,enrollment_id,username,course_id,no_of_objects,bno_access,bno_pageclose,bno_problem,bno_video,bno_discussion,bno_navigate,bno_wiki,bno_total,bno_avg,no_of_active_days,time_consumption,browser_access,browser_pageclose,browser_problem,browser_video,server_access,server_discussion,server_problem,server_navigate,server_wiki,bno_browser,bno_server,label
0,3,1qXC7Fjbwp66GPQc6pHLfEuO8WKozxG4,7GRhBDsirIGkRZBtSMEzNTyDr2JQm4xx,99,79,22,138,9,26,14,0,288,41.142857142857146,9,2102731.0,34,22,135,9,45,26,3,14,0,200,88,0
1,5,p1Mp7WkVfzUijX0peVQKSHbgd5pXyl4c,7GRhBDsirIGkRZBtSMEzNTyDr2JQm4xx,111,226,87,170,86,34,30,0,633,90.42857142857143,11,0.0,120,87,138,86,106,34,32,30,0,431,202,0
2,7,I1KwJ6EdCZnEPLfC8Q7yWpIkLOHn7h02,7GRhBDsirIGkRZBtSMEzNTyDr2JQm4xx,86,203,60,94,69,33,20,0,479,68.42857142857143,10,0.0,122,60,74,69,81,33,20,20,0,325,154,1
3,13,hDbSkVrFRj9Ryk3c5E1JYJQLyxm4jLRb,5X6FeZozNMgE2VRi3MJYjkkFK8SETtu2,100,200,25,150,69,4,15,0,463,66.14285714285714,8,0.0,106,25,114,69,94,4,36,15,0,314,149,0
4,22,dPBUV0FPFjTZZK079rPAeq0WXhW4DUkF,7GRhBDsirIGkRZBtSMEzNTyDr2JQm4xx,49,66,38,64,36,0,1,0,205,29.285714285714285,2,0.0,26,38,56,36,40,0,8,1,0,156,49,1
5,45,5Tz6BGN7p1lkmdoopAY1Z5ufYTrUsi9E,7GRhBDsirIGkRZBtSMEzNTyDr2JQm4xx,113,326,115,166,104,45,39,0,795,113.57142857142857,16,0.0,153,115,138,104,173,45,28,39,0,510,285,0
6,49,2oTvbzieHn2y5oozeOgSnruqE6N0BtR5,7GRhBDsirIGkRZBtSMEzNTyDr2JQm4xx,95,337,171,68,45,1324,160,0,2105,300.7142857142857,29,0.0,71,171,34,45,266,1324,34,160,0,321,1784,0
7,50,LnNj9zDI8D38ixGOYTIjTH2iF5m36v9S,7GRhBDsirIGkRZBtSMEzNTyDr2JQm4xx,24,49,22,48,0,0,7,0,126,18.0,6,0.0,19,22,43,0,30,0,5,7,0,84,42,1
8,51,bYjPoNbc5ILh7K7s9YR8HLOMNJGN6Ums,5X6FeZozNMgE2VRi3MJYjkkFK8SETtu2,85,520,237,6,229,175,71,0,1238,176.85714285714286,26,0.0,200,237,3,229,320,175,3,71,0,669,569,0
9,58,l9KseRU4xYtwOzoILYmGcicF0iiXQqxl,7GRhBDsirIGkRZBtSMEzNTyDr2JQm4xx,100,239,85,141,34,40,48,2,589,84.14285714285714,16,0.0,68,85,128,34,171,40,13,48,2,315,274,0
10,96,KXi2lu4GlKmrO1lJTLg3t4l701rvNXNZ,7GRhBDsirIGkRZBtSMEzNTyDr2JQm4xx,40,80,38,34,28,1,10,0,191,27.285714285714285,8,0.0,29,38,29,28,51,1,5,10,0,124,67,1
11,114,JNo2rLqKe6aBGDwGzu8tXd13uOC5tEnq,5X6FeZozNMgE2VRi3MJYjkkFK8SETtu2,5,1,1,0,0,0,5,0,7,1.0,1,0.0,0,1,0,0,1,0,0,5,0,1,6,1
12,134,Q5TmTVdy8nnH2vTL73s67ZseaCMO3k91,7GRhBDsirIGkRZBtSMEzNTyDr2JQm4xx,29,23,11,24,8,0,14,0,80,11.428571428571429,4,0.0,9,11,24,8,14,0,0,14,0,52,28,1
13,141,CB4JYroUtmiKv572P6g4vrvJCi6Pzr9h,7GRhBDsirIGkRZBtSMEzNTyDr2JQm4xx,59,105,42,101,31,22,36,0,337,48.142857142857146,6,0.0,61,42,87,31,44,22,14,36,0,221,116,1
14,192,hCxbmPBmjgsEuMY36HnZH4x3BwWFnCUn,7GRhBDsirIGkRZBtSMEzNTyDr2JQm4xx,91,247,58,28,60,0,70,0,463,66.14285714285714,19,0.0,142,58,25,60,105,0,3,70,0,285,178,0
15,199,OEQBiRbbo3yEBzKSHcNX9ESBTSUy08ze,7GRhBDsirIGkRZBtSMEzNTyDr2JQm4xx,136,307,114,216,73,239,57,8,1014,144.85714285714286,10,0.0,168,114,178,73,139,239,38,57,8,533,481,0
16,200,tp9GLoYyljDV6mILQxrtrv1Iw4qcPl5Z,5X6FeZozNMgE2VRi3MJYjkkFK8SETtu2,6,8,3,0,3,0,4,0,18,2.5714285714285716,2,0.0,3,3,0,3,5,0,0,4,0,9,9,1
17,219,088SASUPOVYUGhoEly8vlrkGvRBJoNwp,7GRhBDsirIGkRZBtSMEzNTyDr2JQm4xx,101,834,231,249,26,472,135,14,1961,280.14285714285717,18,0.0,428,231,203,26,406,472,46,135,14,888,1073,0
18,248,BTWrAWjg41jpM1wlPsS1mmQbZAFIvx2o,7GRhBDsirIGkRZBtSMEzNTyDr2JQm4xx,2,0,0,0,0,0,4,0,4,0.5714285714285714,1,0.0,0,0,0,0,0,0,0,4,0,0,4,1
19,255,O6WL6sxvoPCZnvTLyTPxdXbnpOz3wcJ4,7GRhBDsirIGkRZBtSMEzNTyDr2JQm4xx,78,181,51,120,32,6,24,0,414,59.142857142857146,10,0.0,55,51,96,32,126,6,24,24,0,234,180,0
20,272,BttUqG7aP3DWaBbIZQal1szLYpZUGYxR,5X6FeZozNMgE2VRi3MJYjkkFK8SETtu2,9,25,9,0,0,111,19,0,164,23.428571428571427,12,0.0,10,9,0,0,15,111,0,19,0,19,145,0
21,284,L9qMLlGWAeAI6zWAZIyJtn0wISNa3dxg,7GRhBDsirIGkRZBtSMEzNTyDr2JQm4xx,99,118,37,6,55,326,78,0,620,88.57142857142857,24,0.0,45,37,5,55,73,326,1,78,0,142,478,0
22,320,2zijdtZPcsrYvyvmgApN5PnCXULBsIBX,7GRhBDsirIGkRZBtSMEzNTyDr2JQm4xx,1,0,0,0,0,0,1,0,1,0.14285714285714285,1,0.0,0,0,0,0,0,0,0,1,0,0,1,1
23,373,XUkSDdNHWcdano4aRGWpLSTI2IF8D1IH,7GRhBDsirIGkRZBtSMEzNTyDr2JQm4xx,71,210,75,134,3,56,49,3,530,75.71428571428571,11,0.0,67,75,114,3,143,56,20,49,3,259,271,0
24,433,PEDnL2c66c2DN92O9BTVM9D6p19gGbT6,7GRhBDsirIGkRZBtSMEzNTyDr2JQm4xx,61,134,61,57,43,62,37,1,395,56.42857142857143,19,0.0,68,61,50,43,66,62,7,37,1,222,173,0
25,447,a2mtYqbDDrFbFqfnqiJDA0edBTN433cW,5X6FeZozNMgE2VRi3MJYjkkFK8SETtu2,2,0,0,0,0,0,2,0,2,0.2857142857142857,1,0.0,0,0,0,0,0,0,0,2,0,0,2,1
26,493,xNkIHhqS8GZXIqyoWwwS3ZeYfSmUsNJo,7GRhBDsirIGkRZBtSMEzNTyDr2JQm4xx,98,257,62,131,61,0,10,0,521,74.42857142857143,12,0.0,64,62,107,61,193,0,24,10,0,294,227,0
27,555,tiLrccMjeOBHHBLooSoPfc0IKYtAsyXK,7GRhBDsirIGkRZBtSMEzNTyDr2JQm4xx,2,0,0,0,0,0,3,0,3,0.42857142857142855,2,0.0,0,0,0,0,0,0,0,3,0,0,3,1
28,561,7LdIrvw2mKsGn0uQY4FG8nOBRXaRc1Ll,5X6FeZozNMgE2VRi3MJYjkkFK8SETtu2,37,95,24,46,22,4,15,0,206,29.428571428571427,3,0.0,57,24,35,22,38,4,11,15,0,138,68,0
29,630,BbZEGv8zMCuD8c0LXrenf9W1lGSlVd04,7GRhBDsirIGkRZBtSMEzNTyDr2JQm4xx,10,49,6,0,0,1,10,0,66,9.428571428571429,2,0.0,0,6,0,0,49,1,0,10,0,6,60,1
30,721,8C8UfNr6FiHHVx6gYUCnrrjltp4r2EEf,5X6FeZozNMgE2VRi3MJYjkkFK8SETtu2,1,0,0,0,0,0,1,0,1,0.14285714285714285,1,0.0,0,0,0,0,0,0,0,1,0,0,1,1
31,744,4EmbBZZKe7031MRObaECOYTAuU5wz706,5X6FeZozNMgE2VRi3MJYjkkFK8SETtu2,8,9,4,0,4,0,2,0,19,2.7142857142857144,1,0.0,3,4,0,4,6,0,0,2,0,11,8,1
32,777,bLIF0ETNcg7fjkutu8YBWJptM3zxtu2Z,7GRhBDsirIGkRZBtSMEzNTyDr2JQm4xx,103,345,156,135,142,77,99,1,955,136.42857142857142,16,0.0,158,156,120,142,187,77,15,99,1,576,379,0
33,780,anqtRE1JbVfWjk9aVYgpNXBcTCoFe9WO,7GRhBDsirIGkRZBtSMEzNTyDr2JQm4xx,100,206,81,82,62,18,44,4,497,71.0,13,0.0,84,81,71,62,122,18,11,44,4,298,199,1
34,796,6gLqDWyaI2NtlxSWPzL6286Swi1mEUeL,7GRhBDsirIGkRZBtSMEzNTyDr2JQm4xx,2,0,0,0,0,0,2,0,2,0.2857142857142857,1,0.0,0,0,0,0,0,0,0,2,0,0,2,1
35,833,TOPojNiMH24da1PoGtHTHtr3v40hc02S,7GRhBDsirIGkRZBtSMEzNTyDr2JQm4xx,10,7,0,19,0,0,6,0,32,4.571428571428571,1,0.0,3,0,16,0,4,0,3,6,0,19,13,1
36,845,bY5BU72AucM53Ivc1aSf6rn9i7DKfcQZ,7GRhBDsirIGkRZBtSMEzNTyDr2JQm4xx,1,0,0,0,0,0,1,0,1,0.14285714285714285,1,0.0,0,0,0,0,0,0,0,1,0,0,1,1
37,884,c3CVim2QZeSVk1wACFUHDmf9ZjEIwtuP,7GRhBDsirIGkRZBtSMEzNTyDr2JQm4xx,90,180,59,212,48,0,26,0,525,75.0,7,0.0,113,59,171,48,67,0,41,26,0,391,134,0
38,936,Z4uUjFPFbGNbmcg4E2opeBQCoO0nQyZe,7GRhBDsirIGkRZBtSMEzNTyDr2JQm4xx,58,352,100,95,46,18,39,0,650,92.85714285714286,12,0.0,140,100,74,46,212,18,21,39,0,360,290,1
39,937,uQjl8NGtIQkRfoe9edBiMgtYYmdkzVXR,7GRhBDsirIGkRZBtSMEzNTyDr2JQm4xx,79,266,79,160,32,29,25,0,591,84.42857142857143,16,0.0,110,79,134,32,156,29,26,25,0,355,236,0
40,956,SIuVkNKTY2J1cPfs6wUSNXAjh8XyxgwI,7GRhBDsirIGkRZBtSMEzNTyDr2JQm4xx,1,0,0,0,0,0,1,0,1,0.14285714285714285,1,0.0,0,0,0,0,0,0,0,1,0,0,1,1
41,966,uVv1ioGVvP0A5CGQgSQhVTbH75lJRG4O,7GRhBDsirIGkRZBtSMEzNTyDr2JQm4xx,8,11,1,0,2,2,8,1,25,3.5714285714285716,4,0.0,2,1,0,2,9,2,0,8,1,5,20,1
42,980,xMPFWnundpXFSWVcNEdsnGtZrrNJ2nna,5X6FeZozNMgE2VRi3MJYjkkFK8SETtu2,31,50,17,42,15,0,7,0,131,18.714285714285715,5,0.0,26,17,34,15,24,0,8,7,0,92,39,0
43,991,HvUs11HJgqndKBOynrg9yliToxZs6PoS,7GRhBDsirIGkRZBtSMEzNTyDr2JQm4xx,20,26,12,0,10,0,3,0,51,7.285714285714286,1,0.0,6,12,0,10,20,0,0,3,0,28,23,0
44,999,sGrMSEzmd0nQ8tazrPYbRhLOuMlMN34w,7GRhBDsirIGkRZBtSMEzNTyDr2JQm4xx,5,4,2,0,0,0,5,0,11,1.5714285714285714,1,0.0,1,2,0,0,3,0,0,5,0,3,8,1
45,1030,uDdfaOyae5qLVYC8BQlj5xLhiV3is9wS,7GRhBDsirIGkRZBtSMEzNTyDr2JQm4xx,73,272,135,7,76,292,46,1,829,118.42857142857143,15,0.0,109,135,5,76,163,292,2,46,1,325,504,0
46,1052,db3m19q36pgCYtTdKoL3kV4Ubidysmpw,7GRhBDsirIGkRZBtSMEzNTyDr2JQm4xx,1,0,0,0,0,0,1,0,1,0.14285714285714285,1,0.0,0,0,0,0,0,0,0,1,0,0,1,1
47,1072,9XUvtVr9N38jFL9d3KSBLe5NN0NI5Xv8,5X6FeZozNMgE2VRi3MJYjkkFK8SETtu2,1,0,0,0,0,0,2,0,2,0.2857142857142857,2,0.0,0,0,0,0,0,0,0,2,0,0,2,1
48,1090,9ct6Fth9rRpjZJrFIHs9xOnW9W5hBHw6,7GRhBDsirIGkRZBtSMEzNTyDr2JQm4xx,54,120,40,141,22,4,14,0,341,48.714285714285715,6,0.0,69,40,123,22,51,4,18,14,0,254,87,1
49,1134,Q3zkClKdiEJIkoKspwBuSNOwYXuxalAX,7GRhBDsirIGkRZBtSMEzNTyDr2JQm4xx,53,81,29,26,23,6,24,0,189,27.0,9,0.0,34,29,26,23,47,6,0,24,0,112,77,1
50,1147,gCxbOVEJ7FeSqOiwKbB6HzPEL3I9x6ca,7GRhBDsirIGkRZBtSMEzNTyDr2JQm4xx,135,224,86,208,54,97,34,1,704,100.57142857142857,9,0.0,117,86,168,54,107,97,40,34,1,425,279,0
51,1153,y4C09JELGArMkj7EYnAM5VIhmCekYYoO,5X6FeZozNMgE2VRi3MJYjkkFK8SETtu2,4,4,1,0,0,0,2,0,7,1.0,1,0.0,0,1,0,0,4,0,0,2,0,1,6,1
52,1158,sO2CX3PTeWKMUH1S4FDuW0NDXEv7jZi0,5X6FeZozNMgE2VRi3MJYjkkFK8SETtu2,2,0,0,0,0,0,5,0,5,0.7142857142857143,3,0.0,0,0,0,0,0,0,0,5,0,0,5,0
53,1168,k27vxLq1BTsJ0FUzoqJDoc4NU2cleRtl,5X6FeZozNMgE2VRi3MJYjkkFK8SETtu2,15,21,14,1,8,3,6,0,53,7.571428571428571,3,0.0,2,14,1,8,19,3,0,6,0,25,28,1
54,1206,ymJGsoe3Y9XwSfD9UhxMG8gRl87RdPUe,7GRhBDsirIGkRZBtSMEzNTyDr2JQm4xx,41,97,45,44,21,2,12,0,221,31.571428571428573,8,0.0,31,45,38,21,66,2,6,12,0,135,86,1
55,1223,o7MfiO1X5Ui1AYG08PXFhTcXSShcuNhK,7GRhBDsirIGkRZBtSMEzNTyDr2JQm4xx,89,151,71,195,43,17,33,3,513,73.28571428571429,13,0.0,61,71,172,43,90,17,23,33,3,347,166,0
56,1227,RuOAeaUVW53IP9AqfP0jxaXbNkmd7lKN,7GRhBDsirIGkRZBtSMEzNTyDr2JQm4xx,59,73,5,58,21,0,32,0,189,27.0,8,0.0,40,5,47,21,33,0,11,32,0,113,76,0
57,1252,mZIaM3Lmux7GERtSm258BKPOSUYFlwyy,7GRhBDsirIGkRZBtSMEzNTyDr2JQm4xx,113,376,93,179,60,98,47,0,853,121.85714285714286,21,0.0,124,93,149,60,252,98,30,47,0,426,427,0
58,1255,jB9rh6QoUWlta1KDWb4mdWzYIut8deHu,7GRhBDsirIGkRZBtSMEzNTyDr2JQm4xx,6,3,1,0,1,0,2,0,7,1.0,1,0.0,0,1,0,1,3,0,0,2,0,2,5,1
59,1260,beV03mdN2n7VoZwDqBMCKGETqOChXWUx,7GRhBDsirIGkRZBtSMEzNTyDr2JQm4xx,108,467,138,146,78,89,51,7,976,139.42857142857142,10,0.0,160,138,134,78,307,89,12,51,7,510,466,0
60,1269,RSJQ68OFisJaYDiRNDqeLSdLFyonAIP1,7GRhBDsirIGkRZBtSMEzNTyDr2JQm4xx,4,3,1,0,0,0,2,0,6,0.8571428571428571,1,0.0,0,1,0,0,3,0,0,2,0,1,5,1
61,1289,zlsPhArkUaQ0CCdgZTO1797WJjiciHBk,7GRhBDsirIGkRZBtSMEzNTyDr2JQm4xx,141,331,120,234,108,115,43,1,952,136.0,12,0.0,120,120,195,108,211,115,39,43,1,543,409,0
62,1315,kNG9cn23NW62SZcqQSqyW9wMtO0GajdN,7GRhBDsirIGkRZBtSMEzNTyDr2JQm4xx,70,144,38,191,44,9,14,1,441,63.0,7,0.0,93,38,162,44,51,9,29,14,1,337,104,0
63,1328,wNK7ZCxNrr5YNZ14b6FlyAI0tpnOxaZ1,5X6FeZozNMgE2VRi3MJYjkkFK8SETtu2,20,21,2,8,11,0,3,0,45,6.428571428571429,2,0.0,12,2,7,11,9,0,1,3,0,32,13,1
64,1345,eyksoE4AUoKYBpwx782vtNzuK4dwKRY9,7GRhBDsirIGkRZBtSMEzNTyDr2JQm4xx,10,15,4,0,2,1,6,1,29,4.142857142857143,1,0.0,9,4,0,2,6,1,0,6,1,15,14,1
65,1381,8W0dKFntzVy5gs8nAvO6lyUGOY4SLHwO,7GRhBDsirIGkRZBtSMEzNTyDr2JQm4xx,6,6,0,0,0,0,4,0,10,1.4285714285714286,2,0.0,0,0,0,0,6,0,0,4,0,0,10,1
66,1406,4zpruwryS301BhCHcVmaMPfD3MqLCk4h,5X6FeZozNMgE2VRi3MJYjkkFK8SETtu2,155,473,19,420,74,363,43,1,1393,199.0,16,0.0,224,19,324,74,249,363,96,43,1,641,752,0
67,1429,YbP52dGau1RB8H6599HdGbUKOVHWxxw1,7GRhBDsirIGkRZBtSMEzNTyDr2JQm4xx,113,394,148,232,78,17,18,0,887,126.71428571428571,9,0.0,201,148,166,78,193,17,66,18,0,593,294,0
68,1450,q88579uTDrz7tsNTbZoL3mbWXAP4ClqK,7GRhBDsirIGkRZBtSMEzNTyDr2JQm4xx,75,191,72,50,47,35,53,13,461,65.85714285714286,10,0.0,98,72,44,47,93,35,6,53,13,261,200,0
69,1472,Qc7qhDYnMQ0se5itn8lyxOFjZ1zzyfhE,7GRhBDsirIGkRZBtSMEzNTyDr2JQm4xx,89,224,51,258,47,53,53,3,689,98.42857142857143,10,0.0,91,51,228,47,133,53,30,53,3,417,272,0
70,1491,lCyf3TRKW0i3K1mBgKz23OONMdCWqNsI,7GRhBDsirIGkRZBtSMEzNTyDr2JQm4xx,86,436,19,233,72,110,104,11,985,140.71428571428572,15,0.0,249,19,200,72,187,110,33,104,11,540,445,0
71,1502,1rAHmNrxrqnzHEQFMlydmQ968LsZW0oG,7GRhBDsirIGkRZBtSMEzNTyDr2JQm4xx,53,107,42,47,21,9,7,0,233,33.285714285714285,5,0.0,58,42,44,21,49,9,3,7,0,165,68,0
72,1521,IweRnM2AMTe7iVCwVnhk6LnMzajZZKLL,5X6FeZozNMgE2VRi3MJYjkkFK8SETtu2,102,251,16,225,75,0,1,0,568,81.14285714285714,18,0.0,173,16,170,75,78,0,55,1,0,434,134,0
73,1529,DT600yQDJaU6nnkoEQdVx5gZnWz5FfNY,7GRhBDsirIGkRZBtSMEzNTyDr2JQm4xx,56,238,9,196,14,18,35,1,511,73.0,5,0.0,92,9,171,14,146,18,25,35,1,286,225,0
74,1541,Ydg0lHV8igjCQUoXTu9LI2axWzXgXWvH,7GRhBDsirIGkRZBtSMEzNTyDr2JQm4xx,5,2,1,0,0,0,3,0,6,0.8571428571428571,1,0.0,0,1,0,0,2,0,0,3,0,1,5,1
75,1576,d9rEzZ3v1PmiMyudpVDJ4ystf1RU9dCH,7GRhBDsirIGkRZBtSMEzNTyDr2JQm4xx,18,33,8,8,3,1,22,2,77,11.0,6,0.0,8,8,7,3,25,1,1,22,2,26,51,1
76,1587,KKySZH8Vhrdd4z2bRf8FAPkHeGpE3JpX,5X6FeZozNMgE2VRi3MJYjkkFK8SETtu2,11,22,6,0,0,0,14,0,42,6.0,8,0.0,0,6,0,0,22,0,0,14,0,6,36,1
77,1593,rLQXRKLwDTvBugA3fH8VUxASy31pAAsE,7GRhBDsirIGkRZBtSMEzNTyDr2JQm4xx,77,283,94,164,42,93,21,5,702,100.28571428571429,13,0.0,160,94,136,42,123,93,28,21,5,432,270,1
78,1594,argwyep7vMTLtgODtMQ0gxLXJNoq9csR,7GRhBDsirIGkRZBtSMEzNTyDr2JQm4xx,47,135,27,69,18,0,19,0,268,38.285714285714285,11,0.0,52,27,58,18,83,0,11,19,0,155,113,1
79,1616,Bi4hHmeTLwTbUCScu9tC6ZZN7frLUhVP,7GRhBDsirIGkRZBtSMEzNTyDr2JQm4xx,60,136,45,84,26,0,13,0,304,43.42857142857143,4,0.0,68,45,82,26,68,0,2,13,0,221,83,0
80,1617,Qq1YK4GwOtJbMK0bS6Tl6T4YUK2Aco59,5X6FeZozNMgE2VRi3MJYjkkFK8SETtu2,7,5,1,0,2,2,7,0,17,2.4285714285714284,2,0.0,2,1,0,2,3,2,0,7,0,5,12,1
81,1621,hM78zuTWvc2c2WdiFwwJZnLKCiMEzZwE,5X6FeZozNMgE2VRi3MJYjkkFK8SETtu2,98,101,29,122,25,11,13,0,301,43.0,2,0.0,66,29,116,25,35,11,6,13,0,236,65,1
82,1630,BN8wlDCfm46NLUt2P4jjdpJvase6IJc9,7GRhBDsirIGkRZBtSMEzNTyDr2JQm4xx,46,150,42,56,18,20,22,0,308,44.0,9,0.0,70,42,53,18,80,20,3,22,0,183,125,1
83,1637,kgAOuue8T6gEPrjctmtIdYSqA3HuAr1W,5X6FeZozNMgE2VRi3MJYjkkFK8SETtu2,111,194,49,166,43,5,24,2,483,69.0,7,0.0,76,49,142,43,118,5,24,24,2,310,173,0
84,1651,iR2FNNwwVPECfrAWwxLxHcw8art5BqJj,7GRhBDsirIGkRZBtSMEzNTyDr2JQm4xx,55,175,58,93,62,9,13,0,410,58.57142857142857,5,0.0,82,58,72,62,93,9,21,13,0,274,136,0
85,1685,rAPaguNT0tnoFK76JileqLEbVcmAD9at,7GRhBDsirIGkRZBtSMEzNTyDr2JQm4xx,1,0,0,0,0,0,1,0,1,0.14285714285714285,1,0.0,0,0,0,0,0,0,0,1,0,0,1,1
86,1687,oYErMzphr0xt2i2tKTG42QELMDaumLkL,5X6FeZozNMgE2VRi3MJYjkkFK8SETtu2,16,70,18,8,8,41,8,0,153,21.857142857142858,6,0.0,29,18,4,8,41,41,4,8,0,59,94,1
87,1688,Aw7PeIkLW9CDHbPpPSjrFUdtBaUuHUXm,5X6FeZozNMgE2VRi3MJYjkkFK8SETtu2,104,186,49,181,64,25,81,3,589,84.14285714285714,14,0.0,130,49,157,64,56,25,24,81,3,400,189,0
88,1697,LdIFMEp4Gma3xMuOQ2mpp1BJ3jFvB9c2,7GRhBDsirIGkRZBtSMEzNTyDr2JQm4xx,92,193,61,156,49,3,12,0,474,67.71428571428571,13,0.0,70,61,127,49,123,3,29,12,0,307,167,0
89,1708,PVIjAE0m0OeJAYOHc5gIjzktRijtXdS4,7GRhBDsirIGkRZBtSMEzNTyDr2JQm4xx,52,109,38,91,28,4,13,1,284,40.57142857142857,5,0.0,56,38,77,28,53,4,14,13,1,199,85,1
90,1724,yXGb0Kuxvr3gyMDMjDKW3Llv1qZCYjSd,7GRhBDsirIGkRZBtSMEzNTyDr2JQm4xx,1,0,0,0,0,0,1,0,1,0.14285714285714285,1,0.0,0,0,0,0,0,0,0,1,0,0,1,1
91,1728,B6EpScn9lSCPa3RR6ElGV7QvO5jse6Q3,7GRhBDsirIGkRZBtSMEzNTyDr2JQm4xx,1,0,0,0,0,0,1,0,1,0.14285714285714285,1,0.0,0,0,0,0,0,0,0,1,0,0,1,1
92,1749,AeXY5V6bNirN94d0GfQQQX1fFim1uqSr,5X6FeZozNMgE2VRi3MJYjkkFK8SETtu2,8,22,4,0,0,0,28,0,54,7.714285714285714,14,0.0,0,4,0,0,22,0,0,28,0,4,50,0
93,1755,qLrXKwo0jPQz47eKqKRnMiywjqEMxYd1,7GRhBDsirIGkRZBtSMEzNTyDr2JQm4xx,117,236,71,189,60,25,28,0,609,87.0,11,0.0,89,71,163,60,147,25,26,28,0,383,226,0
94,1756,wc32nzp9MMjroUa1gifXyCPIfYwLXy9J,7GRhBDsirIGkRZBtSMEzNTyDr2JQm4xx,36,61,27,39,20,10,28,2,187,26.714285714285715,10,0.0,22,27,34,20,39,10,5,28,2,103,84,1
95,1788,ZsmdkNcVTPviDi6RDTzc0nnIspFki9Ld,7GRhBDsirIGkRZBtSMEzNTyDr2JQm4xx,45,82,38,40,15,6,12,0,193,27.571428571428573,6,0.0,36,38,34,15,46,6,6,12,0,123,70,0
96,1801,wy2vY5aiYwg0C5zglGAXrG2vaWLSbGC9,fbPkOYLVPtPgIt0MxizjfFJov3JbHyAi,14,19,4,0,2,19,10,2,56,8.0,3,0.0,1,4,0,2,18,19,0,10,2,7,49,1
97,1803,MlHPKmdi90dDdvX24jYoFlYEp8xS4RGn,fbPkOYLVPtPgIt0MxizjfFJov3JbHyAi,9,3,1,0,2,0,8,0,14,2.0,3,0.0,0,1,0,2,3,0,0,8,0,3,11,1
98,1804,qRMvc4T53dkwmyfrgm76E5HygPUZo2vr,fbPkOYLVPtPgIt0MxizjfFJov3JbHyAi,77,229,103,47,44,177,72,5,677,96.71428571428571,24,0.0,61,103,41,44,168,177,6,72,5,249,428,0
99,1805,bPy7U6tSxZ9PLPL59Ctwyzm55OFpghJ1,fbPkOYLVPtPgIt0MxizjfFJov3JbHyAi,17,23,12,8,7,0,4,0,54,7.714285714285714,2,0.0,8,12,6,7,15,0,2,4,0,33,21,1
100,1806,NizqQaGjtKbKSjIbDqiqnHJildCbDYqn,fbPkOYLVPtPgIt0MxizjfFJov3JbHyAi,5,2,1,0,1,0,2,0,6,0.8571428571428571,1,0.0,0,1,0,1,2,0,0,2,0,2,4,1
101,1807,tvXgoUvFgvHT9SyDah6Ue0bK2mvIbZdy,fbPkOYLVPtPgIt0MxizjfFJov3JbHyAi,63,220,137,68,50,122,43,0,640,91.42857142857143,13,0.0,51,137,53,50,169,122,15,43,0,291,349,0
102,1811,466PN9Ek5iJamUCk5pZUwazAoeVcTj9e,fbPkOYLVPtPgIt0MxizjfFJov3JbHyAi,7,15,8,0,5,0,5,0,33,4.714285714285714,3,0.0,3,8,0,5,12,0,0,5,0,16,17,1
103,1812,RAptfYJD6Shz4mBcU5ZDsgyIhOYMP4Cp,fbPkOYLVPtPgIt0MxizjfFJov3JbHyAi,12,18,7,4,8,0,16,1,54,7.714285714285714,3,0.0,6,7,3,8,12,0,1,16,1,24,30,1
104,1813,y28h4Mo8cYpNiUreeF5KoyNN24Uz0qpM,fbPkOYLVPtPgIt0MxizjfFJov3JbHyAi,5,7,3,0,3,0,2,0,15,2.142857142857143,1,0.0,3,3,0,3,4,0,0,2,0,9,6,1
105,1815,EZXku3HiM8iDGMBMsO2RMLHj3AEpHhBq,fbPkOYLVPtPgIt0MxizjfFJov3JbHyAi,27,76,3,11,15,31,13,2,151,21.571428571428573,6,0.0,30,3,10,15,46,31,1,13,2,58,93,0
106,1816,uA8rfZuH0eMveW06zMXRELfenuAEs8xA,fbPkOYLVPtPgIt0MxizjfFJov3JbHyAi,1,0,0,0,0,0,1,0,1,0.14285714285714285,1,0.0,0,0,0,0,0,0,0,1,0,0,1,1
107,1817,bXMaalfz1ZqHKnJWw6VXCAoemSeuw45Q,fbPkOYLVPtPgIt0MxizjfFJov3JbHyAi,2,0,0,0,0,0,4,0,4,0.5714285714285714,2,0.0,0,0,0,0,0,0,0,4,0,0,4,0
108,1818,pIBqJuNsqTHvkyItKwWF6wLVRjCC6EZu,fbPkOYLVPtPgIt0MxizjfFJov3JbHyAi,14,58,23,6,17,5,24,0,133,19.0,4,0.0,21,23,6,17,37,5,0,24,0,67,66,1
109,1819,dg1Id0ZrueajjkgW22Z2GRzCY20snksW,fbPkOYLVPtPgIt0MxizjfFJov3JbHyAi,17,40,2,6,6,0,19,1,74,10.571428571428571,5,0.0,10,2,5,6,30,0,1,19,1,23,51,1
110,1821,dovSPYooNHmzLLH97Ddy4FG7Uxhw5XJl,fbPkOYLVPtPgIt0MxizjfFJov3JbHyAi,6,7,4,0,1,0,2,0,14,2.0,2,0.0,0,4,0,1,7,0,0,2,0,5,9,1
111,1822,v1Dw0XqubI6wLrO1l5puralkQ2Aofi2j,fbPkOYLVPtPgIt0MxizjfFJov3JbHyAi,81,237,101,71,73,234,63,13,792,113.14285714285714,20,0.0,99,101,54,73,138,234,17,63,13,327,465,0
112,1823,SnTftKVvcKGSnHeK28R5spRYYXrrxUfB,fbPkOYLVPtPgIt0MxizjfFJov3JbHyAi,9,8,5,0,3,0,6,0,22,3.142857142857143,2,0.0,0,5,0,3,8,0,0,6,0,8,14,1
113,1826,5BwluL2iwK0HgKhM8FgXFAWZQHsXkB8V,fbPkOYLVPtPgIt0MxizjfFJov3JbHyAi,61,124,18,35,19,59,37,3,295,42.142857142857146,11,0.0,32,18,34,19,92,59,1,37,3,103,192,0
114,1827,tfcv93vJo2GySad9H44VOkIGpLaZ6vJT,fbPkOYLVPtPgIt0MxizjfFJov3JbHyAi,79,233,112,84,58,180,49,2,718,102.57142857142857,13,0.0,78,112,72,58,155,180,12,49,2,320,398,0
115,1828,ybh9vQ6AAauphhK98Yeo3xSFaVKS2FRf,fbPkOYLVPtPgIt0MxizjfFJov3JbHyAi,7,6,1,0,1,2,7,0,17,2.4285714285714284,2,0.0,0,1,0,1,6,2,0,7,0,2,15,1
116,1829,xVFYGvJ70vgxoDUQx0bNSbGPI24xZu95,fbPkOYLVPtPgIt0MxizjfFJov3JbHyAi,21,45,16,8,7,0,8,0,84,12.0,1,0.0,1,16,6,7,44,0,2,8,0,30,54,1
117,1830,dtAiYXul2PNEQLlJvo6qGgg8Rx9ORbY3,fbPkOYLVPtPgIt0MxizjfFJov3JbHyAi,10,10,6,0,3,1,11,1,32,4.571428571428571,3,0.0,1,6,0,3,9,1,0,11,1,10,22,1
118,1831,AJJNA78hu8M0U3iP5zWH5DCYqnQ40oOu,fbPkOYLVPtPgIt0MxizjfFJov3JbHyAi,1,0,0,0,0,0,1,0,1,0.14285714285714285,1,0.0,0,0,0,0,0,0,0,1,0,0,1,1
119,1832,IIfD9UPHJEG512IBEQGZwkZbr6HRQ12X,fbPkOYLVPtPgIt0MxizjfFJov3JbHyAi,17,10,6,7,6,6,19,0,54,7.714285714285714,4,0.0,2,6,4,6,8,6,3,19,0,18,36,1
120,1833,HmB7Zdy2V8HQu5G1BqmV4NlAuUyOhHRH,fbPkOYLVPtPgIt0MxizjfFJov3JbHyAi,5,2,1,0,1,0,2,0,6,0.8571428571428571,1,0.0,0,1,0,1,2,0,0,2,0,2,4,1
121,1835,EF6CIWnoQbVOAhqoxFyrjqUraX7wKiE2,fbPkOYLVPtPgIt0MxizjfFJov3JbHyAi,9,13,2,2,4,0,7,0,28,4.0,2,0.0,7,2,2,4,6,0,0,7,0,15,13,1
122,1838,lWTcPPbtiIF5S9YQyk662ew20jbdMtY0,fbPkOYLVPtPgIt0MxizjfFJov3JbHyAi,8,6,4,0,3,0,3,0,16,2.2857142857142856,1,0.0,0,4,0,3,6,0,0,3,0,7,9,1
123,1842,Hie5jI1V7aqUGyRciLGioIx6C3WNaVxM,fbPkOYLVPtPgIt0MxizjfFJov3JbHyAi,8,6,4,0,3,0,3,0,16,2.2857142857142856,1,0.0,0,4,0,3,6,0,0,3,0,7,9,1
124,1844,FSrU0Uh74oBwrZKS577R74m2Rk2Lst8A,fbPkOYLVPtPgIt0MxizjfFJov3JbHyAi,19,21,16,0,10,2,11,0,60,8.571428571428571,3,0.0,0,16,0,10,21,2,0,11,0,26,34,1
125,1845,oaoj9be4jW2Hot8wYgYrzLRvB0RU4KYy,fbPkOYLVPtPgIt0MxizjfFJov3JbHyAi,5,26,11,0,1,0,12,0,50,7.142857142857143,11,0.0,0,11,0,1,26,0,0,12,0,12,38,0
126,1849,EwY7qFfJi5mALnvpyzKwHyXzi33SDVyS,fbPkOYLVPtPgIt0MxizjfFJov3JbHyAi,1,0,0,0,0,0,1,0,1,0.14285714285714285,1,0.0,0,0,0,0,0,0,0,1,0,0,1,1
127,1852,srnnzUkIJr2Uisav8LfnV4SnpbNw9CLp,fbPkOYLVPtPgIt0MxizjfFJov3JbHyAi,8,12,6,0,3,1,5,0,27,3.857142857142857,2,0.0,3,6,0,3,9,1,0,5,0,12,15,1
128,1856,ScOtpH9Zf7UmvFfXBxi9XtXFmhGO9CpS,fbPkOYLVPtPgIt0MxizjfFJov3JbHyAi,74,262,109,52,71,130,82,5,711,101.57142857142857,19,0.0,65,109,49,71,197,130,3,82,5,294,417,0
129,1859,renLevNnf6MkkqeGAoBcuGxp4Cuebb9X,fbPkOYLVPtPgIt0MxizjfFJov3JbHyAi,29,79,46,13,19,66,74,12,309,44.142857142857146,8,0.0,6,46,10,19,73,66,3,74,12,81,228,0
130,1861,wHW6M4zJx3WQvnkWxa8NK7bA13uSffjE,fbPkOYLVPtPgIt0MxizjfFJov3JbHyAi,89,382,197,73,106,196,90,12,1056,150.85714285714286,22,0.0,119,197,61,106,263,196,12,90,12,483,573,0
131,1862,w85QVmINOIyrXRzegh8uuBeGTw3K4uG8,fbPkOYLVPtPgIt0MxizjfFJov3JbHyAi,29,69,31,8,20,33,15,2,178,25.428571428571427,6,0.0,27,31,8,20,42,33,0,15,2,86,92,0
132,1863,2HxHgYZUxjcTVAkRZXALZPpAKp12AIkW,fbPkOYLVPtPgIt0MxizjfFJov3JbHyAi,74,127,56,46,47,44,36,5,361,51.57142857142857,10,0.0,35,56,39,47,92,44,7,36,5,177,184,1
133,1864,FRQoIHmdY13z6FOe616T4ApTF4hqzTvO,fbPkOYLVPtPgIt0MxizjfFJov3JbHyAi,1,0,0,0,0,0,2,0,2,0.2857142857142857,1,0.0,0,0,0,0,0,0,0,2,0,0,2,1
134,1865,UA8vU3s92g3lXc62U363PEO0xor6Mpeg,fbPkOYLVPtPgIt0MxizjfFJov3JbHyAi,18,27,13,2,10,0,5,0,57,8.142857142857142,5,0.0,3,13,2,10,24,0,0,5,0,28,29,0
135,1867,ZfVW8NtYbpP20iy3ae2NWyUMggR9fJnX,fbPkOYLVPtPgIt0MxizjfFJov3JbHyAi,6,1,1,0,1,2,3,0,8,1.1428571428571428,1,0.0,0,1,0,1,1,2,0,3,0,2,6,1
136,1869,F2lMVOvthfQUdLTXVbrysvFvsOo64vSi,fbPkOYLVPtPgIt0MxizjfFJov3JbHyAi,1,0,0,0,0,0,1,0,1,0.14285714285714285,1,0.0,0,0,0,0,0,0,0,1,0,0,1,1
137,1870,hl0OrMfg8qb0yyqeozXaj4TvTbuGpido,fbPkOYLVPtPgIt0MxizjfFJov3JbHyAi,5,3,1,0,1,0,2,0,7,1.0,1,0.0,1,1,0,1,2,0,0,2,0,3,4,1
138,1871,h6FvnvKLn3PYeo7ymsUxV04MtM6t8VXd,fbPkOYLVPtPgIt0MxizjfFJov3JbHyAi,6,5,3,0,2,0,2,0,12,1.7142857142857142,1,0.0,0,3,0,2,5,0,0,2,0,5,7,0
139,1872,IEhRIW6aJG3VEfNQv5VS8sa7hXLIMUWs,fbPkOYLVPtPgIt0MxizjfFJov3JbHyAi,5,4,2,0,2,0,3,0,11,1.5714285714285714,2,0.0,0,2,0,2,4,0,0,3,0,4,7,1
140,1873,kkiICQcdDTiO8OFUMgn7HGjTwIHaL29F,fbPkOYLVPtPgIt0MxizjfFJov3JbHyAi,12,24,12,0,5,0,14,1,56,8.0,2,0.0,6,12,0,5,18,0,0,14,1,23,33,1
141,1874,PPK7S6McpqG1xker7o77HjrFULvz49Xg,fbPkOYLVPtPgIt0MxizjfFJov3JbHyAi,1,0,0,0,0,0,1,0,1,0.14285714285714285,1,0.0,0,0,0,0,0,0,0,1,0,0,1,1
142,1875,NmOI6yuIgn0ShW8ps51AeOISH4CX20PY,fbPkOYLVPtPgIt0MxizjfFJov3JbHyAi,6,5,0,0,0,0,6,0,11,1.5714285714285714,2,0.0,0,0,0,0,5,0,0,6,0,0,11,1
143,1876,fB8dnTYj30CwHncKJXhBKyfe0bv6lATH,fbPkOYLVPtPgIt0MxizjfFJov3JbHyAi,1,0,0,0,0,0,1,0,1,0.14285714285714285,1,0.0,0,0,0,0,0,0,0,1,0,0,1,1
144,1878,0UPVw8ecIiIpfGXqAIUJXTbKxiiOJqXC,fbPkOYLVPtPgIt0MxizjfFJov3JbHyAi,26,42,17,6,15,4,6,0,90,12.857142857142858,3,0.0,5,17,5,15,37,4,1,6,0,42,48,1
145,1879,29lVEZFZAjCojpdMgxYvJN3otXj3PLWe,fbPkOYLVPtPgIt0MxizjfFJov3JbHyAi,38,69,21,14,11,35,17,10,177,25.285714285714285,4,0.0,12,21,13,11,57,35,1,17,10,57,120,0
146,1880,DSWjfYVjIvEWi0MzNQ04NT3mnhbcHkJI,fbPkOYLVPtPgIt0MxizjfFJov3JbHyAi,25,15,13,0,11,0,3,0,42,6.0,2,0.0,0,13,0,11,15,0,0,3,0,24,18,0
147,1882,QphSShJ8h2yJ72VG9nEiSoDfHxRIzVu7,fbPkOYLVPtPgIt0MxizjfFJov3JbHyAi,5,2,1,0,1,0,2,0,6,0.8571428571428571,1,0.0,0,1,0,1,2,0,0,2,0,2,4,1
148,1883,N9Ha8uFhXV9Cw5jdp4DZ3nwxS00UsWF7,fbPkOYLVPtPgIt0MxizjfFJov3JbHyAi,5,2,1,0,1,0,2,0,6,0.8571428571428571,1,0.0,0,1,0,1,2,0,0,2,0,2,4,1
149,1886,C8YNpI6QedFpxBsm2SSsdYc3sr1kuXhE,fbPkOYLVPtPgIt0MxizjfFJov3JbHyAi,11,6,5,0,2,0,3,0,16,2.2857142857142856,1,0.0,0,5,0,2,6,0,0,3,0,7,9,1
150,1888,lbgTV2YMskSv2TX4EXpaazpMVWfsftEV,fbPkOYLVPtPgIt0MxizjfFJov3JbHyAi,9,17,11,0,5,0,10,0,43,6.142857142857143,2,0.0,0,11,0,5,17,0,0,10,0,16,27,0
151,1891,s6iksgptFmyh2vfiarKdJkiKnp6RLi3f,fbPkOYLVPtPgIt0MxizjfFJov3JbHyAi,27,63,23,0,9,154,25,1,275,39.285714285714285,10,0.0,3,23,0,9,60,154,0,25,1,35,240,0
152,1893,oKLMQAZTIOtP37CLM9yXiFLXKHfYljGQ,fbPkOYLVPtPgIt0MxizjfFJov3JbHyAi,8,5,4,0,3,0,2,0,14,2.0,1,0.0,0,4,0,3,5,0,0,2,0,7,7,0
153,1894,Vc4rFh1HQZiO6qLgOrealEeiZYYPbmOY,fbPkOYLVPtPgIt0MxizjfFJov3JbHyAi,80,148,68,110,32,62,22,0,442,63.142857142857146,14,0.0,24,68,90,32,124,62,20,22,0,214,228,0
154,1895,OSy4QIw7JPCY2rc20jXdh8AKuQUlvuiP,fbPkOYLVPtPgIt0MxizjfFJov3JbHyAi,1,0,0,0,0,0,1,0,1,0.14285714285714285,1,0.0,0,0,0,0,0,0,0,1,0,0,1,1
155,1899,CXDFvBGg10x2RDdl5BC09Fv76dN9FJm7,fbPkOYLVPtPgIt0MxizjfFJov3JbHyAi,81,181,55,98,36,50,29,0,449,64.14285714285714,8,0.0,63,55,94,36,118,50,4,29,0,248,201,0
156,1901,d4vFRav8ffA9IVzingBKcuQRy85TQDkU,fbPkOYLVPtPgIt0MxizjfFJov3JbHyAi,2,0,0,0,0,0,2,0,2,0.2857142857142857,1,0.0,0,0,0,0,0,0,0,2,0,0,2,1
157,1902,Kd69M9W1nim0woqVm1QxfVaSebsYtFIh,fbPkOYLVPtPgIt0MxizjfFJov3JbHyAi,18,32,12,9,9,2,12,1,77,11.0,2,0.0,9,12,9,9,23,2,0,12,1,39,38,0
158,1903,TkQQvYTOoXkFjbJKIO2v3OeQa3imG4fA,fbPkOYLVPtPgIt0MxizjfFJov3JbHyAi,91,186,68,40,68,121,48,2,533,76.14285714285714,14,0.0,94,68,36,68,92,121,4,48,2,266,267,0
159,1906,9axGajSG0OSppcbacnyHhfFBFAa9eoTG,fbPkOYLVPtPgIt0MxizjfFJov3JbHyAi,7,5,2,0,0,5,6,1,19,2.7142857142857144,1,0.0,2,2,0,0,3,5,0,6,1,4,15,1
160,1909,ZV8DsXL77GGEtffNT3JZQjNfaNYGufcp,fbPkOYLVPtPgIt0MxizjfFJov3JbHyAi,1,0,0,0,0,0,1,0,1,0.14285714285714285,1,0.0,0,0,0,0,0,0,0,1,0,0,1,1
161,1910,CtgLRd04Cnda49EWlN19NulXjkuBNDXd,fbPkOYLVPtPgIt0MxizjfFJov3JbHyAi,79,126,34,60,33,55,11,0,319,45.57142857142857,7,0.0,46,34,53,33,80,55,7,11,0,166,153,0
162,1911,vW12OyfPXCTKZvYAAAyAdgYsdUu0MHKL,fbPkOYLVPtPgIt0MxizjfFJov3JbHyAi,2,0,0,0,0,0,3,0,3,0.42857142857142855,1,0.0,0,0,0,0,0,0,0,3,0,0,3,1
163,1913,OXDIjQPBiuWpB7PdzfniEtiITaq40Kxq,fbPkOYLVPtPgIt0MxizjfFJov3JbHyAi,8,8,4,0,3,0,7,0,22,3.142857142857143,3,0.0,0,4,0,3,8,0,0,7,0,7,15,1
164,1915,FCTGjFMpPr9Ardf2214VmZ4FrZJLQUjd,fbPkOYLVPtPgIt0MxizjfFJov3JbHyAi,1,0,0,0,0,0,1,0,1,0.14285714285714285,1,0.0,0,0,0,0,0,0,0,1,0,0,1,1
165,1917,Q7l1wAYa10mkA3laPizDBbeQPyCyYqgB,fbPkOYLVPtPgIt0MxizjfFJov3JbHyAi,1,0,0,0,0,0,1,0,1,0.14285714285714285,1,0.0,0,0,0,0,0,0,0,1,0,0,1,1
166,1918,rJw2uGGbceq8fztznJ85JmFc8aj1HUrB,fbPkOYLVPtPgIt0MxizjfFJov3JbHyAi,1,0,0,0,0,0,1,0,1,0.14285714285714285,1,0.0,0,0,0,0,0,0,0,1,0,0,1,1
167,1922,ddq0oVEKEWGKWnbGS4cfbzVZj0yFimxw,fbPkOYLVPtPgIt0MxizjfFJov3JbHyAi,48,62,46,19,27,0,14,0,168,24.0,8,0.0,7,46,16,27,55,0,3,14,0,96,72,0
168,1923,UgNr6maIjrTPAjpLAvEGxJ6P02hrpr0j,fbPkOYLVPtPgIt0MxizjfFJov3JbHyAi,77,182,71,73,46,17,37,1,427,61.0,17,0.0,41,71,69,46,141,17,4,37,1,227,200,0
169,1926,5ZyvCd3AP7a8azCiLN5JfLAP53iZpAyD,fbPkOYLVPtPgIt0MxizjfFJov3JbHyAi,1,0,0,0,0,0,2,0,2,0.2857142857142857,2,0.0,0,0,0,0,0,0,0,2,0,0,2,1
170,1928,qQzK8soi99yuu1apkrTsdydZJSsJ4gfB,fbPkOYLVPtPgIt0MxizjfFJov3JbHyAi,12,18,9,8,4,9,7,2,57,8.142857142857142,3,0.0,7,9,6,4,11,9,2,7,2,26,31,1
171,1929,v9mjKPlqj9n2M1xFKzFtpQVo3yi6HxGV,fbPkOYLVPtPgIt0MxizjfFJov3JbHyAi,8,8,6,0,3,0,3,0,20,2.857142857142857,2,0.0,0,6,0,3,8,0,0,3,0,9,11,1
172,1931,gUUf0vmNg6gEFqYol91VXQX0Cn6Mly3v,fbPkOYLVPtPgIt0MxizjfFJov3JbHyAi,84,230,150,43,92,71,13,4,603,86.14285714285714,15,0.0,53,150,40,92,177,71,3,13,4,335,268,0
173,1932,0QuoKrP2mZHT58SMwYhNVh8QIa2Bx3jw,fbPkOYLVPtPgIt0MxizjfFJov3JbHyAi,47,70,49,0,32,3,13,3,170,24.285714285714285,4,0.0,2,49,0,32,68,3,0,13,3,83,87,0
174,1933,mNLR1O6gqXF6Zqi4uIf130gITni9gN1A,fbPkOYLVPtPgIt0MxizjfFJov3JbHyAi,81,150,86,34,46,29,33,3,381,54.42857142857143,16,0.0,26,86,34,46,124,29,0,33,3,192,189,0
175,1934,vLkHxueYkg4zIw30PVDRmNNDttOLjZ8Q,fbPkOYLVPtPgIt0MxizjfFJov3JbHyAi,8,8,3,0,4,0,2,0,17,2.4285714285714284,1,0.0,2,3,0,4,6,0,0,2,0,9,8,1
176,1936,YLLq9nLffaF9TP2dJ2OpMZwhKv5cSnoB,fbPkOYLVPtPgIt0MxizjfFJov3JbHyAi,16,26,12,2,7,3,2,0,52,7.428571428571429,2,0.0,5,12,2,7,21,3,0,2,0,26,26,1
177,1938,TWWcfQljyWhMSOCysnI4EAWbqXZ7VNJj,fbPkOYLVPtPgIt0MxizjfFJov3JbHyAi,10,7,2,6,3,0,6,1,25,3.5714285714285716,1,0.0,4,2,5,3,3,0,1,6,1,14,11,1
178,1939,GpNHaNdhxCDdSQ7DpRSuzDihSlnkIh3f,fbPkOYLVPtPgIt0MxizjfFJov3JbHyAi,11,3,2,0,2,0,7,1,15,2.142857142857143,2,0.0,0,2,0,2,3,0,0,7,1,4,11,1
179,1940,a7VEIs7rhyootOFOxpi9zJBtM0N2POJ5,fbPkOYLVPtPgIt0MxizjfFJov3JbHyAi,7,6,3,0,2,0,3,0,14,2.0,3,0.0,1,3,0,2,5,0,0,3,0,6,8,1
180,1941,ieB6czVULq4QvL1aVq2UtWwf2TXRyCrf,fbPkOYLVPtPgIt0MxizjfFJov3JbHyAi,5,3,1,0,1,0,2,0,7,1.0,1,0.0,0,1,0,1,3,0,0,2,0,2,5,1
181,1943,S1MqxZA8wNnn30FSBfJ8uK4pTicj2Ko9,fbPkOYLVPtPgIt0MxizjfFJov3JbHyAi,69,151,96,37,52,30,42,7,415,59.285714285714285,15,0.0,24,96,34,52,127,30,3,42,7,206,209,0
182,1945,KM3IAf1A23ZYRH7BjTN3a6rzUKD52rd8,fbPkOYLVPtPgIt0MxizjfFJov3JbHyAi,10,12,7,0,3,0,20,0,42,6.0,5,0.0,0,7,0,3,12,0,0,20,0,10,32,1
183,1947,bopoENydvuKHGXiexTKfIqhYixOE9yJX,fbPkOYLVPtPgIt0MxizjfFJov3JbHyAi,1,0,0,0,0,0,1,0,1,0.14285714285714285,1,0.0,0,0,0,0,0,0,0,1,0,0,1,1
184,1948,Ftq38qAgSBQ9kcYE1HcFamzukTfMOPPE,fbPkOYLVPtPgIt0MxizjfFJov3JbHyAi,8,10,6,0,6,2,5,0,29,4.142857142857143,1,0.0,2,6,0,6,8,2,0,5,0,14,15,1
185,1949,2AW6aH0SqKYjpe5J2qxXqfKxHscq7JWf,fbPkOYLVPtPgIt0MxizjfFJov3JbHyAi,1,0,0,0,0,0,1,0,1,0.14285714285714285,1,0.0,0,0,0,0,0,0,0,1,0,0,1,1
186,1950,yGZoU4KfSyze8yifx7Q3tvuL6vVequyW,fbPkOYLVPtPgIt0MxizjfFJov3JbHyAi,9,5,2,0,2,0,4,1,14,2.0,1,0.0,0,2,0,2,5,0,0,4,1,4,10,1
187,1951,dq3iqibSI5OSwCbWRZv7tfgbiuLwOgjh,fbPkOYLVPtPgIt0MxizjfFJov3JbHyAi,31,53,32,0,20,6,11,3,125,17.857142857142858,6,0.0,2,32,0,20,51,6,0,11,3,54,71,0
188,1952,GHASD1jXGkBlTg5fu3oCYk3lClJihiOZ,fbPkOYLVPtPgIt0MxizjfFJov3JbHyAi,8,5,4,0,3,0,2,0,14,2.0,1,0.0,0,4,0,3,5,0,0,2,0,7,7,1
189,1966,mR9Awu9GGhq6cpZDsN1vhsOMBBjHJTwu,5Gyp41oLVo7Gg7vF4vpmggWP5MU70QO6,20,45,18,12,9,3,14,1,102,14.571428571428571,4,0.0,12,18,6,9,33,3,6,14,1,45,57,0
190,1967,viuKt4GgrX0rYL5EpHoxJbsiC9TblSuk,5Gyp41oLVo7Gg7vF4vpmggWP5MU70QO6,43,185,100,3,48,49,59,0,444,63.42857142857143,11,0.0,29,100,3,48,156,49,0,59,0,180,264,0
191,1971,9W6HDa8nbr3i4rkBKbOa5qCJz73HRO2D,5Gyp41oLVo7Gg7vF4vpmggWP5MU70QO6,7,4,1,0,1,0,6,0,12,1.7142857142857142,4,0.0,0,1,0,1,4,0,0,6,0,2,10,0
192,2007,WwTMXNtl4b2JCcFe3lwVpQGXGiLdPZkR,5Gyp41oLVo7Gg7vF4vpmggWP5MU70QO6,48,145,56,38,39,36,28,1,343,49.0,13,0.0,44,56,31,39,101,36,7,28,1,170,173,0
193,2010,Wb6aI9r02EpZ5D98i2k8BFs1ifi8zKrN,5Gyp41oLVo7Gg7vF4vpmggWP5MU70QO6,31,44,22,18,10,12,8,0,114,16.285714285714285,3,0.0,13,22,11,10,31,12,7,8,0,56,58,1
194,2020,MT2eJtF59AVNdUs7mwFqputROb2HgEm3,5Gyp41oLVo7Gg7vF4vpmggWP5MU70QO6,47,84,39,40,27,2,17,2,211,30.142857142857142,5,0.0,34,39,26,27,50,2,14,17,2,126,85,0
195,2050,AAAvWauitKfXD0xRpNsfpOKQu223kCXG,5Gyp41oLVo7Gg7vF4vpmggWP5MU70QO6,7,11,5,0,0,0,8,0,24,3.4285714285714284,1,0.0,0,5,0,0,11,0,0,8,0,5,19,1
196,2052,YdQETnM22WB3LHnbv3lrj7jNNeRZbGOv,5Gyp41oLVo7Gg7vF4vpmggWP5MU70QO6,24,40,21,8,11,4,16,0,100,14.285714285714286,9,0.0,8,21,5,11,32,4,3,16,0,45,55,1
197,2090,EFLqetAC0SbN4lqTSizhSOwWBqOW5pzD,5Gyp41oLVo7Gg7vF4vpmggWP5MU70QO6,30,196,101,49,0,8,49,0,403,57.57142857142857,10,0.0,52,101,46,0,144,8,3,49,0,199,204,0
198,2095,tmFoPNpDaAjHzJfZZJ0IMTgD0xB27hlJ,5Gyp41oLVo7Gg7vF4vpmggWP5MU70QO6,40,114,56,16,15,210,12,1,424,60.57142857142857,10,0.0,29,56,10,15,85,210,6,12,1,110,314,0
199,2100,HL02PKMnOIDdiDp79NgTxbZJpjcKEWWT,5Gyp41oLVo7Gg7vF4vpmggWP5MU70QO6,41,155,79,41,19,31,45,6,376,53.714285714285715,14,0.0,24,79,36,19,131,31,5,45,6,158,218,0
200,2109,HAAyQYNYY3ULmqhNC56bxv5FSwyMVoqP,5Gyp41oLVo7Gg7vF4vpmggWP5MU70QO6,68,275,104,91,56,81,50,2,659,94.14285714285714,12,0.0,105,104,81,56,170,81,10,50,2,346,313,0
201,2110,uLcaXBNyG83zLSyGLz4DRe4DcdelO0kq,5Gyp41oLVo7Gg7vF4vpmggWP5MU70QO6,6,4,2,0,1,0,4,0,11,1.5714285714285714,2,0.0,0,2,0,1,4,0,0,4,0,3,8,1
202,2114,sOkc0wEXSSLpxtxlqjZObJqg94IyLpuY,5Gyp41oLVo7Gg7vF4vpmggWP5MU70QO6,65,409,174,50,96,22,97,2,850,121.42857142857143,20,0.0,128,174,42,96,281,22,8,97,2,440,410,0
203,2128,RKrHiM5fV6iRyDSg9nuc5aF1dnWrhOU4,5Gyp41oLVo7Gg7vF4vpmggWP5MU70QO6,34,82,38,28,32,5,12,0,197,28.142857142857142,9,0.0,36,38,17,32,46,5,11,12,0,123,74,1
204,2131,WyF6ThNl8T4ZuBisCQw24oD2MtmL93xx,5Gyp41oLVo7Gg7vF4vpmggWP5MU70QO6,32,74,29,26,22,108,29,1,289,41.285714285714285,6,0.0,28,29,16,22,46,108,10,29,1,95,194,0
205,2134,jZihjvtYP7amDpkoC0oh2f8rmnfsHP9b,5Gyp41oLVo7Gg7vF4vpmggWP5MU70QO6,21,42,19,16,4,0,5,0,86,12.285714285714286,3,0.0,9,19,12,4,33,0,4,5,0,44,42,1
206,2153,3IgwuZBiVdgdYRQ9ySaEvpMizbjCJFS0,5Gyp41oLVo7Gg7vF4vpmggWP5MU70QO6,36,79,36,27,18,19,29,0,208,29.714285714285715,8,0.0,12,36,22,18,67,19,5,29,0,88,120,0
207,2160,XY4zkM1XF8dydjqcvDmQyLNW1UDj6PeN,5Gyp41oLVo7Gg7vF4vpmggWP5MU70QO6,53,153,79,65,32,53,40,0,422,60.285714285714285,15,0.0,35,79,52,32,118,53,13,40,0,198,224,0
208,2179,MkhWkWrDBg7jFp3XklVC8uZQ46nAon3u,5Gyp41oLVo7Gg7vF4vpmggWP5MU70QO6,15,25,12,6,4,6,7,0,60,8.571428571428571,2,0.0,3,12,4,4,22,6,2,7,0,23,37,0
209,2197,nwB8ZmEmfTKf0a8lq14Fk2ak05qhI5uT,5Gyp41oLVo7Gg7vF4vpmggWP5MU70QO6,5,2,1,0,1,0,2,0,6,0.8571428571428571,1,0.0,0,1,0,1,2,0,0,2,0,2,4,1
210,2201,Yni8rK7aKtRJ53sTltPsG2WLebXl61tk,5Gyp41oLVo7Gg7vF4vpmggWP5MU70QO6,74,190,105,35,57,0,36,1,424,60.57142857142857,26,0.0,51,105,31,57,139,0,4,36,1,244,180,0
211,2213,4DUZBFD9Fwl71r8i0SB6pVZCzmNoxKnn,5Gyp41oLVo7Gg7vF4vpmggWP5MU70QO6,61,283,91,29,30,55,71,0,559,79.85714285714286,26,0.0,49,91,26,30,234,55,3,71,0,196,363,0
212,2233,IAOTVxG7e06ArppQIZcVBCeppiZS52Zi,5Gyp41oLVo7Gg7vF4vpmggWP5MU70QO6,7,3,2,0,2,0,2,0,9,1.2857142857142858,1,0.0,0,2,0,2,3,0,0,2,0,4,5,1
213,2251,i9KniaV1B46Y9GkyuEOezIhgC4L1zbPS,5Gyp41oLVo7Gg7vF4vpmggWP5MU70QO6,67,429,190,98,56,148,105,8,1034,147.71428571428572,24,0.0,88,190,87,56,341,148,11,105,8,421,613,0
214,2262,dgFOOUSNfQK8xIrT47Av0Q04bBFeE21W,5Gyp41oLVo7Gg7vF4vpmggWP5MU70QO6,18,41,16,15,10,3,10,0,95,13.571428571428571,4,0.0,16,16,10,10,25,3,5,10,0,52,43,1
215,2265,WdeZz7OyQpyfXtfu6OVEuvlOTlAEPRGd,5Gyp41oLVo7Gg7vF4vpmggWP5MU70QO6,36,173,9,29,15,19,32,1,278,39.714285714285715,14,0.0,34,9,23,15,139,19,6,32,1,81,197,0
216,2292,fCcstm1UmVtNkQjxvmynrnOTNEshrQAy,5Gyp41oLVo7Gg7vF4vpmggWP5MU70QO6,28,53,16,16,11,0,9,0,105,15.0,10,0.0,9,16,11,11,44,0,5,9,0,47,58,0
217,2296,foQ0qrxdc5pW7WTJ6CqhvwoYucCLIx5q,5Gyp41oLVo7Gg7vF4vpmggWP5MU70QO6,4,0,0,0,0,1,3,0,4,0.5714285714285714,1,0.0,0,0,0,0,0,1,0,3,0,0,4,1
218,2301,XrXHtqckCj56x4VbN0hXe9QBiRIdyn6o,5Gyp41oLVo7Gg7vF4vpmggWP5MU70QO6,18,22,10,2,12,0,6,1,53,7.571428571428571,2,0.0,7,10,1,12,15,0,1,6,1,30,23,1
219,2321,7mGdRiMzSbTybRB8CqLZKk01SINUa2wl,5Gyp41oLVo7Gg7vF4vpmggWP5MU70QO6,6,4,2,0,3,0,1,0,10,1.4285714285714286,1,0.0,1,2,0,3,3,0,0,1,0,6,4,1
220,2364,vMVabvpkzSgKBRSkZq6rXDzalfa01CME,5Gyp41oLVo7Gg7vF4vpmggWP5MU70QO6,1,0,0,0,0,0,1,0,1,0.14285714285714285,1,0.0,0,0,0,0,0,0,0,1,0,0,1,1
221,2385,CE7hlTWnMpoldcHVRqlfbEgzp5iUVo4d,5Gyp41oLVo7Gg7vF4vpmggWP5MU70QO6,51,164,70,52,69,21,60,6,442,63.142857142857146,15,0.0,62,70,38,69,102,21,14,60,6,239,203,0
222,2386,ZDVmuYiPoGm0gu1bR2BaE1soF6dU5v1W,5Gyp41oLVo7Gg7vF4vpmggWP5MU70QO6,32,122,74,50,2,92,17,3,360,51.42857142857143,7,0.0,28,74,42,2,94,92,8,17,3,146,214,1
223,2404,PZR92F4vjGduhGUb6Sp8QbsK0UCWUlwa,5Gyp41oLVo7Gg7vF4vpmggWP5MU70QO6,10,7,3,0,2,0,6,0,18,2.5714285714285716,2,0.0,0,3,0,2,7,0,0,6,0,5,13,1
224,2407,R3kslje9mLlSM7EKRZmEPd7ZEdwrTHI6,5Gyp41oLVo7Gg7vF4vpmggWP5MU70QO6,19,38,24,0,11,0,12,0,85,12.142857142857142,6,0.0,1,24,0,11,37,0,0,12,0,36,49,1
225,2415,qzW6QZMtIcHTMNtiHaANlHSnvdzPgQYz,5Gyp41oLVo7Gg7vF4vpmggWP5MU70QO6,9,7,5,0,3,2,10,4,31,4.428571428571429,1,0.0,0,5,0,3,7,2,0,10,4,8,23,1
226,2425,cS4j36iYvYOHHK4d6wWz4Cr0lyqpITjd,5Gyp41oLVo7Gg7vF4vpmggWP5MU70QO6,7,4,2,0,3,0,3,0,12,1.7142857142857142,1,0.0,1,2,0,3,3,0,0,3,0,6,6,1
227,2430,NxaQovohNGJ7YH62gDXL54m0ee7NBEMY,5Gyp41oLVo7Gg7vF4vpmggWP5MU70QO6,5,2,1,0,1,0,2,0,6,0.8571428571428571,1,0.0,0,1,0,1,2,0,0,2,0,2,4,1
228,2449,wN3D5V0PcvlAmjJOpaJoryMWfNHdUYCU,5Gyp41oLVo7Gg7vF4vpmggWP5MU70QO6,9,7,3,0,1,20,21,57,109,15.571428571428571,2,0.0,0,3,0,1,7,20,0,21,57,4,105,0
229,2455,xV9PPe0O5JVt8N996wddaP95GExzbGyi,5Gyp41oLVo7Gg7vF4vpmggWP5MU70QO6,1,0,0,0,0,0,1,0,1,0.14285714285714285,1,0.0,0,0,0,0,0,0,0,1,0,0,1,0
230,2472,1tZVjYbxh9CHPwBYYql5LZw9fjNAGkzN,5Gyp41oLVo7Gg7vF4vpmggWP5MU70QO6,31,141,80,39,36,32,45,11,384,54.857142857142854,17,0.0,20,80,25,36,121,32,14,45,11,161,223,0
231,2495,jRtgy99WPnw21snDCZC48Y86Vr0MWh80,5Gyp41oLVo7Gg7vF4vpmggWP5MU70QO6,5,2,1,0,1,0,2,0,6,0.8571428571428571,1,0.0,0,1,0,1,2,0,0,2,0,2,4,1
232,2505,YjJnZDIbpTQQAvSZDN4eLLymiczln0Oe,5Gyp41oLVo7Gg7vF4vpmggWP5MU70QO6,6,3,1,0,1,0,4,0,9,1.2857142857142858,2,0.0,0,1,0,1,3,0,0,4,0,2,7,1
233,2516,RgSsBQ3nqtDrfLpSobr2YuUHRErLTR4s,5Gyp41oLVo7Gg7vF4vpmggWP5MU70QO6,46,172,101,25,36,6,31,2,373,53.285714285714285,16,0.0,41,101,18,36,131,6,7,31,2,196,177,0
234,2534,ZhTCqX8GMUcn0a0betuEauHNuCk1aRhm,5Gyp41oLVo7Gg7vF4vpmggWP5MU70QO6,95,549,246,175,64,724,222,18,1998,285.42857142857144,30,0.0,177,246,150,64,372,724,25,222,18,637,1361,0
235,2559,HbDaABEakQmE8DQEoFoIphu2SH13rFRy,5Gyp41oLVo7Gg7vF4vpmggWP5MU70QO6,1,0,0,0,0,0,1,0,1,0.14285714285714285,1,0.0,0,0,0,0,0,0,0,1,0,0,1,1
236,2560,oJ9j9ejTgKixczg3tSE8Sg8DPI7YQpJq,5Gyp41oLVo7Gg7vF4vpmggWP5MU70QO6,39,156,87,43,34,23,34,7,384,54.857142857142854,19,0.0,37,87,37,34,119,23,6,34,7,195,189,0
237,2571,RJ1FVW8gXQIpK321uzh2Sh69ojlsqnvg,5Gyp41oLVo7Gg7vF4vpmggWP5MU70QO6,26,121,65,31,13,42,54,11,337,48.142857142857146,11,0.0,23,65,23,13,98,42,8,54,11,124,213,0
238,2577,IAvuP4GGmvnNj3Zisz3jDfo3mSmXiJSb,5Gyp41oLVo7Gg7vF4vpmggWP5MU70QO6,9,13,6,0,5,0,13,1,38,5.428571428571429,5,0.0,2,6,0,5,11,0,0,13,1,13,25,1
239,2600,bPuqI7fU2OAyevO36pU6vztTiLxuvJ4j,5Gyp41oLVo7Gg7vF4vpmggWP5MU70QO6,8,6,4,0,3,0,3,0,16,2.2857142857142856,2,0.0,0,4,0,3,6,0,0,3,0,7,9,1
240,2601,2hMeaUc14fgUG8b3kgXxN1xDYogexPXy,5Gyp41oLVo7Gg7vF4vpmggWP5MU70QO6,46,119,66,8,59,25,33,4,314,44.857142857142854,8,0.0,27,66,4,59,92,25,4,33,4,156,158,0
241,2603,FALCit9nnWsURM3iEkGUle8YXOvnt8ti,5Gyp41oLVo7Gg7vF4vpmggWP5MU70QO6,73,170,58,137,39,5,48,7,464,66.28571428571429,16,0.0,74,58,126,39,96,5,11,48,7,297,167,0
242,2606,hjUSUM6roI2mLGkMAqBjE0uxFRBSMYHJ,5Gyp41oLVo7Gg7vF4vpmggWP5MU70QO6,58,166,83,15,58,23,37,2,384,54.857142857142854,17,0.0,42,83,13,58,124,23,2,37,2,196,188,0
243,2610,4cRZxyVNjv13lU3nu2aK2rwyndExVCGa,5Gyp41oLVo7Gg7vF4vpmggWP5MU70QO6,46,68,30,34,20,0,14,0,166,23.714285714285715,8,0.0,22,30,24,20,46,0,10,14,0,96,70,1
244,2620,KaCDWxCgO010qDxS3HlQF8ZaUvXkCOjA,5Gyp41oLVo7Gg7vF4vpmggWP5MU70QO6,1,0,0,0,0,0,1,0,1,0.14285714285714285,1,0.0,0,0,0,0,0,0,0,1,0,0,1,1
245,2629,dqE1PGrWExsbP4JkEoKdSn4p50FzqbEb,5Gyp41oLVo7Gg7vF4vpmggWP5MU70QO6,14,59,25,2,13,35,33,4,171,24.428571428571427,5,0.0,11,25,2,13,48,35,0,33,4,51,120,1
246,2677,mQ8TrbvVdRK07e6nFL5h5mKREpzb2mbn,5Gyp41oLVo7Gg7vF4vpmggWP5MU70QO6,42,202,22,74,37,13,26,3,377,53.857142857142854,11,0.0,69,22,52,37,133,13,22,26,3,180,197,0
247,2689,vTDXcAyOYpiQ0ogAQ7JOjHcoNexnjoq5,5Gyp41oLVo7Gg7vF4vpmggWP5MU70QO6,1,0,0,0,0,0,1,0,1,0.14285714285714285,1,0.0,0,0,0,0,0,0,0,1,0,0,1,1
248,2692,owHNspB8DrsecsPRNmUB7UBdqXOlW955,5Gyp41oLVo7Gg7vF4vpmggWP5MU70QO6,16,12,8,0,5,3,9,1,38,5.428571428571429,3,0.0,0,8,0,5,12,3,0,9,1,13,25,0
249,2702,jcdJUvdxIg03VTKugjVUNiWSl6LwbiFS,5Gyp41oLVo7Gg7vF4vpmggWP5MU70QO6,42,100,49,29,33,17,21,3,252,36.0,8,0.0,36,49,23,33,64,17,6,21,3,141,111,0
250,2716,TMJz2EoPbsHk1FPWR3St1suTlnbZjyZn,5Gyp41oLVo7Gg7vF4vpmggWP5MU70QO6,15,16,10,12,4,0,3,0,45,6.428571428571429,2,0.0,3,10,10,4,13,0,2,3,0,27,18,0
251,2722,XIgFx2VwwDoVC2upnRyzGHvQjRJmijA1,5Gyp41oLVo7Gg7vF4vpmggWP5MU70QO6,1,0,0,0,0,0,1,0,1,0.14285714285714285,1,0.0,0,0,0,0,0,0,0,1,0,0,1,1
252,2747,HAPPxnLUjIhcauBZnnWBFk3JE6gETTxa,5Gyp41oLVo7Gg7vF4vpmggWP5MU70QO6,49,200,75,0,73,22,43,4,417,59.57142857142857,15,0.0,76,75,0,73,124,22,0,43,4,224,193,0
253,2753,PAlyBxBk6VLwEvpnrgSrO85KSF9PnIju,5Gyp41oLVo7Gg7vF4vpmggWP5MU70QO6,6,6,4,0,0,0,4,0,14,2.0,2,0.0,0,4,0,0,6,0,0,4,0,4,10,1
254,2775,jz1GL9oh8JwqUWgCaMuHQu1SAuzli1lI,5Gyp41oLVo7Gg7vF4vpmggWP5MU70QO6,6,3,1,0,1,0,2,0,7,1.0,1,0.0,0,1,0,1,3,0,0,2,0,2,5,1
255,2794,UD5FqfNicjboiN32GGPYtIcMIUIxLZOX,5Gyp41oLVo7Gg7vF4vpmggWP5MU70QO6,7,3,2,0,2,0,2,0,9,1.2857142857142858,1,0.0,0,2,0,2,3,0,0,2,0,4,5,1
256,2806,Ypjn6lJteU7Qmp6sXmdyBHqzJOAWqbT5,5Gyp41oLVo7Gg7vF4vpmggWP5MU70QO6,6,3,2,0,2,0,1,0,8,1.1428571428571428,1,0.0,0,2,0,2,3,0,0,1,0,4,4,1
257,2814,n4G59XocOCc4qmD9sEVWpzrFOQjZRmCQ,5Gyp41oLVo7Gg7vF4vpmggWP5MU70QO6,8,8,3,0,1,0,5,0,17,2.4285714285714284,1,0.0,1,3,0,1,7,0,0,5,0,5,12,1
258,2817,UEf9mhauGWJ0X68XBH7UwpOQwtQf9rHu,5Gyp41oLVo7Gg7vF4vpmggWP5MU70QO6,1,0,0,0,0,0,1,0,1,0.14285714285714285,1,0.0,0,0,0,0,0,0,0,1,0,0,1,1
259,2829,ipd5zyoOnSKFBbqUTGdeQ2JqK13k0hdA,5Gyp41oLVo7Gg7vF4vpmggWP5MU70QO6,18,33,12,16,2,4,10,2,79,11.285714285714286,3,0.0,14,12,8,2,19,4,8,10,2,36,43,1
260,2843,g3902agYIRHzac78MKVZlvljLMXXNpQ7,5Gyp41oLVo7Gg7vF4vpmggWP5MU70QO6,77,572,272,127,82,31,123,3,1210,172.85714285714286,24,0.0,157,272,111,82,415,31,16,123,3,622,588,0
261,2848,f6XlBSiBlYkzOyVOP1pzxGVC9XyhPDbP,5Gyp41oLVo7Gg7vF4vpmggWP5MU70QO6,1,0,0,0,0,0,1,0,1,0.14285714285714285,1,0.0,0,0,0,0,0,0,0,1,0,0,1,1
262,2856,DMUIuAv3fBvr0tRlOS42Z2GhVKzRRFaD,5Gyp41oLVo7Gg7vF4vpmggWP5MU70QO6,13,9,6,2,2,7,10,0,36,5.142857142857143,1,0.0,1,6,1,2,8,7,1,10,0,10,26,1
263,2865,KrIVcXIiCdwRGUI4WguKXHPsvZChbtIb,5Gyp41oLVo7Gg7vF4vpmggWP5MU70QO6,47,154,86,44,38,153,54,1,530,75.71428571428571,16,0.0,26,86,37,38,128,153,7,54,1,187,343,0
264,2883,2mD1u3b1vLrSJM0DZTrsvLcZVBVwwd27,5Gyp41oLVo7Gg7vF4vpmggWP5MU70QO6,53,121,81,12,60,2,79,1,356,50.857142857142854,23,0.0,29,81,9,60,92,2,3,79,1,179,177,0
265,2894,qQS3O1HMJ50lGdnO1g7QmXa7NMl9N6QM,5Gyp41oLVo7Gg7vF4vpmggWP5MU70QO6,5,2,1,0,1,0,3,0,7,1.0,1,0.0,0,1,0,1,2,0,0,3,0,2,5,0
266,2901,mJAgtJKHxy28GsPIeuAEUCIOXmHzCywF,5Gyp41oLVo7Gg7vF4vpmggWP5MU70QO6,54,350,191,47,85,129,107,5,914,130.57142857142858,23,0.0,81,191,41,85,269,129,6,107,5,398,516,0
267,2909,71ZP7KjXo0yq58HTstdsSNg0mxNnuR8j,5Gyp41oLVo7Gg7vF4vpmggWP5MU70QO6,4,2,0,0,0,0,3,0,5,0.7142857142857143,1,0.0,1,0,0,0,1,0,0,3,0,1,4,1
268,2910,R2cga9JVVM2tXEVs2saYswslfxAU4nMk,5Gyp41oLVo7Gg7vF4vpmggWP5MU70QO6,22,34,14,19,9,6,18,0,100,14.285714285714286,7,0.0,12,14,13,9,22,6,6,18,0,48,52,0
269,2923,0OQWZBG0W4kepi8nreWMZMMypwSc3KLe,5Gyp41oLVo7Gg7vF4vpmggWP5MU70QO6,63,230,114,68,39,121,74,4,650,92.85714285714286,18,0.0,72,114,53,39,158,121,15,74,4,278,372,0
270,2949,zILXfIGJjWXm6dA2MrEQWr2XeEUry8lN,5Gyp41oLVo7Gg7vF4vpmggWP5MU70QO6,26,110,55,17,9,44,37,0,272,38.857142857142854,14,0.0,21,55,14,9,89,44,3,37,0,99,173,0
271,2952,htMjNQEkszQDZ8v3ebxdPo7AiuYpf2pK,5Gyp41oLVo7Gg7vF4vpmggWP5MU70QO6,1,0,0,0,0,0,1,0,1,0.14285714285714285,1,0.0,0,0,0,0,0,0,0,1,0,0,1,1
272,2956,p9fSvL1QHeabgSWvdxgsdZ9twnsNAaXD,5Gyp41oLVo7Gg7vF4vpmggWP5MU70QO6,6,2,1,0,2,0,3,0,8,1.1428571428571428,1,0.0,1,1,0,2,1,0,0,3,0,4,4,1
273,2980,6PLuywzEAD5lv83Yke18fohzcg9K1vR5,5Gyp41oLVo7Gg7vF4vpmggWP5MU70QO6,38,93,49,4,26,34,22,1,229,32.714285714285715,4,0.0,27,49,4,26,66,34,0,22,1,106,123,1
274,3000,xO6Dx5ILltwlO66h9g17SP993fnZ6pHi,5Gyp41oLVo7Gg7vF4vpmggWP5MU70QO6,5,2,1,0,1,0,2,0,6,0.8571428571428571,1,0.0,0,1,0,1,2,0,0,2,0,2,4,1
275,3008,REW5UtvpMNQiskyvZjp6AaiGdPzBLXiY,5Gyp41oLVo7Gg7vF4vpmggWP5MU70QO6,44,127,10,68,15,8,47,9,284,40.57142857142857,10,0.0,47,10,58,15,80,8,10,47,9,130,154,0
276,3020,JDTEn5xJLcPCagcpPFhmwRsZ0N8AbJZ6,5Gyp41oLVo7Gg7vF4vpmggWP5MU70QO6,46,98,54,13,50,4,19,4,242,34.57142857142857,9,0.0,31,54,7,50,67,4,6,19,4,142,100,0
277,3029,RrCkixJREIfn0lQqmAjFjHO0cJoG2cW9,5Gyp41oLVo7Gg7vF4vpmggWP5MU70QO6,28,53,26,37,0,0,10,0,126,18.0,2,0.0,10,26,36,0,43,0,1,10,0,72,54,1
278,3036,af6Z43TpCc7kiut9b72BDJ48EEfhwWh3,5Gyp41oLVo7Gg7vF4vpmggWP5MU70QO6,26,48,24,30,0,0,8,0,110,15.714285714285714,2,0.0,13,24,30,0,35,0,0,8,0,67,43,1
279,3042,XkKS323fFxBVezQ5JyIgzxHDxEKEwwEf,5Gyp41oLVo7Gg7vF4vpmggWP5MU70QO6,47,103,49,32,6,20,37,4,251,35.857142857142854,4,0.0,27,49,29,6,76,20,3,37,4,111,140,1
280,3045,7WKXNJxTOEnqnRzamCaAUVNKwMcfpnEO,5Gyp41oLVo7Gg7vF4vpmggWP5MU70QO6,6,3,2,0,2,0,1,0,8,1.1428571428571428,1,0.0,0,2,0,2,3,0,0,1,0,4,4,1
281,3046,YaP2AuckukEZITP3IVvIt6Z8ci6RHew7,5Gyp41oLVo7Gg7vF4vpmggWP5MU70QO6,20,26,16,0,7,4,8,0,61,8.714285714285714,6,0.0,0,16,0,7,26,4,0,8,0,23,38,1
282,3055,2X7585R8U4bOw8knpAMGoshn3HeMlUXv,5Gyp41oLVo7Gg7vF4vpmggWP5MU70QO6,48,163,67,54,34,6,16,1,341,48.714285714285715,13,0.0,30,67,43,34,133,6,11,16,1,174,167,0
283,3064,Es0ufHExTzrmxAjsHHoEdZ2EBjvO050s,5Gyp41oLVo7Gg7vF4vpmggWP5MU70QO6,21,27,3,4,4,7,7,1,53,7.571428571428571,4,0.0,9,3,3,4,18,7,1,7,1,19,34,1
284,3065,niLMw8MCObO7SSR2V1jNg9WQt5oSjDFJ,5Gyp41oLVo7Gg7vF4vpmggWP5MU70QO6,31,57,39,10,14,3,20,0,143,20.428571428571427,6,0.0,8,39,9,14,49,3,1,20,0,70,73,0
285,3079,tAPBqKHBDdcLvdLNs6CmpzwZNP25c5j3,5Gyp41oLVo7Gg7vF4vpmggWP5MU70QO6,10,6,4,0,1,1,6,1,19,2.7142857142857144,2,0.0,0,4,0,1,6,1,0,6,1,5,14,1
286,3085,LU9kxt8aKnlOn8SnA2EuX2MLajf5Sg2a,5Gyp41oLVo7Gg7vF4vpmggWP5MU70QO6,22,39,3,0,7,0,24,1,74,10.571428571428571,13,0.0,1,3,0,7,38,0,0,24,1,11,63,0
287,3127,tX5rO3NEgwGap375QiX826UZxwo7eG7l,5Gyp41oLVo7Gg7vF4vpmggWP5MU70QO6,1,0,0,0,0,0,1,0,1,0.14285714285714285,1,0.0,0,0,0,0,0,0,0,1,0,0,1,1
288,3140,9uqkwYb5ddQJIw4su6OaF1hwvWEdLp1S,5Gyp41oLVo7Gg7vF4vpmggWP5MU70QO6,42,90,57,0,55,0,11,0,213,30.428571428571427,7,0.0,17,57,0,55,73,0,0,11,0,129,84,0
289,3146,LXkkU0Q9ED3oa1tokPnoPFpATycz64Oo,5Gyp41oLVo7Gg7vF4vpmggWP5MU70QO6,10,5,3,4,2,0,2,0,16,2.2857142857142856,1,0.0,1,3,2,2,4,0,2,2,0,8,8,1
290,3166,OPlk4et0QDh8unILE7N0m7DW2t62ExS3,5Gyp41oLVo7Gg7vF4vpmggWP5MU70QO6,20,49,24,41,4,50,9,2,179,25.571428571428573,6,0.0,16,24,29,4,33,50,12,9,2,73,106,0
291,3185,hwVOqX65HJP61knp4xwbZXR18Hh7HwAV,5Gyp41oLVo7Gg7vF4vpmggWP5MU70QO6,6,1,1,0,1,0,3,0,6,0.8571428571428571,1,0.0,0,1,0,1,1,0,0,3,0,2,4,1
292,3189,Ve30VVfu3WOSJCl56SL7TQHGBM98BQ3E,5Gyp41oLVo7Gg7vF4vpmggWP5MU70QO6,34,67,39,52,2,3,19,0,182,26.0,4,0.0,25,39,46,2,42,3,6,19,0,112,70,0
293,3198,sZW50FIndc0IzSzdKKo2sGFjArizKE5S,5Gyp41oLVo7Gg7vF4vpmggWP5MU70QO6,6,4,2,0,0,0,4,0,10,1.4285714285714286,3,0.0,0,2,0,0,4,0,0,4,0,2,8,0
294,3201,Ms0MC4W5moiGJLWP7iE3FImeH9CHN4KT,5Gyp41oLVo7Gg7vF4vpmggWP5MU70QO6,54,192,102,29,40,220,68,15,666,95.14285714285714,17,0.0,52,102,24,40,140,220,5,68,15,218,448,0
295,3214,UK0wMwBzvN90sgDmKYl9zi5a5BuEJyvZ,5Gyp41oLVo7Gg7vF4vpmggWP5MU70QO6,6,4,2,0,1,0,3,0,10,1.4285714285714286,2,0.0,0,2,0,1,4,0,0,3,0,3,7,1
296,3224,OUbrW18OgibVb4I41eHFiFhkobpgjEP2,5Gyp41oLVo7Gg7vF4vpmggWP5MU70QO6,45,67,32,0,51,0,13,0,163,23.285714285714285,5,0.0,28,32,0,51,39,0,0,13,0,111,52,0
297,3225,7rK7Uy26DYQFFceei5MF7BwFprvKz0Gb,5Gyp41oLVo7Gg7vF4vpmggWP5MU70QO6,6,1,1,0,1,0,3,0,6,0.8571428571428571,1,0.0,0,1,0,1,1,0,0,3,0,2,4,1
298,3231,da3Kt8w4H4PVhwdYyoSXcS80ozIENFOQ,5Gyp41oLVo7Gg7vF4vpmggWP5MU70QO6,43,84,44,46,20,9,36,2,241,34.42857142857143,7,0.0,30,44,34,20,54,9,12,36,2,128,113,1
299,3250,MOJ1BiwMK7lBUiFS9DTwwPvbUWIkdFFP,5Gyp41oLVo7Gg7vF4vpmggWP5MU70QO6,83,412,224,162,71,36,54,2,961,137.28571428571428,19,0.0,106,224,140,71,306,36,22,54,2,541,420,0
300,3264,s6iksgptFmyh2vfiarKdJkiKnp6RLi3f,5Gyp41oLVo7Gg7vF4vpmggWP5MU70QO6,13,47,17,0,6,78,25,2,175,25.0,6,0.0,8,17,0,6,39,78,0,25,2,31,144,0
301,3295,oWOfoMSwxFJkBlwLG8XI3GNMHdlBBaGM,5Gyp41oLVo7Gg7vF4vpmggWP5MU70QO6,44,266,165,21,86,44,56,4,642,91.71428571428571,18,0.0,68,165,17,86,198,44,4,56,4,336,306,0
302,3325,wpCDOX0slOiZnds0I4m6mUJjN54j7NHD,5Gyp41oLVo7Gg7vF4vpmggWP5MU70QO6,10,12,6,0,4,0,4,0,26,3.7142857142857144,3,0.0,3,6,0,4,9,0,0,4,0,13,13,1
303,3326,D4LPr9a0DKiZfUzg8gczdCFrU5mq2QDm,5Gyp41oLVo7Gg7vF4vpmggWP5MU70QO6,60,170,46,69,7,21,68,1,382,54.57142857142857,11,0.0,54,46,62,7,116,21,7,68,1,169,213,0
304,3327,ecpi7DZ71ZRx6H6XAh885uO1l0O5kvOG,5Gyp41oLVo7Gg7vF4vpmggWP5MU70QO6,6,6,3,1,0,0,1,0,11,1.5714285714285714,1,0.0,2,3,1,0,4,0,0,1,0,6,5,0
305,3331,layckrYedWZgFw7etRwkXZmJxZfLSCWL,5Gyp41oLVo7Gg7vF4vpmggWP5MU70QO6,48,190,84,83,24,81,53,3,518,74.0,14,0.0,47,84,70,24,143,81,13,53,3,225,293,0
306,3349,PWtrTBU08HcMIVKmBf17gfZfZrEKBCYw,5Gyp41oLVo7Gg7vF4vpmggWP5MU70QO6,12,9,6,0,3,0,4,0,22,3.142857142857143,2,0.0,0,6,0,3,9,0,0,4,0,9,13,1
307,3351,VXjfCuVPdUNjER0BgKDTzXxTuaTuHQ2o,5Gyp41oLVo7Gg7vF4vpmggWP5MU70QO6,39,107,46,27,20,3,30,1,234,33.42857142857143,8,0.0,37,46,20,20,70,3,7,30,1,123,111,1
308,3352,nlq4r6xc3rTUqTwcYhL6wudXdN6RIE52,5Gyp41oLVo7Gg7vF4vpmggWP5MU70QO6,54,134,80,6,56,0,20,0,296,42.285714285714285,14,0.0,24,80,3,56,110,0,3,20,0,163,133,0
309,3371,pdAqVvKgeCIaihAcxhTXOYjPQxxjaa8K,5Gyp41oLVo7Gg7vF4vpmggWP5MU70QO6,10,8,7,0,0,0,3,0,18,2.5714285714285716,2,0.0,0,7,0,0,8,0,0,3,0,7,11,1
310,3394,1I1Q3JgkX7LID2tw8cHgRGGETfsuXaK0,5Gyp41oLVo7Gg7vF4vpmggWP5MU70QO6,1,0,0,0,0,0,1,0,1,0.14285714285714285,1,0.0,0,0,0,0,0,0,0,1,0,0,1,1
311,3408,xn9XMOUsLFqfdTbtWya5WUWiCxZ2QGu8,5Gyp41oLVo7Gg7vF4vpmggWP5MU70QO6,11,10,4,4,1,21,9,2,51,7.285714285714286,1,0.0,2,4,2,1,8,21,2,9,2,9,42,0
312,3415,7k0pNzVH9lwkASYqqwWy0HckNIMsB4CP,5Gyp41oLVo7Gg7vF4vpmggWP5MU70QO6,42,80,43,67,2,11,41,1,245,35.0,7,0.0,32,43,53,2,48,11,14,41,1,130,115,0
313,3416,j1jdy8OF5VQw4rqSYOkbK2pQplvvvz37,5Gyp41oLVo7Gg7vF4vpmggWP5MU70QO6,71,283,141,72,72,65,80,12,725,103.57142857142857,20,0.0,81,141,57,72,202,65,15,80,12,351,374,0
314,3425,nZHDVGR2taFZ428UJIwMv53Rp94HbGnD,5Gyp41oLVo7Gg7vF4vpmggWP5MU70QO6,1,0,0,0,0,0,1,0,1,0.14285714285714285,1,0.0,0,0,0,0,0,0,0,1,0,0,1,1
315,3446,CS2NxxkxYN2gdGmgVH4QBWlYCL6CBUo7,5Gyp41oLVo7Gg7vF4vpmggWP5MU70QO6,16,19,8,14,3,3,4,0,51,7.285714285714286,1,0.0,8,8,7,3,11,3,7,4,0,26,25,1
316,3451,jD3UOYibaPKSzUrDAsr0OejITusd7VrV,5Gyp41oLVo7Gg7vF4vpmggWP5MU70QO6,2,0,0,0,0,0,2,0,2,0.2857142857142857,1,0.0,0,0,0,0,0,0,0,2,0,0,2,1
317,3461,GEB7lnRATVntgooFsQX8a3NQzClZLP1N,5Gyp41oLVo7Gg7vF4vpmggWP5MU70QO6,8,6,3,0,2,0,3,0,14,2.0,2,0.0,1,3,0,2,5,0,0,3,0,6,8,1
318,3469,zeUi2UnQZPPF6bRQXw2s8LZ41ZOdqRAa,5Gyp41oLVo7Gg7vF4vpmggWP5MU70QO6,5,4,2,0,0,24,5,0,35,5.0,3,0.0,0,2,0,0,4,24,0,5,0,2,33,1
319,3482,9zJGVvMDoimbmO5jrwImOVZINPfOiYqF,5Gyp41oLVo7Gg7vF4vpmggWP5MU70QO6,2,0,0,0,0,0,2,0,2,0.2857142857142857,1,0.0,0,0,0,0,0,0,0,2,0,0,2,1
320,3501,ehQsBJH6Sh0Hb1yGwhBgVwobig6KyUlg,5Gyp41oLVo7Gg7vF4vpmggWP5MU70QO6,63,240,122,30,44,185,85,3,709,101.28571428571429,12,0.0,66,122,23,44,174,185,7,85,3,255,454,0
321,3512,egu9R2zi3bUYOErhkCesp0oMig9lwpnh,5Gyp41oLVo7Gg7vF4vpmggWP5MU70QO6,33,63,31,81,1,4,12,0,192,27.428571428571427,4,0.0,25,31,67,1,38,4,14,12,0,124,68,1
322,3520,GoCzFgZtKHP9v4b0WP4lIjCorcS7Jt3F,5Gyp41oLVo7Gg7vF4vpmggWP5MU70QO6,7,6,3,0,2,0,3,0,14,2.0,3,0.0,0,3,0,2,6,0,0,3,0,5,9,1
323,3524,H12UkRTeuK8PiRUUsA27x5ar53xuK6n8,5Gyp41oLVo7Gg7vF4vpmggWP5MU70QO6,1,0,0,0,0,0,2,0,2,0.2857142857142857,2,0.0,0,0,0,0,0,0,0,2,0,0,2,1
324,3529,CmIaRR2qgpGVOUIbsTC8R6ZChGQweVzS,5Gyp41oLVo7Gg7vF4vpmggWP5MU70QO6,37,92,48,17,10,34,12,0,213,30.428571428571427,8,0.0,14,48,12,10,78,34,5,12,0,84,129,0
325,3539,uVKRpb0wpcO3OMHZp7JeDIDcxBS5RLcM,5Gyp41oLVo7Gg7vF4vpmggWP5MU70QO6,8,6,3,0,2,0,2,0,13,1.8571428571428572,1,0.0,1,3,0,2,5,0,0,2,0,6,7,1
326,3545,jSPjvvcGEGdnkGRTlhr1w4P4dzPL1W95,5Gyp41oLVo7Gg7vF4vpmggWP5MU70QO6,2,0,0,0,0,0,2,0,2,0.2857142857142857,1,0.0,0,0,0,0,0,0,0,2,0,0,2,1
327,3568,j3hbCNcvLarbvZL0w1bgZayyaRyrLQTj,5Gyp41oLVo7Gg7vF4vpmggWP5MU70QO6,8,7,4,2,1,0,2,0,16,2.2857142857142856,1,0.0,1,4,1,1,6,0,1,2,0,7,9,0
328,3569,3nIiTMbxCDiSlQaRR62YaLBBApxBbHsO,5Gyp41oLVo7Gg7vF4vpmggWP5MU70QO6,1,0,0,0,0,0,1,0,1,0.14285714285714285,1,0.0,0,0,0,0,0,0,0,1,0,0,1,1
329,3575,kvoUslzLG0mKlFKuSPgqASK2op5HSx76,5Gyp41oLVo7Gg7vF4vpmggWP5MU70QO6,13,43,21,0,11,2,14,5,96,13.714285714285714,4,0.0,2,21,0,11,41,2,0,14,5,34,62,0
330,3595,IzX1R0Q45PClKcuxYHyIKKmFuFt93Lx2,5Gyp41oLVo7Gg7vF4vpmggWP5MU70QO6,44,200,80,52,11,14,63,1,421,60.142857142857146,20,0.0,41,80,37,11,159,14,15,63,1,169,252,0
331,3613,FqIQ1li3eim3G1b9mwuqVSaOci5g4Yx0,5Gyp41oLVo7Gg7vF4vpmggWP5MU70QO6,6,7,5,0,0,0,5,0,17,2.4285714285714284,1,0.0,1,5,0,0,6,0,0,5,0,6,11,0
332,3644,9e5dcfJQbPUU8sTcmzE9DWoDPOA9Nhu3,5Gyp41oLVo7Gg7vF4vpmggWP5MU70QO6,19,40,15,17,3,0,6,0,81,11.571428571428571,2,0.0,5,15,16,3,35,0,1,6,0,39,42,1
333,3647,AFUJTbEqqgSsqCkUsNrjbPAjZvFwpzeW,5Gyp41oLVo7Gg7vF4vpmggWP5MU70QO6,88,240,88,109,65,13,36,0,551,78.71428571428571,16,0.0,65,88,90,65,175,13,19,36,0,308,243,0
334,3652,eq1oOsePtvDHcr5VwwIpagivS72utAhr,5Gyp41oLVo7Gg7vF4vpmggWP5MU70QO6,49,131,7,21,39,4,20,0,222,31.714285714285715,14,0.0,33,7,14,39,98,4,7,20,0,93,129,1
335,3658,86t1iR0NT9tOoJvgV2BHlNDh2I7ZFriX,5Gyp41oLVo7Gg7vF4vpmggWP5MU70QO6,1,0,0,0,0,0,2,0,2,0.2857142857142857,1,0.0,0,0,0,0,0,0,0,2,0,0,2,1
336,3716,ZSKBKnD8wfegggUigWIwrMo7a1rGr9YG,5Gyp41oLVo7Gg7vF4vpmggWP5MU70QO6,17,26,13,2,5,1,13,1,61,8.714285714285714,5,0.0,2,13,1,5,24,1,1,13,1,21,40,1
337,3724,nglaToodcU5Q8FzrMWGY4MUCnpZFGaF5,5Gyp41oLVo7Gg7vF4vpmggWP5MU70QO6,8,8,5,0,3,0,4,0,20,2.857142857142857,2,0.0,0,5,0,3,8,0,0,4,0,8,12,1
338,3727,2fI4wWrvurl3ODzFoF1kViu5y8Lc1NgZ,5Gyp41oLVo7Gg7vF4vpmggWP5MU70QO6,35,125,56,39,20,63,29,3,335,47.857142857142854,12,0.0,21,56,31,20,104,63,8,29,3,128,207,0
339,3737,uj6NI1xikJKmYtrSvOvp2gjQGnklt0N8,5Gyp41oLVo7Gg7vF4vpmggWP5MU70QO6,36,71,44,8,17,0,21,0,161,23.0,11,0.0,3,44,5,17,68,0,3,21,0,69,92,0
340,3757,CXT3urKvwCIfBmuQmODRcZXAAAJs07Dk,5Gyp41oLVo7Gg7vF4vpmggWP5MU70QO6,3,0,0,0,0,0,3,0,3,0.42857142857142855,1,0.0,0,0,0,0,0,0,0,3,0,0,3,1
341,3784,X8qfNjsHrwR5R67KkU9t7FXc6jQSGsyo,5Gyp41oLVo7Gg7vF4vpmggWP5MU70QO6,35,140,62,17,41,58,45,3,366,52.285714285714285,10,0.0,54,62,11,41,86,58,6,45,3,168,198,0
342,3785,ts7gxS52MJ8xeq4ZgoYDEEVK8tqcrK43,5Gyp41oLVo7Gg7vF4vpmggWP5MU70QO6,36,97,51,37,16,15,19,1,236,33.714285714285715,9,0.0,16,51,22,16,81,15,15,19,1,105,131,0
343,3802,CE0RG1R9BsnYR68sZcEdfpQ3RBoQAI8l,5Gyp41oLVo7Gg7vF4vpmggWP5MU70QO6,11,17,6,6,2,8,2,0,41,5.857142857142857,1,0.0,8,6,3,2,9,8,3,2,0,19,22,1
344,3833,sApH95kwlTdIi3RvuRD74A0dFhVPKais,5Gyp41oLVo7Gg7vF4vpmggWP5MU70QO6,23,30,26,0,13,2,6,1,78,11.142857142857142,5,0.0,0,26,0,13,30,2,0,6,1,39,39,1
345,3838,vlHmtLHxbw7S6zxC5oHlY3I9JCi1BY6K,5Gyp41oLVo7Gg7vF4vpmggWP5MU70QO6,11,7,4,0,3,0,6,0,20,2.857142857142857,1,0.0,0,4,0,3,7,0,0,6,0,7,13,1
346,3848,Aw4IDXePUvZHJziRsaCOUg8dgwu5BZXP,5Gyp41oLVo7Gg7vF4vpmggWP5MU70QO6,4,2,1,0,0,0,2,0,5,0.7142857142857143,1,0.0,0,1,0,0,2,0,0,2,0,1,4,1
347,3851,38HaiNGogMQZ7XFJyXto2il2akhOzypw,5Gyp41oLVo7Gg7vF4vpmggWP5MU70QO6,40,93,49,30,23,43,19,1,258,36.857142857142854,14,0.0,16,49,24,23,77,43,6,19,1,112,146,0
348,3876,Vy4WRiZ6wqh3K0MhM76WnkqAwo2EzenE,5Gyp41oLVo7Gg7vF4vpmggWP5MU70QO6,1,0,0,0,0,0,1,0,1,0.14285714285714285,1,0.0,0,0,0,0,0,0,0,1,0,0,1,0
349,3904,SZ1Dps7XHlF6LX8F5UjfRiNZqGOPfABK,5Gyp41oLVo7Gg7vF4vpmggWP5MU70QO6,1,0,0,0,0,0,1,0,1,0.14285714285714285,1,0.0,0,0,0,0,0,0,0,1,0,0,1,1
350,3912,VKDNE86ItuOpp2oVHDMGR3EPQG95zuXs,5Gyp41oLVo7Gg7vF4vpmggWP5MU70QO6,35,80,42,27,21,0,28,0,198,28.285714285714285,9,0.0,18,42,19,21,62,0,8,28,0,100,98,0
351,3913,CeHkW43YFk9n9jgYvcA4TSUcxZb4rdJe,5Gyp41oLVo7Gg7vF4vpmggWP5MU70QO6,7,3,2,0,2,0,3,0,10,1.4285714285714286,1,0.0,0,2,0,2,3,0,0,3,0,4,6,1
352,3914,n6BphJhAHOGzVmyCEt3aewV8nmcl7E7b,5Gyp41oLVo7Gg7vF4vpmggWP5MU70QO6,7,5,3,0,1,0,3,0,12,1.7142857142857142,1,0.0,0,3,0,1,5,0,0,3,0,4,8,1
353,3924,L50CznUPZXrrizGMyYwcQayFKBMeZJLf,5Gyp41oLVo7Gg7vF4vpmggWP5MU70QO6,8,7,4,0,2,0,3,0,16,2.2857142857142856,3,0.0,0,4,0,2,7,0,0,3,0,6,10,1
354,3929,GxWg4h8gAiKctUf8VxaJMnstU2gEPNkZ,5Gyp41oLVo7Gg7vF4vpmggWP5MU70QO6,31,58,28,32,7,0,7,0,132,18.857142857142858,4,0.0,11,28,26,7,47,0,6,7,0,72,60,0
355,3934,htua1xywlnpsMMY7EJSOsurL86GI912X,5Gyp41oLVo7Gg7vF4vpmggWP5MU70QO6,26,69,38,25,13,0,26,1,172,24.571428571428573,10,0.0,16,38,14,13,53,0,11,26,1,81,91,0
356,3936,4w65IJuU7aRi28m7eaz5o1EHevqyF6Ws,5Gyp41oLVo7Gg7vF4vpmggWP5MU70QO6,25,61,27,28,13,0,15,0,144,20.571428571428573,13,0.0,14,27,18,13,47,0,10,15,0,72,72,0
357,3940,SHmlUgNk9MPVdcZ7Cn8s2iFXGP9J6KWU,5Gyp41oLVo7Gg7vF4vpmggWP5MU70QO6,5,2,1,0,1,0,2,0,6,0.8571428571428571,1,0.0,0,1,0,1,2,0,0,2,0,2,4,1
358,3952,eXEITuHYjhxsbm5B6dP5cReIRssXuhPy,5Gyp41oLVo7Gg7vF4vpmggWP5MU70QO6,9,7,4,0,1,0,5,0,17,2.4285714285714284,3,0.0,0,4,0,1,7,0,0,5,0,5,12,1
359,3967,vcbB1O65ViiZQm6jlzGN6W2EH2EmJjQK,5Gyp41oLVo7Gg7vF4vpmggWP5MU70QO6,47,100,65,26,25,46,18,1,281,40.142857142857146,10,0.0,17,65,18,25,83,46,8,18,1,125,156,1
360,3975,rwZPkNP5jbYPX691iPVLQRdGmrqAlsLH,5Gyp41oLVo7Gg7vF4vpmggWP5MU70QO6,1,0,0,0,0,0,1,0,1,0.14285714285714285,1,0.0,0,0,0,0,0,0,0,1,0,0,1,1
361,3982,Dw289XdbVPARtBCp3XyIbEXKo6sChudi,fbPkOYLVPtPgIt0MxizjfFJov3JbHyAi,12,15,5,5,5,8,7,1,46,6.571428571428571,1,0.0,5,5,4,5,10,8,1,7,1,19,27,1
362,3986,lri3Bm6mGdJ1wEpJO4c8fcTdLtxpvXa6,fbPkOYLVPtPgIt0MxizjfFJov3JbHyAi,46,143,46,46,23,58,37,1,354,50.57142857142857,7,0.0,44,46,43,23,99,58,3,37,1,156,198,0
363,3987,RvRsXzYULX8CJPXHa5mzL8AcNhscf6wx,fbPkOYLVPtPgIt0MxizjfFJov3JbHyAi,8,15,8,0,5,13,8,0,49,7.0,3,0.0,1,8,0,5,14,13,0,8,0,14,35,1
364,3988,n6g50uYKXPDZP0tI3HvDI3sQlgkEYQ9t,fbPkOYLVPtPgIt0MxizjfFJov3JbHyAi,2,0,0,0,0,0,5,0,5,0.7142857142857143,1,0.0,0,0,0,0,0,0,0,5,0,0,5,1
365,3989,WQvAdilRxsksKqQWzKEILUwddYnT927z,fbPkOYLVPtPgIt0MxizjfFJov3JbHyAi,8,19,7,0,5,4,11,0,46,6.571428571428571,3,0.0,0,7,0,5,19,4,0,11,0,12,34,1
366,3990,IjNUKB7dvHimeVQdJPcMV9GHh8X3ACi4,fbPkOYLVPtPgIt0MxizjfFJov3JbHyAi,9,3,2,0,2,0,7,1,15,2.142857142857143,1,0.0,0,2,0,2,3,0,0,7,1,4,11,1
367,3991,affppoxqvCZhtMd3A1khAMJ6PTtvZhf9,fbPkOYLVPtPgIt0MxizjfFJov3JbHyAi,34,82,33,17,30,91,20,10,283,40.42857142857143,6,0.0,36,33,14,30,46,91,3,20,10,113,170,1
368,3992,uzWBIpHNnLP0Ck2jFJb3dlQmKW50Edgg,fbPkOYLVPtPgIt0MxizjfFJov3JbHyAi,9,7,4,0,3,0,12,0,26,3.7142857142857144,1,0.0,0,4,0,3,7,0,0,12,0,7,19,1
369,3993,LBiRwhykvYlkPokFukwKE3pfXRl4e4Nw,fbPkOYLVPtPgIt0MxizjfFJov3JbHyAi,10,50,30,0,12,1,17,1,111,15.857142857142858,6,0.0,3,30,0,12,47,1,0,17,1,45,66,1
370,3994,CAJTHZgER1cUEaMoS6UrUkuHNZZbsU9M,fbPkOYLVPtPgIt0MxizjfFJov3JbHyAi,43,63,27,45,23,23,10,2,193,27.571428571428573,4,0.0,27,27,35,23,36,23,10,10,2,112,81,1
371,3995,TYu8VgV6TkJO1pWVABdfXnpa6VWQUK0O,fbPkOYLVPtPgIt0MxizjfFJov3JbHyAi,11,15,6,3,9,1,7,1,42,6.0,3,0.0,8,6,3,9,7,1,0,7,1,26,16,1
372,3999,4IkxYjTflPhoHxhEdrFyf3T4ZXNMTaKd,fbPkOYLVPtPgIt0MxizjfFJov3JbHyAi,59,222,76,40,26,34,39,0,437,62.42857142857143,12,0.0,55,76,37,26,167,34,3,39,0,194,243,0
373,4000,A8rz0vMThAU17OyS7TiHPCSZ088mScoQ,fbPkOYLVPtPgIt0MxizjfFJov3JbHyAi,12,18,10,0,6,0,6,0,40,5.714285714285714,2,0.0,3,10,0,6,15,0,0,6,0,19,21,1
374,4001,NKzNFHK6LaJqjMec69ZX5HfBigF4yyJV,fbPkOYLVPtPgIt0MxizjfFJov3JbHyAi,21,45,4,14,2,48,14,1,128,18.285714285714285,4,0.0,9,4,12,2,36,48,2,14,1,27,101,1
375,4002,MoOt0pLc6LPrRtSRaIbD7yJ5rRpkSxQh,fbPkOYLVPtPgIt0MxizjfFJov3JbHyAi,9,9,3,0,5,10,7,2,36,5.142857142857143,1,0.0,5,3,0,5,4,10,0,7,2,13,23,1
376,4003,DgaifwdXOeOWB23pZZjNIgSww1uVv3vI,fbPkOYLVPtPgIt0MxizjfFJov3JbHyAi,6,5,2,0,1,0,9,0,17,2.4285714285714284,1,0.0,0,2,0,1,5,0,0,9,0,3,14,1
377,4005,HAPPxnLUjIhcauBZnnWBFk3JE6gETTxa,fbPkOYLVPtPgIt0MxizjfFJov3JbHyAi,8,5,3,0,2,0,4,0,14,2.0,2,0.0,0,3,0,2,5,0,0,4,0,5,9,0
378,4006,McVFksjsd7gqjfpNdRYswxB6Ly7zMDUI,fbPkOYLVPtPgIt0MxizjfFJov3JbHyAi,11,26,11,22,7,24,23,1,114,16.285714285714285,2,0.0,9,11,13,7,17,24,9,23,1,40,74,1
379,4010,tCXUYAVw455MAJWBfBlKD9PaArTnum6K,fbPkOYLVPtPgIt0MxizjfFJov3JbHyAi,5,2,1,0,1,0,3,0,7,1.0,1,0.0,0,1,0,1,2,0,0,3,0,2,5,1
380,4013,mDG9Rxl75Wy9jJLHldZXeLQnqCWbJnNh,fbPkOYLVPtPgIt0MxizjfFJov3JbHyAi,9,10,6,0,4,0,7,0,27,3.857142857142857,1,0.0,0,6,0,4,10,0,0,7,0,10,17,1
381,4014,cDTJe7mzABgZuuhVrbXbLDlWeF860dTW,fbPkOYLVPtPgIt0MxizjfFJov3JbHyAi,5,4,2,0,1,2,2,0,11,1.5714285714285714,1,0.0,0,2,0,1,4,2,0,2,0,3,8,1
382,4015,Sqb9rCT9CzMY8ZiGPrmmTQHW8dIqJZBT,fbPkOYLVPtPgIt0MxizjfFJov3JbHyAi,1,0,0,0,0,0,1,0,1,0.14285714285714285,1,0.0,0,0,0,0,0,0,0,1,0,0,1,1
383,4016,0OQWZBG0W4kepi8nreWMZMMypwSc3KLe,fbPkOYLVPtPgIt0MxizjfFJov3JbHyAi,30,102,62,16,24,67,28,2,301,43.0,11,0.0,24,62,14,24,78,67,2,28,2,124,177,0
384,4017,R0BF3k8rl0hN1Xjq59ZjmegVjqcKX9oA,fbPkOYLVPtPgIt0MxizjfFJov3JbHyAi,12,25,8,9,3,6,4,0,55,7.857142857142857,4,0.0,6,8,7,3,19,6,2,4,0,24,31,1
385,4018,PueCTOZid1NIenGrGQNvEExDupERGR94,fbPkOYLVPtPgIt0MxizjfFJov3JbHyAi,6,15,2,0,0,21,5,0,43,6.142857142857143,3,0.0,1,2,0,0,14,21,0,5,0,3,40,1
386,4019,dFrBZuKOTxv7Ek84BAuACScgZVHLiPRz,fbPkOYLVPtPgIt0MxizjfFJov3JbHyAi,27,89,50,15,30,40,17,1,242,34.57142857142857,6,0.0,18,50,12,30,71,40,3,17,1,110,132,0
387,4021,2txyeJeVHewFPGKztIs7LVNsRtu62SIj,fbPkOYLVPtPgIt0MxizjfFJov3JbHyAi,15,29,19,16,13,0,10,0,87,12.428571428571429,6,0.0,4,19,14,13,25,0,2,10,0,50,37,0
388,4022,CNy8nHnus6ReY45d9zqNv8rRJDfMythS,fbPkOYLVPtPgIt0MxizjfFJov3JbHyAi,10,11,5,0,5,0,5,0,26,3.7142857142857144,2,0.0,2,5,0,5,9,0,0,5,0,12,14,1
389,4024,UInMBEH8f1h2vxXVslRsWyLOTv8ggYq3,fbPkOYLVPtPgIt0MxizjfFJov3JbHyAi,62,214,105,20,59,290,42,4,734,104.85714285714286,14,0.0,47,105,15,59,167,290,5,42,4,226,508,0
390,4025,0XUEmNa1QlvbJ6h0wBm0Vh8YELQW58i8,fbPkOYLVPtPgIt0MxizjfFJov3JbHyAi,2,0,0,0,0,0,3,0,3,0.42857142857142855,1,0.0,0,0,0,0,0,0,0,3,0,0,3,1
391,4026,OMzzJICpXQ12vN2QhxiLmWbQhc59H2Je,fbPkOYLVPtPgIt0MxizjfFJov3JbHyAi,19,30,13,0,10,118,13,0,184,26.285714285714285,3,0.0,8,13,0,10,22,118,0,13,0,31,153,1
392,4028,BJaK31XM4DCMgldXltRIhwlSVt79ImvN,fbPkOYLVPtPgIt0MxizjfFJov3JbHyAi,1,0,0,0,0,0,2,0,2,0.2857142857142857,2,0.0,0,0,0,0,0,0,0,2,0,0,2,1
393,4029,Wkp6iolUyaZoJ05flcS8uKmcM1K0sTAZ,fbPkOYLVPtPgIt0MxizjfFJov3JbHyAi,6,7,4,0,2,1,3,0,17,2.4285714285714284,1,0.0,0,4,0,2,7,1,0,3,0,6,11,1
394,4030,qdFvSvAu7YEiiOuRfROhUegKEcAw8WjI,fbPkOYLVPtPgIt0MxizjfFJov3JbHyAi,9,7,3,0,3,0,5,0,18,2.5714285714285716,2,0.0,0,3,0,3,7,0,0,5,0,6,12,1
395,4031,l5LfU8gApOG72AnBkdAbfOLQLwFH7Zo2,fbPkOYLVPtPgIt0MxizjfFJov3JbHyAi,18,39,6,9,3,13,12,0,82,11.714285714285714,8,0.0,5,6,7,3,34,13,2,12,0,21,61,0
396,4035,YJ5mxpUsuGnox6GEy3E35b75l1Yuk6TC,fbPkOYLVPtPgIt0MxizjfFJov3JbHyAi,1,0,0,0,0,0,1,0,1,0.14285714285714285,1,0.0,0,0,0,0,0,0,0,1,0,0,1,1
397,4036,Y75HPUfsmJFX2l4CIc47CvtaKqz7eTTH,fbPkOYLVPtPgIt0MxizjfFJov3JbHyAi,5,2,1,0,1,0,2,0,6,0.8571428571428571,1,0.0,0,1,0,1,2,0,0,2,0,2,4,1
398,4039,nPGsjt6sk2qCL2FY7YNDGlVui96j8qhd,fbPkOYLVPtPgIt0MxizjfFJov3JbHyAi,24,22,10,14,11,0,7,0,64,9.142857142857142,2,0.0,10,10,13,11,12,0,1,7,0,44,20,0
399,4040,tmmvczbZLiPw6t5Ru9DTWRYnvMI3hKxN,fbPkOYLVPtPgIt0MxizjfFJov3JbHyAi,7,30,12,0,7,5,10,1,65,9.285714285714286,3,0.0,0,12,0,7,30,5,0,10,1,19,46,1
400,4042,03I1lWZt67ECKkJOIVeqAmBCKjZopH4v,fbPkOYLVPtPgIt0MxizjfFJov3JbHyAi,15,26,15,7,9,11,13,0,81,11.571428571428571,8,0.0,4,15,5,9,22,11,2,13,0,33,48,1
401,4044,dQeQGMqD2AfjLt9WMqT1wjR4i8srmTVY,fbPkOYLVPtPgIt0MxizjfFJov3JbHyAi,7,6,4,0,3,0,2,0,15,2.142857142857143,2,0.0,0,4,0,3,6,0,0,2,0,7,8,1
402,4046,FUyt82uYcKeXe5a1uDqi5Za4PXy0kx7h,fbPkOYLVPtPgIt0MxizjfFJov3JbHyAi,9,8,2,3,4,0,6,0,23,3.2857142857142856,1,0.0,5,2,2,4,3,0,1,6,0,13,10,1
403,4048,pWZNevyPOl4ouTcnYPIT4PYWT7cW7Aq7,fbPkOYLVPtPgIt0MxizjfFJov3JbHyAi,12,29,13,1,11,7,9,1,71,10.142857142857142,4,0.0,10,13,1,11,19,7,0,9,1,35,36,1
404,4052,e1CSwKLgflGiW7QjzYRNEoHjbDEH3F2k,fbPkOYLVPtPgIt0MxizjfFJov3JbHyAi,6,9,0,0,0,0,4,1,14,2.0,3,0.0,0,0,0,0,9,0,0,4,1,0,14,1
405,4054,hOv5RKQK1RGRxpJJGcW0k2cA3RwQ8Rk5,fbPkOYLVPtPgIt0MxizjfFJov3JbHyAi,13,30,12,5,8,22,12,0,89,12.714285714285714,4,0.0,9,12,4,8,21,22,1,12,0,33,56,1
406,4056,jcyuD7rFE4XO7CpWU6qjqHSzjWdDLgUn,fbPkOYLVPtPgIt0MxizjfFJov3JbHyAi,12,19,9,4,6,7,13,0,58,8.285714285714286,2,0.0,7,9,3,6,12,7,1,13,0,25,33,1
407,4060,vag0mKRhWPXqyPdrs8UzxFb02sZFFg3Z,fbPkOYLVPtPgIt0MxizjfFJov3JbHyAi,6,1,1,0,1,1,3,1,8,1.1428571428571428,1,0.0,0,1,0,1,1,1,0,3,1,2,6,1
408,4061,A7tHWOZtAjCVDU6Pkr6MtHjmqydOP5Uv,fbPkOYLVPtPgIt0MxizjfFJov3JbHyAi,8,5,3,0,2,0,2,0,12,1.7142857142857142,1,0.0,1,3,0,2,4,0,0,2,0,6,6,1
409,4062,GfQva8AQrZlwGbvyDGDInKzkvq0dln6l,fbPkOYLVPtPgIt0MxizjfFJov3JbHyAi,12,21,11,0,9,0,6,0,47,6.714285714285714,3,0.0,4,11,0,9,17,0,0,6,0,24,23,1
410,4064,IhporhjBpD87E7pLhYtc9YRC8PipZyt6,fbPkOYLVPtPgIt0MxizjfFJov3JbHyAi,21,58,35,3,19,15,34,4,168,24.0,8,0.0,6,35,3,19,52,15,0,34,4,63,105,1
411,4065,6khySUugasTypUZbIissXWV1lXFT1d5n,fbPkOYLVPtPgIt0MxizjfFJov3JbHyAi,8,5,3,0,2,8,8,1,27,3.857142857142857,1,0.0,0,3,0,2,5,8,0,8,1,5,22,1
412,4066,0m3zP8nDyi6TxYSAa3KOP4WzeZItFG3V,fbPkOYLVPtPgIt0MxizjfFJov3JbHyAi,5,2,1,0,1,0,11,0,15,2.142857142857143,1,0.0,0,1,0,1,2,0,0,11,0,2,13,1
413,4070,bUizg9a7xaQ9xo39EDPwubco3asipi0e,fbPkOYLVPtPgIt0MxizjfFJov3JbHyAi,45,40,33,0,22,7,15,2,119,17.0,7,0.0,0,33,0,22,40,7,0,15,2,55,64,1
414,4071,HH3HV5HDJ35z2ldQAEIDXBOSBTxLd6O9,fbPkOYLVPtPgIt0MxizjfFJov3JbHyAi,24,40,27,12,11,24,17,0,131,18.714285714285715,7,0.0,4,27,10,11,36,24,2,17,0,52,79,1
415,4072,kHp5QZURLzbWn4koqFYZnQmO0kliz5hb,fbPkOYLVPtPgIt0MxizjfFJov3JbHyAi,51,80,45,27,21,33,19,1,226,32.285714285714285,10,0.0,17,45,24,21,63,33,3,19,1,107,119,0
416,4077,reYWWuBxz5Nnxq3jAGjfGe1NyMEEto5R,fbPkOYLVPtPgIt0MxizjfFJov3JbHyAi,27,62,20,12,22,47,37,31,231,33.0,6,0.0,31,20,11,22,31,47,1,37,31,84,147,1
417,4081,GXuacM1G2BzxiXouSVLnDv1V97NGwCCe,fbPkOYLVPtPgIt0MxizjfFJov3JbHyAi,10,17,8,0,3,0,9,1,38,5.428571428571429,2,0.0,0,8,0,3,17,0,0,9,1,11,27,1
418,4083,5tD3trtPQ6jzqFRimP1PMPhgvFtRmfA4,fbPkOYLVPtPgIt0MxizjfFJov3JbHyAi,14,64,7,5,6,6,13,1,102,14.571428571428571,6,0.0,10,7,4,6,54,6,1,13,1,27,75,1
419,4084,a4RYqILKcnu8c617gYSbD0KQIm9DqZnc,fbPkOYLVPtPgIt0MxizjfFJov3JbHyAi,4,6,0,0,0,0,2,0,8,1.1428571428571428,2,0.0,0,0,0,0,6,0,0,2,0,0,8,1
420,4088,czTQ5ELSy91Dy79vk5MgxZdL9nunJtpb,fbPkOYLVPtPgIt0MxizjfFJov3JbHyAi,4,3,0,0,0,0,7,0,10,1.4285714285714286,1,0.0,0,0,0,0,3,0,0,7,0,0,10,1
421,4090,1nooHXMbJhGPsGTrHpT4esI4WCkiFA2H,fbPkOYLVPtPgIt0MxizjfFJov3JbHyAi,8,8,5,0,3,0,6,0,22,3.142857142857143,1,0.0,0,5,0,3,8,0,0,6,0,8,14,1
422,4091,BbZEGv8zMCuD8c0LXrenf9W1lGSlVd04,fbPkOYLVPtPgIt0MxizjfFJov3JbHyAi,18,22,9,8,10,0,3,0,52,7.428571428571429,2,0.0,4,9,5,10,18,0,3,3,0,28,24,1
423,4093,zLfLf7Y2Kf0HyKtBcK0c943FFMXMBiGO,fbPkOYLVPtPgIt0MxizjfFJov3JbHyAi,12,23,7,0,6,7,4,0,47,6.714285714285714,2,0.0,3,7,0,6,20,7,0,4,0,16,31,1
424,4095,ijFjDmHOLiyu54Ko0v4roRDWdDCIX5i1,fbPkOYLVPtPgIt0MxizjfFJov3JbHyAi,66,153,89,40,57,27,30,1,397,56.714285714285715,20,0.0,25,89,36,57,128,27,4,30,1,207,190,0
425,4097,CVQI4y90zNEQKnbziqeit6sPoxhPlPMP,fbPkOYLVPtPgIt0MxizjfFJov3JbHyAi,7,2,1,0,1,0,3,0,7,1.0,1,0.0,0,1,0,1,2,0,0,3,0,2,5,1
426,4101,pWkLIEFKVWp1dpRpiw46ybvs7QZ4nDA4,fbPkOYLVPtPgIt0MxizjfFJov3JbHyAi,7,5,2,0,0,0,7,0,14,2.0,2,0.0,0,2,0,0,5,0,0,7,0,2,12,1
427,4103,Y1ppxEgbx61jNTLCoOABIFXnW04QUYST,fbPkOYLVPtPgIt0MxizjfFJov3JbHyAi,7,3,2,0,2,0,4,0,11,1.5714285714285714,1,0.0,0,2,0,2,3,0,0,4,0,4,7,1
428,4105,VJ15PTmNAjfB6ipRCoKMs7aSjJuraSNv,fbPkOYLVPtPgIt0MxizjfFJov3JbHyAi,39,97,37,28,14,46,17,1,240,34.285714285714285,10,0.0,18,37,25,14,79,46,3,17,1,94,146,1
429,4106,TMVzoCHYEzB4dA3dJFO0jufgXr0xWoMt,fbPkOYLVPtPgIt0MxizjfFJov3JbHyAi,6,7,1,0,1,0,2,0,11,1.5714285714285714,1,0.0,3,1,0,1,4,0,0,2,0,5,6,1
430,4108,ILcXhWva6fUJAzRZSl16N8h2AK8Jjf9I,fbPkOYLVPtPgIt0MxizjfFJov3JbHyAi,7,8,2,0,2,0,3,0,15,2.142857142857143,1,0.0,0,2,0,2,8,0,0,3,0,4,11,1
431,4111,blTEANBNlwleHMZh60k5xSk9rNOJZKek,fbPkOYLVPtPgIt0MxizjfFJov3JbHyAi,2,0,0,0,0,0,6,0,6,0.8571428571428571,2,0.0,0,0,0,0,0,0,0,6,0,0,6,1
432,4112,FM7f8SmryrQv0xQWmeGBOm7E9JzAE7cF,fbPkOYLVPtPgIt0MxizjfFJov3JbHyAi,12,17,6,0,5,20,10,1,59,8.428571428571429,2,0.0,4,6,0,5,13,20,0,10,1,15,44,1
433,4113,uYnLLjFhtmRLfdb6UnGOhZKWKwE2Sz7S,fbPkOYLVPtPgIt0MxizjfFJov3JbHyAi,1,0,0,0,0,0,3,0,3,0.42857142857142855,1,0.0,0,0,0,0,0,0,0,3,0,0,3,1
434,4114,XqcIbo9pkzTiouZzC4CsMH0T57ZrJT7c,fbPkOYLVPtPgIt0MxizjfFJov3JbHyAi,12,21,8,11,5,8,7,1,61,8.714285714285714,3,0.0,3,8,8,5,18,8,3,7,1,24,37,1
435,4116,SbxWcDAQO1PnIdll82O1Qa8HqEHuIfT7,fbPkOYLVPtPgIt0MxizjfFJov3JbHyAi,5,5,1,0,1,0,1,0,8,1.1428571428571428,1,0.0,0,1,0,1,5,0,0,1,0,2,6,1
436,4117,DIqOhojonPjb3L0MafoRC4vbkm2ZgCPT,fbPkOYLVPtPgIt0MxizjfFJov3JbHyAi,15,13,4,13,5,7,6,2,50,7.142857142857143,2,0.0,6,4,9,5,7,7,4,6,2,24,26,1
437,4121,jcdJUvdxIg03VTKugjVUNiWSl6LwbiFS,fbPkOYLVPtPgIt0MxizjfFJov3JbHyAi,6,3,2,0,2,10,1,0,18,2.5714285714285716,1,0.0,0,2,0,2,3,10,0,1,0,4,14,1
438,4122,Uo5Is5U7melZAv7xg2Req57LK7O8TGT8,fbPkOYLVPtPgIt0MxizjfFJov3JbHyAi,30,41,25,0,16,1,14,3,100,14.285714285714286,3,0.0,2,25,0,16,39,1,0,14,3,43,57,1
439,4124,gml56PidNECJRV7FxBwKkFjPhRALq3yM,fbPkOYLVPtPgIt0MxizjfFJov3JbHyAi,9,8,5,0,4,0,10,0,27,3.857142857142857,2,0.0,0,5,0,4,8,0,0,10,0,9,18,1
440,4125,bGXe45VQE79P82jCvYbfBiOeISe1I8HL,fbPkOYLVPtPgIt0MxizjfFJov3JbHyAi,8,4,2,0,1,4,6,1,18,2.5714285714285716,2,0.0,0,2,0,1,4,4,0,6,1,3,15,1
441,4126,u4TNxfYOFL4kSz0gq3emLn9aOKma8Z0X,fbPkOYLVPtPgIt0MxizjfFJov3JbHyAi,12,8,6,3,2,0,0,0,19,2.7142857142857144,4,0.0,0,6,3,2,8,0,0,0,0,11,8,1
442,4127,iMXZvpdXIEwupZ3KLZs1wDk19TeUIZDi,fbPkOYLVPtPgIt0MxizjfFJov3JbHyAi,37,105,49,39,32,92,42,5,364,52.0,8,0.0,32,49,31,32,73,92,8,42,5,144,220,1
443,4129,Xl7O5Es6VpkB2PrTgzArkv7OwJ7XzlEg,fbPkOYLVPtPgIt0MxizjfFJov3JbHyAi,17,33,10,5,9,5,13,2,77,11.0,4,0.0,5,10,4,9,28,5,1,13,2,28,49,1
444,4130,8h1kpVFWyv776a7gZ8tw0jpXvK9G6pQ2,fbPkOYLVPtPgIt0MxizjfFJov3JbHyAi,10,9,4,0,3,0,7,0,23,3.2857142857142856,1,0.0,0,4,0,3,9,0,0,7,0,7,16,1
445,4133,sT9hGAnww95aeGvqwQpJlS3ORhWDT49F,fbPkOYLVPtPgIt0MxizjfFJov3JbHyAi,80,122,58,43,40,27,22,0,312,44.57142857142857,9,0.0,48,58,40,40,74,27,3,22,0,186,126,0
446,4134,bRG3KNKPz8MtEb5G1Duc4i5IiNMa8ZLU,fbPkOYLVPtPgIt0MxizjfFJov3JbHyAi,10,17,5,2,1,10,10,2,47,6.714285714285714,2,0.0,1,5,2,1,16,10,0,10,2,9,38,1
447,4135,Y9GqNI8HKN8AZelF8dSXK2b9zuzFq9b9,fbPkOYLVPtPgIt0MxizjfFJov3JbHyAi,4,2,1,0,1,0,1,0,5,0.7142857142857143,1,0.0,0,1,0,1,2,0,0,1,0,2,3,1
448,4136,WfTazznjeVMuts1c6fhfvqWuaprKs7C3,fbPkOYLVPtPgIt0MxizjfFJov3JbHyAi,32,46,30,0,20,97,34,4,231,33.0,8,0.0,0,30,0,20,46,97,0,34,4,50,181,1
449,4137,Z9qi5pq1C1bndfjP0mrTCfL8YAf6Qiv7,fbPkOYLVPtPgIt0MxizjfFJov3JbHyAi,16,31,18,7,16,11,15,1,99,14.142857142857142,4,0.0,8,18,6,16,23,11,1,15,1,48,51,0
450,4138,9tBhYjIXbTBZ0n8EA8LPV9H9GyKFjXEe,fbPkOYLVPtPgIt0MxizjfFJov3JbHyAi,9,4,3,0,3,0,2,0,12,1.7142857142857142,1,0.0,0,3,0,3,4,0,0,2,0,6,6,1
451,4140,JqdbZyx8jQDjvl0RCDBDldcliaXwceyv,fbPkOYLVPtPgIt0MxizjfFJov3JbHyAi,8,5,3,0,2,0,4,0,14,2.0,2,0.0,0,3,0,2,5,0,0,4,0,5,9,1
452,4141,3n39NQ5LzQS0QCcr9JZOE6aTUD48ZbAa,fbPkOYLVPtPgIt0MxizjfFJov3JbHyAi,7,3,2,0,2,0,6,0,13,1.8571428571428572,1,0.0,0,2,0,2,3,0,0,6,0,4,9,1
453,4143,9sFMHkQmozo76x80tFTC9ms1LtFpAvDD,fbPkOYLVPtPgIt0MxizjfFJov3JbHyAi,44,70,23,50,31,37,27,0,238,34.0,8,0.0,44,23,40,31,26,37,10,27,0,138,100,0
454,4145,AIdvsyhxoVQRPe3inEZOul3GszLWUII0,fbPkOYLVPtPgIt0MxizjfFJov3JbHyAi,7,3,2,0,2,0,5,0,12,1.7142857142857142,1,0.0,0,2,0,2,3,0,0,5,0,4,8,1
455,4146,UzWWq61d6vy3b9FQ0Zm3Qt9Ks0lmq3Qw,fbPkOYLVPtPgIt0MxizjfFJov3JbHyAi,9,4,3,0,3,0,5,0,15,2.142857142857143,1,0.0,0,3,0,3,4,0,0,5,0,6,9,1
456,4147,pUAX44GhkdnMgwkbpKeIXW1XZgu0a3SV,fbPkOYLVPtPgIt0MxizjfFJov3JbHyAi,5,2,1,0,1,0,4,0,8,1.1428571428571428,1,0.0,0,1,0,1,2,0,0,4,0,2,6,1
457,4148,V2KAeU5M9aZ71MSOJMPq9O99rHGzmKaR,fbPkOYLVPtPgIt0MxizjfFJov3JbHyAi,9,33,5,0,5,0,7,0,50,7.142857142857143,4,0.0,3,5,0,5,30,0,0,7,0,13,37,1
458,4149,dTHHrNH4JPIQjJnYjUmUZmHrgYHdCxcs,fbPkOYLVPtPgIt0MxizjfFJov3JbHyAi,6,5,2,0,3,0,1,0,11,1.5714285714285714,1,0.0,2,2,0,3,3,0,0,1,0,7,4,1
459,4150,mkfe4TuGJEOOkk4BSi5C0OnTlC842bEi,fbPkOYLVPtPgIt0MxizjfFJov3JbHyAi,26,51,15,13,22,0,8,1,110,15.714285714285714,3,0.0,33,15,11,22,18,0,2,8,1,81,29,1
460,4152,SBELepDdWchL6dd3B4yF17bQJZRyBGmW,fbPkOYLVPtPgIt0MxizjfFJov3JbHyAi,4,2,0,0,0,2,2,0,6,0.8571428571428571,1,0.0,0,0,0,0,2,2,0,2,0,0,6,1
461,4155,82WiuHoB3dVqYkf2UKsu9ogC0IsQQnqa,fbPkOYLVPtPgIt0MxizjfFJov3JbHyAi,13,57,22,1,10,6,10,0,106,15.142857142857142,5,0.0,10,22,1,10,47,6,0,10,0,43,63,1
462,4157,ZfaQRDpYRWxr1tKliyWhtiIkOEpZJsx1,fbPkOYLVPtPgIt0MxizjfFJov3JbHyAi,11,21,14,0,1,9,5,0,50,7.142857142857143,3,0.0,2,14,0,1,19,9,0,5,0,17,33,1
463,4160,nLSyDmuwtZ9VcSdeL7kW6FG97w0wmm94,fbPkOYLVPtPgIt0MxizjfFJov3JbHyAi,6,2,1,0,1,2,4,1,11,1.5714285714285714,1,0.0,0,1,0,1,2,2,0,4,1,2,9,1
464,4161,gT3kB48dwTiT117VlKJVDNNpHcWl18uZ,fbPkOYLVPtPgIt0MxizjfFJov3JbHyAi,5,0,0,0,0,1,5,1,7,1.0,1,0.0,0,0,0,0,0,1,0,5,1,0,7,1
465,4162,w9kAk351HcnpUdtlF40UgfJ8nmtrjk1M,fbPkOYLVPtPgIt0MxizjfFJov3JbHyAi,3,3,0,0,0,0,2,0,5,0.7142857142857143,1,0.0,0,0,0,0,3,0,0,2,0,0,5,1
466,4163,PBd2c59pI8ZCJwc4iQjHYNeQj4K3oGvT,fbPkOYLVPtPgIt0MxizjfFJov3JbHyAi,12,10,6,0,4,6,13,1,40,5.714285714285714,2,0.0,0,6,0,4,10,6,0,13,1,10,30,1
467,4164,6PFF6a3rTtp143lPxgdGFZZ0CCZBKH49,fbPkOYLVPtPgIt0MxizjfFJov3JbHyAi,27,46,17,12,18,4,13,6,116,16.571428571428573,2,0.0,20,17,10,18,26,4,2,13,6,65,51,1
468,4168,heWUPIsxtHSwXQGmJMsYqzGkbNQihssP,fbPkOYLVPtPgIt0MxizjfFJov3JbHyAi,10,10,6,3,5,0,2,0,26,3.7142857142857144,2,0.0,1,6,3,5,9,0,0,2,0,15,11,1
469,4169,z9oFzf9xIbCN4mhupPeK6qv2AnZTqp8G,fbPkOYLVPtPgIt0MxizjfFJov3JbHyAi,6,1,1,0,1,0,3,0,6,0.8571428571428571,1,0.0,0,1,0,1,1,0,0,3,0,2,4,1
470,4170,cJuR6mykFWWefoh4qiG9O6BBEr08qxSv,fbPkOYLVPtPgIt0MxizjfFJov3JbHyAi,8,13,4,0,4,18,6,3,48,6.857142857142857,2,0.0,4,4,0,4,9,18,0,6,3,12,36,1
471,4171,uHgH8m4GJET0eE5mE8JCyLZD7HEKwM4t,SpATywNh6bZuzm8s1ceuBUnMUAeoAHHw,43,84,43,39,11,39,46,3,265,37.857142857142854,15,0.0,22,43,33,11,62,39,6,46,3,109,156,0
472,4182,HgeZmyLysCZF827lPwLNCfqcskKVvNDd,SpATywNh6bZuzm8s1ceuBUnMUAeoAHHw,24,47,4,28,2,16,27,2,126,18.0,6,0.0,12,4,25,2,35,16,3,27,2,43,83,0
473,4218,EReWp6ilgaQY61GGX2jAkIc5IQisheJq,SpATywNh6bZuzm8s1ceuBUnMUAeoAHHw,33,45,19,34,10,0,13,0,121,17.285714285714285,9,0.0,8,19,28,10,37,0,6,13,0,65,56,1
474,4219,Jm4nQ05ndX10jbofbWx6S0r9VXrqia6S,bWdj2GDclj5ofokWjzoa5jAwMkxCykd6,11,30,15,46,2,14,12,0,119,17.0,4,0.0,3,15,44,2,27,14,2,12,0,64,55,0
475,4237,SVFfJJhaWd2RlHPtvg5SWBRGj8N0paMQ,SpATywNh6bZuzm8s1ceuBUnMUAeoAHHw,32,76,9,54,1,2,33,0,175,25.0,11,0.0,26,9,46,1,50,2,8,33,0,82,93,0
476,4238,hevZgCUVQAVwtaivzco7bLaVpTOAAfiG,SpATywNh6bZuzm8s1ceuBUnMUAeoAHHw,30,47,27,18,12,1,9,0,114,16.285714285714285,6,0.0,11,27,15,12,36,1,3,9,0,65,49,0
477,4243,83p9ejSELsW1j5wNlAyUXF2YWFL8Z8tc,A3fsA9Zfv1X2fVEQhTw51lKENdNrEqT3,71,41,19,118,14,1,16,0,209,29.857142857142858,7,0.0,2,19,112,14,39,1,6,16,0,147,62,0
478,4247,0NGZq9HZW5KOrSfzSGGipuN20pCRDMWu,G8EPVSXsOYB5YQWZGiz1aVq5Pgr2GrQu,79,301,88,17,28,98,63,3,598,85.42857142857143,12,0.0,76,88,13,28,225,98,4,63,3,205,393,0
479,4250,DHUv7XpIZcPp2QYGNmTXjhgg7Zq4BpJ7,SpATywNh6bZuzm8s1ceuBUnMUAeoAHHw,34,34,23,14,14,0,6,0,91,13.0,4,0.0,7,23,13,14,27,0,1,6,0,57,34,1
480,4254,J5PQMceXoOVyN05md7NqKfAhSfcgJgVJ,SpATywNh6bZuzm8s1ceuBUnMUAeoAHHw,35,73,4,53,0,155,28,2,315,45.0,13,0.0,23,4,45,0,50,155,8,28,2,72,243,0
481,4268,nYFWhKbFKiXgZ193lmJEmg3xQ65UNrPv,SpATywNh6bZuzm8s1ceuBUnMUAeoAHHw,28,49,21,29,8,3,11,1,122,17.428571428571427,5,0.0,22,21,27,8,27,3,2,11,1,78,44,1
482,4270,xmsckIAcvM2S7rjWsHHPvyDsjVFjwdMr,SpATywNh6bZuzm8s1ceuBUnMUAeoAHHw,27,50,12,22,6,13,9,0,112,16.0,6,0.0,11,12,20,6,39,13,2,9,0,49,63,1
483,4278,iVNWfvqx80bYGUpxbD5kOVH2Fugs6QtQ,SpATywNh6bZuzm8s1ceuBUnMUAeoAHHw,54,59,37,28,24,3,15,0,166,23.714285714285715,7,0.0,11,37,26,24,48,3,2,15,0,98,68,0
484,4286,i9UIJe9BPLqUSVYMtAIMhpSeBf6cbruQ,SpATywNh6bZuzm8s1ceuBUnMUAeoAHHw,19,45,19,11,9,0,7,0,91,13.0,7,0.0,12,19,11,9,33,0,0,7,0,51,40,0
485,4290,EVhDvNThWnvwe7HGJiMKoMo6EeAXDH9R,bWdj2GDclj5ofokWjzoa5jAwMkxCykd6,14,15,10,0,5,2,20,3,55,7.857142857142857,3,0.0,0,10,0,5,15,2,0,20,3,15,40,1
486,4291,UTQBVZwwRuN7bMqGkwJeqpNJF2PPrsFV,A3fsA9Zfv1X2fVEQhTw51lKENdNrEqT3,18,12,9,0,8,0,2,0,31,4.428571428571429,1,0.0,0,9,0,8,12,0,0,2,0,17,14,0
487,4292,5IOZn10arhSe83Sz47oGoyNxbAFXZkA2,SpATywNh6bZuzm8s1ceuBUnMUAeoAHHw,16,43,12,0,3,16,15,0,89,12.714285714285714,5,0.0,2,12,0,3,41,16,0,15,0,17,72,1
488,4301,QOK5LHvwN0A5g3JhxMPHBffh5Rh2wZF8,SpATywNh6bZuzm8s1ceuBUnMUAeoAHHw,13,20,5,0,2,3,11,1,42,6.0,3,0.0,1,5,0,2,19,3,0,11,1,8,34,1
489,4304,j1jdy8OF5VQw4rqSYOkbK2pQplvvvz37,5X6FeZozNMgE2VRi3MJYjkkFK8SETtu2,118,363,17,190,60,17,65,2,714,102.0,18,0.0,176,17,161,60,187,17,29,65,2,414,300,0
490,4313,l80sDXQh6tFmRSRsJvWJgP55drvQUfT2,SpATywNh6bZuzm8s1ceuBUnMUAeoAHHw,34,722,30,28,12,0,48,1,841,120.14285714285714,10,0.0,20,30,26,12,702,0,2,48,1,88,753,1
491,4327,glS180WZt8C6hB13WP6NUijid7zN96cg,SpATywNh6bZuzm8s1ceuBUnMUAeoAHHw,33,52,21,39,5,4,11,1,133,19.0,6,0.0,23,21,34,5,29,4,5,11,1,83,50,0
492,4342,gqe5NXbZbf5uXY0rPviLeIFOMpQyekdp,G8EPVSXsOYB5YQWZGiz1aVq5Pgr2GrQu,77,102,7,132,11,16,27,0,295,42.142857142857146,11,0.0,1,7,117,11,101,16,15,27,0,136,159,1
493,4344,xq251j4u37TVpTeMx1v6QtnvJbeUYzjd,SpATywNh6bZuzm8s1ceuBUnMUAeoAHHw,19,44,7,12,0,0,18,0,81,11.571428571428571,3,0.0,4,7,11,0,40,0,1,18,0,22,59,1
494,4352,3OBHdoV61de7ICMrnWAXr689Eb2AyuN0,SpATywNh6bZuzm8s1ceuBUnMUAeoAHHw,32,35,18,34,11,12,16,1,127,18.142857142857142,5,0.0,9,18,29,11,26,12,5,16,1,67,60,0
495,4361,jygZDxdNc5vnyQVPVME6xQbLWCY2Zptq,SpATywNh6bZuzm8s1ceuBUnMUAeoAHHw,7,14,6,0,6,0,5,0,31,4.428571428571429,2,0.0,0,6,0,6,14,0,0,5,0,12,19,1
496,4364,dVnTQl9ANUhHsXIPIWBdmTgLVkOgcfeV,bWdj2GDclj5ofokWjzoa5jAwMkxCykd6,5,2,1,0,1,0,2,0,6,0.8571428571428571,1,0.0,0,1,0,1,2,0,0,2,0,2,4,1
497,4365,ebO6e76NCFlMeek1yPjM9gz3mJBPl1yH,RXDvfPUBYFlVdlueBFbLW0mhhAyGEqpt,105,126,67,190,30,43,34,2,492,70.28571428571429,6,0.0,27,67,180,30,99,43,10,34,2,304,188,1
498,4393,PehZ8w7lhwueNJQVLn4O4a5DjlM7RVHJ,5X6FeZozNMgE2VRi3MJYjkkFK8SETtu2,30,42,9,60,15,5,4,0,135,19.285714285714285,3,0.0,14,9,52,15,28,5,8,4,0,90,45,1
499,4395,C6xrhZPOmVH2gCVNP26gSSPka2CcwgB5,SpATywNh6bZuzm8s1ceuBUnMUAeoAHHw,30,23,15,14,9,1,19,1,82,11.714285714285714,6,0.0,7,15,14,9,16,1,0,19,1,45,37,1
500,4396,5c5BMuD35oybcLij9FEBpLM3FZXJ5QAD,G8EPVSXsOYB5YQWZGiz1aVq5Pgr2GrQu,65,197,10,49,2,32,51,7,348,49.714285714285715,13,0.0,14,10,41,2,183,32,8,51,7,67,281,0
501,4406,U0MChqulsymiJYCtbj873TXGFuXiZDFk,SpATywNh6bZuzm8s1ceuBUnMUAeoAHHw,46,67,38,29,17,14,26,1,192,27.428571428571427,13,0.0,18,38,27,17,49,14,2,26,1,100,92,0
502,4430,sWkTuB7KUS6C7uaxH84rlQvKN8aRF9JC,bWdj2GDclj5ofokWjzoa5jAwMkxCykd6,6,6,3,0,1,8,10,0,28,4.0,3,0.0,0,3,0,1,6,8,0,10,0,4,24,1
503,4432,kdQVQcPehC1WZyKhleQe5vDaCQv1dpj8,SpATywNh6bZuzm8s1ceuBUnMUAeoAHHw,45,53,33,48,17,7,21,4,183,26.142857142857142,10,0.0,8,33,46,17,45,7,2,21,4,104,79,0
504,4435,bN6JhUz4s97Xsh7eq2ZH1ilTMaKJDuUF,bWdj2GDclj5ofokWjzoa5jAwMkxCykd6,42,168,48,113,15,38,38,1,421,60.142857142857146,17,0.0,17,48,99,15,151,38,14,38,1,179,242,0
505,4440,ZhTCqX8GMUcn0a0betuEauHNuCk1aRhm,bWdj2GDclj5ofokWjzoa5jAwMkxCykd6,93,169,66,240,27,150,36,0,688,98.28571428571429,8,0.0,33,66,216,27,136,150,24,36,0,342,346,0
506,4453,4sZlPbPnBCwNHbrOUXcVAiPkTKHriJTV,SpATywNh6bZuzm8s1ceuBUnMUAeoAHHw,37,103,8,48,2,52,79,4,296,42.285714285714285,16,0.0,22,8,43,2,81,52,5,79,4,75,221,0
507,4454,lMy0A59BRo4770ALzvOjsBS5HJkCRV78,bWdj2GDclj5ofokWjzoa5jAwMkxCykd6,49,89,15,120,5,28,52,1,310,44.285714285714285,9,0.0,11,15,109,5,78,28,11,52,1,140,170,1
508,4481,XjrP1VAGwJCwkRm4KgImIkZYNjnvGQN9,RXDvfPUBYFlVdlueBFbLW0mhhAyGEqpt,125,412,156,240,100,141,200,39,1288,184.0,30,0.0,96,156,218,100,316,141,22,200,39,570,718,0
509,4487,K8rCvtgiQNoA3MkpXyD7cZBeSU2lQVue,5X6FeZozNMgE2VRi3MJYjkkFK8SETtu2,10,9,8,0,7,0,6,0,30,4.285714285714286,2,0.0,0,8,0,7,9,0,0,6,0,15,15,1
510,4498,dxoTIhhPXBvqzWGLltH0slJdxsuyggjI,G8EPVSXsOYB5YQWZGiz1aVq5Pgr2GrQu,88,198,153,0,95,86,85,5,622,88.85714285714286,19,0.0,3,153,0,95,195,86,0,85,5,251,371,0
511,4499,2ZP4iw9joeRPfEuWLWQQFnKchFtuqx5l,SpATywNh6bZuzm8s1ceuBUnMUAeoAHHw,17,27,15,14,8,3,8,0,75,10.714285714285714,5,0.0,6,15,13,8,21,3,1,8,0,42,33,0
512,4506,j1jdy8OF5VQw4rqSYOkbK2pQplvvvz37,G8EPVSXsOYB5YQWZGiz1aVq5Pgr2GrQu,136,335,37,221,10,238,156,9,1006,143.71428571428572,26,0.0,36,37,181,10,299,238,40,156,9,264,742,0
513,4507,HuDaXYBstQFpbEGg5tkyPhxLKzB3hVSB,SpATywNh6bZuzm8s1ceuBUnMUAeoAHHw,53,252,123,65,26,120,126,6,718,102.57142857142857,29,0.0,55,123,49,26,197,120,16,126,6,253,465,0
514,4524,j1jdy8OF5VQw4rqSYOkbK2pQplvvvz37,bWdj2GDclj5ofokWjzoa5jAwMkxCykd6,61,150,29,198,8,68,71,3,527,75.28571428571429,16,0.0,17,29,176,8,133,68,22,71,3,230,297,1
515,4533,4LLdV2zTWS697dAsOgAPJZPFwfNnrjt6,5X6FeZozNMgE2VRi3MJYjkkFK8SETtu2,60,134,71,74,68,2,11,0,360,51.42857142857143,9,0.0,37,71,61,68,97,2,13,11,0,237,123,0
516,4547,fczke4UuC99kQHbLPBF9eDbT99FMycXd,SpATywNh6bZuzm8s1ceuBUnMUAeoAHHw,4,0,0,0,0,0,10,0,10,1.4285714285714286,3,0.0,0,0,0,0,0,0,0,10,0,0,10,0
517,4548,kla9cpzzaIqMfwRx5dULfeceoZisiJXJ,SpATywNh6bZuzm8s1ceuBUnMUAeoAHHw,35,144,50,36,16,53,86,11,396,56.57142857142857,15,0.0,60,50,32,16,84,53,4,86,11,158,238,0
518,4560,LUmOTPPHIX2y7l2dFV3yMvYCAxk1M4FC,SpATywNh6bZuzm8s1ceuBUnMUAeoAHHw,18,38,27,0,0,1,14,3,83,11.857142857142858,2,0.0,5,27,0,0,33,1,0,14,3,32,51,1
519,4571,PUW0i4IuafllkJEtV0GCqmTDeLHkDmH3,bWdj2GDclj5ofokWjzoa5jAwMkxCykd6,54,122,17,142,8,424,83,7,803,114.71428571428571,15,0.0,22,17,121,8,100,424,21,83,7,168,635,0
520,4585,HqsJVGNbokPBStWiDvKZXbvoLlDHixpp,SpATywNh6bZuzm8s1ceuBUnMUAeoAHHw,32,82,11,42,1,0,12,0,148,21.142857142857142,7,0.0,38,11,37,1,44,0,5,12,0,87,61,0
521,4598,izDb8XjXh0aaLsv56xtUKjGq4nGYtog4,G8EPVSXsOYB5YQWZGiz1aVq5Pgr2GrQu,101,200,130,48,60,49,57,12,556,79.42857142857143,7,0.0,42,130,24,60,158,49,24,57,12,256,300,0
522,4602,1qPavhGaGseYAa3UI9iFE9Ty6uv8yxcD,5X6FeZozNMgE2VRi3MJYjkkFK8SETtu2,15,30,3,17,12,0,5,0,67,9.571428571428571,1,0.0,25,3,15,12,5,0,2,5,0,55,12,1
523,4610,sZNhT3IqtfFMwMod3w0cGQK1HKvrIFwI,SpATywNh6bZuzm8s1ceuBUnMUAeoAHHw,29,20,13,31,8,8,5,0,85,12.142857142857142,3,0.0,4,13,30,8,16,8,1,5,0,55,30,1
524,4613,aVE6FAaI67jjqObdfL3BkKQUvDsOp43M,SpATywNh6bZuzm8s1ceuBUnMUAeoAHHw,63,246,140,68,47,96,143,6,746,106.57142857142857,9,0.0,54,140,61,47,192,96,7,143,6,302,444,0
525,4614,D77mYRAEHVmHmrch91cWflZwkGfWXMn3,SpATywNh6bZuzm8s1ceuBUnMUAeoAHHw,23,45,6,0,5,0,10,0,66,9.428571428571429,6,0.0,0,6,0,5,45,0,0,10,0,11,55,1
526,4619,y7HHpDc09mCS3h1lthBIJASJI1RnROT7,SpATywNh6bZuzm8s1ceuBUnMUAeoAHHw,1,0,0,0,0,0,1,0,1,0.14285714285714285,1,0.0,0,0,0,0,0,0,0,1,0,0,1,1
527,4625,qRy2DimM9SNsqYvrYrrnIw2oQKcYB3wP,SpATywNh6bZuzm8s1ceuBUnMUAeoAHHw,33,62,4,44,2,0,14,0,126,18.0,8,0.0,10,4,36,2,52,0,8,14,0,52,74,0
528,4630,DLDhUvvvfnnYFJuV65Zt2yaS0jPJgvzq,G8EPVSXsOYB5YQWZGiz1aVq5Pgr2GrQu,117,151,1,284,3,31,34,2,506,72.28571428571429,10,0.0,53,1,218,3,98,31,66,34,2,275,231,0
529,4637,jWkqymVvvfv6xuX5RWgcj99r1zpcnb3g,SpATywNh6bZuzm8s1ceuBUnMUAeoAHHw,33,84,4,25,2,2,20,0,137,19.571428571428573,9,0.0,12,4,21,2,72,2,4,20,0,39,98,0
530,4641,8oxFWBumsNA4SJ0CIJujNkjFW8ZzMgtQ,SpATywNh6bZuzm8s1ceuBUnMUAeoAHHw,38,132,6,60,5,71,75,9,358,51.142857142857146,16,0.0,32,6,48,5,100,71,12,75,9,91,267,0
531,4646,bfYktB6xMRG2G8ooGt6o3rE63qV6JxlI,5X6FeZozNMgE2VRi3MJYjkkFK8SETtu2,22,41,12,25,19,3,11,1,112,16.0,3,0.0,25,12,23,19,16,3,2,11,1,79,33,1
532,4647,MKlpymF14KtyI236a0RjVjNdDlFXwHJE,SpATywNh6bZuzm8s1ceuBUnMUAeoAHHw,39,98,23,25,4,45,20,3,218,31.142857142857142,13,0.0,21,23,24,4,77,45,1,20,3,72,146,0
533,4652,D1N0ONIJFdYniASKJjZ0ujwEVr50txl7,A3fsA9Zfv1X2fVEQhTw51lKENdNrEqT3,8,7,5,0,5,0,3,0,20,2.857142857142857,2,0.0,0,5,0,5,7,0,0,3,0,10,10,1
534,4664,kMN5uYNaj23K9PVTrdyiL9iDB1lCye57,SpATywNh6bZuzm8s1ceuBUnMUAeoAHHw,47,142,51,47,18,65,37,1,361,51.57142857142857,16,0.0,34,51,41,18,108,65,6,37,1,144,217,0
535,4667,hjlIy32j2vlgUCGRsMhZTr5gQN9bE8Ko,A3fsA9Zfv1X2fVEQhTw51lKENdNrEqT3,3,3,1,0,0,0,1,0,5,0.7142857142857143,1,0.0,0,1,0,0,3,0,0,1,0,1,4,1
536,4672,LBkf4MhTcgqLqBnp8u6ZnAtRKKkDVT0Y,RXDvfPUBYFlVdlueBFbLW0mhhAyGEqpt,87,114,71,104,28,11,12,1,341,48.714285714285715,4,0.0,35,71,98,28,79,11,6,12,1,232,109,0
537,4685,vdpA0dH9z73XaAQ0RErmDlnn6qBKeXm2,SpATywNh6bZuzm8s1ceuBUnMUAeoAHHw,2,0,0,0,0,0,2,0,2,0.2857142857142857,1,0.0,0,0,0,0,0,0,0,2,0,0,2,1
538,4690,uOFQjpYGMV24K1kl5khOKpWKqO5hcEHE,SpATywNh6bZuzm8s1ceuBUnMUAeoAHHw,39,83,9,56,7,18,26,5,204,29.142857142857142,9,0.0,26,9,47,7,57,18,9,26,5,89,115,0
539,4697,Dth3GgZsbd3MjUskvlTR45iDGsOfcse1,bWdj2GDclj5ofokWjzoa5jAwMkxCykd6,9,6,0,0,1,0,7,1,15,2.142857142857143,1,0.0,2,0,0,1,4,0,0,7,1,3,12,1
540,4713,2d73pTPKGJeE59DtbgirchSdsN0c5ZX8,G8EPVSXsOYB5YQWZGiz1aVq5Pgr2GrQu,83,156,57,255,18,9,38,2,535,76.42857142857143,10,0.0,73,57,213,18,83,9,42,38,2,361,174,1
541,4717,pYVXRlnQ0YvWKNjc7FEDAmE4Ai0Z428V,SpATywNh6bZuzm8s1ceuBUnMUAeoAHHw,15,10,5,13,5,3,11,0,47,6.714285714285714,3,0.0,3,5,11,5,7,3,2,11,0,24,23,1
542,4721,f3gOHcsH9dxbGnjsoxzcxRnJIKI7kpN0,5X6FeZozNMgE2VRi3MJYjkkFK8SETtu2,17,21,5,14,8,3,11,2,64,9.142857142857142,1,0.0,13,5,13,8,8,3,1,11,2,39,25,1
543,4724,CjC2ROZAsG20pDynA7ZPw7kC7J3IUQLv,SpATywNh6bZuzm8s1ceuBUnMUAeoAHHw,37,58,28,39,10,19,23,1,178,25.428571428571427,6,0.0,8,28,37,10,50,19,2,23,1,83,95,0
544,4728,pteLC5OQ4se3k1DPDEwaYOBtzSkv9plY,A3fsA9Zfv1X2fVEQhTw51lKENdNrEqT3,8,6,2,0,2,0,5,0,15,2.142857142857143,2,0.0,0,2,0,2,6,0,0,5,0,4,11,1
545,4731,LgFsEu5TARkqPf6cgrTX0NqpOzewq5Lk,SpATywNh6bZuzm8s1ceuBUnMUAeoAHHw,27,27,14,23,8,3,12,2,89,12.714285714285714,6,0.0,6,14,20,8,21,3,3,12,2,48,41,0
546,4742,24nfIqL449Y829FZxcDvbCwFktTYfhAB,SpATywNh6bZuzm8s1ceuBUnMUAeoAHHw,1,0,0,0,0,0,1,0,1,0.14285714285714285,1,0.0,0,0,0,0,0,0,0,1,0,0,1,1
547,4743,24nfIqL449Y829FZxcDvbCwFktTYfhAB,bWdj2GDclj5ofokWjzoa5jAwMkxCykd6,5,2,1,0,1,0,2,0,6,0.8571428571428571,1,0.0,0,1,0,1,2,0,0,2,0,2,4,1
548,4747,2YrfQZgyUPdiZGXhplgKBSkvHochAfw6,SpATywNh6bZuzm8s1ceuBUnMUAeoAHHw,43,176,77,47,22,5,44,0,371,53.0,16,0.0,17,77,38,22,159,5,9,44,0,154,217,0
549,4756,5QI6OaFhCHlCtRcFfvDdZQ38fgw6K7ZS,SpATywNh6bZuzm8s1ceuBUnMUAeoAHHw,1,0,0,0,0,0,1,0,1,0.14285714285714285,1,0.0,0,0,0,0,0,0,0,1,0,0,1,1
550,4767,OLNUzQUHvlNsi2WFlH5eEyaieqKXrEz7,SpATywNh6bZuzm8s1ceuBUnMUAeoAHHw,14,19,9,0,4,6,7,0,45,6.428571428571429,4,0.0,2,9,0,4,17,6,0,7,0,15,30,1
551,4772,6BV3xjXq9ekiRfYm3O3pN6jZMMACVAnm,G8EPVSXsOYB5YQWZGiz1aVq5Pgr2GrQu,1,0,0,0,0,0,1,0,1,0.14285714285714285,1,0.0,0,0,0,0,0,0,0,1,0,0,1,1
552,4773,29ctmAiYEOKj7HqUZOWS8Kj1hgVEvKs8,bWdj2GDclj5ofokWjzoa5jAwMkxCykd6,11,26,1,14,1,0,6,0,48,6.857142857142857,2,0.0,5,1,14,1,21,0,0,6,0,21,27,1
553,4774,urHq1UPtLFVLJW8r9uUffDflKlN7AYRL,SpATywNh6bZuzm8s1ceuBUnMUAeoAHHw,33,46,22,31,7,5,17,0,128,18.285714285714285,6,0.0,12,22,26,7,34,5,5,17,0,67,61,0
554,4781,OOsRSTJd6U7cE43XHk99M9ofvrefufrh,5X6FeZozNMgE2VRi3MJYjkkFK8SETtu2,9,17,3,8,5,0,2,0,35,5.0,2,0.0,7,3,7,5,10,0,1,2,0,22,13,1
555,4790,WoOgbdNrXyv06YgEFJ3swrzgLpeYWjTw,5X6FeZozNMgE2VRi3MJYjkkFK8SETtu2,23,33,16,20,10,15,11,5,110,15.714285714285714,3,0.0,10,16,17,10,23,15,3,11,5,53,57,1
556,4792,SmONSyS4YgG4Afnv6ZxU81t7p4CQPV5P,5X6FeZozNMgE2VRi3MJYjkkFK8SETtu2,5,7,1,0,1,0,2,0,11,1.5714285714285714,2,0.0,0,1,0,1,7,0,0,2,0,2,9,1
557,4801,uvl7kPB3Po3jrDtnQvCsunCWcJhdeQPU,A3fsA9Zfv1X2fVEQhTw51lKENdNrEqT3,50,60,32,103,19,3,26,2,245,35.0,7,0.0,4,32,88,19,56,3,15,26,2,143,102,1
558,4802,aI2WbSCktVyijPTHCbgAdpzpfdnFGcq9,RXDvfPUBYFlVdlueBFbLW0mhhAyGEqpt,47,128,64,0,14,1,49,6,262,37.42857142857143,13,0.0,4,64,0,14,124,1,0,49,6,82,180,0
559,4806,iGjPcJm3i62KsWTQKhrsxcQv7n97iair,G8EPVSXsOYB5YQWZGiz1aVq5Pgr2GrQu,170,333,42,510,13,102,44,2,1046,149.42857142857142,15,0.0,112,42,358,13,221,102,152,44,2,525,521,0
560,4813,8956nHnvCL40778s76lABgHdN1UGjdzq,bWdj2GDclj5ofokWjzoa5jAwMkxCykd6,5,3,1,0,1,0,2,0,7,1.0,1,0.0,0,1,0,1,3,0,0,2,0,2,5,1
561,4819,srJeJbIuD6nlvLtYdUFiQcvh7X1ghk8m,5X6FeZozNMgE2VRi3MJYjkkFK8SETtu2,23,61,3,39,22,2,5,0,132,18.857142857142858,2,0.0,40,3,37,22,21,2,2,5,0,102,30,1
562,4825,q3SjGV3d1qwn1q3ehoXsAmC01281iVQV,SpATywNh6bZuzm8s1ceuBUnMUAeoAHHw,42,72,44,48,29,8,24,1,226,32.285714285714285,6,0.0,16,44,41,29,56,8,7,24,1,130,96,0
563,4827,yNygMjDRQbsmQrkdzv6Ni3gEhrA9rC9T,SpATywNh6bZuzm8s1ceuBUnMUAeoAHHw,14,40,20,12,7,2,9,0,90,12.857142857142858,5,0.0,10,20,9,7,30,2,3,9,0,46,44,0
564,4846,7gQzvY1ridUPLjuboweNhi3eMZVeaUA3,SpATywNh6bZuzm8s1ceuBUnMUAeoAHHw,1,0,0,0,0,0,1,0,1,0.14285714285714285,1,0.0,0,0,0,0,0,0,0,1,0,0,1,1
565,4852,bvRAS0uJ0Teq8mZcNb9rxcXigDj59DTa,RXDvfPUBYFlVdlueBFbLW0mhhAyGEqpt,20,39,26,0,2,0,11,0,78,11.142857142857142,7,0.0,1,26,0,2,38,0,0,11,0,29,49,0
566,4859,WFpcwuADsWD4IXIxExn0sUfX41HgFWZg,SpATywNh6bZuzm8s1ceuBUnMUAeoAHHw,6,5,2,0,2,0,1,0,10,1.4285714285714286,1,0.0,0,2,0,2,5,0,0,1,0,4,6,1
567,4876,JEyrK2UFmqy57ey0eTcC8j1tS8jjredk,5X6FeZozNMgE2VRi3MJYjkkFK8SETtu2,11,12,6,0,4,0,9,1,32,4.571428571428571,2,0.0,2,6,0,4,10,0,0,9,1,12,20,1
568,4903,jJEQAKDG1yT0OS9qRBZrNXlEJDxE8Etq,A3fsA9Zfv1X2fVEQhTw51lKENdNrEqT3,44,91,23,47,2,264,77,4,508,72.57142857142857,25,0.0,7,23,39,2,84,264,8,77,4,71,437,0
569,4907,24hyIKTWvGbDpRNiVA2hNdG9ApRuVKWS,SpATywNh6bZuzm8s1ceuBUnMUAeoAHHw,53,71,41,37,23,14,29,1,216,30.857142857142858,11,0.0,14,41,32,23,57,14,5,29,1,110,106,0
570,4910,FlH4hJdTFopI7d7C8aCFmJunlCxyAcSh,SpATywNh6bZuzm8s1ceuBUnMUAeoAHHw,47,63,35,45,19,7,24,4,197,28.142857142857142,8,0.0,17,35,39,19,46,7,6,24,4,110,87,1
571,4916,zgScsnx97lbYEQNQ5ihDmYHFxSK6ucUx,SpATywNh6bZuzm8s1ceuBUnMUAeoAHHw,1,0,0,0,0,0,1,0,1,0.14285714285714285,1,0.0,0,0,0,0,0,0,0,1,0,0,1,1
572,4919,QDpN8D19Mr8RZumTONWpZNlCWcHCCTbH,bWdj2GDclj5ofokWjzoa5jAwMkxCykd6,16,31,3,44,3,14,9,0,104,14.857142857142858,5,0.0,6,3,42,3,25,14,2,9,0,54,50,1
573,4920,QDpN8D19Mr8RZumTONWpZNlCWcHCCTbH,5X6FeZozNMgE2VRi3MJYjkkFK8SETtu2,15,25,1,0,12,0,3,0,41,5.857142857142857,3,0.0,12,1,0,12,13,0,0,3,0,25,16,1
574,4924,bef1HHNzLfXpAEPkvkmDyHD9r4t8l5gN,RXDvfPUBYFlVdlueBFbLW0mhhAyGEqpt,2,0,0,0,0,0,2,0,2,0.2857142857142857,1,0.0,0,0,0,0,0,0,0,2,0,0,2,1
575,4927,WYPfgLKE9VINcT4gmCjKg6KY4hGmzmxN,SpATywNh6bZuzm8s1ceuBUnMUAeoAHHw,30,39,19,20,7,3,9,0,97,13.857142857142858,3,0.0,14,19,17,7,25,3,3,9,0,57,40,0
576,4931,eiL4sJzBUqNqEAwJXavGTHQchRgg0E9e,G8EPVSXsOYB5YQWZGiz1aVq5Pgr2GrQu,107,154,13,329,4,32,56,7,595,85.0,20,0.0,35,13,267,4,119,32,62,56,7,319,276,0
577,4934,RkupeBiDJM8eQAHegSIZXnYfypYMPCFs,SpATywNh6bZuzm8s1ceuBUnMUAeoAHHw,16,79,44,5,10,0,23,0,161,23.0,12,0.0,9,44,5,10,70,0,0,23,0,68,93,0
578,4937,aZcgamrUxwqX7Nt2qxeI2ZGGKhcvbWIt,SpATywNh6bZuzm8s1ceuBUnMUAeoAHHw,39,98,4,75,1,2,39,1,220,31.428571428571427,8,0.0,35,4,62,1,63,2,13,39,1,102,118,0
579,4948,D8SfZbudbfX5pEFjOEna12FQCnvrJwde,SpATywNh6bZuzm8s1ceuBUnMUAeoAHHw,7,13,6,0,0,1,10,1,31,4.428571428571429,3,0.0,0,6,0,0,13,1,0,10,1,6,25,1
580,4954,w9jybkX7jENxFw2ZN48ruQIJfCGfUCTe,bWdj2GDclj5ofokWjzoa5jAwMkxCykd6,20,34,1,56,4,1,7,0,103,14.714285714285714,5,0.0,11,1,49,4,23,1,7,7,0,65,38,1
581,4956,w9jybkX7jENxFw2ZN48ruQIJfCGfUCTe,A3fsA9Zfv1X2fVEQhTw51lKENdNrEqT3,61,69,1,226,1,0,10,0,307,43.857142857142854,6,0.0,8,1,183,1,61,0,43,10,0,193,114,1
582,4967,W4dUmcINvn4EmYk22ZRR3EuEX8WaEqL8,A3fsA9Zfv1X2fVEQhTw51lKENdNrEqT3,9,6,4,0,2,0,3,0,15,2.142857142857143,1,0.0,0,4,0,2,6,0,0,3,0,6,9,1
583,4979,dSloiolTuQA1YnIVrIEZb5m23cL24cRw,bWdj2GDclj5ofokWjzoa5jAwMkxCykd6,10,12,4,0,4,0,5,0,25,3.5714285714285716,4,0.0,0,4,0,4,12,0,0,5,0,8,17,1
584,4982,3ZzNkdWgGb47Go07PRKPf0XZ6jjhVCB4,A3fsA9Zfv1X2fVEQhTw51lKENdNrEqT3,55,57,40,78,18,36,26,0,255,36.42857142857143,10,0.0,1,40,63,18,56,36,15,26,0,122,133,0
585,4984,3h1zqwMTeQWdhoWHPgvllPWyD6P0qFtr,SpATywNh6bZuzm8s1ceuBUnMUAeoAHHw,36,81,41,24,22,5,18,2,193,27.571428571428573,10,0.0,22,41,24,22,59,5,0,18,2,109,84,0
586,4989,WxVM9kOqNmenlQy1YKMo3yVYKYKkewCz,A3fsA9Zfv1X2fVEQhTw51lKENdNrEqT3,102,60,39,272,18,27,30,0,446,63.714285714285715,10,0.0,9,39,214,18,51,27,58,30,0,280,166,0
587,5009,lgip049r6Eu24ga2SPdixKHu4ShoVkOP,SpATywNh6bZuzm8s1ceuBUnMUAeoAHHw,56,48,31,35,19,1,19,1,154,22.0,5,0.0,9,31,31,19,39,1,4,19,1,90,64,0
588,5014,CIp7kQvL8WZLrf0lp78hw3OiOipB94Fc,SpATywNh6bZuzm8s1ceuBUnMUAeoAHHw,1,0,0,0,0,0,1,0,1,0.14285714285714285,1,0.0,0,0,0,0,0,0,0,1,0,0,1,1
589,5026,m9R5p8ELPeEGL2TgmgmNZypetc0YKw9N,5X6FeZozNMgE2VRi3MJYjkkFK8SETtu2,10,13,6,0,8,0,4,0,31,4.428571428571429,1,0.0,6,6,0,8,7,0,0,4,0,20,11,1
590,5028,v1AqHfMoNhUox9GyIOrxftKibIp07zrt,RXDvfPUBYFlVdlueBFbLW0mhhAyGEqpt,19,28,23,0,17,15,7,0,90,12.857142857142858,5,0.0,0,23,0,17,28,15,0,7,0,40,50,1
591,5042,QP1Im9jEj4yDlujZ0cdksBwzi1qoq6uz,A3fsA9Zfv1X2fVEQhTw51lKENdNrEqT3,21,17,14,0,12,0,8,1,52,7.428571428571429,3,0.0,0,14,0,12,17,0,0,8,1,26,26,1
592,5058,UJNew1tDOTKAwtlVI7Xin0dzgnQGk4oE,SpATywNh6bZuzm8s1ceuBUnMUAeoAHHw,44,104,44,60,11,16,29,0,264,37.714285714285715,13,0.0,39,44,54,11,65,16,6,29,0,148,116,0
593,5081,EEKRPW8tn9Mg3QBn5MHwc7463f6P9lSa,SpATywNh6bZuzm8s1ceuBUnMUAeoAHHw,19,29,0,7,0,0,6,0,42,6.0,4,0.0,5,0,6,0,24,0,1,6,0,11,31,1
594,5084,kMzMJEHy7fAHiNUZU0um3I2BsPC7gMll,bWdj2GDclj5ofokWjzoa5jAwMkxCykd6,80,143,101,243,71,47,62,2,669,95.57142857142857,22,0.0,19,101,205,71,124,47,38,62,2,396,273,0
595,5092,EiO5bky9R1Iqlpv4ItUpPBUgGb1eJItE,A3fsA9Zfv1X2fVEQhTw51lKENdNrEqT3,32,116,11,20,6,216,79,0,448,64.0,11,0.0,3,11,17,6,113,216,3,79,0,37,411,1
596,5106,77HeNUdRA0IEkObqGpfDRUjK9MGFXlcs,SpATywNh6bZuzm8s1ceuBUnMUAeoAHHw,22,63,31,5,24,5,19,0,147,21.0,5,0.0,0,31,4,24,63,5,1,19,0,59,88,0
597,5112,eXHbDnPXGOepjGY8R1QdCMeSWp9NDZZc,SpATywNh6bZuzm8s1ceuBUnMUAeoAHHw,58,140,67,33,27,17,14,0,298,42.57142857142857,9,0.0,29,67,31,27,111,17,2,14,0,154,144,0
598,5114,3SWDgl41jXPWPBCB5sVpNEwmW9L3MerS,SpATywNh6bZuzm8s1ceuBUnMUAeoAHHw,56,81,51,49,26,0,11,0,218,31.142857142857142,12,0.0,14,51,43,26,67,0,6,11,0,134,84,0
599,5136,35QP8hkG1fMgJT5B2mWO7L1K5UDzKccP,SpATywNh6bZuzm8s1ceuBUnMUAeoAHHw,12,25,1,0,1,0,16,1,44,6.285714285714286,4,0.0,4,1,0,1,21,0,0,16,1,6,38,1
600,5148,uN992cfJ2NJqNQmns1XgyEcZyWUiJR0U,SpATywNh6bZuzm8s1ceuBUnMUAeoAHHw,42,148,28,27,8,25,46,2,284,40.57142857142857,14,0.0,37,28,27,8,111,25,0,46,2,100,184,0
601,5163,nOBQYWrG3xrA9IeoO0kkFbpfztBbno3g,A3fsA9Zfv1X2fVEQhTw51lKENdNrEqT3,20,11,8,0,7,1,6,0,33,4.714285714285714,2,0.0,0,8,0,7,11,1,0,6,0,15,18,1
602,5168,UWuyaaoLwLnyFDmtW8yT3lff7bHBBBqe,SpATywNh6bZuzm8s1ceuBUnMUAeoAHHw,39,122,12,50,11,6,28,6,235,33.57142857142857,17,0.0,14,12,45,11,108,6,5,28,6,82,153,0
603,5176,Qi3PLuC7w2Yo9hFgq37MObjY8icnRdc6,5X6FeZozNMgE2VRi3MJYjkkFK8SETtu2,4,3,1,0,1,0,1,0,6,0.8571428571428571,1,0.0,0,1,0,1,3,0,0,1,0,2,4,1
604,5205,VhlYBZ7MZgP2ChzlwqizJv2MimYYdGta,SpATywNh6bZuzm8s1ceuBUnMUAeoAHHw,26,36,22,15,15,0,10,4,102,14.571428571428571,4,0.0,2,22,15,15,34,0,0,10,4,54,48,1
605,5209,884KSEusRiMlLTSulMFf41A22MivDNwN,G8EPVSXsOYB5YQWZGiz1aVq5Pgr2GrQu,7,3,2,0,2,0,5,0,12,1.7142857142857142,1,0.0,0,2,0,2,3,0,0,5,0,4,8,1
606,5212,4HfbFsCyYszJO7w4OHW3KiOw346tCEQ3,SpATywNh6bZuzm8s1ceuBUnMUAeoAHHw,27,26,13,19,7,0,2,0,67,9.571428571428571,2,0.0,11,13,18,7,15,0,1,2,0,49,18,1
607,5238,S4uinMe8PGabKcmtVdXuBZWFnRj2oMAw,bWdj2GDclj5ofokWjzoa5jAwMkxCykd6,1,0,0,0,0,0,1,0,1,0.14285714285714285,1,0.0,0,0,0,0,0,0,0,1,0,0,1,1
608,5245,17IsanlXziT2tczTSDkapcsRHmSWuCWH,SpATywNh6bZuzm8s1ceuBUnMUAeoAHHw,16,67,7,0,8,0,10,0,92,13.142857142857142,5,0.0,10,7,0,8,57,0,0,10,0,25,67,0
609,5249,TCQ7j55cp3iQY2crxSrod75YneerL94o,SpATywNh6bZuzm8s1ceuBUnMUAeoAHHw,29,35,16,29,7,4,15,0,106,15.142857142857142,6,0.0,12,16,27,7,23,4,2,15,0,62,44,1
610,5255,0NbLYZNvmNdh82upKkBVVwJoa5b6RKVj,SpATywNh6bZuzm8s1ceuBUnMUAeoAHHw,40,81,29,42,10,18,33,6,219,31.285714285714285,8,0.0,7,29,35,10,74,18,7,33,6,81,138,0
611,5272,ClI23A4eXCdUFVQKR5uvI4exGZKJHgkV,SpATywNh6bZuzm8s1ceuBUnMUAeoAHHw,6,6,0,0,0,0,2,0,8,1.1428571428571428,4,0.0,0,0,0,0,6,0,0,2,0,0,8,1
612,5280,nsvq9MYt4IahoN4kXXFtAP2mFM9VmORm,SpATywNh6bZuzm8s1ceuBUnMUAeoAHHw,20,25,12,18,6,20,8,0,89,12.714285714285714,2,0.0,7,12,16,6,18,20,2,8,0,41,48,1
613,5284,QqE2Xjwy9gUzOvFdkDqAwAaNZLBZkxvd,RXDvfPUBYFlVdlueBFbLW0mhhAyGEqpt,70,359,26,113,17,254,140,1,910,130.0,26,0.0,27,26,103,17,332,254,10,140,1,173,737,0
614,5290,4xEpIgR9alQqM4xeSug69KmBmO9gpD69,A3fsA9Zfv1X2fVEQhTw51lKENdNrEqT3,132,208,115,178,63,79,98,6,747,106.71428571428571,16,0.0,11,115,160,63,197,79,18,98,6,349,398,0
615,5293,Ta6WQlpuBnJV22uRUjTDrQopOfeygKUE,5X6FeZozNMgE2VRi3MJYjkkFK8SETtu2,25,34,12,44,11,0,4,0,105,15.0,2,0.0,19,12,34,11,15,0,10,4,0,76,29,1
616,5294,KZD0EIKZJQdXNs947RuceyEoKIUwV8dz,SpATywNh6bZuzm8s1ceuBUnMUAeoAHHw,1,0,0,0,0,0,1,0,1,0.14285714285714285,1,0.0,0,0,0,0,0,0,0,1,0,0,1,1
617,5311,SFbTZDEo0JTOG7VHfxeJz2kz3qSzlHq4,SpATywNh6bZuzm8s1ceuBUnMUAeoAHHw,39,69,3,75,0,0,12,0,159,22.714285714285715,9,0.0,30,3,65,0,39,0,10,12,0,98,61,0
618,5316,0tT4cQq52T8bu4irQ9KewNXtlD33hVZo,SpATywNh6bZuzm8s1ceuBUnMUAeoAHHw,45,62,34,47,14,4,22,1,184,26.285714285714285,8,0.0,11,34,43,14,51,4,4,22,1,102,82,0
619,5337,a6f3gPi6axX0cfBnUGVliBDQrPx92l1r,bWdj2GDclj5ofokWjzoa5jAwMkxCykd6,58,237,110,205,72,42,38,2,706,100.85714285714286,16,0.0,74,110,173,72,163,42,32,38,2,429,277,1
620,5368,dXV6CXhMuL2MovsaBcVnWuwVAfDnBy3D,A3fsA9Zfv1X2fVEQhTw51lKENdNrEqT3,12,18,0,0,0,54,9,0,81,11.571428571428571,4,0.0,0,0,0,0,18,54,0,9,0,0,81,1
621,5369,AcgDUm5SSEb0zgM8tYKiOFvTewc0KRAc,SpATywNh6bZuzm8s1ceuBUnMUAeoAHHw,61,71,45,41,23,4,18,1,203,29.0,9,0.0,18,45,38,23,53,4,3,18,1,124,79,0
622,5374,Z9h5SEHVh1MWbNBNnOXUduD5djAjdPpF,SpATywNh6bZuzm8s1ceuBUnMUAeoAHHw,2,0,0,0,0,0,3,0,3,0.42857142857142855,1,0.0,0,0,0,0,0,0,0,3,0,0,3,1
623,5416,nds56JS5tgInTRshD1ZJkwXi4oW5Ln7a,RXDvfPUBYFlVdlueBFbLW0mhhAyGEqpt,98,200,110,219,44,145,75,2,795,113.57142857142857,22,0.0,29,110,200,44,171,145,19,75,2,383,412,0
624,5431,VnkZQ14wQqfipOllRb5zJLKqrvJ7kfcr,A3fsA9Zfv1X2fVEQhTw51lKENdNrEqT3,1,0,0,0,0,0,2,0,2,0.2857142857142857,2,0.0,0,0,0,0,0,0,0,2,0,0,2,1
625,5435,90Sn7UxaiRTmCSrIbSNevcUMokJI9XYS,A3fsA9Zfv1X2fVEQhTw51lKENdNrEqT3,11,14,1,0,1,0,3,0,19,2.7142857142857144,2,0.0,0,1,0,1,14,0,0,3,0,2,17,1
626,5439,vUerya30clLdh9EQX34ayPT3Cr8C7lb8,A3fsA9Zfv1X2fVEQhTw51lKENdNrEqT3,6,7,0,0,0,0,3,0,10,1.4285714285714286,1,0.0,0,0,0,0,7,0,0,3,0,0,10,1
627,5470,acVvGaaH1iVFQOYF94V9THpGPkF7EIj3,SpATywNh6bZuzm8s1ceuBUnMUAeoAHHw,30,58,28,50,11,16,28,3,194,27.714285714285715,6,0.0,19,28,44,11,39,16,6,28,3,102,92,0
628,5471,ZWj0iRzT4HOMV032BfEyYj9IEk1Rdo03,SpATywNh6bZuzm8s1ceuBUnMUAeoAHHw,56,161,35,68,12,113,48,3,440,62.857142857142854,11,0.0,61,35,59,12,100,113,9,48,3,167,273,0
629,5482,lfAQ0nsHdkBDoIcTW4jXyPy4wOsVYtMB,RXDvfPUBYFlVdlueBFbLW0mhhAyGEqpt,108,124,70,257,37,18,35,4,545,77.85714285714286,10,0.0,40,70,240,37,84,18,17,35,4,387,158,1
630,5484,DjQWiwlbqq88H7QziTtErXo3yBTqRc6U,A3fsA9Zfv1X2fVEQhTw51lKENdNrEqT3,9,10,4,0,0,1,7,1,23,3.2857142857142856,6,0.0,0,4,0,0,10,1,0,7,1,4,19,1
631,5495,xsW19PmjvHmfOgtSCjdxnkpzOWqbKfLn,SpATywNh6bZuzm8s1ceuBUnMUAeoAHHw,63,146,66,49,22,33,52,3,371,53.0,15,0.0,56,66,42,22,90,33,7,52,3,186,185,0
632,5507,n3cFXGx3rjoPJPOmeF5tlnmkFmFFJI7p,5X6FeZozNMgE2VRi3MJYjkkFK8SETtu2,5,2,1,0,1,0,2,0,6,0.8571428571428571,1,0.0,0,1,0,1,2,0,0,2,0,2,4,1
633,5509,BSZDIT15eAtNgfldCBCd9uZr5nmLTo1Y,RXDvfPUBYFlVdlueBFbLW0mhhAyGEqpt,1,0,0,0,0,0,1,0,1,0.14285714285714285,1,0.0,0,0,0,0,0,0,0,1,0,0,1,1
634,5519,BsWy5ImeTPQvYgOCRPYHOm3gBOyZfxYj,SpATywNh6bZuzm8s1ceuBUnMUAeoAHHw,19,24,12,14,8,0,5,0,63,9.0,4,0.0,7,12,14,8,17,0,0,5,0,41,22,0
635,5523,njb10SfHXKB30cApzPJzWBcqA8VQx0HA,SpATywNh6bZuzm8s1ceuBUnMUAeoAHHw,3,0,0,0,0,0,4,0,4,0.5714285714285714,2,0.0,0,0,0,0,0,0,0,4,0,0,4,1
636,5546,sc5S8mzwcw7LbcetViv5Dahuhyet4uF1,SpATywNh6bZuzm8s1ceuBUnMUAeoAHHw,19,36,10,36,0,25,14,3,124,17.714285714285715,4,0.0,17,10,30,0,19,25,6,14,3,57,67,0
637,5548,c0aU5RgllqMj1NNDQEzDSUbWmFuFrvQ6,5X6FeZozNMgE2VRi3MJYjkkFK8SETtu2,6,3,2,0,2,0,2,0,9,1.2857142857142858,1,0.0,0,2,0,2,3,0,0,2,0,4,5,1
638,5558,WRVD7vy9jlNHm0bah44rHP1heNWkqPcT,G8EPVSXsOYB5YQWZGiz1aVq5Pgr2GrQu,1,0,0,0,0,0,1,0,1,0.14285714285714285,1,0.0,0,0,0,0,0,0,0,1,0,0,1,1
639,5562,XERB0lrfKs66PgzJO1IOD0FHZqNqZnJ6,G8EPVSXsOYB5YQWZGiz1aVq5Pgr2GrQu,5,2,1,0,1,0,2,0,6,0.8571428571428571,1,0.0,0,1,0,1,2,0,0,2,0,2,4,1
640,5584,Qt99KRFUK6FY5ovJvB9yRLziSf5bEirX,SpATywNh6bZuzm8s1ceuBUnMUAeoAHHw,25,44,19,8,9,1,11,1,93,13.285714285714286,4,0.0,6,19,8,9,38,1,0,11,1,42,51,1
641,5585,9SqAB4FNYGY3EljMvCEjcqYhPFLwBD3j,SpATywNh6bZuzm8s1ceuBUnMUAeoAHHw,7,3,0,0,0,16,7,1,27,3.857142857142857,1,0.0,0,0,0,0,3,16,0,7,1,0,27,1
642,5606,Ecxkox9cBNw9DlXWEeDlSJP4O73ORQaY,SpATywNh6bZuzm8s1ceuBUnMUAeoAHHw,7,30,6,0,2,0,5,0,43,6.142857142857143,8,0.0,0,6,0,2,30,0,0,5,0,8,35,0
643,5621,3rCZba8eKP7jaFsDjNb32WoGn9BjnrjN,A3fsA9Zfv1X2fVEQhTw51lKENdNrEqT3,38,44,21,86,13,35,11,0,210,30.0,4,0.0,7,21,68,13,37,35,18,11,0,109,101,1
644,5623,0V0UTSnfmpjJ4ctKxsLk1IHNpN42J6mH,G8EPVSXsOYB5YQWZGiz1aVq5Pgr2GrQu,4,2,0,0,0,0,3,0,5,0.7142857142857143,1,0.0,0,0,0,0,2,0,0,3,0,0,5,1
645,5635,7bFemKDlww8gPchsZMuFNOn3TtHTqbHw,bWdj2GDclj5ofokWjzoa5jAwMkxCykd6,6,7,2,0,1,0,11,0,21,3.0,3,0.0,0,2,0,1,7,0,0,11,0,3,18,1
646,5641,dzQyKxZ43BiLWGC6nfqSfnHfJKyWUbky,SpATywNh6bZuzm8s1ceuBUnMUAeoAHHw,17,18,14,2,10,0,5,0,49,7.0,2,0.0,0,14,2,10,18,0,0,5,0,26,23,1
647,5642,IAvuP4GGmvnNj3Zisz3jDfo3mSmXiJSb,A3fsA9Zfv1X2fVEQhTw51lKENdNrEqT3,34,108,4,56,2,0,13,0,183,26.142857142857142,9,0.0,0,4,44,2,108,0,12,13,0,50,133,1
648,5644,J388HMX5pYHjqXdA7jEUkFec6orRQtIq,A3fsA9Zfv1X2fVEQhTw51lKENdNrEqT3,74,109,50,0,22,0,20,0,201,28.714285714285715,5,0.0,0,50,0,22,109,0,0,20,0,72,129,0
649,5655,PztWYF4ZTLP8rvUvCUcN3hQiYuYJPY9t,bWdj2GDclj5ofokWjzoa5jAwMkxCykd6,7,14,4,0,1,0,7,0,26,3.7142857142857144,3,0.0,0,4,0,1,14,0,0,7,0,5,21,1
650,5660,CZZkgDgsqVR6ftNFrTmx0jPpBHh2f3Zo,SpATywNh6bZuzm8s1ceuBUnMUAeoAHHw,42,201,9,51,3,97,66,2,429,61.285714285714285,19,0.0,45,9,46,3,156,97,5,66,2,103,326,0
651,5663,1QA0SqfAW0hFBv6FjoAHgHRHfBlvLSPL,A3fsA9Zfv1X2fVEQhTw51lKENdNrEqT3,4,2,0,0,0,0,3,0,5,0.7142857142857143,2,0.0,0,0,0,0,2,0,0,3,0,0,5,1
652,5671,HbDaABEakQmE8DQEoFoIphu2SH13rFRy,A3fsA9Zfv1X2fVEQhTw51lKENdNrEqT3,45,27,21,80,14,0,5,0,147,21.0,5,0.0,1,21,69,14,26,0,11,5,0,105,42,1
653,5672,HbDaABEakQmE8DQEoFoIphu2SH13rFRy,bWdj2GDclj5ofokWjzoa5jAwMkxCykd6,5,6,3,0,1,0,4,0,14,2.0,3,0.0,0,3,0,1,6,0,0,4,0,4,10,1
654,5675,HbDaABEakQmE8DQEoFoIphu2SH13rFRy,RXDvfPUBYFlVdlueBFbLW0mhhAyGEqpt,13,15,10,8,3,0,5,0,41,5.857142857142857,4,0.0,1,10,7,3,14,0,1,5,0,21,20,1
655,5702,C6xrhZPOmVH2gCVNP26gSSPka2CcwgB5,bWdj2GDclj5ofokWjzoa5jAwMkxCykd6,25,24,15,82,11,13,11,0,156,22.285714285714285,3,0.0,9,15,78,11,15,13,4,11,0,113,43,1
656,5705,TwYAYdYU7yn5FjnP72W4DEwE8N7Dqkqq,bWdj2GDclj5ofokWjzoa5jAwMkxCykd6,8,10,2,0,2,1,8,0,23,3.2857142857142856,3,0.0,0,2,0,2,10,1,0,8,0,4,19,1
657,5709,PUW0i4IuafllkJEtV0GCqmTDeLHkDmH3,5X6FeZozNMgE2VRi3MJYjkkFK8SETtu2,16,56,25,4,15,1,12,0,113,16.142857142857142,4,0.0,20,25,3,15,36,1,1,12,0,63,50,1
658,5724,9b2fchNyVZPjqpmxjleqzL9edi9EOH23,SpATywNh6bZuzm8s1ceuBUnMUAeoAHHw,6,1,1,0,1,0,4,0,7,1.0,2,0.0,0,1,0,1,1,0,0,4,0,2,5,1
659,5740,PizUKf6mRUas66X3VMYXf9aygnN1CUCf,SpATywNh6bZuzm8s1ceuBUnMUAeoAHHw,36,65,34,24,23,18,10,5,179,25.571428571428573,3,0.0,25,34,20,23,40,18,4,10,5,102,77,1
660,5742,SfZbjjvyiSDCCOAoK4WFbDb5dRmW5oVl,5X6FeZozNMgE2VRi3MJYjkkFK8SETtu2,1,0,0,0,0,0,1,0,1,0.14285714285714285,1,0.0,0,0,0,0,0,0,0,1,0,0,1,1
661,5743,57qzgJAwfROYPxzSOrsA3G5DLHP95ajU,RXDvfPUBYFlVdlueBFbLW0mhhAyGEqpt,53,68,51,0,28,0,19,0,166,23.714285714285715,11,0.0,3,51,0,28,65,0,0,19,0,82,84,0
662,5746,seRgjh60dHSex83x3yaP07EkHkNZ3zq1,SpATywNh6bZuzm8s1ceuBUnMUAeoAHHw,36,80,41,36,17,17,18,1,210,30.0,12,0.0,25,41,32,17,55,17,4,18,1,115,95,0
663,5768,ytK9EwjDrcEsoXMvgjh9BEVuEXIjTD3M,bWdj2GDclj5ofokWjzoa5jAwMkxCykd6,7,4,2,0,2,0,4,0,12,1.7142857142857142,1,0.0,0,2,0,2,4,0,0,4,0,4,8,1
664,5777,FVINYuQhNwQ1IBS2HaRVFMtFczGjKWmz,SpATywNh6bZuzm8s1ceuBUnMUAeoAHHw,1,0,0,0,0,0,1,0,1,0.14285714285714285,1,0.0,0,0,0,0,0,0,0,1,0,0,1,1
665,5781,D2S5bjWjmtwLivqx7n7FZWso5Kd6We5x,bWdj2GDclj5ofokWjzoa5jAwMkxCykd6,29,51,10,83,3,1,11,0,159,22.714285714285715,5,0.0,14,10,74,3,37,1,9,11,0,101,58,0
666,5785,Llzpy0Dk1LPSE6nBLZ8vNVNgQXCzGpc1,SpATywNh6bZuzm8s1ceuBUnMUAeoAHHw,45,62,38,35,22,0,23,2,182,26.0,10,0.0,8,38,31,22,54,0,4,23,2,99,83,1
667,5788,zysr84QD6b78mLaezXoryEdhH6kH14EQ,SpATywNh6bZuzm8s1ceuBUnMUAeoAHHw,31,50,27,32,11,0,15,0,135,19.285714285714285,10,0.0,9,27,30,11,41,0,2,15,0,77,58,0
668,5789,C6xrhZPOmVH2gCVNP26gSSPka2CcwgB5,5X6FeZozNMgE2VRi3MJYjkkFK8SETtu2,16,21,6,14,10,0,10,0,61,8.714285714285714,2,0.0,15,6,13,10,6,0,1,10,0,44,17,1
669,5792,GIb3glgYrsEfHWtEWPWpwONqwE7RMf6f,bWdj2GDclj5ofokWjzoa5jAwMkxCykd6,93,307,155,247,26,181,105,5,1026,146.57142857142858,23,0.0,29,155,222,26,278,181,25,105,5,432,594,0
670,5801,NMqhcmmxkLiM0RcDlPlkNnMgmo9q8VT7,5X6FeZozNMgE2VRi3MJYjkkFK8SETtu2,8,8,3,0,7,0,1,0,19,2.7142857142857144,1,0.0,4,3,0,7,4,0,0,1,0,14,5,1
671,5802,8tzllCaQFf5FO2XcYgqoYiMGBjUwujYx,A3fsA9Zfv1X2fVEQhTw51lKENdNrEqT3,5,3,0,0,0,0,4,0,7,1.0,1,0.0,0,0,0,0,3,0,0,4,0,0,7,1
672,5803,sD3rDh1CtXsAdfDDyFRBf917K7ELQzHQ,SpATywNh6bZuzm8s1ceuBUnMUAeoAHHw,39,134,34,56,10,0,36,0,270,38.57142857142857,12,0.0,29,34,52,10,105,0,4,36,0,125,145,0
673,5805,VUYRWxIK25dyFla7xdkPw6qN6gZPPejU,SpATywNh6bZuzm8s1ceuBUnMUAeoAHHw,20,37,25,6,10,0,14,0,92,13.142857142857142,4,0.0,2,25,6,10,35,0,0,14,0,43,49,0
674,5807,8tzllCaQFf5FO2XcYgqoYiMGBjUwujYx,bWdj2GDclj5ofokWjzoa5jAwMkxCykd6,5,15,0,0,1,0,6,0,22,3.142857142857143,2,0.0,3,0,0,1,12,0,0,6,0,4,18,1
675,5822,yXIAbgjR7S4042oicRyG8kfTX0pG8yI5,SpATywNh6bZuzm8s1ceuBUnMUAeoAHHw,27,50,6,14,6,4,6,0,86,12.285714285714286,4,0.0,8,6,13,6,42,4,1,6,0,33,53,0
676,5826,zTf8XOQnwWWl1KDwh9NJmoY9QiDPt6oU,SpATywNh6bZuzm8s1ceuBUnMUAeoAHHw,34,79,45,42,14,0,28,1,209,29.857142857142858,13,0.0,20,45,41,14,59,0,1,28,1,120,89,0
677,5827,IXG6Mrr8VTjEEQIqeVi1KlyYwZ2T4ziy,A3fsA9Zfv1X2fVEQhTw51lKENdNrEqT3,4,2,1,0,1,0,1,0,5,0.7142857142857143,1,0.0,0,1,0,1,2,0,0,1,0,2,3,0
678,5841,eKmIYKU6Yx5AUBketpCKhFRjn0XSrN5J,SpATywNh6bZuzm8s1ceuBUnMUAeoAHHw,30,54,31,22,16,3,16,1,143,20.428571428571427,3,0.0,8,31,22,16,46,3,0,16,1,77,66,0
679,5865,Ojf2FGMPjkgcQ8cOS7KSlXqYowZOsPoh,A3fsA9Zfv1X2fVEQhTw51lKENdNrEqT3,14,27,14,0,2,2,13,0,58,8.285714285714286,9,0.0,0,14,0,2,27,2,0,13,0,16,42,0
680,5876,5hXpDY3fUOWXeNSNssxdgQEXyy5gGZpD,SpATywNh6bZuzm8s1ceuBUnMUAeoAHHw,6,5,1,0,1,0,2,0,9,1.2857142857142858,1,0.0,1,1,0,1,4,0,0,2,0,3,6,1
681,5890,8c2gk77rfHeG4kEZpifVHT547X2ayTNE,RXDvfPUBYFlVdlueBFbLW0mhhAyGEqpt,72,143,88,143,31,51,48,4,508,72.57142857142857,9,0.0,28,88,139,31,115,51,4,48,4,286,222,0
682,5891,PenDUeO0eoR8hyLVdfPN6H7q2FnTGMus,5X6FeZozNMgE2VRi3MJYjkkFK8SETtu2,9,15,2,2,1,7,7,1,35,5.0,1,0.0,8,2,2,1,7,7,0,7,1,13,22,1
683,5892,1YxknoiTrSwQgclDlSAh4oMYHRyARhLv,SpATywNh6bZuzm8s1ceuBUnMUAeoAHHw,28,50,19,17,6,0,15,0,107,15.285714285714286,9,0.0,22,19,17,6,28,0,0,15,0,64,43,0
684,5894,biGiKcwkAdzTvOFIAeW8Vs1H1jbCmhSY,SpATywNh6bZuzm8s1ceuBUnMUAeoAHHw,4,2,0,0,0,0,2,0,4,0.5714285714285714,1,0.0,0,0,0,0,2,0,0,2,0,0,4,1
685,5902,7o8xhk1rh0BQyK6zL1slDKappRA3D8Mk,SpATywNh6bZuzm8s1ceuBUnMUAeoAHHw,37,56,10,38,8,4,41,2,159,22.714285714285715,6,0.0,13,10,37,8,43,4,1,41,2,68,91,0
686,5927,vYyC3PI9WOfKd54xBrxSVvrhn62CQxzz,SpATywNh6bZuzm8s1ceuBUnMUAeoAHHw,26,31,20,13,9,0,5,0,78,11.142857142857142,5,0.0,4,20,13,9,27,0,0,5,0,46,32,1
687,5934,hdKqkkWKrDzbKE9btGChBqiCfsTwp68E,A3fsA9Zfv1X2fVEQhTw51lKENdNrEqT3,37,41,27,28,12,62,45,3,218,31.142857142857142,12,0.0,2,27,23,12,39,62,5,45,3,64,154,0
688,5966,ClOQgL2YoKdTIw9nVe15uHQUMfFPajE3,5X6FeZozNMgE2VRi3MJYjkkFK8SETtu2,13,16,1,16,1,3,16,3,56,8.0,1,0.0,8,1,13,1,8,3,3,16,3,23,33,1
689,5971,XVAvU5kUUejQSld1XjHX8mt1uGOkgzW4,RXDvfPUBYFlVdlueBFbLW0mhhAyGEqpt,9,6,5,0,3,0,2,0,16,2.2857142857142856,2,0.0,0,5,0,3,6,0,0,2,0,8,8,1
690,6001,Wb4KcRKSzKNnIp1HnFKSZY95LILGuTll,SpATywNh6bZuzm8s1ceuBUnMUAeoAHHw,34,53,0,43,1,1,9,0,107,15.285714285714286,3,0.0,16,0,38,1,37,1,5,9,0,55,52,0
691,6004,dlFVVLBV3ZD4RhjUk38UJOj8FktRTHQw,SpATywNh6bZuzm8s1ceuBUnMUAeoAHHw,1,0,0,0,0,0,2,0,2,0.2857142857142857,2,0.0,0,0,0,0,0,0,0,2,0,0,2,1
692,6018,cJcuhtji0eqLhfXtnFSDlw6v5huTlvOS,SpATywNh6bZuzm8s1ceuBUnMUAeoAHHw,31,49,1,41,1,5,15,1,113,16.142857142857142,8,0.0,18,1,32,1,31,5,9,15,1,52,61,0
693,6022,zzh7OhB1yuFx7KNMW6cKx1t3e2ezVcvZ,SpATywNh6bZuzm8s1ceuBUnMUAeoAHHw,6,4,1,0,1,0,2,0,8,1.1428571428571428,1,0.0,0,1,0,1,4,0,0,2,0,2,6,1
694,6031,H2B0ZVh2RYo5LjimmBQ15UDjcAOL7h2y,A3fsA9Zfv1X2fVEQhTw51lKENdNrEqT3,9,3,3,0,3,0,11,1,21,3.0,3,0.0,0,3,0,3,3,0,0,11,1,6,15,1
695,6032,sc5S8mzwcw7LbcetViv5Dahuhyet4uF1,bWdj2GDclj5ofokWjzoa5jAwMkxCykd6,17,17,9,16,1,24,12,1,80,11.428571428571429,3,0.0,0,9,16,1,17,24,0,12,1,26,54,1
696,6048,hf7YI3B1kTTuvmd2vS9DIoiPGXbrQyBH,SpATywNh6bZuzm8s1ceuBUnMUAeoAHHw,37,68,10,34,7,59,28,0,206,29.428571428571427,9,0.0,19,10,28,7,49,59,6,28,0,64,142,0
697,6058,KrIVcXIiCdwRGUI4WguKXHPsvZChbtIb,A3fsA9Zfv1X2fVEQhTw51lKENdNrEqT3,99,98,70,242,31,127,35,0,603,86.14285714285714,12,0.0,5,70,188,31,93,127,54,35,0,294,309,0
698,6059,RDBly29xbybxfRPXjsOP81xd2Sgww6yI,bWdj2GDclj5ofokWjzoa5jAwMkxCykd6,8,11,5,34,3,0,15,0,68,9.714285714285714,5,0.0,1,5,33,3,10,0,1,15,0,42,26,1
699,6061,KrIVcXIiCdwRGUI4WguKXHPsvZChbtIb,5X6FeZozNMgE2VRi3MJYjkkFK8SETtu2,30,71,32,52,13,55,27,0,250,35.714285714285715,12,0.0,19,32,41,13,52,55,11,27,0,105,145,0
700,6069,imazrFpyX68kLUAydat119Z5XKshja9y,SpATywNh6bZuzm8s1ceuBUnMUAeoAHHw,37,50,31,38,10,0,13,0,142,20.285714285714285,10,0.0,8,31,36,10,42,0,2,13,0,85,57,0
701,6084,egIcBO9xXh5XDAWBOR2C58eTHcHVaPTq,SpATywNh6bZuzm8s1ceuBUnMUAeoAHHw,10,7,5,0,3,31,5,0,51,7.285714285714286,4,0.0,0,5,0,3,7,31,0,5,0,8,43,1
702,6086,ZL7VsgZBlKFfi6BGNSyN1gGJros1L9ra,SpATywNh6bZuzm8s1ceuBUnMUAeoAHHw,36,68,25,23,9,49,28,1,203,29.0,5,0.0,18,25,19,9,50,49,4,28,1,71,132,1
703,6087,uUWoPLkJSFKbD6KppcebOwMXezopCcLj,SpATywNh6bZuzm8s1ceuBUnMUAeoAHHw,30,214,24,52,8,28,47,1,374,53.42857142857143,9,0.0,67,24,44,8,147,28,8,47,1,143,231,0
704,6090,Qsrx4kwwBFByqyYPAbCeTAurBzPDhOG4,SpATywNh6bZuzm8s1ceuBUnMUAeoAHHw,5,6,3,0,1,0,3,0,13,1.8571428571428572,3,0.0,0,3,0,1,6,0,0,3,0,4,9,1
705,6125,CovNnemmooeYpLX2YfcP75dIKg65MoIW,SpATywNh6bZuzm8s1ceuBUnMUAeoAHHw,4,2,1,0,1,0,1,0,5,0.7142857142857143,1,0.0,0,1,0,1,2,0,0,1,0,2,3,1
706,6135,bJ0ocYs4A8xL8l054ix6Xw9bRk0Rp5no,5X6FeZozNMgE2VRi3MJYjkkFK8SETtu2,7,13,0,6,0,1,9,1,30,4.285714285714286,4,0.0,0,0,6,0,13,1,0,9,1,6,24,1
707,6136,sF8Qur7NIXPGJG744QNBCJLJgM51K1cT,SpATywNh6bZuzm8s1ceuBUnMUAeoAHHw,10,20,9,0,4,2,7,0,42,6.0,3,0.0,3,9,0,4,17,2,0,7,0,16,26,1
708,6184,Ui5s6msHQkQWoojIHrlye6CrlPfuJtqr,SpATywNh6bZuzm8s1ceuBUnMUAeoAHHw,7,4,1,0,1,0,2,0,8,1.1428571428571428,1,0.0,0,1,0,1,4,0,0,2,0,2,6,1
709,6197,6A2JLpLWnCwUlo9pD1HHlgEwNLvzcllv,SpATywNh6bZuzm8s1ceuBUnMUAeoAHHw,22,24,14,12,8,0,6,0,64,9.142857142857142,5,0.0,4,14,9,8,20,0,3,6,0,35,29,1
710,6200,P1GB7lMEFMwTm3zg0Vd2JWGeu5aUPfGc,bWdj2GDclj5ofokWjzoa5jAwMkxCykd6,1,0,0,0,0,0,1,0,1,0.14285714285714285,1,0.0,0,0,0,0,0,0,0,1,0,0,1,1
711,6203,qwOn6svjZUr6PbEPbdgCynJcocJs2Tff,SpATywNh6bZuzm8s1ceuBUnMUAeoAHHw,47,69,36,25,19,20,27,2,198,28.285714285714285,9,0.0,11,36,25,19,58,20,0,27,2,91,107,0
712,6215,FgYPvBwLri7YiFI9og6clP9FuKJ08jX7,SpATywNh6bZuzm8s1ceuBUnMUAeoAHHw,50,66,36,28,18,1,10,0,159,22.714285714285715,8,0.0,16,36,27,18,50,1,1,10,0,97,62,1
713,6217,xVu6NAX59MOmpApYDfs9WPe7YPPVhsFD,A3fsA9Zfv1X2fVEQhTw51lKENdNrEqT3,44,35,8,62,7,5,11,1,129,18.428571428571427,3,0.0,1,8,53,7,34,5,9,11,1,69,60,1
714,6222,2CJPniJdzPQB2xVD7usFld4N6998DubA,SpATywNh6bZuzm8s1ceuBUnMUAeoAHHw,60,92,49,56,25,36,45,3,306,43.714285714285715,13,0.0,29,49,43,25,63,36,13,45,3,146,160,0
715,6225,f2GMLkjrqGdN19ysxF64zEiQj9fxR4cG,5X6FeZozNMgE2VRi3MJYjkkFK8SETtu2,2,0,0,0,0,0,4,0,4,0.5714285714285714,1,0.0,0,0,0,0,0,0,0,4,0,0,4,1
716,6235,ywdL3xkp7d2PSjbvnflAvIe7Wp6Q4SRe,A3fsA9Zfv1X2fVEQhTw51lKENdNrEqT3,130,90,34,358,23,0,29,0,534,76.28571428571429,11,0.0,4,34,334,23,86,0,24,29,0,395,139,0
717,6238,rc6U1IMtYVyu2KS4UAAUQ2nFc3tipLM4,SpATywNh6bZuzm8s1ceuBUnMUAeoAHHw,3,0,0,0,0,0,3,0,3,0.42857142857142855,1,0.0,0,0,0,0,0,0,0,3,0,0,3,1
718,6241,JOowoFboUWVsMh86KvKaqn28cyqJccLu,SpATywNh6bZuzm8s1ceuBUnMUAeoAHHw,42,106,7,62,1,32,28,1,237,33.857142857142854,13,0.0,33,7,52,1,73,32,10,28,1,93,144,1
719,6249,wlfhNc0EqwNzSbWGuR5Gw22PX4idrOB9,5X6FeZozNMgE2VRi3MJYjkkFK8SETtu2,30,88,25,44,24,0,20,1,202,28.857142857142858,5,0.0,48,25,36,24,40,0,8,20,1,133,69,1
720,6251,xHZbSROhwP4RRQerUVWvcNTfOGc2DHWf,A3fsA9Zfv1X2fVEQhTw51lKENdNrEqT3,164,201,95,539,33,191,105,2,1166,166.57142857142858,24,0.0,14,95,421,33,187,191,118,105,2,563,603,0
721,6275,CMyYXmkdotyZIBj4pIMXARl4LU8dOntR,RXDvfPUBYFlVdlueBFbLW0mhhAyGEqpt,15,13,6,0,3,4,7,3,36,5.142857142857143,1,0.0,2,6,0,3,11,4,0,7,3,11,25,1
722,6276,e05jFgKTpMKrOATktordZrOlXAadcmLm,bWdj2GDclj5ofokWjzoa5jAwMkxCykd6,5,4,1,0,1,0,3,0,9,1.2857142857142858,3,0.0,0,1,0,1,4,0,0,3,0,2,7,1
723,6297,IBlNXwDR3MmRt5PBvnP44ynAugPBAbiq,A3fsA9Zfv1X2fVEQhTw51lKENdNrEqT3,8,12,5,0,0,0,5,0,22,3.142857142857143,4,0.0,0,5,0,0,12,0,0,5,0,5,17,1
724,6301,4NUGABfnQkRS9FoH90Vgnhdha4tRSmOB,A3fsA9Zfv1X2fVEQhTw51lKENdNrEqT3,129,143,96,252,44,0,42,0,577,82.42857142857143,22,0.0,10,96,198,44,133,0,54,42,0,348,229,0
725,6310,K0OSl2yDmHYQ9TtZdxy9shErNwx3ga0n,SpATywNh6bZuzm8s1ceuBUnMUAeoAHHw,13,13,5,20,1,0,2,0,41,5.857142857142857,2,0.0,6,5,19,1,7,0,1,2,0,31,10,1
726,6322,2IvFgMw0NfaiiFt35dmyYrQHt1TRMHZA,SpATywNh6bZuzm8s1ceuBUnMUAeoAHHw,60,130,52,68,20,127,100,7,504,72.0,8,0.0,42,52,60,20,88,127,8,100,7,174,330,0
727,6333,VRqncpDBm1hyq75gsrR3U5uyrx0nFI6D,G8EPVSXsOYB5YQWZGiz1aVq5Pgr2GrQu,9,13,6,0,3,0,4,0,26,3.7142857142857144,2,0.0,0,6,0,3,13,0,0,4,0,9,17,0
728,6344,e09uq36QgLuBVK5DERoejsHeMH2uPMRM,RXDvfPUBYFlVdlueBFbLW0mhhAyGEqpt,7,5,1,0,1,0,2,0,9,1.2857142857142858,1,0.0,0,1,0,1,5,0,0,2,0,2,7,1
729,6360,S6vBzHKpSh31SFGGZmwgKaOH2RvW3RpH,A3fsA9Zfv1X2fVEQhTw51lKENdNrEqT3,10,10,8,0,7,0,5,0,30,4.285714285714286,5,0.0,0,8,0,7,10,0,0,5,0,15,15,0
730,6361,8nT76hrzyl8ZAUdI7W6kfrIzHxI3puKM,A3fsA9Zfv1X2fVEQhTw51lKENdNrEqT3,102,85,0,332,0,0,29,0,446,63.714285714285715,11,0.0,8,0,297,0,77,0,35,29,0,305,141,0
731,6386,sgU8bYbkNg27HLTOfRzwWIg1HmjCd9Xd,SpATywNh6bZuzm8s1ceuBUnMUAeoAHHw,37,63,2,59,3,2,28,3,160,22.857142857142858,7,0.0,18,2,49,3,45,2,10,28,3,72,88,0
732,6391,VWT0erf4AD2BzAGMlVwaBcrhUFyVXGW3,SpATywNh6bZuzm8s1ceuBUnMUAeoAHHw,35,74,2,38,0,48,31,4,197,28.142857142857142,9,0.0,26,2,36,0,48,48,2,31,4,64,133,0
733,6396,mXsmDArxUTe9rMFHp3cGPJEx5ACYKD90,SpATywNh6bZuzm8s1ceuBUnMUAeoAHHw,54,107,41,57,15,137,25,2,384,54.857142857142854,13,0.0,33,41,47,15,74,137,10,25,2,136,248,0
734,6407,y7mamutAMELy79Bgdj0zOeVjiQ071oNX,SpATywNh6bZuzm8s1ceuBUnMUAeoAHHw,42,74,28,37,14,0,9,0,162,23.142857142857142,9,0.0,27,28,31,14,47,0,6,9,0,100,62,0
735,6419,ogzPi8CzE9rbCDvKtEdVGoEcOcn50cII,G8EPVSXsOYB5YQWZGiz1aVq5Pgr2GrQu,1,0,0,0,0,0,1,0,1,0.14285714285714285,1,0.0,0,0,0,0,0,0,0,1,0,0,1,1
736,6423,46NDON0KgB1jK61LBfpVyB2xpUlT8XUc,SpATywNh6bZuzm8s1ceuBUnMUAeoAHHw,4,2,0,0,0,0,4,0,6,0.8571428571428571,1,0.0,0,0,0,0,2,0,0,4,0,0,6,1
737,6427,vuqnfFRpmwKE9RdxK6XJMNF9m6H6VyTM,RXDvfPUBYFlVdlueBFbLW0mhhAyGEqpt,104,161,104,239,48,56,40,12,660,94.28571428571429,12,0.0,37,104,217,48,124,56,22,40,12,406,254,0
738,6453,thQSVbeIiNRLplpbUVbYa004tKe0jz1z,SpATywNh6bZuzm8s1ceuBUnMUAeoAHHw,17,33,4,14,0,0,8,0,59,8.428571428571429,4,0.0,2,4,12,0,31,0,2,8,0,18,41,1
739,6473,QYNtwRXZGk0TiZU9fvvZmyYTg9wzmVe8,bWdj2GDclj5ofokWjzoa5jAwMkxCykd6,59,135,11,195,5,290,119,4,759,108.42857142857143,18,0.0,24,11,171,5,111,290,24,119,4,211,548,0
740,6475,4NUGABfnQkRS9FoH90Vgnhdha4tRSmOB,SpATywNh6bZuzm8s1ceuBUnMUAeoAHHw,39,105,50,22,17,9,64,1,268,38.285714285714285,21,0.0,28,50,17,17,77,9,5,64,1,112,156,0
741,6476,5l7JbkjmfBonHdF7CbCa3GMejToAwTQZ,SpATywNh6bZuzm8s1ceuBUnMUAeoAHHw,20,39,6,24,0,8,25,2,104,14.857142857142858,5,0.0,15,6,21,0,24,8,3,25,2,42,62,1
742,6480,fFnDSL1hWADv25SE5UTFI35tGRTcYBEF,SpATywNh6bZuzm8s1ceuBUnMUAeoAHHw,25,58,4,30,2,1,11,0,106,15.142857142857142,4,0.0,14,4,26,2,44,1,4,11,0,46,60,0
743,6490,CozZoSX7AwprtwyJFCAeFUYiCq7OSEAP,G8EPVSXsOYB5YQWZGiz1aVq5Pgr2GrQu,26,72,27,0,24,0,3,0,126,18.0,6,0.0,0,27,0,24,72,0,0,3,0,51,75,0
744,6494,w1o1S1rsKOagmFCmrSXvpPsO3fHW3lAq,A3fsA9Zfv1X2fVEQhTw51lKENdNrEqT3,57,46,30,108,14,16,25,4,243,34.714285714285715,5,0.0,4,30,86,14,42,16,22,25,4,134,109,1
745,6497,QYNtwRXZGk0TiZU9fvvZmyYTg9wzmVe8,A3fsA9Zfv1X2fVEQhTw51lKENdNrEqT3,90,153,6,242,3,428,133,3,968,138.28571428571428,19,0.0,11,6,197,3,142,428,45,133,3,217,751,0
746,6502,MFUbiMqXEmfaBzK7hirtX5aBXDvqfQ39,RXDvfPUBYFlVdlueBFbLW0mhhAyGEqpt,32,42,27,34,13,4,13,1,134,19.142857142857142,6,0.0,8,27,31,13,34,4,3,13,1,79,55,0
747,6507,srJeJbIuD6nlvLtYdUFiQcvh7X1ghk8m,bWdj2GDclj5ofokWjzoa5jAwMkxCykd6,1,0,0,0,0,0,1,0,1,0.14285714285714285,1,0.0,0,0,0,0,0,0,0,1,0,0,1,1
748,6527,iYw8kPkvjn3xb3wtZEyAytTepRhqUlKj,SpATywNh6bZuzm8s1ceuBUnMUAeoAHHw,35,87,47,28,22,6,31,2,223,31.857142857142858,11,0.0,6,47,26,22,81,6,2,31,2,101,122,0
749,6542,wSw0H7eAN6dfAeYMaWU4nG5bgtRJyFlj,SpATywNh6bZuzm8s1ceuBUnMUAeoAHHw,57,136,39,43,18,52,29,2,319,45.57142857142857,15,0.0,13,39,37,18,123,52,6,29,2,107,212,0
750,6547,6U06x0rZdU2wXE04MeChX934BjpYCGYO,A3fsA9Zfv1X2fVEQhTw51lKENdNrEqT3,73,55,32,108,11,30,16,2,254,36.285714285714285,6,0.0,7,32,97,11,48,30,11,16,2,147,107,0
751,6551,uiGGvm5bzelA6YjURZYgSYljUTVOBIB1,A3fsA9Zfv1X2fVEQhTw51lKENdNrEqT3,4,2,1,0,0,0,4,0,7,1.0,3,0.0,0,1,0,0,2,0,0,4,0,1,6,1
752,6556,xeRiyg2Y5ZgvqPGiWyjXk0hLMBeGkeoJ,RXDvfPUBYFlVdlueBFbLW0mhhAyGEqpt,25,33,17,48,11,3,19,1,132,18.857142857142858,9,0.0,7,17,39,11,26,3,9,19,1,74,58,0
753,6562,KnR9Rn7adHv02cUeYZsmQrRux2GhqbgV,SpATywNh6bZuzm8s1ceuBUnMUAeoAHHw,20,20,15,0,8,0,7,0,50,7.142857142857143,5,0.0,0,15,0,8,20,0,0,7,0,23,27,1
754,6563,5zX31TZPkBQ4nxGKP7lPYFABTGNW6PHa,A3fsA9Zfv1X2fVEQhTw51lKENdNrEqT3,51,51,23,122,9,57,25,1,288,41.142857142857146,8,0.0,4,23,95,9,47,57,27,25,1,131,157,1
755,6576,X1EwqmDy4MdORdVb79oGgVGVtNlVZgX3,A3fsA9Zfv1X2fVEQhTw51lKENdNrEqT3,8,1,1,0,0,1,14,2,19,2.7142857142857144,2,0.0,0,1,0,0,1,1,0,14,2,1,18,1
756,6579,FxyjnTbjAUnINdJgNqjfUflUXLEYBAKC,SpATywNh6bZuzm8s1ceuBUnMUAeoAHHw,25,76,8,12,2,6,12,0,116,16.571428571428573,7,0.0,35,8,12,2,41,6,0,12,0,57,59,0
757,6582,MVGkJ43FVRFDNt0Uc0vZz4wcUGSmTO97,5X6FeZozNMgE2VRi3MJYjkkFK8SETtu2,5,2,1,0,1,0,3,0,7,1.0,1,0.0,0,1,0,1,2,0,0,3,0,2,5,1
758,6605,xR1z4zZU6RpVYkLfGcAdkLgM2fC8s4Qf,SpATywNh6bZuzm8s1ceuBUnMUAeoAHHw,1,0,0,0,0,0,1,0,1,0.14285714285714285,1,0.0,0,0,0,0,0,0,0,1,0,0,1,1
759,6606,vqNQHlaqBAqN0Ghl4wYJYkeoe3u1AJkM,SpATywNh6bZuzm8s1ceuBUnMUAeoAHHw,6,6,3,0,1,0,10,0,20,2.857142857142857,2,0.0,0,3,0,1,6,0,0,10,0,4,16,1
760,6619,TgtZeZ58ebuFniTgQX061K6ibFhvtBpU,SpATywNh6bZuzm8s1ceuBUnMUAeoAHHw,47,94,43,43,17,3,22,3,225,32.142857142857146,14,0.0,12,43,39,17,82,3,4,22,3,111,114,0
761,6633,hu8eak1Xmf8voE8pnxPzkSD2dZP9Sipf,SpATywNh6bZuzm8s1ceuBUnMUAeoAHHw,19,20,1,19,1,16,26,0,83,11.857142857142858,5,0.0,7,1,17,1,13,16,2,26,0,26,57,0
762,6634,CozZoSX7AwprtwyJFCAeFUYiCq7OSEAP,SpATywNh6bZuzm8s1ceuBUnMUAeoAHHw,28,81,34,0,25,0,4,0,144,20.571428571428573,8,0.0,0,34,0,25,81,0,0,4,0,59,85,0
763,6635,xKsPjk1jm2BE3h1iJlr6XUhvP4lcDdRk,RXDvfPUBYFlVdlueBFbLW0mhhAyGEqpt,74,105,64,177,35,14,22,2,419,59.857142857142854,11,0.0,23,64,163,35,82,14,14,22,2,285,134,0
764,6645,jzhfcjSJMALhuWl4kOoGHRTc9xbTfPXO,SpATywNh6bZuzm8s1ceuBUnMUAeoAHHw,10,23,2,0,0,0,6,0,31,4.428571428571429,5,0.0,0,2,0,0,23,0,0,6,0,2,29,0
765,6646,JV1BgG1khCT6s4RU5oY7ZOSmwW31Qjbp,SpATywNh6bZuzm8s1ceuBUnMUAeoAHHw,29,51,26,30,9,22,24,3,165,23.571428571428573,9,0.0,5,26,24,9,46,22,6,24,3,64,101,0
766,6651,imazrFpyX68kLUAydat119Z5XKshja9y,G8EPVSXsOYB5YQWZGiz1aVq5Pgr2GrQu,23,38,31,50,15,0,6,0,140,20.0,5,0.0,0,31,45,15,38,0,5,6,0,91,49,1
767,6654,WIULTFMTHtU9DH0SABu7cidImBPYBDLB,SpATywNh6bZuzm8s1ceuBUnMUAeoAHHw,30,41,6,28,5,1,20,2,103,14.714285714285714,3,0.0,5,6,26,5,36,1,2,20,2,42,61,1
768,6664,7nQB7cjVdr2HijR82OoX1oMRPa42JjfY,bWdj2GDclj5ofokWjzoa5jAwMkxCykd6,84,115,68,185,29,60,42,1,500,71.42857142857143,9,0.0,21,68,166,29,94,60,19,42,1,284,216,0
769,6665,tanZAGaF7HXSgqth6P4eBUao9FBYSWWr,G8EPVSXsOYB5YQWZGiz1aVq5Pgr2GrQu,6,6,1,0,1,0,5,0,13,1.8571428571428572,1,0.0,3,1,0,1,3,0,0,5,0,5,8,1
770,6666,MFUbiMqXEmfaBzK7hirtX5aBXDvqfQ39,A3fsA9Zfv1X2fVEQhTw51lKENdNrEqT3,11,7,6,0,5,0,2,0,20,2.857142857142857,3,0.0,0,6,0,5,7,0,0,2,0,11,9,1
771,6668,FFC6l9rAl1GAsErQ9wySBY8QQVxtUctK,SpATywNh6bZuzm8s1ceuBUnMUAeoAHHw,3,0,0,0,0,0,3,0,3,0.42857142857142855,1,0.0,0,0,0,0,0,0,0,3,0,0,3,1
772,6680,dSGnj6srDjb9PWIgErMSQXx2qQzyzYUX,SpATywNh6bZuzm8s1ceuBUnMUAeoAHHw,18,19,12,0,8,0,3,0,42,6.0,3,0.0,1,12,0,8,18,0,0,3,0,21,21,0
773,6682,hl9NS7ZQVsxPwew9lFoMcbw555xXfA7K,SpATywNh6bZuzm8s1ceuBUnMUAeoAHHw,19,23,11,14,5,0,7,0,60,8.571428571428571,4,0.0,7,11,11,5,16,0,3,7,0,34,26,1
774,6710,7FUJzRatex45Tiw3cL91Uz5fZD5gpQMy,RXDvfPUBYFlVdlueBFbLW0mhhAyGEqpt,2,0,0,0,0,0,2,0,2,0.2857142857142857,1,0.0,0,0,0,0,0,0,0,2,0,0,2,1
775,6712,7FUJzRatex45Tiw3cL91Uz5fZD5gpQMy,A3fsA9Zfv1X2fVEQhTw51lKENdNrEqT3,2,0,0,0,0,0,3,0,3,0.42857142857142855,1,0.0,0,0,0,0,0,0,0,3,0,0,3,1
776,6721,5EbadEY64E8d6mWCOGPXe4HNciATivZW,SpATywNh6bZuzm8s1ceuBUnMUAeoAHHw,48,124,49,32,17,10,29,1,262,37.42857142857143,9,0.0,55,49,30,17,69,10,2,29,1,151,111,0
777,6722,r5hJNp3FkX6JOBVI5bSeTBPneDl7PaKl,A3fsA9Zfv1X2fVEQhTw51lKENdNrEqT3,13,18,1,0,1,4,38,3,65,9.285714285714286,6,0.0,0,1,0,1,18,4,0,38,3,2,63,1
778,6723,e12uQn96OlYfknMdqSXCXdImglIj4IRR,A3fsA9Zfv1X2fVEQhTw51lKENdNrEqT3,120,245,150,78,40,436,195,13,1157,165.28571428571428,26,0.0,28,150,78,40,217,436,0,195,13,296,861,0
779,6724,2VLDXf2vRwSQsnPUMIG8jcgCB93IxRHm,SpATywNh6bZuzm8s1ceuBUnMUAeoAHHw,2,0,0,0,0,0,5,0,5,0.7142857142857143,2,0.0,0,0,0,0,0,0,0,5,0,0,5,1
780,6725,2LSIOP9EwUlEUMR84kNdXwxCTBof59AV,SpATywNh6bZuzm8s1ceuBUnMUAeoAHHw,38,37,22,20,13,1,20,1,114,16.285714285714285,9,0.0,2,22,16,13,35,1,4,20,1,53,61,0
781,6734,XxYK4zbyqtm9UELp1oR6gZVKRAER78zL,A3fsA9Zfv1X2fVEQhTw51lKENdNrEqT3,36,49,30,50,16,39,37,2,223,31.857142857142858,7,0.0,4,30,39,16,45,39,11,37,2,89,134,1
782,6739,D5mwgoAPtfwdsFrdNADBqEJQSy8E0CUi,SpATywNh6bZuzm8s1ceuBUnMUAeoAHHw,60,102,64,30,22,12,46,7,283,40.42857142857143,11,0.0,18,64,29,22,84,12,1,46,7,133,150,0
783,6740,YkHlvsvfON124uz3tNHCqQavCTgfzIIn,SpATywNh6bZuzm8s1ceuBUnMUAeoAHHw,23,26,10,13,5,6,17,3,80,11.428571428571429,3,0.0,5,10,11,5,21,6,2,17,3,31,49,1
784,6741,uOAgQLQslSL4cABC9ZqhaeK1XrisqlGh,SpATywNh6bZuzm8s1ceuBUnMUAeoAHHw,49,65,33,33,18,0,26,0,175,25.0,8,0.0,17,33,29,18,48,0,4,26,0,97,78,0
785,6761,DTS3O3ZujmzMefQXzAvfnTTqItcbsW8A,SpATywNh6bZuzm8s1ceuBUnMUAeoAHHw,30,75,8,28,1,70,19,3,204,29.142857142857142,10,0.0,15,8,24,1,60,70,4,19,3,48,156,0
786,6762,MFUbiMqXEmfaBzK7hirtX5aBXDvqfQ39,bWdj2GDclj5ofokWjzoa5jAwMkxCykd6,6,4,3,0,3,0,1,0,11,1.5714285714285714,1,0.0,0,3,0,3,4,0,0,1,0,6,5,1
787,6776,r5hJNp3FkX6JOBVI5bSeTBPneDl7PaKl,bWdj2GDclj5ofokWjzoa5jAwMkxCykd6,1,0,0,0,0,0,1,0,1,0.14285714285714285,1,0.0,0,0,0,0,0,0,0,1,0,0,1,1
788,6778,lVgq3gYt1tDiZq5EPAUcQ3qHGrMei1Rm,SpATywNh6bZuzm8s1ceuBUnMUAeoAHHw,59,107,66,54,28,64,60,15,394,56.285714285714285,10,0.0,22,66,44,28,85,64,10,60,15,160,234,0
789,6781,eWIsTbhL2p3ztTyrIxD7wf9RK1qPkZuf,SpATywNh6bZuzm8s1ceuBUnMUAeoAHHw,26,38,27,6,0,21,14,2,108,15.428571428571429,8,0.0,0,27,6,0,38,21,0,14,2,33,75,0
790,6783,hjSv3nB1dzB315OJ0MdIWlJoWmd5FDgm,bWdj2GDclj5ofokWjzoa5jAwMkxCykd6,9,21,6,60,5,10,11,0,113,16.142857142857142,2,0.0,11,6,58,5,10,10,2,11,0,80,33,1
791,6785,ptoBkN66Bt2QtZB1aEXx1ZVYWGKSe4nx,SpATywNh6bZuzm8s1ceuBUnMUAeoAHHw,40,91,23,45,8,21,34,1,223,31.857142857142858,8,0.0,24,23,39,8,67,21,6,34,1,94,129,0
792,6790,QZbPGbTnAqz8GS6cm25XcpeiETovvLN6,A3fsA9Zfv1X2fVEQhTw51lKENdNrEqT3,1,0,0,0,0,0,1,0,1,0.14285714285714285,1,0.0,0,0,0,0,0,0,0,1,0,0,1,1
793,6794,Yh46fozwerObqlP4OOrKTS69VvjT8dK1,A3fsA9Zfv1X2fVEQhTw51lKENdNrEqT3,40,14,10,90,8,0,8,0,130,18.571428571428573,5,0.0,2,10,86,8,12,0,4,8,0,106,24,1
794,6823,DeZ9eduD0lM3aHUAAOCnUrOhgp8jUmje,SpATywNh6bZuzm8s1ceuBUnMUAeoAHHw,11,25,2,4,0,8,20,0,59,8.428571428571429,9,0.0,8,2,3,0,17,8,1,20,0,13,46,0
795,6825,QwrR0O4UOobB3AXjFyYOVMeWzFnayzmx,SpATywNh6bZuzm8s1ceuBUnMUAeoAHHw,45,61,27,40,14,75,74,10,301,43.0,10,0.0,27,27,35,14,34,75,5,74,10,103,198,1
796,6831,DeZ9eduD0lM3aHUAAOCnUrOhgp8jUmje,5X6FeZozNMgE2VRi3MJYjkkFK8SETtu2,7,9,0,8,2,0,4,0,23,3.2857142857142856,1,0.0,7,0,7,2,2,0,1,4,0,16,7,1
797,6841,dSloiolTuQA1YnIVrIEZb5m23cL24cRw,5X6FeZozNMgE2VRi3MJYjkkFK8SETtu2,4,2,1,0,1,0,1,0,5,0.7142857142857143,1,0.0,0,1,0,1,2,0,0,1,0,2,3,1
798,6842,sbyXmrcpTszqVBWlyhJ5lsnmstVyQQWU,SpATywNh6bZuzm8s1ceuBUnMUAeoAHHw,1,0,0,0,0,0,2,0,2,0.2857142857142857,1,0.0,0,0,0,0,0,0,0,2,0,0,2,1
799,6862,JtMmp5BCDQnYE7CMI3NvnX4aRCZsQW9K,A3fsA9Zfv1X2fVEQhTw51lKENdNrEqT3,44,203,107,0,36,289,208,4,847,121.0,20,0.0,15,107,0,36,188,289,0,208,4,158,689,0
800,6866,ysSrXViwdbNw9df0HT1ETP8r4aB84YLw,SpATywNh6bZuzm8s1ceuBUnMUAeoAHHw,6,4,1,0,1,0,1,0,7,1.0,1,0.0,0,1,0,1,4,0,0,1,0,2,5,1
801,6878,7fC3V6ivG07wUIMOmiYFzSlyjWvbYnYf,SpATywNh6bZuzm8s1ceuBUnMUAeoAHHw,32,40,1,61,0,11,17,0,130,18.571428571428573,10,0.0,9,1,53,0,31,11,8,17,0,63,67,0
802,6895,z69L6knExrBf5gtr9B70Dgt3D9Xtp8CH,A3fsA9Zfv1X2fVEQhTw51lKENdNrEqT3,46,38,25,146,16,4,14,0,243,34.714285714285715,2,0.0,7,25,126,16,31,4,20,14,0,174,69,1
803,6896,WVOs4Pi3ll5FpomkXlRuIpcugHN3f0rV,SpATywNh6bZuzm8s1ceuBUnMUAeoAHHw,45,91,37,20,20,31,36,1,236,33.714285714285715,13,0.0,36,37,20,20,55,31,0,36,1,113,123,0
804,6907,CjvViMn5KClGeXFftICAvm8SWkvn3LHW,A3fsA9Zfv1X2fVEQhTw51lKENdNrEqT3,76,44,35,118,27,33,15,3,275,39.285714285714285,4,0.0,3,35,108,27,41,33,10,15,3,173,102,1
805,6908,bKbwS8bsj3eNxoCQcsrg5SKpHAoJ8uGu,5X6FeZozNMgE2VRi3MJYjkkFK8SETtu2,29,104,10,44,16,14,19,0,207,29.571428571428573,6,0.0,37,10,36,16,67,14,8,19,0,99,108,1
806,6915,V29AZJRcvBxCayax5I99yuRivRNPAZjj,SpATywNh6bZuzm8s1ceuBUnMUAeoAHHw,9,5,3,0,2,1,6,1,18,2.5714285714285716,2,0.0,0,3,0,2,5,1,0,6,1,5,13,0
807,6920,V29AZJRcvBxCayax5I99yuRivRNPAZjj,A3fsA9Zfv1X2fVEQhTw51lKENdNrEqT3,10,10,6,0,2,13,15,1,47,6.714285714285714,3,0.0,0,6,0,2,10,13,0,15,1,8,39,0
808,6923,FXwY1YS9Ue01cJBRQTifvzVPDx1ARw9E,SpATywNh6bZuzm8s1ceuBUnMUAeoAHHw,6,6,0,0,0,0,3,0,9,1.2857142857142858,2,0.0,0,0,0,0,6,0,0,3,0,0,9,1
809,6934,nsZMAREUaN1W79W768VHLU7EdYuf3Qrp,G8EPVSXsOYB5YQWZGiz1aVq5Pgr2GrQu,76,155,18,147,30,42,53,2,447,63.857142857142854,17,0.0,32,18,106,30,123,42,41,53,2,186,261,0
810,6935,JR1R4x5j4WkP10KgaKlpdN5JIGsgsmdk,SpATywNh6bZuzm8s1ceuBUnMUAeoAHHw,18,20,10,10,5,0,6,0,51,7.285714285714286,4,0.0,4,10,9,5,16,0,1,6,0,28,23,1
811,6944,cG2zraudtV44kPzel5abcAzgwVOUaAs4,A3fsA9Zfv1X2fVEQhTw51lKENdNrEqT3,7,8,0,6,0,0,4,0,18,2.5714285714285716,2,0.0,1,0,5,0,7,0,1,4,0,6,12,1
812,6955,uarVJhEs6XLW7Dw1D7iBgEK6zPe65WwX,5X6FeZozNMgE2VRi3MJYjkkFK8SETtu2,28,81,38,48,37,23,12,0,239,34.142857142857146,8,0.0,32,38,36,37,49,23,12,12,0,143,96,1
813,6972,ySy2zYThCkVZr5MjEXuKxq60wfOynxkJ,RXDvfPUBYFlVdlueBFbLW0mhhAyGEqpt,74,383,1,185,6,47,70,1,693,99.0,12,0.0,48,1,173,6,335,47,12,70,1,228,465,0
814,6975,ztNAIyTwcTmZ7oVMH6qBDo3dC1RimDND,SpATywNh6bZuzm8s1ceuBUnMUAeoAHHw,20,42,5,24,5,3,13,2,94,13.428571428571429,2,0.0,21,5,19,5,21,3,5,13,2,50,44,0
815,6977,EO1ssFp8oIj0TSE3bDdD8GeuhxRs5RVg,SpATywNh6bZuzm8s1ceuBUnMUAeoAHHw,42,157,24,64,16,32,90,3,386,55.142857142857146,13,0.0,31,24,56,16,126,32,8,90,3,127,259,0
816,6982,R0LbBsHoep5Au5A4mW7do32jHSfgQD8E,SpATywNh6bZuzm8s1ceuBUnMUAeoAHHw,48,140,52,61,16,82,43,3,397,56.714285714285715,9,0.0,67,52,48,16,73,82,13,43,3,183,214,1
817,6986,7fC3V6ivG07wUIMOmiYFzSlyjWvbYnYf,bWdj2GDclj5ofokWjzoa5jAwMkxCykd6,77,75,1,392,0,4,25,0,497,71.0,12,0.0,15,1,332,0,60,4,60,25,0,348,149,0
818,6992,YvR8b2YAoaLYLpo6WJ6bDiEtPLllysRd,RXDvfPUBYFlVdlueBFbLW0mhhAyGEqpt,24,45,30,32,12,12,22,3,156,22.285714285714285,3,0.0,5,30,29,12,40,12,3,22,3,76,80,0
819,6996,Ah63NhKhS4EP98tjvGlVfvoLlBn6V6BJ,A3fsA9Zfv1X2fVEQhTw51lKENdNrEqT3,13,7,4,0,2,1,15,1,30,4.285714285714286,3,0.0,0,4,0,2,7,1,0,15,1,6,24,1
820,6999,4L8FEL9uQ33lr2hJ5CSJNyGu6GEq5daD,5X6FeZozNMgE2VRi3MJYjkkFK8SETtu2,9,10,6,0,3,18,9,0,46,6.571428571428571,6,0.0,1,6,0,3,9,18,0,9,0,10,36,1
821,7009,oBSB2zh7bYN4yELh7x5ItqnxR463BvKC,bWdj2GDclj5ofokWjzoa5jAwMkxCykd6,71,392,124,228,92,3,55,0,894,127.71428571428571,20,0.0,103,124,201,92,289,3,27,55,0,520,374,0
822,7013,FTzllWD6ZzVNVacMJQ1FqQQ50E09onOa,bWdj2GDclj5ofokWjzoa5jAwMkxCykd6,9,9,4,0,2,4,8,1,28,4.0,1,0.0,0,4,0,2,9,4,0,8,1,6,22,1
823,7025,EFMEoi5W4mceo8rjft5LKrYvvT3E2eat,bWdj2GDclj5ofokWjzoa5jAwMkxCykd6,14,27,7,10,5,77,9,5,140,20.0,6,0.0,5,7,9,5,22,77,1,9,5,26,114,1
824,7030,AntKijOf83pltCnII9LLX8PQYe0F20yO,G8EPVSXsOYB5YQWZGiz1aVq5Pgr2GrQu,18,24,13,18,5,0,12,0,72,10.285714285714286,4,0.0,1,13,16,5,23,0,2,12,0,35,37,0
825,7033,hplRuUXyLFhHcMqMJcb12YjqquTYp3Qw,A3fsA9Zfv1X2fVEQhTw51lKENdNrEqT3,43,38,18,80,11,0,5,0,152,21.714285714285715,4,0.0,5,18,64,11,33,0,16,5,0,98,54,0
826,7037,1pusTPLSLF5m0UuZqZkNpGlAq8VrQ1KA,SpATywNh6bZuzm8s1ceuBUnMUAeoAHHw,50,51,33,26,20,6,16,0,152,21.714285714285715,7,0.0,9,33,25,20,42,6,1,16,0,87,65,0
827,7045,Qo4EYwRduG0qocv3scjgK3zQnLtIvid1,SpATywNh6bZuzm8s1ceuBUnMUAeoAHHw,40,152,49,0,27,4,57,7,296,42.285714285714285,17,0.0,0,49,0,27,152,4,0,57,7,76,220,0
828,7055,tx4grxmlQgEoy6eADYfJTj1STA6T1B91,5X6FeZozNMgE2VRi3MJYjkkFK8SETtu2,11,9,5,8,1,10,7,0,40,5.714285714285714,3,0.0,0,5,8,1,9,10,0,7,0,14,26,1
829,7060,dGqImSq9UHavQbhAMWmMoDizcuOefX1Y,SpATywNh6bZuzm8s1ceuBUnMUAeoAHHw,29,69,5,34,2,27,20,3,160,22.857142857142858,7,0.0,22,5,28,2,47,27,6,20,3,57,103,0
830,7080,KqUCRL8ws5CG5PQvlspSHJpgFexIO4Jl,SpATywNh6bZuzm8s1ceuBUnMUAeoAHHw,36,115,7,60,3,0,5,0,190,27.142857142857142,5,0.0,40,7,50,3,75,0,10,5,0,100,90,0
831,7083,k85NFhuORfuDcrrXLAFWOhl0dHDWmC1t,bWdj2GDclj5ofokWjzoa5jAwMkxCykd6,12,15,9,2,3,0,7,0,36,5.142857142857143,4,0.0,2,9,2,3,13,0,0,7,0,16,20,1
832,7091,zBYq3S89hCrsMeRBWwKxH3wWGwuZLtQd,SpATywNh6bZuzm8s1ceuBUnMUAeoAHHw,13,11,1,22,0,0,1,0,35,5.0,1,0.0,5,1,22,0,6,0,0,1,0,28,7,1
833,7093,cz3HVUxVHDVORvVKi9yREbYasmzZlaFd,G8EPVSXsOYB5YQWZGiz1aVq5Pgr2GrQu,73,115,9,72,6,2,29,1,234,33.42857142857143,7,0.0,2,9,67,6,113,2,5,29,1,84,150,0
834,7117,RHl3DsvAX7TisJ7qBptmgrrtDAQvH7mr,A3fsA9Zfv1X2fVEQhTw51lKENdNrEqT3,31,66,33,28,11,5,26,0,169,24.142857142857142,10,0.0,7,33,25,11,59,5,3,26,0,76,93,0
835,7124,DRhlp1eJHQqsxjCL0bRD6kkHN20HbJ4w,SpATywNh6bZuzm8s1ceuBUnMUAeoAHHw,27,63,31,20,15,0,15,0,144,20.571428571428573,12,0.0,15,31,19,15,48,0,1,15,0,80,64,0
836,7128,RvFRgUGsoT6kl0oxj3AEZMdMRkNHUTgp,SpATywNh6bZuzm8s1ceuBUnMUAeoAHHw,20,30,7,45,0,1,14,0,97,13.857142857142858,6,0.0,17,7,38,0,13,1,7,14,0,62,35,1
837,7129,mgwquciozkhcF0WnEEHOJYDb1rZHthNN,A3fsA9Zfv1X2fVEQhTw51lKENdNrEqT3,5,4,0,0,0,0,3,0,7,1.0,1,0.0,0,0,0,0,4,0,0,3,0,0,7,1
838,7137,rT1OrFQC18rdvYkTGYqwRgC7eDvihHsc,bWdj2GDclj5ofokWjzoa5jAwMkxCykd6,25,105,57,0,9,773,162,8,1114,159.14285714285714,30,0.0,4,57,0,9,101,773,0,162,8,70,1044,0
839,7142,YE22fRNdaFtk3nhWfjSOMHWERX5O7Ymi,A3fsA9Zfv1X2fVEQhTw51lKENdNrEqT3,86,90,9,144,5,0,19,0,267,38.142857142857146,7,0.0,5,9,134,5,85,0,10,19,0,153,114,0
840,7158,Ky3k8JBiR8OkS6sd2foNFIGjx3wXRsFp,G8EPVSXsOYB5YQWZGiz1aVq5Pgr2GrQu,32,55,2,8,2,20,19,3,109,15.571428571428571,2,0.0,13,2,4,2,42,20,4,19,3,21,88,0
841,7162,uJ1omfNa6wThHrODhBq1mtJVihr2Vf9k,5X6FeZozNMgE2VRi3MJYjkkFK8SETtu2,2,0,0,0,0,0,2,0,2,0.2857142857142857,1,0.0,0,0,0,0,0,0,0,2,0,0,2,1
842,7171,QzVwezWUOBpl33EMiprsTWQNwkGzpYUZ,A3fsA9Zfv1X2fVEQhTw51lKENdNrEqT3,9,8,5,0,2,0,7,0,22,3.142857142857143,4,0.0,1,5,0,2,7,0,0,7,0,8,14,0
843,7179,3HOnjRDe3XaKpyhDvtGYWIvTQ5R0B6U5,RXDvfPUBYFlVdlueBFbLW0mhhAyGEqpt,15,12,8,0,4,1,12,0,37,5.285714285714286,3,0.0,1,8,0,4,11,1,0,12,0,13,24,1
844,7181,29zlPnPFaHRpKhWmQq4cQrKoDn0GEyMA,SpATywNh6bZuzm8s1ceuBUnMUAeoAHHw,18,77,34,15,8,8,42,1,185,26.428571428571427,12,0.0,13,34,13,8,64,8,2,42,1,68,117,1
845,7197,yiOlNWWu3p4vJ73FHFCmMYCNgzMDTrne,A3fsA9Zfv1X2fVEQhTw51lKENdNrEqT3,96,52,36,234,23,0,25,1,371,53.0,5,0.0,3,36,206,23,49,0,28,25,1,268,103,1
846,7219,t0cRwLqt3PES7T3WXJUMfvNkz6DOAsQy,G8EPVSXsOYB5YQWZGiz1aVq5Pgr2GrQu,33,71,23,74,14,31,12,1,226,32.285714285714285,6,0.0,28,23,50,14,43,31,24,12,1,115,111,0
847,7221,Er0phLmicWoU9yr3sUBC2BCne0YIK1vQ,5X6FeZozNMgE2VRi3MJYjkkFK8SETtu2,4,2,0,0,0,0,5,0,7,1.0,3,0.0,0,0,0,0,2,0,0,5,0,0,7,1
848,7222,7abxlkdMiNWAIk78NzVnHWo2fZI6eMvl,SpATywNh6bZuzm8s1ceuBUnMUAeoAHHw,23,15,11,0,7,35,14,1,83,11.857142857142858,4,0.0,2,11,0,7,13,35,0,14,1,20,63,1
849,7229,iZlqOil8HuQgM9wIdCp3EDJlfdWSJRmO,SpATywNh6bZuzm8s1ceuBUnMUAeoAHHw,34,58,1,50,1,59,24,8,201,28.714285714285715,8,0.0,10,1,43,1,48,59,7,24,8,55,146,0
850,7232,Kv9yM6Ye606xOusGmqGDWX6SW9fdHP2Q,A3fsA9Zfv1X2fVEQhTw51lKENdNrEqT3,1,0,0,0,0,0,1,0,1,0.14285714285714285,1,0.0,0,0,0,0,0,0,0,1,0,0,1,1
851,7240,HJ4qDtw6u2JHJE7qmEDgWJOzWUYAv4mG,A3fsA9Zfv1X2fVEQhTw51lKENdNrEqT3,87,69,52,202,27,23,27,0,400,57.142857142857146,12,0.0,2,52,178,27,67,23,24,27,0,259,141,0
852,7256,D1NRZnTG0gvNQpfa2XPRkdGhYZVx3Bz8,RXDvfPUBYFlVdlueBFbLW0mhhAyGEqpt,70,90,64,155,34,15,19,8,385,55.0,10,0.0,16,64,136,34,74,15,19,19,8,250,135,0
853,7262,WIuYkRjZD9FutPqnDeyA4qgpxVJpTEdL,SpATywNh6bZuzm8s1ceuBUnMUAeoAHHw,14,12,4,18,2,0,8,0,44,6.285714285714286,4,0.0,5,4,18,2,7,0,0,8,0,29,15,0
854,7274,YZ1MgmwJiUridNKhbKx061bAjGk955T1,G8EPVSXsOYB5YQWZGiz1aVq5Pgr2GrQu,81,158,11,210,4,16,17,4,420,60.0,15,0.0,5,11,178,4,153,16,32,17,4,198,222,0
855,7291,o7nB1nybhMcFgLy31X3R6RDOK94b1Iaa,SpATywNh6bZuzm8s1ceuBUnMUAeoAHHw,27,66,8,8,6,0,17,0,105,15.0,6,0.0,3,8,7,6,63,0,1,17,0,24,81,0
856,7296,ObMYjZj16p1bGCa8nmaBIv8cDUPUXE5o,SpATywNh6bZuzm8s1ceuBUnMUAeoAHHw,35,86,1,35,1,14,39,3,179,25.571428571428573,12,0.0,17,1,30,1,69,14,5,39,3,49,130,0
857,7297,bAkMyE6uCR0gc04pERZmDJrGVqJ4Z2Yi,G8EPVSXsOYB5YQWZGiz1aVq5Pgr2GrQu,125,184,74,268,50,37,24,0,637,91.0,15,0.0,54,74,213,50,130,37,55,24,0,391,246,0
858,7298,VSEOcWZYpZiKC2PUmidzj4VqbBnc3GAo,bWdj2GDclj5ofokWjzoa5jAwMkxCykd6,57,80,41,147,19,93,143,5,528,75.42857142857143,23,0.0,23,41,130,19,57,93,17,143,5,213,315,0
859,7301,Yby0It9Tj4ASosIcvg72qeavqJKBNZLT,bWdj2GDclj5ofokWjzoa5jAwMkxCykd6,1,0,0,0,0,0,1,0,1,0.14285714285714285,1,0.0,0,0,0,0,0,0,0,1,0,0,1,1
860,7303,Yby0It9Tj4ASosIcvg72qeavqJKBNZLT,A3fsA9Zfv1X2fVEQhTw51lKENdNrEqT3,2,0,0,0,0,0,2,0,2,0.2857142857142857,1,0.0,0,0,0,0,0,0,0,2,0,0,2,1
861,7318,7glymc4Wt1TTt6LrLi78VQNF5GV1r6UY,bWdj2GDclj5ofokWjzoa5jAwMkxCykd6,8,4,2,8,1,0,2,0,17,2.4285714285714284,1,0.0,1,2,8,1,3,0,0,2,0,12,5,1
862,7325,3jh7S7idreXg4tLgwxk2JirIFS2kxatr,SpATywNh6bZuzm8s1ceuBUnMUAeoAHHw,38,81,38,37,22,7,27,1,213,30.428571428571427,10,0.0,16,38,31,22,65,7,6,27,1,107,106,0
863,7328,83p9ejSELsW1j5wNlAyUXF2YWFL8Z8tc,bWdj2GDclj5ofokWjzoa5jAwMkxCykd6,73,87,36,282,23,13,22,1,464,66.28571428571429,11,0.0,21,36,252,23,66,13,30,22,1,332,132,0
864,7344,B9KqNNxXBxHFUsJnQKQysblL3f8zF7sg,A3fsA9Zfv1X2fVEQhTw51lKENdNrEqT3,64,155,11,69,0,7,34,0,276,39.42857142857143,18,0.0,7,11,55,0,148,7,14,34,0,73,203,0
865,7350,ve9ySeJmFQKT879uz3hqg8kvVYA6FA8D,SpATywNh6bZuzm8s1ceuBUnMUAeoAHHw,1,0,0,0,0,0,2,0,2,0.2857142857142857,1,0.0,0,0,0,0,0,0,0,2,0,0,2,1
866,7352,CWDKRVVm01sfgssULmzIPwx9dbULLbqB,5X6FeZozNMgE2VRi3MJYjkkFK8SETtu2,111,493,137,244,120,41,63,1,1099,157.0,18,0.0,194,137,192,120,299,41,52,63,1,643,456,0
867,7356,uXSmZuPz2xNXPk2qFBcPykAtedr98vP4,RXDvfPUBYFlVdlueBFbLW0mhhAyGEqpt,46,44,25,80,17,3,5,0,174,24.857142857142858,4,0.0,10,25,75,17,34,3,5,5,0,127,47,0
868,7365,84Vq27rxsidbGJFxLO0cd5e2CSiXRChu,5X6FeZozNMgE2VRi3MJYjkkFK8SETtu2,20,55,20,0,32,0,10,0,117,16.714285714285715,6,0.0,26,20,0,32,29,0,0,10,0,78,39,1
869,7372,32uJBAomTJQIXKZnCX4K7PYoVfESGbct,A3fsA9Zfv1X2fVEQhTw51lKENdNrEqT3,74,53,8,182,5,0,11,0,259,37.0,12,0.0,3,8,159,5,50,0,23,11,0,175,84,1
870,7385,ErlOpSNxC1ZbmJguJSp3ZjxFq4nCmwgx,G8EPVSXsOYB5YQWZGiz1aVq5Pgr2GrQu,20,44,10,2,4,0,25,2,87,12.428571428571429,6,0.0,7,10,1,4,37,0,1,25,2,22,65,0
871,7391,7L5unYIhab1TebFiFv55Vd3f3JppE4WH,A3fsA9Zfv1X2fVEQhTw51lKENdNrEqT3,10,12,9,0,6,0,4,0,31,4.428571428571429,2,0.0,0,9,0,6,12,0,0,4,0,15,16,0
872,7422,WKdxdVcCk0v6q8w6qEVoDAEpoNH9nq1b,A3fsA9Zfv1X2fVEQhTw51lKENdNrEqT3,43,39,19,66,10,4,14,0,152,21.714285714285715,4,0.0,3,19,53,10,36,4,13,14,0,85,67,1
873,7428,dTkPxaFmNowU6Qk7fnasqvgAevZOuRY9,RXDvfPUBYFlVdlueBFbLW0mhhAyGEqpt,45,19,11,78,7,9,6,0,130,18.571428571428573,3,0.0,7,11,77,7,12,9,1,6,0,102,28,1
874,7439,yK7fQWYLG0RsBbgokh3BoTMU9oScdsOd,bWdj2GDclj5ofokWjzoa5jAwMkxCykd6,4,3,2,0,2,0,1,0,8,1.1428571428571428,1,0.0,0,2,0,2,3,0,0,1,0,4,4,1
875,7440,5TRqp5WlxU778HZGbnj0S6xLTaRfUJxG,SpATywNh6bZuzm8s1ceuBUnMUAeoAHHw,45,122,7,41,6,21,40,2,239,34.142857142857146,15,0.0,28,7,35,6,94,21,6,40,2,76,163,0
876,7463,zdqliI4eCBGH6nGv4KKIRZFL1YFXBytK,SpATywNh6bZuzm8s1ceuBUnMUAeoAHHw,45,98,47,52,16,176,69,2,460,65.71428571428571,13,0.0,28,47,44,16,70,176,8,69,2,135,325,0
877,7464,lFMYqumkG36iLJm9YwVpbzadzxUvswUa,bWdj2GDclj5ofokWjzoa5jAwMkxCykd6,1,0,0,0,0,0,3,0,3,0.42857142857142855,2,0.0,0,0,0,0,0,0,0,3,0,0,3,1
878,7466,lFMYqumkG36iLJm9YwVpbzadzxUvswUa,SpATywNh6bZuzm8s1ceuBUnMUAeoAHHw,22,40,23,20,0,5,12,0,100,14.285714285714286,6,0.0,11,23,18,0,29,5,2,12,0,52,48,0
879,7475,vRHTfFGO3STxLwMRkIw1geBTPnARvg2o,SpATywNh6bZuzm8s1ceuBUnMUAeoAHHw,15,21,13,6,6,8,14,0,68,9.714285714285714,4,0.0,1,13,5,6,20,8,1,14,0,25,43,0
880,7488,uUSTKM8g1hIskJbYHh1UiIQ6epHTSTNR,A3fsA9Zfv1X2fVEQhTw51lKENdNrEqT3,34,36,18,80,3,0,13,0,150,21.428571428571427,8,0.0,5,18,66,3,31,0,14,13,0,92,58,1
881,7491,uUSTKM8g1hIskJbYHh1UiIQ6epHTSTNR,RXDvfPUBYFlVdlueBFbLW0mhhAyGEqpt,79,128,81,112,59,3,22,1,406,58.0,9,0.0,28,81,105,59,100,3,7,22,1,273,133,0
882,7496,6qVy3H4VOdeTnu4v49EIcz51mS5B3gWH,SpATywNh6bZuzm8s1ceuBUnMUAeoAHHw,33,90,51,24,0,151,63,8,387,55.285714285714285,13,0.0,17,51,21,0,73,151,3,63,8,89,298,0
883,7503,0PrF4PViZdaRQhbt6FYXwLbcetJ8RnwC,A3fsA9Zfv1X2fVEQhTw51lKENdNrEqT3,79,57,2,272,1,0,23,0,355,50.714285714285715,8,0.0,7,2,232,1,50,0,40,23,0,242,113,0
884,7504,NH2DAS5rCP8HjIcwHAZxDBAjUjjdHeyM,SpATywNh6bZuzm8s1ceuBUnMUAeoAHHw,35,28,21,28,10,29,26,0,142,20.285714285714285,6,0.0,7,21,26,10,21,29,2,26,0,64,78,0
885,7521,a3StgABPgimfVHzW1FR4usG9kIA0tZV5,bWdj2GDclj5ofokWjzoa5jAwMkxCykd6,18,89,5,26,8,0,18,0,146,20.857142857142858,10,0.0,19,5,24,8,70,0,2,18,0,56,90,1
886,7525,xNkIHhqS8GZXIqyoWwwS3ZeYfSmUsNJo,A3fsA9Zfv1X2fVEQhTw51lKENdNrEqT3,160,157,63,342,41,8,26,1,638,91.14285714285714,9,0.0,5,63,275,41,152,8,67,26,1,384,254,0
887,7535,8a9f5zlAzg00IZpxpFpd0Yys1Z1UDN82,RXDvfPUBYFlVdlueBFbLW0mhhAyGEqpt,42,90,58,31,27,2,18,0,226,32.285714285714285,7,0.0,2,58,27,27,88,2,4,18,0,114,112,1
888,7539,p6HxMfZynarvwZflE5DcOWxdvhYhrFbF,G8EPVSXsOYB5YQWZGiz1aVq5Pgr2GrQu,6,2,1,0,1,0,3,0,7,1.0,1,0.0,0,1,0,1,2,0,0,3,0,2,5,1
889,7540,oRVMh8MBvWswMrCZYZVSC4ANhRghr3SC,RXDvfPUBYFlVdlueBFbLW0mhhAyGEqpt,25,41,20,13,7,5,14,2,102,14.571428571428571,6,0.0,3,20,13,7,38,5,0,14,2,43,59,1
890,7550,EGswqlieknT0DkOMjaOEPr1kJjoddSSw,G8EPVSXsOYB5YQWZGiz1aVq5Pgr2GrQu,33,80,9,42,9,85,32,8,265,37.857142857142854,11,0.0,10,9,33,9,70,85,9,32,8,61,204,0
891,7552,ljmWZCzWPqv1RXsn1q2wpsQtrnA1zct2,SpATywNh6bZuzm8s1ceuBUnMUAeoAHHw,57,115,39,60,17,7,17,0,255,36.42857142857143,8,0.0,41,39,49,17,74,7,11,17,0,146,109,0
892,7562,606SeIKBIFg9vt3BinDbRysHBP3GLEGI,bWdj2GDclj5ofokWjzoa5jAwMkxCykd6,11,10,2,0,3,7,11,2,35,5.0,1,0.0,2,2,0,3,8,7,0,11,2,7,28,1
893,7571,hPtqAQmVA3C7MVQi98nPJLfZYLyZ86Qe,SpATywNh6bZuzm8s1ceuBUnMUAeoAHHw,6,5,2,0,1,0,2,0,10,1.4285714285714286,3,0.0,0,2,0,1,5,0,0,2,0,3,7,1
894,7579,7KQcIrOp3KoypOTvziMED7rHtDH1CXtE,SpATywNh6bZuzm8s1ceuBUnMUAeoAHHw,14,11,0,18,0,11,9,0,49,7.0,2,0.0,3,0,15,0,8,11,3,9,0,18,31,1
895,7581,QoKkWqCz9JSPf2G2l4XrJl2BfFSq9X9B,RXDvfPUBYFlVdlueBFbLW0mhhAyGEqpt,49,78,4,135,4,45,28,9,303,43.285714285714285,9,0.0,19,4,124,4,59,45,11,28,9,151,152,0
896,7589,ljmWZCzWPqv1RXsn1q2wpsQtrnA1zct2,A3fsA9Zfv1X2fVEQhTw51lKENdNrEqT3,42,16,13,68,9,1,4,0,111,15.857142857142858,2,0.0,1,13,56,9,15,1,12,4,0,79,32,1
897,7628,hRBUrY0Ipi1X9aVKI1Gcp4xJWynJPCa6,SpATywNh6bZuzm8s1ceuBUnMUAeoAHHw,42,50,30,38,17,0,8,0,143,20.428571428571427,9,0.0,13,30,36,17,37,0,2,8,0,96,47,0
898,7632,YpYAswD6xdR70kiD53LA7ygDBkdDLMQF,SpATywNh6bZuzm8s1ceuBUnMUAeoAHHw,11,13,6,2,3,4,2,0,30,4.285714285714286,2,0.0,1,6,2,3,12,4,0,2,0,12,18,1
899,7633,11ljuSLdnPtPyfemLE7b9qn6qXcmssv1,SpATywNh6bZuzm8s1ceuBUnMUAeoAHHw,28,74,22,65,2,9,23,0,195,27.857142857142858,9,0.0,27,22,53,2,47,9,12,23,0,104,91,1
900,7634,I4noBaz6GyRD2PZe6j4LCRYlVDmmxoLh,SpATywNh6bZuzm8s1ceuBUnMUAeoAHHw,12,17,2,1,0,1,8,1,30,4.285714285714286,1,0.0,2,2,1,0,15,1,0,8,1,5,25,1
901,7642,WZSiXPjEuCIRtzYUNEK3DyAuPVNMLJ4a,SpATywNh6bZuzm8s1ceuBUnMUAeoAHHw,17,19,8,29,4,8,9,1,78,11.142857142857142,2,0.0,6,8,24,4,13,8,5,9,1,42,36,1
902,7647,ylrXVJAuag501sD5FTvKV7DusuU60h41,SpATywNh6bZuzm8s1ceuBUnMUAeoAHHw,5,2,0,0,1,0,3,0,6,0.8571428571428571,1,0.0,0,0,0,1,2,0,0,3,0,1,5,1
903,7652,PQ7ibn4CoD7R92qj9CnBXvU4YpUOqVHi,SpATywNh6bZuzm8s1ceuBUnMUAeoAHHw,35,63,39,16,17,4,38,4,181,25.857142857142858,8,0.0,21,39,16,17,42,4,0,38,4,93,88,0
904,7653,v9Jp2iBPSFTVxP8FrUe1odwfz8Hd1wS3,RXDvfPUBYFlVdlueBFbLW0mhhAyGEqpt,132,188,104,186,43,39,37,4,601,85.85714285714286,9,0.0,49,104,171,43,139,39,15,37,4,367,234,0
905,7675,LiEDHNjd9tDT7NPtKiOjuDJtkaP8cSxY,bWdj2GDclj5ofokWjzoa5jAwMkxCykd6,46,109,63,88,19,76,33,5,393,56.142857142857146,8,0.0,14,63,73,19,95,76,15,33,5,169,224,0
906,7679,GjmRL85Fx59ASzosh0kQzycWTmRCzek4,SpATywNh6bZuzm8s1ceuBUnMUAeoAHHw,14,31,1,17,1,1,5,0,56,8.0,3,0.0,19,1,16,1,12,1,1,5,0,37,19,1
907,7702,ulNRkVxxtx7SLWYKYYIDWhAGHHFqHWWG,SpATywNh6bZuzm8s1ceuBUnMUAeoAHHw,45,79,33,37,14,7,33,2,205,29.285714285714285,12,0.0,25,33,34,14,54,7,3,33,2,106,99,0
908,7707,Om7TmUpRVXmKCq1XRkQCdyE9M7r8n9tE,SpATywNh6bZuzm8s1ceuBUnMUAeoAHHw,15,32,5,28,0,4,8,1,78,11.142857142857142,2,0.0,12,5,26,0,20,4,2,8,1,43,35,0
909,7711,U4GXlaQk4qQjr2K7P59OKvXX0vv1Pxee,SpATywNh6bZuzm8s1ceuBUnMUAeoAHHw,23,59,7,47,1,0,23,2,139,19.857142857142858,10,0.0,18,7,41,1,41,0,6,23,2,67,72,0
910,7713,0W4XScVx81tfxJ0Qr09mHB39FqA62JyS,SpATywNh6bZuzm8s1ceuBUnMUAeoAHHw,19,24,4,31,2,2,4,0,67,9.571428571428571,4,0.0,8,4,29,2,16,2,2,4,0,43,24,1
911,7716,yG9o9nU1hVydCMiwULHDO2ptGPwb3jNJ,SpATywNh6bZuzm8s1ceuBUnMUAeoAHHw,22,31,15,12,5,2,6,0,71,10.142857142857142,6,0.0,10,15,12,5,21,2,0,6,0,42,29,1
912,7721,MAlRgKpZXlP3WrMKjRw2YskqEALVtCKw,SpATywNh6bZuzm8s1ceuBUnMUAeoAHHw,40,85,1,31,0,5,32,2,156,22.285714285714285,11,0.0,18,1,30,0,67,5,1,32,2,49,107,0
913,7727,h5vEAVTb94xGNGjpn4Ohi5mNcXfM0rMl,RXDvfPUBYFlVdlueBFbLW0mhhAyGEqpt,21,46,4,14,5,1,13,5,88,12.571428571428571,3,0.0,11,4,14,5,35,1,0,13,5,34,54,1
914,7742,zu1WAijSG0F2wy5x45xxD1w2SrPWGtuK,RXDvfPUBYFlVdlueBFbLW0mhhAyGEqpt,72,90,24,72,16,39,78,9,328,46.857142857142854,8,0.0,17,24,65,16,73,39,7,78,9,122,206,0
915,7748,cXt4yzdeLQWJ2a8N3WCCOFlxmV6sHALc,bWdj2GDclj5ofokWjzoa5jAwMkxCykd6,28,34,14,182,11,0,7,0,248,35.42857142857143,3,0.0,16,14,173,11,18,0,9,7,0,214,34,1
916,7752,nIJT2WzxvFmAAdv0mMRGLvQiPT819gU3,SpATywNh6bZuzm8s1ceuBUnMUAeoAHHw,47,171,30,49,17,132,96,1,496,70.85714285714286,17,0.0,34,30,39,17,137,132,10,96,1,120,376,0
917,7753,kzQ1HmHoPnIhyiOH3J5g0gxiDZh4kW6J,RXDvfPUBYFlVdlueBFbLW0mhhAyGEqpt,83,61,37,145,26,2,34,0,305,43.57142857142857,6,0.0,19,37,131,26,42,2,14,34,0,213,92,1
918,7762,2Sqmg51RWZnvGf1B4BEysn1wJm7yLaQl,G8EPVSXsOYB5YQWZGiz1aVq5Pgr2GrQu,92,143,21,196,5,11,25,0,401,57.285714285714285,8,0.0,39,21,173,5,104,11,23,25,0,238,163,0
919,7769,QV7Z9LfpjzP9d797QCfKxmoOjdo08shd,SpATywNh6bZuzm8s1ceuBUnMUAeoAHHw,36,51,27,15,13,24,12,1,143,20.428571428571427,7,0.0,9,27,15,13,42,24,0,12,1,64,79,0
920,7770,4dVGo2nGpdhjYgYbTYmjlligu2kflHn7,RXDvfPUBYFlVdlueBFbLW0mhhAyGEqpt,50,105,35,77,13,4,20,3,257,36.714285714285715,2,0.0,24,35,73,13,81,4,4,20,3,145,112,1
921,7782,EJ52dc9s4CYydLeBR3nGlXxXka6Fltqj,A3fsA9Zfv1X2fVEQhTw51lKENdNrEqT3,7,5,2,0,2,0,7,0,16,2.2857142857142856,2,0.0,0,2,0,2,5,0,0,7,0,4,12,0
922,7784,Y96AzEZtgYGN39EPdmAzdYPvLhv1Tzsf,SpATywNh6bZuzm8s1ceuBUnMUAeoAHHw,33,34,21,33,11,16,20,1,136,19.428571428571427,5,0.0,8,21,28,11,26,16,5,20,1,68,68,0
923,7787,b87ksD29UBdF2YCxTtUOCsx5OJsZrMS6,SpATywNh6bZuzm8s1ceuBUnMUAeoAHHw,10,19,2,0,0,4,7,0,32,4.571428571428571,3,0.0,2,2,0,0,17,4,0,7,0,4,28,1
924,7808,xG6pQFBC9YTxYi6joCJjOh2c6LkI7Trq,SpATywNh6bZuzm8s1ceuBUnMUAeoAHHw,5,2,1,0,1,0,2,0,6,0.8571428571428571,1,0.0,0,1,0,1,2,0,0,2,0,2,4,1
925,7816,rbxp4ygAJiuJravRmpeSgvTRbWslY8KE,G8EPVSXsOYB5YQWZGiz1aVq5Pgr2GrQu,43,47,18,102,12,2,12,2,195,27.857142857142858,3,0.0,25,18,75,12,22,2,27,12,2,130,65,1
926,7817,KLERBlLR5to2IuMEV6VaweaoU18ID2Ks,SpATywNh6bZuzm8s1ceuBUnMUAeoAHHw,30,51,27,30,15,0,20,0,143,20.428571428571427,4,0.0,13,27,28,15,38,0,2,20,0,83,60,1
927,7818,LMGbvXS3ZBgtTcKCRLMcqBHrfADBxwXe,SpATywNh6bZuzm8s1ceuBUnMUAeoAHHw,46,96,43,25,21,9,38,0,232,33.142857142857146,16,0.0,17,43,22,21,79,9,3,38,0,103,129,0
928,7819,hHscGHEjmeiL8NswOTKn3P6KxplprGQ7,SpATywNh6bZuzm8s1ceuBUnMUAeoAHHw,4,3,2,0,0,0,1,0,6,0.8571428571428571,1,0.0,0,2,0,0,3,0,0,1,0,2,4,1
929,7832,RNgrmqPicYezsE4BsF8Au4WfPdSMWP6C,G8EPVSXsOYB5YQWZGiz1aVq5Pgr2GrQu,12,13,7,0,1,2,13,1,37,5.285714285714286,2,0.0,2,7,0,1,11,2,0,13,1,10,27,1
930,7835,3iSbhZU0XFdJUgUA6Ry01TQ9T4nPzP7c,SpATywNh6bZuzm8s1ceuBUnMUAeoAHHw,11,24,6,0,2,0,10,0,42,6.0,3,0.0,0,6,0,2,24,0,0,10,0,8,34,1
931,7838,S10grfxrn0tXcuL6DSaVTf7wyvXspCvq,SpATywNh6bZuzm8s1ceuBUnMUAeoAHHw,8,19,1,0,0,31,11,0,62,8.857142857142858,4,0.0,2,1,0,0,17,31,0,11,0,3,59,0
932,7839,WYNpj52NyIePFOfUouGRXkQmACPQnP2J,SpATywNh6bZuzm8s1ceuBUnMUAeoAHHw,40,328,160,38,19,1695,274,10,2524,360.57142857142856,23,0.0,38,160,32,19,290,1695,6,274,10,249,2275,0
933,7853,70BrIR23BcsI705EZj4LSyr7fHWI0Xjf,A3fsA9Zfv1X2fVEQhTw51lKENdNrEqT3,25,40,24,0,17,12,10,0,103,14.714285714285714,5,0.0,0,24,0,17,40,12,0,10,0,41,62,0
934,7855,FOHqSST3UlMcK0PZ2G62CXA809f8BW7i,bWdj2GDclj5ofokWjzoa5jAwMkxCykd6,5,2,1,0,1,0,2,0,6,0.8571428571428571,1,0.0,0,1,0,1,2,0,0,2,0,2,4,1
935,7857,Z6YQS36VdHJFF4DkVSTcUgmOIdlOITNE,SpATywNh6bZuzm8s1ceuBUnMUAeoAHHw,45,88,35,49,15,1,12,0,200,28.571428571428573,7,0.0,31,35,42,15,57,1,7,12,0,123,77,0
936,7858,Ak0ru019Ynz1X1qhUbDFCskGZavLrHBc,SpATywNh6bZuzm8s1ceuBUnMUAeoAHHw,61,135,73,51,33,50,26,2,370,52.857142857142854,6,0.0,44,73,48,33,91,50,3,26,2,198,172,0
937,7860,rWA9BhwEXXwDdj5p5FXRqP1JA3HaX1US,SpATywNh6bZuzm8s1ceuBUnMUAeoAHHw,29,59,32,31,18,2,7,0,149,21.285714285714285,4,0.0,17,32,28,18,42,2,3,7,0,95,54,1
938,7863,bDqqR2hng29QNjexgLbMGRH4AJBfyli8,SpATywNh6bZuzm8s1ceuBUnMUAeoAHHw,21,38,25,12,8,5,14,1,103,14.714285714285714,6,0.0,2,25,10,8,36,5,2,14,1,45,58,1
939,7868,ptvDGcVFI5vzF4lBwRLTADNrenNp2tF2,SpATywNh6bZuzm8s1ceuBUnMUAeoAHHw,49,126,19,34,6,12,59,4,260,37.142857142857146,11,0.0,14,19,31,6,112,12,3,59,4,70,190,0
940,7870,sj7wQJWVAxmId67LlkoaFzAmqWKmeC7I,SpATywNh6bZuzm8s1ceuBUnMUAeoAHHw,47,267,13,36,9,144,103,1,573,81.85714285714286,19,0.0,54,13,34,9,213,144,2,103,1,110,463,0
941,7882,0zObXmoXHP7rszDYuu8m5842mUKzCfEP,G8EPVSXsOYB5YQWZGiz1aVq5Pgr2GrQu,12,16,1,38,0,0,3,0,58,8.285714285714286,1,0.0,2,1,33,0,14,0,5,3,0,36,22,1
942,7883,JiNN6rHoPfwH1fuAk6q9tmTGqAFVjob4,SpATywNh6bZuzm8s1ceuBUnMUAeoAHHw,16,16,9,12,5,2,8,1,53,7.571428571428571,3,0.0,4,9,10,5,12,2,2,8,1,28,25,0
943,7909,fbuy5iqzFkLuifp42uT7tvssNinDwhQ9,G8EPVSXsOYB5YQWZGiz1aVq5Pgr2GrQu,19,12,5,0,5,0,5,0,27,3.857142857142857,1,0.0,2,5,0,5,10,0,0,5,0,12,15,1
944,7923,pJUI0Hs11rZxgXk3r1clZCyuDCtGsbvH,SpATywNh6bZuzm8s1ceuBUnMUAeoAHHw,52,69,19,46,10,0,16,1,161,23.0,7,0.0,22,19,44,10,47,0,2,16,1,95,66,1
945,7933,dEPUxcdyZTnKUVP0o2JXv6VWX3ETnwmr,SpATywNh6bZuzm8s1ceuBUnMUAeoAHHw,26,77,39,32,3,18,48,7,224,32.0,5,0.0,34,39,26,3,43,18,6,48,7,102,122,1
946,7937,ywdL3xkp7d2PSjbvnflAvIe7Wp6Q4SRe,SpATywNh6bZuzm8s1ceuBUnMUAeoAHHw,60,149,58,78,22,0,53,1,361,51.57142857142857,20,0.0,30,58,70,22,119,0,8,53,1,180,181,0
947,7942,JNo2rLqKe6aBGDwGzu8tXd13uOC5tEnq,bWdj2GDclj5ofokWjzoa5jAwMkxCykd6,15,25,13,52,0,18,42,2,152,21.714285714285715,6,0.0,8,13,51,0,17,18,1,42,2,72,80,0
948,7949,FnY3or5QaQRvUAAgyu53eYBfcMnduugT,SpATywNh6bZuzm8s1ceuBUnMUAeoAHHw,40,120,15,36,8,11,31,1,222,31.714285714285715,13,0.0,26,15,32,8,94,11,4,31,1,81,141,0
949,7952,CI12SZIYH2QOfgaDvq8F4VKXwDinb334,SpATywNh6bZuzm8s1ceuBUnMUAeoAHHw,61,76,47,39,25,1,13,1,202,28.857142857142858,9,0.0,17,47,35,25,59,1,4,13,1,124,78,0
950,7954,WzyWOzB7f8AVbQvaWeU3O4gxEwZ13sIC,RXDvfPUBYFlVdlueBFbLW0mhhAyGEqpt,69,112,57,161,38,21,26,3,418,59.714285714285715,13,0.0,23,57,151,38,89,21,10,26,3,269,149,0
951,7956,ljmWZCzWPqv1RXsn1q2wpsQtrnA1zct2,G8EPVSXsOYB5YQWZGiz1aVq5Pgr2GrQu,137,136,39,409,18,46,19,0,667,95.28571428571429,6,0.0,57,39,298,18,79,46,111,19,0,412,255,1
952,7962,mtW8rWxW2XwZIB5TM8b8gUVmE4UACp0R,SpATywNh6bZuzm8s1ceuBUnMUAeoAHHw,52,55,35,28,16,0,16,0,150,21.428571428571427,14,0.0,10,35,28,16,45,0,0,16,0,89,61,0
953,7964,z8zMi50azvRwAPUNW2f5Gt0F6WOr8PI9,A3fsA9Zfv1X2fVEQhTw51lKENdNrEqT3,13,12,9,0,5,0,4,0,30,4.285714285714286,4,0.0,0,9,0,5,12,0,0,4,0,14,16,1
954,7967,Wyji6pvgj7unEJ4mD7FWwu0Sma8fUdv4,SpATywNh6bZuzm8s1ceuBUnMUAeoAHHw,33,86,60,19,29,20,30,3,247,35.285714285714285,7,0.0,11,60,19,29,75,20,0,30,3,119,128,0
955,7970,2mdoNlBiXpgUVSmoihAheHl3NISmi738,SpATywNh6bZuzm8s1ceuBUnMUAeoAHHw,3,0,0,0,0,14,2,0,16,2.2857142857142856,1,0.0,0,0,0,0,0,14,0,2,0,0,16,1
956,7973,SUqHrTqjE8jHVpASqCaMjjR6iZ17k2Gq,SpATywNh6bZuzm8s1ceuBUnMUAeoAHHw,54,85,46,49,19,1,45,1,246,35.142857142857146,16,0.0,16,46,42,19,69,1,7,45,1,123,123,0
957,7975,EwJz8sdPLnTPbvCqxQKV7YueKEdP0wYf,SpATywNh6bZuzm8s1ceuBUnMUAeoAHHw,59,76,48,47,25,4,19,0,219,31.285714285714285,8,0.0,12,48,40,25,64,4,7,19,0,125,94,0
958,7999,j55CnsxXtuPHDTIgqOvx7oExU3RRtQ4I,SpATywNh6bZuzm8s1ceuBUnMUAeoAHHw,42,68,32,31,15,14,36,1,197,28.142857142857142,11,0.0,14,32,29,15,54,14,2,36,1,90,107,1
959,8000,YiNeIrEOhZYEzsuuN5nQKcsVr5To2nDU,SpATywNh6bZuzm8s1ceuBUnMUAeoAHHw,43,42,26,44,16,2,24,0,154,22.0,9,0.0,15,26,39,16,27,2,5,24,0,96,58,0
960,8001,DI3YZyhWTKxhZZnQuVUpGne2QEEoyvnw,SpATywNh6bZuzm8s1ceuBUnMUAeoAHHw,47,65,32,41,18,1,20,30,207,29.571428571428573,5,0.0,26,32,38,18,39,1,3,20,30,114,93,0
961,8016,0wTvjguYOmHTRx6CgVlID5lRmd6At3zN,RXDvfPUBYFlVdlueBFbLW0mhhAyGEqpt,50,65,53,0,41,4,12,0,175,25.0,5,0.0,0,53,0,41,65,4,0,12,0,94,81,0
962,8026,KtSnhyXFi6bevwD38L0oZAkqxHVX0Rkl,RXDvfPUBYFlVdlueBFbLW0mhhAyGEqpt,31,55,10,43,17,13,6,19,163,23.285714285714285,3,0.0,18,10,41,17,37,13,2,6,19,86,77,1
963,8029,cuDL2ISAKT9SiekAD9CQynXiu9fQTVyV,G8EPVSXsOYB5YQWZGiz1aVq5Pgr2GrQu,71,76,14,218,8,8,43,5,372,53.142857142857146,14,0.0,1,14,175,8,75,8,43,43,5,198,174,0
964,8031,Ra8GzsxOGVkAaMFXN2T6V1Y5fgtJJH5X,SpATywNh6bZuzm8s1ceuBUnMUAeoAHHw,23,71,1,31,1,4,15,0,123,17.571428571428573,9,0.0,10,1,28,1,61,4,3,15,0,40,83,0
965,8051,HZ6Si9PJ3YYyrZuVsVHlXbrETWWPILa2,SpATywNh6bZuzm8s1ceuBUnMUAeoAHHw,30,30,13,39,7,4,17,1,111,15.857142857142858,3,0.0,12,13,33,7,18,4,6,17,1,65,46,1
966,8059,W8K4VS8rPvnPTNUJrqgtS2FKH93KmR91,bWdj2GDclj5ofokWjzoa5jAwMkxCykd6,42,75,36,251,17,5,18,1,403,57.57142857142857,7,0.0,6,36,228,17,69,5,23,18,1,287,116,1
967,8061,eDdFtfGTTqvukOdpQCeNfhpEnZacRMyL,SpATywNh6bZuzm8s1ceuBUnMUAeoAHHw,41,40,25,33,15,0,19,0,132,18.857142857142858,6,0.0,7,25,30,15,33,0,3,19,0,77,55,0
968,8065,F4JRzQAurYVB0YRhdceJcfWH3R0QimyF,A3fsA9Zfv1X2fVEQhTw51lKENdNrEqT3,6,9,0,0,0,1,4,0,14,2.0,1,0.0,0,0,0,0,9,1,0,4,0,0,14,1
969,8070,Hk1cgW0d6IHp4JJgdPvorinTv3vI8Eld,bWdj2GDclj5ofokWjzoa5jAwMkxCykd6,2,0,0,0,0,0,2,0,2,0.2857142857142857,1,0.0,0,0,0,0,0,0,0,2,0,0,2,1
970,8078,nD2aR2lBTYEZ05tUWGjogkwgt2d7zeNx,bWdj2GDclj5ofokWjzoa5jAwMkxCykd6,35,64,3,137,3,25,23,1,256,36.57142857142857,5,0.0,8,3,125,3,56,25,12,23,1,139,117,1
971,8087,3nOS3JEH08BgwunQqioyEFfja4qIND4p,A3fsA9Zfv1X2fVEQhTw51lKENdNrEqT3,37,26,3,58,2,0,8,0,97,13.857142857142858,3,0.0,5,3,51,2,21,0,7,8,0,61,36,1
972,8106,MyaVABM4nYDk4vd54igotJktuGSzZ2QZ,SpATywNh6bZuzm8s1ceuBUnMUAeoAHHw,4,2,0,0,0,0,2,0,4,0.5714285714285714,1,0.0,0,0,0,0,2,0,0,2,0,0,4,1
973,8120,9vfzrI57qoGmouqr760GeuDugjxYZgDg,A3fsA9Zfv1X2fVEQhTw51lKENdNrEqT3,2,0,0,0,0,0,2,0,2,0.2857142857142857,1,0.0,0,0,0,0,0,0,0,2,0,0,2,1
974,8124,aFQfsfvTRloUF4eJLXlE0V3FUzRLFNv8,RXDvfPUBYFlVdlueBFbLW0mhhAyGEqpt,11,10,6,0,3,0,5,0,24,3.4285714285714284,2,0.0,2,6,0,3,8,0,0,5,0,11,13,1
975,8131,0chnDCxU68X7ybwDimwVoWcTfCUDrb8j,SpATywNh6bZuzm8s1ceuBUnMUAeoAHHw,21,23,12,18,7,74,16,5,155,22.142857142857142,2,0.0,7,12,15,7,16,74,3,16,5,41,114,1
976,8150,0QzhB266MffxtP4NW9xGCK2aFIanQJEL,SpATywNh6bZuzm8s1ceuBUnMUAeoAHHw,17,50,22,16,6,190,37,6,327,46.714285714285715,6,0.0,18,22,13,6,32,190,3,37,6,59,268,1
977,8155,S6HVmLPlerZStE1FmYWcP13FOlr0Ldio,SpATywNh6bZuzm8s1ceuBUnMUAeoAHHw,29,48,2,20,1,4,23,2,100,14.285714285714286,7,0.0,15,2,18,1,33,4,2,23,2,36,64,1
978,8159,rLDZGBeZrRdOkLUUwzLb6ezyjai8N3vb,G8EPVSXsOYB5YQWZGiz1aVq5Pgr2GrQu,9,3,2,0,1,2,8,0,16,2.2857142857142856,1,0.0,0,2,0,1,3,2,0,8,0,3,13,1
979,8164,OvIrFDXnTf7lPGXHN37tKh2m9dXSHGJK,RXDvfPUBYFlVdlueBFbLW0mhhAyGEqpt,106,170,98,173,31,206,69,17,764,109.14285714285714,12,0.0,30,98,170,31,140,206,3,69,17,329,435,0
980,8167,4OFy9ZLb1svxpVgXkgI60wOGeiU4V4oA,SpATywNh6bZuzm8s1ceuBUnMUAeoAHHw,32,67,32,38,10,3,24,1,175,25.0,4,0.0,10,32,31,10,57,3,7,24,1,83,92,1
981,8171,Agc8I1aREEPfi2PqA7NK0aenTcuvE1HC,SpATywNh6bZuzm8s1ceuBUnMUAeoAHHw,43,51,33,40,18,21,15,4,182,26.0,7,0.0,10,33,34,18,41,21,6,15,4,95,87,0
982,8174,ZFeBOOLKgUUTF7XgzMMbqDAJmFSviC7K,SpATywNh6bZuzm8s1ceuBUnMUAeoAHHw,62,108,58,51,31,1,40,1,290,41.42857142857143,12,0.0,26,58,47,31,82,1,4,40,1,162,128,0
983,8182,LVZNwk74X0NnQqnGU1Um0MYH9C8V0Gpb,A3fsA9Zfv1X2fVEQhTw51lKENdNrEqT3,29,28,22,4,17,1,10,1,83,11.857142857142858,1,0.0,0,22,3,17,28,1,1,10,1,42,41,1
984,8183,FFyynYy7wGQKjNauntgybGuFHItz8juf,G8EPVSXsOYB5YQWZGiz1aVq5Pgr2GrQu,151,140,69,388,44,0,18,0,659,94.14285714285714,11,0.0,8,69,330,44,132,0,58,18,0,451,208,0
985,8189,vJz36xQo6TWpiQM1Na1nFu4lVJoSD2XQ,A3fsA9Zfv1X2fVEQhTw51lKENdNrEqT3,11,5,1,0,1,1,8,1,17,2.4285714285714284,2,0.0,0,1,0,1,5,1,0,8,1,2,15,1
986,8190,yFLanYq8p4sf6NFSB1Td9ag6632plY4t,bWdj2GDclj5ofokWjzoa5jAwMkxCykd6,20,35,21,12,11,0,14,0,93,13.285714285714286,5,0.0,7,21,11,11,28,0,1,14,0,50,43,1
987,8193,95EnvGi27MT4ra7RQ8eLxKyAZNUVPzZY,G8EPVSXsOYB5YQWZGiz1aVq5Pgr2GrQu,4,0,0,0,0,0,5,0,5,0.7142857142857143,1,0.0,0,0,0,0,0,0,0,5,0,0,5,1
988,8194,I2GJVZ7RHpZycmvh6r4mj8R0Y34OZpBl,SpATywNh6bZuzm8s1ceuBUnMUAeoAHHw,25,52,3,32,2,11,22,1,123,17.571428571428573,6,0.0,11,3,26,2,41,11,6,22,1,42,81,1
989,8200,myPDU4mr5TIDvQCh3WcoSxbhe6fCunPv,SpATywNh6bZuzm8s1ceuBUnMUAeoAHHw,32,63,24,30,12,1,15,1,146,20.857142857142858,5,0.0,8,24,27,12,55,1,3,15,1,71,75,0
990,8216,PR09vSIT2XyOVxXQjGmEX911FaSVIYTE,SpATywNh6bZuzm8s1ceuBUnMUAeoAHHw,17,22,9,14,4,3,11,1,64,9.142857142857142,5,0.0,6,9,13,4,16,3,1,11,1,32,32,1
991,8223,nx1z63DgmeEAxW8gQgEbpcNs34kbRne4,bWdj2GDclj5ofokWjzoa5jAwMkxCykd6,2,0,0,0,0,0,10,0,10,1.4285714285714286,5,0.0,0,0,0,0,0,0,0,10,0,0,10,1
992,8224,5u57vWlYBlYDQJhbIpJzLY4ZLMAv0Mtf,SpATywNh6bZuzm8s1ceuBUnMUAeoAHHw,47,74,27,41,22,34,27,5,230,32.857142857142854,7,0.0,21,27,38,22,53,34,3,27,5,108,122,1
993,8234,1IMOvf9v1bRH0tUTRkiIkzGe833lnAgf,SpATywNh6bZuzm8s1ceuBUnMUAeoAHHw,27,33,14,20,7,2,4,0,80,11.428571428571429,2,0.0,14,14,16,7,19,2,4,4,0,51,29,1
994,8235,gNTGzjcOmHTKgzmUa0veV0Pk7aaKxz1N,SpATywNh6bZuzm8s1ceuBUnMUAeoAHHw,18,34,7,28,1,12,6,0,88,12.571428571428571,3,0.0,14,7,23,1,20,12,5,6,0,45,43,0
995,8241,EV3yvBrX41XoJgzc87hp5TvHhhtAvyFn,SpATywNh6bZuzm8s1ceuBUnMUAeoAHHw,27,41,21,28,8,0,10,0,108,15.428571428571429,4,0.0,8,21,26,8,33,0,2,10,0,63,45,1
996,8242,3mL78JhEm154Hwp0XQW8ZVuzbvUw5uCk,SpATywNh6bZuzm8s1ceuBUnMUAeoAHHw,48,82,48,3,27,4,18,1,183,26.142857142857142,10,0.0,9,48,3,27,73,4,0,18,1,87,96,0
997,8252,HKDSRzc7MQzCfJsk49D6xFQK4oFHHvy7,SpATywNh6bZuzm8s1ceuBUnMUAeoAHHw,39,110,1,60,0,7,53,2,233,33.285714285714285,11,0.0,37,1,51,0,73,7,9,53,2,89,144,0
998,8258,JTNAXWhf5PjT17BvIH89SNZsmQ5O87y8,SpATywNh6bZuzm8s1ceuBUnMUAeoAHHw,22,33,16,21,9,0,3,0,82,11.714285714285714,2,0.0,15,16,21,9,18,0,0,3,0,61,21,1
999,8259,DVIil2NM7ZWOtqe6rhlMzwEUAb2wuaeh,bWdj2GDclj5ofokWjzoa5jAwMkxCykd6,34,85,49,76,19,16,20,0,265,37.857142857142854,12,0.0,13,49,76,19,72,16,0,20,0,157,108,0
1000,8260,DVIil2NM7ZWOtqe6rhlMzwEUAb2wuaeh,A3fsA9Zfv1X2fVEQhTw51lKENdNrEqT3,68,153,90,69,31,20,24,0,387,55.285714285714285,11,0.0,5,90,69,31,148,20,0,24,0,195,192,0
1001,8271,Bf5XnSmEHpp62KAmmEq9Qh5nAQvits8I,SpATywNh6bZuzm8s1ceuBUnMUAeoAHHw,28,45,27,19,19,7,13,1,131,18.714285714285715,6,0.0,17,27,18,19,28,7,1,13,1,81,50,1
1002,8274,wcD7BoyQ6hUK2AqYmriY7H2V7sWuy6kP,G8EPVSXsOYB5YQWZGiz1aVq5Pgr2GrQu,6,2,0,0,0,1,6,1,10,1.4285714285714286,1,0.0,0,0,0,0,2,1,0,6,1,0,10,1
1003,8275,GHabqgRgi0KXSBTYXxIc3mcQESEOp0QM,SpATywNh6bZuzm8s1ceuBUnMUAeoAHHw,25,61,28,4,3,1578,92,1,1767,252.42857142857142,15,0.0,12,28,3,3,49,1578,1,92,1,46,1721,0
1004,8276,V7y3ErWDx79HQwDxdGqBqCI3nEwG2a9C,SpATywNh6bZuzm8s1ceuBUnMUAeoAHHw,35,69,8,40,5,37,28,3,190,27.142857142857142,7,0.0,13,8,36,5,56,37,4,28,3,62,128,0
1005,8280,41Lg2hcbw0N9iuSjhrPTYqB7aTnux5zG,SpATywNh6bZuzm8s1ceuBUnMUAeoAHHw,45,77,34,38,16,0,21,0,186,26.571428571428573,12,0.0,6,34,35,16,71,0,3,21,0,91,95,0
1006,8299,SYTowVKdp8XatPrqrpe4A3JAMuYI5Sox,A3fsA9Zfv1X2fVEQhTw51lKENdNrEqT3,3,3,0,0,0,0,2,0,5,0.7142857142857143,1,0.0,0,0,0,0,3,0,0,2,0,0,5,1
1007,8306,cpsVaqCE0ju1HgyRTcGi2lL27KFxQlQV,G8EPVSXsOYB5YQWZGiz1aVq5Pgr2GrQu,13,38,2,0,2,33,16,0,91,13.0,3,0.0,0,2,0,2,38,33,0,16,0,4,87,1
1008,8307,U091mKrbkiTDzf4rGIqu8muSeBSZhUjL,A3fsA9Zfv1X2fVEQhTw51lKENdNrEqT3,37,18,10,76,6,0,4,0,114,16.285714285714285,2,0.0,5,10,61,6,13,0,15,4,0,82,32,1
1009,8319,VzKWDpKk4q6OejBxKl56odCKiGjlmGba,SpATywNh6bZuzm8s1ceuBUnMUAeoAHHw,7,3,2,0,2,0,2,0,9,1.2857142857142858,1,0.0,0,2,0,2,3,0,0,2,0,4,5,1
1010,8327,Rxx8uEqY3FOt7Egy2EEEwihJJCyVsQKy,G8EPVSXsOYB5YQWZGiz1aVq5Pgr2GrQu,139,175,83,252,63,15,39,5,632,90.28571428571429,14,0.0,67,83,197,63,108,15,55,39,5,410,222,0
1011,8330,RPoQoiLJoTfoUXTEomWL6iW4S8GRhX7J,SpATywNh6bZuzm8s1ceuBUnMUAeoAHHw,13,23,8,17,3,0,5,0,56,8.0,4,0.0,4,8,14,3,19,0,3,5,0,29,27,0
1012,8335,2tvGCUYYinrGZmVDaUEHPItUSSMqiKmY,SpATywNh6bZuzm8s1ceuBUnMUAeoAHHw,44,84,46,42,29,0,14,0,215,30.714285714285715,8,0.0,13,46,38,29,71,0,4,14,0,126,89,0
1013,8336,UgRvVqO3twMvJzAlD49rqrTbxTS8yLpX,A3fsA9Zfv1X2fVEQhTw51lKENdNrEqT3,74,44,34,116,25,0,11,0,230,32.857142857142854,7,0.0,2,34,105,25,42,0,11,11,0,166,64,1
1014,8337,SP1OGXx7XA1zodabwHSZpThCzaY2Fjl2,SpATywNh6bZuzm8s1ceuBUnMUAeoAHHw,35,54,12,29,5,24,14,0,138,19.714285714285715,11,0.0,8,12,28,5,46,24,1,14,0,53,85,0
1015,8347,jMKMopo0fDIDt1YMaxiGrP1SNRt3VtFz,SpATywNh6bZuzm8s1ceuBUnMUAeoAHHw,32,99,56,26,25,3,22,0,231,33.0,7,0.0,22,56,25,25,77,3,1,22,0,128,103,0
1016,8359,xI8Nr9tpm5UYMfkPTEK7ZnHqHm9s1zwr,SpATywNh6bZuzm8s1ceuBUnMUAeoAHHw,30,59,0,31,1,2,10,1,104,14.857142857142858,7,0.0,8,0,26,1,51,2,5,10,1,35,69,1
1017,8372,Ja8xgxpUQSylPcWwfGyX1RUCUJ6MhJqT,SpATywNh6bZuzm8s1ceuBUnMUAeoAHHw,45,95,37,26,15,43,20,2,238,34.0,7,0.0,22,37,23,15,73,43,3,20,2,97,141,0
1018,8374,eA2IVnHLbAPJoKRWHDe6zYszLSF4Gt3f,SpATywNh6bZuzm8s1ceuBUnMUAeoAHHw,5,2,1,0,1,1,2,0,7,1.0,1,0.0,0,1,0,1,2,1,0,2,0,2,5,1
1019,8386,UkUsH963uedhLI1tDU35ug9sCdholLWP,SpATywNh6bZuzm8s1ceuBUnMUAeoAHHw,1,0,0,0,0,0,1,0,1,0.14285714285714285,1,0.0,0,0,0,0,0,0,0,1,0,0,1,1
1020,8389,NngMZQTGAdrhmbSK51CUolNQSpFXDhiO,SpATywNh6bZuzm8s1ceuBUnMUAeoAHHw,60,122,62,34,28,7,44,2,299,42.714285714285715,9,0.0,25,62,31,28,97,7,3,44,2,146,153,0
1021,8391,tF8i4h1a2Nm3JCN3xA7kONOWBOERcJ4Q,SpATywNh6bZuzm8s1ceuBUnMUAeoAHHw,45,68,36,70,13,5,15,0,207,29.571428571428573,9,0.0,26,36,56,13,42,5,14,15,0,131,76,0
1022,8393,4sCPuVlkq4rBRlBYNyTR5EDg94co1oy4,bWdj2GDclj5ofokWjzoa5jAwMkxCykd6,7,5,2,0,1,0,6,0,14,2.0,3,0.0,0,2,0,1,5,0,0,6,0,3,11,0
1023,8400,LutlROyPHhGEkAfetUikskFihdvWMQNQ,SpATywNh6bZuzm8s1ceuBUnMUAeoAHHw,7,2,1,0,1,0,12,0,16,2.2857142857142856,4,0.0,0,1,0,1,2,0,0,12,0,2,14,1
1024,8405,kWUbu8oK1dFJKpHhiF15MwcSzNzv8GaS,bWdj2GDclj5ofokWjzoa5jAwMkxCykd6,30,64,34,118,14,25,18,0,273,39.0,7,0.0,12,34,111,14,52,25,7,18,0,171,102,0
1025,8416,mrUvSMVJRVrLlCOcTH6rs5HGHSxrWvwY,A3fsA9Zfv1X2fVEQhTw51lKENdNrEqT3,44,32,19,60,12,1,10,1,135,19.285714285714285,4,0.0,7,19,50,12,25,1,10,10,1,88,47,1
1026,8431,7CBtPeICctNtzQffl1jHApp4Y7WIYc5w,SpATywNh6bZuzm8s1ceuBUnMUAeoAHHw,7,6,5,0,2,0,2,0,15,2.142857142857143,1,0.0,0,5,0,2,6,0,0,2,0,7,8,1
1027,8435,j1jdy8OF5VQw4rqSYOkbK2pQplvvvz37,A3fsA9Zfv1X2fVEQhTw51lKENdNrEqT3,133,166,18,243,14,13,74,0,528,75.42857142857143,16,0.0,10,18,204,14,156,13,39,74,0,246,282,0
1028,8437,12tfSRcVHU1LY6VYbYjnNdGrVUGUAhWB,SpATywNh6bZuzm8s1ceuBUnMUAeoAHHw,57,68,43,23,23,3,17,1,178,25.428571428571427,8,0.0,15,43,21,23,53,3,2,17,1,102,76,0
1029,8446,oDnQYjxji4p3XVFJMOGI9NvIvASqoqC1,A3fsA9Zfv1X2fVEQhTw51lKENdNrEqT3,45,24,19,78,14,0,20,0,155,22.142857142857142,6,0.0,1,19,63,14,23,0,15,20,0,97,58,1
1030,8447,gok0oMg5xY1pC9HgrOtGpZy6NUwXLxlf,SpATywNh6bZuzm8s1ceuBUnMUAeoAHHw,9,30,0,6,0,1,13,0,50,7.142857142857143,4,0.0,2,0,5,0,28,1,1,13,0,7,43,1
1031,8456,Ve3uiMw5Q81FgfkGuxFl4mQAXBScEtc6,G8EPVSXsOYB5YQWZGiz1aVq5Pgr2GrQu,29,11,8,69,6,0,7,0,101,14.428571428571429,2,0.0,0,8,54,6,11,0,15,7,0,68,33,1
1032,8461,tH916xRbn4bSZXJ6Z57PlnTAPQfz04PX,SpATywNh6bZuzm8s1ceuBUnMUAeoAHHw,42,47,31,2,18,0,17,0,115,16.428571428571427,10,0.0,1,31,2,18,46,0,0,17,0,52,63,0
1033,8473,wfFQgTOVxHIMKx1Ficu9NrZPRH0gMksQ,bWdj2GDclj5ofokWjzoa5jAwMkxCykd6,3,3,0,0,0,0,1,0,4,0.5714285714285714,1,0.0,0,0,0,0,3,0,0,1,0,0,4,1
1034,8476,iUNH7SHIFk6NFV7H1Nzzf4QPKBlc8jre,SpATywNh6bZuzm8s1ceuBUnMUAeoAHHw,9,5,4,0,4,0,2,0,15,2.142857142857143,1,0.0,0,4,0,4,5,0,0,2,0,8,7,1
1035,8486,BeZnyZhcScrHr8WAPYtxUxDjMPiK7yK1,SpATywNh6bZuzm8s1ceuBUnMUAeoAHHw,24,50,27,0,13,0,15,0,105,15.0,9,0.0,4,27,0,13,46,0,0,15,0,44,61,0
1036,8492,ttr9a170CwLt0wxJRJXz9h6pCGNxEiGM,SpATywNh6bZuzm8s1ceuBUnMUAeoAHHw,8,11,0,0,0,0,6,0,17,2.4285714285714284,4,0.0,0,0,0,0,11,0,0,6,0,0,17,1
1037,8494,gir9E9ZUbwj6bCUNLD2kQmOx1nsVwG4J,SpATywNh6bZuzm8s1ceuBUnMUAeoAHHw,29,59,25,14,11,13,18,1,141,20.142857142857142,8,0.0,15,25,14,11,44,13,0,18,1,65,76,1
1038,8503,PtXR7nBc6ugMebaEp6mKjp0TYO5kZtvE,SpATywNh6bZuzm8s1ceuBUnMUAeoAHHw,48,122,72,49,33,37,35,1,349,49.857142857142854,14,0.0,25,72,43,33,97,37,6,35,1,173,176,0
1039,8511,FjbDR3UaxcNBkb6IH3GDQCUcWtWdh8Qq,A3fsA9Zfv1X2fVEQhTw51lKENdNrEqT3,17,8,5,46,2,0,3,0,64,9.142857142857142,2,0.0,1,5,37,2,7,0,9,3,0,45,19,1
1040,8519,doRePDFWyZgA5bRcL7NARsAGKc9EfIRX,SpATywNh6bZuzm8s1ceuBUnMUAeoAHHw,1,0,0,0,0,0,1,0,1,0.14285714285714285,1,0.0,0,0,0,0,0,0,0,1,0,0,1,1
1041,8534,sYJH30p3sjRgvjLciMuuEKpuHxukMGmh,bWdj2GDclj5ofokWjzoa5jAwMkxCykd6,13,17,6,12,4,2,14,2,57,8.142857142857142,3,0.0,5,6,10,4,12,2,2,14,2,25,32,1
1042,8539,ApFdQQBcLqTLoA4wIvtlnnwFs4FrlVS1,A3fsA9Zfv1X2fVEQhTw51lKENdNrEqT3,103,66,51,252,26,1,52,1,449,64.14285714285714,15,0.0,6,51,238,26,60,1,14,52,1,321,128,0
1043,8542,DALf49Q7nGCtSxipmkha0WYpWi5x67si,SpATywNh6bZuzm8s1ceuBUnMUAeoAHHw,26,51,5,33,5,9,32,4,139,19.857142857142858,3,0.0,14,5,29,5,37,9,4,32,4,53,86,1
1044,8552,pSX00XUyCx7VlmgWGN0d39OwC9BZ8bRV,A3fsA9Zfv1X2fVEQhTw51lKENdNrEqT3,44,19,14,46,9,3,8,0,99,14.142857142857142,2,0.0,1,14,43,9,18,3,3,8,0,67,32,1
1045,8554,R2LGboNcUADM1LGFGgPuEpT43AraZJb1,SpATywNh6bZuzm8s1ceuBUnMUAeoAHHw,2,0,0,0,0,0,2,0,2,0.2857142857142857,1,0.0,0,0,0,0,0,0,0,2,0,0,2,1
1046,8562,2YohZ5UKGzy1qUgVAShosLdhgm3pfvsR,RXDvfPUBYFlVdlueBFbLW0mhhAyGEqpt,30,47,5,35,3,10,9,11,120,17.142857142857142,6,0.0,7,5,33,3,40,10,2,9,11,48,72,1
1047,8576,HHsJECDPslzJS0fyoCEbSGrnL1evzSJb,SpATywNh6bZuzm8s1ceuBUnMUAeoAHHw,61,88,40,26,24,5,25,3,211,30.142857142857142,8,0.0,30,40,26,24,58,5,0,25,3,120,91,0
1048,8578,ctoSfpAfvm3av2aqkT0D3Yq8icDxZKCx,SpATywNh6bZuzm8s1ceuBUnMUAeoAHHw,7,7,2,0,2,0,6,0,17,2.4285714285714284,4,0.0,1,2,0,2,6,0,0,6,0,5,12,1
1049,8579,5SaN6rc1Jws1AbkuHmPyLN82qDTc23Xp,SpATywNh6bZuzm8s1ceuBUnMUAeoAHHw,15,31,2,16,0,5,15,2,71,10.142857142857142,3,0.0,1,2,12,0,30,5,4,15,2,15,56,1
1050,8580,NbSKhx4CxJyTkjcYgC3wEU9PLylFddj5,SpATywNh6bZuzm8s1ceuBUnMUAeoAHHw,35,128,4,40,3,61,46,6,288,41.142857142857146,12,0.0,53,4,35,3,75,61,5,46,6,95,193,0
1051,8589,QiGOPB8shOtQ5nbvOvvOxzT1SShMMuAf,SpATywNh6bZuzm8s1ceuBUnMUAeoAHHw,29,37,13,45,7,6,8,0,116,16.571428571428573,3,0.0,13,13,37,7,24,6,8,8,0,70,46,0
1052,8590,tQHFI5lya7DKbCzO4oTkHd2600sh8kNe,G8EPVSXsOYB5YQWZGiz1aVq5Pgr2GrQu,21,22,7,38,5,0,5,0,77,11.0,3,0.0,9,7,30,5,13,0,8,5,0,51,26,1
1053,8603,NDWoO09mCIeS4HdBeNYH7dNkyhIv3eXv,SpATywNh6bZuzm8s1ceuBUnMUAeoAHHw,46,61,2,35,1,23,17,2,141,20.142857142857142,7,0.0,12,2,32,1,49,23,3,17,2,47,94,1
1054,8610,YPO9VbNOFh7KZMXyxOJMSk1iTNwVpJOe,SpATywNh6bZuzm8s1ceuBUnMUAeoAHHw,11,12,0,12,0,0,6,0,30,4.285714285714286,1,0.0,6,0,11,0,6,0,1,6,0,17,13,0
1055,8617,ls4yyZ7MYyWiEmQ5nJV5QAmKdBgFaV8n,G8EPVSXsOYB5YQWZGiz1aVq5Pgr2GrQu,51,99,35,114,16,0,17,0,281,40.142857142857146,5,0.0,61,35,81,16,38,0,33,17,0,193,88,1
1056,8622,Y7IgoRAqVJfNlsulCSI4HObujHPSzoLA,A3fsA9Zfv1X2fVEQhTw51lKENdNrEqT3,13,8,6,0,5,0,2,0,21,3.0,2,0.0,0,6,0,5,8,0,0,2,0,11,10,1
1057,8626,yq8YyMugEpZrcWzhPtzidXoqQsPJ81ZJ,G8EPVSXsOYB5YQWZGiz1aVq5Pgr2GrQu,4,2,0,0,0,1,3,0,6,0.8571428571428571,2,0.0,0,0,0,0,2,1,0,3,0,0,6,1
1058,8635,jH123vWnpYTVLfmuSyled9Oau0AYvcx6,G8EPVSXsOYB5YQWZGiz1aVq5Pgr2GrQu,41,20,2,118,1,0,7,0,148,21.142857142857142,3,0.0,0,2,103,1,20,0,15,7,0,106,42,1
1059,8637,YeutUTPU1KeBL2Vd5ZhxL2fFNQ8D7NVG,SpATywNh6bZuzm8s1ceuBUnMUAeoAHHw,17,43,13,12,3,11,18,3,103,14.714285714285714,2,0.0,21,13,12,3,22,11,0,18,3,49,54,1
1060,8638,kXndrjnvT5RUWACXG428KqXdIpBxsEit,A3fsA9Zfv1X2fVEQhTw51lKENdNrEqT3,12,26,0,0,0,2,12,1,41,5.857142857142857,4,0.0,1,0,0,0,25,2,0,12,1,1,40,1
1061,8639,xqboiFlp42vyY93nDStsbVWBCL5sgIRH,SpATywNh6bZuzm8s1ceuBUnMUAeoAHHw,5,2,1,0,1,0,4,0,8,1.1428571428571428,1,0.0,0,1,0,1,2,0,0,4,0,2,6,1
1062,8644,4PVAcJZJLiNhJa8rMcHaqBMuPaZIl5Nm,SpATywNh6bZuzm8s1ceuBUnMUAeoAHHw,27,30,17,27,11,0,13,0,98,14.0,4,0.0,7,17,23,11,23,0,4,13,0,58,40,1
1063,8647,pZDK7WA5fQeGMPFsats2GLmFnZbZQ7ed,SpATywNh6bZuzm8s1ceuBUnMUAeoAHHw,24,49,22,26,6,15,14,1,133,19.0,5,0.0,16,22,23,6,33,15,3,14,1,67,66,1
1064,8654,nquBmikiqPFYvs17N894M5iUc88scoVO,SpATywNh6bZuzm8s1ceuBUnMUAeoAHHw,36,144,6,50,1,73,37,2,313,44.714285714285715,8,0.0,11,6,42,1,133,73,8,37,2,60,253,0
1065,8661,CxzZVyClE1BEgH3USSirqOtKD3HSH7vg,SpATywNh6bZuzm8s1ceuBUnMUAeoAHHw,17,17,8,12,4,0,6,2,49,7.0,2,0.0,2,8,11,4,15,0,1,6,2,25,24,1
1066,8679,kyUPY0MEVeZNvkmrQxOn0CHNXLZiD03b,A3fsA9Zfv1X2fVEQhTw51lKENdNrEqT3,10,24,2,0,1,10,8,0,45,6.428571428571429,5,0.0,3,2,0,1,21,10,0,8,0,6,39,1
1067,8691,ESjXyWS3x5wlkZHp5KISOO9gy5mDNyIG,SpATywNh6bZuzm8s1ceuBUnMUAeoAHHw,15,27,15,0,9,0,11,0,62,8.857142857142858,6,0.0,2,15,0,9,25,0,0,11,0,26,36,1
1068,8700,je9A6l6tP7wnbFhNJD7vbbHTYhqshuqB,G8EPVSXsOYB5YQWZGiz1aVq5Pgr2GrQu,86,230,85,236,32,15,32,1,631,90.14285714285714,14,0.0,76,85,177,32,154,15,59,32,1,370,261,0
1069,8701,kxC3AAELak9RRmJoG2dzH7rfP0Xyo0FH,SpATywNh6bZuzm8s1ceuBUnMUAeoAHHw,15,24,16,4,7,0,7,0,58,8.285714285714286,4,0.0,0,16,4,7,24,0,0,7,0,27,31,1
1070,8706,4G8PB07c1AYOLDoNxj95BoxFXM7YCCci,SpATywNh6bZuzm8s1ceuBUnMUAeoAHHw,3,2,0,0,0,0,1,0,3,0.42857142857142855,1,0.0,0,0,0,0,2,0,0,1,0,0,3,1
1071,8708,nzGzo6fW6QPE9hjoabI90qrzv3llY1Fg,G8EPVSXsOYB5YQWZGiz1aVq5Pgr2GrQu,12,17,6,0,3,0,5,0,31,4.428571428571429,2,0.0,2,6,0,3,15,0,0,5,0,11,20,1
1072,8711,MQxVHrLqN67CEKfOyyeFlttLUKuqvrcv,RXDvfPUBYFlVdlueBFbLW0mhhAyGEqpt,30,45,23,12,53,4,3,0,140,20.0,3,0.0,0,23,11,53,45,4,1,3,0,87,53,0
1073,8730,JoruyAOmEeM1qjcSEWRUjLvQUHpNPZGp,RXDvfPUBYFlVdlueBFbLW0mhhAyGEqpt,52,116,3,107,8,88,37,9,368,52.57142857142857,7,0.0,24,3,91,8,92,88,16,37,9,126,242,1
1074,8735,WNT8mFhPmDPRuQT8JLsnindelSr1MnST,SpATywNh6bZuzm8s1ceuBUnMUAeoAHHw,40,62,30,34,11,40,34,3,214,30.571428571428573,8,0.0,14,30,29,11,48,40,5,34,3,84,130,1
1075,8747,WuOqx5J7nUG7M0CzOeQJHpDiW7DgSS7B,SpATywNh6bZuzm8s1ceuBUnMUAeoAHHw,16,31,1,24,1,2,3,0,62,8.857142857142858,1,0.0,15,1,20,1,16,2,4,3,0,37,25,1
1076,8758,NCbFqYNTEfc5vPQvAyBwDtnbS3ENYJY7,bWdj2GDclj5ofokWjzoa5jAwMkxCykd6,12,22,1,37,3,3,14,2,82,11.714285714285714,2,0.0,7,1,35,3,15,3,2,14,2,46,36,1
1077,8759,9SPQ1jfplQbke9byQIAxTVMFCooGS54y,A3fsA9Zfv1X2fVEQhTw51lKENdNrEqT3,16,10,5,0,4,4,8,1,32,4.571428571428571,1,0.0,2,5,0,4,8,4,0,8,1,11,21,1
1078,8761,7ye3FQXc4XBmC7UwnNQWxsWGDnaNcvG6,SpATywNh6bZuzm8s1ceuBUnMUAeoAHHw,24,41,0,34,0,3,12,1,91,13.0,5,0.0,5,0,29,0,36,3,5,12,1,34,57,1
1079,8780,l7cIWSn2QdqLoOKMFO8yNQGKfk999nJh,A3fsA9Zfv1X2fVEQhTw51lKENdNrEqT3,11,11,6,0,0,1,11,2,31,4.428571428571429,3,0.0,2,6,0,0,9,1,0,11,2,8,23,1
1080,8791,E2VKNfvaS8HbcvRZooqcq8161JUOvad2,RXDvfPUBYFlVdlueBFbLW0mhhAyGEqpt,14,23,12,0,4,0,6,0,45,6.428571428571429,4,0.0,1,12,0,4,22,0,0,6,0,17,28,1
1081,8793,Ga4lr67F0RIjyUetWH1EgQ3xzSHDnViF,bWdj2GDclj5ofokWjzoa5jAwMkxCykd6,30,53,26,92,13,5,15,3,207,29.571428571428573,6,0.0,18,26,85,13,35,5,7,15,3,142,65,0
1082,8794,br8lmEhz6IHlXV0QfsU4Spi9BczfMT8x,SpATywNh6bZuzm8s1ceuBUnMUAeoAHHw,31,45,21,44,0,0,8,0,118,16.857142857142858,5,0.0,18,21,40,0,27,0,4,8,0,79,39,0
1083,8803,RFvs5NuNtACNU2U9ElWUm5Jw7rHjvZwP,SpATywNh6bZuzm8s1ceuBUnMUAeoAHHw,6,5,4,0,2,0,1,0,12,1.7142857142857142,1,0.0,0,4,0,2,5,0,0,1,0,6,6,1
1084,8809,ivdkzhYPhrTUKnU1xY68Yfp2rdDhgD3h,SpATywNh6bZuzm8s1ceuBUnMUAeoAHHw,50,119,53,40,24,34,51,4,325,46.42857142857143,7,0.0,33,53,36,24,86,34,4,51,4,146,179,0
1085,8814,8IuzZOXaXVUql9pLZtNuJIyLoDJ8ZL4V,SpATywNh6bZuzm8s1ceuBUnMUAeoAHHw,15,29,11,6,3,1,9,0,59,8.428571428571429,6,0.0,4,11,6,3,25,1,0,9,0,24,35,0
1086,8815,Ga4lr67F0RIjyUetWH1EgQ3xzSHDnViF,A3fsA9Zfv1X2fVEQhTw51lKENdNrEqT3,1,0,0,0,0,0,1,0,1,0.14285714285714285,1,0.0,0,0,0,0,0,0,0,1,0,0,1,1
1087,8852,1sf1a7OMEvwky5hvLFD12TaOsmoNw2Qb,SpATywNh6bZuzm8s1ceuBUnMUAeoAHHw,39,91,39,38,18,0,9,0,195,27.857142857142858,9,0.0,12,39,36,18,79,0,2,9,0,105,90,0
1088,8860,IwB6SmnBZExRlnmOtkIDRkNteqe5iWyf,SpATywNh6bZuzm8s1ceuBUnMUAeoAHHw,1,0,0,0,0,0,1,0,1,0.14285714285714285,1,0.0,0,0,0,0,0,0,0,1,0,0,1,1
1089,8865,Up0SfqXbbz6NGY2S4ku6GM2FOwYrzCdN,SpATywNh6bZuzm8s1ceuBUnMUAeoAHHw,1,0,0,0,0,0,1,0,1,0.14285714285714285,1,0.0,0,0,0,0,0,0,0,1,0,0,1,1
1090,8870,ZNWyxGsQnaw3e5XPyIUr5rwKsBrD0VQe,G8EPVSXsOYB5YQWZGiz1aVq5Pgr2GrQu,8,21,1,0,2,0,4,0,28,4.0,1,0.0,8,1,0,2,13,0,0,4,0,11,17,0
1091,8900,fY0uxi2rFKNgoTYTvIZdgXrk3XKUTjS3,SpATywNh6bZuzm8s1ceuBUnMUAeoAHHw,41,86,25,48,10,2,9,0,180,25.714285714285715,6,0.0,10,25,42,10,76,2,6,9,0,87,93,0
1092,8904,0QFADiD6IvsCiGKcRzsLQbDvaZGh6BVG,SpATywNh6bZuzm8s1ceuBUnMUAeoAHHw,9,9,2,0,2,0,3,0,16,2.2857142857142856,2,0.0,0,2,0,2,9,0,0,3,0,4,12,0
1093,8917,5vUuq5ZeDCNce4LmvH0naoUjpb3qbNOp,SpATywNh6bZuzm8s1ceuBUnMUAeoAHHw,19,20,11,14,3,8,15,1,72,10.285714285714286,7,0.0,3,11,11,3,17,8,3,15,1,28,44,1
1094,8925,PenDUeO0eoR8hyLVdfPN6H7q2FnTGMus,A3fsA9Zfv1X2fVEQhTw51lKENdNrEqT3,37,45,22,102,4,99,42,2,316,45.142857142857146,9,0.0,3,22,83,4,42,99,19,42,2,112,204,0
1095,8929,1oBn81XXDSWJtnCZIRPmhZcBWe7qP0iB,RXDvfPUBYFlVdlueBFbLW0mhhAyGEqpt,61,105,65,145,28,2,28,0,373,53.285714285714285,9,0.0,19,65,133,28,86,2,12,28,0,245,128,1
1096,8934,H3CmwGihecRb7lZltIA7orKjensSqIgF,RXDvfPUBYFlVdlueBFbLW0mhhAyGEqpt,16,21,3,0,4,12,2,0,42,6.0,3,0.0,2,3,0,4,19,12,0,2,0,9,33,1
1097,8935,pYasYOOyUapjKdoqnDhFpArs52eNDPLb,SpATywNh6bZuzm8s1ceuBUnMUAeoAHHw,39,73,42,50,18,1,20,0,204,29.142857142857142,12,0.0,16,42,42,18,57,1,8,20,0,118,86,0
1098,8945,Iupcx1vHh7MTin0aJweHjQkwiErp9HHL,SpATywNh6bZuzm8s1ceuBUnMUAeoAHHw,5,2,1,0,1,0,2,0,6,0.8571428571428571,1,0.0,0,1,0,1,2,0,0,2,0,2,4,1
1099,8956,JtMmp5BCDQnYE7CMI3NvnX4aRCZsQW9K,bWdj2GDclj5ofokWjzoa5jAwMkxCykd6,16,32,14,0,8,11,59,2,126,18.0,15,0.0,4,14,0,8,28,11,0,59,2,26,100,0
1100,8966,qFpdcx3mtZSSE0KVCMsIlMdOIeoOzyoo,SpATywNh6bZuzm8s1ceuBUnMUAeoAHHw,30,95,29,38,4,16,42,6,230,32.857142857142854,17,0.0,24,29,31,4,71,16,7,42,6,88,142,0
1101,8971,p04QzukP32kpPk8EGoBhDUGJJQqJUoNz,SpATywNh6bZuzm8s1ceuBUnMUAeoAHHw,41,93,14,23,8,47,38,6,229,32.714285714285715,10,0.0,24,14,23,8,69,47,0,38,6,69,160,0
1102,8990,d50bzrDUj3g2Xiqt1t5CNiAegqkJwLeY,SpATywNh6bZuzm8s1ceuBUnMUAeoAHHw,15,19,2,0,2,1,7,1,32,4.571428571428571,1,0.0,5,2,0,2,14,1,0,7,1,9,23,1
1103,8991,N16QHS59cTDWe3hpSKjuHvn5eRO4wcEE,SpATywNh6bZuzm8s1ceuBUnMUAeoAHHw,7,6,3,0,2,0,3,0,14,2.0,1,0.0,0,3,0,2,6,0,0,3,0,5,9,1
1104,9002,L534Da3JB50xKXQoTXrCa1H5GVkKxZyU,SpATywNh6bZuzm8s1ceuBUnMUAeoAHHw,8,5,2,0,2,0,4,0,13,1.8571428571428572,1,0.0,0,2,0,2,5,0,0,4,0,4,9,1
1105,9011,sNZ43ghPU2QwNk3cu7wYztVZWvmkGmKL,SpATywNh6bZuzm8s1ceuBUnMUAeoAHHw,48,83,41,38,14,13,6,0,195,27.857142857142858,8,0.0,24,41,37,14,59,13,1,6,0,116,79,0
1106,9015,3BQ5hO2xolpwYa13L4VN9VBwShRsjOB9,A3fsA9Zfv1X2fVEQhTw51lKENdNrEqT3,17,9,7,0,6,0,4,0,26,3.7142857142857144,1,0.0,0,7,0,6,9,0,0,4,0,13,13,1
1107,9017,a5tgLYkHndhh8Yb10TacQs9Vi34mi45u,RXDvfPUBYFlVdlueBFbLW0mhhAyGEqpt,47,40,22,79,12,5,16,9,183,26.142857142857142,3,0.0,15,22,72,12,25,5,7,16,9,121,62,0
1108,9018,pVooF8yxRpciMTpPCaLN6jM2lWrWpauA,SpATywNh6bZuzm8s1ceuBUnMUAeoAHHw,7,4,2,0,0,2,8,1,17,2.4285714285714284,2,0.0,1,2,0,0,3,2,0,8,1,3,14,1
1109,9023,K7xeVolEtXE0AogXgMn5GEzQ96UioEwW,SpATywNh6bZuzm8s1ceuBUnMUAeoAHHw,16,16,8,0,8,0,1,0,33,4.714285714285714,1,0.0,4,8,0,8,12,0,0,1,0,20,13,1
1110,9031,L534Da3JB50xKXQoTXrCa1H5GVkKxZyU,bWdj2GDclj5ofokWjzoa5jAwMkxCykd6,5,2,1,0,1,0,2,0,6,0.8571428571428571,1,0.0,0,1,0,1,2,0,0,2,0,2,4,1
1111,9040,AoGNGJBevj5UJJAo0rhBglhkcP4W6WBy,bWdj2GDclj5ofokWjzoa5jAwMkxCykd6,1,0,0,0,0,0,1,0,1,0.14285714285714285,1,0.0,0,0,0,0,0,0,0,1,0,0,1,1
1112,9041,L534Da3JB50xKXQoTXrCa1H5GVkKxZyU,RXDvfPUBYFlVdlueBFbLW0mhhAyGEqpt,5,2,1,0,1,0,2,0,6,0.8571428571428571,1,0.0,0,1,0,1,2,0,0,2,0,2,4,1
1113,9047,bssQsmzoNxPtkllVsM0XyYElvtsPU1iO,A3fsA9Zfv1X2fVEQhTw51lKENdNrEqT3,6,10,1,0,1,0,2,0,14,2.0,2,0.0,0,1,0,1,10,0,0,2,0,2,12,1
1114,9048,8IYoAw78mc8ysNlcBgXt630ETnnEuaUM,SpATywNh6bZuzm8s1ceuBUnMUAeoAHHw,14,24,2,23,1,0,12,0,62,8.857142857142858,4,0.0,9,2,22,1,15,0,1,12,0,34,28,0
1115,9056,WJoD89Bo9NFFK86vx66y3rksOk6ixc2b,SpATywNh6bZuzm8s1ceuBUnMUAeoAHHw,21,30,19,0,11,0,9,0,69,9.857142857142858,2,0.0,2,19,0,11,28,0,0,9,0,32,37,1
1116,9064,J782awhmjhWAohIOvWifbZTNvhSxGcmf,RXDvfPUBYFlVdlueBFbLW0mhhAyGEqpt,32,45,29,0,19,0,7,0,100,14.285714285714286,4,0.0,2,29,0,19,43,0,0,7,0,50,50,1
1117,9065,6Dq4LTGgUzJAJPwYkedRMadSEQwnkyG3,SpATywNh6bZuzm8s1ceuBUnMUAeoAHHw,7,27,15,0,1,0,11,0,54,7.714285714285714,2,0.0,0,15,0,1,27,0,0,11,0,16,38,1
1118,9072,xBNDEDD7fMER9fNR4W15k6QiKRrdBf4x,G8EPVSXsOYB5YQWZGiz1aVq5Pgr2GrQu,51,79,8,116,3,1,15,1,223,31.857142857142858,4,0.0,37,8,81,3,42,1,35,15,1,129,94,1
1119,9079,Cb1aR5BeXGrDewkPGGzseNCh6yBNhS9Z,G8EPVSXsOYB5YQWZGiz1aVq5Pgr2GrQu,18,22,8,20,5,0,6,0,61,8.714285714285714,3,0.0,7,8,13,5,15,0,7,6,0,33,28,1
1120,9085,q78BjeBORwDIcVH7lRGRd3WfImLmduN4,G8EPVSXsOYB5YQWZGiz1aVq5Pgr2GrQu,18,9,8,0,8,0,3,0,28,4.0,1,0.0,0,8,0,8,9,0,0,3,0,16,12,1
1121,9100,0K6JPqiivQzicxY4EV4nqMLCL3a08A97,bWdj2GDclj5ofokWjzoa5jAwMkxCykd6,17,21,8,10,10,0,25,0,74,10.571428571428571,6,0.0,6,8,10,10,15,0,0,25,0,34,40,0
1122,9112,XDPvGyFLLEYwbNEQik2MM4yiADs5rrYJ,bWdj2GDclj5ofokWjzoa5jAwMkxCykd6,9,7,4,0,3,0,2,0,16,2.2857142857142856,1,0.0,1,4,0,3,6,0,0,2,0,8,8,0
1123,9118,ZPIRNChg4KaoHQC5y65LKyeBd78COsQH,A3fsA9Zfv1X2fVEQhTw51lKENdNrEqT3,8,4,3,0,3,0,1,0,11,1.5714285714285714,1,0.0,0,3,0,3,4,0,0,1,0,6,5,1
1124,9124,0mJoMFAp6vm88Kg6ltLw74tsdf8pNH48,SpATywNh6bZuzm8s1ceuBUnMUAeoAHHw,10,9,3,0,3,0,3,0,18,2.5714285714285716,2,0.0,0,3,0,3,9,0,0,3,0,6,12,0
1125,9125,8NRsKZ3hMeinWXhN3qtntd7OTP25jyWY,bWdj2GDclj5ofokWjzoa5jAwMkxCykd6,13,13,6,14,5,0,3,0,41,5.857142857142857,2,0.0,3,6,14,5,10,0,0,3,0,28,13,1
1126,9128,bZSiNUbAIuydDBd77IMAJ15Hy6k2A1kT,bWdj2GDclj5ofokWjzoa5jAwMkxCykd6,11,17,10,30,3,6,7,1,74,10.571428571428571,2,0.0,1,10,28,3,16,6,2,7,1,42,32,1
1127,9129,x8EozFE9amTkjsgRipu221C7Pejcw9dl,RXDvfPUBYFlVdlueBFbLW0mhhAyGEqpt,41,92,28,18,16,42,51,3,250,35.714285714285715,9,0.0,0,28,17,16,92,42,1,51,3,61,189,1
1128,9132,AkJ8njZZaMlqYX3miC2oUBlMGg9ZSm2E,SpATywNh6bZuzm8s1ceuBUnMUAeoAHHw,23,34,0,31,0,9,15,1,90,12.857142857142858,3,0.0,12,0,29,0,22,9,2,15,1,41,49,1
1129,9137,rD3x5Ovuza1MLiqkvaHksaL42hepSLSa,A3fsA9Zfv1X2fVEQhTw51lKENdNrEqT3,24,39,19,0,11,5,10,0,84,12.0,4,0.0,3,19,0,11,36,5,0,10,0,33,51,1
1130,9145,RFW46IpEEo40HQZmVwQOMd3VcTSwzvKz,SpATywNh6bZuzm8s1ceuBUnMUAeoAHHw,48,107,39,30,10,7,22,0,215,30.714285714285715,11,0.0,31,39,29,10,76,7,1,22,0,109,106,0
1131,9147,FTc6jHk7ojdVaEQtsGdTEiSOrQxUe2mX,SpATywNh6bZuzm8s1ceuBUnMUAeoAHHw,7,6,1,0,1,0,1,0,9,1.2857142857142858,1,0.0,0,1,0,1,6,0,0,1,0,2,7,0
1132,9148,9DysAmMC3i4TW1eruWnww7wyDSDGRjXp,bWdj2GDclj5ofokWjzoa5jAwMkxCykd6,9,17,11,0,6,0,7,0,41,5.857142857142857,2,0.0,0,11,0,6,17,0,0,7,0,17,24,1
1133,9158,DbhhTMdVqWIBI3VwdAesh5LxfMFeyK5c,SpATywNh6bZuzm8s1ceuBUnMUAeoAHHw,7,3,2,0,2,0,2,0,9,1.2857142857142858,1,0.0,0,2,0,2,3,0,0,2,0,4,5,1
1134,9163,Hv1gke8Z6oPKIjxv7227ovS4ZRFTrLpp,bWdj2GDclj5ofokWjzoa5jAwMkxCykd6,4,2,1,0,1,0,1,0,5,0.7142857142857143,1,0.0,0,1,0,1,2,0,0,1,0,2,3,1
1135,9165,fnvAURpBgndjkYxbDVVMCKsNQuRUMiGS,SpATywNh6bZuzm8s1ceuBUnMUAeoAHHw,30,70,36,0,17,6,25,2,156,22.285714285714285,10,0.0,3,36,0,17,67,6,0,25,2,56,100,0
1136,9171,9cDsgjqaFerwqRiPgBxIO3HH5FKzzgdj,RXDvfPUBYFlVdlueBFbLW0mhhAyGEqpt,28,22,19,0,16,2,2,0,61,8.714285714285714,1,0.0,2,19,0,16,20,2,0,2,0,37,24,1
1137,9182,aqcsR8SNbfax2wKqSkYdDU8hi71eVqW9,A3fsA9Zfv1X2fVEQhTw51lKENdNrEqT3,7,10,2,0,1,0,4,0,17,2.4285714285714284,1,0.0,1,2,0,1,9,0,0,4,0,4,13,0
1138,9202,TnBvipzpsoJKVSP9HO76PUA5bg5zcHA5,SpATywNh6bZuzm8s1ceuBUnMUAeoAHHw,1,0,0,0,0,0,1,0,1,0.14285714285714285,1,0.0,0,0,0,0,0,0,0,1,0,0,1,1
1139,9214,cw1zp7V2E9LtJgGgHmRoYt6oelCovAzM,bWdj2GDclj5ofokWjzoa5jAwMkxCykd6,25,42,23,118,6,36,22,2,249,35.57142857142857,6,0.0,8,23,112,6,34,36,6,22,2,149,100,1
1140,9217,ZWsQt8qxIk0ozpqBcSOvnGxYevyvwXWW,SpATywNh6bZuzm8s1ceuBUnMUAeoAHHw,4,4,0,0,0,0,1,0,5,0.7142857142857143,1,0.0,0,0,0,0,4,0,0,1,0,0,5,1
1141,9218,llxTRiluZGftr8xJaXSwJljp3xP1zOiw,SpATywNh6bZuzm8s1ceuBUnMUAeoAHHw,6,3,2,0,2,0,1,0,8,1.1428571428571428,1,0.0,0,2,0,2,3,0,0,1,0,4,4,1
1142,9221,DHqQemLc6gAFLZmIcghnnHYSJ9DiwwJJ,A3fsA9Zfv1X2fVEQhTw51lKENdNrEqT3,19,10,3,30,2,1,8,1,55,7.857142857142857,3,0.0,0,3,27,2,10,1,3,8,1,32,23,1
1143,9223,DHqQemLc6gAFLZmIcghnnHYSJ9DiwwJJ,G8EPVSXsOYB5YQWZGiz1aVq5Pgr2GrQu,4,2,0,0,0,0,2,0,4,0.5714285714285714,1,0.0,0,0,0,0,2,0,0,2,0,0,4,1
1144,9225,bBiJ7ASlGThY8sK9BrJtoHZicOYFZngs,SpATywNh6bZuzm8s1ceuBUnMUAeoAHHw,9,17,0,4,0,0,4,0,25,3.5714285714285716,4,0.0,0,0,3,0,17,0,1,4,0,3,22,1
1145,9249,0px3bu53b0JtWfgR2HZboUVCWvKPFWbh,SpATywNh6bZuzm8s1ceuBUnMUAeoAHHw,16,32,0,27,0,2,10,1,72,10.285714285714286,5,0.0,16,0,21,0,16,2,6,10,1,37,35,1
1146,9252,9YWFnwknNOzyIUIKR7l51R7vKAyWFRtw,SpATywNh6bZuzm8s1ceuBUnMUAeoAHHw,16,13,9,0,8,1,3,0,34,4.857142857142857,2,0.0,1,9,0,8,12,1,0,3,0,18,16,1
1147,9256,tfcOvcMIVTpughZ66Us0P1WhX9cxijTo,SpATywNh6bZuzm8s1ceuBUnMUAeoAHHw,31,53,31,16,15,8,20,1,144,20.571428571428573,6,0.0,15,31,15,15,38,8,1,20,1,76,68,1
1148,9261,QC8X6HHWWr8l8BhOv6dcxn8F38OGn4O4,bWdj2GDclj5ofokWjzoa5jAwMkxCykd6,19,28,12,48,11,8,15,0,122,17.428571428571427,3,0.0,11,12,43,11,17,8,5,15,0,77,45,1
1149,9263,cgHFcM0rIMOzMpGf6lXZssDwXCb8l7YM,SpATywNh6bZuzm8s1ceuBUnMUAeoAHHw,61,82,48,39,26,187,44,3,429,61.285714285714285,16,0.0,14,48,37,26,68,187,2,44,3,125,304,0
1150,9266,9Gijx5H37DPofktlpBMoMZTbguUDFGMv,SpATywNh6bZuzm8s1ceuBUnMUAeoAHHw,47,76,43,25,21,16,20,1,202,28.857142857142858,12,0.0,12,43,23,21,64,16,2,20,1,99,103,0
1151,9280,S33pdehUgQXmm7BALY2AI5GkXomITIjp,SpATywNh6bZuzm8s1ceuBUnMUAeoAHHw,10,10,6,0,2,5,13,8,44,6.285714285714286,1,0.0,0,6,0,2,10,5,0,13,8,8,36,1
1152,9284,nmePotX0raTb5EFn0d2G6sYKXgcl2u96,SpATywNh6bZuzm8s1ceuBUnMUAeoAHHw,30,33,15,24,7,26,16,1,122,17.428571428571427,4,0.0,12,15,21,7,21,26,3,16,1,55,67,1
1153,9300,V2BC6P9m08ZwtWifNk1sABHW864l2OQe,SpATywNh6bZuzm8s1ceuBUnMUAeoAHHw,59,58,29,53,18,0,13,1,172,24.571428571428573,7,0.0,19,29,47,18,39,0,6,13,1,113,59,0
1154,9319,7KQcIrOp3KoypOTvziMED7rHtDH1CXtE,bWdj2GDclj5ofokWjzoa5jAwMkxCykd6,14,20,2,34,5,0,4,0,65,9.285714285714286,2,0.0,11,2,29,5,9,0,5,4,0,47,18,1
1155,9326,cw1zp7V2E9LtJgGgHmRoYt6oelCovAzM,A3fsA9Zfv1X2fVEQhTw51lKENdNrEqT3,43,64,38,66,12,13,42,2,237,33.857142857142854,8,0.0,10,38,52,12,54,13,14,42,2,112,125,0
1156,9331,U5AVDljh153RMBqEeJz3uJoBcMeMiYU5,RXDvfPUBYFlVdlueBFbLW0mhhAyGEqpt,65,62,38,82,26,2,11,0,221,31.571428571428573,7,0.0,13,38,78,26,49,2,4,11,0,155,66,0
1157,9337,6W9L2N1NV5yWuM4zWKiNN7jncCdBZXs0,SpATywNh6bZuzm8s1ceuBUnMUAeoAHHw,14,18,1,19,1,0,3,0,42,6.0,2,0.0,3,1,16,1,15,0,3,3,0,21,21,1
1158,9348,yh14zaFitCUTgvBPqRXiaZ6cUijtktL4,SpATywNh6bZuzm8s1ceuBUnMUAeoAHHw,10,8,4,0,4,0,3,0,19,2.7142857142857144,2,0.0,0,4,0,4,8,0,0,3,0,8,11,1
1159,9359,aR6DmUHNNFHdBeCRliKxXxLUoIhOd6AH,SpATywNh6bZuzm8s1ceuBUnMUAeoAHHw,54,106,42,22,19,49,30,1,269,38.42857142857143,14,0.0,12,42,20,19,94,49,2,30,1,93,176,1
1160,9361,8Eqf4bSicFmRziRU1kFgF89C5yGB8WDX,A3fsA9Zfv1X2fVEQhTw51lKENdNrEqT3,66,101,15,120,6,7,83,7,339,48.42857142857143,16,0.0,8,15,112,6,93,7,8,83,7,141,198,0
1161,9368,gGSMkNgPdXpBQgdZzyjzifomyCxFSNyt,RXDvfPUBYFlVdlueBFbLW0mhhAyGEqpt,50,99,43,89,23,9,22,1,286,40.857142857142854,7,0.0,13,43,80,23,86,9,9,22,1,159,127,1
1162,9373,y94TMklf7UHNxvOoBChAR2OERrGRdiJq,G8EPVSXsOYB5YQWZGiz1aVq5Pgr2GrQu,27,30,8,26,7,0,11,0,82,11.714285714285714,3,0.0,16,8,17,7,14,0,9,11,0,48,34,0
1163,9385,8fvsCrC8dcOje6DxrGntnTxmufYXJCrq,RXDvfPUBYFlVdlueBFbLW0mhhAyGEqpt,6,4,3,0,1,0,4,0,12,1.7142857142857142,2,0.0,0,3,0,1,4,0,0,4,0,4,8,1
1164,9388,67TNJl3Pfj4UvDY0EpzZyKupN8wfhq1l,SpATywNh6bZuzm8s1ceuBUnMUAeoAHHw,18,26,15,14,5,1,22,7,90,12.857142857142858,3,0.0,5,15,13,5,21,1,1,22,7,38,52,1
1165,9407,iY3PnTi5AY3h01aMZ0ccsJOuRXfKtImU,SpATywNh6bZuzm8s1ceuBUnMUAeoAHHw,41,69,32,24,15,4,12,0,156,22.285714285714285,5,0.0,26,32,24,15,43,4,0,12,0,97,59,0
1166,9412,ZoicU1K1NYxoyDJQjMEMlarFqaZkNBQL,SpATywNh6bZuzm8s1ceuBUnMUAeoAHHw,30,51,5,29,3,0,26,0,114,16.285714285714285,9,0.0,5,5,28,3,46,0,1,26,0,41,73,0
1167,9413,7LCuPqBIUzStV6rbjpGGsRhhNGaAe94J,G8EPVSXsOYB5YQWZGiz1aVq5Pgr2GrQu,5,2,1,0,1,0,2,0,6,0.8571428571428571,1,0.0,0,1,0,1,2,0,0,2,0,2,4,1
1168,9421,mVo6pZlclrtmbfR2GbQ4wq8gZuK7O36S,SpATywNh6bZuzm8s1ceuBUnMUAeoAHHw,55,92,55,44,26,17,8,2,244,34.857142857142854,10,0.0,18,55,35,26,74,17,9,8,2,134,110,0
1169,9443,mt466qDcj0vZCLdMYFtb42Vnaf84dHao,SpATywNh6bZuzm8s1ceuBUnMUAeoAHHw,36,88,53,24,15,3,54,2,239,34.142857142857146,14,0.0,12,53,18,15,76,3,6,54,2,98,141,1
1170,9451,3tkFTpynSNaQLF6kINch4bQXEK1IrheG,SpATywNh6bZuzm8s1ceuBUnMUAeoAHHw,56,90,51,37,20,2,23,0,223,31.857142857142858,12,0.0,17,51,32,20,73,2,5,23,0,120,103,0
1171,9461,L22HEShRU3FqNfdzTYdzEWxS4vfndGJu,SpATywNh6bZuzm8s1ceuBUnMUAeoAHHw,28,48,5,59,0,26,33,4,175,25.0,13,0.0,19,5,53,0,29,26,6,33,4,77,98,0
1172,9496,lzjn3SIRVbYq5ZVBPCRXRd4xV1z1jylE,SpATywNh6bZuzm8s1ceuBUnMUAeoAHHw,44,80,48,60,22,38,29,0,277,39.57142857142857,9,0.0,17,48,49,22,63,38,11,29,0,136,141,0
1173,9498,tNcQJSYfIwP0RRLCMvpsyr5j06z8N8iO,G8EPVSXsOYB5YQWZGiz1aVq5Pgr2GrQu,116,258,43,191,28,68,57,12,657,93.85714285714286,14,0.0,65,43,144,28,193,68,47,57,12,280,377,0
1174,9513,onGGlsMh4Ah4OxYC5tqGXHHp3fKlLcL2,RXDvfPUBYFlVdlueBFbLW0mhhAyGEqpt,22,21,15,0,9,0,5,0,50,7.142857142857143,4,0.0,0,15,0,9,21,0,0,5,0,24,26,1
1175,9515,FK87Mh9LEgwj1VU4pstPcNLLVrRCTWuM,SpATywNh6bZuzm8s1ceuBUnMUAeoAHHw,54,111,62,41,29,35,22,3,303,43.285714285714285,7,0.0,35,62,41,29,76,35,0,22,3,167,136,0
1176,9524,qLAmicSwiz2res8NbViiztvss1lFMGpj,SpATywNh6bZuzm8s1ceuBUnMUAeoAHHw,31,51,7,24,2,1,15,1,101,14.428571428571429,8,0.0,10,7,22,2,41,1,2,15,1,41,60,1
1177,9527,zdZzILDgH724BR2ZZqHskjwJPcqfxq36,SpATywNh6bZuzm8s1ceuBUnMUAeoAHHw,1,0,0,0,0,0,1,0,1,0.14285714285714285,1,0.0,0,0,0,0,0,0,0,1,0,0,1,1
1178,9531,KwyWbYzWCyNQryHYqWYU5PuARebCENlh,SpATywNh6bZuzm8s1ceuBUnMUAeoAHHw,25,30,17,3,10,0,12,0,72,10.285714285714286,6,0.0,5,17,3,10,25,0,0,12,0,35,37,0
1179,9554,qLhvnFj4NLk8zjpoDXsgy2yaKup2la0b,SpATywNh6bZuzm8s1ceuBUnMUAeoAHHw,8,9,3,0,2,0,1,0,15,2.142857142857143,1,0.0,0,3,0,2,9,0,0,1,0,5,10,1
1180,9561,CS0wlcwiXBGjNBCCxbQaVvPkChe2nnOH,SpATywNh6bZuzm8s1ceuBUnMUAeoAHHw,4,2,1,0,1,0,1,0,5,0.7142857142857143,1,0.0,0,1,0,1,2,0,0,1,0,2,3,1
1181,9562,ELMHLkq0bytqwO03zO0z2h1fRq8v5uwM,RXDvfPUBYFlVdlueBFbLW0mhhAyGEqpt,16,40,3,25,3,0,2,0,73,10.428571428571429,4,0.0,4,3,20,3,36,0,5,2,0,30,43,0
1182,9570,kRNs7iQ9Dcre5KLj8rtojE3fVWuqCtop,SpATywNh6bZuzm8s1ceuBUnMUAeoAHHw,33,42,4,36,0,2,14,2,100,14.285714285714286,4,0.0,13,4,35,0,29,2,1,14,2,52,48,0
1183,9576,8L1ZpuGtJGJkgFF34DS0HYPQNaVRqmzv,G8EPVSXsOYB5YQWZGiz1aVq5Pgr2GrQu,7,1,1,0,1,1,5,1,10,1.4285714285714286,1,0.0,0,1,0,1,1,1,0,5,1,2,8,1
1184,9583,InTDVHpDSVoZu5vOSvueBLdJOgZb9Qu8,bWdj2GDclj5ofokWjzoa5jAwMkxCykd6,12,18,9,14,4,4,6,0,55,7.857142857142857,2,0.0,4,9,12,4,14,4,2,6,0,29,26,0
1185,9589,oJ9j9ejTgKixczg3tSE8Sg8DPI7YQpJq,A3fsA9Zfv1X2fVEQhTw51lKENdNrEqT3,16,21,15,0,7,1,8,1,53,7.571428571428571,3,0.0,1,15,0,7,20,1,0,8,1,23,30,0
1186,9596,8fvsCrC8dcOje6DxrGntnTxmufYXJCrq,G8EPVSXsOYB5YQWZGiz1aVq5Pgr2GrQu,2,0,0,0,0,0,3,0,3,0.42857142857142855,2,0.0,0,0,0,0,0,0,0,3,0,0,3,1
1187,9597,op6fYsDSJ7UTrHBvFtSBIo32ykj3vZlc,SpATywNh6bZuzm8s1ceuBUnMUAeoAHHw,34,83,12,42,3,35,37,1,213,30.428571428571427,11,0.0,23,12,36,3,60,35,6,37,1,74,139,0
1188,9601,op6fYsDSJ7UTrHBvFtSBIo32ykj3vZlc,A3fsA9Zfv1X2fVEQhTw51lKENdNrEqT3,4,2,2,0,0,0,4,0,8,1.1428571428571428,2,0.0,0,2,0,0,2,0,0,4,0,2,6,1
1189,9602,op6fYsDSJ7UTrHBvFtSBIo32ykj3vZlc,bWdj2GDclj5ofokWjzoa5jAwMkxCykd6,4,2,1,0,0,0,11,0,14,2.0,6,0.0,1,1,0,0,1,0,0,11,0,2,12,1
1190,9626,foCA7ZrrJkil1q7yKxvukoHCZEz5fz8N,bWdj2GDclj5ofokWjzoa5jAwMkxCykd6,47,132,4,118,3,0,35,0,292,41.714285714285715,9,0.0,21,4,103,3,111,0,15,35,0,131,161,0
1191,9629,RMdVVE71rvbt2Qm5k09H4IClAre95rfd,SpATywNh6bZuzm8s1ceuBUnMUAeoAHHw,7,2,1,0,1,1,5,1,11,1.5714285714285714,1,0.0,0,1,0,1,2,1,0,5,1,2,9,1
1192,9631,ZkR2H9b56Jhek553JSEuRtj1fnuwaa03,SpATywNh6bZuzm8s1ceuBUnMUAeoAHHw,1,0,0,0,0,0,1,0,1,0.14285714285714285,1,0.0,0,0,0,0,0,0,0,1,0,0,1,1
1193,9646,op6fYsDSJ7UTrHBvFtSBIo32ykj3vZlc,G8EPVSXsOYB5YQWZGiz1aVq5Pgr2GrQu,1,0,0,0,0,0,1,0,1,0.14285714285714285,1,0.0,0,0,0,0,0,0,0,1,0,0,1,1
1194,9647,bPCZpicN2hhnN8uELNOuVf328EONwoA2,SpATywNh6bZuzm8s1ceuBUnMUAeoAHHw,15,46,17,4,3,2,21,2,95,13.571428571428571,5,0.0,23,17,4,3,23,2,0,21,2,47,48,1
1195,9649,EH4LxHwYpFQLq5kesgWPY21JUpYpymba,SpATywNh6bZuzm8s1ceuBUnMUAeoAHHw,1,0,0,0,0,0,1,0,1,0.14285714285714285,1,0.0,0,0,0,0,0,0,0,1,0,0,1,1
1196,9654,EH4LxHwYpFQLq5kesgWPY21JUpYpymba,A3fsA9Zfv1X2fVEQhTw51lKENdNrEqT3,1,0,0,0,0,0,1,0,1,0.14285714285714285,1,0.0,0,0,0,0,0,0,0,1,0,0,1,1
1197,9662,tRu7kc3B7i0xOP4FswhcDsdZx5KznD0T,SpATywNh6bZuzm8s1ceuBUnMUAeoAHHw,16,50,12,9,7,0,7,0,85,12.142857142857142,5,0.0,7,12,9,7,43,0,0,7,0,35,50,0
1198,9673,Bi4hHmeTLwTbUCScu9tC6ZZN7frLUhVP,bWdj2GDclj5ofokWjzoa5jAwMkxCykd6,51,55,33,94,18,8,25,1,234,33.42857142857143,5,0.0,12,33,91,18,43,8,3,25,1,154,80,0
1199,9684,LdhLlSD36AR268yKf0v6JE8vG5XYPHSF,RXDvfPUBYFlVdlueBFbLW0mhhAyGEqpt,94,201,29,211,38,11,24,2,516,73.71428571428571,9,0.0,84,29,195,38,117,11,16,24,2,346,170,0
1200,9707,5GS5OD1cmKWecEPymf3UVauvWYXb9WHE,SpATywNh6bZuzm8s1ceuBUnMUAeoAHHw,15,27,15,5,8,0,7,0,62,8.857142857142858,3,0.0,4,15,4,8,23,0,1,7,0,31,31,0
1201,9713,KFNYz6Dhe7c7sjFmDdHR2V6Cj3vv7anD,SpATywNh6bZuzm8s1ceuBUnMUAeoAHHw,27,20,10,28,5,0,14,1,78,11.142857142857142,2,0.0,8,10,24,5,12,0,4,14,1,47,31,1
1202,9718,0dBn4alo7QBTd62VD5XO0yNMbQ5QN2OQ,A3fsA9Zfv1X2fVEQhTw51lKENdNrEqT3,41,71,21,64,8,0,6,0,170,24.285714285714285,4,0.0,2,21,61,8,69,0,3,6,0,92,78,0
1203,9719,STRzNG5Wp366HphlQVfWFRMC5QrerXCb,SpATywNh6bZuzm8s1ceuBUnMUAeoAHHw,48,88,34,10,22,0,11,0,165,23.571428571428573,8,0.0,3,34,10,22,85,0,0,11,0,69,96,0
1204,9735,gL9bGH4cIhlV7ZeZxNKPKl7YRjV9LvBk,bWdj2GDclj5ofokWjzoa5jAwMkxCykd6,8,7,2,94,1,0,5,0,109,15.571428571428571,2,0.0,1,2,92,1,6,0,2,5,0,96,13,1
1205,9745,ITkxDxE80MnM3R1P6Tny4qeXU1QIqBHa,bWdj2GDclj5ofokWjzoa5jAwMkxCykd6,25,38,22,38,11,78,22,2,211,30.142857142857142,6,0.0,8,22,34,11,30,78,4,22,2,75,136,1
1206,9754,UhHoLs8knx0jlEPi8SMFvlBmI0lPgR6y,SpATywNh6bZuzm8s1ceuBUnMUAeoAHHw,27,79,4,12,4,19,35,3,156,22.285714285714285,12,0.0,14,4,11,4,65,19,1,35,3,33,123,1
1207,9770,Z719Tc3zuVfTrBRe6VKkZp0coC11gNCc,SpATywNh6bZuzm8s1ceuBUnMUAeoAHHw,9,22,13,0,10,0,1,0,46,6.571428571428571,6,0.0,0,13,0,10,22,0,0,1,0,23,23,1
1208,9785,gm1mCfFqKN0eTkg2YXDowzQf6xnuANVZ,SpATywNh6bZuzm8s1ceuBUnMUAeoAHHw,28,66,5,22,3,2,19,0,117,16.714285714285715,4,0.0,19,5,22,3,47,2,0,19,0,49,68,1
1209,9786,LcO86mxxL8cZOPJBDybTSOoI4LZ5qE2M,SpATywNh6bZuzm8s1ceuBUnMUAeoAHHw,32,49,33,0,22,0,8,0,112,16.0,8,0.0,0,33,0,22,49,0,0,8,0,55,57,0
1210,9787,EYniy2nQGNpFME0mRi8PdZNA2QjnXIxY,RXDvfPUBYFlVdlueBFbLW0mhhAyGEqpt,89,156,2,233,12,13,28,4,448,64.0,8,0.0,48,2,217,12,108,13,16,28,4,279,169,0
1211,9792,M7EQ6UxOsXQjbu4WIJCWam7cgbYToC2D,bWdj2GDclj5ofokWjzoa5jAwMkxCykd6,1,0,0,0,0,0,1,0,1,0.14285714285714285,1,0.0,0,0,0,0,0,0,0,1,0,0,1,1
1212,9799,oIeIfwhQt9r1G6uZ62W7p7DLvDQ1KzcN,SpATywNh6bZuzm8s1ceuBUnMUAeoAHHw,4,0,0,0,0,0,4,1,5,0.7142857142857143,1,0.0,0,0,0,0,0,0,0,4,1,0,5,0
1213,9806,q0a8XSQyj8ok2HbWv28MubA9x20SFg4i,SpATywNh6bZuzm8s1ceuBUnMUAeoAHHw,20,28,5,12,5,0,24,0,74,10.571428571428571,6,0.0,2,5,10,5,26,0,2,24,0,22,52,0
1214,9820,aHRdc7lsBBp8F9aMkgntONfsLpIf0i6y,SpATywNh6bZuzm8s1ceuBUnMUAeoAHHw,56,66,31,74,19,1,13,0,204,29.142857142857142,4,0.0,28,31,70,19,38,1,4,13,0,148,56,0
1215,9833,31jhVyZsYwM3i4SgxR1MFYrhxZjgzlJ8,SpATywNh6bZuzm8s1ceuBUnMUAeoAHHw,57,59,38,75,25,2,10,0,209,29.857142857142858,7,0.0,11,38,63,25,48,2,12,10,0,137,72,0
1216,9834,SVcpJb6gXZcQDuOEWDQYFqv2P86R1Xaj,A3fsA9Zfv1X2fVEQhTw51lKENdNrEqT3,16,7,6,0,4,4,11,1,33,4.714285714285714,2,0.0,0,6,0,4,7,4,0,11,1,10,23,1
1217,9835,a9OOTcAZgZGDa68djsRaJXsHoRuNVOvz,SpATywNh6bZuzm8s1ceuBUnMUAeoAHHw,59,178,101,57,35,97,58,3,529,75.57142857142857,15,0.0,30,101,46,35,148,97,11,58,3,212,317,1
1218,9836,nknXXbQsC6Q6nMDyRKc0MDJZg6KtAXBE,SpATywNh6bZuzm8s1ceuBUnMUAeoAHHw,33,94,44,18,11,9,16,0,192,27.428571428571427,11,0.0,32,44,16,11,62,9,2,16,0,103,89,0
1219,9842,MVF65xcT9c1o85EvDPizEzpYwxjeii1v,SpATywNh6bZuzm8s1ceuBUnMUAeoAHHw,37,94,9,46,1,7,33,1,191,27.285714285714285,10,0.0,14,9,40,1,80,7,6,33,1,64,127,1
1220,9857,qDhyxHmDfIFLWQlPUBxWy3YNuv335dWU,SpATywNh6bZuzm8s1ceuBUnMUAeoAHHw,27,75,30,18,12,15,19,0,169,24.142857142857142,12,0.0,10,30,18,12,65,15,0,19,0,70,99,0
1221,9866,0KmXUOal7sGDR9cJbaeaj8aaBpdVW5sk,bWdj2GDclj5ofokWjzoa5jAwMkxCykd6,6,6,2,0,1,0,6,0,15,2.142857142857143,2,0.0,0,2,0,1,6,0,0,6,0,3,12,1
1222,9867,Cv6IwnmHzYzI7Znom4eT6Rs7brgvVn5U,SpATywNh6bZuzm8s1ceuBUnMUAeoAHHw,7,10,2,0,1,0,3,0,16,2.2857142857142856,2,0.0,0,2,0,1,10,0,0,3,0,3,13,1
1223,9874,mZIaM3Lmux7GERtSm258BKPOSUYFlwyy,SpATywNh6bZuzm8s1ceuBUnMUAeoAHHw,55,99,30,46,11,12,24,1,223,31.857142857142858,10,0.0,26,30,43,11,73,12,3,24,1,110,113,0
1224,9878,iw5QtMAk2wyMi9Kh4hTv1WAFOj2rnxVj,SpATywNh6bZuzm8s1ceuBUnMUAeoAHHw,28,33,4,32,2,0,7,2,80,11.428571428571429,5,0.0,5,4,31,2,28,0,1,7,2,42,38,0
1225,9894,MarhO8rhsTXcbFpvat4mcEiSQvbAftxM,SpATywNh6bZuzm8s1ceuBUnMUAeoAHHw,5,2,1,0,1,0,3,0,7,1.0,3,0.0,0,1,0,1,2,0,0,3,0,2,5,1
1226,9896,47Lhswr4ZfAxhCMxQ5kAgIIaZKdQ7ZYE,SpATywNh6bZuzm8s1ceuBUnMUAeoAHHw,29,78,21,45,6,99,30,1,280,40.0,8,0.0,21,21,39,6,57,99,6,30,1,87,193,0
1227,9903,wHRp5VFhSRE1ez0DDg63jhbDbNE6ujgu,bWdj2GDclj5ofokWjzoa5jAwMkxCykd6,1,0,0,0,0,0,2,0,2,0.2857142857142857,2,0.0,0,0,0,0,0,0,0,2,0,0,2,1
1228,9910,FUkw8gvbqykqbH4tdSuG6VwP03f4pQvB,SpATywNh6bZuzm8s1ceuBUnMUAeoAHHw,47,65,37,20,18,1,22,0,163,23.285714285714285,11,0.0,15,37,20,18,50,1,0,22,0,90,73,0
1229,9911,Jd5OP6GIsguRdsq9k3eSYNENmzhPbdGe,bWdj2GDclj5ofokWjzoa5jAwMkxCykd6,9,18,8,0,2,0,10,0,38,5.428571428571429,6,0.0,2,8,0,2,16,0,0,10,0,12,26,1
1230,9916,CJe4pjtrcC0FOMy3krEkccqFJZO0Cqq4,RXDvfPUBYFlVdlueBFbLW0mhhAyGEqpt,34,54,15,68,3,69,40,21,270,38.57142857142857,5,0.0,14,15,59,3,40,69,9,40,21,91,179,1
1231,9919,YwojqO58bCgaotjJoOTtpKH2oiEFOZyB,SpATywNh6bZuzm8s1ceuBUnMUAeoAHHw,19,18,10,21,7,0,6,0,62,8.857142857142858,2,0.0,6,10,18,7,12,0,3,6,0,41,21,1
1232,9921,Mv7oSGs75OaCjYLhHCNmqqrqaAjjO5gs,RXDvfPUBYFlVdlueBFbLW0mhhAyGEqpt,81,203,22,229,14,13,45,10,536,76.57142857142857,15,0.0,46,22,205,14,157,13,24,45,10,287,249,1
1233,9926,TgheOgj9khTgshxaHKtqDHWb3smGHeUA,SpATywNh6bZuzm8s1ceuBUnMUAeoAHHw,22,21,2,18,0,1,9,1,52,7.428571428571429,2,0.0,6,2,16,0,15,1,2,9,1,24,28,1
1234,9937,lZ58Ty5L7QhiK80QjmlI7dd3eLrrNLr0,A3fsA9Zfv1X2fVEQhTw51lKENdNrEqT3,7,3,2,0,2,0,3,0,10,1.4285714285714286,1,0.0,0,2,0,2,3,0,0,3,0,4,6,1
1235,9944,IUn6MADAjAYkGlJisA1WiDvCeNlJd5Xd,G8EPVSXsOYB5YQWZGiz1aVq5Pgr2GrQu,85,96,34,137,20,0,8,0,295,42.142857142857146,13,0.0,47,34,91,20,49,0,46,8,0,192,103,1
1236,9945,5NIu7B9o5GAsLAdx3xyl9xnxkK6Z7Hn1,SpATywNh6bZuzm8s1ceuBUnMUAeoAHHw,1,0,0,0,0,0,1,0,1,0.14285714285714285,1,0.0,0,0,0,0,0,0,0,1,0,0,1,1
1237,9965,XL8OObjZsaGHAKex6gNHyGuTbyi42iwz,SpATywNh6bZuzm8s1ceuBUnMUAeoAHHw,24,68,0,23,1,39,23,6,160,22.857142857142858,5,0.0,26,0,21,1,42,39,2,23,6,48,112,1
1238,9973,pqAmXCZ0vs0c5YNrZSPIZNZIkmuJCMBN,RXDvfPUBYFlVdlueBFbLW0mhhAyGEqpt,88,70,50,183,27,43,19,5,397,56.714285714285715,8,0.0,12,50,169,27,58,43,14,19,5,258,139,0
1239,9986,hM3OejyZim6cDpiFQsjtqNuKMzh1dYaY,SpATywNh6bZuzm8s1ceuBUnMUAeoAHHw,12,11,0,24,0,0,4,0,39,5.571428571428571,2,0.0,2,0,20,0,9,0,4,4,0,22,17,1
1240,9989,GVRJN4wkoooaXJUVmwnX983A87KsrZPK,A3fsA9Zfv1X2fVEQhTw51lKENdNrEqT3,54,38,21,116,6,10,16,0,207,29.571428571428573,10,0.0,8,21,101,6,30,10,15,16,0,136,71,0
1241,9993,oThgY0TV97t9DlLv4WWVQ93RXTQBQvf5,SpATywNh6bZuzm8s1ceuBUnMUAeoAHHw,1,0,0,0,0,0,2,0,2,0.2857142857142857,1,0.0,0,0,0,0,0,0,0,2,0,0,2,1
1242,10001,vsk33lNJbFXN2L68Y5R9TSkfONwNMOQ8,SpATywNh6bZuzm8s1ceuBUnMUAeoAHHw,43,69,28,37,12,92,27,6,271,38.714285714285715,8,0.0,25,28,33,12,44,92,4,27,6,98,173,0
1243,10002,HjIrUt1Ax8b3fBkdKQupL2gDMbKYgLrZ,bWdj2GDclj5ofokWjzoa5jAwMkxCykd6,5,5,3,0,2,0,2,0,12,1.7142857142857142,2,0.0,0,3,0,2,5,0,0,2,0,5,7,1
1244,10011,gGIYUaDzHtuVAdLHD7FaG5z9ih7s8ZFV,SpATywNh6bZuzm8s1ceuBUnMUAeoAHHw,6,1,1,0,1,0,3,1,7,1.0,1,0.0,0,1,0,1,1,0,0,3,1,2,5,1
1245,10012,vqSgORDp5PsEpveQVJoPh4dnJvR6AQkK,RXDvfPUBYFlVdlueBFbLW0mhhAyGEqpt,89,156,90,136,40,80,39,1,542,77.42857142857143,16,0.0,33,90,127,40,123,80,9,39,1,290,252,0
1246,10013,NYNmhRIaW3AmhvVQt7ReXvH6yAc7z73U,RXDvfPUBYFlVdlueBFbLW0mhhAyGEqpt,7,24,12,0,0,131,35,5,207,29.571428571428573,7,0.0,0,12,0,0,24,131,0,35,5,12,195,1
1247,10021,oX8Y4icCGan10HVW1mtOWEP3pxrvK1WZ,RXDvfPUBYFlVdlueBFbLW0mhhAyGEqpt,39,53,33,47,8,156,15,5,317,45.285714285714285,5,0.0,8,33,46,8,45,156,1,15,5,95,222,0
1248,10029,sdNkCaSqYSgtx1tSTEHqB38WFlBnpR89,SpATywNh6bZuzm8s1ceuBUnMUAeoAHHw,16,17,11,5,6,0,5,0,44,6.285714285714286,1,0.0,4,11,4,6,13,0,1,5,0,25,19,1
1249,10036,M0OuzdgM82B7CvwoM2EBQihSEuKyfCoB,G8EPVSXsOYB5YQWZGiz1aVq5Pgr2GrQu,16,7,1,26,1,3,16,0,54,7.714285714285714,2,0.0,0,1,22,1,7,3,4,16,0,24,30,1
1250,10042,RCWIrGGQZDVLNIofIMbc1GdSrqA961jg,RXDvfPUBYFlVdlueBFbLW0mhhAyGEqpt,34,93,50,12,5,290,74,4,528,75.42857142857143,11,0.0,11,50,7,5,82,290,5,74,4,73,455,1
1251,10044,Wigd4PnyDnjfDcFOxsTBcEnXo7kl9GSg,bWdj2GDclj5ofokWjzoa5jAwMkxCykd6,21,91,26,74,8,22,28,0,249,35.57142857142857,5,0.0,15,26,69,8,76,22,5,28,0,118,131,1
1252,10048,X8GmwqDtWUFSMSOGWtivlDRmblWXusTi,SpATywNh6bZuzm8s1ceuBUnMUAeoAHHw,13,15,10,7,3,12,10,0,57,8.142857142857142,5,0.0,2,10,7,3,13,12,0,10,0,22,35,0
1253,10065,GV5J9MUmZdHez5d6vsAQtSAbOI4jKQlj,bWdj2GDclj5ofokWjzoa5jAwMkxCykd6,40,71,41,162,19,50,25,2,370,52.857142857142854,4,0.0,11,41,138,19,60,50,24,25,2,209,161,0
1254,10067,IkfMHDVbFGQIQxWjHsEqTwjNnrBCaA7O,SpATywNh6bZuzm8s1ceuBUnMUAeoAHHw,42,121,45,41,15,43,32,1,298,42.57142857142857,13,0.0,28,45,38,15,93,43,3,32,1,126,172,0
1255,10068,GV5J9MUmZdHez5d6vsAQtSAbOI4jKQlj,A3fsA9Zfv1X2fVEQhTw51lKENdNrEqT3,12,8,5,0,2,0,7,0,22,3.142857142857143,3,0.0,0,5,0,2,8,0,0,7,0,7,15,1
1256,10069,EdSyqy374rFTTRmoH6AfOLgRNsPjxdOm,A3fsA9Zfv1X2fVEQhTw51lKENdNrEqT3,19,14,10,0,6,0,6,0,36,5.142857142857143,2,0.0,0,10,0,6,14,0,0,6,0,16,20,1
1257,10070,FkxhG6zHFqigfK7M5JQhv4MT6lPE3kxN,RXDvfPUBYFlVdlueBFbLW0mhhAyGEqpt,107,196,123,301,68,7,32,19,746,106.57142857142857,15,0.0,42,123,263,68,154,7,38,32,19,496,250,0
1258,10071,ivII4h55QUeXOce5qbbvWPv1IAJ1FXtO,SpATywNh6bZuzm8s1ceuBUnMUAeoAHHw,21,30,1,23,0,0,10,0,64,9.142857142857142,2,0.0,11,1,22,0,19,0,1,10,0,34,30,1
1259,10073,3VQVtsFphnOA3h1KWYRcAEMgfViLsPnF,A3fsA9Zfv1X2fVEQhTw51lKENdNrEqT3,19,48,1,0,4,0,7,0,60,8.571428571428571,5,0.0,5,1,0,4,43,0,0,7,0,10,50,1
1260,10075,EdSyqy374rFTTRmoH6AfOLgRNsPjxdOm,bWdj2GDclj5ofokWjzoa5jAwMkxCykd6,8,11,7,0,4,0,4,0,26,3.7142857142857144,3,0.0,1,7,0,4,10,0,0,4,0,12,14,1
1261,10081,2LiXT3Fppj80YAOl6K8p0HtAK0LHy6KG,SpATywNh6bZuzm8s1ceuBUnMUAeoAHHw,59,73,50,46,29,6,27,0,231,33.0,10,0.0,11,50,45,29,62,6,1,27,0,135,96,0
1262,10095,JQVJEgOcL8lOPq9QqGxWJ7NUVC20wQ1o,SpATywNh6bZuzm8s1ceuBUnMUAeoAHHw,51,81,41,77,20,26,22,2,269,38.42857142857143,8,0.0,27,41,66,20,54,26,11,22,2,154,115,0
1263,10112,D1iAkJgGLDV90w339eOp4Bqd5z6wvBY6,bWdj2GDclj5ofokWjzoa5jAwMkxCykd6,1,0,0,0,0,0,1,0,1,0.14285714285714285,1,0.0,0,0,0,0,0,0,0,1,0,0,1,1
1264,10114,D1iAkJgGLDV90w339eOp4Bqd5z6wvBY6,A3fsA9Zfv1X2fVEQhTw51lKENdNrEqT3,1,0,0,0,0,0,1,0,1,0.14285714285714285,1,0.0,0,0,0,0,0,0,0,1,0,0,1,1
1265,10119,8IVnhzyRJrPiaCjSSJli9bG8p44dgy3T,SpATywNh6bZuzm8s1ceuBUnMUAeoAHHw,14,18,7,0,5,0,6,0,36,5.142857142857143,2,0.0,1,7,0,5,17,0,0,6,0,13,23,1
1266,10120,9Dm5yt1s5sm1v7MbrzCfMpw138AkercO,RXDvfPUBYFlVdlueBFbLW0mhhAyGEqpt,44,38,24,105,18,41,14,5,245,35.0,3,0.0,13,24,98,18,25,41,7,14,5,153,92,0
1267,10122,NiXPZUmEILmWUPwXexYxtHvaIL7QdjCQ,RXDvfPUBYFlVdlueBFbLW0mhhAyGEqpt,97,162,98,132,21,95,40,14,562,80.28571428571429,15,0.0,36,98,125,21,126,95,7,40,14,280,282,0
1268,10129,7rP408Gy6dVEeyQ5Me3hr5GFRnqOotmL,A3fsA9Zfv1X2fVEQhTw51lKENdNrEqT3,49,32,21,74,16,0,16,2,161,23.0,2,0.0,7,21,61,16,25,0,13,16,2,105,56,1
1269,10130,u3iTsADy3VjWLwiWIPabdGKGPi8ZLAbJ,SpATywNh6bZuzm8s1ceuBUnMUAeoAHHw,24,28,6,8,4,0,23,0,69,9.857142857142858,9,0.0,0,6,8,4,28,0,0,23,0,18,51,0
1270,10137,CUHsvexAAfaCEMKsM3644JTxXL5DgSss,bWdj2GDclj5ofokWjzoa5jAwMkxCykd6,4,2,1,0,1,0,1,0,5,0.7142857142857143,1,0.0,0,1,0,1,2,0,0,1,0,2,3,1
1271,10147,ng7eSUGwAsEpodxFM2MoBV45uXU9cRkh,SpATywNh6bZuzm8s1ceuBUnMUAeoAHHw,23,30,11,15,6,0,5,0,67,9.571428571428571,2,0.0,10,11,14,6,20,0,1,5,0,41,26,1
1272,10161,n4cJEUTWqAxTpul10x8ZDTmIRIbytL0a,SpATywNh6bZuzm8s1ceuBUnMUAeoAHHw,31,58,20,38,8,4,13,1,142,20.285714285714285,6,0.0,24,20,35,8,34,4,3,13,1,87,55,1
1273,10164,w7s7CbDlE2P2RGY2w8kEYH9keSavEsec,A3fsA9Zfv1X2fVEQhTw51lKENdNrEqT3,8,6,3,0,2,0,4,0,15,2.142857142857143,3,0.0,0,3,0,2,6,0,0,4,0,5,10,1
1274,10165,PzZ2nmySEoPT9qSsl3Z3wqf8hhgEC7RR,bWdj2GDclj5ofokWjzoa5jAwMkxCykd6,10,12,2,0,3,0,7,2,26,3.7142857142857144,3,0.0,4,2,0,3,8,0,0,7,2,9,17,1
1275,10171,IceoOG9Um0Dwn1hM2FcjjE3CJhGCpTrp,SpATywNh6bZuzm8s1ceuBUnMUAeoAHHw,1,0,0,0,0,0,1,0,1,0.14285714285714285,1,0.0,0,0,0,0,0,0,0,1,0,0,1,1
1276,10190,h81tMgwEiasc4dN2MBVSIam9UKAPfs93,A3fsA9Zfv1X2fVEQhTw51lKENdNrEqT3,68,106,43,164,31,0,9,0,353,50.42857142857143,6,0.0,10,43,137,31,96,0,27,9,0,221,132,0
1277,10193,T6JL6sNT8M40gVvb059fgHfBQIftQwIF,SpATywNh6bZuzm8s1ceuBUnMUAeoAHHw,24,89,38,26,0,3,35,0,191,27.285714285714285,11,0.0,34,38,23,0,55,3,3,35,0,95,96,1
1278,10200,Sb9hMB1NLdfMmS0ToFmgrY6MZEZ6TYgo,SpATywNh6bZuzm8s1ceuBUnMUAeoAHHw,53,93,53,40,32,3,14,1,236,33.714285714285715,9,0.0,23,53,34,32,70,3,6,14,1,142,94,0
1279,10202,BiB7jdHiaAHugRlYDLxmiYyQzifAAliU,SpATywNh6bZuzm8s1ceuBUnMUAeoAHHw,12,34,16,0,3,1,15,1,70,10.0,3,0.0,2,16,0,3,32,1,0,15,1,21,49,1
1280,10204,nJbKKV1iJX5hAlKTzoiNMNIkB5aNJcfW,G8EPVSXsOYB5YQWZGiz1aVq5Pgr2GrQu,45,58,37,40,16,2,22,3,178,25.428571428571427,7,0.0,0,37,37,16,58,2,3,22,3,90,88,0
1281,10207,Qf6P6bxCyzplkdXIQa3YsHmpzfUnMGYL,SpATywNh6bZuzm8s1ceuBUnMUAeoAHHw,51,117,49,24,29,3,32,4,258,36.857142857142854,9,0.0,19,49,21,29,98,3,3,32,4,118,140,0
1282,10210,qVH2miiWM8Lf3bY2iypzRXLuMojA4gKB,SpATywNh6bZuzm8s1ceuBUnMUAeoAHHw,26,23,15,15,9,3,8,1,74,10.571428571428571,3,0.0,5,15,12,9,18,3,3,8,1,41,33,1
1283,10212,IKkLcanOfBFv8w6vw2fYzBwzbCJQZq5m,SpATywNh6bZuzm8s1ceuBUnMUAeoAHHw,23,27,12,12,7,9,7,1,75,10.714285714285714,2,0.0,4,12,12,7,23,9,0,7,1,35,40,0
1284,10214,X71Zy6g4fufrJXrIbNfXtlVdtViubQUc,G8EPVSXsOYB5YQWZGiz1aVq5Pgr2GrQu,5,6,1,0,3,0,2,0,12,1.7142857142857142,1,0.0,3,1,0,3,3,0,0,2,0,7,5,1
1285,10218,JN0hu6OtICcRlrPNS3Zt5hNT8ffEQP2J,bWdj2GDclj5ofokWjzoa5jAwMkxCykd6,12,29,12,0,5,1,12,1,60,8.571428571428571,2,0.0,2,12,0,5,27,1,0,12,1,19,41,1
1286,10227,SnivjdMp3HL6G23yPscSnzZlAD2Rbyt6,A3fsA9Zfv1X2fVEQhTw51lKENdNrEqT3,78,34,22,186,12,0,7,0,261,37.285714285714285,5,0.0,5,22,165,12,29,0,21,7,0,204,57,0
1287,10230,X9IfBkBBoI1jhyhTI5cK6hEB3eMT1rI2,SpATywNh6bZuzm8s1ceuBUnMUAeoAHHw,36,68,39,34,3,84,16,0,244,34.857142857142854,6,0.0,20,39,31,3,48,84,3,16,0,93,151,0
1288,10232,zXzBBpTV9epJ0NK0fVVhqGAiB4MQXdB4,SpATywNh6bZuzm8s1ceuBUnMUAeoAHHw,45,48,28,25,14,20,23,2,160,22.857142857142858,7,0.0,11,28,24,14,37,20,1,23,2,77,83,0
1289,10236,zMsdFc2bNoJ6urVmU6g31AhzZMFpCEEM,SpATywNh6bZuzm8s1ceuBUnMUAeoAHHw,16,14,1,19,1,0,6,1,42,6.0,3,0.0,2,1,16,1,12,0,3,6,1,20,22,1
1290,10244,5gwirWhcaVB1Z2yy4RRslODx7MsCrRca,SpATywNh6bZuzm8s1ceuBUnMUAeoAHHw,46,80,41,57,20,16,20,2,236,33.714285714285715,8,0.0,22,41,50,20,58,16,7,20,2,133,103,0
1291,10250,GhXXCYV4l3r313zlwGPyJpPeGLc4qMAC,bWdj2GDclj5ofokWjzoa5jAwMkxCykd6,8,3,2,0,2,0,3,0,10,1.4285714285714286,1,0.0,0,2,0,2,3,0,0,3,0,4,6,1
1292,10263,Gy6MuuTSUxAvObvL74Ev0uen9bQJO61p,SpATywNh6bZuzm8s1ceuBUnMUAeoAHHw,7,5,3,0,3,1,8,3,23,3.2857142857142856,2,0.0,0,3,0,3,5,1,0,8,3,6,17,1
1293,10271,1kFTVSLESXiimtERcEyClh5CUMgpZbSa,SpATywNh6bZuzm8s1ceuBUnMUAeoAHHw,26,48,19,27,9,12,16,4,135,19.285714285714285,3,0.0,16,19,27,9,32,12,0,16,4,71,64,0
1294,10276,6pYrzEgLAB7Gx24u5Kn0l64uyJLXY41J,SpATywNh6bZuzm8s1ceuBUnMUAeoAHHw,7,3,1,0,1,0,21,0,26,3.7142857142857144,6,0.0,0,1,0,1,3,0,0,21,0,2,24,0
1295,10280,dtlGqEkxytgl4rvxvygVAnxqgcqdYicp,SpATywNh6bZuzm8s1ceuBUnMUAeoAHHw,40,70,21,33,11,6,16,0,157,22.428571428571427,9,0.0,9,21,30,11,61,6,3,16,0,71,86,0
1296,10289,83H2FVc0DUlyPpMlZsbpGsFQRMFc6fan,SpATywNh6bZuzm8s1ceuBUnMUAeoAHHw,15,14,12,6,6,0,4,0,42,6.0,2,0.0,0,12,5,6,14,0,1,4,0,23,19,0
1297,10307,ZBhV1m5APkbtG3EQZyk5pMZqkJsFLe6t,SpATywNh6bZuzm8s1ceuBUnMUAeoAHHw,9,25,16,0,11,1,11,0,64,9.142857142857142,3,0.0,1,16,0,11,24,1,0,11,0,28,36,1
1298,10310,nTUP3gEuwVy2Io3TzQXGmuh9VvJxgHk3,bWdj2GDclj5ofokWjzoa5jAwMkxCykd6,18,35,19,90,5,27,4,0,180,25.714285714285715,3,0.0,3,19,86,5,32,27,4,4,0,113,67,1
1299,10328,GSkYUOcl4XzYMWSWhE6gXRGQ9kqPeXsi,SpATywNh6bZuzm8s1ceuBUnMUAeoAHHw,45,54,31,44,15,1,16,0,161,23.0,7,0.0,14,31,40,15,40,1,4,16,0,100,61,0
1300,10340,afCicX2FGCc7YS72xtNmCsPkAgJ0p3xk,SpATywNh6bZuzm8s1ceuBUnMUAeoAHHw,5,2,0,0,0,0,7,0,9,1.2857142857142858,1,0.0,0,0,0,0,2,0,0,7,0,0,9,1
1301,10342,snAYYuMQqGAkhlZMfAgAWobAumSD4u2s,SpATywNh6bZuzm8s1ceuBUnMUAeoAHHw,8,5,3,0,2,0,3,0,13,1.8571428571428572,1,0.0,0,3,0,2,5,0,0,3,0,5,8,1
1302,10358,Nzrw7pk0OZ13UV7zfdLy7gEMwvTA7qqG,SpATywNh6bZuzm8s1ceuBUnMUAeoAHHw,48,160,78,49,18,214,75,8,602,86.0,21,0.0,47,78,45,18,113,214,4,75,8,188,414,0
1303,10365,xg8dkQPzve0MzcpgxvEsbKyY4VwKrxAC,SpATywNh6bZuzm8s1ceuBUnMUAeoAHHw,13,34,1,0,0,0,5,0,40,5.714285714285714,3,0.0,5,1,0,0,29,0,0,5,0,6,34,1
1304,10380,ziZWaDkSdnYYFQL9rVa6Bhv9eL7a9wWX,SpATywNh6bZuzm8s1ceuBUnMUAeoAHHw,41,99,10,49,7,76,59,1,301,43.0,12,0.0,21,10,42,7,78,76,7,59,1,80,221,0
1305,10382,wONMmUHIYwPBmEB9lgpOY3KCldKiuZFl,SpATywNh6bZuzm8s1ceuBUnMUAeoAHHw,13,23,13,0,11,4,13,1,65,9.285714285714286,5,0.0,6,13,0,11,17,4,0,13,1,30,35,0
1306,10383,1wBdrtLehQQJkXlNE5BI48cxv9PbJtLD,bWdj2GDclj5ofokWjzoa5jAwMkxCykd6,1,0,0,0,0,0,1,0,1,0.14285714285714285,1,0.0,0,0,0,0,0,0,0,1,0,0,1,1
1307,10388,SaHrUfZXnTghdXjrd2g1gBsj8aUTXhNX,SpATywNh6bZuzm8s1ceuBUnMUAeoAHHw,41,70,12,30,7,15,23,1,158,22.571428571428573,8,0.0,27,12,29,7,43,15,1,23,1,75,83,0
1308,10395,HYP3Q558qDipVvMi5tV4os7veHPJBNBQ,bWdj2GDclj5ofokWjzoa5jAwMkxCykd6,8,13,6,0,2,0,6,0,27,3.857142857142857,3,0.0,0,6,0,2,13,0,0,6,0,8,19,0
1309,10403,VgIpHnZLrMLRtvQcwLJvvhrvLtLKds8Y,SpATywNh6bZuzm8s1ceuBUnMUAeoAHHw,24,55,4,8,4,0,14,0,85,12.142857142857142,3,0.0,1,4,7,4,54,0,1,14,0,16,69,1
1310,10407,xLsstPG4sh6BOKWjwGwQnQICDDoIsKTd,SpATywNh6bZuzm8s1ceuBUnMUAeoAHHw,26,73,38,3,18,20,20,8,180,25.714285714285715,12,0.0,14,38,3,18,59,20,0,20,8,73,107,0
1311,10416,9jZsAxMdQXvLjxKIorcfAyZ7kTyyk2m3,bWdj2GDclj5ofokWjzoa5jAwMkxCykd6,21,43,16,22,11,3,14,2,111,15.857142857142858,6,0.0,9,16,21,11,34,3,1,14,2,57,54,1
1312,10422,Eu9HoDt3WhECHgcXaERosbI6lMj7Hipb,RXDvfPUBYFlVdlueBFbLW0mhhAyGEqpt,65,95,54,135,35,44,17,6,386,55.142857142857146,9,0.0,26,54,124,35,69,44,11,17,6,239,147,0
1313,10423,0bGsOnbsTfgtcrUHSL9Ba6RYBtQEiaAR,SpATywNh6bZuzm8s1ceuBUnMUAeoAHHw,5,2,1,0,1,0,3,0,7,1.0,2,0.0,0,1,0,1,2,0,0,3,0,2,5,1
1314,10427,Daw06K1PSOXldo19kBgHP5sewulb7Vu5,SpATywNh6bZuzm8s1ceuBUnMUAeoAHHw,32,59,1,24,0,8,13,1,106,15.142857142857142,8,0.0,12,1,23,0,47,8,1,13,1,36,70,1
1315,10441,KRLjLXKoKEagD4g49Zuzvz0geq7JPqfn,bWdj2GDclj5ofokWjzoa5jAwMkxCykd6,17,62,30,40,18,1,19,2,172,24.571428571428573,8,0.0,12,30,36,18,50,1,4,19,2,96,76,0
1316,10462,PERCKVrZOUZ9ZmdU3J0Mwd1TZrMvK8yc,RXDvfPUBYFlVdlueBFbLW0mhhAyGEqpt,38,76,40,0,40,5,9,1,171,24.428571428571427,3,0.0,25,40,0,40,51,5,0,9,1,105,66,0
1317,10481,4baDuWDcygh3I7gf3DfgmuPMN0Tyoi19,SpATywNh6bZuzm8s1ceuBUnMUAeoAHHw,38,70,12,40,4,26,36,3,191,27.285714285714285,8,0.0,16,12,31,4,54,26,9,36,3,63,128,0
1318,10489,VC1Fuf9dV49znO9PkMawj1ZQqMcKHAjm,SpATywNh6bZuzm8s1ceuBUnMUAeoAHHw,35,69,9,39,5,31,25,1,179,25.571428571428573,14,0.0,23,9,35,5,46,31,4,25,1,72,107,0
1319,10502,vx1j5ZdbVcqMnaq8fewmENptts2XnB9X,SpATywNh6bZuzm8s1ceuBUnMUAeoAHHw,28,44,9,20,5,11,12,1,102,14.571428571428571,3,0.0,16,9,17,5,28,11,3,12,1,47,55,0
1320,10509,gtq5s5jDEXDrRLbMZLZJIjHVD4oTJM3K,SpATywNh6bZuzm8s1ceuBUnMUAeoAHHw,25,37,1,30,1,9,15,2,95,13.571428571428571,2,0.0,11,1,26,1,26,9,4,15,2,39,56,1
1321,10510,Dz5Gcjm5wFySM7nVbkILZVfr9rOqjoD4,bWdj2GDclj5ofokWjzoa5jAwMkxCykd6,1,0,0,0,0,0,1,0,1,0.14285714285714285,1,0.0,0,0,0,0,0,0,0,1,0,0,1,1
1322,10518,rzGwtyhvOohTorRAFSpekt9j8KJVn1Nq,SpATywNh6bZuzm8s1ceuBUnMUAeoAHHw,42,91,50,36,26,3,28,0,234,33.42857142857143,9,0.0,17,50,33,26,74,3,3,28,0,126,108,0
1323,10522,6rHs7FPoWFgbGCrOeJU6CnRQs9oaZ934,SpATywNh6bZuzm8s1ceuBUnMUAeoAHHw,1,0,0,0,0,0,2,0,2,0.2857142857142857,2,0.0,0,0,0,0,0,0,0,2,0,0,2,0
1324,10523,jUBhH6RhAb1JtOUdjtvZ9A8khJilFTTv,RXDvfPUBYFlVdlueBFbLW0mhhAyGEqpt,9,14,4,0,1,4,8,0,31,4.428571428571429,1,0.0,9,4,0,1,5,4,0,8,0,14,17,1
1325,10527,VYMfm0tgVS6x4Eosz9NPpRPYpCrgFsMy,A3fsA9Zfv1X2fVEQhTw51lKENdNrEqT3,97,111,48,375,31,2,32,0,599,85.57142857142857,11,0.0,11,48,336,31,100,2,39,32,0,426,173,0
1326,10528,WubsiWqf9HrcjL91VrCtUc1j3k8esFc2,G8EPVSXsOYB5YQWZGiz1aVq5Pgr2GrQu,13,10,4,4,3,7,5,0,33,4.714285714285714,2,0.0,0,4,3,3,10,7,1,5,0,10,23,1
1327,10535,TyLciGh9B6yO4eY9EZiNs3MwXyb1sWVv,SpATywNh6bZuzm8s1ceuBUnMUAeoAHHw,21,28,2,34,2,2,10,0,78,11.142857142857142,4,0.0,12,2,30,2,16,2,4,10,0,46,32,1
1328,10540,Cwlc0kvvLoKXxEuXNQkjFRo818TDMpZS,SpATywNh6bZuzm8s1ceuBUnMUAeoAHHw,45,122,35,53,15,16,18,4,263,37.57142857142857,11,0.0,40,35,49,15,82,16,4,18,4,139,124,0
1329,10542,r2u5KF0HWbXOmPd8SinNo3Ik67swOdP7,SpATywNh6bZuzm8s1ceuBUnMUAeoAHHw,36,59,38,20,18,1,13,0,149,21.285714285714285,6,0.0,15,38,17,18,44,1,3,13,0,88,61,0
1330,10555,QqE2Xjwy9gUzOvFdkDqAwAaNZLBZkxvd,bWdj2GDclj5ofokWjzoa5jAwMkxCykd6,11,19,2,0,1,3,29,0,54,7.714285714285714,8,0.0,0,2,0,1,19,3,0,29,0,3,51,0
1331,10558,Cvs414mYH2FKto3axCpDhfQljawQ5dk9,SpATywNh6bZuzm8s1ceuBUnMUAeoAHHw,17,41,24,15,4,2,17,0,103,14.714285714285714,7,0.0,4,24,15,4,37,2,0,17,0,47,56,0
1332,10567,WubsiWqf9HrcjL91VrCtUc1j3k8esFc2,SpATywNh6bZuzm8s1ceuBUnMUAeoAHHw,1,0,0,0,0,0,2,0,2,0.2857142857142857,2,0.0,0,0,0,0,0,0,0,2,0,0,2,1
1333,10580,m1V3ygdnufe369wleiOQ11JelGyARbAF,SpATywNh6bZuzm8s1ceuBUnMUAeoAHHw,32,49,29,34,15,3,23,0,153,21.857142857142858,4,0.0,11,29,28,15,38,3,6,23,0,83,70,1
1334,10591,wbbNGhodAmSlYSg7ZSWYtWMdb0rjLgRw,G8EPVSXsOYB5YQWZGiz1aVq5Pgr2GrQu,136,84,49,266,27,56,43,1,526,75.14285714285714,10,0.0,4,49,246,27,80,56,20,43,1,326,200,0
1335,10602,v86tUMPiBVyN5RvZX1ZNepQ3NEMTABtY,A3fsA9Zfv1X2fVEQhTw51lKENdNrEqT3,20,21,20,0,20,0,1,0,62,8.857142857142858,1,0.0,0,20,0,20,21,0,0,1,0,40,22,1
1336,10604,UKrQdzHwNJRJK7ZoTzKsoWlrkEbsQk7X,G8EPVSXsOYB5YQWZGiz1aVq5Pgr2GrQu,62,91,50,82,15,15,30,1,284,40.57142857142857,12,0.0,2,50,76,15,89,15,6,30,1,143,141,1
1337,10606,BOBLP6pTmRtpQ8LtVgJyutFMDL3q6xno,SpATywNh6bZuzm8s1ceuBUnMUAeoAHHw,30,39,24,14,8,0,8,0,93,13.285714285714286,7,0.0,7,24,14,8,32,0,0,8,0,53,40,0
1338,10608,a3StgABPgimfVHzW1FR4usG9kIA0tZV5,SpATywNh6bZuzm8s1ceuBUnMUAeoAHHw,44,127,2,45,1,7,28,0,210,30.0,10,0.0,11,2,38,1,116,7,7,28,0,52,158,0
1339,10609,VYMfm0tgVS6x4Eosz9NPpRPYpCrgFsMy,bWdj2GDclj5ofokWjzoa5jAwMkxCykd6,46,95,33,222,19,17,24,0,410,58.57142857142857,9,0.0,25,33,198,19,70,17,24,24,0,275,135,1
1340,10619,CGB0PTeWY2VA2Nk2INJOsdD7IvpzgObV,G8EPVSXsOYB5YQWZGiz1aVq5Pgr2GrQu,33,59,32,35,18,24,20,0,188,26.857142857142858,5,0.0,15,32,30,18,44,24,5,20,0,95,93,1
1341,10620,uhhVn2X7KTVJ0ZZ7uUwG1hMZv4TidRQj,SpATywNh6bZuzm8s1ceuBUnMUAeoAHHw,5,2,1,0,1,0,2,0,6,0.8571428571428571,1,0.0,0,1,0,1,2,0,0,2,0,2,4,1
1342,10623,dzaUNwKZy91BtYj96fOhuSgIlp9lXQDU,SpATywNh6bZuzm8s1ceuBUnMUAeoAHHw,9,19,9,0,1,6,11,0,46,6.571428571428571,7,0.0,2,9,0,1,17,6,0,11,0,12,34,0
1343,10634,OUOJlObKrXM0JmEUq0o8KzZHzr8jy9dn,bWdj2GDclj5ofokWjzoa5jAwMkxCykd6,13,31,13,58,6,27,27,2,164,23.428571428571427,9,0.0,11,13,57,6,20,27,1,27,2,87,77,0
1344,10637,uzPUKUi7vVAcTKZXvlLeqjC4erxz8WBI,bWdj2GDclj5ofokWjzoa5jAwMkxCykd6,35,47,39,34,37,6,9,0,172,24.571428571428573,16,0.0,0,39,31,37,47,6,3,9,0,107,65,0
1345,10642,OnuqqUI42ulcOdv07J5FWiuL2V3DVzCo,RXDvfPUBYFlVdlueBFbLW0mhhAyGEqpt,10,15,8,0,2,0,5,0,30,4.285714285714286,4,0.0,0,8,0,2,15,0,0,5,0,10,20,1
1346,10647,JqgIGUKaljto8rJQxV18FonxG0JqVkY4,SpATywNh6bZuzm8s1ceuBUnMUAeoAHHw,15,22,3,0,2,0,6,0,33,4.714285714285714,3,0.0,0,3,0,2,22,0,0,6,0,5,28,1
1347,10655,39GYbZ8lJRbKZppnA1dQGPRJvzLTR46Q,SpATywNh6bZuzm8s1ceuBUnMUAeoAHHw,16,55,27,2,7,10,17,1,119,17.0,9,0.0,4,27,2,7,51,10,0,17,1,40,79,0
1348,10658,teqJGecOr4a6oVYU1O9bgvPkX5ZSKA8N,A3fsA9Zfv1X2fVEQhTw51lKENdNrEqT3,10,17,2,8,0,0,8,0,35,5.0,6,0.0,0,2,8,0,17,0,0,8,0,10,25,1
1349,10666,9G8Z3eYe0C9cQmNRrnywgJDzRVO9yiAU,SpATywNh6bZuzm8s1ceuBUnMUAeoAHHw,10,7,4,0,3,0,2,0,16,2.2857142857142856,1,0.0,0,4,0,3,7,0,0,2,0,7,9,1
1350,10667,gvBW2L5p7TFF6lkwpHMNMz6nt7oEVYk1,SpATywNh6bZuzm8s1ceuBUnMUAeoAHHw,34,43,19,23,9,0,15,0,109,15.571428571428571,5,0.0,16,19,23,9,27,0,0,15,0,67,42,0
1351,10670,vUBx8sjBPXrETcrwHSfZ0pSQFIH0HPOl,SpATywNh6bZuzm8s1ceuBUnMUAeoAHHw,8,6,3,0,2,0,7,0,18,2.5714285714285716,2,0.0,0,3,0,2,6,0,0,7,0,5,13,1
1352,10671,xg8dkQPzve0MzcpgxvEsbKyY4VwKrxAC,A3fsA9Zfv1X2fVEQhTw51lKENdNrEqT3,15,22,1,0,0,0,5,0,28,4.0,2,0.0,1,1,0,0,21,0,0,5,0,2,26,1
1353,10676,Bv9FSXvHlE6wLC4E4yrAKqe3BQhrrtfx,SpATywNh6bZuzm8s1ceuBUnMUAeoAHHw,36,70,3,41,3,1,15,0,133,19.0,8,0.0,19,3,32,3,51,1,9,15,0,57,76,0
1354,10677,e3VhXxfZ0vOxuCz75HZxH5mLRjbeafOC,A3fsA9Zfv1X2fVEQhTw51lKENdNrEqT3,46,19,15,66,11,4,14,3,132,18.857142857142858,3,0.0,1,15,57,11,18,4,9,14,3,84,48,1
1355,10692,rTYF0meww41Jaf1ZhSKn71dF6UobIHyn,SpATywNh6bZuzm8s1ceuBUnMUAeoAHHw,42,119,8,35,2,11,43,3,221,31.571428571428573,11,0.0,16,8,34,2,103,11,1,43,3,60,161,0
1356,10693,ZAehH9zLr3mvrD0qfr21tfeJdYtTkUHf,SpATywNh6bZuzm8s1ceuBUnMUAeoAHHw,35,49,5,18,4,12,20,2,110,15.714285714285714,7,0.0,5,5,16,4,44,12,2,20,2,30,80,1
1357,10700,jX1wtG8uym7vm2Ny85W79HCXnEeqhUm4,bWdj2GDclj5ofokWjzoa5jAwMkxCykd6,40,135,65,156,9,70,58,2,495,70.71428571428571,12,0.0,19,65,136,9,116,70,20,58,2,229,266,0
1358,10701,01A7cnd3gvCIwCcMkE5K8qeHnbk9l92w,SpATywNh6bZuzm8s1ceuBUnMUAeoAHHw,10,8,1,0,1,0,5,0,15,2.142857142857143,2,0.0,0,1,0,1,8,0,0,5,0,2,13,1
1359,10712,IaSb2U7ef1Fkefm60uQQgWhKloK1Rfe8,SpATywNh6bZuzm8s1ceuBUnMUAeoAHHw,47,57,19,31,11,0,15,0,133,19.0,10,0.0,10,19,28,11,47,0,3,15,0,68,65,0
1360,10725,TgheOgj9khTgshxaHKtqDHWb3smGHeUA,G8EPVSXsOYB5YQWZGiz1aVq5Pgr2GrQu,2,0,0,0,0,0,2,0,2,0.2857142857142857,1,0.0,0,0,0,0,0,0,0,2,0,0,2,1
1361,10730,mJZNVvZltlGUOWmItS7lca1ZZKMYLgfv,A3fsA9Zfv1X2fVEQhTw51lKENdNrEqT3,69,28,1,224,1,0,10,0,264,37.714285714285715,4,0.0,5,1,222,1,23,0,2,10,0,229,35,1
1362,10743,98UEGByxiN7tned6NDQeKfQDq4HCSGvQ,SpATywNh6bZuzm8s1ceuBUnMUAeoAHHw,34,64,26,27,12,19,15,1,164,23.428571428571427,6,0.0,17,26,23,12,47,19,4,15,1,78,86,0
1363,10746,FQskTqGJU9GeC9XfemJd5Qp19XhmSu0D,SpATywNh6bZuzm8s1ceuBUnMUAeoAHHw,9,14,4,0,2,1,7,0,28,4.0,3,0.0,2,4,0,2,12,1,0,7,0,8,20,1
1364,10747,348VAoiXzNIM3yBiHWYaT9jpmJfwDK3a,SpATywNh6bZuzm8s1ceuBUnMUAeoAHHw,24,14,9,31,7,0,1,0,62,8.857142857142858,1,0.0,4,9,27,7,10,0,4,1,0,47,15,1
1365,10758,JjZeMsAmsZa7SQS0vTrtExRB1lmjwAQ2,SpATywNh6bZuzm8s1ceuBUnMUAeoAHHw,32,72,6,16,5,0,21,0,120,17.142857142857142,9,0.0,5,6,16,5,67,0,0,21,0,32,88,0
1366,10760,Y2f2dC6l8KkgqmCmVNjopMQFUan6brSz,G8EPVSXsOYB5YQWZGiz1aVq5Pgr2GrQu,5,5,3,0,2,0,2,0,12,1.7142857142857142,2,0.0,0,3,0,2,5,0,0,2,0,5,7,1
1367,10761,Grmueh4kYgLYo2kInw23ZHrSQJbjli7D,SpATywNh6bZuzm8s1ceuBUnMUAeoAHHw,56,83,55,57,35,4,22,3,259,37.0,10,0.0,15,55,50,35,68,4,7,22,3,155,104,0
1368,10763,tby14fMJpDIjTBkK50rauZ0P5DHnQphs,SpATywNh6bZuzm8s1ceuBUnMUAeoAHHw,30,74,27,26,10,2,16,5,160,22.857142857142858,7,0.0,12,27,23,10,62,2,3,16,5,72,88,1
1369,10774,QmKLhFuFtodx97KXUUkaok1RXKwJOs6p,SpATywNh6bZuzm8s1ceuBUnMUAeoAHHw,31,58,29,44,14,6,21,0,172,24.571428571428573,7,0.0,21,29,36,14,37,6,8,21,0,100,72,0
1370,10780,4rsvMJ6Q6FXQkVitKsbveKESjOLTvSkd,bWdj2GDclj5ofokWjzoa5jAwMkxCykd6,5,2,1,0,1,0,3,0,7,1.0,2,0.0,0,1,0,1,2,0,0,3,0,2,5,1
1371,10784,4fg1E2X2Iqab02UjKHSaN93jLrNDtbK1,SpATywNh6bZuzm8s1ceuBUnMUAeoAHHw,6,2,1,0,1,0,3,0,7,1.0,2,0.0,0,1,0,1,2,0,0,3,0,2,5,1
1372,10798,8gqnQBccwF9lDaMHj8oF8zZMqUrUX7OJ,SpATywNh6bZuzm8s1ceuBUnMUAeoAHHw,6,2,0,0,0,0,4,0,6,0.8571428571428571,1,0.0,0,0,0,0,2,0,0,4,0,0,6,1
1373,10799,4wGoSTuzJXBCojeNmaxk9GbR1KaCV7ql,G8EPVSXsOYB5YQWZGiz1aVq5Pgr2GrQu,85,119,10,260,9,2,19,3,422,60.285714285714285,6,0.0,42,10,217,9,77,2,43,19,3,278,144,0
1374,10802,7jkKKf5Pb7FrtJ3WnuF11G7ePioUPJm3,SpATywNh6bZuzm8s1ceuBUnMUAeoAHHw,44,75,44,41,22,8,14,0,204,29.142857142857142,7,0.0,20,44,40,22,55,8,1,14,0,126,78,0
1375,10805,mJAgtJKHxy28GsPIeuAEUCIOXmHzCywF,SpATywNh6bZuzm8s1ceuBUnMUAeoAHHw,50,177,92,27,26,152,93,2,569,81.28571428571429,14,0.0,31,92,24,26,146,152,3,93,2,173,396,0
1376,10815,2MQR5LCqimp6aDvlkve2ALXoA292MToK,A3fsA9Zfv1X2fVEQhTw51lKENdNrEqT3,3,3,0,0,0,0,3,0,6,0.8571428571428571,1,0.0,0,0,0,0,3,0,0,3,0,0,6,1
1377,10820,2DRl1D33z6i9gsgW5IB0KBdkJJ1Zsu7a,SpATywNh6bZuzm8s1ceuBUnMUAeoAHHw,8,6,2,12,0,1,3,0,24,3.4285714285714284,1,0.0,4,2,12,0,2,1,0,3,0,18,6,1
1378,10821,NXEwBXbU6vvce77sujWgRB6LivhFJvRb,SpATywNh6bZuzm8s1ceuBUnMUAeoAHHw,8,11,7,0,4,0,6,0,28,4.0,3,0.0,0,7,0,4,11,0,0,6,0,11,17,0
1379,10824,lMRWvZAvduvP2Pz46WY1VVjM0sCfB7T7,A3fsA9Zfv1X2fVEQhTw51lKENdNrEqT3,14,8,7,0,7,0,1,0,23,3.2857142857142856,1,0.0,0,7,0,7,8,0,0,1,0,14,9,1
1380,10825,7WuJYJfQSGYpjK1VOCbNTWx56QRfHZwF,SpATywNh6bZuzm8s1ceuBUnMUAeoAHHw,12,18,8,0,2,2,11,2,43,6.142857142857143,1,0.0,5,8,0,2,13,2,0,11,2,15,28,1
1381,10832,W73xMu8SLqBdMS90qjmpE3wGeT86YnLl,SpATywNh6bZuzm8s1ceuBUnMUAeoAHHw,1,0,0,0,0,0,1,0,1,0.14285714285714285,1,0.0,0,0,0,0,0,0,0,1,0,0,1,1
1382,10850,O4Go02y0WzYwbHIZc8uk50WjYKUP2Q4Y,G8EPVSXsOYB5YQWZGiz1aVq5Pgr2GrQu,8,17,2,0,4,2,9,0,34,4.857142857142857,3,0.0,5,2,0,4,12,2,0,9,0,11,23,1
1383,10863,SE8wOQdHqwRS7ESACXcTxQAuYFlgu1Py,SpATywNh6bZuzm8s1ceuBUnMUAeoAHHw,24,69,42,26,0,14,18,2,171,24.428571428571427,6,0.0,20,42,19,0,49,14,7,18,2,81,90,1
1384,10867,n6zGNJI1hLWYjlMIVXYesa3jTXjLwizj,SpATywNh6bZuzm8s1ceuBUnMUAeoAHHw,33,84,51,25,10,0,29,1,200,28.571428571428573,14,0.0,13,51,22,10,71,0,3,29,1,96,104,0
1385,10868,d9cbpiPwBULo3iFfJzjTidseoxKi3AEA,SpATywNh6bZuzm8s1ceuBUnMUAeoAHHw,28,75,14,40,5,55,36,7,232,33.142857142857146,10,0.0,13,14,34,5,62,55,6,36,7,66,166,0
1386,10873,YLA48gUHn1Dc2R5xXAOe8bpBqZ5RWVW4,A3fsA9Zfv1X2fVEQhTw51lKENdNrEqT3,7,5,3,0,1,0,4,0,13,1.8571428571428572,2,0.0,0,3,0,1,5,0,0,4,0,4,9,1
1387,10881,31ZWCwEsmLt26QDeYIg9aUSXrbkhFpxl,SpATywNh6bZuzm8s1ceuBUnMUAeoAHHw,25,28,16,26,6,8,11,0,95,13.571428571428571,5,0.0,4,16,22,6,24,8,4,11,0,48,47,0
1388,10883,FRmbznbV6x9Ojz1brfaBTFmC2TFyzd4t,SpATywNh6bZuzm8s1ceuBUnMUAeoAHHw,6,2,1,0,1,0,3,0,7,1.0,1,0.0,0,1,0,1,2,0,0,3,0,2,5,1
1389,10889,QYLtTejmIZrOzfj0rdDVGzAjECmBavYx,A3fsA9Zfv1X2fVEQhTw51lKENdNrEqT3,22,12,9,0,7,4,11,1,44,6.285714285714286,4,0.0,0,9,0,7,12,4,0,11,1,16,28,1
1390,10902,wGtQdpTL13GOtTQAxkeOO6rmRR5kG8Nt,G8EPVSXsOYB5YQWZGiz1aVq5Pgr2GrQu,17,19,1,15,1,3,12,1,52,7.428571428571429,2,0.0,6,1,9,1,13,3,6,12,1,17,35,1
1391,10903,896KUUFdpc0Ig8weMXOkWbw7cjXtmIVV,SpATywNh6bZuzm8s1ceuBUnMUAeoAHHw,32,37,16,55,5,0,35,1,149,21.285714285714285,11,0.0,9,16,52,5,28,0,3,35,1,82,67,0
1392,10907,90tR2Jy52lv1kJ6TwJ9Jqo5P6u0CqT0E,SpATywNh6bZuzm8s1ceuBUnMUAeoAHHw,46,68,42,50,25,0,20,0,205,29.285714285714285,9,0.0,11,42,45,25,57,0,5,20,0,123,82,0
1393,10959,DgZ8el6keJUnUjxjYHQCrfhij2kpBixa,SpATywNh6bZuzm8s1ceuBUnMUAeoAHHw,6,5,1,0,1,0,6,0,13,1.8571428571428572,3,0.0,0,1,0,1,5,0,0,6,0,2,11,1
1394,10960,0LuT01kLiLvn9XWvvtK0UMLQOoqN4d0O,SpATywNh6bZuzm8s1ceuBUnMUAeoAHHw,7,3,2,0,2,0,2,0,9,1.2857142857142858,1,0.0,0,2,0,2,3,0,0,2,0,4,5,1
1395,10961,1N6nOsYXnkatuA8YMolfRAv0tQpjn2uG,SpATywNh6bZuzm8s1ceuBUnMUAeoAHHw,47,59,33,44,17,5,13,0,171,24.428571428571427,10,0.0,14,33,38,17,45,5,6,13,0,102,69,0
1396,10965,Vc1baHxuYCOF9wXqOziB65UR0NyB8LSm,bWdj2GDclj5ofokWjzoa5jAwMkxCykd6,13,12,0,78,0,8,4,0,102,14.571428571428571,2,0.0,3,0,75,0,9,8,3,4,0,78,24,1
1397,10966,DmvuE1XVhhp2s0ZR7GTfZK1NmSM6wJmI,SpATywNh6bZuzm8s1ceuBUnMUAeoAHHw,18,22,10,14,5,2,9,1,63,9.0,2,0.0,9,10,12,5,13,2,2,9,1,36,27,1
1398,10970,IdRsdksEKIk9aXKOiGRUkjb7QPozokDa,SpATywNh6bZuzm8s1ceuBUnMUAeoAHHw,49,148,41,38,20,1,28,2,278,39.714285714285715,11,0.0,15,41,33,20,133,1,5,28,2,109,169,0
1399,10977,2VCaGNRfRGGtWxoLqznZdBtjcnH6XG28,SpATywNh6bZuzm8s1ceuBUnMUAeoAHHw,6,5,1,0,1,0,3,0,10,1.4285714285714286,2,0.0,0,1,0,1,5,0,0,3,0,2,8,1
1400,10981,gFIubR5L7uAqsUwFMmCtpUtAJn2LXJti,SpATywNh6bZuzm8s1ceuBUnMUAeoAHHw,12,33,13,0,8,0,16,2,72,10.285714285714286,4,0.0,0,13,0,8,33,0,0,16,2,21,51,1
1401,10986,MN4wOgynUY4QcRaraCB5Ym52vNjUttfc,SpATywNh6bZuzm8s1ceuBUnMUAeoAHHw,33,42,25,37,16,9,7,0,136,19.428571428571427,4,0.0,11,25,31,16,31,9,6,7,0,83,53,0
1402,10992,EaV63ns250Za7MNTuadlc0JeYoVcm5bM,SpATywNh6bZuzm8s1ceuBUnMUAeoAHHw,57,66,23,46,14,4,18,1,172,24.571428571428573,8,0.0,21,23,40,14,45,4,6,18,1,98,74,0
1403,11000,zyIWmJjaz36PnMZpAzR2HEZCUbJWe8iQ,bWdj2GDclj5ofokWjzoa5jAwMkxCykd6,62,55,25,156,14,5,21,2,278,39.714285714285715,9,0.0,20,25,151,14,35,5,5,21,2,210,68,1
1404,11005,o6ABKk2KTrZIkABXncviG8GWvJhMxPWI,A3fsA9Zfv1X2fVEQhTw51lKENdNrEqT3,23,10,5,60,0,0,5,0,80,11.428571428571429,2,0.0,4,5,55,0,6,0,5,5,0,64,16,1
1405,11007,o6ABKk2KTrZIkABXncviG8GWvJhMxPWI,bWdj2GDclj5ofokWjzoa5jAwMkxCykd6,5,2,1,0,0,0,8,4,15,2.142857142857143,3,0.0,0,1,0,0,2,0,0,8,4,1,14,1
1406,11009,V9WdcffWyPz5HIrf6AUJoXYLZsZmovZs,bWdj2GDclj5ofokWjzoa5jAwMkxCykd6,8,5,2,0,2,0,6,0,15,2.142857142857143,1,0.0,0,2,0,2,5,0,0,6,0,4,11,1
1407,11018,bjG4XBkL5oSJA9TxyrmgPKXKYOTfiWVp,bWdj2GDclj5ofokWjzoa5jAwMkxCykd6,56,96,34,129,20,27,23,1,330,47.142857142857146,10,0.0,11,34,110,20,85,27,19,23,1,175,155,0
1408,11035,oOFCpO143ty3GSSLZVLh2o69NMEyxWhF,A3fsA9Zfv1X2fVEQhTw51lKENdNrEqT3,3,0,0,0,0,0,2,1,3,0.42857142857142855,1,0.0,0,0,0,0,0,0,0,2,1,0,3,1
1409,11039,uukZZIB0DkTcJFX9Kfm5gzAJiaQWt3jq,SpATywNh6bZuzm8s1ceuBUnMUAeoAHHw,25,34,18,12,8,12,21,2,107,15.285714285714286,6,0.0,8,18,10,8,26,12,2,21,2,44,63,1
1410,11063,RlHRJAiYu3Nfz7DEuzJcJRZJq4vbOfQu,SpATywNh6bZuzm8s1ceuBUnMUAeoAHHw,8,5,3,0,2,0,8,0,18,2.5714285714285716,3,0.0,0,3,0,2,5,0,0,8,0,5,13,0
1411,11072,48y8P1mBttkP3u0gtvk3ydvAiO35KU2g,SpATywNh6bZuzm8s1ceuBUnMUAeoAHHw,31,48,28,22,13,0,6,0,117,16.714285714285715,9,0.0,12,28,22,13,36,0,0,6,0,75,42,0
1412,11095,ALXyvdc776DMhlVyaaoPo6cQhevpwTYD,SpATywNh6bZuzm8s1ceuBUnMUAeoAHHw,30,73,11,27,3,2,32,1,149,21.285714285714285,13,0.0,31,11,24,3,42,2,3,32,1,69,80,0
1413,11096,vogj6DdqvLTkNOGuPksobO32JsQUkuqr,SpATywNh6bZuzm8s1ceuBUnMUAeoAHHw,33,112,8,60,1,31,22,1,235,33.57142857142857,14,0.0,37,8,50,1,75,31,10,22,1,96,139,0
1414,11098,R5MIWOdfQPF58rt5zIICrbN58FLsYSLK,SpATywNh6bZuzm8s1ceuBUnMUAeoAHHw,21,36,24,9,15,8,14,0,106,15.142857142857142,7,0.0,0,24,7,15,36,8,2,14,0,46,60,0
1415,11099,EfuhWoaB1h47xaBVO37JU7S7sIj3K77V,SpATywNh6bZuzm8s1ceuBUnMUAeoAHHw,29,48,4,46,1,9,18,1,127,18.142857142857142,6,0.0,10,4,40,1,38,9,6,18,1,55,72,0
1416,11100,qRCFXu9SKQXvPlpvjvNkgxm9VD5k2SNq,G8EPVSXsOYB5YQWZGiz1aVq5Pgr2GrQu,6,14,5,0,2,0,7,0,28,4.0,4,0.0,0,5,0,2,14,0,0,7,0,7,21,1
1417,11102,WCS011LuLB85y1yYsddT54kQDph1Fl5i,SpATywNh6bZuzm8s1ceuBUnMUAeoAHHw,11,5,4,0,4,0,2,0,15,2.142857142857143,1,0.0,0,4,0,4,5,0,0,2,0,8,7,1
1418,11108,kfRiZgRVbY5ABTVoI4HG09f2IgSZ5p9y,SpATywNh6bZuzm8s1ceuBUnMUAeoAHHw,1,0,0,0,0,0,1,0,1,0.14285714285714285,1,0.0,0,0,0,0,0,0,0,1,0,0,1,1
1419,11110,fNM6a78gna3DBlYrxiSuwL1HfiXFBx1X,SpATywNh6bZuzm8s1ceuBUnMUAeoAHHw,42,41,22,33,13,1,12,2,124,17.714285714285715,4,0.0,14,22,27,13,27,1,6,12,2,76,48,1
1420,11117,yBKClM5or0v37bBK9shMFXqtoOJsEOKi,SpATywNh6bZuzm8s1ceuBUnMUAeoAHHw,60,101,40,50,20,11,16,2,240,34.285714285714285,8,0.0,24,40,45,20,77,11,5,16,2,129,111,0
1421,11118,8G3TIfWeYnotKEBloHzMAvSj0jab6YCE,SpATywNh6bZuzm8s1ceuBUnMUAeoAHHw,42,107,13,46,9,1,25,0,201,28.714285714285715,10,0.0,19,13,44,9,88,1,2,25,0,85,116,0
1422,11132,2YJ5Tv1YViB4JNiKZeHEEz6eSF3MN6um,bWdj2GDclj5ofokWjzoa5jAwMkxCykd6,1,0,0,0,0,0,1,0,1,0.14285714285714285,1,0.0,0,0,0,0,0,0,0,1,0,0,1,1
1423,11133,CdI8eHwhOFOmT1gRfkQHwobJyLn2OtRJ,SpATywNh6bZuzm8s1ceuBUnMUAeoAHHw,8,8,2,0,0,0,8,0,18,2.5714285714285716,3,0.0,0,2,0,0,8,0,0,8,0,2,16,1
1424,11140,kQ63n93d5CTXewyEhcoySFeLgYStuYpO,SpATywNh6bZuzm8s1ceuBUnMUAeoAHHw,42,61,33,48,11,7,20,0,180,25.714285714285715,15,0.0,11,33,40,11,50,7,8,20,0,95,85,0
1425,11145,UnV0HDk59T6cuzi8hS829ZOjCdT0CRoB,SpATywNh6bZuzm8s1ceuBUnMUAeoAHHw,56,109,52,46,24,41,30,11,313,44.714285714285715,11,0.0,27,52,42,24,82,41,4,30,11,145,168,0
1426,11152,SuK945tkxadINDtal1yRSiV9QKse6fnl,G8EPVSXsOYB5YQWZGiz1aVq5Pgr2GrQu,84,146,51,158,41,25,13,0,434,62.0,8,0.0,72,51,109,41,74,25,49,13,0,273,161,0
1427,11153,h8eBexpHr95TQpIPdJzX4ggtrj3rthKs,SpATywNh6bZuzm8s1ceuBUnMUAeoAHHw,33,60,27,24,12,10,10,0,143,20.428571428571427,7,0.0,13,27,22,12,47,10,2,10,0,74,69,0
1428,11156,HIC4ktOJbqbNeF2uNjLeMCsJ9XcoLJFS,SpATywNh6bZuzm8s1ceuBUnMUAeoAHHw,7,9,5,0,5,0,3,0,22,3.142857142857143,2,0.0,0,5,0,5,9,0,0,3,0,10,12,1
1429,11196,0K6JPqiivQzicxY4EV4nqMLCL3a08A97,A3fsA9Zfv1X2fVEQhTw51lKENdNrEqT3,8,2,2,0,2,0,7,0,13,1.8571428571428572,3,0.0,0,2,0,2,2,0,0,7,0,4,9,1
1430,11199,G5krO16D3cyvAnQXVywA0e0QfvmDKyJE,SpATywNh6bZuzm8s1ceuBUnMUAeoAHHw,11,35,13,0,6,2,16,1,73,10.428571428571429,4,0.0,2,13,0,6,33,2,0,16,1,21,52,1
1431,11218,ESIDCh7JUpjIHOXvPcQBcrSs3Att83qK,SpATywNh6bZuzm8s1ceuBUnMUAeoAHHw,39,175,5,55,1,7,73,0,316,45.142857142857146,18,0.0,16,5,49,1,159,7,6,73,0,71,245,0
1432,11231,FpAFHYP26eZqx6Z5sDhKdTJPTBgbDKt4,SpATywNh6bZuzm8s1ceuBUnMUAeoAHHw,47,130,55,63,16,149,64,7,484,69.14285714285714,16,0.0,47,55,50,16,83,149,13,64,7,168,316,0
1433,11232,wmD7RtZPHqOfpVEXsJ4kv2jVIQOymIt7,G8EPVSXsOYB5YQWZGiz1aVq5Pgr2GrQu,17,16,5,2,3,5,8,1,40,5.714285714285714,2,0.0,5,5,1,3,11,5,1,8,1,14,26,1
1434,11266,VhukMS7IeX7XDUBwwZYzbVsz6P6yEHKX,RXDvfPUBYFlVdlueBFbLW0mhhAyGEqpt,1,0,0,0,0,0,1,0,1,0.14285714285714285,1,0.0,0,0,0,0,0,0,0,1,0,0,1,1
1435,11267,Zp4vK4oqe1AwFnnOJdy7Uz1AWwNAcdOt,SpATywNh6bZuzm8s1ceuBUnMUAeoAHHw,25,27,16,11,11,0,6,0,71,10.142857142857142,3,0.0,4,16,10,11,23,0,1,6,0,41,30,1
1436,11277,fOGAjxxxpsDuk08vAdjWtxgrvUhA2ic8,SpATywNh6bZuzm8s1ceuBUnMUAeoAHHw,21,39,0,34,0,25,6,0,104,14.857142857142858,4,0.0,14,0,27,0,25,25,7,6,0,41,63,1
1437,11298,gnjZOoI8BeitDTrO8bhWhoFLWjid4LeA,A3fsA9Zfv1X2fVEQhTw51lKENdNrEqT3,8,11,9,0,0,0,1,0,21,3.0,1,0.0,0,9,0,0,11,0,0,1,0,9,12,1
1438,11307,1dxQmK9WwlHWuIG7ZTn4PsJ2vflQBDH3,SpATywNh6bZuzm8s1ceuBUnMUAeoAHHw,15,22,3,6,0,1,3,0,35,5.0,3,0.0,6,3,6,0,16,1,0,3,0,15,20,0
1439,11316,dw8UeboqdsSC29cEE9urly5h5PKlFfq8,SpATywNh6bZuzm8s1ceuBUnMUAeoAHHw,2,0,0,0,0,0,3,0,3,0.42857142857142855,2,0.0,0,0,0,0,0,0,0,3,0,0,3,1
1440,11325,urVw10ZOKTw1O1zHFnsutUzT6EcZdTal,SpATywNh6bZuzm8s1ceuBUnMUAeoAHHw,54,68,28,33,16,4,20,2,171,24.428571428571427,11,0.0,9,28,30,16,59,4,3,20,2,83,88,0
1441,11336,dEamTHPv2n4UBaBMMzaMVTBu34nRHB8p,SpATywNh6bZuzm8s1ceuBUnMUAeoAHHw,5,0,0,0,0,4,5,1,10,1.4285714285714286,1,0.0,0,0,0,0,0,4,0,5,1,0,10,1
1442,11341,mJAgtJKHxy28GsPIeuAEUCIOXmHzCywF,bWdj2GDclj5ofokWjzoa5jAwMkxCykd6,22,86,48,38,22,9,39,0,242,34.57142857142857,10,0.0,11,48,36,22,75,9,2,39,0,117,125,0
1443,11350,OfMabADNCpK7MfQ7IaqBsUw8RvPeHL0S,G8EPVSXsOYB5YQWZGiz1aVq5Pgr2GrQu,1,0,0,0,0,0,1,0,1,0.14285714285714285,1,0.0,0,0,0,0,0,0,0,1,0,0,1,1
1444,11351,1YxknoiTrSwQgclDlSAh4oMYHRyARhLv,A3fsA9Zfv1X2fVEQhTw51lKENdNrEqT3,20,15,8,8,4,0,10,0,45,6.428571428571429,6,0.0,1,8,8,4,14,0,0,10,0,21,24,1
1445,11353,8OeiQbuEbEG2DSTpkZJyuKzc1PTNg0ge,SpATywNh6bZuzm8s1ceuBUnMUAeoAHHw,5,3,1,0,1,0,1,0,6,0.8571428571428571,1,0.0,0,1,0,1,3,0,0,1,0,2,4,1
1446,11366,GsMuFjXWxUh2UrLHKPEnIwFvWlVxAcB7,SpATywNh6bZuzm8s1ceuBUnMUAeoAHHw,7,5,3,0,2,0,2,0,12,1.7142857142857142,2,0.0,0,3,0,2,5,0,0,2,0,5,7,0
1447,11367,zEiNHlokNuJTLVoV4Hy4kJd9kzaIjztD,SpATywNh6bZuzm8s1ceuBUnMUAeoAHHw,30,42,20,20,9,1,9,0,101,14.428571428571429,7,0.0,6,20,16,9,36,1,4,9,0,51,50,0
1448,11369,7KNecsubFdywoFPLyTu2kgv5VbQekjao,SpATywNh6bZuzm8s1ceuBUnMUAeoAHHw,22,37,2,29,0,3,7,0,78,11.142857142857142,3,0.0,17,2,26,0,20,3,3,7,0,45,33,1
1449,11382,GDyZ2LKwtCChKfTbObuzefDdka9nIeiE,G8EPVSXsOYB5YQWZGiz1aVq5Pgr2GrQu,1,0,0,0,0,0,1,0,1,0.14285714285714285,1,0.0,0,0,0,0,0,0,0,1,0,0,1,1
1450,11384,U8CJ4eMAocRPzH9a3a2MJhXfikEQ51WM,bWdj2GDclj5ofokWjzoa5jAwMkxCykd6,5,2,1,0,1,0,2,0,6,0.8571428571428571,1,0.0,0,1,0,1,2,0,0,2,0,2,4,1
1451,11385,KKGY1xUUxKUn4nPRs2VmwvVd6JuyBBfA,SpATywNh6bZuzm8s1ceuBUnMUAeoAHHw,3,0,0,0,0,0,2,3,5,0.7142857142857143,1,0.0,0,0,0,0,0,0,0,2,3,0,5,1
1452,11387,8xe55v4hJPUrl0YZIl8G73vP4j2l4PsW,SpATywNh6bZuzm8s1ceuBUnMUAeoAHHw,31,33,9,37,3,0,7,0,89,12.714285714285714,4,0.0,11,9,29,3,22,0,8,7,0,52,37,0
1453,11393,D1fgtFfIsG1EcZQzDGeiCx6sI7k5ShWV,G8EPVSXsOYB5YQWZGiz1aVq5Pgr2GrQu,17,21,2,10,4,9,13,2,61,8.714285714285714,3,0.0,9,2,7,4,12,9,3,13,2,22,39,1
1454,11396,rYSxun4NgQnH8EYwHicH82Z91cblITe8,RXDvfPUBYFlVdlueBFbLW0mhhAyGEqpt,1,0,0,0,0,0,1,0,1,0.14285714285714285,1,0.0,0,0,0,0,0,0,0,1,0,0,1,1
1455,11406,rYSxun4NgQnH8EYwHicH82Z91cblITe8,G8EPVSXsOYB5YQWZGiz1aVq5Pgr2GrQu,1,0,0,0,0,0,1,0,1,0.14285714285714285,1,0.0,0,0,0,0,0,0,0,1,0,0,1,1
1456,11407,HYCkyEJhW9QtzilmanJKsxRLSBi9UGoV,RXDvfPUBYFlVdlueBFbLW0mhhAyGEqpt,1,0,0,0,0,0,1,0,1,0.14285714285714285,1,0.0,0,0,0,0,0,0,0,1,0,0,1,1
1457,11418,Km3IX0L3OZADSpnXU3tgLmBjn4mYhfRJ,SpATywNh6bZuzm8s1ceuBUnMUAeoAHHw,33,58,0,51,0,26,28,8,171,24.428571428571427,4,0.0,15,0,47,0,43,26,4,28,8,62,109,0
1458,11423,WeFVkkJO52wtRMBMdihRXPPKstU7E9sn,A3fsA9Zfv1X2fVEQhTw51lKENdNrEqT3,2,0,0,0,0,0,2,0,2,0.2857142857142857,1,0.0,0,0,0,0,0,0,0,2,0,0,2,1
1459,11430,7KNecsubFdywoFPLyTu2kgv5VbQekjao,RXDvfPUBYFlVdlueBFbLW0mhhAyGEqpt,12,13,1,0,1,0,3,0,18,2.5714285714285716,3,0.0,0,1,0,1,13,0,0,3,0,2,16,1
1460,11442,Sz8jNgPmKJ1IbqEEVQqTtQlVUDGarqh2,A3fsA9Zfv1X2fVEQhTw51lKENdNrEqT3,26,38,25,0,15,0,26,0,104,14.857142857142858,8,0.0,0,25,0,15,38,0,0,26,0,40,64,0
1461,11448,tLAxgBhXx0zpE8fWNnwggaJx5LeHI2h1,RXDvfPUBYFlVdlueBFbLW0mhhAyGEqpt,97,114,49,244,19,2,17,2,447,63.857142857142854,5,0.0,22,49,227,19,92,2,17,17,2,317,130,1
1462,11450,HnptwVrdWLkMWuHezQcYS6A0pyVov5BG,SpATywNh6bZuzm8s1ceuBUnMUAeoAHHw,47,77,44,68,17,23,27,7,263,37.57142857142857,8,0.0,20,44,55,17,57,23,13,27,7,136,127,0
1463,11454,G5viWFw6vjc0kZ7aRbev4NG1fp3ajLxi,A3fsA9Zfv1X2fVEQhTw51lKENdNrEqT3,17,13,10,0,9,0,2,0,34,4.857142857142857,3,0.0,0,10,0,9,13,0,0,2,0,19,15,1
1464,11455,5ObfmFiTeuGjRWtYuJy4iGiMBZ3jgU0e,SpATywNh6bZuzm8s1ceuBUnMUAeoAHHw,15,28,15,16,10,0,3,0,72,10.285714285714286,4,0.0,8,15,14,10,20,0,2,3,0,47,25,1
1465,11456,CWDKRVVm01sfgssULmzIPwx9dbULLbqB,A3fsA9Zfv1X2fVEQhTw51lKENdNrEqT3,162,128,98,454,70,19,19,0,788,112.57142857142857,9,0.0,5,98,389,70,123,19,65,19,0,562,226,0
1466,11461,cW0TF0QgesgeR4yvyFNeSG2Tsy7pGtpm,A3fsA9Zfv1X2fVEQhTw51lKENdNrEqT3,49,78,17,84,11,9,24,1,224,32.0,6,0.0,4,17,65,11,74,9,19,24,1,97,127,1
1467,11472,mN4qYBgpy4Qxh2rSlBkY5ZDyLEZtAHu9,RXDvfPUBYFlVdlueBFbLW0mhhAyGEqpt,57,43,26,82,15,30,11,10,217,31.0,5,0.0,11,26,80,15,32,30,2,11,10,132,85,1
1468,11483,fG7nauhHd6Hp0Y6uPPSQifF45RcZ5wiO,SpATywNh6bZuzm8s1ceuBUnMUAeoAHHw,16,23,3,17,0,1,4,0,48,6.857142857142857,3,0.0,5,3,14,0,18,1,3,4,0,22,26,1
1469,11490,mDEirND7nLzt2vy8e34SZhdfEbglxCWs,SpATywNh6bZuzm8s1ceuBUnMUAeoAHHw,32,87,24,28,12,20,21,1,193,27.571428571428573,6,0.0,21,24,22,12,66,20,6,21,1,79,114,0
1470,11494,nBVpguvJeCUz3AWDoX9CCNT2qyeZb33T,G8EPVSXsOYB5YQWZGiz1aVq5Pgr2GrQu,42,94,63,84,1,8,13,0,263,37.57142857142857,7,0.0,14,63,67,1,80,8,17,13,0,145,118,0
1471,11497,tfkukKUMRkePYIfP864uQoXVHWicLcZ3,A3fsA9Zfv1X2fVEQhTw51lKENdNrEqT3,13,23,12,0,5,0,9,0,49,7.0,2,0.0,1,12,0,5,22,0,0,9,0,18,31,1
1472,11511,zNxhmmLWnSaIABuhKypYetmsDg2VcOK8,SpATywNh6bZuzm8s1ceuBUnMUAeoAHHw,14,12,6,11,5,1,3,0,38,5.428571428571429,3,0.0,4,6,11,5,8,1,0,3,0,26,12,1
1473,11516,aSlIMkfly6xTMJCGTWDQcnFZjajcWM6y,RXDvfPUBYFlVdlueBFbLW0mhhAyGEqpt,25,46,6,0,6,4,8,0,70,10.0,8,0.0,4,6,0,6,42,4,0,8,0,16,54,0
1474,11541,vIBcYbs1BLdmaaP30fcE2FS7kB7v7QRn,A3fsA9Zfv1X2fVEQhTw51lKENdNrEqT3,7,23,11,0,1,0,14,0,49,7.0,9,0.0,0,11,0,1,23,0,0,14,0,12,37,1
1475,11546,9PS6Icub6VXkyVUcoskrzajETE7Qoarh,SpATywNh6bZuzm8s1ceuBUnMUAeoAHHw,41,87,35,75,14,6,15,0,232,33.142857142857146,7,0.0,37,35,66,14,50,6,9,15,0,152,80,0
1476,11556,pplAmbuLk2c8g7K4eYBlhKFfYSpZgbNo,SpATywNh6bZuzm8s1ceuBUnMUAeoAHHw,20,39,4,10,1,0,19,1,74,10.571428571428571,6,0.0,6,4,8,1,33,0,2,19,1,19,55,0
1477,11557,mtYhUCuiqvMc7E9n6ZRYWej43jynHbMu,SpATywNh6bZuzm8s1ceuBUnMUAeoAHHw,14,18,12,10,8,0,4,0,52,7.428571428571429,2,0.0,1,12,9,8,17,0,1,4,0,30,22,1
1478,11564,ZPbUovw1YoDeaWUVrbGEj5A5WdIXTYjf,SpATywNh6bZuzm8s1ceuBUnMUAeoAHHw,9,25,9,0,4,0,2,0,40,5.714285714285714,2,0.0,11,9,0,4,14,0,0,2,0,24,16,1
1479,11568,l1IK9ZY8MbRv8UoeCkxEH7P4W2dtATGX,SpATywNh6bZuzm8s1ceuBUnMUAeoAHHw,46,69,10,38,5,1,18,1,142,20.285714285714285,12,0.0,11,10,38,5,58,1,0,18,1,64,78,0
1480,11574,ypwDBeQLkxtWilMLhemtoXkZG88PSCik,SpATywNh6bZuzm8s1ceuBUnMUAeoAHHw,32,213,98,0,1,1,18,1,332,47.42857142857143,22,0.0,23,98,0,1,190,1,0,18,1,122,210,0
1481,11576,GKKNtfrAHKD2xUEQBz7HLN3kKO9SrWyD,SpATywNh6bZuzm8s1ceuBUnMUAeoAHHw,18,80,44,12,11,42,46,3,238,34.0,6,0.0,10,44,9,11,70,42,3,46,3,74,164,0
1482,11579,MgYx3sTen8piVhQ0ZPLZ6p6e7rh59bPE,SpATywNh6bZuzm8s1ceuBUnMUAeoAHHw,11,18,0,8,0,0,7,0,33,4.714285714285714,2,0.0,5,0,7,0,13,0,1,7,0,12,21,1
1483,11581,PXjkYsNMSYVKdz07qjMtS6mMBWIuSmKF,bWdj2GDclj5ofokWjzoa5jAwMkxCykd6,7,22,3,0,0,1,14,3,43,6.142857142857143,5,0.0,2,3,0,0,20,1,0,14,3,5,38,1
1484,11586,GIK69AVoFAXQo5stVHHEqOqo5xlrkSOx,SpATywNh6bZuzm8s1ceuBUnMUAeoAHHw,49,121,11,43,6,86,106,10,383,54.714285714285715,25,0.0,30,11,39,6,91,86,4,106,10,86,297,0
1485,11591,nlq4r6xc3rTUqTwcYhL6wudXdN6RIE52,A3fsA9Zfv1X2fVEQhTw51lKENdNrEqT3,76,65,52,0,35,0,15,0,167,23.857142857142858,7,0.0,0,52,0,35,65,0,0,15,0,87,80,0
1486,11593,wmwDf7eIRrKPL0l8cNmMygnEPd5vzoqs,SpATywNh6bZuzm8s1ceuBUnMUAeoAHHw,31,74,14,14,6,1,13,1,123,17.571428571428573,8,0.0,23,14,14,6,51,1,0,13,1,57,66,0
1487,11596,2AeMxbMeXomHZjSsEj2bsr8PzPP1Dh6q,bWdj2GDclj5ofokWjzoa5jAwMkxCykd6,16,46,21,32,5,12,21,2,139,19.857142857142858,2,0.0,12,21,30,5,34,12,2,21,2,68,71,1
1488,11599,GD5KzWMBHDnHVJHzVFtf3u7bIC7XYtJH,SpATywNh6bZuzm8s1ceuBUnMUAeoAHHw,35,120,2,60,1,3,56,1,243,34.714285714285715,15,0.0,19,2,45,1,101,3,15,56,1,67,176,0
1489,11600,IroEtJPlvjKfczRi5laeb2DQegyNKOWM,SpATywNh6bZuzm8s1ceuBUnMUAeoAHHw,17,23,13,10,6,7,5,0,64,9.142857142857142,2,0.0,6,13,8,6,17,7,2,5,0,33,31,0
1490,11603,wrdkNhe8GmpsjdZUr22H6zTi43mdouZW,SpATywNh6bZuzm8s1ceuBUnMUAeoAHHw,26,40,3,26,3,0,10,0,82,11.714285714285714,3,0.0,5,3,23,3,35,0,3,10,0,34,48,1
1491,11606,nNXCDU7pCvXdQPycxWESwEGIIRWvHKWv,A3fsA9Zfv1X2fVEQhTw51lKENdNrEqT3,1,0,0,0,0,0,1,0,1,0.14285714285714285,1,0.0,0,0,0,0,0,0,0,1,0,0,1,1
1492,11607,nNXCDU7pCvXdQPycxWESwEGIIRWvHKWv,bWdj2GDclj5ofokWjzoa5jAwMkxCykd6,6,13,3,0,2,14,3,1,36,5.142857142857143,1,0.0,0,3,0,2,13,14,0,3,1,5,31,1
1493,11609,lk3lGbNCFxoPG1OVILbfGp3s2wN91K2M,SpATywNh6bZuzm8s1ceuBUnMUAeoAHHw,5,9,1,0,0,0,1,0,11,1.5714285714285714,2,0.0,0,1,0,0,9,0,0,1,0,1,10,1
1494,11624,Kw83ufYGIFIihz0PdiaJro4hz0pKGozQ,SpATywNh6bZuzm8s1ceuBUnMUAeoAHHw,21,24,1,24,1,0,6,0,56,8.0,5,0.0,4,1,20,1,20,0,4,6,0,26,30,1
1495,11628,BHczT02DEALJmy7zbrGU6QbzLcOGM0Lz,SpATywNh6bZuzm8s1ceuBUnMUAeoAHHw,36,77,5,16,6,5,19,4,132,18.857142857142858,8,0.0,11,5,15,6,66,5,1,19,4,37,95,0
1496,11630,MR4k3wv95Ttq1fQaT9W4WgxrPezl0N4j,SpATywNh6bZuzm8s1ceuBUnMUAeoAHHw,5,3,1,0,1,0,4,0,9,1.2857142857142858,1,0.0,0,1,0,1,3,0,0,4,0,2,7,1
1497,11637,glYOnGBygagQ3d4VwvOcHKnCEWLKXuzk,SpATywNh6bZuzm8s1ceuBUnMUAeoAHHw,36,126,15,28,8,10,32,1,220,31.428571428571427,10,0.0,39,15,26,8,87,10,2,32,1,88,132,0
1498,11641,WHRYwHaNw8C182lJomkvSukjZ7e91Upo,SpATywNh6bZuzm8s1ceuBUnMUAeoAHHw,30,38,24,25,9,26,11,2,135,19.285714285714285,2,0.0,10,24,19,9,28,26,6,11,2,62,73,1
1499,11650,ilWzYGLWBh9DSc1MV8g2C4Go5wDNgUHX,SpATywNh6bZuzm8s1ceuBUnMUAeoAHHw,43,58,34,35,9,12,11,0,159,22.714285714285715,9,0.0,16,34,29,9,42,12,6,11,0,88,71,0
1500,11651,tnLfm9tutF6YoqDXNIONCmii1aynBy80,G8EPVSXsOYB5YQWZGiz1aVq5Pgr2GrQu,60,130,55,126,18,57,50,1,437,62.42857142857143,12,0.0,24,55,104,18,106,57,22,50,1,201,236,0
1501,11653,WHRYwHaNw8C182lJomkvSukjZ7e91Upo,G8EPVSXsOYB5YQWZGiz1aVq5Pgr2GrQu,64,72,24,130,14,27,14,2,283,40.42857142857143,5,0.0,40,24,88,14,32,27,42,14,2,166,117,1
1502,11668,3D1G3v8o9ZJD4YifQcvj5oZ6l4EKMMc3,SpATywNh6bZuzm8s1ceuBUnMUAeoAHHw,47,81,26,49,12,13,21,0,202,28.857142857142858,8,0.0,32,26,45,12,49,13,4,21,0,115,87,0
1503,11670,LJnHkVr961LFlbm7Gjo7zRYOv6MZ6dE5,bWdj2GDclj5ofokWjzoa5jAwMkxCykd6,6,4,2,0,1,0,4,0,11,1.5714285714285714,1,0.0,0,2,0,1,4,0,0,4,0,3,8,1
1504,11682,VLIaJAnZiJEAdolQsQ0bq4zJoZaIUmTN,SpATywNh6bZuzm8s1ceuBUnMUAeoAHHw,9,11,2,0,2,0,11,0,26,3.7142857142857144,3,0.0,0,2,0,2,11,0,0,11,0,4,22,1
1505,11688,QyLVPf4M60EkZ1E7DsOzioCPS0UDQt1T,SpATywNh6bZuzm8s1ceuBUnMUAeoAHHw,13,17,1,12,1,2,11,0,44,6.285714285714286,4,0.0,0,1,10,1,17,2,2,11,0,12,32,1
1506,11692,relWJA0qYE5Pue4C6aAwg584OGIxhwwx,A3fsA9Zfv1X2fVEQhTw51lKENdNrEqT3,1,0,0,0,0,0,2,0,2,0.2857142857142857,2,0.0,0,0,0,0,0,0,0,2,0,0,2,1
1507,11698,kVkYStq5954wY9YqVoootgnbo59g0CLi,SpATywNh6bZuzm8s1ceuBUnMUAeoAHHw,4,2,0,0,0,0,2,0,4,0.5714285714285714,1,0.0,0,0,0,0,2,0,0,2,0,0,4,1
1508,11699,fJdUKH8czX92V7yfMeG7e087z1xbQDMc,SpATywNh6bZuzm8s1ceuBUnMUAeoAHHw,59,52,35,28,20,3,11,0,149,21.285714285714285,6,0.0,11,35,27,20,41,3,1,11,0,93,56,0
1509,11704,DVIil2NM7ZWOtqe6rhlMzwEUAb2wuaeh,SpATywNh6bZuzm8s1ceuBUnMUAeoAHHw,21,52,26,6,7,11,13,1,116,16.571428571428573,6,0.0,10,26,6,7,42,11,0,13,1,49,67,1
1510,11719,cr12tMBqYKzLJbEmIsyFvFLKAg0DiCbM,SpATywNh6bZuzm8s1ceuBUnMUAeoAHHw,29,60,23,16,12,0,10,0,121,17.285714285714285,8,0.0,10,23,15,12,50,0,1,10,0,60,61,0
1511,11732,6L205IIarnrBFjrCXSXMQhtSJJ5O5hiQ,SpATywNh6bZuzm8s1ceuBUnMUAeoAHHw,48,178,95,53,43,13,32,18,432,61.714285714285715,5,0.0,51,95,44,43,127,13,9,32,18,233,199,0
1512,11737,vn3szbx80pQPfVJU7Et6YnUzTgKJ2evQ,A3fsA9Zfv1X2fVEQhTw51lKENdNrEqT3,8,3,2,0,2,0,5,0,12,1.7142857142857142,2,0.0,0,2,0,2,3,0,0,5,0,4,8,1
1513,11743,relWJA0qYE5Pue4C6aAwg584OGIxhwwx,SpATywNh6bZuzm8s1ceuBUnMUAeoAHHw,1,0,0,0,0,0,1,0,1,0.14285714285714285,1,0.0,0,0,0,0,0,0,0,1,0,0,1,1
1514,11765,CF9EOBndFkwfNq6XdrlnJGwplvjOhGZh,SpATywNh6bZuzm8s1ceuBUnMUAeoAHHw,34,94,4,51,0,76,21,0,246,35.142857142857146,5,0.0,41,4,47,0,53,76,4,21,0,92,154,0
1515,11773,gxkoHTlKe7FVuciB5TU7TNQLS1IuXLYY,SpATywNh6bZuzm8s1ceuBUnMUAeoAHHw,43,74,18,40,10,19,16,1,178,25.428571428571427,12,0.0,18,18,34,10,56,19,6,16,1,80,98,1
1516,11782,twnWF0mfZYHjmoqBvUs9g7jWpDxNR6WV,SpATywNh6bZuzm8s1ceuBUnMUAeoAHHw,38,72,28,24,8,17,19,1,169,24.142857142857142,5,0.0,37,28,22,8,35,17,2,19,1,95,74,1
1517,11795,iQzwToywLVi52lg7X1CKAqUmrJweCbY4,A3fsA9Zfv1X2fVEQhTw51lKENdNrEqT3,2,0,0,0,0,0,4,0,4,0.5714285714285714,1,0.0,0,0,0,0,0,0,0,4,0,0,4,1
1518,11796,5Pn4uvjsBWdhF0lVc4LtU6HIHnySgqaU,SpATywNh6bZuzm8s1ceuBUnMUAeoAHHw,1,0,0,0,0,0,1,0,1,0.14285714285714285,1,0.0,0,0,0,0,0,0,0,1,0,0,1,1
1519,11797,ejIJpZTu0P4rcWcZmBKl6OiURGceVpiA,SpATywNh6bZuzm8s1ceuBUnMUAeoAHHw,41,71,36,25,13,3,20,0,168,24.0,11,0.0,13,36,24,13,58,3,1,20,0,86,82,0
1520,11803,jpgFrFPODuxdIxVKUbbelvbFMPtUp7jo,SpATywNh6bZuzm8s1ceuBUnMUAeoAHHw,63,84,44,37,25,37,30,1,258,36.857142857142854,10,0.0,26,44,33,25,58,37,4,30,1,128,130,0
1521,11822,neCsLgPwvO3NM22QUF7ePoDh9jooDB1R,G8EPVSXsOYB5YQWZGiz1aVq5Pgr2GrQu,21,34,5,8,4,5,16,1,73,10.428571428571429,6,0.0,5,5,7,4,29,5,1,16,1,21,52,0
1522,11830,OJNek1dgn6lYb4ldZM3hUDbtlOcoRdmG,SpATywNh6bZuzm8s1ceuBUnMUAeoAHHw,14,11,7,11,5,0,3,0,37,5.285714285714286,2,0.0,2,7,10,5,9,0,1,3,0,24,13,0
1523,11866,0Ycdp4l6pgMwD7gJz4jynSnW5FA5aOcj,RXDvfPUBYFlVdlueBFbLW0mhhAyGEqpt,45,70,42,85,24,4,18,4,247,35.285714285714285,3,0.0,18,42,81,24,52,4,4,18,4,165,82,0
1524,11868,grkG64gC1ukbqi3lu9n1P24tGPzF2BzQ,SpATywNh6bZuzm8s1ceuBUnMUAeoAHHw,53,94,62,24,31,20,24,0,255,36.42857142857143,9,0.0,15,62,21,31,79,20,3,24,0,129,126,0
1525,11873,CLsYy7g1hYWHJyj1aROfKK9oTeo5yxJx,SpATywNh6bZuzm8s1ceuBUnMUAeoAHHw,56,65,33,36,18,27,20,1,200,28.571428571428573,8,0.0,18,33,32,18,47,27,4,20,1,101,99,0
1526,11875,s1zoJG6TsTv8LP9PRWCYbeiv4OLIivpy,SpATywNh6bZuzm8s1ceuBUnMUAeoAHHw,36,42,30,0,20,0,11,0,103,14.714285714285714,8,0.0,1,30,0,20,41,0,0,11,0,51,52,0
1527,11882,x5ZyS8ChPKTwgxrKWhGeApVsRxKYNf86,SpATywNh6bZuzm8s1ceuBUnMUAeoAHHw,18,27,0,12,1,2,10,0,52,7.428571428571429,2,0.0,14,0,9,1,13,2,3,10,0,24,28,1
1528,11885,5Yc9dIv7921c7z5p5LW8t3x8iddn1yRC,SpATywNh6bZuzm8s1ceuBUnMUAeoAHHw,30,81,23,35,10,5,20,1,175,25.0,3,0.0,19,23,33,10,62,5,2,20,1,85,90,1
1529,11891,BeyfLbwb8pdDQU6WTI5ee3FkxRPRP7B2,A3fsA9Zfv1X2fVEQhTw51lKENdNrEqT3,8,7,4,0,2,0,5,0,18,2.5714285714285716,3,0.0,0,4,0,2,7,0,0,5,0,6,12,1
1530,11898,pSPFAE8vJ6UClRkBsZEyTga6sVysOokX,SpATywNh6bZuzm8s1ceuBUnMUAeoAHHw,1,0,0,0,0,0,1,0,1,0.14285714285714285,1,0.0,0,0,0,0,0,0,0,1,0,0,1,1
1531,11909,Hh6CQ9eQF89j5a5Oi2NUf2uAs2DZd4QT,A3fsA9Zfv1X2fVEQhTw51lKENdNrEqT3,56,104,68,102,22,131,44,3,474,67.71428571428571,14,0.0,2,68,79,22,102,131,23,44,3,171,303,1
1532,11912,5FSqkpRO54sosmyXXDdXixBIUlxd8QNQ,SpATywNh6bZuzm8s1ceuBUnMUAeoAHHw,39,98,57,45,24,1,30,1,256,36.57142857142857,12,0.0,8,57,37,24,90,1,8,30,1,126,130,0
1533,11928,syrttArug8Mpzs9L0IHsvBtATawYF9J2,A3fsA9Zfv1X2fVEQhTw51lKENdNrEqT3,54,29,15,118,3,1,17,0,183,26.142857142857142,7,0.0,4,15,103,3,25,1,15,17,0,125,58,0
1534,11933,OmF4aFe06TkjIpsTgGpQ4vBzMWi2jjQV,bWdj2GDclj5ofokWjzoa5jAwMkxCykd6,52,49,25,146,13,0,30,1,264,37.714285714285715,7,0.0,11,25,120,13,38,0,26,30,1,169,95,0
1535,11955,oyFfPK6y9oPPwQR5mbsXW98FJaEnU88b,SpATywNh6bZuzm8s1ceuBUnMUAeoAHHw,15,27,11,16,7,2,6,0,69,9.857142857142858,4,0.0,10,11,15,7,17,2,1,6,0,43,26,1
1536,11958,HG2MGN3erjLUr4zPCv4UJukzIqIJPVZ2,SpATywNh6bZuzm8s1ceuBUnMUAeoAHHw,46,62,33,54,14,56,21,1,241,34.42857142857143,6,0.0,17,33,45,14,45,56,9,21,1,109,132,1
1537,11969,RhMByUF03fgdIuaHANL6m20mbMakGgJs,SpATywNh6bZuzm8s1ceuBUnMUAeoAHHw,23,61,32,0,13,0,11,0,117,16.714285714285715,7,0.0,5,32,0,13,56,0,0,11,0,50,67,0
1538,11975,MAjx1xtQvL5ZiofHx4xuO3WtfmkLHjqM,SpATywNh6bZuzm8s1ceuBUnMUAeoAHHw,21,26,16,0,11,1,5,0,59,8.428571428571429,4,0.0,3,16,0,11,23,1,0,5,0,30,29,1
1539,11981,FZjjoikxEifQwEx2vf6LYlhg4yyTwbym,A3fsA9Zfv1X2fVEQhTw51lKENdNrEqT3,34,62,30,24,14,34,32,0,196,28.0,9,0.0,5,30,19,14,57,34,5,32,0,68,128,1
1540,11982,BA5BMBRmhCtFQyjTLAMMLlVS5ABrW2hi,SpATywNh6bZuzm8s1ceuBUnMUAeoAHHw,22,28,12,24,5,4,8,1,82,11.714285714285714,4,0.0,7,12,20,5,21,4,4,8,1,44,38,0
1541,11998,NHPpKvbnrSpxM8e1DORBWJbRCpmrxZw8,SpATywNh6bZuzm8s1ceuBUnMUAeoAHHw,61,84,45,51,21,13,23,0,237,33.857142857142854,8,0.0,27,45,39,21,57,13,12,23,0,132,105,0
1542,12000,tncBhgwJEnaybUdK2e3UQ2PdOl85hyHm,SpATywNh6bZuzm8s1ceuBUnMUAeoAHHw,30,58,21,41,9,20,11,2,162,23.142857142857142,3,0.0,29,21,35,9,29,20,6,11,2,94,68,0
1543,12016,matrDCCbXVpxlcX50EwFfEaLRW1d7v0q,SpATywNh6bZuzm8s1ceuBUnMUAeoAHHw,9,13,3,0,1,1,6,0,24,3.4285714285714284,3,0.0,0,3,0,1,13,1,0,6,0,4,20,1
1544,12019,UaSh8dwx8gnofYbXlmpqj9uYDbpJ89pX,bWdj2GDclj5ofokWjzoa5jAwMkxCykd6,36,138,27,170,13,111,54,1,514,73.42857142857143,16,0.0,25,27,159,13,113,111,11,54,1,224,290,0
1545,12022,wHhHCETlsngCbxRgyphDRhWNDaw9hkb5,bWdj2GDclj5ofokWjzoa5jAwMkxCykd6,7,18,1,30,2,0,1,0,52,7.428571428571429,1,0.0,13,1,29,2,5,0,1,1,0,45,7,1
1546,12028,TnWxqbrMUttPbRmFwVduGXC6tM50wXNs,G8EPVSXsOYB5YQWZGiz1aVq5Pgr2GrQu,17,8,6,16,3,0,7,1,41,5.857142857142857,2,0.0,0,6,13,3,8,0,3,7,1,22,19,1
1547,12029,yj09XjzxRqPWNB0AOEufH55lHRijrBGr,A3fsA9Zfv1X2fVEQhTw51lKENdNrEqT3,11,7,3,0,3,0,6,0,19,2.7142857142857144,1,0.0,0,3,0,3,7,0,0,6,0,6,13,1
1548,12051,ECki0IXplihhOXFtHwNEOZv3lgdNQeLX,bWdj2GDclj5ofokWjzoa5jAwMkxCykd6,8,7,4,0,2,1,7,1,22,3.142857142857143,2,0.0,0,4,0,2,7,1,0,7,1,6,16,1
1549,12052,g3902agYIRHzac78MKVZlvljLMXXNpQ7,SpATywNh6bZuzm8s1ceuBUnMUAeoAHHw,60,95,58,52,25,1,36,0,267,38.142857142857146,13,0.0,17,58,47,25,78,1,5,36,0,147,120,0
1550,12058,iPBAJ9CVDCVYdsrujNIhJfrUSnaDCIHG,bWdj2GDclj5ofokWjzoa5jAwMkxCykd6,6,6,2,0,2,0,4,0,14,2.0,2,0.0,1,2,0,2,5,0,0,4,0,5,9,1
1551,12071,aeavxOLfuZgcJqnNwarxFiMVjjeJZrPA,SpATywNh6bZuzm8s1ceuBUnMUAeoAHHw,5,3,1,0,1,0,2,0,7,1.0,1,0.0,0,1,0,1,3,0,0,2,0,2,5,1
1552,12079,ZpZGRrq9otivAzXqSjL90NMLUImGmxsg,SpATywNh6bZuzm8s1ceuBUnMUAeoAHHw,6,7,1,0,0,0,2,0,10,1.4285714285714286,2,0.0,0,1,0,0,7,0,0,2,0,1,9,1
1553,12082,QWRabGXxCqME5Lkb4IAANkZxIcelEiGP,bWdj2GDclj5ofokWjzoa5jAwMkxCykd6,1,0,0,0,0,0,2,0,2,0.2857142857142857,1,0.0,0,0,0,0,0,0,0,2,0,0,2,1
1554,12083,U0kf3qSBRgyWv3qqGgGYInyPjg6gK9O9,RXDvfPUBYFlVdlueBFbLW0mhhAyGEqpt,1,0,0,0,0,0,1,0,1,0.14285714285714285,1,0.0,0,0,0,0,0,0,0,1,0,0,1,1
1555,12088,7yMNJWNsXgPHWgF0rje4LKKgdLbyOw5Y,A3fsA9Zfv1X2fVEQhTw51lKENdNrEqT3,4,3,2,0,0,0,1,0,6,0.8571428571428571,1,0.0,0,2,0,0,3,0,0,1,0,2,4,1
1556,12097,LclkEDGY7WCR76zraNkzkcQywMJivp2l,SpATywNh6bZuzm8s1ceuBUnMUAeoAHHw,31,93,29,42,19,6,20,2,211,30.142857142857142,5,0.0,25,29,36,19,68,6,6,20,2,109,102,1
1557,12100,tCXa4pMsMXRuliZWNM9so3Odte6UmpYj,A3fsA9Zfv1X2fVEQhTw51lKENdNrEqT3,1,0,0,0,0,0,1,0,1,0.14285714285714285,1,0.0,0,0,0,0,0,0,0,1,0,0,1,1
1558,12111,1GWkEwQ90VRdtDsFxjla0MbrnOSbAEId,RXDvfPUBYFlVdlueBFbLW0mhhAyGEqpt,4,2,0,0,0,0,2,0,4,0.5714285714285714,1,0.0,0,0,0,0,2,0,0,2,0,0,4,1
1559,12119,x0VzAeYdlywtGLqE1HF68qQMYZTLfsw9,A3fsA9Zfv1X2fVEQhTw51lKENdNrEqT3,70,66,46,124,16,7,20,0,279,39.857142857142854,10,0.0,4,46,114,16,62,7,10,20,0,180,99,1
1560,12126,32uJBAomTJQIXKZnCX4K7PYoVfESGbct,RXDvfPUBYFlVdlueBFbLW0mhhAyGEqpt,63,94,51,120,35,0,9,0,309,44.142857142857146,6,0.0,29,51,111,35,65,0,9,9,0,226,83,1
1561,12127,HElrq1eSGzBafUMUdvN7RCubKET34OTX,SpATywNh6bZuzm8s1ceuBUnMUAeoAHHw,1,0,0,0,0,0,1,0,1,0.14285714285714285,1,0.0,0,0,0,0,0,0,0,1,0,0,1,1
1562,12137,jkbAnCxwl3OIEg7uH62X9N4RjNwDvZxg,SpATywNh6bZuzm8s1ceuBUnMUAeoAHHw,21,36,15,0,10,0,8,0,69,9.857142857142858,7,0.0,5,15,0,10,31,0,0,8,0,30,39,1
1563,12139,i8WIZSEgsoHBi5QZhvayPbZQldL0txWw,A3fsA9Zfv1X2fVEQhTw51lKENdNrEqT3,7,3,2,0,2,0,3,0,10,1.4285714285714286,1,0.0,0,2,0,2,3,0,0,3,0,4,6,1
1564,12144,4JPTMOEW3QvxnvFVxcqBPUVqTDTMZIow,SpATywNh6bZuzm8s1ceuBUnMUAeoAHHw,1,0,0,0,0,0,2,0,2,0.2857142857142857,1,0.0,0,0,0,0,0,0,0,2,0,0,2,1
1565,12166,x6CSpC8D3vQdEDfFDD93c2HvZ1J8Rtto,RXDvfPUBYFlVdlueBFbLW0mhhAyGEqpt,67,90,59,124,21,31,11,0,336,48.0,4,0.0,20,59,112,21,70,31,12,11,0,212,124,1
1566,12171,eAArxLyCThtu9N3Mv8rQculKbGSa66j9,SpATywNh6bZuzm8s1ceuBUnMUAeoAHHw,10,12,8,0,2,9,12,0,43,6.142857142857143,6,0.0,0,8,0,2,12,9,0,12,0,10,33,1
1567,12182,rdSWxFhXxAq7LLsaFRDkga5HDqBXvg9z,bWdj2GDclj5ofokWjzoa5jAwMkxCykd6,2,0,0,0,0,0,2,0,2,0.2857142857142857,1,0.0,0,0,0,0,0,0,0,2,0,0,2,1
1568,12193,ajHCgh5jQq7dgoaNHY1H5hSSSFewTHW9,A3fsA9Zfv1X2fVEQhTw51lKENdNrEqT3,2,0,0,0,0,0,2,0,2,0.2857142857142857,1,0.0,0,0,0,0,0,0,0,2,0,0,2,1
1569,12197,RPansaKc9yPYyKahcqLAJO6a0GoBHglr,SpATywNh6bZuzm8s1ceuBUnMUAeoAHHw,61,116,69,34,40,20,37,1,317,45.285714285714285,14,0.0,19,69,33,40,97,20,1,37,1,161,156,0
1570,12202,rdSWxFhXxAq7LLsaFRDkga5HDqBXvg9z,A3fsA9Zfv1X2fVEQhTw51lKENdNrEqT3,7,5,1,0,1,0,2,0,9,1.2857142857142858,1,0.0,0,1,0,1,5,0,0,2,0,2,7,1
1571,12212,KXPHZfgM3L9NmmWzrburRZrpNwRct3s8,SpATywNh6bZuzm8s1ceuBUnMUAeoAHHw,32,57,26,43,8,13,24,2,173,24.714285714285715,6,0.0,22,26,37,8,35,13,6,24,2,93,80,1
1572,12220,9b4Qm8eSvDuZev1N90TcJBdVRXi0Jx1k,SpATywNh6bZuzm8s1ceuBUnMUAeoAHHw,25,26,2,39,1,5,9,1,83,11.857142857142858,3,0.0,10,2,33,1,16,5,6,9,1,46,37,1
1573,12255,lCVPDaggOlwGJsnAJvi5aMCj1weM2Pue,SpATywNh6bZuzm8s1ceuBUnMUAeoAHHw,6,3,2,0,2,0,1,0,8,1.1428571428571428,1,0.0,0,2,0,2,3,0,0,1,0,4,4,1
1574,12257,Htb70W0lnqw4QeBjeePevzE0xRg4O6vF,A3fsA9Zfv1X2fVEQhTw51lKENdNrEqT3,12,11,10,0,0,1,4,0,26,3.7142857142857144,1,0.0,0,10,0,0,11,1,0,4,0,10,16,1
1575,12258,Htb70W0lnqw4QeBjeePevzE0xRg4O6vF,bWdj2GDclj5ofokWjzoa5jAwMkxCykd6,1,0,0,0,0,0,2,0,2,0.2857142857142857,1,0.0,0,0,0,0,0,0,0,2,0,0,2,1
1576,12270,mccn7oMsSoLGVTk06xkhM1ICp7gdLXuk,SpATywNh6bZuzm8s1ceuBUnMUAeoAHHw,20,35,17,19,6,2,13,1,93,13.285714285714286,4,0.0,12,17,16,6,23,2,3,13,1,51,42,1
1577,12276,lCVPDaggOlwGJsnAJvi5aMCj1weM2Pue,A3fsA9Zfv1X2fVEQhTw51lKENdNrEqT3,4,2,1,0,1,0,1,0,5,0.7142857142857143,1,0.0,0,1,0,1,2,0,0,1,0,2,3,1
1578,12281,lCVPDaggOlwGJsnAJvi5aMCj1weM2Pue,bWdj2GDclj5ofokWjzoa5jAwMkxCykd6,6,6,1,0,1,0,2,0,10,1.4285714285714286,1,0.0,0,1,0,1,6,0,0,2,0,2,8,1
1579,12289,j3c6K94i9dgmcXc2NErAuVxnWFJZj8tT,bWdj2GDclj5ofokWjzoa5jAwMkxCykd6,7,4,3,0,2,0,2,0,11,1.5714285714285714,2,0.0,0,3,0,2,4,0,0,2,0,5,6,1
1580,12299,fa6SZdwIb8QmMO5YcB5PQzrN75peDxq7,G8EPVSXsOYB5YQWZGiz1aVq5Pgr2GrQu,9,7,5,0,2,0,5,0,19,2.7142857142857144,2,0.0,0,5,0,2,7,0,0,5,0,7,12,1
1581,12301,OeLBIzS0gNQ56euxy5b66gAZMzQCGE7n,bWdj2GDclj5ofokWjzoa5jAwMkxCykd6,1,0,0,0,0,0,1,0,1,0.14285714285714285,1,0.0,0,0,0,0,0,0,0,1,0,0,1,1
1582,12308,CQOn4KWCA0duDCOSP1DQzvXZ3yAfq1zW,SpATywNh6bZuzm8s1ceuBUnMUAeoAHHw,33,69,41,40,12,35,27,1,225,32.142857142857146,11,0.0,14,41,34,12,55,35,6,27,1,101,124,0
1583,12317,niLMw8MCObO7SSR2V1jNg9WQt5oSjDFJ,A3fsA9Zfv1X2fVEQhTw51lKENdNrEqT3,14,12,7,0,5,0,4,0,28,4.0,3,0.0,0,7,0,5,12,0,0,4,0,12,16,1
1584,12320,niLMw8MCObO7SSR2V1jNg9WQt5oSjDFJ,SpATywNh6bZuzm8s1ceuBUnMUAeoAHHw,9,14,7,0,3,0,7,0,31,4.428571428571429,4,0.0,2,7,0,3,12,0,0,7,0,12,19,1
1585,12321,g3902agYIRHzac78MKVZlvljLMXXNpQ7,A3fsA9Zfv1X2fVEQhTw51lKENdNrEqT3,25,20,14,0,8,2,23,2,69,9.857142857142858,6,0.0,0,14,0,8,20,2,0,23,2,22,47,1
1586,12323,dceX0m9075YvlWaEabJwd03DyXl3MtL8,SpATywNh6bZuzm8s1ceuBUnMUAeoAHHw,27,60,20,27,3,1,18,3,132,18.857142857142858,8,0.0,26,20,24,3,34,1,3,18,3,73,59,0
1587,12328,lCVPDaggOlwGJsnAJvi5aMCj1weM2Pue,RXDvfPUBYFlVdlueBFbLW0mhhAyGEqpt,7,5,4,0,1,0,1,0,11,1.5714285714285714,1,0.0,0,4,0,1,5,0,0,1,0,5,6,1
1588,12332,ncwdVeNEm9rMUWWKD40nNQFCSGSrd8Qu,SpATywNh6bZuzm8s1ceuBUnMUAeoAHHw,1,0,0,0,0,0,1,0,1,0.14285714285714285,1,0.0,0,0,0,0,0,0,0,1,0,0,1,1
1589,12333,8V1FCzMo3zMKQW1ts44FS8gSim8xyz9W,G8EPVSXsOYB5YQWZGiz1aVq5Pgr2GrQu,4,2,1,0,1,0,1,0,5,0.7142857142857143,1,0.0,0,1,0,1,2,0,0,1,0,2,3,1
1590,12348,ZhTCqX8GMUcn0a0betuEauHNuCk1aRhm,A3fsA9Zfv1X2fVEQhTw51lKENdNrEqT3,121,85,42,322,9,104,37,0,599,85.57142857142857,13,0.0,11,42,288,9,74,104,34,37,0,350,249,0
1591,12351,f5nUM7X4snZl1Dwk9DyOLQ7PstRe3yG1,SpATywNh6bZuzm8s1ceuBUnMUAeoAHHw,17,12,8,21,5,0,11,0,57,8.142857142857142,3,0.0,2,8,17,5,10,0,4,11,0,32,25,1
1592,12371,Dx1ZzKpwFtwNhE9gdaLaohssqGyqrqjD,SpATywNh6bZuzm8s1ceuBUnMUAeoAHHw,46,83,41,39,15,71,24,2,275,39.285714285714285,9,0.0,25,41,30,15,58,71,9,24,2,111,164,0
1593,12384,bKVslXuzEQ1pv4c6iV5mVjs6X6avUbmL,RXDvfPUBYFlVdlueBFbLW0mhhAyGEqpt,74,490,236,61,55,894,409,98,2243,320.42857142857144,26,0.0,19,236,53,55,471,894,8,409,98,363,1880,0
1594,12386,Ak5p1JsyLmT4pGKGNb849PzZbmvFekml,SpATywNh6bZuzm8s1ceuBUnMUAeoAHHw,11,15,4,12,2,0,2,0,35,5.0,1,0.0,10,4,11,2,5,0,1,2,0,27,8,1
1595,12389,DNxlKJNm5ao3DSObllNvFwn0RJUn50Hh,SpATywNh6bZuzm8s1ceuBUnMUAeoAHHw,1,0,0,0,0,0,1,0,1,0.14285714285714285,1,0.0,0,0,0,0,0,0,0,1,0,0,1,1
1596,12402,3z0hX7DEeFfsgBAb2GCqLtG7EloWzN4g,bWdj2GDclj5ofokWjzoa5jAwMkxCykd6,5,4,1,0,0,0,3,0,8,1.1428571428571428,2,0.0,0,1,0,0,4,0,0,3,0,1,7,1
1597,12409,Io5gLr8QOxaBw8nFReloAXOpt3IlZ5WE,SpATywNh6bZuzm8s1ceuBUnMUAeoAHHw,6,6,1,0,0,0,12,0,19,2.7142857142857144,6,0.0,0,1,0,0,6,0,0,12,0,1,18,0
1598,12415,9xXPu4XrxUEQD4kiDWTsMvTkTFxGkYzI,A3fsA9Zfv1X2fVEQhTw51lKENdNrEqT3,44,35,17,64,11,0,3,0,130,18.571428571428573,4,0.0,3,17,55,11,32,0,9,3,0,86,44,1
1599,12430,w62eko3BoCGIpZmfYYoFjoaBC9TFzjaB,SpATywNh6bZuzm8s1ceuBUnMUAeoAHHw,47,47,27,37,15,34,23,1,184,26.285714285714285,6,0.0,11,27,32,15,36,34,5,23,1,85,99,1
1600,12431,dOkXreE5Co54rqG7YecVg356rhQtEiRH,SpATywNh6bZuzm8s1ceuBUnMUAeoAHHw,16,18,2,21,1,1,9,0,52,7.428571428571429,4,0.0,7,2,17,1,11,1,4,9,0,27,25,1
1601,12440,48vx3qHAZvBzdWBXsxihTari5aBTmUGi,SpATywNh6bZuzm8s1ceuBUnMUAeoAHHw,16,12,6,0,4,2,12,2,38,5.428571428571429,1,0.0,0,6,0,4,12,2,0,12,2,10,28,1
1602,12448,AQaaG4AcAnObnM2M4NcHCUkX6lEg0Mlu,SpATywNh6bZuzm8s1ceuBUnMUAeoAHHw,58,59,27,56,17,6,27,1,193,27.571428571428573,6,0.0,16,27,51,17,43,6,5,27,1,111,82,1
1603,12473,Jn3Y3EwJczNHkfzTGUpSSJOFpEETB0cw,A3fsA9Zfv1X2fVEQhTw51lKENdNrEqT3,2,0,0,0,0,0,4,0,4,0.5714285714285714,2,0.0,0,0,0,0,0,0,0,4,0,0,4,1
1604,12484,yEuZmA9AbYZaWqEfxA4FratjPoewKT3C,bWdj2GDclj5ofokWjzoa5jAwMkxCykd6,10,14,7,0,6,4,11,2,44,6.285714285714286,2,0.0,4,7,0,6,10,4,0,11,2,17,27,1
1605,12488,UkVp32qxLqsEWmDdG99xhNvtg1mVGbkd,SpATywNh6bZuzm8s1ceuBUnMUAeoAHHw,17,36,14,20,3,7,10,0,90,12.857142857142858,2,0.0,12,14,16,3,24,7,4,10,0,45,45,1
1606,12513,Jn3Y3EwJczNHkfzTGUpSSJOFpEETB0cw,SpATywNh6bZuzm8s1ceuBUnMUAeoAHHw,13,16,5,0,5,0,5,0,31,4.428571428571429,2,0.0,0,5,0,5,16,0,0,5,0,10,21,1
1607,12517,VfrUmEAx0ZYYX6kUXFzpxLwtafRhi7qR,SpATywNh6bZuzm8s1ceuBUnMUAeoAHHw,5,2,1,0,1,0,2,0,6,0.8571428571428571,1,0.0,0,1,0,1,2,0,0,2,0,2,4,1
1608,12518,4IkxYjTflPhoHxhEdrFyf3T4ZXNMTaKd,SpATywNh6bZuzm8s1ceuBUnMUAeoAHHw,42,73,33,36,13,0,10,0,165,23.571428571428573,7,0.0,12,33,35,13,61,0,1,10,0,93,72,0
1609,12521,jCbueeMsegjPu59bj6eGJyYcDxtIb05e,bWdj2GDclj5ofokWjzoa5jAwMkxCykd6,7,4,1,4,1,0,3,0,13,1.8571428571428572,1,0.0,2,1,3,1,2,0,1,3,0,7,6,1
1610,12536,XKtSJUu70kLs3jRiKFAR2MlWI70CZUcv,G8EPVSXsOYB5YQWZGiz1aVq5Pgr2GrQu,30,60,3,2,5,3,18,2,93,13.285714285714286,3,0.0,8,3,1,5,52,3,1,18,2,17,76,0
1611,12540,nlq4r6xc3rTUqTwcYhL6wudXdN6RIE52,bWdj2GDclj5ofokWjzoa5jAwMkxCykd6,12,8,7,0,7,6,5,0,33,4.714285714285714,3,0.0,0,7,0,7,8,6,0,5,0,14,19,1
1612,12546,LRHDYNgQAsG2UssS8TgaqkiYDbFlVrrj,A3fsA9Zfv1X2fVEQhTw51lKENdNrEqT3,36,48,37,0,20,5,17,2,129,18.428571428571427,6,0.0,1,37,0,20,47,5,0,17,2,58,71,1
1613,12547,IImOhpbuTNHI88DulkMnjvsH7H0HMncx,SpATywNh6bZuzm8s1ceuBUnMUAeoAHHw,4,2,1,0,1,0,1,0,5,0.7142857142857143,1,0.0,0,1,0,1,2,0,0,1,0,2,3,1
1614,12556,InTDVHpDSVoZu5vOSvueBLdJOgZb9Qu8,A3fsA9Zfv1X2fVEQhTw51lKENdNrEqT3,8,5,3,0,1,7,4,0,20,2.857142857142857,1,0.0,0,3,0,1,5,7,0,4,0,4,16,1
1615,12557,Vx74c4EnHqTcmxhMcO6kRvadcvYQC7Hl,SpATywNh6bZuzm8s1ceuBUnMUAeoAHHw,35,79,37,11,14,1,26,0,168,24.0,13,0.0,6,37,10,14,73,1,1,26,0,67,101,0
1616,12564,D59LfxtLBEXUXJuXCGYTJcy2S1d5nPYE,SpATywNh6bZuzm8s1ceuBUnMUAeoAHHw,34,49,8,28,5,0,13,0,103,14.714285714285714,9,0.0,10,8,25,5,39,0,3,13,0,48,55,0
1617,12566,ph8ToQs4xH6gdMMZGt7KWlSytujO4hy7,bWdj2GDclj5ofokWjzoa5jAwMkxCykd6,30,70,37,46,12,10,27,0,202,28.857142857142858,7,0.0,11,37,44,12,59,10,2,27,0,104,98,0
1618,12590,g8m22R7W0Wo8v9RXY0TMbj5qf5RFgvht,A3fsA9Zfv1X2fVEQhTw51lKENdNrEqT3,49,53,38,54,23,0,14,0,182,26.0,5,0.0,7,38,53,23,46,0,1,14,0,121,61,1
1619,12592,VwUXTBGJaTv5xN1He6TwE1OKxII3IUB4,A3fsA9Zfv1X2fVEQhTw51lKENdNrEqT3,19,23,17,0,7,7,18,2,74,10.571428571428571,3,0.0,1,17,0,7,22,7,0,18,2,25,49,1
1620,12598,0MgLdwlRWQ7TpUbl7lDTcNpvvpvRxwZk,SpATywNh6bZuzm8s1ceuBUnMUAeoAHHw,18,25,15,12,6,0,6,0,64,9.142857142857142,5,0.0,3,15,12,6,22,0,0,6,0,36,28,1
1621,12602,8g5cBj0Gjzli28QiIdgpvFAz2836fyoV,A3fsA9Zfv1X2fVEQhTw51lKENdNrEqT3,14,20,13,0,7,1,13,1,55,7.857142857142857,3,0.0,0,13,0,7,20,1,0,13,1,20,35,1
1622,12628,JaYbgvhgx43SysY9J8DaCR3IcdUzCcUf,SpATywNh6bZuzm8s1ceuBUnMUAeoAHHw,23,35,1,6,1,0,9,0,52,7.428571428571429,8,0.0,2,1,6,1,33,0,0,9,0,10,42,0
1623,12643,8DlfU1bgriTJuUO8vI8x268Lnn7yRdfp,bWdj2GDclj5ofokWjzoa5jAwMkxCykd6,5,2,1,0,1,3,4,0,11,1.5714285714285714,2,0.0,0,1,0,1,2,3,0,4,0,2,9,1
1624,12665,2DNSh2UatQFpodq67CmKbjqpA6AJb7Oi,SpATywNh6bZuzm8s1ceuBUnMUAeoAHHw,45,50,26,25,13,0,21,0,135,19.285714285714285,8,0.0,13,26,24,13,37,0,1,21,0,76,59,0
1625,12671,UcbTdkZF8IIJuBiyaeVa5dJ5AMKloTWJ,A3fsA9Zfv1X2fVEQhTw51lKENdNrEqT3,1,0,0,0,0,0,1,0,1,0.14285714285714285,1,0.0,0,0,0,0,0,0,0,1,0,0,1,1
1626,12676,NGkJealfvLzyvMkO29aSPohtdMh2i3ow,SpATywNh6bZuzm8s1ceuBUnMUAeoAHHw,18,21,13,6,7,1,2,0,50,7.142857142857143,2,0.0,6,13,6,7,15,1,0,2,0,32,18,1
1627,12678,v8Csqzh937f2Vg9ZqHM3p8LLheZjBof3,SpATywNh6bZuzm8s1ceuBUnMUAeoAHHw,13,15,2,0,1,0,3,0,21,3.0,2,0.0,3,2,0,1,12,0,0,3,0,6,15,0
1628,12691,nUlI6cjptTLAgli6MFzyKD61AHPa0Ow2,SpATywNh6bZuzm8s1ceuBUnMUAeoAHHw,7,4,3,0,2,0,1,0,10,1.4285714285714286,1,0.0,0,3,0,2,4,0,0,1,0,5,5,1
1629,12694,EelXsFqmLbbOgu7NMVlCz136fL2FTkZO,G8EPVSXsOYB5YQWZGiz1aVq5Pgr2GrQu,17,49,18,0,10,0,6,0,83,11.857142857142858,6,0.0,2,18,0,10,47,0,0,6,0,30,53,1
1630,12702,piMSzq394zCurmILy54TdIfNK5vFDgeH,SpATywNh6bZuzm8s1ceuBUnMUAeoAHHw,10,17,10,0,2,1,11,1,42,6.0,2,0.0,0,10,0,2,17,1,0,11,1,12,30,1
1631,12717,pXqbqKhLN9u2vMm4aIB5JwL5PRPhZDCp,A3fsA9Zfv1X2fVEQhTw51lKENdNrEqT3,4,2,0,0,0,0,3,0,5,0.7142857142857143,2,0.0,0,0,0,0,2,0,0,3,0,0,5,0
1632,12725,yXkO3eR7yt6I5YPt7SbP4lJC7f4DWsPi,SpATywNh6bZuzm8s1ceuBUnMUAeoAHHw,37,100,9,75,5,12,18,0,219,31.285714285714285,10,0.0,19,9,60,5,81,12,15,18,0,93,126,0
1633,12741,yFLanYq8p4sf6NFSB1Td9ag6632plY4t,A3fsA9Zfv1X2fVEQhTw51lKENdNrEqT3,32,36,28,0,20,1,17,1,103,14.714285714285714,7,0.0,0,28,0,20,36,1,0,17,1,48,55,0
1634,12743,qWbrTjg87QoJMjqclpcgpkGIkTTfGYPg,SpATywNh6bZuzm8s1ceuBUnMUAeoAHHw,1,0,0,0,0,0,1,0,1,0.14285714285714285,1,0.0,0,0,0,0,0,0,0,1,0,0,1,1
1635,12762,u82lBhpDxJIwlZISEntCxj1zgVFdW0vT,A3fsA9Zfv1X2fVEQhTw51lKENdNrEqT3,1,0,0,0,0,0,3,0,3,0.42857142857142855,2,0.0,0,0,0,0,0,0,0,3,0,0,3,1
1636,12781,xI2qMeJnp6aq2CKhFmXJQYegY0eBgJqh,SpATywNh6bZuzm8s1ceuBUnMUAeoAHHw,18,78,29,4,10,13,15,2,151,21.571428571428573,11,0.0,27,29,4,10,51,13,0,15,2,70,81,0
1637,12786,rZSLmwiYX8trzeLsBLeg8r0IN1GBbqOC,RXDvfPUBYFlVdlueBFbLW0mhhAyGEqpt,1,0,0,0,0,0,1,0,1,0.14285714285714285,1,0.0,0,0,0,0,0,0,0,1,0,0,1,1
1638,12788,rZSLmwiYX8trzeLsBLeg8r0IN1GBbqOC,A3fsA9Zfv1X2fVEQhTw51lKENdNrEqT3,117,50,25,252,7,0,20,0,354,50.57142857142857,5,0.0,9,25,229,7,41,0,23,20,0,270,84,0
1639,12797,0r0opwFyJ4N25MV6ZjVs69MBQP4LTfaz,RXDvfPUBYFlVdlueBFbLW0mhhAyGEqpt,106,97,58,190,28,13,15,4,405,57.857142857142854,7,0.0,30,58,184,28,67,13,6,15,4,300,105,0
1640,12798,SZOXOmDilP1KR3OJXHpIlLf61tEoqX1S,SpATywNh6bZuzm8s1ceuBUnMUAeoAHHw,20,39,0,26,0,12,13,2,92,13.142857142857142,3,0.0,18,0,23,0,21,12,3,13,2,41,51,1
1641,12801,N5iDERl36Pe29yDG8gDe9a99dYgqwB7y,bWdj2GDclj5ofokWjzoa5jAwMkxCykd6,33,36,8,141,2,0,15,0,202,28.857142857142858,5,0.0,9,8,119,2,27,0,22,15,0,138,64,1
1642,12802,n2H1RsIyXGWShdCbCzwLRVNV0gBoMcRI,bWdj2GDclj5ofokWjzoa5jAwMkxCykd6,12,14,7,4,5,0,12,1,43,6.142857142857143,3,0.0,5,7,4,5,9,0,0,12,1,21,22,1
1643,12803,P0uW8e7uWJsgVO5MWg1krlEvXljM181Y,A3fsA9Zfv1X2fVEQhTw51lKENdNrEqT3,2,0,0,0,0,0,2,0,2,0.2857142857142857,1,0.0,0,0,0,0,0,0,0,2,0,0,2,1
1644,12817,n2H1RsIyXGWShdCbCzwLRVNV0gBoMcRI,A3fsA9Zfv1X2fVEQhTw51lKENdNrEqT3,2,0,0,0,0,0,3,0,3,0.42857142857142855,2,0.0,0,0,0,0,0,0,0,3,0,0,3,1
1645,12830,L0KQTTHes3X5LPSdqQrdBMVgea19D6tJ,SpATywNh6bZuzm8s1ceuBUnMUAeoAHHw,27,57,29,14,13,0,10,0,123,17.571428571428573,7,0.0,7,29,14,13,50,0,0,10,0,63,60,1
1646,12838,D1VQybdJv05b8bnQWlTwVLnxuzPr9TGg,SpATywNh6bZuzm8s1ceuBUnMUAeoAHHw,50,76,30,46,14,1,31,2,200,28.571428571428573,9,0.0,19,30,41,14,57,1,5,31,2,104,96,0
1647,12850,cVHCYdG6eoXKQe55dLZbvLgwBGbWam7p,SpATywNh6bZuzm8s1ceuBUnMUAeoAHHw,10,12,0,0,0,1,15,1,29,4.142857142857143,2,0.0,2,0,0,0,10,1,0,15,1,2,27,1
1648,12861,clcszcRJ03jiyZ5GYQyVZZ7N7YqBvRWN,G8EPVSXsOYB5YQWZGiz1aVq5Pgr2GrQu,12,21,12,16,7,2,7,2,67,9.571428571428571,2,0.0,5,12,14,7,16,2,2,7,2,38,29,1
1649,12876,birimXAhV5T8auACU6PoAgdoddyc5gxF,SpATywNh6bZuzm8s1ceuBUnMUAeoAHHw,20,16,8,16,4,6,5,1,56,8.0,1,0.0,6,8,15,4,10,6,1,5,1,33,23,1
1650,12878,nxXaLxK1WzKt8vz8gfQ7mw2jj0DmsYuz,SpATywNh6bZuzm8s1ceuBUnMUAeoAHHw,24,29,0,27,1,1,31,2,91,13.0,10,0.0,8,0,23,1,21,1,4,31,2,32,59,0
1651,12886,jitS86VYMmQkiBJMhbTP5ghyPiIbWGe4,SpATywNh6bZuzm8s1ceuBUnMUAeoAHHw,7,13,1,0,0,4,3,1,22,3.142857142857143,1,0.0,2,1,0,0,11,4,0,3,1,3,19,1
1652,12898,P0uW8e7uWJsgVO5MWg1krlEvXljM181Y,RXDvfPUBYFlVdlueBFbLW0mhhAyGEqpt,2,0,0,0,0,0,2,0,2,0.2857142857142857,1,0.0,0,0,0,0,0,0,0,2,0,0,2,1
1653,12911,qAfzRWdcV29MrGV4Q3OpnDw6sMEqxrsX,SpATywNh6bZuzm8s1ceuBUnMUAeoAHHw,6,4,0,0,0,0,3,0,7,1.0,1,0.0,0,0,0,0,4,0,0,3,0,0,7,1
1654,12919,UaSh8dwx8gnofYbXlmpqj9uYDbpJ89pX,SpATywNh6bZuzm8s1ceuBUnMUAeoAHHw,12,41,5,0,0,205,34,5,290,41.42857142857143,9,0.0,7,5,0,0,34,205,0,34,5,12,278,0
1655,12920,C7qRsA5jr1OEmJhfxUyc4ekgHn4q4XXi,SpATywNh6bZuzm8s1ceuBUnMUAeoAHHw,10,62,15,0,0,3,11,0,91,13.0,5,0.0,1,15,0,0,61,3,0,11,0,16,75,1
1656,12922,uqIn0vdfJ1SDJCOeCVEAQPRFBBKQA2eB,A3fsA9Zfv1X2fVEQhTw51lKENdNrEqT3,137,94,45,262,33,0,24,0,458,65.42857142857143,9,0.0,4,45,240,33,90,0,22,24,0,322,136,1
1657,12939,BZIh5Ji4WRsl5XFn0vcayrSAt3EwPPq7,SpATywNh6bZuzm8s1ceuBUnMUAeoAHHw,40,90,7,42,7,3,38,3,190,27.142857142857142,13,0.0,16,7,36,7,74,3,6,38,3,66,124,0
1658,12941,agXxlcmOoEfRNuHGmntEOJrJqSCOihJk,SpATywNh6bZuzm8s1ceuBUnMUAeoAHHw,36,69,0,25,0,2,17,1,114,16.285714285714285,11,0.0,16,0,25,0,53,2,0,17,1,41,73,1
1659,12960,QxcB9RiJu5tiHZOch1DPGex1fIsAotsI,SpATywNh6bZuzm8s1ceuBUnMUAeoAHHw,48,123,6,46,4,41,57,9,286,40.857142857142854,16,0.0,32,6,40,4,91,41,6,57,9,82,204,0
1660,12970,GR6VeteR9GEbfhgsQCuQ7IOGLVIdLf6Q,SpATywNh6bZuzm8s1ceuBUnMUAeoAHHw,10,20,1,2,0,0,4,0,27,3.857142857142857,3,0.0,1,1,2,0,19,0,0,4,0,4,23,0
1661,12973,7fFZLbLMI7Ucj1mdrBxpY9hCEcczhOLF,RXDvfPUBYFlVdlueBFbLW0mhhAyGEqpt,78,91,10,165,3,5,27,2,303,43.285714285714285,11,0.0,26,10,162,3,65,5,3,27,2,201,102,0
1662,12987,d1JMD7qxfNKpLgzBvlpfaUYeKyTI6qbc,RXDvfPUBYFlVdlueBFbLW0mhhAyGEqpt,22,16,12,0,10,1,11,0,50,7.142857142857143,3,0.0,0,12,0,10,16,1,0,11,0,22,28,0
1663,12998,MM2B2653YFHORo361rzambfOSuqgdvxU,SpATywNh6bZuzm8s1ceuBUnMUAeoAHHw,27,35,16,20,6,4,12,0,93,13.285714285714286,8,0.0,12,16,17,6,23,4,3,12,0,51,42,1
1664,13002,qBuOYvjWXxAt6x3Clq0Mm94iVtXMfRzl,A3fsA9Zfv1X2fVEQhTw51lKENdNrEqT3,42,23,18,60,15,3,9,2,130,18.571428571428573,2,0.0,2,18,49,15,21,3,11,9,2,84,46,1
1665,13021,rXHS1nVaWODpE4oMoF8GV1PH34kuNjhN,A3fsA9Zfv1X2fVEQhTw51lKENdNrEqT3,70,38,25,158,13,8,20,1,263,37.57142857142857,4,0.0,4,25,138,13,34,8,20,20,1,180,83,1
1666,13024,gdBVlnD2M7V6ljn8vJvT9NnajpxXqL1v,SpATywNh6bZuzm8s1ceuBUnMUAeoAHHw,28,41,15,18,9,1,11,0,95,13.571428571428571,5,0.0,14,15,15,9,27,1,3,11,0,53,42,1
1667,13026,nE3rPlTTHJqOdfeqGlvnz4cddsiodod7,SpATywNh6bZuzm8s1ceuBUnMUAeoAHHw,4,2,0,0,0,0,2,0,4,0.5714285714285714,1,0.0,0,0,0,0,2,0,0,2,0,0,4,0
1668,13038,Ys5FH0nq7NeLEdwGoDUOp7Sz8iAMAB3d,SpATywNh6bZuzm8s1ceuBUnMUAeoAHHw,20,89,28,5,7,0,12,0,141,20.142857142857142,5,0.0,9,28,4,7,80,0,1,12,0,48,93,1
1669,13049,8nRie7othcdG0O4zmQQo2Wo4gx8ixPWA,SpATywNh6bZuzm8s1ceuBUnMUAeoAHHw,8,3,0,0,0,1,6,1,11,1.5714285714285714,1,0.0,0,0,0,0,3,1,0,6,1,0,11,1
1670,13064,FH8uaUgDtH5I6cjMpNACS7MT4OVRdm6l,SpATywNh6bZuzm8s1ceuBUnMUAeoAHHw,35,42,4,36,1,3,15,1,102,14.571428571428571,6,0.0,12,4,33,1,30,3,3,15,1,50,52,0
1671,13068,Oewk1cgUhxDAPgxI9Y8opSnbFrQ56lFp,G8EPVSXsOYB5YQWZGiz1aVq5Pgr2GrQu,73,75,43,72,29,3,44,0,266,38.0,9,0.0,10,43,64,29,65,3,8,44,0,146,120,0
1672,13079,UnqeeEn98S2A9CknpatcyHPMxgZC4vhi,bWdj2GDclj5ofokWjzoa5jAwMkxCykd6,12,17,10,56,0,2,9,0,94,13.428571428571429,2,0.0,4,10,53,0,13,2,3,9,0,67,27,1
1673,13084,iKiK6wMQ7FsUhBHmZmA4WSvuLlgoIAIT,SpATywNh6bZuzm8s1ceuBUnMUAeoAHHw,29,44,19,12,7,1,5,0,88,12.571428571428571,4,0.0,20,19,12,7,24,1,0,5,0,58,30,1
1674,13087,JuiV77lwSiyunloCdIxpEqZLnyAIWuGF,SpATywNh6bZuzm8s1ceuBUnMUAeoAHHw,28,93,18,37,8,58,33,0,247,35.285714285714285,7,0.0,31,18,31,8,62,58,6,33,0,88,159,1
1675,13093,X0UQZEMetzdnutZa926McNof6mCEs6hL,bWdj2GDclj5ofokWjzoa5jAwMkxCykd6,19,13,2,220,4,12,8,1,260,37.142857142857146,3,0.0,3,2,214,4,10,12,6,8,1,223,37,0
1676,13096,WkW7xhOBov4cdi1HI8MIcYy2tcL8JIqM,G8EPVSXsOYB5YQWZGiz1aVq5Pgr2GrQu,29,39,15,78,7,1,18,0,158,22.571428571428573,6,0.0,21,15,61,7,18,1,17,18,0,104,54,0
1677,13097,jSElHDudYQXAurrUrZvr8PEvqza2483p,SpATywNh6bZuzm8s1ceuBUnMUAeoAHHw,22,63,9,15,9,25,52,5,178,25.428571428571427,9,0.0,6,9,13,9,57,25,2,52,5,37,141,0
1678,13118,VSdgqyGl0eURAhfgbcwFZu4zgDm6da40,A3fsA9Zfv1X2fVEQhTw51lKENdNrEqT3,7,8,0,0,0,0,7,0,15,2.142857142857143,1,0.0,0,0,0,0,8,0,0,7,0,0,15,1
1679,13123,DER7joh3KQKE4dEofQirnM23uWHXKmaD,SpATywNh6bZuzm8s1ceuBUnMUAeoAHHw,2,0,0,0,0,0,2,0,2,0.2857142857142857,1,0.0,0,0,0,0,0,0,0,2,0,0,2,1
1680,13126,zEeuqWNlBTdOCPxX0tLPUzZrt62Jaced,SpATywNh6bZuzm8s1ceuBUnMUAeoAHHw,19,32,2,19,2,0,10,0,65,9.285714285714286,1,0.0,14,2,17,2,18,0,2,10,0,35,30,1
1681,13150,5LHFGZp52JmCecbZlM5IR7cocsBDm2vK,A3fsA9Zfv1X2fVEQhTw51lKENdNrEqT3,1,0,0,0,0,0,2,0,2,0.2857142857142857,1,0.0,0,0,0,0,0,0,0,2,0,0,2,1
1682,13160,i9EYjpibuPRn90FUwaEumbd5PTkZZAqq,SpATywNh6bZuzm8s1ceuBUnMUAeoAHHw,1,0,0,0,0,0,1,0,1,0.14285714285714285,1,0.0,0,0,0,0,0,0,0,1,0,0,1,1
1683,13162,PLNAK5eO2jDldFb2P1VVgW3GLNYSW1XE,A3fsA9Zfv1X2fVEQhTw51lKENdNrEqT3,58,25,1,128,0,20,12,1,187,26.714285714285715,4,0.0,3,1,112,0,22,20,16,12,1,116,71,1
1684,13167,c1zDCPDnvv0eep80ND9h9tNicqqWeY8x,SpATywNh6bZuzm8s1ceuBUnMUAeoAHHw,4,2,1,0,1,0,1,0,5,0.7142857142857143,1,0.0,0,1,0,1,2,0,0,1,0,2,3,1
1685,13169,VD51DafWdYqPb9OUf4DGqW0cSE2mdG9x,RXDvfPUBYFlVdlueBFbLW0mhhAyGEqpt,50,52,32,75,15,14,14,0,202,28.857142857142858,6,0.0,12,32,70,15,40,14,5,14,0,129,73,0
1686,13171,Xz4KwNrqILWO256erDoEJKlZ22fLi17K,bWdj2GDclj5ofokWjzoa5jAwMkxCykd6,8,12,0,74,2,0,9,0,97,13.857142857142858,4,0.0,6,0,73,2,6,0,1,9,0,81,16,1
1687,13182,Gur5FuhE9EyV9K1F0qLPk7AenhoY8PBS,A3fsA9Zfv1X2fVEQhTw51lKENdNrEqT3,30,45,14,0,10,0,19,0,88,12.571428571428571,6,0.0,0,14,0,10,45,0,0,19,0,24,64,0
1688,13202,Oyq7ji1m15xuxwPKjm7Gg05YiNCQEcyW,A3fsA9Zfv1X2fVEQhTw51lKENdNrEqT3,4,2,1,0,1,0,1,0,5,0.7142857142857143,1,0.0,0,1,0,1,2,0,0,1,0,2,3,1
1689,13205,t0soD7aQ6w7DGyhmXz7wyAfUbtBWT4NA,SpATywNh6bZuzm8s1ceuBUnMUAeoAHHw,6,7,2,0,1,0,3,1,14,2.0,1,0.0,4,2,0,1,3,0,0,3,1,7,7,1
1690,13213,fvcf8Mss4D9M5Dkk5Dn5T9NiTapwZ9dB,A3fsA9Zfv1X2fVEQhTw51lKENdNrEqT3,34,11,6,80,5,0,8,0,110,15.714285714285714,2,0.0,4,6,65,5,7,0,15,8,0,80,30,1
1691,13215,YKsQbxqCbn9zYlM8hXkeyvve9j97h5Fs,SpATywNh6bZuzm8s1ceuBUnMUAeoAHHw,5,2,1,0,1,0,2,0,6,0.8571428571428571,1,0.0,0,1,0,1,2,0,0,2,0,2,4,1
1692,13231,CGCo1ulRSzYrFke9WXpheptgBfQxf2gK,SpATywNh6bZuzm8s1ceuBUnMUAeoAHHw,35,86,41,25,13,17,36,2,220,31.428571428571427,12,0.0,18,41,23,13,68,17,2,36,2,95,125,0
1693,13243,D3y4ChHgB3o0JcWw3QbeyrPnD6ZSD4me,SpATywNh6bZuzm8s1ceuBUnMUAeoAHHw,4,0,0,0,0,8,4,1,13,1.8571428571428572,1,0.0,0,0,0,0,0,8,0,4,1,0,13,1
1694,13268,eAArxLyCThtu9N3Mv8rQculKbGSa66j9,G8EPVSXsOYB5YQWZGiz1aVq5Pgr2GrQu,144,120,51,365,30,26,33,0,625,89.28571428571429,7,0.0,61,51,273,30,59,26,92,33,0,415,210,0
1695,13270,ffLXxfgMU4yir9uI5fIkKo2iZzEw2Lpz,SpATywNh6bZuzm8s1ceuBUnMUAeoAHHw,21,23,15,0,8,4,12,0,62,8.857142857142858,6,0.0,0,15,0,8,23,4,0,12,0,23,39,1
1696,13278,XwU61hOxlE8cqDut2rPIgRseTsxZ07jG,SpATywNh6bZuzm8s1ceuBUnMUAeoAHHw,24,81,12,40,1,8,9,0,151,21.571428571428573,3,0.0,58,12,36,1,23,8,4,9,0,107,44,0
1697,13284,HmCqvdVQxacevQymd3KKpvfG444InuCU,RXDvfPUBYFlVdlueBFbLW0mhhAyGEqpt,62,82,47,144,5,0,10,0,288,41.142857142857146,4,0.0,26,47,140,5,56,0,4,10,0,218,70,0
1698,13294,kI6cheDOBy9s4ZYk6wZ8CKNoQdId12d9,SpATywNh6bZuzm8s1ceuBUnMUAeoAHHw,11,13,6,0,2,2,16,6,45,6.428571428571429,2,0.0,0,6,0,2,13,2,0,16,6,8,37,1
1699,13297,0b8UUNX7vDapSg0uCVOk0glpsbuPbDat,SpATywNh6bZuzm8s1ceuBUnMUAeoAHHw,48,126,55,52,25,110,33,5,406,58.0,15,0.0,49,55,43,25,77,110,9,33,5,172,234,0
1700,13305,QIQR6VwK3cpUKM5lDzadEKeQATM23w8z,RXDvfPUBYFlVdlueBFbLW0mhhAyGEqpt,1,0,0,0,0,0,1,0,1,0.14285714285714285,1,0.0,0,0,0,0,0,0,0,1,0,0,1,1
1701,13309,1dxQmK9WwlHWuIG7ZTn4PsJ2vflQBDH3,A3fsA9Zfv1X2fVEQhTw51lKENdNrEqT3,14,17,5,16,2,0,9,0,49,7.0,6,0.0,0,5,12,2,17,0,4,9,0,19,30,0
1702,13312,9aWGLeAVHncegHPXAP1qMMyzvcIDPZKu,A3fsA9Zfv1X2fVEQhTw51lKENdNrEqT3,42,26,21,164,0,7,17,2,237,33.857142857142854,3,0.0,1,21,132,0,25,7,32,17,2,154,83,1
1703,13318,Xzt2w1aRoJeIAP02oHWxu8IVeFzxqDvF,SpATywNh6bZuzm8s1ceuBUnMUAeoAHHw,34,106,39,49,28,9,21,3,255,36.42857142857143,6,0.0,16,39,40,28,90,9,9,21,3,123,132,0
1704,13324,NuZwpz0U4SxzLHddLsrKCkHdkj5yyqPt,A3fsA9Zfv1X2fVEQhTw51lKENdNrEqT3,40,57,3,60,0,0,8,1,129,18.428571428571427,3,0.0,3,3,54,0,54,0,6,8,1,60,69,1
1705,13327,M3xTB6LenTJvMpybZKparVtRZKzrRM1R,SpATywNh6bZuzm8s1ceuBUnMUAeoAHHw,30,90,38,20,9,108,45,3,313,44.714285714285715,7,0.0,21,38,19,9,69,108,1,45,3,87,226,0
1706,13335,BuvcW1QbEkmICBwJsmVk62irFMyFXFIl,SpATywNh6bZuzm8s1ceuBUnMUAeoAHHw,19,22,11,0,7,0,3,0,43,6.142857142857143,2,0.0,0,11,0,7,22,0,0,3,0,18,25,0
1707,13350,ooqIS0ldRRRaqJrrOHVscbkigkM4wbN5,SpATywNh6bZuzm8s1ceuBUnMUAeoAHHw,40,42,35,0,27,0,9,0,113,16.142857142857142,7,0.0,0,35,0,27,42,0,0,9,0,62,51,0
1708,13353,Aw7PeIkLW9CDHbPpPSjrFUdtBaUuHUXm,A3fsA9Zfv1X2fVEQhTw51lKENdNrEqT3,113,65,51,192,31,4,87,0,430,61.42857142857143,19,0.0,5,51,157,31,60,4,35,87,0,244,186,0
1709,13357,sFfdfS73lXtMTUaBLpEd17ZzknvXcxlF,G8EPVSXsOYB5YQWZGiz1aVq5Pgr2GrQu,5,3,1,0,1,0,2,0,7,1.0,1,0.0,0,1,0,1,3,0,0,2,0,2,5,1
1710,13389,suNtRVoL26o1uoSjCtTBYoEROkIKHNRV,SpATywNh6bZuzm8s1ceuBUnMUAeoAHHw,21,46,6,10,3,10,7,0,82,11.714285714285714,3,0.0,16,6,10,3,30,10,0,7,0,35,47,0
1711,13392,Zp81uMflvqqrfEwxhUzFhFbNFp63e2qq,SpATywNh6bZuzm8s1ceuBUnMUAeoAHHw,34,130,16,45,6,6,21,1,225,32.142857142857146,15,0.0,30,16,41,6,100,6,4,21,1,93,132,0
1712,13395,eq0kQUYo3qpAoZ9JUGvTejR7TbE9dl0n,A3fsA9Zfv1X2fVEQhTw51lKENdNrEqT3,1,0,0,0,0,0,2,0,2,0.2857142857142857,1,0.0,0,0,0,0,0,0,0,2,0,0,2,1
1713,13417,P6cCvRjvbpDjgLjSjFoCoaUi3J3jrMaV,bWdj2GDclj5ofokWjzoa5jAwMkxCykd6,19,55,3,94,5,6,27,2,192,27.428571428571427,4,0.0,14,3,90,5,41,6,4,27,2,112,80,1
1714,13419,zFUDj5TvEjIvvTLimj5EmmmOcToptA99,bWdj2GDclj5ofokWjzoa5jAwMkxCykd6,5,2,1,0,1,0,2,0,6,0.8571428571428571,1,0.0,0,1,0,1,2,0,0,2,0,2,4,1
1715,13426,PfZH4Yubwsve9DvShzAvHjayDN16nhpN,RXDvfPUBYFlVdlueBFbLW0mhhAyGEqpt,2,0,0,0,0,0,2,0,2,0.2857142857142857,1,0.0,0,0,0,0,0,0,0,2,0,0,2,1
1716,13434,xzjKh0on5UQxslbqX3WgWTiQPFL3pvFu,A3fsA9Zfv1X2fVEQhTw51lKENdNrEqT3,9,7,5,0,3,0,3,0,18,2.5714285714285716,2,0.0,0,5,0,3,7,0,0,3,0,8,10,1
1717,13436,0wXXwNeE6W7NBvQ3k3OMvVCCQezsKKgg,SpATywNh6bZuzm8s1ceuBUnMUAeoAHHw,39,56,26,42,18,0,4,0,146,20.857142857142858,3,0.0,10,26,35,18,46,0,7,4,0,89,57,1
1718,13442,Q459I6WtHQ4LYscZN5C0n5NrNaEwzARk,A3fsA9Zfv1X2fVEQhTw51lKENdNrEqT3,5,2,1,0,1,0,6,0,10,1.4285714285714286,2,0.0,0,1,0,1,2,0,0,6,0,2,8,0
1719,13466,G9zssYsMiy0OM7PcLiakkEdvgznZi21h,bWdj2GDclj5ofokWjzoa5jAwMkxCykd6,10,7,4,22,2,0,2,0,37,5.285714285714286,2,0.0,1,4,18,2,6,0,4,2,0,25,12,1
1720,13468,LSqC7qdkRAhbSsajNxT5pt4NlUyn2gsl,SpATywNh6bZuzm8s1ceuBUnMUAeoAHHw,6,5,4,0,4,0,1,0,14,2.0,1,0.0,0,4,0,4,5,0,0,1,0,8,6,1
1721,13488,3szdu9Q6Oikq1zf8fBs2hQUGk7dqskOy,SpATywNh6bZuzm8s1ceuBUnMUAeoAHHw,13,11,2,14,2,0,4,0,33,4.714285714285714,1,0.0,3,2,13,2,8,0,1,4,0,20,13,1
1722,13502,Zdseq1rQmkAi5wZl57d3RwjzOxlL3B5I,A3fsA9Zfv1X2fVEQhTw51lKENdNrEqT3,143,112,87,282,57,18,44,6,606,86.57142857142857,13,0.0,7,87,224,57,105,18,58,44,6,375,231,0
1723,13503,2YfvPW4RjjB1wuYNlMfzfMUdSCE4Rwzu,SpATywNh6bZuzm8s1ceuBUnMUAeoAHHw,23,59,4,35,1,27,23,3,152,21.714285714285715,8,0.0,17,4,28,1,42,27,7,23,3,50,102,0
1724,13513,OsjipUObm67JsyJjOy7xHoa32L8CSYg5,RXDvfPUBYFlVdlueBFbLW0mhhAyGEqpt,70,81,9,91,7,17,11,0,216,30.857142857142858,5,0.0,18,9,90,7,63,17,1,11,0,124,92,0
1725,13514,XDXCn0FDh32qCzKi52Qo5wbWma8m1QWg,SpATywNh6bZuzm8s1ceuBUnMUAeoAHHw,2,0,0,0,0,0,2,0,2,0.2857142857142857,1,0.0,0,0,0,0,0,0,0,2,0,0,2,1
1726,13529,Ge8ZKyoh7v3U8XFFvvntz8tE5dDD1txz,SpATywNh6bZuzm8s1ceuBUnMUAeoAHHw,17,42,17,15,5,11,29,4,123,17.571428571428573,6,0.0,14,17,12,5,28,11,3,29,4,48,75,1
1727,13538,LjMEB9aIUIvEfq4JTf4C9ef9fHbbyj0M,SpATywNh6bZuzm8s1ceuBUnMUAeoAHHw,57,96,32,81,19,19,23,1,271,38.714285714285715,12,0.0,40,32,71,19,56,19,10,23,1,162,109,0
1728,13539,UCcQjKn5wSzQ8Z7Gu1uECZPrSwuRD4I9,SpATywNh6bZuzm8s1ceuBUnMUAeoAHHw,4,3,1,0,1,0,3,0,8,1.1428571428571428,1,0.0,0,1,0,1,3,0,0,3,0,2,6,1
1729,13541,dQ6ARJIxCHLlztvK37NHQ0C1ttipx0zg,SpATywNh6bZuzm8s1ceuBUnMUAeoAHHw,21,30,16,13,8,4,6,0,77,11.0,5,0.0,8,16,12,8,22,4,1,6,0,44,33,0
1730,13561,i6CSuJ6asUrdPRp5edOkSDBKGwbyCy2y,bWdj2GDclj5ofokWjzoa5jAwMkxCykd6,3,0,0,0,0,1,4,0,5,0.7142857142857143,1,0.0,0,0,0,0,0,1,0,4,0,0,5,1
1731,13562,Du4OhdznDw29gaWDeHXBUWRKyEVAbHaQ,SpATywNh6bZuzm8s1ceuBUnMUAeoAHHw,46,88,43,42,14,1,39,1,228,32.57142857142857,12,0.0,29,43,30,14,59,1,12,39,1,116,112,0
1732,13568,r0yAsNzYkqEPYi6zNhQfzuueDjmcyFRr,G8EPVSXsOYB5YQWZGiz1aVq5Pgr2GrQu,103,92,60,172,22,0,21,1,368,52.57142857142857,3,0.0,28,60,140,22,64,0,32,21,1,250,118,1
1733,13571,QFQlbn421RXpUzVVaKhkxpBlvQfTJy18,SpATywNh6bZuzm8s1ceuBUnMUAeoAHHw,29,48,23,40,9,0,11,0,131,18.714285714285715,5,0.0,19,23,34,9,29,0,6,11,0,85,46,0
1734,13574,BOWTvQlkFu3OONGPj2orMpzJbZOzBXuG,SpATywNh6bZuzm8s1ceuBUnMUAeoAHHw,43,79,8,40,2,50,40,4,223,31.857142857142858,11,0.0,17,8,35,2,62,50,5,40,4,62,161,0
1735,13577,r9n2Z7iYkL5tKegLJwMIOxTHQqxopYp0,SpATywNh6bZuzm8s1ceuBUnMUAeoAHHw,25,42,23,30,10,0,10,0,115,16.428571428571427,10,0.0,9,23,25,10,33,0,5,10,0,67,48,1
1736,13591,thD3JQHh1xpY9SdL9w6TAUhWjJrPsSHi,SpATywNh6bZuzm8s1ceuBUnMUAeoAHHw,51,114,53,51,27,7,21,1,274,39.142857142857146,6,0.0,44,53,45,27,70,7,6,21,1,169,105,0
1737,13596,SuKlsA6xoxq9JGrANP30LMW7qjrc07fy,bWdj2GDclj5ofokWjzoa5jAwMkxCykd6,23,33,21,82,5,0,14,0,155,22.142857142857142,3,0.0,7,21,75,5,26,0,7,14,0,108,47,1
1738,13603,2YfvPW4RjjB1wuYNlMfzfMUdSCE4Rwzu,RXDvfPUBYFlVdlueBFbLW0mhhAyGEqpt,5,7,0,0,0,6,3,0,16,2.2857142857142856,1,0.0,0,0,0,0,7,6,0,3,0,0,16,0
1739,13611,taXwAmoyCNDGaXo8nVRGsDZwnk4if3bF,SpATywNh6bZuzm8s1ceuBUnMUAeoAHHw,28,84,22,26,6,2,20,2,162,23.142857142857142,7,0.0,26,22,24,6,58,2,2,20,2,78,84,0
1740,13615,SFczaSY6Hc3uft6fwzUwvxTQx8AOyArS,G8EPVSXsOYB5YQWZGiz1aVq5Pgr2GrQu,21,57,2,36,8,9,14,2,128,18.285714285714285,2,0.0,30,2,27,8,27,9,9,14,2,67,61,1
1741,13617,q1nSg7gMR4fmcENPvRW7b84TFAk5YaYv,SpATywNh6bZuzm8s1ceuBUnMUAeoAHHw,33,81,3,27,3,17,25,2,158,22.571428571428573,7,0.0,20,3,23,3,61,17,4,25,2,49,109,1
1742,13619,q1nSg7gMR4fmcENPvRW7b84TFAk5YaYv,bWdj2GDclj5ofokWjzoa5jAwMkxCykd6,1,0,0,0,0,0,1,0,1,0.14285714285714285,1,0.0,0,0,0,0,0,0,0,1,0,0,1,1
1743,13625,Df1QcOycdzVWQv3hsgRFSNdSZglUPcB7,SpATywNh6bZuzm8s1ceuBUnMUAeoAHHw,1,0,0,0,0,0,2,0,2,0.2857142857142857,1,0.0,0,0,0,0,0,0,0,2,0,0,2,1
1744,13627,Df1QcOycdzVWQv3hsgRFSNdSZglUPcB7,G8EPVSXsOYB5YQWZGiz1aVq5Pgr2GrQu,1,0,0,0,0,0,1,0,1,0.14285714285714285,1,0.0,0,0,0,0,0,0,0,1,0,0,1,1
1745,13635,ePpfrPKFmuYE4CHcpunEZ73b0FxyOz0q,A3fsA9Zfv1X2fVEQhTw51lKENdNrEqT3,100,48,30,198,19,6,34,1,336,48.0,7,0.0,4,30,167,19,44,6,31,34,1,220,116,1
1746,13639,6ZFGnTjh94PbXkR7sbTLWokikXbcLQlV,A3fsA9Zfv1X2fVEQhTw51lKENdNrEqT3,13,14,6,8,0,0,13,0,41,5.857142857142857,3,0.0,1,6,8,0,13,0,0,13,0,15,26,0
1747,13643,kF8fYPSPVuf77u2d6KdtH12htaNTxyrR,SpATywNh6bZuzm8s1ceuBUnMUAeoAHHw,5,7,1,0,1,0,2,0,11,1.5714285714285714,2,0.0,0,1,0,1,7,0,0,2,0,2,9,1
1748,13645,FOoOtP9CvNldG35bvwpepCilGCCL9n8O,SpATywNh6bZuzm8s1ceuBUnMUAeoAHHw,42,58,37,15,23,0,18,0,151,21.571428571428573,6,0.0,3,37,13,23,55,0,2,18,0,76,75,1
1749,13646,2gMbFqhNbghdA4J5huVDcJIix3xmMqms,SpATywNh6bZuzm8s1ceuBUnMUAeoAHHw,29,54,14,33,7,20,18,1,147,21.0,6,0.0,17,14,28,7,37,20,5,18,1,66,81,1
1750,13655,5LtufKrJgtzGXPllU5SjGTHr8eJRp7wi,SpATywNh6bZuzm8s1ceuBUnMUAeoAHHw,9,4,3,0,3,0,2,0,12,1.7142857142857142,1,0.0,0,3,0,3,4,0,0,2,0,6,6,1
1751,13658,BRb6GOIqcgYg1e6c431h8FubF4jTJim3,SpATywNh6bZuzm8s1ceuBUnMUAeoAHHw,39,73,7,31,4,3,26,4,148,21.142857142857142,8,0.0,15,7,26,4,58,3,5,26,4,52,96,1
1752,13663,oNStIislotbuK2XCCskaFe8CInb3EbrY,bWdj2GDclj5ofokWjzoa5jAwMkxCykd6,3,3,0,0,0,0,1,0,4,0.5714285714285714,1,0.0,1,0,0,0,2,0,0,1,0,1,3,1
1753,13666,Y0LHIPeN84CX2pJB37p6sblq4PhQo9k4,SpATywNh6bZuzm8s1ceuBUnMUAeoAHHw,22,27,4,30,3,1,7,0,72,10.285714285714286,4,0.0,7,4,29,3,20,1,1,7,0,43,29,1
1754,13668,ZFgJH3XPKn6EjDuXV9VLOpKftzENCqEZ,G8EPVSXsOYB5YQWZGiz1aVq5Pgr2GrQu,113,162,90,223,18,38,35,1,567,81.0,15,0.0,27,90,206,18,135,38,17,35,1,341,226,0
1755,13677,ZFgJH3XPKn6EjDuXV9VLOpKftzENCqEZ,RXDvfPUBYFlVdlueBFbLW0mhhAyGEqpt,36,77,54,27,10,28,26,0,222,31.714285714285715,10,0.0,7,54,27,10,70,28,0,26,0,98,124,0
1756,13688,1TRHxgoibI9N1jVfz15wdiz3VF8KLiZV,G8EPVSXsOYB5YQWZGiz1aVq5Pgr2GrQu,8,5,4,0,4,0,2,0,15,2.142857142857143,1,0.0,0,4,0,4,5,0,0,2,0,8,7,1
1757,13690,XkKS323fFxBVezQ5JyIgzxHDxEKEwwEf,bWdj2GDclj5ofokWjzoa5jAwMkxCykd6,10,12,4,14,3,0,2,0,35,5.0,1,0.0,4,4,14,3,8,0,0,2,0,25,10,1
1758,13692,dB9soxJVmgwXZSiR7r7fYfCigeYZx4rK,SpATywNh6bZuzm8s1ceuBUnMUAeoAHHw,8,6,4,0,3,1,4,0,18,2.5714285714285716,3,0.0,0,4,0,3,6,1,0,4,0,7,11,1
1759,13695,eosk3dY7502Pbg6Dsnx0qWKWUpRTliXK,SpATywNh6bZuzm8s1ceuBUnMUAeoAHHw,23,56,17,12,5,0,12,0,102,14.571428571428571,9,0.0,5,17,9,5,51,0,3,12,0,36,66,1
1760,13722,MFpshextOJLHhySF4C6u9eWxWZPDeRiA,SpATywNh6bZuzm8s1ceuBUnMUAeoAHHw,5,3,1,0,1,0,5,0,10,1.4285714285714286,3,0.0,1,1,0,1,2,0,0,5,0,3,7,1
1761,13725,r0yAsNzYkqEPYi6zNhQfzuueDjmcyFRr,A3fsA9Zfv1X2fVEQhTw51lKENdNrEqT3,2,0,0,0,0,0,3,0,3,0.42857142857142855,1,0.0,0,0,0,0,0,0,0,3,0,0,3,1
1762,13746,QNA44zjiZdozxT5YpeINlRZRlMKPMkhp,A3fsA9Zfv1X2fVEQhTw51lKENdNrEqT3,21,20,17,0,17,0,1,0,55,7.857142857142857,2,0.0,0,17,0,17,20,0,0,1,0,34,21,1
1763,13752,GUhU3sa7QMussHGi4kspdulqSqF9Ft42,SpATywNh6bZuzm8s1ceuBUnMUAeoAHHw,36,145,6,46,4,35,36,1,273,39.0,15,0.0,33,6,36,4,112,35,10,36,1,79,194,0
1764,13756,zx92A3etlZOmjWi19IMDYlwaWCkvF08z,SpATywNh6bZuzm8s1ceuBUnMUAeoAHHw,7,23,3,0,2,0,4,0,32,4.571428571428571,4,0.0,2,3,0,2,21,0,0,4,0,7,25,1
1765,13765,rtYqtRTnqUXb6diSp0MKjdA0eLt2BJ3X,A3fsA9Zfv1X2fVEQhTw51lKENdNrEqT3,1,0,0,0,0,0,4,0,4,0.5714285714285714,3,0.0,0,0,0,0,0,0,0,4,0,0,4,1
1766,13770,73akjB4xSPosxH1enrEsMGxNVgbw9q8A,SpATywNh6bZuzm8s1ceuBUnMUAeoAHHw,20,48,20,6,13,2,5,0,94,13.428571428571429,4,0.0,0,20,5,13,48,2,1,5,0,38,56,1
1767,13771,I1KwJ6EdCZnEPLfC8Q7yWpIkLOHn7h02,A3fsA9Zfv1X2fVEQhTw51lKENdNrEqT3,98,108,70,256,38,9,37,2,520,74.28571428571429,11,0.0,9,70,207,38,99,9,49,37,2,324,196,1
1768,13776,PUFh3BsQaDVIJMDvwsFTqkrgAzvjO9ME,A3fsA9Zfv1X2fVEQhTw51lKENdNrEqT3,23,34,23,0,9,7,20,1,94,13.428571428571429,5,0.0,1,23,0,9,33,7,0,20,1,33,61,0
1769,13783,LnPF2pHnhCMvVEpluujjfPcHsgc8Fmmk,bWdj2GDclj5ofokWjzoa5jAwMkxCykd6,1,0,0,0,0,0,1,0,1,0.14285714285714285,1,0.0,0,0,0,0,0,0,0,1,0,0,1,1
1770,13793,1Uc6kG05PFkTNzxuWvIFBwjY8EtNBPxQ,A3fsA9Zfv1X2fVEQhTw51lKENdNrEqT3,2,0,0,0,0,0,5,0,5,0.7142857142857143,2,0.0,0,0,0,0,0,0,0,5,0,0,5,1
1771,14546,82UlWF6Fm1gkNum7nNbVw0yOV1BUdNoS,7GRhBDsirIGkRZBtSMEzNTyDr2JQm4xx,61,153,62,80,35,60,16,0,406,58.0,12,0.0,75,62,65,35,78,60,15,16,0,237,169,1
1772,14552,gmqCuQTX0aljJXYwlMbQKWVNQXzJBU7z,7GRhBDsirIGkRZBtSMEzNTyDr2JQm4xx,59,72,41,0,26,21,25,2,187,26.714285714285715,6,0.0,1,41,0,26,71,21,0,25,2,68,119,0
1773,14609,Q9kdHcV1kbonm0KnIW9OSERwU5lfVZ8s,7GRhBDsirIGkRZBtSMEzNTyDr2JQm4xx,91,270,53,95,50,27,17,2,514,73.42857142857143,9,0.0,129,53,77,50,141,27,18,17,2,309,205,1
1774,14627,wXa3VpbKMQY5nmCqd1pDfzVK4mBWfzPA,7GRhBDsirIGkRZBtSMEzNTyDr2JQm4xx,5,3,1,0,0,6,5,1,16,2.2857142857142856,1,0.0,0,1,0,0,3,6,0,5,1,1,15,1
1775,14654,StcQZMEDAMldF4GFQUzkrPFNVNZnPaeq,7GRhBDsirIGkRZBtSMEzNTyDr2JQm4xx,109,417,149,196,103,64,32,7,968,138.28571428571428,9,0.0,245,149,152,103,172,64,44,32,7,649,319,0
1776,14715,WuM67GwQW9M3d1mnuGHuvAdo907S9qb5,7GRhBDsirIGkRZBtSMEzNTyDr2JQm4xx,1,0,0,0,0,0,1,0,1,0.14285714285714285,1,0.0,0,0,0,0,0,0,0,1,0,0,1,1
1777,14729,vfwAUxRdOnC4hT5Ba9e9XvBRXfww6oyg,7GRhBDsirIGkRZBtSMEzNTyDr2JQm4xx,12,7,5,0,2,0,8,1,23,3.2857142857142856,2,0.0,0,5,0,2,7,0,0,8,1,7,16,1
1778,14738,QqvzSns2WWHJJpRBF1DJin1UI4cHoJM0,7GRhBDsirIGkRZBtSMEzNTyDr2JQm4xx,53,95,24,78,27,3,14,1,242,34.57142857142857,3,0.0,51,24,69,27,44,3,9,14,1,171,71,1
1779,14744,fznl9GLBUcCuiLFhCkHOSxn8Xeb6YOkl,7GRhBDsirIGkRZBtSMEzNTyDr2JQm4xx,48,95,42,76,47,67,15,0,342,48.857142857142854,5,0.0,53,42,62,47,42,67,14,15,0,204,138,1
1780,14778,SxA4qsG4oQiVsK58JS1BnBCuBa1rQRmi,7GRhBDsirIGkRZBtSMEzNTyDr2JQm4xx,36,44,18,62,12,4,4,0,144,20.571428571428573,3,0.0,20,18,52,12,24,4,10,4,0,102,42,1
1781,14816,NJcCHbOJUQpAuhbw958dR9qCvbh6GNk7,7GRhBDsirIGkRZBtSMEzNTyDr2JQm4xx,47,101,30,57,32,0,16,0,236,33.714285714285715,7,0.0,46,30,51,32,55,0,6,16,0,159,77,1
1782,14827,qxbESUsL0xgJYJDfjiKdrZA2VpHvSkr3,7GRhBDsirIGkRZBtSMEzNTyDr2JQm4xx,35,51,18,47,19,1,4,0,140,20.0,3,0.0,29,18,41,19,22,1,6,4,0,107,33,1
1783,14832,wU9dwS3WWOQY9ZgttcIaOxUTFKpzQrwI,5X6FeZozNMgE2VRi3MJYjkkFK8SETtu2,2,0,0,0,0,0,2,0,2,0.2857142857142857,1,0.0,0,0,0,0,0,0,0,2,0,0,2,1
1784,14847,1CUoIZB9t7SxaldyOLjOrt0HiuV3YmmT,7GRhBDsirIGkRZBtSMEzNTyDr2JQm4xx,42,120,48,0,11,3,29,2,213,30.428571428571427,6,0.0,30,48,0,11,90,3,0,29,2,89,124,0
1785,14900,iG30XkTMNSFjufmkcMfMeTLCQkIO89rL,7GRhBDsirIGkRZBtSMEzNTyDr2JQm4xx,2,0,0,0,0,0,3,0,3,0.42857142857142855,1,0.0,0,0,0,0,0,0,0,3,0,0,3,1
1786,14914,V3T018M85bBO96dvqXCnq2n6MCjTou0e,5X6FeZozNMgE2VRi3MJYjkkFK8SETtu2,12,25,7,0,7,0,2,0,41,5.857142857142857,6,0.0,10,7,0,7,15,0,0,2,0,24,17,1
1787,14920,tLb8Xi221e5NaJvytwcAD3V04AqBaAZQ,7GRhBDsirIGkRZBtSMEzNTyDr2JQm4xx,25,31,11,18,12,0,6,0,78,11.142857142857142,1,0.0,16,11,17,12,15,0,1,6,0,56,22,1
1788,14931,wo4ToMqIotOBdME6IawWUY9YebACZzlB,5X6FeZozNMgE2VRi3MJYjkkFK8SETtu2,98,223,13,305,20,33,17,1,612,87.42857142857143,13,0.0,140,13,263,20,83,33,42,17,1,436,176,0
1789,14977,dIopyk7eN7utmmbDdsk2JIW9Z0tySqPS,5X6FeZozNMgE2VRi3MJYjkkFK8SETtu2,6,10,2,0,1,0,7,0,20,2.857142857142857,5,0.0,0,2,0,1,10,0,0,7,0,3,17,0
1790,15002,pjhTiut9oLwyZ0Gl3Ry1rcutvHkAHeum,5X6FeZozNMgE2VRi3MJYjkkFK8SETtu2,9,17,4,0,0,0,3,0,24,3.4285714285714284,1,0.0,4,4,0,0,13,0,0,3,0,8,16,1
1791,15020,5WZIqIqzSetVQERyKqK5gvhx5uoDAeQ9,5X6FeZozNMgE2VRi3MJYjkkFK8SETtu2,14,23,9,0,5,0,1,0,38,5.428571428571429,1,0.0,3,9,0,5,20,0,0,1,0,17,21,1
1792,15048,YUqXNrT8XQT6xSTrWrerz6EWyspe1b7c,7GRhBDsirIGkRZBtSMEzNTyDr2JQm4xx,123,331,87,273,40,44,33,0,808,115.42857142857143,11,0.0,164,87,235,40,167,44,38,33,0,526,282,0
1793,15051,KXPsJNzb3MNK5rxQc94IXJdmXF0ziWwA,7GRhBDsirIGkRZBtSMEzNTyDr2JQm4xx,1,0,0,0,0,0,1,0,1,0.14285714285714285,1,0.0,0,0,0,0,0,0,0,1,0,0,1,1
1794,15066,6vCR5MIMPnf9UWKZznVOJS5OTo4Gr7Hd,7GRhBDsirIGkRZBtSMEzNTyDr2JQm4xx,56,149,31,75,24,25,10,0,314,44.857142857142854,3,0.0,70,31,68,24,79,25,7,10,0,193,121,1
1795,15082,0ogceMBqbMfusFqG89X9sBzEnUGema9q,7GRhBDsirIGkRZBtSMEzNTyDr2JQm4xx,10,7,6,0,6,0,3,0,22,3.142857142857143,3,0.0,0,6,0,6,7,0,0,3,0,12,10,1
1796,15083,AsBtR21xGFKZ6c2LKvPTdlawgiUBcaPL,7GRhBDsirIGkRZBtSMEzNTyDr2JQm4xx,131,340,137,214,105,29,55,1,881,125.85714285714286,15,0.0,120,137,170,105,220,29,44,55,1,532,349,0
1797,15095,MJ0x5dfI1IbDZGrKNdjFdqwl7WJ8lS9F,5X6FeZozNMgE2VRi3MJYjkkFK8SETtu2,27,64,23,14,17,6,10,0,134,19.142857142857142,4,0.0,25,23,10,17,39,6,4,10,0,75,59,0
1798,15187,q36eiA77bwwsXGg05ifhgnTFDpR9Ar4V,7GRhBDsirIGkRZBtSMEzNTyDr2JQm4xx,130,287,78,249,72,14,23,0,723,103.28571428571429,5,0.0,158,78,209,72,129,14,40,23,0,517,206,0
1799,15202,ePpfrPKFmuYE4CHcpunEZ73b0FxyOz0q,7GRhBDsirIGkRZBtSMEzNTyDr2JQm4xx,57,72,26,160,19,1,8,0,286,40.857142857142854,4,0.0,36,26,138,19,36,1,22,8,0,219,67,1
1800,15240,9PiJFDewOyLmHT48JZWbbQ236haTndT7,7GRhBDsirIGkRZBtSMEzNTyDr2JQm4xx,71,240,70,89,43,13,46,3,504,72.0,14,0.0,115,70,83,43,125,13,6,46,3,311,193,1
1801,15242,CYwEz0VhssUEnyi7GLISc2cCNlhTg5eu,7GRhBDsirIGkRZBtSMEzNTyDr2JQm4xx,84,157,5,188,22,2,19,0,393,56.142857142857146,9,0.0,88,5,162,22,69,2,26,19,0,277,116,1
1802,15273,zx92A3etlZOmjWi19IMDYlwaWCkvF08z,7GRhBDsirIGkRZBtSMEzNTyDr2JQm4xx,27,81,0,43,8,17,1,0,150,21.428571428571427,1,0.0,37,0,41,8,44,17,2,1,0,86,64,1
1803,15296,S0OJjF6aof0iTnIX6lUAxekoH3m4w7V0,7GRhBDsirIGkRZBtSMEzNTyDr2JQm4xx,131,349,130,268,75,148,48,0,1018,145.42857142857142,19,0.0,179,130,227,75,170,148,41,48,0,611,407,0
1804,15339,C6xrhZPOmVH2gCVNP26gSSPka2CcwgB5,7GRhBDsirIGkRZBtSMEzNTyDr2JQm4xx,42,52,20,42,21,3,12,1,151,21.571428571428573,4,0.0,31,20,39,21,21,3,3,12,1,111,40,1
1805,15361,CrwYq2YvOe70PhTOuriN4QumcrUjBJDI,7GRhBDsirIGkRZBtSMEzNTyDr2JQm4xx,81,260,58,152,24,26,29,0,549,78.42857142857143,7,0.0,176,58,130,24,84,26,22,29,0,388,161,0
1806,15365,sDcc9eMBMovhbCv3mcSbRYupViyMpSXg,7GRhBDsirIGkRZBtSMEzNTyDr2JQm4xx,1,0,0,0,0,0,2,0,2,0.2857142857142857,1,0.0,0,0,0,0,0,0,0,2,0,0,2,1
1807,15367,nnTxxp3z9fcrPPkS4kzYDi6mu4P5bdue,7GRhBDsirIGkRZBtSMEzNTyDr2JQm4xx,80,143,52,160,34,17,34,0,440,62.857142857142854,14,0.0,69,52,137,34,74,17,23,34,0,292,148,0
1808,15373,sDcc9eMBMovhbCv3mcSbRYupViyMpSXg,5X6FeZozNMgE2VRi3MJYjkkFK8SETtu2,1,0,0,0,0,0,2,0,2,0.2857142857142857,1,0.0,0,0,0,0,0,0,0,2,0,0,2,1
1809,15393,MtAV4nOSlZRilJebONQfKIwpW2brA3ei,5X6FeZozNMgE2VRi3MJYjkkFK8SETtu2,42,235,78,8,18,4,39,1,383,54.714285714285715,14,0.0,88,78,6,18,147,4,2,39,1,190,193,0
1810,15401,9iGaqBGS5kkoXjLd87hUL2eIJMVUVKfU,7GRhBDsirIGkRZBtSMEzNTyDr2JQm4xx,4,4,1,0,0,0,4,0,9,1.2857142857142858,2,0.0,0,1,0,0,4,0,0,4,0,1,8,0
1811,15436,OURivxGQBNOdhRVXNUy5pKGguC3x3JGV,7GRhBDsirIGkRZBtSMEzNTyDr2JQm4xx,37,72,24,20,23,2,20,0,161,23.0,4,0.0,17,24,17,23,55,2,3,20,0,81,80,0
1812,15491,iKE2AmvagEBVkqWumD0qyaUU8HShKvRo,7GRhBDsirIGkRZBtSMEzNTyDr2JQm4xx,1,0,0,0,0,0,1,0,1,0.14285714285714285,1,0.0,0,0,0,0,0,0,0,1,0,0,1,0
1813,15563,VVltscgfR96aweHb5nQdD1Q7dsOwuOJz,7GRhBDsirIGkRZBtSMEzNTyDr2JQm4xx,33,42,2,41,7,2,4,0,98,14.0,3,0.0,19,2,38,7,23,2,3,4,0,66,32,0
1814,15602,kJJIE2h2w0vYBZNbvF8G6P5lWhPX9ZyA,5X6FeZozNMgE2VRi3MJYjkkFK8SETtu2,35,62,22,62,21,0,12,0,179,25.571428571428573,6,0.0,30,22,56,21,32,0,6,12,0,129,50,1
1815,15633,FjbDR3UaxcNBkb6IH3GDQCUcWtWdh8Qq,5X6FeZozNMgE2VRi3MJYjkkFK8SETtu2,57,72,23,183,15,1,8,0,302,43.142857142857146,5,0.0,36,23,151,15,36,1,32,8,0,225,77,1
1816,15641,xY5IUgrYconprXri0F5cssyTAsVeuYqD,7GRhBDsirIGkRZBtSMEzNTyDr2JQm4xx,7,18,6,0,0,0,3,0,27,3.857142857142857,2,0.0,8,6,0,0,10,0,0,3,0,14,13,1
1817,15655,jtxvuHBV8ZOgNnNCL1A1WerzR2TVfFNy,5X6FeZozNMgE2VRi3MJYjkkFK8SETtu2,56,54,17,81,3,0,9,0,164,23.428571428571427,4,0.0,29,17,80,3,25,0,1,9,0,129,35,1
1818,15694,ls88dNG7SGcb3wsgc3lZQCJwuuAQTKkF,7GRhBDsirIGkRZBtSMEzNTyDr2JQm4xx,8,14,1,0,2,0,5,0,22,3.142857142857143,3,0.0,2,1,0,2,12,0,0,5,0,5,17,1
1819,15700,p8pFuUg19xWGOlJygMvSlQjonA3l7FUn,7GRhBDsirIGkRZBtSMEzNTyDr2JQm4xx,7,6,3,0,2,0,5,0,16,2.2857142857142856,3,0.0,1,3,0,2,5,0,0,5,0,6,10,1
1820,15713,UQMPqDnQtELOyig8xWMMs5ktcYwtyCzh,7GRhBDsirIGkRZBtSMEzNTyDr2JQm4xx,51,74,39,0,34,3,19,0,169,24.142857142857142,9,0.0,2,39,0,34,72,3,0,19,0,75,94,0
1821,15716,W2ohBuN5JfRDGloM0s99vkGQJHKKrtyK,7GRhBDsirIGkRZBtSMEzNTyDr2JQm4xx,25,46,21,8,13,1,7,0,96,13.714285714285714,9,0.0,15,21,6,13,31,1,2,7,0,55,41,1
1822,15730,DTunSgXKeBHwLChUNl9RWnBhBvCOB1OP,5X6FeZozNMgE2VRi3MJYjkkFK8SETtu2,2,0,0,0,0,0,2,0,2,0.2857142857142857,1,0.0,0,0,0,0,0,0,0,2,0,0,2,1
1823,15771,HbdIEiZ1jslj2pBp8czn7lhBbxLYjtpj,7GRhBDsirIGkRZBtSMEzNTyDr2JQm4xx,122,133,39,168,22,0,10,0,372,53.142857142857146,6,0.0,79,39,168,22,54,0,0,10,0,308,64,0
1824,15804,eA8qPXDg9mAIRhOgZfPGHskw4HtvZE6Q,5X6FeZozNMgE2VRi3MJYjkkFK8SETtu2,7,6,2,0,1,0,3,0,12,1.7142857142857142,2,0.0,0,2,0,1,6,0,0,3,0,3,9,1
1825,15809,dSje9mLQSmkfjnddVAmZbSZcEblgwLyE,5X6FeZozNMgE2VRi3MJYjkkFK8SETtu2,7,6,3,0,1,0,8,0,18,2.5714285714285716,3,0.0,0,3,0,1,6,0,0,8,0,4,14,1
1826,15810,WJLMraoon9e2y7OtDk9UrQjU4oqkoa0t,7GRhBDsirIGkRZBtSMEzNTyDr2JQm4xx,52,123,72,49,45,43,27,11,370,52.857142857142854,11,0.0,24,72,40,45,99,43,9,27,11,181,189,0
1827,15814,g7u6ac7DR9jMW4aOouB4W8Gur81b4cDe,7GRhBDsirIGkRZBtSMEzNTyDr2JQm4xx,86,107,42,110,42,0,31,2,334,47.714285714285715,10,0.0,59,42,85,42,48,0,25,31,2,228,106,0
1828,15876,rrw2WJkAL0R5jcfwKMTsm56jlh9a5ial,7GRhBDsirIGkRZBtSMEzNTyDr2JQm4xx,34,73,1,55,5,9,19,0,162,23.142857142857142,5,0.0,22,1,48,5,51,9,7,19,0,76,86,1
1829,15878,468cxTIslgaJVBCubZgOneiS2rtqRqqz,7GRhBDsirIGkRZBtSMEzNTyDr2JQm4xx,7,7,1,0,1,0,1,0,10,1.4285714285714286,1,0.0,0,1,0,1,7,0,0,1,0,2,8,1
1830,15881,W8K4VS8rPvnPTNUJrqgtS2FKH93KmR91,7GRhBDsirIGkRZBtSMEzNTyDr2JQm4xx,58,157,49,73,28,3,15,0,325,46.42857142857143,7,0.0,52,49,69,28,105,3,4,15,0,198,127,1
1831,15892,MgS6WK9esRya9QyP2ZOjbNdLSIL7NuM9,5X6FeZozNMgE2VRi3MJYjkkFK8SETtu2,30,19,5,60,1,0,4,2,91,13.0,1,0.0,13,5,50,1,6,0,10,4,2,69,22,1
1832,15894,CFcaqGvFyaIYHoQBSZafTygNmgOBr9If,5X6FeZozNMgE2VRi3MJYjkkFK8SETtu2,51,69,22,71,26,0,12,0,200,28.571428571428573,6,0.0,36,22,56,26,33,0,15,12,0,140,60,0
1833,15900,MvkVXPKImqjQobZ7zCJXq4GfQ4IthLq9,7GRhBDsirIGkRZBtSMEzNTyDr2JQm4xx,110,172,45,115,40,22,30,0,424,60.57142857142857,17,0.0,61,45,113,40,111,22,2,30,0,259,165,0
1834,15906,3c8IXjLzAuM9vKLwVwPhkOijPLPnFRJ2,7GRhBDsirIGkRZBtSMEzNTyDr2JQm4xx,1,0,0,0,0,0,1,0,1,0.14285714285714285,1,0.0,0,0,0,0,0,0,0,1,0,0,1,1
1835,15912,hJo1MgKiPZFXuH2ko6hqPTd9dbjMQKDO,7GRhBDsirIGkRZBtSMEzNTyDr2JQm4xx,90,146,61,166,53,3,34,3,466,66.57142857142857,10,0.0,64,61,142,53,82,3,24,34,3,320,146,1
1836,15919,oho8eUx0qt2QgQUM9H4Puo64w9V5nVUl,7GRhBDsirIGkRZBtSMEzNTyDr2JQm4xx,118,190,70,112,70,6,38,2,488,69.71428571428571,13,0.0,98,70,106,70,92,6,6,38,2,344,144,1
1837,15922,OHdLWfOkVYVSxh9avWbeG6oGLyuN9vvx,7GRhBDsirIGkRZBtSMEzNTyDr2JQm4xx,62,134,44,99,35,27,19,0,358,51.142857142857146,6,0.0,63,44,89,35,71,27,10,19,0,231,127,1
1838,15924,pXzK9E1YOZkyyLlXWv7EKpRMBTF7x1zF,7GRhBDsirIGkRZBtSMEzNTyDr2JQm4xx,1,0,0,0,0,0,1,0,1,0.14285714285714285,1,0.0,0,0,0,0,0,0,0,1,0,0,1,1
1839,15933,T8EEyGWGKbnympgZPqbMUH0q1ogy6HvR,5X6FeZozNMgE2VRi3MJYjkkFK8SETtu2,2,0,0,0,0,0,2,0,2,0.2857142857142857,2,0.0,0,0,0,0,0,0,0,2,0,0,2,1
1840,15944,i4Ja5POFcbWsTXzyspWne0P4gq0Sndm7,7GRhBDsirIGkRZBtSMEzNTyDr2JQm4xx,29,55,21,27,9,0,13,0,125,17.857142857142858,3,0.0,30,21,22,9,25,0,5,13,0,82,43,1
1841,15947,JvcRsdOfDUJrxbmOeabeYf6ul7MDwm6b,7GRhBDsirIGkRZBtSMEzNTyDr2JQm4xx,22,25,7,19,6,0,3,0,60,8.571428571428571,3,0.0,14,7,17,6,11,0,2,3,0,44,16,1
1842,15956,wg7c1wZNHnWuQEzOFg3X7UO4UvdvZ0Nl,7GRhBDsirIGkRZBtSMEzNTyDr2JQm4xx,59,57,20,241,8,0,8,0,334,47.714285714285715,5,0.0,19,20,214,8,38,0,27,8,0,261,73,1
1843,15959,KD5stEhIDxW0wB7Mr1YVPQQ5AGRkzqAA,7GRhBDsirIGkRZBtSMEzNTyDr2JQm4xx,117,233,91,166,58,33,43,1,625,89.28571428571429,13,0.0,118,91,141,58,115,33,25,43,1,408,217,1
1844,15966,dWGIj0UEkV1WxMBYGHRsdtDhUsNSq5LC,7GRhBDsirIGkRZBtSMEzNTyDr2JQm4xx,48,134,53,26,38,9,20,1,281,40.142857142857146,10,0.0,61,53,25,38,73,9,1,20,1,177,104,0
1845,15982,yUo0f8mA9XEAtzr6kcSUh5ydpzcuIcml,7GRhBDsirIGkRZBtSMEzNTyDr2JQm4xx,57,128,32,74,29,18,26,0,307,43.857142857142854,6,0.0,61,32,66,29,67,18,8,26,0,188,119,1
1846,15987,6zXGZtvwHnFZCYFcS3Xzk5yrVH7CXdoJ,7GRhBDsirIGkRZBtSMEzNTyDr2JQm4xx,1,0,0,0,0,0,1,0,1,0.14285714285714285,1,0.0,0,0,0,0,0,0,0,1,0,0,1,1
1847,16020,ywdL3xkp7d2PSjbvnflAvIe7Wp6Q4SRe,7GRhBDsirIGkRZBtSMEzNTyDr2JQm4xx,46,147,20,108,21,0,20,0,316,45.142857142857146,7,0.0,64,20,102,21,83,0,6,20,0,207,109,1
1848,16029,aWq626ehQk5Iuuwzds6iAgtzgkimu1j2,7GRhBDsirIGkRZBtSMEzNTyDr2JQm4xx,60,91,32,130,36,2,15,0,306,43.714285714285715,6,0.0,50,32,113,36,41,2,17,15,0,231,75,1
1849,16038,NoaJNfAZAESYC7salsh3Qwaa5hC3sdBk,7GRhBDsirIGkRZBtSMEzNTyDr2JQm4xx,58,140,57,138,11,72,14,1,433,61.857142857142854,6,0.0,66,57,111,11,74,72,27,14,1,245,188,0
1850,16081,Z9zd5ft7NWbOfEUxKVShKB2Y1F3jXBm8,7GRhBDsirIGkRZBtSMEzNTyDr2JQm4xx,13,10,6,2,3,1,10,0,32,4.571428571428571,2,0.0,1,6,2,3,9,1,0,10,0,12,20,1
1851,16087,SIdEQEXoagJ5WwAcAkPtkVF6pipatiIa,7GRhBDsirIGkRZBtSMEzNTyDr2JQm4xx,101,254,69,98,56,4,19,0,500,71.42857142857143,7,0.0,79,69,83,56,175,4,15,19,0,287,213,0
1852,16091,DWloCId6fkO6Ms5BXhdCfDhm96dIK6F3,7GRhBDsirIGkRZBtSMEzNTyDr2JQm4xx,1,0,0,0,0,0,1,0,1,0.14285714285714285,1,0.0,0,0,0,0,0,0,0,1,0,0,1,1
1853,16130,nPRsjektHdbQkeAf1fIK4JbhrESPbPsA,5X6FeZozNMgE2VRi3MJYjkkFK8SETtu2,1,0,0,0,0,0,1,0,1,0.14285714285714285,1,0.0,0,0,0,0,0,0,0,1,0,0,1,0
1854,16131,cwM32Iyo8DmzSk0EybXLo5ksFWhXG4Da,7GRhBDsirIGkRZBtSMEzNTyDr2JQm4xx,79,139,39,31,42,0,9,0,260,37.142857142857146,9,0.0,79,39,21,42,60,0,10,9,0,181,79,0
1855,16134,JmlFAaRVuCFkmr6g7GLFJYPWWHADo3Vp,7GRhBDsirIGkRZBtSMEzNTyDr2JQm4xx,1,0,0,0,0,0,1,0,1,0.14285714285714285,1,0.0,0,0,0,0,0,0,0,1,0,0,1,1
1856,16168,DLDhUvvvfnnYFJuV65Zt2yaS0jPJgvzq,7GRhBDsirIGkRZBtSMEzNTyDr2JQm4xx,37,92,0,82,1,0,13,0,188,26.857142857142858,6,0.0,29,0,68,1,63,0,14,13,0,98,90,1
1857,16238,4NRUo07WkcrdRLUhlPTipY45aaERRn99,7GRhBDsirIGkRZBtSMEzNTyDr2JQm4xx,52,114,28,64,48,1,7,0,262,37.42857142857143,8,0.0,40,28,51,48,74,1,13,7,0,167,95,0
1858,16285,W8p8vrZuo5elf0zj1Aez8mTMlTcetQ7p,7GRhBDsirIGkRZBtSMEzNTyDr2JQm4xx,6,4,2,0,1,0,2,0,9,1.2857142857142858,1,0.0,0,2,0,1,4,0,0,2,0,3,6,1
1859,16289,moK1GdnqoYxhSRCf5a95lgXdVNdzYrjs,7GRhBDsirIGkRZBtSMEzNTyDr2JQm4xx,49,151,13,72,15,2,46,0,299,42.714285714285715,8,0.0,43,13,64,15,108,2,8,46,0,135,164,1
1860,16303,2WHNpOBPMmOzdjUXQIDdX6w5Bhh6AyHU,7GRhBDsirIGkRZBtSMEzNTyDr2JQm4xx,32,78,7,41,7,0,17,0,150,21.428571428571427,4,0.0,37,7,35,7,41,0,6,17,0,86,64,0
1861,16378,RjbxXw1YYmiUcedHIl1VrXvYXiS6wbOC,7GRhBDsirIGkRZBtSMEzNTyDr2JQm4xx,86,137,3,224,24,9,33,6,436,62.285714285714285,7,0.0,82,3,194,24,55,9,30,33,6,303,133,0
1862,16415,096xYyhB9kL7G6lT7J9rVrXyGNwUToLF,7GRhBDsirIGkRZBtSMEzNTyDr2JQm4xx,43,100,37,0,4,0,13,0,154,22.0,7,0.0,31,37,0,4,69,0,0,13,0,72,82,0
1863,16460,KDzfaWgTSBqeMJLFLmFuh4CMLsva9aWu,7GRhBDsirIGkRZBtSMEzNTyDr2JQm4xx,68,170,4,120,16,5,21,0,336,48.0,11,0.0,49,4,100,16,121,5,20,21,0,169,167,0
1864,16484,v1iavhjAgOftyRIIBT7pVhYkpNdcTDpm,7GRhBDsirIGkRZBtSMEzNTyDr2JQm4xx,12,11,5,0,2,1,7,1,27,3.857142857142857,3,0.0,4,5,0,2,7,1,0,7,1,11,16,1
1865,16518,VFg2AN5zsuWpHyPwDEXIcAxQpNCPCOo7,7GRhBDsirIGkRZBtSMEzNTyDr2JQm4xx,66,178,62,99,48,54,43,2,486,69.42857142857143,5,0.0,70,62,86,48,108,54,13,43,2,266,220,1
1866,16541,tDBUBIMhJEJx4Pe5n9oY4eK5G81QRmVq,7GRhBDsirIGkRZBtSMEzNTyDr2JQm4xx,126,314,79,309,90,16,18,0,826,118.0,13,0.0,142,79,276,90,172,16,33,18,0,587,239,0
1867,16559,WbPhqfwmFYggW432ooC1iHmgUJBCP9Le,7GRhBDsirIGkRZBtSMEzNTyDr2JQm4xx,125,338,146,167,134,55,73,10,923,131.85714285714286,15,0.0,163,146,145,134,175,55,22,73,10,588,335,0
1868,16582,BxR5XM6DXnDlyXChlQFtgsFNvTkRDfGo,7GRhBDsirIGkRZBtSMEzNTyDr2JQm4xx,5,4,1,0,0,0,2,0,7,1.0,1,0.0,1,1,0,0,3,0,0,2,0,2,5,1
1869,16632,uPNpQwnvEtjDufLcIcScg8qVljQjes1y,7GRhBDsirIGkRZBtSMEzNTyDr2JQm4xx,54,113,27,93,21,0,16,0,270,38.57142857142857,10,0.0,57,27,89,21,56,0,4,16,0,194,76,1
1870,16685,0OpVcmwG6bVPxKzOCpgJ9F6MfBtuGolr,5X6FeZozNMgE2VRi3MJYjkkFK8SETtu2,10,5,4,0,3,0,4,0,16,2.2857142857142856,2,0.0,0,4,0,3,5,0,0,4,0,7,9,1
1871,16696,EshSTNSaPVDLcPEwlm2e07DrZJhzPNHK,7GRhBDsirIGkRZBtSMEzNTyDr2JQm4xx,162,426,159,267,113,65,63,0,1093,156.14285714285714,13,0.0,228,159,215,113,198,65,52,63,0,715,378,0
1872,16712,5nwrdJlhASYfMmSpU3deRRqUrd3ZpMIS,7GRhBDsirIGkRZBtSMEzNTyDr2JQm4xx,6,4,2,0,1,0,4,0,11,1.5714285714285714,2,0.0,0,2,0,1,4,0,0,4,0,3,8,1
1873,16717,zwtc7XYkGr4Bhsl8UEIZlPO0o9lpzfSZ,5X6FeZozNMgE2VRi3MJYjkkFK8SETtu2,143,188,41,338,63,4,19,0,653,93.28571428571429,10,0.0,123,41,287,63,65,4,51,19,0,514,139,0
1874,16787,ntbB11ay7TxjZmHHl7KvM6m0h5FtxAHR,7GRhBDsirIGkRZBtSMEzNTyDr2JQm4xx,9,8,4,0,5,1,6,1,25,3.5714285714285716,1,0.0,3,4,0,5,5,1,0,6,1,12,13,1
1875,16828,FhnsJdRTpIANrPfAv3Fv2vn7QGHPfOsl,7GRhBDsirIGkRZBtSMEzNTyDr2JQm4xx,13,24,11,0,2,91,41,0,169,24.142857142857142,9,0.0,4,11,0,2,20,91,0,41,0,17,152,0
1876,16873,t8qBiDTvOvYmrxcVIErRuEOf38tywm6t,5X6FeZozNMgE2VRi3MJYjkkFK8SETtu2,41,73,32,64,19,7,15,0,210,30.0,8,0.0,27,32,50,19,46,7,14,15,0,128,82,1
1877,16923,oSfAVLTcGEmcT7y7OMQrYnvkkm78yh0P,7GRhBDsirIGkRZBtSMEzNTyDr2JQm4xx,113,185,70,292,56,70,17,0,690,98.57142857142857,7,0.0,96,70,250,56,89,70,42,17,0,472,218,1
1878,16957,5fUv2a4WMEi2Bc60cQo0Uzo1I7SufPfI,7GRhBDsirIGkRZBtSMEzNTyDr2JQm4xx,38,69,2,96,10,43,8,0,228,32.57142857142857,5,0.0,29,2,80,10,40,43,16,8,0,121,107,1
1879,16978,9gZpfuq1OK1diJdWcNoIpwo7QJUSplIt,7GRhBDsirIGkRZBtSMEzNTyDr2JQm4xx,56,151,65,69,29,6,33,2,355,50.714285714285715,7,0.0,72,65,63,29,79,6,6,33,2,229,126,1
1880,16979,hdKqkkWKrDzbKE9btGChBqiCfsTwp68E,7GRhBDsirIGkRZBtSMEzNTyDr2JQm4xx,13,7,5,0,0,26,18,2,58,8.285714285714286,3,0.0,0,5,0,0,7,26,0,18,2,5,53,1
1881,16984,9lksmcPg7FQE2FGQIA9VvWum1Z9DYrHM,5X6FeZozNMgE2VRi3MJYjkkFK8SETtu2,17,23,5,12,6,9,16,1,72,10.285714285714286,4,0.0,11,5,12,6,12,9,0,16,1,34,38,1
1882,16989,76mZXn9JCyY7Mb7TWPGPGPMVCvSrLgze,7GRhBDsirIGkRZBtSMEzNTyDr2JQm4xx,39,74,18,68,27,1,8,1,197,28.142857142857142,2,0.0,44,18,63,27,30,1,5,8,1,152,45,1
1883,16999,Jb792VQeMGhUz59LQDa5JysSU082aNRs,7GRhBDsirIGkRZBtSMEzNTyDr2JQm4xx,25,58,23,30,11,1,4,0,127,18.142857142857142,7,0.0,29,23,26,11,29,1,4,4,0,89,38,0
1884,17028,HF98YPKzT8oi2j9flZW9kstZcvL3ZimG,7GRhBDsirIGkRZBtSMEzNTyDr2JQm4xx,37,100,30,74,13,0,7,0,224,32.0,6,0.0,28,30,63,13,72,0,11,7,0,134,90,0
1885,17049,4i80ssNqIa74pSBDzjYYryTbL6MBe9I9,7GRhBDsirIGkRZBtSMEzNTyDr2JQm4xx,95,217,78,197,75,63,76,0,706,100.85714285714286,12,0.0,127,78,163,75,90,63,34,76,0,443,263,1
1886,17055,CxUPOQRaQMGLmbOcfniIQOhh24PXLDR6,7GRhBDsirIGkRZBtSMEzNTyDr2JQm4xx,37,144,48,34,23,13,14,2,278,39.714285714285715,19,0.0,51,48,27,23,93,13,7,14,2,149,129,0
1887,17087,f6TXZbfciBHE4LWM7x8lXiScOGpqV9US,5X6FeZozNMgE2VRi3MJYjkkFK8SETtu2,1,0,0,0,0,0,1,0,1,0.14285714285714285,1,0.0,0,0,0,0,0,0,0,1,0,0,1,1
1888,17104,oxYTAYYaR98reRev5BqLPii4AFJGZbGZ,7GRhBDsirIGkRZBtSMEzNTyDr2JQm4xx,56,118,26,135,30,6,22,1,338,48.285714285714285,7,0.0,57,26,122,30,61,6,13,22,1,235,103,1
1889,17126,jRi5kMZL8gw9VtNxiN9NAzyTyPmFUqYw,5X6FeZozNMgE2VRi3MJYjkkFK8SETtu2,7,3,2,0,2,1,12,4,24,3.4285714285714284,1,0.0,0,2,0,2,3,1,0,12,4,4,20,1
1890,17134,gtKTzkXHwS41ljYVmjlLLf4WyQSkK02q,5X6FeZozNMgE2VRi3MJYjkkFK8SETtu2,19,47,20,26,1,1,10,1,106,15.142857142857142,5,0.0,19,20,21,1,28,1,5,10,1,61,45,0
1891,17164,VJIMgDIUwiPJWjSYlLErL1YmuU1Np82d,5X6FeZozNMgE2VRi3MJYjkkFK8SETtu2,6,5,2,0,1,2,4,0,14,2.0,1,0.0,1,2,0,1,4,2,0,4,0,4,10,1
1892,17166,aJMNcTer76nTaYZZR58xtdmLr8BYq1Op,7GRhBDsirIGkRZBtSMEzNTyDr2JQm4xx,1,0,0,0,0,0,1,0,1,0.14285714285714285,1,0.0,0,0,0,0,0,0,0,1,0,0,1,1
1893,17196,uqIn0vdfJ1SDJCOeCVEAQPRFBBKQA2eB,5X6FeZozNMgE2VRi3MJYjkkFK8SETtu2,8,12,6,0,1,0,8,0,27,3.857142857142857,3,0.0,0,6,0,1,12,0,0,8,0,7,20,1
1894,17267,5nhjk1VnZY8a3OWnkRujRs0BorgiAKUm,7GRhBDsirIGkRZBtSMEzNTyDr2JQm4xx,47,96,2,204,5,29,29,2,367,52.42857142857143,8,0.0,44,2,187,5,52,29,17,29,2,238,129,1
1895,17301,cEMxPdpNr0sg7WlHPqAdbLiWdfHH1ZVi,5X6FeZozNMgE2VRi3MJYjkkFK8SETtu2,22,52,14,12,13,3,14,0,108,15.428571428571429,4,0.0,16,14,12,13,36,3,0,14,0,55,53,0
1896,17303,yhSGXw7EnYX7J3WWxRb9piBAfJaOtRLJ,7GRhBDsirIGkRZBtSMEzNTyDr2JQm4xx,80,119,42,183,23,0,7,0,374,53.42857142857143,6,0.0,57,42,163,23,62,0,20,7,0,285,89,1
1897,17332,Dy53HBwqZRiUys0tuL4RoOSu6jKEN99b,7GRhBDsirIGkRZBtSMEzNTyDr2JQm4xx,82,222,7,143,32,18,31,5,458,65.42857142857143,8,0.0,128,7,127,32,94,18,16,31,5,294,164,0
1898,17337,Jm4nQ05ndX10jbofbWx6S0r9VXrqia6S,5X6FeZozNMgE2VRi3MJYjkkFK8SETtu2,27,37,18,55,8,0,7,0,125,17.857142857142858,5,0.0,13,18,44,8,24,0,11,7,0,83,42,0
1899,17340,TilPXsBtUeInJte9nDlpbC1Ot52Vr9xD,7GRhBDsirIGkRZBtSMEzNTyDr2JQm4xx,6,8,1,0,1,0,3,0,13,1.8571428571428572,1,0.0,0,1,0,1,8,0,0,3,0,2,11,1
1900,17344,WrpEjmHODRDkmfpIc4iwJ23Oo8WNkTBQ,5X6FeZozNMgE2VRi3MJYjkkFK8SETtu2,6,9,4,0,3,2,4,0,22,3.142857142857143,2,0.0,2,4,0,3,7,2,0,4,0,9,13,1
1901,17350,3WLDG20nmrHcXqgUBcbAgxTDjIgQgeWc,7GRhBDsirIGkRZBtSMEzNTyDr2JQm4xx,1,0,0,0,0,0,1,0,1,0.14285714285714285,1,0.0,0,0,0,0,0,0,0,1,0,0,1,1
1902,17382,B9q7BVaj4oZ0WT5JELnStUq4yahYsvGS,7GRhBDsirIGkRZBtSMEzNTyDr2JQm4xx,52,182,32,68,41,13,12,0,348,49.714285714285715,9,0.0,82,32,63,41,100,13,5,12,0,218,130,1
1903,17388,QRh7ApSBJNbSH61R3OkAQmXanxVzZM0F,7GRhBDsirIGkRZBtSMEzNTyDr2JQm4xx,39,86,37,44,25,14,8,0,214,30.571428571428573,5,0.0,41,37,33,25,45,14,11,8,0,136,78,0
1904,17389,Qj89AM8R8CzDfUmyoFjU0iKz1g513ZXt,7GRhBDsirIGkRZBtSMEzNTyDr2JQm4xx,100,332,134,234,52,597,109,9,1467,209.57142857142858,14,0.0,89,134,196,52,243,597,38,109,9,471,996,1
1905,17404,XDng1mliVGDk6IontbBqBdoGZnODrUp1,5X6FeZozNMgE2VRi3MJYjkkFK8SETtu2,6,2,0,0,0,1,10,4,17,2.4285714285714284,3,0.0,0,0,0,0,2,1,0,10,4,0,17,1
1906,17419,RALsNmDC4TIWwMjDij2qj4Bbd4iRP5eW,7GRhBDsirIGkRZBtSMEzNTyDr2JQm4xx,5,2,1,0,1,0,2,0,6,0.8571428571428571,1,0.0,0,1,0,1,2,0,0,2,0,2,4,1
1907,17429,YxbZAJS4qgRwnWhCIRD2nIZdnFSzg6u2,5X6FeZozNMgE2VRi3MJYjkkFK8SETtu2,5,2,1,0,1,0,3,0,7,1.0,2,0.0,0,1,0,1,2,0,0,3,0,2,5,1
1908,17459,1Ueye4RWWjvz8urTBfWMjk9mmqk3rMDD,7GRhBDsirIGkRZBtSMEzNTyDr2JQm4xx,39,70,26,32,23,13,10,0,174,24.857142857142858,4,0.0,39,26,32,23,31,13,0,10,0,120,54,1
1909,17510,riM9GkB0ajSqpIPlVq4tRzOjk7wJ6NHE,7GRhBDsirIGkRZBtSMEzNTyDr2JQm4xx,56,135,58,95,55,4,33,1,381,54.42857142857143,8,0.0,64,58,85,55,71,4,10,33,1,262,119,0
1910,17535,0j1auVPH81fVETuSCGy4JUgrdNva23MX,7GRhBDsirIGkRZBtSMEzNTyDr2JQm4xx,10,10,3,0,2,1,5,0,21,3.0,1,0.0,0,3,0,2,10,1,0,5,0,5,16,1
1911,17536,5EqHj7Yiq3ymf3kXC9ShF9mwG40Y7dpr,7GRhBDsirIGkRZBtSMEzNTyDr2JQm4xx,6,7,1,0,1,0,2,0,11,1.5714285714285714,1,0.0,0,1,0,1,7,0,0,2,0,2,9,1
1912,17540,FAO2ZdiHLpuwiCcIDpRl8MBgRMyFcfQ2,7GRhBDsirIGkRZBtSMEzNTyDr2JQm4xx,7,6,2,0,1,1,3,0,13,1.8571428571428572,2,0.0,0,2,0,1,6,1,0,3,0,3,10,1
1913,17586,TwDUv8vbemLEqdAHMCXeJ0dOJyZMBx6V,7GRhBDsirIGkRZBtSMEzNTyDr2JQm4xx,59,143,39,103,16,9,13,0,323,46.142857142857146,7,0.0,54,39,92,16,89,9,11,13,0,201,122,0
1914,17592,87HjW3xlExsdfk3WF0s7d71nmAzoFuKE,7GRhBDsirIGkRZBtSMEzNTyDr2JQm4xx,2,0,0,0,0,0,2,0,2,0.2857142857142857,1,0.0,0,0,0,0,0,0,0,2,0,0,2,1
1915,17595,3vhCoT2dzeVdCpmcedhNzxK4VNLZ2l0r,7GRhBDsirIGkRZBtSMEzNTyDr2JQm4xx,9,5,1,0,1,0,7,1,15,2.142857142857143,2,0.0,0,1,0,1,5,0,0,7,1,2,13,1
1916,17597,dxt9lWTWbhPZn9mT70zVSi49oFElvqw6,7GRhBDsirIGkRZBtSMEzNTyDr2JQm4xx,34,64,6,74,10,1,7,0,162,23.142857142857142,5,0.0,31,6,63,10,33,1,11,7,0,110,52,1
1917,17608,3vhCoT2dzeVdCpmcedhNzxK4VNLZ2l0r,5X6FeZozNMgE2VRi3MJYjkkFK8SETtu2,2,0,0,0,0,0,4,0,4,0.5714285714285714,2,0.0,0,0,0,0,0,0,0,4,0,0,4,1
1918,17612,XarBLnhwPhERC9Lork4s2tIiSLNqD9KT,7GRhBDsirIGkRZBtSMEzNTyDr2JQm4xx,1,0,0,0,0,0,1,0,1,0.14285714285714285,1,0.0,0,0,0,0,0,0,0,1,0,0,1,1
1919,17620,5HX4czL6Sp8ee3UX2kWAHqmFW5CMMTjE,7GRhBDsirIGkRZBtSMEzNTyDr2JQm4xx,45,167,53,70,30,2,18,0,340,48.57142857142857,6,0.0,52,53,63,30,115,2,7,18,0,198,142,0
1920,17626,uol5rXltLKrhjm5SMrTU5qkZcMAMKTe6,7GRhBDsirIGkRZBtSMEzNTyDr2JQm4xx,49,102,46,96,35,23,20,1,323,46.142857142857146,6,0.0,44,46,81,35,58,23,15,20,1,206,117,1
1921,17647,f0IqI5DBlXdS6eUmVFeyauyA8dq5ftiC,7GRhBDsirIGkRZBtSMEzNTyDr2JQm4xx,23,38,19,2,10,8,6,0,83,11.857142857142858,1,0.0,5,19,2,10,33,8,0,6,0,36,47,1
1922,17652,dW2So4dhz8sFwZQzndBoTpsFa69MFo0q,7GRhBDsirIGkRZBtSMEzNTyDr2JQm4xx,1,0,0,0,0,0,1,0,1,0.14285714285714285,1,0.0,0,0,0,0,0,0,0,1,0,0,1,1
1923,17659,12sfc8OjIBcmkTHeaayvh8umY2ATBMOw,5X6FeZozNMgE2VRi3MJYjkkFK8SETtu2,8,5,3,0,1,0,6,0,15,2.142857142857143,2,0.0,0,3,0,1,5,0,0,6,0,4,11,1
1924,17660,UaSh8dwx8gnofYbXlmpqj9uYDbpJ89pX,7GRhBDsirIGkRZBtSMEzNTyDr2JQm4xx,36,144,7,52,10,42,23,0,278,39.714285714285715,8,0.0,82,7,44,10,62,42,8,23,0,143,135,0
1925,17677,7VmmzXV3A639hzlpZwrx655FqwOsl8uh,7GRhBDsirIGkRZBtSMEzNTyDr2JQm4xx,10,15,0,0,0,0,12,0,27,3.857142857142857,5,0.0,0,0,0,0,15,0,0,12,0,0,27,1
1926,17692,xndkXq03AGanha0Zu6RBymqlwrjUbtA1,7GRhBDsirIGkRZBtSMEzNTyDr2JQm4xx,10,5,2,6,3,0,5,0,21,3.0,2,0.0,2,2,6,3,3,0,0,5,0,13,8,1
1927,17706,WJVoKPfDDccrIbPzaP1iqdrTUwOdTQpf,7GRhBDsirIGkRZBtSMEzNTyDr2JQm4xx,43,101,22,4,23,6,12,2,170,24.285714285714285,2,0.0,45,22,4,23,56,6,0,12,2,94,76,1
1928,17707,8hNQWXBoItm3CRzdk0wSJDwYSfUbhUCO,7GRhBDsirIGkRZBtSMEzNTyDr2JQm4xx,48,86,23,54,19,3,5,0,190,27.142857142857142,4,0.0,40,23,45,19,46,3,9,5,0,127,63,1
1929,17754,jpXIq3stqWScWG27acYJbNKpdTmc6kli,3VkHkmOtom3jM2wCu94xgzzu1d6Dn7or,71,285,115,69,87,76,103,0,735,105.0,21,0.0,122,115,67,87,163,76,2,103,0,391,344,0
1930,17787,LhnkyJkR9hozRi5eOf0ZASlpRXuZDre9,3VkHkmOtom3jM2wCu94xgzzu1d6Dn7or,1,0,0,0,0,0,1,0,1,0.14285714285714285,1,0.0,0,0,0,0,0,0,0,1,0,0,1,1
1931,17823,FsCZ2JlPdTOKccvkXXkGRkEo9MNtfR49,3VkHkmOtom3jM2wCu94xgzzu1d6Dn7or,50,61,49,0,52,0,2,0,164,23.428571428571427,13,0.0,2,49,0,52,59,0,0,2,0,103,61,0
1932,17853,Cx9AvhpaoGF7JJ71AI7APeANc2Vipt9I,3VkHkmOtom3jM2wCu94xgzzu1d6Dn7or,54,205,95,0,60,0,21,0,381,54.42857142857143,13,0.0,7,95,0,60,198,0,0,21,0,162,219,0
1933,17876,Rs4pfmJlaHiSs2fYG1vucMoIlgnMNq35,3VkHkmOtom3jM2wCu94xgzzu1d6Dn7or,82,242,122,70,78,18,41,4,575,82.14285714285714,12,0.0,79,122,63,78,163,18,7,41,4,342,233,1
1934,17887,v6sJocXlJFeoDG1nXrmoTeUih19304GZ,3VkHkmOtom3jM2wCu94xgzzu1d6Dn7or,63,218,118,47,80,32,27,3,525,75.0,16,0.0,58,118,40,80,160,32,7,27,3,296,229,0
1935,17897,PYa4cvEoYgJqptqnFduMFw6qOph7rV1S,3VkHkmOtom3jM2wCu94xgzzu1d6Dn7or,5,4,0,0,1,0,2,0,7,1.0,1,0.0,0,0,0,1,4,0,0,2,0,1,6,1
1936,17928,bvMut7mm0xiNcIyWj0y5IqntcnEKiS1J,3VkHkmOtom3jM2wCu94xgzzu1d6Dn7or,1,0,0,0,0,0,1,0,1,0.14285714285714285,1,0.0,0,0,0,0,0,0,0,1,0,0,1,1
1937,17935,JZ8D07WpMQUIA2O2a3f2Q2gV7h70rqbC,3VkHkmOtom3jM2wCu94xgzzu1d6Dn7or,33,57,17,25,21,13,14,5,152,21.714285714285715,6,0.0,31,17,25,21,26,13,0,14,5,94,58,0
1938,18009,UEfxjgGbCSErczHqdTpEK7y3ob5jn4Gk,3VkHkmOtom3jM2wCu94xgzzu1d6Dn7or,1,0,0,0,0,0,1,0,1,0.14285714285714285,1,0.0,0,0,0,0,0,0,0,1,0,0,1,1
1939,18039,NHPpKvbnrSpxM8e1DORBWJbRCpmrxZw8,3VkHkmOtom3jM2wCu94xgzzu1d6Dn7or,98,368,169,79,72,306,122,7,1123,160.42857142857142,25,0.0,124,169,75,72,244,306,4,122,7,440,683,0
1940,18056,OjOCFzFYMRhmN0dKAwMid2Xaqedb9Byb,3VkHkmOtom3jM2wCu94xgzzu1d6Dn7or,25,21,13,0,10,0,4,0,48,6.857142857142857,3,0.0,0,13,0,10,21,0,0,4,0,23,25,0
1941,18076,d9MkkuCn04Toz7g1JpLdUJWD9xM5braA,3VkHkmOtom3jM2wCu94xgzzu1d6Dn7or,95,435,140,94,134,73,76,3,955,136.42857142857142,20,0.0,209,140,88,134,226,73,6,76,3,571,384,0
1942,18094,tRpWIQFUfZGZNpEuAzKRkssWyAFqJTs5,3VkHkmOtom3jM2wCu94xgzzu1d6Dn7or,68,129,75,24,52,16,40,1,337,48.142857142857146,13,0.0,27,75,24,52,102,16,0,40,1,178,159,0
1943,18115,DdzZ8hxB7LD572mJ80Q8pStHyEce3G8N,3VkHkmOtom3jM2wCu94xgzzu1d6Dn7or,1,0,0,0,0,0,1,0,1,0.14285714285714285,1,0.0,0,0,0,0,0,0,0,1,0,0,1,1
1944,18135,lar47ou1ATEHV2YH4cOI3oy3IuxgsIhT,3VkHkmOtom3jM2wCu94xgzzu1d6Dn7or,16,24,10,15,3,1,2,0,55,7.857142857142857,2,0.0,7,10,15,3,17,1,0,2,0,35,20,1
1945,18143,nrxFiXWjMUWPNdzxTgBy5GRAtL700fYA,3VkHkmOtom3jM2wCu94xgzzu1d6Dn7or,86,276,99,62,51,28,141,0,657,93.85714285714286,25,0.0,109,99,58,51,167,28,4,141,0,317,340,0
1946,18169,oagcmeHMGRWan9rRULVfHrzxIgyIwGhI,3VkHkmOtom3jM2wCu94xgzzu1d6Dn7or,35,60,22,38,22,23,20,8,193,27.571428571428573,5,0.0,34,22,28,22,26,23,10,20,8,106,87,1
1947,18192,aoJgXkaEB6ghw3VtYYCS6SC6JCyweCx9,3VkHkmOtom3jM2wCu94xgzzu1d6Dn7or,65,145,60,55,26,4,16,0,306,43.714285714285715,6,0.0,31,60,54,26,114,4,1,16,0,171,135,1
1948,18205,mgkR734CuGPwkjZusiDKIEITlUrFqk0v,3VkHkmOtom3jM2wCu94xgzzu1d6Dn7or,6,8,5,0,3,1,7,0,24,3.4285714285714284,3,0.0,0,5,0,3,8,1,0,7,0,8,16,1
1949,18212,uGhfznzXOPt7LKNhqHKFI7ETQMarwh4W,3VkHkmOtom3jM2wCu94xgzzu1d6Dn7or,32,85,39,45,22,43,16,4,254,36.285714285714285,6,0.0,32,39,38,22,53,43,7,16,4,131,123,0
1950,18214,fBUstayd9IBoQWzWS7yo0s9kWc5pQmPM,3VkHkmOtom3jM2wCu94xgzzu1d6Dn7or,1,0,0,0,0,0,1,0,1,0.14285714285714285,1,0.0,0,0,0,0,0,0,0,1,0,0,1,1
1951,18220,j5XgrOAxRxENrCOne236prVqUgGjIY7N,3VkHkmOtom3jM2wCu94xgzzu1d6Dn7or,73,143,64,48,52,12,50,5,374,53.42857142857143,8,0.0,55,64,43,52,88,12,5,50,5,214,160,0
1952,18231,w79oIXxJA51xRJ7RWNha0P7ISQqedK5M,3VkHkmOtom3jM2wCu94xgzzu1d6Dn7or,54,77,39,0,29,0,20,0,165,23.571428571428573,9,0.0,6,39,0,29,71,0,0,20,0,74,91,1
1953,18240,OKzPg2IoKpUrxLcbcmTCXAiAOnBotolX,3VkHkmOtom3jM2wCu94xgzzu1d6Dn7or,65,296,64,70,72,115,47,0,664,94.85714285714286,13,0.0,124,64,62,72,172,115,8,47,0,322,342,0
1954,18270,s0mBlRwUxx5kP9aOdegyh1ySJrjQirTH,3VkHkmOtom3jM2wCu94xgzzu1d6Dn7or,30,62,22,14,25,3,2,0,128,18.285714285714285,3,0.0,35,22,12,25,27,3,2,2,0,94,34,1
1955,18289,7w9CunRH9hyQPA1xx2b3RiIHMXEv8N1y,3VkHkmOtom3jM2wCu94xgzzu1d6Dn7or,5,4,1,0,1,0,2,0,8,1.1428571428571428,1,0.0,1,1,0,1,3,0,0,2,0,3,5,1
1956,18310,cuXvmIw1hv6FEoYwQfwDU7O59pSpyB17,3VkHkmOtom3jM2wCu94xgzzu1d6Dn7or,11,22,11,0,0,0,2,0,35,5.0,3,0.0,2,11,0,0,20,0,0,2,0,13,22,1
1957,18382,fwORcHM9hBLMMJD62wvWtWoKD86AwAls,3VkHkmOtom3jM2wCu94xgzzu1d6Dn7or,81,199,56,33,66,3,25,1,383,54.714285714285715,13,0.0,106,56,32,66,93,3,1,25,1,260,123,0
1958,18413,2UIdqPRKpgTkXkubY12P5suWz65Jis6l,3VkHkmOtom3jM2wCu94xgzzu1d6Dn7or,54,214,84,97,0,103,38,9,545,77.85714285714286,18,0.0,105,84,94,0,109,103,3,38,9,283,262,0
1959,18416,s1ZG3pi1BtIXGlTEtKkgdFf84oYE79H2,3VkHkmOtom3jM2wCu94xgzzu1d6Dn7or,2,0,0,0,0,0,4,0,4,0.5714285714285714,1,0.0,0,0,0,0,0,0,0,4,0,0,4,1
1960,18418,WSRqaiZltcPtf2Ni0Fz3XVfyHdHabSkZ,3VkHkmOtom3jM2wCu94xgzzu1d6Dn7or,8,5,3,0,2,0,4,0,14,2.0,2,0.0,0,3,0,2,5,0,0,4,0,5,9,1
1961,18437,fshVdX7gogS9amjUUfvMRuuVgkpjuXnx,3VkHkmOtom3jM2wCu94xgzzu1d6Dn7or,9,10,3,0,0,0,13,2,28,4.0,2,0.0,0,3,0,0,10,0,0,13,2,3,25,1
1962,18440,aA2T9FUjPC32yfraIt7WIwEwoZxlGYcd,3VkHkmOtom3jM2wCu94xgzzu1d6Dn7or,7,13,1,0,0,0,3,0,17,2.4285714285714284,1,0.0,0,1,0,0,13,0,0,3,0,1,16,1
1963,18449,lIdwZfZp6F2QvlXA6VMlrlG2EDx3wbA6,3VkHkmOtom3jM2wCu94xgzzu1d6Dn7or,1,0,0,0,0,0,1,0,1,0.14285714285714285,1,0.0,0,0,0,0,0,0,0,1,0,0,1,1
1964,18467,JFydRlh3r5b6TgtatAKjLqxhaGea1l2v,3VkHkmOtom3jM2wCu94xgzzu1d6Dn7or,61,143,40,30,38,34,24,10,319,45.57142857142857,11,0.0,81,40,30,38,62,34,0,24,10,189,130,1
1965,18475,m9cr9bC1ceLP6JRtqXmb61EDIFHQCdkt,3VkHkmOtom3jM2wCu94xgzzu1d6Dn7or,1,0,0,0,0,0,1,0,1,0.14285714285714285,1,0.0,0,0,0,0,0,0,0,1,0,0,1,1
1966,18476,XtUtchk5ogUiIURmIZQdHpNh2PWn3RnP,3VkHkmOtom3jM2wCu94xgzzu1d6Dn7or,7,7,5,0,2,3,3,0,20,2.857142857142857,1,0.0,0,5,0,2,7,3,0,3,0,7,13,1
1967,18489,IKnWhfStgn6HzF4rCtxpMA6vaE95bkoN,3VkHkmOtom3jM2wCu94xgzzu1d6Dn7or,84,201,81,63,74,44,21,9,493,70.42857142857143,9,0.0,98,81,56,74,103,44,7,21,9,309,184,0
1968,18495,ztJdAnCpBgEgLx5fhRggF88Y3Pxlvyek,3VkHkmOtom3jM2wCu94xgzzu1d6Dn7or,1,0,0,0,0,0,1,0,1,0.14285714285714285,1,0.0,0,0,0,0,0,0,0,1,0,0,1,1
1969,18524,p6hc44NeJi1WiSZUn5CvpCCXiZFi44WN,3VkHkmOtom3jM2wCu94xgzzu1d6Dn7or,5,9,2,0,3,2,5,0,21,3.0,2,0.0,6,2,0,3,3,2,0,5,0,11,10,0
1970,18538,5cBPq51N9I9AzXHlHIBSLnKPdUzCIUfc,3VkHkmOtom3jM2wCu94xgzzu1d6Dn7or,5,3,2,0,2,0,2,0,9,1.2857142857142858,1,0.0,0,2,0,2,3,0,0,2,0,4,5,1
1971,18564,hRh2Y2Uw5YLe8i2fkEP0Vgw7w0oqTBB3,3VkHkmOtom3jM2wCu94xgzzu1d6Dn7or,17,18,10,0,7,0,9,0,44,6.285714285714286,6,0.0,0,10,0,7,18,0,0,9,0,17,27,0
1972,18575,EJPF6XlYz9cFyfNK7rmmfSFxHr2AsPXh,3VkHkmOtom3jM2wCu94xgzzu1d6Dn7or,10,14,4,0,1,3,8,3,33,4.714285714285714,2,0.0,6,4,0,1,8,3,0,8,3,11,22,1
1973,18576,x9eE2t1pkeexbvLs88HZIiFp0JGQqsVU,3VkHkmOtom3jM2wCu94xgzzu1d6Dn7or,53,78,45,6,33,83,26,2,273,39.0,7,0.0,21,45,3,33,57,83,3,26,2,102,171,0
1974,18603,87SYGQjFYUtEWda0pG12bcNker0JGBy3,3VkHkmOtom3jM2wCu94xgzzu1d6Dn7or,59,156,27,34,40,34,29,1,321,45.857142857142854,11,0.0,78,27,33,40,78,34,1,29,1,178,143,1
1975,18606,UMhqMBvNkRDXsJUWPwy4GcSQoSlGBO8t,3VkHkmOtom3jM2wCu94xgzzu1d6Dn7or,9,13,8,0,6,0,9,1,37,5.285714285714286,2,0.0,2,8,0,6,11,0,0,9,1,16,21,0
1976,18622,RnOkMifE6IabhEJlmNQOUk0wV82RqPXX,3VkHkmOtom3jM2wCu94xgzzu1d6Dn7or,18,38,14,6,9,10,10,1,88,12.571428571428571,6,0.0,15,14,6,9,23,10,0,10,1,44,44,1
1977,18647,vgENoZ7IMNHQOATqRlfRe4wFSridKoir,3VkHkmOtom3jM2wCu94xgzzu1d6Dn7or,21,26,12,18,7,9,14,1,87,12.428571428571429,5,0.0,6,12,15,7,20,9,3,14,1,40,47,1
1978,18668,knDHPR8YfOkLpXHV6I75VqEUj60nQPXN,3VkHkmOtom3jM2wCu94xgzzu1d6Dn7or,5,2,1,0,1,0,2,0,6,0.8571428571428571,1,0.0,0,1,0,1,2,0,0,2,0,2,4,1
1979,18695,gBHaHbn79faxGc3HZ5WWWEq0qMpof2nV,3VkHkmOtom3jM2wCu94xgzzu1d6Dn7or,10,22,9,0,4,4,24,1,64,9.142857142857142,4,0.0,7,9,0,4,15,4,0,24,1,20,44,1
1980,18734,JfQVgXDVu1NGs9lcRBOD4w6V7BSaZCc2,3VkHkmOtom3jM2wCu94xgzzu1d6Dn7or,81,204,63,49,74,77,42,1,510,72.85714285714286,7,0.0,114,63,47,74,90,77,2,42,1,298,212,0
1981,18762,5b9C3riGM9XWa3qjobB2XvMXtZIZEhOi,3VkHkmOtom3jM2wCu94xgzzu1d6Dn7or,9,15,8,2,7,0,3,0,35,5.0,2,0.0,4,8,2,7,11,0,0,3,0,21,14,1
1982,18854,PFJhF2sNLYftHHb21pjL43RM5viviTlT,3VkHkmOtom3jM2wCu94xgzzu1d6Dn7or,96,206,67,91,71,40,21,0,496,70.85714285714286,17,0.0,113,67,78,71,93,40,13,21,0,329,167,0
1983,18894,P2xHl8oxJOV4TMoYrxym6L2dPSAdMMJs,3VkHkmOtom3jM2wCu94xgzzu1d6Dn7or,97,300,98,47,105,99,91,9,749,107.0,21,0.0,84,98,43,105,216,99,4,91,9,330,419,0
1984,18920,SvayS3hRjiQUsZJZ3Z80XuRW7pnvNCGH,3VkHkmOtom3jM2wCu94xgzzu1d6Dn7or,2,0,0,0,0,0,5,0,5,0.7142857142857143,2,0.0,0,0,0,0,0,0,0,5,0,0,5,1
1985,18936,O0GD5bq4HX44FjCMV4VF4e6soOzsH9jU,3VkHkmOtom3jM2wCu94xgzzu1d6Dn7or,42,45,20,0,22,1,6,0,94,13.428571428571429,2,0.0,23,20,0,22,22,1,0,6,0,65,29,0
1986,18949,LAYouz4itNZzvPmshvKiqSMh0zjmZcQO,3VkHkmOtom3jM2wCu94xgzzu1d6Dn7or,1,0,0,0,0,0,1,0,1,0.14285714285714285,1,0.0,0,0,0,0,0,0,0,1,0,0,1,1
1987,18964,mUI8TGZDkA6o3xg0ZzjcBPw1a3PiNc4S,3VkHkmOtom3jM2wCu94xgzzu1d6Dn7or,32,49,34,0,17,3,13,1,117,16.714285714285715,7,0.0,0,34,0,17,49,3,0,13,1,51,66,1
1988,19021,NW8TWIfI5QyCDlKS0XzM26mCFAnY0gAl,3VkHkmOtom3jM2wCu94xgzzu1d6Dn7or,62,202,37,98,86,16,17,1,457,65.28571428571429,6,0.0,150,37,87,86,52,16,11,17,1,360,97,0
1989,19029,w1HLpf01ff60tSyrkRwOPpdSlz3uqa1C,3VkHkmOtom3jM2wCu94xgzzu1d6Dn7or,83,290,100,87,60,55,90,7,689,98.42857142857143,15,0.0,72,100,80,60,218,55,7,90,7,312,377,0
1990,19034,3dNtOnVHtGbnIgpNEyiNdWuRrG9P1yCf,3VkHkmOtom3jM2wCu94xgzzu1d6Dn7or,1,0,0,0,0,0,1,0,1,0.14285714285714285,1,0.0,0,0,0,0,0,0,0,1,0,0,1,1
1991,19091,LHYSNVzTYxm5IcNgKgLIwIeMHKVsmlIb,3VkHkmOtom3jM2wCu94xgzzu1d6Dn7or,9,4,3,0,3,0,7,0,17,2.4285714285714284,1,0.0,0,3,0,3,4,0,0,7,0,6,11,1
1992,19094,DN3ijWfAAWPn1I6Iktij5lvXWwKiG3wC,3VkHkmOtom3jM2wCu94xgzzu1d6Dn7or,11,10,8,0,8,0,2,0,28,4.0,2,0.0,0,8,0,8,10,0,0,2,0,16,12,1
1993,19097,WK0Fgs86cA55qEjGdACCPsAyup9yYjBW,3VkHkmOtom3jM2wCu94xgzzu1d6Dn7or,32,51,30,0,22,0,7,0,110,15.714285714285714,7,0.0,2,30,0,22,49,0,0,7,0,54,56,1
1994,19107,FW47VC0lzmys2S4k8Ky52JrXCSFDeyeP,3VkHkmOtom3jM2wCu94xgzzu1d6Dn7or,73,128,46,32,54,31,26,4,321,45.857142857142854,8,0.0,69,46,29,54,59,31,3,26,4,198,123,1
1995,19145,keNewYvbzg2eq90KcSOtX7Zs6BZix0S4,3VkHkmOtom3jM2wCu94xgzzu1d6Dn7or,29,27,17,0,11,0,7,0,62,8.857142857142858,5,0.0,0,17,0,11,27,0,0,7,0,28,34,1
1996,19168,zawgO73Gsv9yYg2M5PPEY7ml7DGDBXeG,3VkHkmOtom3jM2wCu94xgzzu1d6Dn7or,79,205,42,86,89,3,17,0,442,63.142857142857146,10,0.0,147,42,82,89,58,3,4,17,0,360,82,0
1997,19172,uTiNrDEvARQcGfWGjFfdSPVTMmffLSmO,3VkHkmOtom3jM2wCu94xgzzu1d6Dn7or,5,2,1,0,1,0,3,0,7,1.0,2,0.0,0,1,0,1,2,0,0,3,0,2,5,1
1998,19180,iMUfXfktcNKkoRB8LhQL6ubljgtzU5l7,3VkHkmOtom3jM2wCu94xgzzu1d6Dn7or,41,59,29,18,26,5,10,1,148,21.142857142857142,5,0.0,23,29,18,26,36,5,0,10,1,96,52,0
1999,19189,i0UAMwrjj2eXydsjRtQeHBmAMB3Ngwx3,3VkHkmOtom3jM2wCu94xgzzu1d6Dn7or,93,403,96,116,70,56,40,10,791,113.0,19,0.0,142,96,108,70,261,56,8,40,10,416,375,0
2000,19275,wKSiPD3ccCI47tDYWhx56Wd2BJP8ki2L,3VkHkmOtom3jM2wCu94xgzzu1d6Dn7or,64,212,85,60,54,61,29,9,510,72.85714285714286,12,0.0,61,85,58,54,151,61,2,29,9,258,252,0
2001,19306,VeyQb2wjeKBwS5o1xUeVWgY5Rkx9xBBK,3VkHkmOtom3jM2wCu94xgzzu1d6Dn7or,1,0,0,0,0,0,2,0,2,0.2857142857142857,1,0.0,0,0,0,0,0,0,0,2,0,0,2,1
2002,19308,KXJnaxosaVPcYuL44D7XWQrAPgd4UcKI,3VkHkmOtom3jM2wCu94xgzzu1d6Dn7or,1,0,0,0,0,0,1,0,1,0.14285714285714285,1,0.0,0,0,0,0,0,0,0,1,0,0,1,1
2003,19311,g5MFP90eHpeTFJhybJGejVaFL9uzOmxA,3VkHkmOtom3jM2wCu94xgzzu1d6Dn7or,10,15,0,12,3,0,2,0,32,4.571428571428571,1,0.0,6,0,12,3,9,0,0,2,0,21,11,1
2004,19326,oDANnbslKtpJTEtMR0SEpxqs6e5prqji,3VkHkmOtom3jM2wCu94xgzzu1d6Dn7or,1,0,0,0,0,0,1,0,1,0.14285714285714285,1,0.0,0,0,0,0,0,0,0,1,0,0,1,1
2005,19332,MNCx7q5SQrMnv8bXtByddRfIhVZZxjUi,3VkHkmOtom3jM2wCu94xgzzu1d6Dn7or,22,90,11,8,1,10,20,0,140,20.0,9,0.0,14,11,7,1,76,10,1,20,0,33,107,0
2006,19335,6hTHLv2ACZhw5sTOpdEFsUQMXrnQn22A,3VkHkmOtom3jM2wCu94xgzzu1d6Dn7or,61,159,47,39,48,20,38,0,351,50.142857142857146,19,0.0,50,47,36,48,109,20,3,38,0,181,170,0
2007,19336,FxmtjLZTfKrDuIUJj9RfT2CnreuIYYsu,3VkHkmOtom3jM2wCu94xgzzu1d6Dn7or,8,7,4,0,2,25,6,1,45,6.428571428571429,3,0.0,0,4,0,2,7,25,0,6,1,6,39,1
2008,19358,JOddnojV0OZrysgzYsnxzhRLS1r6GCxl,3VkHkmOtom3jM2wCu94xgzzu1d6Dn7or,55,85,41,0,25,3,23,0,177,25.285714285714285,18,0.0,8,41,0,25,77,3,0,23,0,74,103,0
2009,19393,VDLlgOqW7FFpT6uHqFXXlnnZR1JOz0x8,3VkHkmOtom3jM2wCu94xgzzu1d6Dn7or,5,3,2,0,2,0,2,0,9,1.2857142857142858,2,0.0,0,2,0,2,3,0,0,2,0,4,5,1
2010,19395,vPZXChPcICCkmHJapo4eBCyfswBI2wT1,3VkHkmOtom3jM2wCu94xgzzu1d6Dn7or,6,2,1,0,1,0,3,0,7,1.0,1,0.0,0,1,0,1,2,0,0,3,0,2,5,1
2011,19410,oSXgzDEY9r915L5ut60Q5zxaEaVixNX9,3VkHkmOtom3jM2wCu94xgzzu1d6Dn7or,90,164,82,55,38,61,37,1,438,62.57142857142857,23,0.0,51,82,47,38,113,61,8,37,1,218,220,0
2012,19415,Gb5o1t4cOlCs6CgHMjwZyTBBHE9KEmzH,3VkHkmOtom3jM2wCu94xgzzu1d6Dn7or,77,92,51,83,39,2,10,4,281,40.142857142857146,6,0.0,35,51,66,39,57,2,17,10,4,191,90,0
2013,19420,DeBpDi71FBvOLpvPeVZCUQOI7dk3TqCp,3VkHkmOtom3jM2wCu94xgzzu1d6Dn7or,3,8,2,0,0,0,1,0,11,1.5714285714285714,1,0.0,3,2,0,0,5,0,0,1,0,5,6,1
2014,19432,itwm4TVODOBqFpKY29D8QUWf1nvyYrio,3VkHkmOtom3jM2wCu94xgzzu1d6Dn7or,79,212,67,67,66,5,33,0,450,64.28571428571429,7,0.0,94,67,60,66,118,5,7,33,0,287,163,0
2015,19440,5VHsEf8JXNm7KJFeH5RI83NlCJ748PxF,3VkHkmOtom3jM2wCu94xgzzu1d6Dn7or,19,28,4,7,4,0,3,0,46,6.571428571428571,2,0.0,10,4,7,4,18,0,0,3,0,25,21,1
2016,19577,udnRYxurswpE4GUZcnc80kafg0hn3fpz,fbPkOYLVPtPgIt0MxizjfFJov3JbHyAi,1,0,0,0,0,0,1,0,1,0.14285714285714285,1,0.0,0,0,0,0,0,0,0,1,0,0,1,1
2017,19578,8o4E9PO3r20M8IPbGHnn7ry81or8oVUd,fbPkOYLVPtPgIt0MxizjfFJov3JbHyAi,5,4,1,0,1,0,2,0,8,1.1428571428571428,1,0.0,0,1,0,1,4,0,0,2,0,2,6,1
2018,19579,mK2PenVNfwXeBJzi7mP3HzWchd5fxecA,fbPkOYLVPtPgIt0MxizjfFJov3JbHyAi,7,5,2,0,1,4,8,0,20,2.857142857142857,3,0.0,0,2,0,1,5,4,0,8,0,3,17,1
2019,19580,3W09pasLSoDWuQqGyvECJ7WiykG165j2,fbPkOYLVPtPgIt0MxizjfFJov3JbHyAi,17,64,18,5,4,31,14,0,136,19.428571428571427,7,0.0,9,18,4,4,55,31,1,14,0,35,101,1
2020,19581,VHVVDsLJTPPR7rfPiJMrbsUMa6RdDEDz,fbPkOYLVPtPgIt0MxizjfFJov3JbHyAi,1,0,0,0,0,0,2,0,2,0.2857142857142857,1,0.0,0,0,0,0,0,0,0,2,0,0,2,1
2021,19582,0YyuZCZ9YG2n31hPJCi1E2GmCt5JQVnE,fbPkOYLVPtPgIt0MxizjfFJov3JbHyAi,7,3,2,0,2,2,3,0,12,1.7142857142857142,1,0.0,0,2,0,2,3,2,0,3,0,4,8,0
2022,19584,svaRJHaQGfUR34JQvStVpv5jX9kWWhlQ,fbPkOYLVPtPgIt0MxizjfFJov3JbHyAi,7,5,2,0,2,0,3,0,12,1.7142857142857142,1,0.0,0,2,0,2,5,0,0,3,0,4,8,1
2023,19586,z5Htt0utseDft2JjH8T5zYokNhpAiHNE,fbPkOYLVPtPgIt0MxizjfFJov3JbHyAi,11,31,0,0,5,23,8,0,67,9.571428571428571,3,0.0,14,0,0,5,17,23,0,8,0,19,48,0
2024,19587,I45Q3yivyiRN2kHVhbV8bUCfrXvtpUvU,fbPkOYLVPtPgIt0MxizjfFJov3JbHyAi,9,7,5,0,4,0,7,0,23,3.2857142857142856,1,0.0,0,5,0,4,7,0,0,7,0,9,14,1
2025,19588,EFioWHTkYv074j9vSFY7qmw2MvFzZ0mo,fbPkOYLVPtPgIt0MxizjfFJov3JbHyAi,67,147,61,58,47,91,39,1,444,63.42857142857143,15,0.0,62,61,47,47,85,91,11,39,1,217,227,0
2026,19589,SgWqRh3XmeJpz6RfUb8yXu2ZkH0AleuJ,fbPkOYLVPtPgIt0MxizjfFJov3JbHyAi,9,9,1,0,0,10,7,1,28,4.0,2,0.0,1,1,0,0,8,10,0,7,1,2,26,1
2027,19591,I91CCtQfetYUPwkEXIvTFBP6tbrp1spN,fbPkOYLVPtPgIt0MxizjfFJov3JbHyAi,27,85,48,20,18,0,21,0,192,27.428571428571427,15,0.0,11,48,16,18,74,0,4,21,0,93,99,0
2028,19592,dl33BYrB63jF9H7InuQDxo3dQrVdjLGV,fbPkOYLVPtPgIt0MxizjfFJov3JbHyAi,7,3,2,0,2,0,4,0,11,1.5714285714285714,1,0.0,0,2,0,2,3,0,0,4,0,4,7,1
2029,19593,sYGG7Hl1IcaeWwJigpwVXXbQKD0HFEPn,fbPkOYLVPtPgIt0MxizjfFJov3JbHyAi,10,10,7,0,5,0,4,0,26,3.7142857142857144,2,0.0,1,7,0,5,9,0,0,4,0,13,13,1
2030,19595,b3ktGBnxedY4iAdFYIyjERgRCauTInkK,fbPkOYLVPtPgIt0MxizjfFJov3JbHyAi,12,30,13,2,8,48,17,2,120,17.142857142857142,3,0.0,10,13,2,8,20,48,0,17,2,33,87,1
2031,19597,wFWVvTUKN4Nj5vWrbX5PVi6EvLKq8sqa,fbPkOYLVPtPgIt0MxizjfFJov3JbHyAi,24,54,18,29,27,0,5,0,133,19.0,2,0.0,32,18,22,27,22,0,7,5,0,99,34,1
2032,19598,rUHwInfwrT2VCsoj7SngGENcoxIrK2aA,fbPkOYLVPtPgIt0MxizjfFJov3JbHyAi,41,139,39,51,36,97,36,7,405,57.857142857142854,9,0.0,78,39,41,36,61,97,10,36,7,194,211,1
2033,19599,QZNGHI9TocOuANx6bTOdMFrqzeb0fTw3,fbPkOYLVPtPgIt0MxizjfFJov3JbHyAi,1,0,0,0,0,0,1,0,1,0.14285714285714285,1,0.0,0,0,0,0,0,0,0,1,0,0,1,1
2034,19600,YCZ0HSNcZja1vuapbZTjyZlLagijA85V,fbPkOYLVPtPgIt0MxizjfFJov3JbHyAi,7,3,2,0,2,0,3,0,10,1.4285714285714286,1,0.0,0,2,0,2,3,0,0,3,0,4,6,1
2035,19601,gpUff0gJHSKcQDbNnT6UR6klN9yWn4B3,fbPkOYLVPtPgIt0MxizjfFJov3JbHyAi,17,27,12,12,10,1,7,0,69,9.857142857142858,2,0.0,8,12,9,10,19,1,3,7,0,39,30,1
2036,19602,cxXfR155NqvzoUrJxE0tct65N6OEUGW3,fbPkOYLVPtPgIt0MxizjfFJov3JbHyAi,2,0,0,0,0,0,3,0,3,0.42857142857142855,1,0.0,0,0,0,0,0,0,0,3,0,0,3,1
2037,19603,0VxsYnODhio1aXODkLqOGQB4NYdClGaT,fbPkOYLVPtPgIt0MxizjfFJov3JbHyAi,2,1,0,0,0,0,1,0,2,0.2857142857142857,1,0.0,0,0,0,0,1,0,0,1,0,0,2,1
2038,19604,1EQy9mKBCgbz8jG2K6f93LU9GKq65V9v,fbPkOYLVPtPgIt0MxizjfFJov3JbHyAi,7,3,1,0,2,0,3,0,9,1.2857142857142858,1,0.0,0,1,0,2,3,0,0,3,0,3,6,1
2039,19606,CLH6KVxeKfUu9lbHyFm5yc6Qf4HvLCyR,fbPkOYLVPtPgIt0MxizjfFJov3JbHyAi,2,0,0,0,0,0,8,0,8,1.1428571428571428,2,0.0,0,0,0,0,0,0,0,8,0,0,8,1
2040,19607,BCPOhUa2LrfH93ebCE15VbF0VEWEyi7T,fbPkOYLVPtPgIt0MxizjfFJov3JbHyAi,9,5,3,0,2,10,4,1,25,3.5714285714285716,2,0.0,0,3,0,2,5,10,0,4,1,5,20,1
2041,19609,hSrmLZQ0ouEuE46yYppuvpfSWmkaTAsV,fbPkOYLVPtPgIt0MxizjfFJov3JbHyAi,8,5,2,0,2,0,5,0,14,2.0,2,0.0,0,2,0,2,5,0,0,5,0,4,10,1
2042,19610,kLgTb4zs1DK0fasndFOTstbWViutnXRG,fbPkOYLVPtPgIt0MxizjfFJov3JbHyAi,17,37,18,11,12,3,17,2,100,14.285714285714286,3,0.0,11,18,9,12,26,3,2,17,2,50,50,1
2043,19611,jmpbNsd2zzToMH9HZWx8NTyZ25PfYydC,fbPkOYLVPtPgIt0MxizjfFJov3JbHyAi,10,8,5,0,4,7,5,0,29,4.142857142857143,2,0.0,0,5,0,4,8,7,0,5,0,9,20,1
2044,19612,XVNXZTDLYViPgXZBTcX5RWMvf5SNK18Y,fbPkOYLVPtPgIt0MxizjfFJov3JbHyAi,18,14,10,0,9,0,4,0,37,5.285714285714286,3,0.0,0,10,0,9,14,0,0,4,0,19,18,1
2045,19615,y9ukbIQfB4L7zn5UoeGfcZjZUqTsQsJk,fbPkOYLVPtPgIt0MxizjfFJov3JbHyAi,6,3,2,0,2,3,1,0,11,1.5714285714285714,1,0.0,0,2,0,2,3,3,0,1,0,4,7,1
2046,19616,kyJzGSg3elXhPrIWM8rkZuAZv6RhnLQu,fbPkOYLVPtPgIt0MxizjfFJov3JbHyAi,29,73,49,4,21,91,11,2,251,35.857142857142854,7,0.0,1,49,3,21,72,91,1,11,2,74,177,1
2047,19617,FcPFK6OTsUF1j3uNGabdzGTvbY8kcO3D,fbPkOYLVPtPgIt0MxizjfFJov3JbHyAi,7,20,0,0,2,0,4,0,26,3.7142857142857144,2,0.0,4,0,0,2,16,0,0,4,0,6,20,1
2048,19620,wbbNGhodAmSlYSg7ZSWYtWMdb0rjLgRw,fbPkOYLVPtPgIt0MxizjfFJov3JbHyAi,13,13,7,2,5,8,6,0,41,5.857142857142857,2,0.0,1,7,2,5,12,8,0,6,0,15,26,1
2049,19621,P7cWTzqHbKs2w7IhW7Eb0IWuvmS7VHHm,fbPkOYLVPtPgIt0MxizjfFJov3JbHyAi,84,252,113,72,94,112,30,2,675,96.42857142857143,10,0.0,122,113,67,94,130,112,5,30,2,396,279,0
2050,19622,qGzhVjTxktnI3gvlHnV7uXSPz6cASHXn,fbPkOYLVPtPgIt0MxizjfFJov3JbHyAi,11,10,5,0,4,13,8,1,41,5.857142857142857,4,0.0,0,5,0,4,10,13,0,8,1,9,32,1
2051,19623,GDKy1KAMQHkxWaQDYOeRxnEA0ZpODsn0,fbPkOYLVPtPgIt0MxizjfFJov3JbHyAi,7,3,2,0,2,10,6,0,23,3.2857142857142856,2,0.0,0,2,0,2,3,10,0,6,0,4,19,1
2052,19624,2we3WxltFBT1dd0FjP3YZ8iHf2xpHEei,fbPkOYLVPtPgIt0MxizjfFJov3JbHyAi,8,16,5,0,4,7,5,0,37,5.285714285714286,5,0.0,4,5,0,4,12,7,0,5,0,13,24,1
2053,19626,HnvxqugChFN5yjBU90JTvP996KYT36S0,fbPkOYLVPtPgIt0MxizjfFJov3JbHyAi,26,86,38,11,14,45,24,2,220,31.428571428571427,6,0.0,30,38,10,14,56,45,1,24,2,92,128,1
2054,19627,aNviqaUsa8tjM9b6nMwh7ketdx2tdX99,fbPkOYLVPtPgIt0MxizjfFJov3JbHyAi,1,0,0,0,0,0,1,0,1,0.14285714285714285,1,0.0,0,0,0,0,0,0,0,1,0,0,1,1
2055,19629,G0JgmTQ55TeK9aeblJVq6TYQNTXqJFIQ,fbPkOYLVPtPgIt0MxizjfFJov3JbHyAi,17,32,15,14,9,0,7,0,77,11.0,6,0.0,3,15,12,9,29,0,2,7,0,39,38,1
2056,19630,peOW1xVaKPULFrN5Gy7l1puUz8vUwyZz,fbPkOYLVPtPgIt0MxizjfFJov3JbHyAi,6,9,5,0,1,12,5,0,32,4.571428571428571,2,0.0,0,5,0,1,9,12,0,5,0,6,26,1
2057,19631,8skbDsuebvai4ARav7dTtpvek1eLVeds,fbPkOYLVPtPgIt0MxizjfFJov3JbHyAi,12,69,47,0,43,15,24,3,201,28.714285714285715,7,0.0,11,47,0,43,58,15,0,24,3,101,100,1
2058,19633,npX3FgekV8W61Z0uW836onGI4m2nQdnG,fbPkOYLVPtPgIt0MxizjfFJov3JbHyAi,4,2,1,0,1,3,1,0,8,1.1428571428571428,1,0.0,0,1,0,1,2,3,0,1,0,2,6,1
2059,19634,jX7tq2pnsDlar9WIdJmOwYa2kqXNP8p5,fbPkOYLVPtPgIt0MxizjfFJov3JbHyAi,26,36,15,23,16,22,18,6,136,19.428571428571427,2,0.0,17,15,19,16,19,22,4,18,6,67,69,1
2060,19636,cFawqBd5fJtkKlCTemtngl3kfpxBO2Oy,fbPkOYLVPtPgIt0MxizjfFJov3JbHyAi,13,23,10,10,9,12,7,1,72,10.285714285714286,4,0.0,8,10,7,9,15,12,3,7,1,34,38,1
2061,19638,VG5BsqnAudb2wrnNFKVoV7tORlRXExaE,fbPkOYLVPtPgIt0MxizjfFJov3JbHyAi,9,26,15,0,6,20,13,3,83,11.857142857142858,4,0.0,2,15,0,6,24,20,0,13,3,23,60,1
2062,19639,nHMKztqwQYqP5QiyWQSLf3rlpTKGeMZ7,fbPkOYLVPtPgIt0MxizjfFJov3JbHyAi,9,6,4,0,3,12,3,2,30,4.285714285714286,1,0.0,0,4,0,3,6,12,0,3,2,7,23,1
2063,19640,qvYnUocR0frsPd3kYwxIbvUGNPr9n1qt,fbPkOYLVPtPgIt0MxizjfFJov3JbHyAi,7,8,5,0,3,0,2,0,18,2.5714285714285716,2,0.0,0,5,0,3,8,0,0,2,0,8,10,1
2064,19641,GoCzFgZtKHP9v4b0WP4lIjCorcS7Jt3F,fbPkOYLVPtPgIt0MxizjfFJov3JbHyAi,23,55,28,15,17,6,7,0,128,18.285714285714285,5,0.0,18,28,12,17,37,6,3,7,0,75,53,1
2065,19642,kQ63n93d5CTXewyEhcoySFeLgYStuYpO,fbPkOYLVPtPgIt0MxizjfFJov3JbHyAi,7,6,4,0,3,0,2,0,15,2.142857142857143,2,0.0,0,4,0,3,6,0,0,2,0,7,8,1
2066,19643,7Wr2VTJWzRxZOKgdu9ZKFIXmTnCI9fnu,fbPkOYLVPtPgIt0MxizjfFJov3JbHyAi,23,72,21,20,16,0,7,0,136,19.428571428571427,2,0.0,35,21,16,16,37,0,4,7,0,88,48,1
2067,19644,No5ifG9v9VDpFVCY05CK70WSRGncERpv,fbPkOYLVPtPgIt0MxizjfFJov3JbHyAi,12,14,5,0,4,1,8,0,32,4.571428571428571,4,0.0,0,5,0,4,14,1,0,8,0,9,23,1
2068,19646,ggEr2STKTwtSSUdtGCmiPr3DBu3TJ34B,fbPkOYLVPtPgIt0MxizjfFJov3JbHyAi,61,123,48,24,48,57,15,0,315,45.0,8,0.0,58,48,24,48,65,57,0,15,0,178,137,1
2069,19648,wQAzZrNBkZu6TvNOv2yKxdbJtBBRTSuF,fbPkOYLVPtPgIt0MxizjfFJov3JbHyAi,6,6,1,0,1,11,5,0,24,3.4285714285714284,1,0.0,0,1,0,1,6,11,0,5,0,2,22,1
2070,19649,mbP9O9bSfibkETk00N09Osk4AH9tyOW9,fbPkOYLVPtPgIt0MxizjfFJov3JbHyAi,1,0,0,0,0,0,1,0,1,0.14285714285714285,1,0.0,0,0,0,0,0,0,0,1,0,0,1,1
2071,19650,9Q3q5ak3WAEiXRLChbacNd3Hje0Wa6sd,fbPkOYLVPtPgIt0MxizjfFJov3JbHyAi,29,106,37,30,29,72,25,1,300,42.857142857142854,6,0.0,38,37,21,29,68,72,9,25,1,125,175,1
2072,19654,5J6AhQDgqCTdGi4V2FLrPa1uynjLJqbR,fbPkOYLVPtPgIt0MxizjfFJov3JbHyAi,11,33,1,6,1,16,6,1,64,9.142857142857142,1,0.0,7,1,4,1,26,16,2,6,1,13,51,1
2073,19655,9e5dcfJQbPUU8sTcmzE9DWoDPOA9Nhu3,fbPkOYLVPtPgIt0MxizjfFJov3JbHyAi,6,8,3,0,2,0,2,0,15,2.142857142857143,2,0.0,0,3,0,2,8,0,0,2,0,5,10,1
2074,19656,gsUbcjiJXGVEzC0HsE7H7oNZQUP3vN7h,fbPkOYLVPtPgIt0MxizjfFJov3JbHyAi,28,67,38,14,23,67,26,3,238,34.0,7,0.0,13,38,11,23,54,67,3,26,3,85,153,1
2075,19657,RaBOiV7pbDCxFmg73km3gwoEkG637iTS,fbPkOYLVPtPgIt0MxizjfFJov3JbHyAi,7,3,2,0,2,0,3,0,10,1.4285714285714286,1,0.0,0,2,0,2,3,0,0,3,0,4,6,1
2076,19658,zTv4QKAduCCJ5yquHsz6UKPKumHF7znP,fbPkOYLVPtPgIt0MxizjfFJov3JbHyAi,10,14,9,0,4,0,4,0,31,4.428571428571429,2,0.0,1,9,0,4,13,0,0,4,0,14,17,1
2077,19659,p8vHkfo5SI0V6B4KROfqrnRCgCCEpojM,fbPkOYLVPtPgIt0MxizjfFJov3JbHyAi,26,55,15,34,16,18,9,0,147,21.0,3,0.0,31,15,25,16,24,18,9,9,0,87,60,1
2078,19660,Fdf5W8Lu9p3zXrwWlt1EPTxeAnJSyNEE,fbPkOYLVPtPgIt0MxizjfFJov3JbHyAi,8,3,2,0,2,2,4,0,13,1.8571428571428572,1,0.0,0,2,0,2,3,2,0,4,0,4,9,1
2079,19661,yJPR0OidzPKNg5Rj1FfQqqXJqCl4r5z8,fbPkOYLVPtPgIt0MxizjfFJov3JbHyAi,1,0,0,0,0,0,1,0,1,0.14285714285714285,1,0.0,0,0,0,0,0,0,0,1,0,0,1,1
2080,19665,NlHO5hXiy7TmVTHiRgExH6y7p9gJG1YF,fbPkOYLVPtPgIt0MxizjfFJov3JbHyAi,5,4,1,0,1,0,1,0,7,1.0,1,0.0,0,1,0,1,4,0,0,1,0,2,5,1
2081,19667,U04y5vFf0AfyJVGIOJHlryTyRQEOm5pT,fbPkOYLVPtPgIt0MxizjfFJov3JbHyAi,21,36,21,10,10,13,10,1,101,14.428571428571429,5,0.0,3,21,8,10,33,13,2,10,1,42,59,1
2082,19668,Xh98I3V3ah7C40wUQRlxQZnzp2hUFzZ9,fbPkOYLVPtPgIt0MxizjfFJov3JbHyAi,7,6,4,0,3,0,2,0,15,2.142857142857143,3,0.0,0,4,0,3,6,0,0,2,0,7,8,1
2083,19671,m38kM2O7Y9dS9qRyh326gVCH42EwGlbN,fbPkOYLVPtPgIt0MxizjfFJov3JbHyAi,7,5,2,0,3,12,4,0,26,3.7142857142857144,2,0.0,2,2,0,3,3,12,0,4,0,7,19,1
2084,19674,ohSArIWJFOjWcw1iipOBHaELVY4dEsuk,fbPkOYLVPtPgIt0MxizjfFJov3JbHyAi,17,19,9,0,5,13,9,4,59,8.428571428571429,2,0.0,0,9,0,5,19,13,0,9,4,14,45,1
2085,19675,2H6KbsPWrpdsyjI0g4q0nnMN85W6it1n,fbPkOYLVPtPgIt0MxizjfFJov3JbHyAi,1,0,0,0,0,0,1,0,1,0.14285714285714285,1,0.0,0,0,0,0,0,0,0,1,0,0,1,1
2086,19678,5zeXp1xbv4d96w4nRSFAsiN01xqmo82u,fbPkOYLVPtPgIt0MxizjfFJov3JbHyAi,2,0,0,0,0,0,7,0,7,1.0,1,0.0,0,0,0,0,0,0,0,7,0,0,7,1
2087,19679,onkD63zW36qWueM4FnIhDEFep4J6xaTB,fbPkOYLVPtPgIt0MxizjfFJov3JbHyAi,2,0,0,0,0,0,7,0,7,1.0,1,0.0,0,0,0,0,0,0,0,7,0,0,7,1
2088,19685,vh8VMxJwpHETuDx8mTcywtcFmJ5lOlZy,fbPkOYLVPtPgIt0MxizjfFJov3JbHyAi,4,3,2,0,2,0,1,0,8,1.1428571428571428,1,0.0,0,2,0,2,3,0,0,1,0,4,4,0
2089,19687,jh0D2keICXHjZlE8o0iWfTU4GtogK2iV,fbPkOYLVPtPgIt0MxizjfFJov3JbHyAi,11,13,6,0,6,10,3,0,38,5.428571428571429,2,0.0,2,6,0,6,11,10,0,3,0,14,24,1
2090,19689,PwY3L0IvWcNAAWE8QgIO3juuVesQg6xr,fbPkOYLVPtPgIt0MxizjfFJov3JbHyAi,6,5,3,0,1,7,5,0,21,3.0,3,0.0,0,3,0,1,5,7,0,5,0,4,17,1
2091,19690,YNemkS5dqknHOwehYprPYVkMaqYUO4yA,fbPkOYLVPtPgIt0MxizjfFJov3JbHyAi,5,3,1,0,1,1,1,0,7,1.0,1,0.0,0,1,0,1,3,1,0,1,0,2,5,1
2092,19692,KkdnagFJtwwq5n9Iuy7rnQaTqa2llFa9,fbPkOYLVPtPgIt0MxizjfFJov3JbHyAi,25,45,19,9,16,22,17,0,128,18.285714285714285,5,0.0,19,19,9,16,26,22,0,17,0,63,65,1
2093,19693,OWBUV30zEQH7Jt1VRLKmraf0vAFBacfv,fbPkOYLVPtPgIt0MxizjfFJov3JbHyAi,9,11,5,0,4,11,12,0,43,6.142857142857143,2,0.0,3,5,0,4,8,11,0,12,0,12,31,1
2094,19694,4GJSwwikGuUWXSajcKoSlvfsoiC8eEZq,fbPkOYLVPtPgIt0MxizjfFJov3JbHyAi,6,7,2,0,1,0,2,0,12,1.7142857142857142,1,0.0,0,2,0,1,7,0,0,2,0,3,9,1
2095,19695,3SP9iNDvUt8m67ZMqC5DpQRe6ekkTpsP,fbPkOYLVPtPgIt0MxizjfFJov3JbHyAi,12,11,7,0,4,5,10,1,38,5.428571428571429,4,0.0,0,7,0,4,11,5,0,10,1,11,27,0
2096,19696,wE17RsVOxdHL75rwI5QafkkqcL3REji3,fbPkOYLVPtPgIt0MxizjfFJov3JbHyAi,4,2,1,0,1,0,1,0,5,0.7142857142857143,1,0.0,0,1,0,1,2,0,0,1,0,2,3,1
2097,19698,vTwbvGW3E1IdqF0HV32uMMc0gGolPCvf,fbPkOYLVPtPgIt0MxizjfFJov3JbHyAi,8,25,15,5,12,5,4,0,66,9.428571428571429,3,0.0,4,15,4,12,21,5,1,4,0,35,31,1
2098,19699,ZQS70X3Ksth8gmZtwesyaYzrxIBfpjcf,fbPkOYLVPtPgIt0MxizjfFJov3JbHyAi,10,24,9,2,4,17,6,0,62,8.857142857142858,2,0.0,10,9,2,4,14,17,0,6,0,25,37,1
2099,19701,Zw1bdKbgaMzUzlqlieQSaucEQ8wggZlx,fbPkOYLVPtPgIt0MxizjfFJov3JbHyAi,4,2,1,0,1,0,2,0,6,0.8571428571428571,1,0.0,0,1,0,1,2,0,0,2,0,2,4,0
2100,19702,p4yxCxiqzIMRoAwoOyGnN7P9RZxypnFm,fbPkOYLVPtPgIt0MxizjfFJov3JbHyAi,20,28,17,6,14,6,6,1,78,11.142857142857142,4,0.0,9,17,6,14,19,6,0,6,1,46,32,1
2101,19705,nbIGolByJC5FPssjDvcKL2vGL3vYMGAq,fbPkOYLVPtPgIt0MxizjfFJov3JbHyAi,82,228,100,93,73,64,52,5,615,87.85714285714286,11,0.0,75,100,80,73,153,64,13,52,5,328,287,0
2102,19708,6U0gCtH3epdLuuj59LGYbTzqvsPQ3DiY,fbPkOYLVPtPgIt0MxizjfFJov3JbHyAi,6,5,3,0,2,0,3,0,13,1.8571428571428572,1,0.0,0,3,0,2,5,0,0,3,0,5,8,1
2103,19709,uMtCQ7Qbv3rm9GwFXfsL1kyH8D7nIalM,fbPkOYLVPtPgIt0MxizjfFJov3JbHyAi,8,33,2,0,1,8,7,0,51,7.285714285714286,5,0.0,2,2,0,1,31,8,0,7,0,5,46,0
2104,19713,IxqtjkNiph0SiGkmwfaH729SQtK50jPu,fbPkOYLVPtPgIt0MxizjfFJov3JbHyAi,13,17,1,0,1,18,14,1,52,7.428571428571429,2,0.0,0,1,0,1,17,18,0,14,1,2,50,1
2105,19714,uuyAyzBNPZJSqNkYTwX3ItAQ7Xcq5lqK,fbPkOYLVPtPgIt0MxizjfFJov3JbHyAi,29,36,21,14,13,16,8,0,108,15.428571428571429,6,0.0,9,21,12,13,27,16,2,8,0,55,53,1
2106,19715,bGUkoSiHaU85ol0k2itTO3o20n3CqprE,fbPkOYLVPtPgIt0MxizjfFJov3JbHyAi,6,3,2,0,2,0,1,0,8,1.1428571428571428,1,0.0,0,2,0,2,3,0,0,1,0,4,4,1
2107,19719,gl2YVlebVAvCcxsYaIoTwLj5l1IGqntH,fbPkOYLVPtPgIt0MxizjfFJov3JbHyAi,11,12,7,0,3,3,7,1,33,4.714285714285714,4,0.0,1,7,0,3,11,3,0,7,1,11,22,1
2108,19720,VgTzrg40YN89iMQMYp8DL2dsBQiMtIfa,fbPkOYLVPtPgIt0MxizjfFJov3JbHyAi,1,0,0,0,0,0,1,0,1,0.14285714285714285,1,0.0,0,0,0,0,0,0,0,1,0,0,1,1
2109,19721,cAjVoc8wOYDE8lScDAhEgvHdzkmg6Oh2,fbPkOYLVPtPgIt0MxizjfFJov3JbHyAi,10,11,8,0,3,0,11,0,33,4.714285714285714,3,0.0,0,8,0,3,11,0,0,11,0,11,22,1
2110,19722,YchS7FPUUCrsbeC0RlrXHuAg4O0pgdnY,fbPkOYLVPtPgIt0MxizjfFJov3JbHyAi,7,14,9,0,5,0,4,0,32,4.571428571428571,4,0.0,0,9,0,5,14,0,0,4,0,14,18,1
2111,19723,jWMVSdUkBIApMFEIB4X88BTUfxnffWAx,fbPkOYLVPtPgIt0MxizjfFJov3JbHyAi,46,91,60,14,52,16,17,0,250,35.714285714285715,7,0.0,15,60,10,52,76,16,4,17,0,137,113,1
2112,19726,LhzU5apxkgFguqzaBs2la7gJhoIHnun9,fbPkOYLVPtPgIt0MxizjfFJov3JbHyAi,5,2,1,0,1,0,7,0,11,1.5714285714285714,3,0.0,0,1,0,1,2,0,0,7,0,2,9,1
2113,19730,nIvIddlMAmTQagaACOulbZ6PInxlyOy2,fbPkOYLVPtPgIt0MxizjfFJov3JbHyAi,45,59,28,38,21,6,8,1,161,23.0,5,0.0,23,28,37,21,36,6,1,8,1,109,52,0
2114,19731,RLvJ5u6m28hhUO44ztK3P01H4ZTIxGoD,fbPkOYLVPtPgIt0MxizjfFJov3JbHyAi,6,8,3,0,3,0,2,0,16,2.2857142857142856,2,0.0,2,3,0,3,6,0,0,2,0,8,8,1
2115,19732,z0Q6ONK9gZ6rOpbD6TitX6FkYPuixcug,fbPkOYLVPtPgIt0MxizjfFJov3JbHyAi,41,119,39,31,17,30,23,4,263,37.57142857142857,8,0.0,26,39,26,17,93,30,5,23,4,108,155,1
2116,19733,D83ozkIhUBEzx10ZBkDPuuGHLXGFtU0D,fbPkOYLVPtPgIt0MxizjfFJov3JbHyAi,1,0,0,0,0,0,1,0,1,0.14285714285714285,1,0.0,0,0,0,0,0,0,0,1,0,0,1,1
2117,19735,KcSCnS83JgHtWEXfmBorkn1UBZpKO1nN,fbPkOYLVPtPgIt0MxizjfFJov3JbHyAi,2,0,0,0,0,0,2,0,2,0.2857142857142857,1,0.0,0,0,0,0,0,0,0,2,0,0,2,1
2118,19738,Bt0YrpvyveynQfxqkzppqbivsu9tYRaK,fbPkOYLVPtPgIt0MxizjfFJov3JbHyAi,12,7,6,0,5,0,1,0,19,2.7142857142857144,1,0.0,0,6,0,5,7,0,0,1,0,11,8,0
2119,19742,c2xUxg7vuhPItQZr96ojei2FNm4xg1X0,fbPkOYLVPtPgIt0MxizjfFJov3JbHyAi,44,81,36,18,31,40,18,2,226,32.285714285714285,8,0.0,33,36,18,31,48,40,0,18,2,118,108,1
2120,19743,EUZk7LUBeSnU7Li4WmLt7uKxhlLiKOYq,fbPkOYLVPtPgIt0MxizjfFJov3JbHyAi,11,29,14,0,6,0,15,1,65,9.285714285714286,2,0.0,0,14,0,6,29,0,0,15,1,20,45,1
2121,19744,k2JSp3bkSnFCXfzGP6sNaxUIyLpM06TA,fbPkOYLVPtPgIt0MxizjfFJov3JbHyAi,1,0,0,0,0,0,1,0,1,0.14285714285714285,1,0.0,0,0,0,0,0,0,0,1,0,0,1,1
2122,19745,Y5j2JtsMt3y0lrKil9FIBv8kmvrOLA4X,fbPkOYLVPtPgIt0MxizjfFJov3JbHyAi,7,5,3,0,2,0,4,0,14,2.0,1,0.0,0,3,0,2,5,0,0,4,0,5,9,1
2123,19746,teqJGecOr4a6oVYU1O9bgvPkX5ZSKA8N,fbPkOYLVPtPgIt0MxizjfFJov3JbHyAi,5,2,1,0,1,0,4,0,8,1.1428571428571428,1,0.0,0,1,0,1,2,0,0,4,0,2,6,1
2124,19748,P9CRp0z2n5HfPA3EY25pk86UB1hpP0VE,fbPkOYLVPtPgIt0MxizjfFJov3JbHyAi,6,7,4,0,0,1,7,0,19,2.7142857142857144,3,0.0,0,4,0,0,7,1,0,7,0,4,15,1
2125,19752,97yjJniO9qlZAjgn3gm4HXnkbwnHzt9O,fbPkOYLVPtPgIt0MxizjfFJov3JbHyAi,1,0,0,0,0,0,1,0,1,0.14285714285714285,1,0.0,0,0,0,0,0,0,0,1,0,0,1,1
2126,19753,4xhrCYKdzHUQrqW9iIr0KOeWujKeYIus,fbPkOYLVPtPgIt0MxizjfFJov3JbHyAi,6,7,1,0,1,0,7,0,16,2.2857142857142856,2,0.0,0,1,0,1,7,0,0,7,0,2,14,1
2127,19754,6K3h9aDeHI9AUqOKTvZxzGkKh6WMc7A3,fbPkOYLVPtPgIt0MxizjfFJov3JbHyAi,7,3,2,0,2,0,2,0,9,1.2857142857142858,1,0.0,0,2,0,2,3,0,0,2,0,4,5,1
2128,19757,hbUthRcRktel8CTk5FJE2GFw0tsGaPJX,fbPkOYLVPtPgIt0MxizjfFJov3JbHyAi,9,4,3,0,3,0,4,0,14,2.0,3,0.0,0,3,0,3,4,0,0,4,0,6,8,1
2129,19758,ipOqQyQpg3SQQaHklGxEISyDZxdmtba9,fbPkOYLVPtPgIt0MxizjfFJov3JbHyAi,3,0,0,0,0,0,5,0,5,0.7142857142857143,1,0.0,0,0,0,0,0,0,0,5,0,0,5,1
2130,19759,K2Gev6RW8VKqmC4C4H0XJFrGZeT1JyyW,fbPkOYLVPtPgIt0MxizjfFJov3JbHyAi,9,3,2,0,2,0,4,1,12,1.7142857142857142,1,0.0,0,2,0,2,3,0,0,4,1,4,8,1
2131,19762,haOtWLq8R5iBRxrylu7qsQb4IXuRIQaN,fbPkOYLVPtPgIt0MxizjfFJov3JbHyAi,20,40,19,24,0,3,11,3,100,14.285714285714286,3,0.0,14,19,22,0,26,3,2,11,3,55,45,1
2132,19763,E3VAWhRWNv6BjTckpQB4VpqgHIOmEPoD,fbPkOYLVPtPgIt0MxizjfFJov3JbHyAi,7,3,2,0,2,0,2,0,9,1.2857142857142858,1,0.0,0,2,0,2,3,0,0,2,0,4,5,1
2133,19766,02KikDpeL3BkT1uIl0J4sjaa91Wls8ih,fbPkOYLVPtPgIt0MxizjfFJov3JbHyAi,14,8,5,5,5,0,5,0,28,4.0,1,0.0,3,5,4,5,5,0,1,5,0,17,11,1
2134,19767,GKKNtfrAHKD2xUEQBz7HLN3kKO9SrWyD,fbPkOYLVPtPgIt0MxizjfFJov3JbHyAi,29,79,42,15,9,22,42,6,215,30.714285714285715,9,0.0,17,42,11,9,62,22,4,42,6,79,136,1
2135,19768,Why02UcIH8ZdjwIJwPOElrNVNSec4in6,fbPkOYLVPtPgIt0MxizjfFJov3JbHyAi,9,8,4,0,4,0,4,0,20,2.857142857142857,1,0.0,2,4,0,4,6,0,0,4,0,10,10,1
2136,19769,bgBhXSh8X6pD8mAGuk3zRCZBNqTSqnHJ,fbPkOYLVPtPgIt0MxizjfFJov3JbHyAi,13,30,17,8,13,8,5,0,81,11.571428571428571,4,0.0,8,17,6,13,22,8,2,5,0,44,37,1
2137,19771,9lFnGVb4ngjyCBpAPFF4Py9FZpYTRwoJ,fbPkOYLVPtPgIt0MxizjfFJov3JbHyAi,5,2,1,0,1,0,2,0,6,0.8571428571428571,1,0.0,0,1,0,1,2,0,0,2,0,2,4,1
2138,19776,CfeENerIdAGepleePWSt0SV88ctt0Tmw,fbPkOYLVPtPgIt0MxizjfFJov3JbHyAi,29,26,16,0,13,0,7,0,62,8.857142857142858,5,0.0,1,16,0,13,25,0,0,7,0,30,32,1
2139,19777,yUDnZwj7Yxaj86CQGKHCPnaBfq9O3vcc,fbPkOYLVPtPgIt0MxizjfFJov3JbHyAi,5,2,1,0,1,0,3,0,7,1.0,2,0.0,0,1,0,1,2,0,0,3,0,2,5,1
2140,19779,0nqj6iIWmYxLKHezCs5xwlB8hzJ9Rg2d,fbPkOYLVPtPgIt0MxizjfFJov3JbHyAi,5,5,2,0,1,0,1,0,9,1.2857142857142858,1,0.0,0,2,0,1,5,0,0,1,0,3,6,1
2141,19780,nG5SIna2Yr2MumgRI14CLkOHNh2U0rkm,fbPkOYLVPtPgIt0MxizjfFJov3JbHyAi,7,4,2,0,1,0,3,0,10,1.4285714285714286,1,0.0,0,2,0,1,4,0,0,3,0,3,7,1
2142,19781,Jv08t8fpcawyaZCw9f0bMJgjS8SuUKfb,fbPkOYLVPtPgIt0MxizjfFJov3JbHyAi,6,5,3,0,1,0,4,0,13,1.8571428571428572,2,0.0,0,3,0,1,5,0,0,4,0,4,9,1
2143,19782,UstweopmwuJ2fqnPYowNY0vr3lDWnNEA,fbPkOYLVPtPgIt0MxizjfFJov3JbHyAi,16,24,15,0,10,2,22,1,74,10.571428571428571,3,0.0,2,15,0,10,22,2,0,22,1,27,47,1
2144,19783,LzhmzME7EkyHXpFVu0EENS6JHqvsJLtH,fbPkOYLVPtPgIt0MxizjfFJov3JbHyAi,28,57,28,16,22,9,9,0,141,20.142857142857142,3,0.0,21,28,14,22,36,9,2,9,0,85,56,1
2145,19785,UhCNSbJxDa9CkR9faEu7q44yTurX7YJH,fbPkOYLVPtPgIt0MxizjfFJov3JbHyAi,5,2,1,0,1,0,3,0,7,1.0,1,0.0,0,1,0,1,2,0,0,3,0,2,5,1
2146,19788,gfuRBmlPKlXNn3u69OCkIXEsqvf1vpRo,fbPkOYLVPtPgIt0MxizjfFJov3JbHyAi,16,21,18,0,16,0,3,0,58,8.285714285714286,6,0.0,0,18,0,16,21,0,0,3,0,34,24,1
2147,19789,Ao05SPEEQv1WpXaKhWVTBjeRlniH33AQ,fbPkOYLVPtPgIt0MxizjfFJov3JbHyAi,9,10,2,2,3,0,3,1,21,3.0,1,0.0,2,2,2,3,8,0,0,3,1,9,12,1
2148,19790,9v5FBlkT08VgqPArpwPYDVOHzgkK8DmA,fbPkOYLVPtPgIt0MxizjfFJov3JbHyAi,12,25,11,4,6,6,10,0,62,8.857142857142858,5,0.0,3,11,4,6,22,6,0,10,0,24,38,1
2149,19791,GAIOcbnQvA9qhvhMc6r6zhVuhoFpfQD2,fbPkOYLVPtPgIt0MxizjfFJov3JbHyAi,4,2,0,0,0,0,2,0,4,0.5714285714285714,1,0.0,0,0,0,0,2,0,0,2,0,0,4,1
2150,19793,NiwhcToNaizZtNhA7c6Q1ZKoUp33LASc,fbPkOYLVPtPgIt0MxizjfFJov3JbHyAi,16,28,13,7,9,1,10,0,68,9.714285714285714,4,0.0,7,13,7,9,21,1,0,10,0,36,32,1
2151,19794,i2J6g1YHP6evnvsQatEoUV6Lz662N8Pt,fbPkOYLVPtPgIt0MxizjfFJov3JbHyAi,24,61,14,15,8,6,12,0,116,16.571428571428573,5,0.0,10,14,11,8,51,6,4,12,0,43,73,1
2152,19795,AtTEb2VyFEMuCpu9E7TOV4gAVRLFEpvg,fbPkOYLVPtPgIt0MxizjfFJov3JbHyAi,3,0,0,0,0,4,4,0,8,1.1428571428571428,1,0.0,0,0,0,0,0,4,0,4,0,0,8,1
2153,19798,ghh1dIrprkTKfllDMPy4cIkYxENWN3hG,fbPkOYLVPtPgIt0MxizjfFJov3JbHyAi,9,10,5,7,6,0,1,0,29,4.142857142857143,1,0.0,4,5,5,6,6,0,2,1,0,20,9,1
2154,19799,HmPFRf4HaEfqanP8jptbixb101SDWsz7,fbPkOYLVPtPgIt0MxizjfFJov3JbHyAi,1,0,0,0,0,0,1,0,1,0.14285714285714285,1,0.0,0,0,0,0,0,0,0,1,0,0,1,1
2155,19800,qmuiZWmGa2h5jyuvdl0AMpjDHyWxmqus,fbPkOYLVPtPgIt0MxizjfFJov3JbHyAi,6,3,2,0,2,13,1,0,21,3.0,1,0.0,0,2,0,2,3,13,0,1,0,4,17,1
2156,19803,DAe94MkHTdcPmdhTmwEa78RpI8unH7VU,fbPkOYLVPtPgIt0MxizjfFJov3JbHyAi,1,0,0,0,0,0,2,0,2,0.2857142857142857,2,0.0,0,0,0,0,0,0,0,2,0,0,2,1
2157,19804,WRgbGIz2wotOKHxhxfqrZ7xS0r15aDGp,fbPkOYLVPtPgIt0MxizjfFJov3JbHyAi,10,5,5,0,5,0,6,0,21,3.0,4,0.0,0,5,0,5,5,0,0,6,0,10,11,1
2158,19806,mV6vIHBrgth3lTaajvzuqQeEfK5qY5yY,fbPkOYLVPtPgIt0MxizjfFJov3JbHyAi,12,15,9,0,7,0,13,0,44,6.285714285714286,2,0.0,2,9,0,7,13,0,0,13,0,18,26,1
2159,19807,FkDqcRzVuKxo8KhYGAYk6Shrbs7IlfbL,fbPkOYLVPtPgIt0MxizjfFJov3JbHyAi,6,3,1,0,1,0,2,0,7,1.0,1,0.0,0,1,0,1,3,0,0,2,0,2,5,1
2160,19809,pApGdDVXhze4S6UmutYTLmYS4Jr9ACYb,fbPkOYLVPtPgIt0MxizjfFJov3JbHyAi,21,40,1,0,2,1,14,0,58,8.285714285714286,4,0.0,0,1,0,2,40,1,0,14,0,3,55,1
2161,19810,Gwx6NHIDtKbDhZ9qq0DoHrv95iBiEB1U,fbPkOYLVPtPgIt0MxizjfFJov3JbHyAi,2,0,0,0,0,0,2,0,2,0.2857142857142857,2,0.0,0,0,0,0,0,0,0,2,0,0,2,0
2162,19814,lxHUxupmVUuN6U299GOAnBvW4C4Ubp0H,fbPkOYLVPtPgIt0MxizjfFJov3JbHyAi,18,23,10,0,7,0,7,0,47,6.714285714285714,4,0.0,0,10,0,7,23,0,0,7,0,17,30,1
2163,19815,1NMKAl678ZBpdBkhXfYTAgEyYygMZz0x,fbPkOYLVPtPgIt0MxizjfFJov3JbHyAi,5,2,1,0,1,4,2,0,10,1.4285714285714286,1,0.0,0,1,0,1,2,4,0,2,0,2,8,1
2164,19818,vjUSE4bgwDQC5HnxxZ5hkgXMs7C5kFpu,fbPkOYLVPtPgIt0MxizjfFJov3JbHyAi,8,8,6,0,1,0,9,2,26,3.7142857142857144,2,0.0,0,6,0,1,8,0,0,9,2,7,19,1
2165,19819,Psc0x9bwTA2QigjfdORw9GCdjVkSZA2A,fbPkOYLVPtPgIt0MxizjfFJov3JbHyAi,7,7,0,0,2,14,5,1,29,4.142857142857143,1,0.0,4,0,0,2,3,14,0,5,1,6,23,1
2166,19820,uUas23B5BASlNq70mr2W0D90rbZsDp9I,fbPkOYLVPtPgIt0MxizjfFJov3JbHyAi,1,0,0,0,0,0,3,0,3,0.42857142857142855,1,0.0,0,0,0,0,0,0,0,3,0,0,3,1
2167,19821,zXwLjZ50Cji8fztc0B2bslPL9Qi2XHaI,fbPkOYLVPtPgIt0MxizjfFJov3JbHyAi,12,5,3,4,3,1,6,1,23,3.2857142857142856,1,0.0,1,3,3,3,4,1,1,6,1,10,13,1
2168,19822,5MN7pHb9NYTV49RYHFa2nAB0siwac3Fy,fbPkOYLVPtPgIt0MxizjfFJov3JbHyAi,4,0,0,0,0,1,4,0,5,0.7142857142857143,1,0.0,0,0,0,0,0,1,0,4,0,0,5,1
2169,19823,bUWcfbWQ4EJOw9u39LuSlWdeodW7fOna,fbPkOYLVPtPgIt0MxizjfFJov3JbHyAi,9,7,4,0,5,0,2,0,18,2.5714285714285716,1,0.0,2,4,0,5,5,0,0,2,0,11,7,1
2170,19824,eNb7XRS8Q3wFtMfryy1D5nNWvhGj2o8v,fbPkOYLVPtPgIt0MxizjfFJov3JbHyAi,1,0,0,0,0,0,1,0,1,0.14285714285714285,1,0.0,0,0,0,0,0,0,0,1,0,0,1,1
2171,19825,MXrTIwWI5paes908dD3STKMpnrGJOoNO,fbPkOYLVPtPgIt0MxizjfFJov3JbHyAi,12,18,6,4,6,0,4,3,41,5.857142857142857,2,0.0,8,6,3,6,10,0,1,4,3,23,18,1
2172,19827,IKvqinkDWiPNKr8H3jp05XvxFjOVjhOj,fbPkOYLVPtPgIt0MxizjfFJov3JbHyAi,8,5,1,0,1,0,7,1,15,2.142857142857143,2,0.0,0,1,0,1,5,0,0,7,1,2,13,1
2173,19828,35U2BNXuS9D65uTVA2fa3pi1wj26AmH8,fbPkOYLVPtPgIt0MxizjfFJov3JbHyAi,51,97,69,28,35,13,8,0,250,35.714285714285715,4,0.0,24,69,26,35,73,13,2,8,0,154,96,1
2174,19829,XQUx3MwVudtjeHmsju8PhHxsdXW0kluK,fbPkOYLVPtPgIt0MxizjfFJov3JbHyAi,46,132,70,50,39,2,19,0,312,44.57142857142857,5,0.0,49,70,48,39,83,2,2,19,0,206,106,1
2175,19833,HgGs6QavYmEoVlzJBRQZ1VM1JzFodPBe,fbPkOYLVPtPgIt0MxizjfFJov3JbHyAi,7,8,3,4,3,0,2,0,20,2.857142857142857,1,0.0,4,3,3,3,4,0,1,2,0,13,7,1
2176,19834,uVhSYke06PCowTkKK0TnzYsz7ytxSXo0,fbPkOYLVPtPgIt0MxizjfFJov3JbHyAi,7,3,2,0,0,2,6,2,15,2.142857142857143,1,0.0,0,2,0,0,3,2,0,6,2,2,13,1
2177,19836,Je1fglzWzz7Ubv1tp06pLOT4u9z98Ytt,fbPkOYLVPtPgIt0MxizjfFJov3JbHyAi,7,3,2,0,2,0,2,0,9,1.2857142857142858,1,0.0,0,2,0,2,3,0,0,2,0,4,5,1
2178,19838,t0CXTWQ7WrgANKqIJnC4VUgKY5pjWYTr,fbPkOYLVPtPgIt0MxizjfFJov3JbHyAi,10,8,5,2,4,0,3,0,22,3.142857142857143,1,0.0,1,5,2,4,7,0,0,3,0,12,10,1
2179,19840,cp0mDdUb6VxZ2pGbwlIxMgdC20NVEaQ4,fbPkOYLVPtPgIt0MxizjfFJov3JbHyAi,1,0,0,0,0,0,1,0,1,0.14285714285714285,1,0.0,0,0,0,0,0,0,0,1,0,0,1,1
2180,19841,a9t5CEcjAfQWyvzEkAK92JIcTHveQuDM,fbPkOYLVPtPgIt0MxizjfFJov3JbHyAi,7,8,2,0,1,0,2,0,13,1.8571428571428572,1,0.0,0,2,0,1,8,0,0,2,0,3,10,1
2181,19842,bKIU4h5S6pxVBBvQYicGGZljVmGThQTZ,fbPkOYLVPtPgIt0MxizjfFJov3JbHyAi,19,81,27,18,25,8,26,6,191,27.285714285714285,9,0.0,23,27,12,25,58,8,6,26,6,87,104,1
2182,19843,T3QyKd9fTQnVL3QXwMXmpa9VWP9rOfpT,fbPkOYLVPtPgIt0MxizjfFJov3JbHyAi,5,2,1,0,1,0,2,0,6,0.8571428571428571,1,0.0,0,1,0,1,2,0,0,2,0,2,4,1
2183,19844,TlJVvBC6ZZacGRqb7kuKo7HQvBARJCM4,fbPkOYLVPtPgIt0MxizjfFJov3JbHyAi,6,2,1,0,1,0,6,0,10,1.4285714285714286,1,0.0,0,1,0,1,2,0,0,6,0,2,8,1
2184,19847,KRnn8XVP0dgmIdWOTGU35QhJLJDHduYk,fbPkOYLVPtPgIt0MxizjfFJov3JbHyAi,1,0,0,0,0,0,1,0,1,0.14285714285714285,1,0.0,0,0,0,0,0,0,0,1,0,0,1,1
2185,19849,mvpXmdYDyNuTBu09E8ipnS5MHRHy94Z3,fbPkOYLVPtPgIt0MxizjfFJov3JbHyAi,1,0,0,0,0,0,1,0,1,0.14285714285714285,1,0.0,0,0,0,0,0,0,0,1,0,0,1,1
2186,19850,UpdEFuakVIRY83Er2LIy9VWQWoA2gpIx,fbPkOYLVPtPgIt0MxizjfFJov3JbHyAi,6,2,1,0,1,0,3,1,8,1.1428571428571428,1,0.0,0,1,0,1,2,0,0,3,1,2,6,1
2187,19851,9JKtUaJcAEBh7CYVmXIhRY2O1dODpq4M,fbPkOYLVPtPgIt0MxizjfFJov3JbHyAi,8,5,2,0,2,1,6,1,17,2.4285714285714284,1,0.0,0,2,0,2,5,1,0,6,1,4,13,1
2188,19852,4qaBwsaC0pfXg0219Ny01dop8gTlFMu6,fbPkOYLVPtPgIt0MxizjfFJov3JbHyAi,8,6,4,0,3,0,4,0,17,2.4285714285714284,2,0.0,0,4,0,3,6,0,0,4,0,7,10,1
2189,19853,yDFNgKY5UYQPIwh86Jl7JH0GU7drQgSP,fbPkOYLVPtPgIt0MxizjfFJov3JbHyAi,1,0,0,0,0,0,1,0,1,0.14285714285714285,1,0.0,0,0,0,0,0,0,0,1,0,0,1,1
2190,19854,yEEPICUjqVU7brBN4wrh8xK8bTVFbXDy,fbPkOYLVPtPgIt0MxizjfFJov3JbHyAi,7,6,2,0,2,0,2,0,12,1.7142857142857142,1,0.0,0,2,0,2,6,0,0,2,0,4,8,1
2191,19855,hr3tXA8jmCXsxdUFfi43JuiRTUpoDlMt,fbPkOYLVPtPgIt0MxizjfFJov3JbHyAi,4,2,0,0,0,1,2,0,5,0.7142857142857143,2,0.0,0,0,0,0,2,1,0,2,0,0,5,0
2192,19857,oB66Su2y0fKCmlftIiys81THD7pT5Kwq,fbPkOYLVPtPgIt0MxizjfFJov3JbHyAi,6,4,2,0,1,0,3,0,10,1.4285714285714286,2,0.0,0,2,0,1,4,0,0,3,0,3,7,1
2193,19859,xqYFyIT46SV7QvhQMGzYnnx9x1RIvm9K,fbPkOYLVPtPgIt0MxizjfFJov3JbHyAi,4,0,0,0,0,1,3,1,5,0.7142857142857143,1,0.0,0,0,0,0,0,1,0,3,1,0,5,1
2194,19860,GFpBLlPKlIeg4yYkbxEh26IfN8cMuAmf,fbPkOYLVPtPgIt0MxizjfFJov3JbHyAi,8,5,2,0,3,0,6,0,16,2.2857142857142856,1,0.0,2,2,0,3,3,0,0,6,0,7,9,1
2195,19861,kMADhIGduPqSkYFwoAlaAOq4Z3kg8su8,fbPkOYLVPtPgIt0MxizjfFJov3JbHyAi,13,35,24,0,15,1,13,0,88,12.571428571428571,5,0.0,0,24,0,15,35,1,0,13,0,39,49,0
2196,19866,BOBLP6pTmRtpQ8LtVgJyutFMDL3q6xno,fbPkOYLVPtPgIt0MxizjfFJov3JbHyAi,45,77,46,23,31,13,11,1,202,28.857142857142858,14,0.0,21,46,20,31,56,13,3,11,1,118,84,0
2197,19867,SxX5znCjYpr86kkQyrVn3BfwaCzWOPGc,fbPkOYLVPtPgIt0MxizjfFJov3JbHyAi,1,0,0,0,0,0,1,0,1,0.14285714285714285,1,0.0,0,0,0,0,0,0,0,1,0,0,1,1
2198,19868,IW1rPvW2Bte4OLapfIZWsk9LSVWmKs26,fbPkOYLVPtPgIt0MxizjfFJov3JbHyAi,9,12,8,0,5,2,6,0,33,4.714285714285714,1,0.0,0,8,0,5,12,2,0,6,0,13,20,1
2199,19869,jUJD4zc1LqwiHBuYXxVgX9j6xi6RKWgV,fbPkOYLVPtPgIt0MxizjfFJov3JbHyAi,23,14,9,0,8,7,8,1,47,6.714285714285714,2,0.0,2,9,0,8,12,7,0,8,1,19,28,1
2200,19870,ynbQlisqFiyBzv22bYVgrb1CTn5JfjMW,fbPkOYLVPtPgIt0MxizjfFJov3JbHyAi,7,3,2,0,2,0,2,0,9,1.2857142857142858,1,0.0,0,2,0,2,3,0,0,2,0,4,5,1
2201,19871,vuIldWG0zIZiagbsArdWgNONid3wMi26,fbPkOYLVPtPgIt0MxizjfFJov3JbHyAi,19,22,0,0,1,0,14,2,39,5.571428571428571,3,0.0,0,0,0,1,22,0,0,14,2,1,38,0
2202,19872,foOeNx7QB7iDsgeA0D657sokODh0QEAw,fbPkOYLVPtPgIt0MxizjfFJov3JbHyAi,9,13,3,3,4,0,4,0,27,3.857142857142857,3,0.0,2,3,2,4,11,0,1,4,0,11,16,1
2203,19873,gVvL6RmTRBe8pjHtydeg9sOn3yGJFctB,fbPkOYLVPtPgIt0MxizjfFJov3JbHyAi,6,1,0,0,0,2,4,1,8,1.1428571428571428,1,0.0,0,0,0,0,1,2,0,4,1,0,8,1
2204,19874,FJnM8KTgJkJ4RTmU7j0GlObcSBlrkSGR,fbPkOYLVPtPgIt0MxizjfFJov3JbHyAi,7,3,2,0,2,0,2,0,9,1.2857142857142858,1,0.0,0,2,0,2,3,0,0,2,0,4,5,1
2205,19875,YCFIP2rd7N9mtFDuRY6Eqqkecqrs4vTb,fbPkOYLVPtPgIt0MxizjfFJov3JbHyAi,7,6,3,0,1,9,4,1,24,3.4285714285714284,1,0.0,0,3,0,1,6,9,0,4,1,4,20,1
2206,19876,ig6krYSkue3MO5KtEMkAXakLUYviTHgU,fbPkOYLVPtPgIt0MxizjfFJov3JbHyAi,6,9,1,0,0,1,10,0,21,3.0,2,0.0,0,1,0,0,9,1,0,10,0,1,20,1
2207,19877,9OvnGSufsqgkF0zk0lt4wMrdl04PgMkr,fbPkOYLVPtPgIt0MxizjfFJov3JbHyAi,1,0,0,0,0,0,1,0,1,0.14285714285714285,1,0.0,0,0,0,0,0,0,0,1,0,0,1,1
2208,19879,1foSXZwCCr5lR9Aws6pCnQ1ZUbu5TIHp,fbPkOYLVPtPgIt0MxizjfFJov3JbHyAi,5,8,4,0,2,0,2,0,16,2.2857142857142856,2,0.0,0,4,0,2,8,0,0,2,0,6,10,0
2209,19884,NqKjMSY6eOZQ1uSyzlPrquJVqzjvSO7O,fbPkOYLVPtPgIt0MxizjfFJov3JbHyAi,36,77,48,10,39,19,14,1,208,29.714285714285715,7,0.0,13,48,8,39,64,19,2,14,1,108,100,1
2210,19885,A6nWdlGih5qGNSA7X8sCBpQ5KoSeu0HC,fbPkOYLVPtPgIt0MxizjfFJov3JbHyAi,2,0,0,0,0,0,3,0,3,0.42857142857142855,2,0.0,0,0,0,0,0,0,0,3,0,0,3,1
2211,19886,ovFlS72dfchdekZxDK8eGHjXjC0Q6ofX,fbPkOYLVPtPgIt0MxizjfFJov3JbHyAi,8,16,8,0,3,0,3,0,30,4.285714285714286,2,0.0,0,8,0,3,16,0,0,3,0,11,19,1
2212,19887,VleZx6AMrGRAMIGS9OzdztH8msuxEpLN,fbPkOYLVPtPgIt0MxizjfFJov3JbHyAi,1,0,0,0,0,0,1,0,1,0.14285714285714285,1,0.0,0,0,0,0,0,0,0,1,0,0,1,1
2213,19888,dgZyMqZ7S2zEOAUOkBV4Iw21KUChsDnG,fbPkOYLVPtPgIt0MxizjfFJov3JbHyAi,1,0,0,0,0,0,1,0,1,0.14285714285714285,1,0.0,0,0,0,0,0,0,0,1,0,0,1,1
2214,19889,esagsd88OzgcWVyUBv4e4lrejs4sAfDh,fbPkOYLVPtPgIt0MxizjfFJov3JbHyAi,4,3,0,0,0,0,3,0,6,0.8571428571428571,1,0.0,0,0,0,0,3,0,0,3,0,0,6,0
2215,19893,NAeglY8cYFpzQKpSfjAgfrtdD2qzmpB5,fbPkOYLVPtPgIt0MxizjfFJov3JbHyAi,51,105,30,0,18,60,37,0,250,35.714285714285715,15,0.0,3,30,0,18,102,60,0,37,0,51,199,0
2216,19894,csHCA49GIFIMIMhddtJXr13v0W45c2zX,fbPkOYLVPtPgIt0MxizjfFJov3JbHyAi,5,2,1,0,1,0,2,0,6,0.8571428571428571,1,0.0,0,1,0,1,2,0,0,2,0,2,4,1
2217,19895,DNuzfFZaKzq1rWcHLzrBtPkDL7hdOTyB,fbPkOYLVPtPgIt0MxizjfFJov3JbHyAi,9,16,8,4,8,0,7,0,43,6.142857142857143,2,0.0,6,8,3,8,10,0,1,7,0,25,18,1
2218,19896,XPjAO3f97ZJcCpAApqMVf8ngBFZ3HzQd,fbPkOYLVPtPgIt0MxizjfFJov3JbHyAi,3,2,0,0,0,0,1,0,3,0.42857142857142855,1,0.0,0,0,0,0,2,0,0,1,0,0,3,1
2219,19897,xdXdQD6d3ouQxPFQHtUqoRivYIjaf4BI,fbPkOYLVPtPgIt0MxizjfFJov3JbHyAi,11,20,6,0,4,16,16,3,65,9.285714285714286,4,0.0,4,6,0,4,16,16,0,16,3,14,51,1
2220,19898,Ng1jToRjDK8omnYgabDdTz8XK2pnHjqz,fbPkOYLVPtPgIt0MxizjfFJov3JbHyAi,7,6,2,0,1,0,3,0,12,1.7142857142857142,1,0.0,0,2,0,1,6,0,0,3,0,3,9,1
2221,19903,yUSW5IznwhnzD0ElBVHBvUlhh23ZO3ve,fbPkOYLVPtPgIt0MxizjfFJov3JbHyAi,5,2,1,0,1,0,2,0,6,0.8571428571428571,1,0.0,0,1,0,1,2,0,0,2,0,2,4,1
2222,19905,3GUwU7gGfH9QSI4jt2ezx9kun1vMueYz,fbPkOYLVPtPgIt0MxizjfFJov3JbHyAi,7,3,1,0,1,1,4,1,11,1.5714285714285714,1,0.0,0,1,0,1,3,1,0,4,1,2,9,1
2223,19906,0CXKn1HfInqkCvrX7MeQPFZQO5dZ0oCE,fbPkOYLVPtPgIt0MxizjfFJov3JbHyAi,9,6,5,0,5,0,2,0,18,2.5714285714285716,1,0.0,0,5,0,5,6,0,0,2,0,10,8,1
2224,19907,vDr9SspvKA7PR8FwpNzXdQMEFONy3TNW,fbPkOYLVPtPgIt0MxizjfFJov3JbHyAi,1,0,0,0,0,0,1,0,1,0.14285714285714285,1,0.0,0,0,0,0,0,0,0,1,0,0,1,1
2225,19908,sxJROJWWpXBhtZ5cBce4vLa62HcIMLBD,fbPkOYLVPtPgIt0MxizjfFJov3JbHyAi,5,3,2,0,2,0,2,0,9,1.2857142857142858,1,0.0,0,2,0,2,3,0,0,2,0,4,5,1
2226,19912,pvxjw4szSuluDWQ3DWPes9Mzs1MCvxjI,fbPkOYLVPtPgIt0MxizjfFJov3JbHyAi,9,7,4,0,2,1,4,1,19,2.7142857142857144,1,0.0,0,4,0,2,7,1,0,4,1,6,13,1
2227,19916,AhEZQvNIIn2lXBelWns2lgtmj9ZMEiO6,fbPkOYLVPtPgIt0MxizjfFJov3JbHyAi,1,0,0,0,0,0,1,0,1,0.14285714285714285,1,0.0,0,0,0,0,0,0,0,1,0,0,1,1
2228,19917,HwGdYA9FLmZeF9QWVKJTGzkq5gZ7zUGa,fbPkOYLVPtPgIt0MxizjfFJov3JbHyAi,6,3,2,0,2,0,1,0,8,1.1428571428571428,1,0.0,0,2,0,2,3,0,0,1,0,4,4,1
2229,19918,xZymr065e4jMs1k7FdN1s1dPRCmzgAiD,fbPkOYLVPtPgIt0MxizjfFJov3JbHyAi,1,0,0,0,0,0,1,0,1,0.14285714285714285,1,0.0,0,0,0,0,0,0,0,1,0,0,1,1
2230,19920,VfXq2XzbXkkKi937rrheKnFTqIJJNxri,fbPkOYLVPtPgIt0MxizjfFJov3JbHyAi,1,0,0,0,0,0,2,0,2,0.2857142857142857,1,0.0,0,0,0,0,0,0,0,2,0,0,2,1
2231,19926,1InE8cdjhx7tJRBfUjLOpNXVGiOXTrtd,fbPkOYLVPtPgIt0MxizjfFJov3JbHyAi,11,33,15,0,3,41,18,1,111,15.857142857142858,4,0.0,0,15,0,3,33,41,0,18,1,18,93,1
2232,19928,97ov4fTuLcUGM3NRcbowYBsVQSUEYP2S,fbPkOYLVPtPgIt0MxizjfFJov3JbHyAi,2,0,0,0,0,0,3,0,3,0.42857142857142855,2,0.0,0,0,0,0,0,0,0,3,0,0,3,1
2233,19932,G2qWD1bGIYovTM2Y7RxiPiKf92aFGc9X,fbPkOYLVPtPgIt0MxizjfFJov3JbHyAi,27,47,26,16,14,41,16,0,160,22.857142857142858,2,0.0,13,26,14,14,34,41,2,16,0,67,93,1
2234,19933,wnXrCFQnu5K77E0TUKHPXLbEZiXu32Gt,fbPkOYLVPtPgIt0MxizjfFJov3JbHyAi,82,96,59,75,40,10,15,4,299,42.714285714285715,4,0.0,26,59,69,40,70,10,6,15,4,194,105,1
2235,19934,GyWTABuPpZEqO585EnNTIpM2B2faPYN3,fbPkOYLVPtPgIt0MxizjfFJov3JbHyAi,12,9,6,0,4,0,4,0,23,3.2857142857142856,4,0.0,0,6,0,4,9,0,0,4,0,10,13,1
2236,19935,wEajQeQse5CzhcFd5XXOtEsUUddZZAU5,fbPkOYLVPtPgIt0MxizjfFJov3JbHyAi,20,45,16,17,16,1,12,1,108,15.428571428571429,4,0.0,23,16,13,16,22,1,4,12,1,68,40,0
2237,19936,viuKt4GgrX0rYL5EpHoxJbsiC9TblSuk,fbPkOYLVPtPgIt0MxizjfFJov3JbHyAi,32,98,58,1,31,60,42,0,290,41.42857142857143,12,0.0,12,58,1,31,86,60,0,42,0,102,188,0
2238,19937,TW2XIE8RVUXEKU7cj0LXiqnV9PpOeW5X,fbPkOYLVPtPgIt0MxizjfFJov3JbHyAi,9,5,4,0,3,0,3,0,15,2.142857142857143,1,0.0,0,4,0,3,5,0,0,3,0,7,8,1
2239,19938,33YJhO56Hz6X3YkBaXAE8jLXj3hGQz0E,fbPkOYLVPtPgIt0MxizjfFJov3JbHyAi,12,12,7,4,4,0,5,0,32,4.571428571428571,3,0.0,2,7,3,4,10,0,1,5,0,16,16,1
2240,19939,7uDVcwukNss0paMtTOJXNPZUXWP9vYuG,fbPkOYLVPtPgIt0MxizjfFJov3JbHyAi,8,8,4,0,2,0,5,0,19,2.7142857142857144,3,0.0,1,4,0,2,7,0,0,5,0,7,12,1
2241,19940,eeYj7ooXMmKNnXyjLGvyz7RVwRLoScYs,fbPkOYLVPtPgIt0MxizjfFJov3JbHyAi,7,3,2,0,2,0,2,0,9,1.2857142857142858,1,0.0,0,2,0,2,3,0,0,2,0,4,5,1
2242,19941,a7hY9wWK5IElJ1dZWTInS8ONEoRm1ika,fbPkOYLVPtPgIt0MxizjfFJov3JbHyAi,4,2,0,0,0,0,3,0,5,0.7142857142857143,2,0.0,0,0,0,0,2,0,0,3,0,0,5,1
2243,19942,je9A6l6tP7wnbFhNJD7vbbHTYhqshuqB,fbPkOYLVPtPgIt0MxizjfFJov3JbHyAi,28,76,29,16,17,14,23,2,177,25.285714285714285,7,0.0,16,29,11,17,60,14,5,23,2,73,104,1
2244,19943,yS4oyG8z71VcMw1yy9w2LWRiDWgGhtKA,fbPkOYLVPtPgIt0MxizjfFJov3JbHyAi,1,0,0,0,0,0,1,0,1,0.14285714285714285,1,0.0,0,0,0,0,0,0,0,1,0,0,1,1
2245,19947,ZkhJUa8EJMEosRkUx3uFogoZkW9dBDLF,fbPkOYLVPtPgIt0MxizjfFJov3JbHyAi,5,2,1,0,1,0,2,0,6,0.8571428571428571,1,0.0,0,1,0,1,2,0,0,2,0,2,4,1
2246,19948,yvyZaz4xAz9F6HZ98hADpdZbO8B3aQLI,fbPkOYLVPtPgIt0MxizjfFJov3JbHyAi,4,2,0,0,0,0,3,0,5,0.7142857142857143,1,0.0,0,0,0,0,2,0,0,3,0,0,5,1
2247,19949,lulY8D00ct0beDGYE4CRU9KsINnQRaV8,fbPkOYLVPtPgIt0MxizjfFJov3JbHyAi,13,39,19,0,8,1,14,2,83,11.857142857142858,5,0.0,3,19,0,8,36,1,0,14,2,30,53,0
2248,19951,rPw77eL90jbIeSFJYyvVIXe9A8wT4cw5,fbPkOYLVPtPgIt0MxizjfFJov3JbHyAi,5,2,1,0,1,3,3,0,10,1.4285714285714286,1,0.0,0,1,0,1,2,3,0,3,0,2,8,1
2249,19953,7rTP5bps09htLBiewU1OlHyTn48UEKTD,fbPkOYLVPtPgIt0MxizjfFJov3JbHyAi,4,2,1,0,1,0,1,0,5,0.7142857142857143,1,0.0,0,1,0,1,2,0,0,1,0,2,3,1
2250,19955,Y7REnesylqzkGeCcXJqxiJ4B25LlDJnj,fbPkOYLVPtPgIt0MxizjfFJov3JbHyAi,11,10,6,0,4,0,5,0,25,3.5714285714285716,3,0.0,2,6,0,4,8,0,0,5,0,12,13,1
2251,19956,MelNG8TL1wwoBfj4YB6xJw5vokLsJ0c9,fbPkOYLVPtPgIt0MxizjfFJov3JbHyAi,1,0,0,0,0,0,1,0,1,0.14285714285714285,1,0.0,0,0,0,0,0,0,0,1,0,0,1,1
2252,20045,E9MhL5j6EEbGw96uDNwSlEIItUx4QLbq,5Gyp41oLVo7Gg7vF4vpmggWP5MU70QO6,3,3,1,0,0,0,2,0,6,0.8571428571428571,1,0.0,0,1,0,0,3,0,0,2,0,1,5,1
2253,20047,9KW86bF2a8wFmh5J9Lgj6m9lvxGd3Fit,5Gyp41oLVo7Gg7vF4vpmggWP5MU70QO6,4,5,1,0,1,0,2,0,9,1.2857142857142858,2,0.0,0,1,0,1,5,0,0,2,0,2,7,1
2254,20050,6wqQQU6gadL03cIVBtw9j6qVgAZqgFIb,5Gyp41oLVo7Gg7vF4vpmggWP5MU70QO6,5,2,0,0,1,3,2,1,9,1.2857142857142858,1,0.0,0,0,0,1,2,3,0,2,1,1,8,1
2255,20052,H6jZionHr3YO42h6C5yeJWFXGReOpPax,5Gyp41oLVo7Gg7vF4vpmggWP5MU70QO6,8,7,3,2,2,0,1,0,15,2.142857142857143,1,0.0,3,3,1,2,4,0,1,1,0,9,6,1
2256,20054,n9LedJO4KNI3qkoMffxQUCkea0pp4KEu,5Gyp41oLVo7Gg7vF4vpmggWP5MU70QO6,23,58,32,21,12,72,24,3,222,31.714285714285715,3,0.0,13,32,14,12,45,72,7,24,3,71,151,1
2257,20058,glPDR5bdnwYTrc7hgG9ULJKpN3nFLGE0,5Gyp41oLVo7Gg7vF4vpmggWP5MU70QO6,15,18,7,6,8,36,6,1,82,11.714285714285714,1,0.0,8,7,4,8,10,36,2,6,1,27,55,1
2258,20060,zeydZlwGQCxDpstjdEq0NvjUsbpOzoxV,5Gyp41oLVo7Gg7vF4vpmggWP5MU70QO6,19,30,18,17,7,0,7,0,79,11.285714285714286,4,0.0,5,18,11,7,25,0,6,7,0,41,38,1
2259,20062,NhuYdPluEkXTEViyaWYrXRod2NyBRGbN,5Gyp41oLVo7Gg7vF4vpmggWP5MU70QO6,20,46,23,20,8,10,29,20,156,22.285714285714285,6,0.0,9,23,12,8,37,10,8,29,20,52,104,0
2260,20066,jqFOiqbIY6C65IovHqkpdBOJQW013YOC,5Gyp41oLVo7Gg7vF4vpmggWP5MU70QO6,68,244,106,72,60,19,35,2,538,76.85714285714286,9,0.0,108,106,57,60,136,19,15,35,2,331,207,0
2261,20070,WTsp1mZz5EDw1He0xKdOvtBGTKevohcm,5Gyp41oLVo7Gg7vF4vpmggWP5MU70QO6,35,98,45,30,10,325,42,4,554,79.14285714285714,8,0.0,34,45,24,10,64,325,6,42,4,113,441,0
2262,20072,2ThHarEubS0c8gep0BeOFf7xxheqMWnH,5Gyp41oLVo7Gg7vF4vpmggWP5MU70QO6,6,4,3,0,3,0,1,0,11,1.5714285714285714,1,0.0,0,3,0,3,4,0,0,1,0,6,5,1
2263,20077,u0SrW65Zdf0RG2PPgt52qf6MWWYZDmbZ,5Gyp41oLVo7Gg7vF4vpmggWP5MU70QO6,24,30,16,0,15,0,10,0,71,10.142857142857142,6,0.0,6,16,0,15,24,0,0,10,0,37,34,1
2264,20090,ttDgrsiryXoKaT4z5CduzwSDltfHA5Tp,5Gyp41oLVo7Gg7vF4vpmggWP5MU70QO6,40,84,48,26,25,8,36,2,229,32.714285714285715,10,0.0,16,48,20,25,68,8,6,36,2,109,120,1
2265,20093,0rTzX8GTA6AO1xZbOJCS52qGTu8sNNgu,5Gyp41oLVo7Gg7vF4vpmggWP5MU70QO6,29,68,30,19,16,56,18,1,208,29.714285714285715,9,0.0,24,30,13,16,44,56,6,18,1,83,125,0
2266,20096,FuoUpz3CIn6IWgPZcXNRWeCZpBo5bqY6,5Gyp41oLVo7Gg7vF4vpmggWP5MU70QO6,17,43,19,31,0,15,4,0,112,16.0,3,0.0,19,19,23,0,24,15,8,4,0,61,51,0
2267,20109,NXWbrhgwPkB8Vmhv89AlGPamswmxk6M5,5Gyp41oLVo7Gg7vF4vpmggWP5MU70QO6,19,28,14,28,5,5,7,0,87,12.428571428571429,4,0.0,9,14,21,5,19,5,7,7,0,49,38,1
2268,20110,ABbPtVE9vR3q9TnGdVr0jhQS05eL9aJw,5Gyp41oLVo7Gg7vF4vpmggWP5MU70QO6,46,75,53,5,23,12,26,1,195,27.857142857142858,8,0.0,6,53,3,23,69,12,2,26,1,85,110,0
2269,20111,Cs0gFHwyaGk2h4OmFyQ67vt8HPC12M1J,5Gyp41oLVo7Gg7vF4vpmggWP5MU70QO6,1,0,0,0,0,0,1,0,1,0.14285714285714285,1,0.0,0,0,0,0,0,0,0,1,0,0,1,1
2270,20113,m10MnR6QWHgJDgjQEm80sVb0dV6pgu2c,5Gyp41oLVo7Gg7vF4vpmggWP5MU70QO6,15,36,18,1,8,12,15,0,90,12.857142857142858,5,0.0,14,18,1,8,22,12,0,15,0,41,49,1
2271,20121,PLLwziP9q0JVMUdxss7Qy2U6TVcLBTA4,5Gyp41oLVo7Gg7vF4vpmggWP5MU70QO6,4,2,1,0,1,0,1,0,5,0.7142857142857143,1,0.0,0,1,0,1,2,0,0,1,0,2,3,1
2272,20125,JZ0cPuTVmC70maYF6NIorZr3bOTKKvsS,5Gyp41oLVo7Gg7vF4vpmggWP5MU70QO6,13,6,4,8,4,0,2,0,24,3.4285714285714284,1,0.0,2,4,5,4,4,0,3,2,0,15,9,1
2273,20126,rGhtBFyJ1i3JCXgagWhQLBoCku1ClaHD,5Gyp41oLVo7Gg7vF4vpmggWP5MU70QO6,10,9,3,4,2,3,4,1,26,3.7142857142857144,1,0.0,2,3,2,2,7,3,2,4,1,9,17,1
2274,20134,XKxu0UHgcJ5pVHhEtOgLZIsKoredZm21,5Gyp41oLVo7Gg7vF4vpmggWP5MU70QO6,32,32,27,0,17,0,11,0,87,12.428571428571429,3,0.0,0,27,0,17,32,0,0,11,0,44,43,1
2275,20138,Xe157JusuZ3tLSedhGrKKw6nHQceWUNE,5Gyp41oLVo7Gg7vF4vpmggWP5MU70QO6,12,14,8,4,2,0,7,0,35,5.0,5,0.0,4,8,2,2,10,0,2,7,0,16,19,1
2276,20140,a9FDBG85NydYrIgZaH9taLl0qSfEQnKr,5Gyp41oLVo7Gg7vF4vpmggWP5MU70QO6,51,172,81,27,42,40,41,0,403,57.57142857142857,14,0.0,55,81,22,42,117,40,5,41,0,200,203,0
2277,20145,2luV6bj304xCxkSajZrqthGBkjmNgJ7T,5Gyp41oLVo7Gg7vF4vpmggWP5MU70QO6,8,7,3,0,0,0,8,1,19,2.7142857142857144,1,0.0,0,3,0,0,7,0,0,8,1,3,16,1
2278,20151,12tfSRcVHU1LY6VYbYjnNdGrVUGUAhWB,5Gyp41oLVo7Gg7vF4vpmggWP5MU70QO6,44,125,54,70,3,3,48,2,305,43.57142857142857,9,0.0,47,54,53,3,78,3,17,48,2,157,148,0
2279,20152,5pjAdY5K4FfgQPLSzQKwXaKF78ph9a0y,5Gyp41oLVo7Gg7vF4vpmggWP5MU70QO6,7,7,3,0,2,0,2,0,14,2.0,2,0.0,0,3,0,2,7,0,0,2,0,5,9,1
2280,20162,8GMUs7oeRalA74SLd7wfRpddCGtQ5rmL,5Gyp41oLVo7Gg7vF4vpmggWP5MU70QO6,9,8,5,3,1,1,4,0,22,3.142857142857143,1,0.0,1,5,2,1,7,1,1,4,0,9,13,1
2281,20169,p3ufn8QcrZUwabpMSs5v5bV2VxuJbcrm,5Gyp41oLVo7Gg7vF4vpmggWP5MU70QO6,23,15,12,0,8,6,11,2,54,7.714285714285714,2,0.0,1,12,0,8,14,6,0,11,2,21,33,1
2282,20179,8NK3iaPYRi5tDjzHZVNIqLtQMUnR3yyG,5Gyp41oLVo7Gg7vF4vpmggWP5MU70QO6,1,0,0,0,0,0,1,0,1,0.14285714285714285,1,0.0,0,0,0,0,0,0,0,1,0,0,1,1
2283,20180,fpOYviCjfT1tZNuDdpNqrinz1621b7mL,5Gyp41oLVo7Gg7vF4vpmggWP5MU70QO6,12,11,7,0,4,3,15,2,42,6.0,2,0.0,0,7,0,4,11,3,0,15,2,11,31,1
2284,20428,0Tg2flbTUdD7fODqYIfpiJiK0IDdFiOP,3VkHkmOtom3jM2wCu94xgzzu1d6Dn7or,88,243,106,33,78,16,61,3,540,77.14285714285714,15,0.0,53,106,31,78,190,16,2,61,3,268,272,0
2285,20433,oE6DPh3f1KJ1QOJPSf6WuTGufFpaw4RL,3VkHkmOtom3jM2wCu94xgzzu1d6Dn7or,96,196,99,104,81,60,49,1,590,84.28571428571429,14,0.0,60,99,102,81,136,60,2,49,1,342,248,0
2286,20450,mFpiELMd2y5tbkdxs4m8pKS7gXHb7bIO,3VkHkmOtom3jM2wCu94xgzzu1d6Dn7or,8,12,3,5,6,0,2,0,28,4.0,2,0.0,8,3,5,6,4,0,0,2,0,22,6,1
2287,20460,fgqnjAQhSNo0zgtESNlcyk6k5zAbpclp,3VkHkmOtom3jM2wCu94xgzzu1d6Dn7or,66,190,68,94,64,10,44,8,478,68.28571428571429,16,0.0,69,68,87,64,121,10,7,44,8,288,190,0
2288,20467,dJfak1mtGaKcbsyIBZ4I9MHKmQ3nj02t,3VkHkmOtom3jM2wCu94xgzzu1d6Dn7or,15,24,9,0,1,0,6,0,40,5.714285714285714,2,0.0,2,9,0,1,22,0,0,6,0,12,28,0
2289,20469,7ZyJguBzL4oDvx3QuauBv2Vv3pHBPVh3,3VkHkmOtom3jM2wCu94xgzzu1d6Dn7or,9,29,5,6,7,7,12,2,68,9.714285714285714,1,0.0,19,5,5,7,10,7,1,12,2,36,32,0
2290,20484,kWet01DzGE5Z1z6FwJt5yEexIuvkBhsh,3VkHkmOtom3jM2wCu94xgzzu1d6Dn7or,73,109,11,42,56,4,18,1,241,34.42857142857143,4,0.0,43,11,41,56,66,4,1,18,1,151,90,0
2291,20509,51xlIGXGRsE7YMneHTw1mXYuaEFgELF3,5Gyp41oLVo7Gg7vF4vpmggWP5MU70QO6,4,4,2,0,1,0,2,0,9,1.2857142857142858,2,0.0,0,2,0,1,4,0,0,2,0,3,6,1
2292,20538,U7EtjqTqdWkMXU8jPYUzk64V0Mn9cfrB,5Gyp41oLVo7Gg7vF4vpmggWP5MU70QO6,15,60,28,11,10,17,23,1,150,21.428571428571427,7,0.0,7,28,6,10,53,17,5,23,1,51,99,0
2293,20546,GXlRC26Ko0I4QuqEBegfYjNMMHXqEAeI,5Gyp41oLVo7Gg7vF4vpmggWP5MU70QO6,2,0,0,0,0,0,3,0,3,0.42857142857142855,1,0.0,0,0,0,0,0,0,0,3,0,0,3,1
2294,20559,nYqIGil9UmfZ8C9e6NMYoAGcfo6Iw6tC,5Gyp41oLVo7Gg7vF4vpmggWP5MU70QO6,33,75,34,32,8,7,40,0,196,28.0,7,0.0,14,34,24,8,61,7,8,40,0,80,116,1
2295,20560,vCT5TWno1npWLslO7yYTAIaOZBV06mao,5Gyp41oLVo7Gg7vF4vpmggWP5MU70QO6,1,0,0,0,0,0,1,0,1,0.14285714285714285,1,0.0,0,0,0,0,0,0,0,1,0,0,1,1
2296,20586,mQjeD6hN9l04FxDxsU4KpCkNxpaYJUy8,5Gyp41oLVo7Gg7vF4vpmggWP5MU70QO6,23,62,35,18,10,62,18,2,207,29.571428571428573,5,0.0,17,35,9,10,45,62,9,18,2,71,136,0
2297,20659,21xHpbTt9IlCSENitiwjX4lHJpt77SM0,5Gyp41oLVo7Gg7vF4vpmggWP5MU70QO6,8,6,3,0,2,0,3,0,14,2.0,1,0.0,1,3,0,2,5,0,0,3,0,6,8,1
2298,20711,DKHkASaue21Ube0NCtRQv5RAIPQ6lG0B,5Gyp41oLVo7Gg7vF4vpmggWP5MU70QO6,1,0,0,0,0,0,1,0,1,0.14285714285714285,1,0.0,0,0,0,0,0,0,0,1,0,0,1,1
2299,20723,pXnPfAM8ms99bW53JuZdfy5kHRn0Gw3F,5Gyp41oLVo7Gg7vF4vpmggWP5MU70QO6,17,35,21,17,11,0,7,0,91,13.0,4,0.0,12,21,16,11,23,0,1,7,0,60,31,0
2300,20724,Tl0cUD0uaRNrptL4xz9FM8t9vDRkb8l2,5Gyp41oLVo7Gg7vF4vpmggWP5MU70QO6,8,6,2,2,1,0,5,0,16,2.2857142857142856,2,0.0,1,2,1,1,5,0,1,5,0,5,11,1
2301,20731,gpz5P4EnF16Nr0OcO2XnJV1T57UyUmj4,5Gyp41oLVo7Gg7vF4vpmggWP5MU70QO6,9,9,5,0,3,0,7,0,24,3.4285714285714284,4,0.0,1,5,0,3,8,0,0,7,0,9,15,0
2302,20764,1dxQmK9WwlHWuIG7ZTn4PsJ2vflQBDH3,5Gyp41oLVo7Gg7vF4vpmggWP5MU70QO6,43,90,46,21,25,37,31,1,251,35.857142857142854,14,0.0,21,46,15,25,69,37,6,31,1,107,144,0
2303,20767,YJcptsgRBvUQgvUGKpQGU1OPeMTESrpy,5Gyp41oLVo7Gg7vF4vpmggWP5MU70QO6,16,14,7,4,2,8,9,2,46,6.571428571428571,3,0.0,1,7,3,2,13,8,1,9,2,13,33,1
2304,20769,UvSRAfOynZWLLb7HhTXhSBS51EOIrExr,5Gyp41oLVo7Gg7vF4vpmggWP5MU70QO6,2,0,0,0,0,0,2,0,2,0.2857142857142857,1,0.0,0,0,0,0,0,0,0,2,0,0,2,1
2305,20773,ogurveh5dgwQ7omkU0IctcIseCFtiniL,5Gyp41oLVo7Gg7vF4vpmggWP5MU70QO6,13,26,11,11,8,1,3,0,60,8.571428571428571,2,0.0,12,11,6,8,14,1,5,3,0,37,23,1
2306,20776,7wDmO3V391mOKctQPBgeS1ILceV0cgzq,5Gyp41oLVo7Gg7vF4vpmggWP5MU70QO6,4,2,1,0,1,0,1,0,5,0.7142857142857143,1,0.0,0,1,0,1,2,0,0,1,0,2,3,1
2307,20796,51UrGO11oEt7DoFaWRLH7OdH7DSe85mH,5Gyp41oLVo7Gg7vF4vpmggWP5MU70QO6,7,3,2,0,2,0,2,0,9,1.2857142857142858,1,0.0,0,2,0,2,3,0,0,2,0,4,5,1
2308,20831,TzUoSJ3pyMjwCKLIHuVSKLad9h9hLr5U,5Gyp41oLVo7Gg7vF4vpmggWP5MU70QO6,54,98,49,34,28,0,21,0,230,32.857142857142854,13,0.0,27,49,27,28,71,0,7,21,0,131,99,0
2309,20838,IweRnM2AMTe7iVCwVnhk6LnMzajZZKLL,5Gyp41oLVo7Gg7vF4vpmggWP5MU70QO6,44,109,76,2,53,0,1,0,241,34.42857142857143,23,0.0,30,76,1,53,79,0,1,1,0,160,81,0
2310,20858,ANGPkqBejn3faj6KlS1vRWpMG1uR4DOb,5Gyp41oLVo7Gg7vF4vpmggWP5MU70QO6,1,0,0,0,0,0,2,0,2,0.2857142857142857,1,0.0,0,0,0,0,0,0,0,2,0,0,2,1
2311,20903,26uh3OFDkawJXE1lMs10AttJdYkXa36s,5Gyp41oLVo7Gg7vF4vpmggWP5MU70QO6,5,2,1,0,1,0,2,0,6,0.8571428571428571,1,0.0,0,1,0,1,2,0,0,2,0,2,4,1
2312,20908,lROQAiXdM7cGoWUW60LyDcyoBjMP9r3o,5Gyp41oLVo7Gg7vF4vpmggWP5MU70QO6,4,2,0,0,0,0,2,0,4,0.5714285714285714,1,0.0,0,0,0,0,2,0,0,2,0,0,4,0
2313,20918,0EjKvRTxPK4ozZ3L3wWm5nTPbXNczvrz,5Gyp41oLVo7Gg7vF4vpmggWP5MU70QO6,1,0,0,0,0,0,1,0,1,0.14285714285714285,1,0.0,0,0,0,0,0,0,0,1,0,0,1,1
2314,20921,evowo3Yg2sbVP9DdhhK3sw1dGIBBhaou,5Gyp41oLVo7Gg7vF4vpmggWP5MU70QO6,39,198,62,21,43,16,42,6,388,55.42857142857143,10,0.0,46,62,12,43,152,16,9,42,6,163,225,0
2315,20938,yMZU4V5TrrHcMWV44L1puCcwo6hPZFxD,5Gyp41oLVo7Gg7vF4vpmggWP5MU70QO6,5,3,1,0,1,0,3,0,8,1.1428571428571428,2,0.0,0,1,0,1,3,0,0,3,0,2,6,0
2316,20963,iyCT8McW9jtPFTdP663jcMhqs1NPgq1J,5Gyp41oLVo7Gg7vF4vpmggWP5MU70QO6,8,5,3,0,2,0,3,0,13,1.8571428571428572,2,0.0,0,3,0,2,5,0,0,3,0,5,8,1
2317,20985,hMmMWG2mCSPmBVJCfg0hTnXWgrWTXDtT,5Gyp41oLVo7Gg7vF4vpmggWP5MU70QO6,44,66,36,31,23,17,19,5,197,28.142857142857142,8,0.0,15,36,21,23,51,17,10,19,5,95,102,0
2318,20990,sT5kGTmMwotrgA4QrrYAzIJ6RZbnZCaK,5Gyp41oLVo7Gg7vF4vpmggWP5MU70QO6,41,135,60,31,25,18,34,1,304,43.42857142857143,8,0.0,50,60,22,25,85,18,9,34,1,157,147,0
2319,20992,UuK4SgZkmPrFxeH0ZPCRQ63pVXUSe96N,5Gyp41oLVo7Gg7vF4vpmggWP5MU70QO6,2,0,0,0,0,0,4,0,4,0.5714285714285714,3,0.0,0,0,0,0,0,0,0,4,0,0,4,1
2320,20999,28R6iGKChcTZe4wfYq3cZyHjYc957tJu,5Gyp41oLVo7Gg7vF4vpmggWP5MU70QO6,34,70,13,19,25,3,14,3,147,21.0,9,0.0,24,13,13,25,46,3,6,14,3,75,72,1
2321,21015,faupOzOQrYnrhUP3CZcXERH5hL8Q3xd2,5Gyp41oLVo7Gg7vF4vpmggWP5MU70QO6,13,22,12,4,5,6,8,0,57,8.142857142857142,5,0.0,2,12,3,5,20,6,1,8,0,22,35,0
2322,21041,amvjX9kh04RcngZb0v489RHBECZoZJN4,5Gyp41oLVo7Gg7vF4vpmggWP5MU70QO6,7,3,2,0,2,0,2,0,9,1.2857142857142858,1,0.0,0,2,0,2,3,0,0,2,0,4,5,1
2323,21043,EYpj7D3bfN6f1CyEX9whEB1qrBw0LMTz,5Gyp41oLVo7Gg7vF4vpmggWP5MU70QO6,7,6,1,2,0,0,4,0,13,1.8571428571428572,2,0.0,1,1,1,0,5,0,1,4,0,3,10,1
2324,21044,O8WpIn8YZlC9fwaPz6HgwkG3VYK9Pnk2,5Gyp41oLVo7Gg7vF4vpmggWP5MU70QO6,1,0,0,0,0,0,1,0,1,0.14285714285714285,1,0.0,0,0,0,0,0,0,0,1,0,0,1,1
2325,21072,0B7Lg7kBiHggKw9Wk7X0Ew4GVuXGGcvN,5Gyp41oLVo7Gg7vF4vpmggWP5MU70QO6,41,52,39,0,26,5,12,0,134,19.142857142857142,3,0.0,1,39,0,26,51,5,0,12,0,66,68,0
2326,21077,8qZ9lGKM03veKCgxfF78AoJnOHCggeil,5Gyp41oLVo7Gg7vF4vpmggWP5MU70QO6,7,3,2,0,2,0,5,0,12,1.7142857142857142,2,0.0,0,2,0,2,3,0,0,5,0,4,8,1
2327,21116,IXpBNvNyAVnPKtJ6Cz72QOA3m4e9Nil9,5Gyp41oLVo7Gg7vF4vpmggWP5MU70QO6,35,46,24,34,8,7,28,0,147,21.0,7,0.0,18,24,25,8,28,7,9,28,0,75,72,1
2328,21140,1srWC81yOUCAiYINElj2QhPEgKzNg58N,5Gyp41oLVo7Gg7vF4vpmggWP5MU70QO6,1,0,0,0,0,0,1,0,1,0.14285714285714285,1,0.0,0,0,0,0,0,0,0,1,0,0,1,1
2329,21169,2VA4csxIMQCx8OPT1JNIuyOwjieGR5SH,5Gyp41oLVo7Gg7vF4vpmggWP5MU70QO6,17,28,11,2,3,3,14,1,62,8.857142857142858,2,0.0,7,11,1,3,21,3,1,14,1,22,40,0
2330,21174,2jQmSZ0Z3BRjurnjzXdja964kW30vIAB,5Gyp41oLVo7Gg7vF4vpmggWP5MU70QO6,22,40,14,22,6,5,15,1,103,14.714285714285714,4,0.0,8,14,16,6,32,5,6,15,1,44,59,0
2331,21190,fOfAvgjoMJaTnjmbbLT9l8oPlz2vuSSr,5Gyp41oLVo7Gg7vF4vpmggWP5MU70QO6,22,69,37,7,15,0,16,0,144,20.571428571428573,7,0.0,10,37,5,15,59,0,2,16,0,67,77,0
2332,21209,FvdPuMrK3zMhYy78N5suTn8yvFPgw8yC,5Gyp41oLVo7Gg7vF4vpmggWP5MU70QO6,28,85,44,28,13,12,23,5,210,30.0,8,0.0,19,44,21,13,66,12,7,23,5,97,113,0
2333,21240,WWULZRuZ3Saytj4k2VnRR35CKpUbULPd,5Gyp41oLVo7Gg7vF4vpmggWP5MU70QO6,10,9,6,0,3,0,17,12,47,6.714285714285714,5,0.0,0,6,0,3,9,0,0,17,12,9,38,0
2334,21290,9LvgV591BX9GhV6hwDHWjRo6mXxb5lb9,5Gyp41oLVo7Gg7vF4vpmggWP5MU70QO6,13,25,11,4,3,8,12,2,65,9.285714285714286,3,0.0,2,11,4,3,23,8,0,12,2,20,45,1
2335,21314,fkbxkXpN20umRnEu1JAMVCW41OYjb7dl,5Gyp41oLVo7Gg7vF4vpmggWP5MU70QO6,18,34,15,8,5,4,15,2,83,11.857142857142858,2,0.0,10,15,4,5,24,4,4,15,2,34,49,0
2336,21316,NRvPF6FnE2qOoEKQlwRiAGDiz3Y2mfqX,5Gyp41oLVo7Gg7vF4vpmggWP5MU70QO6,7,2,1,0,1,3,7,1,15,2.142857142857143,2,0.0,0,1,0,1,2,3,0,7,1,2,13,0
2337,21322,IZwgoYiQOwzeEoIsJbmj0ULJBVLQ8tDo,5Gyp41oLVo7Gg7vF4vpmggWP5MU70QO6,5,2,1,0,1,0,2,0,6,0.8571428571428571,1,0.0,0,1,0,1,2,0,0,2,0,2,4,1
2338,21459,NH0hsgo5xcqAdosarQoW4RQUZxH32Gzl,7GRhBDsirIGkRZBtSMEzNTyDr2JQm4xx,108,344,133,157,102,9,35,0,780,111.42857142857143,15,0.0,121,133,144,102,223,9,13,35,0,500,280,0
2339,21468,Hj6wuu6IJzCenxWAs1sLyWNMm32YIpDq,7GRhBDsirIGkRZBtSMEzNTyDr2JQm4xx,70,322,129,158,72,54,44,0,779,111.28571428571429,16,0.0,113,129,135,72,209,54,23,44,0,449,330,0
2340,21473,fd2e5NJVnyVwHFHuiTOOM639ZY1uThtn,7GRhBDsirIGkRZBtSMEzNTyDr2JQm4xx,90,285,90,158,48,112,38,2,733,104.71428571428571,16,0.0,147,90,129,48,138,112,29,38,2,414,319,1
2341,21482,lHDkxc2iXUHUUn5UnDpMsfQNxnS3B8Lp,7GRhBDsirIGkRZBtSMEzNTyDr2JQm4xx,41,80,31,34,31,22,8,0,206,29.428571428571427,4,0.0,45,31,18,31,35,22,16,8,0,125,81,0
2342,21485,l3mz2aAslwaCLhkdMrM7sQ5OXLzl6A2r,7GRhBDsirIGkRZBtSMEzNTyDr2JQm4xx,90,201,10,243,42,33,22,2,553,79.0,10,0.0,109,10,211,42,92,33,32,22,2,372,181,0
2343,21486,6ysaEs6vstKtLjiClow0f4E5UhF658OT,7GRhBDsirIGkRZBtSMEzNTyDr2JQm4xx,7,4,2,0,2,0,2,0,10,1.4285714285714286,2,0.0,0,2,0,2,4,0,0,2,0,4,6,0
2344,21487,ppwn795jM3X8HLmfBGWlJ1RCSK9HLpNe,7GRhBDsirIGkRZBtSMEzNTyDr2JQm4xx,12,17,10,0,1,2,27,2,59,8.428571428571429,2,0.0,0,10,0,1,17,2,0,27,2,11,48,0
2345,21490,zyW9YJBc7dwBcLXqHqpoJivJzWpl85bK,7GRhBDsirIGkRZBtSMEzNTyDr2JQm4xx,1,0,0,0,0,0,1,0,1,0.14285714285714285,1,0.0,0,0,0,0,0,0,0,1,0,0,1,1
2346,21495,B1P5t3Y1Njy7srjQTkBKL4uTp9GuTAn0,7GRhBDsirIGkRZBtSMEzNTyDr2JQm4xx,16,21,6,0,5,7,23,1,63,9.0,1,0.0,12,6,0,5,9,7,0,23,1,23,40,1
2347,21496,z6p7uYa25VIrmVARFxz5koBofuqHB2cM,7GRhBDsirIGkRZBtSMEzNTyDr2JQm4xx,112,167,53,157,50,9,14,0,450,64.28571428571429,7,0.0,100,53,140,50,67,9,17,14,0,343,107,0
2348,21497,NToJOpRtq67cszdyzl1RlLKqGwS5lZl5,7GRhBDsirIGkRZBtSMEzNTyDr2JQm4xx,60,78,27,113,25,0,9,0,252,36.0,7,0.0,42,27,93,25,36,0,20,9,0,187,65,1
2349,21507,NzH7q1ytDRSu9qNhporAXyxIIUjowT51,7GRhBDsirIGkRZBtSMEzNTyDr2JQm4xx,2,0,0,0,0,0,2,0,2,0.2857142857142857,1,0.0,0,0,0,0,0,0,0,2,0,0,2,1
2350,21514,ZhTCqX8GMUcn0a0betuEauHNuCk1aRhm,7GRhBDsirIGkRZBtSMEzNTyDr2JQm4xx,120,146,68,139,30,152,38,0,573,81.85714285714286,11,0.0,46,68,131,30,100,152,8,38,0,275,298,0
2351,21518,j5n34dhJSAsFAv6KAw4rsAZTfhL07lCD,7GRhBDsirIGkRZBtSMEzNTyDr2JQm4xx,2,0,0,0,0,0,3,0,3,0.42857142857142855,2,0.0,0,0,0,0,0,0,0,3,0,0,3,1
2352,21524,6Ysh3EXeoiNCd1uXxsjEQronkryNKRU5,7GRhBDsirIGkRZBtSMEzNTyDr2JQm4xx,52,167,66,74,32,7,27,0,373,53.285714285714285,9,0.0,73,66,63,32,94,7,11,27,0,234,139,1
2353,21526,uFrE2nkTnL4ZVSelDABxT39yNh0J04Eo,7GRhBDsirIGkRZBtSMEzNTyDr2JQm4xx,34,64,21,26,13,8,9,0,141,20.142857142857142,4,0.0,20,21,13,13,44,8,13,9,0,67,74,0
2354,21529,Lf0mThPYOrtlCzgRGBCVTPy1hiGUII8h,7GRhBDsirIGkRZBtSMEzNTyDr2JQm4xx,92,574,186,97,61,84,74,17,1093,156.14285714285714,15,0.0,324,186,66,61,250,84,31,74,17,637,456,0
2355,21531,GvY4Z1NOjK4oYpeBStbrl7zpe2zlFqoT,7GRhBDsirIGkRZBtSMEzNTyDr2JQm4xx,97,201,74,243,50,5,17,0,590,84.28571428571429,10,0.0,101,74,205,50,100,5,38,17,0,430,160,0
2356,21537,ofcigTTYbE1oojdrdB7FR2yHe6nxdUzR,7GRhBDsirIGkRZBtSMEzNTyDr2JQm4xx,87,125,37,50,71,2,12,0,297,42.42857142857143,9,0.0,80,37,43,71,45,2,7,12,0,231,66,0
2357,21540,3YgaCGoD5yLZIY9V7Ynw4SqcteQ0nC6R,7GRhBDsirIGkRZBtSMEzNTyDr2JQm4xx,2,0,0,0,0,0,3,0,3,0.42857142857142855,2,0.0,0,0,0,0,0,0,0,3,0,0,3,1
2358,21541,Fsp9s2U9w9caQohubxxnoFebg7SxRmA1,7GRhBDsirIGkRZBtSMEzNTyDr2JQm4xx,1,0,0,0,0,0,1,0,1,0.14285714285714285,1,0.0,0,0,0,0,0,0,0,1,0,0,1,1
2359,21545,be7952wawx5BhhJ4vIqX6Vxi48lNKbM1,7GRhBDsirIGkRZBtSMEzNTyDr2JQm4xx,9,19,12,0,12,2,7,0,52,7.428571428571429,9,0.0,2,12,0,12,17,2,0,7,0,26,26,1
2360,21550,F0XF3FxDWOcsU1tKt96v78Q6rC9yCH1T,7GRhBDsirIGkRZBtSMEzNTyDr2JQm4xx,34,61,25,50,24,0,13,0,173,24.714285714285715,4,0.0,29,25,39,24,32,0,11,13,0,117,56,0
2361,21555,QsTytAYV8W14PH6exal9KlcV5tRATGJv,7GRhBDsirIGkRZBtSMEzNTyDr2JQm4xx,5,2,1,0,1,0,3,0,7,1.0,1,0.0,0,1,0,1,2,0,0,3,0,2,5,1
2362,21558,dQBjOw3ZDQ2EPHOdT4W6pRAoF6sniGIc,7GRhBDsirIGkRZBtSMEzNTyDr2JQm4xx,43,66,32,65,18,6,26,1,214,30.571428571428573,6,0.0,27,32,58,18,39,6,7,26,1,135,79,1
2363,21561,OaI9ma7KxaY6DFxSwgYhrXCPXva2T3pp,7GRhBDsirIGkRZBtSMEzNTyDr2JQm4xx,68,164,64,132,33,10,29,0,432,61.714285714285715,12,0.0,62,64,110,33,102,10,22,29,0,269,163,0
2364,21562,VL0rdkFTRaRvYW02oZ1fEazY0Pyp6eKe,7GRhBDsirIGkRZBtSMEzNTyDr2JQm4xx,5,2,1,0,1,0,2,0,6,0.8571428571428571,1,0.0,0,1,0,1,2,0,0,2,0,2,4,1
2365,21564,w1NKmDhRc1aeBgZmDEyDguSkZ23SdrlX,7GRhBDsirIGkRZBtSMEzNTyDr2JQm4xx,54,81,46,20,48,4,20,1,220,31.428571428571427,6,0.0,26,46,14,48,55,4,6,20,1,134,86,1
2366,21565,ld1EJfSSRlnpkPJAGgD6T5OR8Mi6NnWn,7GRhBDsirIGkRZBtSMEzNTyDr2JQm4xx,41,38,17,36,13,7,1,0,112,16.0,2,0.0,20,17,21,13,18,7,15,1,0,71,41,0
2367,21570,y9BxmAhm0ieCF6b0HaF7gMrGu5BDtZs5,7GRhBDsirIGkRZBtSMEzNTyDr2JQm4xx,152,447,177,281,157,14,85,0,1161,165.85714285714286,12,0.0,223,177,228,157,224,14,53,85,0,785,376,0
2368,21618,TzODuX5kuf2iqGNG9vk0uMzeGNqx5LsA,7GRhBDsirIGkRZBtSMEzNTyDr2JQm4xx,71,247,13,62,23,1,43,3,392,56.0,7,0.0,90,13,41,23,157,1,21,43,3,167,225,0
2369,21638,mwc0YjZS72xD4dO6Zk7KmFewdh7PWkAS,7GRhBDsirIGkRZBtSMEzNTyDr2JQm4xx,92,206,69,83,72,11,24,1,466,66.57142857142857,14,0.0,116,69,80,72,90,11,3,24,1,337,129,0
2370,21640,yf6f57VN5vQ3uXtZoopqYTtboGpfts8e,7GRhBDsirIGkRZBtSMEzNTyDr2JQm4xx,53,58,21,79,6,13,10,0,187,26.714285714285715,4,0.0,20,21,71,6,38,13,8,10,0,118,69,0
2371,21642,J08eSQ89mAYluVujsdeguHqd32zsFjVm,7GRhBDsirIGkRZBtSMEzNTyDr2JQm4xx,19,46,8,10,11,1,4,1,81,11.571428571428571,1,0.0,17,8,5,11,29,1,5,4,1,41,40,0
2372,21659,D5mwgoAPtfwdsFrdNADBqEJQSy8E0CUi,7GRhBDsirIGkRZBtSMEzNTyDr2JQm4xx,166,312,136,187,88,25,98,2,848,121.14285714285714,17,0.0,129,136,172,88,183,25,15,98,2,525,323,0
2373,21672,c9jABEJQla4i8vH29nKPFM4cx5bWdrLS,7GRhBDsirIGkRZBtSMEzNTyDr2JQm4xx,141,379,162,126,134,7,31,2,841,120.14285714285714,11,0.0,184,162,119,134,195,7,7,31,2,599,242,0
2374,21690,mezQjcBtwPIB1SXkjHJo9kxjc5UIXdOH,7GRhBDsirIGkRZBtSMEzNTyDr2JQm4xx,136,266,99,217,100,18,30,0,730,104.28571428571429,10,0.0,138,99,172,100,128,18,45,30,0,509,221,1
2375,21692,rf43ZHojMqXQ775bmX3nnHgQ62d9XvGK,7GRhBDsirIGkRZBtSMEzNTyDr2JQm4xx,9,7,2,11,2,0,14,0,36,5.142857142857143,7,0.0,2,2,9,2,5,0,2,14,0,15,21,1
2376,21708,aU6SEeOgxLKetBRDwfHMDunWavvfr54M,7GRhBDsirIGkRZBtSMEzNTyDr2JQm4xx,105,305,103,159,93,90,66,8,824,117.71428571428571,15,0.0,132,103,133,93,173,90,26,66,8,461,363,0
2377,21714,b4VAhvG3MG7lVRCMYGT7EV06rJVZjoZJ,7GRhBDsirIGkRZBtSMEzNTyDr2JQm4xx,4,2,0,0,0,0,2,0,4,0.5714285714285714,1,0.0,0,0,0,0,2,0,0,2,0,0,4,1
2378,21732,u5O8fjjPHRbPw2KPw4c64f7wflYutdNi,7GRhBDsirIGkRZBtSMEzNTyDr2JQm4xx,9,6,2,0,3,0,3,0,14,2.0,1,0.0,3,2,0,3,3,0,0,3,0,8,6,1
2379,21782,Byhwk1UEYpL8TtNadTQnAIVJYIZTg2mz,7GRhBDsirIGkRZBtSMEzNTyDr2JQm4xx,9,5,3,0,2,1,5,0,16,2.2857142857142856,1,0.0,0,3,0,2,5,1,0,5,0,5,11,1
2380,21816,5M2ejSoYrgCHrezYAGX7ObuTLuLA6uzQ,7GRhBDsirIGkRZBtSMEzNTyDr2JQm4xx,7,12,1,0,3,0,5,0,21,3.0,2,0.0,4,1,0,3,8,0,0,5,0,8,13,1
2381,21820,GGGVxWw7kUcQH8IveSqLixfu0u0FTfvz,7GRhBDsirIGkRZBtSMEzNTyDr2JQm4xx,13,12,2,0,1,19,15,0,49,7.0,4,0.0,0,2,0,1,12,19,0,15,0,3,46,1
2382,21844,On1tK59iw06VEP0NRLWC0Rz8UvbQNGmx,7GRhBDsirIGkRZBtSMEzNTyDr2JQm4xx,3,0,0,0,0,1,2,0,3,0.42857142857142855,1,0.0,0,0,0,0,0,1,0,2,0,0,3,0
2383,21868,i7XmXhv20MDc4pSGJ73V7rP8k8qLIKo3,7GRhBDsirIGkRZBtSMEzNTyDr2JQm4xx,1,0,0,0,0,0,1,0,1,0.14285714285714285,1,0.0,0,0,0,0,0,0,0,1,0,0,1,1
2384,21870,3OGm4X1PEnAaZoBoZXt04kXOR4TFtoHS,7GRhBDsirIGkRZBtSMEzNTyDr2JQm4xx,63,121,47,78,62,3,40,1,352,50.285714285714285,11,0.0,69,47,64,62,52,3,14,40,1,242,110,1
2385,21877,x0ypShGgWj2iz8J8F4tgf2ws2WEbIgWB,7GRhBDsirIGkRZBtSMEzNTyDr2JQm4xx,1,0,0,0,0,0,1,0,1,0.14285714285714285,1,0.0,0,0,0,0,0,0,0,1,0,0,1,1
2386,21899,1dqyrMpu9Xi6FGeCi6jMkyQJfHaqDBod,7GRhBDsirIGkRZBtSMEzNTyDr2JQm4xx,7,6,0,0,1,0,2,0,9,1.2857142857142858,1,0.0,2,0,0,1,4,0,0,2,0,3,6,1
2387,21900,LRwPaW9GtyhH2VMWEMsABaY8IaWh4rBR,7GRhBDsirIGkRZBtSMEzNTyDr2JQm4xx,103,116,30,173,46,21,10,1,397,56.714285714285715,3,0.0,79,30,133,46,37,21,40,10,1,288,109,1
2388,21922,UyrB62TC80PvjIx5mHAqyBQJHo9hnImU,7GRhBDsirIGkRZBtSMEzNTyDr2JQm4xx,12,7,5,0,4,0,5,0,21,3.0,3,0.0,0,5,0,4,7,0,0,5,0,9,12,1
2389,21976,MYCZGZUUB6h2kR5SWwXC3erQhe8wj439,7GRhBDsirIGkRZBtSMEzNTyDr2JQm4xx,78,161,61,101,27,32,49,0,431,61.57142857142857,13,0.0,71,61,100,27,90,32,1,49,0,259,172,0
2390,21999,r6bvKJ2a2G72TbQZE3LacWwmKi7rGXEx,7GRhBDsirIGkRZBtSMEzNTyDr2JQm4xx,56,186,46,81,35,25,24,3,400,57.142857142857146,6,0.0,80,46,74,35,106,25,7,24,3,235,165,1
2391,22022,wXFfHtwd9smrvhh9NQW7SmEEo1001LDW,7GRhBDsirIGkRZBtSMEzNTyDr2JQm4xx,36,41,17,36,12,11,9,1,127,18.142857142857142,4,0.0,18,17,31,12,23,11,5,9,1,78,49,1
2392,22062,MuwljKZkWjKmChDtxaHsKSqu30ykavpg,7GRhBDsirIGkRZBtSMEzNTyDr2JQm4xx,96,293,99,78,42,4,28,3,547,78.14285714285714,10,0.0,121,99,73,42,172,4,5,28,3,335,212,0
2393,22066,Bjvrs4inCOWPKrgMojrWIxl2MDJEdLE9,7GRhBDsirIGkRZBtSMEzNTyDr2JQm4xx,10,7,1,0,1,0,2,0,11,1.5714285714285714,1,0.0,0,1,0,1,7,0,0,2,0,2,9,1
2394,22076,6izQCEneEK1X6C1taxn0XENXkSv3cl84,7GRhBDsirIGkRZBtSMEzNTyDr2JQm4xx,1,0,0,0,0,0,3,0,3,0.42857142857142855,2,0.0,0,0,0,0,0,0,0,3,0,0,3,1
2395,22212,ezzV2inIlk654APZ7lOJdt6ubCpUxMCa,7GRhBDsirIGkRZBtSMEzNTyDr2JQm4xx,72,198,28,134,28,165,38,5,596,85.14285714285714,14,0.0,82,28,111,28,116,165,23,38,5,249,347,0
2396,22268,tixL6jRbFRYTnAeCUMfXKIdV2z5MfmCZ,7GRhBDsirIGkRZBtSMEzNTyDr2JQm4xx,39,39,34,14,22,0,11,0,120,17.142857142857142,4,0.0,1,34,11,22,38,0,3,11,0,68,52,1
2397,22293,kK7amf4iBPuG10KmyQTgC89PtCcZTAe2,7GRhBDsirIGkRZBtSMEzNTyDr2JQm4xx,10,6,5,0,4,0,26,1,42,6.0,2,0.0,0,5,0,4,6,0,0,26,1,9,33,0
2398,22317,GGioMvSJ2TI5A4koIk2G8ocfb1Yz1YTO,5Gyp41oLVo7Gg7vF4vpmggWP5MU70QO6,1,0,0,0,0,0,1,0,1,0.14285714285714285,1,0.0,0,0,0,0,0,0,0,1,0,0,1,1
2399,22347,smHnG8vpfHIB1FLFCsfWSMXg6fq0twWp,5Gyp41oLVo7Gg7vF4vpmggWP5MU70QO6,20,14,12,7,5,0,4,0,42,6.0,2,0.0,1,12,4,5,13,0,3,4,0,22,20,1
2400,22366,HOykN2uJJue4nk8EOtMAMPwGp1qoBRJT,5Gyp41oLVo7Gg7vF4vpmggWP5MU70QO6,29,46,31,7,10,22,12,0,128,18.285714285714285,4,0.0,8,31,4,10,38,22,3,12,0,53,75,1
2401,22375,lZnDmUFZ3RPpS8WhvoeYbrPZZf5syUz5,5Gyp41oLVo7Gg7vF4vpmggWP5MU70QO6,13,23,5,20,6,21,4,0,79,11.285714285714286,3,0.0,5,5,15,6,18,21,5,4,0,31,48,1
2402,22376,OkJ0lKmMXuQ2MGftQ8Isfw1JciMpapRC,5Gyp41oLVo7Gg7vF4vpmggWP5MU70QO6,12,15,6,0,2,0,12,0,35,5.0,4,0.0,3,6,0,2,12,0,0,12,0,11,24,1
2403,22386,JdJ1SwT93OWgPbpS5GdJzD3RLASaE4SR,5Gyp41oLVo7Gg7vF4vpmggWP5MU70QO6,62,124,62,110,7,15,39,1,358,51.142857142857146,14,0.0,28,62,99,7,96,15,11,39,1,196,162,0
2404,22427,UrENN1zIfJIc4hCxDDWe8c7coKokiTdF,5Gyp41oLVo7Gg7vF4vpmggWP5MU70QO6,45,148,86,64,37,27,12,0,374,53.42857142857143,6,0.0,45,86,57,37,103,27,7,12,0,225,149,0
2405,22439,blQFA8HzhNQeb8MMYJXyJW6sPMdvZQKn,5Gyp41oLVo7Gg7vF4vpmggWP5MU70QO6,15,15,7,7,6,3,6,0,44,6.285714285714286,3,0.0,4,7,5,6,11,3,2,6,0,22,22,1
2406,22453,SRWyybFCyRnJ5WkAnmW9p9zBXOYVWjli,5Gyp41oLVo7Gg7vF4vpmggWP5MU70QO6,9,21,11,0,0,149,20,6,207,29.571428571428573,7,0.0,0,11,0,0,21,149,0,20,6,11,196,1
2407,22474,Ci9K2Hg2fGB1BwuqHBCLFF3JRq0fwfBw,5Gyp41oLVo7Gg7vF4vpmggWP5MU70QO6,11,13,8,0,5,0,3,0,29,4.142857142857143,3,0.0,2,8,0,5,11,0,0,3,0,15,14,1
2408,22497,DVIil2NM7ZWOtqe6rhlMzwEUAb2wuaeh,5Gyp41oLVo7Gg7vF4vpmggWP5MU70QO6,5,0,0,0,0,1,4,1,6,0.8571428571428571,1,0.0,0,0,0,0,0,1,0,4,1,0,6,1
2409,22523,TozaOtIFG8vkGyP2fXfC45I7si7w78eb,5Gyp41oLVo7Gg7vF4vpmggWP5MU70QO6,8,4,2,0,1,4,8,1,20,2.857142857142857,1,0.0,0,2,0,1,4,4,0,8,1,3,17,1
2410,22538,uMEUDlZ1tL8WoZ2EmL0CStSYwA0zOal8,5Gyp41oLVo7Gg7vF4vpmggWP5MU70QO6,10,17,7,6,2,0,2,0,34,4.857142857142857,2,0.0,5,7,5,2,12,0,1,2,0,19,15,1
2411,22547,sEjCSxiV4U3FouTICvcD4zFUuMByUanv,5Gyp41oLVo7Gg7vF4vpmggWP5MU70QO6,7,6,4,0,3,1,1,0,15,2.142857142857143,1,0.0,1,4,0,3,5,1,0,1,0,8,7,1
2412,22549,LWpdQl1kIM7O0RFkPOOWkIIuXkfkptb7,5Gyp41oLVo7Gg7vF4vpmggWP5MU70QO6,10,25,8,2,4,2,4,0,45,6.428571428571429,3,0.0,9,8,1,4,16,2,1,4,0,22,23,1
2413,22555,L4rfrz5IG5CnYOQ8tF1uZUfhIbYnk3pq,5Gyp41oLVo7Gg7vF4vpmggWP5MU70QO6,1,0,0,0,0,0,4,0,4,0.5714285714285714,1,0.0,0,0,0,0,0,0,0,4,0,0,4,1
2414,22572,cTe9j4PdslDnq3xIrpLJR1wCTH6ieU9f,5Gyp41oLVo7Gg7vF4vpmggWP5MU70QO6,9,8,4,0,2,0,6,0,20,2.857142857142857,3,0.0,0,4,0,2,8,0,0,6,0,6,14,1
2415,22582,i0ksX07HnsV5rQlWqOr1uKEuc7yNU24c,5Gyp41oLVo7Gg7vF4vpmggWP5MU70QO6,31,61,37,11,10,9,31,3,162,23.142857142857142,14,0.0,11,37,7,10,50,9,4,31,3,65,97,0
2416,22586,bFBipIvg3ynAbrvo3mXNRP6i8NWVQRYx,5Gyp41oLVo7Gg7vF4vpmggWP5MU70QO6,15,30,17,6,9,15,26,17,120,17.142857142857142,5,0.0,4,17,4,9,26,15,2,26,17,34,86,1
2417,22600,TskFrPtAVOkXDid77obsVFy9LWYFHqHh,5Gyp41oLVo7Gg7vF4vpmggWP5MU70QO6,1,0,0,0,0,0,1,0,1,0.14285714285714285,1,0.0,0,0,0,0,0,0,0,1,0,0,1,1
2418,22603,BlAzg2gVUHCR0etol6wfOtV7A74GKZIx,5Gyp41oLVo7Gg7vF4vpmggWP5MU70QO6,1,0,0,0,0,0,1,0,1,0.14285714285714285,1,0.0,0,0,0,0,0,0,0,1,0,0,1,1
2419,22609,BRuob7UoRxkckZfA2Kz9zU3YGLVQRLrf,5Gyp41oLVo7Gg7vF4vpmggWP5MU70QO6,15,16,7,12,1,0,3,0,39,5.571428571428571,2,0.0,4,7,9,1,12,0,3,3,0,21,18,0
2420,22611,LpKc0q3vwtZx2tbV2GItCPMY7oFOnDvF,5Gyp41oLVo7Gg7vF4vpmggWP5MU70QO6,15,33,19,0,1,5,12,0,70,10.0,7,0.0,5,19,0,1,28,5,0,12,0,25,45,1
2421,22622,AtlXb54YoHc4l0gdtB83pi4Jcr8xBgAB,5Gyp41oLVo7Gg7vF4vpmggWP5MU70QO6,10,10,3,3,4,0,2,0,22,3.142857142857143,1,0.0,6,3,2,4,4,0,1,2,0,15,7,1
2422,22628,8UhW1HcJSpUKetcNndZSyo2w5k5GEb12,5Gyp41oLVo7Gg7vF4vpmggWP5MU70QO6,4,0,0,0,0,8,4,0,12,1.7142857142857142,1,0.0,0,0,0,0,0,8,0,4,0,0,12,1
2423,22640,SXQudUQxotVyHX3jIj58IdonMUWj4z4L,RXDvfPUBYFlVdlueBFbLW0mhhAyGEqpt,64,174,99,122,19,1,37,0,452,64.57142857142857,9,0.0,38,99,119,19,136,1,3,37,0,275,177,0
2424,22647,ytmo5vQStkDdkr7G8Cx66kM5tANiVYa8,G8EPVSXsOYB5YQWZGiz1aVq5Pgr2GrQu,48,64,53,66,26,0,11,1,221,31.571428571428573,5,0.0,5,53,48,26,59,0,18,11,1,132,89,1
2425,22651,bPMM8JJVMbo3dHwzrkYwNanOXVlVjIZM,SpATywNh6bZuzm8s1ceuBUnMUAeoAHHw,47,124,80,58,61,4,11,0,338,48.285714285714285,18,0.0,34,80,48,61,90,4,10,11,0,223,115,0
2426,22655,DVzw8nYpE4lnf8MkHHhtHMESTcnd5SSm,A3fsA9Zfv1X2fVEQhTw51lKENdNrEqT3,7,3,2,0,2,0,4,0,11,1.5714285714285714,2,0.0,0,2,0,2,3,0,0,4,0,4,7,1
2427,22656,6r68uLeYBa0U5j97XGrLINpoFwwpiU0a,SpATywNh6bZuzm8s1ceuBUnMUAeoAHHw,41,142,9,19,4,1,23,4,202,28.857142857142858,12,0.0,35,9,16,4,107,1,3,23,4,64,138,0
2428,22658,3SER276qaao5TSZqnt0y9TkdmkGTUUcO,A3fsA9Zfv1X2fVEQhTw51lKENdNrEqT3,42,17,14,62,12,0,3,0,108,15.428571428571429,2,0.0,1,14,54,12,16,0,8,3,0,81,27,1
2429,22661,zgbCsvFYb3b53axsu4K7VNjBEGD1Bru2,G8EPVSXsOYB5YQWZGiz1aVq5Pgr2GrQu,50,119,14,105,7,49,26,5,325,46.42857142857143,6,0.0,17,14,89,7,102,49,16,26,5,127,198,1
2430,22663,v8EL49Rw5uIBfTnluJIiynUhJSONuHZw,A3fsA9Zfv1X2fVEQhTw51lKENdNrEqT3,24,7,2,38,0,0,1,0,48,6.857142857142857,2,0.0,2,2,38,0,5,0,0,1,0,42,6,1
2431,22666,8NZmD5KXyLIfbrDZRanIJvBfumgIsUhW,SpATywNh6bZuzm8s1ceuBUnMUAeoAHHw,22,53,21,16,2,8,15,0,115,16.428571428571427,9,0.0,15,21,15,2,38,8,1,15,0,53,62,0
2432,22672,xtQFPkqe4Pp8hbaCpifaLA8aJ90k2oDs,SpATywNh6bZuzm8s1ceuBUnMUAeoAHHw,20,68,2,12,2,0,4,0,88,12.571428571428571,5,0.0,22,2,9,2,46,0,3,4,0,35,53,0
2433,22675,FZWt1vapJFvo3kXFvlr3Pcq5dqSsXIdl,A3fsA9Zfv1X2fVEQhTw51lKENdNrEqT3,18,22,15,0,8,0,12,0,57,8.142857142857142,3,0.0,0,15,0,8,22,0,0,12,0,23,34,1
2434,22688,6aazLDsf7EAZ2t5BIjBNI9Ug5zAk9J2O,SpATywNh6bZuzm8s1ceuBUnMUAeoAHHw,29,33,17,20,6,5,10,0,91,13.0,5,0.0,4,17,18,6,29,5,2,10,0,45,46,0
2435,22699,f7tZxTkA0B7yOxMWeydGO2hW0y86mAhD,A3fsA9Zfv1X2fVEQhTw51lKENdNrEqT3,101,152,58,126,24,6,27,1,394,56.285714285714285,12,0.0,11,58,125,24,141,6,1,27,1,218,176,0
2436,22705,JoQg2qlyTB6aPyv163qnZSLUAy3J9zXZ,bWdj2GDclj5ofokWjzoa5jAwMkxCykd6,9,12,5,6,4,0,2,0,29,4.142857142857143,2,0.0,5,5,6,4,7,0,0,2,0,20,9,1
2437,22706,JoQg2qlyTB6aPyv163qnZSLUAy3J9zXZ,A3fsA9Zfv1X2fVEQhTw51lKENdNrEqT3,6,6,3,0,0,0,3,0,12,1.7142857142857142,3,0.0,0,3,0,0,6,0,0,3,0,3,9,1
2438,22711,TPPsOieQBcwqH8dqABTR3mddQ5gDzlZO,SpATywNh6bZuzm8s1ceuBUnMUAeoAHHw,44,63,28,64,14,0,14,0,183,26.142857142857142,6,0.0,29,28,54,14,34,0,10,14,0,125,58,0
2439,22720,4iz2t15J5bzEPElZVcStT3H8hpTNKJIQ,SpATywNh6bZuzm8s1ceuBUnMUAeoAHHw,15,23,9,18,0,3,5,0,58,8.285714285714286,4,0.0,7,9,15,0,16,3,3,5,0,31,27,0
2440,22733,IQ4ladQoM2x2909mlbY9xWKwXIcK6uEd,A3fsA9Zfv1X2fVEQhTw51lKENdNrEqT3,45,21,18,60,14,1,22,1,137,19.571428571428573,4,0.0,2,18,55,14,19,1,5,22,1,89,48,0
2441,22737,Os09VRrdiO6C7gqaf1B7u0gzmL7FIPJg,SpATywNh6bZuzm8s1ceuBUnMUAeoAHHw,19,75,17,31,0,17,11,1,152,21.714285714285715,3,0.0,54,17,27,0,21,17,4,11,1,98,54,1
2442,22760,xQ0oPcnoBqnptb23qNnWO05KL2jCqFC5,SpATywNh6bZuzm8s1ceuBUnMUAeoAHHw,7,26,9,0,0,1,9,0,45,6.428571428571429,6,0.0,8,9,0,0,18,1,0,9,0,17,28,1
2443,22779,Di3I8NyVIkGc06HLMDBeTqdX1iL5ZolI,A3fsA9Zfv1X2fVEQhTw51lKENdNrEqT3,6,0,0,0,0,4,12,0,16,2.2857142857142856,1,0.0,0,0,0,0,0,4,0,12,0,0,16,1
2444,22786,6TmTcNQyMYVAXbtK6HsQ96Mn7OGENU3z,bWdj2GDclj5ofokWjzoa5jAwMkxCykd6,4,2,1,0,0,0,2,0,5,0.7142857142857143,1,0.0,0,1,0,0,2,0,0,2,0,1,4,1
2445,22796,NEe9TsP56Xype0U6CLfwX8CaejtfAtDd,SpATywNh6bZuzm8s1ceuBUnMUAeoAHHw,28,101,8,62,1,15,32,1,220,31.428571428571427,7,0.0,35,8,52,1,66,15,10,32,1,96,124,0
2446,22805,6TmTcNQyMYVAXbtK6HsQ96Mn7OGENU3z,A3fsA9Zfv1X2fVEQhTw51lKENdNrEqT3,7,6,1,0,1,0,1,0,9,1.2857142857142858,1,0.0,0,1,0,1,6,0,0,1,0,2,7,1
2447,22822,jt6cAnJpqYCiS3Lj5wNBvifs8WZJznlF,A3fsA9Zfv1X2fVEQhTw51lKENdNrEqT3,9,4,3,0,3,0,3,0,13,1.8571428571428572,1,0.0,0,3,0,3,4,0,0,3,0,6,7,1
2448,22825,pgtfwPx3gBWk0s41FLIY8xNKvQvpnNYF,SpATywNh6bZuzm8s1ceuBUnMUAeoAHHw,25,42,2,25,3,9,13,1,95,13.571428571428571,2,0.0,12,2,19,3,30,9,6,13,1,36,59,0
2449,22828,pgtfwPx3gBWk0s41FLIY8xNKvQvpnNYF,A3fsA9Zfv1X2fVEQhTw51lKENdNrEqT3,10,5,1,0,1,2,10,2,21,3.0,3,0.0,0,1,0,1,5,2,0,10,2,2,19,1
2450,22844,TQIRy5vD7Rgv73APMCqQZ7AssMVX3u4N,A3fsA9Zfv1X2fVEQhTw51lKENdNrEqT3,34,20,17,0,14,0,6,0,57,8.142857142857142,4,0.0,0,17,0,14,20,0,0,6,0,31,26,1
2451,22847,uKSoXEJNhPBaLwogtj5AI2INbh67Hhkx,G8EPVSXsOYB5YQWZGiz1aVq5Pgr2GrQu,7,12,0,0,1,0,3,0,16,2.2857142857142856,2,0.0,2,0,0,1,10,0,0,3,0,3,13,1
2452,22849,Wd5Y51TL4njlLeYHUjz5D9nrsHvDXUZ8,A3fsA9Zfv1X2fVEQhTw51lKENdNrEqT3,130,64,41,318,13,5,30,1,472,67.42857142857143,10,0.0,5,41,280,13,59,5,38,30,1,339,133,0
2453,22855,4J9zAQq4ZlZzXgNIT2zhfBx7kGs24C6D,SpATywNh6bZuzm8s1ceuBUnMUAeoAHHw,30,41,21,26,8,21,24,0,141,20.142857142857142,10,0.0,11,21,25,8,30,21,1,24,0,65,76,0
2454,22858,xOeteuxexg2mP8NxgmLBWH8qhXnVfLfh,A3fsA9Zfv1X2fVEQhTw51lKENdNrEqT3,1,0,0,0,0,0,1,0,1,0.14285714285714285,1,0.0,0,0,0,0,0,0,0,1,0,0,1,1
2455,22867,ec87BaRQsrP5IAuQEXYeAFWoVPURyRtj,SpATywNh6bZuzm8s1ceuBUnMUAeoAHHw,30,48,10,28,6,4,14,1,111,15.857142857142858,3,0.0,17,10,25,6,31,4,3,14,1,58,53,0
2456,22882,53VGMeycKD8ekdZB7srikqwK1dcTbnwu,bWdj2GDclj5ofokWjzoa5jAwMkxCykd6,20,41,14,44,13,0,11,0,123,17.571428571428573,6,0.0,19,14,38,13,22,0,6,11,0,84,39,1
2457,22889,VXeEmbu1PPBvvH7wFjnGFaE2yqIFKByx,G8EPVSXsOYB5YQWZGiz1aVq5Pgr2GrQu,23,38,2,0,3,2,14,0,59,8.428571428571429,4,0.0,4,2,0,3,34,2,0,14,0,9,50,1
2458,22891,tnLfm9tutF6YoqDXNIONCmii1aynBy80,SpATywNh6bZuzm8s1ceuBUnMUAeoAHHw,28,70,33,30,7,5,25,0,170,24.285714285714285,8,0.0,7,33,23,7,63,5,7,25,0,70,100,0
2459,22893,fslIhUAreTqu48Va3DJjHuBASqZWV4lb,SpATywNh6bZuzm8s1ceuBUnMUAeoAHHw,18,27,2,3,1,0,5,0,38,5.428571428571429,3,0.0,0,2,3,1,27,0,0,5,0,6,32,0
2460,22896,kwtDMW6kCF4Dj4cVANDmT2RtqpyiMQZT,A3fsA9Zfv1X2fVEQhTw51lKENdNrEqT3,101,176,77,225,43,0,51,0,572,81.71428571428571,14,0.0,3,77,189,43,173,0,36,51,0,312,260,0
2461,22909,za2dBkPPLD9IPRBjooK7GJit2ulI5UgN,SpATywNh6bZuzm8s1ceuBUnMUAeoAHHw,19,19,7,43,1,13,10,1,94,13.428571428571429,4,0.0,9,7,36,1,10,13,7,10,1,53,41,0
2462,22916,dLoTMfurIDgppPqjn68MhR8oLIGjxbCC,A3fsA9Zfv1X2fVEQhTw51lKENdNrEqT3,12,32,16,0,5,0,12,1,66,9.428571428571429,5,0.0,0,16,0,5,32,0,0,12,1,21,45,1
2463,22917,faHDojVqWXLiB8t0I6HX2vfFaDqeEAWd,G8EPVSXsOYB5YQWZGiz1aVq5Pgr2GrQu,26,45,3,64,1,0,4,0,117,16.714285714285715,3,0.0,18,3,46,1,27,0,18,4,0,68,49,1
2464,22923,CbShtPgX8EbSEeSUeGV654dzDIai2s5c,G8EPVSXsOYB5YQWZGiz1aVq5Pgr2GrQu,4,8,0,0,1,0,1,0,10,1.4285714285714286,1,0.0,5,0,0,1,3,0,0,1,0,6,4,1
2465,22930,HrbizO8RcI1YFSo093sl97C3MRm3iZSm,SpATywNh6bZuzm8s1ceuBUnMUAeoAHHw,10,7,1,0,1,3,4,0,16,2.2857142857142856,2,0.0,0,1,0,1,7,3,0,4,0,2,14,1
2466,22939,za2dBkPPLD9IPRBjooK7GJit2ulI5UgN,A3fsA9Zfv1X2fVEQhTw51lKENdNrEqT3,12,8,4,0,3,0,5,0,20,2.857142857142857,2,0.0,0,4,0,3,8,0,0,5,0,7,13,1
2467,22960,G7eyYYWDjRzjfvQepcwnefZtLIHlQINA,SpATywNh6bZuzm8s1ceuBUnMUAeoAHHw,28,45,18,35,5,11,18,1,133,19.0,7,0.0,18,18,31,5,27,11,4,18,1,72,61,1
2468,22962,M6VmJD8JYDR5w6GV5uzAgWpIXM5eanml,G8EPVSXsOYB5YQWZGiz1aVq5Pgr2GrQu,193,462,212,332,97,45,45,1,1194,170.57142857142858,12,0.0,90,212,257,97,372,45,75,45,1,656,538,0
2469,22969,dT92IjRcuruPiAlpqVUTtu3wNL9IIegT,A3fsA9Zfv1X2fVEQhTw51lKENdNrEqT3,27,44,17,0,10,0,11,0,82,11.714285714285714,3,0.0,2,17,0,10,42,0,0,11,0,29,53,1
2470,22970,dT92IjRcuruPiAlpqVUTtu3wNL9IIegT,bWdj2GDclj5ofokWjzoa5jAwMkxCykd6,49,90,33,130,17,104,27,1,402,57.42857142857143,8,0.0,8,33,112,17,82,104,18,27,1,170,232,1
2471,22988,mYyzW7j4oHjgvbS0hfWvmpiecRMbZDgq,SpATywNh6bZuzm8s1ceuBUnMUAeoAHHw,15,35,16,29,5,4,10,0,99,14.142857142857142,5,0.0,7,16,22,5,28,4,7,10,0,50,49,1
2472,22993,WaZjCMCq9zHT0tGjpLu6Y2rc6ox0JLNd,A3fsA9Zfv1X2fVEQhTw51lKENdNrEqT3,44,24,16,86,14,0,14,0,154,22.0,3,0.0,3,16,67,14,21,0,19,14,0,100,54,1
2473,22996,W9f8UmYzSEsFhECsZDg6FwyOA22yb0R3,SpATywNh6bZuzm8s1ceuBUnMUAeoAHHw,61,146,67,56,29,316,79,13,706,100.85714285714286,16,0.0,53,67,50,29,93,316,6,79,13,199,507,0
2474,23002,QgNI0yI2W8R4yAAyuaSrYw2RL1D6EBzF,A3fsA9Zfv1X2fVEQhTw51lKENdNrEqT3,5,2,1,0,1,0,2,0,6,0.8571428571428571,1,0.0,0,1,0,1,2,0,0,2,0,2,4,1
2475,23006,UInMBEH8f1h2vxXVslRsWyLOTv8ggYq3,A3fsA9Zfv1X2fVEQhTw51lKENdNrEqT3,81,109,53,172,17,107,37,1,496,70.85714285714286,9,0.0,11,53,137,17,98,107,35,37,1,218,278,1
2476,23014,UInMBEH8f1h2vxXVslRsWyLOTv8ggYq3,bWdj2GDclj5ofokWjzoa5jAwMkxCykd6,35,56,29,134,8,73,28,3,331,47.285714285714285,9,0.0,4,29,127,8,52,73,7,28,3,168,163,0
2477,23049,I2ghGumCKIaVsnJOGZA0xyJzTnEm5KtW,SpATywNh6bZuzm8s1ceuBUnMUAeoAHHw,29,34,19,26,7,27,7,0,120,17.142857142857142,6,0.0,7,19,22,7,27,27,4,7,0,55,65,1
2478,23054,aOK5wIKpKN9ikUy2a1FUGeQDEt1AAFa3,G8EPVSXsOYB5YQWZGiz1aVq5Pgr2GrQu,46,76,55,44,25,11,42,2,255,36.42857142857143,11,0.0,0,55,36,25,76,11,8,42,2,116,139,1
2479,23058,Dp9gZlmwGRMU0Crlqtgk7QHM4JW7fsY6,SpATywNh6bZuzm8s1ceuBUnMUAeoAHHw,33,62,10,51,5,0,13,0,141,20.142857142857142,6,0.0,21,10,40,5,41,0,11,13,0,76,65,0
2480,23061,PzUJiLnP9HZJxQE6JmMTkx1KTzCMtAvI,bWdj2GDclj5ofokWjzoa5jAwMkxCykd6,8,7,4,0,1,0,6,0,18,2.5714285714285716,1,0.0,0,4,0,1,7,0,0,6,0,5,13,1
2481,23063,mekJnkZy13R9odlyEHUcID5pf1ROn3NK,bWdj2GDclj5ofokWjzoa5jAwMkxCykd6,1,0,0,0,0,0,1,0,1,0.14285714285714285,1,0.0,0,0,0,0,0,0,0,1,0,0,1,1
2482,23066,wKKdkZJ3MevUShYy00jn3yNZpY2kcdrV,bWdj2GDclj5ofokWjzoa5jAwMkxCykd6,7,4,2,0,0,1,8,1,16,2.2857142857142856,2,0.0,0,2,0,0,4,1,0,8,1,2,14,1
2483,23068,mekJnkZy13R9odlyEHUcID5pf1ROn3NK,A3fsA9Zfv1X2fVEQhTw51lKENdNrEqT3,2,0,0,0,0,0,2,0,2,0.2857142857142857,1,0.0,0,0,0,0,0,0,0,2,0,0,2,1
2484,23073,gZWf27ETcHz4bBmwZPjiPumw55JZ4IOR,SpATywNh6bZuzm8s1ceuBUnMUAeoAHHw,32,54,2,38,5,67,12,1,179,25.571428571428573,5,0.0,22,2,34,5,32,67,4,12,1,63,116,0
2485,23084,mjoKY29bSBUSIg1iJCO4z3ZZIabGnClW,SpATywNh6bZuzm8s1ceuBUnMUAeoAHHw,28,59,24,39,8,42,23,0,195,27.857142857142858,8,0.0,14,24,30,8,45,42,9,23,0,76,119,0
2486,23091,aOhrgEBrLoAbudoZk6lY36jneHxQbWdO,G8EPVSXsOYB5YQWZGiz1aVq5Pgr2GrQu,66,57,29,116,13,8,32,7,262,37.42857142857143,6,0.0,0,29,96,13,57,8,20,32,7,138,124,0
2487,23118,2wKdgTom3CXBb3VapzvEijoKrYgkRC9s,SpATywNh6bZuzm8s1ceuBUnMUAeoAHHw,26,33,26,8,14,13,20,3,117,16.714285714285715,3,0.0,0,26,8,14,33,13,0,20,3,48,69,0
2488,23130,hGDnsprgLmlBuNCzDAhbMdsa7xgZW8Z4,A3fsA9Zfv1X2fVEQhTw51lKENdNrEqT3,50,16,8,136,2,21,14,0,197,28.142857142857142,2,0.0,2,8,113,2,14,21,23,14,0,125,72,1
2489,23135,Emt7DBFLBFlleaJw0CDWZkbz2fh9bCe8,SpATywNh6bZuzm8s1ceuBUnMUAeoAHHw,15,11,8,0,5,0,6,0,30,4.285714285714286,1,0.0,0,8,0,5,11,0,0,6,0,13,17,1
2490,23137,adDGX99l1n1iBt8AmYVD4kO1enVdrmvn,SpATywNh6bZuzm8s1ceuBUnMUAeoAHHw,20,20,12,24,4,0,5,0,65,9.285714285714286,3,0.0,5,12,24,4,15,0,0,5,0,45,20,1
2491,23140,0Tg2flbTUdD7fODqYIfpiJiK0IDdFiOP,RXDvfPUBYFlVdlueBFbLW0mhhAyGEqpt,71,117,59,89,26,74,21,7,393,56.142857142857146,13,0.0,27,59,87,26,90,74,2,21,7,199,194,0
2492,23145,VO6tFMF3YqIQYaW8tkV9BLtheEJyKKQK,SpATywNh6bZuzm8s1ceuBUnMUAeoAHHw,47,63,38,35,20,1,17,1,175,25.0,7,0.0,13,38,31,20,50,1,4,17,1,102,73,0
2493,23174,dpHLF21uvMbokNNTJHdbSyHoiwNjC5Qc,RXDvfPUBYFlVdlueBFbLW0mhhAyGEqpt,18,15,11,0,5,8,5,4,48,6.857142857142857,2,0.0,0,11,0,5,15,8,0,5,4,16,32,1
2494,23181,PwNax3W8g4wFzRQCUhWcP9EnmZeticjo,SpATywNh6bZuzm8s1ceuBUnMUAeoAHHw,27,29,14,12,8,1,3,0,67,9.571428571428571,4,0.0,12,14,12,8,17,1,0,3,0,46,21,1
2495,23182,CBLeEN4LtKF8I3pqDKXGm8PyJoErUnYX,A3fsA9Zfv1X2fVEQhTw51lKENdNrEqT3,10,9,1,0,1,1,3,0,15,2.142857142857143,1,0.0,0,1,0,1,9,1,0,3,0,2,13,1
2496,23186,jOKGDo32k5y1tQ1HBtDhmlq3GlvnMuW4,A3fsA9Zfv1X2fVEQhTw51lKENdNrEqT3,30,53,41,0,30,2,34,0,160,22.857142857142858,5,0.0,1,41,0,30,52,2,0,34,0,72,88,1
2497,23188,HycevJIm7cBjf1oJ5QCBMMXEBTG8jyRF,RXDvfPUBYFlVdlueBFbLW0mhhAyGEqpt,103,175,113,167,19,80,76,2,632,90.28571428571429,12,0.0,34,113,153,19,141,80,14,76,2,319,313,0
2498,23189,ClKPcHfoSfkiUFto4BTBZmMJfgBwADCv,bWdj2GDclj5ofokWjzoa5jAwMkxCykd6,4,2,1,0,1,0,1,0,5,0.7142857142857143,1,0.0,0,1,0,1,2,0,0,1,0,2,3,1
2499,23203,YBZJfjYuKfwb2VLWbDlKIMN1YSYXBGau,A3fsA9Zfv1X2fVEQhTw51lKENdNrEqT3,14,34,16,0,4,6,13,0,73,10.428571428571429,5,0.0,0,16,0,4,34,6,0,13,0,20,53,1
2500,23216,BdGjvuZcr0pZwpTvi8kd6szBp0GhSFRx,bWdj2GDclj5ofokWjzoa5jAwMkxCykd6,10,10,6,0,5,0,5,0,26,3.7142857142857144,1,0.0,2,6,0,5,8,0,0,5,0,13,13,1
2501,23229,AjE14bAFpRvd1b44PmMUpBPn2loehR8N,SpATywNh6bZuzm8s1ceuBUnMUAeoAHHw,19,31,7,15,7,9,18,0,87,12.428571428571429,3,0.0,5,7,14,7,26,9,1,18,0,33,54,1
2502,23230,qJSVGIIBKQpzllCeTCwG3pgdEZIo3QRz,A3fsA9Zfv1X2fVEQhTw51lKENdNrEqT3,12,9,2,4,1,0,16,0,32,4.571428571428571,3,0.0,0,2,3,1,9,0,1,16,0,6,26,1
2503,23241,wmmgynPgGzw7ypLLU9vcdxog9SI7Juul,RXDvfPUBYFlVdlueBFbLW0mhhAyGEqpt,19,13,8,20,3,0,3,0,47,6.714285714285714,2,0.0,2,8,17,3,11,0,3,3,0,30,17,1
2504,23254,3rBX9dOAFMfNlnyfBe9F26nbNxp33Uvk,G8EPVSXsOYB5YQWZGiz1aVq5Pgr2GrQu,20,21,7,0,6,1,13,1,49,7.0,3,0.0,0,7,0,6,21,1,0,13,1,13,36,1
2505,23255,FfhVetKUzu5KpGrHLPHaynXPJghmm3It,SpATywNh6bZuzm8s1ceuBUnMUAeoAHHw,22,31,4,17,2,0,7,0,61,8.714285714285714,5,0.0,6,4,16,2,25,0,1,7,0,28,33,0
2506,23259,xqwUV9iQK4erbWJ9fEZ3Fau5k4aAZ9DO,SpATywNh6bZuzm8s1ceuBUnMUAeoAHHw,34,86,38,80,8,24,29,2,267,38.142857142857146,9,0.0,32,38,64,8,54,24,16,29,2,142,125,0
2507,23263,tnLfm9tutF6YoqDXNIONCmii1aynBy80,A3fsA9Zfv1X2fVEQhTw51lKENdNrEqT3,9,8,4,0,0,3,12,1,28,4.0,3,0.0,0,4,0,0,8,3,0,12,1,4,24,1
2508,23264,XTgYONXtkRAl3sCFaGFF8e1mU9AMcEwg,SpATywNh6bZuzm8s1ceuBUnMUAeoAHHw,27,26,19,0,12,0,9,0,66,9.428571428571429,6,0.0,0,19,0,12,26,0,0,9,0,31,35,1
2509,23265,knRZtWEcWI5MFAs7PYIJdk2jdyAY8A24,SpATywNh6bZuzm8s1ceuBUnMUAeoAHHw,30,38,17,16,7,2,16,1,97,13.857142857142858,4,0.0,13,17,16,7,25,2,0,16,1,53,44,0
2510,23268,XJpmNtat26NZxNAZqQE63m1qpYdHanqw,RXDvfPUBYFlVdlueBFbLW0mhhAyGEqpt,69,101,63,96,28,10,8,3,309,44.142857142857146,4,0.0,16,63,89,28,85,10,7,8,3,196,113,0
2511,23281,peL7W7HsPQXwJW8IfNPUpznrjT13FLeH,SpATywNh6bZuzm8s1ceuBUnMUAeoAHHw,12,25,0,13,0,0,12,0,50,7.142857142857143,2,0.0,8,0,12,0,17,0,1,12,0,20,30,1
2512,23288,pLQfsJL46iqa9L7UfI8ODNozilMqoPl0,A3fsA9Zfv1X2fVEQhTw51lKENdNrEqT3,7,4,3,0,2,0,2,0,11,1.5714285714285714,1,0.0,0,3,0,2,4,0,0,2,0,5,6,1
2513,23297,3cB0rEpxJxC0jjqfQ9EPT6ntxFajOXrx,A3fsA9Zfv1X2fVEQhTw51lKENdNrEqT3,85,120,72,244,23,35,24,1,519,74.14285714285714,11,0.0,7,72,211,23,113,35,33,24,1,313,206,0
2514,23304,WEwbMamm1WQzZcIYKs7fv3KkFwrZAu4n,SpATywNh6bZuzm8s1ceuBUnMUAeoAHHw,46,68,36,39,19,6,14,0,182,26.0,8,0.0,22,36,38,19,46,6,1,14,0,115,67,0
2515,23307,S1PbXrIuvwc8AvxDGKhjkWzwRdM8cFN0,SpATywNh6bZuzm8s1ceuBUnMUAeoAHHw,38,62,37,27,0,46,15,1,188,26.857142857142858,9,0.0,9,37,24,0,53,46,3,15,1,70,118,0
2516,23308,P0KoQHPz5chEfkMzzCMKKbnUkwSC15gh,G8EPVSXsOYB5YQWZGiz1aVq5Pgr2GrQu,1,0,0,0,0,0,1,0,1,0.14285714285714285,1,0.0,0,0,0,0,0,0,0,1,0,0,1,1
2517,23311,fE7crtUj4hDSQo6ITE7OJYFi4AN2F95M,A3fsA9Zfv1X2fVEQhTw51lKENdNrEqT3,43,32,16,92,10,2,9,0,161,23.0,2,0.0,1,16,75,10,31,2,17,9,0,102,59,1
2518,23313,TXBaUi0GpvXZWCDXsKlkFWTtfaT87UMz,bWdj2GDclj5ofokWjzoa5jAwMkxCykd6,11,37,7,32,1,1,11,2,91,13.0,6,0.0,3,7,30,1,34,1,2,11,2,41,50,1
2519,23341,1cMpA6zMPA0affI3yASPkTig9lUEcx1e,G8EPVSXsOYB5YQWZGiz1aVq5Pgr2GrQu,9,14,7,0,1,63,11,0,96,13.714285714285714,4,0.0,0,7,0,1,14,63,0,11,0,8,88,1
2520,23358,dob27oJoC3Vd5K1oOuihpbNGBh5pIGaM,SpATywNh6bZuzm8s1ceuBUnMUAeoAHHw,17,38,17,1,8,1,7,0,72,10.285714285714286,4,0.0,6,17,1,8,32,1,0,7,0,32,40,1
2521,23388,HZWZtPkCTeK90eQ90MHe5cWcAqiVgkGk,bWdj2GDclj5ofokWjzoa5jAwMkxCykd6,39,120,67,186,31,64,40,1,509,72.71428571428571,8,0.0,26,67,164,31,94,64,22,40,1,288,221,0
2522,23390,lfrqXPATBesMooHpdCa9ZnxlXhb59rmp,SpATywNh6bZuzm8s1ceuBUnMUAeoAHHw,30,153,93,37,29,15,39,0,366,52.285714285714285,9,0.0,17,93,34,29,136,15,3,39,0,173,193,1
2523,23399,QUw5YB8tw6ArwfIF1vjOH2aXsMxDBB6n,SpATywNh6bZuzm8s1ceuBUnMUAeoAHHw,49,56,33,35,17,23,25,2,191,27.285714285714285,10,0.0,7,33,28,17,49,23,7,25,2,85,106,0
2524,23405,3AFvyqpOB7zyiycGY1NpbFOUZUj9K9Bb,SpATywNh6bZuzm8s1ceuBUnMUAeoAHHw,25,26,16,12,7,1,10,0,72,10.285714285714286,5,0.0,4,16,12,7,22,1,0,10,0,39,33,1
2525,23416,1ulA4jhwI0WhLE9MVLjWBxEEeOzdq7WL,SpATywNh6bZuzm8s1ceuBUnMUAeoAHHw,53,111,58,40,22,39,30,3,303,43.285714285714285,11,0.0,32,58,35,22,79,39,5,30,3,147,156,0
2526,23440,lHNqd6KTSO9CrJzRDAqosVITLVN3mMHR,bWdj2GDclj5ofokWjzoa5jAwMkxCykd6,58,89,52,242,16,0,30,0,429,61.285714285714285,9,0.0,17,52,226,16,72,0,16,30,0,311,118,1
2527,23450,RKjVof9Yhxeyyya4gtkZu1fqgIbPHIOB,A3fsA9Zfv1X2fVEQhTw51lKENdNrEqT3,17,16,10,0,5,14,20,5,70,10.0,5,0.0,1,10,0,5,15,14,0,20,5,16,54,0
2528,23452,iEsDxJ2LNGTFl1t0aAKhf24FeoeDy4PX,G8EPVSXsOYB5YQWZGiz1aVq5Pgr2GrQu,14,19,1,28,1,0,2,0,51,7.285714285714286,2,0.0,0,1,26,1,19,0,2,2,0,28,23,1
2529,23457,wLAgbiz3XWV6Nef8pQe1TlLxUN8CIoJ8,G8EPVSXsOYB5YQWZGiz1aVq5Pgr2GrQu,1,0,0,0,0,0,1,0,1,0.14285714285714285,1,0.0,0,0,0,0,0,0,0,1,0,0,1,1
2530,23477,wctOEAfOfHjaIn2ukTVBg3NDDfP2Pt1c,SpATywNh6bZuzm8s1ceuBUnMUAeoAHHw,40,130,81,28,24,18,46,5,332,47.42857142857143,13,0.0,10,81,24,24,120,18,4,46,5,139,193,0
2531,23490,Id4UmIRRQiLXHoJYSjh5OCO1CRaFgQ2K,SpATywNh6bZuzm8s1ceuBUnMUAeoAHHw,48,95,43,40,17,8,23,2,228,32.57142857142857,9,0.0,25,43,32,17,70,8,8,23,2,117,111,1
2532,23510,GIb3glgYrsEfHWtEWPWpwONqwE7RMf6f,A3fsA9Zfv1X2fVEQhTw51lKENdNrEqT3,186,240,153,354,93,23,76,1,940,134.28571428571428,23,0.0,10,153,308,93,230,23,46,76,1,564,376,0
2533,23515,Oqfkhjg6t51PZcyyCwvjWtQ6bDHYceB1,SpATywNh6bZuzm8s1ceuBUnMUAeoAHHw,32,88,50,24,14,25,22,0,223,31.857142857142858,13,0.0,18,50,19,14,70,25,5,22,0,101,122,0
2534,23516,PzbAAQBdNIO5q0hDkxJETX7v12Y9h0xH,SpATywNh6bZuzm8s1ceuBUnMUAeoAHHw,7,6,1,0,1,0,3,0,11,1.5714285714285714,1,0.0,0,1,0,1,6,0,0,3,0,2,9,0
2535,23519,DsdEYwXt7PO92K8VROCVVtUqrprzaIo4,A3fsA9Zfv1X2fVEQhTw51lKENdNrEqT3,46,26,17,88,10,1,24,1,167,23.857142857142858,2,0.0,2,17,71,10,24,1,17,24,1,100,67,1
2536,23542,d4mvkfcwFcYKWYB1PuCW432MT8LvqlFh,SpATywNh6bZuzm8s1ceuBUnMUAeoAHHw,45,83,42,52,18,0,21,0,216,30.857142857142858,8,0.0,32,42,50,18,51,0,2,21,0,142,74,1
2537,23552,H0WeKsbXeLHWXz7EV7ygxgCQNCt5DOUD,SpATywNh6bZuzm8s1ceuBUnMUAeoAHHw,52,92,43,67,18,7,24,1,252,36.0,17,0.0,8,43,56,18,84,7,11,24,1,125,127,0
2538,23554,bVCYDQX7pJxff6OyJX4M9s17AtFlpk5i,SpATywNh6bZuzm8s1ceuBUnMUAeoAHHw,10,18,12,0,7,0,6,0,43,6.142857142857143,2,0.0,0,12,0,7,18,0,0,6,0,19,24,1
2539,23573,MwhE2MowwPvamSVFrLUWaatDsrzcIgQY,SpATywNh6bZuzm8s1ceuBUnMUAeoAHHw,31,47,26,24,15,5,13,1,131,18.714285714285715,6,0.0,10,26,24,15,37,5,0,13,1,75,56,0
2540,23585,NRdQjU0MJFdxtbDqiTrBcJcd064egve1,SpATywNh6bZuzm8s1ceuBUnMUAeoAHHw,17,45,28,15,0,11,24,1,124,17.714285714285715,3,0.0,8,28,13,0,37,11,2,24,1,49,75,1
2541,23588,DHUv7XpIZcPp2QYGNmTXjhgg7Zq4BpJ7,RXDvfPUBYFlVdlueBFbLW0mhhAyGEqpt,1,0,0,0,0,0,1,0,1,0.14285714285714285,1,0.0,0,0,0,0,0,0,0,1,0,0,1,1
2542,23595,0EotlIgKGd3opCDMhDC2aBqeeKmFST46,A3fsA9Zfv1X2fVEQhTw51lKENdNrEqT3,2,0,0,0,0,0,4,0,4,0.5714285714285714,1,0.0,0,0,0,0,0,0,0,4,0,0,4,1
2543,23596,DdGVDKNQwSkPIQKeE1XouOkZR5kVZ7SK,SpATywNh6bZuzm8s1ceuBUnMUAeoAHHw,23,42,8,34,3,0,8,0,95,13.571428571428571,3,0.0,15,8,28,3,27,0,6,8,0,54,41,1
2544,23597,lLz9WbehghUNLRABDjzrIp7BjBkWjoW9,SpATywNh6bZuzm8s1ceuBUnMUAeoAHHw,6,5,2,0,1,0,2,0,10,1.4285714285714286,1,0.0,0,2,0,1,5,0,0,2,0,3,7,1
2545,23603,0wJhtCWK60WPCeRF62m8T80DtNpWhRrg,SpATywNh6bZuzm8s1ceuBUnMUAeoAHHw,26,36,17,32,5,0,10,1,101,14.428571428571429,3,0.0,14,17,28,5,22,0,4,10,1,64,37,0
2546,23633,o6ILANWxUGmdLZhlBol9mZCEolnG5bhy,SpATywNh6bZuzm8s1ceuBUnMUAeoAHHw,28,36,21,3,8,34,19,1,122,17.428571428571427,9,0.0,2,21,3,8,34,34,0,19,1,34,88,1
2547,23639,tMPZYG0DCvDSDEuO4KsQAdk0iwwmXKYt,A3fsA9Zfv1X2fVEQhTw51lKENdNrEqT3,32,78,42,28,23,2,22,0,195,27.857142857142858,6,0.0,2,42,23,23,76,2,5,22,0,90,105,0
2548,23640,9uqkwYb5ddQJIw4su6OaF1hwvWEdLp1S,A3fsA9Zfv1X2fVEQhTw51lKENdNrEqT3,49,58,39,16,24,0,11,0,148,21.142857142857142,9,0.0,3,39,14,24,55,0,2,11,0,80,68,0
2549,23647,3rCZba8eKP7jaFsDjNb32WoGn9BjnrjN,bWdj2GDclj5ofokWjzoa5jAwMkxCykd6,1,0,0,0,0,0,1,0,1,0.14285714285714285,1,0.0,0,0,0,0,0,0,0,1,0,0,1,1
2550,23671,9sTtmQQAXG5XvwtZJPuuRKLnfgaYWfWO,SpATywNh6bZuzm8s1ceuBUnMUAeoAHHw,41,39,18,44,11,0,7,0,119,17.0,4,0.0,16,18,38,11,23,0,6,7,0,83,36,1
2551,23674,l9KseRU4xYtwOzoILYmGcicF0iiXQqxl,SpATywNh6bZuzm8s1ceuBUnMUAeoAHHw,56,95,41,55,12,34,25,1,263,37.57142857142857,13,0.0,18,41,46,12,77,34,9,25,1,117,146,0
2552,23675,pJj2PU7RZQK2Nwrb96O5DurQcsPoqkDx,bWdj2GDclj5ofokWjzoa5jAwMkxCykd6,7,4,3,0,3,0,5,0,15,2.142857142857143,3,0.0,0,3,0,3,4,0,0,5,0,6,9,1
2553,23692,zJ99WhK6aN6yEmbpXd5cJuqKo0p9kPsD,RXDvfPUBYFlVdlueBFbLW0mhhAyGEqpt,59,41,22,78,16,2,14,1,174,24.857142857142858,3,0.0,16,22,74,16,25,2,4,14,1,128,46,1
2554,23710,3iJrlZJEv2h7DgWBpz6wZtSXPXEy6IAY,A3fsA9Zfv1X2fVEQhTw51lKENdNrEqT3,14,19,9,0,6,0,10,0,44,6.285714285714286,8,0.0,0,9,0,6,19,0,0,10,0,15,29,0
2555,23711,POOwrt9teJiwgIKzPgqwiwhGp5kUKv01,SpATywNh6bZuzm8s1ceuBUnMUAeoAHHw,29,37,22,27,10,8,12,1,117,16.714285714285715,2,0.0,9,22,23,10,28,8,4,12,1,64,53,0
2556,23716,epEhe5zjAdMHelSWe8cywAVR1iLucvwI,SpATywNh6bZuzm8s1ceuBUnMUAeoAHHw,4,2,0,0,0,0,2,0,4,0.5714285714285714,1,0.0,0,0,0,0,2,0,0,2,0,0,4,1
2557,23723,aX5o3K4conQ4SoTRN7MBCmGaArjn5YFA,SpATywNh6bZuzm8s1ceuBUnMUAeoAHHw,10,14,7,0,4,0,9,0,34,4.857142857142857,3,0.0,0,7,0,4,14,0,0,9,0,11,23,1
2558,23725,wNbKFPX6oYsfVEr8buyWthBblPuPZGxv,SpATywNh6bZuzm8s1ceuBUnMUAeoAHHw,1,0,0,0,0,0,1,0,1,0.14285714285714285,1,0.0,0,0,0,0,0,0,0,1,0,0,1,1
2559,23740,oJ9j9ejTgKixczg3tSE8Sg8DPI7YQpJq,SpATywNh6bZuzm8s1ceuBUnMUAeoAHHw,35,57,28,23,6,14,16,0,144,20.571428571428573,9,0.0,18,28,20,6,39,14,3,16,0,72,72,0
2560,23745,Ot8esbQhlnTNYRjqPJ5gBbiW6Aw8bpdE,G8EPVSXsOYB5YQWZGiz1aVq5Pgr2GrQu,1,0,0,0,0,0,1,0,1,0.14285714285714285,1,0.0,0,0,0,0,0,0,0,1,0,0,1,1
2561,23752,oW1SPRE23Cu85GeGZYRmhPcFuXq6dZoG,SpATywNh6bZuzm8s1ceuBUnMUAeoAHHw,30,56,28,23,10,3,15,0,135,19.285714285714285,4,0.0,20,28,22,10,36,3,1,15,0,80,55,0
2562,23754,atxTINx1wNa0Kz1uw7bW34Z47POxkGeq,SpATywNh6bZuzm8s1ceuBUnMUAeoAHHw,40,106,18,50,14,4,69,1,262,37.42857142857143,14,0.0,13,18,42,14,93,4,8,69,1,87,175,0
2563,23760,6uy0rYsVs6ntSHgwhJ1mwDkW5uKAQxi4,SpATywNh6bZuzm8s1ceuBUnMUAeoAHHw,26,72,42,16,20,10,10,0,170,24.285714285714285,9,0.0,12,42,14,20,60,10,2,10,0,88,82,1
2564,23771,zG5wQdjarSEp1xTKP5FU2TvutBYexg1v,bWdj2GDclj5ofokWjzoa5jAwMkxCykd6,6,12,0,0,0,0,4,0,16,2.2857142857142856,1,0.0,1,0,0,0,11,0,0,4,0,1,15,1
2565,23773,35E85h2ExBPeTd1VmxNX0GKo8krIMsCP,SpATywNh6bZuzm8s1ceuBUnMUAeoAHHw,30,64,24,32,13,1,12,0,146,20.857142857142858,4,0.0,32,24,28,13,32,1,4,12,0,97,49,1
2566,23789,i1f7BljhTNgVMfGOHZ66OYaR3kNetCAs,SpATywNh6bZuzm8s1ceuBUnMUAeoAHHw,19,40,1,46,0,19,9,0,115,16.428571428571427,7,0.0,17,1,42,0,23,19,4,9,0,60,55,0
2567,23795,bHKiB8yjzvUwkeHE5fxnHNywx47ldJ6B,SpATywNh6bZuzm8s1ceuBUnMUAeoAHHw,36,74,7,43,4,2,15,0,145,20.714285714285715,9,0.0,21,7,38,4,53,2,5,15,0,70,75,1
2568,23798,GOPMGFz5xoFESgugOmv6JtNIOPfS0GCX,SpATywNh6bZuzm8s1ceuBUnMUAeoAHHw,29,69,2,36,2,13,19,1,142,20.285714285714285,10,0.0,21,2,33,2,48,13,3,19,1,58,84,0
2569,23806,uxWndEUVVRQyohhChNH7OrcMXH2VCOhT,SpATywNh6bZuzm8s1ceuBUnMUAeoAHHw,10,11,2,0,1,0,2,0,16,2.2857142857142856,2,0.0,0,2,0,1,11,0,0,2,0,3,13,1
2570,23812,6GriNnzq8xnsLEV5ztRmUAFnPPewwL0q,A3fsA9Zfv1X2fVEQhTw51lKENdNrEqT3,29,16,8,64,0,0,6,0,94,13.428571428571429,3,0.0,3,8,56,0,13,0,8,6,0,67,27,1
2571,23836,83Gotur1nDdhzZnnscpduWQ3wLNBDtA6,SpATywNh6bZuzm8s1ceuBUnMUAeoAHHw,12,15,1,22,0,0,3,0,41,5.857142857142857,1,0.0,8,1,18,0,7,0,4,3,0,27,14,1
2572,23840,FBu5R2eGEtl9EDw0VwXtH1t5i2ELpdqI,SpATywNh6bZuzm8s1ceuBUnMUAeoAHHw,9,18,7,0,3,0,7,0,35,5.0,3,0.0,0,7,0,3,18,0,0,7,0,10,25,1
2573,23841,7Vj4ziukCVrVZvt93RQ91d2zl9J3pERE,SpATywNh6bZuzm8s1ceuBUnMUAeoAHHw,17,22,13,6,5,0,6,0,52,7.428571428571429,2,0.0,5,13,5,5,17,0,1,6,0,28,24,1
2574,23852,dFrBZuKOTxv7Ek84BAuACScgZVHLiPRz,SpATywNh6bZuzm8s1ceuBUnMUAeoAHHw,5,5,0,0,0,0,3,0,8,1.1428571428571428,2,0.0,0,0,0,0,5,0,0,3,0,0,8,1
2575,23855,4okppsrdnKYxqs2gLNMiS6gb60QmM8WN,RXDvfPUBYFlVdlueBFbLW0mhhAyGEqpt,63,92,69,168,14,9,17,17,386,55.142857142857146,4,0.0,13,69,155,14,79,9,13,17,17,251,135,1
2576,23857,840TvauCMn8hUpsV90vm3IXVVzLXLwLs,A3fsA9Zfv1X2fVEQhTw51lKENdNrEqT3,35,43,1,80,0,0,3,0,127,18.142857142857142,2,0.0,6,1,70,0,37,0,10,3,0,77,50,1
2577,23862,YxEAEqB4R6GTRBWDvga1GWE0URAxGc6U,A3fsA9Zfv1X2fVEQhTw51lKENdNrEqT3,9,16,11,0,0,0,4,0,31,4.428571428571429,4,0.0,0,11,0,0,16,0,0,4,0,11,20,1
2578,23863,3Ta0rfBtrbiqFMIpcV3b3USyW2ELEZd2,bWdj2GDclj5ofokWjzoa5jAwMkxCykd6,14,24,3,6,6,9,16,2,66,9.428571428571429,3,0.0,5,3,5,6,19,9,1,16,2,19,47,1
2579,23872,7iw4UiR57uyLjfIdpxq0wONlaNvYfNiV,SpATywNh6bZuzm8s1ceuBUnMUAeoAHHw,1,0,0,0,0,0,1,0,1,0.14285714285714285,1,0.0,0,0,0,0,0,0,0,1,0,0,1,1
2580,23874,986WgoFI0AZSDPIvWwBI8MUZveW4E4Xu,RXDvfPUBYFlVdlueBFbLW0mhhAyGEqpt,23,73,37,0,17,0,10,0,137,19.571428571428573,6,0.0,0,37,0,17,73,0,0,10,0,54,83,0
2581,23891,FBu5R2eGEtl9EDw0VwXtH1t5i2ELpdqI,A3fsA9Zfv1X2fVEQhTw51lKENdNrEqT3,68,73,32,202,14,1,15,0,337,48.142857142857146,7,0.0,5,32,168,14,68,1,34,15,0,219,118,1
2582,23893,dkQw8oK3XR4qlNNv9mJoCG5KMSpfLA0u,SpATywNh6bZuzm8s1ceuBUnMUAeoAHHw,45,40,25,50,15,9,9,1,149,21.285714285714285,5,0.0,10,25,44,15,30,9,6,9,1,94,55,1
2583,23895,g7nx8KecXhqsIkJIviLtJahoCAcu06DW,SpATywNh6bZuzm8s1ceuBUnMUAeoAHHw,2,0,0,0,0,0,2,0,2,0.2857142857142857,1,0.0,0,0,0,0,0,0,0,2,0,0,2,1
2584,23901,4dLqJDBbl4XgAFoagStv97aI3aHRciy5,SpATywNh6bZuzm8s1ceuBUnMUAeoAHHw,13,19,12,0,7,3,10,1,52,7.428571428571429,3,0.0,0,12,0,7,19,3,0,10,1,19,33,1
2585,23909,B7s9DHPpvHggi4c4m5C7RuYNMMAUXQfR,SpATywNh6bZuzm8s1ceuBUnMUAeoAHHw,8,10,6,0,5,0,4,0,25,3.5714285714285716,1,0.0,0,6,0,5,10,0,0,4,0,11,14,1
2586,23920,v5teTtQ61doFtyEryEU1FEZNTQeJUrxX,SpATywNh6bZuzm8s1ceuBUnMUAeoAHHw,37,98,9,41,1,13,47,2,211,30.142857142857142,12,0.0,39,9,39,1,59,13,2,47,2,88,123,0
2587,23926,haBS6HInfRwWNu7SJCbVrmAnlh8blC7U,SpATywNh6bZuzm8s1ceuBUnMUAeoAHHw,1,0,0,0,0,0,1,0,1,0.14285714285714285,1,0.0,0,0,0,0,0,0,0,1,0,0,1,1
2588,23942,yk8HuNxXIum8r8XDIOHqnAVeWfg9tYo1,A3fsA9Zfv1X2fVEQhTw51lKENdNrEqT3,60,41,31,64,19,2,25,3,185,26.428571428571427,5,0.0,2,31,64,19,39,2,0,25,3,116,69,1
2589,23944,ZKAk08L8Iriz8Uv5UOeqSbrNnzg1rlMz,RXDvfPUBYFlVdlueBFbLW0mhhAyGEqpt,39,37,25,27,15,17,16,1,138,19.714285714285715,6,0.0,5,25,27,15,32,17,0,16,1,72,66,0
2590,23955,5mJ1itg2cQYRNscuJuLNd4sNUrdim8JB,bWdj2GDclj5ofokWjzoa5jAwMkxCykd6,71,229,101,138,19,58,69,7,621,88.71428571428571,13,0.0,21,101,132,19,208,58,6,69,7,273,348,0
2591,23975,xCPsccPRbQTL93kwam6OPz5i1lU77hqE,SpATywNh6bZuzm8s1ceuBUnMUAeoAHHw,37,59,4,17,1,4,23,1,109,15.571428571428571,7,0.0,4,4,13,1,55,4,4,23,1,22,87,0
2592,23976,PSJftXZeDfoFySmsRqkLgFson1mEyJqX,SpATywNh6bZuzm8s1ceuBUnMUAeoAHHw,47,161,69,77,20,95,92,4,518,74.0,17,0.0,66,69,64,20,95,95,13,92,4,219,299,0
2593,23982,3W09pasLSoDWuQqGyvECJ7WiykG165j2,RXDvfPUBYFlVdlueBFbLW0mhhAyGEqpt,16,20,12,0,3,10,11,0,56,8.0,7,0.0,1,12,0,3,19,10,0,11,0,16,40,1
2594,23985,T23nrSnpQ3vWpr6CtL4ZskVcSM0KOOu0,A3fsA9Zfv1X2fVEQhTw51lKENdNrEqT3,46,20,16,40,14,0,5,0,95,13.571428571428571,2,0.0,2,16,39,14,18,0,1,5,0,71,24,1
2595,24006,FrLEzodgON5rcdCDFBdqJa5CoY6xgWo9,G8EPVSXsOYB5YQWZGiz1aVq5Pgr2GrQu,2,0,0,0,0,1,1,0,2,0.2857142857142857,1,0.0,0,0,0,0,0,1,0,1,0,0,2,1
2596,24015,op8q14GHWgkmIf6XOfnEOFm5IfQDADrc,SpATywNh6bZuzm8s1ceuBUnMUAeoAHHw,4,2,1,0,1,0,1,0,5,0.7142857142857143,1,0.0,0,1,0,1,2,0,0,1,0,2,3,1
2597,24019,tML4IQ8jFiP4YuH9NbvzKQFqAdof0qcO,G8EPVSXsOYB5YQWZGiz1aVq5Pgr2GrQu,94,127,6,236,4,38,37,2,450,64.28571428571429,14,0.0,14,6,197,4,113,38,39,37,2,221,229,0
2598,24035,j5UlwBty5MOwHf8rgRJk1hdlEvwivM1k,SpATywNh6bZuzm8s1ceuBUnMUAeoAHHw,27,85,38,29,9,38,62,1,262,37.42857142857143,12,0.0,17,38,29,9,68,38,0,62,1,93,169,0
2599,24036,tx5OjuBvtxXu3JLfhVRvs5pDkriVKuCZ,SpATywNh6bZuzm8s1ceuBUnMUAeoAHHw,2,0,0,0,0,0,2,0,2,0.2857142857142857,1,0.0,0,0,0,0,0,0,0,2,0,0,2,1
2600,24046,5C3sCk6rXQc2OvYtSBZh5PoYxtIPWyJ2,SpATywNh6bZuzm8s1ceuBUnMUAeoAHHw,13,18,13,0,5,2,7,0,45,6.428571428571429,3,0.0,5,13,0,5,13,2,0,7,0,23,22,1
2601,24050,vJOEMmX7SHj3LcECHogPAykr3CpSjcOR,SpATywNh6bZuzm8s1ceuBUnMUAeoAHHw,9,7,5,0,4,0,2,0,18,2.5714285714285716,1,0.0,0,5,0,4,7,0,0,2,0,9,9,0
2602,24053,eosk3dY7502Pbg6Dsnx0qWKWUpRTliXK,A3fsA9Zfv1X2fVEQhTw51lKENdNrEqT3,54,42,5,140,0,0,20,0,207,29.571428571428573,9,0.0,4,5,130,0,38,0,10,20,0,139,68,1
2603,24065,DTTxrR88jPl5bCCaxQVsf8wzpnk1CzMM,bWdj2GDclj5ofokWjzoa5jAwMkxCykd6,3,0,0,0,0,0,3,0,3,0.42857142857142855,1,0.0,0,0,0,0,0,0,0,3,0,0,3,1
2604,24066,kXKIMNlMdItv4EM1IWayIAvXYTB44MoC,RXDvfPUBYFlVdlueBFbLW0mhhAyGEqpt,15,43,16,0,7,0,10,0,76,10.857142857142858,2,0.0,0,16,0,7,43,0,0,10,0,23,53,1
2605,24068,lUdpqcwQn1Cq8H3mwfWcSvZsVHMY64gd,SpATywNh6bZuzm8s1ceuBUnMUAeoAHHw,24,49,4,32,2,0,23,6,116,16.571428571428573,3,0.0,18,4,27,2,31,0,5,23,6,51,65,1
2606,24070,DTTxrR88jPl5bCCaxQVsf8wzpnk1CzMM,A3fsA9Zfv1X2fVEQhTw51lKENdNrEqT3,7,2,0,0,0,0,7,0,9,1.2857142857142858,1,0.0,0,0,0,0,2,0,0,7,0,0,9,1
2607,24077,1xg9Qkt1ODqUyNotraxCzvVYE0R3XRTq,SpATywNh6bZuzm8s1ceuBUnMUAeoAHHw,19,108,67,2,0,4,41,1,223,31.857142857142858,10,0.0,11,67,2,0,97,4,0,41,1,80,143,0
2608,24088,M8ZBCZwMuabH0ACZboTe8kVgLwQBa43E,SpATywNh6bZuzm8s1ceuBUnMUAeoAHHw,7,9,2,0,2,0,2,0,15,2.142857142857143,1,0.0,0,2,0,2,9,0,0,2,0,4,11,1
2609,24095,gIOMjsdC7cxqbaSIU1FRFPikduEMi8Cf,A3fsA9Zfv1X2fVEQhTw51lKENdNrEqT3,1,0,0,0,0,0,1,0,1,0.14285714285714285,1,0.0,0,0,0,0,0,0,0,1,0,0,1,1
2610,24097,quAtav6r2isPETtEaXY0Zey5BbVDiT8E,bWdj2GDclj5ofokWjzoa5jAwMkxCykd6,12,12,4,160,4,1,10,3,194,27.714285714285715,3,0.0,6,4,149,4,6,1,11,10,3,163,31,1
2611,24104,vhdI0CMIgkIrtFphutHmT5NtC4th9ah8,G8EPVSXsOYB5YQWZGiz1aVq5Pgr2GrQu,19,29,15,20,6,8,9,2,89,12.714285714285714,1,0.0,11,15,13,6,18,8,7,9,2,45,44,1
2612,24105,CARvKOUSVZPjSOb5Yfv5PAWmTBO0zJGw,SpATywNh6bZuzm8s1ceuBUnMUAeoAHHw,11,10,5,0,2,0,25,2,44,6.285714285714286,1,0.0,0,5,0,2,10,0,0,25,2,7,37,1
2613,24107,GCaUOiguxLs9b5sngb0RwjOWSkIZZOW6,RXDvfPUBYFlVdlueBFbLW0mhhAyGEqpt,1,0,0,0,0,0,2,0,2,0.2857142857142857,1,0.0,0,0,0,0,0,0,0,2,0,0,2,1
2614,24113,dMrgH440WCDAs3UnYGenYjtBiGOLNMI7,G8EPVSXsOYB5YQWZGiz1aVq5Pgr2GrQu,10,10,1,14,0,0,5,1,31,4.428571428571429,1,0.0,0,1,12,0,10,0,2,5,1,13,18,1
2615,24117,qQwIO2VZC7PFj9cTI7x2EoRtRcwJFk5y,A3fsA9Zfv1X2fVEQhTw51lKENdNrEqT3,17,11,2,24,1,5,7,0,50,7.142857142857143,2,0.0,0,2,19,1,11,5,5,7,0,22,28,1
2616,24130,PweHbRIHs8SwjKQfEtpqIQuZBXBDcuDm,SpATywNh6bZuzm8s1ceuBUnMUAeoAHHw,31,43,22,34,10,0,11,2,122,17.428571428571427,4,0.0,15,22,31,10,28,0,3,11,2,78,44,1
2617,24139,oz1karFupMeBQM5wp1X9Aheb4RKufic7,SpATywNh6bZuzm8s1ceuBUnMUAeoAHHw,42,50,32,51,14,16,13,0,176,25.142857142857142,10,0.0,6,32,45,14,44,16,6,13,0,97,79,0
2618,24140,68BjCXfBFqeZ01fFx1csrFmvef5xs0w2,SpATywNh6bZuzm8s1ceuBUnMUAeoAHHw,15,30,20,0,10,12,8,0,80,11.428571428571429,6,0.0,3,20,0,10,27,12,0,8,0,33,47,1
2619,24142,6zt7VkEpMezYkke6xelTowmnsTySao1Z,SpATywNh6bZuzm8s1ceuBUnMUAeoAHHw,34,24,16,18,11,9,7,0,85,12.142857142857142,6,0.0,6,16,16,11,18,9,2,7,0,49,36,1
2620,24146,W41zjpcR5alpzNzSmbyy9bBZYrT6UXxL,RXDvfPUBYFlVdlueBFbLW0mhhAyGEqpt,33,41,31,18,17,0,25,0,132,18.857142857142858,6,0.0,4,31,13,17,37,0,5,25,0,65,67,1
2621,24149,yEc0qGRUsnGavj0JPbk8pVtWktClrURk,SpATywNh6bZuzm8s1ceuBUnMUAeoAHHw,24,42,19,22,4,8,18,0,113,16.142857142857142,10,0.0,13,19,17,4,29,8,5,18,0,53,60,0
2622,24150,7mxOgTUP9lSjAUBOPZ9fhNEhVSHMvF2J,bWdj2GDclj5ofokWjzoa5jAwMkxCykd6,70,125,22,218,13,54,26,2,460,65.71428571428571,13,0.0,28,22,189,13,97,54,29,26,2,252,208,0
2623,24154,WTCEOd5LeoB3M6qdd6wv5K0UJQNEdjBy,bWdj2GDclj5ofokWjzoa5jAwMkxCykd6,7,2,1,0,1,7,6,1,18,2.5714285714285716,2,0.0,0,1,0,1,2,7,0,6,1,2,16,1
2624,24161,ZRTZW05J88lidJZzll8LtXVXzVI1deNg,SpATywNh6bZuzm8s1ceuBUnMUAeoAHHw,8,8,0,0,0,1,10,0,19,2.7142857142857144,2,0.0,0,0,0,0,8,1,0,10,0,0,19,1
2625,24172,s4TNdVBVykBR8x72RZEnjBx6ebkwwW3k,A3fsA9Zfv1X2fVEQhTw51lKENdNrEqT3,16,10,9,0,9,0,1,0,29,4.142857142857143,1,0.0,0,9,0,9,10,0,0,1,0,18,11,1
2626,24179,gEzMd6gbgpZIm67NWd6vqHpEEo3Eo4i8,RXDvfPUBYFlVdlueBFbLW0mhhAyGEqpt,1,0,0,0,0,0,1,0,1,0.14285714285714285,1,0.0,0,0,0,0,0,0,0,1,0,0,1,1
2627,24187,GlAlbUSi7bTkQeCE1bsVWDk5GBPq0ZBP,bWdj2GDclj5ofokWjzoa5jAwMkxCykd6,15,20,11,22,5,26,11,0,95,13.571428571428571,5,0.0,3,11,21,5,17,26,1,11,0,40,55,1
2628,24188,6my3HLUJsR66IUqoTOpOu4zu43YWvDxI,A3fsA9Zfv1X2fVEQhTw51lKENdNrEqT3,10,16,4,0,1,0,9,0,30,4.285714285714286,2,0.0,2,4,0,1,14,0,0,9,0,7,23,1
2629,24191,VVltscgfR96aweHb5nQdD1Q7dsOwuOJz,A3fsA9Zfv1X2fVEQhTw51lKENdNrEqT3,37,35,0,48,0,0,8,0,91,13.0,4,0.0,1,0,45,0,34,0,3,8,0,46,45,1
2630,24205,KjugBA6V5bkEA5fAIbJoGnSUlDhZoaIH,SpATywNh6bZuzm8s1ceuBUnMUAeoAHHw,17,39,18,0,7,7,13,0,84,12.0,5,0.0,2,18,0,7,37,7,0,13,0,27,57,0
2631,24210,LpAsllakvdmHNKkTbI74k56UY22DACic,SpATywNh6bZuzm8s1ceuBUnMUAeoAHHw,4,2,1,0,1,0,2,0,6,0.8571428571428571,1,0.0,0,1,0,1,2,0,0,2,0,2,4,1
2632,24228,Kawdpya8bnbVtCe5VJbkVPFzmayWdtI6,SpATywNh6bZuzm8s1ceuBUnMUAeoAHHw,1,0,0,0,0,0,1,0,1,0.14285714285714285,1,0.0,0,0,0,0,0,0,0,1,0,0,1,1
2633,24250,UPb6839zer74dQL1gRcC95mBDcZeCZUO,bWdj2GDclj5ofokWjzoa5jAwMkxCykd6,4,2,1,0,1,0,1,0,5,0.7142857142857143,1,0.0,0,1,0,1,2,0,0,1,0,2,3,1
2634,24255,SvdoxHaqv4If8vTEQE4Ye6pIzdBuUEi9,G8EPVSXsOYB5YQWZGiz1aVq5Pgr2GrQu,25,44,29,28,14,13,7,0,135,19.285714285714285,3,0.0,11,29,24,14,33,13,4,7,0,78,57,1
2635,24257,L8lHLh6Mth1S7I3sErP5oDZD885a1BOh,A3fsA9Zfv1X2fVEQhTw51lKENdNrEqT3,45,14,6,117,1,0,6,0,144,20.571428571428573,2,0.0,5,6,111,1,9,0,6,6,0,123,21,1
2636,24258,Ne25k1DU4nK81LWo7930HvBFWlFV2ZKt,SpATywNh6bZuzm8s1ceuBUnMUAeoAHHw,37,60,24,43,12,0,18,0,157,22.428571428571427,10,0.0,13,24,41,12,47,0,2,18,0,90,67,0
2637,24260,RxUvz1VnE0RHae7wTLOzUprYmci0pJ08,bWdj2GDclj5ofokWjzoa5jAwMkxCykd6,6,2,1,0,1,0,4,1,9,1.2857142857142858,1,0.0,0,1,0,1,2,0,0,4,1,2,7,1
2638,24283,yZoviGGxgr5NFf9klHeC5PfXfdVd14QP,A3fsA9Zfv1X2fVEQhTw51lKENdNrEqT3,51,43,32,58,13,2,20,2,170,24.285714285714285,5,0.0,1,32,54,13,42,2,4,20,2,100,70,1
2639,24285,Kd69M9W1nim0woqVm1QxfVaSebsYtFIh,RXDvfPUBYFlVdlueBFbLW0mhhAyGEqpt,16,38,16,12,5,1,12,1,85,12.142857142857142,7,0.0,1,16,12,5,37,1,0,12,1,34,51,1
2640,24289,oMQSjsmH1aRsG8joAcNWi5ozsWLu10HK,bWdj2GDclj5ofokWjzoa5jAwMkxCykd6,5,2,1,0,1,0,2,0,6,0.8571428571428571,1,0.0,0,1,0,1,2,0,0,2,0,2,4,1
2641,24290,Ms0MC4W5moiGJLWP7iE3FImeH9CHN4KT,A3fsA9Zfv1X2fVEQhTw51lKENdNrEqT3,7,16,7,0,1,0,13,0,37,5.285714285714286,7,0.0,0,7,0,1,16,0,0,13,0,8,29,0
2642,24294,j1LAePLDyUZgKcurnBhMK9q8whbJ98ja,SpATywNh6bZuzm8s1ceuBUnMUAeoAHHw,4,2,0,0,0,0,2,0,4,0.5714285714285714,1,0.0,0,0,0,0,2,0,0,2,0,0,4,1
2643,24302,ew0XpK44UZ9NkpDlIMehLaSdbqgabj65,SpATywNh6bZuzm8s1ceuBUnMUAeoAHHw,4,2,1,0,1,0,2,0,6,0.8571428571428571,1,0.0,0,1,0,1,2,0,0,2,0,2,4,1
2644,24313,Evco2d15cNydZMimph5VWFT3j0HfgNP5,SpATywNh6bZuzm8s1ceuBUnMUAeoAHHw,38,61,29,27,15,0,11,2,145,20.714285714285715,9,0.0,12,29,27,15,49,0,0,11,2,83,62,0
2645,24324,W41zjpcR5alpzNzSmbyy9bBZYrT6UXxL,A3fsA9Zfv1X2fVEQhTw51lKENdNrEqT3,20,29,22,0,19,0,6,0,76,10.857142857142858,3,0.0,0,22,0,19,29,0,0,6,0,41,35,1
2646,24351,iugl3Rn3u1ci3BiC2tfekDHOQsD5QVGj,A3fsA9Zfv1X2fVEQhTw51lKENdNrEqT3,11,20,11,0,1,1,13,0,46,6.571428571428571,6,0.0,4,11,0,1,16,1,0,13,0,16,30,1
2647,24356,jb05o2Us6b6SE2vZsRGcabjWWbS3vGCF,SpATywNh6bZuzm8s1ceuBUnMUAeoAHHw,1,0,0,0,0,0,2,0,2,0.2857142857142857,1,0.0,0,0,0,0,0,0,0,2,0,0,2,1
2648,24359,WdQwb0B6ZnAdvXskBHP8stZHsjNTkrqQ,SpATywNh6bZuzm8s1ceuBUnMUAeoAHHw,10,11,5,9,1,0,8,0,34,4.857142857142857,1,0.0,1,5,7,1,10,0,2,8,0,14,20,1
2649,24369,dWVj5G83xAxBDmPzLgLHfDC3pxyIk4K1,SpATywNh6bZuzm8s1ceuBUnMUAeoAHHw,1,0,0,0,0,0,3,0,3,0.42857142857142855,1,0.0,0,0,0,0,0,0,0,3,0,0,3,1
2650,24371,1RLhIao7wKT4YvgWBYzjLBBf7hozJmqb,SpATywNh6bZuzm8s1ceuBUnMUAeoAHHw,8,5,1,0,1,1,6,1,15,2.142857142857143,2,0.0,0,1,0,1,5,1,0,6,1,2,13,1
2651,24375,vx3ISVZde9Js9SAljxLNpat5gkbJKEY2,RXDvfPUBYFlVdlueBFbLW0mhhAyGEqpt,53,60,19,75,12,15,27,2,210,30.0,6,0.0,22,19,70,12,38,15,5,27,2,123,87,0
2652,24384,j1jdy8OF5VQw4rqSYOkbK2pQplvvvz37,SpATywNh6bZuzm8s1ceuBUnMUAeoAHHw,1,0,0,0,0,0,2,0,2,0.2857142857142857,2,0.0,0,0,0,0,0,0,0,2,0,0,2,1
2653,24391,5tGNQxzw9lFd1DSnmxNCdWwVZfTyj1IB,bWdj2GDclj5ofokWjzoa5jAwMkxCykd6,24,35,22,108,8,0,13,0,186,26.571428571428573,8,0.0,4,22,106,8,31,0,2,13,0,140,46,1
2654,24396,WdQwb0B6ZnAdvXskBHP8stZHsjNTkrqQ,A3fsA9Zfv1X2fVEQhTw51lKENdNrEqT3,10,4,1,0,1,0,7,2,15,2.142857142857143,1,0.0,0,1,0,1,4,0,0,7,2,2,13,1
2655,24397,2ZTBzb1Y4dwuOwNiUUSWB6SyHlRXxNso,SpATywNh6bZuzm8s1ceuBUnMUAeoAHHw,31,63,18,25,9,2,9,1,127,18.142857142857142,5,0.0,33,18,25,9,30,2,0,9,1,85,42,1
2656,24418,a3VUGRBh4vIHU6nTy2I0Dl5D5S8VvzQM,SpATywNh6bZuzm8s1ceuBUnMUAeoAHHw,7,3,2,0,2,0,2,0,9,1.2857142857142858,1,0.0,0,2,0,2,3,0,0,2,0,4,5,1
2657,24431,ADFd6U5gb8MuQY2di0urTV7aR0h11Ir1,RXDvfPUBYFlVdlueBFbLW0mhhAyGEqpt,2,0,0,0,0,0,2,0,2,0.2857142857142857,1,0.0,0,0,0,0,0,0,0,2,0,0,2,1
2658,24432,ADFd6U5gb8MuQY2di0urTV7aR0h11Ir1,A3fsA9Zfv1X2fVEQhTw51lKENdNrEqT3,2,0,0,0,0,0,2,0,2,0.2857142857142857,1,0.0,0,0,0,0,0,0,0,2,0,0,2,1
2659,24445,mFNGHC6aCmhHmhRXFCDO0uvnGnNYaro0,bWdj2GDclj5ofokWjzoa5jAwMkxCykd6,15,25,16,14,6,8,12,0,81,11.571428571428571,5,0.0,2,16,12,6,23,8,2,12,0,36,45,1
2660,24447,bSOq11L6zS91mDTcR42LcWMRdkU0Htpv,SpATywNh6bZuzm8s1ceuBUnMUAeoAHHw,20,19,12,0,8,1,13,0,53,7.571428571428571,4,0.0,1,12,0,8,18,1,0,13,0,21,32,1
2661,24456,AOtTiaeDNx4G2J0NpAHDjb596RxqAAI3,SpATywNh6bZuzm8s1ceuBUnMUAeoAHHw,19,28,10,14,6,2,13,2,75,10.714285714285714,2,0.0,15,10,11,6,13,2,3,13,2,42,33,1
2662,24475,1yAfuEW0CNQiRXnPO0v79LFUyx4hhTWm,bWdj2GDclj5ofokWjzoa5jAwMkxCykd6,16,9,7,38,1,0,14,0,69,9.857142857142858,4,0.0,0,7,33,1,9,0,5,14,0,41,28,0
2663,24503,VVgqDLLa7j66k9tQU3M7wVOF4BEse4lo,SpATywNh6bZuzm8s1ceuBUnMUAeoAHHw,41,111,36,18,18,1,16,0,200,28.571428571428573,9,0.0,11,36,18,18,100,1,0,16,0,83,117,0
2664,24505,iXoEMwcJ5o4IM7VKZ5pyam9GxPy4olUQ,G8EPVSXsOYB5YQWZGiz1aVq5Pgr2GrQu,4,3,1,0,0,0,4,0,8,1.1428571428571428,2,0.0,0,1,0,0,3,0,0,4,0,1,7,1
2665,24517,iXoEMwcJ5o4IM7VKZ5pyam9GxPy4olUQ,bWdj2GDclj5ofokWjzoa5jAwMkxCykd6,19,70,20,0,3,0,6,0,99,14.142857142857142,2,0.0,3,20,0,3,67,0,0,6,0,26,73,1
2666,24536,tE3Bwjiismxnblg3Eq9l6K3IoXQaklnD,bWdj2GDclj5ofokWjzoa5jAwMkxCykd6,1,0,0,0,0,0,1,0,1,0.14285714285714285,1,0.0,0,0,0,0,0,0,0,1,0,0,1,1
2667,24539,tE3Bwjiismxnblg3Eq9l6K3IoXQaklnD,SpATywNh6bZuzm8s1ceuBUnMUAeoAHHw,11,12,1,0,1,0,3,0,17,2.4285714285714284,1,0.0,3,1,0,1,9,0,0,3,0,5,12,1
2668,24542,GW33fgaq0ndGNQkirzfpXhCeUuV3tuD2,SpATywNh6bZuzm8s1ceuBUnMUAeoAHHw,30,50,25,28,15,3,14,1,136,19.428571428571427,6,0.0,12,25,27,15,38,3,1,14,1,79,57,0
2669,24550,qr1Y8xuPrcpdzScNHYsirGXqasfUdOVa,SpATywNh6bZuzm8s1ceuBUnMUAeoAHHw,8,15,7,0,4,0,7,0,33,4.714285714285714,4,0.0,0,7,0,4,15,0,0,7,0,11,22,1
2670,24551,foJyfq5hSUj3jzVw8TG0nT1wv3hLMMNc,G8EPVSXsOYB5YQWZGiz1aVq5Pgr2GrQu,86,128,58,184,39,0,19,0,428,61.142857142857146,8,0.0,2,58,162,39,126,0,22,19,0,261,167,0
2671,24552,foJyfq5hSUj3jzVw8TG0nT1wv3hLMMNc,SpATywNh6bZuzm8s1ceuBUnMUAeoAHHw,39,69,15,36,7,5,19,0,151,21.571428571428573,9,0.0,7,15,35,7,62,5,1,19,0,64,87,0
2672,24569,VeFENcSXAiXgJQaSjlXiodtIBxgSrzaH,A3fsA9Zfv1X2fVEQhTw51lKENdNrEqT3,9,11,4,0,2,0,6,0,23,3.2857142857142856,4,0.0,0,4,0,2,11,0,0,6,0,6,17,1
2673,24572,QDaW6SyhKIOYnUckUXKfy6A7QKIp9Kb8,A3fsA9Zfv1X2fVEQhTw51lKENdNrEqT3,6,0,0,0,0,1,5,0,6,0.8571428571428571,1,0.0,0,0,0,0,0,1,0,5,0,0,6,1
2674,24587,f7pgA2Hp0s8DkqzKuvE0Kw8QRuoBh3Zv,RXDvfPUBYFlVdlueBFbLW0mhhAyGEqpt,66,94,53,132,22,19,11,0,331,47.285714285714285,6,0.0,26,53,116,22,68,19,16,11,0,217,114,0
2675,24601,rhJzZeMBkfw1Q75cLyvgh9HzDvUXe9cc,SpATywNh6bZuzm8s1ceuBUnMUAeoAHHw,4,3,0,0,0,0,4,0,7,1.0,2,0.0,0,0,0,0,3,0,0,4,0,0,7,1
2676,24602,tBWD1VTj6Jcj3AQ0AXY8eZtUzkjmoiNH,SpATywNh6bZuzm8s1ceuBUnMUAeoAHHw,38,91,11,25,6,25,35,3,196,28.0,11,0.0,15,11,22,6,76,25,3,35,3,54,142,0
2677,24608,S5LJKm1sQOy9mdQmh7HP7gCjw7krEMbq,A3fsA9Zfv1X2fVEQhTw51lKENdNrEqT3,13,6,3,0,3,0,8,0,20,2.857142857142857,3,0.0,0,3,0,3,6,0,0,8,0,6,14,1
2678,24619,0JvlwMe8wRQNeLJu71UvJCaEJca2naUP,7GRhBDsirIGkRZBtSMEzNTyDr2JQm4xx,38,48,17,34,14,9,15,2,139,19.857142857142858,4,0.0,17,17,28,14,31,9,6,15,2,76,63,1
2679,24632,zn2X74vvqUQRINz90WjZLsSsFglpYr7o,bWdj2GDclj5ofokWjzoa5jAwMkxCykd6,2,0,0,0,0,0,4,0,4,0.5714285714285714,2,0.0,0,0,0,0,0,0,0,4,0,0,4,1
2680,24639,V8bq19VRjJPQTPqkEHpwumnaTzC0PrkP,SpATywNh6bZuzm8s1ceuBUnMUAeoAHHw,28,39,5,20,3,0,10,0,77,11.0,4,0.0,5,5,17,3,34,0,3,10,0,30,47,0
2681,24640,a34YLXSKFcXb1SBjIduE3dfW4OSAFwK1,A3fsA9Zfv1X2fVEQhTw51lKENdNrEqT3,104,212,142,222,79,139,19,1,814,116.28571428571429,10,0.0,9,142,189,79,203,139,33,19,1,419,395,0
2682,24647,irfHUOmQ9hKgTbYvLuUeHyoDnnmQjKX2,SpATywNh6bZuzm8s1ceuBUnMUAeoAHHw,12,24,0,9,0,0,1,0,34,4.857142857142857,3,0.0,2,0,9,0,22,0,0,1,0,11,23,1
2683,24661,ZgPDgY8Y43cADkyBad03WZKNqaM99vmp,7GRhBDsirIGkRZBtSMEzNTyDr2JQm4xx,83,256,22,86,50,7,70,4,495,70.71428571428571,10,0.0,119,22,69,50,137,7,17,70,4,260,235,0
2684,24671,CujRQEMNAms1MfkSbNZMqIZ2ckRo2DyK,SpATywNh6bZuzm8s1ceuBUnMUAeoAHHw,24,13,12,0,12,0,1,0,38,5.428571428571429,1,0.0,0,12,0,12,13,0,0,1,0,24,14,1
2685,24680,1VsjBK2ROnIVYUeDYM5LmXmBSaC6415r,7GRhBDsirIGkRZBtSMEzNTyDr2JQm4xx,4,2,1,0,0,0,2,0,5,0.7142857142857143,1,0.0,0,1,0,0,2,0,0,2,0,1,4,1
2686,24720,umgqnQJ37y6QmsMhUUaPYa8Ra9JvurY1,RXDvfPUBYFlVdlueBFbLW0mhhAyGEqpt,40,31,2,96,5,10,8,2,154,22.0,2,0.0,13,2,91,5,18,10,5,8,2,111,43,1
2687,24733,hKPStE98N24xDjgawMiipqs6yqyYY1sR,A3fsA9Zfv1X2fVEQhTw51lKENdNrEqT3,25,21,17,0,17,0,4,0,59,8.428571428571429,2,0.0,0,17,0,17,21,0,0,4,0,34,25,1
2688,24744,S6vBzHKpSh31SFGGZmwgKaOH2RvW3RpH,bWdj2GDclj5ofokWjzoa5jAwMkxCykd6,19,48,28,26,14,1,36,1,154,22.0,5,0.0,3,28,20,14,45,1,6,36,1,65,89,1
2689,24770,JSUd2wnxbPhnPOoSIVdrMCxy8KhaLF4M,7GRhBDsirIGkRZBtSMEzNTyDr2JQm4xx,20,34,17,17,10,0,9,0,87,12.428571428571429,5,0.0,5,17,14,10,29,0,3,9,0,46,41,1
2690,24771,zOqvR5SeTZmNwN7GW7m4oZ7a32WZgEDz,RXDvfPUBYFlVdlueBFbLW0mhhAyGEqpt,23,23,2,35,2,15,5,0,82,11.714285714285714,2,0.0,0,2,32,2,23,15,3,5,0,36,46,1
2691,24783,3b2PIBrJ06iLfdDIB9BTmuEwfL5TZfMa,RXDvfPUBYFlVdlueBFbLW0mhhAyGEqpt,68,63,36,112,17,8,11,1,248,35.42857142857143,5,0.0,15,36,103,17,48,8,9,11,1,171,77,0
2692,24796,8tSKdZ8K9lE8Sg5tXOt7ENrj00lNonld,SpATywNh6bZuzm8s1ceuBUnMUAeoAHHw,33,38,1,46,0,15,15,2,117,16.714285714285715,5,0.0,9,1,40,0,29,15,6,15,2,50,67,0
2693,24801,L3UNEJ1eeCeR9aybOSGMuUGRsyDaN7a4,bWdj2GDclj5ofokWjzoa5jAwMkxCykd6,6,3,1,0,1,0,3,0,8,1.1428571428571428,1,0.0,0,1,0,1,3,0,0,3,0,2,6,1
2694,24805,KRi80h1uK84snC5HvtQKWlsjwt9i3oa5,SpATywNh6bZuzm8s1ceuBUnMUAeoAHHw,16,22,13,16,5,0,5,0,61,8.714285714285714,4,0.0,5,13,15,5,17,0,1,5,0,38,23,0
2695,24823,FCXkOVtASvwM4OqelAOjh7n6TzPCCzLb,7GRhBDsirIGkRZBtSMEzNTyDr2JQm4xx,7,5,3,0,3,0,2,0,13,1.8571428571428572,1,0.0,1,3,0,3,4,0,0,2,0,7,6,1
2696,24824,JEEkuD8nRyQdFWZOzS8kZ8mhHw8bPQH3,7GRhBDsirIGkRZBtSMEzNTyDr2JQm4xx,2,0,0,0,0,0,2,0,2,0.2857142857142857,1,0.0,0,0,0,0,0,0,0,2,0,0,2,1
2697,24834,NsnGWsRio9JsRS5X1oYgeBjF7tc8iDdA,7GRhBDsirIGkRZBtSMEzNTyDr2JQm4xx,40,95,39,85,27,28,18,1,293,41.857142857142854,5,0.0,44,39,74,27,51,28,11,18,1,184,109,1
2698,24836,wuaIkUodYTr49NZ7BbMPsEdpO0t0C8Nt,7GRhBDsirIGkRZBtSMEzNTyDr2JQm4xx,2,0,0,0,0,0,2,0,2,0.2857142857142857,1,0.0,0,0,0,0,0,0,0,2,0,0,2,1
2699,24842,jp9FX1owC1BGGjPOS9WG7gx9X0bMCATT,A3fsA9Zfv1X2fVEQhTw51lKENdNrEqT3,12,5,4,0,4,1,6,0,20,2.857142857142857,1,0.0,0,4,0,4,5,1,0,6,0,8,12,1
2700,24853,uk4lJc7hhDXtTbcWelQONZl266ZHWHlG,bWdj2GDclj5ofokWjzoa5jAwMkxCykd6,1,0,0,0,0,0,1,0,1,0.14285714285714285,1,0.0,0,0,0,0,0,0,0,1,0,0,1,1
2701,24866,8UmSY8k6lf4RKxdf5ricL28pLrACJVR9,SpATywNh6bZuzm8s1ceuBUnMUAeoAHHw,34,24,21,12,14,0,5,0,76,10.857142857142858,3,0.0,0,21,11,14,24,0,1,5,0,46,30,0
2702,24868,fyj3r6vk9lK8U7ImkbdH1MthcS6agXn7,SpATywNh6bZuzm8s1ceuBUnMUAeoAHHw,49,68,37,34,17,0,14,0,170,24.285714285714285,6,0.0,12,37,29,17,56,0,5,14,0,95,75,0
2703,24869,uk4lJc7hhDXtTbcWelQONZl266ZHWHlG,SpATywNh6bZuzm8s1ceuBUnMUAeoAHHw,5,2,1,0,1,0,2,0,6,0.8571428571428571,1,0.0,0,1,0,1,2,0,0,2,0,2,4,1
2704,24885,7AeiHdeG7nh46bg2JDAmPWtQ1zuvRpUT,A3fsA9Zfv1X2fVEQhTw51lKENdNrEqT3,15,11,2,0,0,1,11,1,26,3.7142857142857144,2,0.0,0,2,0,0,11,1,0,11,1,2,24,0
2705,24886,rO1KHHxaPbWq8U3I08PqNPYplaZaPb83,RXDvfPUBYFlVdlueBFbLW0mhhAyGEqpt,44,24,22,0,21,0,4,0,71,10.142857142857142,3,0.0,0,22,0,21,24,0,0,4,0,43,28,1
2706,24896,0njFIWivrrj9Fy960ZZzqHbIMRcsR4hZ,5X6FeZozNMgE2VRi3MJYjkkFK8SETtu2,1,0,0,0,0,0,1,0,1,0.14285714285714285,1,0.0,0,0,0,0,0,0,0,1,0,0,1,1
2707,24901,paRtaUir7BROwVpnw69gcE7HkkiPuHFt,7GRhBDsirIGkRZBtSMEzNTyDr2JQm4xx,34,81,6,70,7,8,43,5,220,31.428571428571427,4,0.0,49,6,61,7,32,8,9,43,5,123,97,1
2708,24909,pyd2EL5x8zMZ7LCIvrt0VYq229eSSKrd,SpATywNh6bZuzm8s1ceuBUnMUAeoAHHw,58,79,51,73,30,12,11,2,258,36.857142857142854,5,0.0,25,51,61,30,54,12,12,11,2,167,91,0
2709,24925,I1KwJ6EdCZnEPLfC8Q7yWpIkLOHn7h02,5X6FeZozNMgE2VRi3MJYjkkFK8SETtu2,4,2,1,0,1,0,2,0,6,0.8571428571428571,2,0.0,0,1,0,1,2,0,0,2,0,2,4,1
2710,24929,hCRoH0np1tajD5PHKKgVw7dH4NZJLfD2,A3fsA9Zfv1X2fVEQhTw51lKENdNrEqT3,123,82,63,224,42,59,38,7,515,73.57142857142857,16,0.0,3,63,188,42,79,59,36,38,7,296,219,0
2711,24942,DCwFNk2m7QLqdKcTT3u5CdSnRyl5YCHB,SpATywNh6bZuzm8s1ceuBUnMUAeoAHHw,5,3,2,0,0,0,3,0,8,1.1428571428571428,2,0.0,0,2,0,0,3,0,0,3,0,2,6,1
2712,24945,rodgm0zI0P2ONVMZgr9w2JZEIK5qKGiW,bWdj2GDclj5ofokWjzoa5jAwMkxCykd6,5,2,1,0,1,0,2,0,6,0.8571428571428571,1,0.0,0,1,0,1,2,0,0,2,0,2,4,1
2713,24948,uFNLKo5bqJzWC9QIIX9vS1Tn11aB7Uzj,5X6FeZozNMgE2VRi3MJYjkkFK8SETtu2,16,33,5,6,12,0,19,1,76,10.857142857142858,4,0.0,20,5,6,12,13,0,0,19,1,43,33,1
2714,24952,agvJ7trZCSUWkipgduUE9TqoVxnUX1n1,G8EPVSXsOYB5YQWZGiz1aVq5Pgr2GrQu,83,175,76,34,67,0,17,0,369,52.714285714285715,2,0.0,2,76,31,67,173,0,3,17,0,176,193,1
2715,24968,BkozGGotFoRWvs7kivTQvwwV5JZ8hddc,SpATywNh6bZuzm8s1ceuBUnMUAeoAHHw,25,33,16,10,10,0,11,0,80,11.428571428571429,2,0.0,2,16,8,10,31,0,2,11,0,36,44,1
2716,24974,KKySZH8Vhrdd4z2bRf8FAPkHeGpE3JpX,RXDvfPUBYFlVdlueBFbLW0mhhAyGEqpt,18,22,2,0,0,0,6,0,30,4.285714285714286,3,0.0,0,2,0,0,22,0,0,6,0,2,28,0
2717,24976,KKySZH8Vhrdd4z2bRf8FAPkHeGpE3JpX,G8EPVSXsOYB5YQWZGiz1aVq5Pgr2GrQu,35,58,3,86,0,0,5,0,152,21.714285714285715,2,0.0,9,3,75,0,49,0,11,5,0,87,65,0
2718,24984,p8pFuUg19xWGOlJygMvSlQjonA3l7FUn,A3fsA9Zfv1X2fVEQhTw51lKENdNrEqT3,67,41,33,149,22,0,6,0,251,35.857142857142854,5,0.0,2,33,132,22,39,0,17,6,0,189,62,0
2719,24994,FP4hLkoHHSoDgNvvli0GZn0SfLgLxSLJ,5X6FeZozNMgE2VRi3MJYjkkFK8SETtu2,12,25,2,4,16,0,4,0,51,7.285714285714286,2,0.0,17,2,4,16,8,0,0,4,0,39,12,0
2720,24996,tLK32ryOHeiJecBcFzaTeN36vYEmQ8Nk,SpATywNh6bZuzm8s1ceuBUnMUAeoAHHw,37,35,18,42,10,8,14,4,131,18.714285714285715,4,0.0,11,18,37,10,24,8,5,14,4,76,55,1
2721,25007,KKySZH8Vhrdd4z2bRf8FAPkHeGpE3JpX,bWdj2GDclj5ofokWjzoa5jAwMkxCykd6,31,40,4,22,1,0,9,0,76,10.857142857142858,5,0.0,0,4,21,1,40,0,1,9,0,26,50,0
2722,25013,hei4w2KIPZzLJz63zWPLxls45GdSfJe0,bWdj2GDclj5ofokWjzoa5jAwMkxCykd6,5,4,1,0,2,0,2,0,9,1.2857142857142858,1,0.0,2,1,0,2,2,0,0,2,0,5,4,1
2723,25019,8ibVKkL5UrFgK6JKg8yfjyVvYk238T4p,5X6FeZozNMgE2VRi3MJYjkkFK8SETtu2,5,2,1,0,1,0,2,0,6,0.8571428571428571,1,0.0,0,1,0,1,2,0,0,2,0,2,4,1
2724,25020,XIT3vh7ciDFWTW9rM7KEuC2m7IOiQwcw,5X6FeZozNMgE2VRi3MJYjkkFK8SETtu2,13,12,2,18,4,0,4,0,40,5.714285714285714,3,0.0,7,2,16,4,5,0,2,4,0,29,11,1
2725,25022,DmRnf6emOOeLa4MI9vNggFDmgXu8cRIO,SpATywNh6bZuzm8s1ceuBUnMUAeoAHHw,26,30,14,46,1,35,17,1,144,20.571428571428573,3,0.0,11,14,43,1,19,35,3,17,1,69,75,0
2726,25027,DbZPQKpa8Qt5UWHmHKDItNooYyEfaZ0X,SpATywNh6bZuzm8s1ceuBUnMUAeoAHHw,41,71,41,31,23,1,14,1,182,26.0,5,0.0,22,41,28,23,49,1,3,14,1,114,68,0
2727,25033,BuZcYQWwWDSVZcqno1RGBiY1PDnVqtUZ,G8EPVSXsOYB5YQWZGiz1aVq5Pgr2GrQu,46,123,66,28,1,9,11,0,238,34.0,4,0.0,4,66,26,1,119,9,2,11,0,97,141,1
2728,25049,zkOr0wwuxAzYftPuxG6iQaCtbl1egkTS,A3fsA9Zfv1X2fVEQhTw51lKENdNrEqT3,92,81,55,162,25,22,52,5,402,57.42857142857143,7,0.0,11,55,146,25,70,22,16,52,5,237,165,0
2729,25066,46mPOafwambmi8gI5RDfSSG6CkqbcJr8,bWdj2GDclj5ofokWjzoa5jAwMkxCykd6,1,0,0,0,0,0,1,0,1,0.14285714285714285,1,0.0,0,0,0,0,0,0,0,1,0,0,1,1
2730,25067,aQ6WrdDe9pTNwVW3vmaMOs1pxy5r3Dxa,A3fsA9Zfv1X2fVEQhTw51lKENdNrEqT3,119,102,61,240,27,50,46,2,528,75.42857142857143,9,0.0,5,61,193,27,97,50,47,46,2,286,242,0
2731,25070,rBTfxwVs2POKvl7kZ0wlpqKQWxNS4JpH,bWdj2GDclj5ofokWjzoa5jAwMkxCykd6,5,2,0,0,0,0,3,0,5,0.7142857142857143,1,0.0,0,0,0,0,2,0,0,3,0,0,5,1
2732,25073,WQKoaWRi4j5EUCfZEZsK4LU6GIHATRae,SpATywNh6bZuzm8s1ceuBUnMUAeoAHHw,60,57,38,53,22,9,20,0,199,28.428571428571427,9,0.0,11,38,41,22,46,9,12,20,0,112,87,1
2733,25075,WQKoaWRi4j5EUCfZEZsK4LU6GIHATRae,7GRhBDsirIGkRZBtSMEzNTyDr2JQm4xx,32,48,17,50,14,10,5,0,144,20.571428571428573,2,0.0,29,17,39,14,19,10,11,5,0,99,45,1
2734,25076,WQKoaWRi4j5EUCfZEZsK4LU6GIHATRae,A3fsA9Zfv1X2fVEQhTw51lKENdNrEqT3,23,28,20,0,15,4,10,0,77,11.0,3,0.0,0,20,0,15,28,4,0,10,0,35,42,1
2735,25081,8lyMyOM14BBuwJGJJ05LNI486l6zCvt9,G8EPVSXsOYB5YQWZGiz1aVq5Pgr2GrQu,72,117,25,177,14,1,8,0,342,48.857142857142854,6,0.0,0,25,150,14,117,1,27,8,0,189,153,0
2736,25091,vIBcYbs1BLdmaaP30fcE2FS7kB7v7QRn,5X6FeZozNMgE2VRi3MJYjkkFK8SETtu2,12,15,7,0,8,1,5,0,36,5.142857142857143,4,0.0,4,7,0,8,11,1,0,5,0,19,17,1
2737,25093,gI5Z44eMWR6ZJ3av3OUOPDUbSXNUhMWL,G8EPVSXsOYB5YQWZGiz1aVq5Pgr2GrQu,6,27,14,0,10,0,11,0,62,8.857142857142858,3,0.0,6,14,0,10,21,0,0,11,0,30,32,1
2738,25096,i7qRP2nhuaIR2tcQnQvT86ViNtPopbnz,7GRhBDsirIGkRZBtSMEzNTyDr2JQm4xx,11,13,7,0,4,0,7,0,31,4.428571428571429,3,0.0,1,7,0,4,12,0,0,7,0,12,19,1
2739,25111,XQUx3MwVudtjeHmsju8PhHxsdXW0kluK,SpATywNh6bZuzm8s1ceuBUnMUAeoAHHw,43,84,47,38,22,38,25,0,254,36.285714285714285,7,0.0,19,47,36,22,65,38,2,25,0,124,130,0
2740,25118,mBkByOktWGTfbLjZh4oUEAyrYqB4PqkG,7GRhBDsirIGkRZBtSMEzNTyDr2JQm4xx,6,17,3,0,1,0,3,0,24,3.4285714285714284,6,0.0,0,3,0,1,17,0,0,3,0,4,20,1
2741,25134,tyleDimh7zmzFWTVgvg7bgaQaZGfwPk2,A3fsA9Zfv1X2fVEQhTw51lKENdNrEqT3,8,7,1,0,0,0,8,0,16,2.2857142857142856,3,0.0,0,1,0,0,7,0,0,8,0,1,15,0
2742,25168,hn3N1teM21fHZj3Va1VunKpgupbOlN1e,G8EPVSXsOYB5YQWZGiz1aVq5Pgr2GrQu,5,2,1,0,1,0,2,0,6,0.8571428571428571,1,0.0,0,1,0,1,2,0,0,2,0,2,4,1
2743,25179,Wv1aklktHgLr1Kkm3cAKn5mEcTvn8MRQ,SpATywNh6bZuzm8s1ceuBUnMUAeoAHHw,16,25,8,12,4,0,9,2,60,8.571428571428571,2,0.0,13,8,11,4,12,0,1,9,2,36,24,1
2744,25182,hGCwfWh9ySQVbALdmRR0HUMpPic5OOrw,bWdj2GDclj5ofokWjzoa5jAwMkxCykd6,7,2,1,0,1,25,6,0,35,5.0,2,0.0,1,1,0,1,1,25,0,6,0,3,32,0
2745,25189,FP4hLkoHHSoDgNvvli0GZn0SfLgLxSLJ,A3fsA9Zfv1X2fVEQhTw51lKENdNrEqT3,9,5,0,0,0,0,4,0,9,1.2857142857142858,1,0.0,0,0,0,0,5,0,0,4,0,0,9,0
2746,25194,evrdwGhLAFWdgr0Clw2EFTM91w358eNP,SpATywNh6bZuzm8s1ceuBUnMUAeoAHHw,42,41,26,15,14,10,12,2,120,17.142857142857142,4,0.0,10,26,14,14,31,10,1,12,2,64,56,0
2747,25198,w6Jq91nutnXM9db4LCqDd346NIYOr0ts,7GRhBDsirIGkRZBtSMEzNTyDr2JQm4xx,8,6,3,0,0,0,9,0,18,2.5714285714285716,1,0.0,1,3,0,0,5,0,0,9,0,4,14,1
2748,25210,w6Jq91nutnXM9db4LCqDd346NIYOr0ts,bWdj2GDclj5ofokWjzoa5jAwMkxCykd6,1,0,0,0,0,0,1,0,1,0.14285714285714285,1,0.0,0,0,0,0,0,0,0,1,0,0,1,1
2749,25211,w6Jq91nutnXM9db4LCqDd346NIYOr0ts,RXDvfPUBYFlVdlueBFbLW0mhhAyGEqpt,1,0,0,0,0,0,1,0,1,0.14285714285714285,1,0.0,0,0,0,0,0,0,0,1,0,0,1,1
2750,25212,95whmOrr6ttgAKmA8d5EYFggt87ONgHi,SpATywNh6bZuzm8s1ceuBUnMUAeoAHHw,38,89,10,59,5,10,11,2,186,26.571428571428573,7,0.0,29,10,51,5,60,10,8,11,2,95,91,1
2751,25219,skOScgcMIkYsPXikHjLqvicjdb3rv6St,A3fsA9Zfv1X2fVEQhTw51lKENdNrEqT3,14,24,11,14,3,0,10,0,62,8.857142857142858,6,0.0,2,11,12,3,22,0,2,10,0,28,34,1
2752,25227,oMeMGN5dWLI9b1NmVln2QTgmonaWkwwr,5X6FeZozNMgE2VRi3MJYjkkFK8SETtu2,2,0,0,0,0,0,2,0,2,0.2857142857142857,1,0.0,0,0,0,0,0,0,0,2,0,0,2,1
2753,25229,CFU5Hcmb88RpDCC1WRy61w8jF98WVrHg,SpATywNh6bZuzm8s1ceuBUnMUAeoAHHw,6,4,0,0,0,0,2,0,6,0.8571428571428571,1,0.0,0,0,0,0,4,0,0,2,0,0,6,0
2754,25235,BgFWtuiCvZoByaUpZ5qN1JDEWuWXlm2n,G8EPVSXsOYB5YQWZGiz1aVq5Pgr2GrQu,42,90,32,110,11,2,22,2,269,38.42857142857143,5,0.0,43,32,67,11,47,2,43,22,2,153,116,1
2755,25245,fwJOSE30dgFjd5HDygnvoRYJwTlCZZHQ,SpATywNh6bZuzm8s1ceuBUnMUAeoAHHw,7,3,2,0,2,0,2,0,9,1.2857142857142858,1,0.0,0,2,0,2,3,0,0,2,0,4,5,1
2756,25249,ycTj3YOXaJ7pHDIwrzbh7koMVXAXAOVY,bWdj2GDclj5ofokWjzoa5jAwMkxCykd6,44,64,40,186,24,3,18,2,337,48.142857142857146,6,0.0,16,40,177,24,48,3,9,18,2,257,80,0
2757,25258,eovSKdG09ZHYTXNtS1zUIy1RfsRsCibs,5X6FeZozNMgE2VRi3MJYjkkFK8SETtu2,1,0,0,0,0,0,1,0,1,0.14285714285714285,1,0.0,0,0,0,0,0,0,0,1,0,0,1,1
2758,25265,9va79rFsgW625mCi6PBHbhUMC5acSS5i,bWdj2GDclj5ofokWjzoa5jAwMkxCykd6,52,54,27,177,22,0,29,2,311,44.42857142857143,8,0.0,22,27,165,22,32,0,12,29,2,236,75,0
2759,25267,5ljcr0UvulJFpE7l8xjXUfhEEvQngZBn,RXDvfPUBYFlVdlueBFbLW0mhhAyGEqpt,17,21,6,18,5,0,11,3,64,9.142857142857142,1,0.0,9,6,13,5,12,0,5,11,3,33,31,1
2760,25269,E1ioRxhhohHY3rrHygts052gZKXoxwdE,7GRhBDsirIGkRZBtSMEzNTyDr2JQm4xx,7,3,2,0,2,0,2,0,9,1.2857142857142858,1,0.0,0,2,0,2,3,0,0,2,0,4,5,1
2761,25277,7f2vx3DQNne1WBDg49zqZf9IbRsj8WIx,SpATywNh6bZuzm8s1ceuBUnMUAeoAHHw,39,96,5,56,2,2,15,3,179,25.571428571428573,3,0.0,16,5,46,2,80,2,10,15,3,69,110,1
2762,25284,6DpgdlGoKRdZ3TeMwKLdUESj04TqApO6,7GRhBDsirIGkRZBtSMEzNTyDr2JQm4xx,41,61,22,84,16,0,7,0,190,27.142857142857142,4,0.0,33,22,74,16,28,0,10,7,0,145,45,1
2763,25285,8GY6nVtp5b50wDGijkY6exWcSNm7iEKc,A3fsA9Zfv1X2fVEQhTw51lKENdNrEqT3,5,2,1,0,1,0,5,0,9,1.2857142857142858,1,0.0,0,1,0,1,2,0,0,5,0,2,7,0
2764,25287,ETzcC9n39CwhBb4MTbqq1Ng4NqGIoiPj,SpATywNh6bZuzm8s1ceuBUnMUAeoAHHw,14,29,3,8,2,0,6,0,48,6.857142857142857,2,0.0,9,3,8,2,20,0,0,6,0,22,26,1
2765,25295,ETzcC9n39CwhBb4MTbqq1Ng4NqGIoiPj,bWdj2GDclj5ofokWjzoa5jAwMkxCykd6,20,23,2,32,1,1,10,0,69,9.857142857142858,3,0.0,1,2,28,1,22,1,4,10,0,32,37,1
2766,25298,zKmoS7m0B5DOXQCEJhwtu5OAJkpItkzI,SpATywNh6bZuzm8s1ceuBUnMUAeoAHHw,49,40,34,15,20,0,6,0,115,16.428571428571427,4,0.0,0,34,12,20,40,0,3,6,0,66,49,0
2767,25299,NwQCoUHJKyAdqdG7U0utXO1oyZsmr8V3,A3fsA9Zfv1X2fVEQhTw51lKENdNrEqT3,186,130,40,454,23,23,36,1,707,101.0,10,0.0,8,40,400,23,122,23,54,36,1,471,236,0
2768,25303,mmqs9k1q1N6mK08e9WtlZS9NC3duFHeJ,5X6FeZozNMgE2VRi3MJYjkkFK8SETtu2,1,0,0,0,0,0,1,0,1,0.14285714285714285,1,0.0,0,0,0,0,0,0,0,1,0,0,1,1
2769,25315,skOScgcMIkYsPXikHjLqvicjdb3rv6St,5X6FeZozNMgE2VRi3MJYjkkFK8SETtu2,9,6,4,0,3,0,3,0,16,2.2857142857142856,3,0.0,0,4,0,3,6,0,0,3,0,7,9,1
2770,25327,HEmUYsQ9Ltj0MM8eYqBVagWQusNuFQuQ,RXDvfPUBYFlVdlueBFbLW0mhhAyGEqpt,5,2,1,0,1,0,2,0,6,0.8571428571428571,1,0.0,0,1,0,1,2,0,0,2,0,2,4,1
2771,25330,JQkQWFK6hvLU3dRb6IiKAH09cV6i6Ru3,SpATywNh6bZuzm8s1ceuBUnMUAeoAHHw,43,73,4,50,3,10,18,2,160,22.857142857142858,4,0.0,17,4,45,3,56,10,5,18,2,69,91,0
2772,25338,yMi75Aqo9j8H3qaYVwZOhYhugu84oiGL,bWdj2GDclj5ofokWjzoa5jAwMkxCykd6,1,0,0,0,0,0,1,0,1,0.14285714285714285,1,0.0,0,0,0,0,0,0,0,1,0,0,1,1
2773,25346,247FLfH4Mb594RFNNow4NoO1PsYj55Me,SpATywNh6bZuzm8s1ceuBUnMUAeoAHHw,7,5,2,0,2,0,5,0,14,2.0,2,0.0,0,2,0,2,5,0,0,5,0,4,10,1
2774,25347,gTKsgFH49hdtAMj9c1UQql70fl3l6ILe,SpATywNh6bZuzm8s1ceuBUnMUAeoAHHw,6,3,1,0,1,0,2,0,7,1.0,1,0.0,0,1,0,1,3,0,0,2,0,2,5,1
2775,25352,7R6kP05AQNpQLlS5bavbBVmFBtWsMm7c,5X6FeZozNMgE2VRi3MJYjkkFK8SETtu2,5,4,2,0,1,0,1,0,8,1.1428571428571428,1,0.0,1,2,0,1,3,0,0,1,0,4,4,1
2776,25371,tMJpDv6ZjEPz2ELzUVp4mZTT6G7u49T6,bWdj2GDclj5ofokWjzoa5jAwMkxCykd6,12,18,9,2,4,0,16,0,49,7.0,8,0.0,2,9,2,4,16,0,0,16,0,17,32,0
2777,25376,Evco2d15cNydZMimph5VWFT3j0HfgNP5,7GRhBDsirIGkRZBtSMEzNTyDr2JQm4xx,8,13,4,2,6,1,2,0,28,4.0,2,0.0,6,4,2,6,7,1,0,2,0,18,10,1
2778,25382,vQWTE7gjUkICJ3AdoTOlEEWV39j5eqPv,5X6FeZozNMgE2VRi3MJYjkkFK8SETtu2,3,2,1,0,0,0,1,0,4,0.5714285714285714,1,0.0,0,1,0,0,2,0,0,1,0,1,3,1
2779,25386,kUY1XcyXvxmSBWMfpg75BTt5q6TEiVc4,bWdj2GDclj5ofokWjzoa5jAwMkxCykd6,9,9,3,0,2,0,7,1,22,3.142857142857143,2,0.0,2,3,0,2,7,0,0,7,1,7,15,0
2780,25391,1aQoKDna73jstuOrupWa9Kq8V3FdvbRU,A3fsA9Zfv1X2fVEQhTw51lKENdNrEqT3,9,9,4,0,2,0,5,0,20,2.857142857142857,4,0.0,0,4,0,2,9,0,0,5,0,6,14,1
2781,25393,qfUwpJQAdesy8M2BZDMAUMfg4I7ObmXB,7GRhBDsirIGkRZBtSMEzNTyDr2JQm4xx,33,29,1,0,0,0,9,1,40,5.714285714285714,2,0.0,0,1,0,0,29,0,0,9,1,1,39,1
2782,25394,UWfjRAXX4Rb8j29dVudOzocpNXp7nal0,SpATywNh6bZuzm8s1ceuBUnMUAeoAHHw,34,48,0,39,0,12,16,0,115,16.428571428571427,2,0.0,15,0,37,0,33,12,2,16,0,52,63,0
2783,25401,avoglTQYC4DCKpMnGcRw7Ok57lEHfs0W,SpATywNh6bZuzm8s1ceuBUnMUAeoAHHw,6,4,3,0,1,0,4,0,12,1.7142857142857142,2,0.0,0,3,0,1,4,0,0,4,0,4,8,1
2784,25406,Ua8t7GvEqkquREwn5gCoNVwYmIqhqGMw,G8EPVSXsOYB5YQWZGiz1aVq5Pgr2GrQu,139,130,89,235,51,48,35,3,591,84.42857142857143,8,0.0,19,89,194,51,111,48,41,35,3,353,238,0
2785,25407,0mg5UfmflBvw9f6RP57AlBJRO9poj3Bs,RXDvfPUBYFlVdlueBFbLW0mhhAyGEqpt,1,0,0,0,0,0,1,0,1,0.14285714285714285,1,0.0,0,0,0,0,0,0,0,1,0,0,1,1
2786,25409,tvH2SB0L50iCqaXyQDY3u7qaByLbL0rV,RXDvfPUBYFlVdlueBFbLW0mhhAyGEqpt,11,11,2,0,2,1,3,0,19,2.7142857142857144,3,0.0,0,2,0,2,11,1,0,3,0,4,15,1
2787,25410,eLRb35TMSz5mhOV1jFWfgFHXl5MBmODw,SpATywNh6bZuzm8s1ceuBUnMUAeoAHHw,4,10,0,0,0,0,4,0,14,2.0,3,0.0,0,0,0,0,10,0,0,4,0,0,14,1
2788,25411,zTKXcgMSZF7JvFUNYP705peyaFADazmR,bWdj2GDclj5ofokWjzoa5jAwMkxCykd6,13,28,16,38,6,3,18,1,110,15.714285714285714,5,0.0,6,16,36,6,22,3,2,18,1,64,46,0
2789,25414,JGLccTidDHJDu8gDiATpQDW1eozc4icT,G8EPVSXsOYB5YQWZGiz1aVq5Pgr2GrQu,41,34,22,116,14,0,5,0,191,27.285714285714285,3,0.0,4,22,101,14,30,0,15,5,0,141,50,1
2790,25425,uk5y5IHI3VEYZMMQy2ltt6P3PYfAG3X8,SpATywNh6bZuzm8s1ceuBUnMUAeoAHHw,22,18,15,0,10,0,7,0,50,7.142857142857143,2,0.0,0,15,0,10,18,0,0,7,0,25,25,1
2791,25437,fyUgBQuZCcUcBZn2eTOxyQlvAAh4aEgk,5X6FeZozNMgE2VRi3MJYjkkFK8SETtu2,6,2,1,0,0,0,4,1,8,1.1428571428571428,1,0.0,0,1,0,0,2,0,0,4,1,1,7,1
2792,25442,QLGFenndIPaX8I2vSI7keErJ6m5JCAL7,7GRhBDsirIGkRZBtSMEzNTyDr2JQm4xx,9,5,2,2,3,1,5,0,18,2.5714285714285716,1,0.0,3,2,2,3,2,1,0,5,0,10,8,1
2793,25443,rpvfqHO7dPQYBUZWKnS2wc1t5Qy6pGj6,bWdj2GDclj5ofokWjzoa5jAwMkxCykd6,27,44,0,63,3,28,16,0,154,22.0,6,0.0,9,0,57,3,35,28,6,16,0,69,85,1
2794,25446,cUmqYT3vXiSNkNfCulTfjg26cA62ehB2,SpATywNh6bZuzm8s1ceuBUnMUAeoAHHw,19,18,6,0,6,1,8,1,40,5.714285714285714,2,0.0,0,6,0,6,18,1,0,8,1,12,28,1
2795,25458,GGeAJfigP0Xcr5t8L5L3jWFB8L2SPoPt,SpATywNh6bZuzm8s1ceuBUnMUAeoAHHw,6,2,1,0,1,0,3,0,7,1.0,1,0.0,0,1,0,1,2,0,0,3,0,2,5,1
2796,25461,TvoBOfhroHgtNwfOxtnATpVOdfdysLPf,SpATywNh6bZuzm8s1ceuBUnMUAeoAHHw,23,29,2,21,3,1,15,2,73,10.428571428571429,2,0.0,13,2,19,3,16,1,2,15,2,37,36,1
2797,25463,tCXa4pMsMXRuliZWNM9so3Odte6UmpYj,RXDvfPUBYFlVdlueBFbLW0mhhAyGEqpt,10,9,4,0,2,3,5,0,23,3.2857142857142856,2,0.0,2,4,0,2,7,3,0,5,0,8,15,1
2798,25465,PxlkoIm8C8IIjQF6yFywl21akC9ROids,A3fsA9Zfv1X2fVEQhTw51lKENdNrEqT3,2,0,0,0,0,0,3,0,3,0.42857142857142855,1,0.0,0,0,0,0,0,0,0,3,0,0,3,1
2799,25471,qfUwpJQAdesy8M2BZDMAUMfg4I7ObmXB,A3fsA9Zfv1X2fVEQhTw51lKENdNrEqT3,6,2,1,0,1,0,3,0,7,1.0,1,0.0,0,1,0,1,2,0,0,3,0,2,5,0
2800,25482,M3Xa5IFPEZiaLK2rAjKqcPYFncjR6IsA,7GRhBDsirIGkRZBtSMEzNTyDr2JQm4xx,10,9,6,0,2,0,8,0,25,3.5714285714285716,3,0.0,0,6,0,2,9,0,0,8,0,8,17,1
2801,25487,6ybUHpN1mcOdThgiQaLfQfBvlnH7diq3,RXDvfPUBYFlVdlueBFbLW0mhhAyGEqpt,42,36,1,120,5,36,4,19,221,31.571428571428573,2,0.0,13,1,108,5,23,36,12,4,19,127,94,0
2802,25494,mI5nNgUr8qgf317y3rTEFMpgeTfF7Wxj,SpATywNh6bZuzm8s1ceuBUnMUAeoAHHw,4,3,1,0,1,0,3,0,8,1.1428571428571428,1,0.0,0,1,0,1,3,0,0,3,0,2,6,1
2803,25503,XQUx3MwVudtjeHmsju8PhHxsdXW0kluK,G8EPVSXsOYB5YQWZGiz1aVq5Pgr2GrQu,53,89,50,80,23,0,17,0,259,37.0,3,0.0,21,50,72,23,68,0,8,17,0,166,93,1
2804,25506,KxUR8ZwyS3V9tRQMRPUJfNwham9GOgQR,SpATywNh6bZuzm8s1ceuBUnMUAeoAHHw,18,15,3,9,2,0,9,2,40,5.714285714285714,3,0.0,2,3,8,2,13,0,1,9,2,15,25,1
2805,25507,jNbqtigMn2EmtZpiK0urYvur6p2mGuL2,bWdj2GDclj5ofokWjzoa5jAwMkxCykd6,29,27,18,26,9,5,17,0,102,14.571428571428571,4,0.0,2,18,13,9,25,5,13,17,0,42,60,1
2806,25511,RtpaISGKG8FC1poFd4XAu8898XLnl6EI,SpATywNh6bZuzm8s1ceuBUnMUAeoAHHw,41,116,42,38,14,28,58,3,299,42.714285714285715,15,0.0,28,42,31,14,88,28,7,58,3,115,184,0
2807,25527,qEjaWdK86bYd7lCS9YD68MsK6migCUpH,SpATywNh6bZuzm8s1ceuBUnMUAeoAHHw,40,42,18,30,12,0,15,0,117,16.714285714285715,6,0.0,10,18,26,12,32,0,4,15,0,66,51,0
2808,25543,XgTmtBqLznxfF9SYrnaNPxmtPq6mixPB,SpATywNh6bZuzm8s1ceuBUnMUAeoAHHw,15,17,8,0,4,5,5,0,39,5.571428571428571,2,0.0,2,8,0,4,15,5,0,5,0,14,25,1
2809,25546,rfOApTbQ4xF2665bHZIBhoJqQcTU6i9L,A3fsA9Zfv1X2fVEQhTw51lKENdNrEqT3,45,47,29,54,12,7,23,1,173,24.714285714285715,5,0.0,3,29,49,12,44,7,5,23,1,93,80,1
2810,25550,h2w8VkYmfNNCtKcYCoxPznAcsJxmWEEX,G8EPVSXsOYB5YQWZGiz1aVq5Pgr2GrQu,3,2,0,0,0,0,1,0,3,0.42857142857142855,1,0.0,0,0,0,0,2,0,0,1,0,0,3,1
2811,25551,KArM7gUn52riH9ery2Pt8jVzh161mtd5,7GRhBDsirIGkRZBtSMEzNTyDr2JQm4xx,1,0,0,0,0,0,1,0,1,0.14285714285714285,1,0.0,0,0,0,0,0,0,0,1,0,0,1,1
2812,25552,OL3EuzPtZh7LsYXjzzPmtbrDH2VopR0Y,bWdj2GDclj5ofokWjzoa5jAwMkxCykd6,6,10,5,0,1,7,8,0,31,4.428571428571429,2,0.0,0,5,0,1,10,7,0,8,0,6,25,0
2813,25557,awWzPHJHqMsVq81riWKDgsPCoY61Vh2P,G8EPVSXsOYB5YQWZGiz1aVq5Pgr2GrQu,21,49,13,14,12,2,14,0,104,14.857142857142858,2,0.0,29,13,11,12,20,2,3,14,0,65,39,0
2814,25569,wALAK8dgjZ2TZgGWVmCaa7YdyCcneRp7,G8EPVSXsOYB5YQWZGiz1aVq5Pgr2GrQu,9,14,1,0,1,1,14,1,32,4.571428571428571,2,0.0,0,1,0,1,14,1,0,14,1,2,30,1
2815,25578,X8AWHZvCEUWZQfbJnH8OYCI17lAwXaHx,SpATywNh6bZuzm8s1ceuBUnMUAeoAHHw,3,0,0,0,0,0,3,0,3,0.42857142857142855,1,0.0,0,0,0,0,0,0,0,3,0,0,3,1
2816,25588,fEjyEDOkalYa6eH46cG6UcR1E7twiXyF,SpATywNh6bZuzm8s1ceuBUnMUAeoAHHw,63,85,43,71,20,128,33,1,381,54.42857142857143,8,0.0,15,43,59,20,70,128,12,33,1,137,244,0
2817,25589,3Oka5GvBd9TakXRvr9D5vxoJEhxwuxJA,SpATywNh6bZuzm8s1ceuBUnMUAeoAHHw,23,41,20,26,4,0,21,0,112,16.0,9,0.0,11,20,26,4,30,0,0,21,0,61,51,0
2818,25591,EoNh9d9qcnIUVTAskhVjs6Md9kUsxJde,SpATywNh6bZuzm8s1ceuBUnMUAeoAHHw,50,79,49,22,14,20,31,1,216,30.857142857142858,3,0.0,16,49,21,14,63,20,1,31,1,100,116,0
2819,25599,tSfB7w0NRlNAlyBUvZCESn8JJeD8KUGH,7GRhBDsirIGkRZBtSMEzNTyDr2JQm4xx,6,2,1,0,0,0,3,0,6,0.8571428571428571,1,0.0,0,1,0,0,2,0,0,3,0,1,5,1
2820,25603,7D3GwZKw33BY2nf2pXW93DDrNPoqNI5y,SpATywNh6bZuzm8s1ceuBUnMUAeoAHHw,4,2,1,0,1,0,1,0,5,0.7142857142857143,1,0.0,0,1,0,1,2,0,0,1,0,2,3,1
2821,25607,s5bmHBniKJzstjkFlsJcJn6YQEnj7XjP,SpATywNh6bZuzm8s1ceuBUnMUAeoAHHw,19,22,13,13,6,14,9,0,77,11.0,5,0.0,3,13,11,6,19,14,2,9,0,33,44,0
2822,25635,F1N61tazho7ZYPRPggPaCszBndAmmJFa,SpATywNh6bZuzm8s1ceuBUnMUAeoAHHw,1,0,0,0,0,0,1,0,1,0.14285714285714285,1,0.0,0,0,0,0,0,0,0,1,0,0,1,1
2823,25640,AzvqiXd9z7PBzvgEy7E2cJ7lqAkLcj7V,G8EPVSXsOYB5YQWZGiz1aVq5Pgr2GrQu,47,118,43,8,29,4,7,1,210,30.0,2,0.0,68,43,6,29,50,4,2,7,1,146,64,0
2824,25649,IePFEx0pR5xLGQlWWjU59zR6qxTHOeo0,bWdj2GDclj5ofokWjzoa5jAwMkxCykd6,1,0,0,0,0,0,2,0,2,0.2857142857142857,2,0.0,0,0,0,0,0,0,0,2,0,0,2,0
2825,25655,TOdJr6wpv1Do14qMOudEcAu5ZtPnzG5P,SpATywNh6bZuzm8s1ceuBUnMUAeoAHHw,39,32,11,30,7,7,15,1,103,14.714285714285714,5,0.0,8,11,30,7,24,7,0,15,1,56,47,0
2826,25669,s24Qk0ZpAXR97ldBDtgP8DE6rT8or69U,5X6FeZozNMgE2VRi3MJYjkkFK8SETtu2,1,0,0,0,0,0,1,0,1,0.14285714285714285,1,0.0,0,0,0,0,0,0,0,1,0,0,1,1
2827,25675,wgifE6A0kxnDEjw7myKTY39TRuCgYxaB,A3fsA9Zfv1X2fVEQhTw51lKENdNrEqT3,23,38,8,0,6,0,8,0,60,8.571428571428571,4,0.0,1,8,0,6,37,0,0,8,0,15,45,1
2828,25678,8hHM4gMR8PLgcGE0KxgxZ4wD71iRPNWp,RXDvfPUBYFlVdlueBFbLW0mhhAyGEqpt,104,187,69,130,51,0,20,1,458,65.42857142857143,5,0.0,60,69,127,51,127,0,3,20,1,307,151,1
2829,25695,UZwAq0BsEX4YZo6rl8WmMkIdjQj4pFYs,A3fsA9Zfv1X2fVEQhTw51lKENdNrEqT3,2,0,0,0,0,0,2,0,2,0.2857142857142857,1,0.0,0,0,0,0,0,0,0,2,0,0,2,1
2830,25696,Ufo4AkS2vTW82q9Kpcrkrp0gG0Us5zu9,7GRhBDsirIGkRZBtSMEzNTyDr2JQm4xx,11,17,2,0,2,0,4,0,25,3.5714285714285716,2,0.0,0,2,0,2,17,0,0,4,0,4,21,1
2831,25706,udBjfCluZTte9l6GhqqG4v3kEGoKKcxC,SpATywNh6bZuzm8s1ceuBUnMUAeoAHHw,45,143,62,52,17,29,43,3,349,49.857142857142854,10,0.0,63,62,44,17,80,29,8,43,3,186,163,0
2832,25720,v0qndwa3TlbOqgdTUBH2afnl049VDWzU,SpATywNh6bZuzm8s1ceuBUnMUAeoAHHw,60,96,53,44,21,0,24,0,238,34.0,15,0.0,19,53,42,21,77,0,2,24,0,135,103,0
2833,25733,AHQHegrW1VuEGnFOHlvBpkb4mWL3NKW9,SpATywNh6bZuzm8s1ceuBUnMUAeoAHHw,43,217,89,60,25,34,66,4,495,70.71428571428571,9,0.0,45,89,52,25,172,34,8,66,4,211,284,0
2834,25761,Y3GsHv1t2an649bMll1LdxvN2SIICjxG,SpATywNh6bZuzm8s1ceuBUnMUAeoAHHw,7,7,4,0,2,0,4,0,17,2.4285714285714284,4,0.0,0,4,0,2,7,0,0,4,0,6,11,0
2835,25769,YGm3RWWdh53qv43WofC48V9ZiIjgJjMn,5X6FeZozNMgE2VRi3MJYjkkFK8SETtu2,22,121,36,33,48,0,18,0,256,36.57142857142857,7,0.0,45,36,26,48,76,0,7,18,0,155,101,0
2836,25773,xYLJB56SVkFUOdT5vN3Qq6OYNlnP0Fjc,7GRhBDsirIGkRZBtSMEzNTyDr2JQm4xx,50,161,56,46,24,0,15,0,302,43.142857142857146,9,0.0,11,56,38,24,150,0,8,15,0,129,173,1
2837,25804,E7Frt6tr6owhsgLSRkD2PqDaTSKmNLId,7GRhBDsirIGkRZBtSMEzNTyDr2JQm4xx,9,17,6,0,2,0,9,0,34,4.857142857142857,5,0.0,4,6,0,2,13,0,0,9,0,12,22,1
2838,25805,qqSaKArI5Op1lhuHFwwbocKm10S49aF1,SpATywNh6bZuzm8s1ceuBUnMUAeoAHHw,1,0,0,0,0,0,1,0,1,0.14285714285714285,1,0.0,0,0,0,0,0,0,0,1,0,0,1,1
2839,25810,UQiycJIWxo787KsYZuzobncCMSKPzxGe,5X6FeZozNMgE2VRi3MJYjkkFK8SETtu2,1,0,0,0,0,0,1,0,1,0.14285714285714285,1,0.0,0,0,0,0,0,0,0,1,0,0,1,1
2840,25814,XfsOspDiOb9wQgSI2MsAsoTalG7mdDaH,A3fsA9Zfv1X2fVEQhTw51lKENdNrEqT3,28,61,3,0,2,0,19,2,87,12.428571428571429,6,0.0,1,3,0,2,60,0,0,19,2,6,81,1
2841,25816,lMefkcgNh5NMvOXiUOkNuemhw07vFq2i,SpATywNh6bZuzm8s1ceuBUnMUAeoAHHw,46,68,33,30,17,6,17,0,171,24.428571428571427,6,0.0,27,33,28,17,41,6,2,17,0,105,66,0
2842,25817,vgUJoEnyrwMGcP0OV3aAYopOjqSc90Hb,SpATywNh6bZuzm8s1ceuBUnMUAeoAHHw,1,0,0,0,0,0,1,0,1,0.14285714285714285,1,0.0,0,0,0,0,0,0,0,1,0,0,1,1
2843,25821,bGjAPcjyWibYHQ9W6Dqgwo4LQHZPkLcJ,SpATywNh6bZuzm8s1ceuBUnMUAeoAHHw,5,2,1,0,1,0,2,0,6,0.8571428571428571,1,0.0,0,1,0,1,2,0,0,2,0,2,4,0
2844,25826,mLf710wFmDQbZB0X7jv0DPpqMqjMZwPk,SpATywNh6bZuzm8s1ceuBUnMUAeoAHHw,33,59,32,34,16,26,27,6,200,28.571428571428573,3,0.0,12,32,32,16,47,26,2,27,6,92,108,1
2845,25841,2h3ZbyGedZ9L0JEpwRsnOZF5HOvOErqj,bWdj2GDclj5ofokWjzoa5jAwMkxCykd6,17,21,10,6,9,0,3,0,49,7.0,2,0.0,1,10,5,9,20,0,1,3,0,25,24,0
2846,25858,OgzxsS34Z691nR1xoz9Qyc7Bh9Mh9a1o,bWdj2GDclj5ofokWjzoa5jAwMkxCykd6,51,50,17,258,15,2,6,1,349,49.857142857142854,5,0.0,20,17,231,15,30,2,27,6,1,283,66,0
2847,25866,pthM90ZamxN8tQ9QKxTMt4KHsxOLgVEd,SpATywNh6bZuzm8s1ceuBUnMUAeoAHHw,42,43,28,45,16,0,17,0,149,21.285714285714285,4,0.0,6,28,41,16,37,0,4,17,0,91,58,0
2848,25882,N3h2N9w5PnUvhnv2E14KTv0J7vawpbdm,7GRhBDsirIGkRZBtSMEzNTyDr2JQm4xx,1,0,0,0,0,0,1,0,1,0.14285714285714285,1,0.0,0,0,0,0,0,0,0,1,0,0,1,1
2849,25900,NRMzH6tZyLT2qk2QIkwNRbUliCMPz2WK,A3fsA9Zfv1X2fVEQhTw51lKENdNrEqT3,18,15,11,0,9,0,4,0,39,5.571428571428571,3,0.0,0,11,0,9,15,0,0,4,0,20,19,0
2850,25915,iyIAPlnIEma306NSolsaccbjttZIVUuH,SpATywNh6bZuzm8s1ceuBUnMUAeoAHHw,46,58,27,44,12,0,17,0,158,22.571428571428573,8,0.0,22,27,40,12,36,0,4,17,0,101,57,0
2851,25925,C7DPJtUIccHcm7HmAie0ZedGLshK4YlB,5X6FeZozNMgE2VRi3MJYjkkFK8SETtu2,2,0,0,0,0,0,2,0,2,0.2857142857142857,1,0.0,0,0,0,0,0,0,0,2,0,0,2,1
2852,25927,OrVbBbY1FlOrLC1xq9uXlMrFdoBE11eg,SpATywNh6bZuzm8s1ceuBUnMUAeoAHHw,45,60,29,23,14,55,20,5,206,29.428571428571427,6,0.0,15,29,22,14,45,55,1,20,5,80,126,0
2853,25929,4mX2CUhzJC73htcqhEjZH6Xi9XbeT2fH,A3fsA9Zfv1X2fVEQhTw51lKENdNrEqT3,4,2,1,0,1,1,3,0,8,1.1428571428571428,1,0.0,0,1,0,1,2,1,0,3,0,2,6,1
2854,25936,Q0eCH09NIGOawcyrOKgsrxZbMJuOLuiw,A3fsA9Zfv1X2fVEQhTw51lKENdNrEqT3,58,86,41,68,30,0,22,0,247,35.285714285714285,6,0.0,1,41,57,30,85,0,11,22,0,129,118,0
2855,25939,Krxyy23fZ28ymHlUM9cR68oteYOpMEoc,bWdj2GDclj5ofokWjzoa5jAwMkxCykd6,14,35,5,0,3,1,18,2,64,9.142857142857142,4,0.0,11,5,0,3,24,1,0,18,2,19,45,0
2856,25944,Q0eCH09NIGOawcyrOKgsrxZbMJuOLuiw,7GRhBDsirIGkRZBtSMEzNTyDr2JQm4xx,1,0,0,0,0,0,3,0,3,0.42857142857142855,1,0.0,0,0,0,0,0,0,0,3,0,0,3,1
2857,25945,Xl7O5Es6VpkB2PrTgzArkv7OwJ7XzlEg,SpATywNh6bZuzm8s1ceuBUnMUAeoAHHw,53,123,45,49,23,47,34,3,324,46.285714285714285,9,0.0,28,45,44,23,95,47,5,34,3,140,184,0
2858,25951,piSFwoJk8ecTZvpcQFfQWuNzR6UBK2aS,5X6FeZozNMgE2VRi3MJYjkkFK8SETtu2,5,6,0,0,0,1,4,0,11,1.5714285714285714,1,0.0,0,0,0,0,6,1,0,4,0,0,11,1
2859,25956,iHFiZ9SvBVcIu7YGo4eFTUpkfFG44jX7,SpATywNh6bZuzm8s1ceuBUnMUAeoAHHw,24,70,25,17,9,4,33,2,160,22.857142857142858,10,0.0,11,25,14,9,59,4,3,33,2,59,101,0
2860,25959,E31WqWw5nCEWlSKgmhsOSj5j4T79ypCl,7GRhBDsirIGkRZBtSMEzNTyDr2JQm4xx,33,87,39,65,18,0,7,0,216,30.857142857142858,3,0.0,39,39,52,18,48,0,13,7,0,148,68,1
2861,25990,Y5AX6ZQ5Ugwn3sD9xwZmBQdLr2GbgKTx,G8EPVSXsOYB5YQWZGiz1aVq5Pgr2GrQu,10,7,2,6,2,3,7,0,27,3.857142857142857,2,0.0,3,2,5,2,4,3,1,7,0,12,15,1
2862,25993,epAPsdfp9ACpY4GkQi5b2cGQoRKMZ8n2,5X6FeZozNMgE2VRi3MJYjkkFK8SETtu2,2,0,0,0,0,0,2,0,2,0.2857142857142857,1,0.0,0,0,0,0,0,0,0,2,0,0,2,1
2863,25996,SZubyOjBBeLTq3a8W8wnSD4ealAJaYwc,SpATywNh6bZuzm8s1ceuBUnMUAeoAHHw,15,22,2,18,2,1,4,0,49,7.0,2,0.0,11,2,15,2,11,1,3,4,0,30,19,1
2864,26008,HPaJ9EDG8HjC5rpTdpwlfh4gznoH5Kdn,7GRhBDsirIGkRZBtSMEzNTyDr2JQm4xx,5,3,1,0,1,0,6,0,11,1.5714285714285714,1,0.0,0,1,0,1,3,0,0,6,0,2,9,1
2865,26009,RADrfrSrqd2D1lhkJRYdtWMv0TybV2Zk,A3fsA9Zfv1X2fVEQhTw51lKENdNrEqT3,13,15,3,0,3,0,5,0,26,3.7142857142857144,4,0.0,0,3,0,3,15,0,0,5,0,6,20,1
2866,26020,Jag1EXQWfAuTRiCgcVLyhRRkdOL9RtSD,A3fsA9Zfv1X2fVEQhTw51lKENdNrEqT3,93,50,40,58,34,9,22,4,217,31.0,7,0.0,1,40,51,34,49,9,7,22,4,126,91,1
2867,26024,niLMw8MCObO7SSR2V1jNg9WQt5oSjDFJ,7GRhBDsirIGkRZBtSMEzNTyDr2JQm4xx,15,26,10,6,5,1,10,0,58,8.285714285714286,5,0.0,9,10,6,5,17,1,0,10,0,30,28,1
2868,26028,O0GD5bq4HX44FjCMV4VF4e6soOzsH9jU,SpATywNh6bZuzm8s1ceuBUnMUAeoAHHw,13,21,15,0,11,0,5,0,52,7.428571428571429,4,0.0,3,15,0,11,18,0,0,5,0,29,23,0
2869,26045,XDpGoHZOK8VrEEa7PvW4PqKqVXXJAMd4,7GRhBDsirIGkRZBtSMEzNTyDr2JQm4xx,19,22,11,0,10,0,6,0,49,7.0,1,0.0,8,11,0,10,14,0,0,6,0,29,20,1
2870,26064,bmnzCBeFMMY9XczD2LcVJyXeCKQk1fV4,bWdj2GDclj5ofokWjzoa5jAwMkxCykd6,72,51,31,134,11,181,41,6,455,65.0,7,0.0,12,31,120,11,39,181,14,41,6,174,281,0
2871,26078,ByDjTuY0oLVzrle7JgW0XGlu5bLAo5Uj,SpATywNh6bZuzm8s1ceuBUnMUAeoAHHw,45,103,3,54,2,12,24,0,198,28.285714285714285,13,0.0,26,3,48,2,77,12,6,24,0,79,119,0
2872,26095,a8dc0CK321Gme12CyOEdOb6nUx65n0O0,G8EPVSXsOYB5YQWZGiz1aVq5Pgr2GrQu,7,3,1,0,1,1,4,0,10,1.4285714285714286,1,0.0,0,1,0,1,3,1,0,4,0,2,8,1
2873,26096,YCRseUDvArFRrEstKkCnaObaGD8ujRKN,SpATywNh6bZuzm8s1ceuBUnMUAeoAHHw,1,0,0,0,0,0,2,0,2,0.2857142857142857,1,0.0,0,0,0,0,0,0,0,2,0,0,2,1
2874,26109,a8dc0CK321Gme12CyOEdOb6nUx65n0O0,A3fsA9Zfv1X2fVEQhTw51lKENdNrEqT3,6,5,2,0,1,0,2,0,10,1.4285714285714286,1,0.0,0,2,0,1,5,0,0,2,0,3,7,1
2875,26113,urk9rrR5tBeZ6421Kpoux7grZg4UgaZm,SpATywNh6bZuzm8s1ceuBUnMUAeoAHHw,1,0,0,0,0,0,1,0,1,0.14285714285714285,1,0.0,0,0,0,0,0,0,0,1,0,0,1,1
2876,26118,BoHg0aGtLUBHCRED1C89CbXgNAVI0w1o,7GRhBDsirIGkRZBtSMEzNTyDr2JQm4xx,7,5,1,0,0,0,4,0,10,1.4285714285714286,1,0.0,0,1,0,0,5,0,0,4,0,1,9,1
2877,26131,bOZulvf2pZbiVc3YTWa6AH2rsP2ovTUK,5X6FeZozNMgE2VRi3MJYjkkFK8SETtu2,22,81,6,31,35,0,1,0,154,22.0,7,0.0,65,6,26,35,16,0,5,1,0,132,22,1
2878,26149,uBTGUyw0foT4aMjENrCp1a840IjnLELO,SpATywNh6bZuzm8s1ceuBUnMUAeoAHHw,29,38,23,39,0,7,10,1,118,16.857142857142858,5,0.0,11,23,32,0,27,7,7,10,1,66,52,0
2879,26151,fZNr9qlThHhgXbezYnWjuEvl2yTJxr3j,SpATywNh6bZuzm8s1ceuBUnMUAeoAHHw,4,2,1,0,1,0,2,0,6,0.8571428571428571,1,0.0,0,1,0,1,2,0,0,2,0,2,4,1
2880,26152,xfB7JXhtbd9UDGft4eYtRwZAYUFQa2nu,SpATywNh6bZuzm8s1ceuBUnMUAeoAHHw,31,42,19,23,9,12,11,2,118,16.857142857142858,3,0.0,15,19,21,9,27,12,2,11,2,64,54,0
2881,26153,WDOhUt18DNMCYDEG35QkOfLroSJB0yOR,7GRhBDsirIGkRZBtSMEzNTyDr2JQm4xx,31,43,11,78,7,2,10,0,151,21.571428571428573,4,0.0,30,11,66,7,13,2,12,10,0,114,37,0
2882,26171,aAcGelZbAzE1VNtMYp15u6evXjd8L864,A3fsA9Zfv1X2fVEQhTw51lKENdNrEqT3,12,8,1,0,1,2,11,1,24,3.4285714285714284,2,0.0,0,1,0,1,8,2,0,11,1,2,22,1
2883,26176,c632QS0HPEwiPyoLxgHwOrVRerl5QVSU,SpATywNh6bZuzm8s1ceuBUnMUAeoAHHw,12,6,6,0,6,0,8,0,26,3.7142857142857144,2,0.0,0,6,0,6,6,0,0,8,0,12,14,1
2884,26177,h8RigcaknBAbfxFRHBW4VasAGH2IDwWq,SpATywNh6bZuzm8s1ceuBUnMUAeoAHHw,1,0,0,0,0,0,2,0,2,0.2857142857142857,1,0.0,0,0,0,0,0,0,0,2,0,0,2,1
2885,26189,h8RigcaknBAbfxFRHBW4VasAGH2IDwWq,A3fsA9Zfv1X2fVEQhTw51lKENdNrEqT3,5,2,1,0,1,0,2,0,6,0.8571428571428571,1,0.0,0,1,0,1,2,0,0,2,0,2,4,1
2886,26196,Pp6wRQkPti9Bk2fBcpI0VrxeT3AtZv4c,bWdj2GDclj5ofokWjzoa5jAwMkxCykd6,1,0,0,0,0,0,1,0,1,0.14285714285714285,1,0.0,0,0,0,0,0,0,0,1,0,0,1,1
2887,26200,9KmImulU8dfYAWqjxKwNzHRnkRXTnV2z,A3fsA9Zfv1X2fVEQhTw51lKENdNrEqT3,1,0,0,0,0,0,1,0,1,0.14285714285714285,1,0.0,0,0,0,0,0,0,0,1,0,0,1,1
2888,26201,dQeQGMqD2AfjLt9WMqT1wjR4i8srmTVY,SpATywNh6bZuzm8s1ceuBUnMUAeoAHHw,16,18,11,2,5,1,2,0,39,5.571428571428571,3,0.0,5,11,2,5,13,1,0,2,0,23,16,0
2889,26202,9KmImulU8dfYAWqjxKwNzHRnkRXTnV2z,bWdj2GDclj5ofokWjzoa5jAwMkxCykd6,1,0,0,0,0,0,1,0,1,0.14285714285714285,1,0.0,0,0,0,0,0,0,0,1,0,0,1,1
2890,26214,SB3PBvXY4EEkcNDmtIOX6bpu8RFJOU8W,G8EPVSXsOYB5YQWZGiz1aVq5Pgr2GrQu,40,66,22,65,0,12,10,2,177,25.285714285714285,6,0.0,37,22,43,0,29,12,22,10,2,102,75,1
2891,26225,mXG0NG89PIYgsz8VTv4xH5Wr0KVwE4Z5,G8EPVSXsOYB5YQWZGiz1aVq5Pgr2GrQu,26,36,0,50,0,12,15,9,122,17.428571428571427,1,0.0,19,0,36,0,17,12,14,15,9,55,67,1
2892,26240,2EOw8IdpJR7gJqo77SwHRhwFw89UUu0T,7GRhBDsirIGkRZBtSMEzNTyDr2JQm4xx,1,0,0,0,0,0,1,0,1,0.14285714285714285,1,0.0,0,0,0,0,0,0,0,1,0,0,1,1
2893,26244,2EOw8IdpJR7gJqo77SwHRhwFw89UUu0T,RXDvfPUBYFlVdlueBFbLW0mhhAyGEqpt,1,0,0,0,0,0,1,0,1,0.14285714285714285,1,0.0,0,0,0,0,0,0,0,1,0,0,1,1
2894,26245,SrYdmWsdLgR34Xuoeb5msz3OavGm9rEt,SpATywNh6bZuzm8s1ceuBUnMUAeoAHHw,32,53,24,0,13,0,12,0,102,14.571428571428571,5,0.0,19,24,0,13,34,0,0,12,0,56,46,0
2895,26266,x0laSvoDXG0a7WULReVXZ8zh05t91jGU,5X6FeZozNMgE2VRi3MJYjkkFK8SETtu2,93,293,127,2,152,0,42,0,616,88.0,5,0.0,114,127,2,152,179,0,0,42,0,395,221,0
2896,26268,tynbQ4TjTy74SqA5UqLPd55W0CYMmxkv,bWdj2GDclj5ofokWjzoa5jAwMkxCykd6,58,107,56,242,19,74,38,4,540,77.14285714285714,10,0.0,27,56,203,19,80,74,39,38,4,305,235,0
2897,26269,yQYMLm30GwIRmqXNc4Jn3nUgA6vXILUA,SpATywNh6bZuzm8s1ceuBUnMUAeoAHHw,18,13,0,31,0,15,26,3,88,12.571428571428571,2,0.0,6,0,26,0,7,15,5,26,3,32,56,1
2898,26275,PSNpE96w64UzqJ7izDn4zKyoyc3uU8P4,SpATywNh6bZuzm8s1ceuBUnMUAeoAHHw,49,98,57,39,26,17,27,5,269,38.42857142857143,10,0.0,10,57,33,26,88,17,6,27,5,126,143,0
2899,26300,skOScgcMIkYsPXikHjLqvicjdb3rv6St,G8EPVSXsOYB5YQWZGiz1aVq5Pgr2GrQu,16,28,10,33,5,1,14,0,91,13.0,3,0.0,3,10,27,5,25,1,6,14,0,45,46,1
2900,26313,2GvmVu0Ap1CyxuPiFvFTtv7YJJqNkAe0,5X6FeZozNMgE2VRi3MJYjkkFK8SETtu2,12,15,2,20,4,0,3,0,44,6.285714285714286,1,0.0,7,2,15,4,8,0,5,3,0,28,16,1
2901,26317,Ke04PwAVtaYumEPrCNIyUmIZgpnMElWJ,SpATywNh6bZuzm8s1ceuBUnMUAeoAHHw,24,50,30,13,11,0,9,0,113,16.142857142857142,6,0.0,2,30,12,11,48,0,1,9,0,55,58,1
2902,26327,WXFtCer94iMbYlxH69t15Pw03EngjneX,7GRhBDsirIGkRZBtSMEzNTyDr2JQm4xx,5,3,1,0,0,0,4,0,8,1.1428571428571428,2,0.0,0,1,0,0,3,0,0,4,0,1,7,1
2903,26328,XkJ6yDVwDuqxrBS1qaJeiIQkhGh99YN5,SpATywNh6bZuzm8s1ceuBUnMUAeoAHHw,62,66,38,37,25,9,14,5,194,27.714285714285715,5,0.0,9,38,32,25,57,9,5,14,5,104,90,0
2904,26331,4iOUNXqQpqxIlccZB4bn3VqeRpS9Wajj,SpATywNh6bZuzm8s1ceuBUnMUAeoAHHw,31,24,12,23,8,2,5,1,75,10.714285714285714,1,0.0,10,12,22,8,14,2,1,5,1,52,23,0
2905,26340,nLSyDmuwtZ9VcSdeL7kW6FG97w0wmm94,SpATywNh6bZuzm8s1ceuBUnMUAeoAHHw,51,84,43,43,18,5,15,0,208,29.714285714285715,9,0.0,25,43,38,18,59,5,5,15,0,124,84,0
2906,26353,EHRxEuwJ6W1Usro8hvBy0CGhrazjH6cO,SpATywNh6bZuzm8s1ceuBUnMUAeoAHHw,24,32,24,0,16,0,5,0,77,11.0,6,0.0,0,24,0,16,32,0,0,5,0,40,37,0
2907,26356,DRiuKqDradfNPZFfU0uOeVbFklDHBL0k,SpATywNh6bZuzm8s1ceuBUnMUAeoAHHw,12,11,9,4,0,0,3,0,27,3.857142857142857,1,0.0,0,9,4,0,11,0,0,3,0,13,14,1
2908,26357,BNkiF9A7J88AJfBxuk7BTxSVookFJYSj,SpATywNh6bZuzm8s1ceuBUnMUAeoAHHw,37,62,2,45,0,53,37,4,203,29.0,8,0.0,9,2,40,0,53,53,5,37,4,51,152,0
2909,26378,2GvmVu0Ap1CyxuPiFvFTtv7YJJqNkAe0,G8EPVSXsOYB5YQWZGiz1aVq5Pgr2GrQu,37,48,10,78,7,1,9,1,154,22.0,2,0.0,25,10,57,7,23,1,21,9,1,99,55,0
2910,26390,4BpRE14XuCFERPNFltqE4ojcMHw6pKyT,SpATywNh6bZuzm8s1ceuBUnMUAeoAHHw,22,38,23,10,12,0,7,0,90,12.857142857142858,4,0.0,7,23,9,12,31,0,1,7,0,51,39,0
2911,26395,xjWkEdO0xALsCMyXVJLQ76Q1mnSHD20m,A3fsA9Zfv1X2fVEQhTw51lKENdNrEqT3,9,19,5,0,3,2,7,0,36,5.142857142857143,1,0.0,0,5,0,3,19,2,0,7,0,8,28,1
2912,26398,x4ez09GGWUnioTSf6qckx5goNY5giLKq,7GRhBDsirIGkRZBtSMEzNTyDr2JQm4xx,68,147,58,211,28,15,32,1,492,70.28571428571429,10,0.0,67,58,188,28,80,15,23,32,1,341,151,0
2913,26399,Ke04PwAVtaYumEPrCNIyUmIZgpnMElWJ,A3fsA9Zfv1X2fVEQhTw51lKENdNrEqT3,14,14,8,14,3,0,8,0,47,6.714285714285714,5,0.0,1,8,14,3,13,0,0,8,0,26,21,1
2914,26400,CHqrwi1Tduj0lJDshmIQF8r1aAWdEqsJ,G8EPVSXsOYB5YQWZGiz1aVq5Pgr2GrQu,16,10,7,0,4,13,8,1,43,6.142857142857143,1,0.0,0,7,0,4,10,13,0,8,1,11,32,0
2915,26417,aX9OEOkANl9FOLFcrZhGuiWv5CPITev8,SpATywNh6bZuzm8s1ceuBUnMUAeoAHHw,5,3,2,0,0,0,2,0,7,1.0,1,0.0,0,2,0,0,3,0,0,2,0,2,5,1
2916,26424,jDvQIlE5Sz6V9SpiJ3fC38kGJJ76UIjp,7GRhBDsirIGkRZBtSMEzNTyDr2JQm4xx,8,3,1,0,1,1,8,0,14,2.0,1,0.0,0,1,0,1,3,1,0,8,0,2,12,1
2917,26430,LqtuGUVCKWBEA86X4uy5b4ZjnXPoVVJt,SpATywNh6bZuzm8s1ceuBUnMUAeoAHHw,34,53,3,40,1,4,9,0,110,15.714285714285714,5,0.0,21,3,35,1,32,4,5,9,0,60,50,0
2918,26436,J7iejq5NtsfdHjPTK3MrPhGPRoJN9WrB,A3fsA9Zfv1X2fVEQhTw51lKENdNrEqT3,56,37,26,84,15,2,16,1,181,25.857142857142858,6,0.0,3,26,81,15,34,2,3,16,1,125,56,0
2919,26453,qIRkU6GTErqHGiePGqqQmQyg81Pc8mmk,SpATywNh6bZuzm8s1ceuBUnMUAeoAHHw,28,33,24,10,11,14,11,1,104,14.857142857142858,3,0.0,0,24,9,11,33,14,1,11,1,44,60,1
2920,26455,FGhnta6Ir68eirXd6aZPRoCB1VjhQYy9,A3fsA9Zfv1X2fVEQhTw51lKENdNrEqT3,11,14,7,0,3,0,7,1,32,4.571428571428571,4,0.0,0,7,0,3,14,0,0,7,1,10,22,0
2921,26460,oNf6qoW6E6dhoPJKSUjvElFlUKN9drLY,SpATywNh6bZuzm8s1ceuBUnMUAeoAHHw,27,50,24,12,14,1,11,0,112,16.0,4,0.0,20,24,12,14,30,1,0,11,0,70,42,0
2922,26462,ZiYqSodBOSGv7K3d6XHhuzqRLmTlxa2q,SpATywNh6bZuzm8s1ceuBUnMUAeoAHHw,18,43,1,14,1,6,8,1,74,10.571428571428571,2,0.0,21,1,13,1,22,6,1,8,1,36,38,1
2923,26464,xioMf6frC9P8sc1cIrYLanKwZwDuxRiz,G8EPVSXsOYB5YQWZGiz1aVq5Pgr2GrQu,213,151,65,494,54,4,35,2,805,115.0,9,0.0,73,65,396,54,78,4,98,35,2,588,217,0
2924,26483,m81Dm6IMFFSE5H719VhdhHcKd9mbfbqm,A3fsA9Zfv1X2fVEQhTw51lKENdNrEqT3,6,11,5,0,1,0,1,0,18,2.5714285714285716,1,0.0,0,5,0,1,11,0,0,1,0,6,12,1
2925,26489,PD0QXI0Ip2PVwJ6kJaKkkINkj7BvGZMC,SpATywNh6bZuzm8s1ceuBUnMUAeoAHHw,34,68,0,44,0,15,27,1,155,22.142857142857142,5,0.0,12,0,37,0,56,15,7,27,1,49,106,0
2926,26497,lHqsd1041AF6CV0C0CnR0FxJTQGWXgTK,SpATywNh6bZuzm8s1ceuBUnMUAeoAHHw,17,22,2,17,3,27,6,0,77,11.0,4,0.0,6,2,15,3,16,27,2,6,0,26,51,1
2927,26500,0jMOLkd6bX5LTqVnq5W50RF0alCjmWfd,SpATywNh6bZuzm8s1ceuBUnMUAeoAHHw,29,42,2,32,0,0,4,0,80,11.428571428571429,3,0.0,15,2,29,0,27,0,3,4,0,46,34,0
2928,26503,xUMqOX7y0bZjdauks6ek26j7lwAW76BX,SpATywNh6bZuzm8s1ceuBUnMUAeoAHHw,5,2,1,0,1,0,2,0,6,0.8571428571428571,1,0.0,0,1,0,1,2,0,0,2,0,2,4,1
2929,26514,IJmtizRHLdF3WotHNxwRcdFjzienWtJz,bWdj2GDclj5ofokWjzoa5jAwMkxCykd6,12,21,12,8,4,0,12,1,58,8.285714285714286,4,0.0,4,12,8,4,17,0,0,12,1,28,30,1
2930,26520,fmqTcfWsPpHbIOnWwE9AtT4PG5wWA4CX,5X6FeZozNMgE2VRi3MJYjkkFK8SETtu2,5,2,1,0,1,3,2,0,9,1.2857142857142858,1,0.0,0,1,0,1,2,3,0,2,0,2,7,1
2931,26522,o1ILwYzfDxF68D6Q3HsUqOMp8hVHeeWy,G8EPVSXsOYB5YQWZGiz1aVq5Pgr2GrQu,14,15,0,0,0,0,4,0,19,2.7142857142857144,1,0.0,0,0,0,0,15,0,0,4,0,0,19,1
2932,26528,CiVcRubRqdt8MrzyUg75lzZmUZcaVQVo,SpATywNh6bZuzm8s1ceuBUnMUAeoAHHw,29,53,27,22,9,0,13,0,124,17.714285714285715,7,0.0,7,27,20,9,46,0,2,13,0,63,61,0
2933,26561,kg6Avyi36lrn1xiUPv7mqR2okQaeNtUx,7GRhBDsirIGkRZBtSMEzNTyDr2JQm4xx,5,5,4,0,3,0,1,0,13,1.8571428571428572,1,0.0,0,4,0,3,5,0,0,1,0,7,6,1
2934,26570,yYrk7RmkclaZIv32ppfmidCUMKYlGdCg,bWdj2GDclj5ofokWjzoa5jAwMkxCykd6,10,15,8,30,4,0,2,0,59,8.428571428571429,3,0.0,2,8,28,4,13,0,2,2,0,42,17,1
2935,26572,h5vEAVTb94xGNGjpn4Ohi5mNcXfM0rMl,SpATywNh6bZuzm8s1ceuBUnMUAeoAHHw,25,49,11,5,6,0,33,0,104,14.857142857142858,9,0.0,0,11,4,6,49,0,1,33,0,21,83,0
2936,26574,kSTg1JLYdhltSJsPuKhUcTkKXIqnVUW2,SpATywNh6bZuzm8s1ceuBUnMUAeoAHHw,29,79,4,23,2,15,26,2,151,21.571428571428573,5,0.0,6,4,21,2,73,15,2,26,2,33,118,1
2937,26579,grJA0XKLUFzvkeUjFTmxhojWDdf12W8r,SpATywNh6bZuzm8s1ceuBUnMUAeoAHHw,7,8,3,0,1,0,3,0,15,2.142857142857143,2,0.0,0,3,0,1,8,0,0,3,0,4,11,1
2938,26590,5pjAdY5K4FfgQPLSzQKwXaKF78ph9a0y,bWdj2GDclj5ofokWjzoa5jAwMkxCykd6,29,32,16,68,4,0,21,1,142,20.285714285714285,8,0.0,4,16,63,4,28,0,5,21,1,87,55,0
2939,26610,xzPjA6KrslcE6S6chFTjdwgsvoAelzjQ,G8EPVSXsOYB5YQWZGiz1aVq5Pgr2GrQu,104,103,33,182,20,3,22,1,364,52.0,9,0.0,57,33,120,20,46,3,62,22,1,230,134,0
2940,26614,CCWe4mJj2KV2ATVT9hkI2qJwZfZ9NcW7,SpATywNh6bZuzm8s1ceuBUnMUAeoAHHw,8,21,13,0,0,0,8,0,42,6.0,1,0.0,4,13,0,0,17,0,0,8,0,17,25,1
2941,26617,KPcfuz5VL4gtxrf9oXg3NuCUgo5lfp0J,A3fsA9Zfv1X2fVEQhTw51lKENdNrEqT3,34,24,3,46,2,1,20,3,99,14.142857142857142,4,0.0,0,3,37,2,24,1,9,20,3,42,57,0
2942,26621,COXHYWB9V3DjwUp5GnfoAY9hBjOExGO8,G8EPVSXsOYB5YQWZGiz1aVq5Pgr2GrQu,6,2,1,0,1,0,3,0,7,1.0,1,0.0,0,1,0,1,2,0,0,3,0,2,5,1
2943,26624,bwFkbWIAdNVUMLQhE1w1MjvyFVabaAgW,SpATywNh6bZuzm8s1ceuBUnMUAeoAHHw,34,38,21,20,12,1,15,1,108,15.428571428571429,8,0.0,7,21,16,12,31,1,4,15,1,56,52,0
2944,26634,rrQbAPV4QBpP2BW10bzZtz96beXLch00,SpATywNh6bZuzm8s1ceuBUnMUAeoAHHw,36,46,31,30,21,17,13,0,158,22.571428571428573,6,0.0,8,31,26,21,38,17,4,13,0,86,72,1
2945,26640,RbUxQb46RHLKt8MRdcRI6KFNQeGEWd4E,7GRhBDsirIGkRZBtSMEzNTyDr2JQm4xx,52,139,57,54,24,23,28,3,328,46.857142857142854,10,0.0,67,57,47,24,72,23,7,28,3,195,133,1
2946,26655,hkI32MAgHvJ4T3I3Up79daEJ8l4sKHaC,7GRhBDsirIGkRZBtSMEzNTyDr2JQm4xx,7,4,2,2,2,0,1,0,11,1.5714285714285714,1,0.0,1,2,2,2,3,0,0,1,0,7,4,1
2947,26657,KPcfuz5VL4gtxrf9oXg3NuCUgo5lfp0J,7GRhBDsirIGkRZBtSMEzNTyDr2JQm4xx,16,26,3,19,0,1,9,1,59,8.428571428571429,3,0.0,8,3,18,0,18,1,1,9,1,29,30,1
2948,26671,FhVGWSUXUeZGSguiLBd186fsM4sRhpPL,SpATywNh6bZuzm8s1ceuBUnMUAeoAHHw,15,28,1,6,1,0,3,0,39,5.571428571428571,2,0.0,13,1,6,1,15,0,0,3,0,21,18,0
2949,26672,XN0YlXkOOCzzQkjkPHbmHYzBt2kMHbPM,G8EPVSXsOYB5YQWZGiz1aVq5Pgr2GrQu,25,51,3,10,3,0,12,0,79,11.285714285714286,4,0.0,6,3,6,3,45,0,4,12,0,18,61,0
2950,26693,HAPPxnLUjIhcauBZnnWBFk3JE6gETTxa,A3fsA9Zfv1X2fVEQhTw51lKENdNrEqT3,21,19,13,0,11,0,3,0,46,6.571428571428571,2,0.0,4,13,0,11,15,0,0,3,0,28,18,1
2951,26705,H612SWXqaaqbDXYCaqpzqRBY7ahAYnN1,bWdj2GDclj5ofokWjzoa5jAwMkxCykd6,5,8,3,0,2,0,2,0,15,2.142857142857143,1,0.0,3,3,0,2,5,0,0,2,0,8,7,1
2952,26720,DsLjooCLnfZ8B5pzT2arifZ6SOAto1Wc,SpATywNh6bZuzm8s1ceuBUnMUAeoAHHw,9,8,5,0,4,0,4,1,22,3.142857142857143,2,0.0,0,5,0,4,8,0,0,4,1,9,13,1
2953,26738,0eze39ft8OIE7NpGiB8mBqdD6OezSRFT,SpATywNh6bZuzm8s1ceuBUnMUAeoAHHw,47,50,30,22,17,0,8,0,127,18.142857142857142,5,0.0,9,30,22,17,41,0,0,8,0,78,49,0
2954,26750,7J9JIWVCQG1g6yXh3uTVbrSu3pa18Ezn,A3fsA9Zfv1X2fVEQhTw51lKENdNrEqT3,14,8,6,0,4,11,9,0,38,5.428571428571429,2,0.0,0,6,0,4,8,11,0,9,0,10,28,1
2955,26754,GLksmLIo4jY0swb77XkCz4Oz6WJw9kTq,bWdj2GDclj5ofokWjzoa5jAwMkxCykd6,10,13,4,42,4,0,3,0,66,9.428571428571429,2,0.0,5,4,40,4,8,0,2,3,0,53,13,1
2956,26763,6gAyvwJKSeHOrljTS7vTc1U71cPBh7nb,RXDvfPUBYFlVdlueBFbLW0mhhAyGEqpt,63,95,14,116,8,0,11,0,244,34.857142857142854,7,0.0,18,14,107,8,77,0,9,11,0,147,97,0
2957,26770,H7bZ54NuzkB5Nw5q0ZI1nld9qDoHNngL,7GRhBDsirIGkRZBtSMEzNTyDr2JQm4xx,6,5,3,0,0,0,4,0,12,1.7142857142857142,3,0.0,0,3,0,0,5,0,0,4,0,3,9,1
2958,26774,HQOz3dJ2hZ8qbl5l8pp7OKuPIeM9Xh55,G8EPVSXsOYB5YQWZGiz1aVq5Pgr2GrQu,38,66,38,56,15,6,15,4,200,28.571428571428573,3,0.0,19,38,43,15,47,6,13,15,4,115,85,0
2959,26779,vpU7efTPBzR1K6YbX3K8cMsGU56WLfGi,A3fsA9Zfv1X2fVEQhTw51lKENdNrEqT3,9,6,3,0,2,0,10,1,22,3.142857142857143,2,0.0,0,3,0,2,6,0,0,10,1,5,17,0
2960,26785,2A79ZgD8yfQPkgbkUr6CFN0mSZV4jc5i,A3fsA9Zfv1X2fVEQhTw51lKENdNrEqT3,4,0,0,0,0,1,4,0,5,0.7142857142857143,1,0.0,0,0,0,0,0,1,0,4,0,0,5,0
2961,26801,q2xQCstASp96wpspi8iqsuaqJ7gzfsux,SpATywNh6bZuzm8s1ceuBUnMUAeoAHHw,36,48,29,35,5,0,11,0,128,18.285714285714285,8,0.0,8,29,28,5,40,0,7,11,0,70,58,0
2962,26805,2RXgNe8oBg9c7SnCiZRXpxd4LaqyoUL3,bWdj2GDclj5ofokWjzoa5jAwMkxCykd6,9,9,3,0,4,0,4,0,20,2.857142857142857,2,0.0,0,3,0,4,9,0,0,4,0,7,13,1
2963,26811,S4x7F2zwGMymIPjPy7YGoWTUwlKzmNvg,SpATywNh6bZuzm8s1ceuBUnMUAeoAHHw,30,56,16,64,2,7,24,3,172,24.571428571428573,6,0.0,30,16,52,2,26,7,12,24,3,100,72,0
2964,26812,8b4CSrjMjmc5Jmqnv833uCnAad4TIcFZ,A3fsA9Zfv1X2fVEQhTw51lKENdNrEqT3,45,29,18,92,16,3,8,0,166,23.714285714285715,4,0.0,2,18,78,16,27,3,14,8,0,114,52,0
2965,26814,6ukzVV282fPHH5seR4Ah1PDJIZzJboQW,A3fsA9Zfv1X2fVEQhTw51lKENdNrEqT3,1,0,0,0,0,0,1,0,1,0.14285714285714285,1,0.0,0,0,0,0,0,0,0,1,0,0,1,1
2966,26816,HCwyZ32TalGxA6ZNHNOB04su4fWSeWBj,A3fsA9Zfv1X2fVEQhTw51lKENdNrEqT3,111,63,39,209,9,2,17,1,340,48.57142857142857,10,0.0,8,39,209,9,55,2,0,17,1,265,75,0
2967,26823,oidXTGaCUuuF1QPNvhmiPoqhWsTY245r,7GRhBDsirIGkRZBtSMEzNTyDr2JQm4xx,19,21,12,0,7,0,4,0,44,6.285714285714286,4,0.0,3,12,0,7,18,0,0,4,0,22,22,1
2968,26832,8zuZeBODltlYx6gcd6dPnNXLDXb8sH6b,SpATywNh6bZuzm8s1ceuBUnMUAeoAHHw,8,17,11,0,6,0,7,0,41,5.857142857142857,2,0.0,0,11,0,6,17,0,0,7,0,17,24,1
2969,26863,erDgXJOtYMWq3DbmDGyxl8sIhvZ9oKFE,SpATywNh6bZuzm8s1ceuBUnMUAeoAHHw,43,91,31,53,18,13,29,2,237,33.857142857142854,11,0.0,10,31,44,18,81,13,9,29,2,103,134,0
2970,26866,VA4ZWPYSTKAyC6xy9lfw5QHXGDYHdJGL,SpATywNh6bZuzm8s1ceuBUnMUAeoAHHw,42,50,33,34,21,1,6,0,145,20.714285714285715,3,0.0,12,33,30,21,38,1,4,6,0,96,49,1
2971,26877,nE23LYiQpabdXkj6YvKSja9sZnHRizmo,bWdj2GDclj5ofokWjzoa5jAwMkxCykd6,7,28,3,0,0,10,8,0,49,7.0,15,0.0,0,3,0,0,28,10,0,8,0,3,46,0
2972,26880,nE23LYiQpabdXkj6YvKSja9sZnHRizmo,5X6FeZozNMgE2VRi3MJYjkkFK8SETtu2,6,21,2,0,3,0,5,0,31,4.428571428571429,16,0.0,2,2,0,3,19,0,0,5,0,7,24,1
2973,26890,cZ2BWDXabTqNlcMYMUyoF2xlKnCvzMeJ,bWdj2GDclj5ofokWjzoa5jAwMkxCykd6,1,0,0,0,0,0,2,0,2,0.2857142857142857,1,0.0,0,0,0,0,0,0,0,2,0,0,2,1
2974,26902,wlMzjZIA65JiQ9JE1VQhTzG17NZZPeo3,SpATywNh6bZuzm8s1ceuBUnMUAeoAHHw,57,337,87,91,35,121,150,5,826,118.0,24,0.0,70,87,76,35,267,121,15,150,5,268,558,0
2975,26903,1YVr5Tebgu8QXWBg3164QQg1YdmUcYYo,7GRhBDsirIGkRZBtSMEzNTyDr2JQm4xx,6,12,3,0,1,2,7,0,25,3.5714285714285716,2,0.0,0,3,0,1,12,2,0,7,0,4,21,1
2976,26907,sTDzO3bjgLIIYNoWgHN2HiaPZw68DTyo,7GRhBDsirIGkRZBtSMEzNTyDr2JQm4xx,8,12,5,0,3,1,7,1,29,4.142857142857143,5,0.0,0,5,0,3,12,1,0,7,1,8,21,0
2977,26928,0eeJP6MiDq1cOnP8cGxNMZEXCvgY0tHY,SpATywNh6bZuzm8s1ceuBUnMUAeoAHHw,19,45,14,18,4,1,4,0,86,12.285714285714286,4,0.0,13,14,15,4,32,1,3,4,0,46,40,0
2978,26931,luNGlNTmJ26UVXohAPNf4yZNgIUDcpxK,SpATywNh6bZuzm8s1ceuBUnMUAeoAHHw,43,56,39,2,22,0,18,0,137,19.571428571428573,13,0.0,1,39,2,22,55,0,0,18,0,64,73,0
2979,26940,EQUZwbG72sVIvQVavXNV7pB9UhkYp9aI,SpATywNh6bZuzm8s1ceuBUnMUAeoAHHw,48,65,31,46,13,85,19,5,264,37.714285714285715,4,0.0,23,31,38,13,42,85,8,19,5,105,159,0
2980,26955,V44Q36yyz0HxZhlrCwrLJjYwv8UzqoCn,A3fsA9Zfv1X2fVEQhTw51lKENdNrEqT3,12,25,10,0,2,0,9,0,46,6.571428571428571,6,0.0,0,10,0,2,25,0,0,9,0,12,34,1
2981,26958,d4EaPE0gMoqaRMtJCkrszQ76BkvS719C,SpATywNh6bZuzm8s1ceuBUnMUAeoAHHw,4,3,2,0,0,0,2,0,7,1.0,1,0.0,0,2,0,0,3,0,0,2,0,2,5,1
2982,26967,GXmApUIE1IechykqO3xyhcbVn1kfVOsr,SpATywNh6bZuzm8s1ceuBUnMUAeoAHHw,15,14,5,10,4,0,4,0,37,5.285714285714286,2,0.0,2,5,8,4,12,0,2,4,0,19,18,0
2983,26994,y2Imh6d65IyLlUtE9DWkdIauRQxTWtdJ,A3fsA9Zfv1X2fVEQhTw51lKENdNrEqT3,70,57,47,0,36,7,23,0,170,24.285714285714285,4,0.0,0,47,0,36,57,7,0,23,0,83,87,0
2984,27013,eA8qPXDg9mAIRhOgZfPGHskw4HtvZE6Q,SpATywNh6bZuzm8s1ceuBUnMUAeoAHHw,46,67,16,51,12,0,11,1,158,22.571428571428573,7,0.0,23,16,44,12,44,0,7,11,1,95,63,0
2985,27019,CIg0k418cM4NKEJ0IrZ66fdZQiBikcx7,G8EPVSXsOYB5YQWZGiz1aVq5Pgr2GrQu,108,62,29,278,8,13,22,2,414,59.142857142857146,8,0.0,14,29,234,8,48,13,44,22,2,285,129,0
2986,27023,FfwX3K5MhBvPJhxnz8s2MdrQvGuLPTtm,5X6FeZozNMgE2VRi3MJYjkkFK8SETtu2,1,0,0,0,0,0,1,0,1,0.14285714285714285,1,0.0,0,0,0,0,0,0,0,1,0,0,1,1
2987,27026,tLtF2xuv7ODjuOISevnoALqvBz99SIrS,SpATywNh6bZuzm8s1ceuBUnMUAeoAHHw,1,0,0,0,0,2,0,0,2,0.2857142857142857,1,0.0,0,0,0,0,0,2,0,0,0,0,2,1
2988,27034,m7QOSCdmTCzPuCv2XL75peqogyn8U25P,bWdj2GDclj5ofokWjzoa5jAwMkxCykd6,9,6,4,0,4,0,2,0,16,2.2857142857142856,1,0.0,0,4,0,4,6,0,0,2,0,8,8,0
2989,27052,LXvLrceHjGVikX2xowdQrgQUDs2YwMQl,SpATywNh6bZuzm8s1ceuBUnMUAeoAHHw,23,20,1,9,1,0,4,0,35,5.0,2,0.0,2,1,9,1,18,0,0,4,0,13,22,1
2990,27061,FR9oYWe14a3wuL1JJGpMLqnxF1jpkbep,SpATywNh6bZuzm8s1ceuBUnMUAeoAHHw,27,33,4,30,4,3,8,0,82,11.714285714285714,2,0.0,8,4,28,4,25,3,2,8,0,44,38,0
2991,27071,SU4JPqAVSnudVJ4UntK2sIqFBtfi7ORe,SpATywNh6bZuzm8s1ceuBUnMUAeoAHHw,4,2,0,0,0,0,3,0,5,0.7142857142857143,1,0.0,1,0,0,0,1,0,0,3,0,1,4,1
2992,27085,Y1uVq657IWCue4abNsh62IVHKtmwsQHQ,SpATywNh6bZuzm8s1ceuBUnMUAeoAHHw,30,45,28,12,10,3,16,2,116,16.571428571428573,5,0.0,6,28,12,10,39,3,0,16,2,56,60,0
2993,27087,1sf1a7OMEvwky5hvLFD12TaOsmoNw2Qb,G8EPVSXsOYB5YQWZGiz1aVq5Pgr2GrQu,54,95,44,176,16,0,15,0,346,49.42857142857143,9,0.0,12,44,148,16,83,0,28,15,0,220,126,0
2994,27094,wamlK8Nx9pa9kXzI19EF5HF3fhJv3sWN,RXDvfPUBYFlVdlueBFbLW0mhhAyGEqpt,2,0,0,0,0,0,3,0,3,0.42857142857142855,1,0.0,0,0,0,0,0,0,0,3,0,0,3,1
2995,27102,HLBZIULiiVTAwZuuOocZdXTuqOHNTspY,SpATywNh6bZuzm8s1ceuBUnMUAeoAHHw,1,0,0,0,0,0,1,0,1,0.14285714285714285,1,0.0,0,0,0,0,0,0,0,1,0,0,1,1
2996,27109,xXksY261TKqU0nrp5V4CHzJJu11xSD4U,bWdj2GDclj5ofokWjzoa5jAwMkxCykd6,1,0,0,0,0,0,1,0,1,0.14285714285714285,1,0.0,0,0,0,0,0,0,0,1,0,0,1,1
2997,27114,aI6LGLI5TSvCsqcL1v38BDwXz2AdVe9U,7GRhBDsirIGkRZBtSMEzNTyDr2JQm4xx,1,0,0,0,0,0,1,0,1,0.14285714285714285,1,0.0,0,0,0,0,0,0,0,1,0,0,1,1
2998,27123,ZSKBKnD8wfegggUigWIwrMo7a1rGr9YG,5X6FeZozNMgE2VRi3MJYjkkFK8SETtu2,7,4,1,0,2,2,13,2,24,3.4285714285714284,1,0.0,2,1,0,2,2,2,0,13,2,5,19,1
2999,27131,HmD5U4sIMvfZvpRZtV6LJ4TMT3hqwpU2,A3fsA9Zfv1X2fVEQhTw51lKENdNrEqT3,7,4,2,0,2,0,2,0,10,1.4285714285714286,1,0.0,0,2,0,2,4,0,0,2,0,4,6,1
3000,27140,9zKzyrDc2ZLmZJn8iNzeeCTIcbRbidfo,A3fsA9Zfv1X2fVEQhTw51lKENdNrEqT3,42,47,23,56,4,15,23,1,169,24.142857142857142,6,0.0,3,23,51,4,44,15,5,23,1,81,88,0
3001,27141,O7ag9DJQGMaSoxNY23KuzUgYBMRSrdlt,SpATywNh6bZuzm8s1ceuBUnMUAeoAHHw,1,0,0,0,0,0,1,0,1,0.14285714285714285,1,0.0,0,0,0,0,0,0,0,1,0,0,1,1
3002,27145,5pjAdY5K4FfgQPLSzQKwXaKF78ph9a0y,A3fsA9Zfv1X2fVEQhTw51lKENdNrEqT3,138,79,53,380,19,9,38,0,578,82.57142857142857,8,0.0,10,53,362,19,69,9,18,38,0,444,134,0
3003,27154,zi3yOAhUK1J3AbYoEq9VqjXWOhiWlKvY,SpATywNh6bZuzm8s1ceuBUnMUAeoAHHw,42,126,10,47,7,72,27,1,290,41.42857142857143,15,0.0,37,10,40,7,89,72,7,27,1,94,196,0
3004,27155,FgKGJkcyrlk2UGTZTaDtYvcpTKr0lNLA,SpATywNh6bZuzm8s1ceuBUnMUAeoAHHw,31,42,25,16,11,0,14,1,109,15.571428571428571,3,0.0,5,25,15,11,37,0,1,14,1,56,53,0
3005,27157,KOtvsBXw2AZmXimVVqYMRgAsUlwCmhAG,5X6FeZozNMgE2VRi3MJYjkkFK8SETtu2,10,10,7,0,1,0,8,0,26,3.7142857142857144,2,0.0,0,7,0,1,10,0,0,8,0,8,18,1
3006,27158,ZSKBKnD8wfegggUigWIwrMo7a1rGr9YG,RXDvfPUBYFlVdlueBFbLW0mhhAyGEqpt,1,0,0,0,0,0,1,0,1,0.14285714285714285,1,0.0,0,0,0,0,0,0,0,1,0,0,1,1
3007,27166,5pjAdY5K4FfgQPLSzQKwXaKF78ph9a0y,5X6FeZozNMgE2VRi3MJYjkkFK8SETtu2,7,12,7,0,3,0,12,0,34,4.857142857142857,5,0.0,0,7,0,3,12,0,0,12,0,10,24,0
3008,27171,EUmZ5qzjwgko2PIWEnctkvYh7APnUrX9,G8EPVSXsOYB5YQWZGiz1aVq5Pgr2GrQu,20,57,3,0,3,0,15,0,78,11.142857142857142,4,0.0,0,3,0,3,57,0,0,15,0,6,72,1
3009,27203,0pXQfM8DUmrkstumtDLyuzaICh0xRgGw,SpATywNh6bZuzm8s1ceuBUnMUAeoAHHw,14,12,6,2,4,0,3,0,27,3.857142857142857,3,0.0,0,6,2,4,12,0,0,3,0,12,15,1
3010,27206,5pjAdY5K4FfgQPLSzQKwXaKF78ph9a0y,7GRhBDsirIGkRZBtSMEzNTyDr2JQm4xx,7,20,6,0,1,0,7,0,34,4.857142857142857,5,0.0,8,6,0,1,12,0,0,7,0,15,19,0
3011,27209,147kfUKOVzUnQEgEhu4oFkvvuFRbAg9Y,bWdj2GDclj5ofokWjzoa5jAwMkxCykd6,11,15,9,0,6,8,7,1,46,6.571428571428571,5,0.0,0,9,0,6,15,8,0,7,1,15,31,1
3012,27213,S0nQm2eOAlSxKM1RfeGoUgB4GQEZsJ1U,SpATywNh6bZuzm8s1ceuBUnMUAeoAHHw,44,75,31,48,18,21,36,11,240,34.285714285714285,4,0.0,22,31,42,18,53,21,6,36,11,113,127,0
3013,27220,SqRpmgv1gGFKN06wuAdrCbdyqbZyrZkj,bWdj2GDclj5ofokWjzoa5jAwMkxCykd6,5,6,2,0,0,0,4,0,12,1.7142857142857142,2,0.0,0,2,0,0,6,0,0,4,0,2,10,1
3014,27229,vvW1UkV9WqtfmPMhz7QIGvDdFqIvY2j3,7GRhBDsirIGkRZBtSMEzNTyDr2JQm4xx,1,0,0,0,0,0,1,0,1,0.14285714285714285,1,0.0,0,0,0,0,0,0,0,1,0,0,1,1
3015,27230,uciz4weP1kSziQB1Oe1Psu4CdK1uNqzl,SpATywNh6bZuzm8s1ceuBUnMUAeoAHHw,22,40,19,37,4,25,14,5,144,20.571428571428573,3,0.0,14,19,31,4,26,25,6,14,5,68,76,0
3016,27245,L6Tc39ltUCigrI45L69IfmvrMsjwxFPz,RXDvfPUBYFlVdlueBFbLW0mhhAyGEqpt,24,20,11,51,11,41,11,0,145,20.714285714285715,4,0.0,6,11,46,11,14,41,5,11,0,74,71,0
3017,27257,ilQqtG05VEreri5rVwRPOodDRvBSi2Yp,7GRhBDsirIGkRZBtSMEzNTyDr2JQm4xx,6,9,0,2,0,0,2,0,13,1.8571428571428572,1,0.0,1,0,2,0,8,0,0,2,0,3,10,1
3018,27258,jBmjwFnt42Gcx6LwIKpHSMaWZmMpbUSA,bWdj2GDclj5ofokWjzoa5jAwMkxCykd6,9,6,3,0,4,28,9,1,51,7.285714285714286,2,0.0,0,3,0,4,6,28,0,9,1,7,44,0
3019,27261,xk5bwSTEAMNKyEU3iNkOO0oTip8zPc6K,7GRhBDsirIGkRZBtSMEzNTyDr2JQm4xx,3,0,0,0,0,3,3,0,6,0.8571428571428571,1,0.0,0,0,0,0,0,3,0,3,0,0,6,1
3020,27262,5YlMIk6eUB42j0JZ5VWqgCtDNQymOsVL,A3fsA9Zfv1X2fVEQhTw51lKENdNrEqT3,1,0,0,0,0,0,1,0,1,0.14285714285714285,1,0.0,0,0,0,0,0,0,0,1,0,0,1,1
3021,27263,X5ugOWLhdmTxo3CYqfXWDVoDsvjcSnkc,SpATywNh6bZuzm8s1ceuBUnMUAeoAHHw,29,65,28,37,5,7,26,2,170,24.285714285714285,10,0.0,20,28,33,5,45,7,4,26,2,86,84,0
3022,27274,RHMCI6WPNb6sodSDz63meesVmYDbjVWv,G8EPVSXsOYB5YQWZGiz1aVq5Pgr2GrQu,1,0,0,0,0,0,1,0,1,0.14285714285714285,1,0.0,0,0,0,0,0,0,0,1,0,0,1,1
3023,27276,RHMCI6WPNb6sodSDz63meesVmYDbjVWv,A3fsA9Zfv1X2fVEQhTw51lKENdNrEqT3,1,0,0,0,0,0,1,0,1,0.14285714285714285,1,0.0,0,0,0,0,0,0,0,1,0,0,1,1
3024,27277,DTD40RjYwLBuwaHKa3c3iphTurXVm83S,7GRhBDsirIGkRZBtSMEzNTyDr2JQm4xx,2,0,0,0,0,0,3,0,3,0.42857142857142855,1,0.0,0,0,0,0,0,0,0,3,0,0,3,1
3025,27284,0vYe49xmwT3tPlTtY6ubPLznONbIxbXe,7GRhBDsirIGkRZBtSMEzNTyDr2JQm4xx,5,6,2,0,0,0,5,0,13,1.8571428571428572,1,0.0,0,2,0,0,6,0,0,5,0,2,11,1
3026,27304,wNwoqC5ObEwtjOwnohUoKsyAr3KoLL2z,SpATywNh6bZuzm8s1ceuBUnMUAeoAHHw,1,0,0,0,0,0,1,0,1,0.14285714285714285,1,0.0,0,0,0,0,0,0,0,1,0,0,1,1
3027,27306,tTMyaWTlizKdT72ief23Wjd2wqSzEHSk,bWdj2GDclj5ofokWjzoa5jAwMkxCykd6,27,24,12,24,7,4,15,0,86,12.285714285714286,6,0.0,0,12,23,7,24,4,1,15,0,42,44,0
3028,27308,tc8ZYWI5FOJIIpcsZ5SRyil7whr7RTIT,5X6FeZozNMgE2VRi3MJYjkkFK8SETtu2,18,59,2,4,3,17,19,3,107,15.285714285714286,8,0.0,11,2,3,3,48,17,1,19,3,19,88,0
3029,27313,rUrD3vOZKxi004QKs8MuR2Ws6PqRB5Bd,SpATywNh6bZuzm8s1ceuBUnMUAeoAHHw,14,17,8,18,3,0,2,0,48,6.857142857142857,2,0.0,7,8,16,3,10,0,2,2,0,34,14,1
3030,27318,qOCeRyabO4TOWDJBtcnFq6ksxPSapJ0M,7GRhBDsirIGkRZBtSMEzNTyDr2JQm4xx,6,6,1,0,1,0,2,0,10,1.4285714285714286,1,0.0,0,1,0,1,6,0,0,2,0,2,8,1
3031,27327,JiMk3YzOg8oAYgApOK7xg1JGgnoRvDfl,SpATywNh6bZuzm8s1ceuBUnMUAeoAHHw,50,99,52,37,22,25,25,3,263,37.57142857142857,6,0.0,30,52,33,22,69,25,4,25,3,137,126,0
3032,27328,nEzidwd1f4tZP3mnFNbL1NYH0VtiIG9o,G8EPVSXsOYB5YQWZGiz1aVq5Pgr2GrQu,9,7,4,0,2,1,13,3,30,4.285714285714286,2,0.0,0,4,0,2,7,1,0,13,3,6,24,0
3033,27367,mvWG8WfFoikkAB9Wg1mtbCZJVje4NMeg,A3fsA9Zfv1X2fVEQhTw51lKENdNrEqT3,1,0,0,0,0,0,1,0,1,0.14285714285714285,1,0.0,0,0,0,0,0,0,0,1,0,0,1,1
3034,27372,9yzTxxapCsl6p0XfgDOC1OZlTO149uIK,RXDvfPUBYFlVdlueBFbLW0mhhAyGEqpt,10,3,3,0,3,0,6,0,15,2.142857142857143,3,0.0,0,3,0,3,3,0,0,6,0,6,9,1
3035,27386,jQaCxlcrIW3B0ti76HtzjtRZOLJHPbzy,RXDvfPUBYFlVdlueBFbLW0mhhAyGEqpt,36,95,53,0,9,203,42,17,419,59.857142857142854,12,0.0,0,53,0,9,95,203,0,42,17,62,357,0
3036,27387,FFlICu8a1PeaY8oKBFESJAT3q6I5h6Xu,SpATywNh6bZuzm8s1ceuBUnMUAeoAHHw,34,56,29,20,10,4,12,0,131,18.714285714285715,8,0.0,10,29,19,10,46,4,1,12,0,68,63,0
3037,27397,bdtPawZirEzy4zJwBHLye0XuKdBDsRNa,7GRhBDsirIGkRZBtSMEzNTyDr2JQm4xx,1,0,0,0,0,0,1,0,1,0.14285714285714285,1,0.0,0,0,0,0,0,0,0,1,0,0,1,1
3038,27398,Bu2t1TMRCrfGFPr5E4de77vGt2jlo7S7,5X6FeZozNMgE2VRi3MJYjkkFK8SETtu2,8,4,3,0,2,2,4,0,15,2.142857142857143,1,0.0,0,3,0,2,4,2,0,4,0,5,10,1
3039,27401,BvCRPlMfMau2kDEBEjyV1l6RJMQy5B5l,7GRhBDsirIGkRZBtSMEzNTyDr2JQm4xx,17,33,12,42,0,0,6,0,93,13.285714285714286,2,0.0,10,12,34,0,23,0,8,6,0,56,37,1
3040,27402,GDOD5H0bl28RO8whBIu6B8qS2nGsRznY,A3fsA9Zfv1X2fVEQhTw51lKENdNrEqT3,6,5,3,0,1,0,3,0,12,1.7142857142857142,3,0.0,0,3,0,1,5,0,0,3,0,4,8,1
3041,27412,JKpUdoayexmnBaGuLjDe4nN4yf5KTJWi,SpATywNh6bZuzm8s1ceuBUnMUAeoAHHw,32,40,31,0,23,0,8,0,102,14.571428571428571,6,0.0,0,31,0,23,40,0,0,8,0,54,48,0
3042,27418,46ijefZyx5KF4YGCmdayIapXrAG6omzt,SpATywNh6bZuzm8s1ceuBUnMUAeoAHHw,14,15,5,16,0,0,4,0,40,5.714285714285714,5,0.0,4,5,15,0,11,0,1,4,0,24,16,0
3043,27441,xaMkz5ExnwaMxZxilE1ZpVj0K68325xB,7GRhBDsirIGkRZBtSMEzNTyDr2JQm4xx,31,63,22,42,12,0,6,0,145,20.714285714285715,2,0.0,18,22,36,12,45,0,6,6,0,88,57,1
3044,27445,M5fmtGmpo2DUfH2kBcBzBwkDFjGnGDqf,7GRhBDsirIGkRZBtSMEzNTyDr2JQm4xx,14,27,2,2,1,17,7,0,56,8.0,3,0.0,3,2,1,1,24,17,1,7,0,7,49,1
3045,27448,h5vEAVTb94xGNGjpn4Ohi5mNcXfM0rMl,7GRhBDsirIGkRZBtSMEzNTyDr2JQm4xx,20,51,6,3,7,0,10,0,77,11.0,4,0.0,15,6,3,7,36,0,0,10,0,31,46,1
3046,27452,FPlcvm9GCa3b2GpGQce61hkgMN4KDTO8,A3fsA9Zfv1X2fVEQhTw51lKENdNrEqT3,5,5,0,0,0,0,4,0,9,1.2857142857142858,1,0.0,0,0,0,0,5,0,0,4,0,0,9,1
3047,27455,Cm1M3tMD81LVoXf16iZdS1f94DBPqFnf,SpATywNh6bZuzm8s1ceuBUnMUAeoAHHw,19,55,2,0,2,0,2,0,61,8.714285714285714,7,0.0,5,2,0,2,50,0,0,2,0,9,52,0
3048,27457,CYUGDG4GDnccqiwcMR066vcF013j1TMy,RXDvfPUBYFlVdlueBFbLW0mhhAyGEqpt,1,0,0,0,0,0,1,0,1,0.14285714285714285,1,0.0,0,0,0,0,0,0,0,1,0,0,1,1
3049,27460,CYUGDG4GDnccqiwcMR066vcF013j1TMy,bWdj2GDclj5ofokWjzoa5jAwMkxCykd6,1,0,0,0,0,0,2,0,2,0.2857142857142857,1,0.0,0,0,0,0,0,0,0,2,0,0,2,1
3050,27461,CYUGDG4GDnccqiwcMR066vcF013j1TMy,A3fsA9Zfv1X2fVEQhTw51lKENdNrEqT3,1,0,0,0,0,0,1,0,1,0.14285714285714285,1,0.0,0,0,0,0,0,0,0,1,0,0,1,1
3051,27464,XLmXRx6QIJBEWZLK5otMq8wfQNXonT4D,SpATywNh6bZuzm8s1ceuBUnMUAeoAHHw,20,32,6,4,4,0,1,0,47,6.714285714285714,7,0.0,2,6,4,4,30,0,0,1,0,16,31,0
3052,27466,rQQvHNajcjjfIyLOReFtjaD8d9v2FigP,7GRhBDsirIGkRZBtSMEzNTyDr2JQm4xx,3,0,0,0,0,0,5,0,5,0.7142857142857143,1,0.0,0,0,0,0,0,0,0,5,0,0,5,1
3053,27472,gBjurtkrE1QG05Q5LeiG3aUmftHx9oSc,bWdj2GDclj5ofokWjzoa5jAwMkxCykd6,13,26,9,0,8,0,7,0,50,7.142857142857143,3,0.0,0,9,0,8,26,0,0,7,0,17,33,1
3054,27473,xYJiCXQflcZ5NTqhkCBqQygWsRlPt9ao,7GRhBDsirIGkRZBtSMEzNTyDr2JQm4xx,4,4,2,0,0,42,2,0,50,7.142857142857143,2,0.0,1,2,0,0,3,42,0,2,0,3,47,1
3055,27475,mEMC3mPRFcLDpf0MVM7Pji9FNHa590x9,SpATywNh6bZuzm8s1ceuBUnMUAeoAHHw,20,46,21,25,0,9,12,0,113,16.142857142857142,4,0.0,18,21,19,0,28,9,6,12,0,58,55,1
3056,27477,pz4WzmrapGULqEk99lfOZVzJbwiC2Cl1,SpATywNh6bZuzm8s1ceuBUnMUAeoAHHw,19,20,0,19,0,8,12,0,59,8.428571428571429,6,0.0,6,0,19,0,14,8,0,12,0,25,34,0
3057,27478,dgp1qm7PjXoVV4MjyzuvWetQrJ3T9kos,7GRhBDsirIGkRZBtSMEzNTyDr2JQm4xx,53,167,78,56,57,72,35,6,471,67.28571428571429,6,0.0,73,78,53,57,94,72,3,35,6,261,210,1
3058,27491,9Nmjm4BvnbKTQ3ZZwECYdKy9zBNGmQNW,7GRhBDsirIGkRZBtSMEzNTyDr2JQm4xx,1,0,0,0,0,0,1,0,1,0.14285714285714285,1,0.0,0,0,0,0,0,0,0,1,0,0,1,1
3059,27508,tMqwmUDBjzV47t93nRMHpK2NbIUU0mEs,SpATywNh6bZuzm8s1ceuBUnMUAeoAHHw,21,32,11,20,5,0,2,0,70,10.0,2,0.0,3,11,18,5,29,0,2,2,0,37,33,1
3060,27517,9CBq37ANJ7gzpAJJLjvNc0D6JKL0q7QE,SpATywNh6bZuzm8s1ceuBUnMUAeoAHHw,57,76,32,55,18,7,9,0,197,28.142857142857142,4,0.0,19,32,53,18,57,7,2,9,0,122,75,1
3061,27523,8ga3z0NKN1WQ3YzAZr5NtUzbD9BjtY0C,G8EPVSXsOYB5YQWZGiz1aVq5Pgr2GrQu,63,54,27,119,9,0,25,0,234,33.42857142857143,9,0.0,17,27,100,9,37,0,19,25,0,153,81,0
3062,27524,vO1mfDIydV81bK1AJmTqdzB6pSb2fl5U,bWdj2GDclj5ofokWjzoa5jAwMkxCykd6,7,4,0,0,0,12,17,1,34,4.857142857142857,1,0.0,0,0,0,0,4,12,0,17,1,0,34,0
3063,27532,ok9deTolTxdwywhUtYqsqR9eC1Gb5v44,SpATywNh6bZuzm8s1ceuBUnMUAeoAHHw,27,40,15,33,4,2,11,1,106,15.142857142857142,3,0.0,21,15,28,4,19,2,5,11,1,68,38,0
3064,27541,4LLdV2zTWS697dAsOgAPJZPFwfNnrjt6,A3fsA9Zfv1X2fVEQhTw51lKENdNrEqT3,67,68,46,148,20,3,20,1,306,43.714285714285715,9,0.0,4,46,129,20,64,3,19,20,1,199,107,1
3065,27547,Nt2MuvKq8ehhC9cDQZ9wTGuVcTn0ishD,5X6FeZozNMgE2VRi3MJYjkkFK8SETtu2,9,10,3,0,1,0,6,0,20,2.857142857142857,2,0.0,5,3,0,1,5,0,0,6,0,9,11,0
3066,27548,azOWgfyXQBkztOqJ4AAsFqAk137ZwNDW,SpATywNh6bZuzm8s1ceuBUnMUAeoAHHw,23,42,30,18,0,6,17,1,114,16.285714285714285,5,0.0,2,30,14,0,40,6,4,17,1,46,68,0
3067,27606,cWykzNKAq5sFQBA059QN4Jx74YGPkfwB,5Gyp41oLVo7Gg7vF4vpmggWP5MU70QO6,38,171,93,102,13,46,41,1,467,66.71428571428571,8,0.0,37,93,80,13,134,46,22,41,1,223,244,1
3068,27619,pOmMyPkqdgoqwjm4uJTo96pDPWn8497v,5Gyp41oLVo7Gg7vF4vpmggWP5MU70QO6,19,28,18,11,10,0,6,0,73,10.428571428571429,5,0.0,5,18,8,10,23,0,3,6,0,41,32,1
3069,27647,h2w2KnlHH0dLj9ah8Ktkr5F5RQhDw3lF,5Gyp41oLVo7Gg7vF4vpmggWP5MU70QO6,13,11,5,0,3,0,5,0,24,3.4285714285714284,1,0.0,2,5,0,3,9,0,0,5,0,10,14,1
3070,27653,68Dxo5Uz0aGDvHTFGMu5vw31QRJ7GnRc,5Gyp41oLVo7Gg7vF4vpmggWP5MU70QO6,2,0,0,0,0,0,2,0,2,0.2857142857142857,1,0.0,0,0,0,0,0,0,0,2,0,0,2,1
3071,27691,EmhLJBUMFxcunqaQdYZAlaquRhoNubHk,5Gyp41oLVo7Gg7vF4vpmggWP5MU70QO6,45,198,106,77,51,33,41,3,509,72.71428571428571,7,0.0,58,106,63,51,140,33,14,41,3,278,231,0
3072,27910,IY29VUWGFHtfrjTNCkqydR2UYXxAmkwM,5Gyp41oLVo7Gg7vF4vpmggWP5MU70QO6,25,62,24,10,13,9,19,3,140,20.0,2,0.0,12,24,5,13,50,9,5,19,3,54,86,1
3073,27912,rV1C0FkMMtpbmabMzq9P6vZBAdXUo30B,5Gyp41oLVo7Gg7vF4vpmggWP5MU70QO6,55,110,49,29,39,4,16,1,248,35.42857142857143,6,0.0,51,49,23,39,59,4,6,16,1,162,86,0
3074,27929,hIXeM0yyb6wIxVNnB5ijRV2LpcYBbrLW,5Gyp41oLVo7Gg7vF4vpmggWP5MU70QO6,8,17,5,0,1,0,4,0,27,3.857142857142857,3,0.0,0,5,0,1,17,0,0,4,0,6,21,1
3075,27931,tMjprEPLBIvFA1wgueSz2eNKPTF9Ywab,5Gyp41oLVo7Gg7vF4vpmggWP5MU70QO6,1,0,0,0,0,0,1,0,1,0.14285714285714285,1,0.0,0,0,0,0,0,0,0,1,0,0,1,1
3076,27935,3dZVfShxC9kemRNKsdGwL5lQ2FKMwdl1,5Gyp41oLVo7Gg7vF4vpmggWP5MU70QO6,16,36,16,8,6,0,10,0,76,10.857142857142858,6,0.0,10,16,4,6,26,0,4,10,0,36,40,1
3077,27982,ZULomXsITwM6vNxcJN8imzU1pyfKn8Cw,5Gyp41oLVo7Gg7vF4vpmggWP5MU70QO6,57,267,164,37,63,32,54,6,623,89.0,14,0.0,67,164,26,63,200,32,11,54,6,320,303,0
3078,27985,NGNG2Ypn5U43gbRiqJUxr2iLJ7uh0fYS,5Gyp41oLVo7Gg7vF4vpmggWP5MU70QO6,15,13,6,0,7,0,5,0,31,4.428571428571429,3,0.0,3,6,0,7,10,0,0,5,0,16,15,0
3079,28002,uHgH8m4GJET0eE5mE8JCyLZD7HEKwM4t,5Gyp41oLVo7Gg7vF4vpmggWP5MU70QO6,1,0,0,0,0,0,1,0,1,0.14285714285714285,1,0.0,0,0,0,0,0,0,0,1,0,0,1,1
3080,28017,Vgv9Vbo4BqJtU7GBUbwfi1DvG0Q1nDxJ,5Gyp41oLVo7Gg7vF4vpmggWP5MU70QO6,17,33,5,9,3,6,15,0,71,10.142857142857142,4,0.0,6,5,8,3,27,6,1,15,0,22,49,0
3081,28023,OHdowkt0lKGMvUmcny07O1EwZDDg5zly,5Gyp41oLVo7Gg7vF4vpmggWP5MU70QO6,1,0,0,0,0,0,1,0,1,0.14285714285714285,1,0.0,0,0,0,0,0,0,0,1,0,0,1,1
3082,28034,JgNllefl6lxMJFs121u0iwNrhgAg4Z2l,5Gyp41oLVo7Gg7vF4vpmggWP5MU70QO6,52,228,124,45,45,79,44,0,565,80.71428571428571,15,0.0,67,124,32,45,161,79,13,44,0,268,297,0
3083,28046,hNJz0qbOhrUgajUkzqSdDbybHkuRglfs,5Gyp41oLVo7Gg7vF4vpmggWP5MU70QO6,11,19,12,2,2,0,7,0,42,6.0,3,0.0,2,12,1,2,17,0,1,7,0,17,25,0
3084,28059,F3YGQxJCx53Ykm07bMYXU5VASdwnVuqU,5Gyp41oLVo7Gg7vF4vpmggWP5MU70QO6,5,7,4,0,2,0,3,0,16,2.2857142857142856,2,0.0,0,4,0,2,7,0,0,3,0,6,10,1
3085,28063,UoQ3qEkl0829bYUdpRZpHbRErQr2wCSM,5Gyp41oLVo7Gg7vF4vpmggWP5MU70QO6,10,10,3,6,2,0,11,0,32,4.571428571428571,2,0.0,7,3,3,2,3,0,3,11,0,15,17,1
3086,28071,xIAiSXUxBKAnRQoPkr2p83UbZxo76sqM,5Gyp41oLVo7Gg7vF4vpmggWP5MU70QO6,1,0,0,0,0,0,1,0,1,0.14285714285714285,1,0.0,0,0,0,0,0,0,0,1,0,0,1,1
3087,28077,MaXB6YBpSNUvXtEuCcY3Jwa8jwvsWVE8,5Gyp41oLVo7Gg7vF4vpmggWP5MU70QO6,7,3,2,0,2,0,2,0,9,1.2857142857142858,1,0.0,0,2,0,2,3,0,0,2,0,4,5,1
3088,28081,BV79vNEzTPlmR22unH2F5S3vLmcSI9HJ,5Gyp41oLVo7Gg7vF4vpmggWP5MU70QO6,14,26,14,3,7,1,14,1,66,9.428571428571429,4,0.0,1,14,2,7,25,1,1,14,1,24,42,0
3089,28089,r3FrxEVNvR9qEi831CCkRSJOpiXnU0FF,5Gyp41oLVo7Gg7vF4vpmggWP5MU70QO6,18,26,12,16,7,0,8,0,69,9.857142857142858,2,0.0,9,12,8,7,17,0,8,8,0,36,33,1
3090,28117,35vL0ALP2ArCVChSKJCitMWjtQl3acP9,5Gyp41oLVo7Gg7vF4vpmggWP5MU70QO6,6,4,1,0,1,0,4,0,10,1.4285714285714286,2,0.0,0,1,0,1,4,0,0,4,0,2,8,1
3091,28120,F0WSLEWTFqAIJPsTVBWVZ6RgMW5ye2Ty,5Gyp41oLVo7Gg7vF4vpmggWP5MU70QO6,1,0,0,0,0,0,1,0,1,0.14285714285714285,1,0.0,0,0,0,0,0,0,0,1,0,0,1,1
3092,28126,NYHJ2hpkQuM6x91lqCpGcKlaiVcQb8tv,5Gyp41oLVo7Gg7vF4vpmggWP5MU70QO6,9,9,2,0,2,0,2,0,15,2.142857142857143,1,0.0,0,2,0,2,9,0,0,2,0,4,11,1
3093,28132,qWUHaBA14wCVQxQ3GlZi8VQT6onaOkYr,5Gyp41oLVo7Gg7vF4vpmggWP5MU70QO6,13,41,1,6,3,0,5,0,56,8.0,2,0.0,7,1,3,3,34,0,3,5,0,14,42,1
3094,28149,umFRjjRou5lxb9SCAQ56IcPskPM6alkQ,5Gyp41oLVo7Gg7vF4vpmggWP5MU70QO6,33,119,62,54,8,6,85,1,335,47.857142857142854,7,0.0,12,62,44,8,107,6,10,85,1,126,209,0
3095,28167,GojuV0la1IgJTICKk09lNC7XjyEWzeax,5Gyp41oLVo7Gg7vF4vpmggWP5MU70QO6,22,36,18,6,6,13,8,0,87,12.428571428571429,3,0.0,13,18,3,6,23,13,3,8,0,40,47,1
3096,28179,Q0RlqkDoye0CFKRgMpSUoXnN9SlonN3k,5Gyp41oLVo7Gg7vF4vpmggWP5MU70QO6,26,33,1,15,12,10,7,0,78,11.142857142857142,4,0.0,11,1,10,12,22,10,5,7,0,34,44,0
3097,28181,RJwnOph0p8T6UAPo7WZFtHqjtt1K7VgK,5Gyp41oLVo7Gg7vF4vpmggWP5MU70QO6,37,91,46,40,14,1,31,0,223,31.857142857142858,11,0.0,13,46,30,14,78,1,10,31,0,103,120,0
3098,28182,Vrqvr8lNbpSjQdsMIu1B8ExqeyPQi6wD,5Gyp41oLVo7Gg7vF4vpmggWP5MU70QO6,6,3,1,0,1,0,2,0,7,1.0,1,0.0,0,1,0,1,3,0,0,2,0,2,5,1
3099,28186,hbiLFwYRNfJ5BzIhONrfQV07bzBd3fcu,5Gyp41oLVo7Gg7vF4vpmggWP5MU70QO6,40,206,106,45,33,19,34,1,444,63.42857142857143,14,0.0,46,106,29,33,160,19,16,34,1,214,230,0
3100,28193,K9nInKsxWeoRDvjfEiycBlskSifL6OWe,5Gyp41oLVo7Gg7vF4vpmggWP5MU70QO6,7,5,3,0,1,1,2,0,12,1.7142857142857142,1,0.0,0,3,0,1,5,1,0,2,0,4,8,1
3101,28198,I4zM9rHEGFO5XPNdII42SPU5yBy5nnDO,5Gyp41oLVo7Gg7vF4vpmggWP5MU70QO6,26,41,25,30,8,5,19,7,135,19.285714285714285,4,0.0,10,25,18,8,31,5,12,19,7,61,74,1
3102,28204,VW1NSXHsRBHsQFDrAdwMVKxbl0FK1kSa,5Gyp41oLVo7Gg7vF4vpmggWP5MU70QO6,25,22,11,14,7,0,6,0,60,8.571428571428571,3,0.0,9,11,7,7,13,0,7,6,0,34,26,0
3103,28214,RxXRKZYpbfKbF79XwFGwONhlZ3CWNuKc,5Gyp41oLVo7Gg7vF4vpmggWP5MU70QO6,1,0,0,0,0,0,1,0,1,0.14285714285714285,1,0.0,0,0,0,0,0,0,0,1,0,0,1,1
3104,28221,RARu5DwVWhsWe4JpwIDGirLcmeGNFIFs,5Gyp41oLVo7Gg7vF4vpmggWP5MU70QO6,22,18,6,72,0,0,5,0,101,14.428571428571429,2,0.0,10,6,61,0,8,0,11,5,0,77,24,1
3105,28228,WELjmgdsP962Pc1teJ96xvofKraKe6qa,5Gyp41oLVo7Gg7vF4vpmggWP5MU70QO6,12,12,6,4,2,29,19,3,75,10.714285714285714,5,0.0,3,6,3,2,9,29,1,19,3,14,61,0
3106,28230,goqhFtKJFc8EIUBDvl7EAlkZyjSW0CkB,5Gyp41oLVo7Gg7vF4vpmggWP5MU70QO6,27,52,28,0,28,0,5,0,113,16.142857142857142,3,0.0,12,28,0,28,40,0,0,5,0,68,45,0
3107,28270,S9WMXu7x4mGtnVsssjOsOIjEB9GwRzBY,5Gyp41oLVo7Gg7vF4vpmggWP5MU70QO6,10,10,7,0,7,6,9,2,41,5.857142857142857,2,0.0,1,7,0,7,9,6,0,9,2,15,26,0
3108,28276,0PfU3KuGh5fUaiigSaVoUh3dHM2dwmbq,5Gyp41oLVo7Gg7vF4vpmggWP5MU70QO6,1,0,0,0,0,0,1,0,1,0.14285714285714285,1,0.0,0,0,0,0,0,0,0,1,0,0,1,1
3109,28300,Sk9AOCT9Pke3AdxAKMgSzcKTQwjFbv8R,5Gyp41oLVo7Gg7vF4vpmggWP5MU70QO6,6,1,1,0,1,0,3,0,6,0.8571428571428571,1,0.0,0,1,0,1,1,0,0,3,0,2,4,1
3110,28317,CEfEi7M9lamzCxAJyDlpYAAxnD3ijzvT,5Gyp41oLVo7Gg7vF4vpmggWP5MU70QO6,9,4,3,0,3,0,2,0,12,1.7142857142857142,1,0.0,0,3,0,3,4,0,0,2,0,6,6,1
3111,28341,QUmY4Qxuc6Lxkcjcv3S35mlSzSQ2SxMI,5Gyp41oLVo7Gg7vF4vpmggWP5MU70QO6,45,158,80,54,32,12,27,2,365,52.142857142857146,15,0.0,52,80,36,32,106,12,18,27,2,200,165,0
3112,28352,bZ35LM6ZK64GRHs2w4e0jSLKpQyNFLAf,5Gyp41oLVo7Gg7vF4vpmggWP5MU70QO6,6,2,1,0,2,0,3,0,8,1.1428571428571428,1,0.0,1,1,0,2,1,0,0,3,0,4,4,1
3113,28365,cHSk2tkmj07D1Si8z7Gc4Xxk3CDu4xnh,5Gyp41oLVo7Gg7vF4vpmggWP5MU70QO6,6,4,2,0,3,0,1,0,10,1.4285714285714286,1,0.0,1,2,0,3,3,0,0,1,0,6,4,1
3114,28366,UYodASsM2kuoVGiMTZuLBu6IW0INt07N,5Gyp41oLVo7Gg7vF4vpmggWP5MU70QO6,40,84,42,28,20,5,19,1,199,28.428571428571427,11,0.0,28,42,23,20,56,5,5,19,1,113,86,0
3115,28373,FkzxKMbMMqgFWfaVd2jKcGrD9SPSB6WC,5Gyp41oLVo7Gg7vF4vpmggWP5MU70QO6,10,9,6,0,4,0,5,0,24,3.4285714285714284,3,0.0,0,6,0,4,9,0,0,5,0,10,14,0
3116,28425,X3X3klM03RXeGUjty93sg2SlkZrg3xpQ,5Gyp41oLVo7Gg7vF4vpmggWP5MU70QO6,17,44,22,14,3,8,10,0,101,14.428571428571429,8,0.0,7,22,9,3,37,8,5,10,0,41,60,0
3117,28431,L5srqSjKk2d49ciW6UpMzrFCE1CKvFWo,5Gyp41oLVo7Gg7vF4vpmggWP5MU70QO6,10,8,4,0,1,2,9,2,26,3.7142857142857144,3,0.0,1,4,0,1,7,2,0,9,2,6,20,1
3118,28446,PUFh3BsQaDVIJMDvwsFTqkrgAzvjO9ME,5Gyp41oLVo7Gg7vF4vpmggWP5MU70QO6,32,82,38,10,17,22,33,2,204,29.142857142857142,11,0.0,12,38,8,17,70,22,2,33,2,75,129,1
3119,28460,plO5KwMn5kVrK7QQxoVeGB2Ku1Irxv2s,5Gyp41oLVo7Gg7vF4vpmggWP5MU70QO6,35,90,40,22,10,37,21,1,221,31.571428571428573,8,0.0,29,40,20,10,61,37,2,21,1,99,122,0
3120,28461,EttKeSyg9r0EcjglXuiRsuMNde5ZPNQV,5Gyp41oLVo7Gg7vF4vpmggWP5MU70QO6,24,63,36,22,11,16,15,0,163,23.285714285714285,9,0.0,12,36,14,11,51,16,8,15,0,73,90,0
3121,28478,YTGgnrEwOUYAUQwflLpD25p77n6Jd78c,5Gyp41oLVo7Gg7vF4vpmggWP5MU70QO6,11,13,7,3,4,0,4,0,31,4.428571428571429,3,0.0,3,7,2,4,10,0,1,4,0,16,15,0
3122,28490,qBuOYvjWXxAt6x3Clq0Mm94iVtXMfRzl,5Gyp41oLVo7Gg7vF4vpmggWP5MU70QO6,9,5,4,0,3,0,2,0,14,2.0,1,0.0,0,4,0,3,5,0,0,2,0,7,7,1
3123,28520,mSZYyfRNnqnDs7qyuaQEMEvx5vC2JS4M,5Gyp41oLVo7Gg7vF4vpmggWP5MU70QO6,6,5,4,0,4,0,1,0,14,2.0,1,0.0,0,4,0,4,5,0,0,1,0,8,6,1
3124,28521,j6ErWPW1uiWtFClFtsuMDI6P4ntwbAdZ,5Gyp41oLVo7Gg7vF4vpmggWP5MU70QO6,14,19,2,6,4,16,2,0,49,7.0,2,0.0,3,2,3,4,16,16,3,2,0,12,37,1
3125,28537,FXyHUn5FK6vjOTbpqXsoSHGWLI84x3qE,5Gyp41oLVo7Gg7vF4vpmggWP5MU70QO6,27,42,23,19,18,0,6,0,108,15.428571428571429,2,0.0,13,23,11,18,29,0,8,6,0,65,43,1
3126,28557,K1pJhtkexIe54pZxjAqUQbAIpHvM5SO6,5Gyp41oLVo7Gg7vF4vpmggWP5MU70QO6,17,18,11,0,5,0,7,1,42,6.0,2,0.0,0,11,0,5,18,0,0,7,1,16,26,1
3127,28569,powqMOenKH0qm70RdpWJkOu71ffX4cZ2,5Gyp41oLVo7Gg7vF4vpmggWP5MU70QO6,5,2,1,0,1,0,2,0,6,0.8571428571428571,1,0.0,0,1,0,1,2,0,0,2,0,2,4,1
3128,28570,N5tl2ONWAOdqInYowuXdxoR0l8SjB2Yi,5Gyp41oLVo7Gg7vF4vpmggWP5MU70QO6,6,8,4,0,1,0,4,0,17,2.4285714285714284,1,0.0,0,4,0,1,8,0,0,4,0,5,12,1
3129,28571,C9gGaOItLlzMqnWPFFyoyUeOqZmZ6BLj,5Gyp41oLVo7Gg7vF4vpmggWP5MU70QO6,11,12,7,2,5,2,3,0,31,4.428571428571429,1,0.0,3,7,1,5,9,2,1,3,0,16,15,1
3130,28579,lYCUe6jDfXsb0c06PHUzEKRKr8ha5nYO,5Gyp41oLVo7Gg7vF4vpmggWP5MU70QO6,21,25,13,6,6,6,11,3,70,10.0,2,0.0,9,13,5,6,16,6,1,11,3,33,37,0
3131,28581,rew0c3O7roxnm8EfAzYQGMCDX1NNxnod,5Gyp41oLVo7Gg7vF4vpmggWP5MU70QO6,19,43,18,0,24,0,2,0,87,12.428571428571429,4,0.0,18,18,0,24,25,0,0,2,0,60,27,1
3132,28592,DmMJESm0HPPuzZsFzUwdEUeMIsKkPmIB,5Gyp41oLVo7Gg7vF4vpmggWP5MU70QO6,26,65,29,28,15,24,12,0,173,24.714285714285715,6,0.0,17,29,18,15,48,24,10,12,0,79,94,1
3133,28598,P1zBFX39hk4RS67q1S3LCCKIITQT24NO,5Gyp41oLVo7Gg7vF4vpmggWP5MU70QO6,6,3,1,0,1,0,5,0,10,1.4285714285714286,2,0.0,0,1,0,1,3,0,0,5,0,2,8,1
3134,28609,Kkk2oty8lHBEgyFYDiZgsO24fUpD8pZQ,5Gyp41oLVo7Gg7vF4vpmggWP5MU70QO6,28,59,29,17,15,1,14,0,135,19.285714285714285,7,0.0,11,29,11,15,48,1,6,14,0,66,69,1
3135,28618,Z13gCiJciUykTdLRTsjNu2GwwR7Nbxp1,5Gyp41oLVo7Gg7vF4vpmggWP5MU70QO6,6,4,2,0,1,0,3,0,10,1.4285714285714286,2,0.0,0,2,0,1,4,0,0,3,0,3,7,1
3136,28639,5h3b7aFxVycJtoVIoQAHNUuIkrkWrRDG,5Gyp41oLVo7Gg7vF4vpmggWP5MU70QO6,31,44,24,10,10,0,10,0,98,14.0,8,0.0,7,24,10,10,37,0,0,10,0,51,47,1
3137,28644,PSnq49NT1XMAnj56MFCY3Tm8aOLD2VrB,5Gyp41oLVo7Gg7vF4vpmggWP5MU70QO6,1,0,0,0,0,0,1,0,1,0.14285714285714285,1,0.0,0,0,0,0,0,0,0,1,0,0,1,1
3138,28656,EvJkscqMA19TxzJafyfC0WBEGMVNjUMY,5Gyp41oLVo7Gg7vF4vpmggWP5MU70QO6,10,6,3,6,3,0,3,0,21,3.0,2,0.0,2,3,3,3,4,0,3,3,0,11,10,1
3139,28669,by4YyBr8Tq0vara5QIoE6KjoE3BZ5ozG,5Gyp41oLVo7Gg7vF4vpmggWP5MU70QO6,11,5,3,2,2,0,5,0,17,2.4285714285714284,1,0.0,1,3,1,2,4,0,1,5,0,7,10,1
3140,28675,nBvjxfottsOCrOycyCAN2ZrAK5pyyTJB,5Gyp41oLVo7Gg7vF4vpmggWP5MU70QO6,1,0,0,0,0,0,1,0,1,0.14285714285714285,1,0.0,0,0,0,0,0,0,0,1,0,0,1,1
3141,28686,dwsRSZLW8XW5JLCc461YQT9Iq8xPIYuB,5Gyp41oLVo7Gg7vF4vpmggWP5MU70QO6,6,3,2,0,1,0,2,0,8,1.1428571428571428,1,0.0,0,2,0,1,3,0,0,2,0,3,5,1
3142,28722,Jg02qgZSWErbjMBLI4Ec4G5s6mLoGXgk,5Gyp41oLVo7Gg7vF4vpmggWP5MU70QO6,6,3,1,0,1,0,2,0,7,1.0,1,0.0,0,1,0,1,3,0,0,2,0,2,5,1
3143,28744,9truuhFe5C1dOpwljnGJpmEuom5JrEfD,5Gyp41oLVo7Gg7vF4vpmggWP5MU70QO6,10,13,9,0,4,10,7,5,48,6.857142857142857,3,0.0,0,9,0,4,13,10,0,7,5,13,35,1
3144,28751,5lEqPu8Wcy0ntbFeV8g26DyNZTHiSuX4,5Gyp41oLVo7Gg7vF4vpmggWP5MU70QO6,25,38,21,15,13,0,5,0,92,13.142857142857142,5,0.0,11,21,10,13,27,0,5,5,0,55,37,1
3145,28771,NpyIJA0xxyDIqIVlOSt1MN2zYTYh79C0,5Gyp41oLVo7Gg7vF4vpmggWP5MU70QO6,10,14,7,4,3,0,2,0,30,4.285714285714286,2,0.0,4,7,2,3,10,0,2,2,0,16,14,1
3146,28823,xIGSAiekQUYr8YO5cwgwCu83bsRi7P5s,5Gyp41oLVo7Gg7vF4vpmggWP5MU70QO6,60,197,99,44,43,174,30,2,589,84.14285714285714,13,0.0,66,99,32,43,131,174,12,30,2,240,349,0
3147,28827,mWv2aD1lbqJSR5LQ8znxXgNEw4RCzno5,5Gyp41oLVo7Gg7vF4vpmggWP5MU70QO6,23,58,20,10,11,0,11,0,110,15.714285714285714,6,0.0,8,20,5,11,50,0,5,11,0,44,66,0
3148,28851,Hz1gD3xapoX9NB1k77xvttI5SLCsWFqX,5Gyp41oLVo7Gg7vF4vpmggWP5MU70QO6,15,22,13,10,6,4,4,0,59,8.428571428571429,1,0.0,5,13,5,6,17,4,5,4,0,29,30,1
3149,28856,Ss1uSs1DdHnQ3SS6zPdNDkPcKK378C4E,5Gyp41oLVo7Gg7vF4vpmggWP5MU70QO6,21,51,20,12,15,3,8,1,110,15.714285714285714,5,0.0,13,20,8,15,38,3,4,8,1,56,54,0
3150,28864,lUmqjiZL8pqPPgjGcmqK6Bx8gf96ZDh9,5Gyp41oLVo7Gg7vF4vpmggWP5MU70QO6,7,3,2,0,2,0,2,0,9,1.2857142857142858,1,0.0,0,2,0,2,3,0,0,2,0,4,5,1
3151,28871,mr6SHndrMUFTgJeI3Xsa4qtu794cguyo,5Gyp41oLVo7Gg7vF4vpmggWP5MU70QO6,3,0,0,0,0,2,2,0,4,0.5714285714285714,1,0.0,0,0,0,0,0,2,0,2,0,0,4,1
3152,28879,WCcz58k4iCjxZhNWgAj7C2bFhYOdHM0V,5Gyp41oLVo7Gg7vF4vpmggWP5MU70QO6,43,102,51,23,33,12,8,1,230,32.857142857142854,4,0.0,33,51,20,33,69,12,3,8,1,137,93,0
3153,28909,XLqOA0uzBEHNqoUS32Oa7pu4rIM9H3dm,5Gyp41oLVo7Gg7vF4vpmggWP5MU70QO6,4,0,0,0,0,0,3,1,4,0.5714285714285714,1,0.0,0,0,0,0,0,0,0,3,1,0,4,1
3154,28918,YFhn0p0B163GXwlC3Qc0b66iIGcGBrIh,5Gyp41oLVo7Gg7vF4vpmggWP5MU70QO6,25,30,17,18,15,0,12,0,92,13.142857142857142,3,0.0,13,17,9,15,17,0,9,12,0,54,38,0
3155,28923,zn2X74vvqUQRINz90WjZLsSsFglpYr7o,5Gyp41oLVo7Gg7vF4vpmggWP5MU70QO6,33,94,37,11,29,13,18,0,202,28.857142857142858,6,0.0,33,37,8,29,61,13,3,18,0,107,95,0
3156,28931,O5vskJ9Repv2jiK8J8yXq85Y8hYEu2dg,5Gyp41oLVo7Gg7vF4vpmggWP5MU70QO6,35,90,16,32,6,27,17,1,189,27.0,9,0.0,20,16,28,6,70,27,4,17,1,70,119,1
3157,28935,AsOtGuZjIIEs9Ge9E033Sbp9VeIeUiUH,5Gyp41oLVo7Gg7vF4vpmggWP5MU70QO6,2,0,0,0,0,0,2,0,2,0.2857142857142857,1,0.0,0,0,0,0,0,0,0,2,0,0,2,0
3158,28970,Qb2VAk3EqflWvF2aBP5imzRDjkUce9e9,5Gyp41oLVo7Gg7vF4vpmggWP5MU70QO6,30,38,10,37,16,0,5,0,106,15.142857142857142,7,0.0,7,10,28,16,31,0,9,5,0,61,45,1
3159,28971,ZRytVQUPgtfhKTh2gHAURcAThGLNgtND,5Gyp41oLVo7Gg7vF4vpmggWP5MU70QO6,11,4,3,0,3,0,4,1,15,2.142857142857143,1,0.0,0,3,0,3,4,0,0,4,1,6,9,1
3160,28978,YwMASqqYJxzRjuKe9JI9rWFNQbTS5tSD,5Gyp41oLVo7Gg7vF4vpmggWP5MU70QO6,17,19,12,8,4,0,4,0,47,6.714285714285714,3,0.0,2,12,7,4,17,0,1,4,0,25,22,1
3161,28994,gYuUT9QMr36TgMwrUR6D9cZmy4gnOehi,5Gyp41oLVo7Gg7vF4vpmggWP5MU70QO6,1,0,0,0,0,0,1,0,1,0.14285714285714285,1,0.0,0,0,0,0,0,0,0,1,0,0,1,1
3162,29004,qjHwo6vj8wB9RjaUFit8YYLku9NQ6yRr,5Gyp41oLVo7Gg7vF4vpmggWP5MU70QO6,6,6,2,0,2,0,3,0,13,1.8571428571428572,1,0.0,0,2,0,2,6,0,0,3,0,4,9,1
3163,29014,YZRgEIqleRNbrmIXR70msHxIqmdQTJEi,5Gyp41oLVo7Gg7vF4vpmggWP5MU70QO6,23,34,19,12,13,4,16,4,102,14.571428571428571,3,0.0,8,19,6,13,26,4,6,16,4,46,56,1
3164,29043,jtsbnKKZ9XPpwCclPqSDCMPCyLbC3Ksj,5Gyp41oLVo7Gg7vF4vpmggWP5MU70QO6,4,2,1,0,0,0,3,0,6,0.8571428571428571,2,0.0,0,1,0,0,2,0,0,3,0,1,5,1
3165,29059,O4E7as3W8jLvygS4k9RX6VKdAkX7GkpR,5Gyp41oLVo7Gg7vF4vpmggWP5MU70QO6,9,3,1,0,1,2,6,1,14,2.0,1,0.0,0,1,0,1,3,2,0,6,1,2,12,1
3166,29067,MYsCU1zkMrWxPhV1b7wSL5LZIo1zGyhU,5Gyp41oLVo7Gg7vF4vpmggWP5MU70QO6,21,30,14,0,16,0,6,0,66,9.428571428571429,5,0.0,5,14,0,16,25,0,0,6,0,35,31,1
3167,29105,2opAUoNSerHZgAopOdFnCtwADJEb5rjv,5Gyp41oLVo7Gg7vF4vpmggWP5MU70QO6,12,20,8,2,7,0,5,0,42,6.0,2,0.0,9,8,1,7,11,0,1,5,0,25,17,1
3168,29106,3yvPMapV0oGhFADehSUOgOal67P5QYOZ,5Gyp41oLVo7Gg7vF4vpmggWP5MU70QO6,8,3,1,0,1,2,6,1,14,2.0,1,0.0,0,1,0,1,3,2,0,6,1,2,12,1
3169,29118,5huQeH1wiIOmABPoRY4ZHf8AKpAeX6tY,5Gyp41oLVo7Gg7vF4vpmggWP5MU70QO6,12,14,9,0,2,5,10,1,41,5.857142857142857,4,0.0,0,9,0,2,14,5,0,10,1,11,30,1
3170,29122,y28h4Mo8cYpNiUreeF5KoyNN24Uz0qpM,5Gyp41oLVo7Gg7vF4vpmggWP5MU70QO6,24,59,29,24,1,0,25,0,138,19.714285714285715,7,0.0,12,29,20,1,47,0,4,25,0,62,76,1
3171,29134,j6yHCOz2971dxJ3D75B738Ui2dTUKwWK,5Gyp41oLVo7Gg7vF4vpmggWP5MU70QO6,1,0,0,0,0,0,1,0,1,0.14285714285714285,1,0.0,0,0,0,0,0,0,0,1,0,0,1,1
3172,29155,TUYpmTNk6Q7u0KzTuM5wULfxBnddBpQa,5Gyp41oLVo7Gg7vF4vpmggWP5MU70QO6,26,70,36,25,5,39,16,8,199,28.428571428571427,6,0.0,22,36,19,5,48,39,6,16,8,82,117,1
3173,29167,3SP9iNDvUt8m67ZMqC5DpQRe6ekkTpsP,5Gyp41oLVo7Gg7vF4vpmggWP5MU70QO6,5,2,1,0,1,0,5,0,9,1.2857142857142858,3,0.0,0,1,0,1,2,0,0,5,0,2,7,0
3174,29173,xJjW1X2F9FnPULUeJMqNeOytdLBSBRfA,5Gyp41oLVo7Gg7vF4vpmggWP5MU70QO6,33,93,49,26,24,42,23,2,259,37.0,10,0.0,16,49,16,24,77,42,10,23,2,105,154,0
3175,29176,z1G7LpYxsjwTZY4hppMJzutv7SFcW56t,5Gyp41oLVo7Gg7vF4vpmggWP5MU70QO6,11,14,5,6,3,0,2,0,30,4.285714285714286,2,0.0,4,5,3,3,10,0,3,2,0,15,15,1
3176,29193,Ff3Eor13TUJQKJ2fXrBcatS19PhaFPUY,5Gyp41oLVo7Gg7vF4vpmggWP5MU70QO6,6,3,2,0,1,0,2,0,8,1.1428571428571428,1,0.0,0,2,0,1,3,0,0,2,0,3,5,1
3177,29198,dT92IjRcuruPiAlpqVUTtu3wNL9IIegT,5Gyp41oLVo7Gg7vF4vpmggWP5MU70QO6,31,78,42,7,28,29,22,2,208,29.714285714285715,9,0.0,22,42,5,28,56,29,2,22,2,97,111,0
3178,29203,Fd76JNXzmmy6WMyqnUG7g2JlGziXBHRa,5Gyp41oLVo7Gg7vF4vpmggWP5MU70QO6,33,48,28,6,16,12,15,2,127,18.142857142857142,3,0.0,6,28,3,16,42,12,3,15,2,53,74,1
3179,29219,3h1FKqVdnDmZ3yTfOEvfGnfVX1CtMfQe,5Gyp41oLVo7Gg7vF4vpmggWP5MU70QO6,4,2,1,0,1,0,1,0,5,0.7142857142857143,1,0.0,0,1,0,1,2,0,0,1,0,2,3,1
3180,29228,j3GJZP6DDST4bxF4BY92UyMmGqZXcisu,5Gyp41oLVo7Gg7vF4vpmggWP5MU70QO6,18,63,30,10,11,8,15,2,139,19.857142857142858,8,0.0,13,30,7,11,50,8,3,15,2,61,78,1
3181,29231,9qSqrvUWqQapebc826sTRi4MoymfAgqm,5Gyp41oLVo7Gg7vF4vpmggWP5MU70QO6,6,5,3,0,1,0,1,0,10,1.4285714285714286,1,0.0,1,3,0,1,4,0,0,1,0,5,5,1
3182,29258,SSYZb9OF5KY8dLa1Ga5Owl0oYrKsZRGn,5Gyp41oLVo7Gg7vF4vpmggWP5MU70QO6,1,0,0,0,0,0,1,0,1,0.14285714285714285,1,0.0,0,0,0,0,0,0,0,1,0,0,1,1
3183,29259,Q7wqVDqz10tk4xe6QnkzI1dJqMLzdK4Z,5Gyp41oLVo7Gg7vF4vpmggWP5MU70QO6,43,136,67,56,46,38,42,2,387,55.285714285714285,9,0.0,52,67,41,46,84,38,15,42,2,206,181,0
3184,29260,qfe1MUR6a62dAgiCJR4API4cCHsYlsVO,5Gyp41oLVo7Gg7vF4vpmggWP5MU70QO6,50,128,72,43,27,19,35,0,324,46.285714285714285,11,0.0,27,72,32,27,101,19,11,35,0,158,166,0
3185,29270,yYvdpBKQCT3mxVBi4HL53T6yMUlPV3lV,5Gyp41oLVo7Gg7vF4vpmggWP5MU70QO6,7,5,2,0,2,0,2,0,11,1.5714285714285714,1,0.0,0,2,0,2,5,0,0,2,0,4,7,1
3186,29282,wxII2lcu70Ngy60gW8YUtG9pAurp2KE2,5Gyp41oLVo7Gg7vF4vpmggWP5MU70QO6,25,41,18,9,10,27,19,1,125,17.857142857142858,3,0.0,15,18,6,10,26,27,3,19,1,49,76,0
3187,29290,KQEanfaExp2HaRRw3kFa1StUZu1Jf6eb,5Gyp41oLVo7Gg7vF4vpmggWP5MU70QO6,7,3,2,0,2,0,3,0,10,1.4285714285714286,1,0.0,0,2,0,2,3,0,0,3,0,4,6,0
3188,29322,clBoQvHF7hj2lt9aMKUGNE4YYTF1KNgv,5Gyp41oLVo7Gg7vF4vpmggWP5MU70QO6,7,2,1,0,1,0,6,1,11,1.5714285714285714,2,0.0,0,1,0,1,2,0,0,6,1,2,9,1
3189,29323,S23VviJLUWhhZxkRbUP6UVbiLqWFCEzq,5Gyp41oLVo7Gg7vF4vpmggWP5MU70QO6,16,54,17,19,0,0,19,0,109,15.571428571428571,7,0.0,11,17,13,0,43,0,6,19,0,41,68,0
3190,29331,CfeENerIdAGepleePWSt0SV88ctt0Tmw,5Gyp41oLVo7Gg7vF4vpmggWP5MU70QO6,36,56,27,33,14,0,10,0,140,20.0,8,0.0,17,27,23,14,39,0,10,10,0,81,59,0
3191,29368,43Wkazohlla5UH9sdItyCzS7QnbvL5qv,5Gyp41oLVo7Gg7vF4vpmggWP5MU70QO6,5,2,1,0,1,0,2,0,6,0.8571428571428571,1,0.0,0,1,0,1,2,0,0,2,0,2,4,1
3192,29370,OGbthebNtjAyVjwwyFFOPyRN8eqkNKOX,5Gyp41oLVo7Gg7vF4vpmggWP5MU70QO6,2,0,0,0,0,0,5,0,5,0.7142857142857143,2,0.0,0,0,0,0,0,0,0,5,0,0,5,1
3193,29371,wEaTyOJwwvOCk7eUttQISK5WPXL7ANNV,5Gyp41oLVo7Gg7vF4vpmggWP5MU70QO6,8,3,2,0,2,3,6,0,16,2.2857142857142856,3,0.0,0,2,0,2,3,3,0,6,0,4,12,1
3194,29380,ebvWYER6Bde0EUcNXXIX0vyTB9ur6Kqi,5Gyp41oLVo7Gg7vF4vpmggWP5MU70QO6,29,86,42,22,18,47,20,2,237,33.857142857142854,5,0.0,25,42,14,18,61,47,8,20,2,99,138,0
3195,29382,bgQsXQVqW7nKiA6XYCj1PJIhNhYmFF2l,5Gyp41oLVo7Gg7vF4vpmggWP5MU70QO6,7,6,3,0,2,0,3,0,14,2.0,2,0.0,0,3,0,2,6,0,0,3,0,5,9,1
3196,29392,oEdWxTxTl1fP4jZhcgcYgWShP81rmHLb,5Gyp41oLVo7Gg7vF4vpmggWP5MU70QO6,35,55,28,36,7,0,7,0,133,19.0,6,0.0,18,28,29,7,37,0,7,7,0,82,51,0
3197,29398,AeCrxYByugIwu4XUBpI0LhoTguBozLAa,5Gyp41oLVo7Gg7vF4vpmggWP5MU70QO6,30,74,39,4,15,2,23,1,158,22.571428571428573,4,0.0,17,39,3,15,57,2,1,23,1,74,84,1
3198,29400,6oCPedN9dJXckwppJuquEbXGJo8RLgKS,5Gyp41oLVo7Gg7vF4vpmggWP5MU70QO6,10,8,3,0,1,1,4,1,18,2.5714285714285716,1,0.0,3,3,0,1,5,1,0,4,1,7,11,1
3199,29411,BdodnRCsey53xS6PtugKwlzojwI7pwLX,5Gyp41oLVo7Gg7vF4vpmggWP5MU70QO6,16,21,9,8,5,2,7,1,53,7.571428571428571,3,0.0,10,9,6,5,11,2,2,7,1,30,23,1
3200,29429,1Q6h3xdVmuuH4K91cf7ebDxMbyWSO6oC,5Gyp41oLVo7Gg7vF4vpmggWP5MU70QO6,3,3,0,0,0,0,1,0,4,0.5714285714285714,1,0.0,0,0,0,0,3,0,0,1,0,0,4,1
3201,29434,7aQ6rvmUrAZhXOumaP4VW6FvjX4qSmMG,5Gyp41oLVo7Gg7vF4vpmggWP5MU70QO6,28,67,28,17,19,9,19,1,160,22.857142857142858,6,0.0,17,28,14,19,50,9,3,19,1,78,82,0
3202,29436,of3rDqGvzfaaTw1dgLkUpAaYyPR92tjG,5Gyp41oLVo7Gg7vF4vpmggWP5MU70QO6,9,6,4,0,3,0,4,0,17,2.4285714285714284,2,0.0,0,4,0,3,6,0,0,4,0,7,10,1
3203,29446,YV392hfECoOmaAZdo0LSEB6pVt8DaTKa,5Gyp41oLVo7Gg7vF4vpmggWP5MU70QO6,11,6,4,0,3,0,5,0,18,2.5714285714285716,2,0.0,0,4,0,3,6,0,0,5,0,7,11,1
3204,29454,bf1vJ4viENhWXEbAPbJbIXhTELHnfeS4,5Gyp41oLVo7Gg7vF4vpmggWP5MU70QO6,1,0,0,0,0,0,1,0,1,0.14285714285714285,1,0.0,0,0,0,0,0,0,0,1,0,0,1,1
3205,29457,4m5GFuE7r7uv3mC9zYjUgCEig5epKquJ,5Gyp41oLVo7Gg7vF4vpmggWP5MU70QO6,28,55,33,35,11,0,17,0,151,21.571428571428573,7,0.0,10,33,25,11,45,0,10,17,0,79,72,0
3206,29460,9kWKUDsV7M3Xl925FSGZmKjgOHYDauwa,5Gyp41oLVo7Gg7vF4vpmggWP5MU70QO6,5,2,1,0,1,0,3,0,7,1.0,1,0.0,0,1,0,1,2,0,0,3,0,2,5,0
3207,29463,StB4aAmvKVcN39RyCivcWuZG1ojX62LP,5Gyp41oLVo7Gg7vF4vpmggWP5MU70QO6,12,7,5,0,4,0,4,1,21,3.0,1,0.0,0,5,0,4,7,0,0,4,1,9,12,1
3208,29479,ComEg5DwSZNvhCGBr5HiWi0eJvqzecfK,5Gyp41oLVo7Gg7vF4vpmggWP5MU70QO6,1,0,0,0,0,0,1,0,1,0.14285714285714285,1,0.0,0,0,0,0,0,0,0,1,0,0,1,1
3209,29486,USLTnsAwagwK2c83KXd1SNEeENnzkTTo,5Gyp41oLVo7Gg7vF4vpmggWP5MU70QO6,10,11,4,0,4,7,7,0,33,4.714285714285714,6,0.0,3,4,0,4,8,7,0,7,0,11,22,0
3210,29495,76h4fJa0WUda9eD251xcu8JxqYQOKc5R,5Gyp41oLVo7Gg7vF4vpmggWP5MU70QO6,1,0,0,0,0,0,2,0,2,0.2857142857142857,2,0.0,0,0,0,0,0,0,0,2,0,0,2,0
3211,29508,2NbXhEsOSF2oLrJt2BdmifqgcsW4T9D5,5Gyp41oLVo7Gg7vF4vpmggWP5MU70QO6,4,6,1,0,0,0,2,0,9,1.2857142857142858,1,0.0,4,1,0,0,2,0,0,2,0,5,4,1
3212,29528,TBC5WTDbcV3aVUUIUvUx97YEiYG5oye2,5Gyp41oLVo7Gg7vF4vpmggWP5MU70QO6,21,50,32,12,6,16,6,0,122,17.428571428571427,4,0.0,9,32,8,6,41,16,4,6,0,55,67,1
3213,29529,l8y9XhqsTWKZM98GIdD9TBmJPA1SlU5G,5Gyp41oLVo7Gg7vF4vpmggWP5MU70QO6,16,26,12,4,8,0,5,0,55,7.857142857142857,2,0.0,11,12,2,8,15,0,2,5,0,33,22,1
3214,29553,G6nlPCsxbn3tVSpDUhIRDWH9MFaFPV4K,5Gyp41oLVo7Gg7vF4vpmggWP5MU70QO6,1,0,0,0,0,0,1,0,1,0.14285714285714285,1,0.0,0,0,0,0,0,0,0,1,0,0,1,1
3215,29561,pLQfsJL46iqa9L7UfI8ODNozilMqoPl0,5Gyp41oLVo7Gg7vF4vpmggWP5MU70QO6,24,48,29,16,16,0,11,2,122,17.428571428571427,5,0.0,12,29,12,16,36,0,4,11,2,69,53,0
3216,29571,KVFLGfkLjESnixIuWE2enCugNN1bDzvq,5Gyp41oLVo7Gg7vF4vpmggWP5MU70QO6,43,132,65,59,23,5,33,2,319,45.57142857142857,10,0.0,36,65,47,23,96,5,12,33,2,171,148,0
3217,29594,TSPlBwReynnjQ2q72CnYFjLp85rX76cJ,5Gyp41oLVo7Gg7vF4vpmggWP5MU70QO6,2,0,0,0,0,0,2,0,2,0.2857142857142857,1,0.0,0,0,0,0,0,0,0,2,0,0,2,1
3218,29603,ERiNRhAcimB8GiumVAtTpcZJjnjuVuqO,3VkHkmOtom3jM2wCu94xgzzu1d6Dn7or,98,383,92,60,94,54,48,3,734,104.85714285714286,11,0.0,169,92,51,94,214,54,9,48,3,406,328,0
3219,29615,uc2JecHkP7BdqwAtRnvlH2Qn6D1UAeHx,3VkHkmOtom3jM2wCu94xgzzu1d6Dn7or,30,79,4,34,33,7,11,1,169,24.142857142857142,3,0.0,57,4,30,33,22,7,4,11,1,124,45,0
3220,29623,QbN1rcT6X70kGcCCu9qHO2zQXGCyhPMc,3VkHkmOtom3jM2wCu94xgzzu1d6Dn7or,71,376,50,54,39,28,69,8,624,89.14285714285714,18,0.0,99,50,49,39,277,28,5,69,8,237,387,0
3221,29640,G14xjTwMWbfsqTNiU3Ie1utHyPegqSvR,3VkHkmOtom3jM2wCu94xgzzu1d6Dn7or,69,146,9,68,57,33,12,0,325,46.42857142857143,8,0.0,52,9,65,57,94,33,3,12,0,183,142,1
3222,29652,ZRcEnEYSSBQbkjzMu7sidjbxasfrmw8l,3VkHkmOtom3jM2wCu94xgzzu1d6Dn7or,57,245,91,53,24,75,72,0,560,80.0,11,0.0,47,91,50,24,198,75,3,72,0,212,348,0
3223,29660,j8pAEG832Dxba9xvdSBnP5qKRrQfOVPx,3VkHkmOtom3jM2wCu94xgzzu1d6Dn7or,88,167,76,68,54,47,40,10,462,66.0,16,0.0,60,76,65,54,107,47,3,40,10,255,207,0
3224,29710,Dj6MZagDLXpRqHs1ziJsdRiKzK9FQr4E,3VkHkmOtom3jM2wCu94xgzzu1d6Dn7or,82,248,112,42,79,22,29,2,534,76.28571428571429,13,0.0,79,112,38,79,169,22,4,29,2,308,226,0
3225,29711,hn5H504xu7pHzMUOVhXt84Zd8pM4hTfO,3VkHkmOtom3jM2wCu94xgzzu1d6Dn7or,64,331,59,83,21,33,51,1,579,82.71428571428571,16,0.0,137,59,83,21,194,33,0,51,1,300,279,0
3226,29753,xXrVRzXnwBPVy7gMaBqKJcUodoANmGAp,3VkHkmOtom3jM2wCu94xgzzu1d6Dn7or,94,221,125,127,85,35,47,2,642,91.71428571428571,9,0.0,69,125,112,85,152,35,15,47,2,391,251,0
3227,29773,MRCD9XxqQVpIexf9EdSwdaoHW691k7OH,3VkHkmOtom3jM2wCu94xgzzu1d6Dn7or,56,199,75,152,0,0,15,0,441,63.0,10,0.0,84,75,139,0,115,0,13,15,0,298,143,0
3228,29779,BMm4TXqDDPzNdjhOhmJHUopJaVFMX2Fi,3VkHkmOtom3jM2wCu94xgzzu1d6Dn7or,37,122,43,45,47,40,30,0,327,46.714285714285715,8,0.0,61,43,39,47,61,40,6,30,0,190,137,0
3229,29831,e3jyk3cEmLPB3vUaF04lE0JygxYvGYSB,3VkHkmOtom3jM2wCu94xgzzu1d6Dn7or,2,0,0,0,0,0,2,0,2,0.2857142857142857,1,0.0,0,0,0,0,0,0,0,2,0,0,2,1
3230,29834,eSLdnCsz2kfsBjZ0LZmqHuo4kYNor6E7,3VkHkmOtom3jM2wCu94xgzzu1d6Dn7or,49,124,16,34,8,31,17,0,230,32.857142857142854,9,0.0,39,16,34,8,85,31,0,17,0,97,133,1
3231,29839,cRaVLabX771mlZBzFVbphmCLcsSt1u7U,3VkHkmOtom3jM2wCu94xgzzu1d6Dn7or,83,380,80,93,46,9,96,3,707,101.0,12,0.0,135,80,87,46,245,9,6,96,3,348,359,1
3232,29859,7cYcOHOEHTj81GR9iJWLLP6E0QCPSEZI,3VkHkmOtom3jM2wCu94xgzzu1d6Dn7or,92,386,56,165,52,21,94,4,778,111.14285714285714,13,0.0,120,56,156,52,266,21,9,94,4,384,394,0
3233,29862,1umo7etGwkx7NcpFxVialzDD37NdyqRT,3VkHkmOtom3jM2wCu94xgzzu1d6Dn7or,44,112,40,79,0,34,22,4,291,41.57142857142857,6,0.0,59,40,75,0,53,34,4,22,4,174,117,0
3234,29901,1LkyopMOf8KZ37c5gNSy63BKRJpsqu4r,3VkHkmOtom3jM2wCu94xgzzu1d6Dn7or,91,356,116,116,128,8,43,0,767,109.57142857142857,8,0.0,210,116,106,128,146,8,10,43,0,560,207,0
3235,29905,J1iCM60eAwVKTPRoP9hdyFlEQf6db3YF,3VkHkmOtom3jM2wCu94xgzzu1d6Dn7or,89,159,45,70,69,3,18,1,365,52.142857142857146,6,0.0,104,45,65,69,55,3,5,18,1,283,82,0
3236,29907,7V4dcaUNsItviw8DzarHDLmlVXnKNzmD,3VkHkmOtom3jM2wCu94xgzzu1d6Dn7or,6,2,2,0,1,0,8,0,13,1.8571428571428572,1,0.0,0,2,0,1,2,0,0,8,0,3,10,1
3237,29931,mRXqdZHYKT0RihxxoCUoovr8vUKN1zpb,3VkHkmOtom3jM2wCu94xgzzu1d6Dn7or,80,390,19,72,23,20,16,5,545,77.85714285714286,8,0.0,157,19,60,23,233,20,12,16,5,259,286,0
3238,29937,kNdT4Mob6J1VkdvqbhmS4aPzbDLqNeYP,3VkHkmOtom3jM2wCu94xgzzu1d6Dn7or,98,277,121,105,88,23,105,1,720,102.85714285714286,22,0.0,86,121,91,88,191,23,14,105,1,386,334,0
3239,29953,wr8WXMW1aPIOlA7JAe7Pc60PLuoPom1V,3VkHkmOtom3jM2wCu94xgzzu1d6Dn7or,30,73,19,19,28,10,21,1,171,24.428571428571427,4,0.0,46,19,18,28,27,10,1,21,1,111,60,1
3240,29989,81MrJTtJ3gigKP7Iz9fJFypIyjsrSPC5,3VkHkmOtom3jM2wCu94xgzzu1d6Dn7or,1,0,0,0,0,0,1,0,1,0.14285714285714285,1,0.0,0,0,0,0,0,0,0,1,0,0,1,1
3241,30002,gD7dR7qYBA1tFY5jHEs9UR01plTA8iId,3VkHkmOtom3jM2wCu94xgzzu1d6Dn7or,73,173,43,88,63,6,18,2,393,56.142857142857146,9,0.0,109,43,76,63,64,6,12,18,2,291,102,0
3242,30005,k7GcrgNM8NrAzS9cqFwxMdS1Vs120F2Y,3VkHkmOtom3jM2wCu94xgzzu1d6Dn7or,63,203,40,66,46,58,31,4,448,64.0,5,0.0,98,40,60,46,105,58,6,31,4,244,204,1
3243,30024,w8ZFhN1TfPEk3lRT4vyoUkNMZOvvywKH,3VkHkmOtom3jM2wCu94xgzzu1d6Dn7or,9,15,5,0,3,4,14,1,42,6.0,1,0.0,6,5,0,3,9,4,0,14,1,14,28,1
3244,30031,e6vc9r1qQ4KcnjRUHEG8vhe39kn3GgXy,3VkHkmOtom3jM2wCu94xgzzu1d6Dn7or,4,2,1,0,1,0,1,0,5,0.7142857142857143,1,0.0,0,1,0,1,2,0,0,1,0,2,3,1
3245,30036,ZRMCnJcNKBuzAyov9v96PceQIVaMcHkt,3VkHkmOtom3jM2wCu94xgzzu1d6Dn7or,6,1,1,0,1,0,5,0,8,1.1428571428571428,1,0.0,0,1,0,1,1,0,0,5,0,2,6,1
3246,30062,bC7hHsLc1Hrq0XtHC39FlQ3EKRZvGnuJ,3VkHkmOtom3jM2wCu94xgzzu1d6Dn7or,65,170,87,112,35,41,33,1,479,68.42857142857143,7,0.0,55,87,97,35,115,41,15,33,1,274,205,0
3247,30077,RzMIvT7jMzqf1FBzeYDC0G8NjaFmpbg8,3VkHkmOtom3jM2wCu94xgzzu1d6Dn7or,74,84,38,60,31,29,21,9,272,38.857142857142854,5,0.0,28,38,52,31,56,29,8,21,9,149,123,0
3248,30121,eCJEYxlte8R6sbqh66Nohv34rvkne1DG,3VkHkmOtom3jM2wCu94xgzzu1d6Dn7or,55,107,56,20,38,38,22,0,281,40.142857142857146,8,0.0,34,56,20,38,73,38,0,22,0,148,133,0
3249,30122,kFzEt3qwJsqHITD5QhkyDtVLrUnmyio7,3VkHkmOtom3jM2wCu94xgzzu1d6Dn7or,1,0,0,0,0,0,1,0,1,0.14285714285714285,1,0.0,0,0,0,0,0,0,0,1,0,0,1,1
3250,30146,ihsYc42XAm1ifDUhRQivHQthyMkuHYKA,3VkHkmOtom3jM2wCu94xgzzu1d6Dn7or,97,156,51,81,61,7,37,10,403,57.57142857142857,5,0.0,84,51,67,61,72,7,14,37,10,263,140,0
3251,30153,IFqWOl32JJm0W3Ap2jxVCpJeXeLJlYDp,3VkHkmOtom3jM2wCu94xgzzu1d6Dn7or,1,0,0,0,0,0,1,0,1,0.14285714285714285,1,0.0,0,0,0,0,0,0,0,1,0,0,1,1
3252,30157,susC0ktJSdFusCIZajPDx4pMj5qgCOcg,3VkHkmOtom3jM2wCu94xgzzu1d6Dn7or,94,212,85,54,55,30,65,1,502,71.71428571428571,22,0.0,89,85,50,55,123,30,4,65,1,279,223,0
3253,30166,8uKfJT3Ferex7gSStlreZzcbQrGyXHDu,3VkHkmOtom3jM2wCu94xgzzu1d6Dn7or,73,165,74,46,60,46,31,2,424,60.57142857142857,14,0.0,67,74,44,60,98,46,2,31,2,245,179,0
3254,30209,ZECsrQDWNf4nPUfo4HpZsLiXc2swEQ6q,3VkHkmOtom3jM2wCu94xgzzu1d6Dn7or,10,24,10,2,8,9,9,0,62,8.857142857142858,3,0.0,10,10,2,8,14,9,0,9,0,30,32,0
3255,30232,NKFrndcZRT8yziegfa31eLoFHGGlUjfW,3VkHkmOtom3jM2wCu94xgzzu1d6Dn7or,5,2,0,0,1,0,6,0,9,1.2857142857142858,1,0.0,0,0,0,1,2,0,0,6,0,1,8,1
3256,30237,f71JJWdw4RL398VAk1Uh1TemaAWJWYXn,3VkHkmOtom3jM2wCu94xgzzu1d6Dn7or,5,8,4,0,1,0,3,0,16,2.2857142857142856,3,0.0,1,4,0,1,7,0,0,3,0,6,10,0
3257,30250,1F8H7rmfvGmKxlm2143vBRoEH3vbZnuH,3VkHkmOtom3jM2wCu94xgzzu1d6Dn7or,8,7,0,0,0,9,10,1,27,3.857142857142857,3,0.0,1,0,0,0,6,9,0,10,1,1,26,1
3258,30266,EzVMqBDdKdZIxkwWCIERgvsBQFIRLYcU,3VkHkmOtom3jM2wCu94xgzzu1d6Dn7or,63,114,39,72,41,3,27,1,297,42.42857142857143,7,0.0,51,39,69,41,63,3,3,27,1,200,97,0
3259,30272,c45tGE4X33f1wuWJww6KL4YDWdrZudFS,3VkHkmOtom3jM2wCu94xgzzu1d6Dn7or,89,410,133,44,89,44,57,2,779,111.28571428571429,18,0.0,150,133,38,89,260,44,6,57,2,410,369,0
3260,30277,pMv1oQj1T6gZE30FoEj4M5Nwt7Fl1qeo,3VkHkmOtom3jM2wCu94xgzzu1d6Dn7or,70,281,100,35,52,70,40,7,585,83.57142857142857,9,0.0,94,100,29,52,187,70,6,40,7,275,310,0
3261,30289,Rdvgrardg53H2oeCgmOt8vFxIUu5nogb,3VkHkmOtom3jM2wCu94xgzzu1d6Dn7or,80,224,74,85,79,23,41,4,530,75.71428571428571,13,0.0,124,74,62,79,100,23,23,41,4,339,191,0
3262,30319,Z2WeYOt69iXKJ7H2QQouqRTK4XZZJKWP,3VkHkmOtom3jM2wCu94xgzzu1d6Dn7or,32,73,20,20,30,10,9,0,162,23.142857142857142,8,0.0,26,20,17,30,47,10,3,9,0,93,69,1
3263,30325,3IgwuZBiVdgdYRQ9ySaEvpMizbjCJFS0,3VkHkmOtom3jM2wCu94xgzzu1d6Dn7or,81,131,48,86,31,37,76,2,411,58.714285714285715,12,0.0,34,48,83,31,97,37,3,76,2,196,215,0
3264,30336,QwzgqwSHCQGBlqpFzwe8sYcM8CZG7iZ9,3VkHkmOtom3jM2wCu94xgzzu1d6Dn7or,32,71,32,16,22,25,16,0,182,26.0,4,0.0,27,32,14,22,44,25,2,16,0,95,87,1
3265,30359,lCdFdlJk7vdaCNir9ichM9R3abkujsQJ,3VkHkmOtom3jM2wCu94xgzzu1d6Dn7or,11,14,5,1,5,4,5,2,36,5.142857142857143,1,0.0,8,5,1,5,6,4,0,5,2,19,17,0
3266,30366,aEIhL4b7R0jCP14Ucbi8EaRq7CzwvPlv,3VkHkmOtom3jM2wCu94xgzzu1d6Dn7or,81,248,95,41,79,108,69,4,644,92.0,12,0.0,113,95,39,79,135,108,2,69,4,326,318,0
3267,30376,pfD3zHiFZnj6cBjjOBS9YbsS1DIwlvbH,3VkHkmOtom3jM2wCu94xgzzu1d6Dn7or,13,42,15,10,7,18,22,0,114,16.285714285714285,4,0.0,10,15,8,7,32,18,2,22,0,40,74,1
3268,30380,aNkyAzI9nPsd5pfu7g1LebeN06BtIXr6,3VkHkmOtom3jM2wCu94xgzzu1d6Dn7or,85,185,100,51,66,44,72,18,536,76.57142857142857,16,0.0,54,100,48,66,131,44,3,72,18,268,268,0
3269,30389,dY4494YE2fVYFC6x5i5x0UProy3lTpSi,3VkHkmOtom3jM2wCu94xgzzu1d6Dn7or,4,2,0,0,0,0,2,0,4,0.5714285714285714,1,0.0,0,0,0,0,2,0,0,2,0,0,4,1
3270,30402,d7CRMAVRgBps84fhYwYVHXr4TrIkJYDp,3VkHkmOtom3jM2wCu94xgzzu1d6Dn7or,78,239,17,81,17,0,25,0,379,54.142857142857146,11,0.0,83,17,77,17,156,0,4,25,0,194,185,0
3271,30406,24UY1ChPkZROri1FK7qbly95xg2qveYr,3VkHkmOtom3jM2wCu94xgzzu1d6Dn7or,1,0,0,0,0,0,1,0,1,0.14285714285714285,1,0.0,0,0,0,0,0,0,0,1,0,0,1,1
3272,30412,gl2YVlebVAvCcxsYaIoTwLj5l1IGqntH,3VkHkmOtom3jM2wCu94xgzzu1d6Dn7or,97,413,103,127,111,98,48,6,906,129.42857142857142,16,0.0,169,103,107,111,244,98,20,48,6,490,416,0
3273,30435,FRmbznbV6x9Ojz1brfaBTFmC2TFyzd4t,3VkHkmOtom3jM2wCu94xgzzu1d6Dn7or,61,141,70,38,63,58,10,1,381,54.42857142857143,8,0.0,54,70,33,63,87,58,5,10,1,220,161,0
3274,30459,N5ZyEwF2fjxmUbb8vyfWMYkhLQ0lBJZV,3VkHkmOtom3jM2wCu94xgzzu1d6Dn7or,7,9,5,0,2,0,9,0,25,3.5714285714285716,4,0.0,0,5,0,2,9,0,0,9,0,7,18,1
3275,30473,hf7YI3B1kTTuvmd2vS9DIoiPGXbrQyBH,3VkHkmOtom3jM2wCu94xgzzu1d6Dn7or,90,190,65,71,68,43,59,1,497,71.0,11,0.0,97,65,59,68,93,43,12,59,1,289,208,0
3276,30475,kHp5QZURLzbWn4koqFYZnQmO0kliz5hb,3VkHkmOtom3jM2wCu94xgzzu1d6Dn7or,80,177,82,39,75,16,43,2,434,62.0,14,0.0,59,82,38,75,118,16,1,43,2,254,180,0
3277,30485,tWy6K2sNXVB2esbGJMyXdZRQGH2Klw9e,3VkHkmOtom3jM2wCu94xgzzu1d6Dn7or,7,6,2,0,1,0,5,0,14,2.0,1,0.0,0,2,0,1,6,0,0,5,0,3,11,1
3278,30546,GW33fgaq0ndGNQkirzfpXhCeUuV3tuD2,3VkHkmOtom3jM2wCu94xgzzu1d6Dn7or,49,149,23,50,47,0,15,0,284,40.57142857142857,4,0.0,114,23,44,47,35,0,6,15,0,228,56,0
3279,30554,AFUJTbEqqgSsqCkUsNrjbPAjZvFwpzeW,3VkHkmOtom3jM2wCu94xgzzu1d6Dn7or,75,293,84,46,51,52,26,0,552,78.85714285714286,14,0.0,101,84,44,51,192,52,2,26,0,280,272,0
3280,30572,scAA3eCOIxJ3zzrtEoo95EWQriP778zG,3VkHkmOtom3jM2wCu94xgzzu1d6Dn7or,5,2,1,0,1,0,4,0,8,1.1428571428571428,1,0.0,0,1,0,1,2,0,0,4,0,2,6,1
3281,30589,4cHW06tF9KqyuTTBOtufVP4zE7Ryeghw,3VkHkmOtom3jM2wCu94xgzzu1d6Dn7or,1,0,0,0,0,0,1,0,1,0.14285714285714285,1,0.0,0,0,0,0,0,0,0,1,0,0,1,1
3282,30597,cGrHiRjztN9fSltHujpfWaaWfYWiidiG,3VkHkmOtom3jM2wCu94xgzzu1d6Dn7or,5,5,2,0,1,0,3,0,11,1.5714285714285714,3,0.0,0,2,0,1,5,0,0,3,0,3,8,1
3283,30619,e2CxwSKYgRRxAYL99ajalycn9caM2cox,3VkHkmOtom3jM2wCu94xgzzu1d6Dn7or,93,320,136,76,83,73,139,5,832,118.85714285714286,12,0.0,88,136,71,83,232,73,5,139,5,378,454,0
3284,30639,kXhNP73v7uspLkRCBOTheP3K82COFCXM,3VkHkmOtom3jM2wCu94xgzzu1d6Dn7or,1,0,0,0,0,0,1,0,1,0.14285714285714285,1,0.0,0,0,0,0,0,0,0,1,0,0,1,1
3285,30650,XDPvGyFLLEYwbNEQik2MM4yiADs5rrYJ,3VkHkmOtom3jM2wCu94xgzzu1d6Dn7or,96,295,123,56,84,76,44,2,680,97.14285714285714,13,0.0,120,123,47,84,175,76,9,44,2,374,306,0
3286,30651,EIH1YpezRj2Lrs71q1s3kjWajWGWK1FM,7GRhBDsirIGkRZBtSMEzNTyDr2JQm4xx,12,10,4,2,4,0,3,0,23,3.2857142857142856,2,0.0,1,4,1,4,9,0,1,3,0,10,13,1
3287,30652,c0SE05tRjiEOaThvWcYxSYbAxboLNaZo,7GRhBDsirIGkRZBtSMEzNTyDr2JQm4xx,28,57,5,40,9,7,46,5,169,24.142857142857142,5,0.0,29,5,35,9,28,7,5,46,5,78,91,0
3288,30655,QWxefOu3r3jtQwuYDDkGQhRP3ua789Nr,7GRhBDsirIGkRZBtSMEzNTyDr2JQm4xx,38,76,36,35,32,3,6,0,188,26.857142857142858,1,0.0,34,36,30,32,42,3,5,6,0,132,56,1
3289,30661,Da2YYkrh9YuRinihWxRQSQhXAdFeKqSb,7GRhBDsirIGkRZBtSMEzNTyDr2JQm4xx,11,9,3,8,4,0,3,0,27,3.857142857142857,2,0.0,3,3,6,4,6,0,2,3,0,16,11,0
3290,30662,4Y6ySID5iQf80xGHEGKPq13tPSHHOAOF,7GRhBDsirIGkRZBtSMEzNTyDr2JQm4xx,85,204,62,122,33,5,16,0,442,63.142857142857146,10,0.0,49,62,97,33,155,5,25,16,0,241,201,0
3291,30667,bZyhF0wh1Z5xsDdkLXcv5kZpz8OlyTUC,7GRhBDsirIGkRZBtSMEzNTyDr2JQm4xx,2,0,0,0,0,0,4,0,4,0.5714285714285714,2,0.0,0,0,0,0,0,0,0,4,0,0,4,1
3292,30674,LGyJGu5Vh9U7ZSPgCkmfu19mVc6YLiy5,7GRhBDsirIGkRZBtSMEzNTyDr2JQm4xx,1,0,0,0,0,0,1,0,1,0.14285714285714285,1,0.0,0,0,0,0,0,0,0,1,0,0,1,1
3293,30675,I0BSd7K17Qe32CsFChIMhJ2Ad5mDVGH4,7GRhBDsirIGkRZBtSMEzNTyDr2JQm4xx,1,0,0,0,0,0,2,0,2,0.2857142857142857,2,0.0,0,0,0,0,0,0,0,2,0,0,2,0
3294,30678,NJshoJ6m7AZhe0j0U3bDZnUZPFMsGEOR,7GRhBDsirIGkRZBtSMEzNTyDr2JQm4xx,2,0,0,0,0,0,2,0,2,0.2857142857142857,1,0.0,0,0,0,0,0,0,0,2,0,0,2,1
3295,30680,iJTPTm9uth33u1s6dPCN0IdL3eivCytM,7GRhBDsirIGkRZBtSMEzNTyDr2JQm4xx,34,47,17,18,16,3,8,1,110,15.714285714285714,2,0.0,22,17,9,16,25,3,9,8,1,64,46,0
3296,30686,uC8uJ021SOxH9uBG1YrO6FA0gR4l0XFz,7GRhBDsirIGkRZBtSMEzNTyDr2JQm4xx,26,36,14,6,13,0,7,0,76,10.857142857142858,2,0.0,21,14,3,13,15,0,3,7,0,51,25,1
3297,30690,AcpmcKbkGL0wHG2z3MmcGuG9z6KsBEJe,7GRhBDsirIGkRZBtSMEzNTyDr2JQm4xx,84,167,77,144,46,10,32,0,476,68.0,17,0.0,67,77,122,46,100,10,22,32,0,312,164,0
3298,30691,mhedqQ7gvHm4ctTyPUkSQewU6keGOdwI,7GRhBDsirIGkRZBtSMEzNTyDr2JQm4xx,5,2,1,0,1,0,2,0,6,0.8571428571428571,1,0.0,0,1,0,1,2,0,0,2,0,2,4,0
3299,30694,z3Cn7RWIM1WhSLCs4j2aJNntpjbu5ZKv,7GRhBDsirIGkRZBtSMEzNTyDr2JQm4xx,1,0,0,0,0,0,1,0,1,0.14285714285714285,1,0.0,0,0,0,0,0,0,0,1,0,0,1,1
3300,30695,uqA5Smdw6BACOcL0f2tmxwTTxZXBpZpE,7GRhBDsirIGkRZBtSMEzNTyDr2JQm4xx,23,34,12,12,12,6,2,0,78,11.142857142857142,2,0.0,17,12,7,12,17,6,5,2,0,48,30,1
3301,30696,IN0Z0VnhwV4yFGii2PrIUyIWqHFlYB2G,7GRhBDsirIGkRZBtSMEzNTyDr2JQm4xx,13,31,14,0,11,0,6,0,62,8.857142857142858,1,0.0,2,14,0,11,29,0,0,6,0,27,35,1
3302,30705,QZYzE4vnJ7EgZqC8YhvEUgm5GIQjclUD,7GRhBDsirIGkRZBtSMEzNTyDr2JQm4xx,15,36,8,15,0,0,1,0,60,8.571428571428571,3,0.0,23,8,11,0,13,0,4,1,0,42,18,0
3303,30708,mAAuxtPoEddxQ2jPmf6WwqHOgdvhqrk2,7GRhBDsirIGkRZBtSMEzNTyDr2JQm4xx,44,55,29,28,23,8,20,0,163,23.285714285714285,2,0.0,16,29,15,23,39,8,13,20,0,83,80,0
3304,30713,yIe8CIBbEe5pUDhYQ62d08qwZaeKb97Q,7GRhBDsirIGkRZBtSMEzNTyDr2JQm4xx,18,12,6,0,5,6,12,1,42,6.0,1,0.0,1,6,0,5,11,6,0,12,1,12,30,1
3305,30717,Upqz62cwWKexlUMk4uvP9aosOnbcADgX,7GRhBDsirIGkRZBtSMEzNTyDr2JQm4xx,133,235,40,245,42,3,33,0,598,85.42857142857143,11,0.0,111,40,217,42,124,3,28,33,0,410,188,0
3306,30719,tC06tDcyfiakkQ82nvNuQ9hOr0id1lp4,7GRhBDsirIGkRZBtSMEzNTyDr2JQm4xx,1,0,0,0,0,0,1,0,1,0.14285714285714285,1,0.0,0,0,0,0,0,0,0,1,0,0,1,1
3307,30721,PlTEJVk9UB3szf9krJ2h1eGbVaZh7tmN,7GRhBDsirIGkRZBtSMEzNTyDr2JQm4xx,6,5,0,0,0,0,3,0,8,1.1428571428571428,1,0.0,1,0,0,0,4,0,0,3,0,1,7,1
3308,30722,N0Sos51WanCzoSGKDmMPzQtMlLxY3bFb,7GRhBDsirIGkRZBtSMEzNTyDr2JQm4xx,160,419,165,246,101,72,102,3,1108,158.28571428571428,16,0.0,185,165,211,101,234,72,35,102,3,662,446,0
3309,30724,Cdp3gxqrAuRwjOLmDu9YrutxbWvuOM9e,7GRhBDsirIGkRZBtSMEzNTyDr2JQm4xx,28,54,2,0,1,3,15,1,76,10.857142857142858,5,0.0,0,2,0,1,54,3,0,15,1,3,73,0
3310,30728,nvkZualT21HB5Rfz2UHfUefEU1tUi2bn,7GRhBDsirIGkRZBtSMEzNTyDr2JQm4xx,1,0,0,0,0,0,1,0,1,0.14285714285714285,1,0.0,0,0,0,0,0,0,0,1,0,0,1,1
3311,30729,dbYop9S01uTyhYqkpGR8ejdLbOiTT1Mo,7GRhBDsirIGkRZBtSMEzNTyDr2JQm4xx,65,111,34,32,41,0,7,0,225,32.142857142857146,1,0.0,29,34,19,41,82,0,13,7,0,123,102,1
3312,30730,NoqigwhYAB9TtnANg1WMYh4zsRGoOl0D,7GRhBDsirIGkRZBtSMEzNTyDr2JQm4xx,92,146,67,64,59,0,29,0,365,52.142857142857146,7,0.0,63,67,48,59,83,0,16,29,0,237,128,0
3313,30731,WkYiyZ27gM6YIccScp8t28IowVqS3ZFY,7GRhBDsirIGkRZBtSMEzNTyDr2JQm4xx,26,38,16,12,19,0,25,0,110,15.714285714285714,4,0.0,17,16,6,19,21,0,6,25,0,58,52,0
3314,30733,9GVWhCbqivE4bnCr9NW81pWzAvrdhoCR,7GRhBDsirIGkRZBtSMEzNTyDr2JQm4xx,22,22,7,12,7,0,3,0,51,7.285714285714286,2,0.0,12,7,6,7,10,0,6,3,0,32,19,1
3315,30735,8ggJCfrYr10gnmbgAYh6GvemUAfmw7Yw,7GRhBDsirIGkRZBtSMEzNTyDr2JQm4xx,5,2,1,0,1,0,2,0,6,0.8571428571428571,1,0.0,0,1,0,1,2,0,0,2,0,2,4,0
3316,30737,MawTy0UaNMzLOBBaurqND3JymILXKOHX,7GRhBDsirIGkRZBtSMEzNTyDr2JQm4xx,6,7,2,0,2,0,1,0,12,1.7142857142857142,1,0.0,1,2,0,2,6,0,0,1,0,5,7,1
3317,30742,m7YQyhtMcEUVm4YEl0ls7E37ljO7KzRy,7GRhBDsirIGkRZBtSMEzNTyDr2JQm4xx,75,246,91,110,32,50,30,0,559,79.85714285714286,13,0.0,106,91,99,32,140,50,11,30,0,328,231,0
3318,30747,tLopTDeUShprCRgfwS3p7Zbir4u3Yxe8,7GRhBDsirIGkRZBtSMEzNTyDr2JQm4xx,21,23,14,6,10,0,4,0,57,8.142857142857142,3,0.0,5,14,5,10,18,0,1,4,0,34,23,1
3319,30750,yk7hISr9k5KlTllac6P28wE1wuN0cd27,7GRhBDsirIGkRZBtSMEzNTyDr2JQm4xx,93,254,27,230,63,34,27,1,636,90.85714285714286,10,0.0,162,27,198,63,92,34,32,27,1,450,186,0
3320,30755,Uox6u1DdfnsZf4RbnG5MWpVhHzZxTTMJ,7GRhBDsirIGkRZBtSMEzNTyDr2JQm4xx,30,22,13,12,9,0,2,0,58,8.285714285714286,1,0.0,3,13,6,9,19,0,6,2,0,31,27,0
3321,30756,5He5r20lSAk84shJAoxdWcVq0zVfBWNL,7GRhBDsirIGkRZBtSMEzNTyDr2JQm4xx,58,119,45,135,9,76,17,0,401,57.285714285714285,7,0.0,35,45,114,9,84,76,21,17,0,203,198,0
3322,30774,NItKuQnswT2hTrMboHQ1dYUDjy7jkHKK,5X6FeZozNMgE2VRi3MJYjkkFK8SETtu2,14,29,2,10,6,0,4,0,51,7.285714285714286,3,0.0,15,2,10,6,14,0,0,4,0,33,18,0
3323,30776,YtymNq1ebo5JQ6VlWg3H52cMIU1je3tP,SpATywNh6bZuzm8s1ceuBUnMUAeoAHHw,44,59,41,39,29,3,4,0,175,25.0,6,0.0,10,41,35,29,49,3,4,4,0,115,60,0
3324,30784,SmONSyS4YgG4Afnv6ZxU81t7p4CQPV5P,SpATywNh6bZuzm8s1ceuBUnMUAeoAHHw,56,111,35,40,19,5,21,4,235,33.57142857142857,4,0.0,22,35,35,19,89,5,5,21,4,111,124,1
3325,30796,LlNl7SWBVAnoKfzeJybnj6blD2Rxs5PY,SpATywNh6bZuzm8s1ceuBUnMUAeoAHHw,3,0,0,0,0,3,2,0,5,0.7142857142857143,1,0.0,0,0,0,0,0,3,0,2,0,0,5,0
3326,30797,S0OJjF6aof0iTnIX6lUAxekoH3m4w7V0,bWdj2GDclj5ofokWjzoa5jAwMkxCykd6,94,106,55,195,17,61,40,1,475,67.85714285714286,10,0.0,18,55,169,17,88,61,26,40,1,259,216,0
3327,30803,Tn7o6GJak1Gmr4wNNrXvcX0HbnjY9Sxn,SpATywNh6bZuzm8s1ceuBUnMUAeoAHHw,22,15,13,3,11,0,1,0,43,6.142857142857143,1,0.0,0,13,3,11,15,0,0,1,0,27,16,1
3328,30809,j9gdcEQiWF4hz17rFxv9vKJSxkrv7Ewo,SpATywNh6bZuzm8s1ceuBUnMUAeoAHHw,10,11,0,10,0,0,3,0,24,3.4285714285714284,2,0.0,2,0,9,0,9,0,1,3,0,11,13,1
3329,30824,VpttOLX6WfGZBZLZt8acfk7430VwqHRi,RXDvfPUBYFlVdlueBFbLW0mhhAyGEqpt,100,195,82,285,42,64,35,1,704,100.57142857142857,9,0.0,45,82,268,42,150,64,17,35,1,437,267,1
3330,30827,pcLKeuvqYxK7totS6nb5Fz5ynJdfYz49,SpATywNh6bZuzm8s1ceuBUnMUAeoAHHw,51,149,48,48,17,21,81,4,368,52.57142857142857,7,0.0,54,48,41,17,95,21,7,81,4,160,208,0
3331,30828,gzQNFFC8T7d59sfgG4kPN8hBQX6lAQIT,SpATywNh6bZuzm8s1ceuBUnMUAeoAHHw,5,4,1,0,1,0,2,0,8,1.1428571428571428,2,0.0,0,1,0,1,4,0,0,2,0,2,6,1
3332,30830,Uj0YzcfvBcWRuM5ooqhtOKSU0RtOgHEO,SpATywNh6bZuzm8s1ceuBUnMUAeoAHHw,37,30,23,14,13,0,7,0,87,12.428571428571429,6,0.0,1,23,13,13,29,0,1,7,0,50,37,0
3333,30839,zxhCxWOnrbJdwphyxiWOTikBBavurNb0,5X6FeZozNMgE2VRi3MJYjkkFK8SETtu2,12,50,11,0,6,0,4,0,71,10.142857142857142,2,0.0,17,11,0,6,33,0,0,4,0,34,37,1
3334,30842,aacyvESmAfP5D5oPQjdLdL2QR8GRVLet,SpATywNh6bZuzm8s1ceuBUnMUAeoAHHw,46,143,84,33,43,55,21,1,380,54.285714285714285,8,0.0,17,84,30,43,126,55,3,21,1,174,206,0
3335,30844,BzAEXi273boWm5fg8ZX5MfzoC5AJdE3M,SpATywNh6bZuzm8s1ceuBUnMUAeoAHHw,29,30,20,23,10,2,12,0,97,13.857142857142858,4,0.0,4,20,21,10,26,2,2,12,0,55,42,1
3336,30851,dEqFTu442IbDfPtop0GcM4lzz1lxVMo1,7GRhBDsirIGkRZBtSMEzNTyDr2JQm4xx,66,203,70,95,26,5,12,0,411,58.714285714285715,15,0.0,67,70,82,26,136,5,13,12,0,245,166,0
3337,30861,Ip3irZsxFvOeGg8WSppVhJArbPhoH3qm,SpATywNh6bZuzm8s1ceuBUnMUAeoAHHw,46,112,52,52,18,10,28,3,275,39.285714285714285,6,0.0,35,52,47,18,77,10,5,28,3,152,123,0
3338,30862,taSkisHl0G5JCCHJPpf0V6gTIns3xoNL,A3fsA9Zfv1X2fVEQhTw51lKENdNrEqT3,21,16,11,0,9,0,4,0,40,5.714285714285714,3,0.0,0,11,0,9,16,0,0,4,0,20,20,0
3339,30863,fNmGVV6MRGGszmFrd5pppYkCKug9pQqa,A3fsA9Zfv1X2fVEQhTw51lKENdNrEqT3,23,27,1,0,1,0,13,3,45,6.428571428571429,3,0.0,3,1,0,1,24,0,0,13,3,5,40,1
3340,30870,GpbDOMkrqaLXOPkd8jI4TxThJAZPGWSK,SpATywNh6bZuzm8s1ceuBUnMUAeoAHHw,59,79,40,85,23,25,16,2,270,38.57142857142857,6,0.0,25,40,70,23,54,25,15,16,2,158,112,0
3341,30871,3IgwuZBiVdgdYRQ9ySaEvpMizbjCJFS0,7GRhBDsirIGkRZBtSMEzNTyDr2JQm4xx,62,132,40,110,30,64,19,0,395,56.42857142857143,6,0.0,66,40,86,30,66,64,24,19,0,222,173,1
3342,30872,XK8ujQ4Km9pom3A1sJ3bhFX2dtNEoQ6O,5X6FeZozNMgE2VRi3MJYjkkFK8SETtu2,6,6,2,0,0,0,1,0,9,1.2857142857142858,1,0.0,0,2,0,0,6,0,0,1,0,2,7,1
3343,30887,1NNWgXZojZkqAeoQhcUz4Xc8qgLXmALC,SpATywNh6bZuzm8s1ceuBUnMUAeoAHHw,59,232,125,41,82,26,12,0,518,74.0,19,0.0,60,125,39,82,172,26,2,12,0,306,212,0
3344,30889,9MbsP03nqyzNF8ytIM40Tx9W50TUxwHO,SpATywNh6bZuzm8s1ceuBUnMUAeoAHHw,44,141,4,43,2,0,35,1,226,32.285714285714285,13,0.0,12,4,43,2,129,0,0,35,1,61,165,0
3345,30896,f2GMLkjrqGdN19ysxF64zEiQj9fxR4cG,bWdj2GDclj5ofokWjzoa5jAwMkxCykd6,5,2,1,0,1,0,2,0,6,0.8571428571428571,1,0.0,0,1,0,1,2,0,0,2,0,2,4,1
3346,30905,5GkxvaD11peDsZoT8jF1pQZKBzcvYxOV,G8EPVSXsOYB5YQWZGiz1aVq5Pgr2GrQu,96,155,82,152,11,40,58,2,500,71.42857142857143,15,0.0,32,82,125,11,123,40,27,58,2,250,250,0
3347,30907,LKEJY5MvP0gj7M4NL5iRnXDBazXBKsOA,SpATywNh6bZuzm8s1ceuBUnMUAeoAHHw,60,217,94,34,26,138,87,9,605,86.42857142857143,15,0.0,44,94,31,26,173,138,3,87,9,195,410,0
3348,30924,YbDGggh5B2xVgz44wTEzgnuIROY324O4,SpATywNh6bZuzm8s1ceuBUnMUAeoAHHw,34,121,1,78,0,11,36,1,248,35.42857142857143,6,0.0,62,1,66,0,59,11,12,36,1,129,119,0
3349,30928,L1c2j6jR9tcRupSypdmfRKPrdeUCZhtR,RXDvfPUBYFlVdlueBFbLW0mhhAyGEqpt,1,0,0,0,0,0,1,0,1,0.14285714285714285,1,0.0,0,0,0,0,0,0,0,1,0,0,1,1
3350,30948,CfeENerIdAGepleePWSt0SV88ctt0Tmw,G8EPVSXsOYB5YQWZGiz1aVq5Pgr2GrQu,210,290,118,412,64,0,14,1,899,128.42857142857142,19,0.0,59,118,331,64,231,0,81,14,1,572,327,0
3351,30959,hjUSUM6roI2mLGkMAqBjE0uxFRBSMYHJ,SpATywNh6bZuzm8s1ceuBUnMUAeoAHHw,58,117,78,40,46,13,21,0,315,45.0,9,0.0,20,78,32,46,97,13,8,21,0,176,139,0
3352,30979,bgulYsE8ZDlY4E6R94M2yq4x1deQnluX,RXDvfPUBYFlVdlueBFbLW0mhhAyGEqpt,16,22,15,0,11,0,8,0,56,8.0,3,0.0,0,15,0,11,22,0,0,8,0,26,30,1
3353,30987,xVvNMYPAdkOMbR8cyTeqVHpVoO8wZQ2b,7GRhBDsirIGkRZBtSMEzNTyDr2JQm4xx,6,9,2,0,1,4,6,0,22,3.142857142857143,2,0.0,1,2,0,1,8,4,0,6,0,4,18,1
3354,31001,oTQ81PqeruuETb6SukxAp0sOazRUpE32,7GRhBDsirIGkRZBtSMEzNTyDr2JQm4xx,30,47,15,48,13,11,6,0,140,20.0,4,0.0,28,15,41,13,19,11,7,6,0,97,43,1
3355,31007,X1KDcg6FJGcjALhOEz460JY2SzJ27Ewm,5X6FeZozNMgE2VRi3MJYjkkFK8SETtu2,5,0,0,0,0,0,10,1,11,1.5714285714285714,3,0.0,0,0,0,0,0,0,0,10,1,0,11,1
3356,31009,8VZ4j0vteayaxOVXmKK7ecCAJiG2jYcZ,SpATywNh6bZuzm8s1ceuBUnMUAeoAHHw,13,16,10,0,1,5,10,3,45,6.428571428571429,1,0.0,1,10,0,1,15,5,0,10,3,12,33,0
3357,31010,u8YPaORaz1zRBmx3Zp1zm30bQFzwDInM,SpATywNh6bZuzm8s1ceuBUnMUAeoAHHw,46,145,52,63,21,83,33,3,400,57.142857142857146,10,0.0,55,52,55,21,90,83,8,33,3,183,217,0
3358,31012,t069DROGMOy4O12B9Ty0yznUmNUBGFUp,7GRhBDsirIGkRZBtSMEzNTyDr2JQm4xx,4,2,1,0,1,0,1,0,5,0.7142857142857143,1,0.0,0,1,0,1,2,0,0,1,0,2,3,1
3359,31020,VahHEq0ILTdfn9bRxTqSs3YUh9h3Bcd2,SpATywNh6bZuzm8s1ceuBUnMUAeoAHHw,2,0,0,0,0,0,4,0,4,0.5714285714285714,2,0.0,0,0,0,0,0,0,0,4,0,0,4,1
3360,31023,nz704tMNuBcgvkxkruhgSzP7htrReWBk,bWdj2GDclj5ofokWjzoa5jAwMkxCykd6,8,2,1,0,1,10,15,2,31,4.428571428571429,3,0.0,0,1,0,1,2,10,0,15,2,2,29,0
3361,31038,Djtv0PgEw9uZSQc7WiXmZsJgnFOxrvrt,5X6FeZozNMgE2VRi3MJYjkkFK8SETtu2,33,110,26,34,15,13,15,0,213,30.428571428571427,7,0.0,32,26,29,15,78,13,5,15,0,102,111,0
3362,31047,068Pcyt4LKcLCAowIhptx8tsMvu1BIce,5X6FeZozNMgE2VRi3MJYjkkFK8SETtu2,4,2,1,0,1,0,2,0,6,0.8571428571428571,1,0.0,0,1,0,1,2,0,0,2,0,2,4,1
3363,31062,CfeENerIdAGepleePWSt0SV88ctt0Tmw,A3fsA9Zfv1X2fVEQhTw51lKENdNrEqT3,9,14,6,0,1,0,7,0,28,4.0,6,0.0,0,6,0,1,14,0,0,7,0,7,21,1
3364,31063,CfeENerIdAGepleePWSt0SV88ctt0Tmw,5X6FeZozNMgE2VRi3MJYjkkFK8SETtu2,13,28,11,0,2,0,10,0,51,7.285714285714286,7,0.0,0,11,0,2,28,0,0,10,0,13,38,0
3365,31070,pZnUCZTT1hmIZNtXsfTMlwWSd2NbHrnl,G8EPVSXsOYB5YQWZGiz1aVq5Pgr2GrQu,162,262,109,443,52,158,105,98,1227,175.28571428571428,6,0.0,81,109,365,52,181,158,78,105,98,607,620,0
3366,31071,0806VNqXMD0ICiYkYVKFNvK1rd99RXnA,bWdj2GDclj5ofokWjzoa5jAwMkxCykd6,3,2,0,0,0,7,1,0,10,1.4285714285714286,1,0.0,0,0,0,0,2,7,0,1,0,0,10,0
3367,31080,6U2xPMo27MRkbrPflG5WrvgHD37CuMpR,7GRhBDsirIGkRZBtSMEzNTyDr2JQm4xx,7,7,3,0,2,0,3,0,15,2.142857142857143,2,0.0,0,3,0,2,7,0,0,3,0,5,10,1
3368,31089,MxVVcAtMSnLQjlvLOx5XySlZblFVugTc,SpATywNh6bZuzm8s1ceuBUnMUAeoAHHw,33,111,1,35,0,0,33,0,180,25.714285714285715,7,0.0,16,1,32,0,95,0,3,33,0,49,131,0
3369,31093,s6iksgptFmyh2vfiarKdJkiKnp6RLi3f,RXDvfPUBYFlVdlueBFbLW0mhhAyGEqpt,11,6,4,0,2,19,9,13,53,7.571428571428571,4,0.0,0,4,0,2,6,19,0,9,13,6,47,0
3370,31096,KiNZ4HZnWaKiAZlgJPtDGHDEbZsXq7d8,SpATywNh6bZuzm8s1ceuBUnMUAeoAHHw,8,6,4,0,3,0,4,0,17,2.4285714285714284,2,0.0,0,4,0,3,6,0,0,4,0,7,10,1
3371,31099,mACn5SO79gLqNBHvtK2mDgkWhQzN9dYE,SpATywNh6bZuzm8s1ceuBUnMUAeoAHHw,18,32,4,7,2,2,7,0,54,7.714285714285714,3,0.0,0,4,7,2,32,2,0,7,0,13,41,0
3372,31100,yNeIUKhEuJHTBsPD5kABjlBuASduqZHz,SpATywNh6bZuzm8s1ceuBUnMUAeoAHHw,61,169,75,58,37,53,30,0,422,60.285714285714285,6,0.0,68,75,49,37,101,53,9,30,0,229,193,1
3373,31106,NGCjg1L5IFyOkl1pLM5r5gRwzJYb60Ux,SpATywNh6bZuzm8s1ceuBUnMUAeoAHHw,22,38,3,0,2,4,19,5,71,10.142857142857142,4,0.0,0,3,0,2,38,4,0,19,5,5,66,0
3374,31112,NGCjg1L5IFyOkl1pLM5r5gRwzJYb60Ux,A3fsA9Zfv1X2fVEQhTw51lKENdNrEqT3,35,91,1,0,1,0,8,0,101,14.428571428571429,3,0.0,0,1,0,1,91,0,0,8,0,2,99,0
3375,31121,HgnrfajlgigvUB5SIR1gkDXyA5E37dFI,G8EPVSXsOYB5YQWZGiz1aVq5Pgr2GrQu,58,234,55,110,37,12,17,1,466,66.57142857142857,3,0.0,65,55,78,37,169,12,32,17,1,235,231,0
3376,31122,zvONfuJex2FW0S3q02qmyYC9aBQXin0x,bWdj2GDclj5ofokWjzoa5jAwMkxCykd6,4,2,0,0,0,0,3,0,5,0.7142857142857143,2,0.0,0,0,0,0,2,0,0,3,0,0,5,1
3377,31124,zvONfuJex2FW0S3q02qmyYC9aBQXin0x,A3fsA9Zfv1X2fVEQhTw51lKENdNrEqT3,2,0,0,0,0,0,3,0,3,0.42857142857142855,1,0.0,0,0,0,0,0,0,0,3,0,0,3,1
3378,31137,JP79INNRcQzkUx6dZie4v1QvuMQ7OVUy,RXDvfPUBYFlVdlueBFbLW0mhhAyGEqpt,95,423,10,227,23,34,24,1,742,106.0,9,0.0,62,10,207,23,361,34,20,24,1,302,440,0
3379,31160,FtYS4vQn9nNokBPNd6SFUszLOV2L9gsu,SpATywNh6bZuzm8s1ceuBUnMUAeoAHHw,8,8,3,2,1,0,3,0,17,2.4285714285714284,2,0.0,3,3,2,1,5,0,0,3,0,9,8,0
3380,31162,tq5rSafpJQn5saVcMLWCPKYcu2G69rbK,7GRhBDsirIGkRZBtSMEzNTyDr2JQm4xx,9,5,3,0,2,0,7,0,17,2.4285714285714284,1,0.0,0,3,0,2,5,0,0,7,0,5,12,1
3381,31169,FtYS4vQn9nNokBPNd6SFUszLOV2L9gsu,5X6FeZozNMgE2VRi3MJYjkkFK8SETtu2,1,0,0,0,0,0,1,0,1,0.14285714285714285,1,0.0,0,0,0,0,0,0,0,1,0,0,1,1
3382,31176,In25hAYYA32yjVT3Fete5XUoGWlQgd5t,G8EPVSXsOYB5YQWZGiz1aVq5Pgr2GrQu,54,38,3,141,1,0,4,0,187,26.714285714285715,3,0.0,4,3,133,1,34,0,8,4,0,141,46,0
3383,31187,s6iksgptFmyh2vfiarKdJkiKnp6RLi3f,G8EPVSXsOYB5YQWZGiz1aVq5Pgr2GrQu,15,20,10,0,2,22,18,0,72,10.285714285714286,4,0.0,2,10,0,2,18,22,0,18,0,14,58,0
3384,31199,UQu58ECfm706pzTxKdZuMBkLVofX5BYJ,A3fsA9Zfv1X2fVEQhTw51lKENdNrEqT3,2,0,0,0,0,0,2,0,2,0.2857142857142857,1,0.0,0,0,0,0,0,0,0,2,0,0,2,1
3385,31209,eeYgUeHIQERDYwF1mxwVIZYsVaVSgwlV,5X6FeZozNMgE2VRi3MJYjkkFK8SETtu2,21,77,16,24,10,4,14,1,146,20.857142857142858,7,0.0,31,16,20,10,46,4,4,14,1,77,69,0
3386,31214,s6iksgptFmyh2vfiarKdJkiKnp6RLi3f,bWdj2GDclj5ofokWjzoa5jAwMkxCykd6,7,7,2,0,1,24,6,0,40,5.714285714285714,3,0.0,0,2,0,1,7,24,0,6,0,3,37,0
3387,31215,5Gf23uaI2ID1BMi2tbrzYBqwuoTD7nj1,G8EPVSXsOYB5YQWZGiz1aVq5Pgr2GrQu,85,107,54,98,29,3,24,1,316,45.142857142857146,8,0.0,36,54,92,29,71,3,6,24,1,211,105,0
3388,31216,VvIsuXfKScxQtpB88WTGf8JMf9TTXDon,SpATywNh6bZuzm8s1ceuBUnMUAeoAHHw,25,22,16,11,9,0,4,0,62,8.857142857142858,3,0.0,2,16,11,9,20,0,0,4,0,38,24,0
3389,31225,FHIf7MUGEVUr0CqbuDIIiBw1QO6ZVxVj,SpATywNh6bZuzm8s1ceuBUnMUAeoAHHw,16,40,0,2,1,24,25,4,96,13.714285714285714,4,0.0,9,0,2,1,31,24,0,25,4,12,84,0
3390,31269,s6iksgptFmyh2vfiarKdJkiKnp6RLi3f,5X6FeZozNMgE2VRi3MJYjkkFK8SETtu2,14,11,7,0,2,5,13,1,39,5.571428571428571,4,0.0,0,7,0,2,11,5,0,13,1,9,30,0
3391,31271,WL2pmxbGb1jmTh21fuUuAtLcak4ndNX3,SpATywNh6bZuzm8s1ceuBUnMUAeoAHHw,15,25,8,18,3,2,5,0,61,8.714285714285714,2,0.0,8,8,15,3,17,2,3,5,0,34,27,1
3392,31282,U04y5vFf0AfyJVGIOJHlryTyRQEOm5pT,SpATywNh6bZuzm8s1ceuBUnMUAeoAHHw,53,75,34,51,14,4,13,0,191,27.285714285714285,6,0.0,9,34,46,14,66,4,5,13,0,103,88,0
3393,31294,wAJGUOfaMNSu8fVs50XbquwP1qlCP18o,7GRhBDsirIGkRZBtSMEzNTyDr2JQm4xx,160,622,188,301,130,186,51,2,1480,211.42857142857142,15,0.0,338,188,223,130,284,186,78,51,2,879,601,0
3394,31301,WWRo2uEUHkdi1Q55mTTl1BhH4Eyiuh4i,SpATywNh6bZuzm8s1ceuBUnMUAeoAHHw,5,2,1,0,1,0,2,0,6,0.8571428571428571,1,0.0,0,1,0,1,2,0,0,2,0,2,4,1
3395,31305,ZfhbKm1xmF6HqwzXYHVP4Uwy6oIJcuUx,SpATywNh6bZuzm8s1ceuBUnMUAeoAHHw,11,16,6,20,0,14,6,1,63,9.0,1,0.0,8,6,17,0,8,14,3,6,1,31,32,0
3396,31314,lk5cMwU2ei6fPMwij7uDCwcTMg6KbTEh,RXDvfPUBYFlVdlueBFbLW0mhhAyGEqpt,65,134,72,0,41,15,40,85,387,55.285714285714285,7,0.0,0,72,0,41,134,15,0,40,85,113,274,0
3397,31315,flpVPPsUWfhNx2m3NGTbdkxp57HITcVF,SpATywNh6bZuzm8s1ceuBUnMUAeoAHHw,62,142,68,75,32,7,48,2,374,53.42857142857143,15,0.0,48,68,59,32,94,7,16,48,2,207,167,0
3398,31322,HgQbl59wfMZ62eOeVscJctviZYi0GAnj,SpATywNh6bZuzm8s1ceuBUnMUAeoAHHw,42,56,35,37,18,13,12,1,172,24.571428571428573,7,0.0,13,35,32,18,43,13,5,12,1,98,74,0
3399,31326,ej54FQqE34ZirP86HxHZ32z2x2VcteZU,SpATywNh6bZuzm8s1ceuBUnMUAeoAHHw,5,2,1,0,0,0,3,0,6,0.8571428571428571,1,0.0,0,1,0,0,2,0,0,3,0,1,5,1
3400,31327,MjVksKClEDbwKLDQ3ID6os0AiFzU5BN2,7GRhBDsirIGkRZBtSMEzNTyDr2JQm4xx,1,0,0,0,0,0,1,0,1,0.14285714285714285,1,0.0,0,0,0,0,0,0,0,1,0,0,1,1
3401,31328,y1hlbSei0fIpjB8ljQWGGvcv5eS6EUAC,A3fsA9Zfv1X2fVEQhTw51lKENdNrEqT3,9,9,5,0,4,0,3,0,21,3.0,3,0.0,0,5,0,4,9,0,0,3,0,9,12,0
3402,31329,ZuXB7SoEgVCDuS66pcJ2jF54Mdbn2Nuz,SpATywNh6bZuzm8s1ceuBUnMUAeoAHHw,13,15,9,0,0,0,2,0,26,3.7142857142857144,5,0.0,0,9,0,0,15,0,0,2,0,9,17,0
3403,31330,y1hlbSei0fIpjB8ljQWGGvcv5eS6EUAC,bWdj2GDclj5ofokWjzoa5jAwMkxCykd6,5,2,1,0,1,0,3,0,7,1.0,2,0.0,0,1,0,1,2,0,0,3,0,2,5,1
3404,31332,i68mZBXUpNDZcfluOcDcrl4JItcNJWzg,5X6FeZozNMgE2VRi3MJYjkkFK8SETtu2,8,8,0,9,2,0,5,0,24,3.4285714285714284,2,0.0,6,0,9,2,2,0,0,5,0,17,7,1
3405,31335,XqfKw12BYBxvQyUszKCvSmcUn4H9qRJJ,7GRhBDsirIGkRZBtSMEzNTyDr2JQm4xx,19,50,13,40,8,5,13,0,129,18.428571428571427,4,0.0,30,13,33,8,20,5,7,13,0,84,45,1
3406,31338,Xm0fBjDbhiZ1hqhhgWghtT86qcZao5Le,SpATywNh6bZuzm8s1ceuBUnMUAeoAHHw,37,33,18,42,13,0,4,0,110,15.714285714285714,3,0.0,11,18,37,13,22,0,5,4,0,79,31,0
3407,31339,Kwwe3mn1o1VyQxfsjLDNj10CJwvv89oe,G8EPVSXsOYB5YQWZGiz1aVq5Pgr2GrQu,7,7,3,0,1,4,4,0,19,2.7142857142857144,1,0.0,2,3,0,1,5,4,0,4,0,6,13,1
3408,31349,RAFVAKoL6cQatcQ8rTN5mIwPhy02koDR,A3fsA9Zfv1X2fVEQhTw51lKENdNrEqT3,76,112,56,164,39,12,24,0,407,58.142857142857146,12,0.0,7,56,140,39,105,12,24,24,0,242,165,0
3409,31358,8kpaF6RjfQ3lij9I92AFwUcHaXEkRwzZ,G8EPVSXsOYB5YQWZGiz1aVq5Pgr2GrQu,6,5,1,0,1,38,6,0,51,7.285714285714286,1,0.0,0,1,0,1,5,38,0,6,0,2,49,0
3410,31363,EshSTNSaPVDLcPEwlm2e07DrZJhzPNHK,A3fsA9Zfv1X2fVEQhTw51lKENdNrEqT3,203,134,108,486,70,10,25,3,836,119.42857142857143,7,0.0,6,108,393,70,128,10,93,25,3,577,259,0
3411,31368,q15es4hix4DJR5zOH0N1aGsdTpjonWNC,SpATywNh6bZuzm8s1ceuBUnMUAeoAHHw,57,117,34,59,15,140,55,3,423,60.42857142857143,17,0.0,22,34,52,15,95,140,7,55,3,123,300,0
3412,31372,VirXFJzuzQKL0tqaVG4iBSKiDEeYTINe,A3fsA9Zfv1X2fVEQhTw51lKENdNrEqT3,5,3,1,0,1,0,2,0,7,1.0,2,0.0,0,1,0,1,3,0,0,2,0,2,5,1
3413,31414,StcFIgK5T4YiiLiOpPHFjzohTVz9Jaf7,A3fsA9Zfv1X2fVEQhTw51lKENdNrEqT3,43,57,26,74,17,0,4,0,178,25.428571428571427,11,0.0,2,26,56,17,55,0,18,4,0,101,77,0
3414,31419,o7pzdRTO1dnxuhf9kxurH0oMz67aa1kw,SpATywNh6bZuzm8s1ceuBUnMUAeoAHHw,30,22,10,23,5,0,5,0,65,9.285714285714286,5,0.0,7,10,23,5,15,0,0,5,0,45,20,1
3415,31446,Sg3DXxUJJ7e58r0b7OHd09yiv7acnFU0,SpATywNh6bZuzm8s1ceuBUnMUAeoAHHw,40,63,36,32,20,40,29,0,220,31.428571428571427,8,0.0,19,36,29,20,44,40,3,29,0,104,116,0
3416,31447,1eGkI0U1fMBa6R6814yg1pK6UpcuLDVs,G8EPVSXsOYB5YQWZGiz1aVq5Pgr2GrQu,2,0,0,0,0,0,2,0,2,0.2857142857142857,1,0.0,0,0,0,0,0,0,0,2,0,0,2,1
3417,31452,ouZJjXOMfv0cgbezRQ2yVqJJVKJPFP9g,SpATywNh6bZuzm8s1ceuBUnMUAeoAHHw,20,46,3,0,3,0,5,0,57,8.142857142857142,4,0.0,0,3,0,3,46,0,0,5,0,6,51,1
3418,31455,AX9Hte0A6zp61WUmhFkv1rU3P0cKffFQ,SpATywNh6bZuzm8s1ceuBUnMUAeoAHHw,45,93,17,56,2,10,32,0,210,30.0,11,0.0,21,17,50,2,72,10,6,32,0,90,120,0
3419,31458,T7p6N91F6KULGtprxI0mhT0EmO9FegFe,A3fsA9Zfv1X2fVEQhTw51lKENdNrEqT3,7,4,2,0,1,0,13,0,20,2.857142857142857,3,0.0,0,2,0,1,4,0,0,13,0,3,17,1
3420,31460,zmunqQU7cdA8pnQFNB1A3xjWmjdxheRC,SpATywNh6bZuzm8s1ceuBUnMUAeoAHHw,1,0,0,0,0,0,1,0,1,0.14285714285714285,1,0.0,0,0,0,0,0,0,0,1,0,0,1,1
3421,31468,CVzATUdOM8Qgz38dXNByctkVtfSnNFbx,SpATywNh6bZuzm8s1ceuBUnMUAeoAHHw,13,12,5,0,2,2,6,1,28,4.0,1,0.0,5,5,0,2,7,2,0,6,1,12,16,1
3422,31479,8jqDD2phXiMGQf0XQi1kVRzLj3TILO0y,bWdj2GDclj5ofokWjzoa5jAwMkxCykd6,16,18,9,120,3,4,6,0,160,22.857142857142858,2,0.0,5,9,116,3,13,4,4,6,0,133,27,1
3423,31486,CTfjOlWW4k8IhTEXOJYJ7bo74K8z07kZ,bWdj2GDclj5ofokWjzoa5jAwMkxCykd6,52,88,37,100,12,2,30,2,271,38.714285714285715,8,0.0,12,37,89,12,76,2,11,30,2,150,121,0
3424,31493,iGNqI0WQkdTRPPMB99MG4DRoKjQuEfCJ,SpATywNh6bZuzm8s1ceuBUnMUAeoAHHw,37,50,20,6,12,0,15,0,103,14.714285714285714,13,0.0,0,20,5,12,50,0,1,15,0,37,66,0
3425,31505,XDDkvG3daqaNFCwfbjOudEVxBaPFdZM4,SpATywNh6bZuzm8s1ceuBUnMUAeoAHHw,32,71,23,36,13,3,10,1,157,22.428571428571427,3,0.0,17,23,30,13,54,3,6,10,1,83,74,0
3426,31508,zc3J3cLI43sSah10iZYvlT8XuC7FiQBt,bWdj2GDclj5ofokWjzoa5jAwMkxCykd6,17,35,15,17,13,1,19,1,101,14.428571428571429,4,0.0,14,15,16,13,21,1,1,19,1,58,43,1
3427,31509,oyStFfS7Y0XvpvDI8JwDIhnFdZZl3Ixl,SpATywNh6bZuzm8s1ceuBUnMUAeoAHHw,23,28,1,26,1,1,11,0,68,9.714285714285714,4,0.0,9,1,25,1,19,1,1,11,0,36,32,0
3428,31513,XBCkMYdRHaBwbyaKg5wVLPpzX1Jqu9p0,7GRhBDsirIGkRZBtSMEzNTyDr2JQm4xx,9,11,3,0,4,0,4,0,22,3.142857142857143,2,0.0,4,3,0,4,7,0,0,4,0,11,11,1
3429,31521,SQBW44VzMb5zXQWTfzFzAP2RU7qxP2su,bWdj2GDclj5ofokWjzoa5jAwMkxCykd6,37,78,47,172,23,0,8,0,328,46.857142857142854,10,0.0,14,47,152,23,64,0,20,8,0,236,92,1
3430,31532,oNX40hvUpCseO8BHKhGJvG2jyQpYKQyk,RXDvfPUBYFlVdlueBFbLW0mhhAyGEqpt,72,169,76,148,28,68,38,3,530,75.71428571428571,12,0.0,17,76,144,28,152,68,4,38,3,265,265,0
3431,31540,fenn4oQ5cZO7k0rG5qWqM8q00nrCNGWN,G8EPVSXsOYB5YQWZGiz1aVq5Pgr2GrQu,11,17,2,0,2,2,9,0,32,4.571428571428571,2,0.0,0,2,0,2,17,2,0,9,0,4,28,0
3432,31548,XXMS71J2H0OH1d5JkGIMcAWAVCkHQnUI,SpATywNh6bZuzm8s1ceuBUnMUAeoAHHw,7,3,2,0,2,0,2,0,9,1.2857142857142858,1,0.0,0,2,0,2,3,0,0,2,0,4,5,1
3433,31554,6QkXIF90lGPt9Vh54FdM4bVGqW5m3GxK,SpATywNh6bZuzm8s1ceuBUnMUAeoAHHw,37,23,19,0,17,0,4,0,63,9.0,3,0.0,0,19,0,17,23,0,0,4,0,36,27,0
3434,31557,H3GbKrAtFVtLEXWNNdFaZDFbuKQIUVPU,SpATywNh6bZuzm8s1ceuBUnMUAeoAHHw,56,111,68,39,28,17,53,0,316,45.142857142857146,19,0.0,18,68,38,28,93,17,1,53,0,152,164,0
3435,31568,c49ANcMlFceMxZBmI2dFNiETx72UlFpt,SpATywNh6bZuzm8s1ceuBUnMUAeoAHHw,51,110,24,57,7,33,46,1,278,39.714285714285715,13,0.0,22,24,49,7,88,33,8,46,1,102,176,0
3436,31574,Choi1P390vmtfro1eWMEt9A5jiQ5ooC0,bWdj2GDclj5ofokWjzoa5jAwMkxCykd6,5,2,1,0,1,0,2,0,6,0.8571428571428571,1,0.0,0,1,0,1,2,0,0,2,0,2,4,1
3437,31575,VYkkz2UClMIV09P0Xfa0EEIHkYXDA8gf,SpATywNh6bZuzm8s1ceuBUnMUAeoAHHw,27,56,8,64,2,34,13,1,178,25.428571428571427,4,0.0,29,8,57,2,27,34,7,13,1,96,82,1
3438,31589,xy9Oc1Yxp7TcZqHQEdlB3DAX67hCrIQ7,5X6FeZozNMgE2VRi3MJYjkkFK8SETtu2,14,17,6,2,2,11,5,1,44,6.285714285714286,1,0.0,9,6,2,2,8,11,0,5,1,19,25,1
3439,31601,dJZL2KzG1hAQ7YWpbHZmN7SyeaNVO2V1,A3fsA9Zfv1X2fVEQhTw51lKENdNrEqT3,1,0,0,0,0,0,1,0,1,0.14285714285714285,1,0.0,0,0,0,0,0,0,0,1,0,0,1,1
3440,31610,9T7PMXOMDFXR9WSJvwPim10fNgzjcp6r,SpATywNh6bZuzm8s1ceuBUnMUAeoAHHw,15,26,2,15,0,14,8,2,67,9.571428571428571,2,0.0,10,2,14,0,16,14,1,8,2,26,41,0
3441,31616,fvZ0NGV51VzyC0WSd0PRSRn84KNPjRPi,SpATywNh6bZuzm8s1ceuBUnMUAeoAHHw,36,57,2,32,1,5,15,0,112,16.0,4,0.0,8,2,32,1,49,5,0,15,0,43,69,0
3442,31630,uqaaAh63woEl1GEmEsDUSC0vwOZYZP0g,G8EPVSXsOYB5YQWZGiz1aVq5Pgr2GrQu,13,10,4,8,4,0,3,0,29,4.142857142857143,2,0.0,3,4,7,4,7,0,1,3,0,18,11,1
3443,31631,OcchkIht8b8QIrrapp5dUsDP9GE3Vfdw,SpATywNh6bZuzm8s1ceuBUnMUAeoAHHw,22,28,8,32,5,0,12,0,85,12.142857142857142,2,0.0,10,8,31,5,18,0,1,12,0,54,31,0
3444,31636,8V9pnrkvwK33pI3AiYSlsgxV7TeKgfNZ,G8EPVSXsOYB5YQWZGiz1aVq5Pgr2GrQu,84,177,57,140,24,137,31,5,571,81.57142857142857,9,0.0,70,57,90,24,107,137,50,31,5,241,330,0
3445,31637,5vZRuON34JUuUxkGF08Mu94iTiQzZas4,RXDvfPUBYFlVdlueBFbLW0mhhAyGEqpt,63,78,43,150,20,2,22,12,327,46.714285714285715,5,0.0,19,43,132,20,59,2,18,22,12,214,113,0
3446,31650,oqeS1F9HDtp76Uor2JA69VvP8s0An8qD,SpATywNh6bZuzm8s1ceuBUnMUAeoAHHw,22,29,5,4,4,0,7,0,49,7.0,1,0.0,7,5,4,4,22,0,0,7,0,20,29,1
3447,31651,2AWz8OiYqJqT0VYmevCkAuxaVCSl88oB,A3fsA9Zfv1X2fVEQhTw51lKENdNrEqT3,92,115,88,82,68,1,17,0,371,53.0,5,0.0,3,88,72,68,112,1,10,17,0,231,140,0
3448,31668,IujXdG8hMcTQBeZJ4Qbpq8kOlC9VAoqW,SpATywNh6bZuzm8s1ceuBUnMUAeoAHHw,1,0,0,0,0,0,1,0,1,0.14285714285714285,1,0.0,0,0,0,0,0,0,0,1,0,0,1,1
3449,31670,AhvhyySPOhgjxA01IKT267rbfuWUyPz5,SpATywNh6bZuzm8s1ceuBUnMUAeoAHHw,6,2,1,0,1,0,4,0,8,1.1428571428571428,1,0.0,0,1,0,1,2,0,0,4,0,2,6,1
3450,31672,kGJ0kJD3LGzwfPeuS19lVyqb4r7gscqA,SpATywNh6bZuzm8s1ceuBUnMUAeoAHHw,38,57,33,26,22,2,15,2,157,22.428571428571427,7,0.0,14,33,23,22,43,2,3,15,2,92,65,0
3451,31683,YTga640T6i241jGBhxN7pUtNHHrQTFGS,7GRhBDsirIGkRZBtSMEzNTyDr2JQm4xx,10,12,3,14,1,1,1,0,32,4.571428571428571,1,0.0,8,3,12,1,4,1,2,1,0,24,8,1
3452,31689,GYtjeqMCQ6Dcisx0HKWJVPtkJ5irEqqj,bWdj2GDclj5ofokWjzoa5jAwMkxCykd6,4,6,0,0,0,7,4,0,17,2.4285714285714284,2,0.0,0,0,0,0,6,7,0,4,0,0,17,1
3453,31695,yWhbSfRhq0GQaIid8lmuGTuOjD7iQVVR,SpATywNh6bZuzm8s1ceuBUnMUAeoAHHw,51,156,62,49,20,53,37,0,377,53.857142857142854,12,0.0,60,62,38,20,96,53,11,37,0,180,197,1
3454,31707,oX0xmFM00RD2zpxC8x8yI57WZl7jF3OW,bWdj2GDclj5ofokWjzoa5jAwMkxCykd6,14,18,8,48,9,0,1,0,84,12.0,1,0.0,7,8,43,9,11,0,5,1,0,67,17,0
3455,31718,TJ0V0Q8Q7PU7JaM3K55nOnFdpx29qUfy,SpATywNh6bZuzm8s1ceuBUnMUAeoAHHw,37,49,22,14,10,36,15,6,152,21.714285714285715,6,0.0,8,22,13,10,41,36,1,15,6,53,99,0
3456,31730,a4RYqILKcnu8c617gYSbD0KQIm9DqZnc,SpATywNh6bZuzm8s1ceuBUnMUAeoAHHw,55,64,24,42,13,1,17,0,161,23.0,8,0.0,11,24,38,13,53,1,4,17,0,86,75,0
3457,31742,Ol0EltSC0dLtmI4Ws0ziQYNZlpSWDTB5,SpATywNh6bZuzm8s1ceuBUnMUAeoAHHw,49,178,15,54,9,1,38,1,296,42.285714285714285,9,0.0,48,15,45,9,130,1,9,38,1,117,179,0
3458,31744,2dBt8xoZ6BLHGNE1IF3iWURIwZGhjEcy,SpATywNh6bZuzm8s1ceuBUnMUAeoAHHw,11,7,2,0,2,2,5,0,18,2.5714285714285716,1,0.0,0,2,0,2,7,2,0,5,0,4,14,1
3459,31756,70Zyu3WQygi3HxuxcZg5BvCVTCfBem3D,SpATywNh6bZuzm8s1ceuBUnMUAeoAHHw,10,17,4,0,4,4,9,0,38,5.428571428571429,3,0.0,4,4,0,4,13,4,0,9,0,12,26,0
3460,31759,tqvV2MwKeLemDHIUsPAVAoV4nZW7CEvr,SpATywNh6bZuzm8s1ceuBUnMUAeoAHHw,7,6,4,0,3,0,2,0,15,2.142857142857143,1,0.0,0,4,0,3,6,0,0,2,0,7,8,0
3461,31770,HFLoTrlo9AoizXsnGd7vPE04tzDGrmOf,SpATywNh6bZuzm8s1ceuBUnMUAeoAHHw,14,86,44,0,19,1,44,2,196,28.0,2,0.0,3,44,0,19,83,1,0,44,2,66,130,1
3462,31775,f13VNamLzXZk1JfiRwsU71KPQBJ3vbOe,SpATywNh6bZuzm8s1ceuBUnMUAeoAHHw,10,10,1,21,0,0,5,0,37,5.285714285714286,2,0.0,7,1,20,0,3,0,1,5,0,28,9,0
3463,31780,DQDVulqp0h5DfSUqCcuRlUTAbYsaxOXV,7GRhBDsirIGkRZBtSMEzNTyDr2JQm4xx,3,0,0,0,0,4,4,0,8,1.1428571428571428,1,0.0,0,0,0,0,0,4,0,4,0,0,8,1
3464,31781,vZTsjWYTV0UK9VehnJVovFZUJthKJRiW,A3fsA9Zfv1X2fVEQhTw51lKENdNrEqT3,1,0,0,0,0,0,1,0,1,0.14285714285714285,1,0.0,0,0,0,0,0,0,0,1,0,0,1,1
3465,31784,vKwONyYQku69SspHkUwKQCkSIIF21aUI,RXDvfPUBYFlVdlueBFbLW0mhhAyGEqpt,52,100,63,0,27,83,24,5,302,43.142857142857146,4,0.0,7,63,0,27,93,83,0,24,5,97,205,1
3466,31785,WMHp5hy6JREfQvjE2o6B3Iu0aAWFRyny,SpATywNh6bZuzm8s1ceuBUnMUAeoAHHw,53,87,45,66,20,15,24,3,260,37.142857142857146,8,0.0,21,45,56,20,66,15,10,24,3,142,118,0
3467,31786,BYn6cWVQSMORsIVShYVRAnnkHpLyiUv8,5X6FeZozNMgE2VRi3MJYjkkFK8SETtu2,18,63,20,12,7,28,17,0,147,21.0,12,0.0,15,20,11,7,48,28,1,17,0,53,94,0
3468,31792,ZNcLOAJ2r3H5DqhbGk1CiPtwI7ixaCeK,A3fsA9Zfv1X2fVEQhTw51lKENdNrEqT3,81,63,53,34,42,1,10,0,203,29.0,7,0.0,0,53,33,42,63,1,1,10,0,128,75,0
3469,31800,w4jUEPZrBRDoTJulTK0CkRpgy77Rfcsr,bWdj2GDclj5ofokWjzoa5jAwMkxCykd6,6,2,1,0,1,0,4,0,8,1.1428571428571428,1,0.0,0,1,0,1,2,0,0,4,0,2,6,1
3470,31801,AXOgFWUEMyDEcBkotXpoXzfY4u6ulWjj,A3fsA9Zfv1X2fVEQhTw51lKENdNrEqT3,5,2,1,0,1,0,5,0,9,1.2857142857142858,2,0.0,0,1,0,1,2,0,0,5,0,2,7,0
3471,31803,AXOgFWUEMyDEcBkotXpoXzfY4u6ulWjj,RXDvfPUBYFlVdlueBFbLW0mhhAyGEqpt,20,27,14,0,6,6,3,0,56,8.0,1,0.0,0,14,0,6,27,6,0,3,0,20,36,0
3472,31815,AXOgFWUEMyDEcBkotXpoXzfY4u6ulWjj,SpATywNh6bZuzm8s1ceuBUnMUAeoAHHw,20,22,13,0,7,1,5,0,48,6.857142857142857,2,0.0,0,13,0,7,22,1,0,5,0,20,28,0
3473,31821,ZZKaYISjwPLd7mjcgaVmNy6TyZg40oVS,A3fsA9Zfv1X2fVEQhTw51lKENdNrEqT3,2,0,0,0,0,0,4,0,4,0.5714285714285714,1,0.0,0,0,0,0,0,0,0,4,0,0,4,1
3474,31827,JOddnojV0OZrysgzYsnxzhRLS1r6GCxl,SpATywNh6bZuzm8s1ceuBUnMUAeoAHHw,16,22,11,0,6,2,9,0,50,7.142857142857143,4,0.0,4,11,0,6,18,2,0,9,0,21,29,1
3475,31829,861mcqUZ4WyFkrWdyYySCd1kJULdzhG3,SpATywNh6bZuzm8s1ceuBUnMUAeoAHHw,26,41,5,26,4,0,6,0,82,11.714285714285714,4,0.0,10,5,25,4,31,0,1,6,0,44,38,1
3476,31854,wLAgbiz3XWV6Nef8pQe1TlLxUN8CIoJ8,7GRhBDsirIGkRZBtSMEzNTyDr2JQm4xx,130,147,45,180,55,13,15,2,457,65.28571428571429,3,0.0,95,45,157,55,52,13,23,15,2,352,105,1
3477,31859,5Vyfi91fKhjJCc9JZTWeaj3foWCTItaL,SpATywNh6bZuzm8s1ceuBUnMUAeoAHHw,5,2,1,0,1,0,2,0,6,0.8571428571428571,1,0.0,0,1,0,1,2,0,0,2,0,2,4,1
3478,31866,yqRjX5x5mZ97nU5DkAkyboMSXTOKxqGq,RXDvfPUBYFlVdlueBFbLW0mhhAyGEqpt,2,0,0,0,0,0,2,0,2,0.2857142857142857,1,0.0,0,0,0,0,0,0,0,2,0,0,2,1
3479,31868,yqRjX5x5mZ97nU5DkAkyboMSXTOKxqGq,bWdj2GDclj5ofokWjzoa5jAwMkxCykd6,2,0,0,0,0,0,2,0,2,0.2857142857142857,1,0.0,0,0,0,0,0,0,0,2,0,0,2,1
3480,31869,R2cga9JVVM2tXEVs2saYswslfxAU4nMk,SpATywNh6bZuzm8s1ceuBUnMUAeoAHHw,21,13,8,14,4,0,11,0,50,7.142857142857143,5,0.0,4,8,14,4,9,0,0,11,0,30,20,0
3481,31870,yqRjX5x5mZ97nU5DkAkyboMSXTOKxqGq,5X6FeZozNMgE2VRi3MJYjkkFK8SETtu2,2,0,0,0,0,0,2,0,2,0.2857142857142857,1,0.0,0,0,0,0,0,0,0,2,0,0,2,1
3482,31877,ioaeb7d1U29jI9wsI7DHJ7aiuWWVX3KB,RXDvfPUBYFlVdlueBFbLW0mhhAyGEqpt,103,257,82,136,65,6,30,2,578,82.57142857142857,5,0.0,68,82,131,65,189,6,5,30,2,346,232,0
3483,31896,kvf1WFygeLGKOFkoertca6J9TDxV9fcY,5X6FeZozNMgE2VRi3MJYjkkFK8SETtu2,6,5,2,0,3,0,1,0,11,1.5714285714285714,1,0.0,2,2,0,3,3,0,0,1,0,7,4,1
3484,31898,PWcBu9Kt7uTK1WC32ssYHrspf5hPuUjQ,7GRhBDsirIGkRZBtSMEzNTyDr2JQm4xx,8,5,3,0,2,0,4,0,14,2.0,2,0.0,0,3,0,2,5,0,0,4,0,5,9,1
3485,31909,cAuoC0RFnhWa1rjmwwXTGirOFJWhZ3O6,SpATywNh6bZuzm8s1ceuBUnMUAeoAHHw,5,4,2,6,0,0,2,0,14,2.0,1,0.0,1,2,5,0,3,0,1,2,0,8,6,1
3486,31927,6tkBZTnNxRRRXGSFUHBd7kkZUgcJhsIy,7GRhBDsirIGkRZBtSMEzNTyDr2JQm4xx,2,0,0,0,0,0,2,0,2,0.2857142857142857,1,0.0,0,0,0,0,0,0,0,2,0,0,2,1
3487,31929,NtoUmtr1rLkqyRgOmRvv7ehcWGsLKb0w,SpATywNh6bZuzm8s1ceuBUnMUAeoAHHw,31,29,16,17,11,1,6,1,81,11.571428571428571,2,0.0,9,16,15,11,20,1,2,6,1,51,30,0
3488,31961,VvPGX7cfFx9biMfbbz3YpB4bcEqLMW9U,RXDvfPUBYFlVdlueBFbLW0mhhAyGEqpt,133,226,138,318,107,8,37,2,836,119.42857142857143,6,0.0,63,138,295,107,163,8,23,37,2,603,233,0
3489,31970,iJvDsYi6zIbeBcBgPSE07utxh6J5vUbE,RXDvfPUBYFlVdlueBFbLW0mhhAyGEqpt,23,26,18,33,13,0,2,0,92,13.142857142857142,2,0.0,7,18,31,13,19,0,2,2,0,69,23,0
3490,31979,XYKAwX2Sl88KhgfkTOpg6K4pRdGN7Orp,7GRhBDsirIGkRZBtSMEzNTyDr2JQm4xx,2,0,0,0,0,0,3,0,3,0.42857142857142855,1,0.0,0,0,0,0,0,0,0,3,0,0,3,1
3491,31983,EwpbggvNdZkeSTjdG48aEltlJYavm02s,A3fsA9Zfv1X2fVEQhTw51lKENdNrEqT3,14,16,1,0,0,0,5,0,22,3.142857142857143,3,0.0,0,1,0,0,16,0,0,5,0,1,21,0
3492,31986,XYKAwX2Sl88KhgfkTOpg6K4pRdGN7Orp,bWdj2GDclj5ofokWjzoa5jAwMkxCykd6,1,0,0,0,0,0,1,0,1,0.14285714285714285,1,0.0,0,0,0,0,0,0,0,1,0,0,1,1
3493,31988,XYKAwX2Sl88KhgfkTOpg6K4pRdGN7Orp,A3fsA9Zfv1X2fVEQhTw51lKENdNrEqT3,1,0,0,0,0,0,1,0,1,0.14285714285714285,1,0.0,0,0,0,0,0,0,0,1,0,0,1,0
3494,31993,3c43AAq389Lt9q10QuQnoNoJ0mkHqvxC,5X6FeZozNMgE2VRi3MJYjkkFK8SETtu2,1,0,0,0,0,0,1,0,1,0.14285714285714285,1,0.0,0,0,0,0,0,0,0,1,0,0,1,1
3495,31996,TZQnDQD4c1wLJcg98vkGC4z0YxJAykwb,SpATywNh6bZuzm8s1ceuBUnMUAeoAHHw,58,148,79,44,50,15,28,5,369,52.714285714285715,15,0.0,45,79,37,50,103,15,7,28,5,211,158,0
3496,32011,nx33gkAhBwAtZXIOjPN1LgE3JpCym17w,SpATywNh6bZuzm8s1ceuBUnMUAeoAHHw,1,0,0,0,0,0,1,0,1,0.14285714285714285,1,0.0,0,0,0,0,0,0,0,1,0,0,1,1
3497,32018,eVjO8UzdCxiCnXMJzeHIA4vFZdeRyoGc,SpATywNh6bZuzm8s1ceuBUnMUAeoAHHw,9,10,6,0,4,0,2,0,22,3.142857142857143,1,0.0,0,6,0,4,10,0,0,2,0,10,12,1
3498,32029,tLtF2xuv7ODjuOISevnoALqvBz99SIrS,RXDvfPUBYFlVdlueBFbLW0mhhAyGEqpt,8,8,1,0,0,0,2,0,11,1.5714285714285714,1,0.0,0,1,0,0,8,0,0,2,0,1,10,1
3499,32031,0xrj8jMy7DRmz2206OV6CH0SXBZh0mT4,5X6FeZozNMgE2VRi3MJYjkkFK8SETtu2,10,6,5,0,5,0,1,0,17,2.4285714285714284,1,0.0,0,5,0,5,6,0,0,1,0,10,7,1
3500,32072,oV1ETioZLdwgIeANYoTTe9mpmAow2qIk,A3fsA9Zfv1X2fVEQhTw51lKENdNrEqT3,14,20,11,0,2,34,16,1,84,12.0,3,0.0,4,11,0,2,16,34,0,16,1,17,67,0
3501,32080,KK88eF8dX9bLCXncq9rSm7T6UVxyajTo,A3fsA9Zfv1X2fVEQhTw51lKENdNrEqT3,7,8,3,0,1,1,25,0,38,5.428571428571429,6,0.0,0,3,0,1,8,1,0,25,0,4,34,0
3502,32083,E4Y6ppfaM7zO2C4oxn78UykFQIZieWjg,5X6FeZozNMgE2VRi3MJYjkkFK8SETtu2,81,339,86,2,120,94,37,5,683,97.57142857142857,7,0.0,111,86,2,120,228,94,0,37,5,319,364,0
3503,32096,c1hkKbuwCfRwqHEOmzJGVU5GV6amXAD9,SpATywNh6bZuzm8s1ceuBUnMUAeoAHHw,5,2,1,0,1,0,2,0,6,0.8571428571428571,1,0.0,0,1,0,1,2,0,0,2,0,2,4,1
3504,32099,aM96vLcGj7eUDPhSS4Er9k1Fdrc63O0N,A3fsA9Zfv1X2fVEQhTw51lKENdNrEqT3,4,2,1,0,0,0,3,0,6,0.8571428571428571,1,0.0,0,1,0,0,2,0,0,3,0,1,5,0
3505,32112,Jf77UYIvUtofHBGpvQMQ0qUfMZBh9rRJ,SpATywNh6bZuzm8s1ceuBUnMUAeoAHHw,33,34,21,33,11,0,7,0,106,15.142857142857142,6,0.0,8,21,31,11,26,0,2,7,0,71,35,0
3506,32123,xrDGwnLLNa6QlQOfL38MTY3529BaxYjK,RXDvfPUBYFlVdlueBFbLW0mhhAyGEqpt,14,9,7,17,3,0,4,0,40,5.714285714285714,2,0.0,1,7,16,3,8,0,1,4,0,27,13,0
3507,32124,SWaMMFaEgBIwWimOSjcPRySyg7Gfrl6L,SpATywNh6bZuzm8s1ceuBUnMUAeoAHHw,57,106,53,41,17,9,18,2,246,35.142857142857146,6,0.0,11,53,37,17,95,9,4,18,2,118,128,0
3508,32130,4bLrsVDvLnrTqHqeIpcqQPyvl02eai7n,bWdj2GDclj5ofokWjzoa5jAwMkxCykd6,6,1,1,0,1,0,3,0,6,0.8571428571428571,2,0.0,0,1,0,1,1,0,0,3,0,2,4,1
3509,32135,610PtRFkaYif9s7nz1Kdra5qTHjPTrYT,SpATywNh6bZuzm8s1ceuBUnMUAeoAHHw,30,29,18,28,11,0,8,0,94,13.428571428571429,5,0.0,7,18,26,11,22,0,2,8,0,62,32,0
3510,32141,jagu0OJDhWTGFhfCMk0ghqluLpW3kzdC,bWdj2GDclj5ofokWjzoa5jAwMkxCykd6,16,12,7,48,3,0,15,0,85,12.142857142857142,4,0.0,2,7,44,3,10,0,4,15,0,56,29,1
3511,32143,sCdFetzDtW2ZNQiiM1GeVRNkzG4jTYgl,G8EPVSXsOYB5YQWZGiz1aVq5Pgr2GrQu,35,33,11,125,5,1,8,0,183,26.142857142857142,1,0.0,22,11,100,5,11,1,25,8,0,138,45,1
3512,32145,N3xBmXADxLX0BRmRQsoG12CSJL5I0LC3,G8EPVSXsOYB5YQWZGiz1aVq5Pgr2GrQu,30,33,14,22,10,1,15,1,96,13.714285714285714,1,0.0,13,14,12,10,20,1,10,15,1,49,47,0
3513,32146,RoOsK5eOQzFUYZazHGNljblhHu8Erb3v,SpATywNh6bZuzm8s1ceuBUnMUAeoAHHw,7,3,2,0,1,0,5,0,11,1.5714285714285714,2,0.0,0,2,0,1,3,0,0,5,0,3,8,0
3514,32154,JB5wgKgEAIwYsiifcpDf7iv2yPgMBOVA,SpATywNh6bZuzm8s1ceuBUnMUAeoAHHw,28,94,3,29,1,1,18,1,147,21.0,7,0.0,14,3,28,1,80,1,1,18,1,46,101,0
3515,32159,DyQHVTNiwX6W4PiKOVh8BCoKQr8u7ImW,bWdj2GDclj5ofokWjzoa5jAwMkxCykd6,13,24,1,0,2,0,13,0,40,5.714285714285714,2,0.0,6,1,0,2,18,0,0,13,0,9,31,1
3516,32162,kAQFM0dEgOQIxOG9jTMe5puRtNxZZWMN,A3fsA9Zfv1X2fVEQhTw51lKENdNrEqT3,107,68,3,316,2,0,11,0,400,57.142857142857146,9,0.0,5,3,282,2,63,0,34,11,0,292,108,0
3517,32165,xVQ88VrIuIA75ygDlevnROobNkwcFnsc,SpATywNh6bZuzm8s1ceuBUnMUAeoAHHw,30,57,7,18,5,16,14,0,117,16.714285714285715,10,0.0,0,7,16,5,57,16,2,14,0,28,89,0
3518,32172,lucxJ3l1qL4UWLhoBqokWI3CdjYfsM5P,SpATywNh6bZuzm8s1ceuBUnMUAeoAHHw,4,2,1,0,1,0,1,0,5,0.7142857142857143,1,0.0,0,1,0,1,2,0,0,1,0,2,3,1
3519,32177,kvf1WFygeLGKOFkoertca6J9TDxV9fcY,7GRhBDsirIGkRZBtSMEzNTyDr2JQm4xx,6,6,2,0,3,0,1,0,12,1.7142857142857142,2,0.0,3,2,0,3,3,0,0,1,0,8,4,1
3520,32181,yz5W8rI4J1brvBsiH8Bk8UlG6rKQV6QY,SpATywNh6bZuzm8s1ceuBUnMUAeoAHHw,19,34,20,16,4,0,11,0,85,12.142857142857142,4,0.0,7,20,14,4,27,0,2,11,0,45,40,0
3521,32190,rrVpn5gbnZ4HT5tgZUFxCL3VXZPoRN4p,SpATywNh6bZuzm8s1ceuBUnMUAeoAHHw,5,5,2,0,0,0,2,0,9,1.2857142857142858,1,0.0,0,2,0,0,5,0,0,2,0,2,7,0
3522,32198,PzbAAQBdNIO5q0hDkxJETX7v12Y9h0xH,5X6FeZozNMgE2VRi3MJYjkkFK8SETtu2,28,47,8,54,15,3,12,1,140,20.0,6,0.0,20,8,41,15,27,3,13,12,1,84,56,0
3523,32202,B0UcZFdES6LvRDMYG7Y0cM3CxcL70HFE,5X6FeZozNMgE2VRi3MJYjkkFK8SETtu2,33,122,36,36,33,0,18,2,247,35.285714285714285,9,0.0,40,36,34,33,82,0,2,18,2,143,104,0
3524,32204,6DV1XDznpXjLYpZGNyw8WjvrI7FbAcBI,SpATywNh6bZuzm8s1ceuBUnMUAeoAHHw,1,0,0,0,0,0,1,0,1,0.14285714285714285,1,0.0,0,0,0,0,0,0,0,1,0,0,1,1
3525,32206,a1hltiyDilurEIFnwffjQJuCpkjLjysQ,bWdj2GDclj5ofokWjzoa5jAwMkxCykd6,1,0,0,0,0,0,1,0,1,0.14285714285714285,1,0.0,0,0,0,0,0,0,0,1,0,0,1,1
3526,32213,Vk7MZGxGXuacnc2MpD5fuExvo0K32AnZ,5X6FeZozNMgE2VRi3MJYjkkFK8SETtu2,1,0,0,0,0,0,1,0,1,0.14285714285714285,1,0.0,0,0,0,0,0,0,0,1,0,0,1,1
3527,32220,dpAJ54wEPUDHZcYRCRrxvDfIakq9pmaQ,SpATywNh6bZuzm8s1ceuBUnMUAeoAHHw,41,43,10,38,6,4,14,1,116,16.571428571428573,7,0.0,12,10,36,6,31,4,2,14,1,64,52,1
3528,32227,iJftBP3zncmjUCwGWSZ77IUrDb3Dt8rz,RXDvfPUBYFlVdlueBFbLW0mhhAyGEqpt,6,3,1,0,1,0,2,0,7,1.0,1,0.0,0,1,0,1,3,0,0,2,0,2,5,1
3529,32231,1SB9qi7MaxHcbORi1JFl9LLHs6wwG3kU,SpATywNh6bZuzm8s1ceuBUnMUAeoAHHw,37,38,0,39,0,2,9,2,90,12.857142857142858,2,0.0,8,0,35,0,30,2,4,9,2,43,47,0
3530,32235,a2KqV4OdHZk4ucffhIhWG5E1QwAi4iE7,SpATywNh6bZuzm8s1ceuBUnMUAeoAHHw,10,8,2,0,2,0,7,0,19,2.7142857142857144,2,0.0,2,2,0,2,6,0,0,7,0,6,13,0
3531,32237,qh4tHm7Ijtk0rXK87a1UXx5JdnCnPyij,7GRhBDsirIGkRZBtSMEzNTyDr2JQm4xx,5,3,2,0,0,0,2,0,7,1.0,1,0.0,0,2,0,0,3,0,0,2,0,2,5,1
3532,32248,s54A0hFU7GzRUM0cq0hWJTDlnMIM1TAX,SpATywNh6bZuzm8s1ceuBUnMUAeoAHHw,44,59,34,43,22,0,8,0,166,23.714285714285715,6,0.0,11,34,40,22,48,0,3,8,0,107,59,1
3533,32253,ttxTsF9ExfVKBVMcQbsoZt6AA8x2bWVB,SpATywNh6bZuzm8s1ceuBUnMUAeoAHHw,14,43,6,22,0,24,15,1,111,15.857142857142858,6,0.0,22,6,19,0,21,24,3,15,1,47,64,1
3534,32257,KJtTFVCUZxFPCdrcl94b8VUY3eA2PtX6,5X6FeZozNMgE2VRi3MJYjkkFK8SETtu2,1,0,0,0,0,0,1,0,1,0.14285714285714285,1,0.0,0,0,0,0,0,0,0,1,0,0,1,1
3535,32265,COpqi7PB37yJZ0BYYjHIpqMxiJ4vAe0U,SpATywNh6bZuzm8s1ceuBUnMUAeoAHHw,1,0,0,0,0,0,1,0,1,0.14285714285714285,1,0.0,0,0,0,0,0,0,0,1,0,0,1,1
3536,32266,JfQVgXDVu1NGs9lcRBOD4w6V7BSaZCc2,SpATywNh6bZuzm8s1ceuBUnMUAeoAHHw,56,62,37,36,27,18,12,1,193,27.571428571428573,3,0.0,17,37,35,27,45,18,1,12,1,116,77,1
3537,32277,TEmVdQ7zwLYXmbCXgKpcJL6SMosCkEk6,7GRhBDsirIGkRZBtSMEzNTyDr2JQm4xx,13,12,5,4,4,8,9,4,46,6.571428571428571,1,0.0,4,5,3,4,8,8,1,9,4,16,30,1
3538,32278,coj5NqErnlD9ozminSGxVugmS0slNqs1,bWdj2GDclj5ofokWjzoa5jAwMkxCykd6,9,8,1,0,0,1,7,1,18,2.5714285714285716,2,0.0,0,1,0,0,8,1,0,7,1,1,17,1
3539,32281,SSlieJULaqRb1C7jSzOwyPvbJnH3adQv,7GRhBDsirIGkRZBtSMEzNTyDr2JQm4xx,50,76,6,151,16,6,8,0,263,37.57142857142857,7,0.0,36,6,131,16,40,6,20,8,0,189,74,1
3540,32289,5getYNIZ2hnUwVH9nwJiD9At1XFs260U,RXDvfPUBYFlVdlueBFbLW0mhhAyGEqpt,96,136,10,281,9,24,17,2,479,68.42857142857143,10,0.0,36,10,255,9,100,24,26,17,2,310,169,0
3541,32298,mXsmDArxUTe9rMFHp3cGPJEx5ACYKD90,RXDvfPUBYFlVdlueBFbLW0mhhAyGEqpt,1,0,0,0,0,0,1,0,1,0.14285714285714285,1,0.0,0,0,0,0,0,0,0,1,0,0,1,1
3542,32327,uC9kT2KA2FrN5E2wnyLKuknCQiL2UjyY,SpATywNh6bZuzm8s1ceuBUnMUAeoAHHw,39,48,1,52,1,14,26,1,143,20.428571428571427,3,0.0,16,1,42,1,32,14,10,26,1,60,83,0
3543,32338,AgNNzeJI1RzulgZ7Mt174twC5BMmXMhy,SpATywNh6bZuzm8s1ceuBUnMUAeoAHHw,16,49,21,0,0,0,7,0,77,11.0,2,0.0,10,21,0,0,39,0,0,7,0,31,46,0
3544,32350,4Z7KasuRx9CbJCcpGQot8eWIzFoK9Y6e,G8EPVSXsOYB5YQWZGiz1aVq5Pgr2GrQu,15,23,12,16,6,1,8,2,68,9.714285714285714,4,0.0,6,12,13,6,17,1,3,8,2,37,31,0
3545,32369,nOWwmMm8RUDfPfoqvXy3xmkIL6qZiu0a,A3fsA9Zfv1X2fVEQhTw51lKENdNrEqT3,1,0,0,0,0,0,2,0,2,0.2857142857142857,1,0.0,0,0,0,0,0,0,0,2,0,0,2,1
3546,32378,dnBboDTKZBSq62soTT8p1zFH5HInmJMi,SpATywNh6bZuzm8s1ceuBUnMUAeoAHHw,42,37,27,34,14,10,11,0,133,19.0,5,0.0,6,27,34,14,31,10,0,11,0,81,52,0
3547,32387,40BfkvCbbDiXljpQ7TxzzDakjMbYaL3S,SpATywNh6bZuzm8s1ceuBUnMUAeoAHHw,24,43,19,66,1,2,8,0,139,19.857142857142858,6,0.0,20,19,59,1,23,2,7,8,0,99,40,0
3548,32388,zY3LGOKMRR2PDg5R97BZ2yUdZPtM97Yl,SpATywNh6bZuzm8s1ceuBUnMUAeoAHHw,15,15,7,0,4,0,5,0,31,4.428571428571429,2,0.0,0,7,0,4,15,0,0,5,0,11,20,0
3549,32397,nOWwmMm8RUDfPfoqvXy3xmkIL6qZiu0a,RXDvfPUBYFlVdlueBFbLW0mhhAyGEqpt,1,0,0,0,0,0,1,0,1,0.14285714285714285,1,0.0,0,0,0,0,0,0,0,1,0,0,1,1
3550,32404,w7790lyNDi5biQPgaVfIpYKtROrGndED,SpATywNh6bZuzm8s1ceuBUnMUAeoAHHw,50,188,61,44,25,6,45,0,369,52.714285714285715,8,0.0,18,61,39,25,170,6,5,45,0,143,226,1
3551,32414,vQKXRGJivHAUfIMdau8F2EHQ9nob0SwQ,SpATywNh6bZuzm8s1ceuBUnMUAeoAHHw,5,3,1,0,1,2,3,0,10,1.4285714285714286,1,0.0,0,1,0,1,3,2,0,3,0,2,8,0
3552,32418,JWL56Ty5ftfkoPK2UQMZpNAsXYgyc1GR,SpATywNh6bZuzm8s1ceuBUnMUAeoAHHw,6,5,0,0,0,0,10,0,15,2.142857142857143,1,0.0,0,0,0,0,5,0,0,10,0,0,15,1
3553,32423,FW47VC0lzmys2S4k8Ky52JrXCSFDeyeP,A3fsA9Zfv1X2fVEQhTw51lKENdNrEqT3,11,11,7,0,3,0,5,0,26,3.7142857142857144,2,0.0,0,7,0,3,11,0,0,5,0,10,16,1
3554,32428,sgWvC8NRvYtrmKjALzTvn9SNvnbzDMjJ,5X6FeZozNMgE2VRi3MJYjkkFK8SETtu2,7,9,0,6,1,0,2,0,18,2.5714285714285716,1,0.0,4,0,6,1,5,0,0,2,0,11,7,1
3555,32435,QqE2Xjwy9gUzOvFdkDqAwAaNZLBZkxvd,7GRhBDsirIGkRZBtSMEzNTyDr2JQm4xx,43,146,8,90,13,68,38,0,363,51.857142857142854,11,0.0,77,8,77,13,69,68,13,38,0,175,188,1
3556,32437,gGSMkNgPdXpBQgdZzyjzifomyCxFSNyt,A3fsA9Zfv1X2fVEQhTw51lKENdNrEqT3,71,68,40,118,21,31,48,1,327,46.714285714285715,14,0.0,6,40,106,21,62,31,12,48,1,173,154,0
3557,32438,ljhELjrE7nbOy1tZAQRzQ0d2zvHLtBFk,SpATywNh6bZuzm8s1ceuBUnMUAeoAHHw,14,13,5,17,3,0,2,0,40,5.714285714285714,2,0.0,4,5,14,3,9,0,3,2,0,26,14,1
3558,32439,sbafJyL5hxYHWbu0cbLBSCFDQh5Oe8Ww,RXDvfPUBYFlVdlueBFbLW0mhhAyGEqpt,29,59,5,25,7,12,9,0,117,16.714285714285715,5,0.0,6,5,22,7,53,12,3,9,0,40,77,0
3559,32440,PFladZHBxKsed81P3VF9JVKRBqF9WnYc,A3fsA9Zfv1X2fVEQhTw51lKENdNrEqT3,3,2,1,0,0,0,1,0,4,0.5714285714285714,1,0.0,0,1,0,0,2,0,0,1,0,1,3,1
3560,32458,0zDhC7Bi6IWixLnOwX1MJzbdTwc3fSoD,SpATywNh6bZuzm8s1ceuBUnMUAeoAHHw,7,3,2,0,2,0,2,0,9,1.2857142857142858,1,0.0,0,2,0,2,3,0,0,2,0,4,5,1
3561,32462,g5xxNUIA9RHROOUKRydh6JdZ7s9weUGi,RXDvfPUBYFlVdlueBFbLW0mhhAyGEqpt,1,0,0,0,0,0,1,0,1,0.14285714285714285,1,0.0,0,0,0,0,0,0,0,1,0,0,1,1
3562,32465,X81ozmfRR6khTijYbF3duBVCPMYOxHia,SpATywNh6bZuzm8s1ceuBUnMUAeoAHHw,30,41,24,38,14,5,11,0,133,19.0,2,0.0,11,24,31,14,30,5,7,11,0,80,53,0
3563,32466,JJro1amtaUogvd4Vkbdsh0DmnqfguR8P,SpATywNh6bZuzm8s1ceuBUnMUAeoAHHw,19,15,7,27,0,0,6,0,55,7.857142857142857,2,0.0,6,7,23,0,9,0,4,6,0,36,19,1
3564,32471,1BEoeS35Ni9RflXqhdHAKpKpQ07oVqkG,SpATywNh6bZuzm8s1ceuBUnMUAeoAHHw,37,100,8,41,2,7,42,4,204,29.142857142857142,7,0.0,20,8,38,2,80,7,3,42,4,68,136,0
3565,32473,c4hCwkmMWlqvj6IYLILNRvCebh0jrQGq,SpATywNh6bZuzm8s1ceuBUnMUAeoAHHw,46,45,43,18,34,0,2,0,142,20.285714285714285,2,0.0,0,43,15,34,45,0,3,2,0,92,50,0
3566,32477,LPul7vNnoWP2lahy0vntgg039NwfmlYY,SpATywNh6bZuzm8s1ceuBUnMUAeoAHHw,46,79,5,46,2,11,30,1,174,24.857142857142858,9,0.0,12,5,34,2,67,11,12,30,1,53,121,0
3567,32483,MauXcYq2z30gm4QmDqcfc1IfWjnRlPwg,SpATywNh6bZuzm8s1ceuBUnMUAeoAHHw,28,71,4,0,3,0,18,2,98,14.0,9,0.0,0,4,0,3,71,0,0,18,2,7,91,0
3568,32499,mGnlknhC56CLUX07J2uvTiiVnxb6XIJ6,A3fsA9Zfv1X2fVEQhTw51lKENdNrEqT3,15,9,7,0,4,5,8,0,33,4.714285714285714,2,0.0,0,7,0,4,9,5,0,8,0,11,22,0
3569,32502,vthDe5chpuGwbDUyc90EI2Y8jHRBb15H,5X6FeZozNMgE2VRi3MJYjkkFK8SETtu2,43,59,25,6,41,0,4,0,135,19.285714285714285,5,0.0,28,25,6,41,31,0,0,4,0,100,35,1
3570,32507,vhSKbWRNOosmCM74JqrukEsGTTYmFc38,SpATywNh6bZuzm8s1ceuBUnMUAeoAHHw,5,2,1,0,1,0,2,0,6,0.8571428571428571,1,0.0,0,1,0,1,2,0,0,2,0,2,4,1
3571,32520,AFUJTbEqqgSsqCkUsNrjbPAjZvFwpzeW,G8EPVSXsOYB5YQWZGiz1aVq5Pgr2GrQu,157,200,60,395,40,0,18,0,713,101.85714285714286,7,0.0,76,60,276,40,124,0,119,18,0,452,261,0
3572,32530,KbfT30uvubax3lKEct6iblV8VhlPaIEn,G8EPVSXsOYB5YQWZGiz1aVq5Pgr2GrQu,52,57,32,100,20,0,7,0,216,30.857142857142858,6,0.0,7,32,85,20,50,0,15,7,0,144,72,0
3573,32532,4PweNxjsOhOMjaZ2FlK8Sbpgnsb73xXB,SpATywNh6bZuzm8s1ceuBUnMUAeoAHHw,11,5,4,0,4,0,3,0,16,2.2857142857142856,1,0.0,0,4,0,4,5,0,0,3,0,8,8,1
3574,32533,iVbKlCBdSTOnwPES1gHCC6kJee3O7Vv2,SpATywNh6bZuzm8s1ceuBUnMUAeoAHHw,1,0,0,0,0,0,2,0,2,0.2857142857142857,1,0.0,0,0,0,0,0,0,0,2,0,0,2,1
3575,32535,msKx0ivmnd2fyZkUe9cuLZiNYOEcdmOY,SpATywNh6bZuzm8s1ceuBUnMUAeoAHHw,17,14,10,17,6,0,3,0,50,7.142857142857143,3,0.0,3,10,15,6,11,0,2,3,0,34,16,1
3576,32536,13AvYdfA6LYkS80MstJgmNNdfNqd80ja,bWdj2GDclj5ofokWjzoa5jAwMkxCykd6,11,7,1,0,1,3,17,1,30,4.285714285714286,5,0.0,0,1,0,1,7,3,0,17,1,2,28,0
3577,32545,mS5t9CRTu7dLDWlOhRLNtJoqifYvSGih,SpATywNh6bZuzm8s1ceuBUnMUAeoAHHw,15,63,41,13,0,0,17,0,134,19.142857142857142,2,0.0,16,41,11,0,47,0,2,17,0,68,66,0
3578,32547,wkfBzItw0JCH6ZUz2WUZn7ngJ5M4Oksy,SpATywNh6bZuzm8s1ceuBUnMUAeoAHHw,47,118,10,31,6,71,32,0,268,38.285714285714285,14,0.0,17,10,29,6,101,71,2,32,0,62,206,0
3579,32555,g14jBWDuqUHRwpf4jHpBljeNVwCyjgqd,G8EPVSXsOYB5YQWZGiz1aVq5Pgr2GrQu,57,88,45,0,43,0,10,0,186,26.571428571428573,6,0.0,11,45,0,43,77,0,0,10,0,99,87,1
3580,32556,F3xkNuC9E3BV92ndqV8Ep20uYNFiQx8b,RXDvfPUBYFlVdlueBFbLW0mhhAyGEqpt,1,0,0,0,0,0,1,0,1,0.14285714285714285,1,0.0,0,0,0,0,0,0,0,1,0,0,1,1
3581,32563,8UEpALpBHIm1SL5uEKGhNPayCrDss58M,A3fsA9Zfv1X2fVEQhTw51lKENdNrEqT3,10,6,4,0,4,0,3,0,17,2.4285714285714284,1,0.0,0,4,0,4,6,0,0,3,0,8,9,1
3582,32579,rQ8twu2Y4JlbZAVSeNSb6mmUSGGvpIAq,SpATywNh6bZuzm8s1ceuBUnMUAeoAHHw,51,95,21,64,10,5,27,0,222,31.714285714285715,10,0.0,22,21,58,10,73,5,6,27,0,111,111,0
3583,32587,dwKCRrq2cYlFl5YxmnjTpirr5PBMVnOq,RXDvfPUBYFlVdlueBFbLW0mhhAyGEqpt,34,85,49,0,33,0,8,0,175,25.0,3,0.0,5,49,0,33,80,0,0,8,0,87,88,0
3584,32589,BbSjcbtyrTEKVbvJAaKNJmSTAo0uyQCs,SpATywNh6bZuzm8s1ceuBUnMUAeoAHHw,12,14,4,0,3,1,12,1,35,5.0,1,0.0,0,4,0,3,14,1,0,12,1,7,28,1
3585,32600,jaDaYkvR41YbLhesvf9mW32i93zNzaSK,RXDvfPUBYFlVdlueBFbLW0mhhAyGEqpt,52,71,39,73,11,3,31,1,229,32.714285714285715,9,0.0,9,39,67,11,62,3,6,31,1,126,103,0
3586,32607,zlC9nEdRrqLSPX386Mctiz9fIdlU29GI,SpATywNh6bZuzm8s1ceuBUnMUAeoAHHw,58,72,46,34,30,2,14,0,198,28.285714285714285,3,0.0,17,46,30,30,55,2,4,14,0,123,75,0
3587,32617,ncKGr6xR4Vhs3wPeU0aqO1sSEow8LN64,SpATywNh6bZuzm8s1ceuBUnMUAeoAHHw,45,78,27,37,12,124,48,6,332,47.42857142857143,11,0.0,20,27,32,12,58,124,5,48,6,91,241,0
3588,32621,rpaUwDDLQ5SNQtDfK9UH7GnL6AP0Q8Ts,SpATywNh6bZuzm8s1ceuBUnMUAeoAHHw,9,6,2,0,3,0,10,1,22,3.142857142857143,1,0.0,0,2,0,3,6,0,0,10,1,5,17,1
3589,32627,2s1w2v8MgoByNGqR51pltJWsiHzHAFZ1,A3fsA9Zfv1X2fVEQhTw51lKENdNrEqT3,1,0,0,0,0,0,1,0,1,0.14285714285714285,1,0.0,0,0,0,0,0,0,0,1,0,0,1,0
3590,32633,KSfQPUyfWWfWDmmi6m3KXcKzxz89wkwt,SpATywNh6bZuzm8s1ceuBUnMUAeoAHHw,43,83,30,19,21,6,14,0,173,24.714285714285715,7,0.0,15,30,19,21,68,6,0,14,0,85,88,0
3591,32634,vjkHj7F0L8pzTZztOfHA8KLslVpjNBKq,G8EPVSXsOYB5YQWZGiz1aVq5Pgr2GrQu,72,53,5,280,3,1,33,9,384,54.857142857142854,4,0.0,20,5,237,3,33,1,43,33,9,265,119,0
3592,32637,E31FYfZk8Go2gNZUtflrVZ8SeSYLm9Rk,bWdj2GDclj5ofokWjzoa5jAwMkxCykd6,4,2,0,0,0,0,4,0,6,0.8571428571428571,1,0.0,0,0,0,0,2,0,0,4,0,0,6,1
3593,32638,EkHNRKsccWzYAV6ML4mvFJOcSzuUNJIQ,bWdj2GDclj5ofokWjzoa5jAwMkxCykd6,2,0,0,0,0,0,4,0,4,0.5714285714285714,2,0.0,0,0,0,0,0,0,0,4,0,0,4,1
3594,32646,AQAJ36M8w2XxIpmKxSmQ7toB8IMFMa8v,SpATywNh6bZuzm8s1ceuBUnMUAeoAHHw,5,2,1,0,1,0,3,0,7,1.0,1,0.0,0,1,0,1,2,0,0,3,0,2,5,1
3595,32650,vhSKbWRNOosmCM74JqrukEsGTTYmFc38,A3fsA9Zfv1X2fVEQhTw51lKENdNrEqT3,1,0,0,0,0,0,1,0,1,0.14285714285714285,1,0.0,0,0,0,0,0,0,0,1,0,0,1,1
3596,32652,nqDX1tmEeTnbqCn9T8Crn5CYQgmIy9Eq,SpATywNh6bZuzm8s1ceuBUnMUAeoAHHw,43,98,54,42,15,23,41,5,278,39.714285714285715,9,0.0,25,54,38,15,73,23,4,41,5,132,146,0
3597,32654,zQwNebC3qLt6HHOuoG7oSsRj8l42sEdO,7GRhBDsirIGkRZBtSMEzNTyDr2JQm4xx,10,16,4,0,2,0,4,1,27,3.857142857142857,2,0.0,0,4,0,2,16,0,0,4,1,6,21,1
3598,32661,qKc8EuUOlEzXysFMoXghKaieW3HIaePV,SpATywNh6bZuzm8s1ceuBUnMUAeoAHHw,41,125,46,56,8,1,35,0,271,38.714285714285715,12,0.0,25,46,48,8,100,1,8,35,0,127,144,0
3599,32663,RQ7L9CpArhwtUrlKYRf29Ou4YmyW3xpx,A3fsA9Zfv1X2fVEQhTw51lKENdNrEqT3,18,26,15,0,10,0,6,0,57,8.142857142857142,3,0.0,0,15,0,10,26,0,0,6,0,25,32,0
3600,32673,bvlRhTMK84NG0AHvWoPSuNz8Lz6khZji,A3fsA9Zfv1X2fVEQhTw51lKENdNrEqT3,2,0,0,0,0,0,6,0,6,0.8571428571428571,1,0.0,0,0,0,0,0,0,0,6,0,0,6,1
3601,32675,S65yhLgjTGwwuDt6C6cjI82AJbGfYIiK,SpATywNh6bZuzm8s1ceuBUnMUAeoAHHw,46,55,30,44,19,0,17,1,166,23.714285714285715,4,0.0,21,30,37,19,34,0,7,17,1,107,59,1
3602,32680,4m1Dg29Y9pbvJRrOBjNRbyWgB17yJl3U,G8EPVSXsOYB5YQWZGiz1aVq5Pgr2GrQu,8,5,2,0,2,0,5,0,14,2.0,2,0.0,0,2,0,2,5,0,0,5,0,4,10,0
3603,32681,t6I1fQ9ItZRIjAyoxww7ONpoKNI8Ya9L,SpATywNh6bZuzm8s1ceuBUnMUAeoAHHw,17,14,0,34,0,0,11,0,59,8.428571428571429,2,0.0,8,0,31,0,6,0,3,11,0,39,20,0
3604,32686,DE2u0bz0HnoULwJGtrWEHwtLyRyGfjcB,SpATywNh6bZuzm8s1ceuBUnMUAeoAHHw,53,99,61,45,40,18,28,0,291,41.57142857142857,6,0.0,21,61,38,40,78,18,7,28,0,160,131,0
3605,32688,vsH3qB64VOSnSTFhrkJQnHqm8c83psRR,SpATywNh6bZuzm8s1ceuBUnMUAeoAHHw,58,123,45,77,22,93,11,0,371,53.0,7,0.0,16,45,65,22,107,93,12,11,0,148,223,0
3606,32691,zIxh0JW4JCwiox9jMtpfpkw3WRcYtUgv,SpATywNh6bZuzm8s1ceuBUnMUAeoAHHw,47,107,15,41,11,10,28,2,214,30.571428571428573,3,0.0,23,15,34,11,84,10,7,28,2,83,131,0
3607,32693,NrExtDPytZeckpp4FyIosvaEjFjzywmC,A3fsA9Zfv1X2fVEQhTw51lKENdNrEqT3,68,18,1,204,0,0,15,0,238,34.0,4,0.0,4,1,192,0,14,0,12,15,0,197,41,1
3608,32695,y8imMYdOt2q2mj8pfo2jTgj4ApcxIHQk,SpATywNh6bZuzm8s1ceuBUnMUAeoAHHw,4,3,0,0,0,0,1,0,4,0.5714285714285714,1,0.0,0,0,0,0,3,0,0,1,0,0,4,0
3609,32701,abaCPMr6xWMrCiOErEioyXWBSEERS1tE,7GRhBDsirIGkRZBtSMEzNTyDr2JQm4xx,17,14,8,0,6,1,14,2,45,6.428571428571429,2,0.0,3,8,0,6,11,1,0,14,2,17,28,1
3610,32704,YKYIjfKiQT6jdADuFkuvypbfW8jlgM1n,SpATywNh6bZuzm8s1ceuBUnMUAeoAHHw,30,26,14,26,9,0,3,0,78,11.142857142857142,2,0.0,10,14,21,9,16,0,5,3,0,54,24,1
3611,32710,HJ2gv3yF0WCJxGH8T6tjLTFYdM4sCizz,RXDvfPUBYFlVdlueBFbLW0mhhAyGEqpt,87,147,84,198,40,28,40,2,539,77.0,8,0.0,37,84,171,40,110,28,27,40,2,332,207,0
3612,32714,bRoCd7cLhhjZ85w2yZEA6KmzEGTRpVRz,SpATywNh6bZuzm8s1ceuBUnMUAeoAHHw,31,50,5,37,3,7,14,0,116,16.571428571428573,4,0.0,6,5,33,3,44,7,4,14,0,47,69,0
3613,32715,KvjMYuIyC1QuxskkhpxIY7MoDNSU5FMk,7GRhBDsirIGkRZBtSMEzNTyDr2JQm4xx,16,23,14,0,11,0,2,0,50,7.142857142857143,1,0.0,6,14,0,11,17,0,0,2,0,31,19,1
3614,32720,JmCoruZKuYTEfRy2RtllkeekTzFeqi2M,SpATywNh6bZuzm8s1ceuBUnMUAeoAHHw,9,18,6,0,5,1,6,0,36,5.142857142857143,3,0.0,1,6,0,5,17,1,0,6,0,12,24,0
3615,32721,aLRP3ahB5SIcOn5vpM1VPEh9ib2QIioX,A3fsA9Zfv1X2fVEQhTw51lKENdNrEqT3,58,76,41,0,37,0,5,0,159,22.714285714285715,4,0.0,0,41,0,37,76,0,0,5,0,78,81,1
3616,32722,Jd5OP6GIsguRdsq9k3eSYNENmzhPbdGe,A3fsA9Zfv1X2fVEQhTw51lKENdNrEqT3,9,9,6,0,1,0,6,0,22,3.142857142857143,4,0.0,0,6,0,1,9,0,0,6,0,7,15,0
3617,32732,L74tKRZpBi1qsh0NM3EwE5D87acCLK8s,A3fsA9Zfv1X2fVEQhTw51lKENdNrEqT3,134,149,77,447,31,3,55,0,762,108.85714285714286,19,0.0,13,77,441,31,136,3,6,55,0,562,200,0
3618,32746,mXsmDArxUTe9rMFHp3cGPJEx5ACYKD90,7GRhBDsirIGkRZBtSMEzNTyDr2JQm4xx,29,45,19,37,9,6,7,0,123,17.571428571428573,5,0.0,18,19,31,9,27,6,6,7,0,77,46,1
3619,32753,Gn3GzN2xweKhiR4C9qIb4ocllZ2lANYz,SpATywNh6bZuzm8s1ceuBUnMUAeoAHHw,12,17,11,0,5,0,7,0,40,5.714285714285714,4,0.0,0,11,0,5,17,0,0,7,0,16,24,1
3620,32769,vEKYOhRdGZ59kfXY6wTO63YZY4EqPYqX,SpATywNh6bZuzm8s1ceuBUnMUAeoAHHw,37,58,41,10,22,0,10,0,141,20.142857142857142,7,0.0,5,41,9,22,53,0,1,10,0,77,64,0
3621,32777,TW8ndAffUINsh706iQobn31l3IsMOQi5,SpATywNh6bZuzm8s1ceuBUnMUAeoAHHw,50,91,38,30,30,1,28,0,218,31.142857142857142,5,0.0,9,38,28,30,82,1,2,28,0,105,113,0
3622,32781,mPCmohVETKOBEAkMNdnfTJW7kVWg1ArQ,bWdj2GDclj5ofokWjzoa5jAwMkxCykd6,12,25,1,0,1,0,8,0,35,5.0,1,0.0,3,1,0,1,22,0,0,8,0,5,30,1
3623,32826,wCKxyDpTEsiI3UuDi33CaUGYhXjKnrBv,SpATywNh6bZuzm8s1ceuBUnMUAeoAHHw,15,15,8,6,5,0,4,0,38,5.428571428571429,2,0.0,2,8,5,5,13,0,1,4,0,20,18,0
3624,32837,wZVSpaATIDuE7qW0svZJi84Cpi6PMqWg,SpATywNh6bZuzm8s1ceuBUnMUAeoAHHw,16,40,6,12,2,0,17,0,77,11.0,5,0.0,6,6,10,2,34,0,2,17,0,24,53,1
3625,32848,shBFkXtQXH3viJ4rhxwHBPknnWE8q371,SpATywNh6bZuzm8s1ceuBUnMUAeoAHHw,1,0,0,0,0,0,1,0,1,0.14285714285714285,1,0.0,0,0,0,0,0,0,0,1,0,0,1,1
3626,32868,Hk1cgW0d6IHp4JJgdPvorinTv3vI8Eld,A3fsA9Zfv1X2fVEQhTw51lKENdNrEqT3,1,0,0,0,0,0,2,0,2,0.2857142857142857,1,0.0,0,0,0,0,0,0,0,2,0,0,2,1
3627,32872,XEcLEoVa2SWvlFcbbhIECksb9a6XvMec,RXDvfPUBYFlVdlueBFbLW0mhhAyGEqpt,71,74,42,193,22,9,11,6,357,51.0,3,0.0,28,42,172,22,46,9,21,11,6,264,93,0
3628,32875,096xYyhB9kL7G6lT7J9rVrXyGNwUToLF,RXDvfPUBYFlVdlueBFbLW0mhhAyGEqpt,40,43,33,0,2,5,6,2,91,13.0,1,0.0,7,33,0,2,36,5,0,6,2,42,49,0
3629,32876,YdtHeotp7qxTsE68WXV4PTL8YQlRtZSZ,SpATywNh6bZuzm8s1ceuBUnMUAeoAHHw,10,6,3,0,3,0,6,0,18,2.5714285714285716,2,0.0,0,3,0,3,6,0,0,6,0,6,12,0
3630,32881,y7ML2j3yhLTXFlpVgDfbFQ7iV1QJE8KN,G8EPVSXsOYB5YQWZGiz1aVq5Pgr2GrQu,1,0,0,0,0,0,1,0,1,0.14285714285714285,1,0.0,0,0,0,0,0,0,0,1,0,0,1,1
3631,32884,z2Zz9wVXxnQo0wOtqHQc06HPM9iWXDoN,SpATywNh6bZuzm8s1ceuBUnMUAeoAHHw,36,55,22,40,10,26,26,2,181,25.857142857142858,4,0.0,12,22,34,10,43,26,6,26,2,78,103,0
3632,32887,9WVTv7dWHzTCHwCGLSPAioAO2udyHWmu,SpATywNh6bZuzm8s1ceuBUnMUAeoAHHw,48,92,53,41,42,32,41,0,301,43.0,12,0.0,31,53,35,42,61,32,6,41,0,161,140,0
3633,32895,GCXdwkqD60eGG5W317sN3ZNf27MOQY4U,SpATywNh6bZuzm8s1ceuBUnMUAeoAHHw,7,5,1,0,1,0,2,0,9,1.2857142857142858,1,0.0,0,1,0,1,5,0,0,2,0,2,7,1
3634,32896,p7kSnjO0uUcIRggHewx0HDSWkZbQpZMf,5X6FeZozNMgE2VRi3MJYjkkFK8SETtu2,2,0,0,0,0,0,3,0,3,0.42857142857142855,2,0.0,0,0,0,0,0,0,0,3,0,0,3,0
3635,32902,4vKI2gaXrHATS50fqVyDxXcmRy0MrgJS,5X6FeZozNMgE2VRi3MJYjkkFK8SETtu2,1,0,0,0,0,0,1,0,1,0.14285714285714285,1,0.0,0,0,0,0,0,0,0,1,0,0,1,1
3636,32906,ZE27RADj3bE2oGbL4tXAfIaeVlYNn4oN,SpATywNh6bZuzm8s1ceuBUnMUAeoAHHw,42,73,29,58,9,10,13,1,193,27.571428571428573,6,0.0,30,29,51,9,43,10,7,13,1,119,74,0
3637,32912,c4hCwkmMWlqvj6IYLILNRvCebh0jrQGq,bWdj2GDclj5ofokWjzoa5jAwMkxCykd6,4,3,2,0,2,0,2,0,9,1.2857142857142858,1,0.0,0,2,0,2,3,0,0,2,0,4,5,1
3638,32917,dwKCRrq2cYlFl5YxmnjTpirr5PBMVnOq,SpATywNh6bZuzm8s1ceuBUnMUAeoAHHw,12,32,16,0,7,5,5,0,65,9.285714285714286,3,0.0,9,16,0,7,23,5,0,5,0,32,33,0
3639,32923,NqKjMSY6eOZQ1uSyzlPrquJVqzjvSO7O,SpATywNh6bZuzm8s1ceuBUnMUAeoAHHw,57,103,46,39,18,36,31,5,278,39.714285714285715,12,0.0,18,46,39,18,85,36,0,31,5,121,157,0
3640,32927,c4hCwkmMWlqvj6IYLILNRvCebh0jrQGq,RXDvfPUBYFlVdlueBFbLW0mhhAyGEqpt,20,15,8,34,6,5,6,1,75,10.714285714285714,1,0.0,2,8,29,6,13,5,5,6,1,45,30,0
3641,32929,OWN7QY4MoQINwciZKacEUOaJkqenbOMp,SpATywNh6bZuzm8s1ceuBUnMUAeoAHHw,16,20,9,15,4,15,12,5,80,11.428571428571429,3,0.0,8,9,13,4,12,15,2,12,5,34,46,0
3642,32936,LWVN5HyIlUP5vqqhXm830bNH0dXW6G7Q,G8EPVSXsOYB5YQWZGiz1aVq5Pgr2GrQu,27,34,15,16,48,4,10,1,128,18.285714285714285,3,0.0,2,15,13,48,32,4,3,10,1,78,50,0
3643,32947,1KCmpfcoDnRnd9ITYAgYi4eQPwc5jiJz,5X6FeZozNMgE2VRi3MJYjkkFK8SETtu2,20,54,14,28,18,0,8,0,122,17.428571428571427,6,0.0,25,14,23,18,29,0,5,8,0,80,42,1
3644,32948,HeUmba4DxhcRtDoTRVT5PFbN9je6Gg4G,SpATywNh6bZuzm8s1ceuBUnMUAeoAHHw,1,0,0,0,0,0,1,0,1,0.14285714285714285,1,0.0,0,0,0,0,0,0,0,1,0,0,1,1
3645,32962,gi1cGXmBNmpbe6lA2hzKFh8EEd7gQMCM,7GRhBDsirIGkRZBtSMEzNTyDr2JQm4xx,1,0,0,0,0,0,1,0,1,0.14285714285714285,1,0.0,0,0,0,0,0,0,0,1,0,0,1,1
3646,32969,z4c8EBwIn89viFGIwasAjQhkMGV3BTQj,SpATywNh6bZuzm8s1ceuBUnMUAeoAHHw,16,31,18,14,14,0,2,0,79,11.285714285714286,4,0.0,7,18,10,14,24,0,4,2,0,49,30,0
3647,32970,f9VMkfOoUWXzqEbeO2IX0YOVcNKnSKLo,7GRhBDsirIGkRZBtSMEzNTyDr2JQm4xx,1,0,0,0,0,0,1,0,1,0.14285714285714285,1,0.0,0,0,0,0,0,0,0,1,0,0,1,1
3648,32971,qUsQUczCM7yxZspK4y0wqEbk7aa4p04H,SpATywNh6bZuzm8s1ceuBUnMUAeoAHHw,1,0,0,0,0,0,1,0,1,0.14285714285714285,1,0.0,0,0,0,0,0,0,0,1,0,0,1,1
3649,32976,E7QFiJdCviuClYDIfnaKnxTdSk0i534L,7GRhBDsirIGkRZBtSMEzNTyDr2JQm4xx,1,0,0,0,0,0,1,0,1,0.14285714285714285,1,0.0,0,0,0,0,0,0,0,1,0,0,1,1
3650,32983,BtS3BvehCjq4QaGPbzrC7JIugP6OKoPy,7GRhBDsirIGkRZBtSMEzNTyDr2JQm4xx,47,104,46,73,32,31,33,2,321,45.857142857142854,7,0.0,41,46,61,32,63,31,12,33,2,180,141,1
3651,33024,P7HoHyQzVXLghYr6m3MYTEIsDQbHfDfp,SpATywNh6bZuzm8s1ceuBUnMUAeoAHHw,46,50,29,36,15,0,12,0,142,20.285714285714285,9,0.0,10,29,35,15,40,0,1,12,0,89,53,0
3652,33033,h7I4MrR4mKnNKblXSAy8wcbhlYTfxUMt,RXDvfPUBYFlVdlueBFbLW0mhhAyGEqpt,6,5,2,0,1,0,2,0,10,1.4285714285714286,2,0.0,0,2,0,1,5,0,0,2,0,3,7,0
3653,33035,fsFhPwlLRADu3y98ioOv5tbQuyaSeyNN,SpATywNh6bZuzm8s1ceuBUnMUAeoAHHw,6,8,2,0,1,0,2,0,13,1.8571428571428572,1,0.0,0,2,0,1,8,0,0,2,0,3,10,0
3654,33064,R4jdTSzPeoexGjkDudtUNf4wM5QqkaKU,5X6FeZozNMgE2VRi3MJYjkkFK8SETtu2,1,0,0,0,0,0,1,0,1,0.14285714285714285,1,0.0,0,0,0,0,0,0,0,1,0,0,1,1
3655,33071,S4x7F2zwGMymIPjPy7YGoWTUwlKzmNvg,7GRhBDsirIGkRZBtSMEzNTyDr2JQm4xx,19,22,8,18,3,7,35,3,96,13.714285714285714,5,0.0,2,8,15,3,20,7,3,35,3,28,68,1
3656,33074,DNPg311dH1sJEozPjhQWBOgx4wvkLFM7,5X6FeZozNMgE2VRi3MJYjkkFK8SETtu2,4,0,0,0,0,1,3,1,5,0.7142857142857143,1,0.0,0,0,0,0,0,1,0,3,1,0,5,0
3657,33080,5ADMlR48WDr3F57JEz4JNbgGytxoga6J,SpATywNh6bZuzm8s1ceuBUnMUAeoAHHw,36,62,7,39,5,1,62,1,177,25.285714285714285,16,0.0,20,7,39,5,42,1,0,62,1,71,106,0
3658,33084,jAeQS6v1suZotlPWHh2m5nRATBxHiHCr,G8EPVSXsOYB5YQWZGiz1aVq5Pgr2GrQu,5,3,1,0,1,0,2,0,7,1.0,1,0.0,0,1,0,1,3,0,0,2,0,2,5,1
3659,33094,nZyLcN4vHeyiwwvW8JQP12ocO8k2uB5o,A3fsA9Zfv1X2fVEQhTw51lKENdNrEqT3,31,74,36,0,3,0,2,0,115,16.428571428571427,1,0.0,0,36,0,3,74,0,0,2,0,39,76,1
3660,33108,ixS1p3tBQwqQrlFRj6LavXiIpA0ocHQj,SpATywNh6bZuzm8s1ceuBUnMUAeoAHHw,42,86,5,52,2,0,11,1,157,22.428571428571427,5,0.0,40,5,47,2,46,0,5,11,1,94,63,1
3661,33123,31YnUQ787pms6asdEq4mYZdG40oJXIcC,SpATywNh6bZuzm8s1ceuBUnMUAeoAHHw,2,0,0,0,0,0,2,0,2,0.2857142857142857,1,0.0,0,0,0,0,0,0,0,2,0,0,2,1
3662,33126,g8FzZPNwpogRDZ96ajFkgFq4Hk5lGots,G8EPVSXsOYB5YQWZGiz1aVq5Pgr2GrQu,1,0,0,0,0,0,2,0,2,0.2857142857142857,2,0.0,0,0,0,0,0,0,0,2,0,0,2,1
3663,33127,FAyJy1gyoIxzJtXvVglyOve11ozvFF4C,SpATywNh6bZuzm8s1ceuBUnMUAeoAHHw,32,38,18,21,11,0,5,0,93,13.285714285714286,3,0.0,5,18,19,11,33,0,2,5,0,53,40,0
3664,33129,eBy9VnMLJAw0hqJXLuWSECKqPc7yNmPx,5X6FeZozNMgE2VRi3MJYjkkFK8SETtu2,16,15,8,18,1,8,12,2,64,9.142857142857142,4,0.0,3,8,16,1,12,8,2,12,2,28,36,1
3665,33140,Nl6KXQBQ15lo8Bj3xZmtCULVumxrpWOd,RXDvfPUBYFlVdlueBFbLW0mhhAyGEqpt,10,19,0,22,5,39,3,0,88,12.571428571428571,1,0.0,11,0,18,5,8,39,4,3,0,34,54,0
3666,33148,UNB2LODshs2HtKrBL5CYaUedKOvveRXk,SpATywNh6bZuzm8s1ceuBUnMUAeoAHHw,38,21,19,0,18,0,2,0,60,8.571428571428571,1,0.0,0,19,0,18,21,0,0,2,0,37,23,1
3667,33150,vU01Fxors0KlSd7gao1Z0nHesILTHNPI,SpATywNh6bZuzm8s1ceuBUnMUAeoAHHw,48,73,22,11,14,36,53,0,209,29.857142857142858,18,0.0,1,22,11,14,72,36,0,53,0,48,161,0
3668,33164,AJYnlahOLAGVXTJrzU8y7gkOQqLtYt6X,SpATywNh6bZuzm8s1ceuBUnMUAeoAHHw,47,58,33,44,19,7,7,0,168,24.0,4,0.0,13,33,40,19,45,7,4,7,0,105,63,0
3669,33169,FPQSXji4bDip0jB4obm0vWFPXClGuSyC,7GRhBDsirIGkRZBtSMEzNTyDr2JQm4xx,52,79,33,88,21,24,18,1,264,37.714285714285715,8,0.0,39,33,71,21,40,24,17,18,1,164,100,0
3670,33179,79cpMMK2EsbvkowaPozXyQoZKeC4iKuw,A3fsA9Zfv1X2fVEQhTw51lKENdNrEqT3,30,20,11,64,4,0,10,0,109,15.571428571428571,6,0.0,3,11,56,4,17,0,8,10,0,74,35,0
3671,33184,91SMPbwCYEBVQrvddh8BFR950javKvv6,A3fsA9Zfv1X2fVEQhTw51lKENdNrEqT3,9,3,2,0,2,0,11,0,18,2.5714285714285716,2,0.0,0,2,0,2,3,0,0,11,0,4,14,1
3672,33189,prx0F7eWxsl3d2mx5LUgQvJ105nB30Fw,SpATywNh6bZuzm8s1ceuBUnMUAeoAHHw,26,63,9,0,5,0,10,0,87,12.428571428571429,3,0.0,0,9,0,5,63,0,0,10,0,14,73,0
3673,33196,0qazDeX2ArYKUwsbw3YPo5IK1kBs3caI,G8EPVSXsOYB5YQWZGiz1aVq5Pgr2GrQu,6,6,2,0,1,0,2,0,11,1.5714285714285714,1,0.0,0,2,0,1,6,0,0,2,0,3,8,1
3674,33203,6oSvXBiE6hMQm6ur1TzQBxRkuWf4UJ1w,SpATywNh6bZuzm8s1ceuBUnMUAeoAHHw,32,106,43,28,11,17,43,2,250,35.714285714285715,7,0.0,30,43,22,11,76,17,6,43,2,106,144,0
3675,33215,P8yzAiNhRid702ItHIVI1p5U2WX8liH9,bWdj2GDclj5ofokWjzoa5jAwMkxCykd6,1,0,0,0,0,0,1,0,1,0.14285714285714285,1,0.0,0,0,0,0,0,0,0,1,0,0,1,1
3676,33217,P8yzAiNhRid702ItHIVI1p5U2WX8liH9,A3fsA9Zfv1X2fVEQhTw51lKENdNrEqT3,7,5,1,0,1,0,2,0,9,1.2857142857142858,1,0.0,1,1,0,1,4,0,0,2,0,3,6,1
3677,33224,M5i9wheFDK1paYxXA7PsW9kp3DBbWp4e,bWdj2GDclj5ofokWjzoa5jAwMkxCykd6,21,59,21,182,10,2,10,2,286,40.857142857142854,8,0.0,23,21,175,10,36,2,7,10,2,229,57,0
3678,33231,NMS9jGnwr8Vw7CGJJuppEbFTwlpwo7HM,SpATywNh6bZuzm8s1ceuBUnMUAeoAHHw,1,0,0,0,0,0,2,0,2,0.2857142857142857,1,0.0,0,0,0,0,0,0,0,2,0,0,2,1
3679,33241,JidGgSxCfdGzmokg3gMkwGiBLuw5F3te,SpATywNh6bZuzm8s1ceuBUnMUAeoAHHw,18,18,14,0,5,0,4,1,42,6.0,1,0.0,1,14,0,5,17,0,0,4,1,20,22,1
3680,33244,zXK10fuHzjlZN6zXC9UzE5cZssrYVIEu,5X6FeZozNMgE2VRi3MJYjkkFK8SETtu2,6,5,3,0,2,0,3,0,13,1.8571428571428572,2,0.0,0,3,0,2,5,0,0,3,0,5,8,1
3681,33249,tBYNgYMLcaid5WsG2NgVjslnqBmTbXuo,bWdj2GDclj5ofokWjzoa5jAwMkxCykd6,5,6,1,2,0,0,1,0,10,1.4285714285714286,1,0.0,3,1,2,0,3,0,0,1,0,6,4,1
3682,33251,9oofyIqQs4svoCsTL3Pyep7hA30rIFOe,SpATywNh6bZuzm8s1ceuBUnMUAeoAHHw,34,47,21,41,7,5,13,1,135,19.285714285714285,6,0.0,16,21,36,7,31,5,5,13,1,80,55,0
3683,33264,UiTx3V3W2jVsD1DrAmMX7V4GWz7c8Sbi,bWdj2GDclj5ofokWjzoa5jAwMkxCykd6,3,0,0,0,0,1,3,0,4,0.5714285714285714,1,0.0,0,0,0,0,0,1,0,3,0,0,4,1
3684,33266,ANj8LPP4QCqsLHbhaQj263PWrIQ9dqGZ,SpATywNh6bZuzm8s1ceuBUnMUAeoAHHw,34,76,0,60,0,0,13,1,150,21.428571428571427,7,0.0,27,0,48,0,49,0,12,13,1,75,75,0
3685,33270,BFrfDseDfXCBvtTfCsJAy36Ogk6b0Rfx,SpATywNh6bZuzm8s1ceuBUnMUAeoAHHw,37,89,45,0,20,0,20,0,174,24.857142857142858,14,0.0,0,45,0,20,89,0,0,20,0,65,109,0
3686,33272,QQyKT0cNRgXjfYZrcyku7Q3OKE07rSzG,A3fsA9Zfv1X2fVEQhTw51lKENdNrEqT3,5,2,1,0,1,0,5,0,9,1.2857142857142858,2,0.0,0,1,0,1,2,0,0,5,0,2,7,1
3687,33282,2OQKy8cwVxfMrqE5RzaRwj0lJIzMo3vb,G8EPVSXsOYB5YQWZGiz1aVq5Pgr2GrQu,1,0,0,0,0,0,1,0,1,0.14285714285714285,1,0.0,0,0,0,0,0,0,0,1,0,0,1,1
3688,33284,jRnFs6XBk6vGxxB24JG9v0Qh3pYfUtLh,RXDvfPUBYFlVdlueBFbLW0mhhAyGEqpt,44,121,37,73,13,10,25,15,294,42.0,15,0.0,12,37,66,13,109,10,7,25,15,128,166,0
3689,33286,tZCjR4qvZsX3wLuSLSjR6yRjeUphuVZ9,SpATywNh6bZuzm8s1ceuBUnMUAeoAHHw,3,4,0,0,0,0,1,0,5,0.7142857142857143,2,0.0,0,0,0,0,4,0,0,1,0,0,5,0
3690,33290,0wm7bVyJC7jfhIoeylaV85sHOH5JOhtj,SpATywNh6bZuzm8s1ceuBUnMUAeoAHHw,57,87,39,47,22,15,19,1,230,32.857142857142854,10,0.0,19,39,37,22,68,15,10,19,1,117,113,0
3691,33291,Ly65lkxGurCaK23EMf3qmWsOuD8e8vVr,bWdj2GDclj5ofokWjzoa5jAwMkxCykd6,8,8,4,8,3,0,1,0,24,3.4285714285714284,1,0.0,3,4,7,3,5,0,1,1,0,17,7,1
3692,33298,wjqMTSqGRhad7XTyyuysYYbP0x4J6ulv,bWdj2GDclj5ofokWjzoa5jAwMkxCykd6,16,21,4,10,4,4,21,3,67,9.571428571428571,6,0.0,2,4,5,4,19,4,5,21,3,15,52,1
3693,33306,YDKgUItosvh9lrVTHMdJodwxXU47oDDn,SpATywNh6bZuzm8s1ceuBUnMUAeoAHHw,34,59,4,7,4,0,21,8,103,14.714285714285714,4,0.0,10,4,6,4,49,0,1,21,8,24,79,0
3694,33317,udZwvYIs8wt15862s5Y6pk6crVu6xztd,SpATywNh6bZuzm8s1ceuBUnMUAeoAHHw,5,3,2,0,2,0,2,0,9,1.2857142857142858,1,0.0,0,2,0,2,3,0,0,2,0,4,5,1
3695,33322,vIBcYbs1BLdmaaP30fcE2FS7kB7v7QRn,SpATywNh6bZuzm8s1ceuBUnMUAeoAHHw,5,4,2,0,0,0,4,0,10,1.4285714285714286,3,0.0,0,2,0,0,4,0,0,4,0,2,8,1
3696,33331,mJNmN9AbVBmhzBfxSlHeSff1yTyr8w50,SpATywNh6bZuzm8s1ceuBUnMUAeoAHHw,27,101,40,0,21,6,32,0,200,28.571428571428573,13,0.0,0,40,0,21,101,6,0,32,0,61,139,0
3697,33344,096xYyhB9kL7G6lT7J9rVrXyGNwUToLF,A3fsA9Zfv1X2fVEQhTw51lKENdNrEqT3,38,37,32,0,0,0,3,0,72,10.285714285714286,2,0.0,0,32,0,0,37,0,0,3,0,32,40,0
3698,33348,we9tWnySpl1G7k7FqyXPj8wmC2gUYK0W,SpATywNh6bZuzm8s1ceuBUnMUAeoAHHw,24,29,1,25,1,8,9,3,76,10.857142857142858,4,0.0,9,1,23,1,20,8,2,9,3,34,42,0
3699,33354,0LjNTZG6byvXe7xKDfNEXUTZjqaDOglx,G8EPVSXsOYB5YQWZGiz1aVq5Pgr2GrQu,38,29,15,102,4,0,14,1,165,23.571428571428573,5,0.0,4,15,84,4,25,0,18,14,1,107,58,1
3700,33368,hJo1MgKiPZFXuH2ko6hqPTd9dbjMQKDO,bWdj2GDclj5ofokWjzoa5jAwMkxCykd6,38,52,26,202,8,0,16,0,304,43.42857142857143,12,0.0,10,26,188,8,42,0,14,16,0,232,72,0
3701,33370,3EwUg208bV0DvnhKptmbGHdmCctMgvT5,SpATywNh6bZuzm8s1ceuBUnMUAeoAHHw,9,19,7,0,1,2,10,1,40,5.714285714285714,3,0.0,0,7,0,1,19,2,0,10,1,8,32,1
3702,33390,wW4GJxMtcZrVSwwTpsg7JhOsvVCWQeUC,A3fsA9Zfv1X2fVEQhTw51lKENdNrEqT3,25,27,25,0,25,0,4,0,81,11.571428571428571,3,0.0,0,25,0,25,27,0,0,4,0,50,31,1
3703,33393,rvGeJBDthuxogYD9iVgKqZ9WWdzkhnrb,G8EPVSXsOYB5YQWZGiz1aVq5Pgr2GrQu,1,0,0,0,0,0,1,0,1,0.14285714285714285,1,0.0,0,0,0,0,0,0,0,1,0,0,1,1
3704,33394,rvGeJBDthuxogYD9iVgKqZ9WWdzkhnrb,RXDvfPUBYFlVdlueBFbLW0mhhAyGEqpt,1,0,0,0,0,0,2,0,2,0.2857142857142857,1,0.0,0,0,0,0,0,0,0,2,0,0,2,1
3705,33404,HYJZRxuL3QhPKaL52ejyF3gmkMGZU1ZH,SpATywNh6bZuzm8s1ceuBUnMUAeoAHHw,4,2,1,0,1,0,1,0,5,0.7142857142857143,1,0.0,0,1,0,1,2,0,0,1,0,2,3,1
3706,33417,dLE8ClT356F8GOTARAp48z5vmhoyi6Jm,SpATywNh6bZuzm8s1ceuBUnMUAeoAHHw,1,0,0,0,0,0,1,0,1,0.14285714285714285,1,0.0,0,0,0,0,0,0,0,1,0,0,1,1
3707,33431,viuKt4GgrX0rYL5EpHoxJbsiC9TblSuk,A3fsA9Zfv1X2fVEQhTw51lKENdNrEqT3,43,95,51,14,12,89,76,1,338,48.285714285714285,12,0.0,1,51,8,12,94,89,6,76,1,72,266,0
3708,33443,viuKt4GgrX0rYL5EpHoxJbsiC9TblSuk,bWdj2GDclj5ofokWjzoa5jAwMkxCykd6,33,54,34,6,16,72,43,1,226,32.285714285714285,13,0.0,2,34,3,16,52,72,3,43,1,55,171,0
3709,33445,viuKt4GgrX0rYL5EpHoxJbsiC9TblSuk,5X6FeZozNMgE2VRi3MJYjkkFK8SETtu2,24,36,20,0,7,31,23,1,118,16.857142857142858,8,0.0,6,20,0,7,30,31,0,23,1,33,85,1
3710,33455,7usMWWPRRbqHqTGVe4yfuQMnaM8GH1DT,SpATywNh6bZuzm8s1ceuBUnMUAeoAHHw,24,30,21,1,12,1,15,0,80,11.428571428571429,8,0.0,0,21,1,12,30,1,0,15,0,34,46,0
3711,33467,3gXjYz3VFr0TvsDYUgKtksPt5WrPBmEo,RXDvfPUBYFlVdlueBFbLW0mhhAyGEqpt,13,14,8,0,3,21,9,2,57,8.142857142857142,2,0.0,0,8,0,3,14,21,0,9,2,11,46,0
3712,33469,viuKt4GgrX0rYL5EpHoxJbsiC9TblSuk,G8EPVSXsOYB5YQWZGiz1aVq5Pgr2GrQu,41,104,59,0,12,62,48,0,285,40.714285714285715,13,0.0,14,59,0,12,90,62,0,48,0,85,200,0
3713,33481,viuKt4GgrX0rYL5EpHoxJbsiC9TblSuk,RXDvfPUBYFlVdlueBFbLW0mhhAyGEqpt,32,103,36,0,7,134,58,8,346,49.42857142857143,11,0.0,11,36,0,7,92,134,0,58,8,54,292,0
3714,33488,w30xo3plQsx0SkiDlFlFfUJzRNbhNqJJ,SpATywNh6bZuzm8s1ceuBUnMUAeoAHHw,16,7,4,9,3,0,6,1,30,4.285714285714286,1,0.0,2,4,9,3,5,0,0,6,1,18,12,1
3715,33490,KKySZH8Vhrdd4z2bRf8FAPkHeGpE3JpX,SpATywNh6bZuzm8s1ceuBUnMUAeoAHHw,18,38,1,35,0,0,6,0,80,11.428571428571429,4,0.0,14,1,31,0,24,0,4,6,0,46,34,0
3716,33494,KKySZH8Vhrdd4z2bRf8FAPkHeGpE3JpX,A3fsA9Zfv1X2fVEQhTw51lKENdNrEqT3,13,16,4,0,0,0,7,0,27,3.857142857142857,4,0.0,0,4,0,0,16,0,0,7,0,4,23,0
3717,33496,LES25z3KevamvJJA1mopKcd17ZKutMko,A3fsA9Zfv1X2fVEQhTw51lKENdNrEqT3,2,0,0,0,0,0,2,0,2,0.2857142857142857,1,0.0,0,0,0,0,0,0,0,2,0,0,2,1
3718,33500,VwUXTBGJaTv5xN1He6TwE1OKxII3IUB4,7GRhBDsirIGkRZBtSMEzNTyDr2JQm4xx,3,6,1,0,1,1,1,0,10,1.4285714285714286,1,0.0,2,1,0,1,4,1,0,1,0,4,6,1
3719,33506,R6mWJ0ZeHkZWWi0xlkZZqK7iozuGXemG,7GRhBDsirIGkRZBtSMEzNTyDr2JQm4xx,47,76,29,46,24,22,14,2,213,30.428571428571427,4,0.0,42,29,37,24,34,22,9,14,2,132,81,1
3720,33517,R6mWJ0ZeHkZWWi0xlkZZqK7iozuGXemG,SpATywNh6bZuzm8s1ceuBUnMUAeoAHHw,20,28,14,20,7,6,18,2,95,13.571428571428571,4,0.0,9,14,17,7,19,6,3,18,2,47,48,1
3721,33519,7yKH9idxIZZIHmSby2TlRwglHE2J4AOu,7GRhBDsirIGkRZBtSMEzNTyDr2JQm4xx,28,74,23,22,9,14,12,2,156,22.285714285714285,4,0.0,19,23,20,9,55,14,2,12,2,71,85,1
3722,33521,kOcsNetIsK9HFRaYNeKiWrndfQDPUf2b,7GRhBDsirIGkRZBtSMEzNTyDr2JQm4xx,46,99,43,54,39,5,9,0,249,35.57142857142857,7,0.0,47,43,47,39,52,5,7,9,0,176,73,1
3723,33529,sYEBB7Cezd6bYcnMjhqBrC5c63jbJN18,SpATywNh6bZuzm8s1ceuBUnMUAeoAHHw,35,41,18,0,13,12,14,2,100,14.285714285714286,6,0.0,5,18,0,13,36,12,0,14,2,36,64,0
3724,33530,aAPaeWN3GBWfW0S1FoCPDVeAcodFtNRR,SpATywNh6bZuzm8s1ceuBUnMUAeoAHHw,1,0,0,0,0,0,2,0,2,0.2857142857142857,2,0.0,0,0,0,0,0,0,0,2,0,0,2,0
3725,33542,5HH0aaaYYEQaS6y1Lay5PLCxlaH9WI7b,A3fsA9Zfv1X2fVEQhTw51lKENdNrEqT3,5,2,1,0,1,0,5,0,9,1.2857142857142858,1,0.0,0,1,0,1,2,0,0,5,0,2,7,1
3726,33554,T2tyjiaDe9s4tWUugE6FZTShWofnfMqo,5X6FeZozNMgE2VRi3MJYjkkFK8SETtu2,30,95,5,46,20,0,20,0,186,26.571428571428573,12,0.0,37,5,43,20,58,0,3,20,0,105,81,1
3727,33555,ALf7rMMKH932l3xWeAFvGNQmKMpEd4tF,SpATywNh6bZuzm8s1ceuBUnMUAeoAHHw,13,16,2,28,0,4,4,0,54,7.714285714285714,1,0.0,6,2,27,0,10,4,1,4,0,35,19,1
3728,33566,xWkSEJurvVs31EV99t5w9EiMtxPaCd2f,5X6FeZozNMgE2VRi3MJYjkkFK8SETtu2,1,0,0,0,0,0,1,0,1,0.14285714285714285,1,0.0,0,0,0,0,0,0,0,1,0,0,1,1
3729,33571,VjR9VP67wJl90FeAkIbcbFMlwY57zr53,SpATywNh6bZuzm8s1ceuBUnMUAeoAHHw,1,0,0,0,0,0,1,0,1,0.14285714285714285,1,0.0,0,0,0,0,0,0,0,1,0,0,1,1
3730,33576,KshwCmsAWd7PYW2Qdxpd0Dd8iC7QTJ5v,SpATywNh6bZuzm8s1ceuBUnMUAeoAHHw,15,21,11,0,9,0,4,0,45,6.428571428571429,4,0.0,2,11,0,9,19,0,0,4,0,22,23,0
3731,33581,YZSZ4TOtqHUreAioK1x0YBDmIRumwoti,5X6FeZozNMgE2VRi3MJYjkkFK8SETtu2,6,3,1,0,1,0,2,0,7,1.0,1,0.0,0,1,0,1,3,0,0,2,0,2,5,1
3732,33589,orkcYdEVQqlH9SJjCRUiZ5P3bFy172XW,7GRhBDsirIGkRZBtSMEzNTyDr2JQm4xx,4,7,0,0,0,0,3,0,10,1.4285714285714286,2,0.0,0,0,0,0,7,0,0,3,0,0,10,1
3733,33610,6i2sU2iOfHEZCirLcCLqodhgstGeUqVi,SpATywNh6bZuzm8s1ceuBUnMUAeoAHHw,47,59,36,35,22,0,11,1,164,23.428571428571427,3,0.0,13,36,32,22,46,0,3,11,1,103,61,0
3734,33615,RiEm3LuxyewdMDpHDHRR7XJGfum71kSq,SpATywNh6bZuzm8s1ceuBUnMUAeoAHHw,1,0,0,0,0,0,1,0,1,0.14285714285714285,1,0.0,0,0,0,0,0,0,0,1,0,0,1,1
3735,33619,XEN1AZJ1cZ1Qg5cpXKAddUVG2n4aD7ZG,SpATywNh6bZuzm8s1ceuBUnMUAeoAHHw,7,7,0,0,0,0,5,0,12,1.7142857142857142,1,0.0,0,0,0,0,7,0,0,5,0,0,12,1
3736,33638,kGNoIC9AxgB9nCs6frsN1R7EeU5BsStD,SpATywNh6bZuzm8s1ceuBUnMUAeoAHHw,22,33,9,34,1,10,5,0,92,13.142857142857142,3,0.0,19,9,29,1,14,10,5,5,0,58,34,1
3737,33644,eE4DAv5aHElS2DPaTad4VXPjk6A3xvPl,G8EPVSXsOYB5YQWZGiz1aVq5Pgr2GrQu,137,132,89,242,44,0,15,1,523,74.71428571428571,9,0.0,15,89,217,44,117,0,25,15,1,365,158,0
3738,33648,yD8ecTJ7efEF8WUp9kS25bxSOmV2HnI4,A3fsA9Zfv1X2fVEQhTw51lKENdNrEqT3,10,9,0,0,0,0,4,0,13,1.8571428571428572,2,0.0,0,0,0,0,9,0,0,4,0,0,13,1
3739,33674,Ry5r3PlRYtX7RdQht9vGdro0Bt4zHDPw,SpATywNh6bZuzm8s1ceuBUnMUAeoAHHw,61,119,43,81,17,82,52,16,410,58.57142857142857,11,0.0,29,43,71,17,90,82,10,52,16,160,250,0
3740,33676,csMt1h4jwoK6sZ6rEkcutiAH8F6ocCR4,A3fsA9Zfv1X2fVEQhTw51lKENdNrEqT3,33,18,1,46,0,0,6,0,71,10.142857142857142,3,0.0,1,1,46,0,17,0,0,6,0,48,23,1
3741,33693,DuJi657C7pWyWAohPqQtEFsp3ioofH9U,3VkHkmOtom3jM2wCu94xgzzu1d6Dn7or,30,45,14,30,15,12,8,1,125,17.857142857142858,5,0.0,24,14,24,15,21,12,6,8,1,77,48,1
3742,33700,yV6W6ti9iteibLzORPGN81YSNOwkANex,3VkHkmOtom3jM2wCu94xgzzu1d6Dn7or,62,117,41,84,33,49,18,7,349,49.857142857142854,5,0.0,47,41,80,33,70,49,4,18,7,201,148,0
3743,33752,0dTl0LLZb3MVQ7vvfkoX3uGGuSQCYhar,3VkHkmOtom3jM2wCu94xgzzu1d6Dn7or,14,21,7,5,4,10,17,1,65,9.285714285714286,4,0.0,3,7,5,4,18,10,0,17,1,19,46,1
3744,33760,tE4cEuVnCai6lb5MdLPjaUrc5lKnLVvQ,3VkHkmOtom3jM2wCu94xgzzu1d6Dn7or,1,0,0,0,0,0,1,0,1,0.14285714285714285,1,0.0,0,0,0,0,0,0,0,1,0,0,1,1
3745,33773,J4whR4tkRWNAuZ9757rGCsnluTOT401Y,3VkHkmOtom3jM2wCu94xgzzu1d6Dn7or,37,109,12,30,2,29,23,0,205,29.285714285714285,10,0.0,22,12,27,2,87,29,3,23,0,63,142,1
3746,33785,1trLCbUNcACEunTz0t0oqSGDB2hHghrr,3VkHkmOtom3jM2wCu94xgzzu1d6Dn7or,8,4,2,0,2,0,8,0,16,2.2857142857142856,4,0.0,0,2,0,2,4,0,0,8,0,4,12,1
3747,33786,P40TML0Cj710JXp6r41PtP7rRZ3kVuFi,3VkHkmOtom3jM2wCu94xgzzu1d6Dn7or,18,8,6,0,6,0,5,1,26,3.7142857142857144,1,0.0,0,6,0,6,8,0,0,5,1,12,14,1
3748,33803,aG8ttlucm14QtDBG2VgxntPklOeFs1gE,3VkHkmOtom3jM2wCu94xgzzu1d6Dn7or,6,6,3,0,2,0,7,0,18,2.5714285714285716,3,0.0,0,3,0,2,6,0,0,7,0,5,13,1
3749,33827,JwxDSGDMUrTarMpmqBus8e9KlkFbHAHz,3VkHkmOtom3jM2wCu94xgzzu1d6Dn7or,9,15,4,0,6,1,4,1,31,4.428571428571429,1,0.0,9,4,0,6,6,1,0,4,1,19,12,1
3750,33847,cRQPwEYCK3Iw8dKAOD2ODiUgaKZ6yPed,3VkHkmOtom3jM2wCu94xgzzu1d6Dn7or,92,361,234,66,113,132,116,0,1022,146.0,27,0.0,91,234,57,113,270,132,9,116,0,495,527,0
3751,33872,TOnSUH2TrhmaSVJBIvM0e6QZcFDQqMZg,3VkHkmOtom3jM2wCu94xgzzu1d6Dn7or,98,323,115,82,109,7,41,10,687,98.14285714285714,7,0.0,175,115,76,109,148,7,6,41,10,475,212,0
3752,33897,RdOt9G6BQbLDtyywMd9fuLxHBkYZbtki,3VkHkmOtom3jM2wCu94xgzzu1d6Dn7or,64,165,72,86,51,37,38,3,452,64.57142857142857,8,0.0,67,72,79,51,98,37,7,38,3,269,183,0
3753,33913,1tfsR5YpJJKMYzdzEoMQ5vXhGsyOBHv0,3VkHkmOtom3jM2wCu94xgzzu1d6Dn7or,4,2,1,0,0,0,2,0,5,0.7142857142857143,1,0.0,0,1,0,0,2,0,0,2,0,1,4,1
3754,33933,hKHwB5Ua0oZcH6SWtFD6GIJQ1tetaoy8,3VkHkmOtom3jM2wCu94xgzzu1d6Dn7or,1,0,0,0,0,0,1,0,1,0.14285714285714285,1,0.0,0,0,0,0,0,0,0,1,0,0,1,1
3755,33934,d52ubpamv7QMs8mm7IKIC7ljhLEjmM3C,3VkHkmOtom3jM2wCu94xgzzu1d6Dn7or,33,80,25,0,16,0,15,0,136,19.428571428571427,6,0.0,0,25,0,16,80,0,0,15,0,41,95,1
3756,33935,Q1L6yAmi2pDCMncureBVjhppMB4OEbbX,3VkHkmOtom3jM2wCu94xgzzu1d6Dn7or,6,2,1,0,1,0,4,0,8,1.1428571428571428,1,0.0,0,1,0,1,2,0,0,4,0,2,6,1
3757,33974,42ykOxe70TRWblI6iCj0oJuIEYjcC8gM,3VkHkmOtom3jM2wCu94xgzzu1d6Dn7or,8,6,4,0,2,0,3,0,15,2.142857142857143,1,0.0,0,4,0,2,6,0,0,3,0,6,9,1
3758,33993,TF3UgiPnTRWimxx4aiWwai5XZkwp6qeG,3VkHkmOtom3jM2wCu94xgzzu1d6Dn7or,15,17,1,7,8,15,3,0,51,7.285714285714286,2,0.0,5,1,7,8,12,15,0,3,0,21,30,0
3759,34001,Q7Qbz0qw7RUQ817YEnRs9pRbpqGVwfCR,3VkHkmOtom3jM2wCu94xgzzu1d6Dn7or,17,42,13,0,0,0,4,0,59,8.428571428571429,3,0.0,0,13,0,0,42,0,0,4,0,13,46,1
3760,34004,mZc1V3rQTRH4oqK1zqSjimuZcPwomnsE,3VkHkmOtom3jM2wCu94xgzzu1d6Dn7or,45,90,40,66,0,18,34,1,249,35.57142857142857,8,0.0,32,40,63,0,58,18,3,34,1,135,114,0
3761,34007,ppoYKBfzaZTEyRRZ2EFxbUFzuyYD53DX,3VkHkmOtom3jM2wCu94xgzzu1d6Dn7or,63,97,38,28,26,42,32,2,265,37.857142857142854,6,0.0,38,38,26,26,59,42,2,32,2,128,137,0
3762,34024,OrtyhCDDCP3mJf5PTiCeln3hXQ7NIFcu,3VkHkmOtom3jM2wCu94xgzzu1d6Dn7or,12,34,14,7,9,9,6,0,79,11.285714285714286,3,0.0,11,14,6,9,23,9,1,6,0,40,39,1
3763,34027,XMC2XTYUqeuq7FqObX1ZI9NtOAkZI4qO,3VkHkmOtom3jM2wCu94xgzzu1d6Dn7or,1,0,0,0,0,0,1,0,1,0.14285714285714285,1,0.0,0,0,0,0,0,0,0,1,0,0,1,1
3764,34029,v68e5yKpgFiV39WDLIk3uKnkjuIxy9L1,3VkHkmOtom3jM2wCu94xgzzu1d6Dn7or,5,5,1,0,0,5,5,0,16,2.2857142857142856,1,0.0,3,1,0,0,2,5,0,5,0,4,12,1
3765,34045,Un9abrC617pqXK03UcjNr06Q8BdWn1dw,3VkHkmOtom3jM2wCu94xgzzu1d6Dn7or,4,4,1,0,0,0,2,0,7,1.0,1,0.0,0,1,0,0,4,0,0,2,0,1,6,1
3766,34048,VSqFiZJe6nAI2fcYQtLAxfgBk9qQ2XsB,3VkHkmOtom3jM2wCu94xgzzu1d6Dn7or,21,40,15,6,13,6,10,1,91,13.0,5,0.0,19,15,5,13,21,6,1,10,1,52,39,1
3767,34085,MQo37Q7W53DPZY2uFLJ08Sd1IlxyeeTy,3VkHkmOtom3jM2wCu94xgzzu1d6Dn7or,1,0,0,0,0,0,1,0,1,0.14285714285714285,1,0.0,0,0,0,0,0,0,0,1,0,0,1,1
3768,34101,SSUeBykJVUVNcYfOVb1xjMpw6wv8mrp4,3VkHkmOtom3jM2wCu94xgzzu1d6Dn7or,73,180,76,37,65,51,29,2,440,62.857142857142854,12,0.0,78,76,33,65,102,51,4,29,2,252,188,0
3769,34110,pifsEWGhALZhemzvj5eCBJDGPeKCqQys,3VkHkmOtom3jM2wCu94xgzzu1d6Dn7or,8,8,2,0,2,0,3,0,15,2.142857142857143,1,0.0,3,2,0,2,5,0,0,3,0,7,8,1
3770,34117,MgAVtl0Q9ZOnv69oO68f2as9w9Cw4pmF,3VkHkmOtom3jM2wCu94xgzzu1d6Dn7or,8,3,2,0,2,7,75,2,91,13.0,3,0.0,0,2,0,2,3,7,0,75,2,4,87,1
3771,34142,7caFhJ8HzCwqK1VfCSEo1EsScanrr6KP,3VkHkmOtom3jM2wCu94xgzzu1d6Dn7or,3,0,0,0,0,0,4,0,4,0.5714285714285714,1,0.0,0,0,0,0,0,0,0,4,0,0,4,1
3772,34167,1YxknoiTrSwQgclDlSAh4oMYHRyARhLv,3VkHkmOtom3jM2wCu94xgzzu1d6Dn7or,64,130,48,38,49,1,19,0,285,40.714285714285715,12,0.0,65,48,37,49,65,1,1,19,0,199,86,0
3773,34178,c4K8IuSRoyINLIWfzBS4l7qo5Oy1ef2X,3VkHkmOtom3jM2wCu94xgzzu1d6Dn7or,16,40,12,13,13,0,8,0,86,12.285714285714286,3,0.0,22,12,12,13,18,0,1,8,0,59,27,1
3774,34182,g3902agYIRHzac78MKVZlvljLMXXNpQ7,3VkHkmOtom3jM2wCu94xgzzu1d6Dn7or,86,331,111,114,113,36,36,1,742,106.0,14,0.0,166,111,108,113,165,36,6,36,1,498,244,0
3775,34207,Klx5HdUU5w9K3aSMJI03hrppJHSCa3R7,3VkHkmOtom3jM2wCu94xgzzu1d6Dn7or,4,2,1,0,0,0,2,0,5,0.7142857142857143,1,0.0,0,1,0,0,2,0,0,2,0,1,4,1
3776,34220,xpYNYgZQGa68GsnLqOUXASZMKJZ8lmG8,3VkHkmOtom3jM2wCu94xgzzu1d6Dn7or,6,3,1,0,1,3,6,0,14,2.0,2,0.0,1,1,0,1,2,3,0,6,0,3,11,1
3777,34245,xpAxjSreQEJGjM28FJsQcyiEt1VA8RXl,3VkHkmOtom3jM2wCu94xgzzu1d6Dn7or,91,247,90,131,59,5,25,0,557,79.57142857142857,16,0.0,45,90,120,59,202,5,11,25,0,314,243,0
3778,34261,bFfXTYik4aYWFfWUWdoOiuwD6nQmMZRw,3VkHkmOtom3jM2wCu94xgzzu1d6Dn7or,1,0,0,0,0,0,1,0,1,0.14285714285714285,1,0.0,0,0,0,0,0,0,0,1,0,0,1,1
3779,34265,5IgVvEPNH3bWuZlCdfNUhcppaJrh3aHd,3VkHkmOtom3jM2wCu94xgzzu1d6Dn7or,35,83,38,43,24,47,18,4,257,36.714285714285715,5,0.0,36,38,38,24,47,47,5,18,4,136,121,0
3780,34273,qSJaX4YJW8hRJDxnEVmivIyE1mLAQ8wD,3VkHkmOtom3jM2wCu94xgzzu1d6Dn7or,63,182,8,49,66,3,24,0,332,47.42857142857143,11,0.0,118,8,45,66,64,3,4,24,0,237,95,0
3781,34275,SzVahzwggSsKJrf1VkZbtdOT7lI7iLUB,3VkHkmOtom3jM2wCu94xgzzu1d6Dn7or,1,0,0,0,0,0,1,0,1,0.14285714285714285,1,0.0,0,0,0,0,0,0,0,1,0,0,1,0
3782,34306,xOaR7vHN6JVd3REJVPobis6s2LVrwA3I,3VkHkmOtom3jM2wCu94xgzzu1d6Dn7or,13,24,2,13,6,9,10,2,66,9.428571428571429,3,0.0,13,2,9,6,11,9,4,10,2,30,36,0
3783,34315,SryICrzq5kc50IPvq5WetHevyFYu34oy,3VkHkmOtom3jM2wCu94xgzzu1d6Dn7or,55,111,37,38,44,5,13,1,249,35.57142857142857,7,0.0,56,37,35,44,55,5,3,13,1,172,77,0
3784,34318,ujKaaUNEqqptCLwGF9Jue70qMPvrOLJo,3VkHkmOtom3jM2wCu94xgzzu1d6Dn7or,65,139,71,37,61,29,10,0,347,49.57142857142857,8,0.0,46,71,35,61,93,29,2,10,0,213,134,0
3785,34356,KeLznPI7itN5EyBP1W6I1lcrHKbQfFai,3VkHkmOtom3jM2wCu94xgzzu1d6Dn7or,3,2,1,0,0,0,1,0,4,0.5714285714285714,1,0.0,0,1,0,0,2,0,0,1,0,1,3,0
3786,34357,XwU6wUI3MC8It5xOE3JsHNSE33ZEcZ8a,3VkHkmOtom3jM2wCu94xgzzu1d6Dn7or,1,0,0,0,0,0,1,0,1,0.14285714285714285,1,0.0,0,0,0,0,0,0,0,1,0,0,1,1
3787,34372,HEvbYdzPT1RdOQkeFBGzM5dG2vT688KF,3VkHkmOtom3jM2wCu94xgzzu1d6Dn7or,7,4,1,0,1,6,6,1,19,2.7142857142857144,3,0.0,0,1,0,1,4,6,0,6,1,2,17,1
3788,34425,eLqag6twmL6nT6SLVrpY07QGG3bytKwe,3VkHkmOtom3jM2wCu94xgzzu1d6Dn7or,63,132,67,26,54,19,22,0,320,45.714285714285715,7,0.0,42,67,25,54,90,19,1,22,0,188,132,0
3789,34427,Aewl2bukzaR3iOy5Mq949jen8SFdB5jq,3VkHkmOtom3jM2wCu94xgzzu1d6Dn7or,1,0,0,0,0,0,2,0,2,0.2857142857142857,1,0.0,0,0,0,0,0,0,0,2,0,0,2,1
3790,34456,CAXYMnI26CJKVZLm27KWhrQ5wZxlWBLx,3VkHkmOtom3jM2wCu94xgzzu1d6Dn7or,7,4,2,0,1,0,3,1,11,1.5714285714285714,1,0.0,0,2,0,1,4,0,0,3,1,3,8,0
3791,34457,a9c4te5q0ehojVccJ2P6whngcQZuQQCX,3VkHkmOtom3jM2wCu94xgzzu1d6Dn7or,42,43,24,0,23,5,11,1,107,15.285714285714286,4,0.0,12,24,0,23,31,5,0,11,1,59,48,1
3792,34463,o8HgCfDb4fBDcx1CsrkAibT0nuxbHTlk,3VkHkmOtom3jM2wCu94xgzzu1d6Dn7or,90,395,123,141,75,62,21,2,819,117.0,11,0.0,127,123,121,75,268,62,20,21,2,446,373,0
3793,34488,GleyV2QgGRzVvYTAp5V2b6ZBaZiURmcd,3VkHkmOtom3jM2wCu94xgzzu1d6Dn7or,1,0,0,0,0,0,1,0,1,0.14285714285714285,1,0.0,0,0,0,0,0,0,0,1,0,0,1,1
3794,34492,GvdqbnM3UIaJ0BFHcHdO9ouTWJGUBtrO,3VkHkmOtom3jM2wCu94xgzzu1d6Dn7or,1,0,0,0,0,0,1,0,1,0.14285714285714285,1,0.0,0,0,0,0,0,0,0,1,0,0,1,1
3795,34495,iXEJ1rfu68zDKDu3FiFKj2kPpqtT5dfz,3VkHkmOtom3jM2wCu94xgzzu1d6Dn7or,29,35,16,0,18,1,11,0,81,11.571428571428571,5,0.0,4,16,0,18,31,1,0,11,0,38,43,1
3796,34504,w2YhBdSobFVOK94JfPRbRKRIarjDjij1,3VkHkmOtom3jM2wCu94xgzzu1d6Dn7or,18,23,14,0,11,0,8,1,57,8.142857142857142,4,0.0,0,14,0,11,23,0,0,8,1,25,32,1
3797,34543,anLYgmC8Wl5xU9kyyzDNYloR1lWVeUQv,3VkHkmOtom3jM2wCu94xgzzu1d6Dn7or,9,17,2,0,0,0,13,0,32,4.571428571428571,5,0.0,0,2,0,0,17,0,0,13,0,2,30,1
3798,34578,siw3z9CF4q7PdqdWdVvFDzTmHm8ZHf2L,3VkHkmOtom3jM2wCu94xgzzu1d6Dn7or,9,15,0,0,2,0,1,0,18,2.5714285714285716,1,0.0,0,0,0,2,15,0,0,1,0,2,16,1
3799,34609,lMzjP7MH4M4HD40rmmb72GIa6BNuIxvn,5X6FeZozNMgE2VRi3MJYjkkFK8SETtu2,4,0,0,0,0,2,3,0,5,0.7142857142857143,1,0.0,0,0,0,0,0,2,0,3,0,0,5,1
3800,34615,tEGUB4A2P1CFVrtUpVRZCuET3K7QndSr,5X6FeZozNMgE2VRi3MJYjkkFK8SETtu2,9,5,3,0,2,0,13,0,23,3.2857142857142856,3,0.0,0,3,0,2,5,0,0,13,0,5,18,1
3801,34640,n6oy92A0COsM84uyQbTNZ7pqWc0u5Wg0,7GRhBDsirIGkRZBtSMEzNTyDr2JQm4xx,1,0,0,0,0,0,1,0,1,0.14285714285714285,1,0.0,0,0,0,0,0,0,0,1,0,0,1,1
3802,34645,3HOnjRDe3XaKpyhDvtGYWIvTQ5R0B6U5,5X6FeZozNMgE2VRi3MJYjkkFK8SETtu2,26,34,10,16,13,43,17,0,133,19.0,4,0.0,17,10,16,13,17,43,0,17,0,56,77,0
3803,34656,96DCfuOrgGXPJxvBhf7d6yZw2He2dVFd,5X6FeZozNMgE2VRi3MJYjkkFK8SETtu2,45,47,9,103,21,0,4,0,184,26.285714285714285,3,0.0,30,9,90,21,17,0,13,4,0,150,34,0
3804,34665,X0fr45rfdEeZ9hURKvWR9AGDFDSFFsR7,7GRhBDsirIGkRZBtSMEzNTyDr2JQm4xx,12,22,6,2,2,0,5,0,37,5.285714285714286,2,0.0,1,6,1,2,21,0,1,5,0,10,27,1
3805,34710,521YJDVy6G9ul5QyLTUZAuztPLpe7gqW,7GRhBDsirIGkRZBtSMEzNTyDr2JQm4xx,3,0,0,0,0,0,3,0,3,0.42857142857142855,1,0.0,0,0,0,0,0,0,0,3,0,0,3,1
3806,34719,42bX0uPWOXgBHMwF4wqdnl1Ve6wIHNQe,7GRhBDsirIGkRZBtSMEzNTyDr2JQm4xx,12,10,5,0,4,0,4,0,23,3.2857142857142856,3,0.0,1,5,0,4,9,0,0,4,0,10,13,1
3807,34725,n8Qj7926d7yvtreYunFCLT4mrboYdeRa,7GRhBDsirIGkRZBtSMEzNTyDr2JQm4xx,14,14,5,4,5,3,9,1,41,5.857142857142857,1,0.0,3,5,3,5,11,3,1,9,1,16,25,1
3808,34730,WcgPk0seMETQ32XVB6Y924ThrGFZxSCx,5X6FeZozNMgE2VRi3MJYjkkFK8SETtu2,1,0,0,0,0,0,1,0,1,0.14285714285714285,1,0.0,0,0,0,0,0,0,0,1,0,0,1,1
3809,34738,4en36s6M5dWiGXaOz7Ao485PkasQppcC,7GRhBDsirIGkRZBtSMEzNTyDr2JQm4xx,34,44,15,18,14,10,7,4,112,16.0,4,0.0,23,15,9,14,21,10,9,7,4,61,51,1
3810,34752,Ul8fOM41ROTx6GwtVQf8fol92V0sOxIU,7GRhBDsirIGkRZBtSMEzNTyDr2JQm4xx,1,0,0,0,0,0,2,0,2,0.2857142857142857,2,0.0,0,0,0,0,0,0,0,2,0,0,2,1
3811,34771,1znu7Xzg4p1qA4YkunjQTwOhXoKFFWr0,7GRhBDsirIGkRZBtSMEzNTyDr2JQm4xx,29,35,3,16,4,1,6,0,65,9.285714285714286,4,0.0,13,3,9,4,22,1,7,6,0,29,36,0
3812,34800,z3YnX73v2uoVHmuLGzQD2gKKBoJqIQxK,5X6FeZozNMgE2VRi3MJYjkkFK8SETtu2,1,0,0,0,0,0,1,0,1,0.14285714285714285,1,0.0,0,0,0,0,0,0,0,1,0,0,1,1
3813,34808,t6gbXbSU5L3FPpVibBhtf9ABrcXvjFov,7GRhBDsirIGkRZBtSMEzNTyDr2JQm4xx,5,9,6,0,5,0,3,0,23,3.2857142857142856,2,0.0,0,6,0,5,9,0,0,3,0,11,12,0
3814,34826,lLBYRG2vdmBMEjzgv1Hsiz1uNkClKMP0,5X6FeZozNMgE2VRi3MJYjkkFK8SETtu2,1,0,0,0,0,0,1,0,1,0.14285714285714285,1,0.0,0,0,0,0,0,0,0,1,0,0,1,1
3815,34836,XZ6wb1QGJGwEfyG45cl1hveOKOr0OgzY,7GRhBDsirIGkRZBtSMEzNTyDr2JQm4xx,5,2,1,0,1,0,2,0,6,0.8571428571428571,1,0.0,0,1,0,1,2,0,0,2,0,2,4,1
3816,34841,DBI154fAsTYpTW5PDGxgInzkEniSAAwK,7GRhBDsirIGkRZBtSMEzNTyDr2JQm4xx,1,0,0,0,0,0,1,0,1,0.14285714285714285,1,0.0,0,0,0,0,0,0,0,1,0,0,1,1
3817,34851,BkozGGotFoRWvs7kivTQvwwV5JZ8hddc,7GRhBDsirIGkRZBtSMEzNTyDr2JQm4xx,1,0,0,0,0,0,1,0,1,0.14285714285714285,1,0.0,0,0,0,0,0,0,0,1,0,0,1,0
3818,34867,ZmcKxihZ1R64O2ndnnAR75Wj8TfQ1PuJ,7GRhBDsirIGkRZBtSMEzNTyDr2JQm4xx,8,4,0,4,0,0,5,0,13,1.8571428571428572,1,0.0,1,0,3,0,3,0,1,5,0,4,9,1
3819,34870,OE6rKd9Nqgw6uyQXd4G7Xvv5u5KYnYfc,7GRhBDsirIGkRZBtSMEzNTyDr2JQm4xx,1,0,0,0,0,0,1,0,1,0.14285714285714285,1,0.0,0,0,0,0,0,0,0,1,0,0,1,0
3820,34887,tjK76iagpFGbk5YoF97wIV91VIkWMXeI,7GRhBDsirIGkRZBtSMEzNTyDr2JQm4xx,1,0,0,0,0,0,1,0,1,0.14285714285714285,1,0.0,0,0,0,0,0,0,0,1,0,0,1,1
3821,34895,TPjv2mgvzs8mtuY7ccAmTpwjgR5agCrX,7GRhBDsirIGkRZBtSMEzNTyDr2JQm4xx,4,6,2,0,0,1,3,0,12,1.7142857142857142,2,0.0,2,2,0,0,4,1,0,3,0,4,8,1
3822,34898,TPjv2mgvzs8mtuY7ccAmTpwjgR5agCrX,5X6FeZozNMgE2VRi3MJYjkkFK8SETtu2,3,0,0,0,0,0,3,0,3,0.42857142857142855,2,0.0,0,0,0,0,0,0,0,3,0,0,3,1
3823,34905,lB6Kl0if51YgTDbpdNoXtX6HKiMZvllY,7GRhBDsirIGkRZBtSMEzNTyDr2JQm4xx,1,0,0,0,0,0,1,0,1,0.14285714285714285,1,0.0,0,0,0,0,0,0,0,1,0,0,1,1
3824,34934,TBQoOvuDjEMUZC2QrWY1HB9UlRprbpL5,5X6FeZozNMgE2VRi3MJYjkkFK8SETtu2,1,0,0,0,0,0,2,0,2,0.2857142857142857,1,0.0,0,0,0,0,0,0,0,2,0,0,2,1
3825,34952,Fc6or2UHUceP4nvPJGhwD2OTewY2syOC,7GRhBDsirIGkRZBtSMEzNTyDr2JQm4xx,5,4,1,0,2,0,2,0,9,1.2857142857142858,1,0.0,2,1,0,2,2,0,0,2,0,5,4,1
3826,34989,qmZrNo1r3Io6ipmYGSgj6k432hR7Tw4I,5X6FeZozNMgE2VRi3MJYjkkFK8SETtu2,4,4,0,0,0,0,2,0,6,0.8571428571428571,2,0.0,0,0,0,0,4,0,0,2,0,0,6,1
3827,34993,sBJaEGuTXbNCvVTwGa7sLLN4Vc6pwdKX,5X6FeZozNMgE2VRi3MJYjkkFK8SETtu2,27,41,3,0,20,0,4,0,68,9.714285714285714,3,0.0,30,3,0,20,11,0,0,4,0,53,15,0
3828,34995,C4q4gNQYEpjKh7pq1qjN8i3L7uSpUX9d,5X6FeZozNMgE2VRi3MJYjkkFK8SETtu2,102,296,73,74,111,1,20,1,576,82.28571428571429,5,0.0,94,73,61,111,202,1,13,20,1,339,237,0
3829,35001,mnSBt3sRNyrZ7VUOLiaw67uN9cm7o4kN,5X6FeZozNMgE2VRi3MJYjkkFK8SETtu2,1,0,0,0,0,0,1,0,1,0.14285714285714285,1,0.0,0,0,0,0,0,0,0,1,0,0,1,1
3830,35004,QQPVMA2jHWo7dIPXsvoAxaE7MsGRZAyE,5X6FeZozNMgE2VRi3MJYjkkFK8SETtu2,10,10,5,2,5,0,3,0,25,3.5714285714285716,3,0.0,2,5,2,5,8,0,0,3,0,14,11,0
3831,35056,Az35wHR97uuRkRSgT8BjE6DkhH91OHMF,7GRhBDsirIGkRZBtSMEzNTyDr2JQm4xx,10,11,5,2,3,0,7,1,29,4.142857142857143,4,0.0,1,5,2,3,10,0,0,7,1,11,18,1
3832,35087,CfeENerIdAGepleePWSt0SV88ctt0Tmw,7GRhBDsirIGkRZBtSMEzNTyDr2JQm4xx,1,0,0,0,0,0,1,0,1,0.14285714285714285,1,0.0,0,0,0,0,0,0,0,1,0,0,1,1
3833,35128,rOp8aBXrvMFn99ymSn6pN6nQjBR9XCcF,7GRhBDsirIGkRZBtSMEzNTyDr2JQm4xx,5,4,0,0,0,0,3,0,7,1.0,1,0.0,0,0,0,0,4,0,0,3,0,0,7,1
3834,35150,AvQhWM9grultmx48matDmWO7LLNb13dd,7GRhBDsirIGkRZBtSMEzNTyDr2JQm4xx,90,94,35,92,36,4,4,0,265,37.857142857142854,6,0.0,49,35,62,36,45,4,30,4,0,182,83,0
3835,35152,VsfU7jeSb2K8k0CBzCZzXJjDlMye1sB1,7GRhBDsirIGkRZBtSMEzNTyDr2JQm4xx,55,139,71,71,37,4,17,0,339,48.42857142857143,9,0.0,53,71,63,37,86,4,8,17,0,224,115,1
3836,35154,6TeNHmnZsy2QqeLuJegGqbjbPJMrX0FT,7GRhBDsirIGkRZBtSMEzNTyDr2JQm4xx,6,2,1,0,1,0,4,0,8,1.1428571428571428,2,0.0,0,1,0,1,2,0,0,4,0,2,6,1
3837,35156,WDMP5c2Ubx8vVSFegA0mXeU23cYb0qCY,7GRhBDsirIGkRZBtSMEzNTyDr2JQm4xx,32,56,3,46,5,8,7,0,125,17.857142857142858,6,0.0,27,3,40,5,29,8,6,7,0,75,50,1
3838,35159,dJJJLtI6F18pblO9KPkBPg9ZKTgQPaQc,7GRhBDsirIGkRZBtSMEzNTyDr2JQm4xx,80,160,5,140,26,7,12,0,350,50.0,11,0.0,77,5,126,26,83,7,14,12,0,234,116,0
3839,35160,kThSxP6kRJAiUPqrS6DypsJwuP8aoEPr,7GRhBDsirIGkRZBtSMEzNTyDr2JQm4xx,71,110,5,104,19,12,11,0,261,37.285714285714285,5,0.0,59,5,77,19,51,12,27,11,0,160,101,0
3840,35165,Gvn1GQVBkQxq6rZTkkY4CKnlRmLWyiJO,7GRhBDsirIGkRZBtSMEzNTyDr2JQm4xx,1,0,0,0,0,0,1,0,1,0.14285714285714285,1,0.0,0,0,0,0,0,0,0,1,0,0,1,1
3841,35167,eU4MPF9R01ru4sQN9giW756pdpNlnW4H,7GRhBDsirIGkRZBtSMEzNTyDr2JQm4xx,32,29,13,30,6,0,9,0,87,12.428571428571429,7,0.0,9,13,29,6,20,0,1,9,0,57,30,0
3842,35175,SWRtXIccwFeW0V06tTCrQAmJKwDAOcQm,7GRhBDsirIGkRZBtSMEzNTyDr2JQm4xx,1,0,0,0,0,0,1,0,1,0.14285714285714285,1,0.0,0,0,0,0,0,0,0,1,0,0,1,1
3843,35186,U04y5vFf0AfyJVGIOJHlryTyRQEOm5pT,5X6FeZozNMgE2VRi3MJYjkkFK8SETtu2,1,0,0,0,0,0,1,0,1,0.14285714285714285,1,0.0,0,0,0,0,0,0,0,1,0,0,1,0
3844,35215,eHvQ2U78p4YZsMgDMMDOOzYAdsqzih5K,5X6FeZozNMgE2VRi3MJYjkkFK8SETtu2,63,85,27,96,31,0,14,0,253,36.142857142857146,9,0.0,43,27,81,31,42,0,15,14,0,182,71,0
3845,35217,dTAykGxHxBqhi6OOd2NdEVRbLFHmTDWA,3VkHkmOtom3jM2wCu94xgzzu1d6Dn7or,6,4,2,0,2,0,3,0,11,1.5714285714285714,2,0.0,0,2,0,2,4,0,0,3,0,4,7,0
3846,35228,ShVY9aayOUs09f1eB0mroPylkADk2z6V,3VkHkmOtom3jM2wCu94xgzzu1d6Dn7or,13,4,4,0,3,0,9,2,22,3.142857142857143,2,0.0,0,4,0,3,4,0,0,9,2,7,15,1
3847,35229,YoDWB1JrmjjQfwRmPIoZFLCY9OTc0qY0,3VkHkmOtom3jM2wCu94xgzzu1d6Dn7or,28,49,19,21,20,19,10,0,138,19.714285714285715,4,0.0,21,19,21,20,28,19,0,10,0,81,57,1
3848,35230,3osqmyLTd0Yp2c4v5JzVTM7F74YzCdVT,3VkHkmOtom3jM2wCu94xgzzu1d6Dn7or,5,6,0,0,0,0,3,0,9,1.2857142857142858,1,0.0,0,0,0,0,6,0,0,3,0,0,9,1
3849,35231,aH50QjMw20jmR2a1SZ5ABNp5kUNFVZvb,3VkHkmOtom3jM2wCu94xgzzu1d6Dn7or,16,36,17,7,15,23,17,3,118,16.857142857142858,4,0.0,9,17,6,15,27,23,1,17,3,47,71,0
3850,35234,o9XCzfAWmkIZ4BcT96IkBMU2AsqEbNit,3VkHkmOtom3jM2wCu94xgzzu1d6Dn7or,26,126,31,32,20,23,17,0,249,35.57142857142857,7,0.0,56,31,29,20,70,23,3,17,0,136,113,0
3851,35239,tT6Sirn09KWiMo3tT1T33g39PgakkrEp,3VkHkmOtom3jM2wCu94xgzzu1d6Dn7or,79,126,72,45,58,8,30,3,342,48.857142857142854,10,0.0,33,72,41,58,93,8,4,30,3,204,138,0
3852,35241,NXyco71N78GkVfHnZsK8R307XzQzXNS1,3VkHkmOtom3jM2wCu94xgzzu1d6Dn7or,44,37,25,0,23,0,11,14,110,15.714285714285714,3,0.0,0,25,0,23,37,0,0,11,14,48,62,0
3853,35249,4aioHONa4uZzCKqGB12iuN523tylzUg4,3VkHkmOtom3jM2wCu94xgzzu1d6Dn7or,20,41,15,11,13,11,17,2,110,15.714285714285714,4,0.0,19,15,8,13,22,11,3,17,2,55,55,1
3854,35254,YfgudDVIeAr4vxyA9CRnVu6z6irXBYtG,3VkHkmOtom3jM2wCu94xgzzu1d6Dn7or,6,13,0,1,0,0,3,0,17,2.4285714285714284,4,0.0,1,0,1,0,12,0,0,3,0,2,15,1
3855,35257,4NR9J7NrWx9P8bFiOFbZEGtYIezzdGum,3VkHkmOtom3jM2wCu94xgzzu1d6Dn7or,79,175,58,50,78,2,7,4,374,53.42857142857143,4,0.0,109,58,42,78,66,2,8,7,4,287,87,0
3856,35261,ngsfhvUZUNnvQAEsXLmgPW2GFFZa3MUi,3VkHkmOtom3jM2wCu94xgzzu1d6Dn7or,20,30,11,5,12,16,11,0,85,12.142857142857142,3,0.0,9,11,5,12,21,16,0,11,0,37,48,1
3857,35267,tQFg4iseBORT6klS4i4ACWpNPhj1B9fa,3VkHkmOtom3jM2wCu94xgzzu1d6Dn7or,68,214,52,112,69,47,32,12,538,76.85714285714286,9,0.0,139,52,94,69,75,47,18,32,12,354,184,0
3858,35273,5o8Q8umISViuVbGmQVw8WnHF5Hfov9C3,3VkHkmOtom3jM2wCu94xgzzu1d6Dn7or,8,4,3,0,3,0,2,0,12,1.7142857142857142,2,0.0,0,3,0,3,4,0,0,2,0,6,6,1
3859,35275,mcSjHTQSOL9z6LfIHOZuth326lgoEoEd,3VkHkmOtom3jM2wCu94xgzzu1d6Dn7or,97,281,149,58,82,107,76,15,768,109.71428571428571,17,0.0,81,149,51,82,200,107,7,76,15,363,405,0
3860,35277,0NGmnEa8Aw1COy6QcVu1sb3DgBWk4plX,3VkHkmOtom3jM2wCu94xgzzu1d6Dn7or,67,373,83,150,142,24,50,3,825,117.85714285714286,8,0.0,248,83,142,142,125,24,8,50,3,615,210,0
3861,35280,oNf6qoW6E6dhoPJKSUjvElFlUKN9drLY,3VkHkmOtom3jM2wCu94xgzzu1d6Dn7or,80,155,76,52,55,24,62,3,427,61.0,8,0.0,45,76,51,55,110,24,1,62,3,227,200,0
3862,35286,DrwrBJqLuYoEmUm9z0KkD7rguSMjAzWZ,3VkHkmOtom3jM2wCu94xgzzu1d6Dn7or,4,5,1,0,0,0,3,0,9,1.2857142857142858,2,0.0,0,1,0,0,5,0,0,3,0,1,8,1
3863,35287,P4gIdHzF607L8e8VPH3Qb09lxgNZRJFa,3VkHkmOtom3jM2wCu94xgzzu1d6Dn7or,1,0,0,0,0,0,1,0,1,0.14285714285714285,1,0.0,0,0,0,0,0,0,0,1,0,0,1,1
3864,35304,OdutB2jwjn089D8EX2NAa3HnsFlikWQS,3VkHkmOtom3jM2wCu94xgzzu1d6Dn7or,23,39,24,0,13,0,19,0,95,13.571428571428571,10,0.0,0,24,0,13,39,0,0,19,0,37,58,1
3865,35305,N8IkPNWNai85jUxrrS9Z8EKzSnbszoPc,3VkHkmOtom3jM2wCu94xgzzu1d6Dn7or,38,48,19,22,15,19,8,0,131,18.714285714285715,6,0.0,16,19,20,15,32,19,2,8,0,70,61,0
3866,35308,g5cfvDvYqz1BC4LMGanzPaVPPBmwbapa,3VkHkmOtom3jM2wCu94xgzzu1d6Dn7or,88,176,59,64,78,14,27,1,419,59.857142857142854,10,0.0,97,59,58,78,79,14,6,27,1,292,127,0
3867,35312,Cl2kLzysgIaawouYP7ePYzkUue0vbAKM,3VkHkmOtom3jM2wCu94xgzzu1d6Dn7or,25,62,33,11,26,15,14,0,161,23.0,6,0.0,13,33,9,26,49,15,2,14,0,81,80,1
3868,35313,L1tmKgDPd0CzZGUi5x679NwUxuPXvaQW,3VkHkmOtom3jM2wCu94xgzzu1d6Dn7or,32,62,19,36,18,7,15,3,160,22.857142857142858,3,0.0,31,19,29,18,31,7,7,15,3,97,63,1
3869,35314,yc36c48wR0POl6aC6ZETCkJX90G6m6sl,3VkHkmOtom3jM2wCu94xgzzu1d6Dn7or,8,6,3,0,1,1,12,4,27,3.857142857142857,2,0.0,0,3,0,1,6,1,0,12,4,4,23,1
3870,35315,5t5QGGXf5uyIR6qWbr2N0KwpICB31qlV,3VkHkmOtom3jM2wCu94xgzzu1d6Dn7or,19,39,9,13,12,11,32,0,116,16.571428571428573,6,0.0,23,9,11,12,16,11,2,32,0,55,61,1
3871,35316,XzOYwpWjfyeCP837S63vDxFLmus8lP1p,3VkHkmOtom3jM2wCu94xgzzu1d6Dn7or,8,5,1,0,0,0,9,1,16,2.2857142857142856,1,0.0,0,1,0,0,5,0,0,9,1,1,15,1
3872,35320,BCPOhUa2LrfH93ebCE15VbF0VEWEyi7T,3VkHkmOtom3jM2wCu94xgzzu1d6Dn7or,80,146,64,51,59,5,41,0,366,52.285714285714285,10,0.0,56,64,48,59,90,5,3,41,0,227,139,0
3873,35326,LkaPh804PmEVlFyujBcIEugyeaRT3JCb,3VkHkmOtom3jM2wCu94xgzzu1d6Dn7or,1,0,0,0,0,0,1,0,1,0.14285714285714285,1,0.0,0,0,0,0,0,0,0,1,0,0,1,1
3874,35331,1u5RJ3ohzI9I8TYHEG8zy2n2QjuVVCRw,3VkHkmOtom3jM2wCu94xgzzu1d6Dn7or,74,277,86,52,59,24,27,1,526,75.14285714285714,5,0.0,72,86,47,59,205,24,5,27,1,264,262,0
3875,35337,RPQvIQfjeayIRS4PyDyrIytbJ9ZHNktA,3VkHkmOtom3jM2wCu94xgzzu1d6Dn7or,97,245,119,33,83,24,54,1,559,79.85714285714286,12,0.0,83,119,33,83,162,24,0,54,1,318,241,0
3876,35340,3F7yaep2FwWAK3l9S0HNjlUpCGuAAcmV,3VkHkmOtom3jM2wCu94xgzzu1d6Dn7or,19,43,18,7,9,1,25,1,104,14.857142857142858,3,0.0,14,18,7,9,29,1,0,25,1,48,56,1
3877,35346,IV6SMIJFVvUc1UCBOIaNbH0gLmOB3YMb,3VkHkmOtom3jM2wCu94xgzzu1d6Dn7or,55,149,2,41,13,1,26,0,232,33.142857142857146,7,0.0,48,2,37,13,101,1,4,26,0,100,132,0
3878,35350,MMTprU0LIvxVqomHdkVRSYImuPQi51Ne,3VkHkmOtom3jM2wCu94xgzzu1d6Dn7or,60,229,49,41,35,15,41,1,411,58.714285714285715,6,0.0,83,49,38,35,146,15,3,41,1,205,206,0
3879,35351,J5m6FPwEGmu5Gn7wOSGcO1Ej5dLfRCw9,3VkHkmOtom3jM2wCu94xgzzu1d6Dn7or,7,5,3,0,2,0,6,0,16,2.2857142857142856,2,0.0,0,3,0,2,5,0,0,6,0,5,11,1
3880,35353,90w1qbnQuEy9DPjkJdcTy8Ku3weZPxFV,3VkHkmOtom3jM2wCu94xgzzu1d6Dn7or,1,0,0,0,0,0,1,0,1,0.14285714285714285,1,0.0,0,0,0,0,0,0,0,1,0,0,1,1
3881,35354,rxDS79E98XmgSuABxs3b3I1YF80eAjg8,3VkHkmOtom3jM2wCu94xgzzu1d6Dn7or,14,10,6,0,5,0,7,0,28,4.0,1,0.0,0,6,0,5,10,0,0,7,0,11,17,1
3882,35359,6kMrJmwcqFNgfzFT3CJTdPq2HO5oFeTe,3VkHkmOtom3jM2wCu94xgzzu1d6Dn7or,78,399,65,112,62,66,32,3,739,105.57142857142857,12,0.0,189,65,103,62,210,66,9,32,3,419,320,1
3883,35360,T8TKNQciNYxyZa02JNR1WAwQ2Y5qXjum,3VkHkmOtom3jM2wCu94xgzzu1d6Dn7or,63,73,28,24,26,7,27,3,188,26.857142857142858,6,0.0,35,28,24,26,38,7,0,27,3,113,75,0
3884,35361,5EJnob1OMXiBHOO6bo7nkQouLkltGzGu,3VkHkmOtom3jM2wCu94xgzzu1d6Dn7or,1,0,0,0,0,0,2,0,2,0.2857142857142857,1,0.0,0,0,0,0,0,0,0,2,0,0,2,1
3885,35363,omynTyB0op2S6N0LZFfMkyOx2iQXr4PS,3VkHkmOtom3jM2wCu94xgzzu1d6Dn7or,31,32,24,0,19,0,6,0,81,11.571428571428571,4,0.0,0,24,0,19,32,0,0,6,0,43,38,0
3886,35369,YM3x5XH5tmfdGcWwsvjAdikPkIR3zAmm,3VkHkmOtom3jM2wCu94xgzzu1d6Dn7or,65,153,68,90,54,8,37,9,419,59.857142857142854,7,0.0,50,68,85,54,103,8,5,37,9,257,162,0
3887,35383,hBpRVfYtdybPhgj3MfVukeLOAvCcgIw6,3VkHkmOtom3jM2wCu94xgzzu1d6Dn7or,4,2,1,0,0,0,2,0,5,0.7142857142857143,1,0.0,0,1,0,0,2,0,0,2,0,1,4,1
3888,35384,BE4JaFadHavW9r5xCXpj3M456eZAgaG6,3VkHkmOtom3jM2wCu94xgzzu1d6Dn7or,4,2,1,0,1,0,1,0,5,0.7142857142857143,1,0.0,0,1,0,1,2,0,0,1,0,2,3,1
3889,35386,8fvsCrC8dcOje6DxrGntnTxmufYXJCrq,3VkHkmOtom3jM2wCu94xgzzu1d6Dn7or,12,41,12,6,4,26,20,0,109,15.571428571428571,6,0.0,9,12,5,4,32,26,1,20,0,30,79,1
3890,35388,ngy9FDiYXpc4c01p0sFczM8viAh3TUDK,3VkHkmOtom3jM2wCu94xgzzu1d6Dn7or,11,10,6,0,4,1,5,0,26,3.7142857142857144,2,0.0,1,6,0,4,9,1,0,5,0,11,15,1
3891,35390,s1zoJG6TsTv8LP9PRWCYbeiv4OLIivpy,3VkHkmOtom3jM2wCu94xgzzu1d6Dn7or,10,20,11,0,5,0,8,0,44,6.285714285714286,9,0.0,0,11,0,5,20,0,0,8,0,16,28,1
3892,35391,jE0dkbFs2fRzdAygi15t1sbkEYmvUbtw,3VkHkmOtom3jM2wCu94xgzzu1d6Dn7or,6,9,3,0,2,0,3,0,17,2.4285714285714284,2,0.0,2,3,0,2,7,0,0,3,0,7,10,1
3893,35394,GcQtcb2ioSzefdF875SDqaLTsuxZvpji,3VkHkmOtom3jM2wCu94xgzzu1d6Dn7or,56,89,74,0,56,5,21,2,247,35.285714285714285,11,0.0,0,74,0,56,89,5,0,21,2,130,117,0
3894,35397,NZRigOdbBm5L1F5X34hgYO92Vp7JjaX3,3VkHkmOtom3jM2wCu94xgzzu1d6Dn7or,1,0,0,0,0,0,1,0,1,0.14285714285714285,1,0.0,0,0,0,0,0,0,0,1,0,0,1,1
3895,35401,rhjTu7dlupNEg0KoplRLx0VbktemTt3u,3VkHkmOtom3jM2wCu94xgzzu1d6Dn7or,3,0,0,0,0,0,10,0,10,1.4285714285714286,1,0.0,0,0,0,0,0,0,0,10,0,0,10,1
3896,35403,K9KsptRLWOmP5jrMOI7PEiLIqzyruebX,3VkHkmOtom3jM2wCu94xgzzu1d6Dn7or,1,0,0,0,0,0,1,0,1,0.14285714285714285,1,0.0,0,0,0,0,0,0,0,1,0,0,1,1
3897,35408,hUgWBwzoxTCI0ZG2TscrqK8ctEypKa8f,3VkHkmOtom3jM2wCu94xgzzu1d6Dn7or,1,0,0,0,0,0,1,0,1,0.14285714285714285,1,0.0,0,0,0,0,0,0,0,1,0,0,1,1
3898,35483,OsqZuhMeFHyilvCkRc36i3NA1vApj2oc,7GRhBDsirIGkRZBtSMEzNTyDr2JQm4xx,1,0,0,0,0,0,1,0,1,0.14285714285714285,1,0.0,0,0,0,0,0,0,0,1,0,0,1,1
3899,35537,npUiSf7zpmcI1kxZNOdnRuQUK0hLYnSc,7GRhBDsirIGkRZBtSMEzNTyDr2JQm4xx,2,0,0,0,0,0,2,0,2,0.2857142857142857,1,0.0,0,0,0,0,0,0,0,2,0,0,2,1
3900,35558,hJwtwnOzJaTrAeP4eXJAEwz2xbKsgc4M,7GRhBDsirIGkRZBtSMEzNTyDr2JQm4xx,5,0,0,0,0,0,12,0,12,1.7142857142857142,4,0.0,0,0,0,0,0,0,0,12,0,0,12,1
3901,35583,O36QxtTrV6jSigC0QBjRMiqSpx0KHX6w,7GRhBDsirIGkRZBtSMEzNTyDr2JQm4xx,130,251,99,206,90,28,31,0,705,100.71428571428571,8,0.0,129,99,172,90,122,28,34,31,0,490,215,0
3902,35585,OmX2SQBCwRoYrHwcrkvse43BtP3hkWEM,7GRhBDsirIGkRZBtSMEzNTyDr2JQm4xx,6,3,1,0,1,0,2,0,7,1.0,1,0.0,0,1,0,1,3,0,0,2,0,2,5,1
3903,35592,WgQR6nrfyl7yDpgHC595JSoog2R9VhVs,7GRhBDsirIGkRZBtSMEzNTyDr2JQm4xx,136,310,121,203,98,33,37,1,803,114.71428571428571,14,0.0,143,121,159,98,167,33,44,37,1,521,282,0
3904,35594,d6aHeIWZcsirh8eDlHrmG2KrUzDWnJuj,7GRhBDsirIGkRZBtSMEzNTyDr2JQm4xx,15,22,11,2,3,0,7,0,45,6.428571428571429,3,0.0,7,11,1,3,15,0,1,7,0,22,23,1
3905,35644,bzlTCtIUcO5BfACSIQwT3PRYSdK0QGTr,7GRhBDsirIGkRZBtSMEzNTyDr2JQm4xx,7,3,2,0,2,0,2,0,9,1.2857142857142858,1,0.0,0,2,0,2,3,0,0,2,0,4,5,1
3906,35646,CCMzevo14iTCqMsIpKsbx331FhP08gFZ,7GRhBDsirIGkRZBtSMEzNTyDr2JQm4xx,26,19,7,22,5,0,4,0,57,8.142857142857142,2,0.0,9,7,12,5,10,0,10,4,0,33,24,1
3907,35660,I7HvXtiH0SNpu1BcvHuR3QJKpkzrbUYb,7GRhBDsirIGkRZBtSMEzNTyDr2JQm4xx,1,0,0,0,0,0,1,0,1,0.14285714285714285,1,0.0,0,0,0,0,0,0,0,1,0,0,1,1
3908,35661,StY7mIcclc0vcUIJFTvL9RrXxdUXnEhh,7GRhBDsirIGkRZBtSMEzNTyDr2JQm4xx,1,0,0,0,0,0,1,0,1,0.14285714285714285,1,0.0,0,0,0,0,0,0,0,1,0,0,1,1
3909,35726,xHZbSROhwP4RRQerUVWvcNTfOGc2DHWf,7GRhBDsirIGkRZBtSMEzNTyDr2JQm4xx,59,170,68,103,31,60,50,1,483,69.0,14,0.0,45,68,84,31,125,60,19,50,1,228,255,1
3910,35740,2Exq2qT4UVjm3V3cO5xfnW6aAT6vUwLB,7GRhBDsirIGkRZBtSMEzNTyDr2JQm4xx,11,13,4,0,1,0,9,0,27,3.857142857142857,2,0.0,0,4,0,1,13,0,0,9,0,5,22,1
3911,35753,aXYyJMDvVYwwKBbiO4CB25XlnDBfWYNg,7GRhBDsirIGkRZBtSMEzNTyDr2JQm4xx,50,71,23,61,11,13,7,0,186,26.571428571428573,5,0.0,42,23,53,11,29,13,8,7,0,129,57,0
3912,35806,b9hN1tjIpM67gB8PuwPQ3u561lqo1V2f,7GRhBDsirIGkRZBtSMEzNTyDr2JQm4xx,7,5,4,0,4,0,2,0,15,2.142857142857143,1,0.0,0,4,0,4,5,0,0,2,0,8,7,1
3913,35817,Kneva8tRfI6BhvgFMe4i80mebf2hEQk0,7GRhBDsirIGkRZBtSMEzNTyDr2JQm4xx,9,6,5,0,3,0,5,0,19,2.7142857142857144,3,0.0,0,5,0,3,6,0,0,5,0,8,11,1
3914,35833,Am2zVb1UB0adRGJ5ZAnKfQVWNzOqucZ5,7GRhBDsirIGkRZBtSMEzNTyDr2JQm4xx,5,2,1,0,1,0,4,0,8,1.1428571428571428,2,0.0,0,1,0,1,2,0,0,4,0,2,6,0
3915,35845,klPtoz7fzAXWyNuTpvNOlHO6ALCwtMKk,7GRhBDsirIGkRZBtSMEzNTyDr2JQm4xx,1,0,0,0,0,0,2,0,2,0.2857142857142857,1,0.0,0,0,0,0,0,0,0,2,0,0,2,1
3916,35868,PeCugnCDRTxTqifK7mkc0ffuLTN5EPRT,7GRhBDsirIGkRZBtSMEzNTyDr2JQm4xx,22,41,15,20,1,0,6,0,83,11.857142857142858,3,0.0,15,15,11,1,26,0,9,6,0,42,41,0
3917,35876,tBcWnrptNiGaZgy4k51BltzcKki801j1,7GRhBDsirIGkRZBtSMEzNTyDr2JQm4xx,1,0,0,0,0,0,1,0,1,0.14285714285714285,1,0.0,0,0,0,0,0,0,0,1,0,0,1,1
3918,37571,9jZsAxMdQXvLjxKIorcfAyZ7kTyyk2m3,A3fsA9Zfv1X2fVEQhTw51lKENdNrEqT3,19,25,13,14,2,3,11,0,68,9.714285714285714,4,0.0,0,13,14,2,25,3,0,11,0,29,39,1
3919,37590,ZHGbzWgnUfJJPdovMfpePS97QxPtktWe,SpATywNh6bZuzm8s1ceuBUnMUAeoAHHw,7,2,1,0,1,0,5,0,9,1.2857142857142858,1,0.0,0,1,0,1,2,0,0,5,0,2,7,1
3920,37593,ZmKF4tFBenzCeCXZcmDdE2tsuT4rzLPd,G8EPVSXsOYB5YQWZGiz1aVq5Pgr2GrQu,5,2,1,0,1,0,2,0,6,0.8571428571428571,1,0.0,0,1,0,1,2,0,0,2,0,2,4,1
3921,37599,yVtzjNm7Xgz14yjopuLvCh7VRZR9RBra,bWdj2GDclj5ofokWjzoa5jAwMkxCykd6,7,13,5,2,6,0,7,0,33,4.714285714285714,2,0.0,5,5,2,6,8,0,0,7,0,18,15,1
3922,37600,NHGmMinB9WoQusKCx50F4M4nJF124Ms4,A3fsA9Zfv1X2fVEQhTw51lKENdNrEqT3,58,58,41,56,24,17,43,5,244,34.857142857142854,9,0.0,3,41,50,24,55,17,6,43,5,118,126,1
3923,37607,NvmmlHTgNmxqyrQU3a9c6oM8kVrIYu3Q,SpATywNh6bZuzm8s1ceuBUnMUAeoAHHw,23,36,18,0,10,0,9,0,73,10.428571428571429,5,0.0,0,18,0,10,36,0,0,9,0,28,45,1
3924,37613,deaOh1cCfPHHygo0HX3j8JDIzRZNPF7P,SpATywNh6bZuzm8s1ceuBUnMUAeoAHHw,10,6,3,13,2,0,1,0,25,3.5714285714285716,2,0.0,2,3,12,2,4,0,1,1,0,19,6,0
3925,37618,ABlVlNkPi30ZMlFLrcsAhP5jZW6rJhdZ,A3fsA9Zfv1X2fVEQhTw51lKENdNrEqT3,22,18,14,0,11,0,5,0,48,6.857142857142857,4,0.0,0,14,0,11,18,0,0,5,0,25,23,1
3926,37621,7ynsHGhJ1N4494Hez57ckblgtBNGbed9,A3fsA9Zfv1X2fVEQhTw51lKENdNrEqT3,5,0,0,0,0,0,9,0,9,1.2857142857142858,3,0.0,0,0,0,0,0,0,0,9,0,0,9,1
3927,37622,3hFWpwvaMZB4do5VrkI46WX7phUXE8q9,SpATywNh6bZuzm8s1ceuBUnMUAeoAHHw,1,0,0,0,0,0,2,0,2,0.2857142857142857,1,0.0,0,0,0,0,0,0,0,2,0,0,2,1
3928,37627,61Btwz5kWZaS3OIGnNTMXi3lqbtcLCB7,SpATywNh6bZuzm8s1ceuBUnMUAeoAHHw,28,118,20,17,6,0,54,0,215,30.714285714285715,12,0.0,12,20,17,6,106,0,0,54,0,55,160,1
3929,37628,9S5uoFAiVHVF4D2DNR23wCkbQZ8LhtES,RXDvfPUBYFlVdlueBFbLW0mhhAyGEqpt,31,43,13,36,10,0,8,0,110,15.714285714285714,5,0.0,12,13,34,10,31,0,2,8,0,69,41,0
3930,37655,W68HJCLMGaPDXLquuNsADTmn70KIcSIQ,G8EPVSXsOYB5YQWZGiz1aVq5Pgr2GrQu,2,0,0,0,0,0,4,0,4,0.5714285714285714,1,0.0,0,0,0,0,0,0,0,4,0,0,4,1
3931,37656,BGZaaH5HDVuGvqaegp5MyJblPEuJpcXP,bWdj2GDclj5ofokWjzoa5jAwMkxCykd6,2,0,0,0,0,0,2,0,2,0.2857142857142857,1,0.0,0,0,0,0,0,0,0,2,0,0,2,1
3932,37657,h93nu205LxG6yA79vswKf1FixgIn79rm,G8EPVSXsOYB5YQWZGiz1aVq5Pgr2GrQu,160,105,67,241,46,4,13,2,478,68.28571428571429,3,0.0,33,67,202,46,72,4,39,13,2,348,130,1
3933,37658,k3sYdhuU0JisiJgPpOdae3U2CoUcaazJ,SpATywNh6bZuzm8s1ceuBUnMUAeoAHHw,16,24,7,12,3,23,7,1,77,11.0,2,0.0,10,7,12,3,14,23,0,7,1,32,45,1
3934,37661,BGZaaH5HDVuGvqaegp5MyJblPEuJpcXP,A3fsA9Zfv1X2fVEQhTw51lKENdNrEqT3,2,0,0,0,0,0,2,0,2,0.2857142857142857,1,0.0,0,0,0,0,0,0,0,2,0,0,2,0
3935,37675,4P8kDd8yuaZj29FYuMADbc9LGiIxpIwD,bWdj2GDclj5ofokWjzoa5jAwMkxCykd6,23,25,6,95,5,5,22,1,159,22.714285714285715,3,0.0,9,6,87,5,16,5,8,22,1,107,52,1
3936,37686,UkQJwGAwu2oSVR7bdUsiWWEqFzH2qHlf,SpATywNh6bZuzm8s1ceuBUnMUAeoAHHw,26,46,8,34,3,23,12,0,126,18.0,5,0.0,9,8,29,3,37,23,5,12,0,49,77,0
3937,37694,umy7brIUz48bN1VUJsZEuHA9by5FINCa,A3fsA9Zfv1X2fVEQhTw51lKENdNrEqT3,25,30,22,0,14,4,19,0,89,12.714285714285714,3,0.0,0,22,0,14,30,4,0,19,0,36,53,1
3938,37695,KaDaT2PXnsmD67HkbCpFnRySFfo61Clp,A3fsA9Zfv1X2fVEQhTw51lKENdNrEqT3,19,20,15,0,13,0,3,0,51,7.285714285714286,2,0.0,0,15,0,13,20,0,0,3,0,28,23,1
3939,37700,bLIF0ETNcg7fjkutu8YBWJptM3zxtu2Z,A3fsA9Zfv1X2fVEQhTw51lKENdNrEqT3,9,11,11,0,11,1,13,0,47,6.714285714285714,4,0.0,0,11,0,11,11,1,0,13,0,22,25,1
3940,37712,K8l2u7bOqtMijaHas6Baa4xmjexwxyjr,G8EPVSXsOYB5YQWZGiz1aVq5Pgr2GrQu,7,3,2,0,2,0,6,0,13,1.8571428571428572,1,0.0,0,2,0,2,3,0,0,6,0,4,9,0
3941,37715,vfZ107RlnUxktrRHn8r9duLiSNHxQt59,SpATywNh6bZuzm8s1ceuBUnMUAeoAHHw,13,8,6,2,3,8,3,0,30,4.285714285714286,1,0.0,0,6,2,3,8,8,0,3,0,11,19,1
3942,37730,z3YnX73v2uoVHmuLGzQD2gKKBoJqIQxK,bWdj2GDclj5ofokWjzoa5jAwMkxCykd6,48,113,60,206,40,2,30,2,453,64.71428571428571,11,0.0,32,60,182,40,81,2,24,30,2,314,139,0
3943,37740,B1u0c5LDTPlzBAhbGuUr9zut2NBFb4ik,G8EPVSXsOYB5YQWZGiz1aVq5Pgr2GrQu,8,4,3,0,2,0,2,0,11,1.5714285714285714,1,0.0,0,3,0,2,4,0,0,2,0,5,6,1
3944,37743,5IM8g7YMOYo5qH7Yu3x31T3JkVOH9iqe,A3fsA9Zfv1X2fVEQhTw51lKENdNrEqT3,17,26,8,0,7,0,2,0,43,6.142857142857143,1,0.0,0,8,0,7,26,0,0,2,0,15,28,1
3945,37744,YGd4irzc5KMR1PH2KdOtbCkghLMZ2dPk,bWdj2GDclj5ofokWjzoa5jAwMkxCykd6,4,2,2,0,0,0,4,0,8,1.1428571428571428,2,0.0,0,2,0,0,2,0,0,4,0,2,6,1
3946,37750,GpHiOkm3UY3R1sigoD8RZsfbPyCjOvL2,bWdj2GDclj5ofokWjzoa5jAwMkxCykd6,12,39,22,0,17,0,18,1,97,13.857142857142858,10,0.0,0,22,0,17,39,0,0,18,1,39,58,1
3947,37754,qzjZHUzfivuSEB3h2CxO69AUVaBX51Ki,A3fsA9Zfv1X2fVEQhTw51lKENdNrEqT3,2,0,0,0,0,0,5,0,5,0.7142857142857143,2,0.0,0,0,0,0,0,0,0,5,0,0,5,1
3948,37767,b9kodEhA94IDSBT3ykY4QWiqr6rjyws0,G8EPVSXsOYB5YQWZGiz1aVq5Pgr2GrQu,1,0,0,0,0,0,1,0,1,0.14285714285714285,1,0.0,0,0,0,0,0,0,0,1,0,0,1,1
3949,37768,CeSP4PMtab0Lz3R25BXEghWPiV1yY5Ef,SpATywNh6bZuzm8s1ceuBUnMUAeoAHHw,15,22,3,17,0,9,17,2,70,10.0,3,0.0,9,3,15,0,13,9,2,17,2,27,43,1
3950,37778,MT2eJtF59AVNdUs7mwFqputROb2HgEm3,A3fsA9Zfv1X2fVEQhTw51lKENdNrEqT3,169,132,61,414,34,0,19,1,661,94.42857142857143,9,0.0,9,61,345,34,123,0,69,19,1,449,212,0
3951,37792,fXZ6GxDg4jr2jydxDfAmDq6HhmCcTKhM,bWdj2GDclj5ofokWjzoa5jAwMkxCykd6,6,1,1,0,1,0,3,1,7,1.0,1,0.0,0,1,0,1,1,0,0,3,1,2,5,1
3952,37794,uQjl8NGtIQkRfoe9edBiMgtYYmdkzVXR,A3fsA9Zfv1X2fVEQhTw51lKENdNrEqT3,70,133,75,134,29,8,49,1,429,61.285714285714285,15,0.0,11,75,107,29,122,8,27,49,1,222,207,0
3953,37795,AtIH4YI3eYIPCQxtOLtZgwyhSnXOdn2e,A3fsA9Zfv1X2fVEQhTw51lKENdNrEqT3,1,0,0,0,0,0,1,0,1,0.14285714285714285,1,0.0,0,0,0,0,0,0,0,1,0,0,1,1
3954,37796,Zl7A4QMlAs6IcbXcPt0cXmqZJLFzPwcf,SpATywNh6bZuzm8s1ceuBUnMUAeoAHHw,15,14,7,10,5,0,10,0,46,6.571428571428571,2,0.0,4,7,9,5,10,0,1,10,0,25,21,1
3955,37799,t7ddfllmrYfl93sdsVEbTfmmaWswoGkm,bWdj2GDclj5ofokWjzoa5jAwMkxCykd6,11,21,11,0,7,0,11,1,51,7.285714285714286,3,0.0,2,11,0,7,19,0,0,11,1,20,31,1
3956,37806,0FuB48Egjj7khWsNq1DtKTVsB7OEgidM,bWdj2GDclj5ofokWjzoa5jAwMkxCykd6,21,32,22,0,15,0,13,0,82,11.714285714285714,3,0.0,2,22,0,15,30,0,0,13,0,39,43,1
3957,37809,eEE69ZWSNrdmveqNEUHZYk60iG9wpaEc,SpATywNh6bZuzm8s1ceuBUnMUAeoAHHw,26,50,23,25,5,32,13,0,148,21.142857142857142,5,0.0,13,23,22,5,37,32,3,13,0,63,85,1
3958,37810,NcPdgwZnF0RkLUxC56tG83zG3V3KP94S,SpATywNh6bZuzm8s1ceuBUnMUAeoAHHw,38,36,22,41,11,14,18,2,144,20.571428571428573,6,0.0,12,22,35,11,24,14,6,18,2,80,64,1
3959,37820,VjekNiOqthnLG6rS8JBJtCSICch28JV9,SpATywNh6bZuzm8s1ceuBUnMUAeoAHHw,11,12,9,0,5,0,8,0,34,4.857142857142857,3,0.0,0,9,0,5,12,0,0,8,0,14,20,0
3960,37823,2Y3h62Lps0fU6B3C4MXM4YNVNDf25XBr,SpATywNh6bZuzm8s1ceuBUnMUAeoAHHw,46,75,46,67,32,1,11,0,232,33.142857142857146,11,0.0,14,46,53,32,61,1,14,11,0,145,87,0
3961,37825,C2tzR0PThnHl9xmZylE5Te8es3KNWViY,SpATywNh6bZuzm8s1ceuBUnMUAeoAHHw,1,0,0,0,0,0,1,0,1,0.14285714285714285,1,0.0,0,0,0,0,0,0,0,1,0,0,1,1
3962,37827,C2tzR0PThnHl9xmZylE5Te8es3KNWViY,bWdj2GDclj5ofokWjzoa5jAwMkxCykd6,8,15,0,0,1,1,6,0,23,3.2857142857142856,5,0.0,0,0,0,1,15,1,0,6,0,1,22,1
3963,37830,0FuB48Egjj7khWsNq1DtKTVsB7OEgidM,A3fsA9Zfv1X2fVEQhTw51lKENdNrEqT3,44,34,27,0,20,0,14,1,96,13.714285714285714,3,0.0,0,27,0,20,34,0,0,14,1,47,49,0
3964,37841,H4f84AflSuLjxZbar9MNvTHEIA8lIMO0,G8EPVSXsOYB5YQWZGiz1aVq5Pgr2GrQu,8,2,2,0,2,0,3,0,9,1.2857142857142858,1,0.0,0,2,0,2,2,0,0,3,0,4,5,1
3965,37842,QeQqhAEpCOGJwaPPp0lj3OsPiBcGFat2,SpATywNh6bZuzm8s1ceuBUnMUAeoAHHw,16,59,3,4,3,1,17,0,87,12.428571428571429,6,0.0,14,3,4,3,45,1,0,17,0,24,63,0
3966,37851,6ovqVSF3YZ6bnWJaJ7v2dHPROWXVVlFQ,SpATywNh6bZuzm8s1ceuBUnMUAeoAHHw,18,21,6,10,3,0,6,2,48,6.857142857142857,3,0.0,6,6,10,3,15,0,0,6,2,25,23,1
3967,37857,fhNT15VFhs3gsHOTo44snQYPYn9BDZ0e,A3fsA9Zfv1X2fVEQhTw51lKENdNrEqT3,5,6,3,0,0,3,4,0,16,2.2857142857142856,2,0.0,1,3,0,0,5,3,0,4,0,4,12,1
3968,37862,i454zkNvATiV1XJbjzVrf2ArWE1JYXx7,G8EPVSXsOYB5YQWZGiz1aVq5Pgr2GrQu,6,1,1,0,1,0,5,0,8,1.1428571428571428,1,0.0,0,1,0,1,1,0,0,5,0,2,6,1
3969,37879,xx9GC4KvGKaMlifXkbb8bDYUKB0PSURf,G8EPVSXsOYB5YQWZGiz1aVq5Pgr2GrQu,14,9,6,0,5,0,4,0,24,3.4285714285714284,1,0.0,0,6,0,5,9,0,0,4,0,11,13,1
3970,37900,qZhmmNUvkNXdf3u04DTUQOFEBxxO10p4,SpATywNh6bZuzm8s1ceuBUnMUAeoAHHw,44,89,40,33,13,4,31,0,210,30.0,13,0.0,15,40,30,13,74,4,3,31,0,98,112,0
3971,37901,blQFA8HzhNQeb8MMYJXyJW6sPMdvZQKn,bWdj2GDclj5ofokWjzoa5jAwMkxCykd6,7,4,2,0,1,0,8,0,15,2.142857142857143,2,0.0,0,2,0,1,4,0,0,8,0,3,12,1
3972,37902,fHWbyI7D8dlYSwaHNTLNlsq8suMt5t3C,SpATywNh6bZuzm8s1ceuBUnMUAeoAHHw,25,83,37,33,10,77,50,4,294,42.0,6,0.0,14,37,30,10,69,77,3,50,4,91,203,1
3973,37917,zov347eGa3QeB2nEEXWZhFIKLoCmgiMD,SpATywNh6bZuzm8s1ceuBUnMUAeoAHHw,10,34,4,0,2,2,8,0,50,7.142857142857143,4,0.0,0,4,0,2,34,2,0,8,0,6,44,0
3974,37922,j3dtYivg2u73ZbuSWbPPpSBQQec6vBYH,A3fsA9Zfv1X2fVEQhTw51lKENdNrEqT3,13,46,26,0,9,0,22,0,103,14.714285714285714,14,0.0,0,26,0,9,46,0,0,22,0,35,68,0
3975,37923,EHdY3AEgr2nI6jaAM9bjHY2nqgEPned4,SpATywNh6bZuzm8s1ceuBUnMUAeoAHHw,11,12,4,5,2,0,4,0,27,3.857142857142857,2,0.0,2,4,4,2,10,0,1,4,0,12,15,1
3976,37925,v1W3YvgJ0IFCSGXyKmwZ2bb9TVfgDIwv,G8EPVSXsOYB5YQWZGiz1aVq5Pgr2GrQu,6,6,2,0,2,0,1,0,11,1.5714285714285714,1,0.0,3,2,0,2,3,0,0,1,0,7,4,0
3977,37935,OkJ0lKmMXuQ2MGftQ8Isfw1JciMpapRC,SpATywNh6bZuzm8s1ceuBUnMUAeoAHHw,21,47,27,7,15,2,16,1,115,16.428571428571427,6,0.0,3,27,7,15,44,2,0,16,1,52,63,0
3978,37940,QmHQ7ayFECnRsgCVpHpJI6yMYR4kf5re,bWdj2GDclj5ofokWjzoa5jAwMkxCykd6,53,60,34,255,7,41,16,0,413,59.0,7,0.0,12,34,215,7,48,41,40,16,0,268,145,0
3979,37960,bz2uqvuFRCLaJmY4vFLIXrs9g0cTBHJC,A3fsA9Zfv1X2fVEQhTw51lKENdNrEqT3,50,28,21,54,13,0,14,3,133,19.0,6,0.0,1,21,48,13,27,0,6,14,3,83,50,1
3980,37973,k0lvFNaTVHTtB1XHBZ8229ej4v1r4rPk,bWdj2GDclj5ofokWjzoa5jAwMkxCykd6,10,9,1,0,1,6,15,1,33,4.714285714285714,3,0.0,0,1,0,1,9,6,0,15,1,2,31,0
3981,37982,OJtJM3YEXIy4oJKwRv1QkycNqhb8JLoi,SpATywNh6bZuzm8s1ceuBUnMUAeoAHHw,6,2,1,0,1,0,3,2,9,1.2857142857142858,1,0.0,0,1,0,1,2,0,0,3,2,2,7,1
3982,37983,YG3IIEQOezPClODg4SNvtFayndWcEJ7a,A3fsA9Zfv1X2fVEQhTw51lKENdNrEqT3,8,11,5,0,1,0,5,0,22,3.142857142857143,2,0.0,0,5,0,1,11,0,0,5,0,6,16,1
3983,37988,fUqxJqppQTNVXv13r4wKORaBU4L22bhx,SpATywNh6bZuzm8s1ceuBUnMUAeoAHHw,5,3,2,0,2,0,2,0,9,1.2857142857142858,1,0.0,0,2,0,2,3,0,0,2,0,4,5,1
3984,37989,jkwnVusgQrKbxfhd5nIkbaklULLOZT9D,A3fsA9Zfv1X2fVEQhTw51lKENdNrEqT3,1,0,0,0,0,0,2,0,2,0.2857142857142857,1,0.0,0,0,0,0,0,0,0,2,0,0,2,1
3985,38003,gxc60X8EJb2yIw8hE5NeguZan8o3YXLZ,SpATywNh6bZuzm8s1ceuBUnMUAeoAHHw,16,14,6,10,3,1,6,1,41,5.857142857142857,2,0.0,2,6,9,3,12,1,1,6,1,20,21,1
3986,38004,QEbMAkKsvpPGPL1XkTiHjXblquVwKrlD,A3fsA9Zfv1X2fVEQhTw51lKENdNrEqT3,17,23,5,0,1,0,23,1,53,7.571428571428571,7,0.0,1,5,0,1,22,0,0,23,1,7,46,1
3987,38006,KRzA1Kk4qiSF9draiukb1XAlRpMcb8Gh,SpATywNh6bZuzm8s1ceuBUnMUAeoAHHw,5,2,1,0,1,0,2,0,6,0.8571428571428571,1,0.0,0,1,0,1,2,0,0,2,0,2,4,1
3988,38016,i9wjeQMhaeiCRSFBW7M0FOy9yJ5VeZZF,SpATywNh6bZuzm8s1ceuBUnMUAeoAHHw,8,15,2,0,0,0,13,0,30,4.285714285714286,2,0.0,0,2,0,0,15,0,0,13,0,2,28,1
3989,38026,u82lBhpDxJIwlZISEntCxj1zgVFdW0vT,G8EPVSXsOYB5YQWZGiz1aVq5Pgr2GrQu,1,0,0,0,0,0,1,0,1,0.14285714285714285,1,0.0,0,0,0,0,0,0,0,1,0,0,1,1
3990,38033,KlQIh6CJiUFTrdMyk4Y8sFKMj5TT9ON4,A3fsA9Zfv1X2fVEQhTw51lKENdNrEqT3,26,20,15,0,10,1,8,1,55,7.857142857142857,2,0.0,2,15,0,10,18,1,0,8,1,27,28,1
3991,38047,KkXSOHPa8OPkVJQjN92ejg7MqYYerSuw,A3fsA9Zfv1X2fVEQhTw51lKENdNrEqT3,5,3,2,0,2,0,5,0,12,1.7142857142857142,2,0.0,0,2,0,2,3,0,0,5,0,4,8,1
3992,38068,PmZJAFj6wJkOD163WkhaJjRHdYOMjBZW,SpATywNh6bZuzm8s1ceuBUnMUAeoAHHw,26,30,14,18,6,64,8,1,141,20.142857142857142,7,0.0,9,14,15,6,21,64,3,8,1,44,97,1
3993,38070,sKmcegdtnOHdb8n0mSxwdw5R2hJqVxhV,SpATywNh6bZuzm8s1ceuBUnMUAeoAHHw,6,3,2,0,2,0,1,0,8,1.1428571428571428,1,0.0,0,2,0,2,3,0,0,1,0,4,4,1
3994,38087,QyvVrWztIgSCCViLyqSM2D5NbMV2fEBm,SpATywNh6bZuzm8s1ceuBUnMUAeoAHHw,13,17,4,5,5,0,8,0,39,5.571428571428571,5,0.0,0,4,5,5,17,0,0,8,0,14,25,0
3995,38092,32tAPwhpK9bCQqIAiBE9WTs1sTNu9Vyf,A3fsA9Zfv1X2fVEQhTw51lKENdNrEqT3,1,0,0,0,0,0,1,0,1,0.14285714285714285,1,0.0,0,0,0,0,0,0,0,1,0,0,1,1
3996,38097,MkuttLQlAg2ibzg21YKyuq14uYFl6Q9Q,A3fsA9Zfv1X2fVEQhTw51lKENdNrEqT3,10,30,7,0,0,1,13,1,52,7.428571428571429,3,0.0,10,7,0,0,20,1,0,13,1,17,35,1
3997,38100,NsLNEhFZrusC9duqTXuavXuymnAo5QEg,SpATywNh6bZuzm8s1ceuBUnMUAeoAHHw,15,35,3,19,1,4,16,0,78,11.142857142857142,4,0.0,12,3,16,1,23,4,3,16,0,32,46,1
3998,38105,vrESC5Tu2ZaCb3FZy3EK8oGteg0Z9Ni5,SpATywNh6bZuzm8s1ceuBUnMUAeoAHHw,9,10,2,2,1,1,2,0,18,2.5714285714285716,2,0.0,0,2,2,1,10,1,0,2,0,5,13,1
3999,38106,ayqwdyDC23QUsfyE7IPhnu9xrtfBNG6f,A3fsA9Zfv1X2fVEQhTw51lKENdNrEqT3,8,3,2,0,2,0,7,0,14,2.0,1,0.0,0,2,0,2,3,0,0,7,0,4,10,1
4000,38107,LHHlrNsXCuatY288NK6FIa7kJtq4Rtqs,bWdj2GDclj5ofokWjzoa5jAwMkxCykd6,8,5,4,0,3,0,8,0,20,2.857142857142857,1,0.0,0,4,0,3,5,0,0,8,0,7,13,1
4001,38111,QRq9SneqdOEdNrPCbzGfNOJsUrpMzzSX,bWdj2GDclj5ofokWjzoa5jAwMkxCykd6,6,2,1,0,1,1,5,1,11,1.5714285714285714,2,0.0,0,1,0,1,2,1,0,5,1,2,9,1
4002,38123,c0naQwXHS50DG3yNNBzMC8iE3KoRWTjm,SpATywNh6bZuzm8s1ceuBUnMUAeoAHHw,7,1,1,0,1,0,4,1,8,1.1428571428571428,1,0.0,0,1,0,1,1,0,0,4,1,2,6,1
4003,38140,xGWjos5nKrn7rxQEQkV1V6pBI2rS4Q4S,SpATywNh6bZuzm8s1ceuBUnMUAeoAHHw,15,28,17,18,8,10,3,0,84,12.0,2,0.0,7,17,15,8,21,10,3,3,0,47,37,1
4004,38144,0Hl4WpPV6z0OC8rO0L3mZy6harAUBUs7,G8EPVSXsOYB5YQWZGiz1aVq5Pgr2GrQu,75,104,22,178,14,5,26,1,350,50.0,10,0.0,35,22,143,14,69,5,35,26,1,214,136,1
4005,38147,OHOHfGJUvl8C8rOynV86vKj0FrD2jzFO,SpATywNh6bZuzm8s1ceuBUnMUAeoAHHw,36,50,6,47,3,3,25,0,134,19.142857142857142,8,0.0,11,6,40,3,39,3,7,25,0,60,74,1
4006,38154,qazSXcMxbAaqtIZJoNDUrPRsgwDYZFDz,SpATywNh6bZuzm8s1ceuBUnMUAeoAHHw,1,0,0,0,0,0,1,0,1,0.14285714285714285,1,0.0,0,0,0,0,0,0,0,1,0,0,1,1
4007,38155,cqdnmjbJq0lDv2xgeKuzXqVr5xQytWr0,A3fsA9Zfv1X2fVEQhTw51lKENdNrEqT3,6,4,2,0,1,0,2,0,9,1.2857142857142858,1,0.0,0,2,0,1,4,0,0,2,0,3,6,1
4008,38157,tHNSnLtZK1vGs5MVrEoD7S1mcW3GtFm4,SpATywNh6bZuzm8s1ceuBUnMUAeoAHHw,30,44,22,26,9,2,4,0,107,15.285714285714286,3,0.0,5,22,25,9,39,2,1,4,0,61,46,0
4009,38170,vs0vqlNXzuHsqVxOsB15kGfpvGf2pUt3,SpATywNh6bZuzm8s1ceuBUnMUAeoAHHw,21,73,37,24,6,0,13,0,153,21.857142857142858,10,0.0,21,37,24,6,52,0,0,13,0,88,65,0
4010,38176,c59GF0I0pecGycS0yL4PRG9aMLNUIigo,bWdj2GDclj5ofokWjzoa5jAwMkxCykd6,5,2,1,0,1,0,3,0,7,1.0,2,0.0,0,1,0,1,2,0,0,3,0,2,5,1
4011,38187,SX4dmJ5a5AfJLGZkCiiWab293xeIyxbW,SpATywNh6bZuzm8s1ceuBUnMUAeoAHHw,39,119,17,38,10,9,44,4,241,34.42857142857143,13,0.0,12,17,33,10,107,9,5,44,4,72,169,0
4012,38192,PfM2UIipqAa1BYASMdmivESfQH5kpXct,RXDvfPUBYFlVdlueBFbLW0mhhAyGEqpt,8,5,4,0,2,0,1,0,12,1.7142857142857142,1,0.0,0,4,0,2,5,0,0,1,0,6,6,0
4013,38201,hUScWllYUJ1urcx9IQ6nI2SqodbYOaw3,SpATywNh6bZuzm8s1ceuBUnMUAeoAHHw,14,23,8,21,5,0,2,0,59,8.428571428571429,2,0.0,8,8,17,5,15,0,4,2,0,38,21,0
4014,38203,fZom2mtwZsSiSJuSBhugfgY0ABzNEmyV,G8EPVSXsOYB5YQWZGiz1aVq5Pgr2GrQu,13,25,13,0,9,2,4,0,53,7.571428571428571,3,0.0,9,13,0,9,16,2,0,4,0,31,22,1
4015,38206,kKH4olslIcMX5RimtmBANWk2T6CuD4cI,G8EPVSXsOYB5YQWZGiz1aVq5Pgr2GrQu,16,11,4,55,2,0,12,0,84,12.0,2,0.0,1,4,46,2,10,0,9,12,0,53,31,1
4016,38219,EwpbggvNdZkeSTjdG48aEltlJYavm02s,bWdj2GDclj5ofokWjzoa5jAwMkxCykd6,7,14,1,0,0,0,3,0,18,2.5714285714285716,2,0.0,1,1,0,0,13,0,0,3,0,2,16,0
4017,38243,dwm6PFLf21BfXk9L9RgwIu033moNrMaZ,A3fsA9Zfv1X2fVEQhTw51lKENdNrEqT3,2,0,0,0,0,0,2,0,2,0.2857142857142857,1,0.0,0,0,0,0,0,0,0,2,0,0,2,1
4018,38245,9d3FbHjuwecHssUlcCF17pB1YrxPmjAd,SpATywNh6bZuzm8s1ceuBUnMUAeoAHHw,5,2,1,0,1,0,2,0,6,0.8571428571428571,1,0.0,0,1,0,1,2,0,0,2,0,2,4,1
4019,38252,S2i0VW7GN0ACeCnuAPN00XONM8w8kvsN,G8EPVSXsOYB5YQWZGiz1aVq5Pgr2GrQu,108,173,83,209,14,12,36,8,535,76.42857142857143,8,0.0,40,83,156,14,133,12,53,36,8,293,242,0
4020,38255,EwpbggvNdZkeSTjdG48aEltlJYavm02s,RXDvfPUBYFlVdlueBFbLW0mhhAyGEqpt,1,0,0,0,0,0,1,0,1,0.14285714285714285,1,0.0,0,0,0,0,0,0,0,1,0,0,1,1
4021,38261,h2cFTJnPj8CTdq0hhUdrEDtmsY30xXQA,G8EPVSXsOYB5YQWZGiz1aVq5Pgr2GrQu,10,20,5,2,1,0,5,0,33,4.714285714285714,3,0.0,6,5,1,1,14,0,1,5,0,13,20,1
4022,38264,DPr3Hy8387gfJi0Jc3ohxKBzY0mvhH1G,SpATywNh6bZuzm8s1ceuBUnMUAeoAHHw,31,44,20,30,5,34,15,2,150,21.428571428571427,8,0.0,17,20,28,5,27,34,2,15,2,70,80,0
4023,38267,xnr1pqResnWIFBWHoMthHT4GwMr3vBWt,SpATywNh6bZuzm8s1ceuBUnMUAeoAHHw,15,23,7,11,3,0,5,0,49,7.0,1,0.0,13,7,11,3,10,0,0,5,0,34,15,1
4024,38269,gzTBwYPoQwnODJJ2vedsUKp2EoGao5Fz,bWdj2GDclj5ofokWjzoa5jAwMkxCykd6,10,16,1,0,1,1,10,0,29,4.142857142857143,6,0.0,1,1,0,1,15,1,0,10,0,3,26,1
4025,38312,PzUJiLnP9HZJxQE6JmMTkx1KTzCMtAvI,A3fsA9Zfv1X2fVEQhTw51lKENdNrEqT3,1,0,0,0,0,0,1,0,1,0.14285714285714285,1,0.0,0,0,0,0,0,0,0,1,0,0,1,1
4026,38319,mGGeZkXtXipHfCgx75xnWUmx7JTil5yZ,SpATywNh6bZuzm8s1ceuBUnMUAeoAHHw,1,0,0,0,0,0,1,0,1,0.14285714285714285,1,0.0,0,0,0,0,0,0,0,1,0,0,1,1
4027,38330,ooLh9t6oSyJHSmVF4HH7sDMAh5QMFRua,bWdj2GDclj5ofokWjzoa5jAwMkxCykd6,7,10,1,0,0,2,15,2,30,4.285714285714286,3,0.0,1,1,0,0,9,2,0,15,2,2,28,1
4028,38342,C8IOBAC7DRHGJ1rz7pC1Kh8zvUK3Uruf,bWdj2GDclj5ofokWjzoa5jAwMkxCykd6,5,2,1,0,1,0,2,0,6,0.8571428571428571,1,0.0,0,1,0,1,2,0,0,2,0,2,4,1
4029,38345,skcEk7TV3jhSAknl5Kr7UawZFeqJNMzy,SpATywNh6bZuzm8s1ceuBUnMUAeoAHHw,11,13,8,0,6,0,4,0,31,4.428571428571429,3,0.0,0,8,0,6,13,0,0,4,0,14,17,1
4030,38348,DTsOT0NTIRutfokoKq4yB8bQe3U1fEsD,SpATywNh6bZuzm8s1ceuBUnMUAeoAHHw,37,55,21,20,10,21,8,1,136,19.428571428571427,4,0.0,22,21,20,10,33,21,0,8,1,73,63,0
4031,38362,ngiOS4CfHKeFfCKjGfQvFpxE4ckVZ4zO,A3fsA9Zfv1X2fVEQhTw51lKENdNrEqT3,9,4,3,0,3,0,2,0,12,1.7142857142857142,1,0.0,0,3,0,3,4,0,0,2,0,6,6,1
4032,38369,P4MCLwt6pxkkQ1f3WWeAp7xsGAazOtsm,SpATywNh6bZuzm8s1ceuBUnMUAeoAHHw,4,2,1,0,1,0,3,0,7,1.0,2,0.0,0,1,0,1,2,0,0,3,0,2,5,1
4033,38371,a3kUr1OVNVUUdkmJCjmwPQMV5PtCkdEz,SpATywNh6bZuzm8s1ceuBUnMUAeoAHHw,2,0,0,0,0,0,2,0,2,0.2857142857142857,1,0.0,0,0,0,0,0,0,0,2,0,0,2,1
4034,38377,qkZ3BaC1M1zrdLJXoQVUnE0RxlFverb8,A3fsA9Zfv1X2fVEQhTw51lKENdNrEqT3,27,45,14,28,5,1,14,1,108,15.428571428571429,3,0.0,2,14,22,5,43,1,6,14,1,43,65,1
4035,38391,MAkHN0TS4uaTPgKLso4eQ3LTCDiU28De,bWdj2GDclj5ofokWjzoa5jAwMkxCykd6,13,32,16,0,10,1,15,0,74,10.571428571428571,3,0.0,2,16,0,10,30,1,0,15,0,28,46,1
4036,38393,NgT4xv3zS3UyiRdDnPLyxI49HQKeMn2D,G8EPVSXsOYB5YQWZGiz1aVq5Pgr2GrQu,62,117,6,118,8,14,33,2,298,42.57142857142857,6,0.0,56,6,87,8,61,14,31,33,2,157,141,1
4037,38407,JJYEr1YA7SClhqsLz61VElUYdghcCxlW,RXDvfPUBYFlVdlueBFbLW0mhhAyGEqpt,1,0,0,0,0,0,1,0,1,0.14285714285714285,1,0.0,0,0,0,0,0,0,0,1,0,0,1,1
4038,38420,YAaB5kbzMpno3yyQhEjSC43PC6r4FUut,bWdj2GDclj5ofokWjzoa5jAwMkxCykd6,3,2,1,0,0,1,4,0,8,1.1428571428571428,1,0.0,0,1,0,0,2,1,0,4,0,1,7,1
4039,38425,bIGq7A9r0Y0NLU65d3TOWeEFWRfABEv0,SpATywNh6bZuzm8s1ceuBUnMUAeoAHHw,17,18,9,14,3,0,13,1,58,8.285714285714286,1,0.0,7,9,12,3,11,0,2,13,1,31,27,1
4040,38431,gjPSUf8VbxmvyczDJCPomXU7IV6RTx1x,SpATywNh6bZuzm8s1ceuBUnMUAeoAHHw,17,28,7,10,3,23,25,4,100,14.285714285714286,2,0.0,10,7,9,3,18,23,1,25,4,29,71,1
4041,38447,dNx7yBBYuWpRM4BeMNLD1yOnUwcueGfB,bWdj2GDclj5ofokWjzoa5jAwMkxCykd6,11,25,5,40,4,5,13,1,93,13.285714285714286,2,0.0,5,5,39,4,20,5,1,13,1,53,40,0
4042,38453,oBHdxxTFsPNGTsDRAnTRpoi8FODO2mxr,SpATywNh6bZuzm8s1ceuBUnMUAeoAHHw,7,3,2,0,2,0,2,0,9,1.2857142857142858,1,0.0,0,2,0,2,3,0,0,2,0,4,5,1
4043,38454,dNx7yBBYuWpRM4BeMNLD1yOnUwcueGfB,SpATywNh6bZuzm8s1ceuBUnMUAeoAHHw,15,31,6,17,4,0,10,0,68,9.714285714285714,2,0.0,4,6,15,4,27,0,2,10,0,29,39,0
4044,38480,Y0R5Jnk5aIi2yBcZ9pxBzdem2y9Lpgok,SpATywNh6bZuzm8s1ceuBUnMUAeoAHHw,10,7,1,0,1,1,6,0,16,2.2857142857142856,1,0.0,0,1,0,1,7,1,0,6,0,2,14,1
4045,38494,nkWrffpo6kobU01lUWepcu6aQb60BdxH,SpATywNh6bZuzm8s1ceuBUnMUAeoAHHw,15,24,14,7,7,0,7,0,59,8.428571428571429,3,0.0,5,14,7,7,19,0,0,7,0,33,26,1
4046,38496,fd1NhQTFxl8TsBhiRc4F6bEwrFxQh7qC,SpATywNh6bZuzm8s1ceuBUnMUAeoAHHw,10,5,4,0,2,0,3,0,14,2.0,1,0.0,0,4,0,2,5,0,0,3,0,6,8,1
4047,38503,KGORZAfEVmjDZyD0eVVyErKdl89uylGc,G8EPVSXsOYB5YQWZGiz1aVq5Pgr2GrQu,5,4,0,0,0,0,1,0,5,0.7142857142857143,1,0.0,0,0,0,0,4,0,0,1,0,0,5,1
4048,38505,Dy0I4gbpbRtwh6YDRhpgGBLDEGUYJgO6,SpATywNh6bZuzm8s1ceuBUnMUAeoAHHw,14,23,11,0,2,2,6,1,45,6.428571428571429,2,0.0,3,11,0,2,20,2,0,6,1,16,29,1
4049,38514,88mqKZu0uTbuMx2E6ZRqhvo4tmoL4qfn,SpATywNh6bZuzm8s1ceuBUnMUAeoAHHw,26,31,3,32,2,12,23,1,104,14.857142857142858,4,0.0,9,3,26,2,22,12,6,23,1,40,64,1
4050,38520,WRiHtWJX61VUGyAGQFSHJ3czdrgqxeQW,RXDvfPUBYFlVdlueBFbLW0mhhAyGEqpt,3,0,0,0,0,5,7,0,12,1.7142857142857142,6,0.0,0,0,0,0,0,5,0,7,0,0,12,1
4051,38525,859jT8mbwD5IkofIqzzz6ylJUi1ZwOt3,SpATywNh6bZuzm8s1ceuBUnMUAeoAHHw,18,31,14,10,9,21,12,1,98,14.0,3,0.0,9,14,9,9,22,21,1,12,1,41,57,1
4052,38532,8SZ4vKq1qHRfFJV3A51uH46l0c4FRvvR,SpATywNh6bZuzm8s1ceuBUnMUAeoAHHw,21,38,22,13,10,2,17,2,104,14.857142857142858,7,0.0,9,22,12,10,29,2,1,17,2,53,51,0
4053,38538,oBHdxxTFsPNGTsDRAnTRpoi8FODO2mxr,RXDvfPUBYFlVdlueBFbLW0mhhAyGEqpt,1,0,0,0,0,0,1,0,1,0.14285714285714285,1,0.0,0,0,0,0,0,0,0,1,0,0,1,1
4054,38541,uarVJhEs6XLW7Dw1D7iBgEK6zPe65WwX,bWdj2GDclj5ofokWjzoa5jAwMkxCykd6,1,0,0,0,0,0,1,0,1,0.14285714285714285,1,0.0,0,0,0,0,0,0,0,1,0,0,1,1
4055,38545,rarzYMzRoT8HAQOSSilddy5adopj22jf,A3fsA9Zfv1X2fVEQhTw51lKENdNrEqT3,8,7,0,0,0,0,1,0,8,1.1428571428571428,1,0.0,0,0,0,0,7,0,0,1,0,0,8,1
4056,38550,Xq1kPqflDNgXwQ2pEniNYUjMpkVzPp1m,A3fsA9Zfv1X2fVEQhTw51lKENdNrEqT3,36,31,16,50,13,2,4,0,116,16.571428571428573,4,0.0,3,16,48,13,28,2,2,4,0,80,36,1
4057,38551,UKG5GO5JWRjFVRMggOgvDIxPiEZzBxAO,bWdj2GDclj5ofokWjzoa5jAwMkxCykd6,5,7,2,0,1,0,2,0,12,1.7142857142857142,2,0.0,0,2,0,1,7,0,0,2,0,3,9,1
4058,38554,tajSblOKlQlXdpIXIOLLEJCHn56vIOfT,bWdj2GDclj5ofokWjzoa5jAwMkxCykd6,21,74,27,80,13,66,32,0,292,41.714285714285715,8,0.0,14,27,70,13,60,66,10,32,0,124,168,1
4059,38556,rajcXZ0kL5d9yXQIc9HHtBEyfRs8vn2R,G8EPVSXsOYB5YQWZGiz1aVq5Pgr2GrQu,6,4,1,0,1,0,3,0,9,1.2857142857142858,2,0.0,0,1,0,1,4,0,0,3,0,2,7,1
4060,38587,NeX0NKDgti39PYJeedkcSvEJfGuCFAhK,SpATywNh6bZuzm8s1ceuBUnMUAeoAHHw,11,5,3,0,3,0,5,0,16,2.2857142857142856,1,0.0,1,3,0,3,4,0,0,5,0,7,9,1
4061,38596,spd8M0wss3Tbv0YQ5WcIllIwTexcZnnW,SpATywNh6bZuzm8s1ceuBUnMUAeoAHHw,27,79,7,38,3,0,15,0,142,20.285714285714285,10,0.0,7,7,33,3,72,0,5,15,0,50,92,0
4062,38602,KbRlzY47exomwt4drbIiBF6s4vNevAUk,A3fsA9Zfv1X2fVEQhTw51lKENdNrEqT3,40,21,16,60,12,0,4,0,113,16.142857142857142,1,0.0,2,16,59,12,19,0,1,4,0,89,24,1
4063,38605,VPjMKah4KBMlWaK4uQInEcrWLVtwuYU3,SpATywNh6bZuzm8s1ceuBUnMUAeoAHHw,8,6,4,0,1,0,8,1,20,2.857142857142857,2,0.0,0,4,0,1,6,0,0,8,1,5,15,1
4064,38610,qatSZvztGH03ZmpAnP6syWYERxxmPTgm,SpATywNh6bZuzm8s1ceuBUnMUAeoAHHw,8,5,4,0,3,0,5,0,17,2.4285714285714284,1,0.0,0,4,0,3,5,0,0,5,0,7,10,1
4065,38618,6zUyeP7S7jGCTdu7QvSdhvgcWdRlZ9vk,A3fsA9Zfv1X2fVEQhTw51lKENdNrEqT3,11,14,5,0,3,0,13,0,35,5.0,2,0.0,0,5,0,3,14,0,0,13,0,8,27,1
4066,38621,C800geUBh3GYBhoh4cW6ReKUGj5LAMGi,SpATywNh6bZuzm8s1ceuBUnMUAeoAHHw,35,44,5,24,5,53,43,0,174,24.857142857142858,8,0.0,5,5,23,5,39,53,1,43,0,38,136,0
4067,38623,aKS3VkxSVtZSsON0tlb1uUJK6seiU1iY,SpATywNh6bZuzm8s1ceuBUnMUAeoAHHw,16,26,14,21,6,0,9,5,81,11.571428571428571,3,0.0,6,14,17,6,20,0,4,9,5,43,38,1
4068,38625,Na52PtAqm4VlTMUv1OPLGNjij0a5votC,A3fsA9Zfv1X2fVEQhTw51lKENdNrEqT3,18,25,12,0,6,15,12,0,70,10.0,3,0.0,0,12,0,6,25,15,0,12,0,18,52,1
4069,38636,xbw9nCFRWInH7KOVpMVJ0cKpswH8IEpv,SpATywNh6bZuzm8s1ceuBUnMUAeoAHHw,13,20,4,18,0,2,9,0,53,7.571428571428571,3,0.0,2,4,16,0,18,2,2,9,0,22,31,0
4070,38637,aYZOvavq8vAsMixc171e3LCkk7Ck4eQv,SpATywNh6bZuzm8s1ceuBUnMUAeoAHHw,2,0,0,0,0,0,2,0,2,0.2857142857142857,1,0.0,0,0,0,0,0,0,0,2,0,0,2,1
4071,38649,I6Zefk3suQV0ULhgPf2DN9gGAf2yKSKv,SpATywNh6bZuzm8s1ceuBUnMUAeoAHHw,10,17,6,0,0,2,6,0,31,4.428571428571429,2,0.0,0,6,0,0,17,2,0,6,0,6,25,1
4072,38668,NjnyUEkQdbuj3M7NhvY8iDqgWMA59DIH,SpATywNh6bZuzm8s1ceuBUnMUAeoAHHw,14,11,7,3,5,2,7,1,36,5.142857142857143,2,0.0,2,7,3,5,9,2,0,7,1,17,19,1
4073,38670,dg0Zm4MjeckxnEiOKa4Gh8nunN8SFI0L,SpATywNh6bZuzm8s1ceuBUnMUAeoAHHw,4,2,1,0,0,0,2,0,5,0.7142857142857143,1,0.0,0,1,0,0,2,0,0,2,0,1,4,1
4074,38676,aWfbena9lEo41V5W87oDDgjvcz4pLKtN,SpATywNh6bZuzm8s1ceuBUnMUAeoAHHw,30,39,16,25,9,1,18,2,110,15.714285714285714,4,0.0,14,16,22,9,25,1,3,18,2,61,49,0
4075,38679,5LOlerEFHf0UNcpvuhvEHGBh6ERlMDur,G8EPVSXsOYB5YQWZGiz1aVq5Pgr2GrQu,9,7,3,0,1,5,9,0,25,3.5714285714285716,4,0.0,0,3,0,1,7,5,0,9,0,4,21,0
4076,38685,FncubT1DgrtJxWo1YRhPHqwgNARiG5Jv,SpATywNh6bZuzm8s1ceuBUnMUAeoAHHw,33,64,3,36,2,0,13,0,118,16.857142857142858,6,0.0,16,3,35,2,48,0,1,13,0,56,62,0
4077,38687,RfCEa3pRuKLOxQiUZgZZMFg3JntXDg1m,SpATywNh6bZuzm8s1ceuBUnMUAeoAHHw,13,28,15,0,9,0,11,0,63,9.0,4,0.0,0,15,0,9,28,0,0,11,0,24,39,0
4078,38688,spd8M0wss3Tbv0YQ5WcIllIwTexcZnnW,A3fsA9Zfv1X2fVEQhTw51lKENdNrEqT3,6,11,0,0,0,0,2,0,13,1.8571428571428572,3,0.0,0,0,0,0,11,0,0,2,0,0,13,1
4079,38692,ktbF3sxXQk0MrToCOKFGvH2bCmfBVgYK,G8EPVSXsOYB5YQWZGiz1aVq5Pgr2GrQu,39,72,23,6,19,1,9,0,130,18.571428571428573,4,0.0,19,23,4,19,53,1,2,9,0,65,65,0
4080,38703,bDOMCQV7nFdKo0pDqOPr3ECLpgkdBCSt,bWdj2GDclj5ofokWjzoa5jAwMkxCykd6,10,9,2,0,1,1,6,1,20,2.857142857142857,2,0.0,0,2,0,1,9,1,0,6,1,3,17,1
4081,38704,LbhBqPcHsayzBPTM5h5jHXG3yJonlt5t,A3fsA9Zfv1X2fVEQhTw51lKENdNrEqT3,44,36,30,72,22,8,14,0,182,26.0,1,0.0,1,30,63,22,35,8,9,14,0,116,66,1
4082,38708,QWAnJ98MRtHXbl78XXr3UpScat4E7MnZ,SpATywNh6bZuzm8s1ceuBUnMUAeoAHHw,24,34,10,23,4,0,5,0,76,10.857142857142858,3,0.0,10,10,23,4,24,0,0,5,0,47,29,0
4083,38719,UIE935UirfemaybvWwRc5Sijo8VfPEYO,SpATywNh6bZuzm8s1ceuBUnMUAeoAHHw,7,6,4,0,2,0,5,0,17,2.4285714285714284,2,0.0,0,4,0,2,6,0,0,5,0,6,11,1
4084,38757,sEqqQzJgfFwEJ59pjhsH9YLQDd58mQLD,SpATywNh6bZuzm8s1ceuBUnMUAeoAHHw,11,34,2,0,1,0,7,0,44,6.285714285714286,5,0.0,5,2,0,1,29,0,0,7,0,8,36,1
4085,38759,JBGQp737lLGmxKZ5ElVyvCkZ4zEqlLXt,SpATywNh6bZuzm8s1ceuBUnMUAeoAHHw,5,3,0,0,0,0,2,0,5,0.7142857142857143,1,0.0,0,0,0,0,3,0,0,2,0,0,5,1
4086,38769,OygU41dc8lyatpKc4JEBkP0ni21xzfvB,SpATywNh6bZuzm8s1ceuBUnMUAeoAHHw,44,51,27,34,13,0,21,0,146,20.857142857142858,8,0.0,8,27,31,13,43,0,3,21,0,79,67,0
4087,38785,QpfK7z5GdRL9KsohkHQ7AWpk99tKhwdp,SpATywNh6bZuzm8s1ceuBUnMUAeoAHHw,12,25,14,9,0,0,6,0,54,7.714285714285714,4,0.0,6,14,7,0,19,0,2,6,0,27,27,1
4088,38808,xy8Pu3m8OtRxFLhTfix6XvZn0H18zyZc,G8EPVSXsOYB5YQWZGiz1aVq5Pgr2GrQu,11,19,1,0,1,0,7,0,28,4.0,4,0.0,0,1,0,1,19,0,0,7,0,2,26,0
4089,38811,T6EWQ7jVP89JlHzj41KN1gEtGYevpSQM,SpATywNh6bZuzm8s1ceuBUnMUAeoAHHw,46,68,36,58,16,0,13,0,191,27.285714285714285,9,0.0,20,36,49,16,48,0,9,13,0,121,70,0
4090,38815,RfVW0lNKrf9tzkgd827lLFW37SMuSXSa,SpATywNh6bZuzm8s1ceuBUnMUAeoAHHw,14,22,1,12,1,0,2,0,38,5.428571428571429,2,0.0,2,1,12,1,20,0,0,2,0,16,22,1
4091,38825,t8zwYEwnyPi1IDBby2HgJ3IlSwhRkmGy,SpATywNh6bZuzm8s1ceuBUnMUAeoAHHw,15,30,1,21,0,25,12,1,90,12.857142857142858,4,0.0,10,1,18,0,20,25,3,12,1,29,61,0
4092,38826,RLA6GL5vSBJRKc1kwf2CaEaK6FOv9roZ,RXDvfPUBYFlVdlueBFbLW0mhhAyGEqpt,27,52,6,0,6,1,7,2,74,10.571428571428571,4,0.0,3,6,0,6,49,1,0,7,2,15,59,0
4093,38827,i5nCgFIHY6Zcmf0CbMZLC0bzGv6djmqm,G8EPVSXsOYB5YQWZGiz1aVq5Pgr2GrQu,7,6,1,0,1,1,7,0,16,2.2857142857142856,1,0.0,0,1,0,1,6,1,0,7,0,2,14,1
4094,38833,v4HIYrR0I8FWtTlaAHD463q83gEr8oUl,RXDvfPUBYFlVdlueBFbLW0mhhAyGEqpt,22,18,11,12,4,1,5,0,51,7.285714285714286,2,0.0,2,11,12,4,16,1,0,5,0,29,22,1
4095,38849,FnrvxXFGCqAMeXxoMCc55xlzH80Et8mi,SpATywNh6bZuzm8s1ceuBUnMUAeoAHHw,7,1,1,0,1,1,5,0,9,1.2857142857142858,1,0.0,0,1,0,1,1,1,0,5,0,2,7,1
4096,38860,aSq9IJ4ZfLUbnD7QSBT8oeA7EtoTrGal,bWdj2GDclj5ofokWjzoa5jAwMkxCykd6,17,31,8,0,8,23,8,1,79,11.285714285714286,4,0.0,0,8,0,8,31,23,0,8,1,16,63,1
4097,38906,U6b5ShGjMWYggq6FsoytPW1feWorMDiT,SpATywNh6bZuzm8s1ceuBUnMUAeoAHHw,1,0,0,0,0,0,1,0,1,0.14285714285714285,1,0.0,0,0,0,0,0,0,0,1,0,0,1,1
4098,38912,35Qckp7squ2ifhCEFcVeQZHmfUAJiaXc,SpATywNh6bZuzm8s1ceuBUnMUAeoAHHw,46,62,33,49,14,18,24,4,204,29.142857142857142,4,0.0,19,33,40,14,43,18,9,24,4,106,98,1
4099,38922,nV21XWIQ3aHCYYV7hPNmU8NbA6rAppIq,G8EPVSXsOYB5YQWZGiz1aVq5Pgr2GrQu,7,6,0,0,0,0,4,0,10,1.4285714285714286,1,0.0,0,0,0,0,6,0,0,4,0,0,10,1
4100,38923,MuiBmNrQSuFDjsexIRPrYiU9583FwFbE,SpATywNh6bZuzm8s1ceuBUnMUAeoAHHw,17,39,18,15,7,15,13,2,109,15.571428571428571,1,0.0,9,18,12,7,30,15,3,13,2,46,63,1
4101,38928,LKo3yUnM07K4Le8KPm2nARMox6nb3a03,SpATywNh6bZuzm8s1ceuBUnMUAeoAHHw,10,12,5,0,2,1,7,1,28,4.0,2,0.0,5,5,0,2,7,1,0,7,1,12,16,1
4102,38940,IXJChwgShKb71VXFYaM4KTehE3VXk7Kg,bWdj2GDclj5ofokWjzoa5jAwMkxCykd6,8,3,2,0,2,0,3,0,10,1.4285714285714286,1,0.0,1,2,0,2,2,0,0,3,0,5,5,1
4103,38942,VrBnKyI7RjgXozKQXJ2DSbj5Gvev22L0,SpATywNh6bZuzm8s1ceuBUnMUAeoAHHw,26,27,15,28,8,0,6,0,84,12.0,4,0.0,6,15,28,8,21,0,0,6,0,57,27,0
4104,38944,N1N2VoCQ3DCM7YknWLib5UEHyI2wyiAp,A3fsA9Zfv1X2fVEQhTw51lKENdNrEqT3,6,3,2,0,1,0,6,0,12,1.7142857142857142,1,0.0,0,2,0,1,3,0,0,6,0,3,9,1
4105,38954,hWagcbwGHP337RS0iBSta7Eh6v3OAnlN,SpATywNh6bZuzm8s1ceuBUnMUAeoAHHw,17,28,12,15,3,5,12,0,75,10.714285714285714,5,0.0,11,12,14,3,17,5,1,12,0,40,35,1
4106,38955,BE4JaFadHavW9r5xCXpj3M456eZAgaG6,SpATywNh6bZuzm8s1ceuBUnMUAeoAHHw,17,32,10,15,4,1,11,0,73,10.428571428571429,3,0.0,13,10,12,4,19,1,3,11,0,39,34,1
4107,38960,csUQD8kl5B2qOhCgBpUdVV3uOWaYGbyH,A3fsA9Zfv1X2fVEQhTw51lKENdNrEqT3,17,29,1,0,1,1,9,0,41,5.857142857142857,3,0.0,1,1,0,1,28,1,0,9,0,3,38,1
4108,38969,qP7HUxoCtXsXPUg6TOciLBwLDEqZxGLw,SpATywNh6bZuzm8s1ceuBUnMUAeoAHHw,5,3,1,0,1,0,2,0,7,1.0,1,0.0,0,1,0,1,3,0,0,2,0,2,5,1
4109,38976,n7mMvLvnaxc6y3IIFJpmSNUncj3jx1Ev,RXDvfPUBYFlVdlueBFbLW0mhhAyGEqpt,7,2,2,0,2,1,4,2,13,1.8571428571428572,1,0.0,0,2,0,2,2,1,0,4,2,4,9,1
4110,38984,Np3UGgyqJRbdjHAs6eqMYNuWuEJ67rAv,bWdj2GDclj5ofokWjzoa5jAwMkxCykd6,29,38,19,86,7,0,9,0,159,22.714285714285715,5,0.0,5,19,79,7,33,0,7,9,0,110,49,1
4111,38995,7nUtazUwwSnnXJpIKdQBJGpXV6Po42DQ,A3fsA9Zfv1X2fVEQhTw51lKENdNrEqT3,15,17,1,0,0,0,22,1,41,5.857142857142857,3,0.0,0,1,0,0,17,0,0,22,1,1,40,1
4112,39016,79QvR9MowSFdJ7PRFtAx8omEmqdf2G66,A3fsA9Zfv1X2fVEQhTw51lKENdNrEqT3,8,5,1,0,1,0,6,0,13,1.8571428571428572,1,0.0,0,1,0,1,5,0,0,6,0,2,11,1
4113,39017,sUk3OLEiiNZtlo4krMYRLjkp5xwgbsPl,bWdj2GDclj5ofokWjzoa5jAwMkxCykd6,1,0,0,0,0,0,1,0,1,0.14285714285714285,1,0.0,0,0,0,0,0,0,0,1,0,0,1,1
4114,39020,sUk3OLEiiNZtlo4krMYRLjkp5xwgbsPl,A3fsA9Zfv1X2fVEQhTw51lKENdNrEqT3,1,0,0,0,0,0,2,0,2,0.2857142857142857,1,0.0,0,0,0,0,0,0,0,2,0,0,2,1
4115,39024,KbrQAfHN76lnV5ENpEesywqeBtzfyubO,SpATywNh6bZuzm8s1ceuBUnMUAeoAHHw,20,38,12,19,5,2,20,7,103,14.714285714285714,3,0.0,13,12,16,5,25,2,3,20,7,46,57,0
4116,39028,dNx7yBBYuWpRM4BeMNLD1yOnUwcueGfB,A3fsA9Zfv1X2fVEQhTw51lKENdNrEqT3,8,25,0,0,0,2,7,0,34,4.857142857142857,2,0.0,1,0,0,0,24,2,0,7,0,1,33,0
4117,39033,NfJMxVbS19N5X90YBDzzOQ6861Bhuidv,SpATywNh6bZuzm8s1ceuBUnMUAeoAHHw,11,6,4,0,3,0,4,1,18,2.5714285714285716,1,0.0,0,4,0,3,6,0,0,4,1,7,11,1
4118,39050,St7zx5CuqYmo3cCQEAdzvR5kNp3mDM9y,SpATywNh6bZuzm8s1ceuBUnMUAeoAHHw,32,42,23,26,9,19,24,1,144,20.571428571428573,6,0.0,11,23,22,9,31,19,4,24,1,65,79,0
4119,39051,PlXHYUUQO0ZfkxRdI3LzMqwSKR0cnJTo,bWdj2GDclj5ofokWjzoa5jAwMkxCykd6,1,0,0,0,0,0,1,0,1,0.14285714285714285,1,0.0,0,0,0,0,0,0,0,1,0,0,1,1
4120,39054,blGSSjmsnVQQQrRQxZJTHNQQUXxgUvBL,SpATywNh6bZuzm8s1ceuBUnMUAeoAHHw,16,33,14,0,7,3,15,1,73,10.428571428571429,5,0.0,8,14,0,7,25,3,0,15,1,29,44,0
4121,39057,l21tCwOolR7RD0CZyqRiNHHeEZC1D67K,SpATywNh6bZuzm8s1ceuBUnMUAeoAHHw,9,33,12,19,0,35,8,0,107,15.285714285714286,4,0.0,16,12,17,0,17,35,2,8,0,45,62,0
4122,39058,uGuE3FWo0NVfQumLjneHZr95vibdZhQe,SpATywNh6bZuzm8s1ceuBUnMUAeoAHHw,8,12,5,3,0,0,2,0,22,3.142857142857143,1,0.0,6,5,3,0,6,0,0,2,0,14,8,1
4123,39060,T4lMOZ9NGQ0RS4ue5IeZuDcW1ySIGZ9u,A3fsA9Zfv1X2fVEQhTw51lKENdNrEqT3,46,29,22,62,18,0,4,0,135,19.285714285714285,3,0.0,0,22,55,18,29,0,7,4,0,95,40,1
4124,39063,Zx1NMbt45yqUj8qZK11kDvFPzYX2jIZZ,SpATywNh6bZuzm8s1ceuBUnMUAeoAHHw,14,15,8,17,6,0,2,0,48,6.857142857142857,1,0.0,4,8,15,6,11,0,2,2,0,33,15,1
4125,39066,3SER276qaao5TSZqnt0y9TkdmkGTUUcO,SpATywNh6bZuzm8s1ceuBUnMUAeoAHHw,8,5,4,0,4,0,1,0,14,2.0,1,0.0,0,4,0,4,5,0,0,1,0,8,6,1
4126,39070,O3F8lLfHLYapLPkEvSdAfSwSBCUUJfWK,SpATywNh6bZuzm8s1ceuBUnMUAeoAHHw,4,0,0,0,0,1,4,1,6,0.8571428571428571,2,0.0,0,0,0,0,0,1,0,4,1,0,6,1
4127,39076,76j1Dib3EpIIxYpQXxI6VKhD3TOXoxhS,SpATywNh6bZuzm8s1ceuBUnMUAeoAHHw,16,31,3,12,1,4,15,0,66,9.428571428571429,2,0.0,9,3,12,1,22,4,0,15,0,25,41,1
4128,39090,fTfrYxb6cRWvjdEVjIZ7skF0s5uk6kd9,SpATywNh6bZuzm8s1ceuBUnMUAeoAHHw,49,72,38,47,17,1,29,1,205,29.285714285714285,13,0.0,7,38,43,17,65,1,4,29,1,105,100,0
4129,39094,tcrMObz5SSDCQNYpPsv4XWOxcLo3IPpN,SpATywNh6bZuzm8s1ceuBUnMUAeoAHHw,7,5,1,0,0,0,3,0,9,1.2857142857142858,2,0.0,0,1,0,0,5,0,0,3,0,1,8,1
4130,39102,7nUtazUwwSnnXJpIKdQBJGpXV6Po42DQ,SpATywNh6bZuzm8s1ceuBUnMUAeoAHHw,26,52,1,28,3,3,21,1,109,15.571428571428571,5,0.0,16,1,22,3,36,3,6,21,1,42,67,1
4131,39103,avH35RZc6PS7vBKogre4B3MKABAedNBF,bWdj2GDclj5ofokWjzoa5jAwMkxCykd6,7,22,12,0,2,0,13,0,49,7.0,5,0.0,1,12,0,2,21,0,0,13,0,15,34,1
4132,39107,Dzo4bt517HDNgh4yuxQj3WQVtnrvmG1A,SpATywNh6bZuzm8s1ceuBUnMUAeoAHHw,5,3,0,0,0,0,2,0,5,0.7142857142857143,1,0.0,0,0,0,0,3,0,0,2,0,0,5,1
4133,39109,zu1WAijSG0F2wy5x45xxD1w2SrPWGtuK,SpATywNh6bZuzm8s1ceuBUnMUAeoAHHw,6,1,1,0,1,0,3,0,6,0.8571428571428571,1,0.0,0,1,0,1,1,0,0,3,0,2,4,1
4134,39113,VvziK1FrzCcoikfRc0daxkE7fq3iFq0v,SpATywNh6bZuzm8s1ceuBUnMUAeoAHHw,31,47,22,30,9,2,18,0,128,18.285714285714285,4,0.0,16,22,26,9,31,2,4,18,0,73,55,0
4135,39125,BTjtyE8NjHRpreY21d7F2wNmadCPRKCQ,SpATywNh6bZuzm8s1ceuBUnMUAeoAHHw,7,8,5,0,2,0,4,0,19,2.7142857142857144,3,0.0,0,5,0,2,8,0,0,4,0,7,12,1
4136,39131,uJIh67cllxQLgAhipzdDZMEunDbuBxvF,RXDvfPUBYFlVdlueBFbLW0mhhAyGEqpt,60,64,46,124,27,17,42,20,340,48.57142857142857,6,0.0,14,46,116,27,50,17,8,42,20,203,137,0
4137,39136,srXgccav6ELo546oVIR7hwKdVqMPE3uB,SpATywNh6bZuzm8s1ceuBUnMUAeoAHHw,7,6,1,0,1,0,4,0,12,1.7142857142857142,2,0.0,0,1,0,1,6,0,0,4,0,2,10,1
4138,39139,sUk3OLEiiNZtlo4krMYRLjkp5xwgbsPl,G8EPVSXsOYB5YQWZGiz1aVq5Pgr2GrQu,1,0,0,0,0,0,1,0,1,0.14285714285714285,1,0.0,0,0,0,0,0,0,0,1,0,0,1,1
4139,39152,9LQKs2OgeSVzfrSEIBiyZg4jCEuAC01N,G8EPVSXsOYB5YQWZGiz1aVq5Pgr2GrQu,11,4,1,12,0,0,2,0,19,2.7142857142857144,1,0.0,1,1,11,0,3,0,1,2,0,13,6,1
4140,39158,V0auOwxD2tv59agygO0uPvKcU5ercMUa,SpATywNh6bZuzm8s1ceuBUnMUAeoAHHw,15,28,15,6,5,0,9,0,63,9.0,4,0.0,4,15,6,5,24,0,0,9,0,30,33,1
4141,39179,OGoPVjudSuGohkzHyvu7N6zC3RGML0mw,G8EPVSXsOYB5YQWZGiz1aVq5Pgr2GrQu,19,34,30,0,27,0,3,0,94,13.428571428571429,2,0.0,0,30,0,27,34,0,0,3,0,57,37,1
4142,39182,VIwJtaSOWWljnDL02ObzIxH4JeVU0QQ1,bWdj2GDclj5ofokWjzoa5jAwMkxCykd6,4,3,1,0,0,0,7,0,11,1.5714285714285714,3,0.0,0,1,0,0,3,0,0,7,0,1,10,1
4143,39201,45r4ENaVPqa3xBFTqWFkoJttz7HBM6Lb,SpATywNh6bZuzm8s1ceuBUnMUAeoAHHw,12,18,0,6,0,3,14,5,46,6.571428571428571,3,0.0,2,0,5,0,16,3,1,14,5,7,39,1
4144,39207,RmlyieNXfVrGM9LWnpgNxfz0WPjjsgcE,A3fsA9Zfv1X2fVEQhTw51lKENdNrEqT3,2,0,0,0,0,0,2,0,2,0.2857142857142857,1,0.0,0,0,0,0,0,0,0,2,0,0,2,1
4145,39216,qsBNE43NxZycap30DuQDyNDzs5hGI95w,SpATywNh6bZuzm8s1ceuBUnMUAeoAHHw,15,14,11,2,7,0,4,0,38,5.428571428571429,3,0.0,0,11,2,7,14,0,0,4,0,20,18,1
4146,39229,rue9XaVrhPMV8jlzLPRPLBsY7dTh1epz,SpATywNh6bZuzm8s1ceuBUnMUAeoAHHw,14,54,4,24,0,8,30,6,126,18.0,6,0.0,19,4,17,0,35,8,7,30,6,40,86,1
4147,39237,PNuCKnyPWCRVxphTjJ1pIquyKu0dURK7,SpATywNh6bZuzm8s1ceuBUnMUAeoAHHw,5,3,1,0,1,0,2,0,7,1.0,1,0.0,0,1,0,1,3,0,0,2,0,2,5,1
4148,39239,xmz4ffo3Xzh257Ul94Vh1nR04juD6y1C,SpATywNh6bZuzm8s1ceuBUnMUAeoAHHw,1,0,0,0,0,0,1,0,1,0.14285714285714285,1,0.0,0,0,0,0,0,0,0,1,0,0,1,1
4149,39241,krVsPdgfe85VvAQ2rdfbpjD89zMbnkR0,SpATywNh6bZuzm8s1ceuBUnMUAeoAHHw,12,14,6,6,4,1,3,0,34,4.857142857142857,2,0.0,6,6,5,4,8,1,1,3,0,21,13,1
4150,39243,gpyXT5iZHN1onXoVstOXZoiFizXraIkU,SpATywNh6bZuzm8s1ceuBUnMUAeoAHHw,11,16,8,0,3,2,6,1,36,5.142857142857143,2,0.0,5,8,0,3,11,2,0,6,1,16,20,1
4151,39246,fv07Mlz09PBHitYybJt9eVrK276xe9YI,SpATywNh6bZuzm8s1ceuBUnMUAeoAHHw,37,29,21,36,12,10,34,0,142,20.285714285714285,10,0.0,7,21,31,12,22,10,5,34,0,71,71,0
4152,39247,Qr5qzmAxo2eU7JvBgyKuPQuH3YgkGzii,SpATywNh6bZuzm8s1ceuBUnMUAeoAHHw,6,3,1,0,1,0,2,0,7,1.0,1,0.0,0,1,0,1,3,0,0,2,0,2,5,1
4153,39248,Lc5TZPB93C58CDuO8VjF5g6g9boxDaHr,RXDvfPUBYFlVdlueBFbLW0mhhAyGEqpt,1,0,0,0,0,0,1,0,1,0.14285714285714285,1,0.0,0,0,0,0,0,0,0,1,0,0,1,1
4154,39254,PATQ2JDuYcR1iRnRPNzs82w3vSQnScOh,RXDvfPUBYFlVdlueBFbLW0mhhAyGEqpt,1,0,0,0,0,0,1,0,1,0.14285714285714285,1,0.0,0,0,0,0,0,0,0,1,0,0,1,1
4155,39264,7ddOasUgoSwmcHs4lJMhvhalD4IA2urH,SpATywNh6bZuzm8s1ceuBUnMUAeoAHHw,25,107,0,45,0,35,20,3,210,30.0,4,0.0,53,0,34,0,54,35,11,20,3,87,123,0
4156,39274,2nLjdaVfmxwWCLw5sEI1KKYk7UXViPES,SpATywNh6bZuzm8s1ceuBUnMUAeoAHHw,14,19,1,6,2,0,3,0,31,4.428571428571429,3,0.0,5,1,6,2,14,0,0,3,0,14,17,0
4157,39277,G6iele4ho79nU5jQ1J8umZLq8jEFa9yN,A3fsA9Zfv1X2fVEQhTw51lKENdNrEqT3,12,5,3,0,3,10,5,1,27,3.857142857142857,2,0.0,0,3,0,3,5,10,0,5,1,6,21,1
4158,39293,59KrgCJlOEHQHzBNjsHoSd6BkQVArDrc,SpATywNh6bZuzm8s1ceuBUnMUAeoAHHw,8,8,4,0,2,0,2,0,16,2.2857142857142856,2,0.0,0,4,0,2,8,0,0,2,0,6,10,1
4159,39294,t43o0GKgntYeNvU3jSnPK3vOmS44e5N2,G8EPVSXsOYB5YQWZGiz1aVq5Pgr2GrQu,9,5,1,0,1,2,3,0,12,1.7142857142857142,1,0.0,0,1,0,1,5,2,0,3,0,2,10,1
4160,39296,R2cga9JVVM2tXEVs2saYswslfxAU4nMk,bWdj2GDclj5ofokWjzoa5jAwMkxCykd6,8,7,5,4,0,0,10,0,26,3.7142857142857144,4,0.0,2,5,4,0,5,0,0,10,0,11,15,1
4161,39301,ezp80xTAgodAGV4fsnNivfTneJn97tLE,RXDvfPUBYFlVdlueBFbLW0mhhAyGEqpt,70,67,38,134,17,6,17,0,279,39.857142857142854,6,0.0,11,38,125,17,56,6,9,17,0,191,88,0
4162,39312,5taolCXbi4GnZeqgvcKlHbiPurs2tpgr,SpATywNh6bZuzm8s1ceuBUnMUAeoAHHw,44,45,27,30,12,0,14,2,130,18.571428571428573,6,0.0,9,27,28,12,36,0,2,14,2,76,54,0
4163,39327,CnuwKGLCLbXYnPgy82VEWYA1NOiOhvr0,A3fsA9Zfv1X2fVEQhTw51lKENdNrEqT3,8,9,0,0,0,0,5,0,14,2.0,2,0.0,1,0,0,0,8,0,0,5,0,1,13,1
4164,39330,YY7yHizDn0UpGHVq4qoTfbulP3ev5TkC,SpATywNh6bZuzm8s1ceuBUnMUAeoAHHw,34,42,29,8,16,4,13,0,112,16.0,6,0.0,0,29,7,16,42,4,1,13,0,52,60,0
4165,39339,0QbAHgL1bHqgkC1CgcznJ6rPBigpeoia,SpATywNh6bZuzm8s1ceuBUnMUAeoAHHw,13,9,7,4,3,0,3,0,26,3.7142857142857144,2,0.0,0,7,4,3,9,0,0,3,0,14,12,1
4166,39349,8eqcmJf66b25Hdf1a71yMHA6gdhfVvDC,G8EPVSXsOYB5YQWZGiz1aVq5Pgr2GrQu,84,171,76,148,41,67,62,4,569,81.28571428571429,7,0.0,14,76,134,41,157,67,14,62,4,265,304,0
4167,39360,aiSJXiTI4iLjZWytdZmE5zydDNEQzaHj,A3fsA9Zfv1X2fVEQhTw51lKENdNrEqT3,2,0,0,0,0,0,2,0,2,0.2857142857142857,1,0.0,0,0,0,0,0,0,0,2,0,0,2,1
4168,39367,SgAa84aajahM2sd2hvCdYRfO014ocPV5,SpATywNh6bZuzm8s1ceuBUnMUAeoAHHw,36,71,30,22,13,27,20,1,184,26.285714285714285,7,0.0,18,30,21,13,53,27,1,20,1,82,102,0
4169,39368,OTHiy7CJ3gPgZvtv97Ds8YkrZ0bgVlAw,G8EPVSXsOYB5YQWZGiz1aVq5Pgr2GrQu,4,4,0,0,2,0,1,0,7,1.0,1,0.0,2,0,0,2,2,0,0,1,0,4,3,0
4170,39371,194jqOV6jnj4prH3N2CqRtpc9qi9vfln,A3fsA9Zfv1X2fVEQhTw51lKENdNrEqT3,6,7,0,0,0,0,7,0,14,2.0,2,0.0,1,0,0,0,6,0,0,7,0,1,13,1
4171,39372,aA47iNtja2lxoPqFPeHjI7xjYuTmvZjx,SpATywNh6bZuzm8s1ceuBUnMUAeoAHHw,15,20,8,18,3,1,5,0,55,7.857142857142857,4,0.0,8,8,15,3,12,1,3,5,0,34,21,1
4172,39377,M0xQooArrVMTCCgk3YkWTaBSUVldkFxi,SpATywNh6bZuzm8s1ceuBUnMUAeoAHHw,53,85,47,40,17,16,29,1,235,33.57142857142857,11,0.0,14,47,40,17,71,16,0,29,1,118,117,0
4173,39395,i2suUv0IuyNKOwhtAFmOMY1okBxszKdN,A3fsA9Zfv1X2fVEQhTw51lKENdNrEqT3,1,0,0,0,0,0,1,0,1,0.14285714285714285,1,0.0,0,0,0,0,0,0,0,1,0,0,1,1
4174,39397,dlNspelxxHXjwBoo8dpRx9m2ctqEqalr,G8EPVSXsOYB5YQWZGiz1aVq5Pgr2GrQu,7,5,2,0,2,0,3,0,12,1.7142857142857142,1,0.0,0,2,0,2,5,0,0,3,0,4,8,1
4175,39407,W7Pzvj7hPa3qVKdWluutDHqjcp3iIpAb,SpATywNh6bZuzm8s1ceuBUnMUAeoAHHw,42,81,41,48,24,1,15,1,211,30.142857142857142,11,0.0,31,41,43,24,50,1,5,15,1,139,72,0
4176,39418,nBG9NwFfkLReYPd7l4XLlLWLMjwV7w8K,A3fsA9Zfv1X2fVEQhTw51lKENdNrEqT3,5,4,1,0,1,0,2,0,8,1.1428571428571428,1,0.0,0,1,0,1,4,0,0,2,0,2,6,1
4177,39422,f6uLbTCHrR4TIVQHhrh2EEZiIDyLA7ZC,SpATywNh6bZuzm8s1ceuBUnMUAeoAHHw,1,0,0,0,0,0,1,0,1,0.14285714285714285,1,0.0,0,0,0,0,0,0,0,1,0,0,1,1
4178,39430,IAvuP4GGmvnNj3Zisz3jDfo3mSmXiJSb,bWdj2GDclj5ofokWjzoa5jAwMkxCykd6,5,9,0,0,0,0,10,0,19,2.7142857142857144,6,0.0,0,0,0,0,9,0,0,10,0,0,19,0
4179,39432,roGokqGBKtukTNGPdY1C2VEr66iWn5eT,G8EPVSXsOYB5YQWZGiz1aVq5Pgr2GrQu,7,7,4,0,2,0,5,0,18,2.5714285714285716,3,0.0,0,4,0,2,7,0,0,5,0,6,12,1
4180,39441,VsLOJ7Xi4SI8kpOP7KF7SoJJkHTp6ASm,SpATywNh6bZuzm8s1ceuBUnMUAeoAHHw,50,57,35,39,21,8,19,1,180,25.714285714285715,7,0.0,13,35,36,21,44,8,3,19,1,105,75,0
4181,39443,WxaYTMCI7yD8mE0osZVkZT9Orbo545LC,G8EPVSXsOYB5YQWZGiz1aVq5Pgr2GrQu,25,20,17,36,12,0,6,1,92,13.142857142857142,3,0.0,2,17,30,12,18,0,6,6,1,61,31,1
4182,39464,e2VhgSHwCVj2IYcx6wF0yjNoIULwWBq8,A3fsA9Zfv1X2fVEQhTw51lKENdNrEqT3,17,17,12,0,7,0,5,0,41,5.857142857142857,3,0.0,1,12,0,7,16,0,0,5,0,20,21,1
4183,39485,O9c4mZKt6PM5RxUHcRjnRJOfvI41UF2p,SpATywNh6bZuzm8s1ceuBUnMUAeoAHHw,31,57,25,26,10,5,24,2,149,21.285714285714285,6,0.0,22,25,21,10,35,5,5,24,2,78,71,0
4184,39486,7UOiW6Ks9JGRUR75AHoSTuRNGYY2xnnm,A3fsA9Zfv1X2fVEQhTw51lKENdNrEqT3,10,10,5,0,2,0,4,0,21,3.0,2,0.0,0,5,0,2,10,0,0,4,0,7,14,0
4185,39488,fxwFHQhfnCCHU83SJwJLBtmbCrCDlv3i,G8EPVSXsOYB5YQWZGiz1aVq5Pgr2GrQu,17,24,17,0,10,1,4,0,56,8.0,4,0.0,0,17,0,10,24,1,0,4,0,27,29,1
4186,39494,L8U7mZiX5tfpfUV7mFpP0znonqPA6G6R,SpATywNh6bZuzm8s1ceuBUnMUAeoAHHw,12,16,2,14,0,0,5,0,37,5.285714285714286,2,0.0,11,2,13,0,5,0,1,5,0,26,11,1
4187,39496,D55KBHzjFX6XlkQnUeIgoK6OnycKiatp,SpATywNh6bZuzm8s1ceuBUnMUAeoAHHw,7,6,3,0,2,0,2,0,13,1.8571428571428572,2,0.0,0,3,0,2,6,0,0,2,0,5,8,1
4188,39499,nBZt0s4EJwoCi0gxserLJGtn0aLrx1yc,A3fsA9Zfv1X2fVEQhTw51lKENdNrEqT3,26,40,9,18,7,0,16,0,90,12.857142857142858,7,0.0,0,9,15,7,40,0,3,16,0,31,59,1
4189,39504,1BLAPxf3lDzwOBM6NeFyerOFp0vZobfY,SpATywNh6bZuzm8s1ceuBUnMUAeoAHHw,21,35,20,2,9,1,8,0,75,10.714285714285714,5,0.0,5,20,2,9,30,1,0,8,0,36,39,0
4190,39512,ivxBGUbA7UT7tzED0gKK31cJU8Lv97zd,SpATywNh6bZuzm8s1ceuBUnMUAeoAHHw,7,7,1,0,1,0,2,0,11,1.5714285714285714,1,0.0,0,1,0,1,7,0,0,2,0,2,9,1
4191,39526,3Aezv8lgcVyIW4Uwgi3KMiL4RZSkwke5,A3fsA9Zfv1X2fVEQhTw51lKENdNrEqT3,12,16,11,0,5,0,7,0,39,5.571428571428571,3,0.0,1,11,0,5,15,0,0,7,0,17,22,1
4192,39527,BZSYb0PJXmPcTlknqBAAi8E9uLmy4IRE,SpATywNh6bZuzm8s1ceuBUnMUAeoAHHw,21,53,26,12,5,1,13,2,112,16.0,5,0.0,4,26,11,5,49,1,1,13,2,46,66,1
4193,39530,ZuUY5FCqqOqbgit08Gvv6v9cPTZXO9su,SpATywNh6bZuzm8s1ceuBUnMUAeoAHHw,9,9,4,0,2,0,6,1,22,3.142857142857143,1,0.0,1,4,0,2,8,0,0,6,1,7,15,1
4194,39534,cULoH8ZJIqrdeB8ADfKnnQ8THzmbMgQV,A3fsA9Zfv1X2fVEQhTw51lKENdNrEqT3,2,0,0,0,0,0,2,0,2,0.2857142857142857,1,0.0,0,0,0,0,0,0,0,2,0,0,2,1
4195,39537,xg8lJQFNYZJBLJxL1TK1I5KNSxuhMUEI,bWdj2GDclj5ofokWjzoa5jAwMkxCykd6,5,7,2,0,0,0,4,0,13,1.8571428571428572,3,0.0,0,2,0,0,7,0,0,4,0,2,11,1
4196,39540,xnObPmivHmj7phvTSVLNuvvFk898J2aO,SpATywNh6bZuzm8s1ceuBUnMUAeoAHHw,16,26,4,9,2,2,10,0,53,7.571428571428571,4,0.0,4,4,9,2,22,2,0,10,0,19,34,1
4197,39541,fnvAURpBgndjkYxbDVVMCKsNQuRUMiGS,RXDvfPUBYFlVdlueBFbLW0mhhAyGEqpt,1,0,0,0,0,0,1,0,1,0.14285714285714285,1,0.0,0,0,0,0,0,0,0,1,0,0,1,1
4198,39546,94sscb1tthVT0LkFotULcfURBxnTdgyP,A3fsA9Zfv1X2fVEQhTw51lKENdNrEqT3,5,2,1,0,1,0,2,0,6,0.8571428571428571,1,0.0,0,1,0,1,2,0,0,2,0,2,4,1
4199,39560,tfLWXkHQA3FBV54C2lvq1caDx4Pi6QwO,SpATywNh6bZuzm8s1ceuBUnMUAeoAHHw,28,56,24,26,10,0,13,0,129,18.428571428571427,8,0.0,13,24,26,10,43,0,0,13,0,73,56,0
4200,39565,lY81J0j7TM6V2dDMqV7lafTfl1uBUPgf,A3fsA9Zfv1X2fVEQhTw51lKENdNrEqT3,36,16,9,92,6,0,14,1,138,19.714285714285715,2,0.0,4,9,81,6,12,0,11,14,1,100,38,1
4201,39567,YC5UG6m05nI4uxDXYqrNEKgzKHSk4oSu,SpATywNh6bZuzm8s1ceuBUnMUAeoAHHw,46,84,44,34,20,14,27,5,228,32.57142857142857,10,0.0,22,44,30,20,62,14,4,27,5,116,112,0
4202,39568,veYIONVCJwpad8Khvzq7a5rgGQHvYo6S,G8EPVSXsOYB5YQWZGiz1aVq5Pgr2GrQu,30,34,23,20,16,1,5,0,99,14.142857142857142,3,0.0,5,23,15,16,29,1,5,5,0,59,40,0
4203,39587,X14gKVD1ZKu0qL0NchpqxwhoYSEpz9QI,SpATywNh6bZuzm8s1ceuBUnMUAeoAHHw,21,42,4,16,1,19,26,0,108,15.428571428571429,13,0.0,7,4,15,1,35,19,1,26,0,27,81,0
4204,39595,YFvrapJWr0AHUdxkctZzup6RNdDbndzC,SpATywNh6bZuzm8s1ceuBUnMUAeoAHHw,7,9,2,0,2,0,3,1,17,2.4285714285714284,2,0.0,0,2,0,2,9,0,0,3,1,4,13,0
4205,39608,Z75g2Nz4DcysTkbj3XO50UPDPTuBSclE,A3fsA9Zfv1X2fVEQhTw51lKENdNrEqT3,38,22,2,88,2,5,8,2,129,18.428571428571427,3,0.0,1,2,70,2,21,5,18,8,2,75,54,1
4206,39613,Kp4YCt5gbTMeLX4vxDVqvPhrGDdHDcEC,SpATywNh6bZuzm8s1ceuBUnMUAeoAHHw,8,6,4,0,3,0,1,0,14,2.0,1,0.0,0,4,0,3,6,0,0,1,0,7,7,1
4207,39620,RERMHDA2gNT2NdhpczhxOdgAsVrkLgnS,SpATywNh6bZuzm8s1ceuBUnMUAeoAHHw,6,4,2,0,1,0,3,0,10,1.4285714285714286,2,0.0,0,2,0,1,4,0,0,3,0,3,7,0
4208,39622,GqdYzH9IQjNV4Qw4poxGmkYlIXbhf40S,SpATywNh6bZuzm8s1ceuBUnMUAeoAHHw,11,6,4,8,3,0,1,0,22,3.142857142857143,1,0.0,1,4,7,3,5,0,1,1,0,15,7,1
4209,39623,nlj7VjLiwr4POHSdgtLvTaDUWFoae60t,SpATywNh6bZuzm8s1ceuBUnMUAeoAHHw,15,18,10,2,6,0,9,1,46,6.571428571428571,3,0.0,1,10,2,6,17,0,0,9,1,19,27,1
4210,39627,W5u0uO7QxoiOFkTJ8a7Iluj7qY01eSEK,SpATywNh6bZuzm8s1ceuBUnMUAeoAHHw,8,3,1,0,1,0,4,1,10,1.4285714285714286,1,0.0,0,1,0,1,3,0,0,4,1,2,8,1
4211,39629,vh69W01dADhjl8K2ZA2b9sRlprr5NXs0,SpATywNh6bZuzm8s1ceuBUnMUAeoAHHw,11,11,5,4,2,0,1,0,23,3.2857142857142856,1,0.0,3,5,4,2,8,0,0,1,0,14,9,1
4212,39630,3Aezv8lgcVyIW4Uwgi3KMiL4RZSkwke5,bWdj2GDclj5ofokWjzoa5jAwMkxCykd6,24,64,33,40,11,58,45,5,256,36.57142857142857,13,0.0,9,33,34,11,55,58,6,45,5,87,169,0
4213,39632,YHL8SFwBUtFpO36pvl6xAPsnC0mLXaOp,G8EPVSXsOYB5YQWZGiz1aVq5Pgr2GrQu,19,40,5,0,5,0,7,0,57,8.142857142857142,6,0.0,0,5,0,5,40,0,0,7,0,10,47,1
4214,39649,BfV7UiYzJLw6WeEm3hlQsMK4WHcSosq4,A3fsA9Zfv1X2fVEQhTw51lKENdNrEqT3,50,27,24,94,21,0,5,0,171,24.428571428571427,3,0.0,1,24,75,21,26,0,19,5,0,121,50,1
4215,39652,6FzXe5nPWUHRxntREHsQRnp7x1pxuhUz,bWdj2GDclj5ofokWjzoa5jAwMkxCykd6,15,37,15,44,7,8,7,1,119,17.0,3,0.0,11,15,43,7,26,8,1,7,1,76,43,1
4216,39662,3uY3PXIjE4xYhALzqv9EDJ3LJju3f4Jc,A3fsA9Zfv1X2fVEQhTw51lKENdNrEqT3,1,0,0,0,0,0,1,0,1,0.14285714285714285,1,0.0,0,0,0,0,0,0,0,1,0,0,1,1
4217,39673,fCmdFT6vVaKttJ0wsJVd3YILMXjqgUpl,A3fsA9Zfv1X2fVEQhTw51lKENdNrEqT3,1,0,0,0,0,0,1,0,1,0.14285714285714285,1,0.0,0,0,0,0,0,0,0,1,0,0,1,1
4218,39676,jsiVqpEsXq0sluinZw5ff1hSi6FTnuod,SpATywNh6bZuzm8s1ceuBUnMUAeoAHHw,5,2,1,0,1,0,4,0,8,1.1428571428571428,2,0.0,0,1,0,1,2,0,0,4,0,2,6,1
4219,39697,CJISoHtkGNnkB0CRrvBDw2uUj4sPNv5j,SpATywNh6bZuzm8s1ceuBUnMUAeoAHHw,12,28,0,13,0,1,4,0,46,6.571428571428571,2,0.0,11,0,10,0,17,1,3,4,0,21,25,1
4220,39709,Nfn60tuwOzVop5pbBaYFyFMaifJoAIP6,bWdj2GDclj5ofokWjzoa5jAwMkxCykd6,16,27,12,56,7,0,4,0,106,15.142857142857142,2,0.0,12,12,48,7,15,0,8,4,0,79,27,1
4221,39723,wg81hfugF770xMHAXCLP7YJmOhdUJnHl,SpATywNh6bZuzm8s1ceuBUnMUAeoAHHw,35,78,25,22,13,11,17,1,167,23.857142857142858,10,0.0,14,25,17,13,64,11,5,17,1,69,98,0
4222,39733,rMXcpM1YL9uvJc9vPGaTEpRlMvl4lfsn,bWdj2GDclj5ofokWjzoa5jAwMkxCykd6,4,3,1,0,0,0,1,0,5,0.7142857142857143,1,0.0,0,1,0,0,3,0,0,1,0,1,4,1
4223,39741,aw5sNjg3Ll84wJrvKaca9hOr6No0sjrv,SpATywNh6bZuzm8s1ceuBUnMUAeoAHHw,13,16,2,13,1,0,4,0,36,5.142857142857143,2,0.0,9,2,11,1,7,0,2,4,0,23,13,1
4224,39756,0aMTCmDPG4aC91o1krmKQxgTxAagyKJp,bWdj2GDclj5ofokWjzoa5jAwMkxCykd6,17,31,17,86,12,0,18,1,165,23.571428571428573,4,0.0,11,17,77,12,20,0,9,18,1,117,48,1
4225,39760,s8yyjhcg4BVOip4HSP4txOTTHFJ4aWPU,SpATywNh6bZuzm8s1ceuBUnMUAeoAHHw,3,2,1,0,0,0,2,0,5,0.7142857142857143,2,0.0,0,1,0,0,2,0,0,2,0,1,4,1
4226,39765,Ea76prVlgHXbifiTXOy9yoJBa7oRFv41,RXDvfPUBYFlVdlueBFbLW0mhhAyGEqpt,1,0,0,0,0,0,1,0,1,0.14285714285714285,1,0.0,0,0,0,0,0,0,0,1,0,0,1,1
4227,39773,6QYAwv5e3xo1Sn1iZiEuGx1qJzd44Lj7,RXDvfPUBYFlVdlueBFbLW0mhhAyGEqpt,19,29,7,0,5,0,10,0,51,7.285714285714286,2,0.0,3,7,0,5,26,0,0,10,0,15,36,1
4228,39774,1aQoKDna73jstuOrupWa9Kq8V3FdvbRU,RXDvfPUBYFlVdlueBFbLW0mhhAyGEqpt,7,4,2,0,2,0,1,0,9,1.2857142857142858,1,0.0,0,2,0,2,4,0,0,1,0,4,5,1
4229,39776,OdMr7dE5UlAme9Tp979vREBvY5CV50po,bWdj2GDclj5ofokWjzoa5jAwMkxCykd6,82,76,42,170,30,0,19,0,337,48.142857142857146,10,0.0,23,42,156,30,53,0,14,19,0,251,86,0
4230,39808,Y1HbgiosdaMEUFcfxOopNbywAYIWyuQr,SpATywNh6bZuzm8s1ceuBUnMUAeoAHHw,10,16,1,0,1,8,5,0,31,4.428571428571429,3,0.0,0,1,0,1,16,8,0,5,0,2,29,1
4231,39817,vkw8WV6aYKsdxKvxTMS0euMnMdoDV8qN,bWdj2GDclj5ofokWjzoa5jAwMkxCykd6,5,7,3,0,2,3,2,0,17,2.4285714285714284,2,0.0,2,3,0,2,5,3,0,2,0,7,10,1
4232,39823,rEKGYBPmMNG2ptSViOUukUYctuPLpJ3c,A3fsA9Zfv1X2fVEQhTw51lKENdNrEqT3,8,10,1,0,0,1,11,3,26,3.7142857142857144,2,0.0,2,1,0,0,8,1,0,11,3,3,23,1
4233,39824,ZKL2WgbeR5PdyCIYfqDQ4XNCHZlCFLIz,bWdj2GDclj5ofokWjzoa5jAwMkxCykd6,5,5,3,0,2,0,5,0,15,2.142857142857143,2,0.0,0,3,0,2,5,0,0,5,0,5,10,1
4234,39827,A6hS9pkzvwTNmFdD6HzIqa5y6YmtMrCe,A3fsA9Zfv1X2fVEQhTw51lKENdNrEqT3,7,7,1,0,1,0,1,0,10,1.4285714285714286,1,0.0,0,1,0,1,7,0,0,1,0,2,8,1
4235,39828,ke8J6J68PMmqZ8rK8FCDUgXlLZQpLLZW,A3fsA9Zfv1X2fVEQhTw51lKENdNrEqT3,46,42,20,102,9,0,14,2,189,27.0,4,0.0,1,20,84,9,41,0,18,14,2,114,75,1
4236,39837,HboM24Wk39YTBPWC8WzrZxRqA9rZpUU4,SpATywNh6bZuzm8s1ceuBUnMUAeoAHHw,7,8,2,0,1,1,8,1,21,3.0,3,0.0,0,2,0,1,8,1,0,8,1,3,18,1
4237,39838,dNIlKItJkU7JaK0shSCPHRrbzZCvxDbc,A3fsA9Zfv1X2fVEQhTw51lKENdNrEqT3,6,0,0,0,0,4,8,0,12,1.7142857142857142,1,0.0,0,0,0,0,0,4,0,8,0,0,12,1
4238,39858,efn1iuG0ajlfaHaXrPxReUu8GzdIHbZe,SpATywNh6bZuzm8s1ceuBUnMUAeoAHHw,12,18,10,0,5,1,13,1,48,6.857142857142857,3,0.0,1,10,0,5,17,1,0,13,1,16,32,0
4239,39861,wVfyl6WgFur5urtfx8TypP7osjiRs72N,A3fsA9Zfv1X2fVEQhTw51lKENdNrEqT3,2,0,0,0,0,0,3,0,3,0.42857142857142855,1,0.0,0,0,0,0,0,0,0,3,0,0,3,1
4240,39885,g6UH67YbvJtewLNXQNVZTYui0XC1Hxpo,G8EPVSXsOYB5YQWZGiz1aVq5Pgr2GrQu,62,101,51,138,19,0,18,1,328,46.857142857142854,7,0.0,37,51,112,19,64,0,26,18,1,219,109,0
4241,39886,Dd40k4eqowbb0BAmqLv8aP0MP2R1XA5P,SpATywNh6bZuzm8s1ceuBUnMUAeoAHHw,18,15,6,6,3,21,11,3,65,9.285714285714286,1,0.0,7,6,6,3,8,21,0,11,3,22,43,1
4242,39891,Dk2p6h1MYjykCuVHQMak8GN098n0FvGH,A3fsA9Zfv1X2fVEQhTw51lKENdNrEqT3,7,5,0,0,0,0,3,0,8,1.1428571428571428,2,0.0,0,0,0,0,5,0,0,3,0,0,8,1
4243,39906,xOGjXyyeq87fCMSZ9z7Yuds9sMvR7Ohh,RXDvfPUBYFlVdlueBFbLW0mhhAyGEqpt,12,13,10,0,6,0,2,0,31,4.428571428571429,2,0.0,0,10,0,6,13,0,0,2,0,16,15,0
4244,39919,C6gazwyl7EiFD8XZj9L3YaSfbatiTDEE,bWdj2GDclj5ofokWjzoa5jAwMkxCykd6,9,28,15,58,10,0,8,0,119,17.0,6,0.0,5,15,55,10,23,0,3,8,0,85,34,0
4245,39924,1Lhe3e5bki1E1AUNwq5SspoMJiU5aMmH,RXDvfPUBYFlVdlueBFbLW0mhhAyGEqpt,70,74,48,59,40,0,10,2,233,33.285714285714285,3,0.0,16,48,53,40,58,0,6,10,2,157,76,0
4246,39925,muBWBBbWzkNF6Dzg57EIx35WmD2zp0yP,SpATywNh6bZuzm8s1ceuBUnMUAeoAHHw,19,34,5,16,4,1,13,0,73,10.428571428571429,6,0.0,7,5,14,4,27,1,2,13,0,30,43,0
4247,39928,ygXUYNlms6qOypCR1kXz9dAuLrVhdPds,SpATywNh6bZuzm8s1ceuBUnMUAeoAHHw,19,32,15,18,3,22,21,1,112,16.0,7,0.0,9,15,15,3,23,22,3,21,1,42,70,1
4248,39929,r3yTAtA27zn29k1K73ADGURrMlpR5nC7,RXDvfPUBYFlVdlueBFbLW0mhhAyGEqpt,21,32,25,0,18,0,8,0,83,11.857142857142858,3,0.0,1,25,0,18,31,0,0,8,0,44,39,0
4249,39932,ddMTOiTV5HSxEMNnjSDeiKLzuF1YmYcT,A3fsA9Zfv1X2fVEQhTw51lKENdNrEqT3,3,2,1,0,0,0,1,0,4,0.5714285714285714,1,0.0,0,1,0,0,2,0,0,1,0,1,3,1
4250,39938,RVwnUs0luG0pmL3ADXHeT8MpQNWgZj3Z,RXDvfPUBYFlVdlueBFbLW0mhhAyGEqpt,34,38,26,100,0,0,1,0,165,23.571428571428573,6,0.0,10,26,92,0,28,0,8,1,0,128,37,1
4251,39941,Z90b24vMiOddvA3R8cPrefim6f9EiVmz,SpATywNh6bZuzm8s1ceuBUnMUAeoAHHw,20,25,7,27,2,8,7,3,79,11.285714285714286,3,0.0,16,7,21,2,9,8,6,7,3,46,33,0
4252,39943,P6hNwLATXTVCZjt7DoobnBSI1FyeLq01,A3fsA9Zfv1X2fVEQhTw51lKENdNrEqT3,8,15,2,0,2,0,6,0,25,3.5714285714285716,1,0.0,0,2,0,2,15,0,0,6,0,4,21,1
4253,39951,UXCeDIhL283LDr12VbAjFZUd7R6owJ9F,G8EPVSXsOYB5YQWZGiz1aVq5Pgr2GrQu,5,4,0,0,0,0,4,0,8,1.1428571428571428,1,0.0,1,0,0,0,3,0,0,4,0,1,7,0
4254,39956,CHAwTqWzS9gyj5Ro2Bvsw8FCNCA8dW6W,RXDvfPUBYFlVdlueBFbLW0mhhAyGEqpt,21,27,1,6,2,3,27,1,67,9.571428571428571,6,0.0,4,1,6,2,23,3,0,27,1,13,54,1
4255,39960,IyXR1neCOqlWiBnFK6SoolM6gOHf0cwa,A3fsA9Zfv1X2fVEQhTw51lKENdNrEqT3,12,4,3,0,3,1,7,0,18,2.5714285714285716,1,0.0,0,3,0,3,4,1,0,7,0,6,12,1
4256,39967,VFl026LXCSxME7l2ZLRhGKmh3R96duCq,SpATywNh6bZuzm8s1ceuBUnMUAeoAHHw,61,144,82,50,35,16,61,2,390,55.714285714285715,21,0.0,17,82,45,35,127,16,5,61,2,179,211,0
4257,39983,m4cy52txIJ3BHr73S3AvnUeiz4g3fpv8,A3fsA9Zfv1X2fVEQhTw51lKENdNrEqT3,8,4,3,0,3,0,1,0,11,1.5714285714285714,1,0.0,0,3,0,3,4,0,0,1,0,6,5,1
4258,39989,dhMm94sLRibUWA6YOpXlMLxyaR3sl4a9,A3fsA9Zfv1X2fVEQhTw51lKENdNrEqT3,18,39,2,0,2,5,14,0,62,8.857142857142858,6,0.0,0,2,0,2,39,5,0,14,0,4,58,0
4259,40010,XsIiMjBHDyB8SLEzKHAHcKIpWlAHXu34,RXDvfPUBYFlVdlueBFbLW0mhhAyGEqpt,29,77,22,45,13,4,9,0,170,24.285714285714285,2,0.0,9,22,43,13,68,4,2,9,0,87,83,0
4260,40013,p1fshV6UZeW7KZmzuxOc9ex10GYNTePc,RXDvfPUBYFlVdlueBFbLW0mhhAyGEqpt,48,41,23,85,12,42,8,2,213,30.428571428571427,3,0.0,15,23,77,12,26,42,8,8,2,127,86,1
4261,40019,wDbI53389OJRBH6MsGEj6dttayfVtGlQ,SpATywNh6bZuzm8s1ceuBUnMUAeoAHHw,1,0,0,0,0,0,1,0,1,0.14285714285714285,1,0.0,0,0,0,0,0,0,0,1,0,0,1,1
4262,40022,SP7CCOQc4gFs6CnOJ8vpnG2qG74ffSCZ,SpATywNh6bZuzm8s1ceuBUnMUAeoAHHw,14,16,0,14,1,0,11,0,42,6.0,4,0.0,5,0,13,1,11,0,1,11,0,19,23,0
4263,40027,vpdMGAwpHu1uhd9ckN957NDWXXLtiXYo,bWdj2GDclj5ofokWjzoa5jAwMkxCykd6,9,8,4,0,1,36,16,3,68,9.714285714285714,6,0.0,3,4,0,1,5,36,0,16,3,8,60,1
4264,40028,KaeCX7DoW5htn0YhXrWslGGGeoVPFyiJ,G8EPVSXsOYB5YQWZGiz1aVq5Pgr2GrQu,12,11,7,0,5,0,5,0,28,4.0,2,0.0,0,7,0,5,11,0,0,5,0,12,16,1
4265,40037,4wGoSTuzJXBCojeNmaxk9GbR1KaCV7ql,bWdj2GDclj5ofokWjzoa5jAwMkxCykd6,8,4,1,0,1,0,7,1,14,2.0,2,0.0,0,1,0,1,4,0,0,7,1,2,12,1
4266,40039,28PHU9suTM8EqUKsQwsvQ03DzFXi0yDl,A3fsA9Zfv1X2fVEQhTw51lKENdNrEqT3,48,38,25,54,10,1,21,1,150,21.428571428571427,8,0.0,3,25,46,10,35,1,8,21,1,84,66,0
4267,40054,dlphjzS7Cck7yL7KPK4kXgmYSbBOCuFC,bWdj2GDclj5ofokWjzoa5jAwMkxCykd6,23,68,26,120,12,52,32,4,314,44.857142857142854,8,0.0,17,26,116,12,51,52,4,32,4,171,143,0
4268,40060,qDqnrpVee3l5HrPD2lnOTUKZmsC9F3UK,A3fsA9Zfv1X2fVEQhTw51lKENdNrEqT3,5,2,1,0,1,0,2,0,6,0.8571428571428571,1,0.0,0,1,0,1,2,0,0,2,0,2,4,1
4269,40063,l5LfU8gApOG72AnBkdAbfOLQLwFH7Zo2,bWdj2GDclj5ofokWjzoa5jAwMkxCykd6,19,43,4,128,5,3,7,0,190,27.142857142857142,4,0.0,14,4,123,5,29,3,5,7,0,146,44,1
4270,40074,gT1aUgmAT0anYSW9us4nwhFYETF9WL3j,A3fsA9Zfv1X2fVEQhTw51lKENdNrEqT3,5,2,1,0,1,0,2,0,6,0.8571428571428571,1,0.0,0,1,0,1,2,0,0,2,0,2,4,1
4271,40079,2A7IXlmbeljDbPAl1ZsZqwpJw9LPGGGX,SpATywNh6bZuzm8s1ceuBUnMUAeoAHHw,31,29,18,28,9,15,7,1,107,15.285714285714286,2,0.0,8,18,23,9,21,15,5,7,1,58,49,1
4272,40080,tw29YEXMOD494kfaqMSHK6i8NRmqKdtq,G8EPVSXsOYB5YQWZGiz1aVq5Pgr2GrQu,9,4,3,0,3,0,2,0,12,1.7142857142857142,1,0.0,0,3,0,3,4,0,0,2,0,6,6,1
4273,40081,zyMs55MEXcYV6llnecBHL4KGyjGwZwbR,SpATywNh6bZuzm8s1ceuBUnMUAeoAHHw,14,12,1,23,0,0,5,0,41,5.857142857142857,3,0.0,3,1,22,0,9,0,1,5,0,26,15,0
4274,40084,J8UiKHYyR4z2Md44vzlhH8x9Cnerjpzr,G8EPVSXsOYB5YQWZGiz1aVq5Pgr2GrQu,2,0,0,0,0,0,2,0,2,0.2857142857142857,1,0.0,0,0,0,0,0,0,0,2,0,0,2,1
4275,40087,yoDT9q7GsYYKpWeoYGubo3V2RcRn4gQU,A3fsA9Zfv1X2fVEQhTw51lKENdNrEqT3,24,4,2,56,1,0,3,0,66,9.428571428571429,1,0.0,1,2,47,1,3,0,9,3,0,51,15,1
4276,40101,D2f4XnvAFD8ZIkDvhpGbd6yCstJua9ut,SpATywNh6bZuzm8s1ceuBUnMUAeoAHHw,9,10,3,0,2,0,3,0,18,2.5714285714285716,2,0.0,0,3,0,2,10,0,0,3,0,5,13,1
4277,40104,FUMcFXXfXADMgcSzTyKSabMQ45EVJp0n,A3fsA9Zfv1X2fVEQhTw51lKENdNrEqT3,42,24,19,72,12,1,16,0,144,20.571428571428573,5,0.0,1,19,60,12,23,1,12,16,0,92,52,1
4278,40137,7Blw5DXu09ENSrwHZywqqUdODuz4CZi6,SpATywNh6bZuzm8s1ceuBUnMUAeoAHHw,45,50,25,38,16,2,26,1,158,22.571428571428573,5,0.0,16,25,33,16,34,2,5,26,1,90,68,0
4279,40139,5veZ6xRUiuZvoK7jObyhZU0X1eoLbhpg,SpATywNh6bZuzm8s1ceuBUnMUAeoAHHw,6,3,2,0,2,0,1,0,8,1.1428571428571428,1,0.0,0,2,0,2,3,0,0,1,0,4,4,1
4280,40140,LEeLDvxwrRnZu2qnrsr2uQ3TKN0DCY1A,SpATywNh6bZuzm8s1ceuBUnMUAeoAHHw,4,2,1,0,1,1,1,0,6,0.8571428571428571,1,0.0,0,1,0,1,2,1,0,1,0,2,4,0
4281,40149,iUzEPtD1F6CCo8jGkTMMkDMICh5ACqJB,SpATywNh6bZuzm8s1ceuBUnMUAeoAHHw,7,4,2,0,1,0,6,0,13,1.8571428571428572,2,0.0,0,2,0,1,4,0,0,6,0,3,10,1
4282,40154,grc1pAXqdUQaBlZrZyROqjuEtg08nen2,bWdj2GDclj5ofokWjzoa5jAwMkxCykd6,7,4,0,0,0,0,12,0,16,2.2857142857142856,2,0.0,0,0,0,0,4,0,0,12,0,0,16,0
4283,40156,BM23agkLBTvZTkItMt2GtI7Rt9Nmmgof,SpATywNh6bZuzm8s1ceuBUnMUAeoAHHw,27,62,30,0,13,83,12,0,200,28.571428571428573,7,0.0,6,30,0,13,56,83,0,12,0,49,151,0
4284,40164,Ml8yd2wTtJsMaa32cmbKtb7cTpIqIKz4,SpATywNh6bZuzm8s1ceuBUnMUAeoAHHw,20,54,34,26,16,0,11,0,141,20.142857142857142,3,0.0,13,34,20,16,41,0,6,11,0,83,58,1
4285,40175,m2y02R5W4wE10TMNO80PJL5IOUbHqLJ2,SpATywNh6bZuzm8s1ceuBUnMUAeoAHHw,38,49,31,19,12,0,15,0,126,18.0,7,0.0,6,31,19,12,43,0,0,15,0,68,58,0
4286,40182,gMD3QXq0NP11IqNCLAQviPDQUlnfIgHG,A3fsA9Zfv1X2fVEQhTw51lKENdNrEqT3,14,25,1,0,0,13,7,3,49,7.0,2,0.0,0,1,0,0,25,13,0,7,3,1,48,1
4287,40184,p2NSaI2ihMq1kpyPoZO7VVEhFNMs1UZl,bWdj2GDclj5ofokWjzoa5jAwMkxCykd6,15,27,6,104,5,9,5,2,158,22.571428571428573,3,0.0,11,6,97,5,16,9,7,5,2,119,39,1
4288,40188,su19QKj6MYt8IN4q4jbVFtyo4Ew7wkeA,RXDvfPUBYFlVdlueBFbLW0mhhAyGEqpt,15,15,12,0,5,1,7,0,40,5.714285714285714,2,0.0,0,12,0,5,15,1,0,7,0,17,23,1
4289,40190,PPWmWzLrUp96FN46Q0IBJuH09vUmH4P8,RXDvfPUBYFlVdlueBFbLW0mhhAyGEqpt,5,2,2,0,0,1,2,0,7,1.0,1,0.0,0,2,0,0,2,1,0,2,0,2,5,1
4290,40198,w1whp42bLIFDRZ3YUW58J4w8I7T8mTT8,SpATywNh6bZuzm8s1ceuBUnMUAeoAHHw,26,105,15,16,5,15,47,1,204,29.142857142857142,11,0.0,36,15,16,5,69,15,0,47,1,72,132,1
4291,40204,tYXSIW41vEc1ilow8iQ6smCJvAodHkNV,bWdj2GDclj5ofokWjzoa5jAwMkxCykd6,3,0,0,0,0,4,6,0,10,1.4285714285714286,3,0.0,0,0,0,0,0,4,0,6,0,0,10,1
4292,40221,eLZwBv2irk6SjmpfpnKpxtWIlq5cEmna,SpATywNh6bZuzm8s1ceuBUnMUAeoAHHw,1,0,0,0,0,0,1,0,1,0.14285714285714285,1,0.0,0,0,0,0,0,0,0,1,0,0,1,1
4293,40222,eLodedTH8LaOO46CeXCjKZbHSbVrNTIU,SpATywNh6bZuzm8s1ceuBUnMUAeoAHHw,14,9,4,12,3,0,2,0,30,4.285714285714286,1,0.0,3,4,10,3,6,0,2,2,0,20,10,1
4294,40241,9y5g4IgoufVMmdRflE8Vnup7J4tZ9eiA,SpATywNh6bZuzm8s1ceuBUnMUAeoAHHw,9,13,5,0,2,0,3,0,23,3.2857142857142856,2,0.0,0,5,0,2,13,0,0,3,0,7,16,1
4295,40247,CnndUXNaSJ8w2bb9DGxHOhqjHw4SEo1K,SpATywNh6bZuzm8s1ceuBUnMUAeoAHHw,20,59,21,24,8,39,17,1,169,24.142857142857142,7,0.0,20,21,21,8,39,39,3,17,1,70,99,0
4296,40257,IRfJ2J3e4oTjcMA6yNpRgLvZtLwyduUa,SpATywNh6bZuzm8s1ceuBUnMUAeoAHHw,44,139,55,42,30,12,41,3,322,46.0,8,0.0,12,55,39,30,127,12,3,41,3,136,186,0
4297,40277,w1whp42bLIFDRZ3YUW58J4w8I7T8mTT8,G8EPVSXsOYB5YQWZGiz1aVq5Pgr2GrQu,1,0,0,0,0,0,3,0,3,0.42857142857142855,2,0.0,0,0,0,0,0,0,0,3,0,0,3,1
4298,40278,mMBONcOMl6gC3uzknh0XJLJbk13L2x3D,SpATywNh6bZuzm8s1ceuBUnMUAeoAHHw,26,18,12,12,9,1,2,0,54,7.714285714285714,2,0.0,5,12,12,9,13,1,0,2,0,38,16,1
4299,40282,CSh5hGbaSFu2yCb31iVMOVwKocrH471Q,A3fsA9Zfv1X2fVEQhTw51lKENdNrEqT3,44,34,22,80,15,0,10,0,161,23.0,5,0.0,1,22,61,15,33,0,19,10,0,99,62,1
4300,40283,QrVCBnMblCvtcbL9oEOfx7eoMJ5VAhGg,A3fsA9Zfv1X2fVEQhTw51lKENdNrEqT3,5,3,0,0,0,1,4,0,8,1.1428571428571428,1,0.0,0,0,0,0,3,1,0,4,0,0,8,1
4301,40311,1Pk7jZ6bfmKYXcNnRyEd7kPSZWAEJN0N,RXDvfPUBYFlVdlueBFbLW0mhhAyGEqpt,4,0,0,0,0,1,3,4,8,1.1428571428571428,3,0.0,0,0,0,0,0,1,0,3,4,0,8,1
4302,40316,TDPVJF1yuusgDrAkAZKxkuuOK4BkswXA,RXDvfPUBYFlVdlueBFbLW0mhhAyGEqpt,1,0,0,0,0,0,1,0,1,0.14285714285714285,1,0.0,0,0,0,0,0,0,0,1,0,0,1,1
4303,40319,wg81hfugF770xMHAXCLP7YJmOhdUJnHl,A3fsA9Zfv1X2fVEQhTw51lKENdNrEqT3,11,16,6,0,3,12,9,0,46,6.571428571428571,4,0.0,0,6,0,3,16,12,0,9,0,9,37,0
4304,40327,5vUuq5ZeDCNce4LmvH0naoUjpb3qbNOp,A3fsA9Zfv1X2fVEQhTw51lKENdNrEqT3,55,79,43,76,9,3,23,1,234,33.42857142857143,6,0.0,3,43,57,9,76,3,19,23,1,112,122,1
4305,40332,JCQSo9f9Aey0YG4wslCCbhR6oOLB0oC6,SpATywNh6bZuzm8s1ceuBUnMUAeoAHHw,45,59,28,26,12,20,20,1,166,23.714285714285715,7,0.0,12,28,25,12,47,20,1,20,1,77,89,0
4306,40352,lkFGShqBa18inWINppsv8Kl48gyf85dR,A3fsA9Zfv1X2fVEQhTw51lKENdNrEqT3,27,18,13,0,11,4,8,1,55,7.857142857142857,1,0.0,1,13,0,11,17,4,0,8,1,25,30,0
4307,40354,GFHYWWeeAuj1pePvOmCpIpIQDTy4Q3Iv,RXDvfPUBYFlVdlueBFbLW0mhhAyGEqpt,38,83,70,0,50,11,9,5,228,32.57142857142857,4,0.0,3,70,0,50,80,11,0,9,5,123,105,0
4308,40358,EEH4DLdmIdcQf1RzjjDafMrB5kVed71w,A3fsA9Zfv1X2fVEQhTw51lKENdNrEqT3,12,12,6,0,5,1,12,0,36,5.142857142857143,3,0.0,0,6,0,5,12,1,0,12,0,11,25,1
4309,40364,yzVmKfAEq3932HHrOfA6gQJmdnGWlxk3,bWdj2GDclj5ofokWjzoa5jAwMkxCykd6,1,0,0,0,0,0,1,0,1,0.14285714285714285,1,0.0,0,0,0,0,0,0,0,1,0,0,1,1
4310,40367,wg81hfugF770xMHAXCLP7YJmOhdUJnHl,bWdj2GDclj5ofokWjzoa5jAwMkxCykd6,7,10,3,4,1,0,3,0,21,3.0,2,0.0,1,3,3,1,9,0,1,3,0,8,13,0
4311,40368,12mZjkjOmjGXj1h45WoNLHZyHxNUfx7S,SpATywNh6bZuzm8s1ceuBUnMUAeoAHHw,8,10,1,0,0,0,4,0,15,2.142857142857143,2,0.0,0,1,0,0,10,0,0,4,0,1,14,1
4312,40379,ypimmfavTEjP3dtudBXAUUwNT9VgZavl,SpATywNh6bZuzm8s1ceuBUnMUAeoAHHw,6,3,2,0,1,0,3,0,9,1.2857142857142858,1,0.0,0,2,0,1,3,0,0,3,0,3,6,1
4313,40393,b3FNzt9bW0DYxGtrDwfKBHrmIKO1If8w,SpATywNh6bZuzm8s1ceuBUnMUAeoAHHw,8,10,3,0,3,0,2,0,18,2.5714285714285716,2,0.0,0,3,0,3,10,0,0,2,0,6,12,1
4314,40400,OEVp80aW59NsIt7NX2Io1skiDEX4Ksu0,RXDvfPUBYFlVdlueBFbLW0mhhAyGEqpt,9,5,5,0,1,2,6,2,21,3.0,2,0.0,0,5,0,1,5,2,0,6,2,6,15,1
4315,40402,O7GZYzgRa5tZbYrbtpqYuheFfdPZTjLl,bWdj2GDclj5ofokWjzoa5jAwMkxCykd6,15,28,14,30,8,52,15,2,149,21.285714285714285,6,0.0,5,14,28,8,23,52,2,15,2,55,94,1
4316,40407,oKgEB6oFYTWjl9uatjwv0rz1CsEob0nE,G8EPVSXsOYB5YQWZGiz1aVq5Pgr2GrQu,1,0,0,0,0,0,1,0,1,0.14285714285714285,1,0.0,0,0,0,0,0,0,0,1,0,0,1,1
4317,40413,0Cx8S0i9vAPm7jZ8jXLUkrYp9xGpIHIS,SpATywNh6bZuzm8s1ceuBUnMUAeoAHHw,4,2,1,0,0,4,3,2,12,1.7142857142857142,2,0.0,0,1,0,0,2,4,0,3,2,1,11,1
4318,40423,8jqDD2phXiMGQf0XQi1kVRzLj3TILO0y,RXDvfPUBYFlVdlueBFbLW0mhhAyGEqpt,21,25,15,44,6,0,7,0,97,13.857142857142858,3,0.0,7,15,36,6,18,0,8,7,0,64,33,1
4319,40426,gp5vtbG0la8PEmRrqmDatBiyjEv7PWrx,SpATywNh6bZuzm8s1ceuBUnMUAeoAHHw,9,12,5,20,0,0,3,0,40,5.714285714285714,3,0.0,3,5,16,0,9,0,4,3,0,24,16,1
4320,40427,7x51V9V9eIHFPqiYUnOLpACvWY55pqZF,G8EPVSXsOYB5YQWZGiz1aVq5Pgr2GrQu,6,4,2,0,2,0,2,0,10,1.4285714285714286,1,0.0,0,2,0,2,4,0,0,2,0,4,6,1
4321,40437,sV8Z2WoHSkq80AVgpDh4TBiipVVqEZ0U,A3fsA9Zfv1X2fVEQhTw51lKENdNrEqT3,6,2,1,0,1,0,4,0,8,1.1428571428571428,1,0.0,0,1,0,1,2,0,0,4,0,2,6,1
4322,40438,sV8Z2WoHSkq80AVgpDh4TBiipVVqEZ0U,bWdj2GDclj5ofokWjzoa5jAwMkxCykd6,4,2,1,0,1,0,1,0,5,0.7142857142857143,1,0.0,0,1,0,1,2,0,0,1,0,2,3,1
4323,40447,y6i20DJpIul6LihHwgZcWxbdAap5GcBP,bWdj2GDclj5ofokWjzoa5jAwMkxCykd6,6,6,1,0,0,3,12,0,22,3.142857142857143,5,0.0,0,1,0,0,6,3,0,12,0,1,21,1
4324,40456,vGcLxIxx9hPQmjm92Kj3O9RHGwvxcHnD,RXDvfPUBYFlVdlueBFbLW0mhhAyGEqpt,18,13,8,6,4,7,8,1,47,6.714285714285714,2,0.0,1,8,6,4,12,7,0,8,1,19,28,1
4325,40467,bNBhDpviOcrLuVFG9Qda6S7fiYJ6jIvc,SpATywNh6bZuzm8s1ceuBUnMUAeoAHHw,19,35,15,14,6,0,5,0,75,10.714285714285714,5,0.0,9,15,13,6,26,0,1,5,0,43,32,1
4326,40469,zynLWMDwDGZGrMFdec4rl1UB2FSg8e8K,A3fsA9Zfv1X2fVEQhTw51lKENdNrEqT3,28,18,14,0,10,4,13,2,61,8.714285714285714,3,0.0,0,14,0,10,18,4,0,13,2,24,37,1
4327,40470,nc7wDS7f7s8kprAeqMfrtjmYyoRdpJ65,bWdj2GDclj5ofokWjzoa5jAwMkxCykd6,7,4,2,0,1,3,7,1,18,2.5714285714285716,2,0.0,0,2,0,1,4,3,0,7,1,3,15,1
4328,40476,EChSttZSil8pQFLm0qImYXOhSqXem2dj,SpATywNh6bZuzm8s1ceuBUnMUAeoAHHw,8,7,0,0,0,0,4,2,13,1.8571428571428572,1,0.0,1,0,0,0,6,0,0,4,2,1,12,1
4329,40478,i0LHbVo0MUWeo1slrPpQRlCoWzknlhLR,A3fsA9Zfv1X2fVEQhTw51lKENdNrEqT3,5,2,1,0,1,0,2,0,6,0.8571428571428571,1,0.0,0,1,0,1,2,0,0,2,0,2,4,1
4330,40483,qbRtu1q5PIx1qmhJ9lRn0S3Y5dNcEYWw,G8EPVSXsOYB5YQWZGiz1aVq5Pgr2GrQu,21,15,5,18,3,0,9,0,50,7.142857142857143,3,0.0,0,5,14,3,15,0,4,9,0,22,28,1
4331,40486,JyWRLOWjORt63r48lT9LFGZBSOdXCttf,SpATywNh6bZuzm8s1ceuBUnMUAeoAHHw,6,3,2,0,2,0,1,0,8,1.1428571428571428,1,0.0,0,2,0,2,3,0,0,1,0,4,4,1
4332,40507,ZuoiR8ZSgQ4EIp0UPK1kvYAuneCl6lTF,SpATywNh6bZuzm8s1ceuBUnMUAeoAHHw,8,9,6,0,3,0,1,0,19,2.7142857142857144,1,0.0,1,6,0,3,8,0,0,1,0,10,9,1
4333,40512,l01aGQuAgd5VHAVuk21pZMIeJcDQOX6i,RXDvfPUBYFlVdlueBFbLW0mhhAyGEqpt,31,30,15,73,8,0,7,0,133,19.0,4,0.0,7,15,69,8,23,0,4,7,0,99,34,0
4334,40514,weKRMLBzfxs8ekS11Y9oGFXbhmcomWRF,A3fsA9Zfv1X2fVEQhTw51lKENdNrEqT3,135,80,33,296,18,0,35,0,462,66.0,7,0.0,11,33,269,18,69,0,27,35,0,331,131,0
4335,40515,zynLWMDwDGZGrMFdec4rl1UB2FSg8e8K,bWdj2GDclj5ofokWjzoa5jAwMkxCykd6,5,2,1,0,1,0,4,0,8,1.1428571428571428,1,0.0,0,1,0,1,2,0,0,4,0,2,6,1
4336,40525,Su94NLhpMEwzyTwfu3GGXYbQEbtpeLin,G8EPVSXsOYB5YQWZGiz1aVq5Pgr2GrQu,23,23,3,28,3,0,3,0,60,8.571428571428571,3,0.0,1,3,24,3,22,0,4,3,0,31,29,1
4337,40531,KUjjznPFpWdBg0GS5p0fa4zyp2j0nULG,SpATywNh6bZuzm8s1ceuBUnMUAeoAHHw,2,0,0,0,0,0,2,0,2,0.2857142857142857,1,0.0,0,0,0,0,0,0,0,2,0,0,2,1
4338,40541,55BMoXCnWKUmNoRDU7bcdmqWNuK9JpZ6,RXDvfPUBYFlVdlueBFbLW0mhhAyGEqpt,5,6,1,0,0,0,3,0,10,1.4285714285714286,1,0.0,2,1,0,0,4,0,0,3,0,3,7,1
4339,40554,vG6SgKMKhZDlcYDUDKC1NlbpiW2uFCxn,A3fsA9Zfv1X2fVEQhTw51lKENdNrEqT3,11,11,0,0,0,4,10,0,25,3.5714285714285716,3,0.0,0,0,0,0,11,4,0,10,0,0,25,1
4340,40565,jPMKgTfqS9zWr9zlMBzf8ARp4D8cnFWF,SpATywNh6bZuzm8s1ceuBUnMUAeoAHHw,7,7,3,0,2,0,2,0,14,2.0,1,0.0,0,3,0,2,7,0,0,2,0,5,9,1
4341,40576,V2LBVc8iZdDnuXsiI9Sw06zIg4OqT9B6,SpATywNh6bZuzm8s1ceuBUnMUAeoAHHw,18,46,20,7,9,7,21,1,111,15.857142857142858,5,0.0,14,20,7,9,32,7,0,21,1,50,61,1
4342,40583,EVKTxmdXvqH9f0V4XuFLHjVRnnUWi9xh,A3fsA9Zfv1X2fVEQhTw51lKENdNrEqT3,49,66,41,46,17,1,38,1,210,30.0,11,0.0,11,41,39,17,55,1,7,38,1,108,102,1
4343,40591,izEpfh69zQRV21ZbipmxXr7f4EKcykoG,bWdj2GDclj5ofokWjzoa5jAwMkxCykd6,14,15,3,0,3,2,14,1,38,5.428571428571429,5,0.0,0,3,0,3,15,2,0,14,1,6,32,1
4344,40600,0ipS9A7VTQjzw25R8uCDpA963DAu7orq,SpATywNh6bZuzm8s1ceuBUnMUAeoAHHw,2,0,0,0,0,0,2,0,2,0.2857142857142857,1,0.0,0,0,0,0,0,0,0,2,0,0,2,1
4345,40608,nD2aR2lBTYEZ05tUWGjogkwgt2d7zeNx,A3fsA9Zfv1X2fVEQhTw51lKENdNrEqT3,48,54,2,92,2,0,5,0,155,22.142857142857142,4,0.0,0,2,81,2,54,0,11,5,0,85,70,1
4346,40611,hQ1i3lCFgZxFqzoAUMmIxeDISYlA8zCv,A3fsA9Zfv1X2fVEQhTw51lKENdNrEqT3,11,5,4,0,4,0,6,0,19,2.7142857142857144,1,0.0,0,4,0,4,5,0,0,6,0,8,11,1
4347,40622,FUMcFXXfXADMgcSzTyKSabMQ45EVJp0n,bWdj2GDclj5ofokWjzoa5jAwMkxCykd6,53,62,35,218,15,23,30,2,385,55.0,7,0.0,13,35,187,15,49,23,31,30,2,250,135,0
4348,40624,Tf1mjUo3ghY0Z5spwun4QIkEOaJmI2Lk,RXDvfPUBYFlVdlueBFbLW0mhhAyGEqpt,7,1,1,0,1,4,10,2,19,2.7142857142857144,1,0.0,0,1,0,1,1,4,0,10,2,2,17,1
4349,40635,BOna3ORacJGhjt4FcGMkKNwkDYsEjcvt,RXDvfPUBYFlVdlueBFbLW0mhhAyGEqpt,28,47,25,0,12,1,18,2,105,15.0,7,0.0,0,25,0,12,47,1,0,18,2,37,68,1
4350,40638,KLMwnbeiUPyAq67r6m0k1uM0yIHdmaWg,SpATywNh6bZuzm8s1ceuBUnMUAeoAHHw,6,2,0,0,0,0,5,0,7,1.0,1,0.0,0,0,0,0,2,0,0,5,0,0,7,1
4351,40646,uL0Po5J8HnBQPqSUKMNRTAvfe5A6cmqw,bWdj2GDclj5ofokWjzoa5jAwMkxCykd6,5,2,1,0,1,0,2,0,6,0.8571428571428571,1,0.0,0,1,0,1,2,0,0,2,0,2,4,1
4352,40670,AMHmOq5PY3K2Bq5bkWrg2Cz6hshdhVde,SpATywNh6bZuzm8s1ceuBUnMUAeoAHHw,11,15,1,7,1,4,8,0,36,5.142857142857143,3,0.0,2,1,6,1,13,4,1,8,0,10,26,1
4353,40685,UIuYkrvUrLhMOE6NfUprrMfA4RCzuhOi,SpATywNh6bZuzm8s1ceuBUnMUAeoAHHw,8,3,2,0,2,0,5,1,13,1.8571428571428572,1,0.0,0,2,0,2,3,0,0,5,1,4,9,1
4354,40693,UGYGSfRkJhOkgkdlCI6YSCshpNvwBF31,SpATywNh6bZuzm8s1ceuBUnMUAeoAHHw,11,13,8,3,4,0,3,0,31,4.428571428571429,2,0.0,1,8,3,4,12,0,0,3,0,16,15,1
4355,40694,EY3QtJOWsoMIz6ZJR9ZEsrPPDsaYmN0t,SpATywNh6bZuzm8s1ceuBUnMUAeoAHHw,16,31,0,20,0,19,21,2,93,13.285714285714286,3,0.0,7,0,15,0,24,19,5,21,2,22,71,1
4356,40696,mWUHV4msWZXLdeYpWFdjuucQsrIdSFxH,SpATywNh6bZuzm8s1ceuBUnMUAeoAHHw,1,0,0,0,0,0,1,0,1,0.14285714285714285,1,0.0,0,0,0,0,0,0,0,1,0,0,1,1
4357,40697,B9Ey1tIo6ANxVa0IvzoinvUWj4cenbLl,SpATywNh6bZuzm8s1ceuBUnMUAeoAHHw,11,19,2,11,1,0,1,0,34,4.857142857142857,4,0.0,3,2,9,1,16,0,2,1,0,15,19,1
4358,40717,P11RKOPCDL5miqBQ5O3oznfREAcXF9hp,A3fsA9Zfv1X2fVEQhTw51lKENdNrEqT3,49,48,24,50,22,4,23,2,173,24.714285714285715,4,0.0,1,24,44,22,47,4,6,23,2,91,82,0
4359,40720,n0jV4ldO1halkYjljprJ6GkJFBgQehlW,bWdj2GDclj5ofokWjzoa5jAwMkxCykd6,5,5,0,0,0,0,3,0,8,1.1428571428571428,1,0.0,0,0,0,0,5,0,0,3,0,0,8,1
4360,40731,1UUWIp3PiN0CT0O96IXxrt6TRVFJmFUz,bWdj2GDclj5ofokWjzoa5jAwMkxCykd6,2,0,0,0,0,0,2,0,2,0.2857142857142857,1,0.0,0,0,0,0,0,0,0,2,0,0,2,1
4361,40755,1Pk7jZ6bfmKYXcNnRyEd7kPSZWAEJN0N,SpATywNh6bZuzm8s1ceuBUnMUAeoAHHw,2,0,0,0,0,0,2,0,2,0.2857142857142857,2,0.0,0,0,0,0,0,0,0,2,0,0,2,1
4362,40759,1Pk7jZ6bfmKYXcNnRyEd7kPSZWAEJN0N,bWdj2GDclj5ofokWjzoa5jAwMkxCykd6,10,12,0,2,1,3,13,2,33,4.714285714285714,4,0.0,1,0,2,1,11,3,0,13,2,4,29,1
4363,40760,n0jV4ldO1halkYjljprJ6GkJFBgQehlW,A3fsA9Zfv1X2fVEQhTw51lKENdNrEqT3,8,8,1,0,1,0,3,0,13,1.8571428571428572,2,0.0,0,1,0,1,8,0,0,3,0,2,11,1
4364,40762,FcIMQNoo2B9wNij30W0t3SsuF1pzZCFp,SpATywNh6bZuzm8s1ceuBUnMUAeoAHHw,14,42,0,21,0,19,33,8,123,17.571428571428573,6,0.0,19,0,18,0,23,19,3,33,8,37,86,0
4365,40771,bsalGAvHbAyi2zQkMdMuno7PqVBrE5qV,SpATywNh6bZuzm8s1ceuBUnMUAeoAHHw,11,14,7,2,4,1,1,0,29,4.142857142857143,1,0.0,6,7,2,4,8,1,0,1,0,19,10,1
4366,40784,H2Rgqo3kRDsNdbNVEDl0788s9SSdLM8P,A3fsA9Zfv1X2fVEQhTw51lKENdNrEqT3,10,8,1,0,0,0,4,0,13,1.8571428571428572,1,0.0,0,1,0,0,8,0,0,4,0,1,12,1
4367,40788,TXXodrsD3gpNuvLWnhSXeHO4v2Kp7PZ2,SpATywNh6bZuzm8s1ceuBUnMUAeoAHHw,18,22,10,13,4,0,7,0,56,8.0,4,0.0,3,10,11,4,19,0,2,7,0,28,28,1
4368,40790,c6KChK06Rh7fb4zwLQYLlfB5pAi9XDtG,A3fsA9Zfv1X2fVEQhTw51lKENdNrEqT3,15,14,2,2,2,0,6,0,26,3.7142857142857144,2,0.0,0,2,2,2,14,0,0,6,0,6,20,1
4369,40818,0wm7bVyJC7jfhIoeylaV85sHOH5JOhtj,RXDvfPUBYFlVdlueBFbLW0mhhAyGEqpt,1,0,0,0,0,0,4,0,4,0.5714285714285714,4,0.0,0,0,0,0,0,0,0,4,0,0,4,1
4370,40830,WVkWa16sSufUj4kk1L49kzGtRQMQkIJr,SpATywNh6bZuzm8s1ceuBUnMUAeoAHHw,14,30,2,17,1,0,6,0,56,8.0,3,0.0,6,2,14,1,24,0,3,6,0,23,33,1
4371,40833,LRHDYNgQAsG2UssS8TgaqkiYDbFlVrrj,bWdj2GDclj5ofokWjzoa5jAwMkxCykd6,5,2,1,0,1,0,2,0,6,0.8571428571428571,1,0.0,0,1,0,1,2,0,0,2,0,2,4,1
4372,40845,PiMa9t7XXgGIfYACepD9P8yHYFoha6X9,SpATywNh6bZuzm8s1ceuBUnMUAeoAHHw,7,3,2,0,2,0,2,0,9,1.2857142857142858,1,0.0,0,2,0,2,3,0,0,2,0,4,5,1
4373,40851,hkTx4XunczsnVq4H9eVYRZURkkofvB6I,bWdj2GDclj5ofokWjzoa5jAwMkxCykd6,15,19,7,20,3,29,6,0,84,12.0,2,0.0,4,7,16,3,15,29,4,6,0,30,54,1
4374,40858,dJJJLtI6F18pblO9KPkBPg9ZKTgQPaQc,SpATywNh6bZuzm8s1ceuBUnMUAeoAHHw,25,73,7,20,3,3,15,0,121,17.285714285714285,10,0.0,24,7,19,3,49,3,1,15,0,53,68,0
4375,40861,40L77km5z19sJEVeJ6u4qpa9SAG2ZSIF,SpATywNh6bZuzm8s1ceuBUnMUAeoAHHw,29,44,25,40,0,0,16,0,125,17.857142857142858,6,0.0,12,25,34,0,32,0,6,16,0,71,54,0
4376,40862,dNG5hDkS45m4C7FwHXebOEhyKKD4NWCM,SpATywNh6bZuzm8s1ceuBUnMUAeoAHHw,9,4,2,0,2,0,4,1,13,1.8571428571428572,1,0.0,1,2,0,2,3,0,0,4,1,5,8,1
4377,40870,8gfCGxZ6lFjZr89RwPF8oXZs1Qn6Pq6X,bWdj2GDclj5ofokWjzoa5jAwMkxCykd6,6,2,2,0,0,0,12,0,16,2.2857142857142856,4,0.0,0,2,0,0,2,0,0,12,0,2,14,1
4378,40873,EjYujgGigN4Oo3US4ixRA3bL0nJn2PDZ,SpATywNh6bZuzm8s1ceuBUnMUAeoAHHw,25,27,5,38,3,4,11,0,88,12.571428571428571,5,0.0,4,5,33,3,23,4,5,11,0,45,43,1
4379,40875,2ekh2uQneNAGmhQ3c3UciXnUFmuOUWou,SpATywNh6bZuzm8s1ceuBUnMUAeoAHHw,34,45,25,30,14,2,12,1,129,18.428571428571427,7,0.0,10,25,27,14,35,2,3,12,1,76,53,1
4380,40877,EjYujgGigN4Oo3US4ixRA3bL0nJn2PDZ,G8EPVSXsOYB5YQWZGiz1aVq5Pgr2GrQu,5,6,1,0,1,0,3,0,11,1.5714285714285714,2,0.0,1,1,0,1,5,0,0,3,0,3,8,1
4381,40891,CuHXUjtagLOKelRrRvelBtnV2Gm8l97I,RXDvfPUBYFlVdlueBFbLW0mhhAyGEqpt,5,2,1,0,1,0,4,0,8,1.1428571428571428,1,0.0,0,1,0,1,2,0,0,4,0,2,6,1
4382,40905,aldLXGpzmiip2CUSDhqN8A5UpGMVUHxY,bWdj2GDclj5ofokWjzoa5jAwMkxCykd6,41,73,44,48,18,18,19,0,220,31.428571428571427,10,0.0,11,44,47,18,62,18,1,19,0,120,100,0
4383,40908,OXDIjQPBiuWpB7PdzfniEtiITaq40Kxq,RXDvfPUBYFlVdlueBFbLW0mhhAyGEqpt,2,0,0,0,0,0,2,0,2,0.2857142857142857,1,0.0,0,0,0,0,0,0,0,2,0,0,2,1
4384,40910,M2AmcvqhvMtUlyRV6vMvvoM2IhrMmAwT,A3fsA9Zfv1X2fVEQhTw51lKENdNrEqT3,132,73,46,170,29,50,29,5,402,57.42857142857143,7,0.0,8,46,170,29,65,50,0,29,5,253,149,1
4385,40911,CdB6oTxVZuxQJ7m61lQzyuJSIxL6zQLH,A3fsA9Zfv1X2fVEQhTw51lKENdNrEqT3,16,17,8,0,7,0,4,0,36,5.142857142857143,1,0.0,0,8,0,7,17,0,0,4,0,15,21,1
4386,40918,6tIWZMByN6VbFXOKgaTSsptqRovNe938,bWdj2GDclj5ofokWjzoa5jAwMkxCykd6,1,0,0,0,0,0,1,0,1,0.14285714285714285,1,0.0,0,0,0,0,0,0,0,1,0,0,1,1
4387,40920,6tIWZMByN6VbFXOKgaTSsptqRovNe938,A3fsA9Zfv1X2fVEQhTw51lKENdNrEqT3,8,4,2,0,0,1,7,1,15,2.142857142857143,2,0.0,0,2,0,0,4,1,0,7,1,2,13,1
4388,40928,qoIGs6RP8XMC5yN9VowJtSVp77FsPrRk,A3fsA9Zfv1X2fVEQhTw51lKENdNrEqT3,25,40,27,0,16,0,8,0,91,13.0,3,0.0,1,27,0,16,39,0,0,8,0,44,47,1
4389,40936,DJeWlgB4cP1RQ3JZLa1wZwd4zgAbYOxv,RXDvfPUBYFlVdlueBFbLW0mhhAyGEqpt,1,0,0,0,0,0,1,0,1,0.14285714285714285,1,0.0,0,0,0,0,0,0,0,1,0,0,1,1
4390,40946,G14xjTwMWbfsqTNiU3Ie1utHyPegqSvR,G8EPVSXsOYB5YQWZGiz1aVq5Pgr2GrQu,4,2,1,0,1,0,2,0,6,0.8571428571428571,2,0.0,0,1,0,1,2,0,0,2,0,2,4,1
4391,40947,G14xjTwMWbfsqTNiU3Ie1utHyPegqSvR,SpATywNh6bZuzm8s1ceuBUnMUAeoAHHw,14,20,4,19,0,0,4,0,47,6.714285714285714,3,0.0,5,4,18,0,15,0,1,4,0,27,20,1
4392,40959,kKw20KeSl1t7Pslb9OutpFfK6qbHmAq8,bWdj2GDclj5ofokWjzoa5jAwMkxCykd6,8,10,2,0,0,0,10,1,23,3.2857142857142856,2,0.0,4,2,0,0,6,0,0,10,1,6,17,1
4393,40965,dSPH9g8Ag2uZLcQxLXukxNXBLRvLY5xp,A3fsA9Zfv1X2fVEQhTw51lKENdNrEqT3,10,8,0,0,1,0,1,0,10,1.4285714285714286,2,0.0,0,0,0,1,8,0,0,1,0,1,9,1
4394,40994,WmqMKoevd5yMpzwxk3BDNFkg4y1FZjx5,G8EPVSXsOYB5YQWZGiz1aVq5Pgr2GrQu,46,66,9,18,8,2,19,1,123,17.571428571428573,14,0.0,1,9,15,8,65,2,3,19,1,33,90,1
4395,40998,syzcMhy375dEj89fdUtXti8MXg1a8bSN,7GRhBDsirIGkRZBtSMEzNTyDr2JQm4xx,26,58,23,54,5,1,30,0,171,24.428571428571427,3,0.0,18,23,52,5,40,1,2,30,0,98,73,1
4396,41012,9GQBKn8LG5mdPSwy8AFUPaG4NSLWjEYt,7GRhBDsirIGkRZBtSMEzNTyDr2JQm4xx,9,15,5,0,0,0,12,2,34,4.857142857142857,2,0.0,3,5,0,0,12,0,0,12,2,8,26,1
4397,41018,Htb70W0lnqw4QeBjeePevzE0xRg4O6vF,7GRhBDsirIGkRZBtSMEzNTyDr2JQm4xx,8,12,5,0,2,0,3,0,22,3.142857142857143,3,0.0,5,5,0,2,7,0,0,3,0,12,10,1
4398,41023,8Ht2Zmfn81Gwb093X2QMQmBGW6qi8rRd,7GRhBDsirIGkRZBtSMEzNTyDr2JQm4xx,41,67,27,70,26,2,9,0,201,28.714285714285715,6,0.0,31,27,60,26,36,2,10,9,0,144,57,1
4399,41059,6EuD05bZDV64mgZbOuyYsTbmEWKlO9F2,5X6FeZozNMgE2VRi3MJYjkkFK8SETtu2,4,2,1,0,1,0,4,0,8,1.1428571428571428,4,0.0,0,1,0,1,2,0,0,4,0,2,6,1
4400,41066,wb00XyLFbUrmycITZ6LeGF1mEqSeoH2s,7GRhBDsirIGkRZBtSMEzNTyDr2JQm4xx,7,6,1,12,0,0,2,0,21,3.0,1,0.0,3,1,10,0,3,0,2,2,0,14,7,1
4401,41082,DVIil2NM7ZWOtqe6rhlMzwEUAb2wuaeh,7GRhBDsirIGkRZBtSMEzNTyDr2JQm4xx,36,98,33,34,17,15,10,0,207,29.571428571428573,5,0.0,53,33,33,17,45,15,1,10,0,136,71,0
4402,41092,BkozGGotFoRWvs7kivTQvwwV5JZ8hddc,5X6FeZozNMgE2VRi3MJYjkkFK8SETtu2,16,19,12,0,3,4,9,0,47,6.714285714285714,3,0.0,0,12,0,3,19,4,0,9,0,15,32,1
4403,41111,LZT7nbUFDfOvhG31ggWghVXoB5daajKc,7GRhBDsirIGkRZBtSMEzNTyDr2JQm4xx,6,9,3,0,0,2,2,0,16,2.2857142857142856,1,0.0,3,3,0,0,6,2,0,2,0,6,10,1
4404,41157,k3YRNSEUtBfnCzCI2ffYAi1qqoCc9d8W,7GRhBDsirIGkRZBtSMEzNTyDr2JQm4xx,5,5,1,0,0,0,2,0,8,1.1428571428571428,1,0.0,0,1,0,0,5,0,0,2,0,1,7,1
4405,41204,LLeDVWTsZ6cKlGvkSg9slNHwG1UoBTzO,5X6FeZozNMgE2VRi3MJYjkkFK8SETtu2,1,0,0,0,0,0,1,0,1,0.14285714285714285,1,0.0,0,0,0,0,0,0,0,1,0,0,1,1
4406,41289,I1VndljUSmkFLMl8yI2zESYAyPlBzjwo,7GRhBDsirIGkRZBtSMEzNTyDr2JQm4xx,10,13,7,0,2,0,1,0,23,3.2857142857142856,1,0.0,4,7,0,2,9,0,0,1,0,13,10,1
4407,41300,qJQBhMSxZNb9FZGkj9PyIWzMqhMNvrJp,7GRhBDsirIGkRZBtSMEzNTyDr2JQm4xx,37,60,6,32,9,0,18,1,126,18.0,6,0.0,21,6,30,9,39,0,2,18,1,66,60,0
4408,41366,Ns35aao5T8wUPwIDoTDfhRc8L852Neqp,7GRhBDsirIGkRZBtSMEzNTyDr2JQm4xx,20,30,10,0,10,2,7,1,60,8.571428571428571,1,0.0,18,10,0,10,12,2,0,7,1,38,22,0
4409,41377,PoxO0NKuyAvBdyfzZW09NxNtHwzofyd3,7GRhBDsirIGkRZBtSMEzNTyDr2JQm4xx,5,2,1,0,1,0,2,0,6,0.8571428571428571,1,0.0,0,1,0,1,2,0,0,2,0,2,4,1
4410,41404,xbPbNw5WluotpcGvfodgid2Z7Rc8OfQr,5X6FeZozNMgE2VRi3MJYjkkFK8SETtu2,1,0,0,0,0,0,1,0,1,0.14285714285714285,1,0.0,0,0,0,0,0,0,0,1,0,0,1,1
4411,41405,wxXsB2E97PklyJnNr2rcYvINOWKCzd23,7GRhBDsirIGkRZBtSMEzNTyDr2JQm4xx,5,3,1,0,1,3,2,0,10,1.4285714285714286,2,0.0,0,1,0,1,3,3,0,2,0,2,8,0
4412,41451,5jvwyA9MThuFQ1JB0z4QxHGot11254OC,5X6FeZozNMgE2VRi3MJYjkkFK8SETtu2,1,0,0,0,0,0,1,0,1,0.14285714285714285,1,0.0,0,0,0,0,0,0,0,1,0,0,1,1
4413,41461,emCY4aIQuto3vHDbWyLccdGfPM1ClSuh,5X6FeZozNMgE2VRi3MJYjkkFK8SETtu2,1,0,0,0,0,0,1,0,1,0.14285714285714285,1,0.0,0,0,0,0,0,0,0,1,0,0,1,1
4414,41463,xg6gozDtJtmbriZIHFk0YIJKhyzF16Dg,5X6FeZozNMgE2VRi3MJYjkkFK8SETtu2,8,13,8,0,3,0,6,0,30,4.285714285714286,2,0.0,0,8,0,3,13,0,0,6,0,11,19,0
4415,41483,KqlAQr8NRKwI0MhjiYskyr4iy4QPJQrZ,7GRhBDsirIGkRZBtSMEzNTyDr2JQm4xx,4,2,1,0,0,0,2,0,5,0.7142857142857143,1,0.0,0,1,0,0,2,0,0,2,0,1,4,1
4416,41485,xg6gozDtJtmbriZIHFk0YIJKhyzF16Dg,7GRhBDsirIGkRZBtSMEzNTyDr2JQm4xx,18,42,18,2,12,0,7,0,81,11.571428571428571,3,0.0,16,18,1,12,26,0,1,7,0,47,34,1
4417,41495,w1eCZn6FuUz5n8CxQTkysG8zjugCkTfX,7GRhBDsirIGkRZBtSMEzNTyDr2JQm4xx,1,0,0,0,0,0,1,0,1,0.14285714285714285,1,0.0,0,0,0,0,0,0,0,1,0,0,1,1
4418,41501,0bsBNQsCMEE2O55Mpr8lzwhfGggHG2nb,5X6FeZozNMgE2VRi3MJYjkkFK8SETtu2,25,54,12,23,15,0,15,0,119,17.0,5,0.0,30,12,20,15,24,0,3,15,0,77,42,0
4419,41514,TDsFMiW3NmfZzVauB4oMkOZiSJ5XLe6I,7GRhBDsirIGkRZBtSMEzNTyDr2JQm4xx,25,40,9,58,3,2,21,1,134,19.142857142857142,5,0.0,17,9,52,3,23,2,6,21,1,81,53,1
4420,41521,m7HNFlUhYzKWxgjrmFGLTIf1VbbNLm66,7GRhBDsirIGkRZBtSMEzNTyDr2JQm4xx,1,0,0,0,0,0,1,0,1,0.14285714285714285,1,0.0,0,0,0,0,0,0,0,1,0,0,1,1
4421,41533,8zcddBOPFYuIEkUZpmoApSiBFpQCKBLf,7GRhBDsirIGkRZBtSMEzNTyDr2JQm4xx,5,5,1,0,0,0,3,0,9,1.2857142857142858,2,0.0,2,1,0,0,3,0,0,3,0,3,6,1
4422,41551,SmViYwWTWrMXjcjjHVYvpvTHTeWvqg4X,7GRhBDsirIGkRZBtSMEzNTyDr2JQm4xx,7,3,1,0,1,0,3,0,8,1.1428571428571428,1,0.0,0,1,0,1,3,0,0,3,0,2,6,1
4423,41564,EP1XQRGS4HZOG1hdGzNZdD1HFhJcHpos,5X6FeZozNMgE2VRi3MJYjkkFK8SETtu2,20,25,3,20,3,0,10,0,61,8.714285714285714,5,0.0,12,3,19,3,13,0,1,10,0,37,24,1
4424,41577,8niPfp9xqHHlhtnR3IY1QWUasjj0zQpl,7GRhBDsirIGkRZBtSMEzNTyDr2JQm4xx,5,2,1,0,1,0,2,0,6,0.8571428571428571,1,0.0,0,1,0,1,2,0,0,2,0,2,4,1
4425,41582,CfUHqy5TfjBtRxjNztsGxyFua9jISd0Q,7GRhBDsirIGkRZBtSMEzNTyDr2JQm4xx,48,83,34,57,26,1,11,0,212,30.285714285714285,6,0.0,42,34,48,26,41,1,9,11,0,150,62,1
4426,41618,ZqebYSMW1RUIRSXJmMzKs77Liu7pj2zF,7GRhBDsirIGkRZBtSMEzNTyDr2JQm4xx,33,34,32,0,24,4,8,1,103,14.714285714285714,3,0.0,0,32,0,24,34,4,0,8,1,56,47,1
4427,41653,nglaToodcU5Q8FzrMWGY4MUCnpZFGaF5,5X6FeZozNMgE2VRi3MJYjkkFK8SETtu2,4,4,0,0,1,0,1,0,6,0.8571428571428571,1,0.0,2,0,0,1,2,0,0,1,0,3,3,1
4428,41660,fY8o8e7SJUdWY1xaUnM6G57PgYadWViL,5X6FeZozNMgE2VRi3MJYjkkFK8SETtu2,1,0,0,0,0,0,1,0,1,0.14285714285714285,1,0.0,0,0,0,0,0,0,0,1,0,0,1,1
4429,41697,CQ8MKRcyoRQu9uvYz8G86ILjGgWWbOQv,7GRhBDsirIGkRZBtSMEzNTyDr2JQm4xx,5,5,2,0,0,0,3,0,10,1.4285714285714286,1,0.0,0,2,0,0,5,0,0,3,0,2,8,1
4430,41753,5QHXCSGlBOGq7ih6SlrH28hNQCROqU2d,7GRhBDsirIGkRZBtSMEzNTyDr2JQm4xx,2,0,0,0,0,0,3,0,3,0.42857142857142855,2,0.0,0,0,0,0,0,0,0,3,0,0,3,1
4431,41762,FJJqBn1iTJmAbav7Ov5Y4ycyF65fvY1E,7GRhBDsirIGkRZBtSMEzNTyDr2JQm4xx,3,0,0,0,0,2,5,0,7,1.0,5,0.0,0,0,0,0,0,2,0,5,0,0,7,0
4432,41792,UNnwy1ZgbFYM2Kztvg7tp4bM94xWe0nF,7GRhBDsirIGkRZBtSMEzNTyDr2JQm4xx,1,0,0,0,0,0,1,0,1,0.14285714285714285,1,0.0,0,0,0,0,0,0,0,1,0,0,1,1
4433,41795,F71ZfnryHCMhVExpC2gJVpDSfOwRuiHf,7GRhBDsirIGkRZBtSMEzNTyDr2JQm4xx,6,1,1,0,1,0,5,0,8,1.1428571428571428,1,0.0,0,1,0,1,1,0,0,5,0,2,6,1
4434,41801,3SP9iNDvUt8m67ZMqC5DpQRe6ekkTpsP,7GRhBDsirIGkRZBtSMEzNTyDr2JQm4xx,1,0,0,0,0,0,1,0,1,0.14285714285714285,1,0.0,0,0,0,0,0,0,0,1,0,0,1,1
4435,41807,txRaMeFRdTsCsziGBMMxzL5gSPIB7mbk,7GRhBDsirIGkRZBtSMEzNTyDr2JQm4xx,79,242,94,90,38,51,40,2,557,79.57142857142857,7,0.0,110,94,82,38,132,51,8,40,2,324,233,1
4436,41815,NYjtfRvfVgjdP93necZvZvYS7zFHrEkH,7GRhBDsirIGkRZBtSMEzNTyDr2JQm4xx,6,2,1,0,1,0,4,0,8,1.1428571428571428,1,0.0,0,1,0,1,2,0,0,4,0,2,6,1
4437,41844,oK1wkJMrtnbx1knb5vStqUw88huLmwS5,5Gyp41oLVo7Gg7vF4vpmggWP5MU70QO6,24,42,26,22,12,5,13,0,120,17.142857142857142,4,0.0,6,26,17,12,36,5,5,13,0,61,59,1
4438,41851,gcway7yukVhkU23YjxQt8J89R78muKel,5Gyp41oLVo7Gg7vF4vpmggWP5MU70QO6,24,34,17,14,9,40,6,1,121,17.285714285714285,3,0.0,6,17,10,9,28,40,4,6,1,42,79,1
4439,41858,uaLxZvxbm1TQQbHyJUmfD5cTdUUQTulO,5Gyp41oLVo7Gg7vF4vpmggWP5MU70QO6,8,4,3,3,1,1,3,0,15,2.142857142857143,1,0.0,0,3,2,1,4,1,1,3,0,6,9,1
4440,41875,3VG32L4W2oc0vDv6hhXZcfEhP3Rb3QH9,5Gyp41oLVo7Gg7vF4vpmggWP5MU70QO6,31,80,46,24,14,20,29,1,214,30.571428571428573,11,0.0,11,46,18,14,69,20,6,29,1,89,125,0
4441,41886,CiSU3A3dnYg9wq3LHFDed0um6sE24Rcy,5Gyp41oLVo7Gg7vF4vpmggWP5MU70QO6,7,8,3,0,1,0,2,0,14,2.0,2,0.0,2,3,0,1,6,0,0,2,0,6,8,0
4442,41909,kGiwkpye34paJt0E8ZP4DxvIGSOY6Bp8,5Gyp41oLVo7Gg7vF4vpmggWP5MU70QO6,2,0,0,0,0,0,2,0,2,0.2857142857142857,1,0.0,0,0,0,0,0,0,0,2,0,0,2,1
4443,41929,VcxKA6fBT5v15CG0tzIGW16yZ7lBAHFR,5Gyp41oLVo7Gg7vF4vpmggWP5MU70QO6,5,2,1,0,1,0,2,0,6,0.8571428571428571,1,0.0,0,1,0,1,2,0,0,2,0,2,4,1
4444,41930,ApFdQQBcLqTLoA4wIvtlnnwFs4FrlVS1,5Gyp41oLVo7Gg7vF4vpmggWP5MU70QO6,4,2,1,0,1,0,2,0,6,0.8571428571428571,2,0.0,0,1,0,1,2,0,0,2,0,2,4,1
4445,41944,GfM0TEq4MIfnphAdOO3PH37OTU8KegxW,5Gyp41oLVo7Gg7vF4vpmggWP5MU70QO6,19,25,11,19,4,3,6,1,69,9.857142857142858,4,0.0,9,11,12,4,16,3,7,6,1,36,33,1
4446,41966,h371iA4AgZEg2RakvkeOsTxClwgDiBHp,5Gyp41oLVo7Gg7vF4vpmggWP5MU70QO6,44,128,77,0,44,0,11,0,260,37.142857142857146,14,0.0,32,77,0,44,96,0,0,11,0,153,107,1
4447,41970,BYn6cWVQSMORsIVShYVRAnnkHpLyiUv8,5Gyp41oLVo7Gg7vF4vpmggWP5MU70QO6,47,249,15,51,22,25,34,0,396,56.57142857142857,16,0.0,52,15,43,22,197,25,8,34,0,132,264,0
4448,41981,35uEyKl4Buh1znVced4nodQ23qT6UkpF,5Gyp41oLVo7Gg7vF4vpmggWP5MU70QO6,39,115,48,37,28,2,13,0,243,34.714285714285715,8,0.0,38,48,26,28,77,2,11,13,0,140,103,0
4449,41986,lsWPPYsqnZVAjvZOYm6DuZ8dMXcHRRkz,5Gyp41oLVo7Gg7vF4vpmggWP5MU70QO6,20,25,13,13,4,27,12,5,99,14.142857142857142,3,0.0,4,13,8,4,21,27,5,12,5,29,70,1
4450,41989,0dTl0LLZb3MVQ7vvfkoX3uGGuSQCYhar,5Gyp41oLVo7Gg7vF4vpmggWP5MU70QO6,10,49,9,13,1,10,3,0,85,12.142857142857142,2,0.0,28,9,8,1,21,10,5,3,0,46,39,1
4451,41995,LAK3kQOhNPU7sNGCw3V3wZRUMmEaRMC4,5Gyp41oLVo7Gg7vF4vpmggWP5MU70QO6,28,57,29,30,11,33,23,6,189,27.0,6,0.0,16,29,18,11,41,33,12,23,6,74,115,1
4452,41998,oiOA4GHiqMEC6R8waIv9r60EFxyZ8MwN,5Gyp41oLVo7Gg7vF4vpmggWP5MU70QO6,1,0,0,0,0,0,1,0,1,0.14285714285714285,1,0.0,0,0,0,0,0,0,0,1,0,0,1,1
4453,42039,O5osNpvARQ134oncM7N5QGhst9sMjRtB,5Gyp41oLVo7Gg7vF4vpmggWP5MU70QO6,73,271,138,91,62,96,66,0,724,103.42857142857143,19,0.0,95,138,77,62,176,96,14,66,0,372,352,0
4454,42082,zGtXuznFoctStZvY1Kwb8pR6kY0dSZq8,5Gyp41oLVo7Gg7vF4vpmggWP5MU70QO6,5,7,3,0,1,0,2,0,13,1.8571428571428572,2,0.0,0,3,0,1,7,0,0,2,0,4,9,1
4455,42117,KoiK3xwBhqPmOEQ0SqGaoljDWNm2J5N4,5Gyp41oLVo7Gg7vF4vpmggWP5MU70QO6,8,3,1,0,1,1,4,0,10,1.4285714285714286,1,0.0,0,1,0,1,3,1,0,4,0,2,8,1
4456,42119,k0IY1JDIlHz8E9FcklcCc7M6vgU6bRMg,5Gyp41oLVo7Gg7vF4vpmggWP5MU70QO6,9,5,3,0,2,0,5,0,15,2.142857142857143,1,0.0,0,3,0,2,5,0,0,5,0,5,10,1
4457,42173,FELnhQR0c7GZZX82ioYJEZsqujOrfyf7,5Gyp41oLVo7Gg7vF4vpmggWP5MU70QO6,55,113,56,77,28,46,49,3,372,53.142857142857146,12,0.0,33,56,53,28,80,46,24,49,3,170,202,0
4458,42221,GcfrlVMG2ru9y4B409IihEpJj1fsWZwu,5Gyp41oLVo7Gg7vF4vpmggWP5MU70QO6,24,39,16,0,18,0,5,0,78,11.142857142857142,2,0.0,15,16,0,18,24,0,0,5,0,49,29,1
4459,42255,vgviVjMVNtT6tD9rdaknQn6H7E6jIs61,5Gyp41oLVo7Gg7vF4vpmggWP5MU70QO6,35,86,49,27,13,49,23,0,247,35.285714285714285,8,0.0,13,49,18,13,73,49,9,23,0,93,154,1
4460,42270,D8J1nI1EMIfxo0mlTd1mZqxYvHDgdtVN,5Gyp41oLVo7Gg7vF4vpmggWP5MU70QO6,1,0,0,0,0,0,1,0,1,0.14285714285714285,1,0.0,0,0,0,0,0,0,0,1,0,0,1,1
4461,42331,ad0B2cwqvECBfF7edrOTXlcMQTbORoHx,5Gyp41oLVo7Gg7vF4vpmggWP5MU70QO6,17,25,15,10,10,0,2,0,62,8.857142857142858,1,0.0,7,15,5,10,18,0,5,2,0,37,25,1
4462,42342,4D9TO74zb0mHkwi6G9vwCLqeflT8BNm5,5Gyp41oLVo7Gg7vF4vpmggWP5MU70QO6,38,76,38,14,25,24,17,0,194,27.714285714285715,6,0.0,27,38,10,25,49,24,4,17,0,100,94,1
4463,42352,qeHXe8DRkB9urr63HS1yAMwTxQkwIbff,5Gyp41oLVo7Gg7vF4vpmggWP5MU70QO6,1,0,0,0,0,0,1,0,1,0.14285714285714285,1,0.0,0,0,0,0,0,0,0,1,0,0,1,1
4464,42366,uSsarL0Xsecsq342KHCnn09W3eM6zSLh,5Gyp41oLVo7Gg7vF4vpmggWP5MU70QO6,13,23,10,6,12,3,3,0,57,8.142857142857142,1,0.0,10,10,3,12,13,3,3,3,0,35,22,1
4465,42367,Kw3ipO3nkJ2O6MLvUuTDqCLl9j8eQ8eR,5Gyp41oLVo7Gg7vF4vpmggWP5MU70QO6,17,28,17,17,0,63,8,0,133,19.0,4,0.0,7,17,12,0,21,63,5,8,0,36,97,1
4466,42375,UMGWwQ03Me0nRWPYI2EwBxPzOF28gAaF,5Gyp41oLVo7Gg7vF4vpmggWP5MU70QO6,1,0,0,0,0,0,1,0,1,0.14285714285714285,1,0.0,0,0,0,0,0,0,0,1,0,0,1,1
4467,42377,V7HQ93K3Oxti8xU7m9LhZ29UQMMdOT2H,5Gyp41oLVo7Gg7vF4vpmggWP5MU70QO6,6,3,2,0,1,0,2,0,8,1.1428571428571428,1,0.0,0,2,0,1,3,0,0,2,0,3,5,1
4468,42395,dJa5Hz9E0NcjdIFPhafeofUNffk7udcb,5Gyp41oLVo7Gg7vF4vpmggWP5MU70QO6,8,26,21,3,17,0,1,0,68,9.714285714285714,12,0.0,1,21,2,17,25,0,1,1,0,41,27,1
4469,42400,GbeaOKMmSDqC1iKIHijNvr7GZSfv6iUN,5Gyp41oLVo7Gg7vF4vpmggWP5MU70QO6,58,233,118,63,62,46,49,5,576,82.28571428571429,19,0.0,67,118,51,62,166,46,12,49,5,298,278,0
4470,42408,G5viWFw6vjc0kZ7aRbev4NG1fp3ajLxi,5Gyp41oLVo7Gg7vF4vpmggWP5MU70QO6,35,123,54,15,20,4,25,1,242,34.57142857142857,8,0.0,29,54,10,20,94,4,5,25,1,113,129,0
4471,42412,TKni4XynpXoISkd4OYGZxkhhQF48YfLJ,5Gyp41oLVo7Gg7vF4vpmggWP5MU70QO6,59,319,110,87,62,63,76,12,729,104.14285714285714,16,0.0,85,110,73,62,234,63,14,76,12,330,399,0
4472,42434,jpXIq3stqWScWG27acYJbNKpdTmc6kli,5Gyp41oLVo7Gg7vF4vpmggWP5MU70QO6,51,127,71,37,25,9,42,0,311,44.42857142857143,10,0.0,38,71,30,25,89,9,7,42,0,164,147,1
4473,42456,MZc1NWeYuOnQeyjxpICNnWFYpBwBXI4z,5Gyp41oLVo7Gg7vF4vpmggWP5MU70QO6,37,96,11,21,28,80,39,1,276,39.42857142857143,14,0.0,20,11,15,28,76,80,6,39,1,74,202,1
4474,42457,w8ymvO72UlYPBd2tG0A8iTEwt4UoIvlZ,5Gyp41oLVo7Gg7vF4vpmggWP5MU70QO6,53,148,82,25,19,72,54,2,402,57.42857142857143,10,0.0,26,82,21,19,122,72,4,54,2,148,254,0
4475,42472,0LlzZQtftf5FgqzUDg0nEE6UvawRFtil,5Gyp41oLVo7Gg7vF4vpmggWP5MU70QO6,1,0,0,0,0,0,2,0,2,0.2857142857142857,2,0.0,0,0,0,0,0,0,0,2,0,0,2,1
4476,42476,erNct1oh0g6Q9OxUYlh6sLY24w7nP582,5Gyp41oLVo7Gg7vF4vpmggWP5MU70QO6,23,24,13,16,10,0,3,0,66,9.428571428571429,3,0.0,6,13,8,10,18,0,8,3,0,37,29,1
4477,42479,wdyLBUXnKZHWy3hjP9iEUMTvoZlBkTI1,5Gyp41oLVo7Gg7vF4vpmggWP5MU70QO6,28,129,58,31,27,10,36,1,292,41.714285714285715,13,0.0,19,58,25,27,110,10,6,36,1,129,163,0
4478,42486,9zKzyrDc2ZLmZJn8iNzeeCTIcbRbidfo,5Gyp41oLVo7Gg7vF4vpmggWP5MU70QO6,1,0,0,0,0,0,1,0,1,0.14285714285714285,1,0.0,0,0,0,0,0,0,0,1,0,0,1,1
4479,42494,D2GOB0YSodwh6v6iFZs08FbkGvuLeJRY,5Gyp41oLVo7Gg7vF4vpmggWP5MU70QO6,14,18,8,0,5,1,5,0,37,5.285714285714286,2,0.0,3,8,0,5,15,1,0,5,0,16,21,0
4480,42497,E6rJgT1B5YorfxfA1yfh0Ek0w6vjtNrL,5Gyp41oLVo7Gg7vF4vpmggWP5MU70QO6,10,5,3,4,2,1,3,0,18,2.5714285714285716,1,0.0,1,3,2,2,4,1,2,3,0,8,10,1
4481,42505,4ZVrwOJI0OZGv0iKNXpa2OrPWHTNPSKw,5Gyp41oLVo7Gg7vF4vpmggWP5MU70QO6,15,12,9,2,5,2,5,0,35,5.0,2,0.0,0,9,1,5,12,2,1,5,0,15,20,1
4482,42612,76MsyfoydlyTteuthkqqJhd4o0zqGEPQ,5Gyp41oLVo7Gg7vF4vpmggWP5MU70QO6,12,10,6,0,5,3,4,0,28,4.0,3,0.0,0,6,0,5,10,3,0,4,0,11,17,1
4483,42624,uQjl8NGtIQkRfoe9edBiMgtYYmdkzVXR,5Gyp41oLVo7Gg7vF4vpmggWP5MU70QO6,35,122,60,21,11,5,23,0,242,34.57142857142857,9,0.0,26,60,15,11,96,5,6,23,0,112,130,1
4484,42665,TFXVbyAsdd8loouVJh53Ci08NPknpb3s,5Gyp41oLVo7Gg7vF4vpmggWP5MU70QO6,12,11,6,0,2,1,6,1,27,3.857142857142857,2,0.0,1,6,0,2,10,1,0,6,1,9,18,1
4485,42668,9H1419fPuuDHWR9HwJ4H1Qz7EYdAWgF5,5Gyp41oLVo7Gg7vF4vpmggWP5MU70QO6,1,0,0,0,0,0,1,0,1,0.14285714285714285,1,0.0,0,0,0,0,0,0,0,1,0,0,1,1
4486,42673,BKMUcOBGaQN1mC31CqWMGNL1FVFpsXK6,5Gyp41oLVo7Gg7vF4vpmggWP5MU70QO6,5,6,3,0,1,0,3,0,13,1.8571428571428572,3,0.0,0,3,0,1,6,0,0,3,0,4,9,1
4487,42725,LJlIg9qp8OR0lcGfKhExv2RRH6wpMrFW,5Gyp41oLVo7Gg7vF4vpmggWP5MU70QO6,24,37,13,4,8,0,15,0,77,11.0,4,0.0,9,13,2,8,28,0,2,15,0,32,45,1
4488,42752,Vqze90OfEzcSxQR4V2mgaBI72yQMkjOI,5Gyp41oLVo7Gg7vF4vpmggWP5MU70QO6,15,13,8,6,4,2,13,2,48,6.857142857142857,1,0.0,1,8,3,4,12,2,3,13,2,16,32,1
4489,42757,KJoE9unyVuT2DeHS57E6xLFn5ZLvwVq9,5Gyp41oLVo7Gg7vF4vpmggWP5MU70QO6,29,48,19,23,8,4,5,0,107,15.285714285714286,2,0.0,22,19,18,8,26,4,5,5,0,67,40,0
4490,42767,ruOt15ngWkrw7KeeBfsTuYT6jUinN1wc,5Gyp41oLVo7Gg7vF4vpmggWP5MU70QO6,8,7,5,0,3,0,3,0,18,2.5714285714285716,2,0.0,0,5,0,3,7,0,0,3,0,8,10,1
4491,42783,PZOAKJpr4tvUdUBjEAo2PyZb1WPiWGKg,5Gyp41oLVo7Gg7vF4vpmggWP5MU70QO6,24,57,31,10,8,6,9,1,122,17.428571428571427,2,0.0,19,31,8,8,38,6,2,9,1,66,56,1
4492,42822,hf7YI3B1kTTuvmd2vS9DIoiPGXbrQyBH,5Gyp41oLVo7Gg7vF4vpmggWP5MU70QO6,31,71,36,21,14,1,16,0,159,22.714285714285715,7,0.0,25,36,15,14,46,1,6,16,0,90,69,1
4493,42823,Gj3E64ugEAQBSvqnqCb1XRhG4lRAaeyl,5Gyp41oLVo7Gg7vF4vpmggWP5MU70QO6,12,13,8,0,3,0,8,0,32,4.571428571428571,2,0.0,0,8,0,3,13,0,0,8,0,11,21,1
4494,42829,llxTRiluZGftr8xJaXSwJljp3xP1zOiw,5Gyp41oLVo7Gg7vF4vpmggWP5MU70QO6,2,0,0,0,0,0,2,0,2,0.2857142857142857,1,0.0,0,0,0,0,0,0,0,2,0,0,2,1
4495,42838,zVdtg8NVS1UKsR7hBTuXsHvQ0Y2M8ZjR,5Gyp41oLVo7Gg7vF4vpmggWP5MU70QO6,54,220,99,62,55,52,48,5,541,77.28571428571429,15,0.0,55,99,44,55,165,52,18,48,5,253,288,0
4496,42862,Cz1MALoI2PsgcnwuxZzMreDeeJQWPhNY,5Gyp41oLVo7Gg7vF4vpmggWP5MU70QO6,1,0,0,0,0,0,1,0,1,0.14285714285714285,1,0.0,0,0,0,0,0,0,0,1,0,0,1,1
4497,42892,MkmHvjSbYbqtqaatv1G3CqgDZI0wlGAK,5Gyp41oLVo7Gg7vF4vpmggWP5MU70QO6,25,84,50,46,19,6,23,8,236,33.714285714285715,8,0.0,11,50,33,19,73,6,13,23,8,113,123,1
4498,42894,4lMCQeDalZibIqNpSbwAQSTC9B54JA0T,5Gyp41oLVo7Gg7vF4vpmggWP5MU70QO6,9,9,3,0,3,0,5,0,20,2.857142857142857,1,0.0,4,3,0,3,5,0,0,5,0,10,10,1
4499,42924,J4UXFQZe2esHAAP8EgxtBhubvEMwPUfX,5Gyp41oLVo7Gg7vF4vpmggWP5MU70QO6,1,0,0,0,0,0,1,0,1,0.14285714285714285,1,0.0,0,0,0,0,0,0,0,1,0,0,1,1
4500,42948,bhtGxozhVNlzdq3dWRuRh5gPdRPZBokV,5Gyp41oLVo7Gg7vF4vpmggWP5MU70QO6,31,66,37,30,12,2,14,0,161,23.0,7,0.0,18,37,20,12,48,2,10,14,0,87,74,0
4501,42961,P7pM2KXNzs4FXZpMC7rALMB2m6SdjKtS,5Gyp41oLVo7Gg7vF4vpmggWP5MU70QO6,1,0,0,0,0,0,1,0,1,0.14285714285714285,1,0.0,0,0,0,0,0,0,0,1,0,0,1,1
4502,42992,FHLCitbEDOO4edZKc13ZGQYp8PFDoEbA,5Gyp41oLVo7Gg7vF4vpmggWP5MU70QO6,11,4,3,0,3,2,6,1,19,2.7142857142857144,2,0.0,1,3,0,3,3,2,0,6,1,7,12,1
4503,42997,iJftBP3zncmjUCwGWSZ77IUrDb3Dt8rz,5Gyp41oLVo7Gg7vF4vpmggWP5MU70QO6,10,6,4,0,3,1,4,0,18,2.5714285714285716,1,0.0,0,4,0,3,6,1,0,4,0,7,11,1
4504,43043,QAguKdvn52pCJKW91rO3BCY8l8ZCAdvQ,5Gyp41oLVo7Gg7vF4vpmggWP5MU70QO6,39,124,58,22,27,19,38,4,292,41.714285714285715,14,0.0,24,58,17,27,100,19,5,38,4,126,166,0
4505,43066,VfXLVSMadpLR6dOrmGK0mfp43tDDaQTe,5Gyp41oLVo7Gg7vF4vpmggWP5MU70QO6,2,0,0,0,0,0,4,0,4,0.5714285714285714,1,0.0,0,0,0,0,0,0,0,4,0,0,4,1
4506,43109,j8vQBepjKMlh4tjkZefoCNI7tigVvraY,5Gyp41oLVo7Gg7vF4vpmggWP5MU70QO6,11,12,6,2,5,0,3,0,28,4.0,1,0.0,5,6,1,5,7,0,1,3,0,17,11,1
4507,43185,5vnywZCHdzItiyRXwxi8AQx0I1FZ74Wh,5Gyp41oLVo7Gg7vF4vpmggWP5MU70QO6,5,3,1,0,1,0,1,0,6,0.8571428571428571,1,0.0,0,1,0,1,3,0,0,1,0,2,4,1
4508,43186,OTADDfXEdjbhqOe8x6BG6zzzmbj4dONF,5Gyp41oLVo7Gg7vF4vpmggWP5MU70QO6,1,0,0,0,0,0,2,0,2,0.2857142857142857,1,0.0,0,0,0,0,0,0,0,2,0,0,2,1
4509,43204,p60my9bd7Og8fU9JTNJwRUF33esyebLh,5Gyp41oLVo7Gg7vF4vpmggWP5MU70QO6,4,2,1,0,1,0,1,0,5,0.7142857142857143,1,0.0,0,1,0,1,2,0,0,1,0,2,3,1
4510,43222,FKUOiQ7mB83YM8up0jg2s7w94Nin9PDr,5Gyp41oLVo7Gg7vF4vpmggWP5MU70QO6,29,78,36,14,17,2,12,0,159,22.714285714285715,4,0.0,30,36,8,17,48,2,6,12,0,91,68,1
4511,43227,00NyFDc4lSZf1P8ucpEoM7aUokrApUCD,5Gyp41oLVo7Gg7vF4vpmggWP5MU70QO6,9,5,2,0,2,1,3,1,14,2.0,1,0.0,0,2,0,2,5,1,0,3,1,4,10,1
4512,43244,97VO9s7PzgyUq9wiAbU39P4Yyn56hGke,5Gyp41oLVo7Gg7vF4vpmggWP5MU70QO6,5,3,1,0,0,0,2,0,6,0.8571428571428571,1,0.0,0,1,0,0,3,0,0,2,0,1,5,1
4513,43253,L6byFv3ZEyrwSeDN11Yz2Yw0YVBxo5al,5Gyp41oLVo7Gg7vF4vpmggWP5MU70QO6,1,0,0,0,0,0,1,0,1,0.14285714285714285,1,0.0,0,0,0,0,0,0,0,1,0,0,1,1
4514,43271,cAjVoc8wOYDE8lScDAhEgvHdzkmg6Oh2,5Gyp41oLVo7Gg7vF4vpmggWP5MU70QO6,1,0,0,0,0,0,1,0,1,0.14285714285714285,1,0.0,0,0,0,0,0,0,0,1,0,0,1,1
4515,43273,wmNYHs69T6CHydhCxfzhydbjA79LMuTD,5Gyp41oLVo7Gg7vF4vpmggWP5MU70QO6,23,47,25,3,12,6,12,1,106,15.142857142857142,6,0.0,9,25,2,12,38,6,1,12,1,48,58,0
4516,43280,7HQI7mn2kOQ2GQbTbRnlEfLi23yvP3iW,5Gyp41oLVo7Gg7vF4vpmggWP5MU70QO6,5,6,2,0,0,0,1,0,9,1.2857142857142858,1,0.0,0,2,0,0,6,0,0,1,0,2,7,1
4517,43298,32oyj5KQNMk4hi2FDjsLzckyX0oTBu94,5Gyp41oLVo7Gg7vF4vpmggWP5MU70QO6,1,0,0,0,0,0,1,0,1,0.14285714285714285,1,0.0,0,0,0,0,0,0,0,1,0,0,1,1
4518,43299,dWHieHYcD5sJPdXBDEU7p6ERE8GLy21y,5Gyp41oLVo7Gg7vF4vpmggWP5MU70QO6,18,15,9,5,4,1,7,1,42,6.0,2,0.0,1,9,3,4,14,1,2,7,1,17,25,1
4519,43304,hGRbVhPfIZgQbsXapr6yYorOesMrDVES,5Gyp41oLVo7Gg7vF4vpmggWP5MU70QO6,7,5,1,0,2,0,3,0,11,1.5714285714285714,1,0.0,1,1,0,2,4,0,0,3,0,4,7,1
4520,43322,QtC4u1cp5XPjpftAYBiUc5gRIvkjYsKW,5Gyp41oLVo7Gg7vF4vpmggWP5MU70QO6,1,0,0,0,0,0,1,0,1,0.14285714285714285,1,0.0,0,0,0,0,0,0,0,1,0,0,1,1
4521,43329,CnhEMnwVEHINgALkGyXSrJuouR8sAbhX,5Gyp41oLVo7Gg7vF4vpmggWP5MU70QO6,1,0,0,0,0,0,1,0,1,0.14285714285714285,1,0.0,0,0,0,0,0,0,0,1,0,0,1,1
4522,43360,43Vu5GdpgaDIO0UCTmo0BcEGYByItL9w,5Gyp41oLVo7Gg7vF4vpmggWP5MU70QO6,1,0,0,0,0,0,1,0,1,0.14285714285714285,1,0.0,0,0,0,0,0,0,0,1,0,0,1,1
4523,43369,8ahxSRQbWy4vPD4cYpRqfvINjHUg6K9P,5Gyp41oLVo7Gg7vF4vpmggWP5MU70QO6,7,3,2,0,2,0,2,0,9,1.2857142857142858,1,0.0,0,2,0,2,3,0,0,2,0,4,5,1
4524,43371,oe42qhXjeEjQuga6r181bRbPriFpqVix,5Gyp41oLVo7Gg7vF4vpmggWP5MU70QO6,9,9,3,8,3,0,3,0,26,3.7142857142857144,1,0.0,4,3,4,3,5,0,4,3,0,14,12,1
4525,43375,IeFJNMkGYtHM1fI1bOxjKNR0xs3f8eOI,5Gyp41oLVo7Gg7vF4vpmggWP5MU70QO6,16,17,10,8,5,0,16,0,56,8.0,9,0.0,4,10,5,5,13,0,3,16,0,24,32,0
4526,43388,j0SxBmQibmRjAaD1ulodQIAoOk5FxRjd,5Gyp41oLVo7Gg7vF4vpmggWP5MU70QO6,9,11,6,0,4,0,5,0,26,3.7142857142857144,5,0.0,0,6,0,4,11,0,0,5,0,10,16,1
4527,43398,o7l3PNeVIF0KFbKUxAraXosVaTUbHolk,3VkHkmOtom3jM2wCu94xgzzu1d6Dn7or,10,12,2,0,0,39,12,0,65,9.285714285714286,5,0.0,0,2,0,0,12,39,0,12,0,2,63,1
4528,43417,D4OCd24hr1vlj5ann2gF8MXtwkygSmZN,3VkHkmOtom3jM2wCu94xgzzu1d6Dn7or,80,141,55,46,52,0,32,0,326,46.57142857142857,9,0.0,66,55,45,52,75,0,1,32,0,218,108,0
4529,43438,uMEUDlZ1tL8WoZ2EmL0CStSYwA0zOal8,3VkHkmOtom3jM2wCu94xgzzu1d6Dn7or,72,166,60,39,40,7,32,2,346,49.42857142857143,13,0.0,64,60,32,40,102,7,7,32,2,196,150,0
4530,43444,Ru7y8duae6LbAc4AWXTCrVmvsCjQD1Id,3VkHkmOtom3jM2wCu94xgzzu1d6Dn7or,30,47,25,0,17,93,21,2,205,29.285714285714285,8,0.0,7,25,0,17,40,93,0,21,2,49,156,0
4531,43445,FogYrI2DBYQJS0Y2CCsXzbRDHnAOEuf5,3VkHkmOtom3jM2wCu94xgzzu1d6Dn7or,1,0,0,0,0,0,1,0,1,0.14285714285714285,1,0.0,0,0,0,0,0,0,0,1,0,0,1,1
4532,43500,nvDU7bHbucx9dxF7Bb2hROl3ydsRR8KW,5Gyp41oLVo7Gg7vF4vpmggWP5MU70QO6,6,7,2,0,3,0,2,0,14,2.0,1,0.0,0,2,0,3,7,0,0,2,0,5,9,1
4533,43535,9jZsAxMdQXvLjxKIorcfAyZ7kTyyk2m3,5Gyp41oLVo7Gg7vF4vpmggWP5MU70QO6,16,14,8,20,6,7,3,0,58,8.285714285714286,2,0.0,4,8,12,6,10,7,8,3,0,30,28,1
4534,43540,0jKQy4qjVAbf7KnmK0z7D4Rd4esbEOKx,5Gyp41oLVo7Gg7vF4vpmggWP5MU70QO6,10,3,2,6,1,2,9,2,25,3.5714285714285716,1,0.0,1,2,5,1,2,2,1,9,2,9,16,1
4535,43545,mmise9ZoT8sOMF3ngv5JfjmucOFyNMhB,5Gyp41oLVo7Gg7vF4vpmggWP5MU70QO6,6,1,1,0,1,0,3,0,6,0.8571428571428571,1,0.0,0,1,0,1,1,0,0,3,0,2,4,1
4536,43547,umQZ2iL6LkRNPUsdvNO54bjSWS7c2PrT,5Gyp41oLVo7Gg7vF4vpmggWP5MU70QO6,47,145,84,47,23,48,44,2,393,56.142857142857146,9,0.0,26,84,37,23,119,48,10,44,2,170,223,0
4537,43569,q1Yhi8ZMaTKIWtjkqcIhA9aMzo2tILs0,5Gyp41oLVo7Gg7vF4vpmggWP5MU70QO6,8,3,2,0,2,2,6,0,15,2.142857142857143,1,0.0,0,2,0,2,3,2,0,6,0,4,11,1
4538,43586,nYDaWGS2eCaz2ctJp9MRoxxHvQjUsB3R,5Gyp41oLVo7Gg7vF4vpmggWP5MU70QO6,6,2,1,0,1,0,5,0,9,1.2857142857142858,1,0.0,0,1,0,1,2,0,0,5,0,2,7,1
4539,43599,rb0bCeAP0PjUKM6QZmb5eDbdcmhSPRHl,5Gyp41oLVo7Gg7vF4vpmggWP5MU70QO6,1,0,0,0,0,0,1,0,1,0.14285714285714285,1,0.0,0,0,0,0,0,0,0,1,0,0,1,1
4540,43636,Djtv0PgEw9uZSQc7WiXmZsJgnFOxrvrt,5Gyp41oLVo7Gg7vF4vpmggWP5MU70QO6,19,51,13,19,8,49,10,1,151,21.571428571428573,5,0.0,11,13,11,8,40,49,8,10,1,43,108,0
4541,43641,ic2lNYBVb2jpZFbLxIr3dTwER79BLmXr,5Gyp41oLVo7Gg7vF4vpmggWP5MU70QO6,5,2,1,0,1,0,3,0,7,1.0,1,0.0,0,1,0,1,2,0,0,3,0,2,5,1
4542,43647,h6BsLrA2Q76qfUqgsVlAbhhJHS6p79uN,5Gyp41oLVo7Gg7vF4vpmggWP5MU70QO6,4,2,1,0,1,0,2,0,6,0.8571428571428571,1,0.0,0,1,0,1,2,0,0,2,0,2,4,1
4543,43649,Z1bGhtGmS6C8OjUf7z2ZCu8g4GygavBf,5Gyp41oLVo7Gg7vF4vpmggWP5MU70QO6,16,91,44,0,11,7,33,6,192,27.428571428571427,5,0.0,35,44,0,11,56,7,0,33,6,90,102,1
4544,43652,t6G2HJgvxm2eWxa54HUBXpV1ffn1iJDl,7GRhBDsirIGkRZBtSMEzNTyDr2JQm4xx,39,41,11,32,11,8,10,0,113,16.142857142857142,2,0.0,13,11,17,11,28,8,15,10,0,52,61,1
4545,43661,12aJ9sgIETRGmRcizwaK1vDrqEhnRGPU,7GRhBDsirIGkRZBtSMEzNTyDr2JQm4xx,4,2,0,0,0,0,6,0,8,1.1428571428571428,2,0.0,0,0,0,0,2,0,0,6,0,0,8,0
4546,43664,crwmDLeslvNKw8pGvXyNPlPr8wNVW5Va,7GRhBDsirIGkRZBtSMEzNTyDr2JQm4xx,4,2,1,0,1,0,1,0,5,0.7142857142857143,1,0.0,0,1,0,1,2,0,0,1,0,2,3,1
4547,43665,NrHk4qmJXuD0TsjkQSnghKpk9ZjGAOyU,7GRhBDsirIGkRZBtSMEzNTyDr2JQm4xx,31,21,18,0,12,0,6,0,57,8.142857142857142,3,0.0,0,18,0,12,21,0,0,6,0,30,27,1
4548,43668,s78QKjJp2qJWP86SKhU5XdBMn22opRSP,7GRhBDsirIGkRZBtSMEzNTyDr2JQm4xx,29,31,15,0,16,0,5,0,67,9.571428571428571,4,0.0,10,15,0,16,21,0,0,5,0,41,26,0
4549,43670,toFc16b10zKbPH9J9fAvCYQwPikiAuYv,7GRhBDsirIGkRZBtSMEzNTyDr2JQm4xx,1,0,0,0,0,0,2,0,2,0.2857142857142857,1,0.0,0,0,0,0,0,0,0,2,0,0,2,1
4550,43673,Y53vJNK6NsQxTqlgv0AKozWzT5IkWSVb,7GRhBDsirIGkRZBtSMEzNTyDr2JQm4xx,11,21,10,9,0,0,6,0,46,6.571428571428571,4,0.0,2,10,6,0,19,0,3,6,0,18,28,0
4551,43675,gnTcbZ4BOuQk0BfuzZDpGiEEYJSGOrYu,7GRhBDsirIGkRZBtSMEzNTyDr2JQm4xx,33,54,7,17,13,0,2,0,93,13.285714285714286,1,0.0,31,7,10,13,23,0,7,2,0,61,32,0
4552,43676,1xkoUHkZYS3vEMwGpVsB3i4SGo9SpX8l,7GRhBDsirIGkRZBtSMEzNTyDr2JQm4xx,7,3,2,0,2,0,2,0,9,1.2857142857142858,1,0.0,0,2,0,2,3,0,0,2,0,4,5,1
4553,43678,aVeyGdrz6Ir4LmiLkJqBoRjG1lQ7MsV8,7GRhBDsirIGkRZBtSMEzNTyDr2JQm4xx,6,9,3,0,1,0,2,0,15,2.142857142857143,1,0.0,4,3,0,1,5,0,0,2,0,8,7,1
4554,43680,eakdJaYNzY2KmT602U8CscAjNHHpGkgl,7GRhBDsirIGkRZBtSMEzNTyDr2JQm4xx,6,7,0,0,0,0,3,0,10,1.4285714285714286,1,0.0,1,0,0,0,6,0,0,3,0,1,9,1
4555,43682,aw4yklySZ6X6NR1UQ1UVCI8ad86zeBd9,7GRhBDsirIGkRZBtSMEzNTyDr2JQm4xx,2,0,0,0,0,0,3,0,3,0.42857142857142855,1,0.0,0,0,0,0,0,0,0,3,0,0,3,1
4556,43686,ieZvhJkTCgLXDudCJD5a3Q8XrFF7c982,7GRhBDsirIGkRZBtSMEzNTyDr2JQm4xx,26,55,18,0,15,2,3,1,94,13.428571428571429,1,0.0,34,18,0,15,21,2,0,3,1,67,27,1
4557,43687,A7tHWOZtAjCVDU6Pkr6MtHjmqydOP5Uv,7GRhBDsirIGkRZBtSMEzNTyDr2JQm4xx,1,0,0,0,0,0,1,0,1,0.14285714285714285,1,0.0,0,0,0,0,0,0,0,1,0,0,1,1
4558,43688,xGVjN54MWUnGiNvAvxY0cQuGMCPuQlWa,7GRhBDsirIGkRZBtSMEzNTyDr2JQm4xx,23,50,18,8,12,3,7,0,98,14.0,1,0.0,16,18,5,12,34,3,3,7,0,51,47,1
4559,43690,FpmZG28mfvYxYytrb579vFO9KWSaFKbr,7GRhBDsirIGkRZBtSMEzNTyDr2JQm4xx,1,0,0,0,0,0,1,0,1,0.14285714285714285,1,0.0,0,0,0,0,0,0,0,1,0,0,1,1
4560,43691,0Cj3x86BuVbVsoa8L3TC7owR7C7fzN1u,7GRhBDsirIGkRZBtSMEzNTyDr2JQm4xx,2,0,0,0,0,0,2,0,2,0.2857142857142857,1,0.0,0,0,0,0,0,0,0,2,0,0,2,0
4561,43692,GEz39roWwtdxB5Iy4Eh7CCr3IDWGQuBF,7GRhBDsirIGkRZBtSMEzNTyDr2JQm4xx,1,0,0,0,0,0,2,0,2,0.2857142857142857,1,0.0,0,0,0,0,0,0,0,2,0,0,2,0
4562,43695,z0WA70zlCYNC0D6ukf1TU1erCNwbETr4,7GRhBDsirIGkRZBtSMEzNTyDr2JQm4xx,9,11,0,4,1,0,3,0,19,2.7142857142857144,2,0.0,3,0,2,1,8,0,2,3,0,6,13,1
4563,43703,dGN0aBrc4HEf76OfjPbKhXTbhv3uUUfQ,7GRhBDsirIGkRZBtSMEzNTyDr2JQm4xx,1,0,0,0,0,0,1,0,1,0.14285714285714285,1,0.0,0,0,0,0,0,0,0,1,0,0,1,1
4564,43711,astaomdRwCWRae7GfR14orvLqERJnyWg,7GRhBDsirIGkRZBtSMEzNTyDr2JQm4xx,49,61,27,66,11,18,20,3,206,29.428571428571427,5,0.0,27,27,60,11,34,18,6,20,3,125,81,0
4565,43712,HmWRxxzZH33xiAvl793Co880fq0frlVo,7GRhBDsirIGkRZBtSMEzNTyDr2JQm4xx,60,186,4,30,10,37,16,0,283,40.42857142857143,6,0.0,33,4,15,10,153,37,15,16,0,62,221,0
4566,43715,NhRNk4mLUp7p5Zk6Fq6M7Wts8nU0uXtP,7GRhBDsirIGkRZBtSMEzNTyDr2JQm4xx,2,0,0,0,0,0,2,0,2,0.2857142857142857,1,0.0,0,0,0,0,0,0,0,2,0,0,2,0
4567,43720,Xl1we0e09OJ8ZoVNnU3bW8wK34y6zhWd,7GRhBDsirIGkRZBtSMEzNTyDr2JQm4xx,3,0,0,0,0,0,3,0,3,0.42857142857142855,1,0.0,0,0,0,0,0,0,0,3,0,0,3,1
4568,43722,e1obZM1bAHvfZHkoYcbAKIAxfJj6crMT,7GRhBDsirIGkRZBtSMEzNTyDr2JQm4xx,5,2,1,0,1,0,3,0,7,1.0,1,0.0,0,1,0,1,2,0,0,3,0,2,5,1
4569,43723,oAAfZtvy6SFGuoVCQRrpt3GFY5Q7HK2Q,7GRhBDsirIGkRZBtSMEzNTyDr2JQm4xx,1,0,0,0,0,0,1,0,1,0.14285714285714285,1,0.0,0,0,0,0,0,0,0,1,0,0,1,1
4570,43724,bbBEHMN2ei4wG0H7nW7BSSaBcqs1CEnx,7GRhBDsirIGkRZBtSMEzNTyDr2JQm4xx,13,37,11,0,17,1,12,0,78,11.142857142857142,2,0.0,21,11,0,17,16,1,0,12,0,49,29,1
4571,43725,6QRfbLtBjFn7GPZrNgqut0wbkSDHHl9M,7GRhBDsirIGkRZBtSMEzNTyDr2JQm4xx,29,23,2,140,1,0,3,0,169,24.142857142857142,2,0.0,10,2,127,1,13,0,13,3,0,140,29,1
4572,43729,qeWOInijveNxEnqq9sukLDxMYUdDSaqr,7GRhBDsirIGkRZBtSMEzNTyDr2JQm4xx,16,21,1,9,1,2,6,1,41,5.857142857142857,1,0.0,12,1,6,1,9,2,3,6,1,20,21,0
4573,43730,kBnoFgMnVWJjqzAf1W1HOC08sES7LnRY,7GRhBDsirIGkRZBtSMEzNTyDr2JQm4xx,1,0,0,0,0,0,1,0,1,0.14285714285714285,1,0.0,0,0,0,0,0,0,0,1,0,0,1,0
4574,43743,PX7SKELqfg9GcSxv3pfpJ8wHrnBmDB4L,7GRhBDsirIGkRZBtSMEzNTyDr2JQm4xx,6,3,2,0,2,0,1,0,8,1.1428571428571428,1,0.0,0,2,0,2,3,0,0,1,0,4,4,1
4575,43744,hmZiTeS7MpL9XKSxVzJIvoy7Uwns8WLt,7GRhBDsirIGkRZBtSMEzNTyDr2JQm4xx,13,15,8,4,5,2,11,1,46,6.571428571428571,2,0.0,2,8,3,5,13,2,1,11,1,18,28,0
4576,43745,NIlxh2g7VTAquieuVc9RGErPkOzbSh2Z,7GRhBDsirIGkRZBtSMEzNTyDr2JQm4xx,11,22,6,0,5,0,1,0,34,4.857142857142857,1,0.0,0,6,0,5,22,0,0,1,0,11,23,1
4577,43993,p0RuxkRTmLRS6ii3YN8z6W4Bqa7AYRuD,fbPkOYLVPtPgIt0MxizjfFJov3JbHyAi,7,3,2,0,2,1,4,0,12,1.7142857142857142,1,0.0,0,2,0,2,3,1,0,4,0,4,8,1
4578,43994,hWE8YlXrkle820sTOY1UXpm2QbX0rLTx,fbPkOYLVPtPgIt0MxizjfFJov3JbHyAi,21,25,14,1,12,12,9,1,74,10.571428571428571,2,0.0,6,14,1,12,19,12,0,9,1,33,41,1
4579,43995,diyFwrzJDqdxnswzs6l8ZdAq590WR6Is,fbPkOYLVPtPgIt0MxizjfFJov3JbHyAi,5,4,0,0,0,1,14,3,22,3.142857142857143,1,0.0,0,0,0,0,4,1,0,14,3,0,22,1
4580,43996,aNKQixLt1xurBtrkCE5j4vCWMytj94zC,fbPkOYLVPtPgIt0MxizjfFJov3JbHyAi,7,14,6,0,3,7,11,0,41,5.857142857142857,3,0.0,0,6,0,3,14,7,0,11,0,9,32,1
4581,43997,mtCGwN4OvCoCnbzMbutLT6Nf2wxkcaDu,fbPkOYLVPtPgIt0MxizjfFJov3JbHyAi,3,1,0,0,0,0,2,0,3,0.42857142857142855,1,0.0,0,0,0,0,1,0,0,2,0,0,3,1
4582,43999,sCVKWDTf6SABzbHNn99T0WibbkC7xg03,fbPkOYLVPtPgIt0MxizjfFJov3JbHyAi,1,0,0,0,0,0,1,0,1,0.14285714285714285,1,0.0,0,0,0,0,0,0,0,1,0,0,1,1
4583,44000,7iDvRXsYqjRdgImengAvKZVd91CAi3lD,fbPkOYLVPtPgIt0MxizjfFJov3JbHyAi,10,13,8,0,4,4,6,2,37,5.285714285714286,2,0.0,2,8,0,4,11,4,0,6,2,14,23,1
4584,44001,mJn5S64R5TbyphUPASOXDVT6KwPqgFqV,fbPkOYLVPtPgIt0MxizjfFJov3JbHyAi,26,25,14,13,11,22,10,1,96,13.714285714285714,2,0.0,8,14,12,11,17,22,1,10,1,45,51,1
4585,44002,u11lG1A4K1gIhpOqkswgAj4EhDI0xOZ0,fbPkOYLVPtPgIt0MxizjfFJov3JbHyAi,7,3,2,0,2,0,6,0,13,1.8571428571428572,1,0.0,0,2,0,2,3,0,0,6,0,4,9,1
4586,44003,DDTIWqk6JJRrEvr9d9O7DmY1OYVdzDEA,fbPkOYLVPtPgIt0MxizjfFJov3JbHyAi,10,7,4,0,3,2,8,1,25,3.5714285714285716,1,0.0,1,4,0,3,6,2,0,8,1,8,17,1
4587,44004,d8EMxzMifzqQKHyC0riOTQo2zuIYKTb1,fbPkOYLVPtPgIt0MxizjfFJov3JbHyAi,11,9,6,0,4,5,7,0,31,4.428571428571429,1,0.0,0,6,0,4,9,5,0,7,0,10,21,1
4588,44005,J8NkUmSvsrLHkKNXPhFg7o0pG3K7Aywh,fbPkOYLVPtPgIt0MxizjfFJov3JbHyAi,20,26,13,18,9,51,6,0,123,17.571428571428573,3,0.0,7,13,16,9,19,51,2,6,0,45,78,0
4589,44006,hjUSUM6roI2mLGkMAqBjE0uxFRBSMYHJ,fbPkOYLVPtPgIt0MxizjfFJov3JbHyAi,7,3,2,0,2,4,4,0,15,2.142857142857143,2,0.0,0,2,0,2,3,4,0,4,0,4,11,1
4590,44011,DBl87nF6WTgoCD6kgTHVE2oB45pDEn6y,fbPkOYLVPtPgIt0MxizjfFJov3JbHyAi,7,7,5,0,3,0,2,0,17,2.4285714285714284,2,0.0,0,5,0,3,7,0,0,2,0,8,9,1
4591,44013,p2au3FOExtiqsg1tYoyGj3KNDXCc91mB,fbPkOYLVPtPgIt0MxizjfFJov3JbHyAi,10,6,4,0,3,1,7,1,22,3.142857142857143,1,0.0,0,4,0,3,6,1,0,7,1,7,15,1
4592,44014,x7XiHrvKEMpxKuTFiRO880d5p07e6S97,fbPkOYLVPtPgIt0MxizjfFJov3JbHyAi,8,2,2,0,2,1,3,1,11,1.5714285714285714,1,0.0,0,2,0,2,2,1,0,3,1,4,7,1
4593,44016,FssYjkUANdoULgFGTzw1AQpi3Hr9RmSx,fbPkOYLVPtPgIt0MxizjfFJov3JbHyAi,7,4,2,0,2,2,4,0,14,2.0,1,0.0,0,2,0,2,4,2,0,4,0,4,10,1
4594,44018,qKfZusm0R8jxltESvgi15dswdw73Gjlp,fbPkOYLVPtPgIt0MxizjfFJov3JbHyAi,11,14,3,0,3,0,3,0,23,3.2857142857142856,2,0.0,0,3,0,3,14,0,0,3,0,6,17,1
4595,44020,Z2WYkCILkqUB8wo1t1Cu8aCpPedEwo19,fbPkOYLVPtPgIt0MxizjfFJov3JbHyAi,5,3,1,0,1,0,1,0,6,0.8571428571428571,1,0.0,0,1,0,1,3,0,0,1,0,2,4,1
4596,44022,PDXGFyBPYCflMZuvp1Ir4M4S3e0nyboZ,fbPkOYLVPtPgIt0MxizjfFJov3JbHyAi,44,182,80,27,22,75,40,0,426,60.857142857142854,16,0.0,30,80,24,22,152,75,3,40,0,156,270,1
4597,44023,YB6Mdw3HVis2k9yXIV8Bn5gVXQ6GVqTU,fbPkOYLVPtPgIt0MxizjfFJov3JbHyAi,5,5,0,0,0,4,4,0,13,1.8571428571428572,2,0.0,0,0,0,0,5,4,0,4,0,0,13,1
4598,44025,26PDrRJYSMH6uI6XnAwbn1s6xjvZitk1,fbPkOYLVPtPgIt0MxizjfFJov3JbHyAi,5,2,1,0,1,0,3,0,7,1.0,1,0.0,0,1,0,1,2,0,0,3,0,2,5,1
4599,44026,A1Bqk2hgKzNE6O0Jd3HBtI2AJixgnU9D,fbPkOYLVPtPgIt0MxizjfFJov3JbHyAi,8,3,2,0,2,2,5,0,14,2.0,1,0.0,0,2,0,2,3,2,0,5,0,4,10,1
4600,44029,cDtNKVgke675efaANxs81gywhUCG6Xvn,fbPkOYLVPtPgIt0MxizjfFJov3JbHyAi,2,0,0,0,0,0,2,0,2,0.2857142857142857,1,0.0,0,0,0,0,0,0,0,2,0,0,2,1
4601,44030,AqCPWoJ3Xqrj0YuS9VE2yr3qK1da6ZEL,fbPkOYLVPtPgIt0MxizjfFJov3JbHyAi,6,2,1,0,1,8,4,0,16,2.2857142857142856,2,0.0,0,1,0,1,2,8,0,4,0,2,14,1
4602,44031,wg3Aluyuv2BxZCQwpp08tOXwIGHtBXla,fbPkOYLVPtPgIt0MxizjfFJov3JbHyAi,9,6,3,0,4,0,13,1,27,3.857142857142857,3,0.0,3,3,0,4,3,0,0,13,1,10,17,1
4603,44033,jCGl2la0U6McatWubPbo3ygrfz4SQroM,fbPkOYLVPtPgIt0MxizjfFJov3JbHyAi,2,0,0,0,0,0,2,0,2,0.2857142857142857,1,0.0,0,0,0,0,0,0,0,2,0,0,2,1
4604,44035,AOTrlTWQ3Oa2ClznlEkXg5ypb6eqlCbx,fbPkOYLVPtPgIt0MxizjfFJov3JbHyAi,11,6,4,0,3,1,11,3,28,4.0,2,0.0,0,4,0,3,6,1,0,11,3,7,21,1
4605,44037,R2NtjVNHKdme1jYGEGYDv7qM6g83uuPF,fbPkOYLVPtPgIt0MxizjfFJov3JbHyAi,10,9,6,0,3,1,6,0,25,3.5714285714285716,1,0.0,0,6,0,3,9,1,0,6,0,9,16,1
4606,44038,3JmWuBfNEBLNWjaLSdiSh8Z86NQq0lk7,fbPkOYLVPtPgIt0MxizjfFJov3JbHyAi,15,23,1,5,1,9,7,1,47,6.714285714285714,1,0.0,3,1,4,1,20,9,1,7,1,9,38,1
4607,44039,4yBRvdZ1Q3XWGsAQkRh6UnzQ7WibjAOe,fbPkOYLVPtPgIt0MxizjfFJov3JbHyAi,7,8,6,0,4,0,7,0,25,3.5714285714285716,1,0.0,0,6,0,4,8,0,0,7,0,10,15,1
4608,44042,4QPOXaQgHIrhjYrZ52sVeohXb5o3Oznm,fbPkOYLVPtPgIt0MxizjfFJov3JbHyAi,2,0,0,0,0,0,2,0,2,0.2857142857142857,1,0.0,0,0,0,0,0,0,0,2,0,0,2,1
4609,44043,s8VWFWImIYSA2JA5l16L3WRLI25ddNXq,fbPkOYLVPtPgIt0MxizjfFJov3JbHyAi,11,21,5,1,8,7,11,0,53,7.571428571428571,3,0.0,13,5,1,8,8,7,0,11,0,27,26,1
4610,44045,HfDg6ZshQIIsqHP26E57zcevXCtObxuT,fbPkOYLVPtPgIt0MxizjfFJov3JbHyAi,1,0,0,0,0,0,2,0,2,0.2857142857142857,1,0.0,0,0,0,0,0,0,0,2,0,0,2,1
4611,44047,SJEqwoHZ7xXB9jGS9EmfQals4M4vlWb2,fbPkOYLVPtPgIt0MxizjfFJov3JbHyAi,5,3,1,0,1,0,5,0,10,1.4285714285714286,1,0.0,0,1,0,1,3,0,0,5,0,2,8,1
4612,44048,YmdgsFslyipuqAvTNMUf5cKIo7lT9UI2,fbPkOYLVPtPgIt0MxizjfFJov3JbHyAi,9,12,4,0,2,0,3,0,21,3.0,1,0.0,2,4,0,2,10,0,0,3,0,8,13,1
4613,44050,VeCExJm9PxMsppGBNIELDYWjqzgCI8lp,fbPkOYLVPtPgIt0MxizjfFJov3JbHyAi,6,3,2,0,2,0,1,0,8,1.1428571428571428,1,0.0,0,2,0,2,3,0,0,1,0,4,4,1
4614,44051,AmoWrYr0vE5hXRkVUs4W3twtpkRI6UWn,fbPkOYLVPtPgIt0MxizjfFJov3JbHyAi,10,19,9,0,6,14,9,1,58,8.285714285714286,3,0.0,4,9,0,6,15,14,0,9,1,19,39,1
4615,44053,eoxsaFPg8O2Z1ERwXNqkhtxGChEAvpFr,fbPkOYLVPtPgIt0MxizjfFJov3JbHyAi,6,8,2,2,2,0,1,0,15,2.142857142857143,1,0.0,5,2,2,2,3,0,0,1,0,11,4,1
4616,44055,aosFpeLMqBiLLcyUKYcbUuWGCjQbFGiD,fbPkOYLVPtPgIt0MxizjfFJov3JbHyAi,11,5,4,0,4,1,3,0,17,2.4285714285714284,1,0.0,0,4,0,4,5,1,0,3,0,8,9,1
4617,44056,pdAqVvKgeCIaihAcxhTXOYjPQxxjaa8K,fbPkOYLVPtPgIt0MxizjfFJov3JbHyAi,5,3,2,0,0,0,2,0,7,1.0,1,0.0,0,2,0,0,3,0,0,2,0,2,5,1
4618,44059,VCAUk6CdtYtSQUkeIHqrUkYmOmbAoytN,fbPkOYLVPtPgIt0MxizjfFJov3JbHyAi,12,16,13,0,10,9,7,0,55,7.857142857142857,4,0.0,0,13,0,10,16,9,0,7,0,23,32,1
4619,44061,YnLmtd3JRb0zimQpfWrFNcrwemvknDW5,fbPkOYLVPtPgIt0MxizjfFJov3JbHyAi,2,0,0,0,0,0,4,0,4,0.5714285714285714,1,0.0,0,0,0,0,0,0,0,4,0,0,4,1
4620,44064,sclpC2Q9gGuchXaYOn9jBhR0HTWTR3aT,fbPkOYLVPtPgIt0MxizjfFJov3JbHyAi,2,0,0,0,0,0,2,0,2,0.2857142857142857,1,0.0,0,0,0,0,0,0,0,2,0,0,2,1
4621,44065,MdDhGnwj5ASXKbZjKBE4rTINrZJxZKmf,fbPkOYLVPtPgIt0MxizjfFJov3JbHyAi,5,3,1,0,1,0,1,0,6,0.8571428571428571,1,0.0,0,1,0,1,3,0,0,1,0,2,4,1
4622,44066,YRnTGuoAQA7UM3uV59YNXUYN4n1CR9jv,fbPkOYLVPtPgIt0MxizjfFJov3JbHyAi,5,2,1,0,1,2,3,0,9,1.2857142857142858,1,0.0,0,1,0,1,2,2,0,3,0,2,7,1
4623,44067,j8RhTJjYDyhhJwKuX9dEaH9i8I1ldsXI,fbPkOYLVPtPgIt0MxizjfFJov3JbHyAi,6,1,1,0,1,0,5,0,8,1.1428571428571428,1,0.0,0,1,0,1,1,0,0,5,0,2,6,1
4624,44068,L5YuT98afVAOrSauv1O87vabcuU5P3FK,fbPkOYLVPtPgIt0MxizjfFJov3JbHyAi,9,6,4,0,4,15,4,0,33,4.714285714285714,2,0.0,1,4,0,4,5,15,0,4,0,9,24,1
4625,44073,IvyZt31HCtjMQMuaWC4jdk1sB0Xv7ntN,fbPkOYLVPtPgIt0MxizjfFJov3JbHyAi,2,0,0,0,0,0,2,0,2,0.2857142857142857,1,0.0,0,0,0,0,0,0,0,2,0,0,2,1
4626,44074,2ZTBzb1Y4dwuOwNiUUSWB6SyHlRXxNso,fbPkOYLVPtPgIt0MxizjfFJov3JbHyAi,7,8,6,0,5,3,2,0,24,3.4285714285714284,2,0.0,0,6,0,5,8,3,0,2,0,11,13,1
4627,44075,igbWLwpgdT3vH8N8WUDj5bw0PNuf5yJu,fbPkOYLVPtPgIt0MxizjfFJov3JbHyAi,5,0,0,0,0,1,10,1,12,1.7142857142857142,1,0.0,0,0,0,0,0,1,0,10,1,0,12,1
4628,44077,O8WpIn8YZlC9fwaPz6HgwkG3VYK9Pnk2,fbPkOYLVPtPgIt0MxizjfFJov3JbHyAi,45,51,34,37,22,13,13,1,171,24.428571428571427,3,0.0,10,34,31,22,41,13,6,13,1,97,74,1
4629,44078,QR9tTgqPj604qYCY9eaTIBAzrFpNWrLy,fbPkOYLVPtPgIt0MxizjfFJov3JbHyAi,11,22,7,8,11,0,7,0,55,7.857142857142857,1,0.0,10,7,6,11,12,0,2,7,0,34,21,1
4630,44080,bheLkhWEWGgBqIkahX9VmPOuI7dx9l0C,fbPkOYLVPtPgIt0MxizjfFJov3JbHyAi,9,5,3,0,2,1,8,0,19,2.7142857142857144,2,0.0,0,3,0,2,5,1,0,8,0,5,14,1
4631,44082,YzWgrkJXzobheYWSTdIFQuZL9QRQEEwo,fbPkOYLVPtPgIt0MxizjfFJov3JbHyAi,15,23,9,0,8,9,20,2,71,10.142857142857142,5,0.0,0,9,0,8,23,9,0,20,2,17,54,1
4632,44085,k3g7vGyejcBHPAYTerpXAPXP3aDlXECc,fbPkOYLVPtPgIt0MxizjfFJov3JbHyAi,12,13,5,4,5,0,5,0,32,4.571428571428571,3,0.0,3,5,3,5,10,0,1,5,0,16,16,1
4633,44086,RdUl2sUA9mfz6RQdwlY0IjEO1TB3V6He,fbPkOYLVPtPgIt0MxizjfFJov3JbHyAi,5,3,1,0,1,6,5,0,16,2.2857142857142856,1,0.0,0,1,0,1,3,6,0,5,0,2,14,1
4634,44087,lFoBW5pwyNxgkXXOh07oCGiEJfc9EI9m,fbPkOYLVPtPgIt0MxizjfFJov3JbHyAi,12,4,4,0,4,0,14,0,26,3.7142857142857144,1,0.0,0,4,0,4,4,0,0,14,0,8,18,1
4635,44088,lROQAiXdM7cGoWUW60LyDcyoBjMP9r3o,fbPkOYLVPtPgIt0MxizjfFJov3JbHyAi,3,2,0,0,0,0,1,0,3,0.42857142857142855,1,0.0,0,0,0,0,2,0,0,1,0,0,3,1
4636,44089,No6TsyszmhFBqFzsKXtnzkYT0Jt4BFGw,fbPkOYLVPtPgIt0MxizjfFJov3JbHyAi,25,62,31,18,22,56,20,9,218,31.142857142857142,5,0.0,18,31,14,22,44,56,4,20,9,85,133,0
4637,44090,8nAPL0mPQAW1c0oKz3Cmzoe0fblYTaaz,fbPkOYLVPtPgIt0MxizjfFJov3JbHyAi,8,6,4,0,3,0,4,0,17,2.4285714285714284,2,0.0,0,4,0,3,6,0,0,4,0,7,10,1
4638,44091,UzZPsoX0fPCsbykjSOoJQOmAIToD9VOQ,fbPkOYLVPtPgIt0MxizjfFJov3JbHyAi,4,2,1,0,1,0,1,0,5,0.7142857142857143,1,0.0,0,1,0,1,2,0,0,1,0,2,3,1
4639,44092,sLiNYOqDfBlMo7O3bGWUzk1xVOtexeDN,fbPkOYLVPtPgIt0MxizjfFJov3JbHyAi,6,3,2,0,2,0,1,0,8,1.1428571428571428,1,0.0,0,2,0,2,3,0,0,1,0,4,4,1
4640,44094,Y5EybULOrY5dAmMMQWE7bK5wg4bsR2Lr,fbPkOYLVPtPgIt0MxizjfFJov3JbHyAi,19,28,15,2,7,0,8,0,60,8.571428571428571,3,0.0,2,15,2,7,26,0,0,8,0,26,34,1
4641,44096,MvkVXPKImqjQobZ7zCJXq4GfQ4IthLq9,fbPkOYLVPtPgIt0MxizjfFJov3JbHyAi,7,2,1,0,1,0,6,1,11,1.5714285714285714,1,0.0,0,1,0,1,2,0,0,6,1,2,9,1
4642,44098,XMrYl2ASKmtprKkSXb8ccJGHLdsrFHJk,fbPkOYLVPtPgIt0MxizjfFJov3JbHyAi,5,0,0,0,0,4,10,1,15,2.142857142857143,1,0.0,0,0,0,0,0,4,0,10,1,0,15,1
4643,44099,ZD3ToNRRIcmCEA8K3LVmNsFQ0Leu0MkF,fbPkOYLVPtPgIt0MxizjfFJov3JbHyAi,7,3,2,0,2,0,4,0,11,1.5714285714285714,1,0.0,0,2,0,2,3,0,0,4,0,4,7,1
4644,44100,ANJ7A7TrnpRJsv1mG7Zq08b8gsBzPJqI,fbPkOYLVPtPgIt0MxizjfFJov3JbHyAi,9,18,11,2,6,22,9,0,68,9.714285714285714,2,0.0,2,11,2,6,16,22,0,9,0,21,47,1
4645,44101,VwVgSiouEmdKXwssd2MCisWFwFtWB9Im,fbPkOYLVPtPgIt0MxizjfFJov3JbHyAi,7,7,3,0,1,0,3,0,14,2.0,2,0.0,0,3,0,1,7,0,0,3,0,4,10,1
4646,44103,A7lXg14ZXc0SEgbl8pEzN5LJNLnibxLn,fbPkOYLVPtPgIt0MxizjfFJov3JbHyAi,4,0,0,0,0,1,9,0,10,1.4285714285714286,1,0.0,0,0,0,0,0,1,0,9,0,0,10,1
4647,44104,v6ULfJ1wWpantgoVZXel0J0DDCWEkouX,fbPkOYLVPtPgIt0MxizjfFJov3JbHyAi,7,2,1,0,1,0,5,0,9,1.2857142857142858,1,0.0,0,1,0,1,2,0,0,5,0,2,7,1
4648,44105,LmCwIRpUqSmmlWIBPK14fUA8Auzaletz,fbPkOYLVPtPgIt0MxizjfFJov3JbHyAi,8,10,5,0,4,5,7,0,31,4.428571428571429,2,0.0,2,5,0,4,8,5,0,7,0,11,20,1
4649,44106,futHw5ylJYoore6oNuefdx05Xc1Es6E8,fbPkOYLVPtPgIt0MxizjfFJov3JbHyAi,18,62,24,4,13,1,14,2,120,17.142857142857142,9,0.0,9,24,4,13,53,1,0,14,2,50,70,1
4650,44107,671RbTfA5jsL1XLdOXGDRlUV35MrYEo2,fbPkOYLVPtPgIt0MxizjfFJov3JbHyAi,2,0,0,0,0,0,5,0,5,0.7142857142857143,1,0.0,0,0,0,0,0,0,0,5,0,0,5,1
4651,44108,05K9eYg3CyRfEGjA2jN84Kisnns0xWMm,fbPkOYLVPtPgIt0MxizjfFJov3JbHyAi,9,6,3,0,4,0,4,0,17,2.4285714285714284,1,0.0,2,3,0,4,4,0,0,4,0,9,8,1
4652,44109,2yhMB5G7BP9mjaTBhgm2Ob8NSOmIWTch,fbPkOYLVPtPgIt0MxizjfFJov3JbHyAi,5,2,1,0,1,6,4,0,14,2.0,1,0.0,0,1,0,1,2,6,0,4,0,2,12,1
4653,44110,e4cZqrYucFu6WeO5quZuqBqXvsVJ1X82,fbPkOYLVPtPgIt0MxizjfFJov3JbHyAi,4,2,1,0,1,2,2,0,8,1.1428571428571428,2,0.0,0,1,0,1,2,2,0,2,0,2,6,1
4654,44113,2X7VWDc6h4sEfr5aWwtNfHXgmbohmuZY,fbPkOYLVPtPgIt0MxizjfFJov3JbHyAi,8,3,2,0,2,0,5,0,12,1.7142857142857142,1,0.0,0,2,0,2,3,0,0,5,0,4,8,1
4655,44114,Hnsg2RdEy94EzQKO2WfhQn1bhDkIZpuP,fbPkOYLVPtPgIt0MxizjfFJov3JbHyAi,16,63,34,0,10,26,20,3,156,22.285714285714285,7,0.0,8,34,0,10,55,26,0,20,3,52,104,1
4656,44116,6A60zadtj8FKi84VaMeYcSvKWRtVJvs6,fbPkOYLVPtPgIt0MxizjfFJov3JbHyAi,6,9,0,0,0,12,6,0,27,3.857142857142857,1,0.0,2,0,0,0,7,12,0,6,0,2,25,1
4657,44117,0MmMvk8S1ad0tMPIPxO3E9ZWoQTH5ohX,fbPkOYLVPtPgIt0MxizjfFJov3JbHyAi,32,34,21,0,17,0,11,0,83,11.857142857142858,2,0.0,5,21,0,17,29,0,0,11,0,43,40,1
4658,44120,FTBGY79AZl1FhUSv46TguNvaQwPqRnW0,fbPkOYLVPtPgIt0MxizjfFJov3JbHyAi,6,8,4,0,1,7,3,0,23,3.2857142857142856,2,0.0,0,4,0,1,8,7,0,3,0,5,18,1
4659,44121,6adUsSvPO0BlKLyJ63pGCXpdZbbHOrC1,fbPkOYLVPtPgIt0MxizjfFJov3JbHyAi,7,3,2,0,2,0,3,0,10,1.4285714285714286,1,0.0,0,2,0,2,3,0,0,3,0,4,6,1
4660,44124,YDpcKYv6zEDbgKCrCZaLRWDXdGnmbBrJ,fbPkOYLVPtPgIt0MxizjfFJov3JbHyAi,7,3,2,0,2,1,2,0,10,1.4285714285714286,1,0.0,0,2,0,2,3,1,0,2,0,4,6,1
4661,44125,S0Ddt9YO0WoRWUIwBGA5TdHpdcYScp4i,fbPkOYLVPtPgIt0MxizjfFJov3JbHyAi,2,0,0,0,0,0,4,0,4,0.5714285714285714,1,0.0,0,0,0,0,0,0,0,4,0,0,4,1
4662,44126,tp8q2FaFgEZoEyMd2w4a4ElJA60aVpjU,fbPkOYLVPtPgIt0MxizjfFJov3JbHyAi,8,4,2,0,2,1,5,0,14,2.0,1,0.0,1,2,0,2,3,1,0,5,0,5,9,1
4663,44127,uE45A9X1ub2amdi5pgtNBuPUXW1OngP4,fbPkOYLVPtPgIt0MxizjfFJov3JbHyAi,8,7,4,0,2,25,8,1,47,6.714285714285714,3,0.0,0,4,0,2,7,25,0,8,1,6,41,1
4664,44128,V1LvU1c7E3PIUZFRN6WpF3BM13fnjgNE,fbPkOYLVPtPgIt0MxizjfFJov3JbHyAi,1,0,0,0,0,0,1,0,1,0.14285714285714285,1,0.0,0,0,0,0,0,0,0,1,0,0,1,1
4665,44129,p1XbGfxeaI6DleJXE743W1CITQmkaVh6,fbPkOYLVPtPgIt0MxizjfFJov3JbHyAi,20,29,15,0,11,41,8,1,105,15.0,2,0.0,6,15,0,11,23,41,0,8,1,32,73,1
4666,44130,aldLXGpzmiip2CUSDhqN8A5UpGMVUHxY,fbPkOYLVPtPgIt0MxizjfFJov3JbHyAi,7,6,3,0,2,0,2,0,13,1.8571428571428572,2,0.0,1,3,0,2,5,0,0,2,0,6,7,1
4667,44132,zFnB514y0Q6xzKQdlkyv2Oz7aEiEsfcU,fbPkOYLVPtPgIt0MxizjfFJov3JbHyAi,11,3,3,0,3,0,10,1,20,2.857142857142857,1,0.0,0,3,0,3,3,0,0,10,1,6,14,1
4668,44136,BF0qnZaKn6rKWwFuVZZ6evM5Lwl2Cgas,fbPkOYLVPtPgIt0MxizjfFJov3JbHyAi,9,5,3,0,3,31,9,1,52,7.428571428571429,2,0.0,1,3,0,3,4,31,0,9,1,7,45,1
4669,44137,2UpfysYIIWrRQes9MePdZN0xiR2zRHJz,fbPkOYLVPtPgIt0MxizjfFJov3JbHyAi,8,6,3,0,2,0,2,0,13,1.8571428571428572,1,0.0,0,3,0,2,6,0,0,2,0,5,8,1
4670,44138,3xpaESbMVIacFbBBinGWFh7uTUaRebCC,fbPkOYLVPtPgIt0MxizjfFJov3JbHyAi,7,5,3,0,1,0,3,0,12,1.7142857142857142,2,0.0,0,3,0,1,5,0,0,3,0,4,8,1
4671,44140,MmriHcroMe075aYWrI4hc7SygXVasdbB,fbPkOYLVPtPgIt0MxizjfFJov3JbHyAi,7,7,5,0,4,2,2,0,20,2.857142857142857,1,0.0,0,5,0,4,7,2,0,2,0,9,11,1
4672,44142,VT4lg4rYLuaybdJw72lJCTs81gBgRRBg,fbPkOYLVPtPgIt0MxizjfFJov3JbHyAi,26,121,61,23,38,68,33,3,347,49.57142857142857,9,0.0,36,61,18,38,85,68,5,33,3,153,194,1
4673,44143,J9FSUo4laXGBW66T35Zr5CFe56ZdTJTQ,fbPkOYLVPtPgIt0MxizjfFJov3JbHyAi,9,6,3,0,4,3,4,0,20,2.857142857142857,1,0.0,2,3,0,4,4,3,0,4,0,9,11,1
4674,44145,niLMw8MCObO7SSR2V1jNg9WQt5oSjDFJ,fbPkOYLVPtPgIt0MxizjfFJov3JbHyAi,6,7,3,0,2,2,2,0,16,2.2857142857142856,1,0.0,2,3,0,2,5,2,0,2,0,7,9,1
4675,44146,NiOuJ51IxTtojHMts8OdX2AfCH09G7vK,fbPkOYLVPtPgIt0MxizjfFJov3JbHyAi,8,5,2,0,2,11,5,1,26,3.7142857142857144,1,0.0,0,2,0,2,5,11,0,5,1,4,22,1
4676,44147,zeUi2UnQZPPF6bRQXw2s8LZ41ZOdqRAa,fbPkOYLVPtPgIt0MxizjfFJov3JbHyAi,5,2,1,0,1,5,5,0,14,2.0,2,0.0,0,1,0,1,2,5,0,5,0,2,12,1
4677,44149,W7N7he2GGE1A2J3fJvsUdwOZI9P4besV,fbPkOYLVPtPgIt0MxizjfFJov3JbHyAi,16,52,14,3,11,0,7,0,87,12.428571428571429,3,0.0,18,14,3,11,34,0,0,7,0,46,41,1
4678,44150,1OCnfEluJ5C06UYF5oIawyvraf5cATWk,fbPkOYLVPtPgIt0MxizjfFJov3JbHyAi,12,9,3,4,5,0,3,0,24,3.4285714285714284,1,0.0,4,3,3,5,5,0,1,3,0,15,9,1
4679,44153,mZ7ilucqUFwey1NwU92PRXQQ0HeHtWmh,fbPkOYLVPtPgIt0MxizjfFJov3JbHyAi,7,4,3,0,3,0,3,0,13,1.8571428571428572,1,0.0,0,3,0,3,4,0,0,3,0,6,7,1
4680,44154,wJViEDKJG9cycqokQxxOomq0g3hb2X0n,fbPkOYLVPtPgIt0MxizjfFJov3JbHyAi,1,0,0,0,0,0,1,0,1,0.14285714285714285,1,0.0,0,0,0,0,0,0,0,1,0,0,1,1
4681,44156,2fI4wWrvurl3ODzFoF1kViu5y8Lc1NgZ,fbPkOYLVPtPgIt0MxizjfFJov3JbHyAi,5,3,1,0,1,10,2,0,17,2.4285714285714284,1,0.0,0,1,0,1,3,10,0,2,0,2,15,1
4682,44157,ScslB7DNmqv4WEnDOYxGnluFKACqdrbs,fbPkOYLVPtPgIt0MxizjfFJov3JbHyAi,13,18,7,1,8,0,9,2,45,6.428571428571429,2,0.0,7,7,1,8,11,0,0,9,2,23,22,1
4683,44158,KBAguIZfF7JFxQgNwhhTOV2JtOxu7CHH,fbPkOYLVPtPgIt0MxizjfFJov3JbHyAi,8,9,4,0,3,0,4,0,20,2.857142857142857,2,0.0,2,4,0,3,7,0,0,4,0,9,11,1
4684,44160,gHeXtpmuyccgWbGT5QiAuKlFydUbHDzc,fbPkOYLVPtPgIt0MxizjfFJov3JbHyAi,5,4,2,0,1,0,2,0,9,1.2857142857142858,2,0.0,0,2,0,1,4,0,0,2,0,3,6,1
4685,44162,Lyagkt8Tl6Y9546SuIOdZylzB0VpBr47,fbPkOYLVPtPgIt0MxizjfFJov3JbHyAi,2,0,0,0,0,0,8,0,8,1.1428571428571428,1,0.0,0,0,0,0,0,0,0,8,0,0,8,1
4686,44164,WLc3nzeMA1m785zH4gOIVyKG8qieUOwG,fbPkOYLVPtPgIt0MxizjfFJov3JbHyAi,4,2,1,0,1,0,2,0,6,0.8571428571428571,1,0.0,0,1,0,1,2,0,0,2,0,2,4,1
4687,44166,zLQK4qXkDKq3GVHuvnA5ZgyIevHVQUHp,fbPkOYLVPtPgIt0MxizjfFJov3JbHyAi,14,17,8,0,5,0,4,1,35,5.0,1,0.0,0,8,0,5,17,0,0,4,1,13,22,1
4688,44167,aXGAxVHU5aDLZJJ1gHpvXefHkIbw92yB,fbPkOYLVPtPgIt0MxizjfFJov3JbHyAi,18,11,8,0,7,18,8,1,53,7.571428571428571,1,0.0,1,8,0,7,10,18,0,8,1,16,37,1
4689,44171,JhiJnBpiVfW8JCO4BrjAwx4ywoZHB71f,fbPkOYLVPtPgIt0MxizjfFJov3JbHyAi,7,8,3,0,2,0,3,0,16,2.2857142857142856,1,0.0,0,3,0,2,8,0,0,3,0,5,11,1
4690,44172,SvI7NjkOF6DOPWLRc1U4XOWjW6ht1V3M,fbPkOYLVPtPgIt0MxizjfFJov3JbHyAi,2,0,0,0,0,0,5,0,5,0.7142857142857143,1,0.0,0,0,0,0,0,0,0,5,0,0,5,1
4691,44174,kr9MhAzeae0UKmOp6QSbcSIPAfRDBwyS,fbPkOYLVPtPgIt0MxizjfFJov3JbHyAi,17,30,12,3,10,32,10,0,97,13.857142857142858,3,0.0,12,12,3,10,18,32,0,10,0,37,60,1
4692,44175,58HxGhVJCkPf0xNzljCqWpiXdfJMiEDw,fbPkOYLVPtPgIt0MxizjfFJov3JbHyAi,8,2,2,0,2,0,6,0,12,1.7142857142857142,1,0.0,0,2,0,2,2,0,0,6,0,4,8,1
4693,44178,ZUj8ciewoY1krerme1rA06bZgMQzwUwF,fbPkOYLVPtPgIt0MxizjfFJov3JbHyAi,10,23,11,0,6,10,10,1,61,8.714285714285714,4,0.0,2,11,0,6,21,10,0,10,1,19,42,0
4694,44179,KybJTS3fr0HyrDCaccrgyo0RzMzG0qom,fbPkOYLVPtPgIt0MxizjfFJov3JbHyAi,2,0,0,0,0,0,4,0,4,0.5714285714285714,1,0.0,0,0,0,0,0,0,0,4,0,0,4,1
4695,44181,ZPamISIdPsbqsq6aVqRDFzUi3IlRadjg,fbPkOYLVPtPgIt0MxizjfFJov3JbHyAi,12,12,6,0,4,16,8,1,47,6.714285714285714,2,0.0,0,6,0,4,12,16,0,8,1,10,37,1
4696,44182,sn2EpOZocGCK2n6oyJ74BVfoIYZKGwBK,fbPkOYLVPtPgIt0MxizjfFJov3JbHyAi,9,15,0,10,3,11,10,0,49,7.0,1,0.0,10,0,7,3,5,11,3,10,0,20,29,1
4697,44184,UsLFN9dzLo3sTXf5tfNoi18KyZHWYRsB,fbPkOYLVPtPgIt0MxizjfFJov3JbHyAi,22,35,16,16,19,5,3,0,94,13.428571428571429,2,0.0,17,16,13,19,18,5,3,3,0,65,29,1
4698,44185,tcFBEkXakkuMK1VljJZtgKVBO9EsakN0,fbPkOYLVPtPgIt0MxizjfFJov3JbHyAi,1,0,0,0,0,0,1,0,1,0.14285714285714285,1,0.0,0,0,0,0,0,0,0,1,0,0,1,1
4699,44186,mJ5BZ6EJA3wLg8jbGMObtpjRK8yspzI5,fbPkOYLVPtPgIt0MxizjfFJov3JbHyAi,46,53,28,38,16,46,13,1,195,27.857142857142858,3,0.0,17,28,32,16,36,46,6,13,1,93,102,1
4700,44187,i7yYKzmNeDNpl7ZXyamysycDjJWbLntm,fbPkOYLVPtPgIt0MxizjfFJov3JbHyAi,11,19,4,7,9,4,5,0,48,6.857142857142857,1,0.0,14,4,6,9,5,4,1,5,0,33,15,1
4701,44188,yFk2LSMib4DE4CR8Gt7OigYN8UE5SERE,fbPkOYLVPtPgIt0MxizjfFJov3JbHyAi,6,5,3,0,1,0,4,0,13,1.8571428571428572,3,0.0,0,3,0,1,5,0,0,4,0,4,9,1
4702,44193,5olZBiEN7fREGvXjZsAPA34LD7TNv2Om,fbPkOYLVPtPgIt0MxizjfFJov3JbHyAi,9,12,3,0,3,11,7,0,36,5.142857142857143,1,0.0,0,3,0,3,12,11,0,7,0,6,30,1
4703,44194,nkWrffpo6kobU01lUWepcu6aQb60BdxH,fbPkOYLVPtPgIt0MxizjfFJov3JbHyAi,46,79,37,18,22,34,19,1,210,30.0,11,0.0,22,37,17,22,57,34,1,19,1,98,112,0
4704,44195,rQ7jrT4jqfVvIwV7TCyxKklrYfaXz5qx,fbPkOYLVPtPgIt0MxizjfFJov3JbHyAi,6,7,4,0,2,7,4,0,24,3.4285714285714284,1,0.0,0,4,0,2,7,7,0,4,0,6,18,1
4705,44196,cXbVpSHehoFAcD5jvifZg4hoGlmfKlx5,fbPkOYLVPtPgIt0MxizjfFJov3JbHyAi,3,3,1,0,0,0,1,0,5,0.7142857142857143,1,0.0,0,1,0,0,3,0,0,1,0,1,4,0
4706,44201,bGSf4Dv41LrPDFgbxGTmHZXMfhKccKJy,fbPkOYLVPtPgIt0MxizjfFJov3JbHyAi,8,4,3,0,3,0,2,0,12,1.7142857142857142,2,0.0,0,3,0,3,4,0,0,2,0,6,6,1
4707,44202,UvmsOyeKqNqdnoWuF67HYRoCd5vZCTT3,fbPkOYLVPtPgIt0MxizjfFJov3JbHyAi,4,2,0,0,0,0,10,0,12,1.7142857142857142,2,0.0,0,0,0,0,2,0,0,10,0,0,12,1
4708,44203,4cRZxyVNjv13lU3nu2aK2rwyndExVCGa,fbPkOYLVPtPgIt0MxizjfFJov3JbHyAi,24,38,23,23,11,10,8,0,113,16.142857142857142,6,0.0,6,23,17,11,32,10,6,8,0,57,56,1
4709,44208,9nBDwXR4PojGZeJgF10uxjH1va7sf1sb,fbPkOYLVPtPgIt0MxizjfFJov3JbHyAi,6,5,2,0,1,0,8,0,16,2.2857142857142856,2,0.0,0,2,0,1,5,0,0,8,0,3,13,1
4710,44209,XZNYPNX0OVSTYmnVJQK9QQliGDqh1neQ,fbPkOYLVPtPgIt0MxizjfFJov3JbHyAi,5,8,3,0,0,0,7,0,18,2.5714285714285716,1,0.0,3,3,0,0,5,0,0,7,0,6,12,1
4711,44212,lMefkcgNh5NMvOXiUOkNuemhw07vFq2i,fbPkOYLVPtPgIt0MxizjfFJov3JbHyAi,6,4,2,0,1,6,5,0,18,2.5714285714285716,1,0.0,0,2,0,1,4,6,0,5,0,3,15,1
4712,44213,lR39Ca78D0WrhfXRqUEM5XEFow5I5VmV,fbPkOYLVPtPgIt0MxizjfFJov3JbHyAi,10,11,4,0,4,0,3,0,22,3.142857142857143,1,0.0,5,4,0,4,6,0,0,3,0,13,9,1
4713,44215,zLhYaUkalf3cJa8yuQ4GA08EdlJo6KYR,fbPkOYLVPtPgIt0MxizjfFJov3JbHyAi,2,0,0,0,0,0,2,0,2,0.2857142857142857,1,0.0,0,0,0,0,0,0,0,2,0,0,2,1
4714,44216,398KUlAbQAJq86al7WBicOZ2ToPIvKyy,fbPkOYLVPtPgIt0MxizjfFJov3JbHyAi,5,2,1,0,1,0,3,0,7,1.0,1,0.0,0,1,0,1,2,0,0,3,0,2,5,1
4715,44217,DwhbrQEsdQ584Yt1VsJhxkmyn6wsMQlr,fbPkOYLVPtPgIt0MxizjfFJov3JbHyAi,9,5,3,4,3,0,1,0,16,2.2857142857142856,1,0.0,1,3,3,3,4,0,1,1,0,10,6,1
4716,44219,Ur8i7WXZlexxp5KjJw4MNXxBOiEFRmEq,fbPkOYLVPtPgIt0MxizjfFJov3JbHyAi,12,4,4,0,4,0,3,0,15,2.142857142857143,2,0.0,0,4,0,4,4,0,0,3,0,8,7,1
4717,44225,9asMsoidPaReetlZL7sWsBgxvGgFunIW,fbPkOYLVPtPgIt0MxizjfFJov3JbHyAi,7,7,2,0,3,0,5,0,17,2.4285714285714284,1,0.0,2,2,0,3,5,0,0,5,0,7,10,1
4718,44227,W3EB1elPrDjFWV4QIzuswTukmjxtHb6Z,fbPkOYLVPtPgIt0MxizjfFJov3JbHyAi,5,2,0,0,1,0,2,0,5,0.7142857142857143,1,0.0,0,0,0,1,2,0,0,2,0,1,4,1
4719,44228,R1FqqBKIoe5gb1Zm4cRd6C2dKym4oN3J,fbPkOYLVPtPgIt0MxizjfFJov3JbHyAi,9,29,16,0,7,0,11,0,63,9.0,4,0.0,1,16,0,7,28,0,0,11,0,24,39,0
4720,44229,xDQR9jsrXbDdyr5ix2doPKar2TBbunBq,fbPkOYLVPtPgIt0MxizjfFJov3JbHyAi,8,8,4,0,3,19,4,1,39,5.571428571428571,1,0.0,0,4,0,3,8,19,0,4,1,7,32,1
4721,44230,Ijb9fKceIgYIt7UF8znubY4lpG9MvHfC,fbPkOYLVPtPgIt0MxizjfFJov3JbHyAi,4,2,1,0,1,0,1,0,5,0.7142857142857143,1,0.0,0,1,0,1,2,0,0,1,0,2,3,1
4722,44232,VvFmHqJuverkRg9SOJfO7EAhSTYwhk8R,fbPkOYLVPtPgIt0MxizjfFJov3JbHyAi,1,0,0,0,0,0,2,0,2,0.2857142857142857,1,0.0,0,0,0,0,0,0,0,2,0,0,2,1
4723,44233,wm9IrPuDWolACPuibTN3CpCrRGsa74ef,fbPkOYLVPtPgIt0MxizjfFJov3JbHyAi,19,8,7,0,7,0,19,1,42,6.0,1,0.0,0,7,0,7,8,0,0,19,1,14,28,1
4724,44236,jagu0OJDhWTGFhfCMk0ghqluLpW3kzdC,fbPkOYLVPtPgIt0MxizjfFJov3JbHyAi,36,54,30,26,21,50,31,5,217,31.0,6,0.0,14,30,20,21,40,50,6,31,5,85,132,0
4725,44237,5wfiCJMdbkN7MkoUGvo3cfz8jV3jCktA,fbPkOYLVPtPgIt0MxizjfFJov3JbHyAi,6,4,2,0,1,11,4,0,22,3.142857142857143,2,0.0,0,2,0,1,4,11,0,4,0,3,19,1
4726,44239,0rBpfipIkPUXXv4992tUqetb5IpoweSC,fbPkOYLVPtPgIt0MxizjfFJov3JbHyAi,7,3,2,0,2,0,2,0,9,1.2857142857142858,1,0.0,0,2,0,2,3,0,0,2,0,4,5,1
4727,44240,OrcJP9YaqKO2WfXtlTi3GWMyG2WCYDrA,fbPkOYLVPtPgIt0MxizjfFJov3JbHyAi,7,3,2,0,2,0,4,0,11,1.5714285714285714,1,0.0,0,2,0,2,3,0,0,4,0,4,7,1
4728,44242,QYVRHTpooyTkzSbIywJ7ri5o4t73Xwty,fbPkOYLVPtPgIt0MxizjfFJov3JbHyAi,7,11,5,0,2,6,6,3,33,4.714285714285714,2,0.0,0,5,0,2,11,6,0,6,3,7,26,1
4729,44243,RR8icbJjkYOdUrylwRxkzCL89mNBS1kQ,fbPkOYLVPtPgIt0MxizjfFJov3JbHyAi,7,5,2,0,2,0,6,0,15,2.142857142857143,1,0.0,2,2,0,2,3,0,0,6,0,6,9,1
4730,44244,g2zZYnTJ1Pk3cSjsVP5SH4UjJdsbDJv7,fbPkOYLVPtPgIt0MxizjfFJov3JbHyAi,34,42,23,28,17,13,10,1,134,19.142857142857142,4,0.0,13,23,22,17,29,13,6,10,1,75,59,0
4731,44248,K1umGIzxZInQChRQpf7KLIJB3rfPL8P3,fbPkOYLVPtPgIt0MxizjfFJov3JbHyAi,7,6,4,0,2,2,1,0,15,2.142857142857143,1,0.0,0,4,0,2,6,2,0,1,0,6,9,1
4732,44251,vFF7Q9hHOJ6qa16cDuF7JSSiOD7EEEuA,fbPkOYLVPtPgIt0MxizjfFJov3JbHyAi,2,0,0,0,0,0,2,0,2,0.2857142857142857,1,0.0,0,0,0,0,0,0,0,2,0,0,2,1
4733,44252,ly2UupZqGwkAeluSmrnRPVaNBG5zI6oB,fbPkOYLVPtPgIt0MxizjfFJov3JbHyAi,10,3,3,0,3,0,3,0,12,1.7142857142857142,1,0.0,0,3,0,3,3,0,0,3,0,6,6,1
4734,44253,ZV7o5798W7XrprHpNhvS0Cr1EgwiSgHZ,fbPkOYLVPtPgIt0MxizjfFJov3JbHyAi,10,11,5,0,4,17,8,0,45,6.428571428571429,2,0.0,3,5,0,4,8,17,0,8,0,12,33,1
4735,44256,bJOkL9U6IOy2ICy3FtWSfPLY5BHrDaNn,fbPkOYLVPtPgIt0MxizjfFJov3JbHyAi,19,19,11,2,8,1,8,0,49,7.0,3,0.0,1,11,2,8,18,1,0,8,0,22,27,1
4736,44257,QyPU5c4UNqLLtktJRpwU2AioPifGtMTU,fbPkOYLVPtPgIt0MxizjfFJov3JbHyAi,5,3,1,0,1,0,5,0,10,1.4285714285714286,1,0.0,0,1,0,1,3,0,0,5,0,2,8,1
4737,44258,mV7oUFoQV8UaUytbbGy8dq3Lp45sMej3,fbPkOYLVPtPgIt0MxizjfFJov3JbHyAi,5,2,1,0,1,0,3,0,7,1.0,1,0.0,0,1,0,1,2,0,0,3,0,2,5,1
4738,44260,fTY7PbFNeV0B3b5XiSuBQtOgneGDS4iZ,fbPkOYLVPtPgIt0MxizjfFJov3JbHyAi,12,7,5,0,4,0,4,0,20,2.857142857142857,2,0.0,0,5,0,4,7,0,0,4,0,9,11,1
4739,44263,w7sOZdeQBox0eO8DVqyUKzi8avIzaYn4,fbPkOYLVPtPgIt0MxizjfFJov3JbHyAi,11,9,4,0,3,2,8,1,27,3.857142857142857,1,0.0,3,4,0,3,6,2,0,8,1,10,17,1
4740,44264,cA8JP9WlrRgRowgBnuouyPdSEGVSdPoU,fbPkOYLVPtPgIt0MxizjfFJov3JbHyAi,7,3,2,0,2,0,2,0,9,1.2857142857142858,1,0.0,0,2,0,2,3,0,0,2,0,4,5,1
4741,44265,beJ7nfPQcUdFyj8P1C0Vl4K57I6wCKrL,fbPkOYLVPtPgIt0MxizjfFJov3JbHyAi,7,8,5,0,3,0,3,1,20,2.857142857142857,1,0.0,0,5,0,3,8,0,0,3,1,8,12,1
4742,44267,r9kprGnmV8vKXI1tErs4EvgHZZ8IRF8I,fbPkOYLVPtPgIt0MxizjfFJov3JbHyAi,4,2,0,0,0,4,4,0,10,1.4285714285714286,1,0.0,0,0,0,0,2,4,0,4,0,0,10,1
4743,44270,GMzSpgZQ6jzVsfHn8W8i83JsYNxnP00b,fbPkOYLVPtPgIt0MxizjfFJov3JbHyAi,19,38,18,6,12,0,7,0,81,11.571428571428571,3,0.0,7,18,5,12,31,0,1,7,0,42,39,1
4744,44272,J3rwPgcYHKst1mTrkHfz6lTuHZtWbhHS,fbPkOYLVPtPgIt0MxizjfFJov3JbHyAi,6,5,3,0,3,0,1,0,12,1.7142857142857142,1,0.0,0,3,0,3,5,0,0,1,0,6,6,1
4745,44274,2qxdbGcKrOShnqwnQiXgdDAFvYPhSM6o,fbPkOYLVPtPgIt0MxizjfFJov3JbHyAi,9,7,5,0,4,0,4,0,20,2.857142857142857,2,0.0,0,5,0,4,7,0,0,4,0,9,11,1
4746,44275,KTCLrjyRw15OM6ZLS9kBfeLSSnS0pLeh,fbPkOYLVPtPgIt0MxizjfFJov3JbHyAi,10,11,8,0,4,3,15,2,43,6.142857142857143,2,0.0,0,8,0,4,11,3,0,15,2,12,31,1
4747,44277,chYWQx9p6mrqtOqnuZLINe1RPkFDRJYi,fbPkOYLVPtPgIt0MxizjfFJov3JbHyAi,10,11,5,0,4,1,15,1,37,5.285714285714286,1,0.0,2,5,0,4,9,1,0,15,1,11,26,1
4748,44279,tx4grxmlQgEoy6eADYfJTj1STA6T1B91,fbPkOYLVPtPgIt0MxizjfFJov3JbHyAi,4,2,1,0,1,0,1,0,5,0.7142857142857143,1,0.0,0,1,0,1,2,0,0,1,0,2,3,1
4749,44280,gIksIEwmEEV0Pn8wMtaqnzuIMor23skp,fbPkOYLVPtPgIt0MxizjfFJov3JbHyAi,12,17,4,2,2,14,19,1,59,8.428571428571429,3,0.0,3,4,2,2,14,14,0,19,1,11,48,1
4750,44282,bxc4zM194IAB8OgoL6kSDGRq4OX5TDtY,fbPkOYLVPtPgIt0MxizjfFJov3JbHyAi,10,12,7,0,3,10,6,1,39,5.571428571428571,2,0.0,2,7,0,3,10,10,0,6,1,12,27,1
4751,44283,57qzgJAwfROYPxzSOrsA3G5DLHP95ajU,fbPkOYLVPtPgIt0MxizjfFJov3JbHyAi,6,5,3,0,2,0,4,0,14,2.0,2,0.0,0,3,0,2,5,0,0,4,0,5,9,1
4752,44284,lAPXQuLP1yRNYGiTpu7dIeoZTMEKBA0b,fbPkOYLVPtPgIt0MxizjfFJov3JbHyAi,10,16,4,6,4,0,3,0,33,4.714285714285714,1,0.0,4,4,6,4,12,0,0,3,0,18,15,1
4753,44285,KMmrb4nTAt1m2OAaFtq8lztLT3NFO2Pb,fbPkOYLVPtPgIt0MxizjfFJov3JbHyAi,1,0,0,0,0,0,1,0,1,0.14285714285714285,1,0.0,0,0,0,0,0,0,0,1,0,0,1,1
4754,44286,Sw0laYN5mow6XiHfrWCJl4qnRcU0Nesb,fbPkOYLVPtPgIt0MxizjfFJov3JbHyAi,10,10,8,0,6,0,2,0,26,3.7142857142857144,2,0.0,0,8,0,6,10,0,0,2,0,14,12,1
4755,44287,DULOyOFZsLRkoNHg3me4lby4O9mlfTfP,fbPkOYLVPtPgIt0MxizjfFJov3JbHyAi,8,14,8,0,0,0,6,0,28,4.0,2,0.0,0,8,0,0,14,0,0,6,0,8,20,1
4756,44288,mSToVMacc08MhsUyEFn562K69bpANB3P,fbPkOYLVPtPgIt0MxizjfFJov3JbHyAi,6,3,1,0,1,0,2,0,7,1.0,2,0.0,0,1,0,1,3,0,0,2,0,2,5,1
4757,44289,Z8E1fWEz0b5y6BD6dlIVX2UJWlqxRpHR,fbPkOYLVPtPgIt0MxizjfFJov3JbHyAi,11,12,6,5,5,4,2,0,34,4.857142857142857,2,0.0,4,6,4,5,8,4,1,2,0,19,15,1
4758,44290,RdArNf6qPycx7nnXJK9MCRyymBwv75n3,fbPkOYLVPtPgIt0MxizjfFJov3JbHyAi,5,2,1,0,0,0,5,0,8,1.1428571428571428,1,0.0,0,1,0,0,2,0,0,5,0,1,7,1
4759,44291,wGwI5daC8SwOUE0hcVwwOwixSwocHFPs,fbPkOYLVPtPgIt0MxizjfFJov3JbHyAi,6,3,2,0,2,0,1,0,8,1.1428571428571428,1,0.0,0,2,0,2,3,0,0,1,0,4,4,1
4760,44295,ydIfB5lDuQMdwnqw1Trec6MMfLMb9KME,fbPkOYLVPtPgIt0MxizjfFJov3JbHyAi,5,9,0,0,1,2,2,0,14,2.0,1,0.0,3,0,0,1,6,2,0,2,0,4,10,1
4761,44296,SlxIPeu1dmMaJlW3478OT2sG7yUhXJL1,fbPkOYLVPtPgIt0MxizjfFJov3JbHyAi,2,0,0,0,0,0,5,0,5,0.7142857142857143,1,0.0,0,0,0,0,0,0,0,5,0,0,5,1
4762,44297,4LlDUfJVZRN4VGhz1cOPbu42ptFr0ItJ,fbPkOYLVPtPgIt0MxizjfFJov3JbHyAi,10,22,16,0,10,4,5,0,57,8.142857142857142,2,0.0,2,16,0,10,20,4,0,5,0,28,29,1
4763,44299,5uyWPVLiSthHYhSAJufLobkztuAqGghO,fbPkOYLVPtPgIt0MxizjfFJov3JbHyAi,12,39,13,8,14,10,6,0,90,12.857142857142858,4,0.0,15,13,5,14,24,10,3,6,0,47,43,1
4764,44302,OzkaXzIRl9kqXzCHMBKEBEDNw27l64vJ,fbPkOYLVPtPgIt0MxizjfFJov3JbHyAi,5,2,1,0,1,0,6,0,10,1.4285714285714286,1,0.0,0,1,0,1,2,0,0,6,0,2,8,1
4765,44303,6SFV3JbKdSV7hRZqshJPkaxQAde0a5lX,fbPkOYLVPtPgIt0MxizjfFJov3JbHyAi,6,2,1,0,1,2,5,1,12,1.7142857142857142,1,0.0,0,1,0,1,2,2,0,5,1,2,10,1
4766,44304,NqxqEj1F6iv4kBP9fZF1q6JwtPVhl0hk,fbPkOYLVPtPgIt0MxizjfFJov3JbHyAi,4,1,0,0,0,0,3,0,4,0.5714285714285714,1,0.0,0,0,0,0,1,0,0,3,0,0,4,1
4767,44306,GCwNBqpZSN8gReMgO4ZxJ7plXwWznnJn,fbPkOYLVPtPgIt0MxizjfFJov3JbHyAi,1,0,0,0,0,0,1,0,1,0.14285714285714285,1,0.0,0,0,0,0,0,0,0,1,0,0,1,1
4768,44308,hIXeM0yyb6wIxVNnB5ijRV2LpcYBbrLW,fbPkOYLVPtPgIt0MxizjfFJov3JbHyAi,5,8,1,0,1,0,2,0,12,1.7142857142857142,1,0.0,0,1,0,1,8,0,0,2,0,2,10,1
4769,45309,cvmNQvB8C9tzfr5JL4ScqNRXsUkWS0qq,RXDvfPUBYFlVdlueBFbLW0mhhAyGEqpt,72,242,150,65,19,206,68,9,759,108.42857142857143,8,0.0,18,150,50,19,224,206,15,68,9,237,522,0
4770,45312,JrU3mQXDsHM3JCMrGML8Gsd1f6KKBRz5,RXDvfPUBYFlVdlueBFbLW0mhhAyGEqpt,7,28,0,0,0,0,3,0,31,4.428571428571429,2,0.0,1,0,0,0,27,0,0,3,0,1,30,1
4771,45316,KUdvYZYC6ZViW3z5eiAU2e6Me0VXEfY4,RXDvfPUBYFlVdlueBFbLW0mhhAyGEqpt,9,6,0,0,0,0,7,0,13,1.8571428571428572,2,0.0,0,0,0,0,6,0,0,7,0,0,13,1
4772,45327,oE1QbspE1VaPia0G9CbmnflG7dN6cZJM,G8EPVSXsOYB5YQWZGiz1aVq5Pgr2GrQu,8,7,4,0,0,0,4,1,16,2.2857142857142856,2,0.0,1,4,0,0,6,0,0,4,1,5,11,1
4773,45339,CladEfFLLomb4XABUtmNVPFfnjm4LhE2,RXDvfPUBYFlVdlueBFbLW0mhhAyGEqpt,44,86,2,135,10,6,13,0,252,36.0,2,0.0,37,2,122,10,49,6,13,13,0,171,81,0
4774,45340,Q57EC9WScoWjECRp7MT77bmBt9oZMVVG,RXDvfPUBYFlVdlueBFbLW0mhhAyGEqpt,71,149,85,72,21,717,239,38,1321,188.71428571428572,25,0.0,20,85,58,21,129,717,14,239,38,184,1137,0
4775,45366,4v506xwnN2gFG9XeSNIeiBlmXImooi1O,RXDvfPUBYFlVdlueBFbLW0mhhAyGEqpt,66,98,44,139,35,0,6,0,322,46.0,3,0.0,43,44,134,35,55,0,5,6,0,256,66,0
4776,45384,zkzUmPQTrqnNy4aMEOpIupZNYtjTcR9O,G8EPVSXsOYB5YQWZGiz1aVq5Pgr2GrQu,1,0,0,0,0,0,1,0,1,0.14285714285714285,1,0.0,0,0,0,0,0,0,0,1,0,0,1,1
4777,45391,sUA9xXq2cjEIung0hBSUfP1uBxFNZSs5,G8EPVSXsOYB5YQWZGiz1aVq5Pgr2GrQu,17,11,5,24,3,3,8,1,55,7.857142857142857,3,0.0,1,5,20,3,10,3,4,8,1,29,26,1
4778,45402,1lu7qFlpJ7c77SdGrohS207VNZCEPQ2W,G8EPVSXsOYB5YQWZGiz1aVq5Pgr2GrQu,14,7,6,0,4,0,19,2,38,5.428571428571429,2,0.0,0,6,0,4,7,0,0,19,2,10,28,1
4779,45436,yX4GtBReTtJl8CLrRCBEP3vcJDxXoOOn,RXDvfPUBYFlVdlueBFbLW0mhhAyGEqpt,1,0,0,0,0,0,1,0,1,0.14285714285714285,1,0.0,0,0,0,0,0,0,0,1,0,0,1,1
4780,45466,E2SSacGkmDwMmCOVOXL29GviqMFLwc68,G8EPVSXsOYB5YQWZGiz1aVq5Pgr2GrQu,1,0,0,0,0,0,1,0,1,0.14285714285714285,1,0.0,0,0,0,0,0,0,0,1,0,0,1,1
4781,45483,5U9E0pnoyq8gJfR6llsPDT5KP7DSR7H8,G8EPVSXsOYB5YQWZGiz1aVq5Pgr2GrQu,1,0,0,0,0,0,1,0,1,0.14285714285714285,1,0.0,0,0,0,0,0,0,0,1,0,0,1,1
4782,45532,ZrIXM5h8t7QDXRvT8qPfGTwh0kjMYeoV,RXDvfPUBYFlVdlueBFbLW0mhhAyGEqpt,9,13,8,0,1,15,4,0,41,5.857142857142857,3,0.0,2,8,0,1,11,15,0,4,0,11,30,1
4783,45546,VMgv7OqkaBwITbfAg6B6mOmAS6m3C11w,G8EPVSXsOYB5YQWZGiz1aVq5Pgr2GrQu,18,21,1,60,0,0,2,0,84,12.0,2,0.0,10,1,44,0,11,0,16,2,0,55,29,1
4784,45611,f2dlkEjQnfiTH1JmGq8MzaHN9HyOSQno,RXDvfPUBYFlVdlueBFbLW0mhhAyGEqpt,1,0,0,0,0,0,1,0,1,0.14285714285714285,1,0.0,0,0,0,0,0,0,0,1,0,0,1,1
4785,45722,zUCFNdkDJjSNIqUVigI0Q3t79JnpwRq3,RXDvfPUBYFlVdlueBFbLW0mhhAyGEqpt,1,0,0,0,0,0,1,0,1,0.14285714285714285,1,0.0,0,0,0,0,0,0,0,1,0,0,1,1
4786,45849,CpJFUzNBBad8gxGQfFWcVCTdakqtlRdi,RXDvfPUBYFlVdlueBFbLW0mhhAyGEqpt,1,0,0,0,0,0,2,0,2,0.2857142857142857,1,0.0,0,0,0,0,0,0,0,2,0,0,2,1
4787,45854,0DHsJAElXb9hqHUPTXAQocHtOXvWXP78,RXDvfPUBYFlVdlueBFbLW0mhhAyGEqpt,1,0,0,0,0,0,1,0,1,0.14285714285714285,1,0.0,0,0,0,0,0,0,0,1,0,0,1,1
4788,45931,BTsn79qot898Mo4TTFaO7NRlDTnmwcCn,G8EPVSXsOYB5YQWZGiz1aVq5Pgr2GrQu,1,0,0,0,0,0,1,0,1,0.14285714285714285,1,0.0,0,0,0,0,0,0,0,1,0,0,1,1
4789,45958,QVJT76zcnp3BslGL7JUS10ZkHM5HFGSg,RXDvfPUBYFlVdlueBFbLW0mhhAyGEqpt,1,0,0,0,0,0,1,0,1,0.14285714285714285,1,0.0,0,0,0,0,0,0,0,1,0,0,1,1
4790,45969,chQJNd08oe4UgyVlUUX52CvD3Wla8eb7,G8EPVSXsOYB5YQWZGiz1aVq5Pgr2GrQu,1,0,0,0,0,0,1,0,1,0.14285714285714285,1,0.0,0,0,0,0,0,0,0,1,0,0,1,1
4791,45977,sGg2QuTzc9ZdW4JVwqEMxUhxNa3l9bLB,G8EPVSXsOYB5YQWZGiz1aVq5Pgr2GrQu,1,0,0,0,0,0,1,0,1,0.14285714285714285,1,0.0,0,0,0,0,0,0,0,1,0,0,1,1
4792,46013,PNXl2SBlhwK5mHxVh3FrbKdX9rl1VIVp,G8EPVSXsOYB5YQWZGiz1aVq5Pgr2GrQu,1,0,0,0,0,0,1,0,1,0.14285714285714285,1,0.0,0,0,0,0,0,0,0,1,0,0,1,1
4793,46015,fGEAQY13PDoFhSvPw6ar51lhcxcXekJz,RXDvfPUBYFlVdlueBFbLW0mhhAyGEqpt,1,0,0,0,0,0,2,0,2,0.2857142857142857,1,0.0,0,0,0,0,0,0,0,2,0,0,2,1
4794,46059,ffnHtZ1QN4qjciwC3Yy8mONo5ZYvivQf,G8EPVSXsOYB5YQWZGiz1aVq5Pgr2GrQu,1,0,0,0,0,0,1,0,1,0.14285714285714285,1,0.0,0,0,0,0,0,0,0,1,0,0,1,1
4795,46114,3YdfU7bhuCtVSPeVcn33KfVYPID77mmY,RXDvfPUBYFlVdlueBFbLW0mhhAyGEqpt,1,0,0,0,0,0,1,0,1,0.14285714285714285,1,0.0,0,0,0,0,0,0,0,1,0,0,1,1
4796,46173,jj6BKJzz2LfNkxpbRScKRBOb519d4fcM,G8EPVSXsOYB5YQWZGiz1aVq5Pgr2GrQu,1,0,0,0,0,0,1,0,1,0.14285714285714285,1,0.0,0,0,0,0,0,0,0,1,0,0,1,1
4797,46237,N7kM3jWM4eH8xNeIeU71MKRwK6kQucbk,G8EPVSXsOYB5YQWZGiz1aVq5Pgr2GrQu,4,2,0,0,0,0,2,0,4,0.5714285714285714,1,0.0,0,0,0,0,2,0,0,2,0,0,4,1
4798,46280,2kMQkfKYMlhaU4UM5pB8xmNc8uChRuw1,RXDvfPUBYFlVdlueBFbLW0mhhAyGEqpt,1,0,0,0,0,0,1,0,1,0.14285714285714285,1,0.0,0,0,0,0,0,0,0,1,0,0,1,1
4799,46284,5lTTIs9nhtO0O7RTM99nDh8BPtI6ScTe,G8EPVSXsOYB5YQWZGiz1aVq5Pgr2GrQu,1,0,0,0,0,0,1,0,1,0.14285714285714285,1,0.0,0,0,0,0,0,0,0,1,0,0,1,1
4800,46304,khyDqhFAo6DpK4tMIyensDnI5TCI4bvw,G8EPVSXsOYB5YQWZGiz1aVq5Pgr2GrQu,1,0,0,0,0,0,1,0,1,0.14285714285714285,1,0.0,0,0,0,0,0,0,0,1,0,0,1,1
4801,46338,ZqLzWImxdtQBdKkWQiADsQDooYoZ3q37,RXDvfPUBYFlVdlueBFbLW0mhhAyGEqpt,1,0,0,0,0,0,1,0,1,0.14285714285714285,1,0.0,0,0,0,0,0,0,0,1,0,0,1,1
4802,46355,kjTdi307uJdPG2dA0MRZXL0j1FvRWtkq,G8EPVSXsOYB5YQWZGiz1aVq5Pgr2GrQu,1,0,0,0,0,0,1,0,1,0.14285714285714285,1,0.0,0,0,0,0,0,0,0,1,0,0,1,1
4803,46366,KuNFtG4l08F89uoxUeo0jGAYIKWrBRbs,RXDvfPUBYFlVdlueBFbLW0mhhAyGEqpt,15,19,6,0,3,0,10,0,38,5.428571428571429,2,0.0,0,6,0,3,19,0,0,10,0,9,29,1
4804,46383,cxxLaXhgAon6KrRcUx12hLoqbuiALekd,RXDvfPUBYFlVdlueBFbLW0mhhAyGEqpt,1,0,0,0,0,0,1,0,1,0.14285714285714285,1,0.0,0,0,0,0,0,0,0,1,0,0,1,1
4805,46389,gGFmJyNMerYTj0kT96HuKIvL9JdTq2vY,RXDvfPUBYFlVdlueBFbLW0mhhAyGEqpt,66,93,51,161,34,28,23,0,390,55.714285714285715,8,0.0,31,51,140,34,62,28,21,23,0,256,134,0
4806,46393,2AW6aH0SqKYjpe5J2qxXqfKxHscq7JWf,G8EPVSXsOYB5YQWZGiz1aVq5Pgr2GrQu,1,0,0,0,0,0,1,0,1,0.14285714285714285,1,0.0,0,0,0,0,0,0,0,1,0,0,1,1
4807,46413,3eLagVEammG0JrQUYdbSaNysDt0g3zAb,RXDvfPUBYFlVdlueBFbLW0mhhAyGEqpt,1,0,0,0,0,0,1,0,1,0.14285714285714285,1,0.0,0,0,0,0,0,0,0,1,0,0,1,1
4808,46414,pxpbjivAFvcOKL2janpM89oHptiaHIsF,G8EPVSXsOYB5YQWZGiz1aVq5Pgr2GrQu,1,0,0,0,0,0,1,0,1,0.14285714285714285,1,0.0,0,0,0,0,0,0,0,1,0,0,1,1
4809,46440,jspM6ZD48llYyfw95wwrh04hh61lp4NC,RXDvfPUBYFlVdlueBFbLW0mhhAyGEqpt,7,6,3,0,1,0,2,0,12,1.7142857142857142,2,0.0,0,3,0,1,6,0,0,2,0,4,8,1
4810,46446,C7E8IpvmWl51PErSqNPx8JIZDHe2uLQP,RXDvfPUBYFlVdlueBFbLW0mhhAyGEqpt,24,47,22,0,17,0,13,0,99,14.142857142857142,3,0.0,6,22,0,17,41,0,0,13,0,45,54,1
4811,46481,HBy8mPchGFgKjPi1BR1hdK1ryzkGe4Eu,fbPkOYLVPtPgIt0MxizjfFJov3JbHyAi,2,0,0,0,0,0,2,0,2,0.2857142857142857,1,0.0,0,0,0,0,0,0,0,2,0,0,2,1
4812,46482,QvWjJCxM4Z5YXutHnyToIP2emrXnT27F,fbPkOYLVPtPgIt0MxizjfFJov3JbHyAi,8,2,1,0,1,1,5,1,11,1.5714285714285714,1,0.0,0,1,0,1,2,1,0,5,1,2,9,1
4813,46483,TZ1qqjK0a5Zztn1Eld8NcfyMD8SKYxjC,fbPkOYLVPtPgIt0MxizjfFJov3JbHyAi,8,2,1,0,1,1,18,3,26,3.7142857142857144,1,0.0,0,1,0,1,2,1,0,18,3,2,24,1
4814,46484,acna1oLISW5GtLdHgEb3HFIk5PnI1WRA,fbPkOYLVPtPgIt0MxizjfFJov3JbHyAi,1,0,0,0,0,0,1,0,1,0.14285714285714285,1,0.0,0,0,0,0,0,0,0,1,0,0,1,1
4815,46485,n0aD0wlRo2epwn74jquTDUFpiwWF99mc,fbPkOYLVPtPgIt0MxizjfFJov3JbHyAi,11,16,5,2,6,4,4,0,37,5.285714285714286,2,0.0,7,5,2,6,9,4,0,4,0,20,17,0
4816,46487,0cQOAQZYor1XBUr8oohVdZF8cKrNp08W,fbPkOYLVPtPgIt0MxizjfFJov3JbHyAi,25,36,15,22,9,1,11,0,94,13.428571428571429,4,0.0,10,15,17,9,26,1,5,11,0,51,43,1
4817,46489,vjcoSDgY9JiBCtsViMhHCl6KGCk2TvE5,fbPkOYLVPtPgIt0MxizjfFJov3JbHyAi,7,3,2,0,2,0,2,0,9,1.2857142857142858,1,0.0,0,2,0,2,3,0,0,2,0,4,5,1
4818,46492,A5Ha5kMAE8LgDZc3iTs32MwLDsMXRqMa,fbPkOYLVPtPgIt0MxizjfFJov3JbHyAi,16,16,9,20,0,0,3,0,48,6.857142857142857,1,0.0,6,9,20,0,10,0,0,3,0,35,13,1
4819,46494,JedhrXCQn7XYerN8pX6fyNhWwODWvnUf,fbPkOYLVPtPgIt0MxizjfFJov3JbHyAi,10,16,3,8,7,0,4,0,38,5.428571428571429,1,0.0,12,3,5,7,4,0,3,4,0,27,11,0
4820,46496,TvKzeZn2ihjFdDt7bera0RviFXCeKKB6,fbPkOYLVPtPgIt0MxizjfFJov3JbHyAi,5,2,1,0,1,0,4,0,8,1.1428571428571428,1,0.0,0,1,0,1,2,0,0,4,0,2,6,1
4821,46498,jSp9qlCQEKpc4PsUPHVOngS2TFfQ6jwl,fbPkOYLVPtPgIt0MxizjfFJov3JbHyAi,3,1,0,0,0,0,2,0,3,0.42857142857142855,1,0.0,0,0,0,0,1,0,0,2,0,0,3,1
4822,46500,Kkk2oty8lHBEgyFYDiZgsO24fUpD8pZQ,fbPkOYLVPtPgIt0MxizjfFJov3JbHyAi,9,5,3,4,3,0,1,0,16,2.2857142857142856,1,0.0,1,3,3,3,4,0,1,1,0,10,6,1
4823,46501,rIwy3FDbkCxSl3lJMcDBmeUqV54svIRx,fbPkOYLVPtPgIt0MxizjfFJov3JbHyAi,8,9,5,0,4,0,5,0,23,3.2857142857142856,1,0.0,0,5,0,4,9,0,0,5,0,9,14,1
4824,46503,DPR39VXlEgPnSvHJlcrFWVjZyCJYvn9R,fbPkOYLVPtPgIt0MxizjfFJov3JbHyAi,11,5,4,0,4,0,6,0,19,2.7142857142857144,2,0.0,0,4,0,4,5,0,0,6,0,8,11,1
4825,46504,CpsMjwcxvfkSN0hyQGRgXRt6dQZxAjwb,fbPkOYLVPtPgIt0MxizjfFJov3JbHyAi,11,7,4,0,5,0,5,1,22,3.142857142857143,1,0.0,2,4,0,5,5,0,0,5,1,11,11,1
4826,46505,kBNWoa4A4jmNOoJaSAupB8wyNzpsoJAN,fbPkOYLVPtPgIt0MxizjfFJov3JbHyAi,83,125,53,55,38,1,22,3,297,42.42857142857143,9,0.0,43,53,47,38,82,1,8,22,3,181,116,0
4827,46511,xeCFX5y6IRjmYKFA9y4Rgt3SG4YPELud,fbPkOYLVPtPgIt0MxizjfFJov3JbHyAi,82,332,111,32,49,61,36,0,621,88.71428571428571,8,0.0,31,111,31,49,301,61,1,36,0,222,399,0
4828,46512,a8mEu8FF4lDfLSb2ZwttyDGOOQsEW3CZ,fbPkOYLVPtPgIt0MxizjfFJov3JbHyAi,9,7,3,0,3,0,6,0,19,2.7142857142857144,1,0.0,2,3,0,3,5,0,0,6,0,8,11,1
4829,46513,EiO5bky9R1Iqlpv4ItUpPBUgGb1eJItE,fbPkOYLVPtPgIt0MxizjfFJov3JbHyAi,5,2,1,0,1,0,2,0,6,0.8571428571428571,2,0.0,0,1,0,1,2,0,0,2,0,2,4,1
4830,46514,wQDLnIhQRiBlJ7OOKtAQT7egktqnXxWd,fbPkOYLVPtPgIt0MxizjfFJov3JbHyAi,13,9,6,0,5,18,11,1,50,7.142857142857143,1,0.0,0,6,0,5,9,18,0,11,1,11,39,1
4831,46515,ZalaHb2nOUsnNI2p4xQ00VNI9pJY08yk,fbPkOYLVPtPgIt0MxizjfFJov3JbHyAi,2,0,0,0,0,0,2,0,2,0.2857142857142857,1,0.0,0,0,0,0,0,0,0,2,0,0,2,1
4832,46516,WvBcJWjHUn0OSdcSOrveOYpPP7iy97HT,fbPkOYLVPtPgIt0MxizjfFJov3JbHyAi,3,0,0,0,0,0,7,0,7,1.0,1,0.0,0,0,0,0,0,0,0,7,0,0,7,1
4833,46517,MN4wOgynUY4QcRaraCB5Ym52vNjUttfc,fbPkOYLVPtPgIt0MxizjfFJov3JbHyAi,9,3,2,0,2,1,5,1,14,2.0,2,0.0,0,2,0,2,3,1,0,5,1,4,10,1
4834,46518,zNp29QwJYW19LnSbsZ5BdQrNdzMHpz2F,fbPkOYLVPtPgIt0MxizjfFJov3JbHyAi,27,53,30,12,20,22,8,0,145,20.714285714285715,3,0.0,14,30,11,20,39,22,1,8,0,75,70,1
4835,46519,q0GqO7mYZSUjsbmDGsoT5N4ppqd8vOBB,fbPkOYLVPtPgIt0MxizjfFJov3JbHyAi,7,4,2,0,2,0,4,0,12,1.7142857142857142,1,0.0,0,2,0,2,4,0,0,4,0,4,8,1
4836,46520,SK3evWrWxCZl0iqN8sbmSNUdgxEYSLSK,fbPkOYLVPtPgIt0MxizjfFJov3JbHyAi,2,0,0,0,0,0,2,0,2,0.2857142857142857,1,0.0,0,0,0,0,0,0,0,2,0,0,2,1
4837,46522,EfURFHip4N6v2zuhSrNJ2KVVAM4Td3mY,fbPkOYLVPtPgIt0MxizjfFJov3JbHyAi,11,11,4,0,4,0,1,0,20,2.857142857142857,1,0.0,0,4,0,4,11,0,0,1,0,8,12,1
4838,46523,UD5FqfNicjboiN32GGPYtIcMIUIxLZOX,fbPkOYLVPtPgIt0MxizjfFJov3JbHyAi,6,4,3,0,3,0,1,0,11,1.5714285714285714,1,0.0,0,3,0,3,4,0,0,1,0,6,5,1
4839,46524,2QBIivovfBXOULGvBnn18Q4kSGQH3yTO,fbPkOYLVPtPgIt0MxizjfFJov3JbHyAi,7,2,1,0,1,0,4,0,8,1.1428571428571428,1,0.0,0,1,0,1,2,0,0,4,0,2,6,1
4840,46526,LTrIeWW4Gi4Y09oaKB1naUI4GII0UZAi,fbPkOYLVPtPgIt0MxizjfFJov3JbHyAi,4,3,0,0,0,0,5,0,8,1.1428571428571428,1,0.0,0,0,0,0,3,0,0,5,0,0,8,1
4841,46527,8JTz84ZDdJm6tvsd7hgyCl1RB6wU6r2e,fbPkOYLVPtPgIt0MxizjfFJov3JbHyAi,23,48,20,13,18,29,23,2,153,21.857142857142858,5,0.0,19,20,10,18,29,29,3,23,2,67,86,1
4842,46529,HQVRezU89umSvdjmOYF3nS0qPRPvMBxw,fbPkOYLVPtPgIt0MxizjfFJov3JbHyAi,8,5,2,0,3,0,3,0,13,1.8571428571428572,1,0.0,3,2,0,3,2,0,0,3,0,8,5,1
4843,46530,TBXYAxwexaNd47Tj9eT3p3QhXiwNSKj3,fbPkOYLVPtPgIt0MxizjfFJov3JbHyAi,1,0,0,0,0,0,1,0,1,0.14285714285714285,1,0.0,0,0,0,0,0,0,0,1,0,0,1,1
4844,46531,KbMG2R5hi7lV4ttClunSqF2UarKF8FNZ,fbPkOYLVPtPgIt0MxizjfFJov3JbHyAi,40,107,28,14,24,85,46,3,307,43.857142857142854,9,0.0,18,28,14,24,89,85,0,46,3,84,223,1
4845,46533,pRxI77wBFvTUHzDy8YsNcKJFbpdAZGNh,fbPkOYLVPtPgIt0MxizjfFJov3JbHyAi,15,9,5,0,4,3,7,1,29,4.142857142857143,2,0.0,0,5,0,4,9,3,0,7,1,9,20,1
4846,46534,KvCAdo1odeI84idtqyQZyVEKdaH6IDdM,fbPkOYLVPtPgIt0MxizjfFJov3JbHyAi,49,173,88,32,26,166,51,3,539,77.0,11,0.0,19,88,31,26,154,166,1,51,3,164,375,1
4847,46536,8HQsMOkKLewVMfte6VD2DYuU0urKWHXv,fbPkOYLVPtPgIt0MxizjfFJov3JbHyAi,14,40,15,4,12,9,22,1,103,14.714285714285714,6,0.0,13,15,4,12,27,9,0,22,1,44,59,0
4848,46540,25lc3om6HRn7SihjBlQbrBSLSUySLWnG,fbPkOYLVPtPgIt0MxizjfFJov3JbHyAi,7,3,2,0,2,0,2,0,9,1.2857142857142858,1,0.0,0,2,0,2,3,0,0,2,0,4,5,1
4849,46541,StTC3qGjYN4V41LymnTzXQRS0bQSlPrF,fbPkOYLVPtPgIt0MxizjfFJov3JbHyAi,7,4,2,0,2,0,2,0,10,1.4285714285714286,1,0.0,1,2,0,2,3,0,0,2,0,5,5,1
4850,46543,xBRGHAvkTfDDok4cH7N9aC7OMTMv6n3O,fbPkOYLVPtPgIt0MxizjfFJov3JbHyAi,7,5,4,0,3,0,4,0,16,2.2857142857142856,1,0.0,0,4,0,3,5,0,0,4,0,7,9,1
4851,46544,DAHT3MY5s8ge8Fy97bhkuUzIKyk1q8L2,fbPkOYLVPtPgIt0MxizjfFJov3JbHyAi,9,6,2,2,3,1,5,0,19,2.7142857142857144,1,0.0,3,2,2,3,3,1,0,5,0,10,9,1
4852,46547,GHqW2sFZULw6xLeFQhSQm5IW9wmBIZnH,fbPkOYLVPtPgIt0MxizjfFJov3JbHyAi,5,3,0,0,0,0,4,0,7,1.0,1,0.0,0,0,0,0,3,0,0,4,0,0,7,1
4853,46549,4ApVgPYGz6bz2SJLoGELpZ6RPnXwOa88,fbPkOYLVPtPgIt0MxizjfFJov3JbHyAi,67,208,89,60,55,44,43,0,499,71.28571428571429,19,0.0,76,89,49,55,132,44,11,43,0,269,230,0
4854,46550,F9UZi4Eyme7smBBGI6b8l0B0Zh1VRQUD,fbPkOYLVPtPgIt0MxizjfFJov3JbHyAi,10,6,3,0,2,1,13,1,26,3.7142857142857144,2,0.0,1,3,0,2,5,1,0,13,1,6,20,1
4855,46552,K3nS4VcLIzBgqPQsAsjEIOPChH8gvdgH,fbPkOYLVPtPgIt0MxizjfFJov3JbHyAi,8,2,1,0,1,2,8,1,15,2.142857142857143,1,0.0,0,1,0,1,2,2,0,8,1,2,13,1
4856,46555,QPiUGBr4vUjXTmo4VUV66g7hHPK0zcgj,fbPkOYLVPtPgIt0MxizjfFJov3JbHyAi,7,3,1,0,2,0,2,0,8,1.1428571428571428,1,0.0,0,1,0,2,3,0,0,2,0,3,5,1
4857,46556,VnuUyTHNwHr2LPEpDCNFEvbJ7YyA2Dtr,fbPkOYLVPtPgIt0MxizjfFJov3JbHyAi,7,2,1,0,1,0,6,1,11,1.5714285714285714,1,0.0,0,1,0,1,2,0,0,6,1,2,9,1
4858,46557,uoS96wNFUwtq7HfaPY02QxMEsIwJzjv6,fbPkOYLVPtPgIt0MxizjfFJov3JbHyAi,12,34,2,0,2,7,5,0,50,7.142857142857143,4,0.0,2,2,0,2,32,7,0,5,0,6,44,1
4859,46558,wgVuc0GdXqkgwRE7sGVxY1lchlcFK9wg,fbPkOYLVPtPgIt0MxizjfFJov3JbHyAi,3,0,0,0,0,0,5,0,5,0.7142857142857143,1,0.0,0,0,0,0,0,0,0,5,0,0,5,1
4860,46559,jl7dXdzz09XmO4Xe8w2lkGI7U7DzbG09,fbPkOYLVPtPgIt0MxizjfFJov3JbHyAi,8,6,4,0,3,0,3,0,16,2.2857142857142856,1,0.0,0,4,0,3,6,0,0,3,0,7,9,1
4861,46560,9giAVCaBxbNk2UdLbnYeVpzaUfG3nD03,fbPkOYLVPtPgIt0MxizjfFJov3JbHyAi,23,42,16,19,12,4,21,1,115,16.428571428571427,2,0.0,16,16,14,12,26,4,5,21,1,58,57,1
4862,46561,7ZyJguBzL4oDvx3QuauBv2Vv3pHBPVh3,fbPkOYLVPtPgIt0MxizjfFJov3JbHyAi,9,8,5,0,5,0,2,0,20,2.857142857142857,1,0.0,0,5,0,5,8,0,0,2,0,10,10,1
4863,46562,rCajReBu2KQJPlVlrrQZIZvrYAp8h9Yy,fbPkOYLVPtPgIt0MxizjfFJov3JbHyAi,2,0,0,0,0,0,3,0,3,0.42857142857142855,2,0.0,0,0,0,0,0,0,0,3,0,0,3,1
4864,46564,W7FXzdnq9Ktue5ZNM3TQmIP7HktmL3kC,fbPkOYLVPtPgIt0MxizjfFJov3JbHyAi,1,0,0,0,0,0,1,0,1,0.14285714285714285,1,0.0,0,0,0,0,0,0,0,1,0,0,1,1
4865,46565,wFCoKk3O7Yg710logPyDwMV7EivrZQCR,fbPkOYLVPtPgIt0MxizjfFJov3JbHyAi,1,0,0,0,0,0,1,0,1,0.14285714285714285,1,0.0,0,0,0,0,0,0,0,1,0,0,1,1
4866,46566,jFdhdjmfzOKKtloREabrCYP6a5dr6kJ3,fbPkOYLVPtPgIt0MxizjfFJov3JbHyAi,10,5,2,0,3,1,13,1,25,3.5714285714285716,1,0.0,2,2,0,3,3,1,0,13,1,7,18,1
4867,46567,UPecCjx5RBL6BceSov5rJLAaDoiPXUhg,fbPkOYLVPtPgIt0MxizjfFJov3JbHyAi,9,7,4,0,2,0,14,1,28,4.0,4,0.0,0,4,0,2,7,0,0,14,1,6,22,1
4868,46568,a9pvo8cVBjTHxQYvCPfHB4tPGRdFjAui,fbPkOYLVPtPgIt0MxizjfFJov3JbHyAi,13,8,5,0,4,2,13,1,33,4.714285714285714,1,0.0,0,5,0,4,8,2,0,13,1,9,24,1
4869,46569,EvnDUDuRuksYPdrCaUQQweT0GY5Najoh,fbPkOYLVPtPgIt0MxizjfFJov3JbHyAi,6,4,2,0,1,0,3,0,10,1.4285714285714286,2,0.0,0,2,0,1,4,0,0,3,0,3,7,1
4870,46570,1w8EW76qmBSgQ2s8Jb4yoPsNX01KUcoD,fbPkOYLVPtPgIt0MxizjfFJov3JbHyAi,10,3,2,0,2,1,7,1,16,2.2857142857142856,1,0.0,0,2,0,2,3,1,0,7,1,4,12,1
4871,46571,ZKAk08L8Iriz8Uv5UOeqSbrNnzg1rlMz,fbPkOYLVPtPgIt0MxizjfFJov3JbHyAi,9,9,6,0,4,0,12,0,31,4.428571428571429,2,0.0,1,6,0,4,8,0,0,12,0,11,20,1
4872,46573,IvhEQ40qNYap5nunxQhwiW2fnAok3TLS,fbPkOYLVPtPgIt0MxizjfFJov3JbHyAi,9,5,3,0,2,31,6,1,48,6.857142857142857,2,0.0,0,3,0,2,5,31,0,6,1,5,43,0
4873,46574,mZc1V3rQTRH4oqK1zqSjimuZcPwomnsE,fbPkOYLVPtPgIt0MxizjfFJov3JbHyAi,5,7,4,0,0,14,2,0,27,3.857142857142857,1,0.0,2,4,0,0,5,14,0,2,0,6,21,1
4874,46576,a8wX3Bl3kW6KFXwHZ6A5CPXKLBX1p4MZ,fbPkOYLVPtPgIt0MxizjfFJov3JbHyAi,2,0,0,0,0,0,3,0,3,0.42857142857142855,1,0.0,0,0,0,0,0,0,0,3,0,0,3,1
4875,46577,Edq6Echk8wEs8ShX5RBw5c8Yx8ANHVje,fbPkOYLVPtPgIt0MxizjfFJov3JbHyAi,1,0,0,0,0,0,1,0,1,0.14285714285714285,1,0.0,0,0,0,0,0,0,0,1,0,0,1,1
4876,46578,xpD8zL0kPAHItDUStTwEIkWWrm8dDFmA,fbPkOYLVPtPgIt0MxizjfFJov3JbHyAi,10,6,3,0,2,3,5,1,20,2.857142857142857,1,0.0,0,3,0,2,6,3,0,5,1,5,15,1
4877,46579,LWBASHvZlE9V0DOIMqscGs93ncFzXARw,fbPkOYLVPtPgIt0MxizjfFJov3JbHyAi,8,9,4,0,3,0,3,0,19,2.7142857142857144,1,0.0,2,4,0,3,7,0,0,3,0,9,10,1
4878,46580,sn1OZIzg3ZOiyRClBvvQLUKwx6tymOkC,fbPkOYLVPtPgIt0MxizjfFJov3JbHyAi,31,36,17,12,17,2,10,2,96,13.714285714285714,3,0.0,16,17,11,17,20,2,1,10,2,61,35,1
4879,46581,sw536JzryZ42F137fkltWvrIc3QLRo3o,fbPkOYLVPtPgIt0MxizjfFJov3JbHyAi,8,3,2,0,0,1,6,1,13,1.8571428571428572,1,0.0,0,2,0,0,3,1,0,6,1,2,11,1
4880,46582,Ikjjxpfg5ascMIjhTuGW8BkxPihDwWmv,fbPkOYLVPtPgIt0MxizjfFJov3JbHyAi,32,41,20,15,17,2,5,0,100,14.285714285714286,2,0.0,13,20,12,17,28,2,3,5,0,62,38,1
4881,46585,1fz7RS94t8nuoMroWFq8B06N4IWtq90I,fbPkOYLVPtPgIt0MxizjfFJov3JbHyAi,2,0,0,0,0,0,2,0,2,0.2857142857142857,1,0.0,0,0,0,0,0,0,0,2,0,0,2,1
4882,46587,lDJqver3AFFUyXISNdqvZpmq6OeWVl0r,fbPkOYLVPtPgIt0MxizjfFJov3JbHyAi,10,9,4,2,3,0,2,0,20,2.857142857142857,2,0.0,2,4,2,3,7,0,0,2,0,11,9,1
4883,46588,yfppFvC7mTSlPuhod9GGDRPkzP1HmCAu,fbPkOYLVPtPgIt0MxizjfFJov3JbHyAi,57,76,33,35,26,0,18,0,188,26.857142857142858,9,0.0,23,33,29,26,53,0,6,18,0,111,77,1
4884,46589,Q8UiR0g4rvfffexhCwFYjhzrBs6RScJA,fbPkOYLVPtPgIt0MxizjfFJov3JbHyAi,8,4,3,0,2,8,6,0,23,3.2857142857142856,1,0.0,0,3,0,2,4,8,0,6,0,5,18,1
4885,46590,DeMkq0IaxnRQrXCQHQpz60sFvrsX1jLn,fbPkOYLVPtPgIt0MxizjfFJov3JbHyAi,15,10,6,0,6,13,11,1,47,6.714285714285714,1,0.0,2,6,0,6,8,13,0,11,1,14,33,1
4886,46593,xanxsjSeaVNFCeWQJAicKck5SsVFdK55,fbPkOYLVPtPgIt0MxizjfFJov3JbHyAi,13,6,5,0,5,0,3,0,19,2.7142857142857144,1,0.0,0,5,0,5,6,0,0,3,0,10,9,1
4887,46646,2oTvbzieHn2y5oozeOgSnruqE6N0BtR5,5Gyp41oLVo7Gg7vF4vpmggWP5MU70QO6,17,17,12,0,6,30,8,0,73,10.428571428571429,6,0.0,0,12,0,6,17,30,0,8,0,18,55,1
4888,46649,ChPPAGWXLjJOcvxbkBJCrEsWXeInJLVE,5Gyp41oLVo7Gg7vF4vpmggWP5MU70QO6,2,0,0,0,0,0,2,0,2,0.2857142857142857,1,0.0,0,0,0,0,0,0,0,2,0,0,2,1
4889,46652,WlHV3frRLxQmTIY14HccRXj4N1zg8F2y,5Gyp41oLVo7Gg7vF4vpmggWP5MU70QO6,15,23,13,9,5,4,9,0,63,9.0,3,0.0,5,13,5,5,18,4,4,9,0,28,35,1
4890,46688,uyomj5PLSD8MuBnIm3UXNOM2zJB1f3kv,5Gyp41oLVo7Gg7vF4vpmggWP5MU70QO6,1,0,0,0,0,0,3,0,3,0.42857142857142855,1,0.0,0,0,0,0,0,0,0,3,0,0,3,1
4891,46702,A2ltJRV014QmRntZJESj7uXdpJ35f6dG,5Gyp41oLVo7Gg7vF4vpmggWP5MU70QO6,6,4,3,0,3,0,2,0,12,1.7142857142857142,2,0.0,0,3,0,3,4,0,0,2,0,6,6,1
4892,46731,UksrT9uZpkXySHca79ioRcFHJPZnRC7P,5Gyp41oLVo7Gg7vF4vpmggWP5MU70QO6,6,10,0,0,0,0,8,0,18,2.5714285714285716,3,0.0,0,0,0,0,10,0,0,8,0,0,18,1
4893,46746,3vqQLZ6JghUm5esklBRrz7FDiDY28Hou,5Gyp41oLVo7Gg7vF4vpmggWP5MU70QO6,1,0,0,0,0,0,1,0,1,0.14285714285714285,1,0.0,0,0,0,0,0,0,0,1,0,0,1,1
4894,46797,2ohWJM8Yz0bj21lrvUC1zfEo5S0znXME,5Gyp41oLVo7Gg7vF4vpmggWP5MU70QO6,7,3,2,0,2,0,2,0,9,1.2857142857142858,1,0.0,0,2,0,2,3,0,0,2,0,4,5,1
4895,46814,OjGyl0UXyxUIsMjT5wg70EZca2HITJbI,5Gyp41oLVo7Gg7vF4vpmggWP5MU70QO6,7,8,0,2,0,0,1,0,11,1.5714285714285714,1,0.0,3,0,1,0,5,0,1,1,0,4,7,1
4896,46815,qKYtIVDmi6VA6pm5FT1o0wAtundA5Xuz,5Gyp41oLVo7Gg7vF4vpmggWP5MU70QO6,2,0,0,0,0,0,2,0,2,0.2857142857142857,1,0.0,0,0,0,0,0,0,0,2,0,0,2,1
4897,46820,PqjTLf02cAkV5YbASLPzwWc5VEK93PK4,5Gyp41oLVo7Gg7vF4vpmggWP5MU70QO6,1,0,0,0,0,0,1,0,1,0.14285714285714285,1,0.0,0,0,0,0,0,0,0,1,0,0,1,1
4898,46825,udPAdZACFu9qQIos0rVmiiJQKeh3MpdC,5Gyp41oLVo7Gg7vF4vpmggWP5MU70QO6,6,1,1,0,1,0,3,0,6,0.8571428571428571,1,0.0,0,1,0,1,1,0,0,3,0,2,4,1
4899,46841,0dms1IW6FOb0POIRwTHzUSJrRJ5hu0UE,5Gyp41oLVo7Gg7vF4vpmggWP5MU70QO6,4,2,0,0,0,0,3,0,5,0.7142857142857143,2,0.0,0,0,0,0,2,0,0,3,0,0,5,1
4900,46874,IJVC32xhcxjduQ5Gn9dQV405cC7i6x7I,5Gyp41oLVo7Gg7vF4vpmggWP5MU70QO6,1,0,0,0,0,0,2,0,2,0.2857142857142857,2,0.0,0,0,0,0,0,0,0,2,0,0,2,1
4901,46875,rGQTQPCj4MkWBrqDuJjICbRv72TLNOkd,5Gyp41oLVo7Gg7vF4vpmggWP5MU70QO6,35,124,45,31,26,0,8,0,234,33.42857142857143,10,0.0,30,45,23,26,94,0,8,8,0,124,110,1
4902,46880,R23hQIkxpjGDipcAUB8Dm9M15B8oN1UL,5Gyp41oLVo7Gg7vF4vpmggWP5MU70QO6,59,289,100,64,58,62,44,2,619,88.42857142857143,17,0.0,72,100,57,58,217,62,7,44,2,287,332,1
4903,46885,vPWxY9z39Ezw02NfLhJz3CxUkYQ2CwWv,5Gyp41oLVo7Gg7vF4vpmggWP5MU70QO6,11,7,3,0,2,3,6,1,22,3.142857142857143,1,0.0,0,3,0,2,7,3,0,6,1,5,17,1
4904,46895,KkdnagFJtwwq5n9Iuy7rnQaTqa2llFa9,5Gyp41oLVo7Gg7vF4vpmggWP5MU70QO6,1,0,0,0,0,0,1,0,1,0.14285714285714285,1,0.0,0,0,0,0,0,0,0,1,0,0,1,1
4905,46901,Zdg1uIW24XoYJfffRXskUWqO3GRGh1cm,5Gyp41oLVo7Gg7vF4vpmggWP5MU70QO6,1,0,0,0,0,0,1,0,1,0.14285714285714285,1,0.0,0,0,0,0,0,0,0,1,0,0,1,0
4906,46939,6CZ44kCZyXFJv3rUR0UsacGRiDDxYx36,5Gyp41oLVo7Gg7vF4vpmggWP5MU70QO6,11,6,3,0,2,2,5,1,19,2.7142857142857144,1,0.0,0,3,0,2,6,2,0,5,1,5,14,1
4907,46942,fR2E6PlrT89XonVUCw1GWPWZCJzvjBZf,5Gyp41oLVo7Gg7vF4vpmggWP5MU70QO6,11,14,7,0,2,0,7,1,31,4.428571428571429,3,0.0,2,7,0,2,12,0,0,7,1,11,20,1
4908,46946,PzUJiLnP9HZJxQE6JmMTkx1KTzCMtAvI,5Gyp41oLVo7Gg7vF4vpmggWP5MU70QO6,46,129,61,30,49,18,25,1,313,44.714285714285715,11,0.0,38,61,24,49,91,18,6,25,1,172,141,0
4909,47053,7Rn3hb72XefKlNlHmNoLxuG2tiWg1aaJ,5Gyp41oLVo7Gg7vF4vpmggWP5MU70QO6,1,0,0,0,0,0,1,0,1,0.14285714285714285,1,0.0,0,0,0,0,0,0,0,1,0,0,1,1
4910,47086,AN4HmcutTb9ny7T8ABd8AMRexI72L33r,5Gyp41oLVo7Gg7vF4vpmggWP5MU70QO6,5,2,1,0,1,0,2,0,6,0.8571428571428571,1,0.0,0,1,0,1,2,0,0,2,0,2,4,1
4911,47099,kYP6qVgwLllQLSDA9DOLDLy7RCAMCJv3,5Gyp41oLVo7Gg7vF4vpmggWP5MU70QO6,1,0,0,0,0,0,2,0,2,0.2857142857142857,2,0.0,0,0,0,0,0,0,0,2,0,0,2,1
4912,47100,MSu8uokJrqtcfhrphP9QLIIZpwlmW0dM,5Gyp41oLVo7Gg7vF4vpmggWP5MU70QO6,10,3,2,0,2,0,5,1,13,1.8571428571428572,1,0.0,0,2,0,2,3,0,0,5,1,4,9,1
4913,47108,LBiRwhykvYlkPokFukwKE3pfXRl4e4Nw,5Gyp41oLVo7Gg7vF4vpmggWP5MU70QO6,26,56,34,11,13,3,15,0,132,18.857142857142858,7,0.0,8,34,8,13,48,3,3,15,0,63,69,1
4914,47109,7CSUleiRarcLK2kAOLxC7f9jw7tD5CFm,5Gyp41oLVo7Gg7vF4vpmggWP5MU70QO6,2,0,0,0,0,0,2,0,2,0.2857142857142857,1,0.0,0,0,0,0,0,0,0,2,0,0,2,1
4915,47130,EoD3EPwCtMDgR3Yh3AaRps1fXec0M2Cq,5Gyp41oLVo7Gg7vF4vpmggWP5MU70QO6,8,2,1,0,1,6,5,1,16,2.2857142857142856,1,0.0,0,1,0,1,2,6,0,5,1,2,14,1
4916,47161,NKPeepA3hQnHdKRyw33rMh6Zq6nPT7FT,5Gyp41oLVo7Gg7vF4vpmggWP5MU70QO6,7,1,1,0,1,1,4,1,9,1.2857142857142858,1,0.0,0,1,0,1,1,1,0,4,1,2,7,1
4917,47178,2IlOpdUgsPu5FVltj0flScFk4CeI7uHm,5Gyp41oLVo7Gg7vF4vpmggWP5MU70QO6,45,89,50,17,28,0,11,0,195,27.857142857142858,9,0.0,29,50,13,28,60,0,4,11,0,120,75,0
4918,47203,yTX2Jyu87XEx5E4DQx6ATrV6A8yZCtx8,5Gyp41oLVo7Gg7vF4vpmggWP5MU70QO6,13,12,5,4,1,0,6,1,29,4.142857142857143,1,0.0,4,5,2,1,8,0,2,6,1,12,17,1
4919,47216,Ps49WR7JAUr7AYdC7h3mibwaZxBToJ9x,5Gyp41oLVo7Gg7vF4vpmggWP5MU70QO6,5,3,0,0,0,0,2,0,5,0.7142857142857143,1,0.0,0,0,0,0,3,0,0,2,0,0,5,1
4920,47234,lhqDZaoCZ3mGBNgKLZFtbu2ZrL5HMtBO,5Gyp41oLVo7Gg7vF4vpmggWP5MU70QO6,12,11,4,8,2,0,3,0,28,4.0,2,0.0,4,4,4,2,7,0,4,3,0,14,14,1
4921,47260,WPblqwZeU5ajyY3BRhsjT3hZDiujE30u,5Gyp41oLVo7Gg7vF4vpmggWP5MU70QO6,6,5,2,0,1,0,4,0,12,1.7142857142857142,2,0.0,0,2,0,1,5,0,0,4,0,3,9,1
4922,47269,SsiBwdLtgBlftQTMaumuPfeXEp9eUN1X,5Gyp41oLVo7Gg7vF4vpmggWP5MU70QO6,7,2,2,0,2,0,9,0,15,2.142857142857143,1,0.0,0,2,0,2,2,0,0,9,0,4,11,1
4923,47279,3DMxdIMHShIiQg7VSSohBgQL1oCtuKe4,5Gyp41oLVo7Gg7vF4vpmggWP5MU70QO6,1,0,0,0,0,0,1,0,1,0.14285714285714285,1,0.0,0,0,0,0,0,0,0,1,0,0,1,1
4924,47302,MiCMgORFv7zcK9ifQfoTyiXHDYEy0Hya,5Gyp41oLVo7Gg7vF4vpmggWP5MU70QO6,1,0,0,0,0,0,2,0,2,0.2857142857142857,2,0.0,0,0,0,0,0,0,0,2,0,0,2,1
4925,47307,8foblRi4wVKVsqYG54QGJuMyU0kKzfol,5Gyp41oLVo7Gg7vF4vpmggWP5MU70QO6,7,7,3,0,1,0,3,0,14,2.0,2,0.0,0,3,0,1,7,0,0,3,0,4,10,1
4926,47308,13tiSzY0chA1pGgz0ufAF1ovTa0Ig4M9,5Gyp41oLVo7Gg7vF4vpmggWP5MU70QO6,3,0,0,0,0,0,3,0,3,0.42857142857142855,1,0.0,0,0,0,0,0,0,0,3,0,0,3,1
4927,47325,hiXDc0k3aCbg2PlfMmAMtnsGGLI4iZVQ,5Gyp41oLVo7Gg7vF4vpmggWP5MU70QO6,14,26,12,0,3,5,15,7,68,9.714285714285714,2,0.0,10,12,0,3,16,5,0,15,7,25,43,1
4928,47329,aLx6tqFKc1WBqw4OJHQenDKCxxPmguKp,5Gyp41oLVo7Gg7vF4vpmggWP5MU70QO6,15,29,13,24,8,7,14,2,97,13.857142857142858,4,0.0,12,13,16,8,17,7,8,14,2,49,48,1
4929,47332,n6NqKWHbujcWwPsIefeHUye27F23G5Fc,5Gyp41oLVo7Gg7vF4vpmggWP5MU70QO6,5,2,1,0,1,0,3,0,7,1.0,2,0.0,0,1,0,1,2,0,0,3,0,2,5,1
4930,47351,08I7chCQLVbkYM7rzYTgQRCe1Rqknw8j,5Gyp41oLVo7Gg7vF4vpmggWP5MU70QO6,5,2,1,0,1,0,2,0,6,0.8571428571428571,1,0.0,0,1,0,1,2,0,0,2,0,2,4,0
4931,47375,BMzdtRq4jFCbcZn2YgqIrxxJku0U75Jw,5Gyp41oLVo7Gg7vF4vpmggWP5MU70QO6,4,6,2,0,0,0,1,0,9,1.2857142857142858,1,0.0,1,2,0,0,5,0,0,1,0,3,6,1
4932,47388,WiK9tHCI6mpcFaEiJu6yf2bid0YSS9EI,5Gyp41oLVo7Gg7vF4vpmggWP5MU70QO6,9,11,3,0,2,1,8,1,26,3.7142857142857144,2,0.0,1,3,0,2,10,1,0,8,1,6,20,1
4933,47426,MlXPAe2Mde9SLAFh4p1AjIP3gik3uaY9,5Gyp41oLVo7Gg7vF4vpmggWP5MU70QO6,11,10,7,0,2,3,6,1,29,4.142857142857143,1,0.0,0,7,0,2,10,3,0,6,1,9,20,1
4934,47433,tonn5pllkTnaCaGk8YHtyjAEYoGoXUOU,5Gyp41oLVo7Gg7vF4vpmggWP5MU70QO6,14,11,6,4,4,0,3,0,28,4.0,2,0.0,3,6,2,4,8,0,2,3,0,15,13,1
4935,47441,ymtZufbqplidzhGpHtpCiBNDNle3lhjP,5Gyp41oLVo7Gg7vF4vpmggWP5MU70QO6,16,23,12,17,5,40,7,2,106,15.142857142857142,3,0.0,9,12,11,5,14,40,6,7,2,37,69,1
4936,47469,UInMBEH8f1h2vxXVslRsWyLOTv8ggYq3,5Gyp41oLVo7Gg7vF4vpmggWP5MU70QO6,56,148,70,39,39,230,24,3,553,79.0,8,0.0,55,70,25,39,93,230,14,24,3,189,364,0
4937,47471,6Zorv2eopTl8p8w8wdczv6lkz7zHm2Tr,5Gyp41oLVo7Gg7vF4vpmggWP5MU70QO6,6,5,2,0,2,0,1,0,10,1.4285714285714286,1,0.0,0,2,0,2,5,0,0,1,0,4,6,0
4938,47498,13oVrtAIMfOBA6qL5c4deu3cWIzI6x2g,5Gyp41oLVo7Gg7vF4vpmggWP5MU70QO6,1,0,0,0,0,0,1,0,1,0.14285714285714285,1,0.0,0,0,0,0,0,0,0,1,0,0,1,1
4939,47502,Ns3kulnSgUfdqxtVnHTwG91vJk1uWDwd,5Gyp41oLVo7Gg7vF4vpmggWP5MU70QO6,14,15,8,4,4,0,5,0,36,5.142857142857143,4,0.0,1,8,3,4,14,0,1,5,0,16,20,1
4940,47503,fMKM67c14wKHVstEXubAi7fRpdq2638L,5Gyp41oLVo7Gg7vF4vpmggWP5MU70QO6,7,4,2,0,3,0,2,0,11,1.5714285714285714,1,0.0,1,2,0,3,3,0,0,2,0,6,5,1
4941,47531,WjTwXU0UqHfY2vRQjeMISV15DHgkpGUt,5Gyp41oLVo7Gg7vF4vpmggWP5MU70QO6,12,18,6,10,6,2,4,0,46,6.571428571428571,1,0.0,10,6,5,6,8,2,5,4,0,27,19,1
4942,47541,TJlzMjBEw43ixyrT7o78I9Gv7heY2xXr,5Gyp41oLVo7Gg7vF4vpmggWP5MU70QO6,5,2,1,0,1,0,2,0,6,0.8571428571428571,1,0.0,0,1,0,1,2,0,0,2,0,2,4,1
4943,47551,3BYsGgCfnWUgGDTNtmTCAaUReolsgTgX,5Gyp41oLVo7Gg7vF4vpmggWP5MU70QO6,10,9,5,0,1,6,10,2,33,4.714285714285714,1,0.0,3,5,0,1,6,6,0,10,2,9,24,1
4944,47554,7iS5tFy4UHN1pupJYZ89Sj2B4of3T7lL,5Gyp41oLVo7Gg7vF4vpmggWP5MU70QO6,1,0,0,0,0,0,1,0,1,0.14285714285714285,1,0.0,0,0,0,0,0,0,0,1,0,0,1,1
4945,47563,GV3JVe1AsW4CH30RPVR8PwpHghCeZots,5Gyp41oLVo7Gg7vF4vpmggWP5MU70QO6,19,47,16,20,9,19,8,1,120,17.142857142857142,3,0.0,14,16,17,9,33,19,3,8,1,56,64,0
4946,47569,82UlWF6Fm1gkNum7nNbVw0yOV1BUdNoS,5Gyp41oLVo7Gg7vF4vpmggWP5MU70QO6,14,18,7,4,2,9,12,5,57,8.142857142857142,1,0.0,7,7,2,2,11,9,2,12,5,18,39,1
4947,47571,Snd5iINQfQsdqJYb8fCoHFcIa7fWA7ac,5Gyp41oLVo7Gg7vF4vpmggWP5MU70QO6,5,2,1,0,1,0,2,0,6,0.8571428571428571,1,0.0,0,1,0,1,2,0,0,2,0,2,4,1
4948,47587,sv2NeuLE6EuaEeLqlDnQ62bMEYW4pvkK,5Gyp41oLVo7Gg7vF4vpmggWP5MU70QO6,5,2,1,0,1,0,4,0,8,1.1428571428571428,2,0.0,0,1,0,1,2,0,0,4,0,2,6,1
4949,47632,zK5IGnc4ujOFuVSnt7npr6foktv9atH5,5Gyp41oLVo7Gg7vF4vpmggWP5MU70QO6,16,26,17,14,1,16,9,0,83,11.857142857142858,4,0.0,5,17,9,1,21,16,5,9,0,32,51,0
4950,47656,LdJlatZF3iaqoaNuDvuaBBgS6L8Hic6g,5Gyp41oLVo7Gg7vF4vpmggWP5MU70QO6,9,7,4,0,2,0,3,1,17,2.4285714285714284,1,0.0,2,4,0,2,5,0,0,3,1,8,9,1
4951,47662,4YOswl65MZZJx0V3vWOYS4fWFhjsESFM,5Gyp41oLVo7Gg7vF4vpmggWP5MU70QO6,7,3,1,0,1,0,4,0,9,1.2857142857142858,1,0.0,0,1,0,1,3,0,0,4,0,2,7,1
4952,47663,Wd5Y51TL4njlLeYHUjz5D9nrsHvDXUZ8,5Gyp41oLVo7Gg7vF4vpmggWP5MU70QO6,12,16,10,6,6,0,3,0,41,5.857142857142857,3,0.0,3,10,4,6,13,0,2,3,0,23,18,1
4953,47669,zfz1vgUWQGuotO2E94rqVWoT88PRB6Bw,5Gyp41oLVo7Gg7vF4vpmggWP5MU70QO6,19,28,9,12,2,11,8,1,71,10.142857142857142,2,0.0,16,9,10,2,12,11,2,8,1,37,34,1
4954,47680,5j9EQkqR4CZfRV8sku9HLld3NnlBiUj6,7GRhBDsirIGkRZBtSMEzNTyDr2JQm4xx,40,68,12,50,11,0,9,0,150,21.428571428571427,3,0.0,41,12,38,11,27,0,12,9,0,102,48,1
4955,47684,uTUI6KRhmxx7IJnVXjU43YiABIEqPIu0,7GRhBDsirIGkRZBtSMEzNTyDr2JQm4xx,1,0,0,0,0,0,1,0,1,0.14285714285714285,1,0.0,0,0,0,0,0,0,0,1,0,0,1,1
4956,47685,wdto087emiBYs3iOi0TPUdGcY6oYrMuN,7GRhBDsirIGkRZBtSMEzNTyDr2JQm4xx,18,23,4,5,5,0,5,0,42,6.0,2,0.0,9,4,4,5,14,0,1,5,0,22,20,1
4957,47686,O2P3OL1YuWbYShJfJIUxOipsTSIZNEDh,7GRhBDsirIGkRZBtSMEzNTyDr2JQm4xx,1,0,0,0,0,0,1,0,1,0.14285714285714285,1,0.0,0,0,0,0,0,0,0,1,0,0,1,1
4958,47692,95Grptw4kDgsizkydsN3dmZo4P1FRwZY,7GRhBDsirIGkRZBtSMEzNTyDr2JQm4xx,72,160,7,72,30,3,26,0,298,42.57142857142857,5,0.0,74,7,57,30,86,3,15,26,0,168,130,0
4959,47701,YCG7k31JW9D1itnYH0cr5f9GRGUr0mhA,7GRhBDsirIGkRZBtSMEzNTyDr2JQm4xx,4,2,0,0,0,0,2,0,4,0.5714285714285714,1,0.0,0,0,0,0,2,0,0,2,0,0,4,1
4960,47702,puC0Dx9PufKMVxVv15STTWR0hwd8EG3K,7GRhBDsirIGkRZBtSMEzNTyDr2JQm4xx,1,0,0,0,0,0,1,0,1,0.14285714285714285,1,0.0,0,0,0,0,0,0,0,1,0,0,1,1
4961,47703,kRQ28BRN3y8KOf3kwDvz0FCqLY1WqOEG,7GRhBDsirIGkRZBtSMEzNTyDr2JQm4xx,1,0,0,0,0,0,1,0,1,0.14285714285714285,1,0.0,0,0,0,0,0,0,0,1,0,0,1,1
4962,47709,gSg4PIaWl0hBhOgVlpN9o8YrQn4pTOeq,7GRhBDsirIGkRZBtSMEzNTyDr2JQm4xx,2,0,0,0,0,0,4,0,4,0.5714285714285714,2,0.0,0,0,0,0,0,0,0,4,0,0,4,1
4963,47714,WWICY0NkATiqKREzdAqASrAU03XmfBat,7GRhBDsirIGkRZBtSMEzNTyDr2JQm4xx,1,0,0,0,0,0,1,0,1,0.14285714285714285,1,0.0,0,0,0,0,0,0,0,1,0,0,1,1
4964,47717,eiL4sJzBUqNqEAwJXavGTHQchRgg0E9e,7GRhBDsirIGkRZBtSMEzNTyDr2JQm4xx,9,9,1,0,0,0,6,0,16,2.2857142857142856,1,0.0,0,1,0,0,9,0,0,6,0,1,15,1
4965,47718,30aCxwCoAgz4qD7x8ZM6PJzP56H1XgXO,7GRhBDsirIGkRZBtSMEzNTyDr2JQm4xx,1,0,0,0,0,0,1,0,1,0.14285714285714285,1,0.0,0,0,0,0,0,0,0,1,0,0,1,1
4966,47720,ez0SzsgZVxpWE67j4N1f6LtoZWfI9k7n,7GRhBDsirIGkRZBtSMEzNTyDr2JQm4xx,1,0,0,0,0,0,1,0,1,0.14285714285714285,1,0.0,0,0,0,0,0,0,0,1,0,0,1,1
4967,47721,svYzSyhP0bZ3DU8gcol1OFQHTOvBNcYG,7GRhBDsirIGkRZBtSMEzNTyDr2JQm4xx,8,2,1,0,1,0,8,0,12,1.7142857142857142,1,0.0,0,1,0,1,2,0,0,8,0,2,10,1
4968,47725,yO35UgaD8utoCb4qpLRXsAlxVi0i8Hs2,7GRhBDsirIGkRZBtSMEzNTyDr2JQm4xx,34,47,11,20,11,4,10,1,104,14.857142857142858,2,0.0,19,11,11,11,28,4,9,10,1,52,52,1
4969,47729,eIiEaMQHQq16kuhBzHJT0OFud5tAHZrY,7GRhBDsirIGkRZBtSMEzNTyDr2JQm4xx,28,49,16,14,13,4,8,0,104,14.857142857142858,2,0.0,11,16,8,13,38,4,6,8,0,48,56,0
4970,47736,EAHXCpfuJzmzizJcl5we9ofgxUPQx6rn,7GRhBDsirIGkRZBtSMEzNTyDr2JQm4xx,11,7,5,0,4,0,2,0,18,2.5714285714285716,2,0.0,0,5,0,4,7,0,0,2,0,9,9,0
4971,47739,GpxTNWiiHORZrtpaNpqPl31grEf03aBZ,7GRhBDsirIGkRZBtSMEzNTyDr2JQm4xx,28,35,15,24,16,0,5,0,95,13.571428571428571,3,0.0,16,15,14,16,19,0,10,5,0,61,34,1
4972,47741,wbGn50klE5ZPJH3A1kcVq6c3LTgsQOiM,7GRhBDsirIGkRZBtSMEzNTyDr2JQm4xx,10,7,5,0,4,0,6,0,22,3.142857142857143,1,0.0,0,5,0,4,7,0,0,6,0,9,13,1
4973,47743,iiuR3N6D1WRXLO09fb3Myc2MlNCCDfce,fbPkOYLVPtPgIt0MxizjfFJov3JbHyAi,4,3,0,0,0,0,2,0,5,0.7142857142857143,1,0.0,0,0,0,0,3,0,0,2,0,0,5,1
4974,47744,vCEQKCbjX310wPLqLwTGRr7i4Nhg0wTp,fbPkOYLVPtPgIt0MxizjfFJov3JbHyAi,10,8,4,0,3,2,5,0,22,3.142857142857143,1,0.0,0,4,0,3,8,2,0,5,0,7,15,1
4975,47745,gHBHYv37TuKpRs5kVViSUWhCV5Lhiblh,fbPkOYLVPtPgIt0MxizjfFJov3JbHyAi,7,3,2,0,2,0,2,0,9,1.2857142857142858,1,0.0,0,2,0,2,3,0,0,2,0,4,5,1
4976,47746,8ZsblV6culyKvM3swAGhgvHIR3alJq9n,fbPkOYLVPtPgIt0MxizjfFJov3JbHyAi,6,4,2,0,1,4,2,0,13,1.8571428571428572,2,0.0,0,2,0,1,4,4,0,2,0,3,10,1
4977,47747,FmNtF0dqiST5GypmKkWanKtXqnTegJEy,fbPkOYLVPtPgIt0MxizjfFJov3JbHyAi,1,0,0,0,0,0,1,0,1,0.14285714285714285,1,0.0,0,0,0,0,0,0,0,1,0,0,1,1
4978,47749,kkpDZ77gSlUQ6KcLobLV9NQm1XnSLEFr,fbPkOYLVPtPgIt0MxizjfFJov3JbHyAi,1,0,0,0,0,0,1,0,1,0.14285714285714285,1,0.0,0,0,0,0,0,0,0,1,0,0,1,1
4979,47751,cNndd5chSMU3sSAeRXd6PJHkgPmrCB8z,fbPkOYLVPtPgIt0MxizjfFJov3JbHyAi,7,2,1,0,1,1,4,2,11,1.5714285714285714,1,0.0,0,1,0,1,2,1,0,4,2,2,9,1
4980,47754,Pp9LbsXIl32Hj8Wq17Qd9kc6BTy8YAGl,fbPkOYLVPtPgIt0MxizjfFJov3JbHyAi,8,2,1,0,1,0,6,1,11,1.5714285714285714,1,0.0,0,1,0,1,2,0,0,6,1,2,9,1
4981,47755,lz6lDEfdau9dm3sqop0RmJjc1H5uyps1,fbPkOYLVPtPgIt0MxizjfFJov3JbHyAi,8,2,2,0,2,0,3,0,9,1.2857142857142858,1,0.0,0,2,0,2,2,0,0,3,0,4,5,1
4982,47756,L0FSy0eDJB0vLjpSsrNVX0T1aJD3NXFR,fbPkOYLVPtPgIt0MxizjfFJov3JbHyAi,15,29,11,12,10,4,19,0,85,12.142857142857142,2,0.0,12,11,9,10,17,4,3,19,0,42,43,1
4983,47757,AVyLSaof0VtZQR2ODvUxATLv8wovFv6r,fbPkOYLVPtPgIt0MxizjfFJov3JbHyAi,5,1,1,0,1,0,5,0,8,1.1428571428571428,1,0.0,0,1,0,1,1,0,0,5,0,2,6,1
4984,47759,ihajxoAz8rtCLZp3NhTz4Dj4wyy7Ve6j,fbPkOYLVPtPgIt0MxizjfFJov3JbHyAi,16,26,13,13,12,5,11,3,83,11.857142857142858,2,0.0,9,13,9,12,17,5,4,11,3,43,40,1
4985,47761,wzqDZnt5ey5srxRDV6DOODvuoPbW2hmC,fbPkOYLVPtPgIt0MxizjfFJov3JbHyAi,3,0,0,0,0,0,3,0,3,0.42857142857142855,1,0.0,0,0,0,0,0,0,0,3,0,0,3,1
4986,47762,zcIKJMENggqIW9hSdKBxNE0nRwFUSouz,fbPkOYLVPtPgIt0MxizjfFJov3JbHyAi,7,5,2,0,2,0,2,0,11,1.5714285714285714,1,0.0,2,2,0,2,3,0,0,2,0,6,5,1
4987,47763,JVoHWX6804dBiuuywxHjLhyoqtZIkCFx,fbPkOYLVPtPgIt0MxizjfFJov3JbHyAi,1,0,0,0,0,0,1,0,1,0.14285714285714285,1,0.0,0,0,0,0,0,0,0,1,0,0,1,1
4988,47765,ri6NVluQbSKckezFilIjxRHtq5swKp7U,fbPkOYLVPtPgIt0MxizjfFJov3JbHyAi,7,4,3,0,2,2,1,0,12,1.7142857142857142,1,0.0,0,3,0,2,4,2,0,1,0,5,7,1
4989,47766,ag9HLImVQiPyL9rK7r26gIINFvgysNlx,fbPkOYLVPtPgIt0MxizjfFJov3JbHyAi,10,7,5,0,4,0,5,0,21,3.0,1,0.0,0,5,0,4,7,0,0,5,0,9,12,0
4990,47767,Y54KD3ZA4LZs5ByE3QveGSSA4lLE8N3J,fbPkOYLVPtPgIt0MxizjfFJov3JbHyAi,6,3,2,0,2,0,1,0,8,1.1428571428571428,1,0.0,0,2,0,2,3,0,0,1,0,4,4,1
4991,47768,Yjq3LhAjOWvN82KjjED7khdom1HyBA50,fbPkOYLVPtPgIt0MxizjfFJov3JbHyAi,4,2,1,0,0,0,2,0,5,0.7142857142857143,1,0.0,0,1,0,0,2,0,0,2,0,1,4,1
4992,47769,37QXIA2mA5HwR196s7DdMurvu7yccsaS,fbPkOYLVPtPgIt0MxizjfFJov3JbHyAi,5,2,1,0,1,0,4,0,8,1.1428571428571428,1,0.0,0,1,0,1,2,0,0,4,0,2,6,1
4993,47771,WEqUhplW7x1SpLabVjNcI5M4HsCYjumg,fbPkOYLVPtPgIt0MxizjfFJov3JbHyAi,7,3,2,0,2,0,2,0,9,1.2857142857142858,1,0.0,0,2,0,2,3,0,0,2,0,4,5,1
4994,47773,rPoI3YNCiMsaBvpMVe9YNNLovGBjXQL1,fbPkOYLVPtPgIt0MxizjfFJov3JbHyAi,5,2,1,0,1,0,2,0,6,0.8571428571428571,1,0.0,0,1,0,1,2,0,0,2,0,2,4,1
4995,47774,38RAlLJIctL7kclCvMfQ1cdfefa6tncU,fbPkOYLVPtPgIt0MxizjfFJov3JbHyAi,7,4,2,0,2,0,4,0,12,1.7142857142857142,1,0.0,0,2,0,2,4,0,0,4,0,4,8,1
4996,47775,NbFjLBlaokvKCRfsLwofmB9VjZfUQeXG,fbPkOYLVPtPgIt0MxizjfFJov3JbHyAi,6,6,4,0,4,0,2,0,16,2.2857142857142856,1,0.0,0,4,0,4,6,0,0,2,0,8,8,1
4997,47778,tF7Aut7t0G2GWI4HCraCbVOE9W7RdLCy,fbPkOYLVPtPgIt0MxizjfFJov3JbHyAi,2,0,0,0,0,0,6,0,6,0.8571428571428571,1,0.0,0,0,0,0,0,0,0,6,0,0,6,1
4998,47781,JelJmDAgdvYMwysu2S8khlhEiSoRMDm3,fbPkOYLVPtPgIt0MxizjfFJov3JbHyAi,64,115,54,51,36,20,19,0,295,42.142857142857146,5,0.0,51,54,50,36,64,20,1,19,0,191,104,0
4999,47782,TGulLRA4GuGoMcQ4GcDFWeudMqmFclIY,fbPkOYLVPtPgIt0MxizjfFJov3JbHyAi,7,6,4,0,3,0,2,0,15,2.142857142857143,2,0.0,0,4,0,3,6,0,0,2,0,7,8,1
5000,47784,o9yvVrDdqWbWhDTxptqPNzcJYAQzSgqs,fbPkOYLVPtPgIt0MxizjfFJov3JbHyAi,7,5,2,0,3,1,5,0,16,2.2857142857142856,1,0.0,2,2,0,3,3,1,0,5,0,7,9,1
5001,47785,hIwxGIao0auqtzgWn2kttNbjIiHkmA5D,fbPkOYLVPtPgIt0MxizjfFJov3JbHyAi,5,2,1,0,1,0,2,0,6,0.8571428571428571,1,0.0,0,1,0,1,2,0,0,2,0,2,4,1
5002,47786,9BOxWH9bnbnBFLyov7eyKil4OAMIu6r8,fbPkOYLVPtPgIt0MxizjfFJov3JbHyAi,1,0,0,0,0,0,4,0,4,0.5714285714285714,1,0.0,0,0,0,0,0,0,0,4,0,0,4,1
5003,47788,ZQSZgZ79Y2BI2kLu43mIPc6ox1OLMn3i,fbPkOYLVPtPgIt0MxizjfFJov3JbHyAi,9,4,3,0,2,0,7,0,16,2.2857142857142856,2,0.0,0,3,0,2,4,0,0,7,0,5,11,1
5004,47791,Hw8jmGp4VI4tAz6cfKhHDOeLB2t7MJ9z,fbPkOYLVPtPgIt0MxizjfFJov3JbHyAi,8,12,7,0,4,21,3,0,47,6.714285714285714,3,0.0,0,7,0,4,12,21,0,3,0,11,36,1
5005,47792,D6PbpNnbT91V2mO50Yo6lGeWMgk4tx0G,fbPkOYLVPtPgIt0MxizjfFJov3JbHyAi,8,9,6,0,2,5,2,0,24,3.4285714285714284,1,0.0,0,6,0,2,9,5,0,2,0,8,16,1
5006,47795,Ve7ldJJUZUHFSKTyCbiFRbXYpCfgkMe0,fbPkOYLVPtPgIt0MxizjfFJov3JbHyAi,6,8,5,0,2,1,4,0,20,2.857142857142857,2,0.0,0,5,0,2,8,1,0,4,0,7,13,1
5007,47796,To4tY3l3Iwdy23bNNN8VbGmgVWF3Gp06,fbPkOYLVPtPgIt0MxizjfFJov3JbHyAi,11,7,3,7,4,0,3,0,24,3.4285714285714284,1,0.0,3,3,5,4,4,0,2,3,0,15,9,1
5008,47797,tHjeVI3fd22SmNtfBSk3NBb4XLGkojbV,fbPkOYLVPtPgIt0MxizjfFJov3JbHyAi,1,0,0,0,0,0,1,0,1,0.14285714285714285,1,0.0,0,0,0,0,0,0,0,1,0,0,1,1
5009,47798,ZobeGMKyIBgjnUNms43CrtMrVHf6iI1r,fbPkOYLVPtPgIt0MxizjfFJov3JbHyAi,8,7,4,0,2,0,6,0,19,2.7142857142857144,3,0.0,0,4,0,2,7,0,0,6,0,6,13,1
5010,47799,Iwfu4an5Skhugcqyo5SceYhoFf90uJBX,fbPkOYLVPtPgIt0MxizjfFJov3JbHyAi,9,5,2,0,2,3,5,1,18,2.5714285714285716,1,0.0,0,2,0,2,5,3,0,5,1,4,14,1
5011,47800,4TT2g7nLcTVtuILlZdgBu9rrz9KLLOMk,fbPkOYLVPtPgIt0MxizjfFJov3JbHyAi,6,8,2,0,3,0,6,0,19,2.7142857142857144,1,0.0,5,2,0,3,3,0,0,6,0,10,9,1
5012,47801,PmMFkd1Rzxa3QPI5maWIgc4heZgC88AX,fbPkOYLVPtPgIt0MxizjfFJov3JbHyAi,7,3,2,0,2,0,2,0,9,1.2857142857142858,1,0.0,0,2,0,2,3,0,0,2,0,4,5,1
5013,47803,93FWPuXY2azQQwZQWS80tdORRpOo60jj,fbPkOYLVPtPgIt0MxizjfFJov3JbHyAi,16,25,15,0,11,10,6,0,67,9.571428571428571,4,0.0,3,15,0,11,22,10,0,6,0,29,38,1
5014,47804,ZcgzdyII0xKmmApyb1MgVZBfYdWiemwd,fbPkOYLVPtPgIt0MxizjfFJov3JbHyAi,7,3,2,0,2,0,3,0,10,1.4285714285714286,2,0.0,0,2,0,2,3,0,0,3,0,4,6,1
5015,47807,JQWlZ9S0smBFDMGfgqcpt4ewgfL5yur6,fbPkOYLVPtPgIt0MxizjfFJov3JbHyAi,10,9,5,0,2,1,6,0,23,3.2857142857142856,2,0.0,1,5,0,2,8,1,0,6,0,8,15,1
5016,47808,FYmdcExkLD3hobz533EUh65L31LUqQ1Y,fbPkOYLVPtPgIt0MxizjfFJov3JbHyAi,2,0,0,0,0,0,3,0,3,0.42857142857142855,1,0.0,0,0,0,0,0,0,0,3,0,0,3,1
5017,47811,eIW9M0Trkt0EiuTzN2HuEtF6QnUOm4E9,fbPkOYLVPtPgIt0MxizjfFJov3JbHyAi,25,41,26,20,17,0,7,0,111,15.857142857142858,3,0.0,10,26,20,17,31,0,0,7,0,73,38,1
5018,47813,pzBdNMI6l60tGyYDZDsD8a3IbqJH27O8,fbPkOYLVPtPgIt0MxizjfFJov3JbHyAi,51,81,21,11,16,6,25,1,161,23.0,13,0.0,9,21,10,16,72,6,1,25,1,56,105,0
5019,47814,1gTDkM1DmoNiWAXMcO7Ry3TBKifByJrA,fbPkOYLVPtPgIt0MxizjfFJov3JbHyAi,5,3,2,0,0,0,2,0,7,1.0,1,0.0,0,2,0,0,3,0,0,2,0,2,5,1
5020,47815,R32OpsvoWT0fJOVOqVFkJPGA6xEYJoku,fbPkOYLVPtPgIt0MxizjfFJov3JbHyAi,5,0,0,0,0,2,5,1,8,1.1428571428571428,1,0.0,0,0,0,0,0,2,0,5,1,0,8,1
5021,47819,JSeJszCXASTiAymchwd8Mbxb0d9xvaME,fbPkOYLVPtPgIt0MxizjfFJov3JbHyAi,4,2,1,0,1,0,1,0,5,0.7142857142857143,1,0.0,0,1,0,1,2,0,0,1,0,2,3,1
5022,47821,GYAhe7QkBFzfyQOufZzJyKbMW1Ol7QR2,fbPkOYLVPtPgIt0MxizjfFJov3JbHyAi,1,0,0,0,0,0,1,0,1,0.14285714285714285,1,0.0,0,0,0,0,0,0,0,1,0,0,1,1
5023,47823,9uK9gXYJyTZNtNSUCINqfEFUfFE2z8C1,fbPkOYLVPtPgIt0MxizjfFJov3JbHyAi,2,0,0,0,0,0,2,0,2,0.2857142857142857,1,0.0,0,0,0,0,0,0,0,2,0,0,2,1
5024,47825,FosOn7Nym18de58uciRhhONZG69DSOHR,fbPkOYLVPtPgIt0MxizjfFJov3JbHyAi,1,0,0,0,0,0,1,0,1,0.14285714285714285,1,0.0,0,0,0,0,0,0,0,1,0,0,1,1
5025,47827,QXhJhqRI2RKlJx1bX2NHrvRhjNHoTmov,fbPkOYLVPtPgIt0MxizjfFJov3JbHyAi,7,5,3,0,2,0,2,0,12,1.7142857142857142,1,0.0,0,3,0,2,5,0,0,2,0,5,7,1
5026,47829,XHEZtfDZPcYKEJdadg7oTWoKvKH8Zuar,fbPkOYLVPtPgIt0MxizjfFJov3JbHyAi,2,0,0,0,0,0,2,0,2,0.2857142857142857,1,0.0,0,0,0,0,0,0,0,2,0,0,2,1
5027,47830,2yx2qSv17vABrVR2NSjoUhZ8khDHzM1p,fbPkOYLVPtPgIt0MxizjfFJov3JbHyAi,6,7,1,0,1,0,3,0,12,1.7142857142857142,2,0.0,0,1,0,1,7,0,0,3,0,2,10,1
5028,47831,YpdehTzQsSqz1ddMB0XGW2Y6lcmHTYFK,fbPkOYLVPtPgIt0MxizjfFJov3JbHyAi,6,4,2,0,0,0,4,0,10,1.4285714285714286,1,0.0,0,2,0,0,4,0,0,4,0,2,8,1
5029,47832,uzyKB6l5IMjDSYdYxLudAhgrFzD2VyDw,fbPkOYLVPtPgIt0MxizjfFJov3JbHyAi,8,6,4,0,3,1,4,0,18,2.5714285714285716,1,0.0,0,4,0,3,6,1,0,4,0,7,11,1
5030,47833,16veA4geT2xKUlqWBL48Fcqf8WTsVJtc,fbPkOYLVPtPgIt0MxizjfFJov3JbHyAi,1,0,0,0,0,0,1,0,1,0.14285714285714285,1,0.0,0,0,0,0,0,0,0,1,0,0,1,1
5031,47834,ONghHwhwAX2IyqpHHX698rW0VH9BRcsu,fbPkOYLVPtPgIt0MxizjfFJov3JbHyAi,7,4,2,0,3,0,3,0,12,1.7142857142857142,1,0.0,2,2,0,3,2,0,0,3,0,7,5,1
5032,47835,bPKFcVQkxVd0TAh9nUEtyZP7EFWzhnRn,fbPkOYLVPtPgIt0MxizjfFJov3JbHyAi,9,8,6,0,5,0,5,0,24,3.4285714285714284,1,0.0,0,6,0,5,8,0,0,5,0,11,13,1
5033,47836,SvayS3hRjiQUsZJZ3Z80XuRW7pnvNCGH,fbPkOYLVPtPgIt0MxizjfFJov3JbHyAi,28,72,32,10,19,9,15,1,158,22.571428571428573,3,0.0,22,32,9,19,50,9,1,15,1,82,76,1
5034,47837,pwbQ0rznhIurRxyuVQAFAxt3Zer8oDir,fbPkOYLVPtPgIt0MxizjfFJov3JbHyAi,4,3,2,0,2,0,3,0,10,1.4285714285714286,1,0.0,0,2,0,2,3,0,0,3,0,4,6,1
5035,47840,BNU2wGZhV5dmPLymeUzZGTZPF40H3QyF,fbPkOYLVPtPgIt0MxizjfFJov3JbHyAi,7,3,2,0,2,0,2,0,9,1.2857142857142858,1,0.0,0,2,0,2,3,0,0,2,0,4,5,1
5036,47841,HIbKGQJ8yDbPhmqDqsEHxHEydttgfsQA,fbPkOYLVPtPgIt0MxizjfFJov3JbHyAi,7,3,2,0,2,0,2,0,9,1.2857142857142858,1,0.0,0,2,0,2,3,0,0,2,0,4,5,1
5037,47842,oQIbxVPhPOzQp4tRk0swq8bc74m862Je,fbPkOYLVPtPgIt0MxizjfFJov3JbHyAi,6,13,1,0,1,0,3,0,18,2.5714285714285716,1,0.0,3,1,0,1,10,0,0,3,0,5,13,1
5038,47843,IZ5pWpBLzW50MjCCGxCjTz4w6DVz2MU3,fbPkOYLVPtPgIt0MxizjfFJov3JbHyAi,7,13,8,0,2,0,3,0,26,3.7142857142857144,3,0.0,1,8,0,2,12,0,0,3,0,11,15,1
5039,47844,P4gIdHzF607L8e8VPH3Qb09lxgNZRJFa,fbPkOYLVPtPgIt0MxizjfFJov3JbHyAi,12,29,17,0,16,3,10,0,75,10.714285714285714,5,0.0,7,17,0,16,22,3,0,10,0,40,35,1
5040,47845,QQOQ1mBFT0hbDG4vhxUnw8WQ7hq3XsN0,fbPkOYLVPtPgIt0MxizjfFJov3JbHyAi,8,5,3,0,2,0,4,0,14,2.0,3,0.0,0,3,0,2,5,0,0,4,0,5,9,1
5041,47847,Bat1lO5dwlkuBIiIqyEjLCmla1w2SsRg,fbPkOYLVPtPgIt0MxizjfFJov3JbHyAi,1,0,0,0,0,0,1,0,1,0.14285714285714285,1,0.0,0,0,0,0,0,0,0,1,0,0,1,1
5042,47849,hjbzzLF0uZqUL22zLBiQhzq51chcw6mb,fbPkOYLVPtPgIt0MxizjfFJov3JbHyAi,18,19,11,5,8,6,5,0,54,7.714285714285714,1,0.0,6,11,4,8,13,6,1,5,0,29,25,1
5043,47851,kLsZKBC25zLVIospdIdcGhrxzfP125JG,fbPkOYLVPtPgIt0MxizjfFJov3JbHyAi,11,6,5,0,5,0,6,0,22,3.142857142857143,1,0.0,0,5,0,5,6,0,0,6,0,10,12,1
5044,47852,RfgbqJEazOp1Rb866WYVJPYz91jABFLG,fbPkOYLVPtPgIt0MxizjfFJov3JbHyAi,15,7,6,0,6,1,4,1,25,3.5714285714285716,1,0.0,0,6,0,6,7,1,0,4,1,12,13,1
5045,47854,gRdV8TKfYOuiXGGwKnVS8SiUiAxajq1L,fbPkOYLVPtPgIt0MxizjfFJov3JbHyAi,13,32,13,4,11,2,16,0,78,11.142857142857142,5,0.0,9,13,4,11,23,2,0,16,0,37,41,1
5046,47855,II1eOimMlUCajOv1GRuK8VabiA0lRWyy,fbPkOYLVPtPgIt0MxizjfFJov3JbHyAi,5,2,1,0,1,0,5,0,9,1.2857142857142858,1,0.0,0,1,0,1,2,0,0,5,0,2,7,1
5047,47856,82BkQjqJpTLnL5kDgBNneTIQ8dLAyaMt,fbPkOYLVPtPgIt0MxizjfFJov3JbHyAi,6,7,3,0,0,0,5,0,15,2.142857142857143,2,0.0,0,3,0,0,7,0,0,5,0,3,12,1
5048,47857,r7L6HOKA435eaor9jfOstdB35ZN19tsN,fbPkOYLVPtPgIt0MxizjfFJov3JbHyAi,5,4,3,0,3,0,2,0,12,1.7142857142857142,1,0.0,0,3,0,3,4,0,0,2,0,6,6,1
5049,47858,4uvFeDWIZ6bzoupIa1lCMrJxU4bo03vY,fbPkOYLVPtPgIt0MxizjfFJov3JbHyAi,21,25,10,13,12,1,5,1,67,9.571428571428571,2,0.0,13,10,10,12,12,1,3,5,1,45,22,1
5050,47859,HlsUiRcEZx95oGsZBkao06lPbfTneh9d,fbPkOYLVPtPgIt0MxizjfFJov3JbHyAi,1,0,0,0,0,0,1,0,1,0.14285714285714285,1,0.0,0,0,0,0,0,0,0,1,0,0,1,1
5051,47860,3Fj747AfeK8Iy9OuiJhJRPDmQRCh2lEF,fbPkOYLVPtPgIt0MxizjfFJov3JbHyAi,7,11,6,0,6,1,2,0,26,3.7142857142857144,2,0.0,2,6,0,6,9,1,0,2,0,14,12,1
5052,47899,7x6GR5vcpLicOQJjWWlyJk5P5JNLZFuv,RXDvfPUBYFlVdlueBFbLW0mhhAyGEqpt,33,56,22,48,9,5,11,6,157,22.428571428571427,3,0.0,10,22,40,9,46,5,8,11,6,81,76,1
5053,47903,H938uEDZMr5x6mZr5R8OyAsB16zTacVQ,SpATywNh6bZuzm8s1ceuBUnMUAeoAHHw,21,31,2,12,0,0,6,0,51,7.285714285714286,3,0.0,2,2,11,0,29,0,1,6,0,15,36,1
5054,47931,ExNrdfeKsdYl3xmpiJlCBa13JPKyssuX,A3fsA9Zfv1X2fVEQhTw51lKENdNrEqT3,24,63,4,0,3,29,30,1,130,18.571428571428573,10,0.0,0,4,0,3,63,29,0,30,1,7,123,0
5055,47944,6u4AKdJzjLLZR1AtlnLDuMzDbZ4kM1Iv,bWdj2GDclj5ofokWjzoa5jAwMkxCykd6,18,31,24,0,19,7,8,0,89,12.714285714285714,6,0.0,2,24,0,19,29,7,0,8,0,45,44,1
5056,47949,9A7NeA8CSGMqqHgIDjiMNeFZF78KMRT6,bWdj2GDclj5ofokWjzoa5jAwMkxCykd6,24,37,7,31,4,3,22,4,108,15.428571428571429,4,0.0,3,7,31,4,34,3,0,22,4,45,63,0
5057,47955,WCBxImuXCQhe4JCGgmUbhM2fHJqNW9fo,bWdj2GDclj5ofokWjzoa5jAwMkxCykd6,27,31,15,0,52,0,6,0,104,14.857142857142858,4,0.0,1,15,0,52,30,0,0,6,0,68,36,1
5058,47959,grSdEhkb3V38lf9YQcXO8O3GBe0inhXx,SpATywNh6bZuzm8s1ceuBUnMUAeoAHHw,22,57,0,17,0,2,13,0,89,12.714285714285714,5,0.0,14,0,17,0,43,2,0,13,0,31,58,0
5059,47968,4ZKN4qjeNhliROr2sm8vB8zmpPTrlPXO,5X6FeZozNMgE2VRi3MJYjkkFK8SETtu2,1,0,0,0,0,0,1,0,1,0.14285714285714285,1,0.0,0,0,0,0,0,0,0,1,0,0,1,1
5060,47976,HhK8Fr5pAwm4jm0sdGfJEGDMiAvZjcpI,bWdj2GDclj5ofokWjzoa5jAwMkxCykd6,15,30,13,42,8,0,8,0,101,14.428571428571429,4,0.0,10,13,41,8,20,0,1,8,0,72,29,1
5061,47982,nC6UOgoIicf8pr79f2rdG7NgUQiopW9Q,SpATywNh6bZuzm8s1ceuBUnMUAeoAHHw,13,15,11,0,6,0,3,0,35,5.0,4,0.0,1,11,0,6,14,0,0,3,0,18,17,0
5062,47983,nC6UOgoIicf8pr79f2rdG7NgUQiopW9Q,A3fsA9Zfv1X2fVEQhTw51lKENdNrEqT3,4,2,1,0,1,0,1,0,5,0.7142857142857143,1,0.0,0,1,0,1,2,0,0,1,0,2,3,0
5063,47984,nC6UOgoIicf8pr79f2rdG7NgUQiopW9Q,bWdj2GDclj5ofokWjzoa5jAwMkxCykd6,14,26,15,0,10,2,4,0,57,8.142857142857142,5,0.0,3,15,0,10,23,2,0,4,0,28,29,0
5064,47991,w37wSK655FONLskeVHZ1T8H2i8llhkAq,SpATywNh6bZuzm8s1ceuBUnMUAeoAHHw,30,73,5,40,2,0,11,0,131,18.714285714285715,6,0.0,17,5,36,2,56,0,4,11,0,60,71,1
5065,47995,UjOHFBm02iem7rlbuAJcfFkUj4JVBikN,RXDvfPUBYFlVdlueBFbLW0mhhAyGEqpt,58,111,6,99,8,16,23,2,265,37.857142857142854,6,0.0,27,6,96,8,84,16,3,23,2,137,128,0
5066,48000,snM8RKlGQmXHQ6OmxlkvPDudAMoZCHyo,SpATywNh6bZuzm8s1ceuBUnMUAeoAHHw,1,0,0,0,0,0,2,0,2,0.2857142857142857,1,0.0,0,0,0,0,0,0,0,2,0,0,2,1
5067,48006,PihBsIILx8UWSnCui7TqzlKGzY1fk9nJ,RXDvfPUBYFlVdlueBFbLW0mhhAyGEqpt,47,42,29,8,19,6,8,2,114,16.285714285714285,4,0.0,1,29,7,19,41,6,1,8,2,56,58,1
5068,48013,VxuboMfJ8lilLCmtY53lGAum5bIt411j,SpATywNh6bZuzm8s1ceuBUnMUAeoAHHw,4,2,1,0,1,0,1,0,5,0.7142857142857143,1,0.0,0,1,0,1,2,0,0,1,0,2,3,1
5069,48023,ZcTwIqiD8HcMijdrvdUAqDGmayt7dewL,SpATywNh6bZuzm8s1ceuBUnMUAeoAHHw,1,0,0,0,0,0,1,0,1,0.14285714285714285,1,0.0,0,0,0,0,0,0,0,1,0,0,1,1
5070,48035,DX4dLCDX6l0Z68Mym7vcnKV6tMlkufOW,RXDvfPUBYFlVdlueBFbLW0mhhAyGEqpt,34,47,27,48,16,1,9,0,148,21.142857142857142,4,0.0,13,27,42,16,34,1,6,9,0,98,50,1
5071,48037,tK5QWvLAN98DDvHjcCO96Vrig3bCPcrd,RXDvfPUBYFlVdlueBFbLW0mhhAyGEqpt,95,238,12,338,46,24,30,3,691,98.71428571428571,7,0.0,109,12,298,46,129,24,40,30,3,465,226,0
5072,48061,LUgTh6GVAZUuu6P6ClIsXLbxeQUErBSM,SpATywNh6bZuzm8s1ceuBUnMUAeoAHHw,34,64,16,20,10,0,3,0,113,16.142857142857142,4,0.0,10,16,18,10,54,0,2,3,0,54,59,1
5073,48063,A07oQKntRx8Y5IjXGJ2uy8rCKeA9UHyA,bWdj2GDclj5ofokWjzoa5jAwMkxCykd6,25,36,12,40,9,6,23,4,130,18.571428571428573,3,0.0,8,12,34,9,28,6,6,23,4,63,67,1
5074,48066,waLyzusenGGt78OBjbfLuixQktneXMVQ,SpATywNh6bZuzm8s1ceuBUnMUAeoAHHw,33,73,1,47,1,26,18,2,168,24.0,3,0.0,31,1,39,1,42,26,8,18,2,72,96,0
5075,48069,S0OJjF6aof0iTnIX6lUAxekoH3m4w7V0,A3fsA9Zfv1X2fVEQhTw51lKENdNrEqT3,134,82,48,358,14,34,36,2,574,82.0,13,0.0,8,48,287,14,74,34,71,36,2,357,217,0
5076,48082,s13Zj70iGaPJV2HiUyzOXf2g6dcMZpb3,RXDvfPUBYFlVdlueBFbLW0mhhAyGEqpt,94,109,46,107,19,37,12,0,330,47.142857142857146,6,0.0,23,46,107,19,86,37,0,12,0,195,135,0
5077,48088,jQM28yyQ4L2nHSWUJsgj6ijycvLum07J,bWdj2GDclj5ofokWjzoa5jAwMkxCykd6,13,13,10,0,3,0,8,1,35,5.0,4,0.0,0,10,0,3,13,0,0,8,1,13,22,1
5078,48089,Yr9in8tqNPW6lzKPGBlYAXmDVewnbDn1,SpATywNh6bZuzm8s1ceuBUnMUAeoAHHw,35,30,19,10,14,12,6,0,91,13.0,5,0.0,6,19,9,14,24,12,1,6,0,48,43,0
5079,48092,TUbsPVDtB54KSPR2qHUpWUmDnVtGYqAT,SpATywNh6bZuzm8s1ceuBUnMUAeoAHHw,41,59,4,41,3,22,18,2,149,21.285714285714285,6,0.0,17,4,40,3,42,22,1,18,2,64,85,0
5080,48100,MEAK3CtWNpeCicplOKHcDUkHm4e2Gnat,A3fsA9Zfv1X2fVEQhTw51lKENdNrEqT3,31,19,16,68,9,0,5,0,117,16.714285714285715,2,0.0,0,16,55,9,19,0,13,5,0,80,37,0
5081,48101,1Eb3AUIMGLx5ZENvg4qlksXP0nKeP5HA,RXDvfPUBYFlVdlueBFbLW0mhhAyGEqpt,1,0,0,0,0,0,1,0,1,0.14285714285714285,1,0.0,0,0,0,0,0,0,0,1,0,0,1,1
5082,48103,pZnUCZTT1hmIZNtXsfTMlwWSd2NbHrnl,SpATywNh6bZuzm8s1ceuBUnMUAeoAHHw,1,0,0,0,0,0,2,0,2,0.2857142857142857,1,0.0,0,0,0,0,0,0,0,2,0,0,2,0
5083,48118,9pydrkItOvXReb7xWe6yqdMpXhFzfa5K,SpATywNh6bZuzm8s1ceuBUnMUAeoAHHw,42,116,27,50,8,64,26,0,291,41.57142857142857,11,0.0,30,27,42,8,86,64,8,26,0,107,184,0
5084,48135,gtGDHRUZ7LgMlMOjWieE5uKSYCgIoTZ0,G8EPVSXsOYB5YQWZGiz1aVq5Pgr2GrQu,66,82,9,178,6,17,13,1,306,43.714285714285715,8,0.0,14,9,145,6,68,17,33,13,1,174,132,0
5085,48138,f3FFKNKPDIkY4ZzespQ1tkojfbmyOtUb,SpATywNh6bZuzm8s1ceuBUnMUAeoAHHw,43,166,54,44,26,137,81,7,515,73.57142857142857,18,0.0,20,54,40,26,146,137,4,81,7,140,375,0
5086,48139,6hXBi8QXIGsuTrfCDVW9WjrIWoxnhuCE,SpATywNh6bZuzm8s1ceuBUnMUAeoAHHw,1,0,0,0,0,0,2,0,2,0.2857142857142857,2,0.0,0,0,0,0,0,0,0,2,0,0,2,1
5087,48147,pUptOf7uHEM5B1QKtZNA8nWgl2SO1Sbf,RXDvfPUBYFlVdlueBFbLW0mhhAyGEqpt,1,0,0,0,0,0,1,0,1,0.14285714285714285,1,0.0,0,0,0,0,0,0,0,1,0,0,1,1
5088,48148,2zQQnqY1LiZ9lcEXTzcE3zimEdKe8CdV,SpATywNh6bZuzm8s1ceuBUnMUAeoAHHw,46,64,37,34,16,13,22,3,189,27.0,10,0.0,16,37,34,16,48,13,0,22,3,103,86,0
5089,48179,HCOgsqUBNFumf2cCspNzKWg9hTVzHRVA,SpATywNh6bZuzm8s1ceuBUnMUAeoAHHw,46,41,24,33,16,3,13,3,133,19.0,5,0.0,14,24,26,16,27,3,7,13,3,80,53,1
5090,48182,PEmuWJA7a0s7F0V9aIB9k0qqsQOvzH5e,bWdj2GDclj5ofokWjzoa5jAwMkxCykd6,1,0,0,0,0,0,2,0,2,0.2857142857142857,1,0.0,0,0,0,0,0,0,0,2,0,0,2,1
5091,48187,PEmuWJA7a0s7F0V9aIB9k0qqsQOvzH5e,RXDvfPUBYFlVdlueBFbLW0mhhAyGEqpt,1,0,0,0,0,0,1,0,1,0.14285714285714285,1,0.0,0,0,0,0,0,0,0,1,0,0,1,1
5092,48197,5KWnGsOw1ONkUhC7cQevc5FAKOxsvvUS,SpATywNh6bZuzm8s1ceuBUnMUAeoAHHw,20,29,6,14,4,0,15,0,68,9.714285714285714,5,0.0,7,6,13,4,22,0,1,15,0,30,38,1
5093,48215,PEmuWJA7a0s7F0V9aIB9k0qqsQOvzH5e,A3fsA9Zfv1X2fVEQhTw51lKENdNrEqT3,9,2,2,0,2,0,5,0,11,1.5714285714285714,1,0.0,0,2,0,2,2,0,0,5,0,4,7,1
5094,48218,VBP5PzVQEKJYFH0y5ffEek5WfP9EW7uc,A3fsA9Zfv1X2fVEQhTw51lKENdNrEqT3,16,28,17,0,4,2,23,2,76,10.857142857142858,10,0.0,0,17,0,4,28,2,0,23,2,21,55,1
5095,48221,eznmpA5TU6txEde6CJT70lkRbK5fBPvC,A3fsA9Zfv1X2fVEQhTw51lKENdNrEqT3,26,6,1,84,0,7,14,0,112,16.0,3,0.0,3,1,69,0,3,7,15,14,0,73,39,0
5096,48223,GfRp1O86gI5zJJh8SIJ1bczUJPWlAqoK,SpATywNh6bZuzm8s1ceuBUnMUAeoAHHw,48,113,21,62,7,20,52,5,280,40.0,8,0.0,21,21,53,7,92,20,9,52,5,102,178,0
5097,48239,5dHhwSyX3MJPaRvMe9fCcvMfYGdzfWsb,SpATywNh6bZuzm8s1ceuBUnMUAeoAHHw,7,3,1,0,1,0,7,0,12,1.7142857142857142,2,0.0,0,1,0,1,3,0,0,7,0,2,10,1
5098,48248,tKb4BJUWaLSpiOQBxJYXLnmz0KvQQ3eJ,5X6FeZozNMgE2VRi3MJYjkkFK8SETtu2,1,0,0,0,0,0,1,0,1,0.14285714285714285,1,0.0,0,0,0,0,0,0,0,1,0,0,1,1
5099,48255,gLAW4GOuyz8JKg5RO5Sf2rzir65isCiq,G8EPVSXsOYB5YQWZGiz1aVq5Pgr2GrQu,38,77,29,0,23,6,21,2,158,22.571428571428573,7,0.0,3,29,0,23,74,6,0,21,2,55,103,0
5100,48268,EhHrinjt1AkEWC09AFZwBuP61S5NJgjn,A3fsA9Zfv1X2fVEQhTw51lKENdNrEqT3,46,44,28,54,17,2,15,0,160,22.857142857142858,4,0.0,1,28,44,17,43,2,10,15,0,90,70,1
5101,48276,mD5ok6d5ptFUQdVqyK8RQXZv5MjdFkGe,SpATywNh6bZuzm8s1ceuBUnMUAeoAHHw,1,0,0,0,0,0,1,0,1,0.14285714285714285,1,0.0,0,0,0,0,0,0,0,1,0,0,1,1
5102,48277,KJnvgR26H5LLeKdyvjJHjjqg4mjHEhgN,A3fsA9Zfv1X2fVEQhTw51lKENdNrEqT3,50,15,11,152,4,0,14,0,196,28.0,5,0.0,2,11,137,4,13,0,15,14,0,154,42,1
5103,48285,CQ3xdz8pT9zQNTAl7b68jJZVAWVF2aTL,SpATywNh6bZuzm8s1ceuBUnMUAeoAHHw,21,22,7,13,5,16,10,1,74,10.571428571428571,4,0.0,3,7,11,5,19,16,2,10,1,26,48,1
5104,48303,ibgC3AgPCiKxZzQtLwOtyIa6DJRV6K2p,SpATywNh6bZuzm8s1ceuBUnMUAeoAHHw,49,126,56,69,12,149,68,8,488,69.71428571428571,15,0.0,34,56,54,12,92,149,15,68,8,156,332,0
5105,48304,H5UEKpeYUS8ZwAU1o3ZTuTx8QVBIM5mj,SpATywNh6bZuzm8s1ceuBUnMUAeoAHHw,42,54,0,26,0,6,16,1,103,14.714285714285714,6,0.0,14,0,25,0,40,6,1,16,1,39,64,1
5106,48308,UqMl8IgLVIouo6TVWfUzDQbBX8JDKQrY,SpATywNh6bZuzm8s1ceuBUnMUAeoAHHw,40,59,35,0,17,1,17,0,129,18.428571428571427,8,0.0,2,35,0,17,57,1,0,17,0,54,75,1
5107,48331,IPypHQ0vWks1CSRgViL4tjily46uWZcU,5X6FeZozNMgE2VRi3MJYjkkFK8SETtu2,35,61,17,63,26,0,12,1,180,25.714285714285715,5,0.0,37,17,55,26,24,0,8,12,1,135,45,1
5108,48343,KJnvgR26H5LLeKdyvjJHjjqg4mjHEhgN,bWdj2GDclj5ofokWjzoa5jAwMkxCykd6,56,77,37,238,33,56,43,1,485,69.28571428571429,8,0.0,33,37,216,33,44,56,22,43,1,319,166,0
5109,48353,kiVzCvDoEqSB7iO0TU3ERoanC9pEAYCs,A3fsA9Zfv1X2fVEQhTw51lKENdNrEqT3,2,0,0,0,0,0,4,0,4,0.5714285714285714,1,0.0,0,0,0,0,0,0,0,4,0,0,4,1
5110,48354,YUkia24kFQkJdU9Tc0bEfJWS5kFL3fnZ,SpATywNh6bZuzm8s1ceuBUnMUAeoAHHw,41,97,34,35,12,43,63,1,285,40.714285714285715,20,0.0,38,34,27,12,59,43,8,63,1,111,174,0
5111,48364,TMaAbfbbsUXbGWJIhu1feBQgRZO29am6,G8EPVSXsOYB5YQWZGiz1aVq5Pgr2GrQu,158,163,82,389,44,123,74,3,878,125.42857142857143,16,0.0,28,82,320,44,135,123,69,74,3,474,404,0
5112,48366,eQnxTOv5tF733HrH1v8IIfXTQQ20WB86,SpATywNh6bZuzm8s1ceuBUnMUAeoAHHw,32,29,16,26,6,6,48,1,132,18.857142857142858,13,0.0,8,16,25,6,21,6,1,48,1,55,77,0
5113,48367,0go0grncbFJXOjLQCf4vOFXHn6ly84Qw,5X6FeZozNMgE2VRi3MJYjkkFK8SETtu2,1,0,0,0,0,0,1,0,1,0.14285714285714285,1,0.0,0,0,0,0,0,0,0,1,0,0,1,1
5114,48376,nC2ll7aLO2fz5jcwsfKAGs7Lo3GKKv7L,bWdj2GDclj5ofokWjzoa5jAwMkxCykd6,5,2,1,0,1,0,2,0,6,0.8571428571428571,1,0.0,0,1,0,1,2,0,0,2,0,2,4,1
5115,48379,22XSmHMOSRFcop0tg62UCikxC7iAPMOE,SpATywNh6bZuzm8s1ceuBUnMUAeoAHHw,5,2,1,0,1,0,4,0,8,1.1428571428571428,1,0.0,0,1,0,1,2,0,0,4,0,2,6,1
5116,48392,kiVzCvDoEqSB7iO0TU3ERoanC9pEAYCs,bWdj2GDclj5ofokWjzoa5jAwMkxCykd6,2,0,0,0,0,0,2,0,2,0.2857142857142857,1,0.0,0,0,0,0,0,0,0,2,0,0,2,1
5117,48402,VEdQQ1yOFNqPNBrecyFKsnw5QECT7x69,G8EPVSXsOYB5YQWZGiz1aVq5Pgr2GrQu,1,0,0,0,0,0,1,0,1,0.14285714285714285,1,0.0,0,0,0,0,0,0,0,1,0,0,1,1
5118,48410,fKzNFTbPePkMpMq31aLHMmVifATbrx2C,A3fsA9Zfv1X2fVEQhTw51lKENdNrEqT3,9,7,3,0,1,1,5,1,18,2.5714285714285716,3,0.0,0,3,0,1,7,1,0,5,1,4,14,1
5119,48450,oWaJx5przpU6lf15eldDAW9VD7f9UZbS,SpATywNh6bZuzm8s1ceuBUnMUAeoAHHw,46,57,38,19,26,51,17,3,211,30.142857142857142,4,0.0,10,38,19,26,47,51,0,17,3,93,118,0
5120,48466,zOGgv8cnkqEW7Y2l6fqZ3IzLqplNhsIx,SpATywNh6bZuzm8s1ceuBUnMUAeoAHHw,14,38,3,1,2,4,14,2,64,9.142857142857142,5,0.0,6,3,1,2,32,4,0,14,2,12,52,1
5121,48480,T2e7T1KVGbCZHkx82TLCiB6K2groJqnl,SpATywNh6bZuzm8s1ceuBUnMUAeoAHHw,38,76,3,54,2,32,19,1,187,26.714285714285715,6,0.0,29,3,47,2,47,32,7,19,1,81,106,1
5122,48494,4FBhmlqlMyaupAUC0WaC8U6eghLWF30B,bWdj2GDclj5ofokWjzoa5jAwMkxCykd6,7,10,1,0,1,0,5,0,17,2.4285714285714284,1,0.0,1,1,0,1,9,0,0,5,0,3,14,1
5123,48498,VEdQQ1yOFNqPNBrecyFKsnw5QECT7x69,SpATywNh6bZuzm8s1ceuBUnMUAeoAHHw,6,9,1,0,1,0,4,0,15,2.142857142857143,3,0.0,0,1,0,1,9,0,0,4,0,2,13,1
5124,48509,a41llItPMmO7jtwR6NH41lmydyfI26Gz,SpATywNh6bZuzm8s1ceuBUnMUAeoAHHw,34,86,2,53,2,17,17,3,180,25.714285714285715,5,0.0,39,2,44,2,47,17,9,17,3,87,93,0
5125,48515,NCU9xqLhC281ErH7IwNmupIJSyhaNMZW,SpATywNh6bZuzm8s1ceuBUnMUAeoAHHw,25,27,9,25,6,0,21,0,88,12.571428571428571,7,0.0,9,9,23,6,18,0,2,21,0,47,41,0
5126,48517,GiTrvkD6ePga5lhQV84iWf2qmN99Wgp4,G8EPVSXsOYB5YQWZGiz1aVq5Pgr2GrQu,112,54,41,132,23,0,21,0,271,38.714285714285715,5,0.0,2,41,131,23,52,0,1,21,0,197,74,0
5127,48520,EBgUhfQ9Yh2Xchyg5A4RNjz8pUXCnWl0,SpATywNh6bZuzm8s1ceuBUnMUAeoAHHw,29,66,0,25,0,0,5,0,96,13.714285714285714,2,0.0,13,0,21,0,53,0,4,5,0,34,62,1
5128,48524,aYYkr3EBoQc6U0mONjplTV8V30x3QwMR,SpATywNh6bZuzm8s1ceuBUnMUAeoAHHw,41,135,28,81,6,68,71,6,395,56.42857142857143,8,0.0,26,28,69,6,109,68,12,71,6,129,266,0
5129,48553,TtCmE1Q9YLiHArFHZakykfuIbhdQtny2,5X6FeZozNMgE2VRi3MJYjkkFK8SETtu2,1,0,0,0,0,0,1,0,1,0.14285714285714285,1,0.0,0,0,0,0,0,0,0,1,0,0,1,1
5130,48557,CMxWacrlvHBos1yTh6CX0stfBtIQjdRZ,SpATywNh6bZuzm8s1ceuBUnMUAeoAHHw,43,85,37,41,11,17,15,7,213,30.428571428571427,5,0.0,39,37,35,11,46,17,6,15,7,122,91,0
5131,48572,RvDbqb1jf5bMQYeeBsAiuychmXlXMqZ3,SpATywNh6bZuzm8s1ceuBUnMUAeoAHHw,42,65,35,38,17,62,18,1,236,33.714285714285715,6,0.0,16,35,31,17,49,62,7,18,1,99,137,0
5132,48579,OmRwEqIcEcFH28h4LCCN9RZtwAWWiBmW,SpATywNh6bZuzm8s1ceuBUnMUAeoAHHw,12,73,2,8,1,0,7,0,91,13.0,4,0.0,0,2,7,1,73,0,1,7,0,10,81,1
5133,48580,PTsQJZyhlmM5FQqbiEkU0C6Xoz9Oth0N,RXDvfPUBYFlVdlueBFbLW0mhhAyGEqpt,25,35,14,30,10,0,6,0,95,13.571428571428571,4,0.0,7,14,27,10,28,0,3,6,0,58,37,0
5134,48581,ZmRlQUxjzuIBTqGZ1TI9p3XDJluy6dCH,SpATywNh6bZuzm8s1ceuBUnMUAeoAHHw,45,86,40,46,24,34,20,0,250,35.714285714285715,6,0.0,11,40,42,24,75,34,4,20,0,117,133,0
5135,48590,Bm1ROY20Td8ahvL40ylWLEiakWpICc5q,SpATywNh6bZuzm8s1ceuBUnMUAeoAHHw,47,57,32,60,15,83,19,7,273,39.0,8,0.0,11,32,50,15,46,83,10,19,7,108,165,0
5136,48594,WGMloidbPaESMPpwR4FhM5YgenySAIUm,5X6FeZozNMgE2VRi3MJYjkkFK8SETtu2,1,0,0,0,0,0,1,0,1,0.14285714285714285,1,0.0,0,0,0,0,0,0,0,1,0,0,1,1
5137,48596,k3YRNSEUtBfnCzCI2ffYAi1qqoCc9d8W,5X6FeZozNMgE2VRi3MJYjkkFK8SETtu2,4,3,0,0,0,0,1,0,4,0.5714285714285714,1,0.0,0,0,0,0,3,0,0,1,0,0,4,1
5138,48627,SRvotFFDI4c4Tqustgf1LZhg7uROitU6,SpATywNh6bZuzm8s1ceuBUnMUAeoAHHw,25,30,2,44,0,0,16,3,95,13.571428571428571,2,0.0,6,2,36,0,24,0,8,16,3,44,51,1
5139,48629,1ERwpt9wMj2n5z0yrcDeOTKwiq17bpYL,SpATywNh6bZuzm8s1ceuBUnMUAeoAHHw,23,33,23,12,11,2,13,1,95,13.571428571428571,5,0.0,3,23,11,11,30,2,1,13,1,48,47,0
5140,48637,rhEIW0I6psA9HvuF18HCB0BDkVKeLeRv,SpATywNh6bZuzm8s1ceuBUnMUAeoAHHw,9,6,4,0,3,0,4,0,17,2.4285714285714284,2,0.0,0,4,0,3,6,0,0,4,0,7,10,1
5141,48647,A5P9jrlzLqQKpA3sVBvwbPCf9CAYmtxw,SpATywNh6bZuzm8s1ceuBUnMUAeoAHHw,46,64,27,49,15,46,17,2,220,31.428571428571427,8,0.0,24,27,40,15,40,46,9,17,2,106,114,0
5142,48658,P1CWRZaaMmY4na07vRJf7J16ENwUgRU2,SpATywNh6bZuzm8s1ceuBUnMUAeoAHHw,1,0,0,0,0,0,1,0,1,0.14285714285714285,1,0.0,0,0,0,0,0,0,0,1,0,0,1,1
5143,48677,miskafWCgRGEerOwmFhGeXinZmiVq8Xq,SpATywNh6bZuzm8s1ceuBUnMUAeoAHHw,30,41,20,28,10,14,15,1,129,18.428571428571427,4,0.0,10,20,23,10,31,14,5,15,1,63,66,0
5144,48680,ugIvWXr0VKdRfQslnLOrtvUMZY9HB5mg,SpATywNh6bZuzm8s1ceuBUnMUAeoAHHw,1,0,0,0,0,0,1,0,1,0.14285714285714285,1,0.0,0,0,0,0,0,0,0,1,0,0,1,1
5145,48710,2wpbmqMFHp4amvfRnEjwZEJ5A6Okr1xC,G8EPVSXsOYB5YQWZGiz1aVq5Pgr2GrQu,11,17,2,6,2,0,3,0,30,4.285714285714286,2,0.0,1,2,5,2,16,0,1,3,0,10,20,1
5146,48718,5AugieBFEAlTT6fEoe5Ptq1jAvWA2bXj,SpATywNh6bZuzm8s1ceuBUnMUAeoAHHw,17,19,1,19,1,0,4,0,44,6.285714285714286,2,0.0,7,1,16,1,12,0,3,4,0,25,19,1
5147,48727,2XL6bjSwWRsdF2Id5N4HOR8GedxbL8Tj,SpATywNh6bZuzm8s1ceuBUnMUAeoAHHw,23,39,1,8,1,4,9,0,62,8.857142857142858,5,0.0,2,1,7,1,37,4,1,9,0,11,51,0
5148,48733,mitKAcO5Yq84LGwUL473CFioIDbwQfRi,SpATywNh6bZuzm8s1ceuBUnMUAeoAHHw,30,49,29,35,0,18,30,0,161,23.0,10,0.0,9,29,35,0,40,18,0,30,0,73,88,0
5149,48739,cyv7VaipsbLsuWJ2HHHulsYIZbB7b4yb,SpATywNh6bZuzm8s1ceuBUnMUAeoAHHw,6,1,1,0,1,3,4,0,10,1.4285714285714286,1,0.0,0,1,0,1,1,3,0,4,0,2,8,1
5150,48743,geHYnGH5sQ7aHnnwLKBvDRjabqJU8jWh,RXDvfPUBYFlVdlueBFbLW0mhhAyGEqpt,46,66,5,96,6,7,17,4,201,28.714285714285715,5,0.0,18,5,82,6,48,7,14,17,4,111,90,1
5151,48764,oWaJx5przpU6lf15eldDAW9VD7f9UZbS,RXDvfPUBYFlVdlueBFbLW0mhhAyGEqpt,106,139,86,139,44,78,28,6,520,74.28571428571429,8,0.0,27,86,136,44,112,78,3,28,6,293,227,0
5152,48766,xBzkSH4dgUCYZ5BDcyxU9YukAdw2snHB,RXDvfPUBYFlVdlueBFbLW0mhhAyGEqpt,11,7,4,0,2,0,7,0,20,2.857142857142857,3,0.0,0,4,0,2,7,0,0,7,0,6,14,1
5153,48767,9A7NeA8CSGMqqHgIDjiMNeFZF78KMRT6,5X6FeZozNMgE2VRi3MJYjkkFK8SETtu2,1,0,0,0,0,0,1,0,1,0.14285714285714285,1,0.0,0,0,0,0,0,0,0,1,0,0,1,1
5154,48788,IN0xY05lGNY1Rxj5WWCYq1C0mF0lQ2fJ,SpATywNh6bZuzm8s1ceuBUnMUAeoAHHw,59,103,29,33,17,119,29,3,333,47.57142857142857,6,0.0,21,29,27,17,82,119,6,29,3,94,239,0
5155,48789,o3OqwnFX0qkBf1G9cTUc5OJ6IQJ9j6yR,G8EPVSXsOYB5YQWZGiz1aVq5Pgr2GrQu,10,8,4,0,0,0,12,1,25,3.5714285714285716,4,0.0,0,4,0,0,8,0,0,12,1,4,21,0
5156,48800,yxV98gfwGW2ulTE4Lsk9ameltFcgsQJw,bWdj2GDclj5ofokWjzoa5jAwMkxCykd6,2,0,0,0,0,0,2,0,2,0.2857142857142857,1,0.0,0,0,0,0,0,0,0,2,0,0,2,1
5157,48803,GkoB2VZz49YRew10AQsiKgGNbvbaRd2W,SpATywNh6bZuzm8s1ceuBUnMUAeoAHHw,29,70,28,0,9,4,37,5,153,21.857142857142858,8,0.0,0,28,0,9,70,4,0,37,5,37,116,0
5158,48804,QtcqxUNiqKC3AtlnzkNFJuPtZbupT07O,SpATywNh6bZuzm8s1ceuBUnMUAeoAHHw,1,0,0,0,0,0,1,0,1,0.14285714285714285,1,0.0,0,0,0,0,0,0,0,1,0,0,1,1
5159,48816,Vn131dD12fh0kapodbBhio0q4dV4IYmG,SpATywNh6bZuzm8s1ceuBUnMUAeoAHHw,32,40,20,28,5,22,13,1,129,18.428571428571427,6,0.0,12,20,27,5,28,22,1,13,1,64,65,0
5160,48838,6CsiBxTkAlMbYFwdBsJIVLhzuq9AycoK,SpATywNh6bZuzm8s1ceuBUnMUAeoAHHw,44,46,23,44,13,0,5,0,131,18.714285714285715,4,0.0,10,23,39,13,36,0,5,5,0,85,46,0
5161,48847,zrYm7VvWMlvZCf7Dgu9kA0S4dPcpd9DE,G8EPVSXsOYB5YQWZGiz1aVq5Pgr2GrQu,5,2,1,0,1,0,3,0,7,1.0,2,0.0,0,1,0,1,2,0,0,3,0,2,5,1
5162,48861,0WvPxKqLdXDP6VJDS60sOhS8Syb4RdJF,G8EPVSXsOYB5YQWZGiz1aVq5Pgr2GrQu,40,204,6,0,5,1,37,2,255,36.42857142857143,5,0.0,2,6,0,5,202,1,0,37,2,13,242,1
5163,48864,FBOyoNjotU9K2EWr7Q4DoavjR5C7dSks,SpATywNh6bZuzm8s1ceuBUnMUAeoAHHw,14,16,8,4,6,0,3,0,37,5.285714285714286,1,0.0,0,8,4,6,16,0,0,3,0,18,19,1
5164,48876,Ufo4AkS2vTW82q9Kpcrkrp0gG0Us5zu9,SpATywNh6bZuzm8s1ceuBUnMUAeoAHHw,27,43,8,11,4,0,18,1,85,12.142857142857142,5,0.0,5,8,10,4,38,0,1,18,1,27,58,0
5165,48881,n7yQ1FvfAXqDnBpszfIUjZkrvw3J2aJC,A3fsA9Zfv1X2fVEQhTw51lKENdNrEqT3,4,0,0,0,0,3,4,0,7,1.0,2,0.0,0,0,0,0,0,3,0,4,0,0,7,1
5166,48885,8abh1wrhouqvPXJGQdSrbDOHdFyzd5U8,SpATywNh6bZuzm8s1ceuBUnMUAeoAHHw,13,17,0,17,0,0,4,0,38,5.428571428571429,1,0.0,7,0,15,0,10,0,2,4,0,22,16,1
5167,48903,TdcZVkuHoNELu59WVF9f7EUYKiYIHP14,A3fsA9Zfv1X2fVEQhTw51lKENdNrEqT3,45,54,30,120,6,0,18,0,228,32.57142857142857,8,0.0,4,30,98,6,50,0,22,18,0,138,90,0
5168,48909,y9wPfGAwhUyEzMcLzeImEmShSOKx49Im,SpATywNh6bZuzm8s1ceuBUnMUAeoAHHw,36,49,0,55,0,5,12,1,122,17.428571428571427,2,0.0,14,0,47,0,35,5,8,12,1,61,61,1
5169,48919,rJ7deFT9ohZCOevrsW5L4Px2yVgiatFT,SpATywNh6bZuzm8s1ceuBUnMUAeoAHHw,1,0,0,0,0,0,1,0,1,0.14285714285714285,1,0.0,0,0,0,0,0,0,0,1,0,0,1,1
5170,48921,rJ7deFT9ohZCOevrsW5L4Px2yVgiatFT,RXDvfPUBYFlVdlueBFbLW0mhhAyGEqpt,1,0,0,0,0,0,1,0,1,0.14285714285714285,1,0.0,0,0,0,0,0,0,0,1,0,0,1,1
5171,48928,TdcZVkuHoNELu59WVF9f7EUYKiYIHP14,bWdj2GDclj5ofokWjzoa5jAwMkxCykd6,19,17,8,46,5,0,5,0,81,11.571428571428571,2,0.0,4,8,43,5,13,0,3,5,0,60,21,0
5172,48953,cPrlzYoTDFDvccHbBKlJUrITep6ieC7X,SpATywNh6bZuzm8s1ceuBUnMUAeoAHHw,44,70,36,33,13,1,26,0,179,25.571428571428573,9,0.0,10,36,30,13,60,1,3,26,0,89,90,0
5173,48954,7Lv6OVvu1nsvUexcKSRks3wnATE3pr1d,G8EPVSXsOYB5YQWZGiz1aVq5Pgr2GrQu,3,0,0,0,0,0,4,0,4,0.5714285714285714,2,0.0,0,0,0,0,0,0,0,4,0,0,4,1
5174,48967,HDhYYZCXbsTJLrhKt1D7fHfh2AMupf0z,SpATywNh6bZuzm8s1ceuBUnMUAeoAHHw,10,10,1,7,1,0,2,0,21,3.0,2,0.0,0,1,6,1,10,0,1,2,0,8,13,0
5175,48972,4IxIKalU9kAsrSpHM9QUN57NRdKohmHA,SpATywNh6bZuzm8s1ceuBUnMUAeoAHHw,28,45,1,32,0,0,15,1,94,13.428571428571429,5,0.0,19,1,28,0,26,0,4,15,1,48,46,0
5176,48983,AsLoTojSuupL42fMfNSRQAF0asRoydgp,SpATywNh6bZuzm8s1ceuBUnMUAeoAHHw,6,4,1,0,1,0,4,0,10,1.4285714285714286,2,0.0,0,1,0,1,4,0,0,4,0,2,8,1
5177,48987,q6JeU48PcDOdiZ368tb3IoCh3BVgnxVp,SpATywNh6bZuzm8s1ceuBUnMUAeoAHHw,1,0,0,0,0,0,1,0,1,0.14285714285714285,1,0.0,0,0,0,0,0,0,0,1,0,0,1,1
5178,48991,aOfddFrct0TUA0MYqpcFv1UssmM1IX2e,SpATywNh6bZuzm8s1ceuBUnMUAeoAHHw,29,51,18,37,12,26,12,0,156,22.285714285714285,4,0.0,31,18,32,12,20,26,5,12,0,93,63,1
5179,49001,xLRXz6THj9rNHROqVgV4eCcKXyO03jXb,RXDvfPUBYFlVdlueBFbLW0mhhAyGEqpt,40,97,37,49,19,0,8,0,210,30.0,5,0.0,2,37,45,19,95,0,4,8,0,103,107,1
5180,49011,1fjO19pGLwHG3depgSJxIFrDpr07UqZK,SpATywNh6bZuzm8s1ceuBUnMUAeoAHHw,43,101,31,44,11,25,39,1,252,36.0,12,0.0,22,31,39,11,79,25,5,39,1,103,149,0
5181,49017,1fjO19pGLwHG3depgSJxIFrDpr07UqZK,bWdj2GDclj5ofokWjzoa5jAwMkxCykd6,27,46,22,62,6,35,23,0,194,27.714285714285715,8,0.0,0,22,53,6,46,35,9,23,0,81,113,1
5182,49024,SLljRLEQVmbKytDsyUG54XDlcZasHRnD,SpATywNh6bZuzm8s1ceuBUnMUAeoAHHw,31,56,23,8,7,1,29,0,124,17.714285714285715,5,0.0,0,23,7,7,56,1,1,29,0,37,87,0
5183,49030,Y7KPA6VBo9EdRB7rIro01vqa27fXQzej,SpATywNh6bZuzm8s1ceuBUnMUAeoAHHw,35,97,41,21,13,22,37,11,242,34.57142857142857,4,0.0,42,41,19,13,55,22,2,37,11,115,127,1
5184,49037,1fjO19pGLwHG3depgSJxIFrDpr07UqZK,5X6FeZozNMgE2VRi3MJYjkkFK8SETtu2,1,0,0,0,0,0,1,0,1,0.14285714285714285,1,0.0,0,0,0,0,0,0,0,1,0,0,1,1
5185,49042,MwdKlhOc9OCBjr4GsQbEEwa9uB7OnJQT,SpATywNh6bZuzm8s1ceuBUnMUAeoAHHw,53,88,50,34,35,2,16,1,226,32.285714285714285,4,0.0,25,50,30,35,63,2,4,16,1,140,86,0
5186,49047,PcQbQt2Pubz9h6iRkhILIzmVZ7ajU4yi,SpATywNh6bZuzm8s1ceuBUnMUAeoAHHw,19,30,2,42,0,0,5,0,79,11.285714285714286,4,0.0,10,2,35,0,20,0,7,5,0,47,32,1
5187,49076,WSyXGkhm7NDepRlMA3agJj8k8GLnavsP,SpATywNh6bZuzm8s1ceuBUnMUAeoAHHw,29,74,42,15,16,31,49,6,233,33.285714285714285,9,0.0,8,42,13,16,66,31,2,49,6,79,154,0
5188,49085,o2VXvGiZdBAPVWYF2ziyS2greQgSpm45,G8EPVSXsOYB5YQWZGiz1aVq5Pgr2GrQu,84,28,18,146,1,0,14,0,207,29.571428571428573,2,0.0,0,18,144,1,28,0,2,14,0,163,44,0
5189,49088,se5zs87qj8m5HDpiAuY9fHW8e8hfOFuJ,A3fsA9Zfv1X2fVEQhTw51lKENdNrEqT3,1,0,0,0,0,0,1,0,1,0.14285714285714285,1,0.0,0,0,0,0,0,0,0,1,0,0,1,1
5190,49093,KcyotPC829BMj56l23keqhJ3VB5WV4xY,A3fsA9Zfv1X2fVEQhTw51lKENdNrEqT3,7,8,2,0,1,1,4,0,16,2.2857142857142856,2,0.0,1,2,0,1,7,1,0,4,0,4,12,1
5191,49096,etO9cGvtnbcyDOUow8PWemZvzpbkeWT2,SpATywNh6bZuzm8s1ceuBUnMUAeoAHHw,35,70,29,24,10,1,23,0,157,22.428571428571427,11,0.0,10,29,22,10,60,1,2,23,0,71,86,0
5192,49098,eCQGRSI1IUOtkZBwaFMsuIa7hX3Csszu,SpATywNh6bZuzm8s1ceuBUnMUAeoAHHw,1,0,0,0,0,0,1,0,1,0.14285714285714285,1,0.0,0,0,0,0,0,0,0,1,0,0,1,1
5193,49104,AFfBbi1fYdYKsFJ8B1KXSG7cPpggG3JD,SpATywNh6bZuzm8s1ceuBUnMUAeoAHHw,15,22,3,4,3,0,5,0,37,5.285714285714286,3,0.0,0,3,4,3,22,0,0,5,0,10,27,0
5194,49114,1uHLOYSfEFwzZFuLCsgyZIWEkaqBo7Qo,A3fsA9Zfv1X2fVEQhTw51lKENdNrEqT3,1,0,0,0,0,0,1,0,1,0.14285714285714285,1,0.0,0,0,0,0,0,0,0,1,0,0,1,1
5195,49124,M7EQ6UxOsXQjbu4WIJCWam7cgbYToC2D,SpATywNh6bZuzm8s1ceuBUnMUAeoAHHw,1,0,0,0,0,0,1,0,1,0.14285714285714285,1,0.0,0,0,0,0,0,0,0,1,0,0,1,1
5196,49129,5VPsupm8AUE2ZBwqUxHjS8zxcSp1Mcls,SpATywNh6bZuzm8s1ceuBUnMUAeoAHHw,35,51,25,43,10,34,33,2,198,28.285714285714285,7,0.0,14,25,35,10,37,34,8,33,2,84,114,0
5197,49132,gSsRzqNvll8eqcaaEGmB933OlJpuGX1g,G8EPVSXsOYB5YQWZGiz1aVq5Pgr2GrQu,175,164,74,385,53,40,59,3,778,111.14285714285714,14,0.0,62,74,311,53,102,40,74,59,3,500,278,0
5198,49139,cszgTMCcWdEja3BpEwPP5MtLXTMUMJXE,G8EPVSXsOYB5YQWZGiz1aVq5Pgr2GrQu,62,88,35,106,17,3,11,1,261,37.285714285714285,3,0.0,37,35,72,17,51,3,34,11,1,161,100,1
5199,49143,Jt2ZVEP2fRpS6kT1yCei4p4So6yqdxLs,SpATywNh6bZuzm8s1ceuBUnMUAeoAHHw,41,58,30,32,15,5,21,4,165,23.571428571428573,8,0.0,14,30,30,15,44,5,2,21,4,89,76,0
5200,49155,xbEgNPkq7oopGIGH4RYgTrlgPLk46GrG,SpATywNh6bZuzm8s1ceuBUnMUAeoAHHw,35,53,2,49,0,1,18,1,124,17.714285714285715,3,0.0,20,2,46,0,33,1,3,18,1,68,56,0
5201,49157,PWKhgtJoYvVLEr2k8pYlCK3lg9ejdXh2,SpATywNh6bZuzm8s1ceuBUnMUAeoAHHw,5,2,1,0,1,0,2,0,6,0.8571428571428571,1,0.0,0,1,0,1,2,0,0,2,0,2,4,1
5202,49174,WjU8VISsquSeFe2LBisgFs90fx26laYI,SpATywNh6bZuzm8s1ceuBUnMUAeoAHHw,34,67,5,45,1,12,24,1,155,22.142857142857142,5,0.0,19,5,41,1,48,12,4,24,1,66,89,0
5203,49188,tg4dRbWUPF4nI55illP72uaDj0KVwE07,SpATywNh6bZuzm8s1ceuBUnMUAeoAHHw,17,56,2,18,1,0,22,3,102,14.571428571428571,3,0.0,5,2,17,1,51,0,1,22,3,25,77,1
5204,49196,FFLpMSWkcYP9u5pfR9jmdACaFpKaDwug,SpATywNh6bZuzm8s1ceuBUnMUAeoAHHw,36,39,27,10,14,0,14,0,104,14.857142857142858,7,0.0,2,27,9,14,37,0,1,14,0,52,52,0
5205,49197,sHAdbtjkiytWLt2Io4BZ2tzs5Et0ae7f,A3fsA9Zfv1X2fVEQhTw51lKENdNrEqT3,4,2,0,0,0,0,5,0,7,1.0,1,0.0,0,0,0,0,2,0,0,5,0,0,7,1
5206,49204,KWhhYcngkyB7QbL1Y9080mTGvLlZLj2v,SpATywNh6bZuzm8s1ceuBUnMUAeoAHHw,32,74,29,34,9,4,24,1,175,25.0,7,0.0,29,29,27,9,45,4,7,24,1,94,81,1
5207,49212,l70wRZ2DS0s6LjbT7C4gRoGrF27x9p2H,SpATywNh6bZuzm8s1ceuBUnMUAeoAHHw,32,63,5,29,3,32,22,0,154,22.0,12,0.0,9,5,26,3,54,32,3,22,0,43,111,0
5208,49224,hU8VTaLYSoElECAB03iz7dXo3kmtsuLn,5X6FeZozNMgE2VRi3MJYjkkFK8SETtu2,9,7,3,0,0,0,12,1,23,3.2857142857142856,3,0.0,0,3,0,0,7,0,0,12,1,3,20,1
5209,49227,Qv53J5pwTj9vVvZOfTayJrmLGAxLRscw,A3fsA9Zfv1X2fVEQhTw51lKENdNrEqT3,7,2,1,0,1,1,5,0,10,1.4285714285714286,1,0.0,0,1,0,1,2,1,0,5,0,2,8,1
5210,49230,nVktdU2hPjrulp1NoJo2DLy3TGZQ0Uld,RXDvfPUBYFlVdlueBFbLW0mhhAyGEqpt,1,0,0,0,0,0,1,0,1,0.14285714285714285,1,0.0,0,0,0,0,0,0,0,1,0,0,1,1
5211,49237,Et66VbQRwkFnF42twZ8Z4ErFWQLehmwC,G8EPVSXsOYB5YQWZGiz1aVq5Pgr2GrQu,10,16,5,0,5,0,11,0,37,5.285714285714286,4,0.0,1,5,0,5,15,0,0,11,0,11,26,1
5212,49282,Onp8u1IlkiXCdEq7Tg9xltw0KEKQAxrs,RXDvfPUBYFlVdlueBFbLW0mhhAyGEqpt,9,6,3,0,2,0,3,0,14,2.0,2,0.0,0,3,0,2,6,0,0,3,0,5,9,1
5213,49289,r4ayLHscytxOLCupR1DXHmdWyARPuLpA,5X6FeZozNMgE2VRi3MJYjkkFK8SETtu2,18,40,11,14,1,3,12,2,83,11.857142857142858,9,0.0,4,11,12,1,36,3,2,12,2,28,55,1
5214,49313,YQzUeDQQAfJF96X2O80R1owwrQ0VWsFN,SpATywNh6bZuzm8s1ceuBUnMUAeoAHHw,21,15,12,0,9,0,4,0,40,5.714285714285714,4,0.0,0,12,0,9,15,0,0,4,0,21,19,0
5215,49351,eFBES6IMQYn0JaXFDvfen5eqvCA8gBJT,A3fsA9Zfv1X2fVEQhTw51lKENdNrEqT3,1,0,0,0,0,0,1,0,1,0.14285714285714285,1,0.0,0,0,0,0,0,0,0,1,0,0,1,1
5216,49353,W6MGFBQ1Tov9lOeRQ8QlzHUMCDNEGRDq,SpATywNh6bZuzm8s1ceuBUnMUAeoAHHw,25,30,10,33,6,0,10,0,89,12.714285714285714,3,0.0,8,10,30,6,22,0,3,10,0,54,35,1
5217,49357,oJ9j9ejTgKixczg3tSE8Sg8DPI7YQpJq,G8EPVSXsOYB5YQWZGiz1aVq5Pgr2GrQu,106,137,58,184,23,11,13,0,426,60.857142857142854,6,0.0,62,58,138,23,75,11,46,13,0,281,145,0
5218,49368,86lwqlBE6tkGHxTUWUK2RErYvHMYsCb4,RXDvfPUBYFlVdlueBFbLW0mhhAyGEqpt,10,8,4,0,3,2,3,0,20,2.857142857142857,1,0.0,0,4,0,3,8,2,0,3,0,7,13,1
5219,49376,endumB3uNuPZEFkf3CSbVDfBrwPiEVSP,A3fsA9Zfv1X2fVEQhTw51lKENdNrEqT3,36,44,32,48,23,1,18,0,166,23.714285714285715,5,0.0,3,32,39,23,41,1,9,18,0,97,69,1
5220,49380,Lco7LdlfaKIY7j4a1DlB6UakSMZTbCc5,5X6FeZozNMgE2VRi3MJYjkkFK8SETtu2,2,0,0,0,0,0,3,0,3,0.42857142857142855,1,0.0,0,0,0,0,0,0,0,3,0,0,3,1
5221,49397,uZVvmJaNXb0GsvOW7SvWgzrpxZ3muXeW,SpATywNh6bZuzm8s1ceuBUnMUAeoAHHw,39,41,17,46,11,15,17,2,149,21.285714285714285,8,0.0,16,17,45,11,25,15,1,17,2,89,60,0
5222,49410,tzUG2qRl7N6mPYRCQUU2RS3J3hIQZLrD,bWdj2GDclj5ofokWjzoa5jAwMkxCykd6,23,62,28,50,19,8,10,0,177,25.285714285714285,5,0.0,18,28,40,19,44,8,10,10,0,105,72,1
5223,49422,0xvOREru4H5eJ6hNO4BlGhEyj2EC6VxN,SpATywNh6bZuzm8s1ceuBUnMUAeoAHHw,1,0,0,0,0,0,1,0,1,0.14285714285714285,1,0.0,0,0,0,0,0,0,0,1,0,0,1,1
5224,49428,HxubVk6qxALTKY86iFsfskUh9kA3f2Wx,SpATywNh6bZuzm8s1ceuBUnMUAeoAHHw,62,174,82,78,34,113,35,4,520,74.28571428571429,9,0.0,46,82,65,34,128,113,13,35,4,227,293,0
5225,49442,MXj6ZGgoAkYjUkY8OaHYQpOdo7dehPJA,SpATywNh6bZuzm8s1ceuBUnMUAeoAHHw,5,2,1,0,1,0,3,0,7,1.0,1,0.0,0,1,0,1,2,0,0,3,0,2,5,1
5226,49457,KdLS3BVh0aFKrdvLPEqJwR9P75VBUiUC,SpATywNh6bZuzm8s1ceuBUnMUAeoAHHw,14,16,9,0,8,0,9,0,42,6.0,2,0.0,1,9,0,8,15,0,0,9,0,18,24,1
5227,49465,AwU9DlMJM6JgTKK1MDMCUEzigNcc7nPC,5X6FeZozNMgE2VRi3MJYjkkFK8SETtu2,8,13,2,0,2,0,8,0,25,3.5714285714285716,2,0.0,4,2,0,2,9,0,0,8,0,8,17,1
5228,49473,VL7NPBJuyzF1uV3nhlsl7JEimjvq8BIB,RXDvfPUBYFlVdlueBFbLW0mhhAyGEqpt,1,0,0,0,0,0,1,0,1,0.14285714285714285,1,0.0,0,0,0,0,0,0,0,1,0,0,1,1
5229,49481,2uoMQOxqyRzmIYFGnyAflqy5t44QW2xE,G8EPVSXsOYB5YQWZGiz1aVq5Pgr2GrQu,53,102,52,52,31,10,25,2,274,39.142857142857146,9,0.0,30,52,37,31,72,10,15,25,2,150,124,0
5230,49488,YOufk89dGH8sqtxV0zNmtG1C5axdPYES,5X6FeZozNMgE2VRi3MJYjkkFK8SETtu2,1,0,0,0,0,0,1,0,1,0.14285714285714285,1,0.0,0,0,0,0,0,0,0,1,0,0,1,1
5231,49489,GXmApUIE1IechykqO3xyhcbVn1kfVOsr,5X6FeZozNMgE2VRi3MJYjkkFK8SETtu2,5,2,1,0,1,0,2,0,6,0.8571428571428571,2,0.0,0,1,0,1,2,0,0,2,0,2,4,1
5232,49491,4WZA45bzzwtSAshCx00ZUSQpyrxBtdvp,SpATywNh6bZuzm8s1ceuBUnMUAeoAHHw,10,11,8,0,7,0,3,0,29,4.142857142857143,3,0.0,0,8,0,7,11,0,0,3,0,15,14,1
5233,49492,8zWgVyFjldbfjgOVhyVSCY9hVHofzB37,SpATywNh6bZuzm8s1ceuBUnMUAeoAHHw,55,95,37,34,22,7,25,2,222,31.714285714285715,15,0.0,19,37,31,22,76,7,3,25,2,109,113,0
5234,49498,fvKvLXxKUkIMSZtq4vkKhxSOsZi4a1AH,SpATywNh6bZuzm8s1ceuBUnMUAeoAHHw,11,5,4,6,3,0,2,0,20,2.857142857142857,1,0.0,0,4,5,3,5,0,1,2,0,12,8,1
5235,49502,zbDDJL57Eoinf5rQFwxv5qPElJd1fdtI,SpATywNh6bZuzm8s1ceuBUnMUAeoAHHw,4,2,1,0,1,0,1,0,5,0.7142857142857143,2,0.0,0,1,0,1,2,0,0,1,0,2,3,1
5236,49506,ZOJ5QbCRlZ7Fm01C02cxFKL8leZWKfBc,SpATywNh6bZuzm8s1ceuBUnMUAeoAHHw,40,84,12,48,6,6,21,2,179,25.571428571428573,5,0.0,20,12,38,6,64,6,10,21,2,76,103,0
5237,49507,IFqWOl32JJm0W3Ap2jxVCpJeXeLJlYDp,bWdj2GDclj5ofokWjzoa5jAwMkxCykd6,13,11,6,10,2,0,6,0,35,5.0,3,0.0,1,6,5,2,10,0,5,6,0,14,21,1
5238,49516,ExNrdfeKsdYl3xmpiJlCBa13JPKyssuX,5X6FeZozNMgE2VRi3MJYjkkFK8SETtu2,6,5,1,0,0,0,9,0,15,2.142857142857143,6,0.0,0,1,0,0,5,0,0,9,0,1,14,0
5239,49547,PIAH3m3yXecwsaiYYmcRmhzQt3oUmGgZ,A3fsA9Zfv1X2fVEQhTw51lKENdNrEqT3,2,0,0,0,0,0,2,0,2,0.2857142857142857,1,0.0,0,0,0,0,0,0,0,2,0,0,2,1
5240,49574,jdOdZxrxaATCu1ggjNzD0BD26QmUeIwp,A3fsA9Zfv1X2fVEQhTw51lKENdNrEqT3,1,0,0,0,0,0,1,0,1,0.14285714285714285,1,0.0,0,0,0,0,0,0,0,1,0,0,1,1
5241,49593,tLAxgBhXx0zpE8fWNnwggaJx5LeHI2h1,A3fsA9Zfv1X2fVEQhTw51lKENdNrEqT3,85,88,47,214,38,0,9,0,396,56.57142857142857,6,0.0,2,47,182,38,86,0,32,9,0,269,127,1
5242,49594,cvoMRtPY6qflB97uu9pYZ8EABJnJiTnH,A3fsA9Zfv1X2fVEQhTw51lKENdNrEqT3,7,7,1,0,1,0,3,0,12,1.7142857142857142,2,0.0,1,1,0,1,6,0,0,3,0,3,9,1
5243,49602,7vO4g7GKU63bpLmNrZ8Z66FvgSw6Sbgl,A3fsA9Zfv1X2fVEQhTw51lKENdNrEqT3,4,2,1,0,1,0,1,0,5,0.7142857142857143,1,0.0,0,1,0,1,2,0,0,1,0,2,3,1
5244,49640,XRprdFoWtySQSNhPZow4aE4x8DdY6QhU,SpATywNh6bZuzm8s1ceuBUnMUAeoAHHw,1,0,0,0,0,0,2,0,2,0.2857142857142857,2,0.0,0,0,0,0,0,0,0,2,0,0,2,1
5245,49648,30XPDexQK4yFduDczZYYxmxB2MeR5QVB,G8EPVSXsOYB5YQWZGiz1aVq5Pgr2GrQu,4,1,0,0,0,0,3,0,4,0.5714285714285714,1,0.0,0,0,0,0,1,0,0,3,0,0,4,1
5246,49675,vEvuCci9jxTTRH9CGXFnMQL31rdrARkm,RXDvfPUBYFlVdlueBFbLW0mhhAyGEqpt,67,168,82,143,43,14,38,2,490,70.0,14,0.0,45,82,131,43,123,14,12,38,2,301,189,1
5247,49676,1rh5VRO8SYrfP8Lu1XXtrSs551JhH1SG,SpATywNh6bZuzm8s1ceuBUnMUAeoAHHw,46,56,30,41,16,21,24,1,189,27.0,6,0.0,16,30,38,16,40,21,3,24,1,100,89,0
5248,49684,RSF86CJJRRqjqcjlLpUNS7gfvntoDbsR,SpATywNh6bZuzm8s1ceuBUnMUAeoAHHw,42,71,30,33,15,1,6,0,156,22.285714285714285,3,0.0,13,30,26,15,58,1,7,6,0,84,72,0
5249,49689,M4KtR07p6NuW0Nzc9JWKn4kOJ33eMAHm,G8EPVSXsOYB5YQWZGiz1aVq5Pgr2GrQu,48,57,18,80,11,7,7,1,181,25.857142857142858,3,0.0,34,18,48,11,23,7,32,7,1,111,70,1
5250,49713,3mhHS6HFiNSDTjK0MItggE081qDKfyqL,SpATywNh6bZuzm8s1ceuBUnMUAeoAHHw,46,64,45,14,31,14,17,0,185,26.428571428571427,9,0.0,9,45,11,31,55,14,3,17,0,96,89,0
5251,49723,ZCmXmibJJyKrtc3CWMzzqRPDMvcmZhyR,SpATywNh6bZuzm8s1ceuBUnMUAeoAHHw,23,38,18,20,7,0,10,1,94,13.428571428571429,3,0.0,10,18,17,7,28,0,3,10,1,52,42,1
5252,49730,yf7eKg1R1s9Jrndu3uHIkRPOTsOf9V7F,SpATywNh6bZuzm8s1ceuBUnMUAeoAHHw,31,41,27,20,17,1,3,0,109,15.571428571428571,3,0.0,4,27,19,17,37,1,1,3,0,67,42,0
5253,49733,YIbC1cuJA4PbBVwCZRQOVlAtofCW8hIn,A3fsA9Zfv1X2fVEQhTw51lKENdNrEqT3,68,29,19,116,13,0,7,0,184,26.285714285714285,5,0.0,3,19,102,13,26,0,14,7,0,137,47,1
5254,49746,pFE82fh5DH8NUVtvV1y83suNQP2lNeAe,RXDvfPUBYFlVdlueBFbLW0mhhAyGEqpt,40,52,1,66,3,0,9,1,132,18.857142857142858,5,0.0,15,1,63,3,37,0,3,9,1,82,50,0
5255,49779,W6MGFBQ1Tov9lOeRQ8QlzHUMCDNEGRDq,A3fsA9Zfv1X2fVEQhTw51lKENdNrEqT3,176,123,72,240,45,3,30,2,515,73.57142857142857,9,0.0,7,72,232,45,116,3,8,30,2,356,159,0
5256,49785,vgCPDvQaJnbjskT5eabUGvowszNYd8hw,bWdj2GDclj5ofokWjzoa5jAwMkxCykd6,1,0,0,0,0,0,1,0,1,0.14285714285714285,1,0.0,0,0,0,0,0,0,0,1,0,0,1,1
5257,49787,ZuPH4O6ElHiBwlm11NvwWK4IBueWaJol,SpATywNh6bZuzm8s1ceuBUnMUAeoAHHw,1,0,0,0,0,0,1,0,1,0.14285714285714285,1,0.0,0,0,0,0,0,0,0,1,0,0,1,1
5258,49796,N8XZVHbpFzVAWZIErWyzhDPvSa6whLzL,SpATywNh6bZuzm8s1ceuBUnMUAeoAHHw,3,0,0,0,0,0,3,0,3,0.42857142857142855,1,0.0,0,0,0,0,0,0,0,3,0,0,3,1
5259,49797,ijnu7LB4FcRJ96Cg1DpU1m8TR26aHP0S,G8EPVSXsOYB5YQWZGiz1aVq5Pgr2GrQu,5,3,0,0,0,0,3,0,6,0.8571428571428571,1,0.0,0,0,0,0,3,0,0,3,0,0,6,1
5260,49814,PLdoU57JNvCjCeLgODtLI3Tukef38LFN,SpATywNh6bZuzm8s1ceuBUnMUAeoAHHw,22,41,2,0,0,0,5,0,48,6.857142857142857,2,0.0,11,2,0,0,30,0,0,5,0,13,35,1
5261,49819,TN2mpCmjDkqLDPlwKTIBj6ZZbjnMqCiy,A3fsA9Zfv1X2fVEQhTw51lKENdNrEqT3,25,18,13,0,11,0,10,0,52,7.428571428571429,2,0.0,0,13,0,11,18,0,0,10,0,24,28,1
5262,49837,lBlhCim6cr1auRYAm96gRvGD6qkdcp2T,A3fsA9Zfv1X2fVEQhTw51lKENdNrEqT3,2,0,0,0,0,0,4,0,4,0.5714285714285714,1,0.0,0,0,0,0,0,0,0,4,0,0,4,1
5263,49838,4dC723f2ZXGHBwWoh8xH8B5ftd5Zr0Rn,SpATywNh6bZuzm8s1ceuBUnMUAeoAHHw,5,2,0,0,1,0,2,0,5,0.7142857142857143,1,0.0,0,0,0,1,2,0,0,2,0,1,4,0
5264,49867,ajdXJNtmFj3djCMALYMagt4EstfNGU3t,SpATywNh6bZuzm8s1ceuBUnMUAeoAHHw,41,43,30,18,19,13,23,0,146,20.857142857142858,7,0.0,6,30,17,19,37,13,1,23,0,72,74,0
5265,49875,0Akk5gAtNLhWs93rvoK6BfZzftMu43VT,SpATywNh6bZuzm8s1ceuBUnMUAeoAHHw,60,83,37,61,19,3,19,2,224,32.0,5,0.0,12,37,57,19,71,3,4,19,2,125,99,0
5266,49878,fvzGqz3wcA15cPFjEfZNgqzkQDubcDYj,SpATywNh6bZuzm8s1ceuBUnMUAeoAHHw,36,161,92,44,0,36,85,10,428,61.142857142857146,14,0.0,28,92,37,0,133,36,7,85,10,157,271,0
5267,49885,v8BycPX41vEGxhnmXhJJeiFe4eT4u7RK,SpATywNh6bZuzm8s1ceuBUnMUAeoAHHw,42,48,33,54,1,3,13,0,152,21.714285714285715,7,0.0,8,33,47,1,40,3,7,13,0,89,63,0
5268,49939,WMFV7sfGiymyypraYicGVqscWxGZ0nHz,SpATywNh6bZuzm8s1ceuBUnMUAeoAHHw,14,21,8,12,5,0,6,0,52,7.428571428571429,3,0.0,2,8,11,5,19,0,1,6,0,26,26,1
5269,49941,C4q4gNQYEpjKh7pq1qjN8i3L7uSpUX9d,RXDvfPUBYFlVdlueBFbLW0mhhAyGEqpt,40,44,32,32,27,1,9,1,146,20.857142857142858,5,0.0,4,32,28,27,40,1,4,9,1,91,55,1
5270,49947,xXjBI1Nf4mgkfSUkf8YjQF9E0XahXwSr,SpATywNh6bZuzm8s1ceuBUnMUAeoAHHw,45,51,24,21,13,14,16,1,140,20.0,5,0.0,20,24,21,13,31,14,0,16,1,78,62,0
5271,49957,BJvWyg8XIdrq4SNeVAfLk9dJg6cRJiup,A3fsA9Zfv1X2fVEQhTw51lKENdNrEqT3,2,0,0,0,0,0,5,0,5,0.7142857142857143,1,0.0,0,0,0,0,0,0,0,5,0,0,5,1
5272,49960,5DZRIacIZU0OycjWEAvqBXR0CzjjwwCH,SpATywNh6bZuzm8s1ceuBUnMUAeoAHHw,31,36,1,38,0,0,11,0,86,12.285714285714286,4,0.0,13,1,36,0,23,0,2,11,0,50,36,0
5273,49980,fFjj8aLqWVfTrDoDqL54VYBbLQmMY3Y1,G8EPVSXsOYB5YQWZGiz1aVq5Pgr2GrQu,27,63,2,40,5,0,19,2,131,18.714285714285715,6,0.0,41,2,32,5,22,0,8,19,2,80,51,1
5274,49981,Q0d1WItnRJvnzlnn5VcAU6GMGN4rfbYJ,A3fsA9Zfv1X2fVEQhTw51lKENdNrEqT3,22,45,28,0,14,0,16,0,103,14.714285714285714,5,0.0,0,28,0,14,45,0,0,16,0,42,61,1
5275,49986,cT0XTodWylQtczhaeg1zuAXwbhCqeXWR,SpATywNh6bZuzm8s1ceuBUnMUAeoAHHw,33,70,5,20,4,0,13,0,112,16.0,9,0.0,2,5,17,4,68,0,3,13,0,28,84,0
5276,50006,IjWCyY0OMptnbDif5zdKxFY839cuvS21,SpATywNh6bZuzm8s1ceuBUnMUAeoAHHw,16,26,6,7,3,0,5,0,47,6.714285714285714,4,0.0,0,6,7,3,26,0,0,5,0,16,31,0
5277,50014,HNrhRop3OWv7dTM3iJvhfqpVPch4tFDK,SpATywNh6bZuzm8s1ceuBUnMUAeoAHHw,5,2,1,0,1,0,2,0,6,0.8571428571428571,1,0.0,0,1,0,1,2,0,0,2,0,2,4,1
5278,50015,me65WsEaHvTZs0TNYVukzNrKK1hdRpMM,A3fsA9Zfv1X2fVEQhTw51lKENdNrEqT3,7,5,3,0,1,0,3,0,12,1.7142857142857142,1,0.0,0,3,0,1,5,0,0,3,0,4,8,1
5279,50023,Eu9HoDt3WhECHgcXaERosbI6lMj7Hipb,A3fsA9Zfv1X2fVEQhTw51lKENdNrEqT3,72,83,70,114,54,17,15,1,354,50.57142857142857,7,0.0,2,70,93,54,81,17,21,15,1,219,135,1
5280,50027,tWEnJYIhXMJ03Foo959mubaAJUHZPTw0,SpATywNh6bZuzm8s1ceuBUnMUAeoAHHw,43,214,7,64,1,80,63,5,434,62.0,17,0.0,25,7,55,1,189,80,9,63,5,88,346,0
5281,50028,9e5dcfJQbPUU8sTcmzE9DWoDPOA9Nhu3,A3fsA9Zfv1X2fVEQhTw51lKENdNrEqT3,8,21,1,0,1,0,5,0,28,4.0,3,0.0,0,1,0,1,21,0,0,5,0,2,26,0
5282,50032,aKjAC5UWlmbeTD1k9n3NGSA3VSvaAKtm,SpATywNh6bZuzm8s1ceuBUnMUAeoAHHw,37,66,39,28,15,7,18,1,174,24.857142857142858,7,0.0,17,39,24,15,49,7,4,18,1,95,79,0
5283,50037,5ARkGJ4p1hrN1paVNwlZ2LmySeAZIjWv,SpATywNh6bZuzm8s1ceuBUnMUAeoAHHw,28,52,24,29,11,0,6,0,122,17.428571428571427,4,0.0,6,24,25,11,46,0,4,6,0,66,56,1
5284,50052,iWQoMguWomITf7gp2KK8eyU3oaGLECcV,SpATywNh6bZuzm8s1ceuBUnMUAeoAHHw,18,22,10,18,5,1,7,1,64,9.142857142857142,2,0.0,7,10,16,5,15,1,2,7,1,38,26,1
5285,50059,knZ4z0qX97n2wyecV68DJHHLXXd3Hlc1,RXDvfPUBYFlVdlueBFbLW0mhhAyGEqpt,6,5,2,0,2,0,1,0,10,1.4285714285714286,1,0.0,0,2,0,2,5,0,0,1,0,4,6,1
5286,50064,IEkq5dNYNtGLgDWnMbZ6LuxRn59Xykyu,SpATywNh6bZuzm8s1ceuBUnMUAeoAHHw,5,2,1,0,1,0,2,0,6,0.8571428571428571,1,0.0,0,1,0,1,2,0,0,2,0,2,4,1
5287,50084,1HlQxNM9nR1hj1jXFLyimiGxZiQUWT8w,RXDvfPUBYFlVdlueBFbLW0mhhAyGEqpt,48,66,25,73,24,12,13,3,216,30.857142857142858,5,0.0,20,25,70,24,46,12,3,13,3,139,77,1
5288,50110,g5r6m0eWuBFo9Ltn4NxasFr3GIgAvV2s,bWdj2GDclj5ofokWjzoa5jAwMkxCykd6,18,5,4,18,2,8,7,0,44,6.285714285714286,1,0.0,0,4,9,2,5,8,9,7,0,15,29,1
5289,50113,YGwgPZSZDAKlEa7pV7OgIimz6xfMMXoJ,A3fsA9Zfv1X2fVEQhTw51lKENdNrEqT3,1,0,0,0,0,0,1,0,1,0.14285714285714285,1,0.0,0,0,0,0,0,0,0,1,0,0,1,1
5290,50117,BYgO44BLHl6nPQHldrc4xzPg69SE4ic2,G8EPVSXsOYB5YQWZGiz1aVq5Pgr2GrQu,5,5,0,0,0,0,3,0,8,1.1428571428571428,1,0.0,0,0,0,0,5,0,0,3,0,0,8,1
5291,50128,SnkMsvFr6gVfsUh2QCHop5MZKFvnnxEr,SpATywNh6bZuzm8s1ceuBUnMUAeoAHHw,9,14,5,0,2,0,3,0,24,3.4285714285714284,1,0.0,0,5,0,2,14,0,0,3,0,7,17,1
5292,50139,YGwgPZSZDAKlEa7pV7OgIimz6xfMMXoJ,SpATywNh6bZuzm8s1ceuBUnMUAeoAHHw,1,0,0,0,0,0,1,0,1,0.14285714285714285,1,0.0,0,0,0,0,0,0,0,1,0,0,1,1
5293,50152,zXbxnvnaWnD5HsPlG7w2dznmSR3nmFJG,SpATywNh6bZuzm8s1ceuBUnMUAeoAHHw,2,0,0,0,0,0,2,0,2,0.2857142857142857,1,0.0,0,0,0,0,0,0,0,2,0,0,2,1
5294,50157,QxxdakYrISiiDLexNlB0fwU8yeNcfQh4,SpATywNh6bZuzm8s1ceuBUnMUAeoAHHw,37,44,25,29,12,1,9,0,120,17.142857142857142,3,0.0,12,25,26,12,32,1,3,9,0,75,45,1
5295,50159,g8JsC0SKbA6BjX9kM924D9Pd4t0BBto8,5X6FeZozNMgE2VRi3MJYjkkFK8SETtu2,1,0,0,0,0,0,1,0,1,0.14285714285714285,1,0.0,0,0,0,0,0,0,0,1,0,0,1,1
5296,50161,vQxwNbtZgUat9SDZRmE7MEKdvAizpBwk,SpATywNh6bZuzm8s1ceuBUnMUAeoAHHw,40,87,4,33,1,9,14,2,150,21.428571428571427,6,0.0,10,4,33,1,77,9,0,14,2,48,102,0
5297,50162,jO3nw1CIj4lie1rvidttURQZ3baEeNVw,SpATywNh6bZuzm8s1ceuBUnMUAeoAHHw,26,37,17,0,12,0,9,1,76,10.857142857142858,2,0.0,1,17,0,12,36,0,0,9,1,30,46,0
5298,50170,jJ6KwmQPdHVF9SNnawJ7zfgWoExKlRbO,SpATywNh6bZuzm8s1ceuBUnMUAeoAHHw,15,27,12,12,3,0,6,0,60,8.571428571428571,3,0.0,5,12,10,3,22,0,2,6,0,30,30,1
5299,50173,lVM3D8yPmd62Fdb29hI2YI0VPwlNvI4t,bWdj2GDclj5ofokWjzoa5jAwMkxCykd6,15,22,8,8,9,2,14,1,64,9.142857142857142,4,0.0,10,8,7,9,12,2,1,14,1,34,30,1
5300,50194,pgQsIllz0tTKnSXyilDnJ4hCvZr8UF8j,5X6FeZozNMgE2VRi3MJYjkkFK8SETtu2,32,103,40,39,34,24,28,4,272,38.857142857142854,5,0.0,49,40,36,34,54,24,3,28,4,159,113,1
5301,50203,8ZgsKNDzCbgk8zoZndfYiYFsfvE0SQgi,SpATywNh6bZuzm8s1ceuBUnMUAeoAHHw,44,79,9,74,4,1,26,1,194,27.714285714285715,10,0.0,33,9,63,4,46,1,11,26,1,109,85,0
5302,50205,MjjHVlUuOHpErRpbxsSv5C4Ujl4db690,SpATywNh6bZuzm8s1ceuBUnMUAeoAHHw,7,8,2,0,2,0,4,0,16,2.2857142857142856,1,0.0,0,2,0,2,8,0,0,4,0,4,12,1
5303,50223,l5LfU8gApOG72AnBkdAbfOLQLwFH7Zo2,SpATywNh6bZuzm8s1ceuBUnMUAeoAHHw,46,82,6,46,3,35,19,0,191,27.285714285714285,11,0.0,17,6,35,3,65,35,11,19,0,61,130,0
5304,50225,zjpZPzRIhIAoPRhm9tqA9rD229kEYBUb,bWdj2GDclj5ofokWjzoa5jAwMkxCykd6,1,0,0,0,0,0,1,0,1,0.14285714285714285,1,0.0,0,0,0,0,0,0,0,1,0,0,1,1
5305,50228,5GeMwmyzCXMcMYfcWdKaXbpNNdL8bmPq,RXDvfPUBYFlVdlueBFbLW0mhhAyGEqpt,1,0,0,0,0,0,1,0,1,0.14285714285714285,1,0.0,0,0,0,0,0,0,0,1,0,0,1,1
5306,50253,EiUeiCLNAFHc6aBGPYOKcqWKwt8Zv1wV,SpATywNh6bZuzm8s1ceuBUnMUAeoAHHw,44,50,1,43,0,2,13,1,110,15.714285714285714,3,0.0,13,1,41,0,37,2,2,13,1,55,55,0
5307,50260,o9m1fMq17KjyGUhfLHLXFO5hoKQ5jU6O,5X6FeZozNMgE2VRi3MJYjkkFK8SETtu2,16,36,1,18,0,2,6,0,63,9.0,5,0.0,18,1,17,0,18,2,1,6,0,36,27,1
5308,50274,qK0jTiDwwAEQs0Aa86HdbFtrLUQNPD2L,SpATywNh6bZuzm8s1ceuBUnMUAeoAHHw,5,3,1,0,1,0,2,0,7,1.0,1,0.0,1,1,0,1,2,0,0,2,0,3,4,1
5309,50279,CyelsVXrffOJcI4D4Ax6e4uKbn9S9AKP,A3fsA9Zfv1X2fVEQhTw51lKENdNrEqT3,2,0,0,0,0,0,2,0,2,0.2857142857142857,1,0.0,0,0,0,0,0,0,0,2,0,0,2,1
5310,50289,y2Ax6YPEXNFRNUBbavPb4UTazWHX4UeX,SpATywNh6bZuzm8s1ceuBUnMUAeoAHHw,7,3,2,0,2,0,2,0,9,1.2857142857142858,1,0.0,0,2,0,2,3,0,0,2,0,4,5,1
5311,50293,qK0jTiDwwAEQs0Aa86HdbFtrLUQNPD2L,RXDvfPUBYFlVdlueBFbLW0mhhAyGEqpt,8,4,3,0,2,0,2,0,11,1.5714285714285714,1,0.0,0,3,0,2,4,0,0,2,0,5,6,1
5312,50294,mexTVUuTBaMSHWugjgX7gCSwX1B8AubF,SpATywNh6bZuzm8s1ceuBUnMUAeoAHHw,11,28,2,0,2,0,6,0,38,5.428571428571429,5,0.0,0,2,0,2,28,0,0,6,0,4,34,0
5313,50320,1OwZz25mXZNgO62URLrpwxju1xtv0yd9,SpATywNh6bZuzm8s1ceuBUnMUAeoAHHw,16,30,7,49,0,6,22,1,115,16.428571428571427,8,0.0,13,7,40,0,17,6,9,22,1,60,55,0
5314,50322,jxVbF1puB335S13Sh1SeiyqryzWrY9TH,SpATywNh6bZuzm8s1ceuBUnMUAeoAHHw,18,22,4,19,5,0,13,0,63,9.0,4,0.0,4,4,19,5,18,0,0,13,0,32,31,1
5315,50352,BS7u1moD4G6tIsp3i8TsGiKk2duVqSQ0,G8EPVSXsOYB5YQWZGiz1aVq5Pgr2GrQu,9,11,6,0,4,0,5,0,26,3.7142857142857144,3,0.0,0,6,0,4,11,0,0,5,0,10,16,1
5316,50361,Gur5FuhE9EyV9K1F0qLPk7AenhoY8PBS,SpATywNh6bZuzm8s1ceuBUnMUAeoAHHw,21,24,0,29,0,34,25,3,115,16.428571428571427,4,0.0,8,0,23,0,16,34,6,25,3,31,84,1
5317,50368,kBV4mR9qFSJedXrCK3UtZoeKEUmuZ9wn,5X6FeZozNMgE2VRi3MJYjkkFK8SETtu2,44,160,14,81,2,69,55,1,382,54.57142857142857,12,0.0,63,14,75,2,97,69,6,55,1,154,228,1
5318,50376,JWtRXomIKoqZYOItc3dpuDZlGcxpfAbC,RXDvfPUBYFlVdlueBFbLW0mhhAyGEqpt,23,50,31,8,22,3,3,0,117,16.714285714285715,2,0.0,0,31,7,22,50,3,1,3,0,60,57,1
5319,50380,Xdag5jOmE7uWC3FmBvgPc5F7lO3QNcPW,bWdj2GDclj5ofokWjzoa5jAwMkxCykd6,59,139,59,223,30,71,50,8,580,82.85714285714286,12,0.0,18,59,194,30,121,71,29,50,8,301,279,0
5320,50383,wcXKTRp3782w7z3pcKy7I4KlcLaVU81W,SpATywNh6bZuzm8s1ceuBUnMUAeoAHHw,17,22,2,0,1,0,5,0,30,4.285714285714286,4,0.0,0,2,0,1,22,0,0,5,0,3,27,0
5321,50387,gWLNrui4xJ6xOW9BQTEyWRBtLNqndryz,bWdj2GDclj5ofokWjzoa5jAwMkxCykd6,8,15,0,0,1,0,2,0,18,2.5714285714285716,2,0.0,3,0,0,1,12,0,0,2,0,4,14,1
5322,50395,sBhz8U16B7sa3LOSIqulBpvj71xTLTZF,SpATywNh6bZuzm8s1ceuBUnMUAeoAHHw,2,0,0,0,0,0,2,0,2,0.2857142857142857,1,0.0,0,0,0,0,0,0,0,2,0,0,2,1
5323,50401,dk07gP54X69nuCMty25BNGOYSGmkxtJW,SpATywNh6bZuzm8s1ceuBUnMUAeoAHHw,25,40,1,23,0,4,25,2,95,13.571428571428571,4,0.0,16,1,21,0,24,4,2,25,2,38,57,0
5324,50417,zYT144o5gG83ITHydzc0I4BahBKUTuVY,A3fsA9Zfv1X2fVEQhTw51lKENdNrEqT3,6,8,0,0,0,0,5,0,13,1.8571428571428572,4,0.0,0,0,0,0,8,0,0,5,0,0,13,1
5325,50418,dy5U2Hr6hWmpYZri5b9XY0EijWuyuZjO,RXDvfPUBYFlVdlueBFbLW0mhhAyGEqpt,2,0,0,0,0,0,4,0,4,0.5714285714285714,1,0.0,0,0,0,0,0,0,0,4,0,0,4,1
5326,50422,SnivjdMp3HL6G23yPscSnzZlAD2Rbyt6,bWdj2GDclj5ofokWjzoa5jAwMkxCykd6,70,109,55,170,37,32,12,0,415,59.285714285714285,9,0.0,36,55,145,37,73,32,25,12,0,273,142,1
5327,50428,SnivjdMp3HL6G23yPscSnzZlAD2Rbyt6,RXDvfPUBYFlVdlueBFbLW0mhhAyGEqpt,1,0,0,0,0,0,1,0,1,0.14285714285714285,1,0.0,0,0,0,0,0,0,0,1,0,0,1,1
5328,50433,nWc5KHoYFVRoaDcRvamz8phBJoK95aNe,RXDvfPUBYFlVdlueBFbLW0mhhAyGEqpt,1,0,0,0,0,0,1,0,1,0.14285714285714285,1,0.0,0,0,0,0,0,0,0,1,0,0,1,1
5329,50455,9jNN69RJsAFkkuYDPHWQVpfsVwA6mFxd,SpATywNh6bZuzm8s1ceuBUnMUAeoAHHw,54,76,48,65,11,0,19,0,219,31.285714285714285,9,0.0,8,48,58,11,68,0,7,19,0,125,94,0
5330,50460,DRhlp1eJHQqsxjCL0bRD6kkHN20HbJ4w,RXDvfPUBYFlVdlueBFbLW0mhhAyGEqpt,17,20,12,12,7,3,5,0,59,8.428571428571429,6,0.0,1,12,12,7,19,3,0,5,0,32,27,1
5331,50473,1v6DOxYlkOvOHyU9Jbeb1YuXisY7Ilv8,SpATywNh6bZuzm8s1ceuBUnMUAeoAHHw,31,28,19,16,14,0,4,0,81,11.571428571428571,3,0.0,2,19,14,14,26,0,2,4,0,49,32,0
5332,50479,wfvJgFT5spPJFxchmb7eMbxy7ga4Z42J,A3fsA9Zfv1X2fVEQhTw51lKENdNrEqT3,31,30,1,80,0,18,27,3,159,22.714285714285715,3,0.0,2,1,66,0,28,18,14,27,3,69,90,0
5333,50481,ZhurkXmgh5sEiUWLyFC6UHrljEG5kXpb,SpATywNh6bZuzm8s1ceuBUnMUAeoAHHw,8,10,8,0,8,0,13,0,39,5.571428571428571,5,0.0,0,8,0,8,10,0,0,13,0,16,23,1
5334,50485,bZVDIvmAMciYIQrrbhRx0jvH9Tiicfyn,SpATywNh6bZuzm8s1ceuBUnMUAeoAHHw,15,31,1,14,0,5,8,0,59,8.428571428571429,4,0.0,5,1,13,0,26,5,1,8,0,19,40,0
5335,50495,3kOFsgHC3tWJNSzqIlZ1BKfxh1AIkRy9,SpATywNh6bZuzm8s1ceuBUnMUAeoAHHw,32,36,17,27,9,0,8,0,97,13.857142857142858,4,0.0,11,17,25,9,25,0,2,8,0,62,35,0
5336,50498,Crsle3QdAPcjxEbhDM61m0114QeooRDa,A3fsA9Zfv1X2fVEQhTw51lKENdNrEqT3,2,0,0,0,0,0,2,0,2,0.2857142857142857,1,0.0,0,0,0,0,0,0,0,2,0,0,2,1
5337,50507,vrKNA3eEZxLntZreFchejbQ8UgnPaTUE,SpATywNh6bZuzm8s1ceuBUnMUAeoAHHw,8,9,5,0,2,0,2,0,18,2.5714285714285716,1,0.0,2,5,0,2,7,0,0,2,0,9,9,1
5338,50515,E7wBgQCkgD4tkfXLdP9URnDZqb2ubvF0,A3fsA9Zfv1X2fVEQhTw51lKENdNrEqT3,5,3,1,0,0,0,2,0,6,0.8571428571428571,2,0.0,0,1,0,0,3,0,0,2,0,1,5,0
5339,50526,SKzEklIJtB0H7qSb29ZCLXx6x8polS8t,G8EPVSXsOYB5YQWZGiz1aVq5Pgr2GrQu,28,30,18,42,3,2,11,3,109,15.571428571428571,3,0.0,6,18,35,3,24,2,7,11,3,62,47,1
5340,50527,Aa6HGi2BP5QmpgVAdMlhlYagK8En1mfR,SpATywNh6bZuzm8s1ceuBUnMUAeoAHHw,4,2,1,0,0,0,2,0,5,0.7142857142857143,1,0.0,0,1,0,0,2,0,0,2,0,1,4,1
5341,50553,Q4kMf3oUxyru1mGynxCyO5lsgz8RcH4I,SpATywNh6bZuzm8s1ceuBUnMUAeoAHHw,1,0,0,0,0,0,1,0,1,0.14285714285714285,1,0.0,0,0,0,0,0,0,0,1,0,0,1,1
5342,50557,Xg5Ot8iedBtydMlcszETASpB9uo3tFAr,SpATywNh6bZuzm8s1ceuBUnMUAeoAHHw,7,7,3,0,2,0,3,0,15,2.142857142857143,1,0.0,0,3,0,2,7,0,0,3,0,5,10,1
5343,50559,5cQUnUgkfNnsoqvndDYLsW5vGZdhNEqy,SpATywNh6bZuzm8s1ceuBUnMUAeoAHHw,6,7,4,0,3,0,2,0,16,2.2857142857142856,1,0.0,1,4,0,3,6,0,0,2,0,8,8,1
5344,50568,Ikx8dqw7N29O68oP7rbQGE7AGY4iLNon,SpATywNh6bZuzm8s1ceuBUnMUAeoAHHw,8,14,6,0,4,0,4,0,28,4.0,3,0.0,0,6,0,4,14,0,0,4,0,10,18,0
5345,50572,XIlz5QvnlEzidDqYGld3VSh8CaOyBXAa,RXDvfPUBYFlVdlueBFbLW0mhhAyGEqpt,19,22,13,0,10,0,12,0,57,8.142857142857142,5,0.0,1,13,0,10,21,0,0,12,0,24,33,1
5346,50609,THlX4ibtjGYQg6ZUfc8ItvnKMtOly4Xi,SpATywNh6bZuzm8s1ceuBUnMUAeoAHHw,34,57,27,0,14,1,15,0,114,16.285714285714285,7,0.0,0,27,0,14,57,1,0,15,0,41,73,0
5347,50616,U3HS4u1TmUUxbQhrTehko1MNIHz71lIC,SpATywNh6bZuzm8s1ceuBUnMUAeoAHHw,8,8,5,0,3,1,4,0,21,3.0,2,0.0,0,5,0,3,8,1,0,4,0,8,13,1
5348,50619,U0ut2RIK4RMVOoanuVtPF17vT9gKZVmq,A3fsA9Zfv1X2fVEQhTw51lKENdNrEqT3,8,5,3,0,1,0,3,0,12,1.7142857142857142,1,0.0,0,3,0,1,5,0,0,3,0,4,8,1
5349,50632,DeyP5lAVv1H3yXRPzbyis5xLngeggxpO,RXDvfPUBYFlVdlueBFbLW0mhhAyGEqpt,12,16,8,0,3,1,11,1,40,5.714285714285714,3,0.0,0,8,0,3,16,1,0,11,1,11,29,1
5350,50670,IDqUeKOsakXfpJsNR0qoC3jJJuHYmkPd,SpATywNh6bZuzm8s1ceuBUnMUAeoAHHw,16,93,33,0,0,16,20,3,165,23.571428571428573,5,0.0,20,33,0,0,73,16,0,20,3,53,112,0
5351,50690,IEkq5dNYNtGLgDWnMbZ6LuxRn59Xykyu,G8EPVSXsOYB5YQWZGiz1aVq5Pgr2GrQu,5,2,1,0,1,7,2,0,13,1.8571428571428572,1,0.0,0,1,0,1,2,7,0,2,0,2,11,1
5352,50692,BfoybeaeQZxTt069jPLA4qjwQgNZD97I,G8EPVSXsOYB5YQWZGiz1aVq5Pgr2GrQu,19,31,0,10,0,18,15,2,76,10.857142857142858,4,0.0,7,0,5,0,24,18,5,15,2,12,64,1
5353,50700,ZjAnj7LejyrDjdytaW8xiEftNjkACZgi,A3fsA9Zfv1X2fVEQhTw51lKENdNrEqT3,1,0,0,0,0,0,1,0,1,0.14285714285714285,1,0.0,0,0,0,0,0,0,0,1,0,0,1,1
5354,50703,AEOK3hwhmsMNDRL3o1uoaIUrWvSc7heg,SpATywNh6bZuzm8s1ceuBUnMUAeoAHHw,11,19,2,28,0,0,3,0,52,7.428571428571429,2,0.0,7,2,24,0,12,0,4,3,0,33,19,1
5355,50717,iVwNFnYcHwv8JroRNWkaHfHv9TTNdn1b,bWdj2GDclj5ofokWjzoa5jAwMkxCykd6,1,0,0,0,0,0,1,0,1,0.14285714285714285,1,0.0,0,0,0,0,0,0,0,1,0,0,1,1
5356,50730,nllK24cE3wNRvB4jmfti8fXlrXtFYAFv,bWdj2GDclj5ofokWjzoa5jAwMkxCykd6,5,2,1,0,1,0,2,0,6,0.8571428571428571,1,0.0,0,1,0,1,2,0,0,2,0,2,4,1
5357,50736,6EsKULTJVMq3E9IpeZllE0vOQuFiZwCm,SpATywNh6bZuzm8s1ceuBUnMUAeoAHHw,32,38,20,41,8,32,12,2,153,21.857142857142858,3,0.0,16,20,36,8,22,32,5,12,2,80,73,1
5358,50738,9va47BxxunDTlRdlZXe6vZY5WX0faoXZ,G8EPVSXsOYB5YQWZGiz1aVq5Pgr2GrQu,32,17,1,112,0,0,10,1,141,20.142857142857142,2,0.0,3,1,95,0,14,0,17,10,1,99,42,1
5359,50761,EttKeSyg9r0EcjglXuiRsuMNde5ZPNQV,A3fsA9Zfv1X2fVEQhTw51lKENdNrEqT3,5,3,2,0,0,0,2,0,7,1.0,1,0.0,0,2,0,0,3,0,0,2,0,2,5,1
5360,50776,kQmP7eUv8W6zmkJRQJGIL9eNv0mJSlzv,SpATywNh6bZuzm8s1ceuBUnMUAeoAHHw,7,8,2,0,2,0,1,0,13,1.8571428571428572,2,0.0,0,2,0,2,8,0,0,1,0,4,9,1
5361,50777,se9ZVl8DNkiCW8i2nP0p3krrUcQqYC47,bWdj2GDclj5ofokWjzoa5jAwMkxCykd6,32,57,35,128,22,5,18,2,267,38.142857142857146,9,0.0,11,35,122,22,46,5,6,18,2,190,77,0
5362,50789,3URMlJ8WFfbFx3SvBMPqUCA5oJqCky66,RXDvfPUBYFlVdlueBFbLW0mhhAyGEqpt,2,0,0,0,0,0,2,0,2,0.2857142857142857,2,0.0,0,0,0,0,0,0,0,2,0,0,2,1
5363,50792,oidXTGaCUuuF1QPNvhmiPoqhWsTY245r,bWdj2GDclj5ofokWjzoa5jAwMkxCykd6,15,29,8,0,5,5,5,0,52,7.428571428571429,3,0.0,0,8,0,5,29,5,0,5,0,13,39,0
5364,50795,c0bjMduOwhlaRS3h8xRhAhid9jTsLzPD,A3fsA9Zfv1X2fVEQhTw51lKENdNrEqT3,13,15,7,0,5,0,4,0,31,4.428571428571429,2,0.0,0,7,0,5,15,0,0,4,0,12,19,1
5365,50797,BWuaSpfjjWoQ6suviyDvOJ1XUJLgJBtc,SpATywNh6bZuzm8s1ceuBUnMUAeoAHHw,63,72,40,66,25,166,38,4,411,58.714285714285715,12,0.0,23,40,56,25,49,166,10,38,4,144,267,0
5366,50805,1HrXazG6mMhlQyrWzEYwtGHFWa0bXXko,SpATywNh6bZuzm8s1ceuBUnMUAeoAHHw,37,60,3,36,1,73,14,1,188,26.857142857142858,6,0.0,12,3,29,1,48,73,7,14,1,45,143,0
5367,50808,xm9wUIf1J8EjTNxXT4ffEWzhuySk21YK,RXDvfPUBYFlVdlueBFbLW0mhhAyGEqpt,47,96,45,110,50,2,13,1,317,45.285714285714285,9,0.0,14,45,102,50,82,2,8,13,1,211,106,0
5368,50813,h8n9HekAuyT08sLL5qmdMZ3BdSJVR4QF,5X6FeZozNMgE2VRi3MJYjkkFK8SETtu2,51,103,29,114,23,23,20,1,313,44.714285714285715,6,0.0,45,29,97,23,58,23,17,20,1,194,119,1
5369,50814,tOVeFZbpewRX07F0N4KV6g00WNGootzd,SpATywNh6bZuzm8s1ceuBUnMUAeoAHHw,2,0,0,0,0,0,3,0,3,0.42857142857142855,2,0.0,0,0,0,0,0,0,0,3,0,0,3,1
5370,50835,KH1qoBE3q99uPmQbxyBhuyXhrxNuFdJJ,A3fsA9Zfv1X2fVEQhTw51lKENdNrEqT3,1,0,0,0,0,0,2,0,2,0.2857142857142857,2,0.0,0,0,0,0,0,0,0,2,0,0,2,1
5371,50841,POGRFFRZzlPiBHiCHXnlCDCb459JTEzc,G8EPVSXsOYB5YQWZGiz1aVq5Pgr2GrQu,105,159,9,345,6,5,43,0,567,81.0,11,0.0,21,9,292,6,138,5,53,43,0,328,239,0
5372,50845,IbSlJreCWcsVrBSn5tZXMZ0WT6gAqUtU,5X6FeZozNMgE2VRi3MJYjkkFK8SETtu2,9,24,8,2,2,2,14,0,52,7.428571428571429,8,0.0,2,8,2,2,22,2,0,14,0,14,38,0
5373,50911,hUDYaJSmYdF2ZsjDDhiBi3bEoysqCLEu,5Gyp41oLVo7Gg7vF4vpmggWP5MU70QO6,11,20,9,2,3,0,3,0,37,5.285714285714286,1,0.0,4,9,1,3,16,0,1,3,0,17,20,1
5374,50945,6CncXwdTCC3PBs88iLEcFh0rzR16XLlT,5Gyp41oLVo7Gg7vF4vpmggWP5MU70QO6,1,0,0,0,0,0,2,0,2,0.2857142857142857,1,0.0,0,0,0,0,0,0,0,2,0,0,2,1
5375,50948,vJn8WpxPLI2ms7Nn48ZlxfL8JZRwXqcW,5Gyp41oLVo7Gg7vF4vpmggWP5MU70QO6,10,9,4,2,3,0,1,0,19,2.7142857142857144,1,0.0,3,4,1,3,6,0,1,1,0,11,8,1
5376,50963,BcJnhjzA1hw0WNze9uWUZQ49uBAiBHyH,5Gyp41oLVo7Gg7vF4vpmggWP5MU70QO6,5,2,1,0,1,0,3,0,7,1.0,2,0.0,0,1,0,1,2,0,0,3,0,2,5,1
5377,50970,sAF0rhnS6eTeFnLUiq2Li82i0HPzFiAf,5Gyp41oLVo7Gg7vF4vpmggWP5MU70QO6,26,112,58,56,18,19,26,4,293,41.857142857142854,5,0.0,39,58,32,18,73,19,24,26,4,147,146,1
5378,50985,GUOpxTQnQN8qFAqM8JSE4fCHAUkjbvvx,5Gyp41oLVo7Gg7vF4vpmggWP5MU70QO6,1,0,0,0,0,0,1,0,1,0.14285714285714285,1,0.0,0,0,0,0,0,0,0,1,0,0,1,1
5379,50989,CNJ2KRdKhIzMbOlxj2daOOkuq5TrQAeD,5Gyp41oLVo7Gg7vF4vpmggWP5MU70QO6,8,10,5,6,0,0,2,0,23,3.2857142857142856,2,0.0,4,5,3,0,6,0,3,2,0,12,11,1
5380,51015,yivRzsNns2AFCmmffardHKKzslL7w3NQ,5Gyp41oLVo7Gg7vF4vpmggWP5MU70QO6,11,13,8,4,4,0,3,0,32,4.571428571428571,3,0.0,1,8,2,4,12,0,2,3,0,15,17,1
5381,51023,8lRHXn9xfK8EXcc6tQhHvcH0giqpsudE,5Gyp41oLVo7Gg7vF4vpmggWP5MU70QO6,14,23,15,14,6,9,5,0,72,10.285714285714286,4,0.0,3,15,11,6,20,9,3,5,0,35,37,1
5382,51058,kQcHT9XjbeNVxuKuAz9nk02Q91AkSUCM,5Gyp41oLVo7Gg7vF4vpmggWP5MU70QO6,1,0,0,0,0,0,3,0,3,0.42857142857142855,1,0.0,0,0,0,0,0,0,0,3,0,0,3,1
5383,51062,xeper6lTTTduQkRnWSDeRoAUobRsjfTO,5Gyp41oLVo7Gg7vF4vpmggWP5MU70QO6,29,64,33,51,18,22,17,3,208,29.714285714285715,6,0.0,22,33,41,18,42,22,10,17,3,114,94,1
5384,51075,cSfkIN06kB0BuNVH3RsKbNNnQyc10IUt,5Gyp41oLVo7Gg7vF4vpmggWP5MU70QO6,35,65,32,20,19,37,25,2,200,28.571428571428573,9,0.0,15,32,13,19,50,37,7,25,2,79,121,0
5385,51096,Yrv9TCoIHfGWJRAoHLHbNeO6aiMpq9Rx,5Gyp41oLVo7Gg7vF4vpmggWP5MU70QO6,11,10,4,4,2,0,4,0,24,3.4285714285714284,3,0.0,1,4,2,2,9,0,2,4,0,9,15,1
5386,51135,jE34qxBejGRuNfhNRx8UVFZQqAMqmjmU,5Gyp41oLVo7Gg7vF4vpmggWP5MU70QO6,16,10,6,8,3,0,3,0,30,4.285714285714286,1,0.0,2,6,4,3,8,0,4,3,0,15,15,1
5387,51139,loP5euETO7r8DEDz3s6e4OL8qAADTSwG,5Gyp41oLVo7Gg7vF4vpmggWP5MU70QO6,10,15,7,0,4,0,6,0,32,4.571428571428571,5,0.0,0,7,0,4,15,0,0,6,0,11,21,1
5388,51159,t4iUOcn0QKxh1mWzwjgY3W5LnRpajtii,5Gyp41oLVo7Gg7vF4vpmggWP5MU70QO6,7,8,2,0,2,0,1,0,13,1.8571428571428572,1,0.0,1,2,0,2,7,0,0,1,0,5,8,1
5389,51164,V0DjG27Lu2GKv0f5ALnYugbRwr67Wu8f,5Gyp41oLVo7Gg7vF4vpmggWP5MU70QO6,5,2,0,0,0,0,3,0,5,0.7142857142857143,1,0.0,0,0,0,0,2,0,0,3,0,0,5,1
5390,51170,i67qzouvUD7nINgK6d1xrH4pvufZqbFd,5Gyp41oLVo7Gg7vF4vpmggWP5MU70QO6,39,156,78,46,41,72,26,11,430,61.42857142857143,7,0.0,54,78,37,41,102,72,9,26,11,210,220,0
5391,51179,8bMxud2pJnttNvsNwa7l9gc36Q1hRhIk,5Gyp41oLVo7Gg7vF4vpmggWP5MU70QO6,30,68,42,10,12,2,14,0,148,21.142857142857142,8,0.0,11,42,7,12,57,2,3,14,0,72,76,1
5392,51191,BveIxduzCtuwgGhSUEmYM6hBnFvwdvcp,5Gyp41oLVo7Gg7vF4vpmggWP5MU70QO6,1,0,0,0,0,0,1,0,1,0.14285714285714285,1,0.0,0,0,0,0,0,0,0,1,0,0,1,1
5393,51199,s4TNdVBVykBR8x72RZEnjBx6ebkwwW3k,5Gyp41oLVo7Gg7vF4vpmggWP5MU70QO6,29,33,20,18,9,7,19,6,112,16.0,7,0.0,4,20,11,9,29,7,7,19,6,44,68,1
5394,51225,dtbXtMjPqeEvzoZBFe2y9uSDcjL0lnx2,5Gyp41oLVo7Gg7vF4vpmggWP5MU70QO6,7,3,2,0,2,15,3,0,25,3.5714285714285716,2,0.0,0,2,0,2,3,15,0,3,0,4,21,1
5395,51231,IY3uQ1CpKmZTS6BFPIvXsM2Z8k2q4Ten,5Gyp41oLVo7Gg7vF4vpmggWP5MU70QO6,28,50,26,12,10,0,25,1,124,17.714285714285715,6,0.0,12,26,8,10,38,0,4,25,1,56,68,1
5396,51241,804HYV0yQ92rGjeWWFPgqhXRYq0Itqqm,5Gyp41oLVo7Gg7vF4vpmggWP5MU70QO6,28,77,48,24,24,113,22,1,309,44.142857142857146,9,0.0,11,48,17,24,66,113,7,22,1,100,209,1
5397,51247,Z4MXAD0JKMHJMDcQZ3bvrhAPRhP6Ylsj,5Gyp41oLVo7Gg7vF4vpmggWP5MU70QO6,29,59,15,35,13,21,16,1,160,22.857142857142858,7,0.0,19,15,25,13,40,21,10,16,1,72,88,1
5398,51264,R0yZQm01vPxwB1FHTvnE4ExR78BMpKhv,5Gyp41oLVo7Gg7vF4vpmggWP5MU70QO6,27,35,17,6,19,10,16,5,108,15.428571428571429,6,0.0,16,17,5,19,19,10,1,16,5,57,51,0
5399,51280,qBEmqvLVJKAtiuGEuUMlrWfek26BR553,5Gyp41oLVo7Gg7vF4vpmggWP5MU70QO6,6,3,2,0,1,0,2,0,8,1.1428571428571428,1,0.0,0,2,0,1,3,0,0,2,0,3,5,1
5400,51283,rYNkAKC3XVLpC4bzbGHzILPwRJzsAVQv,5Gyp41oLVo7Gg7vF4vpmggWP5MU70QO6,14,22,9,0,6,1,2,0,40,5.714285714285714,1,0.0,10,9,0,6,12,1,0,2,0,25,15,1
5401,51297,JQRXqEKqYgVt3yLRwyn6A8k5Glf2cOSO,5Gyp41oLVo7Gg7vF4vpmggWP5MU70QO6,3,2,1,0,0,0,2,0,5,0.7142857142857143,1,0.0,0,1,0,0,2,0,0,2,0,1,4,1
5402,51303,Al5ekOcwSYEmIj8FtIvMEyeKBOFRAwO4,5Gyp41oLVo7Gg7vF4vpmggWP5MU70QO6,18,27,15,6,1,3,9,3,64,9.142857142857142,2,0.0,4,15,3,1,23,3,3,9,3,23,41,1
5403,51337,l5LfU8gApOG72AnBkdAbfOLQLwFH7Zo2,5Gyp41oLVo7Gg7vF4vpmggWP5MU70QO6,32,91,33,7,12,23,21,1,188,26.857142857142858,10,0.0,25,33,6,12,66,23,1,21,1,76,112,0
5404,51348,SB5SpH3bmeO3Q4jhsGMmhdtd7LwNbsmt,5Gyp41oLVo7Gg7vF4vpmggWP5MU70QO6,32,48,21,6,22,3,18,12,130,18.571428571428573,4,0.0,19,21,4,22,29,3,2,18,12,66,64,1
5405,51364,bUqcs6NKKHUQx25s7Yo0TWpKwiOnMYKl,5Gyp41oLVo7Gg7vF4vpmggWP5MU70QO6,1,0,0,0,0,0,2,0,2,0.2857142857142857,2,0.0,0,0,0,0,0,0,0,2,0,0,2,1
5406,51365,zK6w0JPDDeUD403WVGuxpKSbry9d8uLr,5Gyp41oLVo7Gg7vF4vpmggWP5MU70QO6,11,15,9,8,4,0,7,0,43,6.142857142857143,1,0.0,4,9,4,4,11,0,4,7,0,21,22,1
5407,51378,Ha83qom95SRdPZQ3GDUlHj6Txt7HaICx,5Gyp41oLVo7Gg7vF4vpmggWP5MU70QO6,5,2,1,0,1,0,3,0,7,1.0,1,0.0,0,1,0,1,2,0,0,3,0,2,5,1
5408,51401,XEg540lTawnkyAL3QhiV5067z0uxHwgk,5Gyp41oLVo7Gg7vF4vpmggWP5MU70QO6,1,0,0,0,0,0,1,0,1,0.14285714285714285,1,0.0,0,0,0,0,0,0,0,1,0,0,1,1
5409,51431,JD10TEfuHqgtsX2PaJg1Dza8TadsNhie,5Gyp41oLVo7Gg7vF4vpmggWP5MU70QO6,8,3,1,0,1,2,9,1,17,2.4285714285714284,3,0.0,0,1,0,1,3,2,0,9,1,2,15,1
5410,51447,wFvodFqghxL7iISMFbYXkYNq6P6eK5gH,5Gyp41oLVo7Gg7vF4vpmggWP5MU70QO6,6,1,1,0,1,7,3,0,13,1.8571428571428572,1,0.0,0,1,0,1,1,7,0,3,0,2,11,1
5411,51463,1TEsUxQgDdO1TalOwwODqO4TXTErPqtQ,5Gyp41oLVo7Gg7vF4vpmggWP5MU70QO6,12,17,4,6,0,2,13,1,43,6.142857142857143,1,0.0,5,4,3,0,12,2,3,13,1,12,31,1
5412,51464,WICtlxmktG02cQ6UoORXrfE9LbHVpnYF,5Gyp41oLVo7Gg7vF4vpmggWP5MU70QO6,1,0,0,0,0,0,1,0,1,0.14285714285714285,1,0.0,0,0,0,0,0,0,0,1,0,0,1,1
5413,51481,BIBYBbrrZACu5lQBVU937ixjRuLu5I81,5Gyp41oLVo7Gg7vF4vpmggWP5MU70QO6,6,3,0,0,0,0,4,0,7,1.0,2,0.0,0,0,0,0,3,0,0,4,0,0,7,1
5414,51483,ASlnVt8E920lbgQCJxblWt3Bu4c4DX5a,5Gyp41oLVo7Gg7vF4vpmggWP5MU70QO6,40,116,5,34,23,34,16,3,231,33.0,6,0.0,25,5,22,23,91,34,12,16,3,75,156,1
5415,51485,LwxIbNwwwIqJzdDONFRGCSNSDsvCOPFx,5Gyp41oLVo7Gg7vF4vpmggWP5MU70QO6,1,0,0,0,0,0,4,0,4,0.5714285714285714,1,0.0,0,0,0,0,0,0,0,4,0,0,4,1
5416,51507,MBCX4v0rM9hS1aHMk7F9d197k8THGWLv,5Gyp41oLVo7Gg7vF4vpmggWP5MU70QO6,24,122,53,11,6,81,21,5,299,42.714285714285715,15,0.0,17,53,7,6,105,81,4,21,5,83,216,0
5417,51552,Dh8qbDxxlKjzZH8rNSVSz50NRROZa0p8,5Gyp41oLVo7Gg7vF4vpmggWP5MU70QO6,7,2,1,0,1,0,6,0,10,1.4285714285714286,1,0.0,0,1,0,1,2,0,0,6,0,2,8,1
5418,51563,WBvLVG145jdU2P71llhBJOxoT4IVQFra,5Gyp41oLVo7Gg7vF4vpmggWP5MU70QO6,15,18,10,6,8,0,4,0,46,6.571428571428571,3,0.0,5,10,3,8,13,0,3,4,0,26,20,1
5419,51570,tsY0YpxAz97OH8J3pGXuWuAcxzg4RYvp,5Gyp41oLVo7Gg7vF4vpmggWP5MU70QO6,14,20,12,0,6,5,9,1,53,7.571428571428571,3,0.0,2,12,0,6,18,5,0,9,1,20,33,0
5420,51575,t59eWzYbxh3bTemgPnwWvkINvX1koffX,5Gyp41oLVo7Gg7vF4vpmggWP5MU70QO6,5,2,1,0,1,0,2,0,6,0.8571428571428571,1,0.0,0,1,0,1,2,0,0,2,0,2,4,1
5421,51588,c7nNfpG3r5ECmvZLmI9s6iYaFduinQF4,5Gyp41oLVo7Gg7vF4vpmggWP5MU70QO6,4,2,1,0,0,0,3,0,6,0.8571428571428571,2,0.0,0,1,0,0,2,0,0,3,0,1,5,1
5422,51595,JrMAzfn8EtSTwcGXcaPgSvYimTCqdIMK,5Gyp41oLVo7Gg7vF4vpmggWP5MU70QO6,6,5,2,0,2,0,1,0,10,1.4285714285714286,1,0.0,0,2,0,2,5,0,0,1,0,4,6,1
5423,51608,xzsFQcCTOKCY5mCIPaCG8t4bl2I0FL3L,5Gyp41oLVo7Gg7vF4vpmggWP5MU70QO6,9,7,3,0,1,7,5,1,24,3.4285714285714284,1,0.0,1,3,0,1,6,7,0,5,1,5,19,1
5424,51610,iYmkUVGHT7OvfSsIIRGv9c31sCISp6uV,5Gyp41oLVo7Gg7vF4vpmggWP5MU70QO6,5,2,1,0,1,0,2,0,6,0.8571428571428571,1,0.0,0,1,0,1,2,0,0,2,0,2,4,0
5425,51617,KRYE8zUhXYbjeLaMR4yeJiqwVIzd4LUl,5Gyp41oLVo7Gg7vF4vpmggWP5MU70QO6,26,85,39,21,5,54,18,2,224,32.0,4,0.0,29,39,11,5,56,54,10,18,2,84,140,0
5426,51619,SOjjKY9wKGLuekw5UPAjpevRHzDodFcf,5Gyp41oLVo7Gg7vF4vpmggWP5MU70QO6,3,0,0,0,0,0,4,0,4,0.5714285714285714,1,0.0,0,0,0,0,0,0,0,4,0,0,4,1
5427,51635,z4RYoRdtpulrjADoXoIsZb2r7hfjRo9d,5Gyp41oLVo7Gg7vF4vpmggWP5MU70QO6,19,48,16,42,6,17,3,0,132,18.857142857142858,2,0.0,22,16,28,6,26,17,14,3,0,72,60,1
5428,51636,oALqCZLHWGwvVuLN82RIMqd1ng0ZjRuQ,5Gyp41oLVo7Gg7vF4vpmggWP5MU70QO6,1,0,0,0,0,0,1,0,1,0.14285714285714285,1,0.0,0,0,0,0,0,0,0,1,0,0,1,1
5429,51653,R2arBlVQ5DlnqBrwRZJfviZdapFQUxuy,5Gyp41oLVo7Gg7vF4vpmggWP5MU70QO6,58,76,45,50,19,7,23,1,221,31.571428571428573,7,0.0,18,45,41,19,58,7,9,23,1,123,98,0
5430,51655,bw9xs0TGdEwI3hCZrkWt8t3o1F7RfTQX,5Gyp41oLVo7Gg7vF4vpmggWP5MU70QO6,1,0,0,0,0,0,1,0,1,0.14285714285714285,1,0.0,0,0,0,0,0,0,0,1,0,0,1,1
5431,51680,tHPSGx00vsFzhzr0zwBlWWarqJT4wPHF,5Gyp41oLVo7Gg7vF4vpmggWP5MU70QO6,10,8,5,0,3,0,2,0,18,2.5714285714285716,2,0.0,1,5,0,3,7,0,0,2,0,9,9,0
5432,51687,CE7qhfQKtb3MqxeuQ8qallIgJXu1qxS5,5Gyp41oLVo7Gg7vF4vpmggWP5MU70QO6,31,110,51,23,9,9,29,4,235,33.57142857142857,5,0.0,33,51,14,9,77,9,9,29,4,107,128,0
5433,51690,qhmgArW8a15UOGQrFTosGi03wE1TjPeN,5Gyp41oLVo7Gg7vF4vpmggWP5MU70QO6,6,2,1,0,1,1,4,1,10,1.4285714285714286,1,0.0,0,1,0,1,2,1,0,4,1,2,8,1
5434,51696,ZKffl4afie5TLzJspqxShk1uv0QDfEMN,5Gyp41oLVo7Gg7vF4vpmggWP5MU70QO6,1,0,0,0,0,0,1,0,1,0.14285714285714285,1,0.0,0,0,0,0,0,0,0,1,0,0,1,1
5435,51701,KtWgTwHTBoytCTItyAbwHKJ3pGHpGdDv,5Gyp41oLVo7Gg7vF4vpmggWP5MU70QO6,1,0,0,0,0,0,1,0,1,0.14285714285714285,1,0.0,0,0,0,0,0,0,0,1,0,0,1,1
5436,51709,eT52ltjmGeDYs5FEiingSEPgC5EAV0W1,5Gyp41oLVo7Gg7vF4vpmggWP5MU70QO6,11,15,5,0,4,0,4,0,28,4.0,3,0.0,2,5,0,4,13,0,0,4,0,11,17,1
5437,51719,vQfYR3RaQe5bKTWc93Z7CoUzAprlVLbv,5Gyp41oLVo7Gg7vF4vpmggWP5MU70QO6,1,0,0,0,0,0,2,0,2,0.2857142857142857,1,0.0,0,0,0,0,0,0,0,2,0,0,2,1
5438,51732,mm4wmOvZtCSS235zGQ4M5AohuMrLoxAj,5Gyp41oLVo7Gg7vF4vpmggWP5MU70QO6,5,2,1,0,1,0,2,0,6,0.8571428571428571,1,0.0,0,1,0,1,2,0,0,2,0,2,4,1
5439,51746,0jee8jeDw5n1CCXRhYOv1ANBEod8h1JO,5Gyp41oLVo7Gg7vF4vpmggWP5MU70QO6,11,13,8,0,3,6,5,0,35,5.0,3,0.0,0,8,0,3,13,6,0,5,0,11,24,1
5440,51756,sJuxpvy6iaiEFXNqwOPDSCbQxADqSatT,5Gyp41oLVo7Gg7vF4vpmggWP5MU70QO6,1,0,0,0,0,0,1,0,1,0.14285714285714285,1,0.0,0,0,0,0,0,0,0,1,0,0,1,1
5441,51780,YGmG6QQHrFEaupwUrD4y2fAiDGnXz2Vs,5Gyp41oLVo7Gg7vF4vpmggWP5MU70QO6,1,0,0,0,0,0,1,0,1,0.14285714285714285,1,0.0,0,0,0,0,0,0,0,1,0,0,1,1
5442,51796,jGUi8ht5KI2NulUOHp46HFjGGsKi7cuc,5Gyp41oLVo7Gg7vF4vpmggWP5MU70QO6,2,0,0,0,0,0,3,0,3,0.42857142857142855,1,0.0,0,0,0,0,0,0,0,3,0,0,3,1
5443,51824,xP7v9orytxca6UvDQFsUNImEq7c1YiZx,5Gyp41oLVo7Gg7vF4vpmggWP5MU70QO6,6,5,1,0,1,0,2,0,9,1.2857142857142858,1,0.0,0,1,0,1,5,0,0,2,0,2,7,1
5444,51825,FwDLTPHw3sTAULAHFxRMaMOKv6yLFX98,5Gyp41oLVo7Gg7vF4vpmggWP5MU70QO6,10,18,5,0,5,0,3,0,31,4.428571428571429,2,0.0,6,5,0,5,12,0,0,3,0,16,15,1
5445,51842,RRTxLpGhKIvltZvSsiZiCAKYiNDjiP9o,5Gyp41oLVo7Gg7vF4vpmggWP5MU70QO6,7,3,2,0,2,0,4,0,11,1.5714285714285714,1,0.0,0,2,0,2,3,0,0,4,0,4,7,1
5446,51885,KKqDJFmpKUd46TAUE6OVnm7gnps6UeUh,5Gyp41oLVo7Gg7vF4vpmggWP5MU70QO6,3,0,0,0,0,0,3,0,3,0.42857142857142855,1,0.0,0,0,0,0,0,0,0,3,0,0,3,1
5447,51887,y8AR5gAVoLBSsXX35MG3ptBTsqGYN5fg,5Gyp41oLVo7Gg7vF4vpmggWP5MU70QO6,6,4,2,0,1,0,3,0,10,1.4285714285714286,1,0.0,0,2,0,1,4,0,0,3,0,3,7,1
5448,51893,cz1ypJ0fK6XmiNBNEoeA46wGs1VufYRf,5Gyp41oLVo7Gg7vF4vpmggWP5MU70QO6,34,98,45,26,23,11,24,3,230,32.857142857142854,5,0.0,36,45,19,23,62,11,7,24,3,123,107,0
5449,51939,C778ENtyLMJLc0Wf4WnEJMSgC28exMmB,5Gyp41oLVo7Gg7vF4vpmggWP5MU70QO6,7,3,2,0,2,0,2,0,9,1.2857142857142858,1,0.0,0,2,0,2,3,0,0,2,0,4,5,1
5450,51966,sGGFeAvfY7lj50ljXiEEQCcyf1h5u7M1,5Gyp41oLVo7Gg7vF4vpmggWP5MU70QO6,9,3,2,0,2,1,5,0,13,1.8571428571428572,1,0.0,0,2,0,2,3,1,0,5,0,4,9,1
5451,51967,qlyUkcKnt4n66zsFTiDZ1H8963znffup,5Gyp41oLVo7Gg7vF4vpmggWP5MU70QO6,1,0,0,0,0,0,1,0,1,0.14285714285714285,1,0.0,0,0,0,0,0,0,0,1,0,0,1,1
5452,51971,bnvm8fnzbQwJ3hRNatRWKMCkORAgyNkF,5Gyp41oLVo7Gg7vF4vpmggWP5MU70QO6,1,0,0,0,0,0,1,0,1,0.14285714285714285,1,0.0,0,0,0,0,0,0,0,1,0,0,1,1
5453,51972,GVGHFr4RjCkEsrUZViSIkcsds0jOH1hH,5Gyp41oLVo7Gg7vF4vpmggWP5MU70QO6,7,3,2,0,2,0,3,0,10,1.4285714285714286,1,0.0,0,2,0,2,3,0,0,3,0,4,6,1
5454,51991,nnwSZfxBmXfZyM59eV74xQk2yLHnc8D6,5Gyp41oLVo7Gg7vF4vpmggWP5MU70QO6,9,8,4,0,3,0,10,2,27,3.857142857142857,1,0.0,2,4,0,3,6,0,0,10,2,9,18,1
5455,51998,6ILZOIG4dpJv6KPosvpXbsZvViQf0aZY,5Gyp41oLVo7Gg7vF4vpmggWP5MU70QO6,1,0,0,0,0,0,1,0,1,0.14285714285714285,1,0.0,0,0,0,0,0,0,0,1,0,0,1,1
5456,52021,UHJFXK17Mvrp909DjyQXn9yqcVzGa7Hj,5Gyp41oLVo7Gg7vF4vpmggWP5MU70QO6,7,5,0,0,0,1,5,1,12,1.7142857142857142,1,0.0,0,0,0,0,5,1,0,5,1,0,12,1
5457,52038,4qIg4pAFpp96AXD2D6RAw2hm8PdGEDpT,5Gyp41oLVo7Gg7vF4vpmggWP5MU70QO6,6,4,1,0,1,0,2,0,8,1.1428571428571428,1,0.0,1,1,0,1,3,0,0,2,0,3,5,1
5458,52047,OnOMADnoNlvN8uVDeVdkjVcjflUdOJKt,5Gyp41oLVo7Gg7vF4vpmggWP5MU70QO6,19,18,7,25,3,0,5,0,58,8.285714285714286,2,0.0,6,7,16,3,12,0,9,5,0,32,26,1
5459,52052,lCGdbW0cq7tu4XgxScfvnDqPzb9JWjM7,5Gyp41oLVo7Gg7vF4vpmggWP5MU70QO6,3,0,0,0,0,0,5,0,5,0.7142857142857143,1,0.0,0,0,0,0,0,0,0,5,0,0,5,1
5460,52067,h7GuboD0ogzGTRqA8dPK90cUumzFsK9u,5Gyp41oLVo7Gg7vF4vpmggWP5MU70QO6,21,27,18,0,11,4,14,0,74,10.571428571428571,5,0.0,3,18,0,11,24,4,0,14,0,32,42,0
5461,52076,QwDettOM8dkwfhtLDwjHbqNUBLBlvPgu,5Gyp41oLVo7Gg7vF4vpmggWP5MU70QO6,11,6,3,0,2,0,5,0,16,2.2857142857142856,2,0.0,0,3,0,2,6,0,0,5,0,5,11,1
5462,52100,VPk4dvtGVkwqbTK9Y9Lrl8Tc3tyEBG7T,5Gyp41oLVo7Gg7vF4vpmggWP5MU70QO6,7,3,2,0,2,0,4,0,11,1.5714285714285714,1,0.0,0,2,0,2,3,0,0,4,0,4,7,1
5463,52138,tsIR2X1ddx5J3izAnImyG9xtupxwxgvv,5Gyp41oLVo7Gg7vF4vpmggWP5MU70QO6,1,0,0,0,0,0,1,0,1,0.14285714285714285,1,0.0,0,0,0,0,0,0,0,1,0,0,1,1
5464,52174,AhqSKxTzIQmvTa7Ncgq37ghFvQ8E1x83,5Gyp41oLVo7Gg7vF4vpmggWP5MU70QO6,8,4,2,0,1,0,10,0,17,2.4285714285714284,1,0.0,1,2,0,1,3,0,0,10,0,4,13,1
5465,52181,6tsK9lf3Seuaf0VSJ30JlPvB4lC5ECMz,5Gyp41oLVo7Gg7vF4vpmggWP5MU70QO6,6,3,1,0,1,0,2,0,7,1.0,1,0.0,0,1,0,1,3,0,0,2,0,2,5,1
5466,52186,CaCsA24Zvpna6ppXx7IuajFHe1iCGRrY,5Gyp41oLVo7Gg7vF4vpmggWP5MU70QO6,5,2,1,0,1,0,2,0,6,0.8571428571428571,1,0.0,0,1,0,1,2,0,0,2,0,2,4,1
5467,52210,scWdlOX3zv7Fw3w52tIrAiCVFn7qfyE0,5Gyp41oLVo7Gg7vF4vpmggWP5MU70QO6,8,4,2,0,2,0,2,0,10,1.4285714285714286,1,0.0,0,2,0,2,4,0,0,2,0,4,6,1
5468,52212,bz1tRAMyCJEZwR74NHea7IOrvcPFJI9o,5Gyp41oLVo7Gg7vF4vpmggWP5MU70QO6,1,0,0,0,0,0,1,0,1,0.14285714285714285,1,0.0,0,0,0,0,0,0,0,1,0,0,1,1
5469,52214,vOFpGbtS5cmjsTXlpKnczAYZvMiym3uV,5Gyp41oLVo7Gg7vF4vpmggWP5MU70QO6,7,3,2,0,2,0,2,0,9,1.2857142857142858,1,0.0,0,2,0,2,3,0,0,2,0,4,5,1
5470,52232,CiXNbYt4GI9npcqJXruK5iMBItV0IGgQ,5Gyp41oLVo7Gg7vF4vpmggWP5MU70QO6,16,26,15,4,6,12,9,0,72,10.285714285714286,5,0.0,2,15,2,6,24,12,2,9,0,25,47,0
5471,52238,6z9bkvAoRaGkuTSa2Ol35EzTHCRsbaKG,5Gyp41oLVo7Gg7vF4vpmggWP5MU70QO6,8,4,3,0,2,0,2,0,11,1.5714285714285714,1,0.0,0,3,0,2,4,0,0,2,0,5,6,1
5472,52246,DpKgvVGd2cJhveb5QdA2tBFVVettqcea,5Gyp41oLVo7Gg7vF4vpmggWP5MU70QO6,6,1,1,0,1,0,3,0,6,0.8571428571428571,1,0.0,0,1,0,1,1,0,0,3,0,2,4,1
5473,52252,ctWJAc5jN66ZRvfBzORGZ2QsqSBM7NJQ,5Gyp41oLVo7Gg7vF4vpmggWP5MU70QO6,2,0,0,0,0,0,2,0,2,0.2857142857142857,1,0.0,0,0,0,0,0,0,0,2,0,0,2,1
5474,52270,MWQlXDJXiker9jzrCCcTEUygIxBWwEe6,5Gyp41oLVo7Gg7vF4vpmggWP5MU70QO6,8,6,4,0,1,0,2,0,13,1.8571428571428572,1,0.0,1,4,0,1,5,0,0,2,0,6,7,1
5475,52272,H0XidwLIsZmWdbCPTFd0bRXdOyGgqqjF,5Gyp41oLVo7Gg7vF4vpmggWP5MU70QO6,2,0,0,0,0,0,4,0,4,0.5714285714285714,3,0.0,0,0,0,0,0,0,0,4,0,0,4,1
5476,52282,oE5sOqI6QsSiA4HdV0v7PWhXjJnY6a47,5Gyp41oLVo7Gg7vF4vpmggWP5MU70QO6,13,16,7,0,1,0,6,0,30,4.285714285714286,2,0.0,6,7,0,1,10,0,0,6,0,14,16,1
5477,52296,RXW97rF0SgW8w5XHhhECCGtvnyiOME4R,5Gyp41oLVo7Gg7vF4vpmggWP5MU70QO6,1,0,0,0,0,0,1,0,1,0.14285714285714285,1,0.0,0,0,0,0,0,0,0,1,0,0,1,1
5478,52305,1Bqfr0hSvH0b41V7S9Rm62rKp4rBDCIO,5Gyp41oLVo7Gg7vF4vpmggWP5MU70QO6,6,3,2,0,1,0,2,0,8,1.1428571428571428,1,0.0,0,2,0,1,3,0,0,2,0,3,5,1
5479,52314,Cb486oaNLCTCEGy9CoTKTUCP9RSvOUoH,5Gyp41oLVo7Gg7vF4vpmggWP5MU70QO6,1,0,0,0,0,0,1,0,1,0.14285714285714285,1,0.0,0,0,0,0,0,0,0,1,0,0,1,1
5480,52338,jGI6ToXYaFr5QpNlhLH2eKWZo5DWdaYD,5Gyp41oLVo7Gg7vF4vpmggWP5MU70QO6,4,7,0,0,0,0,3,0,10,1.4285714285714286,1,0.0,0,0,0,0,7,0,0,3,0,0,10,1
5481,52351,pXZnov33LQzlL1ag3wLXD0iMfUMXESwJ,5Gyp41oLVo7Gg7vF4vpmggWP5MU70QO6,15,24,17,5,9,5,17,1,78,11.142857142857142,4,0.0,6,17,3,9,18,5,2,17,1,35,43,1
5482,52358,rOCB1NPitCjPvv1ez8qWo625TnbV6Fbm,5Gyp41oLVo7Gg7vF4vpmggWP5MU70QO6,3,0,0,0,0,1,2,1,4,0.5714285714285714,1,0.0,0,0,0,0,0,1,0,2,1,0,4,1
5483,52370,3Gs0bXFvc4LLI7AfCF4oB5yzN9Yklpk0,5Gyp41oLVo7Gg7vF4vpmggWP5MU70QO6,10,14,6,0,2,0,5,0,27,3.857142857142857,4,0.0,1,6,0,2,13,0,0,5,0,9,18,1
5484,52374,xFoT6chNWPO8NhaVQB7bIHvYsC8ybg4Z,5Gyp41oLVo7Gg7vF4vpmggWP5MU70QO6,1,0,0,0,0,0,1,0,1,0.14285714285714285,1,0.0,0,0,0,0,0,0,0,1,0,0,1,1
5485,52387,aQ9CnnuCAIRGqHmWnpfeBTUlxegnsP3q,5Gyp41oLVo7Gg7vF4vpmggWP5MU70QO6,13,19,5,0,4,4,16,2,50,7.142857142857143,4,0.0,7,5,0,4,12,4,0,16,2,16,34,0
5486,52388,hdmv0McMoVHMLLrHqFYCXO6Pxxwgsh7q,5Gyp41oLVo7Gg7vF4vpmggWP5MU70QO6,6,3,1,0,2,0,1,0,7,1.0,1,0.0,0,1,0,2,3,0,0,1,0,3,4,1
5487,52389,FKe53Gv2w1Zwg0Iba7RZZwJM9Y2eERSG,5Gyp41oLVo7Gg7vF4vpmggWP5MU70QO6,12,23,7,13,7,0,2,0,52,7.428571428571429,1,0.0,8,7,10,7,15,0,3,2,0,32,20,1
5488,52398,Q0PzQpnPe8SOmoovDUUa2g54jTcYAO1Q,5Gyp41oLVo7Gg7vF4vpmggWP5MU70QO6,9,4,1,0,2,0,4,1,12,1.7142857142857142,1,0.0,0,1,0,2,4,0,0,4,1,3,9,1
5489,52405,XydvMA0BgL1Al10q3L0D2wz1Y6wVb2rC,5X6FeZozNMgE2VRi3MJYjkkFK8SETtu2,54,70,29,0,57,2,7,0,165,23.571428571428573,4,0.0,35,29,0,57,35,2,0,7,0,121,44,1
5490,52414,LwOwoJdIBH6qSphf2Y21IIrVgEcOPNno,7GRhBDsirIGkRZBtSMEzNTyDr2JQm4xx,8,4,1,0,0,3,11,0,19,2.7142857142857144,1,0.0,0,1,0,0,4,3,0,11,0,1,18,1
5491,52418,AWLXkSqW4e7SbhduVpZ7fOXghxuuP6q1,7GRhBDsirIGkRZBtSMEzNTyDr2JQm4xx,38,48,17,54,17,1,10,0,147,21.0,3,0.0,27,17,47,17,21,1,7,10,0,108,39,1
5492,52525,7tM0glf5iOjFrrOx11jEjeXPWGg1qnPf,7GRhBDsirIGkRZBtSMEzNTyDr2JQm4xx,27,57,20,125,9,7,13,0,231,33.0,4,0.0,24,20,124,9,33,7,1,13,0,177,54,1
5493,52527,3EXQpH44dmXe1KuNCn9IRB8zLxVzdC0Z,7GRhBDsirIGkRZBtSMEzNTyDr2JQm4xx,4,2,0,0,0,0,2,0,4,0.5714285714285714,2,0.0,0,0,0,0,2,0,0,2,0,0,4,1
5494,52564,KFkM2LdM6U7FLDyErp7vnT4e1T4YjeOt,7GRhBDsirIGkRZBtSMEzNTyDr2JQm4xx,1,0,0,0,0,0,1,0,1,0.14285714285714285,1,0.0,0,0,0,0,0,0,0,1,0,0,1,1
5495,52609,pf5bjcn02zW6F9NEdRWcVWa4U5P6G0ff,7GRhBDsirIGkRZBtSMEzNTyDr2JQm4xx,16,11,1,24,0,0,3,0,39,5.571428571428571,2,0.0,0,1,21,0,11,0,3,3,0,22,17,1
5496,52627,EbKjJZq8GOECUxJBvCCbIZN8O8RweU4z,5X6FeZozNMgE2VRi3MJYjkkFK8SETtu2,11,18,6,0,14,0,2,0,40,5.714285714285714,2,0.0,10,6,0,14,8,0,0,2,0,30,10,1
5497,52629,N1ze97FAwTuBZx89GGh4oyy7kZndQ2aO,7GRhBDsirIGkRZBtSMEzNTyDr2JQm4xx,1,0,0,0,0,0,1,0,1,0.14285714285714285,1,0.0,0,0,0,0,0,0,0,1,0,0,1,1
5498,52648,PCT9UecTLFgHQMLESQLM3zo2VKyldhOq,7GRhBDsirIGkRZBtSMEzNTyDr2JQm4xx,58,145,6,182,17,29,16,2,397,56.714285714285715,7,0.0,80,6,162,17,65,29,20,16,2,265,132,0
5499,52668,ub9oOCoL9cGnQSH3zubxNnnsblJY03jm,5X6FeZozNMgE2VRi3MJYjkkFK8SETtu2,5,2,1,0,1,0,2,0,6,0.8571428571428571,1,0.0,0,1,0,1,2,0,0,2,0,2,4,1
5500,52688,0Pyw7HKEB2SM2jK3ml9nk8ciHo5seMMx,5X6FeZozNMgE2VRi3MJYjkkFK8SETtu2,9,7,3,0,2,1,6,1,20,2.857142857142857,1,0.0,0,3,0,2,7,1,0,6,1,5,15,0
5501,52705,Z7RrJYLLbvUuUiPg9CWslVocwxBTUDWy,5X6FeZozNMgE2VRi3MJYjkkFK8SETtu2,1,0,0,0,0,0,1,0,1,0.14285714285714285,1,0.0,0,0,0,0,0,0,0,1,0,0,1,1
5502,52708,qZCURwy8JtTyuwzOv8VNGZdlPKRFUQ4x,7GRhBDsirIGkRZBtSMEzNTyDr2JQm4xx,6,4,1,0,1,2,8,0,16,2.2857142857142856,2,0.0,0,1,0,1,4,2,0,8,0,2,14,1
5503,52730,8XaoEwTyWeXdGPkk69feFC4MnARlyEPY,7GRhBDsirIGkRZBtSMEzNTyDr2JQm4xx,91,139,9,98,23,13,26,2,310,44.285714285714285,5,0.0,85,9,95,23,54,13,3,26,2,212,98,0
5504,52749,2E5IBJ0dkMcN4wshO47gaNDhROz8v0SJ,5X6FeZozNMgE2VRi3MJYjkkFK8SETtu2,43,40,12,80,20,0,1,0,153,21.857142857142858,1,0.0,26,12,74,20,14,0,6,1,0,132,21,1
5505,52753,SwHZgUxPjIeMthkMeeVpPfNadNOmRqaT,7GRhBDsirIGkRZBtSMEzNTyDr2JQm4xx,9,3,2,0,3,0,2,0,10,1.4285714285714286,1,0.0,0,2,0,3,3,0,0,2,0,5,5,1
5506,52756,hyGNNqxhAyFxbHW9ng6YRyMeUCWAgj0x,5X6FeZozNMgE2VRi3MJYjkkFK8SETtu2,4,2,1,0,1,0,1,0,5,0.7142857142857143,1,0.0,0,1,0,1,2,0,0,1,0,2,3,1
5507,52762,yoBRTcR2cnNdwxBl8X3b5dAnEe5pLM8o,7GRhBDsirIGkRZBtSMEzNTyDr2JQm4xx,27,59,15,24,16,0,3,0,117,16.714285714285715,1,0.0,22,15,21,16,37,0,3,3,0,74,43,1
5508,52767,oegjA7ZBrBlZ5Cd9WyrHTpKnm4129pWq,7GRhBDsirIGkRZBtSMEzNTyDr2JQm4xx,3,3,1,0,0,0,1,0,5,0.7142857142857143,1,0.0,0,1,0,0,3,0,0,1,0,1,4,0
5509,52771,0mg5UfmflBvw9f6RP57AlBJRO9poj3Bs,5X6FeZozNMgE2VRi3MJYjkkFK8SETtu2,19,21,14,26,9,0,5,0,75,10.714285714285714,2,0.0,2,14,21,9,19,0,5,5,0,46,29,1
5510,52794,ZI5bmLXRjGY30yDOOtLk3SjipijnEDdH,7GRhBDsirIGkRZBtSMEzNTyDr2JQm4xx,40,114,35,60,19,2,11,0,241,34.42857142857143,4,0.0,44,35,50,19,70,2,10,11,0,148,93,1
5511,52796,5PAJAhGm6mrmRya9bVA0TVEjvyxWSpHH,7GRhBDsirIGkRZBtSMEzNTyDr2JQm4xx,1,0,0,0,0,0,1,0,1,0.14285714285714285,1,0.0,0,0,0,0,0,0,0,1,0,0,1,1
5512,52797,JIMEFE3LdWAEpCV2LFwTCYSPjTS7eSnb,7GRhBDsirIGkRZBtSMEzNTyDr2JQm4xx,1,0,0,0,0,0,2,0,2,0.2857142857142857,1,0.0,0,0,0,0,0,0,0,2,0,0,2,1
5513,52822,kXa3f0Vj2v6uxMPIg14PPBVn8OhOZ096,7GRhBDsirIGkRZBtSMEzNTyDr2JQm4xx,2,0,0,0,0,0,2,0,2,0.2857142857142857,1,0.0,0,0,0,0,0,0,0,2,0,0,2,1
5514,52863,3AQcLF4401vlSQmnRaDEtc72D2nXEfx6,7GRhBDsirIGkRZBtSMEzNTyDr2JQm4xx,3,0,0,0,0,0,4,0,4,0.5714285714285714,2,0.0,0,0,0,0,0,0,0,4,0,0,4,1
5515,52876,YLANZPJHmSiI5Lb9P4F0Gshaw8Xy809b,5X6FeZozNMgE2VRi3MJYjkkFK8SETtu2,2,0,0,0,0,0,2,0,2,0.2857142857142857,1,0.0,0,0,0,0,0,0,0,2,0,0,2,1
5516,52886,tuClSbz7p6HhpkAOyf6VUIvd6ariEHmb,5X6FeZozNMgE2VRi3MJYjkkFK8SETtu2,1,0,0,0,0,0,1,0,1,0.14285714285714285,1,0.0,0,0,0,0,0,0,0,1,0,0,1,0
5517,52938,fhjtgu2LR6DQ0FWqUyl3qWg718eD1pm8,5X6FeZozNMgE2VRi3MJYjkkFK8SETtu2,6,5,0,0,0,0,5,0,10,1.4285714285714286,1,0.0,0,0,0,0,5,0,0,5,0,0,10,1
5518,52950,fWZgP0XbRPXR1W1wGS4xEWSR9s0TsZDO,5X6FeZozNMgE2VRi3MJYjkkFK8SETtu2,1,0,0,0,0,0,1,0,1,0.14285714285714285,1,0.0,0,0,0,0,0,0,0,1,0,0,1,1
5519,52951,ZFZTZbiKHOXenp1TWxEkC4SRLbwYuUkm,7GRhBDsirIGkRZBtSMEzNTyDr2JQm4xx,2,0,0,0,0,0,2,0,2,0.2857142857142857,1,0.0,0,0,0,0,0,0,0,2,0,0,2,1
5520,52952,MfF2UM103u4NW6P3ppuUwg5ByBUcnBZA,7GRhBDsirIGkRZBtSMEzNTyDr2JQm4xx,11,14,7,0,6,0,3,0,30,4.285714285714286,2,0.0,0,7,0,6,14,0,0,3,0,13,17,1
5521,52954,9Jy1wR1kNKfVIlzkWjf6DnrfYfDGnPzT,5X6FeZozNMgE2VRi3MJYjkkFK8SETtu2,9,17,7,0,2,0,8,0,34,4.857142857142857,3,0.0,4,7,0,2,13,0,0,8,0,13,21,1
5522,52969,Qfd5NSQMshaz9tIWhiDXjUxqfga3DDZq,5X6FeZozNMgE2VRi3MJYjkkFK8SETtu2,20,15,2,1,1,0,2,0,21,3.0,1,0.0,0,2,1,1,15,0,0,2,0,4,17,1
5523,52976,IiVkIz2ymD5LAyFMLUAoz4dlLCufsOLN,7GRhBDsirIGkRZBtSMEzNTyDr2JQm4xx,1,0,0,0,0,0,1,0,1,0.14285714285714285,1,0.0,0,0,0,0,0,0,0,1,0,0,1,0
5524,52994,KogrHROquIJLSXIZqzhYU9Hcb9zVebwT,7GRhBDsirIGkRZBtSMEzNTyDr2JQm4xx,18,25,4,24,7,0,1,0,61,8.714285714285714,1,0.0,10,4,22,7,15,0,2,1,0,43,18,1
5525,53007,0d9QTHxHI38QwsI8Nrfe3h4nIFkKB9wm,7GRhBDsirIGkRZBtSMEzNTyDr2JQm4xx,67,112,40,114,28,10,6,0,310,44.285714285714285,6,0.0,44,40,100,28,68,10,14,6,0,212,98,0
5526,53011,GZZNq061lXwXR7WgklaRbZ8ItW5pxFQW,5X6FeZozNMgE2VRi3MJYjkkFK8SETtu2,2,0,0,0,0,0,2,0,2,0.2857142857142857,1,0.0,0,0,0,0,0,0,0,2,0,0,2,1
5527,53015,zKm7XBlAnX1kvqmnbBunuJ0zgW910NPD,7GRhBDsirIGkRZBtSMEzNTyDr2JQm4xx,2,0,0,0,0,0,2,0,2,0.2857142857142857,1,0.0,0,0,0,0,0,0,0,2,0,0,2,1
5528,53022,fpL49L4pRoYIOyXEEhNfWE8QrqJt2aKb,5X6FeZozNMgE2VRi3MJYjkkFK8SETtu2,4,2,0,0,0,0,2,0,4,0.5714285714285714,1,0.0,0,0,0,0,2,0,0,2,0,0,4,1
5529,53030,KR1JBNTPMvAMQwZ6jsgCry7qScNUELlI,7GRhBDsirIGkRZBtSMEzNTyDr2JQm4xx,1,0,0,0,0,0,1,0,1,0.14285714285714285,1,0.0,0,0,0,0,0,0,0,1,0,0,1,1
5530,53034,TCECwaNYQUDA9PVYFYURPe0mJR7V4JvI,SpATywNh6bZuzm8s1ceuBUnMUAeoAHHw,5,2,1,0,1,0,3,0,7,1.0,2,0.0,0,1,0,1,2,0,0,3,0,2,5,0
5531,53041,FW02PfU8vx3pzmS7oOXpJualmcvfngs4,SpATywNh6bZuzm8s1ceuBUnMUAeoAHHw,25,106,3,27,3,0,20,0,159,22.714285714285715,7,0.0,34,3,23,3,72,0,4,20,0,63,96,0
5532,53043,4LLdV2zTWS697dAsOgAPJZPFwfNnrjt6,SpATywNh6bZuzm8s1ceuBUnMUAeoAHHw,33,37,28,4,18,2,10,0,99,14.142857142857142,7,0.0,2,28,4,18,35,2,0,10,0,52,47,0
5533,53050,dy8SjTNGjfrg38FBIbengGqlbDgTOAri,bWdj2GDclj5ofokWjzoa5jAwMkxCykd6,7,3,2,0,2,0,2,0,9,1.2857142857142858,1,0.0,0,2,0,2,3,0,0,2,0,4,5,1
5534,53055,1EHzEIUJa67W0jqPggV7KDaLGgi5Qkxp,SpATywNh6bZuzm8s1ceuBUnMUAeoAHHw,22,25,12,11,8,1,4,0,61,8.714285714285714,3,0.0,8,12,11,8,17,1,0,4,0,39,22,1
5535,53074,vwFaMtviPYvvdeDxiexQOh059O9Yefj1,SpATywNh6bZuzm8s1ceuBUnMUAeoAHHw,24,99,11,0,12,1,15,2,140,20.0,8,0.0,6,11,0,12,93,1,0,15,2,29,111,1
5536,53087,Bos3zEEnAcYzPXQktMkJJ0ak5mhGWCAf,A3fsA9Zfv1X2fVEQhTw51lKENdNrEqT3,67,42,20,104,13,0,6,0,185,26.428571428571427,3,0.0,4,20,103,13,38,0,1,6,0,140,45,1
5537,53099,l5zm2dyq1Lp4ch4ILKl8mqNj892nMhsW,A3fsA9Zfv1X2fVEQhTw51lKENdNrEqT3,45,36,25,72,10,6,23,2,174,24.857142857142858,4,0.0,1,25,55,10,35,6,17,23,2,91,83,1
5538,53104,f3SUvLtMnVyEZPEDJVhRMSC5cEFasHSH,G8EPVSXsOYB5YQWZGiz1aVq5Pgr2GrQu,14,19,12,2,5,1,8,1,48,6.857142857142857,4,0.0,5,12,1,5,14,1,1,8,1,23,25,1
5539,53109,fFw6uRnMpWU4RqpwQO2WZ8GCAi6hyn9t,SpATywNh6bZuzm8s1ceuBUnMUAeoAHHw,31,39,19,31,12,5,20,1,127,18.142857142857142,6,0.0,7,19,27,12,32,5,4,20,1,65,62,0
5540,53110,ovvuiEhj0QBv4xi11GVjXr8JhlCgaPmd,bWdj2GDclj5ofokWjzoa5jAwMkxCykd6,38,50,21,288,8,17,34,0,418,59.714285714285715,5,0.0,16,21,264,8,34,17,24,34,0,309,109,0
5541,53122,OOC2fhf6AkZDpDsl3NCh3irgmTTqQt8y,G8EPVSXsOYB5YQWZGiz1aVq5Pgr2GrQu,3,0,0,0,0,1,2,0,3,0.42857142857142855,1,0.0,0,0,0,0,0,1,0,2,0,0,3,1
5542,53138,SSeq3zqfD5kMUB9gUKp0rdzGfihYMJi7,A3fsA9Zfv1X2fVEQhTw51lKENdNrEqT3,1,0,0,0,0,0,1,0,1,0.14285714285714285,1,0.0,0,0,0,0,0,0,0,1,0,0,1,1
5543,53142,AjsS25Vcjgm2GGcNjE7GPEmmTU7snmJA,SpATywNh6bZuzm8s1ceuBUnMUAeoAHHw,24,43,16,30,9,7,9,1,115,16.428571428571427,4,0.0,19,16,28,9,24,7,2,9,1,72,43,0
5544,53149,fkwxmynqKl1E9zGnE59tFxhsiBODuFhR,SpATywNh6bZuzm8s1ceuBUnMUAeoAHHw,6,3,1,0,1,0,2,0,7,1.0,1,0.0,0,1,0,1,3,0,0,2,0,2,5,1
5545,53157,H8hoxOy1VDjrCqtl8Y1RjEzCSImzfPb1,SpATywNh6bZuzm8s1ceuBUnMUAeoAHHw,34,41,18,34,10,15,10,5,133,19.0,5,0.0,15,18,29,10,26,15,5,10,5,72,61,1
5546,53160,PPZEwof9f8rZx0lcTpURHpbkLB2YY5hH,A3fsA9Zfv1X2fVEQhTw51lKENdNrEqT3,8,7,4,0,2,0,8,0,21,3.0,3,0.0,0,4,0,2,7,0,0,8,0,6,15,1
5547,53162,4nHfdAZtp0niyFyrjm2L6LhTVPrJBlZM,A3fsA9Zfv1X2fVEQhTw51lKENdNrEqT3,139,114,59,264,33,9,55,2,536,76.57142857142857,14,0.0,12,59,237,33,102,9,27,55,2,341,195,1
5548,53178,kgME9COu6f9ljQ8FhJeUQLVyeGDbkeLG,SpATywNh6bZuzm8s1ceuBUnMUAeoAHHw,15,15,1,24,0,0,4,0,44,6.285714285714286,2,0.0,6,1,21,0,9,0,3,4,0,28,16,1
5549,53190,cWykzNKAq5sFQBA059QN4Jx74YGPkfwB,SpATywNh6bZuzm8s1ceuBUnMUAeoAHHw,21,36,0,38,0,0,9,0,83,11.857142857142858,4,0.0,8,0,36,0,28,0,2,9,0,44,39,0
5550,53199,RfxrjGWEyzBCwnQEmvcmVh3DEMcbhg4m,bWdj2GDclj5ofokWjzoa5jAwMkxCykd6,11,15,11,0,10,0,4,0,40,5.714285714285714,4,0.0,0,11,0,10,15,0,0,4,0,21,19,1
5551,53220,5TX7mZmksEi56P8MasqobWPGE5NBw2IQ,A3fsA9Zfv1X2fVEQhTw51lKENdNrEqT3,10,8,7,0,6,0,2,0,23,3.2857142857142856,1,0.0,0,7,0,6,8,0,0,2,0,13,10,1
5552,53233,nOWqKetxGFQ9o73UNfcoh0XyCt3ITawR,SpATywNh6bZuzm8s1ceuBUnMUAeoAHHw,27,56,20,28,8,0,11,0,123,17.571428571428573,8,0.0,14,20,25,8,42,0,3,11,0,67,56,0
5553,53242,XHTKaBKRPxCmq5MPcwRRZlQAa68hU6KT,RXDvfPUBYFlVdlueBFbLW0mhhAyGEqpt,15,7,3,31,2,1,3,0,47,6.714285714285714,1,0.0,3,3,28,2,4,1,3,3,0,36,11,1
5554,53244,cW2Xkl8EMUT4ygDkm6LqHv4BqvkNTIWA,SpATywNh6bZuzm8s1ceuBUnMUAeoAHHw,9,3,2,0,2,1,5,0,13,1.8571428571428572,1,0.0,0,2,0,2,3,1,0,5,0,4,9,1
5555,53245,2Bc3e8bWl6DTvfTPBZCyShFFG8OApkva,G8EPVSXsOYB5YQWZGiz1aVq5Pgr2GrQu,24,53,20,20,12,23,7,0,135,19.285714285714285,5,0.0,15,20,15,12,38,23,5,7,0,62,73,1
5556,53253,nsNOT1cU6IuLaV7JjnTNsqpFb1YDxqEb,SpATywNh6bZuzm8s1ceuBUnMUAeoAHHw,41,119,54,38,3,93,43,15,365,52.142857142857146,16,0.0,29,54,34,3,90,93,4,43,15,120,245,0
5557,53264,cWykzNKAq5sFQBA059QN4Jx74YGPkfwB,bWdj2GDclj5ofokWjzoa5jAwMkxCykd6,7,10,1,0,1,0,4,0,16,2.2857142857142856,3,0.0,0,1,0,1,10,0,0,4,0,2,14,0
5558,53267,alOTnyZzhm1w471FhEQsPMZXRjsY4Vw8,SpATywNh6bZuzm8s1ceuBUnMUAeoAHHw,14,14,6,13,3,0,3,0,39,5.571428571428571,1,0.0,7,6,10,3,7,0,3,3,0,26,13,1
5559,53274,OfEWzuzCYpLy1DIkUzWxNoBbzCb9peT6,SpATywNh6bZuzm8s1ceuBUnMUAeoAHHw,6,4,1,0,0,0,6,0,11,1.5714285714285714,1,0.0,0,1,0,0,4,0,0,6,0,1,10,0
5560,53297,wEZByhPumKHDR8Jv649KZn2fKnoB4Z7a,RXDvfPUBYFlVdlueBFbLW0mhhAyGEqpt,88,136,10,262,7,9,7,1,432,61.714285714285715,8,0.0,34,10,249,7,102,9,13,7,1,300,132,0
5561,53298,TL33IPw9u5rF9KFoVrfFEZ81kglnbuR1,bWdj2GDclj5ofokWjzoa5jAwMkxCykd6,1,0,0,0,0,0,1,0,1,0.14285714285714285,1,0.0,0,0,0,0,0,0,0,1,0,0,1,1
5562,53302,yo1PAd1hBwimD9OOoxvyi6mwQC5bfK9g,A3fsA9Zfv1X2fVEQhTw51lKENdNrEqT3,5,2,1,0,1,0,3,0,7,1.0,3,0.0,0,1,0,1,2,0,0,3,0,2,5,1
5563,53311,aPkMT9tuTlJ66PtOLGr8kUMmFmOPUdkZ,SpATywNh6bZuzm8s1ceuBUnMUAeoAHHw,7,7,4,0,3,0,2,0,16,2.2857142857142856,2,0.0,0,4,0,3,7,0,0,2,0,7,9,1
5564,53317,yEniPsoZW8Rgn4eOpAbvQhjj6pD8iwKc,A3fsA9Zfv1X2fVEQhTw51lKENdNrEqT3,1,0,0,0,0,0,1,0,1,0.14285714285714285,1,0.0,0,0,0,0,0,0,0,1,0,0,1,1
5565,53331,hibDkoksqk55U27uWSImoVEarIMKhRU6,SpATywNh6bZuzm8s1ceuBUnMUAeoAHHw,1,0,0,0,0,0,1,0,1,0.14285714285714285,1,0.0,0,0,0,0,0,0,0,1,0,0,1,1
5566,53344,zDAtaSKsAJQmmJ6xHQBbAGN68vDebyev,bWdj2GDclj5ofokWjzoa5jAwMkxCykd6,4,4,0,0,0,0,1,0,5,0.7142857142857143,1,0.0,1,0,0,0,3,0,0,1,0,1,4,0
5567,53345,FtZzEliHSUjgpcn9CYNSke7IZriM02xT,SpATywNh6bZuzm8s1ceuBUnMUAeoAHHw,27,29,21,37,6,3,5,0,101,14.428571428571429,3,0.0,4,21,31,6,25,3,6,5,0,62,39,1
5568,53355,NiXPZUmEILmWUPwXexYxtHvaIL7QdjCQ,A3fsA9Zfv1X2fVEQhTw51lKENdNrEqT3,10,15,8,0,0,0,17,0,40,5.714285714285714,3,0.0,1,8,0,0,14,0,0,17,0,9,31,1
5569,53363,kMMGkT5aXtXvkc2Ht1vStIyRGPA6Fe7z,G8EPVSXsOYB5YQWZGiz1aVq5Pgr2GrQu,17,14,10,0,7,0,8,1,40,5.714285714285714,2,0.0,2,10,0,7,12,0,0,8,1,19,21,1
5570,53367,qJEf5DGSDkSxZ1JIhipEbBFRbrhnAj1a,SpATywNh6bZuzm8s1ceuBUnMUAeoAHHw,35,101,28,32,16,0,17,0,194,27.714285714285715,5,0.0,30,28,31,16,71,0,1,17,0,105,89,0
5571,53375,Wz9l8snB7xy02KowUlwVZlKvIqcEcSjS,SpATywNh6bZuzm8s1ceuBUnMUAeoAHHw,20,25,1,16,0,0,2,0,44,6.285714285714286,1,0.0,10,1,16,0,15,0,0,2,0,27,17,1
5572,53378,5IoXxgwnl1RIJLxkp1FnmYezwVSXlFjr,SpATywNh6bZuzm8s1ceuBUnMUAeoAHHw,61,113,56,73,27,6,28,2,305,43.57142857142857,10,0.0,32,56,57,27,81,6,16,28,2,172,133,0
5573,53388,b8RIifGIgaKQKUnIb1k2djgWvbjJC3hc,A3fsA9Zfv1X2fVEQhTw51lKENdNrEqT3,1,0,0,0,0,0,1,0,1,0.14285714285714285,1,0.0,0,0,0,0,0,0,0,1,0,0,1,1
5574,53468,rLYXv7hKF9TmAtWbjwlsT53xTtV0g4r6,A3fsA9Zfv1X2fVEQhTw51lKENdNrEqT3,13,6,3,0,2,0,10,2,23,3.2857142857142856,1,0.0,0,3,0,2,6,0,0,10,2,5,18,0
5575,53487,N3Kcp8HxIitle1dnmjMusLDj62CzfGvL,SpATywNh6bZuzm8s1ceuBUnMUAeoAHHw,21,57,8,6,9,23,18,0,121,17.285714285714285,10,0.0,5,8,6,9,52,23,0,18,0,28,93,0
5576,53488,OnFhgQq4yBEqO4X7tLyRDBVhde68jGdf,RXDvfPUBYFlVdlueBFbLW0mhhAyGEqpt,52,49,31,97,12,42,28,4,263,37.57142857142857,4,0.0,13,31,87,12,36,42,10,28,4,143,120,0
5577,53489,griMTqEKR37PeprCrLd3ng7H5lhHXROa,G8EPVSXsOYB5YQWZGiz1aVq5Pgr2GrQu,6,0,0,0,0,1,6,1,8,1.1428571428571428,1,0.0,0,0,0,0,0,1,0,6,1,0,8,1
5578,53491,DJenb7iikHj085JzrOjjcdsjyfa241f7,RXDvfPUBYFlVdlueBFbLW0mhhAyGEqpt,2,0,0,0,0,0,2,0,2,0.2857142857142857,1,0.0,0,0,0,0,0,0,0,2,0,0,2,1
5579,53502,MrmZgmDV3fLNPBur1xb2HpNXhTz9Exkt,SpATywNh6bZuzm8s1ceuBUnMUAeoAHHw,24,30,3,48,2,0,21,0,104,14.857142857142858,8,0.0,13,3,41,2,17,0,7,21,0,59,45,0
5580,53508,PJ44wkPMp1IThxNmQ1GXtcqK19ORMpJF,A3fsA9Zfv1X2fVEQhTw51lKENdNrEqT3,2,0,0,0,0,0,2,0,2,0.2857142857142857,1,0.0,0,0,0,0,0,0,0,2,0,0,2,1
5581,53520,MhrFHIexWYn2dilUXh03cpnfpoe9tMBe,SpATywNh6bZuzm8s1ceuBUnMUAeoAHHw,31,46,15,32,6,8,17,1,125,17.857142857142858,9,0.0,25,15,29,6,21,8,3,17,1,75,50,1
5582,53539,i2lUV72IHqqXWYqLFMWv3y4XGmlq2lXa,SpATywNh6bZuzm8s1ceuBUnMUAeoAHHw,35,47,23,29,8,4,11,0,122,17.428571428571427,5,0.0,7,23,28,8,40,4,1,11,0,66,56,0
5583,53549,luffaRyMH17lmf9lXIITCUvmvLstdhJF,RXDvfPUBYFlVdlueBFbLW0mhhAyGEqpt,8,9,1,0,1,0,2,0,13,1.8571428571428572,1,0.0,0,1,0,1,9,0,0,2,0,2,11,1
5584,53555,gb9jOdGxS4Zwvh3LQboE7LmvRCw5TLz9,SpATywNh6bZuzm8s1ceuBUnMUAeoAHHw,18,32,2,15,1,0,16,1,67,9.571428571428571,2,0.0,8,2,14,1,24,0,1,16,1,25,42,1
5585,53562,KhZJrlhAYzlNSzHg9PDkxBUGTDjg8IXY,SpATywNh6bZuzm8s1ceuBUnMUAeoAHHw,14,13,2,7,1,0,3,0,26,3.7142857142857144,2,0.0,2,2,7,1,11,0,0,3,0,12,14,1
5586,53578,aEf8iYWPFredkFvIYIscqnDLIOz4fHRM,RXDvfPUBYFlVdlueBFbLW0mhhAyGEqpt,4,6,0,0,0,0,1,0,7,1.0,1,0.0,0,0,0,0,6,0,0,1,0,0,7,1
5587,53584,6ulfbgGgKweBR5jQh3XucxQAX08OMB72,SpATywNh6bZuzm8s1ceuBUnMUAeoAHHw,17,13,2,0,3,0,3,0,21,3.0,2,0.0,0,2,0,3,13,0,0,3,0,5,16,0
5588,53597,dL8suqa4DXYE6Q2rD72jJySCosptOAyu,SpATywNh6bZuzm8s1ceuBUnMUAeoAHHw,15,37,11,3,8,0,14,0,73,10.428571428571429,4,0.0,6,11,3,8,31,0,0,14,0,28,45,0
5589,53603,4Eyygyv4Uek4GSzjnDMCkiuVf4JBrAxc,SpATywNh6bZuzm8s1ceuBUnMUAeoAHHw,17,32,1,30,0,23,12,0,98,14.0,4,0.0,17,1,27,0,15,23,3,12,0,45,53,1
5590,53622,N07QLGV4GMHH6HuHURctAIeJ4ePasSlF,SpATywNh6bZuzm8s1ceuBUnMUAeoAHHw,2,0,0,0,0,0,2,0,2,0.2857142857142857,1,0.0,0,0,0,0,0,0,0,2,0,0,2,1
5591,53625,WJVoKPfDDccrIbPzaP1iqdrTUwOdTQpf,A3fsA9Zfv1X2fVEQhTw51lKENdNrEqT3,5,4,2,0,1,0,1,0,8,1.1428571428571428,1,0.0,0,2,0,1,4,0,0,1,0,3,5,1
5592,53651,TXNnbjY690dLjW2nCR7nDyfRxXhXZM7x,A3fsA9Zfv1X2fVEQhTw51lKENdNrEqT3,7,11,0,0,0,0,3,0,14,2.0,2,0.0,0,0,0,0,11,0,0,3,0,0,14,1
5593,53678,uqIn0vdfJ1SDJCOeCVEAQPRFBBKQA2eB,bWdj2GDclj5ofokWjzoa5jAwMkxCykd6,55,46,19,161,11,9,16,1,263,37.57142857142857,6,0.0,8,19,156,11,38,9,5,16,1,194,69,1
5594,53706,xQeTj9CLDdVhlEixqachfO1hdSy3qexC,SpATywNh6bZuzm8s1ceuBUnMUAeoAHHw,17,32,5,32,0,4,11,4,88,12.571428571428571,6,0.0,14,5,31,0,18,4,1,11,4,50,38,1
5595,53713,RluI9XQtU4oZmhgM6DxuPP3K5fCr0lBq,SpATywNh6bZuzm8s1ceuBUnMUAeoAHHw,17,15,11,5,7,0,3,0,41,5.857142857142857,3,0.0,0,11,5,7,15,0,0,3,0,23,18,1
5596,53714,Ar22lkOE5FvesxoMKtYhm8Cbv4MUQUYF,RXDvfPUBYFlVdlueBFbLW0mhhAyGEqpt,53,97,4,138,8,28,65,26,366,52.285714285714285,7,0.0,33,4,127,8,64,28,11,65,26,172,194,1
5597,53720,eeYgUeHIQERDYwF1mxwVIZYsVaVSgwlV,A3fsA9Zfv1X2fVEQhTw51lKENdNrEqT3,51,64,35,104,11,21,22,0,257,36.714285714285715,6,0.0,3,35,89,11,61,21,15,22,0,138,119,1
5598,53727,krkfIMLel7iDn2mta14hX7PO3xGpidTe,bWdj2GDclj5ofokWjzoa5jAwMkxCykd6,4,6,0,0,0,0,3,0,9,1.2857142857142858,2,0.0,0,0,0,0,6,0,0,3,0,0,9,1
5599,53733,1OspHY7rOajB01D4WOGZGtONpUzR26jm,bWdj2GDclj5ofokWjzoa5jAwMkxCykd6,1,0,0,0,0,0,1,0,1,0.14285714285714285,1,0.0,0,0,0,0,0,0,0,1,0,0,1,1
5600,53750,DHyGbluRYDb9YK4sD54nYIDtRwaCVU4f,SpATywNh6bZuzm8s1ceuBUnMUAeoAHHw,37,73,14,27,3,10,13,1,141,20.142857142857142,8,0.0,12,14,24,3,61,10,3,13,1,53,88,1
5601,53758,Hu906OsUOpYkLeeay2GUzLMtBtAH0201,SpATywNh6bZuzm8s1ceuBUnMUAeoAHHw,22,46,7,0,5,0,18,0,76,10.857142857142858,9,0.0,0,7,0,5,46,0,0,18,0,12,64,1
5602,53765,tsMYMsnBDSMWs12MBfqVxxI4flEFKsqY,SpATywNh6bZuzm8s1ceuBUnMUAeoAHHw,6,2,1,0,1,0,3,0,7,1.0,1,0.0,0,1,0,1,2,0,0,3,0,2,5,1
5603,53767,7pxuwoHJlBJIgCUu1Em6p1jZ4AOgWd02,SpATywNh6bZuzm8s1ceuBUnMUAeoAHHw,1,0,0,0,0,0,1,0,1,0.14285714285714285,1,0.0,0,0,0,0,0,0,0,1,0,0,1,1
5604,53775,10a3aPUuiEikOQBzdtiLA8dXlMBNaCqq,SpATywNh6bZuzm8s1ceuBUnMUAeoAHHw,1,0,0,0,0,0,1,0,1,0.14285714285714285,1,0.0,0,0,0,0,0,0,0,1,0,0,1,1
5605,53790,F6SQlqazEZ0w5BjMwjWgS37WY6aKoLpg,SpATywNh6bZuzm8s1ceuBUnMUAeoAHHw,25,42,1,21,1,31,16,1,113,16.142857142857142,1,0.0,10,1,20,1,32,31,1,16,1,32,81,1
5606,53800,j69quqIKpcCSzqXo9ZsaY7H1y4DglvlA,SpATywNh6bZuzm8s1ceuBUnMUAeoAHHw,8,6,4,0,3,1,3,0,17,2.4285714285714284,2,0.0,0,4,0,3,6,1,0,3,0,7,10,1
5607,53801,JVippbCdijsZvDTgzyPclP2OizOfI7bg,SpATywNh6bZuzm8s1ceuBUnMUAeoAHHw,26,32,15,26,7,5,5,0,90,12.857142857142858,2,0.0,5,15,21,7,27,5,5,5,0,48,42,1
5608,53811,VMIa4tT0g1D8FcJ7AhOiLBIndESbZgIA,A3fsA9Zfv1X2fVEQhTw51lKENdNrEqT3,1,0,0,0,0,0,1,0,1,0.14285714285714285,1,0.0,0,0,0,0,0,0,0,1,0,0,1,1
5609,53813,JfKuoH41ocsNDmphdAQOIFuKNZWqJJwf,SpATywNh6bZuzm8s1ceuBUnMUAeoAHHw,29,48,31,25,1,172,27,2,306,43.714285714285715,5,0.0,4,31,22,1,44,172,3,27,2,58,248,1
5610,53815,zSmc8rKmn3W7ClGZoLsZk5lSBVQHeitz,SpATywNh6bZuzm8s1ceuBUnMUAeoAHHw,21,28,1,10,1,0,31,0,71,10.142857142857142,8,0.0,2,1,8,1,26,0,2,31,0,12,59,0
5611,53828,anpgTlAzqtcn1vI43094PZ2LMGoPXQz9,SpATywNh6bZuzm8s1ceuBUnMUAeoAHHw,8,9,4,0,1,12,7,0,33,4.714285714285714,2,0.0,3,4,0,1,6,12,0,7,0,8,25,1
5612,53838,QApdmb1PXR97hGOt28aAXkYQiicNqOKw,SpATywNh6bZuzm8s1ceuBUnMUAeoAHHw,35,52,1,40,1,0,15,1,110,15.714285714285714,4,0.0,13,1,37,1,39,0,3,15,1,52,58,0
5613,53842,tN95ymRxU88OqvEeFVj1h9MemYWUdm2H,A3fsA9Zfv1X2fVEQhTw51lKENdNrEqT3,21,12,9,0,8,0,3,0,32,4.571428571428571,2,0.0,0,9,0,8,12,0,0,3,0,17,15,1
5614,53849,gSVGAbR6ZoNLN4J93dYtc3hGFE6M7IrZ,SpATywNh6bZuzm8s1ceuBUnMUAeoAHHw,5,2,0,0,0,0,3,0,5,0.7142857142857143,1,0.0,0,0,0,0,2,0,0,3,0,0,5,1
5615,53858,6Upqh8KDtBiZuS1AWTucTCCkEJCPfX5m,SpATywNh6bZuzm8s1ceuBUnMUAeoAHHw,34,113,6,55,3,163,18,0,358,51.142857142857146,12,0.0,40,6,45,3,73,163,10,18,0,94,264,0
5616,53861,Su9COtUoYOdyYjAUoqvAULKdQODTHr7E,bWdj2GDclj5ofokWjzoa5jAwMkxCykd6,69,116,40,345,8,19,44,4,576,82.28571428571429,13,0.0,22,40,322,8,94,19,23,44,4,392,184,0
5617,53875,wgifE6A0kxnDEjw7myKTY39TRuCgYxaB,bWdj2GDclj5ofokWjzoa5jAwMkxCykd6,9,10,4,0,3,0,7,0,24,3.4285714285714284,4,0.0,0,4,0,3,10,0,0,7,0,7,17,1
5618,53877,cLYelk5eLuqZus5jIOPS82VsEcbwjlHd,SpATywNh6bZuzm8s1ceuBUnMUAeoAHHw,17,26,13,6,8,0,4,0,57,8.142857142857142,1,0.0,8,13,6,8,18,0,0,4,0,35,22,1
5619,53881,nEyHrNWAhCJiBBDbSB6IHu4lz50w5Dy6,A3fsA9Zfv1X2fVEQhTw51lKENdNrEqT3,17,14,10,0,7,0,6,0,37,5.285714285714286,4,0.0,0,10,0,7,14,0,0,6,0,17,20,1
5620,53895,Y0j1i2gPpBKnJTyvOTxYtV3JtU8UpMcv,SpATywNh6bZuzm8s1ceuBUnMUAeoAHHw,20,37,12,27,3,0,15,4,98,14.0,3,0.0,16,12,25,3,21,0,2,15,4,56,42,1
5621,53904,SjgqKMmF4tqpvhmgO66D1TdoOxgqcy2V,RXDvfPUBYFlVdlueBFbLW0mhhAyGEqpt,35,53,18,49,11,2,6,0,139,19.857142857142858,3,0.0,16,18,49,11,37,2,0,6,0,94,45,0
5622,53906,nCx7ByTflBYRKyE0yen5MKylk9XOx9rV,A3fsA9Zfv1X2fVEQhTw51lKENdNrEqT3,10,18,9,0,4,0,4,0,35,5.0,3,0.0,1,9,0,4,17,0,0,4,0,14,21,1
5623,53913,a2z9RsxlqGCqsHimTXs86MGbzWTI57AJ,SpATywNh6bZuzm8s1ceuBUnMUAeoAHHw,11,9,6,5,4,1,2,0,27,3.857142857142857,1,0.0,2,6,4,4,7,1,1,2,0,16,11,1
5624,53917,4S03noH7cjIbR4dHJ5qcypZRCrtfcYb6,bWdj2GDclj5ofokWjzoa5jAwMkxCykd6,16,28,3,10,2,11,8,2,64,9.142857142857142,5,0.0,3,3,10,2,25,11,0,8,2,18,46,1
5625,53923,hiq4p9Wpf1ENeqXLCQsPukhDTDL2bNA2,RXDvfPUBYFlVdlueBFbLW0mhhAyGEqpt,27,36,15,33,3,18,21,5,131,18.714285714285715,4,0.0,14,15,31,3,22,18,2,21,5,63,68,0
5626,53939,JUQwyjRts4o299yp6PZYUiNur6LnV5UN,SpATywNh6bZuzm8s1ceuBUnMUAeoAHHw,7,5,1,0,1,0,2,0,9,1.2857142857142858,1,0.0,0,1,0,1,5,0,0,2,0,2,7,1
5627,53947,cL4725Y58Cl01IjeOv5CCdtpjNF0EqJp,SpATywNh6bZuzm8s1ceuBUnMUAeoAHHw,13,23,13,0,4,7,9,1,57,8.142857142857142,5,0.0,3,13,0,4,20,7,0,9,1,20,37,1
5628,53958,wcSIko8HPcmbs4cOPlImi3EyazICOLlR,bWdj2GDclj5ofokWjzoa5jAwMkxCykd6,2,0,0,0,0,0,9,0,9,1.2857142857142858,4,0.0,0,0,0,0,0,0,0,9,0,0,9,1
5629,53962,HH3HV5HDJ35z2ldQAEIDXBOSBTxLd6O9,bWdj2GDclj5ofokWjzoa5jAwMkxCykd6,20,19,9,118,7,1,12,1,167,23.857142857142858,4,0.0,7,9,113,7,12,1,5,12,1,136,31,1
5630,53968,561j5AofjwKlXet6wIEWLTESu761wNuJ,SpATywNh6bZuzm8s1ceuBUnMUAeoAHHw,10,12,6,0,3,9,6,1,37,5.285714285714286,1,0.0,0,6,0,3,12,9,0,6,1,9,28,1
5631,53980,f50myi7Wnjd1BWfZdyqaXMcdfMAdeGX9,G8EPVSXsOYB5YQWZGiz1aVq5Pgr2GrQu,118,158,0,257,2,40,43,1,501,71.57142857142857,19,0.0,57,0,212,2,101,40,45,43,1,271,230,0
5632,53983,R48KCTeb8uSJLAUTCApWBwkMVREjjMDW,A3fsA9Zfv1X2fVEQhTw51lKENdNrEqT3,24,5,3,87,0,2,8,1,106,15.142857142857142,1,0.0,1,3,71,0,4,2,16,8,1,75,31,1
5633,53992,srF76iHf3IXwkM0p0daLjk1LYx1sO9QO,A3fsA9Zfv1X2fVEQhTw51lKENdNrEqT3,43,69,4,68,5,1,16,1,164,23.428571428571427,2,0.0,7,4,59,5,62,1,9,16,1,75,89,1
5634,54001,Gglvz7f1jVuISouyvTJRaLDdezGOZ6EL,SpATywNh6bZuzm8s1ceuBUnMUAeoAHHw,45,75,20,51,13,11,29,1,200,28.571428571428573,7,0.0,14,20,43,13,61,11,8,29,1,90,110,0
5635,54002,FHrj4N2SCEsxza13qmFjgJkCjs8BkrF3,bWdj2GDclj5ofokWjzoa5jAwMkxCykd6,18,36,22,68,8,22,22,2,180,25.714285714285715,4,0.0,5,22,61,8,31,22,7,22,2,96,84,1
5636,54009,U2oiAxypJX3TTENRYPio3LHOtQ2XmXGS,SpATywNh6bZuzm8s1ceuBUnMUAeoAHHw,25,50,19,17,6,4,17,1,114,16.285714285714285,4,0.0,12,19,14,6,38,4,3,17,1,51,63,0
5637,54015,Uo49WNvktWkKOAhlqrqOXLXaeoQpAgrc,SpATywNh6bZuzm8s1ceuBUnMUAeoAHHw,26,30,14,15,12,0,4,0,75,10.714285714285714,4,0.0,8,14,14,12,22,0,1,4,0,48,27,1
5638,54018,dyoINQ9hlelfXhGgA7SokU45MaV6r2b8,SpATywNh6bZuzm8s1ceuBUnMUAeoAHHw,47,42,28,42,15,2,7,0,136,19.428571428571427,6,0.0,7,28,34,15,35,2,8,7,0,84,52,0
5639,54023,n7yQ1FvfAXqDnBpszfIUjZkrvw3J2aJC,bWdj2GDclj5ofokWjzoa5jAwMkxCykd6,2,0,0,0,0,0,2,0,2,0.2857142857142857,1,0.0,0,0,0,0,0,0,0,2,0,0,2,1
5640,54026,gw1ywpstRy3gY1kWojp1woauzVM2ZYVr,SpATywNh6bZuzm8s1ceuBUnMUAeoAHHw,39,70,51,22,17,0,16,0,176,25.142857142857142,6,0.0,5,51,18,17,65,0,4,16,0,91,85,0
5641,54027,0S1IMyqlmBJaUdNY6QqTX948M0Vx0tcJ,SpATywNh6bZuzm8s1ceuBUnMUAeoAHHw,13,18,6,0,3,0,3,0,30,4.285714285714286,2,0.0,0,6,0,3,18,0,0,3,0,9,21,1
5642,54029,So8gZ8cXseEZ7lXf4idNMqcN46bXtlIA,SpATywNh6bZuzm8s1ceuBUnMUAeoAHHw,41,69,36,31,23,4,17,0,180,25.714285714285715,11,0.0,17,36,25,23,52,4,6,17,0,101,79,0
5643,54048,pXLwXf6zUsqL9SOfZNShdqFixygLJrWR,SpATywNh6bZuzm8s1ceuBUnMUAeoAHHw,7,4,2,0,2,0,2,0,10,1.4285714285714286,1,0.0,1,2,0,2,3,0,0,2,0,5,5,1
5644,54056,HLuhLxGFPt6I9n1CokhbKviDPHHdGO60,G8EPVSXsOYB5YQWZGiz1aVq5Pgr2GrQu,4,2,0,0,0,0,2,0,4,0.5714285714285714,1,0.0,0,0,0,0,2,0,0,2,0,0,4,1
5645,54062,1zcBOliKKVXK419jHsqjZGpz654bIAn5,RXDvfPUBYFlVdlueBFbLW0mhhAyGEqpt,24,42,23,42,13,13,6,1,140,20.0,3,0.0,10,23,40,13,32,13,2,6,1,86,54,1
5646,54071,vYeGcWGAJP4B8Lvbjdr2jkY9NnpHN8xb,SpATywNh6bZuzm8s1ceuBUnMUAeoAHHw,32,52,29,27,13,5,23,0,149,21.285714285714285,6,0.0,12,29,24,13,40,5,3,23,0,78,71,1
5647,54076,33fwsM5EFqk5KwLRS1Hdk3QGBr5jYWOs,SpATywNh6bZuzm8s1ceuBUnMUAeoAHHw,36,47,25,29,10,20,27,2,160,22.857142857142858,8,0.0,13,25,27,10,34,20,2,27,2,75,85,0
5648,54078,mzJ0trk582dssKvdbvvSr3OyxZiFuQ3P,bWdj2GDclj5ofokWjzoa5jAwMkxCykd6,11,13,2,0,1,1,6,1,24,3.4285714285714284,3,0.0,0,2,0,1,13,1,0,6,1,3,21,1
5649,54079,pJOjDRWW7Xh5i12ZiWoQnz8dZuNP8rXl,SpATywNh6bZuzm8s1ceuBUnMUAeoAHHw,11,18,8,0,5,2,1,0,34,4.857142857142857,1,0.0,2,8,0,5,16,2,0,1,0,15,19,1
5650,54082,4LX6gYDKcYMBLDa9yuezfCQG1GKo9eu8,SpATywNh6bZuzm8s1ceuBUnMUAeoAHHw,5,8,0,0,0,0,7,0,15,2.142857142857143,1,0.0,0,0,0,0,8,0,0,7,0,0,15,1
5651,54083,QYVRHTpooyTkzSbIywJ7ri5o4t73Xwty,RXDvfPUBYFlVdlueBFbLW0mhhAyGEqpt,1,0,0,0,0,0,1,0,1,0.14285714285714285,1,0.0,0,0,0,0,0,0,0,1,0,0,1,1
5652,54085,BQCssLSYZBRoNs0A82WS0r6vRVhdQKvg,SpATywNh6bZuzm8s1ceuBUnMUAeoAHHw,9,6,4,0,2,0,3,0,15,2.142857142857143,1,0.0,0,4,0,2,6,0,0,3,0,6,9,1
5653,54088,7Xq01ZEcLJ8EiJEfAlByyafLSPE4vuef,SpATywNh6bZuzm8s1ceuBUnMUAeoAHHw,5,3,2,0,0,0,2,0,7,1.0,1,0.0,0,2,0,0,3,0,0,2,0,2,5,1
5654,54094,Fdt86Xu5OLPdaOgl6M1XDpiJ3zar7SU6,SpATywNh6bZuzm8s1ceuBUnMUAeoAHHw,28,49,14,65,3,2,21,6,160,22.857142857142858,6,0.0,19,14,57,3,30,2,8,21,6,93,67,0
5655,54103,uEA5Un9wAGiDxjEkoYiTUGhoxCFEEvwr,SpATywNh6bZuzm8s1ceuBUnMUAeoAHHw,1,0,0,0,0,0,1,0,1,0.14285714285714285,1,0.0,0,0,0,0,0,0,0,1,0,0,1,1
5656,54113,Dpj1ute7yeokptEET2ZfYuubDiXNwLXm,A3fsA9Zfv1X2fVEQhTw51lKENdNrEqT3,9,13,7,0,4,0,2,0,26,3.7142857142857144,2,0.0,0,7,0,4,13,0,0,2,0,11,15,1
5657,54121,nVNeaHavpiSEFe567sT2ScRxObLjhEGL,G8EPVSXsOYB5YQWZGiz1aVq5Pgr2GrQu,42,34,24,140,10,6,7,0,221,31.571428571428573,5,0.0,0,24,120,10,34,6,20,7,0,154,67,1
5658,54123,b5xbU8SGcZEvpqzyP6Qk6welzZOUxOvx,A3fsA9Zfv1X2fVEQhTw51lKENdNrEqT3,9,6,2,0,2,0,5,0,15,2.142857142857143,2,0.0,0,2,0,2,6,0,0,5,0,4,11,1
5659,54129,qKOvjGeHnXAGhScloNy1qhNnfc1xHZ3T,SpATywNh6bZuzm8s1ceuBUnMUAeoAHHw,32,151,5,36,5,122,57,5,381,54.42857142857143,12,0.0,41,5,28,5,110,122,8,57,5,79,302,0
5660,54132,PfTpx7WgTJY6IpNokJ2POml34GMs7LTI,bWdj2GDclj5ofokWjzoa5jAwMkxCykd6,67,44,25,130,13,8,15,0,235,33.57142857142857,7,0.0,10,25,127,13,34,8,3,15,0,175,60,0
5661,54133,jU9n6p1KRt3F2eM3pIcFgt7azc85bbxP,SpATywNh6bZuzm8s1ceuBUnMUAeoAHHw,18,46,28,0,18,6,25,1,124,17.714285714285715,4,0.0,3,28,0,18,43,6,0,25,1,49,75,1
5662,54134,BtB75B9l8XyH0uPaKeOkkRrm2NqBrtQe,A3fsA9Zfv1X2fVEQhTw51lKENdNrEqT3,37,32,23,0,18,0,11,0,84,12.0,8,0.0,0,23,0,18,32,0,0,11,0,41,43,1
5663,54137,kdSq236IYQMsCu2OjWxBROoAPTYOBg4Z,A3fsA9Zfv1X2fVEQhTw51lKENdNrEqT3,1,0,0,0,0,0,1,0,1,0.14285714285714285,1,0.0,0,0,0,0,0,0,0,1,0,0,1,1
5664,54138,cZ43eywkms9yBmvkdibtxlcZqrcdFmmE,SpATywNh6bZuzm8s1ceuBUnMUAeoAHHw,10,8,4,0,0,2,6,1,21,3.0,2,0.0,2,4,0,0,6,2,0,6,1,6,15,1
5665,54140,2Bc3e8bWl6DTvfTPBZCyShFFG8OApkva,A3fsA9Zfv1X2fVEQhTw51lKENdNrEqT3,9,11,5,0,3,0,2,0,21,3.0,2,0.0,0,5,0,3,11,0,0,2,0,8,13,1
5666,54144,oEOiBLMr97GK8O9ympHG9NMLQODJ0Xam,bWdj2GDclj5ofokWjzoa5jAwMkxCykd6,1,0,0,0,0,0,1,0,1,0.14285714285714285,1,0.0,0,0,0,0,0,0,0,1,0,0,1,1
5667,54145,uL6960SAwN5kJgcsaw9m5ztApNeZFO95,A3fsA9Zfv1X2fVEQhTw51lKENdNrEqT3,40,32,23,56,12,0,10,0,133,19.0,3,0.0,2,23,50,12,30,0,6,10,0,87,46,1
5668,54149,oEOiBLMr97GK8O9ympHG9NMLQODJ0Xam,SpATywNh6bZuzm8s1ceuBUnMUAeoAHHw,1,0,0,0,0,0,1,0,1,0.14285714285714285,1,0.0,0,0,0,0,0,0,0,1,0,0,1,1
5669,54153,1rAHmNrxrqnzHEQFMlydmQ968LsZW0oG,A3fsA9Zfv1X2fVEQhTw51lKENdNrEqT3,18,12,9,0,5,0,9,0,35,5.0,3,0.0,0,9,0,5,12,0,0,9,0,14,21,1
5670,54176,i2jPckJdA9hhx8KLohXM0CrojRerYpdv,SpATywNh6bZuzm8s1ceuBUnMUAeoAHHw,47,155,69,64,27,68,47,12,442,63.142857142857146,10,0.0,61,69,52,27,94,68,12,47,12,209,233,0
5671,54185,0fPKzumQAfSwGfxF7d6bvXWcsMGpFXOP,SpATywNh6bZuzm8s1ceuBUnMUAeoAHHw,30,46,19,28,9,6,8,2,118,16.857142857142858,5,0.0,7,19,26,9,39,6,2,8,2,61,57,0
5672,54199,yhj9ME5eIWuvrbwWqT7KNKtjeY6yuvxW,A3fsA9Zfv1X2fVEQhTw51lKENdNrEqT3,4,0,0,0,0,1,4,2,7,1.0,1,0.0,0,0,0,0,0,1,0,4,2,0,7,1
5673,54226,l3sfUHhSnAdS6GAthlSM3lKuUCRdk9CZ,A3fsA9Zfv1X2fVEQhTw51lKENdNrEqT3,21,14,8,62,2,0,5,0,91,13.0,3,0.0,2,8,48,2,12,0,14,5,0,60,31,1
5674,54231,o6TNCL8FasDR1iE3PXeICx9M4vKCc0T1,bWdj2GDclj5ofokWjzoa5jAwMkxCykd6,10,17,12,0,9,0,6,0,44,6.285714285714286,5,0.0,0,12,0,9,17,0,0,6,0,21,23,1
5675,54233,o6TNCL8FasDR1iE3PXeICx9M4vKCc0T1,A3fsA9Zfv1X2fVEQhTw51lKENdNrEqT3,1,0,0,0,0,0,1,0,1,0.14285714285714285,1,0.0,0,0,0,0,0,0,0,1,0,0,1,1
5676,54238,V9HQPxlLSz0QiOl8p8UTUo6CstrlztcH,SpATywNh6bZuzm8s1ceuBUnMUAeoAHHw,4,2,0,0,0,0,2,0,4,0.5714285714285714,1,0.0,0,0,0,0,2,0,0,2,0,0,4,1
5677,54285,Io3VzTK6sP3a0ZVRKkRhFNz8A2ULjris,bWdj2GDclj5ofokWjzoa5jAwMkxCykd6,2,0,0,0,0,0,3,0,3,0.42857142857142855,1,0.0,0,0,0,0,0,0,0,3,0,0,3,1
5678,54287,kuiW3Le0WeMGiwxmKgXwp1GfHw3vKMeq,SpATywNh6bZuzm8s1ceuBUnMUAeoAHHw,14,10,6,4,4,0,4,0,28,4.0,4,0.0,1,6,4,4,9,0,0,4,0,15,13,1
5679,54306,pQnR1td8vlxsKseVpfzZVvCBdR2iP4U6,A3fsA9Zfv1X2fVEQhTw51lKENdNrEqT3,16,18,6,0,4,0,11,0,39,5.571428571428571,4,0.0,0,6,0,4,18,0,0,11,0,10,29,0
5680,54312,np300nKbgkFp0EFcdJyIdPu3KUkiYdwY,G8EPVSXsOYB5YQWZGiz1aVq5Pgr2GrQu,6,4,1,0,1,0,2,0,8,1.1428571428571428,1,0.0,0,1,0,1,4,0,0,2,0,2,6,1
5681,54316,64OeQzK990rz5QNrMOQujVxWZWc38bZL,SpATywNh6bZuzm8s1ceuBUnMUAeoAHHw,17,11,7,11,4,0,3,0,36,5.142857142857143,2,0.0,2,7,11,4,9,0,0,3,0,24,12,1
5682,54321,qgHNkIIeFGRC3Bav4KufUnqlMzkDetSU,bWdj2GDclj5ofokWjzoa5jAwMkxCykd6,20,31,13,54,10,8,12,1,129,18.428571428571427,4,0.0,8,13,51,10,23,8,3,12,1,82,47,0
5683,54341,bJm6vpekKjS0vCZZW0loTWMZ3NWdcX0T,SpATywNh6bZuzm8s1ceuBUnMUAeoAHHw,1,0,0,0,0,0,1,0,1,0.14285714285714285,1,0.0,0,0,0,0,0,0,0,1,0,0,1,1
5684,54344,M7Vbw5q1oL32IfEMSI9AM5uHCUMDFHmm,bWdj2GDclj5ofokWjzoa5jAwMkxCykd6,1,0,0,0,0,0,1,0,1,0.14285714285714285,1,0.0,0,0,0,0,0,0,0,1,0,0,1,1
5685,54345,7P3XgLwfwlFBQozc5Gty8UBmzZ1wk3nf,bWdj2GDclj5ofokWjzoa5jAwMkxCykd6,3,5,1,0,1,0,1,0,8,1.1428571428571428,1,0.0,3,1,0,1,2,0,0,1,0,5,3,1
5686,54352,pQnR1td8vlxsKseVpfzZVvCBdR2iP4U6,RXDvfPUBYFlVdlueBFbLW0mhhAyGEqpt,5,2,1,0,1,0,2,0,6,0.8571428571428571,1,0.0,0,1,0,1,2,0,0,2,0,2,4,1
5687,54378,wykDdjB45pC3zZUNNLpkNXDJGEatsGFp,SpATywNh6bZuzm8s1ceuBUnMUAeoAHHw,1,0,0,0,0,0,1,0,1,0.14285714285714285,1,0.0,0,0,0,0,0,0,0,1,0,0,1,1
5688,54389,Dpj1ute7yeokptEET2ZfYuubDiXNwLXm,SpATywNh6bZuzm8s1ceuBUnMUAeoAHHw,9,14,9,0,6,0,4,0,33,4.714285714285714,4,0.0,0,9,0,6,14,0,0,4,0,15,18,1
5689,54391,6GW7T2KXNaFy6SJDNV3BLn1vYIvac4zq,bWdj2GDclj5ofokWjzoa5jAwMkxCykd6,1,0,0,0,0,0,1,0,1,0.14285714285714285,1,0.0,0,0,0,0,0,0,0,1,0,0,1,1
5690,54398,lg3JWapmXZgNYOt38qBO2QsZMUBFS5SJ,G8EPVSXsOYB5YQWZGiz1aVq5Pgr2GrQu,84,127,54,180,32,19,24,2,438,62.57142857142857,6,0.0,61,54,136,32,66,19,44,24,2,283,155,0
5691,54399,6GW7T2KXNaFy6SJDNV3BLn1vYIvac4zq,A3fsA9Zfv1X2fVEQhTw51lKENdNrEqT3,21,16,12,0,11,0,1,0,40,5.714285714285714,1,0.0,1,12,0,11,15,0,0,1,0,24,16,1
5692,54411,UZrNs5yPvW1ZVC8d6wdut2Js7XUvysRH,SpATywNh6bZuzm8s1ceuBUnMUAeoAHHw,29,36,24,27,7,29,12,3,138,19.714285714285715,8,0.0,4,24,26,7,32,29,1,12,3,61,77,1
5693,54419,H4rucA3Bl92feiIFqEyA7i9inMfODBCx,SpATywNh6bZuzm8s1ceuBUnMUAeoAHHw,5,5,2,0,0,0,4,0,11,1.5714285714285714,2,0.0,0,2,0,0,5,0,0,4,0,2,9,0
5694,54447,6A2JLpLWnCwUlo9pD1HHlgEwNLvzcllv,A3fsA9Zfv1X2fVEQhTw51lKENdNrEqT3,43,64,31,70,16,0,11,0,192,27.428571428571427,6,0.0,3,31,57,16,61,0,13,11,0,107,85,1
5695,54458,w8ymvO72UlYPBd2tG0A8iTEwt4UoIvlZ,A3fsA9Zfv1X2fVEQhTw51lKENdNrEqT3,41,33,21,50,12,0,5,0,121,17.285714285714285,3,0.0,5,21,50,12,28,0,0,5,0,88,33,1
5696,54467,Ha2E1KX6VBrxAJ0Y64ONsTCt1RbrAdiK,SpATywNh6bZuzm8s1ceuBUnMUAeoAHHw,43,39,27,13,18,0,15,0,112,16.0,8,0.0,6,27,11,18,33,0,2,15,0,62,50,0
5697,54485,bbBKqbJ74sqbqRiQHsLpyapFJxr2Z728,SpATywNh6bZuzm8s1ceuBUnMUAeoAHHw,17,55,16,14,3,5,13,2,108,15.428571428571429,3,0.0,26,16,12,3,29,5,2,13,2,57,51,1
5698,54509,HPaDTzk2xymxbpoa0VdcxdHl3uFfOfZk,bWdj2GDclj5ofokWjzoa5jAwMkxCykd6,11,21,12,0,1,5,52,3,94,13.428571428571429,8,0.0,2,12,0,1,19,5,0,52,3,15,79,1
5699,54512,x6BtQH70uuLHaxqzHA21U9wmfT0SxzD9,SpATywNh6bZuzm8s1ceuBUnMUAeoAHHw,46,74,9,48,6,41,91,6,275,39.285714285714285,21,0.0,19,9,38,6,55,41,10,91,6,72,203,0
5700,54514,Xq1kPqflDNgXwQ2pEniNYUjMpkVzPp1m,bWdj2GDclj5ofokWjzoa5jAwMkxCykd6,5,8,3,0,0,0,2,0,13,1.8571428571428572,2,0.0,0,3,0,0,8,0,0,2,0,3,10,1
5701,54516,bYSbXmkovrv6ucz58VC2SSCMvEjrNo7x,SpATywNh6bZuzm8s1ceuBUnMUAeoAHHw,1,0,0,0,0,0,1,0,1,0.14285714285714285,1,0.0,0,0,0,0,0,0,0,1,0,0,1,1
5702,54518,CE7hlTWnMpoldcHVRqlfbEgzp5iUVo4d,SpATywNh6bZuzm8s1ceuBUnMUAeoAHHw,15,17,8,0,4,1,7,1,38,5.428571428571429,2,0.0,7,8,0,4,10,1,0,7,1,19,19,0
5703,54524,CxUPOQRaQMGLmbOcfniIQOhh24PXLDR6,bWdj2GDclj5ofokWjzoa5jAwMkxCykd6,17,42,16,30,4,13,9,0,114,16.285714285714285,10,0.0,8,16,26,4,34,13,4,9,0,54,60,0
5704,54528,MXVve1Eg6sXSXHh1Skrb0tjPJ9Wtb0M7,SpATywNh6bZuzm8s1ceuBUnMUAeoAHHw,5,2,1,0,1,0,4,0,8,1.1428571428571428,2,0.0,0,1,0,1,2,0,0,4,0,2,6,1
5705,54544,CF0PQ9PBY5Y16Xk8e9CdQNNLQnwOLSsu,bWdj2GDclj5ofokWjzoa5jAwMkxCykd6,7,9,1,0,2,0,4,0,16,2.2857142857142856,1,0.0,3,1,0,2,6,0,0,4,0,6,10,1
5706,54554,7kbuqNU54d8d11QmdSpTGAMhLhmSDka1,SpATywNh6bZuzm8s1ceuBUnMUAeoAHHw,9,6,2,2,0,0,5,0,15,2.142857142857143,1,0.0,1,2,2,0,5,0,0,5,0,5,10,1
5707,54555,7kbuqNU54d8d11QmdSpTGAMhLhmSDka1,G8EPVSXsOYB5YQWZGiz1aVq5Pgr2GrQu,13,13,4,0,2,0,5,0,24,3.4285714285714284,1,0.0,6,4,0,2,7,0,0,5,0,12,12,1
5708,54558,jtxvuHBV8ZOgNnNCL1A1WerzR2TVfFNy,RXDvfPUBYFlVdlueBFbLW0mhhAyGEqpt,43,42,28,63,10,0,6,0,149,21.285714285714285,3,0.0,7,28,60,10,35,0,3,6,0,105,44,1
5709,54568,fUMqQuy71n3a3vBlGt3GhPdNsIerKaNG,SpATywNh6bZuzm8s1ceuBUnMUAeoAHHw,21,34,21,10,1,0,9,0,75,10.714285714285714,5,0.0,4,21,8,1,30,0,2,9,0,34,41,1
5710,54581,MF9uYxE1fYdj67HROuwgGArAcww4zZp4,bWdj2GDclj5ofokWjzoa5jAwMkxCykd6,1,0,0,0,0,0,1,0,1,0.14285714285714285,1,0.0,0,0,0,0,0,0,0,1,0,0,1,1
5711,54586,XMX9ZzyckuT66ALkAoQ1Ndie7Ls8rbRQ,fbPkOYLVPtPgIt0MxizjfFJov3JbHyAi,3,0,0,0,0,0,6,0,6,0.8571428571428571,1,0.0,0,0,0,0,0,0,0,6,0,0,6,1
5712,54587,XwtXdahYBtKn1j9zGxg0PnMltlmGyk2u,fbPkOYLVPtPgIt0MxizjfFJov3JbHyAi,1,0,0,0,0,0,1,0,1,0.14285714285714285,1,0.0,0,0,0,0,0,0,0,1,0,0,1,1
5713,54588,iL3U1k6BvBmHPE9rSR4M1VNouviCTM2t,fbPkOYLVPtPgIt0MxizjfFJov3JbHyAi,5,3,1,0,1,0,3,0,8,1.1428571428571428,2,0.0,0,1,0,1,3,0,0,3,0,2,6,1
5714,54590,UKq5lhvAp06ZhcbYGirhBoJurTHlyP25,fbPkOYLVPtPgIt0MxizjfFJov3JbHyAi,5,2,1,0,1,0,2,0,6,0.8571428571428571,1,0.0,0,1,0,1,2,0,0,2,0,2,4,1
5715,54591,RPtZCNTAyQipNNl051bobyaDbhugsIOS,fbPkOYLVPtPgIt0MxizjfFJov3JbHyAi,1,0,0,0,0,0,1,0,1,0.14285714285714285,1,0.0,0,0,0,0,0,0,0,1,0,0,1,1
5716,54592,CWFidUgIzgdopV7O6G9SWuzois32YUUt,fbPkOYLVPtPgIt0MxizjfFJov3JbHyAi,1,0,0,0,0,0,1,0,1,0.14285714285714285,1,0.0,0,0,0,0,0,0,0,1,0,0,1,1
5717,54593,S5r0CKOxIwwZ6o4r0E3DEfNq3HUydzP8,fbPkOYLVPtPgIt0MxizjfFJov3JbHyAi,78,122,43,30,62,5,4,0,266,38.0,3,0.0,76,43,29,62,46,5,1,4,0,210,56,0
5718,54595,jMSxxfftYD0taGWVEUZkcvxpGucC0j8q,fbPkOYLVPtPgIt0MxizjfFJov3JbHyAi,9,9,6,0,2,0,3,0,20,2.857142857142857,2,0.0,0,6,0,2,9,0,0,3,0,8,12,1
5719,54596,4iIFGSGht2JSMTrJpTy2D2ifltt0fayQ,fbPkOYLVPtPgIt0MxizjfFJov3JbHyAi,5,4,1,0,1,0,1,0,7,1.0,1,0.0,0,1,0,1,4,0,0,1,0,2,5,1
5720,54597,aLRP3ahB5SIcOn5vpM1VPEh9ib2QIioX,fbPkOYLVPtPgIt0MxizjfFJov3JbHyAi,19,34,19,0,10,0,11,0,74,10.571428571428571,2,0.0,0,19,0,10,34,0,0,11,0,29,45,1
5721,54598,mrfe3bnp3SndeE2oXZeqVQsRy8JkXozQ,fbPkOYLVPtPgIt0MxizjfFJov3JbHyAi,1,0,0,0,0,0,1,0,1,0.14285714285714285,1,0.0,0,0,0,0,0,0,0,1,0,0,1,1
5722,54600,3jguyYNURG292EUyxbyVUDYpy7NMnhYE,fbPkOYLVPtPgIt0MxizjfFJov3JbHyAi,2,0,0,0,0,0,3,0,3,0.42857142857142855,1,0.0,0,0,0,0,0,0,0,3,0,0,3,1
5723,54602,hykYMYi1SCeVtZUyKpT75CoPzh8xB9pn,fbPkOYLVPtPgIt0MxizjfFJov3JbHyAi,20,18,8,6,12,0,4,0,48,6.857142857142857,1,0.0,10,8,5,12,8,0,1,4,0,35,13,1
5724,54603,3dZz5nboCyxa8YKpUFHpHSa7N8m8WCDt,fbPkOYLVPtPgIt0MxizjfFJov3JbHyAi,2,0,0,0,0,0,5,0,5,0.7142857142857143,1,0.0,0,0,0,0,0,0,0,5,0,0,5,1
5725,54604,X3X3klM03RXeGUjty93sg2SlkZrg3xpQ,fbPkOYLVPtPgIt0MxizjfFJov3JbHyAi,21,44,25,7,10,0,10,0,96,13.714285714285714,4,0.0,9,25,6,10,35,0,1,10,0,50,46,1
5726,54605,68Y0pXhq9Lx2MQo0abFJCRjCfXDaWS2b,fbPkOYLVPtPgIt0MxizjfFJov3JbHyAi,5,4,0,0,0,0,3,0,7,1.0,1,0.0,0,0,0,0,4,0,0,3,0,0,7,1
5727,54606,JKXm7kCLnrEkQn6smb2KejU80afBEA8I,fbPkOYLVPtPgIt0MxizjfFJov3JbHyAi,7,2,1,0,1,2,6,0,12,1.7142857142857142,2,0.0,0,1,0,1,2,2,0,6,0,2,10,1
5728,54607,3ayJeMiC46YUIYHWS9RASqN9Dt7wyONm,fbPkOYLVPtPgIt0MxizjfFJov3JbHyAi,5,0,0,0,0,0,6,1,7,1.0,1,0.0,0,0,0,0,0,0,0,6,1,0,7,1
5729,54608,MrDXcYGCOMj7Og2GASLJ6dZyvLj00XPp,fbPkOYLVPtPgIt0MxizjfFJov3JbHyAi,1,0,0,0,0,0,1,0,1,0.14285714285714285,1,0.0,0,0,0,0,0,0,0,1,0,0,1,1
5730,54610,E4HSnpUkqI5y9XSTBy23MiGSddJydK2h,fbPkOYLVPtPgIt0MxizjfFJov3JbHyAi,5,2,1,0,1,0,2,0,6,0.8571428571428571,1,0.0,0,1,0,1,2,0,0,2,0,2,4,1
5731,54614,4dfnEKxHCmGabkBCiKHt5nKr3H7Bwo1x,fbPkOYLVPtPgIt0MxizjfFJov3JbHyAi,1,0,0,0,0,0,1,0,1,0.14285714285714285,1,0.0,0,0,0,0,0,0,0,1,0,0,1,1
5732,54615,FJLE8ZIB8tn8NP6ctFklhYObRCm7VWUC,fbPkOYLVPtPgIt0MxizjfFJov3JbHyAi,8,9,3,0,2,0,4,0,18,2.5714285714285716,1,0.0,0,3,0,2,9,0,0,4,0,5,13,1
5733,54616,cgTRAnMuMn887xEhHTcg5rpmYHHPoyIP,fbPkOYLVPtPgIt0MxizjfFJov3JbHyAi,60,129,62,44,36,58,23,1,353,50.42857142857143,8,0.0,51,62,40,36,78,58,4,23,1,189,164,0
5734,54617,v4j1wfop6EMQnhgchWfG3Fk2beob6Ah0,fbPkOYLVPtPgIt0MxizjfFJov3JbHyAi,8,2,2,0,2,0,3,0,9,1.2857142857142858,1,0.0,0,2,0,2,2,0,0,3,0,4,5,1
5735,54618,bgBEVIT7lED5jwl9T1xbuywAm7JQXaqp,fbPkOYLVPtPgIt0MxizjfFJov3JbHyAi,7,10,3,0,2,0,6,0,21,3.0,1,0.0,0,3,0,2,10,0,0,6,0,5,16,1
5736,54619,tWw75YIFgGadaRnkyPeGlfSVpk3ysa4L,fbPkOYLVPtPgIt0MxizjfFJov3JbHyAi,1,0,0,0,0,0,1,0,1,0.14285714285714285,1,0.0,0,0,0,0,0,0,0,1,0,0,1,1
5737,54620,z4EDsyht0TzSAKAyhX4LHmg2BH9dRlQd,fbPkOYLVPtPgIt0MxizjfFJov3JbHyAi,12,7,5,0,3,5,7,1,28,4.0,2,0.0,0,5,0,3,7,5,0,7,1,8,20,1
5738,54621,NBbu054C30RuH0I4yDic7caWEQZO4bn5,fbPkOYLVPtPgIt0MxizjfFJov3JbHyAi,21,43,12,13,11,11,14,1,105,15.0,4,0.0,15,12,10,11,28,11,3,14,1,48,57,1
5739,54622,X8MvmBWiv5czlgrpqB1eLRykN3Qwf2jh,fbPkOYLVPtPgIt0MxizjfFJov3JbHyAi,1,0,0,0,0,0,1,0,1,0.14285714285714285,1,0.0,0,0,0,0,0,0,0,1,0,0,1,1
5740,54624,PC4EL6B63vuOYbykrnGpiuWu1FrHfz8b,fbPkOYLVPtPgIt0MxizjfFJov3JbHyAi,6,6,1,0,1,0,2,0,10,1.4285714285714286,1,0.0,1,1,0,1,5,0,0,2,0,3,7,1
5741,54625,OJlmjkvuQW4IsXhvjyjAhhq68S3friGW,fbPkOYLVPtPgIt0MxizjfFJov3JbHyAi,28,54,20,19,20,8,12,2,135,19.285714285714285,4,0.0,29,20,16,20,25,8,3,12,2,85,50,1
5742,54627,oW31TfZT4sMwKphpcFRVlAdMfoQmLRUC,fbPkOYLVPtPgIt0MxizjfFJov3JbHyAi,1,0,0,0,0,0,1,0,1,0.14285714285714285,1,0.0,0,0,0,0,0,0,0,1,0,0,1,1
5743,54628,KaJKU9td3vSh2K6R1qjWlYSN0w1tZztZ,fbPkOYLVPtPgIt0MxizjfFJov3JbHyAi,1,0,0,0,0,0,1,0,1,0.14285714285714285,1,0.0,0,0,0,0,0,0,0,1,0,0,1,1
5744,54629,AkvoyA0ovU8KwnK8lPG0oOHqQo6t4vfK,fbPkOYLVPtPgIt0MxizjfFJov3JbHyAi,34,40,30,0,19,6,22,2,119,17.0,3,0.0,3,30,0,19,37,6,0,22,2,52,67,1
5745,54630,vzQWE9ulRkQ7hUrO1Cw0UEGI4ALwL8Jg,fbPkOYLVPtPgIt0MxizjfFJov3JbHyAi,5,2,1,0,1,0,2,0,6,0.8571428571428571,1,0.0,0,1,0,1,2,0,0,2,0,2,4,1
5746,54634,jg6mic3A2edNAJQLBV82OtqrTUZvWZsn,fbPkOYLVPtPgIt0MxizjfFJov3JbHyAi,2,0,0,0,0,0,2,0,2,0.2857142857142857,1,0.0,0,0,0,0,0,0,0,2,0,0,2,1
5747,54635,FocgTK7ZKP5rXdprEvR0U5yJcvk72CbF,fbPkOYLVPtPgIt0MxizjfFJov3JbHyAi,1,0,0,0,0,0,1,0,1,0.14285714285714285,1,0.0,0,0,0,0,0,0,0,1,0,0,1,1
5748,54636,pmZbE114x6R9Sm7IX225BSoFooNlDkab,fbPkOYLVPtPgIt0MxizjfFJov3JbHyAi,6,5,3,0,2,0,4,0,14,2.0,1,0.0,0,3,0,2,5,0,0,4,0,5,9,1
5749,54637,MUxj4zhJzjf6cGr6IrakP1EI9h9I48vr,fbPkOYLVPtPgIt0MxizjfFJov3JbHyAi,1,0,0,0,0,0,1,0,1,0.14285714285714285,1,0.0,0,0,0,0,0,0,0,1,0,0,1,1
5750,54639,yS4yakhBHc7NyuksINmBYVCnlqRezW4d,fbPkOYLVPtPgIt0MxizjfFJov3JbHyAi,6,3,1,0,1,1,4,0,10,1.4285714285714286,1,0.0,0,1,0,1,3,1,0,4,0,2,8,1
5751,54641,R6Dq5lnvFvykWq4BZFiSva1xi66sjtTX,fbPkOYLVPtPgIt0MxizjfFJov3JbHyAi,2,0,0,0,0,0,2,0,2,0.2857142857142857,1,0.0,0,0,0,0,0,0,0,2,0,0,2,1
5752,54643,2M96sKmnmm86XkJJ5fWbCFo098WJohWW,fbPkOYLVPtPgIt0MxizjfFJov3JbHyAi,1,0,0,0,0,0,1,0,1,0.14285714285714285,1,0.0,0,0,0,0,0,0,0,1,0,0,1,1
5753,54645,4HsvrccrEIKH8v4O0M12O72D4OeoBTHD,fbPkOYLVPtPgIt0MxizjfFJov3JbHyAi,2,0,0,0,0,0,2,0,2,0.2857142857142857,1,0.0,0,0,0,0,0,0,0,2,0,0,2,1
5754,54646,gLf8tcvfqgbiET6dKZOWAuUewpIVftFZ,fbPkOYLVPtPgIt0MxizjfFJov3JbHyAi,20,35,13,9,12,0,3,0,72,10.285714285714286,2,0.0,17,13,9,12,18,0,0,3,0,51,21,0
5755,54648,dPiM2rbWtOtubgVSYCUPyBbIkDj9J9Sy,fbPkOYLVPtPgIt0MxizjfFJov3JbHyAi,7,4,3,0,2,5,6,0,20,2.857142857142857,1,0.0,0,3,0,2,4,5,0,6,0,5,15,1
5756,54652,cs7jyCx1ujF4i5d03WipV8TsS1FQHKcf,fbPkOYLVPtPgIt0MxizjfFJov3JbHyAi,1,0,0,0,0,0,1,0,1,0.14285714285714285,1,0.0,0,0,0,0,0,0,0,1,0,0,1,1
5757,54654,e09uq36QgLuBVK5DERoejsHeMH2uPMRM,fbPkOYLVPtPgIt0MxizjfFJov3JbHyAi,1,0,0,0,0,0,1,0,1,0.14285714285714285,1,0.0,0,0,0,0,0,0,0,1,0,0,1,1
5758,54657,LKcdjugIkIE0PpSCrOwHezIGmXzBNzHJ,fbPkOYLVPtPgIt0MxizjfFJov3JbHyAi,9,4,3,0,3,0,2,0,12,1.7142857142857142,1,0.0,0,3,0,3,4,0,0,2,0,6,6,1
5759,54659,BV79vNEzTPlmR22unH2F5S3vLmcSI9HJ,fbPkOYLVPtPgIt0MxizjfFJov3JbHyAi,10,30,11,2,10,0,6,0,59,8.428571428571429,2,0.0,3,11,2,10,27,0,0,6,0,26,33,1
5760,54660,LG6VIza4JcQFFbXQ1PDBU7m3JeA6BbpC,fbPkOYLVPtPgIt0MxizjfFJov3JbHyAi,27,42,15,17,19,25,17,3,138,19.714285714285715,2,0.0,14,15,14,19,28,25,3,17,3,62,76,1
5761,54661,KdWukBGM6ubMnQd8k7slAlzFr5FmMMhw,fbPkOYLVPtPgIt0MxizjfFJov3JbHyAi,8,2,2,0,2,0,8,0,14,2.0,2,0.0,0,2,0,2,2,0,0,8,0,4,10,1
5762,54663,Cdt2szpMU9KahBjpAUW9oXon7wUux9EX,fbPkOYLVPtPgIt0MxizjfFJov3JbHyAi,6,4,1,0,0,0,5,0,10,1.4285714285714286,2,0.0,0,1,0,0,4,0,0,5,0,1,9,1
5763,54668,KEpGXvdRkmZf3PNthZY5jtIyu6Bw3Rlp,SpATywNh6bZuzm8s1ceuBUnMUAeoAHHw,45,54,29,24,12,8,32,1,160,22.857142857142858,6,0.0,13,29,22,12,41,8,2,32,1,76,84,1
5764,54690,goA9z819kccFvSfjnBmFLW5zxeJMJD6F,bWdj2GDclj5ofokWjzoa5jAwMkxCykd6,1,0,0,0,0,0,1,0,1,0.14285714285714285,1,0.0,0,0,0,0,0,0,0,1,0,0,1,1
5765,54700,Oi0KruZLNADobw8iF9nGECGXaaoz8di4,SpATywNh6bZuzm8s1ceuBUnMUAeoAHHw,9,21,1,19,0,17,3,0,61,8.714285714285714,2,0.0,10,1,18,0,11,17,1,3,0,29,32,0
5766,54721,5FY4ZrNjp3ms2uO9UJ9szCrbCrZUttRZ,7GRhBDsirIGkRZBtSMEzNTyDr2JQm4xx,5,3,1,0,1,0,1,0,6,0.8571428571428571,1,0.0,0,1,0,1,3,0,0,1,0,2,4,1
5767,54723,z5Ulo2w0cg5OjY2Cx9aYoywDQvm6hLIF,RXDvfPUBYFlVdlueBFbLW0mhhAyGEqpt,29,51,30,3,18,0,11,0,113,16.142857142857142,10,0.0,0,30,3,18,51,0,0,11,0,51,62,0
5768,54724,XfiCSk5eLAbq9rzQtnLkX2OQTd6M8xFG,bWdj2GDclj5ofokWjzoa5jAwMkxCykd6,48,67,29,62,11,40,35,0,244,34.857142857142854,7,0.0,12,29,61,11,55,40,1,35,0,113,131,0
5769,54731,EBk8CcgfO89MwmYfmQzxphOJxpVE6Uvu,bWdj2GDclj5ofokWjzoa5jAwMkxCykd6,7,3,1,0,1,3,8,0,16,2.2857142857142856,2,0.0,0,1,0,1,3,3,0,8,0,2,14,1
5770,54736,16QzaT3BGZQ3ycViO0KNFfkskSZdjqFw,SpATywNh6bZuzm8s1ceuBUnMUAeoAHHw,47,66,26,42,16,11,18,1,180,25.714285714285715,6,0.0,12,26,33,16,54,11,9,18,1,87,93,0
5771,54739,EBk8CcgfO89MwmYfmQzxphOJxpVE6Uvu,5X6FeZozNMgE2VRi3MJYjkkFK8SETtu2,1,0,0,0,0,0,1,0,1,0.14285714285714285,1,0.0,0,0,0,0,0,0,0,1,0,0,1,1
5772,54761,MfwWTipzPsRtzbyiOZCobMuGSNow3sHg,SpATywNh6bZuzm8s1ceuBUnMUAeoAHHw,14,19,13,5,8,0,4,0,49,7.0,3,0.0,0,13,4,8,19,0,1,4,0,25,24,0
5773,54765,WczGVRZMmNzgMggUe3ZQ1bOs2IuTwUWO,5X6FeZozNMgE2VRi3MJYjkkFK8SETtu2,1,0,0,0,0,0,1,0,1,0.14285714285714285,1,0.0,0,0,0,0,0,0,0,1,0,0,1,1
5774,54774,RxdtlMcw4rjm1ZlZfBelJCDeVB6xV1AQ,SpATywNh6bZuzm8s1ceuBUnMUAeoAHHw,16,14,7,19,4,0,2,0,46,6.571428571428571,1,0.0,6,7,18,4,8,0,1,2,0,35,11,1
5775,54792,Q7Wy56y25KB2WjBLql9AoH2Qdj9xO94M,SpATywNh6bZuzm8s1ceuBUnMUAeoAHHw,1,0,0,0,0,0,1,0,1,0.14285714285714285,1,0.0,0,0,0,0,0,0,0,1,0,0,1,1
5776,54800,OseLd0Vj4CawbZPfZRznLZH5tivxQP68,SpATywNh6bZuzm8s1ceuBUnMUAeoAHHw,7,2,2,0,2,0,3,0,9,1.2857142857142858,2,0.0,0,2,0,2,2,0,0,3,0,4,5,1
5777,54807,CyhW9ceUO9NYz6xFgPeXoLjeNitx4OvW,bWdj2GDclj5ofokWjzoa5jAwMkxCykd6,1,0,0,0,0,0,1,0,1,0.14285714285714285,1,0.0,0,0,0,0,0,0,0,1,0,0,1,1
5778,54810,T6JGf7KDvuej9SKYUMtG3FHgkPZQV429,A3fsA9Zfv1X2fVEQhTw51lKENdNrEqT3,70,52,38,0,34,0,6,0,130,18.571428571428573,4,0.0,3,38,0,34,49,0,0,6,0,75,55,0
5779,54811,CyhW9ceUO9NYz6xFgPeXoLjeNitx4OvW,A3fsA9Zfv1X2fVEQhTw51lKENdNrEqT3,1,0,0,0,0,0,1,0,1,0.14285714285714285,1,0.0,0,0,0,0,0,0,0,1,0,0,1,1
5780,54819,PkEcTe3rugNe3WrTlhHnV7MduvQXThEB,RXDvfPUBYFlVdlueBFbLW0mhhAyGEqpt,8,21,12,0,0,0,4,0,37,5.285714285714286,3,0.0,4,12,0,0,17,0,0,4,0,16,21,1
5781,54823,NNTbkWufZqd6OEZ4OfeDtmQCNI4vEzJo,A3fsA9Zfv1X2fVEQhTw51lKENdNrEqT3,23,11,10,0,10,0,6,0,37,5.285714285714286,3,0.0,0,10,0,10,11,0,0,6,0,20,17,1
5782,54827,ZwPBK7fW5s99bkJqWGxirmPrZf0cW4rp,A3fsA9Zfv1X2fVEQhTw51lKENdNrEqT3,47,88,41,0,29,1,9,0,168,24.0,4,0.0,0,41,0,29,88,1,0,9,0,70,98,0
5783,54837,2AWz8OiYqJqT0VYmevCkAuxaVCSl88oB,7GRhBDsirIGkRZBtSMEzNTyDr2JQm4xx,1,0,0,0,0,0,1,0,1,0.14285714285714285,1,0.0,0,0,0,0,0,0,0,1,0,0,1,1
5784,54838,mPNkb6VG8jFY8g5rcOoX3iIx4F3q09nE,SpATywNh6bZuzm8s1ceuBUnMUAeoAHHw,2,0,0,0,0,0,2,0,2,0.2857142857142857,1,0.0,0,0,0,0,0,0,0,2,0,0,2,1
5785,54839,2AWz8OiYqJqT0VYmevCkAuxaVCSl88oB,RXDvfPUBYFlVdlueBFbLW0mhhAyGEqpt,2,0,0,0,0,0,2,0,2,0.2857142857142857,1,0.0,0,0,0,0,0,0,0,2,0,0,2,0
5786,54847,PJax8eefw80yapFhrp3A2CEHvokzQQrL,SpATywNh6bZuzm8s1ceuBUnMUAeoAHHw,5,2,1,0,1,0,2,0,6,0.8571428571428571,1,0.0,0,1,0,1,2,0,0,2,0,2,4,1
5787,54869,M1VrwOWjiMnBueo7ci4JBR246P3AJPFN,A3fsA9Zfv1X2fVEQhTw51lKENdNrEqT3,1,0,0,0,0,0,1,0,1,0.14285714285714285,1,0.0,0,0,0,0,0,0,0,1,0,0,1,1
5788,54871,H2pnCC5fUi5Ho09aPqAE97vnlsM8FGBU,bWdj2GDclj5ofokWjzoa5jAwMkxCykd6,9,12,8,12,2,1,4,0,39,5.571428571428571,3,0.0,0,8,9,2,12,1,3,4,0,19,20,1
5789,54876,tVqiyi20xeAPqMyQ1qSspr9PuF7fr80u,SpATywNh6bZuzm8s1ceuBUnMUAeoAHHw,17,29,14,1,6,3,9,0,62,8.857142857142858,3,0.0,9,14,1,6,20,3,0,9,0,30,32,1
5790,54879,bT6yH99PTuyz3a6ueCehCDHIMjMdNYHB,SpATywNh6bZuzm8s1ceuBUnMUAeoAHHw,17,20,9,18,4,7,4,0,62,8.857142857142858,3,0.0,6,9,15,4,14,7,3,4,0,34,28,1
5791,54897,2DBJY0D6vIAPQoXDRvKdizih9jCV7Kvf,SpATywNh6bZuzm8s1ceuBUnMUAeoAHHw,14,13,2,5,1,1,4,0,26,3.7142857142857144,2,0.0,0,2,4,1,13,1,1,4,0,7,19,0
5792,54904,LP0Jcdn3SCKZzldDBUXhHgzQTRBhcAFC,SpATywNh6bZuzm8s1ceuBUnMUAeoAHHw,1,0,0,0,0,0,1,0,1,0.14285714285714285,1,0.0,0,0,0,0,0,0,0,1,0,0,1,1
5793,54910,L8A0UDBue4RuYlwBFsU412yruT49eHlP,7GRhBDsirIGkRZBtSMEzNTyDr2JQm4xx,6,4,1,0,0,0,8,0,13,1.8571428571428572,1,0.0,0,1,0,0,4,0,0,8,0,1,12,1
5794,54911,BY9YLSZcQDQQEQ3MNU6DAt6np51iLH0O,SpATywNh6bZuzm8s1ceuBUnMUAeoAHHw,3,2,0,0,0,0,1,0,3,0.42857142857142855,1,0.0,0,0,0,0,2,0,0,1,0,0,3,1
5795,54928,PrE64zhEuNh83grWL2cXaZZPY2nI1xUf,SpATywNh6bZuzm8s1ceuBUnMUAeoAHHw,1,0,0,0,0,1,0,0,1,0.14285714285714285,1,0.0,0,0,0,0,0,1,0,0,0,0,1,0
5796,54937,o076ufFxYjFcAtg8dPv0W5vwk5oKbSiz,SpATywNh6bZuzm8s1ceuBUnMUAeoAHHw,13,29,18,0,7,0,11,1,66,9.428571428571429,6,0.0,0,18,0,7,29,0,0,11,1,25,41,1
5797,54938,EoOFKLnEYmufwMQdHqSZZDxomOFT0KCX,SpATywNh6bZuzm8s1ceuBUnMUAeoAHHw,4,5,1,0,0,0,4,0,10,1.4285714285714286,1,0.0,0,1,0,0,5,0,0,4,0,1,9,1
5798,54942,ijpfz5cJPrusRBczJIwOiwlUzdR9aysy,SpATywNh6bZuzm8s1ceuBUnMUAeoAHHw,38,49,25,23,11,0,19,0,127,18.142857142857142,7,0.0,16,25,22,11,33,0,1,19,0,74,53,0
5799,54944,ak9H3u3GmnBMjkxaXtGHxcLDDF2zUXnS,7GRhBDsirIGkRZBtSMEzNTyDr2JQm4xx,2,0,0,0,0,0,3,0,3,0.42857142857142855,1,0.0,0,0,0,0,0,0,0,3,0,0,3,1
5800,54945,Tx73qWK6TWa0dZ4Atd8qRPel2HBsO6lU,SpATywNh6bZuzm8s1ceuBUnMUAeoAHHw,4,1,0,0,0,0,4,0,5,0.7142857142857143,1,0.0,0,0,0,0,1,0,0,4,0,0,5,1
5801,54951,5ZHw0M7FTk5cO1fK8KsZKsofS7GANtcz,RXDvfPUBYFlVdlueBFbLW0mhhAyGEqpt,1,0,0,0,0,0,1,0,1,0.14285714285714285,1,0.0,0,0,0,0,0,0,0,1,0,0,1,1
5802,54959,7l6N3NrTQYFrf5h1HstsMDlVYWOdk0w2,SpATywNh6bZuzm8s1ceuBUnMUAeoAHHw,7,4,1,0,1,0,4,0,10,1.4285714285714286,1,0.0,0,1,0,1,4,0,0,4,0,2,8,1
5803,54966,sazaFVrhkSRDlyN7NAZCwVsSjFg3v04q,SpATywNh6bZuzm8s1ceuBUnMUAeoAHHw,1,0,0,0,0,0,1,0,1,0.14285714285714285,1,0.0,0,0,0,0,0,0,0,1,0,0,1,1
5804,54973,KIPXc8MOqmnlmMqnIzIeaBqliIw9pS44,A3fsA9Zfv1X2fVEQhTw51lKENdNrEqT3,17,13,9,0,5,0,13,1,41,5.857142857142857,3,0.0,0,9,0,5,13,0,0,13,1,14,27,1
5805,54974,6G9LhtuC4WRjtVlDXOsvFj9Bvx98BbnJ,bWdj2GDclj5ofokWjzoa5jAwMkxCykd6,8,5,3,0,2,0,9,1,20,2.857142857142857,1,0.0,0,3,0,2,5,0,0,9,1,5,15,1
5806,54989,DUw85TcNpxyZaZKIM1HlHxvgtSm7uwxY,A3fsA9Zfv1X2fVEQhTw51lKENdNrEqT3,7,3,1,0,1,0,9,1,15,2.142857142857143,3,0.0,0,1,0,1,3,0,0,9,1,2,13,1
5807,54993,sY9TePhZjFIEI666AS8T1sarfUUaa8vk,5X6FeZozNMgE2VRi3MJYjkkFK8SETtu2,1,0,0,0,0,0,1,0,1,0.14285714285714285,1,0.0,0,0,0,0,0,0,0,1,0,0,1,1
5808,54994,sY9TePhZjFIEI666AS8T1sarfUUaa8vk,bWdj2GDclj5ofokWjzoa5jAwMkxCykd6,1,0,0,0,0,0,1,0,1,0.14285714285714285,1,0.0,0,0,0,0,0,0,0,1,0,0,1,1
5809,54999,4RUK0a6HkZbpdBgheC58rw27wDnlPa70,7GRhBDsirIGkRZBtSMEzNTyDr2JQm4xx,10,8,3,0,4,2,5,1,23,3.2857142857142856,1,0.0,4,3,0,4,4,2,0,5,1,11,12,1
5810,55018,j2cyViq0dJomWYIOYnP2unh4khXf8CIF,SpATywNh6bZuzm8s1ceuBUnMUAeoAHHw,4,2,0,0,0,0,2,0,4,0.5714285714285714,1,0.0,0,0,0,0,2,0,0,2,0,0,4,0
5811,55022,dChjFm9SF9SHITReJylSFO5QWMAx2ciJ,A3fsA9Zfv1X2fVEQhTw51lKENdNrEqT3,1,0,0,0,0,0,1,0,1,0.14285714285714285,1,0.0,0,0,0,0,0,0,0,1,0,0,1,1
5812,55026,7GuXtdTnAtax3FkfgWewqF5JrGz1oCyt,7GRhBDsirIGkRZBtSMEzNTyDr2JQm4xx,1,0,0,0,0,0,1,0,1,0.14285714285714285,1,0.0,0,0,0,0,0,0,0,1,0,0,1,1
5813,55039,0Au7FrQGJI1dB5PAH0C5RtkL9GE7xsrQ,SpATywNh6bZuzm8s1ceuBUnMUAeoAHHw,18,32,13,0,8,1,10,0,64,9.142857142857142,7,0.0,1,13,0,8,31,1,0,10,0,22,42,1
5814,55045,E0Blx9HE2elltXbYcGSTffe9JEV6Z2iZ,A3fsA9Zfv1X2fVEQhTw51lKENdNrEqT3,72,28,21,144,14,0,13,1,221,31.571428571428573,2,0.0,3,21,121,14,25,0,23,13,1,159,62,0
5815,55051,ZuvVADnqMaprUOeHuBezreM7CKPKteSc,SpATywNh6bZuzm8s1ceuBUnMUAeoAHHw,11,9,3,8,1,0,2,0,23,3.2857142857142856,2,0.0,0,3,8,1,9,0,0,2,0,12,11,0
5816,55058,rPyu4cIbS3LCjrN2mpvx4iaQSTgSq9Ou,A3fsA9Zfv1X2fVEQhTw51lKENdNrEqT3,7,6,0,4,0,0,3,0,13,1.8571428571428572,1,0.0,0,0,4,0,6,0,0,3,0,4,9,0
5817,55082,UbxAJQUpM4nPUifCeu8NjmX0juFyLMFH,SpATywNh6bZuzm8s1ceuBUnMUAeoAHHw,31,36,2,42,1,3,10,0,94,13.428571428571429,6,0.0,6,2,38,1,30,3,4,10,0,47,47,1
5818,55085,Urb6ZsqNoXv3PA7YJFXeq2bBJzv2VAN5,SpATywNh6bZuzm8s1ceuBUnMUAeoAHHw,11,26,0,16,0,0,2,0,44,6.285714285714286,1,0.0,14,0,15,0,12,0,1,2,0,29,15,1
5819,55105,5ysSxswt94Gjj7n5OSEcRzDBWhgbKFUg,7GRhBDsirIGkRZBtSMEzNTyDr2JQm4xx,8,11,4,6,4,0,2,0,27,3.857142857142857,2,0.0,5,4,5,4,6,0,1,2,0,18,9,1
5820,55113,nrfTofFWRzT5axwsEM3PpLmORUpN9eKo,SpATywNh6bZuzm8s1ceuBUnMUAeoAHHw,4,3,2,0,2,0,2,0,9,1.2857142857142858,1,0.0,0,2,0,2,3,0,0,2,0,4,5,1
5821,55114,7U7MZiTthIrdSyitYp5jXYVRqrLWtNBu,7GRhBDsirIGkRZBtSMEzNTyDr2JQm4xx,11,10,0,0,0,0,4,0,14,2.0,1,0.0,0,0,0,0,10,0,0,4,0,0,14,1
5822,55115,gNne9bdjxLwaUTIwTm8OmxkhOqWbx1zf,bWdj2GDclj5ofokWjzoa5jAwMkxCykd6,1,0,0,0,0,0,1,0,1,0.14285714285714285,1,0.0,0,0,0,0,0,0,0,1,0,0,1,1
5823,55123,7U7MZiTthIrdSyitYp5jXYVRqrLWtNBu,5X6FeZozNMgE2VRi3MJYjkkFK8SETtu2,9,9,1,0,1,0,4,0,15,2.142857142857143,1,0.0,0,1,0,1,9,0,0,4,0,2,13,1
5824,55135,GaaUSAn7OjFLzHXXBEBVyi3shjmvN0lH,A3fsA9Zfv1X2fVEQhTw51lKENdNrEqT3,8,13,8,0,5,0,3,0,29,4.142857142857143,2,0.0,0,8,0,5,13,0,0,3,0,13,16,1
5825,55151,xBGnGb4xFBdhBVCY9WqghW7DBVBeUQyg,A3fsA9Zfv1X2fVEQhTw51lKENdNrEqT3,17,14,7,0,4,3,16,4,48,6.857142857142857,2,0.0,0,7,0,4,14,3,0,16,4,11,37,1
5826,55155,AYeDEDyu9LwDiPuNM8LqOlU9NVVRa6au,A3fsA9Zfv1X2fVEQhTw51lKENdNrEqT3,16,35,1,10,1,2,3,0,52,7.428571428571429,1,0.0,2,1,8,1,33,2,2,3,0,12,40,1
5827,55164,ELrr1JfnDsWjEvT48HXDtL9YqiQpfZmF,A3fsA9Zfv1X2fVEQhTw51lKENdNrEqT3,22,15,11,0,10,0,3,0,39,5.571428571428571,2,0.0,1,11,0,10,14,0,0,3,0,22,17,1
5828,55166,gKSJfTKRpPRCZVoRPeT84zeHU3dzpwjK,RXDvfPUBYFlVdlueBFbLW0mhhAyGEqpt,1,0,0,0,0,0,1,0,1,0.14285714285714285,1,0.0,0,0,0,0,0,0,0,1,0,0,1,1
5829,55180,JKdQMqi4dha8K2v4FbAwEfzazmC4IqdJ,SpATywNh6bZuzm8s1ceuBUnMUAeoAHHw,1,0,0,0,0,0,1,0,1,0.14285714285714285,1,0.0,0,0,0,0,0,0,0,1,0,0,1,1
5830,55182,VF14jDCwIzSb92Zq60K5zB8BaUbLT4fN,A3fsA9Zfv1X2fVEQhTw51lKENdNrEqT3,62,51,2,175,1,5,7,0,241,34.42857142857143,2,0.0,7,2,150,1,44,5,25,7,0,160,81,1
5831,55188,bUoqFmbvMs2kDsdZ9ItKtLQ4XhI3NVJ3,bWdj2GDclj5ofokWjzoa5jAwMkxCykd6,4,2,0,0,0,17,2,1,22,3.142857142857143,1,0.0,0,0,0,0,2,17,0,2,1,0,22,0
5832,55190,T71AtVPaJkGSIyo6SH0vxJiIfo9P5xoJ,bWdj2GDclj5ofokWjzoa5jAwMkxCykd6,1,0,0,0,0,0,3,0,3,0.42857142857142855,2,0.0,0,0,0,0,0,0,0,3,0,0,3,0
5833,55191,T71AtVPaJkGSIyo6SH0vxJiIfo9P5xoJ,A3fsA9Zfv1X2fVEQhTw51lKENdNrEqT3,1,0,0,0,0,0,1,0,1,0.14285714285714285,1,0.0,0,0,0,0,0,0,0,1,0,0,1,0
5834,55205,tjOYFkIRp5PgOsGOEKpZq20Cj6O439Op,bWdj2GDclj5ofokWjzoa5jAwMkxCykd6,4,7,2,0,1,0,2,0,12,1.7142857142857142,1,0.0,3,2,0,1,4,0,0,2,0,6,6,1
5835,55211,JcJgQocWkVJNrenjTE31xbqKDeCKKpym,G8EPVSXsOYB5YQWZGiz1aVq5Pgr2GrQu,8,6,5,0,0,0,2,0,13,1.8571428571428572,1,0.0,0,5,0,0,6,0,0,2,0,5,8,1
5836,55214,njTQZJN9KnLBVMzmSgwxd8LilddPxYw5,5X6FeZozNMgE2VRi3MJYjkkFK8SETtu2,5,2,1,0,1,0,2,0,6,0.8571428571428571,1,0.0,0,1,0,1,2,0,0,2,0,2,4,1
5837,55215,RHl3DsvAX7TisJ7qBptmgrrtDAQvH7mr,7GRhBDsirIGkRZBtSMEzNTyDr2JQm4xx,5,4,2,0,1,0,2,0,9,1.2857142857142858,2,0.0,0,2,0,1,4,0,0,2,0,3,6,1
5838,55220,nPRsjektHdbQkeAf1fIK4JbhrESPbPsA,RXDvfPUBYFlVdlueBFbLW0mhhAyGEqpt,9,9,2,0,1,2,6,1,21,3.0,2,0.0,0,2,0,1,9,2,0,6,1,3,18,1
5839,55230,aoDaUNT8Ab84EPMGNmI2OJb9XhPOK2AW,5X6FeZozNMgE2VRi3MJYjkkFK8SETtu2,2,0,0,0,0,0,3,0,3,0.42857142857142855,1,0.0,0,0,0,0,0,0,0,3,0,0,3,1
5840,55252,SFUf9a1eQYyFSfDqOIKMZYV7yqLnThV1,SpATywNh6bZuzm8s1ceuBUnMUAeoAHHw,44,56,6,42,4,1,7,0,116,16.571428571428573,6,0.0,7,6,40,4,49,1,2,7,0,57,59,0
5841,55258,YJeMkd3jz6x14dPiy98P6Q1CUjEPbHyt,SpATywNh6bZuzm8s1ceuBUnMUAeoAHHw,2,0,0,0,0,0,2,0,2,0.2857142857142857,1,0.0,0,0,0,0,0,0,0,2,0,0,2,1
5842,55266,ynnzmwoHbOAMevzqq5Q1QxkJp0HBCaYR,5X6FeZozNMgE2VRi3MJYjkkFK8SETtu2,2,0,0,0,0,0,2,0,2,0.2857142857142857,1,0.0,0,0,0,0,0,0,0,2,0,0,2,1
5843,55272,AwH7D2KycefughRmQIRA3p8DlN7XohhR,SpATywNh6bZuzm8s1ceuBUnMUAeoAHHw,7,6,4,0,0,0,5,0,15,2.142857142857143,1,0.0,0,4,0,0,6,0,0,5,0,4,11,1
5844,55286,XmfaTDISWF5comI3j0oigEszknbdPhWn,5X6FeZozNMgE2VRi3MJYjkkFK8SETtu2,1,0,0,0,0,0,1,0,1,0.14285714285714285,1,0.0,0,0,0,0,0,0,0,1,0,0,1,1
5845,55295,XmfaTDISWF5comI3j0oigEszknbdPhWn,7GRhBDsirIGkRZBtSMEzNTyDr2JQm4xx,1,0,0,0,0,0,2,0,2,0.2857142857142857,1,0.0,0,0,0,0,0,0,0,2,0,0,2,1
5846,55298,XmfaTDISWF5comI3j0oigEszknbdPhWn,SpATywNh6bZuzm8s1ceuBUnMUAeoAHHw,1,0,0,0,0,0,1,0,1,0.14285714285714285,1,0.0,0,0,0,0,0,0,0,1,0,0,1,1
5847,55300,XmfaTDISWF5comI3j0oigEszknbdPhWn,bWdj2GDclj5ofokWjzoa5jAwMkxCykd6,1,0,0,0,0,0,1,0,1,0.14285714285714285,1,0.0,0,0,0,0,0,0,0,1,0,0,1,0
5848,55317,eC2ad02aL61OuzveX2kkkz9OFa5jN0xs,SpATywNh6bZuzm8s1ceuBUnMUAeoAHHw,1,0,0,0,0,0,1,0,1,0.14285714285714285,1,0.0,0,0,0,0,0,0,0,1,0,0,1,1
5849,55318,IbBBT7oGA5eW3cwYlSN4uNF6XN76bEJ4,RXDvfPUBYFlVdlueBFbLW0mhhAyGEqpt,1,0,0,0,0,0,1,0,1,0.14285714285714285,1,0.0,0,0,0,0,0,0,0,1,0,0,1,1
5850,55343,YPEupTuOqSGieSSneZcv3AcUcSBCtbGY,7GRhBDsirIGkRZBtSMEzNTyDr2JQm4xx,8,10,1,6,1,1,3,0,22,3.142857142857143,2,0.0,3,1,5,1,7,1,1,3,0,10,12,1
5851,55346,7bnGjPq4sg9VhmEEoEqqXHNgeEpEuUDV,SpATywNh6bZuzm8s1ceuBUnMUAeoAHHw,29,33,13,20,7,21,9,2,105,15.0,6,0.0,5,13,20,7,28,21,0,9,2,45,60,0
5852,55350,FbrKChJI6NE19RCUX3nZg6RKzVDriIZa,7GRhBDsirIGkRZBtSMEzNTyDr2JQm4xx,1,0,0,0,0,0,1,0,1,0.14285714285714285,1,0.0,0,0,0,0,0,0,0,1,0,0,1,1
5853,55358,eeotL07J3Y8VeL6DbnIqkm9FhuiNkg7O,SpATywNh6bZuzm8s1ceuBUnMUAeoAHHw,34,34,21,0,13,4,18,2,92,13.142857142857142,6,0.0,7,21,0,13,27,4,0,18,2,41,51,0
5854,55376,avsFLymnsxrXULvKpllQNNUZoqF0bJ35,SpATywNh6bZuzm8s1ceuBUnMUAeoAHHw,37,37,17,31,10,0,6,1,102,14.571428571428571,4,0.0,6,17,29,10,31,0,2,6,1,62,40,0
5855,55402,OHCPSNCvfiPAnB9Qj7bWGHtZV42QZ1Uv,SpATywNh6bZuzm8s1ceuBUnMUAeoAHHw,14,22,5,17,3,1,4,1,53,7.571428571428571,1,0.0,16,5,16,3,6,1,1,4,1,40,13,1
5856,55406,u3Hn1s5XHCNiAXpJABAcauLSB7bNmrfy,bWdj2GDclj5ofokWjzoa5jAwMkxCykd6,3,2,1,0,0,0,1,0,4,0.5714285714285714,1,0.0,0,1,0,0,2,0,0,1,0,1,3,1
5857,55409,LuPgMCIdX2ugHzDAngaEsA394qOat0id,7GRhBDsirIGkRZBtSMEzNTyDr2JQm4xx,4,6,1,0,1,0,1,0,9,1.2857142857142858,1,0.0,3,1,0,1,3,0,0,1,0,5,4,1
5858,55415,uVEyIFBybJdw7i4BVUfdVmm3z7A34ZCY,bWdj2GDclj5ofokWjzoa5jAwMkxCykd6,25,16,13,14,8,6,4,1,62,8.857142857142858,1,0.0,1,13,7,8,15,6,7,4,1,29,33,0
5859,55425,iDV5to1cYevkdTWvpbQHbqC1rLSJxp3m,SpATywNh6bZuzm8s1ceuBUnMUAeoAHHw,56,82,40,41,24,11,14,0,212,30.285714285714285,5,0.0,25,40,38,24,57,11,3,14,0,127,85,0
5860,55427,n5fmXY7W3OsRId8yMehdsktfc1GCY6un,7GRhBDsirIGkRZBtSMEzNTyDr2JQm4xx,16,20,10,34,3,12,4,0,83,11.857142857142858,1,0.0,6,10,28,3,14,12,6,4,0,47,36,0
5861,55436,jhFpPMLGec23OmPqsOtaYaFXaKHweZzI,A3fsA9Zfv1X2fVEQhTw51lKENdNrEqT3,15,11,2,0,2,1,11,1,28,4.0,2,0.0,0,2,0,2,11,1,0,11,1,4,24,1
5862,55448,gACW4eW6IndswRGYovdbuYWVGeoweSw7,5X6FeZozNMgE2VRi3MJYjkkFK8SETtu2,17,32,1,34,17,0,1,0,85,12.142857142857142,1,0.0,26,1,28,17,6,0,6,1,0,72,13,1
5863,55462,zL30XztkWYaGUamoGfokQV3dBHPTpud2,SpATywNh6bZuzm8s1ceuBUnMUAeoAHHw,4,2,0,0,0,0,2,0,4,0.5714285714285714,1,0.0,0,0,0,0,2,0,0,2,0,0,4,1
5864,55468,kYJNxYDAilMvu34mGr6cbIsnQA0irwNN,bWdj2GDclj5ofokWjzoa5jAwMkxCykd6,10,7,3,0,3,0,7,0,20,2.857142857142857,3,0.0,0,3,0,3,7,0,0,7,0,6,14,0
5865,55475,mDHr8WvVVX9KSvXMqxtLvZ6vP4uuNF6E,SpATywNh6bZuzm8s1ceuBUnMUAeoAHHw,29,59,3,49,1,9,15,4,140,20.0,2,0.0,25,3,39,1,34,9,10,15,4,68,72,1
5866,55483,C4q4gNQYEpjKh7pq1qjN8i3L7uSpUX9d,A3fsA9Zfv1X2fVEQhTw51lKENdNrEqT3,129,121,66,360,46,1,23,2,619,88.42857142857143,9,0.0,3,66,302,46,118,1,58,23,2,417,202,0
5867,55489,vCm3LfZ9M6wOLWnqELTZFsk5hnCTaEbi,SpATywNh6bZuzm8s1ceuBUnMUAeoAHHw,35,67,7,39,2,12,22,4,153,21.857142857142858,6,0.0,21,7,33,2,46,12,6,22,4,63,90,0
5868,55501,8Yib6PEBmIeNqpZ6dKYrUB3VUPCxqdYG,SpATywNh6bZuzm8s1ceuBUnMUAeoAHHw,1,0,0,0,0,0,2,0,2,0.2857142857142857,2,0.0,0,0,0,0,0,0,0,2,0,0,2,1
5869,55505,3DMtg3Ou9e33dDThiO2ndZwS8d6akzB7,RXDvfPUBYFlVdlueBFbLW0mhhAyGEqpt,24,34,2,0,4,2,9,0,51,7.285714285714286,4,0.0,3,2,0,4,31,2,0,9,0,9,42,0
5870,55511,g1maG24WsPdpEOMuZUsxQc7SlEYHJjT4,SpATywNh6bZuzm8s1ceuBUnMUAeoAHHw,12,28,13,0,7,0,6,0,54,7.714285714285714,2,0.0,6,13,0,7,22,0,0,6,0,26,28,1
5871,55516,lgS8T7X8MPl4rnyyVo63W82KpUI1LtmK,SpATywNh6bZuzm8s1ceuBUnMUAeoAHHw,15,16,8,14,3,0,3,0,44,6.285714285714286,2,0.0,6,8,12,3,10,0,2,3,0,29,15,1
5872,55524,Sle0t5zy0VbRjUdpojBY9wV6zuG12LCM,A3fsA9Zfv1X2fVEQhTw51lKENdNrEqT3,34,14,10,48,7,3,4,0,86,12.285714285714286,3,0.0,1,10,45,7,13,3,3,4,0,63,23,1
5873,55531,icc28ggRdRmZu2r1UuNBMEMav6yv5QTB,7GRhBDsirIGkRZBtSMEzNTyDr2JQm4xx,1,0,0,0,0,0,1,0,1,0.14285714285714285,1,0.0,0,0,0,0,0,0,0,1,0,0,1,1
5874,55532,vrKNA3eEZxLntZreFchejbQ8UgnPaTUE,RXDvfPUBYFlVdlueBFbLW0mhhAyGEqpt,98,112,65,132,36,2,9,0,356,50.857142857142854,4,0.0,34,65,127,36,78,2,5,9,0,262,94,1
5875,55536,lVM3D8yPmd62Fdb29hI2YI0VPwlNvI4t,7GRhBDsirIGkRZBtSMEzNTyDr2JQm4xx,5,2,1,0,1,0,3,0,7,1.0,2,0.0,0,1,0,1,2,0,0,3,0,2,5,1
5876,55537,QN2mu01aS3iQpw1z3TFQyQa0hQWsCjGH,SpATywNh6bZuzm8s1ceuBUnMUAeoAHHw,35,90,47,43,0,10,35,5,230,32.857142857142854,5,0.0,23,47,36,0,67,10,7,35,5,106,124,0
5877,55551,Lk947zUxODvAz9uAzr7LhEhqya4oVnNV,bWdj2GDclj5ofokWjzoa5jAwMkxCykd6,2,0,0,0,0,0,3,0,3,0.42857142857142855,2,0.0,0,0,0,0,0,0,0,3,0,0,3,0
5878,55553,cOOKiwY8YqGykJyWVpEjwjg32qCVI2h5,SpATywNh6bZuzm8s1ceuBUnMUAeoAHHw,17,11,8,12,7,0,3,0,41,5.857142857142857,2,0.0,2,8,12,7,9,0,0,3,0,29,12,0
5879,55556,Pg0gXikYsatKV6C2YLhl2LUFEvJuK423,SpATywNh6bZuzm8s1ceuBUnMUAeoAHHw,6,3,1,0,1,0,3,0,8,1.1428571428571428,2,0.0,0,1,0,1,3,0,0,3,0,2,6,1
5880,55557,FELnhQR0c7GZZX82ioYJEZsqujOrfyf7,SpATywNh6bZuzm8s1ceuBUnMUAeoAHHw,9,7,4,0,2,9,12,1,35,5.0,3,0.0,0,4,0,2,7,9,0,12,1,6,29,1
5881,55560,NGCjg1L5IFyOkl1pLM5r5gRwzJYb60Ux,7GRhBDsirIGkRZBtSMEzNTyDr2JQm4xx,1,0,0,0,0,0,2,0,2,0.2857142857142857,1,0.0,0,0,0,0,0,0,0,2,0,0,2,1
5882,55573,9MJtonlQxxOCrYvWkEprq1yVcFsrnJFZ,SpATywNh6bZuzm8s1ceuBUnMUAeoAHHw,19,29,13,0,9,0,7,0,58,8.285714285714286,4,0.0,0,13,0,9,29,0,0,7,0,22,36,1
5883,55584,ZYiV7TFt5Ex9C4qMS4F6xM653Evkxqg5,G8EPVSXsOYB5YQWZGiz1aVq5Pgr2GrQu,1,0,0,0,0,0,1,0,1,0.14285714285714285,1,0.0,0,0,0,0,0,0,0,1,0,0,1,1
5884,55591,9t2KBUQ5GiAw5lDqGOd0BuKNW0LVvTVG,A3fsA9Zfv1X2fVEQhTw51lKENdNrEqT3,77,80,45,158,19,0,17,0,319,45.57142857142857,8,0.0,15,45,135,19,65,0,23,17,0,214,105,0
5885,55593,9t2KBUQ5GiAw5lDqGOd0BuKNW0LVvTVG,bWdj2GDclj5ofokWjzoa5jAwMkxCykd6,56,110,52,118,17,15,29,1,342,48.857142857142854,11,0.0,23,52,107,17,87,15,11,29,1,199,143,0
5886,55604,kUTtwBKG3vzyymERNLukoy5hQ6c4zXj6,G8EPVSXsOYB5YQWZGiz1aVq5Pgr2GrQu,1,0,0,0,0,0,1,0,1,0.14285714285714285,1,0.0,0,0,0,0,0,0,0,1,0,0,1,1
5887,55610,j38sS48yyjSQUQ4EfqmBmZ0QyWUgAHfx,A3fsA9Zfv1X2fVEQhTw51lKENdNrEqT3,11,5,4,0,4,0,2,0,15,2.142857142857143,1,0.0,0,4,0,4,5,0,0,2,0,8,7,1
5888,55624,QOwpzKqFZ32bfGgNkKoMFA0kfbklA5vW,7GRhBDsirIGkRZBtSMEzNTyDr2JQm4xx,6,6,4,0,1,0,3,0,14,2.0,2,0.0,0,4,0,1,6,0,0,3,0,5,9,1
5889,55637,ykaUPJW4Nc9r2mv4b25QxgdHgIcQ63RQ,7GRhBDsirIGkRZBtSMEzNTyDr2JQm4xx,2,0,0,0,0,0,2,0,2,0.2857142857142857,1,0.0,0,0,0,0,0,0,0,2,0,0,2,1
5890,55641,ykaUPJW4Nc9r2mv4b25QxgdHgIcQ63RQ,5X6FeZozNMgE2VRi3MJYjkkFK8SETtu2,4,3,1,0,0,0,2,0,6,0.8571428571428571,1,0.0,0,1,0,0,3,0,0,2,0,1,5,1
5891,55642,ykaUPJW4Nc9r2mv4b25QxgdHgIcQ63RQ,bWdj2GDclj5ofokWjzoa5jAwMkxCykd6,5,3,1,0,1,0,2,0,7,1.0,1,0.0,0,1,0,1,3,0,0,2,0,2,5,1
5892,55649,4bbbxt4gBliPERhFJsgXSSeGNzE1uNe2,A3fsA9Zfv1X2fVEQhTw51lKENdNrEqT3,2,0,0,0,0,0,2,0,2,0.2857142857142857,1,0.0,0,0,0,0,0,0,0,2,0,0,2,1
5893,55661,KKjjlHFWeLSseHD90tBUbNiE7bxXsPHK,A3fsA9Zfv1X2fVEQhTw51lKENdNrEqT3,2,0,0,0,0,0,4,0,4,0.5714285714285714,2,0.0,0,0,0,0,0,0,0,4,0,0,4,1
5894,55663,GgCLl5NjwqMgkh5JCvkbSguhpqbBPXLG,A3fsA9Zfv1X2fVEQhTw51lKENdNrEqT3,9,6,0,0,0,1,20,2,29,4.142857142857143,3,0.0,0,0,0,0,6,1,0,20,2,0,29,1
5895,55667,8ZhpSkXuKXWxDMEbryu3zVTkh7o5swmt,SpATywNh6bZuzm8s1ceuBUnMUAeoAHHw,18,33,1,27,0,5,17,0,83,11.857142857142858,4,0.0,23,1,25,0,10,5,2,17,0,49,34,1
5896,55670,UEfmPgYtumlIP4ZVBLy50d35T1FxzKJg,bWdj2GDclj5ofokWjzoa5jAwMkxCykd6,3,0,0,0,0,0,4,0,4,0.5714285714285714,1,0.0,0,0,0,0,0,0,0,4,0,0,4,1
5897,55675,Fslz74hcTdRSeV6ABwYgUmV0VJF6YRMZ,SpATywNh6bZuzm8s1ceuBUnMUAeoAHHw,1,0,0,0,0,0,1,0,1,0.14285714285714285,1,0.0,0,0,0,0,0,0,0,1,0,0,1,1
5898,55692,y2EdvoA45jiUkTJcqU8mJ6KiT8yLZUjw,SpATywNh6bZuzm8s1ceuBUnMUAeoAHHw,7,6,1,0,0,3,7,0,17,2.4285714285714284,2,0.0,0,1,0,0,6,3,0,7,0,1,16,1
5899,55696,jaCcwHYnVHfV5mSQjy3wPbHHjpbiHJ5a,SpATywNh6bZuzm8s1ceuBUnMUAeoAHHw,44,112,40,45,26,0,46,0,269,38.42857142857143,10,0.0,17,40,40,26,95,0,5,46,0,123,146,0
5900,55699,HFO33lcsFKBDjSdg8KE5lGTCABOqytNM,RXDvfPUBYFlVdlueBFbLW0mhhAyGEqpt,73,103,44,179,33,6,11,1,377,53.857142857142854,6,0.0,48,44,149,33,55,6,30,11,1,274,103,0
5901,55700,f4KmYPe7Gd87l00BQWaThQRwVwEhyZVI,SpATywNh6bZuzm8s1ceuBUnMUAeoAHHw,14,23,0,13,0,0,5,0,41,5.857142857142857,3,0.0,6,0,11,0,17,0,2,5,0,17,24,1
5902,55727,1hNSAKFFSNkfntTlfWYg2UegOK7Bt861,SpATywNh6bZuzm8s1ceuBUnMUAeoAHHw,31,43,3,50,2,2,20,0,120,17.142857142857142,4,0.0,11,3,42,2,32,2,8,20,0,58,62,0
5903,55732,n5fmXY7W3OsRId8yMehdsktfc1GCY6un,A3fsA9Zfv1X2fVEQhTw51lKENdNrEqT3,1,0,0,0,0,0,1,0,1,0.14285714285714285,1,0.0,0,0,0,0,0,0,0,1,0,0,1,1
5904,55734,JwzCuKRnJiCboJiRTMovpzJhdCfcNETm,bWdj2GDclj5ofokWjzoa5jAwMkxCykd6,7,5,1,0,1,0,3,0,10,1.4285714285714286,2,0.0,0,1,0,1,5,0,0,3,0,2,8,1
5905,55738,rCrf0hc0QRrKoK9w9R5Z8IvJlhGyjTyy,bWdj2GDclj5ofokWjzoa5jAwMkxCykd6,20,30,8,70,4,16,10,1,139,19.857142857142858,5,0.0,4,8,64,4,26,16,6,10,1,80,59,1
5906,55754,IEvlNL8VOnMEhZDsUABPXo7LZfwGp4gY,bWdj2GDclj5ofokWjzoa5jAwMkxCykd6,1,0,0,0,0,0,1,0,1,0.14285714285714285,1,0.0,0,0,0,0,0,0,0,1,0,0,1,1
5907,55757,lzpjjiq4oMj4Jrgwrf3vY9lfIBWvCjOT,SpATywNh6bZuzm8s1ceuBUnMUAeoAHHw,1,0,0,0,0,0,1,0,1,0.14285714285714285,1,0.0,0,0,0,0,0,0,0,1,0,0,1,1
5908,55761,gEZOnwjA41tJvFOifXsWWDx9ePmBM5Kk,7GRhBDsirIGkRZBtSMEzNTyDr2JQm4xx,2,0,0,0,0,0,2,0,2,0.2857142857142857,1,0.0,0,0,0,0,0,0,0,2,0,0,2,1
5909,55763,invjLFwmOJ5b2g8Hz4dPO4FErak7u41P,RXDvfPUBYFlVdlueBFbLW0mhhAyGEqpt,12,12,1,0,0,0,2,0,15,2.142857142857143,1,0.0,0,1,0,0,12,0,0,2,0,1,14,1
5910,55771,rPyu4cIbS3LCjrN2mpvx4iaQSTgSq9Ou,G8EPVSXsOYB5YQWZGiz1aVq5Pgr2GrQu,21,7,0,70,0,0,6,0,83,11.857142857142858,2,0.0,0,0,54,0,7,0,16,6,0,54,29,0
5911,55772,5Y2cv07dwHIwwxuX55zFfzgqQ22I0Kj7,G8EPVSXsOYB5YQWZGiz1aVq5Pgr2GrQu,1,0,0,0,0,0,1,0,1,0.14285714285714285,1,0.0,0,0,0,0,0,0,0,1,0,0,1,1
5912,55773,mKWCTH01KzkLjFgXaCUEfs0dLu17r2jM,SpATywNh6bZuzm8s1ceuBUnMUAeoAHHw,7,8,5,0,2,0,3,0,18,2.5714285714285716,3,0.0,0,5,0,2,8,0,0,3,0,7,11,0
5913,55775,ZvdQafaVNGdhweIxI9FbVGKoGVxZDXFe,7GRhBDsirIGkRZBtSMEzNTyDr2JQm4xx,2,0,0,0,0,0,4,0,4,0.5714285714285714,3,0.0,0,0,0,0,0,0,0,4,0,0,4,1
5914,55777,aQ6WrdDe9pTNwVW3vmaMOs1pxy5r3Dxa,bWdj2GDclj5ofokWjzoa5jAwMkxCykd6,27,38,21,106,7,10,13,0,195,27.857142857142858,8,0.0,6,21,100,7,32,10,6,13,0,134,61,0
5915,55780,i5WDkhlf7rrVPmbQxsFTG1gowMYshvKj,bWdj2GDclj5ofokWjzoa5jAwMkxCykd6,9,24,11,8,7,2,4,0,56,8.0,3,0.0,8,11,8,7,16,2,0,4,0,34,22,1
5916,55815,BomMRlBByw8amFeVspHb5AR3og0R9z55,bWdj2GDclj5ofokWjzoa5jAwMkxCykd6,2,0,0,0,0,0,2,0,2,0.2857142857142857,1,0.0,0,0,0,0,0,0,0,2,0,0,2,1
5917,55820,LdhLlSD36AR268yKf0v6JE8vG5XYPHSF,SpATywNh6bZuzm8s1ceuBUnMUAeoAHHw,6,3,2,0,1,0,3,0,9,1.2857142857142858,2,0.0,0,2,0,1,3,0,0,3,0,3,6,1
5918,55843,S2i0VW7GN0ACeCnuAPN00XONM8w8kvsN,SpATywNh6bZuzm8s1ceuBUnMUAeoAHHw,47,129,50,63,19,29,28,4,322,46.0,8,0.0,30,50,51,19,99,29,12,28,4,150,172,0
5919,55846,q7ZtC6SevF8q9PKkXEaBMzUJ37xWhTDz,SpATywNh6bZuzm8s1ceuBUnMUAeoAHHw,31,55,21,29,8,16,12,0,141,20.142857142857142,10,0.0,8,21,26,8,47,16,3,12,0,63,78,1
5920,55854,cWzgbOpkXbzHEONOe0DzF6cxsOBOT2Ck,A3fsA9Zfv1X2fVEQhTw51lKENdNrEqT3,6,3,2,0,1,0,2,0,8,1.1428571428571428,1,0.0,0,2,0,1,3,0,0,2,0,3,5,1
5921,55865,ZEHkvN1JnR5aRFAd5UGefALeV7OHXWFP,7GRhBDsirIGkRZBtSMEzNTyDr2JQm4xx,37,106,32,42,13,24,22,3,242,34.57142857142857,4,0.0,49,32,40,13,57,24,2,22,3,134,108,1
5922,55866,DJyEuOUq1xzS66Zf6PmUg8ngoR0QofLh,SpATywNh6bZuzm8s1ceuBUnMUAeoAHHw,16,9,8,0,8,0,1,0,26,3.7142857142857144,1,0.0,0,8,0,8,9,0,0,1,0,16,10,0
5923,55871,Dpp8XuhtF10egN1qaOT5cqNb9iZXsbP6,bWdj2GDclj5ofokWjzoa5jAwMkxCykd6,4,2,0,0,0,0,3,0,5,0.7142857142857143,1,0.0,0,0,0,0,2,0,0,3,0,0,5,1
5924,55877,GPe5tDvCMFa0yvoGbU7FbSxYbtu5eayz,SpATywNh6bZuzm8s1ceuBUnMUAeoAHHw,48,79,42,44,19,2,29,1,216,30.857142857142858,14,0.0,11,42,37,19,68,2,7,29,1,109,107,0
5925,55882,HPL7SV5UPwGqlgRjicmrgS3BHX5sJveM,SpATywNh6bZuzm8s1ceuBUnMUAeoAHHw,11,5,4,0,4,0,2,0,15,2.142857142857143,1,0.0,0,4,0,4,5,0,0,2,0,8,7,1
5926,55932,nUlI6cjptTLAgli6MFzyKD61AHPa0Ow2,5X6FeZozNMgE2VRi3MJYjkkFK8SETtu2,6,3,2,0,1,0,2,0,8,1.1428571428571428,1,0.0,0,2,0,1,3,0,0,2,0,3,5,1
5927,55936,Uh4whLcptRuZuhdtjFruuYJY4YmOeYlV,SpATywNh6bZuzm8s1ceuBUnMUAeoAHHw,25,41,1,34,1,0,7,0,84,12.0,4,0.0,10,1,30,1,31,0,4,7,0,42,42,0
5928,55948,fOZTYKShrDEPywLsvnOq8r6y0esJP04d,G8EPVSXsOYB5YQWZGiz1aVq5Pgr2GrQu,76,211,79,198,50,57,27,2,624,89.14285714285714,7,0.0,102,79,156,50,109,57,42,27,2,387,237,0
5929,55953,YtCtmmeHWdDsVBWEFPwN8TpSoaeOXyLN,SpATywNh6bZuzm8s1ceuBUnMUAeoAHHw,9,7,3,0,0,1,9,1,21,3.0,2,0.0,1,3,0,0,6,1,0,9,1,4,17,0
5930,55960,jMs7ADG9ZqrxYx65fsOTRMWpEC2ydubk,G8EPVSXsOYB5YQWZGiz1aVq5Pgr2GrQu,6,2,1,0,1,0,3,0,7,1.0,1,0.0,0,1,0,1,2,0,0,3,0,2,5,1
5931,55968,nUyvnDYHNr07VuH4P7bXoHw66oueIve2,A3fsA9Zfv1X2fVEQhTw51lKENdNrEqT3,5,2,1,0,1,0,3,0,7,1.0,2,0.0,0,1,0,1,2,0,0,3,0,2,5,1
5932,55969,Qs9VQJkriDZBH3FlG0bgTumvMa49MEaO,SpATywNh6bZuzm8s1ceuBUnMUAeoAHHw,7,5,2,0,2,2,3,0,14,2.0,2,0.0,0,2,0,2,5,2,0,3,0,4,10,1
5933,55975,DtMnsqy6X2aMCS8gI4UYHBMONV1kA6dl,SpATywNh6bZuzm8s1ceuBUnMUAeoAHHw,15,28,7,13,1,0,10,0,59,8.428571428571429,3,0.0,9,7,11,1,19,0,2,10,0,28,31,0
5934,55988,FOVpUwiKXJnDfM4S62NCDgM0f8GaoUKw,bWdj2GDclj5ofokWjzoa5jAwMkxCykd6,25,9,2,42,0,0,2,0,55,7.857142857142857,2,0.0,0,2,31,0,9,0,11,2,0,33,22,1
5935,55996,vZhbOtXd7TjZcztq33p3Mc4YNdrrQnbd,SpATywNh6bZuzm8s1ceuBUnMUAeoAHHw,5,4,2,0,1,0,1,0,8,1.1428571428571428,1,0.0,1,2,0,1,3,0,0,1,0,4,4,0
5936,56001,7EU7vMf2b4Xv6MdI3zbAqQNQTiRVSvYt,bWdj2GDclj5ofokWjzoa5jAwMkxCykd6,10,15,4,0,2,0,8,0,29,4.142857142857143,4,0.0,0,4,0,2,15,0,0,8,0,6,23,0
5937,56002,aX8XTxJBQE99ErDnzZHdMXoXH5wjXDSz,SpATywNh6bZuzm8s1ceuBUnMUAeoAHHw,6,8,5,0,2,0,4,0,19,2.7142857142857144,2,0.0,0,5,0,2,8,0,0,4,0,7,12,1
5938,56008,PzU299qhBRNb9VKeEV5yMlpPdnEheXTy,5X6FeZozNMgE2VRi3MJYjkkFK8SETtu2,1,0,0,0,0,0,1,0,1,0.14285714285714285,1,0.0,0,0,0,0,0,0,0,1,0,0,1,1
5939,56010,hJo1MgKiPZFXuH2ko6hqPTd9dbjMQKDO,A3fsA9Zfv1X2fVEQhTw51lKENdNrEqT3,14,17,9,18,1,0,7,0,52,7.428571428571429,6,0.0,0,9,15,1,17,0,3,7,0,25,27,0
5940,56032,Y7LsqgQDUbWtXalaq4LkDEQKBlxOaCL3,A3fsA9Zfv1X2fVEQhTw51lKENdNrEqT3,7,8,3,0,2,0,2,0,15,2.142857142857143,2,0.0,1,3,0,2,7,0,0,2,0,6,9,1
5941,56040,420Gm2AWh0nImDTapBba1KojOp3noScY,SpATywNh6bZuzm8s1ceuBUnMUAeoAHHw,36,56,2,40,1,0,26,0,125,17.857142857142858,8,0.0,9,2,36,1,47,0,4,26,0,48,77,0
5942,56054,3bXohZfAfuP5Qk5brSDj9o6O5jB9eHXU,5X6FeZozNMgE2VRi3MJYjkkFK8SETtu2,7,4,2,0,3,0,2,0,11,1.5714285714285714,1,0.0,1,2,0,3,3,0,0,2,0,6,5,1
5943,56070,F0zHnv4QBXCCfC08pj4xRYVtaBbC9hrB,SpATywNh6bZuzm8s1ceuBUnMUAeoAHHw,4,2,1,0,0,0,2,0,5,0.7142857142857143,1,0.0,0,1,0,0,2,0,0,2,0,1,4,1
5944,56088,mSe1A4ptQkbf64uqFepueFInmdXgPhYy,A3fsA9Zfv1X2fVEQhTw51lKENdNrEqT3,48,21,17,72,12,3,16,1,142,20.285714285714285,2,0.0,1,17,63,12,20,3,9,16,1,93,49,1
5945,56100,rW6wdLuDHOXNnhL0u3gR5RZox9WggKAN,SpATywNh6bZuzm8s1ceuBUnMUAeoAHHw,11,16,7,16,4,7,1,0,51,7.285714285714286,1,0.0,8,7,14,4,8,7,2,1,0,33,18,0
5946,56103,h7RW3AuXPtbIdr6MfEtTA3AoeBZHMuDe,SpATywNh6bZuzm8s1ceuBUnMUAeoAHHw,19,42,25,20,7,0,17,0,111,15.857142857142858,6,0.0,6,25,16,7,36,0,4,17,0,54,57,1
5947,56130,NMP7zcZ1OXsWVHsXwjitPqAEZM0pNqdR,A3fsA9Zfv1X2fVEQhTw51lKENdNrEqT3,27,14,6,58,1,0,6,0,85,12.142857142857142,2,0.0,4,6,54,1,10,0,4,6,0,65,20,1
5948,56136,Ooe9SpvA9vL8fZI7YLdrPaZtM6Unwf0C,SpATywNh6bZuzm8s1ceuBUnMUAeoAHHw,24,34,1,20,2,1,4,0,62,8.857142857142858,3,0.0,6,1,18,2,28,1,2,4,0,27,35,1
5949,56142,ARgT3lphZ0ZC6ZJYyDs99tgWSQUEKTUQ,SpATywNh6bZuzm8s1ceuBUnMUAeoAHHw,27,47,20,33,10,0,6,0,116,16.571428571428573,2,0.0,8,20,29,10,39,0,4,6,0,67,49,0
5950,56159,PUyc6oo2n07bGLsFd9xq6RBtBr2Hfhy7,bWdj2GDclj5ofokWjzoa5jAwMkxCykd6,1,0,0,0,0,0,1,0,1,0.14285714285714285,1,0.0,0,0,0,0,0,0,0,1,0,0,1,1
5951,56162,n0lYyTCDVJTcalBduFlSaEDaBXfXmLkQ,G8EPVSXsOYB5YQWZGiz1aVq5Pgr2GrQu,15,8,6,0,5,0,10,0,29,4.142857142857143,1,0.0,0,6,0,5,8,0,0,10,0,11,18,1
5952,56177,pgUrKndBHF9gje2enxkGexSpNr299J4Q,SpATywNh6bZuzm8s1ceuBUnMUAeoAHHw,1,0,0,0,0,0,2,0,2,0.2857142857142857,2,0.0,0,0,0,0,0,0,0,2,0,0,2,1
5953,56184,ndLSZuWw3bhlmRMZV7snp1VzVKaJfO1o,7GRhBDsirIGkRZBtSMEzNTyDr2JQm4xx,1,0,0,0,0,0,1,0,1,0.14285714285714285,1,0.0,0,0,0,0,0,0,0,1,0,0,1,1
5954,56193,EZA4MRAtJae4wE8uswRBoOap1OUMEftr,5X6FeZozNMgE2VRi3MJYjkkFK8SETtu2,4,3,0,0,0,0,2,0,5,0.7142857142857143,1,0.0,1,0,0,0,2,0,0,2,0,1,4,1
5955,56202,xbYSqp0T7Uu69VoCNyfTCvQcS3HV3UeU,SpATywNh6bZuzm8s1ceuBUnMUAeoAHHw,15,59,25,20,1,56,41,7,209,29.857142857142858,9,0.0,12,25,16,1,47,56,4,41,7,54,155,1
5956,56205,TjHVysWRiYZK11ScpcMVmYhM1fqHEb9X,A3fsA9Zfv1X2fVEQhTw51lKENdNrEqT3,10,6,5,0,5,0,1,0,17,2.4285714285714284,1,0.0,0,5,0,5,6,0,0,1,0,10,7,1
5957,56211,v2qco953Z21cQ5MzJrZ1eVzwRDnupmBG,5X6FeZozNMgE2VRi3MJYjkkFK8SETtu2,5,3,2,0,2,1,2,0,10,1.4285714285714286,1,0.0,0,2,0,2,3,1,0,2,0,4,6,1
5958,56215,J3FKLxbUlPTor4lyG8lMpHc8oUQEjfcp,SpATywNh6bZuzm8s1ceuBUnMUAeoAHHw,11,7,5,0,3,0,4,0,19,2.7142857142857144,3,0.0,0,5,0,3,7,0,0,4,0,8,11,0
5959,56223,7qDBI7pI0SQ1bfBBjf175GzJeqNA6CgO,7GRhBDsirIGkRZBtSMEzNTyDr2JQm4xx,6,4,2,0,1,0,3,0,10,1.4285714285714286,2,0.0,0,2,0,1,4,0,0,3,0,3,7,1
5960,56226,ok15ssTMon44FKUffK29mVEN6xTGU7F9,SpATywNh6bZuzm8s1ceuBUnMUAeoAHHw,11,10,7,6,3,0,2,0,28,4.0,2,0.0,1,7,5,3,9,0,1,2,0,16,12,1
5961,56229,TZjkaaGxXeLRW9XAH2HdEXhi5AnCNUXO,A3fsA9Zfv1X2fVEQhTw51lKENdNrEqT3,1,0,0,0,0,0,1,0,1,0.14285714285714285,1,0.0,0,0,0,0,0,0,0,1,0,0,1,1
5962,56243,ggVtZvI2xjx0ksyejZETO0XkCjbToZaz,5X6FeZozNMgE2VRi3MJYjkkFK8SETtu2,5,2,1,0,1,0,2,0,6,0.8571428571428571,1,0.0,0,1,0,1,2,0,0,2,0,2,4,1
5963,56244,XKteUTBXNdDfK3DTLCpAPdVFmdrv3Rx5,7GRhBDsirIGkRZBtSMEzNTyDr2JQm4xx,13,27,1,0,0,0,5,2,35,5.0,1,0.0,4,1,0,0,23,0,0,5,2,5,30,1
5964,56262,pFNUXgPhrHzyB36jYajNTB53rVt1Mtce,A3fsA9Zfv1X2fVEQhTw51lKENdNrEqT3,26,22,6,44,3,2,12,1,90,12.857142857142858,2,0.0,3,6,36,3,19,2,8,12,1,48,42,0
5965,56292,0hayldpMfgwxDpctJQP76sfxg5OJaZQR,bWdj2GDclj5ofokWjzoa5jAwMkxCykd6,4,0,0,0,0,0,4,0,4,0.5714285714285714,1,0.0,0,0,0,0,0,0,0,4,0,0,4,1
5966,56297,99qtmmRFqQo6ZkEaf8SX5eCCPu7FxBw0,SpATywNh6bZuzm8s1ceuBUnMUAeoAHHw,21,34,0,37,0,6,11,0,88,12.571428571428571,2,0.0,11,0,36,0,23,6,1,11,0,47,41,0
5967,56305,6x8Qn3NADOhKwTty3SohsZ5HqvETwfPz,A3fsA9Zfv1X2fVEQhTw51lKENdNrEqT3,42,168,72,0,4,0,4,0,248,35.42857142857143,1,0.0,0,72,0,4,168,0,0,4,0,76,172,1
5968,56307,1GmUBgbH4qyfafNMJ2VdhisOaMrOQzrs,A3fsA9Zfv1X2fVEQhTw51lKENdNrEqT3,2,0,0,0,0,0,3,0,3,0.42857142857142855,2,0.0,0,0,0,0,0,0,0,3,0,0,3,1
5969,56311,O0ctfeDXN3RQlb9YZzp4oH5DaLYaRlEd,A3fsA9Zfv1X2fVEQhTw51lKENdNrEqT3,39,30,23,85,17,0,8,0,163,23.285714285714285,5,0.0,0,23,80,17,30,0,5,8,0,120,43,1
5970,56312,yOmriI6ep4L8AeXfk2CRItQ1EOEJgSeE,SpATywNh6bZuzm8s1ceuBUnMUAeoAHHw,8,15,9,0,7,0,3,0,34,4.857142857142857,1,0.0,0,9,0,7,15,0,0,3,0,16,18,1
5971,56318,VENcGNiuhhY6sNpgOfcZfhLXpuYyEtGh,SpATywNh6bZuzm8s1ceuBUnMUAeoAHHw,2,0,0,0,0,0,2,0,2,0.2857142857142857,1,0.0,0,0,0,0,0,0,0,2,0,0,2,1
5972,56321,YQloiHp4EDEAnQ7UnBm1Re3dyFVVFj8Z,SpATywNh6bZuzm8s1ceuBUnMUAeoAHHw,27,137,3,71,0,24,20,0,255,36.42857142857143,7,0.0,67,3,59,0,70,24,12,20,0,129,126,0
5973,56332,lyFNL8kV6VicGW73AnKGdsGcS116jdQS,A3fsA9Zfv1X2fVEQhTw51lKENdNrEqT3,8,8,0,0,1,0,3,0,12,1.7142857142857142,1,0.0,0,0,0,1,8,0,0,3,0,1,11,0
5974,56333,CwAitLaYuWheNSIoTgEZfJ56lAJf0HG8,7GRhBDsirIGkRZBtSMEzNTyDr2JQm4xx,36,48,18,55,19,0,17,0,157,22.428571428571427,4,0.0,28,18,49,19,20,0,6,17,0,114,43,1
5975,56348,yHbKBcrGUc65c5y9lhVo9REsfVSZTyxI,5X6FeZozNMgE2VRi3MJYjkkFK8SETtu2,1,0,0,0,0,0,3,0,3,0.42857142857142855,1,0.0,0,0,0,0,0,0,0,3,0,0,3,1
5976,56354,EKjzbhHjXWCVYpc4LH9ESzstcF131j56,7GRhBDsirIGkRZBtSMEzNTyDr2JQm4xx,1,0,0,0,0,0,1,0,1,0.14285714285714285,1,0.0,0,0,0,0,0,0,0,1,0,0,1,1
5977,56358,IJWUl0dWQiuiW9w5y2FbSbROivrhPUri,RXDvfPUBYFlVdlueBFbLW0mhhAyGEqpt,2,0,0,0,0,0,3,0,3,0.42857142857142855,1,0.0,0,0,0,0,0,0,0,3,0,0,3,1
5978,56366,CQ9z29HXcNaQxMUuAJ5s2uvH0fLzGYjv,SpATywNh6bZuzm8s1ceuBUnMUAeoAHHw,20,32,12,39,0,1,6,1,91,13.0,2,0.0,14,12,35,0,18,1,4,6,1,61,30,1
5979,56387,z198xKV3Xh3vq8jATGS5cKDaYaYNm0Ij,SpATywNh6bZuzm8s1ceuBUnMUAeoAHHw,5,3,1,0,1,0,1,0,6,0.8571428571428571,1,0.0,0,1,0,1,3,0,0,1,0,2,4,1
5980,56391,qlLes0SdNspaw8U0NHOyJVADLb1vNlZ2,SpATywNh6bZuzm8s1ceuBUnMUAeoAHHw,1,0,0,0,0,0,1,0,1,0.14285714285714285,1,0.0,0,0,0,0,0,0,0,1,0,0,1,1
5981,56392,YjkBBS3B1bfu7o3vhzRHcMiPertfPIVg,SpATywNh6bZuzm8s1ceuBUnMUAeoAHHw,1,0,0,0,0,0,1,0,1,0.14285714285714285,1,0.0,0,0,0,0,0,0,0,1,0,0,1,0
5982,56395,i5ccs6iw5ZhzXCfBV7j5tGNuPIZR5SkL,5X6FeZozNMgE2VRi3MJYjkkFK8SETtu2,10,13,0,6,0,9,7,0,35,5.0,1,0.0,3,0,5,0,10,9,1,7,0,8,27,1
5983,56398,aGbKep26uuguTzwAUYDcwjqS1RQNroF5,SpATywNh6bZuzm8s1ceuBUnMUAeoAHHw,42,59,16,46,13,0,13,1,148,21.142857142857142,8,0.0,14,16,43,13,45,0,3,13,1,86,62,1
5984,56413,4GCUZawdASarA3TMg6HAfW2kyE7xYxA6,A3fsA9Zfv1X2fVEQhTw51lKENdNrEqT3,2,0,0,0,0,0,2,0,2,0.2857142857142857,1,0.0,0,0,0,0,0,0,0,2,0,0,2,1
5985,56418,1yk3ITtkCTeBgpvC46EyEEfYcyKWD7Qc,SpATywNh6bZuzm8s1ceuBUnMUAeoAHHw,46,36,22,39,13,10,9,1,130,18.571428571428573,6,0.0,10,22,35,13,26,10,4,9,1,80,50,0
5986,56423,ouOARkjMonPxhUKVUmTMgEZ4vGcTZcAk,7GRhBDsirIGkRZBtSMEzNTyDr2JQm4xx,45,43,0,164,2,0,3,0,212,30.285714285714285,2,0.0,23,0,161,2,20,0,3,3,0,186,26,1
5987,56444,bUYPIrKUhpdtG1KH0Y9GXp4xZk1AgdLJ,SpATywNh6bZuzm8s1ceuBUnMUAeoAHHw,47,42,30,34,19,4,11,0,140,20.0,5,0.0,9,30,34,19,33,4,0,11,0,92,48,0
5988,56445,UalIk08w9p6VGqWfZ6drUaQL5GhjEzcw,SpATywNh6bZuzm8s1ceuBUnMUAeoAHHw,43,57,31,28,13,11,12,1,153,21.857142857142858,4,0.0,15,31,26,13,42,11,2,12,1,85,68,1
5989,56446,TVQrQzdOFJxL0otAPBsN1HXNpNNlOLWm,7GRhBDsirIGkRZBtSMEzNTyDr2JQm4xx,24,41,0,84,3,0,3,0,131,18.714285714285715,2,0.0,27,0,74,3,14,0,10,3,0,104,27,1
5990,56451,mNb7LM1EgQY9ZcZGX1ENFwEQJQ6p6qce,SpATywNh6bZuzm8s1ceuBUnMUAeoAHHw,15,12,7,0,6,0,4,0,29,4.142857142857143,3,0.0,0,7,0,6,12,0,0,4,0,13,16,0
5991,56459,IJmtizRHLdF3WotHNxwRcdFjzienWtJz,A3fsA9Zfv1X2fVEQhTw51lKENdNrEqT3,1,0,0,0,0,0,1,0,1,0.14285714285714285,1,0.0,0,0,0,0,0,0,0,1,0,0,1,1
5992,56468,1hZKrwuDlrmzTLBd6Jwp6RaIYtYXhqMF,SpATywNh6bZuzm8s1ceuBUnMUAeoAHHw,19,37,10,20,4,0,5,0,76,10.857142857142858,3,0.0,24,10,18,4,13,0,2,5,0,56,20,0
5993,56473,Y8djJGa5xO2Tk4mEUFLDW9jkITveu6qG,SpATywNh6bZuzm8s1ceuBUnMUAeoAHHw,4,2,0,0,0,0,2,0,4,0.5714285714285714,1,0.0,0,0,0,0,2,0,0,2,0,0,4,1
5994,56477,g5ozjvUCdaFJGkcIZvHKw5OmNcDvdyli,G8EPVSXsOYB5YQWZGiz1aVq5Pgr2GrQu,14,19,7,12,2,0,4,0,44,6.285714285714286,3,0.0,6,7,7,2,13,0,5,4,0,22,22,1
5995,56483,H2pnCC5fUi5Ho09aPqAE97vnlsM8FGBU,SpATywNh6bZuzm8s1ceuBUnMUAeoAHHw,3,2,0,0,0,0,1,0,3,0.42857142857142855,1,0.0,0,0,0,0,2,0,0,1,0,0,3,0
5996,56485,eDC5FVVahMFWunS9Jkj1FnUpkxAaFQxm,SpATywNh6bZuzm8s1ceuBUnMUAeoAHHw,1,0,0,0,0,0,1,0,1,0.14285714285714285,1,0.0,0,0,0,0,0,0,0,1,0,0,1,1
5997,56490,kqS8BwWN9R1093oeblGkvtCsQJ68Gh0G,SpATywNh6bZuzm8s1ceuBUnMUAeoAHHw,34,131,64,45,28,20,27,0,315,45.0,14,0.0,18,64,36,28,113,20,9,27,0,146,169,0
5998,56494,mSe1A4ptQkbf64uqFepueFInmdXgPhYy,SpATywNh6bZuzm8s1ceuBUnMUAeoAHHw,13,14,8,0,1,2,12,0,37,5.285714285714286,3,0.0,0,8,0,1,14,2,0,12,0,9,28,1
5999,56495,LMrnY95OXOcKLbPJNFk6CNnUTJJC01Mr,7GRhBDsirIGkRZBtSMEzNTyDr2JQm4xx,1,0,0,0,0,0,1,0,1,0.14285714285714285,1,0.0,0,0,0,0,0,0,0,1,0,0,1,1
6000,56496,LMrnY95OXOcKLbPJNFk6CNnUTJJC01Mr,SpATywNh6bZuzm8s1ceuBUnMUAeoAHHw,5,3,0,0,0,0,4,0,7,1.0,1,0.0,0,0,0,0,3,0,0,4,0,0,7,1
6001,56499,LMrnY95OXOcKLbPJNFk6CNnUTJJC01Mr,A3fsA9Zfv1X2fVEQhTw51lKENdNrEqT3,1,0,0,0,0,0,1,0,1,0.14285714285714285,1,0.0,0,0,0,0,0,0,0,1,0,0,1,1
6002,56501,AxlfZzXkXnhJLfyjxNARPh8wNlmuerJT,SpATywNh6bZuzm8s1ceuBUnMUAeoAHHw,15,26,7,25,3,1,7,0,69,9.857142857142858,3,0.0,10,7,20,3,16,1,5,7,0,40,29,0
6003,56514,57DmCkxeT4CodU6tDrBCDXqGpXQ0D1sF,A3fsA9Zfv1X2fVEQhTw51lKENdNrEqT3,56,74,9,190,1,13,10,0,297,42.42857142857143,7,0.0,7,9,153,1,67,13,37,10,0,170,127,0
6004,56520,Q0J8U0u6fxm0Djpm7255SwygxGBxa60v,A3fsA9Zfv1X2fVEQhTw51lKENdNrEqT3,29,8,4,62,2,1,10,0,87,12.428571428571429,3,0.0,2,4,51,2,6,1,11,10,0,59,28,0
6005,56527,3t7GtELm6lLnb8FYC1DTga6GS5ymEox1,bWdj2GDclj5ofokWjzoa5jAwMkxCykd6,9,7,0,0,0,8,10,1,26,3.7142857142857144,3,0.0,1,0,0,0,6,8,0,10,1,1,25,1
6006,56536,v3Nj91qeWhwVYxgQExYL9jO1Rd2uR5bo,SpATywNh6bZuzm8s1ceuBUnMUAeoAHHw,5,2,1,0,1,0,3,0,7,1.0,2,0.0,0,1,0,1,2,0,0,3,0,2,5,1
6007,56541,9oxisAfoCqhNdPyxfe8mXe0RtSf4cETJ,bWdj2GDclj5ofokWjzoa5jAwMkxCykd6,7,1,1,0,1,0,4,0,7,1.0,1,0.0,0,1,0,1,1,0,0,4,0,2,5,1
6008,56559,Mr892OMsEEXQ3UZ94sswWXvqkTfFWjMB,SpATywNh6bZuzm8s1ceuBUnMUAeoAHHw,7,9,4,0,1,0,6,0,20,2.857142857142857,2,0.0,0,4,0,1,9,0,0,6,0,5,15,0
6009,56576,zlC9nEdRrqLSPX386Mctiz9fIdlU29GI,A3fsA9Zfv1X2fVEQhTw51lKENdNrEqT3,32,31,27,0,21,0,6,0,85,12.142857142857142,5,0.0,0,27,0,21,31,0,0,6,0,48,37,0
6010,56588,1ek5QqaGzN6P33dWOwYmxFbMxKwWe19o,bWdj2GDclj5ofokWjzoa5jAwMkxCykd6,1,0,0,0,0,0,1,0,1,0.14285714285714285,1,0.0,0,0,0,0,0,0,0,1,0,0,1,1
6011,56590,1ek5QqaGzN6P33dWOwYmxFbMxKwWe19o,A3fsA9Zfv1X2fVEQhTw51lKENdNrEqT3,1,0,0,0,0,0,1,0,1,0.14285714285714285,1,0.0,0,0,0,0,0,0,0,1,0,0,1,1
6012,56597,JEPcJF0TTKl5vK9nCSqR8pH0kXl1lZQb,G8EPVSXsOYB5YQWZGiz1aVq5Pgr2GrQu,6,9,1,0,0,0,3,0,13,1.8571428571428572,1,0.0,3,1,0,0,6,0,0,3,0,4,9,1
6013,56606,YDx22wmqU2QQRuqAsFKiF79xppsDVVtu,SpATywNh6bZuzm8s1ceuBUnMUAeoAHHw,8,13,5,0,1,0,3,0,22,3.142857142857143,1,0.0,0,5,0,1,13,0,0,3,0,6,16,1
6014,56607,ZI1SmXpqFYe45F6w8W5vh7KFZWZHkCX6,SpATywNh6bZuzm8s1ceuBUnMUAeoAHHw,6,4,2,0,1,0,3,0,10,1.4285714285714286,2,0.0,0,2,0,1,4,0,0,3,0,3,7,1
6015,56615,ktKfaRtFOnFJdZMcfSCqSP14OG6TxlMY,SpATywNh6bZuzm8s1ceuBUnMUAeoAHHw,31,55,4,30,3,0,15,0,107,15.285714285714286,6,0.0,6,4,30,3,49,0,0,15,0,43,64,0
6016,56621,ma8nscMCD0ftKjbxujos5nzHFFtaZMo4,A3fsA9Zfv1X2fVEQhTw51lKENdNrEqT3,61,43,9,194,5,0,20,0,271,38.714285714285715,6,0.0,5,9,163,5,38,0,31,20,0,182,89,0
6017,56632,J4UXFQZe2esHAAP8EgxtBhubvEMwPUfX,SpATywNh6bZuzm8s1ceuBUnMUAeoAHHw,7,11,5,0,1,0,2,0,19,2.7142857142857144,1,0.0,0,5,0,1,11,0,0,2,0,6,13,1
6018,56633,NGQ6HXbhxwBlJxikVxca5noX2u8xI9AV,A3fsA9Zfv1X2fVEQhTw51lKENdNrEqT3,40,34,14,76,10,0,7,0,141,20.142857142857142,4,0.0,2,14,61,10,32,0,15,7,0,87,54,0
6019,56683,MbewcgzgToNhp9B6eaNSolme5R0M2nkY,A3fsA9Zfv1X2fVEQhTw51lKENdNrEqT3,33,29,4,72,1,0,6,0,112,16.0,5,0.0,2,4,58,1,27,0,14,6,0,65,47,1
6020,56695,zEnfy6jGZRz4vOOACnUS9WJEmxBWMfYK,SpATywNh6bZuzm8s1ceuBUnMUAeoAHHw,20,38,0,32,0,7,21,6,104,14.857142857142858,3,0.0,17,0,29,0,21,7,3,21,6,46,58,0
6021,56696,ReIy3etnMmZBVQ3CosU4FbzEF29F9nHU,SpATywNh6bZuzm8s1ceuBUnMUAeoAHHw,30,35,3,20,3,0,6,0,67,9.571428571428571,8,0.0,9,3,19,3,26,0,1,6,0,34,33,0
6022,56701,6JgXcKWsc0MTV1avPvLw4YopCc17Rmgt,A3fsA9Zfv1X2fVEQhTw51lKENdNrEqT3,1,0,0,0,0,0,1,0,1,0.14285714285714285,1,0.0,0,0,0,0,0,0,0,1,0,0,1,1
6023,56707,bFvRESu40USsImLcj4Wu3bOXKdpnzC9Q,SpATywNh6bZuzm8s1ceuBUnMUAeoAHHw,3,2,0,0,0,0,2,0,4,0.5714285714285714,1,0.0,0,0,0,0,2,0,0,2,0,0,4,0
6024,56715,6iyCCTAEdDUFtgP0yXcCVROgqrKuAsJY,SpATywNh6bZuzm8s1ceuBUnMUAeoAHHw,28,31,21,40,9,2,8,0,111,15.857142857142858,4,0.0,6,21,34,9,25,2,6,8,0,70,41,0
6025,56718,TqNtDLLO1ShCV3mG6MbvpUVS2QVfiYPr,SpATywNh6bZuzm8s1ceuBUnMUAeoAHHw,1,0,0,0,0,0,1,0,1,0.14285714285714285,1,0.0,0,0,0,0,0,0,0,1,0,0,1,1
6026,56722,xYLJB56SVkFUOdT5vN3Qq6OYNlnP0Fjc,A3fsA9Zfv1X2fVEQhTw51lKENdNrEqT3,11,7,3,0,3,1,4,0,18,2.5714285714285716,2,0.0,0,3,0,3,7,1,0,4,0,6,12,1
6027,56725,Bxz1zTHFCCx9o1kJA9B0Pzm3PnmqKxr5,SpATywNh6bZuzm8s1ceuBUnMUAeoAHHw,19,35,30,0,17,0,2,0,84,12.0,7,0.0,2,30,0,17,33,0,0,2,0,49,35,1
6028,56736,csg0yBjjrshmLGGyq6UVgiiqMZP9T0vI,A3fsA9Zfv1X2fVEQhTw51lKENdNrEqT3,10,8,5,0,3,0,9,0,25,3.5714285714285716,3,0.0,0,5,0,3,8,0,0,9,0,8,17,1
6029,56739,abujBNmSyI9HYgtoO1EXyLGaW1rUTrMR,5X6FeZozNMgE2VRi3MJYjkkFK8SETtu2,6,5,1,0,1,0,3,0,10,1.4285714285714286,2,0.0,0,1,0,1,5,0,0,3,0,2,8,1
6030,56763,bZSiNUbAIuydDBd77IMAJ15Hy6k2A1kT,SpATywNh6bZuzm8s1ceuBUnMUAeoAHHw,10,6,5,0,4,0,2,0,17,2.4285714285714284,1,0.0,0,5,0,4,6,0,0,2,0,9,8,0
6031,56771,I8C35PB4HAz5bxjARemPN0YBdl9xTOvv,SpATywNh6bZuzm8s1ceuBUnMUAeoAHHw,24,48,1,33,1,0,5,0,88,12.571428571428571,2,0.0,12,1,29,1,36,0,4,5,0,43,45,1
6032,56785,70BrIR23BcsI705EZj4LSyr7fHWI0Xjf,SpATywNh6bZuzm8s1ceuBUnMUAeoAHHw,8,6,4,0,3,0,3,0,16,2.2857142857142856,2,0.0,0,4,0,3,6,0,0,3,0,7,9,1
6033,56791,1G2HPMj7bCJEDZxxbF8ae2kPQCHvH8vB,bWdj2GDclj5ofokWjzoa5jAwMkxCykd6,10,18,9,0,4,1,14,8,54,7.714285714285714,3,0.0,0,9,0,4,18,1,0,14,8,13,41,1
6034,56806,1ZeLZDjvvDkWWsoonk2q4KdJg9fzmSLS,SpATywNh6bZuzm8s1ceuBUnMUAeoAHHw,10,19,1,4,1,0,5,0,30,4.285714285714286,3,0.0,1,1,3,1,18,0,1,5,0,6,24,1
6035,56817,qzripbhm6sAPdZP3rld8n0avyAjcFNv4,G8EPVSXsOYB5YQWZGiz1aVq5Pgr2GrQu,8,11,3,0,3,0,5,0,22,3.142857142857143,4,0.0,0,3,0,3,11,0,0,5,0,6,16,0
6036,56834,i86rWeuy3cBtKeVeDiyieBp3ovKTOVnd,SpATywNh6bZuzm8s1ceuBUnMUAeoAHHw,31,50,25,1,13,1,25,1,116,16.571428571428573,7,0.0,6,25,1,13,44,1,0,25,1,45,71,1
6037,56836,PihBsIILx8UWSnCui7TqzlKGzY1fk9nJ,SpATywNh6bZuzm8s1ceuBUnMUAeoAHHw,1,0,0,0,0,0,1,0,1,0.14285714285714285,1,0.0,0,0,0,0,0,0,0,1,0,0,1,1
6038,56846,JQHOsaQcbZuyd8KUhRwPnej9sALKGQEC,SpATywNh6bZuzm8s1ceuBUnMUAeoAHHw,23,60,4,50,0,10,13,3,140,20.0,6,0.0,28,4,39,0,32,10,11,13,3,71,69,0
6039,56864,y64BqR5f4fJBfwxF4aLt14ViHkvnjGLs,A3fsA9Zfv1X2fVEQhTw51lKENdNrEqT3,43,40,20,50,7,8,19,0,144,20.571428571428573,7,0.0,3,20,48,7,37,8,2,19,0,78,66,1
6040,56875,T8TKNQciNYxyZa02JNR1WAwQ2Y5qXjum,G8EPVSXsOYB5YQWZGiz1aVq5Pgr2GrQu,39,54,30,64,5,11,28,2,194,27.714285714285715,7,0.0,6,30,59,5,48,11,5,28,2,100,94,0
6041,56905,bIokry3DgDVeJkqlmb8eSHiuWbIB78ly,5X6FeZozNMgE2VRi3MJYjkkFK8SETtu2,44,112,32,64,27,25,19,2,281,40.142857142857146,4,0.0,46,32,55,27,66,25,9,19,2,160,121,1
6042,56922,O1q1xXNHTWodSWO9JfUWT4rggWDNTlDY,SpATywNh6bZuzm8s1ceuBUnMUAeoAHHw,7,8,4,0,0,0,2,0,14,2.0,1,0.0,3,4,0,0,5,0,0,2,0,7,7,0
6043,56928,GXmApUIE1IechykqO3xyhcbVn1kfVOsr,A3fsA9Zfv1X2fVEQhTw51lKENdNrEqT3,1,0,0,0,0,0,1,0,1,0.14285714285714285,1,0.0,0,0,0,0,0,0,0,1,0,0,1,1
6044,56931,T6EWQ7jVP89JlHzj41KN1gEtGYevpSQM,bWdj2GDclj5ofokWjzoa5jAwMkxCykd6,20,30,19,10,8,9,18,2,96,13.714285714285714,6,0.0,4,19,9,8,26,9,1,18,2,40,56,1
6045,56934,8rmN9H3w27FWPHiV35iZMwZvoCzyP6Mm,RXDvfPUBYFlVdlueBFbLW0mhhAyGEqpt,9,10,7,0,5,0,4,0,26,3.7142857142857144,1,0.0,0,7,0,5,10,0,0,4,0,12,14,1
6046,56936,6YrlVe0EsBFAYrnxnMsqTpBboV8J5mFJ,SpATywNh6bZuzm8s1ceuBUnMUAeoAHHw,5,3,2,0,0,0,2,0,7,1.0,1,0.0,0,2,0,0,3,0,0,2,0,2,5,1
6047,56950,kSTVldlILQTC4uvQjFTvUZT6Q6PR2etw,SpATywNh6bZuzm8s1ceuBUnMUAeoAHHw,12,27,3,26,0,3,7,0,66,9.428571428571429,3,0.0,7,3,21,0,20,3,5,7,0,31,35,0
6048,56956,6iOLSqRTRABETCaDgzA6NufDV3dLbSSl,bWdj2GDclj5ofokWjzoa5jAwMkxCykd6,63,46,32,166,16,17,32,0,309,44.142857142857146,7,0.0,11,32,146,16,35,17,20,32,0,205,104,1
6049,56962,0XE1X3Ctb7lK10K23BNZFxwGgwh0UjZf,SpATywNh6bZuzm8s1ceuBUnMUAeoAHHw,9,14,9,0,0,0,4,0,27,3.857142857142857,1,0.0,2,9,0,0,12,0,0,4,0,11,16,1
6050,56963,GKzw24uGItaRbrNpOwWtTqnRbaZohHHZ,SpATywNh6bZuzm8s1ceuBUnMUAeoAHHw,31,77,37,42,15,43,32,3,249,35.57142857142857,6,0.0,26,37,36,15,51,43,6,32,3,114,135,0
6051,56973,yeTZ5KMDDEc73UUfQpRLrz0nY0YDQXhl,SpATywNh6bZuzm8s1ceuBUnMUAeoAHHw,28,56,21,25,9,3,6,0,120,17.142857142857142,2,0.0,5,21,25,9,51,3,0,6,0,60,60,1
6052,56974,ca0FiReQbSJ11H1fqXLWoWnOvLbBbR3V,SpATywNh6bZuzm8s1ceuBUnMUAeoAHHw,18,56,22,23,6,7,13,1,128,18.285714285714285,6,0.0,18,22,16,6,38,7,7,13,1,62,66,0
6053,57000,iCeqWib80JT1adwU3NbFJnaBIJ2wIhjE,RXDvfPUBYFlVdlueBFbLW0mhhAyGEqpt,10,8,1,0,1,0,4,0,14,2.0,2,0.0,1,1,0,1,7,0,0,4,0,3,11,1
6054,57007,ZmVWu5hbUnLsKkFZOEf7HKPqWqXcgH33,5X6FeZozNMgE2VRi3MJYjkkFK8SETtu2,1,0,0,0,0,0,1,0,1,0.14285714285714285,1,0.0,0,0,0,0,0,0,0,1,0,0,1,1
6055,57017,RVthfCRYYRCiFRx3Qkq6vL0caXa3Y6XL,SpATywNh6bZuzm8s1ceuBUnMUAeoAHHw,22,27,9,46,2,2,22,1,109,15.571428571428571,3,0.0,18,9,40,2,9,2,6,22,1,69,40,0
6056,57037,I7IIrHAh1LzzCf8lcvI92o8deFulzAh8,5X6FeZozNMgE2VRi3MJYjkkFK8SETtu2,1,0,0,0,0,0,1,0,1,0.14285714285714285,1,0.0,0,0,0,0,0,0,0,1,0,0,1,1
6057,57039,pJVtkRFEs9CaJKE9rNOcmTvOB8uBPejR,A3fsA9Zfv1X2fVEQhTw51lKENdNrEqT3,9,7,3,0,1,0,5,0,16,2.2857142857142856,3,0.0,0,3,0,1,7,0,0,5,0,4,12,0
6058,57041,LiEq7cB8PYL97VcZAVnxJwY7r8Xsvmdl,SpATywNh6bZuzm8s1ceuBUnMUAeoAHHw,4,2,0,0,0,0,3,0,5,0.7142857142857143,1,0.0,0,0,0,0,2,0,0,3,0,0,5,1
6059,57042,7QBdZ8YakikUsDbHJXtRSZV9tfWCg7qW,SpATywNh6bZuzm8s1ceuBUnMUAeoAHHw,27,35,14,48,4,0,5,0,106,15.142857142857142,3,0.0,15,14,42,4,20,0,6,5,0,75,31,0
6060,57048,I7IIrHAh1LzzCf8lcvI92o8deFulzAh8,G8EPVSXsOYB5YQWZGiz1aVq5Pgr2GrQu,1,0,0,0,0,0,3,0,3,0.42857142857142855,3,0.0,0,0,0,0,0,0,0,3,0,0,3,1
6061,57049,I7IIrHAh1LzzCf8lcvI92o8deFulzAh8,RXDvfPUBYFlVdlueBFbLW0mhhAyGEqpt,1,0,0,0,0,0,5,0,5,0.7142857142857143,3,0.0,0,0,0,0,0,0,0,5,0,0,5,1
6062,57051,I7IIrHAh1LzzCf8lcvI92o8deFulzAh8,A3fsA9Zfv1X2fVEQhTw51lKENdNrEqT3,1,0,0,0,0,0,2,0,2,0.2857142857142857,2,0.0,0,0,0,0,0,0,0,2,0,0,2,1
6063,57057,uMWcv4ZmW7X4PBv6egGkJZliUjuRluME,A3fsA9Zfv1X2fVEQhTw51lKENdNrEqT3,5,3,0,0,0,0,2,0,5,0.7142857142857143,1,0.0,0,0,0,0,3,0,0,2,0,0,5,1
6064,57071,ZAm3LJlcyCl8h6ue5pLqqLpG5qq07BLo,A3fsA9Zfv1X2fVEQhTw51lKENdNrEqT3,1,0,0,0,0,0,1,0,1,0.14285714285714285,1,0.0,0,0,0,0,0,0,0,1,0,0,1,0
6065,57088,Wwec43la23BkGWuxstkp5xbmi9HpOvs1,G8EPVSXsOYB5YQWZGiz1aVq5Pgr2GrQu,12,15,1,0,1,0,4,0,21,3.0,1,0.0,0,1,0,1,15,0,0,4,0,2,19,0
6066,57094,NY9lbGArbud0VjFCO45IgKzDykuc5Wkn,G8EPVSXsOYB5YQWZGiz1aVq5Pgr2GrQu,3,2,0,0,0,0,2,0,4,0.5714285714285714,1,0.0,0,0,0,0,2,0,0,2,0,0,4,1
6067,57105,91awV6zWN0QiCEvZkSCaXQj0382CBE5H,A3fsA9Zfv1X2fVEQhTw51lKENdNrEqT3,1,0,0,0,0,0,1,0,1,0.14285714285714285,1,0.0,0,0,0,0,0,0,0,1,0,0,1,1
6068,57116,FeZn6c6vb5R5SPZtACtqOXKJC1inbsZN,SpATywNh6bZuzm8s1ceuBUnMUAeoAHHw,28,44,4,38,4,5,8,0,103,14.714285714285714,5,0.0,9,4,31,4,35,5,7,8,0,48,55,0
6069,57118,Icz7FevFRJsXLyENa86VfhJuan698xy0,5X6FeZozNMgE2VRi3MJYjkkFK8SETtu2,2,0,0,0,0,0,2,0,2,0.2857142857142857,1,0.0,0,0,0,0,0,0,0,2,0,0,2,1
6070,57131,3CLlQYPJzaDqTsMDCyIWfYEpsKmi9sXD,G8EPVSXsOYB5YQWZGiz1aVq5Pgr2GrQu,18,35,9,10,7,3,25,1,90,12.857142857142858,4,0.0,18,9,6,7,17,3,4,25,1,40,50,0
6071,57161,35E85h2ExBPeTd1VmxNX0GKo8krIMsCP,5X6FeZozNMgE2VRi3MJYjkkFK8SETtu2,10,12,8,0,5,0,3,0,28,4.0,3,0.0,0,8,0,5,12,0,0,3,0,13,15,1
6072,57162,aHtknnRqNt7Y7dvI5B5U8KGn3pFw6RdZ,G8EPVSXsOYB5YQWZGiz1aVq5Pgr2GrQu,29,46,32,16,0,7,10,1,112,16.0,2,0.0,8,32,15,0,38,7,1,10,1,55,57,1
6073,57182,n2sxBm1YdWdbqY5218d4GO8H7c30aZzU,SpATywNh6bZuzm8s1ceuBUnMUAeoAHHw,1,0,0,0,0,0,1,0,1,0.14285714285714285,1,0.0,0,0,0,0,0,0,0,1,0,0,1,1
6074,57183,5jlZO84otZB9xpGdUF5HgmcrtViZn9QR,SpATywNh6bZuzm8s1ceuBUnMUAeoAHHw,1,0,0,0,0,0,1,0,1,0.14285714285714285,1,0.0,0,0,0,0,0,0,0,1,0,0,1,1
6075,57190,ZzEeIm98vbP9lRunZYePLW46UyhiVxbR,A3fsA9Zfv1X2fVEQhTw51lKENdNrEqT3,8,12,4,0,1,0,5,1,23,3.2857142857142856,3,0.0,3,4,0,1,9,0,0,5,1,8,15,1
6076,57193,v6sJocXlJFeoDG1nXrmoTeUih19304GZ,SpATywNh6bZuzm8s1ceuBUnMUAeoAHHw,16,25,3,9,3,0,7,0,47,6.714285714285714,5,0.0,2,3,8,3,23,0,1,7,0,16,31,1
6077,57213,iSYj2oDe5RyCcvKGOIlJlpq8H0342az5,SpATywNh6bZuzm8s1ceuBUnMUAeoAHHw,15,13,11,5,9,1,12,1,52,7.428571428571429,2,0.0,1,11,4,9,12,1,1,12,1,25,27,1
6078,57215,XP5riJnXYg5EQATrHDgwlSDdWk49ZnJK,SpATywNh6bZuzm8s1ceuBUnMUAeoAHHw,27,61,5,14,4,2,9,1,96,13.714285714285714,5,0.0,10,5,12,4,51,2,2,9,1,31,65,1
6079,57223,CYN3tl2d8PV3r7FRKTn3DmaQTLhkh777,A3fsA9Zfv1X2fVEQhTw51lKENdNrEqT3,19,21,0,0,0,4,15,1,41,5.857142857142857,2,0.0,0,0,0,0,21,4,0,15,1,0,41,1
6080,57225,Ct3eFzamQizfpV2I2rZSBKqavcN2kzGI,bWdj2GDclj5ofokWjzoa5jAwMkxCykd6,18,36,22,14,13,0,5,0,90,12.857142857142858,4,0.0,7,22,14,13,29,0,0,5,0,56,34,1
6081,57247,mAtPYhgVQEdXuexaQz1O6am3axcwvcQv,SpATywNh6bZuzm8s1ceuBUnMUAeoAHHw,9,9,1,0,1,1,5,0,17,2.4285714285714284,2,0.0,0,1,0,1,9,1,0,5,0,2,15,0
6082,57274,a91ewPLjlp1X8KqwrnZISs7xgERRXuh7,SpATywNh6bZuzm8s1ceuBUnMUAeoAHHw,40,140,37,26,7,250,44,3,507,72.42857142857143,13,0.0,3,37,22,7,137,250,4,44,3,69,438,0
6083,57275,2Al3Sg2oc4NVlws5jTNzQZvd3PHAcnAl,SpATywNh6bZuzm8s1ceuBUnMUAeoAHHw,18,18,8,0,7,2,3,0,38,5.428571428571429,2,0.0,1,8,0,7,17,2,0,3,0,16,22,1
6084,57289,JfftjOGdDbpgbrupi0Gwr899R0jzXikJ,SpATywNh6bZuzm8s1ceuBUnMUAeoAHHw,25,43,21,5,8,0,20,0,97,13.857142857142858,10,0.0,7,21,5,8,36,0,0,20,0,41,56,0
6085,57303,CaX18aJHbUP3ScD0zmD3Y89LmBQVHmQw,SpATywNh6bZuzm8s1ceuBUnMUAeoAHHw,9,11,1,0,1,0,5,0,18,2.5714285714285716,1,0.0,0,1,0,1,11,0,0,5,0,2,16,1
6086,57310,amNosdi6Uiilljdy8esSBA3F29NKPLUW,A3fsA9Zfv1X2fVEQhTw51lKENdNrEqT3,16,23,15,0,3,2,23,0,66,9.428571428571429,7,0.0,0,15,0,3,23,2,0,23,0,18,48,1
6087,57326,v5WfKNQF0CY0mETK5LltBghiZQFigDWQ,A3fsA9Zfv1X2fVEQhTw51lKENdNrEqT3,5,0,0,0,0,0,8,0,8,1.1428571428571428,1,0.0,0,0,0,0,0,0,0,8,0,0,8,1
6088,57331,lG1rIQFzGK2zgeecJjKcKMBkKt4Dzz9j,RXDvfPUBYFlVdlueBFbLW0mhhAyGEqpt,7,3,2,0,2,0,2,0,9,1.2857142857142858,1,0.0,0,2,0,2,3,0,0,2,0,4,5,1
6089,57336,7FBwqoodmzhvrGGLuwBjRrxsykocUv8u,A3fsA9Zfv1X2fVEQhTw51lKENdNrEqT3,31,108,81,0,44,22,19,1,275,39.285714285714285,5,0.0,9,81,0,44,99,22,0,19,1,134,141,1
6090,57348,YPxQmDfYnmHgiT7CBa1xK3KUyMZAnQfd,SpATywNh6bZuzm8s1ceuBUnMUAeoAHHw,16,9,5,6,3,1,6,1,31,4.428571428571429,2,0.0,2,5,6,3,7,1,0,6,1,16,15,1
6091,57351,m8heXBwBoAingce16ZKybSsmTBnHzE4y,SpATywNh6bZuzm8s1ceuBUnMUAeoAHHw,1,0,0,0,0,0,1,0,1,0.14285714285714285,1,0.0,0,0,0,0,0,0,0,1,0,0,1,1
6092,57356,3SNPt0tgFaFs22ZCc56rWyLmizBS9I72,RXDvfPUBYFlVdlueBFbLW0mhhAyGEqpt,1,0,0,0,0,0,1,0,1,0.14285714285714285,1,0.0,0,0,0,0,0,0,0,1,0,0,1,1
6093,57359,Arkq8NiPd69nYa08JuNw4PEusLHNf9hH,SpATywNh6bZuzm8s1ceuBUnMUAeoAHHw,4,6,1,0,0,0,2,0,9,1.2857142857142858,1,0.0,0,1,0,0,6,0,0,2,0,1,8,1
6094,57362,VrrBciftY2IctWxZzgYOD4l9QhmKgryv,SpATywNh6bZuzm8s1ceuBUnMUAeoAHHw,56,66,50,34,35,1,9,0,195,27.857142857142858,7,0.0,9,50,31,35,57,1,3,9,0,125,70,0
6095,57385,XJf8gYhDJm1hrkVJvLQ4HKEnvPd3mIMq,SpATywNh6bZuzm8s1ceuBUnMUAeoAHHw,21,24,0,18,0,1,6,0,49,7.0,4,0.0,4,0,18,0,20,1,0,6,0,22,27,0
6096,57396,YTd6RUCxKSrzEOkqGgY5uphLrJJcaHu6,RXDvfPUBYFlVdlueBFbLW0mhhAyGEqpt,1,0,0,0,0,0,1,0,1,0.14285714285714285,1,0.0,0,0,0,0,0,0,0,1,0,0,1,1
6097,57398,jHVltfBYXhDsXX9G7YWEMLSGV2wRodE1,SpATywNh6bZuzm8s1ceuBUnMUAeoAHHw,2,0,0,0,0,0,3,0,3,0.42857142857142855,1,0.0,0,0,0,0,0,0,0,3,0,0,3,1
6098,57414,sQhlNn7KiXOhhd3W8wdYsXetKwfQaOrI,SpATywNh6bZuzm8s1ceuBUnMUAeoAHHw,14,35,2,5,2,0,2,0,46,6.571428571428571,2,0.0,23,2,5,2,12,0,0,2,0,32,14,0
6099,57416,VrQWFYHS8Y40ZzXEJSIKFiNDL1oCM4M9,G8EPVSXsOYB5YQWZGiz1aVq5Pgr2GrQu,7,3,2,0,2,0,2,0,9,1.2857142857142858,1,0.0,0,2,0,2,3,0,0,2,0,4,5,1
6100,57420,xQ0oPcnoBqnptb23qNnWO05KL2jCqFC5,5X6FeZozNMgE2VRi3MJYjkkFK8SETtu2,4,12,3,0,0,0,4,0,19,2.7142857142857144,2,0.0,3,3,0,0,9,0,0,4,0,6,13,1
6101,57421,xVSPiuldrfuaqB5x0wSqqh0RzPMsoNZK,SpATywNh6bZuzm8s1ceuBUnMUAeoAHHw,35,47,40,0,28,1,7,1,124,17.714285714285715,7,0.0,0,40,0,28,47,1,0,7,1,68,56,0
6102,57430,trbTOxlGHBKj11KndbOpMZg4seGBeXai,SpATywNh6bZuzm8s1ceuBUnMUAeoAHHw,1,0,0,0,0,0,1,0,1,0.14285714285714285,1,0.0,0,0,0,0,0,0,0,1,0,0,1,1
6103,57441,VR8oLKZP6LgyxXON0sRbhHMwM11kusu8,bWdj2GDclj5ofokWjzoa5jAwMkxCykd6,2,0,0,0,0,0,4,0,4,0.5714285714285714,1,0.0,0,0,0,0,0,0,0,4,0,0,4,1
6104,57444,VR8oLKZP6LgyxXON0sRbhHMwM11kusu8,A3fsA9Zfv1X2fVEQhTw51lKENdNrEqT3,1,0,0,0,0,0,1,0,1,0.14285714285714285,1,0.0,0,0,0,0,0,0,0,1,0,0,1,1
6105,57446,kQIkvivFIxDUKmroLdQlORRiVyNMIh8I,5X6FeZozNMgE2VRi3MJYjkkFK8SETtu2,2,0,0,0,0,0,2,0,2,0.2857142857142857,1,0.0,0,0,0,0,0,0,0,2,0,0,2,1
6106,57462,QLGFenndIPaX8I2vSI7keErJ6m5JCAL7,A3fsA9Zfv1X2fVEQhTw51lKENdNrEqT3,28,20,13,0,12,1,19,2,67,9.571428571428571,2,0.0,2,13,0,12,18,1,0,19,2,27,40,1
6107,57477,5OgjW4RBhSCbfYx5XYwPp5mVp3N7l8JT,SpATywNh6bZuzm8s1ceuBUnMUAeoAHHw,41,56,38,24,11,11,46,3,189,27.0,9,0.0,7,38,23,11,49,11,1,46,3,79,110,1
6108,57497,h8ApK52PAIR0nuhXQv52hCsI8LxUHnXl,SpATywNh6bZuzm8s1ceuBUnMUAeoAHHw,15,23,1,15,0,0,5,1,45,6.428571428571429,2,0.0,6,1,12,0,17,0,3,5,1,19,26,1
6109,57510,CUu3LU8HdtJIouVTGHl3Ax78lqpPSeMD,A3fsA9Zfv1X2fVEQhTw51lKENdNrEqT3,12,12,7,0,3,0,4,0,26,3.7142857142857144,3,0.0,0,7,0,3,12,0,0,4,0,10,16,1
6110,57513,UzQguR9rIMiPdU8z0yQro6T1cVdElqDP,RXDvfPUBYFlVdlueBFbLW0mhhAyGEqpt,1,0,0,0,0,0,1,0,1,0.14285714285714285,1,0.0,0,0,0,0,0,0,0,1,0,0,1,1
6111,57540,q9BQrPVmTGVLXUZRKxvQUgkPlzz6bi8e,SpATywNh6bZuzm8s1ceuBUnMUAeoAHHw,7,8,4,0,4,0,3,0,19,2.7142857142857144,2,0.0,0,4,0,4,8,0,0,3,0,8,11,1
6112,57561,6aFJz85V1QzDFnu4WDixDzJkjtxtwyZY,5X6FeZozNMgE2VRi3MJYjkkFK8SETtu2,20,48,10,16,29,0,2,0,105,15.0,6,0.0,33,10,16,29,15,0,0,2,0,88,17,1
6113,57564,eAArxLyCThtu9N3Mv8rQculKbGSa66j9,bWdj2GDclj5ofokWjzoa5jAwMkxCykd6,7,7,2,22,1,0,6,0,38,5.428571428571429,3,0.0,3,2,20,1,4,0,2,6,0,26,12,1
6114,57568,73lhhrOcE2srJj5BkIzSweWSnQRZBT2o,SpATywNh6bZuzm8s1ceuBUnMUAeoAHHw,31,74,47,29,0,1,16,0,167,23.857142857142858,13,0.0,8,47,26,0,66,1,3,16,0,81,86,1
6115,57575,2OPkOMgZitV39CjjFQfjbadYph2VzorR,SpATywNh6bZuzm8s1ceuBUnMUAeoAHHw,6,3,1,0,1,0,2,0,7,1.0,1,0.0,0,1,0,1,3,0,0,2,0,2,5,1
6116,57594,OOsRSTJd6U7cE43XHk99M9ofvrefufrh,A3fsA9Zfv1X2fVEQhTw51lKENdNrEqT3,18,21,10,0,7,0,4,0,42,6.0,3,0.0,0,10,0,7,21,0,0,4,0,17,25,0
6117,57617,NVzsLV2hJQHxCBnLyaDpT9HrhRSWUOfa,RXDvfPUBYFlVdlueBFbLW0mhhAyGEqpt,48,91,29,66,11,9,22,4,232,33.142857142857146,4,0.0,18,29,63,11,73,9,3,22,4,121,111,1
6118,57619,WN542VQFBPN1yXud5IZMh3hZ3MXP7IGT,SpATywNh6bZuzm8s1ceuBUnMUAeoAHHw,6,0,0,0,0,1,7,1,9,1.2857142857142858,1,0.0,0,0,0,0,0,1,0,7,1,0,9,1
6119,57636,D5gDQ8hFb4klemeBiodWmMPe9KIvqw9O,A3fsA9Zfv1X2fVEQhTw51lKENdNrEqT3,21,32,2,12,1,0,8,0,55,7.857142857142857,5,0.0,1,2,9,1,31,0,3,8,0,13,42,1
6120,57647,4nbfL8rG09dpITd3UJqnI29RM9ZdkZtq,SpATywNh6bZuzm8s1ceuBUnMUAeoAHHw,2,0,0,0,0,0,2,0,2,0.2857142857142857,2,0.0,0,0,0,0,0,0,0,2,0,0,2,0
6121,57651,4nbfL8rG09dpITd3UJqnI29RM9ZdkZtq,RXDvfPUBYFlVdlueBFbLW0mhhAyGEqpt,1,0,0,0,0,0,1,0,1,0.14285714285714285,1,0.0,0,0,0,0,0,0,0,1,0,0,1,1
6122,57656,Y3ZpN8DOQK8YTfD0eUtklxiZfpWuBIeU,SpATywNh6bZuzm8s1ceuBUnMUAeoAHHw,32,42,25,25,15,4,10,0,121,17.285714285714285,4,0.0,9,25,25,15,33,4,0,10,0,74,47,0
6123,57658,gVmGREkYa5QlWPxC36Kl2VgCKKIwVXGZ,SpATywNh6bZuzm8s1ceuBUnMUAeoAHHw,1,0,0,0,0,0,1,0,1,0.14285714285714285,1,0.0,0,0,0,0,0,0,0,1,0,0,1,1
6124,57662,Py3KfqJj0ayFe0tkBJK6rKEFzXLKIBTS,RXDvfPUBYFlVdlueBFbLW0mhhAyGEqpt,30,41,3,0,3,0,5,0,52,7.428571428571429,3,0.0,1,3,0,3,40,0,0,5,0,7,45,0
6125,57663,bMJNLK5q5EUyioc5VWWKIebvvb4KHRiu,SpATywNh6bZuzm8s1ceuBUnMUAeoAHHw,14,20,2,18,1,0,8,1,50,7.142857142857143,2,0.0,10,2,15,1,10,0,3,8,1,28,22,1
6126,57671,j2LUphS0wjc6SNX1uC1d62i1omfcNa3o,SpATywNh6bZuzm8s1ceuBUnMUAeoAHHw,1,0,0,0,0,0,1,0,1,0.14285714285714285,1,0.0,0,0,0,0,0,0,0,1,0,0,1,1
6127,57674,o51Y4SLAGY9EUpnbYlzlny2aYMXKv66D,RXDvfPUBYFlVdlueBFbLW0mhhAyGEqpt,32,25,19,0,15,2,4,0,65,9.285714285714286,2,0.0,0,19,0,15,25,2,0,4,0,34,31,0
6128,57682,srWiqmJDli77OpcMHfZ4qTkRYOHonVJT,SpATywNh6bZuzm8s1ceuBUnMUAeoAHHw,18,18,0,10,0,1,8,0,37,5.285714285714286,3,0.0,0,0,10,0,18,1,0,8,0,10,27,0
6129,57711,cIl5ErCL6J4OGJVSovWEaY2KTpWCk21L,SpATywNh6bZuzm8s1ceuBUnMUAeoAHHw,20,19,7,38,2,16,7,2,91,13.0,1,0.0,11,7,33,2,8,16,5,7,2,53,38,1
6130,57712,p8eEbMqW5LefqN7qPq07exxdOPrIZY20,SpATywNh6bZuzm8s1ceuBUnMUAeoAHHw,23,69,19,14,13,1,20,2,138,19.714285714285715,9,0.0,5,19,14,13,64,1,0,20,2,51,87,1
6131,57719,3t9ZicXafEarB5kevklUjZj2RJMyb5VH,A3fsA9Zfv1X2fVEQhTw51lKENdNrEqT3,8,13,4,0,2,7,6,0,32,4.571428571428571,1,0.0,0,4,0,2,13,7,0,6,0,6,26,1
6132,57721,s61FWJSeWbhAUVg6RnrheusxdyXUW2UQ,bWdj2GDclj5ofokWjzoa5jAwMkxCykd6,1,0,0,0,0,0,1,0,1,0.14285714285714285,1,0.0,0,0,0,0,0,0,0,1,0,0,1,1
6133,57723,s61FWJSeWbhAUVg6RnrheusxdyXUW2UQ,A3fsA9Zfv1X2fVEQhTw51lKENdNrEqT3,1,0,0,0,0,0,1,0,1,0.14285714285714285,1,0.0,0,0,0,0,0,0,0,1,0,0,1,1
6134,57731,VfWuQS8OTjJmyvWxq07hV2rzKtyu1LCX,SpATywNh6bZuzm8s1ceuBUnMUAeoAHHw,11,14,9,6,0,0,5,0,34,4.857142857142857,2,0.0,2,9,6,0,12,0,0,5,0,17,17,0
6135,57735,uhbUne0Zqx7l0LKNWrxxR44WistJmxKI,SpATywNh6bZuzm8s1ceuBUnMUAeoAHHw,26,49,5,32,3,0,12,0,101,14.428571428571429,6,0.0,8,5,29,3,41,0,3,12,0,45,56,1
6136,57739,6hTHLv2ACZhw5sTOpdEFsUQMXrnQn22A,RXDvfPUBYFlVdlueBFbLW0mhhAyGEqpt,3,2,1,0,0,0,2,0,5,0.7142857142857143,2,0.0,0,1,0,0,2,0,0,2,0,1,4,1
6137,57745,2cQ9kfcrQBQHmPAj78FQajELUCejB41f,bWdj2GDclj5ofokWjzoa5jAwMkxCykd6,6,2,1,0,1,0,3,0,7,1.0,1,0.0,0,1,0,1,2,0,0,3,0,2,5,1
6138,57750,c7B7iseemfO0QdFbtlw4FK4yHsx5NyMH,SpATywNh6bZuzm8s1ceuBUnMUAeoAHHw,11,6,4,6,3,0,2,0,21,3.0,1,0.0,1,4,5,3,5,0,1,2,0,13,8,1
6139,57770,TiyssQ1xBxRpSE8M84hoblpjLNawoMPM,A3fsA9Zfv1X2fVEQhTw51lKENdNrEqT3,12,7,5,0,4,0,8,0,24,3.4285714285714284,3,0.0,0,5,0,4,7,0,0,8,0,9,15,1
6140,57777,RDWXbk79jB26meX1BrQSCYz1EfxumOsd,bWdj2GDclj5ofokWjzoa5jAwMkxCykd6,1,0,0,0,0,0,1,0,1,0.14285714285714285,1,0.0,0,0,0,0,0,0,0,1,0,0,1,1
6141,57793,QiC1wt4ygzMS12Sok49ryeSwI2RAnFQT,bWdj2GDclj5ofokWjzoa5jAwMkxCykd6,4,3,0,0,0,0,4,0,7,1.0,1,0.0,0,0,0,0,3,0,0,4,0,0,7,1
6142,57797,bZSiNUbAIuydDBd77IMAJ15Hy6k2A1kT,A3fsA9Zfv1X2fVEQhTw51lKENdNrEqT3,48,34,23,76,17,0,11,0,161,23.0,3,0.0,5,23,62,17,29,0,14,11,0,107,54,0
6143,57814,qdfZW2ffZy8gfDfLseVXmzjU3pjHztuR,SpATywNh6bZuzm8s1ceuBUnMUAeoAHHw,11,6,4,11,2,1,7,1,32,4.571428571428571,2,0.0,1,4,10,2,5,1,1,7,1,17,15,1
6144,57823,nTCOXKuQTHlcdJy5DLRFkg6Zh0x7ymZf,SpATywNh6bZuzm8s1ceuBUnMUAeoAHHw,22,49,5,30,2,3,13,0,102,14.571428571428571,2,0.0,13,5,27,2,36,3,3,13,0,47,55,0
6145,57840,97ov4fTuLcUGM3NRcbowYBsVQSUEYP2S,SpATywNh6bZuzm8s1ceuBUnMUAeoAHHw,10,10,6,0,5,0,2,0,23,3.2857142857142856,2,0.0,0,6,0,5,10,0,0,2,0,11,12,0
6146,57842,pJxqH2g5fYbOQNkZyqRIriBj2xa6OAqj,A3fsA9Zfv1X2fVEQhTw51lKENdNrEqT3,12,7,5,0,4,0,3,0,19,2.7142857142857144,2,0.0,0,5,0,4,7,0,0,3,0,9,10,0
6147,57865,6R0qSS2YfDD3HGMPKZeKRUJLbFOIEhNG,SpATywNh6bZuzm8s1ceuBUnMUAeoAHHw,21,36,5,0,1,0,15,0,57,8.142857142857142,5,0.0,0,5,0,1,36,0,0,15,0,6,51,0
6148,57882,X5rINxWa3wsNz25becwIKIJ1YSNrjMdg,bWdj2GDclj5ofokWjzoa5jAwMkxCykd6,2,0,0,0,0,0,2,0,2,0.2857142857142857,1,0.0,0,0,0,0,0,0,0,2,0,0,2,0
6149,57891,zwagDP4QQaMM8mzfViYvCtx8beK29IaC,A3fsA9Zfv1X2fVEQhTw51lKENdNrEqT3,5,2,1,0,1,0,3,0,7,1.0,1,0.0,0,1,0,1,2,0,0,3,0,2,5,1
6150,57921,LJN1NW4KDrkfGUEkF9SJPSL4rdPIFcim,RXDvfPUBYFlVdlueBFbLW0mhhAyGEqpt,11,10,5,0,2,0,6,0,23,3.2857142857142856,3,0.0,0,5,0,2,10,0,0,6,0,7,16,1
6151,57923,g6dPr9Qj9PAMVLVyPAgx25XT3ANwjQos,A3fsA9Zfv1X2fVEQhTw51lKENdNrEqT3,34,15,11,48,8,0,5,0,87,12.428571428571429,3,0.0,1,11,46,8,14,0,2,5,0,66,21,1
6152,57973,pZOzdWSKDu3gPwQbI7bGCPRq9RkLjBvS,SpATywNh6bZuzm8s1ceuBUnMUAeoAHHw,1,0,0,0,0,0,1,0,1,0.14285714285714285,1,0.0,0,0,0,0,0,0,0,1,0,0,1,1
6153,57974,kdNglpfKE0K2VvGEZqSD6DoYNnlqyGGv,SpATywNh6bZuzm8s1ceuBUnMUAeoAHHw,11,12,1,5,1,0,2,0,21,3.0,2,0.0,1,1,5,1,11,0,0,2,0,8,13,1
6154,57983,Di7uZGkXU7ZYc44baVoHLFkrq0yYlHlb,SpATywNh6bZuzm8s1ceuBUnMUAeoAHHw,28,37,15,27,7,2,9,0,97,13.857142857142858,2,0.0,9,15,26,7,28,2,1,9,0,57,40,0
6155,57985,Fg273P4R5QIMcXX0ux53RnorAp03dcGp,SpATywNh6bZuzm8s1ceuBUnMUAeoAHHw,5,7,1,0,1,0,2,0,11,1.5714285714285714,1,0.0,0,1,0,1,7,0,0,2,0,2,9,1
6156,58010,iHNKByBLJR2ePn7ZhbbN3FnmeYGE5yyC,SpATywNh6bZuzm8s1ceuBUnMUAeoAHHw,8,10,4,0,2,0,3,2,21,3.0,1,0.0,2,4,0,2,8,0,0,3,2,8,13,1
6157,58047,RTEXU8778fHYGtEiPFJloCtKj0eYc7zl,SpATywNh6bZuzm8s1ceuBUnMUAeoAHHw,6,3,0,0,0,4,4,0,11,1.5714285714285714,1,0.0,0,0,0,0,3,4,0,4,0,0,11,1
6158,58064,rtg3Ki4vk14kI9MkEBE0pkOCAO2AnCnU,A3fsA9Zfv1X2fVEQhTw51lKENdNrEqT3,90,65,40,246,17,0,20,1,389,55.57142857142857,8,0.0,6,40,204,17,59,0,42,20,1,267,122,0
6159,58067,pAWmot8vJjNkDuzTDPJSBxqvPejAjgVS,RXDvfPUBYFlVdlueBFbLW0mhhAyGEqpt,7,6,5,0,5,0,6,0,22,3.142857142857143,2,0.0,0,5,0,5,6,0,0,6,0,10,12,1
6160,58072,QWCcSRplc8XLohtOnjfleuw3Kl55Wt2l,G8EPVSXsOYB5YQWZGiz1aVq5Pgr2GrQu,20,28,15,4,9,0,2,0,58,8.285714285714286,2,0.0,5,15,3,9,23,0,1,2,0,32,26,1
6161,58081,VdrjT29t1tCYeqV5Pjs9K79bb5dKTQSe,SpATywNh6bZuzm8s1ceuBUnMUAeoAHHw,12,6,3,0,2,1,8,1,21,3.0,2,0.0,0,3,0,2,6,1,0,8,1,5,16,1
6162,58088,ohNbQfFfbGDEMVmhwhRAFtQhn1peVJYy,SpATywNh6bZuzm8s1ceuBUnMUAeoAHHw,17,15,10,16,6,3,4,0,54,7.714285714285714,2,0.0,3,10,14,6,12,3,2,4,0,33,21,1
6163,58090,02SLgXn6QytDv0WqMwkosTxHkpEuP7VB,bWdj2GDclj5ofokWjzoa5jAwMkxCykd6,5,2,1,0,1,0,2,0,6,0.8571428571428571,1,0.0,0,1,0,1,2,0,0,2,0,2,4,0
6164,58102,RPQvIQfjeayIRS4PyDyrIytbJ9ZHNktA,SpATywNh6bZuzm8s1ceuBUnMUAeoAHHw,35,68,36,12,8,7,24,1,156,22.285714285714285,11,0.0,18,36,12,8,50,7,0,24,1,74,82,1
6165,58103,7bgBjtUo1mIawwXbLRcW3oiIroDcQOz6,SpATywNh6bZuzm8s1ceuBUnMUAeoAHHw,5,2,1,0,1,0,2,0,6,0.8571428571428571,1,0.0,0,1,0,1,2,0,0,2,0,2,4,1
6166,58112,Bf025FfgNrlcqN8gYGnmBAhjBy0v5Xmo,A3fsA9Zfv1X2fVEQhTw51lKENdNrEqT3,8,7,4,0,2,0,6,0,19,2.7142857142857144,2,0.0,0,4,0,2,7,0,0,6,0,6,13,1
6167,58123,YUqfabBN24DH37opLol4A70oThsuifuQ,SpATywNh6bZuzm8s1ceuBUnMUAeoAHHw,1,0,0,0,0,0,1,0,1,0.14285714285714285,1,0.0,0,0,0,0,0,0,0,1,0,0,1,1
6168,58128,th3jtP88bHr6FB2R2HdadrOKTixMDxTi,SpATywNh6bZuzm8s1ceuBUnMUAeoAHHw,11,11,3,0,3,0,16,1,34,4.857142857142857,3,0.0,0,3,0,3,11,0,0,16,1,6,28,1
6169,58133,dytCdr5a5mu9Lr4Kt80AVLD7WwBUELzE,A3fsA9Zfv1X2fVEQhTw51lKENdNrEqT3,13,23,12,0,5,0,5,0,45,6.428571428571429,2,0.0,0,12,0,5,23,0,0,5,0,17,28,1
6170,58144,S6sXBOP7ss0lVuaz3ZVr4HFw4oNRFeXC,5X6FeZozNMgE2VRi3MJYjkkFK8SETtu2,8,7,1,0,1,1,7,1,18,2.5714285714285716,1,0.0,0,1,0,1,7,1,0,7,1,2,16,1
6171,58150,7a8ZShKuD962zsBaN4mct9BkYS1KNLrF,SpATywNh6bZuzm8s1ceuBUnMUAeoAHHw,18,27,20,7,10,1,6,0,71,10.142857142857142,2,0.0,2,20,6,10,25,1,1,6,0,38,33,0
6172,58153,5IgfYzsKnLRjBd3YVdiUAOaMV18WR5D2,SpATywNh6bZuzm8s1ceuBUnMUAeoAHHw,2,0,0,0,0,0,3,0,3,0.42857142857142855,2,0.0,0,0,0,0,0,0,0,3,0,0,3,1
6173,58161,0WJYCLUpH1qPXc41N4k9wHMseoSu2vAz,SpATywNh6bZuzm8s1ceuBUnMUAeoAHHw,30,42,19,29,8,5,6,0,109,15.571428571428571,3,0.0,17,19,26,8,25,5,3,6,0,70,39,0
6174,58181,XuNt1i5t4SR1AjDP4UHvsoux0R9qVf5C,A3fsA9Zfv1X2fVEQhTw51lKENdNrEqT3,23,15,7,52,2,0,3,0,79,11.285714285714286,1,0.0,0,7,49,2,15,0,3,3,0,58,21,1
6175,58186,QxxdakYrISiiDLexNlB0fwU8yeNcfQh4,5X6FeZozNMgE2VRi3MJYjkkFK8SETtu2,1,0,0,0,0,0,1,0,1,0.14285714285714285,1,0.0,0,0,0,0,0,0,0,1,0,0,1,1
6176,58216,nZTn5dZMRyIKKNGuMbIWH6lpWaWoYX62,bWdj2GDclj5ofokWjzoa5jAwMkxCykd6,7,6,2,0,1,0,3,0,12,1.7142857142857142,2,0.0,0,2,0,1,6,0,0,3,0,3,9,1
6177,58242,JaIi02fnjAZfoUxjYtpyJ7uZYWKdC5yF,RXDvfPUBYFlVdlueBFbLW0mhhAyGEqpt,20,54,3,17,4,10,17,0,105,15.0,3,0.0,6,3,17,4,48,10,0,17,0,30,75,1
6178,58254,hkGRaSb7xMufUFhBVJXaeYKKkPgEjvNE,SpATywNh6bZuzm8s1ceuBUnMUAeoAHHw,12,9,1,0,1,0,3,1,15,2.142857142857143,1,0.0,0,1,0,1,9,0,0,3,1,2,13,1
6179,58255,zzLagpOecSivjjn7PNG5qmEhwa4PmnNX,SpATywNh6bZuzm8s1ceuBUnMUAeoAHHw,21,48,22,30,7,0,17,0,124,17.714285714285715,5,0.0,17,22,27,7,31,0,3,17,0,73,51,1
6180,58270,49oypRKmbhsESvRt5ynYhyueQezYQsCQ,bWdj2GDclj5ofokWjzoa5jAwMkxCykd6,4,2,0,0,0,0,3,0,5,0.7142857142857143,2,0.0,0,0,0,0,2,0,0,3,0,0,5,1
6181,58271,S8Q8neHdkaiSIrDXkWMhuMhsENfqfEdt,G8EPVSXsOYB5YQWZGiz1aVq5Pgr2GrQu,13,17,9,0,9,0,8,0,43,6.142857142857143,2,0.0,6,9,0,9,11,0,0,8,0,24,19,1
6182,58272,xOB7vl3l1Tpb0i0cSWni40BfJ5FBclms,A3fsA9Zfv1X2fVEQhTw51lKENdNrEqT3,41,39,10,74,8,3,20,0,154,22.0,4,0.0,3,10,66,8,36,3,8,20,0,87,67,1
6183,58273,YkzGM7FCSZusATw7cM0Pqx3TXux1w8Gj,SpATywNh6bZuzm8s1ceuBUnMUAeoAHHw,7,5,2,0,1,0,3,0,11,1.5714285714285714,2,0.0,0,2,0,1,5,0,0,3,0,3,8,1
6184,58286,y6i20DJpIul6LihHwgZcWxbdAap5GcBP,A3fsA9Zfv1X2fVEQhTw51lKENdNrEqT3,28,31,9,56,3,21,29,2,151,21.571428571428573,9,0.0,2,9,44,3,29,21,12,29,2,58,93,1
6185,58291,PCPmtsqEtkHe7GooXQswbqyH8cnukgFn,G8EPVSXsOYB5YQWZGiz1aVq5Pgr2GrQu,77,120,33,142,9,29,14,1,348,49.714285714285715,6,0.0,42,33,106,9,78,29,36,14,1,190,158,0
6186,58293,3ZzhbGHk0AMavVBVS0pUAaZvWnLoQODp,A3fsA9Zfv1X2fVEQhTw51lKENdNrEqT3,5,3,1,0,1,0,1,0,6,0.8571428571428571,1,0.0,0,1,0,1,3,0,0,1,0,2,4,0
6187,58300,uQw9hBSE2Dk9ZRkbmlhR0YJ8RRLoEt0U,SpATywNh6bZuzm8s1ceuBUnMUAeoAHHw,14,12,2,10,1,0,3,0,28,4.0,2,0.0,2,2,10,1,10,0,0,3,0,15,13,1
6188,58316,GfppdBt6zqP8G2m8ukjaahHhJ4ewTb0w,SpATywNh6bZuzm8s1ceuBUnMUAeoAHHw,25,61,3,28,2,1,7,0,102,14.571428571428571,7,0.0,11,3,26,2,50,1,2,7,0,42,60,0
6189,58328,bwboRgaiFEflIqviFAKUixpzo8aJUZGL,G8EPVSXsOYB5YQWZGiz1aVq5Pgr2GrQu,60,262,5,140,9,0,21,1,438,62.57142857142857,9,0.0,79,5,77,9,183,0,63,21,1,170,268,0
6190,58357,OdMr7dE5UlAme9Tp979vREBvY5CV50po,A3fsA9Zfv1X2fVEQhTw51lKENdNrEqT3,87,38,23,168,12,0,8,0,249,35.57142857142857,4,0.0,7,23,153,12,31,0,15,8,0,195,54,0
6191,58359,czKChsqaxfwVoznY2WnWYH2vLIXb6X34,bWdj2GDclj5ofokWjzoa5jAwMkxCykd6,18,24,14,2,12,1,5,0,58,8.285714285714286,3,0.0,3,14,2,12,21,1,0,5,0,31,27,1
6192,58371,O77ylT4ugXOb86DaYG0RYlYAbEVpuj16,bWdj2GDclj5ofokWjzoa5jAwMkxCykd6,6,3,1,0,2,0,3,0,9,1.2857142857142858,1,0.0,2,1,0,2,1,0,0,3,0,5,4,1
6193,58383,ewcDv7X6I323ciCMJsU4n4MdvO632A9I,bWdj2GDclj5ofokWjzoa5jAwMkxCykd6,14,18,1,154,1,0,4,0,178,25.428571428571427,2,0.0,8,1,151,1,10,0,3,4,0,161,17,1
6194,58387,AsOtGuZjIIEs9Ge9E033Sbp9VeIeUiUH,A3fsA9Zfv1X2fVEQhTw51lKENdNrEqT3,9,7,5,0,4,0,2,0,18,2.5714285714285716,2,0.0,0,5,0,4,7,0,0,2,0,9,9,1
6195,58396,vMwiflFInrKAqz6Uhuhl7ZJhinTtaSMK,SpATywNh6bZuzm8s1ceuBUnMUAeoAHHw,1,0,0,0,0,0,1,0,1,0.14285714285714285,1,0.0,0,0,0,0,0,0,0,1,0,0,1,1
6196,58399,Dw8R0agU0UT0CHCyap3lEB834WRdn2Bl,5X6FeZozNMgE2VRi3MJYjkkFK8SETtu2,8,5,4,0,4,0,1,0,14,2.0,1,0.0,0,4,0,4,5,0,0,1,0,8,6,1
6197,58403,Xn2ydtleLSG85TyAEd0OMkY2BfH9jhfO,SpATywNh6bZuzm8s1ceuBUnMUAeoAHHw,27,42,3,36,4,52,14,1,152,21.714285714285715,3,0.0,12,3,30,4,30,52,6,14,1,49,103,0
6198,58404,RBJm407yEn5NJTf66xkOViV4vHRGXhZs,A3fsA9Zfv1X2fVEQhTw51lKENdNrEqT3,44,55,25,0,20,0,13,0,113,16.142857142857142,3,0.0,0,25,0,20,55,0,0,13,0,45,68,0
6199,58453,fgzbUfrTxXYCuiFYTG1cTemcEJUl36an,A3fsA9Zfv1X2fVEQhTw51lKENdNrEqT3,10,13,4,0,3,0,7,0,27,3.857142857142857,6,0.0,0,4,0,3,13,0,0,7,0,7,20,1
6200,58459,UO0yW1yQ6dpOPTHCocxgWJWaWMRmXAmV,SpATywNh6bZuzm8s1ceuBUnMUAeoAHHw,19,43,11,4,8,0,14,0,80,11.428571428571429,9,0.0,1,11,3,8,42,0,1,14,0,23,57,0
6201,58485,UO0yW1yQ6dpOPTHCocxgWJWaWMRmXAmV,A3fsA9Zfv1X2fVEQhTw51lKENdNrEqT3,1,0,0,0,0,0,1,0,1,0.14285714285714285,1,0.0,0,0,0,0,0,0,0,1,0,0,1,1
6202,58503,uznRyNJNtd1ZgZ95fF39jNQxAuIkBivb,A3fsA9Zfv1X2fVEQhTw51lKENdNrEqT3,29,36,27,12,22,0,12,0,109,15.571428571428571,3,0.0,2,27,12,22,34,0,0,12,0,63,46,0
6203,58524,T761UltC8HrAVgHTpcJuQFf7vNJ3Ud9J,A3fsA9Zfv1X2fVEQhTw51lKENdNrEqT3,40,48,32,0,23,0,5,0,108,15.428571428571429,3,0.0,0,32,0,23,48,0,0,5,0,55,53,0
6204,58526,OgKWYLWF7k4jNyuIPtj4HfbaQ79kKNws,A3fsA9Zfv1X2fVEQhTw51lKENdNrEqT3,21,16,13,0,10,0,14,0,53,7.571428571428571,4,0.0,0,13,0,10,16,0,0,14,0,23,30,1
6205,58544,bpxaFadaQixJuWRVtAAq5miKiBM3zC6u,A3fsA9Zfv1X2fVEQhTw51lKENdNrEqT3,64,92,5,142,4,23,33,1,300,42.857142857142854,10,0.0,5,5,134,4,87,23,8,33,1,148,152,0
6206,58546,u1YszrViylpVYfK1eoJx8s7LOLPdQuxR,G8EPVSXsOYB5YQWZGiz1aVq5Pgr2GrQu,8,6,1,0,1,1,5,1,15,2.142857142857143,1,0.0,3,1,0,1,3,1,0,5,1,5,10,1
6207,58549,PNuCKnyPWCRVxphTjJ1pIquyKu0dURK7,5X6FeZozNMgE2VRi3MJYjkkFK8SETtu2,14,29,7,16,5,0,7,0,64,9.142857142857142,6,0.0,7,7,14,5,22,0,2,7,0,33,31,1
6208,58560,3wojMge418Q4FflCb29r3hem59j6egRX,SpATywNh6bZuzm8s1ceuBUnMUAeoAHHw,21,64,2,20,0,5,24,0,115,16.428571428571427,6,0.0,23,2,16,0,41,5,4,24,0,41,74,1
6209,58581,2rfL8B4HbJAOL6vHmGEftXwUPWvgkqAq,G8EPVSXsOYB5YQWZGiz1aVq5Pgr2GrQu,2,0,0,0,0,0,2,0,2,0.2857142857142857,1,0.0,0,0,0,0,0,0,0,2,0,0,2,1
6210,58582,o0M6SOlciWGWtqkYLASaq6tS76D18V6N,SpATywNh6bZuzm8s1ceuBUnMUAeoAHHw,30,69,25,40,10,47,22,1,214,30.571428571428573,6,0.0,28,25,33,10,41,47,7,22,1,96,118,0
6211,58598,7Yap2PcZ1Tcmw27mR2CH7ZbGwXBMRlQy,bWdj2GDclj5ofokWjzoa5jAwMkxCykd6,7,3,1,0,1,0,8,1,14,2.0,1,0.0,0,1,0,1,3,0,0,8,1,2,12,1
6212,58600,O3gLgOLI0OlNHxEv48gq43YbMqSfrrr5,SpATywNh6bZuzm8s1ceuBUnMUAeoAHHw,1,0,0,0,0,0,1,0,1,0.14285714285714285,1,0.0,0,0,0,0,0,0,0,1,0,0,1,1
6213,58601,pIkx6nDAjTla5NYVEsjhMXOIu5zXDzmO,G8EPVSXsOYB5YQWZGiz1aVq5Pgr2GrQu,31,23,16,0,15,0,11,2,67,9.571428571428571,3,0.0,3,16,0,15,20,0,0,11,2,34,33,0
6214,58614,Elb131j0dQdh1y8beabFLrOKaH2n8x2C,SpATywNh6bZuzm8s1ceuBUnMUAeoAHHw,1,0,0,0,0,0,1,0,1,0.14285714285714285,1,0.0,0,0,0,0,0,0,0,1,0,0,1,1
6215,58637,2CPNIar2bLO0Nk3gqpw6tYIpylWKP9T0,RXDvfPUBYFlVdlueBFbLW0mhhAyGEqpt,21,29,10,31,14,0,12,0,96,13.714285714285714,4,0.0,18,10,29,14,11,0,2,12,0,71,25,0
6216,58640,z0d4GdTRWwPphB67CIM0rjy94Artnm4E,bWdj2GDclj5ofokWjzoa5jAwMkxCykd6,13,16,9,4,7,15,9,1,61,8.714285714285714,2,0.0,2,9,4,7,14,15,0,9,1,22,39,1
6217,58641,0du1ow9RqiNaGy3uHg59U3uAi9Pl6foI,SpATywNh6bZuzm8s1ceuBUnMUAeoAHHw,6,3,1,0,1,0,2,0,7,1.0,1,0.0,0,1,0,1,3,0,0,2,0,2,5,1
6218,58642,ALYZFAVviUOGzyN4znk46d3PmVgvtUAM,A3fsA9Zfv1X2fVEQhTw51lKENdNrEqT3,35,24,2,74,1,0,4,0,105,15.0,2,0.0,1,2,62,1,23,0,12,4,0,66,39,1
6219,58644,zWZdErlwOQ1yvd6vlyAltL2Balhdc8gj,G8EPVSXsOYB5YQWZGiz1aVq5Pgr2GrQu,144,167,98,368,39,60,33,1,766,109.42857142857143,12,0.0,31,98,314,39,136,60,54,33,1,482,284,0
6220,58651,tdWhb9WfoB7e0A5Gjo7JvSpPeeCoQg77,5X6FeZozNMgE2VRi3MJYjkkFK8SETtu2,2,0,0,0,0,0,2,0,2,0.2857142857142857,1,0.0,0,0,0,0,0,0,0,2,0,0,2,1
6221,58658,CG3QLsuznsakuKho7ljIoKCjBowMzxNf,SpATywNh6bZuzm8s1ceuBUnMUAeoAHHw,6,3,2,0,2,0,1,0,8,1.1428571428571428,1,0.0,0,2,0,2,3,0,0,1,0,4,4,0
6222,58675,jm31Z85lUKPglpGy76SHR0pRWJW0VhuU,SpATywNh6bZuzm8s1ceuBUnMUAeoAHHw,23,48,6,22,1,1,13,0,91,13.0,5,0.0,10,6,22,1,38,1,0,13,0,39,52,1
6223,58686,y9A8XMlmfPaglBBuQFjiuxUOvb1WQu2v,bWdj2GDclj5ofokWjzoa5jAwMkxCykd6,1,0,0,0,0,0,1,0,1,0.14285714285714285,1,0.0,0,0,0,0,0,0,0,1,0,0,1,0
6224,58692,2rfL8B4HbJAOL6vHmGEftXwUPWvgkqAq,A3fsA9Zfv1X2fVEQhTw51lKENdNrEqT3,5,2,1,0,1,0,3,0,7,1.0,1,0.0,0,1,0,1,2,0,0,3,0,2,5,1
6225,58693,2AEx3J0dyYAsdnSPWbdrCmQApLqSYiKY,SpATywNh6bZuzm8s1ceuBUnMUAeoAHHw,32,52,28,22,8,12,15,2,139,19.857142857142858,3,0.0,17,28,17,8,35,12,5,15,2,70,69,0
6226,58738,eFoLZ7Ff0p8wCkYKEUOC13yf0OTaGh2R,A3fsA9Zfv1X2fVEQhTw51lKENdNrEqT3,2,0,0,0,0,0,6,0,6,0.8571428571428571,1,0.0,0,0,0,0,0,0,0,6,0,0,6,1
6227,58755,Hw4Baku6JlYmMCYHpyYlIRmyrGYxbxqZ,bWdj2GDclj5ofokWjzoa5jAwMkxCykd6,4,2,1,0,1,0,1,0,5,0.7142857142857143,1,0.0,0,1,0,1,2,0,0,1,0,2,3,1
6228,58763,HZ8Q7bQ1EwRW8jOabrhMI019qnvyVzyL,G8EPVSXsOYB5YQWZGiz1aVq5Pgr2GrQu,88,152,46,156,34,20,10,3,421,60.142857142857146,7,0.0,64,46,109,34,88,20,47,10,3,253,168,0
6229,58765,rc05wotvNjs6yb6NUxWRBXqWQTWfWnjs,SpATywNh6bZuzm8s1ceuBUnMUAeoAHHw,9,10,1,0,0,0,4,0,15,2.142857142857143,1,0.0,0,1,0,0,10,0,0,4,0,1,14,1
6230,58777,4Ofl2Ny0Hi8mgxaGCrkktZk3mHl8PQkx,SpATywNh6bZuzm8s1ceuBUnMUAeoAHHw,1,0,0,0,0,0,1,0,1,0.14285714285714285,1,0.0,0,0,0,0,0,0,0,1,0,0,1,1
6231,58791,rc05wotvNjs6yb6NUxWRBXqWQTWfWnjs,bWdj2GDclj5ofokWjzoa5jAwMkxCykd6,1,0,0,0,0,0,1,0,1,0.14285714285714285,1,0.0,0,0,0,0,0,0,0,1,0,0,1,1
6232,58793,mrUvSMVJRVrLlCOcTH6rs5HGHSxrWvwY,5X6FeZozNMgE2VRi3MJYjkkFK8SETtu2,15,17,3,16,6,0,3,0,45,6.428571428571429,3,0.0,10,3,14,6,7,0,2,3,0,33,12,1
6233,58794,1zErz13s8fNQRVaEvkOtvw6bLhr23yB4,SpATywNh6bZuzm8s1ceuBUnMUAeoAHHw,16,19,9,31,1,0,3,0,63,9.0,3,0.0,7,9,26,1,12,0,5,3,0,43,20,0
6234,58800,irZDaKqT4KdxcZGgiOHoDpvTtZyUugWP,G8EPVSXsOYB5YQWZGiz1aVq5Pgr2GrQu,83,90,29,187,15,8,25,0,354,50.57142857142857,9,0.0,1,29,170,15,89,8,17,25,0,215,139,0
6235,58804,OUbh6hvaOJDp9RK7kgTBzzPmjzmkYhZF,SpATywNh6bZuzm8s1ceuBUnMUAeoAHHw,34,49,0,40,1,16,18,2,126,18.0,6,0.0,8,0,34,1,41,16,6,18,2,43,83,0
6236,58806,Sz4iN9vM7plSJObu2Kgng7aJijtNNsts,SpATywNh6bZuzm8s1ceuBUnMUAeoAHHw,9,11,1,0,0,1,1,0,14,2.0,1,0.0,1,1,0,0,10,1,0,1,0,2,12,1
6237,58812,x2TXADDQJTDLVMnKDb6BhJyWEoYQjlQy,SpATywNh6bZuzm8s1ceuBUnMUAeoAHHw,25,48,1,26,2,8,11,0,96,13.714285714285714,7,0.0,19,1,20,2,29,8,6,11,0,42,54,1
6238,58818,67rSRaCVWXo14Jy7qMP7vHh2SS3POF3M,G8EPVSXsOYB5YQWZGiz1aVq5Pgr2GrQu,68,73,40,20,28,3,24,4,192,27.428571428571427,6,0.0,10,40,10,28,63,3,10,24,4,88,104,0
6239,58827,3TxSZWzNHIbrfRxUDxTOVx9pjdTX8q1m,5X6FeZozNMgE2VRi3MJYjkkFK8SETtu2,10,11,2,14,0,0,1,0,28,4.0,1,0.0,8,2,13,0,3,0,1,1,0,23,5,1
6240,58833,z9n4TGh9UXCrVLnylY34Ni1zPy7fphxP,G8EPVSXsOYB5YQWZGiz1aVq5Pgr2GrQu,8,15,10,0,0,1,2,0,28,4.0,2,0.0,2,10,0,0,13,1,0,2,0,12,16,1
6241,58849,9UxAqNYuBtvS2ppV37y5D8wZyoNAl3Em,SpATywNh6bZuzm8s1ceuBUnMUAeoAHHw,16,56,10,15,2,23,17,4,127,18.142857142857142,5,0.0,13,10,12,2,43,23,3,17,4,37,90,1
6242,58855,6K3h9aDeHI9AUqOKTvZxzGkKh6WMc7A3,SpATywNh6bZuzm8s1ceuBUnMUAeoAHHw,26,19,16,0,13,0,5,0,53,7.571428571428571,3,0.0,0,16,0,13,19,0,0,5,0,29,24,0
6243,58877,Hoitr98hXhrf7xDGgACEFamKhiarA3wg,SpATywNh6bZuzm8s1ceuBUnMUAeoAHHw,47,91,54,44,19,49,25,1,283,40.42857142857143,11,0.0,19,54,39,19,72,49,5,25,1,131,152,0
6244,58887,7wyfXvc1g99QNmXzEb4w8C1vE0Vi2bHm,RXDvfPUBYFlVdlueBFbLW0mhhAyGEqpt,22,34,16,0,9,1,7,0,67,9.571428571428571,4,0.0,0,16,0,9,34,1,0,7,0,25,42,0
6245,58893,Oh4qObC7j4dz8QtvEnVVjGNXqScAv0Td,A3fsA9Zfv1X2fVEQhTw51lKENdNrEqT3,3,0,0,0,0,0,4,0,4,0.5714285714285714,2,0.0,0,0,0,0,0,0,0,4,0,0,4,0
6246,58928,oxKInSadxtDVW8xImZsLo8dMy3cZAYYB,G8EPVSXsOYB5YQWZGiz1aVq5Pgr2GrQu,6,2,2,0,2,0,6,0,12,1.7142857142857142,1,0.0,0,2,0,2,2,0,0,6,0,4,8,0
6247,58931,KF0Hp0kY1zRx3PfsDN1lrNbV34F9NU2o,SpATywNh6bZuzm8s1ceuBUnMUAeoAHHw,1,0,0,0,0,0,1,0,1,0.14285714285714285,1,0.0,0,0,0,0,0,0,0,1,0,0,1,1
6248,58937,BWQpUowEHGBDEzSf23lNUZVBPlEw3Sq1,SpATywNh6bZuzm8s1ceuBUnMUAeoAHHw,24,46,4,24,0,1,14,0,89,12.714285714285714,8,0.0,12,4,18,0,34,1,6,14,0,34,55,0
6249,58950,whJWNnqELrOvTyaZggRzz2ByxhMecVCf,5X6FeZozNMgE2VRi3MJYjkkFK8SETtu2,3,2,0,0,0,0,2,0,4,0.5714285714285714,1,0.0,0,0,0,0,2,0,0,2,0,0,4,1
6250,58988,yQ30DktO8KD929ApuNMOdNKTtmTpkfc3,SpATywNh6bZuzm8s1ceuBUnMUAeoAHHw,3,0,0,0,0,8,4,0,12,1.7142857142857142,2,0.0,0,0,0,0,0,8,0,4,0,0,12,1
6251,58995,s52sWVKWNW4BhZF8lEKgLOTywZdUL59a,A3fsA9Zfv1X2fVEQhTw51lKENdNrEqT3,46,42,24,76,14,1,23,4,184,26.285714285714285,4,0.0,3,24,65,14,39,1,11,23,4,106,78,1
6252,58998,yQ30DktO8KD929ApuNMOdNKTtmTpkfc3,5X6FeZozNMgE2VRi3MJYjkkFK8SETtu2,3,0,0,0,0,4,2,0,6,0.8571428571428571,1,0.0,0,0,0,0,0,4,0,2,0,0,6,1
6253,59000,yQ30DktO8KD929ApuNMOdNKTtmTpkfc3,bWdj2GDclj5ofokWjzoa5jAwMkxCykd6,3,0,0,0,0,4,2,0,6,0.8571428571428571,1,0.0,0,0,0,0,0,4,0,2,0,0,6,1
6254,59003,yQ30DktO8KD929ApuNMOdNKTtmTpkfc3,RXDvfPUBYFlVdlueBFbLW0mhhAyGEqpt,3,0,0,0,0,4,2,0,6,0.8571428571428571,1,0.0,0,0,0,0,0,4,0,2,0,0,6,1
6255,59023,1zErz13s8fNQRVaEvkOtvw6bLhr23yB4,G8EPVSXsOYB5YQWZGiz1aVq5Pgr2GrQu,62,110,50,116,21,11,27,4,339,48.42857142857143,6,0.0,39,50,81,21,71,11,35,27,4,191,148,0
6256,59026,yxVlIOgiPy2uO2769tIJMAsvrTHms87z,5X6FeZozNMgE2VRi3MJYjkkFK8SETtu2,2,0,0,0,0,0,2,0,2,0.2857142857142857,1,0.0,0,0,0,0,0,0,0,2,0,0,2,1
6257,59030,yxVlIOgiPy2uO2769tIJMAsvrTHms87z,SpATywNh6bZuzm8s1ceuBUnMUAeoAHHw,1,0,0,0,0,0,1,0,1,0.14285714285714285,1,0.0,0,0,0,0,0,0,0,1,0,0,1,1
6258,59043,SicKtTdinGjYgkh3dK0y8UiEfELy0LiN,A3fsA9Zfv1X2fVEQhTw51lKENdNrEqT3,4,3,2,0,0,0,1,0,6,0.8571428571428571,1,0.0,0,2,0,0,3,0,0,1,0,2,4,1
6259,59059,WyukafQHQxismOtYiPzoFkAc38hAOB09,SpATywNh6bZuzm8s1ceuBUnMUAeoAHHw,36,93,41,31,16,17,16,0,214,30.571428571428573,9,0.0,41,41,27,16,52,17,4,16,0,125,89,0
6260,59061,XviXJdbSmJpUjtXY3NDPcBVoPrslVGvz,A3fsA9Zfv1X2fVEQhTw51lKENdNrEqT3,2,0,0,0,0,0,2,0,2,0.2857142857142857,1,0.0,0,0,0,0,0,0,0,2,0,0,2,1
6261,59074,pspPjjKHZe0z6Fq8OVRjBFFpabOEyxUN,G8EPVSXsOYB5YQWZGiz1aVq5Pgr2GrQu,1,0,0,0,0,0,1,0,1,0.14285714285714285,1,0.0,0,0,0,0,0,0,0,1,0,0,1,0
6262,59086,QscGDFmAAH7jp4ntcbRqVptjZvFSEe7R,bWdj2GDclj5ofokWjzoa5jAwMkxCykd6,1,0,0,0,0,0,1,0,1,0.14285714285714285,1,0.0,0,0,0,0,0,0,0,1,0,0,1,1
6263,59096,ycTj3YOXaJ7pHDIwrzbh7koMVXAXAOVY,A3fsA9Zfv1X2fVEQhTw51lKENdNrEqT3,9,4,3,0,3,0,3,0,13,1.8571428571428572,2,0.0,0,3,0,3,4,0,0,3,0,6,7,1
6264,59112,SSR2C7GBXM7XyR67GN0wwOxiCuLYjW4G,SpATywNh6bZuzm8s1ceuBUnMUAeoAHHw,28,97,5,42,6,8,37,3,198,28.285714285714285,8,0.0,26,5,36,6,71,8,6,37,3,73,125,0
6265,59123,GDXKLbggMsEQESvte5Fm99YDi8EaSknC,SpATywNh6bZuzm8s1ceuBUnMUAeoAHHw,2,0,0,0,0,0,2,0,2,0.2857142857142857,1,0.0,0,0,0,0,0,0,0,2,0,0,2,1
6266,59127,B9KqNNxXBxHFUsJnQKQysblL3f8zF7sg,5X6FeZozNMgE2VRi3MJYjkkFK8SETtu2,4,14,6,0,0,0,9,0,29,4.142857142857143,8,0.0,0,6,0,0,14,0,0,9,0,6,23,0
6267,59133,kqS8BwWN9R1093oeblGkvtCsQJ68Gh0G,A3fsA9Zfv1X2fVEQhTw51lKENdNrEqT3,11,11,6,0,2,3,7,0,29,4.142857142857143,3,0.0,1,6,0,2,10,3,0,7,0,9,20,1
6268,59140,kqS8BwWN9R1093oeblGkvtCsQJ68Gh0G,5X6FeZozNMgE2VRi3MJYjkkFK8SETtu2,7,6,3,0,2,0,3,0,14,2.0,1,0.0,1,3,0,2,5,0,0,3,0,6,8,1
6269,59152,1QXHZAtBZ2KaQglYqYbNwbUn7ThwuB1g,A3fsA9Zfv1X2fVEQhTw51lKENdNrEqT3,1,0,0,0,0,0,1,0,1,0.14285714285714285,1,0.0,0,0,0,0,0,0,0,1,0,0,1,1
6270,59154,xkk52A95ro7prnFrC4vTRChCiKRyqt9P,bWdj2GDclj5ofokWjzoa5jAwMkxCykd6,13,11,6,4,7,1,6,1,36,5.142857142857143,2,0.0,4,6,4,7,7,1,0,6,1,21,15,1
6271,59155,1QXHZAtBZ2KaQglYqYbNwbUn7ThwuB1g,RXDvfPUBYFlVdlueBFbLW0mhhAyGEqpt,11,12,2,12,2,4,10,1,43,6.142857142857143,2,0.0,6,2,10,2,6,4,2,10,1,20,23,1
6272,59158,83bogZlv4TVHMx4MUYOU3yEQWNYHnGAe,A3fsA9Zfv1X2fVEQhTw51lKENdNrEqT3,6,4,2,0,0,0,3,1,10,1.4285714285714286,1,0.0,0,2,0,0,4,0,0,3,1,2,8,1
6273,59163,Jx3Mosyeukaoh3SiTDGSPF6OEZs0bdWa,bWdj2GDclj5ofokWjzoa5jAwMkxCykd6,15,9,7,0,6,4,7,1,34,4.857142857142857,1,0.0,0,7,0,6,9,4,0,7,1,13,21,1
6274,59172,jImHfNEIObE674KdIbKVj7cCJ4ufqzHJ,SpATywNh6bZuzm8s1ceuBUnMUAeoAHHw,9,25,12,0,3,59,10,0,109,15.571428571428571,5,0.0,2,12,0,3,23,59,0,10,0,17,92,0
6275,59176,EEY05e2oBdca2rsoXfuwyrFxbCmUnL6Y,SpATywNh6bZuzm8s1ceuBUnMUAeoAHHw,1,0,0,0,0,0,2,0,2,0.2857142857142857,2,0.0,0,0,0,0,0,0,0,2,0,0,2,1
6276,59184,GBRSAR4GUGDv32LhHoze2mah1gIJQuBL,bWdj2GDclj5ofokWjzoa5jAwMkxCykd6,1,0,0,0,0,0,1,0,1,0.14285714285714285,1,0.0,0,0,0,0,0,0,0,1,0,0,1,1
6277,59212,VEbRHtoIqckybLHD2s2cXrjpdz3kQuu9,3VkHkmOtom3jM2wCu94xgzzu1d6Dn7or,42,42,8,0,22,1,7,1,81,11.571428571428571,9,0.0,6,8,0,22,36,1,0,7,1,36,45,0
6278,59228,poD9Y0r7TViOtu4Ne3cNJnc5HjxX414e,3VkHkmOtom3jM2wCu94xgzzu1d6Dn7or,21,39,3,14,11,9,9,0,85,12.142857142857142,5,0.0,18,3,13,11,21,9,1,9,0,45,40,1
6279,59247,MEBJlQgBfdioTMjrRwNRUmbBPKNQD24F,3VkHkmOtom3jM2wCu94xgzzu1d6Dn7or,19,40,16,11,13,47,21,39,187,26.714285714285715,3,0.0,15,16,10,13,25,47,1,21,39,54,133,1
6280,59290,85L8uHzEedN356VgQnCHbmew9208lpJw,3VkHkmOtom3jM2wCu94xgzzu1d6Dn7or,2,0,0,0,0,0,2,0,2,0.2857142857142857,1,0.0,0,0,0,0,0,0,0,2,0,0,2,1
6281,59300,V3FWVoDh1BAEjKi9l57CdriT1ZIRxyWZ,3VkHkmOtom3jM2wCu94xgzzu1d6Dn7or,6,6,3,0,2,0,6,0,17,2.4285714285714284,1,0.0,1,3,0,2,5,0,0,6,0,6,11,1
6282,59318,RFW46IpEEo40HQZmVwQOMd3VcTSwzvKz,3VkHkmOtom3jM2wCu94xgzzu1d6Dn7or,61,235,62,112,0,13,44,0,466,66.57142857142857,10,0.0,129,62,108,0,106,13,4,44,0,299,167,0
6283,59324,vApExcFFS0JPmBW9MgVKKwBFHidt1SlY,3VkHkmOtom3jM2wCu94xgzzu1d6Dn7or,41,166,38,66,1,5,12,0,288,41.142857142857146,5,0.0,70,38,66,1,96,5,0,12,0,175,113,1
6284,59332,NizqQaGjtKbKSjIbDqiqnHJildCbDYqn,3VkHkmOtom3jM2wCu94xgzzu1d6Dn7or,61,92,35,43,30,18,14,0,232,33.142857142857146,7,0.0,39,35,40,30,53,18,3,14,0,144,88,0
6285,59345,EFkTkZftT8UKiQGx6m8Gni8w9ocFq7gc,3VkHkmOtom3jM2wCu94xgzzu1d6Dn7or,64,111,55,37,52,8,11,0,274,39.142857142857146,6,0.0,44,55,35,52,67,8,2,11,0,186,88,0
6286,59351,jayUpzhZrhovArxIEdJtENjkmEYhxbYh,3VkHkmOtom3jM2wCu94xgzzu1d6Dn7or,5,2,1,0,1,0,2,0,6,0.8571428571428571,1,0.0,0,1,0,1,2,0,0,2,0,2,4,1
6287,59361,1ITGuQ2R8DpLVa12S7xW3GeCStKCoFln,3VkHkmOtom3jM2wCu94xgzzu1d6Dn7or,26,56,22,6,17,1,7,0,109,15.571428571428571,5,0.0,9,22,6,17,47,1,0,7,0,54,55,1
6288,59377,FixP7IuJ80KsWtzMzcQsJZKOjLxDKZgC,3VkHkmOtom3jM2wCu94xgzzu1d6Dn7or,1,0,0,0,0,0,1,0,1,0.14285714285714285,1,0.0,0,0,0,0,0,0,0,1,0,0,1,1
6289,59400,cCe6xOEVFA542oTGtw9gUWrojQghfhVL,3VkHkmOtom3jM2wCu94xgzzu1d6Dn7or,1,0,0,0,0,0,1,0,1,0.14285714285714285,1,0.0,0,0,0,0,0,0,0,1,0,0,1,1
6290,59438,rE9K06oyERpjKJkpGfIsPBvYwhHDKHpS,3VkHkmOtom3jM2wCu94xgzzu1d6Dn7or,7,2,2,0,2,0,2,0,8,1.1428571428571428,1,0.0,0,2,0,2,2,0,0,2,0,4,4,1
6291,59459,uqV3t3wNYphdy7WkOt07V9fSIpdy9v7v,3VkHkmOtom3jM2wCu94xgzzu1d6Dn7or,43,64,30,12,35,1,6,0,148,21.142857142857142,5,0.0,31,30,10,35,33,1,2,6,0,106,42,0
6292,59468,7C9sedCuDcI0Lupln8IsomQAXFXtukZX,3VkHkmOtom3jM2wCu94xgzzu1d6Dn7or,80,173,54,98,69,0,43,1,438,62.57142857142857,13,0.0,91,54,78,69,82,0,20,43,1,292,146,0
6293,59505,zeUi2UnQZPPF6bRQXw2s8LZ41ZOdqRAa,3VkHkmOtom3jM2wCu94xgzzu1d6Dn7or,95,241,127,32,73,75,43,2,593,84.71428571428571,23,0.0,76,127,30,73,165,75,2,43,2,306,287,0
6294,59506,RO3dHKrKxiT60KjWceTSY3tRkkyA4JcO,3VkHkmOtom3jM2wCu94xgzzu1d6Dn7or,41,55,30,45,16,22,23,0,191,27.285714285714285,9,0.0,11,30,38,16,44,22,7,23,0,95,96,1
6295,59516,LMI1lXDB0wCJqGnBSI17rtPaArmZDSph,3VkHkmOtom3jM2wCu94xgzzu1d6Dn7or,4,3,1,0,1,0,1,0,6,0.8571428571428571,1,0.0,0,1,0,1,3,0,0,1,0,2,4,1
6296,59530,juVbHX0foXtVM2nuXBZsl3U8Jfr3RbwI,3VkHkmOtom3jM2wCu94xgzzu1d6Dn7or,9,8,3,0,2,0,7,1,21,3.0,4,0.0,1,3,0,2,7,0,0,7,1,6,15,1
6297,59572,zn2X74vvqUQRINz90WjZLsSsFglpYr7o,3VkHkmOtom3jM2wCu94xgzzu1d6Dn7or,28,67,25,20,24,23,11,0,170,24.285714285714285,7,0.0,30,25,16,24,37,23,4,11,0,95,75,1
6298,59595,8UhW1HcJSpUKetcNndZSyo2w5k5GEb12,3VkHkmOtom3jM2wCu94xgzzu1d6Dn7or,1,0,0,0,0,0,2,0,2,0.2857142857142857,1,0.0,0,0,0,0,0,0,0,2,0,0,2,0
6299,59616,G4AOaMm0AmjNhZ9C9axrZ0ht7wgkQeIL,3VkHkmOtom3jM2wCu94xgzzu1d6Dn7or,13,15,2,0,4,18,26,3,68,9.714285714285714,3,0.0,3,2,0,4,12,18,0,26,3,9,59,1
6300,59660,qmA1tIdKETbr0fzM0M5nXzq02tLsRnXu,3VkHkmOtom3jM2wCu94xgzzu1d6Dn7or,2,0,0,0,0,0,5,0,5,0.7142857142857143,2,0.0,0,0,0,0,0,0,0,5,0,0,5,1
6301,59672,Ffohn9JNnGJQD2IavzMTS00ubnVtcb2T,3VkHkmOtom3jM2wCu94xgzzu1d6Dn7or,95,224,63,126,91,36,21,3,564,80.57142857142857,11,0.0,128,63,115,91,96,36,11,21,3,397,167,0
6302,59684,BJFktx6XLqraMQHAMGcWHetpDrvPxBxd,3VkHkmOtom3jM2wCu94xgzzu1d6Dn7or,23,14,10,0,9,1,6,4,44,6.285714285714286,2,0.0,0,10,0,9,14,1,0,6,4,19,25,0
6303,59699,ERmr1GfdrAI0qFKxZkfcfxM8oSkRx0Ds,3VkHkmOtom3jM2wCu94xgzzu1d6Dn7or,6,4,1,0,1,2,6,0,14,2.0,1,0.0,1,1,0,1,3,2,0,6,0,3,11,1
6304,59707,ervv8qudQXPt17u1LrtitMJZWYGrVoGN,3VkHkmOtom3jM2wCu94xgzzu1d6Dn7or,1,0,0,0,0,0,1,0,1,0.14285714285714285,1,0.0,0,0,0,0,0,0,0,1,0,0,1,1
6305,59724,1y6m9mPuH7mPBqHvt801n34GaYBVVluZ,3VkHkmOtom3jM2wCu94xgzzu1d6Dn7or,6,5,3,0,2,0,2,0,12,1.7142857142857142,1,0.0,0,3,0,2,5,0,0,2,0,5,7,1
6306,59729,4dfnEKxHCmGabkBCiKHt5nKr3H7Bwo1x,3VkHkmOtom3jM2wCu94xgzzu1d6Dn7or,85,168,60,32,62,11,6,0,339,48.42857142857143,8,0.0,68,60,32,62,100,11,0,6,0,222,117,0
6307,59731,BQ9KAjZKqbg2NifI7C0AAaErNLk2PIaJ,3VkHkmOtom3jM2wCu94xgzzu1d6Dn7or,6,2,1,0,1,0,4,0,8,1.1428571428571428,1,0.0,0,1,0,1,2,0,0,4,0,2,6,1
6308,59733,hqcMEOE1A4JiPcXtM6pROthzRRCVwxKR,3VkHkmOtom3jM2wCu94xgzzu1d6Dn7or,1,0,0,0,0,0,1,0,1,0.14285714285714285,1,0.0,0,0,0,0,0,0,0,1,0,0,1,1
6309,59741,uEijUBLW1L48ks9Yg3X6PWezXlhSNpBG,3VkHkmOtom3jM2wCu94xgzzu1d6Dn7or,23,42,21,24,15,6,26,5,139,19.857142857142858,2,0.0,18,21,20,15,24,6,4,26,5,74,65,1
6310,59752,Qkgoou3r4TgVjNLlv6htzGfkFEYo98Y1,3VkHkmOtom3jM2wCu94xgzzu1d6Dn7or,6,2,1,0,1,0,5,0,9,1.2857142857142858,1,0.0,0,1,0,1,2,0,0,5,0,2,7,1
6311,59759,KwbKBuJJ500i8wZdeFPG8Me42kEDTjsQ,3VkHkmOtom3jM2wCu94xgzzu1d6Dn7or,11,13,1,2,4,3,8,0,31,4.428571428571429,1,0.0,2,1,2,4,11,3,0,8,0,9,22,1
6312,59762,SbxWcDAQO1PnIdll82O1Qa8HqEHuIfT7,3VkHkmOtom3jM2wCu94xgzzu1d6Dn7or,23,26,22,0,14,0,11,0,73,10.428571428571429,3,0.0,0,22,0,14,26,0,0,11,0,36,37,0
6313,59789,nXcUtSl1H5elkR3fcabMsthQk8DiOJnh,3VkHkmOtom3jM2wCu94xgzzu1d6Dn7or,4,2,1,0,1,0,1,0,5,0.7142857142857143,1,0.0,0,1,0,1,2,0,0,1,0,2,3,1
6314,59797,06CPxvQ87tR05bV6rCGnDt3kdtYbJKM4,3VkHkmOtom3jM2wCu94xgzzu1d6Dn7or,11,10,5,4,3,0,3,0,25,3.5714285714285716,2,0.0,1,5,3,3,9,0,1,3,0,12,13,1
6315,59798,w85QVmINOIyrXRzegh8uuBeGTw3K4uG8,3VkHkmOtom3jM2wCu94xgzzu1d6Dn7or,70,150,31,40,44,10,27,2,304,43.42857142857143,14,0.0,61,31,39,44,89,10,1,27,2,175,129,0
6316,59808,YmAogTXGoaSGS2jBtwsCLUVebiwWGuMB,3VkHkmOtom3jM2wCu94xgzzu1d6Dn7or,15,22,4,5,7,2,6,0,46,6.571428571428571,2,0.0,12,4,4,7,10,2,1,6,0,27,19,0
6317,59826,sZ8OcUtlsHSfyDWYiLYzpr2d1BxixQDw,3VkHkmOtom3jM2wCu94xgzzu1d6Dn7or,62,171,46,79,63,16,27,0,402,57.42857142857143,4,0.0,89,46,70,63,82,16,9,27,0,268,134,1
6318,59851,HhPWIb0EGJ5j5q6DzxeKjCcUiZc0LGrO,3VkHkmOtom3jM2wCu94xgzzu1d6Dn7or,55,128,63,0,44,3,30,1,269,38.42857142857143,8,0.0,0,63,0,44,128,3,0,30,1,107,162,0
6319,59875,mlNqp7jcg3ulVLnJQaWtUA357Z110noc,3VkHkmOtom3jM2wCu94xgzzu1d6Dn7or,49,89,36,45,35,7,10,0,222,31.714285714285715,9,0.0,41,36,35,35,48,7,10,10,0,147,75,1
6320,59890,a8UKs1NxAK1Rc6mTIgzTKX0mHyAKUP88,3VkHkmOtom3jM2wCu94xgzzu1d6Dn7or,8,11,3,7,6,3,4,0,34,4.857142857142857,2,0.0,7,3,6,6,4,3,1,4,0,22,12,1
6321,59909,Wdfot5Syam86Zwq2ZnK5uHRtRyOhXClI,3VkHkmOtom3jM2wCu94xgzzu1d6Dn7or,9,28,5,0,4,0,7,0,44,6.285714285714286,3,0.0,1,5,0,4,27,0,0,7,0,10,34,1
6322,59924,fBNwaNNwzcybh8tC3Lc2wBKjJTR5vjRb,3VkHkmOtom3jM2wCu94xgzzu1d6Dn7or,8,5,0,0,2,0,14,7,28,4.0,1,0.0,3,0,0,2,2,0,0,14,7,5,23,1
6323,59959,iajSh65MjBysgZJuIFTLe4Uf4UcvDwPm,3VkHkmOtom3jM2wCu94xgzzu1d6Dn7or,71,166,52,155,21,30,33,1,458,65.42857142857143,10,0.0,96,52,143,21,70,30,12,33,1,312,146,0
6324,59998,mEBjJdKe2aB4znRfVwqZSlDKwqcAUUKv,3VkHkmOtom3jM2wCu94xgzzu1d6Dn7or,70,170,38,67,68,48,38,1,430,61.42857142857143,7,0.0,69,38,66,68,101,48,1,38,1,241,189,0
6325,60003,obFxfGLSP12hWUYqYGw1SR5lINNLUPlg,3VkHkmOtom3jM2wCu94xgzzu1d6Dn7or,17,59,21,16,18,7,21,10,152,21.714285714285715,4,0.0,26,21,11,18,33,7,5,21,10,76,76,0
6326,60016,Bl2GFpVypjnwol9jB8TQQ7qn8MIykZbR,3VkHkmOtom3jM2wCu94xgzzu1d6Dn7or,5,5,1,0,0,0,2,0,8,1.1428571428571428,1,0.0,0,1,0,0,5,0,0,2,0,1,7,1
6327,60035,wAN9qMt86ZcazBUSN9qSPUuop2dLTASV,3VkHkmOtom3jM2wCu94xgzzu1d6Dn7or,8,3,2,0,2,2,6,0,15,2.142857142857143,1,0.0,0,2,0,2,3,2,0,6,0,4,11,1
6328,60061,bYV2ECkbVEzILNLnjio0M2wLrbMzskol,7GRhBDsirIGkRZBtSMEzNTyDr2JQm4xx,2,0,0,0,0,0,2,0,2,0.2857142857142857,1,0.0,0,0,0,0,0,0,0,2,0,0,2,1
6329,60066,OkJ0lKmMXuQ2MGftQ8Isfw1JciMpapRC,7GRhBDsirIGkRZBtSMEzNTyDr2JQm4xx,1,0,0,0,0,0,1,0,1,0.14285714285714285,1,0.0,0,0,0,0,0,0,0,1,0,0,1,1
6330,60071,5tG3vaPrIg0p6kfnNpabCOvGZgklgDfi,5X6FeZozNMgE2VRi3MJYjkkFK8SETtu2,14,10,8,0,5,0,2,0,25,3.5714285714285716,2,0.0,0,8,0,5,10,0,0,2,0,13,12,0
6331,60074,Vve0UwhmiGWZN8bT2t4sC82sMWi2ZyY8,7GRhBDsirIGkRZBtSMEzNTyDr2JQm4xx,14,8,3,14,4,1,15,1,46,6.571428571428571,3,0.0,4,3,13,4,4,1,1,15,1,24,22,1
6332,60137,oQhebmIEEDGSQ048AIhyw1aXOl3SgEvP,5X6FeZozNMgE2VRi3MJYjkkFK8SETtu2,7,8,4,1,4,0,5,0,22,3.142857142857143,2,0.0,2,4,1,4,6,0,0,5,0,11,11,0
6333,60168,IJVC32xhcxjduQ5Gn9dQV405cC7i6x7I,5X6FeZozNMgE2VRi3MJYjkkFK8SETtu2,5,3,2,0,2,0,2,0,9,1.2857142857142858,1,0.0,0,2,0,2,3,0,0,2,0,4,5,1
6334,60186,YIoKCUIP4Rx4Vrk0MaySMDs3xqxsTZ0O,7GRhBDsirIGkRZBtSMEzNTyDr2JQm4xx,27,22,10,33,6,0,7,0,78,11.142857142857142,2,0.0,9,10,30,6,13,0,3,7,0,55,23,1
6335,60189,trY5Yo0vbJ00GveQ31z4FIOxjL0ITdnW,7GRhBDsirIGkRZBtSMEzNTyDr2JQm4xx,5,2,1,0,1,0,2,0,6,0.8571428571428571,1,0.0,0,1,0,1,2,0,0,2,0,2,4,0
6336,60193,ya3v1iYETjj0QFCSbW4Y8PQXQRFY49xl,7GRhBDsirIGkRZBtSMEzNTyDr2JQm4xx,46,108,32,76,33,21,13,0,283,40.42857142857143,7,0.0,48,32,60,33,60,21,16,13,0,173,110,1
6337,60197,PQI2FfKayBY1gxpt5gRYDDr8V8BaU7zU,5X6FeZozNMgE2VRi3MJYjkkFK8SETtu2,7,8,3,0,1,0,3,0,15,2.142857142857143,2,0.0,1,3,0,1,7,0,0,3,0,5,10,1
6338,60210,wGqhUJlJ3fGYOW2r7IbwNL0CdAR0avoU,7GRhBDsirIGkRZBtSMEzNTyDr2JQm4xx,79,297,105,204,63,134,16,0,819,117.0,10,0.0,163,105,155,63,134,134,49,16,0,486,333,1
6339,60214,Y3uwxWCm13Ol5xozrT2GPjOPhBlC2kOq,7GRhBDsirIGkRZBtSMEzNTyDr2JQm4xx,87,152,24,200,22,0,13,0,411,58.714285714285715,8,0.0,44,24,178,22,108,0,22,13,0,268,143,1
6340,60224,Glan4HLmS50xRoKOWAXnEjHiOG5ALXJa,7GRhBDsirIGkRZBtSMEzNTyDr2JQm4xx,2,0,0,0,0,0,2,0,2,0.2857142857142857,1,0.0,0,0,0,0,0,0,0,2,0,0,2,1
6341,60229,4IJ56QlJSL8avuRQEkrBcEyhUIO3LIP3,7GRhBDsirIGkRZBtSMEzNTyDr2JQm4xx,51,139,47,72,38,5,15,0,316,45.142857142857146,4,0.0,82,47,55,38,57,5,17,15,0,222,94,1
6342,60241,n2vbSLePtnxy4AVvThroeNvlXpcTMINy,7GRhBDsirIGkRZBtSMEzNTyDr2JQm4xx,42,55,22,2,15,0,7,0,101,14.428571428571429,4,0.0,9,22,1,15,46,0,1,7,0,47,54,0
6343,60245,yO1Jj5u6PMEcpPI9xjxordPxwxelX8AU,7GRhBDsirIGkRZBtSMEzNTyDr2JQm4xx,1,0,0,0,0,0,1,0,1,0.14285714285714285,1,0.0,0,0,0,0,0,0,0,1,0,0,1,1
6344,60264,iSrdvAXagFyTWuVpDzl1vXqwXkCyI8Nx,7GRhBDsirIGkRZBtSMEzNTyDr2JQm4xx,2,0,0,0,0,0,8,0,8,1.1428571428571428,3,0.0,0,0,0,0,0,0,0,8,0,0,8,1
6345,60266,7L5unYIhab1TebFiFv55Vd3f3JppE4WH,5X6FeZozNMgE2VRi3MJYjkkFK8SETtu2,4,2,1,0,1,0,2,0,6,0.8571428571428571,1,0.0,0,1,0,1,2,0,0,2,0,2,4,1
6346,60279,vxpUumLCzU7FedUSJgEG4isBVr1VqobO,7GRhBDsirIGkRZBtSMEzNTyDr2JQm4xx,5,2,0,0,0,0,3,0,5,0.7142857142857143,1,0.0,0,0,0,0,2,0,0,3,0,0,5,1
6347,60283,uRNJHauAxW10nQZrIpEU1nj0mhvBnDcR,7GRhBDsirIGkRZBtSMEzNTyDr2JQm4xx,8,6,3,0,2,1,5,0,17,2.4285714285714284,2,0.0,0,3,0,2,6,1,0,5,0,5,12,1
6348,60285,3A3xnhkl0PPjpuPQj8ksbgab2OoOm2Bf,7GRhBDsirIGkRZBtSMEzNTyDr2JQm4xx,2,0,0,0,0,0,2,0,2,0.2857142857142857,1,0.0,0,0,0,0,0,0,0,2,0,0,2,1
6349,60295,zKEKzDZvBY5bjlEOjPTJFe0fxEtpR0hq,7GRhBDsirIGkRZBtSMEzNTyDr2JQm4xx,1,0,0,0,0,0,1,0,1,0.14285714285714285,1,0.0,0,0,0,0,0,0,0,1,0,0,1,1
6350,60359,FMaoSj6PouPVBL36elw7C1ayn8NuceeR,7GRhBDsirIGkRZBtSMEzNTyDr2JQm4xx,1,0,0,0,0,0,1,0,1,0.14285714285714285,1,0.0,0,0,0,0,0,0,0,1,0,0,1,1
6351,60388,8Mx72ChYyrYeKtnyPn99FZFTvl5QDtPg,5X6FeZozNMgE2VRi3MJYjkkFK8SETtu2,11,8,6,0,3,6,5,0,28,4.0,2,0.0,0,6,0,3,8,6,0,5,0,9,19,1
6352,60427,r3TtJNrYEPB9JfkbBp23luDTSVLZGHt2,7GRhBDsirIGkRZBtSMEzNTyDr2JQm4xx,75,307,18,141,39,55,53,1,614,87.71428571428571,20,0.0,129,18,119,39,178,55,22,53,1,305,309,0
6353,60442,76btfIjeEvKDRqZ07unLyzOBWCQVXirv,7GRhBDsirIGkRZBtSMEzNTyDr2JQm4xx,37,39,16,52,11,1,9,0,128,18.285714285714285,5,0.0,15,16,43,11,24,1,9,9,0,85,43,0
6354,60459,IxKN3STMPrToOW2zFDcQPvfmFqbbi8Bw,5X6FeZozNMgE2VRi3MJYjkkFK8SETtu2,1,0,0,0,0,0,1,0,1,0.14285714285714285,1,0.0,0,0,0,0,0,0,0,1,0,0,1,1
6355,60514,p2VhKgs5pW28rABeDCjJR76cxi1YS9XC,5X6FeZozNMgE2VRi3MJYjkkFK8SETtu2,26,32,1,28,11,0,1,0,73,10.428571428571429,1,0.0,26,1,25,11,6,0,3,1,0,63,10,1
6356,60518,r639bFH7kDBWMyuyounNz9zTrG9jbNqa,7GRhBDsirIGkRZBtSMEzNTyDr2JQm4xx,77,219,57,120,40,82,47,2,567,81.0,6,0.0,70,57,107,40,149,82,13,47,2,274,293,0
6357,60531,Vdzl3X3O6ZP4Npa6oBdNxCc6U3L9nvWo,7GRhBDsirIGkRZBtSMEzNTyDr2JQm4xx,103,311,90,153,73,13,29,0,669,95.57142857142857,11,0.0,155,90,128,73,156,13,25,29,0,446,223,0
6358,60537,HixqtECIw1MfDhOlFHcd4iKMiA1aAB20,7GRhBDsirIGkRZBtSMEzNTyDr2JQm4xx,1,0,0,0,0,0,1,0,1,0.14285714285714285,1,0.0,0,0,0,0,0,0,0,1,0,0,1,1
6359,60551,yYnzwoX1EEo9O5PANf4AeqhApgmnqHcZ,7GRhBDsirIGkRZBtSMEzNTyDr2JQm4xx,48,77,36,48,25,5,12,0,203,29.0,2,0.0,34,36,42,25,43,5,6,12,0,137,66,1
6360,60575,u5mzcmE18EKn09QMnw59wiWLJPMqcNLU,7GRhBDsirIGkRZBtSMEzNTyDr2JQm4xx,11,5,4,0,4,0,2,0,15,2.142857142857143,1,0.0,0,4,0,4,5,0,0,2,0,8,7,1
6361,60578,n8xDhUwKlkQ0nvvpXIE3P2WLYZ4QLCAp,7GRhBDsirIGkRZBtSMEzNTyDr2JQm4xx,1,0,0,0,0,0,1,0,1,0.14285714285714285,1,0.0,0,0,0,0,0,0,0,1,0,0,1,1
6362,60612,hXKu4e2xQzaCku75DATROcU5QTIKASt0,7GRhBDsirIGkRZBtSMEzNTyDr2JQm4xx,9,4,3,0,3,0,4,0,14,2.0,1,0.0,0,3,0,3,4,0,0,4,0,6,8,1
6363,60621,oPxUAN8GTpfRQcDdNiJwDsKtCpP4XGLa,5X6FeZozNMgE2VRi3MJYjkkFK8SETtu2,5,2,1,0,1,0,2,0,6,0.8571428571428571,1,0.0,0,1,0,1,2,0,0,2,0,2,4,1
6364,60698,yWBM5NSXn0oxTlghKgVFEOhem7bIKtAR,7GRhBDsirIGkRZBtSMEzNTyDr2JQm4xx,1,0,0,0,0,0,1,0,1,0.14285714285714285,1,0.0,0,0,0,0,0,0,0,1,0,0,1,1
6365,60726,YmnL5Vd2hwZrlPvojHN5WzyBYQvWTeW1,7GRhBDsirIGkRZBtSMEzNTyDr2JQm4xx,2,0,0,0,0,0,2,0,2,0.2857142857142857,1,0.0,0,0,0,0,0,0,0,2,0,0,2,1
6366,60736,c9pXHqWvBB8LbdUhG5A5ihiNKOhfyXDu,7GRhBDsirIGkRZBtSMEzNTyDr2JQm4xx,6,7,0,0,0,0,3,0,10,1.4285714285714286,3,0.0,0,0,0,0,7,0,0,3,0,0,10,1
6367,60762,kCGRIKdKYvPuUYrVxn91JXcnBAZClhV5,5Gyp41oLVo7Gg7vF4vpmggWP5MU70QO6,16,32,16,3,6,1,4,0,62,8.857142857142858,2,0.0,12,16,3,6,20,1,0,4,0,37,25,1
6368,60788,JtMmp5BCDQnYE7CMI3NvnX4aRCZsQW9K,5Gyp41oLVo7Gg7vF4vpmggWP5MU70QO6,15,14,8,2,4,11,16,1,56,8.0,2,0.0,0,8,1,4,14,11,1,16,1,13,43,1
6369,60800,KZKp5TYL1EcqL79HaYEbES7V1ylqNKMQ,5Gyp41oLVo7Gg7vF4vpmggWP5MU70QO6,6,14,2,0,2,0,2,0,20,2.857142857142857,1,0.0,2,2,0,2,12,0,0,2,0,6,14,1
6370,60807,sseSPNAdgq0K7ngWvRJ9VjZGxKbBzOHV,5Gyp41oLVo7Gg7vF4vpmggWP5MU70QO6,13,23,10,0,7,50,14,1,105,15.0,5,0.0,8,10,0,7,15,50,0,14,1,25,80,1
6371,60812,7J9JIWVCQG1g6yXh3uTVbrSu3pa18Ezn,5Gyp41oLVo7Gg7vF4vpmggWP5MU70QO6,9,9,4,0,2,6,3,0,24,3.4285714285714284,2,0.0,1,4,0,2,8,6,0,3,0,7,17,1
6372,60821,ZzTSVpCC3NZTmUJDu5qmPWy1kpkkg23B,5Gyp41oLVo7Gg7vF4vpmggWP5MU70QO6,12,16,6,5,4,0,3,0,34,4.857142857142857,2,0.0,6,6,3,4,10,0,2,3,0,19,15,1
6373,60824,EdSyqy374rFTTRmoH6AfOLgRNsPjxdOm,5Gyp41oLVo7Gg7vF4vpmggWP5MU70QO6,12,40,7,17,1,33,5,0,103,14.714285714285714,3,0.0,17,7,12,1,23,33,5,5,0,37,66,0
6374,60836,qZitrXj0xDyiMoVtMqJ0te0xvV2uuGvW,5Gyp41oLVo7Gg7vF4vpmggWP5MU70QO6,10,4,3,0,2,2,5,1,17,2.4285714285714284,1,0.0,0,3,0,2,4,2,0,5,1,5,12,1
6375,60889,GhjwXxw03ma5isc4qZG3VJmb78KCJ9cp,5Gyp41oLVo7Gg7vF4vpmggWP5MU70QO6,8,2,0,0,1,1,5,1,10,1.4285714285714286,1,0.0,0,0,0,1,2,1,0,5,1,1,9,1
6376,60893,q6ImRwYI49QH6rDfPPrjdpug7s8VmM2U,5Gyp41oLVo7Gg7vF4vpmggWP5MU70QO6,3,0,0,0,0,0,7,0,7,1.0,1,0.0,0,0,0,0,0,0,0,7,0,0,7,1
6377,60895,kUV7PkffqTPC2wwIDiSU996TO0hf9cl5,5Gyp41oLVo7Gg7vF4vpmggWP5MU70QO6,4,2,1,0,1,0,1,0,5,0.7142857142857143,1,0.0,0,1,0,1,2,0,0,1,0,2,3,1
6378,60900,ixroUTgMTbZ2v416satSEbB9LtxayGob,5Gyp41oLVo7Gg7vF4vpmggWP5MU70QO6,10,16,6,4,5,3,2,0,36,5.142857142857143,2,0.0,6,6,3,5,10,3,1,2,0,20,16,1
6379,60908,YUajDafaxYTI7N27Q7CLvJUo32157OqV,5Gyp41oLVo7Gg7vF4vpmggWP5MU70QO6,1,0,0,0,0,0,1,0,1,0.14285714285714285,1,0.0,0,0,0,0,0,0,0,1,0,0,1,1
6380,60936,3bqMPd7dmQ6bVwYt9AjfxpDPMW8ppczj,7GRhBDsirIGkRZBtSMEzNTyDr2JQm4xx,4,2,1,0,1,1,1,0,6,0.8571428571428571,1,0.0,0,1,0,1,2,1,0,1,0,2,4,1
6381,60940,QVVTY0MAE22SN6rxHu950HeUm4kG0Wko,7GRhBDsirIGkRZBtSMEzNTyDr2JQm4xx,6,6,3,0,1,0,1,0,11,1.5714285714285714,1,0.0,0,3,0,1,6,0,0,1,0,4,7,1
6382,60941,GhWSz5WEMmds3hiXd5zoNrNGoNsN9LXL,7GRhBDsirIGkRZBtSMEzNTyDr2JQm4xx,14,14,6,0,4,1,12,1,38,5.428571428571429,2,0.0,5,6,0,4,9,1,0,12,1,15,23,1
6383,60960,hcKYo6bLhlANvHE0FxLuR4YY8jocfBwJ,7GRhBDsirIGkRZBtSMEzNTyDr2JQm4xx,1,0,0,0,0,0,1,0,1,0.14285714285714285,1,0.0,0,0,0,0,0,0,0,1,0,0,1,1
6384,60976,loY20pnf7suv2LWREXjC0h3XNawzaj7l,7GRhBDsirIGkRZBtSMEzNTyDr2JQm4xx,9,4,3,0,3,0,2,0,12,1.7142857142857142,1,0.0,0,3,0,3,4,0,0,2,0,6,6,1
6385,61001,KwMhn6xKDQ4sc6tWHQxhmw9vLZQikEKV,7GRhBDsirIGkRZBtSMEzNTyDr2JQm4xx,2,0,0,0,0,0,2,0,2,0.2857142857142857,1,0.0,0,0,0,0,0,0,0,2,0,0,2,1
6386,61008,8RsUWVhT21wU3hqZiuarsy4LdzVsaOkQ,5X6FeZozNMgE2VRi3MJYjkkFK8SETtu2,12,7,3,0,6,0,2,0,18,2.5714285714285716,1,0.0,3,3,0,6,4,0,0,2,0,12,6,1
6387,61039,RzKvPu4qwYnkKioYxIJem5I7hV4q5Zey,7GRhBDsirIGkRZBtSMEzNTyDr2JQm4xx,2,0,0,0,0,0,4,0,4,0.5714285714285714,2,0.0,0,0,0,0,0,0,0,4,0,0,4,0
6388,61051,ZqebYSMW1RUIRSXJmMzKs77Liu7pj2zF,5X6FeZozNMgE2VRi3MJYjkkFK8SETtu2,2,0,0,0,0,0,2,0,2,0.2857142857142857,1,0.0,0,0,0,0,0,0,0,2,0,0,2,1
6389,61087,GDHvw72iSHIz6VwsSteleP4praXBxk8h,7GRhBDsirIGkRZBtSMEzNTyDr2JQm4xx,38,76,1,36,6,33,13,5,170,24.285714285714285,4,0.0,40,1,26,6,36,33,10,13,5,73,97,1
6390,61101,PxY4KTZXiR1nUBRtclSF0b03F1Pqss0m,5X6FeZozNMgE2VRi3MJYjkkFK8SETtu2,9,11,6,2,5,0,5,0,29,4.142857142857143,1,0.0,3,6,2,5,8,0,0,5,0,16,13,1
6391,61115,dOT2svs05paSxmjedHl57q7jZeXZzSd2,5X6FeZozNMgE2VRi3MJYjkkFK8SETtu2,1,0,0,0,0,0,1,0,1,0.14285714285714285,1,0.0,0,0,0,0,0,0,0,1,0,0,1,1
6392,61130,v6Wfy2XnikKgnCNfehO3TIQzyPp7MzcN,7GRhBDsirIGkRZBtSMEzNTyDr2JQm4xx,2,0,0,0,0,0,2,0,2,0.2857142857142857,1,0.0,0,0,0,0,0,0,0,2,0,0,2,1
6393,61150,Z0pyF529vY6gfAXTUXYd2MCguE49KLJ7,7GRhBDsirIGkRZBtSMEzNTyDr2JQm4xx,2,0,0,0,0,0,4,0,4,0.5714285714285714,2,0.0,0,0,0,0,0,0,0,4,0,0,4,1
6394,61163,5HJHxaIfd0nCZcEUKuXJqPamaYk6aBtq,7GRhBDsirIGkRZBtSMEzNTyDr2JQm4xx,5,4,1,0,2,0,2,0,9,1.2857142857142858,1,0.0,2,1,0,2,2,0,0,2,0,5,4,1
6395,61186,J2puydpByblFRXtlxh6rWFA0oulKsltP,5X6FeZozNMgE2VRi3MJYjkkFK8SETtu2,6,3,1,0,1,0,4,1,10,1.4285714285714286,1,0.0,0,1,0,1,3,0,0,4,1,2,8,1
6396,61200,Y3GsHv1t2an649bMll1LdxvN2SIICjxG,7GRhBDsirIGkRZBtSMEzNTyDr2JQm4xx,5,2,1,0,1,0,3,0,7,1.0,1,0.0,0,1,0,1,2,0,0,3,0,2,5,1
6397,61208,5REjJFENp7n9hcI3zWF81mKx1k4GQz67,7GRhBDsirIGkRZBtSMEzNTyDr2JQm4xx,12,11,1,12,0,5,7,0,36,5.142857142857143,2,0.0,10,1,6,0,1,5,6,7,0,17,19,1
6398,61235,qDUQ1iBvNWtXbHcBUbRaieW5ktYMRWE0,7GRhBDsirIGkRZBtSMEzNTyDr2JQm4xx,1,0,0,0,0,0,1,0,1,0.14285714285714285,1,0.0,0,0,0,0,0,0,0,1,0,0,1,1
6399,61243,NVDm1UrviKBwDUtIj2XElADPKVdYouRj,5X6FeZozNMgE2VRi3MJYjkkFK8SETtu2,5,2,1,0,1,0,3,1,8,1.1428571428571428,2,0.0,0,1,0,1,2,0,0,3,1,2,6,1
6400,61267,dGZm4Htdvb1iV3IKfAeIZ2LAhkb1Gbe6,3VkHkmOtom3jM2wCu94xgzzu1d6Dn7or,4,13,3,0,0,0,1,0,17,2.4285714285714284,1,0.0,4,3,0,0,9,0,0,1,0,7,10,1
6401,61269,Xu2Wmr7ChGZ30LhApimfa4W4CAsLZTb4,3VkHkmOtom3jM2wCu94xgzzu1d6Dn7or,30,162,55,46,20,64,50,4,401,57.285714285714285,5,0.0,37,55,39,20,125,64,7,50,4,151,250,1
6402,61270,1SJmhRDD4Bzcm6S9X3GSNxkp9PjEl8e5,3VkHkmOtom3jM2wCu94xgzzu1d6Dn7or,14,7,6,0,6,0,3,0,22,3.142857142857143,1,0.0,0,6,0,6,7,0,0,3,0,12,10,1
6403,61271,QCz7iAgWTglOujTUKSsduDB6Qilzu930,3VkHkmOtom3jM2wCu94xgzzu1d6Dn7or,1,0,0,0,0,0,1,0,1,0.14285714285714285,1,0.0,0,0,0,0,0,0,0,1,0,0,1,1
6404,61275,fZ46j2fohm03QTARbgF90FHd23VNyR7N,3VkHkmOtom3jM2wCu94xgzzu1d6Dn7or,7,4,2,0,1,0,4,0,11,1.5714285714285714,2,0.0,0,2,0,1,4,0,0,4,0,3,8,1
6405,61277,sNixQiqbyoByL0a8WTxXOh0j3W120QrY,3VkHkmOtom3jM2wCu94xgzzu1d6Dn7or,16,36,12,11,14,14,9,0,96,13.714285714285714,3,0.0,19,12,9,14,17,14,2,9,0,54,42,1
6406,61278,Jb4oUgpxqLwX7kTj7ccezvvn1kbsURnR,3VkHkmOtom3jM2wCu94xgzzu1d6Dn7or,5,0,0,0,0,2,6,0,8,1.1428571428571428,1,0.0,0,0,0,0,0,2,0,6,0,0,8,1
6407,61279,N33q0sZm2H4OCladSji4PPu5G3B3tcSM,3VkHkmOtom3jM2wCu94xgzzu1d6Dn7or,96,258,125,99,79,28,113,2,704,100.57142857142857,19,0.0,94,125,90,79,164,28,9,113,2,388,316,0
6408,61285,lMM1JzejQytGyVkIVUZhykrOSAgSFpP7,3VkHkmOtom3jM2wCu94xgzzu1d6Dn7or,7,7,4,0,2,0,5,1,19,2.7142857142857144,2,0.0,0,4,0,2,7,0,0,5,1,6,13,1
6409,61286,55eRUKhAgZ6jAG2QNlk8p8bxI8Mo1ci4,3VkHkmOtom3jM2wCu94xgzzu1d6Dn7or,9,5,3,0,2,1,7,1,19,2.7142857142857144,1,0.0,0,3,0,2,5,1,0,7,1,5,14,1
6410,61291,thNUY2LiLdfoa2GF2Lwhr6spnxSoHgtr,3VkHkmOtom3jM2wCu94xgzzu1d6Dn7or,5,2,1,0,1,1,3,0,8,1.1428571428571428,1,0.0,0,1,0,1,2,1,0,3,0,2,6,1
6411,61295,1YFqbq4eZv4Mhq7JPXkIeiT5gk9dirXn,3VkHkmOtom3jM2wCu94xgzzu1d6Dn7or,4,0,0,0,0,3,3,1,7,1.0,1,0.0,0,0,0,0,0,3,0,3,1,0,7,1
6412,61300,uCa5BufZ9SzdynjpiFKUgTwQrCSkIuTv,3VkHkmOtom3jM2wCu94xgzzu1d6Dn7or,10,13,2,0,1,4,8,1,29,4.142857142857143,3,0.0,3,2,0,1,10,4,0,8,1,6,23,1
6413,61304,aPufBZhx6k52eMylgE3zOO2d01RzR36G,3VkHkmOtom3jM2wCu94xgzzu1d6Dn7or,1,0,0,0,0,0,1,0,1,0.14285714285714285,1,0.0,0,0,0,0,0,0,0,1,0,0,1,1
6414,61307,PLNJfZdR6EYXYVrLGogKUAQMKIHkwEgU,3VkHkmOtom3jM2wCu94xgzzu1d6Dn7or,4,2,1,0,1,0,1,0,5,0.7142857142857143,1,0.0,0,1,0,1,2,0,0,1,0,2,3,1
6415,61310,B7Iubi23XVqzH9vIBYh3kd1Uu97xMgg5,3VkHkmOtom3jM2wCu94xgzzu1d6Dn7or,2,0,0,0,0,0,3,0,3,0.42857142857142855,1,0.0,0,0,0,0,0,0,0,3,0,0,3,1
6416,61313,XZ29aLocCQNX1wXcSW5kg15u9Cwj9LID,3VkHkmOtom3jM2wCu94xgzzu1d6Dn7or,22,32,20,0,13,2,10,6,83,11.857142857142858,4,0.0,0,20,0,13,32,2,0,10,6,33,50,1
6417,61314,zHeujEYh5L6paRQ7acJHcEFwTj5egykX,3VkHkmOtom3jM2wCu94xgzzu1d6Dn7or,58,223,79,109,7,72,15,0,505,72.14285714285714,10,0.0,75,79,101,7,148,72,8,15,0,262,243,0
6418,61315,bXMaalfz1ZqHKnJWw6VXCAoemSeuw45Q,3VkHkmOtom3jM2wCu94xgzzu1d6Dn7or,91,117,63,55,72,2,43,2,354,50.57142857142857,13,0.0,48,63,47,72,69,2,8,43,2,230,124,0
6419,61317,GXpHmORghgiXMAlEcDVGL594XpoUvqlX,3VkHkmOtom3jM2wCu94xgzzu1d6Dn7or,64,125,53,42,44,40,31,0,335,47.857142857142854,6,0.0,50,53,39,44,75,40,3,31,0,186,149,0
6420,61318,Ynti1kEVPZ88eymZgi4Ldsdb7WhG2uKG,3VkHkmOtom3jM2wCu94xgzzu1d6Dn7or,17,40,15,0,9,2,16,1,83,11.857142857142858,7,0.0,0,15,0,9,40,2,0,16,1,24,59,1
6421,61320,UaTXpBQ57ylpYjSfyedXwjRneTYvxLXD,3VkHkmOtom3jM2wCu94xgzzu1d6Dn7or,1,0,0,0,0,0,1,0,1,0.14285714285714285,1,0.0,0,0,0,0,0,0,0,1,0,0,1,1
6422,61321,YY7yHizDn0UpGHVq4qoTfbulP3ev5TkC,3VkHkmOtom3jM2wCu94xgzzu1d6Dn7or,12,17,12,0,7,49,5,0,90,12.857142857142858,3,0.0,0,12,0,7,17,49,0,5,0,19,71,0
6423,61323,KmYofLuc0BaIyeuN3HJy8CuJaHG4AJDb,3VkHkmOtom3jM2wCu94xgzzu1d6Dn7or,4,2,1,0,1,0,1,0,5,0.7142857142857143,1,0.0,0,1,0,1,2,0,0,1,0,2,3,1
6424,61324,pFFSzAIsKlRn4mToKiENn82VvmlAcGfv,3VkHkmOtom3jM2wCu94xgzzu1d6Dn7or,9,5,3,0,4,0,7,0,19,2.7142857142857144,2,0.0,1,3,0,4,4,0,0,7,0,8,11,1
6425,61326,fyaPQSkjahso8DKGgPjDCImFPdJUGCuW,3VkHkmOtom3jM2wCu94xgzzu1d6Dn7or,5,6,1,0,2,0,2,0,11,1.5714285714285714,1,0.0,2,1,0,2,4,0,0,2,0,5,6,1
6426,61329,tSyXllu3VBRd0aW6BYXjiam1fTkDqGu0,3VkHkmOtom3jM2wCu94xgzzu1d6Dn7or,1,0,0,0,0,0,1,0,1,0.14285714285714285,1,0.0,0,0,0,0,0,0,0,1,0,0,1,1
6427,61333,3y0hMQPuZObbo4YGcpFjkRzHS18C7xm9,3VkHkmOtom3jM2wCu94xgzzu1d6Dn7or,1,0,0,0,0,0,2,0,2,0.2857142857142857,2,0.0,0,0,0,0,0,0,0,2,0,0,2,1
6428,61334,LvdumVddfOkiRrgcuYPzC8PJen0ULcog,3VkHkmOtom3jM2wCu94xgzzu1d6Dn7or,7,7,2,0,1,0,4,0,14,2.0,1,0.0,0,2,0,1,7,0,0,4,0,3,11,1
6429,61340,cmBf5dDhylT8akf52vSLbehcwSB094o7,3VkHkmOtom3jM2wCu94xgzzu1d6Dn7or,1,0,0,0,0,0,1,0,1,0.14285714285714285,1,0.0,0,0,0,0,0,0,0,1,0,0,1,1
6430,61342,ge4fVyuuR3ALhxHgeKDRlmkSZoMrgTvY,3VkHkmOtom3jM2wCu94xgzzu1d6Dn7or,6,2,1,0,1,0,3,2,9,1.2857142857142858,1,0.0,0,1,0,1,2,0,0,3,2,2,7,0
6431,61344,RraMsxEKuI5fM01TqMkfBoe68A6ycVzD,3VkHkmOtom3jM2wCu94xgzzu1d6Dn7or,33,81,39,16,41,28,25,3,233,33.285714285714285,5,0.0,36,39,15,41,45,28,1,25,3,131,102,1
6432,61345,EKW68EVipwDnVj4OACaFT183WfWiotRr,3VkHkmOtom3jM2wCu94xgzzu1d6Dn7or,66,324,94,76,90,63,97,27,771,110.14285714285714,13,0.0,182,94,65,90,142,63,11,97,27,431,340,0
6433,61346,cS4j36iYvYOHHK4d6wWz4Cr0lyqpITjd,3VkHkmOtom3jM2wCu94xgzzu1d6Dn7or,11,7,4,0,2,5,7,3,28,4.0,1,0.0,0,4,0,2,7,5,0,7,3,6,22,1
6434,61347,J0gLEwt810bfm4giMRKF4WoOeR9tXk1Z,3VkHkmOtom3jM2wCu94xgzzu1d6Dn7or,5,2,0,0,1,0,3,0,6,0.8571428571428571,2,0.0,0,0,0,1,2,0,0,3,0,1,5,1
6435,61353,7xNBrJLcG8Tw9PPj6SmLjDEzgSVEhwan,3VkHkmOtom3jM2wCu94xgzzu1d6Dn7or,7,3,2,0,2,0,2,0,9,1.2857142857142858,1,0.0,0,2,0,2,3,0,0,2,0,4,5,1
6436,61355,rO1YSAfPCFricBt51eVbZyq3Unb5LsBN,3VkHkmOtom3jM2wCu94xgzzu1d6Dn7or,5,2,1,0,1,0,3,0,7,1.0,1,0.0,0,1,0,1,2,0,0,3,0,2,5,1
6437,61357,9wj9AdMRKthqccyk1ZqPGvCnoYtKZSpQ,3VkHkmOtom3jM2wCu94xgzzu1d6Dn7or,16,38,7,6,18,32,3,0,104,14.857142857142858,1,0.0,30,7,6,18,8,32,0,3,0,61,43,1
6438,61359,C3qCYHZjY0uUjx6apnpRwLyUBwJoN7l6,3VkHkmOtom3jM2wCu94xgzzu1d6Dn7or,6,10,3,6,0,3,2,0,24,3.4285714285714284,1,0.0,4,3,5,0,6,3,1,2,0,12,12,1
6439,61362,eWDW1Ib1s4bTakCzRKbuXJli4ZP8oo7h,3VkHkmOtom3jM2wCu94xgzzu1d6Dn7or,8,13,7,1,2,9,6,0,38,5.428571428571429,2,0.0,1,7,1,2,12,9,0,6,0,11,27,1
6440,61363,B3hat72Gwdsh5VGB4UtT2PVbufh0eUw7,3VkHkmOtom3jM2wCu94xgzzu1d6Dn7or,5,3,1,2,1,0,2,0,9,1.2857142857142858,2,0.0,1,1,2,1,2,0,0,2,0,5,4,1
6441,61364,EmHfiIQoHEo5612aeOXbXefIQiZ9pivk,3VkHkmOtom3jM2wCu94xgzzu1d6Dn7or,8,13,4,3,6,3,3,1,33,4.714285714285714,1,0.0,7,4,3,6,6,3,0,3,1,20,13,1
6442,61365,5J6KvEX4H3vlRE4219qlauCGkc30MlxJ,3VkHkmOtom3jM2wCu94xgzzu1d6Dn7or,12,9,7,0,4,2,10,1,33,4.714285714285714,1,0.0,0,7,0,4,9,2,0,10,1,11,22,1
6443,61366,gTNmoWvWhpJtO6YnFGRmSk32TH4m5N9w,3VkHkmOtom3jM2wCu94xgzzu1d6Dn7or,5,4,1,0,2,0,2,0,9,1.2857142857142858,2,0.0,2,1,0,2,2,0,0,2,0,5,4,1
6444,61368,0lZgJ3Izj3xzJXE4iKqwdlPNZOcb8tfr,3VkHkmOtom3jM2wCu94xgzzu1d6Dn7or,20,14,10,0,8,0,4,0,36,5.142857142857143,1,0.0,1,10,0,8,13,0,0,4,0,19,17,1
6445,61370,KOlXIysOb8VF04tCZjd1kg0II2kb2mYu,3VkHkmOtom3jM2wCu94xgzzu1d6Dn7or,76,217,78,74,65,64,33,1,532,76.0,6,0.0,65,78,59,65,152,64,15,33,1,267,265,1
6446,61371,sZV7O4QepCcao3DEyr879t5mUWopWkVJ,3VkHkmOtom3jM2wCu94xgzzu1d6Dn7or,8,6,4,0,3,0,4,0,17,2.4285714285714284,1,0.0,0,4,0,3,6,0,0,4,0,7,10,1
6447,61373,gY4MmFhIOsF1Wm6XUOhrj2V8aIoxYXRx,3VkHkmOtom3jM2wCu94xgzzu1d6Dn7or,36,35,24,0,23,0,5,0,87,12.428571428571429,2,0.0,6,24,0,23,29,0,0,5,0,53,34,0
6448,61374,lSaDV1sycxZPmpqdOL4s2OzyxDadBcyQ,3VkHkmOtom3jM2wCu94xgzzu1d6Dn7or,28,80,26,29,20,38,12,0,205,29.285714285714285,8,0.0,27,26,25,20,53,38,4,12,0,98,107,1
6449,61376,1gHjCt90HibsGdolYHcLgNSayamL9Lgl,3VkHkmOtom3jM2wCu94xgzzu1d6Dn7or,4,2,1,0,1,0,1,0,5,0.7142857142857143,1,0.0,0,1,0,1,2,0,0,1,0,2,3,1
6450,61377,uBXyCnpgkxfIsstjod3TOmkkKg7d8zYv,3VkHkmOtom3jM2wCu94xgzzu1d6Dn7or,6,8,3,0,1,0,3,0,15,2.142857142857143,2,0.0,0,3,0,1,8,0,0,3,0,4,11,1
6451,61380,YoRqoOzvuzCTaiYWYaAvvKsbRs610g1g,3VkHkmOtom3jM2wCu94xgzzu1d6Dn7or,12,6,4,3,4,0,2,0,19,2.7142857142857144,1,0.0,1,4,3,4,5,0,0,2,0,12,7,1
6452,61381,B6EpScn9lSCPa3RR6ElGV7QvO5jse6Q3,3VkHkmOtom3jM2wCu94xgzzu1d6Dn7or,25,48,28,0,13,0,11,0,100,14.285714285714286,5,0.0,9,28,0,13,39,0,0,11,0,50,50,1
6453,61382,RSXPZ0RYmgpEvoW0QkrQF3dLkoX0vNEm,3VkHkmOtom3jM2wCu94xgzzu1d6Dn7or,1,0,0,0,0,0,2,0,2,0.2857142857142857,1,0.0,0,0,0,0,0,0,0,2,0,0,2,1
6454,61384,8gBenfAUifEb6sBv6EsCyw6oCQrobvm4,3VkHkmOtom3jM2wCu94xgzzu1d6Dn7or,24,32,9,22,13,9,9,0,94,13.428571428571429,3,0.0,18,9,21,13,14,9,1,9,0,61,33,0
6455,61385,xoBl0wW603taJwbMVeNODpDk0IbKa0yR,3VkHkmOtom3jM2wCu94xgzzu1d6Dn7or,25,30,18,12,17,3,10,0,90,12.857142857142858,3,0.0,8,18,11,17,22,3,1,10,0,54,36,1
6456,61386,iADIVtxyoQg4RtIKmWkz3YbJ1msvN2b8,3VkHkmOtom3jM2wCu94xgzzu1d6Dn7or,51,106,30,49,30,30,14,0,259,37.0,7,0.0,55,30,49,30,51,30,0,14,0,164,95,0
6457,61387,FY0TX9L7aPWX7VSeYOlhP1yt2bFTBqsi,3VkHkmOtom3jM2wCu94xgzzu1d6Dn7or,6,2,1,0,1,6,7,1,18,2.5714285714285716,2,0.0,0,1,0,1,2,6,0,7,1,2,16,1
6458,61388,qYPidKifaMFHp3213708Kz4gZcU4t8KS,3VkHkmOtom3jM2wCu94xgzzu1d6Dn7or,2,0,0,0,0,0,2,0,2,0.2857142857142857,1,0.0,0,0,0,0,0,0,0,2,0,0,2,1
6459,61392,ef55znmweQJrijlI0fO1Ekc271nZnV0m,3VkHkmOtom3jM2wCu94xgzzu1d6Dn7or,17,34,19,8,10,5,17,0,93,13.285714285714286,6,0.0,6,19,7,10,28,5,1,17,0,42,51,1
6460,61395,LfxVPkTskllD2jF3lfPEyHkfcPupyhDZ,3VkHkmOtom3jM2wCu94xgzzu1d6Dn7or,61,179,44,44,61,124,66,7,525,75.0,8,0.0,107,44,42,61,72,124,2,66,7,254,271,0
6461,61396,DeelyUHip68Bc1nEcSFah2ZDex256xUw,3VkHkmOtom3jM2wCu94xgzzu1d6Dn7or,6,2,1,0,1,2,5,1,12,1.7142857142857142,1,0.0,0,1,0,1,2,2,0,5,1,2,10,1
6462,61402,W7FXzdnq9Ktue5ZNM3TQmIP7HktmL3kC,3VkHkmOtom3jM2wCu94xgzzu1d6Dn7or,1,0,0,0,0,0,4,0,4,0.5714285714285714,1,0.0,0,0,0,0,0,0,0,4,0,0,4,1
6463,61407,zXW8D0tz2Cbaz6e77hrhozxkcZ5D0GFc,3VkHkmOtom3jM2wCu94xgzzu1d6Dn7or,5,2,1,0,1,0,2,0,6,0.8571428571428571,1,0.0,1,1,0,1,1,0,0,2,0,3,3,0
6464,61411,ohdROxpKfDmnPtJyTyliDaSUWBX4My6k,3VkHkmOtom3jM2wCu94xgzzu1d6Dn7or,38,59,19,29,24,15,8,0,154,22.0,3,0.0,30,19,25,24,29,15,4,8,0,98,56,1
6465,61416,viuKt4GgrX0rYL5EpHoxJbsiC9TblSuk,3VkHkmOtom3jM2wCu94xgzzu1d6Dn7or,8,8,4,0,2,10,25,1,50,7.142857142857143,8,0.0,0,4,0,2,8,10,0,25,1,6,44,0
6466,61418,pwCfOUjALc5NN8I5D9HogP6ntKzjlQLE,3VkHkmOtom3jM2wCu94xgzzu1d6Dn7or,7,3,2,0,2,0,2,0,9,1.2857142857142858,1,0.0,0,2,0,2,3,0,0,2,0,4,5,1
6467,61419,Pn2js00VBj94JFMjcjEse7Ds31Qeyttu,3VkHkmOtom3jM2wCu94xgzzu1d6Dn7or,74,310,122,22,84,15,91,25,669,95.57142857142857,19,0.0,98,122,21,84,212,15,1,91,25,325,344,0
6468,61425,4f5ozMpUJiQzRSDFnW6c4nKslwS1tye5,3VkHkmOtom3jM2wCu94xgzzu1d6Dn7or,16,64,19,15,14,4,19,0,135,19.285714285714285,4,0.0,34,19,12,14,30,4,3,19,0,79,56,0
6469,61426,Sv1TlrCiKjLHso6ovH5ZRk4wqqQPvzdd,3VkHkmOtom3jM2wCu94xgzzu1d6Dn7or,41,194,56,55,0,8,23,2,338,48.285714285714285,10,0.0,82,56,50,0,112,8,5,23,2,188,150,0
6470,61428,eQUEJ6p5loiYpm1ANmHrs30KEjfp1dL6,3VkHkmOtom3jM2wCu94xgzzu1d6Dn7or,13,14,8,0,5,0,6,0,33,4.714285714285714,1,0.0,0,8,0,5,14,0,0,6,0,13,20,0
6471,61429,zR8Wt44Nq9HKrXeqDmWD3gO2XkyhFav0,3VkHkmOtom3jM2wCu94xgzzu1d6Dn7or,15,13,8,6,5,6,14,1,53,7.571428571428571,1,0.0,2,8,5,5,11,6,1,14,1,20,33,1
6472,61433,tndnRnD7XfGiN94qfNeJcN7FgKETHiW0,3VkHkmOtom3jM2wCu94xgzzu1d6Dn7or,77,108,53,39,40,2,23,0,265,37.857142857142854,10,0.0,31,53,35,40,77,2,4,23,0,159,106,0
6473,61446,eMElakxdNwyds7hvAWWqn6yuj6dKI8Ws,3VkHkmOtom3jM2wCu94xgzzu1d6Dn7or,1,0,0,0,0,0,1,0,1,0.14285714285714285,1,0.0,0,0,0,0,0,0,0,1,0,0,1,1
6474,61447,SvUZcSJqn5uviSnLCETv5RXbwMQgArRw,3VkHkmOtom3jM2wCu94xgzzu1d6Dn7or,1,0,0,0,0,0,2,0,2,0.2857142857142857,2,0.0,0,0,0,0,0,0,0,2,0,0,2,1
6475,61448,8ANCOi1p12J3JBmvi0fahJDF8PDtEndE,3VkHkmOtom3jM2wCu94xgzzu1d6Dn7or,1,0,0,0,0,0,1,0,1,0.14285714285714285,1,0.0,0,0,0,0,0,0,0,1,0,0,1,1
6476,61449,zlr5J3lVoCh9O5Oq0mhAPCa6l5p8dJMQ,3VkHkmOtom3jM2wCu94xgzzu1d6Dn7or,1,0,0,0,0,0,1,0,1,0.14285714285714285,1,0.0,0,0,0,0,0,0,0,1,0,0,1,1
6477,61451,1FyiQnekweZ2XeXnccwpWWqNfcnFn7vs,3VkHkmOtom3jM2wCu94xgzzu1d6Dn7or,12,9,7,4,6,0,2,0,28,4.0,1,0.0,1,7,3,6,8,0,1,2,0,17,11,1
6478,61452,fNei7kDieK9E7YoqiBlAHzuDqZQbwUNs,3VkHkmOtom3jM2wCu94xgzzu1d6Dn7or,1,0,0,0,0,0,1,0,1,0.14285714285714285,1,0.0,0,0,0,0,0,0,0,1,0,0,1,1
6479,61455,9A0XvslxdczABblVWK0KCOD4pp55ghXg,3VkHkmOtom3jM2wCu94xgzzu1d6Dn7or,5,2,1,0,1,0,2,1,7,1.0,1,0.0,0,1,0,1,2,0,0,2,1,2,5,1
6480,61457,bnVD3IsHOnhCEVYhUQiRg9PpaxBlbMJ1,3VkHkmOtom3jM2wCu94xgzzu1d6Dn7or,80,118,47,40,39,32,24,1,301,43.0,9,0.0,49,47,37,39,69,32,3,24,1,172,129,0
6481,61459,NlHO5hXiy7TmVTHiRgExH6y7p9gJG1YF,3VkHkmOtom3jM2wCu94xgzzu1d6Dn7or,10,7,6,0,3,0,2,0,18,2.5714285714285716,1,0.0,0,6,0,3,7,0,0,2,0,9,9,1
6482,61461,vYZLFtHzbRZEyiuRAYkPU2TurFaRRb3e,3VkHkmOtom3jM2wCu94xgzzu1d6Dn7or,66,149,45,43,56,36,17,0,346,49.42857142857143,9,0.0,81,45,41,56,68,36,2,17,0,223,123,0
6483,61465,x9Cr4bD2XYNPQezjlTHozwMEvRoII5Sk,3VkHkmOtom3jM2wCu94xgzzu1d6Dn7or,1,0,0,0,0,0,1,0,1,0.14285714285714285,1,0.0,0,0,0,0,0,0,0,1,0,0,1,1
6484,61468,bl2rAEaePA356erajHAXTdRy3MQRHe67,3VkHkmOtom3jM2wCu94xgzzu1d6Dn7or,5,2,1,0,1,0,3,0,7,1.0,1,0.0,0,1,0,1,2,0,0,3,0,2,5,1
6485,61469,6BmZVjLN4nNolB7W1oGMr5uOMLXqdZJQ,3VkHkmOtom3jM2wCu94xgzzu1d6Dn7or,1,0,0,0,0,0,1,0,1,0.14285714285714285,1,0.0,0,0,0,0,0,0,0,1,0,0,1,1
6486,61470,paWCgHpHAyFQT9OUe0ll6zOiopVQPD6e,3VkHkmOtom3jM2wCu94xgzzu1d6Dn7or,1,0,0,0,0,0,2,0,2,0.2857142857142857,1,0.0,0,0,0,0,0,0,0,2,0,0,2,1
6487,61471,VSis3GPLe3g5PXWWtZzI0G79Q5DGCKD1,3VkHkmOtom3jM2wCu94xgzzu1d6Dn7or,6,3,2,0,2,0,1,0,8,1.1428571428571428,1,0.0,0,2,0,2,3,0,0,1,0,4,4,1
6488,61473,KJwbmkoK69ToUHYM3JjYSRGZ65hxphzP,3VkHkmOtom3jM2wCu94xgzzu1d6Dn7or,13,8,7,0,6,0,4,0,25,3.5714285714285716,1,0.0,0,7,0,6,8,0,0,4,0,13,12,1
6489,61474,ZmfdNNznGUKjrKBTFXV9DMVwFsyogQYG,3VkHkmOtom3jM2wCu94xgzzu1d6Dn7or,20,25,16,0,11,0,6,0,58,8.285714285714286,3,0.0,0,16,0,11,25,0,0,6,0,27,31,1
6490,61475,AQn3PPb2JuDtBjYGg9IXD30i1dxGAvNS,3VkHkmOtom3jM2wCu94xgzzu1d6Dn7or,14,61,14,8,17,7,20,2,129,18.428571428571427,4,0.0,36,14,6,17,25,7,2,20,2,73,56,1
6491,61479,BzOVfnUGvTKh9CiG8OwvUOF9UW93jsVA,3VkHkmOtom3jM2wCu94xgzzu1d6Dn7or,4,3,1,0,1,0,1,0,6,0.8571428571428571,1,0.0,1,1,0,1,2,0,0,1,0,3,3,1
6492,61481,3VXSMMHCshIzL95WBx5J3VPEs63QKqBF,3VkHkmOtom3jM2wCu94xgzzu1d6Dn7or,10,42,22,7,11,7,12,9,110,15.714285714285714,3,0.0,10,22,6,11,32,7,1,12,9,49,61,1
6493,61482,VUYRWxIK25dyFla7xdkPw6qN6gZPPejU,3VkHkmOtom3jM2wCu94xgzzu1d6Dn7or,67,159,80,121,56,43,13,0,472,67.42857142857143,5,0.0,54,80,112,56,105,43,9,13,0,302,170,0
6494,61484,8fCBuC51eLJ5RTCB0MFJYHIbTlyqgVN5,3VkHkmOtom3jM2wCu94xgzzu1d6Dn7or,86,307,46,88,102,38,24,1,606,86.57142857142857,6,0.0,172,46,84,102,135,38,4,24,1,404,202,1
6495,61485,yOLHyWyY5w1GXVtNrWqjdKWYXdnSJFEG,3VkHkmOtom3jM2wCu94xgzzu1d6Dn7or,13,17,7,7,5,10,9,0,55,7.857142857142857,2,0.0,5,7,7,5,12,10,0,9,0,24,31,1
6496,61493,yNVxqTDIVLfbY4CIKcL1TfyR4C1WDgZe,3VkHkmOtom3jM2wCu94xgzzu1d6Dn7or,67,208,75,100,31,6,46,1,467,66.71428571428571,11,0.0,54,75,95,31,154,6,5,46,1,255,212,0
6497,61496,gir9E9ZUbwj6bCUNLD2kQmOx1nsVwG4J,3VkHkmOtom3jM2wCu94xgzzu1d6Dn7or,6,6,4,0,1,0,3,0,14,2.0,2,0.0,0,4,0,1,6,0,0,3,0,5,9,1
6498,61497,hOVlGtXDkiKHOf01Bd7mgZZ1xKb8JhRd,3VkHkmOtom3jM2wCu94xgzzu1d6Dn7or,21,43,17,8,18,18,18,0,122,17.428571428571427,3,0.0,20,17,8,18,23,18,0,18,0,63,59,0
6499,61499,fo7ouvtbNwlDgRdiBgqVy1Dhppt33SVk,3VkHkmOtom3jM2wCu94xgzzu1d6Dn7or,17,14,7,0,8,0,1,0,30,4.285714285714286,1,0.0,4,7,0,8,10,0,0,1,0,19,11,1
6500,61507,DHfZKMAezkn3orBA6nrTmayLvgvs1xwo,3VkHkmOtom3jM2wCu94xgzzu1d6Dn7or,10,12,5,0,5,7,11,2,42,6.0,2,0.0,4,5,0,5,8,7,0,11,2,14,28,1
6501,61508,PSNpE96w64UzqJ7izDn4zKyoyc3uU8P4,3VkHkmOtom3jM2wCu94xgzzu1d6Dn7or,19,48,21,0,11,4,10,5,99,14.142857142857142,4,0.0,0,21,0,11,48,4,0,10,5,32,67,1
6502,61509,WnQjfOx2gyRuONOtXTqJRGPXAZeKb0hk,3VkHkmOtom3jM2wCu94xgzzu1d6Dn7or,46,179,6,42,12,6,23,1,269,38.42857142857143,11,0.0,69,6,36,12,110,6,6,23,1,123,146,0
6503,61510,ZSscaSWAxgdRQr0HRr5Ud3cI8gdzS6Tf,3VkHkmOtom3jM2wCu94xgzzu1d6Dn7or,55,112,15,32,42,24,12,0,237,33.857142857142854,6,0.0,43,15,31,42,69,24,1,12,0,131,106,1
6504,61511,qwXoPjhUKPW4mjMQuu0Cra7UJGmweA6l,3VkHkmOtom3jM2wCu94xgzzu1d6Dn7or,7,5,3,0,2,4,4,2,20,2.857142857142857,2,0.0,0,3,0,2,5,4,0,4,2,5,15,1
6505,61512,LQ8TblvoMlGOQu9VCylquJYWHUijd0ne,3VkHkmOtom3jM2wCu94xgzzu1d6Dn7or,6,9,4,0,0,0,4,0,17,2.4285714285714284,3,0.0,0,4,0,0,9,0,0,4,0,4,13,1
6506,61518,ngcKp0ODgyjN9TK21DEb0ectQJN0qS7o,3VkHkmOtom3jM2wCu94xgzzu1d6Dn7or,83,149,54,77,41,0,24,1,346,49.42857142857143,5,0.0,38,54,76,41,111,0,1,24,1,209,137,0
6507,61519,FBTuVfz1jYWkvk1XcAXFgGcmrwdirPiT,3VkHkmOtom3jM2wCu94xgzzu1d6Dn7or,37,27,20,0,17,3,13,1,81,11.571428571428571,3,0.0,3,20,0,17,24,3,0,13,1,40,41,1
6508,61520,Z8E1fWEz0b5y6BD6dlIVX2UJWlqxRpHR,3VkHkmOtom3jM2wCu94xgzzu1d6Dn7or,12,17,5,4,6,6,5,0,43,6.142857142857143,3,0.0,8,5,4,6,9,6,0,5,0,23,20,1
6509,61521,cn2YSKU6p7JeVQ11FhjesODRi4bPnlsB,3VkHkmOtom3jM2wCu94xgzzu1d6Dn7or,22,24,15,5,12,2,3,0,61,8.714285714285714,3,0.0,2,15,5,12,22,2,0,3,0,34,27,1
6510,61523,wwHA7fYVmcTg223vcU6GFcJ6brkYax5H,3VkHkmOtom3jM2wCu94xgzzu1d6Dn7or,6,5,2,0,1,0,5,0,13,1.8571428571428572,1,0.0,0,2,0,1,5,0,0,5,0,3,10,1
6511,61529,2AW6aH0SqKYjpe5J2qxXqfKxHscq7JWf,3VkHkmOtom3jM2wCu94xgzzu1d6Dn7or,34,80,27,29,26,0,11,0,173,24.714285714285715,5,0.0,45,27,29,26,35,0,0,11,0,127,46,1
6512,61530,L1ChD5lPBWD49W1CLcxht18PcZVlJzua,3VkHkmOtom3jM2wCu94xgzzu1d6Dn7or,65,145,53,47,48,41,41,7,382,54.57142857142857,6,0.0,70,53,43,48,75,41,4,41,7,214,168,0
6513,61533,Z9abodGLnoAKUQpj3iaQLs7Q9MTs6Wvr,3VkHkmOtom3jM2wCu94xgzzu1d6Dn7or,68,145,53,43,60,22,43,0,366,52.285714285714285,8,0.0,87,53,34,60,58,22,9,43,0,234,132,0
6514,61534,QlgMlXvog36Jv95J9pxeMiYy3CA0cwLU,3VkHkmOtom3jM2wCu94xgzzu1d6Dn7or,85,237,112,45,79,19,89,0,581,83.0,20,0.0,80,112,41,79,157,19,4,89,0,312,269,0
6515,61539,dhPF0MOUpHT5OZTFAONgRdkH1ZwnZtFz,3VkHkmOtom3jM2wCu94xgzzu1d6Dn7or,7,3,1,0,1,0,14,0,19,2.7142857142857144,2,0.0,0,1,0,1,3,0,0,14,0,2,17,0
6516,61542,zzNKAc7xfesbRQ4blnMrgsBQluZ0zJuQ,3VkHkmOtom3jM2wCu94xgzzu1d6Dn7or,13,23,8,0,7,2,5,0,45,6.428571428571429,3,0.0,8,8,0,7,15,2,0,5,0,23,22,0
6517,61545,uzWunaITmXKEfZHqvJVQKYhKGD41xhQj,3VkHkmOtom3jM2wCu94xgzzu1d6Dn7or,1,0,0,0,0,0,1,0,1,0.14285714285714285,1,0.0,0,0,0,0,0,0,0,1,0,0,1,1
6518,61548,2oqOis9uVkS5zFMz0hufDKmC3fKLmo8y,3VkHkmOtom3jM2wCu94xgzzu1d6Dn7or,1,0,0,0,0,0,2,0,2,0.2857142857142857,2,0.0,0,0,0,0,0,0,0,2,0,0,2,1
6519,61549,p77vjaHaFIiHskX3dumxWC6D5ZNYLne6,3VkHkmOtom3jM2wCu94xgzzu1d6Dn7or,45,157,63,34,64,5,17,4,344,49.142857142857146,9,0.0,84,63,29,64,73,5,5,17,4,240,104,1
6520,61554,ixaZdNaa2ZlUJVQIu27ONqwS5TEcz7ia,3VkHkmOtom3jM2wCu94xgzzu1d6Dn7or,9,11,6,0,1,8,24,2,52,7.428571428571429,2,0.0,0,6,0,1,11,8,0,24,2,7,45,1
6521,61555,uSpti6Yw7qPzPT4S4dLtJ0lPSlE5C6Xf,3VkHkmOtom3jM2wCu94xgzzu1d6Dn7or,71,197,77,101,56,63,44,5,543,77.57142857142857,12,0.0,65,77,93,56,132,63,8,44,5,291,252,0
6522,61556,Ck0jmNMsCRLB2TtPvaiIXguP6hyGiJxH,3VkHkmOtom3jM2wCu94xgzzu1d6Dn7or,23,77,19,20,17,19,11,1,164,23.428571428571427,6,0.0,45,19,16,17,32,19,4,11,1,97,67,1
6523,61558,KPZf9GET341Xk4ORsXzHy6Cn9V1LgPHy,3VkHkmOtom3jM2wCu94xgzzu1d6Dn7or,5,3,1,0,1,0,5,0,10,1.4285714285714286,1,0.0,1,1,0,1,2,0,0,5,0,3,7,1
6524,61562,3ZzhbGHk0AMavVBVS0pUAaZvWnLoQODp,3VkHkmOtom3jM2wCu94xgzzu1d6Dn7or,14,64,22,5,18,14,18,1,142,20.285714285714285,7,0.0,12,22,5,18,52,14,0,18,1,57,85,1
6525,61563,J44vilXvhZO4CMbzk7NQGJgFAdmThuli,3VkHkmOtom3jM2wCu94xgzzu1d6Dn7or,15,14,8,0,5,1,21,2,51,7.285714285714286,2,0.0,0,8,0,5,14,1,0,21,2,13,38,1
6526,61565,5Sdd90y9f6G1O01oh8dNylP38h97ZkQP,3VkHkmOtom3jM2wCu94xgzzu1d6Dn7or,7,4,2,0,1,4,5,0,16,2.2857142857142856,2,0.0,0,2,0,1,4,4,0,5,0,3,13,1
6527,61568,ykaUPJW4Nc9r2mv4b25QxgdHgIcQ63RQ,3VkHkmOtom3jM2wCu94xgzzu1d6Dn7or,4,5,0,0,2,0,2,0,9,1.2857142857142858,1,0.0,3,0,0,2,2,0,0,2,0,5,4,1
6528,61572,mvgecpIuM19IAt1bbE3Mi8BpDwnT3DEI,3VkHkmOtom3jM2wCu94xgzzu1d6Dn7or,9,23,9,2,4,8,11,1,58,8.285714285714286,2,0.0,5,9,2,4,18,8,0,11,1,20,38,1
6529,61578,2DccYKlqpoQf6OVf4P499VuvWPHZoTTu,3VkHkmOtom3jM2wCu94xgzzu1d6Dn7or,5,7,3,0,0,8,5,0,23,3.2857142857142856,4,0.0,0,3,0,0,7,8,0,5,0,3,20,1
6530,61579,ah9PpJgFXG9Fbwd7z8sEIODsCPTfULdy,3VkHkmOtom3jM2wCu94xgzzu1d6Dn7or,4,2,1,0,0,0,2,0,5,0.7142857142857143,1,0.0,0,1,0,0,2,0,0,2,0,1,4,1
6531,61581,DawlCH8NcvFmcnrUGRB8b9wi64nyiEPI,3VkHkmOtom3jM2wCu94xgzzu1d6Dn7or,80,156,59,61,66,9,31,4,386,55.142857142857146,9,0.0,73,59,54,66,83,9,7,31,4,252,134,0
6532,61582,EiO5bky9R1Iqlpv4ItUpPBUgGb1eJItE,3VkHkmOtom3jM2wCu94xgzzu1d6Dn7or,7,4,3,0,3,0,2,0,12,1.7142857142857142,2,0.0,0,3,0,3,4,0,0,2,0,6,6,1
6533,61584,ToBdLREKywPS9utX4VtkzPw40pRNsYiq,3VkHkmOtom3jM2wCu94xgzzu1d6Dn7or,9,9,6,0,4,0,9,1,29,4.142857142857143,2,0.0,0,6,0,4,9,0,0,9,1,10,19,1
6534,61604,X8nI71wgjvVnziT2GohIRTnyUeumIuGT,SpATywNh6bZuzm8s1ceuBUnMUAeoAHHw,41,61,13,37,7,38,17,2,175,25.0,5,0.0,8,13,32,7,53,38,5,17,2,60,115,0
6535,61609,0RRA0LeDh4nSJ7FMl9qY1fE7T0M4oANR,SpATywNh6bZuzm8s1ceuBUnMUAeoAHHw,41,45,21,43,11,2,20,1,143,20.428571428571427,5,0.0,10,21,40,11,35,2,3,20,1,82,61,0
6536,61610,jB0CpdoFx6mbd8VYrFivcPv6zE00pZ1K,5X6FeZozNMgE2VRi3MJYjkkFK8SETtu2,13,10,1,12,4,0,4,0,31,4.428571428571429,2,0.0,9,1,11,4,1,0,1,4,0,25,6,1
6537,61626,w7supWZd9V8OYuV6GbfYuMkG68T2DAiS,SpATywNh6bZuzm8s1ceuBUnMUAeoAHHw,5,2,1,0,1,0,4,0,8,1.1428571428571428,1,0.0,0,1,0,1,2,0,0,4,0,2,6,0
6538,61631,KI5ihDfSUNAjYVTbGrXe4uplnhTwkLF8,A3fsA9Zfv1X2fVEQhTw51lKENdNrEqT3,35,45,30,0,21,0,13,0,109,15.571428571428571,4,0.0,0,30,0,21,45,0,0,13,0,51,58,1
6539,61634,PyaXrfJadEJJdtWYxd1SSz75aPVyhQhH,SpATywNh6bZuzm8s1ceuBUnMUAeoAHHw,40,66,0,46,0,17,21,4,154,22.0,5,0.0,25,0,40,0,41,17,6,21,4,65,89,0
6540,61638,lLutp8H3vKf6Z8olMEwVlKswK040AY6M,7GRhBDsirIGkRZBtSMEzNTyDr2JQm4xx,39,111,43,85,28,3,15,1,286,40.857142857142854,5,0.0,54,43,75,28,57,3,10,15,1,200,86,1
6541,61654,LYqZV37zE6nJxDsCo1hT04A5qKWsawBT,SpATywNh6bZuzm8s1ceuBUnMUAeoAHHw,61,110,62,54,38,13,50,1,328,46.857142857142854,8,0.0,11,62,47,38,99,13,7,50,1,158,170,0
6542,61656,IMC5v8VADk2BSRQySPnoyeNJYhIEb0n5,SpATywNh6bZuzm8s1ceuBUnMUAeoAHHw,45,35,26,12,21,3,9,0,106,15.142857142857142,2,0.0,2,26,11,21,33,3,1,9,0,60,46,0
6543,61675,gejGa8SAgjHkzsw2hD6p8TKYmXAjocFe,A3fsA9Zfv1X2fVEQhTw51lKENdNrEqT3,48,34,23,68,17,0,11,1,154,22.0,3,0.0,5,23,57,17,29,0,11,11,1,102,52,1
6544,61686,zRHa8EKlGdYTvX9vjas2PMVSV4pf61jb,bWdj2GDclj5ofokWjzoa5jAwMkxCykd6,5,0,0,0,0,0,5,1,6,0.8571428571428571,1,0.0,0,0,0,0,0,0,0,5,1,0,6,0
6545,61687,Iy2ElCZpRw3zxSRKsJzk7TkINwbfRI7p,bWdj2GDclj5ofokWjzoa5jAwMkxCykd6,6,2,1,0,1,0,3,0,7,1.0,1,0.0,0,1,0,1,2,0,0,3,0,2,5,1
6546,61698,ohrImkqpGgcOH7KX180kLXMmkm87D1S7,A3fsA9Zfv1X2fVEQhTw51lKENdNrEqT3,10,4,0,0,0,3,17,2,26,3.7142857142857144,2,0.0,0,0,0,0,4,3,0,17,2,0,26,0
6547,61701,BYKshB0XEKF6r4IznOvn2k5BErn13iSA,A3fsA9Zfv1X2fVEQhTw51lKENdNrEqT3,1,0,0,0,0,0,1,0,1,0.14285714285714285,1,0.0,0,0,0,0,0,0,0,1,0,0,1,1
6548,61703,1Ccev0ap5uQQlfggUCTp94lkg9qZetYO,SpATywNh6bZuzm8s1ceuBUnMUAeoAHHw,15,12,1,0,1,1,17,1,33,4.714285714285714,3,0.0,0,1,0,1,12,1,0,17,1,2,31,1
6549,61707,hCcqWAdqv94Wqd11wCByvAvYa7YD0am3,SpATywNh6bZuzm8s1ceuBUnMUAeoAHHw,11,19,11,0,0,0,1,0,31,4.428571428571429,1,0.0,7,11,0,0,12,0,0,1,0,18,13,1
6550,61710,O8jXBTHa2km7hdR2fu64rRfE2lYYjYno,5X6FeZozNMgE2VRi3MJYjkkFK8SETtu2,5,2,1,0,1,1,3,0,8,1.1428571428571428,1,0.0,0,1,0,1,2,1,0,3,0,2,6,1
6551,61713,MYsCU1zkMrWxPhV1b7wSL5LZIo1zGyhU,bWdj2GDclj5ofokWjzoa5jAwMkxCykd6,34,46,30,0,21,0,8,0,105,15.0,6,0.0,7,30,0,21,39,0,0,8,0,58,47,0
6552,61723,JLHcajAdHD1OYKJrQ84J1iFmbxZ6Hs3q,SpATywNh6bZuzm8s1ceuBUnMUAeoAHHw,1,0,0,0,0,0,1,0,1,0.14285714285714285,1,0.0,0,0,0,0,0,0,0,1,0,0,1,1
6553,61729,lDtS3t8GwsTaLDIL0mQN8CpFBwRABCCR,SpATywNh6bZuzm8s1ceuBUnMUAeoAHHw,48,54,42,16,23,1,15,1,152,21.714285714285715,2,0.0,0,42,14,23,54,1,2,15,1,79,73,0
6554,61732,NcracMTfiaTPMbO6SSDnt9CDc4SnvBs9,SpATywNh6bZuzm8s1ceuBUnMUAeoAHHw,61,53,33,30,19,44,12,0,191,27.285714285714285,4,0.0,12,33,29,19,41,44,1,12,0,93,98,0
6555,61733,gMD3QXq0NP11IqNCLAQviPDQUlnfIgHG,SpATywNh6bZuzm8s1ceuBUnMUAeoAHHw,11,12,4,24,2,9,2,0,53,7.571428571428571,1,0.0,7,4,18,2,5,9,6,2,0,31,22,1
6556,61740,I9yi1jZjIznCPzP5fpMJEhPDMiUaetUu,SpATywNh6bZuzm8s1ceuBUnMUAeoAHHw,31,80,41,35,10,112,27,6,311,44.42857142857143,8,0.0,16,41,29,10,64,112,6,27,6,96,215,0
6557,61741,SA0LQfPIgP3MHhYP2mxz0u46Ceavmq26,SpATywNh6bZuzm8s1ceuBUnMUAeoAHHw,1,0,0,0,0,0,1,0,1,0.14285714285714285,1,0.0,0,0,0,0,0,0,0,1,0,0,1,1
6558,61744,l30g3WB045lPyRkHzrw7l9v0SYLqOMWO,SpATywNh6bZuzm8s1ceuBUnMUAeoAHHw,30,91,34,43,11,14,19,2,214,30.571428571428573,6,0.0,14,34,38,11,77,14,5,19,2,97,117,0
6559,61745,ZQ6y2Bmw7qT9LD8jxMjYzUpaHRmpaQsM,A3fsA9Zfv1X2fVEQhTw51lKENdNrEqT3,5,5,0,0,0,0,4,0,9,1.2857142857142858,3,0.0,0,0,0,0,5,0,0,4,0,0,9,0
6560,61755,lH1Zg2rCl3kv8uXAu0T77rdY9bAtw7jj,5X6FeZozNMgE2VRi3MJYjkkFK8SETtu2,5,2,1,0,1,0,3,0,7,1.0,1,0.0,0,1,0,1,2,0,0,3,0,2,5,1
6561,61756,lH1Zg2rCl3kv8uXAu0T77rdY9bAtw7jj,bWdj2GDclj5ofokWjzoa5jAwMkxCykd6,1,0,0,0,0,0,1,0,1,0.14285714285714285,1,0.0,0,0,0,0,0,0,0,1,0,0,1,1
6562,61759,fx9PEMItfmJUgx5YPFOnYPw9ZcUduuYm,SpATywNh6bZuzm8s1ceuBUnMUAeoAHHw,34,80,8,12,4,1,33,5,143,20.428571428571427,3,0.0,6,8,11,4,74,1,1,33,5,29,114,1
6563,61764,LXvzoXwYMI8XUD9YKm4GDUJg3NNw2lJx,SpATywNh6bZuzm8s1ceuBUnMUAeoAHHw,1,0,0,0,0,0,1,0,1,0.14285714285714285,1,0.0,0,0,0,0,0,0,0,1,0,0,1,1
6564,61781,Niuzd4uUgVDA7FmSxhu5zyPye1iamD36,A3fsA9Zfv1X2fVEQhTw51lKENdNrEqT3,48,48,30,66,17,5,40,4,210,30.0,5,0.0,2,30,56,17,46,5,10,40,4,105,105,0
6565,61790,qmqKP6SAEowU2N3tlmffeinW9LdivxOy,SpATywNh6bZuzm8s1ceuBUnMUAeoAHHw,5,3,2,0,2,0,2,0,9,1.2857142857142858,1,0.0,0,2,0,2,3,0,0,2,0,4,5,1
6566,61801,2we3WxltFBT1dd0FjP3YZ8iHf2xpHEei,SpATywNh6bZuzm8s1ceuBUnMUAeoAHHw,43,59,28,21,15,0,13,0,136,19.428571428571427,10,0.0,6,28,20,15,53,0,1,13,0,69,67,1
6567,61813,8h7TPToROF0s05SQ5vZMG2ojEeeLcCFW,A3fsA9Zfv1X2fVEQhTw51lKENdNrEqT3,1,0,0,0,0,0,1,0,1,0.14285714285714285,1,0.0,0,0,0,0,0,0,0,1,0,0,1,1
6568,61814,6ewbhsgJh7NTFUpGTc6v0or3nCOYP5Dz,bWdj2GDclj5ofokWjzoa5jAwMkxCykd6,1,0,0,0,0,0,1,0,1,0.14285714285714285,1,0.0,0,0,0,0,0,0,0,1,0,0,1,1
6569,61820,Z9cEVuw4mcpJgmZnx9s7TqG2hjvWE1iq,SpATywNh6bZuzm8s1ceuBUnMUAeoAHHw,9,4,1,0,1,0,5,0,11,1.5714285714285714,1,0.0,0,1,0,1,4,0,0,5,0,2,9,1
6570,61827,Vsgn39xnzwCAHySZDmd4brygEDxODJoX,SpATywNh6bZuzm8s1ceuBUnMUAeoAHHw,14,22,5,11,2,3,3,0,46,6.571428571428571,1,0.0,15,5,10,2,7,3,1,3,0,32,14,1
6571,61831,3anigzzYhfNjapezJCJsh7byfpbHQLWl,bWdj2GDclj5ofokWjzoa5jAwMkxCykd6,1,0,0,0,0,0,1,0,1,0.14285714285714285,1,0.0,0,0,0,0,0,0,0,1,0,0,1,1
6572,61837,2yFrrfFKwmpyH7xPcC8i0UYFZJHtjntf,SpATywNh6bZuzm8s1ceuBUnMUAeoAHHw,41,75,41,62,11,45,29,2,265,37.857142857142854,11,0.0,13,41,50,11,62,45,12,29,2,115,150,0
6573,61849,d075hTME47faaDBbuuQqettSTx0qUOAw,SpATywNh6bZuzm8s1ceuBUnMUAeoAHHw,10,5,1,4,1,0,5,2,18,2.5714285714285716,1,0.0,1,1,3,1,4,0,1,5,2,6,12,0
6574,61851,nK30QtYMul8F2pspph6f3bZqVlAGvF0S,A3fsA9Zfv1X2fVEQhTw51lKENdNrEqT3,11,21,6,0,3,0,6,0,36,5.142857142857143,1,0.0,0,6,0,3,21,0,0,6,0,9,27,1
6575,61890,bY3M6NxBAZjGeFa96h2br6AbSx8krpDK,SpATywNh6bZuzm8s1ceuBUnMUAeoAHHw,29,36,20,21,14,7,7,0,105,15.0,3,0.0,3,20,17,14,33,7,4,7,0,54,51,0
6576,61910,TNArortVQm3F09odJ2W3xdM27lVc5PiX,SpATywNh6bZuzm8s1ceuBUnMUAeoAHHw,20,26,11,12,10,2,9,0,70,10.0,2,0.0,5,11,12,10,21,2,0,9,0,38,32,0
6577,61916,XDPvGyFLLEYwbNEQik2MM4yiADs5rrYJ,A3fsA9Zfv1X2fVEQhTw51lKENdNrEqT3,28,42,24,26,15,0,8,0,115,16.428571428571427,5,0.0,3,24,21,15,39,0,5,8,0,63,52,0
6578,61933,ZvGWd8SnJBMBXelpyx7gJSeWR5DJOwTo,SpATywNh6bZuzm8s1ceuBUnMUAeoAHHw,23,25,0,34,0,0,6,0,65,9.285714285714286,3,0.0,12,0,31,0,13,0,3,6,0,43,22,0
6579,61934,8dPQDWD7NMlHSztQh4Fh3dqPVx6xptft,SpATywNh6bZuzm8s1ceuBUnMUAeoAHHw,56,92,39,48,20,2,27,1,229,32.714285714285715,10,0.0,11,39,38,20,81,2,10,27,1,108,121,0
6580,61941,aJMNcTer76nTaYZZR58xtdmLr8BYq1Op,bWdj2GDclj5ofokWjzoa5jAwMkxCykd6,7,6,3,0,1,0,4,1,15,2.142857142857143,2,0.0,0,3,0,1,6,0,0,4,1,4,11,0
6581,61948,MHUd30s3WtRLChM8IirlGkLsv26fGFJh,bWdj2GDclj5ofokWjzoa5jAwMkxCykd6,14,28,15,36,6,20,13,2,120,17.142857142857142,4,0.0,3,15,34,6,25,20,2,13,2,58,62,1
6582,61951,01vp16vMBdfdzNflK84lEgGXfBDKyb7S,SpATywNh6bZuzm8s1ceuBUnMUAeoAHHw,9,8,4,0,3,0,7,0,22,3.142857142857143,2,0.0,2,4,0,3,6,0,0,7,0,9,13,1
6583,61959,0qbWIMzrwjcZydLWs8mxTmhu7QXiYFSP,7GRhBDsirIGkRZBtSMEzNTyDr2JQm4xx,11,8,5,0,6,0,3,0,22,3.142857142857143,1,0.0,2,5,0,6,6,0,0,3,0,13,9,1
6584,61961,za2dBkPPLD9IPRBjooK7GJit2ulI5UgN,5X6FeZozNMgE2VRi3MJYjkkFK8SETtu2,1,0,0,0,0,0,1,0,1,0.14285714285714285,1,0.0,0,0,0,0,0,0,0,1,0,0,1,1
6585,61968,oNcOLZOgRKuqVCWgf9VQFQ2ph82THXaV,7GRhBDsirIGkRZBtSMEzNTyDr2JQm4xx,17,58,22,0,13,0,7,0,100,14.285714285714286,3,0.0,4,22,0,13,54,0,0,7,0,39,61,1
6586,61970,rw1CeO1TCa8fgCdp1zXNf3dRKMz7g6nk,SpATywNh6bZuzm8s1ceuBUnMUAeoAHHw,7,8,5,0,2,0,3,0,18,2.5714285714285716,2,0.0,0,5,0,2,8,0,0,3,0,7,11,1
6587,61976,ylLJf4W02XCQY6BRCUv9QXbHD8BqRMHC,5X6FeZozNMgE2VRi3MJYjkkFK8SETtu2,1,0,0,0,0,0,3,0,3,0.42857142857142855,1,0.0,0,0,0,0,0,0,0,3,0,0,3,1
6588,61977,XupxNoKQxp2aAQkFy5RiZK4Yl6Wd1tRi,SpATywNh6bZuzm8s1ceuBUnMUAeoAHHw,41,76,7,48,6,25,32,3,197,28.142857142857142,13,0.0,9,7,39,6,67,25,9,32,3,61,136,0
6589,61986,foVkTyqD4PcwEOzU1yZGubmwk25CvIbn,5X6FeZozNMgE2VRi3MJYjkkFK8SETtu2,6,10,4,0,5,0,1,0,20,2.857142857142857,1,0.0,2,4,0,5,8,0,0,1,0,11,9,1
6590,61987,VHRjjAEe4Vcbn4fNxXSJ9BDfSyDWAt6F,SpATywNh6bZuzm8s1ceuBUnMUAeoAHHw,26,28,13,15,9,0,1,0,66,9.428571428571429,1,0.0,4,13,14,9,24,0,1,1,0,40,26,0
6591,61994,pvjfd8HSIoVZ71m9TCBbQlraohrUi2x6,SpATywNh6bZuzm8s1ceuBUnMUAeoAHHw,18,18,2,17,1,0,3,0,41,5.857142857142857,2,0.0,1,2,14,1,17,0,3,3,0,18,23,0
6592,62001,9RakuKxD8WS6oi5xvzWI4nJK3Tjlrymz,7GRhBDsirIGkRZBtSMEzNTyDr2JQm4xx,5,2,1,0,1,0,2,0,6,0.8571428571428571,1,0.0,0,1,0,1,2,0,0,2,0,2,4,1
6593,62005,63waYBGRyitKxyJxVKV8NWeJFWacnPQr,7GRhBDsirIGkRZBtSMEzNTyDr2JQm4xx,8,5,4,0,4,0,1,0,14,2.0,1,0.0,0,4,0,4,5,0,0,1,0,8,6,1
6594,62011,vPv7PsanhRceiGshTPXtgrOmcrOEYM8O,SpATywNh6bZuzm8s1ceuBUnMUAeoAHHw,25,23,13,17,8,0,4,0,65,9.285714285714286,4,0.0,4,13,14,8,19,0,3,4,0,39,26,1
6595,62032,xMkkyPamBlQnoa7jeVZTYr4avomD93Rr,7GRhBDsirIGkRZBtSMEzNTyDr2JQm4xx,2,0,0,0,0,0,3,0,3,0.42857142857142855,1,0.0,0,0,0,0,0,0,0,3,0,0,3,1
6596,62033,63waYBGRyitKxyJxVKV8NWeJFWacnPQr,bWdj2GDclj5ofokWjzoa5jAwMkxCykd6,13,9,7,0,5,0,6,0,27,3.857142857142857,1,0.0,0,7,0,5,9,0,0,6,0,12,15,1
6597,62039,M1wHxfNvMfzb2hOsqqFPB2oGlkH2NCqL,SpATywNh6bZuzm8s1ceuBUnMUAeoAHHw,1,0,0,0,0,0,1,0,1,0.14285714285714285,1,0.0,0,0,0,0,0,0,0,1,0,0,1,1
6598,62051,xFkd6TNWJ8qmIM4trYH57onQcjo5lnU0,SpATywNh6bZuzm8s1ceuBUnMUAeoAHHw,21,49,15,18,6,0,15,0,103,14.714285714285714,7,0.0,7,15,17,6,42,0,1,15,0,45,58,0
6599,62061,TuJrZ9qQp5b2qpTGGmQsmYcn7kQGqQe7,bWdj2GDclj5ofokWjzoa5jAwMkxCykd6,8,5,1,0,1,4,5,1,17,2.4285714285714284,1,0.0,0,1,0,1,5,4,0,5,1,2,15,1
6600,62067,d7CRMAVRgBps84fhYwYVHXr4TrIkJYDp,SpATywNh6bZuzm8s1ceuBUnMUAeoAHHw,3,2,0,0,0,0,1,0,3,0.42857142857142855,1,0.0,0,0,0,0,2,0,0,1,0,0,3,1
6601,62072,VWEcCKiwp28lQZuBYYNslDL0523gk0Z6,SpATywNh6bZuzm8s1ceuBUnMUAeoAHHw,30,41,24,23,13,1,11,2,115,16.428571428571427,5,0.0,9,24,18,13,32,1,5,11,2,64,51,0
6602,62076,gRHI1NeWW3c6BFrZIrJSlWu9NHDjRltm,A3fsA9Zfv1X2fVEQhTw51lKENdNrEqT3,1,0,0,0,0,0,1,0,1,0.14285714285714285,1,0.0,0,0,0,0,0,0,0,1,0,0,1,1
6603,62091,6AOZlfpjI3ayLpXvguaWVv2FqhQMzw4M,SpATywNh6bZuzm8s1ceuBUnMUAeoAHHw,26,37,13,36,0,4,11,0,101,14.428571428571429,8,0.0,14,13,35,0,23,4,1,11,0,62,39,0
6604,62107,2WHNpOBPMmOzdjUXQIDdX6w5Bhh6AyHU,A3fsA9Zfv1X2fVEQhTw51lKENdNrEqT3,4,2,0,0,0,0,3,0,5,0.7142857142857143,1,0.0,0,0,0,0,2,0,0,3,0,0,5,1
6605,62113,jJEQAKDG1yT0OS9qRBZrNXlEJDxE8Etq,SpATywNh6bZuzm8s1ceuBUnMUAeoAHHw,25,26,1,51,0,8,3,1,90,12.857142857142858,1,0.0,12,1,39,0,14,8,12,3,1,52,38,0
6606,62121,NhPJ9UBOBOBhPPFbQaBatdINFBV0LhGH,bWdj2GDclj5ofokWjzoa5jAwMkxCykd6,6,3,1,0,1,0,2,0,7,1.0,1,0.0,0,1,0,1,3,0,0,2,0,2,5,1
6607,62126,TW1ehLQL40Ikq19OEBxpAsyok2kyaCmk,SpATywNh6bZuzm8s1ceuBUnMUAeoAHHw,2,0,0,0,0,0,3,0,3,0.42857142857142855,1,0.0,0,0,0,0,0,0,0,3,0,0,3,0
6608,62127,mf8NzKqxFvs6BIygtQ5WjltMylvjXbHc,SpATywNh6bZuzm8s1ceuBUnMUAeoAHHw,13,8,6,0,5,1,2,0,22,3.142857142857143,1,0.0,1,6,0,5,7,1,0,2,0,12,10,0
6609,62133,CsUkH6E2FiorKRYwpRBQQof16ywBIfF7,SpATywNh6bZuzm8s1ceuBUnMUAeoAHHw,46,87,36,57,17,1,20,1,219,31.285714285714285,4,0.0,25,36,51,17,62,1,6,20,1,129,90,0
6610,62139,i045qgxm9LaqFzlH53qyz9yZHDVsE7Hd,A3fsA9Zfv1X2fVEQhTw51lKENdNrEqT3,9,5,3,0,2,2,3,0,15,2.142857142857143,1,0.0,1,3,0,2,4,2,0,3,0,6,9,0
6611,62146,y8Q2VwfVlqk1j3XET9GUUSulEAonzlDI,7GRhBDsirIGkRZBtSMEzNTyDr2JQm4xx,4,0,0,0,0,0,5,1,6,0.8571428571428571,1,0.0,0,0,0,0,0,0,0,5,1,0,6,1
6612,62156,W2whDchxLBc7jpJ4UAVUryN7DSrj5pnr,SpATywNh6bZuzm8s1ceuBUnMUAeoAHHw,8,4,1,0,1,10,24,2,42,6.0,2,0.0,0,1,0,1,4,10,0,24,2,2,40,0
6613,62160,Mm7Iv2bcZu7V7eMb3kbuiZ6iWSUOq5iS,7GRhBDsirIGkRZBtSMEzNTyDr2JQm4xx,7,6,2,0,1,0,3,0,12,1.7142857142857142,2,0.0,0,2,0,1,6,0,0,3,0,3,9,1
6614,62161,We0slB08viHgFv6ByLfwdtuQZUg6JG7L,SpATywNh6bZuzm8s1ceuBUnMUAeoAHHw,3,0,0,0,0,0,4,0,4,0.5714285714285714,2,0.0,0,0,0,0,0,0,0,4,0,0,4,1
6615,62171,0qWriw6Ob6vvUwGuar3co0oWxdxDhQfz,SpATywNh6bZuzm8s1ceuBUnMUAeoAHHw,22,37,3,0,3,0,11,0,54,7.714285714285714,3,0.0,0,3,0,3,37,0,0,11,0,6,48,1
6616,62186,W0MWfR8rCQKyPPfo34tiE6MzA7EX1V3m,7GRhBDsirIGkRZBtSMEzNTyDr2JQm4xx,1,0,0,0,0,0,1,0,1,0.14285714285714285,1,0.0,0,0,0,0,0,0,0,1,0,0,1,1
6617,62191,iyrbynbgfl6D6KuieOqH3w32Iw2l2I2s,SpATywNh6bZuzm8s1ceuBUnMUAeoAHHw,7,9,2,0,1,1,3,0,16,2.2857142857142856,1,0.0,0,2,0,1,9,1,0,3,0,3,13,0
6618,62201,1OBrER2fhEaO1ssR5JjSNPBTyfOQ6TtL,SpATywNh6bZuzm8s1ceuBUnMUAeoAHHw,1,0,0,0,0,0,1,0,1,0.14285714285714285,1,0.0,0,0,0,0,0,0,0,1,0,0,1,0
6619,62202,rTwB58J1ssafmkoi8YPftYxAHYuyJ7NT,SpATywNh6bZuzm8s1ceuBUnMUAeoAHHw,9,13,5,11,1,0,1,0,31,4.428571428571429,1,0.0,6,5,10,1,7,0,1,1,0,22,9,1
6620,62208,mPSPvu82Gr17tV9GJ95bDC7exvsVnwDE,7GRhBDsirIGkRZBtSMEzNTyDr2JQm4xx,26,39,13,57,11,3,1,0,124,17.714285714285715,1,0.0,22,13,50,11,17,3,7,1,0,96,28,1
6621,62212,OEQBiRbbo3yEBzKSHcNX9ESBTSUy08ze,bWdj2GDclj5ofokWjzoa5jAwMkxCykd6,1,0,0,0,0,0,1,0,1,0.14285714285714285,1,0.0,0,0,0,0,0,0,0,1,0,0,1,1
6622,62218,FZjjoikxEifQwEx2vf6LYlhg4yyTwbym,bWdj2GDclj5ofokWjzoa5jAwMkxCykd6,9,6,3,0,4,0,6,0,19,2.7142857142857144,1,0.0,2,3,0,4,4,0,0,6,0,9,10,1
6623,62221,8wfthNOb0BPhThSw9kjQe6qRCSNePszj,A3fsA9Zfv1X2fVEQhTw51lKENdNrEqT3,14,8,6,0,5,0,7,1,27,3.857142857142857,1,0.0,0,6,0,5,8,0,0,7,1,11,16,1
6624,62230,ndhDcdDAu6yt6DqeoDQVxePRQtPmMi2n,bWdj2GDclj5ofokWjzoa5jAwMkxCykd6,3,2,0,0,0,0,2,0,4,0.5714285714285714,1,0.0,0,0,0,0,2,0,0,2,0,0,4,0
6625,62233,ndhDcdDAu6yt6DqeoDQVxePRQtPmMi2n,A3fsA9Zfv1X2fVEQhTw51lKENdNrEqT3,2,0,0,0,0,0,2,0,2,0.2857142857142857,1,0.0,0,0,0,0,0,0,0,2,0,0,2,1
6626,62235,2cdJoONM7ugDmkPkQHwnxWZwEOIANTXn,SpATywNh6bZuzm8s1ceuBUnMUAeoAHHw,52,166,83,20,21,87,52,3,432,61.714285714285715,15,0.0,3,83,19,21,163,87,1,52,3,126,306,0
6627,62250,09X3P3tf7uZBb0lMjqIth9ywCuAasY60,bWdj2GDclj5ofokWjzoa5jAwMkxCykd6,11,12,7,0,5,0,5,0,29,4.142857142857143,1,0.0,0,7,0,5,12,0,0,5,0,12,17,1
6628,62251,76Kz8DEQMUa3r549crPtcn99eC1czeI6,7GRhBDsirIGkRZBtSMEzNTyDr2JQm4xx,1,0,0,0,0,0,1,0,1,0.14285714285714285,1,0.0,0,0,0,0,0,0,0,1,0,0,1,1
6629,62252,WqQAkduIaOlq1wWFWXlgkkciS37w9XAD,SpATywNh6bZuzm8s1ceuBUnMUAeoAHHw,5,2,0,0,0,0,3,0,5,0.7142857142857143,1,0.0,0,0,0,0,2,0,0,3,0,0,5,1
6630,62261,0teJ1SJvfM0H0N4uvzYYmDS7MZCwymzl,SpATywNh6bZuzm8s1ceuBUnMUAeoAHHw,4,2,1,0,0,0,4,0,7,1.0,1,0.0,0,1,0,0,2,0,0,4,0,1,6,1
6631,62270,MoUfFGTeyhYQMUSCAFTBt9yT4WYYwdbw,5X6FeZozNMgE2VRi3MJYjkkFK8SETtu2,1,0,0,0,0,0,2,0,2,0.2857142857142857,1,0.0,0,0,0,0,0,0,0,2,0,0,2,1
6632,62273,IuNpIOaZuRBW2mgIKgHs21LDtcpNsfmu,A3fsA9Zfv1X2fVEQhTw51lKENdNrEqT3,2,0,0,0,0,0,2,0,2,0.2857142857142857,1,0.0,0,0,0,0,0,0,0,2,0,0,2,1
6633,62274,MoUfFGTeyhYQMUSCAFTBt9yT4WYYwdbw,A3fsA9Zfv1X2fVEQhTw51lKENdNrEqT3,2,0,0,0,0,0,5,0,5,0.7142857142857143,1,0.0,0,0,0,0,0,0,0,5,0,0,5,1
6634,62285,VlxbZHrbMUNIIDz1p5aud0MZpY7LDewP,SpATywNh6bZuzm8s1ceuBUnMUAeoAHHw,8,3,3,0,3,0,3,0,12,1.7142857142857142,1,0.0,0,3,0,3,3,0,0,3,0,6,6,1
6635,62287,Iqr8rhvnyF52EAaKRHEvXgD2JWX5u592,SpATywNh6bZuzm8s1ceuBUnMUAeoAHHw,1,0,0,0,0,0,1,0,1,0.14285714285714285,1,0.0,0,0,0,0,0,0,0,1,0,0,1,1
6636,62290,FAyKTlOaLRLHiyLG5PXQhYddpdx56j0F,SpATywNh6bZuzm8s1ceuBUnMUAeoAHHw,23,52,24,19,10,7,16,1,129,18.428571428571427,4,0.0,16,24,16,10,36,7,3,16,1,66,63,0
6637,62298,tgRV4Ph6jBkXuRC2WRimt2dpgifT6OCw,SpATywNh6bZuzm8s1ceuBUnMUAeoAHHw,4,2,1,0,1,0,2,0,6,0.8571428571428571,1,0.0,0,1,0,1,2,0,0,2,0,2,4,1
6638,62305,jFuORSL1URM2oqg9zp9eOfHmKoYyUgBh,SpATywNh6bZuzm8s1ceuBUnMUAeoAHHw,30,51,14,28,8,1,12,1,115,16.428571428571427,4,0.0,16,14,25,8,35,1,3,12,1,63,52,1
6639,62308,b4rUjBS7vB8qaoMp858Ib5n66iOTypn7,A3fsA9Zfv1X2fVEQhTw51lKENdNrEqT3,6,4,3,0,3,0,1,0,11,1.5714285714285714,1,0.0,0,3,0,3,4,0,0,1,0,6,5,0
6640,62310,OGbZQlCPOxb4YZ1VHMQPOFrqLYAV6XNt,SpATywNh6bZuzm8s1ceuBUnMUAeoAHHw,9,5,3,0,2,0,4,0,14,2.0,2,0.0,0,3,0,2,5,0,0,4,0,5,9,0
6641,62311,vrSE88LVDCOnrKr9y1AdVXn1Flmm2mPs,SpATywNh6bZuzm8s1ceuBUnMUAeoAHHw,17,17,2,14,2,0,3,0,38,5.428571428571429,2,0.0,6,2,13,2,11,0,1,3,0,23,15,0
6642,62315,rehkhATQUQzsvPUt1FSAdQznlBbIBQCI,A3fsA9Zfv1X2fVEQhTw51lKENdNrEqT3,1,0,0,0,0,0,1,0,1,0.14285714285714285,1,0.0,0,0,0,0,0,0,0,1,0,0,1,1
6643,62321,4aUZNrEysB01BTDaMjEoJUWN7ca7RotB,SpATywNh6bZuzm8s1ceuBUnMUAeoAHHw,8,11,8,0,5,6,5,0,35,5.0,2,0.0,0,8,0,5,11,6,0,5,0,13,22,1
6644,62322,4DoyyXDqOMsiMWzvrBTSPT0IBsmDX2A1,SpATywNh6bZuzm8s1ceuBUnMUAeoAHHw,15,20,18,8,16,0,1,0,63,9.0,3,0.0,1,18,6,16,19,0,2,1,0,41,22,0
6645,62327,92bKvTvnwq2jhFMZWZTxnhsEZdpV3NGQ,SpATywNh6bZuzm8s1ceuBUnMUAeoAHHw,2,0,0,0,0,0,2,0,2,0.2857142857142857,1,0.0,0,0,0,0,0,0,0,2,0,0,2,1
6646,62331,FMwKUA8u0BzLarxpeAgKTtl6QSWIGKl8,SpATywNh6bZuzm8s1ceuBUnMUAeoAHHw,1,0,0,0,0,0,2,0,2,0.2857142857142857,2,0.0,0,0,0,0,0,0,0,2,0,0,2,0
6647,62342,Ld3gWjLWB7sts9LKFmrdXWXwm92Xd0Uq,bWdj2GDclj5ofokWjzoa5jAwMkxCykd6,5,2,2,0,2,0,4,0,10,1.4285714285714286,1,0.0,0,2,0,2,2,0,0,4,0,4,6,1
6648,62352,sow5cbVOHzieZ57WdIZ7rxvpXXvB9GoH,A3fsA9Zfv1X2fVEQhTw51lKENdNrEqT3,12,7,6,0,5,0,2,0,20,2.857142857142857,1,0.0,0,6,0,5,7,0,0,2,0,11,9,1
6649,62371,sdgY41MIb6WYbIgC75Nfq2olF7e670eU,7GRhBDsirIGkRZBtSMEzNTyDr2JQm4xx,6,3,1,0,1,0,2,0,7,1.0,1,0.0,0,1,0,1,3,0,0,2,0,2,5,1
6650,62376,CqhdzHIILIe1pnO5H5MX1yWHcBaohaEB,7GRhBDsirIGkRZBtSMEzNTyDr2JQm4xx,8,2,2,0,2,0,3,0,9,1.2857142857142858,1,0.0,0,2,0,2,2,0,0,3,0,4,5,1
6651,62383,hIFgL0n5x61JjabCFOIHZgZxMVGzmHNh,SpATywNh6bZuzm8s1ceuBUnMUAeoAHHw,51,99,49,32,29,1,12,0,222,31.714285714285715,8,0.0,7,49,29,29,92,1,3,12,0,114,108,0
6652,62392,FLIojen7fff3GhtDNtEDgYWfLgv0g8w4,A3fsA9Zfv1X2fVEQhTw51lKENdNrEqT3,12,7,2,0,0,1,12,1,23,3.2857142857142856,3,0.0,0,2,0,0,7,1,0,12,1,2,21,1
6653,62394,rhi6DwOdDxPn54oD7Ihjt2rbAzoJjgeO,A3fsA9Zfv1X2fVEQhTw51lKENdNrEqT3,2,0,0,0,0,0,2,0,2,0.2857142857142857,1,0.0,0,0,0,0,0,0,0,2,0,0,2,0
6654,62395,pK6rzyUuCZmhSxLTFQprydajDiiwmTm8,SpATywNh6bZuzm8s1ceuBUnMUAeoAHHw,4,2,1,0,1,0,1,0,5,0.7142857142857143,1,0.0,0,1,0,1,2,0,0,1,0,2,3,1
6655,62408,nWHKYpL7gfGd5o6Yik3SkKS20pn1ocoS,SpATywNh6bZuzm8s1ceuBUnMUAeoAHHw,21,17,5,14,3,0,3,0,42,6.0,2,0.0,4,5,13,3,13,0,1,3,0,25,17,1
6656,62416,xOjhmcafCtLT2q16oVNZpjeZh4FUCy6U,bWdj2GDclj5ofokWjzoa5jAwMkxCykd6,9,13,6,0,4,0,7,0,30,4.285714285714286,2,0.0,3,6,0,4,10,0,0,7,0,13,17,0
6657,62420,d7WW3KTRknYcXaBZVYoIbNodkFYiI6Ik,bWdj2GDclj5ofokWjzoa5jAwMkxCykd6,17,36,10,32,12,13,11,1,115,16.428571428571427,1,0.0,6,10,31,12,30,13,1,11,1,59,56,0
6658,62421,SdcBphx7BESMj1mdAJDqRrAazSDoLz8G,A3fsA9Zfv1X2fVEQhTw51lKENdNrEqT3,7,2,1,0,0,0,8,0,11,1.5714285714285714,2,0.0,0,1,0,0,2,0,0,8,0,1,10,0
6659,62426,5mO7C1dFwundVgxmwj0qAHfPbFKc9GyD,A3fsA9Zfv1X2fVEQhTw51lKENdNrEqT3,1,0,0,0,0,0,2,0,2,0.2857142857142857,1,0.0,0,0,0,0,0,0,0,2,0,0,2,1
6660,62427,7FBwqoodmzhvrGGLuwBjRrxsykocUv8u,7GRhBDsirIGkRZBtSMEzNTyDr2JQm4xx,17,13,10,0,7,0,2,0,32,4.571428571428571,1,0.0,2,10,0,7,11,0,0,2,0,19,13,1
6661,62431,s3wtFKugaAKB43ojnhovCpGktGjeVAzu,5X6FeZozNMgE2VRi3MJYjkkFK8SETtu2,13,36,4,4,1,0,8,0,53,7.571428571428571,4,0.0,12,4,4,1,24,0,0,8,0,21,32,1
6662,62438,95gHhLGdlbtW5E72xyxtYlwvSjIG9gAI,5X6FeZozNMgE2VRi3MJYjkkFK8SETtu2,5,2,1,0,1,0,3,0,7,1.0,2,0.0,0,1,0,1,2,0,0,3,0,2,5,1
6663,62440,WmzYkzlMNuHgERGSMthySa2d3K7cWcp2,5X6FeZozNMgE2VRi3MJYjkkFK8SETtu2,7,3,1,0,2,0,2,0,8,1.1428571428571428,1,0.0,0,1,0,2,3,0,0,2,0,3,5,1
6664,62455,TGKKBT4W2L0CWcP0EPRhdqdXdbvVz6Hc,5X6FeZozNMgE2VRi3MJYjkkFK8SETtu2,1,0,0,0,0,0,1,0,1,0.14285714285714285,1,0.0,0,0,0,0,0,0,0,1,0,0,1,1
6665,62466,ggEr2STKTwtSSUdtGCmiPr3DBu3TJ34B,SpATywNh6bZuzm8s1ceuBUnMUAeoAHHw,24,23,5,22,0,0,8,0,58,8.285714285714286,5,0.0,8,5,22,0,15,0,0,8,0,35,23,1
6666,62481,ggEr2STKTwtSSUdtGCmiPr3DBu3TJ34B,7GRhBDsirIGkRZBtSMEzNTyDr2JQm4xx,1,0,0,0,0,0,1,0,1,0.14285714285714285,1,0.0,0,0,0,0,0,0,0,1,0,0,1,1
6667,62510,VKZrA9UHz7VaRJstik2phf1CbUI8Uxym,SpATywNh6bZuzm8s1ceuBUnMUAeoAHHw,1,0,0,0,0,0,2,0,2,0.2857142857142857,1,0.0,0,0,0,0,0,0,0,2,0,0,2,0
6668,62516,l7f4vHvlZkxCYoU9qM63V45bmndBSeZQ,A3fsA9Zfv1X2fVEQhTw51lKENdNrEqT3,18,13,6,40,0,0,6,0,65,9.285714285714286,3,0.0,0,6,38,0,13,0,2,6,0,44,21,1
6669,62532,VYMfm0tgVS6x4Eosz9NPpRPYpCrgFsMy,SpATywNh6bZuzm8s1ceuBUnMUAeoAHHw,45,89,16,59,9,1,16,0,190,27.142857142857142,3,0.0,13,16,53,9,76,1,6,16,0,91,99,0
6670,62533,UOssUZDJcaoIiaAH8nTbzjrXIWUHSQSA,7GRhBDsirIGkRZBtSMEzNTyDr2JQm4xx,3,2,1,0,0,0,1,0,4,0.5714285714285714,1,0.0,0,1,0,0,2,0,0,1,0,1,3,1
6671,62549,u82lBhpDxJIwlZISEntCxj1zgVFdW0vT,bWdj2GDclj5ofokWjzoa5jAwMkxCykd6,1,0,0,0,0,0,2,0,2,0.2857142857142857,2,0.0,0,0,0,0,0,0,0,2,0,0,2,1
6672,62551,u82lBhpDxJIwlZISEntCxj1zgVFdW0vT,5X6FeZozNMgE2VRi3MJYjkkFK8SETtu2,1,0,0,0,0,0,1,0,1,0.14285714285714285,1,0.0,0,0,0,0,0,0,0,1,0,0,1,1
6673,62554,bYD2u7vuN3G54awyDYPdRiZI3O4zw6kx,SpATywNh6bZuzm8s1ceuBUnMUAeoAHHw,48,49,27,38,13,4,15,0,146,20.857142857142858,7,0.0,13,27,36,13,36,4,2,15,0,89,57,0
6674,62571,E96VmAw6m1AOHRckdqiq2ASKbnHBlpAb,SpATywNh6bZuzm8s1ceuBUnMUAeoAHHw,30,55,23,18,9,4,19,0,128,18.285714285714285,11,0.0,10,23,16,9,45,4,2,19,0,58,70,0
6675,62572,KSk9vNaHKrnc7mpW0UkB9gnAccFXKZ3t,SpATywNh6bZuzm8s1ceuBUnMUAeoAHHw,7,3,2,0,2,0,2,0,9,1.2857142857142858,1,0.0,0,2,0,2,3,0,0,2,0,4,5,1
6676,62578,Q11HqpDxrpVz5YMzRCx4zOr85dBot8E5,A3fsA9Zfv1X2fVEQhTw51lKENdNrEqT3,21,27,2,0,2,2,13,0,46,6.571428571428571,4,0.0,1,2,0,2,26,2,0,13,0,5,41,0
6677,62586,EHWtzteXxfhRPYJzgfTPSomgv9mCA5Xm,A3fsA9Zfv1X2fVEQhTw51lKENdNrEqT3,5,4,1,0,1,0,3,0,9,1.2857142857142858,1,0.0,0,1,0,1,4,0,0,3,0,2,7,1
6678,62599,TaWtI5u5Mwwhlx2CHWDc1SetqGJdEFl5,5X6FeZozNMgE2VRi3MJYjkkFK8SETtu2,4,2,1,0,1,0,1,0,5,0.7142857142857143,1,0.0,0,1,0,1,2,0,0,1,0,2,3,1
6679,62615,P18honwQPPbELUE86qFIATuZK3YDtjvG,5X6FeZozNMgE2VRi3MJYjkkFK8SETtu2,8,11,4,0,2,0,4,0,21,3.0,4,0.0,0,4,0,2,11,0,0,4,0,6,15,1
6680,62621,CO3sprBt7zms4eyX8oyF4N8qFejqwRFV,A3fsA9Zfv1X2fVEQhTw51lKENdNrEqT3,11,7,6,0,6,0,2,0,21,3.0,1,0.0,0,6,0,6,7,0,0,2,0,12,9,0
6681,62622,uU71zmfnwmq5Imjxap728hWGDmNRuuCF,SpATywNh6bZuzm8s1ceuBUnMUAeoAHHw,17,18,15,19,11,1,7,1,72,10.285714285714286,3,0.0,2,15,16,11,16,1,3,7,1,44,28,1
6682,62633,zlsPhArkUaQ0CCdgZTO1797WJjiciHBk,SpATywNh6bZuzm8s1ceuBUnMUAeoAHHw,7,18,13,0,4,0,10,1,46,6.571428571428571,5,0.0,1,13,0,4,17,0,0,10,1,18,28,0
6683,62637,7PJjcgOQXwj0M6oz8Sxyd66Tvypm0TFY,SpATywNh6bZuzm8s1ceuBUnMUAeoAHHw,28,42,28,3,17,6,9,3,108,15.428571428571429,5,0.0,3,28,3,17,39,6,0,9,3,51,57,0
6684,62639,FQhheXDYqPnNGkMGcpToxersRXUHO59E,5X6FeZozNMgE2VRi3MJYjkkFK8SETtu2,2,0,0,0,0,0,2,0,2,0.2857142857142857,1,0.0,0,0,0,0,0,0,0,2,0,0,2,1
6685,62650,fRwQZvCpdOagdKZsrPTgO4eZ7tbF55Tm,SpATywNh6bZuzm8s1ceuBUnMUAeoAHHw,5,2,1,0,1,0,2,0,6,0.8571428571428571,1,0.0,0,1,0,1,2,0,0,2,0,2,4,1
6686,62651,zVNMq6x92zDzxLFewYkpNWI57ohFqEE9,A3fsA9Zfv1X2fVEQhTw51lKENdNrEqT3,7,3,2,0,2,0,2,0,9,1.2857142857142858,1,0.0,0,2,0,2,3,0,0,2,0,4,5,0
6687,62669,PMp3RxnsqELMI5BiCmteZ8iF2l5wlW7H,7GRhBDsirIGkRZBtSMEzNTyDr2JQm4xx,1,0,0,0,0,0,1,0,1,0.14285714285714285,1,0.0,0,0,0,0,0,0,0,1,0,0,1,1
6688,62673,PL1LSMvKwzFrxfWucLcQyZyAiyrnjJPM,SpATywNh6bZuzm8s1ceuBUnMUAeoAHHw,8,10,3,0,3,0,3,0,19,2.7142857142857144,2,0.0,0,3,0,3,10,0,0,3,0,6,13,1
6689,62675,W7aaCFsYNegloRh1IlKOwq22jdh9r52p,5X6FeZozNMgE2VRi3MJYjkkFK8SETtu2,15,13,9,0,6,0,6,0,34,4.857142857142857,3,0.0,0,9,0,6,13,0,0,6,0,15,19,0
6690,62682,1kf9MpHbiCgoPms85eVRLEWBQo2ISdL8,bWdj2GDclj5ofokWjzoa5jAwMkxCykd6,5,2,1,0,1,0,4,0,8,1.1428571428571428,1,0.0,0,1,0,1,2,0,0,4,0,2,6,1
6691,62685,xhufFs72rOwOGZDYtQtHTXdheNyqrUTX,SpATywNh6bZuzm8s1ceuBUnMUAeoAHHw,44,54,33,35,13,2,34,1,172,24.571428571428573,10,0.0,9,33,32,13,45,2,3,34,1,87,85,0
6692,62686,DpXkrIHIAIPNESKyvFah0WhpVT5PHFeL,bWdj2GDclj5ofokWjzoa5jAwMkxCykd6,10,32,18,16,0,3,10,0,79,11.285714285714286,3,0.0,3,18,16,0,29,3,0,10,0,37,42,1
6693,62730,HwmOe48TnHpxGJFpJY55xag3SIXvxDtW,bWdj2GDclj5ofokWjzoa5jAwMkxCykd6,1,0,0,0,0,0,1,0,1,0.14285714285714285,1,0.0,0,0,0,0,0,0,0,1,0,0,1,1
6694,62737,FHNmlUHjqfGgz0Bf1982fW5CY3mV647H,SpATywNh6bZuzm8s1ceuBUnMUAeoAHHw,15,26,14,21,6,0,6,0,73,10.428571428571429,1,0.0,6,14,17,6,20,0,4,6,0,43,30,0
6695,62738,hkI32MAgHvJ4T3I3Up79daEJ8l4sKHaC,5X6FeZozNMgE2VRi3MJYjkkFK8SETtu2,7,4,1,2,2,0,2,0,11,1.5714285714285714,1,0.0,2,1,2,2,2,0,0,2,0,7,4,1
6696,62739,CaM5OJ40UpPm5AoorpoNghXDZnct2Zfn,SpATywNh6bZuzm8s1ceuBUnMUAeoAHHw,34,55,17,32,8,27,15,2,156,22.285714285714285,5,0.0,17,17,28,8,38,27,4,15,2,70,86,1
6697,62752,GKJr5PPNFb6sbmwmK3Q19sOuk5TaY1oJ,SpATywNh6bZuzm8s1ceuBUnMUAeoAHHw,11,14,3,7,0,0,5,0,29,4.142857142857143,4,0.0,1,3,6,0,13,0,1,5,0,10,19,1
6698,62756,rn8AvGrYTXmz2EJDIFn9QybnzSd0klef,A3fsA9Zfv1X2fVEQhTw51lKENdNrEqT3,1,0,0,0,0,0,1,0,1,0.14285714285714285,1,0.0,0,0,0,0,0,0,0,1,0,0,1,1
6699,62761,yfEYs1l7yxStwsdpgK6SIUUGtvFFQgxO,5X6FeZozNMgE2VRi3MJYjkkFK8SETtu2,20,46,7,9,23,1,8,4,98,14.0,4,0.0,37,7,9,23,9,1,0,8,4,76,22,1
6700,62764,XsK920toyXvpWwNS6lvZzDVJcrgCTFKd,SpATywNh6bZuzm8s1ceuBUnMUAeoAHHw,37,46,24,28,14,4,7,0,123,17.571428571428573,5,0.0,13,24,26,14,33,4,2,7,0,77,46,0
6701,62769,Y3Qq9FqOVwUj6PrB3KNsrLngzeSzadt5,A3fsA9Zfv1X2fVEQhTw51lKENdNrEqT3,1,0,0,0,0,0,1,0,1,0.14285714285714285,1,0.0,0,0,0,0,0,0,0,1,0,0,1,1
6702,62770,TqLkmogP9A8wj7y0peV7PS3deY5AXfKI,5X6FeZozNMgE2VRi3MJYjkkFK8SETtu2,1,0,0,0,0,0,1,0,1,0.14285714285714285,1,0.0,0,0,0,0,0,0,0,1,0,0,1,1
6703,62774,jccfrbjOfPTUO9oDFonSJAjYRAHbe3jz,SpATywNh6bZuzm8s1ceuBUnMUAeoAHHw,8,5,3,0,2,0,6,0,16,2.2857142857142856,1,0.0,0,3,0,2,5,0,0,6,0,5,11,0
6704,62778,w5f3SCso3vkK2wUsopN9cXi6es2y9wa9,SpATywNh6bZuzm8s1ceuBUnMUAeoAHHw,6,3,1,0,0,0,3,1,8,1.1428571428571428,1,0.0,0,1,0,0,3,0,0,3,1,1,7,1
6705,62785,M7hDuaWvzRtPysMPuLiwkaKPgvCGqMeN,bWdj2GDclj5ofokWjzoa5jAwMkxCykd6,8,2,0,0,1,1,8,3,15,2.142857142857143,1,0.0,0,0,0,1,2,1,0,8,3,1,14,1
6706,62795,hf0GNWS6vfpKVHFBCaEpR8vnVjTeyl46,7GRhBDsirIGkRZBtSMEzNTyDr2JQm4xx,1,0,0,0,0,0,1,0,1,0.14285714285714285,1,0.0,0,0,0,0,0,0,0,1,0,0,1,1
6707,62805,LJYBef7iIBiSZz8D7KTtMTsdkyd91gnR,A3fsA9Zfv1X2fVEQhTw51lKENdNrEqT3,53,34,24,68,15,0,9,0,150,21.428571428571427,6,0.0,1,24,61,15,33,0,7,9,0,101,49,1
6708,62806,baIBGHksBqEhi8cV6mSaiIUAZMUNWNoH,bWdj2GDclj5ofokWjzoa5jAwMkxCykd6,7,11,6,0,1,2,10,0,30,4.285714285714286,1,0.0,0,6,0,1,11,2,0,10,0,7,23,0
6709,62809,EEgHvStGR7XKoMKoPOCBxkxFHcb7UdMh,SpATywNh6bZuzm8s1ceuBUnMUAeoAHHw,6,30,16,0,1,0,16,0,63,9.0,10,0.0,0,16,0,1,30,0,0,16,0,17,46,0
6710,62813,reVwvLtud5XxET1iG7iTTQOqQC7njl8h,SpATywNh6bZuzm8s1ceuBUnMUAeoAHHw,47,55,47,7,34,0,10,0,153,21.857142857142858,4,0.0,2,47,7,34,53,0,0,10,0,90,63,0
6711,62819,zn2X74vvqUQRINz90WjZLsSsFglpYr7o,SpATywNh6bZuzm8s1ceuBUnMUAeoAHHw,8,7,6,0,4,0,7,0,24,3.4285714285714284,3,0.0,0,6,0,4,7,0,0,7,0,10,14,1
6712,62823,z7VHnpzigmVh7wBxUgytC06GpTDQHeLr,SpATywNh6bZuzm8s1ceuBUnMUAeoAHHw,4,4,3,0,3,0,1,0,11,1.5714285714285714,1,0.0,0,3,0,3,4,0,0,1,0,6,5,0
6713,62837,k4ieA0VLPLUG1GV8FhtBGpWAykZRhHXI,7GRhBDsirIGkRZBtSMEzNTyDr2JQm4xx,58,154,56,147,35,3,14,1,410,58.57142857142857,10,0.0,87,56,132,35,67,3,15,14,1,310,100,1
6714,62856,SMph1YQCIZlmphiUl0TLsRAe6lO4LFpT,7GRhBDsirIGkRZBtSMEzNTyDr2JQm4xx,1,0,0,0,0,0,1,0,1,0.14285714285714285,1,0.0,0,0,0,0,0,0,0,1,0,0,1,1
6715,62864,3LVlNsK7BHroChDOSCZ8wTJul8hRnncw,7GRhBDsirIGkRZBtSMEzNTyDr2JQm4xx,8,18,5,6,2,0,3,0,34,4.857142857142857,1,0.0,11,5,4,2,7,0,2,3,0,22,12,1
6716,62868,Z5Dgq02GJZwP1I2fvmHLkqgiztGyQl0J,SpATywNh6bZuzm8s1ceuBUnMUAeoAHHw,21,16,6,28,0,20,5,4,79,11.285714285714286,1,0.0,8,6,27,0,8,20,1,5,4,41,38,1
6717,62873,lo9vHqgfDG1UEcho8eZgahljlKaQ2l9G,bWdj2GDclj5ofokWjzoa5jAwMkxCykd6,9,3,1,18,1,0,8,0,31,4.428571428571429,1,0.0,1,1,17,1,2,0,1,8,0,20,11,0
6718,62879,YzrG8hkWHsWBnejqfVSQT69MsrfeFNO4,SpATywNh6bZuzm8s1ceuBUnMUAeoAHHw,1,0,0,0,0,0,1,0,1,0.14285714285714285,1,0.0,0,0,0,0,0,0,0,1,0,0,1,1
6719,62882,uNvVk5ZxKLJZf61FQYrSSEMvIvy0EL4b,SpATywNh6bZuzm8s1ceuBUnMUAeoAHHw,11,7,4,0,3,0,2,0,16,2.2857142857142856,2,0.0,0,4,0,3,7,0,0,2,0,7,9,1
6720,62884,gv12mj7TYLo5OX6vjchegr74v64uwg6T,bWdj2GDclj5ofokWjzoa5jAwMkxCykd6,1,0,0,0,0,0,1,0,1,0.14285714285714285,1,0.0,0,0,0,0,0,0,0,1,0,0,1,1
6721,62885,3woJp7iHTbi0jGvMsKVmiaEnMujLv8R8,A3fsA9Zfv1X2fVEQhTw51lKENdNrEqT3,20,27,12,0,8,6,10,1,64,9.142857142857142,2,0.0,0,12,0,8,27,6,0,10,1,20,44,1
6722,62891,lo9vHqgfDG1UEcho8eZgahljlKaQ2l9G,7GRhBDsirIGkRZBtSMEzNTyDr2JQm4xx,1,0,0,0,0,0,1,0,1,0.14285714285714285,1,0.0,0,0,0,0,0,0,0,1,0,0,1,1
6723,62895,A30ldvcZzMcGBRvQ5EfE4QUuIq2OYLGK,SpATywNh6bZuzm8s1ceuBUnMUAeoAHHw,14,15,6,19,3,0,3,0,46,6.571428571428571,1,0.0,6,6,16,3,9,0,3,3,0,31,15,1
6724,62903,6WyBLtTebYxWs237cTFazhrWvguV9PiM,7GRhBDsirIGkRZBtSMEzNTyDr2JQm4xx,40,76,0,151,9,0,4,0,240,34.285714285714285,3,0.0,34,0,135,9,42,0,16,4,0,178,62,1
6725,62911,KwjYZWNYzBofNYG8mRoeOhYNpisNnTvM,SpATywNh6bZuzm8s1ceuBUnMUAeoAHHw,6,3,2,0,2,0,3,0,10,1.4285714285714286,2,0.0,0,2,0,2,3,0,0,3,0,4,6,1
6726,62913,VnWhM3BeDRhDK8eiBuMGZHGyfJnGv0sM,SpATywNh6bZuzm8s1ceuBUnMUAeoAHHw,46,72,11,62,7,1,23,3,179,25.571428571428573,5,0.0,10,11,57,7,62,1,5,23,3,85,94,1
6727,62915,sOkc0wEXSSLpxtxlqjZObJqg94IyLpuY,5X6FeZozNMgE2VRi3MJYjkkFK8SETtu2,6,8,1,0,0,0,2,0,11,1.5714285714285714,1,0.0,3,1,0,0,5,0,0,2,0,4,7,1
6728,62925,S6pyc72qK2lqlFxsAUiWhEvowKWj4Fmg,SpATywNh6bZuzm8s1ceuBUnMUAeoAHHw,5,2,0,0,1,0,3,0,6,0.8571428571428571,1,0.0,0,0,0,1,2,0,0,3,0,1,5,0
6729,62927,e3zKHlvslzm6unuvuFVFRMmvFxyH5DET,bWdj2GDclj5ofokWjzoa5jAwMkxCykd6,1,0,0,0,0,0,1,0,1,0.14285714285714285,1,0.0,0,0,0,0,0,0,0,1,0,0,1,1
6730,62928,lFMbkCaY0FKfyGbh1VOL30jTZ1USVgB2,A3fsA9Zfv1X2fVEQhTw51lKENdNrEqT3,25,18,14,10,11,0,6,0,59,8.428571428571429,2,0.0,0,14,10,11,18,0,0,6,0,35,24,0
6731,62937,JJDRXXLRU75H8Dx2cuK7Td1V7D7QoKg9,bWdj2GDclj5ofokWjzoa5jAwMkxCykd6,6,12,0,0,1,0,7,0,20,2.857142857142857,2,0.0,3,0,0,1,9,0,0,7,0,4,16,0
6732,62944,NLLJQp9UUSoaM0rH4iw5IExuDzB3QzHc,SpATywNh6bZuzm8s1ceuBUnMUAeoAHHw,1,0,0,0,0,0,1,0,1,0.14285714285714285,1,0.0,0,0,0,0,0,0,0,1,0,0,1,1
6733,62945,psUY0jMEvxZuoP9UKA82E9maLgW6I63x,SpATywNh6bZuzm8s1ceuBUnMUAeoAHHw,23,33,3,14,3,1,13,0,67,9.571428571428571,2,0.0,5,3,13,3,28,1,1,13,0,24,43,0
6734,62948,XjHYgZsrS0l8TkcDRDNv64IhD09kdX0g,7GRhBDsirIGkRZBtSMEzNTyDr2JQm4xx,4,2,1,0,1,0,1,0,5,0.7142857142857143,1,0.0,0,1,0,1,2,0,0,1,0,2,3,1
6735,62957,iugl3Rn3u1ci3BiC2tfekDHOQsD5QVGj,bWdj2GDclj5ofokWjzoa5jAwMkxCykd6,50,175,98,194,29,47,57,5,605,86.42857142857143,11,0.0,30,98,169,29,145,47,25,57,5,326,279,0
6736,62967,3blAUsZiu4FW1Jp6vOBSuHfrNCEPv1lZ,A3fsA9Zfv1X2fVEQhTw51lKENdNrEqT3,16,31,2,0,1,0,12,0,46,6.571428571428571,3,0.0,0,2,0,1,31,0,0,12,0,3,43,1
6737,62968,jkLf5s9Tdb22fUhtxgRjd7TDlKmc2OGK,5X6FeZozNMgE2VRi3MJYjkkFK8SETtu2,28,30,8,83,13,6,6,2,148,21.142857142857142,3,0.0,19,8,68,13,11,6,15,6,2,108,40,1
6738,62975,fV0W6675p3fpyY1tGNGM2NdIFpKgGWLW,SpATywNh6bZuzm8s1ceuBUnMUAeoAHHw,28,41,17,16,3,31,13,0,121,17.285714285714285,7,0.0,14,17,14,3,27,31,2,13,0,48,73,0
6739,62980,MH2dufcdc5plwSw55pPAPhNOJ4cLMg4S,A3fsA9Zfv1X2fVEQhTw51lKENdNrEqT3,1,0,0,0,0,0,1,0,1,0.14285714285714285,1,0.0,0,0,0,0,0,0,0,1,0,0,1,1
6740,62984,8ObpbvAiGmvYrSKfJWLgd5tWjdqZp8vX,SpATywNh6bZuzm8s1ceuBUnMUAeoAHHw,18,19,9,11,5,1,5,1,51,7.285714285714286,2,0.0,7,9,10,5,12,1,1,5,1,31,20,0
6741,62999,JFnonbrySwtMlSqTfY5pp3MQd3sPiIYz,bWdj2GDclj5ofokWjzoa5jAwMkxCykd6,71,55,27,182,13,45,24,4,350,50.0,4,0.0,14,27,149,13,41,45,33,24,4,203,147,0
6742,63000,qMIYVG4oQ2FTHHjmoLKypRdKRuC5AfVw,SpATywNh6bZuzm8s1ceuBUnMUAeoAHHw,5,2,1,0,1,3,4,0,11,1.5714285714285714,1,0.0,0,1,0,1,2,3,0,4,0,2,9,1
6743,63012,dNinMzvnUI72XIboKkbVFVTrZjj6iw1l,SpATywNh6bZuzm8s1ceuBUnMUAeoAHHw,1,0,0,0,0,0,1,0,1,0.14285714285714285,1,0.0,0,0,0,0,0,0,0,1,0,0,1,1
6744,63013,GAibePvSMp9STM46ehplfCoY7z7zhgo4,5X6FeZozNMgE2VRi3MJYjkkFK8SETtu2,16,33,2,17,10,0,4,1,67,9.571428571428571,2,0.0,26,2,12,10,7,0,5,4,1,50,17,0
6745,63022,aGKf0W7DbO5pZNcjJ5sGrg9jyzAmLXkB,SpATywNh6bZuzm8s1ceuBUnMUAeoAHHw,11,18,12,0,8,0,6,0,44,6.285714285714286,2,0.0,0,12,0,8,18,0,0,6,0,20,24,0
6746,63029,uuBww6mp7aLC6vKEZ8cAu2A6VCMt4RtS,A3fsA9Zfv1X2fVEQhTw51lKENdNrEqT3,13,6,4,0,2,0,8,1,21,3.0,2,0.0,0,4,0,2,6,0,0,8,1,6,15,1
6747,63030,6izQCEneEK1X6C1taxn0XENXkSv3cl84,SpATywNh6bZuzm8s1ceuBUnMUAeoAHHw,1,0,0,0,0,0,1,0,1,0.14285714285714285,1,0.0,0,0,0,0,0,0,0,1,0,0,1,1
6748,63040,2YtScMMDlxOx1tCYRwqHIeB1EPIbtkoW,A3fsA9Zfv1X2fVEQhTw51lKENdNrEqT3,16,13,1,0,1,0,12,1,28,4.0,2,0.0,1,1,0,1,12,0,0,12,1,3,25,1
6749,63048,OO2Ag6HEFKkZRtZuzzt1ya8SiL4BLCOC,bWdj2GDclj5ofokWjzoa5jAwMkxCykd6,25,31,14,40,7,1,20,1,114,16.285714285714285,3,0.0,6,14,40,7,25,1,0,20,1,67,47,0
6750,63053,2gXHY5qLgY96Nt3kImmboPawcy43EQXt,7GRhBDsirIGkRZBtSMEzNTyDr2JQm4xx,11,22,11,6,7,0,4,0,50,7.142857142857143,4,0.0,1,11,5,7,21,0,1,4,0,24,26,0
6751,63056,L6bCWveyHz41t3spRecuTvoTMpDuSMwv,SpATywNh6bZuzm8s1ceuBUnMUAeoAHHw,9,7,0,2,0,2,2,0,13,1.8571428571428572,1,0.0,0,0,2,0,7,2,0,2,0,2,11,0
6752,63076,VX0Y1hntiHf9WXSFg6clUWcthaOv0uSF,SpATywNh6bZuzm8s1ceuBUnMUAeoAHHw,3,0,0,0,0,0,3,0,3,0.42857142857142855,1,0.0,0,0,0,0,0,0,0,3,0,0,3,1
6753,63099,WYoMb9pjSPIkNMKnbh6vDtB0LRCn2aRR,bWdj2GDclj5ofokWjzoa5jAwMkxCykd6,11,6,4,0,3,0,5,0,18,2.5714285714285716,3,0.0,0,4,0,3,6,0,0,5,0,7,11,1
6754,63101,ylWFzVpNQAo4ibGT55iIYAAAd3NRBVw1,A3fsA9Zfv1X2fVEQhTw51lKENdNrEqT3,1,0,0,0,0,0,1,0,1,0.14285714285714285,1,0.0,0,0,0,0,0,0,0,1,0,0,1,1
6755,63108,rtYqtRTnqUXb6diSp0MKjdA0eLt2BJ3X,7GRhBDsirIGkRZBtSMEzNTyDr2JQm4xx,25,23,12,18,6,0,5,0,64,9.142857142857142,2,0.0,8,12,17,6,15,0,1,5,0,43,21,1
6756,63112,Uii99HGTZ00iRAn85JVms9bIGm6Sf0Gn,5X6FeZozNMgE2VRi3MJYjkkFK8SETtu2,1,0,0,0,0,0,1,0,1,0.14285714285714285,1,0.0,0,0,0,0,0,0,0,1,0,0,1,0
6757,63116,BvCRPlMfMau2kDEBEjyV1l6RJMQy5B5l,SpATywNh6bZuzm8s1ceuBUnMUAeoAHHw,27,51,18,50,0,4,19,1,143,20.428571428571427,3,0.0,20,18,46,0,31,4,4,19,1,84,59,0
6758,63119,HVSG66Eu1vmbossvKhmdJDOdo5jOHC1z,7GRhBDsirIGkRZBtSMEzNTyDr2JQm4xx,1,0,0,0,0,0,1,0,1,0.14285714285714285,1,0.0,0,0,0,0,0,0,0,1,0,0,1,1
6759,63126,8nlNDsWSaxHCvsMKtqhBs81sknEiTCeb,bWdj2GDclj5ofokWjzoa5jAwMkxCykd6,57,80,46,116,30,5,20,0,297,42.42857142857143,14,0.0,17,46,89,30,63,5,27,20,0,182,115,0
6760,63128,5uO2cAopKsWa3VCKCGDarnhTzdurYycs,SpATywNh6bZuzm8s1ceuBUnMUAeoAHHw,39,37,22,34,14,0,7,0,114,16.285714285714285,6,0.0,9,22,30,14,28,0,4,7,0,75,39,0
6761,63131,6soSIDwrJrHtOwhrrHwhMkHLJvUycuiD,SpATywNh6bZuzm8s1ceuBUnMUAeoAHHw,13,12,3,7,2,0,7,0,31,4.428571428571429,4,0.0,0,3,6,2,12,0,1,7,0,11,20,1
6762,63135,qqsKaxuXSxP1f8916mpMwrS7CvZrqfwm,bWdj2GDclj5ofokWjzoa5jAwMkxCykd6,6,6,0,0,0,0,2,0,8,1.1428571428571428,1,0.0,0,0,0,0,6,0,0,2,0,0,8,1
6763,63143,oE1QbspE1VaPia0G9CbmnflG7dN6cZJM,bWdj2GDclj5ofokWjzoa5jAwMkxCykd6,1,0,0,0,0,0,2,0,2,0.2857142857142857,2,0.0,0,0,0,0,0,0,0,2,0,0,2,1
6764,63144,Uf8FY0gZoVytp6K7SsDRXVZeOCL2hDEX,A3fsA9Zfv1X2fVEQhTw51lKENdNrEqT3,19,15,11,0,7,4,5,0,42,6.0,3,0.0,0,11,0,7,15,4,0,5,0,18,24,1
6765,63157,6iyCCTAEdDUFtgP0yXcCVROgqrKuAsJY,A3fsA9Zfv1X2fVEQhTw51lKENdNrEqT3,1,0,0,0,0,0,1,0,1,0.14285714285714285,1,0.0,0,0,0,0,0,0,0,1,0,0,1,1
6766,63158,U24ZSbLp0qd6U36m7tKLx7zFvStnoEpw,A3fsA9Zfv1X2fVEQhTw51lKENdNrEqT3,10,9,6,0,4,0,5,0,24,3.4285714285714284,2,0.0,0,6,0,4,9,0,0,5,0,10,14,1
6767,63159,u0QxgU6zGWMbarsYWmtzCygq7j38M60A,5X6FeZozNMgE2VRi3MJYjkkFK8SETtu2,8,4,3,0,2,0,6,0,15,2.142857142857143,1,0.0,0,3,0,2,4,0,0,6,0,5,10,1
6768,63165,lECqbqrkQ3HlfeNWRN0jqJEeRHxVUCOh,A3fsA9Zfv1X2fVEQhTw51lKENdNrEqT3,52,24,21,84,19,0,3,0,151,21.571428571428573,3,0.0,2,21,68,19,22,0,16,3,0,110,41,1
6769,63198,JUAvN6CchqwicZ9lfSkTbwue3bPu0qhC,7GRhBDsirIGkRZBtSMEzNTyDr2JQm4xx,28,76,37,6,36,1,8,2,166,23.714285714285715,2,0.0,25,37,6,36,51,1,0,8,2,104,62,0
6770,63215,TyFg3KPXG2hfujUtXeVIkYJiwq6NnB4U,A3fsA9Zfv1X2fVEQhTw51lKENdNrEqT3,2,0,0,0,0,0,2,0,2,0.2857142857142857,1,0.0,0,0,0,0,0,0,0,2,0,0,2,0
6771,63233,MvNnLQma2eBM9bCcMIR159XYSNp8VREs,A3fsA9Zfv1X2fVEQhTw51lKENdNrEqT3,89,49,35,230,23,44,18,0,399,57.0,9,0.0,4,35,184,23,45,44,46,18,0,246,153,0
6772,63255,7u0QfTKQg4itZK9m8foLXkIGwUxxHMsT,7GRhBDsirIGkRZBtSMEzNTyDr2JQm4xx,40,49,18,32,18,1,7,0,125,17.857142857142858,4,0.0,27,18,32,18,22,1,0,7,0,95,30,0
6773,63257,A1X8BnmDZU7GoDnOEZBjlNXiBeexxBQy,7GRhBDsirIGkRZBtSMEzNTyDr2JQm4xx,1,0,0,0,0,0,1,0,1,0.14285714285714285,1,0.0,0,0,0,0,0,0,0,1,0,0,1,1
6774,63296,qMFAmPw34z5IViYTtA1Kkpcn2uEg1WBM,7GRhBDsirIGkRZBtSMEzNTyDr2JQm4xx,1,0,0,0,0,0,2,0,2,0.2857142857142857,2,0.0,0,0,0,0,0,0,0,2,0,0,2,1
6775,63308,nvARqsoei1VE7ACdygyy6zqJeJH2Ns3d,5X6FeZozNMgE2VRi3MJYjkkFK8SETtu2,22,21,3,0,16,0,4,1,45,6.428571428571429,1,0.0,17,3,0,16,4,0,0,4,1,36,9,1
6776,63324,0qbWIMzrwjcZydLWs8mxTmhu7QXiYFSP,A3fsA9Zfv1X2fVEQhTw51lKENdNrEqT3,7,3,2,0,2,0,3,0,10,1.4285714285714286,1,0.0,0,2,0,2,3,0,0,3,0,4,6,1
6777,63328,BkozGGotFoRWvs7kivTQvwwV5JZ8hddc,A3fsA9Zfv1X2fVEQhTw51lKENdNrEqT3,8,9,2,0,2,0,2,0,15,2.142857142857143,2,0.0,0,2,0,2,9,0,0,2,0,4,11,0
6778,63344,pxvZPop6eUfNSRIk3XGIXLwhqmGee9n7,A3fsA9Zfv1X2fVEQhTw51lKENdNrEqT3,15,9,7,0,6,0,11,3,36,5.142857142857143,2,0.0,0,7,0,6,9,0,0,11,3,13,23,1
6779,63346,fOHPhMpeg8x93fPCuBnyT2XMX6wTKqV5,7GRhBDsirIGkRZBtSMEzNTyDr2JQm4xx,4,4,1,0,0,0,3,0,8,1.1428571428571428,1,0.0,0,1,0,0,4,0,0,3,0,1,7,1
6780,63384,oT95jnCrOomgCStV09kTjQxruOcKiBza,7GRhBDsirIGkRZBtSMEzNTyDr2JQm4xx,1,0,0,0,0,0,2,0,2,0.2857142857142857,2,0.0,0,0,0,0,0,0,0,2,0,0,2,1
6781,63415,BkWsoOcHNs2015z3Qrz6HVGKHPIIV4xg,7GRhBDsirIGkRZBtSMEzNTyDr2JQm4xx,1,0,0,0,0,0,1,0,1,0.14285714285714285,1,0.0,0,0,0,0,0,0,0,1,0,0,1,1
6782,63441,zga7Ud0Vk6NOYChIx78X5xKIKbxIADsx,7GRhBDsirIGkRZBtSMEzNTyDr2JQm4xx,2,0,0,0,0,0,2,0,2,0.2857142857142857,1,0.0,0,0,0,0,0,0,0,2,0,0,2,1
6783,63459,DbJ2fWeAP98RKGycV2m76nmSvYzZUwMu,A3fsA9Zfv1X2fVEQhTw51lKENdNrEqT3,1,0,0,0,0,0,1,0,1,0.14285714285714285,1,0.0,0,0,0,0,0,0,0,1,0,0,1,1
6784,63464,DIQ2cAHWjYXUFJyw27IkZyxU8J2LbFhM,A3fsA9Zfv1X2fVEQhTw51lKENdNrEqT3,7,3,2,0,2,0,4,0,11,1.5714285714285714,1,0.0,0,2,0,2,3,0,0,4,0,4,7,1
6785,63491,d5V0InJeymvV3tMA3RbiAnJILSNsmv66,A3fsA9Zfv1X2fVEQhTw51lKENdNrEqT3,7,3,1,0,1,1,6,0,12,1.7142857142857142,1,0.0,0,1,0,1,3,1,0,6,0,2,10,1
6786,63492,VbEvpztD3t9yxnslq9RFoJwCqkpqqcHm,A3fsA9Zfv1X2fVEQhTw51lKENdNrEqT3,2,0,0,0,0,0,2,0,2,0.2857142857142857,1,0.0,0,0,0,0,0,0,0,2,0,0,2,1
6787,63493,NRZzsjM7f5dJSFvndgYyTX54NocUI1PS,7GRhBDsirIGkRZBtSMEzNTyDr2JQm4xx,31,58,19,36,11,15,6,0,145,20.714285714285715,3,0.0,35,19,28,11,23,15,8,6,0,93,52,1
6788,63498,5P9Jg9PB0Bpdf0i8vhVF4X9FZYYuI2qy,7GRhBDsirIGkRZBtSMEzNTyDr2JQm4xx,8,4,4,0,3,0,5,0,16,2.2857142857142856,1,0.0,0,4,0,3,4,0,0,5,0,7,9,1
6789,63504,Bf025FfgNrlcqN8gYGnmBAhjBy0v5Xmo,7GRhBDsirIGkRZBtSMEzNTyDr2JQm4xx,7,8,4,0,2,0,1,0,15,2.142857142857143,1,0.0,0,4,0,2,8,0,0,1,0,6,9,1
6790,63534,XNb7KU6KeHuNJzclGX2ePynnmu8yxV3v,7GRhBDsirIGkRZBtSMEzNTyDr2JQm4xx,1,0,0,0,0,0,1,0,1,0.14285714285714285,1,0.0,0,0,0,0,0,0,0,1,0,0,1,1
6791,63541,kq2xSgp8UyUnYWtPUU1dLGJ6LLqx20W2,A3fsA9Zfv1X2fVEQhTw51lKENdNrEqT3,15,24,15,2,3,1,15,0,60,8.571428571428571,3,0.0,2,15,2,3,22,1,0,15,0,22,38,0
6792,63571,EwaALzeaojV7pPZOsHFx7jzB7xjVDGvQ,A3fsA9Zfv1X2fVEQhTw51lKENdNrEqT3,63,42,5,138,5,0,15,1,206,29.428571428571427,4,0.0,2,5,116,5,40,0,22,15,1,128,78,1
6793,63577,WofGn4IWpKZgx8XqCdK2PR8vwgQ2CXSv,7GRhBDsirIGkRZBtSMEzNTyDr2JQm4xx,4,2,1,0,1,0,1,0,5,0.7142857142857143,1,0.0,0,1,0,1,2,0,0,1,0,2,3,0
6794,63579,WaJ13sIQFvbAmwEOGfYhYy9jgF2vI8GT,A3fsA9Zfv1X2fVEQhTw51lKENdNrEqT3,8,6,3,0,1,0,6,1,17,2.4285714285714284,1,0.0,0,3,0,1,6,0,0,6,1,4,13,1
6795,63583,CLsYy7g1hYWHJyj1aROfKK9oTeo5yxJx,7GRhBDsirIGkRZBtSMEzNTyDr2JQm4xx,59,74,24,48,27,34,13,0,220,31.428571428571427,4,0.0,30,24,40,27,44,34,8,13,0,121,99,1
6796,63585,Hv22dFoxkFI4yq44orETwHESFuBEtOPQ,A3fsA9Zfv1X2fVEQhTw51lKENdNrEqT3,2,0,0,0,0,0,2,0,2,0.2857142857142857,1,0.0,0,0,0,0,0,0,0,2,0,0,2,1
6797,63591,qJUbI5BkvqMbHBHrzo94tR25I8rTeAje,A3fsA9Zfv1X2fVEQhTw51lKENdNrEqT3,2,0,0,0,0,0,5,0,5,0.7142857142857143,2,0.0,0,0,0,0,0,0,0,5,0,0,5,1
6798,63593,KNf8lqR4KQcQVf1nb3UW38BlYtlHOqrY,A3fsA9Zfv1X2fVEQhTw51lKENdNrEqT3,9,13,7,0,4,0,2,1,27,3.857142857142857,3,0.0,1,7,0,4,12,0,0,2,1,12,15,0
6799,63599,UOssUZDJcaoIiaAH8nTbzjrXIWUHSQSA,A3fsA9Zfv1X2fVEQhTw51lKENdNrEqT3,47,19,16,58,11,0,3,0,107,15.285714285714286,1,0.0,1,16,58,11,18,0,0,3,0,86,21,0
6800,63609,1tgzEFnyDV9hzcUXSbdwhJOg2vheOekT,A3fsA9Zfv1X2fVEQhTw51lKENdNrEqT3,5,3,1,0,1,0,2,0,7,1.0,1,0.0,0,1,0,1,3,0,0,2,0,2,5,1
6801,63635,YdulDnem4l1DSLhP0wDFvDj53pxIZEBX,5X6FeZozNMgE2VRi3MJYjkkFK8SETtu2,4,2,0,0,0,0,2,0,4,0.5714285714285714,1,0.0,0,0,0,0,2,0,0,2,0,0,4,1
6802,63644,abujBNmSyI9HYgtoO1EXyLGaW1rUTrMR,7GRhBDsirIGkRZBtSMEzNTyDr2JQm4xx,10,5,1,0,1,1,11,1,20,2.857142857142857,1,0.0,0,1,0,1,5,1,0,11,1,2,18,1
6803,63661,kNcE6GSdHEQgruLMOEFRn2X0xyKoI8Gk,A3fsA9Zfv1X2fVEQhTw51lKENdNrEqT3,8,3,2,0,2,1,3,1,12,1.7142857142857142,1,0.0,0,2,0,2,3,1,0,3,1,4,8,0
6804,63662,JFaXJp13wvkCeQQDDH7gpaTiCpXvjbvf,7GRhBDsirIGkRZBtSMEzNTyDr2JQm4xx,10,17,4,0,2,0,3,0,26,3.7142857142857144,1,0.0,3,4,0,2,14,0,0,3,0,9,17,1
6805,63710,Ga4lr67F0RIjyUetWH1EgQ3xzSHDnViF,7GRhBDsirIGkRZBtSMEzNTyDr2JQm4xx,13,10,5,13,4,0,3,0,35,5.0,2,0.0,2,5,12,4,8,0,1,3,0,23,12,1
6806,63713,DedOVhQ90meYxq6Misau3AEJ23SFBM8N,A3fsA9Zfv1X2fVEQhTw51lKENdNrEqT3,24,6,4,62,1,0,6,0,79,11.285714285714286,2,0.0,0,4,58,1,6,0,4,6,0,63,16,1
6807,63717,tEGUB4A2P1CFVrtUpVRZCuET3K7QndSr,A3fsA9Zfv1X2fVEQhTw51lKENdNrEqT3,6,2,1,0,1,0,3,0,7,1.0,1,0.0,0,1,0,1,2,0,0,3,0,2,5,1
6808,63719,RPsysYLHG9V8ibC4agPmUkz49odzJ61i,A3fsA9Zfv1X2fVEQhTw51lKENdNrEqT3,113,83,2,278,0,5,23,1,392,56.0,8,0.0,4,2,249,0,79,5,29,23,1,255,137,0
6809,63721,KXPsJNzb3MNK5rxQc94IXJdmXF0ziWwA,A3fsA9Zfv1X2fVEQhTw51lKENdNrEqT3,15,24,11,0,5,0,12,0,52,7.428571428571429,3,0.0,0,11,0,5,24,0,0,12,0,16,36,0
6810,63730,ZxSt3TZtQO3EpuEM7vETaMfS20LEVHky,7GRhBDsirIGkRZBtSMEzNTyDr2JQm4xx,1,0,0,0,0,0,1,0,1,0.14285714285714285,1,0.0,0,0,0,0,0,0,0,1,0,0,1,1
6811,63735,ECsVHkALFzk1X2uOxQI4vWaYz6Q2nfDW,A3fsA9Zfv1X2fVEQhTw51lKENdNrEqT3,1,0,0,0,0,0,1,0,1,0.14285714285714285,1,0.0,0,0,0,0,0,0,0,1,0,0,1,0
6812,63743,CQ7W1bUjrd2ieiBxuOygArXf04qfadoR,A3fsA9Zfv1X2fVEQhTw51lKENdNrEqT3,2,0,0,0,0,0,2,0,2,0.2857142857142857,1,0.0,0,0,0,0,0,0,0,2,0,0,2,1
6813,63750,0wm7bVyJC7jfhIoeylaV85sHOH5JOhtj,7GRhBDsirIGkRZBtSMEzNTyDr2JQm4xx,1,0,0,0,0,0,2,0,2,0.2857142857142857,2,0.0,0,0,0,0,0,0,0,2,0,0,2,1
6814,63766,2oTvbzieHn2y5oozeOgSnruqE6N0BtR5,A3fsA9Zfv1X2fVEQhTw51lKENdNrEqT3,15,10,7,0,5,6,2,0,30,4.285714285714286,1,0.0,1,7,0,5,9,6,0,2,0,13,17,1
6815,63800,pwyQw70rdHu06KaDwuJu2ks1YZiiVKHU,7GRhBDsirIGkRZBtSMEzNTyDr2JQm4xx,5,2,1,0,1,0,2,0,6,0.8571428571428571,1,0.0,0,1,0,1,2,0,0,2,0,2,4,1
6816,63863,cgTUwLEE5PIWea85qZ4m3A5o29rDp7wb,5X6FeZozNMgE2VRi3MJYjkkFK8SETtu2,6,0,0,0,0,1,5,1,7,1.0,1,0.0,0,0,0,0,0,1,0,5,1,0,7,1
6817,63866,T7jegaLU73gmMgJ6osvv16CDGIDooSd3,A3fsA9Zfv1X2fVEQhTw51lKENdNrEqT3,1,0,0,0,0,0,1,0,1,0.14285714285714285,1,0.0,0,0,0,0,0,0,0,1,0,0,1,1
6818,63868,5Dk7QJtqh7ATnN1jDaFE4dN4E1GugvAr,A3fsA9Zfv1X2fVEQhTw51lKENdNrEqT3,21,15,12,0,9,0,3,0,39,5.571428571428571,2,0.0,0,12,0,9,15,0,0,3,0,21,18,1
6819,63906,bBmyT6TanupXnnAek0TJ3b0HfJIXbuOY,A3fsA9Zfv1X2fVEQhTw51lKENdNrEqT3,2,0,0,0,0,0,4,0,4,0.5714285714285714,1,0.0,0,0,0,0,0,0,0,4,0,0,4,1
6820,63914,Yt9n1K8qzV8RLiOcWgNVrYW5xiZerljd,7GRhBDsirIGkRZBtSMEzNTyDr2JQm4xx,41,58,3,62,10,2,12,2,149,21.285714285714285,2,0.0,35,3,55,10,23,2,7,12,2,103,46,1
6821,63933,K9G4dlm9tLRMMK1kov6MCkkTMks8NOCf,7GRhBDsirIGkRZBtSMEzNTyDr2JQm4xx,1,0,0,0,0,0,1,0,1,0.14285714285714285,1,0.0,0,0,0,0,0,0,0,1,0,0,1,1
6822,63934,QXR5sUbv4S12yRWxM4AzFUAlm7Vhd4VU,7GRhBDsirIGkRZBtSMEzNTyDr2JQm4xx,2,0,0,0,0,0,2,0,2,0.2857142857142857,1,0.0,0,0,0,0,0,0,0,2,0,0,2,1
6823,63959,QZsedNDdPfnk94fBJk0YmSDWyLPfZv2T,A3fsA9Zfv1X2fVEQhTw51lKENdNrEqT3,1,0,0,0,0,0,1,0,1,0.14285714285714285,1,0.0,0,0,0,0,0,0,0,1,0,0,1,1
6824,63977,OVG8I98WuYVhtwF4PGQiRQJNGKoIW18s,7GRhBDsirIGkRZBtSMEzNTyDr2JQm4xx,9,5,3,0,3,0,2,0,13,1.8571428571428572,1,0.0,0,3,0,3,5,0,0,2,0,6,7,0
6825,63983,53qrF6M0dMx7kKnOiKvVv5yJevXuY3XD,5X6FeZozNMgE2VRi3MJYjkkFK8SETtu2,26,20,6,28,12,0,4,0,70,10.0,2,0.0,12,6,22,12,8,0,6,4,0,52,18,1
6826,63996,kaNpWuIxNLxZkDfmjMzrYRVzuOgwIf0o,7GRhBDsirIGkRZBtSMEzNTyDr2JQm4xx,1,0,0,0,0,0,1,0,1,0.14285714285714285,1,0.0,0,0,0,0,0,0,0,1,0,0,1,1
6827,64025,VmlXkvuP00sXBlaPmnRadtsHqWz5E4fz,7GRhBDsirIGkRZBtSMEzNTyDr2JQm4xx,137,696,152,246,76,77,52,0,1299,185.57142857142858,19,0.0,337,152,188,76,359,77,58,52,0,753,546,0
6828,64036,4dC723f2ZXGHBwWoh8xH8B5ftd5Zr0Rn,A3fsA9Zfv1X2fVEQhTw51lKENdNrEqT3,12,14,2,0,2,0,8,0,26,3.7142857142857144,6,0.0,0,2,0,2,14,0,0,8,0,4,22,1
6829,64050,i0zkZjQmNkaA9MaOL5qmrA42E822EXRd,A3fsA9Zfv1X2fVEQhTw51lKENdNrEqT3,9,16,8,0,4,0,4,0,32,4.571428571428571,1,0.0,2,8,0,4,14,0,0,4,0,14,18,1
6830,64095,RtFjOHQ78yo3bQ6aRAVmoLevb4Ve3GxB,A3fsA9Zfv1X2fVEQhTw51lKENdNrEqT3,1,0,0,0,0,0,1,0,1,0.14285714285714285,1,0.0,0,0,0,0,0,0,0,1,0,0,1,0
6831,64102,kt21fnWwjm6f9DEs5cQgmHF7wEsSCJjC,5X6FeZozNMgE2VRi3MJYjkkFK8SETtu2,4,2,0,0,0,0,3,0,5,0.7142857142857143,1,0.0,0,0,0,0,2,0,0,3,0,0,5,1
6832,64113,EVGpdajso7QxNR24Ui7ldtFyj6uWtpYs,7GRhBDsirIGkRZBtSMEzNTyDr2JQm4xx,39,66,16,67,15,0,5,0,169,24.142857142857142,3,0.0,30,16,59,15,36,0,8,5,0,120,49,1
6833,64116,sQpA2SuskRigo277vTUjZ4C84cF8DuDE,7GRhBDsirIGkRZBtSMEzNTyDr2JQm4xx,18,43,10,22,6,7,11,1,100,14.285714285714286,3,0.0,16,10,18,6,27,7,4,11,1,50,50,0
6834,64124,pseKOpRPBJlgz4ycJmBeuSlXa5DHSZxH,7GRhBDsirIGkRZBtSMEzNTyDr2JQm4xx,4,2,1,0,1,5,1,0,10,1.4285714285714286,1,0.0,0,1,0,1,2,5,0,1,0,2,8,1
6835,64130,8fEd87RyI2bwi77a0f1unb4dfVmT9VZV,5X6FeZozNMgE2VRi3MJYjkkFK8SETtu2,11,12,1,0,0,0,6,1,20,2.857142857142857,1,0.0,0,1,0,0,12,0,0,6,1,1,19,1
6836,64139,oKHRSMo3yDALM11wXRuypZuoIWmshJLG,7GRhBDsirIGkRZBtSMEzNTyDr2JQm4xx,2,0,0,0,0,0,2,0,2,0.2857142857142857,1,0.0,0,0,0,0,0,0,0,2,0,0,2,1
6837,64140,Kn2cw1zCeCwQaG81MHzo9gNVv9guOBXK,A3fsA9Zfv1X2fVEQhTw51lKENdNrEqT3,3,0,0,0,0,7,4,0,11,1.5714285714285714,1,0.0,0,0,0,0,0,7,0,4,0,0,11,1
6838,64142,as5VymGJtrKzsVSyPlhaHLjXcgFKhbSH,A3fsA9Zfv1X2fVEQhTw51lKENdNrEqT3,18,11,8,0,6,6,10,1,42,6.0,3,0.0,0,8,0,6,11,6,0,10,1,14,28,1
6839,64156,D1WRmyOZhQRwAt1t1iTB3PMrgAYapw75,A3fsA9Zfv1X2fVEQhTw51lKENdNrEqT3,7,3,2,0,2,0,2,0,9,1.2857142857142858,1,0.0,0,2,0,2,3,0,0,2,0,4,5,0
6840,64169,Z5Gd8RjsJSljoHUoBd3hvIVNy4VKuGq0,7GRhBDsirIGkRZBtSMEzNTyDr2JQm4xx,12,29,7,10,0,2,5,0,53,7.571428571428571,3,0.0,7,7,9,0,22,2,1,5,0,23,30,1
6841,64170,XPA1Jv5NXHfUcU7CMUA4EKvCqSxl1bO3,7GRhBDsirIGkRZBtSMEzNTyDr2JQm4xx,4,2,1,0,1,0,1,0,5,0.7142857142857143,1,0.0,0,1,0,1,2,0,0,1,0,2,3,1
6842,64176,5DIcniD9kRbDupVPBNugV5by0SZHtD2e,5X6FeZozNMgE2VRi3MJYjkkFK8SETtu2,2,0,0,0,0,0,6,0,6,0.8571428571428571,2,0.0,0,0,0,0,0,0,0,6,0,0,6,0
6843,64177,SSM7wEvdZo8FZW0zxJcXGwdA1S6Vbn5Q,A3fsA9Zfv1X2fVEQhTw51lKENdNrEqT3,37,27,21,0,16,0,5,0,69,9.857142857142858,4,0.0,0,21,0,16,27,0,0,5,0,37,32,1
6844,64181,dyoINQ9hlelfXhGgA7SokU45MaV6r2b8,A3fsA9Zfv1X2fVEQhTw51lKENdNrEqT3,2,0,0,0,0,0,2,0,2,0.2857142857142857,1,0.0,0,0,0,0,0,0,0,2,0,0,2,1
6845,64227,vG3M5JLO0gRotnItxOh8CvNNDagvaG8a,3VkHkmOtom3jM2wCu94xgzzu1d6Dn7or,1,0,0,0,0,0,1,0,1,0.14285714285714285,1,0.0,0,0,0,0,0,0,0,1,0,0,1,1
6846,64233,42YCKn2Ek3uQFTd64udo36R8aXuDsTjU,3VkHkmOtom3jM2wCu94xgzzu1d6Dn7or,11,6,4,0,3,0,23,1,37,5.285714285714286,2,0.0,0,4,0,3,6,0,0,23,1,7,30,1
6847,64245,GaqZRaDmjqTJL7sJbhIxHxwz67bGCYvi,3VkHkmOtom3jM2wCu94xgzzu1d6Dn7or,21,57,12,15,11,10,7,0,112,16.0,6,0.0,15,12,12,11,42,10,3,7,0,50,62,1
6848,64261,0k4CvTlW0Ki9TqpnhbL5aydIJGDeyaVi,3VkHkmOtom3jM2wCu94xgzzu1d6Dn7or,1,0,0,0,0,0,1,0,1,0.14285714285714285,1,0.0,0,0,0,0,0,0,0,1,0,0,1,1
6849,64282,5XeGbjtO9ZpHcMDPUljamexTzJj8TT7H,3VkHkmOtom3jM2wCu94xgzzu1d6Dn7or,7,11,2,0,2,0,3,0,18,2.5714285714285716,1,0.0,0,2,0,2,11,0,0,3,0,4,14,1
6850,64307,cYevHiCgyQphB5TqHdaxuD82gdFcsuo3,3VkHkmOtom3jM2wCu94xgzzu1d6Dn7or,9,12,4,0,2,2,11,1,32,4.571428571428571,1,0.0,3,4,0,2,9,2,0,11,1,9,23,1
6851,64312,n2St1YMqHrqzcJGG4eNYjjSajfpOnhDK,3VkHkmOtom3jM2wCu94xgzzu1d6Dn7or,1,0,0,0,0,0,1,0,1,0.14285714285714285,1,0.0,0,0,0,0,0,0,0,1,0,0,1,1
6852,64358,dqSfWCCLLdDoawrlG8LB6YtjPp851gTf,3VkHkmOtom3jM2wCu94xgzzu1d6Dn7or,60,74,36,9,32,2,14,0,167,23.857142857142858,9,0.0,20,36,9,32,54,2,0,14,0,97,70,1
6853,64367,uMq806nlQZ11Soe4JXPvVomaqEq8wpzS,3VkHkmOtom3jM2wCu94xgzzu1d6Dn7or,6,4,2,0,1,0,5,0,12,1.7142857142857142,1,0.0,0,2,0,1,4,0,0,5,0,3,9,1
6854,64410,TvGN18RRCa0ZkjqJAXD9aJ8uRfrq7SIN,3VkHkmOtom3jM2wCu94xgzzu1d6Dn7or,4,2,0,0,0,0,2,0,4,0.5714285714285714,1,0.0,0,0,0,0,2,0,0,2,0,0,4,1
6855,64438,mmsDJElioYpl5eQ7bq0CkG0zfpNNAZR1,3VkHkmOtom3jM2wCu94xgzzu1d6Dn7or,3,3,0,0,0,0,1,0,4,0.5714285714285714,1,0.0,0,0,0,0,3,0,0,1,0,0,4,1
6856,64471,O3F8lLfHLYapLPkEvSdAfSwSBCUUJfWK,3VkHkmOtom3jM2wCu94xgzzu1d6Dn7or,6,4,2,0,1,0,4,0,11,1.5714285714285714,2,0.0,0,2,0,1,4,0,0,4,0,3,8,1
6857,64518,CwmPG2drWGl9ALMZkxrKTV2gZqZEfFHE,3VkHkmOtom3jM2wCu94xgzzu1d6Dn7or,1,0,0,0,0,0,1,0,1,0.14285714285714285,1,0.0,0,0,0,0,0,0,0,1,0,0,1,1
6858,64533,xLuYLWXPTcFb9iRSrRAYjniXRvqBP99N,3VkHkmOtom3jM2wCu94xgzzu1d6Dn7or,1,0,0,0,0,0,1,0,1,0.14285714285714285,1,0.0,0,0,0,0,0,0,0,1,0,0,1,1
6859,64553,mokiIB7Q2Z6eHJ3DGx9f2taiL5liYirz,3VkHkmOtom3jM2wCu94xgzzu1d6Dn7or,81,351,36,89,44,3,64,0,587,83.85714285714286,12,0.0,141,36,80,44,210,3,9,64,0,301,286,0
6860,64560,61HPKOhG7Es91f38AHmMRZoNZFhDszNT,3VkHkmOtom3jM2wCu94xgzzu1d6Dn7or,1,0,0,0,0,0,1,0,1,0.14285714285714285,1,0.0,0,0,0,0,0,0,0,1,0,0,1,1
6861,64567,e6wP3becPmfG6HGdByUW00ZFxRLgAmgY,3VkHkmOtom3jM2wCu94xgzzu1d6Dn7or,3,3,1,0,0,0,2,0,6,0.8571428571428571,1,0.0,0,1,0,0,3,0,0,2,0,1,5,1
6862,64584,QQOQ1mBFT0hbDG4vhxUnw8WQ7hq3XsN0,3VkHkmOtom3jM2wCu94xgzzu1d6Dn7or,10,7,3,0,2,0,5,0,17,2.4285714285714284,3,0.0,0,3,0,2,7,0,0,5,0,5,12,1
6863,64602,BOKQK9bANog8js8ZS6fczS1c2Qck04bm,3VkHkmOtom3jM2wCu94xgzzu1d6Dn7or,2,0,0,0,0,0,2,0,2,0.2857142857142857,1,0.0,0,0,0,0,0,0,0,2,0,0,2,1
6864,64603,qvYnUocR0frsPd3kYwxIbvUGNPr9n1qt,3VkHkmOtom3jM2wCu94xgzzu1d6Dn7or,5,4,1,0,0,0,3,0,8,1.1428571428571428,1,0.0,0,1,0,0,4,0,0,3,0,1,7,1
6865,64615,qKB2XQNbRVqqDMhQPlQh48h20NofWfSV,3VkHkmOtom3jM2wCu94xgzzu1d6Dn7or,1,0,0,0,0,0,1,0,1,0.14285714285714285,1,0.0,0,0,0,0,0,0,0,1,0,0,1,1
6866,64650,gAgemCzJGmixMig6mQD6NWFEvbJXhb78,3VkHkmOtom3jM2wCu94xgzzu1d6Dn7or,68,277,87,62,88,2,33,1,550,78.57142857142857,13,0.0,145,87,58,88,132,2,4,33,1,378,172,0
6867,64662,rEshrXNp0EMe0kgk6a6QvKN0GvvqP09g,3VkHkmOtom3jM2wCu94xgzzu1d6Dn7or,2,0,0,0,0,0,2,0,2,0.2857142857142857,1,0.0,0,0,0,0,0,0,0,2,0,0,2,1
6868,64674,vGQAID39BKk1FvQYReBWX247x3QlYrgz,3VkHkmOtom3jM2wCu94xgzzu1d6Dn7or,62,199,76,99,51,47,28,9,509,72.71428571428571,13,0.0,69,76,95,51,130,47,4,28,9,291,218,0
6869,64713,k0z6RGGewAn8TOLu7gTAfbvZpKAlaO9s,3VkHkmOtom3jM2wCu94xgzzu1d6Dn7or,8,6,3,0,2,0,10,0,21,3.0,2,0.0,0,3,0,2,6,0,0,10,0,5,16,1
6870,64731,v7V5lxZod154cnKdaWzRncJReivDoCGm,3VkHkmOtom3jM2wCu94xgzzu1d6Dn7or,1,0,0,0,0,0,1,0,1,0.14285714285714285,1,0.0,0,0,0,0,0,0,0,1,0,0,1,1
6871,64749,NZrJhxLLoF5Z5OBot3OZHMpZISE3ex3z,3VkHkmOtom3jM2wCu94xgzzu1d6Dn7or,70,118,43,62,57,10,13,3,306,43.714285714285715,6,0.0,62,43,60,57,56,10,2,13,3,222,84,0
6872,64753,shRLUNza7ToIRumUukwmCPdAakP1Z4MR,3VkHkmOtom3jM2wCu94xgzzu1d6Dn7or,8,2,1,0,1,0,6,2,12,1.7142857142857142,2,0.0,0,1,0,1,2,0,0,6,2,2,10,1
6873,64772,c2xUxg7vuhPItQZr96ojei2FNm4xg1X0,3VkHkmOtom3jM2wCu94xgzzu1d6Dn7or,96,202,69,83,74,9,26,6,469,67.0,10,0.0,107,69,79,74,95,9,4,26,6,329,140,0
6874,64784,XYyEyYkiXbQAB5EYzyXMuE8giVn3YEv6,3VkHkmOtom3jM2wCu94xgzzu1d6Dn7or,7,2,2,0,2,0,13,4,23,3.2857142857142856,1,0.0,0,2,0,2,2,0,0,13,4,4,19,0
6875,64812,itxkUZlleVt8P8yDd0VbJBHxtmvlnPtZ,3VkHkmOtom3jM2wCu94xgzzu1d6Dn7or,1,0,0,0,0,0,1,0,1,0.14285714285714285,1,0.0,0,0,0,0,0,0,0,1,0,0,1,1
6876,64827,HUcV9f0KlUI5fr3swBcOW4ndqldbTUfQ,3VkHkmOtom3jM2wCu94xgzzu1d6Dn7or,43,138,50,31,44,1,12,1,277,39.57142857142857,5,0.0,71,50,30,44,67,1,1,12,1,195,82,0
6877,64855,uXENfpJ5grhp1Qr3FBnsuSG3ncYtxO8a,3VkHkmOtom3jM2wCu94xgzzu1d6Dn7or,1,0,0,0,0,0,1,0,1,0.14285714285714285,1,0.0,0,0,0,0,0,0,0,1,0,0,1,1
6878,64859,ZbKU5GVgsZZvDM1IUG4qrpiO477YibB6,3VkHkmOtom3jM2wCu94xgzzu1d6Dn7or,4,2,1,0,1,0,1,0,5,0.7142857142857143,1,0.0,0,1,0,1,2,0,0,1,0,2,3,1
6879,64861,CyxMdLdauH0yjNBg0n7X7c0tmTOyOQoH,3VkHkmOtom3jM2wCu94xgzzu1d6Dn7or,1,0,0,0,0,0,1,0,1,0.14285714285714285,1,0.0,0,0,0,0,0,0,0,1,0,0,1,1
6880,65687,FOKF27675cifNbJRDl4981DQvPoTqlyq,5X6FeZozNMgE2VRi3MJYjkkFK8SETtu2,1,0,0,0,0,0,1,0,1,0.14285714285714285,1,0.0,0,0,0,0,0,0,0,1,0,0,1,1
6881,65688,EP1XQRGS4HZOG1hdGzNZdD1HFhJcHpos,7GRhBDsirIGkRZBtSMEzNTyDr2JQm4xx,1,0,0,0,0,0,1,0,1,0.14285714285714285,1,0.0,0,0,0,0,0,0,0,1,0,0,1,1
6882,65705,0PYlPo8KoOqdfXLmHxHfVVjmiH634i57,5X6FeZozNMgE2VRi3MJYjkkFK8SETtu2,50,32,27,0,26,0,2,0,87,12.428571428571429,1,0.0,2,27,0,26,30,0,0,2,0,55,32,1
6883,65717,Qp3BNNi2PRh8N3k7qOPk9z3KeApis9gf,7GRhBDsirIGkRZBtSMEzNTyDr2JQm4xx,8,2,1,0,1,2,5,0,11,1.5714285714285714,1,0.0,0,1,0,1,2,2,0,5,0,2,9,1
6884,65731,rsQSljy58PFsI3No6cbIG6iDQtqQAtCs,7GRhBDsirIGkRZBtSMEzNTyDr2JQm4xx,1,0,0,0,0,0,1,0,1,0.14285714285714285,1,0.0,0,0,0,0,0,0,0,1,0,0,1,1
6885,65732,PWsIUDujlx4s1VHM6RAyjgvMb6HCslXd,5X6FeZozNMgE2VRi3MJYjkkFK8SETtu2,5,2,1,0,1,0,2,0,6,0.8571428571428571,1,0.0,0,1,0,1,2,0,0,2,0,2,4,1
6886,65766,RPnWL5ddEAqNC9HzON3z0LuIcVuEKZPT,5X6FeZozNMgE2VRi3MJYjkkFK8SETtu2,1,0,0,0,0,0,3,0,3,0.42857142857142855,3,0.0,0,0,0,0,0,0,0,3,0,0,3,1
6887,65788,aszS4GIQTgIfNXx5jr5Ct6AzWRVtVT5s,7GRhBDsirIGkRZBtSMEzNTyDr2JQm4xx,107,207,53,161,70,1,2,0,494,70.57142857142857,14,0.0,125,53,134,70,82,1,27,2,0,382,112,1
6888,65790,ee5z0tJLP6Khk8QhqHWb5RZbzlS7e0OS,7GRhBDsirIGkRZBtSMEzNTyDr2JQm4xx,1,0,0,0,0,0,1,0,1,0.14285714285714285,1,0.0,0,0,0,0,0,0,0,1,0,0,1,1
6889,65794,ee5z0tJLP6Khk8QhqHWb5RZbzlS7e0OS,5X6FeZozNMgE2VRi3MJYjkkFK8SETtu2,1,0,0,0,0,0,1,0,1,0.14285714285714285,1,0.0,0,0,0,0,0,0,0,1,0,0,1,1
6890,65802,60AdiK8bE6l0acvscYCimI00NJzONtxh,7GRhBDsirIGkRZBtSMEzNTyDr2JQm4xx,18,17,1,4,1,0,5,1,29,4.142857142857143,2,0.0,2,1,2,1,15,0,2,5,1,6,23,1
6891,65812,h0zdkMb61woGfNMOXfs3Ua8AU5wIq6lQ,7GRhBDsirIGkRZBtSMEzNTyDr2JQm4xx,1,0,0,0,0,0,1,0,1,0.14285714285714285,1,0.0,0,0,0,0,0,0,0,1,0,0,1,1
6892,65830,MolmRPAkFPlZY7OScpgwiUUkM3K4fMlt,7GRhBDsirIGkRZBtSMEzNTyDr2JQm4xx,28,57,26,18,20,3,12,0,136,19.428571428571427,4,0.0,20,26,13,20,37,3,5,12,0,79,57,0
6893,65860,FWTjpNOuI4RsBkDu0yW01kwOX7KPfCTS,5X6FeZozNMgE2VRi3MJYjkkFK8SETtu2,1,0,0,0,0,0,1,0,1,0.14285714285714285,1,0.0,0,0,0,0,0,0,0,1,0,0,1,1
6894,65865,GR3SserD0hZUoJkJpGFDq48sIZDvaFeW,7GRhBDsirIGkRZBtSMEzNTyDr2JQm4xx,8,7,0,2,1,0,4,0,14,2.0,2,0.0,3,0,1,1,4,0,1,4,0,5,9,1
6895,65875,FIYIY0le6IgAtT64SQdOQ9wlHEZCwQOO,5X6FeZozNMgE2VRi3MJYjkkFK8SETtu2,73,119,2,79,17,7,22,1,247,35.285714285714285,6,0.0,65,2,71,17,54,7,8,22,1,155,92,1
6896,65898,eiLcveXPgb7IWmxyYugGtGV92SFN2oTV,5X6FeZozNMgE2VRi3MJYjkkFK8SETtu2,90,139,0,137,39,0,9,0,324,46.285714285714285,6,0.0,90,0,114,39,49,0,23,9,0,243,81,0
6897,65923,RoVG0kiFP0OBGlNfg8NpT0lrHhQWFVjU,7GRhBDsirIGkRZBtSMEzNTyDr2JQm4xx,51,63,27,70,34,1,5,0,200,28.571428571428573,2,0.0,35,27,54,34,28,1,16,5,0,150,50,1
6898,65927,HduQY3IOfXhSoooBb9r0J73pVo2wwi5W,5X6FeZozNMgE2VRi3MJYjkkFK8SETtu2,11,8,5,0,3,0,5,1,22,3.142857142857143,1,0.0,0,5,0,3,8,0,0,5,1,8,14,1
6899,65929,trlHigiDuElPZHAcTtKxGjwa3iTdimGy,5X6FeZozNMgE2VRi3MJYjkkFK8SETtu2,2,0,0,0,0,0,2,0,2,0.2857142857142857,1,0.0,0,0,0,0,0,0,0,2,0,0,2,1
6900,65944,IPs8z12Ih1D0cstuKylzJa6KPypnLd8o,5X6FeZozNMgE2VRi3MJYjkkFK8SETtu2,6,4,1,0,0,0,3,0,8,1.1428571428571428,1,0.0,0,1,0,0,4,0,0,3,0,1,7,1
6901,65973,aIukhaeMXO0Xpo45YRTaW0ARdMHoLnbr,7GRhBDsirIGkRZBtSMEzNTyDr2JQm4xx,7,2,1,0,1,4,4,1,13,1.8571428571428572,1,0.0,0,1,0,1,2,4,0,4,1,2,11,1
6902,65976,4Le8TpGtOuf2E9j40zmI7yYIE8EBcwun,5X6FeZozNMgE2VRi3MJYjkkFK8SETtu2,10,12,4,0,2,0,2,0,20,2.857142857142857,2,0.0,2,4,0,2,10,0,0,2,0,8,12,1
6903,66546,DTbJ7KB3uMFcpk8W3n4kvUeKqSYyolkW,SpATywNh6bZuzm8s1ceuBUnMUAeoAHHw,17,39,6,18,2,1,15,0,81,11.571428571428571,4,0.0,19,6,15,2,20,1,3,15,0,42,39,1
6904,66551,fkrSqTHnPEweVdPiAW6RgeMJZWZWaXQt,G8EPVSXsOYB5YQWZGiz1aVq5Pgr2GrQu,87,70,21,201,15,22,26,2,357,51.0,5,0.0,46,21,149,15,24,22,52,26,2,231,126,0
6905,66555,fdzq5tofwv4sAm3YqrsC6AMOnGl1oPA0,RXDvfPUBYFlVdlueBFbLW0mhhAyGEqpt,3,0,0,0,0,5,2,0,7,1.0,2,0.0,0,0,0,0,0,5,0,2,0,0,7,1
6906,66558,z6Xzy59qUrOr9kg6qBkR4Bly4uQ6Qoy2,SpATywNh6bZuzm8s1ceuBUnMUAeoAHHw,23,52,22,23,9,11,28,4,149,21.285714285714285,7,0.0,12,22,19,9,40,11,4,28,4,62,87,1
6907,66563,rMO5SCPyMgH89I8wk1aP5Tz4xRCn17BB,SpATywNh6bZuzm8s1ceuBUnMUAeoAHHw,6,5,2,0,2,0,1,0,10,1.4285714285714286,1,0.0,0,2,0,2,5,0,0,1,0,4,6,1
6908,66564,pzsUx69X9Xid85hyecE8y9Ou9VDtnPhb,SpATywNh6bZuzm8s1ceuBUnMUAeoAHHw,1,0,0,0,0,0,1,0,1,0.14285714285714285,1,0.0,0,0,0,0,0,0,0,1,0,0,1,1
6909,66569,2daUzJgefGOj5dfl9u5sPO7QTYuS1O1e,SpATywNh6bZuzm8s1ceuBUnMUAeoAHHw,4,2,1,0,0,0,2,0,5,0.7142857142857143,1,0.0,0,1,0,0,2,0,0,2,0,1,4,1
6910,66570,MpNfjrXai4aLf7BfVSQwZSS0DPolU3oZ,RXDvfPUBYFlVdlueBFbLW0mhhAyGEqpt,51,69,41,69,24,0,15,2,220,31.428571428571427,7,0.0,14,41,66,24,55,0,3,15,2,145,75,0
6911,66571,2jofclRKNdmEGIMZjR1X3xlqQjjV6yF4,SpATywNh6bZuzm8s1ceuBUnMUAeoAHHw,23,37,17,29,8,6,19,1,117,16.714285714285715,4,0.0,9,17,22,8,28,6,7,19,1,56,61,0
6912,66577,s9OHCOR537Yr2UKR6DSCnB7grKBa5GVW,SpATywNh6bZuzm8s1ceuBUnMUAeoAHHw,5,2,1,0,1,0,2,0,6,0.8571428571428571,1,0.0,0,1,0,1,2,0,0,2,0,2,4,1
6913,66579,bDdEUq0MJvGkx68ulN38uXa8x4Oc6Mqn,SpATywNh6bZuzm8s1ceuBUnMUAeoAHHw,17,18,6,20,4,0,9,1,58,8.285714285714286,1,0.0,5,6,16,4,13,0,4,9,1,31,27,1
6914,66581,thNNhxxCA11oJLPqP35etO0M0nOY00HM,G8EPVSXsOYB5YQWZGiz1aVq5Pgr2GrQu,33,62,30,60,19,0,5,0,176,25.142857142857142,3,0.0,27,30,50,19,35,0,10,5,0,126,50,1
6915,66586,F2b4wQkSXPvl6LtgZJlfZ4TcFXgwDGKe,SpATywNh6bZuzm8s1ceuBUnMUAeoAHHw,7,4,3,0,3,0,2,0,12,1.7142857142857142,1,0.0,0,3,0,3,4,0,0,2,0,6,6,1
6916,66592,7mVgrKQULKrxGxLEFeqEhI8vLoHAKVjH,SpATywNh6bZuzm8s1ceuBUnMUAeoAHHw,5,2,1,0,1,0,2,0,6,0.8571428571428571,1,0.0,0,1,0,1,2,0,0,2,0,2,4,1
6917,66594,Jkvg2vrMG0bsI6gC4CJJwz6mYReBwqyD,bWdj2GDclj5ofokWjzoa5jAwMkxCykd6,18,34,17,8,7,0,25,2,93,13.285714285714286,5,0.0,2,17,8,7,32,0,0,25,2,34,59,1
6918,66599,FrnZkjOLuaGZ96dbbyAebpl6VdyOmBDE,RXDvfPUBYFlVdlueBFbLW0mhhAyGEqpt,6,2,1,0,1,0,4,0,8,1.1428571428571428,2,0.0,0,1,0,1,2,0,0,4,0,2,6,1
6919,66603,2zQQnqY1LiZ9lcEXTzcE3zimEdKe8CdV,G8EPVSXsOYB5YQWZGiz1aVq5Pgr2GrQu,28,25,12,62,8,0,5,0,112,16.0,3,0.0,12,12,51,8,13,0,11,5,0,83,29,1
6920,66606,yceNLUK4FCR6SZUYW0W0TAVYCfKl5jP6,SpATywNh6bZuzm8s1ceuBUnMUAeoAHHw,18,30,0,29,0,10,16,1,86,12.285714285714286,3,0.0,4,0,27,0,26,10,2,16,1,31,55,1
6921,66607,nvX3zuXPoMSUhlRzwAoQtF8bA4zlkXZY,G8EPVSXsOYB5YQWZGiz1aVq5Pgr2GrQu,21,40,31,20,2,20,32,3,148,21.142857142857142,3,0.0,0,31,18,2,40,20,2,32,3,51,97,1
6922,66614,RxKdUoY8VjcWLXSrUuB2O5rajs7dKtPo,SpATywNh6bZuzm8s1ceuBUnMUAeoAHHw,9,10,4,0,3,1,4,0,22,3.142857142857143,1,0.0,3,4,0,3,7,1,0,4,0,10,12,1
6923,66620,YSRj2LyghpGgbkTJyCc5CeAD7nnieGEa,SpATywNh6bZuzm8s1ceuBUnMUAeoAHHw,7,9,1,0,1,0,2,0,13,1.8571428571428572,1,0.0,0,1,0,1,9,0,0,2,0,2,11,1
6924,66622,3BM8P16Xlf6mH29LptGI3X2aHEFZEk4O,SpATywNh6bZuzm8s1ceuBUnMUAeoAHHw,11,10,6,0,3,8,12,2,41,5.857142857142857,2,0.0,0,6,0,3,10,8,0,12,2,9,32,1
6925,66625,WSyXGkhm7NDepRlMA3agJj8k8GLnavsP,bWdj2GDclj5ofokWjzoa5jAwMkxCykd6,5,2,1,0,1,0,2,0,6,0.8571428571428571,1,0.0,0,1,0,1,2,0,0,2,0,2,4,1
6926,66633,tuzr7UEFeueCuu7trKtH12YoCRZa4u3J,SpATywNh6bZuzm8s1ceuBUnMUAeoAHHw,35,79,34,19,15,101,28,2,278,39.714285714285715,8,0.0,16,34,17,15,63,101,2,28,2,82,196,1
6927,66642,7i6uHx2i3AcAV22o4Aq16TZJzUL7SbJ8,SpATywNh6bZuzm8s1ceuBUnMUAeoAHHw,20,32,9,19,4,9,14,4,91,13.0,4,0.0,9,9,16,4,23,9,3,14,4,38,53,0
6928,66643,YpwPSpfFUdYNa3VjazLGMwZAAiqtZEgp,SpATywNh6bZuzm8s1ceuBUnMUAeoAHHw,1,0,0,0,0,0,1,0,1,0.14285714285714285,1,0.0,0,0,0,0,0,0,0,1,0,0,1,1
6929,66648,Z5eVqB1AyrDAwIaFYca0z5tjEfS46LEV,SpATywNh6bZuzm8s1ceuBUnMUAeoAHHw,6,2,1,0,0,0,4,0,7,1.0,1,0.0,0,1,0,0,2,0,0,4,0,1,6,1
6930,66649,Gmz5iMjiwcyTx4KusyWM0rOecmUutZaf,RXDvfPUBYFlVdlueBFbLW0mhhAyGEqpt,119,303,180,299,109,54,65,20,1030,147.14285714285714,13,0.0,78,180,280,109,225,54,19,65,20,647,383,0
6931,66661,uPc8X6Bm31kSZXvsGiF4cJMs1CphJwNI,RXDvfPUBYFlVdlueBFbLW0mhhAyGEqpt,7,4,3,0,1,0,2,0,10,1.4285714285714286,1,0.0,0,3,0,1,4,0,0,2,0,4,6,1
6932,66666,4QSKoi2COLIjISXuWMSgkhYU8OcqVVuy,SpATywNh6bZuzm8s1ceuBUnMUAeoAHHw,10,12,4,0,3,0,2,0,21,3.0,1,0.0,4,4,0,3,8,0,0,2,0,11,10,1
6933,66667,emzkGgKaVLaDWCW4bOLMsgyMV9eX3Ume,G8EPVSXsOYB5YQWZGiz1aVq5Pgr2GrQu,29,33,13,62,3,6,11,1,129,18.428571428571427,2,0.0,13,13,44,3,20,6,18,11,1,73,56,0
6934,66668,VKxATUtWUHvLpvjNhrujhWYm5cDOeljR,SpATywNh6bZuzm8s1ceuBUnMUAeoAHHw,3,3,0,0,0,0,1,0,4,0.5714285714285714,2,0.0,0,0,0,0,3,0,0,1,0,0,4,1
6935,66673,jdTzrZz0SYzgENOxdTEUzOnYtapHefGQ,SpATywNh6bZuzm8s1ceuBUnMUAeoAHHw,3,2,0,0,0,0,1,0,3,0.42857142857142855,1,0.0,0,0,0,0,2,0,0,1,0,0,3,1
6936,66686,N1N2VoCQ3DCM7YknWLib5UEHyI2wyiAp,SpATywNh6bZuzm8s1ceuBUnMUAeoAHHw,12,10,3,25,2,0,6,0,46,6.571428571428571,2,0.0,4,3,20,2,6,0,5,6,0,29,17,1
6937,66687,Lb2uKLbwD8GvR2CPQEYJA4oaJUHHccBI,G8EPVSXsOYB5YQWZGiz1aVq5Pgr2GrQu,9,9,0,0,0,0,4,0,13,1.8571428571428572,1,0.0,0,0,0,0,9,0,0,4,0,0,13,1
6938,66692,X2YAK6wLAh05M8slR10ibCM34PqZNEYp,G8EPVSXsOYB5YQWZGiz1aVq5Pgr2GrQu,21,24,2,24,1,1,4,0,56,8.0,2,0.0,1,2,19,1,23,1,5,4,0,23,33,1
6939,66693,Q0GCy8RLg4XnQiHX0oDTDootKu46YmWa,SpATywNh6bZuzm8s1ceuBUnMUAeoAHHw,4,2,0,0,0,0,2,0,4,0.5714285714285714,1,0.0,0,0,0,0,2,0,0,2,0,0,4,1
6940,66694,ZnCJUx9hjBAhb4k6sSnSHXC3G4doeeAn,SpATywNh6bZuzm8s1ceuBUnMUAeoAHHw,12,17,8,0,4,10,6,1,46,6.571428571428571,1,0.0,6,8,0,4,11,10,0,6,1,18,28,1
6941,66699,vYjevNGSZuPL0Me7nQ7eB69nuvnbZiuq,SpATywNh6bZuzm8s1ceuBUnMUAeoAHHw,13,17,0,16,0,0,6,1,40,5.714285714285714,3,0.0,8,0,14,0,9,0,2,6,1,22,18,1
6942,66700,xLfQrz0Mm3ryvcwRcTyZdkwlshtwNJHB,RXDvfPUBYFlVdlueBFbLW0mhhAyGEqpt,5,2,1,0,1,0,2,0,6,0.8571428571428571,1,0.0,0,1,0,1,2,0,0,2,0,2,4,1
6943,66708,bPMM8JJVMbo3dHwzrkYwNanOXVlVjIZM,bWdj2GDclj5ofokWjzoa5jAwMkxCykd6,6,2,1,0,1,0,3,0,7,1.0,1,0.0,0,1,0,1,2,0,0,3,0,2,5,1
6944,66710,fUNdgzfWSE4HzsYQQ7FDu5pyDUIMQ40m,bWdj2GDclj5ofokWjzoa5jAwMkxCykd6,1,0,0,0,0,0,1,0,1,0.14285714285714285,1,0.0,0,0,0,0,0,0,0,1,0,0,1,1
6945,66712,Ksg32KcGSJwlEbdLbDafCAI8P52qq3MX,SpATywNh6bZuzm8s1ceuBUnMUAeoAHHw,5,2,1,0,0,0,3,0,6,0.8571428571428571,1,0.0,0,1,0,0,2,0,0,3,0,1,5,1
6946,66716,m8pWjgRGGqizCnvKfqrgJiRn5L3s4aMf,SpATywNh6bZuzm8s1ceuBUnMUAeoAHHw,10,6,4,0,3,0,4,1,18,2.5714285714285716,1,0.0,1,4,0,3,5,0,0,4,1,8,10,1
6947,66717,PI4R0HcIedaRtD4i4AnoySGCINPF9uFD,SpATywNh6bZuzm8s1ceuBUnMUAeoAHHw,15,16,7,15,3,0,6,0,47,6.714285714285714,2,0.0,4,7,12,3,12,0,3,6,0,26,21,1
6948,66722,dwydM4WZn1EE9lbFO8uBMhGMVscnDmyy,G8EPVSXsOYB5YQWZGiz1aVq5Pgr2GrQu,18,26,15,2,10,18,11,1,83,11.857142857142858,2,0.0,5,15,1,10,21,18,1,11,1,31,52,0
6949,66723,o4fNZaSYX3UHutrkuKOAdzPPx4q40e5R,SpATywNh6bZuzm8s1ceuBUnMUAeoAHHw,17,31,13,6,7,14,8,1,80,11.428571428571429,3,0.0,2,13,6,7,29,14,0,8,1,28,52,1
6950,66724,cWGbfR2Lw2D62YH4zDUtSEtnjy8NlUpm,SpATywNh6bZuzm8s1ceuBUnMUAeoAHHw,28,44,13,27,9,1,16,1,111,15.857142857142858,5,0.0,14,13,22,9,30,1,5,16,1,58,53,1
6951,66727,1F8QRhMnvAcX05zajUIEw9khHJe9qgvr,SpATywNh6bZuzm8s1ceuBUnMUAeoAHHw,2,2,0,0,0,0,2,0,4,0.5714285714285714,1,0.0,0,0,0,0,2,0,0,2,0,0,4,1
6952,66729,YG3IIEQOezPClODg4SNvtFayndWcEJ7a,bWdj2GDclj5ofokWjzoa5jAwMkxCykd6,10,18,7,0,7,1,4,0,37,5.285714285714286,2,0.0,7,7,0,7,11,1,0,4,0,21,16,1
6953,66731,Sz4iN9vM7plSJObu2Kgng7aJijtNNsts,bWdj2GDclj5ofokWjzoa5jAwMkxCykd6,10,11,0,14,3,8,3,0,39,5.571428571428571,1,0.0,5,0,13,3,6,8,1,3,0,21,18,1
6954,66734,NMCQVQ1Cg6MS9ushYbZMMzLoDclKVOyZ,SpATywNh6bZuzm8s1ceuBUnMUAeoAHHw,9,13,5,0,1,2,10,0,31,4.428571428571429,1,0.0,0,5,0,1,13,2,0,10,0,6,25,1
6955,66735,BF8BUQGTWJSC3An0NoOdiFsCvGqN90lp,SpATywNh6bZuzm8s1ceuBUnMUAeoAHHw,10,16,6,0,4,0,3,0,29,4.142857142857143,3,0.0,0,6,0,4,16,0,0,3,0,10,19,1
6956,66739,ggntZRuHqDckUtFC9TYtfF8K09iXYWES,G8EPVSXsOYB5YQWZGiz1aVq5Pgr2GrQu,12,11,2,26,2,2,3,0,46,6.571428571428571,2,0.0,6,2,20,2,5,2,6,3,0,30,16,1
6957,66743,ilB3zN3UyBwxCz4uXPqvzE0bs5QUbmk2,SpATywNh6bZuzm8s1ceuBUnMUAeoAHHw,6,12,0,0,0,0,4,0,16,2.2857142857142856,3,0.0,0,0,0,0,12,0,0,4,0,0,16,1
6958,66746,S5gDAq7XL2B348BbNrSZrsxK2ihjbqjX,bWdj2GDclj5ofokWjzoa5jAwMkxCykd6,4,2,0,0,0,2,10,0,14,2.0,2,0.0,0,0,0,0,2,2,0,10,0,0,14,1
6959,66748,IGtuwcXa7Vvuptxp2yP0y7DMlNgXBbkF,SpATywNh6bZuzm8s1ceuBUnMUAeoAHHw,17,19,11,6,0,12,6,0,54,7.714285714285714,3,0.0,5,11,6,0,14,12,0,6,0,22,32,1
6960,66752,qdU5OfBLhmAdLS2yu5kAr5MPjmjgxaEx,SpATywNh6bZuzm8s1ceuBUnMUAeoAHHw,9,9,4,0,4,0,2,0,19,2.7142857142857144,1,0.0,0,4,0,4,9,0,0,2,0,8,11,1
6961,66759,IFoWLGmc3yYo3jvZy7brYExecFieUsPa,SpATywNh6bZuzm8s1ceuBUnMUAeoAHHw,17,18,7,21,4,3,6,1,60,8.571428571428571,2,0.0,9,7,18,4,9,3,3,6,1,38,22,1
6962,66761,jZW7RSw8d3NHdCMzGR4TAiNXCrcYo90E,SpATywNh6bZuzm8s1ceuBUnMUAeoAHHw,22,24,8,41,4,12,13,1,103,14.714285714285714,2,0.0,14,8,37,4,10,12,4,13,1,63,40,0
6963,66763,3LiDRA4eEhNTPRwhkLOl4Xef83bJtvN6,SpATywNh6bZuzm8s1ceuBUnMUAeoAHHw,16,12,5,14,3,0,7,0,41,5.857142857142857,1,0.0,2,5,13,3,10,0,1,7,0,23,18,1
6964,66767,hphlDgjkqVbyJnFgMbu9WAMmL2wONlSy,SpATywNh6bZuzm8s1ceuBUnMUAeoAHHw,13,20,0,28,2,4,6,1,61,8.714285714285714,1,0.0,14,0,21,2,6,4,7,6,1,37,24,0
6965,66769,j8UeSZFNUzzfzk2DFBytx4Rkr6FApV94,SpATywNh6bZuzm8s1ceuBUnMUAeoAHHw,4,4,3,0,0,0,1,0,8,1.1428571428571428,1,0.0,0,3,0,0,4,0,0,1,0,3,5,1
6966,66771,DSoedfH3iEqkDSoEfnR9hPK9fGA03nvE,SpATywNh6bZuzm8s1ceuBUnMUAeoAHHw,8,6,4,0,3,3,3,0,19,2.7142857142857144,2,0.0,0,4,0,3,6,3,0,3,0,7,12,1
6967,66772,3IQ5vbIjcGZGFJfWLKmxNcLXTnJQLHyr,SpATywNh6bZuzm8s1ceuBUnMUAeoAHHw,17,25,13,16,4,35,17,2,112,16.0,4,0.0,2,13,13,4,23,35,3,17,2,32,80,1
6968,66773,5KXpHHWqAiriAz89DseoECa9CF8nNmNg,G8EPVSXsOYB5YQWZGiz1aVq5Pgr2GrQu,2,0,0,0,0,0,2,0,2,0.2857142857142857,1,0.0,0,0,0,0,0,0,0,2,0,0,2,1
6969,66774,3imocgNxcBfwQHadpMof51TjC5xJp8PT,SpATywNh6bZuzm8s1ceuBUnMUAeoAHHw,9,9,6,0,4,0,8,0,27,3.857142857142857,2,0.0,1,6,0,4,8,0,0,8,0,11,16,1
6970,66777,FQiENNRH2NfeZWMamUs40Z7QmdDjNODH,SpATywNh6bZuzm8s1ceuBUnMUAeoAHHw,5,2,1,0,1,0,2,0,6,0.8571428571428571,1,0.0,0,1,0,1,2,0,0,2,0,2,4,1
6971,66786,qGRPIv5dAFSTdBTLUyG7n07ghfZFrtTR,SpATywNh6bZuzm8s1ceuBUnMUAeoAHHw,17,51,4,16,3,4,22,4,104,14.857142857142858,3,0.0,18,4,14,3,33,4,2,22,4,39,65,1
6972,66787,hphlDgjkqVbyJnFgMbu9WAMmL2wONlSy,G8EPVSXsOYB5YQWZGiz1aVq5Pgr2GrQu,9,10,1,0,0,1,8,0,20,2.857142857142857,1,0.0,3,1,0,0,7,1,0,8,0,4,16,1
6973,66791,YKDsG4vA9NLXfljPnrmnZIZC1s2Q0ugD,SpATywNh6bZuzm8s1ceuBUnMUAeoAHHw,5,2,1,0,1,0,4,0,8,1.1428571428571428,1,0.0,0,1,0,1,2,0,0,4,0,2,6,1
6974,66795,ee4pYUOGDieGavHZlg2HTSjfqraD5k7B,SpATywNh6bZuzm8s1ceuBUnMUAeoAHHw,13,10,0,18,0,0,6,1,35,5.0,1,0.0,5,0,15,0,5,0,3,6,1,20,15,1
6975,66814,x0EQgyUAdVGVXHM8VfLLFzp2FQY3yEsn,SpATywNh6bZuzm8s1ceuBUnMUAeoAHHw,8,6,3,0,3,0,3,0,15,2.142857142857143,1,0.0,2,3,0,3,4,0,0,3,0,8,7,0
6976,66817,to6uzLarCrneiGy62nJuyfDuz8bCYwik,G8EPVSXsOYB5YQWZGiz1aVq5Pgr2GrQu,83,100,35,163,20,9,25,2,354,50.57142857142857,6,0.0,51,35,116,20,49,9,47,25,2,222,132,1
6977,66819,j21aImOKDywGp9C5VIymBW05Q7mvVltH,SpATywNh6bZuzm8s1ceuBUnMUAeoAHHw,4,5,0,0,0,0,1,0,6,0.8571428571428571,1,0.0,0,0,0,0,5,0,0,1,0,0,6,1
6978,66821,JcMvDAHro8DuV6i3JIeUIujj4IscZiT7,G8EPVSXsOYB5YQWZGiz1aVq5Pgr2GrQu,13,10,3,22,0,1,4,0,40,5.714285714285714,1,0.0,7,3,16,0,3,1,6,4,0,26,14,0
6979,66831,grwjhoAI1dEZsOpkE7fbBAVHWaIfQbiU,SpATywNh6bZuzm8s1ceuBUnMUAeoAHHw,7,10,6,0,5,0,2,0,23,3.2857142857142856,2,0.0,0,6,0,5,10,0,0,2,0,11,12,1
6980,66836,GjmAjZkQ0i4VbB9kzslDSKYjTMxi0DJm,SpATywNh6bZuzm8s1ceuBUnMUAeoAHHw,10,14,8,0,6,1,2,0,31,4.428571428571429,1,0.0,3,8,0,6,11,1,0,2,0,17,14,1
6981,66840,jW6xo8o8ggQigxJzuOWpksdLscP0nmMK,RXDvfPUBYFlVdlueBFbLW0mhhAyGEqpt,9,11,9,0,7,0,2,0,29,4.142857142857143,1,0.0,1,9,0,7,10,0,0,2,0,17,12,1
6982,66842,KP9bG9uWRMGfX1tzS44KTvN8Cg66ynpe,SpATywNh6bZuzm8s1ceuBUnMUAeoAHHw,13,12,3,13,2,0,4,0,34,4.857142857142857,3,0.0,3,3,10,2,9,0,3,4,0,18,16,1
6983,66845,spo2AoBcB8z4JnQ75NfCsXxxs58G8kjU,SpATywNh6bZuzm8s1ceuBUnMUAeoAHHw,4,2,1,0,1,0,1,0,5,0.7142857142857143,1,0.0,0,1,0,1,2,0,0,1,0,2,3,0
6984,66849,Q089sE9VtgxkkGKk7SyD8fz5PShaeQQT,SpATywNh6bZuzm8s1ceuBUnMUAeoAHHw,6,2,0,0,0,14,5,3,24,3.4285714285714284,1,0.0,0,0,0,0,2,14,0,5,3,0,24,1
6985,66850,WREte9djoqLkGoMvPHsglYJ5ApOOE4Xa,SpATywNh6bZuzm8s1ceuBUnMUAeoAHHw,5,2,0,0,0,1,4,0,7,1.0,1,0.0,0,0,0,0,2,1,0,4,0,0,7,0
6986,66856,9Bmxb2kRkvmXtKdf1iC2KsdGSl1k4oD2,G8EPVSXsOYB5YQWZGiz1aVq5Pgr2GrQu,3,0,0,0,0,0,7,0,7,1.0,5,0.0,0,0,0,0,0,0,0,7,0,0,7,1
6987,66863,xdClWt95AonMUbXmVncDz7pyQAF4u9BG,RXDvfPUBYFlVdlueBFbLW0mhhAyGEqpt,1,0,0,0,0,0,1,0,1,0.14285714285714285,1,0.0,0,0,0,0,0,0,0,1,0,0,1,1
6988,66867,t2MGYeUu0hRLKtqGYRo6b7Rz4YOZ5CAl,SpATywNh6bZuzm8s1ceuBUnMUAeoAHHw,8,3,1,0,1,1,8,0,14,2.0,2,0.0,0,1,0,1,3,1,0,8,0,2,12,1
6989,66876,lBWHzt16Kw5civcvlfzsyLbIMpskhKLb,SpATywNh6bZuzm8s1ceuBUnMUAeoAHHw,4,2,1,0,0,0,2,0,5,0.7142857142857143,1,0.0,0,1,0,0,2,0,0,2,0,1,4,1
6990,66882,RUyO8vGMdp7jhM6g17yji5ANjGox4I7a,G8EPVSXsOYB5YQWZGiz1aVq5Pgr2GrQu,15,45,18,6,13,1,3,7,93,13.285714285714286,2,0.0,16,18,4,13,29,1,2,3,7,51,42,1
6991,66901,jsqKkuSbErall5JnaWQXJQsGef5XwKOD,SpATywNh6bZuzm8s1ceuBUnMUAeoAHHw,11,22,11,0,1,4,12,1,51,7.285714285714286,3,0.0,0,11,0,1,22,4,0,12,1,12,39,1
6992,66902,SaCuUEx4yVWy7KEZ7c1LumXyYr79w4Rm,bWdj2GDclj5ofokWjzoa5jAwMkxCykd6,7,4,2,0,0,3,5,1,15,2.142857142857143,1,0.0,0,2,0,0,4,3,0,5,1,2,13,1
6993,66906,dEKCxHL9joqZNeQKkyzq4Y5b5GlTbyt0,SpATywNh6bZuzm8s1ceuBUnMUAeoAHHw,1,0,0,0,0,0,1,0,1,0.14285714285714285,1,0.0,0,0,0,0,0,0,0,1,0,0,1,1
6994,66912,i0LHbVo0MUWeo1slrPpQRlCoWzknlhLR,SpATywNh6bZuzm8s1ceuBUnMUAeoAHHw,6,6,1,0,0,0,3,0,10,1.4285714285714286,1,0.0,1,1,0,0,5,0,0,3,0,2,8,1
6995,66913,Pp6wRQkPti9Bk2fBcpI0VrxeT3AtZv4c,SpATywNh6bZuzm8s1ceuBUnMUAeoAHHw,13,42,7,16,3,4,10,0,82,11.714285714285714,3,0.0,7,7,14,3,35,4,2,10,0,31,51,1
6996,66919,4W9VDoom5TgPKJhY4YS0TxVzPBBhVmKe,SpATywNh6bZuzm8s1ceuBUnMUAeoAHHw,5,5,3,2,0,0,1,0,11,1.5714285714285714,1,0.0,1,3,2,0,4,0,0,1,0,6,5,1
6997,66921,HEyWCm29dAxf2gF6HX7SoCKEpp5xOaMH,SpATywNh6bZuzm8s1ceuBUnMUAeoAHHw,8,16,2,0,0,23,11,1,53,7.571428571428571,2,0.0,0,2,0,0,16,23,0,11,1,2,51,1
6998,66936,STtQLJYeEtdkd5hogRcAby24tBZrG3TQ,SpATywNh6bZuzm8s1ceuBUnMUAeoAHHw,1,0,0,0,0,0,1,0,1,0.14285714285714285,1,0.0,0,0,0,0,0,0,0,1,0,0,1,1
6999,66953,hgypFYGQkHCtSzjmFaIf3CToNAXniUea,bWdj2GDclj5ofokWjzoa5jAwMkxCykd6,4,4,0,0,2,0,3,0,9,1.2857142857142858,1,0.0,2,0,0,2,2,0,0,3,0,4,5,1
7000,66954,8Eqf4bSicFmRziRU1kFgF89C5yGB8WDX,bWdj2GDclj5ofokWjzoa5jAwMkxCykd6,7,26,7,0,6,16,20,0,75,10.714285714285714,3,0.0,0,7,0,6,26,16,0,20,0,13,62,1
7001,66957,19VrgqzLVY9ZBYQoB1uroAA02q94O1Zu,SpATywNh6bZuzm8s1ceuBUnMUAeoAHHw,11,8,0,21,0,1,4,1,35,5.0,1,0.0,2,0,17,0,6,1,4,4,1,19,16,1
7002,66958,VNn0ZSteI0TUWATSfv7oNQMdpP8UUblh,SpATywNh6bZuzm8s1ceuBUnMUAeoAHHw,31,61,23,18,10,9,20,1,142,20.285714285714285,3,0.0,17,23,18,10,44,9,0,20,1,68,74,1
7003,66963,HYIak5MajHEE4KscVQZXOCe1sQzZq7OB,G8EPVSXsOYB5YQWZGiz1aVq5Pgr2GrQu,7,7,1,0,0,0,3,0,11,1.5714285714285714,2,0.0,1,1,0,0,6,0,0,3,0,2,9,1
7004,66973,AtBEE9J055aDlITLvmg36iywfRw9ii2d,SpATywNh6bZuzm8s1ceuBUnMUAeoAHHw,36,37,21,15,14,0,21,0,108,15.428571428571429,5,0.0,2,21,12,14,35,0,3,21,0,49,59,1
7005,66977,vEpbzgzC6vVRH2ddUE3uoPla0NVwp3kL,SpATywNh6bZuzm8s1ceuBUnMUAeoAHHw,7,4,0,0,0,0,5,0,9,1.2857142857142858,1,0.0,0,0,0,0,4,0,0,5,0,0,9,1
7006,66996,vgJBdvzTqJ5MKR9sNPkrlU2Mvr3KdXZ3,SpATywNh6bZuzm8s1ceuBUnMUAeoAHHw,18,23,11,19,7,0,5,0,65,9.285714285714286,4,0.0,6,11,16,7,17,0,3,5,0,40,25,0
7007,66999,FfIijJSc7v6Gx20szDQGd4UKB6lngdbn,SpATywNh6bZuzm8s1ceuBUnMUAeoAHHw,4,2,1,0,1,0,1,0,5,0.7142857142857143,1,0.0,0,1,0,1,2,0,0,1,0,2,3,1
7008,67000,5TmlEBiIGuIt6aB6TwvG68U4RXEnGCj0,SpATywNh6bZuzm8s1ceuBUnMUAeoAHHw,4,2,1,0,1,0,1,0,5,0.7142857142857143,1,0.0,0,1,0,1,2,0,0,1,0,2,3,0
7009,67002,x0d0kPxQt2lqC4Ti0c8RfiJ0ufqJ2aAF,SpATywNh6bZuzm8s1ceuBUnMUAeoAHHw,4,2,1,0,0,1,2,0,6,0.8571428571428571,1,0.0,0,1,0,0,2,1,0,2,0,1,5,1
7010,67004,P2uvU61vWnBKPWmDU3fEsDqh9JFKsQoE,bWdj2GDclj5ofokWjzoa5jAwMkxCykd6,11,15,11,66,5,0,3,0,100,14.285714285714286,2,0.0,1,11,65,5,14,0,1,3,0,82,18,1
7011,67006,3KIB4La3IsOSQkcNKGmRWQWUPPUMWKbW,RXDvfPUBYFlVdlueBFbLW0mhhAyGEqpt,9,3,2,0,2,1,5,1,14,2.0,1,0.0,0,2,0,2,3,1,0,5,1,4,10,0
7012,67012,Id4UmIRRQiLXHoJYSjh5OCO1CRaFgQ2K,RXDvfPUBYFlVdlueBFbLW0mhhAyGEqpt,10,12,8,0,5,0,2,0,27,3.857142857142857,2,0.0,0,8,0,5,12,0,0,2,0,13,14,1
7013,67014,1yJ7vGttwVZkfwO9DkOg0seBq4i9314Q,bWdj2GDclj5ofokWjzoa5jAwMkxCykd6,1,0,0,0,0,0,1,0,1,0.14285714285714285,1,0.0,0,0,0,0,0,0,0,1,0,0,1,1
7014,67015,knXx0VSX34ZZdw5j0pCDnRFFDbxG6IJ6,SpATywNh6bZuzm8s1ceuBUnMUAeoAHHw,32,42,26,17,15,0,15,0,115,16.428571428571427,5,0.0,9,26,16,15,33,0,1,15,0,66,49,0
7015,67022,qgATVDXI6hyNw5k2TylFI0Voj1oJ8GzP,RXDvfPUBYFlVdlueBFbLW0mhhAyGEqpt,4,2,1,0,1,0,1,0,5,0.7142857142857143,1,0.0,0,1,0,1,2,0,0,1,0,2,3,1
7016,67023,qgATVDXI6hyNw5k2TylFI0Voj1oJ8GzP,SpATywNh6bZuzm8s1ceuBUnMUAeoAHHw,2,0,0,0,0,0,2,0,2,0.2857142857142857,1,0.0,0,0,0,0,0,0,0,2,0,0,2,1
7017,67033,tPYh43YRHAzuf09xESxSKtWvST0aCsjn,SpATywNh6bZuzm8s1ceuBUnMUAeoAHHw,20,25,10,27,1,0,9,0,72,10.285714285714286,6,0.0,10,10,24,1,15,0,3,9,0,45,27,0
7018,67034,yZ9FndAKqVsKwZtO1B2JJJblefdbhZ02,SpATywNh6bZuzm8s1ceuBUnMUAeoAHHw,18,18,2,44,0,0,16,0,80,11.428571428571429,7,0.0,10,2,40,0,8,0,4,16,0,52,28,0
7019,67037,6RtjQ87TFCeYnCEQooYczzLrx8zugyat,SpATywNh6bZuzm8s1ceuBUnMUAeoAHHw,1,0,0,0,0,0,1,0,1,0.14285714285714285,1,0.0,0,0,0,0,0,0,0,1,0,0,1,1
7020,67040,Rf7b7AtnB3yMHMysfPwxe6fh0kofBsCX,G8EPVSXsOYB5YQWZGiz1aVq5Pgr2GrQu,6,7,3,0,2,0,6,0,18,2.5714285714285716,2,0.0,3,3,0,2,4,0,0,6,0,8,10,1
7021,67041,G2vTTAEhPpy1uiGVOSc3WfzCmuUhZyw6,SpATywNh6bZuzm8s1ceuBUnMUAeoAHHw,12,19,1,19,1,0,12,0,52,7.428571428571429,1,0.0,8,1,15,1,11,0,4,12,0,25,27,1
7022,67049,caAQbOI1NkkZKVF3oGPK3OdsY0lbDlYb,SpATywNh6bZuzm8s1ceuBUnMUAeoAHHw,10,16,7,0,3,0,9,3,38,5.428571428571429,3,0.0,0,7,0,3,16,0,0,9,3,10,28,1
7023,67051,fJHji2otGUDYDMFxwiigoqhPCAcWp4zZ,SpATywNh6bZuzm8s1ceuBUnMUAeoAHHw,5,2,1,0,1,0,2,0,6,0.8571428571428571,1,0.0,0,1,0,1,2,0,0,2,0,2,4,1
7024,67058,b5Gj1OyeYKLhLlGsleyNSSJpbJ2lneFj,RXDvfPUBYFlVdlueBFbLW0mhhAyGEqpt,19,9,6,24,4,0,3,0,46,6.571428571428571,1,0.0,2,6,24,4,7,0,0,3,0,36,10,1
7025,67059,3w7hN41KgzlGkT6XiQZqVbo1geJzchKr,G8EPVSXsOYB5YQWZGiz1aVq5Pgr2GrQu,5,1,1,0,1,0,4,0,7,1.0,2,0.0,0,1,0,1,1,0,0,4,0,2,5,1
7026,67061,OisrcH2Uqqf03TtDLM3YLpNZbhlSzcT1,SpATywNh6bZuzm8s1ceuBUnMUAeoAHHw,8,7,4,0,2,0,11,1,25,3.5714285714285716,1,0.0,0,4,0,2,7,0,0,11,1,6,19,1
7027,67076,llPRK5GJ1Fu42jqOdNFWOcUEenGG1vdv,SpATywNh6bZuzm8s1ceuBUnMUAeoAHHw,13,26,6,17,3,0,4,0,56,8.0,1,0.0,15,6,16,3,11,0,1,4,0,40,16,1
7028,67077,wDMKq3Xvq95ERd20zjEMEb0BtCbHx7BM,SpATywNh6bZuzm8s1ceuBUnMUAeoAHHw,29,60,19,48,4,6,35,2,174,24.857142857142858,17,0.0,13,19,45,4,47,6,3,35,2,81,93,0
7029,67080,CgsguvEs0KUN3Abw9Qjh5ZZT0chwXUSw,SpATywNh6bZuzm8s1ceuBUnMUAeoAHHw,31,72,26,34,8,247,18,1,406,58.0,6,0.0,22,26,33,8,50,247,1,18,1,89,317,0
7030,67087,CN11ovtPF8fJmUO54gCiYLygyrR54itQ,SpATywNh6bZuzm8s1ceuBUnMUAeoAHHw,8,11,6,0,2,0,2,0,21,3.0,2,0.0,0,6,0,2,11,0,0,2,0,8,13,0
7031,67096,N7x6rez9AavUVus2y33zQwbgvW9e4FwN,SpATywNh6bZuzm8s1ceuBUnMUAeoAHHw,14,18,6,17,3,0,2,0,46,6.571428571428571,1,0.0,10,6,16,3,8,0,1,2,0,35,11,1
7032,67099,rwVFzRApiQw3vAU5Rpa6do3mD0uc5CXG,SpATywNh6bZuzm8s1ceuBUnMUAeoAHHw,29,64,1,49,1,5,18,1,139,19.857142857142858,6,0.0,20,1,42,1,44,5,7,18,1,64,75,1
7033,67104,8IdT3BpziJuUIg1uIZIVpj0NWmeXuSS8,G8EPVSXsOYB5YQWZGiz1aVq5Pgr2GrQu,37,62,5,96,5,6,15,1,190,27.142857142857142,4,0.0,38,5,80,5,24,6,16,15,1,128,62,1
7034,67111,KOlp6BtLHFtxPjNN0KYQVjD6WvIwSYtA,SpATywNh6bZuzm8s1ceuBUnMUAeoAHHw,22,56,1,25,0,9,14,0,105,15.0,4,0.0,16,1,24,0,40,9,1,14,0,41,64,0
7035,67114,G7XB7BvktED5k0pfiNMFlIFMFGCreTGp,G8EPVSXsOYB5YQWZGiz1aVq5Pgr2GrQu,6,12,1,0,3,0,3,0,19,2.7142857142857144,1,0.0,10,1,0,3,2,0,0,3,0,14,5,1
7036,67116,KhEJGS2oZuX97oPJJp9Z5yTu0JSgEwNN,SpATywNh6bZuzm8s1ceuBUnMUAeoAHHw,11,26,2,11,0,1,5,0,45,6.428571428571429,1,0.0,10,2,10,0,16,1,1,5,0,22,23,1
7037,67122,TuRtla6uL7YMLA6vfJsBKtiNWjCxP0OZ,RXDvfPUBYFlVdlueBFbLW0mhhAyGEqpt,10,26,13,0,3,0,3,0,45,6.428571428571429,2,0.0,9,13,0,3,17,0,0,3,0,25,20,1
7038,67128,dL3mb41Bm8AhTujPtToBfgUCEqTQ4yms,G8EPVSXsOYB5YQWZGiz1aVq5Pgr2GrQu,11,25,3,0,1,0,4,0,33,4.714285714285714,3,0.0,3,3,0,1,22,0,0,4,0,7,26,1
7039,67133,iU8sg5PBq7mTADvs0COG4jXH4nM6hq2B,SpATywNh6bZuzm8s1ceuBUnMUAeoAHHw,31,54,21,13,12,16,26,1,143,20.428571428571427,7,0.0,20,21,13,12,34,16,0,26,1,66,77,1
7040,67137,iZa1NC6aT0Npl7jBiTIydtSYeYsdEobQ,bWdj2GDclj5ofokWjzoa5jAwMkxCykd6,3,0,0,0,0,0,2,1,3,0.42857142857142855,1,0.0,0,0,0,0,0,0,0,2,1,0,3,1
7041,67152,gaiJtHdepYI8ZLS7HsizBoGVbYaMsssC,bWdj2GDclj5ofokWjzoa5jAwMkxCykd6,2,0,0,0,0,0,2,0,2,0.2857142857142857,1,0.0,0,0,0,0,0,0,0,2,0,0,2,1
7042,67156,3vhG5LSOA1YcHy71CJJOxAgCZ2y6XT8e,SpATywNh6bZuzm8s1ceuBUnMUAeoAHHw,15,31,11,23,4,0,9,0,78,11.142857142857142,2,0.0,15,11,20,4,16,0,3,9,0,50,28,1
7043,67158,07nBIjV5wvxeipK7Zz3uxWH8hv0V5VvH,SpATywNh6bZuzm8s1ceuBUnMUAeoAHHw,49,79,39,29,19,5,15,1,187,26.714285714285715,8,0.0,24,39,27,19,55,5,2,15,1,109,78,0
7044,67159,CQ3lDAshmWjO1E4GBV1wnteO6NqYgq2s,G8EPVSXsOYB5YQWZGiz1aVq5Pgr2GrQu,30,63,1,68,5,8,7,1,153,21.857142857142858,2,0.0,23,1,53,5,40,8,15,7,1,82,71,1
7045,67164,ztcM8oJ9cYwAQxtlfaWWEY7el55tNp3L,SpATywNh6bZuzm8s1ceuBUnMUAeoAHHw,13,60,15,0,13,12,17,2,119,17.0,3,0.0,2,15,0,13,58,12,0,17,2,30,89,1
7046,67171,ILwuNMaKW9cfodB9O42BE2MDGjshUqyt,SpATywNh6bZuzm8s1ceuBUnMUAeoAHHw,10,12,0,0,0,0,7,0,19,2.7142857142857144,2,0.0,0,0,0,0,12,0,0,7,0,0,19,1
7047,67175,U9sp7fhhso4I4hUMdZYxdb4jjkzhb9EZ,SpATywNh6bZuzm8s1ceuBUnMUAeoAHHw,16,16,8,20,6,6,20,8,84,12.0,2,0.0,3,8,17,6,13,6,3,20,8,34,50,1
7048,67178,29637v4JeTV4lmXkjMER9DNWcGaMyJ4v,G8EPVSXsOYB5YQWZGiz1aVq5Pgr2GrQu,3,2,1,0,0,0,1,0,4,0.5714285714285714,1,0.0,0,1,0,0,2,0,0,1,0,1,3,1
7049,67184,tYMYXyJdOChlQSPrkrVNlrHj5tCYzHnQ,bWdj2GDclj5ofokWjzoa5jAwMkxCykd6,11,15,3,50,4,0,1,0,73,10.428571428571429,2,0.0,8,3,47,4,7,0,3,1,0,62,11,1
7050,67185,yCubUbsDW6wXrTu9ngQq5pTghAOVDrjs,SpATywNh6bZuzm8s1ceuBUnMUAeoAHHw,1,0,0,0,0,0,1,0,1,0.14285714285714285,1,0.0,0,0,0,0,0,0,0,1,0,0,1,1
7051,67195,MPLO46zeqSAmGFkKKuWvnx6pcJItRavU,SpATywNh6bZuzm8s1ceuBUnMUAeoAHHw,32,80,30,39,8,10,27,9,203,29.0,4,0.0,38,30,33,8,42,10,6,27,9,109,94,0
7052,67198,MozrQftkFsk2HJMPpZe4xQGho83nBBbJ,SpATywNh6bZuzm8s1ceuBUnMUAeoAHHw,9,8,3,0,1,1,6,1,20,2.857142857142857,1,0.0,1,3,0,1,7,1,0,6,1,5,15,1
7053,67207,jn6VKgJPC4fyRRCl6zZirG5zLpU8fnC6,SpATywNh6bZuzm8s1ceuBUnMUAeoAHHw,2,0,0,0,0,0,2,0,2,0.2857142857142857,1,0.0,0,0,0,0,0,0,0,2,0,0,2,1
7054,67209,lXVULXqG43l726A9V3NFlFs9kvovJQx4,SpATywNh6bZuzm8s1ceuBUnMUAeoAHHw,10,7,5,0,4,0,4,0,20,2.857142857142857,2,0.0,0,5,0,4,7,0,0,4,0,9,11,1
7055,67213,IHjTTbtSKJcagLP8HZiMzotl9tnHf7ev,SpATywNh6bZuzm8s1ceuBUnMUAeoAHHw,19,22,10,12,5,7,17,2,75,10.714285714285714,4,0.0,2,10,9,5,20,7,3,17,2,26,49,0
7056,67220,5UJZmEar1AX3gQXOzkh3MnQcYdErI17M,SpATywNh6bZuzm8s1ceuBUnMUAeoAHHw,21,25,9,12,5,3,10,1,65,9.285714285714286,3,0.0,12,9,10,5,13,3,2,10,1,36,29,1
7057,67224,AszzZcQ3DzjVCWiO17ucpHFrMmRC8MRV,SpATywNh6bZuzm8s1ceuBUnMUAeoAHHw,17,66,5,31,3,74,35,4,218,31.142857142857142,3,0.0,15,5,25,3,51,74,6,35,4,48,170,0
7058,67231,DBWpurAvW8awkr3pqCDDF8bsim2D57Vj,G8EPVSXsOYB5YQWZGiz1aVq5Pgr2GrQu,14,7,5,0,6,0,8,1,27,3.857142857142857,1,0.0,2,5,0,6,5,0,0,8,1,13,14,1
7059,67246,kA48LgfRPY6vHgTrWK5pJnx3RsuxrRTH,SpATywNh6bZuzm8s1ceuBUnMUAeoAHHw,10,6,3,1,2,0,3,0,15,2.142857142857143,1,0.0,1,3,1,2,5,0,0,3,0,7,8,1
7060,67247,q2AJDoW2EuJlq2uo87Sn9QLp36IwXzSv,SpATywNh6bZuzm8s1ceuBUnMUAeoAHHw,8,3,1,0,2,0,5,0,11,1.5714285714285714,2,0.0,0,1,0,2,3,0,0,5,0,3,8,1
7061,67248,8R7wkJYHxnNXLQq4dxMbBtsEclGat3j9,bWdj2GDclj5ofokWjzoa5jAwMkxCykd6,1,0,0,0,0,0,1,0,1,0.14285714285714285,1,0.0,0,0,0,0,0,0,0,1,0,0,1,1
7062,67260,ZULZi8TAkwGNSYKMYJ57kBAZvrMte2xF,SpATywNh6bZuzm8s1ceuBUnMUAeoAHHw,15,28,13,16,7,0,5,0,69,9.857142857142858,1,0.0,4,13,14,7,24,0,2,5,0,38,31,1
7063,67262,4hqkXkyq5mjsuNE9t6Q3zzOu4OQAJfqm,SpATywNh6bZuzm8s1ceuBUnMUAeoAHHw,14,22,11,10,5,0,6,0,54,7.714285714285714,5,0.0,5,11,10,5,17,0,0,6,0,31,23,1
7064,67264,uxiQAPJTLsI808GQpb2cYmEtdBDdQ3cx,SpATywNh6bZuzm8s1ceuBUnMUAeoAHHw,14,15,6,9,3,0,5,0,38,5.428571428571429,2,0.0,8,6,9,3,7,0,0,5,0,26,12,1
7065,67265,hfSXPDFaR2dzrQsij0JMBqqFRCNkzN0i,SpATywNh6bZuzm8s1ceuBUnMUAeoAHHw,6,3,1,0,1,0,2,0,7,1.0,1,0.0,0,1,0,1,3,0,0,2,0,2,5,1
7066,67266,X0qiYFDfIWOz74gDCjJtjtlJKUHThKgm,SpATywNh6bZuzm8s1ceuBUnMUAeoAHHw,26,49,26,18,9,19,14,1,136,19.428571428571427,7,0.0,15,26,15,9,34,19,3,14,1,65,71,0
7067,67267,d4AhROqi4DjVmWKfbbbhi19n7hcGPkSg,RXDvfPUBYFlVdlueBFbLW0mhhAyGEqpt,55,66,2,178,3,12,19,4,284,40.57142857142857,11,0.0,14,2,150,3,52,12,28,19,4,169,115,0
7068,67272,28W5CJrYp73LQgjHivjzAixkCQuqTCh6,bWdj2GDclj5ofokWjzoa5jAwMkxCykd6,4,2,1,0,1,0,2,0,6,0.8571428571428571,2,0.0,0,1,0,1,2,0,0,2,0,2,4,1
7069,67275,d7AooNZI1FOSZnZfgBmuAUMu5eysX9mb,SpATywNh6bZuzm8s1ceuBUnMUAeoAHHw,12,13,8,14,6,0,2,0,43,6.142857142857143,1,0.0,4,8,11,6,9,0,3,2,0,29,14,1
7070,67278,frK0oim7qtvURbYrZJ5gIFPqgQt63IEt,G8EPVSXsOYB5YQWZGiz1aVq5Pgr2GrQu,9,3,2,0,0,7,9,1,22,3.142857142857143,2,0.0,0,2,0,0,3,7,0,9,1,2,20,0
7071,67287,r9n2Z7iYkL5tKegLJwMIOxTHQqxopYp0,G8EPVSXsOYB5YQWZGiz1aVq5Pgr2GrQu,7,5,3,0,2,0,2,0,12,1.7142857142857142,2,0.0,0,3,0,2,5,0,0,2,0,5,7,0
7072,67288,PXVYYQlV1TwZ9b9f7GhoFUXTgABGZcBY,SpATywNh6bZuzm8s1ceuBUnMUAeoAHHw,23,30,14,19,8,3,22,2,98,14.0,4,0.0,12,14,16,8,18,3,3,22,2,50,48,0
7073,67297,mZ0efv4ffU6kCJ0Ro6mv6OGSULVT9odf,SpATywNh6bZuzm8s1ceuBUnMUAeoAHHw,1,0,0,0,0,0,1,0,1,0.14285714285714285,1,0.0,0,0,0,0,0,0,0,1,0,0,1,1
7074,67300,3QGIXvN5AKtl5SyCz6EZh0jA8JPL5Nkx,bWdj2GDclj5ofokWjzoa5jAwMkxCykd6,6,9,1,0,0,0,3,0,13,1.8571428571428572,2,0.0,0,1,0,0,9,0,0,3,0,1,12,1
7075,67302,CrdUJ25e700hCpU6YbocYb3uKRMcCPjz,SpATywNh6bZuzm8s1ceuBUnMUAeoAHHw,9,15,0,4,0,0,2,0,21,3.0,3,0.0,0,0,3,0,15,0,1,2,0,3,18,1
7076,67303,xrGYbDqan6dLH2p778nfhYmmVfnrrpam,SpATywNh6bZuzm8s1ceuBUnMUAeoAHHw,2,0,0,0,0,0,2,0,2,0.2857142857142857,1,0.0,0,0,0,0,0,0,0,2,0,0,2,1
7077,67308,T73fWQC3H2PhmOiodFuHvvahENx7TmZo,SpATywNh6bZuzm8s1ceuBUnMUAeoAHHw,11,11,8,8,5,0,2,0,34,4.857142857142857,2,0.0,2,8,6,5,9,0,2,2,0,21,13,1
7078,67314,CVINZY0qqZyjVQC8d4yq3w0fqkMGJBVL,G8EPVSXsOYB5YQWZGiz1aVq5Pgr2GrQu,21,16,2,14,2,0,7,1,42,6.0,1,0.0,0,2,12,2,16,0,2,7,1,16,26,1
7079,67328,HurK028hfari9vlQzhAchljjKEaGMu7l,SpATywNh6bZuzm8s1ceuBUnMUAeoAHHw,21,49,18,19,2,0,8,0,96,13.714285714285714,5,0.0,21,18,18,2,28,0,1,8,0,59,37,1
7080,67332,0xyoG1WvCKM42y6l9xPNGRXw8gklJB9a,G8EPVSXsOYB5YQWZGiz1aVq5Pgr2GrQu,14,34,7,8,5,9,5,0,68,9.714285714285714,2,0.0,2,7,6,5,32,9,2,5,0,20,48,1
7081,67345,WACfmqzUT9wOhkm3QdtpYOSdY2CeIJWa,RXDvfPUBYFlVdlueBFbLW0mhhAyGEqpt,44,42,25,57,14,3,13,3,157,22.428571428571427,2,0.0,10,25,52,14,32,3,5,13,3,101,56,1
7082,67346,DDhKDNB6fEAHv06PdV80Zz5GVaFianlg,SpATywNh6bZuzm8s1ceuBUnMUAeoAHHw,11,13,5,0,1,4,9,1,33,4.714285714285714,1,0.0,3,5,0,1,10,4,0,9,1,9,24,1
7083,67348,GQMirxB5y3FtUmix76KGcpTxWntGgKiV,RXDvfPUBYFlVdlueBFbLW0mhhAyGEqpt,50,35,22,50,15,8,6,0,136,19.428571428571427,2,0.0,9,22,48,15,26,8,2,6,0,94,42,1
7084,67353,VWEcCKiwp28lQZuBYYNslDL0523gk0Z6,G8EPVSXsOYB5YQWZGiz1aVq5Pgr2GrQu,16,19,7,8,7,0,4,1,46,6.571428571428571,1,0.0,10,7,5,7,9,0,3,4,1,29,17,1
7085,67354,ZdDSfnnRjfjHFmnDyPudXjLUHiOgLvKy,SpATywNh6bZuzm8s1ceuBUnMUAeoAHHw,4,2,0,0,0,0,2,0,4,0.5714285714285714,1,0.0,0,0,0,0,2,0,0,2,0,0,4,1
7086,67359,SODa9wZLHSXHCkQdc5G9XFSaZePE5xpY,bWdj2GDclj5ofokWjzoa5jAwMkxCykd6,1,0,0,0,0,0,1,0,1,0.14285714285714285,1,0.0,0,0,0,0,0,0,0,1,0,0,1,1
7087,67360,V5bKpsSihRb2F9h32bBQPUZX9j9nvFi3,SpATywNh6bZuzm8s1ceuBUnMUAeoAHHw,5,5,0,0,0,0,2,0,7,1.0,1,0.0,0,0,0,0,5,0,0,2,0,0,7,1
7088,67362,a5BZ9otCoBYjX9WVbUSqK2dp356IUlVP,bWdj2GDclj5ofokWjzoa5jAwMkxCykd6,2,0,0,0,0,0,2,0,2,0.2857142857142857,1,0.0,0,0,0,0,0,0,0,2,0,0,2,1
7089,67371,Ofc6ixmmoavYN92PkloL7C1g0H36jbU2,SpATywNh6bZuzm8s1ceuBUnMUAeoAHHw,10,11,5,0,3,0,8,1,28,4.0,3,0.0,0,5,0,3,11,0,0,8,1,8,20,1
7090,67377,w2OXuLJJs4MYqj6mF4JPNXoMIMuUu4d7,SpATywNh6bZuzm8s1ceuBUnMUAeoAHHw,6,5,2,0,1,2,3,0,13,1.8571428571428572,1,0.0,0,2,0,1,5,2,0,3,0,3,10,1
7091,67381,lPTnc5ZrBauZXbwYcDNNjt3Gvgvmp9Cq,SpATywNh6bZuzm8s1ceuBUnMUAeoAHHw,5,5,3,0,1,0,3,0,12,1.7142857142857142,2,0.0,0,3,0,1,5,0,0,3,0,4,8,1
7092,67382,ib1Tw9jwnFk22Zeb4pY0FX5aHNkeyMBZ,SpATywNh6bZuzm8s1ceuBUnMUAeoAHHw,3,3,1,0,0,0,1,0,5,0.7142857142857143,1,0.0,0,1,0,0,3,0,0,1,0,1,4,1
7093,67388,ALYZFAVviUOGzyN4znk46d3PmVgvtUAM,bWdj2GDclj5ofokWjzoa5jAwMkxCykd6,4,2,0,0,0,0,2,2,6,0.8571428571428571,1,0.0,0,0,0,0,2,0,0,2,2,0,6,1
7094,67389,k5fKzDcQyLOb8CsK2DtBEPxysEHaDdpC,RXDvfPUBYFlVdlueBFbLW0mhhAyGEqpt,6,12,3,0,1,3,4,1,24,3.4285714285714284,2,0.0,0,3,0,1,12,3,0,4,1,4,20,1
7095,67394,5fHLQXAfhzEdTjeeb4rbhkUBfbZKOD1P,SpATywNh6bZuzm8s1ceuBUnMUAeoAHHw,6,9,1,0,0,2,4,0,16,2.2857142857142856,1,0.0,0,1,0,0,9,2,0,4,0,1,15,1
7096,67405,5MnZ5TXikbZdya4aF9I9IoQXVWF4ujt6,SpATywNh6bZuzm8s1ceuBUnMUAeoAHHw,2,0,0,0,0,0,3,0,3,0.42857142857142855,1,0.0,0,0,0,0,0,0,0,3,0,0,3,1
7097,67406,KglHKNjP3QUQRobKP7GTczISSfhOt7DT,SpATywNh6bZuzm8s1ceuBUnMUAeoAHHw,1,0,0,0,0,0,1,0,1,0.14285714285714285,1,0.0,0,0,0,0,0,0,0,1,0,0,1,1
7098,67418,lCMgevd3r8NsQWpObW4O6eaYbm6xHejf,bWdj2GDclj5ofokWjzoa5jAwMkxCykd6,8,6,4,0,3,0,3,0,16,2.2857142857142856,2,0.0,0,4,0,3,6,0,0,3,0,7,9,1
7099,67421,DjTSUM8no03TdLiv7ibkGW8BkXCgFLYB,bWdj2GDclj5ofokWjzoa5jAwMkxCykd6,11,22,11,16,9,0,6,0,64,9.142857142857142,2,0.0,4,11,14,9,18,0,2,6,0,38,26,1
7100,67424,kuV8TXv5cFVPIWK37fDR8nnl0vrHyjjA,RXDvfPUBYFlVdlueBFbLW0mhhAyGEqpt,61,108,50,115,10,6,14,2,305,43.57142857142857,5,0.0,16,50,107,10,92,6,8,14,2,183,122,0
7101,67427,vS0PO2z5tTpDl1S200qdqNDkFjNmdjxd,G8EPVSXsOYB5YQWZGiz1aVq5Pgr2GrQu,47,37,23,30,19,0,6,0,115,16.428571428571427,4,0.0,1,23,26,19,36,0,4,6,0,69,46,1
7102,67429,JY3pL2MJnhOGuIufYZaXnkXrdE9eR9kZ,SpATywNh6bZuzm8s1ceuBUnMUAeoAHHw,7,3,2,0,2,0,2,0,9,1.2857142857142858,1,0.0,0,2,0,2,3,0,0,2,0,4,5,1
7103,67431,ic21uM8q7hG6lYEnCwOGpdZRk8GzB2Q4,bWdj2GDclj5ofokWjzoa5jAwMkxCykd6,4,3,1,0,1,0,1,0,6,0.8571428571428571,1,0.0,0,1,0,1,3,0,0,1,0,2,4,1
7104,67435,gK0C2Qn10uFCDrXyxIuukzeUErx51I1a,SpATywNh6bZuzm8s1ceuBUnMUAeoAHHw,23,49,1,35,2,2,11,0,100,14.285714285714286,5,0.0,22,1,33,2,27,2,2,11,0,58,42,0
7105,67437,H1gNXDemnE2i9lW82GrGfdWk3AATsmHy,SpATywNh6bZuzm8s1ceuBUnMUAeoAHHw,51,68,23,30,16,6,8,2,153,21.857142857142858,3,0.0,24,23,29,16,44,6,1,8,2,92,61,0
7106,67444,Cow0Edw3V8JD4s2oOxNrhyd18ZVv78TG,SpATywNh6bZuzm8s1ceuBUnMUAeoAHHw,16,22,9,7,5,0,2,0,45,6.428571428571429,2,0.0,5,9,6,5,17,0,1,2,0,25,20,1
7107,67445,Q9jQ2QVFcDk6rCEN1ap0bZmI7VqzGuqs,SpATywNh6bZuzm8s1ceuBUnMUAeoAHHw,25,47,5,33,3,10,10,1,109,15.571428571428571,3,0.0,12,5,27,3,35,10,6,10,1,47,62,0
7108,67454,7KhKGJPxu4uQKYHNs7O3NjmuTH6NjrVY,bWdj2GDclj5ofokWjzoa5jAwMkxCykd6,9,50,28,4,7,19,39,2,149,21.285714285714285,7,0.0,2,28,3,7,48,19,1,39,2,40,109,0
7109,67458,gjY6BujcNO3C8usrnDcYxkNzXuI0fCEe,SpATywNh6bZuzm8s1ceuBUnMUAeoAHHw,8,6,4,0,3,0,4,0,17,2.4285714285714284,1,0.0,0,4,0,3,6,0,0,4,0,7,10,1
7110,67464,uBWT9p90Ea0JVvR5wbRV9EQLPt0ehYR1,SpATywNh6bZuzm8s1ceuBUnMUAeoAHHw,35,74,3,36,2,13,26,0,154,22.0,7,0.0,23,3,33,2,51,13,3,26,0,61,93,1
7111,67466,6yy5YFhebeCVEWPcZqK4jg9qO8ru1OT4,SpATywNh6bZuzm8s1ceuBUnMUAeoAHHw,15,17,3,23,2,2,7,0,54,7.714285714285714,4,0.0,3,3,19,2,14,2,4,7,0,27,27,1
7112,67467,ZLbvkY9GfOSzox7JCIcmWczltkUqxVjR,SpATywNh6bZuzm8s1ceuBUnMUAeoAHHw,7,6,4,0,2,0,4,0,16,2.2857142857142856,1,0.0,0,4,0,2,6,0,0,4,0,6,10,1
7113,67468,lHCmVtLnmElXqFcol1pTzGnaqp21GEs7,RXDvfPUBYFlVdlueBFbLW0mhhAyGEqpt,24,10,10,0,10,0,5,3,38,5.428571428571429,2,0.0,0,10,0,10,10,0,0,5,3,20,18,1
7114,67469,7tCVHfGANSkwc2DzOsbidXgZOw6Q8q5f,G8EPVSXsOYB5YQWZGiz1aVq5Pgr2GrQu,9,4,3,0,3,0,2,0,12,1.7142857142857142,1,0.0,0,3,0,3,4,0,0,2,0,6,6,1
7115,67474,XQsLTRxBgT09jhwR2kw4g3k34p5O8kHV,bWdj2GDclj5ofokWjzoa5jAwMkxCykd6,10,16,9,0,7,0,5,0,37,5.285714285714286,3,0.0,3,9,0,7,13,0,0,5,0,19,18,1
7116,67483,vEVxgcd4BTOgXUZ4VmhnVVivaAZ5TwNb,bWdj2GDclj5ofokWjzoa5jAwMkxCykd6,8,19,9,0,1,0,14,0,43,6.142857142857143,2,0.0,2,9,0,1,17,0,0,14,0,12,31,1
7117,67486,Ey4V2u8lgXOqStmlXh5LfVpeA2fR57Ho,SpATywNh6bZuzm8s1ceuBUnMUAeoAHHw,1,0,0,0,0,0,1,0,1,0.14285714285714285,1,0.0,0,0,0,0,0,0,0,1,0,0,1,1
7118,67492,pUaHa5R2nATh2lieQIvoIQ34ofl1qMpg,RXDvfPUBYFlVdlueBFbLW0mhhAyGEqpt,41,40,2,102,4,1,10,1,160,22.857142857142858,2,0.0,15,2,91,4,25,1,11,10,1,112,48,1
7119,67510,9by6FuLW9p6hAe2x8b5HjrOAjJeqk2av,SpATywNh6bZuzm8s1ceuBUnMUAeoAHHw,61,69,43,37,24,5,13,1,192,27.428571428571427,5,0.0,15,43,32,24,54,5,5,13,1,114,78,0
7120,67511,XiaZKMFLZltgVmLipzSXdXFKLHeDtV4U,SpATywNh6bZuzm8s1ceuBUnMUAeoAHHw,6,7,3,0,1,0,4,0,15,2.142857142857143,2,0.0,0,3,0,1,7,0,0,4,0,4,11,1
7121,67513,XKOZTIyRECata3wyZZEEtiKIhGnxgB74,SpATywNh6bZuzm8s1ceuBUnMUAeoAHHw,5,2,1,0,1,0,3,0,7,1.0,1,0.0,0,1,0,1,2,0,0,3,0,2,5,1
7122,67514,cCePdsnJSYHqdiZSbXBQK6xp3gMbJSPB,SpATywNh6bZuzm8s1ceuBUnMUAeoAHHw,8,2,1,0,1,0,4,1,9,1.2857142857142858,1,0.0,0,1,0,1,2,0,0,4,1,2,7,1
7123,67518,hd2F6jShBoDgDRbyWyB2cglMktEJbDcH,SpATywNh6bZuzm8s1ceuBUnMUAeoAHHw,5,2,1,0,1,0,3,0,7,1.0,1,0.0,0,1,0,1,2,0,0,3,0,2,5,1
7124,67532,GnIRbc6SlMVQELxTtsBRscVXZT2NaPnc,bWdj2GDclj5ofokWjzoa5jAwMkxCykd6,6,10,1,0,0,0,7,0,18,2.5714285714285716,2,0.0,0,1,0,0,10,0,0,7,0,1,17,1
7125,67535,HMMCRStJmM0GACTX8KnkMjogoI7SHUjo,SpATywNh6bZuzm8s1ceuBUnMUAeoAHHw,7,3,1,0,1,0,4,1,10,1.4285714285714286,1,0.0,0,1,0,1,3,0,0,4,1,2,8,1
7126,67539,ZhvYiagkjSANqD9iooXU2LPvYt7TDBNe,G8EPVSXsOYB5YQWZGiz1aVq5Pgr2GrQu,4,3,1,0,1,0,1,0,6,0.8571428571428571,1,0.0,1,1,0,1,2,0,0,1,0,3,3,1
7127,67542,87BKS3OvioYx6sBWp6JvkL3oGnn9HR6v,SpATywNh6bZuzm8s1ceuBUnMUAeoAHHw,6,2,0,0,1,0,6,0,9,1.2857142857142858,1,0.0,0,0,0,1,2,0,0,6,0,1,8,1
7128,67550,ScQd2YUPQVjLNV28id8viiUK1faGo8Du,SpATywNh6bZuzm8s1ceuBUnMUAeoAHHw,16,33,13,5,6,15,16,0,88,12.571428571428571,2,0.0,10,13,5,6,23,15,0,16,0,34,54,1
7129,67560,KpidFAO2tkY7K2KKYbeq2b9OWhsW5M4B,SpATywNh6bZuzm8s1ceuBUnMUAeoAHHw,1,0,0,0,0,0,1,0,1,0.14285714285714285,1,0.0,0,0,0,0,0,0,0,1,0,0,1,1
7130,67564,TyrR2674qqrmqDfJA1ba19pBHw30wbZn,bWdj2GDclj5ofokWjzoa5jAwMkxCykd6,9,11,3,2,2,0,7,1,26,3.7142857142857144,2,0.0,4,3,2,2,7,0,0,7,1,11,15,1
7131,67566,tYJFbmbzeY9dNgPSZvFhNskxnqvhh3AK,SpATywNh6bZuzm8s1ceuBUnMUAeoAHHw,34,48,25,18,10,9,18,2,130,18.571428571428573,7,0.0,6,25,15,10,42,9,3,18,2,56,74,0
7132,67572,HMOOD0QNsPiJ6FSYOiE4GQjvcEPtEXiW,SpATywNh6bZuzm8s1ceuBUnMUAeoAHHw,22,31,12,12,6,0,6,0,67,9.571428571428571,3,0.0,7,12,9,6,24,0,3,6,0,34,33,0
7133,67579,JsUpucQyiTLV5gDB7KrgqzRdiUsoUyeZ,bWdj2GDclj5ofokWjzoa5jAwMkxCykd6,1,0,0,0,0,0,2,0,2,0.2857142857142857,2,0.0,0,0,0,0,0,0,0,2,0,0,2,1
7134,67588,KgPlJUOxzo6K50clHm6VhLAZdTWxAeXA,SpATywNh6bZuzm8s1ceuBUnMUAeoAHHw,12,23,13,4,7,2,18,0,67,9.571428571428571,4,0.0,0,13,4,7,23,2,0,18,0,24,43,1
7135,67589,PiJ3gX6gddDaZL8DcE6EIcui1JUSTcfU,SpATywNh6bZuzm8s1ceuBUnMUAeoAHHw,21,20,13,6,8,16,6,1,70,10.0,2,0.0,3,13,6,8,17,16,0,6,1,30,40,1
7136,67590,iNC1K3GLRLEbKnkKM9DRjQmgl0TV31hj,SpATywNh6bZuzm8s1ceuBUnMUAeoAHHw,8,6,3,0,2,0,3,0,14,2.0,1,0.0,0,3,0,2,6,0,0,3,0,5,9,1
7137,67594,MwsjD881hF2KUCEG3rXUPSq3GKMfMo2d,SpATywNh6bZuzm8s1ceuBUnMUAeoAHHw,6,9,3,0,2,0,2,0,16,2.2857142857142856,2,0.0,0,3,0,2,9,0,0,2,0,5,11,0
7138,67595,FMyTD79DpzQKrXEJ9281Xlgi6vC7oMRz,SpATywNh6bZuzm8s1ceuBUnMUAeoAHHw,17,17,7,17,5,8,10,2,66,9.428571428571429,1,0.0,8,7,16,5,9,8,1,10,2,36,30,1
7139,67596,HMOOD0QNsPiJ6FSYOiE4GQjvcEPtEXiW,bWdj2GDclj5ofokWjzoa5jAwMkxCykd6,5,7,3,0,2,0,2,0,14,2.0,2,0.0,0,3,0,2,7,0,0,2,0,5,9,1
7140,67604,L7L1tCD13b9bwYB3itcIQLsWY4ZOzl4s,bWdj2GDclj5ofokWjzoa5jAwMkxCykd6,6,5,1,0,1,0,2,0,9,1.2857142857142858,1,0.0,0,1,0,1,5,0,0,2,0,2,7,1
7141,67606,zZJSO6J2IdlSRtL9i78S9ARTcFOb9HLo,SpATywNh6bZuzm8s1ceuBUnMUAeoAHHw,14,17,9,17,7,0,3,0,53,7.571428571428571,2,0.0,6,9,16,7,11,0,1,3,0,38,15,1
7142,67616,GkpBYL5A7XxQyiiOJwD69PHsUVDvMfPz,SpATywNh6bZuzm8s1ceuBUnMUAeoAHHw,15,14,10,0,5,0,8,1,38,5.428571428571429,4,0.0,0,10,0,5,14,0,0,8,1,15,23,0
7143,67621,n288BYpWLuFVQQ2eIcifxwEJn9u582IB,G8EPVSXsOYB5YQWZGiz1aVq5Pgr2GrQu,25,45,18,0,10,0,13,1,87,12.428571428571429,2,0.0,21,18,0,10,24,0,0,13,1,49,38,1
7144,67622,Sl7LGszo87N2dywG99gPMorFDWvvcTbU,SpATywNh6bZuzm8s1ceuBUnMUAeoAHHw,17,30,15,12,4,2,8,1,72,10.285714285714286,2,0.0,11,15,11,4,19,2,1,8,1,41,31,1
7145,67627,8AVylVqrvC0I5BhB8uK5ffluG4JxIZF6,SpATywNh6bZuzm8s1ceuBUnMUAeoAHHw,1,0,0,0,0,0,1,0,1,0.14285714285714285,1,0.0,0,0,0,0,0,0,0,1,0,0,1,1
7146,67633,IDjwQPQrnszw6soIGbbAmOia0h5OBccp,SpATywNh6bZuzm8s1ceuBUnMUAeoAHHw,2,0,0,0,0,0,2,0,2,0.2857142857142857,1,0.0,0,0,0,0,0,0,0,2,0,0,2,1
7147,67648,is1YRTEVdAbYSlOww6gWdslOyhkcfPV2,SpATywNh6bZuzm8s1ceuBUnMUAeoAHHw,15,30,14,17,7,2,6,0,76,10.857142857142858,3,0.0,11,14,14,7,19,2,3,6,0,46,30,0
7148,67652,HFAIeLw8Y6ycDg9QeC8e64dlQREKJUgu,SpATywNh6bZuzm8s1ceuBUnMUAeoAHHw,11,15,11,2,6,3,2,0,39,5.571428571428571,1,0.0,2,11,2,6,13,3,0,2,0,21,18,1
7149,67655,tkE1JI2oJkZLA1XOzEZ3Jn8IFDQS4QJ9,G8EPVSXsOYB5YQWZGiz1aVq5Pgr2GrQu,89,181,61,252,24,25,22,2,567,81.0,6,0.0,104,61,180,24,77,25,72,22,2,369,198,0
7150,67663,nBG9NwFfkLReYPd7l4XLlLWLMjwV7w8K,SpATywNh6bZuzm8s1ceuBUnMUAeoAHHw,5,11,6,0,3,0,5,0,25,3.5714285714285716,1,0.0,0,6,0,3,11,0,0,5,0,9,16,1
7151,67664,4GEmQt0JA7IFOeI2xvDzq0AMU7AHzUAO,G8EPVSXsOYB5YQWZGiz1aVq5Pgr2GrQu,1,0,0,0,0,0,1,0,1,0.14285714285714285,1,0.0,0,0,0,0,0,0,0,1,0,0,1,1
7152,67665,4GEmQt0JA7IFOeI2xvDzq0AMU7AHzUAO,RXDvfPUBYFlVdlueBFbLW0mhhAyGEqpt,8,8,1,0,1,0,2,0,12,1.7142857142857142,1,0.0,0,1,0,1,8,0,0,2,0,2,10,1
7153,67671,0ghe43x8DU4ZKEP2rwt8HDtWNCmUsBMb,SpATywNh6bZuzm8s1ceuBUnMUAeoAHHw,3,2,1,0,0,0,1,0,4,0.5714285714285714,1,0.0,0,1,0,0,2,0,0,1,0,1,3,1
7154,67676,HYd5rlFFgGK0QJw1jPObfen7RGCCaTWr,SpATywNh6bZuzm8s1ceuBUnMUAeoAHHw,12,19,2,14,0,0,11,0,46,6.571428571428571,2,0.0,6,2,13,0,13,0,1,11,0,21,25,1
7155,67678,5QFY4jhno4lDKDZjex2aoyci3DX1zToG,SpATywNh6bZuzm8s1ceuBUnMUAeoAHHw,6,3,1,0,1,0,2,0,7,1.0,1,0.0,0,1,0,1,3,0,0,2,0,2,5,1
7156,67679,MSP7eDamCCVYhdl4Hb4ah8yrT6phuW5z,SpATywNh6bZuzm8s1ceuBUnMUAeoAHHw,1,0,0,0,0,0,1,0,1,0.14285714285714285,1,0.0,0,0,0,0,0,0,0,1,0,0,1,1
7157,67682,UgNxeSUTyiiwvKUEwlvxMdHu83PhXRUn,G8EPVSXsOYB5YQWZGiz1aVq5Pgr2GrQu,5,6,1,0,0,0,2,0,9,1.2857142857142858,1,0.0,0,1,0,0,6,0,0,2,0,1,8,1
7158,67684,dQggCBdg5KVSltApPCgVZB7TTUQzzzoI,bWdj2GDclj5ofokWjzoa5jAwMkxCykd6,1,0,0,0,0,0,3,0,3,0.42857142857142855,2,0.0,0,0,0,0,0,0,0,3,0,0,3,1
7159,67685,fZeg9HEKP8oNI2LkglD6L1BrnS7HGXVv,SpATywNh6bZuzm8s1ceuBUnMUAeoAHHw,1,0,0,0,0,0,1,0,1,0.14285714285714285,1,0.0,0,0,0,0,0,0,0,1,0,0,1,1
7160,67686,eWYR1r7NLXWhx2IMzSgNL5MgIoGDCoNF,G8EPVSXsOYB5YQWZGiz1aVq5Pgr2GrQu,8,3,2,0,2,0,7,0,14,2.0,2,0.0,1,2,0,2,2,0,0,7,0,5,9,1
7161,67688,Bi4hHmeTLwTbUCScu9tC6ZZN7frLUhVP,RXDvfPUBYFlVdlueBFbLW0mhhAyGEqpt,8,7,3,0,1,0,4,0,15,2.142857142857143,2,0.0,0,3,0,1,7,0,0,4,0,4,11,1
7162,67690,nPRsjektHdbQkeAf1fIK4JbhrESPbPsA,G8EPVSXsOYB5YQWZGiz1aVq5Pgr2GrQu,11,15,1,8,1,0,2,0,27,3.857142857142857,2,0.0,6,1,5,1,9,0,3,2,0,13,14,0
7163,67692,EVc4qUhPkP7UL5sL9o4Nn0zqfNCNBtZE,SpATywNh6bZuzm8s1ceuBUnMUAeoAHHw,5,5,1,0,0,0,1,0,7,1.0,1,0.0,0,1,0,0,5,0,0,1,0,1,6,1
7164,67701,4TWfM9na19lYGzUwRed2aAXURJ78KWCP,RXDvfPUBYFlVdlueBFbLW0mhhAyGEqpt,12,13,10,0,4,0,8,11,46,6.571428571428571,1,0.0,0,10,0,4,13,0,0,8,11,14,32,1
7165,67710,zDAtaSKsAJQmmJ6xHQBbAGN68vDebyev,SpATywNh6bZuzm8s1ceuBUnMUAeoAHHw,24,33,6,54,2,0,9,0,104,14.857142857142858,5,0.0,11,6,53,2,22,0,1,9,0,72,32,0
7166,67716,wuUYknrhhK9A1rfWPXYwIaIGT1vO8QhA,SpATywNh6bZuzm8s1ceuBUnMUAeoAHHw,9,12,1,12,0,1,2,0,28,4.0,2,0.0,7,1,12,0,5,1,0,2,0,20,8,1
7167,67717,qO8ml6g9ZeMxls7C74RxeVjl6mVWAz7I,RXDvfPUBYFlVdlueBFbLW0mhhAyGEqpt,13,9,0,21,1,0,5,0,36,5.142857142857143,2,0.0,5,0,21,1,4,0,0,5,0,27,9,1
7168,67722,vVABuHEl55FNtayFertBjV9CA1b1uUqW,SpATywNh6bZuzm8s1ceuBUnMUAeoAHHw,14,44,10,23,3,9,4,0,93,13.285714285714286,3,0.0,29,10,18,3,15,9,5,4,0,60,33,1
7169,67726,R2bf9dlDhtEUgfKzXR1GPBa12LhUfZ8W,bWdj2GDclj5ofokWjzoa5jAwMkxCykd6,8,7,2,28,2,1,3,0,43,6.142857142857143,1,0.0,3,2,28,2,4,1,0,3,0,35,8,1
7170,67736,SBdAO3sKpqSlgeWybSBaDHqROjoMpn5T,SpATywNh6bZuzm8s1ceuBUnMUAeoAHHw,8,6,4,0,3,0,2,0,15,2.142857142857143,1,0.0,1,4,0,3,5,0,0,2,0,8,7,1
7171,67737,NcqjzYwttpnmK16DHJYLwVOs33NDqK5j,bWdj2GDclj5ofokWjzoa5jAwMkxCykd6,5,5,3,0,3,0,3,0,14,2.0,2,0.0,0,3,0,3,5,0,0,3,0,6,8,1
7172,67738,7MNV6BxCJmXmzQulnH88qjtXkhlV5cJV,SpATywNh6bZuzm8s1ceuBUnMUAeoAHHw,1,0,0,0,0,0,2,0,2,0.2857142857142857,1,0.0,0,0,0,0,0,0,0,2,0,0,2,1
7173,67747,tV7GilNH4qERxqQG9yXRbyo0vWdEfCmA,bWdj2GDclj5ofokWjzoa5jAwMkxCykd6,2,0,0,0,0,0,2,0,2,0.2857142857142857,1,0.0,0,0,0,0,0,0,0,2,0,0,2,1
7174,67759,51ihx2Bl0VB10raEriHBNStktgNYyJiR,bWdj2GDclj5ofokWjzoa5jAwMkxCykd6,5,0,0,0,0,1,4,1,6,0.8571428571428571,1,0.0,0,0,0,0,0,1,0,4,1,0,6,1
7175,67761,vLffmcT3S49L5a1tJO8Q4Q4dkiJJ7J44,RXDvfPUBYFlVdlueBFbLW0mhhAyGEqpt,6,7,2,0,1,0,2,0,12,1.7142857142857142,1,0.0,3,2,0,1,4,0,0,2,0,6,6,1
7176,67779,bYYoAejjFfWzrfKZwav40GCs4SuO1jAC,SpATywNh6bZuzm8s1ceuBUnMUAeoAHHw,7,2,1,0,1,2,10,1,17,2.4285714285714284,1,0.0,0,1,0,1,2,2,0,10,1,2,15,1
7177,67781,bavq9pAJWJ3ks5oNWHTGf2k9koDwXsAH,RXDvfPUBYFlVdlueBFbLW0mhhAyGEqpt,14,17,12,0,4,2,6,0,41,5.857142857142857,4,0.0,0,12,0,4,17,2,0,6,0,16,25,1
7178,67793,Q97rHk1i5w2LHTlLAzCat2tEB4ZGa9hz,SpATywNh6bZuzm8s1ceuBUnMUAeoAHHw,11,8,5,0,3,1,6,0,23,3.2857142857142856,1,0.0,0,5,0,3,8,1,0,6,0,8,15,1
7179,67796,X2XXZYuDF6JxTO2GjiNfzkEyj4FQesn5,SpATywNh6bZuzm8s1ceuBUnMUAeoAHHw,29,49,14,40,8,28,23,4,166,23.714285714285715,6,0.0,27,14,35,8,22,28,5,23,4,84,82,0
7180,67797,BDbaeDrifYAc4onT7CTIZiQyVNIb3LDx,SpATywNh6bZuzm8s1ceuBUnMUAeoAHHw,1,0,0,0,0,0,1,0,1,0.14285714285714285,1,0.0,0,0,0,0,0,0,0,1,0,0,1,1
7181,67798,Zz1hYW3bIv4cloYkUjUfNR6Tk0kO8ZBM,SpATywNh6bZuzm8s1ceuBUnMUAeoAHHw,13,19,0,12,0,3,19,1,54,7.714285714285714,2,0.0,7,0,12,0,12,3,0,19,1,19,35,1
7182,67803,MVA6iVb95DkbKsEBY1TwCJRFhaq9Spfs,SpATywNh6bZuzm8s1ceuBUnMUAeoAHHw,8,4,3,0,3,0,4,0,14,2.0,1,0.0,0,3,0,3,4,0,0,4,0,6,8,1
7183,67804,A0FFdH0xpvPEedjm7o52yYaFKsMLgpjw,SpATywNh6bZuzm8s1ceuBUnMUAeoAHHw,12,15,1,10,1,8,6,0,41,5.857142857142857,2,0.0,5,1,10,1,10,8,0,6,0,17,24,1
7184,67809,FlsqjVVrWyPYAwe3clQKMsya1OMo4po8,SpATywNh6bZuzm8s1ceuBUnMUAeoAHHw,4,5,1,0,0,0,1,0,7,1.0,1,0.0,2,1,0,0,3,0,0,1,0,3,4,1
7185,67817,CBLeEN4LtKF8I3pqDKXGm8PyJoErUnYX,bWdj2GDclj5ofokWjzoa5jAwMkxCykd6,7,16,6,0,3,6,6,0,37,5.285714285714286,2,0.0,0,6,0,3,16,6,0,6,0,9,28,0
7186,67818,Ve30VVfu3WOSJCl56SL7TQHGBM98BQ3E,bWdj2GDclj5ofokWjzoa5jAwMkxCykd6,2,0,0,0,0,0,2,0,2,0.2857142857142857,1,0.0,0,0,0,0,0,0,0,2,0,0,2,1
7187,67820,opdILbT2IBFIYJvyIT5NXM7ymKeuMTcM,SpATywNh6bZuzm8s1ceuBUnMUAeoAHHw,62,170,118,63,61,48,52,3,515,73.57142857142857,16,0.0,21,118,57,61,149,48,6,52,3,257,258,0
7188,67822,AQTVoGGpVGka0Kb0gVc0xEeMCYW0e1Aj,SpATywNh6bZuzm8s1ceuBUnMUAeoAHHw,12,10,6,0,4,1,3,0,24,3.4285714285714284,1,0.0,2,6,0,4,8,1,0,3,0,12,12,1
7189,67832,Kp7bCEP3w8tCAj2Zcsfolokp8CiYHRrL,SpATywNh6bZuzm8s1ceuBUnMUAeoAHHw,11,10,0,21,0,0,3,0,34,4.857142857142857,1,0.0,4,0,17,0,6,0,4,3,0,21,13,1
7190,67837,FSLduWx3U7kR3IEOy9TPL7q6u3uDMATy,SpATywNh6bZuzm8s1ceuBUnMUAeoAHHw,17,29,15,20,8,7,10,3,92,13.142857142857142,3,0.0,8,15,18,8,21,7,2,10,3,49,43,1
7191,67845,ndNZsN4dzAawDolPqzrjn2BmwgSJmFEf,bWdj2GDclj5ofokWjzoa5jAwMkxCykd6,16,40,4,130,4,23,20,4,225,32.142857142857146,4,0.0,11,4,125,4,29,23,5,20,4,144,81,1
7192,67853,oseHKim5ugRciFh8lXIQ174blllPPfFO,SpATywNh6bZuzm8s1ceuBUnMUAeoAHHw,48,83,39,31,16,36,26,5,236,33.714285714285715,7,0.0,7,39,27,16,76,36,4,26,5,89,147,0
7193,67855,RGHao356rd6STLU5i2lDxhCwgle1rNFw,SpATywNh6bZuzm8s1ceuBUnMUAeoAHHw,13,11,7,0,4,1,7,1,31,4.428571428571429,3,0.0,0,7,0,4,11,1,0,7,1,11,20,1
7194,67867,YJjGstHCH0jRUJlDUc92oNrPq0d0Zijd,SpATywNh6bZuzm8s1ceuBUnMUAeoAHHw,43,54,32,35,17,0,9,0,147,21.0,6,0.0,12,32,31,17,42,0,4,9,0,92,55,1
7195,67869,Tn3HlTIsOQNqv7r0Cv64haAgTvsZ6b4U,SpATywNh6bZuzm8s1ceuBUnMUAeoAHHw,1,0,0,0,0,0,6,0,6,0.8571428571428571,1,0.0,0,0,0,0,0,0,0,6,0,0,6,1
7196,67875,LacgvIbC5Mx6NWAbh5ZFbP873whAiOPf,SpATywNh6bZuzm8s1ceuBUnMUAeoAHHw,7,5,2,0,2,0,2,0,11,1.5714285714285714,2,0.0,0,2,0,2,5,0,0,2,0,4,7,1
7197,67876,yTPe4A1Cw5qKDjYpFW5H73VItf0UPFbm,SpATywNh6bZuzm8s1ceuBUnMUAeoAHHw,15,28,15,0,4,7,12,1,67,9.571428571428571,5,0.0,3,15,0,4,25,7,0,12,1,22,45,1
7198,67897,yKgKNljfs8EwbfiKqNgGPLaIDdrvaFSp,SpATywNh6bZuzm8s1ceuBUnMUAeoAHHw,18,36,14,17,5,0,12,0,84,12.0,5,0.0,2,14,15,5,34,0,2,12,0,36,48,0
7199,67898,hs0BkyfSJv3crs4cIvcxkt53zip5FMPg,bWdj2GDclj5ofokWjzoa5jAwMkxCykd6,5,2,1,0,1,0,2,0,6,0.8571428571428571,1,0.0,0,1,0,1,2,0,0,2,0,2,4,1
7200,67899,p3H39E0dwbDTbdLaprpRXUCSVCX0arUc,SpATywNh6bZuzm8s1ceuBUnMUAeoAHHw,8,5,1,0,1,0,3,3,13,1.8571428571428572,1,0.0,0,1,0,1,5,0,0,3,3,2,11,1
7201,67901,8qABUnBBHxxZkfUhEQNUn5NNMSRrqvPC,RXDvfPUBYFlVdlueBFbLW0mhhAyGEqpt,81,68,40,153,0,17,12,1,291,41.57142857142857,4,0.0,18,40,148,0,50,17,5,12,1,206,85,1
7202,67910,uegc4WtztZ9oPCp3WmAu2ymDghX5YdD7,SpATywNh6bZuzm8s1ceuBUnMUAeoAHHw,8,7,4,0,1,0,10,0,22,3.142857142857143,3,0.0,0,4,0,1,7,0,0,10,0,5,17,0
7203,67917,g7pbT2353K6nDyXKA1Zfrr1XqVe2dRBP,SpATywNh6bZuzm8s1ceuBUnMUAeoAHHw,17,57,28,18,16,27,16,2,164,23.428571428571427,3,0.0,10,28,15,16,47,27,3,16,2,69,95,1
7204,67920,gqL1AoJbIkLDCmEi1SGH37fAu1Zdec1f,SpATywNh6bZuzm8s1ceuBUnMUAeoAHHw,8,15,9,0,2,0,10,0,36,5.142857142857143,4,0.0,0,9,0,2,15,0,0,10,0,11,25,0
7205,67926,ndNZsN4dzAawDolPqzrjn2BmwgSJmFEf,SpATywNh6bZuzm8s1ceuBUnMUAeoAHHw,5,2,0,0,0,0,3,0,5,0.7142857142857143,1,0.0,0,0,0,0,2,0,0,3,0,0,5,1
7206,67942,PXSCTSolyT6nzbTsv2Nsca26yVAoeW5q,SpATywNh6bZuzm8s1ceuBUnMUAeoAHHw,59,77,37,43,19,6,23,3,208,29.714285714285715,6,0.0,27,37,39,19,50,6,4,23,3,122,86,0
7207,67943,jR4AfVlqsecU2OD2EAAPnmIP3mzjfI1q,bWdj2GDclj5ofokWjzoa5jAwMkxCykd6,5,5,3,0,2,0,5,0,15,2.142857142857143,3,0.0,0,3,0,2,5,0,0,5,0,5,10,1
7208,67947,Ybrpv4FlyuZUoocuO2Icsv1UQ9DeHSQ3,RXDvfPUBYFlVdlueBFbLW0mhhAyGEqpt,17,27,4,6,1,0,6,0,44,6.285714285714286,4,0.0,0,4,5,1,27,0,1,6,0,10,34,1
7209,67952,S7PakAxNjFEw6AvrJnn5uzkFmL6Zaill,SpATywNh6bZuzm8s1ceuBUnMUAeoAHHw,5,2,1,0,1,0,3,0,7,1.0,1,0.0,0,1,0,1,2,0,0,3,0,2,5,1
7210,67955,8Kp5E2we1VVLiWHeVTgDcI33lkyZihaL,SpATywNh6bZuzm8s1ceuBUnMUAeoAHHw,3,2,0,0,0,0,1,0,3,0.42857142857142855,1,0.0,0,0,0,0,2,0,0,1,0,0,3,1
7211,67957,NFziKHIzOwiPmHVTsgIR3hdUWupUP7S5,SpATywNh6bZuzm8s1ceuBUnMUAeoAHHw,6,14,1,0,1,0,2,0,18,2.5714285714285716,3,0.0,0,1,0,1,14,0,0,2,0,2,16,1
7212,67960,up9RsivyokQDdIY9XjceWgPIaWSXiHeb,SpATywNh6bZuzm8s1ceuBUnMUAeoAHHw,17,45,2,12,1,8,10,1,79,11.285714285714286,2,0.0,2,2,10,1,43,8,2,10,1,15,64,1
7213,67961,TauShxFiSmmTBchoFAIoZD1cYw24SbpR,SpATywNh6bZuzm8s1ceuBUnMUAeoAHHw,23,96,3,44,0,14,61,2,220,31.428571428571427,5,0.0,21,3,36,0,75,14,8,61,2,60,160,1
7214,67971,tfoakS3EMOjWuYWNRSgWZTjBxe3Mf9Te,RXDvfPUBYFlVdlueBFbLW0mhhAyGEqpt,1,0,0,0,0,0,1,0,1,0.14285714285714285,1,0.0,0,0,0,0,0,0,0,1,0,0,1,1
7215,67972,6iHCxsm5tJiarmhUscvMMFN1oXgIYfGK,SpATywNh6bZuzm8s1ceuBUnMUAeoAHHw,12,18,1,14,1,14,11,0,59,8.428571428571429,2,0.0,4,1,11,1,14,14,3,11,0,17,42,1
7216,67977,tfoakS3EMOjWuYWNRSgWZTjBxe3Mf9Te,G8EPVSXsOYB5YQWZGiz1aVq5Pgr2GrQu,1,0,0,0,0,0,1,0,1,0.14285714285714285,1,0.0,0,0,0,0,0,0,0,1,0,0,1,1
7217,67978,nI7KHCeuUwYkf0rhfMBOC7e8vy7auq4l,SpATywNh6bZuzm8s1ceuBUnMUAeoAHHw,7,3,2,0,2,0,2,0,9,1.2857142857142858,1,0.0,0,2,0,2,3,0,0,2,0,4,5,1
7218,67982,ILI6Vf7i1QDo4pXG14Vgww7LNrHFRhLg,SpATywNh6bZuzm8s1ceuBUnMUAeoAHHw,7,5,0,4,0,0,6,0,15,2.142857142857143,2,0.0,1,0,3,0,4,0,1,6,0,4,11,1
7219,67988,Qy32fNQVMClwOlmUTHDbimblSTgM9GDa,SpATywNh6bZuzm8s1ceuBUnMUAeoAHHw,4,1,0,0,0,0,4,0,5,0.7142857142857143,1,0.0,0,0,0,0,1,0,0,4,0,0,5,1
7220,67993,HwikiMaD2SSDNPWrHLzCjZX0RDgnndHf,bWdj2GDclj5ofokWjzoa5jAwMkxCykd6,5,4,1,0,1,0,1,0,7,1.0,1,0.0,0,1,0,1,4,0,0,1,0,2,5,0
7221,68002,K0IGGULkNaDBoXYWwyrmeTaxQ3RLMvBE,SpATywNh6bZuzm8s1ceuBUnMUAeoAHHw,8,7,3,0,3,0,1,0,14,2.0,1,0.0,0,3,0,3,7,0,0,1,0,6,8,1
7222,68013,CDy3wblikhG2TGdNI3LhbAglknKqeMeq,RXDvfPUBYFlVdlueBFbLW0mhhAyGEqpt,1,0,0,0,0,0,2,0,2,0.2857142857142857,2,0.0,0,0,0,0,0,0,0,2,0,0,2,0
7223,68017,Ea76prVlgHXbifiTXOy9yoJBa7oRFv41,SpATywNh6bZuzm8s1ceuBUnMUAeoAHHw,18,40,2,17,1,8,9,1,78,11.142857142857142,5,0.0,12,2,14,1,28,8,3,9,1,29,49,1
7224,68019,c4Lb4MH2H2BBD2Eny5diwcURGPUNIr88,G8EPVSXsOYB5YQWZGiz1aVq5Pgr2GrQu,17,26,7,14,7,0,2,0,56,8.0,3,0.0,18,7,7,7,8,0,7,2,0,39,17,1
7225,68021,YxdX3NPpzVJ59dpoBODWSD8Noi3lkajj,G8EPVSXsOYB5YQWZGiz1aVq5Pgr2GrQu,186,309,162,484,77,23,43,8,1106,158.0,15,0.0,97,162,363,77,212,23,121,43,8,699,407,0
7226,68042,zHQwuuMF2E73UUayJX1hbmgxSuUBnwou,G8EPVSXsOYB5YQWZGiz1aVq5Pgr2GrQu,30,54,16,58,14,1,13,0,156,22.285714285714285,2,0.0,32,16,41,14,22,1,17,13,0,103,53,0
7227,68049,EBHdi8xR8rUEs7i0QRogmtFZNO8JeTy8,SpATywNh6bZuzm8s1ceuBUnMUAeoAHHw,16,16,7,5,3,2,7,1,41,5.857142857142857,3,0.0,3,7,5,3,13,2,0,7,1,18,23,1
7228,68051,CORJXNhWUR52sdjQNNf8qLspXXnCgswJ,SpATywNh6bZuzm8s1ceuBUnMUAeoAHHw,32,60,15,41,8,17,19,5,165,23.571428571428573,3,0.0,31,15,34,8,29,17,7,19,5,88,77,0
7229,68055,EBLsXyMzbHjWnC0OjjqcacEXrmUIJvTs,SpATywNh6bZuzm8s1ceuBUnMUAeoAHHw,5,2,1,0,1,0,3,0,7,1.0,2,0.0,0,1,0,1,2,0,0,3,0,2,5,1
7230,68058,8qyr4gmatx7C6lBFbhpf1S75SesVpGhm,SpATywNh6bZuzm8s1ceuBUnMUAeoAHHw,16,30,10,17,5,11,12,1,86,12.285714285714286,4,0.0,13,10,15,5,17,11,2,12,1,43,43,0
7231,68061,Y0xpzPU1KVTtj1ZRV6oETnVQafrG6Rxw,G8EPVSXsOYB5YQWZGiz1aVq5Pgr2GrQu,15,17,10,18,4,0,5,0,54,7.714285714285714,2,0.0,3,10,15,4,14,0,3,5,0,32,22,1
7232,68074,C1sQeK9WfNApOsknFeDtbZSozuem8vKZ,SpATywNh6bZuzm8s1ceuBUnMUAeoAHHw,8,10,2,0,1,0,6,1,20,2.857142857142857,1,0.0,0,2,0,1,10,0,0,6,1,3,17,1
7233,68078,w9Zejjae59IiHj98CiIbluCo9JOahx2s,bWdj2GDclj5ofokWjzoa5jAwMkxCykd6,20,20,10,42,7,3,8,2,92,13.142857142857142,1,0.0,7,10,39,7,13,3,3,8,2,63,29,1
7234,68081,C1sQeK9WfNApOsknFeDtbZSozuem8vKZ,bWdj2GDclj5ofokWjzoa5jAwMkxCykd6,1,0,0,0,0,0,1,0,1,0.14285714285714285,1,0.0,0,0,0,0,0,0,0,1,0,0,1,1
7235,68082,C1sQeK9WfNApOsknFeDtbZSozuem8vKZ,G8EPVSXsOYB5YQWZGiz1aVq5Pgr2GrQu,1,0,0,0,0,0,1,0,1,0.14285714285714285,1,0.0,0,0,0,0,0,0,0,1,0,0,1,1
7236,68087,GlnhykNK42Hk2YDmiiI5XtZaM9QknLVN,SpATywNh6bZuzm8s1ceuBUnMUAeoAHHw,14,56,21,11,0,27,26,4,145,20.714285714285715,2,0.0,22,21,10,0,34,27,1,26,4,53,92,1
7237,68088,GIsRCDxWVYGm4So2chhYPzgj7oVxCsSB,RXDvfPUBYFlVdlueBFbLW0mhhAyGEqpt,14,17,3,0,4,0,5,0,29,4.142857142857143,4,0.0,0,3,0,4,17,0,0,5,0,7,22,1
7238,68092,gmQzxzrGOrQhncsrBOMeYdsKsXhK53lF,bWdj2GDclj5ofokWjzoa5jAwMkxCykd6,11,10,4,34,3,0,9,0,60,8.571428571428571,1,0.0,1,4,34,3,9,0,0,9,0,42,18,1
7239,68093,GjzhHwDiXF2E87hVW0UoZGkmnIxus0Jb,G8EPVSXsOYB5YQWZGiz1aVq5Pgr2GrQu,2,0,0,0,0,0,2,0,2,0.2857142857142857,1,0.0,0,0,0,0,0,0,0,2,0,0,2,1
7240,68097,YtgrpGciY5emPU7tatGUnxp8LeEpuZ2R,G8EPVSXsOYB5YQWZGiz1aVq5Pgr2GrQu,1,0,0,0,0,0,1,0,1,0.14285714285714285,1,0.0,0,0,0,0,0,0,0,1,0,0,1,1
7241,68099,bf977a2Ekvsg0xEzQOrZjXRWnBKTxo2i,G8EPVSXsOYB5YQWZGiz1aVq5Pgr2GrQu,20,22,16,14,10,1,2,0,65,9.285714285714286,1,0.0,0,16,13,10,22,1,1,2,0,39,26,1
7242,68102,7rvGs1kznZu35xmEOruWRR3N50tl6czz,bWdj2GDclj5ofokWjzoa5jAwMkxCykd6,8,9,1,10,1,0,2,0,23,3.2857142857142856,1,0.0,1,1,9,1,8,0,1,2,0,12,11,1
7243,68104,6ybGGzfjXeEOFmc8PHowGPQhK4ir7keP,SpATywNh6bZuzm8s1ceuBUnMUAeoAHHw,9,5,1,0,1,4,7,1,19,2.7142857142857144,1,0.0,0,1,0,1,5,4,0,7,1,2,17,1
7244,68107,fJGnkdlpDXyGxGQQghKR3BhEMVARR2Lg,SpATywNh6bZuzm8s1ceuBUnMUAeoAHHw,1,0,0,0,0,0,1,0,1,0.14285714285714285,1,0.0,0,0,0,0,0,0,0,1,0,0,1,1
7245,68108,A0dHL3oOosmNf0Of1dLTB9JxNisZL1pv,SpATywNh6bZuzm8s1ceuBUnMUAeoAHHw,8,10,4,0,3,0,8,0,25,3.5714285714285716,2,0.0,1,4,0,3,9,0,0,8,0,8,17,1
7246,68110,aIu8QzWjQFPb4qaDfl0P1tztYuItpL4R,RXDvfPUBYFlVdlueBFbLW0mhhAyGEqpt,39,54,4,100,1,3,18,2,182,26.0,4,0.0,10,4,94,1,44,3,6,18,2,109,73,1
7247,68114,5PtI5arrhi7X94UIlnofTGsT9hPK6ewX,SpATywNh6bZuzm8s1ceuBUnMUAeoAHHw,5,4,3,0,0,0,1,0,8,1.1428571428571428,1,0.0,0,3,0,0,4,0,0,1,0,3,5,1
7248,68118,Z5b3QXG5aJtKMyvjqd5INn7f1wDhqIm4,SpATywNh6bZuzm8s1ceuBUnMUAeoAHHw,10,12,6,0,4,1,6,0,29,4.142857142857143,3,0.0,1,6,0,4,11,1,0,6,0,11,18,0
7249,68125,6akze6dlAjqRJRBQfIi4wuyuoFxmW6lS,SpATywNh6bZuzm8s1ceuBUnMUAeoAHHw,9,21,9,0,7,0,12,0,49,7.0,1,0.0,0,9,0,7,21,0,0,12,0,16,33,1
7250,68126,gLWYERddjD0e20XUR43WwbF7uNaF2Pgm,bWdj2GDclj5ofokWjzoa5jAwMkxCykd6,6,17,2,0,4,0,1,0,24,3.4285714285714284,1,0.0,0,2,0,4,17,0,0,1,0,6,18,1
7251,68130,gmQzxzrGOrQhncsrBOMeYdsKsXhK53lF,SpATywNh6bZuzm8s1ceuBUnMUAeoAHHw,1,0,0,0,0,0,1,0,1,0.14285714285714285,1,0.0,0,0,0,0,0,0,0,1,0,0,1,1
7252,68133,2NZH8U3WrlujDhhhOcDdw5QM9Su6Hvdq,SpATywNh6bZuzm8s1ceuBUnMUAeoAHHw,12,21,4,14,3,8,2,0,52,7.428571428571429,1,0.0,16,4,13,3,5,8,1,2,0,36,16,1
7253,68138,TnMuPtEYCG1UP1JnaDUM0auIBTc6VjvH,SpATywNh6bZuzm8s1ceuBUnMUAeoAHHw,4,2,0,0,0,0,5,0,7,1.0,1,0.0,0,0,0,0,2,0,0,5,0,0,7,0
7254,68142,78gf8prmiaXO1waYCeS1MI82L5gA5cph,SpATywNh6bZuzm8s1ceuBUnMUAeoAHHw,8,12,3,0,1,5,4,1,26,3.7142857142857144,1,0.0,0,3,0,1,12,5,0,4,1,4,22,1
7255,68155,GlnhykNK42Hk2YDmiiI5XtZaM9QknLVN,G8EPVSXsOYB5YQWZGiz1aVq5Pgr2GrQu,18,35,29,78,11,3,10,0,166,23.714285714285715,2,0.0,2,29,76,11,33,3,2,10,0,118,48,1
7256,68157,WHlJuYfhW4fQXvIRdAMxkZtYXebgfAZs,SpATywNh6bZuzm8s1ceuBUnMUAeoAHHw,7,4,3,0,3,0,2,0,12,1.7142857142857142,1,0.0,0,3,0,3,4,0,0,2,0,6,6,1
7257,68158,ZDEv7xdHlbONQGNdkwzMgbMsJFIzjdrJ,RXDvfPUBYFlVdlueBFbLW0mhhAyGEqpt,17,41,1,16,3,13,11,5,90,12.857142857142858,2,0.0,16,1,13,3,25,13,3,11,5,33,57,1
7258,68159,8PUTYY5GxR5hJrTB9VGuf6OwgmQYLlz6,SpATywNh6bZuzm8s1ceuBUnMUAeoAHHw,17,30,10,18,3,2,14,0,77,11.0,5,0.0,15,10,16,3,15,2,2,14,0,44,33,1
7259,68163,E7q8xgbm4JOITPhixAXraRklJYYNgqh3,SpATywNh6bZuzm8s1ceuBUnMUAeoAHHw,1,0,0,0,0,0,1,0,1,0.14285714285714285,1,0.0,0,0,0,0,0,0,0,1,0,0,1,1
7260,68165,c011xwxkscfGfFvLGjK44gLGvqvYHhED,SpATywNh6bZuzm8s1ceuBUnMUAeoAHHw,13,17,8,3,3,0,10,0,41,5.857142857142857,2,0.0,2,8,3,3,15,0,0,10,0,16,25,1
7261,68175,WAqLnSQyhRD0PYZmBqQYHPqSLjTTUH6O,SpATywNh6bZuzm8s1ceuBUnMUAeoAHHw,15,34,13,18,8,0,7,3,83,11.857142857142858,3,0.0,3,13,16,8,31,0,2,7,3,40,43,1
7262,68181,wCP7MM6FfvdZx8uOqp7AG8m1oFJcqLHB,SpATywNh6bZuzm8s1ceuBUnMUAeoAHHw,28,62,34,12,15,26,34,3,186,26.571428571428573,8,0.0,16,34,9,15,46,26,3,34,3,74,112,1
7263,68182,U8vo2wOZC3Q8EW1kIl6iwoIzgmQUZ4u1,SpATywNh6bZuzm8s1ceuBUnMUAeoAHHw,3,0,0,0,0,2,2,0,4,0.5714285714285714,1,0.0,0,0,0,0,0,2,0,2,0,0,4,1
7264,68191,hkTx4XunczsnVq4H9eVYRZURkkofvB6I,SpATywNh6bZuzm8s1ceuBUnMUAeoAHHw,8,6,3,2,2,0,1,0,14,2.0,1,0.0,0,3,2,2,6,0,0,1,0,7,7,1
7265,68194,3F9rh0xtO3MPjBfGcFPCm9PRbwYuY4I3,SpATywNh6bZuzm8s1ceuBUnMUAeoAHHw,23,46,4,34,1,8,17,1,111,15.857142857142858,9,0.0,9,4,29,1,37,8,5,17,1,43,68,1
7266,68195,PUFh3BsQaDVIJMDvwsFTqkrgAzvjO9ME,bWdj2GDclj5ofokWjzoa5jAwMkxCykd6,3,2,1,0,0,0,1,0,4,0.5714285714285714,1,0.0,0,1,0,0,2,0,0,1,0,1,3,1
7267,68203,6U8VFnPyZYhBRDbe5XdPXo17gTSrU7h6,bWdj2GDclj5ofokWjzoa5jAwMkxCykd6,10,11,7,0,2,10,8,1,39,5.571428571428571,3,0.0,0,7,0,2,11,10,0,8,1,9,30,1
7268,68205,XRUycqJgK6Teg1VieyLPSxgajklcF856,SpATywNh6bZuzm8s1ceuBUnMUAeoAHHw,8,7,1,0,0,5,4,1,18,2.5714285714285716,1,0.0,2,1,0,0,5,5,0,4,1,3,15,0
7269,68206,XZ83JcONkALUi8eW1z8sh8GNkNHnCecC,SpATywNh6bZuzm8s1ceuBUnMUAeoAHHw,17,26,11,25,3,11,11,3,90,12.857142857142858,2,0.0,12,11,19,3,14,11,6,11,3,45,45,1
7270,68208,j4u6F4qZpPKGLDItX0Q2HAWM10zHBR79,SpATywNh6bZuzm8s1ceuBUnMUAeoAHHw,13,19,8,11,3,0,2,0,43,6.142857142857143,1,0.0,7,8,11,3,12,0,0,2,0,29,14,1
7271,68210,6A7JcBAaCtlmyXJds1FDIeGlm0ezPnc3,SpATywNh6bZuzm8s1ceuBUnMUAeoAHHw,12,13,1,17,1,0,4,0,36,5.142857142857143,1,0.0,8,1,16,1,5,0,1,4,0,26,10,1
7272,68212,1fxFMFifV1rQ9EWjOwHxBWikLCyhcjXV,SpATywNh6bZuzm8s1ceuBUnMUAeoAHHw,7,15,1,8,0,0,1,0,25,3.5714285714285716,1,0.0,0,1,6,0,15,0,2,1,0,7,18,1
7273,68222,WnGoJ0X05nmmcr9OBuNGFmD5r4EVF1g6,bWdj2GDclj5ofokWjzoa5jAwMkxCykd6,12,30,16,0,5,34,22,4,111,15.857142857142858,6,0.0,0,16,0,5,30,34,0,22,4,21,90,1
7274,68230,82GMCFQFd0THTrsyKfVm7WvJIFvIx6zJ,bWdj2GDclj5ofokWjzoa5jAwMkxCykd6,1,0,0,0,0,0,1,0,1,0.14285714285714285,1,0.0,0,0,0,0,0,0,0,1,0,0,1,1
7275,68234,CR4gghlbM9RsvrMmN4aq9I8yiSZncbD8,SpATywNh6bZuzm8s1ceuBUnMUAeoAHHw,54,62,35,32,15,0,16,0,160,22.857142857142858,7,0.0,18,35,32,15,44,0,0,16,0,100,60,0
7276,68239,ZGeJlcog0o13nhqeKC2vRvkt6LFvOzyP,SpATywNh6bZuzm8s1ceuBUnMUAeoAHHw,1,0,0,0,0,0,1,0,1,0.14285714285714285,1,0.0,0,0,0,0,0,0,0,1,0,0,1,1
7277,68240,IZwgoYiQOwzeEoIsJbmj0ULJBVLQ8tDo,SpATywNh6bZuzm8s1ceuBUnMUAeoAHHw,6,3,2,0,2,0,1,0,8,1.1428571428571428,1,0.0,0,2,0,2,3,0,0,1,0,4,4,0
7278,68241,i2PPXz5Z5PB2ZfiVAI64TcWxYgJR1QQ1,RXDvfPUBYFlVdlueBFbLW0mhhAyGEqpt,31,28,19,12,10,7,12,1,89,12.714285714285714,6,0.0,0,19,11,10,28,7,1,12,1,40,49,1
7279,68242,zQ0WfWm1cz6xtKNF9R3KOD2OW4OSAkc1,SpATywNh6bZuzm8s1ceuBUnMUAeoAHHw,11,7,6,6,0,0,5,0,24,3.4285714285714284,2,0.0,0,6,5,0,7,0,1,5,0,11,13,1
7280,68248,difzQoAVFjIhhoeyJCnFHhQfdluM0dbZ,G8EPVSXsOYB5YQWZGiz1aVq5Pgr2GrQu,1,0,0,0,0,0,1,0,1,0.14285714285714285,1,0.0,0,0,0,0,0,0,0,1,0,0,1,1
7281,68250,bNThALRhT3LNXximO1paliuB0aPzkqk7,SpATywNh6bZuzm8s1ceuBUnMUAeoAHHw,17,15,7,25,4,47,15,3,116,16.571428571428573,2,0.0,6,7,21,4,9,47,4,15,3,38,78,1
7282,68251,Hy6j11K745hIL1HizKPEi5wjs7F2sOsG,SpATywNh6bZuzm8s1ceuBUnMUAeoAHHw,5,3,1,0,1,0,4,0,9,1.2857142857142858,1,0.0,0,1,0,1,3,0,0,4,0,2,7,1
7283,68252,5N9UtpTd0Iyfm1Amzky3t1R9JrMPidgw,SpATywNh6bZuzm8s1ceuBUnMUAeoAHHw,25,58,23,24,20,0,27,1,153,21.857142857142858,5,0.0,14,23,17,20,44,0,7,27,1,74,79,0
7284,68258,oL1G89Phk4nduULmJ17br7A4xddcHdc4,RXDvfPUBYFlVdlueBFbLW0mhhAyGEqpt,13,16,8,0,3,6,12,1,46,6.571428571428571,5,0.0,1,8,0,3,15,6,0,12,1,12,34,0
7285,68262,jwmMikqyMlJ3SzOUjqLjM22mCL5p25A7,SpATywNh6bZuzm8s1ceuBUnMUAeoAHHw,5,3,1,0,1,0,4,0,9,1.2857142857142858,1,0.0,1,1,0,1,2,0,0,4,0,3,6,1
7286,68263,pbaQcU38LWlEY15kC2Yb0jdLNtMAYhsA,SpATywNh6bZuzm8s1ceuBUnMUAeoAHHw,28,81,40,30,15,0,12,0,178,25.428571428571427,10,0.0,22,40,26,15,59,0,4,12,0,103,75,0
7287,68268,jwN9sgXwQLE8sD1F25K97DLtEDZ0gnxi,SpATywNh6bZuzm8s1ceuBUnMUAeoAHHw,1,0,0,0,0,0,1,0,1,0.14285714285714285,1,0.0,0,0,0,0,0,0,0,1,0,0,1,1
7288,68273,1qOWHE2SxHYAOzNCTuiHl1kSZUHL0gyU,SpATywNh6bZuzm8s1ceuBUnMUAeoAHHw,63,237,102,56,52,16,85,7,555,79.28571428571429,11,0.0,51,102,47,52,186,16,9,85,7,252,303,0
7289,68275,RWU4omSsfIhWMdUidy2dDc2hADqC6J7F,RXDvfPUBYFlVdlueBFbLW0mhhAyGEqpt,1,0,0,0,0,0,1,0,1,0.14285714285714285,1,0.0,0,0,0,0,0,0,0,1,0,0,1,1
7290,68279,S5r0CKOxIwwZ6o4r0E3DEfNq3HUydzP8,SpATywNh6bZuzm8s1ceuBUnMUAeoAHHw,10,11,9,0,7,0,2,0,29,4.142857142857143,1,0.0,0,9,0,7,11,0,0,2,0,16,13,1
7291,68280,0iBsrOe2KnLxk8TGZ7ugYIrItWDyZcX5,bWdj2GDclj5ofokWjzoa5jAwMkxCykd6,1,0,0,0,0,0,1,0,1,0.14285714285714285,1,0.0,0,0,0,0,0,0,0,1,0,0,1,1
7292,68296,b1g4AWG6A2zG5plnQY4paLSHRFnrgObC,G8EPVSXsOYB5YQWZGiz1aVq5Pgr2GrQu,9,21,7,0,2,1,25,0,56,8.0,5,0.0,0,7,0,2,21,1,0,25,0,9,47,1
7293,68299,MzTmeAugUJkvlIkD1VbUcP5NYDEco9Sz,bWdj2GDclj5ofokWjzoa5jAwMkxCykd6,12,9,3,54,3,0,1,0,70,10.0,1,0.0,5,3,51,3,4,0,3,1,0,62,8,1
7294,68305,1Z4DcQGB0iHwU6wAGYAE4UwCDJhJoWI1,SpATywNh6bZuzm8s1ceuBUnMUAeoAHHw,5,2,1,0,1,0,4,0,8,1.1428571428571428,1,0.0,0,1,0,1,2,0,0,4,0,2,6,0
7295,68312,FmmzXResih4xmTvS1USR90U6hsc9smA9,RXDvfPUBYFlVdlueBFbLW0mhhAyGEqpt,6,10,3,0,3,0,1,0,17,2.4285714285714284,2,0.0,0,3,0,3,10,0,0,1,0,6,11,1
7296,68316,FocgTK7ZKP5rXdprEvR0U5yJcvk72CbF,SpATywNh6bZuzm8s1ceuBUnMUAeoAHHw,11,14,6,10,0,9,7,0,46,6.571428571428571,2,0.0,7,6,8,0,7,9,2,7,0,21,25,1
7297,68318,g3PG76pcZjQr6VJ2OlBuhnEf9tLvgXf4,SpATywNh6bZuzm8s1ceuBUnMUAeoAHHw,4,2,1,0,1,0,1,0,5,0.7142857142857143,1,0.0,0,1,0,1,2,0,0,1,0,2,3,1
7298,68321,AOjgDe9pflTNYpkfyCGVCxzTomGLrXC9,G8EPVSXsOYB5YQWZGiz1aVq5Pgr2GrQu,9,7,3,0,2,3,15,1,31,4.428571428571429,1,0.0,2,3,0,2,5,3,0,15,1,7,24,1
7299,68324,VwIVGF64yzO60dfdnqn1D6KZSjw1xNvm,bWdj2GDclj5ofokWjzoa5jAwMkxCykd6,6,19,2,0,1,0,5,0,27,3.857142857142857,3,0.0,0,2,0,1,19,0,0,5,0,3,24,1
7300,68332,hJo1MgKiPZFXuH2ko6hqPTd9dbjMQKDO,SpATywNh6bZuzm8s1ceuBUnMUAeoAHHw,16,42,22,10,8,0,8,0,90,12.857142857142858,8,0.0,10,22,10,8,32,0,0,8,0,50,40,0
7301,68333,8DBF0kTYvtu7h0hsdxFO3EFrNNkmUkiM,SpATywNh6bZuzm8s1ceuBUnMUAeoAHHw,16,17,5,14,3,11,7,0,57,8.142857142857142,2,0.0,10,5,14,3,7,11,0,7,0,32,25,1
7302,68345,SnyeeNQTfkqzknIlQQLm06X1xA6g9a0l,SpATywNh6bZuzm8s1ceuBUnMUAeoAHHw,16,29,9,19,8,12,9,1,87,12.428571428571429,2,0.0,9,9,16,8,20,12,3,9,1,42,45,1
7303,68349,iADE6TgYebHG0th9GrbiEmbQ3Qc3Go8z,RXDvfPUBYFlVdlueBFbLW0mhhAyGEqpt,13,6,6,0,4,0,7,1,24,3.4285714285714284,3,0.0,0,6,0,4,6,0,0,7,1,10,14,1
7304,68351,QkN5nvBbZszJiSQ2f66kudMZ2eWWY8sa,RXDvfPUBYFlVdlueBFbLW0mhhAyGEqpt,6,4,3,0,1,0,1,0,9,1.2857142857142858,1,0.0,0,3,0,1,4,0,0,1,0,4,5,1
7305,68352,clbUGnOQsN7CuaV7idGJ2LVbYN3t8qC3,SpATywNh6bZuzm8s1ceuBUnMUAeoAHHw,36,59,14,27,6,17,12,1,136,19.428571428571427,8,0.0,9,14,25,6,50,17,2,12,1,54,82,0
7306,68357,uxWS9amhXxmjOvqXmZExJSg0LcMFBAvq,G8EPVSXsOYB5YQWZGiz1aVq5Pgr2GrQu,7,3,2,0,1,0,6,0,12,1.7142857142857142,2,0.0,0,2,0,1,3,0,0,6,0,3,9,1
7307,68360,4pJW5s4UUKXpxe6ChNDK23aeXIukgMH8,SpATywNh6bZuzm8s1ceuBUnMUAeoAHHw,16,17,6,17,4,17,10,1,72,10.285714285714286,1,0.0,3,6,14,4,14,17,3,10,1,27,45,1
7308,68362,tlaj4fnwxWl22MIDqzqpAu1L2vA1lQmh,bWdj2GDclj5ofokWjzoa5jAwMkxCykd6,12,23,14,16,7,10,8,1,79,11.285714285714286,4,0.0,3,14,15,7,20,10,1,8,1,39,40,1
7309,68363,0F1DhnfuH8hFtOjZ8dWmoNBQat6tI7Te,SpATywNh6bZuzm8s1ceuBUnMUAeoAHHw,9,9,5,0,2,1,10,2,29,4.142857142857143,2,0.0,0,5,0,2,9,1,0,10,2,7,22,1
7310,68364,2FyRSMemMx0WQNXDNdLObUL8ox2VWXod,SpATywNh6bZuzm8s1ceuBUnMUAeoAHHw,48,87,51,35,28,9,20,0,230,32.857142857142854,12,0.0,10,51,31,28,77,9,4,20,0,120,110,1
7311,68365,SG7hB83Yya2DA2E0NTjAVNa4uzxtdA6s,SpATywNh6bZuzm8s1ceuBUnMUAeoAHHw,9,9,2,0,0,2,6,1,20,2.857142857142857,1,0.0,0,2,0,0,9,2,0,6,1,2,18,1
7312,68371,xBU5Obte2st2JNuH81iN4TihJEa7jvrL,SpATywNh6bZuzm8s1ceuBUnMUAeoAHHw,1,0,0,0,0,0,2,0,2,0.2857142857142857,1,0.0,0,0,0,0,0,0,0,2,0,0,2,1
7313,68379,b4M5OphEGf9HhlcR04bazUL6wKV8uIkU,G8EPVSXsOYB5YQWZGiz1aVq5Pgr2GrQu,81,102,4,199,5,85,21,10,426,60.857142857142854,8,0.0,21,4,177,5,81,85,22,21,10,207,219,1
7314,68388,R2V0izPrSC9aiv4wxr7ZUbqHHqyQkLxw,bWdj2GDclj5ofokWjzoa5jAwMkxCykd6,4,2,1,0,1,0,1,0,5,0.7142857142857143,1,0.0,0,1,0,1,2,0,0,1,0,2,3,1
7315,68395,lTZusowYpBCkpVlkG3X20kNgU6aMOOBS,SpATywNh6bZuzm8s1ceuBUnMUAeoAHHw,17,18,7,18,3,3,15,1,65,9.285714285714286,3,0.0,8,7,15,3,10,3,3,15,1,33,32,1
7316,68397,td9JVyRGLfbXKWE7ys0aQ9IRUtJd97NP,bWdj2GDclj5ofokWjzoa5jAwMkxCykd6,5,2,1,0,1,0,3,0,7,1.0,1,0.0,0,1,0,1,2,0,0,3,0,2,5,1
7317,68398,LNdimqsJkOxQDP9dT4IGwewg9YvH7zfV,SpATywNh6bZuzm8s1ceuBUnMUAeoAHHw,16,35,18,6,5,8,6,0,78,11.142857142857142,5,0.0,9,18,6,5,26,8,0,6,0,38,40,1
7318,68399,TTmbjhCeX7YmnFUettVVam4HwYq17paa,SpATywNh6bZuzm8s1ceuBUnMUAeoAHHw,4,5,0,0,0,0,4,0,9,1.2857142857142858,2,0.0,0,0,0,0,5,0,0,4,0,0,9,0
7319,68406,fWzpIAl5AhTFdJeUPdzJHspdUzMjFUYM,bWdj2GDclj5ofokWjzoa5jAwMkxCykd6,5,3,2,0,1,0,5,0,11,1.5714285714285714,2,0.0,0,2,0,1,3,0,0,5,0,3,8,1
7320,68411,4vxCaGfGDr7qH4ipzhuoVimWrYG1kGYQ,bWdj2GDclj5ofokWjzoa5jAwMkxCykd6,17,47,22,58,6,52,43,4,232,33.142857142857146,4,0.0,3,22,49,6,44,52,9,43,4,80,152,1
7321,68412,0KxBv7TNEUj27dsp2zMGG4WpBswpgOyf,SpATywNh6bZuzm8s1ceuBUnMUAeoAHHw,13,26,16,10,2,0,10,0,64,9.142857142857142,7,0.0,0,16,10,2,26,0,0,10,0,28,36,0
7322,68423,bET2Moo4lPgmSBI2ZHgAloQD25b1Jinn,G8EPVSXsOYB5YQWZGiz1aVq5Pgr2GrQu,17,18,8,30,4,0,3,0,63,9.0,3,0.0,0,8,28,4,18,0,2,3,0,40,23,1
7323,68424,7XeEjaT7Rw76VaeBef1jnkEycygog40I,SpATywNh6bZuzm8s1ceuBUnMUAeoAHHw,9,16,8,0,7,0,2,0,33,4.714285714285714,1,0.0,2,8,0,7,14,0,0,2,0,17,16,1
7324,68426,4a1LmrNqPaRbQL0Q68aycdhtteXqXTMU,SpATywNh6bZuzm8s1ceuBUnMUAeoAHHw,5,2,1,0,1,0,2,0,6,0.8571428571428571,1,0.0,0,1,0,1,2,0,0,2,0,2,4,1
7325,68435,dYES117kkj3IhCPWFa9k6hhXgoc7YknJ,G8EPVSXsOYB5YQWZGiz1aVq5Pgr2GrQu,8,4,1,0,0,6,6,1,18,2.5714285714285716,1,0.0,0,1,0,0,4,6,0,6,1,1,17,1
7326,68438,nnZGKhMV6zkzSC8Qzeh7UPQIZVHpp5uX,bWdj2GDclj5ofokWjzoa5jAwMkxCykd6,1,0,0,0,0,0,1,0,1,0.14285714285714285,1,0.0,0,0,0,0,0,0,0,1,0,0,1,1
7327,68439,6H5tZYvQXUXA5x38gvAZ0WgqLjIkqn3b,SpATywNh6bZuzm8s1ceuBUnMUAeoAHHw,8,5,2,0,2,0,3,0,12,1.7142857142857142,2,0.0,0,2,0,2,5,0,0,3,0,4,8,1
7328,68442,v8CV9SymhVbpaH5nH9XVMeR4jjsMeKhG,G8EPVSXsOYB5YQWZGiz1aVq5Pgr2GrQu,15,5,4,20,3,0,2,0,34,4.857142857142857,1,0.0,0,4,17,3,5,0,3,2,0,24,10,1
7329,68455,HzaFh1I0rWfjYqs3kd2mhXywhDrDBNWZ,bWdj2GDclj5ofokWjzoa5jAwMkxCykd6,8,17,5,0,2,3,9,1,37,5.285714285714286,3,0.0,2,5,0,2,15,3,0,9,1,9,28,1
7330,68463,CJyFZrp4dFxNPWh98LYOwXSivShmskBg,SpATywNh6bZuzm8s1ceuBUnMUAeoAHHw,7,3,2,0,2,0,2,0,9,1.2857142857142858,1,0.0,0,2,0,2,3,0,0,2,0,4,5,1
7331,68467,4VUauTz2C9X4SCHk8ugs49B1paCitpmU,G8EPVSXsOYB5YQWZGiz1aVq5Pgr2GrQu,22,14,13,42,5,1,12,1,88,12.571428571428571,1,0.0,0,13,37,5,14,1,5,12,1,55,33,1
7332,68475,FCvIa0IivvqNa6modx0mbEXg1jcpQzBN,SpATywNh6bZuzm8s1ceuBUnMUAeoAHHw,1,0,0,0,0,0,1,0,1,0.14285714285714285,1,0.0,0,0,0,0,0,0,0,1,0,0,1,1
7333,68483,b3xaxczfVryBkeC1YPbXWEZUleYIZAnq,bWdj2GDclj5ofokWjzoa5jAwMkxCykd6,7,5,4,0,2,0,5,0,16,2.2857142857142856,2,0.0,1,4,0,2,4,0,0,5,0,7,9,1
7334,68485,v6euctfbzWthWyLBlYjaRzf7ryZssgjA,bWdj2GDclj5ofokWjzoa5jAwMkxCykd6,1,0,0,0,0,0,1,0,1,0.14285714285714285,1,0.0,0,0,0,0,0,0,0,1,0,0,1,1
7335,68494,yvCmfQ3z3fMLbjXX0h1AIIPVh4np9hhq,SpATywNh6bZuzm8s1ceuBUnMUAeoAHHw,42,81,36,53,15,6,22,1,214,30.571428571428573,8,0.0,33,36,47,15,48,6,6,22,1,131,83,0
7336,68496,SI82MK5h5zRoUuXAAtKY5ltobDSBBXh9,bWdj2GDclj5ofokWjzoa5jAwMkxCykd6,21,32,16,132,9,0,10,1,200,28.571428571428573,2,0.0,10,16,128,9,22,0,4,10,1,163,37,1
7337,68500,IhUEedXCjE6LoKReKNbXGS4Fqk4t4GUl,SpATywNh6bZuzm8s1ceuBUnMUAeoAHHw,7,5,1,0,1,0,3,0,10,1.4285714285714286,1,0.0,0,1,0,1,5,0,0,3,0,2,8,1
7338,68509,hkI32MAgHvJ4T3I3Up79daEJ8l4sKHaC,bWdj2GDclj5ofokWjzoa5jAwMkxCykd6,20,26,12,156,11,29,9,1,244,34.857142857142854,3,0.0,9,12,146,11,17,29,10,9,1,178,66,1
7339,68511,Q9VYSqOD2rxffT9mHJg8GtdPL5OsLSDn,G8EPVSXsOYB5YQWZGiz1aVq5Pgr2GrQu,5,2,1,0,1,0,3,0,7,1.0,1,0.0,0,1,0,1,2,0,0,3,0,2,5,1
7340,68513,PRgLfGkxJHP58QbJdXg5l5vWjuJI88nv,SpATywNh6bZuzm8s1ceuBUnMUAeoAHHw,25,26,15,12,9,15,8,0,85,12.142857142857142,4,0.0,7,15,9,9,19,15,3,8,0,40,45,1
7341,68516,6oCDtYWE1YbVTX7pVBS5Cflb4KyRNNI9,SpATywNh6bZuzm8s1ceuBUnMUAeoAHHw,7,5,4,0,4,1,3,1,18,2.5714285714285716,2,0.0,0,4,0,4,5,1,0,3,1,8,10,1
7342,68521,iSIDy53M1GeZpXt46JkUT1CVMnifiRBT,bWdj2GDclj5ofokWjzoa5jAwMkxCykd6,6,4,1,0,1,1,3,1,11,1.5714285714285714,2,0.0,0,1,0,1,4,1,0,3,1,2,9,1
7343,68543,kS5Tu2RHO9HzXMOZp3CUIdzW6Y8prRRh,SpATywNh6bZuzm8s1ceuBUnMUAeoAHHw,35,67,2,46,1,12,14,1,143,20.428571428571427,6,0.0,23,2,40,1,44,12,6,14,1,66,77,1
7344,68544,neZ18tPUzdX2s40f6yVBysxDUKCDyzmG,SpATywNh6bZuzm8s1ceuBUnMUAeoAHHw,14,22,2,13,2,0,4,0,43,6.142857142857143,2,0.0,10,2,12,2,12,0,1,4,0,26,17,0
7345,68551,NfUq1iJeG4DoVU66A3eQnbdSJYCM4IOC,SpATywNh6bZuzm8s1ceuBUnMUAeoAHHw,6,3,2,0,1,0,2,0,8,1.1428571428571428,1,0.0,0,2,0,1,3,0,0,2,0,3,5,1
7346,68555,vle68wJbpBxaKK8jTIIpU222057lhydD,bWdj2GDclj5ofokWjzoa5jAwMkxCykd6,4,3,1,0,1,0,2,0,7,1.0,1,0.0,0,1,0,1,3,0,0,2,0,2,5,1
7347,68561,Y3Qq9FqOVwUj6PrB3KNsrLngzeSzadt5,bWdj2GDclj5ofokWjzoa5jAwMkxCykd6,9,12,5,2,2,0,6,0,27,3.857142857142857,2,0.0,1,5,2,2,11,0,0,6,0,10,17,1
7348,68563,8fwUYmiU3p577nM1EutDr5QOZIKfzBRc,RXDvfPUBYFlVdlueBFbLW0mhhAyGEqpt,108,172,85,214,40,67,38,20,636,90.85714285714286,14,0.0,41,85,201,40,131,67,13,38,20,367,269,0
7349,68567,IFerpKRFijjTvFKVmnLPfRMMDF4cIZJF,SpATywNh6bZuzm8s1ceuBUnMUAeoAHHw,7,4,0,0,0,0,5,0,9,1.2857142857142858,1,0.0,0,0,0,0,4,0,0,5,0,0,9,1
7350,68585,Glxmm6OkKDEBHVvI7QqNEC5RvmqUE0HS,bWdj2GDclj5ofokWjzoa5jAwMkxCykd6,4,3,2,0,1,0,2,0,8,1.1428571428571428,1,0.0,0,2,0,1,3,0,0,2,0,3,5,1
7351,68590,E8oGkXDZccLFAlXi9bJFdyG7ZjuPGPVx,bWdj2GDclj5ofokWjzoa5jAwMkxCykd6,6,5,3,0,2,0,6,0,16,2.2857142857142856,1,0.0,0,3,0,2,5,0,0,6,0,5,11,1
7352,68593,ko8ha9Nr4wk6DeuPN4U2tszPncta4AJu,RXDvfPUBYFlVdlueBFbLW0mhhAyGEqpt,6,5,2,0,2,0,1,0,10,1.4285714285714286,1,0.0,0,2,0,2,5,0,0,1,0,4,6,1
7353,68594,rPL0mqKklpGJ7nKQwJfgLcDkUtLeeh8C,SpATywNh6bZuzm8s1ceuBUnMUAeoAHHw,1,0,0,0,0,0,1,0,1,0.14285714285714285,1,0.0,0,0,0,0,0,0,0,1,0,0,1,1
7354,68600,w4KVb9q7mwoVRgCyZI0dPAL72VxyapbO,SpATywNh6bZuzm8s1ceuBUnMUAeoAHHw,17,25,10,10,4,13,23,1,86,12.285714285714286,2,0.0,12,10,9,4,13,13,1,23,1,35,51,0
7355,68608,xKFuemwLTt1HbT05n0729C3MfJQfGzio,bWdj2GDclj5ofokWjzoa5jAwMkxCykd6,8,8,2,0,2,0,4,0,16,2.2857142857142856,2,0.0,0,2,0,2,8,0,0,4,0,4,12,1
7356,68614,oA0E9aMtllY5HCZuDmQFAhbdEUxnmzHK,SpATywNh6bZuzm8s1ceuBUnMUAeoAHHw,14,13,5,18,3,5,6,0,50,7.142857142857143,2,0.0,5,5,15,3,8,5,3,6,0,28,22,1
7357,68615,mPyp7jTeTZOoi8uKfW9n4yxp1m3yxLU6,SpATywNh6bZuzm8s1ceuBUnMUAeoAHHw,16,12,6,11,3,3,7,1,43,6.142857142857143,2,0.0,3,6,10,3,9,3,1,7,1,22,21,1
7358,68623,F5DvCuAufOHMNW6g3uuO7OUr15Bgdj9y,SpATywNh6bZuzm8s1ceuBUnMUAeoAHHw,36,74,21,38,8,20,18,0,179,25.571428571428573,6,0.0,14,21,34,8,60,20,4,18,0,77,102,0
7359,68633,EoHwSWSzaw8CNhaYKiwnwX4BUG0jVkiR,G8EPVSXsOYB5YQWZGiz1aVq5Pgr2GrQu,28,35,10,95,5,0,7,0,152,21.714285714285715,2,0.0,20,10,79,5,15,0,16,7,0,114,38,1
7360,68643,800D5qwHCt3Ko9pzEVC49paGCt6dYzm8,bWdj2GDclj5ofokWjzoa5jAwMkxCykd6,14,61,32,26,10,79,18,0,226,32.285714285714285,6,0.0,11,32,23,10,50,79,3,18,0,76,150,1
7361,68645,uSpti6Yw7qPzPT4S4dLtJ0lPSlE5C6Xf,RXDvfPUBYFlVdlueBFbLW0mhhAyGEqpt,1,0,0,0,0,0,1,0,1,0.14285714285714285,1,0.0,0,0,0,0,0,0,0,1,0,0,1,1
7362,68648,xHynkOdioqQyjpJfj8K7fiM1HqYlBJD7,SpATywNh6bZuzm8s1ceuBUnMUAeoAHHw,9,9,5,0,4,0,8,0,26,3.7142857142857144,2,0.0,0,5,0,4,9,0,0,8,0,9,17,1
7363,68652,HVM7cvH7tmJviHLVmU4moAWMBQcFDIXR,SpATywNh6bZuzm8s1ceuBUnMUAeoAHHw,1,0,0,0,0,0,1,0,1,0.14285714285714285,1,0.0,0,0,0,0,0,0,0,1,0,0,1,1
7364,68663,uWg9viAyRsUVYkVv3Yy7uJ56PNmRweOf,SpATywNh6bZuzm8s1ceuBUnMUAeoAHHw,7,3,1,0,1,1,3,0,9,1.2857142857142858,1,0.0,0,1,0,1,3,1,0,3,0,2,7,1
7365,68668,LJN1NW4KDrkfGUEkF9SJPSL4rdPIFcim,bWdj2GDclj5ofokWjzoa5jAwMkxCykd6,9,14,0,8,3,15,8,1,49,7.0,2,0.0,8,0,8,3,6,15,0,8,1,19,30,1
7366,68669,UpJrRBQ59x3Gn5L7s007cXh7Wi1pgqj5,G8EPVSXsOYB5YQWZGiz1aVq5Pgr2GrQu,1,0,0,0,0,0,1,0,1,0.14285714285714285,1,0.0,0,0,0,0,0,0,0,1,0,0,1,1
7367,68672,XlAtLUmCwQMJblZxz5Uj8YKvORzQq8sL,bWdj2GDclj5ofokWjzoa5jAwMkxCykd6,2,0,0,0,0,0,2,0,2,0.2857142857142857,1,0.0,0,0,0,0,0,0,0,2,0,0,2,1
7368,68673,LDvIjeK3BrrUiPE6HdHKfvDgiWdtz8gl,bWdj2GDclj5ofokWjzoa5jAwMkxCykd6,5,5,2,0,1,0,3,0,11,1.5714285714285714,2,0.0,0,2,0,1,5,0,0,3,0,3,8,1
7369,68675,ZBFATksKEZIW0yZpEc4DInpubrEeq3eS,SpATywNh6bZuzm8s1ceuBUnMUAeoAHHw,16,22,11,4,5,0,1,0,43,6.142857142857143,4,0.0,2,11,4,5,20,0,0,1,0,22,21,1
7370,68684,wL3zK87VyJEaxj3JDk5zLpiovNVlVgY0,SpATywNh6bZuzm8s1ceuBUnMUAeoAHHw,9,4,3,0,3,0,3,0,13,1.8571428571428572,1,0.0,0,3,0,3,4,0,0,3,0,6,7,1
7371,68685,0sGUIxoauZHFSZVR3Y4LtOM6Pq2DRxjU,SpATywNh6bZuzm8s1ceuBUnMUAeoAHHw,6,2,1,0,1,0,3,0,7,1.0,1,0.0,0,1,0,1,2,0,0,3,0,2,5,1
7372,68686,YRBA7GRiLrrlZjduaK8N9tfqRO36138H,SpATywNh6bZuzm8s1ceuBUnMUAeoAHHw,24,53,19,37,6,0,12,0,127,18.142857142857142,7,0.0,10,19,32,6,43,0,5,12,0,67,60,0
7373,68690,vsAcPV04LnM01WalbcA4jNxiuu2qNyeQ,SpATywNh6bZuzm8s1ceuBUnMUAeoAHHw,46,127,20,59,9,32,23,3,273,39.0,16,0.0,45,20,57,9,82,32,2,23,3,131,142,0
7374,68694,SPA2zjP6CEFeNMb3HCTy4jT9WpFTBDct,SpATywNh6bZuzm8s1ceuBUnMUAeoAHHw,28,37,13,29,7,1,9,1,97,13.857142857142858,3,0.0,5,13,27,7,32,1,2,9,1,52,45,1
7375,68698,L0kYOQ1jlQCXWFfUIC5KdixPfS0gzVfJ,SpATywNh6bZuzm8s1ceuBUnMUAeoAHHw,1,0,0,0,0,0,1,0,1,0.14285714285714285,1,0.0,0,0,0,0,0,0,0,1,0,0,1,1
7376,68702,vX3VPIJhPCYSA7dPeCf6CgdqKnk7djlz,SpATywNh6bZuzm8s1ceuBUnMUAeoAHHw,1,0,0,0,0,0,1,0,1,0.14285714285714285,1,0.0,0,0,0,0,0,0,0,1,0,0,1,1
7377,68706,i1TcNs7eTFFk7oCk5M8KreZU8FvcW9bN,SpATywNh6bZuzm8s1ceuBUnMUAeoAHHw,5,1,1,0,1,3,2,0,8,1.1428571428571428,1,0.0,0,1,0,1,1,3,0,2,0,2,6,1
7378,68714,AUQbcN6sP8jOc3r7pDcomR6R8baoxLvG,SpATywNh6bZuzm8s1ceuBUnMUAeoAHHw,9,9,4,0,3,0,5,0,21,3.0,1,0.0,1,4,0,3,8,0,0,5,0,8,13,1
7379,68715,naqtjO9tZgTvMaAs9wVFgT7OrPAljiOn,bWdj2GDclj5ofokWjzoa5jAwMkxCykd6,6,6,2,0,1,0,5,0,14,2.0,3,0.0,1,2,0,1,5,0,0,5,0,4,10,1
7380,68725,v9XA8V9r9cuRk407xmjctqU28ZOWPjKH,SpATywNh6bZuzm8s1ceuBUnMUAeoAHHw,11,14,2,14,1,9,4,0,44,6.285714285714286,2,0.0,4,2,13,1,10,9,1,4,0,20,24,1
7381,68726,9DFLyn8rbv9Edwun9eQjrB5tgbqXjOr5,RXDvfPUBYFlVdlueBFbLW0mhhAyGEqpt,13,24,11,0,8,3,10,1,57,8.142857142857142,3,0.0,2,11,0,8,22,3,0,10,1,21,36,1
7382,68728,OPI0XMiYXF2KbjFje02yg2IsfXd4KQW0,G8EPVSXsOYB5YQWZGiz1aVq5Pgr2GrQu,1,0,0,0,0,0,1,0,1,0.14285714285714285,1,0.0,0,0,0,0,0,0,0,1,0,0,1,1
7383,68729,fgHXEx1kTgwNtn0duzRnGZnTM9G4nrHz,SpATywNh6bZuzm8s1ceuBUnMUAeoAHHw,7,6,4,0,3,0,2,0,15,2.142857142857143,2,0.0,0,4,0,3,6,0,0,2,0,7,8,1
7384,68734,U7RYhML9VmouEXOzi3jihOcHs1Odr6nQ,SpATywNh6bZuzm8s1ceuBUnMUAeoAHHw,4,2,1,0,1,2,2,0,8,1.1428571428571428,1,0.0,0,1,0,1,2,2,0,2,0,2,6,1
7385,68735,3JdonxNhNI9NQjhEwg0qbYv0wUomYvrC,SpATywNh6bZuzm8s1ceuBUnMUAeoAHHw,5,6,4,0,0,0,5,0,15,2.142857142857143,2,0.0,0,4,0,0,6,0,0,5,0,4,11,1
7386,68738,8mpNTb2f22eIFQe95nOOySrTvXoHGtkW,SpATywNh6bZuzm8s1ceuBUnMUAeoAHHw,5,1,1,0,0,0,4,0,6,0.8571428571428571,1,0.0,0,1,0,0,1,0,0,4,0,1,5,1
7387,68742,kv6R7WjolUetaoWMs79hGLWsktu3yDdz,bWdj2GDclj5ofokWjzoa5jAwMkxCykd6,16,39,5,0,5,0,9,0,58,8.285714285714286,2,0.0,12,5,0,5,27,0,0,9,0,22,36,1
7388,68744,Gt9BtVmn4m8oLlyiIlUegGAp2m9g8UFD,SpATywNh6bZuzm8s1ceuBUnMUAeoAHHw,12,14,7,0,3,0,8,1,33,4.714285714285714,3,0.0,0,7,0,3,14,0,0,8,1,10,23,1
7389,68753,i3mc4Kbynj5lAgvXLfa16WvI77RFTi9E,SpATywNh6bZuzm8s1ceuBUnMUAeoAHHw,13,21,4,17,1,11,9,3,66,9.428571428571429,2,0.0,15,4,16,1,6,11,1,9,3,36,30,1
7390,68756,GbO46rd9u4nTIYKWQ4uqsc2u6MxCvlf3,bWdj2GDclj5ofokWjzoa5jAwMkxCykd6,8,17,10,0,0,0,10,0,37,5.285714285714286,4,0.0,2,10,0,0,15,0,0,10,0,12,25,1
7391,68766,o9OiuR1V9DDjBMFIfw7sS4DiqEBIQuP8,SpATywNh6bZuzm8s1ceuBUnMUAeoAHHw,1,0,0,0,0,0,1,0,1,0.14285714285714285,1,0.0,0,0,0,0,0,0,0,1,0,0,1,1
7392,68769,RtEFZWMpyIRlgcponU0BmtpKa8uVqiIS,bWdj2GDclj5ofokWjzoa5jAwMkxCykd6,8,8,2,0,1,19,9,1,40,5.714285714285714,3,0.0,2,2,0,1,6,19,0,9,1,5,35,1
7393,68770,yo49sG8PZONryMrR1vxvvUfG4Kw6dJSG,bWdj2GDclj5ofokWjzoa5jAwMkxCykd6,1,0,0,0,0,0,1,0,1,0.14285714285714285,1,0.0,0,0,0,0,0,0,0,1,0,0,1,1
7394,68773,G1AwzYA13F3hOahvKjBBoTuWWSrXyEmf,SpATywNh6bZuzm8s1ceuBUnMUAeoAHHw,8,20,1,0,1,1,18,0,41,5.857142857142857,4,0.0,1,1,0,1,19,1,0,18,0,3,38,1
7395,68774,b7XeenIAmbbWWMDukegOQ8zSwFKoA3Yg,SpATywNh6bZuzm8s1ceuBUnMUAeoAHHw,6,10,1,0,1,0,5,0,17,2.4285714285714284,2,0.0,0,1,0,1,10,0,0,5,0,2,15,1
7396,68779,r5IH8s4isWFYMIVZOSBCnIzOrNuqNLMt,RXDvfPUBYFlVdlueBFbLW0mhhAyGEqpt,2,0,0,0,0,0,3,0,3,0.42857142857142855,1,0.0,0,0,0,0,0,0,0,3,0,0,3,1
7397,68781,THXcc2NGn7OhkfHl1lLehmfkJwTtl0vs,SpATywNh6bZuzm8s1ceuBUnMUAeoAHHw,18,18,8,15,3,37,14,2,97,13.857142857142858,5,0.0,6,8,15,3,12,37,0,14,2,32,65,1
7398,68782,0txLoRwFKi6b3jBavBHeGS8Bc3NOwsVb,SpATywNh6bZuzm8s1ceuBUnMUAeoAHHw,6,2,1,0,1,1,4,0,9,1.2857142857142858,2,0.0,0,1,0,1,2,1,0,4,0,2,7,1
7399,68784,QhYcOEapN0nrffEwA6S7jQzZwToRePP8,SpATywNh6bZuzm8s1ceuBUnMUAeoAHHw,5,7,5,0,0,0,2,0,14,2.0,2,0.0,0,5,0,0,7,0,0,2,0,5,9,1
7400,68786,zikfbKKf6UwbalVzNX9BImZBlJFR20fk,bWdj2GDclj5ofokWjzoa5jAwMkxCykd6,5,0,0,0,0,2,7,0,9,1.2857142857142858,2,0.0,0,0,0,0,0,2,0,7,0,0,9,1
7401,68792,SmrYmgxL1AB7vaaR6Foc1c7Uyze9dDt7,RXDvfPUBYFlVdlueBFbLW0mhhAyGEqpt,1,0,0,0,0,0,1,0,1,0.14285714285714285,1,0.0,0,0,0,0,0,0,0,1,0,0,1,1
7402,68797,7BZDKYSiNttbGsEOSXAkMuiEhZ6QNT9G,bWdj2GDclj5ofokWjzoa5jAwMkxCykd6,16,27,15,46,2,38,5,1,134,19.142857142857142,2,0.0,10,15,42,2,17,38,4,5,1,69,65,1
7403,68805,xjDtTrSSXACX8VZBwSxlHbYQJ7eeUCIt,SpATywNh6bZuzm8s1ceuBUnMUAeoAHHw,5,2,1,0,1,0,2,0,6,0.8571428571428571,2,0.0,0,1,0,1,2,0,0,2,0,2,4,1
7404,68807,3vpFIgzmYroxEHJb2wiXr0H3xcuBXZTn,SpATywNh6bZuzm8s1ceuBUnMUAeoAHHw,1,0,0,0,0,0,1,0,1,0.14285714285714285,1,0.0,0,0,0,0,0,0,0,1,0,0,1,1
7405,68830,RqkVdaWIELGLgdM7036pqEWeMvYmKVEW,A3fsA9Zfv1X2fVEQhTw51lKENdNrEqT3,1,0,0,0,0,0,1,0,1,0.14285714285714285,1,0.0,0,0,0,0,0,0,0,1,0,0,1,1
7406,68831,SmLgezr6vw2mXwO7w10XynKKHaO5xE5n,SpATywNh6bZuzm8s1ceuBUnMUAeoAHHw,17,19,8,8,4,4,10,1,54,7.714285714285714,3,0.0,3,8,8,4,16,4,0,10,1,23,31,1
7407,68843,B2BG30LLtuU2kSL0uylbi1RWlBzZcLDB,SpATywNh6bZuzm8s1ceuBUnMUAeoAHHw,7,4,2,0,2,0,2,0,10,1.4285714285714286,1,0.0,0,2,0,2,4,0,0,2,0,4,6,1
7408,68844,EleMlloryvuXR0G9AOtui0gfdXfrUQfc,SpATywNh6bZuzm8s1ceuBUnMUAeoAHHw,11,25,1,0,0,2,24,2,54,7.714285714285714,5,0.0,2,1,0,0,23,2,0,24,2,3,51,1
7409,68868,FvJCcTNYroCUcSPHSotcunzGZyPy4Qi0,SpATywNh6bZuzm8s1ceuBUnMUAeoAHHw,1,0,0,0,0,0,1,0,1,0.14285714285714285,1,0.0,0,0,0,0,0,0,0,1,0,0,1,1
7410,68880,abcXzTNrOBL75IbG8Oh34uJmizkY4tz5,SpATywNh6bZuzm8s1ceuBUnMUAeoAHHw,5,2,0,0,0,0,5,3,10,1.4285714285714286,1,0.0,0,0,0,0,2,0,0,5,3,0,10,1
7411,68881,8cN2OVniTirjZQCsN0ZQrtldoXZmf2q1,SpATywNh6bZuzm8s1ceuBUnMUAeoAHHw,1,0,0,0,0,0,1,0,1,0.14285714285714285,1,0.0,0,0,0,0,0,0,0,1,0,0,1,1
7412,68888,de81RIzfVtIgQfKrUlwLBazhrka9zYFQ,RXDvfPUBYFlVdlueBFbLW0mhhAyGEqpt,44,29,19,80,13,6,6,0,153,21.857142857142858,2,0.0,9,19,78,13,20,6,2,6,0,119,34,1
7413,68902,ZNvFH7xCRnWt4senPXcU6KKoaNuuuPfc,SpATywNh6bZuzm8s1ceuBUnMUAeoAHHw,15,13,9,8,4,8,6,1,49,7.0,1,0.0,1,9,7,4,12,8,1,6,1,21,28,1
7414,68909,dgs5q517os0QP00EQ3rFo0TcrFNCs1kW,RXDvfPUBYFlVdlueBFbLW0mhhAyGEqpt,18,15,7,22,3,0,1,0,48,6.857142857142857,1,0.0,3,7,18,3,12,0,4,1,0,31,17,1
7415,68914,KwglP5SNsu1REAmS7zGy1xBBD4v1B0TU,A3fsA9Zfv1X2fVEQhTw51lKENdNrEqT3,2,0,0,0,0,0,3,0,3,0.42857142857142855,1,0.0,0,0,0,0,0,0,0,3,0,0,3,1
7416,68924,ekbuMTLYQMuR0OvEI2LJUhDBg5Hzduc2,SpATywNh6bZuzm8s1ceuBUnMUAeoAHHw,13,14,8,6,3,4,6,0,41,5.857142857142857,2,0.0,0,8,5,3,14,4,1,6,0,16,25,1
7417,68932,yDiB1gdGW97IDQmCuLOgxDpZ8bOAbVfO,SpATywNh6bZuzm8s1ceuBUnMUAeoAHHw,10,3,3,0,3,0,3,0,12,1.7142857142857142,1,0.0,0,3,0,3,3,0,0,3,0,6,6,1
7418,68936,FsS49SZqT6XuQy2tX0gejqco4jQwOMN4,SpATywNh6bZuzm8s1ceuBUnMUAeoAHHw,29,31,17,21,8,0,2,0,79,11.285714285714286,2,0.0,11,17,17,8,20,0,4,2,0,53,26,0
7419,68939,qUJHOEJOIUq6GHsEj06xYmT7rQa6YMuP,SpATywNh6bZuzm8s1ceuBUnMUAeoAHHw,8,6,4,0,3,0,3,0,16,2.2857142857142856,2,0.0,0,4,0,3,6,0,0,3,0,7,9,1
7420,68944,iLiEQfwv1SBVYie6f2UeSo0gjqwSPq60,SpATywNh6bZuzm8s1ceuBUnMUAeoAHHw,12,16,2,14,0,1,3,1,37,5.285714285714286,2,0.0,7,2,13,0,9,1,1,3,1,22,15,1
7421,68957,03OlEjthtH7bdIcwtrFwO8IymW2gZt4t,SpATywNh6bZuzm8s1ceuBUnMUAeoAHHw,24,66,2,43,1,47,27,8,194,27.714285714285715,5,0.0,21,2,35,1,45,47,8,27,8,59,135,0
7422,68961,Ivwf4DZ9PeaEe6riRbe3YhY3mU61V7Rv,SpATywNh6bZuzm8s1ceuBUnMUAeoAHHw,8,6,3,0,2,0,2,0,13,1.8571428571428572,1,0.0,1,3,0,2,5,0,0,2,0,6,7,1
7423,68965,wyjPcrAJWPhHnDHJIjk8dYEEg9jaoLeO,A3fsA9Zfv1X2fVEQhTw51lKENdNrEqT3,5,2,1,0,1,0,3,0,7,1.0,2,0.0,0,1,0,1,2,0,0,3,0,2,5,1
7424,68982,jvjNqoblvibp0tKoaV1BTGpJ4j9v7r5a,SpATywNh6bZuzm8s1ceuBUnMUAeoAHHw,7,13,3,0,2,0,6,0,24,3.4285714285714284,2,0.0,3,3,0,2,10,0,0,6,0,8,16,0
7425,68983,drUu3tyovHqnF7EAaPHayHDYbWMe2Od6,SpATywNh6bZuzm8s1ceuBUnMUAeoAHHw,1,0,0,0,0,0,2,0,2,0.2857142857142857,2,0.0,0,0,0,0,0,0,0,2,0,0,2,1
7426,68985,xHLXHkY22B9ev5t6W5YAgehgj6yjfueC,bWdj2GDclj5ofokWjzoa5jAwMkxCykd6,2,0,0,0,0,0,3,0,3,0.42857142857142855,1,0.0,0,0,0,0,0,0,0,3,0,0,3,1
7427,68990,Plvb7aRlGh6MOUAvNEeJPeQdOD4FTpby,SpATywNh6bZuzm8s1ceuBUnMUAeoAHHw,6,2,1,0,1,0,4,0,8,1.1428571428571428,1,0.0,0,1,0,1,2,0,0,4,0,2,6,1
7428,69002,f6sYAy41OQsdqlcuUmQWoHmf9GvB4eiI,SpATywNh6bZuzm8s1ceuBUnMUAeoAHHw,8,8,3,0,1,0,7,0,19,2.7142857142857144,2,0.0,0,3,0,1,8,0,0,7,0,4,15,1
7429,69017,fo11APiMDJF2DjuYtDFoBE2X6zRUvD0O,A3fsA9Zfv1X2fVEQhTw51lKENdNrEqT3,7,4,3,0,0,1,4,0,12,1.7142857142857142,1,0.0,0,3,0,0,4,1,0,4,0,3,9,1
7430,69030,fvADHkZjzAohNYEqPdzq6kjINkcTeJGs,SpATywNh6bZuzm8s1ceuBUnMUAeoAHHw,1,0,0,0,0,0,1,0,1,0.14285714285714285,1,0.0,0,0,0,0,0,0,0,1,0,0,1,1
7431,69035,Z71mo3axv3ChUzLxRVr9u5krFj7IoCv8,SpATywNh6bZuzm8s1ceuBUnMUAeoAHHw,1,0,0,0,0,0,1,0,1,0.14285714285714285,1,0.0,0,0,0,0,0,0,0,1,0,0,1,1
7432,69038,DanoP5XpHODQZmwuFGZgNKBiu5nY9yH1,A3fsA9Zfv1X2fVEQhTw51lKENdNrEqT3,39,25,14,68,11,0,4,0,122,17.428571428571427,2,0.0,5,14,59,11,20,0,9,4,0,89,33,1
7433,69046,iOxekl9VdW2ENNqFsiAkjUDt6XuQIiCO,G8EPVSXsOYB5YQWZGiz1aVq5Pgr2GrQu,9,17,2,0,1,1,12,1,34,4.857142857142857,2,0.0,2,2,0,1,15,1,0,12,1,5,29,1
7434,69051,NCEmznACf7J3BIMI6JIs4ZzQnHlfSjOZ,SpATywNh6bZuzm8s1ceuBUnMUAeoAHHw,2,0,0,0,0,0,2,0,2,0.2857142857142857,1,0.0,0,0,0,0,0,0,0,2,0,0,2,1
7435,69066,0a6HihupPBi4xpjolN637qOYG6WSN1Gx,SpATywNh6bZuzm8s1ceuBUnMUAeoAHHw,49,184,100,32,43,40,35,0,434,62.0,11,0.0,51,100,29,43,133,40,3,35,0,223,211,0
7436,69070,g5yKalRrHBvoyNkzpNTa67etQfVwykko,SpATywNh6bZuzm8s1ceuBUnMUAeoAHHw,59,92,48,78,32,10,12,1,273,39.0,8,0.0,29,48,67,32,63,10,11,12,1,176,97,0
7437,69076,cy1UxkAxcqJswFy9Syqm01bsE17PQcla,SpATywNh6bZuzm8s1ceuBUnMUAeoAHHw,46,95,51,55,19,21,41,2,284,40.57142857142857,14,0.0,16,51,43,19,79,21,12,41,2,129,155,0
7438,69081,BByvTH8isxSvKoMrLrxzWQ5eR0EYxeSe,SpATywNh6bZuzm8s1ceuBUnMUAeoAHHw,8,9,4,0,3,1,7,0,24,3.4285714285714284,3,0.0,0,4,0,3,9,1,0,7,0,7,17,1
7439,69087,sydTASQZF88RFtSW5G7BxBO6Hd5gV1Jf,A3fsA9Zfv1X2fVEQhTw51lKENdNrEqT3,43,51,23,90,16,2,8,1,191,27.285714285714285,2,0.0,5,23,72,16,46,2,18,8,1,116,75,1
7440,69088,tZsLQPiwQA1iRhDP7AIV5FXBJBCNasRN,SpATywNh6bZuzm8s1ceuBUnMUAeoAHHw,5,3,1,0,1,0,2,0,7,1.0,1,0.0,0,1,0,1,3,0,0,2,0,2,5,1
7441,69090,jtRxF2WWWP8ViskFgfl6yKIsTs5XUZVy,SpATywNh6bZuzm8s1ceuBUnMUAeoAHHw,5,2,1,0,1,0,2,0,6,0.8571428571428571,1,0.0,0,1,0,1,2,0,0,2,0,2,4,1
7442,69096,JsUpucQyiTLV5gDB7KrgqzRdiUsoUyeZ,SpATywNh6bZuzm8s1ceuBUnMUAeoAHHw,1,0,0,0,0,0,1,0,1,0.14285714285714285,1,0.0,0,0,0,0,0,0,0,1,0,0,1,1
7443,69098,EXVoxE3v0YCKVCUy0azISc65MiXBDpAw,SpATywNh6bZuzm8s1ceuBUnMUAeoAHHw,13,12,6,0,3,0,7,0,28,4.0,2,0.0,2,6,0,3,10,0,0,7,0,11,17,1
7444,69099,JQSlrp0DjB9to2Jj4hPDSm3T2LtQheyt,SpATywNh6bZuzm8s1ceuBUnMUAeoAHHw,1,0,0,0,0,0,1,0,1,0.14285714285714285,1,0.0,0,0,0,0,0,0,0,1,0,0,1,1
7445,69111,1pa7pgDaPKVXrmbNpHMbk5nmhTlNRGem,bWdj2GDclj5ofokWjzoa5jAwMkxCykd6,1,0,0,0,0,0,1,0,1,0.14285714285714285,1,0.0,0,0,0,0,0,0,0,1,0,0,1,1
7446,69118,27R6lnSTl4HmEumP2huFCqg7wjTw1o6f,SpATywNh6bZuzm8s1ceuBUnMUAeoAHHw,12,18,7,0,2,3,16,3,49,7.0,3,0.0,0,7,0,2,18,3,0,16,3,9,40,1
7447,69122,JsUpucQyiTLV5gDB7KrgqzRdiUsoUyeZ,A3fsA9Zfv1X2fVEQhTw51lKENdNrEqT3,1,0,0,0,0,0,1,0,1,0.14285714285714285,1,0.0,0,0,0,0,0,0,0,1,0,0,1,1
7448,69127,y7mamutAMELy79Bgdj0zOeVjiQ071oNX,bWdj2GDclj5ofokWjzoa5jAwMkxCykd6,6,4,2,0,1,0,5,0,12,1.7142857142857142,2,0.0,0,2,0,1,4,0,0,5,0,3,9,1
7449,69130,pGYLDmhkSj1iBp1YljlDSId0XSrjZNZR,SpATywNh6bZuzm8s1ceuBUnMUAeoAHHw,27,29,18,19,9,0,9,0,84,12.0,8,0.0,4,18,18,9,25,0,1,9,0,49,35,1
7450,69136,dcJzvjKrpatpLnXddQ3Vx9PLCNP0aaAz,SpATywNh6bZuzm8s1ceuBUnMUAeoAHHw,5,2,1,0,1,0,2,0,6,0.8571428571428571,1,0.0,0,1,0,1,2,0,0,2,0,2,4,1
7451,69138,C5Rja3fyOmRxfpM2pXQmwA2G5rEfb320,SpATywNh6bZuzm8s1ceuBUnMUAeoAHHw,33,70,2,34,1,2,26,2,137,19.571428571428573,5,0.0,11,2,29,1,59,2,5,26,2,43,94,1
7452,69140,EJxY61pifGLoX5582yQzVg4H77fLkSml,A3fsA9Zfv1X2fVEQhTw51lKENdNrEqT3,5,2,1,0,1,0,5,0,9,1.2857142857142858,1,0.0,0,1,0,1,2,0,0,5,0,2,7,1
7453,69142,YLA48gUHn1Dc2R5xXAOe8bpBqZ5RWVW4,bWdj2GDclj5ofokWjzoa5jAwMkxCykd6,1,0,0,0,0,0,1,0,1,0.14285714285714285,1,0.0,0,0,0,0,0,0,0,1,0,0,1,1
7454,69160,Vnhhp2QbBiDiUTTHmXkksXuO8NCNMbjj,A3fsA9Zfv1X2fVEQhTw51lKENdNrEqT3,16,11,7,0,7,0,4,0,29,4.142857142857143,2,0.0,0,7,0,7,11,0,0,4,0,14,15,1
7455,69163,Oc5qPJBdwZoUrwnszLfpz6LxBxG1LBA2,SpATywNh6bZuzm8s1ceuBUnMUAeoAHHw,1,0,0,0,0,0,1,0,1,0.14285714285714285,1,0.0,0,0,0,0,0,0,0,1,0,0,1,1
7456,69170,RfZCGgQvqSwCxzUkNgQBjxizWHoR00JV,SpATywNh6bZuzm8s1ceuBUnMUAeoAHHw,1,0,0,0,0,0,1,0,1,0.14285714285714285,1,0.0,0,0,0,0,0,0,0,1,0,0,1,1
7457,69172,g2ieOC0GwkKqaZWeJNXowTArkXtXRKC6,SpATywNh6bZuzm8s1ceuBUnMUAeoAHHw,1,0,0,0,0,0,2,0,2,0.2857142857142857,2,0.0,0,0,0,0,0,0,0,2,0,0,2,0
7458,69179,WX5bge9EFbPypYuObEiSD1Gyvh8Z866G,A3fsA9Zfv1X2fVEQhTw51lKENdNrEqT3,68,47,39,0,34,0,8,0,128,18.285714285714285,4,0.0,0,39,0,34,47,0,0,8,0,73,55,1
7459,69184,2qz1ezmlR3R3fKwgJceAEHpik5SGv87j,SpATywNh6bZuzm8s1ceuBUnMUAeoAHHw,1,0,0,0,0,0,1,0,1,0.14285714285714285,1,0.0,0,0,0,0,0,0,0,1,0,0,1,1
7460,69193,R8klv9uflG5co96NLU45hbr8n54FLcZh,SpATywNh6bZuzm8s1ceuBUnMUAeoAHHw,1,0,0,0,0,0,1,0,1,0.14285714285714285,1,0.0,0,0,0,0,0,0,0,1,0,0,1,1
7461,69194,pngME6c5Y6LdP7X9v20FCeYjZ97OMCQR,SpATywNh6bZuzm8s1ceuBUnMUAeoAHHw,11,7,1,11,0,1,4,1,25,3.5714285714285716,1,0.0,2,1,10,0,5,1,1,4,1,13,12,1
7462,69199,CpruMjpYp2wLmRpTC4dJZ8iwMDhltzag,RXDvfPUBYFlVdlueBFbLW0mhhAyGEqpt,10,5,1,11,1,0,2,0,20,2.857142857142857,2,0.0,1,1,10,1,4,0,1,2,0,13,7,1
7463,69213,WX5bge9EFbPypYuObEiSD1Gyvh8Z866G,bWdj2GDclj5ofokWjzoa5jAwMkxCykd6,9,4,2,12,2,0,2,0,22,3.142857142857143,1,0.0,1,2,11,2,3,0,1,2,0,16,6,0
7464,69218,YZJnbvfbnhVRirLqDRHGzQv4606Wu6TO,bWdj2GDclj5ofokWjzoa5jAwMkxCykd6,12,23,15,0,8,2,7,1,56,8.0,4,0.0,2,15,0,8,21,2,0,7,1,25,31,1
7465,69224,65ggrHSAXoVCOK75IinKW9i4EJF8EDcN,SpATywNh6bZuzm8s1ceuBUnMUAeoAHHw,6,3,1,0,1,0,3,0,8,1.1428571428571428,2,0.0,0,1,0,1,3,0,0,3,0,2,6,1
7466,69233,W8K4VS8rPvnPTNUJrqgtS2FKH93KmR91,A3fsA9Zfv1X2fVEQhTw51lKENdNrEqT3,70,86,43,194,17,3,18,0,361,51.57142857142857,7,0.0,2,43,166,17,84,3,28,18,0,228,133,1
7467,69258,8O10QoLvReRhqOHRxozXCjfp01CP9Y6X,RXDvfPUBYFlVdlueBFbLW0mhhAyGEqpt,5,2,1,0,1,0,2,0,6,0.8571428571428571,1,0.0,0,1,0,1,2,0,0,2,0,2,4,1
7468,69261,Y0yiSfPX9V0A8oNPfdzCuT5yHRuHvSj6,SpATywNh6bZuzm8s1ceuBUnMUAeoAHHw,23,18,12,14,5,0,6,1,56,8.0,3,0.0,2,12,14,5,16,0,0,6,1,33,23,1
7469,69262,X9IKf8GgqS6dvoKX3VBo51mIr8yb4uFC,A3fsA9Zfv1X2fVEQhTw51lKENdNrEqT3,63,88,37,54,23,5,20,5,232,33.142857142857146,3,0.0,9,37,51,23,79,5,3,20,5,120,112,1
7470,69266,ZutC6FPMJvnUSI7oc7F8Om4NpwtKuyEH,SpATywNh6bZuzm8s1ceuBUnMUAeoAHHw,8,5,2,0,2,0,3,0,12,1.7142857142857142,1,0.0,0,2,0,2,5,0,0,3,0,4,8,1
7471,69270,2XqSSCGvWuNVBTm3MCFePDMOSuloLKPQ,SpATywNh6bZuzm8s1ceuBUnMUAeoAHHw,8,4,1,0,1,3,4,0,13,1.8571428571428572,4,0.0,0,1,0,1,4,3,0,4,0,2,11,1
7472,69273,61kObDGseAVKKKJnoykLCdN2clfrzPTZ,SpATywNh6bZuzm8s1ceuBUnMUAeoAHHw,20,26,10,16,8,0,5,0,65,9.285714285714286,2,0.0,6,10,13,8,20,0,3,5,0,37,28,1
7473,69279,HKRHFribtFXCazZMADj8ySc6wcBJmS1L,A3fsA9Zfv1X2fVEQhTw51lKENdNrEqT3,10,4,3,0,2,1,6,0,16,2.2857142857142856,1,0.0,0,3,0,2,4,1,0,6,0,5,11,1
7474,69295,NGQ6HXbhxwBlJxikVxca5noX2u8xI9AV,bWdj2GDclj5ofokWjzoa5jAwMkxCykd6,17,17,7,50,10,0,1,0,85,12.142857142857142,1,0.0,9,7,43,10,8,0,7,1,0,69,16,0
7475,69304,JR238GZjZ1ruNiJtwVaWypz6LFnrEv5m,A3fsA9Zfv1X2fVEQhTw51lKENdNrEqT3,10,10,5,0,0,1,19,1,36,5.142857142857143,3,0.0,0,5,0,0,10,1,0,19,1,5,31,1
7476,69305,1RaxWRR42BzbDLa8H5HkFu4x9YPe7T0C,A3fsA9Zfv1X2fVEQhTw51lKENdNrEqT3,9,4,2,0,2,0,6,0,14,2.0,1,0.0,1,2,0,2,3,0,0,6,0,5,9,1
7477,69313,JZ8D07WpMQUIA2O2a3f2Q2gV7h70rqbC,SpATywNh6bZuzm8s1ceuBUnMUAeoAHHw,15,22,11,8,6,32,7,0,86,12.285714285714286,4,0.0,7,11,7,6,15,32,1,7,0,31,55,1
7478,69343,hSBgpCIALinoasvGugUi15XiQqzIP0W5,SpATywNh6bZuzm8s1ceuBUnMUAeoAHHw,11,34,10,0,6,1,16,0,67,9.571428571428571,2,0.0,0,10,0,6,34,1,0,16,0,16,51,1
7479,69344,mAEhdvjtLD2ESiLI6ko7GgTTKTJ1f5Tn,SpATywNh6bZuzm8s1ceuBUnMUAeoAHHw,12,46,13,15,1,5,6,1,87,12.428571428571429,2,0.0,29,13,13,1,17,5,2,6,1,56,31,1
7480,69346,4G8hhK38eDoUtZ2viIFKnYiWqmC4nF56,SpATywNh6bZuzm8s1ceuBUnMUAeoAHHw,21,44,4,10,0,0,7,0,65,9.285714285714286,4,0.0,16,4,10,0,28,0,0,7,0,30,35,1
7481,69347,mhllqKKDFjXI3RWMG7mLE4M16FOLrFxr,SpATywNh6bZuzm8s1ceuBUnMUAeoAHHw,4,3,1,0,1,1,1,0,7,1.0,1,0.0,0,1,0,1,3,1,0,1,0,2,5,1
7482,69364,4cOOYrtQdvpiZuIPnsoBt4lhRdbqEcsp,SpATywNh6bZuzm8s1ceuBUnMUAeoAHHw,13,13,0,12,0,0,3,0,28,4.0,2,0.0,5,0,12,0,8,0,0,3,0,17,11,1
7483,69369,uMEUDlZ1tL8WoZ2EmL0CStSYwA0zOal8,bWdj2GDclj5ofokWjzoa5jAwMkxCykd6,10,6,3,8,2,0,5,0,24,3.4285714285714284,2,0.0,1,3,8,2,5,0,0,5,0,14,10,1
7484,69370,YsoUugdKj0wstrontIOHZ151jgNGqxCe,G8EPVSXsOYB5YQWZGiz1aVq5Pgr2GrQu,8,6,3,0,2,0,3,0,14,2.0,2,0.0,0,3,0,2,6,0,0,3,0,5,9,1
7485,69386,yeibveOoJwlHHcJycB6lhQvIP04mhNkZ,SpATywNh6bZuzm8s1ceuBUnMUAeoAHHw,7,11,0,0,0,0,1,0,12,1.7142857142857142,1,0.0,1,0,0,0,10,0,0,1,0,1,11,1
7486,69392,TmRAKP6Cldz70hzdom0pqdRRs9qbBLvD,SpATywNh6bZuzm8s1ceuBUnMUAeoAHHw,4,1,0,0,0,0,3,0,4,0.5714285714285714,1,0.0,0,0,0,0,1,0,0,3,0,0,4,1
7487,69404,EB2RCe088gjmT7cbJrt6urBwZOusH5vg,SpATywNh6bZuzm8s1ceuBUnMUAeoAHHw,24,46,23,27,11,0,9,0,116,16.571428571428573,3,0.0,15,23,24,11,31,0,3,9,0,73,43,1
7488,69407,cpYO1CIRym9qUpCwm4jnjZ21HfSKew1t,SpATywNh6bZuzm8s1ceuBUnMUAeoAHHw,20,26,1,15,1,4,14,1,62,8.857142857142858,2,0.0,9,1,15,1,17,4,0,14,1,26,36,1
7489,69418,Wb7djzeQ8T0CrP6nbbq8WdqHClynqFRu,SpATywNh6bZuzm8s1ceuBUnMUAeoAHHw,1,0,0,0,0,0,1,0,1,0.14285714285714285,1,0.0,0,0,0,0,0,0,0,1,0,0,1,1
7490,69422,1taO8BWZHffh7l7BaqgWcQJY3gQ1z1ac,A3fsA9Zfv1X2fVEQhTw51lKENdNrEqT3,5,0,0,0,0,0,5,1,6,0.8571428571428571,1,0.0,0,0,0,0,0,0,0,5,1,0,6,1
7491,69426,2iC0lVJQRHLawEI3r58K4Wl79T69zQyN,G8EPVSXsOYB5YQWZGiz1aVq5Pgr2GrQu,6,4,0,0,0,2,6,0,12,1.7142857142857142,1,0.0,0,0,0,0,4,2,0,6,0,0,12,1
7492,69435,vPqhvdjrX3GgCAjq6K96tYCv7DiMTBkh,SpATywNh6bZuzm8s1ceuBUnMUAeoAHHw,35,66,4,27,2,0,15,0,114,16.285714285714285,7,0.0,13,4,26,2,53,0,1,15,0,45,69,0
7493,69437,tHPSGx00vsFzhzr0zwBlWWarqJT4wPHF,bWdj2GDclj5ofokWjzoa5jAwMkxCykd6,18,17,11,36,7,0,3,0,74,10.571428571428571,3,0.0,3,11,35,7,14,0,1,3,0,56,18,1
7494,69438,QDpN8D19Mr8RZumTONWpZNlCWcHCCTbH,SpATywNh6bZuzm8s1ceuBUnMUAeoAHHw,5,5,1,0,0,0,2,0,8,1.1428571428571428,2,0.0,0,1,0,0,5,0,0,2,0,1,7,1
7495,69439,WELjmgdsP962Pc1teJ96xvofKraKe6qa,A3fsA9Zfv1X2fVEQhTw51lKENdNrEqT3,29,29,20,30,12,36,28,4,159,22.714285714285715,7,0.0,0,20,28,12,29,36,2,28,4,60,99,1
7496,69443,JnRbwXg3XGYAmOXQP1OiJxv44LsKYQS5,SpATywNh6bZuzm8s1ceuBUnMUAeoAHHw,21,26,1,26,1,5,11,1,71,10.142857142857142,4,0.0,7,1,23,1,19,5,3,11,1,32,39,0
7497,69444,sfdgnQL9ZJy8iQoJsTh6pz33V1sjsZlD,A3fsA9Zfv1X2fVEQhTw51lKENdNrEqT3,58,49,39,0,30,0,11,0,129,18.428571428571427,4,0.0,0,39,0,30,49,0,0,11,0,69,60,0
7498,69452,30KFUYZeibWx0Iky00wqYaxS7YWNwWx4,SpATywNh6bZuzm8s1ceuBUnMUAeoAHHw,5,5,2,0,1,0,1,0,9,1.2857142857142858,1,0.0,0,2,0,1,5,0,0,1,0,3,6,1
7499,69466,DcPL5Zur8S33yRX2fv1HxqidGklhFV5P,SpATywNh6bZuzm8s1ceuBUnMUAeoAHHw,22,34,17,18,7,2,10,1,89,12.714285714285714,3,0.0,9,17,15,7,25,2,3,10,1,48,41,1
7500,69471,x9up4wvnaS79M9udGA7fqhv1sigb86bK,SpATywNh6bZuzm8s1ceuBUnMUAeoAHHw,8,7,4,0,2,3,4,0,20,2.857142857142857,2,0.0,0,4,0,2,7,3,0,4,0,6,14,1
7501,69477,FlAkKX6ow9SvOzk0dTWPWgnX5766zY29,G8EPVSXsOYB5YQWZGiz1aVq5Pgr2GrQu,26,40,20,32,11,0,5,0,108,15.428571428571429,4,0.0,5,20,27,11,35,0,5,5,0,63,45,0
7502,69478,8tkFlxYnls5Mxd2ekCeWIpaKuJe1mR6W,G8EPVSXsOYB5YQWZGiz1aVq5Pgr2GrQu,19,25,8,12,8,4,6,1,64,9.142857142857142,1,0.0,15,8,7,8,10,4,5,6,1,38,26,1
7503,69499,oG7qUH6PFRXdknLnOhOWneHPtBW8Ta2o,A3fsA9Zfv1X2fVEQhTw51lKENdNrEqT3,3,0,0,0,0,0,3,0,3,0.42857142857142855,1,0.0,0,0,0,0,0,0,0,3,0,0,3,0
7504,69500,pNxcbeMWYcUZBxJCtPF9qmCQyBYd1bU7,SpATywNh6bZuzm8s1ceuBUnMUAeoAHHw,29,40,20,32,9,2,14,0,117,16.714285714285715,4,0.0,14,20,30,9,26,2,2,14,0,73,44,1
7505,69536,F6yoJDYdOCdZg3HrTm4YkvnDfcsvPtnN,SpATywNh6bZuzm8s1ceuBUnMUAeoAHHw,7,6,3,0,2,0,1,0,12,1.7142857142857142,1,0.0,0,3,0,2,6,0,0,1,0,5,7,1
7506,69538,RCYov8DEPqszWUDtrunbywhn5eFESjlB,SpATywNh6bZuzm8s1ceuBUnMUAeoAHHw,16,22,8,9,5,7,5,1,57,8.142857142857142,1,0.0,9,8,9,5,13,7,0,5,1,31,26,1
7507,69540,a160ewxyRJdtN45GnX3uGxkLMyeZKvV7,bWdj2GDclj5ofokWjzoa5jAwMkxCykd6,13,20,10,84,5,7,13,2,141,20.142857142857142,2,0.0,4,10,82,5,16,7,2,13,2,101,40,1
7508,69543,ZAi0jAKRdwQEtga2Yygb9adNtNc26TKH,SpATywNh6bZuzm8s1ceuBUnMUAeoAHHw,7,6,3,0,1,0,2,0,12,1.7142857142857142,1,0.0,2,3,0,1,4,0,0,2,0,6,6,1
7509,69548,cjgnRFcpPxhUwluGuMHbhKtpIo8g67oX,SpATywNh6bZuzm8s1ceuBUnMUAeoAHHw,5,2,1,0,1,0,5,0,9,1.2857142857142858,1,0.0,0,1,0,1,2,0,0,5,0,2,7,1
7510,69551,WfPfJn9lrx0nGBfxPbzYzJSQElx0Vya0,A3fsA9Zfv1X2fVEQhTw51lKENdNrEqT3,7,7,6,0,1,0,1,0,15,2.142857142857143,3,0.0,0,6,0,1,7,0,0,1,0,7,8,1
7511,69561,Z4SPpJfwg3kmbYmCX1430X6xnjXFgqan,SpATywNh6bZuzm8s1ceuBUnMUAeoAHHw,1,0,0,0,0,0,1,0,1,0.14285714285714285,1,0.0,0,0,0,0,0,0,0,1,0,0,1,1
7512,69567,q3DUInVVvDGT22ACyMKixODyUkgLOKmI,SpATywNh6bZuzm8s1ceuBUnMUAeoAHHw,18,25,16,13,8,0,5,0,67,9.571428571428571,3,0.0,4,16,13,8,21,0,0,5,0,41,26,1
7513,69577,zdQpZzeZtdBJrKxe0kkh4zz1KUaEeB2I,G8EPVSXsOYB5YQWZGiz1aVq5Pgr2GrQu,101,67,54,173,37,4,8,0,343,49.0,5,0.0,1,54,147,37,66,4,26,8,0,239,104,1
7514,69583,82WiuHoB3dVqYkf2UKsu9ogC0IsQQnqa,A3fsA9Zfv1X2fVEQhTw51lKENdNrEqT3,5,3,0,0,0,0,3,0,6,0.8571428571428571,1,0.0,0,0,0,0,3,0,0,3,0,0,6,1
7515,69590,aYhMdR5xaez3fr0lBrD6kCxYiCOyculR,SpATywNh6bZuzm8s1ceuBUnMUAeoAHHw,3,0,0,0,0,1,2,0,3,0.42857142857142855,1,0.0,0,0,0,0,0,1,0,2,0,0,3,0
7516,69594,0pQnhOp7TmXmyZJvGFVAPDeo6QapvPWM,SpATywNh6bZuzm8s1ceuBUnMUAeoAHHw,1,0,0,0,0,0,1,0,1,0.14285714285714285,1,0.0,0,0,0,0,0,0,0,1,0,0,1,1
7517,69602,ebvWYER6Bde0EUcNXXIX0vyTB9ur6Kqi,bWdj2GDclj5ofokWjzoa5jAwMkxCykd6,4,4,0,0,0,0,2,0,6,0.8571428571428571,2,0.0,0,0,0,0,4,0,0,2,0,0,6,1
7518,69604,ebvWYER6Bde0EUcNXXIX0vyTB9ur6Kqi,RXDvfPUBYFlVdlueBFbLW0mhhAyGEqpt,11,10,0,0,0,3,10,1,24,3.4285714285714284,2,0.0,1,0,0,0,9,3,0,10,1,1,23,1
7519,69608,luffaRyMH17lmf9lXIITCUvmvLstdhJF,SpATywNh6bZuzm8s1ceuBUnMUAeoAHHw,7,6,1,0,1,0,3,0,11,1.5714285714285714,2,0.0,2,1,0,1,4,0,0,3,0,4,7,1
7520,69609,m6d8SS4M8CUq3BoC3xOyTU0oHsPjDd2w,SpATywNh6bZuzm8s1ceuBUnMUAeoAHHw,4,2,0,0,0,0,2,0,4,0.5714285714285714,1,0.0,0,0,0,0,2,0,0,2,0,0,4,1
7521,69611,nJobBmBuwmDPhO4EIrWUJq110WMVvZw4,SpATywNh6bZuzm8s1ceuBUnMUAeoAHHw,8,4,3,0,2,0,2,0,11,1.5714285714285714,1,0.0,0,3,0,2,4,0,0,2,0,5,6,1
7522,69616,faupOzOQrYnrhUP3CZcXERH5hL8Q3xd2,SpATywNh6bZuzm8s1ceuBUnMUAeoAHHw,18,27,14,10,6,23,7,0,87,12.428571428571429,5,0.0,7,14,10,6,20,23,0,7,0,37,50,1
7523,69638,nkfthsiEhj5rlE8h2UVfSYWZi1i1pvPD,SpATywNh6bZuzm8s1ceuBUnMUAeoAHHw,25,46,15,22,8,2,7,0,100,14.285714285714286,2,0.0,11,15,19,8,35,2,3,7,0,53,47,1
7524,69643,W17GnVDduKqnwPQhc7qvZa9k2VQEwhjA,G8EPVSXsOYB5YQWZGiz1aVq5Pgr2GrQu,5,2,1,0,1,0,2,0,6,0.8571428571428571,1,0.0,0,1,0,1,2,0,0,2,0,2,4,1
7525,69647,tD4YaA9C1jzNLnr7tPBZ897xHEsnzm9F,SpATywNh6bZuzm8s1ceuBUnMUAeoAHHw,1,0,0,0,0,0,1,0,1,0.14285714285714285,1,0.0,0,0,0,0,0,0,0,1,0,0,1,1
7526,69650,tD4YaA9C1jzNLnr7tPBZ897xHEsnzm9F,A3fsA9Zfv1X2fVEQhTw51lKENdNrEqT3,1,0,0,0,0,0,1,0,1,0.14285714285714285,1,0.0,0,0,0,0,0,0,0,1,0,0,1,1
7527,69654,lD3KgUtWok6mjiblbvy163en24cSYNXc,RXDvfPUBYFlVdlueBFbLW0mhhAyGEqpt,1,0,0,0,0,0,1,0,1,0.14285714285714285,1,0.0,0,0,0,0,0,0,0,1,0,0,1,1
7528,69680,tes6smsqnnhtic7mel4he0HOVKxdsIk0,SpATywNh6bZuzm8s1ceuBUnMUAeoAHHw,5,6,3,0,1,0,5,0,15,2.142857142857143,3,0.0,0,3,0,1,6,0,0,5,0,4,11,1
7529,69682,DpqUZKEZpIFvZzvEXk8oaJMRAbEfypNN,A3fsA9Zfv1X2fVEQhTw51lKENdNrEqT3,25,20,15,0,14,0,16,0,65,9.285714285714286,4,0.0,2,15,0,14,18,0,0,16,0,31,34,1
7530,69684,jKWIhuXmlYFBIapfd4E50TBTHed3oveP,SpATywNh6bZuzm8s1ceuBUnMUAeoAHHw,16,25,10,12,4,1,4,0,56,8.0,3,0.0,6,10,11,4,19,1,1,4,0,31,25,1
7531,69690,RsnXePogfsPEsPaBIDmu1zOlkZ0nGsJG,SpATywNh6bZuzm8s1ceuBUnMUAeoAHHw,10,14,6,0,5,0,15,0,40,5.714285714285714,3,0.0,2,6,0,5,12,0,0,15,0,13,27,1
7532,69693,Z3XF9lddm62bhylNbOc8gNaNENZtsGVQ,SpATywNh6bZuzm8s1ceuBUnMUAeoAHHw,6,6,2,0,0,0,4,0,12,1.7142857142857142,2,0.0,0,2,0,0,6,0,0,4,0,2,10,1
7533,69697,KCsv9o14hbrQKvzaJVVOUtS9ZXoioMZi,SpATywNh6bZuzm8s1ceuBUnMUAeoAHHw,23,26,16,11,12,0,3,0,68,9.714285714285714,2,0.0,7,16,10,12,19,0,1,3,0,45,23,1
7534,69702,V5MB02xz5am2kHfey21j0yueDNM7JiHU,A3fsA9Zfv1X2fVEQhTw51lKENdNrEqT3,6,3,2,0,2,0,4,0,11,1.5714285714285714,1,0.0,0,2,0,2,3,0,0,4,0,4,7,1
7535,69708,xcD6YWhnGA2xukGmX4eaYrm6VS9ffz1H,RXDvfPUBYFlVdlueBFbLW0mhhAyGEqpt,50,84,40,84,20,15,19,1,263,37.57142857142857,4,0.0,29,40,76,20,55,15,8,19,1,165,98,0
7536,69709,HkR8egrosmo3p8vvw0Masj2JRYmaSMRW,bWdj2GDclj5ofokWjzoa5jAwMkxCykd6,3,0,0,0,0,1,6,0,7,1.0,2,0.0,0,0,0,0,0,1,0,6,0,0,7,0
7537,69713,8gwjs0B0kUE7stjGZjvEBczr2cXGTwYJ,SpATywNh6bZuzm8s1ceuBUnMUAeoAHHw,11,7,4,6,1,0,2,0,20,2.857142857142857,2,0.0,2,4,6,1,5,0,0,2,0,13,7,0
7538,69719,o7QNLHma5sLHPf1vf8edH1AxEjwzXjmH,RXDvfPUBYFlVdlueBFbLW0mhhAyGEqpt,4,2,1,0,1,0,1,0,5,0.7142857142857143,1,0.0,0,1,0,1,2,0,0,1,0,2,3,1
7539,69726,MJibuyVypmuBs7BncEuo5i3GOsk8IZAX,SpATywNh6bZuzm8s1ceuBUnMUAeoAHHw,11,7,5,0,3,1,5,0,21,3.0,2,0.0,0,5,0,3,7,1,0,5,0,8,13,1
7540,69728,RGp0TGYq2GqXU0ffAofLYX0dCiUdIWSh,SpATywNh6bZuzm8s1ceuBUnMUAeoAHHw,9,8,5,0,2,0,6,0,21,3.0,3,0.0,0,5,0,2,8,0,0,6,0,7,14,0
7541,69749,1mwVsEWRdpRYvoqkUN67uGNzTUomXEbQ,G8EPVSXsOYB5YQWZGiz1aVq5Pgr2GrQu,31,58,5,34,4,3,10,0,114,16.285714285714285,3,0.0,2,5,29,4,56,3,5,10,0,40,74,1
7542,69750,LITEXQWwZ0HwbfUIw2ZTJ1Nz80g3xPKl,RXDvfPUBYFlVdlueBFbLW0mhhAyGEqpt,5,4,2,0,1,0,2,0,9,1.2857142857142858,2,0.0,0,2,0,1,4,0,0,2,0,3,6,1
7543,69752,WXX8Za7OuZw2MA7QaLNUhKigQ32JFLJo,SpATywNh6bZuzm8s1ceuBUnMUAeoAHHw,11,10,4,1,3,0,2,0,20,2.857142857142857,1,0.0,5,4,1,3,5,0,0,2,0,13,7,1
7544,69774,NiepHsDkcSMT8UZbqGGY6QXqNiJKeyrC,SpATywNh6bZuzm8s1ceuBUnMUAeoAHHw,6,4,1,0,1,0,3,0,9,1.2857142857142858,1,0.0,0,1,0,1,4,0,0,3,0,2,7,1
7545,69776,P1MYDLvlR6YqACMf13Tb8sFZFVWSr1nZ,bWdj2GDclj5ofokWjzoa5jAwMkxCykd6,7,11,0,0,0,0,11,0,22,3.142857142857143,1,0.0,0,0,0,0,11,0,0,11,0,0,22,1
7546,69777,vljlAhHGhHZt2ciFpy2bQxMoEL2SUwdk,G8EPVSXsOYB5YQWZGiz1aVq5Pgr2GrQu,10,5,1,0,0,2,8,1,17,2.4285714285714284,1,0.0,0,1,0,0,5,2,0,8,1,1,16,1
7547,69783,Nr4xgaqWlp3GY7Luca1HZwWSVTgxpORh,A3fsA9Zfv1X2fVEQhTw51lKENdNrEqT3,29,27,8,47,0,0,9,1,92,13.142857142857142,5,0.0,1,8,46,0,26,0,1,9,1,55,37,0
7548,69792,pmTpzYlO4DcSR3Hjn7J1Go0PaUoezH5E,SpATywNh6bZuzm8s1ceuBUnMUAeoAHHw,6,1,1,0,1,0,3,0,6,0.8571428571428571,1,0.0,0,1,0,1,1,0,0,3,0,2,4,1
7549,69800,kzyt7hO7yEeJxQfXO5XM7Bawq3xoVkTz,SpATywNh6bZuzm8s1ceuBUnMUAeoAHHw,9,6,3,7,1,0,5,0,22,3.142857142857143,2,0.0,2,3,6,1,4,0,1,5,0,12,10,0
7550,69802,2NIeHPnJrY66zbADeGJTptXbk5YYYnSv,G8EPVSXsOYB5YQWZGiz1aVq5Pgr2GrQu,6,3,1,9,0,0,1,0,14,2.0,1,0.0,0,1,7,0,3,0,2,1,0,8,6,1
7551,69807,iysh9174eOcFH0suenSCLNsv1cqN2Oie,A3fsA9Zfv1X2fVEQhTw51lKENdNrEqT3,15,13,5,0,4,0,8,0,30,4.285714285714286,2,0.0,0,5,0,4,13,0,0,8,0,9,21,1
7552,69808,rDR9DQbHi1eXHd28a6bdjn6YaDG8j833,SpATywNh6bZuzm8s1ceuBUnMUAeoAHHw,4,2,1,0,1,0,1,0,5,0.7142857142857143,1,0.0,0,1,0,1,2,0,0,1,0,2,3,1
7553,69809,j7794Az14TTh7tEEmhTpADHq4ipGllnd,SpATywNh6bZuzm8s1ceuBUnMUAeoAHHw,37,83,39,62,13,37,29,1,264,37.714285714285715,10,0.0,28,39,52,13,55,37,10,29,1,132,132,0
7554,69811,RN9YqqNsHa7lmCtbb4sE8JmcbttJklXE,SpATywNh6bZuzm8s1ceuBUnMUAeoAHHw,13,18,3,0,3,31,13,2,70,10.0,3,0.0,0,3,0,3,18,31,0,13,2,6,64,1
7555,69831,LFBaIhK5031yuWJYVNd4qT9zLr1L16XD,A3fsA9Zfv1X2fVEQhTw51lKENdNrEqT3,9,5,3,0,3,0,4,0,15,2.142857142857143,2,0.0,1,3,0,3,4,0,0,4,0,7,8,1
7556,69841,AlFdkAawiX4QZgKaI0ukIeHoMMs579rt,A3fsA9Zfv1X2fVEQhTw51lKENdNrEqT3,1,0,0,0,0,0,1,0,1,0.14285714285714285,1,0.0,0,0,0,0,0,0,0,1,0,0,1,1
7557,69843,yIgziBEY1QeE2VunyvjKVApcpAZz6INk,bWdj2GDclj5ofokWjzoa5jAwMkxCykd6,13,26,13,20,6,7,8,0,80,11.428571428571429,2,0.0,6,13,18,6,20,7,2,8,0,43,37,1
7558,69847,LyDM0yrwn8zKtQsuxEGqFMxdhffaZNVY,SpATywNh6bZuzm8s1ceuBUnMUAeoAHHw,21,34,2,28,1,0,4,0,69,9.857142857142858,3,0.0,6,2,25,1,28,0,3,4,0,34,35,1
7559,69849,jSFXNgNICT3cTdtFY1qrRx06ncJbHNIL,SpATywNh6bZuzm8s1ceuBUnMUAeoAHHw,51,95,39,51,17,12,27,3,244,34.857142857142854,8,0.0,33,39,43,17,62,12,8,27,3,132,112,0
7560,69852,jGWjfQmpnKrCWFzIMxwjgnePo6w3vCLc,SpATywNh6bZuzm8s1ceuBUnMUAeoAHHw,19,50,24,2,12,4,17,3,112,16.0,6,0.0,16,24,2,12,34,4,0,17,3,54,58,1
7561,69854,vtTIluoXpRIe9zpqEiPikMWtGXSMpuiF,SpATywNh6bZuzm8s1ceuBUnMUAeoAHHw,18,37,12,18,4,1,9,0,81,11.571428571428571,5,0.0,8,12,15,4,29,1,3,9,0,39,42,1
7562,69856,SBz1G9CPNh7b1YKxwzjWQ2S8H7JkEfYW,SpATywNh6bZuzm8s1ceuBUnMUAeoAHHw,31,67,1,36,0,17,9,0,130,18.571428571428573,4,0.0,16,1,32,0,51,17,4,9,0,49,81,0
7563,69861,TgjP3M05p3RMkUJ6UX2DRRlsHiZcIeqm,SpATywNh6bZuzm8s1ceuBUnMUAeoAHHw,17,28,2,15,0,2,7,1,55,7.857142857142857,2,0.0,10,2,12,0,18,2,3,7,1,24,31,1
7564,69877,2eCbk1UbEiqe2btnyk0kQWHxge0iLKhu,SpATywNh6bZuzm8s1ceuBUnMUAeoAHHw,10,4,4,0,4,0,3,0,15,2.142857142857143,1,0.0,0,4,0,4,4,0,0,3,0,8,7,1
7565,69879,T7hyLHRci3AaSKtnxgzZP9PZimkugFag,SpATywNh6bZuzm8s1ceuBUnMUAeoAHHw,31,28,17,16,8,0,13,0,82,11.714285714285714,4,0.0,7,17,16,8,21,0,0,13,0,48,34,1
7566,69886,C89edYjc0egHm9DK0UhG6TICXc3cgfYt,SpATywNh6bZuzm8s1ceuBUnMUAeoAHHw,14,19,11,0,6,2,8,1,47,6.714285714285714,4,0.0,0,11,0,6,19,2,0,8,1,17,30,1
7567,69887,uxXbNZQzMKFVtvkoRDDVyoOZczad3AGk,SpATywNh6bZuzm8s1ceuBUnMUAeoAHHw,5,2,1,0,1,0,3,0,7,1.0,1,0.0,0,1,0,1,2,0,0,3,0,2,5,1
7568,69894,uxXbNZQzMKFVtvkoRDDVyoOZczad3AGk,bWdj2GDclj5ofokWjzoa5jAwMkxCykd6,1,0,0,0,0,0,1,0,1,0.14285714285714285,1,0.0,0,0,0,0,0,0,0,1,0,0,1,1
7569,69896,uxXbNZQzMKFVtvkoRDDVyoOZczad3AGk,A3fsA9Zfv1X2fVEQhTw51lKENdNrEqT3,1,0,0,0,0,0,1,0,1,0.14285714285714285,1,0.0,0,0,0,0,0,0,0,1,0,0,1,1
7570,69913,NMnvuPuFFRZJF8iN4i8wvMDrTjhZSOh9,SpATywNh6bZuzm8s1ceuBUnMUAeoAHHw,20,43,11,9,4,1,9,1,78,11.142857142857142,1,0.0,10,11,9,4,33,1,0,9,1,34,44,1
7571,69924,hF9wzZzzUNXUdemSIRccNUzFWcmYBmRA,SpATywNh6bZuzm8s1ceuBUnMUAeoAHHw,4,2,1,0,1,0,1,0,5,0.7142857142857143,1,0.0,0,1,0,1,2,0,0,1,0,2,3,1
7572,69926,iC67OjDFbVlCchthNt40xrjNGlZz61fX,SpATywNh6bZuzm8s1ceuBUnMUAeoAHHw,2,0,0,0,0,0,4,0,4,0.5714285714285714,2,0.0,0,0,0,0,0,0,0,4,0,0,4,0
7573,69928,VzpntkFDzyOIiXtUxc8LkeciWhAJhdSD,SpATywNh6bZuzm8s1ceuBUnMUAeoAHHw,9,4,3,2,2,0,3,0,14,2.0,2,0.0,0,3,2,2,4,0,0,3,0,7,7,1
7574,69933,GRXlFzfh4xOjZLiMJPGMcltQGlQAKqSw,A3fsA9Zfv1X2fVEQhTw51lKENdNrEqT3,3,2,0,0,0,0,2,0,4,0.5714285714285714,2,0.0,0,0,0,0,2,0,0,2,0,0,4,0
7575,69941,DpqUZKEZpIFvZzvEXk8oaJMRAbEfypNN,SpATywNh6bZuzm8s1ceuBUnMUAeoAHHw,30,33,17,0,17,0,15,0,82,11.714285714285714,3,0.0,6,17,0,17,27,0,0,15,0,40,42,0
7576,69948,lqeVvfv7UmHu5JiyWoTOATw0yL0HJQEo,G8EPVSXsOYB5YQWZGiz1aVq5Pgr2GrQu,1,0,0,0,0,0,1,0,1,0.14285714285714285,1,0.0,0,0,0,0,0,0,0,1,0,0,1,1
7577,69949,jcyADRcnQkvVHllsyVvCCi5Wcx40AoFW,SpATywNh6bZuzm8s1ceuBUnMUAeoAHHw,2,0,0,0,0,0,2,0,2,0.2857142857142857,1,0.0,0,0,0,0,0,0,0,2,0,0,2,1
7578,69961,jcyADRcnQkvVHllsyVvCCi5Wcx40AoFW,A3fsA9Zfv1X2fVEQhTw51lKENdNrEqT3,1,0,0,0,0,0,1,0,1,0.14285714285714285,1,0.0,0,0,0,0,0,0,0,1,0,0,1,1
7579,69973,CabsQjb2Sd2I3ynTdtsErAG67rLex08f,A3fsA9Zfv1X2fVEQhTw51lKENdNrEqT3,2,0,0,0,0,0,2,0,2,0.2857142857142857,1,0.0,0,0,0,0,0,0,0,2,0,0,2,1
7580,69975,xL2GGqHxlfngRtz8ATMPQBFRBvX6HArr,SpATywNh6bZuzm8s1ceuBUnMUAeoAHHw,37,82,17,21,3,21,34,5,183,26.142857142857142,6,0.0,24,17,21,3,58,21,0,34,5,65,118,0
7581,69997,viQoPUNtB7SIUiKvJ4gjpMz5oecDT31f,G8EPVSXsOYB5YQWZGiz1aVq5Pgr2GrQu,4,2,1,0,1,0,1,0,5,0.7142857142857143,1,0.0,0,1,0,1,2,0,0,1,0,2,3,1
7582,70006,wBxOvXavxcvDHQtsCbkdt1VRzmB8Qh9E,bWdj2GDclj5ofokWjzoa5jAwMkxCykd6,10,18,9,19,2,3,12,0,63,9.0,4,0.0,2,9,19,2,16,3,0,12,0,32,31,1
7583,70013,Kmxwvn5YFvJ5yFX0GZXEdEhcQGDP2CuP,SpATywNh6bZuzm8s1ceuBUnMUAeoAHHw,4,2,1,0,1,0,1,0,5,0.7142857142857143,1,0.0,0,1,0,1,2,0,0,1,0,2,3,1
7584,70034,J1us9rPcxSTckBHItgnAQKi26DjcRbl6,A3fsA9Zfv1X2fVEQhTw51lKENdNrEqT3,7,3,2,0,2,0,9,0,16,2.2857142857142856,1,0.0,0,2,0,2,3,0,0,9,0,4,12,1
7585,70037,jQGozXgCDEtih8n0QNDjwOxHGubLTjEt,SpATywNh6bZuzm8s1ceuBUnMUAeoAHHw,6,6,4,0,2,0,2,0,14,2.0,1,0.0,0,4,0,2,6,0,0,2,0,6,8,0
7586,70046,J1us9rPcxSTckBHItgnAQKi26DjcRbl6,bWdj2GDclj5ofokWjzoa5jAwMkxCykd6,5,2,1,0,1,0,2,0,6,0.8571428571428571,1,0.0,0,1,0,1,2,0,0,2,0,2,4,1
7587,70048,DbyuNNEIfQSCSjURAYhbFblaR63gfHlU,A3fsA9Zfv1X2fVEQhTw51lKENdNrEqT3,2,0,0,0,0,0,2,0,2,0.2857142857142857,1,0.0,0,0,0,0,0,0,0,2,0,0,2,1
7588,70049,DbyuNNEIfQSCSjURAYhbFblaR63gfHlU,bWdj2GDclj5ofokWjzoa5jAwMkxCykd6,7,5,1,24,2,0,4,0,36,5.142857142857143,2,0.0,3,1,23,2,2,0,1,4,0,29,7,1
7589,70050,hcNcs1eHZusVH4vyoLl8j9zdN7CZ6Lcy,SpATywNh6bZuzm8s1ceuBUnMUAeoAHHw,24,20,16,12,12,0,5,0,65,9.285714285714286,2,0.0,2,16,10,12,18,0,2,5,0,40,25,1
7590,70063,EJgYYp7MOTUbdsSUr6xoQChx0uLQ5Tys,SpATywNh6bZuzm8s1ceuBUnMUAeoAHHw,7,3,2,0,2,0,2,0,9,1.2857142857142858,1,0.0,0,2,0,2,3,0,0,2,0,4,5,1
7591,70070,nzxk9UvHRiwkN6SIsgPzgRjDaGaCgQRa,bWdj2GDclj5ofokWjzoa5jAwMkxCykd6,1,0,0,0,0,0,1,0,1,0.14285714285714285,1,0.0,0,0,0,0,0,0,0,1,0,0,1,1
7592,70101,vYeGcWGAJP4B8Lvbjdr2jkY9NnpHN8xb,bWdj2GDclj5ofokWjzoa5jAwMkxCykd6,1,0,0,0,0,0,1,0,1,0.14285714285714285,1,0.0,0,0,0,0,0,0,0,1,0,0,1,1
7593,70108,JaY583iEzhUh1H375yAqlbYi0f6zdDLM,SpATywNh6bZuzm8s1ceuBUnMUAeoAHHw,4,3,0,0,0,0,2,0,5,0.7142857142857143,1,0.0,1,0,0,0,2,0,0,2,0,1,4,1
7594,70109,w1PJeTTskG2DF1TtLUpuz9MkqxNdq5EB,SpATywNh6bZuzm8s1ceuBUnMUAeoAHHw,6,8,2,0,2,0,3,0,15,2.142857142857143,2,0.0,0,2,0,2,8,0,0,3,0,4,11,1
7595,70119,NXyco71N78GkVfHnZsK8R307XzQzXNS1,SpATywNh6bZuzm8s1ceuBUnMUAeoAHHw,18,27,12,8,4,0,2,0,53,7.571428571428571,4,0.0,7,12,7,4,20,0,1,2,0,30,23,0
7596,70122,68BjCXfBFqeZ01fFx1csrFmvef5xs0w2,G8EPVSXsOYB5YQWZGiz1aVq5Pgr2GrQu,33,47,28,8,14,31,10,0,138,19.714285714285715,6,0.0,8,28,5,14,39,31,3,10,0,55,83,1
7597,70132,rSEfJyHxNlxmmbC9ORIbqcFKKq08QDrh,A3fsA9Zfv1X2fVEQhTw51lKENdNrEqT3,7,5,2,0,2,14,3,0,26,3.7142857142857144,2,0.0,0,2,0,2,5,14,0,3,0,4,22,1
7598,70137,DyZ33FUAQ083lF7iqwpOMtJVUGHaWBxJ,SpATywNh6bZuzm8s1ceuBUnMUAeoAHHw,1,0,0,0,0,0,1,0,1,0.14285714285714285,1,0.0,0,0,0,0,0,0,0,1,0,0,1,1
7599,70139,j4hecXKY3USBQpRwMuzKA9d9SPzBKhRY,bWdj2GDclj5ofokWjzoa5jAwMkxCykd6,22,21,12,0,8,9,11,0,61,8.714285714285714,3,0.0,0,12,0,8,21,9,0,11,0,20,41,1
7600,70147,YlInwW32qLdS6CieoVgP5nZzRZh7iEhb,A3fsA9Zfv1X2fVEQhTw51lKENdNrEqT3,11,16,8,0,5,0,4,0,33,4.714285714285714,2,0.0,0,8,0,5,16,0,0,4,0,13,20,1
7601,70151,Zn9SLiwLflmw7DD6LFx0hGPxPjMJmhLJ,SpATywNh6bZuzm8s1ceuBUnMUAeoAHHw,1,0,0,0,0,0,1,0,1,0.14285714285714285,1,0.0,0,0,0,0,0,0,0,1,0,0,1,1
7602,70163,wykDdjB45pC3zZUNNLpkNXDJGEatsGFp,RXDvfPUBYFlVdlueBFbLW0mhhAyGEqpt,1,0,0,0,0,0,1,0,1,0.14285714285714285,1,0.0,0,0,0,0,0,0,0,1,0,0,1,1
7603,70168,ep3Z6ZNyXyvrIgNVR9OB0zeq4nPzioY7,3VkHkmOtom3jM2wCu94xgzzu1d6Dn7or,18,13,8,0,8,0,1,0,30,4.285714285714286,1,0.0,2,8,0,8,11,0,0,1,0,18,12,1
7604,70169,BIFwVHfEy95UAI6fjUhoMnDY7s4N3DmJ,3VkHkmOtom3jM2wCu94xgzzu1d6Dn7or,4,2,1,0,1,0,1,0,5,0.7142857142857143,2,0.0,0,1,0,1,2,0,0,1,0,2,3,1
7605,70170,Fihr9UrpQ666m8I3iynqbiyrKzTfsyia,3VkHkmOtom3jM2wCu94xgzzu1d6Dn7or,65,125,35,49,48,4,8,0,269,38.42857142857143,5,0.0,68,35,43,48,57,4,6,8,0,194,75,0
7606,70171,9uWO6TD3G9nGO1KlOlU8aXoG5qyfm2Vc,3VkHkmOtom3jM2wCu94xgzzu1d6Dn7or,49,96,38,48,22,24,15,1,244,34.857142857142854,9,0.0,36,38,41,22,60,24,7,15,1,137,107,0
7607,70172,Y9zzxa8aT5mj3vCCOFRszZ8rRbH90TaX,3VkHkmOtom3jM2wCu94xgzzu1d6Dn7or,3,5,1,0,0,0,1,0,7,1.0,2,0.0,0,1,0,0,5,0,0,1,0,1,6,1
7608,70173,DA24ez1cFBoNsRFo2iZZUnyu42Ymeo7y,3VkHkmOtom3jM2wCu94xgzzu1d6Dn7or,31,45,17,16,17,1,13,1,110,15.714285714285714,4,0.0,20,17,14,17,25,1,2,13,1,68,42,1
7609,70174,p0pfWFWA1dQyY3znYKNGTmTkIK6eywNP,3VkHkmOtom3jM2wCu94xgzzu1d6Dn7or,29,90,30,45,26,0,15,0,206,29.428571428571427,5,0.0,24,30,39,26,66,0,6,15,0,119,87,1
7610,70176,swBDY3r3CGAHOlRfYZZxONtreFtoAwWg,3VkHkmOtom3jM2wCu94xgzzu1d6Dn7or,33,57,12,27,25,0,16,1,138,19.714285714285715,4,0.0,42,12,26,25,15,0,1,16,1,105,33,1
7611,70178,mJpaUtqteUxu4VKFz9l1u77hB4BHtjqx,3VkHkmOtom3jM2wCu94xgzzu1d6Dn7or,4,3,1,0,0,0,2,0,6,0.8571428571428571,1,0.0,0,1,0,0,3,0,0,2,0,1,5,1
7612,70179,XuNt1i5t4SR1AjDP4UHvsoux0R9qVf5C,3VkHkmOtom3jM2wCu94xgzzu1d6Dn7or,9,43,14,5,1,8,15,0,86,12.285714285714286,3,0.0,10,14,4,1,33,8,1,15,0,29,57,1
7613,70181,siIDvWusnWDUBUBvTa7iJwnzxgWHcwAD,3VkHkmOtom3jM2wCu94xgzzu1d6Dn7or,11,13,6,4,3,3,8,1,38,5.428571428571429,3,0.0,1,6,3,3,12,3,1,8,1,13,25,1
7614,70197,Dj6SMQBl9KJ8yiS8P2s2KUlJ0yhi0WEY,3VkHkmOtom3jM2wCu94xgzzu1d6Dn7or,21,18,13,1,10,0,6,1,49,7.0,3,0.0,1,13,1,10,17,0,0,6,1,25,24,1
7615,70198,bC5wGeGWcIV679pjGNakGYlcr75e13l6,3VkHkmOtom3jM2wCu94xgzzu1d6Dn7or,34,121,28,49,24,36,22,0,280,40.0,3,0.0,46,28,42,24,75,36,7,22,0,140,140,1
7616,70204,kQtdnNEoRWo2Qg6oC84HRWANAqptJ7GF,3VkHkmOtom3jM2wCu94xgzzu1d6Dn7or,72,182,18,83,41,10,25,0,359,51.285714285714285,13,0.0,96,18,78,41,86,10,5,25,0,233,126,0
7617,70213,sdMJ9yEwKnseKwJKlSTcSmAPBTnKrqGh,3VkHkmOtom3jM2wCu94xgzzu1d6Dn7or,29,89,22,20,21,19,16,0,187,26.714285714285715,5,0.0,43,22,19,21,46,19,1,16,0,105,82,1
7618,70220,gbWAIBjOoSxn1yat60fXAQ95TIrvofyV,3VkHkmOtom3jM2wCu94xgzzu1d6Dn7or,4,2,1,0,1,0,2,0,6,0.8571428571428571,1,0.0,0,1,0,1,2,0,0,2,0,2,4,1
7619,70223,yNygMjDRQbsmQrkdzv6Ni3gEhrA9rC9T,3VkHkmOtom3jM2wCu94xgzzu1d6Dn7or,65,192,49,30,66,23,42,2,404,57.714285714285715,5,0.0,107,49,28,66,85,23,2,42,2,250,154,0
7620,70224,YEbdE61pf0gugV8YlJ3iI35aaxpMiJnI,3VkHkmOtom3jM2wCu94xgzzu1d6Dn7or,3,2,0,0,0,1,2,0,5,0.7142857142857143,1,0.0,0,0,0,0,2,1,0,2,0,0,5,0
7621,70226,8ukiQxCkCDfwUHfKzWmYD4i4dbE3kwEM,3VkHkmOtom3jM2wCu94xgzzu1d6Dn7or,8,17,4,0,1,0,11,0,33,4.714285714285714,1,0.0,0,4,0,1,17,0,0,11,0,5,28,1
7622,70227,loCbBAjJE6LEqCnUdKy3teIi6RVdybxK,3VkHkmOtom3jM2wCu94xgzzu1d6Dn7or,8,3,2,0,2,0,3,0,10,1.4285714285714286,1,0.0,0,2,0,2,3,0,0,3,0,4,6,1
7623,70228,ByKzQI3CgoJubYuohnSCQwycjV52Fk1r,3VkHkmOtom3jM2wCu94xgzzu1d6Dn7or,24,21,17,0,15,0,4,0,57,8.142857142857142,3,0.0,0,17,0,15,21,0,0,4,0,32,25,1
7624,70231,DxVdwjmi6EcYOau7Cr3jh5M2TX3cbxrT,3VkHkmOtom3jM2wCu94xgzzu1d6Dn7or,11,31,18,5,5,4,25,0,88,12.571428571428571,3,0.0,3,18,4,5,28,4,1,25,0,30,58,1
7625,70232,xtLU6YgItl9Yzw20rtIpovJ1JJpqbywC,3VkHkmOtom3jM2wCu94xgzzu1d6Dn7or,6,2,1,0,1,0,5,1,10,1.4285714285714286,1,0.0,0,1,0,1,2,0,0,5,1,2,8,0
7626,70233,8S967Vddj3mqTvUoNDSVumD7L6ahw75c,3VkHkmOtom3jM2wCu94xgzzu1d6Dn7or,18,40,9,6,12,12,17,1,97,13.857142857142858,3,0.0,22,9,6,12,18,12,0,17,1,49,48,1
7627,70236,IVUnZUhXPP7pASqRdLR6xcYo9MU0LT2m,3VkHkmOtom3jM2wCu94xgzzu1d6Dn7or,28,175,50,31,11,13,9,0,289,41.285714285714285,6,0.0,49,50,25,11,126,13,6,9,0,135,154,1
7628,70239,zY9UrfteAhELgKFy5X9J7x3Fmx6jcLg3,3VkHkmOtom3jM2wCu94xgzzu1d6Dn7or,7,5,1,0,1,0,2,0,9,1.2857142857142858,1,0.0,0,1,0,1,5,0,0,2,0,2,7,1
7629,70247,F4iC3qBrSKrshpvFu7yK5q8UUugl757b,3VkHkmOtom3jM2wCu94xgzzu1d6Dn7or,74,249,49,42,30,1,28,0,399,57.0,17,0.0,71,49,41,30,178,1,1,28,0,191,208,0
7630,70249,jx3H6f2miwKbLN02Gt82PEqx2tCxuPiz,3VkHkmOtom3jM2wCu94xgzzu1d6Dn7or,64,100,40,33,36,24,20,0,253,36.142857142857146,8,0.0,42,40,30,36,58,24,3,20,0,148,105,0
7631,70250,Bxz1zTHFCCx9o1kJA9B0Pzm3PnmqKxr5,3VkHkmOtom3jM2wCu94xgzzu1d6Dn7or,5,2,1,0,1,0,3,0,7,1.0,1,0.0,0,1,0,1,2,0,0,3,0,2,5,1
7632,70254,MuMZdME6Q21aYmZZ71oios0YuPvoMKvI,3VkHkmOtom3jM2wCu94xgzzu1d6Dn7or,51,64,44,2,32,8,17,2,169,24.142857142857142,8,0.0,2,44,2,32,62,8,0,17,2,80,89,0
7633,70255,GmHJt2279LUj6P2OGQD6V5Y1W95kmZpl,3VkHkmOtom3jM2wCu94xgzzu1d6Dn7or,9,16,3,15,5,4,4,0,47,6.714285714285714,1,0.0,10,3,10,5,6,4,5,4,0,28,19,1
7634,70256,gi7jUcChDtycblzWHdtqBoSjwB2G74db,3VkHkmOtom3jM2wCu94xgzzu1d6Dn7or,10,9,5,2,4,0,2,0,22,3.142857142857143,1,0.0,2,5,2,4,7,0,0,2,0,13,9,1
7635,70258,9y6zGDBb0JPlOjDopsZLjg4eWMIumAce,3VkHkmOtom3jM2wCu94xgzzu1d6Dn7or,8,10,5,0,2,0,6,0,23,3.2857142857142856,3,0.0,0,5,0,2,10,0,0,6,0,7,16,1
7636,70262,Xci1viGBABzXjikcwwlwGEGBfmePUlzw,3VkHkmOtom3jM2wCu94xgzzu1d6Dn7or,11,13,0,0,4,3,13,1,34,4.857142857142857,1,0.0,3,0,0,4,10,3,0,13,1,7,27,1
7637,70263,Bny5sqtonXj6ygMRx2lKkdupc3MOztaQ,3VkHkmOtom3jM2wCu94xgzzu1d6Dn7or,69,259,14,36,11,3,28,1,352,50.285714285714285,6,0.0,101,14,34,11,158,3,2,28,1,160,192,0
7638,70264,nvbLG7UzZsP47uFiujs10g1dZd2wJ34T,3VkHkmOtom3jM2wCu94xgzzu1d6Dn7or,1,0,0,0,0,0,1,0,1,0.14285714285714285,1,0.0,0,0,0,0,0,0,0,1,0,0,1,1
7639,70268,MC3MMrytePyvhe3UwuGSqjOSe0NFZLlI,3VkHkmOtom3jM2wCu94xgzzu1d6Dn7or,27,67,14,34,28,2,9,0,154,22.0,1,0.0,51,14,34,28,16,2,0,9,0,127,27,1
7640,70271,ZhYYSrMQcxjzRT3UKJSOuTE3HPAvHZFo,3VkHkmOtom3jM2wCu94xgzzu1d6Dn7or,3,5,0,0,0,0,1,0,6,0.8571428571428571,1,0.0,0,0,0,0,5,0,0,1,0,0,6,1
7641,70278,lcZqIkYpGjtScNDLdtqKt3haLc6LMQSH,3VkHkmOtom3jM2wCu94xgzzu1d6Dn7or,13,19,5,0,4,0,2,0,30,4.285714285714286,1,0.0,0,5,0,4,19,0,0,2,0,9,21,0
7642,70281,7wdA0s42aT5UZB7EhROFGpGYTrXW9coN,3VkHkmOtom3jM2wCu94xgzzu1d6Dn7or,3,2,0,0,0,0,1,0,3,0.42857142857142855,1,0.0,0,0,0,0,2,0,0,1,0,0,3,1
7643,70282,P6Fd1IQp59pN6lTEXXlgnsX26ikebpg7,3VkHkmOtom3jM2wCu94xgzzu1d6Dn7or,54,82,42,0,42,0,14,0,180,25.714285714285715,2,0.0,10,42,0,42,72,0,0,14,0,94,86,1
7644,70288,0OQWZBG0W4kepi8nreWMZMMypwSc3KLe,3VkHkmOtom3jM2wCu94xgzzu1d6Dn7or,92,241,108,82,65,94,88,15,693,99.0,18,0.0,79,108,75,65,162,94,7,88,15,327,366,0
7645,70291,Kw3ipO3nkJ2O6MLvUuTDqCLl9j8eQ8eR,3VkHkmOtom3jM2wCu94xgzzu1d6Dn7or,61,137,64,36,0,10,47,1,295,42.142857142857146,10,0.0,45,64,35,0,92,10,1,47,1,144,151,1
7646,70296,MfUQhvI4WmU09qeX5p4ZVxtPSEfQQU3k,3VkHkmOtom3jM2wCu94xgzzu1d6Dn7or,5,2,1,0,1,0,2,0,6,0.8571428571428571,1,0.0,0,1,0,1,2,0,0,2,0,2,4,1
7647,70300,oRJWav0i1xSVu6EZJhTpjUgFr01mfw6c,3VkHkmOtom3jM2wCu94xgzzu1d6Dn7or,7,4,3,0,3,0,3,0,13,1.8571428571428572,2,0.0,0,3,0,3,4,0,0,3,0,6,7,0
7648,70302,vBXqxoWJohV9Wf8XlmfMorfJ7u2A3yGp,3VkHkmOtom3jM2wCu94xgzzu1d6Dn7or,1,0,0,0,0,0,1,0,1,0.14285714285714285,1,0.0,0,0,0,0,0,0,0,1,0,0,1,1
7649,70303,mbCXC3WNWeKxT2srxS0yuaJqyTswmXfo,3VkHkmOtom3jM2wCu94xgzzu1d6Dn7or,28,64,11,20,27,1,4,0,127,18.142857142857142,2,0.0,49,11,18,27,15,1,2,4,0,105,22,1
7650,70309,YaCnDWGCLNcR2DnaQ9u9p8sw7fKEiin2,3VkHkmOtom3jM2wCu94xgzzu1d6Dn7or,5,4,1,0,2,0,2,0,9,1.2857142857142858,1,0.0,2,1,0,2,2,0,0,2,0,5,4,1
7651,70310,KUpvOHsEawSobVanRDD5FA8fMCzoOPMN,3VkHkmOtom3jM2wCu94xgzzu1d6Dn7or,23,43,18,10,16,8,27,1,123,17.571428571428573,2,0.0,22,18,9,16,21,8,1,27,1,65,58,1
7652,70312,6VQ3sGdZ7IDi0XSXtc9z65tW3KI3pMqL,3VkHkmOtom3jM2wCu94xgzzu1d6Dn7or,27,71,15,39,16,25,2,0,168,24.0,2,0.0,32,15,37,16,39,25,2,2,0,100,68,1
7653,70315,ryiQeDye7Wz8n7Dvct1bgEdO7KJyfUCE,3VkHkmOtom3jM2wCu94xgzzu1d6Dn7or,1,0,0,0,0,0,1,0,1,0.14285714285714285,1,0.0,0,0,0,0,0,0,0,1,0,0,1,1
7654,70316,zix9SUJrsLq90i4v6qVnrCaX7daB40Kq,3VkHkmOtom3jM2wCu94xgzzu1d6Dn7or,6,2,1,0,1,12,4,0,20,2.857142857142857,1,0.0,0,1,0,1,2,12,0,4,0,2,18,1
7655,70320,5hHsKD7Y4qwCFGPWR0Qrgi4COj92slri,3VkHkmOtom3jM2wCu94xgzzu1d6Dn7or,4,5,1,0,2,0,1,0,9,1.2857142857142858,1,0.0,3,1,0,2,2,0,0,1,0,6,3,1
7656,70322,HLZWnEeT0vXMhJ5Y39hdve4GY4PxY7G4,3VkHkmOtom3jM2wCu94xgzzu1d6Dn7or,4,4,1,0,2,0,1,0,8,1.1428571428571428,1,0.0,2,1,0,2,2,0,0,1,0,5,3,0
7657,70324,m0ftathRLrGnJCnhmZSV8vDms8QzsQ7P,3VkHkmOtom3jM2wCu94xgzzu1d6Dn7or,58,44,2,73,18,0,3,0,140,20.0,2,0.0,21,2,55,18,23,0,18,3,0,96,44,0
7658,70327,psO6n0Pn0k59iFDyVR97ioYoWwNZ7QsM,3VkHkmOtom3jM2wCu94xgzzu1d6Dn7or,6,3,2,0,2,0,1,0,8,1.1428571428571428,1,0.0,0,2,0,2,3,0,0,1,0,4,4,1
7659,70328,3EzbgHWZ0FxtHgHATDhP7VMkxOCnEE8q,3VkHkmOtom3jM2wCu94xgzzu1d6Dn7or,13,41,25,0,15,0,7,0,88,12.571428571428571,6,0.0,0,25,0,15,41,0,0,7,0,40,48,0
7660,70331,g3G5U2ecjp6P7h6ZZOeiyZmcR6BGiVtX,3VkHkmOtom3jM2wCu94xgzzu1d6Dn7or,1,0,0,0,0,0,1,0,1,0.14285714285714285,1,0.0,0,0,0,0,0,0,0,1,0,0,1,1
7661,70332,hTLHk1bFczWfAXr9QMndt4A9GjkUvCZJ,3VkHkmOtom3jM2wCu94xgzzu1d6Dn7or,1,0,0,0,0,0,1,0,1,0.14285714285714285,1,0.0,0,0,0,0,0,0,0,1,0,0,1,1
7662,70334,bmxQ66AsItv9EBQTswW4vQGNA82BElw3,3VkHkmOtom3jM2wCu94xgzzu1d6Dn7or,19,55,18,0,9,12,19,3,116,16.571428571428573,3,0.0,0,18,0,9,55,12,0,19,3,27,89,1
7663,70336,VKDNE86ItuOpp2oVHDMGR3EPQG95zuXs,3VkHkmOtom3jM2wCu94xgzzu1d6Dn7or,14,33,8,4,4,3,10,2,64,9.142857142857142,3,0.0,13,8,4,4,20,3,0,10,2,29,35,1
7664,70339,1LwHP3062AHKmQwDl3FPlP3B3adaBvx7,3VkHkmOtom3jM2wCu94xgzzu1d6Dn7or,4,7,2,0,3,0,3,0,15,2.142857142857143,3,0.0,3,2,0,3,4,0,0,3,0,8,7,1
7665,70341,ZHPpfCRpNebZJ1nTVopN0Pp2GHKAIGhu,3VkHkmOtom3jM2wCu94xgzzu1d6Dn7or,5,2,1,0,1,0,2,0,6,0.8571428571428571,1,0.0,0,1,0,1,2,0,0,2,0,2,4,1
7666,70342,XpxUE9h3D6JhhexHlslc4WxiJHl4lcVq,3VkHkmOtom3jM2wCu94xgzzu1d6Dn7or,40,52,26,0,18,0,9,0,105,15.0,4,0.0,0,26,0,18,52,0,0,9,0,44,61,1
7667,70348,yrqzO8RwLO4nzk1s3CGqdHrreQE8SqwS,3VkHkmOtom3jM2wCu94xgzzu1d6Dn7or,4,2,1,0,1,0,1,0,5,0.7142857142857143,1,0.0,0,1,0,1,2,0,0,1,0,2,3,1
7668,70355,DrwF2jyRuqsM9TWUaALjnxgaploRRL1G,3VkHkmOtom3jM2wCu94xgzzu1d6Dn7or,4,2,1,0,1,0,1,0,5,0.7142857142857143,1,0.0,0,1,0,1,2,0,0,1,0,2,3,1
7669,70357,A0CAGUq6HZAffziWV2GV4z0WUWMbjcLr,3VkHkmOtom3jM2wCu94xgzzu1d6Dn7or,15,10,1,9,5,3,15,0,43,6.142857142857143,1,0.0,5,1,8,5,5,3,1,15,0,19,24,1
7670,70359,AXWWqNDiRDejTjo5V7yUaMbjtzXKhlP0,3VkHkmOtom3jM2wCu94xgzzu1d6Dn7or,66,161,63,34,44,17,37,3,359,51.285714285714285,8,0.0,53,63,32,44,108,17,2,37,3,192,167,0
7671,70363,u2uyYrsZ1NxMBxwWaoB6Ro03rTqsVsmy,fbPkOYLVPtPgIt0MxizjfFJov3JbHyAi,9,6,4,0,1,1,18,2,32,4.571428571428571,1,0.0,0,4,0,1,6,1,0,18,2,5,27,1
7672,70365,p48vWUMspFuVCwMv8mYFsyaHTRvcpcL8,fbPkOYLVPtPgIt0MxizjfFJov3JbHyAi,7,10,5,0,2,0,7,0,24,3.4285714285714284,1,0.0,0,5,0,2,10,0,0,7,0,7,17,1
7673,70368,4AzWdcwb3SG5chIViRUSkI6mbhUE2J75,fbPkOYLVPtPgIt0MxizjfFJov3JbHyAi,49,102,58,0,39,2,20,1,222,31.714285714285715,10,0.0,2,58,0,39,100,2,0,20,1,99,123,1
7674,70371,kC7JLQowN0BSKnzXXKRn5vuXi1nnM0dA,fbPkOYLVPtPgIt0MxizjfFJov3JbHyAi,14,16,13,0,10,0,3,0,42,6.0,3,0.0,0,13,0,10,16,0,0,3,0,23,19,1
7675,70372,FQa7FML2dxClmAhYk6OVYx2GHs5nEEVz,fbPkOYLVPtPgIt0MxizjfFJov3JbHyAi,11,15,5,0,3,0,4,0,27,3.857142857142857,1,0.0,0,5,0,3,15,0,0,4,0,8,19,1
7676,70373,cX0P9gUHB3WzWCloaI5EOvK7S6ZZ4sV6,fbPkOYLVPtPgIt0MxizjfFJov3JbHyAi,1,0,0,0,0,0,1,0,1,0.14285714285714285,1,0.0,0,0,0,0,0,0,0,1,0,0,1,1
7677,70375,0U0tIMU8GJAaJuwFbrHTH59SwJZ2uGnq,fbPkOYLVPtPgIt0MxizjfFJov3JbHyAi,5,2,1,0,1,0,2,0,6,0.8571428571428571,1,0.0,0,1,0,1,2,0,0,2,0,2,4,1
7678,70376,61PsrnqGMh19xjWowe2Lz8ELqYCTUUqE,fbPkOYLVPtPgIt0MxizjfFJov3JbHyAi,70,224,111,83,14,52,67,6,557,79.57142857142857,20,0.0,56,111,73,14,168,52,10,67,6,254,303,0
7679,70377,F1rdosKmYTZ6HBhTBGWJEe9EBJKQd8S8,fbPkOYLVPtPgIt0MxizjfFJov3JbHyAi,8,9,6,0,4,4,4,0,27,3.857142857142857,1,0.0,1,6,0,4,8,4,0,4,0,11,16,1
7680,70378,msjMVm4wh7wQYNgRDY7af8l1AlP1idBu,fbPkOYLVPtPgIt0MxizjfFJov3JbHyAi,13,6,3,9,3,0,4,0,25,3.5714285714285716,1,0.0,2,3,7,3,4,0,2,4,0,15,10,1
7681,70379,XjdksOkSKZrf2p0cWebK5cufRcdWg90c,fbPkOYLVPtPgIt0MxizjfFJov3JbHyAi,7,7,2,0,3,0,2,0,14,2.0,1,0.0,4,2,0,3,3,0,0,2,0,9,5,1
7682,70381,i67qzouvUD7nINgK6d1xrH4pvufZqbFd,fbPkOYLVPtPgIt0MxizjfFJov3JbHyAi,4,2,1,0,1,0,1,0,5,0.7142857142857143,1,0.0,0,1,0,1,2,0,0,1,0,2,3,1
7683,70384,QJS32fOTs325a0GlAhy998Sct293VriJ,fbPkOYLVPtPgIt0MxizjfFJov3JbHyAi,8,2,1,0,1,0,8,1,13,1.8571428571428572,1,0.0,0,1,0,1,2,0,0,8,1,2,11,1
7684,70385,BQwPjuIfQmrx5lpYZY3tsAMsirLTrL44,fbPkOYLVPtPgIt0MxizjfFJov3JbHyAi,9,4,3,0,3,0,2,0,12,1.7142857142857142,1,0.0,0,3,0,3,4,0,0,2,0,6,6,1
7685,70388,3VWYOIqoNbquvkyiG0UxiMd0Ny2ffzYn,fbPkOYLVPtPgIt0MxizjfFJov3JbHyAi,1,0,0,0,0,0,1,0,1,0.14285714285714285,1,0.0,0,0,0,0,0,0,0,1,0,0,1,1
7686,70389,AHPbZNsGkOJLnomSDr66Lsr56SzydeZ9,fbPkOYLVPtPgIt0MxizjfFJov3JbHyAi,4,0,0,0,0,0,4,0,4,0.5714285714285714,1,0.0,0,0,0,0,0,0,0,4,0,0,4,1
7687,70390,CZolsxTOSFE94rXDRXRTcZmeVsLJ3JH7,fbPkOYLVPtPgIt0MxizjfFJov3JbHyAi,20,13,10,0,8,0,4,0,35,5.0,3,0.0,0,10,0,8,13,0,0,4,0,18,17,1
7688,70391,33mJ0RGBAyjE4CKOfiTALYWXunuMDP86,fbPkOYLVPtPgIt0MxizjfFJov3JbHyAi,9,5,3,0,2,0,6,0,16,2.2857142857142856,1,0.0,0,3,0,2,5,0,0,6,0,5,11,1
7689,70392,RObsRvS6ivBKFOxQvJXBp0LqecTCcxns,fbPkOYLVPtPgIt0MxizjfFJov3JbHyAi,5,3,1,0,1,3,5,0,13,1.8571428571428572,2,0.0,0,1,0,1,3,3,0,5,0,2,11,1
7690,70393,NRRB20JWU11ewowP1RJ7HD6jBKqLT3DC,fbPkOYLVPtPgIt0MxizjfFJov3JbHyAi,1,0,0,0,0,0,1,0,1,0.14285714285714285,1,0.0,0,0,0,0,0,0,0,1,0,0,1,1
7691,70394,jVBLsQocjzyX8TfhIQuGcF0tRTsZU0fl,fbPkOYLVPtPgIt0MxizjfFJov3JbHyAi,8,8,4,0,3,0,4,0,19,2.7142857142857144,2,0.0,1,4,0,3,7,0,0,4,0,8,11,1
7692,70395,e0E9n0HmHiD7GloTGo5pwSGRifRse0is,fbPkOYLVPtPgIt0MxizjfFJov3JbHyAi,1,0,0,0,0,0,1,0,1,0.14285714285714285,1,0.0,0,0,0,0,0,0,0,1,0,0,1,1
7693,70396,WxiMfvuIhzGtTOKN3rfExm4cBAegUNmS,fbPkOYLVPtPgIt0MxizjfFJov3JbHyAi,4,0,0,0,0,1,7,0,8,1.1428571428571428,1,0.0,0,0,0,0,0,1,0,7,0,0,8,1
7694,70397,1CMLhtavMvC0VlqRyCT3yzXnyLuHWoin,fbPkOYLVPtPgIt0MxizjfFJov3JbHyAi,7,8,4,0,2,0,4,0,18,2.5714285714285716,1,0.0,0,4,0,2,8,0,0,4,0,6,12,1
7695,70398,ZDwBma59xbolXq5GHAmKUUQnUT2REqrt,fbPkOYLVPtPgIt0MxizjfFJov3JbHyAi,1,0,0,0,0,0,1,0,1,0.14285714285714285,1,0.0,0,0,0,0,0,0,0,1,0,0,1,1
7696,70399,MjMfsXNTnm5lSVaPE42HKPGjEP4JdYyv,fbPkOYLVPtPgIt0MxizjfFJov3JbHyAi,11,5,2,8,2,0,6,1,24,3.4285714285714284,1,0.0,1,2,6,2,4,0,2,6,1,11,13,1
7697,70400,SdUI7MFv1cY1lGHTqsLRYstBYRI0xIIR,fbPkOYLVPtPgIt0MxizjfFJov3JbHyAi,17,21,14,10,7,2,5,0,59,8.428571428571429,2,0.0,5,14,8,7,16,2,2,5,0,34,25,1
7698,70401,Fnv71uLEZTKv4jXhwN4OiZMjnP26bZSP,fbPkOYLVPtPgIt0MxizjfFJov3JbHyAi,3,0,0,0,0,0,5,0,5,0.7142857142857143,1,0.0,0,0,0,0,0,0,0,5,0,0,5,1
7699,70404,8ZhpSkXuKXWxDMEbryu3zVTkh7o5swmt,fbPkOYLVPtPgIt0MxizjfFJov3JbHyAi,1,0,0,0,0,0,1,0,1,0.14285714285714285,1,0.0,0,0,0,0,0,0,0,1,0,0,1,1
7700,70406,6Ozqfp4jaBSg7FmT8HpyXWJDqKSyAP5W,fbPkOYLVPtPgIt0MxizjfFJov3JbHyAi,2,0,0,0,0,0,2,0,2,0.2857142857142857,1,0.0,0,0,0,0,0,0,0,2,0,0,2,1
7701,70407,2G7A4QoutYqsQhCEpYdHlicpDLnRQDr3,fbPkOYLVPtPgIt0MxizjfFJov3JbHyAi,2,0,0,0,0,0,2,0,2,0.2857142857142857,1,0.0,0,0,0,0,0,0,0,2,0,0,2,1
7702,70409,rmhIiBxDtXLZVL14b2QxLmm4nyg5Vaki,fbPkOYLVPtPgIt0MxizjfFJov3JbHyAi,1,0,0,0,0,0,1,0,1,0.14285714285714285,1,0.0,0,0,0,0,0,0,0,1,0,0,1,1
7703,70410,XRUsgF0CDtpOGrnGNBjxKyyDO6IoyuZv,fbPkOYLVPtPgIt0MxizjfFJov3JbHyAi,1,0,0,0,0,0,1,0,1,0.14285714285714285,1,0.0,0,0,0,0,0,0,0,1,0,0,1,1
7704,70412,HJDBhocphGBunDu6wRNi5xUX9mlf7tO8,fbPkOYLVPtPgIt0MxizjfFJov3JbHyAi,43,72,24,58,25,0,9,0,188,26.857142857142858,3,0.0,30,24,51,25,42,0,7,9,0,130,58,1
7705,70414,DxcYMrQ21AStjf17HASizKXEPVvKuUI9,fbPkOYLVPtPgIt0MxizjfFJov3JbHyAi,10,6,1,0,0,2,7,1,17,2.4285714285714284,1,0.0,0,1,0,0,6,2,0,7,1,1,16,1
7706,70419,SDT3ZftpiolwjTigpC58j5o0ZRUhDG2F,fbPkOYLVPtPgIt0MxizjfFJov3JbHyAi,12,12,5,5,6,12,3,0,43,6.142857142857143,1,0.0,5,5,4,6,7,12,1,3,0,20,23,1
7707,70423,LBz8eebDA0q3o7gWfqXlzvsHwwqTUJzd,fbPkOYLVPtPgIt0MxizjfFJov3JbHyAi,14,15,7,4,3,0,8,1,38,5.428571428571429,2,0.0,5,7,3,3,10,0,1,8,1,18,20,1
7708,70424,umLfDUbxjnrT5PppK2cJ5eTNtkgpa74K,fbPkOYLVPtPgIt0MxizjfFJov3JbHyAi,1,0,0,0,0,0,1,0,1,0.14285714285714285,1,0.0,0,0,0,0,0,0,0,1,0,0,1,1
7709,70427,xlOz0HV4EOx3YcSKdziNkU6Tif0rYjnx,fbPkOYLVPtPgIt0MxizjfFJov3JbHyAi,6,8,5,0,3,0,5,0,21,3.0,3,0.0,0,5,0,3,8,0,0,5,0,8,13,1
7710,70428,XuNpmX60qMeqTMm6loZLPt3hrjsNO9oc,fbPkOYLVPtPgIt0MxizjfFJov3JbHyAi,5,2,1,0,1,0,2,0,6,0.8571428571428571,1,0.0,0,1,0,1,2,0,0,2,0,2,4,1
7711,70429,ndJjad3g9fi4m3MaVbqG9HoSdy5NpmWc,fbPkOYLVPtPgIt0MxizjfFJov3JbHyAi,5,2,1,0,1,0,2,0,6,0.8571428571428571,1,0.0,0,1,0,1,2,0,0,2,0,2,4,1
7712,70431,2g8zxwHmn0vyZ27TucfkG6P7s8LClDHy,fbPkOYLVPtPgIt0MxizjfFJov3JbHyAi,2,0,0,0,0,0,2,0,2,0.2857142857142857,1,0.0,0,0,0,0,0,0,0,2,0,0,2,1
7713,70433,guAAb9ckvAjdsS0lv2pnwyDARfevxUzH,fbPkOYLVPtPgIt0MxizjfFJov3JbHyAi,6,3,2,0,2,0,1,0,8,1.1428571428571428,1,0.0,0,2,0,2,3,0,0,1,0,4,4,1
7714,70434,lSCJ8ylZ5PCl7TN61VRBQOeN1dbHBCKj,fbPkOYLVPtPgIt0MxizjfFJov3JbHyAi,7,5,3,0,3,0,2,0,13,1.8571428571428572,2,0.0,0,3,0,3,5,0,0,2,0,6,7,1
7715,70435,bexdM93ug7d9XS96XYNBLrki1Em3eYQu,fbPkOYLVPtPgIt0MxizjfFJov3JbHyAi,1,0,0,0,0,0,1,0,1,0.14285714285714285,1,0.0,0,0,0,0,0,0,0,1,0,0,1,1
7716,70436,5tNddvEPZ6adptKjdq6L9gHvDOUDmliH,fbPkOYLVPtPgIt0MxizjfFJov3JbHyAi,7,10,2,0,2,0,2,0,16,2.2857142857142856,1,0.0,5,2,0,2,5,0,0,2,0,9,7,1
7717,70437,zlHnyn2o1Q4DVHdUqyCbAWLuHmOKttM3,fbPkOYLVPtPgIt0MxizjfFJov3JbHyAi,1,0,0,0,0,0,1,0,1,0.14285714285714285,1,0.0,0,0,0,0,0,0,0,1,0,0,1,1
7718,70438,TcuUuOMUA0rnssmvuX7CLScapgs7yDzA,fbPkOYLVPtPgIt0MxizjfFJov3JbHyAi,9,6,2,0,1,0,4,1,14,2.0,1,0.0,0,2,0,1,6,0,0,4,1,3,11,1
7719,70439,qgV0HNJ9ICkZ7TcoJUGdc2JSSqNGtGZ7,fbPkOYLVPtPgIt0MxizjfFJov3JbHyAi,8,10,6,5,4,0,3,0,28,4.0,1,0.0,3,6,4,4,7,0,1,3,0,17,11,1
7720,70441,a4heGNfxWtaNpzRnv4l5t37neKjFR36r,fbPkOYLVPtPgIt0MxizjfFJov3JbHyAi,10,12,8,0,6,0,9,1,36,5.142857142857143,2,0.0,0,8,0,6,12,0,0,9,1,14,22,1
7721,70445,jJnHLWNDobnCPy5FiRkgK6gW3VoeZNER,fbPkOYLVPtPgIt0MxizjfFJov3JbHyAi,12,6,5,0,4,10,3,0,28,4.0,1,0.0,0,5,0,4,6,10,0,3,0,9,19,1
7722,70446,ZbaPpC6DlaDgy5Ic6oj7YX9qkm2j3Pmr,fbPkOYLVPtPgIt0MxizjfFJov3JbHyAi,2,0,0,0,0,0,2,0,2,0.2857142857142857,1,0.0,0,0,0,0,0,0,0,2,0,0,2,1
7723,70449,OuD2K7J68ITZFWHHO1jbGZ6J29NSRzcb,fbPkOYLVPtPgIt0MxizjfFJov3JbHyAi,1,0,0,0,0,0,2,0,2,0.2857142857142857,1,0.0,0,0,0,0,0,0,0,2,0,0,2,1
7724,70452,BtObcKvoRLWw2wTYrIxs3nRcUhT64kDl,fbPkOYLVPtPgIt0MxizjfFJov3JbHyAi,5,3,2,0,1,0,1,0,7,1.0,1,0.0,0,2,0,1,3,0,0,1,0,3,4,1
7725,70455,UdUawMbovWyI95L2WHmtm8dSD2c6Mirq,fbPkOYLVPtPgIt0MxizjfFJov3JbHyAi,1,0,0,0,0,0,3,0,3,0.42857142857142855,2,0.0,0,0,0,0,0,0,0,3,0,0,3,1
7726,70456,glPr7QpSO3UuaddnFvb5PsvEyV64Bjzf,fbPkOYLVPtPgIt0MxizjfFJov3JbHyAi,6,9,2,4,4,0,1,0,20,2.857142857142857,1,0.0,6,2,3,4,3,0,1,1,0,15,5,1
7727,70457,yGll7cBEK4l513wg08W8WjrXiINZSUwd,fbPkOYLVPtPgIt0MxizjfFJov3JbHyAi,1,0,0,0,0,0,1,0,1,0.14285714285714285,1,0.0,0,0,0,0,0,0,0,1,0,0,1,1
7728,70458,TLnrwcxEgz2mrbehNNXwzL2eSvPdN3Si,fbPkOYLVPtPgIt0MxizjfFJov3JbHyAi,18,22,10,2,5,0,2,0,41,5.857142857142857,1,0.0,1,10,2,5,21,0,0,2,0,18,23,1
7729,70459,jR6b1WwZvYbWar4qY41wd06uzAZM2Wm4,fbPkOYLVPtPgIt0MxizjfFJov3JbHyAi,1,0,0,0,0,0,1,0,1,0.14285714285714285,1,0.0,0,0,0,0,0,0,0,1,0,0,1,1
7730,70461,6s9Xh8eciyhZj6AHFu4vTyr6KvYwFOCT,fbPkOYLVPtPgIt0MxizjfFJov3JbHyAi,2,0,0,0,0,0,2,0,2,0.2857142857142857,1,0.0,0,0,0,0,0,0,0,2,0,0,2,1
7731,70462,q7Q44V2N9alRALsjF38u0JgTcKmJyVSV,fbPkOYLVPtPgIt0MxizjfFJov3JbHyAi,8,4,2,0,1,0,6,0,13,1.8571428571428572,1,0.0,0,2,0,1,4,0,0,6,0,3,10,1
7732,70463,q5Mh1DiRxqFPerzFhySJn3OvdiZ2Qdjc,fbPkOYLVPtPgIt0MxizjfFJov3JbHyAi,9,6,4,0,3,1,5,2,21,3.0,2,0.0,0,4,0,3,6,1,0,5,2,7,14,1
7733,70469,wsHrywXqK9pQHQooNVLXSXuDfHuX10wJ,fbPkOYLVPtPgIt0MxizjfFJov3JbHyAi,11,8,5,0,4,1,6,1,25,3.5714285714285716,1,0.0,0,5,0,4,8,1,0,6,1,9,16,1
7734,70470,RbeBYSWxB5YUB8XfumpP3ReeBILP8GQy,fbPkOYLVPtPgIt0MxizjfFJov3JbHyAi,6,4,2,0,1,0,3,0,10,1.4285714285714286,1,0.0,0,2,0,1,4,0,0,3,0,3,7,1
7735,70471,qbl5rpxJliTRqjMlXPxrXNDAwFWGT88v,fbPkOYLVPtPgIt0MxizjfFJov3JbHyAi,4,2,1,0,1,0,1,0,5,0.7142857142857143,1,0.0,0,1,0,1,2,0,0,1,0,2,3,1
7736,70472,Jxzkhh0U3PjsXsXvIQ1RukUNEABuBZir,fbPkOYLVPtPgIt0MxizjfFJov3JbHyAi,6,1,1,0,1,0,3,0,6,0.8571428571428571,1,0.0,0,1,0,1,1,0,0,3,0,2,4,1
7737,70473,TfXAnflKNnQz6DuwkJiGkjk0fNqIcdbb,fbPkOYLVPtPgIt0MxizjfFJov3JbHyAi,9,3,2,0,2,0,4,0,11,1.5714285714285714,1,0.0,0,2,0,2,3,0,0,4,0,4,7,1
7738,70474,NvOjhiruQj7OPLj435mRJgxxBFzX5464,fbPkOYLVPtPgIt0MxizjfFJov3JbHyAi,1,0,0,0,0,0,1,0,1,0.14285714285714285,1,0.0,0,0,0,0,0,0,0,1,0,0,1,1
7739,70476,EiRrHQO9y6KZsQm1S959e8bTml9ewKqm,fbPkOYLVPtPgIt0MxizjfFJov3JbHyAi,6,2,1,0,1,0,5,0,9,1.2857142857142858,1,0.0,0,1,0,1,2,0,0,5,0,2,7,1
7740,70477,jEK7s8PazjYlgavgxBhEJ34esgHb5r59,fbPkOYLVPtPgIt0MxizjfFJov3JbHyAi,8,8,5,0,4,3,7,0,27,3.857142857142857,1,0.0,0,5,0,4,8,3,0,7,0,9,18,1
7741,70478,KUQVcSgCXyv6H6oERclsfGhdo9VFKXlH,fbPkOYLVPtPgIt0MxizjfFJov3JbHyAi,9,4,3,0,3,0,3,0,13,1.8571428571428572,1,0.0,0,3,0,3,4,0,0,3,0,6,7,1
7742,70481,bcuHKGDPi1i2lleukutg2XopIRt9zCPL,fbPkOYLVPtPgIt0MxizjfFJov3JbHyAi,1,0,0,0,0,0,2,0,2,0.2857142857142857,1,0.0,0,0,0,0,0,0,0,2,0,0,2,1
7743,70482,jHiBXPRyvnOA5W3dD5pIjKcoACQXqFJ5,fbPkOYLVPtPgIt0MxizjfFJov3JbHyAi,5,2,1,0,1,0,2,0,6,0.8571428571428571,1,0.0,0,1,0,1,2,0,0,2,0,2,4,1
7744,70484,NZGDKrLK9sMpIPoDEekWqKbifVFi38Go,fbPkOYLVPtPgIt0MxizjfFJov3JbHyAi,5,2,1,0,1,2,10,0,16,2.2857142857142856,1,0.0,0,1,0,1,2,2,0,10,0,2,14,1
7745,70485,scWFbDUGBDAED5tZERDIuB5WNVjTVxwA,fbPkOYLVPtPgIt0MxizjfFJov3JbHyAi,13,6,4,0,4,0,5,0,19,2.7142857142857144,1,0.0,0,4,0,4,6,0,0,5,0,8,11,1
7746,70486,HpRhpantip3wKMH4DG1UO07aIjpFrvNc,fbPkOYLVPtPgIt0MxizjfFJov3JbHyAi,1,0,0,0,0,0,1,0,1,0.14285714285714285,1,0.0,0,0,0,0,0,0,0,1,0,0,1,1
7747,70487,bNsQaARwlcoPz5iHn0mmqTE4ae2nNQLk,fbPkOYLVPtPgIt0MxizjfFJov3JbHyAi,5,2,1,0,1,0,2,0,6,0.8571428571428571,1,0.0,0,1,0,1,2,0,0,2,0,2,4,0
7748,70488,OJtIvWrXfQPJJSf2ovLSm6YwghN7AEL1,fbPkOYLVPtPgIt0MxizjfFJov3JbHyAi,7,3,2,0,2,0,2,0,9,1.2857142857142858,1,0.0,0,2,0,2,3,0,0,2,0,4,5,1
7749,70490,txE1eLKUbbtrl9557b0RVmjAcidcH23D,fbPkOYLVPtPgIt0MxizjfFJov3JbHyAi,4,2,1,0,0,0,2,0,5,0.7142857142857143,1,0.0,0,1,0,0,2,0,0,2,0,1,4,1
7750,70492,MlowXT3hhqxu8JbBXveSGYwt4gmwlpxF,fbPkOYLVPtPgIt0MxizjfFJov3JbHyAi,9,12,6,0,3,6,5,1,33,4.714285714285714,1,0.0,2,6,0,3,10,6,0,5,1,11,22,1
7751,70495,STkYkZEAJSwprBqpDKOiSfNJUIRyo0Bq,fbPkOYLVPtPgIt0MxizjfFJov3JbHyAi,10,11,7,0,4,0,5,0,27,3.857142857142857,3,0.0,0,7,0,4,11,0,0,5,0,11,16,0
7752,70496,AzLeSPI7N5fTBGeJQXVJiiiwHcrcLWj9,fbPkOYLVPtPgIt0MxizjfFJov3JbHyAi,7,2,1,0,1,0,10,0,14,2.0,1,0.0,0,1,0,1,2,0,0,10,0,2,12,1
7753,70501,QRNZCYPVLmCISEPDuklXJvVOWAcJbKvm,fbPkOYLVPtPgIt0MxizjfFJov3JbHyAi,1,0,0,0,0,0,1,0,1,0.14285714285714285,1,0.0,0,0,0,0,0,0,0,1,0,0,1,1
7754,70502,fd3M5GFuTNibIF234PDGuNuJ7TaPIle6,fbPkOYLVPtPgIt0MxizjfFJov3JbHyAi,11,8,3,0,2,0,12,0,25,3.5714285714285716,4,0.0,0,3,0,2,8,0,0,12,0,5,20,1
7755,70503,yoIXcPh3WeERNBgp3KavFpHxxtSbEbDw,fbPkOYLVPtPgIt0MxizjfFJov3JbHyAi,1,0,0,0,0,0,1,0,1,0.14285714285714285,1,0.0,0,0,0,0,0,0,0,1,0,0,1,1
7756,70504,hx5sJ7jwWSrYbv8AAwrwIYlkyA5lh0xw,fbPkOYLVPtPgIt0MxizjfFJov3JbHyAi,7,8,0,0,0,0,3,0,11,1.5714285714285714,2,0.0,0,0,0,0,8,0,0,3,0,0,11,1
7757,70506,mfNh4uOHHxwzdcujnNlWt7NLyD4AZdsC,fbPkOYLVPtPgIt0MxizjfFJov3JbHyAi,6,6,1,0,1,0,2,0,10,1.4285714285714286,1,0.0,0,1,0,1,6,0,0,2,0,2,8,1
7758,70617,UNVbIrcEO0nclbN5f0xdIeSb61jrpRSX,fbPkOYLVPtPgIt0MxizjfFJov3JbHyAi,12,31,8,4,10,0,10,0,63,9.0,3,0.0,18,8,3,10,13,0,1,10,0,39,24,1
7759,70618,pE2pfmXY2JZ1ppA5N0APNqSGmVpRUVPY,fbPkOYLVPtPgIt0MxizjfFJov3JbHyAi,4,2,1,0,0,0,2,0,5,0.7142857142857143,1,0.0,0,1,0,0,2,0,0,2,0,1,4,1
7760,70620,szRdvMC9nJxtimPyvxBftIjBA99HXMVn,fbPkOYLVPtPgIt0MxizjfFJov3JbHyAi,5,2,1,0,1,0,2,0,6,0.8571428571428571,1,0.0,0,1,0,1,2,0,0,2,0,2,4,1
7761,70622,vL40lDIpwhva8z6IagRWvDtekT2W0mhZ,fbPkOYLVPtPgIt0MxizjfFJov3JbHyAi,10,12,9,0,7,7,6,0,41,5.857142857142857,3,0.0,0,9,0,7,12,7,0,6,0,16,25,1
7762,70623,MIB3h4eZc4hBNhmh6kNQRNuuqfplV8jE,fbPkOYLVPtPgIt0MxizjfFJov3JbHyAi,2,0,0,0,0,0,3,0,3,0.42857142857142855,1,0.0,0,0,0,0,0,0,0,3,0,0,3,1
7763,70624,ig7R2lu2J2odRrDTiKZUVfTrsahUIcRt,fbPkOYLVPtPgIt0MxizjfFJov3JbHyAi,5,2,1,0,1,0,3,0,7,1.0,2,0.0,0,1,0,1,2,0,0,3,0,2,5,0
7764,70625,07qmQr7YUC93IIwpmr9s2O0n03vLXYHf,fbPkOYLVPtPgIt0MxizjfFJov3JbHyAi,5,4,1,0,1,0,2,0,8,1.1428571428571428,1,0.0,1,1,0,1,3,0,0,2,0,3,5,1
7765,70626,QhtGT2PDmxENzsHDxP88jgz9lWXkKr4b,fbPkOYLVPtPgIt0MxizjfFJov3JbHyAi,9,20,9,6,9,4,1,0,49,7.0,1,0.0,3,9,5,9,17,4,1,1,0,26,23,1
7766,70627,VJsbRtMXxy8aqyccEZDzV7pPAGBosBu1,fbPkOYLVPtPgIt0MxizjfFJov3JbHyAi,76,121,82,39,46,6,21,2,317,45.285714285714285,9,0.0,22,82,34,46,99,6,5,21,2,184,133,0
7767,70629,jsdFWuQZ9wDLCnnTt28t2BLCDeZlTxUM,fbPkOYLVPtPgIt0MxizjfFJov3JbHyAi,6,5,1,0,1,0,2,0,9,1.2857142857142858,1,0.0,0,1,0,1,5,0,0,2,0,2,7,1
7768,70632,sMynuMhoZTpmWI7JIgM7Zcgv9Nw77yWq,fbPkOYLVPtPgIt0MxizjfFJov3JbHyAi,5,2,1,0,1,0,2,0,6,0.8571428571428571,1,0.0,0,1,0,1,2,0,0,2,0,2,4,1
7769,70635,DIYlLDsIX3rRB00v33V6F050gdzNiYGy,fbPkOYLVPtPgIt0MxizjfFJov3JbHyAi,10,13,9,5,5,0,3,0,35,5.0,2,0.0,1,9,4,5,12,0,1,3,0,19,16,1
7770,70636,cWnlO9T3wiOdZzNrm52Q8On5YEPOag8t,fbPkOYLVPtPgIt0MxizjfFJov3JbHyAi,14,21,2,0,2,0,11,0,36,5.142857142857143,3,0.0,1,2,0,2,20,0,0,11,0,5,31,1
7771,70637,1fleh7lPd7aghMITlPRITTq0TKiljgoj,fbPkOYLVPtPgIt0MxizjfFJov3JbHyAi,7,3,2,0,2,0,3,0,10,1.4285714285714286,2,0.0,0,2,0,2,3,0,0,3,0,4,6,1
7772,70638,xM8lVcqU5uqtxPXKRkobTl3b50GvL7Y6,fbPkOYLVPtPgIt0MxizjfFJov3JbHyAi,5,2,1,0,1,0,2,0,6,0.8571428571428571,1,0.0,0,1,0,1,2,0,0,2,0,2,4,1
7773,70641,2uadn8x6eG3s1sEJofJgCr35bh3OHGLh,fbPkOYLVPtPgIt0MxizjfFJov3JbHyAi,33,56,31,11,19,42,18,1,178,25.428571428571427,6,0.0,18,31,11,19,38,42,0,18,1,79,99,1
7774,70642,FaGf4ZENvncNMeGerxuOLnibVyMwnEb7,fbPkOYLVPtPgIt0MxizjfFJov3JbHyAi,4,2,1,0,1,0,1,0,5,0.7142857142857143,1,0.0,0,1,0,1,2,0,0,1,0,2,3,1
7775,70644,6kW13L6OI2CXAgkzbQCGiGCWDPgPVNqL,fbPkOYLVPtPgIt0MxizjfFJov3JbHyAi,8,3,2,0,2,0,5,1,13,1.8571428571428572,1,0.0,0,2,0,2,3,0,0,5,1,4,9,1
7776,70646,tuBfe6WhJei1RdPAXwFNRJbSnuTMeD4l,fbPkOYLVPtPgIt0MxizjfFJov3JbHyAi,1,0,0,0,0,0,1,0,1,0.14285714285714285,1,0.0,0,0,0,0,0,0,0,1,0,0,1,1
7777,70647,5Hvfr1gz4w1l7NMxdNIG23Iybswr6a4X,fbPkOYLVPtPgIt0MxizjfFJov3JbHyAi,5,2,1,0,1,0,2,0,6,0.8571428571428571,1,0.0,0,1,0,1,2,0,0,2,0,2,4,1
7778,70648,fdJXQSSucuzaRljy096jXgInnW2TakHQ,fbPkOYLVPtPgIt0MxizjfFJov3JbHyAi,1,0,0,0,0,0,1,0,1,0.14285714285714285,1,0.0,0,0,0,0,0,0,0,1,0,0,1,1
7779,70649,TqM5lkEeW6odNqcCIpnB8ZfnKymScjxh,fbPkOYLVPtPgIt0MxizjfFJov3JbHyAi,9,10,7,0,6,0,8,0,31,4.428571428571429,1,0.0,0,7,0,6,10,0,0,8,0,13,18,1
7780,70651,zPbUIdTRPjnN9GVjy7Vs8SVwjdhRAaUM,fbPkOYLVPtPgIt0MxizjfFJov3JbHyAi,14,40,18,0,6,54,15,1,134,19.142857142857142,7,0.0,3,18,0,6,37,54,0,15,1,27,107,1
7781,70652,RUk1UgFf8pHkjYocajMr35nYXvyKvRsO,fbPkOYLVPtPgIt0MxizjfFJov3JbHyAi,21,31,14,0,8,15,11,2,81,11.571428571428571,2,0.0,0,14,0,8,31,15,0,11,2,22,59,1
7782,70653,PNYL1Lh4wAAOtLwVLWtMerOLdRvGmWgc,fbPkOYLVPtPgIt0MxizjfFJov3JbHyAi,7,1,1,0,1,1,4,1,9,1.2857142857142858,1,0.0,0,1,0,1,1,1,0,4,1,2,7,1
7783,70655,NrraMyTwgTzYDPkTyoYsd0r0OJPy1sab,fbPkOYLVPtPgIt0MxizjfFJov3JbHyAi,7,3,2,0,2,0,6,0,13,1.8571428571428572,1,0.0,0,2,0,2,3,0,0,6,0,4,9,1
7784,70656,Nc9p0NDSJdMFoXyGCYKlMLXQtm4qOOTX,fbPkOYLVPtPgIt0MxizjfFJov3JbHyAi,7,3,2,0,2,6,6,0,19,2.7142857142857144,1,0.0,0,2,0,2,3,6,0,6,0,4,15,1
7785,70657,kF87tAiaM8moNftPhO4ia9AXwDDxrUtb,fbPkOYLVPtPgIt0MxizjfFJov3JbHyAi,11,9,5,0,2,14,13,4,47,6.714285714285714,1,0.0,0,5,0,2,9,14,0,13,4,7,40,1
7786,70658,7h3tDULs3BTNaDybaRAqNsIlSNoXgEZh,fbPkOYLVPtPgIt0MxizjfFJov3JbHyAi,11,14,6,0,4,0,7,0,31,4.428571428571429,2,0.0,1,6,0,4,13,0,0,7,0,11,20,1
7787,70659,3w3oVzXQmE457clbfwy8fl67WyFwWeZX,fbPkOYLVPtPgIt0MxizjfFJov3JbHyAi,4,3,1,0,1,0,1,0,6,0.8571428571428571,1,0.0,0,1,0,1,3,0,0,1,0,2,4,1
7788,70661,eLqag6twmL6nT6SLVrpY07QGG3bytKwe,fbPkOYLVPtPgIt0MxizjfFJov3JbHyAi,4,3,2,0,2,0,2,0,9,1.2857142857142858,1,0.0,0,2,0,2,3,0,0,2,0,4,5,1
7789,70664,8djQJACWabqqdfUYlZxiiBK5fRdO0gWZ,fbPkOYLVPtPgIt0MxizjfFJov3JbHyAi,26,35,19,13,8,10,9,0,94,13.428571428571429,5,0.0,6,19,11,8,29,10,2,9,0,44,50,1
7790,70666,ThmrVFQiXEXdtbVq9OcHgxf5egZE7CCF,fbPkOYLVPtPgIt0MxizjfFJov3JbHyAi,1,0,0,0,0,0,1,0,1,0.14285714285714285,1,0.0,0,0,0,0,0,0,0,1,0,0,1,1
7791,70669,NrAjCwSdkokFEs2cMTtwLegWozRaakkE,fbPkOYLVPtPgIt0MxizjfFJov3JbHyAi,7,3,2,0,2,0,2,0,9,1.2857142857142858,1,0.0,0,2,0,2,3,0,0,2,0,4,5,1
7792,70670,mgRmoo6F9KYYizHMOajedFcuJHtEV6by,fbPkOYLVPtPgIt0MxizjfFJov3JbHyAi,32,32,13,21,8,0,3,0,77,11.0,2,0.0,10,13,21,8,22,0,0,3,0,52,25,1
7793,70672,XRCyFAenNfq06SRijoW2bL3eLeq7TTnH,fbPkOYLVPtPgIt0MxizjfFJov3JbHyAi,1,0,0,0,0,0,1,0,1,0.14285714285714285,1,0.0,0,0,0,0,0,0,0,1,0,0,1,1
7794,70674,tsQNS0TFi4T2OwDWxOZsXYloXeaBeZAv,fbPkOYLVPtPgIt0MxizjfFJov3JbHyAi,16,22,11,10,8,0,3,0,54,7.714285714285714,3,0.0,5,11,10,8,17,0,0,3,0,34,20,1
7795,70675,qgTFbAMyZczl8sJiC9JGSI0pTfFVEsq0,fbPkOYLVPtPgIt0MxizjfFJov3JbHyAi,2,0,0,0,0,0,3,0,3,0.42857142857142855,1,0.0,0,0,0,0,0,0,0,3,0,0,3,1
7796,70676,Pv9LrfjnRw1WO1VwPNHCu7aKxUz6zC8i,fbPkOYLVPtPgIt0MxizjfFJov3JbHyAi,11,17,13,0,7,5,5,0,47,6.714285714285714,3,0.0,0,13,0,7,17,5,0,5,0,20,27,1
7797,70677,zmlL73g2U1Ek37ZDQ2H6P7dwK1MBsxuX,fbPkOYLVPtPgIt0MxizjfFJov3JbHyAi,11,24,13,2,8,11,10,0,68,9.714285714285714,4,0.0,5,13,2,8,19,11,0,10,0,28,40,1
7798,70678,o8iN3RNsKXCFYghfUgBvPvRXa514UVMy,fbPkOYLVPtPgIt0MxizjfFJov3JbHyAi,1,0,0,0,0,0,1,0,1,0.14285714285714285,1,0.0,0,0,0,0,0,0,0,1,0,0,1,1
7799,70682,KAxSek3GgKlkDfM652adYCX6zjbSz36L,fbPkOYLVPtPgIt0MxizjfFJov3JbHyAi,7,5,4,0,2,0,2,0,13,1.8571428571428572,1,0.0,0,4,0,2,5,0,0,2,0,6,7,1
7800,70685,HUREvJ7y9WAOKVUwE1W5wjAznpJ2uyCs,fbPkOYLVPtPgIt0MxizjfFJov3JbHyAi,9,4,3,0,3,0,3,0,13,1.8571428571428572,1,0.0,0,3,0,3,4,0,0,3,0,6,7,1
7801,70687,EjU0dAqbUvEwc53uCAdZVva4XIVSaRPC,fbPkOYLVPtPgIt0MxizjfFJov3JbHyAi,5,2,1,0,1,0,4,0,8,1.1428571428571428,1,0.0,0,1,0,1,2,0,0,4,0,2,6,1
7802,70688,RtFjOHQ78yo3bQ6aRAVmoLevb4Ve3GxB,fbPkOYLVPtPgIt0MxizjfFJov3JbHyAi,7,5,3,0,1,0,5,0,14,2.0,2,0.0,0,3,0,1,5,0,0,5,0,4,10,1
7803,70690,R8o5XScw0cHktAR1kvrGC4Hk6nsNJ50O,fbPkOYLVPtPgIt0MxizjfFJov3JbHyAi,7,4,2,0,2,0,2,0,10,1.4285714285714286,1,0.0,0,2,0,2,4,0,0,2,0,4,6,1
7804,70691,sW1u9EOUYrJApfkaDSoDkISZzFP3ogv6,fbPkOYLVPtPgIt0MxizjfFJov3JbHyAi,6,4,2,0,2,0,1,0,9,1.2857142857142858,1,0.0,0,2,0,2,4,0,0,1,0,4,5,1
7805,70693,10zM0lTEidXp4ysKuDBYxHMLWTshL529,fbPkOYLVPtPgIt0MxizjfFJov3JbHyAi,1,0,0,0,0,0,1,0,1,0.14285714285714285,1,0.0,0,0,0,0,0,0,0,1,0,0,1,1
7806,70695,aR3fk0CNwd9ygarvr0BOVu5p8WeU32I1,fbPkOYLVPtPgIt0MxizjfFJov3JbHyAi,5,2,1,0,1,0,4,0,8,1.1428571428571428,2,0.0,0,1,0,1,2,0,0,4,0,2,6,0
7807,70697,ZQ7aIrw0oaneyIJXr1o9BaGyCupjLIKv,fbPkOYLVPtPgIt0MxizjfFJov3JbHyAi,8,9,3,0,3,0,2,0,17,2.4285714285714284,1,0.0,4,3,0,3,5,0,0,2,0,10,7,1
7808,70699,w5ZVCLR3vfwLftGVhyQYRVOjp6YWhw1i,fbPkOYLVPtPgIt0MxizjfFJov3JbHyAi,14,19,6,2,6,0,11,2,46,6.571428571428571,1,0.0,7,6,2,6,12,0,0,11,2,21,25,1
7809,70700,TaMOkXsZdqqtZoisxF7gCh53bqhSIWJo,fbPkOYLVPtPgIt0MxizjfFJov3JbHyAi,8,3,1,0,1,2,6,1,14,2.0,1,0.0,0,1,0,1,3,2,0,6,1,2,12,1
7810,70701,u71FEuwuCmO3r4p2rE2moG5KipMWcySZ,fbPkOYLVPtPgIt0MxizjfFJov3JbHyAi,6,3,0,0,0,0,6,2,11,1.5714285714285714,1,0.0,0,0,0,0,3,0,0,6,2,0,11,1
7811,70702,0x2sITGXbmptNoJgvpnNEvFzUs19fgRa,fbPkOYLVPtPgIt0MxizjfFJov3JbHyAi,5,3,1,0,1,0,2,0,7,1.0,1,0.0,0,1,0,1,3,0,0,2,0,2,5,1
7812,70703,Evomveryl9GU6Kyv21VjN2TZpSsXcU7r,fbPkOYLVPtPgIt0MxizjfFJov3JbHyAi,2,0,0,0,0,0,3,0,3,0.42857142857142855,1,0.0,0,0,0,0,0,0,0,3,0,0,3,1
7813,70704,vyZYP10ZbNOAlqCfJpVxupzTWedLnj63,fbPkOYLVPtPgIt0MxizjfFJov3JbHyAi,1,0,0,0,0,0,1,0,1,0.14285714285714285,1,0.0,0,0,0,0,0,0,0,1,0,0,1,1
7814,70705,tdygDfFACDU3UgcaUQcaQlbTc0CT910g,fbPkOYLVPtPgIt0MxizjfFJov3JbHyAi,5,2,0,0,0,0,4,0,6,0.8571428571428571,1,0.0,0,0,0,0,2,0,0,4,0,0,6,1
7815,70706,2j7JDJ8MsffyV0kSC0vh7baFkUIS4GAx,fbPkOYLVPtPgIt0MxizjfFJov3JbHyAi,36,74,28,35,30,0,9,0,176,25.142857142857142,5,0.0,42,28,28,30,32,0,7,9,0,128,48,1
7816,70708,7h2Z9QDw2si8maJ5It93IgGcw9Rvo97L,fbPkOYLVPtPgIt0MxizjfFJov3JbHyAi,7,2,1,0,1,0,3,0,7,1.0,1,0.0,0,1,0,1,2,0,0,3,0,2,5,1
7817,70709,bxNjpvJUyYuoYRYlnOXzFxygMwQkPpdy,fbPkOYLVPtPgIt0MxizjfFJov3JbHyAi,1,0,0,0,0,0,1,0,1,0.14285714285714285,1,0.0,0,0,0,0,0,0,0,1,0,0,1,1
7818,70710,ZbRcmeUPJ5YWlzvZySRNdBYY12qzZPLH,fbPkOYLVPtPgIt0MxizjfFJov3JbHyAi,2,0,0,0,0,0,5,0,5,0.7142857142857143,1,0.0,0,0,0,0,0,0,0,5,0,0,5,1
7819,70711,898EWlvcqwFCOnhtz4G2TeXb2eJQJsSY,fbPkOYLVPtPgIt0MxizjfFJov3JbHyAi,6,4,0,0,0,0,5,1,10,1.4285714285714286,1,0.0,0,0,0,0,4,0,0,5,1,0,10,1
7820,70712,OXXS9H9b2CvKWuZ1kgFXpystd5LpKcni,fbPkOYLVPtPgIt0MxizjfFJov3JbHyAi,1,0,0,0,0,0,2,0,2,0.2857142857142857,1,0.0,0,0,0,0,0,0,0,2,0,0,2,1
7821,70713,4aIAxdudlKdNnJYDYlmurnayXljF85dB,fbPkOYLVPtPgIt0MxizjfFJov3JbHyAi,5,2,1,0,1,0,2,0,6,0.8571428571428571,1,0.0,0,1,0,1,2,0,0,2,0,2,4,1
7822,70715,fMmuNXjPEhNXfnU1x4BfSanHlv9m7fK3,fbPkOYLVPtPgIt0MxizjfFJov3JbHyAi,7,6,2,0,3,0,2,0,13,1.8571428571428572,1,0.0,3,2,0,3,3,0,0,2,0,8,5,1
7823,70717,ptm9xuFWpeV3IYsTqQHb5OT1hlhuZP2R,fbPkOYLVPtPgIt0MxizjfFJov3JbHyAi,5,2,1,0,1,0,2,0,6,0.8571428571428571,1,0.0,0,1,0,1,2,0,0,2,0,2,4,1
7824,70721,vKb5mkAesgp0CxIabJFr8I3VERLyILwt,fbPkOYLVPtPgIt0MxizjfFJov3JbHyAi,2,0,0,0,0,0,2,0,2,0.2857142857142857,1,0.0,0,0,0,0,0,0,0,2,0,0,2,1
7825,70722,x3bkOAcKf3YrvrKxnJbZKaEoApnaabtK,fbPkOYLVPtPgIt0MxizjfFJov3JbHyAi,2,0,0,0,0,0,5,0,5,0.7142857142857143,1,0.0,0,0,0,0,0,0,0,5,0,0,5,1
7826,70723,IkoiWVr2ygCLdZNh2Bkmtx3mmgIErIzY,fbPkOYLVPtPgIt0MxizjfFJov3JbHyAi,1,0,0,0,0,0,1,0,1,0.14285714285714285,1,0.0,0,0,0,0,0,0,0,1,0,0,1,1
7827,70727,jtRMyLnPrQKBYosd7A0axGxYdzZLfoyG,fbPkOYLVPtPgIt0MxizjfFJov3JbHyAi,5,2,1,0,1,0,2,0,6,0.8571428571428571,1,0.0,0,1,0,1,2,0,0,2,0,2,4,1
7828,70728,txNRRPx9OJW1ssLv0i1BuynOrKT6T5bw,fbPkOYLVPtPgIt0MxizjfFJov3JbHyAi,7,3,2,0,2,0,2,0,9,1.2857142857142858,1,0.0,0,2,0,2,3,0,0,2,0,4,5,1
7829,70729,D7NGYdR3TLx6U0EvEqMYenyKGPerYPxa,fbPkOYLVPtPgIt0MxizjfFJov3JbHyAi,4,2,1,0,1,0,1,0,5,0.7142857142857143,1,0.0,0,1,0,1,2,0,0,1,0,2,3,1
7830,70730,OdsEBh425XZxll0hTUv04OAotDf6aGtE,fbPkOYLVPtPgIt0MxizjfFJov3JbHyAi,1,0,0,0,0,0,1,0,1,0.14285714285714285,1,0.0,0,0,0,0,0,0,0,1,0,0,1,1
7831,70732,1Z5BGBo2C4Yx5dovaTv5L9hwpHiDBAED,fbPkOYLVPtPgIt0MxizjfFJov3JbHyAi,6,0,0,0,0,0,5,3,8,1.1428571428571428,1,0.0,0,0,0,0,0,0,0,5,3,0,8,1
7832,70734,5W0RrimHGXv2rlPQ5YUetmDKQyAz3Zx5,fbPkOYLVPtPgIt0MxizjfFJov3JbHyAi,5,2,1,0,1,0,4,0,8,1.1428571428571428,1,0.0,0,1,0,1,2,0,0,4,0,2,6,1
7833,70736,pVY9a8xiiW5Hoddx6sJePwV7ScRr5XzD,fbPkOYLVPtPgIt0MxizjfFJov3JbHyAi,5,2,1,0,1,0,2,0,6,0.8571428571428571,1,0.0,0,1,0,1,2,0,0,2,0,2,4,1
7834,70737,Dht5yukEe9IZ0iWFi8cUIe1SOPRbmo8J,fbPkOYLVPtPgIt0MxizjfFJov3JbHyAi,1,0,0,0,0,0,1,0,1,0.14285714285714285,1,0.0,0,0,0,0,0,0,0,1,0,0,1,1
7835,70742,cMdcyYeaotcfCR4kGKYkD6AiwNH9y3n3,fbPkOYLVPtPgIt0MxizjfFJov3JbHyAi,1,0,0,0,0,0,1,0,1,0.14285714285714285,1,0.0,0,0,0,0,0,0,0,1,0,0,1,1
7836,70743,vIbI2SixV9mKPlPtOmgytvBhorWx01zg,fbPkOYLVPtPgIt0MxizjfFJov3JbHyAi,9,20,5,4,7,0,4,0,40,5.714285714285714,2,0.0,5,5,4,7,15,0,0,4,0,21,19,1
7837,70744,JRuzCriX6hvuTQ943ttXKlmrFVyfxMHr,fbPkOYLVPtPgIt0MxizjfFJov3JbHyAi,9,17,10,0,8,0,5,0,40,5.714285714285714,2,0.0,0,10,0,8,17,0,0,5,0,18,22,1
7838,70747,lzZwGZ8LEp741qdGyudVx7KySokTlOIW,fbPkOYLVPtPgIt0MxizjfFJov3JbHyAi,2,0,0,0,0,0,2,0,2,0.2857142857142857,1,0.0,0,0,0,0,0,0,0,2,0,0,2,1
7839,70749,R7ezqxAQ4nt5CDDIMvGiu8qnbxIzzY4p,fbPkOYLVPtPgIt0MxizjfFJov3JbHyAi,12,18,5,5,7,7,5,0,47,6.714285714285714,1,0.0,11,5,4,7,7,7,1,5,0,27,20,1
7840,70750,IUee3dxL3SpdHZIyH7i51dwHDxPaEBUA,fbPkOYLVPtPgIt0MxizjfFJov3JbHyAi,5,4,3,0,0,2,2,0,11,1.5714285714285714,1,0.0,0,3,0,0,4,2,0,2,0,3,8,1
7841,70752,SQJaiB30pTjKgZfQdgaYh0tKJZ2Vbeya,fbPkOYLVPtPgIt0MxizjfFJov3JbHyAi,5,2,1,0,1,5,4,0,13,1.8571428571428572,1,0.0,0,1,0,1,2,5,0,4,0,2,11,1
7842,70753,pPpyZpCndPvCUqSYWY13yKivGYGNWTDN,fbPkOYLVPtPgIt0MxizjfFJov3JbHyAi,10,5,2,0,2,0,6,1,16,2.2857142857142856,2,0.0,0,2,0,2,5,0,0,6,1,4,12,1
7843,70757,lvOGlvq1OFLMKhaj3JewwbbVHWgR6eFx,fbPkOYLVPtPgIt0MxizjfFJov3JbHyAi,5,2,1,0,1,0,2,0,6,0.8571428571428571,1,0.0,0,1,0,1,2,0,0,2,0,2,4,1
7844,70760,OqvR8B9aeDPyw7GoFTuy14iBmyo2yUUo,fbPkOYLVPtPgIt0MxizjfFJov3JbHyAi,1,0,0,0,0,0,1,0,1,0.14285714285714285,1,0.0,0,0,0,0,0,0,0,1,0,0,1,1
7845,70761,jlGY9VVNLsG0TC6XiI2Gb1hDNr4xsLUL,fbPkOYLVPtPgIt0MxizjfFJov3JbHyAi,1,0,0,0,0,0,1,0,1,0.14285714285714285,1,0.0,0,0,0,0,0,0,0,1,0,0,1,1
7846,70762,WwezrN5LILw3d1vvAAZRdwCqhKY8Em85,fbPkOYLVPtPgIt0MxizjfFJov3JbHyAi,1,0,0,0,0,0,1,0,1,0.14285714285714285,1,0.0,0,0,0,0,0,0,0,1,0,0,1,1
7847,70764,tLk8QFN3K7Bcj6ufd8b4XKqxIHVe1uKA,fbPkOYLVPtPgIt0MxizjfFJov3JbHyAi,5,2,1,0,1,0,2,0,6,0.8571428571428571,1,0.0,0,1,0,1,2,0,0,2,0,2,4,1
7848,70765,tGM2jlTFxHBYs0VdqQh38eEUGkMospiQ,fbPkOYLVPtPgIt0MxizjfFJov3JbHyAi,5,6,0,0,0,2,2,0,10,1.4285714285714286,1,0.0,1,0,0,0,5,2,0,2,0,1,9,1
7849,70769,ZkpfVZ9dukn1hNLus0iW46eniC4TxZ6X,fbPkOYLVPtPgIt0MxizjfFJov3JbHyAi,1,0,0,0,0,0,1,0,1,0.14285714285714285,1,0.0,0,0,0,0,0,0,0,1,0,0,1,1
7850,70770,HTGoS5GBox39vCiJgxlIGI9vDOWsXL3B,fbPkOYLVPtPgIt0MxizjfFJov3JbHyAi,1,0,0,0,0,0,1,0,1,0.14285714285714285,1,0.0,0,0,0,0,0,0,0,1,0,0,1,1
7851,70771,4kLcf1sktZawnqU0fFOj7xHNGXJNEsqd,fbPkOYLVPtPgIt0MxizjfFJov3JbHyAi,5,2,1,0,1,0,2,0,6,0.8571428571428571,1,0.0,0,1,0,1,2,0,0,2,0,2,4,1
7852,70772,pSL3xyt1UkD2OS3D0WJIKUXPhJ7M3COF,fbPkOYLVPtPgIt0MxizjfFJov3JbHyAi,5,3,1,0,1,4,4,0,13,1.8571428571428572,2,0.0,0,1,0,1,3,4,0,4,0,2,11,1
7853,70773,0HbAPj0XnG7vlXZFqJF9LLMjlYRkGlju,fbPkOYLVPtPgIt0MxizjfFJov3JbHyAi,5,2,1,0,1,0,2,0,6,0.8571428571428571,1,0.0,0,1,0,1,2,0,0,2,0,2,4,1
7854,70774,u8utNBdxE23PvPDWJ6xVLDwIgTiwdrjZ,fbPkOYLVPtPgIt0MxizjfFJov3JbHyAi,7,3,2,0,2,0,5,0,12,1.7142857142857142,1,0.0,0,2,0,2,3,0,0,5,0,4,8,1
7855,70775,gefkY5cBNvxKJUtGlDogpcQymljtkCst,fbPkOYLVPtPgIt0MxizjfFJov3JbHyAi,7,7,2,0,1,0,5,0,15,2.142857142857143,1,0.0,0,2,0,1,7,0,0,5,0,3,12,1
7856,70776,QjEHoumOE3gC1HJbKGy6t8704j46vuue,fbPkOYLVPtPgIt0MxizjfFJov3JbHyAi,5,2,1,0,1,0,2,0,6,0.8571428571428571,1,0.0,0,1,0,1,2,0,0,2,0,2,4,1
7857,70779,i26V50afV6u2Oz8a9ixc5ngW3fXqCcxA,fbPkOYLVPtPgIt0MxizjfFJov3JbHyAi,1,0,0,0,0,0,1,0,1,0.14285714285714285,1,0.0,0,0,0,0,0,0,0,1,0,0,1,1
7858,70780,sEr814ypFl2X1b9bje9rxXB65bZC1Pq5,fbPkOYLVPtPgIt0MxizjfFJov3JbHyAi,6,1,1,0,1,0,6,0,9,1.2857142857142858,1,0.0,0,1,0,1,1,0,0,6,0,2,7,1
7859,70781,ctdO04zd7K8QUa5HFdH2dxaEs6nEQGcX,fbPkOYLVPtPgIt0MxizjfFJov3JbHyAi,9,9,6,0,3,1,3,0,22,3.142857142857143,2,0.0,0,6,0,3,9,1,0,3,0,9,13,0
7860,70783,mjSdUbH7OSJo2BOaPOnuv8MaiHH7FYld,fbPkOYLVPtPgIt0MxizjfFJov3JbHyAi,7,7,1,0,1,0,6,0,15,2.142857142857143,1,0.0,0,1,0,1,7,0,0,6,0,2,13,1
7861,70784,aF5137RwRQKiOvbUfzDxmAlUCEx92fD4,fbPkOYLVPtPgIt0MxizjfFJov3JbHyAi,1,0,0,0,0,0,1,0,1,0.14285714285714285,1,0.0,0,0,0,0,0,0,0,1,0,0,1,1
7862,70787,Oul8bw2tz24DOZALLi9OxblcSUmg6nEp,fbPkOYLVPtPgIt0MxizjfFJov3JbHyAi,1,0,0,0,0,0,1,0,1,0.14285714285714285,1,0.0,0,0,0,0,0,0,0,1,0,0,1,1
7863,70789,mCnzi5BmvpEBZDUN0ETW99FPkWmNtKNX,fbPkOYLVPtPgIt0MxizjfFJov3JbHyAi,1,0,0,0,0,0,1,0,1,0.14285714285714285,1,0.0,0,0,0,0,0,0,0,1,0,0,1,1
7864,70793,7SossPIJgp94YSmcs9GpN1Sm5zV7LKJL,fbPkOYLVPtPgIt0MxizjfFJov3JbHyAi,7,2,1,0,1,0,3,0,7,1.0,1,0.0,0,1,0,1,2,0,0,3,0,2,5,1
7865,70794,JMM8zz1Uply0QN5h5fJ96sYTBK2yeOxI,fbPkOYLVPtPgIt0MxizjfFJov3JbHyAi,9,6,1,0,1,0,6,0,14,2.0,1,0.0,0,1,0,1,6,0,0,6,0,2,12,1
7866,70796,t9IYCo7lv1UoShjijTGehWjAkf2pn5n5,fbPkOYLVPtPgIt0MxizjfFJov3JbHyAi,5,7,0,0,0,0,4,0,11,1.5714285714285714,1,0.0,0,0,0,0,7,0,0,4,0,0,11,1
7867,70797,uu7UzVxYYlz1pgYD2MFJ9iOaqFHTpesA,fbPkOYLVPtPgIt0MxizjfFJov3JbHyAi,7,4,2,0,1,2,4,1,14,2.0,2,0.0,0,2,0,1,4,2,0,4,1,3,11,1
7868,70799,fanbcR91UHcbTVNiIv1nQj1qUYZ30rX0,fbPkOYLVPtPgIt0MxizjfFJov3JbHyAi,1,0,0,0,0,0,1,0,1,0.14285714285714285,1,0.0,0,0,0,0,0,0,0,1,0,0,1,1
7869,70803,ssyd9rdEHVqPnd0fx1MHuvIhEU773VLT,fbPkOYLVPtPgIt0MxizjfFJov3JbHyAi,2,0,0,0,0,0,3,0,3,0.42857142857142855,1,0.0,0,0,0,0,0,0,0,3,0,0,3,1
7870,70804,1NKuiSaTPUbZFDACCyv5YoUfO7qDer9w,fbPkOYLVPtPgIt0MxizjfFJov3JbHyAi,6,6,2,0,1,0,2,0,11,1.5714285714285714,1,0.0,2,2,0,1,4,0,0,2,0,5,6,1
7871,70808,lpmkkM8oiYpde5WjxbhcBFXAV9lrOr4z,fbPkOYLVPtPgIt0MxizjfFJov3JbHyAi,2,0,0,0,0,0,3,0,3,0.42857142857142855,1,0.0,0,0,0,0,0,0,0,3,0,0,3,1
7872,70809,Fr6BZTrWQKFo57dNUS0jHL2UnsMPDOqr,fbPkOYLVPtPgIt0MxizjfFJov3JbHyAi,6,1,1,0,1,0,3,0,6,0.8571428571428571,1,0.0,0,1,0,1,1,0,0,3,0,2,4,1
7873,70812,CkTzCZEBDUKVj2CxuBE6PIjgAxiqFn5E,fbPkOYLVPtPgIt0MxizjfFJov3JbHyAi,2,0,0,0,0,0,2,0,2,0.2857142857142857,1,0.0,0,0,0,0,0,0,0,2,0,0,2,1
7874,70813,yk15CHpjIZz9cgwSjdiK1bpIkmjG49Ja,fbPkOYLVPtPgIt0MxizjfFJov3JbHyAi,3,0,0,0,0,0,3,0,3,0.42857142857142855,1,0.0,0,0,0,0,0,0,0,3,0,0,3,1
7875,70814,7DDb0W5dNil3mOKBSIGlg2cdwn7LYTP2,fbPkOYLVPtPgIt0MxizjfFJov3JbHyAi,9,9,5,0,4,0,5,0,23,3.2857142857142856,1,0.0,0,5,0,4,9,0,0,5,0,9,14,1
7876,70817,D8q3p28oNnCDKOIbiGQbgveHVNlF4K29,fbPkOYLVPtPgIt0MxizjfFJov3JbHyAi,4,3,0,0,0,0,1,0,4,0.5714285714285714,1,0.0,0,0,0,0,3,0,0,1,0,0,4,1
7877,70820,ELhlMyuHt1scQfOhkxfCzXRENMteryFF,fbPkOYLVPtPgIt0MxizjfFJov3JbHyAi,6,1,1,0,1,0,3,0,6,0.8571428571428571,2,0.0,0,1,0,1,1,0,0,3,0,2,4,1
7878,70821,1DYVtevZL3aXGY7HGRbaRGOoCf6sTS9c,fbPkOYLVPtPgIt0MxizjfFJov3JbHyAi,6,3,1,0,1,0,2,0,7,1.0,1,0.0,0,1,0,1,3,0,0,2,0,2,5,1
7879,70822,k8AJw7WDdTwEOJNmtUY3WESJ7YjggqcB,fbPkOYLVPtPgIt0MxizjfFJov3JbHyAi,8,3,2,0,2,0,5,0,12,1.7142857142857142,1,0.0,0,2,0,2,3,0,0,5,0,4,8,1
7880,70823,EORvS3nZwxrQaK5VcaXN4Zq4BMWJUMRs,fbPkOYLVPtPgIt0MxizjfFJov3JbHyAi,5,2,1,0,1,0,2,0,6,0.8571428571428571,1,0.0,0,1,0,1,2,0,0,2,0,2,4,1
7881,70824,V68nYWLc75b2tl11Mh8jvaF8SbKiBV2d,fbPkOYLVPtPgIt0MxizjfFJov3JbHyAi,8,2,2,0,2,0,5,0,11,1.5714285714285714,1,0.0,0,2,0,2,2,0,0,5,0,4,7,1
7882,70825,oPTYZ3PJdSd8ml5amG32UA8HE12eiUok,fbPkOYLVPtPgIt0MxizjfFJov3JbHyAi,1,0,0,0,0,0,1,0,1,0.14285714285714285,1,0.0,0,0,0,0,0,0,0,1,0,0,1,1
7883,70826,j3jyWJflvqAFzJJxwhnXOjHUHBgIVWxk,fbPkOYLVPtPgIt0MxizjfFJov3JbHyAi,5,0,0,0,0,0,8,1,9,1.2857142857142858,1,0.0,0,0,0,0,0,0,0,8,1,0,9,1
7884,70828,fK4SC23SdBJjy6ZJHLxy5rG3k6OEQhRL,fbPkOYLVPtPgIt0MxizjfFJov3JbHyAi,2,0,0,0,0,0,2,0,2,0.2857142857142857,1,0.0,0,0,0,0,0,0,0,2,0,0,2,1
7885,70829,xUwzuL2GpG7tsntxE4jr1sQzSM0uvwiU,fbPkOYLVPtPgIt0MxizjfFJov3JbHyAi,1,0,0,0,0,0,2,0,2,0.2857142857142857,1,0.0,0,0,0,0,0,0,0,2,0,0,2,1
7886,70830,riMtgGmUwEsIgmPcMgfRpJw7h8RVspUI,fbPkOYLVPtPgIt0MxizjfFJov3JbHyAi,8,5,3,0,2,0,5,0,15,2.142857142857143,1,0.0,0,3,0,2,5,0,0,5,0,5,10,1
7887,70831,o5TpAjMe8TM6a528HMcKqr5zZTFMsmaP,fbPkOYLVPtPgIt0MxizjfFJov3JbHyAi,5,2,1,0,1,0,4,0,8,1.1428571428571428,2,0.0,0,1,0,1,2,0,0,4,0,2,6,1
7888,70832,YZxXVaDyfqjJPwTonj6xC3yeCKyyMcwI,fbPkOYLVPtPgIt0MxizjfFJov3JbHyAi,13,7,5,0,4,1,14,1,32,4.571428571428571,1,0.0,0,5,0,4,7,1,0,14,1,9,23,1
7889,70833,4kqdE82TaUj9Ob6PVxpRbM2PysfdMkCH,fbPkOYLVPtPgIt0MxizjfFJov3JbHyAi,2,0,0,0,0,0,2,0,2,0.2857142857142857,1,0.0,0,0,0,0,0,0,0,2,0,0,2,1
7890,70836,2WmhxllOxqyxpNvuB1Z1rT8LyIpEZOpF,fbPkOYLVPtPgIt0MxizjfFJov3JbHyAi,5,2,1,0,1,0,4,0,8,1.1428571428571428,1,0.0,0,1,0,1,2,0,0,4,0,2,6,1
7891,70837,afJgM79zX2Cd4ccBAriQnfjQcEwLizk6,fbPkOYLVPtPgIt0MxizjfFJov3JbHyAi,6,2,1,0,1,0,4,0,8,1.1428571428571428,1,0.0,0,1,0,1,2,0,0,4,0,2,6,1
7892,70839,Kc2ZLOGfjK9xNvMUO1HfN3eAcuOUNA78,fbPkOYLVPtPgIt0MxizjfFJov3JbHyAi,8,6,4,6,4,0,2,0,22,3.142857142857143,1,0.0,1,4,5,4,5,0,1,2,0,14,8,1
7893,70840,5fjtZf3Xc8lWt8s6egMqZtlShhUGjtFd,fbPkOYLVPtPgIt0MxizjfFJov3JbHyAi,1,0,0,0,0,0,2,0,2,0.2857142857142857,1,0.0,0,0,0,0,0,0,0,2,0,0,2,1
7894,70842,fZXWFljczIs2zKTKNU8XHxkkGuihaYBi,fbPkOYLVPtPgIt0MxizjfFJov3JbHyAi,9,2,2,0,2,0,9,0,15,2.142857142857143,1,0.0,0,2,0,2,2,0,0,9,0,4,11,1
7895,70845,32PywyFA7AkNsj9LytGcBkA7FP2gdk44,fbPkOYLVPtPgIt0MxizjfFJov3JbHyAi,11,6,4,0,4,0,2,0,16,2.2857142857142856,1,0.0,1,4,0,4,5,0,0,2,0,9,7,1
7896,70846,9MUoTs0to78yIRrWTuXVx5TqwwKqlOPH,fbPkOYLVPtPgIt0MxizjfFJov3JbHyAi,5,3,0,0,0,0,6,0,9,1.2857142857142858,1,0.0,0,0,0,0,3,0,0,6,0,0,9,1
7897,70847,RAvsZ60Di0pQF1FWzazLKNgo4gQa7NT4,fbPkOYLVPtPgIt0MxizjfFJov3JbHyAi,5,2,1,0,1,0,2,0,6,0.8571428571428571,1,0.0,0,1,0,1,2,0,0,2,0,2,4,1
7898,70850,ynbc4a4L1nKWaQxbZwKtj7FjbYhjhhuF,fbPkOYLVPtPgIt0MxizjfFJov3JbHyAi,9,9,4,0,4,6,8,1,32,4.571428571428571,1,0.0,2,4,0,4,7,6,0,8,1,10,22,1
7899,70854,tg8ij1J8ppYeqUKBQEMOpFULhUiviSC2,fbPkOYLVPtPgIt0MxizjfFJov3JbHyAi,9,6,3,0,2,0,3,0,14,2.0,1,0.0,0,3,0,2,6,0,0,3,0,5,9,1
7900,70855,qpLrdk2TB7GVW6GaJkCWKNJYyd2ZkyLM,fbPkOYLVPtPgIt0MxizjfFJov3JbHyAi,1,0,0,0,0,0,1,0,1,0.14285714285714285,1,0.0,0,0,0,0,0,0,0,1,0,0,1,1
7901,70858,4oK5zfJFZ9TDAoTvsTlgrbulTcK542q2,fbPkOYLVPtPgIt0MxizjfFJov3JbHyAi,1,0,0,0,0,0,1,0,1,0.14285714285714285,1,0.0,0,0,0,0,0,0,0,1,0,0,1,1
7902,70859,VkEXjyLrlFj2CVFPhpeVw6CAqjFXGva0,fbPkOYLVPtPgIt0MxizjfFJov3JbHyAi,2,0,0,0,0,0,2,0,2,0.2857142857142857,1,0.0,0,0,0,0,0,0,0,2,0,0,2,1
7903,70861,6IJVUSEMpeG6F6UAW6d6aBbrEWsQ8azq,fbPkOYLVPtPgIt0MxizjfFJov3JbHyAi,13,15,9,0,7,0,5,0,36,5.142857142857143,2,0.0,0,9,0,7,15,0,0,5,0,16,20,1
7904,70862,I1a9vqQH46q1bfrkbp3ETeJrS6dPcAC4,fbPkOYLVPtPgIt0MxizjfFJov3JbHyAi,4,2,1,0,1,0,1,0,5,0.7142857142857143,1,0.0,0,1,0,1,2,0,0,1,0,2,3,1
7905,70864,YJYft8Pp3kKpsnAX9YvA8ajUcBQBHE3D,fbPkOYLVPtPgIt0MxizjfFJov3JbHyAi,2,0,0,0,0,0,4,0,4,0.5714285714285714,1,0.0,0,0,0,0,0,0,0,4,0,0,4,1
7906,70866,I6VmaLF2DMFBmVoL127xEyjprXeqzx0a,fbPkOYLVPtPgIt0MxizjfFJov3JbHyAi,1,0,0,0,0,0,1,0,1,0.14285714285714285,1,0.0,0,0,0,0,0,0,0,1,0,0,1,1
7907,70867,Y1l5HeKL2xGQ4Lkb5zNCgu2DeFrAlTw8,fbPkOYLVPtPgIt0MxizjfFJov3JbHyAi,1,0,0,0,0,0,1,0,1,0.14285714285714285,1,0.0,0,0,0,0,0,0,0,1,0,0,1,1
7908,70869,LowxZv7QGeTRZfT1csfuXH5r1UZa4mVS,fbPkOYLVPtPgIt0MxizjfFJov3JbHyAi,2,0,0,0,0,0,2,0,2,0.2857142857142857,1,0.0,0,0,0,0,0,0,0,2,0,0,2,1
7909,70870,NaTkGN0OVzlcYhXnPctl6N7eYxY7z7gT,fbPkOYLVPtPgIt0MxizjfFJov3JbHyAi,10,10,7,0,5,0,7,0,29,4.142857142857143,2,0.0,2,7,0,5,8,0,0,7,0,14,15,1
7910,70872,tqL96lBifCNy09m1ns0UwqJwea5MwY8p,fbPkOYLVPtPgIt0MxizjfFJov3JbHyAi,5,2,1,0,1,0,2,0,6,0.8571428571428571,1,0.0,0,1,0,1,2,0,0,2,0,2,4,1
7911,70875,nFDMbovZeON7sHMHTJjtcsqufxGoPyJM,fbPkOYLVPtPgIt0MxizjfFJov3JbHyAi,7,3,2,0,2,13,3,0,23,3.2857142857142856,1,0.0,0,2,0,2,3,13,0,3,0,4,19,1
7912,70876,MJ4Uban6VG5v2fJm4mTva4c0ih2DGhnb,fbPkOYLVPtPgIt0MxizjfFJov3JbHyAi,1,0,0,0,0,0,1,0,1,0.14285714285714285,1,0.0,0,0,0,0,0,0,0,1,0,0,1,1
7913,70877,54WhnApSVDtiavajsWLmVxiyF7WDQOJu,fbPkOYLVPtPgIt0MxizjfFJov3JbHyAi,6,2,1,0,1,0,3,1,8,1.1428571428571428,1,0.0,0,1,0,1,2,0,0,3,1,2,6,1
7914,70884,d5N36ltJLuexchMmFNrBfpp3LZsF74JT,fbPkOYLVPtPgIt0MxizjfFJov3JbHyAi,6,4,2,0,3,0,4,1,14,2.0,1,0.0,1,2,0,3,3,0,0,4,1,6,8,0
7915,70885,Qn4oQ1lJoD4ucx7ZxtRp3oFmTZaTCpvg,fbPkOYLVPtPgIt0MxizjfFJov3JbHyAi,6,11,1,0,1,0,2,0,15,2.142857142857143,1,0.0,0,1,0,1,11,0,0,2,0,2,13,1
7916,70888,Xa0yw5PV4YIPq4eEJJzljtBOuhOF0jib,fbPkOYLVPtPgIt0MxizjfFJov3JbHyAi,1,0,0,0,0,0,1,0,1,0.14285714285714285,1,0.0,0,0,0,0,0,0,0,1,0,0,1,1
7917,70889,k1wwEuRLRVBVQA9v2crFDSBLM3kZLoUU,fbPkOYLVPtPgIt0MxizjfFJov3JbHyAi,1,0,0,0,0,0,1,0,1,0.14285714285714285,1,0.0,0,0,0,0,0,0,0,1,0,0,1,1
7918,70891,Q1IUtiIo2SS94zzJgNzczdxtoIMSWoLW,fbPkOYLVPtPgIt0MxizjfFJov3JbHyAi,1,0,0,0,0,0,1,0,1,0.14285714285714285,1,0.0,0,0,0,0,0,0,0,1,0,0,1,1
7919,70894,oKN2xGH7PD9pLBHMPHUcfj3zTJV8tvd5,fbPkOYLVPtPgIt0MxizjfFJov3JbHyAi,5,2,1,0,1,0,2,0,6,0.8571428571428571,1,0.0,0,1,0,1,2,0,0,2,0,2,4,1
7920,70896,U6LzAVwYbxAVbRMMxjnV16LKATxmA2bk,fbPkOYLVPtPgIt0MxizjfFJov3JbHyAi,7,2,1,0,1,0,4,1,9,1.2857142857142858,1,0.0,0,1,0,1,2,0,0,4,1,2,7,1
7921,70897,83JPfkin3GX4GLKqML2uaHSZ5KvsuJhM,fbPkOYLVPtPgIt0MxizjfFJov3JbHyAi,7,7,4,0,3,0,4,0,18,2.5714285714285716,2,0.0,0,4,0,3,7,0,0,4,0,7,11,1
7922,70898,u8Y97sSr2xWs294k9cdsB9u79pU8RMWs,fbPkOYLVPtPgIt0MxizjfFJov3JbHyAi,7,3,2,0,2,0,2,0,9,1.2857142857142858,1,0.0,0,2,0,2,3,0,0,2,0,4,5,0
7923,70899,tfQATW81rZGgOpzlf2lkFqeziBeMELEX,fbPkOYLVPtPgIt0MxizjfFJov3JbHyAi,2,0,0,0,0,0,3,0,3,0.42857142857142855,1,0.0,0,0,0,0,0,0,0,3,0,0,3,1
7924,70905,OrhyJL1JbaOfmgNByKgbYgqzq4Sm4HlT,G8EPVSXsOYB5YQWZGiz1aVq5Pgr2GrQu,39,37,14,76,8,0,6,0,141,20.142857142857142,2,0.0,17,14,53,8,20,0,23,6,0,92,49,1
7925,70908,B6p5x6qI5IapFaeXO9jhM5m7rqDF4l8p,SpATywNh6bZuzm8s1ceuBUnMUAeoAHHw,23,31,15,19,8,0,7,0,80,11.428571428571429,4,0.0,3,15,15,8,28,0,4,7,0,41,39,0
7926,70917,Iv5H8eRk1KgfQB11AxWDsPacAIgml2Fq,SpATywNh6bZuzm8s1ceuBUnMUAeoAHHw,15,20,10,10,4,0,4,0,48,6.857142857142857,2,0.0,5,10,9,4,15,0,1,4,0,28,20,1
7927,70941,hplRuUXyLFhHcMqMJcb12YjqquTYp3Qw,bWdj2GDclj5ofokWjzoa5jAwMkxCykd6,11,13,7,0,4,1,9,1,35,5.0,4,0.0,0,7,0,4,13,1,0,9,1,11,24,1
7928,70964,AtOHbVb7kxzZIoD2M5RWKjBCYCoDUPL6,SpATywNh6bZuzm8s1ceuBUnMUAeoAHHw,28,53,17,42,2,0,11,0,125,17.857142857142858,6,0.0,29,17,34,2,24,0,8,11,0,82,43,0
7929,70965,1NDrkg6Fm6LSwpX18XkWoeP8L4g5eTy0,5X6FeZozNMgE2VRi3MJYjkkFK8SETtu2,23,47,22,39,27,0,4,0,139,19.857142857142858,2,0.0,19,22,31,27,28,0,8,4,0,99,40,1
7930,70969,Ooaq1toVrKJC9KROMnT52Id1rqx2sDam,A3fsA9Zfv1X2fVEQhTw51lKENdNrEqT3,66,53,29,172,11,62,29,1,357,51.0,12,0.0,2,29,137,11,51,62,35,29,1,179,178,0
7931,70994,EMrObXWheuWLSYoJOoJqZbkDhx4X9COM,SpATywNh6bZuzm8s1ceuBUnMUAeoAHHw,20,29,1,16,0,5,7,1,59,8.428571428571429,2,0.0,3,1,15,0,26,5,1,7,1,19,40,1
7932,70998,VuxUQKMDYsA4LWFsDh3lY6mcAw5xbtkR,SpATywNh6bZuzm8s1ceuBUnMUAeoAHHw,7,15,3,0,1,2,4,0,25,3.5714285714285716,2,0.0,5,3,0,1,10,2,0,4,0,9,16,0
7933,71000,SuOS5e9JRupQcpgzaLejcvmk4nnyhsIA,A3fsA9Zfv1X2fVEQhTw51lKENdNrEqT3,6,4,3,0,3,0,1,0,11,1.5714285714285714,1,0.0,0,3,0,3,4,0,0,1,0,6,5,1
7934,71001,Qty87BeKrf3ZgzVA2PT9rBe28vADAPbJ,A3fsA9Zfv1X2fVEQhTw51lKENdNrEqT3,10,9,6,0,4,0,3,0,22,3.142857142857143,3,0.0,0,6,0,4,9,0,0,3,0,10,12,0
7935,71004,Sk4DUKJRImF6lijTnkABuH01jDj9zcnP,5X6FeZozNMgE2VRi3MJYjkkFK8SETtu2,1,0,0,0,0,0,1,0,1,0.14285714285714285,1,0.0,0,0,0,0,0,0,0,1,0,0,1,1
7936,71025,Sk4DUKJRImF6lijTnkABuH01jDj9zcnP,RXDvfPUBYFlVdlueBFbLW0mhhAyGEqpt,1,0,0,0,0,0,1,0,1,0.14285714285714285,1,0.0,0,0,0,0,0,0,0,1,0,0,1,1
7937,71027,oDMwcP97XCFhatRKDALyEk29j0A66Zee,A3fsA9Zfv1X2fVEQhTw51lKENdNrEqT3,11,4,3,0,3,1,18,1,30,4.285714285714286,4,0.0,1,3,0,3,3,1,0,18,1,7,23,1
7938,71036,SbxWcDAQO1PnIdll82O1Qa8HqEHuIfT7,SpATywNh6bZuzm8s1ceuBUnMUAeoAHHw,4,2,0,0,0,0,3,0,5,0.7142857142857143,1,0.0,0,0,0,0,2,0,0,3,0,0,5,1
7939,71042,Rz8bL6jCH0Pf0jvKzb91yxe7VkOLAlQk,SpATywNh6bZuzm8s1ceuBUnMUAeoAHHw,7,8,0,0,0,0,10,2,20,2.857142857142857,1,0.0,0,0,0,0,8,0,0,10,2,0,20,1
7940,71078,dfEK3xvueeR9teWVma5VAaO4dthOOslM,bWdj2GDclj5ofokWjzoa5jAwMkxCykd6,50,54,18,113,17,0,34,2,238,34.0,5,0.0,17,18,101,17,37,0,12,34,2,153,85,1
7941,71085,niCfrernMgxaiAe4XJm2E9uKlmDuNpx3,SpATywNh6bZuzm8s1ceuBUnMUAeoAHHw,1,0,0,0,0,0,1,0,1,0.14285714285714285,1,0.0,0,0,0,0,0,0,0,1,0,0,1,1
7942,71094,8IMVGvB09WRKHeXEjWGkZOVu6CXmlVXA,RXDvfPUBYFlVdlueBFbLW0mhhAyGEqpt,6,4,1,0,1,0,1,0,7,1.0,1,0.0,0,1,0,1,4,0,0,1,0,2,5,1
7943,71101,kv6R7WjolUetaoWMs79hGLWsktu3yDdz,SpATywNh6bZuzm8s1ceuBUnMUAeoAHHw,5,4,1,0,0,0,2,0,7,1.0,2,0.0,0,1,0,0,4,0,0,2,0,1,6,1
7944,71114,Pb8bKUVAg7ulAlD1hKSRovFicuM9wDrS,5X6FeZozNMgE2VRi3MJYjkkFK8SETtu2,9,4,3,0,3,0,4,1,15,2.142857142857143,1,0.0,0,3,0,3,4,0,0,4,1,6,9,1
7945,71121,WonWbBpwgN3XpAwPD3B5sUYZEtzBanfo,A3fsA9Zfv1X2fVEQhTw51lKENdNrEqT3,2,0,0,0,0,0,3,0,3,0.42857142857142855,1,0.0,0,0,0,0,0,0,0,3,0,0,3,1
7946,71122,WonWbBpwgN3XpAwPD3B5sUYZEtzBanfo,bWdj2GDclj5ofokWjzoa5jAwMkxCykd6,1,0,0,0,0,0,1,0,1,0.14285714285714285,1,0.0,0,0,0,0,0,0,0,1,0,0,1,1
7947,71124,5niJhzBqY5BWt03iPKjNSLwlp6bq9sIM,SpATywNh6bZuzm8s1ceuBUnMUAeoAHHw,7,3,1,0,2,0,2,0,8,1.1428571428571428,1,0.0,0,1,0,2,3,0,0,2,0,3,5,1
7948,71144,Ze9kgklMuT1yRhjZzYqZ128xNCVJ9Ing,G8EPVSXsOYB5YQWZGiz1aVq5Pgr2GrQu,6,4,1,0,1,0,2,0,8,1.1428571428571428,1,0.0,0,1,0,1,4,0,0,2,0,2,6,1
7949,71148,nzvOBXg9mmjIbNHZZO9eP5MzuZiA7QBu,SpATywNh6bZuzm8s1ceuBUnMUAeoAHHw,8,8,6,0,3,0,3,0,20,2.857142857142857,2,0.0,0,6,0,3,8,0,0,3,0,9,11,1
7950,71159,yG8wEEmCuC5YTy4CQDGA5I639Z9JzSu0,5X6FeZozNMgE2VRi3MJYjkkFK8SETtu2,5,3,1,0,1,0,2,0,7,1.0,2,0.0,0,1,0,1,3,0,0,2,0,2,5,1
7951,71161,FixP7IuJ80KsWtzMzcQsJZKOjLxDKZgC,bWdj2GDclj5ofokWjzoa5jAwMkxCykd6,1,0,0,0,0,0,1,0,1,0.14285714285714285,1,0.0,0,0,0,0,0,0,0,1,0,0,1,1
7952,71164,GqY8cM6bEQ2o2zTrfF7msueNZ1f4HNE4,A3fsA9Zfv1X2fVEQhTw51lKENdNrEqT3,13,11,2,0,2,0,4,0,19,2.7142857142857144,2,0.0,0,2,0,2,11,0,0,4,0,4,15,1
7953,71171,PpZEAa1Mdati01h1lf363alLOjmVtvBB,5X6FeZozNMgE2VRi3MJYjkkFK8SETtu2,5,2,1,0,1,0,2,0,6,0.8571428571428571,1,0.0,0,1,0,1,2,0,0,2,0,2,4,1
7954,71174,axaScF3P7Dmq9RVjqcR7oOXvuGJjIWKx,SpATywNh6bZuzm8s1ceuBUnMUAeoAHHw,34,67,20,29,11,9,23,2,161,23.0,8,0.0,5,20,24,11,62,9,5,23,2,60,101,0
7955,71177,moqDrkL7HaqSVPAIPOv1C3iTYb2EoCoF,A3fsA9Zfv1X2fVEQhTw51lKENdNrEqT3,36,25,1,82,0,12,6,0,126,18.0,1,0.0,3,1,67,0,22,12,15,6,0,71,55,1
7956,71183,v6Wfy2XnikKgnCNfehO3TIQzyPp7MzcN,RXDvfPUBYFlVdlueBFbLW0mhhAyGEqpt,2,0,0,0,0,0,3,0,3,0.42857142857142855,2,0.0,0,0,0,0,0,0,0,3,0,0,3,1
7957,71191,a5Mkdg3fnTGCu7x8lN0CyRFil7seaApN,SpATywNh6bZuzm8s1ceuBUnMUAeoAHHw,10,22,10,0,1,3,24,0,60,8.571428571428571,2,0.0,0,10,0,1,22,3,0,24,0,11,49,1
7958,71194,AeStUweNOwwDKml97drefO9KmmqkdvwG,bWdj2GDclj5ofokWjzoa5jAwMkxCykd6,2,0,0,0,0,0,2,0,2,0.2857142857142857,1,0.0,0,0,0,0,0,0,0,2,0,0,2,1
7959,71195,4k7x6DcNdq1PRhbqFmfcKoI6JpPSJsyb,G8EPVSXsOYB5YQWZGiz1aVq5Pgr2GrQu,17,43,1,0,1,0,6,0,51,7.285714285714286,2,0.0,0,1,0,1,43,0,0,6,0,2,49,1
7960,71212,VaOhD86uWnK2TjloSi50DgiXbw9C3K0T,A3fsA9Zfv1X2fVEQhTw51lKENdNrEqT3,12,38,10,0,7,0,8,0,63,9.0,3,0.0,0,10,0,7,38,0,0,8,0,17,46,1
7961,71222,mRThjjGON0zU0Y2plEdpqVN16fEiXwSr,bWdj2GDclj5ofokWjzoa5jAwMkxCykd6,11,13,8,0,5,0,8,0,34,4.857142857142857,2,0.0,0,8,0,5,13,0,0,8,0,13,21,1
7962,71253,TPJCnKhFzWhbo2FKOiMksWmjMVFIKGgD,SpATywNh6bZuzm8s1ceuBUnMUAeoAHHw,5,3,1,0,1,0,2,0,7,1.0,1,0.0,1,1,0,1,2,0,0,2,0,3,4,1
7963,71272,CeGIsWlT0KBVS1hQGCUY2KCY4J9xzr3t,SpATywNh6bZuzm8s1ceuBUnMUAeoAHHw,39,43,16,46,8,54,19,0,186,26.571428571428573,6,0.0,6,16,40,8,37,54,6,19,0,70,116,1
7964,71289,VObPdzDYiBKi8TLPXY1g1HS4rT0eO4IR,RXDvfPUBYFlVdlueBFbLW0mhhAyGEqpt,20,22,10,30,8,0,7,0,77,11.0,1,0.0,7,10,27,8,15,0,3,7,0,52,25,1
7965,71291,TdqsraGiWnME5OctPE2I7wQ3BMLqTuwl,SpATywNh6bZuzm8s1ceuBUnMUAeoAHHw,5,9,1,0,1,0,3,0,14,2.0,2,0.0,2,1,0,1,7,0,0,3,0,4,10,1
7966,71305,lBX5Yzu1Dk0lwimtM6RHOAgAth8sqjDN,G8EPVSXsOYB5YQWZGiz1aVq5Pgr2GrQu,22,24,6,26,2,0,1,0,59,8.428571428571429,1,0.0,12,6,14,2,12,0,12,1,0,34,25,1
7967,71355,HwPaWKFgttQqp1SWzLrqkMuI2ELbGJaG,G8EPVSXsOYB5YQWZGiz1aVq5Pgr2GrQu,1,0,0,0,0,0,1,0,1,0.14285714285714285,1,0.0,0,0,0,0,0,0,0,1,0,0,1,1
7968,71362,f6IvpzZQ4NKKZIUTkgWEi3BVq577qLnM,SpATywNh6bZuzm8s1ceuBUnMUAeoAHHw,22,26,6,27,3,18,15,0,95,13.571428571428571,4,0.0,11,6,25,3,15,18,2,15,0,45,50,0
7969,71375,fol611Bi6YnD4zjFVUOPJixEwpbUH6yt,SpATywNh6bZuzm8s1ceuBUnMUAeoAHHw,2,0,0,0,0,0,3,0,3,0.42857142857142855,2,0.0,0,0,0,0,0,0,0,3,0,0,3,0
7970,71380,4Q0hw7idVzdmILVQjJdMPqXbEU97hajF,A3fsA9Zfv1X2fVEQhTw51lKENdNrEqT3,1,0,0,0,0,0,2,0,2,0.2857142857142857,1,0.0,0,0,0,0,0,0,0,2,0,0,2,1
7971,71393,bzlTCtIUcO5BfACSIQwT3PRYSdK0QGTr,SpATywNh6bZuzm8s1ceuBUnMUAeoAHHw,21,25,15,10,8,0,7,0,65,9.285714285714286,3,0.0,6,15,8,8,19,0,2,7,0,37,28,1
7972,71441,VG72z05p4N4OFvxvgLIqa7VdIfM3Q8YO,A3fsA9Zfv1X2fVEQhTw51lKENdNrEqT3,1,0,0,0,0,0,1,0,1,0.14285714285714285,1,0.0,0,0,0,0,0,0,0,1,0,0,1,1
7973,71454,gxNweITMLFQ6uKW8j94tIvo0aCJTBt29,SpATywNh6bZuzm8s1ceuBUnMUAeoAHHw,2,0,0,0,0,0,2,0,2,0.2857142857142857,1,0.0,0,0,0,0,0,0,0,2,0,0,2,1
7974,71478,au4q0hHoeIchXXu4o0X9kRH2tLR2LkOi,SpATywNh6bZuzm8s1ceuBUnMUAeoAHHw,7,2,1,0,1,1,7,1,13,1.8571428571428572,2,0.0,0,1,0,1,2,1,0,7,1,2,11,1
7975,71492,AgmWWSmPg3HCFtB0FkZujRvKdZYey1as,SpATywNh6bZuzm8s1ceuBUnMUAeoAHHw,6,7,5,0,2,0,3,0,17,2.4285714285714284,2,0.0,0,5,0,2,7,0,0,3,0,7,10,1
7976,71503,2YohZ5UKGzy1qUgVAShosLdhgm3pfvsR,A3fsA9Zfv1X2fVEQhTw51lKENdNrEqT3,5,2,1,0,1,0,2,0,6,0.8571428571428571,1,0.0,0,1,0,1,2,0,0,2,0,2,4,1
7977,71505,vP0leqUpaGisQu73FfHJ6k2A2vAG6aiB,bWdj2GDclj5ofokWjzoa5jAwMkxCykd6,5,2,1,0,1,0,2,0,6,0.8571428571428571,1,0.0,0,1,0,1,2,0,0,2,0,2,4,1
7978,71521,SmONSyS4YgG4Afnv6ZxU81t7p4CQPV5P,G8EPVSXsOYB5YQWZGiz1aVq5Pgr2GrQu,1,0,0,0,0,0,1,0,1,0.14285714285714285,1,0.0,0,0,0,0,0,0,0,1,0,0,1,1
7979,71523,SmONSyS4YgG4Afnv6ZxU81t7p4CQPV5P,RXDvfPUBYFlVdlueBFbLW0mhhAyGEqpt,2,0,0,0,0,0,2,0,2,0.2857142857142857,1,0.0,0,0,0,0,0,0,0,2,0,0,2,0
7980,71526,PrwfjW9YGtDxqVBHDm7KtO2cr4GlU48n,SpATywNh6bZuzm8s1ceuBUnMUAeoAHHw,24,25,12,27,5,6,7,1,83,11.857142857142858,1,0.0,7,12,26,5,18,6,1,7,1,50,33,0
7981,71534,6kmRTTlm2tGjO1GkeO8yvcp6lmCvKO0m,A3fsA9Zfv1X2fVEQhTw51lKENdNrEqT3,9,6,3,0,2,1,9,0,21,3.0,4,0.0,0,3,0,2,6,1,0,9,0,5,16,1
7982,71546,f1e5g73OiAut7IKbJN1QM0zdAV9QZu4j,G8EPVSXsOYB5YQWZGiz1aVq5Pgr2GrQu,19,23,8,0,6,2,8,0,47,6.714285714285714,1,0.0,4,8,0,6,19,2,0,8,0,18,29,0
7983,71552,wEaTyOJwwvOCk7eUttQISK5WPXL7ANNV,G8EPVSXsOYB5YQWZGiz1aVq5Pgr2GrQu,1,0,0,0,0,0,1,0,1,0.14285714285714285,1,0.0,0,0,0,0,0,0,0,1,0,0,1,1
7984,71567,9gXVEZEqUIEtX73kugMCi6mJh0HupPfO,5X6FeZozNMgE2VRi3MJYjkkFK8SETtu2,2,0,0,0,0,0,2,0,2,0.2857142857142857,1,0.0,0,0,0,0,0,0,0,2,0,0,2,1
7985,71612,L56U1ayQBSvA3ytGNrFwHPNpiuCpgXCq,A3fsA9Zfv1X2fVEQhTw51lKENdNrEqT3,36,15,9,50,8,0,4,0,86,12.285714285714286,1,0.0,4,9,46,8,11,0,4,4,0,67,19,1
7986,71616,Lt7VPheILDSvy2io7NudVCZ6gMhwTn9j,SpATywNh6bZuzm8s1ceuBUnMUAeoAHHw,1,0,0,0,0,0,1,0,1,0.14285714285714285,1,0.0,0,0,0,0,0,0,0,1,0,0,1,1
7987,71625,ddRUcnq8CFHBGHWZEDIhMAjA3ypo6C57,RXDvfPUBYFlVdlueBFbLW0mhhAyGEqpt,7,4,1,0,1,0,2,0,8,1.1428571428571428,1,0.0,0,1,0,1,4,0,0,2,0,2,6,1
7988,71642,YZqjHyJb9T1aeLqKSF3CKbXzYGNTpFDA,SpATywNh6bZuzm8s1ceuBUnMUAeoAHHw,5,3,0,0,0,0,2,0,5,0.7142857142857143,2,0.0,0,0,0,0,3,0,0,2,0,0,5,1
7989,71654,qTtdX55CV2fJxnEb7mhnsvXbisJZJyaM,bWdj2GDclj5ofokWjzoa5jAwMkxCykd6,2,0,0,0,0,0,2,0,2,0.2857142857142857,1,0.0,0,0,0,0,0,0,0,2,0,0,2,1
7990,71669,k3kcaBPxWWgmPtwRAgC17pKIVVmpYDWX,5X6FeZozNMgE2VRi3MJYjkkFK8SETtu2,1,0,0,0,0,0,1,0,1,0.14285714285714285,1,0.0,0,0,0,0,0,0,0,1,0,0,1,1
7991,71671,ElsXlbvFFCxkAZK5wxKh1k6NT3PqrFej,bWdj2GDclj5ofokWjzoa5jAwMkxCykd6,1,0,0,0,0,0,1,0,1,0.14285714285714285,1,0.0,0,0,0,0,0,0,0,1,0,0,1,1
7992,71679,udXq1W3W39FL5ELVdayz2yBuWe1SMQSB,SpATywNh6bZuzm8s1ceuBUnMUAeoAHHw,3,0,0,0,0,0,3,0,3,0.42857142857142855,1,0.0,0,0,0,0,0,0,0,3,0,0,3,1
7993,71687,G0R41qglSXZRKpF9p8Vfr2YtoPUNtseQ,A3fsA9Zfv1X2fVEQhTw51lKENdNrEqT3,1,0,0,0,0,0,1,0,1,0.14285714285714285,1,0.0,0,0,0,0,0,0,0,1,0,0,1,1
7994,71700,qGPfY7GDQqrO1DPuPdsJnIrEGeJp1MpX,SpATywNh6bZuzm8s1ceuBUnMUAeoAHHw,20,56,6,18,4,14,14,0,112,16.0,4,0.0,8,6,15,4,48,14,3,14,0,33,79,1
7995,71702,JUwnpYDokyUXTC7SfWpuPqShDK4ZEqmX,A3fsA9Zfv1X2fVEQhTw51lKENdNrEqT3,11,5,4,0,4,1,7,1,22,3.142857142857143,3,0.0,0,4,0,4,5,1,0,7,1,8,14,1
7996,71712,TztthVt5KMop1hWx6wFArC8xg8H9VhnG,SpATywNh6bZuzm8s1ceuBUnMUAeoAHHw,22,21,14,4,7,5,12,0,63,9.0,7,0.0,1,14,3,7,20,5,1,12,0,25,38,1
7997,71718,pcpAhLjoTN8lH8rrB4WzhaKSF9JUuI0T,G8EPVSXsOYB5YQWZGiz1aVq5Pgr2GrQu,7,5,4,0,3,0,3,0,15,2.142857142857143,1,0.0,0,4,0,3,5,0,0,3,0,7,8,1
7998,71737,5VlUeVUXRN1CcPaOOWsH3KOAj8dOWksi,G8EPVSXsOYB5YQWZGiz1aVq5Pgr2GrQu,27,25,13,24,8,0,4,0,74,10.571428571428571,2,0.0,6,13,18,8,19,0,6,4,0,45,29,1
7999,71765,RNIlCFbK1TpIi5Jv91aZZHNNmFBjGDjQ,SpATywNh6bZuzm8s1ceuBUnMUAeoAHHw,1,0,0,0,0,0,1,0,1,0.14285714285714285,1,0.0,0,0,0,0,0,0,0,1,0,0,1,1
8000,71768,gGSMkNgPdXpBQgdZzyjzifomyCxFSNyt,5X6FeZozNMgE2VRi3MJYjkkFK8SETtu2,6,3,1,0,1,0,2,0,7,1.0,1,0.0,0,1,0,1,3,0,0,2,0,2,5,0
8001,71782,bvymgtoEENeCZc8oxchZvznMloDqHCnU,bWdj2GDclj5ofokWjzoa5jAwMkxCykd6,5,5,3,0,0,0,4,0,12,1.7142857142857142,2,0.0,0,3,0,0,5,0,0,4,0,3,9,1
8002,71802,YkfUrC2IjNSUcSjXepY6IHt6QpgdD85G,SpATywNh6bZuzm8s1ceuBUnMUAeoAHHw,31,50,27,18,15,10,11,0,131,18.714285714285715,4,0.0,16,27,18,15,34,10,0,11,0,76,55,1
8003,71822,Z1BvcrHFnz5lnLSAy2ZEcjcmCxIRFxqE,bWdj2GDclj5ofokWjzoa5jAwMkxCykd6,1,0,0,0,0,0,1,0,1,0.14285714285714285,1,0.0,0,0,0,0,0,0,0,1,0,0,1,1
8004,71823,Z1BvcrHFnz5lnLSAy2ZEcjcmCxIRFxqE,A3fsA9Zfv1X2fVEQhTw51lKENdNrEqT3,1,0,0,0,0,0,1,0,1,0.14285714285714285,1,0.0,0,0,0,0,0,0,0,1,0,0,1,1
8005,71842,ErXNe7efkRl64E8pJRc91VCcYddra1a4,SpATywNh6bZuzm8s1ceuBUnMUAeoAHHw,29,58,17,39,3,25,23,2,167,23.857142857142858,8,0.0,20,17,33,3,38,25,6,23,2,73,94,0
8006,71844,yjE4tqKQR2WC3DLToz6n1TUHIiH6cjX1,SpATywNh6bZuzm8s1ceuBUnMUAeoAHHw,13,21,12,0,7,0,9,0,49,7.0,6,0.0,0,12,0,7,21,0,0,9,0,19,30,0
8007,71845,Bl9yotIOWBgbQXjSe795sBrgMyA0TCNf,RXDvfPUBYFlVdlueBFbLW0mhhAyGEqpt,53,37,1,110,1,0,4,0,153,21.857142857142858,2,0.0,12,1,102,1,25,0,8,4,0,116,37,1
8008,71854,It5GZoF42fMzBpqBoHOwTBOzCr0aB6Mf,SpATywNh6bZuzm8s1ceuBUnMUAeoAHHw,46,45,20,21,11,4,10,1,112,16.0,2,0.0,8,20,19,11,37,4,2,10,1,58,54,0
8009,71855,PzUJiLnP9HZJxQE6JmMTkx1KTzCMtAvI,SpATywNh6bZuzm8s1ceuBUnMUAeoAHHw,6,5,3,0,2,0,3,0,13,1.8571428571428572,1,0.0,0,3,0,2,5,0,0,3,0,5,8,1
8010,71873,nBOtam7XKIa3PxdTZIAJPzc36wtmbKH4,A3fsA9Zfv1X2fVEQhTw51lKENdNrEqT3,59,27,18,144,9,2,15,0,215,30.714285714285715,3,0.0,5,18,141,9,22,2,3,15,0,173,42,1
8011,71885,STpGdIPaHCaW4TikUdsIz5l3OEI1w4EH,SpATywNh6bZuzm8s1ceuBUnMUAeoAHHw,5,2,1,0,1,0,2,0,6,0.8571428571428571,1,0.0,0,1,0,1,2,0,0,2,0,2,4,1
8012,71888,sr89KLsFZj5opXIwIPCyClXHTk70EGW9,SpATywNh6bZuzm8s1ceuBUnMUAeoAHHw,10,13,9,0,5,0,3,0,30,4.285714285714286,2,0.0,2,9,0,5,11,0,0,3,0,16,14,1
8013,71930,fvtcu8mnRKcOOxIrvdMmUWRWOCvOPCJY,A3fsA9Zfv1X2fVEQhTw51lKENdNrEqT3,4,2,1,0,0,0,2,0,5,0.7142857142857143,1,0.0,0,1,0,0,2,0,0,2,0,1,4,1
8014,71935,Cg7iNBAj8Tw36V9R4YA417eEEGy00kAz,SpATywNh6bZuzm8s1ceuBUnMUAeoAHHw,22,29,12,43,1,1,11,0,97,13.857142857142858,6,0.0,9,12,39,1,20,1,4,11,0,61,36,0
8015,71946,ap47j49GydESvLtt85D5zvr7ZznC8gTV,bWdj2GDclj5ofokWjzoa5jAwMkxCykd6,10,11,2,0,2,1,8,2,26,3.7142857142857144,1,0.0,0,2,0,2,11,1,0,8,2,4,22,1
8016,71947,HSj7vOMOwXAAtHMXn91NInlCIdQuHAYQ,5X6FeZozNMgE2VRi3MJYjkkFK8SETtu2,7,7,2,0,3,0,2,0,14,2.0,2,0.0,1,2,0,3,6,0,0,2,0,6,8,1
8017,71949,ap47j49GydESvLtt85D5zvr7ZznC8gTV,RXDvfPUBYFlVdlueBFbLW0mhhAyGEqpt,38,52,24,53,18,15,34,4,200,28.571428571428573,2,0.0,3,24,46,18,49,15,7,34,4,91,109,0
8018,71966,Zs0g0mKdq0TdImqBhrX0faEWu7slOeJl,G8EPVSXsOYB5YQWZGiz1aVq5Pgr2GrQu,7,3,2,0,2,0,2,0,9,1.2857142857142858,1,0.0,0,2,0,2,3,0,0,2,0,4,5,1
8019,71970,51xlIGXGRsE7YMneHTw1mXYuaEFgELF3,A3fsA9Zfv1X2fVEQhTw51lKENdNrEqT3,41,32,27,0,19,0,5,0,83,11.857142857142858,3,0.0,0,27,0,19,32,0,0,5,0,46,37,0
8020,71985,1LkX4t7QGG0LPbqqJvnwJmrweFNAYkvm,bWdj2GDclj5ofokWjzoa5jAwMkxCykd6,15,17,4,0,5,0,5,0,31,4.428571428571429,3,0.0,3,4,0,5,14,0,0,5,0,12,19,1
8021,71991,imshqH7JQ2KBPUk9GL3zPD8OWwRSwtuq,SpATywNh6bZuzm8s1ceuBUnMUAeoAHHw,7,5,3,0,2,35,7,1,53,7.571428571428571,2,0.0,0,3,0,2,5,35,0,7,1,5,48,1
8022,71997,1twNQDvdxBOgcj0lq6GVrkkiWBY4fWuM,A3fsA9Zfv1X2fVEQhTw51lKENdNrEqT3,2,0,0,0,0,0,5,0,5,0.7142857142857143,2,0.0,0,0,0,0,0,0,0,5,0,0,5,1
8023,72013,ukCIrv5h45nbdIEPPmMlvipT87B8fFE7,A3fsA9Zfv1X2fVEQhTw51lKENdNrEqT3,1,0,0,0,0,0,1,0,1,0.14285714285714285,1,0.0,0,0,0,0,0,0,0,1,0,0,1,1
8024,72028,rGUcxYNOJhuu9K9SMgsP5W3xbSiphSwH,SpATywNh6bZuzm8s1ceuBUnMUAeoAHHw,19,28,12,14,5,12,9,1,81,11.571428571428571,4,0.0,9,12,14,5,19,12,0,9,1,40,41,1
8025,72034,4D3Mr9GTnnSeHqe4k4RduVTIffzivKXV,SpATywNh6bZuzm8s1ceuBUnMUAeoAHHw,25,22,11,26,4,2,10,2,77,11.0,3,0.0,8,11,25,4,14,2,1,10,2,48,29,1
8026,72036,X5enyutaN4BslWhmXx6XhoGlJxHpkXgF,SpATywNh6bZuzm8s1ceuBUnMUAeoAHHw,5,3,1,0,0,0,3,0,7,1.0,1,0.0,0,1,0,0,3,0,0,3,0,1,6,1
8027,72066,FCXISzNoe8FGZLEA3b4ES0P455MShvJn,SpATywNh6bZuzm8s1ceuBUnMUAeoAHHw,4,2,1,0,1,0,3,0,7,1.0,2,0.0,0,1,0,1,2,0,0,3,0,2,5,1
8028,72074,RuDy1GBbehKUBaX6QEes5OGfFL3kKVSX,SpATywNh6bZuzm8s1ceuBUnMUAeoAHHw,1,0,0,0,0,0,1,0,1,0.14285714285714285,1,0.0,0,0,0,0,0,0,0,1,0,0,1,1
8029,72106,zIrlaPdUoa4jAQzQMvRWsAtbCae2mGEc,G8EPVSXsOYB5YQWZGiz1aVq5Pgr2GrQu,1,0,0,0,0,0,1,0,1,0.14285714285714285,1,0.0,0,0,0,0,0,0,0,1,0,0,1,1
8030,72110,UuK4SgZkmPrFxeH0ZPCRQ63pVXUSe96N,5X6FeZozNMgE2VRi3MJYjkkFK8SETtu2,1,0,0,0,0,0,1,0,1,0.14285714285714285,1,0.0,0,0,0,0,0,0,0,1,0,0,1,1
8031,72117,Sel2OIwsCKHe9RO5oHI96p00tLi1mx10,RXDvfPUBYFlVdlueBFbLW0mhhAyGEqpt,1,0,0,0,0,0,1,0,1,0.14285714285714285,1,0.0,0,0,0,0,0,0,0,1,0,0,1,1
8032,72123,a8HvMkBRr1QnoDxivZVIhrkeiZFWplka,bWdj2GDclj5ofokWjzoa5jAwMkxCykd6,32,46,27,93,13,10,15,0,204,29.142857142857142,5,0.0,8,27,74,13,38,10,19,15,0,122,82,1
8033,72166,yS4hKsLzPsdj6M1qMcvQzXXEbCXgtzUx,A3fsA9Zfv1X2fVEQhTw51lKENdNrEqT3,11,7,1,0,1,11,7,1,28,4.0,1,0.0,0,1,0,1,7,11,0,7,1,2,26,1
8034,72179,oJ9j9ejTgKixczg3tSE8Sg8DPI7YQpJq,5X6FeZozNMgE2VRi3MJYjkkFK8SETtu2,6,5,4,0,0,0,1,0,10,1.4285714285714286,1,0.0,0,4,0,0,5,0,0,1,0,4,6,1
8035,72180,h3JQOcsvjUnoJCiMtN2qNwJvDlNp6yEa,SpATywNh6bZuzm8s1ceuBUnMUAeoAHHw,6,3,2,0,2,0,1,0,8,1.1428571428571428,1,0.0,0,2,0,2,3,0,0,1,0,4,4,1
8036,72186,hm5fInUESikvdLXUApWeBZ8sQediiiZi,5X6FeZozNMgE2VRi3MJYjkkFK8SETtu2,1,0,0,0,0,0,1,0,1,0.14285714285714285,1,0.0,0,0,0,0,0,0,0,1,0,0,1,1
8037,72187,pg03VLobZ1zAAslEUdBaTgGu7kih28vz,SpATywNh6bZuzm8s1ceuBUnMUAeoAHHw,6,3,1,0,1,0,2,0,7,1.0,1,0.0,0,1,0,1,3,0,0,2,0,2,5,0
8038,72195,2XrVfo49pLwaH12euHkVNsz60Xa54j5d,SpATywNh6bZuzm8s1ceuBUnMUAeoAHHw,2,0,0,0,0,0,3,0,3,0.42857142857142855,2,0.0,0,0,0,0,0,0,0,3,0,0,3,1
8039,72196,uiC9EHMxnf2w4h6Qgd2IixJ8SdchRJcU,5X6FeZozNMgE2VRi3MJYjkkFK8SETtu2,1,0,0,0,0,0,2,0,2,0.2857142857142857,2,0.0,0,0,0,0,0,0,0,2,0,0,2,1
8040,72198,dRTXM152V1lTMTi8e61qXn3u4WelzJ82,A3fsA9Zfv1X2fVEQhTw51lKENdNrEqT3,20,20,1,0,2,0,6,0,29,4.142857142857143,2,0.0,0,1,0,2,20,0,0,6,0,3,26,1
8041,72200,ZRC032b6bAMTdyW8JO1vU2llk0mQNPce,SpATywNh6bZuzm8s1ceuBUnMUAeoAHHw,21,39,13,38,3,23,15,5,136,19.428571428571427,3,0.0,17,13,31,3,22,23,7,15,5,64,72,1
8042,72206,2t2mFcXnjCSGOBpya1wSPFZtPiud9I2F,SpATywNh6bZuzm8s1ceuBUnMUAeoAHHw,34,65,1,32,0,0,30,3,131,18.714285714285715,9,0.0,22,1,29,0,43,0,3,30,3,52,79,0
8043,72215,6ngga8jBuXKmnKYc00TBjXbVEmc0f4XL,SpATywNh6bZuzm8s1ceuBUnMUAeoAHHw,11,10,6,0,4,0,3,0,23,3.2857142857142856,3,0.0,0,6,0,4,10,0,0,3,0,10,13,1
8044,72250,SozblGZP0jqptTVCGb8oKsTCWZZGfIvg,SpATywNh6bZuzm8s1ceuBUnMUAeoAHHw,35,52,3,43,3,74,17,0,192,27.428571428571427,5,0.0,18,3,37,3,34,74,6,17,0,61,131,0
8045,72268,hluzPB1y7zkKLSSzVkJvXfWNLyDAuRho,RXDvfPUBYFlVdlueBFbLW0mhhAyGEqpt,16,18,11,0,6,0,6,4,45,6.428571428571429,3,0.0,0,11,0,6,18,0,0,6,4,17,28,1
8046,72270,VCY6PHshXOjPWWfmo1l8Uf1lH1o7rZ3R,bWdj2GDclj5ofokWjzoa5jAwMkxCykd6,1,0,0,0,0,0,1,0,1,0.14285714285714285,1,0.0,0,0,0,0,0,0,0,1,0,0,1,1
8047,72321,cfFiO9ikb1PkctbOzz1e9XkphXHtxdbN,A3fsA9Zfv1X2fVEQhTw51lKENdNrEqT3,10,4,2,0,2,0,7,0,15,2.142857142857143,1,0.0,0,2,0,2,4,0,0,7,0,4,11,1
8048,72327,vpU9FFM3siBSv5Tq74CkiYBZ5nbD9oub,SpATywNh6bZuzm8s1ceuBUnMUAeoAHHw,23,30,1,28,0,2,11,1,73,10.428571428571429,3,0.0,11,1,26,0,19,2,2,11,1,38,35,1
8049,72328,iq2dRooMckypJXruhYgCykZbS7Y4UNpS,SpATywNh6bZuzm8s1ceuBUnMUAeoAHHw,2,0,0,0,0,0,2,0,2,0.2857142857142857,1,0.0,0,0,0,0,0,0,0,2,0,0,2,1
8050,72342,AImx2eHFGaeqTe0d3fwuX86fffC0rd9k,RXDvfPUBYFlVdlueBFbLW0mhhAyGEqpt,6,4,3,0,1,0,1,0,9,1.2857142857142858,1,0.0,0,3,0,1,4,0,0,1,0,4,5,1
8051,72354,4ZKN4qjeNhliROr2sm8vB8zmpPTrlPXO,A3fsA9Zfv1X2fVEQhTw51lKENdNrEqT3,7,11,1,0,1,0,2,0,15,2.142857142857143,1,0.0,1,1,0,1,10,0,0,2,0,3,12,1
8052,72357,CRIxBWowFPqH4PKg7CVbbYai7181zWdg,5X6FeZozNMgE2VRi3MJYjkkFK8SETtu2,17,22,6,19,12,0,5,0,64,9.142857142857142,2,0.0,14,6,18,12,8,0,1,5,0,50,14,0
8053,72370,WI9rk8aS11tBAJzjcX0JSIgomYYRQVjW,SpATywNh6bZuzm8s1ceuBUnMUAeoAHHw,38,66,6,26,5,5,29,0,137,19.571428571428573,9,0.0,4,6,25,5,62,5,1,29,0,40,97,0
8054,72371,iahhmqoMx53j5nO5miK92n3wdWI8ut4z,RXDvfPUBYFlVdlueBFbLW0mhhAyGEqpt,5,2,1,0,1,0,6,0,10,1.4285714285714286,4,0.0,0,1,0,1,2,0,0,6,0,2,8,1
8055,72375,jpXIq3stqWScWG27acYJbNKpdTmc6kli,bWdj2GDclj5ofokWjzoa5jAwMkxCykd6,40,89,54,190,14,13,44,0,404,57.714285714285715,12,0.0,7,54,183,14,82,13,7,44,0,258,146,0
8056,72406,m2qlFWWWmt2hJc2nGhR4gu4Qag46wOrg,bWdj2GDclj5ofokWjzoa5jAwMkxCykd6,15,9,6,0,4,0,9,1,29,4.142857142857143,3,0.0,0,6,0,4,9,0,0,9,1,10,19,1
8057,72412,NIlxh2g7VTAquieuVc9RGErPkOzbSh2Z,SpATywNh6bZuzm8s1ceuBUnMUAeoAHHw,17,34,14,19,3,0,14,0,84,12.0,3,0.0,4,14,17,3,30,0,2,14,0,38,46,1
8058,72416,iPefB9aOL6bAjIaS6Gks903vpOsT6Kof,SpATywNh6bZuzm8s1ceuBUnMUAeoAHHw,8,6,1,0,1,0,7,0,15,2.142857142857143,2,0.0,0,1,0,1,6,0,0,7,0,2,13,1
8059,72418,idKVU6p7Q7GgRNB8N8uPXj3SONpH1Rke,SpATywNh6bZuzm8s1ceuBUnMUAeoAHHw,9,10,1,0,1,0,3,0,15,2.142857142857143,1,0.0,0,1,0,1,10,0,0,3,0,2,13,1
8060,72426,B9BCqbSn4dXX7PoOMPBly9mxS1ETXKHH,SpATywNh6bZuzm8s1ceuBUnMUAeoAHHw,14,46,20,12,8,1,6,0,93,13.285714285714286,6,0.0,19,20,12,8,27,1,0,6,0,59,34,1
8061,72429,GwQix8XlCp4q9CmSxf5jg9NO42lfroib,SpATywNh6bZuzm8s1ceuBUnMUAeoAHHw,2,0,0,0,0,0,3,0,3,0.42857142857142855,3,0.0,0,0,0,0,0,0,0,3,0,0,3,1
8062,72438,7o7xgD7LMzcqbchAXccb0936AlSMEPrX,G8EPVSXsOYB5YQWZGiz1aVq5Pgr2GrQu,3,2,0,0,0,0,1,0,3,0.42857142857142855,1,0.0,0,0,0,0,2,0,0,1,0,0,3,1
8063,72442,LWfPQEZcfqcdY03cxPtuNt5LIUXK1J1h,bWdj2GDclj5ofokWjzoa5jAwMkxCykd6,20,31,2,80,5,25,26,1,170,24.285714285714285,4,0.0,10,2,75,5,21,25,5,26,1,92,78,1
8064,72443,r4duLXpBfZecmSM9LE5BQOC4ssd1sXJk,SpATywNh6bZuzm8s1ceuBUnMUAeoAHHw,1,0,0,0,0,0,1,0,1,0.14285714285714285,1,0.0,0,0,0,0,0,0,0,1,0,0,1,1
8065,72445,r4duLXpBfZecmSM9LE5BQOC4ssd1sXJk,bWdj2GDclj5ofokWjzoa5jAwMkxCykd6,3,0,0,0,0,0,4,0,4,0.5714285714285714,1,0.0,0,0,0,0,0,0,0,4,0,0,4,1
8066,72448,Ln23tN1YAlBNEBT8tndbR9JhZVhVTsS7,SpATywNh6bZuzm8s1ceuBUnMUAeoAHHw,30,57,29,36,15,3,22,1,163,23.285714285714285,5,0.0,18,29,33,15,39,3,3,22,1,95,68,1
8067,72451,9FaPBbsYKn0C9myyRYf9vYNhns2eJDpD,bWdj2GDclj5ofokWjzoa5jAwMkxCykd6,24,69,27,0,12,0,29,1,138,19.714285714285715,9,0.0,2,27,0,12,67,0,0,29,1,41,97,0
8068,72452,MU4dVyJTD7iIRSTZIdJZ9VoLOxogfKQN,A3fsA9Zfv1X2fVEQhTw51lKENdNrEqT3,44,22,16,86,11,5,9,0,149,21.285714285714285,4,0.0,1,16,74,11,21,5,12,9,0,102,47,0
8069,72465,ypoGZw2r9uT31DVWRK8Ak5IwBPQDf2ZW,A3fsA9Zfv1X2fVEQhTw51lKENdNrEqT3,6,5,2,0,0,0,5,0,12,1.7142857142857142,3,0.0,0,2,0,0,5,0,0,5,0,2,10,1
8070,72468,clbUGnOQsN7CuaV7idGJ2LVbYN3t8qC3,bWdj2GDclj5ofokWjzoa5jAwMkxCykd6,39,80,4,93,2,10,21,2,212,30.285714285714285,7,0.0,26,4,90,2,54,10,3,21,2,122,90,0
8071,72485,H1nbdkC904EOh8jWeVVcV5piaqMVBsli,RXDvfPUBYFlVdlueBFbLW0mhhAyGEqpt,46,49,5,84,3,0,15,2,158,22.571428571428573,6,0.0,9,5,83,3,40,0,1,15,2,100,58,0
8072,72488,KQPXidcwG060yQGJPDlINxK2yFVflTSt,bWdj2GDclj5ofokWjzoa5jAwMkxCykd6,1,0,0,0,0,0,1,0,1,0.14285714285714285,1,0.0,0,0,0,0,0,0,0,1,0,0,1,1
8073,72489,RJYmcEEhHfwNHiJXK5LzE5hkiIIoNU9v,RXDvfPUBYFlVdlueBFbLW0mhhAyGEqpt,1,0,0,0,0,0,1,0,1,0.14285714285714285,1,0.0,0,0,0,0,0,0,0,1,0,0,1,1
8074,72499,sD8qOTBQiDeb2NJjPdXUeUPzMkOLP9sv,G8EPVSXsOYB5YQWZGiz1aVq5Pgr2GrQu,18,17,5,17,4,1,14,2,60,8.571428571428571,1,0.0,7,5,14,4,10,1,3,14,2,30,30,1
8075,72510,0Zbkv3HIeYhldfQXVnfym9fVEiuNqjhW,G8EPVSXsOYB5YQWZGiz1aVq5Pgr2GrQu,10,21,2,0,2,1,12,1,39,5.571428571428571,1,0.0,0,2,0,2,21,1,0,12,1,4,35,1
8076,72521,8UBuXoKnbGMq6Q0kIIWDMawKN4aOMWdt,SpATywNh6bZuzm8s1ceuBUnMUAeoAHHw,6,7,5,0,4,0,1,0,17,2.4285714285714284,1,0.0,0,5,0,4,7,0,0,1,0,9,8,1
8077,72523,bBon9Fz54W0VEKu51qXuvXYwLHShFyI1,SpATywNh6bZuzm8s1ceuBUnMUAeoAHHw,11,21,11,0,0,1,10,1,44,6.285714285714286,2,0.0,6,11,0,0,15,1,0,10,1,17,27,1
8078,72527,3RFxfyZdyTuIPVV58WHND3p7FoSeVnvd,SpATywNh6bZuzm8s1ceuBUnMUAeoAHHw,1,0,0,0,0,0,1,0,1,0.14285714285714285,1,0.0,0,0,0,0,0,0,0,1,0,0,1,1
8079,72532,QPoypIc1fBONo2zEXZGrqFPP68plPMOG,A3fsA9Zfv1X2fVEQhTw51lKENdNrEqT3,73,59,3,248,1,1,25,3,340,48.57142857142857,6,0.0,6,3,190,1,53,1,58,25,3,200,140,0
8080,72540,3RFxfyZdyTuIPVV58WHND3p7FoSeVnvd,G8EPVSXsOYB5YQWZGiz1aVq5Pgr2GrQu,19,33,20,0,10,0,9,0,72,10.285714285714286,4,0.0,0,20,0,10,33,0,0,9,0,30,42,1
8081,72547,ACrAvl4ssWNFndB2wDhI3oY0Vqi5B1FR,RXDvfPUBYFlVdlueBFbLW0mhhAyGEqpt,47,28,18,88,9,2,3,0,148,21.142857142857142,2,0.0,7,18,86,9,21,2,2,3,0,120,28,1
8082,72554,92DwnWdf0DjZODrvrNNLdxmEfzQWnu5Z,A3fsA9Zfv1X2fVEQhTw51lKENdNrEqT3,17,11,10,0,8,4,11,1,45,6.428571428571429,2,0.0,0,10,0,8,11,4,0,11,1,18,27,1
8083,72588,5fUv2a4WMEi2Bc60cQo0Uzo1I7SufPfI,SpATywNh6bZuzm8s1ceuBUnMUAeoAHHw,47,82,2,49,1,17,17,1,169,24.142857142857142,6,0.0,19,2,44,1,63,17,5,17,1,66,103,0
8084,72593,rPY59o3LLmGBPTPMGcA5vX57KVfmywv5,bWdj2GDclj5ofokWjzoa5jAwMkxCykd6,1,0,0,0,0,0,1,0,1,0.14285714285714285,1,0.0,0,0,0,0,0,0,0,1,0,0,1,1
8085,72596,rPY59o3LLmGBPTPMGcA5vX57KVfmywv5,5X6FeZozNMgE2VRi3MJYjkkFK8SETtu2,1,0,0,0,0,0,1,0,1,0.14285714285714285,1,0.0,0,0,0,0,0,0,0,1,0,0,1,1
8086,72609,qIgfmlfsBIhgTbQqqVFddAaDPPK19iKa,SpATywNh6bZuzm8s1ceuBUnMUAeoAHHw,6,6,3,0,0,0,3,0,12,1.7142857142857142,1,0.0,2,3,0,0,4,0,0,3,0,5,7,1
8087,72622,3RFxfyZdyTuIPVV58WHND3p7FoSeVnvd,A3fsA9Zfv1X2fVEQhTw51lKENdNrEqT3,1,0,0,0,0,0,1,0,1,0.14285714285714285,1,0.0,0,0,0,0,0,0,0,1,0,0,1,1
8088,72626,KQPXidcwG060yQGJPDlINxK2yFVflTSt,A3fsA9Zfv1X2fVEQhTw51lKENdNrEqT3,2,0,0,0,0,0,3,0,3,0.42857142857142855,1,0.0,0,0,0,0,0,0,0,3,0,0,3,1
8089,72628,NKFAtRqaabgEQPy42hYUIZ9UDec46naf,5X6FeZozNMgE2VRi3MJYjkkFK8SETtu2,15,39,3,23,11,6,4,0,86,12.285714285714286,4,0.0,22,3,21,11,17,6,2,4,0,57,29,1
8090,72636,xOB7vl3l1Tpb0i0cSWni40BfJ5FBclms,bWdj2GDclj5ofokWjzoa5jAwMkxCykd6,1,0,0,0,0,0,2,0,2,0.2857142857142857,2,0.0,0,0,0,0,0,0,0,2,0,0,2,1
8091,72659,Ikx8dqw7N29O68oP7rbQGE7AGY4iLNon,A3fsA9Zfv1X2fVEQhTw51lKENdNrEqT3,6,3,1,0,1,0,3,0,8,1.1428571428571428,1,0.0,0,1,0,1,3,0,0,3,0,2,6,1
8092,72685,2IlOpdUgsPu5FVltj0flScFk4CeI7uHm,RXDvfPUBYFlVdlueBFbLW0mhhAyGEqpt,31,29,17,26,7,7,5,0,91,13.0,4,0.0,4,17,26,7,25,7,0,5,0,54,37,0
8093,72692,H2pnCC5fUi5Ho09aPqAE97vnlsM8FGBU,A3fsA9Zfv1X2fVEQhTw51lKENdNrEqT3,104,30,17,414,2,0,11,0,474,67.71428571428571,4,0.0,6,17,404,2,24,0,10,11,0,429,45,0
8094,72701,h2ynGKkFoAy58qRjHGCAYsp0Afa0leqG,SpATywNh6bZuzm8s1ceuBUnMUAeoAHHw,6,7,0,0,0,0,6,0,13,1.8571428571428572,3,0.0,0,0,0,0,7,0,0,6,0,0,13,1
8095,72714,FsRtG9gDIPReRoDWnJ4MFLGSrRsEmLDJ,5X6FeZozNMgE2VRi3MJYjkkFK8SETtu2,14,9,4,14,2,3,7,2,41,5.857142857142857,2,0.0,3,4,12,2,6,3,2,7,2,21,20,1
8096,72716,0VjAWG5aLQgXyXeTqTPnha195szz41mH,RXDvfPUBYFlVdlueBFbLW0mhhAyGEqpt,73,74,34,155,26,57,14,2,362,51.714285714285715,4,0.0,33,34,148,26,41,57,7,14,2,241,121,1
8097,72717,GWNKqanO7Bwv22F8soWqeHa4Wn2DiLGZ,5X6FeZozNMgE2VRi3MJYjkkFK8SETtu2,10,12,2,10,3,0,1,0,28,4.0,1,0.0,5,2,10,3,7,0,0,1,0,20,8,1
8098,72721,1UwRwlLE0RwxPaY5NbrfjlESNYQllZZa,A3fsA9Zfv1X2fVEQhTw51lKENdNrEqT3,18,28,8,0,6,9,10,0,61,8.714285714285714,4,0.0,0,8,0,6,28,9,0,10,0,14,47,0
8099,72726,0bJvCDj0GgBeU0HMz26Zp0pAIP7Ku0m6,G8EPVSXsOYB5YQWZGiz1aVq5Pgr2GrQu,23,20,12,0,12,0,4,0,48,6.857142857142857,2,0.0,6,12,0,12,14,0,0,4,0,30,18,0
8100,72729,gfqBONxF3vgkgkzNGOBh2NvmbBtnV553,A3fsA9Zfv1X2fVEQhTw51lKENdNrEqT3,22,17,15,0,12,0,7,0,51,7.285714285714286,1,0.0,0,15,0,12,17,0,0,7,0,27,24,1
8101,72741,CVH6urFvexNmD0aVZsmcYsZiC7ATsEWQ,SpATywNh6bZuzm8s1ceuBUnMUAeoAHHw,23,35,12,23,5,16,4,0,95,13.571428571428571,2,0.0,14,12,19,5,21,16,4,4,0,50,45,1
8102,72750,Jd5OP6GIsguRdsq9k3eSYNENmzhPbdGe,RXDvfPUBYFlVdlueBFbLW0mhhAyGEqpt,1,0,0,0,0,0,1,0,1,0.14285714285714285,1,0.0,0,0,0,0,0,0,0,1,0,0,1,1
8103,72760,V7hPLACO2aZJMGkqrqGs8iTi1dh1D640,A3fsA9Zfv1X2fVEQhTw51lKENdNrEqT3,8,3,2,0,2,1,6,0,14,2.0,1,0.0,0,2,0,2,3,1,0,6,0,4,10,1
8104,72764,Sr1toTUNefJAFbhTUg77mqKaZFTtdaV4,A3fsA9Zfv1X2fVEQhTw51lKENdNrEqT3,5,0,0,0,0,3,5,2,10,1.4285714285714286,1,0.0,0,0,0,0,0,3,0,5,2,0,10,1
8105,72794,GcYYdMUd1jTzTWqukpvr0rVRxsxU8er2,G8EPVSXsOYB5YQWZGiz1aVq5Pgr2GrQu,1,0,0,0,0,0,1,0,1,0.14285714285714285,1,0.0,0,0,0,0,0,0,0,1,0,0,1,1
8106,72811,QmwPzVmCybpAgMwyMz1fwIqSJEweIwjc,SpATywNh6bZuzm8s1ceuBUnMUAeoAHHw,12,8,5,0,3,4,5,3,28,4.0,1,0.0,1,5,0,3,7,4,0,5,3,9,19,1
8107,72814,kPOhZ6qf9bbLzunMF2utkZU62wMNJPxJ,SpATywNh6bZuzm8s1ceuBUnMUAeoAHHw,13,15,4,12,2,0,2,0,35,5.0,1,0.0,9,4,11,2,6,0,1,2,0,26,9,1
8108,72824,UZj9qZ6lkWkIz7HEEFyBh5LFRNaz4SI2,bWdj2GDclj5ofokWjzoa5jAwMkxCykd6,5,2,1,0,1,0,2,0,6,0.8571428571428571,1,0.0,0,1,0,1,2,0,0,2,0,2,4,1
8109,72844,pQdSl7i5ZuZeH9uPILgdHrvwskp4vc4V,A3fsA9Zfv1X2fVEQhTw51lKENdNrEqT3,5,2,1,0,1,0,4,0,8,1.1428571428571428,2,0.0,0,1,0,1,2,0,0,4,0,2,6,1
8110,72847,OUbh6hvaOJDp9RK7kgTBzzPmjzmkYhZF,bWdj2GDclj5ofokWjzoa5jAwMkxCykd6,11,13,1,70,0,0,8,0,92,13.142857142857142,3,0.0,1,1,68,0,12,0,2,8,0,70,22,1
8111,72850,QqE2Xjwy9gUzOvFdkDqAwAaNZLBZkxvd,G8EPVSXsOYB5YQWZGiz1aVq5Pgr2GrQu,22,34,4,0,1,18,34,1,92,13.142857142857142,13,0.0,3,4,0,1,31,18,0,34,1,8,84,1
8112,72861,uynRJ81lKSVTwiBUWysuMw4GfvXEQcj1,A3fsA9Zfv1X2fVEQhTw51lKENdNrEqT3,1,0,0,0,0,0,1,0,1,0.14285714285714285,1,0.0,0,0,0,0,0,0,0,1,0,0,1,1
8113,72878,3z37iBp19kh1LYVfVTprpt7Nc7WFUSh9,bWdj2GDclj5ofokWjzoa5jAwMkxCykd6,13,15,9,0,7,0,6,0,37,5.285714285714286,2,0.0,2,9,0,7,13,0,0,6,0,18,19,1
8114,72885,czhzfQM5hzKsjmfr33GA4a86kqhVxJHf,A3fsA9Zfv1X2fVEQhTw51lKENdNrEqT3,44,19,13,70,11,0,7,0,120,17.142857142857142,3,0.0,1,13,60,11,18,0,10,7,0,85,35,1
8115,72922,ria1rZm5v1iNiSZkl2at79lKlYWZvHeF,SpATywNh6bZuzm8s1ceuBUnMUAeoAHHw,24,51,0,21,0,45,15,2,134,19.142857142857142,4,0.0,10,0,21,0,41,45,0,15,2,31,103,0
8116,72923,bK25MCIg6ikdYLUuBMScg0aIrIK7DQNQ,5X6FeZozNMgE2VRi3MJYjkkFK8SETtu2,1,0,0,0,0,0,1,0,1,0.14285714285714285,1,0.0,0,0,0,0,0,0,0,1,0,0,1,1
8117,72942,PwGj8ON4yrWpMaoZE0ES8sG2eAqFQNfN,5X6FeZozNMgE2VRi3MJYjkkFK8SETtu2,6,3,2,0,2,0,2,0,9,1.2857142857142858,2,0.0,0,2,0,2,3,0,0,2,0,4,5,1
8118,72950,5lXEnKEAbuix9ITMHrIbzKht9sQOw1oR,A3fsA9Zfv1X2fVEQhTw51lKENdNrEqT3,1,0,0,0,0,0,1,0,1,0.14285714285714285,1,0.0,0,0,0,0,0,0,0,1,0,0,1,1
8119,72951,Ou3iHiBDr7O5XF3iHhMwgAvySH9eHz42,RXDvfPUBYFlVdlueBFbLW0mhhAyGEqpt,39,63,4,108,6,4,20,0,205,29.285714285714285,5,0.0,23,4,99,6,40,4,9,20,0,132,73,1
8120,72964,rN6lunIjAbCWqlUClfGlFjDjxcPvXSQ8,G8EPVSXsOYB5YQWZGiz1aVq5Pgr2GrQu,2,0,0,0,0,0,3,0,3,0.42857142857142855,2,0.0,0,0,0,0,0,0,0,3,0,0,3,1
8121,72967,NYagfMVvA1FDdZ7PZwzv8OVDbZ0jsy8R,SpATywNh6bZuzm8s1ceuBUnMUAeoAHHw,4,2,0,0,0,1,4,0,7,1.0,3,0.0,0,0,0,0,2,1,0,4,0,0,7,1
8122,73009,l569pvTkqA1hwU8mlPA8zjV2SyK4a7w2,SpATywNh6bZuzm8s1ceuBUnMUAeoAHHw,29,65,0,34,0,1,7,0,107,15.285714285714286,6,0.0,12,0,29,0,53,1,5,7,0,41,66,0
8123,73024,LzA5wgwJJZVLbqKdv9NjOOvbbtbdWAC9,SpATywNh6bZuzm8s1ceuBUnMUAeoAHHw,5,2,1,0,1,0,2,0,6,0.8571428571428571,1,0.0,0,1,0,1,2,0,0,2,0,2,4,1
8124,73036,zcVtFTrToAbXyBSFxcFkJCnMsb7Jt1Wc,SpATywNh6bZuzm8s1ceuBUnMUAeoAHHw,7,8,4,0,0,0,3,0,15,2.142857142857143,2,0.0,0,4,0,0,8,0,0,3,0,4,11,1
8125,73080,y1PyjNePB0NOk56DVMODQe87hVVXR5yE,bWdj2GDclj5ofokWjzoa5jAwMkxCykd6,1,0,0,0,0,0,1,0,1,0.14285714285714285,1,0.0,0,0,0,0,0,0,0,1,0,0,1,1
8126,73091,bVDYKiZvgd2IcK5UYf7mO2QJtYbh5uZ8,SpATywNh6bZuzm8s1ceuBUnMUAeoAHHw,5,2,1,0,1,0,2,0,6,0.8571428571428571,1,0.0,0,1,0,1,2,0,0,2,0,2,4,1
8127,73105,O2ctwJV4MPvP5qTfQJUUGlNEKgJxJSl6,G8EPVSXsOYB5YQWZGiz1aVq5Pgr2GrQu,1,0,0,0,0,0,1,0,1,0.14285714285714285,1,0.0,0,0,0,0,0,0,0,1,0,0,1,1
8128,73106,OWturuXXamL4qdRmyvXAQUfG96tebkB5,5X6FeZozNMgE2VRi3MJYjkkFK8SETtu2,1,0,0,0,0,0,2,0,2,0.2857142857142857,1,0.0,0,0,0,0,0,0,0,2,0,0,2,1
8129,73113,Liq3zOCCoZeQzrp7SiKverX8kFDQZENr,5X6FeZozNMgE2VRi3MJYjkkFK8SETtu2,5,2,1,0,1,0,6,0,10,1.4285714285714286,1,0.0,0,1,0,1,2,0,0,6,0,2,8,1
8130,73141,YWIcWPk2owvGQjJvioCvuMwwhqp9Hu6o,SpATywNh6bZuzm8s1ceuBUnMUAeoAHHw,2,0,0,0,0,0,2,0,2,0.2857142857142857,1,0.0,0,0,0,0,0,0,0,2,0,0,2,1
8131,73173,afdo7sttc7aaNvz9ca7YCfhlkfRUdKCm,SpATywNh6bZuzm8s1ceuBUnMUAeoAHHw,1,0,0,0,0,0,3,0,3,0.42857142857142855,1,0.0,0,0,0,0,0,0,0,3,0,0,3,1
8132,73180,uoufNidjh1zD724gB2zYdd5MROgtTWHO,A3fsA9Zfv1X2fVEQhTw51lKENdNrEqT3,29,34,27,0,24,0,3,0,88,12.571428571428571,2,0.0,1,27,0,24,33,0,0,3,0,52,36,1
8133,73197,Lm6J3qI5iNdtiMvPAGBW8hmcUCVUqmON,3VkHkmOtom3jM2wCu94xgzzu1d6Dn7or,11,11,7,0,5,0,3,0,26,3.7142857142857144,3,0.0,0,7,0,5,11,0,0,3,0,12,14,1
8134,73200,KbVIZwe7S3MOh9dlFVWDZwSpf3zNL2tv,3VkHkmOtom3jM2wCu94xgzzu1d6Dn7or,1,0,0,0,0,0,3,0,3,0.42857142857142855,2,0.0,0,0,0,0,0,0,0,3,0,0,3,1
8135,73208,S5JEpWHgN20ET81VeLmsjVq6FkZoKJg6,3VkHkmOtom3jM2wCu94xgzzu1d6Dn7or,1,0,0,0,0,0,1,0,1,0.14285714285714285,1,0.0,0,0,0,0,0,0,0,1,0,0,1,1
8136,73209,b9118bQqxgqIy1PGFhvP98mfMsVg8dff,3VkHkmOtom3jM2wCu94xgzzu1d6Dn7or,10,8,6,0,4,0,5,0,23,3.2857142857142856,2,0.0,0,6,0,4,8,0,0,5,0,10,13,1
8137,73217,2we3WxltFBT1dd0FjP3YZ8iHf2xpHEei,3VkHkmOtom3jM2wCu94xgzzu1d6Dn7or,87,205,77,31,57,8,24,2,404,57.714285714285715,18,0.0,61,77,29,57,144,8,2,24,2,224,180,0
8138,73220,6S42i3UQWxx5Vy8tElcT4nwPzZzrdR85,3VkHkmOtom3jM2wCu94xgzzu1d6Dn7or,33,101,28,28,16,44,28,0,245,35.0,8,0.0,29,28,23,16,72,44,5,28,0,96,149,1
8139,73221,PKGM0PZA2Jkm4eJkhnQK54JbcGNphgCu,3VkHkmOtom3jM2wCu94xgzzu1d6Dn7or,15,29,6,20,11,0,6,0,72,10.285714285714286,3,0.0,20,6,18,11,9,0,2,6,0,55,17,1
8140,73222,D0RJX8LWpSJiOYT59P1X3r8qNhJsdkkW,3VkHkmOtom3jM2wCu94xgzzu1d6Dn7or,8,11,1,0,3,0,8,0,23,3.2857142857142856,3,0.0,7,1,0,3,4,0,0,8,0,11,12,1
8141,73224,PbtEZmikq1bOEQJ0ub4zxpBJadIsTRw3,3VkHkmOtom3jM2wCu94xgzzu1d6Dn7or,1,0,0,0,0,0,1,0,1,0.14285714285714285,1,0.0,0,0,0,0,0,0,0,1,0,0,1,1
8142,73231,8mJzNtbbhYVCgZPRtpQ3nYyV12q5x7iP,3VkHkmOtom3jM2wCu94xgzzu1d6Dn7or,7,4,2,0,2,0,6,0,14,2.0,1,0.0,0,2,0,2,4,0,0,6,0,4,10,0
8143,73234,nNu7fBxwIxknxpghde4lZ2WkggoZZZqU,3VkHkmOtom3jM2wCu94xgzzu1d6Dn7or,6,5,3,0,1,0,2,0,11,1.5714285714285714,2,0.0,0,3,0,1,5,0,0,2,0,4,7,1
8144,73239,N0De3s0orNACcEd2OVzwpa1d753PsHOL,3VkHkmOtom3jM2wCu94xgzzu1d6Dn7or,5,5,3,0,2,1,2,0,13,1.8571428571428572,2,0.0,0,3,0,2,5,1,0,2,0,5,8,1
8145,73242,xrLVCjvq2WZdMIKT9yLmMgpNoKuooAqk,3VkHkmOtom3jM2wCu94xgzzu1d6Dn7or,4,2,1,0,1,0,1,0,5,0.7142857142857143,1,0.0,0,1,0,1,2,0,0,1,0,2,3,1
8146,73245,FNfRWeqC2pKht5WsSWN1TiZEifuqhSGH,3VkHkmOtom3jM2wCu94xgzzu1d6Dn7or,6,5,3,0,2,0,2,0,12,1.7142857142857142,1,0.0,0,3,0,2,5,0,0,2,0,5,7,1
8147,73251,2Etgf2LdVc2Aplhz3Ti29bA2IzDHwMCl,3VkHkmOtom3jM2wCu94xgzzu1d6Dn7or,7,4,1,0,1,0,9,0,15,2.142857142857143,2,0.0,0,1,0,1,4,0,0,9,0,2,13,1
8148,73253,HB5xN5WvO63fyle8L9OU8KEV5tvW4m0R,3VkHkmOtom3jM2wCu94xgzzu1d6Dn7or,1,0,0,0,0,0,1,0,1,0.14285714285714285,1,0.0,0,0,0,0,0,0,0,1,0,0,1,1
8149,73257,ZMsKvqGPvyoyzO8L6K7CrRjoSN8Ix7BT,3VkHkmOtom3jM2wCu94xgzzu1d6Dn7or,22,65,26,37,0,15,6,9,158,22.571428571428573,5,0.0,29,26,36,0,36,15,1,6,9,91,67,1
8150,73264,lowpjo6E4nS7i7uK8zQgTiMb3jQkTH9B,3VkHkmOtom3jM2wCu94xgzzu1d6Dn7or,31,48,22,17,20,17,8,0,132,18.857142857142858,2,0.0,19,22,17,20,29,17,0,8,0,78,54,1
8151,73272,R4zaFozhL1MuUlv9bsWLOdQlV0cSgMuo,3VkHkmOtom3jM2wCu94xgzzu1d6Dn7or,1,0,0,0,0,0,1,0,1,0.14285714285714285,1,0.0,0,0,0,0,0,0,0,1,0,0,1,1
8152,73274,eM2VlYVwCSxNYbgtqwfFJNqE3ZKGFRHs,3VkHkmOtom3jM2wCu94xgzzu1d6Dn7or,4,2,0,0,1,0,2,0,5,0.7142857142857143,2,0.0,0,0,0,1,2,0,0,2,0,1,4,1
8153,73275,WBWpmfTjwWFYEkWYODOKc6dG21aksLsN,3VkHkmOtom3jM2wCu94xgzzu1d6Dn7or,1,0,0,0,0,0,1,0,1,0.14285714285714285,1,0.0,0,0,0,0,0,0,0,1,0,0,1,1
8154,73286,YNDq95jX1KOzsEMn70Xi3AzeL2bo2v0j,3VkHkmOtom3jM2wCu94xgzzu1d6Dn7or,21,96,45,13,4,20,22,8,208,29.714285714285715,7,0.0,29,45,12,4,67,20,1,22,8,90,118,1
8155,73290,Xc50FKYttTq6KTss24QRE6hOEnatNWn2,3VkHkmOtom3jM2wCu94xgzzu1d6Dn7or,1,0,0,0,0,0,1,0,1,0.14285714285714285,1,0.0,0,0,0,0,0,0,0,1,0,0,1,1
8156,73291,WIgM6nvV9YFBo82xFhtQp6923xmcbs69,3VkHkmOtom3jM2wCu94xgzzu1d6Dn7or,76,388,121,73,64,38,49,4,737,105.28571428571429,16,0.0,140,121,71,64,248,38,2,49,4,396,341,0
8157,73292,ZYuOb7GejOxNmB17SrMGXD1XSycRcwqA,3VkHkmOtom3jM2wCu94xgzzu1d6Dn7or,4,2,1,0,1,0,1,0,5,0.7142857142857143,1,0.0,0,1,0,1,2,0,0,1,0,2,3,1
8158,73305,8HND7pRMGcXENbJtDH640SQuLfMpOGU7,3VkHkmOtom3jM2wCu94xgzzu1d6Dn7or,7,15,4,3,3,9,5,0,39,5.571428571428571,2,0.0,2,4,3,3,13,9,0,5,0,12,27,1
8159,73314,33eeozPiEQNXDhiBOKkMbYxyVM2jD8Xx,3VkHkmOtom3jM2wCu94xgzzu1d6Dn7or,6,5,1,0,1,0,2,0,9,1.2857142857142858,1,0.0,0,1,0,1,5,0,0,2,0,2,7,0
8160,73319,n2r6kyDnsWpbtliBFHcr0YWSTfVt0HhQ,3VkHkmOtom3jM2wCu94xgzzu1d6Dn7or,1,0,0,0,0,0,1,0,1,0.14285714285714285,1,0.0,0,0,0,0,0,0,0,1,0,0,1,1
8161,73323,aw9MeSsEIWZfCoZa5WIkU4GBvdkWhDfh,3VkHkmOtom3jM2wCu94xgzzu1d6Dn7or,11,12,3,2,4,3,6,1,31,4.428571428571429,1,0.0,6,3,2,4,6,3,0,6,1,15,16,1
8162,73326,ew3k1siBazVRlKYAMIZfWGnoLOHfg9SB,3VkHkmOtom3jM2wCu94xgzzu1d6Dn7or,1,0,0,0,0,0,1,0,1,0.14285714285714285,1,0.0,0,0,0,0,0,0,0,1,0,0,1,1
8163,73329,ypKJEOq9RE42Wyx4cHfMNATFPWvLrFfM,3VkHkmOtom3jM2wCu94xgzzu1d6Dn7or,4,3,0,0,2,0,1,0,6,0.8571428571428571,2,0.0,0,0,0,2,3,0,0,1,0,2,4,1
8164,73330,sJThH3sI3ghUBWEkkF5jl318HrGCcG4Q,3VkHkmOtom3jM2wCu94xgzzu1d6Dn7or,1,0,0,0,0,0,1,0,1,0.14285714285714285,1,0.0,0,0,0,0,0,0,0,1,0,0,1,1
8165,73331,d0cUzfZkyBQPnCP3CKMyAuE9ljoEyP7U,3VkHkmOtom3jM2wCu94xgzzu1d6Dn7or,2,0,0,0,0,0,7,0,7,1.0,1,0.0,0,0,0,0,0,0,0,7,0,0,7,1
8166,73336,0nzLNSkxmYEImF1RMACgDuDcQYA8Ty7I,3VkHkmOtom3jM2wCu94xgzzu1d6Dn7or,7,2,1,0,1,0,8,1,13,1.8571428571428572,1,0.0,0,1,0,1,2,0,0,8,1,2,11,0
8167,73338,z4eEpbgnGWvaRZq0NVRTsnBVWbViFEhI,3VkHkmOtom3jM2wCu94xgzzu1d6Dn7or,13,57,16,4,14,8,6,0,105,15.0,2,0.0,32,16,4,14,25,8,0,6,0,66,39,0
8168,73347,H3Qc07G9YgX2wzdRP9apJtdIeiQH3Zm6,3VkHkmOtom3jM2wCu94xgzzu1d6Dn7or,7,3,2,0,2,0,2,0,9,1.2857142857142858,1,0.0,0,2,0,2,3,0,0,2,0,4,5,1
8169,73350,6OFnO0TDkR1wK489Hvzp4brUZCtZaDg6,3VkHkmOtom3jM2wCu94xgzzu1d6Dn7or,6,5,2,0,1,0,2,0,10,1.4285714285714286,1,0.0,1,2,0,1,4,0,0,2,0,4,6,1
8170,73351,OOgcDcjl9MAxdL96TG7mngPkNaGdTZN2,3VkHkmOtom3jM2wCu94xgzzu1d6Dn7or,5,2,1,0,1,0,2,0,6,0.8571428571428571,1,0.0,0,1,0,1,2,0,0,2,0,2,4,1
8171,73365,LQ6QnottBcqSXxkN4WKfnfY5e6SCiNG8,3VkHkmOtom3jM2wCu94xgzzu1d6Dn7or,49,79,36,33,19,60,11,0,238,34.0,3,0.0,24,36,28,19,55,60,5,11,0,107,131,1
8172,73368,CfKWJuXe1mLbJ87shgFKw4nso72JeAvS,3VkHkmOtom3jM2wCu94xgzzu1d6Dn7or,9,9,4,0,1,0,3,0,17,2.4285714285714284,1,0.0,1,4,0,1,8,0,0,3,0,6,11,1
8173,73370,p2EA4v3RuditCgTzshojYPIesin9VTov,3VkHkmOtom3jM2wCu94xgzzu1d6Dn7or,1,0,0,0,0,0,1,0,1,0.14285714285714285,1,0.0,0,0,0,0,0,0,0,1,0,0,1,1
8174,73373,PNltRKReLHuKml6LKXYu0Xf2LLMAke1h,3VkHkmOtom3jM2wCu94xgzzu1d6Dn7or,10,27,3,8,1,5,8,0,52,7.428571428571429,3,0.0,5,3,7,1,22,5,1,8,0,16,36,1
8175,73375,U403WYn6adN6B92pqyV94lVDVY5X6ogV,3VkHkmOtom3jM2wCu94xgzzu1d6Dn7or,6,4,0,0,1,4,4,0,13,1.8571428571428572,2,0.0,0,0,0,1,4,4,0,4,0,1,12,1
8176,73377,2sabJnPZ4PXIGS9Rc16i9z5l9q3qU9rM,3VkHkmOtom3jM2wCu94xgzzu1d6Dn7or,3,1,0,0,0,0,4,0,5,0.7142857142857143,1,0.0,0,0,0,0,1,0,0,4,0,0,5,1
8177,73379,J7W6xcofEG9wJ5LyqIeV5vIUzD2pB5WC,3VkHkmOtom3jM2wCu94xgzzu1d6Dn7or,1,0,0,0,0,0,1,0,1,0.14285714285714285,1,0.0,0,0,0,0,0,0,0,1,0,0,1,1
8178,73381,JBNqk6tHCptThSrUPGNncjudftwyc1Qa,3VkHkmOtom3jM2wCu94xgzzu1d6Dn7or,23,23,9,8,10,7,6,0,63,9.0,1,0.0,12,9,7,10,11,7,1,6,0,38,25,1
8179,73383,UXHhCclAWBH32N4igbYPUq4G6i6kR7iM,3VkHkmOtom3jM2wCu94xgzzu1d6Dn7or,1,0,0,0,0,0,1,0,1,0.14285714285714285,1,0.0,0,0,0,0,0,0,0,1,0,0,1,1
8180,73390,kEwU45XSSuvWpEXuhbk6x6UaLxfQaNpY,3VkHkmOtom3jM2wCu94xgzzu1d6Dn7or,14,41,8,7,16,8,9,0,89,12.714285714285714,1,0.0,30,8,6,16,11,8,1,9,0,60,29,1
8181,73395,jZLnB03LZukvKcwsPqLRnttNusWPzKTZ,3VkHkmOtom3jM2wCu94xgzzu1d6Dn7or,1,0,0,0,0,0,1,0,1,0.14285714285714285,1,0.0,0,0,0,0,0,0,0,1,0,0,1,1
8182,73396,XqsuHAQKifUs35GJxJ1REsoDVf3OuLM6,3VkHkmOtom3jM2wCu94xgzzu1d6Dn7or,8,14,0,0,4,0,1,0,19,2.7142857142857144,1,0.0,3,0,0,4,11,0,0,1,0,7,12,1
8183,73397,POKigF1JShaOhcT7DH0E1Hkp0z55XQt7,3VkHkmOtom3jM2wCu94xgzzu1d6Dn7or,7,3,1,0,1,0,10,1,16,2.2857142857142856,1,0.0,0,1,0,1,3,0,0,10,1,2,14,1
8184,73399,OiuAOUQG29pszkR2iKfcV8sG5Cg92o35,3VkHkmOtom3jM2wCu94xgzzu1d6Dn7or,3,0,0,0,0,0,4,0,4,0.5714285714285714,1,0.0,0,0,0,0,0,0,0,4,0,0,4,1
8185,73402,88eLwCwXXMwwcoLppijnhIqGvr97TfWn,3VkHkmOtom3jM2wCu94xgzzu1d6Dn7or,4,2,1,0,1,0,3,0,7,1.0,1,0.0,0,1,0,1,2,0,0,3,0,2,5,1
8186,73405,hoVo7u7rh07n0uhmHsy18WyqrTVbWA1n,3VkHkmOtom3jM2wCu94xgzzu1d6Dn7or,6,5,3,0,1,2,4,0,15,2.142857142857143,1,0.0,0,3,0,1,5,2,0,4,0,4,11,1
8187,73409,a9zMpUuN718aAcGP1EnMBC7Ro0fc7OKl,3VkHkmOtom3jM2wCu94xgzzu1d6Dn7or,2,0,0,0,0,0,4,0,4,0.5714285714285714,1,0.0,0,0,0,0,0,0,0,4,0,0,4,1
8188,73411,PFDEsyWOjv2IVOUp45n5YkUolkzEQhjf,3VkHkmOtom3jM2wCu94xgzzu1d6Dn7or,11,27,8,2,5,8,11,0,61,8.714285714285714,2,0.0,10,8,2,5,17,8,0,11,0,25,36,1
8189,73414,77F1RO7O8svYgHwWT72gjb22PFV7YHFl,3VkHkmOtom3jM2wCu94xgzzu1d6Dn7or,51,76,43,0,30,0,6,0,155,22.142857142857142,3,0.0,0,43,0,30,76,0,0,6,0,73,82,0
8190,73430,WRFWp197Rw0PrJwMqyaDiKOKO3BhjRAN,3VkHkmOtom3jM2wCu94xgzzu1d6Dn7or,11,27,11,4,7,5,20,2,76,10.857142857142858,3,0.0,9,11,3,7,18,5,1,20,2,30,46,1
8191,73431,G2pgwXLjCYqfE1x9Y8KlRWhczaPYTf1b,3VkHkmOtom3jM2wCu94xgzzu1d6Dn7or,1,0,0,0,0,0,1,0,1,0.14285714285714285,1,0.0,0,0,0,0,0,0,0,1,0,0,1,1
8192,73498,BXEKxoXoxulJe6lVUNmBzkuoxML0RzPQ,fbPkOYLVPtPgIt0MxizjfFJov3JbHyAi,7,3,2,0,2,0,3,0,10,1.4285714285714286,1,0.0,0,2,0,2,3,0,0,3,0,4,6,1
8193,73499,jUIr9wOMURctG2Xi2g3BgjMkOiapnsO1,fbPkOYLVPtPgIt0MxizjfFJov3JbHyAi,28,35,12,23,11,0,4,0,85,12.142857142857142,1,0.0,13,12,19,11,22,0,4,4,0,55,30,0
8194,73500,m7jLYh84m9f53uDPmmpRCKYuGkwpenOB,fbPkOYLVPtPgIt0MxizjfFJov3JbHyAi,9,8,3,0,2,0,4,0,17,2.4285714285714284,2,0.0,2,3,0,2,6,0,0,4,0,7,10,1
8195,73501,s2PAlsYP8d4801r4Nm3R5kEQLZkO3n8P,fbPkOYLVPtPgIt0MxizjfFJov3JbHyAi,7,12,3,0,3,0,9,0,27,3.857142857142857,1,0.0,0,3,0,3,12,0,0,9,0,6,21,1
8196,73503,X4CLNdDMr0iaKybdAdeBwRFlzkg01KOk,fbPkOYLVPtPgIt0MxizjfFJov3JbHyAi,11,13,5,4,4,1,10,1,38,5.428571428571429,2,0.0,5,5,3,4,8,1,1,10,1,17,21,1
8197,73507,DBQ1f2dZLi3kL265Xk9L0uxAjzEo29LF,fbPkOYLVPtPgIt0MxizjfFJov3JbHyAi,7,3,2,0,2,0,2,0,9,1.2857142857142858,1,0.0,0,2,0,2,3,0,0,2,0,4,5,1
8198,73510,nKMPTOF6v1sp7aVmO78zmSRg9f9QXrTf,fbPkOYLVPtPgIt0MxizjfFJov3JbHyAi,7,3,2,0,2,0,2,0,9,1.2857142857142858,1,0.0,0,2,0,2,3,0,0,2,0,4,5,1
8199,73512,EKW68EVipwDnVj4OACaFT183WfWiotRr,fbPkOYLVPtPgIt0MxizjfFJov3JbHyAi,9,22,8,0,9,0,6,0,45,6.428571428571429,2,0.0,8,8,0,9,14,0,0,6,0,25,20,1
8200,73513,vwRRndtOgDNgC1JYZP9PwFq6QjfnEInC,fbPkOYLVPtPgIt0MxizjfFJov3JbHyAi,8,5,4,0,4,2,5,0,20,2.857142857142857,1,0.0,0,4,0,4,5,2,0,5,0,8,12,1
8201,73514,eAreSTsX7Dih2J54vyrFl8ByPnikZNX4,fbPkOYLVPtPgIt0MxizjfFJov3JbHyAi,49,84,38,35,24,75,21,2,279,39.857142857142854,6,0.0,28,38,30,24,56,75,5,21,2,120,159,0
8202,73515,VTfyca7HGDJyi22ZKM6n3Dsdq6SoCZin,fbPkOYLVPtPgIt0MxizjfFJov3JbHyAi,4,2,1,0,0,0,4,0,7,1.0,1,0.0,0,1,0,0,2,0,0,4,0,1,6,1
8203,73517,laUhtb4TTvpYCULEO93ntEWHn8S6WSjL,fbPkOYLVPtPgIt0MxizjfFJov3JbHyAi,2,0,0,0,0,0,5,0,5,0.7142857142857143,1,0.0,0,0,0,0,0,0,0,5,0,0,5,1
8204,73521,tZsZwfZKEwgih9HC8eRqwpFt6sEwssno,fbPkOYLVPtPgIt0MxizjfFJov3JbHyAi,12,14,7,0,5,0,5,0,31,4.428571428571429,2,0.0,0,7,0,5,14,0,0,5,0,12,19,0
8205,73522,FXBGUXiMXMIDn9Ik7DDYbKq9pN9kTETb,fbPkOYLVPtPgIt0MxizjfFJov3JbHyAi,1,0,0,0,0,0,1,0,1,0.14285714285714285,1,0.0,0,0,0,0,0,0,0,1,0,0,1,1
8206,73523,tL1jjw7cf7YKbbngDtAe9kyoMEQ67AIr,fbPkOYLVPtPgIt0MxizjfFJov3JbHyAi,1,0,0,0,0,0,1,0,1,0.14285714285714285,1,0.0,0,0,0,0,0,0,0,1,0,0,1,1
8207,73524,iZKyUn2tYUQ1sJ0MQmmHDINTc5EMQvaW,fbPkOYLVPtPgIt0MxizjfFJov3JbHyAi,5,3,1,0,1,0,2,0,7,1.0,1,0.0,0,1,0,1,3,0,0,2,0,2,5,1
8208,73527,QWcNKnNsoo8fIdhMS0KLQpCh2c21RSQ4,fbPkOYLVPtPgIt0MxizjfFJov3JbHyAi,7,7,0,6,0,0,3,0,16,2.2857142857142856,1,0.0,1,0,5,0,6,0,1,3,0,6,10,1
8209,73530,v8MmiOrUSSFRN5yML1Gtv18HNGm2mHOy,fbPkOYLVPtPgIt0MxizjfFJov3JbHyAi,6,24,0,0,1,0,5,0,30,4.285714285714286,2,0.0,5,0,0,1,19,0,0,5,0,6,24,1
8210,73531,8FaiBxOZwTPPSCqh3zE727iJIkEkB2sH,fbPkOYLVPtPgIt0MxizjfFJov3JbHyAi,1,0,0,0,0,0,1,0,1,0.14285714285714285,1,0.0,0,0,0,0,0,0,0,1,0,0,1,1
8211,73532,7VsczNppAvXZ8ck0uavEfxlQU3FSAWxI,fbPkOYLVPtPgIt0MxizjfFJov3JbHyAi,10,3,2,0,2,2,8,2,19,2.7142857142857144,1,0.0,0,2,0,2,3,2,0,8,2,4,15,1
8212,73533,8QVzbiM59wokmwQi18hR506gdYJvXMvd,fbPkOYLVPtPgIt0MxizjfFJov3JbHyAi,1,0,0,0,0,0,1,0,1,0.14285714285714285,1,0.0,0,0,0,0,0,0,0,1,0,0,1,1
8213,73534,RrfIBAHL7YP1AFgCuF5PBiTyJdzDN7Zs,fbPkOYLVPtPgIt0MxizjfFJov3JbHyAi,2,0,0,0,0,0,2,0,2,0.2857142857142857,1,0.0,0,0,0,0,0,0,0,2,0,0,2,1
8214,73535,WokDRYxJvEaGKxTY44u78VwJKvy9EFw3,fbPkOYLVPtPgIt0MxizjfFJov3JbHyAi,1,0,0,0,0,0,1,0,1,0.14285714285714285,1,0.0,0,0,0,0,0,0,0,1,0,0,1,1
8215,73537,i4WrJL8oW0eRfAXMn0ZgMZhPoessUNnF,fbPkOYLVPtPgIt0MxizjfFJov3JbHyAi,5,2,1,0,1,0,2,0,6,0.8571428571428571,1,0.0,0,1,0,1,2,0,0,2,0,2,4,1
8216,73538,YbXDR0OWqjazkhydYVY2vq3vuaW6LGOY,fbPkOYLVPtPgIt0MxizjfFJov3JbHyAi,6,6,2,0,2,0,1,0,11,1.5714285714285714,1,0.0,0,2,0,2,6,0,0,1,0,4,7,1
8217,73540,i0UAMwrjj2eXydsjRtQeHBmAMB3Ngwx3,fbPkOYLVPtPgIt0MxizjfFJov3JbHyAi,7,9,3,0,3,0,2,0,17,2.4285714285714284,1,0.0,2,3,0,3,7,0,0,2,0,8,9,1
8218,73541,eVwpauOF6qjJLEmGvNpHpCiI8NiIhc0t,fbPkOYLVPtPgIt0MxizjfFJov3JbHyAi,20,17,11,3,9,53,8,1,102,14.571428571428571,2,0.0,3,11,3,9,14,53,0,8,1,26,76,1
8219,73544,bR1FbD3FkuJiVcTAr5M8EJyKKJMKvGAe,fbPkOYLVPtPgIt0MxizjfFJov3JbHyAi,4,2,1,0,1,0,1,0,5,0.7142857142857143,1,0.0,0,1,0,1,2,0,0,1,0,2,3,1
8220,73547,rpuvJtcoGSYgL65FrFGnvZ4Z1q1X7W9y,fbPkOYLVPtPgIt0MxizjfFJov3JbHyAi,5,2,0,0,0,1,5,1,9,1.2857142857142858,1,0.0,0,0,0,0,2,1,0,5,1,0,9,1
8221,73548,gV4fAWOeRtYhHlLz6So4slTP8BWQUEo3,fbPkOYLVPtPgIt0MxizjfFJov3JbHyAi,7,5,2,0,2,0,2,0,11,1.5714285714285714,1,0.0,0,2,0,2,5,0,0,2,0,4,7,1
8222,73551,tpXvTahACNQY51r2DDxBjRZh56EvpTZe,fbPkOYLVPtPgIt0MxizjfFJov3JbHyAi,10,23,7,0,6,3,13,1,53,7.571428571428571,2,0.0,12,7,0,6,11,3,0,13,1,25,28,1
8223,73557,Yzsn36CkmAU2tRNso83yQ89Xcjxcxh0w,3VkHkmOtom3jM2wCu94xgzzu1d6Dn7or,1,0,0,0,0,0,2,0,2,0.2857142857142857,1,0.0,0,0,0,0,0,0,0,2,0,0,2,1
8224,73558,fzGEHOQW3CMmJ4kaYSTYf0w9UbXUQwzz,3VkHkmOtom3jM2wCu94xgzzu1d6Dn7or,6,2,1,0,1,0,5,0,9,1.2857142857142858,1,0.0,0,1,0,1,2,0,0,5,0,2,7,1
8225,73564,YwdsRsHYervYLk48Gr1hWkSfDceYJsi1,3VkHkmOtom3jM2wCu94xgzzu1d6Dn7or,1,0,0,0,0,0,1,0,1,0.14285714285714285,1,0.0,0,0,0,0,0,0,0,1,0,0,1,1
8226,73568,eN3Zet0tDUonovGa1sjqSTY5JzjDSKDq,3VkHkmOtom3jM2wCu94xgzzu1d6Dn7or,1,0,0,0,0,0,2,0,2,0.2857142857142857,1,0.0,0,0,0,0,0,0,0,2,0,0,2,1
8227,73570,QFHxVjsAGU64l3hz86aP74VatqKFjBXV,3VkHkmOtom3jM2wCu94xgzzu1d6Dn7or,1,0,0,0,0,0,1,0,1,0.14285714285714285,1,0.0,0,0,0,0,0,0,0,1,0,0,1,1
8228,73576,DznZsrasCl121bzuiSvVlMZs4RV0IyV5,3VkHkmOtom3jM2wCu94xgzzu1d6Dn7or,7,4,2,0,2,0,3,0,11,1.5714285714285714,2,0.0,1,2,0,2,3,0,0,3,0,5,6,1
8229,73578,ZfbqOFx366o4C78cVKBouX7RxiryNTnP,3VkHkmOtom3jM2wCu94xgzzu1d6Dn7or,6,4,1,0,1,2,3,0,11,1.5714285714285714,1,0.0,1,1,0,1,3,2,0,3,0,3,8,1
8230,73579,S27JhtzYyRNpLDsNSMCoEIRcs2ozc9Ah,3VkHkmOtom3jM2wCu94xgzzu1d6Dn7or,10,11,5,0,4,0,4,0,24,3.4285714285714284,2,0.0,0,5,0,4,11,0,0,4,0,9,15,1
8231,73583,HoSlBbgDrkYdbJ8NcV5YnNuNMzJ22m0Z,3VkHkmOtom3jM2wCu94xgzzu1d6Dn7or,7,2,1,0,1,3,6,0,13,1.8571428571428572,1,0.0,0,1,0,1,2,3,0,6,0,2,11,1
8232,73586,0jTYZbiBUtN5SUb8tVJAxbA0onn41X8V,3VkHkmOtom3jM2wCu94xgzzu1d6Dn7or,36,130,50,34,42,90,22,4,372,53.142857142857146,8,0.0,59,50,29,42,71,90,5,22,4,180,192,1
8233,73587,hvSJqWbsVNQOjwtetsJMg8BhdysZrLgZ,3VkHkmOtom3jM2wCu94xgzzu1d6Dn7or,5,2,1,0,1,0,5,0,9,1.2857142857142858,2,0.0,0,1,0,1,2,0,0,5,0,2,7,1
8234,73591,fqjLnH3OTCihOU2gsb0OSNI1dFNVFkLM,3VkHkmOtom3jM2wCu94xgzzu1d6Dn7or,1,0,0,0,0,0,1,0,1,0.14285714285714285,1,0.0,0,0,0,0,0,0,0,1,0,0,1,1
8235,73593,2kMQkfKYMlhaU4UM5pB8xmNc8uChRuw1,3VkHkmOtom3jM2wCu94xgzzu1d6Dn7or,4,2,1,0,1,0,1,0,5,0.7142857142857143,1,0.0,0,1,0,1,2,0,0,1,0,2,3,1
8236,73595,0UkKiJ9OhWT6zFcmUkOiRpAWLzDgAour,3VkHkmOtom3jM2wCu94xgzzu1d6Dn7or,4,2,1,0,0,0,2,0,5,0.7142857142857143,1,0.0,0,1,0,0,2,0,0,2,0,1,4,1
8237,73597,bAGLARNkQtWbcEXtBHWNuY2QpKiztkKZ,3VkHkmOtom3jM2wCu94xgzzu1d6Dn7or,4,2,0,0,0,0,2,0,4,0.5714285714285714,1,0.0,0,0,0,0,2,0,0,2,0,0,4,1
8238,73600,oASR1hbK6DD6OJfTJCDKLW9l2vPgw7kR,3VkHkmOtom3jM2wCu94xgzzu1d6Dn7or,52,90,42,34,41,4,10,0,221,31.571428571428573,7,0.0,34,42,31,41,56,4,3,10,0,148,73,0
8239,73605,TqVhoyEhTvvU2Hxdt7bwVMSeybZuSUDA,3VkHkmOtom3jM2wCu94xgzzu1d6Dn7or,8,4,1,0,2,0,9,1,17,2.4285714285714284,1,0.0,2,1,0,2,2,0,0,9,1,5,12,1
8240,73607,TRaddyVLpovw0vItvxbFjdLiscv12LDo,3VkHkmOtom3jM2wCu94xgzzu1d6Dn7or,1,0,0,0,0,0,1,0,1,0.14285714285714285,1,0.0,0,0,0,0,0,0,0,1,0,0,1,1
8241,73614,ZOes1wSnhBEEvg5nvcw1hU2VWw7GcGX5,3VkHkmOtom3jM2wCu94xgzzu1d6Dn7or,1,0,0,0,0,0,1,0,1,0.14285714285714285,1,0.0,0,0,0,0,0,0,0,1,0,0,1,1
8242,73624,qxcCVatBg3ma615T1vZP9a3vFceHZOma,3VkHkmOtom3jM2wCu94xgzzu1d6Dn7or,8,6,0,0,2,2,9,1,20,2.857142857142857,1,0.0,2,0,0,2,4,2,0,9,1,4,16,1
8243,73626,levomtYcyu0jXhNQAYAyEq8Zo7sAVLzz,3VkHkmOtom3jM2wCu94xgzzu1d6Dn7or,1,0,0,0,0,0,1,0,1,0.14285714285714285,1,0.0,0,0,0,0,0,0,0,1,0,0,1,1
8244,73627,jllL9C8ZwJmzJRJlHKabdnhUdXuzRtYK,3VkHkmOtom3jM2wCu94xgzzu1d6Dn7or,25,60,28,25,21,13,25,0,172,24.571428571428573,5,0.0,24,28,20,21,36,13,5,25,0,93,79,1
8245,73628,OnRz7QBZqhddyAYZRHKVJ7GgqyS3ZVya,3VkHkmOtom3jM2wCu94xgzzu1d6Dn7or,10,12,4,0,4,10,3,1,34,4.857142857142857,2,0.0,3,4,0,4,9,10,0,3,1,11,23,1
8246,73629,AxjnmzIKgGmkrYUGKQPeh9c8x0m6gyxX,3VkHkmOtom3jM2wCu94xgzzu1d6Dn7or,5,2,1,0,1,0,3,0,7,1.0,1,0.0,0,1,0,1,2,0,0,3,0,2,5,1
8247,73633,gu2GQiSVSAGd0yPDejQCvhAaMLANJqDZ,3VkHkmOtom3jM2wCu94xgzzu1d6Dn7or,4,2,1,0,1,0,1,0,5,0.7142857142857143,1,0.0,0,1,0,1,2,0,0,1,0,2,3,1
8248,73635,tRemMYZPILwjc4AN7PAQTdy7le7m6gBS,3VkHkmOtom3jM2wCu94xgzzu1d6Dn7or,8,6,2,0,2,0,6,1,17,2.4285714285714284,1,0.0,2,2,0,2,4,0,0,6,1,6,11,1
8249,73637,USvxkIKrz0rKsL2Ss0F5K20ol7w9dVqK,3VkHkmOtom3jM2wCu94xgzzu1d6Dn7or,6,4,1,0,2,0,1,0,8,1.1428571428571428,1,0.0,0,1,0,2,4,0,0,1,0,3,5,1
8250,73639,ioGIIvGBcofeTW0x1FXR4tnlONjci6Gc,3VkHkmOtom3jM2wCu94xgzzu1d6Dn7or,56,75,25,55,31,5,11,1,203,29.0,3,0.0,44,25,43,31,31,5,12,11,1,143,60,0
8251,73645,grX5gXClHAQGBsyiB0gWgR5pFtsTwOAy,3VkHkmOtom3jM2wCu94xgzzu1d6Dn7or,11,14,4,7,2,7,14,1,49,7.0,3,0.0,4,4,5,2,10,7,2,14,1,15,34,1
8252,73646,5nRWWgpq05OOATwbRqwqxsA7k9Zu5So4,3VkHkmOtom3jM2wCu94xgzzu1d6Dn7or,10,9,2,0,2,0,10,0,23,3.2857142857142856,5,0.0,0,2,0,2,9,0,0,10,0,4,19,1
8253,73653,OwlSBFN2Y2Jw9zVSj4JyOO1C4mU3Pq74,3VkHkmOtom3jM2wCu94xgzzu1d6Dn7or,1,0,0,0,0,0,2,0,2,0.2857142857142857,1,0.0,0,0,0,0,0,0,0,2,0,0,2,1
8254,73655,GDn0bSNUJ7FW4llVrh1uR3Awm3DznlZj,3VkHkmOtom3jM2wCu94xgzzu1d6Dn7or,8,11,5,0,1,1,6,1,25,3.5714285714285716,1,0.0,3,5,0,1,8,1,0,6,1,9,16,1
8255,73657,oKLMQAZTIOtP37CLM9yXiFLXKHfYljGQ,3VkHkmOtom3jM2wCu94xgzzu1d6Dn7or,4,3,0,0,0,0,2,0,5,0.7142857142857143,1,0.0,0,0,0,0,3,0,0,2,0,0,5,1
8256,73675,3fxWMQqTEtfXx3DdUjBp1Fv5awszMakP,3VkHkmOtom3jM2wCu94xgzzu1d6Dn7or,1,0,0,0,0,0,1,0,1,0.14285714285714285,1,0.0,0,0,0,0,0,0,0,1,0,0,1,1
8257,73680,j1j8kUymAdn1VrqsKmht4D0bf9Tk67Ru,3VkHkmOtom3jM2wCu94xgzzu1d6Dn7or,1,0,0,0,0,0,1,0,1,0.14285714285714285,1,0.0,0,0,0,0,0,0,0,1,0,0,1,1
8258,73683,O5FAv2WJ9y2Iw3ydNqVb8wtG4rpJE8Qp,3VkHkmOtom3jM2wCu94xgzzu1d6Dn7or,7,17,5,0,1,0,10,1,34,4.857142857142857,5,0.0,1,5,0,1,16,0,0,10,1,7,27,1
8259,73688,nX93ZghoVHJD8uU67SJIJwZVR9wM1iWY,3VkHkmOtom3jM2wCu94xgzzu1d6Dn7or,6,2,1,0,1,0,7,0,11,1.5714285714285714,1,0.0,0,1,0,1,2,0,0,7,0,2,9,1
8260,73691,noRaQFZPOfDInGxZhdSk6IgkoFtqEtNn,3VkHkmOtom3jM2wCu94xgzzu1d6Dn7or,52,136,82,84,0,9,28,2,341,48.714285714285715,5,0.0,40,82,81,0,96,9,3,28,2,203,138,1
8261,73697,lVBDM3g8iTGKPEQ3t1UDfl5jfI2Cil4F,3VkHkmOtom3jM2wCu94xgzzu1d6Dn7or,29,106,23,33,35,12,18,0,227,32.42857142857143,4,0.0,71,23,26,35,35,12,7,18,0,155,72,1
8262,73698,UV1snD7DHa55OZjQRgIzYu36CkzlZ6ST,3VkHkmOtom3jM2wCu94xgzzu1d6Dn7or,1,0,0,0,0,0,1,0,1,0.14285714285714285,1,0.0,0,0,0,0,0,0,0,1,0,0,1,1
8263,73705,jaeRBfNSkyTpFxAZieHe5vTAkzlHFDmm,3VkHkmOtom3jM2wCu94xgzzu1d6Dn7or,1,0,0,0,0,0,1,0,1,0.14285714285714285,1,0.0,0,0,0,0,0,0,0,1,0,0,1,1
8264,73706,7BhCQDTKWRWZRyFrvifBoDnXkJRzN5Pt,3VkHkmOtom3jM2wCu94xgzzu1d6Dn7or,9,6,3,0,1,4,8,1,23,3.2857142857142856,3,0.0,0,3,0,1,6,4,0,8,1,4,19,0
8265,73708,SksEDKlyixx27wQZiWmCVYK1viWs7FrA,3VkHkmOtom3jM2wCu94xgzzu1d6Dn7or,9,13,8,0,3,0,6,0,30,4.285714285714286,6,0.0,0,8,0,3,13,0,0,6,0,11,19,0
8266,73714,R2bsNKaCyFNpEJtfIBR7wHhqazhTieVv,3VkHkmOtom3jM2wCu94xgzzu1d6Dn7or,70,104,55,4,43,3,22,2,233,33.285714285714285,13,0.0,9,55,3,43,95,3,1,22,2,110,123,0
8267,73718,XE05vZThEHf17O6FM08AySNf2qZFgNWa,3VkHkmOtom3jM2wCu94xgzzu1d6Dn7or,81,309,24,79,28,2,20,1,463,66.14285714285714,12,0.0,130,24,73,28,179,2,6,20,1,255,208,0
8268,73719,0BKRUeE2TrhxWjSTfZlj7IOKQoZxuJ28,3VkHkmOtom3jM2wCu94xgzzu1d6Dn7or,12,20,5,0,3,5,8,0,41,5.857142857142857,1,0.0,8,5,0,3,12,5,0,8,0,16,25,1
8269,73720,KV4xz4xdX7GojXxeuOHbrKNDm7dYrhhj,3VkHkmOtom3jM2wCu94xgzzu1d6Dn7or,3,0,0,0,0,0,5,0,5,0.7142857142857143,2,0.0,0,0,0,0,0,0,0,5,0,0,5,1
8270,73722,Uf4GWOA8sESCXDRwOHzGljTp0FT7AFg9,3VkHkmOtom3jM2wCu94xgzzu1d6Dn7or,1,0,0,0,0,0,1,0,1,0.14285714285714285,1,0.0,0,0,0,0,0,0,0,1,0,0,1,1
8271,73724,Jz6wD2B02Np9coR4hOXdRVlsstbtLmqi,3VkHkmOtom3jM2wCu94xgzzu1d6Dn7or,1,0,0,0,0,0,1,0,1,0.14285714285714285,1,0.0,0,0,0,0,0,0,0,1,0,0,1,1
8272,73729,ypGCuSMoTu4jFEklb1OmiXvUyZSt3GFy,3VkHkmOtom3jM2wCu94xgzzu1d6Dn7or,10,37,0,1,0,17,8,0,63,9.0,3,0.0,6,0,1,0,31,17,0,8,0,7,56,1
8273,73730,q1QFOwEyQ18luVjxvJy17HxosFEdu2Cn,3VkHkmOtom3jM2wCu94xgzzu1d6Dn7or,57,144,40,69,56,44,2,0,355,50.714285714285715,7,0.0,92,40,64,56,52,44,5,2,0,252,103,0
8274,73731,NeUM2mSh0PreOuQDOFlmpSqC0DHTLWRd,3VkHkmOtom3jM2wCu94xgzzu1d6Dn7or,1,0,0,0,0,0,1,0,1,0.14285714285714285,1,0.0,0,0,0,0,0,0,0,1,0,0,1,1
8275,73732,PtoknOk588UciqjaSaRFarSWUL7CQGqd,3VkHkmOtom3jM2wCu94xgzzu1d6Dn7or,5,4,2,0,2,0,1,0,9,1.2857142857142858,1,0.0,0,2,0,2,4,0,0,1,0,4,5,1
8276,73733,rqqNQl0bghaqvkPV1u2C08foWzi8FdRA,3VkHkmOtom3jM2wCu94xgzzu1d6Dn7or,9,26,4,2,7,3,4,0,46,6.571428571428571,2,0.0,18,4,2,7,8,3,0,4,0,31,15,1
8277,73736,Q0CA1Q4hyAUuIpB1kk41n5xq9eQN0zwO,3VkHkmOtom3jM2wCu94xgzzu1d6Dn7or,1,0,0,0,0,0,1,0,1,0.14285714285714285,1,0.0,0,0,0,0,0,0,0,1,0,0,1,1
8278,73742,ovvuiEhj0QBv4xi11GVjXr8JhlCgaPmd,3VkHkmOtom3jM2wCu94xgzzu1d6Dn7or,60,182,31,109,92,26,24,1,465,66.42857142857143,5,0.0,145,31,102,92,37,26,7,24,1,370,95,0
8279,73744,zA8CqP1kZ0TZq4hxCbq0AkMFv6jDXluo,3VkHkmOtom3jM2wCu94xgzzu1d6Dn7or,5,2,1,0,1,0,3,0,7,1.0,1,0.0,0,1,0,1,2,0,0,3,0,2,5,1
8280,73746,GYoy1HdvsO4mH1bXnkMB7sEyOCz7rANY,3VkHkmOtom3jM2wCu94xgzzu1d6Dn7or,25,87,28,15,29,29,17,4,209,29.857142857142858,5,0.0,40,28,13,29,47,29,2,17,4,110,99,1
8281,73753,VgAtbYSZPQjOfrclLC6CaD7nhsX1iFFP,3VkHkmOtom3jM2wCu94xgzzu1d6Dn7or,1,0,0,0,0,0,1,0,1,0.14285714285714285,1,0.0,0,0,0,0,0,0,0,1,0,0,1,1
8282,73756,VkLxnN54Rw5zM8b687K5ZIPiSzMio4QS,3VkHkmOtom3jM2wCu94xgzzu1d6Dn7or,1,0,0,0,0,0,2,0,2,0.2857142857142857,1,0.0,0,0,0,0,0,0,0,2,0,0,2,1
8283,73763,isREfnusXioFlXK1R4tw2vT4IosRAXVA,3VkHkmOtom3jM2wCu94xgzzu1d6Dn7or,5,8,5,0,3,0,3,0,19,2.7142857142857144,3,0.0,0,5,0,3,8,0,0,3,0,8,11,1
8284,73764,GGioMvSJ2TI5A4koIk2G8ocfb1Yz1YTO,3VkHkmOtom3jM2wCu94xgzzu1d6Dn7or,5,2,1,0,1,0,2,0,6,0.8571428571428571,1,0.0,0,1,0,1,2,0,0,2,0,2,4,1
8285,73765,qTno0LLDbZSn2CC4rZpUMVqkfAX6tLBw,3VkHkmOtom3jM2wCu94xgzzu1d6Dn7or,13,19,9,0,4,1,10,2,45,6.428571428571429,1,0.0,5,9,0,4,14,1,0,10,2,18,27,1
8286,73770,SSlVryVbEN4dMdspRjPAIVHSt473LaJm,3VkHkmOtom3jM2wCu94xgzzu1d6Dn7or,4,5,0,0,0,0,2,0,7,1.0,2,0.0,0,0,0,0,5,0,0,2,0,0,7,1
8287,73771,90DzNf2idxHLgOYBCO0UTQn7scQMBICM,3VkHkmOtom3jM2wCu94xgzzu1d6Dn7or,5,2,1,0,1,0,2,0,6,0.8571428571428571,1,0.0,0,1,0,1,2,0,0,2,0,2,4,1
8288,73772,FbFzxcgOenGEHKMXxCSjDnrIiqrr6PFf,3VkHkmOtom3jM2wCu94xgzzu1d6Dn7or,1,0,0,0,0,0,2,0,2,0.2857142857142857,1,0.0,0,0,0,0,0,0,0,2,0,0,2,1
8289,73782,OqWMSgwiNNMZvnSrR3UUAymPPmQ5DtGr,3VkHkmOtom3jM2wCu94xgzzu1d6Dn7or,78,203,51,81,70,42,16,1,464,66.28571428571429,9,0.0,106,51,72,70,97,42,9,16,1,299,165,0
8290,73783,EChSttZSil8pQFLm0qImYXOhSqXem2dj,3VkHkmOtom3jM2wCu94xgzzu1d6Dn7or,83,187,54,83,71,5,19,3,422,60.285714285714285,7,0.0,116,54,74,71,71,5,9,19,3,315,107,0
8291,73786,Zay6nKuUKOZ7IwZcXRj8E7AQad8zDVUP,3VkHkmOtom3jM2wCu94xgzzu1d6Dn7or,7,3,1,1,0,13,8,0,26,3.7142857142857144,2,0.0,1,1,1,0,2,13,0,8,0,3,23,1
8292,73788,98r1yyZ02P5Yb7DOkeUA6eb8RHK6juvp,3VkHkmOtom3jM2wCu94xgzzu1d6Dn7or,4,0,0,0,0,4,4,0,8,1.1428571428571428,2,0.0,0,0,0,0,0,4,0,4,0,0,8,1
8293,73885,zlC9nEdRrqLSPX386Mctiz9fIdlU29GI,7GRhBDsirIGkRZBtSMEzNTyDr2JQm4xx,71,109,44,44,52,0,4,0,253,36.142857142857146,4,0.0,60,44,41,52,49,0,3,4,0,197,56,1
8294,73899,4hEMELZWHLOm7hvjgIF8HpEdrI7mKYR9,7GRhBDsirIGkRZBtSMEzNTyDr2JQm4xx,1,0,0,0,0,0,4,0,4,0.5714285714285714,1,0.0,0,0,0,0,0,0,0,4,0,0,4,1
8295,73902,ylROXg8giT8WUi6VCjfxuNTR05tI9pz4,RXDvfPUBYFlVdlueBFbLW0mhhAyGEqpt,8,3,2,0,2,0,3,0,10,1.4285714285714286,1,0.0,0,2,0,2,3,0,0,3,0,4,6,1
8296,73907,u40Wnz941IKPEKg6evh8MfJNEbnPlztD,7GRhBDsirIGkRZBtSMEzNTyDr2JQm4xx,1,0,0,0,0,0,1,0,1,0.14285714285714285,1,0.0,0,0,0,0,0,0,0,1,0,0,1,1
8297,73909,SQIuOWvxkt3YnLUzk8J5rhFP8qdbWUct,7GRhBDsirIGkRZBtSMEzNTyDr2JQm4xx,9,9,1,0,1,0,6,2,19,2.7142857142857144,1,0.0,4,1,0,1,5,0,0,6,2,6,13,1
8298,73914,nBvjxfottsOCrOycyCAN2ZrAK5pyyTJB,7GRhBDsirIGkRZBtSMEzNTyDr2JQm4xx,1,0,0,0,0,0,1,0,1,0.14285714285714285,1,0.0,0,0,0,0,0,0,0,1,0,0,1,1
8299,73920,Md9y03wRztv9cddm3W0J1vz80OlCJmEe,RXDvfPUBYFlVdlueBFbLW0mhhAyGEqpt,9,6,4,0,2,0,1,0,13,1.8571428571428572,1,0.0,0,4,0,2,6,0,0,1,0,6,7,1
8300,73925,QJJ8wBq7nom8t0h6F4ecboFqFhwa246L,7GRhBDsirIGkRZBtSMEzNTyDr2JQm4xx,1,0,0,0,0,0,2,0,2,0.2857142857142857,1,0.0,0,0,0,0,0,0,0,2,0,0,2,1
8301,73926,MrlzmdVJr5WOflJfAlRUbmdI8vfVUpTE,7GRhBDsirIGkRZBtSMEzNTyDr2JQm4xx,7,4,1,2,1,0,2,0,10,1.4285714285714286,1,0.0,1,1,2,1,3,0,0,2,0,5,5,1
8302,73937,28W5CJrYp73LQgjHivjzAixkCQuqTCh6,A3fsA9Zfv1X2fVEQhTw51lKENdNrEqT3,52,110,70,0,15,1,17,0,213,30.428571428571427,5,0.0,2,70,0,15,108,1,0,17,0,87,126,0
8303,73939,CQZYPowUu7Qz28eSyPodtf1cGcYnxZ3h,SpATywNh6bZuzm8s1ceuBUnMUAeoAHHw,15,32,2,25,2,0,4,0,65,9.285714285714286,2,0.0,17,2,20,2,15,0,5,4,0,41,24,1
8304,73941,vaBnFuKrFzaRvpuQOGO2KMutesPcXn34,SpATywNh6bZuzm8s1ceuBUnMUAeoAHHw,30,41,18,31,7,2,11,1,111,15.857142857142858,6,0.0,15,18,27,7,26,2,4,11,1,67,44,0
8305,73944,aCpcxbxbjQL3dCtVXBMdBsAJlz21Z4Ca,A3fsA9Zfv1X2fVEQhTw51lKENdNrEqT3,34,25,3,90,3,0,7,0,128,18.285714285714285,1,0.0,6,3,77,3,19,0,13,7,0,89,39,1
8306,73951,7nQB7cjVdr2HijR82OoX1oMRPa42JjfY,7GRhBDsirIGkRZBtSMEzNTyDr2JQm4xx,11,4,2,4,2,0,5,0,17,2.4285714285714284,1,0.0,1,2,3,2,3,0,1,5,0,8,9,1
8307,73952,wkO5wnAaXL3FXQv1NNUwzDWkbORgDBJo,A3fsA9Zfv1X2fVEQhTw51lKENdNrEqT3,4,3,1,0,0,0,2,0,6,0.8571428571428571,1,0.0,0,1,0,0,3,0,0,2,0,1,5,1
8308,73954,sUy7TGB2Hf96dZU6f73hwUBNPEtOfYuk,A3fsA9Zfv1X2fVEQhTw51lKENdNrEqT3,1,0,0,0,0,0,1,0,1,0.14285714285714285,1,0.0,0,0,0,0,0,0,0,1,0,0,1,1
8309,73970,j32U9Y949ZW1nXMwG0aPWZXCmluBzel9,7GRhBDsirIGkRZBtSMEzNTyDr2JQm4xx,3,4,1,0,0,0,2,0,7,1.0,2,0.0,0,1,0,0,4,0,0,2,0,1,6,1
8310,73971,LizXiJbJqGyJ8h2k4iCO24clMfax3bGH,A3fsA9Zfv1X2fVEQhTw51lKENdNrEqT3,40,26,1,56,0,9,17,1,110,15.714285714285714,1,0.0,1,1,50,0,25,9,6,17,1,52,58,1
8311,73972,fK0ybxlrUhmgrAr6gFQPIfSHLrJ4RdyL,7GRhBDsirIGkRZBtSMEzNTyDr2JQm4xx,27,49,16,32,12,0,10,0,119,17.0,1,0.0,27,16,29,12,22,0,3,10,0,84,35,1
8312,73975,YmZgT8JqU8nh2NPc6NVlnnDgPwwbycrT,SpATywNh6bZuzm8s1ceuBUnMUAeoAHHw,27,34,9,40,6,0,4,0,93,13.285714285714286,4,0.0,12,9,35,6,22,0,5,4,0,62,31,0
8313,73976,7mxOgTUP9lSjAUBOPZ9fhNEhVSHMvF2J,A3fsA9Zfv1X2fVEQhTw51lKENdNrEqT3,36,50,8,68,1,10,16,0,153,21.857142857142858,9,0.0,3,8,57,1,47,10,11,16,0,69,84,0
8314,73977,CaAAtghbZXcO6X5eGK5X6sBmcGDS3kOP,A3fsA9Zfv1X2fVEQhTw51lKENdNrEqT3,12,15,10,0,7,0,7,0,39,5.571428571428571,3,0.0,0,10,0,7,15,0,0,7,0,17,22,0
8315,73982,j8DKRXlbBhJ6ifZiglKMxqN6K5Ef7FDx,G8EPVSXsOYB5YQWZGiz1aVq5Pgr2GrQu,1,0,0,0,0,0,1,0,1,0.14285714285714285,1,0.0,0,0,0,0,0,0,0,1,0,0,1,1
8316,73993,Eh45q8Ah1FUCV8WxwA3O4F0KC13LsNiS,SpATywNh6bZuzm8s1ceuBUnMUAeoAHHw,27,33,25,19,13,0,4,0,94,13.428571428571429,3,0.0,6,25,16,13,27,0,3,4,0,60,34,0
8317,73996,scxglJg1rKZaKkFqQzaKvUj0JIYchHXc,A3fsA9Zfv1X2fVEQhTw51lKENdNrEqT3,11,10,4,0,2,2,13,3,34,4.857142857142857,1,0.0,0,4,0,2,10,2,0,13,3,6,28,1
8318,74004,obFplu8p0J5bdsesTSoaj6Bc4UGbTB6M,7GRhBDsirIGkRZBtSMEzNTyDr2JQm4xx,1,0,0,0,0,0,2,0,2,0.2857142857142857,1,0.0,0,0,0,0,0,0,0,2,0,0,2,1
8319,74005,3yqtr1mxJ0CGmkMSFU8VEZ9QxV5XzjUS,SpATywNh6bZuzm8s1ceuBUnMUAeoAHHw,8,7,5,0,4,0,4,0,20,2.857142857142857,1,0.0,0,5,0,4,7,0,0,4,0,9,11,1
8320,74006,obFplu8p0J5bdsesTSoaj6Bc4UGbTB6M,RXDvfPUBYFlVdlueBFbLW0mhhAyGEqpt,1,0,0,0,0,0,1,0,1,0.14285714285714285,1,0.0,0,0,0,0,0,0,0,1,0,0,1,1
8321,74009,obFplu8p0J5bdsesTSoaj6Bc4UGbTB6M,bWdj2GDclj5ofokWjzoa5jAwMkxCykd6,2,0,0,0,0,0,2,0,2,0.2857142857142857,2,0.0,0,0,0,0,0,0,0,2,0,0,2,1
8322,74012,1rnRBDe6QdlyFMXjNKkPkQwNjoqRhDMp,SpATywNh6bZuzm8s1ceuBUnMUAeoAHHw,30,41,19,33,4,4,9,0,110,15.714285714285714,3,0.0,12,19,32,4,29,4,1,9,0,67,43,0
8323,74013,nogA2x0BUvhes20YqJTGpVXi7iEsM9Kl,A3fsA9Zfv1X2fVEQhTw51lKENdNrEqT3,16,20,9,0,7,0,14,0,50,7.142857142857143,1,0.0,0,9,0,7,20,0,0,14,0,16,34,1
8324,74017,2kb07SQlxjCbOTE1DAO38U9f5IsTds9o,7GRhBDsirIGkRZBtSMEzNTyDr2JQm4xx,10,6,4,0,4,0,2,0,16,2.2857142857142856,1,0.0,0,4,0,4,6,0,0,2,0,8,8,1
8325,74024,EPmLjBxeWpwhjwoRgtmLV8RkhFOu2zzj,7GRhBDsirIGkRZBtSMEzNTyDr2JQm4xx,2,0,0,0,0,0,2,0,2,0.2857142857142857,1,0.0,0,0,0,0,0,0,0,2,0,0,2,1
8326,74026,zQ1YX4nsnROAkBYQ0FJFP0QSnhVmUslT,7GRhBDsirIGkRZBtSMEzNTyDr2JQm4xx,1,0,0,0,0,0,1,0,1,0.14285714285714285,1,0.0,0,0,0,0,0,0,0,1,0,0,1,1
8327,74040,CopXShP3zDILDEKJnKili2vT6Sl9AJnD,SpATywNh6bZuzm8s1ceuBUnMUAeoAHHw,2,0,0,0,0,0,3,0,3,0.42857142857142855,2,0.0,0,0,0,0,0,0,0,3,0,0,3,1
8328,74042,vQAS0obh0bWlfi2VaK7gKWVKUzPkWalY,7GRhBDsirIGkRZBtSMEzNTyDr2JQm4xx,7,2,1,0,1,0,4,0,8,1.1428571428571428,1,0.0,0,1,0,1,2,0,0,4,0,2,6,1
8329,74045,vQAS0obh0bWlfi2VaK7gKWVKUzPkWalY,SpATywNh6bZuzm8s1ceuBUnMUAeoAHHw,2,0,0,0,0,0,2,0,2,0.2857142857142857,1,0.0,0,0,0,0,0,0,0,2,0,0,2,1
8330,74046,vQAS0obh0bWlfi2VaK7gKWVKUzPkWalY,bWdj2GDclj5ofokWjzoa5jAwMkxCykd6,6,2,1,0,1,0,5,0,9,1.2857142857142858,2,0.0,0,1,0,1,2,0,0,5,0,2,7,1
8331,74052,2TaYh8ycp9sh1x4LkBWnthNJDMCHE85T,7GRhBDsirIGkRZBtSMEzNTyDr2JQm4xx,29,59,20,46,16,1,8,0,150,21.428571428571427,2,0.0,31,20,37,16,28,1,9,8,0,104,46,1
8332,74057,O0YmxDboJ63OaHyMfnj8iH9wPr65QNiO,SpATywNh6bZuzm8s1ceuBUnMUAeoAHHw,38,83,5,48,3,3,19,10,171,24.428571428571427,5,0.0,16,5,42,3,67,3,6,19,10,66,105,0
8333,74058,2DWLTxRTemXyf4r3vpMSxxKp5UI9KrMK,SpATywNh6bZuzm8s1ceuBUnMUAeoAHHw,44,38,21,9,12,15,9,2,106,15.142857142857142,2,0.0,14,21,9,12,24,15,0,9,2,56,50,1
8334,74059,TRGa3GfGhognO7jXiVPcSrWpnBuIeInO,7GRhBDsirIGkRZBtSMEzNTyDr2JQm4xx,7,7,5,0,0,0,3,0,15,2.142857142857143,1,0.0,0,5,0,0,7,0,0,3,0,5,10,1
8335,74074,ve7Ft3pn5zWGBanwhSnSQvIFg9ZaO7O3,bWdj2GDclj5ofokWjzoa5jAwMkxCykd6,1,0,0,0,0,0,1,0,1,0.14285714285714285,1,0.0,0,0,0,0,0,0,0,1,0,0,1,1
8336,74075,DfnO2Gp0WpLIOOGCReKHPkH7dv25s88Q,7GRhBDsirIGkRZBtSMEzNTyDr2JQm4xx,1,0,0,0,0,0,1,0,1,0.14285714285714285,1,0.0,0,0,0,0,0,0,0,1,0,0,1,1
8337,74077,jLtFUJPyfA46FykTUb6QOOwQ7a9wlh6r,SpATywNh6bZuzm8s1ceuBUnMUAeoAHHw,24,19,10,15,7,4,3,1,59,8.428571428571429,3,0.0,2,10,14,7,17,4,1,3,1,33,26,1
8338,74078,yqOOYx1jXUdpDzqGMMXJAQVE6fglCaFI,7GRhBDsirIGkRZBtSMEzNTyDr2JQm4xx,2,0,0,0,0,0,3,0,3,0.42857142857142855,1,0.0,0,0,0,0,0,0,0,3,0,0,3,1
8339,74085,cm7tSP8npn8e7q4HdgpiE4ontpb8vvi9,SpATywNh6bZuzm8s1ceuBUnMUAeoAHHw,13,9,4,8,2,0,4,0,27,3.857142857142857,1,0.0,3,4,8,2,6,0,0,4,0,17,10,0
8340,74086,a4naBAZCHNqdVKKeEiKQVvfTN6r4f6eG,bWdj2GDclj5ofokWjzoa5jAwMkxCykd6,29,26,17,51,12,4,7,1,118,16.857142857142858,2,0.0,3,17,49,12,23,4,2,7,1,81,37,1
8341,74090,XX8QqYjq3DDYAwGvSBM9FgSBaZDZXB3w,SpATywNh6bZuzm8s1ceuBUnMUAeoAHHw,1,0,0,0,0,0,1,0,1,0.14285714285714285,1,0.0,0,0,0,0,0,0,0,1,0,0,1,1
8342,74095,f66qV2E6gvO4HMZXdbtN6yW4m9klwB2A,7GRhBDsirIGkRZBtSMEzNTyDr2JQm4xx,2,0,0,0,0,0,2,0,2,0.2857142857142857,1,0.0,0,0,0,0,0,0,0,2,0,0,2,1
8343,74114,OakZIwMalw5UgG2N0rTydClOEPiV8rki,SpATywNh6bZuzm8s1ceuBUnMUAeoAHHw,43,51,25,17,13,0,8,0,114,16.285714285714285,3,0.0,8,25,17,13,43,0,0,8,0,63,51,0
8344,74115,NFrovzSNFaGOKX4ckxlOk5TIATwQWZDv,SpATywNh6bZuzm8s1ceuBUnMUAeoAHHw,62,115,65,104,23,24,35,4,370,52.857142857142854,6,0.0,26,65,82,23,89,24,22,35,4,196,174,0
8345,74116,zqPiN6fngW7il9FbWkBXYXifniNaXNn1,G8EPVSXsOYB5YQWZGiz1aVq5Pgr2GrQu,6,5,2,0,1,0,4,0,12,1.7142857142857142,3,0.0,0,2,0,1,5,0,0,4,0,3,9,1
8346,74117,ehQYO42YZfN9JqdFqKxgBFmu1fmVCsCo,7GRhBDsirIGkRZBtSMEzNTyDr2JQm4xx,8,1,1,0,1,3,9,0,15,2.142857142857143,1,0.0,0,1,0,1,1,3,0,9,0,2,13,1
8347,74121,Ym1ZTRs6QB0e3lMSh4qwLaB0p6ohf0Ak,RXDvfPUBYFlVdlueBFbLW0mhhAyGEqpt,107,217,118,149,69,53,24,0,630,90.0,8,0.0,66,118,133,69,151,53,16,24,0,386,244,0
8348,74122,MkhWkWrDBg7jFp3XklVC8uZQ46nAon3u,7GRhBDsirIGkRZBtSMEzNTyDr2JQm4xx,16,40,15,8,3,0,7,0,73,10.428571428571429,4,0.0,5,15,6,3,35,0,2,7,0,29,44,1
8349,74123,AisGNT34d6x1DicMgidteYUWukPQUQ7X,7GRhBDsirIGkRZBtSMEzNTyDr2JQm4xx,1,0,0,0,0,0,2,0,2,0.2857142857142857,2,0.0,0,0,0,0,0,0,0,2,0,0,2,1
8350,74130,Hzo5Ctg10ZQey5IjMeCvl0CH7lPNTM5X,A3fsA9Zfv1X2fVEQhTw51lKENdNrEqT3,55,82,29,0,22,6,31,1,171,24.428571428571427,7,0.0,3,29,0,22,79,6,0,31,1,54,117,0
8351,74136,ogJhjZ6JRse1i9Rm200W41y6knKdib4X,7GRhBDsirIGkRZBtSMEzNTyDr2JQm4xx,7,3,2,0,2,0,2,0,9,1.2857142857142858,1,0.0,0,2,0,2,3,0,0,2,0,4,5,1
8352,74143,xDJMkV9mDTaAuE2EG90IC7v4J66eZQpO,A3fsA9Zfv1X2fVEQhTw51lKENdNrEqT3,13,12,1,0,1,0,5,0,19,2.7142857142857144,1,0.0,0,1,0,1,12,0,0,5,0,2,17,1
8353,74148,IlI6WFCOksFJvUDYbo61Mefo3NVc2z35,SpATywNh6bZuzm8s1ceuBUnMUAeoAHHw,19,16,12,0,9,0,4,0,41,5.857142857142857,2,0.0,1,12,0,9,15,0,0,4,0,22,19,1
8354,74160,fkpoiY9BcwTpPdjkd5ID0mAyCrJQOIvN,7GRhBDsirIGkRZBtSMEzNTyDr2JQm4xx,7,3,2,0,2,0,2,0,9,1.2857142857142858,1,0.0,0,2,0,2,3,0,0,2,0,4,5,1
8355,74161,nDTTL9R9lgX70taGjXWWhpV9HneItz9X,SpATywNh6bZuzm8s1ceuBUnMUAeoAHHw,3,0,0,0,0,0,4,0,4,0.5714285714285714,1,0.0,0,0,0,0,0,0,0,4,0,0,4,1
8356,74179,MSkAqYUm0K8MrH08RV5TknBJ7b8d8KBP,bWdj2GDclj5ofokWjzoa5jAwMkxCykd6,4,0,0,0,0,1,3,0,4,0.5714285714285714,1,0.0,0,0,0,0,0,1,0,3,0,0,4,1
8357,74200,xfB7JXhtbd9UDGft4eYtRwZAYUFQa2nu,A3fsA9Zfv1X2fVEQhTw51lKENdNrEqT3,19,23,15,0,12,1,5,0,56,8.0,2,0.0,1,15,0,12,22,1,0,5,0,28,28,1
8358,74201,9AsHXNkBQvXo8HhSoI7QGvcrwFiTnePm,SpATywNh6bZuzm8s1ceuBUnMUAeoAHHw,13,11,2,4,2,0,6,1,26,3.7142857142857144,1,0.0,0,2,3,2,11,0,1,6,1,7,19,1
8359,74208,8y6epeJrjhugLO51W4a4wQLvEs8JOxqT,5X6FeZozNMgE2VRi3MJYjkkFK8SETtu2,6,4,0,0,0,0,6,0,10,1.4285714285714286,2,0.0,0,0,0,0,4,0,0,6,0,0,10,1
8360,74224,s8rbNwiDb6Ued6nUvpbwuDl2s256fOiD,SpATywNh6bZuzm8s1ceuBUnMUAeoAHHw,31,32,1,41,1,0,4,0,79,11.285714285714286,2,0.0,10,1,31,1,22,0,10,4,0,43,36,1
8361,74235,5KlniVT8DHSXcPiuR6nW6St4F855ogkm,G8EPVSXsOYB5YQWZGiz1aVq5Pgr2GrQu,19,16,2,0,2,0,5,0,25,3.5714285714285716,2,0.0,1,2,0,2,15,0,0,5,0,5,20,0
8362,74236,f0rOHsHG0q3gNFB6DywzqLWndZGHzmin,SpATywNh6bZuzm8s1ceuBUnMUAeoAHHw,1,0,0,0,0,0,1,0,1,0.14285714285714285,1,0.0,0,0,0,0,0,0,0,1,0,0,1,1
8363,74242,eGEAL8qSr92ZD6fgaD9bwbIgjlv0k1By,5X6FeZozNMgE2VRi3MJYjkkFK8SETtu2,15,24,1,24,12,0,2,0,63,9.0,1,0.0,20,1,20,12,4,0,4,2,0,53,10,1
8364,74245,2ZDZeGxlSkOYdQNOELblzmlZJh9Z3y1x,SpATywNh6bZuzm8s1ceuBUnMUAeoAHHw,36,37,29,17,19,0,6,0,108,15.428571428571429,4,0.0,0,29,15,19,37,0,2,6,0,63,45,0
8365,74262,USFNJQ0DS4O3ARJSYADvtg2Aw3GLb3J9,SpATywNh6bZuzm8s1ceuBUnMUAeoAHHw,10,11,4,7,2,0,4,0,28,4.0,4,0.0,0,4,6,2,11,0,1,4,0,12,16,1
8366,74268,NFrovzSNFaGOKX4ckxlOk5TIATwQWZDv,RXDvfPUBYFlVdlueBFbLW0mhhAyGEqpt,57,47,32,96,18,2,10,1,206,29.428571428571427,4,0.0,9,32,86,18,38,2,10,10,1,145,61,1
8367,74272,T7I0bmVpFP7i0YadOfDRSUAzo81IilUz,bWdj2GDclj5ofokWjzoa5jAwMkxCykd6,15,19,7,0,5,0,7,1,39,5.571428571428571,2,0.0,0,7,0,5,19,0,0,7,1,12,27,1
8368,74275,Qr56xJpKpx3PDtASRPf6XQoHmcGp3CKT,7GRhBDsirIGkRZBtSMEzNTyDr2JQm4xx,1,0,0,0,0,0,3,0,3,0.42857142857142855,2,0.0,0,0,0,0,0,0,0,3,0,0,3,1
8369,74284,lB6Kl0if51YgTDbpdNoXtX6HKiMZvllY,A3fsA9Zfv1X2fVEQhTw51lKENdNrEqT3,15,10,2,6,1,0,9,0,28,4.0,2,0.0,1,2,5,1,9,0,1,9,0,9,19,1
8370,74287,Yqe9tlKJmwXgMmJk8s60HvnWbYuOSFJG,bWdj2GDclj5ofokWjzoa5jAwMkxCykd6,8,23,9,48,4,8,5,0,97,13.857142857142858,1,0.0,7,9,46,4,16,8,2,5,0,66,31,1
8371,74292,a4RYqILKcnu8c617gYSbD0KQIm9DqZnc,7GRhBDsirIGkRZBtSMEzNTyDr2JQm4xx,7,4,2,2,2,0,1,0,11,1.5714285714285714,1,0.0,1,2,2,2,3,0,0,1,0,7,4,1
8372,74293,1484VvY7Fi4yz6Sx6JQlO6okKw4a6Bw6,7GRhBDsirIGkRZBtSMEzNTyDr2JQm4xx,3,3,0,0,0,0,1,0,4,0.5714285714285714,1,0.0,0,0,0,0,3,0,0,1,0,0,4,1
8373,74297,ntJ6fxz21zj1WGCOh981AGug6ZMrS8X6,5X6FeZozNMgE2VRi3MJYjkkFK8SETtu2,11,8,5,0,2,0,6,0,21,3.0,3,0.0,0,5,0,2,8,0,0,6,0,7,14,1
8374,74302,Na52PtAqm4VlTMUv1OPLGNjij0a5votC,7GRhBDsirIGkRZBtSMEzNTyDr2JQm4xx,6,7,3,4,1,0,1,0,16,2.2857142857142856,1,0.0,1,3,3,1,6,0,1,1,0,8,8,1
8375,74303,cynSK4pVMg8QkEFbKcs3bJdr6KIkWo0k,A3fsA9Zfv1X2fVEQhTw51lKENdNrEqT3,8,4,1,0,1,0,11,1,18,2.5714285714285716,1,0.0,0,1,0,1,4,0,0,11,1,2,16,1
8376,74304,93Z6q7IrfLjW0jIJMAho4C8mo899qi3t,A3fsA9Zfv1X2fVEQhTw51lKENdNrEqT3,9,6,4,0,3,0,3,0,16,2.2857142857142856,2,0.0,0,4,0,3,6,0,0,3,0,7,9,1
8377,74313,gMa3FGU3wfWVEbrDbTw7qJJxfolE9poa,SpATywNh6bZuzm8s1ceuBUnMUAeoAHHw,1,0,0,0,0,0,1,0,1,0.14285714285714285,1,0.0,0,0,0,0,0,0,0,1,0,0,1,1
8378,74323,fCmdFT6vVaKttJ0wsJVd3YILMXjqgUpl,7GRhBDsirIGkRZBtSMEzNTyDr2JQm4xx,8,8,4,0,3,0,4,0,19,2.7142857142857144,1,0.0,2,4,0,3,6,0,0,4,0,9,10,1
8379,74329,vCnaR7A3EMdV2eOQ4pBMh0byIjK5VwLE,SpATywNh6bZuzm8s1ceuBUnMUAeoAHHw,4,11,2,0,0,0,3,0,16,2.2857142857142856,6,0.0,0,2,0,0,11,0,0,3,0,2,14,1
8380,74333,Dc9OIUGhQBh3pdZe3Ppn36a1Oo81Nm8J,RXDvfPUBYFlVdlueBFbLW0mhhAyGEqpt,12,15,2,0,1,0,4,0,22,3.142857142857143,3,0.0,0,2,0,1,15,0,0,4,0,3,19,1
8381,74338,6W0BpjkpO0dAMGUgwI3l3rChjx6l5wlj,5X6FeZozNMgE2VRi3MJYjkkFK8SETtu2,7,11,1,0,1,0,2,0,15,2.142857142857143,1,0.0,0,1,0,1,11,0,0,2,0,2,13,1
8382,74342,GCXdwkqD60eGG5W317sN3ZNf27MOQY4U,7GRhBDsirIGkRZBtSMEzNTyDr2JQm4xx,1,0,0,0,0,0,1,0,1,0.14285714285714285,1,0.0,0,0,0,0,0,0,0,1,0,0,1,1
8383,74354,9svIRkOgRyjEbOZMMP92ryMYJokXCyUX,SpATywNh6bZuzm8s1ceuBUnMUAeoAHHw,16,21,12,18,1,2,5,0,59,8.428571428571429,3,0.0,5,12,14,1,16,2,4,5,0,32,27,1
8384,74361,TvtViclCsd2PmV5PrW2DKEwPmoLOSaRh,7GRhBDsirIGkRZBtSMEzNTyDr2JQm4xx,16,23,1,11,2,0,3,0,40,5.714285714285714,2,0.0,6,1,10,2,17,0,1,3,0,19,21,1
8385,74369,G1FfkddeVeIbkz2kmbhjCGjDdGtyuyp9,SpATywNh6bZuzm8s1ceuBUnMUAeoAHHw,19,24,8,19,5,0,5,1,62,8.857142857142858,1,0.0,12,8,16,5,12,0,3,5,1,41,21,1
8386,74370,s8rbNwiDb6Ued6nUvpbwuDl2s256fOiD,A3fsA9Zfv1X2fVEQhTw51lKENdNrEqT3,9,8,1,0,1,0,1,0,11,1.5714285714285714,1,0.0,0,1,0,1,8,0,0,1,0,2,9,1
8387,74375,pOkvcIFcOLnKHqzWe7X68PwdTZWgfXNn,7GRhBDsirIGkRZBtSMEzNTyDr2JQm4xx,26,46,15,20,8,1,3,0,93,13.285714285714286,1,0.0,15,15,20,8,31,1,0,3,0,58,35,1
8388,74376,uhOpSMle6LWQUtiKJ61AGF4uUuGwyCQB,7GRhBDsirIGkRZBtSMEzNTyDr2JQm4xx,7,6,1,0,1,0,3,0,11,1.5714285714285714,2,0.0,0,1,0,1,6,0,0,3,0,2,9,1
8389,74385,PiugBYfME8MQpTzoS0G5QvEJsAm89oP5,7GRhBDsirIGkRZBtSMEzNTyDr2JQm4xx,9,5,1,4,2,3,9,1,25,3.5714285714285716,1,0.0,3,1,3,2,2,3,1,9,1,9,16,1
8390,74391,CCjaP0a0XOS5DYKLqhLcmuVP0ZMtmJbe,SpATywNh6bZuzm8s1ceuBUnMUAeoAHHw,2,0,0,0,0,0,2,0,2,0.2857142857142857,1,0.0,0,0,0,0,0,0,0,2,0,0,2,0
8391,74397,FzKYBP9DQh3u0w9lQRHJGeubpb75FItD,A3fsA9Zfv1X2fVEQhTw51lKENdNrEqT3,20,15,1,22,0,1,9,1,49,7.0,2,0.0,0,1,22,0,15,1,0,9,1,23,26,0
8392,74403,kTXF1gPewccB1VIt2bJnfMXFVMCM29nB,SpATywNh6bZuzm8s1ceuBUnMUAeoAHHw,15,15,1,21,0,1,4,2,44,6.285714285714286,1,0.0,4,1,17,0,11,1,4,4,2,22,22,1
8393,74412,vX9PpvehRTgTkIr6tSKODV93gbmBGfye,7GRhBDsirIGkRZBtSMEzNTyDr2JQm4xx,1,0,0,0,0,0,3,0,3,0.42857142857142855,2,0.0,0,0,0,0,0,0,0,3,0,0,3,1
8394,74417,pZeZwcDZvDaUYfNrM0JBq16CcPqoVjAy,7GRhBDsirIGkRZBtSMEzNTyDr2JQm4xx,2,0,0,0,0,0,2,0,2,0.2857142857142857,1,0.0,0,0,0,0,0,0,0,2,0,0,2,1
8395,74426,JYiXW3dpkzmGlUrad7aUjTowRtDP23eD,5X6FeZozNMgE2VRi3MJYjkkFK8SETtu2,1,0,0,0,0,0,1,0,1,0.14285714285714285,1,0.0,0,0,0,0,0,0,0,1,0,0,1,1
8396,74428,flqVHzaI93P4MJBmTZVjZNaIqqmijscB,G8EPVSXsOYB5YQWZGiz1aVq5Pgr2GrQu,19,37,1,0,1,0,2,0,41,5.857142857142857,1,0.0,0,1,0,1,37,0,0,2,0,2,39,1
8397,74432,iB2CzgEKP1k7rQZEzYQoAPIRp7dEItA4,7GRhBDsirIGkRZBtSMEzNTyDr2JQm4xx,14,16,8,12,8,0,2,0,46,6.571428571428571,1,0.0,6,8,11,8,10,0,1,2,0,33,13,1
8398,74439,I79OMGSY4ZrLgUTAB0cVX1h1GhooCLNo,A3fsA9Zfv1X2fVEQhTw51lKENdNrEqT3,6,2,1,0,1,0,4,1,9,1.2857142857142858,1,0.0,0,1,0,1,2,0,0,4,1,2,7,1
8399,74441,grxgFxuiaSTlMIk1kWcHwbLAYZVnIvkA,7GRhBDsirIGkRZBtSMEzNTyDr2JQm4xx,10,9,3,0,3,0,3,0,18,2.5714285714285716,1,0.0,0,3,0,3,9,0,0,3,0,6,12,1
8400,74453,XKfrMCVtqlIZ8enVJyGd7DD1q7PXaYx0,bWdj2GDclj5ofokWjzoa5jAwMkxCykd6,8,3,0,0,0,0,6,1,10,1.4285714285714286,2,0.0,0,0,0,0,3,0,0,6,1,0,10,1
8401,74455,PRNejdeVNKfxLUk8kGMRZmgBIyh1R45g,7GRhBDsirIGkRZBtSMEzNTyDr2JQm4xx,5,2,1,0,1,0,2,0,6,0.8571428571428571,1,0.0,0,1,0,1,2,0,0,2,0,2,4,1
8402,74456,2ZaLqb29uQ5ksFfqfhamJxjvg9jGJ9Ay,7GRhBDsirIGkRZBtSMEzNTyDr2JQm4xx,5,3,0,0,0,0,3,0,6,0.8571428571428571,1,0.0,0,0,0,0,3,0,0,3,0,0,6,1
8403,74460,ACadGToRbfVhLuGyd9Wpg2G1uz3esqK0,SpATywNh6bZuzm8s1ceuBUnMUAeoAHHw,6,2,1,0,1,1,3,0,8,1.1428571428571428,1,0.0,0,1,0,1,2,1,0,3,0,2,6,0
8404,74461,z2UutrDxctGBl3XhV09hNxXdsZmqDZvY,A3fsA9Zfv1X2fVEQhTw51lKENdNrEqT3,36,38,29,36,18,40,23,1,185,26.428571428571427,5,0.0,3,29,32,18,35,40,4,23,1,82,103,1
8405,74462,dT92IjRcuruPiAlpqVUTtu3wNL9IIegT,7GRhBDsirIGkRZBtSMEzNTyDr2JQm4xx,4,0,0,0,0,0,3,1,4,0.5714285714285714,1,0.0,0,0,0,0,0,0,0,3,1,0,4,1
8406,74469,XwG3vcP20DIeZlmf1pcrm3ClOhU48FuI,bWdj2GDclj5ofokWjzoa5jAwMkxCykd6,5,2,1,0,1,0,2,0,6,0.8571428571428571,1,0.0,0,1,0,1,2,0,0,2,0,2,4,1
8407,74483,SP7hg1EWo2mZkHuxZFtI4Vbcyr5vcP4h,SpATywNh6bZuzm8s1ceuBUnMUAeoAHHw,33,34,17,34,7,14,13,0,119,17.0,8,0.0,9,17,33,7,25,14,1,13,0,66,53,0
8408,74500,spNi8Q5WiDgxakh0uckmQbexani6DCOh,7GRhBDsirIGkRZBtSMEzNTyDr2JQm4xx,20,23,7,12,6,0,2,0,50,7.142857142857143,2,0.0,8,7,12,6,15,0,0,2,0,33,17,1
8409,74506,M3qc1xm79CLjiw98zxp89bImiVSCJcDh,7GRhBDsirIGkRZBtSMEzNTyDr2JQm4xx,1,0,0,0,0,0,1,0,1,0.14285714285714285,1,0.0,0,0,0,0,0,0,0,1,0,0,1,1
8410,74516,KaBv8PoJ8OVsLIkZYrjM1X6uYKyRrniG,7GRhBDsirIGkRZBtSMEzNTyDr2JQm4xx,8,8,2,0,3,0,3,0,16,2.2857142857142856,1,0.0,5,2,0,3,3,0,0,3,0,10,6,1
8411,74522,ZYGzPhdrKsCQft8z3gUrz2GR31kmqGY8,SpATywNh6bZuzm8s1ceuBUnMUAeoAHHw,30,72,34,33,9,37,12,1,198,28.285714285714285,5,0.0,25,34,28,9,47,37,5,12,1,96,102,0
8412,74526,qwopEmmu52GEF4KxBC26RpTkcwtY07S9,SpATywNh6bZuzm8s1ceuBUnMUAeoAHHw,22,40,21,17,8,1,12,0,99,14.142857142857142,4,0.0,13,21,15,8,27,1,2,12,0,57,42,0
8413,74532,MV1wf85ScBlo9ArAqT4i8ZoZIKCQgEfs,SpATywNh6bZuzm8s1ceuBUnMUAeoAHHw,6,7,4,0,0,0,5,0,16,2.2857142857142856,2,0.0,0,4,0,0,7,0,0,5,0,4,12,1
8414,74537,p64MOtUXpLiy07h6B0dKNFYMkAVaqQ98,7GRhBDsirIGkRZBtSMEzNTyDr2JQm4xx,2,0,0,0,0,0,4,0,4,0.5714285714285714,1,0.0,0,0,0,0,0,0,0,4,0,0,4,1
8415,74541,HbmZzALzRW0CJmaD07o1oMpvJwGgfjK4,bWdj2GDclj5ofokWjzoa5jAwMkxCykd6,4,6,0,0,0,0,2,0,8,1.1428571428571428,2,0.0,0,0,0,0,6,0,0,2,0,0,8,1
8416,74548,HF98YPKzT8oi2j9flZW9kstZcvL3ZimG,A3fsA9Zfv1X2fVEQhTw51lKENdNrEqT3,40,57,23,74,8,0,7,0,169,24.142857142857142,6,0.0,1,23,63,8,56,0,11,7,0,95,74,1
8417,74560,Q0d1WItnRJvnzlnn5VcAU6GMGN4rfbYJ,7GRhBDsirIGkRZBtSMEzNTyDr2JQm4xx,1,0,0,0,0,0,1,0,1,0.14285714285714285,1,0.0,0,0,0,0,0,0,0,1,0,0,1,1
8418,74585,GyWTABuPpZEqO585EnNTIpM2B2faPYN3,5X6FeZozNMgE2VRi3MJYjkkFK8SETtu2,6,5,2,2,0,0,2,0,11,1.5714285714285714,2,0.0,0,2,2,0,5,0,0,2,0,4,7,1
8419,74598,OTHlyZh4aRihnrH9Vutug3qdQ6q32Nov,SpATywNh6bZuzm8s1ceuBUnMUAeoAHHw,9,4,3,0,3,0,2,0,12,1.7142857142857142,1,0.0,0,3,0,3,4,0,0,2,0,6,6,1
8420,74603,A5la8pvW0tLLXP6HSr61aMxUll9fPTHI,7GRhBDsirIGkRZBtSMEzNTyDr2JQm4xx,11,5,2,4,3,0,10,0,24,3.4285714285714284,1,0.0,3,2,3,3,2,0,1,10,0,11,13,1
8421,74612,T8yZ978Owo7xSmEVFbiCM8j5K4ntSTo2,7GRhBDsirIGkRZBtSMEzNTyDr2JQm4xx,1,0,0,0,0,0,1,0,1,0.14285714285714285,1,0.0,0,0,0,0,0,0,0,1,0,0,1,1
8422,74644,NoceYrOX1tWqokyDfvqtevfQbA2rhFqB,SpATywNh6bZuzm8s1ceuBUnMUAeoAHHw,8,39,26,0,14,3,11,0,93,13.285714285714286,4,0.0,2,26,0,14,37,3,0,11,0,42,51,0
8423,74645,yyQKmUmpVqmqFiYGe484Lz475SV3nfm5,bWdj2GDclj5ofokWjzoa5jAwMkxCykd6,5,3,1,0,1,0,3,0,8,1.1428571428571428,1,0.0,0,1,0,1,3,0,0,3,0,2,6,1
8424,74647,7jwWb0uiBH4HpnQekwYLSZ97fL4vhEw1,SpATywNh6bZuzm8s1ceuBUnMUAeoAHHw,7,7,1,0,0,0,5,1,14,2.0,1,0.0,0,1,0,0,7,0,0,5,1,1,13,1
8425,74649,3x63reHnPUEpxvneROppT18TTVHKvgH3,SpATywNh6bZuzm8s1ceuBUnMUAeoAHHw,43,50,23,34,13,0,7,0,127,18.142857142857142,4,0.0,10,23,29,13,40,0,5,7,0,75,52,0
8426,74650,usRZSdDsUQfZaciTJTskV4NLSeP1lHRl,7GRhBDsirIGkRZBtSMEzNTyDr2JQm4xx,14,22,4,14,6,13,8,1,68,9.714285714285714,1,0.0,10,4,11,6,12,13,3,8,1,31,37,1
8427,74655,zd4bqhboWRT9GK0kaDHAAEgCWB98gZCz,A3fsA9Zfv1X2fVEQhTw51lKENdNrEqT3,4,2,1,0,1,0,2,0,6,0.8571428571428571,1,0.0,0,1,0,1,2,0,0,2,0,2,4,1
8428,74667,g6Gud8aJq8WYBVZlhPICi85SNqSTC9hb,SpATywNh6bZuzm8s1ceuBUnMUAeoAHHw,7,5,1,0,1,0,2,0,9,1.2857142857142858,1,0.0,0,1,0,1,5,0,0,2,0,2,7,1
8429,74684,3Mo4KKxt5XsXFl1wmKukaZclKwhABriO,A3fsA9Zfv1X2fVEQhTw51lKENdNrEqT3,4,2,1,0,0,0,2,0,5,0.7142857142857143,1,0.0,0,1,0,0,2,0,0,2,0,1,4,1
8430,74697,RYEl9qV5WolRR4P8IF9M1gxceAzD6Axt,SpATywNh6bZuzm8s1ceuBUnMUAeoAHHw,18,31,14,25,3,35,9,0,117,16.714285714285715,4,0.0,12,14,21,3,19,35,4,9,0,50,67,1
8431,74699,IZ5pWpBLzW50MjCCGxCjTz4w6DVz2MU3,G8EPVSXsOYB5YQWZGiz1aVq5Pgr2GrQu,1,0,0,0,0,0,1,0,1,0.14285714285714285,1,0.0,0,0,0,0,0,0,0,1,0,0,1,1
8432,74712,ZudgpcrDV2RrJQUR1YBw9q8iUT5VbCHi,RXDvfPUBYFlVdlueBFbLW0mhhAyGEqpt,21,19,10,32,9,0,7,0,77,11.0,3,0.0,6,10,28,9,13,0,4,7,0,53,24,0
8433,74721,2cWT2r9kI6XDpveso7mwMhmCGJDMpJ6X,A3fsA9Zfv1X2fVEQhTw51lKENdNrEqT3,1,0,0,0,0,0,1,0,1,0.14285714285714285,1,0.0,0,0,0,0,0,0,0,1,0,0,1,1
8434,74723,bLurC9srutCM4k4gLSsbzYrz2ihcIC86,7GRhBDsirIGkRZBtSMEzNTyDr2JQm4xx,6,3,1,0,1,0,4,0,9,1.2857142857142858,1,0.0,0,1,0,1,3,0,0,4,0,2,7,1
8435,74724,2mlxTydWoLZJ5NQWesHHKUelrVUBGoHh,5X6FeZozNMgE2VRi3MJYjkkFK8SETtu2,6,2,1,0,1,0,4,0,8,1.1428571428571428,1,0.0,0,1,0,1,2,0,0,4,0,2,6,1
8436,74725,dg1KWi5LRRms7lQMyP0ii5Pv3KonWqiG,7GRhBDsirIGkRZBtSMEzNTyDr2JQm4xx,30,40,22,40,13,1,20,1,137,19.571428571428573,4,0.0,9,22,35,13,31,1,5,20,1,79,58,1
8437,74737,xMjaHywxqKHoEbgcAEYnpZkLLGRuzCTC,SpATywNh6bZuzm8s1ceuBUnMUAeoAHHw,41,98,31,37,16,7,18,0,207,29.571428571428573,7,0.0,16,31,28,16,82,7,9,18,0,91,116,0
8438,74739,WnGoJ0X05nmmcr9OBuNGFmD5r4EVF1g6,A3fsA9Zfv1X2fVEQhTw51lKENdNrEqT3,17,15,10,0,5,18,13,1,62,8.857142857142858,3,0.0,0,10,0,5,15,18,0,13,1,15,47,0
8439,74749,usRZSdDsUQfZaciTJTskV4NLSeP1lHRl,A3fsA9Zfv1X2fVEQhTw51lKENdNrEqT3,1,0,0,0,0,0,1,0,1,0.14285714285714285,1,0.0,0,0,0,0,0,0,0,1,0,0,1,1
8440,74761,Z5b3QXG5aJtKMyvjqd5INn7f1wDhqIm4,A3fsA9Zfv1X2fVEQhTw51lKENdNrEqT3,1,0,0,0,0,0,1,0,1,0.14285714285714285,1,0.0,0,0,0,0,0,0,0,1,0,0,1,1
8441,74762,Z5b3QXG5aJtKMyvjqd5INn7f1wDhqIm4,bWdj2GDclj5ofokWjzoa5jAwMkxCykd6,14,22,7,10,5,0,3,0,47,6.714285714285714,2,0.0,3,7,10,5,19,0,0,3,0,25,22,0
8442,74764,ZV0a8d6GAHaQT1yxkoLDTJWbniV7l6vc,5X6FeZozNMgE2VRi3MJYjkkFK8SETtu2,6,1,1,0,1,0,5,0,8,1.1428571428571428,1,0.0,0,1,0,1,1,0,0,5,0,2,6,1
8443,74778,bYD2u7vuN3G54awyDYPdRiZI3O4zw6kx,G8EPVSXsOYB5YQWZGiz1aVq5Pgr2GrQu,8,7,5,0,3,0,4,0,19,2.7142857142857144,2,0.0,0,5,0,3,7,0,0,4,0,8,11,1
8444,74789,x2AGMzmJPCrXZNc7gGF2iADeNGLrtzi4,A3fsA9Zfv1X2fVEQhTw51lKENdNrEqT3,13,11,7,0,6,0,5,0,29,4.142857142857143,2,0.0,0,7,0,6,11,0,0,5,0,13,16,1
8445,74790,s29WON0nEycbuI4M7GDpKZCuvPrDZcLx,G8EPVSXsOYB5YQWZGiz1aVq5Pgr2GrQu,12,4,4,0,4,0,3,0,15,2.142857142857143,1,0.0,0,4,0,4,4,0,0,3,0,8,7,1
8446,74803,rOS1kOMsU3zAy3GVc3zUTuvG3J4hWGN2,SpATywNh6bZuzm8s1ceuBUnMUAeoAHHw,7,2,1,0,1,0,7,1,12,1.7142857142857142,1,0.0,0,1,0,1,2,0,0,7,1,2,10,1
8447,74808,ciYJmrXFDUtWkjoF7Zvs7BQ2J3037Bux,bWdj2GDclj5ofokWjzoa5jAwMkxCykd6,4,2,1,0,1,0,1,0,5,0.7142857142857143,1,0.0,0,1,0,1,2,0,0,1,0,2,3,1
8448,74813,dfEUetbMC28MXxBYUZ94BQFzb5NJzCJ0,SpATywNh6bZuzm8s1ceuBUnMUAeoAHHw,8,2,1,0,1,0,5,1,10,1.4285714285714286,1,0.0,0,1,0,1,2,0,0,5,1,2,8,1
8449,74815,LFkf4WR1XfFwr3RF5erdei3F4d3PlupD,7GRhBDsirIGkRZBtSMEzNTyDr2JQm4xx,2,0,0,0,0,0,2,0,2,0.2857142857142857,1,0.0,0,0,0,0,0,0,0,2,0,0,2,1
8450,74816,uT14yawTmUCC7G7h6dlovFEDCG0rTxiC,5X6FeZozNMgE2VRi3MJYjkkFK8SETtu2,1,0,0,0,0,0,1,0,1,0.14285714285714285,1,0.0,0,0,0,0,0,0,0,1,0,0,1,1
8451,74822,NY9s8OFouHZCCkZ3OfBNpnQKNG5h9lgn,SpATywNh6bZuzm8s1ceuBUnMUAeoAHHw,6,5,1,0,1,0,2,1,10,1.4285714285714286,1,0.0,0,1,0,1,5,0,0,2,1,2,8,1
8452,74823,h5DbxORjpK7o2YwkPjSoh86dvC8KHNlm,SpATywNh6bZuzm8s1ceuBUnMUAeoAHHw,38,55,22,20,13,0,6,0,116,16.571428571428573,4,0.0,7,22,20,13,48,0,0,6,0,62,54,0
8453,74824,dfEUetbMC28MXxBYUZ94BQFzb5NJzCJ0,A3fsA9Zfv1X2fVEQhTw51lKENdNrEqT3,6,3,2,0,1,0,2,0,8,1.1428571428571428,1,0.0,0,2,0,1,3,0,0,2,0,3,5,1
8454,74840,FvY4K2RN2da3T8MEGlPk2LmHUIxOyg0h,SpATywNh6bZuzm8s1ceuBUnMUAeoAHHw,18,25,12,14,8,18,6,0,83,11.857142857142858,4,0.0,7,12,13,8,18,18,1,6,0,40,43,0
8455,74852,0wpgF8T87E4lIPjqoh0AkxyomANfbalw,7GRhBDsirIGkRZBtSMEzNTyDr2JQm4xx,1,0,0,0,0,0,1,0,1,0.14285714285714285,1,0.0,0,0,0,0,0,0,0,1,0,0,1,1
8456,74855,pTjlgRGlVEY0q8gZSgoQhD2BjMBUQLrl,SpATywNh6bZuzm8s1ceuBUnMUAeoAHHw,15,33,18,0,10,1,14,2,78,11.142857142857142,4,0.0,8,18,0,10,25,1,0,14,2,36,42,1
8457,74858,mB36rXDIKgGQROGEKlrDrvsLRYA6xyWr,bWdj2GDclj5ofokWjzoa5jAwMkxCykd6,15,30,16,2,6,11,15,0,80,11.428571428571429,4,0.0,1,16,1,6,29,11,1,15,0,24,56,1
8458,74862,iNVrCH89sJttoddUpv5O2bH5LrAKlFHk,SpATywNh6bZuzm8s1ceuBUnMUAeoAHHw,7,4,3,0,3,0,3,0,13,1.8571428571428572,2,0.0,0,3,0,3,4,0,0,3,0,6,7,1
8459,74865,WlLtmSTcQZkOIIH38SOYOKYSBYpp2ymS,7GRhBDsirIGkRZBtSMEzNTyDr2JQm4xx,1,0,0,0,0,0,1,0,1,0.14285714285714285,1,0.0,0,0,0,0,0,0,0,1,0,0,1,1
8460,74867,IePFEx0pR5xLGQlWWjU59zR6qxTHOeo0,7GRhBDsirIGkRZBtSMEzNTyDr2JQm4xx,1,0,0,0,0,0,2,0,2,0.2857142857142857,2,0.0,0,0,0,0,0,0,0,2,0,0,2,1
8461,74868,Ob4gv0EanZge2ZoC1mjpKSlZhrSnoOS3,SpATywNh6bZuzm8s1ceuBUnMUAeoAHHw,32,58,30,46,9,1,9,0,153,21.857142857142858,5,0.0,18,30,42,9,40,1,4,9,0,99,54,0
8462,74874,CjjbRPpHR9Bj7mz7vlCMGl56lBOfuzeG,7GRhBDsirIGkRZBtSMEzNTyDr2JQm4xx,1,0,0,0,0,0,1,0,1,0.14285714285714285,1,0.0,0,0,0,0,0,0,0,1,0,0,1,1
8463,74883,r3ymEDBeAtjd52LKkH7rXxWW6cBfLEDa,A3fsA9Zfv1X2fVEQhTw51lKENdNrEqT3,5,4,3,0,0,0,1,0,8,1.1428571428571428,1,0.0,0,3,0,0,4,0,0,1,0,3,5,1
8464,74887,YnXdaRteqU5oS01NC3H96Vynlp7riJjN,7GRhBDsirIGkRZBtSMEzNTyDr2JQm4xx,5,2,1,0,1,0,2,0,6,0.8571428571428571,1,0.0,0,1,0,1,2,0,0,2,0,2,4,1
8465,74888,hB4yTUnQMne1LtjUUKgpcnhj6jq7S5Co,7GRhBDsirIGkRZBtSMEzNTyDr2JQm4xx,73,98,41,84,39,2,15,0,279,39.857142857142854,8,0.0,41,41,76,39,57,2,8,15,0,197,82,0
8466,74890,ZqjoiK6u3Oz9EZH4lOkXjinyTZauCj8B,7GRhBDsirIGkRZBtSMEzNTyDr2JQm4xx,4,3,1,0,0,0,2,0,6,0.8571428571428571,1,0.0,0,1,0,0,3,0,0,2,0,1,5,1
8467,74892,JiMk3YzOg8oAYgApOK7xg1JGgnoRvDfl,A3fsA9Zfv1X2fVEQhTw51lKENdNrEqT3,4,2,1,0,1,0,2,0,6,0.8571428571428571,1,0.0,0,1,0,1,2,0,0,2,0,2,4,1
8468,74897,x29OOChdmJGXK62DnUpwKbwJurqULmnD,5X6FeZozNMgE2VRi3MJYjkkFK8SETtu2,5,5,1,0,2,0,2,0,10,1.4285714285714286,1,0.0,3,1,0,2,2,0,0,2,0,6,4,0
8469,74900,JiMk3YzOg8oAYgApOK7xg1JGgnoRvDfl,bWdj2GDclj5ofokWjzoa5jAwMkxCykd6,4,3,2,0,2,0,1,0,8,1.1428571428571428,1,0.0,0,2,0,2,3,0,0,1,0,4,4,1
8470,74902,x29OOChdmJGXK62DnUpwKbwJurqULmnD,bWdj2GDclj5ofokWjzoa5jAwMkxCykd6,5,3,1,0,1,0,2,0,7,1.0,1,0.0,1,1,0,1,2,0,0,2,0,3,4,1
8471,74903,Y0dbTriNAgSzbrnkzFHfTSZPt5kDzGfo,7GRhBDsirIGkRZBtSMEzNTyDr2JQm4xx,55,128,4,181,22,11,14,0,360,51.42857142857143,5,0.0,71,4,163,22,57,11,18,14,0,260,100,1
8472,74911,KXR3u54SykbWYMuF2sF6lcMFs68otiQO,SpATywNh6bZuzm8s1ceuBUnMUAeoAHHw,46,78,39,46,17,9,14,0,203,29.0,8,0.0,21,39,41,17,57,9,5,14,0,118,85,0
8473,74913,uFxbwM61ZWFC5xnxVOlmiGXCTyHmK3HX,bWdj2GDclj5ofokWjzoa5jAwMkxCykd6,8,8,5,0,3,9,7,1,33,4.714285714285714,2,0.0,0,5,0,3,8,9,0,7,1,8,25,1
8474,74917,iFkbfunFypPiiZAClHyDLR02ievAgqRo,7GRhBDsirIGkRZBtSMEzNTyDr2JQm4xx,8,5,3,2,3,0,2,0,15,2.142857142857143,1,0.0,1,3,2,3,4,0,0,2,0,9,6,1
8475,74921,S6vBzHKpSh31SFGGZmwgKaOH2RvW3RpH,7GRhBDsirIGkRZBtSMEzNTyDr2JQm4xx,10,10,6,3,6,2,10,0,37,5.285714285714286,1,0.0,3,6,3,6,7,2,0,10,0,18,19,1
8476,74930,5v8l5BICnEGCGWpQvqxFCJVjz2acEKZl,G8EPVSXsOYB5YQWZGiz1aVq5Pgr2GrQu,9,14,4,0,3,1,4,0,26,3.7142857142857144,1,0.0,3,4,0,3,11,1,0,4,0,10,16,0
8477,74932,zaNavQl8vjpykftGiklyCQVgYYsAGELI,7GRhBDsirIGkRZBtSMEzNTyDr2JQm4xx,9,4,3,0,3,0,2,0,12,1.7142857142857142,1,0.0,0,3,0,3,4,0,0,2,0,6,6,1
8478,74934,knxAJpSFDgjN8jBmnCV7BB7s4fbgoTt1,SpATywNh6bZuzm8s1ceuBUnMUAeoAHHw,35,43,24,30,1,13,18,9,138,19.714285714285715,5,0.0,6,24,27,1,37,13,3,18,9,58,80,0
8479,74943,mOZWwAiWS8RfyGtuX0b9jvrQpdX3BP1X,bWdj2GDclj5ofokWjzoa5jAwMkxCykd6,11,28,2,66,2,0,18,0,116,16.571428571428573,3,0.0,9,2,65,2,19,0,1,18,0,78,38,0
8480,74947,GXo2SYlrCC46fM8KQJ07eqitBWYgaplM,SpATywNh6bZuzm8s1ceuBUnMUAeoAHHw,53,195,57,59,7,10,43,5,376,53.714285714285715,8,0.0,33,57,55,7,162,10,4,43,5,152,224,0
8481,74959,AzcVSEK0IpU0E5IZQu1LwCDywMZBgNAW,SpATywNh6bZuzm8s1ceuBUnMUAeoAHHw,5,2,1,0,1,0,2,0,6,0.8571428571428571,1,0.0,0,1,0,1,2,0,0,2,0,2,4,1
8482,74963,jt6cAnJpqYCiS3Lj5wNBvifs8WZJznlF,7GRhBDsirIGkRZBtSMEzNTyDr2JQm4xx,5,2,1,0,1,0,2,0,6,0.8571428571428571,1,0.0,0,1,0,1,2,0,0,2,0,2,4,1
8483,74976,SNVrdMjIVUeHCh0ANatiA4r6Zjv5zuOs,SpATywNh6bZuzm8s1ceuBUnMUAeoAHHw,1,0,0,0,0,0,1,0,1,0.14285714285714285,1,0.0,0,0,0,0,0,0,0,1,0,0,1,1
8484,74979,SNVrdMjIVUeHCh0ANatiA4r6Zjv5zuOs,bWdj2GDclj5ofokWjzoa5jAwMkxCykd6,1,0,0,0,0,0,1,0,1,0.14285714285714285,1,0.0,0,0,0,0,0,0,0,1,0,0,1,1
8485,74980,FjNebfWhfRwodURnqPOMm3ZfKL7caXWJ,SpATywNh6bZuzm8s1ceuBUnMUAeoAHHw,4,0,0,0,0,1,3,0,4,0.5714285714285714,1,0.0,0,0,0,0,0,1,0,3,0,0,4,1
8486,74990,RbewLSSgBXbMSLEvzESHw0b6pdUZ0dT1,7GRhBDsirIGkRZBtSMEzNTyDr2JQm4xx,4,2,1,0,1,0,1,0,5,0.7142857142857143,1,0.0,0,1,0,1,2,0,0,1,0,2,3,1
8487,75002,0FC20UDeWvUi5UrOg2NVCepKkW4oulyY,SpATywNh6bZuzm8s1ceuBUnMUAeoAHHw,23,32,15,32,3,14,12,1,109,15.571428571428571,4,0.0,12,15,29,3,20,14,3,12,1,59,50,1
8488,75008,s2svupUO1VMo8YfeGdH5qCtTY141gV4e,7GRhBDsirIGkRZBtSMEzNTyDr2JQm4xx,16,41,1,4,5,1,13,0,65,9.285714285714286,2,0.0,18,1,3,5,23,1,1,13,0,27,38,1
8489,75023,NyiU395X6Fy3DZbS0WCSdHXksL7FK9tP,RXDvfPUBYFlVdlueBFbLW0mhhAyGEqpt,5,2,0,0,0,0,5,2,9,1.2857142857142858,2,0.0,0,0,0,0,2,0,0,5,2,0,9,0
8490,75024,e5rwU2LwislVyOTeqeRmKDP4jS4xeeeT,SpATywNh6bZuzm8s1ceuBUnMUAeoAHHw,18,18,13,2,7,0,2,0,42,6.0,1,0.0,1,13,2,7,17,0,0,2,0,23,19,1
8491,75033,9oCGRMqQ5CGhjL72D087jHZSMR83iAkq,SpATywNh6bZuzm8s1ceuBUnMUAeoAHHw,37,44,12,14,11,0,4,0,85,12.142857142857142,3,0.0,5,12,13,11,39,0,1,4,0,41,44,0
8492,75043,oDHEQbFNA2xviYWXNUI5rdNNLqWcTgSk,bWdj2GDclj5ofokWjzoa5jAwMkxCykd6,1,0,0,0,0,0,1,0,1,0.14285714285714285,1,0.0,0,0,0,0,0,0,0,1,0,0,1,1
8493,75076,Oa5Z9qxxvzPY6Y4pD2DPDPqyzdKPou5A,7GRhBDsirIGkRZBtSMEzNTyDr2JQm4xx,5,7,2,0,1,0,1,0,11,1.5714285714285714,1,0.0,3,2,0,1,4,0,0,1,0,6,5,1
8494,75083,WFdKiZBTbeCiiw3YIeAU1XWn0P3M4cOn,7GRhBDsirIGkRZBtSMEzNTyDr2JQm4xx,1,0,0,0,0,0,1,0,1,0.14285714285714285,1,0.0,0,0,0,0,0,0,0,1,0,0,1,1
8495,75093,Wcbtj2ddFRjLWK9tTZ7uzCDmpegrAZ78,A3fsA9Zfv1X2fVEQhTw51lKENdNrEqT3,62,35,23,104,13,2,16,1,194,27.714285714285715,5,0.0,3,23,92,13,32,2,12,16,1,131,63,0
8496,75099,lnW3snH3Dt7UKPOuS5LuzzO6fmhyVp7F,SpATywNh6bZuzm8s1ceuBUnMUAeoAHHw,5,3,1,0,1,0,1,0,6,0.8571428571428571,1,0.0,0,1,0,1,3,0,0,1,0,2,4,1
8497,75102,7PsSHlEYnB89Jan9VqppndjNHL90G8j5,7GRhBDsirIGkRZBtSMEzNTyDr2JQm4xx,1,0,0,0,0,0,3,0,3,0.42857142857142855,3,0.0,0,0,0,0,0,0,0,3,0,0,3,1
8498,75106,wCksXloTMkWRNjUlFs8kEf1uEAKNJm9S,SpATywNh6bZuzm8s1ceuBUnMUAeoAHHw,2,0,0,0,0,0,2,0,2,0.2857142857142857,1,0.0,0,0,0,0,0,0,0,2,0,0,2,1
8499,75108,35ygmhgWZR3Rp3zgk5PM9pjJe8hJeFw2,G8EPVSXsOYB5YQWZGiz1aVq5Pgr2GrQu,22,22,14,20,9,6,8,1,80,11.428571428571429,3,0.0,4,14,19,9,18,6,1,8,1,46,34,0
8500,75120,H2nT05aeA6Q1zZKHa66kquyct5PT5SXn,SpATywNh6bZuzm8s1ceuBUnMUAeoAHHw,33,62,4,35,1,21,9,0,132,18.857142857142858,7,0.0,18,4,33,1,44,21,2,9,0,56,76,0
8501,75130,zeydZlwGQCxDpstjdEq0NvjUsbpOzoxV,A3fsA9Zfv1X2fVEQhTw51lKENdNrEqT3,25,19,15,0,13,1,13,2,63,9.0,4,0.0,0,15,0,13,19,1,0,13,2,28,35,1
8502,75180,XjoWzgT5svv3QrHsOovsOWAEcNVxKsvq,bWdj2GDclj5ofokWjzoa5jAwMkxCykd6,1,0,0,0,0,0,1,0,1,0.14285714285714285,1,0.0,0,0,0,0,0,0,0,1,0,0,1,1
8503,75187,L9qMLlGWAeAI6zWAZIyJtn0wISNa3dxg,RXDvfPUBYFlVdlueBFbLW0mhhAyGEqpt,3,0,0,0,0,12,2,0,14,2.0,2,0.0,0,0,0,0,0,12,0,2,0,0,14,1
8504,75189,QlvFciinGDGt7csjDmjYPPZqFlKAzfUP,5X6FeZozNMgE2VRi3MJYjkkFK8SETtu2,1,0,0,0,0,0,1,0,1,0.14285714285714285,1,0.0,0,0,0,0,0,0,0,1,0,0,1,1
8505,75201,U3LNfYcdRIeU9qhiaPG7Yg8NuZRGOnSS,bWdj2GDclj5ofokWjzoa5jAwMkxCykd6,1,0,0,0,0,0,1,0,1,0.14285714285714285,1,0.0,0,0,0,0,0,0,0,1,0,0,1,1
8506,75208,EsXr4Om7Vwi1sKSVuaosexmk6LU6FCZi,SpATywNh6bZuzm8s1ceuBUnMUAeoAHHw,19,27,16,8,9,6,13,4,83,11.857142857142858,2,0.0,6,16,8,9,21,6,0,13,4,39,44,0
8507,75212,umgqnQJ37y6QmsMhUUaPYa8Ra9JvurY1,A3fsA9Zfv1X2fVEQhTw51lKENdNrEqT3,6,3,0,0,1,0,2,0,6,0.8571428571428571,1,0.0,0,0,0,1,3,0,0,2,0,1,5,1
8508,75214,pXIGt0PRh4Kb7rmAnRSyrPgJarEYjwPQ,SpATywNh6bZuzm8s1ceuBUnMUAeoAHHw,4,2,1,0,1,0,1,0,5,0.7142857142857143,1,0.0,0,1,0,1,2,0,0,1,0,2,3,1
8509,75216,grxgFxuiaSTlMIk1kWcHwbLAYZVnIvkA,G8EPVSXsOYB5YQWZGiz1aVq5Pgr2GrQu,1,0,0,0,0,0,1,0,1,0.14285714285714285,1,0.0,0,0,0,0,0,0,0,1,0,0,1,1
8510,75218,loLM1q927UBCE6cjZ1Vielkh2VBpufUl,7GRhBDsirIGkRZBtSMEzNTyDr2JQm4xx,2,0,0,0,0,0,2,0,2,0.2857142857142857,1,0.0,0,0,0,0,0,0,0,2,0,0,2,1
8511,75224,ZpdK4JyprYJ3RXwz9T54FRcouWhOvm2M,SpATywNh6bZuzm8s1ceuBUnMUAeoAHHw,1,0,0,0,0,0,1,0,1,0.14285714285714285,1,0.0,0,0,0,0,0,0,0,1,0,0,1,0
8512,75226,8VNllEJU5IWGHwzKYxjVrn3uY1FEJx1D,SpATywNh6bZuzm8s1ceuBUnMUAeoAHHw,18,30,10,11,6,2,10,1,70,10.0,1,0.0,18,10,10,6,12,2,1,10,1,44,26,1
8513,75229,roZnXzS2HTclICKkrEV00q4r4cGpS00w,SpATywNh6bZuzm8s1ceuBUnMUAeoAHHw,15,14,6,12,3,3,2,0,40,5.714285714285714,1,0.0,5,6,12,3,9,3,0,2,0,26,14,1
8514,75237,RFr9TyIVEW42bBHoptkHxr0bo57RDi2m,7GRhBDsirIGkRZBtSMEzNTyDr2JQm4xx,94,149,44,158,45,44,26,2,468,66.85714285714286,3,0.0,103,44,135,45,46,44,23,26,2,327,141,1
8515,75239,azgXgRxypRV3MCHuv22g9fm7GCtWHZdX,SpATywNh6bZuzm8s1ceuBUnMUAeoAHHw,12,22,15,8,0,1,5,0,51,7.285714285714286,2,0.0,6,15,7,0,16,1,1,5,0,28,23,1
8516,75244,pkcnSnJ3oMXJ1Rn021rYtsOpPmKbDGk6,7GRhBDsirIGkRZBtSMEzNTyDr2JQm4xx,32,68,30,17,17,5,9,0,146,20.857142857142858,2,0.0,25,30,10,17,43,5,7,9,0,82,64,1
8517,75258,JJYEr1YA7SClhqsLz61VElUYdghcCxlW,5X6FeZozNMgE2VRi3MJYjkkFK8SETtu2,3,2,0,0,0,0,2,0,4,0.5714285714285714,1,0.0,0,0,0,0,2,0,0,2,0,0,4,1
8518,75269,rlaxlckAFc9FC5RGSAxvTGGClfed4789,bWdj2GDclj5ofokWjzoa5jAwMkxCykd6,1,0,0,0,0,0,2,0,2,0.2857142857142857,1,0.0,0,0,0,0,0,0,0,2,0,0,2,0
8519,75272,YiYJ3RnpzhhfakeMA3KKlM5DPKZuE0U2,bWdj2GDclj5ofokWjzoa5jAwMkxCykd6,2,0,0,0,0,0,2,0,2,0.2857142857142857,1,0.0,0,0,0,0,0,0,0,2,0,0,2,1
8520,75279,t8eDuPU4MsZrMH2MoE1n7JeYLVBJZOGD,5X6FeZozNMgE2VRi3MJYjkkFK8SETtu2,30,21,6,28,6,0,10,1,72,10.285714285714286,3,0.0,12,6,28,6,9,0,0,10,1,52,20,0
8521,75288,ZuPH4O6ElHiBwlm11NvwWK4IBueWaJol,7GRhBDsirIGkRZBtSMEzNTyDr2JQm4xx,1,0,0,0,0,0,1,0,1,0.14285714285714285,1,0.0,0,0,0,0,0,0,0,1,0,0,1,1
8522,75305,tQwNuzxGOUPFYlY5A3ZFrjnMB9Szs2jV,A3fsA9Zfv1X2fVEQhTw51lKENdNrEqT3,1,0,0,0,0,0,1,0,1,0.14285714285714285,1,0.0,0,0,0,0,0,0,0,1,0,0,1,1
8523,75307,80mucTACVCDvIo1wfgGJkZ9oDdziiwCh,SpATywNh6bZuzm8s1ceuBUnMUAeoAHHw,31,48,16,30,9,9,13,1,126,18.0,3,0.0,21,16,29,9,27,9,1,13,1,75,51,0
8524,75314,2IlOpdUgsPu5FVltj0flScFk4CeI7uHm,A3fsA9Zfv1X2fVEQhTw51lKENdNrEqT3,111,43,28,166,14,18,18,1,288,41.142857142857146,5,0.0,6,28,165,14,37,18,1,18,1,213,75,1
8525,75323,1aZU0pZlvemw2X4WLr3aSR93nNOLRr5M,7GRhBDsirIGkRZBtSMEzNTyDr2JQm4xx,13,12,4,16,5,1,2,0,40,5.714285714285714,1,0.0,6,4,13,5,6,1,3,2,0,28,12,1
8526,75325,DcYuNoj7qO6bSoP00ZpC8JGbOHS0FkLq,A3fsA9Zfv1X2fVEQhTw51lKENdNrEqT3,1,0,0,0,0,0,1,0,1,0.14285714285714285,1,0.0,0,0,0,0,0,0,0,1,0,0,1,1
8527,75329,gmhCT21egJ120TaG89Xay0aaFTdFxysB,7GRhBDsirIGkRZBtSMEzNTyDr2JQm4xx,2,0,0,0,0,0,2,0,2,0.2857142857142857,1,0.0,0,0,0,0,0,0,0,2,0,0,2,1
8528,75342,LYUpAsU4h8m8YAaUfY7NTYDa3U4FDtNg,G8EPVSXsOYB5YQWZGiz1aVq5Pgr2GrQu,9,4,3,0,3,0,2,0,12,1.7142857142857142,1,0.0,0,3,0,3,4,0,0,2,0,6,6,1
8529,75343,Z0wLwaqmdxgdDY3I1REtvLcfEmLLHTQn,SpATywNh6bZuzm8s1ceuBUnMUAeoAHHw,1,0,0,0,0,0,1,0,1,0.14285714285714285,1,0.0,0,0,0,0,0,0,0,1,0,0,1,1
8530,75347,iJftBP3zncmjUCwGWSZ77IUrDb3Dt8rz,7GRhBDsirIGkRZBtSMEzNTyDr2JQm4xx,9,10,5,4,3,0,3,0,25,3.5714285714285716,1,0.0,2,5,3,3,8,0,1,3,0,13,12,1
8531,75352,gvSShG1YYTmpJLc5fUzYYJybQmPOEusw,RXDvfPUBYFlVdlueBFbLW0mhhAyGEqpt,31,40,19,31,16,4,17,2,129,18.428571428571427,2,0.0,14,19,29,16,26,4,2,17,2,78,51,1
8532,75374,a4lLJZ6TEk4Nk0N3U6P35yYFPwm8oPCu,SpATywNh6bZuzm8s1ceuBUnMUAeoAHHw,5,3,1,0,1,1,4,0,10,1.4285714285714286,1,0.0,0,1,0,1,3,1,0,4,0,2,8,1
8533,75379,MYsCU1zkMrWxPhV1b7wSL5LZIo1zGyhU,A3fsA9Zfv1X2fVEQhTw51lKENdNrEqT3,72,66,58,2,46,0,8,0,180,25.714285714285715,6,0.0,0,58,2,46,66,0,0,8,0,106,74,0
8534,75389,4hm01j0jNhOy0D3MAC90STk6UKDwkBuN,SpATywNh6bZuzm8s1ceuBUnMUAeoAHHw,4,2,0,0,0,0,2,0,4,0.5714285714285714,1,0.0,0,0,0,0,2,0,0,2,0,0,4,1
8535,75394,pbucftaYT0bUhiGeQH3fHhc1yRJzZ1IA,SpATywNh6bZuzm8s1ceuBUnMUAeoAHHw,12,6,5,0,5,0,1,0,17,2.4285714285714284,1,0.0,0,5,0,5,6,0,0,1,0,10,7,0
8536,75399,ZoYGnrXOVzOUx1IBbZEpgAgR6pM1f79T,SpATywNh6bZuzm8s1ceuBUnMUAeoAHHw,8,6,3,0,2,0,4,0,15,2.142857142857143,1,0.0,0,3,0,2,6,0,0,4,0,5,10,1
8537,75401,i93wq7dpRKS8LWX4FM6N5PqvNqUj0cQr,G8EPVSXsOYB5YQWZGiz1aVq5Pgr2GrQu,88,97,50,166,28,62,26,15,444,63.42857142857143,5,0.0,30,50,130,28,67,62,36,26,15,238,206,1
8538,75419,B2GQpolo5ouDH0z3sr0heBhmmfs3lRR0,bWdj2GDclj5ofokWjzoa5jAwMkxCykd6,5,2,0,0,0,0,6,0,8,1.1428571428571428,2,0.0,0,0,0,0,2,0,0,6,0,0,8,1
8539,75425,Th6GGIKucyCokdQsUn3aOeloTzqx0Qbo,G8EPVSXsOYB5YQWZGiz1aVq5Pgr2GrQu,63,71,2,140,1,28,12,0,254,36.285714285714285,3,0.0,14,2,114,1,57,28,26,12,0,131,123,1
8540,75426,Ii5I7AVMkxFqBe6GOJtwj479RGiJPW5D,5X6FeZozNMgE2VRi3MJYjkkFK8SETtu2,1,0,0,0,0,0,1,0,1,0.14285714285714285,1,0.0,0,0,0,0,0,0,0,1,0,0,1,1
8541,75433,vF3Wpw7dZ70yAQhvwH59vsIsW43Fy9UR,G8EPVSXsOYB5YQWZGiz1aVq5Pgr2GrQu,2,0,0,0,0,0,3,0,3,0.42857142857142855,1,0.0,0,0,0,0,0,0,0,3,0,0,3,1
8542,75459,5khGTvLU6yjmXaeHpWJGWa1iZGzL5YGz,bWdj2GDclj5ofokWjzoa5jAwMkxCykd6,1,0,0,0,0,0,1,0,1,0.14285714285714285,1,0.0,0,0,0,0,0,0,0,1,0,0,1,1
8543,75460,5khGTvLU6yjmXaeHpWJGWa1iZGzL5YGz,A3fsA9Zfv1X2fVEQhTw51lKENdNrEqT3,1,0,0,0,0,0,1,0,1,0.14285714285714285,1,0.0,0,0,0,0,0,0,0,1,0,0,1,1
8544,75467,SR6E1PEdPOWeoyx0JB3mYrCcyPyQVNur,SpATywNh6bZuzm8s1ceuBUnMUAeoAHHw,1,0,0,0,0,0,1,0,1,0.14285714285714285,1,0.0,0,0,0,0,0,0,0,1,0,0,1,1
8545,75476,RJ8UDBA8MoIbU3vEiMeGJTOTXtH9PTgu,7GRhBDsirIGkRZBtSMEzNTyDr2JQm4xx,21,44,17,32,20,2,3,0,118,16.857142857142858,1,0.0,25,17,31,20,19,2,1,3,0,93,25,1
8546,75480,RsZjSLVxYbmsMcCyiGpXZKIPYOa4dUlN,7GRhBDsirIGkRZBtSMEzNTyDr2JQm4xx,1,0,0,0,0,0,2,0,2,0.2857142857142857,1,0.0,0,0,0,0,0,0,0,2,0,0,2,1
8547,75493,Y7Pi7uKjChwCBFftO7ZsD2oE8A4VzjzU,7GRhBDsirIGkRZBtSMEzNTyDr2JQm4xx,5,2,1,0,1,0,2,0,6,0.8571428571428571,1,0.0,0,1,0,1,2,0,0,2,0,2,4,1
8548,75497,EgqHA1OdkjYgdxhtnGhhZnjCGKC8K9Xc,A3fsA9Zfv1X2fVEQhTw51lKENdNrEqT3,4,0,0,0,0,0,6,0,6,0.8571428571428571,1,0.0,0,0,0,0,0,0,0,6,0,0,6,1
8549,75511,MYsCU1zkMrWxPhV1b7wSL5LZIo1zGyhU,RXDvfPUBYFlVdlueBFbLW0mhhAyGEqpt,52,43,35,0,24,0,6,0,108,15.428571428571429,5,0.0,2,35,0,24,41,0,0,6,0,61,47,0
8550,75519,xJjW1X2F9FnPULUeJMqNeOytdLBSBRfA,A3fsA9Zfv1X2fVEQhTw51lKENdNrEqT3,4,2,1,0,1,0,1,0,5,0.7142857142857143,1,0.0,0,1,0,1,2,0,0,1,0,2,3,1
8551,75520,9Ymehs8Guv0M3ykIpbJLNOnh3ut9xb1R,SpATywNh6bZuzm8s1ceuBUnMUAeoAHHw,12,26,9,0,5,0,10,0,50,7.142857142857143,2,0.0,13,9,0,5,13,0,0,10,0,27,23,1
8552,75532,VZpQ5fkZ1BnI92zZZncFhaR85gRVSNv5,bWdj2GDclj5ofokWjzoa5jAwMkxCykd6,1,0,0,0,0,0,1,0,1,0.14285714285714285,1,0.0,0,0,0,0,0,0,0,1,0,0,1,1
8553,75534,YJcptsgRBvUQgvUGKpQGU1OPeMTESrpy,bWdj2GDclj5ofokWjzoa5jAwMkxCykd6,7,7,4,0,2,0,2,0,15,2.142857142857143,1,0.0,1,4,0,2,6,0,0,2,0,7,8,1
8554,75537,MYsCU1zkMrWxPhV1b7wSL5LZIo1zGyhU,7GRhBDsirIGkRZBtSMEzNTyDr2JQm4xx,11,6,5,0,3,0,2,0,16,2.2857142857142856,1,0.0,0,5,0,3,6,0,0,2,0,8,8,1
8555,75546,r8DGbOGptFcObhXTHK1R95j3RAtmtYI9,SpATywNh6bZuzm8s1ceuBUnMUAeoAHHw,19,26,11,11,3,1,17,0,69,9.857142857142858,1,0.0,13,11,11,3,13,1,0,17,0,38,31,0
8556,75550,Dek55Yy14Wc8ji3EaeNQmJNgORQPfUnO,A3fsA9Zfv1X2fVEQhTw51lKENdNrEqT3,22,23,5,0,3,0,12,1,44,6.285714285714286,3,0.0,0,5,0,3,23,0,0,12,1,8,36,1
8557,75551,VZpQ5fkZ1BnI92zZZncFhaR85gRVSNv5,A3fsA9Zfv1X2fVEQhTw51lKENdNrEqT3,5,2,1,0,1,0,3,0,7,1.0,1,0.0,0,1,0,1,2,0,0,3,0,2,5,1
8558,75564,YJcptsgRBvUQgvUGKpQGU1OPeMTESrpy,A3fsA9Zfv1X2fVEQhTw51lKENdNrEqT3,7,3,2,0,2,0,2,0,9,1.2857142857142858,1,0.0,0,2,0,2,3,0,0,2,0,4,5,1
8559,75568,ZdxHJrP5CNTD1MfH7Z4GYI0JTs7bRCCq,SpATywNh6bZuzm8s1ceuBUnMUAeoAHHw,1,0,0,0,0,0,1,0,1,0.14285714285714285,1,0.0,0,0,0,0,0,0,0,1,0,0,1,1
8560,75569,XYe0CM3N7dYmrf9sLMa4FZv52JAuUnko,SpATywNh6bZuzm8s1ceuBUnMUAeoAHHw,6,4,1,0,1,0,1,0,7,1.0,1,0.0,0,1,0,1,4,0,0,1,0,2,5,1
8561,75587,hcKYo6bLhlANvHE0FxLuR4YY8jocfBwJ,RXDvfPUBYFlVdlueBFbLW0mhhAyGEqpt,1,0,0,0,0,0,2,0,2,0.2857142857142857,1,0.0,0,0,0,0,0,0,0,2,0,0,2,1
8562,75593,9aM24JWMSszlno8F5rXsYdVrvPAYQQTl,7GRhBDsirIGkRZBtSMEzNTyDr2JQm4xx,2,0,0,0,0,0,2,0,2,0.2857142857142857,1,0.0,0,0,0,0,0,0,0,2,0,0,2,1
8563,75600,Xt4h1KWJBlSDSafJvdbE69LJiRLDiihq,A3fsA9Zfv1X2fVEQhTw51lKENdNrEqT3,7,12,2,0,1,0,3,0,18,2.5714285714285716,3,0.0,3,2,0,1,9,0,0,3,0,6,12,0
8564,75601,Xt4h1KWJBlSDSafJvdbE69LJiRLDiihq,7GRhBDsirIGkRZBtSMEzNTyDr2JQm4xx,6,3,1,0,1,0,2,0,7,1.0,1,0.0,0,1,0,1,3,0,0,2,0,2,5,0
8565,75607,2rRO2m2Tts8mA1JnL8szKbbtUjTgDVrv,SpATywNh6bZuzm8s1ceuBUnMUAeoAHHw,1,0,0,0,0,0,1,0,1,0.14285714285714285,1,0.0,0,0,0,0,0,0,0,1,0,0,1,1
8566,75634,d89wuOHpC7Vn9JqPTUxlWcTfbXFz4Jqa,SpATywNh6bZuzm8s1ceuBUnMUAeoAHHw,1,0,0,0,0,0,1,0,1,0.14285714285714285,1,0.0,0,0,0,0,0,0,0,1,0,0,1,1
8567,75636,wVMamfzRvn8ggzqqz7KnBSjMVeEGKAVa,G8EPVSXsOYB5YQWZGiz1aVq5Pgr2GrQu,5,5,1,0,1,0,4,0,11,1.5714285714285714,1,0.0,3,1,0,1,2,0,0,4,0,5,6,1
8568,75642,jZTK26BTfBLHQKFhPE9kcyNEiSpfCkRJ,SpATywNh6bZuzm8s1ceuBUnMUAeoAHHw,21,29,11,17,8,0,8,1,74,10.571428571428571,3,0.0,6,11,15,8,23,0,2,8,1,40,34,0
8569,75653,opGP9S4qTowSY3s74oSvvaEMZTZCaex3,SpATywNh6bZuzm8s1ceuBUnMUAeoAHHw,4,2,0,0,0,1,3,0,6,0.8571428571428571,1,0.0,0,0,0,0,2,1,0,3,0,0,6,1
8570,75657,gdYB2uKieMG440BMMPn1TjGUEdcmZtra,SpATywNh6bZuzm8s1ceuBUnMUAeoAHHw,1,0,0,0,0,0,1,0,1,0.14285714285714285,1,0.0,0,0,0,0,0,0,0,1,0,0,1,1
8571,75662,nBvjxfottsOCrOycyCAN2ZrAK5pyyTJB,SpATywNh6bZuzm8s1ceuBUnMUAeoAHHw,5,2,1,0,1,1,2,0,7,1.0,1,0.0,0,1,0,1,2,1,0,2,0,2,5,0
8572,75672,900ZMEgjiXT78JdNbM02wL3ugTz6vLs2,SpATywNh6bZuzm8s1ceuBUnMUAeoAHHw,5,3,1,0,1,0,2,0,7,1.0,1,0.0,0,1,0,1,3,0,0,2,0,2,5,1
8573,75679,2DRoBN35Fg0xbk0dtkqR4hEGCgR0ym7U,SpATywNh6bZuzm8s1ceuBUnMUAeoAHHw,5,2,1,0,1,0,3,0,7,1.0,1,0.0,0,1,0,1,2,0,0,3,0,2,5,1
8574,75683,2jrpxtUIXsWPIVOxhzZkmXgvu9KlY2UV,5X6FeZozNMgE2VRi3MJYjkkFK8SETtu2,6,5,2,0,1,0,2,0,10,1.4285714285714286,2,0.0,0,2,0,1,5,0,0,2,0,3,7,1
8575,75685,7glymc4Wt1TTt6LrLi78VQNF5GV1r6UY,7GRhBDsirIGkRZBtSMEzNTyDr2JQm4xx,6,1,0,0,0,1,6,1,9,1.2857142857142858,1,0.0,0,0,0,0,1,1,0,6,1,0,9,1
8576,75687,LFB2kImAJUILQTj3BlBgq5zjMlrHesod,7GRhBDsirIGkRZBtSMEzNTyDr2JQm4xx,1,0,0,0,0,0,2,0,2,0.2857142857142857,1,0.0,0,0,0,0,0,0,0,2,0,0,2,1
8577,75689,NoiNbgKNGrBKsO5sdYiCtmGZFgGMLv9U,A3fsA9Zfv1X2fVEQhTw51lKENdNrEqT3,1,0,0,0,0,0,1,0,1,0.14285714285714285,1,0.0,0,0,0,0,0,0,0,1,0,0,1,1
8578,75690,BSh5O31gIGvDrYgmsU5wxbvxaTpBXZ4G,A3fsA9Zfv1X2fVEQhTw51lKENdNrEqT3,6,4,1,0,1,0,2,0,8,1.1428571428571428,2,0.0,0,1,0,1,4,0,0,2,0,2,6,1
8579,75692,42ADuPtX4XbJqCPm754Am2gTrysmHBtZ,5X6FeZozNMgE2VRi3MJYjkkFK8SETtu2,4,2,1,0,0,1,3,1,8,1.1428571428571428,1,0.0,0,1,0,0,2,1,0,3,1,1,7,1
8580,75693,xLSpoVb23knkFiYzprt9lH19YWAHUscy,G8EPVSXsOYB5YQWZGiz1aVq5Pgr2GrQu,4,2,0,0,0,0,12,0,14,2.0,1,0.0,0,0,0,0,2,0,0,12,0,0,14,0
8581,75707,vQt9TYLzgldZ6xZevGT5tZaVh2QbxNnZ,A3fsA9Zfv1X2fVEQhTw51lKENdNrEqT3,1,0,0,0,0,0,1,0,1,0.14285714285714285,1,0.0,0,0,0,0,0,0,0,1,0,0,1,1
8582,75711,ONaGFOFSpTcGmGss3L3s1gXRn5LKjFn3,SpATywNh6bZuzm8s1ceuBUnMUAeoAHHw,7,2,2,0,2,2,4,0,12,1.7142857142857142,2,0.0,0,2,0,2,2,2,0,4,0,4,8,1
8583,75713,UIuiknFcMQSDDlsjhv6DEHOmlCIlKRjg,5X6FeZozNMgE2VRi3MJYjkkFK8SETtu2,5,3,1,0,0,0,2,0,6,0.8571428571428571,1,0.0,0,1,0,0,3,0,0,2,0,1,5,1
8584,75721,hkOcH5tOuxyPKzObCfNaFgGI6cTMtgMP,SpATywNh6bZuzm8s1ceuBUnMUAeoAHHw,11,12,8,0,2,0,9,0,31,4.428571428571429,2,0.0,0,8,0,2,12,0,0,9,0,10,21,0
8585,75722,HVhFikY19vIN7YGNsfMyCuWrJd1ba910,bWdj2GDclj5ofokWjzoa5jAwMkxCykd6,2,0,0,0,0,0,2,0,2,0.2857142857142857,1,0.0,0,0,0,0,0,0,0,2,0,0,2,1
8586,75736,bwGV7RxO9uTA6WTvdbogMOQvBlvVU3Dn,A3fsA9Zfv1X2fVEQhTw51lKENdNrEqT3,27,18,13,6,10,0,4,0,51,7.285714285714286,2,0.0,2,13,6,10,16,0,0,4,0,31,20,1
8587,75738,Fzmjh2xG2BFrAdVYbFRtDZxpTYA0nmbP,5X6FeZozNMgE2VRi3MJYjkkFK8SETtu2,4,5,0,0,1,0,2,0,8,1.1428571428571428,1,0.0,1,0,0,1,4,0,0,2,0,2,6,1
8588,75743,2ohWJM8Yz0bj21lrvUC1zfEo5S0znXME,A3fsA9Zfv1X2fVEQhTw51lKENdNrEqT3,4,3,0,0,0,0,3,0,6,0.8571428571428571,1,0.0,0,0,0,0,3,0,0,3,0,0,6,1
8589,75750,pXIGt0PRh4Kb7rmAnRSyrPgJarEYjwPQ,bWdj2GDclj5ofokWjzoa5jAwMkxCykd6,9,18,9,10,4,0,3,0,44,6.285714285714286,1,0.0,3,9,9,4,15,0,1,3,0,25,19,1
8590,75751,AQki29spcihutk4byKfhdfiwIESO5QjE,7GRhBDsirIGkRZBtSMEzNTyDr2JQm4xx,4,3,1,0,0,0,3,0,7,1.0,1,0.0,0,1,0,0,3,0,0,3,0,1,6,1
8591,75752,0CuRIhBavvQKL5rTT1QWf2kztAfRXZug,A3fsA9Zfv1X2fVEQhTw51lKENdNrEqT3,62,73,38,110,12,15,22,2,272,38.857142857142854,10,0.0,5,38,88,12,68,15,22,22,2,143,129,0
8592,75760,87yFIXn8YjKLNtiBpBtMqW5Rij3yU58s,SpATywNh6bZuzm8s1ceuBUnMUAeoAHHw,5,5,0,0,0,0,6,0,11,1.5714285714285714,2,0.0,0,0,0,0,5,0,0,6,0,0,11,0
8593,75761,Ez2wwRGD5HKrpBiFL1N8vI6Y03Eb7DuE,bWdj2GDclj5ofokWjzoa5jAwMkxCykd6,2,0,0,0,0,0,2,0,2,0.2857142857142857,1,0.0,0,0,0,0,0,0,0,2,0,0,2,1
8594,75767,Ez2wwRGD5HKrpBiFL1N8vI6Y03Eb7DuE,A3fsA9Zfv1X2fVEQhTw51lKENdNrEqT3,2,0,0,0,0,0,4,0,4,0.5714285714285714,1,0.0,0,0,0,0,0,0,0,4,0,0,4,1
8595,75772,nknXXbQsC6Q6nMDyRKc0MDJZg6KtAXBE,G8EPVSXsOYB5YQWZGiz1aVq5Pgr2GrQu,7,10,4,0,1,0,6,1,22,3.142857142857143,3,0.0,0,4,0,1,10,0,0,6,1,5,17,0
8596,75790,rT1OrFQC18rdvYkTGYqwRgC7eDvihHsc,A3fsA9Zfv1X2fVEQhTw51lKENdNrEqT3,25,14,11,0,9,11,12,1,58,8.285714285714286,5,0.0,1,11,0,9,13,11,0,12,1,21,37,1
8597,75805,MUIa6qD7GjPbUNaVCnuA1JB2CKlFxAhB,5X6FeZozNMgE2VRi3MJYjkkFK8SETtu2,10,8,6,0,1,0,7,0,22,3.142857142857143,1,0.0,0,6,0,1,8,0,0,7,0,7,15,1
8598,75808,HwVLN1J20SKxglwoAhZ25HfWKhmy2J55,bWdj2GDclj5ofokWjzoa5jAwMkxCykd6,28,13,7,40,1,6,13,2,82,11.714285714285714,1,0.0,4,7,28,1,9,6,12,13,2,40,42,0
8599,75810,5aTSEnkjfpLtMifb6I0aDufPHJiD4Kpv,A3fsA9Zfv1X2fVEQhTw51lKENdNrEqT3,1,0,0,0,0,0,1,0,1,0.14285714285714285,1,0.0,0,0,0,0,0,0,0,1,0,0,1,1
8600,75855,qoVEgoDHTZXl1xk3NNpgXC5ePtcEHLyo,SpATywNh6bZuzm8s1ceuBUnMUAeoAHHw,13,18,10,8,6,0,5,0,47,6.714285714285714,2,0.0,4,10,8,6,14,0,0,5,0,28,19,1
8601,75879,Slk5JcZSYHmDLQZXaNVmcMDmjJ16kBhI,SpATywNh6bZuzm8s1ceuBUnMUAeoAHHw,47,92,17,34,6,8,28,1,186,26.571428571428573,12,0.0,23,17,31,6,69,8,3,28,1,77,109,0
8602,75888,PQscC5e4adjOlDXssQTF1miDsYNrTX1i,7GRhBDsirIGkRZBtSMEzNTyDr2JQm4xx,5,2,1,0,1,1,3,0,8,1.1428571428571428,1,0.0,0,1,0,1,2,1,0,3,0,2,6,1
8603,75897,Y89GJdSZUpoYFMgx00SCe6qFoYoXIpUj,RXDvfPUBYFlVdlueBFbLW0mhhAyGEqpt,1,0,0,0,0,0,1,0,1,0.14285714285714285,1,0.0,0,0,0,0,0,0,0,1,0,0,1,1
8604,75926,nZMtHRGCOwkrOLE7E6uKf1YVlLLujKjO,G8EPVSXsOYB5YQWZGiz1aVq5Pgr2GrQu,7,5,1,0,1,0,2,0,9,1.2857142857142858,1,0.0,0,1,0,1,5,0,0,2,0,2,7,1
8605,75947,29wIR2YiGRVbsOT8ievKfVtP4R5px8Qo,5X6FeZozNMgE2VRi3MJYjkkFK8SETtu2,4,3,0,0,0,0,2,0,5,0.7142857142857143,1,0.0,0,0,0,0,3,0,0,2,0,0,5,1
8606,75961,usnYJ8MdQmnJqA1xJ5WyVx49Lm7npBxw,A3fsA9Zfv1X2fVEQhTw51lKENdNrEqT3,2,0,0,0,0,0,6,0,6,0.8571428571428571,1,0.0,0,0,0,0,0,0,0,6,0,0,6,1
8607,75965,v3CIUjxPH9xWB79tSDrtVHc9ShR8m6Ki,7GRhBDsirIGkRZBtSMEzNTyDr2JQm4xx,9,15,0,2,1,36,3,0,57,8.142857142857142,1,0.0,2,0,2,1,13,36,0,3,0,5,52,1
8608,75972,QE1GAKkI5XZdeDVvm96I8rxHAhiLrarh,SpATywNh6bZuzm8s1ceuBUnMUAeoAHHw,1,0,0,0,0,0,1,0,1,0.14285714285714285,1,0.0,0,0,0,0,0,0,0,1,0,0,1,1
8609,75985,XJ0fPDPj1weE8n0B17PQ5bWqC1TTj821,7GRhBDsirIGkRZBtSMEzNTyDr2JQm4xx,4,2,0,0,0,0,2,0,4,0.5714285714285714,1,0.0,0,0,0,0,2,0,0,2,0,0,4,1
8610,75997,ye1qNcwLMVEAyXZxda61F8zTpgv5P1cn,bWdj2GDclj5ofokWjzoa5jAwMkxCykd6,25,26,10,114,12,2,8,1,173,24.714285714285715,1,0.0,14,10,111,12,12,2,3,8,1,147,26,1
8611,76003,2gIyQvzCOzwcg12cbPihdITZquwdviac,5X6FeZozNMgE2VRi3MJYjkkFK8SETtu2,4,2,1,0,1,0,1,0,5,0.7142857142857143,1,0.0,0,1,0,1,2,0,0,1,0,2,3,1
8612,76015,03LSJMJGCEPYScMXgYv3wZ9A4zZCWROs,SpATywNh6bZuzm8s1ceuBUnMUAeoAHHw,5,2,1,0,1,0,2,0,6,0.8571428571428571,1,0.0,0,1,0,1,2,0,0,2,0,2,4,1
8613,76025,VWQu1dhnKTy5XjlrKdDTFzN2ON0OJPXW,5X6FeZozNMgE2VRi3MJYjkkFK8SETtu2,1,0,0,0,0,0,1,0,1,0.14285714285714285,1,0.0,0,0,0,0,0,0,0,1,0,0,1,1
8614,76027,BlBPU32FQaOv4FFjXSkiNL1PvarqZtmh,7GRhBDsirIGkRZBtSMEzNTyDr2JQm4xx,1,0,0,0,0,0,1,0,1,0.14285714285714285,1,0.0,0,0,0,0,0,0,0,1,0,0,1,1
8615,76042,EdUEhKqzlcZzUOVd6gkhH4yikmNzaFOo,5X6FeZozNMgE2VRi3MJYjkkFK8SETtu2,2,0,0,0,0,0,3,0,3,0.42857142857142855,2,0.0,0,0,0,0,0,0,0,3,0,0,3,1
8616,76044,Qfr71fBWHfCr6Grcd1acKeeOb47jgXr2,RXDvfPUBYFlVdlueBFbLW0mhhAyGEqpt,21,18,12,0,8,3,8,0,49,7.0,2,0.0,0,12,0,8,18,3,0,8,0,20,29,1
8617,76046,VQgE6No0aWl6KJGMl6ENY2W7pdT7Ee3x,SpATywNh6bZuzm8s1ceuBUnMUAeoAHHw,2,0,0,0,0,0,2,0,2,0.2857142857142857,1,0.0,0,0,0,0,0,0,0,2,0,0,2,1
8618,76052,1p0GemwRRphdcYcT1EB1KkjZ05b7lJJE,SpATywNh6bZuzm8s1ceuBUnMUAeoAHHw,1,0,0,0,0,0,1,0,1,0.14285714285714285,1,0.0,0,0,0,0,0,0,0,1,0,0,1,1
8619,76055,qX6GnUFvQV8fhcfo2vDxSk5lUZGpfHG2,SpATywNh6bZuzm8s1ceuBUnMUAeoAHHw,11,10,7,12,0,0,4,0,33,4.714285714285714,3,0.0,0,7,12,0,10,0,0,4,0,19,14,0
8620,76069,po8VsdSuE45R9f8cQhYrAT9xKsA9SY1D,SpATywNh6bZuzm8s1ceuBUnMUAeoAHHw,15,30,2,9,1,0,6,0,48,6.857142857142857,2,0.0,15,2,9,1,15,0,0,6,0,27,21,1
8621,76071,erW7pLi6zCDRwT5XL8FqOQCuc017OfKV,SpATywNh6bZuzm8s1ceuBUnMUAeoAHHw,3,2,1,0,0,0,1,0,4,0.5714285714285714,1,0.0,0,1,0,0,2,0,0,1,0,1,3,1
8622,76073,sxlaG4Fls4yl9crPN8VEZQ5WoWsunptZ,7GRhBDsirIGkRZBtSMEzNTyDr2JQm4xx,3,0,0,0,0,3,2,0,5,0.7142857142857143,1,0.0,0,0,0,0,0,3,0,2,0,0,5,1
8623,76076,mMF5Hf2GkWKPKuwtMKnnuMzAQr3x7Iso,bWdj2GDclj5ofokWjzoa5jAwMkxCykd6,4,2,1,0,1,0,1,0,5,0.7142857142857143,1,0.0,0,1,0,1,2,0,0,1,0,2,3,1
8624,76088,wunZtNKxMsk2xAb7WtZTQgu1ulM02qIO,5X6FeZozNMgE2VRi3MJYjkkFK8SETtu2,3,2,1,0,0,0,1,0,4,0.5714285714285714,1,0.0,0,1,0,0,2,0,0,1,0,1,3,1
8625,76089,KwnxSTbiO8w9DjvNhEpJZXf1R621Cpug,A3fsA9Zfv1X2fVEQhTw51lKENdNrEqT3,4,0,0,0,0,1,7,0,8,1.1428571428571428,1,0.0,0,0,0,0,0,1,0,7,0,0,8,1
8626,76091,UcMBbV5apyBn6US03aF0lorBUPxtfuSB,bWdj2GDclj5ofokWjzoa5jAwMkxCykd6,14,13,4,14,3,13,6,1,54,7.714285714285714,2,0.0,2,4,13,3,11,13,1,6,1,22,32,0
8627,76102,CjgJE17lQhs840ANyRWRY3zbs19fMxRt,SpATywNh6bZuzm8s1ceuBUnMUAeoAHHw,1,0,0,0,0,0,1,0,1,0.14285714285714285,1,0.0,0,0,0,0,0,0,0,1,0,0,1,1
8628,76108,zKXJGJg9DMEB2RAxuThjb4UbLJ2XM2gW,RXDvfPUBYFlVdlueBFbLW0mhhAyGEqpt,20,21,14,21,5,0,4,0,65,9.285714285714286,2,0.0,4,14,19,5,17,0,2,4,0,42,23,1
8629,76111,G5JFEd58i47FiqQxatEMibk5NL9uoQb2,5X6FeZozNMgE2VRi3MJYjkkFK8SETtu2,8,6,1,12,0,0,2,0,21,3.0,1,0.0,3,1,10,0,3,0,2,2,0,14,7,1
8630,76116,P2IHpZFxqRXDLPtwjrmd6pAQXPHckBAL,A3fsA9Zfv1X2fVEQhTw51lKENdNrEqT3,9,5,3,0,3,0,2,0,13,1.8571428571428572,1,0.0,0,3,0,3,5,0,0,2,0,6,7,1
8631,76121,UcMBbV5apyBn6US03aF0lorBUPxtfuSB,SpATywNh6bZuzm8s1ceuBUnMUAeoAHHw,18,17,7,12,4,47,9,1,97,13.857142857142858,3,0.0,5,7,11,4,12,47,1,9,1,27,70,0
8632,76124,qciW3eHpuKm9iUPQVKuwWV8dfW8XAZ18,SpATywNh6bZuzm8s1ceuBUnMUAeoAHHw,5,2,1,0,1,0,2,0,6,0.8571428571428571,1,0.0,0,1,0,1,2,0,0,2,0,2,4,0
8633,76129,9fxxFfW4aPgoh2CUJjE52T1S8e5tZgpY,5X6FeZozNMgE2VRi3MJYjkkFK8SETtu2,24,56,16,17,11,2,8,1,111,15.857142857142858,2,0.0,24,16,13,11,32,2,4,8,1,64,47,1
8634,76137,clAPSIXt7Z3rqM3rGgd1wQzNC23LcW4e,G8EPVSXsOYB5YQWZGiz1aVq5Pgr2GrQu,1,0,0,0,0,0,1,0,1,0.14285714285714285,1,0.0,0,0,0,0,0,0,0,1,0,0,1,1
8635,76147,w7NaXVqLfb12JtbKUJJpaV8HtqNTI2Pp,RXDvfPUBYFlVdlueBFbLW0mhhAyGEqpt,9,7,5,0,2,0,6,0,20,2.857142857142857,3,0.0,0,5,0,2,7,0,0,6,0,7,13,1
8636,76157,AfNncKo8cCWFvFod2iPlCGZujMUUS876,5X6FeZozNMgE2VRi3MJYjkkFK8SETtu2,5,2,1,0,1,0,2,0,6,0.8571428571428571,1,0.0,0,1,0,1,2,0,0,2,0,2,4,1
8637,76162,1DSdmxxUMWOTHSkExvKthSEqp4DXhX5M,SpATywNh6bZuzm8s1ceuBUnMUAeoAHHw,1,0,0,0,0,0,1,0,1,0.14285714285714285,1,0.0,0,0,0,0,0,0,0,1,0,0,1,1
8638,76169,6RuWsSvS3Ngnjl37PzNAaaGn8Jd9a1lW,A3fsA9Zfv1X2fVEQhTw51lKENdNrEqT3,10,22,5,0,5,0,11,0,43,6.142857142857143,6,0.0,0,5,0,5,22,0,0,11,0,10,33,0
8639,76171,yYrk7RmkclaZIv32ppfmidCUMKYlGdCg,A3fsA9Zfv1X2fVEQhTw51lKENdNrEqT3,2,0,0,0,0,0,2,0,2,0.2857142857142857,1,0.0,0,0,0,0,0,0,0,2,0,0,2,1
8640,76175,2mxSfvrV4dprNDPX9sOXqPpvnwSid2Cc,RXDvfPUBYFlVdlueBFbLW0mhhAyGEqpt,8,5,3,0,1,0,2,0,11,1.5714285714285714,1,0.0,0,3,0,1,5,0,0,2,0,4,7,0
8641,76192,eeUPLnGQx37dkxrDcGRSCAvma26w8Yjq,RXDvfPUBYFlVdlueBFbLW0mhhAyGEqpt,9,12,6,0,2,3,7,0,30,4.285714285714286,2,0.0,0,6,0,2,12,3,0,7,0,8,22,0
8642,76196,QIvWlVh4DGWYNW4pCjLKrTx8CHKBwzBx,A3fsA9Zfv1X2fVEQhTw51lKENdNrEqT3,7,3,1,0,1,0,5,0,10,1.4285714285714286,1,0.0,0,1,0,1,3,0,0,5,0,2,8,1
8643,76221,b3SOFZmts4SmXw5596bSnHzqI34305P2,A3fsA9Zfv1X2fVEQhTw51lKENdNrEqT3,8,7,0,0,0,0,5,0,12,1.7142857142857142,1,0.0,0,0,0,0,7,0,0,5,0,0,12,1
8644,76229,xI7ax9Ka1esjgFn8PpUpxkEbwfVImQEH,SpATywNh6bZuzm8s1ceuBUnMUAeoAHHw,1,0,0,0,0,0,1,0,1,0.14285714285714285,1,0.0,0,0,0,0,0,0,0,1,0,0,1,1
8645,76232,o9SCOAY5nuSxaVorNF1mq3E0AGKQbCox,G8EPVSXsOYB5YQWZGiz1aVq5Pgr2GrQu,40,38,0,0,0,0,3,1,42,6.0,2,0.0,0,0,0,0,38,0,0,3,1,0,42,1
8646,76234,tBEEN04LrGCBpwUCJaMiCLFgfmCnlUJk,5X6FeZozNMgE2VRi3MJYjkkFK8SETtu2,1,0,0,0,0,0,1,0,1,0.14285714285714285,1,0.0,0,0,0,0,0,0,0,1,0,0,1,1
8647,76235,jByBG50ghoSer5UP92qpkAfDGFpraaH7,SpATywNh6bZuzm8s1ceuBUnMUAeoAHHw,24,55,14,25,3,8,35,1,141,20.142857142857142,6,0.0,12,14,24,3,43,8,1,35,1,53,88,0
8648,76237,tBEEN04LrGCBpwUCJaMiCLFgfmCnlUJk,A3fsA9Zfv1X2fVEQhTw51lKENdNrEqT3,1,0,0,0,0,0,1,0,1,0.14285714285714285,1,0.0,0,0,0,0,0,0,0,1,0,0,1,1
8649,76243,6RuWsSvS3Ngnjl37PzNAaaGn8Jd9a1lW,5X6FeZozNMgE2VRi3MJYjkkFK8SETtu2,6,8,2,0,3,0,5,0,18,2.5714285714285716,3,0.0,2,2,0,3,6,0,0,5,0,7,11,0
8650,76269,wXBHYtvPptXdCPYqduCnU02Sq8QZUVkp,SpATywNh6bZuzm8s1ceuBUnMUAeoAHHw,16,23,3,0,1,0,6,1,34,4.857142857142857,3,0.0,0,3,0,1,23,0,0,6,1,4,30,1
8651,76270,BCPhbcVTukJPsOtUJJbyOWvpso8GiEV1,5X6FeZozNMgE2VRi3MJYjkkFK8SETtu2,1,0,0,0,0,0,1,0,1,0.14285714285714285,1,0.0,0,0,0,0,0,0,0,1,0,0,1,1
8652,76272,BCPhbcVTukJPsOtUJJbyOWvpso8GiEV1,bWdj2GDclj5ofokWjzoa5jAwMkxCykd6,4,2,0,0,0,0,2,0,4,0.5714285714285714,1,0.0,0,0,0,0,2,0,0,2,0,0,4,1
8653,76287,PouMCXf669TnZYoflZVyLCeWfAZS1SwB,SpATywNh6bZuzm8s1ceuBUnMUAeoAHHw,1,0,0,0,0,0,1,0,1,0.14285714285714285,1,0.0,0,0,0,0,0,0,0,1,0,0,1,1
8654,76295,Slk5JcZSYHmDLQZXaNVmcMDmjJ16kBhI,bWdj2GDclj5ofokWjzoa5jAwMkxCykd6,76,141,32,176,7,7,33,2,398,56.857142857142854,17,0.0,28,32,158,7,113,7,18,33,2,225,173,0
8655,76320,BXL9nH3f6LphZe9b92PH9mstGPVs8XeE,7GRhBDsirIGkRZBtSMEzNTyDr2JQm4xx,9,2,2,0,1,2,6,0,13,1.8571428571428572,1,0.0,0,2,0,1,2,2,0,6,0,3,10,1
8656,76325,R5PVQLHQfRcyGqt0KVpTkwcmfBgB3rs1,7GRhBDsirIGkRZBtSMEzNTyDr2JQm4xx,29,67,19,12,10,4,16,0,128,18.285714285714285,7,0.0,25,19,7,10,42,4,5,16,0,61,67,0
8657,76332,kj5o7wMZl1s4q0cggcmipnm7O7L6g4Ps,7GRhBDsirIGkRZBtSMEzNTyDr2JQm4xx,4,2,1,0,1,0,1,0,5,0.7142857142857143,1,0.0,0,1,0,1,2,0,0,1,0,2,3,1
8658,76335,dSl7zOv7kGW6u17PjzlP5zgwvHOZv7rt,7GRhBDsirIGkRZBtSMEzNTyDr2JQm4xx,6,3,1,0,1,0,2,0,7,1.0,1,0.0,0,1,0,1,3,0,0,2,0,2,5,1
8659,76337,6sGNi05QsObpATkcEQjWHXDNKN41Upok,7GRhBDsirIGkRZBtSMEzNTyDr2JQm4xx,1,0,0,0,0,0,1,0,1,0.14285714285714285,1,0.0,0,0,0,0,0,0,0,1,0,0,1,1
8660,76344,iovbYKZEVn8y0HWLmItml8gjngEc7lb2,7GRhBDsirIGkRZBtSMEzNTyDr2JQm4xx,9,3,2,0,2,0,9,0,16,2.2857142857142856,1,0.0,0,2,0,2,3,0,0,9,0,4,12,0
8661,76349,oIHEiOwjcaMd5CeWZdkq4rXU3yelDWwT,7GRhBDsirIGkRZBtSMEzNTyDr2JQm4xx,42,36,10,34,12,3,12,1,108,15.428571428571429,2,0.0,14,10,19,12,22,3,15,12,1,55,53,0
8662,76354,EC7JgbRpr51TVuV7NLrdIDBFtnNPPSiG,7GRhBDsirIGkRZBtSMEzNTyDr2JQm4xx,1,0,0,0,0,0,1,0,1,0.14285714285714285,1,0.0,0,0,0,0,0,0,0,1,0,0,1,1
8663,76359,jhg3s2dxy9WdrRmT5pz5jPUSUOVpJNeP,7GRhBDsirIGkRZBtSMEzNTyDr2JQm4xx,17,22,10,0,6,0,10,0,48,6.857142857142857,1,0.0,0,10,0,6,22,0,0,10,0,16,32,1
8664,76368,Kcl98h3mNpyExmJuf2coZt58rSEztGxk,7GRhBDsirIGkRZBtSMEzNTyDr2JQm4xx,99,172,75,144,74,65,20,0,550,78.57142857142857,10,0.0,82,75,130,74,90,65,14,20,0,361,189,0
8665,76371,ROmjxRyD0zRa5rrnW4EKeskNImToIKPq,7GRhBDsirIGkRZBtSMEzNTyDr2JQm4xx,2,0,0,0,0,0,2,0,2,0.2857142857142857,1,0.0,0,0,0,0,0,0,0,2,0,0,2,1
8666,76380,r35LdxNTWJfdVQvcp8RZKTAJgxX1nfp9,5Gyp41oLVo7Gg7vF4vpmggWP5MU70QO6,7,4,3,0,2,0,3,0,12,1.7142857142857142,1,0.0,0,3,0,2,4,0,0,3,0,5,7,1
8667,76381,tZiEWSG4ckYuEfMlEJuKYvivoXtHRnol,5Gyp41oLVo7Gg7vF4vpmggWP5MU70QO6,34,44,27,0,13,41,28,4,157,22.428571428571427,9,0.0,8,27,0,13,36,41,0,28,4,48,109,0
8668,76403,F3cHapYVPmy1vgqQH9zl0AmAMhu2Xtco,5Gyp41oLVo7Gg7vF4vpmggWP5MU70QO6,1,0,0,0,0,0,1,0,1,0.14285714285714285,1,0.0,0,0,0,0,0,0,0,1,0,0,1,1
8669,76425,czTQ5ELSy91Dy79vk5MgxZdL9nunJtpb,5Gyp41oLVo7Gg7vF4vpmggWP5MU70QO6,11,15,8,0,3,0,3,0,29,4.142857142857143,3,0.0,0,8,0,3,15,0,0,3,0,11,18,1
8670,76429,0MCpaDlfe0ogU0Bpr8YdZUzqGocNSgue,5Gyp41oLVo7Gg7vF4vpmggWP5MU70QO6,1,0,0,0,0,0,1,0,1,0.14285714285714285,1,0.0,0,0,0,0,0,0,0,1,0,0,1,1
8671,76434,01REfzd0bHyPVP3nfAw98BhXBIGkncM6,5Gyp41oLVo7Gg7vF4vpmggWP5MU70QO6,1,0,0,0,0,0,1,0,1,0.14285714285714285,1,0.0,0,0,0,0,0,0,0,1,0,0,1,1
8672,76436,OcUGJyMjBmkUYRCBKiZMQQTnkl0U1Q1K,5Gyp41oLVo7Gg7vF4vpmggWP5MU70QO6,9,5,3,2,2,0,2,0,14,2.0,2,0.0,1,3,1,2,4,0,1,2,0,7,7,1
8673,76438,dpgaw2nKuBdnbOGRuhwVGCL68MKxXQr7,5Gyp41oLVo7Gg7vF4vpmggWP5MU70QO6,5,3,2,0,0,0,2,0,7,1.0,1,0.0,0,2,0,0,3,0,0,2,0,2,5,1
8674,76447,2rS9ufrltSIJVkQHjlKCjTvqcoR7anzz,5Gyp41oLVo7Gg7vF4vpmggWP5MU70QO6,6,4,3,0,0,0,3,0,10,1.4285714285714286,2,0.0,0,3,0,0,4,0,0,3,0,3,7,1
8675,76451,W38DcguBOORgyx8AQARyx9O00yMNPg6e,5Gyp41oLVo7Gg7vF4vpmggWP5MU70QO6,1,0,0,0,0,0,1,0,1,0.14285714285714285,1,0.0,0,0,0,0,0,0,0,1,0,0,1,1
8676,76453,P7HoHyQzVXLghYr6m3MYTEIsDQbHfDfp,5Gyp41oLVo7Gg7vF4vpmggWP5MU70QO6,10,11,8,0,4,0,7,0,30,4.285714285714286,4,0.0,0,8,0,4,11,0,0,7,0,12,18,1
8677,76464,HZfVkUj1UTn8X6ZLuJMgL4oCnEEXA6p2,5Gyp41oLVo7Gg7vF4vpmggWP5MU70QO6,42,89,39,3,38,4,26,1,200,28.571428571428573,8,0.0,31,39,2,38,58,4,1,26,1,110,90,0
8678,76469,Qi3PLuC7w2Yo9hFgq37MObjY8icnRdc6,5Gyp41oLVo7Gg7vF4vpmggWP5MU70QO6,41,164,68,22,39,68,35,2,398,56.857142857142854,11,0.0,40,68,15,39,124,68,7,35,2,162,236,1
8679,76471,GVRJN4wkoooaXJUVmwnX983A87KsrZPK,5Gyp41oLVo7Gg7vF4vpmggWP5MU70QO6,29,31,18,21,5,9,12,0,96,13.714285714285714,5,0.0,8,18,15,5,23,9,6,12,0,46,50,0
8680,76478,Nh4ykrZCKJQE0joZJf6OOl8TVvMpZEMx,5Gyp41oLVo7Gg7vF4vpmggWP5MU70QO6,1,0,0,0,0,0,1,0,1,0.14285714285714285,1,0.0,0,0,0,0,0,0,0,1,0,0,1,1
8681,76500,oXyTsuSH1YW2a61VoEY0YGjslddJVdhA,5Gyp41oLVo7Gg7vF4vpmggWP5MU70QO6,25,73,44,68,0,0,17,0,202,28.857142857142858,6,0.0,14,44,59,0,59,0,9,17,0,117,85,1
8682,76512,23VoQcTxASSDASFUAvUuymCcwOQv9RSj,5Gyp41oLVo7Gg7vF4vpmggWP5MU70QO6,2,0,0,0,0,0,4,0,4,0.5714285714285714,1,0.0,0,0,0,0,0,0,0,4,0,0,4,1
8683,76525,TLX7LJS0ydCwjKB1WIZECukWF1RMIWp2,5Gyp41oLVo7Gg7vF4vpmggWP5MU70QO6,7,3,2,0,2,0,2,0,9,1.2857142857142858,1,0.0,0,2,0,2,3,0,0,2,0,4,5,1
8684,76530,Blc2cPbaiLlSJOOyzIgyUkjSqEuJ1hID,5Gyp41oLVo7Gg7vF4vpmggWP5MU70QO6,10,15,7,0,2,0,10,1,35,5.0,3,0.0,2,7,0,2,13,0,0,10,1,11,24,0
8685,76538,3LhbWzGmJxAgtRjE8h3SMA5rd0ifwtoR,5Gyp41oLVo7Gg7vF4vpmggWP5MU70QO6,7,3,2,0,2,0,2,0,9,1.2857142857142858,1,0.0,0,2,0,2,3,0,0,2,0,4,5,1
8686,76547,3kmVKNRbGOm4fMFsW3dgnHkHEGKHE1G0,5Gyp41oLVo7Gg7vF4vpmggWP5MU70QO6,41,117,60,9,12,27,16,0,241,34.42857142857143,7,0.0,44,60,6,12,73,27,3,16,0,122,119,0
8687,76588,qdOxhk95r6WmeaG3FUGj8tSBbwNHowPZ,5Gyp41oLVo7Gg7vF4vpmggWP5MU70QO6,2,0,0,0,0,0,2,0,2,0.2857142857142857,1,0.0,0,0,0,0,0,0,0,2,0,0,2,1
8688,76600,zOEgMOav7CUMwRRFWKO0oz29ko7pIf8n,5Gyp41oLVo7Gg7vF4vpmggWP5MU70QO6,20,80,30,8,11,17,12,1,159,22.714285714285715,2,0.0,13,30,4,11,67,17,4,12,1,58,101,1
8689,76602,8yrIKDtnkYcLfERwrXrvcRGxHxbt2Jd3,5Gyp41oLVo7Gg7vF4vpmggWP5MU70QO6,6,16,2,0,0,0,5,0,23,3.2857142857142856,2,0.0,0,2,0,0,16,0,0,5,0,2,21,0
8690,76611,wGXRcY0FS7DP9yn6e6xwYPxjUYuVv96W,5Gyp41oLVo7Gg7vF4vpmggWP5MU70QO6,7,6,4,0,2,0,2,0,14,2.0,1,0.0,0,4,0,2,6,0,0,2,0,6,8,1
8691,76629,dZVJyJJSeeVocn7cMiTOV5aW6B1w5NEB,5Gyp41oLVo7Gg7vF4vpmggWP5MU70QO6,1,0,0,0,0,0,1,0,1,0.14285714285714285,1,0.0,0,0,0,0,0,0,0,1,0,0,1,1
8692,76637,iQ1ZOAneqV9rONJvmuuo7x6SpSQnMfuP,5Gyp41oLVo7Gg7vF4vpmggWP5MU70QO6,8,4,2,0,1,0,8,0,15,2.142857142857143,3,0.0,0,2,0,1,4,0,0,8,0,3,12,0
8693,76657,XcI7uEjIr1DmRehhSSqydR1U47iJlOYT,5Gyp41oLVo7Gg7vF4vpmggWP5MU70QO6,20,38,21,24,2,27,15,0,127,18.142857142857142,8,0.0,7,21,21,2,31,27,3,15,0,51,76,0
8694,76664,5DIZTCmFTMb3LFveBGIs4k3JMiXmUcsw,5Gyp41oLVo7Gg7vF4vpmggWP5MU70QO6,5,1,0,0,1,0,3,0,5,0.7142857142857143,1,0.0,0,0,0,1,1,0,0,3,0,1,4,1
8695,76667,RDr32Woc9myoQw2Xi6L4iYcJgFRmol6W,5Gyp41oLVo7Gg7vF4vpmggWP5MU70QO6,9,5,3,0,2,1,5,1,17,2.4285714285714284,1,0.0,0,3,0,2,5,1,0,5,1,5,12,1
8696,76686,0V5njqYhG6vk5oGbavFWKAqcyUFQti8J,5Gyp41oLVo7Gg7vF4vpmggWP5MU70QO6,9,13,4,0,1,1,11,0,30,4.285714285714286,3,0.0,0,4,0,1,13,1,0,11,0,5,25,1
8697,76690,JOkOOayftI7KyiA2jVmQZXbUOyL5Y1Sp,5Gyp41oLVo7Gg7vF4vpmggWP5MU70QO6,17,25,12,12,7,11,4,0,71,10.142857142857142,1,0.0,7,12,6,7,18,11,6,4,0,32,39,1
8698,76693,hqCEmHevHWO3zOOJGQPPXN8yqCSfkWdM,5Gyp41oLVo7Gg7vF4vpmggWP5MU70QO6,8,9,5,0,4,0,3,0,21,3.0,2,0.0,0,5,0,4,9,0,0,3,0,9,12,1
8699,76706,IN8gEmlASGy70WohZx2nMtKudBlGVvbl,5Gyp41oLVo7Gg7vF4vpmggWP5MU70QO6,7,5,1,0,1,0,2,0,9,1.2857142857142858,1,0.0,0,1,0,1,5,0,0,2,0,2,7,1
8700,76730,K7CgKRgMVffqmfQ4icZywy4tOpnKzbbo,5Gyp41oLVo7Gg7vF4vpmggWP5MU70QO6,26,48,19,24,12,1,17,4,125,17.857142857142858,5,0.0,15,19,15,12,33,1,9,17,4,61,64,1
8701,76761,aQHjMngXqegLudsDYka25fojRIIJUDh0,5Gyp41oLVo7Gg7vF4vpmggWP5MU70QO6,5,1,1,0,1,0,2,0,5,0.7142857142857143,1,0.0,0,1,0,1,1,0,0,2,0,2,3,1
8702,76786,5kiOQEoxCz9L4xn13ZLtWmbzfanKQzAY,5Gyp41oLVo7Gg7vF4vpmggWP5MU70QO6,19,48,12,6,13,11,5,0,95,13.571428571428571,4,0.0,14,12,4,13,34,11,2,5,0,43,52,0
8703,76790,I5rgeNU6h77yZVA7kJlQEH8sZiClxs9R,5Gyp41oLVo7Gg7vF4vpmggWP5MU70QO6,1,0,0,0,0,0,1,0,1,0.14285714285714285,1,0.0,0,0,0,0,0,0,0,1,0,0,1,1
8704,76807,HpN38BOEWC4MTqFjdUgj3lllv5aUQAFF,5Gyp41oLVo7Gg7vF4vpmggWP5MU70QO6,5,2,1,0,1,0,2,0,6,0.8571428571428571,1,0.0,0,1,0,1,2,0,0,2,0,2,4,1
8705,76811,txK1IajTGQpVcQ72n86NIa2loiwGFz8z,5Gyp41oLVo7Gg7vF4vpmggWP5MU70QO6,14,21,14,11,0,0,5,0,51,7.285714285714286,4,0.0,3,14,9,0,18,0,2,5,0,26,25,0
8706,76825,DPgt1nWWpEPCVlM5JMAOCZotwCwXYBrq,5Gyp41oLVo7Gg7vF4vpmggWP5MU70QO6,7,3,2,0,2,0,3,0,10,1.4285714285714286,1,0.0,0,2,0,2,3,0,0,3,0,4,6,1
8707,76828,RfQgAwEjK7W6GIZVrYc3gRVqD6FBHekC,5Gyp41oLVo7Gg7vF4vpmggWP5MU70QO6,65,1193,400,87,171,84,63,3,2001,285.85714285714283,19,0.0,528,400,47,171,665,84,40,63,3,1146,855,1
8708,76836,fmOsSyqJ3MkCLmkBTf9TaKxgCi9OoSQc,5Gyp41oLVo7Gg7vF4vpmggWP5MU70QO6,8,7,5,0,4,0,1,0,17,2.4285714285714284,1,0.0,1,5,0,4,6,0,0,1,0,10,7,1
8709,76837,QQOQ1mBFT0hbDG4vhxUnw8WQ7hq3XsN0,5Gyp41oLVo7Gg7vF4vpmggWP5MU70QO6,4,2,0,0,0,0,2,0,4,0.5714285714285714,1,0.0,0,0,0,0,2,0,0,2,0,0,4,1
8710,76846,bzKtHOPFUaea15sNycgmBf8B2nTVyZo6,5Gyp41oLVo7Gg7vF4vpmggWP5MU70QO6,65,94,51,54,22,4,20,0,245,35.0,10,0.0,29,51,45,22,65,4,9,20,0,147,98,0
8711,76858,Z8E1fWEz0b5y6BD6dlIVX2UJWlqxRpHR,5Gyp41oLVo7Gg7vF4vpmggWP5MU70QO6,28,77,39,35,18,0,14,0,183,26.142857142857142,11,0.0,21,39,29,18,56,0,6,14,0,107,76,1
8712,76861,cYibpCaMUGq0WjgUWfTv0iIvJ7QbFj5E,5Gyp41oLVo7Gg7vF4vpmggWP5MU70QO6,11,3,3,0,3,0,6,1,16,2.2857142857142856,3,0.0,0,3,0,3,3,0,0,6,1,6,10,1
8713,76876,HcXHj2yLx983REjBajdZ52KZySziWl80,5Gyp41oLVo7Gg7vF4vpmggWP5MU70QO6,2,0,0,0,0,0,4,0,4,0.5714285714285714,1,0.0,0,0,0,0,0,0,0,4,0,0,4,1
8714,76881,RcjpucDzUC1iswD9S4CPE7gWCBaAR7b9,5Gyp41oLVo7Gg7vF4vpmggWP5MU70QO6,26,86,35,32,3,16,32,7,211,30.142857142857142,9,0.0,17,35,24,3,69,16,8,32,7,79,132,0
8715,76891,aBjRmwE0qVwVv54guv7sKRAwotzxH80x,5Gyp41oLVo7Gg7vF4vpmggWP5MU70QO6,6,15,9,0,4,0,24,0,52,7.428571428571429,5,0.0,0,9,0,4,15,0,0,24,0,13,39,0
8716,76896,jtxvuHBV8ZOgNnNCL1A1WerzR2TVfFNy,5Gyp41oLVo7Gg7vF4vpmggWP5MU70QO6,47,124,71,132,26,12,16,0,381,54.42857142857143,10,0.0,32,71,115,26,92,12,17,16,0,244,137,0
8717,76908,C0QLYaW6rtZSCQAW7HOPSLZOO4bSdDa7,5Gyp41oLVo7Gg7vF4vpmggWP5MU70QO6,10,15,6,0,3,0,3,0,27,3.857142857142857,3,0.0,2,6,0,3,13,0,0,3,0,11,16,1
8718,76914,ceKKJVPiFWJDEPgwoHma8Ge3V9JM7lTS,5Gyp41oLVo7Gg7vF4vpmggWP5MU70QO6,5,5,2,0,0,0,2,0,9,1.2857142857142858,2,0.0,1,2,0,0,4,0,0,2,0,3,6,1
8719,76919,9Nmjm4BvnbKTQ3ZZwECYdKy9zBNGmQNW,5Gyp41oLVo7Gg7vF4vpmggWP5MU70QO6,1,0,0,0,0,0,1,0,1,0.14285714285714285,1,0.0,0,0,0,0,0,0,0,1,0,0,1,1
8720,76920,b2X2fnB79GNMQdIzmD5l0K2cgWGf5AR4,5Gyp41oLVo7Gg7vF4vpmggWP5MU70QO6,8,4,3,0,2,0,2,0,11,1.5714285714285714,1,0.0,0,3,0,2,4,0,0,2,0,5,6,1
8721,76949,QzYbn86ruFNwqcTxxFURk0zGhEatBUQQ,7GRhBDsirIGkRZBtSMEzNTyDr2JQm4xx,3,2,0,0,0,0,1,0,3,0.42857142857142855,1,0.0,0,0,0,0,2,0,0,1,0,0,3,0
8722,76950,e1Ni97fhQkMnOfSs68693wQS8Fze4UXJ,7GRhBDsirIGkRZBtSMEzNTyDr2JQm4xx,41,33,28,0,19,1,3,0,84,12.0,3,0.0,0,28,0,19,33,1,0,3,0,47,37,1
8723,76967,2NKObRqEjsRrxsIaHNv4gzcAP6eW660j,7GRhBDsirIGkRZBtSMEzNTyDr2JQm4xx,1,0,0,0,0,0,1,0,1,0.14285714285714285,1,0.0,0,0,0,0,0,0,0,1,0,0,1,1
8724,77031,uLw7Ns7eU6sxKEU6M5svYmkgyCUXe32f,7GRhBDsirIGkRZBtSMEzNTyDr2JQm4xx,18,29,3,5,4,0,4,0,45,6.428571428571429,1,0.0,1,3,3,4,28,0,2,4,0,11,34,0
8725,77034,s6iksgptFmyh2vfiarKdJkiKnp6RLi3f,7GRhBDsirIGkRZBtSMEzNTyDr2JQm4xx,30,54,33,0,21,11,35,3,157,22.428571428571427,6,0.0,10,33,0,21,44,11,0,35,3,64,93,0
8726,77042,h2A0iMKtZOnc2TftPlP9GQGNtfgyyhcj,7GRhBDsirIGkRZBtSMEzNTyDr2JQm4xx,1,0,0,0,0,0,1,0,1,0.14285714285714285,1,0.0,0,0,0,0,0,0,0,1,0,0,1,1
8727,77064,h18jWYSAObqvOO5XjUcCaWiyguLiAvCC,7GRhBDsirIGkRZBtSMEzNTyDr2JQm4xx,2,0,0,0,0,0,2,0,2,0.2857142857142857,1,0.0,0,0,0,0,0,0,0,2,0,0,2,1
8728,77122,Q4w60uH4MK8mN5fYaKMbhF5stFXWr0Vi,7GRhBDsirIGkRZBtSMEzNTyDr2JQm4xx,2,0,0,0,0,0,4,0,4,0.5714285714285714,1,0.0,0,0,0,0,0,0,0,4,0,0,4,1
8729,77123,s6dupzTq7IPrRZizdsz3m7uW9SFh4kDC,7GRhBDsirIGkRZBtSMEzNTyDr2JQm4xx,20,26,12,8,12,0,2,0,60,8.571428571428571,1,0.0,10,12,4,12,16,0,4,2,0,38,22,1
8730,77128,KsfSaMDW3YtqB9HKnB6Qn6E8m6zJPOJA,7GRhBDsirIGkRZBtSMEzNTyDr2JQm4xx,7,6,3,0,1,0,3,0,13,1.8571428571428572,1,0.0,1,3,0,1,5,0,0,3,0,5,8,1
8731,77148,80y9S8r32w7HjdSrNUEAoEBMUZWJtxmp,7GRhBDsirIGkRZBtSMEzNTyDr2JQm4xx,1,0,0,0,0,0,1,0,1,0.14285714285714285,1,0.0,0,0,0,0,0,0,0,1,0,0,1,1
8732,77151,CDzHyYO40Bybwfq6RBlk0Sz8LcMuVYAa,7GRhBDsirIGkRZBtSMEzNTyDr2JQm4xx,1,0,0,0,0,0,2,0,2,0.2857142857142857,1,0.0,0,0,0,0,0,0,0,2,0,0,2,1
8733,77169,Cp72CI2Sf9jM7OL4FtK9fjTjNz5WkQpA,fbPkOYLVPtPgIt0MxizjfFJov3JbHyAi,21,20,16,0,7,0,6,1,50,7.142857142857143,2,0.0,0,16,0,7,20,0,0,6,1,23,27,1
8734,77171,HBsmUsRxNy9YIFuJFQ7jYNsbYwo3J2fi,fbPkOYLVPtPgIt0MxizjfFJov3JbHyAi,2,0,0,0,0,0,4,0,4,0.5714285714285714,1,0.0,0,0,0,0,0,0,0,4,0,0,4,1
8735,77174,SAaosoVr2vtr4dixGOnJyFfsZpQgNJkr,fbPkOYLVPtPgIt0MxizjfFJov3JbHyAi,7,3,2,0,2,0,2,0,9,1.2857142857142858,1,0.0,0,2,0,2,3,0,0,2,0,4,5,1
8736,77175,uHjc02bb5yahJPEhzfl5FY8Jbd1eMOQQ,fbPkOYLVPtPgIt0MxizjfFJov3JbHyAi,6,2,1,0,1,0,4,0,8,1.1428571428571428,1,0.0,0,1,0,1,2,0,0,4,0,2,6,1
8737,77178,sgnybIqhppcE8t2VPYKo1tSMEtj9RDxf,fbPkOYLVPtPgIt0MxizjfFJov3JbHyAi,11,13,2,4,5,0,2,0,26,3.7142857142857144,1,0.0,7,2,4,5,6,0,0,2,0,18,8,1
8738,77179,eoSLO9oJFq2ypi74bXNS4eHCMDLAFDL3,fbPkOYLVPtPgIt0MxizjfFJov3JbHyAi,30,136,52,29,34,7,47,2,307,43.857142857142854,12,0.0,45,52,21,34,91,7,8,47,2,152,155,0
8739,77180,4G8giDRiV5HhGR2bRPmscEq6mPK32SgK,fbPkOYLVPtPgIt0MxizjfFJov3JbHyAi,1,0,0,0,0,0,1,0,1,0.14285714285714285,1,0.0,0,0,0,0,0,0,0,1,0,0,1,1
8740,77183,bDjOfMP0w62FEHIuWcxaWhNnsKOONfSS,fbPkOYLVPtPgIt0MxizjfFJov3JbHyAi,8,3,2,0,2,0,3,1,11,1.5714285714285714,1,0.0,0,2,0,2,3,0,0,3,1,4,7,1
8741,77186,ezX0IzuZ3J41r6pzTzeXqv8c59Uxb12M,fbPkOYLVPtPgIt0MxizjfFJov3JbHyAi,25,56,25,44,9,6,15,2,157,22.428571428571427,2,0.0,20,25,37,9,36,6,7,15,2,91,66,1
8742,77192,meLyG0wJkMmV21DuYQM3wSrWMuffsNoT,fbPkOYLVPtPgIt0MxizjfFJov3JbHyAi,6,7,1,0,2,0,2,0,12,1.7142857142857142,1,0.0,4,1,0,2,3,0,0,2,0,7,5,1
8743,77193,alkuv5SdY4gggdYWMPXddOsJJh5KuvhQ,fbPkOYLVPtPgIt0MxizjfFJov3JbHyAi,8,5,2,0,2,1,4,1,15,2.142857142857143,1,0.0,0,2,0,2,5,1,0,4,1,4,11,1
8744,77195,gir9E9ZUbwj6bCUNLD2kQmOx1nsVwG4J,fbPkOYLVPtPgIt0MxizjfFJov3JbHyAi,1,0,0,0,0,0,1,0,1,0.14285714285714285,1,0.0,0,0,0,0,0,0,0,1,0,0,1,1
8745,77196,MzVpgt6eIu33aOAUbbblQyleNNMrWM7t,fbPkOYLVPtPgIt0MxizjfFJov3JbHyAi,5,2,1,0,1,0,2,0,6,0.8571428571428571,1,0.0,0,1,0,1,2,0,0,2,0,2,4,1
8746,77199,KG6oNmBFEPQJXhvAD0RPIYEBC1kCcYzu,fbPkOYLVPtPgIt0MxizjfFJov3JbHyAi,12,12,8,2,4,0,6,0,32,4.571428571428571,1,0.0,1,8,2,4,11,0,0,6,0,15,17,1
8747,77201,syI09vfTHJXWHQvllYPBF5DBbMlFFVEK,fbPkOYLVPtPgIt0MxizjfFJov3JbHyAi,8,8,3,0,1,0,9,0,21,3.0,3,0.0,0,3,0,1,8,0,0,9,0,4,17,1
8748,77202,U7npE6DxNpBR5QQ69mhzcy60y59pDPJp,fbPkOYLVPtPgIt0MxizjfFJov3JbHyAi,7,4,3,0,3,0,2,0,12,1.7142857142857142,1,0.0,0,3,0,3,4,0,0,2,0,6,6,1
8749,77203,riM9GkB0ajSqpIPlVq4tRzOjk7wJ6NHE,fbPkOYLVPtPgIt0MxizjfFJov3JbHyAi,4,2,0,0,0,0,2,0,4,0.5714285714285714,1,0.0,0,0,0,0,2,0,0,2,0,0,4,1
8750,77204,cNbaOf1E9E66ogkJPuo6YM141nAFPTNg,fbPkOYLVPtPgIt0MxizjfFJov3JbHyAi,14,22,15,0,11,3,5,0,56,8.0,2,0.0,2,15,0,11,20,3,0,5,0,28,28,1
8751,77205,tAelht5FQdpcbtZQoKgvZA90XQy6zeRb,fbPkOYLVPtPgIt0MxizjfFJov3JbHyAi,7,5,4,0,3,0,1,0,13,1.8571428571428572,1,0.0,0,4,0,3,5,0,0,1,0,7,6,1
8752,77207,AXWWqNDiRDejTjo5V7yUaMbjtzXKhlP0,fbPkOYLVPtPgIt0MxizjfFJov3JbHyAi,12,9,5,0,2,6,8,1,31,4.428571428571429,2,0.0,1,5,0,2,8,6,0,8,1,8,23,1
8753,77217,QRNQyo9fRzqgUX2q0vTfj8EzY2qkaaCu,5Gyp41oLVo7Gg7vF4vpmggWP5MU70QO6,19,24,9,22,6,6,10,1,78,11.142857142857142,2,0.0,12,9,17,6,12,6,5,10,1,44,34,1
8754,77225,WV6kBxOjvrRHSlIpkoZong2JAf7M5bhc,5Gyp41oLVo7Gg7vF4vpmggWP5MU70QO6,9,9,4,0,3,0,4,0,20,2.857142857142857,1,0.0,0,4,0,3,9,0,0,4,0,7,13,1
8755,77254,Xj3CWtnTWB4m6gYguTHbfyC0Omwc8AeO,5Gyp41oLVo7Gg7vF4vpmggWP5MU70QO6,11,6,4,0,3,0,6,1,20,2.857142857142857,1,0.0,0,4,0,3,6,0,0,6,1,7,13,1
8756,77264,inR4nWyRwTj5VInI1qBYZxVb5NkAgObN,5Gyp41oLVo7Gg7vF4vpmggWP5MU70QO6,7,3,2,0,2,0,3,0,10,1.4285714285714286,1,0.0,0,2,0,2,3,0,0,3,0,4,6,1
8757,77267,gCxbOVEJ7FeSqOiwKbB6HzPEL3I9x6ca,5Gyp41oLVo7Gg7vF4vpmggWP5MU70QO6,15,17,9,2,2,25,9,0,64,9.142857142857142,2,0.0,5,9,1,2,12,25,1,9,0,17,47,1
8758,77274,cLY0QedPVSDHE0E9NRua57b8raELruZw,5Gyp41oLVo7Gg7vF4vpmggWP5MU70QO6,20,36,3,49,5,0,11,1,105,15.0,5,0.0,7,3,42,5,29,0,7,11,1,57,48,1
8759,77279,1APzoh3KTfIe4NQ3KAf0SKmIs5QtPkYp,fbPkOYLVPtPgIt0MxizjfFJov3JbHyAi,2,0,0,0,0,0,2,0,2,0.2857142857142857,1,0.0,0,0,0,0,0,0,0,2,0,0,2,1
8760,77280,HNOGJwV4rdRhqUou8hYUuOI1xR3yp1lD,fbPkOYLVPtPgIt0MxizjfFJov3JbHyAi,11,4,3,0,3,1,4,1,16,2.2857142857142856,1,0.0,0,3,0,3,4,1,0,4,1,6,10,1
8761,77284,a7Bcg3aa7MqnyDqhPEpyx9fS4SMptY3m,fbPkOYLVPtPgIt0MxizjfFJov3JbHyAi,6,4,1,0,1,0,2,0,8,1.1428571428571428,1,0.0,0,1,0,1,4,0,0,2,0,2,6,1
8762,77286,bmHPkhsao4f2BTxdwnZZHpZIKe38OLFK,fbPkOYLVPtPgIt0MxizjfFJov3JbHyAi,11,24,4,9,9,0,3,0,49,7.0,1,0.0,19,4,9,9,5,0,0,3,0,41,8,0
8763,77290,yjv4fWxgBh3oNe3vGpcEgJYTY3lZDEJ7,fbPkOYLVPtPgIt0MxizjfFJov3JbHyAi,12,12,6,0,3,0,4,0,25,3.5714285714285716,1,0.0,0,6,0,3,12,0,0,4,0,9,16,1
8764,77292,lYs6uTLhEyomcaec07g09oLWhf3wcIzp,fbPkOYLVPtPgIt0MxizjfFJov3JbHyAi,7,3,2,0,2,0,2,0,9,1.2857142857142858,1,0.0,0,2,0,2,3,0,0,2,0,4,5,1
8765,77293,yGzWkCztUWXAvPvFdaROSwu9Gxp9wpii,fbPkOYLVPtPgIt0MxizjfFJov3JbHyAi,41,64,44,52,10,67,10,0,247,35.285714285714285,2,0.0,10,44,47,10,54,67,5,10,0,111,136,0
8766,77295,dHUuZjpItF11lyBzOZmo46k7ssSyfCST,fbPkOYLVPtPgIt0MxizjfFJov3JbHyAi,1,0,0,0,0,0,1,0,1,0.14285714285714285,1,0.0,0,0,0,0,0,0,0,1,0,0,1,1
8767,77296,AoPMS1aocKySHG5G4KmN0kwNsp9QUjuC,fbPkOYLVPtPgIt0MxizjfFJov3JbHyAi,1,0,0,0,0,0,1,0,1,0.14285714285714285,1,0.0,0,0,0,0,0,0,0,1,0,0,1,1
8768,77299,Koz1ZA2l1oXbWFXWhjywfJjDT8YkU22X,fbPkOYLVPtPgIt0MxizjfFJov3JbHyAi,7,4,2,0,2,0,2,0,10,1.4285714285714286,1,0.0,1,2,0,2,3,0,0,2,0,5,5,1
8769,77300,nrvnGbNgEbMCBnDyUIcDWTB4Vb2f0K6G,fbPkOYLVPtPgIt0MxizjfFJov3JbHyAi,7,9,1,8,2,0,2,0,22,3.142857142857143,1,0.0,3,1,6,2,6,0,2,2,0,12,10,1
8770,77304,nknXXbQsC6Q6nMDyRKc0MDJZg6KtAXBE,fbPkOYLVPtPgIt0MxizjfFJov3JbHyAi,10,13,8,0,4,3,8,0,36,5.142857142857143,3,0.0,0,8,0,4,13,3,0,8,0,12,24,1
8771,77305,gdYB2uKieMG440BMMPn1TjGUEdcmZtra,fbPkOYLVPtPgIt0MxizjfFJov3JbHyAi,6,3,1,0,1,0,2,0,7,1.0,1,0.0,0,1,0,1,3,0,0,2,0,2,5,1
8772,77306,skAMaBabPIaxUxfkPa75q1Xs8j2018uU,fbPkOYLVPtPgIt0MxizjfFJov3JbHyAi,10,9,4,0,3,0,4,0,20,2.857142857142857,1,0.0,4,4,0,3,5,0,0,4,0,11,9,1
8773,77307,ovvuiEhj0QBv4xi11GVjXr8JhlCgaPmd,fbPkOYLVPtPgIt0MxizjfFJov3JbHyAi,1,0,0,0,0,0,1,0,1,0.14285714285714285,1,0.0,0,0,0,0,0,0,0,1,0,0,1,1
8774,77848,4s6cwLPbdRkDxHfFtEkiNoQ9RLKrwhVv,A3fsA9Zfv1X2fVEQhTw51lKENdNrEqT3,16,10,8,0,5,4,10,1,38,5.428571428571429,4,0.0,0,8,0,5,10,4,0,10,1,13,25,1
8775,77859,FbNQPrTC7bI79XxVFKHE9WIoUItnOpDj,SpATywNh6bZuzm8s1ceuBUnMUAeoAHHw,35,50,24,28,15,17,9,0,143,20.428571428571427,3,0.0,8,24,26,15,42,17,2,9,0,73,70,1
8776,77863,YV0OYizek02yKJ88HEeJHkNjkL20XUDk,SpATywNh6bZuzm8s1ceuBUnMUAeoAHHw,31,99,18,32,3,8,13,1,174,24.857142857142858,5,0.0,51,18,28,3,48,8,4,13,1,100,74,0
8777,77865,mqEWhrPz1lKF0rYKRYPaEdxo5F8aEixX,bWdj2GDclj5ofokWjzoa5jAwMkxCykd6,11,23,1,60,0,5,11,0,100,14.285714285714286,4,0.0,9,1,59,0,14,5,1,11,0,69,31,0
8778,77895,ywdL3xkp7d2PSjbvnflAvIe7Wp6Q4SRe,bWdj2GDclj5ofokWjzoa5jAwMkxCykd6,61,101,36,216,15,0,34,0,402,57.42857142857143,9,0.0,19,36,200,15,82,0,16,34,0,270,132,0
8779,77897,rxZkN71X2cLXhIjLr3jy095yRsk5XsRc,RXDvfPUBYFlVdlueBFbLW0mhhAyGEqpt,32,76,12,40,2,0,16,7,153,21.857142857142858,2,0.0,18,12,39,2,58,0,1,16,7,71,82,1
8780,77906,lzBQ7nLCxYOqaheVjLakGDqP6Wmnlnpq,A3fsA9Zfv1X2fVEQhTw51lKENdNrEqT3,2,0,0,0,0,0,2,0,2,0.2857142857142857,1,0.0,0,0,0,0,0,0,0,2,0,0,2,1
8781,77917,UpJrRBQ59x3Gn5L7s007cXh7Wi1pgqj5,A3fsA9Zfv1X2fVEQhTw51lKENdNrEqT3,1,0,0,0,0,0,1,0,1,0.14285714285714285,1,0.0,0,0,0,0,0,0,0,1,0,0,1,1
8782,77928,VMdzrbYtGV36FN9W1AkdzkH4XbMSVyDM,5X6FeZozNMgE2VRi3MJYjkkFK8SETtu2,27,46,8,76,12,0,3,0,145,20.714285714285715,3,0.0,33,8,67,12,13,0,9,3,0,120,25,1
8783,77956,1hThKgDvGcWwSWVkG0XRyCPk0C8L5ypr,SpATywNh6bZuzm8s1ceuBUnMUAeoAHHw,7,2,0,0,0,0,6,1,9,1.2857142857142858,1,0.0,0,0,0,0,2,0,0,6,1,0,9,1
8784,77959,oL1G89Phk4nduULmJ17br7A4xddcHdc4,bWdj2GDclj5ofokWjzoa5jAwMkxCykd6,1,0,0,0,0,0,2,0,2,0.2857142857142857,2,0.0,0,0,0,0,0,0,0,2,0,0,2,1
8785,77984,lmR86sBtJRFaUISdgjy7MTzO5iilHcad,G8EPVSXsOYB5YQWZGiz1aVq5Pgr2GrQu,18,8,7,0,7,4,3,0,29,4.142857142857143,1,0.0,0,7,0,7,8,4,0,3,0,14,15,1
8786,77993,c8WJAdYLV71mOx4ZXSglpCNd0dBUR3Om,A3fsA9Zfv1X2fVEQhTw51lKENdNrEqT3,162,81,47,364,30,1,41,1,565,80.71428571428571,15,0.0,6,47,357,30,75,1,7,41,1,440,125,0
8787,78000,fFuKiCeoQQwOgD8VAud2ta198Mbq05KK,bWdj2GDclj5ofokWjzoa5jAwMkxCykd6,38,95,48,76,9,266,44,0,538,76.85714285714286,10,0.0,8,48,70,9,87,266,6,44,0,135,403,0
8788,78011,G1AkjrLrzxk8VSlUiuwTegO49rw4sqVB,SpATywNh6bZuzm8s1ceuBUnMUAeoAHHw,6,4,1,0,1,0,2,0,8,1.1428571428571428,1,0.0,0,1,0,1,4,0,0,2,0,2,6,1
8789,78033,PqRGPZDwCt8mcSQTJP9YLW5JCb0jrVN9,SpATywNh6bZuzm8s1ceuBUnMUAeoAHHw,5,2,1,0,1,0,2,0,6,0.8571428571428571,1,0.0,0,1,0,1,2,0,0,2,0,2,4,1
8790,78049,92DwnWdf0DjZODrvrNNLdxmEfzQWnu5Z,bWdj2GDclj5ofokWjzoa5jAwMkxCykd6,9,5,3,0,2,0,8,1,19,2.7142857142857144,1,0.0,0,3,0,2,5,0,0,8,1,5,14,1
8791,78061,CTzsOL49UPUArAP2sAfnnQhe79FdliFF,bWdj2GDclj5ofokWjzoa5jAwMkxCykd6,8,7,2,0,3,0,2,0,14,2.0,2,0.0,2,2,0,3,5,0,0,2,0,7,7,1
8792,78074,69m94gHdGGbBNOXpX0bnvC61pSot80tW,SpATywNh6bZuzm8s1ceuBUnMUAeoAHHw,31,49,18,41,8,41,25,3,185,26.428571428571427,5,0.0,23,18,34,8,26,41,7,25,3,83,102,1
8793,78082,kVKFY3wJD9F9OUo7qKYWy4VSNf8ef9A6,SpATywNh6bZuzm8s1ceuBUnMUAeoAHHw,11,11,0,0,0,9,8,1,29,4.142857142857143,2,0.0,0,0,0,0,11,9,0,8,1,0,29,1
8794,78089,hL8JceSXib9VR5R33sNp2RkuLry7d4Yu,SpATywNh6bZuzm8s1ceuBUnMUAeoAHHw,17,22,0,37,0,0,8,0,67,9.571428571428571,2,0.0,4,0,33,0,18,0,4,8,0,37,30,1
8795,78095,pd8vtyQRUNRd6UqLQhDDx4sQEKhI3nO6,SpATywNh6bZuzm8s1ceuBUnMUAeoAHHw,15,29,3,30,0,3,14,1,80,11.428571428571429,7,0.0,9,3,26,0,20,3,4,14,1,38,42,1
8796,78101,ew5XZC7WSosl0QdXH45kYD3syMSGbOj6,SpATywNh6bZuzm8s1ceuBUnMUAeoAHHw,32,37,21,12,12,12,13,1,108,15.428571428571429,5,0.0,4,21,9,12,33,12,3,13,1,46,62,1
8797,78102,3iVQIJ2a6dmEKXpiFwzH2EedoHvLyisM,bWdj2GDclj5ofokWjzoa5jAwMkxCykd6,7,4,1,0,1,1,6,0,13,1.8571428571428572,1,0.0,0,1,0,1,4,1,0,6,0,2,11,1
8798,78113,95wznOdbj11g3FRFEWLtWETJ4xtU9Lr5,G8EPVSXsOYB5YQWZGiz1aVq5Pgr2GrQu,6,2,1,0,0,5,6,1,15,2.142857142857143,2,0.0,0,1,0,0,2,5,0,6,1,1,14,1
8799,78118,5s2QZF0oRCYI8h2ElmgC6T7pH2gEDZ5h,G8EPVSXsOYB5YQWZGiz1aVq5Pgr2GrQu,1,0,0,0,0,0,1,0,1,0.14285714285714285,1,0.0,0,0,0,0,0,0,0,1,0,0,1,1
8800,78124,ipCWNN8EoPw4ehuG3rBsqrmm1abywAYg,SpATywNh6bZuzm8s1ceuBUnMUAeoAHHw,9,8,4,0,3,0,3,0,18,2.5714285714285716,2,0.0,1,4,0,3,7,0,0,3,0,8,10,1
8801,78127,2RG1wvJ2Akp0VzrUn9TPDWB6kxO9ia9I,SpATywNh6bZuzm8s1ceuBUnMUAeoAHHw,1,0,0,0,0,0,1,0,1,0.14285714285714285,1,0.0,0,0,0,0,0,0,0,1,0,0,1,1
8802,78129,JntXNtR3vyFADq0v1flreEKkRmGG9OQK,A3fsA9Zfv1X2fVEQhTw51lKENdNrEqT3,3,1,0,0,0,0,3,0,4,0.5714285714285714,1,0.0,0,0,0,0,1,0,0,3,0,0,4,1
8803,78136,s8Jf0qU6li81AKZyIKNz4C8LkYvCndM9,SpATywNh6bZuzm8s1ceuBUnMUAeoAHHw,8,2,1,0,1,0,4,1,9,1.2857142857142858,1,0.0,0,1,0,1,2,0,0,4,1,2,7,1
8804,78149,LXuJhI2cIog5nvobdVGbKieoIrAAgMV0,A3fsA9Zfv1X2fVEQhTw51lKENdNrEqT3,13,8,6,0,4,0,3,0,21,3.0,1,0.0,0,6,0,4,8,0,0,3,0,10,11,1
8805,78152,SozAkRr5kfRi3urQaoczmRXQoW70onBa,RXDvfPUBYFlVdlueBFbLW0mhhAyGEqpt,28,146,5,2,6,0,24,1,184,26.285714285714285,4,0.0,3,5,2,6,143,0,0,24,1,16,168,1
8806,78155,6D9tNiLYL0h3Qh7QJGbRexG5UNsHPfh9,bWdj2GDclj5ofokWjzoa5jAwMkxCykd6,6,2,1,0,1,1,3,1,9,1.2857142857142858,1,0.0,0,1,0,1,2,1,0,3,1,2,7,1
8807,78193,qxN9EXLVijHnXOSweK0J0YYviNolRhYg,SpATywNh6bZuzm8s1ceuBUnMUAeoAHHw,10,6,1,0,1,2,8,2,20,2.857142857142857,1,0.0,0,1,0,1,6,2,0,8,2,2,18,1
8808,78198,WnXohtCVTjGmg2VYZ7QMusUaSQiMqg1z,SpATywNh6bZuzm8s1ceuBUnMUAeoAHHw,15,21,9,6,3,0,8,0,47,6.714285714285714,4,0.0,8,9,6,3,13,0,0,8,0,26,21,1
8809,78203,xzcwIWfHC78uxpQVEgBvu57PAv3HxSB6,5X6FeZozNMgE2VRi3MJYjkkFK8SETtu2,1,0,0,0,0,0,1,0,1,0.14285714285714285,1,0.0,0,0,0,0,0,0,0,1,0,0,1,1
8810,78207,KxuHPQOdlWxQw9hyxXdRrGHh12yzsPD2,SpATywNh6bZuzm8s1ceuBUnMUAeoAHHw,30,81,1,57,0,6,23,4,172,24.571428571428573,9,0.0,13,1,45,0,68,6,12,23,4,59,113,0
8811,78210,KioHEjkZcVkBeglI1qAOjEpPNoTwM8Q3,5X6FeZozNMgE2VRi3MJYjkkFK8SETtu2,8,14,7,0,3,0,7,0,31,4.428571428571429,1,0.0,0,7,0,3,14,0,0,7,0,10,21,1
8812,78230,Q9vRNhatkLDJJU3tGkLQZvY6VPiyvyvp,SpATywNh6bZuzm8s1ceuBUnMUAeoAHHw,12,27,2,4,2,0,2,0,37,5.285714285714286,3,0.0,6,2,3,2,21,0,1,2,0,13,24,1
8813,78253,oDMwcP97XCFhatRKDALyEk29j0A66Zee,bWdj2GDclj5ofokWjzoa5jAwMkxCykd6,10,6,3,16,4,0,11,0,40,5.714285714285714,2,0.0,3,3,14,4,3,0,2,11,0,24,16,1
8814,78254,CWfEuozBd4liyBTvOMVgNSWJo0S8l1jG,A3fsA9Zfv1X2fVEQhTw51lKENdNrEqT3,2,0,0,0,0,0,2,0,2,0.2857142857142857,1,0.0,0,0,0,0,0,0,0,2,0,0,2,1
8815,78272,wnNKMl9xF7Ymo4g0NZCDRhkVYih1owQr,SpATywNh6bZuzm8s1ceuBUnMUAeoAHHw,31,73,44,42,20,0,10,0,189,27.0,5,0.0,21,44,35,20,52,0,7,10,0,120,69,1
8816,78273,XE05vZThEHf17O6FM08AySNf2qZFgNWa,SpATywNh6bZuzm8s1ceuBUnMUAeoAHHw,36,35,23,16,12,0,6,0,92,13.142857142857142,4,0.0,8,23,16,12,27,0,0,6,0,59,33,0
8817,78287,4If157RX0kFtn3QRqNwswYxl3iATvTeY,SpATywNh6bZuzm8s1ceuBUnMUAeoAHHw,13,27,9,17,0,4,8,0,65,9.285714285714286,1,0.0,15,9,14,0,12,4,3,8,0,38,27,1
8818,78302,CwyPNNTiGuAPbLEEKCBOpScgD8z9aW45,G8EPVSXsOYB5YQWZGiz1aVq5Pgr2GrQu,7,2,1,0,1,1,7,0,12,1.7142857142857142,1,0.0,0,1,0,1,2,1,0,7,0,2,10,1
8819,78317,kGMrZZF6IokC4ENFCmz5DqVfi7S4EU7Y,A3fsA9Zfv1X2fVEQhTw51lKENdNrEqT3,11,5,4,0,4,1,4,0,18,2.5714285714285716,1,0.0,0,4,0,4,5,1,0,4,0,8,10,1
8820,78320,d7dHJyfZvhoC9wAanfH162cM80LBpWIS,SpATywNh6bZuzm8s1ceuBUnMUAeoAHHw,6,7,4,0,1,0,5,0,17,2.4285714285714284,1,0.0,2,4,0,1,5,0,0,5,0,7,10,1
8821,78323,VhJqWY1s8NggIUb1uIcah3mgkAeL4PFu,SpATywNh6bZuzm8s1ceuBUnMUAeoAHHw,1,0,0,0,0,0,1,0,1,0.14285714285714285,1,0.0,0,0,0,0,0,0,0,1,0,0,1,1
8822,78327,VhJqWY1s8NggIUb1uIcah3mgkAeL4PFu,bWdj2GDclj5ofokWjzoa5jAwMkxCykd6,1,0,0,0,0,0,1,0,1,0.14285714285714285,1,0.0,0,0,0,0,0,0,0,1,0,0,1,1
8823,78376,QAguKdvn52pCJKW91rO3BCY8l8ZCAdvQ,bWdj2GDclj5ofokWjzoa5jAwMkxCykd6,4,2,1,0,1,0,1,0,5,0.7142857142857143,1,0.0,0,1,0,1,2,0,0,1,0,2,3,0
8824,78403,yndqePvRltfbBBHRj2cAuoKRvu7Id8hO,A3fsA9Zfv1X2fVEQhTw51lKENdNrEqT3,5,2,1,0,1,0,4,0,8,1.1428571428571428,1,0.0,0,1,0,1,2,0,0,4,0,2,6,1
8825,78404,r83Hvy5kcw0EMVIlIEQofYLVkxqypRN2,A3fsA9Zfv1X2fVEQhTw51lKENdNrEqT3,10,10,7,0,0,0,10,0,27,3.857142857142857,3,0.0,0,7,0,0,10,0,0,10,0,7,20,1
8826,78411,Bz3KWhAEO9yzXIB0jVNYIzbr7mGbueA4,A3fsA9Zfv1X2fVEQhTw51lKENdNrEqT3,8,4,3,0,2,0,2,0,11,1.5714285714285714,1,0.0,0,3,0,2,4,0,0,2,0,5,6,1
8827,78414,VzHARyOCXw9czoqgTkAm6CGUmYU7yDEA,A3fsA9Zfv1X2fVEQhTw51lKENdNrEqT3,5,0,0,0,0,0,12,1,13,1.8571428571428572,2,0.0,0,0,0,0,0,0,0,12,1,0,13,1
8828,78418,XE05vZThEHf17O6FM08AySNf2qZFgNWa,A3fsA9Zfv1X2fVEQhTw51lKENdNrEqT3,23,18,14,0,11,0,2,0,45,6.428571428571429,2,0.0,1,14,0,11,17,0,0,2,0,26,19,1
8829,78425,z0WA70zlCYNC0D6ukf1TU1erCNwbETr4,SpATywNh6bZuzm8s1ceuBUnMUAeoAHHw,10,13,3,7,1,1,7,1,33,4.714285714285714,2,0.0,6,3,6,1,7,1,1,7,1,16,17,0
8830,78439,urVw10ZOKTw1O1zHFnsutUzT6EcZdTal,A3fsA9Zfv1X2fVEQhTw51lKENdNrEqT3,5,5,0,0,0,0,1,0,6,0.8571428571428571,1,0.0,0,0,0,0,5,0,0,1,0,0,6,1
8831,78450,FKaIUzhQjfUDPqxWuQzJXyqHP4qLLgRX,SpATywNh6bZuzm8s1ceuBUnMUAeoAHHw,39,87,3,56,3,12,32,3,196,28.0,6,0.0,40,3,45,3,47,12,11,32,3,91,105,0
8832,78456,eBckG9AVr6bIBOpezfRr2S1KzQMM7OtD,SpATywNh6bZuzm8s1ceuBUnMUAeoAHHw,6,7,3,0,2,0,2,0,14,2.0,2,0.0,0,3,0,2,7,0,0,2,0,5,9,1
8833,78467,J2luenZYZZPbaRbefvLso2Jyw46qiM9q,G8EPVSXsOYB5YQWZGiz1aVq5Pgr2GrQu,46,49,17,82,10,0,8,0,166,23.714285714285715,4,0.0,26,17,55,10,23,0,27,8,0,108,58,1
8834,78480,NnzxbmsIt5XwCuqd88R8ZxWHliFkPx5u,A3fsA9Zfv1X2fVEQhTw51lKENdNrEqT3,4,2,0,0,0,0,2,0,4,0.5714285714285714,1,0.0,0,0,0,0,2,0,0,2,0,0,4,1
8835,78495,btLR1bWGFkTXEBZ7Aiu8bAmygJLuQ8xU,SpATywNh6bZuzm8s1ceuBUnMUAeoAHHw,1,0,0,0,0,0,1,0,1,0.14285714285714285,1,0.0,0,0,0,0,0,0,0,1,0,0,1,1
8836,78501,OX8GRDjTfhi0f98MbIiYM0XH4DZcRvix,SpATywNh6bZuzm8s1ceuBUnMUAeoAHHw,4,2,1,0,1,0,1,0,5,0.7142857142857143,1,0.0,0,1,0,1,2,0,0,1,0,2,3,1
8837,78507,BSh5O31gIGvDrYgmsU5wxbvxaTpBXZ4G,bWdj2GDclj5ofokWjzoa5jAwMkxCykd6,38,67,23,158,14,6,11,1,280,40.0,2,0.0,20,23,148,14,47,6,10,11,1,205,75,1
8838,78511,98Rmjqd0huhIhiHJIK65vNiEBdUVwDLb,A3fsA9Zfv1X2fVEQhTw51lKENdNrEqT3,17,18,13,0,7,0,5,0,43,6.142857142857143,4,0.0,0,13,0,7,18,0,0,5,0,20,23,1
8839,78545,Ckb71Ev9RlsIUvVDfkFS0AumQJilppvB,SpATywNh6bZuzm8s1ceuBUnMUAeoAHHw,5,3,1,0,1,0,2,0,7,1.0,2,0.0,0,1,0,1,3,0,0,2,0,2,5,1
8840,78551,n2o2ZtJFwUSYSGDBSers3t9xfBVg1pV7,SpATywNh6bZuzm8s1ceuBUnMUAeoAHHw,12,13,2,0,2,0,3,0,20,2.857142857142857,2,0.0,0,2,0,2,13,0,0,3,0,4,16,1
8841,78556,cWykzNKAq5sFQBA059QN4Jx74YGPkfwB,A3fsA9Zfv1X2fVEQhTw51lKENdNrEqT3,7,5,0,0,0,0,11,0,16,2.2857142857142856,3,0.0,0,0,0,0,5,0,0,11,0,0,16,1
8842,78559,MkNNXRtvb2oEn4QkB8O2p0cdUi1EqesX,SpATywNh6bZuzm8s1ceuBUnMUAeoAHHw,9,6,3,0,2,1,7,1,20,2.857142857142857,1,0.0,0,3,0,2,6,1,0,7,1,5,15,1
8843,78562,QMBvXsBcxfHzg1mixrcjUrcMaoA4FrQo,SpATywNh6bZuzm8s1ceuBUnMUAeoAHHw,6,3,1,0,1,0,2,0,7,1.0,1,0.0,0,1,0,1,3,0,0,2,0,2,5,1
8844,78564,X8qfNjsHrwR5R67KkU9t7FXc6jQSGsyo,A3fsA9Zfv1X2fVEQhTw51lKENdNrEqT3,45,59,10,65,5,13,32,1,185,26.428571428571427,4,0.0,0,10,56,5,59,13,9,32,1,71,114,1
8845,78584,5bg7aQCg1xT3BNwuorGcguCUDl8W5Lwl,bWdj2GDclj5ofokWjzoa5jAwMkxCykd6,6,13,2,0,0,21,9,1,46,6.571428571428571,3,0.0,2,2,0,0,11,21,0,9,1,4,42,1
8846,78609,kC4wYWc6Emavjmr6JKn4tLm7xkcMHafd,5X6FeZozNMgE2VRi3MJYjkkFK8SETtu2,20,25,10,34,7,0,2,0,78,11.142857142857142,1,0.0,14,10,28,7,11,0,6,2,0,59,19,1
8847,78622,0gWJ7DFjheSDJbXHYhPpXkJuq9a45Fds,bWdj2GDclj5ofokWjzoa5jAwMkxCykd6,1,0,0,0,0,0,2,0,2,0.2857142857142857,2,0.0,0,0,0,0,0,0,0,2,0,0,2,1
8848,78627,mJ6Ucc9SqO7RDdkh3xF9KLI6sTyfYc24,SpATywNh6bZuzm8s1ceuBUnMUAeoAHHw,22,43,17,36,4,7,15,0,122,17.428571428571427,3,0.0,15,17,33,4,28,7,3,15,0,69,53,1
8849,78660,uhbUne0Zqx7l0LKNWrxxR44WistJmxKI,RXDvfPUBYFlVdlueBFbLW0mhhAyGEqpt,7,9,1,0,0,0,4,0,14,2.0,2,0.0,0,1,0,0,9,0,0,4,0,1,13,1
8850,78664,97xUfvFptTHex9YOgZiJKjEEIQ0YhjLh,bWdj2GDclj5ofokWjzoa5jAwMkxCykd6,7,5,3,0,3,4,1,0,16,2.2857142857142856,1,0.0,0,3,0,3,5,4,0,1,0,6,10,1
8851,78686,38U4yWxOl4oZXP5u7g0lCPmmavOa19Ln,A3fsA9Zfv1X2fVEQhTw51lKENdNrEqT3,11,17,3,0,3,0,8,0,31,4.428571428571429,3,0.0,0,3,0,3,17,0,0,8,0,6,25,1
8852,78691,tmJw00mRQLbE68iN3hs2GcRMynHK5cxp,A3fsA9Zfv1X2fVEQhTw51lKENdNrEqT3,44,26,19,96,11,2,7,2,163,23.285714285714285,2,0.0,3,19,83,11,23,2,13,7,2,116,47,1
8853,78700,avCGoxb1ZCWUYXGamrmyET2g851xKp7v,SpATywNh6bZuzm8s1ceuBUnMUAeoAHHw,4,6,0,0,0,0,4,0,10,1.4285714285714286,1,0.0,0,0,0,0,6,0,0,4,0,0,10,1
8854,78716,rjA1flUm5W5QdousXm9Zvd4FhEyMHlGN,SpATywNh6bZuzm8s1ceuBUnMUAeoAHHw,6,5,2,0,1,0,1,0,9,1.2857142857142858,1,0.0,0,2,0,1,5,0,0,1,0,3,6,1
8855,78733,hiYWxbK79jotdVc0LNw6xFpPROtaee83,SpATywNh6bZuzm8s1ceuBUnMUAeoAHHw,18,24,3,18,1,10,13,1,70,10.0,5,0.0,8,3,15,1,16,10,3,13,1,27,43,0
8856,78761,w7e18flx60x3aWIj6WG7yk02Ben80Ufh,SpATywNh6bZuzm8s1ceuBUnMUAeoAHHw,6,1,1,0,1,0,3,0,6,0.8571428571428571,1,0.0,0,1,0,1,1,0,0,3,0,2,4,1
8857,78765,UwNh19bGTGX7YEBtcKZFqxDpmh2gUs3A,A3fsA9Zfv1X2fVEQhTw51lKENdNrEqT3,17,17,10,0,8,0,2,0,37,5.285714285714286,2,0.0,0,10,0,8,17,0,0,2,0,18,19,1
8858,78773,Hua13xdEo1dQEcejfla3D6xiVkGTobMn,A3fsA9Zfv1X2fVEQhTw51lKENdNrEqT3,44,23,19,62,16,0,5,0,125,17.857142857142858,3,0.0,1,19,51,16,22,0,11,5,0,87,38,1
8859,78776,eAArxLyCThtu9N3Mv8rQculKbGSa66j9,A3fsA9Zfv1X2fVEQhTw51lKENdNrEqT3,9,9,6,0,1,0,6,0,22,3.142857142857143,4,0.0,0,6,0,1,9,0,0,6,0,7,15,1
8860,78793,hUKI9vR9OSrT9NXeUijAdTM2tdFNBSDI,SpATywNh6bZuzm8s1ceuBUnMUAeoAHHw,5,0,0,0,0,1,4,1,6,0.8571428571428571,1,0.0,0,0,0,0,0,1,0,4,1,0,6,1
8861,78822,WmqMKoevd5yMpzwxk3BDNFkg4y1FZjx5,A3fsA9Zfv1X2fVEQhTw51lKENdNrEqT3,18,38,3,0,2,0,8,0,51,7.285714285714286,4,0.0,1,3,0,2,37,0,0,8,0,6,45,1
8862,78826,Aig8ARodMBd76Kc3mmaMuAMQomuOW0FH,5X6FeZozNMgE2VRi3MJYjkkFK8SETtu2,4,3,1,0,0,0,2,0,6,0.8571428571428571,1,0.0,0,1,0,0,3,0,0,2,0,1,5,1
8863,78828,DLDhUvvvfnnYFJuV65Zt2yaS0jPJgvzq,RXDvfPUBYFlVdlueBFbLW0mhhAyGEqpt,1,0,0,0,0,0,1,0,1,0.14285714285714285,1,0.0,0,0,0,0,0,0,0,1,0,0,1,1
8864,78834,Ffohn9JNnGJQD2IavzMTS00ubnVtcb2T,bWdj2GDclj5ofokWjzoa5jAwMkxCykd6,72,97,47,176,21,4,32,1,378,54.0,13,0.0,20,47,150,21,77,4,26,32,1,238,140,0
8865,78843,FSe393m4kqHOdsL9YDo8QralMIqcUHdZ,A3fsA9Zfv1X2fVEQhTw51lKENdNrEqT3,39,36,1,88,1,5,19,2,152,21.714285714285715,2,0.0,4,1,71,1,32,5,17,19,2,77,75,1
8866,78852,CfllunMvXOvFI7xojIDlg3YUnXMpOZhH,SpATywNh6bZuzm8s1ceuBUnMUAeoAHHw,1,0,0,0,0,0,1,0,1,0.14285714285714285,1,0.0,0,0,0,0,0,0,0,1,0,0,1,1
8867,78879,8a6lcOY5tqRSg2M4LEQLAhRHX2NBy9qe,G8EPVSXsOYB5YQWZGiz1aVq5Pgr2GrQu,46,59,26,64,17,12,12,3,193,27.571428571428573,4,0.0,25,26,47,17,34,12,17,12,3,115,78,0
8868,78880,b5FAs3DRd36MUCxhLKFjsHu3HN0mJvs6,SpATywNh6bZuzm8s1ceuBUnMUAeoAHHw,10,28,21,0,0,5,8,6,68,9.714285714285714,2,0.0,2,21,0,0,26,5,0,8,6,23,45,1
8869,78881,toLFcom7KFecBZf6qB124Knuopx8NQmy,SpATywNh6bZuzm8s1ceuBUnMUAeoAHHw,54,79,55,52,26,2,12,2,228,32.57142857142857,4,0.0,16,55,49,26,63,2,3,12,2,146,82,0
8870,78893,m4OoBDaIG24Lym5ngdexbjC54oYFKP8C,SpATywNh6bZuzm8s1ceuBUnMUAeoAHHw,10,9,2,0,2,0,7,0,20,2.857142857142857,2,0.0,0,2,0,2,9,0,0,7,0,4,16,0
8871,78897,E96VmAw6m1AOHRckdqiq2ASKbnHBlpAb,A3fsA9Zfv1X2fVEQhTw51lKENdNrEqT3,11,27,5,2,0,0,10,0,44,6.285714285714286,4,0.0,0,5,2,0,27,0,0,10,0,7,37,0
8872,78908,tWF4e4DlILxn4rwporSArA8ZE58OsZbt,5X6FeZozNMgE2VRi3MJYjkkFK8SETtu2,5,2,1,0,1,0,2,0,6,0.8571428571428571,1,0.0,0,1,0,1,2,0,0,2,0,2,4,1
8873,78914,azVElWk7I3VwRJA3S907C5a9P0Jn3yCG,SpATywNh6bZuzm8s1ceuBUnMUAeoAHHw,16,28,21,20,9,0,2,0,80,11.428571428571429,4,0.0,4,21,16,9,24,0,4,2,0,50,30,1
8874,78923,8Sqo9fjyeTTkNJlQMuecsmvzSyQTiwcU,A3fsA9Zfv1X2fVEQhTw51lKENdNrEqT3,2,0,0,0,0,0,2,0,2,0.2857142857142857,1,0.0,0,0,0,0,0,0,0,2,0,0,2,1
8875,78926,E96VmAw6m1AOHRckdqiq2ASKbnHBlpAb,5X6FeZozNMgE2VRi3MJYjkkFK8SETtu2,4,4,2,0,0,0,5,0,11,1.5714285714285714,3,0.0,0,2,0,0,4,0,0,5,0,2,9,1
8876,78937,oZKhsAromYlsN9MhR64yAv55dJDSDM8L,A3fsA9Zfv1X2fVEQhTw51lKENdNrEqT3,43,33,15,76,10,0,6,1,141,20.142857142857142,2,0.0,1,15,63,10,32,0,13,6,1,89,52,1
8877,78947,v9rP8OpiFSURJRERz1ekVHhngFGnpcnQ,A3fsA9Zfv1X2fVEQhTw51lKENdNrEqT3,1,0,0,0,0,0,1,0,1,0.14285714285714285,1,0.0,0,0,0,0,0,0,0,1,0,0,1,1
8878,78948,0OC0czg5KrchA85VzU71XhGpYSu49K6t,SpATywNh6bZuzm8s1ceuBUnMUAeoAHHw,14,20,2,0,1,0,9,0,32,4.571428571428571,2,0.0,4,2,0,1,16,0,0,9,0,7,25,0
8879,78967,GCaUOiguxLs9b5sngb0RwjOWSkIZZOW6,G8EPVSXsOYB5YQWZGiz1aVq5Pgr2GrQu,18,24,0,26,0,0,5,0,55,7.857142857142857,2,0.0,10,0,15,0,14,0,11,5,0,25,30,1
8880,78972,ef55znmweQJrijlI0fO1Ekc271nZnV0m,SpATywNh6bZuzm8s1ceuBUnMUAeoAHHw,39,65,35,20,13,14,25,0,172,24.571428571428573,9,0.0,18,35,20,13,47,14,0,25,0,86,86,0
8881,78977,w1o1S1rsKOagmFCmrSXvpPsO3fHW3lAq,5X6FeZozNMgE2VRi3MJYjkkFK8SETtu2,6,5,3,0,1,0,2,0,11,1.5714285714285714,2,0.0,0,3,0,1,5,0,0,2,0,4,7,1
8882,78980,B07cELO2KlXRGPLctjDn89XuHJVdJwZi,SpATywNh6bZuzm8s1ceuBUnMUAeoAHHw,4,0,0,0,0,1,3,0,4,0.5714285714285714,1,0.0,0,0,0,0,0,1,0,3,0,0,4,1
8883,78981,NohnA6aI0IdpBmazHAgdTY50K8lYcWSq,A3fsA9Zfv1X2fVEQhTw51lKENdNrEqT3,8,4,3,0,3,0,2,0,12,1.7142857142857142,2,0.0,0,3,0,3,4,0,0,2,0,6,6,1
8884,78984,v6Va3YleqjOFxWX0C18ItZbiVgGPA6xX,RXDvfPUBYFlVdlueBFbLW0mhhAyGEqpt,28,62,10,20,3,29,24,2,150,21.428571428571427,7,0.0,6,10,20,3,56,29,0,24,2,39,111,1
8885,78990,bYjPoNbc5ILh7K7s9YR8HLOMNJGN6Ums,bWdj2GDclj5ofokWjzoa5jAwMkxCykd6,6,7,3,0,2,0,2,0,14,2.0,2,0.0,0,3,0,2,7,0,0,2,0,5,9,1
8886,79004,xsisvuj6gK52B2ADQNofz9kAaPqANNhO,SpATywNh6bZuzm8s1ceuBUnMUAeoAHHw,11,11,2,0,1,1,8,1,24,3.4285714285714284,2,0.0,0,2,0,1,11,1,0,8,1,3,21,1
8887,79006,mP6z9RZ14UwkQFXdxH2YSItn6R2tzg1x,SpATywNh6bZuzm8s1ceuBUnMUAeoAHHw,19,35,20,16,7,83,14,3,178,25.428571428571427,9,0.0,7,20,15,7,28,83,1,14,3,49,129,1
8888,79007,THie45OT0ypeHdwObqe2tZANN0miCnWz,SpATywNh6bZuzm8s1ceuBUnMUAeoAHHw,9,25,1,18,0,2,3,0,49,7.0,2,0.0,17,1,15,0,8,2,3,3,0,33,16,1
8889,79018,Goj0c3E01QAOXfaddEPmncKJ5Y6bAC2m,5X6FeZozNMgE2VRi3MJYjkkFK8SETtu2,1,0,0,0,0,0,1,0,1,0.14285714285714285,1,0.0,0,0,0,0,0,0,0,1,0,0,1,1
8890,79020,lYvVL2L87vZrMtNfBHPIK2tByK515zCD,SpATywNh6bZuzm8s1ceuBUnMUAeoAHHw,31,54,25,38,12,4,11,0,144,20.571428571428573,2,0.0,9,25,32,12,45,4,6,11,0,78,66,1
8891,79022,twCpzhGO216Hze2mrl4NXCjfHuwTo4Bh,SpATywNh6bZuzm8s1ceuBUnMUAeoAHHw,40,53,33,22,13,0,12,0,133,19.0,6,0.0,7,33,22,13,46,0,0,12,0,75,58,0
8892,79040,iLTS4ygaMtSYfXaaMTXBF8rpkzMAdIeB,5X6FeZozNMgE2VRi3MJYjkkFK8SETtu2,8,4,1,2,2,2,4,1,16,2.2857142857142856,1,0.0,2,1,2,2,2,2,0,4,1,7,9,1
8893,79046,L7niq1ncOBb383w11rnZfYbZzDjcQtn7,SpATywNh6bZuzm8s1ceuBUnMUAeoAHHw,1,0,0,0,0,0,1,0,1,0.14285714285714285,1,0.0,0,0,0,0,0,0,0,1,0,0,1,1
8894,79047,XEg540lTawnkyAL3QhiV5067z0uxHwgk,A3fsA9Zfv1X2fVEQhTw51lKENdNrEqT3,5,2,1,0,1,0,2,0,6,0.8571428571428571,1,0.0,0,1,0,1,2,0,0,2,0,2,4,1
8895,79052,3Ue58lEEP6phWdiZFyqYsSebxfUI01kl,G8EPVSXsOYB5YQWZGiz1aVq5Pgr2GrQu,1,0,0,0,0,0,1,0,1,0.14285714285714285,1,0.0,0,0,0,0,0,0,0,1,0,0,1,1
8896,79055,zTHTtX2nKd2KBXQuLnlYdTrAwR5h128q,SpATywNh6bZuzm8s1ceuBUnMUAeoAHHw,14,25,2,14,1,0,3,0,45,6.428571428571429,2,0.0,13,2,13,1,12,0,1,3,0,29,16,1
8897,79060,iTtOMe88nbiuPASutV8uClvRUhsz01ky,SpATywNh6bZuzm8s1ceuBUnMUAeoAHHw,14,24,1,15,1,4,2,0,47,6.714285714285714,2,0.0,10,1,13,1,14,4,2,2,0,25,22,1
8898,79061,MoBz0U3Ui9CRWte6snkIzBaarIFflstn,SpATywNh6bZuzm8s1ceuBUnMUAeoAHHw,43,58,24,53,12,2,15,3,167,23.857142857142858,4,0.0,17,24,50,12,41,2,3,15,3,103,64,1
8899,79072,J5syH0FXR6WjYKnEvVUNdcCFIQBe5xVs,SpATywNh6bZuzm8s1ceuBUnMUAeoAHHw,10,7,4,0,3,0,4,0,18,2.5714285714285716,1,0.0,0,4,0,3,7,0,0,4,0,7,11,1
8900,79076,0eMlSFoZScU7zUCIgAM0BWfQh50FQz3i,5X6FeZozNMgE2VRi3MJYjkkFK8SETtu2,29,19,5,58,5,0,1,0,88,12.571428571428571,1,0.0,13,5,53,5,6,0,5,1,0,76,12,1
8901,79091,jSkiatUtSnpEyEODEjICZMBSnZji4UaY,SpATywNh6bZuzm8s1ceuBUnMUAeoAHHw,9,11,4,0,3,0,6,0,24,3.4285714285714284,1,0.0,0,4,0,3,11,0,0,6,0,7,17,1
8902,79092,7YLwmbXkWTQcIOGJa3UGeXl0rdNkt9r0,SpATywNh6bZuzm8s1ceuBUnMUAeoAHHw,15,25,11,20,4,0,10,0,70,10.0,2,0.0,8,11,17,4,17,0,3,10,0,40,30,1
8903,79110,TpoKGwVbR1z5uy5X3SWIdHRQv5iAfdP8,G8EPVSXsOYB5YQWZGiz1aVq5Pgr2GrQu,84,86,47,212,20,13,12,1,391,55.857142857142854,3,0.0,14,47,193,20,72,13,19,12,1,274,117,0
8904,79137,uGhg5UtMcNJmxDTYVPsOvlEYnzl32Hxh,SpATywNh6bZuzm8s1ceuBUnMUAeoAHHw,1,0,0,0,0,0,1,0,1,0.14285714285714285,1,0.0,0,0,0,0,0,0,0,1,0,0,1,1
8905,79141,uGhg5UtMcNJmxDTYVPsOvlEYnzl32Hxh,bWdj2GDclj5ofokWjzoa5jAwMkxCykd6,1,0,0,0,0,0,1,0,1,0.14285714285714285,1,0.0,0,0,0,0,0,0,0,1,0,0,1,1
8906,79163,LwwIfMdYfjJJxHB8Z4Fggv4xXuygh6dE,A3fsA9Zfv1X2fVEQhTw51lKENdNrEqT3,9,22,3,0,0,0,10,0,35,5.0,6,0.0,2,3,0,0,20,0,0,10,0,5,30,1
8907,79167,Zz3pwLjAzfZui2iOxDBByv28nniL3g2U,SpATywNh6bZuzm8s1ceuBUnMUAeoAHHw,17,26,11,13,5,0,3,0,58,8.285714285714286,2,0.0,10,11,13,5,16,0,0,3,0,39,19,1
8908,79169,LwwIfMdYfjJJxHB8Z4Fggv4xXuygh6dE,bWdj2GDclj5ofokWjzoa5jAwMkxCykd6,20,33,5,42,4,15,15,0,114,16.285714285714285,8,0.0,2,5,36,4,31,15,6,15,0,47,67,0
8909,79170,h774wdF6vIIcl50Js74gckwUtlv9SBGH,SpATywNh6bZuzm8s1ceuBUnMUAeoAHHw,48,121,67,19,16,2,24,2,251,35.857142857142854,10,0.0,30,67,19,16,91,2,0,24,2,132,119,0
8910,79172,layckrYedWZgFw7etRwkXZmJxZfLSCWL,RXDvfPUBYFlVdlueBFbLW0mhhAyGEqpt,7,8,4,0,1,0,10,0,23,3.2857142857142856,4,0.0,0,4,0,1,8,0,0,10,0,5,18,1
8911,79174,D34T8AaHzLaSWIuVXlXMljij4qGduaRA,bWdj2GDclj5ofokWjzoa5jAwMkxCykd6,4,3,0,0,0,0,4,0,7,1.0,1,0.0,0,0,0,0,3,0,0,4,0,0,7,1
8912,79178,7JsrwSACMJjWauKMGXgtvQhEeYIhl4Zy,G8EPVSXsOYB5YQWZGiz1aVq5Pgr2GrQu,19,15,10,0,8,0,2,0,35,5.0,1,0.0,2,10,0,8,13,0,0,2,0,20,15,1
8913,79180,PT6UXcwKy3wc3VzHkqI3gbGZ6DxtjZzB,SpATywNh6bZuzm8s1ceuBUnMUAeoAHHw,11,12,3,0,1,0,6,0,22,3.142857142857143,3,0.0,1,3,0,1,11,0,0,6,0,5,17,0
8914,79194,0bPKxjIIw0GaiIYeAS2yIr8ZqMELBNL4,5X6FeZozNMgE2VRi3MJYjkkFK8SETtu2,3,2,0,0,0,0,1,0,3,0.42857142857142855,1,0.0,0,0,0,0,2,0,0,1,0,0,3,0
8915,79195,InUllTAkGXfLdwKOwLDshmASkFan6oBH,SpATywNh6bZuzm8s1ceuBUnMUAeoAHHw,1,0,0,0,0,0,1,0,1,0.14285714285714285,1,0.0,0,0,0,0,0,0,0,1,0,0,1,1
8916,79198,Edg0dAozE0JCiiLSAwIR5kwd1RYH2rd2,G8EPVSXsOYB5YQWZGiz1aVq5Pgr2GrQu,4,2,0,0,0,0,2,0,4,0.5714285714285714,1,0.0,0,0,0,0,2,0,0,2,0,0,4,1
8917,79238,KDatTi0m54YiEzXl0F0AXQe6UojttDHe,SpATywNh6bZuzm8s1ceuBUnMUAeoAHHw,2,0,0,0,0,0,2,0,2,0.2857142857142857,1,0.0,0,0,0,0,0,0,0,2,0,0,2,1
8918,79239,U7VST4h8u3L0dHQ2t3EXKPCnNxPfh7x1,SpATywNh6bZuzm8s1ceuBUnMUAeoAHHw,2,0,0,0,0,0,2,0,2,0.2857142857142857,1,0.0,0,0,0,0,0,0,0,2,0,0,2,1
8919,79244,Rq4yaO7GHrMIHqYMcL0bgP4mTQfRB57T,bWdj2GDclj5ofokWjzoa5jAwMkxCykd6,6,3,1,0,1,0,4,2,11,1.5714285714285714,1,0.0,0,1,0,1,3,0,0,4,2,2,9,1
8920,79263,ZnZiec7AmaGxSp844K5Oif1ySc9WoZ4f,SpATywNh6bZuzm8s1ceuBUnMUAeoAHHw,1,0,0,0,0,0,1,0,1,0.14285714285714285,1,0.0,0,0,0,0,0,0,0,1,0,0,1,1
8921,79273,DpXkrIHIAIPNESKyvFah0WhpVT5PHFeL,A3fsA9Zfv1X2fVEQhTw51lKENdNrEqT3,8,9,7,0,0,4,5,0,25,3.5714285714285716,3,0.0,0,7,0,0,9,4,0,5,0,7,18,1
8922,79281,1bKMONcV6Mq58szdlIajPdFyqaw4BvrA,A3fsA9Zfv1X2fVEQhTw51lKENdNrEqT3,5,2,1,0,1,0,2,0,6,0.8571428571428571,1,0.0,0,1,0,1,2,0,0,2,0,2,4,1
8923,79286,aGY42WVQQtCQKQRks3knIxGWrLxCy60h,5X6FeZozNMgE2VRi3MJYjkkFK8SETtu2,3,2,0,0,0,0,1,0,3,0.42857142857142855,1,0.0,0,0,0,0,2,0,0,1,0,0,3,1
8924,79287,wd4pAwN3deBeynXwR5OfOX4prNtBduEk,bWdj2GDclj5ofokWjzoa5jAwMkxCykd6,9,16,6,0,3,0,3,0,28,4.0,2,0.0,5,6,0,3,11,0,0,3,0,14,14,1
8925,79290,vtrHNbtnxRGyZem1sSOdKIp109fZtSKY,SpATywNh6bZuzm8s1ceuBUnMUAeoAHHw,29,47,27,35,12,7,11,0,139,19.857142857142858,4,0.0,10,27,31,12,37,7,4,11,0,80,59,0
8926,79299,gpn05NwMGqKm6lLZGRrnOmPlhHxlC7Wb,A3fsA9Zfv1X2fVEQhTw51lKENdNrEqT3,52,23,12,111,2,0,13,0,161,23.0,3,0.0,3,12,104,2,20,0,7,13,0,121,40,1
8927,79307,3MN9gqffGxZJqVwbda6Nr5mGlWwnaW7z,G8EPVSXsOYB5YQWZGiz1aVq5Pgr2GrQu,74,90,53,134,39,0,7,0,323,46.142857142857146,5,0.0,28,53,110,39,62,0,24,7,0,230,93,0
8928,79315,b9hN1tjIpM67gB8PuwPQ3u561lqo1V2f,A3fsA9Zfv1X2fVEQhTw51lKENdNrEqT3,30,29,23,12,19,2,12,1,98,14.0,4,0.0,1,23,12,19,28,2,0,12,1,55,43,1
8929,79316,tOQd1UTCcWjv4TzfNnDKeVxaYKZcK6zC,SpATywNh6bZuzm8s1ceuBUnMUAeoAHHw,6,7,5,0,3,0,4,0,19,2.7142857142857144,2,0.0,0,5,0,3,7,0,0,4,0,8,11,1
8930,79320,xJW8ZtKDlfhPg81A47phNyXQMCFChGTr,A3fsA9Zfv1X2fVEQhTw51lKENdNrEqT3,1,0,0,0,0,0,1,0,1,0.14285714285714285,1,0.0,0,0,0,0,0,0,0,1,0,0,1,1
8931,79325,O8PspZcvgkNwi1MucHwbb6Csnu0UqahQ,SpATywNh6bZuzm8s1ceuBUnMUAeoAHHw,7,8,4,0,3,0,1,0,16,2.2857142857142856,2,0.0,2,4,0,3,6,0,0,1,0,9,7,1
8932,79326,GzwlErGyP5vVrMuPju1CoSG91uAwN5Ll,5X6FeZozNMgE2VRi3MJYjkkFK8SETtu2,21,40,14,22,16,16,15,1,124,17.714285714285715,2,0.0,18,14,17,16,22,16,5,15,1,65,59,1
8933,79332,WQI2O3Oijx2QlB8hE2TltFPDzjM5E22B,5X6FeZozNMgE2VRi3MJYjkkFK8SETtu2,1,0,0,0,0,0,1,0,1,0.14285714285714285,1,0.0,0,0,0,0,0,0,0,1,0,0,1,1
8934,79338,pubFqThb9vS8zwU3cGWTlZ3rwYEdRpLE,SpATywNh6bZuzm8s1ceuBUnMUAeoAHHw,9,7,3,0,3,0,4,2,19,2.7142857142857144,1,0.0,0,3,0,3,7,0,0,4,2,6,13,1
8935,79352,giXuT5U1RtMqgo8IXt5j9x4mrlpr0AWq,SpATywNh6bZuzm8s1ceuBUnMUAeoAHHw,23,40,3,24,1,1,14,0,83,11.857142857142858,5,0.0,14,3,22,1,26,1,2,14,0,40,43,0
8936,79358,YUp9wnsqBKRrw8pzgc3Bo2ZNocfIQJ74,SpATywNh6bZuzm8s1ceuBUnMUAeoAHHw,5,3,1,0,1,0,3,0,8,1.1428571428571428,1,0.0,1,1,0,1,2,0,0,3,0,3,5,1
8937,79368,1aQoKDna73jstuOrupWa9Kq8V3FdvbRU,5X6FeZozNMgE2VRi3MJYjkkFK8SETtu2,6,6,1,2,3,0,1,0,13,1.8571428571428572,1,0.0,3,1,2,3,3,0,0,1,0,9,4,1
8938,79374,2Z36vzEoy2AuTF2qkFNHld62ohkbaoik,G8EPVSXsOYB5YQWZGiz1aVq5Pgr2GrQu,5,4,2,0,1,0,7,0,14,2.0,2,0.0,0,2,0,1,4,0,0,7,0,3,11,1
8939,79378,LgPlpopSU02baX8XsEJO6rWixplusEKm,SpATywNh6bZuzm8s1ceuBUnMUAeoAHHw,34,50,31,19,9,2,14,0,125,17.857142857142858,7,0.0,12,31,18,9,38,2,1,14,0,70,55,0
8940,79382,txR343znllIAYfUTT6ID4MaG49Hdxeix,A3fsA9Zfv1X2fVEQhTw51lKENdNrEqT3,12,8,7,0,4,1,12,0,32,4.571428571428571,2,0.0,1,7,0,4,7,1,0,12,0,12,20,1
8941,79392,yUyVc0xcETBdtpqOJUXovZ3QcO5gddPt,SpATywNh6bZuzm8s1ceuBUnMUAeoAHHw,10,9,5,0,2,0,3,0,19,2.7142857142857144,4,0.0,2,5,0,2,7,0,0,3,0,9,10,1
8942,79408,xrzB2fu1qTsTekSF1ue54a05GliBSiQw,G8EPVSXsOYB5YQWZGiz1aVq5Pgr2GrQu,1,0,0,0,0,0,1,0,1,0.14285714285714285,1,0.0,0,0,0,0,0,0,0,1,0,0,1,0
8943,79415,hDbCMto0j5iDn7Maxag0gQGk8WC8ErXx,A3fsA9Zfv1X2fVEQhTw51lKENdNrEqT3,1,0,0,0,0,0,1,0,1,0.14285714285714285,1,0.0,0,0,0,0,0,0,0,1,0,0,1,1
8944,79416,s1GlDLVUCJ2BKuqNJCwk2KXE92Q3fWuw,SpATywNh6bZuzm8s1ceuBUnMUAeoAHHw,2,0,0,0,0,0,2,0,2,0.2857142857142857,1,0.0,0,0,0,0,0,0,0,2,0,0,2,1
8945,79417,hDbCMto0j5iDn7Maxag0gQGk8WC8ErXx,bWdj2GDclj5ofokWjzoa5jAwMkxCykd6,1,0,0,0,0,0,1,0,1,0.14285714285714285,1,0.0,0,0,0,0,0,0,0,1,0,0,1,1
8946,79430,3MN9gqffGxZJqVwbda6Nr5mGlWwnaW7z,SpATywNh6bZuzm8s1ceuBUnMUAeoAHHw,35,80,44,37,17,0,16,0,194,27.714285714285715,5,0.0,16,44,34,17,64,0,3,16,0,111,83,0
8947,79443,FhE6YIauK1Fn9VMPL41bdd6jvfL2mFQX,SpATywNh6bZuzm8s1ceuBUnMUAeoAHHw,20,26,12,20,5,2,9,1,75,10.714285714285714,3,0.0,10,12,17,5,16,2,3,9,1,44,31,1
8948,79447,xhSNxzAdJZ3UvqN1HWRUi586YbiFg3gP,A3fsA9Zfv1X2fVEQhTw51lKENdNrEqT3,2,0,0,0,0,0,4,0,4,0.5714285714285714,1,0.0,0,0,0,0,0,0,0,4,0,0,4,1
8949,79458,onuTApdLgDnonVluLQhn0MEl8fr7acBD,SpATywNh6bZuzm8s1ceuBUnMUAeoAHHw,6,5,0,0,0,0,10,0,15,2.142857142857143,1,0.0,0,0,0,0,5,0,0,10,0,0,15,1
8950,79468,f1tp9GXe4J7KK6zPunhxBF4LGwylqtkw,A3fsA9Zfv1X2fVEQhTw51lKENdNrEqT3,1,0,0,0,0,0,1,0,1,0.14285714285714285,1,0.0,0,0,0,0,0,0,0,1,0,0,1,1
8951,79469,fu60FMGFqAwgUp8glfVKZNcdqYonSFb4,bWdj2GDclj5ofokWjzoa5jAwMkxCykd6,1,0,0,0,0,0,1,0,1,0.14285714285714285,1,0.0,0,0,0,0,0,0,0,1,0,0,1,1
8952,79478,JpLo3QIFwGWGVDbiGmNZwT1Vbl57aYGg,bWdj2GDclj5ofokWjzoa5jAwMkxCykd6,9,7,1,14,3,0,4,0,29,4.142857142857143,1,0.0,5,1,14,3,2,0,0,4,0,23,6,1
8953,79489,qtWe93d8kqRlRaOEECSUVeX06aKzKrra,5X6FeZozNMgE2VRi3MJYjkkFK8SETtu2,7,4,1,0,1,1,4,1,12,1.7142857142857142,1,0.0,0,1,0,1,4,1,0,4,1,2,10,1
8954,79498,GPbq86k98Rz9tUbijEEopIymy9u0Fcyf,RXDvfPUBYFlVdlueBFbLW0mhhAyGEqpt,24,22,18,38,5,1,5,4,93,13.285714285714286,2,0.0,3,18,30,5,19,1,8,5,4,56,37,1
8955,79511,NMqhcmmxkLiM0RcDlPlkNnMgmo9q8VT7,A3fsA9Zfv1X2fVEQhTw51lKENdNrEqT3,3,4,0,0,0,0,1,0,5,0.7142857142857143,1,0.0,0,0,0,0,4,0,0,1,0,0,5,1
8956,79516,PSAOLNrXnjwLk6spKn3AQn9MyKNbkNFR,A3fsA9Zfv1X2fVEQhTw51lKENdNrEqT3,10,7,5,0,4,0,3,0,19,2.7142857142857144,1,0.0,0,5,0,4,7,0,0,3,0,9,10,1
8957,79521,7bCBpTD7PhZ8lYzjppG3noO0NI4oSQjz,5X6FeZozNMgE2VRi3MJYjkkFK8SETtu2,5,3,1,0,1,0,2,0,7,1.0,1,0.0,0,1,0,1,3,0,0,2,0,2,5,1
8958,79530,iF24oNq097ygA95BwYxAfvpVnpWVn9EH,A3fsA9Zfv1X2fVEQhTw51lKENdNrEqT3,1,0,0,0,0,0,1,0,1,0.14285714285714285,1,0.0,0,0,0,0,0,0,0,1,0,0,1,1
8959,79540,68aPv7D3ZE4JVkIRm8IjOcsEwxcFlwFO,5X6FeZozNMgE2VRi3MJYjkkFK8SETtu2,2,0,0,0,0,0,2,0,2,0.2857142857142857,1,0.0,0,0,0,0,0,0,0,2,0,0,2,1
8960,79550,XfiCSk5eLAbq9rzQtnLkX2OQTd6M8xFG,5X6FeZozNMgE2VRi3MJYjkkFK8SETtu2,17,41,1,21,2,0,2,0,67,9.571428571428571,1,0.0,19,1,21,2,22,0,0,2,0,43,24,1
8961,79554,Ci40ficC1bpaw3mnSB9r8W1A64fHEKTq,5X6FeZozNMgE2VRi3MJYjkkFK8SETtu2,18,18,5,36,3,0,1,0,63,9.0,1,0.0,12,5,28,3,6,0,8,1,0,48,15,1
8962,79565,9XlOX9Eokvp6Ei0R3cZVPHieVEjDZ3jD,SpATywNh6bZuzm8s1ceuBUnMUAeoAHHw,1,0,0,0,0,0,1,0,1,0.14285714285714285,1,0.0,0,0,0,0,0,0,0,1,0,0,1,1
8963,79568,rZUdPpi92l1qQIS8kuhajEO9kujkZRBg,SpATywNh6bZuzm8s1ceuBUnMUAeoAHHw,20,22,9,23,3,0,6,0,63,9.0,4,0.0,12,9,21,3,10,0,2,6,0,45,18,1
8964,79580,D5cI8Qw5g3uZUHpPzRKVsXECgTB7bAYQ,SpATywNh6bZuzm8s1ceuBUnMUAeoAHHw,7,3,1,0,1,0,3,0,8,1.1428571428571428,1,0.0,0,1,0,1,3,0,0,3,0,2,6,1
8965,79582,yMKOk0dVftHnVR1CEiO9scq4ARXi4xK4,A3fsA9Zfv1X2fVEQhTw51lKENdNrEqT3,15,7,7,0,7,0,3,0,24,3.4285714285714284,2,0.0,0,7,0,7,7,0,0,3,0,14,10,0
8966,79584,ZbdgVvxsxyG1aqBQ8n6eLVu27gWAZvhX,A3fsA9Zfv1X2fVEQhTw51lKENdNrEqT3,1,0,0,0,0,0,1,0,1,0.14285714285714285,1,0.0,0,0,0,0,0,0,0,1,0,0,1,1
8967,79586,moK1GdnqoYxhSRCf5a95lgXdVNdzYrjs,5X6FeZozNMgE2VRi3MJYjkkFK8SETtu2,5,5,3,0,1,0,5,0,14,2.0,2,0.0,0,3,0,1,5,0,0,5,0,4,10,1
8968,79596,dOESZLIKPuHnZVCxKOM963mYGkTHRDgL,SpATywNh6bZuzm8s1ceuBUnMUAeoAHHw,1,0,0,0,0,0,1,0,1,0.14285714285714285,1,0.0,0,0,0,0,0,0,0,1,0,0,1,1
8969,79606,ZOTpNZ0MPCzhXQVB7FrlPGVckR2bh01V,SpATywNh6bZuzm8s1ceuBUnMUAeoAHHw,34,109,7,53,2,7,27,1,206,29.428571428571427,8,0.0,39,7,49,2,70,7,4,27,1,97,109,0
8970,79608,cqucGUKHc5OyzV7unT5Cx0FmLMjKSwuY,SpATywNh6bZuzm8s1ceuBUnMUAeoAHHw,23,30,1,25,0,1,9,1,67,9.571428571428571,3,0.0,11,1,25,0,19,1,0,9,1,37,30,1
8971,79612,WEqJEPw3UV2Mp3IuXDKYrDsEow0Eq2np,SpATywNh6bZuzm8s1ceuBUnMUAeoAHHw,22,14,9,8,7,0,3,0,41,5.857142857142857,1,0.0,5,9,8,7,9,0,0,3,0,29,12,1
8972,79614,fIRimGrxWNqdzbEvkhoxiWFjGRhUXcWW,A3fsA9Zfv1X2fVEQhTw51lKENdNrEqT3,26,41,14,0,10,0,6,0,71,10.142857142857142,4,0.0,0,14,0,10,41,0,0,6,0,24,47,0
8973,79639,HHjw6PARN0UbkiffbOwvG4RULtVIyY0R,RXDvfPUBYFlVdlueBFbLW0mhhAyGEqpt,11,19,1,0,1,4,4,0,29,4.142857142857143,3,0.0,1,1,0,1,18,4,0,4,0,3,26,0
8974,79644,tx5OZwe4nbDaE4essnf26SrQBKKIE3v3,SpATywNh6bZuzm8s1ceuBUnMUAeoAHHw,12,19,3,0,3,1,11,0,37,5.285714285714286,1,0.0,0,3,0,3,19,1,0,11,0,6,31,1
8975,79651,vQxwNbtZgUat9SDZRmE7MEKdvAizpBwk,5X6FeZozNMgE2VRi3MJYjkkFK8SETtu2,4,3,0,0,0,0,1,0,4,0.5714285714285714,1,0.0,0,0,0,0,3,0,0,1,0,0,4,1
8976,79658,MIuMzVdl8gwQZWh4ux7IRLhRo5aprHQC,A3fsA9Zfv1X2fVEQhTw51lKENdNrEqT3,24,13,10,0,10,0,2,0,35,5.0,1,0.0,0,10,0,10,13,0,0,2,0,20,15,1
8977,79664,Z8r3kWGF2ZuWSy5TZGg00SEG4qfRh2Ag,5X6FeZozNMgE2VRi3MJYjkkFK8SETtu2,1,0,0,0,0,0,1,0,1,0.14285714285714285,1,0.0,0,0,0,0,0,0,0,1,0,0,1,0
8978,79672,kzKMRE4CEMjRtmtzEE50k044KTV0exYI,A3fsA9Zfv1X2fVEQhTw51lKENdNrEqT3,4,2,0,0,0,0,2,0,4,0.5714285714285714,1,0.0,0,0,0,0,2,0,0,2,0,0,4,1
8979,79685,gcVoHE2eZKEdZoZi7osuc3qSbsrdZukl,SpATywNh6bZuzm8s1ceuBUnMUAeoAHHw,5,2,1,0,1,0,2,0,6,0.8571428571428571,1,0.0,0,1,0,1,2,0,0,2,0,2,4,1
8980,79689,yMKOk0dVftHnVR1CEiO9scq4ARXi4xK4,RXDvfPUBYFlVdlueBFbLW0mhhAyGEqpt,31,15,15,0,14,0,11,0,55,7.857142857142857,3,0.0,0,15,0,14,15,0,0,11,0,29,26,1
8981,79708,rScZ8wYdCfayAwidHm4E5aYRTim0GnWj,A3fsA9Zfv1X2fVEQhTw51lKENdNrEqT3,7,3,2,0,2,0,4,0,11,1.5714285714285714,1,0.0,0,2,0,2,3,0,0,4,0,4,7,1
8982,79716,WIkPVA3ZQexYqPa7aSal3hPiR2XYOXKW,SpATywNh6bZuzm8s1ceuBUnMUAeoAHHw,5,4,2,0,0,0,2,0,8,1.1428571428571428,1,0.0,1,2,0,0,3,0,0,2,0,3,5,1
8983,79730,DfqPNSIrdvOzcxA1l2O2553pTk1dT4j1,SpATywNh6bZuzm8s1ceuBUnMUAeoAHHw,6,3,2,0,2,0,1,0,8,1.1428571428571428,1,0.0,0,2,0,2,3,0,0,1,0,4,4,1
8984,79750,iRchfzTUfvY9CtdBwkeS8vPP8TSfaMHm,A3fsA9Zfv1X2fVEQhTw51lKENdNrEqT3,9,12,6,0,5,0,6,0,29,4.142857142857143,1,0.0,1,6,0,5,11,0,0,6,0,12,17,1
8985,79754,wYJCkBOQ32exeR75AeEladGac7kG04uu,G8EPVSXsOYB5YQWZGiz1aVq5Pgr2GrQu,2,0,0,0,0,0,2,0,2,0.2857142857142857,1,0.0,0,0,0,0,0,0,0,2,0,0,2,1
8986,79762,cRzRjCJgmuuwG5N13DvLSiSY2kvou3I1,RXDvfPUBYFlVdlueBFbLW0mhhAyGEqpt,7,3,2,0,2,0,3,0,10,1.4285714285714286,1,0.0,0,2,0,2,3,0,0,3,0,4,6,1
8987,79767,ffg9VbmMkFKj2DfO61ClA5PDHr5Xa6gN,A3fsA9Zfv1X2fVEQhTw51lKENdNrEqT3,16,37,7,0,6,0,5,0,55,7.857142857142857,5,0.0,0,7,0,6,37,0,0,5,0,13,42,1
8988,79783,MMo67tZd2HnjPcYw7tUwheGT7fqD2cqI,SpATywNh6bZuzm8s1ceuBUnMUAeoAHHw,47,69,29,52,17,28,19,4,218,31.142857142857142,3,0.0,36,29,48,17,33,28,4,19,4,130,88,0
8989,79789,WIkPVA3ZQexYqPa7aSal3hPiR2XYOXKW,A3fsA9Zfv1X2fVEQhTw51lKENdNrEqT3,42,18,16,60,13,0,2,0,109,15.571428571428571,1,0.0,1,16,52,13,17,0,8,2,0,82,27,1
8990,79797,ziI4sKMlAzhuWPMy9t2U96G01O68Dxyj,A3fsA9Zfv1X2fVEQhTw51lKENdNrEqT3,30,9,2,54,2,0,11,0,78,11.142857142857142,3,0.0,1,2,47,2,8,0,7,11,0,52,26,0
8991,79798,tFCnCHPhdyVxBnAUk6TxLus2jXyEZIZz,SpATywNh6bZuzm8s1ceuBUnMUAeoAHHw,1,0,0,0,0,0,1,0,1,0.14285714285714285,1,0.0,0,0,0,0,0,0,0,1,0,0,1,1
8992,79806,Ku1kMcdvssJWj6FcSWxZr39sjgOG0VOZ,SpATywNh6bZuzm8s1ceuBUnMUAeoAHHw,17,20,11,18,6,3,9,0,67,9.571428571428571,2,0.0,6,11,15,6,14,3,3,9,0,38,29,1
8993,79813,qMFAmPw34z5IViYTtA1Kkpcn2uEg1WBM,RXDvfPUBYFlVdlueBFbLW0mhhAyGEqpt,24,35,17,16,12,0,4,0,84,12.0,4,0.0,4,17,14,12,31,0,2,4,0,47,37,1
8994,79820,h8BwrBZ61dHhi5fhxZzTUeeYh9J3sER4,SpATywNh6bZuzm8s1ceuBUnMUAeoAHHw,2,0,0,0,0,0,2,0,2,0.2857142857142857,1,0.0,0,0,0,0,0,0,0,2,0,0,2,1
8995,79825,TsxkgE9HYxx9Zb0VBXE5lsblSSqIkd78,SpATywNh6bZuzm8s1ceuBUnMUAeoAHHw,5,15,5,0,1,0,1,0,22,3.142857142857143,1,0.0,0,5,0,1,15,0,0,1,0,6,16,1
8996,79849,g8GfWRB0OxvXROL4NPNW5ZSi8XCvG0Vj,5X6FeZozNMgE2VRi3MJYjkkFK8SETtu2,1,0,0,0,0,0,1,0,1,0.14285714285714285,1,0.0,0,0,0,0,0,0,0,1,0,0,1,1
8997,79851,g8GfWRB0OxvXROL4NPNW5ZSi8XCvG0Vj,SpATywNh6bZuzm8s1ceuBUnMUAeoAHHw,1,0,0,0,0,0,1,0,1,0.14285714285714285,1,0.0,0,0,0,0,0,0,0,1,0,0,1,1
8998,79859,gEzMd6gbgpZIm67NWd6vqHpEEo3Eo4i8,SpATywNh6bZuzm8s1ceuBUnMUAeoAHHw,7,3,2,0,2,4,5,0,16,2.2857142857142856,2,0.0,0,2,0,2,3,4,0,5,0,4,12,1
8999,79861,E2JkawM7swORjZfJKIvXjkQElhQ86LjY,SpATywNh6bZuzm8s1ceuBUnMUAeoAHHw,5,2,0,0,1,0,2,0,5,0.7142857142857143,1,0.0,0,0,0,1,2,0,0,2,0,1,4,1
9000,79872,kFWoX8WayJBb1JiJ1zWV3jeUZLUqB1uv,SpATywNh6bZuzm8s1ceuBUnMUAeoAHHw,1,0,0,0,0,0,1,0,1,0.14285714285714285,1,0.0,0,0,0,0,0,0,0,1,0,0,1,1
9001,79874,P9ocaJAKrVY3fEwlpYkQdiICF2x4gV0B,SpATywNh6bZuzm8s1ceuBUnMUAeoAHHw,1,0,0,0,0,0,1,0,1,0.14285714285714285,1,0.0,0,0,0,0,0,0,0,1,0,0,1,1
9002,79887,yonwfYKGqRaxFqA59D8fadwOwcb5hmqL,SpATywNh6bZuzm8s1ceuBUnMUAeoAHHw,45,83,36,53,17,23,29,1,242,34.57142857142857,10,0.0,26,36,49,17,57,23,4,29,1,128,114,1
9003,79893,Wd5Y51TL4njlLeYHUjz5D9nrsHvDXUZ8,bWdj2GDclj5ofokWjzoa5jAwMkxCykd6,4,2,1,0,1,0,1,0,5,0.7142857142857143,1,0.0,0,1,0,1,2,0,0,1,0,2,3,1
9004,79908,Q2dKqJgalCRkN8Z90Lq1SNPa32DtEIlR,A3fsA9Zfv1X2fVEQhTw51lKENdNrEqT3,4,2,0,0,0,0,3,0,5,0.7142857142857143,2,0.0,0,0,0,0,2,0,0,3,0,0,5,1
9005,79912,6aZq0tRjnqwqsZYSpN4QHIWtCCCKxYqK,A3fsA9Zfv1X2fVEQhTw51lKENdNrEqT3,7,3,2,0,2,0,2,0,9,1.2857142857142858,1,0.0,0,2,0,2,3,0,0,2,0,4,5,1
9006,79947,mvNsYHmLGVvx6RdgKEq4DO6WGtgd6ICk,5X6FeZozNMgE2VRi3MJYjkkFK8SETtu2,2,0,0,0,0,0,2,0,2,0.2857142857142857,1,0.0,0,0,0,0,0,0,0,2,0,0,2,1
9007,79950,mvNsYHmLGVvx6RdgKEq4DO6WGtgd6ICk,G8EPVSXsOYB5YQWZGiz1aVq5Pgr2GrQu,2,0,0,0,0,0,2,0,2,0.2857142857142857,1,0.0,0,0,0,0,0,0,0,2,0,0,2,1
9008,79951,mvNsYHmLGVvx6RdgKEq4DO6WGtgd6ICk,RXDvfPUBYFlVdlueBFbLW0mhhAyGEqpt,2,0,0,0,0,0,2,0,2,0.2857142857142857,1,0.0,0,0,0,0,0,0,0,2,0,0,2,1
9009,79954,U0h9ZcOzwmSa5zXabz3gRq51gj9CVPUf,SpATywNh6bZuzm8s1ceuBUnMUAeoAHHw,40,79,42,40,15,9,27,0,212,30.285714285714285,9,0.0,17,42,38,15,62,9,2,27,0,112,100,0
9010,79959,ViTvmoQakNqraCyfp2YEkEE863w1n9bk,A3fsA9Zfv1X2fVEQhTw51lKENdNrEqT3,13,22,15,0,12,0,7,0,56,8.0,2,0.0,1,15,0,12,21,0,0,7,0,28,28,1
9011,79973,lxjW2IwfKKnK2DrRSZaIR9GsDl9lxdt8,A3fsA9Zfv1X2fVEQhTw51lKENdNrEqT3,32,36,19,0,14,1,15,1,86,12.285714285714286,6,0.0,0,19,0,14,36,1,0,15,1,33,53,0
9012,79979,CNhJjrWccp5AYlucreTqDX8ieLTPwczE,bWdj2GDclj5ofokWjzoa5jAwMkxCykd6,1,0,0,0,0,0,1,0,1,0.14285714285714285,1,0.0,0,0,0,0,0,0,0,1,0,0,1,1
9013,79986,4LisTHudeBfv9ZX0nmcSnvoJT2p6nfzE,RXDvfPUBYFlVdlueBFbLW0mhhAyGEqpt,5,2,0,0,0,0,4,1,7,1.0,1,0.0,0,0,0,0,2,0,0,4,1,0,7,1
9014,79987,N3hAbbmjAcgnrOfHxCtYgYIWhCN4yU2c,SpATywNh6bZuzm8s1ceuBUnMUAeoAHHw,33,57,19,37,10,8,12,5,148,21.142857142857142,2,0.0,18,19,33,10,39,8,4,12,5,80,68,1
9015,79990,M0c3f3OA8Aim8kZWQMZkBlO1O030yIDl,A3fsA9Zfv1X2fVEQhTw51lKENdNrEqT3,7,4,1,0,1,0,7,0,13,1.8571428571428572,1,0.0,0,1,0,1,4,0,0,7,0,2,11,1
9016,79991,CmIaRR2qgpGVOUIbsTC8R6ZChGQweVzS,SpATywNh6bZuzm8s1ceuBUnMUAeoAHHw,1,0,0,0,0,0,1,0,1,0.14285714285714285,1,0.0,0,0,0,0,0,0,0,1,0,0,1,1
9017,79992,zYV55JtHGMyWJNzyklwx9RUxhxbuIU91,SpATywNh6bZuzm8s1ceuBUnMUAeoAHHw,16,15,11,16,0,0,6,0,48,6.857142857142857,2,0.0,2,11,13,0,13,0,3,6,0,26,22,1
9018,80003,8MTzNIeHZxoPzUB3QuA9UPwzkLipeLI2,SpATywNh6bZuzm8s1ceuBUnMUAeoAHHw,42,43,28,37,17,0,3,0,128,18.285714285714285,2,0.0,12,28,32,17,31,0,5,3,0,89,39,0
9019,80011,va3cVfF38XAjn4LEh6VxTTEdlP5IupZ2,A3fsA9Zfv1X2fVEQhTw51lKENdNrEqT3,37,25,0,52,0,0,6,0,83,11.857142857142858,1,0.0,3,0,47,0,22,0,5,6,0,50,33,1
9020,80028,HW81M2taDDpjfIALyR6RGLxMn7Z51s6I,SpATywNh6bZuzm8s1ceuBUnMUAeoAHHw,6,3,1,0,1,0,2,0,7,1.0,1,0.0,0,1,0,1,3,0,0,2,0,2,5,1
9021,80047,QjwQzuiA6TAJjCb0ag4sYfZRjiTOPACp,SpATywNh6bZuzm8s1ceuBUnMUAeoAHHw,36,67,40,26,21,1,20,0,175,25.0,8,0.0,6,40,22,21,61,1,4,20,0,89,86,0
9022,80052,dALdfMzfktV6uHq0TdqzSFS1vTHWuBBf,RXDvfPUBYFlVdlueBFbLW0mhhAyGEqpt,1,0,0,0,0,0,1,0,1,0.14285714285714285,1,0.0,0,0,0,0,0,0,0,1,0,0,1,1
9023,80060,PeuNsQ0DfVUJN0dfnSQ4wu6EhabO3RIr,SpATywNh6bZuzm8s1ceuBUnMUAeoAHHw,6,11,4,0,2,0,5,0,22,3.142857142857143,2,0.0,0,4,0,2,11,0,0,5,0,6,16,1
9024,80068,u88ty77IjrBmBqGSc7g01hskCAQHKUhV,SpATywNh6bZuzm8s1ceuBUnMUAeoAHHw,1,0,0,0,0,0,1,0,1,0.14285714285714285,1,0.0,0,0,0,0,0,0,0,1,0,0,1,1
9025,80069,srJeJbIuD6nlvLtYdUFiQcvh7X1ghk8m,A3fsA9Zfv1X2fVEQhTw51lKENdNrEqT3,1,0,0,0,0,0,1,0,1,0.14285714285714285,1,0.0,0,0,0,0,0,0,0,1,0,0,1,1
9026,80090,IAOTVxG7e06ArppQIZcVBCeppiZS52Zi,bWdj2GDclj5ofokWjzoa5jAwMkxCykd6,1,0,0,0,0,0,1,0,1,0.14285714285714285,1,0.0,0,0,0,0,0,0,0,1,0,0,1,1
9027,80096,IAOTVxG7e06ArppQIZcVBCeppiZS52Zi,A3fsA9Zfv1X2fVEQhTw51lKENdNrEqT3,1,0,0,0,0,0,1,0,1,0.14285714285714285,1,0.0,0,0,0,0,0,0,0,1,0,0,1,1
9028,80097,RPansaKc9yPYyKahcqLAJO6a0GoBHglr,bWdj2GDclj5ofokWjzoa5jAwMkxCykd6,10,16,6,32,6,7,6,0,73,10.428571428571429,4,0.0,7,6,30,6,9,7,2,6,0,49,24,1
9029,80124,CUvKB4XQpBmSBshZw5ZdyRvSPwxCLw87,SpATywNh6bZuzm8s1ceuBUnMUAeoAHHw,1,0,0,0,0,0,1,0,1,0.14285714285714285,1,0.0,0,0,0,0,0,0,0,1,0,0,1,1
9030,80132,hnPqEloZo6dqHCQR5BDkkOtRq9rLOuCJ,RXDvfPUBYFlVdlueBFbLW0mhhAyGEqpt,2,0,0,0,0,0,2,0,2,0.2857142857142857,1,0.0,0,0,0,0,0,0,0,2,0,0,2,1
9031,80136,XQFWhrsULMJrGiXoFieAPwx4Rm1ETQ8D,SpATywNh6bZuzm8s1ceuBUnMUAeoAHHw,58,83,46,57,20,2,18,0,226,32.285714285714285,10,0.0,23,46,55,20,60,2,2,18,0,144,82,0
9032,80140,yvsrEHHhwnRtY4nOPyuGoTME5YnK10XZ,SpATywNh6bZuzm8s1ceuBUnMUAeoAHHw,6,7,1,0,1,0,2,0,11,1.5714285714285714,1,0.0,0,1,0,1,7,0,0,2,0,2,9,1
9033,80145,LW6Tlr1sh6qRnRRoccMyoktiDikrPY7X,SpATywNh6bZuzm8s1ceuBUnMUAeoAHHw,5,2,1,0,1,0,2,0,6,0.8571428571428571,1,0.0,0,1,0,1,2,0,0,2,0,2,4,1
9034,80153,WltsLfDHgmeE6MCb49VMxs0TpIKzPZYO,SpATywNh6bZuzm8s1ceuBUnMUAeoAHHw,6,3,1,0,1,0,2,0,7,1.0,1,0.0,0,1,0,1,3,0,0,2,0,2,5,1
9035,80167,P4jUBX1wYi9y3sCR2kOEae0bW8qmRIv0,SpATywNh6bZuzm8s1ceuBUnMUAeoAHHw,8,13,6,0,3,0,6,0,28,4.0,1,0.0,0,6,0,3,13,0,0,6,0,9,19,1
9036,80196,y6xjaNTFuIUic3qLUBgR8svfOIFXDQ53,A3fsA9Zfv1X2fVEQhTw51lKENdNrEqT3,2,0,0,0,0,0,4,0,4,0.5714285714285714,1,0.0,0,0,0,0,0,0,0,4,0,0,4,1
9037,80202,fmLFfxTDbxBjR0ZGqW3ABKUJvjXC97BH,RXDvfPUBYFlVdlueBFbLW0mhhAyGEqpt,8,3,1,0,1,0,4,1,10,1.4285714285714286,1,0.0,0,1,0,1,3,0,0,4,1,2,8,1
9038,80203,TcTuC5hiyHRmVc5qZWpzVJY3ugVLXB30,5X6FeZozNMgE2VRi3MJYjkkFK8SETtu2,2,0,0,0,0,0,3,0,3,0.42857142857142855,1,0.0,0,0,0,0,0,0,0,3,0,0,3,1
9039,80207,53qrF6M0dMx7kKnOiKvVv5yJevXuY3XD,RXDvfPUBYFlVdlueBFbLW0mhhAyGEqpt,52,33,21,87,10,5,10,7,173,24.714285714285715,2,0.0,8,21,79,10,25,5,8,10,7,118,55,1
9040,80208,A6qBZik0VBfWjUh1l97ldNrUQvZV7VDA,bWdj2GDclj5ofokWjzoa5jAwMkxCykd6,8,5,2,0,2,0,4,0,13,1.8571428571428572,2,0.0,0,2,0,2,5,0,0,4,0,4,9,1
9041,80226,IVH8kKmCoTvdDqBRydeePjJ8DeEc5nxo,G8EPVSXsOYB5YQWZGiz1aVq5Pgr2GrQu,12,7,1,8,2,2,9,1,30,4.285714285714286,2,0.0,4,1,5,2,3,2,3,9,1,12,18,1
9042,80231,v20UMppd3ocHkd49REEhfohYTaesL83r,SpATywNh6bZuzm8s1ceuBUnMUAeoAHHw,6,9,4,0,2,0,5,0,20,2.857142857142857,5,0.0,3,4,0,2,6,0,0,5,0,9,11,1
9043,80243,JouvtE8n4ChPr4xaVaDvsPHmw4GRKG3o,SpATywNh6bZuzm8s1ceuBUnMUAeoAHHw,2,0,0,0,0,0,2,0,2,0.2857142857142857,1,0.0,0,0,0,0,0,0,0,2,0,0,2,1
9044,80256,qbxr7nsJKbupU2nnOZ4AXSvMY5DklIDV,SpATywNh6bZuzm8s1ceuBUnMUAeoAHHw,27,36,20,1,10,0,11,0,78,11.142857142857142,6,0.0,6,20,1,10,30,0,0,11,0,37,41,0
9045,80258,AlLFcyRB5UwpN8dJK67Vqu0OFPpIDrGm,A3fsA9Zfv1X2fVEQhTw51lKENdNrEqT3,75,72,57,168,35,18,14,0,364,52.0,7,0.0,4,57,137,35,68,18,31,14,0,233,131,0
9046,80259,BJsE566nx9Uhzip3qBQTh9T7yFdMy0IZ,SpATywNh6bZuzm8s1ceuBUnMUAeoAHHw,6,4,1,0,1,0,1,0,7,1.0,1,0.0,0,1,0,1,4,0,0,1,0,2,5,1
9047,80283,TY4t65XwSRMNK0q3MPTxoH0jDDniCwnz,bWdj2GDclj5ofokWjzoa5jAwMkxCykd6,1,0,0,0,0,0,1,0,1,0.14285714285714285,1,0.0,0,0,0,0,0,0,0,1,0,0,1,1
9048,80287,TY4t65XwSRMNK0q3MPTxoH0jDDniCwnz,RXDvfPUBYFlVdlueBFbLW0mhhAyGEqpt,2,0,0,0,0,0,2,0,2,0.2857142857142857,1,0.0,0,0,0,0,0,0,0,2,0,0,2,1
9049,80288,TY4t65XwSRMNK0q3MPTxoH0jDDniCwnz,A3fsA9Zfv1X2fVEQhTw51lKENdNrEqT3,1,0,0,0,0,0,1,0,1,0.14285714285714285,1,0.0,0,0,0,0,0,0,0,1,0,0,1,1
9050,80289,ZNeDcv9lqRN7ZQjZM2CkfhEwlbeNJpas,SpATywNh6bZuzm8s1ceuBUnMUAeoAHHw,29,24,15,22,7,3,14,2,87,12.428571428571429,5,0.0,4,15,21,7,20,3,1,14,2,47,40,0
9051,80298,TY4t65XwSRMNK0q3MPTxoH0jDDniCwnz,SpATywNh6bZuzm8s1ceuBUnMUAeoAHHw,1,0,0,0,0,0,1,0,1,0.14285714285714285,1,0.0,0,0,0,0,0,0,0,1,0,0,1,1
9052,80323,I90xPqkS9HpEgNxHw8dM4fDCcTPeHknd,5X6FeZozNMgE2VRi3MJYjkkFK8SETtu2,1,0,0,0,0,0,1,0,1,0.14285714285714285,1,0.0,0,0,0,0,0,0,0,1,0,0,1,1
9053,80324,I90xPqkS9HpEgNxHw8dM4fDCcTPeHknd,A3fsA9Zfv1X2fVEQhTw51lKENdNrEqT3,1,0,0,0,0,0,1,0,1,0.14285714285714285,1,0.0,0,0,0,0,0,0,0,1,0,0,1,1
9054,80333,3BztBUlI63kL9yRcRfPOmeFpKMf9EWqH,SpATywNh6bZuzm8s1ceuBUnMUAeoAHHw,13,24,5,16,3,0,1,0,49,7.0,1,0.0,15,5,13,3,9,0,3,1,0,36,13,1
9055,80339,XT1waMohYamMih4d0cft0xqoQTrmFfop,SpATywNh6bZuzm8s1ceuBUnMUAeoAHHw,5,2,1,0,1,0,4,0,8,1.1428571428571428,1,0.0,0,1,0,1,2,0,0,4,0,2,6,1
9056,80344,EFMEoi5W4mceo8rjft5LKrYvvT3E2eat,A3fsA9Zfv1X2fVEQhTw51lKENdNrEqT3,6,4,1,0,1,0,3,0,9,1.2857142857142858,2,0.0,0,1,0,1,4,0,0,3,0,2,7,1
9057,80347,XEEROzXFwjY4oyjlmSc2mETyORRAjvE9,RXDvfPUBYFlVdlueBFbLW0mhhAyGEqpt,1,0,0,0,0,0,1,0,1,0.14285714285714285,1,0.0,0,0,0,0,0,0,0,1,0,0,1,1
9058,80348,9D8Fr85Y0xJSTSvXENunTRQkQQzpKKhe,bWdj2GDclj5ofokWjzoa5jAwMkxCykd6,19,24,14,72,4,4,14,1,133,19.0,5,0.0,5,14,68,4,19,4,4,14,1,91,42,1
9059,80349,d7Yl1K2nrAPh1Q4Gl4OFPqaLmDsQKnZb,SpATywNh6bZuzm8s1ceuBUnMUAeoAHHw,11,10,1,3,0,0,2,0,16,2.2857142857142856,1,0.0,4,1,3,0,6,0,0,2,0,8,8,1
9060,80360,eShFyPGgCT65uThL7XGiKvmljTNciFAA,G8EPVSXsOYB5YQWZGiz1aVq5Pgr2GrQu,34,54,8,50,8,6,17,1,144,20.571428571428573,4,0.0,15,8,36,8,39,6,14,17,1,67,77,1
9061,80373,YrgwsEFjLyT5SXSOyIIpFlTBfXK1acSP,bWdj2GDclj5ofokWjzoa5jAwMkxCykd6,19,17,7,32,7,1,5,2,71,10.142857142857142,2,0.0,8,7,25,7,9,1,7,5,2,47,24,0
9062,80396,3B3YADugrZ4bBgjxxClgqtVXSh5LmkAW,SpATywNh6bZuzm8s1ceuBUnMUAeoAHHw,9,5,4,0,4,0,2,0,15,2.142857142857143,2,0.0,0,4,0,4,5,0,0,2,0,8,7,1
9063,80400,xH5f8nfW6oTIgHjXoQgEUKIx6qvDN8rk,A3fsA9Zfv1X2fVEQhTw51lKENdNrEqT3,5,4,0,0,0,0,6,0,10,1.4285714285714286,3,0.0,0,0,0,0,4,0,0,6,0,0,10,1
9064,80406,9d6HoNqzGbbCd66bGVck7uPSgkXTez3M,G8EPVSXsOYB5YQWZGiz1aVq5Pgr2GrQu,14,26,5,4,5,0,10,0,50,7.142857142857143,6,0.0,11,5,3,5,15,0,1,10,0,24,26,1
9065,80429,3WaaFhQhqNoXoyRVVZyUHNenDiDckaYh,bWdj2GDclj5ofokWjzoa5jAwMkxCykd6,1,0,0,0,0,0,1,0,1,0.14285714285714285,1,0.0,0,0,0,0,0,0,0,1,0,0,1,1
9066,80437,ef12hM7jr4TcIrwraImsdOigb7ZzGQBR,SpATywNh6bZuzm8s1ceuBUnMUAeoAHHw,13,18,1,12,1,2,4,0,38,5.428571428571429,3,0.0,3,1,12,1,15,2,0,4,0,17,21,1
9067,80438,Ne25k1DU4nK81LWo7930HvBFWlFV2ZKt,5X6FeZozNMgE2VRi3MJYjkkFK8SETtu2,7,4,2,0,1,0,4,0,11,1.5714285714285714,1,0.0,0,2,0,1,4,0,0,4,0,3,8,1
9068,80439,hw4USDUss7xpmyvWKsTyQsT2eAX2LBFT,SpATywNh6bZuzm8s1ceuBUnMUAeoAHHw,1,0,0,0,0,0,1,0,1,0.14285714285714285,1,0.0,0,0,0,0,0,0,0,1,0,0,1,1
9069,80442,d50GHjVwwNPRl6KQMtLsCG0z8s5vd7XF,bWdj2GDclj5ofokWjzoa5jAwMkxCykd6,4,2,0,0,0,0,2,0,4,0.5714285714285714,1,0.0,0,0,0,0,2,0,0,2,0,0,4,1
9070,80452,oIncNl2qqfpjBksI2zhFahnNU9rnYXqO,SpATywNh6bZuzm8s1ceuBUnMUAeoAHHw,8,5,1,0,1,2,6,1,16,2.2857142857142856,2,0.0,0,1,0,1,5,2,0,6,1,2,14,1
9071,80454,SicKtTdinGjYgkh3dK0y8UiEfELy0LiN,bWdj2GDclj5ofokWjzoa5jAwMkxCykd6,5,6,2,0,0,0,7,0,15,2.142857142857143,3,0.0,0,2,0,0,6,0,0,7,0,2,13,1
9072,80455,zB3DnodqJETqBAtFNKyb5VwXIslDdCgP,RXDvfPUBYFlVdlueBFbLW0mhhAyGEqpt,24,15,14,0,11,0,2,0,42,6.0,1,0.0,0,14,0,11,15,0,0,2,0,25,17,1
9073,80462,6I4onWELkk7bHacbwPRHkBZyFy5av4gK,G8EPVSXsOYB5YQWZGiz1aVq5Pgr2GrQu,1,0,0,0,0,0,1,0,1,0.14285714285714285,1,0.0,0,0,0,0,0,0,0,1,0,0,1,1
9074,80464,KY2OGJhlQwlrWsxzAaVbFxD3T2YixWes,SpATywNh6bZuzm8s1ceuBUnMUAeoAHHw,19,35,0,39,0,0,6,0,80,11.428571428571429,1,0.0,17,0,32,0,18,0,7,6,0,49,31,1
9075,80475,53qrF6M0dMx7kKnOiKvVv5yJevXuY3XD,bWdj2GDclj5ofokWjzoa5jAwMkxCykd6,16,11,5,32,4,2,6,1,61,8.714285714285714,1,0.0,4,5,27,4,7,2,5,6,1,40,21,1
9076,80505,I7kUxTrFR4kUt4IUmZUgm3AQtDQNh7Pu,G8EPVSXsOYB5YQWZGiz1aVq5Pgr2GrQu,22,27,24,36,10,4,31,0,132,18.857142857142858,5,0.0,0,24,28,10,27,4,8,31,0,62,70,0
9077,80512,Of5W8KonUNuLgzthIAJI1wlPDbxM4WvO,5X6FeZozNMgE2VRi3MJYjkkFK8SETtu2,1,0,0,0,0,0,1,0,1,0.14285714285714285,1,0.0,0,0,0,0,0,0,0,1,0,0,1,1
9078,80518,vrIS3rOFH8II8t7yTEWKp29B27kjVKhm,RXDvfPUBYFlVdlueBFbLW0mhhAyGEqpt,2,0,0,0,0,0,2,0,2,0.2857142857142857,1,0.0,0,0,0,0,0,0,0,2,0,0,2,1
9079,80537,LPlZQJB3VT531jm1uSCcLkocTrYuWDuM,SpATywNh6bZuzm8s1ceuBUnMUAeoAHHw,5,2,0,0,0,0,3,0,5,0.7142857142857143,1,0.0,0,0,0,0,2,0,0,3,0,0,5,1
9080,80550,CXCaJpUSDS18xEbIkOvQDpHLpsuhXdw4,A3fsA9Zfv1X2fVEQhTw51lKENdNrEqT3,6,3,1,0,1,0,2,0,7,1.0,1,0.0,0,1,0,1,3,0,0,2,0,2,5,1
9081,80561,0TYsGSagjtpdvts8BjnEYwbdzO0Cq9cu,bWdj2GDclj5ofokWjzoa5jAwMkxCykd6,11,26,13,0,4,2,19,1,65,9.285714285714286,4,0.0,3,13,0,4,23,2,0,19,1,20,45,1
9082,80563,ZjWuXv8EONEQWoGCaTlXceVXFgdHRHNG,A3fsA9Zfv1X2fVEQhTw51lKENdNrEqT3,24,12,1,58,0,0,2,0,73,10.428571428571429,1,0.0,1,1,47,0,11,0,11,2,0,49,24,1
9083,80564,qWUac1M6H0GGCt2oRkcCo2PK0QcGvZVS,A3fsA9Zfv1X2fVEQhTw51lKENdNrEqT3,9,9,1,8,0,0,2,0,20,2.857142857142857,2,0.0,1,1,8,0,8,0,0,2,0,10,10,1
9084,80567,RDBly29xbybxfRPXjsOP81xd2Sgww6yI,5X6FeZozNMgE2VRi3MJYjkkFK8SETtu2,19,20,9,16,6,0,3,0,54,7.714285714285714,1,0.0,9,9,14,6,11,0,2,3,0,38,16,1
9085,80568,ADKumVbkV9N5Z2ohQ2vgzJz2AGQtvwrg,G8EPVSXsOYB5YQWZGiz1aVq5Pgr2GrQu,2,0,0,0,0,0,2,0,2,0.2857142857142857,1,0.0,0,0,0,0,0,0,0,2,0,0,2,1
9086,80594,7U17eU07Q58xc6IhNX4TREySfrRlxt89,SpATywNh6bZuzm8s1ceuBUnMUAeoAHHw,5,2,1,0,1,0,2,0,6,0.8571428571428571,1,0.0,0,1,0,1,2,0,0,2,0,2,4,1
9087,80598,OLmaTq1VRWq8uhF6WwamKt59rXmIqMgh,bWdj2GDclj5ofokWjzoa5jAwMkxCykd6,1,0,0,0,0,0,1,0,1,0.14285714285714285,1,0.0,0,0,0,0,0,0,0,1,0,0,1,1
9088,80602,gpn05NwMGqKm6lLZGRrnOmPlhHxlC7Wb,bWdj2GDclj5ofokWjzoa5jAwMkxCykd6,1,0,0,0,0,0,1,0,1,0.14285714285714285,1,0.0,0,0,0,0,0,0,0,1,0,0,1,1
9089,80608,ci9OqCUCFmkuIFOKMHsPsoK829Gh2eXP,SpATywNh6bZuzm8s1ceuBUnMUAeoAHHw,6,3,2,0,1,0,2,0,8,1.1428571428571428,1,0.0,0,2,0,1,3,0,0,2,0,3,5,1
9090,80625,OtvBXiuty3fVhm4b8HhX0yrFKjgkxxYs,bWdj2GDclj5ofokWjzoa5jAwMkxCykd6,1,0,0,0,0,0,1,0,1,0.14285714285714285,1,0.0,0,0,0,0,0,0,0,1,0,0,1,1
9091,80632,4CBJi9FPwBtDwABbM6tdSqW9vKh1q7Z5,SpATywNh6bZuzm8s1ceuBUnMUAeoAHHw,34,51,22,37,8,32,25,3,178,25.428571428571427,7,0.0,20,22,31,8,31,32,6,25,3,81,97,1
9092,80634,LoPeI5vpiJIc8eFJHRcQzxkTVUzWtzqj,SpATywNh6bZuzm8s1ceuBUnMUAeoAHHw,4,3,2,0,0,0,1,0,6,0.8571428571428571,1,0.0,0,2,0,0,3,0,0,1,0,2,4,1
9093,80638,s4hqnx8xUoYKrJLqweBa2aNshVWoic6X,SpATywNh6bZuzm8s1ceuBUnMUAeoAHHw,1,0,0,0,0,0,1,0,1,0.14285714285714285,1,0.0,0,0,0,0,0,0,0,1,0,0,1,1
9094,80639,29gH0FAs4oAb41p5WLnz0d22eodFn1iN,bWdj2GDclj5ofokWjzoa5jAwMkxCykd6,7,4,3,0,3,0,2,0,12,1.7142857142857142,1,0.0,0,3,0,3,4,0,0,2,0,6,6,1
9095,80652,iUoRbwUg4gdzLJukOCZgCgZYdA1FqiAT,5X6FeZozNMgE2VRi3MJYjkkFK8SETtu2,4,0,0,0,0,2,3,3,8,1.1428571428571428,1,0.0,0,0,0,0,0,2,0,3,3,0,8,1
9096,80654,NKR2Krh4HHLg8axBFiC363Ms5CaLr3EI,SpATywNh6bZuzm8s1ceuBUnMUAeoAHHw,1,0,0,0,0,0,1,0,1,0.14285714285714285,1,0.0,0,0,0,0,0,0,0,1,0,0,1,1
9097,80660,TMS9M7AUlYgaEtdQAX29SchyEATrODFG,G8EPVSXsOYB5YQWZGiz1aVq5Pgr2GrQu,63,87,37,88,20,3,11,2,248,35.42857142857143,5,0.0,45,37,54,20,42,3,34,11,2,156,92,1
9098,80666,TaFs8IDIsMzdpxbnD04ku2RkLxSKkkwk,SpATywNh6bZuzm8s1ceuBUnMUAeoAHHw,7,7,1,4,0,0,1,0,13,1.8571428571428572,1,0.0,0,1,3,0,7,0,1,1,0,4,9,1
9099,80681,SyrTnLXKpH34dNmIyW3n9ptk8gbsqg3F,SpATywNh6bZuzm8s1ceuBUnMUAeoAHHw,1,0,0,0,0,0,1,0,1,0.14285714285714285,1,0.0,0,0,0,0,0,0,0,1,0,0,1,1
9100,80698,CqJyXqN2l3WOJQLqxchvfRFp3seiLXw6,A3fsA9Zfv1X2fVEQhTw51lKENdNrEqT3,15,15,7,0,6,0,4,0,32,4.571428571428571,2,0.0,0,7,0,6,15,0,0,4,0,13,19,1
9101,80707,29gH0FAs4oAb41p5WLnz0d22eodFn1iN,RXDvfPUBYFlVdlueBFbLW0mhhAyGEqpt,5,2,1,0,1,0,3,0,7,1.0,1,0.0,0,1,0,1,2,0,0,3,0,2,5,1
9102,80714,ATgF2ilKXTZ2e87FKuPjMOOGbSWS0Lln,bWdj2GDclj5ofokWjzoa5jAwMkxCykd6,1,0,0,0,0,0,1,0,1,0.14285714285714285,1,0.0,0,0,0,0,0,0,0,1,0,0,1,1
9103,80717,eVZffGeL4uoEevrNNMdcmW6f0YwT8plW,SpATywNh6bZuzm8s1ceuBUnMUAeoAHHw,16,25,13,13,6,2,11,2,72,10.285714285714286,4,0.0,6,13,13,6,19,2,0,11,2,38,34,1
9104,80728,EZ8RICWKm2CZHfClKFJxNtx1ItORs9so,SpATywNh6bZuzm8s1ceuBUnMUAeoAHHw,16,43,5,19,1,4,18,2,92,13.142857142857142,4,0.0,9,5,16,1,34,4,3,18,2,31,61,1
9105,80729,nuKEM7FMFD9npzL9DafH3T1pYgMoLJoQ,RXDvfPUBYFlVdlueBFbLW0mhhAyGEqpt,7,9,6,0,5,0,1,0,21,3.0,1,0.0,0,6,0,5,9,0,0,1,0,11,10,0
9106,80733,WsI66cX2IVbmlTGQ0zbjJBYm3CRzD6S5,5X6FeZozNMgE2VRi3MJYjkkFK8SETtu2,6,26,1,0,9,0,2,0,38,5.428571428571429,1,0.0,21,1,0,9,5,0,0,2,0,31,7,1
9107,80735,qOBlKap97zfj4fiqNpXMa6P8l1mqWQt7,SpATywNh6bZuzm8s1ceuBUnMUAeoAHHw,1,0,0,0,0,0,2,0,2,0.2857142857142857,1,0.0,0,0,0,0,0,0,0,2,0,0,2,1
9108,80758,T4bTYOzPYArqtWPF4tmIGoxoB2vrFxrw,SpATywNh6bZuzm8s1ceuBUnMUAeoAHHw,28,33,20,17,9,2,16,1,98,14.0,6,0.0,5,20,16,9,28,2,1,16,1,50,48,1
9109,80769,OmF4aFe06TkjIpsTgGpQ4vBzMWi2jjQV,RXDvfPUBYFlVdlueBFbLW0mhhAyGEqpt,1,0,0,0,0,0,1,0,1,0.14285714285714285,1,0.0,0,0,0,0,0,0,0,1,0,0,1,1
9110,80779,6qgQAmX6y5wh5nEPRINOiKrZNoTl5yfT,bWdj2GDclj5ofokWjzoa5jAwMkxCykd6,35,54,31,80,15,38,31,2,251,35.857142857142854,8,0.0,11,31,67,15,43,38,13,31,2,124,127,1
9111,80780,Nn60hlJlXHP7n7M6lOuhaSQUkd1WY1lX,A3fsA9Zfv1X2fVEQhTw51lKENdNrEqT3,2,0,0,0,0,0,3,0,3,0.42857142857142855,2,0.0,0,0,0,0,0,0,0,3,0,0,3,1
9112,80798,B0jVKFlvXfKwVR9pXnhJZcf2VbxqeEJP,SpATywNh6bZuzm8s1ceuBUnMUAeoAHHw,18,25,15,4,6,0,5,0,55,7.857142857142857,3,0.0,4,15,4,6,21,0,0,5,0,29,26,1
9113,80799,cJ9a9VybEQZXRFqEMI78WQ8ukmEaaVlE,SpATywNh6bZuzm8s1ceuBUnMUAeoAHHw,31,36,17,33,8,4,7,0,105,15.0,5,0.0,12,17,29,8,24,4,4,7,0,66,39,0
9114,80810,XGZlC1RvsVEr4DyOUAX5cTpjhf6EgwX5,G8EPVSXsOYB5YQWZGiz1aVq5Pgr2GrQu,1,0,0,0,0,0,1,0,1,0.14285714285714285,1,0.0,0,0,0,0,0,0,0,1,0,0,1,1
9115,80815,Kv9yM6Ye606xOusGmqGDWX6SW9fdHP2Q,5X6FeZozNMgE2VRi3MJYjkkFK8SETtu2,1,0,0,0,0,0,1,0,1,0.14285714285714285,1,0.0,0,0,0,0,0,0,0,1,0,0,1,1
9116,80825,IH2c5uYafZAMnz8GRu5q3bfkjqRBG0d4,bWdj2GDclj5ofokWjzoa5jAwMkxCykd6,4,3,1,0,1,0,4,0,9,1.2857142857142858,2,0.0,0,1,0,1,3,0,0,4,0,2,7,1
9117,80832,GMSc5TEkkpgIO0gc1xREEszljcEWZiiA,SpATywNh6bZuzm8s1ceuBUnMUAeoAHHw,32,43,25,30,12,16,19,3,148,21.142857142857142,2,0.0,13,25,24,12,30,16,6,19,3,74,74,1
9118,80834,GMSc5TEkkpgIO0gc1xREEszljcEWZiiA,5X6FeZozNMgE2VRi3MJYjkkFK8SETtu2,1,0,0,0,0,0,1,0,1,0.14285714285714285,1,0.0,0,0,0,0,0,0,0,1,0,0,1,1
9119,80835,GMSc5TEkkpgIO0gc1xREEszljcEWZiiA,bWdj2GDclj5ofokWjzoa5jAwMkxCykd6,5,2,1,0,1,0,2,0,6,0.8571428571428571,1,0.0,0,1,0,1,2,0,0,2,0,2,4,1
9120,80849,2mD1u3b1vLrSJM0DZTrsvLcZVBVwwd27,A3fsA9Zfv1X2fVEQhTw51lKENdNrEqT3,3,0,0,0,0,0,9,0,9,1.2857142857142858,3,0.0,0,0,0,0,0,0,0,9,0,0,9,1
9121,80851,okZrRzk81VekqLN26qutXWOBN8y8aCor,SpATywNh6bZuzm8s1ceuBUnMUAeoAHHw,7,3,1,0,1,0,3,0,8,1.1428571428571428,1,0.0,0,1,0,1,3,0,0,3,0,2,6,1
9122,80859,diZ65EjFunlRsT8e2068pcUuzCl79D1p,G8EPVSXsOYB5YQWZGiz1aVq5Pgr2GrQu,4,2,0,0,0,0,2,0,4,0.5714285714285714,1,0.0,0,0,0,0,2,0,0,2,0,0,4,1
9123,80867,pXgjy4DXaOKMQD4LAgLui9VHE5CpkZu9,fbPkOYLVPtPgIt0MxizjfFJov3JbHyAi,31,45,27,0,20,26,8,1,127,18.142857142857142,2,0.0,9,27,0,20,36,26,0,8,1,56,71,1
9124,80868,swFi5fb79eZLyE5zYDE8WBJhH3Y94beD,fbPkOYLVPtPgIt0MxizjfFJov3JbHyAi,2,0,0,0,0,0,2,0,2,0.2857142857142857,1,0.0,0,0,0,0,0,0,0,2,0,0,2,1
9125,80869,Ov1eEIsyiq4NpsQyBb4m5rDEEYvFdikk,fbPkOYLVPtPgIt0MxizjfFJov3JbHyAi,10,7,5,0,3,1,2,0,18,2.5714285714285716,1,0.0,0,5,0,3,7,1,0,2,0,8,10,1
9126,80870,YM9Z89N137bY5qphnaUaFSAicUvT78c0,fbPkOYLVPtPgIt0MxizjfFJov3JbHyAi,8,11,7,0,3,0,5,0,26,3.7142857142857144,1,0.0,0,7,0,3,11,0,0,5,0,10,16,1
9127,80871,Rs4pfmJlaHiSs2fYG1vucMoIlgnMNq35,fbPkOYLVPtPgIt0MxizjfFJov3JbHyAi,1,0,0,0,0,0,1,0,1,0.14285714285714285,1,0.0,0,0,0,0,0,0,0,1,0,0,1,1
9128,80873,J6Gdt3OhkKwtA1tiJMtQErFzdO5CDNjE,fbPkOYLVPtPgIt0MxizjfFJov3JbHyAi,4,3,0,0,0,0,1,0,4,0.5714285714285714,1,0.0,0,0,0,0,3,0,0,1,0,0,4,1
9129,80877,9aS1NSJb2Hj0xHbbuoyhLmktYrjypxsy,fbPkOYLVPtPgIt0MxizjfFJov3JbHyAi,31,69,24,45,18,26,20,0,202,28.857142857142858,5,0.0,34,24,44,18,35,26,1,20,0,120,82,1
9130,80878,mz4jh38pq3jPwJJzfaN8eT823I3JqGp6,fbPkOYLVPtPgIt0MxizjfFJov3JbHyAi,6,4,0,0,0,2,5,1,12,1.7142857142857142,1,0.0,0,0,0,0,4,2,0,5,1,0,12,1
9131,80881,whV1nFYZoFkMMEitqUr4NmhBR8HyCOwO,fbPkOYLVPtPgIt0MxizjfFJov3JbHyAi,10,18,12,0,6,24,9,0,69,9.857142857142858,5,0.0,0,12,0,6,18,24,0,9,0,18,51,1
9132,80882,a98Mt6r9LLCkAEPo2R3JVMN20OhIPoaG,fbPkOYLVPtPgIt0MxizjfFJov3JbHyAi,9,10,5,0,4,0,6,1,26,3.7142857142857144,4,0.0,0,5,0,4,10,0,0,6,1,9,17,1
9133,80884,jUXtuG5Q1xcdJqmPNWwEYGXvh7x6ZP49,fbPkOYLVPtPgIt0MxizjfFJov3JbHyAi,1,0,0,0,0,0,2,0,2,0.2857142857142857,2,0.0,0,0,0,0,0,0,0,2,0,0,2,1
9134,80886,0DzldTHKdoH90kklIAjpWyAEe6XDDjyM,fbPkOYLVPtPgIt0MxizjfFJov3JbHyAi,8,13,8,0,5,13,7,0,46,6.571428571428571,4,0.0,1,8,0,5,12,13,0,7,0,14,32,1
9135,80887,oFIudRLykO0Fs6hEVqUgdjhHssApq1CY,fbPkOYLVPtPgIt0MxizjfFJov3JbHyAi,10,6,3,8,4,0,2,0,23,3.2857142857142856,1,0.0,2,3,6,4,4,0,2,2,0,15,8,1
9136,80888,koWvCadm1og0LpcFvcQlTqhBDNIm2AFz,fbPkOYLVPtPgIt0MxizjfFJov3JbHyAi,8,6,4,0,3,0,3,0,16,2.2857142857142856,2,0.0,0,4,0,3,6,0,0,3,0,7,9,1
9137,80889,K8SEVoLEOyaxiId31CfQ3tViDlX904mj,fbPkOYLVPtPgIt0MxizjfFJov3JbHyAi,8,7,4,0,3,0,3,0,17,2.4285714285714284,2,0.0,0,4,0,3,7,0,0,3,0,7,10,1
9138,80893,u5RnzaYe9alTOldsdopsRhwom5jR9n5h,fbPkOYLVPtPgIt0MxizjfFJov3JbHyAi,12,16,6,4,7,0,3,0,36,5.142857142857143,1,0.0,8,6,4,7,8,0,0,3,0,25,11,1
9139,80895,b17BXpd9CJ1FbG7Eiys3N3TmOMsQOqc5,fbPkOYLVPtPgIt0MxizjfFJov3JbHyAi,6,2,1,0,1,0,3,0,7,1.0,1,0.0,0,1,0,1,2,0,0,3,0,2,5,1
9140,80897,IVsQLNPDPXZtEeF9QnUix2gm2WS214ki,fbPkOYLVPtPgIt0MxizjfFJov3JbHyAi,1,0,0,0,0,0,1,0,1,0.14285714285714285,1,0.0,0,0,0,0,0,0,0,1,0,0,1,1
9141,80898,87MEmQxd2seObxQu44Z8XlD7ySMr8nwp,fbPkOYLVPtPgIt0MxizjfFJov3JbHyAi,9,3,2,0,2,0,9,1,17,2.4285714285714284,1,0.0,0,2,0,2,3,0,0,9,1,4,13,1
9142,80899,LB9Y3hHJxXFKUivI2IDZO69UMgf1mHWd,fbPkOYLVPtPgIt0MxizjfFJov3JbHyAi,12,31,11,0,1,9,4,0,56,8.0,2,0.0,1,11,0,1,30,9,0,4,0,13,43,1
9143,80900,zbVrmGy9kpOt2q8xeIclHo9H8afE2cMh,fbPkOYLVPtPgIt0MxizjfFJov3JbHyAi,4,6,2,0,0,0,1,0,9,1.2857142857142858,1,0.0,0,2,0,0,6,0,0,1,0,2,7,1
9144,80905,80glaVvHvBUy48oZdvFjTEnT1I1ayEGd,5Gyp41oLVo7Gg7vF4vpmggWP5MU70QO6,11,15,7,0,3,0,7,0,32,4.571428571428571,4,0.0,0,7,0,3,15,0,0,7,0,10,22,0
9145,80907,yGiLrjdZupRhdvMdLZVVcCQ82dMfdHjX,5Gyp41oLVo7Gg7vF4vpmggWP5MU70QO6,9,6,2,2,1,1,4,1,17,2.4285714285714284,1,0.0,3,2,1,1,3,1,1,4,1,7,10,1
9146,80915,5JBXs7Eegffbn9K1DzV3WApq68Z50pHH,5Gyp41oLVo7Gg7vF4vpmggWP5MU70QO6,1,0,0,0,0,0,2,0,2,0.2857142857142857,1,0.0,0,0,0,0,0,0,0,2,0,0,2,1
9147,80918,1siC9HdVMAi0tBMmzySCSyCC7x6QknkV,5Gyp41oLVo7Gg7vF4vpmggWP5MU70QO6,8,5,0,0,0,0,4,0,9,1.2857142857142858,1,0.0,0,0,0,0,5,0,0,4,0,0,9,1
9148,80941,8vEwP3HCYC0jRoIm7rp8JIAcGEcRo4Cr,5Gyp41oLVo7Gg7vF4vpmggWP5MU70QO6,1,0,0,0,0,0,1,0,1,0.14285714285714285,1,0.0,0,0,0,0,0,0,0,1,0,0,1,1
9149,80972,Dz2soaBWrFp2eghae8JCBpfQPKY7BOHW,5Gyp41oLVo7Gg7vF4vpmggWP5MU70QO6,12,15,7,2,1,0,7,1,33,4.714285714285714,2,0.0,0,7,1,1,15,0,1,7,1,9,24,0
9150,80986,6M91U4Jjh1zXyEtnnWfZC11jlFbX18Gl,5Gyp41oLVo7Gg7vF4vpmggWP5MU70QO6,9,5,4,0,1,0,4,0,14,2.0,1,0.0,1,4,0,1,4,0,0,4,0,6,8,1
9151,81008,WuewKMj9rDXfi3Ee2xNKJ0LUPR3KMMWb,5Gyp41oLVo7Gg7vF4vpmggWP5MU70QO6,5,3,2,0,0,0,2,0,7,1.0,1,0.0,0,2,0,0,3,0,0,2,0,2,5,1
9152,81009,UE4ObE6MNUtq2YZs04l4Qpq0RNxbuB1R,5Gyp41oLVo7Gg7vF4vpmggWP5MU70QO6,7,2,1,0,1,0,4,0,8,1.1428571428571428,1,0.0,0,1,0,1,2,0,0,4,0,2,6,1
9153,81015,xYWmnmUWp3IWOaF5fh4qA4e7AK8hEElb,5Gyp41oLVo7Gg7vF4vpmggWP5MU70QO6,9,12,1,0,2,0,4,0,19,2.7142857142857144,3,0.0,1,1,0,2,11,0,0,4,0,4,15,1
9154,81026,FODQFrCQnkGgP5FEgm7xRdwveNuzsX04,5Gyp41oLVo7Gg7vF4vpmggWP5MU70QO6,24,31,13,11,8,0,13,2,78,11.142857142857142,2,0.0,11,13,6,8,20,0,5,13,2,38,40,1
9155,81064,mfwDBD5dIZoX7jNUjK1pdlNpAz8Zfo2D,5Gyp41oLVo7Gg7vF4vpmggWP5MU70QO6,1,0,0,0,0,0,1,0,1,0.14285714285714285,1,0.0,0,0,0,0,0,0,0,1,0,0,1,1
9156,81067,UPL9Lvx89H3gz94r9i5tl5V9zo6NsMCc,5Gyp41oLVo7Gg7vF4vpmggWP5MU70QO6,4,2,1,0,0,0,2,0,5,0.7142857142857143,1,0.0,0,1,0,0,2,0,0,2,0,1,4,1
9157,81070,xa2Rc3QWrEY8yDRVKZtfHO6VJQtIYqqg,5Gyp41oLVo7Gg7vF4vpmggWP5MU70QO6,10,3,2,0,2,0,6,1,14,2.0,1,0.0,0,2,0,2,3,0,0,6,1,4,10,1
9158,81138,Lb7smBlNGKGreCBWna2HqUxFEZPNlPcQ,5Gyp41oLVo7Gg7vF4vpmggWP5MU70QO6,7,5,2,0,2,2,5,1,17,2.4285714285714284,1,0.0,0,2,0,2,5,2,0,5,1,4,13,1
9159,81146,yvUBDN0FiDtWpDpYWBs2NOZYrZvcxRLe,5Gyp41oLVo7Gg7vF4vpmggWP5MU70QO6,1,0,0,0,0,0,1,0,1,0.14285714285714285,1,0.0,0,0,0,0,0,0,0,1,0,0,1,1
9160,81154,1bKMONcV6Mq58szdlIajPdFyqaw4BvrA,5Gyp41oLVo7Gg7vF4vpmggWP5MU70QO6,6,2,1,0,1,0,4,1,9,1.2857142857142858,1,0.0,0,1,0,1,2,0,0,4,1,2,7,0
9161,81192,ECCMGZYVv2K5DCWTqOR5m6ar5eGtvymw,5Gyp41oLVo7Gg7vF4vpmggWP5MU70QO6,7,3,2,0,2,0,4,0,11,1.5714285714285714,1,0.0,0,2,0,2,3,0,0,4,0,4,7,1
9162,81194,xiDptcso6FkIZ5YV6Fs9S7SMsBZpHpkg,5Gyp41oLVo7Gg7vF4vpmggWP5MU70QO6,1,0,0,0,0,0,1,0,1,0.14285714285714285,1,0.0,0,0,0,0,0,0,0,1,0,0,1,1
9163,81198,k1jxHgY5rOXbaWEGpQGKEP3yWvLIIm1P,5Gyp41oLVo7Gg7vF4vpmggWP5MU70QO6,1,0,0,0,0,0,1,0,1,0.14285714285714285,1,0.0,0,0,0,0,0,0,0,1,0,0,1,1
9164,81217,8cMfXpJwi6t06um2KrGHukgzI2aYELtv,5Gyp41oLVo7Gg7vF4vpmggWP5MU70QO6,1,0,0,0,0,0,1,0,1,0.14285714285714285,1,0.0,0,0,0,0,0,0,0,1,0,0,1,1
9165,81237,Rdvgrardg53H2oeCgmOt8vFxIUu5nogb,5Gyp41oLVo7Gg7vF4vpmggWP5MU70QO6,25,51,28,18,11,29,11,0,148,21.142857142857142,5,0.0,13,28,11,11,38,29,7,11,0,63,85,1
9166,81254,MwwlSUI8F4oDpi9LVs3eg06n3iwy8YvF,5Gyp41oLVo7Gg7vF4vpmggWP5MU70QO6,1,0,0,0,0,0,1,0,1,0.14285714285714285,1,0.0,0,0,0,0,0,0,0,1,0,0,1,1
9167,81261,z79FxI6IxKXksSKIwsXSYM1kOlaP8f6r,5Gyp41oLVo7Gg7vF4vpmggWP5MU70QO6,12,22,0,10,0,6,5,1,44,6.285714285714286,1,0.0,7,0,5,0,15,6,5,5,1,12,32,0
9168,81293,IlLRiN73iGMsvGrUTmMGOzIMn2oK4dZp,5Gyp41oLVo7Gg7vF4vpmggWP5MU70QO6,1,0,0,0,0,0,1,0,1,0.14285714285714285,1,0.0,0,0,0,0,0,0,0,1,0,0,1,1
9169,81294,Wa7OAQyjELO0edwgO2a4gSm2jSZTemEI,5Gyp41oLVo7Gg7vF4vpmggWP5MU70QO6,5,0,0,0,0,8,4,0,12,1.7142857142857142,1,0.0,0,0,0,0,0,8,0,4,0,0,12,1
9170,81313,gEqIHfHmAAvBc0rLTB1C7tRehCWFJnIr,5Gyp41oLVo7Gg7vF4vpmggWP5MU70QO6,7,3,2,0,2,0,5,0,12,1.7142857142857142,1,0.0,0,2,0,2,3,0,0,5,0,4,8,1
9171,81328,OJ0LoXMYeoupgtCsqXPKoTXc19jkOfHU,5Gyp41oLVo7Gg7vF4vpmggWP5MU70QO6,11,7,4,0,2,1,5,0,19,2.7142857142857144,1,0.0,0,4,0,2,7,1,0,5,0,6,13,1
9172,81381,zoXigsWBjyJG6OSyWQP4Y5frh0Mc9ncS,5Gyp41oLVo7Gg7vF4vpmggWP5MU70QO6,1,0,0,0,0,0,1,0,1,0.14285714285714285,1,0.0,0,0,0,0,0,0,0,1,0,0,1,1
9173,81382,uAiXtjZln558M2i3rYEEm2XkgYlhSfMT,5Gyp41oLVo7Gg7vF4vpmggWP5MU70QO6,19,29,21,0,14,0,12,0,76,10.857142857142858,4,0.0,2,21,0,14,27,0,0,12,0,37,39,1
9174,81385,KtFm7BUlplqAQ0eEpxvwq82vxj2gfBmJ,5Gyp41oLVo7Gg7vF4vpmggWP5MU70QO6,1,0,0,0,0,0,1,0,1,0.14285714285714285,1,0.0,0,0,0,0,0,0,0,1,0,0,1,1
9175,81397,cT78xvKkV1UFGcRKty0V03Jr4RRPh50F,5Gyp41oLVo7Gg7vF4vpmggWP5MU70QO6,1,0,0,0,0,0,1,0,1,0.14285714285714285,1,0.0,0,0,0,0,0,0,0,1,0,0,1,1
9176,81401,X1KDcg6FJGcjALhOEz460JY2SzJ27Ewm,5Gyp41oLVo7Gg7vF4vpmggWP5MU70QO6,6,8,4,0,0,0,4,1,17,2.4285714285714284,1,0.0,0,4,0,0,8,0,0,4,1,4,13,1
9177,81407,okqN4nBVKRYYrkYonKicKGOmPqVGYjZh,5Gyp41oLVo7Gg7vF4vpmggWP5MU70QO6,43,247,108,69,31,3,52,1,511,73.0,12,0.0,39,108,62,31,208,3,7,52,1,240,271,0
9178,81421,jDvQIlE5Sz6V9SpiJ3fC38kGJJ76UIjp,5Gyp41oLVo7Gg7vF4vpmggWP5MU70QO6,5,2,1,0,1,0,2,0,6,0.8571428571428571,1,0.0,0,1,0,1,2,0,0,2,0,2,4,1
9179,81422,nWwV0iLe6YugeJuwswmouvW60daPn3qh,5Gyp41oLVo7Gg7vF4vpmggWP5MU70QO6,1,0,0,0,0,0,1,0,1,0.14285714285714285,1,0.0,0,0,0,0,0,0,0,1,0,0,1,1
9180,81424,Eb81LwG9GXAYL3HRXZ1DmiHY6DkHKHL1,5Gyp41oLVo7Gg7vF4vpmggWP5MU70QO6,1,0,0,0,0,0,1,0,1,0.14285714285714285,1,0.0,0,0,0,0,0,0,0,1,0,0,1,1
9181,81429,E3uSUPqhCM6qMf5A53Kr8C5Ks2Mqniz2,5Gyp41oLVo7Gg7vF4vpmggWP5MU70QO6,1,0,0,0,0,0,1,0,1,0.14285714285714285,1,0.0,0,0,0,0,0,0,0,1,0,0,1,1
9182,81432,EVcoLcSnWlfmvKyibRqo4bsnirupfeCB,5Gyp41oLVo7Gg7vF4vpmggWP5MU70QO6,10,6,4,0,2,0,3,0,15,2.142857142857143,1,0.0,0,4,0,2,6,0,0,3,0,6,9,1
9183,81437,2obImradCczKWNAiD5PB3T50fxdRnZcY,5Gyp41oLVo7Gg7vF4vpmggWP5MU70QO6,8,5,3,0,3,0,3,0,14,2.0,1,0.0,0,3,0,3,5,0,0,3,0,6,8,1
9184,81456,NpYBYyw1XJ9LuDixdnai46t6pNciyLYs,5Gyp41oLVo7Gg7vF4vpmggWP5MU70QO6,1,0,0,0,0,0,1,0,1,0.14285714285714285,1,0.0,0,0,0,0,0,0,0,1,0,0,1,1
9185,81463,vOgUJ4E49nmsRlQDaaH91xRCySNGI4WL,5Gyp41oLVo7Gg7vF4vpmggWP5MU70QO6,12,27,16,7,8,0,5,0,63,9.0,4,0.0,6,16,4,8,21,0,3,5,0,34,29,1
9186,81464,gTnArh0oPGEOmMh6hJyyS2iZFdCYgCEZ,5Gyp41oLVo7Gg7vF4vpmggWP5MU70QO6,13,16,9,7,5,0,3,0,40,5.714285714285714,4,0.0,4,9,5,5,12,0,2,3,0,23,17,1
9187,81490,awNiHcfaLmIgQygcxufPZke7YT91Tlmy,5Gyp41oLVo7Gg7vF4vpmggWP5MU70QO6,11,9,6,0,5,3,9,1,33,4.714285714285714,3,0.0,1,6,0,5,8,3,0,9,1,12,21,0
9188,81499,3y2XGrXV12phjHWJYa19FG6DINKDjdIB,5Gyp41oLVo7Gg7vF4vpmggWP5MU70QO6,8,5,4,0,2,0,1,0,12,1.7142857142857142,1,0.0,0,4,0,2,5,0,0,1,0,6,6,1
9189,81504,2tXywtJQD2C1dKRzRzUewvgORqwUmXtE,5Gyp41oLVo7Gg7vF4vpmggWP5MU70QO6,17,11,8,6,5,2,8,1,41,5.857142857142857,1,0.0,1,8,3,5,10,2,3,8,1,17,24,1
9190,81505,fZtl6CLGkXt3aozJmivTDUyscSsi3JCf,5Gyp41oLVo7Gg7vF4vpmggWP5MU70QO6,8,5,2,6,1,0,2,0,16,2.2857142857142856,1,0.0,2,2,3,1,3,0,3,2,0,8,8,1
9191,81517,eIz1QdRrhcYteukRLgOlTi2GZdnEpdtj,5Gyp41oLVo7Gg7vF4vpmggWP5MU70QO6,1,0,0,0,0,0,1,0,1,0.14285714285714285,1,0.0,0,0,0,0,0,0,0,1,0,0,1,1
9192,81526,RUhbDEGzuGiozW42x5lFaNzzdgUAuP4z,5Gyp41oLVo7Gg7vF4vpmggWP5MU70QO6,1,0,0,0,0,0,1,0,1,0.14285714285714285,1,0.0,0,0,0,0,0,0,0,1,0,0,1,1
9193,81530,kFJUPP4PT5hRWkkzRpfMGB8B8BwQArn7,5Gyp41oLVo7Gg7vF4vpmggWP5MU70QO6,29,57,31,22,13,89,15,2,229,32.714285714285715,6,0.0,12,31,15,13,45,89,7,15,2,71,158,0
9194,81543,fgaDXA4j6cHk0FnifTSdjVGPTjk5iRju,5Gyp41oLVo7Gg7vF4vpmggWP5MU70QO6,1,0,0,0,0,0,1,0,1,0.14285714285714285,1,0.0,0,0,0,0,0,0,0,1,0,0,1,1
9195,81544,cgBusYXiNBsyile8fKg57RdfoNSHxREd,5Gyp41oLVo7Gg7vF4vpmggWP5MU70QO6,1,0,0,0,0,0,1,0,1,0.14285714285714285,1,0.0,0,0,0,0,0,0,0,1,0,0,1,1
9196,81545,DK0C2OoM9pED5J54cuVFRs3cJYbvw6n8,5Gyp41oLVo7Gg7vF4vpmggWP5MU70QO6,1,0,0,0,0,0,1,0,1,0.14285714285714285,1,0.0,0,0,0,0,0,0,0,1,0,0,1,1
9197,81563,ynpQJ1KNFlwGGjbvB4jjK45fmhFIwSzj,5Gyp41oLVo7Gg7vF4vpmggWP5MU70QO6,7,4,4,0,3,0,6,0,17,2.4285714285714284,2,0.0,0,4,0,3,4,0,0,6,0,7,10,1
9198,81564,wJC86gc3viBGM4vTuYg8647vhYAtlLLc,5Gyp41oLVo7Gg7vF4vpmggWP5MU70QO6,4,2,0,0,0,0,2,0,4,0.5714285714285714,1,0.0,0,0,0,0,2,0,0,2,0,0,4,1
9199,81571,DUVNCAOW5Uq3WAymMRBzIy6a7NnFfgK9,5Gyp41oLVo7Gg7vF4vpmggWP5MU70QO6,1,0,0,0,0,0,1,0,1,0.14285714285714285,1,0.0,0,0,0,0,0,0,0,1,0,0,1,1
9200,81576,Fkf58lC4LlkBK9l03hDS8g86sf3RUqj8,5Gyp41oLVo7Gg7vF4vpmggWP5MU70QO6,8,6,1,4,1,0,4,0,16,2.2857142857142856,1,0.0,2,1,2,1,4,0,2,4,0,6,10,1
9201,81598,Pj9kGggxpq0sMYjSFqPNkAQrvOEBLtbk,5Gyp41oLVo7Gg7vF4vpmggWP5MU70QO6,5,2,1,0,1,0,2,0,6,0.8571428571428571,1,0.0,0,1,0,1,2,0,0,2,0,2,4,1
9202,81617,4NwdwhTCkAbuPHoDkJ6AWQ1Dq7CWTOcu,5Gyp41oLVo7Gg7vF4vpmggWP5MU70QO6,2,0,0,0,0,0,2,0,2,0.2857142857142857,1,0.0,0,0,0,0,0,0,0,2,0,0,2,1
9203,81620,mUWsqZFWrB15z8pLpQnajB2yNWrSRPl9,5Gyp41oLVo7Gg7vF4vpmggWP5MU70QO6,21,13,9,8,6,0,2,0,38,5.428571428571429,1,0.0,3,9,4,6,10,0,4,2,0,22,16,1
9204,81622,hpBcUixqIYN9QJG8vvXqJZQPLWPUvpPA,5Gyp41oLVo7Gg7vF4vpmggWP5MU70QO6,11,15,7,18,2,0,3,0,45,6.428571428571429,2,0.0,6,7,9,2,9,0,9,3,0,24,21,1
9205,81630,Ji6hwggIttTjOJLJJ2Fyx2zSqY8obZY5,5Gyp41oLVo7Gg7vF4vpmggWP5MU70QO6,8,8,1,8,0,0,2,0,19,2.7142857142857144,1,0.0,4,1,4,0,4,0,4,2,0,9,10,1
9206,81637,3SBPXGcoEiRb4Rr22FrPQJdZoEpkDJr2,5Gyp41oLVo7Gg7vF4vpmggWP5MU70QO6,1,0,0,0,0,0,1,0,1,0.14285714285714285,1,0.0,0,0,0,0,0,0,0,1,0,0,1,1
9207,81640,XeXLRKhL1tlAXxElqSJMNggZeP11626N,5Gyp41oLVo7Gg7vF4vpmggWP5MU70QO6,14,24,11,6,4,6,16,2,69,9.857142857142858,1,0.0,5,11,3,4,19,6,3,16,2,23,46,1
9208,81673,FcPFK6OTsUF1j3uNGabdzGTvbY8kcO3D,5Gyp41oLVo7Gg7vF4vpmggWP5MU70QO6,10,10,0,0,0,0,4,1,15,2.142857142857143,1,0.0,1,0,0,0,9,0,0,4,1,1,14,1
9209,81697,JYeCYbK21kYELQ56DJ4mCCCl3DrmUMGD,5Gyp41oLVo7Gg7vF4vpmggWP5MU70QO6,22,82,30,8,13,0,13,0,146,20.857142857142858,15,0.0,25,30,4,13,57,0,4,13,0,72,74,0
9210,81699,ErBXi0pY00kAr7JQ9C5qO39mzbMPIL2X,5Gyp41oLVo7Gg7vF4vpmggWP5MU70QO6,1,0,0,0,0,0,1,0,1,0.14285714285714285,1,0.0,0,0,0,0,0,0,0,1,0,0,1,1
9211,81708,sLdE1XwCqd1M3K3CU3JeR9fAJx9wS4IC,5Gyp41oLVo7Gg7vF4vpmggWP5MU70QO6,19,28,16,0,10,0,13,0,67,9.571428571428571,4,0.0,3,16,0,10,25,0,0,13,0,29,38,1
9212,81712,7iTmBBKChEc8vaDVoNej7Za5TQKoyJKR,5Gyp41oLVo7Gg7vF4vpmggWP5MU70QO6,11,6,5,2,4,0,2,0,19,2.7142857142857144,1,0.0,0,5,1,4,6,0,1,2,0,10,9,1
9213,81722,UepPDDQKRX2gvfyC0cC72CpSt0htccXe,5Gyp41oLVo7Gg7vF4vpmggWP5MU70QO6,1,0,0,0,0,0,1,0,1,0.14285714285714285,1,0.0,0,0,0,0,0,0,0,1,0,0,1,1
9214,81729,NdrXoMMHPfNYZRBXjBmHK3Oxybjvb5JH,5Gyp41oLVo7Gg7vF4vpmggWP5MU70QO6,6,2,1,0,1,0,3,0,7,1.0,1,0.0,0,1,0,1,2,0,0,3,0,2,5,1
9215,81734,9qutpyxUCJIQJHMwAfrHtNX60WWqvl3G,5Gyp41oLVo7Gg7vF4vpmggWP5MU70QO6,7,4,2,0,2,0,3,0,11,1.5714285714285714,1,0.0,0,2,0,2,4,0,0,3,0,4,7,1
9216,81741,rL2Wp2McshMzJOuTaYQQEauhMVr1cn9o,5Gyp41oLVo7Gg7vF4vpmggWP5MU70QO6,4,2,1,0,1,0,1,0,5,0.7142857142857143,1,0.0,0,1,0,1,2,0,0,1,0,2,3,1
9217,81742,9puzLzVlA2TgO5Rh6gzTqoNWo0F9Q1Uf,5Gyp41oLVo7Gg7vF4vpmggWP5MU70QO6,9,14,2,0,2,1,9,1,29,4.142857142857143,2,0.0,6,2,0,2,8,1,0,9,1,10,19,1
9218,81756,W7KujC4k3yZdIHgAhugdfXrOXHL5jGWa,5Gyp41oLVo7Gg7vF4vpmggWP5MU70QO6,9,6,3,0,2,0,2,0,13,1.8571428571428572,1,0.0,0,3,0,2,6,0,0,2,0,5,8,1
9219,81771,HScXm7gr8Ll2wrmo4nR7HrfaRZw9SyE8,5Gyp41oLVo7Gg7vF4vpmggWP5MU70QO6,4,2,1,0,0,0,2,0,5,0.7142857142857143,1,0.0,0,1,0,0,2,0,0,2,0,1,4,1
9220,81778,IJ4NU8caWTuANVpCRSjvfDjTyce4VyLa,5Gyp41oLVo7Gg7vF4vpmggWP5MU70QO6,39,53,28,19,16,11,14,1,142,20.285714285714285,6,0.0,15,28,13,16,38,11,6,14,1,72,70,1
9221,81823,TXNnbjY690dLjW2nCR7nDyfRxXhXZM7x,5Gyp41oLVo7Gg7vF4vpmggWP5MU70QO6,1,0,0,0,0,0,1,0,1,0.14285714285714285,1,0.0,0,0,0,0,0,0,0,1,0,0,1,1
9222,81824,L3WpwWMk3AHS6ogVOti5NMJf0SEPrDvU,5Gyp41oLVo7Gg7vF4vpmggWP5MU70QO6,15,12,8,7,3,0,5,0,35,5.0,2,0.0,1,8,5,3,11,0,2,5,0,17,18,1
9223,81826,5SK8e6Td5yG9MSZHpZBKOgeDEnZoAZ5q,5Gyp41oLVo7Gg7vF4vpmggWP5MU70QO6,6,3,1,0,1,0,2,0,7,1.0,1,0.0,0,1,0,1,3,0,0,2,0,2,5,1
9224,81835,KOvmBcA9s1Xzvf4Ba1b6Jxr1bE5t44Zl,5Gyp41oLVo7Gg7vF4vpmggWP5MU70QO6,1,0,0,0,0,0,1,0,1,0.14285714285714285,1,0.0,0,0,0,0,0,0,0,1,0,0,1,1
9225,81837,RTkGQ4UmTL2ed98p2vxbPQoTurdG2SAC,5Gyp41oLVo7Gg7vF4vpmggWP5MU70QO6,22,56,25,7,9,10,20,0,127,18.142857142857142,9,0.0,15,25,5,9,41,10,2,20,0,54,73,1
9226,81841,InrI4RcRtMCVIAkBJwEbqprSPKTdUwZL,5Gyp41oLVo7Gg7vF4vpmggWP5MU70QO6,9,14,8,0,4,0,5,0,31,4.428571428571429,4,0.0,1,8,0,4,13,0,0,5,0,13,18,0
9227,81844,tnRrFt3zZPitlsQHq3ziTWoyjogTqR1S,5Gyp41oLVo7Gg7vF4vpmggWP5MU70QO6,1,0,0,0,0,0,2,0,2,0.2857142857142857,1,0.0,0,0,0,0,0,0,0,2,0,0,2,1
9228,81845,itwm4TVODOBqFpKY29D8QUWf1nvyYrio,5Gyp41oLVo7Gg7vF4vpmggWP5MU70QO6,1,0,0,0,0,0,1,0,1,0.14285714285714285,1,0.0,0,0,0,0,0,0,0,1,0,0,1,1
9229,81847,FV2QLqrxJnpFV8kh2dMlhF1Q4TPyAwGe,5Gyp41oLVo7Gg7vF4vpmggWP5MU70QO6,4,3,0,0,0,0,2,0,5,0.7142857142857143,1,0.0,0,0,0,0,3,0,0,2,0,0,5,1
9230,81864,Ep4Q95tKnG1eQgBqFXbKyAx3i4zRNHfc,5Gyp41oLVo7Gg7vF4vpmggWP5MU70QO6,35,76,41,29,19,16,11,2,194,27.714285714285715,5,0.0,23,41,19,19,53,16,10,11,2,102,92,0
9231,81883,cNdAhNMBLjPljDxmVI92aVbHrB5aRq30,5Gyp41oLVo7Gg7vF4vpmggWP5MU70QO6,8,6,4,0,3,0,4,0,17,2.4285714285714284,2,0.0,0,4,0,3,6,0,0,4,0,7,10,1
9232,81889,AXOgFWUEMyDEcBkotXpoXzfY4u6ulWjj,5Gyp41oLVo7Gg7vF4vpmggWP5MU70QO6,11,15,6,2,2,0,10,2,37,5.285714285714286,3,0.0,5,6,1,2,10,0,1,10,2,14,23,1
9233,81891,kvbydr7J9toNfajV4DY9FDU8zEAMAVQ1,5Gyp41oLVo7Gg7vF4vpmggWP5MU70QO6,14,19,11,0,5,11,18,2,66,9.428571428571429,2,0.0,3,11,0,5,16,11,0,18,2,19,47,1
9234,81898,xyBsJIxBvJWelISp41iqkjFWa1ZRWDuS,5Gyp41oLVo7Gg7vF4vpmggWP5MU70QO6,1,0,0,0,0,0,1,0,1,0.14285714285714285,1,0.0,0,0,0,0,0,0,0,1,0,0,1,1
9235,81933,2XL3DeJoAlSciNfv1lzOeAVybSPVMeST,5Gyp41oLVo7Gg7vF4vpmggWP5MU70QO6,7,7,2,0,3,0,2,0,14,2.0,1,0.0,1,2,0,3,6,0,0,2,0,6,8,1
9236,81941,p5Zov2RnBbluw06bAF0vsZiD2bb4lHm4,5Gyp41oLVo7Gg7vF4vpmggWP5MU70QO6,5,3,1,0,1,0,3,0,8,1.1428571428571428,1,0.0,0,1,0,1,3,0,0,3,0,2,6,1
9237,81951,JJToVFow5qkZZjCpX43ZJexjuIRhopwC,5Gyp41oLVo7Gg7vF4vpmggWP5MU70QO6,7,2,1,0,1,0,6,0,10,1.4285714285714286,1,0.0,0,1,0,1,2,0,0,6,0,2,8,1
9238,81962,wTTO5UZvOHJ50psl9u7EHqTW3gaK1AzY,5Gyp41oLVo7Gg7vF4vpmggWP5MU70QO6,5,2,1,0,1,0,2,0,6,0.8571428571428571,1,0.0,0,1,0,1,2,0,0,2,0,2,4,1
9239,81966,664aA95SpLjGifl4HhPxBvhnpaUFQ70i,5Gyp41oLVo7Gg7vF4vpmggWP5MU70QO6,13,22,8,2,5,0,5,0,42,6.0,1,0.0,2,8,1,5,20,0,1,5,0,16,26,1
9240,81968,svZr5zFr0ZC9w2UrVxLBYNSQ4Tg5eFZO,5Gyp41oLVo7Gg7vF4vpmggWP5MU70QO6,5,1,0,0,0,1,8,0,10,1.4285714285714286,2,0.0,0,0,0,0,1,1,0,8,0,0,10,1
9241,81969,RWPbtiIjgj4dbd83AeP26tTQo9Ej8m5m,5Gyp41oLVo7Gg7vF4vpmggWP5MU70QO6,29,30,14,53,8,17,21,2,145,20.714285714285715,1,0.0,14,14,41,8,16,17,12,21,2,77,68,1
9242,81975,o3zSSjoMuw2lsjy8BEo2oq83BTgFfSUZ,5Gyp41oLVo7Gg7vF4vpmggWP5MU70QO6,11,14,6,2,6,0,3,0,31,4.428571428571429,1,0.0,6,6,1,6,8,0,1,3,0,19,12,1
9243,81983,M414kNG7PkuOj7PNcBcNihP3YtAnl8Hp,5Gyp41oLVo7Gg7vF4vpmggWP5MU70QO6,3,0,0,0,0,0,3,0,3,0.42857142857142855,1,0.0,0,0,0,0,0,0,0,3,0,0,3,1
9244,81984,5zX31TZPkBQ4nxGKP7lPYFABTGNW6PHa,5Gyp41oLVo7Gg7vF4vpmggWP5MU70QO6,13,17,0,12,1,0,8,0,38,5.428571428571429,2,0.0,7,0,6,1,10,0,6,8,0,14,24,0
9245,81994,1bB5By8ujdlSjP6o6ZLWtPqvKKY6OuER,5Gyp41oLVo7Gg7vF4vpmggWP5MU70QO6,9,15,5,2,6,0,1,0,29,4.142857142857143,1,0.0,9,5,1,6,6,0,1,1,0,21,8,1
9246,81997,qXiwcKMSPAduA1ypbRUmB2QxtrPDn2mK,5Gyp41oLVo7Gg7vF4vpmggWP5MU70QO6,12,13,6,0,4,0,5,0,28,4.0,1,0.0,0,6,0,4,13,0,0,5,0,10,18,1
9247,82007,oJU0HZZ0PaJzfIGtWJOsNrl9Aa1NvCud,5Gyp41oLVo7Gg7vF4vpmggWP5MU70QO6,8,4,3,0,2,0,2,0,11,1.5714285714285714,1,0.0,0,3,0,2,4,0,0,2,0,5,6,1
9248,82013,jLnpoJcCnQK5rZk7KO8X2PwlohODJnXc,5Gyp41oLVo7Gg7vF4vpmggWP5MU70QO6,27,28,15,15,8,1,5,1,73,10.428571428571429,3,0.0,10,15,10,8,18,1,5,5,1,43,30,1
9249,82017,WlQYChhbsWhTEjPZxscP3TwUFCCBGjXl,5Gyp41oLVo7Gg7vF4vpmggWP5MU70QO6,6,4,1,0,0,0,5,2,12,1.7142857142857142,1,0.0,0,1,0,0,4,0,0,5,2,1,11,1
9250,82027,O8MsYQpR4hEy66ifxKhaGCm8wRRh6472,5Gyp41oLVo7Gg7vF4vpmggWP5MU70QO6,2,0,0,0,0,0,2,0,2,0.2857142857142857,1,0.0,0,0,0,0,0,0,0,2,0,0,2,1
9251,82031,MyMqBrbl1dBhRUWrRtNASDGXmSUH1uii,5Gyp41oLVo7Gg7vF4vpmggWP5MU70QO6,5,2,1,0,1,0,2,0,6,0.8571428571428571,1,0.0,0,1,0,1,2,0,0,2,0,2,4,1
9252,82036,ScNR9KK65fU9GIo3aRVLiGsq4AeK70F3,5Gyp41oLVo7Gg7vF4vpmggWP5MU70QO6,17,50,25,14,5,18,14,0,126,18.0,8,0.0,12,25,11,5,38,18,3,14,0,53,73,1
9253,82049,dysLfjeanq4tHamdntfde34XOZUPd7EJ,5Gyp41oLVo7Gg7vF4vpmggWP5MU70QO6,11,11,5,6,4,0,4,0,30,4.285714285714286,2,0.0,3,5,3,4,8,0,3,4,0,15,15,1
9254,82057,Ng3EMafi8VXifl0s5jfFxcYN5zgfdp6i,5Gyp41oLVo7Gg7vF4vpmggWP5MU70QO6,1,0,0,0,0,0,2,0,2,0.2857142857142857,1,0.0,0,0,0,0,0,0,0,2,0,0,2,1
9255,82079,yDGtxNnNQSlh4G0yTVxQ19yHJmDULM8y,5Gyp41oLVo7Gg7vF4vpmggWP5MU70QO6,1,0,0,0,0,0,1,0,1,0.14285714285714285,1,0.0,0,0,0,0,0,0,0,1,0,0,1,1
9256,82097,tedGThhHMqVARfBh6zyzyocTKbTJYJpB,5Gyp41oLVo7Gg7vF4vpmggWP5MU70QO6,5,3,0,0,0,3,21,0,27,3.857142857142857,7,0.0,0,0,0,0,3,3,0,21,0,0,27,1
9257,82110,IWADLwZhlWLo0OXuOChElEmmzDM9dqDV,5Gyp41oLVo7Gg7vF4vpmggWP5MU70QO6,7,4,3,0,2,0,2,0,11,1.5714285714285714,2,0.0,0,3,0,2,4,0,0,2,0,5,6,1
9258,82113,M75L90OOMTV1kEiI3n7vM0ty47YBFna9,5Gyp41oLVo7Gg7vF4vpmggWP5MU70QO6,37,155,64,16,19,44,45,5,348,49.714285714285715,6,0.0,28,64,11,19,127,44,5,45,5,122,226,1
9259,82119,VzR6XMdgKh4ZvcxT2eTU6o4kqKRYIMlT,5Gyp41oLVo7Gg7vF4vpmggWP5MU70QO6,16,28,15,12,7,3,23,16,104,14.857142857142858,7,0.0,5,15,6,7,23,3,6,23,16,33,71,1
9260,82126,BrtDkxIRglqJVY1aYKID2Vb6SWafzpud,5Gyp41oLVo7Gg7vF4vpmggWP5MU70QO6,19,31,16,8,9,12,7,0,83,11.857142857142858,5,0.0,7,16,5,9,24,12,3,7,0,37,46,0
9261,82132,UUZ8BPtKmDd7fu7X5v0nxZ0blsaD4W7o,5Gyp41oLVo7Gg7vF4vpmggWP5MU70QO6,15,23,11,6,5,3,48,3,99,14.142857142857142,5,0.0,1,11,4,5,22,3,2,48,3,21,78,1
9262,82140,m2vHU6I2vHbIjXkP5syq1gW8Xrvw3Ajn,5Gyp41oLVo7Gg7vF4vpmggWP5MU70QO6,14,21,7,2,4,1,5,0,40,5.714285714285714,1,0.0,10,7,1,4,11,1,1,5,0,22,18,1
9263,82156,pvwCMEkEuouZMLykCCdaUt3Holz1rXIP,5Gyp41oLVo7Gg7vF4vpmggWP5MU70QO6,7,3,2,0,2,0,5,0,12,1.7142857142857142,2,0.0,0,2,0,2,3,0,0,5,0,4,8,1
9264,82158,6nLW7vb3UEnUZBkO8BF0tZXFHSpKRYLR,5Gyp41oLVo7Gg7vF4vpmggWP5MU70QO6,7,3,2,0,2,0,2,0,9,1.2857142857142858,1,0.0,0,2,0,2,3,0,0,2,0,4,5,1
9265,82166,XmfaTDISWF5comI3j0oigEszknbdPhWn,5Gyp41oLVo7Gg7vF4vpmggWP5MU70QO6,13,6,5,0,3,0,4,1,19,2.7142857142857144,1,0.0,0,5,0,3,6,0,0,4,1,8,11,1
9266,82170,MY8EEZrNKd2bRcqc2C0ahob3DWC1rh6l,5Gyp41oLVo7Gg7vF4vpmggWP5MU70QO6,5,5,1,0,2,0,1,0,9,1.2857142857142858,1,0.0,2,1,0,2,3,0,0,1,0,5,4,1
9267,82174,ncPZRMbiKY9KkV5EbPeewQlV9WFZuuny,5Gyp41oLVo7Gg7vF4vpmggWP5MU70QO6,14,13,9,0,3,0,8,0,33,4.714285714285714,2,0.0,1,9,0,3,12,0,0,8,0,13,20,1
9268,82193,emp71NVk1KXao3OlLR8agWGAj1IKUQ7Q,5Gyp41oLVo7Gg7vF4vpmggWP5MU70QO6,9,10,7,0,5,0,4,0,26,3.7142857142857144,2,0.0,0,7,0,5,10,0,0,4,0,12,14,1
9269,82198,5AFyzPkHwyTVsfPkttq2r1sY0ki8ht9E,5Gyp41oLVo7Gg7vF4vpmggWP5MU70QO6,5,2,1,0,1,0,3,0,7,1.0,1,0.0,0,1,0,1,2,0,0,3,0,2,5,1
9270,82204,r4LtQoLlaaTrHds7HYAdM3HkMRox2Az0,5Gyp41oLVo7Gg7vF4vpmggWP5MU70QO6,7,8,2,0,1,0,2,0,13,1.8571428571428572,2,0.0,0,2,0,1,8,0,0,2,0,3,10,1
9271,82234,AvrMRFWoCuzDtN7hbx3GuuisUX9dn4mc,5Gyp41oLVo7Gg7vF4vpmggWP5MU70QO6,10,16,7,0,3,1,5,0,32,4.571428571428571,4,0.0,2,7,0,3,14,1,0,5,0,12,20,1
9272,82248,4oUbp13NVHc29DccFhqfdkKKNEywtCeE,5Gyp41oLVo7Gg7vF4vpmggWP5MU70QO6,6,1,1,0,1,0,3,0,6,0.8571428571428571,1,0.0,0,1,0,1,1,0,0,3,0,2,4,1
9273,82252,uJ1omfNa6wThHrODhBq1mtJVihr2Vf9k,5Gyp41oLVo7Gg7vF4vpmggWP5MU70QO6,6,3,1,0,1,0,4,0,9,1.2857142857142858,1,0.0,0,1,0,1,3,0,0,4,0,2,7,0
9274,82261,KpB9pFcFkZGqFLAJyYAoBcRReytXA7a4,5Gyp41oLVo7Gg7vF4vpmggWP5MU70QO6,6,3,2,0,2,0,1,0,8,1.1428571428571428,1,0.0,0,2,0,2,3,0,0,1,0,4,4,1
9275,82265,GKB9h3WVdBElKYEACxUSpjlSvU0bLxUa,5Gyp41oLVo7Gg7vF4vpmggWP5MU70QO6,11,13,6,0,6,0,2,0,27,3.857142857142857,1,0.0,0,6,0,6,13,0,0,2,0,12,15,1
9276,82272,0P2GtMy28JDcPARuexfQD2kqs1CWnSqR,5Gyp41oLVo7Gg7vF4vpmggWP5MU70QO6,7,4,2,0,3,0,3,0,12,1.7142857142857142,2,0.0,1,2,0,3,3,0,0,3,0,6,6,0
9277,82277,O9Pboxj2Omf1Ml9NHOiRahIRShnC75bO,5Gyp41oLVo7Gg7vF4vpmggWP5MU70QO6,1,0,0,0,0,0,2,0,2,0.2857142857142857,1,0.0,0,0,0,0,0,0,0,2,0,0,2,1
9278,82285,bueP8xU7CdiOxIwikFuvLqc6wvzofi5k,5Gyp41oLVo7Gg7vF4vpmggWP5MU70QO6,14,9,6,4,4,3,6,0,32,4.571428571428571,1,0.0,2,6,2,4,7,3,2,6,0,14,18,1
9279,82287,fKIYKEAGjFjOVTaUhIbkE3jtMMjkLesA,5Gyp41oLVo7Gg7vF4vpmggWP5MU70QO6,11,20,6,0,3,1,8,0,38,5.428571428571429,4,0.0,2,6,0,3,18,1,0,8,0,11,27,1
9280,82291,6Syl5iFEMiZhZ3Kx0ufBuMuPfsA0G6FI,5Gyp41oLVo7Gg7vF4vpmggWP5MU70QO6,6,2,1,0,1,0,5,0,9,1.2857142857142858,1,0.0,0,1,0,1,2,0,0,5,0,2,7,1
9281,82292,vCT5TWno1npWLslO7yYTAIaOZBV06mao,fbPkOYLVPtPgIt0MxizjfFJov3JbHyAi,3,2,0,0,0,0,1,0,3,0.42857142857142855,1,0.0,0,0,0,0,2,0,0,1,0,0,3,1
9282,82294,mPSu9wD4am4oNde1aNJ4Hx4pSuKdoZ9s,fbPkOYLVPtPgIt0MxizjfFJov3JbHyAi,1,0,0,0,0,0,1,0,1,0.14285714285714285,1,0.0,0,0,0,0,0,0,0,1,0,0,1,1
9283,82295,2vTiDJaUXObkB4MCSVV6b36fCzIFNmlO,fbPkOYLVPtPgIt0MxizjfFJov3JbHyAi,7,1,1,0,1,14,17,1,35,5.0,2,0.0,0,1,0,1,1,14,0,17,1,2,33,1
9284,82297,mucqYKQHr68fZN1W1bDFGJobVl8lTzGk,fbPkOYLVPtPgIt0MxizjfFJov3JbHyAi,5,2,1,0,1,0,4,0,8,1.1428571428571428,1,0.0,0,1,0,1,2,0,0,4,0,2,6,1
9285,82299,qGj2UPAGCVKaEMFWyN0RHLn8amW4mHcs,fbPkOYLVPtPgIt0MxizjfFJov3JbHyAi,2,0,0,0,0,0,2,0,2,0.2857142857142857,1,0.0,0,0,0,0,0,0,0,2,0,0,2,1
9286,82301,qDO5LP5T3lr3EoF63npeMJOU1F5CHwlT,fbPkOYLVPtPgIt0MxizjfFJov3JbHyAi,1,0,0,0,0,0,1,0,1,0.14285714285714285,1,0.0,0,0,0,0,0,0,0,1,0,0,1,1
9287,82302,LJ7sgKzaMtvAPFXeVXXiaB5SrStNVwGH,fbPkOYLVPtPgIt0MxizjfFJov3JbHyAi,2,0,0,0,0,0,2,0,2,0.2857142857142857,1,0.0,0,0,0,0,0,0,0,2,0,0,2,1
9288,82303,7cOxNQ9QY0kpQ3XCTHRP00ygFCzb9CpO,fbPkOYLVPtPgIt0MxizjfFJov3JbHyAi,7,4,2,0,1,2,4,1,14,2.0,2,0.0,0,2,0,1,4,2,0,4,1,3,11,1
9289,82304,zrkzLXbSKLZ5TMR3XqCd3VcTJUh1RbFU,fbPkOYLVPtPgIt0MxizjfFJov3JbHyAi,7,3,2,0,2,0,2,0,9,1.2857142857142858,1,0.0,0,2,0,2,3,0,0,2,0,4,5,1
9290,82305,5D84XSx425N7nheLe6kqFUzsI4xGTRr7,fbPkOYLVPtPgIt0MxizjfFJov3JbHyAi,15,23,7,8,10,4,7,1,60,8.571428571428571,1,0.0,13,7,6,10,10,4,2,7,1,36,24,1
9291,82307,i6tlOFL86lQi7en8qXwdqAGtc3xj3T2v,fbPkOYLVPtPgIt0MxizjfFJov3JbHyAi,1,0,0,0,0,0,1,0,1,0.14285714285714285,1,0.0,0,0,0,0,0,0,0,1,0,0,1,1
9292,82308,dMfbUZDFyVyywHwJG3Dt4QrakRtLnsTX,fbPkOYLVPtPgIt0MxizjfFJov3JbHyAi,7,3,2,0,2,0,2,0,9,1.2857142857142858,1,0.0,0,2,0,2,3,0,0,2,0,4,5,1
9293,82309,R2bsNKaCyFNpEJtfIBR7wHhqazhTieVv,fbPkOYLVPtPgIt0MxizjfFJov3JbHyAi,5,3,2,0,1,0,1,0,7,1.0,1,0.0,0,2,0,1,3,0,0,1,0,3,4,1
9294,82310,2Hh0hyPi2bcd1tRNePJ2qIF1dysf5ndk,fbPkOYLVPtPgIt0MxizjfFJov3JbHyAi,6,2,1,0,1,0,6,0,10,1.4285714285714286,1,0.0,1,1,0,1,1,0,0,6,0,3,7,1
9295,82311,Ll3IzS1S6bZksUUlpyvq7rkVFnPwdP4J,fbPkOYLVPtPgIt0MxizjfFJov3JbHyAi,7,3,2,0,2,0,4,0,11,1.5714285714285714,1,0.0,0,2,0,2,3,0,0,4,0,4,7,1
9296,82312,Ocs5vn2Cz5hAUdTB4aWABUkRHND3d6Kt,fbPkOYLVPtPgIt0MxizjfFJov3JbHyAi,6,6,3,0,2,0,4,0,15,2.142857142857143,2,0.0,0,3,0,2,6,0,0,4,0,5,10,1
9297,82313,x2Dh8FpB4LfDSl1DvzXzmScd6yLeEPWy,fbPkOYLVPtPgIt0MxizjfFJov3JbHyAi,4,0,0,0,0,0,5,0,5,0.7142857142857143,1,0.0,0,0,0,0,0,0,0,5,0,0,5,1
9298,82314,XIDZAAoEp5yiaJ1NSNfTaFGT6RLKKbeY,fbPkOYLVPtPgIt0MxizjfFJov3JbHyAi,1,0,0,0,0,0,1,0,1,0.14285714285714285,1,0.0,0,0,0,0,0,0,0,1,0,0,1,1
9299,82315,t2E5rQgbhesaMxxpyksf3DgIq81BWWBg,fbPkOYLVPtPgIt0MxizjfFJov3JbHyAi,5,4,2,0,1,0,2,0,9,1.2857142857142858,1,0.0,0,2,0,1,4,0,0,2,0,3,6,1
9300,82321,npaSrrzEzioGRzWdj7UAaA6xDgKQrILa,5X6FeZozNMgE2VRi3MJYjkkFK8SETtu2,4,3,1,0,0,0,2,0,6,0.8571428571428571,1,0.0,0,1,0,0,3,0,0,2,0,1,5,1
9301,82337,0XFCa4HLY6qqhFLkbyOG8QvQlbZdVLQp,7GRhBDsirIGkRZBtSMEzNTyDr2JQm4xx,3,0,0,0,0,0,3,0,3,0.42857142857142855,1,0.0,0,0,0,0,0,0,0,3,0,0,3,1
9302,82347,HMYpimZGFgj5IczDutkfjUfnxl45PoHW,7GRhBDsirIGkRZBtSMEzNTyDr2JQm4xx,1,0,0,0,0,0,5,0,5,0.7142857142857143,3,0.0,0,0,0,0,0,0,0,5,0,0,5,1
9303,82354,4Kx1Tk1FEFaPAhJJ1qabZH7R2QRjZNC4,7GRhBDsirIGkRZBtSMEzNTyDr2JQm4xx,11,8,4,2,3,1,2,0,20,2.857142857142857,1,0.0,2,4,1,3,6,1,1,2,0,10,10,1
9304,82357,1v1hnAW2fjxDgMlfMAcBqTKOh6UMFrVl,7GRhBDsirIGkRZBtSMEzNTyDr2JQm4xx,31,40,17,4,17,1,16,0,95,13.571428571428571,4,0.0,16,17,3,17,24,1,1,16,0,53,42,1
9305,82358,GulRMWFcPY5JE8HNbJPRyRdVqJqL2eEA,5X6FeZozNMgE2VRi3MJYjkkFK8SETtu2,13,8,1,22,2,0,2,0,35,5.0,1,0.0,5,1,17,2,3,0,5,2,0,25,10,1
9306,82369,1EoPeAPt0rQExpDMUB0Oh9LRcg1yhFWa,7GRhBDsirIGkRZBtSMEzNTyDr2JQm4xx,1,0,0,0,0,0,1,0,1,0.14285714285714285,1,0.0,0,0,0,0,0,0,0,1,0,0,1,1
9307,82372,P59zgxkiZZAY4L2oDvB0C7gvcL7QBtyx,5X6FeZozNMgE2VRi3MJYjkkFK8SETtu2,6,19,11,0,3,0,9,0,42,6.0,1,0.0,1,11,0,3,18,0,0,9,0,15,27,0
9308,82391,r6vCAWlYIzTyZ2tN64AHwtfHr1599fdG,7GRhBDsirIGkRZBtSMEzNTyDr2JQm4xx,78,386,12,186,20,4,100,2,710,101.42857142857143,15,0.0,246,12,155,20,140,4,31,100,2,433,277,0
9309,82402,9ZFS4K1NbtsFJNVDZcG24bdRzdU6w1Qj,5X6FeZozNMgE2VRi3MJYjkkFK8SETtu2,2,0,0,0,0,0,3,0,3,0.42857142857142855,2,0.0,0,0,0,0,0,0,0,3,0,0,3,1
9310,82419,kkrf4aiGvXPFoVcEvoantT9MIbaoN3ev,7GRhBDsirIGkRZBtSMEzNTyDr2JQm4xx,2,0,0,0,0,0,2,0,2,0.2857142857142857,1,0.0,0,0,0,0,0,0,0,2,0,0,2,1
9311,82425,AYyigeqx54KlykjSn8XXM8xIAmNPwwgy,7GRhBDsirIGkRZBtSMEzNTyDr2JQm4xx,1,0,0,0,0,0,1,0,1,0.14285714285714285,1,0.0,0,0,0,0,0,0,0,1,0,0,1,1
9312,82426,AYyigeqx54KlykjSn8XXM8xIAmNPwwgy,5X6FeZozNMgE2VRi3MJYjkkFK8SETtu2,8,9,0,0,0,14,9,0,32,4.571428571428571,1,0.0,2,0,0,0,7,14,0,9,0,2,30,1
9313,82434,5MqtNGumkUVehW5cfaAfZ7nPmHPSTQ7V,5X6FeZozNMgE2VRi3MJYjkkFK8SETtu2,10,8,1,14,1,0,2,0,26,3.7142857142857144,1,0.0,4,1,13,1,4,0,1,2,0,19,7,1
9314,82439,nsVUUOs0l2kNCEJWP7CuzEzLUL7HHA2o,7GRhBDsirIGkRZBtSMEzNTyDr2JQm4xx,1,0,0,0,0,0,1,0,1,0.14285714285714285,1,0.0,0,0,0,0,0,0,0,1,0,0,1,1
9315,82443,506JH480T3Hay89W7G1dTs4qRT8mnHIv,7GRhBDsirIGkRZBtSMEzNTyDr2JQm4xx,4,3,1,0,0,0,2,0,6,0.8571428571428571,1,0.0,0,1,0,0,3,0,0,2,0,1,5,1
9316,82444,0OsY8LWQHJyrf2iZ6AGYuDrpmW3bfvqO,7GRhBDsirIGkRZBtSMEzNTyDr2JQm4xx,23,29,14,14,8,0,5,0,70,10.0,1,0.0,11,14,8,8,18,0,6,5,0,41,29,1
9317,82445,BA6kCSqOZYgPcpy87C2hTl09S7lpFd09,7GRhBDsirIGkRZBtSMEzNTyDr2JQm4xx,8,8,2,6,3,2,2,0,23,3.2857142857142856,1,0.0,2,2,5,3,6,2,1,2,0,12,11,0
9318,82460,N0lIDzx7ySDqstMupMct3nbriqwOpqNG,5X6FeZozNMgE2VRi3MJYjkkFK8SETtu2,1,0,0,0,0,0,1,0,1,0.14285714285714285,1,0.0,0,0,0,0,0,0,0,1,0,0,1,1
9319,82478,FG49dGsnehbDquxb5MR2UKw7UsmsUWRR,5X6FeZozNMgE2VRi3MJYjkkFK8SETtu2,1,0,0,0,0,0,2,0,2,0.2857142857142857,1,0.0,0,0,0,0,0,0,0,2,0,0,2,1
9320,82479,iVw6PFrlJCMW2i4yQDVBv0p8rh0bg8oB,7GRhBDsirIGkRZBtSMEzNTyDr2JQm4xx,10,10,3,0,1,9,15,0,38,5.428571428571429,2,0.0,2,3,0,1,8,9,0,15,0,6,32,1
9321,82490,nCjvWGBuFy5INkXPz8A7SRdydYBldjvQ,5X6FeZozNMgE2VRi3MJYjkkFK8SETtu2,6,10,1,0,1,0,2,0,14,2.0,1,0.0,7,1,0,1,3,0,0,2,0,9,5,1
9322,82501,C90t4OTJKLckQlEHPGqMg6X9e1cv22jh,7GRhBDsirIGkRZBtSMEzNTyDr2JQm4xx,5,2,1,0,1,0,4,0,8,1.1428571428571428,2,0.0,0,1,0,1,2,0,0,4,0,2,6,1
9323,82516,akfKNyiclQIBJSqS87A1d10ODSvejPEf,7GRhBDsirIGkRZBtSMEzNTyDr2JQm4xx,4,2,0,0,0,0,2,0,4,0.5714285714285714,1,0.0,0,0,0,0,2,0,0,2,0,0,4,1
9324,82545,mnt6WUJv4Nm9SlBAqM8Wy80LtV0oy5xh,7GRhBDsirIGkRZBtSMEzNTyDr2JQm4xx,1,0,0,0,0,0,1,0,1,0.14285714285714285,1,0.0,0,0,0,0,0,0,0,1,0,0,1,1
9325,82548,2DJrQZ1DQwZ17FIT9rErCdsuhNRIOxUc,7GRhBDsirIGkRZBtSMEzNTyDr2JQm4xx,1,0,0,0,0,0,1,0,1,0.14285714285714285,1,0.0,0,0,0,0,0,0,0,1,0,0,1,1
9326,82551,UJiJ4PvH4qodyDnURbFXyi5LWwaSKUwb,7GRhBDsirIGkRZBtSMEzNTyDr2JQm4xx,11,11,6,8,5,0,2,0,32,4.571428571428571,1,0.0,2,6,6,5,9,0,2,2,0,19,13,1
9327,82552,z6hFsPzsbEnFbaZ8fz961gcLxQ5khAMh,7GRhBDsirIGkRZBtSMEzNTyDr2JQm4xx,1,0,0,0,0,0,1,0,1,0.14285714285714285,1,0.0,0,0,0,0,0,0,0,1,0,0,1,1
9328,82569,CbshEYIe2wcAzVubCMNTR8AyCYM6IoV7,5X6FeZozNMgE2VRi3MJYjkkFK8SETtu2,8,6,0,0,1,0,3,0,10,1.4285714285714286,1,0.0,2,0,0,1,4,0,0,3,0,3,7,1
9329,82580,99Z3XYkjkHbSSUTlX3TBtdd4he2ej5Yp,5X6FeZozNMgE2VRi3MJYjkkFK8SETtu2,5,2,1,0,1,0,2,0,6,0.8571428571428571,1,0.0,0,1,0,1,2,0,0,2,0,2,4,1
9330,82581,aq4CF7Ase1niDETNNnN3SPNstQIkMzIb,7GRhBDsirIGkRZBtSMEzNTyDr2JQm4xx,1,0,0,0,0,0,1,0,1,0.14285714285714285,1,0.0,0,0,0,0,0,0,0,1,0,0,1,1
9331,82587,4BgAKbYEi6Ae1ZfaDy8dVhzCZKLQsM2C,7GRhBDsirIGkRZBtSMEzNTyDr2JQm4xx,2,0,0,0,0,0,2,0,2,0.2857142857142857,1,0.0,0,0,0,0,0,0,0,2,0,0,2,1
9332,82609,8t2I7RZ6tGpzDNhY5KSmkbKJTicFPhFD,SpATywNh6bZuzm8s1ceuBUnMUAeoAHHw,55,81,44,52,22,0,27,0,226,32.285714285714285,8,0.0,27,44,46,22,54,0,6,27,0,139,87,0
9333,82611,7xsMLAoX5cfA1ELNnW1Jyq3921JNch8p,bWdj2GDclj5ofokWjzoa5jAwMkxCykd6,7,5,2,0,1,0,9,0,17,2.4285714285714284,1,0.0,0,2,0,1,5,0,0,9,0,3,14,1
9334,82619,HBNOGDmQrCA8ZCNHwMOm4mGR9448iscJ,A3fsA9Zfv1X2fVEQhTw51lKENdNrEqT3,9,3,2,0,2,0,8,1,16,2.2857142857142856,2,0.0,0,2,0,2,3,0,0,8,1,4,12,0
9335,82626,1LsKSfuKnKljzcVBDuX88jdA4iNAFPmK,SpATywNh6bZuzm8s1ceuBUnMUAeoAHHw,8,39,19,0,15,0,10,0,83,11.857142857142858,2,0.0,2,19,0,15,37,0,0,10,0,36,47,0
9336,82633,xLA7fhjHBFsq0q4kxpkXfUkRljEs0TAd,SpATywNh6bZuzm8s1ceuBUnMUAeoAHHw,14,29,21,4,8,1,8,0,71,10.142857142857142,3,0.0,3,21,4,8,26,1,0,8,0,36,35,0
9337,82635,xLA7fhjHBFsq0q4kxpkXfUkRljEs0TAd,bWdj2GDclj5ofokWjzoa5jAwMkxCykd6,30,49,27,82,9,15,20,0,202,28.857142857142858,4,0.0,10,27,80,9,39,15,2,20,0,126,76,0
9338,82641,TqooiK8GaIskZ1TWtOHUh45RuTpvOkj9,SpATywNh6bZuzm8s1ceuBUnMUAeoAHHw,7,6,4,0,3,0,3,0,16,2.2857142857142856,1,0.0,0,4,0,3,6,0,0,3,0,7,9,0
9339,82642,7IO6p4687fQRowFKh8aP2BRrTBz96sXF,G8EPVSXsOYB5YQWZGiz1aVq5Pgr2GrQu,37,28,15,24,13,3,16,2,101,14.428571428571429,6,0.0,7,15,16,13,21,3,8,16,2,51,50,0
9340,82654,CSh5hGbaSFu2yCb31iVMOVwKocrH471Q,5X6FeZozNMgE2VRi3MJYjkkFK8SETtu2,17,19,6,20,8,0,6,0,59,8.428571428571429,2,0.0,10,6,18,8,9,0,2,6,0,42,17,1
9341,82661,pSfJ0uMpX5mtiDADVfED9j2PrehMi4qf,SpATywNh6bZuzm8s1ceuBUnMUAeoAHHw,11,14,5,0,4,0,2,0,25,3.5714285714285716,1,0.0,8,5,0,4,6,0,0,2,0,17,8,1
9342,82682,pSfJ0uMpX5mtiDADVfED9j2PrehMi4qf,bWdj2GDclj5ofokWjzoa5jAwMkxCykd6,7,4,2,0,2,0,2,0,10,1.4285714285714286,1,0.0,1,2,0,2,3,0,0,2,0,5,5,1
9343,82686,r2H5XCYvW75clbYorkxbeTJTDpcuYsqR,A3fsA9Zfv1X2fVEQhTw51lKENdNrEqT3,1,0,0,0,0,0,1,0,1,0.14285714285714285,1,0.0,0,0,0,0,0,0,0,1,0,0,1,1
9344,82713,Qej7uJiPxPofj5VkSw5arNMXnDFwdHaU,bWdj2GDclj5ofokWjzoa5jAwMkxCykd6,1,0,0,0,0,0,1,0,1,0.14285714285714285,1,0.0,0,0,0,0,0,0,0,1,0,0,1,1
9345,82714,dmKq4wezB2pymsF6jHa3iwdFnCP4NIvi,SpATywNh6bZuzm8s1ceuBUnMUAeoAHHw,4,2,0,0,0,0,2,0,4,0.5714285714285714,1,0.0,0,0,0,0,2,0,0,2,0,0,4,1
9346,82722,i0k5iK0fS6RmfXLKfz70zhtGt8sKmdev,G8EPVSXsOYB5YQWZGiz1aVq5Pgr2GrQu,19,41,5,40,2,0,6,0,94,13.428571428571429,4,0.0,0,5,35,2,41,0,5,6,0,42,52,1
9347,82731,Yoi2x66FMpn68ZsrWcG2qShRXgJS18Rh,G8EPVSXsOYB5YQWZGiz1aVq5Pgr2GrQu,15,17,16,0,7,11,8,0,59,8.428571428571429,1,0.0,0,16,0,7,17,11,0,8,0,23,36,1
9348,82751,8kDMxN2jxnl0uIdlggQjT6QmHT7F6WvQ,A3fsA9Zfv1X2fVEQhTw51lKENdNrEqT3,10,12,1,0,0,0,8,0,21,3.0,4,0.0,0,1,0,0,12,0,0,8,0,1,20,0
9349,82772,ydoaEAxmO4gHSSp9D7mNNRYfsM5IVoFl,SpATywNh6bZuzm8s1ceuBUnMUAeoAHHw,6,0,0,0,0,1,5,1,7,1.0,1,0.0,0,0,0,0,0,1,0,5,1,0,7,1
9350,82820,PCDzowxElNLixXyfAFPkQqlbkMlIrEa9,SpATywNh6bZuzm8s1ceuBUnMUAeoAHHw,1,0,0,0,0,0,1,0,1,0.14285714285714285,1,0.0,0,0,0,0,0,0,0,1,0,0,1,1
9351,82828,PCDzowxElNLixXyfAFPkQqlbkMlIrEa9,RXDvfPUBYFlVdlueBFbLW0mhhAyGEqpt,1,0,0,0,0,0,1,0,1,0.14285714285714285,1,0.0,0,0,0,0,0,0,0,1,0,0,1,1
9352,82832,bNG7kJA3jy4DW8PDzMNAT9OoyHwhutqS,bWdj2GDclj5ofokWjzoa5jAwMkxCykd6,28,66,1,128,5,0,24,1,225,32.142857142857146,5,0.0,14,1,119,5,52,0,9,24,1,139,86,1
9353,82834,rXk8o13Kpmo1kUY0hqp1VAqDdB7oaIVw,SpATywNh6bZuzm8s1ceuBUnMUAeoAHHw,1,0,0,0,0,0,1,0,1,0.14285714285714285,1,0.0,0,0,0,0,0,0,0,1,0,0,1,1
9354,82840,Jee7EGsn5XYP5oawysLFsO8VcnPFjYWM,SpATywNh6bZuzm8s1ceuBUnMUAeoAHHw,21,29,16,21,8,0,5,0,79,11.285714285714286,3,0.0,9,16,18,8,20,0,3,5,0,51,28,1
9355,82856,2Pkptevs7J69rsFmJqSHjNMBnKCLyXs7,SpATywNh6bZuzm8s1ceuBUnMUAeoAHHw,11,16,13,0,5,0,6,0,40,5.714285714285714,1,0.0,0,13,0,5,16,0,0,6,0,18,22,1
9356,82860,MWgepnFrbhIoMtzaoOzOjEjpjYI14nzb,bWdj2GDclj5ofokWjzoa5jAwMkxCykd6,5,3,0,0,0,0,4,0,7,1.0,1,0.0,0,0,0,0,3,0,0,4,0,0,7,1
9357,82865,UVY9zxbBVUyhzTA4AJhTZxTOHFZ2duQd,SpATywNh6bZuzm8s1ceuBUnMUAeoAHHw,25,34,5,16,1,2,7,0,65,9.285714285714286,3,0.0,5,5,14,1,29,2,2,7,0,25,40,1
9358,82875,LSxdutAKHjruUktaLYDzR4TTFH4npHSj,SpATywNh6bZuzm8s1ceuBUnMUAeoAHHw,15,33,17,14,10,0,12,0,86,12.285714285714286,4,0.0,10,17,13,10,23,0,1,12,0,50,36,1
9359,82897,V05RDMzHe21axAEGmWItNlvN0EepoKmU,5X6FeZozNMgE2VRi3MJYjkkFK8SETtu2,2,0,0,0,0,0,2,0,2,0.2857142857142857,1,0.0,0,0,0,0,0,0,0,2,0,0,2,1
9360,82911,g1LVeBlQiVCOcKiTDDTy4PafQkGd4pbr,A3fsA9Zfv1X2fVEQhTw51lKENdNrEqT3,56,18,12,144,8,0,7,1,190,27.142857142857142,3,0.0,3,12,125,8,15,0,19,7,1,148,42,0
9361,82912,dSKLyWRwDNYp6bnGVfES0oxRsg4F2fbZ,SpATywNh6bZuzm8s1ceuBUnMUAeoAHHw,25,39,2,28,2,0,7,0,78,11.142857142857142,4,0.0,10,2,22,2,29,0,6,7,0,36,42,1
9362,82914,cJcuhtji0eqLhfXtnFSDlw6v5huTlvOS,A3fsA9Zfv1X2fVEQhTw51lKENdNrEqT3,4,2,1,0,1,0,1,0,5,0.7142857142857143,1,0.0,0,1,0,1,2,0,0,1,0,2,3,1
9363,82928,xJa5HsLvA8jsaOm3YgI5AyYKc4qtiOFH,SpATywNh6bZuzm8s1ceuBUnMUAeoAHHw,5,4,1,0,1,0,2,0,8,1.1428571428571428,2,0.0,0,1,0,1,4,0,0,2,0,2,6,1
9364,82934,Vrjrap5JcUBcGnZI9GyoeJ8llD9p1BxJ,SpATywNh6bZuzm8s1ceuBUnMUAeoAHHw,9,5,4,0,4,0,4,0,17,2.4285714285714284,1,0.0,0,4,0,4,5,0,0,4,0,8,9,1
9365,82964,jMzDAkDrCqzTj207GrZXDfLQXbYc8WXP,A3fsA9Zfv1X2fVEQhTw51lKENdNrEqT3,4,0,0,0,0,0,4,0,4,0.5714285714285714,1,0.0,0,0,0,0,0,0,0,4,0,0,4,1
9366,82965,jMzDAkDrCqzTj207GrZXDfLQXbYc8WXP,bWdj2GDclj5ofokWjzoa5jAwMkxCykd6,10,15,7,0,2,10,8,0,42,6.0,2,0.0,0,7,0,2,15,10,0,8,0,9,33,0
9367,82968,k3mZz4gOE5kxngWJdlg5ZkSuFCPjQxmM,A3fsA9Zfv1X2fVEQhTw51lKENdNrEqT3,24,18,13,0,12,0,5,0,48,6.857142857142857,2,0.0,0,13,0,12,18,0,0,5,0,25,23,1
9368,82994,pzQmB4p3u9FrEJSWAX6BNOWRPavo1Lrn,A3fsA9Zfv1X2fVEQhTw51lKENdNrEqT3,1,0,0,0,0,0,1,0,1,0.14285714285714285,1,0.0,0,0,0,0,0,0,0,1,0,0,1,1
9369,82997,HKDSRzc7MQzCfJsk49D6xFQK4oFHHvy7,RXDvfPUBYFlVdlueBFbLW0mhhAyGEqpt,26,50,2,0,2,0,15,0,69,9.857142857142858,4,0.0,13,2,0,2,37,0,0,15,0,17,52,1
9370,83039,2T4Z0Imx9CFpIzAb5WFSfhS9FT4FpZWV,SpATywNh6bZuzm8s1ceuBUnMUAeoAHHw,8,12,7,0,2,0,2,0,23,3.2857142857142856,2,0.0,0,7,0,2,12,0,0,2,0,9,14,1
9371,83046,c9uDpmjbhEZRV8vNkDH73VXR3MBTMWZN,SpATywNh6bZuzm8s1ceuBUnMUAeoAHHw,3,3,0,0,0,0,1,0,4,0.5714285714285714,1,0.0,0,0,0,0,3,0,0,1,0,0,4,1
9372,83062,srfjFpufe5zNlnc0Z3dNMD37ukToEJo1,bWdj2GDclj5ofokWjzoa5jAwMkxCykd6,5,2,1,0,1,0,2,0,6,0.8571428571428571,1,0.0,0,1,0,1,2,0,0,2,0,2,4,1
9373,83077,U58EahcrdrWDxUCYXDIka19POAAfjp1t,SpATywNh6bZuzm8s1ceuBUnMUAeoAHHw,1,0,0,0,0,0,1,0,1,0.14285714285714285,1,0.0,0,0,0,0,0,0,0,1,0,0,1,1
9374,83082,OIznJTzf0VYpJo8slc0B4fnJO5XA07gY,SpATywNh6bZuzm8s1ceuBUnMUAeoAHHw,3,0,0,0,0,0,3,0,3,0.42857142857142855,1,0.0,0,0,0,0,0,0,0,3,0,0,3,1
9375,83107,TBj8ERKtARA6ABLjSlKdebgRJkBjpHod,5X6FeZozNMgE2VRi3MJYjkkFK8SETtu2,10,6,4,0,1,2,9,3,25,3.5714285714285716,1,0.0,0,4,0,1,6,2,0,9,3,5,20,1
9376,83117,TBj8ERKtARA6ABLjSlKdebgRJkBjpHod,RXDvfPUBYFlVdlueBFbLW0mhhAyGEqpt,2,0,0,0,0,0,2,0,2,0.2857142857142857,1,0.0,0,0,0,0,0,0,0,2,0,0,2,1
9377,83123,ZNcLOAJ2r3H5DqhbGk1CiPtwI7ixaCeK,bWdj2GDclj5ofokWjzoa5jAwMkxCykd6,30,25,16,36,11,3,5,0,96,13.714285714285714,3,0.0,2,16,35,11,23,3,1,5,0,64,32,0
9378,83126,Lcn36O95deZy87mO20P7rqE00Sa7JkLZ,SpATywNh6bZuzm8s1ceuBUnMUAeoAHHw,16,30,13,18,2,16,13,1,93,13.285714285714286,5,0.0,11,13,15,2,19,16,3,13,1,41,52,1
9379,83137,4QdCY5LBLprzaTySBBQaKyTy9rCkNUT7,5X6FeZozNMgE2VRi3MJYjkkFK8SETtu2,1,0,0,0,0,0,1,0,1,0.14285714285714285,1,0.0,0,0,0,0,0,0,0,1,0,0,1,1
9380,83139,vwYpmLrcF8bt1idVso7bAZqs27Gfb44w,SpATywNh6bZuzm8s1ceuBUnMUAeoAHHw,1,0,0,0,0,0,2,0,2,0.2857142857142857,2,0.0,0,0,0,0,0,0,0,2,0,0,2,1
9381,83152,eDH23vVDxXZaCChKrwOZtbVMeyImNCFQ,SpATywNh6bZuzm8s1ceuBUnMUAeoAHHw,25,26,13,20,7,0,2,0,68,9.714285714285714,2,0.0,4,13,18,7,22,0,2,2,0,42,26,1
9382,83161,pAklb1PvY7ruK0UegPVyIZm4Osf6iC9m,bWdj2GDclj5ofokWjzoa5jAwMkxCykd6,5,1,1,0,1,0,3,0,6,0.8571428571428571,2,0.0,0,1,0,1,1,0,0,3,0,2,4,1
9383,83169,8xLHRJYQMKIoYFTLtqTA4nbHlXLKnGUi,SpATywNh6bZuzm8s1ceuBUnMUAeoAHHw,14,28,13,9,5,2,7,0,64,9.142857142857142,3,0.0,10,13,8,5,18,2,1,7,0,36,28,0
9384,83173,TxlSnMAR26IaOfJh6C0k9qQhw2BgogEc,A3fsA9Zfv1X2fVEQhTw51lKENdNrEqT3,25,26,10,0,10,0,16,0,62,8.857142857142858,2,0.0,0,10,0,10,26,0,0,16,0,20,42,1
9385,83179,x0laSvoDXG0a7WULReVXZ8zh05t91jGU,bWdj2GDclj5ofokWjzoa5jAwMkxCykd6,9,25,6,0,0,0,2,0,33,4.714285714285714,1,0.0,0,6,0,0,25,0,0,2,0,6,27,1
9386,83196,mJZNVvZltlGUOWmItS7lca1ZZKMYLgfv,5X6FeZozNMgE2VRi3MJYjkkFK8SETtu2,16,16,1,30,1,0,3,0,51,7.285714285714286,2,0.0,9,1,23,1,7,0,7,3,0,34,17,1
9387,83203,cpPSwRiyzrnBZYcFR4yyg60XVFgQxQi4,A3fsA9Zfv1X2fVEQhTw51lKENdNrEqT3,2,0,0,0,0,0,2,0,2,0.2857142857142857,1,0.0,0,0,0,0,0,0,0,2,0,0,2,1
9388,83204,jBaD9LGpQhL9ahJeTZMqoOmC2qbpaMeG,5X6FeZozNMgE2VRi3MJYjkkFK8SETtu2,23,27,8,20,12,1,9,1,78,11.142857142857142,3,0.0,14,8,19,12,13,1,1,9,1,53,25,0
9389,83225,PQOxOuUmyRHKBoJFPoN8Q817ShM1EBnU,SpATywNh6bZuzm8s1ceuBUnMUAeoAHHw,19,28,9,3,6,0,6,0,52,7.428571428571429,3,0.0,14,9,3,6,14,0,0,6,0,32,20,1
9390,83229,x0laSvoDXG0a7WULReVXZ8zh05t91jGU,SpATywNh6bZuzm8s1ceuBUnMUAeoAHHw,10,29,7,0,0,0,2,0,38,5.428571428571429,1,0.0,0,7,0,0,29,0,0,2,0,7,31,1
9391,83231,d7WW3KTRknYcXaBZVYoIbNodkFYiI6Ik,A3fsA9Zfv1X2fVEQhTw51lKENdNrEqT3,18,18,8,0,6,2,8,1,43,6.142857142857143,2,0.0,0,8,0,6,18,2,0,8,1,14,29,1
9392,83237,EzJ8kmSst3q4WJG0Np16XBDvh9hFUAyd,SpATywNh6bZuzm8s1ceuBUnMUAeoAHHw,12,17,1,4,0,2,2,0,26,3.7142857142857144,3,0.0,0,1,4,0,17,2,0,2,0,5,21,0
9393,83257,kGjYv3fIEEVtPJnIV3ey8jABNxw0G9DP,5X6FeZozNMgE2VRi3MJYjkkFK8SETtu2,3,0,0,0,0,5,2,0,7,1.0,1,0.0,0,0,0,0,0,5,0,2,0,0,7,1
9394,83259,kGjYv3fIEEVtPJnIV3ey8jABNxw0G9DP,A3fsA9Zfv1X2fVEQhTw51lKENdNrEqT3,8,6,3,0,1,0,5,0,15,2.142857142857143,1,0.0,0,3,0,1,6,0,0,5,0,4,11,1
9395,83271,8rZiJk9Qyng7Kz2M0sWaeZmr6L3VBmoQ,A3fsA9Zfv1X2fVEQhTw51lKENdNrEqT3,1,0,0,0,0,0,1,0,1,0.14285714285714285,1,0.0,0,0,0,0,0,0,0,1,0,0,1,1
9396,83274,nronI72HtraF0IcAJUYxB4sbj9I4wtB0,bWdj2GDclj5ofokWjzoa5jAwMkxCykd6,27,48,25,134,12,0,8,0,227,32.42857142857143,2,0.0,8,25,125,12,40,0,9,8,0,170,57,1
9397,83294,drMAzq4nC1GseQmyuPqctPxioPnjLJpD,bWdj2GDclj5ofokWjzoa5jAwMkxCykd6,9,7,1,2,2,0,6,1,19,2.7142857142857144,2,0.0,2,1,2,2,5,0,0,6,1,7,12,1
9398,83296,WlpCtlv6l7VubBVcQacaEfXgsH5IUowW,bWdj2GDclj5ofokWjzoa5jAwMkxCykd6,2,0,0,0,0,0,2,0,2,0.2857142857142857,1,0.0,0,0,0,0,0,0,0,2,0,0,2,1
9399,83299,DawlCH8NcvFmcnrUGRB8b9wi64nyiEPI,RXDvfPUBYFlVdlueBFbLW0mhhAyGEqpt,1,0,0,0,0,0,1,0,1,0.14285714285714285,1,0.0,0,0,0,0,0,0,0,1,0,0,1,1
9400,83305,4NR9J7NrWx9P8bFiOFbZEGtYIezzdGum,SpATywNh6bZuzm8s1ceuBUnMUAeoAHHw,6,5,2,0,1,0,5,0,13,1.8571428571428572,3,0.0,0,2,0,1,5,0,0,5,0,3,10,1
9401,83313,6cy8BWaUGaMCAOjojQczbStvsRKYISdK,SpATywNh6bZuzm8s1ceuBUnMUAeoAHHw,31,47,24,16,9,5,11,0,112,16.0,3,0.0,8,24,16,9,39,5,0,11,0,57,55,0
9402,83314,n49l3ufDNhve5wMzUe1UGnoLeZWomGLA,SpATywNh6bZuzm8s1ceuBUnMUAeoAHHw,8,8,5,0,3,0,2,0,18,2.5714285714285716,2,0.0,0,5,0,3,8,0,0,2,0,8,10,1
9403,83320,7uDVcwukNss0paMtTOJXNPZUXWP9vYuG,SpATywNh6bZuzm8s1ceuBUnMUAeoAHHw,5,5,0,0,0,0,1,0,6,0.8571428571428571,1,0.0,0,0,0,0,5,0,0,1,0,0,6,1
9404,83351,9HqwJ8d4m6K7QOSGhF3dVzXYAYpOl0vj,SpATywNh6bZuzm8s1ceuBUnMUAeoAHHw,4,2,1,0,1,0,1,0,5,0.7142857142857143,1,0.0,0,1,0,1,2,0,0,1,0,2,3,1
9405,83362,UROHliIogkXuXAccUzTqFupOwNjOEbXL,SpATywNh6bZuzm8s1ceuBUnMUAeoAHHw,7,7,1,0,1,0,4,0,13,1.8571428571428572,1,0.0,0,1,0,1,7,0,0,4,0,2,11,1
9406,83387,6rAXQgJka1nTTwbebP8kTYZLBZ3H51fb,A3fsA9Zfv1X2fVEQhTw51lKENdNrEqT3,6,3,1,0,1,0,2,0,7,1.0,1,0.0,0,1,0,1,3,0,0,2,0,2,5,1
9407,83394,4Wmd4Th2aTvlEICpolKlrpcWMkbPEV69,RXDvfPUBYFlVdlueBFbLW0mhhAyGEqpt,44,37,14,58,16,10,2,0,137,19.571428571428573,1,0.0,21,14,56,16,16,10,2,2,0,107,30,1
9408,83403,e7qNFJlKhMPlLeAG8swrUc3pRnnUCD82,SpATywNh6bZuzm8s1ceuBUnMUAeoAHHw,29,39,24,33,12,2,10,0,120,17.142857142857142,5,0.0,9,24,30,12,30,2,3,10,0,75,45,0
9409,83407,DmtYVZArE2EvS9aiKUqKSMgZGIBgO1QS,RXDvfPUBYFlVdlueBFbLW0mhhAyGEqpt,25,26,15,43,7,0,6,0,97,13.857142857142858,3,0.0,3,15,39,7,23,0,4,6,0,64,33,1
9410,83412,AImx2eHFGaeqTe0d3fwuX86fffC0rd9k,SpATywNh6bZuzm8s1ceuBUnMUAeoAHHw,6,5,2,2,1,0,1,0,11,1.5714285714285714,1,0.0,2,2,2,1,3,0,0,1,0,7,4,1
9411,83415,RbskEZqQKwCnVdL6duQzlEj5uu5RNIef,G8EPVSXsOYB5YQWZGiz1aVq5Pgr2GrQu,16,27,12,8,7,7,9,0,70,10.0,1,0.0,11,12,7,7,16,7,1,9,0,37,33,1
9412,83425,Lr6km982apCQSCgmC6f9GQFgHOEktsCy,G8EPVSXsOYB5YQWZGiz1aVq5Pgr2GrQu,12,7,2,14,1,1,6,0,31,4.428571428571429,3,0.0,0,2,12,1,7,1,2,6,0,15,16,1
9413,83436,Pp6wRQkPti9Bk2fBcpI0VrxeT3AtZv4c,A3fsA9Zfv1X2fVEQhTw51lKENdNrEqT3,1,0,0,0,0,0,1,0,1,0.14285714285714285,1,0.0,0,0,0,0,0,0,0,1,0,0,1,1
9414,83457,ZxhebDCFWL0m0f61BciDLXGRMOKOE45R,SpATywNh6bZuzm8s1ceuBUnMUAeoAHHw,2,0,0,0,0,0,3,0,3,0.42857142857142855,1,0.0,0,0,0,0,0,0,0,3,0,0,3,1
9415,83490,XjHYgZsrS0l8TkcDRDNv64IhD09kdX0g,RXDvfPUBYFlVdlueBFbLW0mhhAyGEqpt,1,0,0,0,0,0,1,0,1,0.14285714285714285,1,0.0,0,0,0,0,0,0,0,1,0,0,1,1
9416,83498,XedkRmZw73FBMyT7OPP5ylIVnvaHlAGN,5X6FeZozNMgE2VRi3MJYjkkFK8SETtu2,7,4,3,0,2,0,2,0,11,1.5714285714285714,1,0.0,0,3,0,2,4,0,0,2,0,5,6,1
9417,83515,EHQfOyQJIuqt0P1nyDah8NPkqTS1EGa4,SpATywNh6bZuzm8s1ceuBUnMUAeoAHHw,13,10,7,0,5,1,7,1,31,4.428571428571429,1,0.0,0,7,0,5,10,1,0,7,1,12,19,1
9418,83519,OmeHT0PntcI0ieBORzxyW3ukuMNHL2Uw,bWdj2GDclj5ofokWjzoa5jAwMkxCykd6,1,0,0,0,0,0,1,0,1,0.14285714285714285,1,0.0,0,0,0,0,0,0,0,1,0,0,1,1
9419,83520,AIxODBgirdS9q7XBbO7B4LHcFYA0NbGc,bWdj2GDclj5ofokWjzoa5jAwMkxCykd6,11,17,4,30,7,0,6,0,64,9.142857142857142,2,0.0,10,4,29,7,7,0,1,6,0,50,14,0
9420,83522,A88tFa21T4XqWWIuRG4iPf7ag41L6qpK,5X6FeZozNMgE2VRi3MJYjkkFK8SETtu2,9,4,4,0,2,0,3,0,13,1.8571428571428572,1,0.0,0,4,0,2,4,0,0,3,0,6,7,1
9421,83524,4Uyhf3xkbmSb7blGg2niZUhegHNb0hzL,SpATywNh6bZuzm8s1ceuBUnMUAeoAHHw,10,8,4,0,3,0,2,0,17,2.4285714285714284,1,0.0,0,4,0,3,8,0,0,2,0,7,10,0
9422,83525,8Rf4S0ug2TWWxQ3mSUdOeqp73t5YEeYH,RXDvfPUBYFlVdlueBFbLW0mhhAyGEqpt,9,6,3,0,4,8,5,0,26,3.7142857142857144,2,0.0,2,3,0,4,4,8,0,5,0,9,17,1
9423,83545,7OnUQoKNPB7YvlLkAtyo2YJK5O7VH0T8,5X6FeZozNMgE2VRi3MJYjkkFK8SETtu2,13,15,2,19,4,3,5,0,48,6.857142857142857,1,0.0,11,2,15,4,4,3,4,5,0,32,16,1
9424,83551,MyYvsUimsdJLREHlZB7pLW11HvGvwatH,5X6FeZozNMgE2VRi3MJYjkkFK8SETtu2,32,72,14,46,22,4,6,1,165,23.571428571428573,4,0.0,28,14,40,22,44,4,6,6,1,104,61,1
9425,83574,bzc6yymc6ktkSbBvgdjBytLe8to97DFg,SpATywNh6bZuzm8s1ceuBUnMUAeoAHHw,5,2,1,0,1,0,2,0,6,0.8571428571428571,1,0.0,0,1,0,1,2,0,0,2,0,2,4,1
9426,83578,t8qBiDTvOvYmrxcVIErRuEOf38tywm6t,A3fsA9Zfv1X2fVEQhTw51lKENdNrEqT3,42,26,20,92,8,9,11,0,166,23.714285714285715,5,0.0,1,20,73,8,25,9,19,11,0,102,64,1
9427,83589,42WEg9p9HKMRw7DcLiehVP064YBoX0CC,G8EPVSXsOYB5YQWZGiz1aVq5Pgr2GrQu,34,20,15,38,6,0,10,0,89,12.714285714285714,1,0.0,1,15,34,6,19,0,4,10,0,56,33,1
9428,83597,kzdGmpsGUR2isiUTRf34FiwBn190CZX2,SpATywNh6bZuzm8s1ceuBUnMUAeoAHHw,8,9,1,1,1,0,2,0,14,2.0,2,0.0,5,1,1,1,4,0,0,2,0,8,6,1
9429,83610,LsCKaHxDojvW6mqkt4YixGtP1AxIvEcR,SpATywNh6bZuzm8s1ceuBUnMUAeoAHHw,26,42,0,22,0,2,16,1,83,11.857142857142858,7,0.0,0,0,18,0,42,2,4,16,1,18,65,0
9430,83614,f0G6xN4ok96NnHxUb12ID1EOiKvmCYmR,SpATywNh6bZuzm8s1ceuBUnMUAeoAHHw,5,19,12,0,0,0,6,0,37,5.285714285714286,4,0.0,0,12,0,0,19,0,0,6,0,12,25,1
9431,83619,DBdf78JfZqUu6Xrj5qSlBFRqX4eZFYBh,SpATywNh6bZuzm8s1ceuBUnMUAeoAHHw,5,5,1,0,0,0,2,0,8,1.1428571428571428,1,0.0,2,1,0,0,3,0,0,2,0,3,5,1
9432,83624,uZO11U6xkUn8TqWyabhD9DUasFPbf13L,SpATywNh6bZuzm8s1ceuBUnMUAeoAHHw,2,0,0,0,0,0,2,0,2,0.2857142857142857,1,0.0,0,0,0,0,0,0,0,2,0,0,2,0
9433,83631,q4FzN29BOCqmKsQz24UjDiDoY7rAOM1p,SpATywNh6bZuzm8s1ceuBUnMUAeoAHHw,1,0,0,0,0,0,1,0,1,0.14285714285714285,1,0.0,0,0,0,0,0,0,0,1,0,0,1,1
9434,83638,kUCkMoz2G1vNKPwfWoTyAK0pg5EEdfy3,5X6FeZozNMgE2VRi3MJYjkkFK8SETtu2,1,0,0,0,0,0,1,0,1,0.14285714285714285,1,0.0,0,0,0,0,0,0,0,1,0,0,1,1
9435,83647,5lUjtpVDM24Ky0bHM8HFsUs8uLGNBspP,SpATywNh6bZuzm8s1ceuBUnMUAeoAHHw,3,3,0,0,0,0,1,0,4,0.5714285714285714,2,0.0,0,0,0,0,3,0,0,1,0,0,4,1
9436,83654,gGPwEyB8WM9RKY8d6MZCxjfZZkbEQNgr,A3fsA9Zfv1X2fVEQhTw51lKENdNrEqT3,1,0,0,0,0,0,1,0,1,0.14285714285714285,1,0.0,0,0,0,0,0,0,0,1,0,0,1,1
9437,83664,KqTFA16VVILHiK0IYy8jaNTctvzYX8nu,bWdj2GDclj5ofokWjzoa5jAwMkxCykd6,11,12,1,0,1,0,1,0,15,2.142857142857143,1,0.0,0,1,0,1,12,0,0,1,0,2,13,1
9438,83671,neZ18tPUzdX2s40f6yVBysxDUKCDyzmG,5X6FeZozNMgE2VRi3MJYjkkFK8SETtu2,8,13,0,0,7,0,3,0,23,3.2857142857142856,1,0.0,8,0,0,7,5,0,0,3,0,15,8,1
9439,83704,z38xWziicrZeTyki4GmVJQHBKXdJd40R,bWdj2GDclj5ofokWjzoa5jAwMkxCykd6,6,6,2,0,2,0,10,0,20,2.857142857142857,2,0.0,2,2,0,2,4,0,0,10,0,6,14,1
9440,83713,bAltXvR0FBKFy91atPslJEMIb77R3lRC,A3fsA9Zfv1X2fVEQhTw51lKENdNrEqT3,12,9,4,0,4,0,5,0,22,3.142857142857143,1,0.0,0,4,0,4,9,0,0,5,0,8,14,1
9441,83727,6uIhQ3yme7QLLxwzkjsfRrOvYJqr7Y3a,5X6FeZozNMgE2VRi3MJYjkkFK8SETtu2,3,2,0,0,0,0,1,0,3,0.42857142857142855,1,0.0,0,0,0,0,2,0,0,1,0,0,3,1
9442,83729,CioR8peuoSw6UJW12F3PHl1hUYQxgYtj,SpATywNh6bZuzm8s1ceuBUnMUAeoAHHw,17,24,7,28,1,5,7,0,72,10.285714285714286,2,0.0,13,7,27,1,11,5,1,7,0,48,24,1
9443,83775,uiC9EHMxnf2w4h6Qgd2IixJ8SdchRJcU,A3fsA9Zfv1X2fVEQhTw51lKENdNrEqT3,1,0,0,0,0,0,1,0,1,0.14285714285714285,1,0.0,0,0,0,0,0,0,0,1,0,0,1,1
9444,83795,P0VuZGgCaFPCBxKorH7bJdlMsmBgjIrL,bWdj2GDclj5ofokWjzoa5jAwMkxCykd6,6,2,1,0,1,2,5,5,16,2.2857142857142856,2,0.0,0,1,0,1,2,2,0,5,5,2,14,1
9445,83829,73yLreN6EzcjveHRceJMpzYK9XWfEA6F,A3fsA9Zfv1X2fVEQhTw51lKENdNrEqT3,1,0,0,0,0,0,1,0,1,0.14285714285714285,1,0.0,0,0,0,0,0,0,0,1,0,0,1,1
9446,83851,hkZJZMuEk3eRSgWhjH7jPcJrlgv2RTNl,A3fsA9Zfv1X2fVEQhTw51lKENdNrEqT3,21,16,13,18,8,0,4,0,59,8.428571428571429,2,0.0,0,13,15,8,16,0,3,4,0,36,23,1
9447,83854,4IJ56QlJSL8avuRQEkrBcEyhUIO3LIP3,bWdj2GDclj5ofokWjzoa5jAwMkxCykd6,23,23,13,54,5,11,13,0,119,17.0,2,0.0,7,13,44,5,16,11,10,13,0,69,50,0
9448,83858,mSQuPHmd8TP05MnBFR4zut82tnd837yj,G8EPVSXsOYB5YQWZGiz1aVq5Pgr2GrQu,12,29,3,0,3,0,6,0,41,5.857142857142857,3,0.0,9,3,0,3,20,0,0,6,0,15,26,0
9449,83861,yfR3kQ7JpR4tbAAtg2uJogcbjyExFgIX,A3fsA9Zfv1X2fVEQhTw51lKENdNrEqT3,66,29,0,234,0,0,12,0,275,39.285714285714285,4,0.0,6,0,232,0,23,0,2,12,0,238,37,1
9450,83875,3CXEafcVCxECgohc6attm6JVlndHTBVL,SpATywNh6bZuzm8s1ceuBUnMUAeoAHHw,15,42,18,0,10,4,9,2,85,12.142857142857142,3,0.0,0,18,0,10,42,4,0,9,2,28,57,1
9451,83891,vIXg8cSMNeH6m9S64QuOOXQlNK5JgpP1,SpATywNh6bZuzm8s1ceuBUnMUAeoAHHw,4,2,1,0,1,1,1,0,6,0.8571428571428571,1,0.0,0,1,0,1,2,1,0,1,0,2,4,1
9452,83898,mbeSuuMfzSoN2eC8D2XuG5snuf7K1Ab4,SpATywNh6bZuzm8s1ceuBUnMUAeoAHHw,5,2,1,0,1,0,3,0,7,1.0,1,0.0,0,1,0,1,2,0,0,3,0,2,5,1
9453,83900,YUf9YSE5dta2ffkPJrkUXDrdyRDcwPmp,SpATywNh6bZuzm8s1ceuBUnMUAeoAHHw,4,2,0,0,0,3,2,0,7,1.0,1,0.0,0,0,0,0,2,3,0,2,0,0,7,1
9454,83914,OQqjSB4aJTEsbrxgicWfXRK0yZcOBPo4,5X6FeZozNMgE2VRi3MJYjkkFK8SETtu2,1,0,0,0,0,0,1,0,1,0.14285714285714285,1,0.0,0,0,0,0,0,0,0,1,0,0,1,1
9455,83916,9gwK2SMO9RzFmbR3NVs20xNig2HGOi8l,A3fsA9Zfv1X2fVEQhTw51lKENdNrEqT3,6,3,1,0,1,0,3,0,8,1.1428571428571428,3,0.0,0,1,0,1,3,0,0,3,0,2,6,1
9456,83924,m5tZ7113qZA5gPphfQM81fCEbUkxpJsE,SpATywNh6bZuzm8s1ceuBUnMUAeoAHHw,3,3,0,0,0,0,1,0,4,0.5714285714285714,1,0.0,0,0,0,0,3,0,0,1,0,0,4,1
9457,83933,bA4tnPZD0UU4XAL3OkL7nUjtkAzbgj9d,bWdj2GDclj5ofokWjzoa5jAwMkxCykd6,48,89,33,81,15,20,14,0,252,36.0,5,0.0,11,33,74,15,78,20,7,14,0,133,119,0
9458,83937,riM9GkB0ajSqpIPlVq4tRzOjk7wJ6NHE,SpATywNh6bZuzm8s1ceuBUnMUAeoAHHw,4,2,1,0,0,0,3,0,6,0.8571428571428571,2,0.0,0,1,0,0,2,0,0,3,0,1,5,1
9459,83945,8sPH4f87PPg93teytSXDrui8J4UUp19X,5X6FeZozNMgE2VRi3MJYjkkFK8SETtu2,1,0,0,0,0,0,1,0,1,0.14285714285714285,1,0.0,0,0,0,0,0,0,0,1,0,0,1,1
9460,83949,Z89wynkx1rcXHYvlCNExAupGqq9VVjQV,G8EPVSXsOYB5YQWZGiz1aVq5Pgr2GrQu,43,11,9,122,1,3,11,2,159,22.714285714285715,3,0.0,0,9,105,1,11,3,17,11,2,115,44,1
9461,83952,3FEVPp7qXQqf7zefGcAP21t6w7dOpf6B,SpATywNh6bZuzm8s1ceuBUnMUAeoAHHw,5,2,1,0,1,0,2,0,6,0.8571428571428571,1,0.0,0,1,0,1,2,0,0,2,0,2,4,1
9462,83957,JXoruAOSjfsBsWMnWERJPrR6Egi77l6M,SpATywNh6bZuzm8s1ceuBUnMUAeoAHHw,4,2,0,0,0,0,2,0,4,0.5714285714285714,1,0.0,0,0,0,0,2,0,0,2,0,0,4,1
9463,83964,y9rcit987NPY2SaKlR7Ue3Haisfwv9TA,G8EPVSXsOYB5YQWZGiz1aVq5Pgr2GrQu,1,0,0,0,0,0,2,0,2,0.2857142857142857,1,0.0,0,0,0,0,0,0,0,2,0,0,2,1
9464,83967,Free8VIbkuRtDePLl5SkDqBlEPkZtxvH,5X6FeZozNMgE2VRi3MJYjkkFK8SETtu2,1,0,0,0,0,0,1,0,1,0.14285714285714285,1,0.0,0,0,0,0,0,0,0,1,0,0,1,1
9465,83972,h2AAA2rscYTKabHFKWYAQiMOilyMV9Ba,SpATywNh6bZuzm8s1ceuBUnMUAeoAHHw,2,0,0,0,0,0,2,0,2,0.2857142857142857,1,0.0,0,0,0,0,0,0,0,2,0,0,2,1
9466,83978,19iVDfShKixZpg8xTJAbBZz9CTfyTS2H,A3fsA9Zfv1X2fVEQhTw51lKENdNrEqT3,28,36,17,0,14,0,4,0,71,10.142857142857142,3,0.0,2,17,0,14,34,0,0,4,0,33,38,1
9467,83989,QbrhOgnPl8mnx3TbklxYm9mtjH3wH9bH,A3fsA9Zfv1X2fVEQhTw51lKENdNrEqT3,18,12,9,0,8,5,9,0,43,6.142857142857143,1,0.0,0,9,0,8,12,5,0,9,0,17,26,1
9468,84000,rdlMbs5MAmZwKWZ5MP6d4JJy7danp2Mg,bWdj2GDclj5ofokWjzoa5jAwMkxCykd6,1,0,0,0,0,0,1,0,1,0.14285714285714285,1,0.0,0,0,0,0,0,0,0,1,0,0,1,1
9469,84001,rdlMbs5MAmZwKWZ5MP6d4JJy7danp2Mg,A3fsA9Zfv1X2fVEQhTw51lKENdNrEqT3,44,24,17,94,15,0,10,1,161,23.0,2,0.0,2,17,77,15,22,0,17,10,1,111,50,1
9470,84015,zIxyUmEBKUIbRs852GDKgts0vTx0P8GO,5X6FeZozNMgE2VRi3MJYjkkFK8SETtu2,1,0,0,0,0,0,1,0,1,0.14285714285714285,1,0.0,0,0,0,0,0,0,0,1,0,0,1,1
9471,84029,7u0QfTKQg4itZK9m8foLXkIGwUxxHMsT,RXDvfPUBYFlVdlueBFbLW0mhhAyGEqpt,58,51,36,58,28,3,3,0,179,25.571428571428573,2,0.0,13,36,57,28,38,3,1,3,0,134,45,0
9472,84035,dhO2y8sIijAlPYlXxsHK1aEk6O7FL2Q2,SpATywNh6bZuzm8s1ceuBUnMUAeoAHHw,1,0,0,0,0,0,1,0,1,0.14285714285714285,1,0.0,0,0,0,0,0,0,0,1,0,0,1,1
9473,84053,dhO2y8sIijAlPYlXxsHK1aEk6O7FL2Q2,5X6FeZozNMgE2VRi3MJYjkkFK8SETtu2,2,0,0,0,0,0,2,0,2,0.2857142857142857,1,0.0,0,0,0,0,0,0,0,2,0,0,2,1
9474,84057,JA3GjaqmpFLtt1yojsnNXLqhMexKQ8aw,SpATywNh6bZuzm8s1ceuBUnMUAeoAHHw,7,4,1,0,1,0,2,0,8,1.1428571428571428,1,0.0,0,1,0,1,4,0,0,2,0,2,6,1
9475,84085,FN5TAXCOvxkHETvtFGXhthh9OlDi8jNI,5X6FeZozNMgE2VRi3MJYjkkFK8SETtu2,2,0,0,0,0,0,2,0,2,0.2857142857142857,1,0.0,0,0,0,0,0,0,0,2,0,0,2,1
9476,84087,bl8YOhounxXowMizQE2ibaM5H4dVfT77,A3fsA9Zfv1X2fVEQhTw51lKENdNrEqT3,1,0,0,0,0,0,1,0,1,0.14285714285714285,1,0.0,0,0,0,0,0,0,0,1,0,0,1,1
9477,84111,uiC9EHMxnf2w4h6Qgd2IixJ8SdchRJcU,SpATywNh6bZuzm8s1ceuBUnMUAeoAHHw,12,12,6,4,3,0,3,0,28,4.0,2,0.0,0,6,4,3,12,0,0,3,0,13,15,1
9478,84133,bVLtn3iBc4ibW8xWVzLLM3Hs9gCB0qb7,A3fsA9Zfv1X2fVEQhTw51lKENdNrEqT3,7,3,1,0,0,0,4,0,8,1.1428571428571428,2,0.0,0,1,0,0,3,0,0,4,0,1,7,1
9479,84158,8xjONclmnIBNB55spM8y9l5QMEcAlTZb,SpATywNh6bZuzm8s1ceuBUnMUAeoAHHw,7,5,1,0,1,1,3,0,11,1.5714285714285714,1,0.0,0,1,0,1,5,1,0,3,0,2,9,1
9480,84165,n1ESpvyobZkFsfrWJhKOuY4URaa1sUc5,SpATywNh6bZuzm8s1ceuBUnMUAeoAHHw,11,30,18,0,3,5,11,0,67,9.571428571428571,5,0.0,0,18,0,3,30,5,0,11,0,21,46,0
9481,84170,YTpSaD5WvcxnMj244x9U8tK7ZjCb9sw0,A3fsA9Zfv1X2fVEQhTw51lKENdNrEqT3,2,0,0,0,0,0,2,0,2,0.2857142857142857,1,0.0,0,0,0,0,0,0,0,2,0,0,2,1
9482,84178,btDL3pREx87iBHbN4DIhDQi5ERLMYVWp,bWdj2GDclj5ofokWjzoa5jAwMkxCykd6,2,0,0,0,0,0,2,0,2,0.2857142857142857,2,0.0,0,0,0,0,0,0,0,2,0,0,2,1
9483,84260,rYr2KHitWY2dJDjTm0iH4NPcJrqWE49C,fbPkOYLVPtPgIt0MxizjfFJov3JbHyAi,6,3,2,0,2,0,1,0,8,1.1428571428571428,1,0.0,0,2,0,2,3,0,0,1,0,4,4,1
9484,84262,FPAm2uFeanUhwrUMeNexrdAIqWOfXUXu,fbPkOYLVPtPgIt0MxizjfFJov3JbHyAi,9,3,2,0,1,0,9,2,17,2.4285714285714284,1,0.0,0,2,0,1,3,0,0,9,2,3,14,1
9485,84263,wYQFQjixTa6JPR4LS7RDubQDsjze2pIh,fbPkOYLVPtPgIt0MxizjfFJov3JbHyAi,4,0,0,0,0,1,6,0,7,1.0,1,0.0,0,0,0,0,0,1,0,6,0,0,7,1
9486,84265,RfVW0lNKrf9tzkgd827lLFW37SMuSXSa,fbPkOYLVPtPgIt0MxizjfFJov3JbHyAi,1,0,0,0,0,0,1,0,1,0.14285714285714285,1,0.0,0,0,0,0,0,0,0,1,0,0,1,1
9487,84266,Y9sABG91qMGS63qErzaDtI7NXtIr1yry,fbPkOYLVPtPgIt0MxizjfFJov3JbHyAi,1,0,0,0,0,0,2,0,2,0.2857142857142857,1,0.0,0,0,0,0,0,0,0,2,0,0,2,1
9488,84267,fSXZR9jouiiFWLCY3FdQ789t2sGYhvFo,fbPkOYLVPtPgIt0MxizjfFJov3JbHyAi,8,3,2,0,2,0,5,0,12,1.7142857142857142,1,0.0,0,2,0,2,3,0,0,5,0,4,8,1
9489,84269,m3CYAa4IcxX9Ylz9hZ2wRjnl2ftCrROV,fbPkOYLVPtPgIt0MxizjfFJov3JbHyAi,2,0,0,0,0,0,2,0,2,0.2857142857142857,1,0.0,0,0,0,0,0,0,0,2,0,0,2,1
9490,84271,hqClGLaQsSBO8I9GqLKpIixM0sA0K0b8,fbPkOYLVPtPgIt0MxizjfFJov3JbHyAi,7,5,2,0,1,0,6,0,14,2.0,1,0.0,0,2,0,1,5,0,0,6,0,3,11,0
9491,84272,evnakjU40Z6lomGsTCUgDGsdugdMX48K,fbPkOYLVPtPgIt0MxizjfFJov3JbHyAi,1,0,0,0,0,0,1,0,1,0.14285714285714285,1,0.0,0,0,0,0,0,0,0,1,0,0,1,1
9492,84275,pzjUl0u19ajI9ZVL0U8kEZyjNgq0vPjp,fbPkOYLVPtPgIt0MxizjfFJov3JbHyAi,6,1,1,0,1,0,3,0,6,0.8571428571428571,1,0.0,0,1,0,1,1,0,0,3,0,2,4,1
9493,84280,BCFi8OFpWeV6fuTRoD5vV8AJMWuQ1jB1,fbPkOYLVPtPgIt0MxizjfFJov3JbHyAi,1,0,0,0,0,0,1,0,1,0.14285714285714285,1,0.0,0,0,0,0,0,0,0,1,0,0,1,1
9494,84283,e0psMwhUBdLDxrOxBkoveKoEdFTTZrF1,fbPkOYLVPtPgIt0MxizjfFJov3JbHyAi,1,0,0,0,0,0,1,0,1,0.14285714285714285,1,0.0,0,0,0,0,0,0,0,1,0,0,1,1
9495,84286,jzGZfbr4RQdn7HQn4oyJMDfKBcS7VFEE,fbPkOYLVPtPgIt0MxizjfFJov3JbHyAi,5,9,0,0,0,0,7,0,16,2.2857142857142856,2,0.0,0,0,0,0,9,0,0,7,0,0,16,1
9496,84287,7Wr0weM79zMxBVlRbYesNzjHgoZsdOEJ,fbPkOYLVPtPgIt0MxizjfFJov3JbHyAi,5,2,1,0,1,0,2,0,6,0.8571428571428571,1,0.0,0,1,0,1,2,0,0,2,0,2,4,1
9497,84288,7o7xgD7LMzcqbchAXccb0936AlSMEPrX,fbPkOYLVPtPgIt0MxizjfFJov3JbHyAi,11,16,5,0,2,1,8,1,33,4.714285714285714,1,0.0,0,5,0,2,16,1,0,8,1,7,26,1
9498,84290,ZjhTJ45cHD4xtUxPoyNMJGOQiBl5fTQp,fbPkOYLVPtPgIt0MxizjfFJov3JbHyAi,5,1,1,0,1,0,3,0,6,0.8571428571428571,1,0.0,0,1,0,1,1,0,0,3,0,2,4,1
9499,84292,vvCucU5XJyhTM3r43nJfSwk9oTpOoOzq,fbPkOYLVPtPgIt0MxizjfFJov3JbHyAi,2,0,0,0,0,0,2,0,2,0.2857142857142857,1,0.0,0,0,0,0,0,0,0,2,0,0,2,1
9500,84428,X7EWmuNzsz8xJY0A1pRUOJGHwrCZ0B64,bWdj2GDclj5ofokWjzoa5jAwMkxCykd6,5,4,1,0,2,0,6,0,13,1.8571428571428572,1,0.0,2,1,0,2,2,0,0,6,0,5,8,1
9501,84435,OOJh2Yrr6RQf9QAHFBo7EBzeZ2OAmLfw,SpATywNh6bZuzm8s1ceuBUnMUAeoAHHw,13,52,18,6,1,3,16,2,98,14.0,6,0.0,0,18,5,1,52,3,1,16,2,24,74,1
9502,84436,Vu8rN942EwDIOj6iE8IDqvSFXpvGHO9R,bWdj2GDclj5ofokWjzoa5jAwMkxCykd6,1,0,0,0,0,0,1,0,1,0.14285714285714285,1,0.0,0,0,0,0,0,0,0,1,0,0,1,1
9503,84453,9g6dyxp7tVOU5kbyy5pf6QgprdOQv6vZ,RXDvfPUBYFlVdlueBFbLW0mhhAyGEqpt,12,15,7,16,5,0,3,1,47,6.714285714285714,1,0.0,7,7,14,5,8,0,2,3,1,33,14,1
9504,84456,RGf4k3THi4AV4qsAjc1UEOWiIeDYcchf,RXDvfPUBYFlVdlueBFbLW0mhhAyGEqpt,6,3,1,0,1,0,6,0,11,1.5714285714285714,2,0.0,0,1,0,1,3,0,0,6,0,2,9,1
9505,84462,bfYktB6xMRG2G8ooGt6o3rE63qV6JxlI,A3fsA9Zfv1X2fVEQhTw51lKENdNrEqT3,1,0,0,0,0,0,1,0,1,0.14285714285714285,1,0.0,0,0,0,0,0,0,0,1,0,0,1,1
9506,84492,unG4C0Ae6YJ39WbV1xtmGVvK7bPgQLG7,RXDvfPUBYFlVdlueBFbLW0mhhAyGEqpt,8,9,4,0,1,0,3,0,17,2.4285714285714284,1,0.0,1,4,0,1,8,0,0,3,0,6,11,1
9507,84519,RijiZcjqs3Sau2onXuynGNDorKgFFeFF,bWdj2GDclj5ofokWjzoa5jAwMkxCykd6,2,0,0,0,0,0,2,0,2,0.2857142857142857,1,0.0,0,0,0,0,0,0,0,2,0,0,2,1
9508,84525,Q8lgDaE6CB6Qe5bNGFRY9Gtyuy1mU1jD,bWdj2GDclj5ofokWjzoa5jAwMkxCykd6,5,6,1,0,0,0,2,0,9,1.2857142857142858,1,0.0,1,1,0,0,5,0,0,2,0,2,7,1
9509,84553,nUVa7zKjNimx07QWGFgK3J5PX7DLOyrU,RXDvfPUBYFlVdlueBFbLW0mhhAyGEqpt,1,0,0,0,0,0,1,0,1,0.14285714285714285,1,0.0,0,0,0,0,0,0,0,1,0,0,1,1
9510,84556,OatCEetKd31vq2MFNsgH6MMikZrZEqiC,bWdj2GDclj5ofokWjzoa5jAwMkxCykd6,6,5,0,0,1,0,4,0,10,1.4285714285714286,2,0.0,0,0,0,1,5,0,0,4,0,1,9,1
9511,84580,7dBPQqnhg3HraIZoj8IGy6tqqgLAonOI,SpATywNh6bZuzm8s1ceuBUnMUAeoAHHw,33,58,4,29,0,0,8,0,99,14.142857142857142,5,0.0,23,4,28,0,35,0,1,8,0,55,44,1
9512,84601,xH5f8nfW6oTIgHjXoQgEUKIx6qvDN8rk,SpATywNh6bZuzm8s1ceuBUnMUAeoAHHw,10,10,5,4,2,0,3,0,24,3.4285714285714284,1,0.0,3,5,3,2,7,0,1,3,0,13,11,1
9513,84623,bVCYDQX7pJxff6OyJX4M9s17AtFlpk5i,bWdj2GDclj5ofokWjzoa5jAwMkxCykd6,7,4,2,0,2,0,2,0,10,1.4285714285714286,1,0.0,0,2,0,2,4,0,0,2,0,4,6,1
9514,84646,RiDnEhaXHtwiFRournEb2192YjpdBStU,G8EPVSXsOYB5YQWZGiz1aVq5Pgr2GrQu,1,0,0,0,0,0,1,0,1,0.14285714285714285,1,0.0,0,0,0,0,0,0,0,1,0,0,1,1
9515,84653,M8sw9Q866fjD6jCvGFf8R8DxTYZlPOJu,A3fsA9Zfv1X2fVEQhTw51lKENdNrEqT3,6,3,2,0,1,0,2,0,8,1.1428571428571428,1,0.0,0,2,0,1,3,0,0,2,0,3,5,1
9516,84661,WEqUhplW7x1SpLabVjNcI5M4HsCYjumg,bWdj2GDclj5ofokWjzoa5jAwMkxCykd6,1,0,0,0,0,0,1,0,1,0.14285714285714285,1,0.0,0,0,0,0,0,0,0,1,0,0,1,1
9517,84662,WEqUhplW7x1SpLabVjNcI5M4HsCYjumg,A3fsA9Zfv1X2fVEQhTw51lKENdNrEqT3,1,0,0,0,0,0,1,0,1,0.14285714285714285,1,0.0,0,0,0,0,0,0,0,1,0,0,1,0
9518,84666,hBNiP82EasOgIR36wjHyg8vPIDQi3YO9,bWdj2GDclj5ofokWjzoa5jAwMkxCykd6,20,33,17,63,3,24,54,1,195,27.857142857142858,7,0.0,3,17,57,3,30,24,6,54,1,80,115,1
9519,84675,BEEx400Zym1Adj0LXV9O094DcgDYxMgU,SpATywNh6bZuzm8s1ceuBUnMUAeoAHHw,4,2,1,0,1,2,1,0,7,1.0,1,0.0,0,1,0,1,2,2,0,1,0,2,5,1
9520,84683,4VbB29c0q05cB50SX5b3ExZB3pSJc6RG,bWdj2GDclj5ofokWjzoa5jAwMkxCykd6,1,0,0,0,0,0,1,0,1,0.14285714285714285,1,0.0,0,0,0,0,0,0,0,1,0,0,1,1
9521,84699,BePz5wimB2cOHtaUExV25HDlvULcE611,bWdj2GDclj5ofokWjzoa5jAwMkxCykd6,1,0,0,0,0,0,1,0,1,0.14285714285714285,1,0.0,0,0,0,0,0,0,0,1,0,0,1,1
9522,84700,y6ntZnNLGo4HBLvhhvkQknL88GLC1lnO,A3fsA9Zfv1X2fVEQhTw51lKENdNrEqT3,14,18,11,0,7,1,6,1,44,6.285714285714286,2,0.0,0,11,0,7,18,1,0,6,1,18,26,1
9523,84701,T7Fjesc6ALJYDwDrKyS5CHisl2gr4aWJ,SpATywNh6bZuzm8s1ceuBUnMUAeoAHHw,18,25,8,16,4,2,7,1,63,9.0,1,0.0,11,8,15,4,14,2,1,7,1,38,25,1
9524,84702,BePz5wimB2cOHtaUExV25HDlvULcE611,A3fsA9Zfv1X2fVEQhTw51lKENdNrEqT3,7,4,2,0,2,0,2,0,10,1.4285714285714286,1,0.0,0,2,0,2,4,0,0,2,0,4,6,1
9525,84709,1Ld3jQU8M0eiaLBshs8gjcgQEfdlgHyZ,A3fsA9Zfv1X2fVEQhTw51lKENdNrEqT3,4,1,0,0,0,0,4,0,5,0.7142857142857143,2,0.0,0,0,0,0,1,0,0,4,0,0,5,1
9526,84728,GEuM5Jv5mgEiHQoZ7WZazbnkG2fcrd9Y,SpATywNh6bZuzm8s1ceuBUnMUAeoAHHw,38,58,40,21,25,2,13,0,159,22.714285714285715,6,0.0,10,40,19,25,48,2,2,13,0,94,65,0
9527,84745,BecDXRtXjm4nVBtBp7AS3BiGeJeKZmYu,SpATywNh6bZuzm8s1ceuBUnMUAeoAHHw,8,19,14,0,4,2,8,0,47,6.714285714285714,2,0.0,0,14,0,4,19,2,0,8,0,18,29,1
9528,84762,NC1pdSztpfJLgz1bqVoe5aonviJWe881,A3fsA9Zfv1X2fVEQhTw51lKENdNrEqT3,9,7,1,0,1,1,5,0,15,2.142857142857143,1,0.0,0,1,0,1,7,1,0,5,0,2,13,1
9529,84772,zZhdHu8U17iajwoRnuWugvDVR1mdDKy8,bWdj2GDclj5ofokWjzoa5jAwMkxCykd6,5,2,1,0,1,0,2,0,6,0.8571428571428571,1,0.0,0,1,0,1,2,0,0,2,0,2,4,1
9530,84777,pQdSl7i5ZuZeH9uPILgdHrvwskp4vc4V,SpATywNh6bZuzm8s1ceuBUnMUAeoAHHw,2,0,0,0,0,0,2,0,2,0.2857142857142857,1,0.0,0,0,0,0,0,0,0,2,0,0,2,1
9531,84779,Yg1xD2SamgKDKmDpRN2e3H3NAX0vGE2e,SpATywNh6bZuzm8s1ceuBUnMUAeoAHHw,31,48,4,43,2,7,19,0,123,17.571428571428573,5,0.0,20,4,38,2,28,7,5,19,0,64,59,1
9532,84789,rK4055OdlTymOWiwkxW7eIve09mowPhX,SpATywNh6bZuzm8s1ceuBUnMUAeoAHHw,7,7,3,0,1,0,2,0,13,1.8571428571428572,1,0.0,3,3,0,1,4,0,0,2,0,7,6,1
9533,84792,uGYj0yruFsWhwZGIUR02DogFquupaSDC,A3fsA9Zfv1X2fVEQhTw51lKENdNrEqT3,2,0,0,0,0,0,2,0,2,0.2857142857142857,1,0.0,0,0,0,0,0,0,0,2,0,0,2,1
9534,84795,uGYj0yruFsWhwZGIUR02DogFquupaSDC,SpATywNh6bZuzm8s1ceuBUnMUAeoAHHw,3,0,0,0,0,0,3,0,3,0.42857142857142855,1,0.0,0,0,0,0,0,0,0,3,0,0,3,1
9535,84798,TMW9SZvtLJ7yT5p9QtW5dUGKwlkcqKyn,SpATywNh6bZuzm8s1ceuBUnMUAeoAHHw,4,5,0,0,0,0,1,0,6,0.8571428571428571,1,0.0,0,0,0,0,5,0,0,1,0,0,6,1
9536,84805,eo86tl8OT9De2TqE4YR9qShJM6EFKpQ8,bWdj2GDclj5ofokWjzoa5jAwMkxCykd6,1,0,0,0,0,0,1,0,1,0.14285714285714285,1,0.0,0,0,0,0,0,0,0,1,0,0,1,1
9537,84812,hfXydPAjmOPsUaxL2NqJ9TVTB2YLFfnT,A3fsA9Zfv1X2fVEQhTw51lKENdNrEqT3,6,6,4,0,1,0,1,0,12,1.7142857142857142,1,0.0,1,4,0,1,5,0,0,1,0,6,6,1
9538,84817,Wefj86tFjwJZnMq6IAWMjbzJgYWyoGE5,SpATywNh6bZuzm8s1ceuBUnMUAeoAHHw,5,2,1,0,1,0,2,0,6,0.8571428571428571,1,0.0,0,1,0,1,2,0,0,2,0,2,4,1
9539,84826,Q9zNW7tUNygCfX90HmMYh3sp90BWwKOU,SpATywNh6bZuzm8s1ceuBUnMUAeoAHHw,5,5,2,0,1,0,3,0,11,1.5714285714285714,2,0.0,0,2,0,1,5,0,0,3,0,3,8,1
9540,84828,Q9zNW7tUNygCfX90HmMYh3sp90BWwKOU,A3fsA9Zfv1X2fVEQhTw51lKENdNrEqT3,7,5,2,0,2,0,4,0,13,1.8571428571428572,2,0.0,0,2,0,2,5,0,0,4,0,4,9,1
9541,84830,Q9zNW7tUNygCfX90HmMYh3sp90BWwKOU,bWdj2GDclj5ofokWjzoa5jAwMkxCykd6,6,2,1,0,1,1,7,1,13,1.8571428571428572,2,0.0,0,1,0,1,2,1,0,7,1,2,11,1
9542,84833,lYZxf8lh7ftdpqB6JLOchZTdcrWSTRKb,SpATywNh6bZuzm8s1ceuBUnMUAeoAHHw,1,0,0,0,0,0,1,0,1,0.14285714285714285,1,0.0,0,0,0,0,0,0,0,1,0,0,1,1
9543,84839,VIwJtaSOWWljnDL02ObzIxH4JeVU0QQ1,A3fsA9Zfv1X2fVEQhTw51lKENdNrEqT3,31,33,23,0,13,1,20,0,90,12.857142857142858,5,0.0,0,23,0,13,33,1,0,20,0,36,54,1
9544,84843,SgKrscfCtmytbxsrqs57oYYzOpyIlSfF,A3fsA9Zfv1X2fVEQhTw51lKENdNrEqT3,52,32,20,74,10,13,19,1,169,24.142857142857142,5,0.0,4,20,64,10,28,13,10,19,1,98,71,0
9545,84847,FeSQQc9CIFMTYLlHcSRbUJqf0NNwxJ2K,A3fsA9Zfv1X2fVEQhTw51lKENdNrEqT3,42,51,19,44,11,0,10,0,135,19.285714285714285,4,0.0,3,19,43,11,48,0,1,10,0,76,59,0
9546,84848,ykaUPJW4Nc9r2mv4b25QxgdHgIcQ63RQ,A3fsA9Zfv1X2fVEQhTw51lKENdNrEqT3,3,5,1,0,0,0,1,0,7,1.0,2,0.0,0,1,0,0,5,0,0,1,0,1,6,0
9547,84851,1GaXo8IuKFR6VdEVIYRJbTRl2qOzgbEk,SpATywNh6bZuzm8s1ceuBUnMUAeoAHHw,31,22,18,2,14,0,3,0,59,8.428571428571429,3,0.0,1,18,2,14,21,0,0,3,0,35,24,1
9548,84859,tW4kGyQmGPxJ7lQyOwGHaOFglTma7gIC,A3fsA9Zfv1X2fVEQhTw51lKENdNrEqT3,1,0,0,0,0,0,2,0,2,0.2857142857142857,2,0.0,0,0,0,0,0,0,0,2,0,0,2,1
9549,84861,HWTC2OrGiLVAGzdqeYnCu2ZFUrUbe6I6,A3fsA9Zfv1X2fVEQhTw51lKENdNrEqT3,24,13,11,0,9,0,10,0,43,6.142857142857143,2,0.0,0,11,0,9,13,0,0,10,0,20,23,1
9550,84872,eLmalTVeebqdOV7NU54KOewS5jRaHr8U,G8EPVSXsOYB5YQWZGiz1aVq5Pgr2GrQu,9,6,5,0,3,0,2,0,16,2.2857142857142856,1,0.0,0,5,0,3,6,0,0,2,0,8,8,1
9551,84878,94L6G6uqjoIozyLQIsc4GEWmNn1tQth5,SpATywNh6bZuzm8s1ceuBUnMUAeoAHHw,5,5,2,0,1,0,1,0,9,1.2857142857142858,1,0.0,2,2,0,1,3,0,0,1,0,5,4,1
9552,84900,kFEFWVRKxySg48KS2BQ5EGBj2Fy43YYR,SpATywNh6bZuzm8s1ceuBUnMUAeoAHHw,21,52,1,41,0,0,5,0,99,14.142857142857142,4,0.0,29,1,34,0,23,0,7,5,0,64,35,0
9553,84901,vDE54330fhfIeduEF4A9zDFR0caHiOdH,SpATywNh6bZuzm8s1ceuBUnMUAeoAHHw,5,4,2,0,2,0,1,0,9,1.2857142857142858,1,0.0,0,2,0,2,4,0,0,1,0,4,5,0
9554,84917,0vwRPKOOXqPVOG208KGIKC6ZMS7Sq8oQ,SpATywNh6bZuzm8s1ceuBUnMUAeoAHHw,1,0,0,0,0,0,1,0,1,0.14285714285714285,1,0.0,0,0,0,0,0,0,0,1,0,0,1,1
9555,84921,P8HECw7bHyNqGqPTlWbv24tTg1SG6bAf,bWdj2GDclj5ofokWjzoa5jAwMkxCykd6,5,2,1,0,1,0,2,0,6,0.8571428571428571,1,0.0,0,1,0,1,2,0,0,2,0,2,4,1
9556,84961,Z7OL2jReCGgQtTEQuUTXjMfA5lyDuHVX,bWdj2GDclj5ofokWjzoa5jAwMkxCykd6,1,0,0,0,0,0,1,0,1,0.14285714285714285,1,0.0,0,0,0,0,0,0,0,1,0,0,1,1
9557,84966,pCc4oMnSwjyLKgjKHMWP0AClAZXrGa7k,SpATywNh6bZuzm8s1ceuBUnMUAeoAHHw,4,3,2,0,2,0,1,0,8,1.1428571428571428,1,0.0,0,2,0,2,3,0,0,1,0,4,4,1
9558,84984,DzeVjg4mxykX9i07xMVI01d13jNEeveb,SpATywNh6bZuzm8s1ceuBUnMUAeoAHHw,7,2,1,0,1,1,5,0,10,1.4285714285714286,1,0.0,0,1,0,1,2,1,0,5,0,2,8,1
9559,84985,CrUGk3m8dLEwGtioGoHIpBu2eedFaqft,A3fsA9Zfv1X2fVEQhTw51lKENdNrEqT3,1,0,0,0,0,0,1,0,1,0.14285714285714285,1,0.0,0,0,0,0,0,0,0,1,0,0,1,1
9560,84991,NA0DQ3D2dj2Qrm5FSVbmrxMOfzF4fwPf,A3fsA9Zfv1X2fVEQhTw51lKENdNrEqT3,4,4,0,0,0,2,2,0,8,1.1428571428571428,1,0.0,0,0,0,0,4,2,0,2,0,0,8,1
9561,85012,DyupaV8BmUavHjvovvxyDg1D0z37S8dm,bWdj2GDclj5ofokWjzoa5jAwMkxCykd6,8,9,6,0,4,0,5,0,24,3.4285714285714284,3,0.0,0,6,0,4,9,0,0,5,0,10,14,1
9562,85019,aIIHBjdeRcv9jhajcTkxD39vpVMqF1ri,RXDvfPUBYFlVdlueBFbLW0mhhAyGEqpt,9,14,6,0,3,0,4,0,27,3.857142857142857,2,0.0,4,6,0,3,10,0,0,4,0,13,14,1
9563,85021,QAaGqoCRVYYJLVC9SEo8gPzESLmuOfNy,SpATywNh6bZuzm8s1ceuBUnMUAeoAHHw,6,3,1,0,2,0,1,0,7,1.0,1,0.0,0,1,0,2,3,0,0,1,0,3,4,1
9564,85025,BvCRPlMfMau2kDEBEjyV1l6RJMQy5B5l,A3fsA9Zfv1X2fVEQhTw51lKENdNrEqT3,5,3,2,0,0,0,4,0,9,1.2857142857142858,1,0.0,0,2,0,0,3,0,0,4,0,2,7,1
9565,85046,kNdT4Mob6J1VkdvqbhmS4aPzbDLqNeYP,bWdj2GDclj5ofokWjzoa5jAwMkxCykd6,5,5,1,0,1,0,1,0,8,1.1428571428571428,2,0.0,0,1,0,1,5,0,0,1,0,2,6,1
9566,85050,nyeqFiX3kXuwJTyYhNUJyRvPBqtJ6Two,bWdj2GDclj5ofokWjzoa5jAwMkxCykd6,5,2,1,0,1,0,4,0,8,1.1428571428571428,1,0.0,0,1,0,1,2,0,0,4,0,2,6,1
9567,85076,oW1xvgPq04VONgGO2ScFMsBR7tam1x2P,SpATywNh6bZuzm8s1ceuBUnMUAeoAHHw,6,6,1,0,1,0,2,0,10,1.4285714285714286,1,0.0,0,1,0,1,6,0,0,2,0,2,8,1
9568,85111,4sNqSI7Ntno9WsJhOo6RhAKwZwVuo3TV,bWdj2GDclj5ofokWjzoa5jAwMkxCykd6,1,0,0,0,0,0,1,0,1,0.14285714285714285,1,0.0,0,0,0,0,0,0,0,1,0,0,1,1
9569,85125,HpVSIYjYyErYvGk0jIIh7vGC0VGqoFpj,bWdj2GDclj5ofokWjzoa5jAwMkxCykd6,8,4,2,0,1,0,7,1,15,2.142857142857143,1,0.0,0,2,0,1,4,0,0,7,1,3,12,0
9570,85126,PWCmirnemxe8gmyr1O505eqeMATy6y8u,SpATywNh6bZuzm8s1ceuBUnMUAeoAHHw,7,3,2,0,2,0,2,0,9,1.2857142857142858,1,0.0,0,2,0,2,3,0,0,2,0,4,5,0
9571,85127,dZqFLbQhzRGv0XrnoR6Btyn7eZPLWNcs,SpATywNh6bZuzm8s1ceuBUnMUAeoAHHw,12,18,0,20,0,0,2,0,40,5.714285714285714,1,0.0,6,0,17,0,12,0,3,2,0,23,17,1
9572,85129,BvCRPlMfMau2kDEBEjyV1l6RJMQy5B5l,bWdj2GDclj5ofokWjzoa5jAwMkxCykd6,4,7,3,0,0,2,5,0,17,2.4285714285714284,1,0.0,2,3,0,0,5,2,0,5,0,5,12,1
9573,85135,n2FEbIJOdMpzLhQAaysQpPRu04nDuH4a,bWdj2GDclj5ofokWjzoa5jAwMkxCykd6,7,9,4,0,3,0,2,0,18,2.5714285714285716,1,0.0,0,4,0,3,9,0,0,2,0,7,11,1
9574,85144,CVCf4od7ffnWY5VcGG9qXOV7fsgr6eo9,G8EPVSXsOYB5YQWZGiz1aVq5Pgr2GrQu,8,2,0,0,0,0,14,0,16,2.2857142857142856,2,0.0,0,0,0,0,2,0,0,14,0,0,16,1
9575,85174,TNWu8lQOCqXwhlhWhjlBSPXoG0TmfsH5,SpATywNh6bZuzm8s1ceuBUnMUAeoAHHw,1,0,0,0,0,0,2,0,2,0.2857142857142857,1,0.0,0,0,0,0,0,0,0,2,0,0,2,1
9576,85178,TNWu8lQOCqXwhlhWhjlBSPXoG0TmfsH5,bWdj2GDclj5ofokWjzoa5jAwMkxCykd6,1,0,0,0,0,0,2,0,2,0.2857142857142857,1,0.0,0,0,0,0,0,0,0,2,0,0,2,1
9577,85180,TNWu8lQOCqXwhlhWhjlBSPXoG0TmfsH5,G8EPVSXsOYB5YQWZGiz1aVq5Pgr2GrQu,1,0,0,0,0,0,2,0,2,0.2857142857142857,1,0.0,0,0,0,0,0,0,0,2,0,0,2,1
9578,85182,TNWu8lQOCqXwhlhWhjlBSPXoG0TmfsH5,A3fsA9Zfv1X2fVEQhTw51lKENdNrEqT3,1,0,0,0,0,0,2,0,2,0.2857142857142857,1,0.0,0,0,0,0,0,0,0,2,0,0,2,1
9579,85191,YgaRsb5CJPElWQw5mvJ8Vl3IfLfYzm4F,SpATywNh6bZuzm8s1ceuBUnMUAeoAHHw,21,19,10,10,7,0,8,1,55,7.857142857142857,3,0.0,3,10,10,7,16,0,0,8,1,30,25,1
9580,85204,rSg9Ux5o4Clwkrl8yQB8aMYBxGhrELBb,bWdj2GDclj5ofokWjzoa5jAwMkxCykd6,5,3,1,0,1,0,2,0,7,1.0,1,0.0,0,1,0,1,3,0,0,2,0,2,5,1
9581,85215,hu8eak1Xmf8voE8pnxPzkSD2dZP9Sipf,RXDvfPUBYFlVdlueBFbLW0mhhAyGEqpt,3,3,0,0,0,0,9,0,12,1.7142857142857142,3,0.0,0,0,0,0,3,0,0,9,0,0,12,1
9582,85221,QtVFRX2q8o00yrhDoRxTCIn6JhufsUXY,A3fsA9Zfv1X2fVEQhTw51lKENdNrEqT3,1,0,0,0,0,0,1,0,1,0.14285714285714285,1,0.0,0,0,0,0,0,0,0,1,0,0,1,1
9583,85234,x8deFWL3OuMwdtM1Ar06UAP0kS8JTUGt,SpATywNh6bZuzm8s1ceuBUnMUAeoAHHw,14,32,0,21,0,0,2,0,55,7.857142857142857,1,0.0,19,0,18,0,13,0,3,2,0,37,18,1
9584,85236,rSg9Ux5o4Clwkrl8yQB8aMYBxGhrELBb,A3fsA9Zfv1X2fVEQhTw51lKENdNrEqT3,6,3,1,0,1,0,2,0,7,1.0,1,0.0,0,1,0,1,3,0,0,2,0,2,5,1
9585,85251,vSCx3udDUOJuH4qQxIeZOxrYva69olaR,G8EPVSXsOYB5YQWZGiz1aVq5Pgr2GrQu,10,7,2,0,2,1,5,0,17,2.4285714285714284,1,0.0,4,2,0,2,3,1,0,5,0,8,9,1
9586,85254,5AnTWuSZRA41O05i9OVXdtPUlL8FmaJL,SpATywNh6bZuzm8s1ceuBUnMUAeoAHHw,13,31,4,2,1,7,24,3,72,10.285714285714286,5,0.0,1,4,2,1,30,7,0,24,3,8,64,1
9587,85263,NTSPR2Wl1tIxtx1KX6XExiYGpKCsz0n8,G8EPVSXsOYB5YQWZGiz1aVq5Pgr2GrQu,1,0,0,0,0,0,1,0,1,0.14285714285714285,1,0.0,0,0,0,0,0,0,0,1,0,0,1,1
9588,85307,HDadS1kWhA9nJbFHsRG6aT6o1pPlcFrf,SpATywNh6bZuzm8s1ceuBUnMUAeoAHHw,1,0,0,0,0,0,2,0,2,0.2857142857142857,2,0.0,0,0,0,0,0,0,0,2,0,0,2,1
9589,85315,6wxNqFTG10UU1QlHAjCeeHAXofHA0Wd6,A3fsA9Zfv1X2fVEQhTw51lKENdNrEqT3,2,0,0,0,0,0,2,0,2,0.2857142857142857,1,0.0,0,0,0,0,0,0,0,2,0,0,2,1
9590,85320,6W33zL2q4028wAczl90YoEq5VRoJonHk,bWdj2GDclj5ofokWjzoa5jAwMkxCykd6,2,0,0,0,0,0,2,0,2,0.2857142857142857,1,0.0,0,0,0,0,0,0,0,2,0,0,2,0
9591,85324,4ZtOohTiezs8VzIzc66Ao14rrfIGFCZG,G8EPVSXsOYB5YQWZGiz1aVq5Pgr2GrQu,10,9,4,0,2,1,8,1,25,3.5714285714285716,2,0.0,0,4,0,2,9,1,0,8,1,6,19,1
9592,85329,dkZKTQ89aNq1jLWsQ8GHGCzeOaVmaX8E,SpATywNh6bZuzm8s1ceuBUnMUAeoAHHw,1,0,0,0,0,0,1,0,1,0.14285714285714285,1,0.0,0,0,0,0,0,0,0,1,0,0,1,1
9593,85336,176ILS8J1NMmZsoc0RxEg8JQJcz6ksLo,A3fsA9Zfv1X2fVEQhTw51lKENdNrEqT3,1,0,0,0,0,0,1,0,1,0.14285714285714285,1,0.0,0,0,0,0,0,0,0,1,0,0,1,1
9594,85340,7iqCukuZ9oGbANuGlupslMrsiHUFtGa5,bWdj2GDclj5ofokWjzoa5jAwMkxCykd6,3,3,1,0,0,0,1,0,5,0.7142857142857143,1,0.0,0,1,0,0,3,0,0,1,0,1,4,1
9595,85347,qr1Y8xuPrcpdzScNHYsirGXqasfUdOVa,A3fsA9Zfv1X2fVEQhTw51lKENdNrEqT3,14,15,11,0,6,0,14,0,46,6.571428571428571,4,0.0,0,11,0,6,15,0,0,14,0,17,29,1
9596,85360,sT9hGAnww95aeGvqwQpJlS3ORhWDT49F,SpATywNh6bZuzm8s1ceuBUnMUAeoAHHw,29,50,19,31,3,0,15,0,118,16.857142857142858,6,0.0,14,19,27,3,36,0,4,15,0,63,55,0
9597,85362,h7k1wsPKqQnsb0xgegTBlN0S8ZpolGHh,SpATywNh6bZuzm8s1ceuBUnMUAeoAHHw,6,5,1,0,1,0,2,0,9,1.2857142857142858,1,0.0,0,1,0,1,5,0,0,2,0,2,7,1
9598,85381,MaYaRLQWCfitDjLO89g6UksqHgmMxPRV,SpATywNh6bZuzm8s1ceuBUnMUAeoAHHw,30,60,5,57,2,5,15,2,146,20.857142857142858,5,0.0,28,5,48,2,32,5,9,15,2,83,63,0
9599,85384,13G00kuKCwdh69q4LTm8Z3EAcWInuO3M,3VkHkmOtom3jM2wCu94xgzzu1d6Dn7or,14,48,27,5,12,21,16,0,129,18.428571428571427,4,0.0,12,27,4,12,36,21,1,16,0,55,74,0
9600,85420,XLTMcH7feYHtvCTPGsBtNd0Km1sdgjIQ,3VkHkmOtom3jM2wCu94xgzzu1d6Dn7or,26,26,18,0,13,25,18,3,103,14.714285714285714,5,0.0,0,18,0,13,26,25,0,18,3,31,72,0
9601,85486,ikX72CHxEGhdeCUCpL9omQYpqM8MqHTI,3VkHkmOtom3jM2wCu94xgzzu1d6Dn7or,11,63,25,4,8,6,34,0,140,20.0,8,0.0,10,25,3,8,53,6,1,34,0,46,94,0
9602,85493,1UiowfZ7uyfZSD6V0fTgYJKnmkDm03gk,3VkHkmOtom3jM2wCu94xgzzu1d6Dn7or,84,139,48,78,52,21,31,0,369,52.714285714285715,9,0.0,71,48,72,52,68,21,6,31,0,243,126,0
9603,85503,YXaF030ton3euPuB53B4LSPXUZjmznML,3VkHkmOtom3jM2wCu94xgzzu1d6Dn7or,11,20,6,0,0,1,11,3,41,5.857142857142857,1,0.0,5,6,0,0,15,1,0,11,3,11,30,1
9604,85562,9tOn7goHN9N7J9eojiuTfPcShVM7kNFp,3VkHkmOtom3jM2wCu94xgzzu1d6Dn7or,27,113,14,0,0,0,9,0,136,19.428571428571427,9,0.0,0,14,0,0,113,0,0,9,0,14,122,1
9605,85572,BefOyg6ykNDc1FataC1t5Raqf6W1A5Yb,3VkHkmOtom3jM2wCu94xgzzu1d6Dn7or,4,2,1,0,0,0,2,0,5,0.7142857142857143,1,0.0,0,1,0,0,2,0,0,2,0,1,4,1
9606,85577,FsRtG9gDIPReRoDWnJ4MFLGSrRsEmLDJ,3VkHkmOtom3jM2wCu94xgzzu1d6Dn7or,80,151,57,93,59,6,21,6,393,56.142857142857146,9,0.0,78,57,86,59,73,6,7,21,6,280,113,0
9607,85592,n42jeLyeDpoJPwT1pkhXRyhzHjUnC2KC,3VkHkmOtom3jM2wCu94xgzzu1d6Dn7or,8,6,1,0,2,4,7,1,21,3.0,1,0.0,2,1,0,2,4,4,0,7,1,5,16,1
9608,85596,rVswAzjMLz5uIPbCwAU1SliCQFpiAqey,3VkHkmOtom3jM2wCu94xgzzu1d6Dn7or,21,16,10,0,9,0,5,0,40,5.714285714285714,2,0.0,0,10,0,9,16,0,0,5,0,19,21,0
9609,85635,rPrdwxrDlJrFMColYZ7kiFx08s7CjBNo,3VkHkmOtom3jM2wCu94xgzzu1d6Dn7or,2,0,0,0,0,0,2,0,2,0.2857142857142857,1,0.0,0,0,0,0,0,0,0,2,0,0,2,1
9610,85642,u82lBhpDxJIwlZISEntCxj1zgVFdW0vT,3VkHkmOtom3jM2wCu94xgzzu1d6Dn7or,1,0,0,0,0,0,1,0,1,0.14285714285714285,1,0.0,0,0,0,0,0,0,0,1,0,0,1,1
9611,85659,fFjMIQfbklZeqfS9aUgse0l8NduTnrt6,3VkHkmOtom3jM2wCu94xgzzu1d6Dn7or,5,6,2,0,0,0,2,0,10,1.4285714285714286,2,0.0,0,2,0,0,6,0,0,2,0,2,8,1
9612,85663,MW4QwctRTPmSxxlsV186y0TFPaRs670c,3VkHkmOtom3jM2wCu94xgzzu1d6Dn7or,1,0,0,0,0,0,1,0,1,0.14285714285714285,1,0.0,0,0,0,0,0,0,0,1,0,0,1,1
9613,85668,HlU1brRw0L84gAhbD8o1bmz657h34FA1,3VkHkmOtom3jM2wCu94xgzzu1d6Dn7or,9,5,0,0,0,0,6,0,11,1.5714285714285714,1,0.0,0,0,0,0,5,0,0,6,0,0,11,0
9614,85676,HK1m8DNsZ7wRvCGkSUvRPlRDv1HLW90b,3VkHkmOtom3jM2wCu94xgzzu1d6Dn7or,3,2,0,0,0,0,1,0,3,0.42857142857142855,1,0.0,0,0,0,0,2,0,0,1,0,0,3,1
9615,85681,cIy3aYPsf2ix38dnJp9RrmaHIory6k1R,3VkHkmOtom3jM2wCu94xgzzu1d6Dn7or,6,4,1,0,1,1,2,0,9,1.2857142857142858,1,0.0,0,1,0,1,4,1,0,2,0,2,7,1
9616,85695,DZTuO7JM8b5ONs3CMIJ4mV8vYzwayKT9,3VkHkmOtom3jM2wCu94xgzzu1d6Dn7or,5,2,1,0,1,1,2,0,7,1.0,1,0.0,0,1,0,1,2,1,0,2,0,2,5,1
9617,85720,KgrGG9kglKcchULRxpqu8ZMQTftFlDgP,3VkHkmOtom3jM2wCu94xgzzu1d6Dn7or,18,18,8,8,6,4,10,2,56,8.0,3,0.0,6,8,8,6,12,4,0,10,2,28,28,1
9618,85725,BoBgrmtQAbGEQdCkYjgMVVWzk508tw3x,3VkHkmOtom3jM2wCu94xgzzu1d6Dn7or,6,6,2,0,1,0,6,0,15,2.142857142857143,2,0.0,0,2,0,1,6,0,0,6,0,3,12,1
9619,85771,ERP6G5WJvBncmE1hQQFmpkycPMeQlLLQ,3VkHkmOtom3jM2wCu94xgzzu1d6Dn7or,9,25,6,0,1,0,1,0,33,4.714285714285714,2,0.0,4,6,0,1,21,0,0,1,0,11,22,1
9620,85797,czTQ5ELSy91Dy79vk5MgxZdL9nunJtpb,3VkHkmOtom3jM2wCu94xgzzu1d6Dn7or,7,3,2,0,2,0,2,0,9,1.2857142857142858,1,0.0,0,2,0,2,3,0,0,2,0,4,5,1
9621,85803,faJFxRjbG3m0AKbC0jLaQQtHVrZKqY1T,3VkHkmOtom3jM2wCu94xgzzu1d6Dn7or,9,11,3,0,1,1,10,1,27,3.857142857142857,2,0.0,0,3,0,1,11,1,0,10,1,4,23,1
9622,85841,OseLd0Vj4CawbZPfZRznLZH5tivxQP68,3VkHkmOtom3jM2wCu94xgzzu1d6Dn7or,73,142,45,69,57,17,26,0,356,50.857142857142854,7,0.0,87,45,67,57,55,17,2,26,0,256,100,1
9623,85842,DUwLHTMFGuVhHLSIqqTRgNrS08sj8j6i,3VkHkmOtom3jM2wCu94xgzzu1d6Dn7or,4,2,1,0,1,0,1,0,5,0.7142857142857143,1,0.0,0,1,0,1,2,0,0,1,0,2,3,1
9624,85851,b68WYpnuysSLqA5Vm5enorAzeKGwIhPy,3VkHkmOtom3jM2wCu94xgzzu1d6Dn7or,1,0,0,0,0,0,2,0,2,0.2857142857142857,1,0.0,0,0,0,0,0,0,0,2,0,0,2,1
9625,85866,v6veVItEgEaf6Hh5YgNhwea7AkkCZ3c0,3VkHkmOtom3jM2wCu94xgzzu1d6Dn7or,63,136,70,31,70,7,25,1,340,48.57142857142857,6,0.0,50,70,30,70,86,7,1,25,1,220,120,0
9626,85907,jok4tEcrobop66tG3KCeJGDlYMQJ4GbL,3VkHkmOtom3jM2wCu94xgzzu1d6Dn7or,77,341,144,67,61,52,82,12,759,108.42857142857143,6,0.0,92,144,65,61,249,52,2,82,12,362,397,0
9627,85983,h7aZWiIcJuKod0GVc86EbGw4w7dN7JZl,3VkHkmOtom3jM2wCu94xgzzu1d6Dn7or,81,172,77,75,58,39,30,0,451,64.42857142857143,7,0.0,48,77,71,58,124,39,4,30,0,254,197,0
9628,86000,6adUsSvPO0BlKLyJ63pGCXpdZbbHOrC1,3VkHkmOtom3jM2wCu94xgzzu1d6Dn7or,10,8,5,3,4,0,4,0,24,3.4285714285714284,1,0.0,2,5,3,4,6,0,0,4,0,14,10,1
9629,86001,lknoqUhBqHjCx4po6r83dmNbz1dDMFhy,3VkHkmOtom3jM2wCu94xgzzu1d6Dn7or,1,0,0,0,0,0,1,0,1,0.14285714285714285,1,0.0,0,0,0,0,0,0,0,1,0,0,1,1
9630,86071,gllevogZGS6BRVDfGGJAldsUWX4xD39r,3VkHkmOtom3jM2wCu94xgzzu1d6Dn7or,1,0,0,0,0,0,1,0,1,0.14285714285714285,1,0.0,0,0,0,0,0,0,0,1,0,0,1,1
9631,86072,6ILYZgVB75HEQ9IFubRRV6u9m1Wcar71,3VkHkmOtom3jM2wCu94xgzzu1d6Dn7or,61,141,47,28,52,37,18,0,323,46.142857142857146,4,0.0,81,47,28,52,60,37,0,18,0,208,115,0
9632,86161,NAYVxjfg7mDZERSfcIfXqiHe5xujNWKz,3VkHkmOtom3jM2wCu94xgzzu1d6Dn7or,2,0,0,0,0,0,3,0,3,0.42857142857142855,1,0.0,0,0,0,0,0,0,0,3,0,0,3,1
9633,86175,kIHsbVR2zzTV3NvaO60gT9C5s18p0XxQ,3VkHkmOtom3jM2wCu94xgzzu1d6Dn7or,25,50,15,26,12,5,9,1,118,16.857142857142858,3,0.0,29,15,21,12,21,5,5,9,1,77,41,0
9634,86178,ICgtAgsydFOa1v88S9dTTLF0BoT0U5Hb,3VkHkmOtom3jM2wCu94xgzzu1d6Dn7or,6,4,1,0,1,0,2,0,8,1.1428571428571428,1,0.0,0,1,0,1,4,0,0,2,0,2,6,1
9635,86208,e1CSwKLgflGiW7QjzYRNEoHjbDEH3F2k,3VkHkmOtom3jM2wCu94xgzzu1d6Dn7or,24,96,4,26,3,7,34,4,174,24.857142857142858,8,0.0,32,4,22,3,64,7,4,34,4,61,113,1
9636,86214,s7rVFkyi6fy4qwqR0x4tgXjSSF6e0Q4g,3VkHkmOtom3jM2wCu94xgzzu1d6Dn7or,16,37,17,5,4,10,20,3,96,13.714285714285714,3,0.0,15,17,5,4,22,10,0,20,3,41,55,0
9637,86257,8f874eWGU5uAHPVWKUx2IReY71ci0kSY,3VkHkmOtom3jM2wCu94xgzzu1d6Dn7or,77,106,52,29,50,1,67,1,306,43.714285714285715,7,0.0,41,52,27,50,65,1,2,67,1,170,136,1
9638,86274,nV86nhQ7hJG7k83qAXvGwRzPT357EJhH,3VkHkmOtom3jM2wCu94xgzzu1d6Dn7or,56,189,66,60,44,14,44,0,417,59.57142857142857,6,0.0,66,66,54,44,123,14,6,44,0,230,187,0
9639,86275,K45ayRpIahZNLgwlcA2lzf9ElmD1cHqp,3VkHkmOtom3jM2wCu94xgzzu1d6Dn7or,10,14,5,3,0,2,5,6,35,5.0,1,0.0,7,5,3,0,7,2,0,5,6,15,20,1
9640,86277,3Fotn6vrZOyU7qEVGnoWfR5Qb28bVPZe,3VkHkmOtom3jM2wCu94xgzzu1d6Dn7or,1,0,0,0,0,0,1,0,1,0.14285714285714285,1,0.0,0,0,0,0,0,0,0,1,0,0,1,1
9641,86280,BizeImMesg1cizlB4zGQZqXbEQSVssmW,3VkHkmOtom3jM2wCu94xgzzu1d6Dn7or,1,0,0,0,0,0,1,0,1,0.14285714285714285,1,0.0,0,0,0,0,0,0,0,1,0,0,1,1
9642,86289,d8M5e4LzHCw29UNYn0tf3jr08TdTpDqU,3VkHkmOtom3jM2wCu94xgzzu1d6Dn7or,1,0,0,0,0,0,1,0,1,0.14285714285714285,1,0.0,0,0,0,0,0,0,0,1,0,0,1,1
9643,86314,hQH8EkY3K9ePEt9jn5ZdKTUudKlRBEnW,3VkHkmOtom3jM2wCu94xgzzu1d6Dn7or,6,5,3,0,2,0,4,0,14,2.0,2,0.0,0,3,0,2,5,0,0,4,0,5,9,1
9644,86377,ar22m4gM6bnNUa1aRM8rqTyJBhSPOBmI,3VkHkmOtom3jM2wCu94xgzzu1d6Dn7or,1,0,0,0,0,0,1,0,1,0.14285714285714285,1,0.0,0,0,0,0,0,0,0,1,0,0,1,0
9645,86381,0SAR9K4qvrSxIkdUOEshHCbisvDXgZs2,3VkHkmOtom3jM2wCu94xgzzu1d6Dn7or,1,0,0,0,0,0,1,0,1,0.14285714285714285,1,0.0,0,0,0,0,0,0,0,1,0,0,1,1
9646,86421,OdiJ027MTGMvZv0Jx8RFUqLQVSPKf0Le,3VkHkmOtom3jM2wCu94xgzzu1d6Dn7or,8,4,2,0,1,1,8,9,25,3.5714285714285716,3,0.0,0,2,0,1,4,1,0,8,9,3,22,1
9647,86439,Y2qzAhcfhmjKefh7VXw2kUO8oGjJyTVE,3VkHkmOtom3jM2wCu94xgzzu1d6Dn7or,11,32,8,4,9,3,12,0,68,9.714285714285714,5,0.0,15,8,3,9,17,3,1,12,0,35,33,1
9648,86533,1wIqcRX58Bpw6RXvGnbxsc6WbPwWGwXd,3VkHkmOtom3jM2wCu94xgzzu1d6Dn7or,92,196,53,34,78,5,26,0,392,56.0,15,0.0,59,53,31,78,137,5,3,26,0,221,171,0
9649,86536,khFWmwKbSLPoLe6xXaOUDOgKsUHYgYeC,3VkHkmOtom3jM2wCu94xgzzu1d6Dn7or,1,0,0,0,0,0,1,0,1,0.14285714285714285,1,0.0,0,0,0,0,0,0,0,1,0,0,1,1
9650,86560,PdxQByxMVopEGTgWt3myeTqPxaRPOrC2,3VkHkmOtom3jM2wCu94xgzzu1d6Dn7or,1,0,0,0,0,0,1,0,1,0.14285714285714285,1,0.0,0,0,0,0,0,0,0,1,0,0,1,1
9651,86592,iNNgCVjnPK0MGKfhlyKj8GoKOMB3W92D,3VkHkmOtom3jM2wCu94xgzzu1d6Dn7or,9,17,2,0,1,1,18,0,39,5.571428571428571,2,0.0,0,2,0,1,17,1,0,18,0,3,36,1
9652,86632,9th1hmunGluj6xZwTGdArB7lPjYPdBbw,3VkHkmOtom3jM2wCu94xgzzu1d6Dn7or,1,0,0,0,0,0,1,0,1,0.14285714285714285,1,0.0,0,0,0,0,0,0,0,1,0,0,1,1
9653,86721,8ILIGGcVTYtJEfEunOA8rlDpD5ITYFNe,3VkHkmOtom3jM2wCu94xgzzu1d6Dn7or,1,0,0,0,0,0,1,0,1,0.14285714285714285,1,0.0,0,0,0,0,0,0,0,1,0,0,1,1
9654,86743,LAV9DZTNpMBa9H7I7DG73I6hrxa0pr3u,3VkHkmOtom3jM2wCu94xgzzu1d6Dn7or,1,0,0,0,0,0,1,0,1,0.14285714285714285,1,0.0,0,0,0,0,0,0,0,1,0,0,1,1
9655,86748,Td8yAwGedsXCvCUvnm0K0TUjk4jXKQt7,3VkHkmOtom3jM2wCu94xgzzu1d6Dn7or,12,23,11,0,9,1,6,0,50,7.142857142857143,2,0.0,6,11,0,9,17,1,0,6,0,26,24,1
9656,86780,oxSbsSgTvgSmA84yFpVeknvhMfpBwdbY,3VkHkmOtom3jM2wCu94xgzzu1d6Dn7or,8,3,2,0,2,0,3,0,10,1.4285714285714286,1,0.0,0,2,0,2,3,0,0,3,0,4,6,0
9657,86855,Ybc642CAm4ubx0xh2F3kNoipp1rEZVzf,3VkHkmOtom3jM2wCu94xgzzu1d6Dn7or,82,191,73,64,69,13,76,3,489,69.85714285714286,15,0.0,92,73,56,69,99,13,8,76,3,290,199,0
9658,86883,Sx6n1bCVIgjBIjUp9Ql4sJc8bEjCGIru,3VkHkmOtom3jM2wCu94xgzzu1d6Dn7or,1,0,0,0,0,0,1,0,1,0.14285714285714285,1,0.0,0,0,0,0,0,0,0,1,0,0,1,1
9659,86898,JUAvN6CchqwicZ9lfSkTbwue3bPu0qhC,A3fsA9Zfv1X2fVEQhTw51lKENdNrEqT3,2,0,0,0,0,0,2,0,2,0.2857142857142857,1,0.0,0,0,0,0,0,0,0,2,0,0,2,1
9660,86909,ycaMgSRQQHtDR1yAvQMlax8o3WWq0O3E,SpATywNh6bZuzm8s1ceuBUnMUAeoAHHw,1,0,0,0,0,0,1,0,1,0.14285714285714285,1,0.0,0,0,0,0,0,0,0,1,0,0,1,1
9661,86912,GfqCozSB56b335uZLl5d2syEloMgMtnE,SpATywNh6bZuzm8s1ceuBUnMUAeoAHHw,27,41,18,50,7,9,35,6,166,23.714285714285715,3,0.0,11,18,42,7,30,9,8,35,6,78,88,0
9662,86916,m9APg30xFaPG98uje3arCJfO5W7zr48c,SpATywNh6bZuzm8s1ceuBUnMUAeoAHHw,1,0,0,0,0,0,2,0,2,0.2857142857142857,2,0.0,0,0,0,0,0,0,0,2,0,0,2,1
9663,86938,rJCRtFYOHadlaWolNt4hiGuOfo8UHBBK,SpATywNh6bZuzm8s1ceuBUnMUAeoAHHw,25,47,17,22,6,7,7,0,106,15.142857142857142,5,0.0,22,17,21,6,25,7,1,7,0,66,40,0
9664,86946,Hvvqp2eQBSWvPQ5p71AaLCkYMkKlVnyN,bWdj2GDclj5ofokWjzoa5jAwMkxCykd6,2,0,0,0,0,0,2,0,2,0.2857142857142857,1,0.0,0,0,0,0,0,0,0,2,0,0,2,1
9665,86951,NWtZfqa5QvMpR8YctnU5Z1G2Mmylu7kF,SpATywNh6bZuzm8s1ceuBUnMUAeoAHHw,1,0,0,0,0,0,2,0,2,0.2857142857142857,1,0.0,0,0,0,0,0,0,0,2,0,0,2,1
9666,86952,OLnlSTOFzG1JYJiPdt4pQRjvFCClSHXl,SpATywNh6bZuzm8s1ceuBUnMUAeoAHHw,6,3,2,0,2,0,1,0,8,1.1428571428571428,2,0.0,0,2,0,2,3,0,0,1,0,4,4,1
9667,86961,f1hGx4vBaHIhL4S79qCy99PHQb78Q3Jf,SpATywNh6bZuzm8s1ceuBUnMUAeoAHHw,5,3,1,0,1,0,2,0,7,1.0,1,0.0,0,1,0,1,3,0,0,2,0,2,5,1
9668,86964,Cq4KSaVkbqHlLqdj1lV0UpERxxxKCyTj,bWdj2GDclj5ofokWjzoa5jAwMkxCykd6,8,3,1,0,1,0,4,1,10,1.4285714285714286,1,0.0,0,1,0,1,3,0,0,4,1,2,8,1
9669,86967,Pvua5hyrKdigZ1ycnO5tmP70GOQQDJjD,RXDvfPUBYFlVdlueBFbLW0mhhAyGEqpt,1,0,0,0,0,0,1,0,1,0.14285714285714285,1,0.0,0,0,0,0,0,0,0,1,0,0,1,1
9670,86974,HB5xN5WvO63fyle8L9OU8KEV5tvW4m0R,SpATywNh6bZuzm8s1ceuBUnMUAeoAHHw,46,36,20,43,13,4,11,3,130,18.571428571428573,4,0.0,12,20,39,13,24,4,4,11,3,84,46,0
9671,86982,sFhXWcZp0e3ojXF41wch1LYksD6BUqWx,SpATywNh6bZuzm8s1ceuBUnMUAeoAHHw,1,0,0,0,0,0,1,0,1,0.14285714285714285,1,0.0,0,0,0,0,0,0,0,1,0,0,1,1
9672,86988,twX4iqCXJtIrZfq1eQVcNh6usPgVLduz,SpATywNh6bZuzm8s1ceuBUnMUAeoAHHw,3,0,0,0,0,0,3,0,3,0.42857142857142855,1,0.0,0,0,0,0,0,0,0,3,0,0,3,1
9673,86997,hXvrvs517Cljnw9n8TIqf0EZFGKj5tLN,A3fsA9Zfv1X2fVEQhTw51lKENdNrEqT3,1,0,0,0,0,0,1,0,1,0.14285714285714285,1,0.0,0,0,0,0,0,0,0,1,0,0,1,1
9674,87001,0dwnge5EOc1G7OI2GIE4cTm6v44kkXQF,A3fsA9Zfv1X2fVEQhTw51lKENdNrEqT3,1,0,0,0,0,0,1,0,1,0.14285714285714285,1,0.0,0,0,0,0,0,0,0,1,0,0,1,0
9675,87042,HaDSWhgDk0wGnojLCgKlWqrHGEOcf3UV,SpATywNh6bZuzm8s1ceuBUnMUAeoAHHw,13,19,6,12,3,0,2,0,42,6.0,2,0.0,9,6,11,3,10,0,1,2,0,29,13,1
9676,87049,1BQpAvqrBw6EmiaIW2MwJ2rv4x4Q2s0V,SpATywNh6bZuzm8s1ceuBUnMUAeoAHHw,6,7,3,0,0,0,3,0,13,1.8571428571428572,2,0.0,1,3,0,0,6,0,0,3,0,4,9,0
9677,87067,z0wmch2gP3COsvtcVA5iWOXrgdxULy0U,SpATywNh6bZuzm8s1ceuBUnMUAeoAHHw,2,0,0,0,0,0,2,0,2,0.2857142857142857,1,0.0,0,0,0,0,0,0,0,2,0,0,2,1
9678,87073,HgrresBBExzRiMszeaiNvsDe9DkhU6l5,SpATywNh6bZuzm8s1ceuBUnMUAeoAHHw,35,46,19,40,7,7,12,1,132,18.857142857142858,2,0.0,11,19,38,7,35,7,2,12,1,75,57,0
9679,87080,Cg300wnMUZ9cUKiSAxwMV9QGJuKTVrUS,SpATywNh6bZuzm8s1ceuBUnMUAeoAHHw,8,8,3,0,2,2,6,1,22,3.142857142857143,1,0.0,1,3,0,2,7,2,0,6,1,6,16,1
9680,87087,ycZcyaRZkRmTmfTyJcaxWvg5l6N3L4CN,SpATywNh6bZuzm8s1ceuBUnMUAeoAHHw,14,20,9,0,4,4,11,2,50,7.142857142857143,4,0.0,3,9,0,4,17,4,0,11,2,16,34,1
9681,87091,hWJT9cmy3MgW1Ixs5CKqFb4FYhTmELi3,bWdj2GDclj5ofokWjzoa5jAwMkxCykd6,7,4,1,0,1,0,2,0,8,1.1428571428571428,1,0.0,0,1,0,1,4,0,0,2,0,2,6,1
9682,87094,TPPsOieQBcwqH8dqABTR3mddQ5gDzlZO,A3fsA9Zfv1X2fVEQhTw51lKENdNrEqT3,23,28,21,0,18,0,5,0,72,10.285714285714286,2,0.0,3,21,0,18,25,0,0,5,0,42,30,1
9683,87097,oXrdtiVWJwaWgRFbUXGT1kyEHfFOVjoz,SpATywNh6bZuzm8s1ceuBUnMUAeoAHHw,3,2,0,0,0,0,3,0,5,0.7142857142857143,1,0.0,0,0,0,0,2,0,0,3,0,0,5,1
9684,87106,QUf1ZaSO2gcebvjw5vbR7zGsBmfjKCCs,SpATywNh6bZuzm8s1ceuBUnMUAeoAHHw,9,11,0,0,1,0,2,0,14,2.0,1,0.0,0,0,0,1,11,0,0,2,0,1,13,1
9685,87108,JawriHlY57Ms9asBj5jDP1bA53V2QKjp,5X6FeZozNMgE2VRi3MJYjkkFK8SETtu2,4,3,2,0,2,0,1,0,8,1.1428571428571428,1,0.0,0,2,0,2,3,0,0,1,0,4,4,1
9686,87109,xSRvBNCdhLUrfFyYzicxsnRRkZUYQ9tk,SpATywNh6bZuzm8s1ceuBUnMUAeoAHHw,13,15,1,0,0,0,10,1,27,3.857142857142857,3,0.0,2,1,0,0,13,0,0,10,1,3,24,1
9687,87110,ePw9vYcz9FHVQfH5E6368oyaxAZ1fT5C,SpATywNh6bZuzm8s1ceuBUnMUAeoAHHw,5,2,1,0,1,0,2,0,6,0.8571428571428571,1,0.0,0,1,0,1,2,0,0,2,0,2,4,1
9688,87119,HW81M2taDDpjfIALyR6RGLxMn7Z51s6I,G8EPVSXsOYB5YQWZGiz1aVq5Pgr2GrQu,6,3,1,0,1,0,2,0,7,1.0,1,0.0,0,1,0,1,3,0,0,2,0,2,5,0
9689,87120,Kpr6ISdqohTmchfzbxziZ98TNPreGKVa,SpATywNh6bZuzm8s1ceuBUnMUAeoAHHw,11,12,6,0,3,0,5,0,26,3.7142857142857144,2,0.0,2,6,0,3,10,0,0,5,0,11,15,1
9690,87122,NFGYUC7dcOkWJh2BiZLJheVSucAvXvpt,A3fsA9Zfv1X2fVEQhTw51lKENdNrEqT3,9,20,0,0,0,0,5,0,25,3.5714285714285716,3,0.0,0,0,0,0,20,0,0,5,0,0,25,1
9691,87147,PHBho9Sc0XQZt8wGEuns5tbDU5eoHa8g,A3fsA9Zfv1X2fVEQhTw51lKENdNrEqT3,71,75,28,138,17,0,28,0,286,40.857142857142854,8,0.0,10,28,125,17,65,0,13,28,0,180,106,0
9692,87148,gSM3dmsvbnknlOwHg7J6Fy5cRwQWWs6l,SpATywNh6bZuzm8s1ceuBUnMUAeoAHHw,5,2,1,0,1,0,2,0,6,0.8571428571428571,1,0.0,0,1,0,1,2,0,0,2,0,2,4,1
9693,87150,NA5Ew6dRh4PhyiB8DSC6tgsWgUAy9AJv,bWdj2GDclj5ofokWjzoa5jAwMkxCykd6,1,0,0,0,0,0,1,0,1,0.14285714285714285,1,0.0,0,0,0,0,0,0,0,1,0,0,1,1
9694,87155,Qn3OccgDXQpcut9yLA9jXfau6FPbS72n,5X6FeZozNMgE2VRi3MJYjkkFK8SETtu2,1,0,0,0,0,0,2,0,2,0.2857142857142857,2,0.0,0,0,0,0,0,0,0,2,0,0,2,1
9695,87162,RgxmGDfKcBuOKimrAda6q6r1m3kTwJWg,SpATywNh6bZuzm8s1ceuBUnMUAeoAHHw,5,6,0,0,0,0,5,0,11,1.5714285714285714,2,0.0,0,0,0,0,6,0,0,5,0,0,11,1
9696,87169,BYoagvhtaQZvEdBOdm0fSGLXeMikTNAf,SpATywNh6bZuzm8s1ceuBUnMUAeoAHHw,10,13,1,0,1,0,5,0,20,2.857142857142857,3,0.0,0,1,0,1,13,0,0,5,0,2,18,1
9697,87187,BPhS68WnBhNHxaKVrJj2k4cMtvSG9MHx,SpATywNh6bZuzm8s1ceuBUnMUAeoAHHw,1,0,0,0,0,0,1,0,1,0.14285714285714285,1,0.0,0,0,0,0,0,0,0,1,0,0,1,1
9698,87190,rs3WOUQ4PSHbNxyhVeLlE6lgdYqGPTef,SpATywNh6bZuzm8s1ceuBUnMUAeoAHHw,19,30,6,15,4,0,7,0,62,8.857142857142858,2,0.0,20,6,14,4,10,0,1,7,0,44,18,1
9699,87193,BPhS68WnBhNHxaKVrJj2k4cMtvSG9MHx,5X6FeZozNMgE2VRi3MJYjkkFK8SETtu2,1,0,0,0,0,0,1,0,1,0.14285714285714285,1,0.0,0,0,0,0,0,0,0,1,0,0,1,1
9700,87195,BPhS68WnBhNHxaKVrJj2k4cMtvSG9MHx,G8EPVSXsOYB5YQWZGiz1aVq5Pgr2GrQu,1,0,0,0,0,0,1,0,1,0.14285714285714285,1,0.0,0,0,0,0,0,0,0,1,0,0,1,1
9701,87196,BPhS68WnBhNHxaKVrJj2k4cMtvSG9MHx,RXDvfPUBYFlVdlueBFbLW0mhhAyGEqpt,1,0,0,0,0,0,1,0,1,0.14285714285714285,1,0.0,0,0,0,0,0,0,0,1,0,0,1,1
9702,87199,hO4ixki4cn72f2HXil7H5yfXyIpxdfFl,SpATywNh6bZuzm8s1ceuBUnMUAeoAHHw,16,21,2,18,2,0,9,0,52,7.428571428571429,3,0.0,9,2,15,2,12,0,3,9,0,28,24,0
9703,87209,1YNi2L12jzZ2lTbHZxOoSAJwmZIzVTSP,SpATywNh6bZuzm8s1ceuBUnMUAeoAHHw,6,2,1,0,1,4,4,0,12,1.7142857142857142,1,0.0,0,1,0,1,2,4,0,4,0,2,10,1
9704,87228,7GGviL1oS0U6CdSXgIhlT1cgPoomop6m,SpATywNh6bZuzm8s1ceuBUnMUAeoAHHw,27,19,12,25,8,0,2,0,66,9.428571428571429,1,0.0,4,12,19,8,15,0,6,2,0,43,23,1
9705,87253,sIlNQ89buPUrQbLfzMqM8ZfxnB8BXILp,SpATywNh6bZuzm8s1ceuBUnMUAeoAHHw,6,21,3,0,0,1,9,0,34,4.857142857142857,1,0.0,0,3,0,0,21,1,0,9,0,3,31,1
9706,87258,d1MkRkjya7ojtBlNRk0Ce9ymSIOXU3g7,G8EPVSXsOYB5YQWZGiz1aVq5Pgr2GrQu,1,0,0,0,0,0,1,0,1,0.14285714285714285,1,0.0,0,0,0,0,0,0,0,1,0,0,1,1
9707,87305,cpJrmEUlEL8EDk9AnTJk0fcLeBecnjUz,SpATywNh6bZuzm8s1ceuBUnMUAeoAHHw,5,2,1,0,1,0,2,0,6,0.8571428571428571,1,0.0,0,1,0,1,2,0,0,2,0,2,4,1
9708,87312,4xeLGa5DZRC3bFnuJocw2mMFvfOIivjJ,5X6FeZozNMgE2VRi3MJYjkkFK8SETtu2,2,0,0,0,0,0,2,0,2,0.2857142857142857,1,0.0,0,0,0,0,0,0,0,2,0,0,2,1
9709,87330,ChO2roT5np1gHX6O4LZD82zuXuaO1HXn,A3fsA9Zfv1X2fVEQhTw51lKENdNrEqT3,35,19,16,24,13,5,6,0,83,11.857142857142858,1,0.0,0,16,20,13,19,5,4,6,0,49,34,1
9710,87338,Mkzdfm5qkl8qxjNMCVluXUDpdsWNCaHt,SpATywNh6bZuzm8s1ceuBUnMUAeoAHHw,2,0,0,0,0,0,2,0,2,0.2857142857142857,1,0.0,0,0,0,0,0,0,0,2,0,0,2,1
9711,87359,q9ZOahsMglbfxvCwKEpt3AMimCuNhfDY,SpATywNh6bZuzm8s1ceuBUnMUAeoAHHw,7,4,0,0,0,1,7,0,12,1.7142857142857142,1,0.0,0,0,0,0,4,1,0,7,0,0,12,1
9712,87377,qZiJyWjzRGeOBeYRlPJKAXcx37BTtgsI,SpATywNh6bZuzm8s1ceuBUnMUAeoAHHw,7,3,2,0,2,0,2,0,9,1.2857142857142858,1,0.0,0,2,0,2,3,0,0,2,0,4,5,1
9713,87382,YcJ85FZw8rSIHoL8wnrNTEWCJdpKSrze,SpATywNh6bZuzm8s1ceuBUnMUAeoAHHw,1,0,0,0,0,0,1,0,1,0.14285714285714285,1,0.0,0,0,0,0,0,0,0,1,0,0,1,0
9714,87386,o4I4EkmQ48q5biBoHPFY4faNuV3hDMKw,SpATywNh6bZuzm8s1ceuBUnMUAeoAHHw,7,6,3,0,1,0,4,0,14,2.0,2,0.0,0,3,0,1,6,0,0,4,0,4,10,1
9715,87402,Xz40w2Sa6ycZOmupSA5XfcYT02Ov8S1m,A3fsA9Zfv1X2fVEQhTw51lKENdNrEqT3,11,8,4,0,3,0,2,0,17,2.4285714285714284,1,0.0,0,4,0,3,8,0,0,2,0,7,10,1
9716,87432,jnldJK9jDRdn3Q2rpqpfrVQIfaYWFHYt,SpATywNh6bZuzm8s1ceuBUnMUAeoAHHw,1,0,0,0,0,0,1,0,1,0.14285714285714285,1,0.0,0,0,0,0,0,0,0,1,0,0,1,1
9717,87447,QflUMQYqgKuyQPnCteHvz3LqhJ9AwCga,RXDvfPUBYFlVdlueBFbLW0mhhAyGEqpt,47,83,63,0,47,6,11,0,210,30.0,3,0.0,10,63,0,47,73,6,0,11,0,120,90,1
9718,87485,HqS5s3hltvHSRLR6PzHeJNPRu48XNpMR,A3fsA9Zfv1X2fVEQhTw51lKENdNrEqT3,1,0,0,0,0,0,1,0,1,0.14285714285714285,1,0.0,0,0,0,0,0,0,0,1,0,0,1,1
9719,87514,UUyRymVa7K1uXcxu9NV7wrw7koSoKJkA,A3fsA9Zfv1X2fVEQhTw51lKENdNrEqT3,13,8,6,0,4,0,10,1,29,4.142857142857143,2,0.0,0,6,0,4,8,0,0,10,1,10,19,1
9720,87520,pqsPOTJhOrzp1CuSM0L3m4JXPVXPbkqe,SpATywNh6bZuzm8s1ceuBUnMUAeoAHHw,16,31,15,6,2,5,12,1,72,10.285714285714286,3,0.0,4,15,6,2,27,5,0,12,1,27,45,1
9721,87544,HF98YPKzT8oi2j9flZW9kstZcvL3ZimG,SpATywNh6bZuzm8s1ceuBUnMUAeoAHHw,42,66,20,31,13,0,10,0,140,20.0,5,0.0,12,20,25,13,54,0,6,10,0,70,70,0
9722,87552,VfEelXsd4Sgrcy5E8mk405V2S0XUGtSK,A3fsA9Zfv1X2fVEQhTw51lKENdNrEqT3,9,7,2,0,0,1,11,1,22,3.142857142857143,3,0.0,0,2,0,0,7,1,0,11,1,2,20,1
9723,87563,mLnrkBxCMzHzCOgxlcePLHngsSsyrmY0,SpATywNh6bZuzm8s1ceuBUnMUAeoAHHw,24,73,4,28,1,8,36,4,154,22.0,7,0.0,16,4,25,1,57,8,3,36,4,46,108,0
9724,87569,q1J333rPyzRXtliUpf4POE9QAtj3sr8G,SpATywNh6bZuzm8s1ceuBUnMUAeoAHHw,1,0,0,0,0,0,1,0,1,0.14285714285714285,1,0.0,0,0,0,0,0,0,0,1,0,0,1,1
9725,87588,jNRA434lMAMZjPiQhPmaP5pXlW3ni5X9,5X6FeZozNMgE2VRi3MJYjkkFK8SETtu2,1,0,0,0,0,0,1,0,1,0.14285714285714285,1,0.0,0,0,0,0,0,0,0,1,0,0,1,1
9726,87600,oNGBL76nG6RSI4sSbcZeTjUXGVOoaIIG,RXDvfPUBYFlVdlueBFbLW0mhhAyGEqpt,12,10,8,0,4,0,4,0,26,3.7142857142857144,1,0.0,0,8,0,4,10,0,0,4,0,12,14,1
9727,87601,fXFz6g5r2Tp8eWARWPVXqKuqaMAimuJv,A3fsA9Zfv1X2fVEQhTw51lKENdNrEqT3,6,4,2,0,2,0,1,0,9,1.2857142857142858,1,0.0,0,2,0,2,4,0,0,1,0,4,5,1
9728,87607,Y1N757YBcw2pa0f5R2cGYXkdHdVAg7lL,RXDvfPUBYFlVdlueBFbLW0mhhAyGEqpt,34,44,24,0,15,0,2,0,85,12.142857142857142,2,0.0,0,24,0,15,44,0,0,2,0,39,46,1
9729,87645,or5tGmwIQtkxzns3Abayo6pKJnoHWcAG,A3fsA9Zfv1X2fVEQhTw51lKENdNrEqT3,11,9,6,0,4,0,8,1,28,4.0,3,0.0,0,6,0,4,9,0,0,8,1,10,18,1
9730,87646,yjHdMjg2Y9TVm5pa02baGNmbc897dEB6,bWdj2GDclj5ofokWjzoa5jAwMkxCykd6,2,0,0,0,0,0,2,0,2,0.2857142857142857,1,0.0,0,0,0,0,0,0,0,2,0,0,2,1
9731,87648,8jZuG0IqleAjOhpsiirCEfBUN87kcxp8,SpATywNh6bZuzm8s1ceuBUnMUAeoAHHw,11,10,2,0,2,0,4,0,18,2.5714285714285716,2,0.0,0,2,0,2,10,0,0,4,0,4,14,1
9732,87649,KCgqr6mS6kq5aoFQfmLbsIxQVUeF53Nr,SpATywNh6bZuzm8s1ceuBUnMUAeoAHHw,15,21,1,17,0,0,4,1,44,6.285714285714286,3,0.0,1,1,15,0,20,0,2,4,1,17,27,0
9733,87696,NDhFf7OjltsbVAydOdtaLNasif6YENxb,G8EPVSXsOYB5YQWZGiz1aVq5Pgr2GrQu,11,14,2,0,1,0,4,0,21,3.0,2,0.0,2,2,0,1,12,0,0,4,0,5,16,1
9734,87697,IHheokBZBTn69jMtC3noFZ77MtM0MaWY,bWdj2GDclj5ofokWjzoa5jAwMkxCykd6,8,1,1,0,1,0,11,1,15,2.142857142857143,1,0.0,0,1,0,1,1,0,0,11,1,2,13,1
9735,87709,MN8CvEqGMXYIHmPItRTjpnojpHW8H7Wg,SpATywNh6bZuzm8s1ceuBUnMUAeoAHHw,50,65,33,68,17,1,13,1,198,28.285714285714285,6,0.0,22,33,61,17,43,1,7,13,1,133,65,0
9736,87732,L1FTG9TM6RI5TBCTexQgshQhXhu2oZpJ,RXDvfPUBYFlVdlueBFbLW0mhhAyGEqpt,64,54,32,83,22,2,12,0,205,29.285714285714285,6,0.0,16,32,79,22,38,2,4,12,0,149,56,1
9737,87733,bwOsVB833e5tHrwHSqmXCzs0EZClNPpv,bWdj2GDclj5ofokWjzoa5jAwMkxCykd6,9,8,3,0,3,3,6,1,24,3.4285714285714284,3,0.0,3,3,0,3,5,3,0,6,1,9,15,1
9738,87742,TvtViclCsd2PmV5PrW2DKEwPmoLOSaRh,A3fsA9Zfv1X2fVEQhTw51lKENdNrEqT3,67,46,3,110,2,1,11,1,174,24.857142857142858,1,0.0,5,3,99,2,41,1,11,11,1,109,65,1
9739,87752,waDceRgc2N0BjPJorKWJj1WtKs87R7xP,A3fsA9Zfv1X2fVEQhTw51lKENdNrEqT3,11,11,7,0,5,0,3,0,26,3.7142857142857144,1,0.0,1,7,0,5,10,0,0,3,0,13,13,1
9740,87759,kbnbUyJ6SeYN8u39lgEBCBnZvcNekMlk,bWdj2GDclj5ofokWjzoa5jAwMkxCykd6,8,7,3,0,1,0,5,0,16,2.2857142857142856,2,0.0,0,3,0,1,7,0,0,5,0,4,12,1
9741,87764,VPCWV7vv7mSXLXdyKv2YQuYNd5q5tnVr,A3fsA9Zfv1X2fVEQhTw51lKENdNrEqT3,1,0,0,0,0,0,1,0,1,0.14285714285714285,1,0.0,0,0,0,0,0,0,0,1,0,0,1,1
9742,87770,yk3MmJnG3pWrtg68UCUE7BF7gkkb0Yf0,5X6FeZozNMgE2VRi3MJYjkkFK8SETtu2,5,5,2,0,0,0,2,0,9,1.2857142857142858,1,0.0,0,2,0,0,5,0,0,2,0,2,7,1
9743,87798,1ahaNbr5YZ3IpOgQelHrM05Cdnz4LKNQ,SpATywNh6bZuzm8s1ceuBUnMUAeoAHHw,16,8,7,13,4,0,1,0,33,4.714285714285714,1,0.0,0,7,12,4,8,0,1,1,0,23,10,0
9744,87820,mXagdU9ktYcsigsUp2GL9G4BfC4p8esK,RXDvfPUBYFlVdlueBFbLW0mhhAyGEqpt,26,41,8,31,3,19,17,4,123,17.571428571428573,2,0.0,11,8,27,3,30,19,4,17,4,49,74,0
9745,87821,1fleh7lPd7aghMITlPRITTq0TKiljgoj,bWdj2GDclj5ofokWjzoa5jAwMkxCykd6,6,2,0,0,0,0,5,0,7,1.0,1,0.0,0,0,0,0,2,0,0,5,0,0,7,1
9746,87826,yGll7cBEK4l513wg08W8WjrXiINZSUwd,SpATywNh6bZuzm8s1ceuBUnMUAeoAHHw,4,2,1,0,1,0,3,0,7,1.0,2,0.0,0,1,0,1,2,0,0,3,0,2,5,1
9747,87838,ROBPgs59OGqWvnQJzICs4ISllL7P1b8A,SpATywNh6bZuzm8s1ceuBUnMUAeoAHHw,8,5,3,0,2,0,2,0,12,1.7142857142857142,1,0.0,0,3,0,2,5,0,0,2,0,5,7,0
9748,87864,nWedGV2Cyz7b86zoWjyUJZtraXV6YlYz,SpATywNh6bZuzm8s1ceuBUnMUAeoAHHw,16,28,3,7,1,1,9,0,49,7.0,2,0.0,4,3,7,1,24,1,0,9,0,15,34,0
9749,87893,31GQcXjkfbx5hDfwBCiiTLmmlCr7ombE,SpATywNh6bZuzm8s1ceuBUnMUAeoAHHw,2,0,0,0,0,0,3,0,3,0.42857142857142855,1,0.0,0,0,0,0,0,0,0,3,0,0,3,1
9750,87899,hWHQ5t1aaxWeNJstlGoFcPp5rXeKd7fT,SpATywNh6bZuzm8s1ceuBUnMUAeoAHHw,32,51,3,44,1,0,4,0,103,14.714285714285714,2,0.0,10,3,40,1,41,0,4,4,0,54,49,1
9751,87919,NtuSsCWxiM5cZ0UalS4e7aFbcsYH60Br,bWdj2GDclj5ofokWjzoa5jAwMkxCykd6,6,6,1,0,1,0,3,0,11,1.5714285714285714,2,0.0,3,1,0,1,3,0,0,3,0,5,6,0
9752,87920,1uj3lODORrX2PgjuF1fpWy9nhOirDGas,G8EPVSXsOYB5YQWZGiz1aVq5Pgr2GrQu,40,87,30,56,5,3,10,1,192,27.428571428571427,9,0.0,4,30,42,5,83,3,14,10,1,81,111,0
9753,87928,cszgTMCcWdEja3BpEwPP5MtLXTMUMJXE,A3fsA9Zfv1X2fVEQhTw51lKENdNrEqT3,1,0,0,0,0,0,1,0,1,0.14285714285714285,1,0.0,0,0,0,0,0,0,0,1,0,0,1,1
9754,87929,0LERVBlr0s6pvZPTHfS8Y74dmJWxJhcj,5X6FeZozNMgE2VRi3MJYjkkFK8SETtu2,7,5,3,0,2,0,2,0,12,1.7142857142857142,1,0.0,0,3,0,2,5,0,0,2,0,5,7,1
9755,87963,bershY3L5dsrOquW1lgM7Vxvmeies3St,SpATywNh6bZuzm8s1ceuBUnMUAeoAHHw,20,22,1,32,0,0,8,0,63,9.0,3,0.0,9,1,29,0,13,0,3,8,0,39,24,0
9756,87982,MQK4DgM2xSqvXiKh3zV47i5iY5mt4VPL,SpATywNh6bZuzm8s1ceuBUnMUAeoAHHw,29,31,16,19,8,0,3,0,77,11.0,3,0.0,12,16,19,8,19,0,0,3,0,55,22,1
9757,87987,Ffohn9JNnGJQD2IavzMTS00ubnVtcb2T,SpATywNh6bZuzm8s1ceuBUnMUAeoAHHw,59,60,33,33,16,1,16,1,160,22.857142857142858,9,0.0,11,33,30,16,49,1,3,16,1,90,70,0
9758,87994,Y51MqWhaiGyWdNickwBkKEZ7LC7se5uV,A3fsA9Zfv1X2fVEQhTw51lKENdNrEqT3,1,0,0,0,0,0,1,0,1,0.14285714285714285,1,0.0,0,0,0,0,0,0,0,1,0,0,1,1
9759,88003,0UfP07I2iwfwmlnUahvfksC7lbNr2lOS,5X6FeZozNMgE2VRi3MJYjkkFK8SETtu2,1,0,0,0,0,0,3,0,3,0.42857142857142855,1,0.0,0,0,0,0,0,0,0,3,0,0,3,1
9760,88006,OG4OaugByeIYTjBlsElVfc6WigiZJJly,SpATywNh6bZuzm8s1ceuBUnMUAeoAHHw,5,2,0,0,0,1,5,0,8,1.1428571428571428,1,0.0,0,0,0,0,2,1,0,5,0,0,8,1
9761,88028,yaibiUtZloczLej3tb9ay8a6wfWQy8SZ,SpATywNh6bZuzm8s1ceuBUnMUAeoAHHw,12,6,4,4,2,0,8,0,24,3.4285714285714284,1,0.0,1,4,3,2,5,0,1,8,0,10,14,1
9762,88029,bSaZ1hYnI1zX06sBhHjW0JtYDEAqEuPp,SpATywNh6bZuzm8s1ceuBUnMUAeoAHHw,38,57,0,30,0,13,42,5,147,21.0,9,0.0,9,0,26,0,48,13,4,42,5,35,112,0
9763,88033,DZjkP3yl2SFuyGy8c50KQgIUMnSURcDF,G8EPVSXsOYB5YQWZGiz1aVq5Pgr2GrQu,1,0,0,0,0,0,1,0,1,0.14285714285714285,1,0.0,0,0,0,0,0,0,0,1,0,0,1,1
9764,88039,pAIEYSSXdgXA2O8eKo5gs0U3YOaGGkK5,SpATywNh6bZuzm8s1ceuBUnMUAeoAHHw,20,12,9,4,7,0,5,0,37,5.285714285714286,2,0.0,1,9,4,7,11,0,0,5,0,21,16,1
9765,88050,PehZ8w7lhwueNJQVLn4O4a5DjlM7RVHJ,RXDvfPUBYFlVdlueBFbLW0mhhAyGEqpt,6,10,3,0,1,0,3,0,17,2.4285714285714284,1,0.0,0,3,0,1,10,0,0,3,0,4,13,1
9766,88082,yiWok4eQ5hgdJ8eYi2O0qHhy67Y9EA3E,RXDvfPUBYFlVdlueBFbLW0mhhAyGEqpt,6,10,4,0,3,0,3,0,20,2.857142857142857,2,0.0,0,4,0,3,10,0,0,3,0,7,13,1
9767,88086,ffLXxfgMU4yir9uI5fIkKo2iZzEw2Lpz,A3fsA9Zfv1X2fVEQhTw51lKENdNrEqT3,6,2,1,0,1,1,4,0,9,1.2857142857142858,2,0.0,0,1,0,1,2,1,0,4,0,2,7,1
9768,88089,x44blDMbARj16T0tLu8ojXSHZTWR98Zp,A3fsA9Zfv1X2fVEQhTw51lKENdNrEqT3,6,2,0,0,0,0,5,0,7,1.0,1,0.0,0,0,0,0,2,0,0,5,0,0,7,1
9769,88095,dCAqk9uHiS99GMTcJQtThG8XWnwwbp5Q,bWdj2GDclj5ofokWjzoa5jAwMkxCykd6,1,0,0,0,0,0,2,0,2,0.2857142857142857,2,0.0,0,0,0,0,0,0,0,2,0,0,2,1
9770,88105,k7suxdbNozM9PSE6QAla7Jce4gizLApj,5X6FeZozNMgE2VRi3MJYjkkFK8SETtu2,7,3,2,0,2,0,3,0,10,1.4285714285714286,2,0.0,0,2,0,2,3,0,0,3,0,4,6,0
9771,88114,giXuT5U1RtMqgo8IXt5j9x4mrlpr0AWq,A3fsA9Zfv1X2fVEQhTw51lKENdNrEqT3,33,29,3,56,0,0,6,0,94,13.428571428571429,3,0.0,5,3,52,0,24,0,4,6,0,60,34,1
9772,88115,57QNpq0y9acG53aqB6y56Mpy1s4uWqKM,A3fsA9Zfv1X2fVEQhTw51lKENdNrEqT3,20,13,10,0,8,0,7,0,38,5.428571428571429,3,0.0,0,10,0,8,13,0,0,7,0,18,20,1
9773,88117,os5aeAM18BF9yPST9BbZNwxdgfyb3iSj,A3fsA9Zfv1X2fVEQhTw51lKENdNrEqT3,4,2,1,0,1,0,6,0,10,1.4285714285714286,1,0.0,0,1,0,1,2,0,0,6,0,2,8,1
9774,88130,lIEujnO1A2cHxxwjhfcjojfSzxvYc5z2,5X6FeZozNMgE2VRi3MJYjkkFK8SETtu2,2,0,0,0,0,0,2,0,2,0.2857142857142857,1,0.0,0,0,0,0,0,0,0,2,0,0,2,1
9775,88136,Y51MqWhaiGyWdNickwBkKEZ7LC7se5uV,5X6FeZozNMgE2VRi3MJYjkkFK8SETtu2,8,6,2,0,2,0,6,0,16,2.2857142857142856,2,0.0,0,2,0,2,6,0,0,6,0,4,12,0
9776,88138,YWNeUmm3QHgPMigKCfanPsAWkQlT4aAZ,G8EPVSXsOYB5YQWZGiz1aVq5Pgr2GrQu,1,0,0,0,0,0,1,0,1,0.14285714285714285,1,0.0,0,0,0,0,0,0,0,1,0,0,1,1
9777,88139,dclBqf1EWh3Ih224SoyQN0nAKWGjQR6I,SpATywNh6bZuzm8s1ceuBUnMUAeoAHHw,12,11,5,0,5,2,12,1,36,5.142857142857143,3,0.0,0,5,0,5,11,2,0,12,1,10,26,1
9778,88140,ci0TVQYsVR5jGo6uk57VSejmvHQzKbHq,SpATywNh6bZuzm8s1ceuBUnMUAeoAHHw,25,50,13,30,5,13,8,0,119,17.0,2,0.0,35,13,26,5,15,13,4,8,0,79,40,1
9779,88144,YWNeUmm3QHgPMigKCfanPsAWkQlT4aAZ,5X6FeZozNMgE2VRi3MJYjkkFK8SETtu2,1,0,0,0,0,0,1,0,1,0.14285714285714285,1,0.0,0,0,0,0,0,0,0,1,0,0,1,1
9780,88145,2UFvx2iVFdUre1OpcD3l0lOVdiHS8S46,SpATywNh6bZuzm8s1ceuBUnMUAeoAHHw,2,0,0,0,0,0,2,0,2,0.2857142857142857,1,0.0,0,0,0,0,0,0,0,2,0,0,2,1
9781,88158,fVHUMs4z7aTjXofyWNn8EBPM3SN6fL56,bWdj2GDclj5ofokWjzoa5jAwMkxCykd6,1,0,0,0,0,0,1,0,1,0.14285714285714285,1,0.0,0,0,0,0,0,0,0,1,0,0,1,1
9782,88164,nn7VGfd1qZ3DMYVVIcQxX76WYR0kOv43,SpATywNh6bZuzm8s1ceuBUnMUAeoAHHw,5,2,1,0,1,0,2,0,6,0.8571428571428571,1,0.0,0,1,0,1,2,0,0,2,0,2,4,1
9783,88184,IErGffEvIhM9v0ckpLiuRUGq95QUDuDa,SpATywNh6bZuzm8s1ceuBUnMUAeoAHHw,1,0,0,0,0,0,1,0,1,0.14285714285714285,1,0.0,0,0,0,0,0,0,0,1,0,0,1,1
9784,88194,mMAeDnJiyPEq1LUCLlMG9ChajUG4lE3B,SpATywNh6bZuzm8s1ceuBUnMUAeoAHHw,14,32,18,0,3,0,14,0,67,9.571428571428571,3,0.0,0,18,0,3,32,0,0,14,0,21,46,1
9785,88196,bnTfu9TwTvosy05oHRjElz0X7ljJOPeF,SpATywNh6bZuzm8s1ceuBUnMUAeoAHHw,7,9,3,0,1,7,3,6,29,4.142857142857143,3,0.0,0,3,0,1,9,7,0,3,6,4,25,1
9786,88209,d1MkRkjya7ojtBlNRk0Ce9ymSIOXU3g7,bWdj2GDclj5ofokWjzoa5jAwMkxCykd6,2,0,0,0,0,0,2,0,2,0.2857142857142857,1,0.0,0,0,0,0,0,0,0,2,0,0,2,1
9787,88219,UFtvGcavohZTrMuIVgrQAHawwTxcdSEE,SpATywNh6bZuzm8s1ceuBUnMUAeoAHHw,28,73,4,10,3,0,13,0,103,14.714285714285714,6,0.0,2,4,10,3,71,0,0,13,0,19,84,0
9788,88221,1at7EJNvpsF17iI0eH6hs4FnRP1Exa0A,RXDvfPUBYFlVdlueBFbLW0mhhAyGEqpt,10,6,4,0,2,0,7,1,20,2.857142857142857,1,0.0,0,4,0,2,6,0,0,7,1,6,14,1
9789,88225,pgpBUza0yx0g5FFeCmRZgahHcLAP1kjI,G8EPVSXsOYB5YQWZGiz1aVq5Pgr2GrQu,1,0,0,0,0,0,1,0,1,0.14285714285714285,1,0.0,0,0,0,0,0,0,0,1,0,0,1,1
9790,88226,yIkD9gy6hoeKl683npvdekS6rJ4gIOSl,5X6FeZozNMgE2VRi3MJYjkkFK8SETtu2,1,0,0,0,0,0,1,0,1,0.14285714285714285,1,0.0,0,0,0,0,0,0,0,1,0,0,1,1
9791,88255,qYM3FuP7P8shrtgZS3R28doqq6ra0j3L,SpATywNh6bZuzm8s1ceuBUnMUAeoAHHw,1,0,0,0,0,0,1,0,1,0.14285714285714285,1,0.0,0,0,0,0,0,0,0,1,0,0,1,1
9792,88263,tTcV8dGcndmFDYceHa4RNtiJpwqrpn9n,5X6FeZozNMgE2VRi3MJYjkkFK8SETtu2,2,0,0,0,0,0,2,0,2,0.2857142857142857,1,0.0,0,0,0,0,0,0,0,2,0,0,2,1
9793,88269,EkFuxvGcdz15iKWA0D48lolAWwrtU4QT,5X6FeZozNMgE2VRi3MJYjkkFK8SETtu2,17,69,2,15,6,0,4,0,96,13.714285714285714,1,0.0,56,2,13,6,13,0,2,4,0,77,19,1
9794,88281,cpRbfaNv5usLp7El18VnnTqxc7iB3VdC,5X6FeZozNMgE2VRi3MJYjkkFK8SETtu2,2,0,0,0,0,0,2,0,2,0.2857142857142857,1,0.0,0,0,0,0,0,0,0,2,0,0,2,1
9795,88290,zagfJzNHtSvWCFgkMj9NSIbmff9j4Jzi,7GRhBDsirIGkRZBtSMEzNTyDr2JQm4xx,5,2,1,0,1,1,4,0,9,1.2857142857142858,1,0.0,0,1,0,1,2,1,0,4,0,2,7,1
9796,88357,nN0k7Wn4LOXQIDOTh4XnZiFtrnIJSCyz,5X6FeZozNMgE2VRi3MJYjkkFK8SETtu2,1,0,0,0,0,0,1,0,1,0.14285714285714285,1,0.0,0,0,0,0,0,0,0,1,0,0,1,1
9797,88395,qInCpaeuecWrGMAIOnQb1wZeYTgOfrqB,7GRhBDsirIGkRZBtSMEzNTyDr2JQm4xx,1,0,0,0,0,0,1,0,1,0.14285714285714285,1,0.0,0,0,0,0,0,0,0,1,0,0,1,1
9798,88419,Nnydl7u2ge7nezXYbZ5DWwoPbVU96qN7,7GRhBDsirIGkRZBtSMEzNTyDr2JQm4xx,25,25,12,25,7,2,4,0,75,10.714285714285714,1,0.0,8,12,19,7,17,2,6,4,0,46,29,1
9799,88423,NpspGwuGkPfDI3FL99baAIJnbXMQ702U,5X6FeZozNMgE2VRi3MJYjkkFK8SETtu2,20,20,2,15,7,3,7,1,55,7.857142857142857,1,0.0,13,2,14,7,7,3,1,7,1,36,19,1
9800,88449,j4yVX1564yXgamumis5bPSWiGDO3Zb8c,5X6FeZozNMgE2VRi3MJYjkkFK8SETtu2,1,0,0,0,0,0,1,0,1,0.14285714285714285,1,0.0,0,0,0,0,0,0,0,1,0,0,1,1
9801,88450,VqGcDRkyuJiEMgdAxi8G9cea98s9aNUc,5X6FeZozNMgE2VRi3MJYjkkFK8SETtu2,2,0,0,0,0,0,4,0,4,0.5714285714285714,1,0.0,0,0,0,0,0,0,0,4,0,0,4,1
9802,88472,riM9GkB0ajSqpIPlVq4tRzOjk7wJ6NHE,5X6FeZozNMgE2VRi3MJYjkkFK8SETtu2,9,16,12,0,2,0,5,0,35,5.0,2,0.0,1,12,0,2,15,0,0,5,0,15,20,1
9803,88473,XKAlDCh4DTZwS9HBSFDAaahKYs73ob53,5X6FeZozNMgE2VRi3MJYjkkFK8SETtu2,1,0,0,0,0,0,1,0,1,0.14285714285714285,1,0.0,0,0,0,0,0,0,0,1,0,0,1,1
9804,88485,N2FuIOQxHi4oGMJNbbYINfgS8eLaVkEY,5X6FeZozNMgE2VRi3MJYjkkFK8SETtu2,2,0,0,0,0,0,2,0,2,0.2857142857142857,1,0.0,0,0,0,0,0,0,0,2,0,0,2,1
9805,88520,klfSXDgeuLd0URCaUqSBWiGxyD6lj0zh,7GRhBDsirIGkRZBtSMEzNTyDr2JQm4xx,31,53,12,38,14,18,7,0,142,20.285714285714285,1,0.0,34,12,33,14,19,18,5,7,0,93,49,1
9806,88535,RMHhN3yqeqMVtL0le3LPxRjp5aMu0uOX,7GRhBDsirIGkRZBtSMEzNTyDr2JQm4xx,7,3,2,0,2,0,2,0,9,1.2857142857142858,1,0.0,0,2,0,2,3,0,0,2,0,4,5,1
9807,88543,dorUpp1ODfe9BqxoBX8EUNGD90FW70kn,7GRhBDsirIGkRZBtSMEzNTyDr2JQm4xx,62,83,33,78,23,3,3,0,223,31.857142857142858,2,0.0,38,33,66,23,45,3,12,3,0,160,63,0
9808,88559,dpAgQLtjPDPymVmdyZFVsWQut5sougN0,7GRhBDsirIGkRZBtSMEzNTyDr2JQm4xx,11,3,2,0,2,4,6,1,18,2.5714285714285716,1,0.0,0,2,0,2,3,4,0,6,1,4,14,1
9809,88580,qn1djZG7LzKtC8vI6yAVSJrTMAG2OGsj,5X6FeZozNMgE2VRi3MJYjkkFK8SETtu2,6,12,4,0,2,0,2,0,20,2.857142857142857,1,0.0,0,4,0,2,12,0,0,2,0,6,14,1
9810,88600,Elyv0DBesmIDtda22RvPoYHZeyVOycgU,5X6FeZozNMgE2VRi3MJYjkkFK8SETtu2,3,2,0,0,0,0,2,0,4,0.5714285714285714,1,0.0,0,0,0,0,2,0,0,2,0,0,4,1
9811,88609,NRGKxfD21idsk82Fv2MwrybcNTOKr52A,7GRhBDsirIGkRZBtSMEzNTyDr2JQm4xx,1,0,0,0,0,0,1,0,1,0.14285714285714285,1,0.0,0,0,0,0,0,0,0,1,0,0,1,1
9812,88613,VVltscgfR96aweHb5nQdD1Q7dsOwuOJz,5X6FeZozNMgE2VRi3MJYjkkFK8SETtu2,24,56,2,26,10,0,6,0,100,14.285714285714286,4,0.0,24,2,23,10,32,0,3,6,0,59,41,1
9813,88618,kPAC602D9DmVqww2TT92vzDLsgdcAg6s,5X6FeZozNMgE2VRi3MJYjkkFK8SETtu2,4,2,1,0,0,0,3,0,6,0.8571428571428571,1,0.0,0,1,0,0,2,0,0,3,0,1,5,1
9814,88628,YKeoakXLvYKQuzmkPlJms5dyRpHXqKSm,5X6FeZozNMgE2VRi3MJYjkkFK8SETtu2,2,0,0,0,0,0,2,0,2,0.2857142857142857,1,0.0,0,0,0,0,0,0,0,2,0,0,2,1
9815,88671,uUGE7QSg22XWq63RpYifnvGl7ha2AJY9,7GRhBDsirIGkRZBtSMEzNTyDr2JQm4xx,1,0,0,0,0,0,1,0,1,0.14285714285714285,1,0.0,0,0,0,0,0,0,0,1,0,0,1,1
9816,88681,8nT76hrzyl8ZAUdI7W6kfrIzHxI3puKM,5X6FeZozNMgE2VRi3MJYjkkFK8SETtu2,3,2,0,0,0,0,1,0,3,0.42857142857142855,1,0.0,0,0,0,0,2,0,0,1,0,0,3,1
9817,88682,IPGiOAgTo8oAVcrOKeYCONet5W5qWWCW,7GRhBDsirIGkRZBtSMEzNTyDr2JQm4xx,2,0,0,0,0,0,2,0,2,0.2857142857142857,1,0.0,0,0,0,0,0,0,0,2,0,0,2,1
9818,88683,YPNKBmbK0WLMDD2GyDPdurqVlRMJYUzc,7GRhBDsirIGkRZBtSMEzNTyDr2JQm4xx,3,0,0,0,0,0,3,0,3,0.42857142857142855,1,0.0,0,0,0,0,0,0,0,3,0,0,3,1
9819,88691,OanZ4liHLS9Z9zOLSdbk7KQJbN4gOKSZ,7GRhBDsirIGkRZBtSMEzNTyDr2JQm4xx,1,0,0,0,0,0,1,0,1,0.14285714285714285,1,0.0,0,0,0,0,0,0,0,1,0,0,1,1
9820,88707,QcFkBpSrsmtN3SQ6KjwS5GaeQqJBdg65,5X6FeZozNMgE2VRi3MJYjkkFK8SETtu2,1,0,0,0,0,0,1,0,1,0.14285714285714285,1,0.0,0,0,0,0,0,0,0,1,0,0,1,1
9821,88714,mZP93anQs7Q6391iFwgUyfSw444ov2HX,5Gyp41oLVo7Gg7vF4vpmggWP5MU70QO6,6,3,1,0,2,4,4,1,15,2.142857142857143,1,0.0,0,1,0,2,3,4,0,4,1,3,12,0
9822,88736,mJZNVvZltlGUOWmItS7lca1ZZKMYLgfv,5Gyp41oLVo7Gg7vF4vpmggWP5MU70QO6,15,22,11,6,4,2,6,1,52,7.428571428571429,3,0.0,5,11,4,4,17,2,2,6,1,24,28,1
9823,88751,qMriGwNUEixgRIrpqeDAVIYWMKZnERwv,5Gyp41oLVo7Gg7vF4vpmggWP5MU70QO6,1,0,0,0,0,0,1,0,1,0.14285714285714285,1,0.0,0,0,0,0,0,0,0,1,0,0,1,1
9824,88760,yT4DZ6P2b1V6Eaa8Kzwtz6qb8BfYt5qf,5Gyp41oLVo7Gg7vF4vpmggWP5MU70QO6,8,17,8,0,3,0,3,0,31,4.428571428571429,2,0.0,4,8,0,3,13,0,0,3,0,15,16,1
9825,88775,zNnqmF2sQm5pVrk4EjykARlvIbp0hTq0,fbPkOYLVPtPgIt0MxizjfFJov3JbHyAi,6,3,1,0,1,0,3,0,8,1.1428571428571428,2,0.0,0,1,0,1,3,0,0,3,0,2,6,1
9826,88777,Uf1qigQqXVxNALjpI0OUPGkslBlud9Ut,fbPkOYLVPtPgIt0MxizjfFJov3JbHyAi,6,3,2,0,2,0,1,0,8,1.1428571428571428,1,0.0,0,2,0,2,3,0,0,1,0,4,4,1
9827,88778,gfCaKEduRhBAyI1gNYKiZ3eGKbbM2Zzn,fbPkOYLVPtPgIt0MxizjfFJov3JbHyAi,2,0,0,0,0,0,2,0,2,0.2857142857142857,1,0.0,0,0,0,0,0,0,0,2,0,0,2,1
9828,88780,nxtpPsNzngYTsI1SZcZNPzXTwqY5qTmx,fbPkOYLVPtPgIt0MxizjfFJov3JbHyAi,5,2,1,0,1,0,2,0,6,0.8571428571428571,1,0.0,0,1,0,1,2,0,0,2,0,2,4,1
9829,88782,0Fj1MjrLeWw10VEjEhUtTscYzoHMiAaR,fbPkOYLVPtPgIt0MxizjfFJov3JbHyAi,2,0,0,0,0,0,6,0,6,0.8571428571428571,1,0.0,0,0,0,0,0,0,0,6,0,0,6,1
9830,88783,0osfGmMGm8jt9kb8kP5HcmQdyiR2KFbt,fbPkOYLVPtPgIt0MxizjfFJov3JbHyAi,9,5,3,0,2,6,4,1,21,3.0,1,0.0,0,3,0,2,5,6,0,4,1,5,16,1
9831,88784,la0M1c91h799fPQIw73JrRQfyaSu3lyA,fbPkOYLVPtPgIt0MxizjfFJov3JbHyAi,1,0,0,0,0,0,1,0,1,0.14285714285714285,1,0.0,0,0,0,0,0,0,0,1,0,0,1,1
9832,88785,76WTB850XyfRMUDEt6Hi4EqgOfT9IEtK,fbPkOYLVPtPgIt0MxizjfFJov3JbHyAi,9,12,1,0,1,1,5,1,21,3.0,1,0.0,1,1,0,1,11,1,0,5,1,3,18,1
9833,88787,9k2E0gibBkBETtLxegOSAXJ2stT7JIe8,fbPkOYLVPtPgIt0MxizjfFJov3JbHyAi,8,5,1,0,2,0,11,2,21,3.0,1,0.0,2,1,0,2,3,0,0,11,2,5,16,1
9834,88788,qT122hnKUhEIpv6ZsCDLoOTP7nHJSaNq,fbPkOYLVPtPgIt0MxizjfFJov3JbHyAi,7,4,2,0,2,0,7,0,15,2.142857142857143,1,0.0,1,2,0,2,3,0,0,7,0,5,10,1
9835,88789,fQyY3sWQeXkKYt8B4zLpW9naNVJ351r5,fbPkOYLVPtPgIt0MxizjfFJov3JbHyAi,11,7,3,0,4,0,8,2,24,3.4285714285714284,1,0.0,3,3,0,4,4,0,0,8,2,10,14,1
9836,88790,nZBEO25QEEdKJsNDjWc27BQlFlOJqVIP,fbPkOYLVPtPgIt0MxizjfFJov3JbHyAi,7,5,3,0,2,1,2,0,13,1.8571428571428572,1,0.0,0,3,0,2,5,1,0,2,0,5,8,1
9837,88791,iZvZwMImGAt7q4aUPPRIOXEQbHAYw3j9,fbPkOYLVPtPgIt0MxizjfFJov3JbHyAi,24,28,14,20,15,2,9,1,89,12.714285714285714,1,0.0,9,14,15,15,19,2,5,9,1,53,36,1
9838,88793,iUbyHXj7nnwsn3idID6iMxIxqlgprHQJ,fbPkOYLVPtPgIt0MxizjfFJov3JbHyAi,2,0,0,0,0,0,4,0,4,0.5714285714285714,1,0.0,0,0,0,0,0,0,0,4,0,0,4,1
9839,88797,SJbFjfL77hmrpjM2fDE61GEOGezGEGS2,fbPkOYLVPtPgIt0MxizjfFJov3JbHyAi,1,0,0,0,0,0,1,0,1,0.14285714285714285,1,0.0,0,0,0,0,0,0,0,1,0,0,1,1
9840,88799,sCKziRJTsOYc4lQfYxPq4wO4jIyYAbxE,fbPkOYLVPtPgIt0MxizjfFJov3JbHyAi,2,0,0,0,0,0,2,0,2,0.2857142857142857,1,0.0,0,0,0,0,0,0,0,2,0,0,2,1
9841,88800,NBVERkC2Sbv324jT0djpWcPmYUJcR4Oa,fbPkOYLVPtPgIt0MxizjfFJov3JbHyAi,3,2,0,0,0,0,1,0,3,0.42857142857142855,1,0.0,0,0,0,0,2,0,0,1,0,0,3,1
9842,88802,1qt3gH5lpss0VnR5LgXp1AGPTrEn5n0R,fbPkOYLVPtPgIt0MxizjfFJov3JbHyAi,2,0,0,0,0,0,2,0,2,0.2857142857142857,1,0.0,0,0,0,0,0,0,0,2,0,0,2,1
9843,88803,2zFsyHLRIVr61iaQkzpRvzQtauWJlCfW,fbPkOYLVPtPgIt0MxizjfFJov3JbHyAi,1,0,0,0,0,0,2,0,2,0.2857142857142857,1,0.0,0,0,0,0,0,0,0,2,0,0,2,1
9844,88804,u4s0SPiIkynucY7ReF58TL89R2q4zw1x,fbPkOYLVPtPgIt0MxizjfFJov3JbHyAi,4,2,1,0,1,0,2,0,6,0.8571428571428571,2,0.0,0,1,0,1,2,0,0,2,0,2,4,0
9845,88805,8YR0tcT3D8d0JlIytw4LxKfYYQekJyvj,fbPkOYLVPtPgIt0MxizjfFJov3JbHyAi,5,3,1,0,1,0,1,0,6,0.8571428571428571,1,0.0,0,1,0,1,3,0,0,1,0,2,4,1
9846,88806,emj3hNG2XZHsTTaF5Lr1CYx27lHx0rEZ,fbPkOYLVPtPgIt0MxizjfFJov3JbHyAi,8,9,4,0,4,0,1,0,18,2.5714285714285716,1,0.0,0,4,0,4,9,0,0,1,0,8,10,1
9847,88808,qvojdac7xUuog4FKjywIiWLo2CLniAnu,fbPkOYLVPtPgIt0MxizjfFJov3JbHyAi,9,5,3,0,3,0,2,0,13,1.8571428571428572,1,0.0,0,3,0,3,5,0,0,2,0,6,7,1
9848,88809,r7HcMNOT5LLOYH8hCtxY2qjQMqPnDz4Z,fbPkOYLVPtPgIt0MxizjfFJov3JbHyAi,11,13,7,2,5,4,4,0,35,5.0,1,0.0,1,7,2,5,12,4,0,4,0,15,20,1
9849,88810,Im5unyUxIwWC6gQuuhs0nm7hNG0B0uwk,fbPkOYLVPtPgIt0MxizjfFJov3JbHyAi,7,3,2,0,2,1,7,0,15,2.142857142857143,1,0.0,0,2,0,2,3,1,0,7,0,4,11,1
9850,88811,75sdjcSshG9zd9yqWMZjrix1dGre1kOU,fbPkOYLVPtPgIt0MxizjfFJov3JbHyAi,5,2,1,0,1,0,2,0,6,0.8571428571428571,1,0.0,0,1,0,1,2,0,0,2,0,2,4,1
9851,88813,KC3eAbHLPns12iVsS4LuLv4X7AErDIWY,fbPkOYLVPtPgIt0MxizjfFJov3JbHyAi,1,0,0,0,0,0,2,0,2,0.2857142857142857,1,0.0,0,0,0,0,0,0,0,2,0,0,2,1
9852,88814,qmemIVC5Iuvmt3EwAEmeheRArNgSE4sO,fbPkOYLVPtPgIt0MxizjfFJov3JbHyAi,1,0,0,0,0,0,1,0,1,0.14285714285714285,1,0.0,0,0,0,0,0,0,0,1,0,0,1,1
9853,88815,Ryj9SYlTY2129nyufOPixA9oPGYhqvjh,fbPkOYLVPtPgIt0MxizjfFJov3JbHyAi,4,3,1,0,1,0,3,0,8,1.1428571428571428,2,0.0,0,1,0,1,3,0,0,3,0,2,6,1
9854,88818,89WrqZK2Q73BIEUqNtaalkZbdJCLDFwZ,fbPkOYLVPtPgIt0MxizjfFJov3JbHyAi,8,4,2,0,1,3,6,1,17,2.4285714285714284,2,0.0,0,2,0,1,4,3,0,6,1,3,14,1
9855,88820,FwTErVkZ5KG64sGBwGPbKk9gM0cwQPh1,fbPkOYLVPtPgIt0MxizjfFJov3JbHyAi,10,7,5,0,4,8,6,1,31,4.428571428571429,1,0.0,0,5,0,4,7,8,0,6,1,9,22,1
9856,88821,p4bpHXDCH4ga8oV8ZqbH95nJI7VYCp8t,fbPkOYLVPtPgIt0MxizjfFJov3JbHyAi,1,0,0,0,0,0,1,0,1,0.14285714285714285,1,0.0,0,0,0,0,0,0,0,1,0,0,1,1
9857,88822,4hbcS1XH6kSybbsyz7K3CYFhB00MIUIr,fbPkOYLVPtPgIt0MxizjfFJov3JbHyAi,6,6,2,0,3,0,1,0,12,1.7142857142857142,1,0.0,3,2,0,3,3,0,0,1,0,8,4,1
9858,88823,AyhJARh0xhxObM9zhvUdDxlTCtu309eW,fbPkOYLVPtPgIt0MxizjfFJov3JbHyAi,8,7,4,0,3,27,5,0,46,6.571428571428571,3,0.0,0,4,0,3,7,27,0,5,0,7,39,1
9859,88824,mc7ReRohr0aHl54443zTpOlq1o12BqN6,fbPkOYLVPtPgIt0MxizjfFJov3JbHyAi,1,0,0,0,0,0,1,0,1,0.14285714285714285,1,0.0,0,0,0,0,0,0,0,1,0,0,1,1
9860,88825,SO7BGTzNf50pHLqWJC7Isbkuvs1iCvSw,fbPkOYLVPtPgIt0MxizjfFJov3JbHyAi,11,8,5,0,3,7,3,1,27,3.857142857142857,1,0.0,1,5,0,3,7,7,0,3,1,9,18,1
9861,88826,FHVGisAeAJdUWbqdfGOX1SqwMTNsn4Sl,fbPkOYLVPtPgIt0MxizjfFJov3JbHyAi,6,1,1,0,1,0,3,0,6,0.8571428571428571,1,0.0,0,1,0,1,1,0,0,3,0,2,4,1
9862,88828,D4QcA7podzZXBTfof4ESNtLtgPKFTty3,fbPkOYLVPtPgIt0MxizjfFJov3JbHyAi,7,2,1,0,1,8,6,1,19,2.7142857142857144,1,0.0,0,1,0,1,2,8,0,6,1,2,17,1
9863,88832,xLVZrHAd2rcd4gjL2AH8LHStjVOxoTXH,fbPkOYLVPtPgIt0MxizjfFJov3JbHyAi,7,7,4,0,3,0,2,0,16,2.2857142857142856,2,0.0,0,4,0,3,7,0,0,2,0,7,9,1
9864,88833,eOxm8XEI11Xs6eiBi1Nu5QzIagZXwEm9,fbPkOYLVPtPgIt0MxizjfFJov3JbHyAi,7,4,2,0,2,8,3,0,19,2.7142857142857144,2,0.0,1,2,0,2,3,8,0,3,0,5,14,1
9865,88834,UPCBTwptJrhgu4vesm7VG1r09OOWFZ8M,fbPkOYLVPtPgIt0MxizjfFJov3JbHyAi,2,0,0,0,0,0,3,0,3,0.42857142857142855,1,0.0,0,0,0,0,0,0,0,3,0,0,3,1
9866,88835,sR0gVqP9THtsGU0nXYxvlPsXuHuYggxR,fbPkOYLVPtPgIt0MxizjfFJov3JbHyAi,8,6,2,2,2,0,4,0,16,2.2857142857142856,1,0.0,2,2,2,2,4,0,0,4,0,8,8,1
9867,88837,QkdU1z3YFvdeUK9lKehYyofsDutrm196,fbPkOYLVPtPgIt0MxizjfFJov3JbHyAi,6,4,2,0,2,0,1,0,9,1.2857142857142858,1,0.0,0,2,0,2,4,0,0,1,0,4,5,1
9868,88838,gVqypDd1b5rP0VnVbrsZj4FDK81Xew1Y,fbPkOYLVPtPgIt0MxizjfFJov3JbHyAi,4,2,1,0,1,0,1,0,5,0.7142857142857143,1,0.0,0,1,0,1,2,0,0,1,0,2,3,1
9869,88839,iKVtXLZY6XC1Ozhvwt3XfCzLYHoRf4Le,fbPkOYLVPtPgIt0MxizjfFJov3JbHyAi,5,1,1,0,1,0,2,0,5,0.7142857142857143,1,0.0,0,1,0,1,1,0,0,2,0,2,3,1
9870,88840,Sbvsuo19O2SfThVQR8m11L1fIHdeUt20,fbPkOYLVPtPgIt0MxizjfFJov3JbHyAi,9,8,4,0,2,2,8,1,25,3.5714285714285716,2,0.0,0,4,0,2,8,2,0,8,1,6,19,1
9871,88841,sXHmxCYzWKnOBp4g0oDOkoNrOpYDpt1m,fbPkOYLVPtPgIt0MxizjfFJov3JbHyAi,1,0,0,0,0,0,1,0,1,0.14285714285714285,1,0.0,0,0,0,0,0,0,0,1,0,0,1,1
9872,88843,YkG4vF4KhqibrD50khtgskxo6iKIJC5w,fbPkOYLVPtPgIt0MxizjfFJov3JbHyAi,6,3,2,0,2,0,1,0,8,1.1428571428571428,1,0.0,0,2,0,2,3,0,0,1,0,4,4,1
9873,88846,AqzJls3OFl2nFap48g5Tia0Yo0Y7Cer3,fbPkOYLVPtPgIt0MxizjfFJov3JbHyAi,9,11,4,0,3,1,5,1,25,3.5714285714285716,1,0.0,0,4,0,3,11,1,0,5,1,7,18,1
9874,88847,6mNKW4qOUXPShTxM8cvfepjQFTLv3oOh,fbPkOYLVPtPgIt0MxizjfFJov3JbHyAi,20,20,16,0,16,18,15,1,86,12.285714285714286,1,0.0,2,16,0,16,18,18,0,15,1,34,52,1
9875,88850,d9MkkuCn04Toz7g1JpLdUJWD9xM5braA,fbPkOYLVPtPgIt0MxizjfFJov3JbHyAi,4,3,1,0,1,0,2,0,7,1.0,1,0.0,0,1,0,1,3,0,0,2,0,2,5,1
9876,88851,Gl03eSeNtb7juYcfyy4T6xQkEEhQalIx,fbPkOYLVPtPgIt0MxizjfFJov3JbHyAi,5,5,3,0,2,0,1,0,11,1.5714285714285714,1,0.0,0,3,0,2,5,0,0,1,0,5,6,0
9877,88852,SW8hZER4lRVJxocMEgvR4kXl1NsQnFzy,fbPkOYLVPtPgIt0MxizjfFJov3JbHyAi,6,3,2,0,2,0,1,0,8,1.1428571428571428,1,0.0,0,2,0,2,3,0,0,1,0,4,4,1
9878,88853,zvDqimtTzQDntzI9wqOWSebcIJKnGJ4a,fbPkOYLVPtPgIt0MxizjfFJov3JbHyAi,12,26,3,11,1,16,15,1,73,10.428571428571429,5,0.0,7,3,7,1,19,16,4,15,1,18,55,1
9879,88855,XQ3dYwdsUwJ24fnMOalUTaMPlpgBFmZW,fbPkOYLVPtPgIt0MxizjfFJov3JbHyAi,3,0,0,0,0,1,2,0,3,0.42857142857142855,1,0.0,0,0,0,0,0,1,0,2,0,0,3,1
9880,88856,hluzPB1y7zkKLSSzVkJvXfWNLyDAuRho,fbPkOYLVPtPgIt0MxizjfFJov3JbHyAi,9,11,8,0,6,0,3,0,28,4.0,2,0.0,0,8,0,6,11,0,0,3,0,14,14,1
9881,88858,sfQpIAyh1Bl1FfOPcdLy9YBFhdo6RQbA,fbPkOYLVPtPgIt0MxizjfFJov3JbHyAi,2,0,0,0,0,0,4,0,4,0.5714285714285714,1,0.0,0,0,0,0,0,0,0,4,0,0,4,1
9882,88859,JF7rR3pF5cT0hx4XGqF6ShAdIIlqNFHc,fbPkOYLVPtPgIt0MxizjfFJov3JbHyAi,7,3,2,0,2,0,2,0,9,1.2857142857142858,1,0.0,0,2,0,2,3,0,0,2,0,4,5,1
9883,88860,V8o57SeARenbMywXqROBGV5CkdHJLIRM,fbPkOYLVPtPgIt0MxizjfFJov3JbHyAi,3,0,0,0,0,8,4,0,12,1.7142857142857142,1,0.0,0,0,0,0,0,8,0,4,0,0,12,1
9884,88911,lAbZwAYKTyZI7H53JXZYE1DAKQNJGlGJ,3VkHkmOtom3jM2wCu94xgzzu1d6Dn7or,21,29,15,40,0,24,17,6,131,18.714285714285715,2,0.0,8,15,38,0,21,24,2,17,6,61,70,1
9885,88916,LRjqhYtqS9moLoOjiLCiCNZwzxUXJkT1,3VkHkmOtom3jM2wCu94xgzzu1d6Dn7or,1,0,0,0,0,0,1,0,1,0.14285714285714285,1,0.0,0,0,0,0,0,0,0,1,0,0,1,1
9886,88918,ahbaDr1KpVEdYWTC3NSwGl199oLA9pwN,3VkHkmOtom3jM2wCu94xgzzu1d6Dn7or,11,13,5,0,6,0,3,0,27,3.857142857142857,1,0.0,6,5,0,6,7,0,0,3,0,17,10,1
9887,88926,cxzXwKcGrJCPE1BOyefClCLGNk3PxQhW,3VkHkmOtom3jM2wCu94xgzzu1d6Dn7or,1,0,0,0,0,0,1,0,1,0.14285714285714285,1,0.0,0,0,0,0,0,0,0,1,0,0,1,1
9888,88928,e0buQlxlHVWdQd03EOAehldJOI8AeFTm,3VkHkmOtom3jM2wCu94xgzzu1d6Dn7or,6,4,2,0,1,0,4,0,11,1.5714285714285714,2,0.0,0,2,0,1,4,0,0,4,0,3,8,0
9889,88933,J7jJzTgJWf8xIO8N4tK5xh1VQj17hBiy,3VkHkmOtom3jM2wCu94xgzzu1d6Dn7or,5,4,1,0,1,1,3,0,10,1.4285714285714286,2,0.0,1,1,0,1,3,1,0,3,0,3,7,1
9890,88937,ucnh7Je2Ujv5K3Q3wjC5gWq40jwh8dv6,3VkHkmOtom3jM2wCu94xgzzu1d6Dn7or,43,121,50,33,37,9,47,3,300,42.857142857142854,10,0.0,46,50,27,37,75,9,6,47,3,160,140,1
9891,88938,3cllbPYEJp74HYn7HHNMKMzXQxN8axkY,3VkHkmOtom3jM2wCu94xgzzu1d6Dn7or,1,0,0,0,0,0,2,0,2,0.2857142857142857,1,0.0,0,0,0,0,0,0,0,2,0,0,2,1
9892,88943,IXOAd9gzq9ETuEABkvxdbEaJcLrRwGoR,3VkHkmOtom3jM2wCu94xgzzu1d6Dn7or,11,7,5,0,3,1,7,0,23,3.2857142857142856,2,0.0,0,5,0,3,7,1,0,7,0,8,15,1
9893,88946,CNJ2KRdKhIzMbOlxj2daOOkuq5TrQAeD,3VkHkmOtom3jM2wCu94xgzzu1d6Dn7or,1,0,0,0,0,0,1,0,1,0.14285714285714285,1,0.0,0,0,0,0,0,0,0,1,0,0,1,1
9894,88949,tsEZQPaaDFu5srPuDEqunB4WLNGL8KRx,3VkHkmOtom3jM2wCu94xgzzu1d6Dn7or,1,0,0,0,0,0,1,0,1,0.14285714285714285,1,0.0,0,0,0,0,0,0,0,1,0,0,1,1
9895,88950,0BYnjPQBJCyvsMCFPwytdDakvmEAJJxG,3VkHkmOtom3jM2wCu94xgzzu1d6Dn7or,6,3,2,0,2,0,2,0,9,1.2857142857142858,1,0.0,0,2,0,2,3,0,0,2,0,4,5,1
9896,88953,bsalGAvHbAyi2zQkMdMuno7PqVBrE5qV,3VkHkmOtom3jM2wCu94xgzzu1d6Dn7or,8,10,3,2,5,1,2,0,23,3.2857142857142856,1,0.0,6,3,2,5,4,1,0,2,0,16,7,1
9897,88954,iCGz2pRa6uhZJEwypFooqVVulX8MzKD9,3VkHkmOtom3jM2wCu94xgzzu1d6Dn7or,7,2,1,0,1,2,5,1,12,1.7142857142857142,1,0.0,0,1,0,1,2,2,0,5,1,2,10,1
9898,88958,wJViEDKJG9cycqokQxxOomq0g3hb2X0n,3VkHkmOtom3jM2wCu94xgzzu1d6Dn7or,5,2,1,0,1,0,2,0,6,0.8571428571428571,1,0.0,0,1,0,1,2,0,0,2,0,2,4,1
9899,88963,k59Gorliztx6a47jV7pr1ch0V9419jgs,3VkHkmOtom3jM2wCu94xgzzu1d6Dn7or,1,0,0,0,0,0,1,0,1,0.14285714285714285,1,0.0,0,0,0,0,0,0,0,1,0,0,1,1
9900,88966,yWv4f7mENeE5nSNa1Bu7iGvTZVHnqgk4,3VkHkmOtom3jM2wCu94xgzzu1d6Dn7or,1,0,0,0,0,0,1,0,1,0.14285714285714285,1,0.0,0,0,0,0,0,0,0,1,0,0,1,1
9901,88967,IVRKzAf1gWN5ButpaPiczzsxf6iD5MK8,3VkHkmOtom3jM2wCu94xgzzu1d6Dn7or,1,0,0,0,0,0,1,0,1,0.14285714285714285,1,0.0,0,0,0,0,0,0,0,1,0,0,1,1
9902,88970,Z5kwG3PpmYL3QYQb9knyt6ww6ALymSSg,3VkHkmOtom3jM2wCu94xgzzu1d6Dn7or,2,0,0,0,0,0,2,0,2,0.2857142857142857,1,0.0,0,0,0,0,0,0,0,2,0,0,2,1
9903,88972,SbEmlTcBjFBtCEwE1MXDr9Ger6m3C2oy,3VkHkmOtom3jM2wCu94xgzzu1d6Dn7or,8,4,2,0,2,5,6,5,24,3.4285714285714284,1,0.0,1,2,0,2,3,5,0,6,5,5,19,1
9904,88975,YKTpkNPEurHlfGW3A9wA7ZyLfR2cuzGi,3VkHkmOtom3jM2wCu94xgzzu1d6Dn7or,6,6,2,0,3,0,5,0,16,2.2857142857142856,1,0.0,3,2,0,3,3,0,0,5,0,8,8,1
9905,88977,syrttArug8Mpzs9L0IHsvBtATawYF9J2,3VkHkmOtom3jM2wCu94xgzzu1d6Dn7or,1,0,0,0,0,0,1,0,1,0.14285714285714285,1,0.0,0,0,0,0,0,0,0,1,0,0,1,1
9906,88982,3XRkXq805MjluZF5vkfqjwvySDkF3LnT,3VkHkmOtom3jM2wCu94xgzzu1d6Dn7or,1,0,0,0,0,0,1,0,1,0.14285714285714285,1,0.0,0,0,0,0,0,0,0,1,0,0,1,1
9907,88983,mAOdvYAdgQSaOInL6L7xQLXLQkzkpnkw,3VkHkmOtom3jM2wCu94xgzzu1d6Dn7or,7,5,1,0,0,0,10,1,17,2.4285714285714284,1,0.0,2,1,0,0,3,0,0,10,1,3,14,1
9908,88990,Yi43nvK6IYnQZd87bkmm0bmUnr9E8D0n,3VkHkmOtom3jM2wCu94xgzzu1d6Dn7or,6,4,0,0,1,0,5,1,11,1.5714285714285714,1,0.0,2,0,0,1,2,0,0,5,1,3,8,1
9909,88991,BcU9hDrDz2F2xEd3tqF67ZptaAdextzP,3VkHkmOtom3jM2wCu94xgzzu1d6Dn7or,8,5,3,0,2,0,3,0,13,1.8571428571428572,3,0.0,0,3,0,2,5,0,0,3,0,5,8,0
9910,88993,EWcraq8C1ApG4sDi5Wn7JWSKpr9J6BU0,3VkHkmOtom3jM2wCu94xgzzu1d6Dn7or,1,0,0,0,0,0,1,0,1,0.14285714285714285,1,0.0,0,0,0,0,0,0,0,1,0,0,1,1
9911,88997,whspXo2pdzqGQ7uUMsLjiaHYpjkc35JW,3VkHkmOtom3jM2wCu94xgzzu1d6Dn7or,2,0,0,0,0,0,3,0,3,0.42857142857142855,3,0.0,0,0,0,0,0,0,0,3,0,0,3,1
9912,88998,oSabIe7L5topw6hwV4H4ZV0Ug7ZVNxfV,3VkHkmOtom3jM2wCu94xgzzu1d6Dn7or,29,52,32,29,26,10,5,0,154,22.0,5,0.0,19,32,23,26,33,10,6,5,0,100,54,1
9913,89001,SIEvRbNGLrbZ8hQx02PeCIy1TZz00zab,3VkHkmOtom3jM2wCu94xgzzu1d6Dn7or,1,0,0,0,0,0,1,0,1,0.14285714285714285,1,0.0,0,0,0,0,0,0,0,1,0,0,1,1
9914,89002,fjBO4dqI4rE3EVJKn1UzLgI1nZOUL8Es,3VkHkmOtom3jM2wCu94xgzzu1d6Dn7or,48,109,21,65,47,0,4,0,246,35.142857142857146,3,0.0,78,21,61,47,31,0,4,4,0,207,39,1
9915,89004,qOPsL7s2uJzugKawS9Eo8qQaSmIpBiZR,3VkHkmOtom3jM2wCu94xgzzu1d6Dn7or,11,11,4,2,4,7,11,1,40,5.714285714285714,2,0.0,5,4,2,4,6,7,0,11,1,15,25,1
9916,89005,qvZjxZ8rTsJK8V0a0T3CWXSelVOq0QMt,3VkHkmOtom3jM2wCu94xgzzu1d6Dn7or,9,6,3,1,2,3,7,1,23,3.2857142857142856,1,0.0,1,3,1,2,5,3,0,7,1,7,16,1
9917,89007,9Z2Md4wmHivzsbvqY2t7sBwH1lK5dRfK,3VkHkmOtom3jM2wCu94xgzzu1d6Dn7or,1,0,0,0,0,0,1,0,1,0.14285714285714285,1,0.0,0,0,0,0,0,0,0,1,0,0,1,1
9918,89009,onHOYD5uzmnV4nRw3pLXt3LrpUkknNmw,3VkHkmOtom3jM2wCu94xgzzu1d6Dn7or,6,3,1,0,1,0,3,0,8,1.1428571428571428,1,0.0,0,1,0,1,3,0,0,3,0,2,6,1
9919,89012,33wUTO936EWlkY1IHcJLwG62YCATj8r9,3VkHkmOtom3jM2wCu94xgzzu1d6Dn7or,1,0,0,0,0,0,1,0,1,0.14285714285714285,1,0.0,0,0,0,0,0,0,0,1,0,0,1,1
9920,89016,hsmZkFD6JkOYgvPKK5l3oc9eLCdW6vFq,3VkHkmOtom3jM2wCu94xgzzu1d6Dn7or,16,81,34,18,0,3,18,1,155,22.142857142857142,3,0.0,21,34,16,0,60,3,2,18,1,71,84,1
9921,89028,DYAk0IkWbJP7Bx09YkPpEGwRc6m4R8OD,3VkHkmOtom3jM2wCu94xgzzu1d6Dn7or,9,10,6,0,4,0,7,0,27,3.857142857142857,2,0.0,1,6,0,4,9,0,0,7,0,11,16,1
9922,89029,MQHx1pkOQZAuD4wT0ZMwn0mRSo8hfk9w,3VkHkmOtom3jM2wCu94xgzzu1d6Dn7or,1,0,0,0,0,0,1,0,1,0.14285714285714285,1,0.0,0,0,0,0,0,0,0,1,0,0,1,1
9923,89033,w3155Vkw5wpuKOK6WeWXLmPGCsMeqo9R,3VkHkmOtom3jM2wCu94xgzzu1d6Dn7or,8,6,3,0,2,2,5,0,18,2.5714285714285716,1,0.0,0,3,0,2,6,2,0,5,0,5,13,1
9924,89037,ySuxn4nU2lxfW7r2bXGbcO5FnHdn6zbc,3VkHkmOtom3jM2wCu94xgzzu1d6Dn7or,31,42,24,8,26,4,2,2,108,15.428571428571429,5,0.0,5,24,7,26,37,4,1,2,2,62,46,1
9925,89038,wTUcP4QaVXs3YwLG8vhem4UlekekF5G9,3VkHkmOtom3jM2wCu94xgzzu1d6Dn7or,1,0,0,0,0,0,1,0,1,0.14285714285714285,1,0.0,0,0,0,0,0,0,0,1,0,0,1,1
9926,89040,Couihzds0zUwIIYOXQBZ6NzQTceVdsaw,3VkHkmOtom3jM2wCu94xgzzu1d6Dn7or,1,0,0,0,0,0,1,0,1,0.14285714285714285,1,0.0,0,0,0,0,0,0,0,1,0,0,1,1
9927,89044,aeuPzDzM6VGDu5jueA6amTVqN9l5gHX3,3VkHkmOtom3jM2wCu94xgzzu1d6Dn7or,1,0,0,0,0,0,1,0,1,0.14285714285714285,1,0.0,0,0,0,0,0,0,0,1,0,0,1,1
9928,89049,oAQVGhcAt6l7hdLJ4W1QLF4wdWetqcue,3VkHkmOtom3jM2wCu94xgzzu1d6Dn7or,6,2,1,0,1,0,3,1,8,1.1428571428571428,1,0.0,0,1,0,1,2,0,0,3,1,2,6,1
9929,89050,3AAYV9UoVtL9DSFaIEJnVYAjOi2mWhEh,3VkHkmOtom3jM2wCu94xgzzu1d6Dn7or,2,0,0,0,0,0,2,0,2,0.2857142857142857,1,0.0,0,0,0,0,0,0,0,2,0,0,2,1
9930,89053,8WkmluXFyfH2RPkt9XBiIrqOQqieGIYU,3VkHkmOtom3jM2wCu94xgzzu1d6Dn7or,1,0,0,0,0,0,1,0,1,0.14285714285714285,1,0.0,0,0,0,0,0,0,0,1,0,0,1,1
9931,89055,BRzMUg3uRehDmYGai2dXPzJ2vy0ZTdCI,3VkHkmOtom3jM2wCu94xgzzu1d6Dn7or,3,0,0,0,0,0,6,0,6,0.8571428571428571,1,0.0,0,0,0,0,0,0,0,6,0,0,6,1
9932,89065,au3rsNa6vBxNlZHvwJ43U4yHJfexllpD,3VkHkmOtom3jM2wCu94xgzzu1d6Dn7or,21,29,11,18,9,20,4,1,92,13.142857142857142,1,0.0,12,11,17,9,17,20,1,4,1,49,43,1
9933,89067,I01Tigm5affXeT685ZIT6O3ETijHB7PS,3VkHkmOtom3jM2wCu94xgzzu1d6Dn7or,4,5,3,0,3,0,1,0,12,1.7142857142857142,1,0.0,0,3,0,3,5,0,0,1,0,6,6,1
9934,89069,vXCsOFvHAmaiRU9e8CXhjo1ldP3789HQ,3VkHkmOtom3jM2wCu94xgzzu1d6Dn7or,1,0,0,0,0,0,1,0,1,0.14285714285714285,1,0.0,0,0,0,0,0,0,0,1,0,0,1,1
9935,89072,CTMTvI2Uro0EeKNBsJxetU9EJ96AOiT1,3VkHkmOtom3jM2wCu94xgzzu1d6Dn7or,1,0,0,0,0,0,1,0,1,0.14285714285714285,1,0.0,0,0,0,0,0,0,0,1,0,0,1,1
9936,89075,TyZ5vRcbKdK9ylblLwR0MRT1s2uEnY5W,3VkHkmOtom3jM2wCu94xgzzu1d6Dn7or,45,79,16,53,33,9,9,0,199,28.428571428571427,2,0.0,58,16,49,33,21,9,4,9,0,156,43,1
9937,89077,vrNEFmWIhF2qeuPtPLyQm0dWGXF9FQDn,3VkHkmOtom3jM2wCu94xgzzu1d6Dn7or,7,4,2,0,2,0,2,0,10,1.4285714285714286,1,0.0,1,2,0,2,3,0,0,2,0,5,5,1
9938,89082,CRNYHnQXh6HkRHMggPMymqKhyKPDJZeG,3VkHkmOtom3jM2wCu94xgzzu1d6Dn7or,1,0,0,0,0,0,1,0,1,0.14285714285714285,1,0.0,0,0,0,0,0,0,0,1,0,0,1,1
9939,89097,bFW1YBBLTe4uG5eW9TDcVIOcLOaSX5ld,3VkHkmOtom3jM2wCu94xgzzu1d6Dn7or,14,24,12,0,7,0,10,0,53,7.571428571428571,8,0.0,0,12,0,7,24,0,0,10,0,19,34,0
9940,89100,qRgamRc0j9SUXfXdqrrge5Qv1AZECycO,3VkHkmOtom3jM2wCu94xgzzu1d6Dn7or,7,7,3,6,4,1,1,0,22,3.142857142857143,1,0.0,3,3,5,4,4,1,1,1,0,15,7,1
9941,89105,ESEPT0SMuO2dXTmyHCgV7oXscA7W26hK,3VkHkmOtom3jM2wCu94xgzzu1d6Dn7or,26,39,19,18,15,12,4,0,107,15.285714285714286,2,0.0,10,19,15,15,29,12,3,4,0,59,48,1
9942,89108,COJspLkVqHUm3DJ5odOYM2jLEfX5mp8g,3VkHkmOtom3jM2wCu94xgzzu1d6Dn7or,2,0,0,0,0,0,2,0,2,0.2857142857142857,1,0.0,0,0,0,0,0,0,0,2,0,0,2,1
9943,89109,w0u223fmMcj8R0XYvkRYTxBWPO2H34gs,3VkHkmOtom3jM2wCu94xgzzu1d6Dn7or,1,0,0,0,0,0,1,0,1,0.14285714285714285,1,0.0,0,0,0,0,0,0,0,1,0,0,1,1
9944,89113,BtQKKM0BtMpj8x1gmvIXn2yelVCPISxo,3VkHkmOtom3jM2wCu94xgzzu1d6Dn7or,4,2,1,0,1,2,1,0,7,1.0,1,0.0,0,1,0,1,2,2,0,1,0,2,5,1
9945,89114,QlMLVIhM5vSav3NBzoFtmciCM1pZZnLs,3VkHkmOtom3jM2wCu94xgzzu1d6Dn7or,1,0,0,0,0,0,1,0,1,0.14285714285714285,1,0.0,0,0,0,0,0,0,0,1,0,0,1,1
9946,89125,yRXk9t7I0ipJKdRCHLx2PuZNLNNkkXb7,3VkHkmOtom3jM2wCu94xgzzu1d6Dn7or,5,2,1,0,1,0,2,0,6,0.8571428571428571,1,0.0,0,1,0,1,2,0,0,2,0,2,4,1
9947,89128,BIiI4gBnsSkEPDiI0fdE5hMfAdZYws3A,3VkHkmOtom3jM2wCu94xgzzu1d6Dn7or,1,0,0,0,0,0,1,0,1,0.14285714285714285,1,0.0,0,0,0,0,0,0,0,1,0,0,1,1
9948,89130,qT5MUcinTAEJodeIhWYHhFiMFnaXOLX0,3VkHkmOtom3jM2wCu94xgzzu1d6Dn7or,8,21,5,0,2,4,6,1,39,5.571428571428571,4,0.0,2,5,0,2,19,4,0,6,1,9,30,1
9949,89134,M47eI6aml6puJVOQSgAD0Ct9KNVhYdOW,3VkHkmOtom3jM2wCu94xgzzu1d6Dn7or,1,0,0,0,0,0,1,0,1,0.14285714285714285,1,0.0,0,0,0,0,0,0,0,1,0,0,1,1
9950,89139,4Seg1mBzfEEtLCIoQ9Why99R7xBxrcs8,3VkHkmOtom3jM2wCu94xgzzu1d6Dn7or,1,0,0,0,0,0,1,0,1,0.14285714285714285,1,0.0,0,0,0,0,0,0,0,1,0,0,1,1
9951,89140,MJVWMTfGhwvTGXPKgy2Gjzmj7rVHWvF4,3VkHkmOtom3jM2wCu94xgzzu1d6Dn7or,12,12,3,4,3,0,10,1,33,4.714285714285714,2,0.0,6,3,3,3,6,0,1,10,1,15,18,1
9952,89142,OBpRO1sT0AeSc4Ploo60TZgSq8G8qvPg,3VkHkmOtom3jM2wCu94xgzzu1d6Dn7or,6,6,3,0,1,0,4,0,14,2.0,3,0.0,0,3,0,1,6,0,0,4,0,4,10,1
9953,89153,93CdCLAT4bSkQ5pBc61CcOzq22oizzqt,3VkHkmOtom3jM2wCu94xgzzu1d6Dn7or,9,16,0,0,3,0,6,1,26,3.7142857142857144,1,0.0,6,0,0,3,10,0,0,6,1,9,17,1
9954,89156,vbW1KaPU4HdAU3ExlW7t2Z2lZknONBDo,SpATywNh6bZuzm8s1ceuBUnMUAeoAHHw,1,0,0,0,0,0,1,0,1,0.14285714285714285,1,0.0,0,0,0,0,0,0,0,1,0,0,1,1
9955,89158,4izQXcJwvwmvhdH2eayMFjLqLTND3JLq,SpATywNh6bZuzm8s1ceuBUnMUAeoAHHw,1,0,0,0,0,0,1,0,1,0.14285714285714285,1,0.0,0,0,0,0,0,0,0,1,0,0,1,1
9956,89160,ujTZ8itG5tOi9RBi81LVjGylcfmfscnv,SpATywNh6bZuzm8s1ceuBUnMUAeoAHHw,1,0,0,0,0,0,4,0,4,0.5714285714285714,1,0.0,0,0,0,0,0,0,0,4,0,0,4,1
9957,89176,xe8A48TmWAWrsrOrkKLLF9EL4o5xag4y,SpATywNh6bZuzm8s1ceuBUnMUAeoAHHw,1,0,0,0,0,0,1,0,1,0.14285714285714285,1,0.0,0,0,0,0,0,0,0,1,0,0,1,1
9958,89177,JfoqUtmque7wAjeDp4JXdK1NxfjlSlfN,SpATywNh6bZuzm8s1ceuBUnMUAeoAHHw,1,0,0,0,0,0,1,0,1,0.14285714285714285,1,0.0,0,0,0,0,0,0,0,1,0,0,1,1
9959,89178,mmrzdjNmPvFK53WAh9BwB5yGYUT5HqSe,G8EPVSXsOYB5YQWZGiz1aVq5Pgr2GrQu,1,0,0,0,0,0,1,0,1,0.14285714285714285,1,0.0,0,0,0,0,0,0,0,1,0,0,1,1
9960,89179,byKEl7rjAYN1zOFtYklTCb9GFeYuN4nO,SpATywNh6bZuzm8s1ceuBUnMUAeoAHHw,1,0,0,0,0,0,1,0,1,0.14285714285714285,1,0.0,0,0,0,0,0,0,0,1,0,0,1,1
9961,89180,GWkPEXh9DjC0IZThysIgNjSmYaI9dcS2,G8EPVSXsOYB5YQWZGiz1aVq5Pgr2GrQu,9,2,1,0,1,1,7,1,13,1.8571428571428572,2,0.0,0,1,0,1,2,1,0,7,1,2,11,1
9962,89187,rfOApTbQ4xF2665bHZIBhoJqQcTU6i9L,bWdj2GDclj5ofokWjzoa5jAwMkxCykd6,7,3,2,0,2,0,4,0,11,1.5714285714285714,1,0.0,0,2,0,2,3,0,0,4,0,4,7,1
9963,89189,bJL1sGEdg6Wyh9EeL6PIHUn7Crptl1QG,SpATywNh6bZuzm8s1ceuBUnMUAeoAHHw,2,0,0,0,0,0,2,0,2,0.2857142857142857,1,0.0,0,0,0,0,0,0,0,2,0,0,2,1
9964,89195,htC7O6KmzjLEAd92jccVhN4tDLN92YII,SpATywNh6bZuzm8s1ceuBUnMUAeoAHHw,5,5,0,0,0,0,3,0,8,1.1428571428571428,2,0.0,0,0,0,0,5,0,0,3,0,0,8,1
9965,89205,iHJGDLnoobtpsuLsojTJ7EMK5S6IfRa5,bWdj2GDclj5ofokWjzoa5jAwMkxCykd6,10,7,1,12,2,1,4,0,27,3.857142857142857,1,0.0,1,1,12,2,6,1,0,4,0,16,11,1
9966,89207,Wfpsd6cFXMtD0KyRvLKtWb4mn0MDgPtD,SpATywNh6bZuzm8s1ceuBUnMUAeoAHHw,6,2,0,0,0,2,21,6,31,4.428571428571429,1,0.0,0,0,0,0,2,2,0,21,6,0,31,1
9967,89211,W4anGZ3gUxihb7qbTalaixckN7io0pRJ,RXDvfPUBYFlVdlueBFbLW0mhhAyGEqpt,1,0,0,0,0,0,1,0,1,0.14285714285714285,1,0.0,0,0,0,0,0,0,0,1,0,0,1,1
9968,89213,7ORBOKUOYBR6pt3N4fl6iHTd7mMd3dtL,G8EPVSXsOYB5YQWZGiz1aVq5Pgr2GrQu,5,9,2,0,2,0,2,0,15,2.142857142857143,2,0.0,6,2,0,2,3,0,0,2,0,10,5,1
9969,89216,moK1GdnqoYxhSRCf5a95lgXdVNdzYrjs,bWdj2GDclj5ofokWjzoa5jAwMkxCykd6,6,5,0,0,0,0,9,0,14,2.0,1,0.0,0,0,0,0,5,0,0,9,0,0,14,1
9970,89217,PA2zIjexrl5X42bUhfLaCsans4YmH5zQ,SpATywNh6bZuzm8s1ceuBUnMUAeoAHHw,12,15,5,0,3,2,11,2,38,5.428571428571429,2,0.0,0,5,0,3,15,2,0,11,2,8,30,1
9971,89219,Mqke4gGiYdtmQuFOtXx8ilrWhvfHEVOG,SpATywNh6bZuzm8s1ceuBUnMUAeoAHHw,6,2,1,0,1,1,5,0,10,1.4285714285714286,2,0.0,0,1,0,1,2,1,0,5,0,2,8,1
9972,89222,JmoVlWZppOh9wSlYvcOL4ciU00D3apDg,SpATywNh6bZuzm8s1ceuBUnMUAeoAHHw,3,2,0,0,0,0,4,0,6,0.8571428571428571,1,0.0,0,0,0,0,2,0,0,4,0,0,6,1
9973,89235,d4cb9OZbLbDBqzuhcJemwCaulhBw3XcA,bWdj2GDclj5ofokWjzoa5jAwMkxCykd6,18,19,7,44,7,4,7,0,88,12.571428571428571,1,0.0,10,7,37,7,9,4,7,7,0,61,27,1
9974,89242,hjUSUM6roI2mLGkMAqBjE0uxFRBSMYHJ,bWdj2GDclj5ofokWjzoa5jAwMkxCykd6,6,3,2,0,2,0,1,0,8,1.1428571428571428,1,0.0,0,2,0,2,3,0,0,1,0,4,4,1
9975,89249,YjL44X3XqXhDvKRGkgBLHiV9slzcQZGJ,SpATywNh6bZuzm8s1ceuBUnMUAeoAHHw,3,1,0,0,0,0,2,0,3,0.42857142857142855,1,0.0,0,0,0,0,1,0,0,2,0,0,3,1
9976,89252,gleoXCfE3tA6f5uM3pUTeqQbfFckrfVd,bWdj2GDclj5ofokWjzoa5jAwMkxCykd6,1,0,0,0,0,0,1,0,1,0.14285714285714285,1,0.0,0,0,0,0,0,0,0,1,0,0,1,1
9977,89262,qxQtZuyIzQWGcD008dVh3c4jYjIPrn2L,SpATywNh6bZuzm8s1ceuBUnMUAeoAHHw,3,1,0,0,0,0,2,0,3,0.42857142857142855,1,0.0,0,0,0,0,1,0,0,2,0,0,3,1
9978,89265,Hh6CQ9eQF89j5a5Oi2NUf2uAs2DZd4QT,SpATywNh6bZuzm8s1ceuBUnMUAeoAHHw,11,7,4,0,3,0,6,1,21,3.0,1,0.0,0,4,0,3,7,0,0,6,1,7,14,1
9979,89274,gAYHJa3M8crEnYGtoK5ulJH4EjKveQ23,SpATywNh6bZuzm8s1ceuBUnMUAeoAHHw,6,2,0,0,0,0,5,1,8,1.1428571428571428,1,0.0,0,0,0,0,2,0,0,5,1,0,8,1
9980,89275,PEDczBqLWdyMeFUgqqnQ5UtJeB7qq12O,SpATywNh6bZuzm8s1ceuBUnMUAeoAHHw,5,7,4,0,3,0,3,0,17,2.4285714285714284,1,0.0,0,4,0,3,7,0,0,3,0,7,10,1
9981,89286,pMaElq6QfFkzEK9UpuWlI5Z36ojw0yzC,bWdj2GDclj5ofokWjzoa5jAwMkxCykd6,1,0,0,0,0,0,1,0,1,0.14285714285714285,1,0.0,0,0,0,0,0,0,0,1,0,0,1,1
9982,89289,2Rw9LEKgxnu10TYMueqqEJs507ou3OOr,SpATywNh6bZuzm8s1ceuBUnMUAeoAHHw,5,2,0,0,0,2,5,1,10,1.4285714285714286,1,0.0,0,0,0,0,2,2,0,5,1,0,10,1
9983,89297,JYyHN8axXgpHcSLeMA1wyxGi6GgnqXzc,bWdj2GDclj5ofokWjzoa5jAwMkxCykd6,7,2,1,0,0,3,7,2,15,2.142857142857143,1,0.0,0,1,0,0,2,3,0,7,2,1,14,1
9984,89300,ZKwoFbqxmjGUhMeAwrPlEcEnBfnKdvyQ,SpATywNh6bZuzm8s1ceuBUnMUAeoAHHw,3,2,0,0,0,2,2,0,6,0.8571428571428571,1,0.0,0,0,0,0,2,2,0,2,0,0,6,1
9985,89301,Uk2Y8qj9Cf6T7k2O1cxM5Fue4zKTF1K8,SpATywNh6bZuzm8s1ceuBUnMUAeoAHHw,10,16,6,0,3,3,5,1,34,4.857142857142857,2,0.0,1,6,0,3,15,3,0,5,1,10,24,1
9986,89310,bwyEPRDnWmgwxNZP823jR0R0w9PchQI0,bWdj2GDclj5ofokWjzoa5jAwMkxCykd6,11,12,1,16,3,2,5,1,40,5.714285714285714,1,0.0,7,1,16,3,5,2,0,5,1,27,13,1
9987,89315,z8zMi50azvRwAPUNW2f5Gt0F6WOr8PI9,bWdj2GDclj5ofokWjzoa5jAwMkxCykd6,15,9,3,52,2,1,3,1,71,10.142857142857142,1,0.0,5,3,49,2,4,1,3,3,1,59,12,1
9988,89316,VF14jDCwIzSb92Zq60K5zB8BaUbLT4fN,bWdj2GDclj5ofokWjzoa5jAwMkxCykd6,16,31,3,40,4,9,8,1,96,13.714285714285714,3,0.0,7,3,39,4,24,9,1,8,1,53,43,1
9989,89320,EUrAZ23hcKSgGkr8BcxsusY5VGcq8UzJ,G8EPVSXsOYB5YQWZGiz1aVq5Pgr2GrQu,26,35,0,24,3,11,9,0,82,11.714285714285714,1,0.0,17,0,13,3,18,11,11,9,0,33,49,1
9990,89321,hwob5cfANjyVXpPbIwjR9A4IpD8atc3c,SpATywNh6bZuzm8s1ceuBUnMUAeoAHHw,10,8,7,0,5,0,2,0,22,3.142857142857143,1,0.0,0,7,0,5,8,0,0,2,0,12,10,1
9991,89323,JNtIRj6hnKiaMOhcBlcWRjLc0QwYKSxo,SpATywNh6bZuzm8s1ceuBUnMUAeoAHHw,12,9,2,14,1,0,4,0,30,4.285714285714286,1,0.0,2,2,11,1,7,0,3,4,0,16,14,1
9992,89325,8nDAopmFCIj7DcwdoC4rkmpeCk1s8Zgz,SpATywNh6bZuzm8s1ceuBUnMUAeoAHHw,9,8,4,0,3,1,5,1,22,3.142857142857143,2,0.0,1,4,0,3,7,1,0,5,1,8,14,1
9993,89330,HhEzipYCSzqDHvfYzAIj6GLpNqmUDFFt,SpATywNh6bZuzm8s1ceuBUnMUAeoAHHw,1,0,0,0,0,0,11,0,11,1.5714285714285714,1,0.0,0,0,0,0,0,0,0,11,0,0,11,1
9994,89345,g6IxzfRtoY3ZngcwPaZoK8tEiW61b5Gm,SpATywNh6bZuzm8s1ceuBUnMUAeoAHHw,7,2,1,0,1,0,4,2,10,1.4285714285714286,1,0.0,0,1,0,1,2,0,0,4,2,2,8,1
9995,89347,nRVtG0QK38ehOZE61TsAumXFUUbgiwAK,SpATywNh6bZuzm8s1ceuBUnMUAeoAHHw,5,3,0,0,0,0,3,0,6,0.8571428571428571,1,0.0,0,0,0,0,3,0,0,3,0,0,6,1
9996,89353,RMJqhWaieV03GDbDCUCDtD33fHLxVV5K,SpATywNh6bZuzm8s1ceuBUnMUAeoAHHw,14,12,6,10,3,1,3,1,36,5.142857142857143,1,0.0,5,6,9,3,7,1,1,3,1,23,13,1
9997,89354,PmjzDmD1PFYqpmVaelKXEbwbYfZH0pBp,SpATywNh6bZuzm8s1ceuBUnMUAeoAHHw,5,7,4,0,3,0,1,0,15,2.142857142857143,1,0.0,2,4,0,3,5,0,0,1,0,9,6,1
9998,89356,NpZps0g6tawFjKVlcYqueUROYKEoKNaJ,SpATywNh6bZuzm8s1ceuBUnMUAeoAHHw,4,3,1,0,1,0,1,0,6,0.8571428571428571,1,0.0,0,1,0,1,3,0,0,1,0,2,4,1
9999,89360,ZufvgvpRY93M4np3YlRkSzwkfWq82En4,SpATywNh6bZuzm8s1ceuBUnMUAeoAHHw,6,6,2,0,2,1,4,0,15,2.142857142857143,1,0.0,0,2,0,2,6,1,0,4,0,4,11,1
10000,89363,7oeUnzeChzbfg8iPaEKhVywsWn9pqTw6,SpATywNh6bZuzm8s1ceuBUnMUAeoAHHw,5,2,1,0,1,1,2,0,7,1.0,1,0.0,0,1,0,1,2,1,0,2,0,2,5,1
10001,89364,lXYwudRP8Zl9Z938FMhDttVYfWWJ9atj,RXDvfPUBYFlVdlueBFbLW0mhhAyGEqpt,12,13,6,0,3,3,7,0,32,4.571428571428571,2,0.0,3,6,0,3,10,3,0,7,0,12,20,1
10002,89365,LslskpvRu2kdJKdLBrkhLUwON3Gy18Vo,SpATywNh6bZuzm8s1ceuBUnMUAeoAHHw,7,4,3,0,3,0,4,0,14,2.0,2,0.0,0,3,0,3,4,0,0,4,0,6,8,1
10003,89368,Hut1tgueSKPspzugaIR7MA7bHeQEJ3sN,SpATywNh6bZuzm8s1ceuBUnMUAeoAHHw,11,7,5,0,3,2,5,1,23,3.2857142857142856,1,0.0,0,5,0,3,7,2,0,5,1,8,15,1
10004,89374,WJOBtEN6MBmL5RAy18uZScmCw5QHqH7o,bWdj2GDclj5ofokWjzoa5jAwMkxCykd6,7,9,5,32,1,0,2,0,49,7.0,1,0.0,1,5,31,1,8,0,1,2,0,38,11,1
10005,89376,x7a8xZCwJM4RqKXg6G5neepAYFOs6m5d,SpATywNh6bZuzm8s1ceuBUnMUAeoAHHw,7,3,1,0,1,1,4,1,11,1.5714285714285714,1,0.0,0,1,0,1,3,1,0,4,1,2,9,1
10006,89378,z8zMi50azvRwAPUNW2f5Gt0F6WOr8PI9,SpATywNh6bZuzm8s1ceuBUnMUAeoAHHw,7,6,2,0,1,0,2,0,11,1.5714285714285714,2,0.0,0,2,0,1,6,0,0,2,0,3,8,1
10007,89382,tEjzvvLPWnUBzeg9eUEbSbUDxKXRjQIx,SpATywNh6bZuzm8s1ceuBUnMUAeoAHHw,8,6,1,0,1,3,4,1,16,2.2857142857142856,1,0.0,0,1,0,1,6,3,0,4,1,2,14,1
10008,89384,IE6kqz4SgQ2K5IXq1ddIKWqjAvkWjxXn,SpATywNh6bZuzm8s1ceuBUnMUAeoAHHw,3,0,0,0,0,1,3,0,4,0.5714285714285714,1,0.0,0,0,0,0,0,1,0,3,0,0,4,1
10009,89389,YcgF3ndOhv1gz5wV43GDFwEO3v9Db2WY,SpATywNh6bZuzm8s1ceuBUnMUAeoAHHw,1,0,0,0,0,0,1,0,1,0.14285714285714285,1,0.0,0,0,0,0,0,0,0,1,0,0,1,1
10010,89392,zHLtAdps4GmYQ36wgo6nLPWMewImtEPP,SpATywNh6bZuzm8s1ceuBUnMUAeoAHHw,5,3,1,0,1,0,2,0,7,1.0,1,0.0,0,1,0,1,3,0,0,2,0,2,5,1
10011,89396,6xizGBxRpzCQSAXaR3hwOv1SoAXsZCKh,SpATywNh6bZuzm8s1ceuBUnMUAeoAHHw,7,1,1,0,1,0,7,1,11,1.5714285714285714,1,0.0,0,1,0,1,1,0,0,7,1,2,9,1
10012,89400,21PiP1YhF59KyQpWQkFYKWspSiSWfrA7,SpATywNh6bZuzm8s1ceuBUnMUAeoAHHw,4,2,0,0,0,0,2,0,4,0.5714285714285714,1,0.0,0,0,0,0,2,0,0,2,0,0,4,1
10013,89402,HG2LtxlWFsBhMuK56mWZ91TjbhMLoylz,SpATywNh6bZuzm8s1ceuBUnMUAeoAHHw,12,18,4,15,3,0,2,0,42,6.0,1,0.0,13,4,12,3,5,0,3,2,0,32,10,0
10014,89409,4OTqFMCZxx7r7u5a2qYtSI5NaNF7PvO8,SpATywNh6bZuzm8s1ceuBUnMUAeoAHHw,16,17,5,14,3,3,6,1,49,7.0,2,0.0,8,5,14,3,9,3,0,6,1,30,19,1
10015,89416,X8YK3vveOwnCTAS3rpB58DG3aostwJaj,SpATywNh6bZuzm8s1ceuBUnMUAeoAHHw,5,2,1,0,1,0,2,0,6,0.8571428571428571,1,0.0,0,1,0,1,2,0,0,2,0,2,4,1
10016,89419,s6NTLcoRryN4aDfvO1qsCQXhze6kEfOl,RXDvfPUBYFlVdlueBFbLW0mhhAyGEqpt,5,0,0,0,0,1,4,2,7,1.0,1,0.0,0,0,0,0,0,1,0,4,2,0,7,1
10017,89422,YjEaFn5LTfYqjxB6JXUvw4Xb9oLhK631,SpATywNh6bZuzm8s1ceuBUnMUAeoAHHw,1,0,0,0,0,0,1,0,1,0.14285714285714285,1,0.0,0,0,0,0,0,0,0,1,0,0,1,1
10018,89427,tMCbE9iM7KBcWjBabYSS51NRc5mnYleA,SpATywNh6bZuzm8s1ceuBUnMUAeoAHHw,4,3,1,0,1,0,1,0,6,0.8571428571428571,1,0.0,0,1,0,1,3,0,0,1,0,2,4,1
10019,89428,7rCsWwNSyvtkrQ3mC6RRhvkE6QVhgAZs,bWdj2GDclj5ofokWjzoa5jAwMkxCykd6,2,0,0,0,0,0,2,0,2,0.2857142857142857,1,0.0,0,0,0,0,0,0,0,2,0,0,2,1
10020,89429,2lYbk0XOrmGdaeqlfLI5dUfAHuZ6yPBA,SpATywNh6bZuzm8s1ceuBUnMUAeoAHHw,2,0,0,0,0,0,2,0,2,0.2857142857142857,1,0.0,0,0,0,0,0,0,0,2,0,0,2,1
10021,89431,nYSFDE8RCbcZhD46fRSvPHUvA1ahfupi,RXDvfPUBYFlVdlueBFbLW0mhhAyGEqpt,16,17,6,0,4,2,4,0,33,4.714285714285714,2,0.0,0,6,0,4,17,2,0,4,0,10,23,1
10022,89434,w60ThqGBllezQkIxCXQKmVVjrEAbCB3o,SpATywNh6bZuzm8s1ceuBUnMUAeoAHHw,13,12,8,0,4,1,11,1,37,5.285714285714286,1,0.0,1,8,0,4,11,1,0,11,1,13,24,1
10023,89435,mXql2iQ0u9MrfhDk3EyQfVgmOA6PfBP6,SpATywNh6bZuzm8s1ceuBUnMUAeoAHHw,9,5,4,0,3,0,3,1,16,2.2857142857142856,1,0.0,0,4,0,3,5,0,0,3,1,7,9,1
10024,89437,JaihKxZ9pTOfses6LZRLDOjCYawYvRFT,SpATywNh6bZuzm8s1ceuBUnMUAeoAHHw,15,14,2,6,1,1,6,1,31,4.428571428571429,1,0.0,6,2,6,1,8,1,0,6,1,15,16,1
10025,89438,KogrHROquIJLSXIZqzhYU9Hcb9zVebwT,bWdj2GDclj5ofokWjzoa5jAwMkxCykd6,12,15,8,38,2,7,8,1,79,11.285714285714286,1,0.0,1,8,37,2,14,7,1,8,1,48,31,1
10026,89439,GmpxJ8O1By2XxJiRtr729hGN3Vo5Le6z,SpATywNh6bZuzm8s1ceuBUnMUAeoAHHw,7,3,0,0,0,0,5,1,9,1.2857142857142858,1,0.0,1,0,0,0,2,0,0,5,1,1,8,1
10027,89445,QB10zfXuA41QjD5k4oKWFSxMld8hOlzr,SpATywNh6bZuzm8s1ceuBUnMUAeoAHHw,5,10,1,0,1,0,1,0,13,1.8571428571428572,1,0.0,0,1,0,1,10,0,0,1,0,2,11,1
10028,89447,reyLh94O0G9Sps1AWVf0MNOYDY3UabsF,bWdj2GDclj5ofokWjzoa5jAwMkxCykd6,1,0,0,0,0,0,1,0,1,0.14285714285714285,1,0.0,0,0,0,0,0,0,0,1,0,0,1,1
10029,89464,k7IDe0FSSJNcEAsxSZDCYYdSJ9TEDema,SpATywNh6bZuzm8s1ceuBUnMUAeoAHHw,5,2,1,0,1,0,2,0,6,0.8571428571428571,1,0.0,0,1,0,1,2,0,0,2,0,2,4,1
10030,89470,vEKYOhRdGZ59kfXY6wTO63YZY4EqPYqX,RXDvfPUBYFlVdlueBFbLW0mhhAyGEqpt,8,4,3,0,2,0,2,0,11,1.5714285714285714,1,0.0,0,3,0,2,4,0,0,2,0,5,6,1
10031,89472,hA0qeCFHNAYT25Zfkgax8xO422WWYXAI,SpATywNh6bZuzm8s1ceuBUnMUAeoAHHw,9,7,0,0,0,6,5,0,18,2.5714285714285716,1,0.0,1,0,0,0,6,6,0,5,0,1,17,1
10032,89481,KUppVPuFnFs0vLCUrPJOIfquMy1mUooq,SpATywNh6bZuzm8s1ceuBUnMUAeoAHHw,3,2,1,0,0,0,1,0,4,0.5714285714285714,1,0.0,0,1,0,0,2,0,0,1,0,1,3,1
10033,89484,tWsedvadboRaUvtnR4XHAbkrBvCaHSP7,SpATywNh6bZuzm8s1ceuBUnMUAeoAHHw,5,2,1,0,1,0,2,0,6,0.8571428571428571,1,0.0,0,1,0,1,2,0,0,2,0,2,4,1
10034,89486,ALqQPup1pnpnyRPY8Wn9arGTMiZcUqbO,SpATywNh6bZuzm8s1ceuBUnMUAeoAHHw,12,7,0,3,0,2,6,0,18,2.5714285714285716,1,0.0,2,0,3,0,5,2,0,6,0,5,13,1
10035,89487,C4jo9SMfYZ7U2XGeGdDn52kX4eeoqM99,bWdj2GDclj5ofokWjzoa5jAwMkxCykd6,13,17,0,36,0,1,7,0,61,8.714285714285714,3,0.0,4,0,30,0,13,1,6,7,0,34,27,1
10036,89493,KMupQNOY5AUo1OSHinupraqdnIAkZaUk,SpATywNh6bZuzm8s1ceuBUnMUAeoAHHw,11,8,5,0,3,2,3,0,21,3.0,1,0.0,2,5,0,3,6,2,0,3,0,10,11,0
10037,89496,9HuS6eeLBJKMWQs5fuvJufNrciBPiV4Z,SpATywNh6bZuzm8s1ceuBUnMUAeoAHHw,14,16,9,4,5,0,6,3,43,6.142857142857143,2,0.0,1,9,4,5,15,0,0,6,3,19,24,1
10038,89497,DoqTCfzI1BFXttxyeA3RWI5TOmYLp0hg,SpATywNh6bZuzm8s1ceuBUnMUAeoAHHw,6,5,0,0,0,1,6,1,13,1.8571428571428572,2,0.0,0,0,0,0,5,1,0,6,1,0,13,1
10039,89501,iIVb1PSNqRo7ycAAOFHU9Md1pZ0vCsoL,RXDvfPUBYFlVdlueBFbLW0mhhAyGEqpt,10,7,4,0,2,8,6,1,28,4.0,2,0.0,0,4,0,2,7,8,0,6,1,6,22,1
10040,89502,mR9Awu9GGhq6cpZDsN1vhsOMBBjHJTwu,SpATywNh6bZuzm8s1ceuBUnMUAeoAHHw,2,0,0,0,0,0,2,0,2,0.2857142857142857,1,0.0,0,0,0,0,0,0,0,2,0,0,2,1
10041,89504,g8m22R7W0Wo8v9RXY0TMbj5qf5RFgvht,SpATywNh6bZuzm8s1ceuBUnMUAeoAHHw,7,12,9,0,5,0,5,0,31,4.428571428571429,3,0.0,0,9,0,5,12,0,0,5,0,14,17,1
10042,89508,IK3hKesiTuTek37MSwSLzKRB4SC1WHUB,RXDvfPUBYFlVdlueBFbLW0mhhAyGEqpt,8,2,2,0,2,12,6,0,24,3.4285714285714284,1,0.0,0,2,0,2,2,12,0,6,0,4,20,1
10043,89510,HlbAiahvOwKnLbpNJlRLXObPS8VUYp1d,SpATywNh6bZuzm8s1ceuBUnMUAeoAHHw,4,4,2,0,2,0,2,0,10,1.4285714285714286,1,0.0,0,2,0,2,4,0,0,2,0,4,6,1
10044,89523,uufMRz1rjLB5PHuvCFtrRWUteDYIyLB4,SpATywNh6bZuzm8s1ceuBUnMUAeoAHHw,7,10,4,0,4,0,8,0,26,3.7142857142857144,5,0.0,1,4,0,4,9,0,0,8,0,9,17,1
10045,89528,UUMX1CmSolRdRWNSlMStbZ6MtOKuPj1e,bWdj2GDclj5ofokWjzoa5jAwMkxCykd6,6,4,1,0,1,0,4,0,10,1.4285714285714286,2,0.0,0,1,0,1,4,0,0,4,0,2,8,0
10046,89530,wIoFAWs9LgckZlTBThLS4htxmELqPsaS,SpATywNh6bZuzm8s1ceuBUnMUAeoAHHw,2,0,0,0,0,0,2,0,2,0.2857142857142857,1,0.0,0,0,0,0,0,0,0,2,0,0,2,1
10047,89537,KMupQNOY5AUo1OSHinupraqdnIAkZaUk,bWdj2GDclj5ofokWjzoa5jAwMkxCykd6,5,2,1,0,1,2,2,0,8,1.1428571428571428,1,0.0,0,1,0,1,2,2,0,2,0,2,6,1
10048,89545,gbYUHxxKDGWDbytDUcXlcbADJemufrHf,bWdj2GDclj5ofokWjzoa5jAwMkxCykd6,1,0,0,0,0,0,1,0,1,0.14285714285714285,1,0.0,0,0,0,0,0,0,0,1,0,0,1,1
10049,89547,yiyWtvIUUgzCTrQ1w4vh6W1sUUxvDdmd,G8EPVSXsOYB5YQWZGiz1aVq5Pgr2GrQu,19,33,11,6,7,0,8,1,66,9.428571428571429,3,0.0,9,11,3,7,24,0,3,8,1,30,36,1
10050,89554,ywVRX55s8qrIIZjyxsYaBHsGW40qS7zt,SpATywNh6bZuzm8s1ceuBUnMUAeoAHHw,8,5,2,5,1,0,2,0,15,2.142857142857143,1,0.0,1,2,4,1,4,0,1,2,0,8,7,1
10051,89558,s4xNNQ4RZ35amMfmvZawsu7u8CabnIey,bWdj2GDclj5ofokWjzoa5jAwMkxCykd6,13,14,8,0,7,1,8,1,39,5.571428571428571,1,0.0,2,8,0,7,12,1,0,8,1,17,22,1
10052,89559,0wpgF8T87E4lIPjqoh0AkxyomANfbalw,bWdj2GDclj5ofokWjzoa5jAwMkxCykd6,6,4,2,0,2,0,1,0,9,1.2857142857142858,1,0.0,1,2,0,2,3,0,0,1,0,5,4,1
10053,89564,CywE8FKIbY3F3QxzorcpvAYCApeOH4J5,SpATywNh6bZuzm8s1ceuBUnMUAeoAHHw,18,36,18,26,8,6,11,1,106,15.142857142857142,4,0.0,8,18,20,8,28,6,6,11,1,54,52,1
10054,89573,EJIkk1z1GAyTxouBU8smmsjhIBwzBhn1,bWdj2GDclj5ofokWjzoa5jAwMkxCykd6,5,2,0,0,0,1,6,0,9,1.2857142857142858,1,0.0,0,0,0,0,2,1,0,6,0,0,9,1
10055,89582,IVRKzAf1gWN5ButpaPiczzsxf6iD5MK8,SpATywNh6bZuzm8s1ceuBUnMUAeoAHHw,44,58,33,26,17,4,23,0,161,23.0,6,0.0,14,33,25,17,44,4,1,23,0,89,72,0
10056,89585,YyGQMZcaxlC6XILTwFAL9ZoWRvDQm7bN,SpATywNh6bZuzm8s1ceuBUnMUAeoAHHw,15,8,4,17,3,111,7,1,151,21.571428571428573,1,0.0,3,4,14,3,5,111,3,7,1,24,127,1
10057,89586,Ici19IlriqXgCDQhlI7Y7CIAQZwpQKlL,SpATywNh6bZuzm8s1ceuBUnMUAeoAHHw,6,2,1,0,1,0,3,0,7,1.0,1,0.0,0,1,0,1,2,0,0,3,0,2,5,1
10058,89594,8lejIyIXg2PoIErIyQIUo4voWGcEGVK1,SpATywNh6bZuzm8s1ceuBUnMUAeoAHHw,14,25,9,19,3,1,3,0,60,8.571428571428571,1,0.0,6,9,16,3,19,1,3,3,0,34,26,1
10059,89596,xfVSAJmUsFwMX0mM4lQFC1xlBJimN3Sw,SpATywNh6bZuzm8s1ceuBUnMUAeoAHHw,1,0,0,0,0,0,1,0,1,0.14285714285714285,1,0.0,0,0,0,0,0,0,0,1,0,0,1,1
10060,89600,JV9PrSM2vjuxfGaaWBES6jKK96YmYbtj,SpATywNh6bZuzm8s1ceuBUnMUAeoAHHw,13,11,4,16,3,1,2,0,37,5.285714285714286,1,0.0,6,4,16,3,5,1,0,2,0,29,8,1
10061,89605,f3LgSSewSBsudoWmIigH2aapqGCxH8CK,SpATywNh6bZuzm8s1ceuBUnMUAeoAHHw,11,11,4,8,1,0,7,0,31,4.428571428571429,5,0.0,1,4,7,1,10,0,1,7,0,13,18,0
10062,89606,QUiyBd2SaZz1OhTujJnVJUzpOWStKB8O,SpATywNh6bZuzm8s1ceuBUnMUAeoAHHw,11,14,7,0,2,2,10,0,35,5.0,2,0.0,3,7,0,2,11,2,0,10,0,12,23,1
10063,89611,oD0FQQV2wqYt3501tltDa6pobGqWwl0U,SpATywNh6bZuzm8s1ceuBUnMUAeoAHHw,2,0,0,0,0,0,2,0,2,0.2857142857142857,1,0.0,0,0,0,0,0,0,0,2,0,0,2,1
10064,89613,TrrLeSGbjOK3szupk5Bxq1KXuDNAsaBR,RXDvfPUBYFlVdlueBFbLW0mhhAyGEqpt,4,0,0,0,0,4,5,0,9,1.2857142857142858,1,0.0,0,0,0,0,0,4,0,5,0,0,9,1
10065,89614,v2d7e1ThXhvKY81XABSzKd6OtFeJV4cC,bWdj2GDclj5ofokWjzoa5jAwMkxCykd6,16,23,8,44,6,0,5,0,86,12.285714285714286,2,0.0,10,8,38,6,13,0,6,5,0,62,24,1
10066,89615,0Dihh52qSGvY4VErU5EvQUZatVGQEN7V,G8EPVSXsOYB5YQWZGiz1aVq5Pgr2GrQu,2,0,0,0,0,0,2,0,2,0.2857142857142857,1,0.0,0,0,0,0,0,0,0,2,0,0,2,1
10067,89629,yd5TT5oOy4dFZZMQ0jlppRbBYPk2zugf,RXDvfPUBYFlVdlueBFbLW0mhhAyGEqpt,34,40,26,34,12,29,15,4,160,22.857142857142858,3,0.0,6,26,31,12,34,29,3,15,4,75,85,1
10068,89632,fGUxtqzvs60cjlG1FT6OPrGFHTQ3arMq,SpATywNh6bZuzm8s1ceuBUnMUAeoAHHw,9,9,4,0,2,0,3,0,18,2.5714285714285716,2,0.0,0,4,0,2,9,0,0,3,0,6,12,1
10069,89633,NecHXZoXWlSlvFR2HUgkuO9YtJstZDyP,SpATywNh6bZuzm8s1ceuBUnMUAeoAHHw,2,0,0,0,0,0,3,0,3,0.42857142857142855,1,0.0,0,0,0,0,0,0,0,3,0,0,3,1
10070,89635,q0VUQjNPG110NUbSYiiAeb8QmfsAGRIl,bWdj2GDclj5ofokWjzoa5jAwMkxCykd6,2,0,0,0,0,0,2,0,2,0.2857142857142857,1,0.0,0,0,0,0,0,0,0,2,0,0,2,1
10071,89637,9FULiZu6qUnuIs2MyDSoVO8NHl3dw8Ao,SpATywNh6bZuzm8s1ceuBUnMUAeoAHHw,27,53,6,26,2,16,17,3,123,17.571428571428573,5,0.0,10,6,26,2,43,16,0,17,3,44,79,1
10072,89639,NecHXZoXWlSlvFR2HUgkuO9YtJstZDyP,G8EPVSXsOYB5YQWZGiz1aVq5Pgr2GrQu,1,0,0,0,0,0,1,0,1,0.14285714285714285,1,0.0,0,0,0,0,0,0,0,1,0,0,1,1
10073,89640,4rTxfdVJbNfbAtIV373iaao2aWX8Xwpx,bWdj2GDclj5ofokWjzoa5jAwMkxCykd6,11,16,4,0,3,1,10,1,35,5.0,1,0.0,2,4,0,3,14,1,0,10,1,9,26,1
10074,89642,tZzxdl7066iNcnLGeU4cT9rDUqFLgEBx,SpATywNh6bZuzm8s1ceuBUnMUAeoAHHw,5,2,1,0,1,0,2,0,6,0.8571428571428571,1,0.0,0,1,0,1,2,0,0,2,0,2,4,0
10075,89646,JEelEWgHt6PkTjt88tREqKMfbXr9CA9f,SpATywNh6bZuzm8s1ceuBUnMUAeoAHHw,5,3,1,0,1,0,2,0,7,1.0,1,0.0,0,1,0,1,3,0,0,2,0,2,5,1
10076,89648,et0FwkFflO62QJKGJwzwDqACodcSRV2v,SpATywNh6bZuzm8s1ceuBUnMUAeoAHHw,15,42,18,7,10,0,6,0,83,11.857142857142858,3,0.0,11,18,7,10,31,0,0,6,0,46,37,1
10077,89651,4qM7n65VbCTp8lq3dbzhDmImmEZcwgn8,bWdj2GDclj5ofokWjzoa5jAwMkxCykd6,7,8,3,0,2,0,3,0,16,2.2857142857142856,3,0.0,0,3,0,2,8,0,0,3,0,5,11,1
10078,89652,g8m22R7W0Wo8v9RXY0TMbj5qf5RFgvht,G8EPVSXsOYB5YQWZGiz1aVq5Pgr2GrQu,8,5,3,0,2,0,5,0,15,2.142857142857143,2,0.0,0,3,0,2,5,0,0,5,0,5,10,1
10079,89654,q0VUQjNPG110NUbSYiiAeb8QmfsAGRIl,SpATywNh6bZuzm8s1ceuBUnMUAeoAHHw,5,2,1,0,1,0,2,0,6,0.8571428571428571,1,0.0,0,1,0,1,2,0,0,2,0,2,4,1
10080,89657,d1q0By7DZyiPLgwuG8hyGXtu0NW1hfAc,SpATywNh6bZuzm8s1ceuBUnMUAeoAHHw,8,12,6,0,3,0,4,0,25,3.5714285714285716,2,0.0,0,6,0,3,12,0,0,4,0,9,16,1
10081,89660,gGywHgGU1Kdw7XJcqMzinsJnpz7uSgex,SpATywNh6bZuzm8s1ceuBUnMUAeoAHHw,3,2,0,0,0,0,2,0,4,0.5714285714285714,1,0.0,0,0,0,0,2,0,0,2,0,0,4,1
10082,89663,7plKTmv3RnLOGLbgKBn60EIAr1uLnnPW,SpATywNh6bZuzm8s1ceuBUnMUAeoAHHw,2,0,0,0,0,0,3,0,3,0.42857142857142855,1,0.0,0,0,0,0,0,0,0,3,0,0,3,1
10083,89665,7plKTmv3RnLOGLbgKBn60EIAr1uLnnPW,G8EPVSXsOYB5YQWZGiz1aVq5Pgr2GrQu,2,0,0,0,0,0,7,0,7,1.0,1,0.0,0,0,0,0,0,0,0,7,0,0,7,1
10084,89667,4ZJIc9fpxQVSj3UgQJHtkAvW8OVkOdgO,SpATywNh6bZuzm8s1ceuBUnMUAeoAHHw,1,0,0,0,0,0,1,0,1,0.14285714285714285,1,0.0,0,0,0,0,0,0,0,1,0,0,1,1
10085,89669,tmmvczbZLiPw6t5Ru9DTWRYnvMI3hKxN,G8EPVSXsOYB5YQWZGiz1aVq5Pgr2GrQu,8,8,5,0,3,0,4,0,20,2.857142857142857,2,0.0,0,5,0,3,8,0,0,4,0,8,12,1
10086,89672,Sqgk0iqdEQnGHvbbLSikGrUMP9U33RaR,SpATywNh6bZuzm8s1ceuBUnMUAeoAHHw,1,0,0,0,0,0,1,0,1,0.14285714285714285,1,0.0,0,0,0,0,0,0,0,1,0,0,1,1
10087,89682,VCrlTy1l4SI8aDl63osChvBColRWsjDv,bWdj2GDclj5ofokWjzoa5jAwMkxCykd6,4,2,1,0,1,6,2,0,12,1.7142857142857142,1,0.0,0,1,0,1,2,6,0,2,0,2,10,1
10088,89685,hAdLjCwSiW0mQdl44dFfRTVxdDqDmjKC,SpATywNh6bZuzm8s1ceuBUnMUAeoAHHw,7,4,3,0,1,0,2,0,10,1.4285714285714286,1,0.0,0,3,0,1,4,0,0,2,0,4,6,1
10089,89691,iADIVtxyoQg4RtIKmWkz3YbJ1msvN2b8,G8EPVSXsOYB5YQWZGiz1aVq5Pgr2GrQu,28,26,14,38,9,0,3,0,90,12.857142857142858,1,0.0,8,14,38,9,18,0,0,3,0,69,21,1
10090,89697,i4fgy4BVHlpEBMVrUkI9gWLihOonqgFN,SpATywNh6bZuzm8s1ceuBUnMUAeoAHHw,8,9,5,0,2,0,6,0,22,3.142857142857143,2,0.0,0,5,0,2,9,0,0,6,0,7,15,1
10091,89700,5c8lpFjwt7A1RG96ZJudxhytTaQ1Rdi3,SpATywNh6bZuzm8s1ceuBUnMUAeoAHHw,9,4,3,0,2,0,4,0,13,1.8571428571428572,2,0.0,0,3,0,2,4,0,0,4,0,5,8,1
10092,89704,EFvdBUP19hneCSDaGOnsFiBemnNxo1wC,SpATywNh6bZuzm8s1ceuBUnMUAeoAHHw,5,2,0,0,0,3,4,0,9,1.2857142857142858,1,0.0,0,0,0,0,2,3,0,4,0,0,9,1
10093,89716,34wvjhwjZXp59iVLK73uLxzWNB5SDXqZ,SpATywNh6bZuzm8s1ceuBUnMUAeoAHHw,1,0,0,0,0,0,1,0,1,0.14285714285714285,1,0.0,0,0,0,0,0,0,0,1,0,0,1,1
10094,89718,gJUEUQ7J006sORAArhI6J8FkT7xUEHkB,SpATywNh6bZuzm8s1ceuBUnMUAeoAHHw,35,53,14,46,5,7,11,1,137,19.571428571428573,6,0.0,12,14,41,5,41,7,5,11,1,72,65,1
10095,89721,Y1k7olzlKnbC2gLcfIeH2MYAVraORisd,SpATywNh6bZuzm8s1ceuBUnMUAeoAHHw,7,3,2,0,2,0,2,0,9,1.2857142857142858,1,0.0,0,2,0,2,3,0,0,2,0,4,5,1
10096,89727,8yrIKDtnkYcLfERwrXrvcRGxHxbt2Jd3,bWdj2GDclj5ofokWjzoa5jAwMkxCykd6,5,5,2,0,1,0,4,0,12,1.7142857142857142,1,0.0,0,2,0,1,5,0,0,4,0,3,9,1
10097,89728,XzytXRsbdOwF87AfAw5uPYzo1dbeIXdh,SpATywNh6bZuzm8s1ceuBUnMUAeoAHHw,11,10,8,0,2,1,6,1,28,4.0,1,0.0,0,8,0,2,10,1,0,6,1,10,18,1
10098,89730,lVnMpRF2pBRLkh9CfasNC1eZi18lrTad,G8EPVSXsOYB5YQWZGiz1aVq5Pgr2GrQu,7,4,3,0,3,0,2,0,12,1.7142857142857142,1,0.0,0,3,0,3,4,0,0,2,0,6,6,1
10099,89735,DBl87nF6WTgoCD6kgTHVE2oB45pDEn6y,RXDvfPUBYFlVdlueBFbLW0mhhAyGEqpt,10,8,4,0,2,0,2,0,16,2.2857142857142856,1,0.0,0,4,0,2,8,0,0,2,0,6,10,1
10100,89736,bRDMid9iRGcartTY4OAKAdQRbX2j8Y86,SpATywNh6bZuzm8s1ceuBUnMUAeoAHHw,5,2,1,0,1,0,2,0,6,0.8571428571428571,1,0.0,0,1,0,1,2,0,0,2,0,2,4,1
10101,89737,Fa7tOqP1WKllvNDMgvUWmTzPr8J8vhy8,bWdj2GDclj5ofokWjzoa5jAwMkxCykd6,4,2,1,0,0,0,3,0,6,0.8571428571428571,1,0.0,0,1,0,0,2,0,0,3,0,1,5,1
10102,89741,4TxI4qNPs1w5xlNJ8vKBNEb6bFI5MoVU,SpATywNh6bZuzm8s1ceuBUnMUAeoAHHw,3,2,0,0,0,0,1,0,3,0.42857142857142855,1,0.0,0,0,0,0,2,0,0,1,0,0,3,1
10103,89750,wpQN3hnHZvt8MtT7VRAs9ZQvlWkphaGS,SpATywNh6bZuzm8s1ceuBUnMUAeoAHHw,7,3,2,0,2,0,2,0,9,1.2857142857142858,1,0.0,0,2,0,2,3,0,0,2,0,4,5,1
10104,89752,bRDMid9iRGcartTY4OAKAdQRbX2j8Y86,G8EPVSXsOYB5YQWZGiz1aVq5Pgr2GrQu,2,0,0,0,0,0,3,0,3,0.42857142857142855,2,0.0,0,0,0,0,0,0,0,3,0,0,3,1
10105,89753,k3RqfBgQWTtiyEyw3fqGDGa48Oo6Lcuo,SpATywNh6bZuzm8s1ceuBUnMUAeoAHHw,2,0,0,0,0,0,3,0,3,0.42857142857142855,1,0.0,0,0,0,0,0,0,0,3,0,0,3,1
10106,89764,Ur5YqRaNsaD6KYfRfGA2p4Zmd8kpRITc,SpATywNh6bZuzm8s1ceuBUnMUAeoAHHw,41,56,29,24,12,12,15,0,148,21.142857142857142,8,0.0,16,29,24,12,40,12,0,15,0,81,67,0
10107,89766,36BAYEapI76Mtxquz6BRxAoc9Y27dWFZ,G8EPVSXsOYB5YQWZGiz1aVq5Pgr2GrQu,10,20,4,0,5,0,2,0,31,4.428571428571429,1,0.0,11,4,0,5,9,0,0,2,0,20,11,1
10108,89767,4geFTA2SGlVqwe93iNEDI1Zg55VMGaYi,SpATywNh6bZuzm8s1ceuBUnMUAeoAHHw,9,15,7,0,2,1,6,0,31,4.428571428571429,1,0.0,1,7,0,2,14,1,0,6,0,10,21,1
10109,89788,jH123vWnpYTVLfmuSyled9Oau0AYvcx6,SpATywNh6bZuzm8s1ceuBUnMUAeoAHHw,14,12,1,18,0,4,6,1,42,6.0,1,0.0,4,1,14,0,8,4,4,6,1,19,23,1
10110,89792,TvO9et6FKUYNWGTC0Lu8cSO0dysynadE,SpATywNh6bZuzm8s1ceuBUnMUAeoAHHw,13,21,1,18,0,2,10,0,52,7.428571428571429,1,0.0,6,1,15,0,15,2,3,10,0,22,30,1
10111,89796,TNaXEhaNWX9mct0CT7Pun5pZ6GW6ngCc,SpATywNh6bZuzm8s1ceuBUnMUAeoAHHw,1,0,0,0,0,0,1,0,1,0.14285714285714285,1,0.0,0,0,0,0,0,0,0,1,0,0,1,1
10112,89799,eaeORohb7wCQL9JM2uz3yah8DgLbswAx,SpATywNh6bZuzm8s1ceuBUnMUAeoAHHw,7,3,2,0,2,25,3,0,35,5.0,1,0.0,0,2,0,2,3,25,0,3,0,4,31,1
10113,89806,55eRUKhAgZ6jAG2QNlk8p8bxI8Mo1ci4,bWdj2GDclj5ofokWjzoa5jAwMkxCykd6,4,2,1,0,1,0,1,0,5,0.7142857142857143,1,0.0,0,1,0,1,2,0,0,1,0,2,3,1
10114,89810,ZGj94V0W2CVzOroBBKkby4OcuobYFXw5,SpATywNh6bZuzm8s1ceuBUnMUAeoAHHw,1,0,0,0,0,0,1,0,1,0.14285714285714285,1,0.0,0,0,0,0,0,0,0,1,0,0,1,1
10115,89814,HOOY7gv2DgQRhkoQeNGOHVNWen0BTC1i,SpATywNh6bZuzm8s1ceuBUnMUAeoAHHw,1,0,0,0,0,0,1,0,1,0.14285714285714285,1,0.0,0,0,0,0,0,0,0,1,0,0,1,1
10116,89816,KDx4Tzovot56yH25Hp8Dvz0vvUPU9kNc,RXDvfPUBYFlVdlueBFbLW0mhhAyGEqpt,13,8,0,0,0,3,7,1,19,2.7142857142857144,1,0.0,0,0,0,0,8,3,0,7,1,0,19,1
10117,89818,UD9YcWI16E6My1ERXiW1sP1n2okAaM6v,bWdj2GDclj5ofokWjzoa5jAwMkxCykd6,1,0,0,0,0,0,1,0,1,0.14285714285714285,1,0.0,0,0,0,0,0,0,0,1,0,0,1,1
10118,89822,9aAr0eFSVkxwTSV4wzEfwp33zeuW9SSs,bWdj2GDclj5ofokWjzoa5jAwMkxCykd6,17,20,5,44,4,0,5,0,78,11.142857142857142,2,0.0,4,5,42,4,16,0,2,5,0,55,23,1
10119,89824,JXDuo0HNKJSjtiXj27sPUY7beWRK43na,SpATywNh6bZuzm8s1ceuBUnMUAeoAHHw,9,3,1,0,2,1,11,2,20,2.857142857142857,1,0.0,0,1,0,2,3,1,0,11,2,3,17,1
10120,89829,sfmDw8Mu24TwJAISRGKb3tkGixPCex4a,SpATywNh6bZuzm8s1ceuBUnMUAeoAHHw,17,40,16,12,7,18,14,1,108,15.428571428571429,3,0.0,6,16,9,7,34,18,3,14,1,38,70,1
10121,89838,ZV56LNPqAGNtVEuE1uQTYk5rPuhQg5k4,bWdj2GDclj5ofokWjzoa5jAwMkxCykd6,2,0,0,0,0,0,3,0,3,0.42857142857142855,1,0.0,0,0,0,0,0,0,0,3,0,0,3,1
10122,89844,ijg95u2jQVjnyTNM7ClS8Oj92hwAA9nz,SpATywNh6bZuzm8s1ceuBUnMUAeoAHHw,8,2,1,0,1,0,5,1,10,1.4285714285714286,1,0.0,0,1,0,1,2,0,0,5,1,2,8,1
10123,89845,yirkVFAFnnxTIzPISxnqlF6vNcZ5Qb6v,SpATywNh6bZuzm8s1ceuBUnMUAeoAHHw,4,2,1,0,0,0,2,0,5,0.7142857142857143,1,0.0,0,1,0,0,2,0,0,2,0,1,4,1
10124,89865,3z5ETakafkt4JzUHVZc8EGa6ySJrNrZy,SpATywNh6bZuzm8s1ceuBUnMUAeoAHHw,5,2,1,0,1,0,2,0,6,0.8571428571428571,1,0.0,0,1,0,1,2,0,0,2,0,2,4,1
10125,89889,esqI93l6FZECayExObEEu4vBjC7wOeKE,SpATywNh6bZuzm8s1ceuBUnMUAeoAHHw,7,2,2,0,2,0,2,0,8,1.1428571428571428,1,0.0,0,2,0,2,2,0,0,2,0,4,4,1
10126,89890,IXH7oZyCKGgxdh9kwUS5VD9TLaoLggU5,SpATywNh6bZuzm8s1ceuBUnMUAeoAHHw,7,3,2,0,2,0,2,0,9,1.2857142857142858,1,0.0,0,2,0,2,3,0,0,2,0,4,5,1
10127,89893,HAAyQYNYY3ULmqhNC56bxv5FSwyMVoqP,SpATywNh6bZuzm8s1ceuBUnMUAeoAHHw,17,41,6,32,0,1,15,0,95,13.571428571428571,5,0.0,14,6,28,0,27,1,4,15,0,48,47,1
10128,89897,HAAyQYNYY3ULmqhNC56bxv5FSwyMVoqP,bWdj2GDclj5ofokWjzoa5jAwMkxCykd6,4,15,7,0,0,0,9,0,31,4.428571428571429,5,0.0,0,7,0,0,15,0,0,9,0,7,24,1
10129,89899,uI2C8kZvxXShkoacauA0S9izMW2oRB2R,RXDvfPUBYFlVdlueBFbLW0mhhAyGEqpt,71,49,28,154,15,10,13,1,270,38.57142857142857,4,0.0,14,28,144,15,35,10,10,13,1,201,69,1
10130,89901,YiHBZRMHXXOxz07e5dCrboCIm1oQ0OKy,RXDvfPUBYFlVdlueBFbLW0mhhAyGEqpt,16,17,12,0,6,7,10,0,52,7.428571428571429,1,0.0,0,12,0,6,17,7,0,10,0,18,34,1
10131,89906,mMv5ULasJWNphOEtfj5B5HTtZYfxsB3G,SpATywNh6bZuzm8s1ceuBUnMUAeoAHHw,2,0,0,0,0,0,2,0,2,0.2857142857142857,1,0.0,0,0,0,0,0,0,0,2,0,0,2,1
10132,89910,qngZFTemZ9VNe5bU9mST85frjoIJ7IAD,RXDvfPUBYFlVdlueBFbLW0mhhAyGEqpt,5,2,1,0,1,0,2,0,6,0.8571428571428571,1,0.0,0,1,0,1,2,0,0,2,0,2,4,1
10133,89913,zlNlEcmlViJgBUG0ywxJEPhI6SYvToC0,SpATywNh6bZuzm8s1ceuBUnMUAeoAHHw,1,0,0,0,0,0,1,0,1,0.14285714285714285,1,0.0,0,0,0,0,0,0,0,1,0,0,1,1
10134,89917,Jr0Xqt1ZmxzSzD15wla9BChmcIeBBK4Z,G8EPVSXsOYB5YQWZGiz1aVq5Pgr2GrQu,9,4,0,0,0,3,7,1,15,2.142857142857143,1,0.0,0,0,0,0,4,3,0,7,1,0,15,1
10135,89923,ysO1bg2EIYdeVFkxhwuOr9gves820gWk,RXDvfPUBYFlVdlueBFbLW0mhhAyGEqpt,6,4,1,0,0,0,3,1,9,1.2857142857142858,1,0.0,0,1,0,0,4,0,0,3,1,1,8,1
10136,89935,Cvsz0UZNQwRp1mBIzDah4d0DHCa0q2WK,SpATywNh6bZuzm8s1ceuBUnMUAeoAHHw,1,0,0,0,0,0,1,0,1,0.14285714285714285,1,0.0,0,0,0,0,0,0,0,1,0,0,1,1
10137,89937,Lb6PKJrTzwsQYsITlNu0wfDvL4DmKZCj,RXDvfPUBYFlVdlueBFbLW0mhhAyGEqpt,4,2,1,0,1,0,1,0,5,0.7142857142857143,1,0.0,0,1,0,1,2,0,0,1,0,2,3,1
10138,89948,TtmytGkYhNaL4UmbxQBMSixlcCRjb9lD,SpATywNh6bZuzm8s1ceuBUnMUAeoAHHw,7,8,1,0,0,6,5,0,20,2.857142857142857,1,0.0,0,1,0,0,8,6,0,5,0,1,19,1
10139,89956,myYQGnE7AuDkDAMs5wvSchGGtMiBR3qG,RXDvfPUBYFlVdlueBFbLW0mhhAyGEqpt,6,4,0,0,0,2,5,0,11,1.5714285714285714,1,0.0,0,0,0,0,4,2,0,5,0,0,11,0
10140,89957,0q9MKOQI6izUm7JGi2QEuKfgyApDxosK,SpATywNh6bZuzm8s1ceuBUnMUAeoAHHw,2,0,0,0,0,0,2,0,2,0.2857142857142857,1,0.0,0,0,0,0,0,0,0,2,0,0,2,1
10141,89967,db8Cy33Nc9oRQhsghT9mZ7YJUbZnnH0B,SpATywNh6bZuzm8s1ceuBUnMUAeoAHHw,5,2,1,0,1,0,2,0,6,0.8571428571428571,1,0.0,0,1,0,1,2,0,0,2,0,2,4,1
10142,89968,KjHvjBsSgp7lqvkYLAjrQHS8ZrdrlLzv,SpATywNh6bZuzm8s1ceuBUnMUAeoAHHw,11,9,7,7,5,1,2,0,31,4.428571428571429,1,0.0,1,7,6,5,8,1,1,2,0,19,12,1
10143,89969,frAGxLKbgrgCbr9YXoqzdmgtbJjUbBNJ,G8EPVSXsOYB5YQWZGiz1aVq5Pgr2GrQu,5,8,1,0,2,1,2,0,14,2.0,1,0.0,6,1,0,2,2,1,0,2,0,9,5,1
10144,89971,DpB3NoJLarAGiHUaBV6zvSP8bR0qw4yk,RXDvfPUBYFlVdlueBFbLW0mhhAyGEqpt,23,17,15,0,11,0,3,0,46,6.571428571428571,3,0.0,0,15,0,11,17,0,0,3,0,26,20,1
10145,89984,HCLrpFC2S5L0Y8JmZewW8gsgYgpEkXeP,SpATywNh6bZuzm8s1ceuBUnMUAeoAHHw,14,12,5,24,3,0,6,0,50,7.142857142857143,2,0.0,4,5,19,3,8,0,5,6,0,31,19,1
10146,89987,8QIwRllpGKgpURtcmS5hWJ0AInSKESf0,RXDvfPUBYFlVdlueBFbLW0mhhAyGEqpt,6,2,1,0,1,0,3,0,7,1.0,1,0.0,0,1,0,1,2,0,0,3,0,2,5,1
10147,89994,zvOHbaUWjxRZ9zCYxYPMcUH4Ef5dE8Ae,G8EPVSXsOYB5YQWZGiz1aVq5Pgr2GrQu,9,6,2,0,2,0,9,0,19,2.7142857142857144,3,0.0,0,2,0,2,6,0,0,9,0,4,15,1
10148,90000,xFi8956jLKPkTqTiwrHbFAm2iOTFidYP,SpATywNh6bZuzm8s1ceuBUnMUAeoAHHw,1,0,0,0,0,0,2,0,2,0.2857142857142857,1,0.0,0,0,0,0,0,0,0,2,0,0,2,1
10149,90008,aM04j8B80UycNpLiy2mFNdgBiaLCgDBx,SpATywNh6bZuzm8s1ceuBUnMUAeoAHHw,5,2,1,0,1,0,4,0,8,1.1428571428571428,1,0.0,0,1,0,1,2,0,0,4,0,2,6,1
10150,90011,KbVIZwe7S3MOh9dlFVWDZwSpf3zNL2tv,SpATywNh6bZuzm8s1ceuBUnMUAeoAHHw,5,4,2,0,1,0,1,0,8,1.1428571428571428,1,0.0,0,2,0,1,4,0,0,1,0,3,5,1
10151,90014,ZDrt6zlGm4y4ur5AWVSG62RV3VJJ5cJS,SpATywNh6bZuzm8s1ceuBUnMUAeoAHHw,6,3,2,0,1,7,3,0,16,2.2857142857142856,1,0.0,0,2,0,1,3,7,0,3,0,3,13,1
10152,90021,bjoQsxzy5xWbIlWJOK88FLxI1KzCehRN,SpATywNh6bZuzm8s1ceuBUnMUAeoAHHw,3,2,0,0,0,0,1,0,3,0.42857142857142855,1,0.0,0,0,0,0,2,0,0,1,0,0,3,1
10153,90023,OMrBHOtDkdk4Zxba42NamuOWH8Ss9fWW,bWdj2GDclj5ofokWjzoa5jAwMkxCykd6,2,0,0,0,0,0,2,0,2,0.2857142857142857,1,0.0,0,0,0,0,0,0,0,2,0,0,2,1
10154,90030,rQT5JCDNn9UQwRKU1wpR7NGmcTvEHfxS,bWdj2GDclj5ofokWjzoa5jAwMkxCykd6,5,2,1,0,1,0,5,0,9,1.2857142857142858,1,0.0,0,1,0,1,2,0,0,5,0,2,7,1
10155,90034,YCpaFH59BZea33ilZmurVIrcGKs7kkSW,SpATywNh6bZuzm8s1ceuBUnMUAeoAHHw,1,0,0,0,0,0,1,0,1,0.14285714285714285,1,0.0,0,0,0,0,0,0,0,1,0,0,1,1
10156,90041,JaLvdj0QPGLA6QlwJ3N2oF66NiYZ7XSV,bWdj2GDclj5ofokWjzoa5jAwMkxCykd6,39,70,38,86,17,114,24,5,354,50.57142857142857,6,0.0,7,38,71,17,63,114,15,24,5,133,221,0
10157,90047,b31D3oEzHUylsy39VKOzq1naz39PNLwH,G8EPVSXsOYB5YQWZGiz1aVq5Pgr2GrQu,41,58,25,54,8,3,23,1,172,24.571428571428573,3,0.0,21,25,34,8,37,3,20,23,1,88,84,1
10158,90052,ggntZRuHqDckUtFC9TYtfF8K09iXYWES,SpATywNh6bZuzm8s1ceuBUnMUAeoAHHw,5,3,0,0,0,0,6,0,9,1.2857142857142858,2,0.0,0,0,0,0,3,0,0,6,0,0,9,1
10159,90055,kGkU7DU5zOC0IQHNRlo6r0rouCnUfi6R,RXDvfPUBYFlVdlueBFbLW0mhhAyGEqpt,24,30,14,17,9,3,15,1,89,12.714285714285714,3,0.0,5,14,16,9,25,3,1,15,1,44,45,1
10160,90063,Vn131dD12fh0kapodbBhio0q4dV4IYmG,bWdj2GDclj5ofokWjzoa5jAwMkxCykd6,4,2,1,0,1,0,1,0,5,0.7142857142857143,1,0.0,0,1,0,1,2,0,0,1,0,2,3,1
10161,90067,6e1wovvtDhnhxwqREzmRRei4eIEEGraW,bWdj2GDclj5ofokWjzoa5jAwMkxCykd6,8,6,4,0,3,0,7,1,21,3.0,1,0.0,0,4,0,3,6,0,0,7,1,7,14,1
10162,90076,QhIEGvYTYkDhEyimLONTXmJHONpcq43g,SpATywNh6bZuzm8s1ceuBUnMUAeoAHHw,1,0,0,0,0,0,1,0,1,0.14285714285714285,1,0.0,0,0,0,0,0,0,0,1,0,0,1,1
10163,90085,JYzVKgw0yfgKYwKodhquOfGRUiHh1739,SpATywNh6bZuzm8s1ceuBUnMUAeoAHHw,4,2,0,0,0,0,2,0,4,0.5714285714285714,1,0.0,0,0,0,0,2,0,0,2,0,0,4,1
10164,90087,6Xt9XL14E8rzUiRHbQmDyc0T0uWOhD5k,SpATywNh6bZuzm8s1ceuBUnMUAeoAHHw,5,4,1,0,1,0,2,0,8,1.1428571428571428,1,0.0,0,1,0,1,4,0,0,2,0,2,6,1
10165,90088,lzm9dP9Q32i0nrdz5KGk9vngMJk6H38J,SpATywNh6bZuzm8s1ceuBUnMUAeoAHHw,7,9,3,0,2,0,5,0,19,2.7142857142857144,2,0.0,1,3,0,2,8,0,0,5,0,6,13,1
10166,90090,srF76iHf3IXwkM0p0daLjk1LYx1sO9QO,bWdj2GDclj5ofokWjzoa5jAwMkxCykd6,1,0,0,0,0,0,1,0,1,0.14285714285714285,1,0.0,0,0,0,0,0,0,0,1,0,0,1,1
10167,90094,TYu8VgV6TkJO1pWVABdfXnpa6VWQUK0O,RXDvfPUBYFlVdlueBFbLW0mhhAyGEqpt,20,13,9,27,5,0,3,0,57,8.142857142857142,2,0.0,2,9,27,5,11,0,0,3,0,43,14,1
10168,90097,ilWzYGLWBh9DSc1MV8g2C4Go5wDNgUHX,bWdj2GDclj5ofokWjzoa5jAwMkxCykd6,9,6,3,6,1,8,3,0,27,3.857142857142857,2,0.0,1,3,6,1,5,8,0,3,0,11,16,1
10169,90103,faywX8b5OPf8lgTBqNfgsgut6a2kmqN4,SpATywNh6bZuzm8s1ceuBUnMUAeoAHHw,6,3,2,0,2,0,1,0,8,1.1428571428571428,1,0.0,0,2,0,2,3,0,0,1,0,4,4,1
10170,90117,MjWnBfKyq3bKCwHG0ZVIL5hXZR3ku4f4,SpATywNh6bZuzm8s1ceuBUnMUAeoAHHw,12,8,5,0,3,0,8,1,25,3.5714285714285716,1,0.0,0,5,0,3,8,0,0,8,1,8,17,1
10171,90120,jDBqOswp4ojFI0uystVaz1714DhGWBFe,SpATywNh6bZuzm8s1ceuBUnMUAeoAHHw,6,4,3,0,2,0,2,2,13,1.8571428571428572,1,0.0,0,3,0,2,4,0,0,2,2,5,8,1
10172,90131,bTJkfLPF7pQ1o12jyPBjkkHpxb8ACgm5,bWdj2GDclj5ofokWjzoa5jAwMkxCykd6,1,0,0,0,0,0,1,0,1,0.14285714285714285,1,0.0,0,0,0,0,0,0,0,1,0,0,1,1
10173,90135,bTJkfLPF7pQ1o12jyPBjkkHpxb8ACgm5,SpATywNh6bZuzm8s1ceuBUnMUAeoAHHw,4,2,1,0,1,0,1,0,5,0.7142857142857143,1,0.0,0,1,0,1,2,0,0,1,0,2,3,1
10174,90136,bMIS6W7sngWZiZpkuSg6XOmdfsq88CgB,bWdj2GDclj5ofokWjzoa5jAwMkxCykd6,9,13,6,126,7,0,2,0,154,22.0,1,0.0,6,6,125,7,7,0,1,2,0,144,10,1
10175,90138,Eg9TEdaEeaxICrLXGeMPzp6XOtJtw2iA,SpATywNh6bZuzm8s1ceuBUnMUAeoAHHw,6,1,1,0,1,0,5,0,8,1.1428571428571428,1,0.0,0,1,0,1,1,0,0,5,0,2,6,1
10176,90139,6ev6a6dpwen0GstMqDij5DO55YCNj8wV,SpATywNh6bZuzm8s1ceuBUnMUAeoAHHw,10,10,5,0,3,7,8,1,34,4.857142857142857,1,0.0,0,5,0,3,10,7,0,8,1,8,26,1
10177,90155,U7btMcQ825kheRskgLUndnBUWWFj60BC,G8EPVSXsOYB5YQWZGiz1aVq5Pgr2GrQu,2,0,0,0,0,0,3,0,3,0.42857142857142855,1,0.0,0,0,0,0,0,0,0,3,0,0,3,1
10178,90160,Q7rqeL75J4PJeAuNXiXhCR5dry9rPsv1,G8EPVSXsOYB5YQWZGiz1aVq5Pgr2GrQu,14,24,9,4,8,1,7,1,54,7.714285714285714,1,0.0,13,9,3,8,11,1,1,7,1,33,21,1
10179,90172,ktsGX0WguDDY6I5ilK51sxzTMtoxdwY2,G8EPVSXsOYB5YQWZGiz1aVq5Pgr2GrQu,5,2,1,0,1,0,4,0,8,1.1428571428571428,2,0.0,0,1,0,1,2,0,0,4,0,2,6,1
10180,90176,TM0zAsul1XLjJRFtspexc3sccxHTiW3v,SpATywNh6bZuzm8s1ceuBUnMUAeoAHHw,2,0,0,0,0,0,2,0,2,0.2857142857142857,1,0.0,0,0,0,0,0,0,0,2,0,0,2,0
10181,90177,ihuUuFaDeVBULP8Ogmzz18gVO9cBzlOD,RXDvfPUBYFlVdlueBFbLW0mhhAyGEqpt,3,0,0,0,0,2,2,0,4,0.5714285714285714,1,0.0,0,0,0,0,0,2,0,2,0,0,4,1
10182,90180,7ibtd0r1yxMhjpaNZCtEirkOcSqUBCGN,RXDvfPUBYFlVdlueBFbLW0mhhAyGEqpt,13,11,5,14,5,0,1,0,36,5.142857142857143,1,0.0,5,5,12,5,6,0,2,1,0,27,9,0
10183,90183,SYRx2sSX9LDLLUNNibf5r7JJQePy5BRh,G8EPVSXsOYB5YQWZGiz1aVq5Pgr2GrQu,27,47,2,48,0,1,12,1,111,15.857142857142858,2,0.0,19,2,35,0,28,1,13,12,1,56,55,1
10184,90184,7zAZJQJmdmR0Q9agHk9B0faabzdMeTDx,G8EPVSXsOYB5YQWZGiz1aVq5Pgr2GrQu,4,5,2,0,2,0,1,0,10,1.4285714285714286,1,0.0,2,2,0,2,3,0,0,1,0,6,4,1
10185,90189,64SFa5QYw3OYdZffw8ZxPKmPdz675qex,G8EPVSXsOYB5YQWZGiz1aVq5Pgr2GrQu,6,3,2,0,2,0,1,0,8,1.1428571428571428,1,0.0,0,2,0,2,3,0,0,1,0,4,4,1
10186,90192,uybm0Sdpts5PrhQW2nyBVnFfiT9zAmh4,G8EPVSXsOYB5YQWZGiz1aVq5Pgr2GrQu,8,9,1,8,1,0,3,0,22,3.142857142857143,1,0.0,2,1,6,1,7,0,2,3,0,10,12,0
10187,90199,loDNGhsCc1OXWM5CF3rme5wzdyMcOTJj,RXDvfPUBYFlVdlueBFbLW0mhhAyGEqpt,26,19,9,0,7,1,9,4,49,7.0,2,0.0,1,9,0,7,18,1,0,9,4,17,32,1
10188,90214,LfZmAYW4GITnFlauWgCvKzPoi1bCqPgK,bWdj2GDclj5ofokWjzoa5jAwMkxCykd6,12,13,4,4,5,0,6,0,32,4.571428571428571,2,0.0,4,4,4,5,9,0,0,6,0,17,15,1
10189,90215,GxfzvZIYYQ6Ai51iUnspJ06bhY10jacX,SpATywNh6bZuzm8s1ceuBUnMUAeoAHHw,17,20,9,18,5,0,8,1,61,8.714285714285714,2,0.0,3,9,15,5,17,0,3,8,1,32,29,1
10190,90219,feANl8pQvsJtkNIIOWO1qX8ND4VT9Cj4,G8EPVSXsOYB5YQWZGiz1aVq5Pgr2GrQu,4,2,1,0,1,0,1,0,5,0.7142857142857143,1,0.0,0,1,0,1,2,0,0,1,0,2,3,1
10191,90223,LRnQOt7NsdMcAvm0GOPse3zkFSQ0mVYI,SpATywNh6bZuzm8s1ceuBUnMUAeoAHHw,5,2,1,0,1,0,2,0,6,0.8571428571428571,1,0.0,0,1,0,1,2,0,0,2,0,2,4,1
10192,90224,S0OJjF6aof0iTnIX6lUAxekoH3m4w7V0,RXDvfPUBYFlVdlueBFbLW0mhhAyGEqpt,18,13,10,29,7,0,1,0,60,8.571428571428571,1,0.0,2,10,23,7,11,0,6,1,0,42,18,1
10193,90233,mXvtIKY9ZnAQyKjdLyySIxbvTtoP8Weq,G8EPVSXsOYB5YQWZGiz1aVq5Pgr2GrQu,5,2,1,0,1,0,3,0,7,1.0,1,0.0,0,1,0,1,2,0,0,3,0,2,5,1
10194,90235,pONYaLTf3U8GoaNpbS0j1PZ1GhOmkS7N,SpATywNh6bZuzm8s1ceuBUnMUAeoAHHw,14,17,6,14,4,1,3,0,45,6.428571428571429,1,0.0,10,6,14,4,7,1,0,3,0,34,11,1
10195,90244,DU0dRtEpZksA4ySXAez5UVn9g5rHoTAA,SpATywNh6bZuzm8s1ceuBUnMUAeoAHHw,8,22,11,0,3,0,3,0,39,5.571428571428571,2,0.0,8,11,0,3,14,0,0,3,0,22,17,1
10196,90248,b0xM3piMaIC7gCFYyxqHoITel9oKF6YW,bWdj2GDclj5ofokWjzoa5jAwMkxCykd6,9,5,1,26,1,2,4,1,40,5.714285714285714,1,0.0,2,1,25,1,3,2,1,4,1,29,11,1
10197,90249,RDTdhSHGbxVSFCWLWYH4XRafyz4IOkLm,SpATywNh6bZuzm8s1ceuBUnMUAeoAHHw,7,6,2,0,1,1,4,0,14,2.0,2,0.0,0,2,0,1,6,1,0,4,0,3,11,1
10198,90250,Cb5KBNxKLciN7IuFLNM0hPSrkcjzkoDX,SpATywNh6bZuzm8s1ceuBUnMUAeoAHHw,7,2,1,0,1,0,3,0,7,1.0,1,0.0,0,1,0,1,2,0,0,3,0,2,5,1
10199,90251,GMTEjCyWbqfKfP4EXN5ReJJtqfdXmmTA,RXDvfPUBYFlVdlueBFbLW0mhhAyGEqpt,2,0,0,0,0,0,2,0,2,0.2857142857142857,1,0.0,0,0,0,0,0,0,0,2,0,0,2,1
10200,90253,5a7fehAo0Ol3kwHzhNqAYRGEzPLIE5FD,bWdj2GDclj5ofokWjzoa5jAwMkxCykd6,6,9,5,0,1,0,7,0,22,3.142857142857143,3,0.0,0,5,0,1,9,0,0,7,0,6,16,1
10201,90256,JHLmQKNX4G6HmeBY0Psd6kgnv0WEcPsm,SpATywNh6bZuzm8s1ceuBUnMUAeoAHHw,7,4,1,0,1,0,6,0,12,1.7142857142857142,1,0.0,0,1,0,1,4,0,0,6,0,2,10,1
10202,90258,tQrXZ3EDIEf1hKQdGJOaurgPvqncjvEA,bWdj2GDclj5ofokWjzoa5jAwMkxCykd6,3,2,0,0,0,0,2,0,4,0.5714285714285714,1,0.0,0,0,0,0,2,0,0,2,0,0,4,1
10203,90260,zykAfhTnSrdYpElmeo66SyCzw5nw6JVn,bWdj2GDclj5ofokWjzoa5jAwMkxCykd6,7,12,7,0,3,0,6,0,28,4.0,1,0.0,0,7,0,3,12,0,0,6,0,10,18,1
10204,90263,QmJXKs57BF6o936ZGaQIMEt20JYrSdAW,G8EPVSXsOYB5YQWZGiz1aVq5Pgr2GrQu,4,27,1,4,2,0,1,0,35,5.0,1,0.0,23,1,3,2,4,0,1,1,0,29,6,1
10205,90266,n0HFF3TwqKuBMzzkdLCbvb8Mji5ZUnVX,SpATywNh6bZuzm8s1ceuBUnMUAeoAHHw,7,9,6,0,4,0,3,0,22,3.142857142857143,3,0.0,0,6,0,4,9,0,0,3,0,10,12,1
10206,90270,521YJDVy6G9ul5QyLTUZAuztPLpe7gqW,G8EPVSXsOYB5YQWZGiz1aVq5Pgr2GrQu,11,14,4,0,2,1,10,1,32,4.571428571428571,1,0.0,2,4,0,2,12,1,0,10,1,8,24,1
10207,90272,s41hWh3vMIIfQQVEuM6UwEzfhfcM1JZA,SpATywNh6bZuzm8s1ceuBUnMUAeoAHHw,5,2,1,0,1,0,2,0,6,0.8571428571428571,1,0.0,0,1,0,1,2,0,0,2,0,2,4,1
10208,90278,bweLZE6WiefKMb8vrgzlIS50q4xPrbd3,G8EPVSXsOYB5YQWZGiz1aVq5Pgr2GrQu,8,8,2,2,2,0,2,0,16,2.2857142857142856,2,0.0,3,2,2,2,5,0,0,2,0,9,7,1
10209,90279,Ewm3oAfqxDgJQMFbDpAkGPAjCut5zQSX,SpATywNh6bZuzm8s1ceuBUnMUAeoAHHw,1,0,0,0,0,0,1,0,1,0.14285714285714285,1,0.0,0,0,0,0,0,0,0,1,0,0,1,1
10210,90280,jwRuJMKgg5MQLF9v6u6v92ntnY2avB7X,SpATywNh6bZuzm8s1ceuBUnMUAeoAHHw,7,3,2,0,2,0,4,0,11,1.5714285714285714,1,0.0,0,2,0,2,3,0,0,4,0,4,7,1
10211,90285,v4laioBlEPXkN50wQCoVv0p0aRfPHa4S,G8EPVSXsOYB5YQWZGiz1aVq5Pgr2GrQu,1,0,0,0,0,0,1,0,1,0.14285714285714285,1,0.0,0,0,0,0,0,0,0,1,0,0,1,1
10212,90286,0nJUVE3hT3v1fqbd9NpHDszm9KS6NNTn,G8EPVSXsOYB5YQWZGiz1aVq5Pgr2GrQu,6,1,1,0,1,0,3,0,6,0.8571428571428571,1,0.0,0,1,0,1,1,0,0,3,0,2,4,1
10213,90289,n5gAmeJZl36AzaSKV2dfNY3RvYF0IYqr,SpATywNh6bZuzm8s1ceuBUnMUAeoAHHw,5,3,1,0,1,0,2,0,7,1.0,1,0.0,1,1,0,1,2,0,0,2,0,3,4,1
10214,90290,264OEiaYNcFYG5J7N6NDOp3G0CBJqdMF,SpATywNh6bZuzm8s1ceuBUnMUAeoAHHw,2,0,0,0,0,0,3,0,3,0.42857142857142855,1,0.0,0,0,0,0,0,0,0,3,0,0,3,1
10215,90294,juZ453F4cmwgObiaW1ClMKkoi0EGrafR,G8EPVSXsOYB5YQWZGiz1aVq5Pgr2GrQu,4,2,0,0,0,1,2,0,5,0.7142857142857143,1,0.0,0,0,0,0,2,1,0,2,0,0,5,1
10216,90305,Sy1NUS22p5IcvKggpod61sUWNUSyXtbs,G8EPVSXsOYB5YQWZGiz1aVq5Pgr2GrQu,19,29,11,0,8,0,7,0,55,7.857142857142857,4,0.0,8,11,0,8,21,0,0,7,0,27,28,0
10217,90306,cwnwk7sVo9oHpSkUPDdu8wUE4KBTJLBj,bWdj2GDclj5ofokWjzoa5jAwMkxCykd6,1,0,0,0,0,0,1,0,1,0.14285714285714285,1,0.0,0,0,0,0,0,0,0,1,0,0,1,1
10218,90321,NlgFEWO87VQbCzq3S6FQjH7bzvdUhuql,RXDvfPUBYFlVdlueBFbLW0mhhAyGEqpt,1,0,0,0,0,0,1,0,1,0.14285714285714285,1,0.0,0,0,0,0,0,0,0,1,0,0,1,1
10219,90326,J1iCM60eAwVKTPRoP9hdyFlEQf6db3YF,SpATywNh6bZuzm8s1ceuBUnMUAeoAHHw,13,10,6,6,4,4,3,0,33,4.714285714285714,1,0.0,2,6,6,4,8,4,0,3,0,18,15,1
10220,90337,AImQCDhN4bmgLgB3jm3FHzAq0G1rwIiv,SpATywNh6bZuzm8s1ceuBUnMUAeoAHHw,5,2,1,0,1,0,2,0,6,0.8571428571428571,1,0.0,0,1,0,1,2,0,0,2,0,2,4,1
10221,90343,jl79Z6TfXd4YLzsAQwSCeo1eMaF6Ha8d,bWdj2GDclj5ofokWjzoa5jAwMkxCykd6,13,14,1,0,2,11,19,4,51,7.285714285714286,2,0.0,2,1,0,2,12,11,0,19,4,5,46,1
10222,90348,VDscv2ylkQ5hVjxSl7FzkFmJDmBcIaMr,bWdj2GDclj5ofokWjzoa5jAwMkxCykd6,11,8,3,18,1,0,14,1,45,6.428571428571429,4,0.0,1,3,18,1,7,0,0,14,1,23,22,1
10223,90349,F6I7OSqjE137AeaYIX9MEazl6a7Noplf,SpATywNh6bZuzm8s1ceuBUnMUAeoAHHw,7,4,0,0,0,0,4,0,8,1.1428571428571428,1,0.0,0,0,0,0,4,0,0,4,0,0,8,1
10224,90351,vSAp2k0hR5TAgTxUO6r2EVSaLCqePHP4,SpATywNh6bZuzm8s1ceuBUnMUAeoAHHw,4,2,1,0,1,0,1,0,5,0.7142857142857143,1,0.0,0,1,0,1,2,0,0,1,0,2,3,1
10225,90354,x3sZblYMoUvQJbk7l9GY688n7RQqaQct,bWdj2GDclj5ofokWjzoa5jAwMkxCykd6,5,5,1,0,1,0,2,0,9,1.2857142857142858,1,0.0,0,1,0,1,5,0,0,2,0,2,7,1
10226,90355,D7Evkt9LkM9awqCB4mL7Tk75xiGKRcNK,RXDvfPUBYFlVdlueBFbLW0mhhAyGEqpt,1,0,0,0,0,0,1,0,1,0.14285714285714285,1,0.0,0,0,0,0,0,0,0,1,0,0,1,1
10227,90356,ublyxWXAJoR0ltzxB8gmTQ7Y4SFlWnZM,G8EPVSXsOYB5YQWZGiz1aVq5Pgr2GrQu,10,23,0,6,1,0,5,1,36,5.142857142857143,2,0.0,14,0,5,1,9,0,1,5,1,20,16,1
10228,90358,JnnoDII6jIRoAG8myf8F5d0DS0vEB9se,bWdj2GDclj5ofokWjzoa5jAwMkxCykd6,3,0,0,0,0,4,2,0,6,0.8571428571428571,1,0.0,0,0,0,0,0,4,0,2,0,0,6,1
10229,90359,6ryFJ2ZF3YGC7hqGJv2IswdyAnxH8nhB,G8EPVSXsOYB5YQWZGiz1aVq5Pgr2GrQu,5,2,1,0,1,0,7,0,11,1.5714285714285714,1,0.0,0,1,0,1,2,0,0,7,0,2,9,1
10230,90369,BBJ3vKTyvStRa10Tpfc6k0oOhgY721Pq,bWdj2GDclj5ofokWjzoa5jAwMkxCykd6,7,5,3,0,2,0,5,1,16,2.2857142857142856,1,0.0,0,3,0,2,5,0,0,5,1,5,11,1
10231,90372,4GMbKnTV7f2uA3paM09GNAdyVnypDTbs,RXDvfPUBYFlVdlueBFbLW0mhhAyGEqpt,8,2,2,0,2,0,8,0,14,2.0,1,0.0,0,2,0,2,2,0,0,8,0,4,10,1
10232,90374,FGJeYJZQGTs7gi3lnr6EovN6yJTo7ibM,G8EPVSXsOYB5YQWZGiz1aVq5Pgr2GrQu,20,8,6,22,3,1,7,1,48,6.857142857142857,1,0.0,0,6,17,3,8,1,5,7,1,26,22,1
10233,90376,BBJ3vKTyvStRa10Tpfc6k0oOhgY721Pq,RXDvfPUBYFlVdlueBFbLW0mhhAyGEqpt,1,0,0,0,0,0,1,0,1,0.14285714285714285,1,0.0,0,0,0,0,0,0,0,1,0,0,1,1
10234,90377,2sT7ojsC1w02fAwhcaRLBrXcss5IOsOK,bWdj2GDclj5ofokWjzoa5jAwMkxCykd6,5,2,1,0,1,0,2,0,6,0.8571428571428571,1,0.0,0,1,0,1,2,0,0,2,0,2,4,1
10235,90381,JnnoDII6jIRoAG8myf8F5d0DS0vEB9se,RXDvfPUBYFlVdlueBFbLW0mhhAyGEqpt,1,0,0,0,0,0,1,0,1,0.14285714285714285,1,0.0,0,0,0,0,0,0,0,1,0,0,1,1
10236,90382,JnnoDII6jIRoAG8myf8F5d0DS0vEB9se,G8EPVSXsOYB5YQWZGiz1aVq5Pgr2GrQu,1,0,0,0,0,0,1,0,1,0.14285714285714285,1,0.0,0,0,0,0,0,0,0,1,0,0,1,1
10237,90389,UdVAw5urwjLmc9uIJ3uWZ6MzY9bq82FD,bWdj2GDclj5ofokWjzoa5jAwMkxCykd6,5,11,1,18,0,5,1,0,36,5.142857142857143,1,0.0,6,1,16,0,5,5,2,1,0,23,13,1
10238,90391,wyK0UoS83lDT8utSJzcLSlSEzOTr7cFo,SpATywNh6bZuzm8s1ceuBUnMUAeoAHHw,4,0,0,0,0,0,4,0,4,0.5714285714285714,1,0.0,0,0,0,0,0,0,0,4,0,0,4,1
10239,90399,Gq0WW1vBA55n1msrepMKrg3TKn8N6yfT,bWdj2GDclj5ofokWjzoa5jAwMkxCykd6,16,21,1,48,2,0,6,0,78,11.142857142857142,2,0.0,10,1,47,2,11,0,1,6,0,60,18,1
10240,90404,5o9h0u1MdREnKa1ru9UVL61wcNO9zJkv,bWdj2GDclj5ofokWjzoa5jAwMkxCykd6,6,15,3,0,1,0,9,0,28,4.0,1,0.0,0,3,0,1,15,0,0,9,0,4,24,1
10241,90408,C6mvlVLzmlNXh4kv8CeERDr2P2W5lqpV,SpATywNh6bZuzm8s1ceuBUnMUAeoAHHw,7,2,0,0,0,2,7,1,12,1.7142857142857142,1,0.0,0,0,0,0,2,2,0,7,1,0,12,1
10242,90416,4tsGZRMByIyec9WCveltaBAT6TVvi6KF,RXDvfPUBYFlVdlueBFbLW0mhhAyGEqpt,9,6,2,26,3,0,1,0,38,5.428571428571429,1,0.0,2,2,20,3,4,0,6,1,0,27,11,1
10243,90418,fBvSAwv6uc40UeqRCaejhOfI13E4tjda,SpATywNh6bZuzm8s1ceuBUnMUAeoAHHw,6,12,3,0,1,0,4,0,20,2.857142857142857,2,0.0,3,3,0,1,9,0,0,4,0,7,13,1
10244,90422,rwjIOQWge6ogv55EFnUadvoZ473wCxPF,SpATywNh6bZuzm8s1ceuBUnMUAeoAHHw,2,0,0,0,0,0,3,0,3,0.42857142857142855,1,0.0,0,0,0,0,0,0,0,3,0,0,3,1
10245,90425,lcgsmC4BQDYDnzCO5vs1TCdTPnBbRaGt,SpATywNh6bZuzm8s1ceuBUnMUAeoAHHw,13,37,0,22,0,11,16,3,89,12.714285714285714,2,0.0,10,0,18,0,27,11,4,16,3,28,61,1
10246,90429,NnJUzVJQXS15uc1WVncpFgpFT3Jtm38y,bWdj2GDclj5ofokWjzoa5jAwMkxCykd6,4,2,1,0,1,0,1,0,5,0.7142857142857143,1,0.0,0,1,0,1,2,0,0,1,0,2,3,1
10247,90432,PCdtFg5aq768xRAGHCfQQy2MLmWOvvld,bWdj2GDclj5ofokWjzoa5jAwMkxCykd6,5,5,3,0,0,0,3,0,11,1.5714285714285714,2,0.0,0,3,0,0,5,0,0,3,0,3,8,1
10248,90435,ohlMhSWqKWmqC7u03UQO1YoFekI6xVAy,RXDvfPUBYFlVdlueBFbLW0mhhAyGEqpt,9,4,1,0,1,2,11,1,20,2.857142857142857,1,0.0,0,1,0,1,4,2,0,11,1,2,18,1
10249,90445,NvpLHMRFxJk2eR30iYl189WOkyZeEnSd,RXDvfPUBYFlVdlueBFbLW0mhhAyGEqpt,4,3,0,0,0,0,1,0,4,0.5714285714285714,1,0.0,0,0,0,0,3,0,0,1,0,0,4,1
10250,90446,FcIMQNoo2B9wNij30W0t3SsuF1pzZCFp,G8EPVSXsOYB5YQWZGiz1aVq5Pgr2GrQu,6,2,1,0,0,0,6,0,9,1.2857142857142858,1,0.0,0,1,0,0,2,0,0,6,0,1,8,1
10251,90448,8spZJm18FAAt0jkb5fLlQ7lVR80rIhqU,SpATywNh6bZuzm8s1ceuBUnMUAeoAHHw,9,8,2,0,1,4,13,3,31,4.428571428571429,2,0.0,0,2,0,1,8,4,0,13,3,3,28,1
10252,90449,MoVymwbcHW0CbhTCwXgAq4UFuaXFCEM8,SpATywNh6bZuzm8s1ceuBUnMUAeoAHHw,5,3,0,0,0,0,2,0,5,0.7142857142857143,1,0.0,0,0,0,0,3,0,0,2,0,0,5,1
10253,90450,K0GvqkFX0mEPCK9WbHThj3iwTwuWgCZz,G8EPVSXsOYB5YQWZGiz1aVq5Pgr2GrQu,83,118,49,230,6,19,18,2,442,63.142857142857146,1,0.0,55,49,171,6,63,19,59,18,2,281,161,1
10254,90451,gbhKUd7BJXTZpVcoQvBpKT3bqB9VoWlp,SpATywNh6bZuzm8s1ceuBUnMUAeoAHHw,4,2,1,0,1,0,1,0,5,0.7142857142857143,1,0.0,0,1,0,1,2,0,0,1,0,2,3,1
10255,90455,loPn0Qajy87SoektWTbVxEkxp7hmTtzk,SpATywNh6bZuzm8s1ceuBUnMUAeoAHHw,1,0,0,0,0,0,1,0,1,0.14285714285714285,1,0.0,0,0,0,0,0,0,0,1,0,0,1,1
10256,90456,ejWSFSNW1jOTCFDROUQkAUS6uY6mX6CR,bWdj2GDclj5ofokWjzoa5jAwMkxCykd6,4,2,1,0,1,0,1,0,5,0.7142857142857143,1,0.0,0,1,0,1,2,0,0,1,0,2,3,1
10257,90468,D0SRTJhzsGGnKbIKtAcGeOVG46CDAXxq,bWdj2GDclj5ofokWjzoa5jAwMkxCykd6,6,11,6,0,3,0,5,0,25,3.5714285714285716,2,0.0,0,6,0,3,11,0,0,5,0,9,16,1
10258,90469,3v3FB5XsF44WUQOyhVB1K7TjhxipIjnJ,bWdj2GDclj5ofokWjzoa5jAwMkxCykd6,1,0,0,0,0,0,1,0,1,0.14285714285714285,1,0.0,0,0,0,0,0,0,0,1,0,0,1,1
10259,90471,AcoYRXM9MxEJpHYoq7SsbSwZ8unsRtq3,SpATywNh6bZuzm8s1ceuBUnMUAeoAHHw,12,7,1,13,1,0,5,0,27,3.857142857142857,2,0.0,2,1,13,1,5,0,0,5,0,17,10,0
10260,90474,AMP1VomhrLvq0oxaLMgCzayTJQ1U3Z03,SpATywNh6bZuzm8s1ceuBUnMUAeoAHHw,8,8,2,0,0,0,10,1,21,3.0,1,0.0,0,2,0,0,8,0,0,10,1,2,19,1
10261,90479,09hA70zHHsdFY99KewQn0t7W1Th1KuA4,RXDvfPUBYFlVdlueBFbLW0mhhAyGEqpt,29,22,16,34,14,2,16,15,119,17.0,2,0.0,6,16,29,14,16,2,5,16,15,65,54,1
10262,90480,jJhM7dfbmyu6QnNvOuNIHUQvXzylS9kq,bWdj2GDclj5ofokWjzoa5jAwMkxCykd6,1,0,0,0,0,0,1,0,1,0.14285714285714285,1,0.0,0,0,0,0,0,0,0,1,0,0,1,1
10263,90482,LfSoKi26BKEYZHPv7eOdEODBvG4bpVnt,SpATywNh6bZuzm8s1ceuBUnMUAeoAHHw,11,8,5,0,3,0,7,0,23,3.2857142857142856,2,0.0,0,5,0,3,8,0,0,7,0,8,15,1
10264,90486,4eRAU6q1j8xj2oZfSvPOcocekaK18w9w,RXDvfPUBYFlVdlueBFbLW0mhhAyGEqpt,16,21,3,0,0,2,11,1,38,5.428571428571429,1,0.0,2,3,0,0,19,2,0,11,1,5,33,1
10265,90487,swTV8FwIOGPvq6kDLTbN7KErbstwahnB,RXDvfPUBYFlVdlueBFbLW0mhhAyGEqpt,5,3,2,0,1,0,2,0,8,1.1428571428571428,1,0.0,0,2,0,1,3,0,0,2,0,3,5,1
10266,90491,0Gw9qsZWrsuN96zAJXr0m2eOAANOJE07,SpATywNh6bZuzm8s1ceuBUnMUAeoAHHw,1,0,0,0,0,0,1,0,1,0.14285714285714285,1,0.0,0,0,0,0,0,0,0,1,0,0,1,1
10267,90493,3yfQbyJ9pf1yrEL1gur3tzr8XAtUzfm8,bWdj2GDclj5ofokWjzoa5jAwMkxCykd6,4,2,0,0,0,0,2,0,4,0.5714285714285714,1,0.0,0,0,0,0,2,0,0,2,0,0,4,1
10268,90494,r3ymEDBeAtjd52LKkH7rXxWW6cBfLEDa,bWdj2GDclj5ofokWjzoa5jAwMkxCykd6,10,9,4,0,4,0,6,0,23,3.2857142857142856,1,0.0,2,4,0,4,7,0,0,6,0,10,13,1
10269,90495,IV2jyEJwnx9XuvLUnJBPSDEiQEmkULrq,SpATywNh6bZuzm8s1ceuBUnMUAeoAHHw,13,25,3,17,1,0,8,0,54,7.714285714285714,1,0.0,11,3,15,1,14,0,2,8,0,30,24,1
10270,90504,3uY3PXIjE4xYhALzqv9EDJ3LJju3f4Jc,SpATywNh6bZuzm8s1ceuBUnMUAeoAHHw,7,4,2,0,2,0,2,0,10,1.4285714285714286,1,0.0,0,2,0,2,4,0,0,2,0,4,6,1
10271,90513,rW9Fl0YODiCSMxzLAOKlzYxXd8TfgDcd,RXDvfPUBYFlVdlueBFbLW0mhhAyGEqpt,4,5,2,0,0,0,1,0,8,1.1428571428571428,1,0.0,0,2,0,0,5,0,0,1,0,2,6,1
10272,90518,9D8Fr85Y0xJSTSvXENunTRQkQQzpKKhe,RXDvfPUBYFlVdlueBFbLW0mhhAyGEqpt,41,32,22,48,10,24,7,0,143,20.428571428571427,1,0.0,7,22,46,10,25,24,2,7,0,85,58,1
10273,90519,Xs5JYGOD3p8qnunCvDbRtmUT4YrLSZAt,SpATywNh6bZuzm8s1ceuBUnMUAeoAHHw,5,1,1,0,1,0,2,0,5,0.7142857142857143,1,0.0,0,1,0,1,1,0,0,2,0,2,3,1
10274,90520,JoruyAOmEeM1qjcSEWRUjLvQUHpNPZGp,bWdj2GDclj5ofokWjzoa5jAwMkxCykd6,1,0,0,0,0,0,1,0,1,0.14285714285714285,1,0.0,0,0,0,0,0,0,0,1,0,0,1,1
10275,90523,3CsUz8mRFoFNKmkeENo8HuDQSH05lxmZ,SpATywNh6bZuzm8s1ceuBUnMUAeoAHHw,11,23,0,16,0,3,9,0,51,7.285714285714286,1,0.0,9,0,13,0,14,3,3,9,0,22,29,1
10276,90524,LowLlbmaDUppvngMtOhXYfyftobUC8Pz,SpATywNh6bZuzm8s1ceuBUnMUAeoAHHw,10,6,3,0,2,1,7,1,20,2.857142857142857,1,0.0,1,3,0,2,5,1,0,7,1,6,14,1
10277,90526,w2OxtzQI9blY6H8U919hOBWDDo1sEi62,SpATywNh6bZuzm8s1ceuBUnMUAeoAHHw,14,22,0,28,0,55,20,2,127,18.142857142857142,1,0.0,12,0,22,0,10,55,6,20,2,34,93,1
10278,90527,HtbY3zzP3Q7syMRtSIgdj2lkZgZynozO,bWdj2GDclj5ofokWjzoa5jAwMkxCykd6,9,14,0,24,1,27,10,0,76,10.857142857142858,2,0.0,5,0,22,1,9,27,2,10,0,28,48,1
10279,90528,3DMxdIMHShIiQg7VSSohBgQL1oCtuKe4,SpATywNh6bZuzm8s1ceuBUnMUAeoAHHw,4,3,1,0,1,0,0,0,5,0.7142857142857143,1,0.0,0,1,0,1,3,0,0,0,0,2,3,1
10280,90531,iEQKBpzbjZD62mKeYEyJG967oZGFzYX2,SpATywNh6bZuzm8s1ceuBUnMUAeoAHHw,1,0,0,0,0,0,1,0,1,0.14285714285714285,1,0.0,0,0,0,0,0,0,0,1,0,0,1,0
10281,90532,MBimBV1KD5WZIVxadl6ACFa9rEZi9InE,SpATywNh6bZuzm8s1ceuBUnMUAeoAHHw,6,2,1,0,1,0,4,0,8,1.1428571428571428,1,0.0,0,1,0,1,2,0,0,4,0,2,6,1
10282,90540,M8ZBCZwMuabH0ACZboTe8kVgLwQBa43E,bWdj2GDclj5ofokWjzoa5jAwMkxCykd6,7,5,2,0,2,1,5,1,16,2.2857142857142856,1,0.0,0,2,0,2,5,1,0,5,1,4,12,1
10283,90546,68BjCXfBFqeZ01fFx1csrFmvef5xs0w2,bWdj2GDclj5ofokWjzoa5jAwMkxCykd6,9,8,5,0,4,7,3,0,27,3.857142857142857,2,0.0,1,5,0,4,7,7,0,3,0,10,17,1
10284,90549,Z3cBuyK57dLpleXUvGj6emfcnGidOatN,SpATywNh6bZuzm8s1ceuBUnMUAeoAHHw,11,9,7,0,5,0,3,0,24,3.4285714285714284,2,0.0,0,7,0,5,9,0,0,3,0,12,12,1
10285,90550,RNHJpl4xeeRwTYeul6H1SE3f8Bgn5J0c,SpATywNh6bZuzm8s1ceuBUnMUAeoAHHw,11,13,5,0,1,2,7,0,28,4.0,1,0.0,0,5,0,1,13,2,0,7,0,6,22,1
10286,90553,Urctwx56OvAe8Aa2Ler31rqDl5pjO2bG,G8EPVSXsOYB5YQWZGiz1aVq5Pgr2GrQu,23,13,3,24,2,9,17,1,69,9.857142857142858,3,0.0,3,3,18,2,10,9,6,17,1,26,43,1
10287,90560,QqAAFsY8kslizUQKd5uhHbFKpFbb6EW2,SpATywNh6bZuzm8s1ceuBUnMUAeoAHHw,28,50,21,32,6,15,12,1,137,19.571428571428573,4,0.0,12,21,29,6,38,15,3,12,1,68,69,0
10288,90564,gpn05NwMGqKm6lLZGRrnOmPlhHxlC7Wb,RXDvfPUBYFlVdlueBFbLW0mhhAyGEqpt,7,5,3,0,1,0,2,0,11,1.5714285714285714,1,0.0,0,3,0,1,5,0,0,2,0,4,7,1
10289,90569,vKmnCHrfJDutyArHoAT9SYM4ChEEDtjx,SpATywNh6bZuzm8s1ceuBUnMUAeoAHHw,3,5,0,0,0,0,1,0,6,0.8571428571428571,1,0.0,0,0,0,0,5,0,0,1,0,0,6,1
10290,90571,i6jKFDXXIDyjle2n9K5Y7L1CTASMdeNx,RXDvfPUBYFlVdlueBFbLW0mhhAyGEqpt,48,74,3,70,2,3,19,23,194,27.714285714285715,6,0.0,15,3,69,2,59,3,1,19,23,89,105,0
10291,90572,T8mcyrbyEy4XKuvvM213HanZBW8dGO2d,G8EPVSXsOYB5YQWZGiz1aVq5Pgr2GrQu,7,5,1,0,1,0,1,0,8,1.1428571428571428,1,0.0,0,1,0,1,5,0,0,1,0,2,6,1
10292,90581,zH9I9L0RNBBTkWMoTXe4TRjHS1m1XHhV,G8EPVSXsOYB5YQWZGiz1aVq5Pgr2GrQu,10,22,3,12,5,0,3,0,45,6.428571428571429,2,0.0,17,3,9,5,5,0,3,3,0,34,11,1
10293,90583,bXejoPivba2ie50IiUpExTQGL9Tgmtcn,bWdj2GDclj5ofokWjzoa5jAwMkxCykd6,5,2,1,0,1,0,2,0,6,0.8571428571428571,1,0.0,0,1,0,1,2,0,0,2,0,2,4,1
10294,90589,eRKD4Ti4W635KvBhrrkbgHKvnvdw2Idz,SpATywNh6bZuzm8s1ceuBUnMUAeoAHHw,5,2,1,0,1,0,2,0,6,0.8571428571428571,1,0.0,0,1,0,1,2,0,0,2,0,2,4,1
10295,90590,jAHcjIKPY9dlDu300CKSWdNxocPzZC4f,G8EPVSXsOYB5YQWZGiz1aVq5Pgr2GrQu,10,10,4,4,2,0,2,0,22,3.142857142857143,2,0.0,3,4,3,2,7,0,1,2,0,12,10,1
10296,90592,kYIFQ3xM3QnRCvimArGnWBFWWaGJijmw,RXDvfPUBYFlVdlueBFbLW0mhhAyGEqpt,5,2,1,0,1,0,2,0,6,0.8571428571428571,1,0.0,0,1,0,1,2,0,0,2,0,2,4,1
10297,90597,DFFDn6kzjxm3QeQyKXF89GDFKDcalqmY,bWdj2GDclj5ofokWjzoa5jAwMkxCykd6,4,2,1,0,1,1,1,0,6,0.8571428571428571,1,0.0,0,1,0,1,2,1,0,1,0,2,4,1
10298,90611,1e3hDoCmipyCoPSCkvgArsY66kXMIOjQ,SpATywNh6bZuzm8s1ceuBUnMUAeoAHHw,8,11,3,0,2,1,6,1,24,3.4285714285714284,1,0.0,0,3,0,2,11,1,0,6,1,5,19,1
10299,90612,JqFx1dnEaecJfkuX3GZ1Q8Br4IpDeS68,SpATywNh6bZuzm8s1ceuBUnMUAeoAHHw,5,5,4,0,0,0,1,0,10,1.4285714285714286,1,0.0,0,4,0,0,5,0,0,1,0,4,6,1
10300,90620,7QseuWlQx7k5rV1TFF4oSS2exFRRLKz7,SpATywNh6bZuzm8s1ceuBUnMUAeoAHHw,11,4,2,0,2,1,8,1,18,2.5714285714285716,1,0.0,0,2,0,2,4,1,0,8,1,4,14,1
10301,90627,vDq8yiqHZiGZE0VPuzr41C23TWmY1JqS,SpATywNh6bZuzm8s1ceuBUnMUAeoAHHw,5,4,3,0,1,0,1,0,9,1.2857142857142858,1,0.0,0,3,0,1,4,0,0,1,0,4,5,1
10302,90632,5Dk7QJtqh7ATnN1jDaFE4dN4E1GugvAr,bWdj2GDclj5ofokWjzoa5jAwMkxCykd6,16,31,17,140,6,19,5,0,218,31.142857142857142,2,0.0,6,17,137,6,25,19,3,5,0,166,52,1
10303,90640,3YR1C1jI56LrsXJAUkFoM0M9MuhHAioI,SpATywNh6bZuzm8s1ceuBUnMUAeoAHHw,8,4,1,0,1,0,4,0,10,1.4285714285714286,1,0.0,2,1,0,1,2,0,0,4,0,4,6,1
10304,90643,LvpKAlZO7ziKr9qX3nIahz2mFKsUbwWI,SpATywNh6bZuzm8s1ceuBUnMUAeoAHHw,6,2,1,0,1,0,6,0,10,1.4285714285714286,3,0.0,0,1,0,1,2,0,0,6,0,2,8,1
10305,90647,ATFpemxOxaCS0pUz9OSp5dq4w85WuWvd,SpATywNh6bZuzm8s1ceuBUnMUAeoAHHw,13,22,0,18,0,0,8,2,50,7.142857142857143,1,0.0,6,0,17,0,16,0,1,8,2,23,27,1
10306,90649,CfeENerIdAGepleePWSt0SV88ctt0Tmw,RXDvfPUBYFlVdlueBFbLW0mhhAyGEqpt,1,0,0,0,0,0,1,0,1,0.14285714285714285,1,0.0,0,0,0,0,0,0,0,1,0,0,1,1
10307,90650,cvuy8HaLnRoF5suMAoOqjooUG2AEFLC2,bWdj2GDclj5ofokWjzoa5jAwMkxCykd6,10,10,2,2,3,0,6,0,23,3.2857142857142856,2,0.0,1,2,2,3,9,0,0,6,0,8,15,1
10308,90655,w0NwX9gVv58q1LwNFajcpOhqIprh7BvB,G8EPVSXsOYB5YQWZGiz1aVq5Pgr2GrQu,10,17,2,6,3,0,5,0,33,4.714285714285714,2,0.0,8,2,5,3,9,0,1,5,0,18,15,1
10309,90671,PwGj8ON4yrWpMaoZE0ES8sG2eAqFQNfN,SpATywNh6bZuzm8s1ceuBUnMUAeoAHHw,21,24,14,16,7,11,9,1,82,11.714285714285714,4,0.0,4,14,14,7,20,11,2,9,1,39,43,1
10310,90673,yDc9ZpbUycr11xuvu88deR54WnL37yET,SpATywNh6bZuzm8s1ceuBUnMUAeoAHHw,37,77,11,41,6,2,22,1,160,22.857142857142858,9,0.0,24,11,37,6,53,2,4,22,1,78,82,0
10311,90674,bLDIg7orV5sh30oIBmQ342IswZTJ8Q5l,RXDvfPUBYFlVdlueBFbLW0mhhAyGEqpt,42,51,32,38,19,10,12,2,164,23.428571428571427,5,0.0,3,32,37,19,48,10,1,12,2,91,73,1
10312,90676,JrmmYCeYhJwPKrtI75WdL68kxmQcjGg8,SpATywNh6bZuzm8s1ceuBUnMUAeoAHHw,11,12,8,0,5,1,6,1,33,4.714285714285714,3,0.0,0,8,0,5,12,1,0,6,1,13,20,1
10313,90678,wQn1gyWkMsHmRn6FRBCpTkRxPyoDtHcK,G8EPVSXsOYB5YQWZGiz1aVq5Pgr2GrQu,5,13,0,0,1,0,4,0,18,2.5714285714285716,2,0.0,6,0,0,1,7,0,0,4,0,7,11,1
10314,90685,p1glD11J2O4xqRjpc7tPhfftojomVp8l,G8EPVSXsOYB5YQWZGiz1aVq5Pgr2GrQu,6,1,1,0,1,1,5,0,9,1.2857142857142858,2,0.0,0,1,0,1,1,1,0,5,0,2,7,1
10315,90696,H5UEKpeYUS8ZwAU1o3ZTuTx8QVBIM5mj,bWdj2GDclj5ofokWjzoa5jAwMkxCykd6,1,0,0,0,0,0,1,0,1,0.14285714285714285,1,0.0,0,0,0,0,0,0,0,1,0,0,1,1
10316,90700,63wWcpmf1i2NKSiQREiAJYYp7SpsRdNk,SpATywNh6bZuzm8s1ceuBUnMUAeoAHHw,6,4,3,0,2,0,2,0,11,1.5714285714285714,1,0.0,0,3,0,2,4,0,0,2,0,5,6,1
10317,90701,deIsi5BI37iNeLK3sFoXHW9756YDHzUX,SpATywNh6bZuzm8s1ceuBUnMUAeoAHHw,8,5,1,0,0,11,9,1,27,3.857142857142857,1,0.0,0,1,0,0,5,11,0,9,1,1,26,1
10318,90702,ORT6fH4QpWfdVApgOFbiZIUgnndzWNam,bWdj2GDclj5ofokWjzoa5jAwMkxCykd6,6,2,1,0,1,0,4,0,8,1.1428571428571428,1,0.0,0,1,0,1,2,0,0,4,0,2,6,1
10319,90707,oJ9j9ejTgKixczg3tSE8Sg8DPI7YQpJq,bWdj2GDclj5ofokWjzoa5jAwMkxCykd6,8,11,5,0,2,1,4,1,24,3.4285714285714284,1,0.0,3,5,0,2,8,1,0,4,1,10,14,1
10320,90708,rd6AxicG284gxewkDLzJ9mHqaB9eMpej,SpATywNh6bZuzm8s1ceuBUnMUAeoAHHw,5,2,1,0,1,0,2,0,6,0.8571428571428571,1,0.0,0,1,0,1,2,0,0,2,0,2,4,1
10321,90711,YwhJiJdY6sdupy0lRkNRU9p6H4rUPLhl,SpATywNh6bZuzm8s1ceuBUnMUAeoAHHw,2,0,0,0,0,0,3,0,3,0.42857142857142855,1,0.0,0,0,0,0,0,0,0,3,0,0,3,1
10322,90712,sKygNm7l33RvePXhMRKhT8eWlgq4D2Uu,G8EPVSXsOYB5YQWZGiz1aVq5Pgr2GrQu,7,2,1,0,1,0,8,1,13,1.8571428571428572,1,0.0,0,1,0,1,2,0,0,8,1,2,11,1
10323,90714,F56VIhO1QqwJ2EV8tGyI5l1mo3yf3Tk3,bWdj2GDclj5ofokWjzoa5jAwMkxCykd6,3,2,0,0,0,0,2,0,4,0.5714285714285714,1,0.0,0,0,0,0,2,0,0,2,0,0,4,1
10324,90716,D03u0gED7VbQRZXbOTEY3B3RSnOHMTwX,G8EPVSXsOYB5YQWZGiz1aVq5Pgr2GrQu,4,4,1,0,1,0,1,0,7,1.0,1,0.0,0,1,0,1,4,0,0,1,0,2,5,1
10325,90718,tOwol93HcvuFb5zloOErYW1pE3AivbGE,bWdj2GDclj5ofokWjzoa5jAwMkxCykd6,1,0,0,0,0,0,1,0,1,0.14285714285714285,1,0.0,0,0,0,0,0,0,0,1,0,0,1,1
10326,90720,tOwol93HcvuFb5zloOErYW1pE3AivbGE,RXDvfPUBYFlVdlueBFbLW0mhhAyGEqpt,6,2,1,0,1,0,3,0,7,1.0,1,0.0,0,1,0,1,2,0,0,3,0,2,5,1
10327,90722,1UXy9epSRpZ4kgvfm7ijkVKWuglHemTQ,SpATywNh6bZuzm8s1ceuBUnMUAeoAHHw,5,2,1,0,1,0,6,0,10,1.4285714285714286,1,0.0,0,1,0,1,2,0,0,6,0,2,8,0
10328,90729,4TzA065DYK6LuKsj03IdWmVVHtLP4pD7,SpATywNh6bZuzm8s1ceuBUnMUAeoAHHw,7,5,2,0,2,0,4,0,13,1.8571428571428572,2,0.0,0,2,0,2,5,0,0,4,0,4,9,1
10329,90741,w5OdJoQZNGUVPiCQDXg0Vd0yo9ewUzmW,RXDvfPUBYFlVdlueBFbLW0mhhAyGEqpt,14,10,7,12,4,0,2,0,35,5.0,2,0.0,1,7,12,4,9,0,0,2,0,24,11,1
10330,90743,Y5C6JW9FcrJIhkFtmu7KcSC7Zibilzs4,RXDvfPUBYFlVdlueBFbLW0mhhAyGEqpt,14,15,10,0,4,2,11,2,44,6.285714285714286,2,0.0,0,10,0,4,15,2,0,11,2,14,30,1
10331,90746,ldckbcGV67YBoSN68pz7hDadzOTSpXE4,G8EPVSXsOYB5YQWZGiz1aVq5Pgr2GrQu,8,26,8,12,6,0,3,0,55,7.857142857142857,3,0.0,6,8,11,6,20,0,1,3,0,31,24,1
10332,90747,4f6gBunWwjsaAgYwinaGIAK95dQig1Sv,bWdj2GDclj5ofokWjzoa5jAwMkxCykd6,1,0,0,0,0,0,1,0,1,0.14285714285714285,1,0.0,0,0,0,0,0,0,0,1,0,0,1,1
10333,90749,Y5EybULOrY5dAmMMQWE7bK5wg4bsR2Lr,bWdj2GDclj5ofokWjzoa5jAwMkxCykd6,12,32,17,60,3,61,21,2,196,28.0,5,0.0,3,17,58,3,29,61,2,21,2,81,115,1
10334,90755,KQaABjEuQepl9FAcsVuUoYwnLleiOaUh,bWdj2GDclj5ofokWjzoa5jAwMkxCykd6,4,4,1,0,2,0,1,0,8,1.1428571428571428,1,0.0,2,1,0,2,2,0,0,1,0,5,3,1
10335,90757,wwEAB1ez2GqscQ96613pzqpcm4gmgk2z,bWdj2GDclj5ofokWjzoa5jAwMkxCykd6,9,13,3,0,5,0,2,0,23,3.2857142857142856,1,0.0,5,3,0,5,8,0,0,2,0,13,10,1
10336,90760,LknZf5R0kFesJr0Rm2KEqD235TVmngp0,SpATywNh6bZuzm8s1ceuBUnMUAeoAHHw,13,11,0,14,0,57,8,1,91,13.0,1,0.0,2,0,11,0,9,57,3,8,1,13,78,1
10337,90761,l4s4x0272kzhcEfgCvz1VNYYSzsAqk0d,G8EPVSXsOYB5YQWZGiz1aVq5Pgr2GrQu,11,8,4,0,3,3,6,0,24,3.4285714285714284,2,0.0,0,4,0,3,8,3,0,6,0,7,17,1
10338,90765,pGY1w8eP7I4lbateXReA0flFyTJRZgPr,G8EPVSXsOYB5YQWZGiz1aVq5Pgr2GrQu,6,1,1,0,1,0,3,0,6,0.8571428571428571,1,0.0,0,1,0,1,1,0,0,3,0,2,4,1
10339,90770,3CsUz8mRFoFNKmkeENo8HuDQSH05lxmZ,G8EPVSXsOYB5YQWZGiz1aVq5Pgr2GrQu,3,0,0,0,0,0,6,0,6,0.8571428571428571,2,0.0,0,0,0,0,0,0,0,6,0,0,6,1
10340,90773,D0SRTJhzsGGnKbIKtAcGeOVG46CDAXxq,SpATywNh6bZuzm8s1ceuBUnMUAeoAHHw,7,8,5,0,3,0,3,0,19,2.7142857142857144,2,0.0,0,5,0,3,8,0,0,3,0,8,11,1
10341,90782,LeyecjAY6mg5LvZFKVpB5z5Vy8PSThxU,SpATywNh6bZuzm8s1ceuBUnMUAeoAHHw,7,6,2,0,2,0,2,0,12,1.7142857142857142,1,0.0,0,2,0,2,6,0,0,2,0,4,8,1
10342,90788,AhMXiVok13ZjNF4gspHPwIDZecQgiWpM,RXDvfPUBYFlVdlueBFbLW0mhhAyGEqpt,1,0,0,0,0,0,1,0,1,0.14285714285714285,1,0.0,0,0,0,0,0,0,0,1,0,0,1,1
10343,90789,bEGwB6bxwamH303rlcp1dTooqcWaF93C,SpATywNh6bZuzm8s1ceuBUnMUAeoAHHw,20,31,3,20,3,19,15,1,92,13.142857142857142,6,0.0,15,3,17,3,16,19,3,15,1,38,54,0
10344,90790,CdOlESGB1DzB9C16eeGe1UhXPsjHWQGW,SpATywNh6bZuzm8s1ceuBUnMUAeoAHHw,13,9,5,13,3,10,3,0,43,6.142857142857143,1,0.0,3,5,12,3,6,10,1,3,0,23,20,1
10345,90794,J38SfNJhh0josFdljlBSrhXRogu9GoqX,G8EPVSXsOYB5YQWZGiz1aVq5Pgr2GrQu,23,56,25,30,7,0,8,0,126,18.0,1,0.0,17,25,23,7,39,0,7,8,0,72,54,1
10346,90799,4LhW0gpz7wD6EZALKqoopL1swej6F6kT,RXDvfPUBYFlVdlueBFbLW0mhhAyGEqpt,9,10,3,0,1,0,6,1,21,3.0,3,0.0,0,3,0,1,10,0,0,6,1,4,17,1
10347,90800,HDDfG2CBGcAcxX3ycvOXstF4TGeBz4ZN,G8EPVSXsOYB5YQWZGiz1aVq5Pgr2GrQu,8,4,3,0,3,0,1,0,11,1.5714285714285714,1,0.0,0,3,0,3,4,0,0,1,0,6,5,1
10348,90801,D819UH6GjR554Q5KsACZVpoO8UDhricE,SpATywNh6bZuzm8s1ceuBUnMUAeoAHHw,7,3,2,0,2,0,2,0,9,1.2857142857142858,1,0.0,0,2,0,2,3,0,0,2,0,4,5,1
10349,90811,I2obse1Zq7Nau4sY1YPG5mgE6G3RFVMC,G8EPVSXsOYB5YQWZGiz1aVq5Pgr2GrQu,6,5,4,0,4,0,1,0,14,2.0,1,0.0,0,4,0,4,5,0,0,1,0,8,6,1
10350,90815,iXNm5ZN5LzdJniA2N9BJpNV8u0KUat63,SpATywNh6bZuzm8s1ceuBUnMUAeoAHHw,10,20,7,0,3,0,5,0,35,5.0,2,0.0,0,7,0,3,20,0,0,5,0,10,25,1
10351,90821,pNgGoRZfmUo4wkTYP23egMC3LUn4nA2d,SpATywNh6bZuzm8s1ceuBUnMUAeoAHHw,12,14,6,0,2,1,10,0,33,4.714285714285714,1,0.0,0,6,0,2,14,1,0,10,0,8,25,1
10352,90822,X6bWAuG7i4cSWjzWor8wb8Jqxiw7Y3fM,G8EPVSXsOYB5YQWZGiz1aVq5Pgr2GrQu,20,12,1,36,1,3,2,0,55,7.857142857142857,1,0.0,1,1,29,1,11,3,7,2,0,32,23,1
10353,90824,5vkNIYp2bYY1LtZU7tLxethQegJYgNo1,G8EPVSXsOYB5YQWZGiz1aVq5Pgr2GrQu,4,8,1,0,3,0,1,0,13,1.8571428571428572,1,0.0,6,1,0,3,2,0,0,1,0,10,3,1
10354,90825,06UqVup6ex1qeNp4vJ1m9FBAIaawxt3L,bWdj2GDclj5ofokWjzoa5jAwMkxCykd6,8,5,3,0,2,0,3,0,13,1.8571428571428572,1,0.0,0,3,0,2,5,0,0,3,0,5,8,1
10355,90828,l8KXVCEZbv28Mkels2ilOG7I8qSBHRqR,RXDvfPUBYFlVdlueBFbLW0mhhAyGEqpt,7,8,1,0,1,0,1,0,11,1.5714285714285714,1,0.0,2,1,0,1,6,0,0,1,0,4,7,1
10356,90832,Qsw20Q5PeTwiq1PxYe0LRVTTkwenKksO,SpATywNh6bZuzm8s1ceuBUnMUAeoAHHw,13,34,7,7,1,6,8,0,63,9.0,5,0.0,6,7,6,1,28,6,1,8,0,20,43,1
10357,90839,5ZwXPjJ7Hpe1sEszjUirFtHlC571EgXW,bWdj2GDclj5ofokWjzoa5jAwMkxCykd6,5,8,1,0,1,0,2,0,12,1.7142857142857142,1,0.0,1,1,0,1,7,0,0,2,0,3,9,1
10358,90848,KrsnHficdQyIsUU0OmJhlaIOPfA02mNz,bWdj2GDclj5ofokWjzoa5jAwMkxCykd6,1,0,0,0,0,0,2,0,2,0.2857142857142857,1,0.0,0,0,0,0,0,0,0,2,0,0,2,1
10359,90850,GWNKqanO7Bwv22F8soWqeHa4Wn2DiLGZ,RXDvfPUBYFlVdlueBFbLW0mhhAyGEqpt,36,32,10,61,8,0,1,0,112,16.0,1,0.0,6,10,59,8,26,0,2,1,0,83,29,1
10360,90855,KogrHROquIJLSXIZqzhYU9Hcb9zVebwT,SpATywNh6bZuzm8s1ceuBUnMUAeoAHHw,28,25,13,22,5,28,7,1,101,14.428571428571429,3,0.0,7,13,19,5,18,28,3,7,1,44,57,1
10361,90856,t4mBW06R5u34zTzy1YY0BqHR3HtrMlxW,bWdj2GDclj5ofokWjzoa5jAwMkxCykd6,17,18,9,20,3,11,15,2,78,11.142857142857142,3,0.0,3,9,19,3,15,11,1,15,2,34,44,1
10362,90861,sD4VJ3Pl6fUXDlwP0L4osteHu9UdT1hV,SpATywNh6bZuzm8s1ceuBUnMUAeoAHHw,6,3,1,0,1,0,4,0,9,1.2857142857142858,1,0.0,0,1,0,1,3,0,0,4,0,2,7,1
10363,90863,OuHC5cgkNZAxQ8FoVKCX7NbOcZdwtnqB,SpATywNh6bZuzm8s1ceuBUnMUAeoAHHw,8,11,7,0,4,0,5,0,27,3.857142857142857,1,0.0,0,7,0,4,11,0,0,5,0,11,16,1
10364,90872,nL9fwNKEZP1vFZxFJDQtGgReRFz5AlyD,SpATywNh6bZuzm8s1ceuBUnMUAeoAHHw,8,8,3,0,1,2,6,2,22,3.142857142857143,1,0.0,4,3,0,1,4,2,0,6,2,8,14,1
10365,90875,Qyq18jm4urtOwW9jbqpJJDMX3auyGXK1,SpATywNh6bZuzm8s1ceuBUnMUAeoAHHw,4,2,0,0,0,0,2,0,4,0.5714285714285714,1,0.0,0,0,0,0,2,0,0,2,0,0,4,1
10366,90877,C9Wh4VK0YDPz8OcZLvDPXEYgZvrO7fON,SpATywNh6bZuzm8s1ceuBUnMUAeoAHHw,4,2,1,0,1,0,1,0,5,0.7142857142857143,1,0.0,0,1,0,1,2,0,0,1,0,2,3,1
10367,90878,vIBcYbs1BLdmaaP30fcE2FS7kB7v7QRn,bWdj2GDclj5ofokWjzoa5jAwMkxCykd6,9,20,11,0,1,3,13,0,48,6.857142857142857,2,0.0,2,11,0,1,18,3,0,13,0,14,34,1
10368,90880,YAHRUvgTShfsjnOmO618HsecfyEFFriC,SpATywNh6bZuzm8s1ceuBUnMUAeoAHHw,5,15,3,0,2,0,2,0,22,3.142857142857143,1,0.0,0,3,0,2,15,0,0,2,0,5,17,1
10369,90885,kFMdrBn76woeFkLVMgIjnzYIkBkN2rjs,SpATywNh6bZuzm8s1ceuBUnMUAeoAHHw,5,5,3,0,2,0,1,0,11,1.5714285714285714,1,0.0,0,3,0,2,5,0,0,1,0,5,6,1
10370,90887,GVUw4u2UhYktwQlrJTo9fWmDS2qzWpQC,SpATywNh6bZuzm8s1ceuBUnMUAeoAHHw,30,44,3,30,3,115,21,1,217,31.0,6,0.0,13,3,26,3,31,115,4,21,1,45,172,0
10371,90905,R3vdKqOlKdhOGFVIJPoEGMoTbxTcB9bc,SpATywNh6bZuzm8s1ceuBUnMUAeoAHHw,16,10,7,5,6,1,17,1,47,6.714285714285714,3,0.0,0,7,4,6,10,1,1,17,1,17,30,1
10372,90910,8mVKxRgJ8A1rq04XffdKXYfatdM3yRYE,RXDvfPUBYFlVdlueBFbLW0mhhAyGEqpt,8,4,3,0,2,0,2,0,11,1.5714285714285714,1,0.0,0,3,0,2,4,0,0,2,0,5,6,1
10373,90915,HPaDTzk2xymxbpoa0VdcxdHl3uFfOfZk,G8EPVSXsOYB5YQWZGiz1aVq5Pgr2GrQu,1,0,0,0,0,0,1,0,1,0.14285714285714285,1,0.0,0,0,0,0,0,0,0,1,0,0,1,1
10374,90916,nMBGX3nqIipxPIzBJdOaTEwO6lPkrYAP,SpATywNh6bZuzm8s1ceuBUnMUAeoAHHw,9,12,8,0,2,2,8,0,32,4.571428571428571,1,0.0,0,8,0,2,12,2,0,8,0,10,22,1
10375,90918,P8T670PRvYsTF14RAy04Ypel9tVdSt4W,SpATywNh6bZuzm8s1ceuBUnMUAeoAHHw,14,16,3,14,2,1,7,1,44,6.285714285714286,1,0.0,11,3,13,2,5,1,1,7,1,29,15,1
10376,90926,mfSlhGs8TOW9c66xAJCzRN5uCUec3OQS,G8EPVSXsOYB5YQWZGiz1aVq5Pgr2GrQu,4,3,0,0,0,0,1,0,4,0.5714285714285714,1,0.0,0,0,0,0,3,0,0,1,0,0,4,1
10377,90938,qA7txaCsDINVj5jwLkjFxBdOEKcLbkUC,bWdj2GDclj5ofokWjzoa5jAwMkxCykd6,4,8,2,0,2,0,1,0,13,1.8571428571428572,1,0.0,4,2,0,2,4,0,0,1,0,8,5,1
10378,90939,hRiaJRtvIOFlbihdEsv906GxXONnrFfr,SpATywNh6bZuzm8s1ceuBUnMUAeoAHHw,6,11,2,0,1,0,7,0,21,3.0,1,0.0,1,2,0,1,10,0,0,7,0,4,17,1
10379,90951,bmpOpVuzweuue9KaoQwJh1soVS4PCMAj,RXDvfPUBYFlVdlueBFbLW0mhhAyGEqpt,16,7,4,15,5,1,4,0,36,5.142857142857143,1,0.0,2,4,14,5,5,1,1,4,0,25,11,1
10380,90953,hIjUruVScjiqfQ0ERHHhB6StdCOggvbB,RXDvfPUBYFlVdlueBFbLW0mhhAyGEqpt,18,14,5,29,3,0,5,1,57,8.142857142857142,1,0.0,2,5,29,3,12,0,0,5,1,39,18,1
10381,90959,bAPyDIJfdAxQ8AHvo3QeBgdKri2hlVLQ,G8EPVSXsOYB5YQWZGiz1aVq5Pgr2GrQu,1,0,0,0,0,0,1,0,1,0.14285714285714285,1,0.0,0,0,0,0,0,0,0,1,0,0,1,1
10382,90961,h3p30ndtRdIyBMRidOGn8LuOdbmfUl5i,bWdj2GDclj5ofokWjzoa5jAwMkxCykd6,4,2,1,0,0,0,2,0,5,0.7142857142857143,1,0.0,0,1,0,0,2,0,0,2,0,1,4,1
10383,90962,1x68B6ELAKzkC8Z87epaTU9JLE90xrom,SpATywNh6bZuzm8s1ceuBUnMUAeoAHHw,6,10,0,5,0,0,2,0,17,2.4285714285714284,1,0.0,7,0,5,0,3,0,0,2,0,12,5,1
10384,90964,UEGgGFOddxp081siu8g5s2awm2LAgg2C,G8EPVSXsOYB5YQWZGiz1aVq5Pgr2GrQu,5,3,0,0,0,0,2,0,5,0.7142857142857143,1,0.0,0,0,0,0,3,0,0,2,0,0,5,1
10385,90967,8nT76hrzyl8ZAUdI7W6kfrIzHxI3puKM,SpATywNh6bZuzm8s1ceuBUnMUAeoAHHw,1,0,0,0,0,0,1,0,1,0.14285714285714285,1,0.0,0,0,0,0,0,0,0,1,0,0,1,1
10386,90968,1YzhwwWLdVM4bzJMYH49O7nplNitMAxK,SpATywNh6bZuzm8s1ceuBUnMUAeoAHHw,1,0,0,0,0,0,1,0,1,0.14285714285714285,1,0.0,0,0,0,0,0,0,0,1,0,0,1,1
10387,90975,ABlVlNkPi30ZMlFLrcsAhP5jZW6rJhdZ,bWdj2GDclj5ofokWjzoa5jAwMkxCykd6,6,3,2,0,1,0,2,0,8,1.1428571428571428,2,0.0,0,2,0,1,3,0,0,2,0,3,5,1
10388,90976,JgACfbSPbgZxvcoTB7IZVAGzYc3ZbdQl,G8EPVSXsOYB5YQWZGiz1aVq5Pgr2GrQu,18,19,0,0,1,2,8,1,31,4.428571428571429,2,0.0,2,0,0,1,17,2,0,8,1,3,28,1
10389,90980,iKjkh1YrFzq5OB5DSHkFwl9ZdnaqKanG,SpATywNh6bZuzm8s1ceuBUnMUAeoAHHw,5,4,1,0,1,1,2,0,9,1.2857142857142858,1,0.0,1,1,0,1,3,1,0,2,0,3,6,1
10390,90982,P9uew3S2WCP2kqlooRwkV6WK6JXjnFW1,SpATywNh6bZuzm8s1ceuBUnMUAeoAHHw,7,4,1,0,0,1,4,1,11,1.5714285714285714,1,0.0,0,1,0,0,4,1,0,4,1,1,10,1
10391,90990,h3p30ndtRdIyBMRidOGn8LuOdbmfUl5i,SpATywNh6bZuzm8s1ceuBUnMUAeoAHHw,13,8,3,12,2,3,4,1,33,4.714285714285714,1,0.0,3,3,12,2,5,3,0,4,1,20,13,1
10392,90991,MSVIULFa47b8oOycWVWVcPhuMCdDd5NZ,SpATywNh6bZuzm8s1ceuBUnMUAeoAHHw,25,32,12,20,4,6,17,1,92,13.142857142857142,3,0.0,6,12,18,4,26,6,2,17,1,40,52,1
10393,90996,XjO6wB2Z4egz4mV0GhT9a1BmKnwX0iZQ,SpATywNh6bZuzm8s1ceuBUnMUAeoAHHw,7,7,1,0,1,0,2,0,11,1.5714285714285714,1,0.0,3,1,0,1,4,0,0,2,0,5,6,1
10394,91000,69mjZoNGtUdd47OHaI2iQubsVwSBE5CT,SpATywNh6bZuzm8s1ceuBUnMUAeoAHHw,5,3,0,0,0,0,5,0,8,1.1428571428571428,1,0.0,0,0,0,0,3,0,0,5,0,0,8,1
10395,91003,iJftBP3zncmjUCwGWSZ77IUrDb3Dt8rz,bWdj2GDclj5ofokWjzoa5jAwMkxCykd6,4,2,1,0,1,0,1,0,5,0.7142857142857143,1,0.0,0,1,0,1,2,0,0,1,0,2,3,1
10396,91005,h83s4W6wEAiVAQw1YsiHYJozxIiZHoSp,G8EPVSXsOYB5YQWZGiz1aVq5Pgr2GrQu,5,2,1,0,1,1,2,0,7,1.0,1,0.0,0,1,0,1,2,1,0,2,0,2,5,1
10397,91007,fnbOlL6zM0TdpgW3GvlsPHFVJnQSFTyA,SpATywNh6bZuzm8s1ceuBUnMUAeoAHHw,10,13,7,0,6,0,4,0,30,4.285714285714286,2,0.0,0,7,0,6,13,0,0,4,0,13,17,1
10398,91008,UB0nPfUwWgaRThrVeKik4SwdfP63TRHx,SpATywNh6bZuzm8s1ceuBUnMUAeoAHHw,14,29,2,18,1,4,6,0,60,8.571428571428571,2,0.0,5,2,15,1,24,4,3,6,0,23,37,1
10399,91011,UyjpsvsOggyMosfJEuRSeI96eHcBNf41,SpATywNh6bZuzm8s1ceuBUnMUAeoAHHw,6,4,2,3,1,0,1,0,11,1.5714285714285714,1,0.0,1,2,3,1,3,0,0,1,0,7,4,1
10400,91013,bqWpav7ocOhCfb3xc4QgAvBDK5g8BmiZ,bWdj2GDclj5ofokWjzoa5jAwMkxCykd6,11,10,8,0,2,0,4,0,24,3.4285714285714284,2,0.0,0,8,0,2,10,0,0,4,0,10,14,1
10401,91014,dLJ4i4UwjNqr5YPEuySq1h5THPMNjgjJ,SpATywNh6bZuzm8s1ceuBUnMUAeoAHHw,10,8,6,0,5,0,3,0,22,3.142857142857143,2,0.0,0,6,0,5,8,0,0,3,0,11,11,0
10402,91016,KyDM2Ub30UlLqAgwV3Kdja9FjS49F2cL,G8EPVSXsOYB5YQWZGiz1aVq5Pgr2GrQu,4,2,1,0,1,0,1,0,5,0.7142857142857143,1,0.0,0,1,0,1,2,0,0,1,0,2,3,1
10403,91017,zrZWN5ij2KPpDRaiyWWPqj2Z1YuwvTvt,SpATywNh6bZuzm8s1ceuBUnMUAeoAHHw,10,19,7,0,4,5,14,3,52,7.428571428571429,3,0.0,0,7,0,4,19,5,0,14,3,11,41,1
10404,91022,BvTUeUSX8ehdvYqgk6h69dy9HSlBWzXM,G8EPVSXsOYB5YQWZGiz1aVq5Pgr2GrQu,7,31,7,0,3,0,9,0,50,7.142857142857143,1,0.0,3,7,0,3,28,0,0,9,0,13,37,1
10405,91023,ZZzQCzIgfdjMh5GZMagmPbKqCFsmjzqD,SpATywNh6bZuzm8s1ceuBUnMUAeoAHHw,5,2,1,0,1,0,2,0,6,0.8571428571428571,1,0.0,0,1,0,1,2,0,0,2,0,2,4,1
10406,91025,nTeEg9IpivRmreYWiIjMvVlevTAaGMey,SpATywNh6bZuzm8s1ceuBUnMUAeoAHHw,7,5,3,0,2,0,2,0,12,1.7142857142857142,2,0.0,0,3,0,2,5,0,0,2,0,5,7,1
10407,91029,tvqXd520K684wy1KQ0GBsByYs78H3st9,RXDvfPUBYFlVdlueBFbLW0mhhAyGEqpt,1,0,0,0,0,0,1,0,1,0.14285714285714285,1,0.0,0,0,0,0,0,0,0,1,0,0,1,1
10408,91037,mJHwEQabAWgiuu06ZP8aR46SMutI8kEA,SpATywNh6bZuzm8s1ceuBUnMUAeoAHHw,5,2,1,0,1,0,3,0,7,1.0,1,0.0,0,1,0,1,2,0,0,3,0,2,5,1
10409,91045,dB4WDfiw60nGNNAG9g9zNz1Z102rMluZ,SpATywNh6bZuzm8s1ceuBUnMUAeoAHHw,19,12,7,12,4,2,7,1,45,6.428571428571429,2,0.0,2,7,11,4,10,2,1,7,1,24,21,1
10410,91050,Y5EybULOrY5dAmMMQWE7bK5wg4bsR2Lr,RXDvfPUBYFlVdlueBFbLW0mhhAyGEqpt,13,8,7,0,4,0,1,0,20,2.857142857142857,1,0.0,0,7,0,4,8,0,0,1,0,11,9,1
10411,91054,EjR7iUwsiJVzqJrC7t3D1JWVRCEYToml,bWdj2GDclj5ofokWjzoa5jAwMkxCykd6,8,7,1,0,2,24,5,1,40,5.714285714285714,1,0.0,2,1,0,2,5,24,0,5,1,5,35,1
10412,91058,JckOmRdQvE0R24dfuPeUe2DTKfe4tF0h,G8EPVSXsOYB5YQWZGiz1aVq5Pgr2GrQu,2,0,0,0,0,0,4,0,4,0.5714285714285714,1,0.0,0,0,0,0,0,0,0,4,0,0,4,0
10413,91059,YJQCaDByfjoOhBSQklKuzWe4YXgqBr84,SpATywNh6bZuzm8s1ceuBUnMUAeoAHHw,5,3,2,0,2,0,3,0,10,1.4285714285714286,2,0.0,0,2,0,2,3,0,0,3,0,4,6,1
10414,91061,4BM2X3vjiB0KMTdSgJPbb92aYDlCdKqm,SpATywNh6bZuzm8s1ceuBUnMUAeoAHHw,1,0,0,0,0,0,5,0,5,0.7142857142857143,1,0.0,0,0,0,0,0,0,0,5,0,0,5,1
10415,91063,gzBj4rBVIL1BI1dJCkBf6DnSNlOqQIwg,SpATywNh6bZuzm8s1ceuBUnMUAeoAHHw,7,8,0,0,0,4,4,0,16,2.2857142857142856,1,0.0,0,0,0,0,8,4,0,4,0,0,16,1
10416,91066,HvCZ1bV9L7D0erySzp1UH1mW8tuWfYPw,SpATywNh6bZuzm8s1ceuBUnMUAeoAHHw,7,11,5,0,3,3,2,0,24,3.4285714285714284,2,0.0,0,5,0,3,11,3,0,2,0,8,16,1
10417,91070,G1AtiTSNDONQwl0Hl81VRJCbBPxu3bhI,bWdj2GDclj5ofokWjzoa5jAwMkxCykd6,7,4,2,0,1,5,6,0,18,2.5714285714285716,1,0.0,0,2,0,1,4,5,0,6,0,3,15,0
10418,91078,KYLGj0LJWlbOKu0N6ntmca4SUIisJJd9,SpATywNh6bZuzm8s1ceuBUnMUAeoAHHw,1,0,0,0,0,0,4,0,4,0.5714285714285714,1,0.0,0,0,0,0,0,0,0,4,0,0,4,1
10419,91081,U04y5vFf0AfyJVGIOJHlryTyRQEOm5pT,RXDvfPUBYFlVdlueBFbLW0mhhAyGEqpt,6,2,1,0,1,0,4,0,8,1.1428571428571428,2,0.0,0,1,0,1,2,0,0,4,0,2,6,1
10420,91105,ZxvROepgS8uZpWYEjrhlsfyND4f2cw2o,SpATywNh6bZuzm8s1ceuBUnMUAeoAHHw,43,46,27,44,11,3,29,2,162,23.142857142857142,4,0.0,13,27,35,11,33,3,9,29,2,86,76,0
10421,91108,nJUQO0awidSkRki1FSo1rhLXdIxrzKfS,G8EPVSXsOYB5YQWZGiz1aVq5Pgr2GrQu,22,30,5,34,4,8,12,1,94,13.428571428571429,5,0.0,5,5,28,4,25,8,6,12,1,42,52,0
10422,91110,9jYO2Na9DSPgmUyIaCnH33KjtnbI2MPN,SpATywNh6bZuzm8s1ceuBUnMUAeoAHHw,8,4,3,0,3,0,1,0,11,1.5714285714285714,1,0.0,0,3,0,3,4,0,0,1,0,6,5,1
10423,91111,Bx6FqxWgsWymyOwxFcEQZn8BP7GPaoEm,G8EPVSXsOYB5YQWZGiz1aVq5Pgr2GrQu,8,5,3,0,1,0,12,0,21,3.0,1,0.0,0,3,0,1,5,0,0,12,0,4,17,1
10424,91115,fAwXW6DQAyNHjMN17jlyBSVcZRO4da21,SpATywNh6bZuzm8s1ceuBUnMUAeoAHHw,14,32,12,14,7,3,5,0,73,10.428571428571429,2,0.0,4,12,12,7,28,3,2,5,0,35,38,1
10425,91116,K1IqR71Sh84XFi6onZppsnD3thTHQIxV,SpATywNh6bZuzm8s1ceuBUnMUAeoAHHw,13,16,11,0,8,1,11,1,48,6.857142857142857,3,0.0,0,11,0,8,16,1,0,11,1,19,29,1
10426,91117,BbiSpjLUYXccDuntMMtC8mx0riONNKqb,bWdj2GDclj5ofokWjzoa5jAwMkxCykd6,5,2,1,0,1,0,2,0,6,0.8571428571428571,1,0.0,0,1,0,1,2,0,0,2,0,2,4,1
10427,91121,7LnOg1xHmRDTcvzCdFBumEhAPUujuxnu,SpATywNh6bZuzm8s1ceuBUnMUAeoAHHw,7,12,1,0,1,0,4,0,18,2.5714285714285716,1,0.0,0,1,0,1,12,0,0,4,0,2,16,1
10428,91124,EiO5bky9R1Iqlpv4ItUpPBUgGb1eJItE,RXDvfPUBYFlVdlueBFbLW0mhhAyGEqpt,1,0,0,0,0,0,1,0,1,0.14285714285714285,1,0.0,0,0,0,0,0,0,0,1,0,0,1,1
10429,91127,Dtyef0XPp5AB6qcxARHBVaIqOwKhnCJD,RXDvfPUBYFlVdlueBFbLW0mhhAyGEqpt,17,17,12,14,6,13,6,0,68,9.714285714285714,1,0.0,1,12,13,6,16,13,1,6,0,32,36,1
10430,91131,q5brbl1IUGTW0QCDlsOmPM8P083V7zR9,SpATywNh6bZuzm8s1ceuBUnMUAeoAHHw,1,0,0,0,0,0,1,0,1,0.14285714285714285,1,0.0,0,0,0,0,0,0,0,1,0,0,1,1
10431,91132,92Eer7xGYFDCorN4RAF4CYzwZt5RGCcT,SpATywNh6bZuzm8s1ceuBUnMUAeoAHHw,1,0,0,0,0,0,1,0,1,0.14285714285714285,1,0.0,0,0,0,0,0,0,0,1,0,0,1,1
10432,91143,hx5sJ7jwWSrYbv8AAwrwIYlkyA5lh0xw,SpATywNh6bZuzm8s1ceuBUnMUAeoAHHw,2,0,0,0,0,0,2,0,2,0.2857142857142857,1,0.0,0,0,0,0,0,0,0,2,0,0,2,1
10433,91145,im3SIH2rxe8iUb1VWEDrDsuvwOO0Qeuq,SpATywNh6bZuzm8s1ceuBUnMUAeoAHHw,1,0,0,0,0,0,1,0,1,0.14285714285714285,1,0.0,0,0,0,0,0,0,0,1,0,0,1,1
10434,91146,5kux74rVeqoEvbABYMpdIOO6ta3zLim7,SpATywNh6bZuzm8s1ceuBUnMUAeoAHHw,6,10,1,0,0,0,3,0,14,2.0,1,0.0,0,1,0,0,10,0,0,3,0,1,13,1
10435,91148,mirL98pOfRc0QA1dI8m4EOtFFog8KIsB,SpATywNh6bZuzm8s1ceuBUnMUAeoAHHw,6,11,2,0,0,0,3,0,16,2.2857142857142856,3,0.0,0,2,0,0,11,0,0,3,0,2,14,1
10436,91151,EpEDPL39pwbGw6HcHWJhf2GDqySvaN1h,SpATywNh6bZuzm8s1ceuBUnMUAeoAHHw,6,2,1,0,1,0,2,0,6,0.8571428571428571,1,0.0,0,1,0,1,2,0,0,2,0,2,4,1
10437,91158,B4jOMU8eQLApET1YBx1fXCzcdODxsgi8,bWdj2GDclj5ofokWjzoa5jAwMkxCykd6,7,9,1,0,2,0,2,0,14,2.0,1,0.0,2,1,0,2,7,0,0,2,0,5,9,1
10438,91159,O7hnrNbVuVSYYY4GiDlB8jr4kCwVIU3W,SpATywNh6bZuzm8s1ceuBUnMUAeoAHHw,1,0,0,0,0,0,7,0,7,1.0,1,0.0,0,0,0,0,0,0,0,7,0,0,7,1
10439,91160,urxyBMLwqPoccprp1W7NCQtPStGZDqxd,SpATywNh6bZuzm8s1ceuBUnMUAeoAHHw,5,2,1,0,1,0,4,0,8,1.1428571428571428,2,0.0,0,1,0,1,2,0,0,4,0,2,6,1
10440,91162,ORT6fH4QpWfdVApgOFbiZIUgnndzWNam,SpATywNh6bZuzm8s1ceuBUnMUAeoAHHw,21,30,20,14,12,3,6,0,85,12.142857142857142,3,0.0,6,20,11,12,24,3,3,6,0,49,36,0
10441,91167,XMtcnsDNasKCOMBWrsjCVH5NONQyEryR,bWdj2GDclj5ofokWjzoa5jAwMkxCykd6,21,42,23,122,7,0,12,0,206,29.428571428571427,3,0.0,12,23,118,7,30,0,4,12,0,160,46,0
10442,91171,XMIsZqrfw7qqk0EIVzNsPndKXVTScrCr,SpATywNh6bZuzm8s1ceuBUnMUAeoAHHw,16,22,10,17,4,5,7,1,66,9.428571428571429,1,0.0,6,10,15,4,16,5,2,7,1,35,31,1
10443,91172,EJfQNb5Mu8lcO1ocmk4PtmUhkW8FMGb9,RXDvfPUBYFlVdlueBFbLW0mhhAyGEqpt,7,10,4,0,2,0,3,0,19,2.7142857142857144,3,0.0,0,4,0,2,10,0,0,3,0,6,13,0
10444,91173,wdzOHZGShaydEKxmovJEzQ6EMiqynMte,SpATywNh6bZuzm8s1ceuBUnMUAeoAHHw,18,59,21,26,0,18,12,2,138,19.714285714285715,4,0.0,29,21,20,0,30,18,6,12,2,70,68,1
10445,91178,ogkoDosyBhbZAvybtPbmcuc4tjatNf2P,G8EPVSXsOYB5YQWZGiz1aVq5Pgr2GrQu,17,36,30,22,16,0,4,0,108,15.428571428571429,2,0.0,0,30,18,16,36,0,4,4,0,64,44,1
10446,91182,H1VDSbfLdFN8dYSqCsn4o54mYdltgayR,SpATywNh6bZuzm8s1ceuBUnMUAeoAHHw,1,0,0,0,0,0,1,0,1,0.14285714285714285,1,0.0,0,0,0,0,0,0,0,1,0,0,1,1
10447,91184,v5DL1tRN6AvAeQThFmEHNCo6sn5M6uIG,SpATywNh6bZuzm8s1ceuBUnMUAeoAHHw,12,14,6,19,4,0,1,0,44,6.285714285714286,1,0.0,5,6,17,4,9,0,2,1,0,32,12,1
10448,91190,HHjw6PARN0UbkiffbOwvG4RULtVIyY0R,bWdj2GDclj5ofokWjzoa5jAwMkxCykd6,1,0,0,0,0,0,1,0,1,0.14285714285714285,1,0.0,0,0,0,0,0,0,0,1,0,0,1,1
10449,91204,JwpnWAbXqqokshNbyxBH2QHaOUPb8wrj,G8EPVSXsOYB5YQWZGiz1aVq5Pgr2GrQu,11,24,1,0,1,1,11,2,40,5.714285714285714,2,0.0,1,1,0,1,23,1,0,11,2,3,37,0
10450,91207,37tZi453KKWhJoY7icXXq6XTM7CZX5cD,SpATywNh6bZuzm8s1ceuBUnMUAeoAHHw,14,16,0,21,0,3,10,2,52,7.428571428571429,1,0.0,4,0,17,0,12,3,4,10,2,21,31,1
10451,91208,tPYh43YRHAzuf09xESxSKtWvST0aCsjn,RXDvfPUBYFlVdlueBFbLW0mhhAyGEqpt,1,0,0,0,0,0,1,0,1,0.14285714285714285,1,0.0,0,0,0,0,0,0,0,1,0,0,1,1
10452,91214,Rd7eeroPlO4BVZv0bnl0CqHm3u7jCGNe,SpATywNh6bZuzm8s1ceuBUnMUAeoAHHw,12,17,8,0,6,6,4,0,41,5.857142857142857,1,0.0,0,8,0,6,17,6,0,4,0,14,27,1
10453,91215,AXWWqNDiRDejTjo5V7yUaMbjtzXKhlP0,bWdj2GDclj5ofokWjzoa5jAwMkxCykd6,6,5,2,0,1,3,3,0,14,2.0,1,0.0,2,2,0,1,3,3,0,3,0,5,9,1
10454,91217,Zw1bdKbgaMzUzlqlieQSaucEQ8wggZlx,G8EPVSXsOYB5YQWZGiz1aVq5Pgr2GrQu,9,14,5,0,3,0,3,0,25,3.5714285714285716,1,0.0,0,5,0,3,14,0,0,3,0,8,17,1
10455,91220,TXdA343riqqgy7iMdaooNvyNV5wjOdTg,SpATywNh6bZuzm8s1ceuBUnMUAeoAHHw,1,0,0,0,0,0,3,0,3,0.42857142857142855,1,0.0,0,0,0,0,0,0,0,3,0,0,3,1
10456,91221,2FMy3BDMeRecSDtTTnOKB2d19YsmeIUm,SpATywNh6bZuzm8s1ceuBUnMUAeoAHHw,17,15,9,6,5,12,11,2,60,8.571428571428571,1,0.0,4,9,6,5,11,12,0,11,2,24,36,1
10457,91228,14pD3OA8ZEvWCgDfU1fYkv0M9pXxNW5u,SpATywNh6bZuzm8s1ceuBUnMUAeoAHHw,14,34,0,19,0,11,14,5,83,11.857142857142858,2,0.0,15,0,17,0,19,11,2,14,5,32,51,0
10458,91243,eds8bJvJ9xWp5J9qVgS3pSKJpcp9ssMO,RXDvfPUBYFlVdlueBFbLW0mhhAyGEqpt,18,22,11,20,5,0,5,0,63,9.0,1,0.0,4,11,20,5,18,0,0,5,0,40,23,1
10459,91250,XdYuk6m8JAApvXFcBONfmeC52I0301IJ,SpATywNh6bZuzm8s1ceuBUnMUAeoAHHw,3,2,0,0,0,0,1,0,3,0.42857142857142855,1,0.0,0,0,0,0,2,0,0,1,0,0,3,1
10460,91251,69mjZoNGtUdd47OHaI2iQubsVwSBE5CT,RXDvfPUBYFlVdlueBFbLW0mhhAyGEqpt,7,3,2,0,1,1,6,1,14,2.0,2,0.0,0,2,0,1,3,1,0,6,1,3,11,1
10461,91253,XdYuk6m8JAApvXFcBONfmeC52I0301IJ,G8EPVSXsOYB5YQWZGiz1aVq5Pgr2GrQu,3,2,0,0,0,0,1,0,3,0.42857142857142855,1,0.0,0,0,0,0,2,0,0,1,0,0,3,1
10462,91254,3BYgVMhPAaxlk6STVmLlShJjZEZk9Ygh,G8EPVSXsOYB5YQWZGiz1aVq5Pgr2GrQu,7,5,4,8,2,0,1,0,20,2.857142857142857,1,0.0,0,4,6,2,5,0,2,1,0,12,8,1
10463,91257,WCmDosmdgfMjDVmsfhMjruGatZmceBZ1,G8EPVSXsOYB5YQWZGiz1aVq5Pgr2GrQu,10,10,1,0,2,2,8,2,25,3.5714285714285716,1,0.0,4,1,0,2,6,2,0,8,2,7,18,1
10464,91263,mpFcyQQmc8dk989EyC0qjuZYiRIdPGUA,G8EPVSXsOYB5YQWZGiz1aVq5Pgr2GrQu,15,14,11,18,5,0,2,0,50,7.142857142857143,2,0.0,0,11,14,5,14,0,4,2,0,30,20,1
10465,91264,Ydgz8POU25ETYijca209j0OeGw9lAoWU,RXDvfPUBYFlVdlueBFbLW0mhhAyGEqpt,6,3,2,0,1,1,4,1,12,1.7142857142857142,1,0.0,0,2,0,1,3,1,0,4,1,3,9,1
10466,91270,1g8yBUc3cHuCmwlbkVdrck4LA6Kk4jp8,SpATywNh6bZuzm8s1ceuBUnMUAeoAHHw,1,0,0,0,0,0,1,0,1,0.14285714285714285,1,0.0,0,0,0,0,0,0,0,1,0,0,1,1
10467,91271,xsGCEWhbZlUdlgrI9YmAsQkfbCuoHlqr,SpATywNh6bZuzm8s1ceuBUnMUAeoAHHw,3,2,0,0,0,0,1,0,3,0.42857142857142855,1,0.0,0,0,0,0,2,0,0,1,0,0,3,1
10468,91272,Xl4Lzddy8Aw3656QCmyajshZUF8lGm25,G8EPVSXsOYB5YQWZGiz1aVq5Pgr2GrQu,8,5,3,0,1,4,3,1,17,2.4285714285714284,1,0.0,0,3,0,1,5,4,0,3,1,4,13,1
10469,91274,Ub05s2SQ9ZHQTwcGaeWGVwMVL3ugFxRh,SpATywNh6bZuzm8s1ceuBUnMUAeoAHHw,18,19,8,11,3,2,9,1,53,7.571428571428571,2,0.0,8,8,11,3,11,2,0,9,1,30,23,1
10470,91278,g5Cdwy5RdXfNsnVJb5dTAjZFbf2MEVG0,bWdj2GDclj5ofokWjzoa5jAwMkxCykd6,5,13,7,0,5,0,3,0,28,4.0,2,0.0,0,7,0,5,13,0,0,3,0,12,16,1
10471,91284,3a9jnl6D615xvyDPr3X72Qm6tyAqQDq6,SpATywNh6bZuzm8s1ceuBUnMUAeoAHHw,5,0,0,0,0,2,6,1,9,1.2857142857142858,1,0.0,0,0,0,0,0,2,0,6,1,0,9,1
10472,91287,Xl4Lzddy8Aw3656QCmyajshZUF8lGm25,SpATywNh6bZuzm8s1ceuBUnMUAeoAHHw,14,19,6,22,3,8,4,0,62,8.857142857142858,1,0.0,10,6,19,3,9,8,3,4,0,38,24,1
10473,91299,3lDn61j7LQx2ct2mXSyFAxE4I2joOjdi,SpATywNh6bZuzm8s1ceuBUnMUAeoAHHw,16,16,5,19,3,4,7,1,55,7.857142857142857,1,0.0,10,5,16,3,6,4,3,7,1,34,21,1
10474,91300,UZj9qZ6lkWkIz7HEEFyBh5LFRNaz4SI2,SpATywNh6bZuzm8s1ceuBUnMUAeoAHHw,11,15,1,6,1,0,4,0,27,3.857142857142857,3,0.0,0,1,5,1,15,0,1,4,0,7,20,1
10475,91302,CuRQgxEa02jfJLJUhEm7AKFBwc2Dt3PE,SpATywNh6bZuzm8s1ceuBUnMUAeoAHHw,10,15,7,7,0,0,4,0,33,4.714285714285714,1,0.0,0,7,6,0,15,0,1,4,0,13,20,1
10476,91304,VYmODogcHFHSX4vALahPhItYfFc245Hp,RXDvfPUBYFlVdlueBFbLW0mhhAyGEqpt,21,28,17,31,5,1,9,0,91,13.0,2,0.0,5,17,26,5,23,1,5,9,0,53,38,1
10477,91307,MHM1aXC71Dw383yBooXdYF1qDKYHoccv,bWdj2GDclj5ofokWjzoa5jAwMkxCykd6,1,0,0,0,0,0,1,0,1,0.14285714285714285,1,0.0,0,0,0,0,0,0,0,1,0,0,1,1
10478,91310,MHM1aXC71Dw383yBooXdYF1qDKYHoccv,SpATywNh6bZuzm8s1ceuBUnMUAeoAHHw,4,2,1,0,1,0,2,0,6,0.8571428571428571,1,0.0,0,1,0,1,2,0,0,2,0,2,4,1
10479,91312,LmrXz112hM3lsrkiQcTLgB1CQdX7OPmf,RXDvfPUBYFlVdlueBFbLW0mhhAyGEqpt,23,22,16,30,10,1,5,1,85,12.142857142857142,1,0.0,4,16,27,10,18,1,3,5,1,57,28,1
10480,91325,q5vo1hp0Q9QDxbtjHEkZyC7Vz9AYHKaw,G8EPVSXsOYB5YQWZGiz1aVq5Pgr2GrQu,1,0,0,0,0,0,1,0,1,0.14285714285714285,1,0.0,0,0,0,0,0,0,0,1,0,0,1,1
10481,91328,OZaq72DmJH6bReA6lKvO4XbWYjmwsu42,bWdj2GDclj5ofokWjzoa5jAwMkxCykd6,18,22,8,98,4,0,7,0,139,19.857142857142858,4,0.0,6,8,92,4,16,0,6,7,0,110,29,1
10482,91333,xRrdKDq0SR8avtZTCYAseO6HdCVb8m0M,bWdj2GDclj5ofokWjzoa5jAwMkxCykd6,9,13,5,43,2,13,8,6,90,12.857142857142858,1,0.0,5,5,42,2,8,13,1,8,6,54,36,1
10483,91337,OtHqAfAnlt18GaEWyak2S1YVbRKxCTZV,bWdj2GDclj5ofokWjzoa5jAwMkxCykd6,1,0,0,0,0,0,1,0,1,0.14285714285714285,1,0.0,0,0,0,0,0,0,0,1,0,0,1,1
10484,91346,b4VAhvG3MG7lVRCMYGT7EV06rJVZjoZJ,SpATywNh6bZuzm8s1ceuBUnMUAeoAHHw,6,5,1,0,1,0,2,0,9,1.2857142857142858,2,0.0,0,1,0,1,5,0,0,2,0,2,7,1
10485,91357,CqJyXqN2l3WOJQLqxchvfRFp3seiLXw6,bWdj2GDclj5ofokWjzoa5jAwMkxCykd6,6,8,3,0,2,0,2,1,16,2.2857142857142856,1,0.0,3,3,0,2,5,0,0,2,1,8,8,1
10486,91358,za2dBkPPLD9IPRBjooK7GJit2ulI5UgN,RXDvfPUBYFlVdlueBFbLW0mhhAyGEqpt,1,0,0,0,0,0,1,0,1,0.14285714285714285,1,0.0,0,0,0,0,0,0,0,1,0,0,1,1
10487,91359,qlATuCCqDpQGO38aosxnvWXoyFwzEQc6,SpATywNh6bZuzm8s1ceuBUnMUAeoAHHw,1,0,0,0,0,0,1,0,1,0.14285714285714285,1,0.0,0,0,0,0,0,0,0,1,0,0,1,1
10488,91360,Y7IgoRAqVJfNlsulCSI4HObujHPSzoLA,bWdj2GDclj5ofokWjzoa5jAwMkxCykd6,16,31,16,18,9,1,9,0,84,12.0,3,0.0,9,16,15,9,22,1,3,9,0,49,35,1
10489,91363,LrkrvySxDPWP0dPv0sy62S8XY8vaxevX,SpATywNh6bZuzm8s1ceuBUnMUAeoAHHw,1,0,0,0,0,0,1,0,1,0.14285714285714285,1,0.0,0,0,0,0,0,0,0,1,0,0,1,1
10490,91364,PERCKVrZOUZ9ZmdU3J0Mwd1TZrMvK8yc,bWdj2GDclj5ofokWjzoa5jAwMkxCykd6,1,0,0,0,0,0,1,0,1,0.14285714285714285,1,0.0,0,0,0,0,0,0,0,1,0,0,1,1
10491,91370,A8jyl8S1kU5U2ikqJ1w16Eh9QcSPe3kU,bWdj2GDclj5ofokWjzoa5jAwMkxCykd6,10,6,2,36,1,14,11,0,70,10.0,4,0.0,1,2,35,1,5,14,1,11,0,39,31,1
10492,91372,KdRLGDNkLtrOcdNI9HZrV8CuGZ4u276z,SpATywNh6bZuzm8s1ceuBUnMUAeoAHHw,6,3,2,0,2,0,1,0,8,1.1428571428571428,1,0.0,0,2,0,2,3,0,0,1,0,4,4,1
10493,91378,2GLZl96ZIgoKdw26t6xniq9LngPm9HvA,RXDvfPUBYFlVdlueBFbLW0mhhAyGEqpt,1,0,0,0,0,0,1,0,1,0.14285714285714285,1,0.0,0,0,0,0,0,0,0,1,0,0,1,1
10494,91382,UmS6fyVqoZGfOpZXm4pjngyByXpv5BZq,SpATywNh6bZuzm8s1ceuBUnMUAeoAHHw,2,0,0,0,0,0,2,0,2,0.2857142857142857,1,0.0,0,0,0,0,0,0,0,2,0,0,2,1
10495,91400,mP7T5RBRG5ILBmmKKL1ktjST3p6gGZyD,G8EPVSXsOYB5YQWZGiz1aVq5Pgr2GrQu,31,38,20,54,13,8,19,3,155,22.142857142857142,3,0.0,7,20,46,13,31,8,8,19,3,86,69,0
10496,91402,95hqHTSw1gz1emf3tVFfyk36gKJr0SpD,SpATywNh6bZuzm8s1ceuBUnMUAeoAHHw,5,2,1,0,1,0,3,0,7,1.0,1,0.0,0,1,0,1,2,0,0,3,0,2,5,1
10497,91403,poUZo66KaOJLyZ89MU32hotzwVV9BV0u,SpATywNh6bZuzm8s1ceuBUnMUAeoAHHw,11,9,0,10,0,4,6,2,31,4.428571428571429,1,0.0,2,0,8,0,7,4,2,6,2,10,21,1
10498,91412,WS43utSG33bYCMf9KzrbX5AdwBBQGbjp,G8EPVSXsOYB5YQWZGiz1aVq5Pgr2GrQu,7,2,1,0,1,0,4,1,9,1.2857142857142858,1,0.0,0,1,0,1,2,0,0,4,1,2,7,1
10499,91418,guY4SSn1fy4TWThod7s2lBFrUtiOX15g,SpATywNh6bZuzm8s1ceuBUnMUAeoAHHw,1,0,0,0,0,0,1,0,1,0.14285714285714285,1,0.0,0,0,0,0,0,0,0,1,0,0,1,1
10500,91425,Kp4YCt5gbTMeLX4vxDVqvPhrGDdHDcEC,bWdj2GDclj5ofokWjzoa5jAwMkxCykd6,1,0,0,0,0,0,1,0,1,0.14285714285714285,1,0.0,0,0,0,0,0,0,0,1,0,0,1,1
10501,91440,FiJs6t54TQx94XiEoXWiArjFjkJV5FwV,SpATywNh6bZuzm8s1ceuBUnMUAeoAHHw,5,2,1,0,1,0,2,0,6,0.8571428571428571,1,0.0,0,1,0,1,2,0,0,2,0,2,4,1
10502,91443,KUB7X44VbEjxMDVZF3W29K5D0UgPC6KH,SpATywNh6bZuzm8s1ceuBUnMUAeoAHHw,1,0,0,0,0,0,1,0,1,0.14285714285714285,1,0.0,0,0,0,0,0,0,0,1,0,0,1,1
10503,91447,tf4ZGAY33jZAuxFy4GuZb8bCcW9cJu8C,SpATywNh6bZuzm8s1ceuBUnMUAeoAHHw,1,0,0,0,0,0,3,0,3,0.42857142857142855,1,0.0,0,0,0,0,0,0,0,3,0,0,3,1
10504,91448,IRULN38M25Cl78bawBWQTQjcpwpaaNDt,SpATywNh6bZuzm8s1ceuBUnMUAeoAHHw,20,37,0,34,0,2,11,4,88,12.571428571428571,3,0.0,15,0,28,0,22,2,6,11,4,43,45,1
10505,91455,iXxs6D3heezRYy4j7tliC14ux3klsjwX,SpATywNh6bZuzm8s1ceuBUnMUAeoAHHw,9,7,0,10,0,0,4,0,21,3.0,2,0.0,2,0,8,0,5,0,2,4,0,10,11,1
10506,91470,QGuKTIBC2KLaYpPdOnB4nXCWgxMM1Dog,SpATywNh6bZuzm8s1ceuBUnMUAeoAHHw,7,4,3,0,2,0,1,0,10,1.4285714285714286,1,0.0,0,3,0,2,4,0,0,1,0,5,5,0
10507,91476,TRCrdidmG6eXWyA1xpJbOiCViWff58Ia,RXDvfPUBYFlVdlueBFbLW0mhhAyGEqpt,35,26,16,42,11,1,6,0,102,14.571428571428571,2,0.0,5,16,39,11,21,1,3,6,0,71,31,1
10508,91479,7wwnUxCzQI2wyfpl5OyzTa3WTS3Ri45e,bWdj2GDclj5ofokWjzoa5jAwMkxCykd6,8,9,5,0,2,1,14,1,32,4.571428571428571,5,0.0,0,5,0,2,9,1,0,14,1,7,25,1
10509,91482,LOVxi1n45DRmVnmmx6W7w15Zc3W4DL9Q,SpATywNh6bZuzm8s1ceuBUnMUAeoAHHw,5,2,1,0,1,0,2,0,6,0.8571428571428571,1,0.0,0,1,0,1,2,0,0,2,0,2,4,1
10510,91485,iEQmrsDBbeOrnopk2RwtHZMbNkoYEU8q,SpATywNh6bZuzm8s1ceuBUnMUAeoAHHw,13,12,5,0,3,1,7,1,29,4.142857142857143,1,0.0,2,5,0,3,10,1,0,7,1,10,19,0
10511,91491,CwyOL3RMOVLomxrxyN9D4jPa9R0iWrS5,SpATywNh6bZuzm8s1ceuBUnMUAeoAHHw,30,39,23,17,12,1,14,1,107,15.285714285714286,4,0.0,6,23,16,12,33,1,1,14,1,57,50,1
10512,91494,Zdseq1rQmkAi5wZl57d3RwjzOxlL3B5I,bWdj2GDclj5ofokWjzoa5jAwMkxCykd6,1,0,0,0,0,0,1,0,1,0.14285714285714285,1,0.0,0,0,0,0,0,0,0,1,0,0,1,1
10513,91496,iX8db0h4bK73Weo8AP1BXtlfn6xSOf6w,bWdj2GDclj5ofokWjzoa5jAwMkxCykd6,6,7,4,0,2,0,7,0,20,2.857142857142857,2,0.0,1,4,0,2,6,0,0,7,0,7,13,1
10514,91500,cGHoibSqVUbVlKoJgTJL9GQ2AhPLVzAA,SpATywNh6bZuzm8s1ceuBUnMUAeoAHHw,5,2,1,0,1,0,2,0,6,0.8571428571428571,1,0.0,0,1,0,1,2,0,0,2,0,2,4,1
10515,91505,NjgQeSBBMWIwQySsR5ymtqiugkMaOyYh,SpATywNh6bZuzm8s1ceuBUnMUAeoAHHw,6,10,4,0,0,0,3,0,17,2.4285714285714284,1,0.0,1,4,0,0,9,0,0,3,0,5,12,1
10516,91508,CoIppafSfTN9XDj22SO0MlvO24IGW3qc,SpATywNh6bZuzm8s1ceuBUnMUAeoAHHw,5,3,1,0,1,0,2,0,7,1.0,1,0.0,0,1,0,1,3,0,0,2,0,2,5,1
10517,91509,sytW49I21SJ70ElOkXGU5SHeeHl1E3fL,bWdj2GDclj5ofokWjzoa5jAwMkxCykd6,9,9,4,4,1,0,11,2,31,4.428571428571429,3,0.0,1,4,3,1,8,0,1,11,2,9,22,1
10518,91515,HMYpimZGFgj5IczDutkfjUfnxl45PoHW,bWdj2GDclj5ofokWjzoa5jAwMkxCykd6,12,20,12,0,6,1,8,1,48,6.857142857142857,3,0.0,3,12,0,6,17,1,0,8,1,21,27,1
10519,91519,INi9R682jCcjSCeRDCpuPIJvFgA3WCPK,SpATywNh6bZuzm8s1ceuBUnMUAeoAHHw,4,4,0,0,0,0,3,0,7,1.0,1,0.0,0,0,0,0,4,0,0,3,0,0,7,1
10520,91523,zTDlJM8GToOfxmvivD5zWrgVHrXjTey0,SpATywNh6bZuzm8s1ceuBUnMUAeoAHHw,5,3,1,0,1,0,1,0,6,0.8571428571428571,1,0.0,0,1,0,1,3,0,0,1,0,2,4,1
10521,91527,8Juk29xSxX3yy5MeVUlmmq4TGH5jCyZl,bWdj2GDclj5ofokWjzoa5jAwMkxCykd6,1,0,0,0,0,0,1,0,1,0.14285714285714285,1,0.0,0,0,0,0,0,0,0,1,0,0,1,1
10522,91546,4ZKN4qjeNhliROr2sm8vB8zmpPTrlPXO,bWdj2GDclj5ofokWjzoa5jAwMkxCykd6,1,0,0,0,0,0,1,0,1,0.14285714285714285,1,0.0,0,0,0,0,0,0,0,1,0,0,1,1
10523,91551,HRDkxtbUq1mjWiCFLcR4tjQW2mCEHxu4,RXDvfPUBYFlVdlueBFbLW0mhhAyGEqpt,18,25,14,0,9,8,20,13,89,12.714285714285714,2,0.0,3,14,0,9,22,8,0,20,13,26,63,1
10524,91553,95ZATSYX39rVcaPDxHBCcw9smfWWWOJE,G8EPVSXsOYB5YQWZGiz1aVq5Pgr2GrQu,4,2,0,0,0,0,2,0,4,0.5714285714285714,1,0.0,0,0,0,0,2,0,0,2,0,0,4,1
10525,91561,JaxQCd7UV5o1rvWxAibMy6iOMU3fCV5H,G8EPVSXsOYB5YQWZGiz1aVq5Pgr2GrQu,2,0,0,0,0,0,2,0,2,0.2857142857142857,1,0.0,0,0,0,0,0,0,0,2,0,0,2,1
10526,91563,CV9JyLcIlYcf3I8rF9dkDEhChf1GM9os,G8EPVSXsOYB5YQWZGiz1aVq5Pgr2GrQu,5,5,1,0,1,0,2,0,9,1.2857142857142858,1,0.0,0,1,0,1,5,0,0,2,0,2,7,1
10527,91565,Yc7DWSMOX4qXPZYRvYXJRnfQO7mqesrH,SpATywNh6bZuzm8s1ceuBUnMUAeoAHHw,9,8,2,8,1,0,2,0,21,3.0,1,0.0,4,2,6,1,4,0,2,2,0,13,8,1
10528,91571,M3CWdGPorPClU70a2twe6L8itu10pmZS,SpATywNh6bZuzm8s1ceuBUnMUAeoAHHw,1,0,0,0,0,0,1,0,1,0.14285714285714285,1,0.0,0,0,0,0,0,0,0,1,0,0,1,1
10529,91572,tl6eW0ZllZHnwqWfi7Wfg5VpXnj5pUEg,SpATywNh6bZuzm8s1ceuBUnMUAeoAHHw,15,11,5,12,3,0,4,0,35,5.0,1,0.0,4,5,10,3,7,0,2,4,0,22,13,1
10530,91575,nzicLrGs2CkHsGEmCwyxF4pye3Bqo62U,G8EPVSXsOYB5YQWZGiz1aVq5Pgr2GrQu,10,6,4,0,3,0,2,0,15,2.142857142857143,1,0.0,1,4,0,3,5,0,0,2,0,8,7,1
10531,91578,Zh7CYVhvtUUFf70foMQSgpBF0IOlRY9B,SpATywNh6bZuzm8s1ceuBUnMUAeoAHHw,5,2,1,0,1,0,2,0,6,0.8571428571428571,1,0.0,0,1,0,1,2,0,0,2,0,2,4,1
10532,91584,JBjA243ZRIqgCsAm61lG2qOhZbNcozpv,G8EPVSXsOYB5YQWZGiz1aVq5Pgr2GrQu,12,16,3,0,2,1,7,1,30,4.285714285714286,3,0.0,1,3,0,2,15,1,0,7,1,6,24,1
10533,91586,vOpj8ur6jA13uE8NuDJFu1oyU88RJP1w,bWdj2GDclj5ofokWjzoa5jAwMkxCykd6,4,8,0,0,0,0,2,0,10,1.4285714285714286,2,0.0,0,0,0,0,8,0,0,2,0,0,10,1
10534,91589,JBjA243ZRIqgCsAm61lG2qOhZbNcozpv,SpATywNh6bZuzm8s1ceuBUnMUAeoAHHw,5,5,1,0,0,0,4,0,10,1.4285714285714286,1,0.0,0,1,0,0,5,0,0,4,0,1,9,1
10535,91591,Jp26ywpmjw8PCn9zJ6Emr3JwxCXz1vqU,SpATywNh6bZuzm8s1ceuBUnMUAeoAHHw,14,21,1,18,1,9,12,0,62,8.857142857142858,5,0.0,2,1,15,1,19,9,3,12,0,19,43,1
10536,91592,rzAa0SbIuqxRiUHWVTPJbitOwzhhOEdv,G8EPVSXsOYB5YQWZGiz1aVq5Pgr2GrQu,8,16,7,6,0,0,4,0,33,4.714285714285714,1,0.0,6,7,5,0,10,0,1,4,0,18,15,1
10537,91593,PizUKf6mRUas66X3VMYXf9aygnN1CUCf,bWdj2GDclj5ofokWjzoa5jAwMkxCykd6,8,12,5,0,6,0,3,0,26,3.7142857142857144,1,0.0,5,5,0,6,7,0,0,3,0,16,10,1
10538,91595,gDaSFJD4b80GGtFaPG7wjh3sxtnlKrIT,SpATywNh6bZuzm8s1ceuBUnMUAeoAHHw,33,53,19,35,9,4,12,2,134,19.142857142857142,8,0.0,16,19,32,9,37,4,3,12,2,76,58,0
10539,91597,GsuSgvyvG4oCfnW3UaGKEeHZUImW7ybU,RXDvfPUBYFlVdlueBFbLW0mhhAyGEqpt,6,3,1,0,1,0,2,0,7,1.0,1,0.0,0,1,0,1,3,0,0,2,0,2,5,1
10540,91601,gVGEUb9jfMmddRlcGqXsnz4ZV26w6q4e,5Gyp41oLVo7Gg7vF4vpmggWP5MU70QO6,7,5,2,0,2,0,2,0,11,1.5714285714285714,1,0.0,0,2,0,2,5,0,0,2,0,4,7,1
10541,91645,J2I8DrDowD3d9j8QRHclVptgZSLA6vjR,5Gyp41oLVo7Gg7vF4vpmggWP5MU70QO6,10,14,8,0,3,0,5,0,30,4.285714285714286,1,0.0,2,8,0,3,12,0,0,5,0,13,17,1
10542,91661,hcKYo6bLhlANvHE0FxLuR4YY8jocfBwJ,5Gyp41oLVo7Gg7vF4vpmggWP5MU70QO6,15,14,8,2,5,15,8,0,52,7.428571428571429,5,0.0,3,8,1,5,11,15,1,8,0,17,35,0
10543,91663,HROFX90wnUUTHf8ADYZ0Ay2MUzgrMCHp,5Gyp41oLVo7Gg7vF4vpmggWP5MU70QO6,18,52,19,0,8,4,14,3,100,14.285714285714286,5,0.0,8,19,0,8,44,4,0,14,3,35,65,1
10544,91666,Mx5vxHsJbFC6B9oxKIPSrygei6h1xd4S,5Gyp41oLVo7Gg7vF4vpmggWP5MU70QO6,17,10,8,0,7,0,2,0,27,3.857142857142857,1,0.0,0,8,0,7,10,0,0,2,0,15,12,1
10545,91706,A2erycAShix7FV5AzEvRQ1fSxczd3obW,5Gyp41oLVo7Gg7vF4vpmggWP5MU70QO6,1,0,0,0,0,0,2,0,2,0.2857142857142857,1,0.0,0,0,0,0,0,0,0,2,0,0,2,1
10546,91724,cjYWBFQWrsyr2eB3uwe411p7xKBeDGQi,5Gyp41oLVo7Gg7vF4vpmggWP5MU70QO6,14,35,17,6,8,0,9,0,75,10.714285714285714,5,0.0,6,17,3,8,29,0,3,9,0,34,41,1
10547,91729,TqwsfzC7boA0P221nJEBMK29H7weQpBs,5Gyp41oLVo7Gg7vF4vpmggWP5MU70QO6,13,12,6,4,3,0,2,0,27,3.857142857142857,1,0.0,5,6,2,3,7,0,2,2,0,16,11,1
10548,91739,HNaJJS3tKCEoZkM0EWhn7UouJ0Nuy7QX,5Gyp41oLVo7Gg7vF4vpmggWP5MU70QO6,2,0,0,0,0,0,2,0,2,0.2857142857142857,1,0.0,0,0,0,0,0,0,0,2,0,0,2,1
10549,91751,92mMNjk3cJsYjNqhq0S3iwov3yrrBBEr,5Gyp41oLVo7Gg7vF4vpmggWP5MU70QO6,1,0,0,0,0,0,1,0,1,0.14285714285714285,1,0.0,0,0,0,0,0,0,0,1,0,0,1,1
10550,91761,k6RJ44LpfDefc4BqSfb5Ks3bqRLzpbPs,5Gyp41oLVo7Gg7vF4vpmggWP5MU70QO6,30,74,33,19,13,17,20,0,176,25.142857142857142,7,0.0,15,33,16,13,59,17,3,20,0,77,99,0
10551,91762,TauOAk4Cm1OS5dlhtWMBldHEzkBkLYAM,5Gyp41oLVo7Gg7vF4vpmggWP5MU70QO6,1,0,0,0,0,0,1,0,1,0.14285714285714285,1,0.0,0,0,0,0,0,0,0,1,0,0,1,1
10552,91783,DIV0XhnvCWVZ3iA9CwmqKCB9ziYsXVmI,5Gyp41oLVo7Gg7vF4vpmggWP5MU70QO6,1,0,0,0,0,0,1,0,1,0.14285714285714285,1,0.0,0,0,0,0,0,0,0,1,0,0,1,1
10553,91793,uaNRMAeOjjxBTsXCXmPYPOpFNtIjXEn1,5Gyp41oLVo7Gg7vF4vpmggWP5MU70QO6,9,6,4,0,2,0,3,0,15,2.142857142857143,2,0.0,0,4,0,2,6,0,0,3,0,6,9,1
10554,91802,FbZxeKF6OWTvZPlj49JWXpcOzpO2oJVZ,5Gyp41oLVo7Gg7vF4vpmggWP5MU70QO6,1,0,0,0,0,0,1,0,1,0.14285714285714285,1,0.0,0,0,0,0,0,0,0,1,0,0,1,1
10555,91811,I73HdLkKTEEKeKJv8RXl4DK1UPKwGJfY,5Gyp41oLVo7Gg7vF4vpmggWP5MU70QO6,5,3,1,0,1,0,2,0,7,1.0,1,0.0,0,1,0,1,3,0,0,2,0,2,5,1
10556,91862,4wGrpM3AgzCdbAUft0CQKA9hOQd1a3At,5Gyp41oLVo7Gg7vF4vpmggWP5MU70QO6,33,71,34,10,27,0,10,0,152,21.714285714285715,8,0.0,19,34,5,27,52,0,5,10,0,85,67,1
10557,91874,fXFz6g5r2Tp8eWARWPVXqKuqaMAimuJv,5Gyp41oLVo7Gg7vF4vpmggWP5MU70QO6,8,9,3,0,1,0,7,0,20,2.857142857142857,2,0.0,0,3,0,1,9,0,0,7,0,4,16,1
10558,91882,VFH6a2uSMyTTmZ3qJklBQDYdnqCeEjjH,5Gyp41oLVo7Gg7vF4vpmggWP5MU70QO6,13,38,8,32,3,0,7,0,88,12.571428571428571,2,0.0,21,8,19,3,17,0,13,7,0,51,37,1
10559,91912,dKrdiEeAHzNQy0ZEy2dsQ27TKgxltzee,5Gyp41oLVo7Gg7vF4vpmggWP5MU70QO6,8,6,4,0,3,0,3,0,16,2.2857142857142856,2,0.0,0,4,0,3,6,0,0,3,0,7,9,1
10560,91922,aiYWCD5OXvg9JcNa3jHM8Sy0IrqSuC2V,5Gyp41oLVo7Gg7vF4vpmggWP5MU70QO6,1,0,0,0,0,0,1,0,1,0.14285714285714285,1,0.0,0,0,0,0,0,0,0,1,0,0,1,1
10561,91937,dJXifgB0AMWBBZbYLPHtaqOVPxCyllD8,5Gyp41oLVo7Gg7vF4vpmggWP5MU70QO6,5,4,1,0,1,0,4,0,10,1.4285714285714286,3,0.0,0,1,0,1,4,0,0,4,0,2,8,1
10562,91947,I7EV0ilbAmvRztKJjn2PkUA9D3WXsldW,5Gyp41oLVo7Gg7vF4vpmggWP5MU70QO6,11,8,4,0,3,0,4,0,19,2.7142857142857144,1,0.0,0,4,0,3,8,0,0,4,0,7,12,1
10563,91967,KQ2RZXNhuAxg3uK4R6cV2U5rzXHTACPD,5Gyp41oLVo7Gg7vF4vpmggWP5MU70QO6,1,0,0,0,0,0,1,0,1,0.14285714285714285,1,0.0,0,0,0,0,0,0,0,1,0,0,1,1
10564,91970,bo2onan1tteC9PtOvOwWhHvlR04pcJEI,5Gyp41oLVo7Gg7vF4vpmggWP5MU70QO6,8,12,6,0,4,0,2,0,24,3.4285714285714284,2,0.0,2,6,0,4,10,0,0,2,0,12,12,1
10565,92010,WPZzQgsRlhCaDKsgOnJym54JEfCX3TnU,3VkHkmOtom3jM2wCu94xgzzu1d6Dn7or,5,2,1,0,1,0,2,0,6,0.8571428571428571,1,0.0,0,1,0,1,2,0,0,2,0,2,4,1
10566,92012,cSPmiYFpvKp3t31tgpU4uGLNNWxYS8Sr,3VkHkmOtom3jM2wCu94xgzzu1d6Dn7or,32,34,12,29,16,8,14,3,116,16.571428571428573,2,0.0,21,12,23,16,13,8,6,14,3,72,44,1
10567,92068,Nl63P9HfrDHNTioAMibVFsG7C6MOQlQ2,3VkHkmOtom3jM2wCu94xgzzu1d6Dn7or,45,43,28,1,26,1,11,0,110,15.714285714285714,6,0.0,5,28,1,26,38,1,0,11,0,60,50,0
10568,92078,hJRlB5RCNQHBXSIyIrtLiU1lhUWnl90A,3VkHkmOtom3jM2wCu94xgzzu1d6Dn7or,6,2,1,0,1,2,4,0,10,1.4285714285714286,1,0.0,0,1,0,1,2,2,0,4,0,2,8,1
10569,92108,6I9tuEOSJXwqZycCyEbmBi10JKjNjXRW,3VkHkmOtom3jM2wCu94xgzzu1d6Dn7or,10,9,3,0,2,1,7,0,22,3.142857142857143,1,0.0,0,3,0,2,9,1,0,7,0,5,17,1
10570,92120,QP4n9xujRmppLpJuo3p8rivz78xLiQtX,3VkHkmOtom3jM2wCu94xgzzu1d6Dn7or,5,2,1,0,1,0,2,0,6,0.8571428571428571,1,0.0,0,1,0,1,2,0,0,2,0,2,4,1
10571,92128,kAubX3YD1QXDkKfXy6xJth37WDkoxpFR,3VkHkmOtom3jM2wCu94xgzzu1d6Dn7or,3,2,0,0,0,0,1,0,3,0.42857142857142855,1,0.0,0,0,0,0,2,0,0,1,0,0,3,1
10572,92170,WpSQzZEMzHXhSbKvxj22CHOz0onI9HWB,3VkHkmOtom3jM2wCu94xgzzu1d6Dn7or,1,0,0,0,0,0,1,0,1,0.14285714285714285,1,0.0,0,0,0,0,0,0,0,1,0,0,1,1
10573,92191,WRdZfW7d6qfvZ0KKlFJKcTTCpuF0nDdo,3VkHkmOtom3jM2wCu94xgzzu1d6Dn7or,7,3,1,2,1,6,6,1,20,2.857142857142857,1,0.0,1,1,2,1,2,6,0,6,1,5,15,1
10574,92215,spEastQ2pq74IRw5KGXpOxXz1MamusN2,3VkHkmOtom3jM2wCu94xgzzu1d6Dn7or,8,6,4,0,3,1,4,0,18,2.5714285714285716,1,0.0,0,4,0,3,6,1,0,4,0,7,11,1
10575,92221,bO3QplYnoiJbQBpC2OFvvQuB9EFbMhM7,3VkHkmOtom3jM2wCu94xgzzu1d6Dn7or,1,0,0,0,0,0,1,0,1,0.14285714285714285,1,0.0,0,0,0,0,0,0,0,1,0,0,1,1
10576,92243,FBq0wRuiW7sFU9U5SlrcNu9eSvWfhQ7T,3VkHkmOtom3jM2wCu94xgzzu1d6Dn7or,1,0,0,0,0,0,2,0,2,0.2857142857142857,1,0.0,0,0,0,0,0,0,0,2,0,0,2,1
10577,92251,xnocImMu4sTSwPlbzqQFZgdYJiDXl6vB,3VkHkmOtom3jM2wCu94xgzzu1d6Dn7or,1,0,0,0,0,0,1,0,1,0.14285714285714285,1,0.0,0,0,0,0,0,0,0,1,0,0,1,1
10578,92274,cbHdj12cCek43EioPVZBH6uxAj25c968,3VkHkmOtom3jM2wCu94xgzzu1d6Dn7or,1,0,0,0,0,0,1,0,1,0.14285714285714285,1,0.0,0,0,0,0,0,0,0,1,0,0,1,1
10579,92286,xp0hBW5Psq6QHRaJN7EADcRMPTBNSHAV,3VkHkmOtom3jM2wCu94xgzzu1d6Dn7or,1,0,0,0,0,0,1,0,1,0.14285714285714285,1,0.0,0,0,0,0,0,0,0,1,0,0,1,1
10580,92287,nnn8ndc06NDVKjww6SG0wlF2ZDIeYbVG,3VkHkmOtom3jM2wCu94xgzzu1d6Dn7or,5,5,3,0,2,1,2,0,13,1.8571428571428572,1,0.0,0,3,0,2,5,1,0,2,0,5,8,1
10581,92288,fV80aRuu00trDWJ7y1VmEAcQ2xKDaujP,3VkHkmOtom3jM2wCu94xgzzu1d6Dn7or,6,33,3,0,2,0,2,1,41,5.857142857142857,1,0.0,28,3,0,2,5,0,0,2,1,33,8,1
10582,92290,7lzEjeizq2WryXPCFV63iiJ0sRC0XsD5,3VkHkmOtom3jM2wCu94xgzzu1d6Dn7or,10,17,5,6,7,2,5,0,42,6.0,1,0.0,10,5,4,7,7,2,2,5,0,26,16,1
10583,92300,zf9u87lPN0HRwW95dz7D254n8gGdhfJZ,3VkHkmOtom3jM2wCu94xgzzu1d6Dn7or,6,2,1,0,1,0,5,0,9,1.2857142857142858,1,0.0,0,1,0,1,2,0,0,5,0,2,7,1
10584,92304,3Fdh79GcEkqhLYQCWdfTb5pLqpRaTMvj,3VkHkmOtom3jM2wCu94xgzzu1d6Dn7or,5,2,1,0,1,0,2,0,6,0.8571428571428571,1,0.0,0,1,0,1,2,0,0,2,0,2,4,1
10585,92320,TCIVkyJgzJ4isZH6dzhFoSor2ZwJ5sAN,3VkHkmOtom3jM2wCu94xgzzu1d6Dn7or,7,4,2,0,2,0,3,0,11,1.5714285714285714,1,0.0,0,2,0,2,4,0,0,3,0,4,7,1
10586,92331,VL7Ebz6uuz9oVtoQ2k8XC6VxIyML6see,3VkHkmOtom3jM2wCu94xgzzu1d6Dn7or,11,11,6,0,4,0,4,1,26,3.7142857142857144,2,0.0,0,6,0,4,11,0,0,4,1,10,16,1
10587,92347,pqdSiFtkQLWzXU8KtYlOOvolG2arha7e,3VkHkmOtom3jM2wCu94xgzzu1d6Dn7or,5,3,1,0,1,0,2,0,7,1.0,1,0.0,0,1,0,1,3,0,0,2,0,2,5,1
10588,92416,hlgAnCIYIgYVFdaX4Qjp6MaN9qlFQlvr,3VkHkmOtom3jM2wCu94xgzzu1d6Dn7or,1,0,0,0,0,0,1,0,1,0.14285714285714285,1,0.0,0,0,0,0,0,0,0,1,0,0,1,1
10589,92449,dGOauLic5mGz4awYOMaqV5TU8s33lg07,3VkHkmOtom3jM2wCu94xgzzu1d6Dn7or,1,0,0,0,0,0,2,0,2,0.2857142857142857,1,0.0,0,0,0,0,0,0,0,2,0,0,2,1
10590,92475,GKGPPaT6okmnGRZj5HObLtLzADcHdH56,3VkHkmOtom3jM2wCu94xgzzu1d6Dn7or,1,0,0,0,0,0,1,0,1,0.14285714285714285,1,0.0,0,0,0,0,0,0,0,1,0,0,1,1
10591,92483,SjrtXywO2Di9R6tWHHpfBZyHXKmSAuXJ,3VkHkmOtom3jM2wCu94xgzzu1d6Dn7or,2,0,0,0,0,0,2,0,2,0.2857142857142857,1,0.0,0,0,0,0,0,0,0,2,0,0,2,1
10592,92497,OgqpjGMMInWS9PhYsy4mlMX0fhVM7tcA,3VkHkmOtom3jM2wCu94xgzzu1d6Dn7or,1,0,0,0,0,0,3,0,3,0.42857142857142855,2,0.0,0,0,0,0,0,0,0,3,0,0,3,1
10593,92503,Dtlo3c1SvhzZjTgzvtTKEnEOoS01REof,3VkHkmOtom3jM2wCu94xgzzu1d6Dn7or,1,0,0,0,0,0,1,0,1,0.14285714285714285,1,0.0,0,0,0,0,0,0,0,1,0,0,1,1
10594,92515,Sx1lH49w886YuzrvbgrhtfBzgGvqLjqU,3VkHkmOtom3jM2wCu94xgzzu1d6Dn7or,1,0,0,0,0,0,1,0,1,0.14285714285714285,1,0.0,0,0,0,0,0,0,0,1,0,0,1,1
10595,92537,JNlPhJ9z2p7in422NWyeL0sdq9lO0Q3S,3VkHkmOtom3jM2wCu94xgzzu1d6Dn7or,5,2,1,0,1,0,2,0,6,0.8571428571428571,1,0.0,0,1,0,1,2,0,0,2,0,2,4,1
10596,92665,YIsZznU3eBMkUE0b5fanRcoCpMSUdgvE,3VkHkmOtom3jM2wCu94xgzzu1d6Dn7or,47,81,20,63,19,3,18,1,205,29.285714285714285,3,0.0,25,20,56,19,56,3,7,18,1,120,85,1
10597,92825,DuFXvlMxtAdxfnPOoOZpxEKgHTS36vNK,A3fsA9Zfv1X2fVEQhTw51lKENdNrEqT3,32,15,13,56,9,0,6,0,99,14.142857142857142,2,0.0,0,13,46,9,15,0,10,6,0,68,31,1
10598,92827,ZEbdtmjZoFNJAd6x9CZyfsFMmBEwQpXv,SpATywNh6bZuzm8s1ceuBUnMUAeoAHHw,13,11,8,0,5,1,7,1,33,4.714285714285714,2,0.0,0,8,0,5,11,1,0,7,1,13,20,1
10599,92860,msWTEJiXPD0IrE0kyLI7rGT23zUS4bM8,A3fsA9Zfv1X2fVEQhTw51lKENdNrEqT3,1,0,0,0,0,0,1,0,1,0.14285714285714285,1,0.0,0,0,0,0,0,0,0,1,0,0,1,1
10600,92870,nCB7ViHcbXHrq91Tw7AsIMYmLiKIa5Jv,A3fsA9Zfv1X2fVEQhTw51lKENdNrEqT3,4,1,0,0,0,0,5,0,6,0.8571428571428571,1,0.0,0,0,0,0,1,0,0,5,0,0,6,1
10601,92890,HJ2gv3yF0WCJxGH8T6tjLTFYdM4sCizz,SpATywNh6bZuzm8s1ceuBUnMUAeoAHHw,16,16,10,12,6,6,7,0,57,8.142857142857142,2,0.0,4,10,9,6,12,6,3,7,0,29,28,1
10602,92931,09jqR7IfvazajqsgYnjd0mGOuTyUXJmR,A3fsA9Zfv1X2fVEQhTw51lKENdNrEqT3,2,0,0,0,0,0,2,0,2,0.2857142857142857,1,0.0,0,0,0,0,0,0,0,2,0,0,2,1
10603,92933,Mf0xp5vhxE4EpnovGXm23q0TRlnpal5a,SpATywNh6bZuzm8s1ceuBUnMUAeoAHHw,1,0,0,0,0,0,1,0,1,0.14285714285714285,1,0.0,0,0,0,0,0,0,0,1,0,0,1,1
10604,92944,9HqwJ8d4m6K7QOSGhF3dVzXYAYpOl0vj,A3fsA9Zfv1X2fVEQhTw51lKENdNrEqT3,2,0,0,0,0,0,2,0,2,0.2857142857142857,1,0.0,0,0,0,0,0,0,0,2,0,0,2,1
10605,92947,xVCW9o5KqxAPnPVb1aenUpUZ6QWvEQCo,A3fsA9Zfv1X2fVEQhTw51lKENdNrEqT3,6,7,6,0,0,0,1,0,14,2.0,1,0.0,0,6,0,0,7,0,0,1,0,6,8,1
10606,92954,erkNYBqLpKRElyeL8GeAgO43CMazg6Rt,bWdj2GDclj5ofokWjzoa5jAwMkxCykd6,2,0,0,0,0,0,6,0,6,0.8571428571428571,2,0.0,0,0,0,0,0,0,0,6,0,0,6,1
10607,92957,DsdpjqDmkf4bB9F4w67WvhR5rXeY4BvC,bWdj2GDclj5ofokWjzoa5jAwMkxCykd6,11,18,7,0,6,27,11,1,70,10.0,1,0.0,7,7,0,6,11,27,0,11,1,20,50,1
10608,92960,3aETBFRObq3YeSOCDzQSdXdbqZJSuHf3,A3fsA9Zfv1X2fVEQhTw51lKENdNrEqT3,5,4,0,0,0,0,1,0,5,0.7142857142857143,1,0.0,0,0,0,0,4,0,0,1,0,0,5,1
10609,92962,4JgrlxTTs75mHh4mrh8qrfNDEELryL3p,bWdj2GDclj5ofokWjzoa5jAwMkxCykd6,12,15,6,18,42,0,4,0,85,12.142857142857142,1,0.0,2,6,16,42,13,0,2,4,0,66,19,1
10610,92968,eD22YcO1SJ996J45uu5dqIqwhKfXceL1,SpATywNh6bZuzm8s1ceuBUnMUAeoAHHw,3,2,1,0,1,0,0,0,4,0.5714285714285714,1,0.0,0,1,0,1,2,0,0,0,0,2,2,1
10611,92972,NXRVwFyxLXtyRtxM7ojyAnaiZQnhtjWO,SpATywNh6bZuzm8s1ceuBUnMUAeoAHHw,3,3,1,0,0,0,1,0,5,0.7142857142857143,1,0.0,0,1,0,0,3,0,0,1,0,1,4,1
10612,92975,mblW3W0a9cnUCcAYuJVrRwCReLzIZfZq,A3fsA9Zfv1X2fVEQhTw51lKENdNrEqT3,27,11,1,60,0,6,12,1,91,13.0,2,0.0,4,1,54,0,7,6,6,12,1,59,32,0
10613,92986,QKIVpxTYRwxpGiT6VdCFipdI87gZtHRH,SpATywNh6bZuzm8s1ceuBUnMUAeoAHHw,6,1,1,0,1,0,5,0,8,1.1428571428571428,1,0.0,0,1,0,1,1,0,0,5,0,2,6,1
10614,92988,niqjW4BciMttbwWr8wY84QzUCSHN5RSJ,G8EPVSXsOYB5YQWZGiz1aVq5Pgr2GrQu,1,0,0,0,0,0,1,0,1,0.14285714285714285,1,0.0,0,0,0,0,0,0,0,1,0,0,1,1
10615,92997,83JPfkin3GX4GLKqML2uaHSZ5KvsuJhM,SpATywNh6bZuzm8s1ceuBUnMUAeoAHHw,14,18,8,8,5,0,2,0,41,5.857142857142857,2,0.0,7,8,7,5,11,0,1,2,0,27,14,1
10616,93010,TMOi85sLkuYVgzErcEPoJc0AevPqR04B,RXDvfPUBYFlVdlueBFbLW0mhhAyGEqpt,17,21,11,14,4,11,10,1,72,10.285714285714286,5,0.0,3,11,11,4,18,11,3,10,1,29,43,1
10617,93012,PLJp2RYA7RZnQtREb0F5oRb3E0g7Z0Hr,G8EPVSXsOYB5YQWZGiz1aVq5Pgr2GrQu,2,0,0,0,0,0,2,0,2,0.2857142857142857,1,0.0,0,0,0,0,0,0,0,2,0,0,2,1
10618,93015,m9qgZNgP3Zn0sGVjbTdK1WyVxg0SzTDj,bWdj2GDclj5ofokWjzoa5jAwMkxCykd6,4,0,0,0,0,1,4,2,7,1.0,1,0.0,0,0,0,0,0,1,0,4,2,0,7,1
10619,93020,1RtjVFUMnRaIGZgXyyq9YVsVqwZO71yi,A3fsA9Zfv1X2fVEQhTw51lKENdNrEqT3,27,11,3,58,1,0,5,0,78,11.142857142857142,1,0.0,5,3,54,1,6,0,4,5,0,63,15,1
10620,93026,faeF4I5p3gAJMB1p4LfYVeCLQZKervYV,RXDvfPUBYFlVdlueBFbLW0mhhAyGEqpt,23,44,4,24,5,0,6,0,83,11.857142857142858,3,0.0,11,4,24,5,33,0,0,6,0,44,39,1
10621,93034,BIzXD84TaTFgXPtPL9bMALD9s3bgn0u7,SpATywNh6bZuzm8s1ceuBUnMUAeoAHHw,7,2,1,0,1,0,3,0,7,1.0,1,0.0,0,1,0,1,2,0,0,3,0,2,5,1
10622,93040,FlkgbrtKorC1nj2J8Ggbje7DCDtg1huD,A3fsA9Zfv1X2fVEQhTw51lKENdNrEqT3,5,4,2,0,1,0,4,0,11,1.5714285714285714,2,0.0,0,2,0,1,4,0,0,4,0,3,8,1
10623,93043,E5602d0htkVZGQTnJE6WlrGSkrgiKfR6,SpATywNh6bZuzm8s1ceuBUnMUAeoAHHw,2,0,0,0,0,0,2,0,2,0.2857142857142857,1,0.0,0,0,0,0,0,0,0,2,0,0,2,1
10624,93059,y5aIEV04Hqe57KpGOGn83CrEmVkQlotT,SpATywNh6bZuzm8s1ceuBUnMUAeoAHHw,4,2,0,0,0,1,2,0,5,0.7142857142857143,1,0.0,0,0,0,0,2,1,0,2,0,0,5,1
10625,93069,wxDnmvTLHWGwCYYCjH3qEOtgLqGKeB8y,bWdj2GDclj5ofokWjzoa5jAwMkxCykd6,2,0,0,0,0,0,3,0,3,0.42857142857142855,1,0.0,0,0,0,0,0,0,0,3,0,0,3,1
10626,93071,va3cVfF38XAjn4LEh6VxTTEdlP5IupZ2,bWdj2GDclj5ofokWjzoa5jAwMkxCykd6,1,0,0,0,0,0,1,0,1,0.14285714285714285,1,0.0,0,0,0,0,0,0,0,1,0,0,1,1
10627,93073,15L69MXCYIH8txiwXfgte6Bdad1p8M7U,SpATywNh6bZuzm8s1ceuBUnMUAeoAHHw,11,20,7,0,4,0,2,0,33,4.714285714285714,1,0.0,0,7,0,4,20,0,0,2,0,11,22,1
10628,93077,cnJW6igbDk7mivnYsxVZcWD5COwXKpJj,A3fsA9Zfv1X2fVEQhTw51lKENdNrEqT3,23,13,5,68,0,0,9,0,95,13.571428571428571,1,0.0,7,5,60,0,6,0,8,9,0,72,23,1
10629,93082,dPAuRkHCuQhCcbVNP1uiDIdfcWFQHP2t,SpATywNh6bZuzm8s1ceuBUnMUAeoAHHw,2,0,0,0,0,0,2,0,2,0.2857142857142857,1,0.0,0,0,0,0,0,0,0,2,0,0,2,1
10630,93106,28Xs6RIGljkwGIhsVvWB0d4RartQZhIp,SpATywNh6bZuzm8s1ceuBUnMUAeoAHHw,14,13,8,3,4,0,5,0,33,4.714285714285714,2,0.0,2,8,3,4,11,0,0,5,0,17,16,0
10631,93108,dBPTjHGtowbPnTOm514Emm9Jz5rIzrSj,SpATywNh6bZuzm8s1ceuBUnMUAeoAHHw,15,17,2,0,1,3,8,1,32,4.571428571428571,3,0.0,0,2,0,1,17,3,0,8,1,3,29,1
10632,93113,QOWLFnVTxLvLint3QUq9XwfNiIwpTPjR,G8EPVSXsOYB5YQWZGiz1aVq5Pgr2GrQu,6,2,1,0,1,0,3,0,7,1.0,1,0.0,0,1,0,1,2,0,0,3,0,2,5,1
10633,93128,OTVmyM3oMOEh3RPUJ9JvZ1cqJuClk9Op,A3fsA9Zfv1X2fVEQhTw51lKENdNrEqT3,13,24,11,0,5,1,6,1,48,6.857142857142857,2,0.0,2,11,0,5,22,1,0,6,1,18,30,1
10634,93151,Co9dycRC3nnJN4rm3WsLzyk3Mwz3zosU,SpATywNh6bZuzm8s1ceuBUnMUAeoAHHw,11,30,0,15,0,9,7,0,61,8.714285714285714,4,0.0,5,0,14,0,25,9,1,7,0,19,42,1
10635,93166,wjcBLe1692KFPJUkCwcKQrXvoLbsDg0j,A3fsA9Zfv1X2fVEQhTw51lKENdNrEqT3,9,13,6,0,3,0,3,0,25,3.5714285714285716,3,0.0,0,6,0,3,13,0,0,3,0,9,16,1
10636,93206,JtMmp5BCDQnYE7CMI3NvnX4aRCZsQW9K,RXDvfPUBYFlVdlueBFbLW0mhhAyGEqpt,1,0,0,0,0,0,2,0,2,0.2857142857142857,2,0.0,0,0,0,0,0,0,0,2,0,0,2,1
10637,93207,E7aYibTjzxGSk6NL3yeJVWuk7dqVnncv,bWdj2GDclj5ofokWjzoa5jAwMkxCykd6,4,5,2,0,2,0,1,0,10,1.4285714285714286,1,0.0,0,2,0,2,5,0,0,1,0,4,6,1
10638,93210,O9DTMIbbKOPsa4B7k1STk0nNuSR3cdx2,SpATywNh6bZuzm8s1ceuBUnMUAeoAHHw,3,2,0,0,0,0,2,0,4,0.5714285714285714,2,0.0,0,0,0,0,2,0,0,2,0,0,4,1
10639,93215,iCEb35gaygczCVXBPDGlI3sXrSsDaVej,A3fsA9Zfv1X2fVEQhTw51lKENdNrEqT3,1,0,0,0,0,0,1,0,1,0.14285714285714285,1,0.0,0,0,0,0,0,0,0,1,0,0,1,1
10640,93221,BhaFO7Lx4Q4YbNxvEeo9nBTXjsmsEz6c,SpATywNh6bZuzm8s1ceuBUnMUAeoAHHw,10,9,6,0,4,0,4,0,23,3.2857142857142856,2,0.0,0,6,0,4,9,0,0,4,0,10,13,1
10641,93225,mWv2aD1lbqJSR5LQ8znxXgNEw4RCzno5,bWdj2GDclj5ofokWjzoa5jAwMkxCykd6,1,0,0,0,0,0,1,0,1,0.14285714285714285,1,0.0,0,0,0,0,0,0,0,1,0,0,1,1
10642,93235,epvD2Wcl45J2GdVoBHzahVMdghFLent2,A3fsA9Zfv1X2fVEQhTw51lKENdNrEqT3,8,6,5,0,5,0,2,0,18,2.5714285714285716,1,0.0,0,5,0,5,6,0,0,2,0,10,8,1
10643,93249,yqsIVJwLxHRAX79gd7ST37Kksa5nD2Lx,SpATywNh6bZuzm8s1ceuBUnMUAeoAHHw,4,8,0,0,0,0,2,0,10,1.4285714285714286,1,0.0,0,0,0,0,8,0,0,2,0,0,10,1
10644,93294,zGuA1mMLvM3gfcKciKtoyFo6318fINqG,SpATywNh6bZuzm8s1ceuBUnMUAeoAHHw,1,0,0,0,0,0,1,0,1,0.14285714285714285,1,0.0,0,0,0,0,0,0,0,1,0,0,1,1
10645,93313,MU7wboUY4X1pw35YtYq9QO37Sakj8O8C,SpATywNh6bZuzm8s1ceuBUnMUAeoAHHw,6,5,3,0,3,0,1,0,12,1.7142857142857142,1,0.0,0,3,0,3,5,0,0,1,0,6,6,1
10646,93326,x6oT9QqDd4S0kTW1QntTwdbJd7rGTsDd,G8EPVSXsOYB5YQWZGiz1aVq5Pgr2GrQu,40,38,26,44,14,8,9,1,140,20.0,1,0.0,7,26,40,14,31,8,4,9,1,87,53,1
10647,93335,6WDAV2K5JXtsN5Y7oVoYno0rdPlDVwAS,SpATywNh6bZuzm8s1ceuBUnMUAeoAHHw,12,33,10,1,8,0,22,0,74,10.571428571428571,3,0.0,1,10,1,8,32,0,0,22,0,20,54,1
10648,93336,J9IFZ6lJS0kAA8VxmLEtsSsATCVlFyib,A3fsA9Zfv1X2fVEQhTw51lKENdNrEqT3,9,5,0,0,0,0,8,1,14,2.0,1,0.0,0,0,0,0,5,0,0,8,1,0,14,1
10649,93338,J9IFZ6lJS0kAA8VxmLEtsSsATCVlFyib,G8EPVSXsOYB5YQWZGiz1aVq5Pgr2GrQu,3,0,0,0,0,0,6,0,6,0.8571428571428571,2,0.0,0,0,0,0,0,0,0,6,0,0,6,1
10650,93346,b3ww03gxsETlWqnhgdTKJu0odbTVWElw,SpATywNh6bZuzm8s1ceuBUnMUAeoAHHw,1,0,0,0,0,0,1,0,1,0.14285714285714285,1,0.0,0,0,0,0,0,0,0,1,0,0,1,1
10651,93347,xfIcqx8ftYruTYGt1LiJYX4e8qkp171D,A3fsA9Zfv1X2fVEQhTw51lKENdNrEqT3,6,5,0,0,0,0,2,0,7,1.0,1,0.0,0,0,0,0,5,0,0,2,0,0,7,1
10652,93351,cwBiyXmdgaiw26TEVXDuCjvVYFCLKOa1,SpATywNh6bZuzm8s1ceuBUnMUAeoAHHw,6,14,3,0,1,0,1,0,19,2.7142857142857144,1,0.0,10,3,0,1,4,0,0,1,0,14,5,1
10653,93356,QKPOTPLCFSSptakTWL9scYXAQmH9VPoV,A3fsA9Zfv1X2fVEQhTw51lKENdNrEqT3,4,2,1,0,1,0,1,0,5,0.7142857142857143,1,0.0,0,1,0,1,2,0,0,1,0,2,3,1
10654,93373,rdlkz4QUHd85FYWQkxx9tuSVm08spAcj,A3fsA9Zfv1X2fVEQhTw51lKENdNrEqT3,11,5,3,0,3,0,3,0,14,2.0,1,0.0,0,3,0,3,5,0,0,3,0,6,8,1
10655,93374,AN1pw84sOSfQ3KFcxuCbDy0hYOBni6dp,G8EPVSXsOYB5YQWZGiz1aVq5Pgr2GrQu,23,30,11,34,3,0,10,0,88,12.571428571428571,1,0.0,12,11,24,3,18,0,10,10,0,50,38,1
10656,93383,YyNcczfjJii4HexOcQkp0MHeatr8c5sB,bWdj2GDclj5ofokWjzoa5jAwMkxCykd6,4,3,0,0,0,0,2,0,5,0.7142857142857143,1,0.0,0,0,0,0,3,0,0,2,0,0,5,1
10657,93384,1M4xACtMIoM8zWBXmaYDVcE8Iy4RYZ8e,G8EPVSXsOYB5YQWZGiz1aVq5Pgr2GrQu,13,13,2,10,1,3,14,1,44,6.285714285714286,2,0.0,5,2,7,1,8,3,3,14,1,15,29,1
10658,93387,HWAJhvF3LR86qA3qhHJiqZmQp4teUKAm,G8EPVSXsOYB5YQWZGiz1aVq5Pgr2GrQu,31,53,0,94,5,2,2,0,156,22.285714285714285,1,0.0,40,0,66,5,13,2,28,2,0,111,45,1
10659,93399,8LtTXy2ZLwBwWwH4BENA0Wiv8pjMa9RP,SpATywNh6bZuzm8s1ceuBUnMUAeoAHHw,11,18,0,10,0,6,3,0,37,5.285714285714286,1,0.0,9,0,8,0,9,6,2,3,0,17,20,1
10660,93402,wRuDkiFKsIS1XayC3m2MgIyWR2x1W3i6,A3fsA9Zfv1X2fVEQhTw51lKENdNrEqT3,6,3,1,0,1,0,3,0,8,1.1428571428571428,1,0.0,0,1,0,1,3,0,0,3,0,2,6,1
10661,93404,eT5JmMMKMcNoJjMWrJaUqOJQSpR601jL,A3fsA9Zfv1X2fVEQhTw51lKENdNrEqT3,4,2,1,0,1,0,5,0,9,1.2857142857142858,2,0.0,0,1,0,1,2,0,0,5,0,2,7,1
10662,93414,LiD14ALXLddUqpdQnujGFxQiBSoJOZGF,bWdj2GDclj5ofokWjzoa5jAwMkxCykd6,25,59,8,132,4,3,31,0,237,33.857142857142854,9,0.0,11,8,122,4,48,3,10,31,0,145,92,0
10663,93415,CiJGHZYjg5XVOtN8y1aUHiZjaXvVvsf8,bWdj2GDclj5ofokWjzoa5jAwMkxCykd6,5,3,1,0,1,0,5,0,10,1.4285714285714286,3,0.0,0,1,0,1,3,0,0,5,0,2,8,1
10664,93416,NFwkvwlecWBzcgNCOvBMTCkkUA7P9cK8,bWdj2GDclj5ofokWjzoa5jAwMkxCykd6,6,7,3,0,1,0,4,0,15,2.142857142857143,2,0.0,0,3,0,1,7,0,0,4,0,4,11,1
10665,93417,C6OkpqYGxZDK55uJrTXLk64MO2W2kN6e,SpATywNh6bZuzm8s1ceuBUnMUAeoAHHw,1,0,0,0,0,0,1,0,1,0.14285714285714285,1,0.0,0,0,0,0,0,0,0,1,0,0,1,1
10666,93422,HcOpBFh3ZPBJu7PjBFffM3Zedw54RSXN,A3fsA9Zfv1X2fVEQhTw51lKENdNrEqT3,4,8,2,0,0,0,2,0,12,1.7142857142857142,3,0.0,0,2,0,0,8,0,0,2,0,2,10,1
10667,93426,Hc0D2UkydjyUi3vnnsfmiB8lOnMbIWKo,SpATywNh6bZuzm8s1ceuBUnMUAeoAHHw,4,2,1,0,1,0,1,0,5,0.7142857142857143,1,0.0,0,1,0,1,2,0,0,1,0,2,3,0
10668,93434,BCPOhUa2LrfH93ebCE15VbF0VEWEyi7T,SpATywNh6bZuzm8s1ceuBUnMUAeoAHHw,6,3,2,0,2,0,1,0,8,1.1428571428571428,1,0.0,0,2,0,2,3,0,0,1,0,4,4,0
10669,93437,lmx2t8WuCRr4yPlE96c0Hld3ah69yimY,SpATywNh6bZuzm8s1ceuBUnMUAeoAHHw,8,16,2,17,0,26,2,0,63,9.0,1,0.0,14,2,15,0,2,26,2,2,0,31,32,1
10670,93444,wfUVHBmDLe0V8vTm9YNAi5Eoe98kipNK,RXDvfPUBYFlVdlueBFbLW0mhhAyGEqpt,36,58,3,0,4,0,12,5,82,11.714285714285714,4,0.0,4,3,0,4,54,0,0,12,5,11,71,1
10671,93454,IdPM07Tobfo8uXfAGdfrnlSPQUjcS5lw,SpATywNh6bZuzm8s1ceuBUnMUAeoAHHw,27,26,13,32,9,3,10,2,95,13.571428571428571,3,0.0,10,13,27,9,16,3,5,10,2,59,36,1
10672,93461,iNqMxLUew1d2DW8l74urvD3s2ojQNcOj,G8EPVSXsOYB5YQWZGiz1aVq5Pgr2GrQu,9,6,1,0,1,0,3,0,11,1.5714285714285714,2,0.0,0,1,0,1,6,0,0,3,0,2,9,1
10673,93463,KnjIylBxQGK5ybTZHRQCIOf6LVaiEDiE,SpATywNh6bZuzm8s1ceuBUnMUAeoAHHw,17,21,9,14,6,56,8,0,114,16.285714285714285,3,0.0,10,9,11,6,11,56,3,8,0,36,78,1
10674,93476,XiRokcstRgTAoxw5fli1EiomcYln51fR,bWdj2GDclj5ofokWjzoa5jAwMkxCykd6,4,3,0,0,0,0,5,0,8,1.1428571428571428,1,0.0,1,0,0,0,2,0,0,5,0,1,7,1
10675,93478,ouHHL7JxNnPJ7sZc8oGHgugCfHuyBFzn,bWdj2GDclj5ofokWjzoa5jAwMkxCykd6,10,12,7,0,4,1,5,1,30,4.285714285714286,4,0.0,0,7,0,4,12,1,0,5,1,11,19,1
10676,93497,QcZtDJ3gyfgBjK6fnA4Umq8WcjzDqlhe,A3fsA9Zfv1X2fVEQhTw51lKENdNrEqT3,1,0,0,0,0,0,1,0,1,0.14285714285714285,1,0.0,0,0,0,0,0,0,0,1,0,0,1,1
10677,93504,vaOIevkYLsk4A7wWmrPXcGrOKX6OgVbB,G8EPVSXsOYB5YQWZGiz1aVq5Pgr2GrQu,12,4,3,0,3,1,5,1,17,2.4285714285714284,1,0.0,0,3,0,3,4,1,0,5,1,6,11,1
10678,93513,yuqYkP52C7pQOIQ48GEgTRDqcNtFSeb3,bWdj2GDclj5ofokWjzoa5jAwMkxCykd6,22,29,13,38,7,37,21,1,146,20.857142857142858,4,0.0,8,13,35,7,21,37,3,21,1,63,83,1
10679,93517,1yALM9xjClF6jgXaABxhrYNC8eb8bQ9n,bWdj2GDclj5ofokWjzoa5jAwMkxCykd6,18,31,16,34,8,14,6,0,109,15.571428571428571,2,0.0,6,16,30,8,25,14,4,6,0,60,49,1
10680,93518,I3RIPLupgcaFBN4TZgx1kwE7cqUmhNGE,SpATywNh6bZuzm8s1ceuBUnMUAeoAHHw,9,12,2,0,2,4,6,0,26,3.7142857142857144,3,0.0,0,2,0,2,12,4,0,6,0,4,22,1
10681,93519,lUW6V1mqrGSz0okgfju4Oi2AssrcTWTN,bWdj2GDclj5ofokWjzoa5jAwMkxCykd6,12,6,4,0,3,1,8,0,22,3.142857142857143,2,0.0,0,4,0,3,6,1,0,8,0,7,15,1
10682,93520,caAQbOI1NkkZKVF3oGPK3OdsY0lbDlYb,bWdj2GDclj5ofokWjzoa5jAwMkxCykd6,6,2,1,0,1,1,5,2,12,1.7142857142857142,1,0.0,0,1,0,1,2,1,0,5,2,2,10,1
10683,93523,7KhKGJPxu4uQKYHNs7O3NjmuTH6NjrVY,A3fsA9Zfv1X2fVEQhTw51lKENdNrEqT3,27,24,18,0,12,2,13,1,70,10.0,3,0.0,0,18,0,12,24,2,0,13,1,30,40,0
10684,93525,SI82rbAOql23YmOWiXWAc0dEkHYrXScg,SpATywNh6bZuzm8s1ceuBUnMUAeoAHHw,8,4,1,0,1,3,5,0,14,2.0,1,0.0,0,1,0,1,4,3,0,5,0,2,12,1
10685,93529,K5WcXRk24XKmzfaggLfniRGhO7RrNYwU,SpATywNh6bZuzm8s1ceuBUnMUAeoAHHw,13,15,8,12,6,0,1,0,42,6.0,1,0.0,6,8,12,6,9,0,0,1,0,32,10,0
10686,93531,RHEMdhoy3TVz84IqO3CiO0ZVmx7sjl4N,A3fsA9Zfv1X2fVEQhTw51lKENdNrEqT3,48,27,19,65,14,0,10,0,135,19.285714285714285,3,0.0,1,19,52,14,26,0,13,10,0,86,49,0
10687,93538,oUwdPVwTRYLcPpw0ARjn83xyQKxe2P4j,A3fsA9Zfv1X2fVEQhTw51lKENdNrEqT3,8,15,0,0,0,0,4,0,19,2.7142857142857144,1,0.0,0,0,0,0,15,0,0,4,0,0,19,1
10688,93558,wjcBLe1692KFPJUkCwcKQrXvoLbsDg0j,bWdj2GDclj5ofokWjzoa5jAwMkxCykd6,3,3,1,0,0,0,1,0,5,0.7142857142857143,1,0.0,0,1,0,0,3,0,0,1,0,1,4,1
10689,93559,kQHHmjfVeHdUMEjst4rHDTfMZ6Hq7zy6,G8EPVSXsOYB5YQWZGiz1aVq5Pgr2GrQu,21,36,13,56,5,0,11,1,122,17.428571428571427,3,0.0,15,13,49,5,21,0,7,11,1,82,40,1
10690,93567,GWCKXkmUMNA4NMWmbV0iY9p0NnvUAuFf,SpATywNh6bZuzm8s1ceuBUnMUAeoAHHw,2,0,0,0,0,0,2,0,2,0.2857142857142857,1,0.0,0,0,0,0,0,0,0,2,0,0,2,1
10691,93576,kWRi0bjTsOLXCT3B1x0edeUqfKik54ld,SpATywNh6bZuzm8s1ceuBUnMUAeoAHHw,7,3,2,0,2,0,2,0,9,1.2857142857142858,1,0.0,0,2,0,2,3,0,0,2,0,4,5,1
10692,93583,3RcsrMTbPrb8ZHYXLlgwoRK7zrqTGSuq,A3fsA9Zfv1X2fVEQhTw51lKENdNrEqT3,22,17,13,2,11,0,4,0,47,6.714285714285714,1,0.0,3,13,2,11,14,0,0,4,0,29,18,1
10693,93594,SI82rbAOql23YmOWiXWAc0dEkHYrXScg,G8EPVSXsOYB5YQWZGiz1aVq5Pgr2GrQu,6,1,1,0,1,0,3,0,6,0.8571428571428571,1,0.0,0,1,0,1,1,0,0,3,0,2,4,1
10694,93601,auyTDueRbJJVbSgkNfSzePWA0sXDjoDA,A3fsA9Zfv1X2fVEQhTw51lKENdNrEqT3,5,4,0,0,0,0,4,0,8,1.1428571428571428,1,0.0,0,0,0,0,4,0,0,4,0,0,8,1
10695,93608,XIhNBV2ngE6VH3B3rFCGmtxUmfBaQQAu,bWdj2GDclj5ofokWjzoa5jAwMkxCykd6,2,0,0,0,0,0,4,0,4,0.5714285714285714,1,0.0,0,0,0,0,0,0,0,4,0,0,4,1
10696,93612,iKQWUg85b7iQVNDnFW3yVIr4MRSX1OiM,SpATywNh6bZuzm8s1ceuBUnMUAeoAHHw,9,4,4,0,4,0,4,0,16,2.2857142857142856,2,0.0,0,4,0,4,4,0,0,4,0,8,8,1
10697,93613,5zmdkrLCsYposTlmADCtPSCtqJszOFSq,A3fsA9Zfv1X2fVEQhTw51lKENdNrEqT3,17,11,8,0,5,1,6,0,31,4.428571428571429,2,0.0,0,8,0,5,11,1,0,6,0,13,18,1
10698,93623,SetmDwaBCsbTdPHVqtt90lo6lvXmXkbh,RXDvfPUBYFlVdlueBFbLW0mhhAyGEqpt,2,0,0,0,0,0,2,0,2,0.2857142857142857,1,0.0,0,0,0,0,0,0,0,2,0,0,2,1
10699,93634,hjHWaXhruoFaGhRZCz2Vsvz3ABLehqZ4,bWdj2GDclj5ofokWjzoa5jAwMkxCykd6,5,2,1,0,1,0,3,0,7,1.0,1,0.0,0,1,0,1,2,0,0,3,0,2,5,1
10700,93641,3NITGQuylcrTi63aoWqnzXuF5Rtf7QVq,A3fsA9Zfv1X2fVEQhTw51lKENdNrEqT3,37,13,11,80,10,0,1,0,115,16.428571428571427,1,0.0,1,11,69,10,12,0,11,1,0,91,24,1
10701,93642,87SYGQjFYUtEWda0pG12bcNker0JGBy3,A3fsA9Zfv1X2fVEQhTw51lKENdNrEqT3,5,7,0,0,0,0,1,0,8,1.1428571428571428,1,0.0,0,0,0,0,7,0,0,1,0,0,8,1
10702,93647,GyNkIVOso2X6ndPFrPZ0dYdTkjhdba2Q,G8EPVSXsOYB5YQWZGiz1aVq5Pgr2GrQu,10,11,3,0,3,0,7,0,24,3.4285714285714284,2,0.0,2,3,0,3,9,0,0,7,0,8,16,1
10703,93654,FFnoMDhUnJZ86LrCRa50JPybQorDvh89,RXDvfPUBYFlVdlueBFbLW0mhhAyGEqpt,10,10,7,0,3,0,4,0,24,3.4285714285714284,3,0.0,1,7,0,3,9,0,0,4,0,11,13,1
10704,93664,wmwDf7eIRrKPL0l8cNmMygnEPd5vzoqs,A3fsA9Zfv1X2fVEQhTw51lKENdNrEqT3,10,7,0,0,0,2,9,2,20,2.857142857142857,2,0.0,1,0,0,0,6,2,0,9,2,1,19,1
10705,93665,OCOZunZP01no4Zh4NYF1FDXoOWZrc1Yv,SpATywNh6bZuzm8s1ceuBUnMUAeoAHHw,10,16,2,26,2,0,1,0,47,6.714285714285714,1,0.0,11,2,21,2,5,0,5,1,0,36,11,1
10706,93668,wmwDf7eIRrKPL0l8cNmMygnEPd5vzoqs,bWdj2GDclj5ofokWjzoa5jAwMkxCykd6,8,7,1,0,0,1,6,1,16,2.2857142857142856,2,0.0,0,1,0,0,7,1,0,6,1,1,15,1
10707,93698,F3pS3HhR6zAyElkIe1WFx5cvIXH3Mmjf,SpATywNh6bZuzm8s1ceuBUnMUAeoAHHw,1,0,0,0,0,0,1,0,1,0.14285714285714285,1,0.0,0,0,0,0,0,0,0,1,0,0,1,1
10708,93711,VvbZjK8y9aernnsSHvAW377h2uAEkOuF,RXDvfPUBYFlVdlueBFbLW0mhhAyGEqpt,2,0,0,0,0,0,2,0,2,0.2857142857142857,1,0.0,0,0,0,0,0,0,0,2,0,0,2,1
10709,93728,GZzbpBGluNcEXFZ9BEQgqFPzH6qJC8rT,SpATywNh6bZuzm8s1ceuBUnMUAeoAHHw,13,21,3,8,1,0,8,1,42,6.0,3,0.0,0,3,7,1,21,0,1,8,1,11,31,1
10710,93733,vSy2YWE0W8axNgPS8DBIlQoMQuLcT6wu,G8EPVSXsOYB5YQWZGiz1aVq5Pgr2GrQu,2,0,0,0,0,0,2,0,2,0.2857142857142857,1,0.0,0,0,0,0,0,0,0,2,0,0,2,1
10711,93734,J2Ryyq6g6TjnFue1VPNlM9zNmZVB3792,SpATywNh6bZuzm8s1ceuBUnMUAeoAHHw,6,3,1,0,1,0,2,0,7,1.0,1,0.0,0,1,0,1,3,0,0,2,0,2,5,1
10712,93744,ROmxIDt1Nv5jCVXIVh1nfk5f1b4KKNIR,bWdj2GDclj5ofokWjzoa5jAwMkxCykd6,8,6,3,0,2,0,6,0,17,2.4285714285714284,2,0.0,0,3,0,2,6,0,0,6,0,5,12,1
10713,93756,KO9zYaiac2CNagQLdx3aJ9c2fXXMgIJX,SpATywNh6bZuzm8s1ceuBUnMUAeoAHHw,14,20,9,11,5,0,5,0,50,7.142857142857143,4,0.0,4,9,11,5,16,0,0,5,0,29,21,1
10714,93774,2AXxkCmyE7acjKrdHA94DKX4eMigeF9j,A3fsA9Zfv1X2fVEQhTw51lKENdNrEqT3,14,8,6,0,6,0,3,0,23,3.2857142857142856,2,0.0,0,6,0,6,8,0,0,3,0,12,11,1
10715,93781,seYLwHio53k0mOFj19dZ5TEGXq5ADUux,SpATywNh6bZuzm8s1ceuBUnMUAeoAHHw,5,2,1,0,0,0,6,0,9,1.2857142857142858,1,0.0,0,1,0,0,2,0,0,6,0,1,8,1
10716,93787,QOHFX3G0atWVkV8bdUDLZP6MvVAU1bxE,A3fsA9Zfv1X2fVEQhTw51lKENdNrEqT3,7,5,0,0,0,0,7,0,12,1.7142857142857142,2,0.0,0,0,0,0,5,0,0,7,0,0,12,1
10717,93789,bFxkSwC4B7FuMDmZm2HkHgiHz8QC2hPC,A3fsA9Zfv1X2fVEQhTw51lKENdNrEqT3,24,31,15,0,12,0,3,0,61,8.714285714285714,2,0.0,0,15,0,12,31,0,0,3,0,27,34,1
10718,93799,SvayS3hRjiQUsZJZ3Z80XuRW7pnvNCGH,SpATywNh6bZuzm8s1ceuBUnMUAeoAHHw,25,52,8,18,3,20,27,4,132,18.857142857142858,4,0.0,8,8,17,3,44,20,1,27,4,36,96,1
10719,93814,uHLnVmnvVGRf9UQIVsgUkoIvLInqWS41,RXDvfPUBYFlVdlueBFbLW0mhhAyGEqpt,35,83,43,32,26,5,26,3,218,31.142857142857142,3,0.0,9,43,30,26,74,5,2,26,3,108,110,1
10720,93818,CYf5wdcurcSyhJdbx09KiN2Kzj9VLvNU,SpATywNh6bZuzm8s1ceuBUnMUAeoAHHw,1,0,0,0,0,0,1,0,1,0.14285714285714285,1,0.0,0,0,0,0,0,0,0,1,0,0,1,1
10721,93821,O2RP4lI2hqQTYW7uUxK7lTmJyXECBert,SpATywNh6bZuzm8s1ceuBUnMUAeoAHHw,4,2,1,0,1,0,1,0,5,0.7142857142857143,1,0.0,0,1,0,1,2,0,0,1,0,2,3,1
10722,93835,D98GkCb5yOnLtlLtWNWnUK2keXt1DRWI,A3fsA9Zfv1X2fVEQhTw51lKENdNrEqT3,2,0,0,0,0,0,2,0,2,0.2857142857142857,1,0.0,0,0,0,0,0,0,0,2,0,0,2,1
10723,93843,OMmdzdRtTLASG3chso9cdfg94JQDfZqt,SpATywNh6bZuzm8s1ceuBUnMUAeoAHHw,11,15,5,2,3,0,3,0,28,4.0,3,0.0,2,5,2,3,13,0,0,3,0,12,16,1
10724,93860,iDEg223wPLRjblw05XWiNlNB0XKXbAH3,SpATywNh6bZuzm8s1ceuBUnMUAeoAHHw,8,4,2,0,1,0,6,1,14,2.0,1,0.0,0,2,0,1,4,0,0,6,1,3,11,1
10725,93862,MdwJcKhWKSfBlz1JQsWSYPZY8VplWXai,SpATywNh6bZuzm8s1ceuBUnMUAeoAHHw,2,0,0,0,0,0,3,0,3,0.42857142857142855,2,0.0,0,0,0,0,0,0,0,3,0,0,3,1
10726,93863,Ac4OXBvc7WZ07azvF8LolPbeFPCXH5U0,SpATywNh6bZuzm8s1ceuBUnMUAeoAHHw,1,0,0,0,0,0,1,0,1,0.14285714285714285,1,0.0,0,0,0,0,0,0,0,1,0,0,1,1
10727,93879,qT6iwsUe27SkWCpThee9QunElnsrIqyP,SpATywNh6bZuzm8s1ceuBUnMUAeoAHHw,16,18,6,14,3,0,8,0,49,7.0,3,0.0,7,6,13,3,11,0,1,8,0,29,20,1
10728,93881,wKKdkZJ3MevUShYy00jn3yNZpY2kcdrV,A3fsA9Zfv1X2fVEQhTw51lKENdNrEqT3,4,1,0,0,0,0,3,0,4,0.5714285714285714,1,0.0,0,0,0,0,1,0,0,3,0,0,4,0
10729,93900,L1FTG9TM6RI5TBCTexQgshQhXhu2oZpJ,A3fsA9Zfv1X2fVEQhTw51lKENdNrEqT3,97,44,31,162,20,0,20,0,277,39.57142857142857,8,0.0,3,31,154,20,41,0,8,20,0,208,69,0
10730,93903,L1FTG9TM6RI5TBCTexQgshQhXhu2oZpJ,G8EPVSXsOYB5YQWZGiz1aVq5Pgr2GrQu,44,39,18,74,14,0,4,0,149,21.285714285714285,2,0.0,15,18,68,14,24,0,6,4,0,115,34,1
10731,93906,df9qJcc4auTr14t9gsIjmvQwAgkzyFuV,SpATywNh6bZuzm8s1ceuBUnMUAeoAHHw,6,2,1,0,1,0,3,0,7,1.0,1,0.0,0,1,0,1,2,0,0,3,0,2,5,1
10732,93917,MyQ8e9mBKn27AhY70WumCof36bw293Y4,SpATywNh6bZuzm8s1ceuBUnMUAeoAHHw,16,24,7,17,3,4,7,0,62,8.857142857142858,3,0.0,12,7,13,3,12,4,4,7,0,35,27,1
10733,93918,oW89eJD99A7pCOqqvTkgIt7CVSu0bGbe,SpATywNh6bZuzm8s1ceuBUnMUAeoAHHw,8,5,2,0,1,0,6,0,14,2.0,1,0.0,0,2,0,1,5,0,0,6,0,3,11,1
10734,93920,EJ6j1DQBzD1orM5Ltf8vXiAVi2YaVKj4,A3fsA9Zfv1X2fVEQhTw51lKENdNrEqT3,12,16,7,0,6,0,1,0,30,4.285714285714286,1,0.0,0,7,0,6,16,0,0,1,0,13,17,1
10735,93924,QrJQFROnKZICXeQTI0yD9R5uKCsOiaxB,bWdj2GDclj5ofokWjzoa5jAwMkxCykd6,5,3,1,0,1,0,2,0,7,1.0,1,0.0,0,1,0,1,3,0,0,2,0,2,5,1
10736,93928,grEUheAl7r2qUdLFFy9nEMsG9X5GQrvY,SpATywNh6bZuzm8s1ceuBUnMUAeoAHHw,17,16,7,7,5,1,6,1,43,6.142857142857143,1,0.0,7,7,7,5,9,1,0,6,1,26,17,1
10737,93937,2j0Susczy7BF2QnNLUm3dJdUMP10ntAU,SpATywNh6bZuzm8s1ceuBUnMUAeoAHHw,16,19,12,9,3,0,9,2,54,7.714285714285714,2,0.0,2,12,8,3,17,0,1,9,2,25,29,1
10738,93949,pQdqlOtxi2sBVu8vnQy738Mf4LOYprkG,SpATywNh6bZuzm8s1ceuBUnMUAeoAHHw,5,2,1,0,1,0,3,0,7,1.0,1,0.0,0,1,0,1,2,0,0,3,0,2,5,1
10739,93951,Ei65KRTqH4vAZu2hVbuPfr6ybTjVLWsx,SpATywNh6bZuzm8s1ceuBUnMUAeoAHHw,12,19,7,0,6,0,4,0,36,5.142857142857143,2,0.0,7,7,0,6,12,0,0,4,0,20,16,1
10740,93967,XyD01HhzMuHzP5ArHNJFexoSZMamD6Wh,SpATywNh6bZuzm8s1ceuBUnMUAeoAHHw,14,17,8,16,5,1,3,0,50,7.142857142857143,2,0.0,7,8,14,5,10,1,2,3,0,34,16,1
10741,93981,aoxjDsJ8sZvuPjSCqksrdXkImRMV7vgy,A3fsA9Zfv1X2fVEQhTw51lKENdNrEqT3,5,5,1,0,0,0,2,0,8,1.1428571428571428,1,0.0,0,1,0,0,5,0,0,2,0,1,7,1
10742,93999,M4LPRpz3NIxIAwFWtYdMyaFovwI23Hwi,SpATywNh6bZuzm8s1ceuBUnMUAeoAHHw,1,0,0,0,0,0,1,0,1,0.14285714285714285,1,0.0,0,0,0,0,0,0,0,1,0,0,1,1
10743,94009,E1EZDOz8phdW938KkZKGZCkkHanJOco1,bWdj2GDclj5ofokWjzoa5jAwMkxCykd6,5,2,1,0,1,0,2,0,6,0.8571428571428571,1,0.0,0,1,0,1,2,0,0,2,0,2,4,1
10744,94020,aj6uF4XWV3XUUfOpWCk3NuntI2wXym6n,bWdj2GDclj5ofokWjzoa5jAwMkxCykd6,3,0,0,0,0,0,9,0,9,1.2857142857142858,1,0.0,0,0,0,0,0,0,0,9,0,0,9,1
10745,94021,ZtP7ZrczBJoU0XUS4dUWlvI4t1uLf935,A3fsA9Zfv1X2fVEQhTw51lKENdNrEqT3,8,6,4,0,3,0,2,0,15,2.142857142857143,1,0.0,1,4,0,3,5,0,0,2,0,8,7,1
10746,94033,1j3EQYZpvzbHITrSXjRLOl0JrSGShjCW,SpATywNh6bZuzm8s1ceuBUnMUAeoAHHw,12,8,5,5,3,0,2,0,23,3.2857142857142856,1,0.0,2,5,4,3,6,0,1,2,0,14,9,1
10747,94041,gMeZHtHbmrRB8drlaFHRYNGQ6Z4lgho8,A3fsA9Zfv1X2fVEQhTw51lKENdNrEqT3,8,2,1,0,1,0,5,1,10,1.4285714285714286,1,0.0,0,1,0,1,2,0,0,5,1,2,8,1
10748,94050,5WAIxgqU8QRTpOrU8O3vmj4h4ZKof8jn,bWdj2GDclj5ofokWjzoa5jAwMkxCykd6,7,3,2,0,2,0,2,0,9,1.2857142857142858,1,0.0,0,2,0,2,3,0,0,2,0,4,5,1
10749,94059,WO12a2dRrxFwdlmt1PknzZCD2wf5mAFA,SpATywNh6bZuzm8s1ceuBUnMUAeoAHHw,4,3,0,0,0,0,2,0,5,0.7142857142857143,1,0.0,0,0,0,0,3,0,0,2,0,0,5,1
10750,94061,eEQqKnaUGHJzSnB7MrBGgZfDTYsV36xI,A3fsA9Zfv1X2fVEQhTw51lKENdNrEqT3,2,0,0,0,0,0,2,0,2,0.2857142857142857,1,0.0,0,0,0,0,0,0,0,2,0,0,2,1
10751,94083,sTlxlEkJ3MbMUAeSajnaHOGfpyW9hgq1,SpATywNh6bZuzm8s1ceuBUnMUAeoAHHw,53,69,33,41,18,1,8,0,170,24.285714285714285,5,0.0,12,33,38,18,57,1,3,8,0,101,69,0
10752,94086,uKZ87zwhOlE6XjyVFr8vmJl9wOD1B9qQ,A3fsA9Zfv1X2fVEQhTw51lKENdNrEqT3,11,9,4,0,2,8,14,0,37,5.285714285714286,4,0.0,0,4,0,2,9,8,0,14,0,6,31,1
10753,94097,uKZ87zwhOlE6XjyVFr8vmJl9wOD1B9qQ,bWdj2GDclj5ofokWjzoa5jAwMkxCykd6,1,0,0,0,0,0,1,0,1,0.14285714285714285,1,0.0,0,0,0,0,0,0,0,1,0,0,1,1
10754,94106,MRzfDn8Dt6xZQHTAuGEWQiuznoHxxpTX,SpATywNh6bZuzm8s1ceuBUnMUAeoAHHw,16,20,13,13,3,3,7,0,59,8.428571428571429,3,0.0,5,13,11,3,15,3,2,7,0,32,27,1
10755,94113,nVXGW3QRysmVp7bseFXpH5xogt6vyuOe,A3fsA9Zfv1X2fVEQhTw51lKENdNrEqT3,1,0,0,0,0,0,4,0,4,0.5714285714285714,3,0.0,0,0,0,0,0,0,0,4,0,0,4,1
10756,94124,XyD01HhzMuHzP5ArHNJFexoSZMamD6Wh,G8EPVSXsOYB5YQWZGiz1aVq5Pgr2GrQu,9,6,2,0,2,0,4,3,17,2.4285714285714284,2,0.0,2,2,0,2,4,0,0,4,3,6,11,1
10757,94128,sKWLe14EbvHw5vqAsPu64KkYjNDdUiTB,SpATywNh6bZuzm8s1ceuBUnMUAeoAHHw,8,9,0,8,0,0,6,0,23,3.2857142857142856,2,0.0,2,0,6,0,7,0,2,6,0,8,15,0
10758,94132,agX7ad5amneAPRCUHAMkIow0n3bNeaeT,SpATywNh6bZuzm8s1ceuBUnMUAeoAHHw,10,5,4,0,3,0,3,0,15,2.142857142857143,1,0.0,0,4,0,3,5,0,0,3,0,7,8,1
10759,94154,sEtktPcVAhFQ7PqkOK3agQy8gf3suIv1,SpATywNh6bZuzm8s1ceuBUnMUAeoAHHw,44,89,23,46,14,8,14,4,198,28.285714285714285,9,0.0,11,23,40,14,78,8,6,14,4,88,110,0
10760,94159,tT3q39TssUZPXoxVdRzgRUu1SUheNubE,A3fsA9Zfv1X2fVEQhTw51lKENdNrEqT3,9,5,3,0,3,1,2,0,14,2.0,1,0.0,0,3,0,3,5,1,0,2,0,6,8,1
10761,94168,ImT05r98NIKWlAcW1CpDyV3beLAyiPwI,A3fsA9Zfv1X2fVEQhTw51lKENdNrEqT3,39,20,10,72,7,0,4,0,113,16.142857142857142,2,0.0,1,10,62,7,19,0,10,4,0,80,33,1
10762,94173,ekbYWgnVFLMYoljaE2I4pYzmSROCPA7U,SpATywNh6bZuzm8s1ceuBUnMUAeoAHHw,17,21,7,11,3,15,11,1,69,9.857142857142858,3,0.0,11,7,10,3,10,15,1,11,1,31,38,1
10763,94185,uHQHB7VXsqIiN9QWww9HiRF0pTlZ4g4T,SpATywNh6bZuzm8s1ceuBUnMUAeoAHHw,12,14,1,23,0,0,2,0,40,5.714285714285714,1,0.0,4,1,20,0,10,0,3,2,0,25,15,1
10764,94191,aMoLa2myIR3XZbIIUknP0HHf77SQMaDf,A3fsA9Zfv1X2fVEQhTw51lKENdNrEqT3,1,0,0,0,0,0,1,0,1,0.14285714285714285,1,0.0,0,0,0,0,0,0,0,1,0,0,1,1
10765,94197,OOnLMU5i5dIEK7NKdoclKsBTE1KLFIfI,SpATywNh6bZuzm8s1ceuBUnMUAeoAHHw,6,7,2,0,1,0,2,0,12,1.7142857142857142,1,0.0,0,2,0,1,7,0,0,2,0,3,9,1
10766,94199,kbnRP5v2Cp1hRovzbBsM6Gb1jKCIVIhL,A3fsA9Zfv1X2fVEQhTw51lKENdNrEqT3,3,2,0,0,0,0,2,0,4,0.5714285714285714,1,0.0,0,0,0,0,2,0,0,2,0,0,4,1
10767,94203,6pBQz4v6AEbi1mr9tNTCug5y9Nmhc90r,A3fsA9Zfv1X2fVEQhTw51lKENdNrEqT3,9,8,5,0,3,0,3,0,19,2.7142857142857144,1,0.0,0,5,0,3,8,0,0,3,0,8,11,1
10768,94205,3KCb4A6amo38Fw6QE756HJn80s8Q1p3u,RXDvfPUBYFlVdlueBFbLW0mhhAyGEqpt,1,0,0,0,0,0,1,0,1,0.14285714285714285,1,0.0,0,0,0,0,0,0,0,1,0,0,1,1
10769,94208,NO1MJkdcGNcIxZKkf5qtzbhQeFobR0HR,SpATywNh6bZuzm8s1ceuBUnMUAeoAHHw,15,11,4,16,3,10,4,0,48,6.857142857142857,1,0.0,6,4,16,3,5,10,0,4,0,29,19,1
10770,94210,4cB4y17zVi4jfdrlreMIHGN1aQJHMMST,bWdj2GDclj5ofokWjzoa5jAwMkxCykd6,5,1,1,0,0,0,3,0,5,0.7142857142857143,1,0.0,0,1,0,0,1,0,0,3,0,1,4,1
10771,94213,6nUn5FL9ZAMjSGoB8M6FuLGMybzSihLy,SpATywNh6bZuzm8s1ceuBUnMUAeoAHHw,4,0,0,0,0,0,3,1,4,0.5714285714285714,1,0.0,0,0,0,0,0,0,0,3,1,0,4,1
10772,94229,dzvyuk189tsgDZIOFuacAzCgRiphRz5M,SpATywNh6bZuzm8s1ceuBUnMUAeoAHHw,13,31,7,12,3,0,10,0,63,9.0,4,0.0,12,7,10,3,19,0,2,10,0,32,31,0
10773,94245,rFglXXD43LPWYWjk5nJFVhPJBw4btSRI,SpATywNh6bZuzm8s1ceuBUnMUAeoAHHw,11,9,2,0,1,3,8,1,24,3.4285714285714284,2,0.0,0,2,0,1,9,3,0,8,1,3,21,1
10774,94269,CyJflfaXZKlRhnAKYz3Gu6YETYpaZMel,SpATywNh6bZuzm8s1ceuBUnMUAeoAHHw,2,0,0,0,0,0,2,0,2,0.2857142857142857,1,0.0,0,0,0,0,0,0,0,2,0,0,2,1
10775,94274,0NICeN7b6gzNzu2kflLtEXCwdFBGs0NN,bWdj2GDclj5ofokWjzoa5jAwMkxCykd6,7,5,0,0,0,0,4,0,9,1.2857142857142858,1,0.0,0,0,0,0,5,0,0,4,0,0,9,1
10776,94286,M8C9BDFICk4ida59GU0jjp556zazDEi1,A3fsA9Zfv1X2fVEQhTw51lKENdNrEqT3,17,19,13,0,6,0,11,0,49,7.0,6,0.0,0,13,0,6,19,0,0,11,0,19,30,1
10777,94287,Ft2AG2HMzLmh2EcmDrFVFbinKvFMlb1G,A3fsA9Zfv1X2fVEQhTw51lKENdNrEqT3,2,0,0,0,0,0,2,0,2,0.2857142857142857,1,0.0,0,0,0,0,0,0,0,2,0,0,2,1
10778,94291,r2j4kmS3sSw2bBC6XtGVEzDG8uZSaMde,bWdj2GDclj5ofokWjzoa5jAwMkxCykd6,2,0,0,0,0,0,2,0,2,0.2857142857142857,2,0.0,0,0,0,0,0,0,0,2,0,0,2,1
10779,94294,M8C9BDFICk4ida59GU0jjp556zazDEi1,bWdj2GDclj5ofokWjzoa5jAwMkxCykd6,10,22,13,0,5,5,12,0,57,8.142857142857142,6,0.0,0,13,0,5,22,5,0,12,0,18,39,1
10780,94297,PSQvTxj1y3we6BHzfg47qDUvmFQLocrD,RXDvfPUBYFlVdlueBFbLW0mhhAyGEqpt,4,3,1,0,0,0,2,0,6,0.8571428571428571,1,0.0,0,1,0,0,3,0,0,2,0,1,5,1
10781,94303,OFXXpJjmXQdJCa3neipnRUGCkhEYKOcL,RXDvfPUBYFlVdlueBFbLW0mhhAyGEqpt,1,0,0,0,0,0,1,0,1,0.14285714285714285,1,0.0,0,0,0,0,0,0,0,1,0,0,1,1
10782,94318,VykAceZUulaqkCpokuW5Za4FHqwbjR1t,bWdj2GDclj5ofokWjzoa5jAwMkxCykd6,2,0,0,0,0,0,3,0,3,0.42857142857142855,2,0.0,0,0,0,0,0,0,0,3,0,0,3,1
10783,94327,nm4sJLNdobmK6nfqGoX1goxharKsSyKv,RXDvfPUBYFlVdlueBFbLW0mhhAyGEqpt,6,3,2,0,2,0,1,0,8,1.1428571428571428,2,0.0,0,2,0,2,3,0,0,1,0,4,4,1
10784,94336,vtU6JORjVkLaXrwFmZEhiuwgIFIb8D5d,bWdj2GDclj5ofokWjzoa5jAwMkxCykd6,4,2,0,0,0,0,2,0,4,0.5714285714285714,1,0.0,0,0,0,0,2,0,0,2,0,0,4,1
10785,94338,yk8HuNxXIum8r8XDIOHqnAVeWfg9tYo1,bWdj2GDclj5ofokWjzoa5jAwMkxCykd6,24,37,17,88,8,2,4,0,156,22.285714285714285,2,0.0,17,17,88,8,20,2,0,4,0,130,26,1
10786,94345,57fIWdKz3C3DE8VWT2c85KC8LovB1GJc,SpATywNh6bZuzm8s1ceuBUnMUAeoAHHw,8,3,0,0,0,0,6,1,10,1.4285714285714286,1,0.0,0,0,0,0,3,0,0,6,1,0,10,1
10787,94349,tkz0XqYzbemGJfGKDWj9gxriQAFTaODF,SpATywNh6bZuzm8s1ceuBUnMUAeoAHHw,5,9,4,0,0,0,3,0,16,2.2857142857142856,1,0.0,0,4,0,0,9,0,0,3,0,4,12,1
10788,94360,Wx74KNuo9MEhjxtzU2HbTG4AbGSUPoBd,SpATywNh6bZuzm8s1ceuBUnMUAeoAHHw,13,11,6,0,4,1,4,0,26,3.7142857142857144,2,0.0,0,6,0,4,11,1,0,4,0,10,16,1
10789,94369,f83h4yuqimgMGxVhGXHOS7nPCMRes6Qy,A3fsA9Zfv1X2fVEQhTw51lKENdNrEqT3,20,10,9,0,8,0,2,0,29,4.142857142857143,1,0.0,0,9,0,8,10,0,0,2,0,17,12,1
10790,94370,LfQeKYjXm6fIUOYzQcp1BnDj9xoPObW8,SpATywNh6bZuzm8s1ceuBUnMUAeoAHHw,8,7,3,0,1,0,6,0,17,2.4285714285714284,1,0.0,0,3,0,1,7,0,0,6,0,4,13,1
10791,94371,na1nn5UiTLqwc4QuFzUQCajZnMiZo4DY,SpATywNh6bZuzm8s1ceuBUnMUAeoAHHw,9,7,5,6,1,0,3,0,22,3.142857142857143,1,0.0,0,5,5,1,7,0,1,3,0,11,11,1
10792,94380,FX47GMrA7B8YjGPkDGCkONJuduXkgeGC,A3fsA9Zfv1X2fVEQhTw51lKENdNrEqT3,1,0,0,0,0,0,1,0,1,0.14285714285714285,1,0.0,0,0,0,0,0,0,0,1,0,0,1,1
10793,94381,NpKmXMDiovurtYgXEkcoE0sVWAxI8pB3,SpATywNh6bZuzm8s1ceuBUnMUAeoAHHw,2,0,0,0,0,0,3,0,3,0.42857142857142855,1,0.0,0,0,0,0,0,0,0,3,0,0,3,1
10794,94390,2ZmAuHOKUwpsOZtu09BcUrjIotbqiy3i,RXDvfPUBYFlVdlueBFbLW0mhhAyGEqpt,7,2,1,0,0,1,6,1,11,1.5714285714285714,1,0.0,0,1,0,0,2,1,0,6,1,1,10,1
10795,94412,mXYBTPDkJluI9G6T4seVU7hhFpBmZYUl,G8EPVSXsOYB5YQWZGiz1aVq5Pgr2GrQu,5,2,1,0,1,0,2,0,6,0.8571428571428571,1,0.0,0,1,0,1,2,0,0,2,0,2,4,1
10796,94434,D7ijm86N7h5o3w1fsSkZ0iVyhHtcIbis,SpATywNh6bZuzm8s1ceuBUnMUAeoAHHw,31,80,22,63,2,11,10,1,189,27.0,6,0.0,48,22,54,2,32,11,9,10,1,126,63,0
10797,94436,dgp1qm7PjXoVV4MjyzuvWetQrJ3T9kos,A3fsA9Zfv1X2fVEQhTw51lKENdNrEqT3,13,10,7,0,3,2,20,2,44,6.285714285714286,3,0.0,0,7,0,3,10,2,0,20,2,10,34,1
10798,94440,Zp3KwB88qNkgRL7fOtXbXw8ohFvxUyg2,bWdj2GDclj5ofokWjzoa5jAwMkxCykd6,13,11,5,50,4,1,13,2,86,12.285714285714286,1,0.0,4,5,48,4,7,1,2,13,2,61,25,1
10799,94470,gTN0rkPeefB1hZOI5VW6CFWJwvhdBtBh,SpATywNh6bZuzm8s1ceuBUnMUAeoAHHw,5,2,1,0,1,0,4,0,8,1.1428571428571428,1,0.0,0,1,0,1,2,0,0,4,0,2,6,1
10800,94473,KkeLwwXyUiCfeVvKPcarXSSK8DrECkDe,A3fsA9Zfv1X2fVEQhTw51lKENdNrEqT3,5,7,3,0,0,0,3,0,13,1.8571428571428572,3,0.0,0,3,0,0,7,0,0,3,0,3,10,1
10801,94480,LkgxCzljZyoH3VIdoXwdLt0OprbSc3sT,SpATywNh6bZuzm8s1ceuBUnMUAeoAHHw,13,17,10,0,3,0,9,0,39,5.571428571428571,2,0.0,0,10,0,3,17,0,0,9,0,13,26,1
10802,94491,a9Qi5jUo324IBdWO7mih7fiFScdu3QAb,SpATywNh6bZuzm8s1ceuBUnMUAeoAHHw,5,4,3,0,0,0,1,0,8,1.1428571428571428,1,0.0,0,3,0,0,4,0,0,1,0,3,5,1
10803,94493,OseLd0Vj4CawbZPfZRznLZH5tivxQP68,G8EPVSXsOYB5YQWZGiz1aVq5Pgr2GrQu,15,10,4,14,2,0,2,0,32,4.571428571428571,1,0.0,6,4,8,2,4,0,6,2,0,20,12,1
10804,94530,nfkChXOgZdpVvi08Lznw3yUSxVHRyF8G,3VkHkmOtom3jM2wCu94xgzzu1d6Dn7or,64,47,38,0,30,3,29,4,151,21.571428571428573,6,0.0,0,38,0,30,47,3,0,29,4,68,83,0
10805,94543,qhQ2GK7Lh19jQzzepIjTZe30HhK11qeW,3VkHkmOtom3jM2wCu94xgzzu1d6Dn7or,1,0,0,0,0,0,1,0,1,0.14285714285714285,1,0.0,0,0,0,0,0,0,0,1,0,0,1,1
10806,94565,3i49Sfu7S1sOSKkYGlbdOOFKpde4e9tM,3VkHkmOtom3jM2wCu94xgzzu1d6Dn7or,19,26,12,2,8,12,25,0,85,12.142857142857142,2,0.0,6,12,2,8,20,12,0,25,0,28,57,1
10807,94566,baW5UAz7zlk0CrGbuOvyaGEkL1grJcoL,3VkHkmOtom3jM2wCu94xgzzu1d6Dn7or,1,0,0,0,0,0,1,0,1,0.14285714285714285,1,0.0,0,0,0,0,0,0,0,1,0,0,1,1
10808,94570,54B8rR1nClZlVaRsYfu6B3kewu4GkqDW,3VkHkmOtom3jM2wCu94xgzzu1d6Dn7or,14,9,7,0,6,0,2,0,24,3.4285714285714284,1,0.0,0,7,0,6,9,0,0,2,0,13,11,1
10809,94599,HhvQOu36AUwxS3HBXRWzCwV2HEANGBv6,3VkHkmOtom3jM2wCu94xgzzu1d6Dn7or,70,49,21,113,23,0,5,0,211,30.142857142857142,2,0.0,25,21,90,23,24,0,23,5,0,159,52,0
10810,94642,pHLiBn4di6o0B9uDKRBPn3MLmLjqZutv,3VkHkmOtom3jM2wCu94xgzzu1d6Dn7or,3,0,0,0,0,0,4,0,4,0.5714285714285714,1,0.0,0,0,0,0,0,0,0,4,0,0,4,1
10811,94656,WIHfqmQWQm1dArw6kMtfoKehEOrFfPTO,3VkHkmOtom3jM2wCu94xgzzu1d6Dn7or,7,2,1,0,1,1,5,1,11,1.5714285714285714,1,0.0,0,1,0,1,2,1,0,5,1,2,9,1
10812,94663,8Og7fXsG7tOj0uMvHAUHZQfHOc8ippo0,3VkHkmOtom3jM2wCu94xgzzu1d6Dn7or,7,4,2,0,2,2,4,4,18,2.5714285714285716,2,0.0,1,2,0,2,3,2,0,4,4,5,13,1
10813,94665,B6qgKGhHiyA76qIwFIN676gO020n5rqy,3VkHkmOtom3jM2wCu94xgzzu1d6Dn7or,10,13,6,0,5,0,4,0,28,4.0,1,0.0,0,6,0,5,13,0,0,4,0,11,17,1
10814,94670,0XqA347t1gkcvYkcQgRDcKNiGKlFYnsB,3VkHkmOtom3jM2wCu94xgzzu1d6Dn7or,35,68,56,0,45,0,9,0,178,25.428571428571427,4,0.0,0,56,0,45,68,0,0,9,0,101,77,0
10815,94672,D7NGYdR3TLx6U0EvEqMYenyKGPerYPxa,3VkHkmOtom3jM2wCu94xgzzu1d6Dn7or,5,2,1,0,1,0,2,0,6,0.8571428571428571,1,0.0,0,1,0,1,2,0,0,2,0,2,4,1
10816,94676,z9xgLltXJrOKzy4oJk2CDd0xNs9LAXro,3VkHkmOtom3jM2wCu94xgzzu1d6Dn7or,1,0,0,0,0,0,1,0,1,0.14285714285714285,1,0.0,0,0,0,0,0,0,0,1,0,0,1,1
10817,94692,bZVTm5UIuuu8152Ew15JO85CwYdhp6KF,3VkHkmOtom3jM2wCu94xgzzu1d6Dn7or,2,0,0,0,0,0,2,0,2,0.2857142857142857,1,0.0,0,0,0,0,0,0,0,2,0,0,2,1
10818,94715,6AaaRrtVZvQnfPKLSvNXhOJuVdyCqSNQ,3VkHkmOtom3jM2wCu94xgzzu1d6Dn7or,6,2,1,0,1,0,3,0,7,1.0,1,0.0,0,1,0,1,2,0,0,3,0,2,5,1
10819,94735,3wXI1egBJpCrUunPn32MLTtZtgDMGhKh,3VkHkmOtom3jM2wCu94xgzzu1d6Dn7or,1,0,0,0,0,0,1,0,1,0.14285714285714285,1,0.0,0,0,0,0,0,0,0,1,0,0,1,1
10820,94777,PzU299qhBRNb9VKeEV5yMlpPdnEheXTy,3VkHkmOtom3jM2wCu94xgzzu1d6Dn7or,10,14,0,7,7,1,14,2,45,6.428571428571429,2,0.0,9,0,6,7,5,1,1,14,2,22,23,1
10821,94780,8fcc753U4KzP0JveMl3w4klOTZBrYC4k,3VkHkmOtom3jM2wCu94xgzzu1d6Dn7or,1,0,0,0,0,0,2,0,2,0.2857142857142857,1,0.0,0,0,0,0,0,0,0,2,0,0,2,1
10822,94804,7MaoDLJpOqt0M6I4hg14oULFD6Rytoi3,3VkHkmOtom3jM2wCu94xgzzu1d6Dn7or,42,74,32,0,23,3,19,2,153,21.857142857142858,8,0.0,14,32,0,23,60,3,0,19,2,69,84,0
10823,94810,q23XMOb2cNX1yZmQGKPIPigDTk7VTnyz,3VkHkmOtom3jM2wCu94xgzzu1d6Dn7or,1,0,0,0,0,0,1,0,1,0.14285714285714285,1,0.0,0,0,0,0,0,0,0,1,0,0,1,1
10824,94845,P1bfM85NxrtE5GDV4Jjq3FQWhmzLv4fy,3VkHkmOtom3jM2wCu94xgzzu1d6Dn7or,1,0,0,0,0,0,1,0,1,0.14285714285714285,1,0.0,0,0,0,0,0,0,0,1,0,0,1,1
10825,94851,eMuxdd3vTTXINi1iAtyaa6P9Ch4DsUYV,3VkHkmOtom3jM2wCu94xgzzu1d6Dn7or,5,2,1,0,1,0,2,0,6,0.8571428571428571,1,0.0,0,1,0,1,2,0,0,2,0,2,4,1
10826,94856,IxVmoE7uFZdgEeYPhBSCDKuc6eYwcaFV,3VkHkmOtom3jM2wCu94xgzzu1d6Dn7or,1,0,0,0,0,0,1,0,1,0.14285714285714285,1,0.0,0,0,0,0,0,0,0,1,0,0,1,1
10827,94858,fmgP8cgTB3j7EOhWhcWnndxOl7Z6grS6,3VkHkmOtom3jM2wCu94xgzzu1d6Dn7or,5,4,2,0,1,0,2,0,9,1.2857142857142858,2,0.0,0,2,0,1,4,0,0,2,0,3,6,0
10828,94872,hvDFOGRe7x4dHfuW8ja5EhgXLQCRe0hR,3VkHkmOtom3jM2wCu94xgzzu1d6Dn7or,1,0,0,0,0,0,1,0,1,0.14285714285714285,1,0.0,0,0,0,0,0,0,0,1,0,0,1,1
10829,94878,H1ppPfdCzm6xwZGaIuCSa4lnrECvijtR,3VkHkmOtom3jM2wCu94xgzzu1d6Dn7or,54,68,32,47,1,1,37,1,187,26.714285714285715,7,0.0,24,32,47,1,44,1,0,37,1,104,83,0
10830,94880,aIeu6o3OoeLK7YyVHts5ZIHmmJDB7MPt,3VkHkmOtom3jM2wCu94xgzzu1d6Dn7or,71,70,31,90,24,3,7,0,225,32.142857142857146,5,0.0,28,31,68,24,42,3,22,7,0,151,74,0
10831,94886,lc1i1oMD2ji6PBYWu6KhasAR3ifuxpqe,fbPkOYLVPtPgIt0MxizjfFJov3JbHyAi,15,26,16,8,10,1,8,1,70,10.0,1,0.0,3,16,7,10,23,1,1,8,1,36,34,0
10832,94889,aJb3knGzS3UXIG3UM7Uui7PFLk23KKtl,fbPkOYLVPtPgIt0MxizjfFJov3JbHyAi,1,0,0,0,0,0,1,0,1,0.14285714285714285,1,0.0,0,0,0,0,0,0,0,1,0,0,1,0
10833,94890,qjMvEFFtc35OoxZ9COlL4lHj3v8ojf4T,fbPkOYLVPtPgIt0MxizjfFJov3JbHyAi,5,2,1,0,1,0,2,0,6,0.8571428571428571,1,0.0,0,1,0,1,2,0,0,2,0,2,4,1
10834,94892,nPRsjektHdbQkeAf1fIK4JbhrESPbPsA,fbPkOYLVPtPgIt0MxizjfFJov3JbHyAi,5,2,1,0,1,0,3,0,7,1.0,2,0.0,0,1,0,1,2,0,0,3,0,2,5,1
10835,94893,5q237fUeGTg5ovm3b5dN9UB3JKJY3Npd,fbPkOYLVPtPgIt0MxizjfFJov3JbHyAi,10,15,4,0,2,0,2,0,23,3.2857142857142856,1,0.0,0,4,0,2,15,0,0,2,0,6,17,1
10836,94897,ptoBkN66Bt2QtZB1aEXx1ZVYWGKSe4nx,fbPkOYLVPtPgIt0MxizjfFJov3JbHyAi,1,0,0,0,0,0,1,0,1,0.14285714285714285,1,0.0,0,0,0,0,0,0,0,1,0,0,1,1
10837,94899,MPudmBDzcFEF2aagd3l2b1PRQVVyLD4u,fbPkOYLVPtPgIt0MxizjfFJov3JbHyAi,5,2,0,0,1,0,2,0,5,0.7142857142857143,1,0.0,0,0,0,1,2,0,0,2,0,1,4,1
10838,94900,HVP9P5Zd2kxYJRMzpkNocUjuv68uFQwI,fbPkOYLVPtPgIt0MxizjfFJov3JbHyAi,6,3,2,0,2,0,1,0,8,1.1428571428571428,1,0.0,0,2,0,2,3,0,0,1,0,4,4,1
10839,94901,aubBvEAbqX7BozVoIow53sGF2mWzIMIJ,fbPkOYLVPtPgIt0MxizjfFJov3JbHyAi,5,2,1,0,1,0,2,0,6,0.8571428571428571,1,0.0,0,1,0,1,2,0,0,2,0,2,4,0
10840,94902,GHdZtrcnj4BHLMcbKc7PIRtO4HiPI7gx,fbPkOYLVPtPgIt0MxizjfFJov3JbHyAi,12,9,4,0,3,2,9,1,28,4.0,1,0.0,1,4,0,3,8,2,0,9,1,8,20,1
10841,94903,2s1w2v8MgoByNGqR51pltJWsiHzHAFZ1,fbPkOYLVPtPgIt0MxizjfFJov3JbHyAi,1,0,0,0,0,0,1,0,1,0.14285714285714285,1,0.0,0,0,0,0,0,0,0,1,0,0,1,1
10842,94904,zP3de4W3VukAs6WLm1x1S3emx69koHez,fbPkOYLVPtPgIt0MxizjfFJov3JbHyAi,3,2,2,0,2,0,0,0,6,0.8571428571428571,1,0.0,0,2,0,2,2,0,0,0,0,4,2,1
10843,94906,6h2GWoIPk8lzExVz7dA23INnjQamzPiM,fbPkOYLVPtPgIt0MxizjfFJov3JbHyAi,1,0,0,0,0,0,1,0,1,0.14285714285714285,1,0.0,0,0,0,0,0,0,0,1,0,0,1,1
10844,94907,1QDbOw54L9ILqqLZZw1ogQGZSzfmiXb1,fbPkOYLVPtPgIt0MxizjfFJov3JbHyAi,5,2,1,0,1,0,2,0,6,0.8571428571428571,1,0.0,0,1,0,1,2,0,0,2,0,2,4,1
10845,94908,Y0dtU5bUn0PrrnfgvOUCPfb1rktwn4CX,fbPkOYLVPtPgIt0MxizjfFJov3JbHyAi,13,16,7,0,5,2,14,1,45,6.428571428571429,3,0.0,0,7,0,5,16,2,0,14,1,12,33,1
10846,94909,jEziRvuSnNpPzYhab0XaMjLlQjk8N2oC,fbPkOYLVPtPgIt0MxizjfFJov3JbHyAi,1,0,0,0,0,0,1,0,1,0.14285714285714285,1,0.0,0,0,0,0,0,0,0,1,0,0,1,1
10847,94910,D2M0lUAbb3NbvYyEfkDkoqJ8mQHTb4db,fbPkOYLVPtPgIt0MxizjfFJov3JbHyAi,1,0,0,0,0,0,1,0,1,0.14285714285714285,1,0.0,0,0,0,0,0,0,0,1,0,0,1,1
10848,94912,xJAu7qb6Tiwmc8LLU0BWAbWEzmc3V9vv,fbPkOYLVPtPgIt0MxizjfFJov3JbHyAi,1,0,0,0,0,0,1,0,1,0.14285714285714285,1,0.0,0,0,0,0,0,0,0,1,0,0,1,1
10849,94913,YPe9PkGt8zBUqd5BCkLiDVIWrxR3Ane8,fbPkOYLVPtPgIt0MxizjfFJov3JbHyAi,1,0,0,0,0,0,1,0,1,0.14285714285714285,1,0.0,0,0,0,0,0,0,0,1,0,0,1,1
10850,94915,CD136AEP3K4fUPxB0PiyL0uWFPHfdCLY,fbPkOYLVPtPgIt0MxizjfFJov3JbHyAi,5,2,1,0,1,0,2,0,6,0.8571428571428571,1,0.0,0,1,0,1,2,0,0,2,0,2,4,1
10851,94916,tN25USY6Yw7TL4DfXwjrjqK862rGOedD,fbPkOYLVPtPgIt0MxizjfFJov3JbHyAi,7,3,2,0,2,0,5,0,12,1.7142857142857142,1,0.0,0,2,0,2,3,0,0,5,0,4,8,1
10852,94925,PF30Vqy17JIy50CbxBzrrEB7UvSbzYk3,fbPkOYLVPtPgIt0MxizjfFJov3JbHyAi,7,3,2,0,2,0,3,0,10,1.4285714285714286,2,0.0,0,2,0,2,3,0,0,3,0,4,6,1
10853,94926,5MiwmAeXmS1fmC9lSNRxf7aBKSjN4L17,fbPkOYLVPtPgIt0MxizjfFJov3JbHyAi,1,0,0,0,0,0,1,0,1,0.14285714285714285,1,0.0,0,0,0,0,0,0,0,1,0,0,1,1
10854,94927,BMt1sMJKW8lUV5XsrUOWqq2qoU33TZEw,fbPkOYLVPtPgIt0MxizjfFJov3JbHyAi,12,9,4,0,3,12,7,3,38,5.428571428571429,2,0.0,1,4,0,3,8,12,0,7,3,8,30,0
10855,94932,Oyh3flf2wYtqmXZJ703xfAIo394jSx4Q,fbPkOYLVPtPgIt0MxizjfFJov3JbHyAi,7,2,2,0,2,1,18,3,28,4.0,1,0.0,0,2,0,2,2,1,0,18,3,4,24,1
10856,94933,oASR1hbK6DD6OJfTJCDKLW9l2vPgw7kR,fbPkOYLVPtPgIt0MxizjfFJov3JbHyAi,6,3,2,0,2,0,1,0,8,1.1428571428571428,1,0.0,0,2,0,2,3,0,0,1,0,4,4,1
10857,94935,KbVIZwe7S3MOh9dlFVWDZwSpf3zNL2tv,fbPkOYLVPtPgIt0MxizjfFJov3JbHyAi,1,0,0,0,0,0,1,0,1,0.14285714285714285,1,0.0,0,0,0,0,0,0,0,1,0,0,1,1
10858,94936,uarVJhEs6XLW7Dw1D7iBgEK6zPe65WwX,fbPkOYLVPtPgIt0MxizjfFJov3JbHyAi,6,3,2,0,1,0,3,0,9,1.2857142857142858,1,0.0,0,2,0,1,3,0,0,3,0,3,6,1
10859,94937,P6rUUMuGXrvMpG8WR8uzYUJPpfieJxTd,fbPkOYLVPtPgIt0MxizjfFJov3JbHyAi,1,0,0,0,0,0,1,0,1,0.14285714285714285,1,0.0,0,0,0,0,0,0,0,1,0,0,1,1
10860,94939,gpRi42UI7sWUeBhI8VeTEp7H6XwIGlNG,fbPkOYLVPtPgIt0MxizjfFJov3JbHyAi,2,0,0,0,0,0,9,0,9,1.2857142857142858,1,0.0,0,0,0,0,0,0,0,9,0,0,9,1
10861,94940,2gXHY5qLgY96Nt3kImmboPawcy43EQXt,fbPkOYLVPtPgIt0MxizjfFJov3JbHyAi,7,3,2,0,2,0,2,0,9,1.2857142857142858,1,0.0,0,2,0,2,3,0,0,2,0,4,5,1
10862,94942,6u1ZWprTe7uoVhqimJI2aVqsjH23ao5o,fbPkOYLVPtPgIt0MxizjfFJov3JbHyAi,7,3,2,0,2,0,4,0,11,1.5714285714285714,1,0.0,0,2,0,2,3,0,0,4,0,4,7,1
10863,94944,Z13gCiJciUykTdLRTsjNu2GwwR7Nbxp1,fbPkOYLVPtPgIt0MxizjfFJov3JbHyAi,6,3,2,0,2,0,1,0,8,1.1428571428571428,1,0.0,0,2,0,2,3,0,0,1,0,4,4,1
10864,94945,VtEfFHwCwR0CG3OZFyRUkRQlzB85HLcu,fbPkOYLVPtPgIt0MxizjfFJov3JbHyAi,4,2,1,0,1,0,1,0,5,0.7142857142857143,1,0.0,0,1,0,1,2,0,0,1,0,2,3,1
10865,94947,MDIYLIYQBWx9HiPTzYboxCieX8UYramh,fbPkOYLVPtPgIt0MxizjfFJov3JbHyAi,2,0,0,0,0,0,3,0,3,0.42857142857142855,2,0.0,0,0,0,0,0,0,0,3,0,0,3,1
10866,94948,wtEiMTsSGyqVYmzAUWtaJeXU5b3t5li0,fbPkOYLVPtPgIt0MxizjfFJov3JbHyAi,9,7,5,0,3,8,2,0,25,3.5714285714285716,1,0.0,1,5,0,3,6,8,0,2,0,9,16,1
10867,94949,6VGKONVpl1KgJ6EuaAzeKa8BNrxzEeZU,fbPkOYLVPtPgIt0MxizjfFJov3JbHyAi,7,9,1,0,1,0,2,0,13,1.8571428571428572,2,0.0,0,1,0,1,9,0,0,2,0,2,11,1
10868,94951,Th6GGIKucyCokdQsUn3aOeloTzqx0Qbo,fbPkOYLVPtPgIt0MxizjfFJov3JbHyAi,1,0,0,0,0,0,1,0,1,0.14285714285714285,1,0.0,0,0,0,0,0,0,0,1,0,0,1,1
10869,95219,79nK2Q1unvY6FmBQxEmzZl9QztvJiFFg,5Gyp41oLVo7Gg7vF4vpmggWP5MU70QO6,8,7,6,0,3,0,1,0,17,2.4285714285714284,1,0.0,0,6,0,3,7,0,0,1,0,9,8,1
10870,95236,sytnI5r8frh9Rwv3xWPhxTLCgzt44IsX,5Gyp41oLVo7Gg7vF4vpmggWP5MU70QO6,1,0,0,0,0,0,1,0,1,0.14285714285714285,1,0.0,0,0,0,0,0,0,0,1,0,0,1,1
10871,95262,wOkgiGT4mKEwfHAbFE5zBkC6tvq7dVH0,5Gyp41oLVo7Gg7vF4vpmggWP5MU70QO6,18,36,26,0,5,4,4,0,75,10.714285714285714,2,0.0,0,26,0,5,36,4,0,4,0,31,44,1
10872,95296,sSL46B3jCoU2n0oCLbbMc8KS0XOKM2e8,5Gyp41oLVo7Gg7vF4vpmggWP5MU70QO6,10,8,5,0,4,0,2,0,19,2.7142857142857144,1,0.0,2,5,0,4,6,0,0,2,0,11,8,1
10873,95304,sXXu4twesSnXXidsHxSOeMg5Xzk8xAsm,A3fsA9Zfv1X2fVEQhTw51lKENdNrEqT3,2,0,0,0,0,0,2,0,2,0.2857142857142857,1,0.0,0,0,0,0,0,0,0,2,0,0,2,0
10874,95315,U0aWEpE7Ns3m6FjrcttSNCCy6f34uaV4,SpATywNh6bZuzm8s1ceuBUnMUAeoAHHw,1,0,0,0,0,0,1,0,1,0.14285714285714285,1,0.0,0,0,0,0,0,0,0,1,0,0,1,1
10875,95323,Ge5fW9CsKdA0D6503NL20NzJpcoMVtar,SpATywNh6bZuzm8s1ceuBUnMUAeoAHHw,6,2,1,0,1,0,3,0,7,1.0,1,0.0,0,1,0,1,2,0,0,3,0,2,5,1
10876,95333,YybGVTqjY7vuqDLgHStfT8JBgnvTLDFS,bWdj2GDclj5ofokWjzoa5jAwMkxCykd6,6,2,1,0,1,0,3,0,7,1.0,1,0.0,0,1,0,1,2,0,0,3,0,2,5,1
10877,95336,QzVwezWUOBpl33EMiprsTWQNwkGzpYUZ,RXDvfPUBYFlVdlueBFbLW0mhhAyGEqpt,1,0,0,0,0,0,1,0,1,0.14285714285714285,1,0.0,0,0,0,0,0,0,0,1,0,0,1,0
10878,95343,WjGAvDgXPzKEfssMPXtQ1xVWZPI1hH6R,SpATywNh6bZuzm8s1ceuBUnMUAeoAHHw,3,2,0,0,0,0,1,0,3,0.42857142857142855,1,0.0,0,0,0,0,2,0,0,1,0,0,3,0
10879,95365,Ieqd5itEcYJJN0R1exEtlEqnGZPAbCE6,A3fsA9Zfv1X2fVEQhTw51lKENdNrEqT3,4,3,1,0,1,0,2,0,7,1.0,1,0.0,0,1,0,1,3,0,0,2,0,2,5,1
10880,95379,jl79Z6TfXd4YLzsAQwSCeo1eMaF6Ha8d,A3fsA9Zfv1X2fVEQhTw51lKENdNrEqT3,10,7,0,0,0,4,9,1,21,3.0,1,0.0,0,0,0,0,7,4,0,9,1,0,21,1
10881,95421,Bha7QMGmONKAqxvqVmMzYDzgn03rupB9,A3fsA9Zfv1X2fVEQhTw51lKENdNrEqT3,2,0,0,0,0,0,2,0,2,0.2857142857142857,1,0.0,0,0,0,0,0,0,0,2,0,0,2,1
10882,95443,Bha7QMGmONKAqxvqVmMzYDzgn03rupB9,bWdj2GDclj5ofokWjzoa5jAwMkxCykd6,4,2,1,0,0,0,3,0,6,0.8571428571428571,1,0.0,0,1,0,0,2,0,0,3,0,1,5,1
10883,95457,5yUqlUp9Xefz1r5QbYyqOcfkyddpZEv3,SpATywNh6bZuzm8s1ceuBUnMUAeoAHHw,19,22,6,12,5,0,5,0,50,7.142857142857143,1,0.0,9,6,10,5,13,0,2,5,0,30,20,1
10884,95460,yell4xFioKaQh1Eh8e1BHgTr9kNc23uL,G8EPVSXsOYB5YQWZGiz1aVq5Pgr2GrQu,2,0,0,0,0,0,2,0,2,0.2857142857142857,1,0.0,0,0,0,0,0,0,0,2,0,0,2,1
10885,95491,pO2KznyI9EIaBuWTbRmHrZfzq1y78Swj,A3fsA9Zfv1X2fVEQhTw51lKENdNrEqT3,10,6,4,0,4,0,3,0,17,2.4285714285714284,1,0.0,1,4,0,4,5,0,0,3,0,9,8,1
10886,95501,XgCNwD2cEVKtD4WAVaPORGAj8LHTJr5e,A3fsA9Zfv1X2fVEQhTw51lKENdNrEqT3,1,0,0,0,0,0,2,0,2,0.2857142857142857,2,0.0,0,0,0,0,0,0,0,2,0,0,2,1
10887,95518,GjBrMYHaMHg9XRlK0GO1kzoiYlxNFcC2,A3fsA9Zfv1X2fVEQhTw51lKENdNrEqT3,60,29,19,126,9,0,13,0,196,28.0,3,0.0,2,19,118,9,27,0,8,13,0,148,48,1
10888,95519,3TwYkv5KYm0nsRHdmcaiJpajLH9JQ0UG,A3fsA9Zfv1X2fVEQhTw51lKENdNrEqT3,3,0,0,0,0,0,5,0,5,0.7142857142857143,1,0.0,0,0,0,0,0,0,0,5,0,0,5,1
10889,95547,t3XemfoUPPfcRENYQvP2H3PO2tJX9CiG,SpATywNh6bZuzm8s1ceuBUnMUAeoAHHw,4,2,1,0,1,0,1,0,5,0.7142857142857143,1,0.0,0,1,0,1,2,0,0,1,0,2,3,1
10890,95560,oSEQ14Ll1d8ZBrsI9L5wTDmDWqMOqneK,A3fsA9Zfv1X2fVEQhTw51lKENdNrEqT3,14,7,6,0,6,1,7,1,28,4.0,1,0.0,0,6,0,6,7,1,0,7,1,12,16,1
10891,95566,WdzyWsqPss1ohcmLXQZkxthaNy8YyGzL,A3fsA9Zfv1X2fVEQhTw51lKENdNrEqT3,3,0,0,0,0,0,5,0,5,0.7142857142857143,1,0.0,0,0,0,0,0,0,0,5,0,0,5,1
10892,95567,BlS8PCoC6oTDUZj2Hj1GOesx0cnG3IDt,A3fsA9Zfv1X2fVEQhTw51lKENdNrEqT3,8,6,4,0,2,0,5,0,17,2.4285714285714284,1,0.0,0,4,0,2,6,0,0,5,0,6,11,1
10893,95570,nYSFDE8RCbcZhD46fRSvPHUvA1ahfupi,SpATywNh6bZuzm8s1ceuBUnMUAeoAHHw,8,9,1,0,1,4,5,0,20,2.857142857142857,1,0.0,0,1,0,1,9,4,0,5,0,2,18,1
10894,95579,8DrwDXKGEBLVwNt7dUNV7BIWxiG8AH1C,A3fsA9Zfv1X2fVEQhTw51lKENdNrEqT3,8,7,2,0,2,0,7,0,18,2.5714285714285716,1,0.0,0,2,0,2,7,0,0,7,0,4,14,1
10895,95584,vnJ8iXwVjPF96rPn5RIZQWSaOopjKseH,SpATywNh6bZuzm8s1ceuBUnMUAeoAHHw,28,33,14,40,8,0,11,0,106,15.142857142857142,1,0.0,8,14,34,8,25,0,6,11,0,64,42,1
10896,95604,nYSFDE8RCbcZhD46fRSvPHUvA1ahfupi,G8EPVSXsOYB5YQWZGiz1aVq5Pgr2GrQu,7,4,1,0,1,1,2,0,9,1.2857142857142858,1,0.0,0,1,0,1,4,1,0,2,0,2,7,1
10897,95610,nYSFDE8RCbcZhD46fRSvPHUvA1ahfupi,A3fsA9Zfv1X2fVEQhTw51lKENdNrEqT3,9,7,1,0,1,3,2,0,14,2.0,1,0.0,0,1,0,1,7,3,0,2,0,2,12,1
10898,95621,nH3NRDQLecB3hMbOpaitsdqKrlyEIXGh,SpATywNh6bZuzm8s1ceuBUnMUAeoAHHw,25,29,17,34,7,0,4,0,91,13.0,3,0.0,8,17,29,7,21,0,5,4,0,61,30,0
10899,95640,Y7qsqdZIsv6Hy0vu4LtgtbOKv08z7vaS,A3fsA9Zfv1X2fVEQhTw51lKENdNrEqT3,2,0,0,0,0,0,2,0,2,0.2857142857142857,1,0.0,0,0,0,0,0,0,0,2,0,0,2,1
10900,95647,kHWuc10C4T4imgPGXw1iL9DdxxMDyloj,A3fsA9Zfv1X2fVEQhTw51lKENdNrEqT3,2,0,0,0,0,0,3,0,3,0.42857142857142855,1,0.0,0,0,0,0,0,0,0,3,0,0,3,1
10901,95655,aFVIDdMfPLCaqut6kVxorTellYImwEAn,RXDvfPUBYFlVdlueBFbLW0mhhAyGEqpt,1,0,0,0,0,0,1,0,1,0.14285714285714285,1,0.0,0,0,0,0,0,0,0,1,0,0,1,1
10902,95692,PoMIsULf4fdpKNpab6c33l88EClRsCjy,A3fsA9Zfv1X2fVEQhTw51lKENdNrEqT3,14,7,6,0,5,0,2,0,20,2.857142857142857,1,0.0,0,6,0,5,7,0,0,2,0,11,9,0
10903,95693,lLO2IvxcSlYUuWvFwkacGc9eGibtMx0u,A3fsA9Zfv1X2fVEQhTw51lKENdNrEqT3,1,0,0,0,0,0,1,0,1,0.14285714285714285,1,0.0,0,0,0,0,0,0,0,1,0,0,1,1
10904,95713,XUeZabU3qZWCaiD6wFnhBaCufbfFTb2H,A3fsA9Zfv1X2fVEQhTw51lKENdNrEqT3,16,7,6,0,6,0,3,0,22,3.142857142857143,1,0.0,0,6,0,6,7,0,0,3,0,12,10,1
10905,95742,Y9G0Vd7vUaj0pt9EeQDbDOvFl3eVdYaR,RXDvfPUBYFlVdlueBFbLW0mhhAyGEqpt,1,0,0,0,0,0,1,0,1,0.14285714285714285,1,0.0,0,0,0,0,0,0,0,1,0,0,1,1
10906,95754,fXpjk0OrbkXxQzpvttVDelNPD6lPfJXA,SpATywNh6bZuzm8s1ceuBUnMUAeoAHHw,20,14,8,19,6,0,6,0,53,7.571428571428571,1,0.0,6,8,16,6,8,0,3,6,0,36,17,1
10907,95775,WuM67GwQW9M3d1mnuGHuvAdo907S9qb5,SpATywNh6bZuzm8s1ceuBUnMUAeoAHHw,1,0,0,0,0,0,1,0,1,0.14285714285714285,1,0.0,0,0,0,0,0,0,0,1,0,0,1,0
10908,95777,Yc8rNkAsH37cAbAebyiE6I2RsfVaxpIZ,A3fsA9Zfv1X2fVEQhTw51lKENdNrEqT3,7,3,2,0,2,0,2,0,9,1.2857142857142858,1,0.0,0,2,0,2,3,0,0,2,0,4,5,1
10909,95783,Xcq5CVanT8J8ISNJVeThaVoqYhMkjumr,SpATywNh6bZuzm8s1ceuBUnMUAeoAHHw,5,2,1,0,1,0,2,0,6,0.8571428571428571,1,0.0,0,1,0,1,2,0,0,2,0,2,4,1
10910,95790,aSlIMkfly6xTMJCGTWDQcnFZjajcWM6y,A3fsA9Zfv1X2fVEQhTw51lKENdNrEqT3,7,4,1,0,1,0,2,0,8,1.1428571428571428,1,0.0,0,1,0,1,4,0,0,2,0,2,6,1
10911,95796,AfmdKPTL0IbcupndNMlY5c7PImPraChY,SpATywNh6bZuzm8s1ceuBUnMUAeoAHHw,25,20,11,16,5,0,6,1,59,8.428571428571429,2,0.0,6,11,15,5,14,0,1,6,1,37,22,1
10912,95800,XhN7QGypor4DcMvMWEJ3oRIi5DeJwYDV,SpATywNh6bZuzm8s1ceuBUnMUAeoAHHw,29,40,1,47,1,2,6,0,97,13.857142857142858,3,0.0,20,1,42,1,20,2,5,6,0,64,33,1
10913,95805,jN3AJMUVBTsXIfTNwaMmorNzhVw7coVS,A3fsA9Zfv1X2fVEQhTw51lKENdNrEqT3,2,0,0,0,0,0,2,0,2,0.2857142857142857,1,0.0,0,0,0,0,0,0,0,2,0,0,2,1
10914,95817,1uEo4BzsZxlgHBFClnUu9nbvDrRmzn4T,SpATywNh6bZuzm8s1ceuBUnMUAeoAHHw,7,4,3,5,1,0,1,0,14,2.0,1,0.0,0,3,5,1,4,0,0,1,0,9,5,1
10915,95824,qHYMkh2G06Tgj4MMABvKGj1g29BRMeXu,SpATywNh6bZuzm8s1ceuBUnMUAeoAHHw,6,4,3,0,3,0,1,0,11,1.5714285714285714,1,0.0,0,3,0,3,4,0,0,1,0,6,5,1
10916,95827,1u5RJ3ohzI9I8TYHEG8zy2n2QjuVVCRw,SpATywNh6bZuzm8s1ceuBUnMUAeoAHHw,1,0,0,0,0,0,1,0,1,0.14285714285714285,1,0.0,0,0,0,0,0,0,0,1,0,0,1,1
10917,95834,86utfBtmFqtE8TLsj2h1BusfBdMTH1O8,SpATywNh6bZuzm8s1ceuBUnMUAeoAHHw,10,11,3,1,2,0,2,0,19,2.7142857142857144,2,0.0,2,3,1,2,9,0,0,2,0,8,11,1
10918,95841,AEeLy9n4nUl6UlG8WfSP7Q5sqAzFdtaD,A3fsA9Zfv1X2fVEQhTw51lKENdNrEqT3,19,28,22,0,17,13,9,1,90,12.857142857142858,8,0.0,0,22,0,17,28,13,0,9,1,39,51,0
10919,95849,j3HNnX1GWjrCGNX5n4Ax13Vu5X6WNds7,SpATywNh6bZuzm8s1ceuBUnMUAeoAHHw,5,2,1,0,1,0,2,0,6,0.8571428571428571,1,0.0,0,1,0,1,2,0,0,2,0,2,4,1
10920,95866,wdK5DIKl9qd73hM1uOx3ufcKj0J9AcRr,A3fsA9Zfv1X2fVEQhTw51lKENdNrEqT3,9,8,6,0,5,0,2,0,21,3.0,2,0.0,0,6,0,5,8,0,0,2,0,11,10,1
10921,95877,ofStwmRRBPN4Od7HYTx4tgAh724FKaML,RXDvfPUBYFlVdlueBFbLW0mhhAyGEqpt,8,4,0,0,0,4,4,1,13,1.8571428571428572,1,0.0,0,0,0,0,4,4,0,4,1,0,13,1
10922,95886,xsD2uaFheAaDTDHzSeAKROA0IH2KQICZ,SpATywNh6bZuzm8s1ceuBUnMUAeoAHHw,12,11,1,6,1,0,2,0,21,3.0,1,0.0,2,1,6,1,9,0,0,2,0,10,11,1
10923,95903,8Bi5fR0qSZjzFptY6NNbPZ6GLpteABmy,SpATywNh6bZuzm8s1ceuBUnMUAeoAHHw,4,2,0,0,0,0,3,0,5,0.7142857142857143,2,0.0,0,0,0,0,2,0,0,3,0,0,5,1
10924,95914,rTLMEQB78zn1g6bt6KRypanGZ8QWPbQv,A3fsA9Zfv1X2fVEQhTw51lKENdNrEqT3,69,106,16,180,13,59,39,1,414,59.142857142857146,10,0.0,9,16,142,13,97,59,38,39,1,180,234,0
10925,95924,yF9l9yvoXyIeGTDuNPcQeoWm8bOFk82H,A3fsA9Zfv1X2fVEQhTw51lKENdNrEqT3,1,0,0,0,0,0,1,0,1,0.14285714285714285,1,0.0,0,0,0,0,0,0,0,1,0,0,1,1
10926,95938,H8hXX8mRAbdpVvW9JxPUH4Vz1O6DjIDQ,SpATywNh6bZuzm8s1ceuBUnMUAeoAHHw,12,15,4,11,3,0,1,0,34,4.857142857142857,1,0.0,10,4,10,3,5,0,1,1,0,27,7,1
10927,95943,Gnvd8M3zeIOpApc28ArYy1li1qM7ZTwg,SpATywNh6bZuzm8s1ceuBUnMUAeoAHHw,15,26,0,18,0,1,10,2,57,8.142857142857142,2,0.0,6,0,15,0,20,1,3,10,2,21,36,1
10928,95946,VSxmvcFHrZIVtNnTaFw0qdfh1Zdl1LMy,SpATywNh6bZuzm8s1ceuBUnMUAeoAHHw,28,49,23,12,9,0,5,0,98,14.0,4,0.0,21,23,12,9,28,0,0,5,0,65,33,0
10929,95965,L22oksNNnEaRYr1idj7T9wNLQN39zTXs,SpATywNh6bZuzm8s1ceuBUnMUAeoAHHw,8,2,1,0,1,1,5,1,11,1.5714285714285714,1,0.0,0,1,0,1,2,1,0,5,1,2,9,1
10930,95979,kYCiC9sjJhVea0nSa72pTn7A2eOhjLmI,SpATywNh6bZuzm8s1ceuBUnMUAeoAHHw,10,6,4,0,3,1,8,1,23,3.2857142857142856,2,0.0,0,4,0,3,6,1,0,8,1,7,16,1
10931,95984,D9YS628mhjQ1I60HvdkUWN4SFDF5a33E,SpATywNh6bZuzm8s1ceuBUnMUAeoAHHw,7,2,0,0,0,1,5,1,9,1.2857142857142858,1,0.0,0,0,0,0,2,1,0,5,1,0,9,1
10932,95991,S144mYN036ngEoT5NOZhFV5f1CGtYvQl,SpATywNh6bZuzm8s1ceuBUnMUAeoAHHw,7,2,0,0,0,1,7,1,11,1.5714285714285714,1,0.0,0,0,0,0,2,1,0,7,1,0,11,1
10933,96002,Hxd16O3nQG6ddXQCBbAu8BGBmmZmiixl,bWdj2GDclj5ofokWjzoa5jAwMkxCykd6,1,0,0,0,0,0,1,0,1,0.14285714285714285,1,0.0,0,0,0,0,0,0,0,1,0,0,1,1
10934,96009,GpLd8OePUlzkVkOH6kyAjUXsolCeEYNN,RXDvfPUBYFlVdlueBFbLW0mhhAyGEqpt,7,3,1,0,1,0,3,0,8,1.1428571428571428,1,0.0,0,1,0,1,3,0,0,3,0,2,6,1
10935,96015,5AnpX5rZgeZiqdXpEpBXchayqHICSQR2,SpATywNh6bZuzm8s1ceuBUnMUAeoAHHw,9,6,4,0,2,0,2,0,14,2.0,1,0.0,1,4,0,2,5,0,0,2,0,7,7,1
10936,96018,HPasLgueYgbdk1es5obBHn6eCO700ZnM,G8EPVSXsOYB5YQWZGiz1aVq5Pgr2GrQu,5,2,1,0,1,0,3,0,7,1.0,1,0.0,0,1,0,1,2,0,0,3,0,2,5,1
10937,96021,ix15aF6FOEF1waZCSZt01VrPOuPGJ3yM,SpATywNh6bZuzm8s1ceuBUnMUAeoAHHw,19,21,0,12,0,4,9,1,47,6.714285714285714,4,0.0,10,0,12,0,11,4,0,9,1,22,25,0
10938,96028,3tDepbYkazgiOrBsQmbtJa1H3rNZc54O,SpATywNh6bZuzm8s1ceuBUnMUAeoAHHw,9,5,1,0,1,0,7,2,16,2.2857142857142856,2,0.0,0,1,0,1,5,0,0,7,2,2,14,0
10939,96037,zwqhxdboQszkcKvPN5pyN1nGDFR4ub3y,bWdj2GDclj5ofokWjzoa5jAwMkxCykd6,7,8,1,6,4,0,3,0,22,3.142857142857143,2,0.0,6,1,6,4,2,0,0,3,0,17,5,1
10940,96038,NGxVJQppNBMfgJiFwD3Ox6xl5bHm79ig,A3fsA9Zfv1X2fVEQhTw51lKENdNrEqT3,7,5,4,0,1,0,2,0,12,1.7142857142857142,1,0.0,0,4,0,1,5,0,0,2,0,5,7,1
10941,96051,nl7CfVETct3efRgniW8qXKplgQDLZElB,bWdj2GDclj5ofokWjzoa5jAwMkxCykd6,2,0,0,0,0,0,3,0,3,0.42857142857142855,1,0.0,0,0,0,0,0,0,0,3,0,0,3,1
10942,96060,1FiRW6JL0h34vWqoZjG8ei2zujPF23NL,A3fsA9Zfv1X2fVEQhTw51lKENdNrEqT3,68,61,28,90,13,2,20,1,215,30.714285714285715,4,0.0,7,28,87,13,54,2,3,20,1,135,80,1
10943,96063,McYATdhZDDMDpni6a4GbjI06ustMpvdV,bWdj2GDclj5ofokWjzoa5jAwMkxCykd6,1,0,0,0,0,0,2,0,2,0.2857142857142857,2,0.0,0,0,0,0,0,0,0,2,0,0,2,1
10944,96074,MiDD69NvLCtsK6jzM5U32WgBFDv8XbVJ,A3fsA9Zfv1X2fVEQhTw51lKENdNrEqT3,11,7,2,0,2,0,11,1,23,3.2857142857142856,1,0.0,0,2,0,2,7,0,0,11,1,4,19,0
10945,96080,nBih09u5WtqrKAXZJuGGTQZ4MinMYlfW,SpATywNh6bZuzm8s1ceuBUnMUAeoAHHw,5,2,0,0,0,0,7,0,9,1.2857142857142858,1,0.0,0,0,0,0,2,0,0,7,0,0,9,1
10946,96094,ps5VcFUapZM31sy4VNJWOTFBzN98932v,SpATywNh6bZuzm8s1ceuBUnMUAeoAHHw,1,0,0,0,0,0,1,0,1,0.14285714285714285,1,0.0,0,0,0,0,0,0,0,1,0,0,1,1
10947,96102,VLNGwZ1eoTZ1MrW64VolhWSmnDD0C1Ov,A3fsA9Zfv1X2fVEQhTw51lKENdNrEqT3,8,3,2,0,1,4,8,1,19,2.7142857142857144,2,0.0,0,2,0,1,3,4,0,8,1,3,16,1
10948,96105,IhdK4MEktWiSl0ozGtXiJFeE1awPcboi,SpATywNh6bZuzm8s1ceuBUnMUAeoAHHw,29,37,19,37,8,3,8,0,112,16.0,2,0.0,6,19,32,8,31,3,5,8,0,65,47,1
10949,96109,gnTcbZ4BOuQk0BfuzZDpGiEEYJSGOrYu,SpATywNh6bZuzm8s1ceuBUnMUAeoAHHw,26,25,16,30,12,5,3,0,91,13.0,2,0.0,5,16,27,12,20,5,3,3,0,60,31,1
10950,96112,o3REKVT5jtm2Ed8QHiz1c3PlSbYTElLg,SpATywNh6bZuzm8s1ceuBUnMUAeoAHHw,3,0,0,0,0,0,3,0,3,0.42857142857142855,1,0.0,0,0,0,0,0,0,0,3,0,0,3,1
10951,96113,o3REKVT5jtm2Ed8QHiz1c3PlSbYTElLg,G8EPVSXsOYB5YQWZGiz1aVq5Pgr2GrQu,2,0,0,0,0,0,2,0,2,0.2857142857142857,1,0.0,0,0,0,0,0,0,0,2,0,0,2,1
10952,96114,XYKEbaRABcMuBHmMB2I3YkBepzCp0swB,A3fsA9Zfv1X2fVEQhTw51lKENdNrEqT3,32,22,2,82,0,14,6,0,126,18.0,4,0.0,3,2,66,0,19,14,16,6,0,71,55,1
10953,96121,gnTcbZ4BOuQk0BfuzZDpGiEEYJSGOrYu,A3fsA9Zfv1X2fVEQhTw51lKENdNrEqT3,7,3,2,0,2,0,4,0,11,1.5714285714285714,2,0.0,0,2,0,2,3,0,0,4,0,4,7,1
10954,96126,8n73BBd3mvRJq2a0KZ4WJWTYj65s8f61,bWdj2GDclj5ofokWjzoa5jAwMkxCykd6,1,0,0,0,0,0,1,0,1,0.14285714285714285,1,0.0,0,0,0,0,0,0,0,1,0,0,1,1
10955,96133,gMMqUNqa2ZYLkCBhPE0t3hx9nA1CQadH,SpATywNh6bZuzm8s1ceuBUnMUAeoAHHw,35,80,44,32,23,11,22,1,213,30.428571428571427,10,0.0,22,44,29,23,58,11,3,22,1,118,95,0
10956,96140,QTgmoEmFx7yveY8D3dDCUQU4BnndurNn,RXDvfPUBYFlVdlueBFbLW0mhhAyGEqpt,78,122,55,96,64,11,16,1,365,52.142857142857146,9,0.0,18,55,94,64,104,11,2,16,1,231,134,0
10957,96145,EpjqZEwurfAejh2DegYmFyOcCfieF5bI,3VkHkmOtom3jM2wCu94xgzzu1d6Dn7or,10,6,5,0,4,0,2,0,17,2.4285714285714284,1,0.0,0,5,0,4,6,0,0,2,0,9,8,1
10958,96152,F9TuVQWNu6ofFAogW7rwyLlFT0z2eQyz,3VkHkmOtom3jM2wCu94xgzzu1d6Dn7or,6,2,1,0,1,0,5,0,9,1.2857142857142858,1,0.0,0,1,0,1,2,0,0,5,0,2,7,1
10959,96153,0KsRcnvH5KwYg9hQpDsfdDezVQYmpNaM,3VkHkmOtom3jM2wCu94xgzzu1d6Dn7or,12,14,4,10,5,0,1,0,34,4.857142857142857,1,0.0,8,4,8,5,6,0,2,1,0,25,9,1
10960,96157,HPunf0IeYEJIqhIcukHL5dSfwWXPJgdK,3VkHkmOtom3jM2wCu94xgzzu1d6Dn7or,7,23,2,5,5,8,4,0,47,6.714285714285714,3,0.0,16,2,4,5,7,8,1,4,0,27,20,1
10961,96161,xScCLVtmeGdEECHRus6S361DX011nviO,3VkHkmOtom3jM2wCu94xgzzu1d6Dn7or,2,0,0,0,0,0,2,0,2,0.2857142857142857,1,0.0,0,0,0,0,0,0,0,2,0,0,2,1
10962,96164,ifLFSwPKPCiTrnURcHdf9bSMBNoQjygW,3VkHkmOtom3jM2wCu94xgzzu1d6Dn7or,1,0,0,0,0,0,1,0,1,0.14285714285714285,1,0.0,0,0,0,0,0,0,0,1,0,0,1,1
10963,96166,vxyHJpAI3o1k0XhGwDw1sJWHtBHM2REM,3VkHkmOtom3jM2wCu94xgzzu1d6Dn7or,1,0,0,0,0,0,1,0,1,0.14285714285714285,1,0.0,0,0,0,0,0,0,0,1,0,0,1,0
10964,96171,Tb7ZmDk2KyMG2qBiHXFKty1zWlhwRH1T,3VkHkmOtom3jM2wCu94xgzzu1d6Dn7or,1,0,0,0,0,0,1,0,1,0.14285714285714285,1,0.0,0,0,0,0,0,0,0,1,0,0,1,1
10965,96173,QGD5Xr8KgGMTyo6VFc8iWuvDWsBcwrxS,3VkHkmOtom3jM2wCu94xgzzu1d6Dn7or,5,2,0,0,1,0,3,0,6,0.8571428571428571,1,0.0,0,0,0,1,2,0,0,3,0,1,5,1
10966,96174,NwBZTCsarBRtTlQQY0VswrANLhW8Le2H,3VkHkmOtom3jM2wCu94xgzzu1d6Dn7or,1,0,0,0,0,0,1,0,1,0.14285714285714285,1,0.0,0,0,0,0,0,0,0,1,0,0,1,1
10967,96176,tUWdsiUp6knC7kU2jL4tyFtEiCURn1SW,3VkHkmOtom3jM2wCu94xgzzu1d6Dn7or,5,2,1,0,1,0,4,0,8,1.1428571428571428,1,0.0,0,1,0,1,2,0,0,4,0,2,6,1
10968,96177,FjMcq9yRoNKJNqdekKiFpBJzde1EqvnP,3VkHkmOtom3jM2wCu94xgzzu1d6Dn7or,24,62,17,14,32,1,10,0,136,19.428571428571427,2,0.0,43,17,11,32,19,1,3,10,0,103,33,1
10969,96183,p0kTR9RrjwCaki8UXW8XKwPOKfeXqB9t,3VkHkmOtom3jM2wCu94xgzzu1d6Dn7or,7,17,5,0,2,0,2,0,26,3.7142857142857144,1,0.0,0,5,0,2,17,0,0,2,0,7,19,1
10970,96187,BuoBAMoQMp8n1QIpTX32C1cd62Qn82L1,3VkHkmOtom3jM2wCu94xgzzu1d6Dn7or,11,11,6,0,2,13,10,1,43,6.142857142857143,1,0.0,0,6,0,2,11,13,0,10,1,8,35,1
10971,96190,oQsM4aPF8H95oLBBQjkyuxP9zhQJyjlM,3VkHkmOtom3jM2wCu94xgzzu1d6Dn7or,4,0,0,0,0,0,5,0,5,0.7142857142857143,1,0.0,0,0,0,0,0,0,0,5,0,0,5,1
10972,96197,HN1X5hWlmOS9Eyiq9T0eFhd60qlqtaGd,3VkHkmOtom3jM2wCu94xgzzu1d6Dn7or,8,2,1,0,1,1,5,1,11,1.5714285714285714,1,0.0,0,1,0,1,2,1,0,5,1,2,9,1
10973,96199,k125nfhPC0c7Tj8cqemBvcT3s17rL1XV,3VkHkmOtom3jM2wCu94xgzzu1d6Dn7or,5,2,1,0,1,0,2,0,6,0.8571428571428571,1,0.0,0,1,0,1,2,0,0,2,0,2,4,1
10974,96209,XxFWC1ndYyndeKPLR0Tthjj3sQQ7nV1V,3VkHkmOtom3jM2wCu94xgzzu1d6Dn7or,5,2,1,0,1,0,3,0,7,1.0,1,0.0,1,1,0,1,1,0,0,3,0,3,4,1
10975,96212,0JURzmiKAgHEm3x2qt8dilXSiBiSlIMu,3VkHkmOtom3jM2wCu94xgzzu1d6Dn7or,1,0,0,0,0,0,2,0,2,0.2857142857142857,1,0.0,0,0,0,0,0,0,0,2,0,0,2,1
10976,96213,jemrZ1weClX8KV7zPk5woJnrTpOh61n0,3VkHkmOtom3jM2wCu94xgzzu1d6Dn7or,5,2,0,0,1,0,3,0,6,0.8571428571428571,1,0.0,0,0,0,1,2,0,0,3,0,1,5,1
10977,96216,enIqpTiaArtw9013z5nXb7q57WWqlRw8,3VkHkmOtom3jM2wCu94xgzzu1d6Dn7or,10,17,8,0,5,3,10,1,44,6.285714285714286,2,0.0,4,8,0,5,13,3,0,10,1,17,27,1
10978,96217,s32ltvD91SqP37xCuPcJTQUji5lNpoIV,3VkHkmOtom3jM2wCu94xgzzu1d6Dn7or,1,0,0,0,0,0,2,0,2,0.2857142857142857,1,0.0,0,0,0,0,0,0,0,2,0,0,2,1
10979,96219,9KIQhXtS8RtIL7nYiRgoTpvfFonnbdyd,3VkHkmOtom3jM2wCu94xgzzu1d6Dn7or,1,0,0,0,0,0,1,0,1,0.14285714285714285,1,0.0,0,0,0,0,0,0,0,1,0,0,1,1
10980,96223,Hd4RuYAWbJNyiFcVDOQm2YknhUCRzDpf,3VkHkmOtom3jM2wCu94xgzzu1d6Dn7or,1,0,0,0,0,0,1,0,1,0.14285714285714285,1,0.0,0,0,0,0,0,0,0,1,0,0,1,1
10981,96230,o36MAZxBelVYcOYv6Q6zU8d38AuIySQf,3VkHkmOtom3jM2wCu94xgzzu1d6Dn7or,19,35,14,16,11,0,3,0,79,11.285714285714286,1,0.0,14,14,13,11,21,0,3,3,0,52,27,1
10982,96234,VVanPUXAmmndxNeDO36jzzp8xTGXseE4,3VkHkmOtom3jM2wCu94xgzzu1d6Dn7or,4,2,1,0,1,2,2,0,8,1.1428571428571428,1,0.0,0,1,0,1,2,2,0,2,0,2,6,1
10983,96241,dqec3C87DYvOwA2QtgWO9A6JF4EynpzQ,3VkHkmOtom3jM2wCu94xgzzu1d6Dn7or,1,0,0,0,0,0,1,0,1,0.14285714285714285,1,0.0,0,0,0,0,0,0,0,1,0,0,1,1
10984,96243,2KYemNc303pEosq37WS18W9XF5RPdrua,3VkHkmOtom3jM2wCu94xgzzu1d6Dn7or,1,0,0,0,0,0,2,0,2,0.2857142857142857,1,0.0,0,0,0,0,0,0,0,2,0,0,2,1
10985,96247,vDcOI9R7bMY6xcvzTxgQszC65IhkS8Gn,3VkHkmOtom3jM2wCu94xgzzu1d6Dn7or,1,0,0,0,0,0,1,0,1,0.14285714285714285,1,0.0,0,0,0,0,0,0,0,1,0,0,1,1
10986,96248,4IuXpm9M2G6R6qZqtV7So8usupBmnRAv,3VkHkmOtom3jM2wCu94xgzzu1d6Dn7or,1,0,0,0,0,0,1,0,1,0.14285714285714285,1,0.0,0,0,0,0,0,0,0,1,0,0,1,1
10987,96250,NGakFmsdjK3lyw04RUw9CrZTM8YOC6oU,3VkHkmOtom3jM2wCu94xgzzu1d6Dn7or,1,0,0,0,0,0,2,0,2,0.2857142857142857,1,0.0,0,0,0,0,0,0,0,2,0,0,2,1
10988,96251,LQFHljzrAsSQnHGzwtY9GERnIvJpaIfZ,3VkHkmOtom3jM2wCu94xgzzu1d6Dn7or,6,6,4,0,0,1,1,0,12,1.7142857142857142,1,0.0,1,4,0,0,5,1,0,1,0,5,7,1
10989,96253,wxo6LeVD85cOB3C5PxOIhJqaQgZNOhP9,3VkHkmOtom3jM2wCu94xgzzu1d6Dn7or,4,2,0,0,0,0,6,0,8,1.1428571428571428,2,0.0,0,0,0,0,2,0,0,6,0,0,8,1
10990,96254,WUClwR7udRuyH0YY9SLxZfL5J9bhMeSZ,3VkHkmOtom3jM2wCu94xgzzu1d6Dn7or,6,2,0,0,1,0,4,1,8,1.1428571428571428,1,0.0,0,0,0,1,2,0,0,4,1,1,7,1
10991,96255,VnvhtlmCzMoaixFjpTOOEG5dQDcoFCrw,3VkHkmOtom3jM2wCu94xgzzu1d6Dn7or,1,0,0,0,0,0,1,0,1,0.14285714285714285,1,0.0,0,0,0,0,0,0,0,1,0,0,1,1
10992,96256,VbInVetDGFepZy5zTdpbn53n6APrskn4,3VkHkmOtom3jM2wCu94xgzzu1d6Dn7or,1,0,0,0,0,0,1,0,1,0.14285714285714285,1,0.0,0,0,0,0,0,0,0,1,0,0,1,1
10993,96258,nd7NWFrPYSuDFf8ksILMMLULZQyKWzkY,3VkHkmOtom3jM2wCu94xgzzu1d6Dn7or,1,0,0,0,0,0,1,0,1,0.14285714285714285,1,0.0,0,0,0,0,0,0,0,1,0,0,1,1
10994,96259,hv4qu378s3aJ0QFqXMOxECZKMBDzDvIa,3VkHkmOtom3jM2wCu94xgzzu1d6Dn7or,1,0,0,0,0,0,1,0,1,0.14285714285714285,1,0.0,0,0,0,0,0,0,0,1,0,0,1,1
10995,96260,4yn2X5ZyYGavHIACThFVdWrFmnpFRB99,3VkHkmOtom3jM2wCu94xgzzu1d6Dn7or,2,0,0,0,0,0,2,0,2,0.2857142857142857,1,0.0,0,0,0,0,0,0,0,2,0,0,2,1
10996,96270,GSkYUOcl4XzYMWSWhE6gXRGQ9kqPeXsi,3VkHkmOtom3jM2wCu94xgzzu1d6Dn7or,32,84,22,21,27,6,11,1,172,24.571428571428573,5,0.0,26,22,19,27,58,6,2,11,1,94,78,1
10997,96273,DIJZt928jSvLUGCtufmBeiAst7HxGgSA,3VkHkmOtom3jM2wCu94xgzzu1d6Dn7or,4,2,1,0,1,0,1,0,5,0.7142857142857143,1,0.0,0,1,0,1,2,0,0,1,0,2,3,1
10998,96276,Lciv47QTZ42EhHhkeATm1doKP6ppFu7V,3VkHkmOtom3jM2wCu94xgzzu1d6Dn7or,6,18,7,0,0,0,3,1,29,4.142857142857143,1,0.0,4,7,0,0,14,0,0,3,1,11,18,1
10999,96280,pC2oj7zUWjwJtppk4Aa8oLGERn6zDZKh,3VkHkmOtom3jM2wCu94xgzzu1d6Dn7or,4,2,0,0,0,0,2,0,4,0.5714285714285714,1,0.0,0,0,0,0,2,0,0,2,0,0,4,1
11000,96283,7FYMj2bFfaTXHKfoaKa59KqAPXY4BWgD,3VkHkmOtom3jM2wCu94xgzzu1d6Dn7or,5,4,2,0,2,0,2,0,10,1.4285714285714286,1,0.0,0,2,0,2,4,0,0,2,0,4,6,1
11001,96289,ZQSZgZ79Y2BI2kLu43mIPc6ox1OLMn3i,3VkHkmOtom3jM2wCu94xgzzu1d6Dn7or,4,0,0,0,0,0,4,2,6,0.8571428571428571,1,0.0,0,0,0,0,0,0,0,4,2,0,6,1
11002,96292,HVLgKKKtcJ5L0yKBrJ8PAnUtQgDtHaQR,3VkHkmOtom3jM2wCu94xgzzu1d6Dn7or,1,0,0,0,0,0,1,0,1,0.14285714285714285,1,0.0,0,0,0,0,0,0,0,1,0,0,1,1
11003,96294,fcuGfbsMcZPq5nDUeSqb2ubFCGZIHmtW,3VkHkmOtom3jM2wCu94xgzzu1d6Dn7or,1,0,0,0,0,0,2,0,2,0.2857142857142857,1,0.0,0,0,0,0,0,0,0,2,0,0,2,1
11004,96296,mrevUEj0qqWnyF0JW6tRN1rAdXv2xb2w,3VkHkmOtom3jM2wCu94xgzzu1d6Dn7or,1,0,0,0,0,0,1,0,1,0.14285714285714285,1,0.0,0,0,0,0,0,0,0,1,0,0,1,1
11005,96298,jiHCZRqZkTsaeaiJrCBkwE60LOZDz9gI,3VkHkmOtom3jM2wCu94xgzzu1d6Dn7or,7,13,0,0,2,0,3,0,18,2.5714285714285716,1,0.0,4,0,0,2,9,0,0,3,0,6,12,1
11006,96299,5KWxvKeP2OgpIZc77LcI9Rh8elyZt0my,3VkHkmOtom3jM2wCu94xgzzu1d6Dn7or,16,23,13,18,9,0,12,0,75,10.714285714285714,1,0.0,7,13,15,9,16,0,3,12,0,44,31,0
11007,96300,TqwsfzC7boA0P221nJEBMK29H7weQpBs,3VkHkmOtom3jM2wCu94xgzzu1d6Dn7or,5,2,1,0,1,0,3,0,7,1.0,1,0.0,0,1,0,1,2,0,0,3,0,2,5,1
11008,96303,ugLwOnoLMnp5lLbvFiuVUtR2inbX7VAT,3VkHkmOtom3jM2wCu94xgzzu1d6Dn7or,7,3,1,0,1,6,6,0,17,2.4285714285714284,1,0.0,1,1,0,1,2,6,0,6,0,3,14,1
11009,96306,i2EWiH0CFlZMNJNVHRgrCnauS8sHdput,3VkHkmOtom3jM2wCu94xgzzu1d6Dn7or,1,0,0,0,0,0,1,0,1,0.14285714285714285,1,0.0,0,0,0,0,0,0,0,1,0,0,1,1
11010,96307,9UHBYD92KFxNzIUjZQKJq8CqZXjf9mef,3VkHkmOtom3jM2wCu94xgzzu1d6Dn7or,96,137,77,65,63,43,34,6,425,60.714285714285715,7,0.0,42,77,62,63,95,43,3,34,6,244,181,0
11011,96309,BuuC3vRfx8lPYpdkNt2eTZulT2ntPSTH,3VkHkmOtom3jM2wCu94xgzzu1d6Dn7or,1,0,0,0,0,0,1,0,1,0.14285714285714285,1,0.0,0,0,0,0,0,0,0,1,0,0,1,1
11012,96311,Wvx341gv8V1C2xMRjBPZaA6fOxorW0PM,3VkHkmOtom3jM2wCu94xgzzu1d6Dn7or,5,2,1,0,1,0,3,0,7,1.0,1,0.0,0,1,0,1,2,0,0,3,0,2,5,1
11013,96315,dz3e3Uyw3EAB6Btb7QoVpBpCs6OCzIuw,3VkHkmOtom3jM2wCu94xgzzu1d6Dn7or,2,0,0,0,0,0,2,0,2,0.2857142857142857,1,0.0,0,0,0,0,0,0,0,2,0,0,2,1
11014,96318,jPQeG3XrSBRtKeFBAHg0JvoXUpHLqvxV,3VkHkmOtom3jM2wCu94xgzzu1d6Dn7or,22,25,11,25,7,12,11,1,92,13.142857142857142,3,0.0,7,11,20,7,18,12,5,11,1,45,47,1
11015,96321,nzf1dZvOOKMtaa1xMnxXB5GkolA267M6,3VkHkmOtom3jM2wCu94xgzzu1d6Dn7or,1,0,0,0,0,0,1,0,1,0.14285714285714285,1,0.0,0,0,0,0,0,0,0,1,0,0,1,1
11016,96322,sY5SceKMJchdbCG2gcUOx5nPMQZzzchQ,3VkHkmOtom3jM2wCu94xgzzu1d6Dn7or,9,4,3,0,3,1,2,0,13,1.8571428571428572,1,0.0,0,3,0,3,4,1,0,2,0,6,7,1
11017,96324,38Y5CIobqNij4aFj76KLUasVvJOAQreZ,3VkHkmOtom3jM2wCu94xgzzu1d6Dn7or,7,4,2,0,2,0,1,0,9,1.2857142857142858,1,0.0,0,2,0,2,4,0,0,1,0,4,5,0
11018,96325,cbr7l5LRDro7CQI0JgaOyUPn8YUM9mv4,3VkHkmOtom3jM2wCu94xgzzu1d6Dn7or,5,2,1,0,1,0,2,0,6,0.8571428571428571,1,0.0,0,1,0,1,2,0,0,2,0,2,4,1
11019,96326,XQ8cWjfBil2LbS40q1iPWrRfwwjzsyVe,3VkHkmOtom3jM2wCu94xgzzu1d6Dn7or,4,6,1,0,2,0,1,0,10,1.4285714285714286,1,0.0,4,1,0,2,2,0,0,1,0,7,3,1
11020,96330,IsCsJjW0xDH4DkKzQKYzHRG4YkMfGi73,3VkHkmOtom3jM2wCu94xgzzu1d6Dn7or,1,0,0,0,0,0,1,0,1,0.14285714285714285,1,0.0,0,0,0,0,0,0,0,1,0,0,1,1
11021,96332,gnDGjS7KmDkjYE8QuMSS8QSW2uwA8L2y,3VkHkmOtom3jM2wCu94xgzzu1d6Dn7or,11,14,5,2,1,6,14,3,45,6.428571428571429,3,0.0,5,5,2,1,9,6,0,14,3,13,32,1
11022,96336,KVFfyYQkCECkqD82goRD9L6cGhnG7Yyt,3VkHkmOtom3jM2wCu94xgzzu1d6Dn7or,6,3,0,0,0,0,4,0,7,1.0,1,0.0,0,0,0,0,3,0,0,4,0,0,7,1
11023,96337,V5BtTNWswVFdas9RLHSBN2Sbe7Es4see,3VkHkmOtom3jM2wCu94xgzzu1d6Dn7or,4,3,1,0,1,0,2,0,7,1.0,1,0.0,1,1,0,1,2,0,0,2,0,3,4,1
11024,96347,va1EzyjrhfrQWrnpm0UcU0zhmwje0Lgb,3VkHkmOtom3jM2wCu94xgzzu1d6Dn7or,5,5,2,0,1,0,2,0,10,1.4285714285714286,1,0.0,1,2,0,1,4,0,0,2,0,4,6,1
11025,96356,FrKCsz7lUcZcU4f2ChSSwOYLHLmQEGxw,3VkHkmOtom3jM2wCu94xgzzu1d6Dn7or,2,0,0,0,0,0,3,0,3,0.42857142857142855,1,0.0,0,0,0,0,0,0,0,3,0,0,3,1
11026,96359,wgSnyXkWmu1gNrkJBMgrRILNAVbfvmPX,3VkHkmOtom3jM2wCu94xgzzu1d6Dn7or,1,0,0,0,0,0,1,0,1,0.14285714285714285,1,0.0,0,0,0,0,0,0,0,1,0,0,1,1
11027,96360,r1v9Rqdep6YVAEXtpRWpkWLslSlgtgyb,3VkHkmOtom3jM2wCu94xgzzu1d6Dn7or,9,19,9,3,2,4,6,0,43,6.142857142857143,4,0.0,3,9,3,2,16,4,0,6,0,17,26,1
11028,96361,hl0OrMfg8qb0yyqeozXaj4TvTbuGpido,3VkHkmOtom3jM2wCu94xgzzu1d6Dn7or,9,13,4,6,6,4,2,0,35,5.0,1,0.0,8,4,5,6,5,4,1,2,0,23,12,1
11029,96367,edy112jDFW9DTLKi2j4yvX37GTSpr4ji,3VkHkmOtom3jM2wCu94xgzzu1d6Dn7or,1,0,0,0,0,0,1,0,1,0.14285714285714285,1,0.0,0,0,0,0,0,0,0,1,0,0,1,1
11030,96369,HD3PNAwAfxdbe7DkvZFjEY40On4EuqxT,3VkHkmOtom3jM2wCu94xgzzu1d6Dn7or,14,30,6,9,12,14,7,0,78,11.142857142857142,2,0.0,20,6,8,12,10,14,1,7,0,46,32,1
11031,96376,djS2tkJzIFUgqNP65BM4kBmvLLZqxLTs,3VkHkmOtom3jM2wCu94xgzzu1d6Dn7or,1,0,0,0,0,0,1,0,1,0.14285714285714285,1,0.0,0,0,0,0,0,0,0,1,0,0,1,1
11032,96379,Vp9lRrKpqmph3iHMmH4MjHMh07OftdBq,3VkHkmOtom3jM2wCu94xgzzu1d6Dn7or,5,4,2,0,1,0,1,0,8,1.1428571428571428,1,0.0,1,2,0,1,3,0,0,1,0,4,4,1
11033,96380,OArwi6O7ZSY2JiImeK6Sw889sg5iYN6Y,3VkHkmOtom3jM2wCu94xgzzu1d6Dn7or,1,0,0,0,0,0,1,0,1,0.14285714285714285,1,0.0,0,0,0,0,0,0,0,1,0,0,1,1
11034,96381,iL9NYNmkyKSSFCPovatPYzIBkey4ylbA,3VkHkmOtom3jM2wCu94xgzzu1d6Dn7or,8,9,1,0,0,8,10,2,30,4.285714285714286,3,0.0,0,1,0,0,9,8,0,10,2,1,29,1
11035,96383,FN0V2FJ9PwsmZe2ZdtFoTzNeftwa8lew,3VkHkmOtom3jM2wCu94xgzzu1d6Dn7or,9,9,4,0,2,0,9,2,26,3.7142857142857144,2,0.0,0,4,0,2,9,0,0,9,2,6,20,1
11036,96388,dMh9VQWRTEnyJkdA9ZgMhWwk39W1YoGN,5Gyp41oLVo7Gg7vF4vpmggWP5MU70QO6,6,7,2,0,0,0,2,0,11,1.5714285714285714,1,0.0,0,2,0,0,7,0,0,2,0,2,9,1
11037,96390,fh4EphLYeMlLWCufiQCSaFg5RdIvqYBV,5Gyp41oLVo7Gg7vF4vpmggWP5MU70QO6,1,0,0,0,0,0,1,0,1,0.14285714285714285,1,0.0,0,0,0,0,0,0,0,1,0,0,1,1
11038,96396,uyCMGQSqEQvYxE6kgiaGm8rp27K2cF85,5Gyp41oLVo7Gg7vF4vpmggWP5MU70QO6,6,7,2,0,1,0,2,0,12,1.7142857142857142,2,0.0,2,2,0,1,5,0,0,2,0,5,7,1
11039,96413,5DRvlJpYdsNcR7W5S4ju0uYQggyV8RF5,5Gyp41oLVo7Gg7vF4vpmggWP5MU70QO6,6,6,3,0,1,0,5,0,15,2.142857142857143,1,0.0,0,3,0,1,6,0,0,5,0,4,11,1
11040,96416,XBSdQamsYfYzRRGJOjuRsFmDekzUw4cN,5Gyp41oLVo7Gg7vF4vpmggWP5MU70QO6,1,0,0,0,0,0,5,0,5,0.7142857142857143,1,0.0,0,0,0,0,0,0,0,5,0,0,5,1
11041,96417,1fnSOOLCTFBv8NWbv5KvTMP3hNiHfhMm,5Gyp41oLVo7Gg7vF4vpmggWP5MU70QO6,1,0,0,0,0,0,1,0,1,0.14285714285714285,1,0.0,0,0,0,0,0,0,0,1,0,0,1,1
11042,96426,9ks3PZ71xYTBAZWZYwlGI227xICme3uh,5Gyp41oLVo7Gg7vF4vpmggWP5MU70QO6,12,16,3,2,2,4,5,4,36,5.142857142857143,1,0.0,11,3,1,2,5,4,1,5,4,17,19,1
11043,96431,gxbFv3w2jQEcMCjTw3OnX3xWd7iwkno0,5Gyp41oLVo7Gg7vF4vpmggWP5MU70QO6,7,4,2,0,2,0,2,0,10,1.4285714285714286,1,0.0,1,2,0,2,3,0,0,2,0,5,5,1
11044,96436,y4LP6KF7rlCesbjS04VFZcr0ymkouqgg,5Gyp41oLVo7Gg7vF4vpmggWP5MU70QO6,7,4,3,0,3,5,2,0,17,2.4285714285714284,1,0.0,0,3,0,3,4,5,0,2,0,6,11,1
11045,96451,S6bQyU4k68cqK5Df4ggJFdi0hXWY7bCC,5Gyp41oLVo7Gg7vF4vpmggWP5MU70QO6,5,2,1,0,1,0,2,0,6,0.8571428571428571,1,0.0,0,1,0,1,2,0,0,2,0,2,4,1
11046,96452,hFUpdiu0hiElLF0SXpu1AulvsOusYwtZ,5Gyp41oLVo7Gg7vF4vpmggWP5MU70QO6,5,2,1,0,1,0,3,0,7,1.0,2,0.0,0,1,0,1,2,0,0,3,0,2,5,1
11047,96456,MTcsFewP5AKdKhm7WCconI2PZnyN3f4Z,5Gyp41oLVo7Gg7vF4vpmggWP5MU70QO6,53,273,150,140,0,146,73,1,783,111.85714285714286,10,0.0,74,150,122,0,199,146,18,73,1,346,437,0
11048,96521,GsNM4TyneJcBYzqDnENCIQOXXKxG2eoA,3VkHkmOtom3jM2wCu94xgzzu1d6Dn7or,1,0,0,0,0,0,1,0,1,0.14285714285714285,1,0.0,0,0,0,0,0,0,0,1,0,0,1,1
11049,96523,qRAJTkZTejCgaeZ2sDW9z6ux0t3hIJMg,3VkHkmOtom3jM2wCu94xgzzu1d6Dn7or,3,0,0,0,0,0,3,0,3,0.42857142857142855,1,0.0,0,0,0,0,0,0,0,3,0,0,3,1
11050,96526,9QIuhIwuEfvjrogqfeXyXDUQ326P7Asr,3VkHkmOtom3jM2wCu94xgzzu1d6Dn7or,2,0,0,0,0,0,3,0,3,0.42857142857142855,1,0.0,0,0,0,0,0,0,0,3,0,0,3,1
11051,96531,lrTVGatgf5mQLoKfT4trphORRE8M2Lmv,3VkHkmOtom3jM2wCu94xgzzu1d6Dn7or,1,0,0,0,0,0,2,0,2,0.2857142857142857,1,0.0,0,0,0,0,0,0,0,2,0,0,2,1
11052,96534,iu8ePW2eHhIFt7cF9xnAgFVNtmK9UR7o,3VkHkmOtom3jM2wCu94xgzzu1d6Dn7or,1,0,0,0,0,0,2,0,2,0.2857142857142857,1,0.0,0,0,0,0,0,0,0,2,0,0,2,1
11053,96535,SeyzjTb3TS9yTnfBxQfVoL7HGCyZcMCL,3VkHkmOtom3jM2wCu94xgzzu1d6Dn7or,1,0,0,0,0,0,2,0,2,0.2857142857142857,1,0.0,0,0,0,0,0,0,0,2,0,0,2,1
11054,96538,Ww89bCEdnDOyx3DV7lSMxZ7xDgYSNYQx,3VkHkmOtom3jM2wCu94xgzzu1d6Dn7or,10,11,5,8,3,2,1,0,30,4.285714285714286,1,0.0,4,5,8,3,7,2,0,1,0,20,10,1
11055,96540,Zr4KLz2ZL4aSF5gVvs5p4LZP1ixAwF6u,3VkHkmOtom3jM2wCu94xgzzu1d6Dn7or,3,0,0,0,0,0,9,0,9,1.2857142857142858,2,0.0,0,0,0,0,0,0,0,9,0,0,9,1
11056,96545,B8YSdLCC0chY0Hi4gF9muFLFGnW5Xq1P,3VkHkmOtom3jM2wCu94xgzzu1d6Dn7or,1,0,0,0,0,0,2,0,2,0.2857142857142857,1,0.0,0,0,0,0,0,0,0,2,0,0,2,1
11057,96547,zO2VhcAdoh7T24EwLrFAZi7hmwyyObxP,3VkHkmOtom3jM2wCu94xgzzu1d6Dn7or,1,0,0,0,0,0,1,0,1,0.14285714285714285,1,0.0,0,0,0,0,0,0,0,1,0,0,1,1
11058,96548,LoEfaid2dOKAK1Vb6WcaGJbgN3PRNGde,3VkHkmOtom3jM2wCu94xgzzu1d6Dn7or,4,3,0,0,0,2,3,0,8,1.1428571428571428,1,0.0,0,0,0,0,3,2,0,3,0,0,8,1
11059,96549,2GpzbExHhNiUBsVX3aGUe0zSsA9C387Y,3VkHkmOtom3jM2wCu94xgzzu1d6Dn7or,1,0,0,0,0,0,1,0,1,0.14285714285714285,1,0.0,0,0,0,0,0,0,0,1,0,0,1,1
11060,96550,ktRWKuIjdpuGKecjIEnR5Rs4zTq2yQBS,3VkHkmOtom3jM2wCu94xgzzu1d6Dn7or,1,0,0,0,0,0,1,0,1,0.14285714285714285,1,0.0,0,0,0,0,0,0,0,1,0,0,1,1
11061,96558,3alUhWh257mQM5A6onXPn87mqMwnY8ws,3VkHkmOtom3jM2wCu94xgzzu1d6Dn7or,8,4,3,0,3,6,10,0,26,3.7142857142857144,1,0.0,0,3,0,3,4,6,0,10,0,6,20,1
11062,96564,8CwT8vsJoNqbQ5sYHbMaosIT6QTdlZQK,3VkHkmOtom3jM2wCu94xgzzu1d6Dn7or,1,0,0,0,0,0,1,0,1,0.14285714285714285,1,0.0,0,0,0,0,0,0,0,1,0,0,1,1
11063,96565,7v36SwdiAdGk2npG7GYc4bVA9RjB8aXw,3VkHkmOtom3jM2wCu94xgzzu1d6Dn7or,1,0,0,0,0,0,1,0,1,0.14285714285714285,1,0.0,0,0,0,0,0,0,0,1,0,0,1,1
11064,96566,teqJGecOr4a6oVYU1O9bgvPkX5ZSKA8N,3VkHkmOtom3jM2wCu94xgzzu1d6Dn7or,8,12,4,0,0,0,10,0,26,3.7142857142857144,5,0.0,0,4,0,0,12,0,0,10,0,4,22,0
11065,96567,eFsmemBDYKCubbpvK6bophBz57DeDjI9,3VkHkmOtom3jM2wCu94xgzzu1d6Dn7or,1,0,0,0,0,0,1,0,1,0.14285714285714285,1,0.0,0,0,0,0,0,0,0,1,0,0,1,1
11066,96568,NXw20imLsAftkOEQqnCfW2uf1rtofEIi,3VkHkmOtom3jM2wCu94xgzzu1d6Dn7or,6,4,2,0,1,1,5,0,13,1.8571428571428572,2,0.0,0,2,0,1,4,1,0,5,0,3,10,1
11067,96569,xd7l7laJViRCqeNwQVN9cYaqt6r2YTd2,3VkHkmOtom3jM2wCu94xgzzu1d6Dn7or,1,0,0,0,0,0,1,0,1,0.14285714285714285,1,0.0,0,0,0,0,0,0,0,1,0,0,1,1
11068,96575,lvrPjshCS0gfAMCRmI8ZLxwWMZI7lhjD,3VkHkmOtom3jM2wCu94xgzzu1d6Dn7or,10,8,4,0,4,0,1,0,17,2.4285714285714284,1,0.0,3,4,0,4,5,0,0,1,0,11,6,1
11069,96577,aqQTf2fLQrJTXefctm75awHMgV3chcLI,3VkHkmOtom3jM2wCu94xgzzu1d6Dn7or,1,0,0,0,0,0,3,0,3,0.42857142857142855,1,0.0,0,0,0,0,0,0,0,3,0,0,3,1
11070,96578,CE7hlTWnMpoldcHVRqlfbEgzp5iUVo4d,3VkHkmOtom3jM2wCu94xgzzu1d6Dn7or,3,0,0,0,0,0,4,0,4,0.5714285714285714,1,0.0,0,0,0,0,0,0,0,4,0,0,4,0
11071,96583,5uoh3HG1nDrMYi2dFveKtERmpEDthN7L,3VkHkmOtom3jM2wCu94xgzzu1d6Dn7or,1,0,0,0,0,0,1,0,1,0.14285714285714285,1,0.0,0,0,0,0,0,0,0,1,0,0,1,1
11072,96585,c9MO50fCrzTuPsgkVZzuZukx5s3e1d2Y,3VkHkmOtom3jM2wCu94xgzzu1d6Dn7or,1,0,0,0,0,0,1,0,1,0.14285714285714285,1,0.0,0,0,0,0,0,0,0,1,0,0,1,1
11073,96586,Jwp0ikLYvBh16g1GJtBqW8Bd54uiA7Uz,3VkHkmOtom3jM2wCu94xgzzu1d6Dn7or,1,0,0,0,0,0,1,0,1,0.14285714285714285,1,0.0,0,0,0,0,0,0,0,1,0,0,1,1
11074,96587,hiNjDCDcv1JzPRBZRj9QRfU9Ul6vxYgf,3VkHkmOtom3jM2wCu94xgzzu1d6Dn7or,3,2,1,0,0,0,2,0,5,0.7142857142857143,1,0.0,0,1,0,0,2,0,0,2,0,1,4,1
11075,96593,7J9JIWVCQG1g6yXh3uTVbrSu3pa18Ezn,3VkHkmOtom3jM2wCu94xgzzu1d6Dn7or,1,0,0,0,0,0,1,0,1,0.14285714285714285,1,0.0,0,0,0,0,0,0,0,1,0,0,1,1
11076,96603,9CnuQIK7YosyuV5lXuwH1YTrUdbaqPIO,3VkHkmOtom3jM2wCu94xgzzu1d6Dn7or,5,7,1,0,1,0,2,0,11,1.5714285714285714,1,0.0,2,1,0,1,5,0,0,2,0,4,7,1
11077,96619,T1h2nTClvb4u9mmdikxybWqwSGostm2v,3VkHkmOtom3jM2wCu94xgzzu1d6Dn7or,1,0,0,0,0,0,1,0,1,0.14285714285714285,1,0.0,0,0,0,0,0,0,0,1,0,0,1,1
11078,96621,NqKjMSY6eOZQ1uSyzlPrquJVqzjvSO7O,3VkHkmOtom3jM2wCu94xgzzu1d6Dn7or,71,171,73,48,61,35,28,1,417,59.57142857142857,12,0.0,71,73,45,61,100,35,3,28,1,250,167,0
11079,96623,DJB5Gl1Ovn2tbiU0joVyu71nUzKvtrAo,3VkHkmOtom3jM2wCu94xgzzu1d6Dn7or,1,0,0,0,0,0,2,0,2,0.2857142857142857,1,0.0,0,0,0,0,0,0,0,2,0,0,2,1
11080,96624,qj7FoMMGmyXc2ttIpiKyiqMFyCbPSMfU,3VkHkmOtom3jM2wCu94xgzzu1d6Dn7or,2,0,0,0,0,18,1,0,19,2.7142857142857144,1,0.0,0,0,0,0,0,18,0,1,0,0,19,0
11081,96627,Fpcn3j59JqdD0go2D9Vju0pFtowXD5t1,3VkHkmOtom3jM2wCu94xgzzu1d6Dn7or,1,0,0,0,0,0,1,0,1,0.14285714285714285,1,0.0,0,0,0,0,0,0,0,1,0,0,1,1
11082,96629,XdPJbYAaOfGSV0DPxyepFBgYITJMqd0Q,3VkHkmOtom3jM2wCu94xgzzu1d6Dn7or,1,0,0,0,0,0,1,0,1,0.14285714285714285,1,0.0,0,0,0,0,0,0,0,1,0,0,1,1
11083,96630,WCDAUZlSmVenqZi8jFXHKvaZIO2xMNrN,3VkHkmOtom3jM2wCu94xgzzu1d6Dn7or,6,5,1,0,0,0,4,1,11,1.5714285714285714,1,0.0,3,1,0,0,2,0,0,4,1,4,7,1
11084,96638,TQ1Tb2cgiG68xs6aUf696l3C3zHYq6fS,3VkHkmOtom3jM2wCu94xgzzu1d6Dn7or,27,83,31,36,25,1,13,0,189,27.0,6,0.0,35,31,30,25,48,1,6,13,0,121,68,0
11085,96644,8wUaJS3OiPlXPEpMaUdmFJpYr0YDMidI,3VkHkmOtom3jM2wCu94xgzzu1d6Dn7or,3,0,0,0,0,2,2,1,5,0.7142857142857143,1,0.0,0,0,0,0,0,2,0,2,1,0,5,1
11086,96650,EWz1Knm7j4qPyfsJuTJMybXhniKlG4fK,3VkHkmOtom3jM2wCu94xgzzu1d6Dn7or,46,79,35,0,33,1,14,1,163,23.285714285714285,5,0.0,31,35,0,33,48,1,0,14,1,99,64,1
11087,96660,K4jFJfgJGqdXK7Z4hAXFjX8nyCsKhSvR,3VkHkmOtom3jM2wCu94xgzzu1d6Dn7or,1,0,0,0,0,0,1,0,1,0.14285714285714285,1,0.0,0,0,0,0,0,0,0,1,0,0,1,1
11088,96665,u3pW4VoOLnKXXznAopRdzC3HjISbRije,bWdj2GDclj5ofokWjzoa5jAwMkxCykd6,9,13,8,0,1,0,9,0,31,4.428571428571429,1,0.0,0,8,0,1,13,0,0,9,0,9,22,1
11089,96690,PNuCKnyPWCRVxphTjJ1pIquyKu0dURK7,RXDvfPUBYFlVdlueBFbLW0mhhAyGEqpt,1,0,0,0,0,0,1,0,1,0.14285714285714285,1,0.0,0,0,0,0,0,0,0,1,0,0,1,1
11090,96694,GklpxWvYTAVCee485ZamCcjaSU51nZj5,SpATywNh6bZuzm8s1ceuBUnMUAeoAHHw,1,0,0,0,0,0,1,0,1,0.14285714285714285,1,0.0,0,0,0,0,0,0,0,1,0,0,1,1
11091,96698,kfq7KT5bB5EYh8pOfijeZyMqCV9XlzvB,RXDvfPUBYFlVdlueBFbLW0mhhAyGEqpt,109,118,84,190,51,29,21,11,504,72.0,5,0.0,20,84,173,51,98,29,17,21,11,328,176,0
11092,96703,6xGDraSqeqntwVZEzFmkXhdYujPnB4LO,bWdj2GDclj5ofokWjzoa5jAwMkxCykd6,5,2,0,0,0,0,4,0,6,0.8571428571428571,2,0.0,0,0,0,0,2,0,0,4,0,0,6,1
11093,96713,b45zb6rgcFvlQYxgSSxpvRcImBdsbXNp,SpATywNh6bZuzm8s1ceuBUnMUAeoAHHw,5,2,1,0,1,0,2,0,6,0.8571428571428571,1,0.0,0,1,0,1,2,0,0,2,0,2,4,1
11094,96720,nyH7Jx4kN1AdDJdwkZQoUDqYoovHgbk5,SpATywNh6bZuzm8s1ceuBUnMUAeoAHHw,19,34,18,16,12,0,4,0,84,12.0,4,0.0,4,18,15,12,30,0,1,4,0,49,35,1
11095,96722,DbjDF1tOy1lx5nslzqXmkcQc1dR90TPF,bWdj2GDclj5ofokWjzoa5jAwMkxCykd6,17,15,10,0,8,2,10,1,46,6.571428571428571,2,0.0,2,10,0,8,13,2,0,10,1,20,26,1
11096,96733,tMJpDv6ZjEPz2ELzUVp4mZTT6G7u49T6,SpATywNh6bZuzm8s1ceuBUnMUAeoAHHw,5,2,1,0,1,0,3,0,7,1.0,2,0.0,0,1,0,1,2,0,0,3,0,2,5,1
11097,96734,fAZJvvaqILemW9qqdyo0ZQidn1S9S3J8,RXDvfPUBYFlVdlueBFbLW0mhhAyGEqpt,55,140,3,164,5,16,25,11,364,52.0,6,0.0,16,3,145,5,124,16,19,25,11,169,195,1
11098,96740,UOssUZDJcaoIiaAH8nTbzjrXIWUHSQSA,5X6FeZozNMgE2VRi3MJYjkkFK8SETtu2,5,7,3,2,1,0,2,0,15,2.142857142857143,2,0.0,2,3,2,1,5,0,0,2,0,8,7,1
11099,96743,FRLanjUzKW4rWwV5FL1637YVNyKuRrXY,G8EPVSXsOYB5YQWZGiz1aVq5Pgr2GrQu,2,0,0,0,0,0,2,0,2,0.2857142857142857,1,0.0,0,0,0,0,0,0,0,2,0,0,2,1
11100,96764,7ITppmxIJuiv2qwirt1AUPH7whJqqqHK,bWdj2GDclj5ofokWjzoa5jAwMkxCykd6,4,1,0,0,0,0,3,0,4,0.5714285714285714,1,0.0,0,0,0,0,1,0,0,3,0,0,4,1
11101,96776,Q2sM7xUZ5pftXbE3pDquUzMiyNyEc1IS,SpATywNh6bZuzm8s1ceuBUnMUAeoAHHw,10,10,3,0,2,1,8,0,24,3.4285714285714284,2,0.0,0,3,0,2,10,1,0,8,0,5,19,1
11102,96793,sr8A7s2BlClhUz4NJffXtRDNVcz1ockZ,G8EPVSXsOYB5YQWZGiz1aVq5Pgr2GrQu,2,0,0,0,0,0,2,0,2,0.2857142857142857,1,0.0,0,0,0,0,0,0,0,2,0,0,2,1
11103,96802,lk035YDNwEm5whK0h05D7Y9rnoNxjcmm,G8EPVSXsOYB5YQWZGiz1aVq5Pgr2GrQu,5,3,0,0,0,0,5,0,8,1.1428571428571428,1,0.0,0,0,0,0,3,0,0,5,0,0,8,1
11104,96804,ySbpVhOvpB9MuHEn2lEoeA4d5zRYukkl,bWdj2GDclj5ofokWjzoa5jAwMkxCykd6,7,3,2,0,2,0,2,0,9,1.2857142857142858,1,0.0,0,2,0,2,3,0,0,2,0,4,5,1
11105,96805,l5LcQXaXypTaa8UtbYyDr1XartlmUM1X,A3fsA9Zfv1X2fVEQhTw51lKENdNrEqT3,71,16,12,254,9,0,11,0,302,43.142857142857146,2,0.0,3,12,222,9,13,0,32,11,0,246,56,1
11106,96815,VeDeV6aD6kowERv1ygPjE9YEMgMJMOAv,SpATywNh6bZuzm8s1ceuBUnMUAeoAHHw,5,4,0,0,0,1,3,0,8,1.1428571428571428,1,0.0,1,0,0,0,3,1,0,3,0,1,7,0
11107,96818,ULdF32fTmMpV957Ngz6P80D0kuxYFb2A,SpATywNh6bZuzm8s1ceuBUnMUAeoAHHw,44,35,21,25,12,0,36,4,133,19.0,8,0.0,13,21,24,12,22,0,1,36,4,70,63,0
11108,96830,2RZRnBZq03ynZpoq39fa7eCt5EQoKRyi,SpATywNh6bZuzm8s1ceuBUnMUAeoAHHw,5,3,0,0,0,0,2,0,5,0.7142857142857143,1,0.0,0,0,0,0,3,0,0,2,0,0,5,1
11109,96837,Y0YamNoipgJ1ygcQIdzGiH4SNlabFh17,A3fsA9Zfv1X2fVEQhTw51lKENdNrEqT3,5,2,1,0,1,0,4,0,8,1.1428571428571428,2,0.0,0,1,0,1,2,0,0,4,0,2,6,1
11110,96842,LdBDSA1JN40omRgUCX83gwfcPGCdnUpp,SpATywNh6bZuzm8s1ceuBUnMUAeoAHHw,1,0,0,0,0,0,1,0,1,0.14285714285714285,1,0.0,0,0,0,0,0,0,0,1,0,0,1,0
11111,96846,M8C9BDFICk4ida59GU0jjp556zazDEi1,5X6FeZozNMgE2VRi3MJYjkkFK8SETtu2,5,3,2,0,1,0,1,0,7,1.0,1,0.0,0,2,0,1,3,0,0,1,0,3,4,1
11112,96873,cD5CJQRtTCG0McZYvErqx6oV3tTvutc8,RXDvfPUBYFlVdlueBFbLW0mhhAyGEqpt,46,50,22,73,9,19,8,3,184,26.285714285714285,2,0.0,11,22,70,9,39,19,3,8,3,112,72,1
11113,96878,em6ahWcMRmenNOPIHJ0IxuoaSlBI3zdC,5X6FeZozNMgE2VRi3MJYjkkFK8SETtu2,5,2,1,0,1,0,2,0,6,0.8571428571428571,1,0.0,0,1,0,1,2,0,0,2,0,2,4,1
11114,96886,DBX65PxBJF0vtcBiyRL7bV1O21H4mRXM,SpATywNh6bZuzm8s1ceuBUnMUAeoAHHw,45,37,22,31,13,2,9,2,116,16.571428571428573,2,0.0,7,22,27,13,30,2,4,9,2,69,47,0
11115,96901,umy7brIUz48bN1VUJsZEuHA9by5FINCa,7GRhBDsirIGkRZBtSMEzNTyDr2JQm4xx,4,2,1,0,1,0,1,0,5,0.7142857142857143,1,0.0,0,1,0,1,2,0,0,1,0,2,3,1
11116,96902,U74IyVXcSeKcVNZXE9AVeORjHrqTX1QT,bWdj2GDclj5ofokWjzoa5jAwMkxCykd6,6,9,0,0,1,0,7,0,17,2.4285714285714284,1,0.0,2,0,0,1,7,0,0,7,0,3,14,1
11117,96903,1pK61ylyaaC4hALoXRUV5dMzHILaBLST,7GRhBDsirIGkRZBtSMEzNTyDr2JQm4xx,10,6,4,0,3,3,5,0,21,3.0,1,0.0,0,4,0,3,6,3,0,5,0,7,14,1
11118,96909,cydJyLaLNn5DY7FvXVsvxCdKUpzLzSYa,7GRhBDsirIGkRZBtSMEzNTyDr2JQm4xx,1,0,0,0,0,0,1,0,1,0.14285714285714285,1,0.0,0,0,0,0,0,0,0,1,0,0,1,1
11119,96922,Pcryla0IgY2rOY0iESPNV3PdGPGcwgwQ,SpATywNh6bZuzm8s1ceuBUnMUAeoAHHw,2,0,0,0,0,0,2,0,2,0.2857142857142857,1,0.0,0,0,0,0,0,0,0,2,0,0,2,1
11120,96932,RdNoFjcCRsxTOOSC7N4ELIdxTaySGrVr,SpATywNh6bZuzm8s1ceuBUnMUAeoAHHw,47,62,29,42,14,3,12,0,162,23.142857142857142,7,0.0,22,29,41,14,40,3,1,12,0,106,56,0
11121,96942,ddBSvwjxr0YTDDcnYkevrytFfJuV96PQ,7GRhBDsirIGkRZBtSMEzNTyDr2JQm4xx,6,2,2,0,1,4,3,0,12,1.7142857142857142,1,0.0,0,2,0,1,2,4,0,3,0,3,9,0
11122,96970,JJDkGcMTxDtJkwoP4HDunO8MvFfCRHjv,G8EPVSXsOYB5YQWZGiz1aVq5Pgr2GrQu,18,15,4,16,4,0,2,0,41,5.857142857142857,1,0.0,10,4,8,4,5,0,8,2,0,26,15,1
11123,96973,sDkPRIBG4BxIPEbrLzSh2qpuZHtht3Is,7GRhBDsirIGkRZBtSMEzNTyDr2JQm4xx,5,5,0,0,0,4,2,1,12,1.7142857142857142,1,0.0,0,0,0,0,5,4,0,2,1,0,12,1
11124,96981,lWM0T55BVqig0BJS7dua8PmdCMELT35Y,SpATywNh6bZuzm8s1ceuBUnMUAeoAHHw,22,30,6,0,5,2,14,0,57,8.142857142857142,3,0.0,0,6,0,5,30,2,0,14,0,11,46,0
11125,96985,JXYISIoy0xfDgxPuIXBBnerkjGt68Wii,7GRhBDsirIGkRZBtSMEzNTyDr2JQm4xx,2,0,0,0,0,0,2,0,2,0.2857142857142857,1,0.0,0,0,0,0,0,0,0,2,0,0,2,1
11126,96988,UpJhrUDqF2VjXGqQuraSx51MIPsKK7IC,7GRhBDsirIGkRZBtSMEzNTyDr2JQm4xx,1,0,0,0,0,0,1,0,1,0.14285714285714285,1,0.0,0,0,0,0,0,0,0,1,0,0,1,1
11127,96994,Pn5FZNl6VLJk6Snk5stzxPkp0wDMfahE,7GRhBDsirIGkRZBtSMEzNTyDr2JQm4xx,17,18,7,6,7,6,3,0,47,6.714285714285714,1,0.0,10,7,5,7,8,6,1,3,0,29,18,1
11128,97000,NTUe1XMr3a8PtjVuNaWc1ebEh7ejstpo,7GRhBDsirIGkRZBtSMEzNTyDr2JQm4xx,5,3,1,0,1,1,2,0,8,1.1428571428571428,1,0.0,0,1,0,1,3,1,0,2,0,2,6,1
11129,97002,uRoFRO1euFkfOgsqx7mXaWeoTuIR1DXQ,7GRhBDsirIGkRZBtSMEzNTyDr2JQm4xx,1,0,0,0,0,0,1,0,1,0.14285714285714285,1,0.0,0,0,0,0,0,0,0,1,0,0,1,1
11130,97009,nRHQUNRUIsIinoYx4tQlxNnAC0I3YYVk,7GRhBDsirIGkRZBtSMEzNTyDr2JQm4xx,4,2,1,0,1,0,1,0,5,0.7142857142857143,1,0.0,0,1,0,1,2,0,0,1,0,2,3,1
11131,97016,MSXFOc30HZVbYZtATkSJwT5euFO05BA1,A3fsA9Zfv1X2fVEQhTw51lKENdNrEqT3,1,0,0,0,0,0,1,0,1,0.14285714285714285,1,0.0,0,0,0,0,0,0,0,1,0,0,1,1
11132,97022,B5xWWXtq7QtEIXusjmb70Va0vI762ykg,7GRhBDsirIGkRZBtSMEzNTyDr2JQm4xx,1,0,0,0,0,0,1,0,1,0.14285714285714285,1,0.0,0,0,0,0,0,0,0,1,0,0,1,1
11133,97025,Wf4JyezR0jRlT8v2vkx1xi1JNRFq0xEi,G8EPVSXsOYB5YQWZGiz1aVq5Pgr2GrQu,5,2,1,0,1,0,2,0,6,0.8571428571428571,1,0.0,0,1,0,1,2,0,0,2,0,2,4,1
11134,97060,XlT7X7Rn0fLTh36Iz42hC1Epd5u3ukUS,A3fsA9Zfv1X2fVEQhTw51lKENdNrEqT3,2,0,0,0,0,0,3,0,3,0.42857142857142855,1,0.0,0,0,0,0,0,0,0,3,0,0,3,1
11135,97065,M2tv4JvKfiiNHzXtHrilXY5dpWpYAsaI,7GRhBDsirIGkRZBtSMEzNTyDr2JQm4xx,32,47,23,52,12,6,18,3,161,23.0,2,0.0,19,23,46,12,28,6,6,18,3,100,61,1
11136,97074,DwUUs9JZigOshXSWTSc43CdDGD0UXHS0,A3fsA9Zfv1X2fVEQhTw51lKENdNrEqT3,1,0,0,0,0,0,1,0,1,0.14285714285714285,1,0.0,0,0,0,0,0,0,0,1,0,0,1,1
11137,97117,c8WJAdYLV71mOx4ZXSglpCNd0dBUR3Om,7GRhBDsirIGkRZBtSMEzNTyDr2JQm4xx,90,69,28,97,16,0,11,0,221,31.571428571428573,6,0.0,32,28,96,16,37,0,1,11,0,172,49,0
11138,97118,4qkLaALORr1a036cib5fpJjiu97UEMIR,A3fsA9Zfv1X2fVEQhTw51lKENdNrEqT3,3,2,0,0,0,0,2,0,4,0.5714285714285714,2,0.0,0,0,0,0,2,0,0,2,0,0,4,0
11139,97187,QRq9SneqdOEdNrPCbzGfNOJsUrpMzzSX,7GRhBDsirIGkRZBtSMEzNTyDr2JQm4xx,6,2,1,0,0,0,4,1,8,1.1428571428571428,1,0.0,0,1,0,0,2,0,0,4,1,1,7,1
11140,97201,XDng1mliVGDk6IontbBqBdoGZnODrUp1,A3fsA9Zfv1X2fVEQhTw51lKENdNrEqT3,4,2,0,0,0,1,7,0,10,1.4285714285714286,1,0.0,0,0,0,0,2,1,0,7,0,0,10,1
11141,97214,9HiOT9GgvrP1q1oAqpQLpBir7zKJrsoX,A3fsA9Zfv1X2fVEQhTw51lKENdNrEqT3,64,77,42,0,25,0,11,0,155,22.142857142857142,4,0.0,0,42,0,25,77,0,0,11,0,67,88,0
11142,97248,NoR9mkFsH1bv284uzLHF1usaPKto2GOu,5X6FeZozNMgE2VRi3MJYjkkFK8SETtu2,5,2,1,0,1,0,2,0,6,0.8571428571428571,1,0.0,0,1,0,1,2,0,0,2,0,2,4,1
11143,97263,7xpmz6LF4dl35fFKZgRU70OZyF8UO4PL,A3fsA9Zfv1X2fVEQhTw51lKENdNrEqT3,14,14,7,0,8,0,4,0,33,4.714285714285714,2,0.0,1,7,0,8,13,0,0,4,0,16,17,0
11144,97267,lDlatmKJdo0qBYapZcbWQLsUydBhY3xU,7GRhBDsirIGkRZBtSMEzNTyDr2JQm4xx,2,0,0,0,0,0,2,0,2,0.2857142857142857,1,0.0,0,0,0,0,0,0,0,2,0,0,2,1
11145,97276,4sSRGcSDSLzxYWcglxw7d9PzYXxgOT88,A3fsA9Zfv1X2fVEQhTw51lKENdNrEqT3,1,0,0,0,0,0,1,0,1,0.14285714285714285,1,0.0,0,0,0,0,0,0,0,1,0,0,1,1
11146,97280,K3hHnTNefmiCtc4XrTaWBBqlsZLO9w2Y,7GRhBDsirIGkRZBtSMEzNTyDr2JQm4xx,7,2,1,0,1,0,6,0,10,1.4285714285714286,1,0.0,0,1,0,1,2,0,0,6,0,2,8,1
11147,97284,pMJooPSuvdyxYlrVEgbsDyM57xOtG2AB,7GRhBDsirIGkRZBtSMEzNTyDr2JQm4xx,10,20,8,0,3,5,12,1,49,7.0,1,0.0,0,8,0,3,20,5,0,12,1,11,38,1
11148,97290,6HdK3GMcDECpURp0hr8iCkrI8mDzaH0T,A3fsA9Zfv1X2fVEQhTw51lKENdNrEqT3,4,5,1,0,1,0,1,0,8,1.1428571428571428,1,0.0,1,1,0,1,4,0,0,1,0,3,5,1
11149,97298,tp9GLoYyljDV6mILQxrtrv1Iw4qcPl5Z,7GRhBDsirIGkRZBtSMEzNTyDr2JQm4xx,6,4,2,0,1,0,2,0,9,1.2857142857142858,1,0.0,1,2,0,1,3,0,0,2,0,4,5,1
11150,97304,yUo0f8mA9XEAtzr6kcSUh5ydpzcuIcml,5X6FeZozNMgE2VRi3MJYjkkFK8SETtu2,9,10,2,0,3,0,3,0,18,2.5714285714285716,1,0.0,5,2,0,3,5,0,0,3,0,10,8,1
11151,97310,OQh4D4FzaoRB0CBhRcAfr9BP6p8j9VSR,7GRhBDsirIGkRZBtSMEzNTyDr2JQm4xx,46,108,41,63,28,22,14,1,277,39.57142857142857,2,0.0,59,41,55,28,49,22,8,14,1,183,94,1
11152,97314,CabsQjb2Sd2I3ynTdtsErAG67rLex08f,5X6FeZozNMgE2VRi3MJYjkkFK8SETtu2,22,36,2,27,15,4,5,3,92,13.142857142857142,1,0.0,24,2,22,15,12,4,5,5,3,63,29,0
11153,97320,l70wRZ2DS0s6LjbT7C4gRoGrF27x9p2H,7GRhBDsirIGkRZBtSMEzNTyDr2JQm4xx,5,4,1,0,1,0,2,0,8,1.1428571428571428,2,0.0,0,1,0,1,4,0,0,2,0,2,6,1
11154,97321,LCbgvnPLqp4sLOznBVH7hp4sgd755glC,A3fsA9Zfv1X2fVEQhTw51lKENdNrEqT3,1,0,0,0,0,0,1,0,1,0.14285714285714285,1,0.0,0,0,0,0,0,0,0,1,0,0,1,1
11155,97324,f90qLjbKhR4QYxfjw2iRpmn1h5TurGYb,7GRhBDsirIGkRZBtSMEzNTyDr2JQm4xx,1,0,0,0,0,0,1,0,1,0.14285714285714285,1,0.0,0,0,0,0,0,0,0,1,0,0,1,1
11156,97328,drUu3tyovHqnF7EAaPHayHDYbWMe2Od6,7GRhBDsirIGkRZBtSMEzNTyDr2JQm4xx,1,0,0,0,0,0,1,0,1,0.14285714285714285,1,0.0,0,0,0,0,0,0,0,1,0,0,1,1
11157,97338,6nY1NKnNZjXTuu3STCQuLqvZK441BMSh,A3fsA9Zfv1X2fVEQhTw51lKENdNrEqT3,9,4,3,0,3,0,2,0,12,1.7142857142857142,1,0.0,0,3,0,3,4,0,0,2,0,6,6,1
11158,97345,PUW0i4IuafllkJEtV0GCqmTDeLHkDmH3,7GRhBDsirIGkRZBtSMEzNTyDr2JQm4xx,41,49,15,73,2,2,6,0,147,21.0,3,0.0,23,15,68,2,26,2,5,6,0,108,39,0
11159,97357,VnkZQ14wQqfipOllRb5zJLKqrvJ7kfcr,7GRhBDsirIGkRZBtSMEzNTyDr2JQm4xx,25,70,24,24,11,2,8,0,139,19.857142857142858,2,0.0,37,24,22,11,33,2,2,8,0,94,45,1
11160,97373,PkSfLYbj8bmlsWpi3b15gaXmhBJLMldT,7GRhBDsirIGkRZBtSMEzNTyDr2JQm4xx,4,0,0,0,0,0,5,0,5,0.7142857142857143,1,0.0,0,0,0,0,0,0,0,5,0,0,5,1
11161,97383,mCG6A82geHUNInyyr8XpxXWG9opXSIn8,A3fsA9Zfv1X2fVEQhTw51lKENdNrEqT3,2,0,0,0,0,0,2,0,2,0.2857142857142857,1,0.0,0,0,0,0,0,0,0,2,0,0,2,1
11162,97388,X4FMUX7NyjmKPKTTYvtQYUeaVHGTuyBO,7GRhBDsirIGkRZBtSMEzNTyDr2JQm4xx,1,0,0,0,0,0,1,0,1,0.14285714285714285,1,0.0,0,0,0,0,0,0,0,1,0,0,1,1
11163,97428,92TVODkqWtTMaGGihgBsUR7wsg2cHNWw,A3fsA9Zfv1X2fVEQhTw51lKENdNrEqT3,29,29,23,2,15,39,32,4,144,20.571428571428573,4,0.0,0,23,2,15,29,39,0,32,4,40,104,1
11164,97462,nCZrnJjbpsSoXVwiEhCJqTYAOI3F94p9,7GRhBDsirIGkRZBtSMEzNTyDr2JQm4xx,1,0,0,0,0,0,1,0,1,0.14285714285714285,1,0.0,0,0,0,0,0,0,0,1,0,0,1,1
11165,97464,rX6twqRSTJA5YELRg8HEcckmy1BY4CL4,7GRhBDsirIGkRZBtSMEzNTyDr2JQm4xx,2,0,0,0,0,0,4,0,4,0.5714285714285714,1,0.0,0,0,0,0,0,0,0,4,0,0,4,1
11166,97489,gSg4PIaWl0hBhOgVlpN9o8YrQn4pTOeq,A3fsA9Zfv1X2fVEQhTw51lKENdNrEqT3,37,29,24,42,16,4,9,0,124,17.714285714285715,2,0.0,2,24,36,16,27,4,6,9,0,78,46,1
11167,97490,gSg4PIaWl0hBhOgVlpN9o8YrQn4pTOeq,5X6FeZozNMgE2VRi3MJYjkkFK8SETtu2,1,0,0,0,0,0,1,0,1,0.14285714285714285,1,0.0,0,0,0,0,0,0,0,1,0,0,1,1
11168,97503,kuZwBvEdgeUtKZ495C2FptBbxEtLtmVH,A3fsA9Zfv1X2fVEQhTw51lKENdNrEqT3,168,163,85,346,48,0,24,0,666,95.14285714285714,13,0.0,7,85,313,48,156,0,33,24,0,453,213,0
11169,97505,irC65kbKvoZeQoBjNpGJgeuitn3hVGmi,7GRhBDsirIGkRZBtSMEzNTyDr2JQm4xx,16,13,8,0,6,0,1,0,28,4.0,1,0.0,4,8,0,6,9,0,0,1,0,18,10,1
11170,97515,pzCTwt0ZOXglZvlGS3lVvI03ZM6KLXP8,A3fsA9Zfv1X2fVEQhTw51lKENdNrEqT3,2,0,0,0,0,0,2,0,2,0.2857142857142857,1,0.0,0,0,0,0,0,0,0,2,0,0,2,1
11171,97542,zanAvKU2mdWyY3mDD8TfWW4Mldy5ZoKh,A3fsA9Zfv1X2fVEQhTw51lKENdNrEqT3,2,0,0,0,0,0,2,0,2,0.2857142857142857,1,0.0,0,0,0,0,0,0,0,2,0,0,2,1
11172,97552,EO6xtvTLkHLCut4ifOiDl6xUZBrLObA6,7GRhBDsirIGkRZBtSMEzNTyDr2JQm4xx,1,0,0,0,0,0,1,0,1,0.14285714285714285,1,0.0,0,0,0,0,0,0,0,1,0,0,1,1
11173,97558,hdh7f9dbamC5OLbnjQIw5ciTwmy2oqSe,5X6FeZozNMgE2VRi3MJYjkkFK8SETtu2,1,0,0,0,0,0,1,0,1,0.14285714285714285,1,0.0,0,0,0,0,0,0,0,1,0,0,1,1
11174,97591,2B1Sa19tBbYgocD2xlB5fX7K09dmclmZ,7GRhBDsirIGkRZBtSMEzNTyDr2JQm4xx,5,5,1,0,1,0,1,0,8,1.1428571428571428,1,0.0,0,1,0,1,5,0,0,1,0,2,6,1
11175,97594,dw4lgaN9P3PyU0MHPWHpyVDf4mzTc9ng,A3fsA9Zfv1X2fVEQhTw51lKENdNrEqT3,5,2,1,0,1,0,2,0,6,0.8571428571428571,1,0.0,0,1,0,1,2,0,0,2,0,2,4,1
11176,97610,s1R28bKWEj15blBL1mUk4SpYHehZMU5V,A3fsA9Zfv1X2fVEQhTw51lKENdNrEqT3,2,0,0,0,0,0,2,0,2,0.2857142857142857,1,0.0,0,0,0,0,0,0,0,2,0,0,2,0
11177,97613,kz8Qaij4c30iDpbw4iAszcAM45hxcKwU,7GRhBDsirIGkRZBtSMEzNTyDr2JQm4xx,6,2,1,0,1,0,4,0,8,1.1428571428571428,2,0.0,0,1,0,1,2,0,0,4,0,2,6,1
11178,97636,xjgxPvzfyFRaUpAnYKBxqwH6viCz5kQQ,7GRhBDsirIGkRZBtSMEzNTyDr2JQm4xx,11,8,0,0,0,2,3,0,13,1.8571428571428572,1,0.0,0,0,0,0,8,2,0,3,0,0,13,1
11179,97651,V2x3aryl9UEOOA9YqVFbOW3AEmLe65no,A3fsA9Zfv1X2fVEQhTw51lKENdNrEqT3,1,0,0,0,0,0,1,0,1,0.14285714285714285,1,0.0,0,0,0,0,0,0,0,1,0,0,1,1
11180,97677,ckLHKK3LLJ1ODiI07ljHA4kEITYOAMp6,A3fsA9Zfv1X2fVEQhTw51lKENdNrEqT3,1,0,0,0,0,0,3,0,3,0.42857142857142855,1,0.0,0,0,0,0,0,0,0,3,0,0,3,1
11181,97687,c4t4dDJowOpIlN13FksSkOjvFA7x8JRq,A3fsA9Zfv1X2fVEQhTw51lKENdNrEqT3,1,0,0,0,0,0,1,0,1,0.14285714285714285,1,0.0,0,0,0,0,0,0,0,1,0,0,1,1
11182,97722,bi9mZp6NegzS3n1ijbBhkJh3tVlhmPEB,5X6FeZozNMgE2VRi3MJYjkkFK8SETtu2,23,47,31,0,30,1,10,1,120,17.142857142857142,1,0.0,12,31,0,30,35,1,0,10,1,73,47,1
11183,97740,pC1UDzWN2ohmqWVct0AFjGKW6gzUzWEQ,7GRhBDsirIGkRZBtSMEzNTyDr2JQm4xx,1,0,0,0,0,0,1,0,1,0.14285714285714285,1,0.0,0,0,0,0,0,0,0,1,0,0,1,1
11184,97741,WIkPVA3ZQexYqPa7aSal3hPiR2XYOXKW,7GRhBDsirIGkRZBtSMEzNTyDr2JQm4xx,7,5,3,4,1,4,2,0,19,2.7142857142857144,1,0.0,1,3,3,1,4,4,1,2,0,8,11,1
11185,97750,PlRR5bewxY5s5UPrV9qsB2qkDqRzxPQw,A3fsA9Zfv1X2fVEQhTw51lKENdNrEqT3,7,3,2,0,2,0,2,0,9,1.2857142857142858,1,0.0,0,2,0,2,3,0,0,2,0,4,5,0
11186,97757,0w9tP8TINgzfbBeYFJprB82ry0PjYiWn,5X6FeZozNMgE2VRi3MJYjkkFK8SETtu2,7,7,1,0,2,0,3,0,13,1.8571428571428572,2,0.0,0,1,0,2,7,0,0,3,0,3,10,1
11187,97786,0fNJ0SS62hGz3ZSBrf8T7bV9piGb2j0E,A3fsA9Zfv1X2fVEQhTw51lKENdNrEqT3,1,0,0,0,0,0,1,0,1,0.14285714285714285,1,0.0,0,0,0,0,0,0,0,1,0,0,1,1
11188,97788,rUoEyfIkacNKFckMvyv3DLlxAp35p4TH,7GRhBDsirIGkRZBtSMEzNTyDr2JQm4xx,1,0,0,0,0,0,1,0,1,0.14285714285714285,1,0.0,0,0,0,0,0,0,0,1,0,0,1,1
11189,97823,ATQZndVeRd2FYpO1RdHKpCdTF73Knsgq,7GRhBDsirIGkRZBtSMEzNTyDr2JQm4xx,25,28,8,22,9,0,1,0,68,9.714285714285714,1,0.0,19,8,20,9,9,0,2,1,0,56,12,1
11190,97850,xRxxfDF9JUhs0UX7r4WnpuABa2UDKRlw,7GRhBDsirIGkRZBtSMEzNTyDr2JQm4xx,5,3,1,0,1,0,2,0,7,1.0,1,0.0,0,1,0,1,3,0,0,2,0,2,5,1
11191,97851,IZaYyCVwq1dThwi2oxpAeUsxd0yreRPl,A3fsA9Zfv1X2fVEQhTw51lKENdNrEqT3,9,7,3,0,0,1,7,0,18,2.5714285714285716,1,0.0,0,3,0,0,7,1,0,7,0,3,15,0
11192,97852,ZzaZO5citAcoeYBQ4xnco2bMgq0deP0c,7GRhBDsirIGkRZBtSMEzNTyDr2JQm4xx,5,2,1,0,1,0,2,0,6,0.8571428571428571,1,0.0,0,1,0,1,2,0,0,2,0,2,4,1
11193,97857,MvNnLQma2eBM9bCcMIR159XYSNp8VREs,5X6FeZozNMgE2VRi3MJYjkkFK8SETtu2,2,0,0,0,0,0,3,0,3,0.42857142857142855,1,0.0,0,0,0,0,0,0,0,3,0,0,3,1
11194,97863,hShVfXi5CDkkf6vDlaLmVJ6jHLXUmY8S,A3fsA9Zfv1X2fVEQhTw51lKENdNrEqT3,4,2,0,0,0,0,4,0,6,0.8571428571428571,1,0.0,0,0,0,0,2,0,0,4,0,0,6,1
11195,97868,MUERAHHFAKMlIE27Ma0uSdeN9dFIyDRi,5X6FeZozNMgE2VRi3MJYjkkFK8SETtu2,1,0,0,0,0,0,1,0,1,0.14285714285714285,1,0.0,0,0,0,0,0,0,0,1,0,0,1,1
11196,97877,PJSchCVoi1SmaEdfj33PHnlCFqCBlPgo,A3fsA9Zfv1X2fVEQhTw51lKENdNrEqT3,10,5,4,0,3,0,2,0,14,2.0,1,0.0,0,4,0,3,5,0,0,2,0,7,7,0
11197,97886,OCAzb1VfLGBRFoguhxZLxVaO4EgntnGi,7GRhBDsirIGkRZBtSMEzNTyDr2JQm4xx,11,5,4,0,3,2,9,1,24,3.4285714285714284,1,0.0,0,4,0,3,5,2,0,9,1,7,17,1
11198,97896,R4QfQe4PmvrG0dbyyhP6sFUlip9zHR1c,5X6FeZozNMgE2VRi3MJYjkkFK8SETtu2,16,28,12,4,9,3,5,0,61,8.714285714285714,1,0.0,14,12,4,9,14,3,0,5,0,39,22,1
11199,97920,vWPEyRranfmzkX1ptXTrcH52A4pj7s7J,7GRhBDsirIGkRZBtSMEzNTyDr2JQm4xx,8,6,3,0,1,0,7,0,17,2.4285714285714284,1,0.0,0,3,0,1,6,0,0,7,0,4,13,1
11200,97931,DH7DKFu2MLGxg6jCvSwsLzCjgZSx5Z86,3VkHkmOtom3jM2wCu94xgzzu1d6Dn7or,1,0,0,0,0,0,1,0,1,0.14285714285714285,1,0.0,0,0,0,0,0,0,0,1,0,0,1,1
11201,97942,Su4rPXbScaVX4fzvhj5AapJGbVpuaceg,3VkHkmOtom3jM2wCu94xgzzu1d6Dn7or,12,23,8,8,10,8,13,0,70,10.0,2,0.0,11,8,6,10,12,8,2,13,0,35,35,1
11202,97961,abHh79QCH3cAl6oc7JOEcMNp91qTsryP,3VkHkmOtom3jM2wCu94xgzzu1d6Dn7or,4,2,1,0,1,0,2,0,6,0.8571428571428571,1,0.0,0,1,0,1,2,0,0,2,0,2,4,1
11203,97962,FXVpQoS8mavqcQRGTmrN03ngBkUOH7AA,3VkHkmOtom3jM2wCu94xgzzu1d6Dn7or,1,0,0,0,0,0,1,0,1,0.14285714285714285,1,0.0,0,0,0,0,0,0,0,1,0,0,1,1
11204,97973,IdbptVxItEcsF1HvcM0Mmm9AW3Imyhv4,3VkHkmOtom3jM2wCu94xgzzu1d6Dn7or,4,2,1,0,1,0,2,0,6,0.8571428571428571,1,0.0,0,1,0,1,2,0,0,2,0,2,4,1
11205,97985,KQj2hgE2ypBs8W61al6mmutfgVYIXLIV,3VkHkmOtom3jM2wCu94xgzzu1d6Dn7or,37,33,20,0,19,3,5,0,80,11.428571428571429,4,0.0,2,20,0,19,31,3,0,5,0,41,39,1
11206,97996,ekFVtCGXV5hw4F7qgGu3EcqujoRSFaUy,3VkHkmOtom3jM2wCu94xgzzu1d6Dn7or,68,135,58,62,53,10,31,0,349,49.857142857142854,4,0.0,57,58,56,53,78,10,6,31,0,224,125,0
11207,98004,F3GLSw15emSxn0kSxBiNH7N0nonK3ccg,3VkHkmOtom3jM2wCu94xgzzu1d6Dn7or,52,132,59,41,53,4,21,1,311,44.42857142857143,9,0.0,47,59,37,53,85,4,4,21,1,196,115,0
11208,98005,iLTYp02qFAAV2qBSc8l9MXAqYasJue82,3VkHkmOtom3jM2wCu94xgzzu1d6Dn7or,21,73,8,17,27,1,8,1,135,19.285714285714285,1,0.0,65,8,13,27,8,1,4,8,1,113,22,1
11209,98041,O6NVBS42QfKnEkcEp9sxd9PQKWghi03h,3VkHkmOtom3jM2wCu94xgzzu1d6Dn7or,5,2,1,0,1,0,2,0,6,0.8571428571428571,1,0.0,0,1,0,1,2,0,0,2,0,2,4,1
11210,98061,HiXatwK463mZWTAoFtPIGdI6o88cs6JU,3VkHkmOtom3jM2wCu94xgzzu1d6Dn7or,4,0,0,0,0,0,6,1,7,1.0,2,0.0,0,0,0,0,0,0,0,6,1,0,7,1
11211,98079,NpsYCkB9qwElqIzB8hvyypgPvRPJPFEs,3VkHkmOtom3jM2wCu94xgzzu1d6Dn7or,1,0,0,0,0,0,1,0,1,0.14285714285714285,1,0.0,0,0,0,0,0,0,0,1,0,0,1,1
11212,98108,xrGttsK9FjNRictE1FckUAFqkfpHfKEh,3VkHkmOtom3jM2wCu94xgzzu1d6Dn7or,5,2,1,0,1,0,2,0,6,0.8571428571428571,2,0.0,0,1,0,1,2,0,0,2,0,2,4,0
11213,98112,kfSRJPL1TGKPwFhYhFu7dFMoFH9Opw3m,3VkHkmOtom3jM2wCu94xgzzu1d6Dn7or,5,4,2,0,2,0,2,0,10,1.4285714285714286,1,0.0,0,2,0,2,4,0,0,2,0,4,6,1
11214,98124,ofKU7RB0CJhUieHQIGlGpj4cWDFTK6Cp,3VkHkmOtom3jM2wCu94xgzzu1d6Dn7or,16,30,3,15,6,0,6,0,60,8.571428571428571,3,0.0,8,3,15,6,22,0,0,6,0,32,28,1
11215,98126,DJ09O49b2a0ZKXkFKbGfN66X8003c5sz,3VkHkmOtom3jM2wCu94xgzzu1d6Dn7or,84,332,142,60,55,28,142,0,759,108.42857142857143,21,0.0,59,142,57,55,273,28,3,142,0,313,446,0
11216,98132,OTtK3oVdmZjTM28AzfshWEpsqiUcaY6A,3VkHkmOtom3jM2wCu94xgzzu1d6Dn7or,5,3,1,0,1,0,1,0,6,0.8571428571428571,1,0.0,0,1,0,1,3,0,0,1,0,2,4,1
11217,98157,n9Ui0WELrqThG18Jlxrr7AX4pRXpl9u1,3VkHkmOtom3jM2wCu94xgzzu1d6Dn7or,9,6,2,0,3,0,2,0,13,1.8571428571428572,1,0.0,0,2,0,3,6,0,0,2,0,5,8,1
11218,98161,svJq0UCXpGBLwUQhJN7jJEKUexhbG6kO,3VkHkmOtom3jM2wCu94xgzzu1d6Dn7or,1,0,0,0,0,0,1,0,1,0.14285714285714285,1,0.0,0,0,0,0,0,0,0,1,0,0,1,1
11219,98163,LPvjHBHzMdJFhBtRez5c8W5vjeymkJ4Y,3VkHkmOtom3jM2wCu94xgzzu1d6Dn7or,21,10,8,0,8,2,4,0,32,4.571428571428571,3,0.0,0,8,0,8,10,2,0,4,0,16,16,1
11220,98168,lUOW63ZIGkmagy3rVXMv25n4vumPKUfs,3VkHkmOtom3jM2wCu94xgzzu1d6Dn7or,75,206,105,70,72,18,38,2,511,73.0,14,0.0,57,105,61,72,149,18,9,38,2,295,216,0
11221,98171,dfdxTZ0k85MRDx2z2M9cbXSWjNPaVqdD,3VkHkmOtom3jM2wCu94xgzzu1d6Dn7or,27,66,28,43,34,1,3,0,175,25.0,1,0.0,33,28,40,34,33,1,3,3,0,135,40,0
11222,98174,3JEt0I9b0JhZhM0RD2D5jI5S8zjjeHFo,3VkHkmOtom3jM2wCu94xgzzu1d6Dn7or,55,87,36,55,21,9,33,8,249,35.57142857142857,8,0.0,35,36,55,21,52,9,0,33,8,147,102,0
11223,98179,QFY0u8BcX8zpFgHdurnyNvsfdg75qGHG,3VkHkmOtom3jM2wCu94xgzzu1d6Dn7or,5,3,2,0,2,0,2,0,9,1.2857142857142858,2,0.0,0,2,0,2,3,0,0,2,0,4,5,1
11224,98198,fWWnaleFjqoRqdH3ZH66iQeRGSeBXDX6,3VkHkmOtom3jM2wCu94xgzzu1d6Dn7or,11,13,1,2,5,4,7,1,33,4.714285714285714,1,0.0,6,1,2,5,7,4,0,7,1,14,19,1
11225,98234,baSoH5iOtjeW8QOvk4jsMg08MFliVLZE,3VkHkmOtom3jM2wCu94xgzzu1d6Dn7or,1,0,0,0,0,0,1,0,1,0.14285714285714285,1,0.0,0,0,0,0,0,0,0,1,0,0,1,1
11226,98263,yNC8T7gdWO96Y2q3tzTQeJUMY0F51xnO,3VkHkmOtom3jM2wCu94xgzzu1d6Dn7or,1,0,0,0,0,0,1,0,1,0.14285714285714285,1,0.0,0,0,0,0,0,0,0,1,0,0,1,0
11227,98273,fUXC3xLfSBf2MlyFHIvuCpzPsd9ArwN8,3VkHkmOtom3jM2wCu94xgzzu1d6Dn7or,1,0,0,0,0,0,1,0,1,0.14285714285714285,1,0.0,0,0,0,0,0,0,0,1,0,0,1,1
11228,98282,syoACpxjYIAbt5Q9DbJe0XoRSZFCMIid,3VkHkmOtom3jM2wCu94xgzzu1d6Dn7or,1,0,0,0,0,0,1,0,1,0.14285714285714285,1,0.0,0,0,0,0,0,0,0,1,0,0,1,1
11229,98298,12oMVExdBsAQTQgYFzO3qgxIkmuiT5Bx,3VkHkmOtom3jM2wCu94xgzzu1d6Dn7or,2,0,0,0,0,0,2,0,2,0.2857142857142857,2,0.0,0,0,0,0,0,0,0,2,0,0,2,0
11230,98300,INOLlVwqw5TvyA71S1bSzF7TuwVv7t6I,3VkHkmOtom3jM2wCu94xgzzu1d6Dn7or,55,120,57,46,48,28,54,2,355,50.714285714285715,7,0.0,51,57,39,48,69,28,7,54,2,195,160,0
11231,98301,D1OZc3K6Vn8pIDyF5hDs13BdGQm44o4J,3VkHkmOtom3jM2wCu94xgzzu1d6Dn7or,1,0,0,0,0,0,1,0,1,0.14285714285714285,1,0.0,0,0,0,0,0,0,0,1,0,0,1,1
11232,98343,M9bfqF0nvJt1IlnydnHJT3twRigs4PVw,3VkHkmOtom3jM2wCu94xgzzu1d6Dn7or,1,0,0,0,0,0,1,0,1,0.14285714285714285,1,0.0,0,0,0,0,0,0,0,1,0,0,1,1
11233,98359,XoDsvRe6R9Ra3m3bjZvXwisFgW37uCyt,3VkHkmOtom3jM2wCu94xgzzu1d6Dn7or,27,49,13,13,21,12,15,1,124,17.714285714285715,2,0.0,34,13,12,21,15,12,1,15,1,80,44,1
11234,98364,yP5aDzTZNqvnJatDbGJMvAzkQQHAJnEq,3VkHkmOtom3jM2wCu94xgzzu1d6Dn7or,34,32,29,0,25,0,3,0,89,12.714285714285714,4,0.0,0,29,0,25,32,0,0,3,0,54,35,1
11235,98392,K0OSl2yDmHYQ9TtZdxy9shErNwx3ga0n,3VkHkmOtom3jM2wCu94xgzzu1d6Dn7or,57,129,19,46,12,1,31,3,241,34.42857142857143,10,0.0,78,19,42,12,51,1,4,31,3,151,90,0
11236,98396,yybWJ0SDHBTVHqp2W9MlgsXiEKhnq5ZK,3VkHkmOtom3jM2wCu94xgzzu1d6Dn7or,1,0,0,0,0,0,1,0,1,0.14285714285714285,1,0.0,0,0,0,0,0,0,0,1,0,0,1,1
11237,98399,kAH6V7JzDoLq5AdXMqvLO78igpFvmPcb,3VkHkmOtom3jM2wCu94xgzzu1d6Dn7or,76,140,45,72,55,6,32,0,350,50.0,7,0.0,80,45,59,55,60,6,13,32,0,239,111,1
11238,98457,hfdZ8fSzTj8jJZaq6vM5x271LYekhHqn,3VkHkmOtom3jM2wCu94xgzzu1d6Dn7or,42,27,21,0,19,0,5,3,75,10.714285714285714,3,0.0,1,21,0,19,26,0,0,5,3,41,34,1
11239,98464,ivAfZ9dFFVTP8vOevev8NwgjV7DAmXVl,3VkHkmOtom3jM2wCu94xgzzu1d6Dn7or,7,9,3,0,3,0,4,0,19,2.7142857142857144,1,0.0,4,3,0,3,5,0,0,4,0,10,9,1
11240,98493,NIy8cNrKgyIVG1jqrgkoRXiAb8eTFOie,3VkHkmOtom3jM2wCu94xgzzu1d6Dn7or,21,53,16,26,17,16,19,2,149,21.285714285714285,2,0.0,27,16,24,17,26,16,2,19,2,84,65,1
11241,98502,PYCd6eKOLWWCug2Fb5EugiwVglo4NNfG,3VkHkmOtom3jM2wCu94xgzzu1d6Dn7or,7,2,2,0,2,0,4,0,10,1.4285714285714286,1,0.0,0,2,0,2,2,0,0,4,0,4,6,1
11242,98513,vQhsm5tD21COEAZuKXUqgoA1GtcgDISI,3VkHkmOtom3jM2wCu94xgzzu1d6Dn7or,7,15,3,0,2,5,3,0,28,4.0,1,0.0,2,3,0,2,13,5,0,3,0,7,21,1
11243,98525,PqaQvxweV5eGBMoHluyfcHT8mUURx05w,3VkHkmOtom3jM2wCu94xgzzu1d6Dn7or,4,4,1,0,2,0,1,0,8,1.1428571428571428,1,0.0,2,1,0,2,2,0,0,1,0,5,3,1
11244,98529,GEnJuBoc4JfLjpvLdKpsVzcpMG2Q9J7E,3VkHkmOtom3jM2wCu94xgzzu1d6Dn7or,24,73,11,30,30,22,25,0,191,27.285714285714285,6,0.0,50,11,26,30,23,22,4,25,0,117,74,1
11245,98532,Nc9p0NDSJdMFoXyGCYKlMLXQtm4qOOTX,3VkHkmOtom3jM2wCu94xgzzu1d6Dn7or,6,9,3,0,0,0,10,0,22,3.142857142857143,2,0.0,1,3,0,0,8,0,0,10,0,4,18,1
11246,98544,Z9zdAxugb9Zp4KyDDbKjBMesWfaV1jbd,3VkHkmOtom3jM2wCu94xgzzu1d6Dn7or,1,0,0,0,0,0,1,0,1,0.14285714285714285,1,0.0,0,0,0,0,0,0,0,1,0,0,1,1
11247,98558,NJ4JsHxTiShzME3OoTaAwV982D1L0qYe,3VkHkmOtom3jM2wCu94xgzzu1d6Dn7or,7,1,1,0,1,0,7,1,11,1.5714285714285714,1,0.0,0,1,0,1,1,0,0,7,1,2,9,1
11248,98574,M04H6w8EedYYL8dzBlYNubNPviTfROgN,3VkHkmOtom3jM2wCu94xgzzu1d6Dn7or,9,4,2,0,1,0,8,1,16,2.2857142857142856,2,0.0,0,2,0,1,4,0,0,8,1,3,13,1
11249,98593,0R9xJ1Ysb1ln5d8A0NbqaetP5LST3PYV,3VkHkmOtom3jM2wCu94xgzzu1d6Dn7or,6,2,1,0,1,0,4,1,9,1.2857142857142858,1,0.0,0,1,0,1,2,0,0,4,1,2,7,1
11250,98594,YbXDR0OWqjazkhydYVY2vq3vuaW6LGOY,3VkHkmOtom3jM2wCu94xgzzu1d6Dn7or,16,19,8,2,4,5,15,6,59,8.428571428571429,3,0.0,2,8,2,4,17,5,0,15,6,16,43,1
11251,98596,FK87Mh9LEgwj1VU4pstPcNLLVrRCTWuM,3VkHkmOtom3jM2wCu94xgzzu1d6Dn7or,6,7,4,0,2,2,7,0,22,3.142857142857143,1,0.0,0,4,0,2,7,2,0,7,0,6,16,1
11252,98610,WauTNyXQDm07IKr6oOotK9PP7wOCBLGL,3VkHkmOtom3jM2wCu94xgzzu1d6Dn7or,11,12,7,0,3,0,8,0,30,4.285714285714286,1,0.0,0,7,0,3,12,0,0,8,0,10,20,1
11253,98611,vCnaR7A3EMdV2eOQ4pBMh0byIjK5VwLE,3VkHkmOtom3jM2wCu94xgzzu1d6Dn7or,1,0,0,0,0,0,2,0,2,0.2857142857142857,2,0.0,0,0,0,0,0,0,0,2,0,0,2,1
11254,98660,CjkpbyAkfq9IEZ4dECDMjQUz889YMW0T,3VkHkmOtom3jM2wCu94xgzzu1d6Dn7or,5,2,1,0,1,4,2,0,10,1.4285714285714286,2,0.0,1,1,0,1,1,4,0,2,0,3,7,1
11255,98683,zK6w0JPDDeUD403WVGuxpKSbry9d8uLr,3VkHkmOtom3jM2wCu94xgzzu1d6Dn7or,1,0,0,0,0,0,1,0,1,0.14285714285714285,1,0.0,0,0,0,0,0,0,0,1,0,0,1,1
11256,98702,HdyIyDlcCFQQgaRjYU1638Ek6DgB899m,3VkHkmOtom3jM2wCu94xgzzu1d6Dn7or,1,0,0,0,0,0,1,0,1,0.14285714285714285,1,0.0,0,0,0,0,0,0,0,1,0,0,1,1
11257,98706,gyzBiYUIth0uJrJ5jqofLffLv4otg9kt,3VkHkmOtom3jM2wCu94xgzzu1d6Dn7or,11,6,4,0,3,0,5,0,18,2.5714285714285716,3,0.0,0,4,0,3,6,0,0,5,0,7,11,1
11258,98727,W8qIdYmrLlNNGLHbIczo12Ny6o42zzQ6,3VkHkmOtom3jM2wCu94xgzzu1d6Dn7or,1,0,0,0,0,0,3,0,3,0.42857142857142855,2,0.0,0,0,0,0,0,0,0,3,0,0,3,1
11259,98728,pQbIHrUkI2ft0gnLvneTDpzQduYYGvpn,3VkHkmOtom3jM2wCu94xgzzu1d6Dn7or,6,4,2,0,1,3,3,0,13,1.8571428571428572,1,0.0,0,2,0,1,4,3,0,3,0,3,10,1
11260,98801,98cD0nIIzlQtn9XgJ5GQHEPFcRF6H0SJ,3VkHkmOtom3jM2wCu94xgzzu1d6Dn7or,4,0,0,0,0,7,3,6,16,2.2857142857142856,1,0.0,0,0,0,0,0,7,0,3,6,0,16,1
11261,98814,b5P6aIah2j5gpMQtJOr9oA1Fmrt673Ev,3VkHkmOtom3jM2wCu94xgzzu1d6Dn7or,1,0,0,0,0,0,2,0,2,0.2857142857142857,1,0.0,0,0,0,0,0,0,0,2,0,0,2,1
11262,98825,HcEVK6JSNpXgsr4SEhprpFsKVHZEZVKm,3VkHkmOtom3jM2wCu94xgzzu1d6Dn7or,1,0,0,0,0,0,1,0,1,0.14285714285714285,1,0.0,0,0,0,0,0,0,0,1,0,0,1,1
11263,98861,KQr8qfRCCQ78DrpyWmyHWiqFZ2EzyK3m,3VkHkmOtom3jM2wCu94xgzzu1d6Dn7or,13,8,5,0,5,9,8,7,42,6.0,2,0.0,0,5,0,5,8,9,0,8,7,10,32,1
11264,98884,eu6zKq8qzWqsJoxjMZQiC4ZsBj3GH9NO,3VkHkmOtom3jM2wCu94xgzzu1d6Dn7or,8,5,3,0,2,6,8,0,24,3.4285714285714284,1,0.0,0,3,0,2,5,6,0,8,0,5,19,1
11265,98886,1bdqW93lrID3dEzePAg75ShXgDY2dgi4,3VkHkmOtom3jM2wCu94xgzzu1d6Dn7or,6,0,0,0,0,0,8,1,9,1.2857142857142858,1,0.0,0,0,0,0,0,0,0,8,1,0,9,1
11266,98889,nduTNjBA0lu6oAy3nBgCpw4zMm9X5e5A,3VkHkmOtom3jM2wCu94xgzzu1d6Dn7or,1,0,0,0,0,0,1,0,1,0.14285714285714285,1,0.0,0,0,0,0,0,0,0,1,0,0,1,1
11267,98898,DpHQO3KmNTyYhc4I0Q72w62csKSCNKTH,3VkHkmOtom3jM2wCu94xgzzu1d6Dn7or,5,6,1,0,0,0,5,0,12,1.7142857142857142,1,0.0,0,1,0,0,6,0,0,5,0,1,11,1
11268,98907,ukGlYmEa0KHeCpCJEgEgxOmqtWR3OurB,3VkHkmOtom3jM2wCu94xgzzu1d6Dn7or,13,40,11,10,1,19,13,2,96,13.714285714285714,2,0.0,7,11,8,1,33,19,2,13,2,27,69,1
11269,98915,GarDXRFXxX5iF1KQFXPHCsoEYMeoE46I,3VkHkmOtom3jM2wCu94xgzzu1d6Dn7or,1,0,0,0,0,0,1,0,1,0.14285714285714285,1,0.0,0,0,0,0,0,0,0,1,0,0,1,1
11270,98920,iB31LIPYOOKdvqRLTA6oqQg1uWKX3cVM,3VkHkmOtom3jM2wCu94xgzzu1d6Dn7or,1,0,0,0,0,0,1,0,1,0.14285714285714285,1,0.0,0,0,0,0,0,0,0,1,0,0,1,1
11271,98934,SFnIK5WBQ1x9v2jhd3whYpbMvj804ymA,3VkHkmOtom3jM2wCu94xgzzu1d6Dn7or,4,2,0,0,0,0,2,0,4,0.5714285714285714,1,0.0,0,0,0,0,2,0,0,2,0,0,4,1
11272,98940,IvSFszPnr18KVZKYGSQ6sSbo1mXQ0RkU,3VkHkmOtom3jM2wCu94xgzzu1d6Dn7or,3,2,1,0,0,0,1,0,4,0.5714285714285714,1,0.0,0,1,0,0,2,0,0,1,0,1,3,1
11273,98950,ltaPWMahEaqTdpjQAeiBFxa5xewAQJDv,SpATywNh6bZuzm8s1ceuBUnMUAeoAHHw,1,0,0,0,0,0,1,0,1,0.14285714285714285,1,0.0,0,0,0,0,0,0,0,1,0,0,1,1
11274,98954,wBGtqMIqfQE0VLJPhcCJAUkBOhFNa6qW,G8EPVSXsOYB5YQWZGiz1aVq5Pgr2GrQu,7,4,0,0,0,0,10,1,15,2.142857142857143,3,0.0,0,0,0,0,4,0,0,10,1,0,15,1
11275,98963,y2GG0eXD492QyyIoYTZNCQnQCo2nl9OI,SpATywNh6bZuzm8s1ceuBUnMUAeoAHHw,4,6,0,0,0,1,2,0,9,1.2857142857142858,1,0.0,0,0,0,0,6,1,0,2,0,0,9,1
11276,98973,uxdJIidy36Grvd6xNfpUFUhDe4OC7W0I,SpATywNh6bZuzm8s1ceuBUnMUAeoAHHw,2,0,0,0,0,0,2,0,2,0.2857142857142857,1,0.0,0,0,0,0,0,0,0,2,0,0,2,1
11277,98979,fIRimGrxWNqdzbEvkhoxiWFjGRhUXcWW,bWdj2GDclj5ofokWjzoa5jAwMkxCykd6,9,12,9,0,7,0,3,0,31,4.428571428571429,3,0.0,0,9,0,7,12,0,0,3,0,16,15,1
11278,98990,m30r8XAusN1tKwuw4RNeOZUufFJ19O18,G8EPVSXsOYB5YQWZGiz1aVq5Pgr2GrQu,1,0,0,0,0,0,1,0,1,0.14285714285714285,1,0.0,0,0,0,0,0,0,0,1,0,0,1,1
11279,99018,ifcc4uHfz9c03WKs2R4honhWtRoNdK5d,SpATywNh6bZuzm8s1ceuBUnMUAeoAHHw,4,0,0,0,0,0,4,0,4,0.5714285714285714,1,0.0,0,0,0,0,0,0,0,4,0,0,4,1
11280,99029,qg6GOCuPcDwehPMMAEed7GZuAdyiaV9B,bWdj2GDclj5ofokWjzoa5jAwMkxCykd6,25,77,3,110,9,3,28,5,235,33.57142857142857,12,0.0,30,3,103,9,47,3,7,28,5,145,90,0
11281,99046,O7BkYKGPbSCKVITR1KG0UTtUy6cDdabs,SpATywNh6bZuzm8s1ceuBUnMUAeoAHHw,13,8,5,9,3,0,4,0,29,4.142857142857143,1,0.0,3,5,9,3,5,0,0,4,0,20,9,1
11282,99054,zzAZgy76SGFU6cR6cdB2SgVDsOtIFGEc,SpATywNh6bZuzm8s1ceuBUnMUAeoAHHw,14,28,15,16,3,10,2,0,74,10.571428571428571,1,0.0,7,15,14,3,21,10,2,2,0,39,35,1
11283,99058,84jM92o4oluSWHz68fjJdNU1O5aejzX8,G8EPVSXsOYB5YQWZGiz1aVq5Pgr2GrQu,39,58,9,46,6,2,18,1,140,20.0,7,0.0,6,9,43,6,52,2,3,18,1,64,76,0
11284,99066,T3sGbyIt0UjiteEMsVXGzcCDHseJZwlW,bWdj2GDclj5ofokWjzoa5jAwMkxCykd6,3,0,0,0,0,0,5,0,5,0.7142857142857143,1,0.0,0,0,0,0,0,0,0,5,0,0,5,1
11285,99069,88XDkNH6bI4ALBv7wIako8gqEashqdgA,bWdj2GDclj5ofokWjzoa5jAwMkxCykd6,4,2,0,0,0,0,2,0,4,0.5714285714285714,1,0.0,0,0,0,0,2,0,0,2,0,0,4,1
11286,99070,9e5dcfJQbPUU8sTcmzE9DWoDPOA9Nhu3,RXDvfPUBYFlVdlueBFbLW0mhhAyGEqpt,10,17,1,0,1,0,3,0,22,3.142857142857143,2,0.0,0,1,0,1,17,0,0,3,0,2,20,0
11287,99081,ZC2nAMORm6ACPbodv0ZDapZ3ammrIH2s,G8EPVSXsOYB5YQWZGiz1aVq5Pgr2GrQu,6,1,1,0,1,0,3,0,6,0.8571428571428571,1,0.0,0,1,0,1,1,0,0,3,0,2,4,1
11288,99082,4DxKDIVHzjxY43c2DifDetzvvaumQ2x6,RXDvfPUBYFlVdlueBFbLW0mhhAyGEqpt,8,7,1,0,1,0,1,0,10,1.4285714285714286,1,0.0,0,1,0,1,7,0,0,1,0,2,8,0
11289,99098,obIiPpvlsnw7kahKveiA1IdOjIdBUlWR,bWdj2GDclj5ofokWjzoa5jAwMkxCykd6,4,3,1,0,0,0,3,0,7,1.0,1,0.0,0,1,0,0,3,0,0,3,0,1,6,1
11290,99100,ZMTgNYkbfDsBe4X8ZM8wJYJMTUYSz0bl,SpATywNh6bZuzm8s1ceuBUnMUAeoAHHw,22,35,0,19,0,37,9,4,104,14.857142857142858,3,0.0,11,0,18,0,24,37,1,9,4,29,75,1
11291,99107,r3OdfccxoUjSXp0sWnFk9IAbamqaQLkg,SpATywNh6bZuzm8s1ceuBUnMUAeoAHHw,6,14,0,0,0,0,4,0,18,2.5714285714285716,3,0.0,0,0,0,0,14,0,0,4,0,0,18,1
11292,99118,8P2tXYi4EZDZkbdP0MJKzxjbxyxdg79S,bWdj2GDclj5ofokWjzoa5jAwMkxCykd6,4,2,0,0,0,0,4,0,6,0.8571428571428571,2,0.0,0,0,0,0,2,0,0,4,0,0,6,1
11293,99132,euFeRK4WVq3xP7j8z58Hdv4WK0cZyZNI,RXDvfPUBYFlVdlueBFbLW0mhhAyGEqpt,46,39,25,64,16,7,6,1,158,22.571428571428573,1,0.0,9,25,60,16,30,7,4,6,1,110,48,1
11294,99139,Q8CD0UEUMHAcRhd0KntpUKYo8YWk4fXe,SpATywNh6bZuzm8s1ceuBUnMUAeoAHHw,6,5,0,0,0,0,1,0,6,0.8571428571428571,1,0.0,0,0,0,0,5,0,0,1,0,0,6,1
11295,99174,u8ZjG1mGoKDfAR0qANs0LauHsnuYvByf,SpATywNh6bZuzm8s1ceuBUnMUAeoAHHw,2,0,0,0,0,0,2,0,2,0.2857142857142857,1,0.0,0,0,0,0,0,0,0,2,0,0,2,1
11296,99181,3gKLDpGjwKizSsdfJ1bxm4OzkmE9SSv0,G8EPVSXsOYB5YQWZGiz1aVq5Pgr2GrQu,12,9,5,0,3,0,9,2,28,4.0,2,0.0,1,5,0,3,8,0,0,9,2,9,19,1
11297,99209,cKCzrCCCXe9nkBgWepq9AEXje7SITRTz,RXDvfPUBYFlVdlueBFbLW0mhhAyGEqpt,1,0,0,0,0,0,2,0,2,0.2857142857142857,2,0.0,0,0,0,0,0,0,0,2,0,0,2,1
11298,99238,Sd9iWVuleZqBvt54uADj49zmx7nnkEGd,SpATywNh6bZuzm8s1ceuBUnMUAeoAHHw,7,4,2,0,1,1,7,0,15,2.142857142857143,2,0.0,0,2,0,1,4,1,0,7,0,3,12,1
11299,99239,T0WYTVwYJgFl0x8drZ3acqWyc5rt9vgS,bWdj2GDclj5ofokWjzoa5jAwMkxCykd6,8,6,4,0,3,0,8,0,21,3.0,1,0.0,0,4,0,3,6,0,0,8,0,7,14,1
11300,99253,8i7cvJkHkgdZTPaFAtgMAW0lWMM44P2s,bWdj2GDclj5ofokWjzoa5jAwMkxCykd6,18,25,10,38,0,2,4,0,79,11.285714285714286,2,0.0,10,10,36,0,15,2,2,4,0,56,23,0
11301,99270,CV7h2ez66N3XbcrhHK1a0MSuvaKeLrbg,SpATywNh6bZuzm8s1ceuBUnMUAeoAHHw,4,2,1,0,1,0,1,0,5,0.7142857142857143,1,0.0,0,1,0,1,2,0,0,1,0,2,3,1
11302,99271,Pe5w2Jkb1gsjqOIYHp7FZfmU0KM6bSQ8,SpATywNh6bZuzm8s1ceuBUnMUAeoAHHw,14,19,2,34,0,39,7,0,101,14.428571428571429,3,0.0,11,2,29,0,8,39,5,7,0,42,59,1
11303,99274,F6DWPZmYOtVM9PypQunsAj9fDIO5oqCA,SpATywNh6bZuzm8s1ceuBUnMUAeoAHHw,7,3,1,0,2,0,2,0,8,1.1428571428571428,1,0.0,0,1,0,2,3,0,0,2,0,3,5,1
11304,99278,Zq7w9tMtshfWhXKxO6HgVWaJZugCDD4X,SpATywNh6bZuzm8s1ceuBUnMUAeoAHHw,7,2,0,0,0,0,6,1,9,1.2857142857142858,1,0.0,0,0,0,0,2,0,0,6,1,0,9,1
11305,99281,kLCnsSmz7iq09RICj2W5oj0rePK2t86T,A3fsA9Zfv1X2fVEQhTw51lKENdNrEqT3,7,4,2,0,1,0,5,0,12,1.7142857142857142,2,0.0,0,2,0,1,4,0,0,5,0,3,9,1
11306,99291,kkiueCBXYoPTmt9I3HbEovrMKKFeGu6b,SpATywNh6bZuzm8s1ceuBUnMUAeoAHHw,7,4,3,0,2,0,1,0,10,1.4285714285714286,1,0.0,0,3,0,2,4,0,0,1,0,5,5,1
11307,99301,U77qPrnpSziwcYTMiYVhQDvF7hOqssuP,A3fsA9Zfv1X2fVEQhTw51lKENdNrEqT3,1,0,0,0,0,0,1,0,1,0.14285714285714285,1,0.0,0,0,0,0,0,0,0,1,0,0,1,1
11308,99307,uA8rfZuH0eMveW06zMXRELfenuAEs8xA,RXDvfPUBYFlVdlueBFbLW0mhhAyGEqpt,12,10,8,0,6,0,1,0,25,3.5714285714285716,1,0.0,1,8,0,6,9,0,0,1,0,15,10,1
11309,99308,LtEcnNjG2bVTqyOQr5fGITsmCk6KdvTV,SpATywNh6bZuzm8s1ceuBUnMUAeoAHHw,7,3,2,0,2,0,2,0,9,1.2857142857142858,1,0.0,0,2,0,2,3,0,0,2,0,4,5,1
11310,99311,70RjGajH7pmMAPjzGV9cfLTOEtPaOO7x,bWdj2GDclj5ofokWjzoa5jAwMkxCykd6,4,0,0,0,0,0,5,1,6,0.8571428571428571,1,0.0,0,0,0,0,0,0,0,5,1,0,6,1
11311,99324,zZiKahy0aUh5eIyH06AprK07k6t9S0px,SpATywNh6bZuzm8s1ceuBUnMUAeoAHHw,4,2,0,0,0,0,2,0,4,0.5714285714285714,2,0.0,0,0,0,0,2,0,0,2,0,0,4,1
11312,99328,4lIBX7jVNURqeuVw7y54KWNhg5lYseZ6,bWdj2GDclj5ofokWjzoa5jAwMkxCykd6,10,8,3,0,2,5,7,0,25,3.5714285714285716,3,0.0,0,3,0,2,8,5,0,7,0,5,20,1
11313,99344,JbEjxQ5AsXJ2R3WBH2hwFnQgUiz9YCm1,RXDvfPUBYFlVdlueBFbLW0mhhAyGEqpt,64,182,63,96,41,32,49,6,469,67.0,9,0.0,58,63,88,41,124,32,8,49,6,250,219,0
11314,99347,d03TqUFy5aM2PIFe72rgYScPoI0zjriD,SpATywNh6bZuzm8s1ceuBUnMUAeoAHHw,1,0,0,0,0,0,1,0,1,0.14285714285714285,1,0.0,0,0,0,0,0,0,0,1,0,0,1,1
11315,99352,KQNAn65G00s1hNhpNIZbIlQjdMIvn0te,SpATywNh6bZuzm8s1ceuBUnMUAeoAHHw,3,2,0,0,0,1,2,0,5,0.7142857142857143,1,0.0,0,0,0,0,2,1,0,2,0,0,5,1
11316,99357,dA2znH7Ys1BZ6Ag1jC6siF2XLsfXuatY,G8EPVSXsOYB5YQWZGiz1aVq5Pgr2GrQu,10,12,4,0,4,0,5,0,25,3.5714285714285716,2,0.0,0,4,0,4,12,0,0,5,0,8,17,1
11317,99361,RUkwQN28KywAbYCPf8B2kmvVB4j6glMk,SpATywNh6bZuzm8s1ceuBUnMUAeoAHHw,4,3,0,0,0,0,2,0,5,0.7142857142857143,1,0.0,0,0,0,0,3,0,0,2,0,0,5,1
11318,99362,pUTxXh2GY765KSOGlKRsr8whr66yS2si,SpATywNh6bZuzm8s1ceuBUnMUAeoAHHw,6,3,1,0,1,0,2,0,7,1.0,1,0.0,0,1,0,1,3,0,0,2,0,2,5,1
11319,99367,7j1Qy60pQmlvQ7Dqk2iUN3aMOz565Svk,SpATywNh6bZuzm8s1ceuBUnMUAeoAHHw,10,7,4,0,3,0,5,0,19,2.7142857142857144,3,0.0,1,4,0,3,6,0,0,5,0,8,11,1
11320,99368,7M1gTpajHgYWFRBJBTE3YPlAjNYb9gfx,SpATywNh6bZuzm8s1ceuBUnMUAeoAHHw,1,0,0,0,0,0,1,0,1,0.14285714285714285,1,0.0,0,0,0,0,0,0,0,1,0,0,1,1
11321,99369,qW9QfVksexOjxQBoakOZ3N1wOwk2Uoq3,SpATywNh6bZuzm8s1ceuBUnMUAeoAHHw,4,2,0,0,0,0,4,0,6,0.8571428571428571,1,0.0,0,0,0,0,2,0,0,4,0,0,6,1
11322,99379,0DbC5JilnobJmMMZ806aDGvS966g1ymK,SpATywNh6bZuzm8s1ceuBUnMUAeoAHHw,5,3,1,0,1,1,2,0,8,1.1428571428571428,1,0.0,0,1,0,1,3,1,0,2,0,2,6,1
11323,99380,0DbC5JilnobJmMMZ806aDGvS966g1ymK,G8EPVSXsOYB5YQWZGiz1aVq5Pgr2GrQu,1,0,0,0,0,0,1,0,1,0.14285714285714285,1,0.0,0,0,0,0,0,0,0,1,0,0,1,1
11324,99395,kKVwpcRVIoBHXwQJxUscCmJVsObHmuic,SpATywNh6bZuzm8s1ceuBUnMUAeoAHHw,11,6,4,0,3,0,5,1,19,2.7142857142857144,1,0.0,0,4,0,3,6,0,0,5,1,7,12,1
11325,99410,RrZI3LBwWWMML70TBgENRap2pJnz1WcI,G8EPVSXsOYB5YQWZGiz1aVq5Pgr2GrQu,7,8,2,0,3,0,3,0,16,2.2857142857142856,1,0.0,4,2,0,3,4,0,0,3,0,9,7,1
11326,99419,CIojvdkZCguBWuN7246vWmUJ6qBNp7JQ,RXDvfPUBYFlVdlueBFbLW0mhhAyGEqpt,66,68,27,118,20,5,10,1,249,35.57142857142857,3,0.0,29,27,115,20,39,5,3,10,1,191,58,1
11327,99429,Og1p6VqqK505SKTAg7oggM1PpCX9htgK,bWdj2GDclj5ofokWjzoa5jAwMkxCykd6,2,0,0,0,0,0,2,0,2,0.2857142857142857,1,0.0,0,0,0,0,0,0,0,2,0,0,2,1
11328,99436,rPmua3xrnLtgdU4TZGq8z4hoSz54twnz,RXDvfPUBYFlVdlueBFbLW0mhhAyGEqpt,2,0,0,0,0,0,2,0,2,0.2857142857142857,1,0.0,0,0,0,0,0,0,0,2,0,0,2,1
11329,99458,XKiESHLmmxxFLSNhNTicMKXZo07ga8rR,SpATywNh6bZuzm8s1ceuBUnMUAeoAHHw,17,21,6,27,3,5,9,1,72,10.285714285714286,1,0.0,12,6,22,3,9,5,5,9,1,43,29,1
11330,99460,x0kuyWECJARUGYUkf8OBmp3NS07aeieW,SpATywNh6bZuzm8s1ceuBUnMUAeoAHHw,22,32,7,30,5,19,8,1,102,14.571428571428571,2,0.0,13,7,25,5,19,19,5,8,1,50,52,1
11331,99465,dDLv4oouOmVB45Y4hnRyV7IUqT7tMKiq,RXDvfPUBYFlVdlueBFbLW0mhhAyGEqpt,5,4,2,0,1,2,2,0,11,1.5714285714285714,1,0.0,0,2,0,1,4,2,0,2,0,3,8,1
11332,99476,H1SXscwZbeBIGdJtjznbLlFWKEefKgS4,bWdj2GDclj5ofokWjzoa5jAwMkxCykd6,1,0,0,0,0,0,1,0,1,0.14285714285714285,1,0.0,0,0,0,0,0,0,0,1,0,0,1,1
11333,99482,YLgIjYna0b19CObH0aixdNFVjkWguI8z,SpATywNh6bZuzm8s1ceuBUnMUAeoAHHw,6,3,1,0,1,0,2,0,7,1.0,1,0.0,0,1,0,1,3,0,0,2,0,2,5,1
11334,99499,nazeZS8BdRMOGGuVriyb5M21Pn5Qng36,RXDvfPUBYFlVdlueBFbLW0mhhAyGEqpt,2,0,0,0,0,0,5,0,5,0.7142857142857143,3,0.0,0,0,0,0,0,0,0,5,0,0,5,1
11335,99504,F6k3M4cXPmDcGMYwz4MYjROjPe1tP3Ym,SpATywNh6bZuzm8s1ceuBUnMUAeoAHHw,2,0,0,0,0,0,2,0,2,0.2857142857142857,1,0.0,0,0,0,0,0,0,0,2,0,0,2,1
11336,99519,qsSi1uSJyI5PyAmcKOuOd3i9fMbo7Kcq,SpATywNh6bZuzm8s1ceuBUnMUAeoAHHw,18,35,4,4,3,10,15,6,77,11.0,2,0.0,0,4,3,3,35,10,1,15,6,10,67,1
11337,99523,tItJmM8DSrsR2C4SUW6G90kGTH9CET7i,A3fsA9Zfv1X2fVEQhTw51lKENdNrEqT3,1,0,0,0,0,0,1,0,1,0.14285714285714285,1,0.0,0,0,0,0,0,0,0,1,0,0,1,1
11338,99528,9HLdaHmr6CL0Qkr0yUtrnxT1uvy3iohQ,G8EPVSXsOYB5YQWZGiz1aVq5Pgr2GrQu,4,4,2,0,0,2,3,0,11,1.5714285714285714,1,0.0,0,2,0,0,4,2,0,3,0,2,9,1
11339,99538,aApTNsNL5V8p77KfIZfCDf8PLQlY5mEZ,RXDvfPUBYFlVdlueBFbLW0mhhAyGEqpt,10,5,4,0,3,0,2,0,14,2.0,1,0.0,0,4,0,3,5,0,0,2,0,7,7,1
11340,99544,VMv3kIqXbjzzweiSaOh7btZJMGqiha14,SpATywNh6bZuzm8s1ceuBUnMUAeoAHHw,8,5,3,0,2,0,4,0,14,2.0,2,0.0,0,3,0,2,5,0,0,4,0,5,9,1
11341,99548,hbUthRcRktel8CTk5FJE2GFw0tsGaPJX,SpATywNh6bZuzm8s1ceuBUnMUAeoAHHw,8,10,1,0,0,0,7,1,19,2.7142857142857144,3,0.0,2,1,0,0,8,0,0,7,1,3,16,1
11342,99553,B48liWLvGTFhxmScNtRccVTYMrDSRz6T,SpATywNh6bZuzm8s1ceuBUnMUAeoAHHw,11,30,0,17,0,9,6,0,62,8.857142857142858,1,0.0,15,0,16,0,15,9,1,6,0,31,31,1
11343,99559,UvQp4bR98Xn1uwzsk2XfrzaGsOC8PbwE,SpATywNh6bZuzm8s1ceuBUnMUAeoAHHw,13,10,4,16,3,0,2,0,35,5.0,1,0.0,4,4,14,3,6,0,2,2,0,25,10,1
11344,99570,K9rvD8Iu0wq956P4CDD0WYKLX5TfMvJ0,G8EPVSXsOYB5YQWZGiz1aVq5Pgr2GrQu,1,0,0,0,0,0,1,0,1,0.14285714285714285,1,0.0,0,0,0,0,0,0,0,1,0,0,1,1
11345,99582,pJZjfxkmSUcLjysKXGMvcQJcdn3Lfmps,G8EPVSXsOYB5YQWZGiz1aVq5Pgr2GrQu,9,21,1,4,4,0,4,1,35,5.0,1,0.0,15,1,2,4,6,0,2,4,1,22,13,1
11346,99585,MsXQVdqX93JlyFfWTzQyZnJZn8bWw73p,G8EPVSXsOYB5YQWZGiz1aVq5Pgr2GrQu,1,0,0,0,0,0,1,0,1,0.14285714285714285,1,0.0,0,0,0,0,0,0,0,1,0,0,1,1
11347,99589,X2tBPTLsKr1PUmH63wCYNuKDkAG71YDY,SpATywNh6bZuzm8s1ceuBUnMUAeoAHHw,2,0,0,0,0,0,2,0,2,0.2857142857142857,1,0.0,0,0,0,0,0,0,0,2,0,0,2,1
11348,99591,X2tBPTLsKr1PUmH63wCYNuKDkAG71YDY,bWdj2GDclj5ofokWjzoa5jAwMkxCykd6,2,0,0,0,0,0,2,0,2,0.2857142857142857,1,0.0,0,0,0,0,0,0,0,2,0,0,2,1
11349,99624,eeYgUeHIQERDYwF1mxwVIZYsVaVSgwlV,RXDvfPUBYFlVdlueBFbLW0mhhAyGEqpt,1,0,0,0,0,0,1,0,1,0.14285714285714285,1,0.0,0,0,0,0,0,0,0,1,0,0,1,1
11350,99632,XcU2XTxeLZ8F89uBFmVFyW4cnWhjcEiA,SpATywNh6bZuzm8s1ceuBUnMUAeoAHHw,17,21,10,9,7,5,5,0,57,8.142857142857142,3,0.0,5,10,9,7,16,5,0,5,0,31,26,1
11351,99634,iKW0Nip3dgY8YRgutfX9HfgsuYc5FITi,SpATywNh6bZuzm8s1ceuBUnMUAeoAHHw,16,16,9,15,6,3,6,0,55,7.857142857142857,1,0.0,4,9,14,6,12,3,1,6,0,33,22,1
11352,99638,KfP7DqXlruQE3Tc1dgUq6GzZBbeDyO72,SpATywNh6bZuzm8s1ceuBUnMUAeoAHHw,6,7,2,0,1,1,2,0,13,1.8571428571428572,1,0.0,0,2,0,1,7,1,0,2,0,3,10,1
11353,99639,HdhmGphCRXsQFbeFhgLmEJAXmcjxk1qH,G8EPVSXsOYB5YQWZGiz1aVq5Pgr2GrQu,1,0,0,0,0,0,2,0,2,0.2857142857142857,2,0.0,0,0,0,0,0,0,0,2,0,0,2,1
11354,99653,2ENDZhPlfPQ7xqwHjrfLuuWg5Duw7ZBj,SpATywNh6bZuzm8s1ceuBUnMUAeoAHHw,43,83,38,25,18,1,20,1,186,26.571428571428573,8,0.0,8,38,25,18,75,1,0,20,1,89,97,0
11355,99654,uA8rfZuH0eMveW06zMXRELfenuAEs8xA,A3fsA9Zfv1X2fVEQhTw51lKENdNrEqT3,1,0,0,0,0,0,1,0,1,0.14285714285714285,1,0.0,0,0,0,0,0,0,0,1,0,0,1,1
11356,99667,yUFGaXV6e729cAx9t4iOfoMO0XzOm9Tn,SpATywNh6bZuzm8s1ceuBUnMUAeoAHHw,5,3,2,0,1,0,1,0,7,1.0,1,0.0,0,2,0,1,3,0,0,1,0,3,4,1
11357,99671,KbnH0sTIlztrZBuSXZduD8Hjf6pJFDbi,G8EPVSXsOYB5YQWZGiz1aVq5Pgr2GrQu,6,2,1,0,1,0,3,0,7,1.0,1,0.0,0,1,0,1,2,0,0,3,0,2,5,1
11358,99693,1poMA1x0qhCnYBPVsxm5CInRDHfF8Q0k,SpATywNh6bZuzm8s1ceuBUnMUAeoAHHw,10,12,8,0,4,2,15,3,44,6.285714285714286,1,0.0,0,8,0,4,12,2,0,15,3,12,32,1
11359,99715,xg8dkQPzve0MzcpgxvEsbKyY4VwKrxAC,G8EPVSXsOYB5YQWZGiz1aVq5Pgr2GrQu,1,0,0,0,0,0,1,0,1,0.14285714285714285,1,0.0,0,0,0,0,0,0,0,1,0,0,1,1
11360,99717,0b1xMc7vBqRRfJj4HArRLbAJZWV8VISr,RXDvfPUBYFlVdlueBFbLW0mhhAyGEqpt,1,0,0,0,0,0,1,0,1,0.14285714285714285,1,0.0,0,0,0,0,0,0,0,1,0,0,1,1
11361,99728,507IdnNFIDoiPRr88JDQa6OplkPcxI18,G8EPVSXsOYB5YQWZGiz1aVq5Pgr2GrQu,1,0,0,0,0,0,1,0,1,0.14285714285714285,1,0.0,0,0,0,0,0,0,0,1,0,0,1,1
11362,99747,SH3THvT9ATqMny80GD63EuK5GGnf8XMU,bWdj2GDclj5ofokWjzoa5jAwMkxCykd6,4,3,0,0,0,3,6,0,12,1.7142857142857142,3,0.0,0,0,0,0,3,3,0,6,0,0,12,1
11363,99752,v8s2hAX8tQgFD6i9MrUt2cuWPYPq3DuN,G8EPVSXsOYB5YQWZGiz1aVq5Pgr2GrQu,15,17,10,22,3,0,6,0,58,8.285714285714286,5,0.0,1,10,20,3,16,0,2,6,0,34,24,0
11364,99758,q5R81Yw8uRP3FrwNvV49L9qc5ag0j7J9,A3fsA9Zfv1X2fVEQhTw51lKENdNrEqT3,1,0,0,0,0,0,1,0,1,0.14285714285714285,1,0.0,0,0,0,0,0,0,0,1,0,0,1,1
11365,99759,LgCMqz3FdP5FVzPuiAaae1dvV0Dou3Op,SpATywNh6bZuzm8s1ceuBUnMUAeoAHHw,7,3,2,0,2,0,2,0,9,1.2857142857142858,1,0.0,0,2,0,2,3,0,0,2,0,4,5,1
11366,99785,oNDKvCCMv3YHycTSYSxE4vCb7yy2VCwV,SpATywNh6bZuzm8s1ceuBUnMUAeoAHHw,10,3,2,0,2,7,5,1,20,2.857142857142857,1,0.0,0,2,0,2,3,7,0,5,1,4,16,1
11367,99798,t84V1IZRpqwPOLkIILsxQF8RqF1exsFD,SpATywNh6bZuzm8s1ceuBUnMUAeoAHHw,4,2,1,0,0,0,2,0,5,0.7142857142857143,1,0.0,0,1,0,0,2,0,0,2,0,1,4,1
11368,99810,E5f5bNHHVwXdE8xNDAy656AeEbGGB2sd,SpATywNh6bZuzm8s1ceuBUnMUAeoAHHw,11,43,3,27,2,0,3,0,78,11.142857142857142,2,0.0,30,3,23,2,13,0,4,3,0,58,20,1
11369,99812,ZDVmuYiPoGm0gu1bR2BaE1soF6dU5v1W,bWdj2GDclj5ofokWjzoa5jAwMkxCykd6,6,12,6,14,0,2,6,0,40,5.714285714285714,1,0.0,4,6,14,0,8,2,0,6,0,24,16,1
11370,99813,7aA6BrVZipLHOrozlrYBMEmfMq4MXahq,A3fsA9Zfv1X2fVEQhTw51lKENdNrEqT3,1,0,0,0,0,0,1,0,1,0.14285714285714285,1,0.0,0,0,0,0,0,0,0,1,0,0,1,1
11371,99817,TJwArXyryXs3RiLiYIGaN8bFGgjvPLws,SpATywNh6bZuzm8s1ceuBUnMUAeoAHHw,4,2,1,0,1,0,2,0,6,0.8571428571428571,1,0.0,0,1,0,1,2,0,0,2,0,2,4,1
11372,99819,GjfzOWel7UtLS6b5EULEaoKkW3os5vHa,SpATywNh6bZuzm8s1ceuBUnMUAeoAHHw,5,2,1,0,1,0,3,0,7,1.0,1,0.0,0,1,0,1,2,0,0,3,0,2,5,1
11373,99822,mb36VuCvp1Z6gW8mqkNElCgDYgcBIF3z,SpATywNh6bZuzm8s1ceuBUnMUAeoAHHw,7,11,8,0,6,0,3,0,28,4.0,1,0.0,0,8,0,6,11,0,0,3,0,14,14,1
11374,99831,Jzdxwa4kNVDonbh32Q542LfZRfsA4OPw,SpATywNh6bZuzm8s1ceuBUnMUAeoAHHw,8,3,2,0,2,1,4,0,12,1.7142857142857142,1,0.0,0,2,0,2,3,1,0,4,0,4,8,1
11375,99839,TdfXOtlNb7Av3MtzwkldFOrTHIZeitdz,SpATywNh6bZuzm8s1ceuBUnMUAeoAHHw,18,41,23,11,11,3,14,0,103,14.714285714285714,5,0.0,1,23,10,11,40,3,1,14,0,45,58,0
11376,99840,eVv8K2gdE5SVTmPw9MARDIRZSaYqMHSQ,SpATywNh6bZuzm8s1ceuBUnMUAeoAHHw,11,9,0,10,0,0,3,2,24,3.4285714285714284,1,0.0,2,0,9,0,7,0,1,3,2,11,13,1
11377,99843,oNDKvCCMv3YHycTSYSxE4vCb7yy2VCwV,RXDvfPUBYFlVdlueBFbLW0mhhAyGEqpt,9,5,4,0,4,0,4,0,17,2.4285714285714284,1,0.0,0,4,0,4,5,0,0,4,0,8,9,1
11378,99866,7aA6BrVZipLHOrozlrYBMEmfMq4MXahq,bWdj2GDclj5ofokWjzoa5jAwMkxCykd6,1,0,0,0,0,0,1,0,1,0.14285714285714285,1,0.0,0,0,0,0,0,0,0,1,0,0,1,1
11379,99879,6ACUaz471Pn1fnrZDeY9K0EfEHUBtjpk,SpATywNh6bZuzm8s1ceuBUnMUAeoAHHw,17,11,6,17,3,24,13,3,77,11.0,1,0.0,2,6,15,3,9,24,2,13,3,26,51,1
11380,99883,CFvk4wjTMYl1iJidR1XmhJBW4azBqofZ,SpATywNh6bZuzm8s1ceuBUnMUAeoAHHw,6,3,1,0,1,0,4,0,9,1.2857142857142858,1,0.0,0,1,0,1,3,0,0,4,0,2,7,1
11381,99891,cNOMlpfCFQuhn4NfuqDzr2Vocotv36oU,A3fsA9Zfv1X2fVEQhTw51lKENdNrEqT3,1,0,0,0,0,0,1,0,1,0.14285714285714285,1,0.0,0,0,0,0,0,0,0,1,0,0,1,1
11382,99892,DDOsm4qYmwEA6E1tTBXPjk0uhAES8TZ9,SpATywNh6bZuzm8s1ceuBUnMUAeoAHHw,9,7,3,3,2,0,2,0,17,2.4285714285714284,1,0.0,3,3,3,2,4,0,0,2,0,11,6,1
11383,99895,sRTon1VBBuP0uvdQE1lWLIce29YVBv8J,SpATywNh6bZuzm8s1ceuBUnMUAeoAHHw,13,19,0,11,0,4,8,0,42,6.0,2,0.0,6,0,10,0,13,4,1,8,0,16,26,1
11384,99900,90Ea96jYOrWvumropceyEFhiPsTvKfzf,bWdj2GDclj5ofokWjzoa5jAwMkxCykd6,8,4,0,0,0,1,4,1,10,1.4285714285714286,1,0.0,0,0,0,0,4,1,0,4,1,0,10,1
11385,99902,Fio0BW8a5yrv46EIdUqSrGYnBJXNuvAc,G8EPVSXsOYB5YQWZGiz1aVq5Pgr2GrQu,1,0,0,0,0,0,1,0,1,0.14285714285714285,1,0.0,0,0,0,0,0,0,0,1,0,0,1,1
11386,99905,GR0IZ8RAROGoO8dlKHQecnjtd4J4CV8E,SpATywNh6bZuzm8s1ceuBUnMUAeoAHHw,7,4,3,0,3,0,2,0,12,1.7142857142857142,1,0.0,0,3,0,3,4,0,0,2,0,6,6,1
11387,99908,Wlz3wRUCGZdxuPjJRKNKqt34F0pjoQUU,SpATywNh6bZuzm8s1ceuBUnMUAeoAHHw,5,3,0,0,0,0,2,0,5,0.7142857142857143,1,0.0,0,0,0,0,3,0,0,2,0,0,5,1
11388,99910,T0V1MC6bsX3mZxJfTJfqpva6BwB6iZOI,SpATywNh6bZuzm8s1ceuBUnMUAeoAHHw,5,3,2,0,2,0,2,0,9,1.2857142857142858,1,0.0,0,2,0,2,3,0,0,2,0,4,5,1
11389,99919,bzlTCtIUcO5BfACSIQwT3PRYSdK0QGTr,bWdj2GDclj5ofokWjzoa5jAwMkxCykd6,5,2,1,0,1,0,3,0,7,1.0,2,0.0,0,1,0,1,2,0,0,3,0,2,5,1
11390,99924,s22y3yJL9OZAJbywe5kehjyeI57l8QWk,SpATywNh6bZuzm8s1ceuBUnMUAeoAHHw,1,0,0,0,0,0,2,0,2,0.2857142857142857,1,0.0,0,0,0,0,0,0,0,2,0,0,2,1
11391,99933,grGzcyT8HhVfjhYhmvwa7hRZvpxVILf7,SpATywNh6bZuzm8s1ceuBUnMUAeoAHHw,12,19,5,15,4,0,1,0,44,6.285714285714286,1,0.0,13,5,14,4,6,0,1,1,0,36,8,1
11392,99936,Oi7Qhc5WNxKsxx530z6SWxDXUzxiC0Iw,G8EPVSXsOYB5YQWZGiz1aVq5Pgr2GrQu,10,15,1,0,2,0,9,0,27,3.857142857142857,2,0.0,8,1,0,2,7,0,0,9,0,11,16,0
11393,99937,cnsyUcQdXkjXAZu2LRhrO31c8mThrNUr,SpATywNh6bZuzm8s1ceuBUnMUAeoAHHw,13,11,5,20,2,0,4,0,42,6.0,2,0.0,2,5,16,2,9,0,4,4,0,25,17,1
11394,99947,IZ16dnDzM5qLtyHLu3aaKf2eiaAGYSGA,SpATywNh6bZuzm8s1ceuBUnMUAeoAHHw,1,0,0,0,0,0,1,0,1,0.14285714285714285,1,0.0,0,0,0,0,0,0,0,1,0,0,1,1
11395,99956,JncF0A6NLmySeUG55ffbMgtwYs8JPP1N,bWdj2GDclj5ofokWjzoa5jAwMkxCykd6,2,0,0,0,0,0,2,0,2,0.2857142857142857,1,0.0,0,0,0,0,0,0,0,2,0,0,2,1
11396,99986,4dUaGH7iXRv1eQLzCgjayv9tRaG807lp,SpATywNh6bZuzm8s1ceuBUnMUAeoAHHw,12,9,6,16,3,0,1,0,35,5.0,1,0.0,2,6,13,3,7,0,3,1,0,24,11,1
11397,99990,BY7rZbvKNAuIQddu3IMUH8CKbKBlCl4t,SpATywNh6bZuzm8s1ceuBUnMUAeoAHHw,16,47,25,17,8,6,15,1,119,17.0,4,0.0,6,25,14,8,41,6,3,15,1,53,66,0
11398,99994,25I3ZHC2CKPuZdwEsDJVb3ivMmenYIrh,SpATywNh6bZuzm8s1ceuBUnMUAeoAHHw,1,0,0,0,0,0,1,0,1,0.14285714285714285,1,0.0,0,0,0,0,0,0,0,1,0,0,1,1
11399,99997,DtHgKVPDhIQdcn9LoDGSbijzl93Gk2jn,SpATywNh6bZuzm8s1ceuBUnMUAeoAHHw,6,3,1,0,1,0,2,0,7,1.0,1,0.0,0,1,0,1,3,0,0,2,0,2,5,1
11400,99999,6sN2V3D1BSB8BILaihUzYoUSAATbUImJ,G8EPVSXsOYB5YQWZGiz1aVq5Pgr2GrQu,2,0,0,0,0,0,2,0,2,0.2857142857142857,1,0.0,0,0,0,0,0,0,0,2,0,0,2,1
11401,100015,kVQgvZQEECWcBpDBfOHSkyukPIRvJ5sY,RXDvfPUBYFlVdlueBFbLW0mhhAyGEqpt,1,0,0,0,0,0,1,0,1,0.14285714285714285,1,0.0,0,0,0,0,0,0,0,1,0,0,1,1
11402,100024,yIWuZECPMnNHsT4nnuxaCnrNgzyFmEU4,SpATywNh6bZuzm8s1ceuBUnMUAeoAHHw,12,9,1,13,0,0,6,0,29,4.142857142857143,2,0.0,2,1,11,0,7,0,2,6,0,14,15,1
11403,100027,lVpMvFJQUkBRc5QzVKlkj16QaA3takHv,G8EPVSXsOYB5YQWZGiz1aVq5Pgr2GrQu,20,10,6,42,3,5,4,0,70,10.0,1,0.0,3,6,34,3,7,5,8,4,0,46,24,0
11404,100028,AMKNyvONM5p8NpA87JkQdxEGdnEv8UBc,SpATywNh6bZuzm8s1ceuBUnMUAeoAHHw,14,16,3,20,1,11,12,4,67,9.571428571428571,3,0.0,2,3,17,1,14,11,3,12,4,23,44,1
11405,100034,UO4K287BxB8BWqN4Vsyelgc9IxlYK4Tg,SpATywNh6bZuzm8s1ceuBUnMUAeoAHHw,13,8,5,12,4,0,2,0,31,4.428571428571429,1,0.0,2,5,12,4,6,0,0,2,0,23,8,1
11406,100036,drecLIVL8lECR1fdFh4q87LPP9hTNU3f,SpATywNh6bZuzm8s1ceuBUnMUAeoAHHw,5,2,1,0,1,0,2,0,6,0.8571428571428571,1,0.0,0,1,0,1,2,0,0,2,0,2,4,1
11407,100061,wSHJOUrC5HDoRV04dRmaj6jhdM6NYaj6,RXDvfPUBYFlVdlueBFbLW0mhhAyGEqpt,17,26,16,0,9,1,12,0,64,9.142857142857142,1,0.0,0,16,0,9,26,1,0,12,0,25,39,1
11408,100063,ZmILkESSKwaUf7dlv2MYezsPM9kEgn0g,bWdj2GDclj5ofokWjzoa5jAwMkxCykd6,1,0,0,0,0,0,1,0,1,0.14285714285714285,1,0.0,0,0,0,0,0,0,0,1,0,0,1,1
11409,100072,GCBiFXC2EhwXYwz6gh8rDQT1ItPzfReO,SpATywNh6bZuzm8s1ceuBUnMUAeoAHHw,1,0,0,0,0,0,1,0,1,0.14285714285714285,1,0.0,0,0,0,0,0,0,0,1,0,0,1,1
11410,100101,7BLSB26pFgDMSTV4x8nY66FLFZIw20Ig,bWdj2GDclj5ofokWjzoa5jAwMkxCykd6,8,9,1,0,2,0,6,0,18,2.5714285714285716,2,0.0,4,1,0,2,5,0,0,6,0,7,11,1
11411,100118,e0PSviaCUv7g6edvYkj3Wxxy57eyFNfw,G8EPVSXsOYB5YQWZGiz1aVq5Pgr2GrQu,8,6,4,0,3,0,3,0,16,2.2857142857142856,1,0.0,0,4,0,3,6,0,0,3,0,7,9,1
11412,100121,zDkFthLb8QiYlJN46xEgukiHh2xvNh17,SpATywNh6bZuzm8s1ceuBUnMUAeoAHHw,12,8,4,4,6,24,5,0,51,7.285714285714286,1,0.0,0,4,4,6,8,24,0,5,0,14,37,1
11413,100126,92FUTIKpJKurgJxPcqboELrIlwQuRnws,SpATywNh6bZuzm8s1ceuBUnMUAeoAHHw,4,2,1,0,1,0,3,0,7,1.0,1,0.0,0,1,0,1,2,0,0,3,0,2,5,1
11414,100128,sQN6Ivaey7nQA0xFHZwWETnwBmEDP3C4,bWdj2GDclj5ofokWjzoa5jAwMkxCykd6,1,0,0,0,0,0,1,0,1,0.14285714285714285,1,0.0,0,0,0,0,0,0,0,1,0,0,1,1
11415,100129,UKq5lhvAp06ZhcbYGirhBoJurTHlyP25,SpATywNh6bZuzm8s1ceuBUnMUAeoAHHw,4,2,1,0,0,0,3,0,6,0.8571428571428571,1,0.0,0,1,0,0,2,0,0,3,0,1,5,0
11416,100132,zhtf7EZUjW6s3Guz5lXD8KDXJ4lw9cuB,SpATywNh6bZuzm8s1ceuBUnMUAeoAHHw,27,30,20,18,11,0,7,0,86,12.285714285714286,3,0.0,7,20,17,11,23,0,1,7,0,55,31,0
11417,100141,OMeQBd65CGlFdF9LPjtleDAWNG4SlWp3,SpATywNh6bZuzm8s1ceuBUnMUAeoAHHw,24,65,18,27,8,24,10,1,153,21.857142857142858,3,0.0,27,18,21,8,38,24,6,10,1,74,79,1
11418,100153,3ZBkeExde7b5snRqlcNlkhznPWJKIR4u,SpATywNh6bZuzm8s1ceuBUnMUAeoAHHw,3,2,0,0,0,0,1,0,3,0.42857142857142855,1,0.0,0,0,0,0,2,0,0,1,0,0,3,1
11419,100197,7VYsu22xA0behvNW5V0HO7suqw3RpS8G,A3fsA9Zfv1X2fVEQhTw51lKENdNrEqT3,1,0,0,0,0,0,1,0,1,0.14285714285714285,1,0.0,0,0,0,0,0,0,0,1,0,0,1,1
11420,100212,2bZFunHMPmr3ZtiaHMdXxkvbsb400BRF,bWdj2GDclj5ofokWjzoa5jAwMkxCykd6,7,2,1,0,1,0,5,1,10,1.4285714285714286,2,0.0,0,1,0,1,2,0,0,5,1,2,8,1
11421,100234,mV6vIHBrgth3lTaajvzuqQeEfK5qY5yY,SpATywNh6bZuzm8s1ceuBUnMUAeoAHHw,14,26,3,19,2,0,4,0,54,7.714285714285714,2,0.0,6,3,16,2,20,0,3,4,0,27,27,1
11422,100242,pOVkDtM2cW4XWonAB3isY5WCbnNkYAIp,G8EPVSXsOYB5YQWZGiz1aVq5Pgr2GrQu,12,38,2,30,5,1,6,1,83,11.857142857142858,1,0.0,21,2,21,5,17,1,9,6,1,49,34,0
11423,100248,YNyEESXbqSWkVhYDWRBMKhf7B8RI9hCb,SpATywNh6bZuzm8s1ceuBUnMUAeoAHHw,9,9,1,0,1,0,9,0,20,2.857142857142857,2,0.0,0,1,0,1,9,0,0,9,0,2,18,1
11424,100250,TciQEzJA4hKxeo0Ve5JLByGDZHpNx3uy,RXDvfPUBYFlVdlueBFbLW0mhhAyGEqpt,1,0,0,0,0,0,1,0,1,0.14285714285714285,1,0.0,0,0,0,0,0,0,0,1,0,0,1,1
11425,100254,qNh1HmZZ5IODkL9bGcGUg3xnGvE9VrLH,A3fsA9Zfv1X2fVEQhTw51lKENdNrEqT3,1,0,0,0,0,0,1,0,1,0.14285714285714285,1,0.0,0,0,0,0,0,0,0,1,0,0,1,1
11426,100255,CyLrnwOuvkEKQhwjogaYhZvzxTeqKBge,bWdj2GDclj5ofokWjzoa5jAwMkxCykd6,1,0,0,0,0,0,1,0,1,0.14285714285714285,1,0.0,0,0,0,0,0,0,0,1,0,0,1,1
11427,100259,c2Q5B1aYF1KkI9v6dRXIUSAa5DOcN20a,SpATywNh6bZuzm8s1ceuBUnMUAeoAHHw,1,0,0,0,0,0,1,0,1,0.14285714285714285,1,0.0,0,0,0,0,0,0,0,1,0,0,1,1
11428,100274,psBmoUfd8F19brtdh1bZTLzNbdOCOBdc,G8EPVSXsOYB5YQWZGiz1aVq5Pgr2GrQu,12,5,4,0,4,1,5,1,20,2.857142857142857,1,0.0,0,4,0,4,5,1,0,5,1,8,12,1
11429,100279,KyiebHDxme4fhoxffRK8u4aC4pCnnodx,RXDvfPUBYFlVdlueBFbLW0mhhAyGEqpt,7,9,1,0,1,0,3,0,14,2.0,2,0.0,0,1,0,1,9,0,0,3,0,2,12,1
11430,100283,RqdDZ59hZyptwdavZ7BebY7MyinitbUb,RXDvfPUBYFlVdlueBFbLW0mhhAyGEqpt,18,17,2,28,2,6,5,1,61,8.714285714285714,2,0.0,2,2,26,2,15,6,2,5,1,32,29,1
11431,100306,mSmEv1ySOfyHPKXATZwYWxeWIR1bOlzf,A3fsA9Zfv1X2fVEQhTw51lKENdNrEqT3,1,0,0,0,0,0,1,0,1,0.14285714285714285,1,0.0,0,0,0,0,0,0,0,1,0,0,1,1
11432,100316,zOam8QEm9OnWecRZGQt83gQL3mhsAeeZ,bWdj2GDclj5ofokWjzoa5jAwMkxCykd6,3,0,0,0,0,0,3,0,3,0.42857142857142855,1,0.0,0,0,0,0,0,0,0,3,0,0,3,1
11433,100317,jHFndzgHWJwhCt25LmxPZ3zqNFqlRdEb,A3fsA9Zfv1X2fVEQhTw51lKENdNrEqT3,7,3,2,0,2,0,2,0,9,1.2857142857142858,2,0.0,0,2,0,2,3,0,0,2,0,4,5,1
11434,100327,wrKMasi8LNygKef8piFZGi3m3QxjccZE,bWdj2GDclj5ofokWjzoa5jAwMkxCykd6,4,2,1,0,1,0,1,0,5,0.7142857142857143,1,0.0,0,1,0,1,2,0,0,1,0,2,3,1
11435,100328,KgI1c7voNVzVIvjs4ZhktR8A7fWkMDoW,SpATywNh6bZuzm8s1ceuBUnMUAeoAHHw,1,0,0,0,0,0,1,0,1,0.14285714285714285,1,0.0,0,0,0,0,0,0,0,1,0,0,1,1
11436,100330,XIlz5QvnlEzidDqYGld3VSh8CaOyBXAa,bWdj2GDclj5ofokWjzoa5jAwMkxCykd6,1,0,0,0,0,0,1,0,1,0.14285714285714285,1,0.0,0,0,0,0,0,0,0,1,0,0,1,1
11437,100338,ZtkS0KlWCGCzlEANBJ5GgCPzAAljBHVt,bWdj2GDclj5ofokWjzoa5jAwMkxCykd6,10,8,4,10,4,0,4,0,30,4.285714285714286,2,0.0,2,4,10,4,6,0,0,4,0,20,10,1
11438,100373,7rPiBqfbPQeCxCiqXyPinFDIqFEPCizE,SpATywNh6bZuzm8s1ceuBUnMUAeoAHHw,4,2,1,0,0,0,2,0,5,0.7142857142857143,1,0.0,0,1,0,0,2,0,0,2,0,1,4,1
11439,100377,MlHPKmdi90dDdvX24jYoFlYEp8xS4RGn,SpATywNh6bZuzm8s1ceuBUnMUAeoAHHw,13,32,14,0,8,3,7,0,64,9.142857142857142,4,0.0,2,14,0,8,30,3,0,7,0,24,40,0
11440,100383,CgW6eb6Uo35foWi9RCL2029DF7zH5e88,SpATywNh6bZuzm8s1ceuBUnMUAeoAHHw,7,2,1,0,1,1,7,1,13,1.8571428571428572,2,0.0,0,1,0,1,2,1,0,7,1,2,11,1
11441,100384,FMxvsapRPXXXNxGG3GDsHR7zl4E2ofKu,bWdj2GDclj5ofokWjzoa5jAwMkxCykd6,2,0,0,0,0,0,2,0,2,0.2857142857142857,1,0.0,0,0,0,0,0,0,0,2,0,0,2,1
11442,100388,2JB50R0jD3NibtfXa92f6mpF735lk1Oo,SpATywNh6bZuzm8s1ceuBUnMUAeoAHHw,13,10,6,16,3,0,1,0,36,5.142857142857143,1,0.0,2,6,14,3,8,0,2,1,0,25,11,1
11443,100391,kyGh4gel5GTGb41pTkpUlnRTMKLiWXKA,G8EPVSXsOYB5YQWZGiz1aVq5Pgr2GrQu,5,2,1,0,1,0,2,0,6,0.8571428571428571,1,0.0,0,1,0,1,2,0,0,2,0,2,4,1
11444,100395,lDJQud5AwL6Ba2zEaWPbxkrhuulYEvyw,bWdj2GDclj5ofokWjzoa5jAwMkxCykd6,1,0,0,0,0,0,3,0,3,0.42857142857142855,1,0.0,0,0,0,0,0,0,0,3,0,0,3,1
11445,100405,lsAfokF5POsODUr1G2X0v5zWkAd5sfbB,SpATywNh6bZuzm8s1ceuBUnMUAeoAHHw,2,0,0,0,0,0,3,0,3,0.42857142857142855,1,0.0,0,0,0,0,0,0,0,3,0,0,3,1
11446,100408,MlHPKmdi90dDdvX24jYoFlYEp8xS4RGn,RXDvfPUBYFlVdlueBFbLW0mhhAyGEqpt,14,22,1,0,1,3,2,0,29,4.142857142857143,2,0.0,4,1,0,1,18,3,0,2,0,6,23,0
11447,100412,OvbupWSPA81Tk7Ur62Bs2bcQ5LB2mCRC,bWdj2GDclj5ofokWjzoa5jAwMkxCykd6,1,0,0,0,0,0,1,0,1,0.14285714285714285,1,0.0,0,0,0,0,0,0,0,1,0,0,1,1
11448,100426,sWiS7fnOghX7y7YX6Vs9Fow1ZPp98c2P,bWdj2GDclj5ofokWjzoa5jAwMkxCykd6,10,26,0,0,3,3,15,1,48,6.857142857142857,1,0.0,9,0,0,3,17,3,0,15,1,12,36,1
11449,100439,FhVGWSUXUeZGSguiLBd186fsM4sRhpPL,G8EPVSXsOYB5YQWZGiz1aVq5Pgr2GrQu,9,11,1,22,1,0,1,0,36,5.142857142857143,1,0.0,3,1,17,1,8,0,5,1,0,22,14,1
11450,100450,lU8LXbJuGJewdk0jE0yxpPj20hcwCqO8,A3fsA9Zfv1X2fVEQhTw51lKENdNrEqT3,59,16,12,100,7,0,13,0,148,21.142857142857142,3,0.0,2,12,94,7,14,0,6,13,0,115,33,0
11451,100489,siw3z9CF4q7PdqdWdVvFDzTmHm8ZHf2L,SpATywNh6bZuzm8s1ceuBUnMUAeoAHHw,1,0,0,0,0,0,1,0,1,0.14285714285714285,1,0.0,0,0,0,0,0,0,0,1,0,0,1,1
11452,100499,ZIt5iRfEuLMxmr9xMDT0sX9zx5GgOmQf,A3fsA9Zfv1X2fVEQhTw51lKENdNrEqT3,1,0,0,0,0,0,2,0,2,0.2857142857142857,1,0.0,0,0,0,0,0,0,0,2,0,0,2,1
11453,100512,sv1H0k2AOskJuUJSlRoi2iUdzle6ZY5e,G8EPVSXsOYB5YQWZGiz1aVq5Pgr2GrQu,3,0,0,0,0,0,3,0,3,0.42857142857142855,1,0.0,0,0,0,0,0,0,0,3,0,0,3,1
11454,100523,FifZKzWgnHbxPg1j0vi1JZCTI4cVJ25l,G8EPVSXsOYB5YQWZGiz1aVq5Pgr2GrQu,9,8,0,6,0,0,2,0,16,2.2857142857142856,1,0.0,3,0,3,0,5,0,3,2,0,6,10,1
11455,100547,0Czxo1UyRYR5I2rUJ5duK2VwsqwaqR13,SpATywNh6bZuzm8s1ceuBUnMUAeoAHHw,10,6,0,0,0,4,6,1,17,2.4285714285714284,1,0.0,0,0,0,0,6,4,0,6,1,0,17,1
11456,100554,8msriFvaCCtQyOBjAsLjk1IXyxsB0lzq,RXDvfPUBYFlVdlueBFbLW0mhhAyGEqpt,5,3,2,0,0,0,2,0,7,1.0,2,0.0,0,2,0,0,3,0,0,2,0,2,5,1
11457,100560,x8DjxiuO7OZapd2gSqXnLZdmO4eYlUve,bWdj2GDclj5ofokWjzoa5jAwMkxCykd6,1,0,0,0,0,0,1,0,1,0.14285714285714285,1,0.0,0,0,0,0,0,0,0,1,0,0,1,1
11458,100568,9fKCM48WCwLwvCl1vZ5Sx66ep0GEs87k,RXDvfPUBYFlVdlueBFbLW0mhhAyGEqpt,10,8,3,6,1,0,1,0,19,2.7142857142857144,1,0.0,1,3,6,1,7,0,0,1,0,11,8,1
11459,100573,krUqGfXTBwqDLoVqEC6x5HRNcKeuU2b1,SpATywNh6bZuzm8s1ceuBUnMUAeoAHHw,1,0,0,0,0,0,1,0,1,0.14285714285714285,1,0.0,0,0,0,0,0,0,0,1,0,0,1,1
11460,100594,0m1xQAlS5S5aY7jod2X9WwncTIVqHxA2,SpATywNh6bZuzm8s1ceuBUnMUAeoAHHw,4,2,1,0,0,0,2,0,5,0.7142857142857143,1,0.0,0,1,0,0,2,0,0,2,0,1,4,0
11461,100599,2sNFZBlVAcN0C3ozIX9ouOQIe9XjJNO6,RXDvfPUBYFlVdlueBFbLW0mhhAyGEqpt,8,5,2,0,2,0,7,0,16,2.2857142857142856,3,0.0,0,2,0,2,5,0,0,7,0,4,12,1
11462,100604,FYehGDNRsrl5wDaAnO5HST0ivs3hH7sH,SpATywNh6bZuzm8s1ceuBUnMUAeoAHHw,12,12,1,12,1,12,3,0,41,5.857142857142857,1,0.0,3,1,12,1,9,12,0,3,0,17,24,1
11463,100606,EW14eVSThxGfz3peXBNT9jQSWqEa62yw,SpATywNh6bZuzm8s1ceuBUnMUAeoAHHw,5,2,1,0,1,0,4,0,8,1.1428571428571428,1,0.0,0,1,0,1,2,0,0,4,0,2,6,1
11464,100608,qrBxOx4xvfJbTRNtYXFo4mMHRch3LE9R,bWdj2GDclj5ofokWjzoa5jAwMkxCykd6,2,0,0,0,0,0,3,0,3,0.42857142857142855,1,0.0,0,0,0,0,0,0,0,3,0,0,3,1
11465,100610,vPuo8DmIldZLRb6b5UgHPfgjxOLUxczJ,SpATywNh6bZuzm8s1ceuBUnMUAeoAHHw,8,6,3,0,2,4,4,0,19,2.7142857142857144,2,0.0,0,3,0,2,6,4,0,4,0,5,14,1
11466,100614,qeHXe8DRkB9urr63HS1yAMwTxQkwIbff,RXDvfPUBYFlVdlueBFbLW0mhhAyGEqpt,48,102,3,85,10,10,31,13,254,36.285714285714285,8,0.0,34,3,78,10,68,10,7,31,13,125,129,1
11467,100628,5POGITm84aGrgNJ0nsPFC65wjX6UfDmC,SpATywNh6bZuzm8s1ceuBUnMUAeoAHHw,4,2,0,0,0,0,5,0,7,1.0,1,0.0,0,0,0,0,2,0,0,5,0,0,7,1
11468,100642,5kFbFpqTAfcE9zjpZiw5sGDR5BhJdfrE,SpATywNh6bZuzm8s1ceuBUnMUAeoAHHw,5,3,0,0,0,0,2,0,5,0.7142857142857143,1,0.0,0,0,0,0,3,0,0,2,0,0,5,1
11469,100644,W3mRXTG4xhvVAzedNOQzsJsrgQcHfu8g,A3fsA9Zfv1X2fVEQhTw51lKENdNrEqT3,1,0,0,0,0,0,1,0,1,0.14285714285714285,1,0.0,0,0,0,0,0,0,0,1,0,0,1,1
11470,100647,rOlo2GoZP9TqbgRI0oVgxX8oSUKh8U3d,RXDvfPUBYFlVdlueBFbLW0mhhAyGEqpt,7,5,0,0,0,0,4,0,9,1.2857142857142858,1,0.0,0,0,0,0,5,0,0,4,0,0,9,1
11471,100648,lWNGGFUB9gkHAgPFHpuxssg4Y5G8A4T2,bWdj2GDclj5ofokWjzoa5jAwMkxCykd6,4,2,1,0,0,0,2,0,5,0.7142857142857143,1,0.0,0,1,0,0,2,0,0,2,0,1,4,1
11472,100659,rDec3XLpppIQx4sScddB7i9e44PtAV8K,A3fsA9Zfv1X2fVEQhTw51lKENdNrEqT3,1,0,0,0,0,0,1,0,1,0.14285714285714285,1,0.0,0,0,0,0,0,0,0,1,0,0,1,1
11473,100661,3C8bDgUvFDILMw4UNlmk2n4yo5NHVGtC,SpATywNh6bZuzm8s1ceuBUnMUAeoAHHw,11,18,0,15,0,1,5,0,39,5.571428571428571,2,0.0,8,0,15,0,10,1,0,5,0,23,16,1
11474,100677,ga70xb8tiQejcbGQlS6US7AEzd2ynNMR,bWdj2GDclj5ofokWjzoa5jAwMkxCykd6,5,5,2,0,1,0,2,0,10,1.4285714285714286,1,0.0,0,2,0,1,5,0,0,2,0,3,7,0
11475,100690,TqIZW6TBerJNN7EZw5XWZ32AUByseuDz,bWdj2GDclj5ofokWjzoa5jAwMkxCykd6,1,0,0,0,0,0,1,0,1,0.14285714285714285,1,0.0,0,0,0,0,0,0,0,1,0,0,1,1
11476,100693,5hXITOhzRYMjx2VRfYxzWyiyJwxTbApF,RXDvfPUBYFlVdlueBFbLW0mhhAyGEqpt,3,0,0,0,0,0,3,0,3,0.42857142857142855,1,0.0,0,0,0,0,0,0,0,3,0,0,3,1
11477,100715,vt827MYpYgT0JKXBC62SZ24Gxa8OJ87k,bWdj2GDclj5ofokWjzoa5jAwMkxCykd6,4,5,1,0,0,0,1,0,7,1.0,1,0.0,0,1,0,0,5,0,0,1,0,1,6,1
11478,100716,dGI6yveNenjFfT8c0PjNzk1ugu0VsvkU,G8EPVSXsOYB5YQWZGiz1aVq5Pgr2GrQu,2,0,0,0,0,0,2,0,2,0.2857142857142857,1,0.0,0,0,0,0,0,0,0,2,0,0,2,1
11479,100739,MqqmdkYysHqA6UDBkyqkZJffv3577kEU,SpATywNh6bZuzm8s1ceuBUnMUAeoAHHw,7,2,1,0,1,1,5,1,11,1.5714285714285714,1,0.0,0,1,0,1,2,1,0,5,1,2,9,1
11480,100745,oBC6VJY82mEcAXDVlIE68Xc4JnrHjU4b,SpATywNh6bZuzm8s1ceuBUnMUAeoAHHw,6,8,2,0,1,0,4,0,15,2.142857142857143,1,0.0,0,2,0,1,8,0,0,4,0,3,12,1
11481,100774,6cRse7eR1s1pCddP2ji9L7RuB7UYuqjL,SpATywNh6bZuzm8s1ceuBUnMUAeoAHHw,5,3,2,0,0,0,2,0,7,1.0,1,0.0,0,2,0,0,3,0,0,2,0,2,5,1
11482,100778,Wigd4PnyDnjfDcFOxsTBcEnXo7kl9GSg,SpATywNh6bZuzm8s1ceuBUnMUAeoAHHw,16,26,9,22,3,5,15,1,81,11.571428571428571,2,0.0,6,9,18,3,20,5,4,15,1,36,45,1
11483,100779,Qi3PLuC7w2Yo9hFgq37MObjY8icnRdc6,bWdj2GDclj5ofokWjzoa5jAwMkxCykd6,59,119,52,135,32,75,32,1,446,63.714285714285715,11,0.0,18,52,113,32,101,75,22,32,1,215,231,1
11484,100781,C82stxYBdobab5s8FnzuMHxgMBwKu2tD,A3fsA9Zfv1X2fVEQhTw51lKENdNrEqT3,1,0,0,0,0,0,1,0,1,0.14285714285714285,1,0.0,0,0,0,0,0,0,0,1,0,0,1,1
11485,100796,oDUwm6L4MXQ6JEb98dYg8X4b6ULu2zCm,SpATywNh6bZuzm8s1ceuBUnMUAeoAHHw,7,14,4,0,0,0,2,0,20,2.857142857142857,1,0.0,3,4,0,0,11,0,0,2,0,7,13,1
11486,100807,zfQZFTiqHKQUgpAItjpYn7ZjkbIcP825,SpATywNh6bZuzm8s1ceuBUnMUAeoAHHw,5,3,1,0,0,0,2,0,6,0.8571428571428571,2,0.0,0,1,0,0,3,0,0,2,0,1,5,1
11487,100817,jSNLRK8jxSbbcqhbWW7DXZqoGlvGgXDY,G8EPVSXsOYB5YQWZGiz1aVq5Pgr2GrQu,10,15,4,0,0,2,7,1,29,4.142857142857143,5,0.0,0,4,0,0,15,2,0,7,1,4,25,1
11488,100823,3SCBHiEI4HvwPrOQDNTIAqp1rZOAx5IK,bWdj2GDclj5ofokWjzoa5jAwMkxCykd6,17,52,29,112,18,0,10,0,221,31.571428571428573,5,0.0,15,29,105,18,37,0,7,10,0,167,54,1
11489,100834,EhKlFSggqkpH0G4s3hbhvR0dQLyh6jQ2,bWdj2GDclj5ofokWjzoa5jAwMkxCykd6,9,5,1,10,1,0,14,0,31,4.428571428571429,1,0.0,2,1,9,1,3,0,1,14,0,13,18,1
11490,100846,78iUKf97Yd7gLvilaD752YymIdL84Vdn,SpATywNh6bZuzm8s1ceuBUnMUAeoAHHw,5,4,1,0,0,0,2,0,7,1.0,1,0.0,0,1,0,0,4,0,0,2,0,1,6,1
11491,100862,G6iele4ho79nU5jQ1J8umZLq8jEFa9yN,bWdj2GDclj5ofokWjzoa5jAwMkxCykd6,6,6,3,0,1,14,4,1,29,4.142857142857143,2,0.0,0,3,0,1,6,14,0,4,1,4,25,1
11492,100869,jfd2LG9hNbbf5Lp41xKYtXydDr9rSQaq,G8EPVSXsOYB5YQWZGiz1aVq5Pgr2GrQu,4,3,1,0,1,0,1,0,6,0.8571428571428571,1,0.0,0,1,0,1,3,0,0,1,0,2,4,1
11493,100879,xlgVVLxBZCGRSXArMda1ZJ2EETOVQEd7,SpATywNh6bZuzm8s1ceuBUnMUAeoAHHw,5,2,1,0,1,1,2,0,7,1.0,1,0.0,0,1,0,1,2,1,0,2,0,2,5,1
11494,100888,JfI1PlGVl9kA0mdAoeqyEmchpJwdwBfa,SpATywNh6bZuzm8s1ceuBUnMUAeoAHHw,16,26,10,6,6,6,6,1,61,8.714285714285714,3,0.0,0,10,5,6,26,6,1,6,1,21,40,1
11495,100921,9Dj7cZ9RPLWRgYWhoZq69xKKKshP0n7X,A3fsA9Zfv1X2fVEQhTw51lKENdNrEqT3,1,0,0,0,0,0,1,0,1,0.14285714285714285,1,0.0,0,0,0,0,0,0,0,1,0,0,1,1
11496,100928,erUNLgaqPpXW5SB6BA1vjCrKhwxECQ5B,bWdj2GDclj5ofokWjzoa5jAwMkxCykd6,5,7,0,0,0,0,3,0,10,1.4285714285714286,2,0.0,0,0,0,0,7,0,0,3,0,0,10,1
11497,100931,QAQOQC9orxaSCK47wTUjk6OT4uXNA4IV,SpATywNh6bZuzm8s1ceuBUnMUAeoAHHw,1,0,0,0,0,0,1,0,1,0.14285714285714285,1,0.0,0,0,0,0,0,0,0,1,0,0,1,1
11498,100944,ZqMeeZA1fdjNAJGfaX50qgTzDRJ8YFP5,SpATywNh6bZuzm8s1ceuBUnMUAeoAHHw,7,9,5,0,2,1,4,0,21,3.0,2,0.0,0,5,0,2,9,1,0,4,0,7,14,1
11499,100956,Qi3PLuC7w2Yo9hFgq37MObjY8icnRdc6,RXDvfPUBYFlVdlueBFbLW0mhhAyGEqpt,4,2,1,0,1,0,2,0,6,0.8571428571428571,1,0.0,0,1,0,1,2,0,0,2,0,2,4,1
11500,100957,U04y5vFf0AfyJVGIOJHlryTyRQEOm5pT,bWdj2GDclj5ofokWjzoa5jAwMkxCykd6,4,2,1,0,1,0,1,0,5,0.7142857142857143,1,0.0,0,1,0,1,2,0,0,1,0,2,3,1
11501,100958,JHP5MvKDX3euU7PqF5LcZxc3GqSOARsL,SpATywNh6bZuzm8s1ceuBUnMUAeoAHHw,2,0,0,0,0,0,2,0,2,0.2857142857142857,1,0.0,0,0,0,0,0,0,0,2,0,0,2,1
11502,100960,U04y5vFf0AfyJVGIOJHlryTyRQEOm5pT,G8EPVSXsOYB5YQWZGiz1aVq5Pgr2GrQu,2,0,0,0,0,0,2,0,2,0.2857142857142857,1,0.0,0,0,0,0,0,0,0,2,0,0,2,1
11503,100961,pdDWSL0qqW5lqoVLDvyIeqmUWuTqLvQ6,SpATywNh6bZuzm8s1ceuBUnMUAeoAHHw,1,0,0,0,0,0,1,0,1,0.14285714285714285,1,0.0,0,0,0,0,0,0,0,1,0,0,1,1
11504,100978,4X713FvFJyCLvswyefbqyJ5rn4U0EDrr,G8EPVSXsOYB5YQWZGiz1aVq5Pgr2GrQu,7,2,1,0,1,0,5,1,10,1.4285714285714286,1,0.0,0,1,0,1,2,0,0,5,1,2,8,1
11505,100990,CnuwKGLCLbXYnPgy82VEWYA1NOiOhvr0,SpATywNh6bZuzm8s1ceuBUnMUAeoAHHw,27,58,1,22,1,1,18,2,103,14.714285714285714,9,0.0,12,1,17,1,46,1,5,18,2,31,72,0
11506,100997,coZTr10eytnE55me2AxqRWq6qrVXEB7M,SpATywNh6bZuzm8s1ceuBUnMUAeoAHHw,47,77,45,31,27,30,25,3,238,34.0,7,0.0,10,45,28,27,67,30,3,25,3,110,128,1
11507,101010,fd2e5NJVnyVwHFHuiTOOM639ZY1uThtn,SpATywNh6bZuzm8s1ceuBUnMUAeoAHHw,1,0,0,0,0,0,1,0,1,0.14285714285714285,1,0.0,0,0,0,0,0,0,0,1,0,0,1,1
11508,101011,6RuWsSvS3Ngnjl37PzNAaaGn8Jd9a1lW,SpATywNh6bZuzm8s1ceuBUnMUAeoAHHw,1,0,0,0,0,0,1,0,1,0.14285714285714285,1,0.0,0,0,0,0,0,0,0,1,0,0,1,1
11509,101020,0ZCSFawDDnRtGIJPo0HlmFehfeS6kHt8,SpATywNh6bZuzm8s1ceuBUnMUAeoAHHw,6,7,3,0,2,0,2,0,14,2.0,1,0.0,0,3,0,2,7,0,0,2,0,5,9,1
11510,101024,WSII4CAtuXXVd816MewodzGLKdBCCfc2,SpATywNh6bZuzm8s1ceuBUnMUAeoAHHw,27,70,22,18,12,1,21,0,144,20.571428571428573,5,0.0,16,22,17,12,54,1,1,21,0,67,77,0
11511,101026,mbu5XDK8Rjc919DDY9nTqWKI0jGsFurC,A3fsA9Zfv1X2fVEQhTw51lKENdNrEqT3,1,0,0,0,0,0,1,0,1,0.14285714285714285,1,0.0,0,0,0,0,0,0,0,1,0,0,1,1
11512,101029,qnchlLjb2Sg0NdcHhbSBOQwh2G3s1NPH,G8EPVSXsOYB5YQWZGiz1aVq5Pgr2GrQu,9,6,1,0,1,0,3,0,11,1.5714285714285714,2,0.0,0,1,0,1,6,0,0,3,0,2,9,1
11513,101037,eWW5LWmp2L4jfpnZTKTrpHZw2NPytGoT,A3fsA9Zfv1X2fVEQhTw51lKENdNrEqT3,1,0,0,0,0,0,1,0,1,0.14285714285714285,1,0.0,0,0,0,0,0,0,0,1,0,0,1,1
11514,101039,3Cx4dFPpXfBhy67BB6opyx75Z6TxCQV0,SpATywNh6bZuzm8s1ceuBUnMUAeoAHHw,1,0,0,0,0,0,1,0,1,0.14285714285714285,1,0.0,0,0,0,0,0,0,0,1,0,0,1,1
11515,101040,0MInlyhRLhTct7ctvAmGIMuZ2WCCEQOJ,A3fsA9Zfv1X2fVEQhTw51lKENdNrEqT3,1,0,0,0,0,0,1,0,1,0.14285714285714285,1,0.0,0,0,0,0,0,0,0,1,0,0,1,1
11516,101049,4s35oxsHucC7ffS0wFNPwafPYeG49GAU,SpATywNh6bZuzm8s1ceuBUnMUAeoAHHw,4,0,0,0,0,0,4,1,5,0.7142857142857143,1,0.0,0,0,0,0,0,0,0,4,1,0,5,1
11517,101051,0WQxgoUN7TBDtRGEW7KgYzWz2pgrrK5v,A3fsA9Zfv1X2fVEQhTw51lKENdNrEqT3,1,0,0,0,0,0,1,0,1,0.14285714285714285,1,0.0,0,0,0,0,0,0,0,1,0,0,1,1
11518,101056,OHdLWfOkVYVSxh9avWbeG6oGLyuN9vvx,SpATywNh6bZuzm8s1ceuBUnMUAeoAHHw,6,3,2,0,1,0,3,0,9,1.2857142857142858,1,0.0,0,2,0,1,3,0,0,3,0,3,6,1
11519,101075,2edy9dIAe4yrL8yAxHgqsIKKU0nldbta,SpATywNh6bZuzm8s1ceuBUnMUAeoAHHw,21,37,14,15,6,17,20,1,110,15.714285714285714,5,0.0,16,14,12,6,21,17,3,20,1,48,62,0
11520,101076,9QftuNjRCr9ybWcdk9XGcjwoamuBGtxp,RXDvfPUBYFlVdlueBFbLW0mhhAyGEqpt,13,8,3,8,2,0,4,1,26,3.7142857142857144,1,0.0,4,3,8,2,4,0,0,4,1,17,9,1
11521,101088,skwGEmBgIkpxOdkOcle3E7qOBQA7vS2R,SpATywNh6bZuzm8s1ceuBUnMUAeoAHHw,5,3,1,0,1,0,2,0,7,1.0,1,0.0,0,1,0,1,3,0,0,2,0,2,5,1
11522,101089,6mMeVC2B7hFVd1nCtPVGU6PaoCXq1G2c,SpATywNh6bZuzm8s1ceuBUnMUAeoAHHw,3,2,0,0,0,0,1,0,3,0.42857142857142855,1,0.0,0,0,0,0,2,0,0,1,0,0,3,1
11523,101100,mRaBEX7ZDfkFg6XYznVptg421BJGPS3w,SpATywNh6bZuzm8s1ceuBUnMUAeoAHHw,6,3,1,0,1,0,2,1,8,1.1428571428571428,1,0.0,0,1,0,1,3,0,0,2,1,2,6,1
11524,101101,FTGBOUC5qFiXzNQNK1iKg2fvAMPM8ThA,SpATywNh6bZuzm8s1ceuBUnMUAeoAHHw,9,8,4,0,4,0,2,0,18,2.5714285714285716,1,0.0,0,4,0,4,8,0,0,2,0,8,10,1
11525,101111,jWJRJs7mP2iWLScGpcEFZK8ziDAIaDM6,SpATywNh6bZuzm8s1ceuBUnMUAeoAHHw,12,20,1,18,0,0,5,0,44,6.285714285714286,2,0.0,12,1,15,0,8,0,3,5,0,28,16,1
11526,101115,FixP7IuJ80KsWtzMzcQsJZKOjLxDKZgC,SpATywNh6bZuzm8s1ceuBUnMUAeoAHHw,1,0,0,0,0,0,1,0,1,0.14285714285714285,1,0.0,0,0,0,0,0,0,0,1,0,0,1,1
11527,101129,dZFFkuSkEdW4wzDVTZtpVIC64kvJ857o,G8EPVSXsOYB5YQWZGiz1aVq5Pgr2GrQu,5,2,1,0,1,0,2,0,6,0.8571428571428571,1,0.0,0,1,0,1,2,0,0,2,0,2,4,1
11528,101152,7B5rcRMuJ6A1xAdnnIVDusvPjMkwnC77,bWdj2GDclj5ofokWjzoa5jAwMkxCykd6,59,102,15,184,8,7,32,2,350,50.0,9,0.0,22,15,166,8,80,7,18,32,2,211,139,1
11529,101155,PSxHADin4S7TFVr4zP5HBd1nZjW3cx4M,G8EPVSXsOYB5YQWZGiz1aVq5Pgr2GrQu,11,10,5,6,0,19,2,0,42,6.0,1,0.0,3,5,3,0,7,19,3,2,0,11,31,1
11530,101166,DFKzgJXlXxnZVHESIM4fYC543XX9ZfDV,A3fsA9Zfv1X2fVEQhTw51lKENdNrEqT3,1,0,0,0,0,0,1,0,1,0.14285714285714285,1,0.0,0,0,0,0,0,0,0,1,0,0,1,1
11531,101168,Fa6BLRRKtDwlKrwyXtqO3LGNnTfVpmlS,SpATywNh6bZuzm8s1ceuBUnMUAeoAHHw,1,0,0,0,0,0,1,0,1,0.14285714285714285,1,0.0,0,0,0,0,0,0,0,1,0,0,1,1
11532,101172,hfMGuVwBeucr422AFfEYrtJHa9rVnsoA,SpATywNh6bZuzm8s1ceuBUnMUAeoAHHw,1,0,0,0,0,0,1,0,1,0.14285714285714285,1,0.0,0,0,0,0,0,0,0,1,0,0,1,1
11533,101178,uAXW7zeSaEEtMIdMcVsYpUquscAKUnr7,bWdj2GDclj5ofokWjzoa5jAwMkxCykd6,2,0,0,0,0,0,3,0,3,0.42857142857142855,2,0.0,0,0,0,0,0,0,0,3,0,0,3,1
11534,101183,4moZsX66K72QjGT5GqDqJCMPu4Ct97bi,G8EPVSXsOYB5YQWZGiz1aVq5Pgr2GrQu,6,5,1,0,2,1,2,0,11,1.5714285714285714,1,0.0,2,1,0,2,3,1,0,2,0,5,6,1
11535,101188,gtKTzkXHwS41ljYVmjlLLf4WyQSkK02q,RXDvfPUBYFlVdlueBFbLW0mhhAyGEqpt,11,10,7,6,0,0,3,0,26,3.7142857142857144,2,0.0,2,7,6,0,8,0,0,3,0,15,11,1
11536,101208,6bpPMNX4VLAo5FNzh6WrMNoyVaRnL68O,RXDvfPUBYFlVdlueBFbLW0mhhAyGEqpt,8,9,1,0,0,0,1,0,11,1.5714285714285714,1,0.0,0,1,0,0,9,0,0,1,0,1,10,1
11537,101210,h9fj5ctPIK6vllChG3R7Ob244BG9PpLx,SpATywNh6bZuzm8s1ceuBUnMUAeoAHHw,3,0,0,0,0,0,3,1,4,0.5714285714285714,1,0.0,0,0,0,0,0,0,0,3,1,0,4,1
11538,101217,eoY58NwX7OVcm2sOG1AAgydEA1V5TiLJ,SpATywNh6bZuzm8s1ceuBUnMUAeoAHHw,1,0,0,0,0,0,1,0,1,0.14285714285714285,1,0.0,0,0,0,0,0,0,0,1,0,0,1,1
11539,101222,7SY0SzNTkW1xUX8FK1P49jbfTWqfgLfG,SpATywNh6bZuzm8s1ceuBUnMUAeoAHHw,7,16,2,0,1,0,7,0,26,3.7142857142857144,2,0.0,0,2,0,1,16,0,0,7,0,3,23,1
11540,101225,MwRVXLIjs7ObnboXYRMgXHQa3UWpN5i5,bWdj2GDclj5ofokWjzoa5jAwMkxCykd6,5,2,1,0,1,0,3,0,7,1.0,1,0.0,0,1,0,1,2,0,0,3,0,2,5,1
11541,101227,1zysq5lTXLzGIAe1yQorA74YMvQPYkm5,SpATywNh6bZuzm8s1ceuBUnMUAeoAHHw,1,0,0,0,0,0,2,0,2,0.2857142857142857,1,0.0,0,0,0,0,0,0,0,2,0,0,2,1
11542,101234,7kbuqNU54d8d11QmdSpTGAMhLhmSDka1,RXDvfPUBYFlVdlueBFbLW0mhhAyGEqpt,44,25,15,72,8,0,4,0,124,17.714285714285715,2,0.0,7,15,68,8,18,0,4,4,0,98,26,1
11543,101236,cCvHnoX6St5OTmXQ2AOInGyMnqlmS6DL,SpATywNh6bZuzm8s1ceuBUnMUAeoAHHw,18,18,8,16,5,1,4,0,52,7.428571428571429,2,0.0,4,8,14,5,14,1,2,4,0,31,21,1
11544,101246,I5LLOe5opvt5J43scHH7lI6K5JrrHIsM,SpATywNh6bZuzm8s1ceuBUnMUAeoAHHw,7,2,1,0,1,0,4,0,8,1.1428571428571428,2,0.0,0,1,0,1,2,0,0,4,0,2,6,1
11545,101250,iI85tnA7qrRiHSPoxfEPOdB8KhBODfhh,bWdj2GDclj5ofokWjzoa5jAwMkxCykd6,3,0,0,0,0,0,3,0,3,0.42857142857142855,1,0.0,0,0,0,0,0,0,0,3,0,0,3,1
11546,101260,ti7nrCLZuFBhUOASmDPlWdVcwOuGnHAJ,SpATywNh6bZuzm8s1ceuBUnMUAeoAHHw,7,7,5,0,3,0,3,0,18,2.5714285714285716,2,0.0,0,5,0,3,7,0,0,3,0,8,10,1
11547,101452,cyHlGmzdd820iXZeJHNijRhHgNUgaRsR,5Gyp41oLVo7Gg7vF4vpmggWP5MU70QO6,15,15,7,8,5,0,3,0,38,5.428571428571429,3,0.0,6,7,4,5,9,0,4,3,0,22,16,1
11548,101456,zrPeuyaXVKnYR1uCd9JL4292EBWbFugp,5Gyp41oLVo7Gg7vF4vpmggWP5MU70QO6,9,5,1,0,1,0,6,1,14,2.0,1,0.0,0,1,0,1,5,0,0,6,1,2,12,1
11549,101465,Bt2D7lmqsxv3cFCET3d4laWzBP0ZnZdv,5Gyp41oLVo7Gg7vF4vpmggWP5MU70QO6,8,5,4,0,3,0,2,0,14,2.0,1,0.0,0,4,0,3,5,0,0,2,0,7,7,1
11550,101467,bPaSH3KfvqKspM1XB21OG1IZ8fF7ldO2,5Gyp41oLVo7Gg7vF4vpmggWP5MU70QO6,9,4,3,0,0,6,8,2,23,3.2857142857142856,1,0.0,0,3,0,0,4,6,0,8,2,3,20,1
11551,101498,pn0U7WqwcrjczUXEzvwACFEkYhXoHWmc,5Gyp41oLVo7Gg7vF4vpmggWP5MU70QO6,1,0,0,0,0,0,1,0,1,0.14285714285714285,1,0.0,0,0,0,0,0,0,0,1,0,0,1,1
11552,101500,1gxs0fwvL2xfwTYgRZccrPKZo7GalF4t,5Gyp41oLVo7Gg7vF4vpmggWP5MU70QO6,6,4,1,0,1,0,2,0,8,1.1428571428571428,1,0.0,0,1,0,1,4,0,0,2,0,2,6,1
11553,101506,ZWnKii7CrzufUGiI6upCzSmttf0gejmY,5Gyp41oLVo7Gg7vF4vpmggWP5MU70QO6,1,0,0,0,0,0,1,0,1,0.14285714285714285,1,0.0,0,0,0,0,0,0,0,1,0,0,1,0
11554,101507,9wopoJ2cGGzuRFqMYS5p5e9NQyyeYnrZ,5Gyp41oLVo7Gg7vF4vpmggWP5MU70QO6,1,0,0,0,0,0,1,0,1,0.14285714285714285,1,0.0,0,0,0,0,0,0,0,1,0,0,1,1
11555,101512,fwhOM3WHOmicuRjMN72AZp4mXhiBMgpc,5Gyp41oLVo7Gg7vF4vpmggWP5MU70QO6,13,19,2,19,3,5,12,3,63,9.0,3,0.0,6,2,12,3,13,5,7,12,3,23,40,1
11556,101514,gJvCNWfsgT56j7y7Un71mXqeZVPhRbg4,5Gyp41oLVo7Gg7vF4vpmggWP5MU70QO6,8,3,0,0,0,2,6,1,12,1.7142857142857142,1,0.0,0,0,0,0,3,2,0,6,1,0,12,1
11557,101518,RL64n4qclvmNyCtbRJIuKrQ8BQgb5LB1,5Gyp41oLVo7Gg7vF4vpmggWP5MU70QO6,7,3,2,0,2,0,3,0,10,1.4285714285714286,2,0.0,0,2,0,2,3,0,0,3,0,4,6,1
11558,101541,KMjIShuxwjyyHXq4vYnxdsaTjtsvpNEc,5Gyp41oLVo7Gg7vF4vpmggWP5MU70QO6,1,0,0,0,0,0,1,0,1,0.14285714285714285,1,0.0,0,0,0,0,0,0,0,1,0,0,1,1
11559,101555,sz7zM1DSp5AQjmznVzMDY1PUixSW7aYf,5Gyp41oLVo7Gg7vF4vpmggWP5MU70QO6,2,0,0,0,0,0,5,0,5,0.7142857142857143,4,0.0,0,0,0,0,0,0,0,5,0,0,5,1
11560,101560,xeSVcZHF8lWMo0zUmOw3Zu2e5bxF0c3b,5Gyp41oLVo7Gg7vF4vpmggWP5MU70QO6,10,6,4,0,3,0,9,0,22,3.142857142857143,2,0.0,0,4,0,3,6,0,0,9,0,7,15,1
11561,101564,wCYurJi36MQ1R9mcfGU9x4rt998XAowy,5Gyp41oLVo7Gg7vF4vpmggWP5MU70QO6,7,13,1,4,1,0,1,0,20,2.857142857142857,1,0.0,4,1,2,1,9,0,2,1,0,8,12,1
11562,101591,BJyRSsWSiezY4yrLm9sDqfWLB4qxlfhl,5Gyp41oLVo7Gg7vF4vpmggWP5MU70QO6,8,4,2,0,1,0,5,0,12,1.7142857142857142,1,0.0,0,2,0,1,4,0,0,5,0,3,9,1
11563,101592,6CNJnhFNmHRhustnp1yAF7y5A4oCDcgB,5Gyp41oLVo7Gg7vF4vpmggWP5MU70QO6,8,7,5,0,2,3,3,0,20,2.857142857142857,2,0.0,0,5,0,2,7,3,0,3,0,7,13,1
11564,101597,04hGIRAwJNhGnbBI3TTn0lNhDIwpoJVc,5Gyp41oLVo7Gg7vF4vpmggWP5MU70QO6,8,5,3,2,2,0,1,0,13,1.8571428571428572,1,0.0,1,3,1,2,4,0,1,1,0,7,6,1
11565,101601,uoB6LjXoO0uEAy8Gm4C48aYCpFXi2nje,5Gyp41oLVo7Gg7vF4vpmggWP5MU70QO6,12,11,5,4,5,0,8,0,33,4.714285714285714,2,0.0,6,5,2,5,5,0,2,8,0,18,15,1
11566,101607,4VSTLb8tmjvrWAcdc1fUYi8rh0FVk7Su,5Gyp41oLVo7Gg7vF4vpmggWP5MU70QO6,1,0,0,0,0,0,1,0,1,0.14285714285714285,1,0.0,0,0,0,0,0,0,0,1,0,0,1,1
11567,101629,QJLw1Q5TwE4X1EdRI7Y8zxzQmZwpmGCu,5Gyp41oLVo7Gg7vF4vpmggWP5MU70QO6,7,3,2,0,2,0,2,0,9,1.2857142857142858,1,0.0,0,2,0,2,3,0,0,2,0,4,5,1
11568,101645,hRVlNOTS6jXxXFoegXsRTavsZxsubLWH,5Gyp41oLVo7Gg7vF4vpmggWP5MU70QO6,9,4,4,0,3,0,3,0,14,2.0,2,0.0,0,4,0,3,4,0,0,3,0,7,7,0
11569,101655,3itNxaQIx1CxzcmIshtAJt0RwR2UMUjE,5Gyp41oLVo7Gg7vF4vpmggWP5MU70QO6,4,2,1,0,0,0,2,0,5,0.7142857142857143,1,0.0,0,1,0,0,2,0,0,2,0,1,4,1
11570,101665,NpWQRg3OAEPQzsdapgtzdDlY7oBIYHtZ,5Gyp41oLVo7Gg7vF4vpmggWP5MU70QO6,1,0,0,0,0,0,1,0,1,0.14285714285714285,1,0.0,0,0,0,0,0,0,0,1,0,0,1,1
11571,101673,sVifRlhP9nBlmdcZTS6jbs286jf9Ait6,5Gyp41oLVo7Gg7vF4vpmggWP5MU70QO6,7,9,1,0,0,1,5,0,16,2.2857142857142856,2,0.0,0,1,0,0,9,1,0,5,0,1,15,1
11572,101679,R2bf9dlDhtEUgfKzXR1GPBa12LhUfZ8W,5Gyp41oLVo7Gg7vF4vpmggWP5MU70QO6,1,0,0,0,0,0,1,0,1,0.14285714285714285,1,0.0,0,0,0,0,0,0,0,1,0,0,1,1
11573,101682,DQt2pn098s49W1ZQVr3TX6g41xJCKLnk,5Gyp41oLVo7Gg7vF4vpmggWP5MU70QO6,20,34,19,21,3,24,14,0,115,16.428571428571427,3,0.0,4,19,16,3,30,24,5,14,0,42,73,0
11574,101687,C89edYjc0egHm9DK0UhG6TICXc3cgfYt,5Gyp41oLVo7Gg7vF4vpmggWP5MU70QO6,2,0,0,0,0,0,2,0,2,0.2857142857142857,1,0.0,0,0,0,0,0,0,0,2,0,0,2,0
11575,101689,pbaqjkvaUNQsMIN40YaHH4YISJL3nrdi,5Gyp41oLVo7Gg7vF4vpmggWP5MU70QO6,19,30,14,7,9,0,9,0,69,9.857142857142858,4,0.0,10,14,5,9,20,0,2,9,0,38,31,1
11576,101727,TQ6dd5H6C14tiFKVOTTVyRFgIGSubl1j,5Gyp41oLVo7Gg7vF4vpmggWP5MU70QO6,1,0,0,0,0,0,1,0,1,0.14285714285714285,1,0.0,0,0,0,0,0,0,0,1,0,0,1,1
11577,101744,bhGqExUGpWPVtLHOBczGOZtP5NSlb2iV,5Gyp41oLVo7Gg7vF4vpmggWP5MU70QO6,1,0,0,0,0,0,1,0,1,0.14285714285714285,1,0.0,0,0,0,0,0,0,0,1,0,0,1,0
11578,101745,0hRwE5vbowYRJTF6rcWCTgSh4yHA34bg,5Gyp41oLVo7Gg7vF4vpmggWP5MU70QO6,31,51,1,23,8,10,15,3,111,15.857142857142858,7,0.0,13,1,16,8,38,10,7,15,3,38,73,1
11579,101748,CWtzx13AibFkLvkg7ivFEzszvepdmZkK,5Gyp41oLVo7Gg7vF4vpmggWP5MU70QO6,2,0,0,0,0,0,2,0,2,0.2857142857142857,1,0.0,0,0,0,0,0,0,0,2,0,0,2,1
11580,101755,3yfQbyJ9pf1yrEL1gur3tzr8XAtUzfm8,5Gyp41oLVo7Gg7vF4vpmggWP5MU70QO6,10,15,8,0,2,13,5,0,43,6.142857142857143,1,0.0,3,8,0,2,12,13,0,5,0,13,30,1
11581,101764,Gj2iWszkWYXSgm6krMUTGIVXgXjnCpdU,5Gyp41oLVo7Gg7vF4vpmggWP5MU70QO6,2,0,0,0,0,0,2,0,2,0.2857142857142857,1,0.0,0,0,0,0,0,0,0,2,0,0,2,1
11582,101767,hi2RRdBggCCfeH7bxNko5GDSFpsH4d7a,5Gyp41oLVo7Gg7vF4vpmggWP5MU70QO6,6,4,2,0,1,2,4,0,13,1.8571428571428572,1,0.0,0,2,0,1,4,2,0,4,0,3,10,1
11583,101771,JfFEDPtTHkbJ97g3bb1XESDWfaaas9bO,5Gyp41oLVo7Gg7vF4vpmggWP5MU70QO6,1,0,0,0,0,0,1,0,1,0.14285714285714285,1,0.0,0,0,0,0,0,0,0,1,0,0,1,1
11584,101797,hvwDkBgYgegt9wVdGid3AcnArAeCqIHd,5Gyp41oLVo7Gg7vF4vpmggWP5MU70QO6,10,11,4,0,4,0,3,0,22,3.142857142857143,2,0.0,0,4,0,4,11,0,0,3,0,8,14,1
11585,101818,HTW0MXRsyGWqdNcPrMPEaXwWOjVd82Bo,5Gyp41oLVo7Gg7vF4vpmggWP5MU70QO6,5,2,1,0,1,0,2,0,6,0.8571428571428571,1,0.0,0,1,0,1,2,0,0,2,0,2,4,1
11586,101830,fZrT5T2XYc9pm3Zx85nVKb18lwTknI1m,5Gyp41oLVo7Gg7vF4vpmggWP5MU70QO6,5,2,1,0,1,0,2,0,6,0.8571428571428571,1,0.0,0,1,0,1,2,0,0,2,0,2,4,1
11587,101840,ew5cf7bpZjN9L5HIpJxjf0mbKDlY7Mli,5Gyp41oLVo7Gg7vF4vpmggWP5MU70QO6,4,2,1,0,1,0,1,0,5,0.7142857142857143,1,0.0,0,1,0,1,2,0,0,1,0,2,3,0
11588,101844,lQyKsLhc77msSpfpFAQdEdwWNrz2sffy,5Gyp41oLVo7Gg7vF4vpmggWP5MU70QO6,18,31,22,4,9,0,8,0,74,10.571428571428571,5,0.0,2,22,2,9,29,0,2,8,0,35,39,0
11589,101848,27cdsuNLSsNdpSImVvDjBjf9ewYI2xCw,5Gyp41oLVo7Gg7vF4vpmggWP5MU70QO6,7,3,2,0,2,0,3,0,10,1.4285714285714286,2,0.0,0,2,0,2,3,0,0,3,0,4,6,1
11590,101850,1AfBYz7PsZIdVlLLLIOlXwXH4cJYR8cq,5Gyp41oLVo7Gg7vF4vpmggWP5MU70QO6,7,3,2,0,2,0,2,0,9,1.2857142857142858,1,0.0,0,2,0,2,3,0,0,2,0,4,5,1
11591,101878,4okppsrdnKYxqs2gLNMiS6gb60QmM8WN,5Gyp41oLVo7Gg7vF4vpmggWP5MU70QO6,6,3,2,0,1,0,4,0,10,1.4285714285714286,2,0.0,0,2,0,1,3,0,0,4,0,3,7,1
11592,101881,ZalaHb2nOUsnNI2p4xQ00VNI9pJY08yk,5Gyp41oLVo7Gg7vF4vpmggWP5MU70QO6,1,0,0,0,0,0,1,0,1,0.14285714285714285,1,0.0,0,0,0,0,0,0,0,1,0,0,1,1
11593,101883,8i0uaFDAsU3DOBshHHoXkpmkG9XUoSYX,5Gyp41oLVo7Gg7vF4vpmggWP5MU70QO6,12,14,4,10,3,0,3,0,34,4.857142857142857,1,0.0,6,4,5,3,8,0,5,3,0,18,16,1
11594,101914,STC9kNvoc8v8oFEpkDJr8SLBeByVv0bI,5Gyp41oLVo7Gg7vF4vpmggWP5MU70QO6,1,0,0,0,0,0,1,0,1,0.14285714285714285,1,0.0,0,0,0,0,0,0,0,1,0,0,1,1
11595,101916,K5e4X2ATT5k1vl1kvQVqsIyRhk1ZY506,5Gyp41oLVo7Gg7vF4vpmggWP5MU70QO6,43,117,76,36,18,47,35,2,331,47.285714285714285,11,0.0,21,76,33,18,96,47,3,35,2,148,183,0
11596,101921,qg7aIxxfHKlqXcXH8Q2TmqUpIJfhnSWV,5Gyp41oLVo7Gg7vF4vpmggWP5MU70QO6,4,0,0,0,0,0,7,0,7,1.0,1,0.0,0,0,0,0,0,0,0,7,0,0,7,1
11597,101929,c4cBsKaeHPIc85bOPe7KYxwPpTPQkGOS,5Gyp41oLVo7Gg7vF4vpmggWP5MU70QO6,8,5,3,0,2,0,4,0,14,2.0,1,0.0,0,3,0,2,5,0,0,4,0,5,9,1
11598,101942,srnnzUkIJr2Uisav8LfnV4SnpbNw9CLp,5Gyp41oLVo7Gg7vF4vpmggWP5MU70QO6,13,19,11,0,2,0,19,0,51,7.285714285714286,6,0.0,1,11,0,2,18,0,0,19,0,14,37,1
11599,101943,nUSBZJtgja7StWJKUoMKeu2Wmlcsct6T,5Gyp41oLVo7Gg7vF4vpmggWP5MU70QO6,4,0,0,0,0,0,4,1,5,0.7142857142857143,2,0.0,0,0,0,0,0,0,0,4,1,0,5,1
11600,101946,X9zb15Nu4pJFCfQgkBigs5ZgWhdpLAGO,5Gyp41oLVo7Gg7vF4vpmggWP5MU70QO6,1,0,0,0,0,0,1,0,1,0.14285714285714285,1,0.0,0,0,0,0,0,0,0,1,0,0,1,1
11601,101947,gYz3DXiXiB2ygQdrSqkvFFqa3NbdbDQD,5Gyp41oLVo7Gg7vF4vpmggWP5MU70QO6,11,9,5,10,3,7,1,0,35,5.0,1,0.0,2,5,5,3,7,7,5,1,0,15,20,1
11602,101951,UnYwehBo2feinTsxQtbrjdcob8LOQRe3,5Gyp41oLVo7Gg7vF4vpmggWP5MU70QO6,1,0,0,0,0,0,1,0,1,0.14285714285714285,1,0.0,0,0,0,0,0,0,0,1,0,0,1,0
11603,101962,GzVsDDvepjc0lLyMS3k9MR0dz8jyV1ca,5Gyp41oLVo7Gg7vF4vpmggWP5MU70QO6,21,82,40,13,20,5,7,0,167,23.857142857142858,12,0.0,9,40,12,20,73,5,1,7,0,81,86,0
11604,101969,ngy9FDiYXpc4c01p0sFczM8viAh3TUDK,5Gyp41oLVo7Gg7vF4vpmggWP5MU70QO6,5,2,1,0,1,0,2,0,6,0.8571428571428571,1,0.0,0,1,0,1,2,0,0,2,0,2,4,1
11605,101980,BP5vZkvTpLRQdxYERPiGbViuRmZcLSEw,5Gyp41oLVo7Gg7vF4vpmggWP5MU70QO6,13,14,7,4,3,5,6,0,39,5.571428571428571,2,0.0,4,7,2,3,10,5,2,6,0,16,23,1
11606,102006,SW8hZER4lRVJxocMEgvR4kXl1NsQnFzy,5Gyp41oLVo7Gg7vF4vpmggWP5MU70QO6,3,0,0,0,0,5,2,0,7,1.0,1,0.0,0,0,0,0,0,5,0,2,0,0,7,1
11607,102010,Cwkpbk9XjaRjxRkXl9T5LLX0pfxG659m,5Gyp41oLVo7Gg7vF4vpmggWP5MU70QO6,27,28,14,10,8,18,7,12,97,13.857142857142858,1,0.0,11,14,5,8,17,18,5,7,12,38,59,1
11608,102022,N26qxxXNzNgtRrCPTTWHycPCg4UmpaBH,5Gyp41oLVo7Gg7vF4vpmggWP5MU70QO6,5,3,1,0,1,0,1,0,6,0.8571428571428571,1,0.0,0,1,0,1,3,0,0,1,0,2,4,1
11609,102055,ANJ7A7TrnpRJsv1mG7Zq08b8gsBzPJqI,5Gyp41oLVo7Gg7vF4vpmggWP5MU70QO6,16,26,14,4,9,0,4,0,57,8.142857142857142,3,0.0,3,14,2,9,23,0,2,4,0,28,29,0
11610,102064,FP4hLkoHHSoDgNvvli0GZn0SfLgLxSLJ,5Gyp41oLVo7Gg7vF4vpmggWP5MU70QO6,13,18,8,0,4,1,5,1,37,5.285714285714286,1,0.0,7,8,0,4,11,1,0,5,1,19,18,1
11611,102071,vamtANIlqxEfssSotq9CBIgt04YnuypF,5Gyp41oLVo7Gg7vF4vpmggWP5MU70QO6,28,35,25,0,13,8,19,3,103,14.714285714285714,5,0.0,1,25,0,13,34,8,0,19,3,39,64,1
11612,102086,hy1o1tFG3MUeKwnpej7pCvF6Qw50OZDs,5Gyp41oLVo7Gg7vF4vpmggWP5MU70QO6,3,0,0,0,0,1,3,0,4,0.5714285714285714,1,0.0,0,0,0,0,0,1,0,3,0,0,4,1
11613,102091,u4schfWJ1mTfhsvkC2Ygk0foJeVZovSx,5Gyp41oLVo7Gg7vF4vpmggWP5MU70QO6,6,3,2,0,2,0,1,0,8,1.1428571428571428,1,0.0,0,2,0,2,3,0,0,1,0,4,4,1
11614,102123,LHuyIYHaN33yTEoBdzkvXzRMGUfJtNER,5Gyp41oLVo7Gg7vF4vpmggWP5MU70QO6,2,0,0,0,0,0,2,0,2,0.2857142857142857,1,0.0,0,0,0,0,0,0,0,2,0,0,2,1
11615,102134,sL5jw3pLWZoRI7avI17oM60mfF67Acgz,5Gyp41oLVo7Gg7vF4vpmggWP5MU70QO6,15,16,8,0,6,26,16,1,73,10.428571428571429,2,0.0,4,8,0,6,12,26,0,16,1,18,55,0
11616,102154,invjLFwmOJ5b2g8Hz4dPO4FErak7u41P,5Gyp41oLVo7Gg7vF4vpmggWP5MU70QO6,27,46,20,14,12,7,8,1,108,15.428571428571429,4,0.0,18,20,7,12,28,7,7,8,1,57,51,0
11617,102155,WjCsc4Ly7MQQaQbBGWJYzwMq4TqEnbSq,5Gyp41oLVo7Gg7vF4vpmggWP5MU70QO6,7,7,0,0,0,0,3,1,11,1.5714285714285714,1,0.0,0,0,0,0,7,0,0,3,1,0,11,1
11618,102163,WlsfaEHV81OmOSz6tpiA5BKWY8BDn0FJ,5Gyp41oLVo7Gg7vF4vpmggWP5MU70QO6,7,3,2,0,2,0,2,0,9,1.2857142857142858,1,0.0,0,2,0,2,3,0,0,2,0,4,5,1
11619,102169,FGewrX4MaiUHx7NVyabzwDjV7PLDRDjt,5Gyp41oLVo7Gg7vF4vpmggWP5MU70QO6,6,3,1,0,1,0,4,0,9,1.2857142857142858,1,0.0,0,1,0,1,3,0,0,4,0,2,7,1
11620,102190,kdWfZaARkb2GKTHY1dNrIxpxXbMmpunp,5Gyp41oLVo7Gg7vF4vpmggWP5MU70QO6,1,0,0,0,0,0,1,0,1,0.14285714285714285,1,0.0,0,0,0,0,0,0,0,1,0,0,1,1
11621,102201,HgZH3VjgoNSGfdNPUYvEYMLEuHiaV4qp,5Gyp41oLVo7Gg7vF4vpmggWP5MU70QO6,17,17,9,6,6,1,10,2,51,7.285714285714286,2,0.0,6,9,3,6,11,1,3,10,2,24,27,1
11622,102215,wmND65rZOV8Cdq3Mq9MmFLy7XUHHSgIW,5Gyp41oLVo7Gg7vF4vpmggWP5MU70QO6,1,0,0,0,0,0,1,0,1,0.14285714285714285,1,0.0,0,0,0,0,0,0,0,1,0,0,1,1
11623,102216,atIOpTw1JfCdMrzLEXG2b3C0gcowmPkz,5Gyp41oLVo7Gg7vF4vpmggWP5MU70QO6,16,30,13,9,5,0,7,0,64,9.142857142857142,3,0.0,7,13,7,5,23,0,2,7,0,32,32,1
11624,102219,VJzTZqcHQdPxdcSTgYflgdTGfDdXSaeh,5Gyp41oLVo7Gg7vF4vpmggWP5MU70QO6,7,3,3,0,3,0,7,1,17,2.4285714285714284,4,0.0,0,3,0,3,3,0,0,7,1,6,11,1
11625,102238,uv7MLyLnrCPPtwLSa3ciSAESDx9fyqLj,5Gyp41oLVo7Gg7vF4vpmggWP5MU70QO6,24,67,31,4,12,4,11,1,130,18.571428571428573,4,0.0,15,31,2,12,52,4,2,11,1,60,70,1
11626,102245,lqZIfyXgEdVIeF9bwEgKmujde3rxC2ID,5Gyp41oLVo7Gg7vF4vpmggWP5MU70QO6,9,9,3,0,1,1,8,2,24,3.4285714285714284,1,0.0,2,3,0,1,7,1,0,8,2,6,18,1
11627,102248,WWhjd2hQrbhidD08sxoeqMUFLgJFtpfq,5Gyp41oLVo7Gg7vF4vpmggWP5MU70QO6,5,2,1,0,1,0,4,0,8,1.1428571428571428,2,0.0,0,1,0,1,2,0,0,4,0,2,6,1
11628,102260,gY4MmFhIOsF1Wm6XUOhrj2V8aIoxYXRx,5Gyp41oLVo7Gg7vF4vpmggWP5MU70QO6,14,15,7,0,6,0,3,0,31,4.428571428571429,2,0.0,3,7,0,6,12,0,0,3,0,16,15,1
11629,102266,RHEMdhoy3TVz84IqO3CiO0ZVmx7sjl4N,5Gyp41oLVo7Gg7vF4vpmggWP5MU70QO6,2,0,0,0,0,0,2,0,2,0.2857142857142857,1,0.0,0,0,0,0,0,0,0,2,0,0,2,1
11630,102799,9ZWuRdJmwsPcVeXfj5eD60nSn6eqt8MO,7GRhBDsirIGkRZBtSMEzNTyDr2JQm4xx,8,2,1,0,1,4,6,0,14,2.0,1,0.0,0,1,0,1,2,4,0,6,0,2,12,1
11631,102807,vTBbaPT6TO6bbvtjEvxDY8u77Dj5cote,7GRhBDsirIGkRZBtSMEzNTyDr2JQm4xx,46,135,49,50,23,2,19,0,278,39.714285714285715,2,0.0,73,49,34,23,62,2,16,19,0,179,99,1
11632,102833,ZJeIfsRIsYEDKYfpXrOW1vPestL4WNer,7GRhBDsirIGkRZBtSMEzNTyDr2JQm4xx,12,9,1,0,1,0,2,0,13,1.8571428571428572,1,0.0,0,1,0,1,9,0,0,2,0,2,11,1
11633,102837,QNU8vTePqclgvI4QsHOj53NeF8gpPvEk,7GRhBDsirIGkRZBtSMEzNTyDr2JQm4xx,1,0,0,0,0,0,1,0,1,0.14285714285714285,1,0.0,0,0,0,0,0,0,0,1,0,0,1,1
11634,102839,HRv57i4EKLnwPHqHSpvdl3J57Q3TYtkt,7GRhBDsirIGkRZBtSMEzNTyDr2JQm4xx,6,2,1,0,1,0,4,0,8,1.1428571428571428,1,0.0,0,1,0,1,2,0,0,4,0,2,6,1
11635,102847,E3FH9dDC5MuAQYulYDcZYXAV78FrDWti,7GRhBDsirIGkRZBtSMEzNTyDr2JQm4xx,4,2,0,0,0,0,3,0,5,0.7142857142857143,1,0.0,0,0,0,0,2,0,0,3,0,0,5,1
11636,102850,bUYPIrKUhpdtG1KH0Y9GXp4xZk1AgdLJ,7GRhBDsirIGkRZBtSMEzNTyDr2JQm4xx,1,0,0,0,0,0,1,0,1,0.14285714285714285,1,0.0,0,0,0,0,0,0,0,1,0,0,1,1
11637,102857,ufz99H6gUISt7XZLJ1TgvDZ6OrpiKTxS,7GRhBDsirIGkRZBtSMEzNTyDr2JQm4xx,1,0,0,0,0,0,2,0,2,0.2857142857142857,2,0.0,0,0,0,0,0,0,0,2,0,0,2,0
11638,102868,eGy9PbpiLJ8MX3YMIjoO70TYhFvF8s3p,SpATywNh6bZuzm8s1ceuBUnMUAeoAHHw,6,2,1,0,1,2,3,1,10,1.4285714285714286,1,0.0,0,1,0,1,2,2,0,3,1,2,8,1
11639,102870,WDJ95rBJgKiyFRr65T6n7aAhLfLzYON5,5X6FeZozNMgE2VRi3MJYjkkFK8SETtu2,1,0,0,0,0,0,1,0,1,0.14285714285714285,1,0.0,0,0,0,0,0,0,0,1,0,0,1,1
11640,102871,j91nMgV3K6rtEcjFaPoRw8ZzxTKSNRyI,A3fsA9Zfv1X2fVEQhTw51lKENdNrEqT3,18,13,10,0,8,0,9,1,41,5.857142857142857,3,0.0,0,10,0,8,13,0,0,9,1,18,23,1
11641,102874,ovOrxCTVGxQyC9labPGJ3gKHEzv9s9aZ,A3fsA9Zfv1X2fVEQhTw51lKENdNrEqT3,1,0,0,0,0,0,1,0,1,0.14285714285714285,1,0.0,0,0,0,0,0,0,0,1,0,0,1,1
11642,102890,QBgKSCSCtuy3kameVOAw6Wwz0K2iKBbH,G8EPVSXsOYB5YQWZGiz1aVq5Pgr2GrQu,10,11,5,0,4,0,3,0,23,3.2857142857142856,1,0.0,0,5,0,4,11,0,0,3,0,9,14,1
11643,102893,c5JhVDkXO4Xl1o4x0X5wpbuFHZccHbBn,SpATywNh6bZuzm8s1ceuBUnMUAeoAHHw,1,0,0,0,0,0,1,0,1,0.14285714285714285,1,0.0,0,0,0,0,0,0,0,1,0,0,1,1
11644,102894,2cEDKyYGVPkvyTHRF0ybKZjw6PISqB33,SpATywNh6bZuzm8s1ceuBUnMUAeoAHHw,8,1,1,0,1,0,5,6,14,2.0,1,0.0,0,1,0,1,1,0,0,5,6,2,12,1
11645,102905,s6iksgptFmyh2vfiarKdJkiKnp6RLi3f,A3fsA9Zfv1X2fVEQhTw51lKENdNrEqT3,15,17,10,0,3,24,21,1,76,10.857142857142858,3,0.0,1,10,0,3,16,24,0,21,1,14,62,0
11646,102911,YbWp9q0RRrBwQyXxgLzRZdIoNM6EmpNj,A3fsA9Zfv1X2fVEQhTw51lKENdNrEqT3,2,0,0,0,0,0,3,0,3,0.42857142857142855,1,0.0,0,0,0,0,0,0,0,3,0,0,3,1
11647,102912,34XPBSlARSAdEabwWriA5XSSURJsqF6Q,bWdj2GDclj5ofokWjzoa5jAwMkxCykd6,5,2,1,0,1,0,2,0,6,0.8571428571428571,1,0.0,0,1,0,1,2,0,0,2,0,2,4,1
11648,102927,wpXUynmsiSu4GN2ibkxsqCGp9o4mfy5I,bWdj2GDclj5ofokWjzoa5jAwMkxCykd6,16,18,5,10,6,0,6,0,45,6.428571428571429,1,0.0,8,5,9,6,10,0,1,6,0,28,17,1
11649,102943,Gkxx7PBptGwgdrd4W0pkw1awMXPiihSA,SpATywNh6bZuzm8s1ceuBUnMUAeoAHHw,6,5,1,0,1,0,2,0,9,1.2857142857142858,1,0.0,0,1,0,1,5,0,0,2,0,2,7,1
11650,102944,23V5Y4dLt5dAp7zCNE7sBan2cormM1XH,SpATywNh6bZuzm8s1ceuBUnMUAeoAHHw,10,4,2,0,2,1,4,1,14,2.0,1,0.0,0,2,0,2,4,1,0,4,1,4,10,1
11651,102949,qqzld2DbTg8EBxOLVVgl3AZMKcPoFnE4,RXDvfPUBYFlVdlueBFbLW0mhhAyGEqpt,5,2,1,0,1,0,2,0,6,0.8571428571428571,1,0.0,0,1,0,1,2,0,0,2,0,2,4,1
11652,102952,F7KfRJPBsgtS0jdyt11WgvAWy4zhSMkM,A3fsA9Zfv1X2fVEQhTw51lKENdNrEqT3,1,0,0,0,0,0,1,0,1,0.14285714285714285,1,0.0,0,0,0,0,0,0,0,1,0,0,1,1
11653,102963,1uu9vv80QLeZErtdx0I8CPsrCRhlMRmo,RXDvfPUBYFlVdlueBFbLW0mhhAyGEqpt,6,2,1,0,1,0,3,0,7,1.0,1,0.0,0,1,0,1,2,0,0,3,0,2,5,1
11654,102964,pNiUFQveXjumuZsJcsFdYJDy5O0Fbp3m,G8EPVSXsOYB5YQWZGiz1aVq5Pgr2GrQu,5,2,1,0,1,0,2,0,6,0.8571428571428571,1,0.0,0,1,0,1,2,0,0,2,0,2,4,0
11655,102971,FVUcdw8gGY0QgNPsAL0lOnlHZYyj7ckt,5X6FeZozNMgE2VRi3MJYjkkFK8SETtu2,10,14,2,12,6,0,1,0,35,5.0,2,0.0,9,2,11,6,5,0,1,1,0,28,7,1
11656,102974,l569pvTkqA1hwU8mlPA8zjV2SyK4a7w2,A3fsA9Zfv1X2fVEQhTw51lKENdNrEqT3,3,3,0,0,0,0,1,0,4,0.5714285714285714,1,0.0,0,0,0,0,3,0,0,1,0,0,4,0
11657,102975,DvNxKU9g5rp8dv94zJRF8Ah76URW61cr,SpATywNh6bZuzm8s1ceuBUnMUAeoAHHw,18,10,8,0,7,0,7,0,32,4.571428571428571,3,0.0,0,8,0,7,10,0,0,7,0,15,17,1
11658,102978,t3ySM4Gbs4aIhGFWYbt2nw6OG5oriaOF,A3fsA9Zfv1X2fVEQhTw51lKENdNrEqT3,8,7,2,0,1,0,2,0,12,1.7142857142857142,1,0.0,0,2,0,1,7,0,0,2,0,3,9,1
11659,102980,uD8Spqeq0tcI9O6lX7gMmMVhDE2HC0Al,SpATywNh6bZuzm8s1ceuBUnMUAeoAHHw,1,0,0,0,0,0,1,0,1,0.14285714285714285,1,0.0,0,0,0,0,0,0,0,1,0,0,1,1
11660,102987,4kjfNdZcdugIVfk27urqgUDiTvuYyakw,5X6FeZozNMgE2VRi3MJYjkkFK8SETtu2,8,3,1,0,1,0,4,0,9,1.2857142857142858,1,0.0,0,1,0,1,3,0,0,4,0,2,7,1
11661,102993,BxKAgVcecbK566xlIeUHElTAEVt3GzGl,bWdj2GDclj5ofokWjzoa5jAwMkxCykd6,1,0,0,0,0,0,1,0,1,0.14285714285714285,1,0.0,0,0,0,0,0,0,0,1,0,0,1,1
11662,102999,9WjmBPp7tHUxJcX9cD1TMvtq8VTyCZtX,SpATywNh6bZuzm8s1ceuBUnMUAeoAHHw,8,6,5,0,5,0,1,0,17,2.4285714285714284,1,0.0,0,5,0,5,6,0,0,1,0,10,7,1
11663,103025,l6kshSYgIFjkBtVOYi7kIq0LGbdGcRje,A3fsA9Zfv1X2fVEQhTw51lKENdNrEqT3,2,0,0,0,0,0,3,0,3,0.42857142857142855,1,0.0,0,0,0,0,0,0,0,3,0,0,3,1
11664,103038,TGrjsRoxwzZ35wp3zciCPp8r5aOpBmZm,SpATywNh6bZuzm8s1ceuBUnMUAeoAHHw,2,0,0,0,0,0,3,0,3,0.42857142857142855,2,0.0,0,0,0,0,0,0,0,3,0,0,3,1
11665,103075,8hmY23T5sCq9C2hlUNLSrX2yqFt52Pgt,RXDvfPUBYFlVdlueBFbLW0mhhAyGEqpt,7,3,2,0,2,0,2,0,9,1.2857142857142858,1,0.0,0,2,0,2,3,0,0,2,0,4,5,1
11666,103089,Sd54wuYLJGE9pQgAE1cFvsQCM2O9iNXw,bWdj2GDclj5ofokWjzoa5jAwMkxCykd6,5,2,1,0,1,0,2,0,6,0.8571428571428571,1,0.0,0,1,0,1,2,0,0,2,0,2,4,1
11667,103104,JXOo8fki25FPq0plM7J4NKpdKtv8nAso,A3fsA9Zfv1X2fVEQhTw51lKENdNrEqT3,1,0,0,0,0,0,1,0,1,0.14285714285714285,1,0.0,0,0,0,0,0,0,0,1,0,0,1,1
11668,103120,UFSjkDLycCAe1fUAiyo92id2TiybbTZT,SpATywNh6bZuzm8s1ceuBUnMUAeoAHHw,1,0,0,0,0,0,1,0,1,0.14285714285714285,1,0.0,0,0,0,0,0,0,0,1,0,0,1,1
11669,103134,PeVPWFtqmyzNVNGrKsrCqRCUp0alyzHv,SpATywNh6bZuzm8s1ceuBUnMUAeoAHHw,1,0,0,0,0,0,1,0,1,0.14285714285714285,1,0.0,0,0,0,0,0,0,0,1,0,0,1,1
11670,103157,8IuzZOXaXVUql9pLZtNuJIyLoDJ8ZL4V,A3fsA9Zfv1X2fVEQhTw51lKENdNrEqT3,20,19,8,50,2,0,4,0,83,11.857142857142858,2,0.0,2,8,43,2,17,0,7,4,0,55,28,1
11671,103175,pta6TaYSQ4VWeJjoWzSVUA5Zasc1vOWe,SpATywNh6bZuzm8s1ceuBUnMUAeoAHHw,1,0,0,0,0,0,1,0,1,0.14285714285714285,1,0.0,0,0,0,0,0,0,0,1,0,0,1,1
11672,103198,lUbIMCaPWDbgwiRy3ym2mDRgVr1wLki4,SpATywNh6bZuzm8s1ceuBUnMUAeoAHHw,11,8,1,0,1,0,2,0,12,1.7142857142857142,1,0.0,0,1,0,1,8,0,0,2,0,2,10,1
11673,103224,TINvhk9VLXQ3D49XU1y8baDw0NlbVtwm,G8EPVSXsOYB5YQWZGiz1aVq5Pgr2GrQu,4,2,1,0,1,0,1,0,5,0.7142857142857143,1,0.0,0,1,0,1,2,0,0,1,0,2,3,1
11674,103258,FBzPXWPyPigVHlzVcgyn2CNx30l85SaP,RXDvfPUBYFlVdlueBFbLW0mhhAyGEqpt,9,13,1,0,0,0,4,0,18,2.5714285714285716,2,0.0,5,1,0,0,8,0,0,4,0,6,12,0
11675,103271,DPNeCmHDELHrss8mkRKEcvkApu8OfWuh,G8EPVSXsOYB5YQWZGiz1aVq5Pgr2GrQu,19,10,8,0,6,1,12,1,38,5.428571428571429,1,0.0,0,8,0,6,10,1,0,12,1,14,24,0
11676,103283,XDwcqxWI4I9CO2vb10lgpVeZsspXXaL1,SpATywNh6bZuzm8s1ceuBUnMUAeoAHHw,1,0,0,0,0,0,1,0,1,0.14285714285714285,1,0.0,0,0,0,0,0,0,0,1,0,0,1,1
11677,103303,0Yuzh7q9awy4giTrLKNAtc9FYnhCvFKA,SpATywNh6bZuzm8s1ceuBUnMUAeoAHHw,4,9,2,0,0,0,1,0,12,1.7142857142857142,1,0.0,6,2,0,0,3,0,0,1,0,8,4,1
11678,103314,DPNeCmHDELHrss8mkRKEcvkApu8OfWuh,SpATywNh6bZuzm8s1ceuBUnMUAeoAHHw,1,0,0,0,0,0,1,0,1,0.14285714285714285,1,0.0,0,0,0,0,0,0,0,1,0,0,1,1
11679,103326,1Gr28fGQi0AhhBsOfiHtkCfOBAY8S9VF,bWdj2GDclj5ofokWjzoa5jAwMkxCykd6,5,3,1,0,1,0,2,0,7,1.0,1,0.0,0,1,0,1,3,0,0,2,0,2,5,1
11680,103338,D2lFXeOodglgSTRNVccRvVrNvHlYgfLJ,5X6FeZozNMgE2VRi3MJYjkkFK8SETtu2,1,0,0,0,0,0,1,0,1,0.14285714285714285,1,0.0,0,0,0,0,0,0,0,1,0,0,1,1
11681,103339,D2lFXeOodglgSTRNVccRvVrNvHlYgfLJ,bWdj2GDclj5ofokWjzoa5jAwMkxCykd6,1,0,0,0,0,0,1,0,1,0.14285714285714285,1,0.0,0,0,0,0,0,0,0,1,0,0,1,1
11682,103347,hNJz0qbOhrUgajUkzqSdDbybHkuRglfs,SpATywNh6bZuzm8s1ceuBUnMUAeoAHHw,30,43,27,25,10,1,15,3,124,17.714285714285715,8,0.0,6,27,23,10,37,1,2,15,3,66,58,0
11683,103363,Cd9PhUepdZFgXcqgJFSSyoIXTR4PezW8,SpATywNh6bZuzm8s1ceuBUnMUAeoAHHw,7,3,2,0,1,12,3,1,22,3.142857142857143,1,0.0,0,2,0,1,3,12,0,3,1,3,19,1
11684,103397,vuxD2zMfzfccChKnwKAggsxPZbOiZaTb,RXDvfPUBYFlVdlueBFbLW0mhhAyGEqpt,5,0,0,0,0,1,5,2,8,1.1428571428571428,1,0.0,0,0,0,0,0,1,0,5,2,0,8,1
11685,103413,YJBz2hu0xpzNzWrBf0qrKIvgi0aKng9X,SpATywNh6bZuzm8s1ceuBUnMUAeoAHHw,1,0,0,0,0,0,1,0,1,0.14285714285714285,1,0.0,0,0,0,0,0,0,0,1,0,0,1,1
11686,103417,0sAOKVns8BSkUL9PacRKzX0uoHgRzVTD,SpATywNh6bZuzm8s1ceuBUnMUAeoAHHw,11,9,2,0,1,1,10,1,24,3.4285714285714284,2,0.0,0,2,0,1,9,1,0,10,1,3,21,1
11687,103438,A7splZdp3CZV6tKUIRVHnnLOftJO8UXC,A3fsA9Zfv1X2fVEQhTw51lKENdNrEqT3,7,10,0,0,0,1,4,0,15,2.142857142857143,1,0.0,0,0,0,0,10,1,0,4,0,0,15,1
11688,103443,U3lhctDRAiyFJZP8fBSRJ5CxsYPJfYQW,SpATywNh6bZuzm8s1ceuBUnMUAeoAHHw,1,0,0,0,0,0,1,0,1,0.14285714285714285,1,0.0,0,0,0,0,0,0,0,1,0,0,1,1
11689,103445,YR1IgV2TtttHJ35h5NJxgcWKWfmLYszA,SpATywNh6bZuzm8s1ceuBUnMUAeoAHHw,16,35,20,4,10,1,11,0,81,11.571428571428571,6,0.0,3,20,4,10,32,1,0,11,0,37,44,0
11690,103451,74Dywe4dn2al60hXONYhqNpcRQDf18AP,RXDvfPUBYFlVdlueBFbLW0mhhAyGEqpt,9,6,5,0,2,0,1,0,14,2.0,1,0.0,0,5,0,2,6,0,0,1,0,7,7,1
11691,103453,0ClPvfgZ3teF26LrMInT4RNIPntzqSzr,SpATywNh6bZuzm8s1ceuBUnMUAeoAHHw,4,2,1,0,1,0,1,0,5,0.7142857142857143,1,0.0,0,1,0,1,2,0,0,1,0,2,3,0
11692,103454,Fl2rv0GIrb1pZGPCAVV4X3WnsKhjbfP2,bWdj2GDclj5ofokWjzoa5jAwMkxCykd6,8,5,2,0,3,0,5,0,15,2.142857142857143,2,0.0,2,2,0,3,3,0,0,5,0,7,8,1
11693,103456,uAXW7zeSaEEtMIdMcVsYpUquscAKUnr7,A3fsA9Zfv1X2fVEQhTw51lKENdNrEqT3,6,2,1,0,1,0,6,0,10,1.4285714285714286,1,0.0,0,1,0,1,2,0,0,6,0,2,8,0
11694,103457,XvNNzv39b8VqKid0q4fV9ms2wVNAdWks,bWdj2GDclj5ofokWjzoa5jAwMkxCykd6,56,112,47,164,8,11,48,2,392,56.0,8,0.0,22,47,156,8,90,11,8,48,2,233,159,0
11695,103479,ZdJ1BYcCBDVkoF1RDWOaW7qs4fUuQvAO,SpATywNh6bZuzm8s1ceuBUnMUAeoAHHw,23,31,13,16,3,2,12,1,78,11.142857142857142,2,0.0,11,13,15,3,20,2,1,12,1,42,36,0
11696,103502,Cp2BbG4q7QXu1vAJ8MUQKIeyJJyHFg2f,G8EPVSXsOYB5YQWZGiz1aVq5Pgr2GrQu,1,0,0,0,0,0,1,0,1,0.14285714285714285,1,0.0,0,0,0,0,0,0,0,1,0,0,1,1
11697,103504,OM0KD57nHAa4Wr8wJ1ilvxhef5Muhj8p,A3fsA9Zfv1X2fVEQhTw51lKENdNrEqT3,21,19,0,0,0,0,2,0,21,3.0,1,0.0,0,0,0,0,19,0,0,2,0,0,21,1
11698,103509,DhyvKgcTrgxrQOa9DadKHClSdCqlYrTj,SpATywNh6bZuzm8s1ceuBUnMUAeoAHHw,1,0,0,0,0,0,1,0,1,0.14285714285714285,1,0.0,0,0,0,0,0,0,0,1,0,0,1,1
11699,103534,YEF0QYiQE86qWLJG6v6QSOKqWyf11mYZ,SpATywNh6bZuzm8s1ceuBUnMUAeoAHHw,9,5,2,0,1,1,7,1,17,2.4285714285714284,1,0.0,0,2,0,1,5,1,0,7,1,3,14,1
11700,103557,vPv7PsanhRceiGshTPXtgrOmcrOEYM8O,RXDvfPUBYFlVdlueBFbLW0mhhAyGEqpt,10,5,5,0,3,0,3,1,17,2.4285714285714284,1,0.0,0,5,0,3,5,0,0,3,1,8,9,1
11701,103566,OSDu5tMGaniTUgLVQTpKE1MEiHaSe3gW,A3fsA9Zfv1X2fVEQhTw51lKENdNrEqT3,3,2,1,0,0,0,1,0,4,0.5714285714285714,1,0.0,0,1,0,0,2,0,0,1,0,1,3,1
11702,103581,QYxvxdCf3BqEP6mnoIkBRIai2RDjDRx6,SpATywNh6bZuzm8s1ceuBUnMUAeoAHHw,4,6,1,0,0,0,2,0,9,1.2857142857142858,1,0.0,3,1,0,0,3,0,0,2,0,4,5,1
11703,103600,5ZyvCd3AP7a8azCiLN5JfLAP53iZpAyD,RXDvfPUBYFlVdlueBFbLW0mhhAyGEqpt,1,0,0,0,0,0,1,0,1,0.14285714285714285,1,0.0,0,0,0,0,0,0,0,1,0,0,1,1
11704,103643,02x1393HfdHWlTjjnIgsA4Mhbk6lI383,SpATywNh6bZuzm8s1ceuBUnMUAeoAHHw,6,2,1,0,1,0,3,0,7,1.0,1,0.0,0,1,0,1,2,0,0,3,0,2,5,0
11705,103645,pGYP47am2d3xk9zOKdaE6fuoOc52iQiA,5X6FeZozNMgE2VRi3MJYjkkFK8SETtu2,31,34,0,96,11,0,5,0,146,20.857142857142858,3,0.0,20,0,81,11,14,0,15,5,0,112,34,1
11706,103651,xzqF2LiZ7Zp1COlqOBger1kuvNL9t5JK,A3fsA9Zfv1X2fVEQhTw51lKENdNrEqT3,26,19,3,30,1,0,6,0,59,8.428571428571429,2,0.0,0,3,27,1,19,0,3,6,0,31,28,1
11707,103661,Z5Gd8RjsJSljoHUoBd3hvIVNy4VKuGq0,SpATywNh6bZuzm8s1ceuBUnMUAeoAHHw,32,63,28,31,12,40,8,0,182,26.0,5,0.0,12,28,26,12,51,40,5,8,0,78,104,0
11708,103666,6TVAbHzle9P1EfKyH9hEoMksSxlp6T76,SpATywNh6bZuzm8s1ceuBUnMUAeoAHHw,22,18,14,10,11,0,5,0,58,8.285714285714286,2,0.0,1,14,9,11,17,0,1,5,0,35,23,1
11709,103668,p9NcQP74LARrulF6JzGeab5yk6ciJM9V,SpATywNh6bZuzm8s1ceuBUnMUAeoAHHw,14,30,2,10,2,1,4,0,49,7.0,3,0.0,6,2,10,2,24,1,0,4,0,20,29,0
11710,103682,gMeZHtHbmrRB8drlaFHRYNGQ6Z4lgho8,bWdj2GDclj5ofokWjzoa5jAwMkxCykd6,1,0,0,0,0,0,1,0,1,0.14285714285714285,1,0.0,0,0,0,0,0,0,0,1,0,0,1,1
11711,103690,4GnibPWQ8lJjDFqzggHzR1fwcHUGxpIS,A3fsA9Zfv1X2fVEQhTw51lKENdNrEqT3,40,16,11,86,9,0,3,0,125,17.857142857142858,1,0.0,4,11,72,9,12,0,14,3,0,96,29,1
11712,103692,lQ2haPSIRb6ySD072MeaIkhUrCYHIGKE,A3fsA9Zfv1X2fVEQhTw51lKENdNrEqT3,7,4,1,0,1,0,3,0,9,1.2857142857142858,1,0.0,0,1,0,1,4,0,0,3,0,2,7,1
11713,103730,yYnx2Djc2xdWmysqfYS5LaytJ644aZht,G8EPVSXsOYB5YQWZGiz1aVq5Pgr2GrQu,4,3,2,0,0,0,2,0,7,1.0,1,0.0,0,2,0,0,3,0,0,2,0,2,5,0
11714,103737,ANBM6p9EaEI4Seaj9IaAoVJfXZGQglbd,bWdj2GDclj5ofokWjzoa5jAwMkxCykd6,4,2,0,0,0,0,5,0,7,1.0,1,0.0,0,0,0,0,2,0,0,5,0,0,7,1
11715,103746,rJa06nlcyBimvgL7PoPXhuOUbmR9mddR,SpATywNh6bZuzm8s1ceuBUnMUAeoAHHw,44,53,32,41,22,12,5,0,165,23.571428571428573,5,0.0,16,32,38,22,37,12,3,5,0,108,57,1
11716,103753,4wd4ZPQBIu7cqe3jxupr4Gm26uh0zMx7,A3fsA9Zfv1X2fVEQhTw51lKENdNrEqT3,9,3,2,0,2,5,13,1,26,3.7142857142857144,1,0.0,0,2,0,2,3,5,0,13,1,4,22,1
11717,103782,8E8MlkBOuzGaVSvo1UqdWtwoQrTmYFYq,5X6FeZozNMgE2VRi3MJYjkkFK8SETtu2,1,0,0,0,0,0,1,0,1,0.14285714285714285,1,0.0,0,0,0,0,0,0,0,1,0,0,1,1
11718,103794,x29OOChdmJGXK62DnUpwKbwJurqULmnD,SpATywNh6bZuzm8s1ceuBUnMUAeoAHHw,16,19,12,0,8,0,2,0,41,5.857142857142857,1,0.0,4,12,0,8,15,0,0,2,0,24,17,1
11719,103817,P8HECw7bHyNqGqPTlWbv24tTg1SG6bAf,5X6FeZozNMgE2VRi3MJYjkkFK8SETtu2,4,5,2,0,1,0,2,0,10,1.4285714285714286,2,0.0,1,2,0,1,4,0,0,2,0,4,6,1
11720,103837,nSjkfSPbC0LXqtynr3m9X0CV4GIunTid,G8EPVSXsOYB5YQWZGiz1aVq5Pgr2GrQu,5,2,1,0,1,0,2,0,6,0.8571428571428571,1,0.0,0,1,0,1,2,0,0,2,0,2,4,1
11721,103847,i4SeHiwnbIIoq9LoP3weAeDXl7e5RBtg,A3fsA9Zfv1X2fVEQhTw51lKENdNrEqT3,44,12,10,66,9,3,10,1,111,15.857142857142858,2,0.0,1,10,58,9,11,3,8,10,1,78,33,1
11722,103849,9poFqdhDn1jEwJp6tGIQlD3gMA14zAqO,SpATywNh6bZuzm8s1ceuBUnMUAeoAHHw,8,8,1,0,0,2,8,1,20,2.857142857142857,3,0.0,0,1,0,0,8,2,0,8,1,1,19,1
11723,103854,V8BBThgMaAUvnyEwHx5s0wvIZmg9ljiC,5X6FeZozNMgE2VRi3MJYjkkFK8SETtu2,6,3,2,0,1,0,5,2,13,1.8571428571428572,1,0.0,0,2,0,1,3,0,0,5,2,3,10,1
11724,103865,WuuGUCveHVXII42bEeLxc9ae8hzxCCU9,SpATywNh6bZuzm8s1ceuBUnMUAeoAHHw,4,4,0,0,0,1,3,0,8,1.1428571428571428,1,0.0,0,0,0,0,4,1,0,3,0,0,8,1
11725,103875,XmievsUMm7pYjS9V5usB7AjkzDHh9x5X,SpATywNh6bZuzm8s1ceuBUnMUAeoAHHw,5,2,1,0,1,0,2,0,6,0.8571428571428571,1,0.0,0,1,0,1,2,0,0,2,0,2,4,1
11726,103881,JNia6gKvSZOSZQHrR3Kro8PKF3m40Fop,A3fsA9Zfv1X2fVEQhTw51lKENdNrEqT3,1,0,0,0,0,0,1,0,1,0.14285714285714285,1,0.0,0,0,0,0,0,0,0,1,0,0,1,1
11727,103884,PGaKSLZzbsk1Y4PL9tj5XLuPkFqOZE5w,SpATywNh6bZuzm8s1ceuBUnMUAeoAHHw,2,0,0,0,0,0,2,0,2,0.2857142857142857,1,0.0,0,0,0,0,0,0,0,2,0,0,2,0
11728,103894,RS2Yi11w0LQ7fKvpNddEmwppsyvf2NcO,SpATywNh6bZuzm8s1ceuBUnMUAeoAHHw,14,8,6,0,5,0,5,1,25,3.5714285714285716,1,0.0,0,6,0,5,8,0,0,5,1,11,14,1
11729,103896,D5E2Qt7jBeIZBIFcDabwhaaXeayXbs8U,A3fsA9Zfv1X2fVEQhTw51lKENdNrEqT3,2,0,0,0,0,0,2,0,2,0.2857142857142857,1,0.0,0,0,0,0,0,0,0,2,0,0,2,1
11730,103902,Mm22Jz2IKnj929tEi3a7QaQsXH1twtvH,5X6FeZozNMgE2VRi3MJYjkkFK8SETtu2,4,2,1,0,1,0,2,0,6,0.8571428571428571,2,0.0,0,1,0,1,2,0,0,2,0,2,4,1
11731,103912,923Md4hufFSw6fyqcrCqvjLKbertSNtk,A3fsA9Zfv1X2fVEQhTw51lKENdNrEqT3,2,0,0,0,0,0,2,0,2,0.2857142857142857,1,0.0,0,0,0,0,0,0,0,2,0,0,2,1
11732,103930,Txv4UTCXPzwxfIDD6g3LwRLt3kYLBXuk,SpATywNh6bZuzm8s1ceuBUnMUAeoAHHw,37,73,14,31,5,48,20,0,191,27.285714285714285,13,0.0,21,14,27,5,52,48,4,20,0,67,124,0
11733,103942,JsgxGxJYDhwgnBgYbCILUrGTg0zFV4WJ,A3fsA9Zfv1X2fVEQhTw51lKENdNrEqT3,5,2,1,0,1,0,2,0,6,0.8571428571428571,1,0.0,0,1,0,1,2,0,0,2,0,2,4,1
11734,103953,IAJw4YtfScJYA1rvh3QXP9oI1WE1l0cK,SpATywNh6bZuzm8s1ceuBUnMUAeoAHHw,1,0,0,0,0,0,1,0,1,0.14285714285714285,1,0.0,0,0,0,0,0,0,0,1,0,0,1,1
11735,103958,1twD6my472TWNbA8IiJP0V3NsZHRSKHs,SpATywNh6bZuzm8s1ceuBUnMUAeoAHHw,9,8,1,0,1,3,8,1,22,3.142857142857143,1,0.0,2,1,0,1,6,3,0,8,1,4,18,0
11736,103963,dCHgtAVwX12C1h73zUIzcSalawnmf1Ly,SpATywNh6bZuzm8s1ceuBUnMUAeoAHHw,1,0,0,0,0,0,1,0,1,0.14285714285714285,1,0.0,0,0,0,0,0,0,0,1,0,0,1,1
11737,103991,ov5fYk5qZ3Ni8oW2PufqBBemq0WW1ldD,SpATywNh6bZuzm8s1ceuBUnMUAeoAHHw,7,4,2,0,2,0,2,0,10,1.4285714285714286,1,0.0,1,2,0,2,3,0,0,2,0,5,5,1
11738,104001,ZD6t0gZaLreJsx23cvmpLJAxc5XEYPzo,G8EPVSXsOYB5YQWZGiz1aVq5Pgr2GrQu,9,6,1,0,1,0,3,0,11,1.5714285714285714,1,0.0,0,1,0,1,6,0,0,3,0,2,9,1
11739,104008,TfPlmQ2inId9ipwO1Tkp44zWAUy81HnS,A3fsA9Zfv1X2fVEQhTw51lKENdNrEqT3,2,0,0,0,0,0,2,0,2,0.2857142857142857,1,0.0,0,0,0,0,0,0,0,2,0,0,2,1
11740,104034,uGLBXaq2O6Oj4FwXgJgHiKB87ZAsGOij,RXDvfPUBYFlVdlueBFbLW0mhhAyGEqpt,7,3,2,0,2,0,2,0,9,1.2857142857142858,1,0.0,0,2,0,2,3,0,0,2,0,4,5,1
11741,104043,CirrORwAsISzZWaS5RqwkDnMi23d5gz0,5X6FeZozNMgE2VRi3MJYjkkFK8SETtu2,5,2,1,0,1,0,2,0,6,0.8571428571428571,1,0.0,0,1,0,1,2,0,0,2,0,2,4,1
11742,104065,Mf49DzxpNroXZrZEzTyFS3opux1fUHZq,SpATywNh6bZuzm8s1ceuBUnMUAeoAHHw,4,2,1,0,1,0,1,0,5,0.7142857142857143,1,0.0,0,1,0,1,2,0,0,1,0,2,3,1
11743,104075,Jeb6HFnTv5BAeG7m0GpNhKDbGECtxEse,RXDvfPUBYFlVdlueBFbLW0mhhAyGEqpt,19,30,2,0,0,1,11,2,46,6.571428571428571,4,0.0,1,2,0,0,29,1,0,11,2,3,43,1
11744,104089,fGDhAQY2WhkQYcL5XaYeDMBiOUQEoTnX,bWdj2GDclj5ofokWjzoa5jAwMkxCykd6,19,11,6,86,5,0,5,0,113,16.142857142857142,2,0.0,3,6,77,5,8,0,9,5,0,91,22,1
11745,104091,Whrc7O8OYrwQtVL43oMCOWkRLnJ5RAnq,A3fsA9Zfv1X2fVEQhTw51lKENdNrEqT3,1,0,0,0,0,0,1,0,1,0.14285714285714285,1,0.0,0,0,0,0,0,0,0,1,0,0,1,1
11746,104095,YI86C9tMYiPNH60fwrrOqDqOHSDWv9QR,SpATywNh6bZuzm8s1ceuBUnMUAeoAHHw,5,2,1,0,1,0,2,0,6,0.8571428571428571,1,0.0,0,1,0,1,2,0,0,2,0,2,4,1
11747,104119,1aQoKDna73jstuOrupWa9Kq8V3FdvbRU,SpATywNh6bZuzm8s1ceuBUnMUAeoAHHw,6,3,2,0,2,0,2,0,9,1.2857142857142858,2,0.0,0,2,0,2,3,0,0,2,0,4,5,1
11748,104144,XFHjgUTOXGdMfDJPVsJ9fIgVszICPgyz,A3fsA9Zfv1X2fVEQhTw51lKENdNrEqT3,9,4,3,0,3,0,2,0,12,1.7142857142857142,1,0.0,0,3,0,3,4,0,0,2,0,6,6,1
11749,104157,3mm3mJxVS0eLh8IUtBxaLL8aknBAQjDa,bWdj2GDclj5ofokWjzoa5jAwMkxCykd6,1,0,0,0,0,0,1,0,1,0.14285714285714285,1,0.0,0,0,0,0,0,0,0,1,0,0,1,1
11750,104162,I8C35PB4HAz5bxjARemPN0YBdl9xTOvv,A3fsA9Zfv1X2fVEQhTw51lKENdNrEqT3,9,5,0,0,0,8,7,1,21,3.0,1,0.0,0,0,0,0,5,8,0,7,1,0,21,0
11751,104178,YTd6RUCxKSrzEOkqGgY5uphLrJJcaHu6,SpATywNh6bZuzm8s1ceuBUnMUAeoAHHw,4,3,0,0,0,0,1,0,4,0.5714285714285714,1,0.0,0,0,0,0,3,0,0,1,0,0,4,1
11752,104194,7EU7vMf2b4Xv6MdI3zbAqQNQTiRVSvYt,A3fsA9Zfv1X2fVEQhTw51lKENdNrEqT3,5,2,1,0,1,0,2,0,6,0.8571428571428571,1,0.0,0,1,0,1,2,0,0,2,0,2,4,1
11753,104211,t5GAapz2qu7QW3ZA52Mo1qG5gvWMLT4H,A3fsA9Zfv1X2fVEQhTw51lKENdNrEqT3,1,0,0,0,0,0,1,0,1,0.14285714285714285,1,0.0,0,0,0,0,0,0,0,1,0,0,1,1
11754,104219,r7mxDUU76gpRNfXXfJxT6UdxuWsIdonz,A3fsA9Zfv1X2fVEQhTw51lKENdNrEqT3,3,3,0,0,0,0,1,0,4,0.5714285714285714,1,0.0,1,0,0,0,2,0,0,1,0,1,3,1
11755,104241,ixafWGJcoRhCM5cJdtULfcNp2InCr2Sa,A3fsA9Zfv1X2fVEQhTw51lKENdNrEqT3,22,13,11,0,6,4,11,2,47,6.714285714285714,1,0.0,0,11,0,6,13,4,0,11,2,17,30,1
11756,104265,M2AmcvqhvMtUlyRV6vMvvoM2IhrMmAwT,5X6FeZozNMgE2VRi3MJYjkkFK8SETtu2,11,10,1,12,4,0,1,0,28,4.0,1,0.0,7,1,12,4,3,0,0,1,0,24,4,1
11757,104273,TldFKIBOCwaUWZkv8geqqO2kCXoWqpzq,SpATywNh6bZuzm8s1ceuBUnMUAeoAHHw,14,8,7,0,5,0,1,0,21,3.0,1,0.0,0,7,0,5,8,0,0,1,0,12,9,1
11758,104284,eTpWGRVGcm2Ik3M0L1jEIkegdNZVCw6R,SpATywNh6bZuzm8s1ceuBUnMUAeoAHHw,14,47,1,21,1,47,6,1,124,17.714285714285715,2,0.0,34,1,18,1,13,47,3,6,1,54,70,0
11759,104292,BhFlcQJWIjFJlF5Tqxm0xkVlpnp9sVr5,A3fsA9Zfv1X2fVEQhTw51lKENdNrEqT3,10,6,4,0,3,0,2,0,15,2.142857142857143,1,0.0,0,4,0,3,6,0,0,2,0,7,8,1
11760,104294,HTFrI1D4p0HbfBDMwhsdYfCOWsNzjXaR,SpATywNh6bZuzm8s1ceuBUnMUAeoAHHw,7,3,2,0,2,0,2,0,9,1.2857142857142858,1,0.0,0,2,0,2,3,0,0,2,0,4,5,1
11761,104296,qIvK9ObB3zgAcjyEoNQW2L93AtBba9D4,G8EPVSXsOYB5YQWZGiz1aVq5Pgr2GrQu,7,5,0,0,0,0,4,0,9,1.2857142857142858,1,0.0,0,0,0,0,5,0,0,4,0,0,9,0
11762,104301,Vy093XdUJPwNTmCPocZUTd1XYGzzyp34,G8EPVSXsOYB5YQWZGiz1aVq5Pgr2GrQu,2,0,0,0,0,0,2,0,2,0.2857142857142857,1,0.0,0,0,0,0,0,0,0,2,0,0,2,1
11763,104335,PcrKUgtxZcGXBYkLOmECh99m3fhAOabf,G8EPVSXsOYB5YQWZGiz1aVq5Pgr2GrQu,3,2,0,0,0,0,1,0,3,0.42857142857142855,1,0.0,0,0,0,0,2,0,0,1,0,0,3,1
11764,104337,dMZ9S55l3tq5M3A71U0KoWxXWAhXsFH4,SpATywNh6bZuzm8s1ceuBUnMUAeoAHHw,7,10,4,0,2,0,2,0,18,2.5714285714285716,1,0.0,0,4,0,2,10,0,0,2,0,6,12,1
11765,104341,2rPgSvtsbYrCOUBollArAnVMcQox4Rzz,SpATywNh6bZuzm8s1ceuBUnMUAeoAHHw,10,5,4,0,3,0,6,0,18,2.5714285714285716,1,0.0,0,4,0,3,5,0,0,6,0,7,11,1
11766,104352,Jc6Rj6cwfhWlrTpjaB2LnqARTW8Bbf0L,SpATywNh6bZuzm8s1ceuBUnMUAeoAHHw,5,3,1,0,1,0,2,0,7,1.0,1,0.0,0,1,0,1,3,0,0,2,0,2,5,1
11767,104356,Nvx1FqKYM0wMKIIRgD0fWbHs2ulluJLe,bWdj2GDclj5ofokWjzoa5jAwMkxCykd6,1,0,0,0,0,0,1,0,1,0.14285714285714285,1,0.0,0,0,0,0,0,0,0,1,0,0,1,1
11768,104358,Nvx1FqKYM0wMKIIRgD0fWbHs2ulluJLe,A3fsA9Zfv1X2fVEQhTw51lKENdNrEqT3,4,2,0,0,0,0,2,0,4,0.5714285714285714,1,0.0,0,0,0,0,2,0,0,2,0,0,4,1
11769,104361,xnObPmivHmj7phvTSVLNuvvFk898J2aO,RXDvfPUBYFlVdlueBFbLW0mhhAyGEqpt,1,0,0,0,0,0,1,0,1,0.14285714285714285,1,0.0,0,0,0,0,0,0,0,1,0,0,1,1
11770,104366,uLsUz9dpaUlUOxHeWF3yHSSVzvVLEW6w,SpATywNh6bZuzm8s1ceuBUnMUAeoAHHw,1,0,0,0,0,0,1,0,1,0.14285714285714285,1,0.0,0,0,0,0,0,0,0,1,0,0,1,1
11771,104391,jTauqnokjVi6ospRFXXduew42x2G5Up9,G8EPVSXsOYB5YQWZGiz1aVq5Pgr2GrQu,7,3,2,0,2,0,2,0,9,1.2857142857142858,1,0.0,0,2,0,2,3,0,0,2,0,4,5,1
11772,104410,ObbXaQT6J9VxlQqNb4O6euoNIJzHR7rT,SpATywNh6bZuzm8s1ceuBUnMUAeoAHHw,9,4,3,0,3,0,2,0,12,1.7142857142857142,1,0.0,0,3,0,3,4,0,0,2,0,6,6,1
11773,104411,pcsiSS3QOPo0n8yKp6skJyBWeonG4c8P,A3fsA9Zfv1X2fVEQhTw51lKENdNrEqT3,7,4,3,0,3,0,2,0,12,1.7142857142857142,1,0.0,0,3,0,3,4,0,0,2,0,6,6,1
11774,104432,nbu72Hfybp6pv1ykyATXAv2RfzFEFoR8,SpATywNh6bZuzm8s1ceuBUnMUAeoAHHw,12,12,0,20,0,4,5,0,41,5.857142857142857,1,0.0,5,0,17,0,7,4,3,5,0,22,19,1
11775,104441,xMs8rC8PWX4mnQhPoCok61SbExcNBkVe,SpATywNh6bZuzm8s1ceuBUnMUAeoAHHw,6,3,1,0,1,0,2,0,7,1.0,1,0.0,0,1,0,1,3,0,0,2,0,2,5,1
11776,104452,ziSW6xDH8gzyWXn2P08NFoRMJoG4EqEB,SpATywNh6bZuzm8s1ceuBUnMUAeoAHHw,12,25,12,0,7,0,2,0,46,6.571428571428571,1,0.0,4,12,0,7,21,0,0,2,0,23,23,1
11777,104453,8uGMX8Xu6j8RLuhsBjmFgfMaI4mZnvz1,SpATywNh6bZuzm8s1ceuBUnMUAeoAHHw,12,10,4,0,3,0,4,0,21,3.0,1,0.0,0,4,0,3,10,0,0,4,0,7,14,1
11778,104458,I3Y9SshT4Px6bPwzvv7ixI5CQirBePZQ,SpATywNh6bZuzm8s1ceuBUnMUAeoAHHw,6,12,6,0,0,0,4,0,22,3.142857142857143,3,0.0,0,6,0,0,12,0,0,4,0,6,16,1
11779,104463,DyQHVTNiwX6W4PiKOVh8BCoKQr8u7ImW,A3fsA9Zfv1X2fVEQhTw51lKENdNrEqT3,12,12,1,0,0,3,10,0,26,3.7142857142857144,1,0.0,1,1,0,0,11,3,0,10,0,2,24,1
11780,104464,4OFy9ZLb1svxpVgXkgI60wOGeiU4V4oA,G8EPVSXsOYB5YQWZGiz1aVq5Pgr2GrQu,1,0,0,0,0,0,1,0,1,0.14285714285714285,1,0.0,0,0,0,0,0,0,0,1,0,0,1,1
11781,104466,KXi2lu4GlKmrO1lJTLg3t4l701rvNXNZ,bWdj2GDclj5ofokWjzoa5jAwMkxCykd6,1,0,0,0,0,0,1,0,1,0.14285714285714285,1,0.0,0,0,0,0,0,0,0,1,0,0,1,1
11782,104468,qUJjM2rHGQKXLfW6M7Cfr4tvklEU6daf,SpATywNh6bZuzm8s1ceuBUnMUAeoAHHw,13,12,6,3,2,6,11,3,43,6.142857142857143,2,0.0,1,6,3,2,11,6,0,11,3,12,31,1
11783,104489,wT2PCRFj23I7HDSSujNYjrYVx91GnsP3,A3fsA9Zfv1X2fVEQhTw51lKENdNrEqT3,5,2,1,0,1,0,4,0,8,1.1428571428571428,3,0.0,0,1,0,1,2,0,0,4,0,2,6,0
11784,104492,tPRxZgUxDUTQm2PmIuX0fewSz7eitT8g,SpATywNh6bZuzm8s1ceuBUnMUAeoAHHw,1,0,0,0,0,0,1,0,1,0.14285714285714285,1,0.0,0,0,0,0,0,0,0,1,0,0,1,1
11785,104495,LYehQDSOM5PcdlXuo0xGoCftzdlyd2gI,A3fsA9Zfv1X2fVEQhTw51lKENdNrEqT3,4,0,0,0,0,0,4,0,4,0.5714285714285714,1,0.0,0,0,0,0,0,0,0,4,0,0,4,1
11786,104496,tWy6K2sNXVB2esbGJMyXdZRQGH2Klw9e,SpATywNh6bZuzm8s1ceuBUnMUAeoAHHw,1,0,0,0,0,0,1,0,1,0.14285714285714285,1,0.0,0,0,0,0,0,0,0,1,0,0,1,1
11787,104503,2jTGBIAeHp8pnl61IF8YWrKorMuy9KJe,SpATywNh6bZuzm8s1ceuBUnMUAeoAHHw,2,0,0,0,0,0,2,0,2,0.2857142857142857,1,0.0,0,0,0,0,0,0,0,2,0,0,2,1
11788,104509,oE1QbspE1VaPia0G9CbmnflG7dN6cZJM,SpATywNh6bZuzm8s1ceuBUnMUAeoAHHw,2,0,0,0,0,0,2,0,2,0.2857142857142857,1,0.0,0,0,0,0,0,0,0,2,0,0,2,1
11789,104515,KQvub9kHQ3XpwpO5JgmmZp67zs4af3TX,A3fsA9Zfv1X2fVEQhTw51lKENdNrEqT3,5,2,1,0,1,0,2,0,6,0.8571428571428571,1,0.0,0,1,0,1,2,0,0,2,0,2,4,1
11790,104521,i5EjwCywnHAh7QM2CMkeJsIdXa8rMV6i,bWdj2GDclj5ofokWjzoa5jAwMkxCykd6,2,0,0,0,0,0,2,0,2,0.2857142857142857,1,0.0,0,0,0,0,0,0,0,2,0,0,2,1
11791,104526,ydd1OhJLlZRjAmcrBX6w4fAjd763MlEr,SpATywNh6bZuzm8s1ceuBUnMUAeoAHHw,2,0,0,0,0,0,2,0,2,0.2857142857142857,1,0.0,0,0,0,0,0,0,0,2,0,0,2,1
11792,104531,VqPSgF7LIkhd0l6BSJd84AdcMj5MaqIS,SpATywNh6bZuzm8s1ceuBUnMUAeoAHHw,1,0,0,0,0,0,1,0,1,0.14285714285714285,1,0.0,0,0,0,0,0,0,0,1,0,0,1,1
11793,104540,WELjmgdsP962Pc1teJ96xvofKraKe6qa,bWdj2GDclj5ofokWjzoa5jAwMkxCykd6,8,5,3,0,1,13,11,0,33,4.714285714285714,5,0.0,0,3,0,1,5,13,0,11,0,4,29,0
11794,104546,h2uPViUap57On5JUqQ9igq5GDP75Rgzf,SpATywNh6bZuzm8s1ceuBUnMUAeoAHHw,24,34,15,9,8,2,11,1,80,11.428571428571429,3,0.0,3,15,9,8,31,2,0,11,1,35,45,1
11795,104548,V0AsQgHGQGwNZqmKaETWBrxe3WpC4m5k,SpATywNh6bZuzm8s1ceuBUnMUAeoAHHw,8,6,3,0,2,0,6,0,17,2.4285714285714284,1,0.0,0,3,0,2,6,0,0,6,0,5,12,1
11796,104555,PSygGEnajNdSwAgw8ZB2LUfijgMjfKqV,bWdj2GDclj5ofokWjzoa5jAwMkxCykd6,1,0,0,0,0,0,1,0,1,0.14285714285714285,1,0.0,0,0,0,0,0,0,0,1,0,0,1,1
11797,104582,xM1yUWSpt3htcKGdTrpZVO5ZeftoW9re,G8EPVSXsOYB5YQWZGiz1aVq5Pgr2GrQu,10,6,2,8,1,0,5,0,22,3.142857142857143,1,0.0,3,2,6,1,3,0,2,5,0,12,10,1
11798,104589,LOsVkswWxHe5YwcAM1YjHggicuRbJ5sf,SpATywNh6bZuzm8s1ceuBUnMUAeoAHHw,1,0,0,0,0,0,1,0,1,0.14285714285714285,1,0.0,0,0,0,0,0,0,0,1,0,0,1,1
11799,104590,hlub8IQ6xr3M5qQPn6YnEFWROpuhMcwL,A3fsA9Zfv1X2fVEQhTw51lKENdNrEqT3,9,2,1,0,1,2,10,1,17,2.4285714285714284,3,0.0,0,1,0,1,2,2,0,10,1,2,15,1
11800,104591,nZpaESUo0GJPIuUQLM7WpTAyDvRCYws3,SpATywNh6bZuzm8s1ceuBUnMUAeoAHHw,11,6,2,8,1,0,6,0,23,3.2857142857142856,1,0.0,2,2,6,1,4,0,2,6,0,11,12,1
11801,104593,Q37fGjJ8eugSdDYZTpXfPJGR1Hy2EJgr,A3fsA9Zfv1X2fVEQhTw51lKENdNrEqT3,8,2,1,0,1,1,6,1,12,1.7142857142857142,1,0.0,0,1,0,1,2,1,0,6,1,2,10,1
11802,104606,n0z9CmHQ1aT2Na1Alnc3POrgJ8DExUjg,G8EPVSXsOYB5YQWZGiz1aVq5Pgr2GrQu,8,12,3,0,3,1,4,0,23,3.2857142857142856,1,0.0,5,3,0,3,7,1,0,4,0,11,12,1
11803,104608,n0z9CmHQ1aT2Na1Alnc3POrgJ8DExUjg,A3fsA9Zfv1X2fVEQhTw51lKENdNrEqT3,1,0,0,0,0,0,1,0,1,0.14285714285714285,1,0.0,0,0,0,0,0,0,0,1,0,0,1,1
11804,104610,3C1lYSFixKkKNR8DGEXYYhDOAMAek2Zr,G8EPVSXsOYB5YQWZGiz1aVq5Pgr2GrQu,12,10,4,6,4,0,2,0,26,3.7142857142857144,1,0.0,5,4,3,4,5,0,3,2,0,16,10,1
11805,104613,Ek3NRIw6r3qK8qXdjTcUWOMSezARAlja,bWdj2GDclj5ofokWjzoa5jAwMkxCykd6,9,24,9,0,6,3,14,2,58,8.285714285714286,3,0.0,5,9,0,6,19,3,0,14,2,20,38,1
11806,104615,yfPEDU3OzZWMdKaypuOZrACuYp6GNcyd,A3fsA9Zfv1X2fVEQhTw51lKENdNrEqT3,1,0,0,0,0,0,2,0,2,0.2857142857142857,1,0.0,0,0,0,0,0,0,0,2,0,0,2,1
11807,104630,CtmqfatIKebJswM6ar9T0zVFJv52NCRl,G8EPVSXsOYB5YQWZGiz1aVq5Pgr2GrQu,7,11,0,0,0,0,5,0,16,2.2857142857142856,1,0.0,6,0,0,0,5,0,0,5,0,6,10,1
11808,104632,z2UutrDxctGBl3XhV09hNxXdsZmqDZvY,RXDvfPUBYFlVdlueBFbLW0mhhAyGEqpt,1,0,0,0,0,0,1,0,1,0.14285714285714285,1,0.0,0,0,0,0,0,0,0,1,0,0,1,1
11809,104633,CtmqfatIKebJswM6ar9T0zVFJv52NCRl,SpATywNh6bZuzm8s1ceuBUnMUAeoAHHw,7,5,0,0,0,0,3,0,8,1.1428571428571428,1,0.0,0,0,0,0,5,0,0,3,0,0,8,1
11810,104636,JgNllefl6lxMJFs121u0iwNrhgAg4Z2l,A3fsA9Zfv1X2fVEQhTw51lKENdNrEqT3,4,2,1,0,1,0,1,0,5,0.7142857142857143,1,0.0,0,1,0,1,2,0,0,1,0,2,3,1
11811,104642,OyCwM8soHH8QE4hfLYRsx6iyHPIOqWTw,SpATywNh6bZuzm8s1ceuBUnMUAeoAHHw,13,12,0,11,0,0,9,1,33,4.714285714285714,2,0.0,7,0,9,0,5,0,2,9,1,16,17,1
11812,104688,1vi3aoGF64IJNwusboKMOjObFPU3HDht,SpATywNh6bZuzm8s1ceuBUnMUAeoAHHw,14,15,6,15,4,0,2,0,42,6.0,1,0.0,8,6,12,4,7,0,3,2,0,30,12,0
11813,104693,vGcc0AnjpQHzU6MhASLVTSg5K7Oxs693,bWdj2GDclj5ofokWjzoa5jAwMkxCykd6,1,0,0,0,0,0,1,0,1,0.14285714285714285,1,0.0,0,0,0,0,0,0,0,1,0,0,1,0
11814,104697,HlYiU2TA92it9HWOPDlsBmlpdZ7J7QTJ,A3fsA9Zfv1X2fVEQhTw51lKENdNrEqT3,30,62,32,52,19,11,20,1,197,28.142857142857142,5,0.0,2,32,43,19,60,11,9,20,1,96,101,1
11815,104724,AO2DWs3lh9A1GvC8BAMupQKT1Hlk19lZ,A3fsA9Zfv1X2fVEQhTw51lKENdNrEqT3,5,7,0,0,0,0,6,0,13,1.8571428571428572,1,0.0,0,0,0,0,7,0,0,6,0,0,13,1
11816,104727,T8KPSkXPudd9vKVat9asv5ysr6zWaQCY,SpATywNh6bZuzm8s1ceuBUnMUAeoAHHw,15,25,2,19,0,1,9,2,58,8.285714285714286,1,0.0,9,2,16,0,16,1,3,9,2,27,31,1
11817,104735,XEAzAzWsIHOpS801lITcIzqWP1a4yYMV,SpATywNh6bZuzm8s1ceuBUnMUAeoAHHw,15,12,7,13,4,2,3,1,42,6.0,1,0.0,4,7,12,4,8,2,1,3,1,27,15,1
11818,104737,o6c539lwIkVrO8m1FxoLjW3D1hV2LZeV,SpATywNh6bZuzm8s1ceuBUnMUAeoAHHw,10,7,0,8,0,6,3,0,24,3.4285714285714284,2,0.0,2,0,7,0,5,6,1,3,0,9,15,1
11819,104746,Lzsz8G97Oqbb3ZBCI5dR9gHrqQ1EH7Ym,bWdj2GDclj5ofokWjzoa5jAwMkxCykd6,5,3,1,0,0,0,3,0,7,1.0,2,0.0,0,1,0,0,3,0,0,3,0,1,6,1
11820,104755,cwVdqEP9opAeKfgoOEHlcQUqgyjLtu9l,G8EPVSXsOYB5YQWZGiz1aVq5Pgr2GrQu,5,2,1,0,1,0,2,0,6,0.8571428571428571,1,0.0,0,1,0,1,2,0,0,2,0,2,4,1
11821,104757,couyquW2Z4n38XcaXOGqoUN34GlfxMVE,A3fsA9Zfv1X2fVEQhTw51lKENdNrEqT3,6,4,1,0,1,0,2,0,8,1.1428571428571428,1,0.0,0,1,0,1,4,0,0,2,0,2,6,0
11822,104762,Lo2vU6mH3fqBjPz8YtN99A9tnKdHVK6o,SpATywNh6bZuzm8s1ceuBUnMUAeoAHHw,8,11,7,0,4,0,8,0,30,4.285714285714286,2,0.0,0,7,0,4,11,0,0,8,0,11,19,1
11823,104767,futyrc5ZKHBBJxaxN8pRQj4FOD0yyEl8,RXDvfPUBYFlVdlueBFbLW0mhhAyGEqpt,7,13,7,0,1,0,4,0,25,3.5714285714285716,2,0.0,0,7,0,1,13,0,0,4,0,8,17,1
11824,104770,1O5EjoRsscLnc9nXfpqkKtbnynlBSzrx,SpATywNh6bZuzm8s1ceuBUnMUAeoAHHw,6,3,2,0,0,0,3,0,8,1.1428571428571428,1,0.0,0,2,0,0,3,0,0,3,0,2,6,1
11825,104774,tBbhVMYYQ6OTtHw8ihRfnNPpAK2u2FCV,SpATywNh6bZuzm8s1ceuBUnMUAeoAHHw,10,16,7,0,4,0,1,0,28,4.0,1,0.0,0,7,0,4,16,0,0,1,0,11,17,1
11826,104777,7AcpuVe6H4EQE4t982IHxKSRBEP280dQ,SpATywNh6bZuzm8s1ceuBUnMUAeoAHHw,11,13,1,16,0,6,5,1,42,6.0,1,0.0,6,1,15,0,7,6,1,5,1,22,20,1
11827,104784,A7BPMFQzaFIvFoWRCDmdq1av9dzZSKUQ,SpATywNh6bZuzm8s1ceuBUnMUAeoAHHw,1,0,0,0,0,0,1,0,1,0.14285714285714285,1,0.0,0,0,0,0,0,0,0,1,0,0,1,1
11828,104792,uMEUDlZ1tL8WoZ2EmL0CStSYwA0zOal8,SpATywNh6bZuzm8s1ceuBUnMUAeoAHHw,6,3,2,0,2,0,1,0,8,1.1428571428571428,1,0.0,0,2,0,2,3,0,0,1,0,4,4,1
11829,104793,qDtFi7e90cUeHzM7V0dyqooeuFxEYpNm,SpATywNh6bZuzm8s1ceuBUnMUAeoAHHw,7,3,2,0,2,0,2,0,9,1.2857142857142858,1,0.0,0,2,0,2,3,0,0,2,0,4,5,1
11830,104795,cjnjr7Duofdr7KxOEuxuSM38OHUgNo60,G8EPVSXsOYB5YQWZGiz1aVq5Pgr2GrQu,18,27,6,0,6,0,15,1,55,7.857142857142857,2,0.0,0,6,0,6,27,0,0,15,1,12,43,0
11831,104800,mz4uLo9BLm8C45jnilK7oxFwMZeC54GR,A3fsA9Zfv1X2fVEQhTw51lKENdNrEqT3,8,6,1,0,0,3,5,0,15,2.142857142857143,1,0.0,0,1,0,0,6,3,0,5,0,1,14,1
11832,104801,dDRiefJH6VL2xh5SH3Jn4nOIwtp9UE53,SpATywNh6bZuzm8s1ceuBUnMUAeoAHHw,4,0,0,0,0,0,5,0,5,0.7142857142857143,1,0.0,0,0,0,0,0,0,0,5,0,0,5,1
11833,104811,xhZvMzC7C3FI6QGx1nJhPvhS30jV3HlC,SpATywNh6bZuzm8s1ceuBUnMUAeoAHHw,1,0,0,0,0,0,1,0,1,0.14285714285714285,1,0.0,0,0,0,0,0,0,0,1,0,0,1,1
11834,104815,I3l3i5FdvqNSQ2HVtWbrElKwC57iq42m,SpATywNh6bZuzm8s1ceuBUnMUAeoAHHw,6,4,1,0,1,0,2,0,8,1.1428571428571428,1,0.0,1,1,0,1,3,0,0,2,0,3,5,1
11835,104817,kCDwRCPqHBdxL6Zm4oP4P8LFVB7ooBk2,A3fsA9Zfv1X2fVEQhTw51lKENdNrEqT3,1,0,0,0,0,0,1,0,1,0.14285714285714285,1,0.0,0,0,0,0,0,0,0,1,0,0,1,1
11836,104821,HZ09CsQBbpW2jBqTRwR09w2caEvBXEBF,SpATywNh6bZuzm8s1ceuBUnMUAeoAHHw,11,9,0,18,0,0,2,0,29,4.142857142857143,1,0.0,2,0,15,0,7,0,3,2,0,17,12,0
11837,104824,zoXigsWBjyJG6OSyWQP4Y5frh0Mc9ncS,A3fsA9Zfv1X2fVEQhTw51lKENdNrEqT3,5,3,1,0,1,0,3,0,8,1.1428571428571428,1,0.0,1,1,0,1,2,0,0,3,0,3,5,1
11838,104825,fPBHPutjsyATgfjDez6QiXqE3EQ549Sn,bWdj2GDclj5ofokWjzoa5jAwMkxCykd6,10,9,2,56,3,3,5,1,79,11.285714285714286,1,0.0,5,2,53,3,4,3,3,5,1,63,16,1
11839,104828,TvgIXPYmwQ8PEavqO4tLfxpm2FF8nOoT,RXDvfPUBYFlVdlueBFbLW0mhhAyGEqpt,5,2,1,0,1,0,3,0,7,1.0,1,0.0,0,1,0,1,2,0,0,3,0,2,5,1
11840,104835,Ri95AXIo8zsMGIr8iLd7Nlf3hXPlEtcm,SpATywNh6bZuzm8s1ceuBUnMUAeoAHHw,5,3,1,0,0,0,2,0,6,0.8571428571428571,1,0.0,0,1,0,0,3,0,0,2,0,1,5,1
11841,104851,zjreW3h1Ea5BeCNB7vdMhwpbveHkJfhN,SpATywNh6bZuzm8s1ceuBUnMUAeoAHHw,7,2,1,0,1,1,4,1,10,1.4285714285714286,1,0.0,0,1,0,1,2,1,0,4,1,2,8,1
11842,104852,YjmLtoh2FsHRMNwgNAtlpUzEWjN5nhAS,SpATywNh6bZuzm8s1ceuBUnMUAeoAHHw,7,3,2,0,2,0,2,0,9,1.2857142857142858,1,0.0,0,2,0,2,3,0,0,2,0,4,5,1
11843,104857,EfAzIK92h28Gz4WXYVhp9fzk6YRB1DXC,A3fsA9Zfv1X2fVEQhTw51lKENdNrEqT3,1,0,0,0,0,0,1,0,1,0.14285714285714285,1,0.0,0,0,0,0,0,0,0,1,0,0,1,0
11844,104865,w1QHQFv3RratMvfK2BnfmiIqIYey1EzI,bWdj2GDclj5ofokWjzoa5jAwMkxCykd6,12,10,1,72,4,0,1,0,88,12.571428571428571,1,0.0,6,1,70,4,4,0,2,1,0,81,7,1
11845,104867,vO07VFd2DYWPdrvNiSqsqXFTXPKE00c4,RXDvfPUBYFlVdlueBFbLW0mhhAyGEqpt,1,0,0,0,0,0,1,0,1,0.14285714285714285,1,0.0,0,0,0,0,0,0,0,1,0,0,1,1
11846,104879,KLWMzt2lbmi8onKYKX9eWLl5lpM0wx0M,A3fsA9Zfv1X2fVEQhTw51lKENdNrEqT3,30,11,8,46,6,1,7,1,80,11.428571428571429,2,0.0,0,8,39,6,11,1,7,7,1,53,27,1
11847,104881,RGtc1IdNIb5F1GGBZyglC3Cmje3Zbvbo,SpATywNh6bZuzm8s1ceuBUnMUAeoAHHw,1,0,0,0,0,0,1,0,1,0.14285714285714285,1,0.0,0,0,0,0,0,0,0,1,0,0,1,1
11848,104892,knqmj88BDpPhBept6EC2R3YJ3D5KQUZz,SpATywNh6bZuzm8s1ceuBUnMUAeoAHHw,6,4,1,0,1,0,2,0,8,1.1428571428571428,1,0.0,0,1,0,1,4,0,0,2,0,2,6,1
11849,104895,pOlc1xunOD2pPlaz6EGQWZcGB6A8fwQn,SpATywNh6bZuzm8s1ceuBUnMUAeoAHHw,6,5,0,0,0,0,2,0,7,1.0,1,0.0,0,0,0,0,5,0,0,2,0,0,7,1
11850,104916,Pe6a7Y0LdkKZQUrgr38AH2nCOR1VUYXS,SpATywNh6bZuzm8s1ceuBUnMUAeoAHHw,20,26,13,16,9,0,3,0,67,9.571428571428571,2,0.0,7,13,15,9,19,0,1,3,0,44,23,0
11851,104920,CGn56kdY0PhcUPAztOY3cUKmF6tF5atc,RXDvfPUBYFlVdlueBFbLW0mhhAyGEqpt,5,2,1,0,1,0,2,0,6,0.8571428571428571,1,0.0,0,1,0,1,2,0,0,2,0,2,4,1
11852,104924,e1PghwtNUGs6vA3J705NBEUcrBHwivKH,G8EPVSXsOYB5YQWZGiz1aVq5Pgr2GrQu,19,19,1,32,0,1,13,1,67,9.571428571428571,2,0.0,2,1,28,0,17,1,4,13,1,31,36,0
11853,104925,EmcvJhyzyIpQugXCF4WUuZQjl0kHTxx5,SpATywNh6bZuzm8s1ceuBUnMUAeoAHHw,5,2,1,0,1,0,2,0,6,0.8571428571428571,1,0.0,0,1,0,1,2,0,0,2,0,2,4,1
11854,104926,ONFhYKrJFqmwx9zBxMrT7qWQQw1Hgoxe,SpATywNh6bZuzm8s1ceuBUnMUAeoAHHw,8,7,3,0,2,0,2,0,14,2.0,1,0.0,3,3,0,2,4,0,0,2,0,8,6,1
11855,104928,hp7Gqo5252E9slRfXH0KFbulYobVoVWo,SpATywNh6bZuzm8s1ceuBUnMUAeoAHHw,7,5,3,0,1,0,4,0,13,1.8571428571428572,1,0.0,1,3,0,1,4,0,0,4,0,5,8,1
11856,104936,9xV1wwHzLoXwKNrE0sl58GGQQc4oj1NS,bWdj2GDclj5ofokWjzoa5jAwMkxCykd6,4,2,1,0,0,0,6,0,9,1.2857142857142858,3,0.0,0,1,0,0,2,0,0,6,0,1,8,1
11857,104943,8yrIKDtnkYcLfERwrXrvcRGxHxbt2Jd3,RXDvfPUBYFlVdlueBFbLW0mhhAyGEqpt,5,4,0,0,0,1,3,0,8,1.1428571428571428,1,0.0,0,0,0,0,4,1,0,3,0,0,8,1
11858,104947,MRBkmzjOlIfmLj12ExsDOcm0igHkBWY5,SpATywNh6bZuzm8s1ceuBUnMUAeoAHHw,4,2,0,0,0,0,2,0,4,0.5714285714285714,1,0.0,0,0,0,0,2,0,0,2,0,0,4,1
11859,104948,GEo21EE9t59WNpPzwlumpgmynliuHSiq,SpATywNh6bZuzm8s1ceuBUnMUAeoAHHw,3,0,0,0,0,0,3,0,3,0.42857142857142855,1,0.0,0,0,0,0,0,0,0,3,0,0,3,1
11860,104968,7cuOR7XN3OKWyCY4rmOlBcFyB6vgzoQs,A3fsA9Zfv1X2fVEQhTw51lKENdNrEqT3,3,0,0,0,0,0,4,0,4,0.5714285714285714,1,0.0,0,0,0,0,0,0,0,4,0,0,4,1
11861,104978,4p8c3FKQ0TxdvnCwTtbL9bKeePWMVkGP,SpATywNh6bZuzm8s1ceuBUnMUAeoAHHw,1,0,0,0,0,0,3,0,3,0.42857142857142855,1,0.0,0,0,0,0,0,0,0,3,0,0,3,1
11862,104984,0BvOWU3Vj9nIRblTj7EEskLoO3PxCxAy,bWdj2GDclj5ofokWjzoa5jAwMkxCykd6,5,2,1,0,1,0,5,0,9,1.2857142857142858,1,0.0,0,1,0,1,2,0,0,5,0,2,7,1
11863,104997,ve3dSb9Szfp4MnOfHAgrGxXGtdEF42Tp,A3fsA9Zfv1X2fVEQhTw51lKENdNrEqT3,10,4,3,0,3,0,3,0,13,1.8571428571428572,1,0.0,0,3,0,3,4,0,0,3,0,6,7,1
11864,105008,yV65Fr78Zm5MeDBgymBFgzc66d5t5Zmy,SpATywNh6bZuzm8s1ceuBUnMUAeoAHHw,12,24,14,0,0,2,13,2,55,7.857142857142857,1,0.0,7,14,0,0,17,2,0,13,2,21,34,0
11865,105014,qUdYzd5flRA3GCXiGt7tidXnS0F0FsHM,SpATywNh6bZuzm8s1ceuBUnMUAeoAHHw,5,3,0,0,0,0,4,2,9,1.2857142857142858,1,0.0,0,0,0,0,3,0,0,4,2,0,9,1
11866,105023,JKdKVDiZ9BQn8tsX4CdH77AcEG85EmQH,SpATywNh6bZuzm8s1ceuBUnMUAeoAHHw,5,3,1,0,0,0,3,0,7,1.0,1,0.0,0,1,0,0,3,0,0,3,0,1,6,1
11867,105024,7NRmTpdp1LUibho8qoHBLQ3GcaVtwUud,SpATywNh6bZuzm8s1ceuBUnMUAeoAHHw,1,0,0,0,0,0,1,0,1,0.14285714285714285,1,0.0,0,0,0,0,0,0,0,1,0,0,1,1
11868,105029,AdZFV9sO1gJgqtrxJrKT3ZcjH3XA6zTA,RXDvfPUBYFlVdlueBFbLW0mhhAyGEqpt,1,0,0,0,0,0,1,0,1,0.14285714285714285,1,0.0,0,0,0,0,0,0,0,1,0,0,1,1
11869,105030,QtcaqP1Oq08hvIX3wqGcQDC13eo6FjVm,SpATywNh6bZuzm8s1ceuBUnMUAeoAHHw,11,11,7,0,5,1,5,1,30,4.285714285714286,1,0.0,0,7,0,5,11,1,0,5,1,12,18,1
11870,105036,ynZ1Df4G2ARwLF4O85BSlMjjeKhXCtXL,SpATywNh6bZuzm8s1ceuBUnMUAeoAHHw,4,4,0,0,0,0,3,0,7,1.0,1,0.0,0,0,0,0,4,0,0,3,0,0,7,1
11871,105049,5GS5OD1cmKWecEPymf3UVauvWYXb9WHE,A3fsA9Zfv1X2fVEQhTw51lKENdNrEqT3,1,0,0,0,0,0,1,0,1,0.14285714285714285,1,0.0,0,0,0,0,0,0,0,1,0,0,1,1
11872,105053,pNgLScEwGgq81vg0a0cEXKNs5eG2UXph,bWdj2GDclj5ofokWjzoa5jAwMkxCykd6,1,0,0,0,0,0,1,0,1,0.14285714285714285,1,0.0,0,0,0,0,0,0,0,1,0,0,1,1
11873,105055,J7rstoE2U9Xgk66AuMKUxWUISAvdCQAz,G8EPVSXsOYB5YQWZGiz1aVq5Pgr2GrQu,12,11,1,6,2,1,5,1,27,3.857142857142857,1,0.0,5,1,3,2,6,1,3,5,1,11,16,1
11874,105057,QhYcOEapN0nrffEwA6S7jQzZwToRePP8,A3fsA9Zfv1X2fVEQhTw51lKENdNrEqT3,1,0,0,0,0,0,1,0,1,0.14285714285714285,1,0.0,0,0,0,0,0,0,0,1,0,0,1,1
11875,105059,KbGfmKt9ZBLOdWhdHwa3KVnLDM8esaSY,bWdj2GDclj5ofokWjzoa5jAwMkxCykd6,6,6,4,0,0,0,3,0,13,1.8571428571428572,1,0.0,0,4,0,0,6,0,0,3,0,4,9,1
11876,105061,jbwkj7UcLcGeNeVIuodsT34xBiopSnSK,A3fsA9Zfv1X2fVEQhTw51lKENdNrEqT3,2,0,0,0,0,0,3,0,3,0.42857142857142855,1,0.0,0,0,0,0,0,0,0,3,0,0,3,0
11877,105065,qhE0nq1HVP5Z55HX3UNFMVHvllKc96Rl,SpATywNh6bZuzm8s1ceuBUnMUAeoAHHw,7,8,2,0,1,0,4,0,15,2.142857142857143,3,0.0,0,2,0,1,8,0,0,4,0,3,12,1
11878,105070,C6BeEBrAxqOuF3t7YwEepluTHqEHWFpN,G8EPVSXsOYB5YQWZGiz1aVq5Pgr2GrQu,5,4,1,0,1,0,1,0,7,1.0,1,0.0,0,1,0,1,4,0,0,1,0,2,5,1
11879,105071,NSXDiRfuzySceLFWn0ct3CJviCtJc0Gq,SpATywNh6bZuzm8s1ceuBUnMUAeoAHHw,1,0,0,0,0,0,1,0,1,0.14285714285714285,1,0.0,0,0,0,0,0,0,0,1,0,0,1,1
11880,105074,O4P6YgbHRYZHkVgbR7e9lebrpm34oAOF,G8EPVSXsOYB5YQWZGiz1aVq5Pgr2GrQu,2,0,0,0,0,0,2,0,2,0.2857142857142857,1,0.0,0,0,0,0,0,0,0,2,0,0,2,1
11881,105076,drf1IY3xrpWQ9619UjKLyUfcUQsAdZju,bWdj2GDclj5ofokWjzoa5jAwMkxCykd6,5,3,1,0,1,0,2,0,7,1.0,1,0.0,0,1,0,1,3,0,0,2,0,2,5,1
11882,105082,0V54aOwQrSAMewtMntBBMI7Ks56rZdIS,A3fsA9Zfv1X2fVEQhTw51lKENdNrEqT3,12,6,4,0,2,1,7,0,20,2.857142857142857,1,0.0,0,4,0,2,6,1,0,7,0,6,14,1
11883,105085,aBoQ4OrEI4L04m6kqgzVP3CKZVnd2VFV,A3fsA9Zfv1X2fVEQhTw51lKENdNrEqT3,9,9,1,0,1,0,6,1,18,2.5714285714285716,1,0.0,0,1,0,1,9,0,0,6,1,2,16,1
11884,105105,aBoQ4OrEI4L04m6kqgzVP3CKZVnd2VFV,bWdj2GDclj5ofokWjzoa5jAwMkxCykd6,5,4,0,0,1,0,3,0,8,1.1428571428571428,1,0.0,2,0,0,1,2,0,0,3,0,3,5,1
11885,105107,kJpZNsO69ywT5OXmlvOgbLwUz2WmPek1,SpATywNh6bZuzm8s1ceuBUnMUAeoAHHw,13,11,5,14,3,0,2,0,35,5.0,1,0.0,5,5,11,3,6,0,3,2,0,24,11,1
11886,105146,hzBzR1u0wuRoc2H2cG5d9FzvO4PwKrLQ,SpATywNh6bZuzm8s1ceuBUnMUAeoAHHw,7,27,8,0,4,6,8,0,53,7.571428571428571,3,0.0,6,8,0,4,21,6,0,8,0,18,35,1
11887,105153,qTzYx0lbBuxcg0Yki7msaMyOo4bFeb91,SpATywNh6bZuzm8s1ceuBUnMUAeoAHHw,29,32,19,27,7,0,15,0,100,14.285714285714286,5,0.0,6,19,26,7,26,0,1,15,0,58,42,0
11888,105158,CCtqoOTfmYZ29m0AHaWWxr5jrw4v0sd6,A3fsA9Zfv1X2fVEQhTw51lKENdNrEqT3,2,0,0,0,0,0,2,0,2,0.2857142857142857,1,0.0,0,0,0,0,0,0,0,2,0,0,2,1
11889,105161,e8r3psiscML69Zoh8ndZVq9bRmvgsAna,RXDvfPUBYFlVdlueBFbLW0mhhAyGEqpt,3,0,0,0,0,0,4,0,4,0.5714285714285714,1,0.0,0,0,0,0,0,0,0,4,0,0,4,1
11890,105162,k5TsyI58X8P4Z61qSJPkdF5Bt76uuEiR,A3fsA9Zfv1X2fVEQhTw51lKENdNrEqT3,6,5,0,0,0,0,5,0,10,1.4285714285714286,1,0.0,0,0,0,0,5,0,0,5,0,0,10,1
11891,105165,WmDH79DnUcU85ObQwdrX32y257qi5DRa,SpATywNh6bZuzm8s1ceuBUnMUAeoAHHw,5,6,4,0,0,0,2,0,12,1.7142857142857142,1,0.0,1,4,0,0,5,0,0,2,0,5,7,1
11892,105182,w5agfaMGeGtqcOtE7XkU1SDkqYl8T1h1,A3fsA9Zfv1X2fVEQhTw51lKENdNrEqT3,8,5,3,0,2,0,6,1,17,2.4285714285714284,1,0.0,0,3,0,2,5,0,0,6,1,5,12,1
11893,105191,BFrfDseDfXCBvtTfCsJAy36Ogk6b0Rfx,G8EPVSXsOYB5YQWZGiz1aVq5Pgr2GrQu,7,7,3,0,2,0,2,0,14,2.0,2,0.0,0,3,0,2,7,0,0,2,0,5,9,1
11894,105194,5KBUyFUobvfAu8D7u7bO9wAPV4vuXQZU,A3fsA9Zfv1X2fVEQhTw51lKENdNrEqT3,43,73,20,76,13,0,12,0,194,27.714285714285715,2,0.0,4,20,67,13,69,0,9,12,0,104,90,0
11895,105199,OX6Bv3g06ycMeO3pZBZoU81BWj7ixSi4,A3fsA9Zfv1X2fVEQhTw51lKENdNrEqT3,5,6,0,0,0,0,5,0,11,1.5714285714285714,1,0.0,0,0,0,0,6,0,0,5,0,0,11,1
11896,105209,H9GkE0FMgvPMf43bNx1b9TXX6TZkGY34,SpATywNh6bZuzm8s1ceuBUnMUAeoAHHw,8,10,4,0,0,0,8,0,22,3.142857142857143,2,0.0,0,4,0,0,10,0,0,8,0,4,18,1
11897,105210,4gTXYNChXbNDMcXayBSE04FxQ2nn4APt,SpATywNh6bZuzm8s1ceuBUnMUAeoAHHw,9,11,6,0,4,7,4,0,32,4.571428571428571,1,0.0,0,6,0,4,11,7,0,4,0,10,22,1
11898,105217,OTdrNhcnMXK6bAJrTqNFs6h1YG7CDhcG,SpATywNh6bZuzm8s1ceuBUnMUAeoAHHw,10,10,3,0,2,3,6,3,27,3.857142857142857,1,0.0,0,3,0,2,10,3,0,6,3,5,22,1
11899,105234,taq5KphdnNYof9EF9ofKeGcG174vbrqW,SpATywNh6bZuzm8s1ceuBUnMUAeoAHHw,7,3,2,0,2,0,3,0,10,1.4285714285714286,1,0.0,0,2,0,2,3,0,0,3,0,4,6,1
11900,105243,cOQL66KmsXcVQs1SDl21ZVtRVEM2A2Mr,SpATywNh6bZuzm8s1ceuBUnMUAeoAHHw,15,16,4,17,3,0,6,0,46,6.571428571428571,1,0.0,8,4,14,3,8,0,3,6,0,29,17,1
11901,105249,TS1ZCG3Pe57Kb9bO3M4HccqPzgampcZm,RXDvfPUBYFlVdlueBFbLW0mhhAyGEqpt,1,0,0,0,0,0,1,0,1,0.14285714285714285,1,0.0,0,0,0,0,0,0,0,1,0,0,1,1
11902,105252,0XkWdOrszvLHfOAiz41vzdHNx25DrTO5,SpATywNh6bZuzm8s1ceuBUnMUAeoAHHw,18,24,9,14,4,2,7,1,61,8.714285714285714,1,0.0,12,9,13,4,12,2,1,7,1,38,23,1
11903,105253,HVCfWzPuIjheqdsfcEfqumsi8ZGav6vR,SpATywNh6bZuzm8s1ceuBUnMUAeoAHHw,10,14,8,0,3,0,5,0,30,4.285714285714286,1,0.0,0,8,0,3,14,0,0,5,0,11,19,1
11904,105260,IK3mtf86eqab6u3Svud8svoyG25XbueY,SpATywNh6bZuzm8s1ceuBUnMUAeoAHHw,13,14,3,17,1,0,5,0,40,5.714285714285714,2,0.0,2,3,15,1,12,0,2,5,0,21,19,1
11905,105262,47V3QOKZAFRfMjY5qh3dGgU05qgUrwzk,SpATywNh6bZuzm8s1ceuBUnMUAeoAHHw,26,32,14,19,7,11,8,0,91,13.0,4,0.0,5,14,18,7,27,11,1,8,0,44,47,0
11906,105263,4HfbFsCyYszJO7w4OHW3KiOw346tCEQ3,RXDvfPUBYFlVdlueBFbLW0mhhAyGEqpt,9,11,8,0,2,0,3,0,24,3.4285714285714284,2,0.0,0,8,0,2,11,0,0,3,0,10,14,0
11907,105269,Kbp64JoaypwT9V2b1Sun21o5uQW5G9la,SpATywNh6bZuzm8s1ceuBUnMUAeoAHHw,6,3,2,0,2,0,1,0,8,1.1428571428571428,1,0.0,0,2,0,2,3,0,0,1,0,4,4,1
11908,105271,b1VyhJSDHv0QJ3rH7siQ8iNr5JEetUc9,RXDvfPUBYFlVdlueBFbLW0mhhAyGEqpt,17,42,13,0,8,1,10,1,75,10.714285714285714,2,0.0,13,13,0,8,29,1,0,10,1,34,41,1
11909,105273,eGtLsIjZlkWgWdMhhuLPGoqFtXLYqSzQ,G8EPVSXsOYB5YQWZGiz1aVq5Pgr2GrQu,11,14,8,0,5,0,5,0,32,4.571428571428571,1,0.0,0,8,0,5,14,0,0,5,0,13,19,0
11910,105274,6nb23dYhCIP1cVQ6kR327mxTR7zAmW6A,SpATywNh6bZuzm8s1ceuBUnMUAeoAHHw,15,13,9,3,5,0,3,0,33,4.714285714285714,2,0.0,2,9,3,5,11,0,0,3,0,19,14,1
11911,105289,BRC3IBMyw5vaRtTzcXuOEQUfoXyf29w0,G8EPVSXsOYB5YQWZGiz1aVq5Pgr2GrQu,8,2,1,0,2,0,3,0,8,1.1428571428571428,1,0.0,0,1,0,2,2,0,0,3,0,3,5,1
11912,105306,drUu3tyovHqnF7EAaPHayHDYbWMe2Od6,bWdj2GDclj5ofokWjzoa5jAwMkxCykd6,1,0,0,0,0,0,1,0,1,0.14285714285714285,1,0.0,0,0,0,0,0,0,0,1,0,0,1,1
11913,105322,CSp8QkNZa6B12LzJipxPFgC5w6lKLtbn,SpATywNh6bZuzm8s1ceuBUnMUAeoAHHw,1,0,0,0,0,0,1,0,1,0.14285714285714285,1,0.0,0,0,0,0,0,0,0,1,0,0,1,1
11914,105331,Sk4DUKJRImF6lijTnkABuH01jDj9zcnP,bWdj2GDclj5ofokWjzoa5jAwMkxCykd6,4,5,3,0,0,5,5,0,18,2.5714285714285716,2,0.0,0,3,0,0,5,5,0,5,0,3,15,1
11915,105347,CvSKLBTIxxGXbtAVP0WUmmB2Wsdsb6DU,SpATywNh6bZuzm8s1ceuBUnMUAeoAHHw,31,48,1,28,3,10,15,1,106,15.142857142857142,2,0.0,12,1,26,3,36,10,2,15,1,42,64,0
11916,105360,OWE34kkoT9KAMAmKtdn3UxQ37r5Vj3AT,SpATywNh6bZuzm8s1ceuBUnMUAeoAHHw,7,5,0,0,0,0,2,0,7,1.0,1,0.0,0,0,0,0,5,0,0,2,0,0,7,1
11917,105365,4ReTrx0DPSKofx7nLibnDMfTITGlbh8n,SpATywNh6bZuzm8s1ceuBUnMUAeoAHHw,7,6,3,0,2,0,3,0,14,2.0,2,0.0,0,3,0,2,6,0,0,3,0,5,9,1
11918,105366,dcPEtQ1aJsWPQvIFxgPvwR3ekqBX6ZB0,SpATywNh6bZuzm8s1ceuBUnMUAeoAHHw,1,0,0,0,0,0,1,0,1,0.14285714285714285,1,0.0,0,0,0,0,0,0,0,1,0,0,1,1
11919,105375,4Z0DzzRnG5ol9npBuWMZsHzI0G7yrdgb,SpATywNh6bZuzm8s1ceuBUnMUAeoAHHw,1,0,0,0,0,0,1,0,1,0.14285714285714285,1,0.0,0,0,0,0,0,0,0,1,0,0,1,1
11920,105377,ugyzx2kY0haeVd2DKPlWf2u8TPvIWwdG,SpATywNh6bZuzm8s1ceuBUnMUAeoAHHw,10,8,6,0,3,1,6,1,25,3.5714285714285716,1,0.0,0,6,0,3,8,1,0,6,1,9,16,1
11921,105382,OBVOXM1wUEgaM1Ic1TPHZnmgDHa3Iw3E,SpATywNh6bZuzm8s1ceuBUnMUAeoAHHw,5,2,1,0,1,0,2,0,6,0.8571428571428571,1,0.0,0,1,0,1,2,0,0,2,0,2,4,1
11922,105403,BAyiuAHT9YavjRYUTL3SqAF5fajY78B8,G8EPVSXsOYB5YQWZGiz1aVq5Pgr2GrQu,9,5,4,0,4,0,2,0,15,2.142857142857143,1,0.0,0,4,0,4,5,0,0,2,0,8,7,1
11923,105405,itFrYwUUr3TPc7mZS2RWfo2HaYAcNOxB,SpATywNh6bZuzm8s1ceuBUnMUAeoAHHw,15,13,6,13,4,1,9,0,46,6.571428571428571,1,0.0,4,6,12,4,9,1,1,9,0,26,20,1
11924,105409,vqSgORDp5PsEpveQVJoPh4dnJvR6AQkK,bWdj2GDclj5ofokWjzoa5jAwMkxCykd6,1,0,0,0,0,0,1,0,1,0.14285714285714285,1,0.0,0,0,0,0,0,0,0,1,0,0,1,1
11925,105412,6d0wTeGZDr0ncgCyWQX4AMn46gB2ZbPz,bWdj2GDclj5ofokWjzoa5jAwMkxCykd6,6,2,1,0,1,0,3,0,7,1.0,1,0.0,0,1,0,1,2,0,0,3,0,2,5,1
11926,105413,uTHtFLFEH5oi1Mhz7WcXFhd8fnlKyBlD,SpATywNh6bZuzm8s1ceuBUnMUAeoAHHw,11,10,6,0,4,0,2,0,22,3.142857142857143,1,0.0,1,6,0,4,9,0,0,2,0,11,11,1
11927,105431,7bBbNS8igBUmtAlhgWeyPaLpz7A08m0l,A3fsA9Zfv1X2fVEQhTw51lKENdNrEqT3,6,6,4,0,1,0,4,0,15,2.142857142857143,2,0.0,0,4,0,1,6,0,0,4,0,5,10,1
11928,105432,1cSsz0UCfa4Sky1FhbU6sbIRYsZ41OPL,A3fsA9Zfv1X2fVEQhTw51lKENdNrEqT3,20,28,1,38,0,2,24,4,97,13.857142857142858,1,0.0,0,1,32,0,28,2,6,24,4,33,64,1
11929,105439,jmHt2ZlvXO3qz2cHf72G06suxgziLa3C,A3fsA9Zfv1X2fVEQhTw51lKENdNrEqT3,2,0,0,0,0,0,2,0,2,0.2857142857142857,1,0.0,0,0,0,0,0,0,0,2,0,0,2,1
11930,105445,LdIFMEp4Gma3xMuOQ2mpp1BJ3jFvB9c2,bWdj2GDclj5ofokWjzoa5jAwMkxCykd6,39,70,28,134,9,4,22,0,267,38.142857142857146,10,0.0,15,28,112,9,55,4,22,22,0,164,103,0
11931,105451,1YSmilr2ajm5pFk4iAawwfB3mRapy4GR,bWdj2GDclj5ofokWjzoa5jAwMkxCykd6,4,2,1,0,1,0,1,0,5,0.7142857142857143,1,0.0,0,1,0,1,2,0,0,1,0,2,3,1
11932,105453,FNaEworzG9JIrUWWqoqtljEERNazKuKb,SpATywNh6bZuzm8s1ceuBUnMUAeoAHHw,6,3,1,0,1,0,2,0,7,1.0,1,0.0,0,1,0,1,3,0,0,2,0,2,5,1
11933,105454,EK81RbZoXEDM3g1RV68PHuRhq28X4Rfk,A3fsA9Zfv1X2fVEQhTw51lKENdNrEqT3,5,2,1,0,1,0,2,0,6,0.8571428571428571,1,0.0,0,1,0,1,2,0,0,2,0,2,4,1
11934,105456,P9cYtrIJUSQx41yE7x59h9MgXtuGnnbs,G8EPVSXsOYB5YQWZGiz1aVq5Pgr2GrQu,1,0,0,0,0,0,1,0,1,0.14285714285714285,1,0.0,0,0,0,0,0,0,0,1,0,0,1,1
11935,105464,rc8mOopKEVh5BHf3pFrEDGrzFcNfbS3h,SpATywNh6bZuzm8s1ceuBUnMUAeoAHHw,5,2,1,0,1,0,3,0,7,1.0,2,0.0,0,1,0,1,2,0,0,3,0,2,5,1
11936,105471,DIfj5Ba2axfDE4LFDWqKjVBCgesW8XXW,SpATywNh6bZuzm8s1ceuBUnMUAeoAHHw,18,51,13,0,4,3,10,0,81,11.571428571428571,2,0.0,0,13,0,4,51,3,0,10,0,17,64,1
11937,105479,DRqM6Ff42uz4k14OFxcFjetTXyC12WI7,SpATywNh6bZuzm8s1ceuBUnMUAeoAHHw,9,11,1,7,1,0,4,0,24,3.4285714285714284,2,0.0,0,1,6,1,11,0,1,4,0,8,16,1
11938,105480,RSwFpC1qMeXR2lSJtCkUxC2GY1HkPGdb,SpATywNh6bZuzm8s1ceuBUnMUAeoAHHw,9,10,6,0,3,0,3,0,22,3.142857142857143,2,0.0,1,6,0,3,9,0,0,3,0,10,12,1
11939,105491,QKXQzGYic4FsMmW8FpleZuFU3phntMAt,SpATywNh6bZuzm8s1ceuBUnMUAeoAHHw,8,4,3,0,3,0,1,0,11,1.5714285714285714,1,0.0,0,3,0,3,4,0,0,1,0,6,5,0
11940,105497,ouzFxiP7ljIzym1OgbkkNZsSGwRWOJRH,SpATywNh6bZuzm8s1ceuBUnMUAeoAHHw,5,2,1,0,1,0,2,0,6,0.8571428571428571,1,0.0,0,1,0,1,2,0,0,2,0,2,4,1
11941,105507,3xA82OlUzQ8FfAlTJcvVktSt0q894DXz,A3fsA9Zfv1X2fVEQhTw51lKENdNrEqT3,9,4,3,0,2,0,3,0,12,1.7142857142857142,1,0.0,0,3,0,2,4,0,0,3,0,5,7,1
11942,105513,huQkoBKNhxQg56EbGDFifh0dLnvHtGe7,SpATywNh6bZuzm8s1ceuBUnMUAeoAHHw,30,25,13,16,7,7,10,2,80,11.428571428571429,3,0.0,9,13,15,7,16,7,1,10,2,44,36,1
11943,105514,pb0NolqZsXAL2OR3XPD1zckdYQxFlvNU,SpATywNh6bZuzm8s1ceuBUnMUAeoAHHw,5,2,1,0,1,0,4,0,8,1.1428571428571428,1,0.0,0,1,0,1,2,0,0,4,0,2,6,1
11944,105517,bR55dFOoIQqPJPBvXoxJUIXx5dva0hOC,G8EPVSXsOYB5YQWZGiz1aVq5Pgr2GrQu,9,3,2,0,2,0,4,0,11,1.5714285714285714,1,0.0,0,2,0,2,3,0,0,4,0,4,7,1
11945,105526,dBYXiPq5rGdb4oW5xYaPd7zkgh6w8ny5,SpATywNh6bZuzm8s1ceuBUnMUAeoAHHw,3,3,0,0,0,0,1,0,4,0.5714285714285714,1,0.0,0,0,0,0,3,0,0,1,0,0,4,1
11946,105528,Gs4A8cx631DBKRtaVJfbdm1OgfYfhvQ8,A3fsA9Zfv1X2fVEQhTw51lKENdNrEqT3,2,0,0,0,0,0,2,0,2,0.2857142857142857,1,0.0,0,0,0,0,0,0,0,2,0,0,2,1
11947,105530,yjJ1iNhFO6aUkQdyDFXsvnts4X4TBbt1,G8EPVSXsOYB5YQWZGiz1aVq5Pgr2GrQu,14,8,7,0,6,0,6,1,28,4.0,1,0.0,0,7,0,6,8,0,0,6,1,13,15,1
11948,105532,YBSh2Ce8VFxfjfLxt9dOr0DLrvgLDo3G,SpATywNh6bZuzm8s1ceuBUnMUAeoAHHw,4,3,1,0,1,0,1,0,6,0.8571428571428571,1,0.0,0,1,0,1,3,0,0,1,0,2,4,1
11949,105538,JFR1iuUdFS1mD5BLqLO5DI7ZsHM5MIC6,SpATywNh6bZuzm8s1ceuBUnMUAeoAHHw,2,0,0,0,0,0,2,0,2,0.2857142857142857,1,0.0,0,0,0,0,0,0,0,2,0,0,2,1
11950,105543,JFR1iuUdFS1mD5BLqLO5DI7ZsHM5MIC6,bWdj2GDclj5ofokWjzoa5jAwMkxCykd6,2,0,0,0,0,0,2,0,2,0.2857142857142857,1,0.0,0,0,0,0,0,0,0,2,0,0,2,0
11951,105549,2OnJKTPobGmyM9bjszCwLbDBhhcw3Ptr,SpATywNh6bZuzm8s1ceuBUnMUAeoAHHw,6,4,2,0,1,0,4,0,11,1.5714285714285714,1,0.0,0,2,0,1,4,0,0,4,0,3,8,1
11952,105554,lD9Di3R0D8jVkARIDTv9uHKlPOJul1IJ,RXDvfPUBYFlVdlueBFbLW0mhhAyGEqpt,21,12,10,0,7,1,10,3,43,6.142857142857143,1,0.0,0,10,0,7,12,1,0,10,3,17,26,1
11953,105560,TBhSGbYkj43z5s2FElhR2mY8V29OFGOl,SpATywNh6bZuzm8s1ceuBUnMUAeoAHHw,9,12,4,14,1,8,1,0,40,5.714285714285714,1,0.0,7,4,12,1,5,8,2,1,0,24,16,1
11954,105564,a160ewxyRJdtN45GnX3uGxkLMyeZKvV7,A3fsA9Zfv1X2fVEQhTw51lKENdNrEqT3,5,3,2,0,1,0,1,0,7,1.0,1,0.0,0,2,0,1,3,0,0,1,0,3,4,1
11955,105572,i1rf4Uc8Jyx4GInthodWWBcAxWOUsNY3,SpATywNh6bZuzm8s1ceuBUnMUAeoAHHw,1,0,0,0,0,0,1,0,1,0.14285714285714285,1,0.0,0,0,0,0,0,0,0,1,0,0,1,1
11956,105578,UZSpGopByMz4vpZWWp6YjynYHDg7IDCz,SpATywNh6bZuzm8s1ceuBUnMUAeoAHHw,7,3,0,0,0,1,7,2,13,1.8571428571428572,1,0.0,0,0,0,0,3,1,0,7,2,0,13,1
11957,105596,9U8TB2VVR3SpNOaUoetOaSnkDznyBFBg,G8EPVSXsOYB5YQWZGiz1aVq5Pgr2GrQu,5,3,0,0,0,0,2,0,5,0.7142857142857143,1,0.0,0,0,0,0,3,0,0,2,0,0,5,1
11958,105603,U5SVBnEdwM8cChRjcz152ZJPSF8LRTgS,SpATywNh6bZuzm8s1ceuBUnMUAeoAHHw,17,23,12,15,6,10,4,0,70,10.0,1,0.0,10,12,12,6,13,10,3,4,0,40,30,1
11959,105605,vqN40E2i0C3fLg1fxObrFNN6aBFCAnYS,SpATywNh6bZuzm8s1ceuBUnMUAeoAHHw,4,2,1,0,1,0,1,0,5,0.7142857142857143,1,0.0,0,1,0,1,2,0,0,1,0,2,3,1
11960,105611,Z91ylcCa0QBPuZRAZnN7Bi8KMhEMk84I,G8EPVSXsOYB5YQWZGiz1aVq5Pgr2GrQu,1,0,0,0,0,0,1,0,1,0.14285714285714285,1,0.0,0,0,0,0,0,0,0,1,0,0,1,1
11961,105614,jkI0zARZWQkZpKjEUfCP0wADmuTyrZSB,G8EPVSXsOYB5YQWZGiz1aVq5Pgr2GrQu,5,2,1,0,1,0,2,0,6,0.8571428571428571,1,0.0,0,1,0,1,2,0,0,2,0,2,4,1
11962,105615,yt2gjsEupK8sBRyKpoF6RM4kG7zfvxKC,SpATywNh6bZuzm8s1ceuBUnMUAeoAHHw,34,73,26,33,7,9,20,2,170,24.285714285714285,8,0.0,27,26,32,7,46,9,1,20,2,92,78,0
11963,105618,UR2QSgawy0CjHWh1ilXf2hWdYdvRIm7a,A3fsA9Zfv1X2fVEQhTw51lKENdNrEqT3,1,0,0,0,0,0,1,0,1,0.14285714285714285,1,0.0,0,0,0,0,0,0,0,1,0,0,1,1
11964,105622,jkI0zARZWQkZpKjEUfCP0wADmuTyrZSB,A3fsA9Zfv1X2fVEQhTw51lKENdNrEqT3,12,11,2,0,2,0,4,0,19,2.7142857142857144,1,0.0,0,2,0,2,11,0,0,4,0,4,15,1
11965,105627,5uQhTmVLlxOLiyKyZlkmRhPs99pj5h4D,SpATywNh6bZuzm8s1ceuBUnMUAeoAHHw,7,3,2,0,2,0,2,0,9,1.2857142857142858,1,0.0,0,2,0,2,3,0,0,2,0,4,5,1
11966,105633,No3uaZVX8QfUWi2WuoYFYrVrLQNiuZit,SpATywNh6bZuzm8s1ceuBUnMUAeoAHHw,4,2,1,0,1,0,1,0,5,0.7142857142857143,1,0.0,0,1,0,1,2,0,0,1,0,2,3,1
11967,105634,6YparlTvGntzzoJlcpXRHjZMmqjae5pt,SpATywNh6bZuzm8s1ceuBUnMUAeoAHHw,14,7,5,2,3,7,7,1,32,4.571428571428571,1,0.0,0,5,2,3,7,7,0,7,1,10,22,1
11968,105640,gw3yc6n6VFyWcEZvOt8ZtzcLtuPxALTw,SpATywNh6bZuzm8s1ceuBUnMUAeoAHHw,14,25,11,19,0,21,16,1,93,13.285714285714286,4,0.0,8,11,16,0,17,21,3,16,1,35,58,1
11969,105645,jcprw7R15XocpeKMqxQA9O1OxKgjloTM,SpATywNh6bZuzm8s1ceuBUnMUAeoAHHw,1,0,0,0,0,0,1,0,1,0.14285714285714285,1,0.0,0,0,0,0,0,0,0,1,0,0,1,1
11970,105654,YpnxbgvlHOSkecYk2lPrRwAg5SZiWPmr,A3fsA9Zfv1X2fVEQhTw51lKENdNrEqT3,5,2,1,0,1,0,2,0,6,0.8571428571428571,1,0.0,0,1,0,1,2,0,0,2,0,2,4,1
11971,105668,7KQcIrOp3KoypOTvziMED7rHtDH1CXtE,A3fsA9Zfv1X2fVEQhTw51lKENdNrEqT3,1,0,0,0,0,0,1,0,1,0.14285714285714285,1,0.0,0,0,0,0,0,0,0,1,0,0,1,1
11972,105671,wpA3YODDDsWaFQtfPR7v2M6HEJbcAeIY,SpATywNh6bZuzm8s1ceuBUnMUAeoAHHw,6,8,3,0,1,0,4,0,16,2.2857142857142856,3,0.0,0,3,0,1,8,0,0,4,0,4,12,1
11973,105672,V02ryEmMmqjGIIiLHIkYu0vvVMLeyKKP,A3fsA9Zfv1X2fVEQhTw51lKENdNrEqT3,8,4,2,0,2,0,2,0,10,1.4285714285714286,1,0.0,0,2,0,2,4,0,0,2,0,4,6,1
11974,105677,tbzj7Go70gnZDKKkB7OUY9ROk4h4NATx,bWdj2GDclj5ofokWjzoa5jAwMkxCykd6,6,4,2,0,1,0,4,0,11,1.5714285714285714,1,0.0,0,2,0,1,4,0,0,4,0,3,8,1
11975,105690,dCV7p4dH2mfgkfJtane8atsSzuvj1JQf,bWdj2GDclj5ofokWjzoa5jAwMkxCykd6,1,0,0,0,0,0,1,0,1,0.14285714285714285,1,0.0,0,0,0,0,0,0,0,1,0,0,1,1
11976,105699,hBWZaknNj3MZUvkhj5xTqflV3rTd1l4t,bWdj2GDclj5ofokWjzoa5jAwMkxCykd6,2,0,0,0,0,0,2,0,2,0.2857142857142857,1,0.0,0,0,0,0,0,0,0,2,0,0,2,1
11977,105703,xePykhVJ0RKvBcesQ9TJJOkbxCOkEY1s,SpATywNh6bZuzm8s1ceuBUnMUAeoAHHw,4,0,0,0,0,3,3,0,6,0.8571428571428571,2,0.0,0,0,0,0,0,3,0,3,0,0,6,1
11978,105706,Higp7tL2evAdDfwxJ7Fv3MD5xI1FILhG,G8EPVSXsOYB5YQWZGiz1aVq5Pgr2GrQu,1,0,0,0,0,0,1,0,1,0.14285714285714285,1,0.0,0,0,0,0,0,0,0,1,0,0,1,1
11979,105707,YXw4AHOHrgMAyUR11Z0AMDwuHnZeqZI7,G8EPVSXsOYB5YQWZGiz1aVq5Pgr2GrQu,5,2,1,0,1,0,2,0,6,0.8571428571428571,1,0.0,0,1,0,1,2,0,0,2,0,2,4,1
11980,105713,RHNP6ku8FrLIdJ9UJ6RZ5wmeyQgTyWsO,A3fsA9Zfv1X2fVEQhTw51lKENdNrEqT3,1,0,0,0,0,0,2,0,2,0.2857142857142857,1,0.0,0,0,0,0,0,0,0,2,0,0,2,1
11981,105729,EhHrinjt1AkEWC09AFZwBuP61S5NJgjn,7GRhBDsirIGkRZBtSMEzNTyDr2JQm4xx,28,57,2,20,0,4,6,0,89,12.714285714285714,1,0.0,22,2,13,0,35,4,7,6,0,37,52,1
11982,105731,IG8NI5PgTAnRqVnVRaFxoKgrZHc8y65q,7GRhBDsirIGkRZBtSMEzNTyDr2JQm4xx,1,0,0,0,0,0,1,0,1,0.14285714285714285,1,0.0,0,0,0,0,0,0,0,1,0,0,1,1
11983,105736,r0ZdlKlEsmKZY094aSTCPxTKx82Pv4jZ,7GRhBDsirIGkRZBtSMEzNTyDr2JQm4xx,3,2,1,0,0,0,1,0,4,0.5714285714285714,1,0.0,0,1,0,0,2,0,0,1,0,1,3,1
11984,105746,szmVnhPypUPoSdN8Z8D02a6M8Gjrnwmf,7GRhBDsirIGkRZBtSMEzNTyDr2JQm4xx,7,5,3,0,2,0,2,0,12,1.7142857142857142,2,0.0,0,3,0,2,5,0,0,2,0,5,7,1
11985,105767,mjObtvp4vmduPSr2e6gxrQuYRjgGF8wF,7GRhBDsirIGkRZBtSMEzNTyDr2JQm4xx,48,73,32,36,18,12,9,1,181,25.857142857142858,5,0.0,34,32,32,18,39,12,4,9,1,116,65,0
11986,105784,QDpN8D19Mr8RZumTONWpZNlCWcHCCTbH,7GRhBDsirIGkRZBtSMEzNTyDr2JQm4xx,5,2,1,0,1,0,5,0,9,1.2857142857142858,1,0.0,0,1,0,1,2,0,0,5,0,2,7,1
11987,105834,QcbB4zGNvIA8Hos1EmgULZPHy4JycNs5,5X6FeZozNMgE2VRi3MJYjkkFK8SETtu2,1,0,0,0,0,0,1,0,1,0.14285714285714285,1,0.0,0,0,0,0,0,0,0,1,0,0,1,1
11988,105836,67qAsD8gffFwGGRYP2VtVSy5y3Ookejk,7GRhBDsirIGkRZBtSMEzNTyDr2JQm4xx,7,3,2,0,2,0,2,0,9,1.2857142857142858,1,0.0,0,2,0,2,3,0,0,2,0,4,5,1
11989,105848,sIyZYSKie5RGu5xNfItLppAaZDEjg9Pu,5X6FeZozNMgE2VRi3MJYjkkFK8SETtu2,5,3,1,0,1,0,1,0,6,0.8571428571428571,1,0.0,0,1,0,1,3,0,0,1,0,2,4,1
11990,105854,woFDw1OEnOkwFSqAm7hIDFxAwHhY3DdP,5X6FeZozNMgE2VRi3MJYjkkFK8SETtu2,16,17,6,10,8,0,4,1,46,6.571428571428571,1,0.0,9,6,10,8,8,0,0,4,1,33,13,1
11991,105865,FmbW6BMW2tvli3L6T9qC97SAIzFg6ww1,5X6FeZozNMgE2VRi3MJYjkkFK8SETtu2,3,2,0,0,0,0,4,0,6,0.8571428571428571,3,0.0,0,0,0,0,2,0,0,4,0,0,6,1
11992,105879,CkUOqtA27OCG1GaoeglcnLgN2xB1KvvL,7GRhBDsirIGkRZBtSMEzNTyDr2JQm4xx,2,0,0,0,0,0,2,0,2,0.2857142857142857,1,0.0,0,0,0,0,0,0,0,2,0,0,2,1
11993,105883,tfxXhrh7iPXKQPNkoHAVsqfq4X6hHi7F,5X6FeZozNMgE2VRi3MJYjkkFK8SETtu2,1,0,0,0,0,0,1,0,1,0.14285714285714285,1,0.0,0,0,0,0,0,0,0,1,0,0,1,1
11994,105971,aldnZSsKcazzeacsfbnsUhMZvWfCzdlz,5X6FeZozNMgE2VRi3MJYjkkFK8SETtu2,1,0,0,0,0,0,1,0,1,0.14285714285714285,1,0.0,0,0,0,0,0,0,0,1,0,0,1,1
11995,105990,V1VqVvaNADQhdwUg7X6GrtUrah1AYvnF,7GRhBDsirIGkRZBtSMEzNTyDr2JQm4xx,6,4,0,0,0,0,6,0,10,1.4285714285714286,2,0.0,0,0,0,0,4,0,0,6,0,0,10,1
11996,106003,wwh7y5mxviojWrVEvWbfoKIYQ3Sgn2tu,7GRhBDsirIGkRZBtSMEzNTyDr2JQm4xx,6,4,1,0,1,0,3,0,9,1.2857142857142858,2,0.0,0,1,0,1,4,0,0,3,0,2,7,1
11997,106004,ZPzO2Jq9MyhQSTfjOYO9iqzdnziVzHhF,7GRhBDsirIGkRZBtSMEzNTyDr2JQm4xx,19,29,12,8,6,0,8,0,63,9.0,2,0.0,12,12,7,6,17,0,1,8,0,37,26,1
11998,106010,VLqeHUMgi9PQ3Cs8paSU7gHzDiYDPzML,7GRhBDsirIGkRZBtSMEzNTyDr2JQm4xx,5,2,1,0,1,0,2,0,6,0.8571428571428571,1,0.0,0,1,0,1,2,0,0,2,0,2,4,1
11999,106019,UBfqapbt41rZhlFda9dIX0sXKEHUoNRR,7GRhBDsirIGkRZBtSMEzNTyDr2JQm4xx,1,0,0,0,0,0,1,0,1,0.14285714285714285,1,0.0,0,0,0,0,0,0,0,1,0,0,1,1
12000,106310,cOQ2CLrZnN7CsViDawRXxdnHfqtQ6g10,A3fsA9Zfv1X2fVEQhTw51lKENdNrEqT3,5,2,1,0,1,0,2,0,6,0.8571428571428571,1,0.0,0,1,0,1,2,0,0,2,0,2,4,1
12001,106359,2zZlUBHgcEWZzLbL8iqQ9VWT51LiEQMY,5X6FeZozNMgE2VRi3MJYjkkFK8SETtu2,6,0,0,0,0,1,5,1,7,1.0,1,0.0,0,0,0,0,0,1,0,5,1,0,7,1
12002,106373,DKhf23FUjC3109rVKohZnczA6uCGbVGI,SpATywNh6bZuzm8s1ceuBUnMUAeoAHHw,7,3,2,0,2,0,2,0,9,1.2857142857142858,1,0.0,0,2,0,2,3,0,0,2,0,4,5,1
12003,106388,N5GsiNu3FAKruWsJ810ZCYlr5LGRTZRP,SpATywNh6bZuzm8s1ceuBUnMUAeoAHHw,9,11,7,0,5,0,4,0,27,3.857142857142857,2,0.0,0,7,0,5,11,0,0,4,0,12,15,1
12004,106408,3C0RNflDAI8FmTdsE1mhjUkpDZ4xUri7,SpATywNh6bZuzm8s1ceuBUnMUAeoAHHw,5,3,1,0,1,0,3,0,8,1.1428571428571428,2,0.0,0,1,0,1,3,0,0,3,0,2,6,1
12005,106422,gOpwYaP0oFM4wK1KEBXUDEJrae3X7fzc,SpATywNh6bZuzm8s1ceuBUnMUAeoAHHw,1,0,0,0,0,0,1,0,1,0.14285714285714285,1,0.0,0,0,0,0,0,0,0,1,0,0,1,1
12006,106434,i6H5zxz2U3b7Stgpyc7yvkBTJYyhoQYo,SpATywNh6bZuzm8s1ceuBUnMUAeoAHHw,14,18,2,10,1,0,5,0,36,5.142857142857143,3,0.0,7,2,8,1,11,0,2,5,0,18,18,1
12007,106436,8TpCqC4monvJnKND6WblTCWAybHmTNVD,SpATywNh6bZuzm8s1ceuBUnMUAeoAHHw,1,0,0,0,0,0,1,0,1,0.14285714285714285,1,0.0,0,0,0,0,0,0,0,1,0,0,1,1
12008,106437,NyEijNa9dfqUApw5iyHdD9FPGDdLrbLb,SpATywNh6bZuzm8s1ceuBUnMUAeoAHHw,5,2,1,0,1,0,2,0,6,0.8571428571428571,2,0.0,0,1,0,1,2,0,0,2,0,2,4,1
12009,106443,t3vj4r7JOWedUjNWDPc1a4izv1Cmnqwm,RXDvfPUBYFlVdlueBFbLW0mhhAyGEqpt,15,11,3,28,3,0,5,0,50,7.142857142857143,3,0.0,6,3,26,3,5,0,2,5,0,38,12,1
12010,106446,bazJXiq7ucQvx12BgvEogiLDadc2i22I,RXDvfPUBYFlVdlueBFbLW0mhhAyGEqpt,4,2,0,0,0,4,2,0,8,1.1428571428571428,1,0.0,0,0,0,0,2,4,0,2,0,0,8,1
12011,106460,pdAqVvKgeCIaihAcxhTXOYjPQxxjaa8K,SpATywNh6bZuzm8s1ceuBUnMUAeoAHHw,5,3,1,0,1,0,2,0,7,1.0,1,0.0,0,1,0,1,3,0,0,2,0,2,5,1
12012,106463,pdAqVvKgeCIaihAcxhTXOYjPQxxjaa8K,G8EPVSXsOYB5YQWZGiz1aVq5Pgr2GrQu,7,5,2,0,2,0,2,0,11,1.5714285714285714,1,0.0,0,2,0,2,5,0,0,2,0,4,7,1
12013,106465,MJfBdskwO4D70ierxBCGMKCiw8lrVzMw,SpATywNh6bZuzm8s1ceuBUnMUAeoAHHw,8,4,3,0,3,0,1,0,11,1.5714285714285714,1,0.0,0,3,0,3,4,0,0,1,0,6,5,1
12014,106470,bMarbVnDr4OepC5ZPynjVXhQz0xRB6Ed,SpATywNh6bZuzm8s1ceuBUnMUAeoAHHw,14,16,5,15,3,1,2,0,42,6.0,1,0.0,10,5,12,3,6,1,3,2,0,30,12,0
12015,106472,B0Edo8kqkjTSYODfsszisfXIJvzjLDbd,SpATywNh6bZuzm8s1ceuBUnMUAeoAHHw,1,0,0,0,0,0,1,0,1,0.14285714285714285,1,0.0,0,0,0,0,0,0,0,1,0,0,1,0
12016,106484,bP02cfOIFimMsMVUcFl4uLZksud3wO6q,SpATywNh6bZuzm8s1ceuBUnMUAeoAHHw,1,0,0,0,0,0,1,0,1,0.14285714285714285,1,0.0,0,0,0,0,0,0,0,1,0,0,1,1
12017,106491,bP02cfOIFimMsMVUcFl4uLZksud3wO6q,5X6FeZozNMgE2VRi3MJYjkkFK8SETtu2,1,0,0,0,0,0,1,0,1,0.14285714285714285,1,0.0,0,0,0,0,0,0,0,1,0,0,1,1
12018,106492,C3hAWoS9AbYLxLAAlN0y3d7i9WUss3n3,SpATywNh6bZuzm8s1ceuBUnMUAeoAHHw,3,0,0,0,0,5,3,0,8,1.1428571428571428,1,0.0,0,0,0,0,0,5,0,3,0,0,8,1
12019,106493,bP02cfOIFimMsMVUcFl4uLZksud3wO6q,bWdj2GDclj5ofokWjzoa5jAwMkxCykd6,1,0,0,0,0,0,1,0,1,0.14285714285714285,1,0.0,0,0,0,0,0,0,0,1,0,0,1,1
12020,106495,bP02cfOIFimMsMVUcFl4uLZksud3wO6q,G8EPVSXsOYB5YQWZGiz1aVq5Pgr2GrQu,1,0,0,0,0,0,1,0,1,0.14285714285714285,1,0.0,0,0,0,0,0,0,0,1,0,0,1,1
12021,106498,bP02cfOIFimMsMVUcFl4uLZksud3wO6q,A3fsA9Zfv1X2fVEQhTw51lKENdNrEqT3,1,0,0,0,0,0,1,0,1,0.14285714285714285,1,0.0,0,0,0,0,0,0,0,1,0,0,1,1
12022,106511,op6fYsDSJ7UTrHBvFtSBIo32ykj3vZlc,5X6FeZozNMgE2VRi3MJYjkkFK8SETtu2,8,16,0,2,5,0,11,0,34,4.857142857142857,5,0.0,11,0,2,5,5,0,0,11,0,18,16,1
12023,106518,aWU6GALeCayeG1vo49En0w2vX7HsfHCy,G8EPVSXsOYB5YQWZGiz1aVq5Pgr2GrQu,24,44,14,8,8,1,13,1,89,12.714285714285714,1,0.0,14,14,5,8,30,1,3,13,1,41,48,1
12024,106520,q2ar2IRhg35oX7gtyUjKKpitik3AlI40,A3fsA9Zfv1X2fVEQhTw51lKENdNrEqT3,1,0,0,0,0,0,1,0,1,0.14285714285714285,1,0.0,0,0,0,0,0,0,0,1,0,0,1,1
12025,106522,pCFkPYqdu1teVglAllomSvRRE7DQZT44,RXDvfPUBYFlVdlueBFbLW0mhhAyGEqpt,7,5,1,0,1,0,1,0,8,1.1428571428571428,1,0.0,0,1,0,1,5,0,0,1,0,2,6,1
12026,106523,Cduwd07l9ihp0BpAay0pd2rAkJg37JEO,RXDvfPUBYFlVdlueBFbLW0mhhAyGEqpt,17,20,0,23,1,0,2,0,46,6.571428571428571,1,0.0,3,0,20,1,17,0,3,2,0,24,22,1
12027,106532,bh5BFBK0otMDKfxb8aR6tfITatyirhu2,SpATywNh6bZuzm8s1ceuBUnMUAeoAHHw,4,2,0,0,0,0,2,0,4,0.5714285714285714,1,0.0,0,0,0,0,2,0,0,2,0,0,4,1
12028,106537,HLWfEZgV82l2tUnqCdihA4swo6uB5JmG,SpATywNh6bZuzm8s1ceuBUnMUAeoAHHw,1,0,0,0,0,0,1,0,1,0.14285714285714285,1,0.0,0,0,0,0,0,0,0,1,0,0,1,0
12029,106547,dstTpT2BjfmJxSzmJpU00abOAObDPwAz,SpATywNh6bZuzm8s1ceuBUnMUAeoAHHw,1,0,0,0,0,0,1,0,1,0.14285714285714285,1,0.0,0,0,0,0,0,0,0,1,0,0,1,1
12030,106591,rxfzVJVj4XNymQN7SX1pdLUM549NCrW7,SpATywNh6bZuzm8s1ceuBUnMUAeoAHHw,8,19,12,0,4,5,8,0,48,6.857142857142857,6,0.0,0,12,0,4,19,5,0,8,0,16,32,0
12031,106598,iXoEMwcJ5o4IM7VKZ5pyam9GxPy4olUQ,5X6FeZozNMgE2VRi3MJYjkkFK8SETtu2,6,16,3,0,0,0,3,0,22,3.142857142857143,1,0.0,3,3,0,0,13,0,0,3,0,6,16,1
12032,106606,9fSst0DYScvrsgwHkRdeAWaCTv1iMoKg,SpATywNh6bZuzm8s1ceuBUnMUAeoAHHw,1,0,0,0,0,0,1,0,1,0.14285714285714285,1,0.0,0,0,0,0,0,0,0,1,0,0,1,1
12033,106640,7JpAhJZcu52sQ4zH9lE7ptLjQsjTlady,G8EPVSXsOYB5YQWZGiz1aVq5Pgr2GrQu,9,27,6,0,5,1,10,1,50,7.142857142857143,1,0.0,13,6,0,5,14,1,0,10,1,24,26,0
12034,106643,MyYvsUimsdJLREHlZB7pLW11HvGvwatH,A3fsA9Zfv1X2fVEQhTw51lKENdNrEqT3,3,3,1,0,0,0,1,0,5,0.7142857142857143,1,0.0,0,1,0,0,3,0,0,1,0,1,4,1
12035,106649,dstTpT2BjfmJxSzmJpU00abOAObDPwAz,G8EPVSXsOYB5YQWZGiz1aVq5Pgr2GrQu,1,0,0,0,0,0,1,0,1,0.14285714285714285,1,0.0,0,0,0,0,0,0,0,1,0,0,1,1
12036,106650,GebdA7Vo87ReyKP2A7BXi3CttXQIgfXb,SpATywNh6bZuzm8s1ceuBUnMUAeoAHHw,5,3,1,0,0,0,5,0,9,1.2857142857142858,2,0.0,0,1,0,0,3,0,0,5,0,1,8,1
12037,106655,5r9OEsSFtsP3T0AQQIuWD6ouO08AmGp2,bWdj2GDclj5ofokWjzoa5jAwMkxCykd6,7,8,1,0,2,0,3,0,14,2.0,2,0.0,2,1,0,2,6,0,0,3,0,5,9,1
12038,106689,RpVeRO6gAfuIJgHx6Sdcq1K3gg7WWxhi,SpATywNh6bZuzm8s1ceuBUnMUAeoAHHw,42,36,22,32,14,0,3,0,107,15.285714285714286,3,0.0,11,22,29,14,25,0,3,3,0,76,31,1
12039,106698,AuIQbwKCl1rpgmIzQXLySneETBtGUcy9,SpATywNh6bZuzm8s1ceuBUnMUAeoAHHw,14,27,3,0,4,0,4,0,38,5.428571428571429,4,0.0,6,3,0,4,21,0,0,4,0,13,25,1
12040,106701,bUlVBXqXRojGcrtmo2UOxhIzd8vCtLry,SpATywNh6bZuzm8s1ceuBUnMUAeoAHHw,7,5,3,0,3,0,3,0,14,2.0,2,0.0,0,3,0,3,5,0,0,3,0,6,8,1
12041,106705,Pnj0azS8P7bL4tIbWN5mqjFl1a8tuCEd,bWdj2GDclj5ofokWjzoa5jAwMkxCykd6,8,6,4,0,3,0,3,0,16,2.2857142857142856,1,0.0,0,4,0,3,6,0,0,3,0,7,9,1
12042,106710,2sYGHfb0Gpw1ITIdkhTs2jjyBEZU4HAF,SpATywNh6bZuzm8s1ceuBUnMUAeoAHHw,16,29,0,10,0,0,13,0,52,7.428571428571429,4,0.0,5,0,10,0,24,0,0,13,0,15,37,1
12043,106714,S9GhTyD7qyH3KrCKFhzfEswPlAknGlRK,SpATywNh6bZuzm8s1ceuBUnMUAeoAHHw,9,3,2,0,2,0,4,0,11,1.5714285714285714,1,0.0,0,2,0,2,3,0,0,4,0,4,7,1
12044,106719,eOyjHJuwOD7RIuhNsn2aD5QXKZmvQvMJ,SpATywNh6bZuzm8s1ceuBUnMUAeoAHHw,1,0,0,0,0,0,1,0,1,0.14285714285714285,1,0.0,0,0,0,0,0,0,0,1,0,0,1,1
12045,106722,tYtKY0fbDxdVMqQSQtSw2vWDwWIzdu2T,SpATywNh6bZuzm8s1ceuBUnMUAeoAHHw,6,2,1,0,1,0,4,1,9,1.2857142857142858,1,0.0,0,1,0,1,2,0,0,4,1,2,7,1
12046,106724,LBz8eebDA0q3o7gWfqXlzvsHwwqTUJzd,SpATywNh6bZuzm8s1ceuBUnMUAeoAHHw,16,36,0,10,0,1,7,1,55,7.857142857142857,3,0.0,7,0,9,0,29,1,1,7,1,16,39,0
12047,106733,Cduwd07l9ihp0BpAay0pd2rAkJg37JEO,A3fsA9Zfv1X2fVEQhTw51lKENdNrEqT3,6,7,1,0,1,0,1,0,10,1.4285714285714286,1,0.0,0,1,0,1,7,0,0,1,0,2,8,1
12048,106744,epz8WjfpOXjHx8PqWhAfdNzAuBHZ8Sqp,G8EPVSXsOYB5YQWZGiz1aVq5Pgr2GrQu,6,2,1,0,1,0,3,1,8,1.1428571428571428,1,0.0,0,1,0,1,2,0,0,3,1,2,6,1
12049,106751,YYCI1ivPCDRa3x25VBUTnS1EqXk51k7P,5X6FeZozNMgE2VRi3MJYjkkFK8SETtu2,8,12,5,0,2,3,9,0,31,4.428571428571429,1,0.0,1,5,0,2,11,3,0,9,0,8,23,1
12050,106757,w9XtwyzvRxdlT7TETbqeY2eb4lfxta29,bWdj2GDclj5ofokWjzoa5jAwMkxCykd6,5,3,2,0,2,0,3,0,10,1.4285714285714286,1,0.0,0,2,0,2,3,0,0,3,0,4,6,1
12051,106781,qXQHPbibS0VS8GGMP77leSpbpNyK0HKr,SpATywNh6bZuzm8s1ceuBUnMUAeoAHHw,5,3,2,0,0,0,2,0,7,1.0,1,0.0,0,2,0,0,3,0,0,2,0,2,5,1
12052,106784,wMDkRlLY4isbEoj9TOjvaXeMCQLsBTi8,SpATywNh6bZuzm8s1ceuBUnMUAeoAHHw,6,5,3,0,0,0,3,0,11,1.5714285714285714,1,0.0,0,3,0,0,5,0,0,3,0,3,8,1
12053,106794,F2owRK2SDPW5FCDK4TxmBVHsTtJ44Nxq,5X6FeZozNMgE2VRi3MJYjkkFK8SETtu2,1,0,0,0,0,0,1,0,1,0.14285714285714285,1,0.0,0,0,0,0,0,0,0,1,0,0,1,1
12054,106797,qSqicsHTfA7awftDly8FnFdkrTLfB2If,bWdj2GDclj5ofokWjzoa5jAwMkxCykd6,10,9,1,12,4,0,3,0,29,4.142857142857143,1,0.0,6,1,10,4,3,0,2,3,0,21,8,1
12055,106816,3PvD9OHPY5l8VAGiigtv266oF9uzOqWW,bWdj2GDclj5ofokWjzoa5jAwMkxCykd6,1,0,0,0,0,0,1,0,1,0.14285714285714285,1,0.0,0,0,0,0,0,0,0,1,0,0,1,1
12056,106822,Ahih1LlFS0wdudINocND3lILXT50AxNl,bWdj2GDclj5ofokWjzoa5jAwMkxCykd6,1,0,0,0,0,0,1,0,1,0.14285714285714285,1,0.0,0,0,0,0,0,0,0,1,0,0,1,1
12057,106833,5URiiR96pJ3BGEHKPw9V5T2W795iQ19d,bWdj2GDclj5ofokWjzoa5jAwMkxCykd6,1,0,0,0,0,0,1,0,1,0.14285714285714285,1,0.0,0,0,0,0,0,0,0,1,0,0,1,1
12058,106835,5URiiR96pJ3BGEHKPw9V5T2W795iQ19d,A3fsA9Zfv1X2fVEQhTw51lKENdNrEqT3,1,0,0,0,0,0,1,0,1,0.14285714285714285,1,0.0,0,0,0,0,0,0,0,1,0,0,1,1
12059,106849,UJiJ4PvH4qodyDnURbFXyi5LWwaSKUwb,bWdj2GDclj5ofokWjzoa5jAwMkxCykd6,9,8,2,16,4,0,2,0,32,4.571428571428571,1,0.0,5,2,14,4,3,0,2,2,0,25,7,1
12060,106853,DSkyPIUtT8xxP5Yu1DrvohPZBHHgxJAD,SpATywNh6bZuzm8s1ceuBUnMUAeoAHHw,6,5,3,0,0,0,4,0,12,1.7142857142857142,2,0.0,0,3,0,0,5,0,0,4,0,3,9,1
12061,106858,wwFNSVNavy53ZZLg1TQ0hM4pFCmqfiLF,A3fsA9Zfv1X2fVEQhTw51lKENdNrEqT3,12,7,3,0,1,2,9,1,23,3.2857142857142856,2,0.0,2,3,0,1,5,2,0,9,1,6,17,0
12062,106865,tpRB0Y2odcJ8wbxdjaREs5gktwFdDR2h,bWdj2GDclj5ofokWjzoa5jAwMkxCykd6,1,0,0,0,0,0,2,0,2,0.2857142857142857,1,0.0,0,0,0,0,0,0,0,2,0,0,2,1
12063,106875,fMx92g7Jo1AcMZwPvPIvrvUTeg1dWBrD,RXDvfPUBYFlVdlueBFbLW0mhhAyGEqpt,5,3,2,0,2,0,3,0,10,1.4285714285714286,3,0.0,0,2,0,2,3,0,0,3,0,4,6,1
12064,106888,6zMvATewcq8WRjty9hT4teUCYKhChdQh,bWdj2GDclj5ofokWjzoa5jAwMkxCykd6,2,0,0,0,0,0,4,0,4,0.5714285714285714,1,0.0,0,0,0,0,0,0,0,4,0,0,4,1
12065,106891,qFnZG81HTlpUeqdWqLaQb2RJMVogFUVu,5X6FeZozNMgE2VRi3MJYjkkFK8SETtu2,1,0,0,0,0,0,1,0,1,0.14285714285714285,1,0.0,0,0,0,0,0,0,0,1,0,0,1,1
12066,106906,myNTp931AmSPRA2kl8memATVLQzx4fxs,SpATywNh6bZuzm8s1ceuBUnMUAeoAHHw,15,16,5,15,0,0,4,0,40,5.714285714285714,2,0.0,7,5,15,0,9,0,0,4,0,27,13,1
12067,106915,1Udy3gnh9HMf01YloLJgkopQMoq9kMsz,bWdj2GDclj5ofokWjzoa5jAwMkxCykd6,2,0,0,0,0,0,4,0,4,0.5714285714285714,1,0.0,0,0,0,0,0,0,0,4,0,0,4,1
12068,106920,mx5uNWTFASThXTBo9bW2o4U3G4bTw9Oo,5X6FeZozNMgE2VRi3MJYjkkFK8SETtu2,1,0,0,0,0,0,1,0,1,0.14285714285714285,1,0.0,0,0,0,0,0,0,0,1,0,0,1,1
12069,106929,fW4fbh90nu73Q6G9ndiED1PUrE0wupYF,SpATywNh6bZuzm8s1ceuBUnMUAeoAHHw,4,3,1,0,0,0,2,0,6,0.8571428571428571,1,0.0,0,1,0,0,3,0,0,2,0,1,5,1
12070,106940,NKTsGtocSBmn1p0LL8TfbQ17Oh6XvCt3,SpATywNh6bZuzm8s1ceuBUnMUAeoAHHw,14,62,10,27,0,71,29,4,203,29.0,11,0.0,19,10,21,0,43,71,6,29,4,50,153,0
12071,106941,pLqg9VEcxR9ds22e3uE9UuC1QIy40paq,RXDvfPUBYFlVdlueBFbLW0mhhAyGEqpt,4,2,1,0,1,0,1,0,5,0.7142857142857143,1,0.0,0,1,0,1,2,0,0,1,0,2,3,1
12072,106950,BxhpecUzZZ9XTMglNesOYipbpJL9rX1j,SpATywNh6bZuzm8s1ceuBUnMUAeoAHHw,6,6,3,0,3,0,4,0,16,2.2857142857142856,1,0.0,0,3,0,3,6,0,0,4,0,6,10,1
12073,106955,wMYwbasBu7kj6nAVyuyEqjGmi3ogAq0E,SpATywNh6bZuzm8s1ceuBUnMUAeoAHHw,11,15,11,0,8,0,3,0,37,5.285714285714286,2,0.0,0,11,0,8,15,0,0,3,0,19,18,1
12074,106963,3wBD00ypE5ShQJhnUdswEeP7Ynn8tGHZ,bWdj2GDclj5ofokWjzoa5jAwMkxCykd6,8,6,2,0,2,0,4,0,14,2.0,1,0.0,1,2,0,2,5,0,0,4,0,5,9,1
12075,106965,4Dp7LLp7t1gYbdcN4ZxWGwhRKXqsnWGQ,A3fsA9Zfv1X2fVEQhTw51lKENdNrEqT3,7,4,1,0,1,0,2,0,8,1.1428571428571428,1,0.0,0,1,0,1,4,0,0,2,0,2,6,1
12076,106974,DccaKc9Q3a9ni72KWPKrJiivxObiw1S5,SpATywNh6bZuzm8s1ceuBUnMUAeoAHHw,4,2,0,0,0,0,2,0,4,0.5714285714285714,1,0.0,0,0,0,0,2,0,0,2,0,0,4,1
12077,106991,foZomfeiH5mdSFjeB6umSt6lwP9hfSDR,A3fsA9Zfv1X2fVEQhTw51lKENdNrEqT3,4,2,1,0,0,0,6,0,9,1.2857142857142858,2,0.0,0,1,0,0,2,0,0,6,0,1,8,1
12078,106994,foZomfeiH5mdSFjeB6umSt6lwP9hfSDR,bWdj2GDclj5ofokWjzoa5jAwMkxCykd6,5,3,1,0,0,0,4,0,8,1.1428571428571428,2,0.0,0,1,0,0,3,0,0,4,0,1,7,1
12079,106999,7bBbNS8igBUmtAlhgWeyPaLpz7A08m0l,bWdj2GDclj5ofokWjzoa5jAwMkxCykd6,3,2,1,0,0,0,1,0,4,0.5714285714285714,1,0.0,0,1,0,0,2,0,0,1,0,1,3,0
12080,107016,mTHEBQKcpUpIn1qJcpLJBf1JarEh6HTV,G8EPVSXsOYB5YQWZGiz1aVq5Pgr2GrQu,6,8,3,0,1,0,5,0,17,2.4285714285714284,1,0.0,0,3,0,1,8,0,0,5,0,4,13,1
12081,107018,OYWBopBO2n38CA6GRAaDJRfIHV9b0dQs,A3fsA9Zfv1X2fVEQhTw51lKENdNrEqT3,1,0,0,0,0,0,3,0,3,0.42857142857142855,1,0.0,0,0,0,0,0,0,0,3,0,0,3,1
12082,107036,qpd1RINX0ghAugS9ZiQmRvWMQe2xJWfG,SpATywNh6bZuzm8s1ceuBUnMUAeoAHHw,1,0,0,0,0,0,1,0,1,0.14285714285714285,1,0.0,0,0,0,0,0,0,0,1,0,0,1,1
12083,107045,urj2Kr7Ws5qXQZp6biE11Qihh39xd0AE,A3fsA9Zfv1X2fVEQhTw51lKENdNrEqT3,1,0,0,0,0,0,1,0,1,0.14285714285714285,1,0.0,0,0,0,0,0,0,0,1,0,0,1,1
12084,107047,dPcBuI7bI8BiBDvjZ0Pq52a3IzmSdDrl,5X6FeZozNMgE2VRi3MJYjkkFK8SETtu2,1,0,0,0,0,0,1,0,1,0.14285714285714285,1,0.0,0,0,0,0,0,0,0,1,0,0,1,0
12085,107049,i8GOkgWlBQByuCuyYT08OdGCpL2A2Lxa,5X6FeZozNMgE2VRi3MJYjkkFK8SETtu2,1,0,0,0,0,0,1,0,1,0.14285714285714285,1,0.0,0,0,0,0,0,0,0,1,0,0,1,1
12086,107061,7ITppmxIJuiv2qwirt1AUPH7whJqqqHK,A3fsA9Zfv1X2fVEQhTw51lKENdNrEqT3,2,0,0,0,0,0,3,0,3,0.42857142857142855,2,0.0,0,0,0,0,0,0,0,3,0,0,3,1
12087,107071,c3Q7zBkcz9A9C9axYIiO1QysEG1V4UAO,3VkHkmOtom3jM2wCu94xgzzu1d6Dn7or,59,73,30,88,32,3,20,0,246,35.142857142857146,5,0.0,41,30,84,32,32,3,4,20,0,187,59,1
12088,107074,tO0oCacyCP3v3H0cyXZQAxRbRlfHVuYj,3VkHkmOtom3jM2wCu94xgzzu1d6Dn7or,21,10,1,0,9,0,2,0,22,3.142857142857143,1,0.0,0,1,0,9,10,0,0,2,0,10,12,1
12089,107077,NLIh4VJYbGXtPc1CA0F1tPrWSh7ESLKA,3VkHkmOtom3jM2wCu94xgzzu1d6Dn7or,2,1,0,0,0,0,1,0,2,0.2857142857142857,1,0.0,0,0,0,0,1,0,0,1,0,0,2,1
12090,107179,HOPYYoB2QW4Q8fdYSBXkCelzcNC0uPwD,3VkHkmOtom3jM2wCu94xgzzu1d6Dn7or,84,117,49,80,41,4,22,1,314,44.857142857142854,6,0.0,49,49,61,41,68,4,19,22,1,200,114,0
12091,107181,j3X3uTmlcQFLfvZ3dhwIq3KsV5teBSm0,3VkHkmOtom3jM2wCu94xgzzu1d6Dn7or,61,130,40,44,48,1,10,0,273,39.0,4,0.0,79,40,42,48,51,1,2,10,0,209,64,1
12092,107184,EUmZ5qzjwgko2PIWEnctkvYh7APnUrX9,3VkHkmOtom3jM2wCu94xgzzu1d6Dn7or,1,0,0,0,0,0,3,0,3,0.42857142857142855,1,0.0,0,0,0,0,0,0,0,3,0,0,3,1
12093,107274,7XqS4DbRrFLzLhwbdt6cdEB5XXkNUsTP,3VkHkmOtom3jM2wCu94xgzzu1d6Dn7or,30,50,18,41,12,25,21,21,188,26.857142857142858,5,0.0,20,18,32,12,30,25,9,21,21,82,106,0
12094,107285,CFwBanDE4eguHX9lcM62Yx5Bex6437kC,3VkHkmOtom3jM2wCu94xgzzu1d6Dn7or,2,0,0,0,0,2,2,0,4,0.5714285714285714,2,0.0,0,0,0,0,0,2,0,2,0,0,4,1
12095,107296,gX80ZeqkATSWdW6ScKpFgzDJH6XqkBjR,3VkHkmOtom3jM2wCu94xgzzu1d6Dn7or,1,0,0,0,0,0,1,0,1,0.14285714285714285,1,0.0,0,0,0,0,0,0,0,1,0,0,1,1
12096,107300,BcvlWUp5Go3BcZqGRpbDcdFffadBUUWh,3VkHkmOtom3jM2wCu94xgzzu1d6Dn7or,5,2,1,0,1,0,3,0,7,1.0,1,0.0,0,1,0,1,2,0,0,3,0,2,5,1
12097,107344,kC7JLQowN0BSKnzXXKRn5vuXi1nnM0dA,3VkHkmOtom3jM2wCu94xgzzu1d6Dn7or,14,13,7,4,5,5,7,0,41,5.857142857142857,2,0.0,2,7,4,5,11,5,0,7,0,18,23,1
12098,107348,WvvMhmSCzwWr2ITV1gNoJaX8mQF8RD4y,3VkHkmOtom3jM2wCu94xgzzu1d6Dn7or,5,2,1,0,1,0,3,0,7,1.0,2,0.0,0,1,0,1,2,0,0,3,0,2,5,1
12099,107357,ue8WVPLLafIf9IYdVejX2hZXpMQfwSob,3VkHkmOtom3jM2wCu94xgzzu1d6Dn7or,62,63,43,0,38,0,8,0,152,21.714285714285715,5,0.0,0,43,0,38,63,0,0,8,0,81,71,1
12100,107380,Idqx4zHscfaoPaYU2tE8rxUSHQT5ynnI,3VkHkmOtom3jM2wCu94xgzzu1d6Dn7or,1,0,0,0,0,0,1,0,1,0.14285714285714285,1,0.0,0,0,0,0,0,0,0,1,0,0,1,1
12101,107383,v8L5A0JOQdQh027Prn4fpZ6yyGP5io4t,3VkHkmOtom3jM2wCu94xgzzu1d6Dn7or,12,15,6,4,4,3,9,3,44,6.285714285714286,2,0.0,3,6,3,4,12,3,1,9,3,16,28,1
12102,107418,bp0cMJdpppPkJKpUEtMjgtVL3r3SoYZi,3VkHkmOtom3jM2wCu94xgzzu1d6Dn7or,1,0,0,0,0,0,1,0,1,0.14285714285714285,1,0.0,0,0,0,0,0,0,0,1,0,0,1,1
12103,107442,su91jdVM4pixtDMTfbv8iv1xV2Hz5B1x,3VkHkmOtom3jM2wCu94xgzzu1d6Dn7or,12,7,5,0,4,0,3,0,19,2.7142857142857144,1,0.0,0,5,0,4,7,0,0,3,0,9,10,1
12104,107443,LunuTlluI57ma5AiSck9cTLsUyT1ttHO,3VkHkmOtom3jM2wCu94xgzzu1d6Dn7or,5,2,1,0,1,0,2,0,6,0.8571428571428571,2,0.0,0,1,0,1,2,0,0,2,0,2,4,1
12105,107444,MlHPKmdi90dDdvX24jYoFlYEp8xS4RGn,3VkHkmOtom3jM2wCu94xgzzu1d6Dn7or,45,51,38,0,38,4,10,1,142,20.285714285714285,3,0.0,5,38,0,38,46,4,0,10,1,81,61,1
12106,107448,tuIaGc8mk8COngnOlFhw7CCBSQJon7zH,3VkHkmOtom3jM2wCu94xgzzu1d6Dn7or,17,39,8,10,11,4,8,0,80,11.428571428571429,2,0.0,13,8,8,11,26,4,2,8,0,40,40,0
12107,107464,qgfUrfWNLjU5Fv1mJqz90WRpjEvuRyfQ,3VkHkmOtom3jM2wCu94xgzzu1d6Dn7or,11,6,2,0,2,3,11,2,26,3.7142857142857144,1,0.0,0,2,0,2,6,3,0,11,2,4,22,1
12108,107471,pVWw7B1JfJMltEPPBSdY6V7SLZlcwQT0,3VkHkmOtom3jM2wCu94xgzzu1d6Dn7or,3,3,0,0,0,0,2,0,5,0.7142857142857143,1,0.0,0,0,0,0,3,0,0,2,0,0,5,1
12109,107506,LU9kxt8aKnlOn8SnA2EuX2MLajf5Sg2a,3VkHkmOtom3jM2wCu94xgzzu1d6Dn7or,5,3,1,0,1,0,3,1,9,1.2857142857142858,1,0.0,1,1,0,1,2,0,0,3,1,3,6,0
12110,107514,Wi2NuIcnwGjcJsrrE5JIp2Vt2U8MBxIT,3VkHkmOtom3jM2wCu94xgzzu1d6Dn7or,1,0,0,0,0,0,1,0,1,0.14285714285714285,1,0.0,0,0,0,0,0,0,0,1,0,0,1,1
12111,107562,xrJZG7bksK3YFan9RqpK1Mnlfo1oxWW3,3VkHkmOtom3jM2wCu94xgzzu1d6Dn7or,9,6,3,0,3,0,2,0,14,2.0,1,0.0,2,3,0,3,4,0,0,2,0,8,6,1
12112,107567,wnqL4ikirTp3IVDSMdZMrbw4XjnrnSDr,3VkHkmOtom3jM2wCu94xgzzu1d6Dn7or,1,0,0,0,0,0,2,0,2,0.2857142857142857,1,0.0,0,0,0,0,0,0,0,2,0,0,2,1
12113,107582,26GvHHySb58OPdFf8Mk6SNqTx0xFsgpD,3VkHkmOtom3jM2wCu94xgzzu1d6Dn7or,1,0,0,0,0,0,1,0,1,0.14285714285714285,1,0.0,0,0,0,0,0,0,0,1,0,0,1,1
12114,107629,1LoOTEJ1k2erzFX1Zw6heKGcrOnMVMUm,3VkHkmOtom3jM2wCu94xgzzu1d6Dn7or,12,18,8,0,7,0,13,0,46,6.571428571428571,1,0.0,6,8,0,7,12,0,0,13,0,21,25,1
12115,107632,MGyo4o8gjQ6E6wwX0LyAB6OgOTxee8JQ,3VkHkmOtom3jM2wCu94xgzzu1d6Dn7or,1,0,0,0,0,0,1,0,1,0.14285714285714285,1,0.0,0,0,0,0,0,0,0,1,0,0,1,1
12116,107688,5wOEfUc8ZPA9KiGaBfIyB4r8VUpQ2P6o,3VkHkmOtom3jM2wCu94xgzzu1d6Dn7or,7,5,2,0,3,0,3,0,13,1.8571428571428572,1,0.0,2,2,0,3,3,0,0,3,0,7,6,1
12117,107708,vsVhqUYkXGNDzYhAcqJvpgRZQTif8hqp,3VkHkmOtom3jM2wCu94xgzzu1d6Dn7or,5,2,1,0,1,0,2,0,6,0.8571428571428571,1,0.0,0,1,0,1,2,0,0,2,0,2,4,1
12118,107725,HhxyfxX2lkUuwRZ0VagK9INqIhhnjfvw,3VkHkmOtom3jM2wCu94xgzzu1d6Dn7or,4,5,1,0,0,0,2,0,8,1.1428571428571428,1,0.0,1,1,0,0,4,0,0,2,0,2,6,1
12119,107762,kv124loauGKO10jbqYqDYWXnHShlzRO4,3VkHkmOtom3jM2wCu94xgzzu1d6Dn7or,1,0,0,0,0,0,2,0,2,0.2857142857142857,1,0.0,0,0,0,0,0,0,0,2,0,0,2,1
12120,107766,PL62mgrpqPwo8AGEhoMOTQ6sdNxiCVqY,3VkHkmOtom3jM2wCu94xgzzu1d6Dn7or,5,5,1,0,2,0,3,0,11,1.5714285714285714,1,0.0,3,1,0,2,2,0,0,3,0,6,5,0
12121,107819,R9YG0w0hL59ToVl3yhmJRFd19TsubPDW,3VkHkmOtom3jM2wCu94xgzzu1d6Dn7or,1,0,0,0,0,0,1,0,1,0.14285714285714285,1,0.0,0,0,0,0,0,0,0,1,0,0,1,1
12122,107823,xQUW0ZINPCfWBAQh2BnHyNs9eUZ1JA0b,3VkHkmOtom3jM2wCu94xgzzu1d6Dn7or,1,0,0,0,0,0,1,0,1,0.14285714285714285,1,0.0,0,0,0,0,0,0,0,1,0,0,1,1
12123,107841,KfcZ3W9oSoFuM8WY2udTATirwh59JEJW,3VkHkmOtom3jM2wCu94xgzzu1d6Dn7or,14,16,10,0,8,0,4,0,38,5.428571428571429,2,0.0,0,10,0,8,16,0,0,4,0,18,20,1
12124,107856,9le10djZxN9iTNFKqMsYSlchlTVUSxwB,3VkHkmOtom3jM2wCu94xgzzu1d6Dn7or,5,2,1,0,1,0,3,0,7,1.0,1,0.0,0,1,0,1,2,0,0,3,0,2,5,1
12125,107861,ISUXk5sdyyrQMtfiKV2swvwh2PS1r6hM,3VkHkmOtom3jM2wCu94xgzzu1d6Dn7or,1,0,0,0,0,0,1,0,1,0.14285714285714285,1,0.0,0,0,0,0,0,0,0,1,0,0,1,1
12126,107877,GvP8ww4LGRcqaW1DVshTWjelfELX1mSf,3VkHkmOtom3jM2wCu94xgzzu1d6Dn7or,1,0,0,0,0,0,1,0,1,0.14285714285714285,1,0.0,0,0,0,0,0,0,0,1,0,0,1,1
12127,107879,iGeUboxof9bW7NItCpNmoDFMiWymYAGm,3VkHkmOtom3jM2wCu94xgzzu1d6Dn7or,1,0,0,0,0,0,1,0,1,0.14285714285714285,1,0.0,0,0,0,0,0,0,0,1,0,0,1,1
12128,107930,gtkky83CXCTW8iQ6mNLOFHjlf4zvNJmH,3VkHkmOtom3jM2wCu94xgzzu1d6Dn7or,7,4,1,0,2,0,6,4,17,2.4285714285714284,1,0.0,2,1,0,2,2,0,0,6,4,5,12,1
12129,107974,dtVsNki5zywoboI6DGdzIRSljGsEQsRE,SpATywNh6bZuzm8s1ceuBUnMUAeoAHHw,7,6,1,0,1,0,3,0,11,1.5714285714285714,1,0.0,0,1,0,1,6,0,0,3,0,2,9,1
12130,107980,lOPfkJTjHU0xkFfC9CIvobXcPYmnNHom,SpATywNh6bZuzm8s1ceuBUnMUAeoAHHw,15,22,14,10,4,0,9,0,59,8.428571428571429,2,0.0,4,14,9,4,18,0,1,9,0,31,28,0
12131,107985,3zcQqBSlndQvb088xX2bWzjwjrK9gGXb,SpATywNh6bZuzm8s1ceuBUnMUAeoAHHw,13,23,0,21,0,2,4,0,50,7.142857142857143,1,0.0,6,0,20,0,17,2,1,4,0,26,24,1
12132,107989,ilWzYGLWBh9DSc1MV8g2C4Go5wDNgUHX,RXDvfPUBYFlVdlueBFbLW0mhhAyGEqpt,1,0,0,0,0,0,1,0,1,0.14285714285714285,1,0.0,0,0,0,0,0,0,0,1,0,0,1,1
12133,108004,6oCIsm9feSmMCAtwRcz7U3xMlVdQPmgW,SpATywNh6bZuzm8s1ceuBUnMUAeoAHHw,6,3,1,0,1,0,2,0,7,1.0,1,0.0,0,1,0,1,3,0,0,2,0,2,5,1
12134,108008,7JBtUpIhUnYCA4q3ae7hJoTZvMtE4cUd,SpATywNh6bZuzm8s1ceuBUnMUAeoAHHw,21,44,10,3,5,1,11,1,75,10.714285714285714,5,0.0,2,10,3,5,42,1,0,11,1,20,55,1
12135,108022,PouZmZXexxytkMLV0zJhqCjIk5MXfiuJ,SpATywNh6bZuzm8s1ceuBUnMUAeoAHHw,17,18,7,21,4,17,6,2,75,10.714285714285714,1,0.0,8,7,17,4,10,17,4,6,2,36,39,1
12136,108028,bDxjtNxv0fWJdWWEfRKEUv4YBma9IgaW,SpATywNh6bZuzm8s1ceuBUnMUAeoAHHw,15,18,8,18,4,5,12,1,66,9.428571428571429,2,0.0,4,8,16,4,14,5,2,12,1,32,34,1
12137,108043,e2g6ypvlbdTJJDNt2jr7tkCU179qUmrV,SpATywNh6bZuzm8s1ceuBUnMUAeoAHHw,1,0,0,0,0,0,1,0,1,0.14285714285714285,1,0.0,0,0,0,0,0,0,0,1,0,0,1,1
12138,108056,P6v79AbA8JNvvK6UNaNGagvsf7jk48sR,SpATywNh6bZuzm8s1ceuBUnMUAeoAHHw,5,2,1,0,1,0,2,0,6,0.8571428571428571,1,0.0,0,1,0,1,2,0,0,2,0,2,4,1
12139,108059,YHlbNc2DvzqJVtSUhFFwHv9LTYvtn9Mw,RXDvfPUBYFlVdlueBFbLW0mhhAyGEqpt,1,0,0,0,0,0,2,0,2,0.2857142857142857,1,0.0,0,0,0,0,0,0,0,2,0,0,2,1
12140,108063,FLuCisP22zuNYM50DiHloNWfjCL7Trqn,SpATywNh6bZuzm8s1ceuBUnMUAeoAHHw,7,7,2,0,1,0,3,0,13,1.8571428571428572,2,0.0,0,2,0,1,7,0,0,3,0,3,10,1
12141,108066,biPbQQgRZQFKOAVcr8zCs5vcz2Zp7TtR,SpATywNh6bZuzm8s1ceuBUnMUAeoAHHw,6,5,3,0,2,0,3,0,13,1.8571428571428572,1,0.0,0,3,0,2,5,0,0,3,0,5,8,1
12142,108067,7LgsB1Dbs9AWbCH4Qtqx9aZFnEle1djD,A3fsA9Zfv1X2fVEQhTw51lKENdNrEqT3,6,3,0,0,0,0,5,0,8,1.1428571428571428,1,0.0,0,0,0,0,3,0,0,5,0,0,8,1
12143,108068,521YJDVy6G9ul5QyLTUZAuztPLpe7gqW,A3fsA9Zfv1X2fVEQhTw51lKENdNrEqT3,8,4,2,0,0,4,10,0,20,2.857142857142857,1,0.0,1,2,0,0,3,4,0,10,0,3,17,1
12144,108075,EboqTOLce3Kcnbr13rePsINEM3noHrcD,A3fsA9Zfv1X2fVEQhTw51lKENdNrEqT3,40,23,15,62,8,29,7,0,144,20.571428571428573,4,0.0,4,15,55,8,19,29,7,7,0,82,62,1
12145,108077,aiXR63FJxLzLjxOw200I9QHjcVwt5TEN,RXDvfPUBYFlVdlueBFbLW0mhhAyGEqpt,1,0,0,0,0,0,1,0,1,0.14285714285714285,1,0.0,0,0,0,0,0,0,0,1,0,0,1,1
12146,108080,KMcnmZ5Os9sw6KyJ7BWURh6K8QGi1wsV,bWdj2GDclj5ofokWjzoa5jAwMkxCykd6,8,6,1,0,2,0,3,0,12,1.7142857142857142,1,0.0,2,1,0,2,4,0,0,3,0,5,7,1
12147,108086,3pgK06P2oLAcnmiNZRznn0B0EGmUgMOP,SpATywNh6bZuzm8s1ceuBUnMUAeoAHHw,6,9,3,0,1,0,4,0,17,2.4285714285714284,1,0.0,0,3,0,1,9,0,0,4,0,4,13,1
12148,108100,KYKzKpnBUYOr84PudAmq8tNzhwmTGrJ8,A3fsA9Zfv1X2fVEQhTw51lKENdNrEqT3,10,5,3,0,2,1,6,1,18,2.5714285714285716,1,0.0,0,3,0,2,5,1,0,6,1,5,13,1
12149,108102,7aA6BrVZipLHOrozlrYBMEmfMq4MXahq,SpATywNh6bZuzm8s1ceuBUnMUAeoAHHw,4,6,0,0,0,0,2,0,8,1.1428571428571428,1,0.0,0,0,0,0,6,0,0,2,0,0,8,1
12150,108103,2jvZGTQOv5HI5u69PvJ98o1zG3YXhtLw,SpATywNh6bZuzm8s1ceuBUnMUAeoAHHw,12,12,4,11,2,1,2,0,32,4.571428571428571,1,0.0,6,4,10,2,6,1,1,2,0,22,10,1
12151,108114,sgggYhWjUONtSvJl6cytWZyV2XJXwrfv,RXDvfPUBYFlVdlueBFbLW0mhhAyGEqpt,1,0,0,0,0,0,1,0,1,0.14285714285714285,1,0.0,0,0,0,0,0,0,0,1,0,0,1,1
12152,108117,dpzYaESA6MCFHXGYe2bLHvSr1kNOP50p,bWdj2GDclj5ofokWjzoa5jAwMkxCykd6,1,0,0,0,0,0,1,0,1,0.14285714285714285,1,0.0,0,0,0,0,0,0,0,1,0,0,1,1
12153,108124,dpzYaESA6MCFHXGYe2bLHvSr1kNOP50p,RXDvfPUBYFlVdlueBFbLW0mhhAyGEqpt,1,0,0,0,0,0,1,0,1,0.14285714285714285,1,0.0,0,0,0,0,0,0,0,1,0,0,1,1
12154,108126,5vV5bz7iJVuZlu434ocQi0K0Vkr9Mwnk,bWdj2GDclj5ofokWjzoa5jAwMkxCykd6,4,2,0,0,0,0,4,0,6,0.8571428571428571,1,0.0,0,0,0,0,2,0,0,4,0,0,6,1
12155,108129,5vV5bz7iJVuZlu434ocQi0K0Vkr9Mwnk,A3fsA9Zfv1X2fVEQhTw51lKENdNrEqT3,2,0,0,0,0,0,3,0,3,0.42857142857142855,1,0.0,0,0,0,0,0,0,0,3,0,0,3,1
12156,108132,2w4cE1JaIeIFAZaP4jTngJpTehNnFzsI,G8EPVSXsOYB5YQWZGiz1aVq5Pgr2GrQu,4,2,0,0,0,0,2,0,4,0.5714285714285714,1,0.0,0,0,0,0,2,0,0,2,0,0,4,0
12157,108137,wKzEabDf6tGdNdSmhgTmVPwzaHM3HdDm,bWdj2GDclj5ofokWjzoa5jAwMkxCykd6,1,0,0,0,0,0,1,0,1,0.14285714285714285,1,0.0,0,0,0,0,0,0,0,1,0,0,1,1
12158,108140,wKzEabDf6tGdNdSmhgTmVPwzaHM3HdDm,A3fsA9Zfv1X2fVEQhTw51lKENdNrEqT3,1,0,0,0,0,0,1,0,1,0.14285714285714285,1,0.0,0,0,0,0,0,0,0,1,0,0,1,1
12159,108154,hbTx2HlAPaSfk5EORjF7ocOSpDhWinaD,G8EPVSXsOYB5YQWZGiz1aVq5Pgr2GrQu,52,127,77,124,39,1,31,0,399,57.0,4,0.0,17,77,101,39,110,1,23,31,0,234,165,0
12160,108178,vz93ZdWSu0NWsoHKFr8vIf7NHeIpZbfP,bWdj2GDclj5ofokWjzoa5jAwMkxCykd6,7,3,2,0,2,0,2,0,9,1.2857142857142858,1,0.0,0,2,0,2,3,0,0,2,0,4,5,1
12161,108187,TSPlBwReynnjQ2q72CnYFjLp85rX76cJ,A3fsA9Zfv1X2fVEQhTw51lKENdNrEqT3,2,0,0,0,0,0,2,0,2,0.2857142857142857,1,0.0,0,0,0,0,0,0,0,2,0,0,2,1
12162,108190,bGjzMxOC88rUacNGu6kshAaxdH2zKDK7,A3fsA9Zfv1X2fVEQhTw51lKENdNrEqT3,6,9,0,0,0,0,1,0,10,1.4285714285714286,1,0.0,0,0,0,0,9,0,0,1,0,0,10,1
12163,108213,zrXVmAXKkFc8iiWu8fCjaRvDc9MMQT2x,SpATywNh6bZuzm8s1ceuBUnMUAeoAHHw,4,2,1,0,1,0,1,0,5,0.7142857142857143,1,0.0,0,1,0,1,2,0,0,1,0,2,3,1
12164,108217,6In9aidJiz35UAmMIZUhwjQpPpqW4IPc,A3fsA9Zfv1X2fVEQhTw51lKENdNrEqT3,4,3,1,0,0,0,4,0,8,1.1428571428571428,1,0.0,0,1,0,0,3,0,0,4,0,1,7,1
12165,108228,6In9aidJiz35UAmMIZUhwjQpPpqW4IPc,bWdj2GDclj5ofokWjzoa5jAwMkxCykd6,2,0,0,0,0,0,2,0,2,0.2857142857142857,1,0.0,0,0,0,0,0,0,0,2,0,0,2,1
12166,108235,uGnwUJpu1DKiWsVPpyszxZyMbYFsrVu7,SpATywNh6bZuzm8s1ceuBUnMUAeoAHHw,13,13,6,11,3,4,3,0,40,5.714285714285714,2,0.0,5,6,11,3,8,4,0,3,0,25,15,0
12167,108247,JVwYgpbMnhyXKC0xUgsIj4AIloKjDOV1,A3fsA9Zfv1X2fVEQhTw51lKENdNrEqT3,4,2,0,0,0,2,3,0,7,1.0,2,0.0,0,0,0,0,2,2,0,3,0,0,7,1
12168,108251,Exf9rFmbTdsimBjbWioKYnQ8NgdvC5jd,RXDvfPUBYFlVdlueBFbLW0mhhAyGEqpt,8,9,1,0,0,0,1,0,11,1.5714285714285714,1,0.0,0,1,0,0,9,0,0,1,0,1,10,1
12169,108256,D6COhDGqanxSpN5gApKicTTjeA66WqVe,SpATywNh6bZuzm8s1ceuBUnMUAeoAHHw,1,0,0,0,0,0,1,0,1,0.14285714285714285,1,0.0,0,0,0,0,0,0,0,1,0,0,1,1
12170,108262,BKTGezJoHjleu4tXARXtOL0EOZtL4wb9,bWdj2GDclj5ofokWjzoa5jAwMkxCykd6,9,11,5,0,3,0,2,0,21,3.0,3,0.0,0,5,0,3,11,0,0,2,0,8,13,1
12171,108283,hmtOqZVjWQ6rLJb3YkFWytQIy20ogszh,A3fsA9Zfv1X2fVEQhTw51lKENdNrEqT3,5,2,1,0,1,0,3,0,7,1.0,1,0.0,0,1,0,1,2,0,0,3,0,2,5,1
12172,108289,uidhjEbrao8Ccg3eBjaALRRkH9i692Ay,RXDvfPUBYFlVdlueBFbLW0mhhAyGEqpt,1,0,0,0,0,0,1,0,1,0.14285714285714285,1,0.0,0,0,0,0,0,0,0,1,0,0,1,1
12173,108291,KEDl5eQRZ3KXdMwf0omOM9Nnx9xLsQXi,SpATywNh6bZuzm8s1ceuBUnMUAeoAHHw,4,2,0,0,0,0,3,0,5,0.7142857142857143,1,0.0,0,0,0,0,2,0,0,3,0,0,5,1
12174,108292,uux8SuQRwPqDOuP8QlaB5wBQy6rHdvqS,SpATywNh6bZuzm8s1ceuBUnMUAeoAHHw,5,3,1,0,1,4,2,0,11,1.5714285714285714,1,0.0,0,1,0,1,3,4,0,2,0,2,9,1
12175,108301,cLfffYpPluVkrQWrGySOJC5E8Pia7HHf,A3fsA9Zfv1X2fVEQhTw51lKENdNrEqT3,2,0,0,0,0,0,2,0,2,0.2857142857142857,1,0.0,0,0,0,0,0,0,0,2,0,0,2,1
12176,108307,dbPMzxs1MK4eXxSu7capyuymr7qmuT7h,G8EPVSXsOYB5YQWZGiz1aVq5Pgr2GrQu,8,14,5,0,4,0,4,0,27,3.857142857142857,1,0.0,0,5,0,4,14,0,0,4,0,9,18,1
12177,108319,yVtzjNm7Xgz14yjopuLvCh7VRZR9RBra,A3fsA9Zfv1X2fVEQhTw51lKENdNrEqT3,5,0,0,0,0,6,8,0,14,2.0,1,0.0,0,0,0,0,0,6,0,8,0,0,14,1
12178,108328,xzsuu7TKRpeInAyJlxSvMP3hCrOSGC3q,G8EPVSXsOYB5YQWZGiz1aVq5Pgr2GrQu,7,6,2,0,2,0,4,0,14,2.0,1,0.0,3,2,0,2,3,0,0,4,0,7,7,1
12179,108342,LWnw8PqIiH64F1iHRbOem9hLLYoUuhVp,SpATywNh6bZuzm8s1ceuBUnMUAeoAHHw,1,0,0,0,0,0,1,0,1,0.14285714285714285,1,0.0,0,0,0,0,0,0,0,1,0,0,1,1
12180,108349,YbIRWz7aGoZEJGOL5qUEZpXGM6vHAAAA,SpATywNh6bZuzm8s1ceuBUnMUAeoAHHw,7,3,2,0,2,0,2,0,9,1.2857142857142858,1,0.0,0,2,0,2,3,0,0,2,0,4,5,1
12181,108363,LSAqQ9qRJ6IA5mDIPLRj3aw5O17rNapz,SpATywNh6bZuzm8s1ceuBUnMUAeoAHHw,4,3,0,0,0,0,1,0,4,0.5714285714285714,1,0.0,0,0,0,0,3,0,0,1,0,0,4,1
12182,108369,ZelBFCiIf4nT2uZgj3xzub7opPstKtrk,SpATywNh6bZuzm8s1ceuBUnMUAeoAHHw,1,0,0,0,0,0,1,0,1,0.14285714285714285,1,0.0,0,0,0,0,0,0,0,1,0,0,1,1
12183,108382,GibLcUgLW0dAKrvBvyjm1UI7aEhY2EYI,SpATywNh6bZuzm8s1ceuBUnMUAeoAHHw,7,7,5,0,3,0,5,0,20,2.857142857142857,1,0.0,0,5,0,3,7,0,0,5,0,8,12,1
12184,108383,dgp1qm7PjXoVV4MjyzuvWetQrJ3T9kos,SpATywNh6bZuzm8s1ceuBUnMUAeoAHHw,1,0,0,0,0,0,1,0,1,0.14285714285714285,1,0.0,0,0,0,0,0,0,0,1,0,0,1,1
12185,108384,HErgZ4jawN9YK19iQGOcyzXBTFaOouqG,bWdj2GDclj5ofokWjzoa5jAwMkxCykd6,7,4,3,0,3,0,2,0,12,1.7142857142857142,1,0.0,0,3,0,3,4,0,0,2,0,6,6,1
12186,108386,eBckG9AVr6bIBOpezfRr2S1KzQMM7OtD,G8EPVSXsOYB5YQWZGiz1aVq5Pgr2GrQu,21,31,20,0,12,8,9,1,81,11.571428571428571,3,0.0,0,20,0,12,31,8,0,9,1,32,49,0
12187,108388,M5VVteWQySX3L3J4dk5RJz0FGibCUyC6,SpATywNh6bZuzm8s1ceuBUnMUAeoAHHw,1,0,0,0,0,0,2,0,2,0.2857142857142857,1,0.0,0,0,0,0,0,0,0,2,0,0,2,1
12188,108444,slbuLFnaQZJ34dE8jfJqWtRl7JJLBe8u,SpATywNh6bZuzm8s1ceuBUnMUAeoAHHw,8,7,4,0,2,0,3,0,16,2.2857142857142856,1,0.0,0,4,0,2,7,0,0,3,0,6,10,1
12189,108472,AVjxFBCViTyDwpTqU42MWgJe18swM9dv,A3fsA9Zfv1X2fVEQhTw51lKENdNrEqT3,1,0,0,0,0,0,1,0,1,0.14285714285714285,1,0.0,0,0,0,0,0,0,0,1,0,0,1,1
12190,108477,0utD2vP6cBRtrip5Htxbgl8CGlMSWQLX,bWdj2GDclj5ofokWjzoa5jAwMkxCykd6,7,4,1,0,2,31,5,0,43,6.142857142857143,1,0.0,3,1,0,2,1,31,0,5,0,6,37,1
12191,108489,HBfe50okXo4yGURKfz5xhaX3ToIkoF7Q,A3fsA9Zfv1X2fVEQhTw51lKENdNrEqT3,46,48,23,61,12,20,11,1,176,25.142857142857142,2,0.0,1,23,51,12,47,20,10,11,1,87,89,1
12192,108497,FtVfxMAHOJCihrndIwrct9vQdb6Q44Wo,A3fsA9Zfv1X2fVEQhTw51lKENdNrEqT3,6,0,0,0,0,1,12,2,15,2.142857142857143,1,0.0,0,0,0,0,0,1,0,12,2,0,15,1
12193,108502,DfCpxv5XAI5uu8kT5xePLzsIgRboevuL,bWdj2GDclj5ofokWjzoa5jAwMkxCykd6,4,2,0,0,0,1,4,0,7,1.0,1,0.0,0,0,0,0,2,1,0,4,0,0,7,1
12194,108527,zbpyeHVfqJFGdhXASTaYNBrzQldiaNac,RXDvfPUBYFlVdlueBFbLW0mhhAyGEqpt,1,0,0,0,0,0,1,0,1,0.14285714285714285,1,0.0,0,0,0,0,0,0,0,1,0,0,1,1
12195,108530,vZzTgGwK0cR24BSm1xzdfANP52hj4iMk,SpATywNh6bZuzm8s1ceuBUnMUAeoAHHw,2,0,0,0,0,0,2,0,2,0.2857142857142857,1,0.0,0,0,0,0,0,0,0,2,0,0,2,1
12196,108537,CZVgFr3TEx4eVQgnanHCgaKUvWrCxqq0,bWdj2GDclj5ofokWjzoa5jAwMkxCykd6,1,0,0,0,0,0,1,0,1,0.14285714285714285,1,0.0,0,0,0,0,0,0,0,1,0,0,1,1
12197,108561,cJebZdZYNfcRFrDILULKtUjsVZucvQNZ,bWdj2GDclj5ofokWjzoa5jAwMkxCykd6,1,0,0,0,0,0,1,0,1,0.14285714285714285,1,0.0,0,0,0,0,0,0,0,1,0,0,1,1
12198,108566,ojqlaWuS8RKsQp5vm29IP0i1rlepDfW4,SpATywNh6bZuzm8s1ceuBUnMUAeoAHHw,9,7,3,0,1,0,5,0,16,2.2857142857142856,2,0.0,0,3,0,1,7,0,0,5,0,4,12,1
12199,108579,CppQWIoYRvNJi8vbZRpDyWKb0nwHtu8o,SpATywNh6bZuzm8s1ceuBUnMUAeoAHHw,8,9,3,0,1,0,3,0,16,2.2857142857142856,1,0.0,0,3,0,1,9,0,0,3,0,4,12,1
12200,108586,zGoXWftPbgMoerOVXBTD4diPBqy753pp,SpATywNh6bZuzm8s1ceuBUnMUAeoAHHw,14,16,8,11,0,2,10,1,48,6.857142857142857,2,0.0,4,8,10,0,12,2,1,10,1,22,26,1
12201,108588,anqtRE1JbVfWjk9aVYgpNXBcTCoFe9WO,RXDvfPUBYFlVdlueBFbLW0mhhAyGEqpt,1,0,0,0,0,0,2,0,2,0.2857142857142857,2,0.0,0,0,0,0,0,0,0,2,0,0,2,1
12202,108598,imxSDm2buzZ62mNMbQHQ2TU94JYpOhZs,A3fsA9Zfv1X2fVEQhTw51lKENdNrEqT3,2,0,0,0,0,0,2,0,2,0.2857142857142857,1,0.0,0,0,0,0,0,0,0,2,0,0,2,1
12203,108606,l1knNMDAAaNYCbUzngkK8zi8ibAxSEhp,SpATywNh6bZuzm8s1ceuBUnMUAeoAHHw,1,0,0,0,0,0,1,0,1,0.14285714285714285,1,0.0,0,0,0,0,0,0,0,1,0,0,1,1
12204,108614,QNTRCRLtlkIMOKaNSTyyYSuzmrMmUnRO,SpATywNh6bZuzm8s1ceuBUnMUAeoAHHw,11,12,1,17,0,0,2,0,32,4.571428571428571,1,0.0,2,1,14,0,10,0,3,2,0,17,15,1
12205,108616,9Em7ZIIQKauUvueNLPgAUpkXgxbNUW1r,A3fsA9Zfv1X2fVEQhTw51lKENdNrEqT3,16,17,7,0,6,0,6,0,36,5.142857142857143,1,0.0,0,7,0,6,17,0,0,6,0,13,23,1
12206,108620,5USBnLyMGXd4vW6kBwxN1Sg97co2qZq2,A3fsA9Zfv1X2fVEQhTw51lKENdNrEqT3,3,2,0,0,0,0,2,0,4,0.5714285714285714,1,0.0,0,0,0,0,2,0,0,2,0,0,4,1
12207,108622,QBPT1uwial7Y5XFWw81ordtuhoTMulQT,A3fsA9Zfv1X2fVEQhTw51lKENdNrEqT3,10,4,3,0,3,0,6,0,16,2.2857142857142856,1,0.0,0,3,0,3,4,0,0,6,0,6,10,1
12208,108623,vvgFtJK0OvK0nLiIcreYLk1PpU7Og3xn,A3fsA9Zfv1X2fVEQhTw51lKENdNrEqT3,6,1,1,0,1,0,5,0,8,1.1428571428571428,1,0.0,0,1,0,1,1,0,0,5,0,2,6,1
12209,108625,hi6YD0ZFgzDW7d6YNZOEVbYcZq8RBo6y,G8EPVSXsOYB5YQWZGiz1aVq5Pgr2GrQu,10,7,4,0,5,0,5,1,22,3.142857142857143,1,0.0,2,4,0,5,5,0,0,5,1,11,11,1
12210,108626,Pku6n7JNFwWSrlmN4ke1wEsgtvibhHUB,SpATywNh6bZuzm8s1ceuBUnMUAeoAHHw,7,4,1,0,1,0,3,0,9,1.2857142857142858,1,0.0,0,1,0,1,4,0,0,3,0,2,7,1
12211,108632,KCAa0nKBsiapAJL8hF3jy3WnrDUcaBRF,A3fsA9Zfv1X2fVEQhTw51lKENdNrEqT3,1,0,0,0,0,0,6,0,6,0.8571428571428571,1,0.0,0,0,0,0,0,0,0,6,0,0,6,1
12212,108646,WEWYd7NOLi6QToOgocTwXHUAGlncS3ka,A3fsA9Zfv1X2fVEQhTw51lKENdNrEqT3,6,7,1,0,1,0,3,0,12,1.7142857142857142,1,0.0,0,1,0,1,7,0,0,3,0,2,10,1
12213,108649,3R8N615p99BGAZXNRR4tu9I4dMAzyaYx,SpATywNh6bZuzm8s1ceuBUnMUAeoAHHw,10,6,6,0,6,0,3,0,21,3.0,1,0.0,0,6,0,6,6,0,0,3,0,12,9,1
12214,108651,LWFByRJk3azFmQgQM4UimOOGLsmXN342,A3fsA9Zfv1X2fVEQhTw51lKENdNrEqT3,1,0,0,0,0,0,3,0,3,0.42857142857142855,1,0.0,0,0,0,0,0,0,0,3,0,0,3,1
12215,108657,TxKyOi1lNIjE6GBf0G1VUEkgRaSNv5aU,bWdj2GDclj5ofokWjzoa5jAwMkxCykd6,5,2,1,0,1,0,2,0,6,0.8571428571428571,1,0.0,0,1,0,1,2,0,0,2,0,2,4,0
12216,108663,IVLYBILu5bsz4kc422I8sXYkTLjww3zh,SpATywNh6bZuzm8s1ceuBUnMUAeoAHHw,5,4,2,0,1,0,3,0,10,1.4285714285714286,1,0.0,0,2,0,1,4,0,0,3,0,3,7,1
12217,108666,wTFt4jd8Vf2XnbTwygw9m5uOggZGQW45,A3fsA9Zfv1X2fVEQhTw51lKENdNrEqT3,4,3,0,0,0,0,2,0,5,0.7142857142857143,1,0.0,0,0,0,0,3,0,0,2,0,0,5,1
12218,108671,uxgNKX0ZdDu87Z4mjH6KkxEGynnwur5T,A3fsA9Zfv1X2fVEQhTw51lKENdNrEqT3,3,4,0,0,0,0,2,0,6,0.8571428571428571,1,0.0,0,0,0,0,4,0,0,2,0,0,6,1
12219,108680,fihaFvHVK0WmjfjHHr8uDKIAQygBbKLV,A3fsA9Zfv1X2fVEQhTw51lKENdNrEqT3,1,0,0,0,0,0,1,0,1,0.14285714285714285,1,0.0,0,0,0,0,0,0,0,1,0,0,1,1
12220,108687,ABbPtVE9vR3q9TnGdVr0jhQS05eL9aJw,A3fsA9Zfv1X2fVEQhTw51lKENdNrEqT3,15,11,6,0,4,9,11,1,42,6.0,1,0.0,0,6,0,4,11,9,0,11,1,10,32,0
12221,108696,5Rbvag4nzKt7RfTqiThTliUWaR0ZVWak,bWdj2GDclj5ofokWjzoa5jAwMkxCykd6,14,23,13,22,8,4,11,1,82,11.714285714285714,1,0.0,7,13,21,8,16,4,1,11,1,49,33,1
12222,108697,6HIBebNSnNEoSeekVShzxF3x0IcbgohT,A3fsA9Zfv1X2fVEQhTw51lKENdNrEqT3,11,12,1,0,1,2,3,0,19,2.7142857142857144,2,0.0,1,1,0,1,11,2,0,3,0,3,16,1
12223,108708,5Rbvag4nzKt7RfTqiThTliUWaR0ZVWak,A3fsA9Zfv1X2fVEQhTw51lKENdNrEqT3,8,8,5,0,1,0,5,0,19,2.7142857142857144,1,0.0,2,5,0,1,6,0,0,5,0,8,11,1
12224,108719,WF6wuTvQFfQjN4sNbpLPNNaCItibHnsk,SpATywNh6bZuzm8s1ceuBUnMUAeoAHHw,5,2,1,0,1,0,2,0,6,0.8571428571428571,1,0.0,0,1,0,1,2,0,0,2,0,2,4,1
12225,108722,MSyG0cZLfbMN5GFb3dR5puqqT5uvCbhT,SpATywNh6bZuzm8s1ceuBUnMUAeoAHHw,6,1,1,0,1,0,3,0,6,0.8571428571428571,1,0.0,0,1,0,1,1,0,0,3,0,2,4,1
12226,108725,2qs5o4ShoJi8U8TmD1cNHDzshN8FK6oF,A3fsA9Zfv1X2fVEQhTw51lKENdNrEqT3,2,0,0,0,0,0,4,0,4,0.5714285714285714,1,0.0,0,0,0,0,0,0,0,4,0,0,4,1
12227,108728,I5y7gNrP5Yz8ZedoBMi3comUdlpFv5gJ,SpATywNh6bZuzm8s1ceuBUnMUAeoAHHw,3,2,0,0,0,0,1,0,3,0.42857142857142855,1,0.0,0,0,0,0,2,0,0,1,0,0,3,1
12228,108732,2Zhak41HpdUHgCzOLAuYT50kXg4d3Zji,G8EPVSXsOYB5YQWZGiz1aVq5Pgr2GrQu,5,2,1,0,1,0,2,0,6,0.8571428571428571,1,0.0,0,1,0,1,2,0,0,2,0,2,4,1
12229,108736,mFyBIO6GmLHqTEssxzuSwYKXW2BbEyYv,A3fsA9Zfv1X2fVEQhTw51lKENdNrEqT3,7,6,4,0,3,0,2,0,15,2.142857142857143,1,0.0,0,4,0,3,6,0,0,2,0,7,8,1
12230,108740,z8PlFZ3kRCGZCtReInG4syWyRUKvCeDo,RXDvfPUBYFlVdlueBFbLW0mhhAyGEqpt,87,125,6,202,19,1,11,1,365,52.142857142857146,5,0.0,56,6,192,19,69,1,10,11,1,273,92,0
12231,108741,8bMxud2pJnttNvsNwa7l9gc36Q1hRhIk,A3fsA9Zfv1X2fVEQhTw51lKENdNrEqT3,8,4,3,0,3,0,1,0,11,1.5714285714285714,1,0.0,0,3,0,3,4,0,0,1,0,6,5,1
12232,108748,ABbPtVE9vR3q9TnGdVr0jhQS05eL9aJw,bWdj2GDclj5ofokWjzoa5jAwMkxCykd6,6,2,1,0,1,0,3,0,7,1.0,1,0.0,0,1,0,1,2,0,0,3,0,2,5,1
12233,108756,h2bHu87wTYXhBBhcXbsLbNIYZ54rAZgt,A3fsA9Zfv1X2fVEQhTw51lKENdNrEqT3,45,38,27,84,19,7,14,1,190,27.142857142857142,1,0.0,4,27,74,19,34,7,10,14,1,124,66,1
12234,108765,wJC86gc3viBGM4vTuYg8647vhYAtlLLc,A3fsA9Zfv1X2fVEQhTw51lKENdNrEqT3,1,0,0,0,0,0,1,0,1,0.14285714285714285,1,0.0,0,0,0,0,0,0,0,1,0,0,1,1
12235,108766,sOb1oiy6NjSaiCXhGkHSqKHtlguCQRa0,A3fsA9Zfv1X2fVEQhTw51lKENdNrEqT3,1,0,0,0,0,0,1,0,1,0.14285714285714285,1,0.0,0,0,0,0,0,0,0,1,0,0,1,1
12236,108769,K1Izk0V4ksCL81zmOeuNNasAXwE95TLa,SpATywNh6bZuzm8s1ceuBUnMUAeoAHHw,1,0,0,0,0,0,2,0,2,0.2857142857142857,1,0.0,0,0,0,0,0,0,0,2,0,0,2,1
12237,108771,AvefCXcG5Ufaee9dlfNQnJvhOv3ejoZa,bWdj2GDclj5ofokWjzoa5jAwMkxCykd6,16,19,3,94,5,2,13,2,138,19.714285714285715,2,0.0,11,3,91,5,8,2,3,13,2,110,28,1
12238,108782,KdDp90RfX0ap0e8qJs31e2eGxlYje3er,A3fsA9Zfv1X2fVEQhTw51lKENdNrEqT3,41,39,18,96,10,0,8,0,171,24.428571428571427,4,0.0,3,18,83,10,36,0,13,8,0,114,57,1
12239,108786,ue5DigOvMG1l9Z3tvu2VwrvC8NR96FUy,SpATywNh6bZuzm8s1ceuBUnMUAeoAHHw,3,2,0,0,0,0,2,0,4,0.5714285714285714,1,0.0,0,0,0,0,2,0,0,2,0,0,4,1
12240,108787,x7jRdqJhx5ja6FBqxJnzxkapRPVQ2fNm,A3fsA9Zfv1X2fVEQhTw51lKENdNrEqT3,1,0,0,0,0,0,1,0,1,0.14285714285714285,1,0.0,0,0,0,0,0,0,0,1,0,0,1,1
12241,108789,AmjIDQe44ue5n1ufYmtWXDVGVMWDOkiz,A3fsA9Zfv1X2fVEQhTw51lKENdNrEqT3,3,3,0,0,0,0,1,0,4,0.5714285714285714,1,0.0,0,0,0,0,3,0,0,1,0,0,4,1
12242,108793,tn5nSlJLNdxx4Uni5Dn3S8nwDR8GJibq,A3fsA9Zfv1X2fVEQhTw51lKENdNrEqT3,14,7,5,0,3,1,7,1,24,3.4285714285714284,1,0.0,0,5,0,3,7,1,0,7,1,8,16,1
12243,108798,O12TpofOcB7jKUNGaL0IFXdieGzZ8DbW,SpATywNh6bZuzm8s1ceuBUnMUAeoAHHw,4,2,0,0,0,0,2,0,4,0.5714285714285714,1,0.0,0,0,0,0,2,0,0,2,0,0,4,1
12244,108799,J8izYPuHoJnyIb9qLV3GxLKVHOmNnyCQ,bWdj2GDclj5ofokWjzoa5jAwMkxCykd6,7,3,1,22,0,0,5,0,31,4.428571428571429,1,0.0,1,1,21,0,2,0,1,5,0,23,8,1
12245,108810,zcKuGtc5O9cMvHSHaVwufdFteCrEpUtA,A3fsA9Zfv1X2fVEQhTw51lKENdNrEqT3,69,43,25,164,16,37,11,0,296,42.285714285714285,4,0.0,3,25,138,16,40,37,26,11,0,182,114,1
12246,108835,NJrnUAVHenUfV0p23UPZO1ifAbb8gJ0p,SpATywNh6bZuzm8s1ceuBUnMUAeoAHHw,6,4,1,0,1,0,1,0,7,1.0,1,0.0,0,1,0,1,4,0,0,1,0,2,5,1
12247,108845,VBP5PzVQEKJYFH0y5ffEek5WfP9EW7uc,bWdj2GDclj5ofokWjzoa5jAwMkxCykd6,11,19,11,32,5,14,7,0,88,12.571428571428571,7,0.0,1,11,30,5,18,14,2,7,0,47,41,1
12248,108855,KQaABjEuQepl9FAcsVuUoYwnLleiOaUh,A3fsA9Zfv1X2fVEQhTw51lKENdNrEqT3,12,10,7,0,5,0,3,0,25,3.5714285714285716,1,0.0,0,7,0,5,10,0,0,3,0,12,13,1
12249,108856,AmiJtmcKc0Yc4REOzpITViIEZy1tcMgF,A3fsA9Zfv1X2fVEQhTw51lKENdNrEqT3,2,0,0,0,0,0,4,0,4,0.5714285714285714,1,0.0,0,0,0,0,0,0,0,4,0,0,4,1
12250,108857,XaYV3yff9o91oPBR4K32BeMm7Wg8wnLi,A3fsA9Zfv1X2fVEQhTw51lKENdNrEqT3,1,0,0,0,0,0,1,0,1,0.14285714285714285,1,0.0,0,0,0,0,0,0,0,1,0,0,1,1
12251,108869,4mtoRYC9jVVxEoNU8knjZ5oLeF7Lb02c,SpATywNh6bZuzm8s1ceuBUnMUAeoAHHw,5,8,0,0,0,0,2,0,10,1.4285714285714286,2,0.0,0,0,0,0,8,0,0,2,0,0,10,1
12252,108895,RGr3DE14hb7Ufb3qkxo2JnrYRs9POJfu,A3fsA9Zfv1X2fVEQhTw51lKENdNrEqT3,8,2,1,0,1,1,5,1,11,1.5714285714285714,1,0.0,0,1,0,1,2,1,0,5,1,2,9,1
12253,108904,5upQSO7J9z4uj80lVoIg3U6hUe3UwAJY,SpATywNh6bZuzm8s1ceuBUnMUAeoAHHw,2,0,0,0,0,0,2,0,2,0.2857142857142857,1,0.0,0,0,0,0,0,0,0,2,0,0,2,1
12254,108909,PIWGwmpuvT6lwwfSr4RWZP56tih9auMI,SpATywNh6bZuzm8s1ceuBUnMUAeoAHHw,8,5,1,0,1,0,3,0,10,1.4285714285714286,1,0.0,0,1,0,1,5,0,0,3,0,2,8,1
12255,108930,9vnJJcOjSmdwXe3BZQ5uEyhKgS7hqzyX,bWdj2GDclj5ofokWjzoa5jAwMkxCykd6,5,5,1,0,0,0,4,0,10,1.4285714285714286,1,0.0,0,1,0,0,5,0,0,4,0,1,9,1
12256,108946,xCHQAq5m2mtyQES4gfg6MjCHDUVD1J71,SpATywNh6bZuzm8s1ceuBUnMUAeoAHHw,9,14,1,0,0,0,3,0,18,2.5714285714285716,4,0.0,0,1,0,0,14,0,0,3,0,1,17,0
12257,108955,kLrl7hvNIzvhv6K321CFhgLYEgDfA62M,bWdj2GDclj5ofokWjzoa5jAwMkxCykd6,1,0,0,0,0,0,2,0,2,0.2857142857142857,1,0.0,0,0,0,0,0,0,0,2,0,0,2,1
12258,108960,g6loW2VoON94gkUidTjl3Rc73OlFLAiK,A3fsA9Zfv1X2fVEQhTw51lKENdNrEqT3,2,0,0,0,0,0,2,0,2,0.2857142857142857,1,0.0,0,0,0,0,0,0,0,2,0,0,2,0
12259,108961,xOpIfUll35xPHM6WEP4Czjw6kk2qoOGO,SpATywNh6bZuzm8s1ceuBUnMUAeoAHHw,5,9,5,0,3,0,5,0,22,3.142857142857143,3,0.0,0,5,0,3,9,0,0,5,0,8,14,1
12260,108968,iRrv3nyo6BGr7ILpR2ahzmHKuzrYBh4I,SpATywNh6bZuzm8s1ceuBUnMUAeoAHHw,5,3,2,0,0,0,2,0,7,1.0,1,0.0,0,2,0,0,3,0,0,2,0,2,5,1
12261,108975,O5osNpvARQ134oncM7N5QGhst9sMjRtB,A3fsA9Zfv1X2fVEQhTw51lKENdNrEqT3,4,2,0,0,0,0,2,0,4,0.5714285714285714,1,0.0,0,0,0,0,2,0,0,2,0,0,4,1
12262,108989,i67qzouvUD7nINgK6d1xrH4pvufZqbFd,A3fsA9Zfv1X2fVEQhTw51lKENdNrEqT3,4,4,0,0,0,0,2,0,6,0.8571428571428571,1,0.0,0,0,0,0,4,0,0,2,0,0,6,0
12263,108990,OBplED2L50SmrdwVpOVn4VpcRjjudLK7,A3fsA9Zfv1X2fVEQhTw51lKENdNrEqT3,5,2,1,0,1,0,2,0,6,0.8571428571428571,1,0.0,0,1,0,1,2,0,0,2,0,2,4,1
12264,108993,SvKqfRpvSIeLIO42O4cF9tQtaigEgElY,A3fsA9Zfv1X2fVEQhTw51lKENdNrEqT3,7,6,2,0,2,0,3,0,13,1.8571428571428572,2,0.0,0,2,0,2,6,0,0,3,0,4,9,1
12265,108996,PhB6dZZRUCfcaCQkgFVOf4MMEPnUePaG,RXDvfPUBYFlVdlueBFbLW0mhhAyGEqpt,5,2,1,0,1,0,2,0,6,0.8571428571428571,1,0.0,0,1,0,1,2,0,0,2,0,2,4,1
12266,108999,3eJvDKkDryOUbJ3SYPy86iIynJcgnuci,SpATywNh6bZuzm8s1ceuBUnMUAeoAHHw,1,0,0,0,0,0,1,0,1,0.14285714285714285,1,0.0,0,0,0,0,0,0,0,1,0,0,1,1
12267,109002,qZCURwy8JtTyuwzOv8VNGZdlPKRFUQ4x,A3fsA9Zfv1X2fVEQhTw51lKENdNrEqT3,17,17,1,0,1,4,10,2,35,5.0,3,0.0,0,1,0,1,17,4,0,10,2,2,33,1
12268,109011,15KYq5P8DtSomIVrM0yWgXsvBsTL3cVz,A3fsA9Zfv1X2fVEQhTw51lKENdNrEqT3,9,5,4,0,4,0,3,0,16,2.2857142857142856,2,0.0,0,4,0,4,5,0,0,3,0,8,8,1
12269,109016,tJDZI9sjRcU2ZrvrdL12AwFT0OmQXIcr,A3fsA9Zfv1X2fVEQhTw51lKENdNrEqT3,5,2,1,0,1,0,5,0,9,1.2857142857142858,2,0.0,0,1,0,1,2,0,0,5,0,2,7,1
12270,109022,uJIh67cllxQLgAhipzdDZMEunDbuBxvF,bWdj2GDclj5ofokWjzoa5jAwMkxCykd6,1,0,0,0,0,0,1,0,1,0.14285714285714285,1,0.0,0,0,0,0,0,0,0,1,0,0,1,1
12271,109028,A1lWOqwgNzPh9AvybgvSnK3H60XpyG9J,SpATywNh6bZuzm8s1ceuBUnMUAeoAHHw,7,6,3,0,0,0,4,0,13,1.8571428571428572,1,0.0,2,3,0,0,4,0,0,4,0,5,8,1
12272,109035,qM8kx4xeCdgN7CQ3kDBj5MRznS4QMkrQ,G8EPVSXsOYB5YQWZGiz1aVq5Pgr2GrQu,1,0,0,0,0,0,1,0,1,0.14285714285714285,1,0.0,0,0,0,0,0,0,0,1,0,0,1,1
12273,109037,uCruZPKaQ2OyzLHOvqZfPPePv6wmtjTT,A3fsA9Zfv1X2fVEQhTw51lKENdNrEqT3,10,7,4,0,3,0,1,0,15,2.142857142857143,1,0.0,0,4,0,3,7,0,0,1,0,7,8,1
12274,109039,9RkNm8sDHM1l6EQFg0Uccrj0rG6zyU2p,A3fsA9Zfv1X2fVEQhTw51lKENdNrEqT3,18,13,0,32,0,0,2,0,47,6.714285714285714,1,0.0,2,0,29,0,11,0,3,2,0,31,16,1
12275,109047,JzBkQb66RlGvGZ9KheszqpvjIwSLUPa9,A3fsA9Zfv1X2fVEQhTw51lKENdNrEqT3,34,36,0,88,0,0,14,0,138,19.714285714285715,1,0.0,19,0,78,0,17,0,10,14,0,97,41,1
12276,109054,ay6BDjRoukNNZyMRT5YgyV5vrEPJDpPO,SpATywNh6bZuzm8s1ceuBUnMUAeoAHHw,8,9,6,0,4,1,5,0,25,3.5714285714285716,2,0.0,0,6,0,4,9,1,0,5,0,10,15,1
12277,109057,6UqKKdBhJ7OhJUUsVD1NV7GupMYMaBeb,RXDvfPUBYFlVdlueBFbLW0mhhAyGEqpt,15,12,8,0,6,0,3,0,29,4.142857142857143,1,0.0,0,8,0,6,12,0,0,3,0,14,15,1
12278,109059,i7lWxTot2xX5tUsFMkvVZL9ZWUCuO03L,A3fsA9Zfv1X2fVEQhTw51lKENdNrEqT3,11,9,4,0,1,1,7,2,24,3.4285714285714284,1,0.0,0,4,0,1,9,1,0,7,2,5,19,1
12279,109069,7JTB4CyOxMIYiscUQS5N24z40QJDU2NG,SpATywNh6bZuzm8s1ceuBUnMUAeoAHHw,13,13,8,7,5,0,5,0,38,5.428571428571429,2,0.0,0,8,6,5,13,0,1,5,0,19,19,1
12280,109074,3Q4BnqdcagQPfwKNQquFMuffhZmA481O,A3fsA9Zfv1X2fVEQhTw51lKENdNrEqT3,43,34,25,100,12,28,18,1,218,31.142857142857142,5,0.0,1,25,91,12,33,28,9,18,1,129,89,0
12281,109084,CJj1ly3IvknwPjPwTtDbF1Ndj6DLlK2p,A3fsA9Zfv1X2fVEQhTw51lKENdNrEqT3,1,0,0,0,0,0,1,0,1,0.14285714285714285,1,0.0,0,0,0,0,0,0,0,1,0,0,1,1
12282,109093,SSeq3zqfD5kMUB9gUKp0rdzGfihYMJi7,bWdj2GDclj5ofokWjzoa5jAwMkxCykd6,8,16,4,32,1,0,3,0,56,8.0,1,0.0,5,4,31,1,11,0,1,3,0,41,15,1
12283,109110,GqdYzH9IQjNV4Qw4poxGmkYlIXbhf40S,A3fsA9Zfv1X2fVEQhTw51lKENdNrEqT3,42,41,14,56,9,6,10,1,137,19.571428571428573,2,0.0,4,14,49,9,37,6,7,10,1,76,61,1
12284,109111,AQdHyQtscAI4B6OA1EdXFLllqKFEoazm,SpATywNh6bZuzm8s1ceuBUnMUAeoAHHw,5,2,1,0,1,0,2,0,6,0.8571428571428571,1,0.0,0,1,0,1,2,0,0,2,0,2,4,1
12285,109119,5bxm8iejKGaSX6YQr0TZiikGC5f5Uall,A3fsA9Zfv1X2fVEQhTw51lKENdNrEqT3,2,0,0,0,0,0,2,0,2,0.2857142857142857,1,0.0,0,0,0,0,0,0,0,2,0,0,2,1
12286,109122,Z9o0wypJqquui2I9MOTdTYh5ZR4U4MfH,A3fsA9Zfv1X2fVEQhTw51lKENdNrEqT3,7,3,0,0,0,0,5,0,8,1.1428571428571428,1,0.0,0,0,0,0,3,0,0,5,0,0,8,1
12287,109127,hIXeM0yyb6wIxVNnB5ijRV2LpcYBbrLW,bWdj2GDclj5ofokWjzoa5jAwMkxCykd6,1,0,0,0,0,0,1,0,1,0.14285714285714285,1,0.0,0,0,0,0,0,0,0,1,0,0,1,1
12288,109128,lvcfwg5xu40SCJNanQ0x3P780n9BnCrh,SpATywNh6bZuzm8s1ceuBUnMUAeoAHHw,5,2,1,0,1,0,2,0,6,0.8571428571428571,1,0.0,0,1,0,1,2,0,0,2,0,2,4,1
12289,109131,WixZusYrasZzR9owXlaQpXrbIZeJOheR,G8EPVSXsOYB5YQWZGiz1aVq5Pgr2GrQu,1,0,0,0,0,0,1,0,1,0.14285714285714285,1,0.0,0,0,0,0,0,0,0,1,0,0,1,1
12290,109132,ZVmjT1rppq7ilCPRRtmAl1wo0gOugsCt,A3fsA9Zfv1X2fVEQhTw51lKENdNrEqT3,49,37,31,66,25,2,8,4,173,24.714285714285715,4,0.0,2,31,58,25,35,2,8,8,4,116,57,1
12291,109136,oqLAJu8zdqUr5XPQYn4bKVmvqSIRanjc,A3fsA9Zfv1X2fVEQhTw51lKENdNrEqT3,1,0,0,0,0,0,1,0,1,0.14285714285714285,1,0.0,0,0,0,0,0,0,0,1,0,0,1,1
12292,109147,yM4AD5P6cznT9ej6JMMHXYh7GR0LcYuh,RXDvfPUBYFlVdlueBFbLW0mhhAyGEqpt,5,2,1,0,1,0,2,0,6,0.8571428571428571,1,0.0,0,1,0,1,2,0,0,2,0,2,4,0
12293,109169,7OAz0qWJXAI5T9rA3xczkfKNiBaKS5xD,A3fsA9Zfv1X2fVEQhTw51lKENdNrEqT3,5,2,1,0,1,0,3,0,7,1.0,1,0.0,0,1,0,1,2,0,0,3,0,2,5,1
12294,109181,YGxQDme0yci5ICjRYEy6Me4N0nnZ0g9H,SpATywNh6bZuzm8s1ceuBUnMUAeoAHHw,4,4,0,0,0,0,1,0,5,0.7142857142857143,1,0.0,0,0,0,0,4,0,0,1,0,0,5,1
12295,109182,QF5cQIRzKp7h2VSkoGej2U04awk99fmw,bWdj2GDclj5ofokWjzoa5jAwMkxCykd6,12,10,6,38,4,1,2,0,61,8.714285714285714,1,0.0,3,6,33,4,7,1,5,2,0,46,15,1
12296,109186,5kEshmgSAUGvBEOsnsKU8IViB0lkOwoD,A3fsA9Zfv1X2fVEQhTw51lKENdNrEqT3,23,4,0,94,0,0,4,0,102,14.571428571428571,2,0.0,1,0,78,0,3,0,16,4,0,79,23,1
12297,109189,eb3mqqeSvUWzy1wBijQrenro4Nhum9Na,SpATywNh6bZuzm8s1ceuBUnMUAeoAHHw,5,2,1,0,1,0,2,0,6,0.8571428571428571,1,0.0,0,1,0,1,2,0,0,2,0,2,4,1
12298,109191,Wigd4PnyDnjfDcFOxsTBcEnXo7kl9GSg,A3fsA9Zfv1X2fVEQhTw51lKENdNrEqT3,16,35,12,0,5,0,5,0,57,8.142857142857142,2,0.0,0,12,0,5,35,0,0,5,0,17,40,1
12299,109193,SclrH2608f72JlTtkBQ5xWQXCuDyyco3,A3fsA9Zfv1X2fVEQhTw51lKENdNrEqT3,131,46,31,440,14,3,19,0,553,79.0,8,0.0,5,31,395,14,41,3,45,19,0,445,108,0
12300,109195,1Gv11nS0XCuxdjw8VOmeY5aEETIaIhPq,A3fsA9Zfv1X2fVEQhTw51lKENdNrEqT3,9,7,4,0,3,0,2,0,16,2.2857142857142856,1,0.0,0,4,0,3,7,0,0,2,0,7,9,1
12301,109196,dUvs72HAR74VSIdDk98Za5hbojuIxWU6,A3fsA9Zfv1X2fVEQhTw51lKENdNrEqT3,7,5,1,6,0,0,1,0,13,1.8571428571428572,1,0.0,0,1,5,0,5,0,1,1,0,6,7,1
12302,109211,qGqiGKt8aL9OJtRSM5jpSwytmMiScrIj,SpATywNh6bZuzm8s1ceuBUnMUAeoAHHw,4,3,1,0,1,0,1,0,6,0.8571428571428571,1,0.0,0,1,0,1,3,0,0,1,0,2,4,1
12303,109231,eBgUh4wTe9cxKEwDUzWCU7PVyq9kVzKO,RXDvfPUBYFlVdlueBFbLW0mhhAyGEqpt,1,0,0,0,0,0,1,0,1,0.14285714285714285,1,0.0,0,0,0,0,0,0,0,1,0,0,1,1
12304,109241,XuNt1i5t4SR1AjDP4UHvsoux0R9qVf5C,SpATywNh6bZuzm8s1ceuBUnMUAeoAHHw,15,11,4,9,3,0,4,0,31,4.428571428571429,3,0.0,3,4,9,3,8,0,0,4,0,19,12,1
12305,109250,eS5XywA64oauZkENyWLpeVNsSbZFhj1k,A3fsA9Zfv1X2fVEQhTw51lKENdNrEqT3,4,2,1,0,1,0,1,0,5,0.7142857142857143,1,0.0,0,1,0,1,2,0,0,1,0,2,3,1
12306,109252,urSFKVbpyaFPrDJOmPVaNjyfC2aA3KOx,SpATywNh6bZuzm8s1ceuBUnMUAeoAHHw,9,10,3,0,2,0,10,0,25,3.5714285714285716,2,0.0,0,3,0,2,10,0,0,10,0,5,20,1
12307,109256,FHrj4N2SCEsxza13qmFjgJkCjs8BkrF3,A3fsA9Zfv1X2fVEQhTw51lKENdNrEqT3,1,0,0,0,0,0,1,0,1,0.14285714285714285,1,0.0,0,0,0,0,0,0,0,1,0,0,1,1
12308,109272,BLoa1RvSOgexbSH4hGzCihmBc8pXd0Db,SpATywNh6bZuzm8s1ceuBUnMUAeoAHHw,14,26,3,0,2,11,14,1,57,8.142857142857142,5,0.0,4,3,0,2,22,11,0,14,1,9,48,1
12309,109278,fsmpK8LD6WXenVxwQRsdTaVF7iZvaL2a,A3fsA9Zfv1X2fVEQhTw51lKENdNrEqT3,24,31,17,21,9,10,12,1,101,14.428571428571429,2,0.0,0,17,17,9,31,10,4,12,1,43,58,0
12310,109279,Y5EybULOrY5dAmMMQWE7bK5wg4bsR2Lr,A3fsA9Zfv1X2fVEQhTw51lKENdNrEqT3,26,32,21,0,9,46,13,2,123,17.571428571428573,1,0.0,0,21,0,9,32,46,0,13,2,30,93,1
12311,109281,MFZvBtjHJjKdCSK87D1kJEMGtcPTGn4S,A3fsA9Zfv1X2fVEQhTw51lKENdNrEqT3,13,14,1,0,0,9,18,2,44,6.285714285714286,5,0.0,1,1,0,0,13,9,0,18,2,2,42,1
12312,109284,wbX1noywm1bmZy8t47H8TCRwxZP7RsKK,A3fsA9Zfv1X2fVEQhTw51lKENdNrEqT3,1,0,0,0,0,0,1,0,1,0.14285714285714285,1,0.0,0,0,0,0,0,0,0,1,0,0,1,1
12313,109290,A7LjkAd6Hsm6pjjO6SeIGFgQk6AkrU13,A3fsA9Zfv1X2fVEQhTw51lKENdNrEqT3,2,0,0,0,0,0,2,0,2,0.2857142857142857,1,0.0,0,0,0,0,0,0,0,2,0,0,2,1
12314,109297,VHpS9hAicdnMqh79M7ktVNQGD7RUDs6Y,SpATywNh6bZuzm8s1ceuBUnMUAeoAHHw,1,0,0,0,0,0,1,0,1,0.14285714285714285,1,0.0,0,0,0,0,0,0,0,1,0,0,1,1
12315,109304,xIuSJsusLSQAfSXoNCyoYjZ56tZodncr,bWdj2GDclj5ofokWjzoa5jAwMkxCykd6,1,0,0,0,0,0,1,0,1,0.14285714285714285,1,0.0,0,0,0,0,0,0,0,1,0,0,1,1
12316,109312,XyoP35cBUiKk44G72mbtEXCBjk8FmHfo,RXDvfPUBYFlVdlueBFbLW0mhhAyGEqpt,25,17,11,40,5,0,6,0,79,11.285714285714286,2,0.0,4,11,37,5,13,0,3,6,0,57,22,1
12317,109317,3MhfBeZhIT9AL4Tb9CZUr8w3WzrKSn3o,A3fsA9Zfv1X2fVEQhTw51lKENdNrEqT3,3,1,0,0,0,0,4,0,5,0.7142857142857143,1,0.0,0,0,0,0,1,0,0,4,0,0,5,1
12318,109318,2kGHpLQ025yq85EhWUzksnj6YbPuOHOR,bWdj2GDclj5ofokWjzoa5jAwMkxCykd6,1,0,0,0,0,0,1,0,1,0.14285714285714285,1,0.0,0,0,0,0,0,0,0,1,0,0,1,1
12319,109319,Xv6VsjsdEll9lNbT4VRN24UmJx0y2b5E,SpATywNh6bZuzm8s1ceuBUnMUAeoAHHw,1,0,0,0,0,0,1,0,1,0.14285714285714285,1,0.0,0,0,0,0,0,0,0,1,0,0,1,1
12320,109328,1hnXgqUJOPkoCUYTmndUozE0mj3w5YNX,A3fsA9Zfv1X2fVEQhTw51lKENdNrEqT3,4,2,1,0,1,0,2,0,6,0.8571428571428571,1,0.0,0,1,0,1,2,0,0,2,0,2,4,1
12321,109344,zhiAnt6m0h6AhsgVFkvjzbntxyU6BMtY,A3fsA9Zfv1X2fVEQhTw51lKENdNrEqT3,7,3,2,0,2,0,3,1,11,1.5714285714285714,1,0.0,0,2,0,2,3,0,0,3,1,4,7,1
12322,109345,yjSLpu9rXQ5LHtGm8PnDgnJW6R5BYmgU,A3fsA9Zfv1X2fVEQhTw51lKENdNrEqT3,9,7,0,0,0,0,3,0,10,1.4285714285714286,1,0.0,1,0,0,0,6,0,0,3,0,1,9,1
12323,109346,m5W0Hr8czUb20VBRzQ0jvBI30TuPU4RJ,G8EPVSXsOYB5YQWZGiz1aVq5Pgr2GrQu,6,0,0,0,0,2,6,1,9,1.2857142857142858,1,0.0,0,0,0,0,0,2,0,6,1,0,9,1
12324,109359,G5JFEd58i47FiqQxatEMibk5NL9uoQb2,A3fsA9Zfv1X2fVEQhTw51lKENdNrEqT3,3,3,1,0,0,0,1,0,5,0.7142857142857143,1,0.0,0,1,0,0,3,0,0,1,0,1,4,1
12325,109374,Tpf1XLLzVEPyFa0H95Pm3DK4tc3XDhko,G8EPVSXsOYB5YQWZGiz1aVq5Pgr2GrQu,1,0,0,0,0,0,1,0,1,0.14285714285714285,1,0.0,0,0,0,0,0,0,0,1,0,0,1,1
12326,109376,Sqh5jl1ru6WQiSCN47rLyyyFSF0wkiCq,SpATywNh6bZuzm8s1ceuBUnMUAeoAHHw,6,9,0,0,0,0,2,0,11,1.5714285714285714,1,0.0,0,0,0,0,9,0,0,2,0,0,11,1
12327,109383,gbm2CIpey5BIwuF4GxSVVzkrIqxOpVxg,A3fsA9Zfv1X2fVEQhTw51lKENdNrEqT3,41,36,25,52,19,6,12,1,151,21.571428571428573,3,0.0,3,25,44,19,33,6,8,12,1,91,60,1
12328,109394,Gbu6u21HudOCm7T5rLfdumNquubs5EJ1,SpATywNh6bZuzm8s1ceuBUnMUAeoAHHw,1,0,0,0,0,0,1,0,1,0.14285714285714285,1,0.0,0,0,0,0,0,0,0,1,0,0,1,1
12329,109402,r9Iw8qv5Gd0slmKCVr3aUz7TALROG0cf,A3fsA9Zfv1X2fVEQhTw51lKENdNrEqT3,11,4,3,0,3,1,7,1,19,2.7142857142857144,1,0.0,0,3,0,3,4,1,0,7,1,6,13,1
12330,109403,RJ2AN96oZxuBCR52LgUmQpj4g9Y4mcD4,bWdj2GDclj5ofokWjzoa5jAwMkxCykd6,16,20,12,16,3,1,6,0,58,8.285714285714286,2,0.0,2,12,16,3,18,1,0,6,0,33,25,0
12331,109417,7T8zBGfQI7GmUNFouD9u4M8LhrQmKX66,RXDvfPUBYFlVdlueBFbLW0mhhAyGEqpt,1,0,0,0,0,0,1,0,1,0.14285714285714285,1,0.0,0,0,0,0,0,0,0,1,0,0,1,1
12332,109420,SPTliKTsT7X2iG2wvNL5AHdQ10rMJVZH,SpATywNh6bZuzm8s1ceuBUnMUAeoAHHw,6,4,1,0,1,0,5,0,11,1.5714285714285714,2,0.0,0,1,0,1,4,0,0,5,0,2,9,1
12333,109439,On26vSCnXPxlOaC4mCdb6AzdACXRPBhk,G8EPVSXsOYB5YQWZGiz1aVq5Pgr2GrQu,5,2,1,0,1,0,2,0,6,0.8571428571428571,1,0.0,0,1,0,1,2,0,0,2,0,2,4,1
12334,109443,7M6n6JJz8OT4WvASBJlRAyi4sCwcAzru,A3fsA9Zfv1X2fVEQhTw51lKENdNrEqT3,8,5,4,0,4,0,1,0,14,2.0,1,0.0,0,4,0,4,5,0,0,1,0,8,6,1
12335,109445,bwOsVB833e5tHrwHSqmXCzs0EZClNPpv,A3fsA9Zfv1X2fVEQhTw51lKENdNrEqT3,1,0,0,0,0,0,1,0,1,0.14285714285714285,1,0.0,0,0,0,0,0,0,0,1,0,0,1,1
12336,109451,JbJKnENXbd4D9YGrXPdV81P48WObl8vL,SpATywNh6bZuzm8s1ceuBUnMUAeoAHHw,6,7,0,0,0,0,7,0,14,2.0,1,0.0,0,0,0,0,7,0,0,7,0,0,14,1
12337,109454,xvNZbY8RiapNT0qosUHeJFlEtqfPfVcr,SpATywNh6bZuzm8s1ceuBUnMUAeoAHHw,14,13,7,12,4,1,5,0,42,6.0,3,0.0,3,7,11,4,10,1,1,5,0,25,17,1
12338,109455,MCvvcTb9wFwriBgKb49jcCFeKRdTXM9j,A3fsA9Zfv1X2fVEQhTw51lKENdNrEqT3,5,2,1,0,1,0,4,0,8,1.1428571428571428,2,0.0,0,1,0,1,2,0,0,4,0,2,6,1
12339,109475,RNh4yH9mZXB6eTgcXXcHwrIgY95Sp0W7,A3fsA9Zfv1X2fVEQhTw51lKENdNrEqT3,7,6,1,0,1,0,1,0,9,1.2857142857142858,1,0.0,0,1,0,1,6,0,0,1,0,2,7,1
12340,109477,7Cs0Abzd0FS9IIdr1A12WVGDozLYcxYb,SpATywNh6bZuzm8s1ceuBUnMUAeoAHHw,1,0,0,0,0,0,1,0,1,0.14285714285714285,1,0.0,0,0,0,0,0,0,0,1,0,0,1,1
12341,109482,ZwZ9L46oJNtj9fhgH7VsyHRiEXY9tnmd,G8EPVSXsOYB5YQWZGiz1aVq5Pgr2GrQu,5,3,1,0,1,0,3,0,8,1.1428571428571428,1,0.0,0,1,0,1,3,0,0,3,0,2,6,1
12342,109484,pdp70UYWh5otKyx4vGTfJaBVRuSZsd0M,SpATywNh6bZuzm8s1ceuBUnMUAeoAHHw,6,2,1,0,1,2,5,0,11,1.5714285714285714,1,0.0,0,1,0,1,2,2,0,5,0,2,9,1
12343,109493,kajklFKczHkuBeWWHTIA518Xzi7jmX3b,A3fsA9Zfv1X2fVEQhTw51lKENdNrEqT3,11,9,1,0,1,6,8,2,27,3.857142857142857,2,0.0,0,1,0,1,9,6,0,8,2,2,25,1
12344,109503,IoDMPccLVuoP1kfQwv1qzxHOaDwHWJ1B,RXDvfPUBYFlVdlueBFbLW0mhhAyGEqpt,34,44,31,3,16,9,16,0,119,17.0,4,0.0,4,31,3,16,40,9,0,16,0,54,65,1
12345,109510,xHqnmrHdKLDxnJRARDHa2hpY45Zdt2kb,A3fsA9Zfv1X2fVEQhTw51lKENdNrEqT3,3,2,0,0,0,0,1,0,3,0.42857142857142855,1,0.0,0,0,0,0,2,0,0,1,0,0,3,1
12346,109514,KpYtE2oiCacGgvHDiOR9EPHvEG8K5VAH,bWdj2GDclj5ofokWjzoa5jAwMkxCykd6,6,4,2,0,0,0,4,0,10,1.4285714285714286,2,0.0,0,2,0,0,4,0,0,4,0,2,8,1
12347,109517,EEukb1HtBZxlb0jW8bNwwOHInCYodyW7,bWdj2GDclj5ofokWjzoa5jAwMkxCykd6,1,0,0,0,0,0,1,0,1,0.14285714285714285,1,0.0,0,0,0,0,0,0,0,1,0,0,1,1
12348,109523,qYbhiF3nJ95ttwkxqyX4iKZXAQTXvtdJ,G8EPVSXsOYB5YQWZGiz1aVq5Pgr2GrQu,1,0,0,0,0,0,1,0,1,0.14285714285714285,1,0.0,0,0,0,0,0,0,0,1,0,0,1,1
12349,109527,e0jCfTT6aDMNOYEB4iNXcTbrqQiVpXOZ,bWdj2GDclj5ofokWjzoa5jAwMkxCykd6,1,0,0,0,0,0,1,0,1,0.14285714285714285,1,0.0,0,0,0,0,0,0,0,1,0,0,1,1
12350,109533,7Cs0Abzd0FS9IIdr1A12WVGDozLYcxYb,bWdj2GDclj5ofokWjzoa5jAwMkxCykd6,2,0,0,0,0,0,2,0,2,0.2857142857142857,1,0.0,0,0,0,0,0,0,0,2,0,0,2,1
12351,109537,F5SjzrcjsAWqSZbt6NDh8MAkDqWpXhkX,SpATywNh6bZuzm8s1ceuBUnMUAeoAHHw,25,38,16,24,9,1,5,0,93,13.285714285714286,2,0.0,19,16,22,9,19,1,2,5,0,66,27,1
12352,109547,R2rZMVSlSMqKi5RYuPtRmvScbhOABzyG,SpATywNh6bZuzm8s1ceuBUnMUAeoAHHw,8,5,0,0,1,0,3,0,9,1.2857142857142858,1,0.0,0,0,0,1,5,0,0,3,0,1,8,1
12353,109548,sXsJQIq7yfhUcvdfsv1TB75YziTHrdKC,SpATywNh6bZuzm8s1ceuBUnMUAeoAHHw,1,0,0,0,0,0,1,0,1,0.14285714285714285,1,0.0,0,0,0,0,0,0,0,1,0,0,1,1
12354,109549,rHrqDHLlL0apyY3RByvtRvQofhL6Brvn,A3fsA9Zfv1X2fVEQhTw51lKENdNrEqT3,8,8,0,0,0,4,5,0,17,2.4285714285714284,1,0.0,0,0,0,0,8,4,0,5,0,0,17,1
12355,109555,Cv1aavObJnuABKfipF6OGePzg0BnGPFs,G8EPVSXsOYB5YQWZGiz1aVq5Pgr2GrQu,64,11,10,264,0,0,19,0,304,43.42857142857143,6,0.0,1,10,226,0,10,0,38,19,0,237,67,1
12356,109569,XTOZBwO5vG1hcHef4AbuiTP7iSg27hS9,A3fsA9Zfv1X2fVEQhTw51lKENdNrEqT3,37,24,2,68,1,0,10,0,105,15.0,2,0.0,2,2,59,1,22,0,9,10,0,64,41,1
12357,109570,ZGw6EJB3cHSkZVviqnd0VnyCd0Hz7wva,SpATywNh6bZuzm8s1ceuBUnMUAeoAHHw,15,12,6,12,2,2,4,1,39,5.571428571428571,1,0.0,4,6,12,2,8,2,0,4,1,24,15,1
12358,109578,QYVRHTpooyTkzSbIywJ7ri5o4t73Xwty,G8EPVSXsOYB5YQWZGiz1aVq5Pgr2GrQu,1,0,0,0,0,0,1,0,1,0.14285714285714285,1,0.0,0,0,0,0,0,0,0,1,0,0,1,1
12359,109585,MF5edVvM6lCZDxnMdHelos9TUh3KERjn,bWdj2GDclj5ofokWjzoa5jAwMkxCykd6,4,2,1,0,1,0,1,0,5,0.7142857142857143,1,0.0,0,1,0,1,2,0,0,1,0,2,3,0
12360,109590,fsmpK8LD6WXenVxwQRsdTaVF7iZvaL2a,RXDvfPUBYFlVdlueBFbLW0mhhAyGEqpt,5,2,1,0,1,0,2,0,6,0.8571428571428571,1,0.0,0,1,0,1,2,0,0,2,0,2,4,0
12361,109591,Lo69R5WSRDc62Oqnj9VlNFkaC1RUwhyo,G8EPVSXsOYB5YQWZGiz1aVq5Pgr2GrQu,8,6,2,0,2,0,3,1,14,2.0,1,0.0,3,2,0,2,3,0,0,3,1,7,7,1
12362,109601,800D5qwHCt3Ko9pzEVC49paGCt6dYzm8,A3fsA9Zfv1X2fVEQhTw51lKENdNrEqT3,5,4,2,0,1,0,3,0,10,1.4285714285714286,1,0.0,0,2,0,1,4,0,0,3,0,3,7,1
12363,109607,6YbtihuLKjD5ARAIowoJ3OQ962AhWkN5,A3fsA9Zfv1X2fVEQhTw51lKENdNrEqT3,5,3,1,0,1,0,2,0,7,1.0,1,0.0,0,1,0,1,3,0,0,2,0,2,5,1
12364,109614,cu1UzrL4copIEW9h08HrvzOBVJhdKzoe,SpATywNh6bZuzm8s1ceuBUnMUAeoAHHw,7,2,1,0,1,0,7,2,13,1.8571428571428572,1,0.0,0,1,0,1,2,0,0,7,2,2,11,1
12365,109621,dpYSVisiS2cUJnMBorcbHAtUmvFhsmWA,bWdj2GDclj5ofokWjzoa5jAwMkxCykd6,7,1,1,0,1,0,7,0,10,1.4285714285714286,1,0.0,0,1,0,1,1,0,0,7,0,2,8,1
12366,109631,ol7Qu6IbbqCzG4dmk5UYJtqKBH41uMvQ,SpATywNh6bZuzm8s1ceuBUnMUAeoAHHw,10,7,5,5,4,0,2,0,23,3.2857142857142856,1,0.0,1,5,4,4,6,0,1,2,0,14,9,1
12367,109642,JsgxGxJYDhwgnBgYbCILUrGTg0zFV4WJ,SpATywNh6bZuzm8s1ceuBUnMUAeoAHHw,12,9,8,6,4,0,2,0,29,4.142857142857143,1,0.0,0,8,5,4,9,0,1,2,0,17,12,1
12368,109647,jHKRHkwov2ldu5B5B6LxfeJx9Okiy1xa,G8EPVSXsOYB5YQWZGiz1aVq5Pgr2GrQu,10,14,5,0,5,0,6,1,31,4.428571428571429,1,0.0,7,5,0,5,7,0,0,6,1,17,14,1
12369,109651,9JqGpnHdkbKBOmcT3LmREcuqxduizBra,SpATywNh6bZuzm8s1ceuBUnMUAeoAHHw,17,36,18,21,5,43,18,2,143,20.428571428571427,4,0.0,8,18,18,5,28,43,3,18,2,49,94,1
12370,109655,rfK1l9cGasJW2YfHTqaTiWeJHGoMfxaD,G8EPVSXsOYB5YQWZGiz1aVq5Pgr2GrQu,9,8,1,0,1,0,3,0,13,1.8571428571428572,1,0.0,2,1,0,1,6,0,0,3,0,4,9,1
12371,109664,SzAtQzNOap38B7fNAidQGz1HfRyu6YSS,A3fsA9Zfv1X2fVEQhTw51lKENdNrEqT3,41,24,15,68,10,0,17,0,134,19.142857142857142,2,0.0,6,15,56,10,18,0,12,17,0,87,47,1
12372,109678,PxrASHNEh6iqdpy6HawW3zGbUAupdzGr,G8EPVSXsOYB5YQWZGiz1aVq5Pgr2GrQu,6,1,1,0,1,0,5,0,8,1.1428571428571428,1,0.0,0,1,0,1,1,0,0,5,0,2,6,1
12373,109679,Dpj1ute7yeokptEET2ZfYuubDiXNwLXm,bWdj2GDclj5ofokWjzoa5jAwMkxCykd6,7,11,7,0,3,0,3,0,24,3.4285714285714284,2,0.0,0,7,0,3,11,0,0,3,0,10,14,1
12374,109680,yesikXRZpFYEGoXWRi2rEHboJsFyCCGG,A3fsA9Zfv1X2fVEQhTw51lKENdNrEqT3,4,2,1,0,1,0,1,0,5,0.7142857142857143,1,0.0,0,1,0,1,2,0,0,1,0,2,3,1
12375,109682,HYMxLb0qNi7DvNLdn0aBxzsZewAG7tgU,SpATywNh6bZuzm8s1ceuBUnMUAeoAHHw,6,3,1,0,1,0,2,0,7,1.0,2,0.0,0,1,0,1,3,0,0,2,0,2,5,1
12376,109695,3o4QanEzrLxU7IR8E0SkDLt6uwLmz5BV,SpATywNh6bZuzm8s1ceuBUnMUAeoAHHw,1,0,0,0,0,0,1,0,1,0.14285714285714285,1,0.0,0,0,0,0,0,0,0,1,0,0,1,1
12377,109702,eO5PxtKBgjWgF4Rm51wpAuHgGsQTJyoc,G8EPVSXsOYB5YQWZGiz1aVq5Pgr2GrQu,9,4,3,0,3,0,2,0,12,1.7142857142857142,1,0.0,0,3,0,3,4,0,0,2,0,6,6,1
12378,109705,HMYpimZGFgj5IczDutkfjUfnxl45PoHW,A3fsA9Zfv1X2fVEQhTw51lKENdNrEqT3,46,36,22,50,11,47,20,0,186,26.571428571428573,6,0.0,4,22,47,11,32,47,3,20,0,84,102,1
12379,109708,nPYAQvL2RWwzE56jCZxlu4AvBduWOQxo,SpATywNh6bZuzm8s1ceuBUnMUAeoAHHw,4,2,1,0,1,0,2,0,6,0.8571428571428571,1,0.0,0,1,0,1,2,0,0,2,0,2,4,1
12380,109716,9257hE3j2ibuyvUsd5ug9QNBvZR626xP,SpATywNh6bZuzm8s1ceuBUnMUAeoAHHw,19,38,15,18,9,0,6,0,86,12.285714285714286,4,0.0,11,15,15,9,27,0,3,6,0,50,36,1
12381,109718,LauvBEW2SjRiQSbmKACjhjUjr7ycSUes,SpATywNh6bZuzm8s1ceuBUnMUAeoAHHw,13,14,4,12,3,0,2,1,36,5.142857142857143,1,0.0,9,4,12,3,5,0,0,2,1,28,8,1
12382,109731,sXWQCMJ5uWT53YScVl07HilRx1j9KLZ2,SpATywNh6bZuzm8s1ceuBUnMUAeoAHHw,1,0,0,0,0,0,1,0,1,0.14285714285714285,1,0.0,0,0,0,0,0,0,0,1,0,0,1,1
12383,109746,GLXgEITEGSlq2OnY03wIuxcorHQRX3zY,A3fsA9Zfv1X2fVEQhTw51lKENdNrEqT3,10,7,5,0,3,1,5,0,21,3.0,1,0.0,0,5,0,3,7,1,0,5,0,8,13,0
12384,109757,NCq7uMk20xis3HUzEQcWP2K284TvGGUT,G8EPVSXsOYB5YQWZGiz1aVq5Pgr2GrQu,10,5,4,0,3,3,3,0,18,2.5714285714285716,1,0.0,0,4,0,3,5,3,0,3,0,7,11,0
12385,109782,OZaq72DmJH6bReA6lKvO4XbWYjmwsu42,A3fsA9Zfv1X2fVEQhTw51lKENdNrEqT3,1,0,0,0,0,0,1,0,1,0.14285714285714285,1,0.0,0,0,0,0,0,0,0,1,0,0,1,1
12386,109783,TGbtpXBmCBBlZeS2P72XRQZjesW8qA9X,SpATywNh6bZuzm8s1ceuBUnMUAeoAHHw,2,0,0,0,0,0,2,0,2,0.2857142857142857,1,0.0,0,0,0,0,0,0,0,2,0,0,2,1
12387,109784,qp7BLvS8nhXNAuvU9LsQhZWo9nk3BTFw,bWdj2GDclj5ofokWjzoa5jAwMkxCykd6,1,0,0,0,0,0,1,0,1,0.14285714285714285,1,0.0,0,0,0,0,0,0,0,1,0,0,1,1
12388,109785,qp7BLvS8nhXNAuvU9LsQhZWo9nk3BTFw,RXDvfPUBYFlVdlueBFbLW0mhhAyGEqpt,1,0,0,0,0,0,1,0,1,0.14285714285714285,1,0.0,0,0,0,0,0,0,0,1,0,0,1,1
12389,109786,jRi5kMZL8gw9VtNxiN9NAzyTyPmFUqYw,A3fsA9Zfv1X2fVEQhTw51lKENdNrEqT3,9,8,1,0,1,0,11,2,23,3.2857142857142856,1,0.0,0,1,0,1,8,0,0,11,2,2,21,1
12390,109800,PenDUeO0eoR8hyLVdfPN6H7q2FnTGMus,bWdj2GDclj5ofokWjzoa5jAwMkxCykd6,1,0,0,0,0,0,1,0,1,0.14285714285714285,1,0.0,0,0,0,0,0,0,0,1,0,0,1,1
12391,109811,4FKdcJP7BDwtMG7CY9eliEHXAfUQYGv7,RXDvfPUBYFlVdlueBFbLW0mhhAyGEqpt,9,12,6,0,3,0,1,0,22,3.142857142857143,1,0.0,0,6,0,3,12,0,0,1,0,9,13,1
12392,109816,NxKBgCf6L0n0EeCKRoJkVqGpdQ3sLVu2,SpATywNh6bZuzm8s1ceuBUnMUAeoAHHw,6,3,2,0,2,0,1,0,8,1.1428571428571428,1,0.0,0,2,0,2,3,0,0,1,0,4,4,1
12393,109821,OEuLxcw6vw5UY038iWtYfZUlieO9mgsq,RXDvfPUBYFlVdlueBFbLW0mhhAyGEqpt,72,81,52,144,23,3,7,0,310,44.285714285714285,4,0.0,17,52,132,23,64,3,12,7,0,224,86,1
12394,109835,QQrQFuArLkquFtXrvX0HKAU3caPT1bEW,SpATywNh6bZuzm8s1ceuBUnMUAeoAHHw,1,0,0,0,0,0,1,0,1,0.14285714285714285,1,0.0,0,0,0,0,0,0,0,1,0,0,1,1
12395,109840,fW2uAkcB4Zo13Su23SC3AqxKoKQQCv9V,bWdj2GDclj5ofokWjzoa5jAwMkxCykd6,14,11,4,28,5,0,2,0,50,7.142857142857143,2,0.0,4,4,27,5,7,0,1,2,0,40,10,1
12396,109841,008XUUt5rc6hUrg7SHj9oW0rG0FE0dkF,A3fsA9Zfv1X2fVEQhTw51lKENdNrEqT3,91,49,38,248,0,1,9,2,347,49.57142857142857,5,0.0,7,38,205,0,42,1,43,9,2,250,97,0
12397,109856,PVIjAE0m0OeJAYOHc5gIjzktRijtXdS4,SpATywNh6bZuzm8s1ceuBUnMUAeoAHHw,6,3,2,0,2,0,1,0,8,1.1428571428571428,2,0.0,0,2,0,2,3,0,0,1,0,4,4,0
12398,109858,45qf8dslh2FbT82HZJkVQ8o4xBP1tetJ,SpATywNh6bZuzm8s1ceuBUnMUAeoAHHw,5,4,1,0,1,0,2,0,8,1.1428571428571428,2,0.0,0,1,0,1,4,0,0,2,0,2,6,1
12399,109865,WRiHtWJX61VUGyAGQFSHJ3czdrgqxeQW,A3fsA9Zfv1X2fVEQhTw51lKENdNrEqT3,3,0,0,0,0,2,2,0,4,0.5714285714285714,1,0.0,0,0,0,0,0,2,0,2,0,0,4,1
12400,109876,J9b5OTfKjKw0x7GgqhJQnViZ6aYw88y1,bWdj2GDclj5ofokWjzoa5jAwMkxCykd6,4,2,0,0,0,0,3,0,5,0.7142857142857143,1,0.0,0,0,0,0,2,0,0,3,0,0,5,1
12401,109884,TiyssQ1xBxRpSE8M84hoblpjLNawoMPM,bWdj2GDclj5ofokWjzoa5jAwMkxCykd6,1,0,0,0,0,0,2,0,2,0.2857142857142857,2,0.0,0,0,0,0,0,0,0,2,0,0,2,1
12402,109888,onkD63zW36qWueM4FnIhDEFep4J6xaTB,SpATywNh6bZuzm8s1ceuBUnMUAeoAHHw,10,9,6,0,6,1,8,1,31,4.428571428571429,3,0.0,0,6,0,6,9,1,0,8,1,12,19,1
12403,109898,26GEnf61bFs7ZWD0apKuRzsFCe2K0kZz,SpATywNh6bZuzm8s1ceuBUnMUAeoAHHw,7,2,0,0,0,14,6,1,23,3.2857142857142856,1,0.0,0,0,0,0,2,14,0,6,1,0,23,1
12404,109903,m4zdr76CpU472F6wsJffFbslI27LpI4g,A3fsA9Zfv1X2fVEQhTw51lKENdNrEqT3,4,2,1,0,1,0,1,0,5,0.7142857142857143,1,0.0,0,1,0,1,2,0,0,1,0,2,3,1
12405,109911,AVOR5ugt0lZQkprV146IIDmyiCL0xSOy,SpATywNh6bZuzm8s1ceuBUnMUAeoAHHw,6,3,1,0,1,0,2,0,7,1.0,1,0.0,0,1,0,1,3,0,0,2,0,2,5,1
12406,109935,CViRSkXaB71kW0MpqfES8A240EKnhiKp,SpATywNh6bZuzm8s1ceuBUnMUAeoAHHw,9,13,10,0,6,0,5,0,34,4.857142857142857,3,0.0,0,10,0,6,13,0,0,5,0,16,18,1
12407,109938,jhSBNR9EEysD5KhTnnFndvZuefk9V3rI,SpATywNh6bZuzm8s1ceuBUnMUAeoAHHw,26,25,17,23,5,2,14,1,87,12.428571428571429,4,0.0,6,17,20,5,19,2,3,14,1,48,39,0
12408,109950,m46ZDnHY4MCOwsZObE6icbOdSDL76NDY,A3fsA9Zfv1X2fVEQhTw51lKENdNrEqT3,1,0,0,0,0,0,1,0,1,0.14285714285714285,1,0.0,0,0,0,0,0,0,0,1,0,0,1,1
12409,109952,7vgfRfYiZZ2eDFnPmEicllnUmROBENw7,SpATywNh6bZuzm8s1ceuBUnMUAeoAHHw,1,0,0,0,0,0,1,0,1,0.14285714285714285,1,0.0,0,0,0,0,0,0,0,1,0,0,1,1
12410,109957,69mjZoNGtUdd47OHaI2iQubsVwSBE5CT,bWdj2GDclj5ofokWjzoa5jAwMkxCykd6,4,3,1,0,1,0,2,0,7,1.0,1,0.0,0,1,0,1,3,0,0,2,0,2,5,1
12411,109960,dq3iqibSI5OSwCbWRZv7tfgbiuLwOgjh,A3fsA9Zfv1X2fVEQhTw51lKENdNrEqT3,10,7,5,0,4,0,1,0,17,2.4285714285714284,1,0.0,0,5,0,4,7,0,0,1,0,9,8,1
12412,109967,gcway7yukVhkU23YjxQt8J89R78muKel,A3fsA9Zfv1X2fVEQhTw51lKENdNrEqT3,1,0,0,0,0,0,2,0,2,0.2857142857142857,1,0.0,0,0,0,0,0,0,0,2,0,0,2,1
12413,109984,9vKJ7o9c510Kb9hLaAaKExOfBIo69t2w,bWdj2GDclj5ofokWjzoa5jAwMkxCykd6,4,3,1,0,1,0,1,0,6,0.8571428571428571,1,0.0,0,1,0,1,3,0,0,1,0,2,4,1
12414,109993,ma5SB0XT5eSIELPtdH2s2g8qesUddnBJ,SpATywNh6bZuzm8s1ceuBUnMUAeoAHHw,4,2,0,0,0,0,3,0,5,0.7142857142857143,1,0.0,0,0,0,0,2,0,0,3,0,0,5,1
12415,109994,V9A9B2T9pRTU3AqvpqzuKs4MfRcAEte2,bWdj2GDclj5ofokWjzoa5jAwMkxCykd6,7,3,2,0,2,0,3,0,10,1.4285714285714286,2,0.0,0,2,0,2,3,0,0,3,0,4,6,1
12416,109995,9vKJ7o9c510Kb9hLaAaKExOfBIo69t2w,SpATywNh6bZuzm8s1ceuBUnMUAeoAHHw,6,7,3,0,2,0,1,0,13,1.8571428571428572,1,0.0,0,3,0,2,7,0,0,1,0,5,8,1
12417,109996,OZ02Yntpt8Hg8thsFgejT4NSsPYtVPPm,A3fsA9Zfv1X2fVEQhTw51lKENdNrEqT3,4,3,2,0,2,0,1,0,8,1.1428571428571428,1,0.0,0,2,0,2,3,0,0,1,0,4,4,0
12418,109999,rYSxun4NgQnH8EYwHicH82Z91cblITe8,A3fsA9Zfv1X2fVEQhTw51lKENdNrEqT3,8,2,1,0,1,1,10,1,16,2.2857142857142856,1,0.0,0,1,0,1,2,1,0,10,1,2,14,1
12419,110000,A49hnVx3rwiVqM2hX3Oana4wZTCICiZX,SpATywNh6bZuzm8s1ceuBUnMUAeoAHHw,4,2,1,0,1,0,1,0,5,0.7142857142857143,1,0.0,0,1,0,1,2,0,0,1,0,2,3,0
12420,110005,CD2QgLWd9xNuEgr45XWnWQUVbnjf79M7,A3fsA9Zfv1X2fVEQhTw51lKENdNrEqT3,14,7,6,0,5,0,3,0,21,3.0,2,0.0,0,6,0,5,7,0,0,3,0,11,10,1
12421,110009,9803qM4isShkjkoVAPID7DQVAjFPwCDe,bWdj2GDclj5ofokWjzoa5jAwMkxCykd6,2,0,0,0,0,0,3,0,3,0.42857142857142855,1,0.0,0,0,0,0,0,0,0,3,0,0,3,1
12422,110013,OvIrFDXnTf7lPGXHN37tKh2m9dXSHGJK,A3fsA9Zfv1X2fVEQhTw51lKENdNrEqT3,1,0,0,0,0,0,2,0,2,0.2857142857142857,2,0.0,0,0,0,0,0,0,0,2,0,0,2,1
12423,110021,hkMQnmp0vvHTyvieOAhjYCGC9vi3Sftr,SpATywNh6bZuzm8s1ceuBUnMUAeoAHHw,10,5,3,0,2,5,5,0,20,2.857142857142857,1,0.0,0,3,0,2,5,5,0,5,0,5,15,1
12424,110025,VLJj9ywKL5TKEmvLWZO7iNyx7gDmV9Dg,SpATywNh6bZuzm8s1ceuBUnMUAeoAHHw,1,0,0,0,0,0,1,0,1,0.14285714285714285,1,0.0,0,0,0,0,0,0,0,1,0,0,1,1
12425,110030,2gXHY5qLgY96Nt3kImmboPawcy43EQXt,A3fsA9Zfv1X2fVEQhTw51lKENdNrEqT3,5,6,2,0,2,0,3,0,13,1.8571428571428572,1,0.0,0,2,0,2,6,0,0,3,0,4,9,1
12426,110033,sVIvm416vjfeqMOGnXZuyI7BvpOH8r6a,A3fsA9Zfv1X2fVEQhTw51lKENdNrEqT3,8,2,1,0,1,4,6,1,15,2.142857142857143,1,0.0,0,1,0,1,2,4,0,6,1,2,13,1
12427,110036,pKc7l3x3OfAQ9k2wvNUoHVHE65xXVFbV,G8EPVSXsOYB5YQWZGiz1aVq5Pgr2GrQu,9,5,3,0,2,1,4,0,15,2.142857142857143,1,0.0,0,3,0,2,5,1,0,4,0,5,10,1
12428,110047,mutkCKvqzTd4FkjKQRYUWL51H59AdIct,SpATywNh6bZuzm8s1ceuBUnMUAeoAHHw,10,10,7,0,6,0,4,0,27,3.857142857142857,1,0.0,0,7,0,6,10,0,0,4,0,13,14,0
12429,110051,UCDPR1k7RkPBDIde3KiukiosB55WbRVo,bWdj2GDclj5ofokWjzoa5jAwMkxCykd6,1,0,0,0,0,0,1,0,1,0.14285714285714285,1,0.0,0,0,0,0,0,0,0,1,0,0,1,1
12430,110053,gaD5Av49rKMTRISUDiGUl6H5FYk7vPMw,G8EPVSXsOYB5YQWZGiz1aVq5Pgr2GrQu,66,59,11,174,12,2,4,1,263,37.57142857142857,2,0.0,37,11,137,12,22,2,37,4,1,197,66,0
12431,110060,HAmydfc2dHhpF7W3j97KPwhZZY0mGz44,bWdj2GDclj5ofokWjzoa5jAwMkxCykd6,6,1,0,0,0,0,8,1,10,1.4285714285714286,2,0.0,0,0,0,0,1,0,0,8,1,0,10,1
12432,110087,TtTC2azhA3pvSmtwPTzGbUN9oyOeRHBv,3VkHkmOtom3jM2wCu94xgzzu1d6Dn7or,63,109,32,63,35,0,5,0,244,34.857142857142854,3,0.0,58,32,60,35,51,0,3,5,0,185,59,0
12433,110094,i91AbpcoiVsM4MtiPDZxirvyVmbhFUip,3VkHkmOtom3jM2wCu94xgzzu1d6Dn7or,6,10,5,0,0,0,6,4,25,3.5714285714285716,2,0.0,0,5,0,0,10,0,0,6,4,5,20,1
12434,110106,8irCUZa4UAKsYYFeHrY9ttb5xgcL2ou7,3VkHkmOtom3jM2wCu94xgzzu1d6Dn7or,11,8,4,0,2,24,12,1,51,7.285714285714286,3,0.0,0,4,0,2,8,24,0,12,1,6,45,0
12435,110127,gh3vlMxFzpJyPcJAc3Sa35bec7vhjiGs,3VkHkmOtom3jM2wCu94xgzzu1d6Dn7or,7,3,2,0,2,0,2,0,9,1.2857142857142858,1,0.0,0,2,0,2,3,0,0,2,0,4,5,1
12436,110153,fS72R3kjN9mNNeiYurwm3Uc8w1dF6aYm,3VkHkmOtom3jM2wCu94xgzzu1d6Dn7or,94,399,126,126,118,145,58,22,994,142.0,22,0.0,225,126,110,118,174,145,16,58,22,579,415,0
12437,110164,EAJX7pYPeyFbc8fdFlq04tVzULACuDzH,3VkHkmOtom3jM2wCu94xgzzu1d6Dn7or,4,2,0,0,0,0,3,0,5,0.7142857142857143,1,0.0,0,0,0,0,2,0,0,3,0,0,5,1
12438,110170,rCXamJ7s0E4WpVnjTj9Ny0mFon0s0b2s,3VkHkmOtom3jM2wCu94xgzzu1d6Dn7or,8,5,3,0,1,2,6,0,17,2.4285714285714284,3,0.0,0,3,0,1,5,2,0,6,0,4,13,0
12439,110177,nknXXbQsC6Q6nMDyRKc0MDJZg6KtAXBE,3VkHkmOtom3jM2wCu94xgzzu1d6Dn7or,11,29,13,4,6,6,12,0,70,10.0,7,0.0,5,13,4,6,24,6,0,12,0,28,42,0
12440,110182,87013PkHpAB228usvI4HKmNxb2mybs5V,3VkHkmOtom3jM2wCu94xgzzu1d6Dn7or,1,0,0,0,0,0,1,0,1,0.14285714285714285,1,0.0,0,0,0,0,0,0,0,1,0,0,1,1
12441,110183,j2Dd0a1l5Qc6RnwSvUw0PSeLYT8b80Nj,3VkHkmOtom3jM2wCu94xgzzu1d6Dn7or,16,23,11,5,10,4,11,0,64,9.142857142857142,3,0.0,8,11,5,10,15,4,0,11,0,34,30,1
12442,110186,jXgMhQKbkiBaFyvNHAIM6AePvnnTFQC0,3VkHkmOtom3jM2wCu94xgzzu1d6Dn7or,14,18,6,24,0,4,3,0,55,7.857142857142857,2,0.0,9,6,23,0,9,4,1,3,0,38,17,1
12443,110189,3iudZystfLNtMUEeNqgADL7gR2YGFlHu,3VkHkmOtom3jM2wCu94xgzzu1d6Dn7or,9,4,3,0,3,0,2,0,12,1.7142857142857142,1,0.0,0,3,0,3,4,0,0,2,0,6,6,1
12444,110191,NO5Xz3DMvF701kgf1hI1ZFFxKMoGSe3T,3VkHkmOtom3jM2wCu94xgzzu1d6Dn7or,1,0,0,0,0,0,1,0,1,0.14285714285714285,1,0.0,0,0,0,0,0,0,0,1,0,0,1,1
12445,110212,yndM0Mmqe4G3WSqDVZ6guxAylWUqTPem,3VkHkmOtom3jM2wCu94xgzzu1d6Dn7or,5,2,1,0,1,0,4,0,8,1.1428571428571428,1,0.0,0,1,0,1,2,0,0,4,0,2,6,1
12446,110222,7ApqvegwR9RncmqiQgmeqYRNwf1naN8H,3VkHkmOtom3jM2wCu94xgzzu1d6Dn7or,1,0,0,0,0,0,1,0,1,0.14285714285714285,1,0.0,0,0,0,0,0,0,0,1,0,0,1,1
12447,110233,ZHxd8TqgIF8DZVKwp0YEIHIiKj4TlTuC,3VkHkmOtom3jM2wCu94xgzzu1d6Dn7or,1,0,0,0,0,0,1,0,1,0.14285714285714285,1,0.0,0,0,0,0,0,0,0,1,0,0,1,1
12448,110297,mSG93IKana8XXZAVtRRCymW2SAgrQS50,3VkHkmOtom3jM2wCu94xgzzu1d6Dn7or,8,6,4,0,4,0,3,0,17,2.4285714285714284,1,0.0,1,4,0,4,5,0,0,3,0,9,8,1
12449,110308,jzTr3LDW83ve5VioJqiTtg9mV6Kn1Sr1,3VkHkmOtom3jM2wCu94xgzzu1d6Dn7or,1,0,0,0,0,0,1,0,1,0.14285714285714285,1,0.0,0,0,0,0,0,0,0,1,0,0,1,1
12450,110312,KkrlMxBokvNpPT9nTD0DxZg6K1J6u4Xr,3VkHkmOtom3jM2wCu94xgzzu1d6Dn7or,1,0,0,0,0,0,1,0,1,0.14285714285714285,1,0.0,0,0,0,0,0,0,0,1,0,0,1,1
12451,110357,MnnYhwyXyzJDgxLaCtkeYz6Haw4CP7sm,3VkHkmOtom3jM2wCu94xgzzu1d6Dn7or,1,0,0,0,0,0,1,0,1,0.14285714285714285,1,0.0,0,0,0,0,0,0,0,1,0,0,1,1
12452,110374,ny721gkgjta5ETYwIQs20w4lCGP0gJwi,3VkHkmOtom3jM2wCu94xgzzu1d6Dn7or,91,353,86,136,95,9,42,1,722,103.14285714285714,4,0.0,170,86,115,95,183,9,21,42,1,466,256,0
12453,110451,CfjKRvCO2vIEYos7lXAFumqsUeYwfePU,3VkHkmOtom3jM2wCu94xgzzu1d6Dn7or,6,2,1,0,1,0,3,0,7,1.0,1,0.0,0,1,0,1,2,0,0,3,0,2,5,1
12454,110577,RvRsXzYULX8CJPXHa5mzL8AcNhscf6wx,3VkHkmOtom3jM2wCu94xgzzu1d6Dn7or,1,0,0,0,0,0,1,0,1,0.14285714285714285,1,0.0,0,0,0,0,0,0,0,1,0,0,1,1
12455,110688,UDlD3p3eo49Q67jkzPz6srqLTM4nCHO8,3VkHkmOtom3jM2wCu94xgzzu1d6Dn7or,2,0,0,0,0,0,2,0,2,0.2857142857142857,1,0.0,0,0,0,0,0,0,0,2,0,0,2,1
12456,110732,MS6IJrovPGBEFYNmUPmeOu0OFDeQqmIx,3VkHkmOtom3jM2wCu94xgzzu1d6Dn7or,1,0,0,0,0,0,1,0,1,0.14285714285714285,1,0.0,0,0,0,0,0,0,0,1,0,0,1,1
12457,110764,HpI5z92WE9TCj3JyfZi0b0yrE9hT84vs,3VkHkmOtom3jM2wCu94xgzzu1d6Dn7or,1,0,0,0,0,0,1,0,1,0.14285714285714285,1,0.0,0,0,0,0,0,0,0,1,0,0,1,1
12458,110785,p311UtUGdUwKmrYHr6K0TG3N9HNIvLDN,3VkHkmOtom3jM2wCu94xgzzu1d6Dn7or,8,7,3,0,2,1,8,0,21,3.0,1,0.0,2,3,0,2,5,1,0,8,0,7,14,1
12459,110829,K0vM4v4lprgkLZgn2YxyCFRJlTM0pFAf,3VkHkmOtom3jM2wCu94xgzzu1d6Dn7or,36,179,46,75,56,42,36,1,435,62.142857142857146,4,0.0,94,46,67,56,85,42,8,36,1,263,172,1
12460,110833,oNX40hvUpCseO8BHKhGJvG2jyQpYKQyk,3VkHkmOtom3jM2wCu94xgzzu1d6Dn7or,1,0,0,0,0,0,1,0,1,0.14285714285714285,1,0.0,0,0,0,0,0,0,0,1,0,0,1,1
12461,110850,6Zw4h1RRXwE1llYOOpSM6nCIHCFPDAX1,3VkHkmOtom3jM2wCu94xgzzu1d6Dn7or,7,5,1,0,1,0,3,0,10,1.4285714285714286,2,0.0,0,1,0,1,5,0,0,3,0,2,8,1
12462,110857,ooEcaiUSlo9CwytpW2T4Oa02YM5UfDcJ,3VkHkmOtom3jM2wCu94xgzzu1d6Dn7or,5,5,3,0,3,0,4,0,15,2.142857142857143,1,0.0,1,3,0,3,4,0,0,4,0,7,8,1
12463,110867,0MqgKoCiBbkOQlILQCSEvVTi8AlhfpfE,3VkHkmOtom3jM2wCu94xgzzu1d6Dn7or,7,3,2,0,1,0,6,0,12,1.7142857142857142,1,0.0,0,2,0,1,3,0,0,6,0,3,9,1
12464,110908,CSldcDH2UXCgzrli1TZwzU7O1XRP6tGR,3VkHkmOtom3jM2wCu94xgzzu1d6Dn7or,4,2,1,0,0,1,2,0,6,0.8571428571428571,1,0.0,0,1,0,0,2,1,0,2,0,1,5,1
12465,110934,gIW1VFFezcONvq2yyTBvVdlT7wXT7HJ0,3VkHkmOtom3jM2wCu94xgzzu1d6Dn7or,1,0,0,0,0,0,1,0,1,0.14285714285714285,1,0.0,0,0,0,0,0,0,0,1,0,0,1,1
12466,110936,6X1wr7GynBQqED8UEDADYfUmXyvxRJTQ,3VkHkmOtom3jM2wCu94xgzzu1d6Dn7or,1,0,0,0,0,0,1,0,1,0.14285714285714285,1,0.0,0,0,0,0,0,0,0,1,0,0,1,1
12467,110997,qZpXWzENd8vPQkANcwupj0acfmacGtsr,3VkHkmOtom3jM2wCu94xgzzu1d6Dn7or,51,26,24,0,25,0,5,0,80,11.428571428571429,1,0.0,0,24,0,25,26,0,0,5,0,49,31,1
12468,111015,arQfCxGonf2cwpjIHxEHKla7HzsDvv25,3VkHkmOtom3jM2wCu94xgzzu1d6Dn7or,1,0,0,0,0,0,1,0,1,0.14285714285714285,1,0.0,0,0,0,0,0,0,0,1,0,0,1,1
12469,111027,rKSBST0Te8Oj86YG9ATJ5n1WsqaVPnYt,3VkHkmOtom3jM2wCu94xgzzu1d6Dn7or,5,2,1,0,1,1,3,0,8,1.1428571428571428,1,0.0,0,1,0,1,2,1,0,3,0,2,6,1
12470,111047,Hsv3SikfSXfiHrnpDP7hs57vBAqVCyW3,3VkHkmOtom3jM2wCu94xgzzu1d6Dn7or,4,2,0,0,0,0,2,0,4,0.5714285714285714,2,0.0,0,0,0,0,2,0,0,2,0,0,4,1
12471,111188,lcOmZtA6Krg5rjWp07W9qAhHzmFjlBmq,3VkHkmOtom3jM2wCu94xgzzu1d6Dn7or,12,14,9,0,4,1,16,0,44,6.285714285714286,2,0.0,0,9,0,4,14,1,0,16,0,13,31,1
12472,111193,ukRefRmBYESKCfUvaHv3IYNgmPPZ33YH,3VkHkmOtom3jM2wCu94xgzzu1d6Dn7or,1,0,0,0,0,0,1,0,1,0.14285714285714285,1,0.0,0,0,0,0,0,0,0,1,0,0,1,1
12473,111332,9nWy1GKxqfTrAeUVolqqnda385xr9lRU,3VkHkmOtom3jM2wCu94xgzzu1d6Dn7or,2,0,0,0,0,0,2,0,2,0.2857142857142857,1,0.0,0,0,0,0,0,0,0,2,0,0,2,1
12474,111334,tsquOdRQXp66gnS29xQRjOmY9wUH5RXe,3VkHkmOtom3jM2wCu94xgzzu1d6Dn7or,1,0,0,0,0,0,1,0,1,0.14285714285714285,1,0.0,0,0,0,0,0,0,0,1,0,0,1,1
12475,111352,lmlSe7ne5kLVEzM7wObkzo8bsMDoN8xr,3VkHkmOtom3jM2wCu94xgzzu1d6Dn7or,1,0,0,0,0,0,1,0,1,0.14285714285714285,1,0.0,0,0,0,0,0,0,0,1,0,0,1,1
12476,111370,PVH5tEGH8GZxJxi2Ll8MBjEy0thVXtCn,3VkHkmOtom3jM2wCu94xgzzu1d6Dn7or,15,20,15,0,6,2,10,0,53,7.571428571428571,1,0.0,0,15,0,6,20,2,0,10,0,21,32,0
12477,111441,ZjjzblWLBhpCB41WVkrtllAfmPXPK6bc,3VkHkmOtom3jM2wCu94xgzzu1d6Dn7or,8,4,1,0,1,0,6,1,13,1.8571428571428572,1,0.0,0,1,0,1,4,0,0,6,1,2,11,1
12478,111473,P3zH2bHQy54kaknfZyFeRJ0FfiXyf86q,3VkHkmOtom3jM2wCu94xgzzu1d6Dn7or,13,12,6,0,5,3,10,1,37,5.285714285714286,1,0.0,3,6,0,5,9,3,0,10,1,14,23,0
12479,111477,AMDM6al5x8sRWdZz2ktXTH398SznbQSe,3VkHkmOtom3jM2wCu94xgzzu1d6Dn7or,1,0,0,0,0,0,1,0,1,0.14285714285714285,1,0.0,0,0,0,0,0,0,0,1,0,0,1,1
12480,111508,pzsUx69X9Xid85hyecE8y9Ou9VDtnPhb,3VkHkmOtom3jM2wCu94xgzzu1d6Dn7or,13,19,7,10,7,1,4,0,48,6.857142857142857,2,0.0,9,7,9,7,10,1,1,4,0,32,16,1
12481,111524,Gdw0OfNNRxeUit8z8trs290TkDB3iLCu,3VkHkmOtom3jM2wCu94xgzzu1d6Dn7or,8,8,5,0,4,1,3,0,21,3.0,1,0.0,0,5,0,4,8,1,0,3,0,9,12,1
12482,111529,VtcqBivUlTKNl0Bc1erobU130cXDS6KE,3VkHkmOtom3jM2wCu94xgzzu1d6Dn7or,62,53,23,27,22,0,8,0,133,19.0,4,0.0,25,23,25,22,28,0,2,8,0,95,38,0
12483,111548,FNVCEUxOa8KJRVtqpHppqwsluCHqZPV0,3VkHkmOtom3jM2wCu94xgzzu1d6Dn7or,1,0,0,0,0,0,1,0,1,0.14285714285714285,1,0.0,0,0,0,0,0,0,0,1,0,0,1,1
12484,111576,Tmbn0NKUx4beAPJhrbC4V92oxhibMjq9,3VkHkmOtom3jM2wCu94xgzzu1d6Dn7or,30,30,17,0,17,0,3,0,67,9.571428571428571,1,0.0,0,17,0,17,30,0,0,3,0,34,33,1
12485,111577,iG5GnBGrbIvw6KizKdyVzTyvZUHTNvH5,3VkHkmOtom3jM2wCu94xgzzu1d6Dn7or,1,0,0,0,0,0,2,0,2,0.2857142857142857,1,0.0,0,0,0,0,0,0,0,2,0,0,2,1
12486,111639,f1qaQjpMgGLuPTyErL1I124VmrWItMHF,3VkHkmOtom3jM2wCu94xgzzu1d6Dn7or,1,0,0,0,0,0,2,0,2,0.2857142857142857,1,0.0,0,0,0,0,0,0,0,2,0,0,2,1
12487,111644,vbghp1PVpZxFaWqasEyQzIEfPKBk8vPh,3VkHkmOtom3jM2wCu94xgzzu1d6Dn7or,1,0,0,0,0,0,1,0,1,0.14285714285714285,1,0.0,0,0,0,0,0,0,0,1,0,0,1,1
12488,111659,Ht8gQquuDWuHnE8TA1lycaHJ8C9MVf20,3VkHkmOtom3jM2wCu94xgzzu1d6Dn7or,61,50,8,0,34,0,9,0,101,14.428571428571429,6,0.0,0,8,0,34,50,0,0,9,0,42,59,0
12489,111707,oDTCQYWkQkQEaFVTuvoUpDp7L9vcbsiB,3VkHkmOtom3jM2wCu94xgzzu1d6Dn7or,7,3,1,0,1,0,8,0,13,1.8571428571428572,1,0.0,0,1,0,1,3,0,0,8,0,2,11,1
12490,111722,hbvRiHicgfl7XhYSimAX7Vhr1jxdVZyC,3VkHkmOtom3jM2wCu94xgzzu1d6Dn7or,14,11,6,0,6,0,1,0,24,3.4285714285714284,1,0.0,0,6,0,6,11,0,0,1,0,12,12,1
12491,111765,NHohBV09H242QDbXlpW5SeArVCRf3EZG,3VkHkmOtom3jM2wCu94xgzzu1d6Dn7or,26,51,14,0,12,0,8,0,85,12.142857142857142,3,0.0,2,14,0,12,49,0,0,8,0,28,57,0
12492,111793,PIK4BwYW6UF5VNk6QwHlj6uqSbAz1VdV,3VkHkmOtom3jM2wCu94xgzzu1d6Dn7or,1,0,0,0,0,0,1,0,1,0.14285714285714285,1,0.0,0,0,0,0,0,0,0,1,0,0,1,1
12493,111812,nBF4tD1vFpwiYJCOxnzt1rMBPoer677d,3VkHkmOtom3jM2wCu94xgzzu1d6Dn7or,18,52,19,9,13,15,12,1,121,17.285714285714285,3,0.0,22,19,7,13,30,15,2,12,1,61,60,0
12494,111818,KWd0W5LFo2aRCM9EB6q9ghMk4KZOMRgX,3VkHkmOtom3jM2wCu94xgzzu1d6Dn7or,8,4,3,0,3,0,5,0,15,2.142857142857143,1,0.0,0,3,0,3,4,0,0,5,0,6,9,1
12495,111837,Pt0ZUDMBwJ6kjWhW14J5JBu0QRWNcMSZ,3VkHkmOtom3jM2wCu94xgzzu1d6Dn7or,8,4,2,0,1,0,5,1,13,1.8571428571428572,1,0.0,0,2,0,1,4,0,0,5,1,3,10,1
12496,111867,G4ndF3jMuKTqtu9uYeLIFsl19xQFpToo,3VkHkmOtom3jM2wCu94xgzzu1d6Dn7or,3,2,0,0,0,0,1,0,3,0.42857142857142855,1,0.0,0,0,0,0,2,0,0,1,0,0,3,1
12497,111879,5fdjSFb0UnHfjLD83iptHyG30XcBntML,3VkHkmOtom3jM2wCu94xgzzu1d6Dn7or,3,2,0,0,0,0,1,0,3,0.42857142857142855,1,0.0,0,0,0,0,2,0,0,1,0,0,3,1
12498,111892,AytMS9By5Hlw48ZNqrCtItQbZYKHh7Q3,3VkHkmOtom3jM2wCu94xgzzu1d6Dn7or,9,18,4,14,3,9,2,0,50,7.142857142857143,1,0.0,7,4,9,3,11,9,5,2,0,23,27,1
12499,111927,3DZEluPiRSphAy398RdO2XX8VKDVzVoK,3VkHkmOtom3jM2wCu94xgzzu1d6Dn7or,16,27,12,15,9,1,5,0,69,9.857142857142858,1,0.0,11,12,12,9,16,1,3,5,0,44,25,1
12500,111928,dMFGb7ZI9NHuXSGQM86qRDKrtK5SOgjQ,3VkHkmOtom3jM2wCu94xgzzu1d6Dn7or,7,3,2,0,2,0,2,0,9,1.2857142857142858,1,0.0,0,2,0,2,3,0,0,2,0,4,5,1
12501,111929,JxVarlBq08OASjpQGibNnUaguOzX31wq,3VkHkmOtom3jM2wCu94xgzzu1d6Dn7or,4,2,1,0,1,0,1,0,5,0.7142857142857143,1,0.0,0,1,0,1,2,0,0,1,0,2,3,1
12502,111933,xozOUk6HJgNqz7jqPBKRd7zYRuT58TEi,3VkHkmOtom3jM2wCu94xgzzu1d6Dn7or,1,0,0,0,0,0,1,0,1,0.14285714285714285,1,0.0,0,0,0,0,0,0,0,1,0,0,1,1
12503,111937,0lZ2gAG5jH1INiMk61cLPbE0aHpRZ1Fo,3VkHkmOtom3jM2wCu94xgzzu1d6Dn7or,1,0,0,0,0,0,1,0,1,0.14285714285714285,1,0.0,0,0,0,0,0,0,0,1,0,0,1,1
12504,111939,ua8xHMwdNZcrAfQNfsd9dNhJSKhizi8U,3VkHkmOtom3jM2wCu94xgzzu1d6Dn7or,4,2,1,0,1,0,1,0,5,0.7142857142857143,1,0.0,0,1,0,1,2,0,0,1,0,2,3,1
12505,111946,9rYfHblkB5nFHGrtpqn8aCCcNIIBs5zT,3VkHkmOtom3jM2wCu94xgzzu1d6Dn7or,11,13,5,0,4,0,2,0,24,3.4285714285714284,1,0.0,1,5,0,4,12,0,0,2,0,10,14,1
12506,111951,7yp7RqyFahdP1GQdWRDVFt7ZLf5G1yWT,3VkHkmOtom3jM2wCu94xgzzu1d6Dn7or,30,52,12,22,24,14,11,1,136,19.428571428571427,2,0.0,39,12,19,24,13,14,3,11,1,94,42,1
12507,111954,yeRsbimDLI4VzVSMeS7rxXsi0BElLbFq,3VkHkmOtom3jM2wCu94xgzzu1d6Dn7or,4,2,1,0,1,0,2,0,6,0.8571428571428571,1,0.0,0,1,0,1,2,0,0,2,0,2,4,1
12508,111963,WW7Yo6PmQhLyd4oqDECwVthtmVns6DPF,3VkHkmOtom3jM2wCu94xgzzu1d6Dn7or,7,14,4,6,1,7,3,0,35,5.0,2,0.0,3,4,5,1,11,7,1,3,0,13,22,1
12509,111964,CrhLQSGEGPJ3AH0hpRJz06hJlud4teh7,3VkHkmOtom3jM2wCu94xgzzu1d6Dn7or,6,2,1,0,1,0,4,0,8,1.1428571428571428,1,0.0,0,1,0,1,2,0,0,4,0,2,6,1
12510,111966,ZUdl8Ggg39iRoGdmF0am1pmKRmXqomrv,3VkHkmOtom3jM2wCu94xgzzu1d6Dn7or,1,0,0,0,0,0,1,0,1,0.14285714285714285,1,0.0,0,0,0,0,0,0,0,1,0,0,1,1
12511,111967,YxMNk2apswQEh8zV5Q50IFWgCD8oo8Ws,3VkHkmOtom3jM2wCu94xgzzu1d6Dn7or,1,0,0,0,0,0,3,0,3,0.42857142857142855,1,0.0,0,0,0,0,0,0,0,3,0,0,3,1
12512,111976,toG3QkJk19CDmq2nM3SKNSGmeAefbNIn,3VkHkmOtom3jM2wCu94xgzzu1d6Dn7or,11,15,0,2,3,6,7,0,33,4.714285714285714,1,0.0,4,0,2,3,11,6,0,7,0,9,24,1
12513,111986,AGD3MBIeqZTxYwDuHS59UCXpZacrTopY,3VkHkmOtom3jM2wCu94xgzzu1d6Dn7or,5,0,0,0,0,0,4,1,5,0.7142857142857143,1,0.0,0,0,0,0,0,0,0,4,1,0,5,1
12514,111988,KaeCX7DoW5htn0YhXrWslGGGeoVPFyiJ,3VkHkmOtom3jM2wCu94xgzzu1d6Dn7or,6,5,2,0,2,0,3,0,12,1.7142857142857142,2,0.0,0,2,0,2,5,0,0,3,0,4,8,1
12515,111990,eT9OhUahWhAeZfHPEbxGN9qGHwvkkQvs,3VkHkmOtom3jM2wCu94xgzzu1d6Dn7or,4,2,1,0,1,0,1,0,5,0.7142857142857143,1,0.0,0,1,0,1,2,0,0,1,0,2,3,1
12516,111994,j2gKYYMcLFwIWIzeiTmjigweYNzNBGo4,3VkHkmOtom3jM2wCu94xgzzu1d6Dn7or,2,0,0,0,0,0,5,0,5,0.7142857142857143,1,0.0,0,0,0,0,0,0,0,5,0,0,5,1
12517,111995,53xb4b3qyj6I63ytkM2e583BKuXLUiaA,3VkHkmOtom3jM2wCu94xgzzu1d6Dn7or,1,0,0,0,0,0,1,0,1,0.14285714285714285,1,0.0,0,0,0,0,0,0,0,1,0,0,1,1
12518,111997,iclIP1jghYCfioY2FqtU5Lc3nRAFn1xN,3VkHkmOtom3jM2wCu94xgzzu1d6Dn7or,4,2,1,0,1,0,1,0,5,0.7142857142857143,1,0.0,0,1,0,1,2,0,0,1,0,2,3,0
12519,112005,YHhKpuvJC4d5Yv14WaZLbr14JVCcikf2,3VkHkmOtom3jM2wCu94xgzzu1d6Dn7or,7,5,2,4,2,1,2,0,16,2.2857142857142856,1,0.0,1,2,3,2,4,1,1,2,0,8,8,1
12520,112007,cYVBkFSdPo0naqk19Kx0uZGlRjFryKuo,3VkHkmOtom3jM2wCu94xgzzu1d6Dn7or,5,4,0,0,2,0,4,0,10,1.4285714285714286,1,0.0,2,0,0,2,2,0,0,4,0,4,6,1
12521,112008,6svB5U4T8Gl5UopI2QlDMRmBtqh4MN4V,3VkHkmOtom3jM2wCu94xgzzu1d6Dn7or,6,4,3,0,3,0,1,0,11,1.5714285714285714,1,0.0,0,3,0,3,4,0,0,1,0,6,5,0
12522,112010,ebYl7COD4e2InprKALscMyYn5VZ3FcRm,3VkHkmOtom3jM2wCu94xgzzu1d6Dn7or,36,107,33,27,46,7,12,1,233,33.285714285714285,4,0.0,66,33,24,46,41,7,3,12,1,169,64,1
12523,112011,3lQBLQevxeH5CcBmmJpYwr3AUKCtRzXF,3VkHkmOtom3jM2wCu94xgzzu1d6Dn7or,10,21,7,6,7,18,2,0,61,8.714285714285714,1,0.0,12,7,5,7,9,18,1,2,0,31,30,1
12524,112014,THL58Oahb12YvJ1YW5saCamuHKc2RTXs,3VkHkmOtom3jM2wCu94xgzzu1d6Dn7or,42,35,26,0,21,0,13,0,95,13.571428571428571,4,0.0,0,26,0,21,35,0,0,13,0,47,48,0
12525,112017,WFycJnPuPLuYOqK1bD1fFD6G4Z2IEQit,3VkHkmOtom3jM2wCu94xgzzu1d6Dn7or,1,0,0,0,0,0,2,0,2,0.2857142857142857,1,0.0,0,0,0,0,0,0,0,2,0,0,2,1
12526,112021,fYVuPS71xJEDv4hsEkks3lym9MZ4TDJV,3VkHkmOtom3jM2wCu94xgzzu1d6Dn7or,6,2,1,0,1,0,6,0,10,1.4285714285714286,1,0.0,0,1,0,1,2,0,0,6,0,2,8,1
12527,112029,8QeNBSoAmfuMMwnfjCjhlHJfHWJb6Z8j,3VkHkmOtom3jM2wCu94xgzzu1d6Dn7or,5,6,3,0,1,0,3,0,13,1.8571428571428572,2,0.0,0,3,0,1,6,0,0,3,0,4,9,1
12528,112032,VeDeV6aD6kowERv1ygPjE9YEMgMJMOAv,3VkHkmOtom3jM2wCu94xgzzu1d6Dn7or,16,36,15,13,10,14,6,0,94,13.428571428571429,2,0.0,11,15,13,10,25,14,0,6,0,49,45,1
12529,112033,yJ5AdpV4Umz0vyCUvOg8esOsmohWDdKi,3VkHkmOtom3jM2wCu94xgzzu1d6Dn7or,5,2,1,0,1,0,2,0,6,0.8571428571428571,1,0.0,0,1,0,1,2,0,0,2,0,2,4,1
12530,112036,BjBet1XrpmufRo3nJSBrADvKxDiooNdd,3VkHkmOtom3jM2wCu94xgzzu1d6Dn7or,1,0,0,0,0,0,1,0,1,0.14285714285714285,1,0.0,0,0,0,0,0,0,0,1,0,0,1,1
12531,112042,78K2WkpPCTZZDuQORBAFkp5eT2Zptciw,3VkHkmOtom3jM2wCu94xgzzu1d6Dn7or,87,308,72,126,60,19,36,0,621,88.71428571428571,10,0.0,123,72,114,60,185,19,12,36,0,369,252,0
12532,112044,oQl0xDZ6pRPXU9L7MUpc2rUtjHufKB7J,3VkHkmOtom3jM2wCu94xgzzu1d6Dn7or,28,85,38,30,14,1,18,0,186,26.571428571428573,7,0.0,28,38,28,14,57,1,2,18,0,108,78,0
12533,112049,ZEQvmWn0Ak2NSUvhNu3WsBnTCcx2wUur,3VkHkmOtom3jM2wCu94xgzzu1d6Dn7or,1,0,0,0,0,0,2,0,2,0.2857142857142857,1,0.0,0,0,0,0,0,0,0,2,0,0,2,1
12534,112050,Ra7sE4wAxUIWpR0t2405LuHyqEioCMqs,3VkHkmOtom3jM2wCu94xgzzu1d6Dn7or,20,32,13,0,11,0,3,0,59,8.428571428571429,1,0.0,0,13,0,11,32,0,0,3,0,24,35,1
12535,112053,6Jl8kTqfFa1rQv3ymDEsunHDEuyu4uCl,3VkHkmOtom3jM2wCu94xgzzu1d6Dn7or,7,7,2,0,1,5,6,0,21,3.0,1,0.0,0,2,0,1,7,5,0,6,0,3,18,1
12536,112054,ibL5MIncSfKj8NGMz1VIWu1lFdMj3iWi,3VkHkmOtom3jM2wCu94xgzzu1d6Dn7or,3,5,0,0,0,0,1,0,6,0.8571428571428571,2,0.0,0,0,0,0,5,0,0,1,0,0,6,0
12537,112076,nF7aAeT70FglKCK63KUkEVk8gbyNehUj,3VkHkmOtom3jM2wCu94xgzzu1d6Dn7or,8,12,4,0,2,1,8,1,28,4.0,4,0.0,1,4,0,2,11,1,0,8,1,7,21,0
12538,112087,YRDulTOgIWgR8cFwTAVhhuxX46WtWav7,3VkHkmOtom3jM2wCu94xgzzu1d6Dn7or,6,5,2,0,2,0,1,0,10,1.4285714285714286,1,0.0,2,2,0,2,3,0,0,1,0,6,4,1
12539,112108,FFDFPK1HNjN0Aa04wodQmENMubJsJXNU,3VkHkmOtom3jM2wCu94xgzzu1d6Dn7or,3,3,1,0,0,0,1,0,5,0.7142857142857143,1,0.0,0,1,0,0,3,0,0,1,0,1,4,1
12540,112116,lXrOH5wPLm23d6wu5X4QSekUdTmIuRYJ,3VkHkmOtom3jM2wCu94xgzzu1d6Dn7or,6,7,2,0,1,0,6,0,16,2.2857142857142856,1,0.0,0,2,0,1,7,0,0,6,0,3,13,1
12541,112159,sMMo4gFgq3RgS4WA6aTyILkePEOc6VJR,3VkHkmOtom3jM2wCu94xgzzu1d6Dn7or,4,3,0,0,0,0,3,0,6,0.8571428571428571,1,0.0,0,0,0,0,3,0,0,3,0,0,6,1
12542,112192,q660sHWwNVPLYlyOFPnKqxZsq0N7tubl,3VkHkmOtom3jM2wCu94xgzzu1d6Dn7or,1,0,0,0,0,0,1,0,1,0.14285714285714285,1,0.0,0,0,0,0,0,0,0,1,0,0,1,1
12543,112196,ZiZkXgxxFkMOEdett3TrVovXNjeMkDCt,3VkHkmOtom3jM2wCu94xgzzu1d6Dn7or,15,17,8,0,7,0,2,0,34,4.857142857142857,1,0.0,0,8,0,7,17,0,0,2,0,15,19,1
12544,112218,QqGEhb9aelEacMmGunNJm1ELEvGaQ2a8,3VkHkmOtom3jM2wCu94xgzzu1d6Dn7or,1,0,0,0,0,0,1,0,1,0.14285714285714285,1,0.0,0,0,0,0,0,0,0,1,0,0,1,1
12545,112224,mpbWhz8yp974O11UFImAPnzjPzgRhhJu,3VkHkmOtom3jM2wCu94xgzzu1d6Dn7or,76,161,39,48,72,14,12,0,346,49.42857142857143,5,0.0,109,39,45,72,52,14,3,12,0,265,81,0
12546,112248,x98CGtCWw95UaH5rhAe7ZjNA6PYDcGv8,3VkHkmOtom3jM2wCu94xgzzu1d6Dn7or,22,100,14,25,8,3,41,0,191,27.285714285714285,4,0.0,22,14,21,8,78,3,4,41,0,65,126,0
12547,112267,oedBUl8bzFPMVSQimVz39gymPfLeWWiZ,3VkHkmOtom3jM2wCu94xgzzu1d6Dn7or,2,0,0,0,0,0,10,0,10,1.4285714285714286,1,0.0,0,0,0,0,0,0,0,10,0,0,10,1
12548,112275,Vgu46RFOhCWtRKgVvFukXU42fM2ek6kD,3VkHkmOtom3jM2wCu94xgzzu1d6Dn7or,5,6,0,0,0,0,2,2,10,1.4285714285714286,1,0.0,2,0,0,0,4,0,0,2,2,2,8,1
12549,112320,02eB8ecCHjqNKo6qHUUGR29f8TPEGh0h,3VkHkmOtom3jM2wCu94xgzzu1d6Dn7or,7,4,2,0,2,0,4,0,12,1.7142857142857142,1,0.0,0,2,0,2,4,0,0,4,0,4,8,1
12550,112322,nxJZuhJjaQY3pxIrLt24GAiKN1UhZHBs,3VkHkmOtom3jM2wCu94xgzzu1d6Dn7or,1,0,0,0,0,0,1,0,1,0.14285714285714285,1,0.0,0,0,0,0,0,0,0,1,0,0,1,1
12551,112336,cq1EcgJkOzsgPApyam8jrBgIihT5dYdk,3VkHkmOtom3jM2wCu94xgzzu1d6Dn7or,1,0,0,0,0,0,1,0,1,0.14285714285714285,1,0.0,0,0,0,0,0,0,0,1,0,0,1,1
12552,112367,6TF5ejz0He9snpKNUlejoFGbQsAtIHw4,5Gyp41oLVo7Gg7vF4vpmggWP5MU70QO6,70,228,95,90,30,123,51,2,619,88.42857142857143,13,0.0,71,95,65,30,157,123,25,51,2,261,358,0
12553,112379,QAV02IL7ajntDdHVirqabwTRIN1Sa6iz,5Gyp41oLVo7Gg7vF4vpmggWP5MU70QO6,57,212,111,34,65,19,51,4,496,70.85714285714286,16,0.0,56,111,26,65,156,19,8,51,4,258,238,0
12554,112408,ANFesR75Jgbaf4kJ69uePCSrh3drP5Gg,5Gyp41oLVo7Gg7vF4vpmggWP5MU70QO6,45,203,28,49,38,105,36,2,461,65.85714285714286,23,0.0,34,28,40,38,169,105,9,36,2,140,321,0
12555,112434,dQeQGMqD2AfjLt9WMqT1wjR4i8srmTVY,5Gyp41oLVo7Gg7vF4vpmggWP5MU70QO6,12,10,5,2,2,0,4,0,23,3.2857142857142856,4,0.0,1,5,1,2,9,0,1,4,0,9,14,1
12556,112437,VlFSAklSaE6MkLq9APNocybzNA8P3gGI,5Gyp41oLVo7Gg7vF4vpmggWP5MU70QO6,29,59,32,19,16,9,15,1,151,21.571428571428573,7,0.0,17,32,12,16,42,9,7,15,1,77,74,1
12557,112445,7RSTSE7CX0EZRW2RDRnKS7CJkHtK7gJx,5Gyp41oLVo7Gg7vF4vpmggWP5MU70QO6,4,2,1,0,0,4,6,0,13,1.8571428571428572,1,0.0,0,1,0,0,2,4,0,6,0,1,12,1
12558,112451,1dkYrsVP9CkJjuyC6VhiBEkMgSrgRGy1,5Gyp41oLVo7Gg7vF4vpmggWP5MU70QO6,15,15,0,12,0,0,6,1,34,4.857142857142857,2,0.0,5,0,6,0,10,0,6,6,1,11,23,1
12559,112463,FeSQQc9CIFMTYLlHcSRbUJqf0NNwxJ2K,5Gyp41oLVo7Gg7vF4vpmggWP5MU70QO6,15,26,14,13,6,0,8,0,67,9.571428571428571,4,0.0,5,14,8,6,21,0,5,8,0,33,34,1
12560,112471,5zyFk8FiLdmnu9WbWgpyC2fkL0q8txqg,5Gyp41oLVo7Gg7vF4vpmggWP5MU70QO6,5,2,1,0,1,0,2,0,6,0.8571428571428571,1,0.0,0,1,0,1,2,0,0,2,0,2,4,1
12561,112489,U2zYL2pX3EUp3326VbwsJLAkNlVZZnCj,5Gyp41oLVo7Gg7vF4vpmggWP5MU70QO6,10,18,9,2,4,0,7,0,40,5.714285714285714,5,0.0,3,9,1,4,15,0,1,7,0,17,23,1
12562,112492,gnjkvYNHASmxrSHftIplHX6Lama9SuHW,5Gyp41oLVo7Gg7vF4vpmggWP5MU70QO6,7,3,2,0,2,0,2,0,9,1.2857142857142858,1,0.0,0,2,0,2,3,0,0,2,0,4,5,1
12563,112495,aufeKSBI3whyrfmkKYIEHMeiZ61NUgYf,5Gyp41oLVo7Gg7vF4vpmggWP5MU70QO6,5,2,1,0,1,0,2,0,6,0.8571428571428571,1,0.0,0,1,0,1,2,0,0,2,0,2,4,1
12564,112498,nQ8zyPaxuBVV0E4EnN5ZsvrgPzjbJntO,5Gyp41oLVo7Gg7vF4vpmggWP5MU70QO6,8,10,6,0,1,0,6,0,23,3.2857142857142856,3,0.0,0,6,0,1,10,0,0,6,0,7,16,1
12565,112515,ILkUjE8LhIAQFlZwnOqsyA4K0QvAbnzA,5Gyp41oLVo7Gg7vF4vpmggWP5MU70QO6,1,0,0,0,0,0,2,0,2,0.2857142857142857,1,0.0,0,0,0,0,0,0,0,2,0,0,2,1
12566,112523,ySy2zYThCkVZr5MjEXuKxq60wfOynxkJ,5Gyp41oLVo7Gg7vF4vpmggWP5MU70QO6,7,5,2,0,1,0,4,0,12,1.7142857142857142,2,0.0,0,2,0,1,5,0,0,4,0,3,9,1
12567,112529,cpPSwRiyzrnBZYcFR4yyg60XVFgQxQi4,5Gyp41oLVo7Gg7vF4vpmggWP5MU70QO6,16,24,17,6,10,3,44,5,109,15.571428571428571,7,0.0,4,17,4,10,20,3,2,44,5,35,74,0
12568,112530,DNAhoSAo2TyzbNbN3nxE9yloBifToEMC,5Gyp41oLVo7Gg7vF4vpmggWP5MU70QO6,1,0,0,0,0,0,1,0,1,0.14285714285714285,1,0.0,0,0,0,0,0,0,0,1,0,0,1,1
12569,112535,KeSzpEWoV0R6xsKMnqGxXoDqNgrDy1ti,5Gyp41oLVo7Gg7vF4vpmggWP5MU70QO6,13,6,5,0,5,0,2,0,18,2.5714285714285716,1,0.0,0,5,0,5,6,0,0,2,0,10,8,1
12570,112544,Qfd5NSQMshaz9tIWhiDXjUxqfga3DDZq,5Gyp41oLVo7Gg7vF4vpmggWP5MU70QO6,30,25,19,0,16,9,11,3,83,11.857142857142858,2,0.0,1,19,0,16,24,9,0,11,3,36,47,1
12571,112561,OT3O39HutXQkPsTvi6rLAq8sPcWlmwof,5Gyp41oLVo7Gg7vF4vpmggWP5MU70QO6,24,88,40,30,9,19,29,2,217,31.0,6,0.0,18,40,20,9,70,19,10,29,2,87,130,0
12572,112573,5f2Vv7UWlj5M1yvVbbBBHVwiDGe0CInr,5Gyp41oLVo7Gg7vF4vpmggWP5MU70QO6,7,6,3,0,3,0,2,0,14,2.0,1,0.0,2,3,0,3,4,0,0,2,0,8,6,1
12573,112587,8fvsCrC8dcOje6DxrGntnTxmufYXJCrq,5Gyp41oLVo7Gg7vF4vpmggWP5MU70QO6,9,14,6,0,3,0,3,0,26,3.7142857142857144,3,0.0,4,6,0,3,10,0,0,3,0,13,13,1
12574,112589,V6eHxf4YFnuStkxXYpZgYV3Sed4O7kw9,5Gyp41oLVo7Gg7vF4vpmggWP5MU70QO6,8,4,2,0,3,1,3,1,14,2.0,1,0.0,1,2,0,3,3,1,0,3,1,6,8,1
12575,112591,CYN3tl2d8PV3r7FRKTn3DmaQTLhkh777,5Gyp41oLVo7Gg7vF4vpmggWP5MU70QO6,16,23,6,12,2,1,6,1,51,7.285714285714286,1,0.0,14,6,6,2,9,1,6,6,1,28,23,0
12576,112595,puCo5YmED6Uq1uR83Fna1joj9SdvQPHR,5Gyp41oLVo7Gg7vF4vpmggWP5MU70QO6,1,0,0,0,0,0,1,0,1,0.14285714285714285,1,0.0,0,0,0,0,0,0,0,1,0,0,1,1
12577,112614,GKKNtfrAHKD2xUEQBz7HLN3kKO9SrWyD,5Gyp41oLVo7Gg7vF4vpmggWP5MU70QO6,1,0,0,0,0,0,1,0,1,0.14285714285714285,1,0.0,0,0,0,0,0,0,0,1,0,0,1,1
12578,112656,51qeivibqjzU02LiU7FPFZmJUBump2P8,5Gyp41oLVo7Gg7vF4vpmggWP5MU70QO6,5,0,0,0,0,1,8,0,9,1.2857142857142858,2,0.0,0,0,0,0,0,1,0,8,0,0,9,1
12579,112662,oQ1m6ynaSjvrLZKayCazlfEosUJu3ieW,5Gyp41oLVo7Gg7vF4vpmggWP5MU70QO6,9,5,3,0,4,13,2,0,27,3.857142857142857,1,0.0,1,3,0,4,4,13,0,2,0,8,19,1
12580,112674,44ijxMUagaLod1iza5FrW1Uqece2jUOc,5Gyp41oLVo7Gg7vF4vpmggWP5MU70QO6,1,0,0,0,0,0,1,0,1,0.14285714285714285,1,0.0,0,0,0,0,0,0,0,1,0,0,1,1
12581,112677,sW1u9EOUYrJApfkaDSoDkISZzFP3ogv6,5Gyp41oLVo7Gg7vF4vpmggWP5MU70QO6,6,3,2,0,2,0,1,0,8,1.1428571428571428,1,0.0,0,2,0,2,3,0,0,1,0,4,4,1
12582,112697,ZmXZsEo2rrliBxnq0XarGwTqKrylhBGN,5Gyp41oLVo7Gg7vF4vpmggWP5MU70QO6,1,0,0,0,0,0,1,0,1,0.14285714285714285,1,0.0,0,0,0,0,0,0,0,1,0,0,1,1
12583,112699,jsoc8YzRzl1dA8hk6IZJ9PMa2b08oMn7,5Gyp41oLVo7Gg7vF4vpmggWP5MU70QO6,13,49,27,4,2,35,22,3,142,20.285714285714285,6,0.0,7,27,4,2,42,35,0,22,3,40,102,0
12584,112703,l01aGQuAgd5VHAVuk21pZMIeJcDQOX6i,5Gyp41oLVo7Gg7vF4vpmggWP5MU70QO6,7,8,3,0,3,0,2,0,16,2.2857142857142856,1,0.0,2,3,0,3,6,0,0,2,0,8,8,1
12585,112706,kd8Q2Ddqd6Nc7nK4UZ0sM8K8LUOgjEo9,5Gyp41oLVo7Gg7vF4vpmggWP5MU70QO6,1,0,0,0,0,0,1,0,1,0.14285714285714285,1,0.0,0,0,0,0,0,0,0,1,0,0,1,1
12586,112711,YY7yHizDn0UpGHVq4qoTfbulP3ev5TkC,5Gyp41oLVo7Gg7vF4vpmggWP5MU70QO6,1,0,0,0,0,0,2,0,2,0.2857142857142857,1,0.0,0,0,0,0,0,0,0,2,0,0,2,1
12587,112729,6w31L0njODaizeDT0XXbujjg7cAV0t69,5Gyp41oLVo7Gg7vF4vpmggWP5MU70QO6,22,51,29,13,11,4,8,1,117,16.714285714285715,4,0.0,16,29,9,11,35,4,4,8,1,65,52,1
12588,112736,4akkAUueIgY5RXpAaqc9EEDjUt2pCs2C,5Gyp41oLVo7Gg7vF4vpmggWP5MU70QO6,5,2,1,0,1,0,2,0,6,0.8571428571428571,1,0.0,0,1,0,1,2,0,0,2,0,2,4,1
12589,112744,p7F9wqiENh8WEIuPUKCaZXtSU8HYgtAG,5Gyp41oLVo7Gg7vF4vpmggWP5MU70QO6,1,0,0,0,0,0,1,0,1,0.14285714285714285,1,0.0,0,0,0,0,0,0,0,1,0,0,1,1
12590,112766,pCfcM2SE8eEiM5EU3JQTfV7HzQcZXFdf,5Gyp41oLVo7Gg7vF4vpmggWP5MU70QO6,12,15,5,4,0,0,11,1,36,5.142857142857143,2,0.0,7,5,2,0,8,0,2,11,1,14,22,1
12591,112767,hbyHCKWmRix8tf3hb9GoVowbX4E7bq4m,5Gyp41oLVo7Gg7vF4vpmggWP5MU70QO6,7,6,3,0,2,0,5,0,16,2.2857142857142856,1,0.0,0,3,0,2,6,0,0,5,0,5,11,1
12592,112780,BgbeTSobCItrrFbAULdDOQ1iv2JVx8uN,5Gyp41oLVo7Gg7vF4vpmggWP5MU70QO6,14,20,0,4,1,1,8,1,35,5.0,1,0.0,8,0,2,1,12,1,2,8,1,11,24,1
12593,112788,UuMORbwrTgxjoSjGOUE1agbW4PPcLBkQ,5Gyp41oLVo7Gg7vF4vpmggWP5MU70QO6,1,0,0,0,0,0,1,0,1,0.14285714285714285,1,0.0,0,0,0,0,0,0,0,1,0,0,1,1
12594,112813,ySNhuN4cMJYw3YunLq5TEcsOAWWfl0O3,5Gyp41oLVo7Gg7vF4vpmggWP5MU70QO6,14,13,6,2,3,0,11,1,36,5.142857142857143,1,0.0,3,6,1,3,10,0,1,11,1,13,23,1
12595,112830,uLNBqDSEmqIWmlqtLwekVjrvGHBhIw9z,5Gyp41oLVo7Gg7vF4vpmggWP5MU70QO6,8,7,3,0,2,0,2,0,14,2.0,1,0.0,2,3,0,2,5,0,0,2,0,7,7,1
12596,112835,e26S3yWE4iC2a5gPCzthjRLKEGyf631u,5Gyp41oLVo7Gg7vF4vpmggWP5MU70QO6,36,103,50,36,29,89,43,8,358,51.142857142857146,5,0.0,37,50,24,29,66,89,12,43,8,140,218,1
12597,112841,xHb1ESzYWClS216SrMiGgpGfuxQDdEps,5Gyp41oLVo7Gg7vF4vpmggWP5MU70QO6,17,37,19,10,8,12,8,1,95,13.571428571428571,3,0.0,2,19,6,8,35,12,4,8,1,35,60,0
12598,112852,qwXoPjhUKPW4mjMQuu0Cra7UJGmweA6l,5Gyp41oLVo7Gg7vF4vpmggWP5MU70QO6,1,0,0,0,0,0,1,0,1,0.14285714285714285,1,0.0,0,0,0,0,0,0,0,1,0,0,1,1
12599,112860,92i6WCDh4pbZko87bg3yoG2KzL63FL3Y,5Gyp41oLVo7Gg7vF4vpmggWP5MU70QO6,15,30,14,0,10,20,16,4,94,13.428571428571429,1,0.0,11,14,0,10,19,20,0,16,4,35,59,1
12600,112867,RUKVb8KJARbyVGqP1jNNqUcwarjb1WYI,5Gyp41oLVo7Gg7vF4vpmggWP5MU70QO6,79,256,86,100,44,113,59,2,660,94.28571428571429,16,0.0,71,86,88,44,185,113,12,59,2,289,371,0
12601,112869,nR6yQ1hW5n2ljHF7U5ltxthBwBA5nCyW,5Gyp41oLVo7Gg7vF4vpmggWP5MU70QO6,13,13,8,12,2,0,4,0,39,5.571428571428571,1,0.0,2,8,6,2,11,0,6,4,0,18,21,1
12602,112874,Uf2yr0QlNUZWe0R6cXLvUSjS71SpRuiX,5Gyp41oLVo7Gg7vF4vpmggWP5MU70QO6,31,61,24,22,29,0,17,0,153,21.857142857142858,4,0.0,30,24,14,29,31,0,8,17,0,97,56,0
12603,112884,7ibPDHAfOQNNdh2QVN08a2m5yntiiyLk,5Gyp41oLVo7Gg7vF4vpmggWP5MU70QO6,9,7,3,0,1,3,4,0,18,2.5714285714285716,1,0.0,2,3,0,1,5,3,0,4,0,6,12,1
12604,112893,djDyVBnfhk7KRdU1C4tpJp1YaOuTd9LV,5Gyp41oLVo7Gg7vF4vpmggWP5MU70QO6,4,2,1,0,1,0,1,0,5,0.7142857142857143,1,0.0,0,1,0,1,2,0,0,1,0,2,3,1
12605,112894,GLKrcnSEAULfCGUeTYXqH0DehboNmRud,5Gyp41oLVo7Gg7vF4vpmggWP5MU70QO6,11,8,5,0,3,4,6,1,27,3.857142857142857,2,0.0,0,5,0,3,8,4,0,6,1,8,19,1
12606,112911,H7N61Yol2XG6wyMnfL2nuTS8QWac9JzQ,5Gyp41oLVo7Gg7vF4vpmggWP5MU70QO6,1,0,0,0,0,0,1,0,1,0.14285714285714285,1,0.0,0,0,0,0,0,0,0,1,0,0,1,1
12607,112928,97wHw7Ax0Tpeo3IOtojYRRxaveg1lUvV,5Gyp41oLVo7Gg7vF4vpmggWP5MU70QO6,16,15,8,8,4,1,2,1,39,5.571428571428571,1,0.0,4,8,4,4,11,1,4,2,1,20,19,1
12608,112952,ylczkA3mhE0JVfBTI7R2Ah2WdZBHZ74W,5Gyp41oLVo7Gg7vF4vpmggWP5MU70QO6,1,0,0,0,0,0,1,0,1,0.14285714285714285,1,0.0,0,0,0,0,0,0,0,1,0,0,1,1
12609,112960,VSXMlLIgs4SMMpav2IXYJyIlOX884gOj,5Gyp41oLVo7Gg7vF4vpmggWP5MU70QO6,1,0,0,0,0,0,2,0,2,0.2857142857142857,2,0.0,0,0,0,0,0,0,0,2,0,0,2,1
12610,112966,7glymc4Wt1TTt6LrLi78VQNF5GV1r6UY,5Gyp41oLVo7Gg7vF4vpmggWP5MU70QO6,28,68,33,12,11,110,69,2,305,43.57142857142857,7,0.0,27,33,8,11,41,110,4,69,2,79,226,0
12611,112978,6gOnMTJMrTUveLgLzoVELk1PZxgQ1kKQ,5Gyp41oLVo7Gg7vF4vpmggWP5MU70QO6,5,2,1,0,1,0,3,0,7,1.0,1,0.0,0,1,0,1,2,0,0,3,0,2,5,1
12612,112985,id1kXtz1h0Ndu1sUboFfRV6umlUL6W8J,5Gyp41oLVo7Gg7vF4vpmggWP5MU70QO6,12,7,3,2,2,4,8,1,27,3.857142857142857,2,0.0,1,3,1,2,6,4,1,8,1,7,20,1
12613,112986,f9q0lXE6jHEaa8DHjM18Quo6WmGR6Sg4,5Gyp41oLVo7Gg7vF4vpmggWP5MU70QO6,1,0,0,0,0,0,1,0,1,0.14285714285714285,1,0.0,0,0,0,0,0,0,0,1,0,0,1,1
12614,112999,RIF5KHeeLRLizFLRWosRqC8xVGz6vS3k,5Gyp41oLVo7Gg7vF4vpmggWP5MU70QO6,1,0,0,0,0,0,1,0,1,0.14285714285714285,1,0.0,0,0,0,0,0,0,0,1,0,0,1,1
12615,113008,STkhY4FDBzqHKYwGLMeALn36Cro74h2w,5Gyp41oLVo7Gg7vF4vpmggWP5MU70QO6,1,0,0,0,0,0,1,0,1,0.14285714285714285,1,0.0,0,0,0,0,0,0,0,1,0,0,1,1
12616,113022,lzXT85O8uHmF2hRbbjG6bXL6iB4nZQbJ,5Gyp41oLVo7Gg7vF4vpmggWP5MU70QO6,7,6,0,0,2,0,4,0,12,1.7142857142857142,2,0.0,0,0,0,2,6,0,0,4,0,2,10,1
12617,113026,nqLRPpborGO3IzbD5YxVONrZGqxfXpwO,5Gyp41oLVo7Gg7vF4vpmggWP5MU70QO6,4,2,1,0,1,0,2,0,6,0.8571428571428571,2,0.0,0,1,0,1,2,0,0,2,0,2,4,1
12618,113031,gOPZ3etUXI0kmJnwEMpCSZNEKAFxy8xg,5Gyp41oLVo7Gg7vF4vpmggWP5MU70QO6,7,3,2,0,2,0,2,0,9,1.2857142857142858,2,0.0,0,2,0,2,3,0,0,2,0,4,5,1
12619,113054,s1N0dNbsWZDqWhBof20h9F9XNjqzGFwU,5Gyp41oLVo7Gg7vF4vpmggWP5MU70QO6,13,9,5,0,4,5,7,1,31,4.428571428571429,3,0.0,1,5,0,4,8,5,0,7,1,10,21,0
12620,113061,P14RsFZwskYIpR5RuUNTAAtw7xsSIRhZ,5Gyp41oLVo7Gg7vF4vpmggWP5MU70QO6,11,7,6,0,4,0,2,0,19,2.7142857142857144,1,0.0,0,6,0,4,7,0,0,2,0,10,9,1
12621,113079,H4rucA3Bl92feiIFqEyA7i9inMfODBCx,5Gyp41oLVo7Gg7vF4vpmggWP5MU70QO6,34,117,59,42,27,50,25,5,325,46.42857142857143,11,0.0,37,59,30,27,80,50,12,25,5,153,172,1
12622,113106,qrcQ2HXUo2OtdaLvPE11MfpxbhBmjbOQ,5Gyp41oLVo7Gg7vF4vpmggWP5MU70QO6,8,4,3,0,2,0,2,0,11,1.5714285714285714,1,0.0,0,3,0,2,4,0,0,2,0,5,6,1
12623,113142,Y31gK8vZGNFE1p0FvJ7aBtAs0fzlqYVf,5Gyp41oLVo7Gg7vF4vpmggWP5MU70QO6,8,4,3,0,2,0,2,0,11,1.5714285714285714,1,0.0,0,3,0,2,4,0,0,2,0,5,6,1
12624,113167,jMSxxfftYD0taGWVEUZkcvxpGucC0j8q,5Gyp41oLVo7Gg7vF4vpmggWP5MU70QO6,7,9,4,0,0,0,3,0,16,2.2857142857142856,1,0.0,0,4,0,0,9,0,0,3,0,4,12,1
12625,113179,9Jd3vMNhp6SyraVetj8QtVOJNQzaAfTi,5Gyp41oLVo7Gg7vF4vpmggWP5MU70QO6,23,48,27,36,7,0,10,0,128,18.285714285714285,4,0.0,9,27,29,7,39,0,7,10,0,72,56,1
12626,113182,lvisrpyGeQckAylDwLBoWaVY1UfLOspu,5Gyp41oLVo7Gg7vF4vpmggWP5MU70QO6,1,0,0,0,0,0,1,0,1,0.14285714285714285,1,0.0,0,0,0,0,0,0,0,1,0,0,1,1
12627,113189,fUZcUE1FRmNuUNTn5Iz8wZHRok3wKZAV,5Gyp41oLVo7Gg7vF4vpmggWP5MU70QO6,10,8,1,2,3,1,4,0,19,2.7142857142857144,1,0.0,3,1,1,3,5,1,1,4,0,8,11,0
12628,113206,6Ricds2xdJuml6Uu7KDw8pScpGwqxOl3,7GRhBDsirIGkRZBtSMEzNTyDr2JQm4xx,29,25,17,0,18,6,2,0,68,9.714285714285714,1,0.0,6,17,0,18,19,6,0,2,0,41,27,0
12629,113225,Ti1mRNlEpadfQjVYDTXYfmLfMF1Sn1O7,7GRhBDsirIGkRZBtSMEzNTyDr2JQm4xx,1,0,0,0,0,0,1,0,1,0.14285714285714285,1,0.0,0,0,0,0,0,0,0,1,0,0,1,1
12630,113226,CozZoSX7AwprtwyJFCAeFUYiCq7OSEAP,7GRhBDsirIGkRZBtSMEzNTyDr2JQm4xx,5,3,1,0,1,0,2,0,7,1.0,1,0.0,0,1,0,1,3,0,0,2,0,2,5,1
12631,113235,nrpTW24MJzbUltV0JUN1fQU4Pmhy2MGS,7GRhBDsirIGkRZBtSMEzNTyDr2JQm4xx,26,44,14,16,11,0,4,0,89,12.714285714285714,1,0.0,19,14,10,11,25,0,6,4,0,54,35,1
12632,113252,qOmxvQ0HKFl7XBqTlqvTjsKLJmmvzb5K,7GRhBDsirIGkRZBtSMEzNTyDr2JQm4xx,2,0,0,0,0,0,4,0,4,0.5714285714285714,1,0.0,0,0,0,0,0,0,0,4,0,0,4,1
12633,113262,H87RUeQNyhaDy48siaXFyvv7ZcvBw8DO,7GRhBDsirIGkRZBtSMEzNTyDr2JQm4xx,6,8,2,0,0,0,3,0,13,1.8571428571428572,2,0.0,0,2,0,0,8,0,0,3,0,2,11,1
12634,113266,SaJRa20OXDY1LCrTPWwAL4qw1OJoFlxd,7GRhBDsirIGkRZBtSMEzNTyDr2JQm4xx,1,0,0,0,0,0,1,0,1,0.14285714285714285,1,0.0,0,0,0,0,0,0,0,1,0,0,1,0
12635,113320,GZo3DRTrJrKQ66RAXkSmxAsw7hv4e5Em,3VkHkmOtom3jM2wCu94xgzzu1d6Dn7or,1,0,0,0,0,0,1,0,1,0.14285714285714285,1,0.0,0,0,0,0,0,0,0,1,0,0,1,1
12636,113356,aZXiEqViR3mJZWuUJRzqAX6Y8grPJzee,3VkHkmOtom3jM2wCu94xgzzu1d6Dn7or,1,0,0,0,0,0,1,0,1,0.14285714285714285,1,0.0,0,0,0,0,0,0,0,1,0,0,1,1
12637,113462,6OR4dT3Nn7HJnm7QL3Pb9sooW2RNywP3,3VkHkmOtom3jM2wCu94xgzzu1d6Dn7or,7,2,1,0,1,1,4,1,10,1.4285714285714286,1,0.0,0,1,0,1,2,1,0,4,1,2,8,1
12638,113500,7BLnGPURyobb1iQ7BErODo6F6LhxSiyD,3VkHkmOtom3jM2wCu94xgzzu1d6Dn7or,1,0,0,0,0,0,1,0,1,0.14285714285714285,1,0.0,0,0,0,0,0,0,0,1,0,0,1,1
12639,113530,zhBulUMBBoq03Uyq0sJ23dOYU92V48SU,3VkHkmOtom3jM2wCu94xgzzu1d6Dn7or,1,0,0,0,0,0,2,0,2,0.2857142857142857,1,0.0,0,0,0,0,0,0,0,2,0,0,2,1
12640,113549,AOy0e5xukkmuYjWQEwT6UCwFma8jpz06,3VkHkmOtom3jM2wCu94xgzzu1d6Dn7or,1,0,0,0,0,0,1,0,1,0.14285714285714285,1,0.0,0,0,0,0,0,0,0,1,0,0,1,1
12641,113591,U7btMcQ825kheRskgLUndnBUWWFj60BC,3VkHkmOtom3jM2wCu94xgzzu1d6Dn7or,4,2,1,0,1,0,2,0,6,0.8571428571428571,1,0.0,0,1,0,1,2,0,0,2,0,2,4,1
12642,113619,LBLEODXfAs2lWDhUZeileXIBJRAYli0D,3VkHkmOtom3jM2wCu94xgzzu1d6Dn7or,1,0,0,0,0,0,1,0,1,0.14285714285714285,1,0.0,0,0,0,0,0,0,0,1,0,0,1,1
12643,113628,etuo6daiaaiJHCZ5OnshEtxiyNmRPrTP,3VkHkmOtom3jM2wCu94xgzzu1d6Dn7or,1,0,0,0,0,0,1,0,1,0.14285714285714285,1,0.0,0,0,0,0,0,0,0,1,0,0,1,1
12644,113632,bKSoZprZeBDowFRoIULA1b2XoCUkEzgH,3VkHkmOtom3jM2wCu94xgzzu1d6Dn7or,63,139,37,116,46,14,24,5,381,54.42857142857143,3,0.0,80,37,107,46,59,14,9,24,5,270,111,1
12645,113639,FM7f8SmryrQv0xQWmeGBOm7E9JzAE7cF,3VkHkmOtom3jM2wCu94xgzzu1d6Dn7or,5,8,5,0,4,4,2,0,23,3.2857142857142856,1,0.0,0,5,0,4,8,4,0,2,0,9,14,0
12646,113667,rHOAxnJnHgkkXAMAFdEP673yAyMeWMLn,3VkHkmOtom3jM2wCu94xgzzu1d6Dn7or,4,2,1,0,1,0,1,0,5,0.7142857142857143,1,0.0,0,1,0,1,2,0,0,1,0,2,3,1
12647,113694,41ih6CMV0Q2tNC5jteIa8qH706Arp4mA,3VkHkmOtom3jM2wCu94xgzzu1d6Dn7or,9,14,2,0,1,1,4,0,22,3.142857142857143,1,0.0,0,2,0,1,14,1,0,4,0,3,19,1
12648,113712,eaeORohb7wCQL9JM2uz3yah8DgLbswAx,3VkHkmOtom3jM2wCu94xgzzu1d6Dn7or,1,0,0,0,0,0,1,0,1,0.14285714285714285,1,0.0,0,0,0,0,0,0,0,1,0,0,1,1
12649,113714,llD0tqUyYHnKGenR1CzxVCYD7wYYCHxa,3VkHkmOtom3jM2wCu94xgzzu1d6Dn7or,6,4,1,0,2,0,7,0,14,2.0,1,0.0,2,1,0,2,2,0,0,7,0,5,9,1
12650,113765,if1RYQQ7Cj29ACdlqQKKzjcriFn3O4s7,3VkHkmOtom3jM2wCu94xgzzu1d6Dn7or,9,4,3,0,2,6,9,5,29,4.142857142857143,1,0.0,0,3,0,2,4,6,0,9,5,5,24,1
12651,113766,g9NnaN8zicHlHIabvjQkRDXqY5W7SH9D,3VkHkmOtom3jM2wCu94xgzzu1d6Dn7or,1,0,0,0,0,0,1,0,1,0.14285714285714285,1,0.0,0,0,0,0,0,0,0,1,0,0,1,1
12652,113825,xUhDcXiX03QQg1jNR3Lksh9CrGcRUkPg,7GRhBDsirIGkRZBtSMEzNTyDr2JQm4xx,38,83,3,20,11,14,20,0,151,21.571428571428573,9,0.0,29,3,12,11,54,14,8,20,0,55,96,0
12653,113845,EwpbggvNdZkeSTjdG48aEltlJYavm02s,7GRhBDsirIGkRZBtSMEzNTyDr2JQm4xx,4,2,1,0,1,0,1,0,5,0.7142857142857143,1,0.0,0,1,0,1,2,0,0,1,0,2,3,1
12654,113846,7hhGe4WcGEHypOzIVz3DLRx9GS52ozkE,7GRhBDsirIGkRZBtSMEzNTyDr2JQm4xx,40,59,25,58,16,0,7,0,165,23.571428571428573,5,0.0,26,25,51,16,33,0,7,7,0,118,47,1
12655,113870,iqeO8OrE0ZCrWK6qDgxXq3GlMxXdM9nN,5X6FeZozNMgE2VRi3MJYjkkFK8SETtu2,2,0,0,0,0,0,2,0,2,0.2857142857142857,1,0.0,0,0,0,0,0,0,0,2,0,0,2,1
12656,113935,nDRvdnRCphlivJCuFTuhDKgd5jyHoHuK,7GRhBDsirIGkRZBtSMEzNTyDr2JQm4xx,119,348,172,195,82,7,54,1,859,122.71428571428571,20,0.0,127,172,162,82,221,7,33,54,1,543,316,0
12657,113951,dgFOOUSNfQK8xIrT47Av0Q04bBFeE21W,5X6FeZozNMgE2VRi3MJYjkkFK8SETtu2,5,2,1,0,1,0,3,0,7,1.0,2,0.0,0,1,0,1,2,0,0,3,0,2,5,0
12658,113957,JoqAGqbao71wc04PyVzx7SVvlZZ0knbI,7GRhBDsirIGkRZBtSMEzNTyDr2JQm4xx,35,103,31,58,7,14,17,0,230,32.857142857142854,4,0.0,49,31,54,7,54,14,4,17,0,141,89,1
12659,113967,BS42tQ4M7qxE2fbtH53iTeEQofO2Q5YM,5X6FeZozNMgE2VRi3MJYjkkFK8SETtu2,2,0,0,0,0,0,3,0,3,0.42857142857142855,1,0.0,0,0,0,0,0,0,0,3,0,0,3,1
12660,114029,B7LHt2Cj2bBAHJSILTk3b5ZvfNYywzep,7GRhBDsirIGkRZBtSMEzNTyDr2JQm4xx,9,6,3,0,1,0,5,0,15,2.142857142857143,1,0.0,1,3,0,1,5,0,0,5,0,5,10,1
12661,114030,7G7gGwBiR8PZ9BGrK3UBdOy5b5BxYw0z,5X6FeZozNMgE2VRi3MJYjkkFK8SETtu2,1,0,0,0,0,0,1,0,1,0.14285714285714285,1,0.0,0,0,0,0,0,0,0,1,0,0,1,1
12662,114045,40f11BuizcEv7ZFFxcPqa0v1O1iUUbkI,7GRhBDsirIGkRZBtSMEzNTyDr2JQm4xx,7,9,5,0,2,0,3,0,19,2.7142857142857144,3,0.0,1,5,0,2,8,0,0,3,0,8,11,1
12663,114118,hNtOw8NhFSEVmWVm0uZ7niVIy1y64lqK,7GRhBDsirIGkRZBtSMEzNTyDr2JQm4xx,4,0,0,0,0,0,11,0,11,1.5714285714285714,3,0.0,0,0,0,0,0,0,0,11,0,0,11,1
12664,114136,tkUa5CpArdCreqMyzIcAuTFrrxiEVJbS,7GRhBDsirIGkRZBtSMEzNTyDr2JQm4xx,38,44,19,34,14,15,14,0,140,20.0,3,0.0,22,19,29,14,22,15,5,14,0,84,56,1
12665,114140,nUWkRuhBy34ASlaPMCQ75Oelnn64cfdy,7GRhBDsirIGkRZBtSMEzNTyDr2JQm4xx,63,218,78,50,64,41,27,2,480,68.57142857142857,5,0.0,124,78,40,64,94,41,10,27,2,306,174,0
12666,114147,okqN4nBVKRYYrkYonKicKGOmPqVGYjZh,7GRhBDsirIGkRZBtSMEzNTyDr2JQm4xx,4,3,1,0,0,0,4,0,8,1.1428571428571428,2,0.0,0,1,0,0,3,0,0,4,0,1,7,0
12667,114179,QZbPGbTnAqz8GS6cm25XcpeiETovvLN6,7GRhBDsirIGkRZBtSMEzNTyDr2JQm4xx,110,241,55,175,57,9,40,1,578,82.57142857142857,6,0.0,122,55,138,57,119,9,37,40,1,372,206,0
12668,114195,KkSinTdG2PbGrJIRATMZos8HES46UawO,5X6FeZozNMgE2VRi3MJYjkkFK8SETtu2,15,34,12,0,9,0,4,0,59,8.428571428571429,4,0.0,6,12,0,9,28,0,0,4,0,27,32,1
12669,114202,BYMia6rYyVXQ3hTTY2SW71awypyGQmbs,5X6FeZozNMgE2VRi3MJYjkkFK8SETtu2,1,0,0,0,0,0,1,0,1,0.14285714285714285,1,0.0,0,0,0,0,0,0,0,1,0,0,1,1
12670,114255,dtcl5eI6yhwMyoweqshgFuTzKqFJQm0u,7GRhBDsirIGkRZBtSMEzNTyDr2JQm4xx,2,0,0,0,0,0,3,0,3,0.42857142857142855,1,0.0,0,0,0,0,0,0,0,3,0,0,3,1
12671,114272,C8zDhaG0vPsQegBtS55u3JZHiYuueFnE,5X6FeZozNMgE2VRi3MJYjkkFK8SETtu2,14,28,1,25,11,0,14,0,79,11.285714285714286,12,0.0,20,1,21,11,8,0,4,14,0,53,26,0
12672,114281,L7NMY402u880Duf2mPDRyP0UpxBO5z2o,5X6FeZozNMgE2VRi3MJYjkkFK8SETtu2,2,0,0,0,0,0,3,0,3,0.42857142857142855,1,0.0,0,0,0,0,0,0,0,3,0,0,3,0
12673,114289,yt0pMjWs1WUyd9gdp8SqXOjWyU58K3uA,7GRhBDsirIGkRZBtSMEzNTyDr2JQm4xx,2,0,0,0,0,0,2,0,2,0.2857142857142857,2,0.0,0,0,0,0,0,0,0,2,0,0,2,1
12674,114304,8vfANOlVROv1BVu6W9lu5Apf2MGCVpIn,5X6FeZozNMgE2VRi3MJYjkkFK8SETtu2,76,216,88,0,138,2,24,2,470,67.14285714285714,7,0.0,107,88,0,138,109,2,0,24,2,333,137,0
12675,114349,HHtkMPGPD7M5HjKp2cITsAXThUPUGeqi,7GRhBDsirIGkRZBtSMEzNTyDr2JQm4xx,49,141,49,101,34,10,14,0,349,49.857142857142854,5,0.0,68,49,88,34,73,10,13,14,0,239,110,1
12676,114404,RrDvHNy910b7XxqIkvHWSamS4IG3fgCH,7GRhBDsirIGkRZBtSMEzNTyDr2JQm4xx,1,0,0,0,0,0,1,0,1,0.14285714285714285,1,0.0,0,0,0,0,0,0,0,1,0,0,1,1
12677,114429,NEVPUSDkU7HaE7xRESmGkn6KaWhWlNDH,7GRhBDsirIGkRZBtSMEzNTyDr2JQm4xx,11,19,4,51,0,0,1,0,75,10.714285714285714,1,0.0,14,4,44,0,5,0,7,1,0,62,13,1
12678,114458,hu8eak1Xmf8voE8pnxPzkSD2dZP9Sipf,7GRhBDsirIGkRZBtSMEzNTyDr2JQm4xx,56,45,0,75,0,4,25,0,149,21.285714285714285,6,0.0,28,0,75,0,17,4,0,25,0,103,46,0
12679,114460,gBUQvhjVwGtG2bUGFkuQNt86DA2hmTm5,7GRhBDsirIGkRZBtSMEzNTyDr2JQm4xx,57,194,104,64,62,3,43,3,473,67.57142857142857,6,0.0,79,104,54,62,115,3,10,43,3,299,174,1
12680,114473,AifTjiD8gsxdxahWngXjdMDduP2s4vuX,5X6FeZozNMgE2VRi3MJYjkkFK8SETtu2,4,3,2,0,0,0,5,0,10,1.4285714285714286,2,0.0,0,2,0,0,3,0,0,5,0,2,8,1
12681,114491,MU4dVyJTD7iIRSTZIdJZ9VoLOxogfKQN,7GRhBDsirIGkRZBtSMEzNTyDr2JQm4xx,4,2,1,0,1,0,1,0,5,0.7142857142857143,1,0.0,0,1,0,1,2,0,0,1,0,2,3,1
12682,114492,oxOzo82Nq65tcwE6AZvxglw3lN8SeywJ,7GRhBDsirIGkRZBtSMEzNTyDr2JQm4xx,5,2,1,0,1,0,2,0,6,0.8571428571428571,1,0.0,0,1,0,1,2,0,0,2,0,2,4,1
12683,114508,DahdU3m64q9GHbzMvs6TdHVFTDo4asbt,7GRhBDsirIGkRZBtSMEzNTyDr2JQm4xx,16,11,7,6,4,12,32,6,78,11.142857142857142,3,0.0,1,7,5,4,10,12,1,32,6,17,61,0
12684,114521,sbaJoVFlMLyfg1PbRG67GWzU7ygSqHEa,5X6FeZozNMgE2VRi3MJYjkkFK8SETtu2,8,10,2,5,3,0,2,0,22,3.142857142857143,2,0.0,4,2,5,3,6,0,0,2,0,14,8,1
12685,114528,Ykpl4oTagCTFKge3GXTMoB9qSHG2mG7d,5X6FeZozNMgE2VRi3MJYjkkFK8SETtu2,17,13,10,0,6,0,5,0,34,4.857142857142857,3,0.0,0,10,0,6,13,0,0,5,0,16,18,1
12686,114536,BIrtFqgMfUNvzbgStoEGnPt5I5Uav700,7GRhBDsirIGkRZBtSMEzNTyDr2JQm4xx,1,0,0,0,0,0,1,0,1,0.14285714285714285,1,0.0,0,0,0,0,0,0,0,1,0,0,1,1
12687,114546,CKlPS4aJNSCYcpmTEnTkXSXKz4jn8q0W,7GRhBDsirIGkRZBtSMEzNTyDr2JQm4xx,2,0,0,0,0,0,2,0,2,0.2857142857142857,1,0.0,0,0,0,0,0,0,0,2,0,0,2,1
12688,114551,dDY6syRWP8OTI4q5NbhQb8dXKkVppYZH,5X6FeZozNMgE2VRi3MJYjkkFK8SETtu2,16,19,1,7,5,0,4,0,36,5.142857142857143,2,0.0,7,1,7,5,12,0,0,4,0,20,16,1
12689,114557,rqwp0DRxlrzViX8K4jHTHKpfYZPPmBwb,5X6FeZozNMgE2VRi3MJYjkkFK8SETtu2,1,0,0,0,0,0,1,0,1,0.14285714285714285,1,0.0,0,0,0,0,0,0,0,1,0,0,1,1
12690,114562,BQSRjVmgixA5nv8k53vKwJ20bVp0NOMd,7GRhBDsirIGkRZBtSMEzNTyDr2JQm4xx,103,143,50,159,45,153,32,2,584,83.42857142857143,8,0.0,75,50,132,45,68,153,27,32,2,302,282,0
12691,114593,TDZqTAe3O03535EQlgLT4WJkveLsaPmx,5X6FeZozNMgE2VRi3MJYjkkFK8SETtu2,127,171,21,283,7,2,32,0,516,73.71428571428571,7,0.0,107,21,240,7,64,2,43,32,0,375,141,0
12692,114597,rwCHpAN1sY0GvFYG7zQQk2qpgkOBz9O3,7GRhBDsirIGkRZBtSMEzNTyDr2JQm4xx,1,0,0,0,0,0,1,0,1,0.14285714285714285,1,0.0,0,0,0,0,0,0,0,1,0,0,1,1
12693,114609,niCmhuSfQsMKGJA13iBf3xqhHudkRRY5,fbPkOYLVPtPgIt0MxizjfFJov3JbHyAi,10,17,8,0,5,3,19,0,52,7.428571428571429,3,0.0,0,8,0,5,17,3,0,19,0,13,39,0
12694,114610,TdYcFi1KMH5omMcyptxlDLiiNNaCOGVb,fbPkOYLVPtPgIt0MxizjfFJov3JbHyAi,5,2,1,0,1,0,2,0,6,0.8571428571428571,1,0.0,0,1,0,1,2,0,0,2,0,2,4,1
12695,114611,5x7PJKAlpwjJHVKa6EUCDUMMHmJ1P3I6,fbPkOYLVPtPgIt0MxizjfFJov3JbHyAi,7,3,2,0,2,0,5,0,12,1.7142857142857142,2,0.0,0,2,0,2,3,0,0,5,0,4,8,1
12696,114612,AnYK2hcpzbjzweqfPwn38soHYvfmjroU,fbPkOYLVPtPgIt0MxizjfFJov3JbHyAi,1,0,0,0,0,0,1,0,1,0.14285714285714285,1,0.0,0,0,0,0,0,0,0,1,0,0,1,0
12697,114613,ov7BYx7M6nQf9HtywUVu0CvVUbJ2cMz9,fbPkOYLVPtPgIt0MxizjfFJov3JbHyAi,7,8,6,0,7,1,4,0,26,3.7142857142857144,3,0.0,0,6,0,7,8,1,0,4,0,13,13,1
12698,114614,dwc3sSLydjXkCgUI09xxNoTdGXTiIq3c,fbPkOYLVPtPgIt0MxizjfFJov3JbHyAi,8,5,3,0,2,0,12,0,22,3.142857142857143,1,0.0,0,3,0,2,5,0,0,12,0,5,17,1
12699,114617,uY0DbkhjMuOAkJCfucw0j5EqP7OIItJS,fbPkOYLVPtPgIt0MxizjfFJov3JbHyAi,16,8,5,4,4,2,7,1,31,4.428571428571429,1,0.0,2,5,3,4,6,2,1,7,1,14,17,1
12700,114619,rK6VIj3YtKNLNkhFEFptdAOiC1zWzKSs,fbPkOYLVPtPgIt0MxizjfFJov3JbHyAi,1,0,0,0,0,0,1,0,1,0.14285714285714285,1,0.0,0,0,0,0,0,0,0,1,0,0,1,1
12701,114621,JeQPL0r0OGbw8HdzB8rTDyc7qvYZbjuq,fbPkOYLVPtPgIt0MxizjfFJov3JbHyAi,2,0,0,0,0,0,6,0,6,0.8571428571428571,1,0.0,0,0,0,0,0,0,0,6,0,0,6,1
12702,114622,whDoakw9KuyWQ8M0W7cddKOMydB0d6nf,fbPkOYLVPtPgIt0MxizjfFJov3JbHyAi,19,42,16,8,20,20,10,0,116,16.571428571428573,3,0.0,20,16,6,20,22,20,2,10,0,62,54,1
12703,114623,lltPVpQeb3LNlctUlWfa8Q4MhniSz7KE,fbPkOYLVPtPgIt0MxizjfFJov3JbHyAi,1,0,0,0,0,0,1,0,1,0.14285714285714285,1,0.0,0,0,0,0,0,0,0,1,0,0,1,0
12704,114624,LoCOszuIzTSeaWLSvGsGNoO7BQacUJ26,fbPkOYLVPtPgIt0MxizjfFJov3JbHyAi,14,12,7,0,7,0,1,0,27,3.857142857142857,1,0.0,0,7,0,7,12,0,0,1,0,14,13,1
12705,114625,z5b37rtZXpcAYDG2omaxcs76JrGc20dV,fbPkOYLVPtPgIt0MxizjfFJov3JbHyAi,10,10,3,0,5,0,4,0,22,3.142857142857143,1,0.0,6,3,0,5,4,0,0,4,0,14,8,1
12706,114626,6tmxpsRtsjoDY9zXnzo3i4nW1oQa44E2,fbPkOYLVPtPgIt0MxizjfFJov3JbHyAi,7,5,3,0,0,0,5,0,13,1.8571428571428572,2,0.0,1,3,0,0,4,0,0,5,0,4,9,0
12707,114627,uKuE1pqPLKBLlaDHpMsHUJvLz6lxiokY,fbPkOYLVPtPgIt0MxizjfFJov3JbHyAi,21,38,20,0,16,0,7,0,81,11.571428571428571,4,0.0,0,20,0,16,38,0,0,7,0,36,45,1
12708,114629,9U8eq2wcLu6mgVxnBD4EHfzYamgCvE9F,fbPkOYLVPtPgIt0MxizjfFJov3JbHyAi,1,0,0,0,0,0,1,0,1,0.14285714285714285,1,0.0,0,0,0,0,0,0,0,1,0,0,1,1
12709,114633,KbfT30uvubax3lKEct6iblV8VhlPaIEn,fbPkOYLVPtPgIt0MxizjfFJov3JbHyAi,1,0,0,0,0,0,1,0,1,0.14285714285714285,1,0.0,0,0,0,0,0,0,0,1,0,0,1,1
12710,114634,5MFqn51ngpNJRILTITSLFdc469nefTuS,fbPkOYLVPtPgIt0MxizjfFJov3JbHyAi,10,9,5,0,3,4,9,2,32,4.571428571428571,2,0.0,2,5,0,3,7,4,0,9,2,10,22,1
12711,114635,J83msrPq5aEXLkbsBsIQs6LqQS1iTroR,fbPkOYLVPtPgIt0MxizjfFJov3JbHyAi,9,4,3,0,3,0,2,0,12,1.7142857142857142,1,0.0,0,3,0,3,4,0,0,2,0,6,6,0
12712,114637,tcp1waH3lybh7mEbOxmBUMGzEZXMKD2w,fbPkOYLVPtPgIt0MxizjfFJov3JbHyAi,3,0,0,0,0,4,2,0,6,0.8571428571428571,1,0.0,0,0,0,0,0,4,0,2,0,0,6,1
12713,114638,se1kyJ0KlduEpFVfhZokiqY2YgGqJGe8,fbPkOYLVPtPgIt0MxizjfFJov3JbHyAi,1,0,0,0,0,0,2,0,2,0.2857142857142857,1,0.0,0,0,0,0,0,0,0,2,0,0,2,1
12714,114639,IXyECojptU5NkfL9RFdtwIRy87m56pw9,fbPkOYLVPtPgIt0MxizjfFJov3JbHyAi,46,172,80,66,38,69,94,27,546,78.0,17,0.0,49,80,42,38,123,69,24,94,27,209,337,1
12715,114640,1HR58VcPK4IMS1mKcNg7SfwEfj1z1o5o,fbPkOYLVPtPgIt0MxizjfFJov3JbHyAi,4,5,1,0,0,0,1,0,7,1.0,1,0.0,0,1,0,0,5,0,0,1,0,1,6,1
12716,114642,zHjd9VGEAzcUjGnFtT4ddyUTp3lS93oc,fbPkOYLVPtPgIt0MxizjfFJov3JbHyAi,4,2,0,0,0,0,2,0,4,0.5714285714285714,1,0.0,0,0,0,0,2,0,0,2,0,0,4,1
12717,114643,WfE8YobKj49KJJchFTR0mkLGdZ0KFFcq,fbPkOYLVPtPgIt0MxizjfFJov3JbHyAi,7,3,2,0,2,6,4,0,17,2.4285714285714284,2,0.0,0,2,0,2,3,6,0,4,0,4,13,1
12718,114645,vBRVRWgAePdcgjHkXuejXMzthEVUxEVX,fbPkOYLVPtPgIt0MxizjfFJov3JbHyAi,5,2,1,0,1,3,4,0,11,1.5714285714285714,1,0.0,0,1,0,1,2,3,0,4,0,2,9,1
12719,114647,bEEMkJ0I54PCyK7ibWoXvwgZk08IOlqP,fbPkOYLVPtPgIt0MxizjfFJov3JbHyAi,5,2,1,0,1,0,2,0,6,0.8571428571428571,1,0.0,0,1,0,1,2,0,0,2,0,2,4,0
12720,114649,Y9tBhsfrr3ypg5AH5wcQ2oUkdhoSd6DM,fbPkOYLVPtPgIt0MxizjfFJov3JbHyAi,6,5,2,0,2,0,4,0,13,1.8571428571428572,1,0.0,0,2,0,2,5,0,0,4,0,4,9,1
12721,114651,7x51V9V9eIHFPqiYUnOLpACvWY55pqZF,fbPkOYLVPtPgIt0MxizjfFJov3JbHyAi,1,0,0,0,0,0,1,0,1,0.14285714285714285,1,0.0,0,0,0,0,0,0,0,1,0,0,1,1
12722,114652,wuaIkUodYTr49NZ7BbMPsEdpO0t0C8Nt,fbPkOYLVPtPgIt0MxizjfFJov3JbHyAi,26,50,1,15,3,4,16,0,89,12.714285714285714,5,0.0,11,1,12,3,39,4,3,16,0,27,62,1
12723,115160,fieyLvxxnJDCWWusdelrijbwpRBWtEpl,3VkHkmOtom3jM2wCu94xgzzu1d6Dn7or,53,107,30,37,31,41,13,0,259,37.0,8,0.0,57,30,35,31,50,41,2,13,0,153,106,1
12724,115173,QvRGOqLSyf5dfsZjPsCzMC3zwxe6tcsy,3VkHkmOtom3jM2wCu94xgzzu1d6Dn7or,76,219,54,54,64,2,35,0,428,61.142857142857146,9,0.0,97,54,49,64,122,2,5,35,0,264,164,0
12725,115174,RovL92vHmNPAy9rTXXm11cTDRwS4wiTZ,3VkHkmOtom3jM2wCu94xgzzu1d6Dn7or,12,12,7,0,5,0,5,0,29,4.142857142857143,2,0.0,0,7,0,5,12,0,0,5,0,12,17,0
12726,115185,P5LB9o4LFc5VzoLgvlYgneakbDE98ytK,3VkHkmOtom3jM2wCu94xgzzu1d6Dn7or,12,17,9,0,5,3,11,5,50,7.142857142857143,1,0.0,3,9,0,5,14,3,0,11,5,17,33,1
12727,115223,OaC3DR2iMODztyfFlezZcG5ZWLBbZoY5,3VkHkmOtom3jM2wCu94xgzzu1d6Dn7or,64,78,23,98,26,20,7,1,253,36.142857142857146,3,0.0,45,23,88,26,33,20,10,7,1,182,71,0
12728,115230,ng6ocRbrVitvQVTJnsnrNknwr1N4z9ik,3VkHkmOtom3jM2wCu94xgzzu1d6Dn7or,31,75,44,0,0,6,25,1,151,21.571428571428573,8,0.0,7,44,0,0,68,6,0,25,1,51,100,0
12729,115289,L7NaJm2W9meokaZSy7jbmVKaCuuQajnz,3VkHkmOtom3jM2wCu94xgzzu1d6Dn7or,87,126,64,56,58,3,43,1,351,50.142857142857146,10,0.0,50,64,48,58,76,3,8,43,1,220,131,0
12730,115310,UOMNuth7w3HbS8GZxzACBwQ58GIkOnsC,3VkHkmOtom3jM2wCu94xgzzu1d6Dn7or,87,222,97,58,75,47,59,1,559,79.85714285714286,11,0.0,71,97,55,75,151,47,3,59,1,298,261,0
12731,115313,YfHmALaAUVJkTXPVPoa3sijNQuWgYS7R,3VkHkmOtom3jM2wCu94xgzzu1d6Dn7or,91,488,101,124,159,42,27,0,941,134.42857142857142,7,0.0,345,101,124,159,143,42,0,27,0,729,212,0
12732,115314,M93tH8gbLG5lH6yh5TZ5PcBqNoDrcmIM,3VkHkmOtom3jM2wCu94xgzzu1d6Dn7or,1,0,0,0,0,0,2,0,2,0.2857142857142857,1,0.0,0,0,0,0,0,0,0,2,0,0,2,1
12733,115454,wxOgTM0U8atO7FTCY8VhNuh0fylTpPFX,3VkHkmOtom3jM2wCu94xgzzu1d6Dn7or,1,0,0,0,0,0,1,0,1,0.14285714285714285,1,0.0,0,0,0,0,0,0,0,1,0,0,1,1
12734,115464,jQGozXgCDEtih8n0QNDjwOxHGubLTjEt,3VkHkmOtom3jM2wCu94xgzzu1d6Dn7or,1,0,0,0,0,0,1,0,1,0.14285714285714285,1,0.0,0,0,0,0,0,0,0,1,0,0,1,1
12735,115473,dnl7OTY17jTVZKBUz2oGzV5ZgMtZUzyw,3VkHkmOtom3jM2wCu94xgzzu1d6Dn7or,1,0,0,0,0,0,1,0,1,0.14285714285714285,1,0.0,0,0,0,0,0,0,0,1,0,0,1,1
12736,115475,TXo0CCOBoSUl3sGr1fGqVDX7GLiPHTPL,3VkHkmOtom3jM2wCu94xgzzu1d6Dn7or,10,50,16,0,1,0,7,0,74,10.571428571428571,4,0.0,8,16,0,1,42,0,0,7,0,25,49,1
12737,115528,Ewi0j7dXy4kTOaWpRDWlB9pPIpAe1PlV,3VkHkmOtom3jM2wCu94xgzzu1d6Dn7or,7,6,4,0,3,0,2,0,15,2.142857142857143,1,0.0,0,4,0,3,6,0,0,2,0,7,8,0
12738,115539,Zxs1RumGHONRCjjtlqlZeQ4V6CgOxVWH,3VkHkmOtom3jM2wCu94xgzzu1d6Dn7or,36,55,24,0,14,3,8,0,104,14.857142857142858,4,0.0,1,24,0,14,54,3,0,8,0,39,65,0
12739,115547,RAMomgZ0L1bKGCOyYy2Aq7TrXqd2gODP,3VkHkmOtom3jM2wCu94xgzzu1d6Dn7or,1,0,0,0,0,0,1,0,1,0.14285714285714285,1,0.0,0,0,0,0,0,0,0,1,0,0,1,1
12740,115554,IjhWPxQ0FPkozhZrQzWjblIBOwZLOTam,3VkHkmOtom3jM2wCu94xgzzu1d6Dn7or,4,3,1,0,1,0,2,0,7,1.0,1,0.0,0,1,0,1,3,0,0,2,0,2,5,1
12741,115571,NaR3qnAVE7AtsDMIfQuAkTqOCgLrJLZR,3VkHkmOtom3jM2wCu94xgzzu1d6Dn7or,8,13,6,7,3,0,6,0,35,5.0,3,0.0,4,6,6,3,9,0,1,6,0,19,16,1
12742,115605,rA6mPEjcnShXmHCoEHgThQ4NwtVmX6Le,3VkHkmOtom3jM2wCu94xgzzu1d6Dn7or,53,221,61,39,34,21,24,0,400,57.142857142857146,9,0.0,80,61,37,34,141,21,2,24,0,212,188,0
12743,115617,nWedGV2Cyz7b86zoWjyUJZtraXV6YlYz,3VkHkmOtom3jM2wCu94xgzzu1d6Dn7or,63,191,85,43,33,22,59,7,440,62.857142857142854,11,0.0,55,85,36,33,136,22,7,59,7,209,231,0
12744,115644,qyZKoOVKnXPt3uf5QoNCxiu3qBc2a5qN,3VkHkmOtom3jM2wCu94xgzzu1d6Dn7or,9,4,3,0,3,0,2,0,12,1.7142857142857142,1,0.0,0,3,0,3,4,0,0,2,0,6,6,1
12745,115675,q5YNxgDFMK1d6eLl2o5B3rP2xueUu1iW,3VkHkmOtom3jM2wCu94xgzzu1d6Dn7or,2,0,0,0,0,0,2,0,2,0.2857142857142857,1,0.0,0,0,0,0,0,0,0,2,0,0,2,1
12746,115678,siN9paTuwgso6C2nIU0pfTpI5zIA7vHg,3VkHkmOtom3jM2wCu94xgzzu1d6Dn7or,64,159,39,73,57,79,21,1,429,61.285714285714285,5,0.0,99,39,70,57,60,79,3,21,1,265,164,0
12747,115688,GgocYHg42QPeXhj3QB7FBVGJqSqHh2yN,3VkHkmOtom3jM2wCu94xgzzu1d6Dn7or,5,4,2,0,0,0,3,0,9,1.2857142857142858,2,0.0,0,2,0,0,4,0,0,3,0,2,7,1
12748,115711,jSWOpyuViewWJZcv27YxPk4V4lgmow6e,3VkHkmOtom3jM2wCu94xgzzu1d6Dn7or,1,0,0,0,0,0,1,0,1,0.14285714285714285,1,0.0,0,0,0,0,0,0,0,1,0,0,1,1
12749,115714,AlSHpBPHRrLS1g39eFf9IIaZAAADponU,3VkHkmOtom3jM2wCu94xgzzu1d6Dn7or,1,0,0,0,0,0,1,0,1,0.14285714285714285,1,0.0,0,0,0,0,0,0,0,1,0,0,1,1
12750,115717,EP1XQRGS4HZOG1hdGzNZdD1HFhJcHpos,3VkHkmOtom3jM2wCu94xgzzu1d6Dn7or,64,126,66,38,43,52,30,4,359,51.285714285714285,9,0.0,39,66,34,43,87,52,4,30,4,182,177,0
12751,115760,va3cVfF38XAjn4LEh6VxTTEdlP5IupZ2,3VkHkmOtom3jM2wCu94xgzzu1d6Dn7or,1,0,0,0,0,0,1,0,1,0.14285714285714285,1,0.0,0,0,0,0,0,0,0,1,0,0,1,1
12752,115764,63cvDQWg2vpRGVS0xYd9KphyyRDSd34N,3VkHkmOtom3jM2wCu94xgzzu1d6Dn7or,30,70,24,33,26,13,16,1,183,26.142857142857142,4,0.0,35,24,27,26,35,13,6,16,1,112,71,1
12753,115766,5EOGhyHOLLtbW0eEa8Dnfl5My4kdYkdc,3VkHkmOtom3jM2wCu94xgzzu1d6Dn7or,27,51,27,4,17,0,15,0,114,16.285714285714285,9,0.0,8,27,4,17,43,0,0,15,0,56,58,1
12754,115767,cnUUxohEmTFV5DSw4q1r5dj1vGWSh7Y1,3VkHkmOtom3jM2wCu94xgzzu1d6Dn7or,12,22,8,0,6,5,10,4,55,7.857142857142857,2,0.0,8,8,0,6,14,5,0,10,4,22,33,1
12755,115807,epcWGQ9GUW4vRbY9walvIeEIlc9Z11Wh,3VkHkmOtom3jM2wCu94xgzzu1d6Dn7or,4,0,0,0,0,0,6,0,6,0.8571428571428571,1,0.0,0,0,0,0,0,0,0,6,0,0,6,1
12756,115913,Th6GGIKucyCokdQsUn3aOeloTzqx0Qbo,3VkHkmOtom3jM2wCu94xgzzu1d6Dn7or,34,40,23,6,18,14,8,0,109,15.571428571428571,3,0.0,5,23,5,18,35,14,1,8,0,51,58,1
12757,115943,YuzFD6BViIQAEul9hFT6qv6dLuFAFbcx,3VkHkmOtom3jM2wCu94xgzzu1d6Dn7or,62,214,49,68,24,21,15,0,391,55.857142857142854,3,0.0,54,49,67,24,160,21,1,15,0,194,197,0
12758,115950,5zqlBxYbrtpFVoicJGaTdh9tPhf25O6l,3VkHkmOtom3jM2wCu94xgzzu1d6Dn7or,1,0,0,0,0,0,1,0,1,0.14285714285714285,1,0.0,0,0,0,0,0,0,0,1,0,0,1,0
12759,115960,gfiPEsWR7f3Ji97wZsTMJFP52I5ZobFs,3VkHkmOtom3jM2wCu94xgzzu1d6Dn7or,78,220,81,33,66,13,93,3,509,72.71428571428571,14,0.0,105,81,30,66,115,13,3,93,3,282,227,0
12760,115978,ARN6lemNodC8v9qPjv26YnbpCElrSWA7,3VkHkmOtom3jM2wCu94xgzzu1d6Dn7or,7,2,2,0,2,0,14,0,20,2.857142857142857,4,0.0,0,2,0,2,2,0,0,14,0,4,16,0
12761,115984,SKAv0beXOQ0EXMa8AzOc39QMzerck7cn,3VkHkmOtom3jM2wCu94xgzzu1d6Dn7or,10,8,4,2,1,2,5,16,38,5.428571428571429,1,0.0,1,4,2,1,7,2,0,5,16,8,30,1
12762,115995,okqN4nBVKRYYrkYonKicKGOmPqVGYjZh,3VkHkmOtom3jM2wCu94xgzzu1d6Dn7or,48,194,88,0,23,89,108,0,502,71.71428571428571,18,0.0,7,88,0,23,187,89,0,108,0,118,384,0
12763,116051,2Vr8sMi8Nmtw7GvPlYj3ww9EzMgjDWh8,3VkHkmOtom3jM2wCu94xgzzu1d6Dn7or,55,384,157,135,0,91,47,3,817,116.71428571428571,15,0.0,127,157,129,0,257,91,6,47,3,413,404,0
12764,116065,q3JtZXXZMqccVupi0pRwWulRNmYHs0DU,3VkHkmOtom3jM2wCu94xgzzu1d6Dn7or,65,204,56,112,70,47,63,0,552,78.85714285714286,13,0.0,121,56,103,70,83,47,9,63,0,350,202,0
12765,116067,6XukKNVATWF9MVOxuIEZEYJF6xf5Cg9L,3VkHkmOtom3jM2wCu94xgzzu1d6Dn7or,4,2,1,0,1,2,1,0,7,1.0,1,0.0,0,1,0,1,2,2,0,1,0,2,5,1
12766,116070,JzTk3xaabrBX5386TjKA3UueO1OK5zNz,3VkHkmOtom3jM2wCu94xgzzu1d6Dn7or,21,26,14,0,8,5,19,4,76,10.857142857142858,2,0.0,0,14,0,8,26,5,0,19,4,22,54,0
12767,116075,VL7NPBJuyzF1uV3nhlsl7JEimjvq8BIB,3VkHkmOtom3jM2wCu94xgzzu1d6Dn7or,1,0,0,0,0,0,1,0,1,0.14285714285714285,1,0.0,0,0,0,0,0,0,0,1,0,0,1,0
12768,116082,9blpGGkQJZFtg7dx6hi9jS54S4JlZMi3,3VkHkmOtom3jM2wCu94xgzzu1d6Dn7or,1,0,0,0,0,0,1,0,1,0.14285714285714285,1,0.0,0,0,0,0,0,0,0,1,0,0,1,1
12769,116153,UgNROyPwf2puAAYe5Yv1ptkL2wZcADTj,3VkHkmOtom3jM2wCu94xgzzu1d6Dn7or,7,7,1,0,2,0,2,0,12,1.7142857142857142,1,0.0,0,1,0,2,7,0,0,2,0,3,9,1
12770,116158,FnqofvxX1Fkh4U7sknKRg4FXxgFJOsei,3VkHkmOtom3jM2wCu94xgzzu1d6Dn7or,1,0,0,0,0,0,1,0,1,0.14285714285714285,1,0.0,0,0,0,0,0,0,0,1,0,0,1,1
12771,116162,7hlZm60MDNLIaepou32eDBEODr724DEp,3VkHkmOtom3jM2wCu94xgzzu1d6Dn7or,1,0,0,0,0,0,2,0,2,0.2857142857142857,1,0.0,0,0,0,0,0,0,0,2,0,0,2,1
12772,116178,CoR4GSkh8XL90hvoWCPPEYiv8I3i4fcv,3VkHkmOtom3jM2wCu94xgzzu1d6Dn7or,4,2,1,0,0,0,2,0,5,0.7142857142857143,1,0.0,0,1,0,0,2,0,0,2,0,1,4,1
12773,116226,0w6TZDemFr3UzefPBzp6wf3wfI9EhHXJ,3VkHkmOtom3jM2wCu94xgzzu1d6Dn7or,21,20,12,24,8,2,7,0,73,10.428571428571429,4,0.0,5,12,20,8,15,2,4,7,0,45,28,0
12774,116229,IZjvzkwq6mW6mk7nIYbEArtjalxzWdW9,3VkHkmOtom3jM2wCu94xgzzu1d6Dn7or,90,118,42,75,35,20,16,0,306,43.714285714285715,4,0.0,50,42,65,35,68,20,10,16,0,192,114,1
12775,116282,8oUoNRigM4DbP8VijtlZv0utnSLvvpbA,3VkHkmOtom3jM2wCu94xgzzu1d6Dn7or,2,0,0,0,0,0,8,0,8,1.1428571428571428,4,0.0,0,0,0,0,0,0,0,8,0,0,8,0
12776,116297,03dVzxLI1AumV0kSjoDxUD9fYstLoIRm,3VkHkmOtom3jM2wCu94xgzzu1d6Dn7or,42,106,55,53,0,29,26,2,271,38.714285714285715,3,0.0,43,55,49,0,63,29,4,26,2,147,124,0
12777,116314,nYSFDE8RCbcZhD46fRSvPHUvA1ahfupi,3VkHkmOtom3jM2wCu94xgzzu1d6Dn7or,1,0,0,0,0,0,3,0,3,0.42857142857142855,1,0.0,0,0,0,0,0,0,0,3,0,0,3,0
12778,116315,D6BGxPd6VwQSrpRVLn8xLb1v6G3wH0MZ,3VkHkmOtom3jM2wCu94xgzzu1d6Dn7or,2,0,0,0,0,0,3,0,3,0.42857142857142855,2,0.0,0,0,0,0,0,0,0,3,0,0,3,1
12779,116392,fq9F4eLKGaYaKqdsBCYkrbRtYIz2HNWS,3VkHkmOtom3jM2wCu94xgzzu1d6Dn7or,15,37,9,15,9,1,6,0,77,11.0,3,0.0,10,9,11,9,27,1,4,6,0,39,38,1
12780,116407,FbdmHwhDtQoDvNNbH5NO4UO0Yhp01nUq,5Gyp41oLVo7Gg7vF4vpmggWP5MU70QO6,30,143,79,4,52,0,29,0,307,43.857142857142854,5,0.0,35,79,2,52,108,0,2,29,0,168,139,0
12781,116408,2AWz8OiYqJqT0VYmevCkAuxaVCSl88oB,5Gyp41oLVo7Gg7vF4vpmggWP5MU70QO6,15,32,18,0,12,1,7,1,71,10.142857142857142,5,0.0,1,18,0,12,31,1,0,7,1,31,40,1
12782,116417,7A1GCwEWpHROkWEfhD1PlzLhzB5NHb1O,5Gyp41oLVo7Gg7vF4vpmggWP5MU70QO6,7,3,2,0,2,0,2,0,9,1.2857142857142858,1,0.0,0,2,0,2,3,0,0,2,0,4,5,1
12783,116465,KogrHROquIJLSXIZqzhYU9Hcb9zVebwT,5Gyp41oLVo7Gg7vF4vpmggWP5MU70QO6,9,11,3,0,3,0,4,0,21,3.0,4,0.0,2,3,0,3,9,0,0,4,0,8,13,1
12784,116485,T760lHQ0RpxOvFjMkGLgsnuQEwsq9PjS,5Gyp41oLVo7Gg7vF4vpmggWP5MU70QO6,1,0,0,0,0,0,1,0,1,0.14285714285714285,1,0.0,0,0,0,0,0,0,0,1,0,0,1,1
12785,116500,2N6o6qJ0czxrbv8wbXwP5oVT4Ra8mOYu,5Gyp41oLVo7Gg7vF4vpmggWP5MU70QO6,1,0,0,0,0,0,4,0,4,0.5714285714285714,2,0.0,0,0,0,0,0,0,0,4,0,0,4,1
12786,116525,UaIcSFKSsXMkLJoEB18mPucIS2F5HMZt,5Gyp41oLVo7Gg7vF4vpmggWP5MU70QO6,29,94,47,25,28,23,17,0,234,33.42857142857143,9,0.0,35,47,18,28,59,23,7,17,0,128,106,0
12787,116563,4mJTMdBQXf0FLkWkpNUKeQduXoe3aC6K,5Gyp41oLVo7Gg7vF4vpmggWP5MU70QO6,5,2,1,0,1,0,4,0,8,1.1428571428571428,1,0.0,0,1,0,1,2,0,0,4,0,2,6,1
12788,116568,cXYqUXWJSTT7g3JkZOD6VVFxaOdV583i,5Gyp41oLVo7Gg7vF4vpmggWP5MU70QO6,34,119,70,5,19,2,39,4,258,36.857142857142854,5,0.0,28,70,4,19,91,2,1,39,4,121,137,1
12789,116579,QowyHsfHFUaEx1YaRDDC0R4vC3JBlmP0,5Gyp41oLVo7Gg7vF4vpmggWP5MU70QO6,9,5,3,0,2,0,3,1,14,2.0,1,0.0,1,3,0,2,4,0,0,3,1,6,8,1
12790,116583,TSwyBREzLotMzg2Iw5PjRsD2LWDfzOVi,5Gyp41oLVo7Gg7vF4vpmggWP5MU70QO6,25,46,24,27,10,34,13,1,155,22.142857142857142,3,0.0,12,24,18,10,34,34,9,13,1,64,91,0
12791,116585,BMt1sMJKW8lUV5XsrUOWqq2qoU33TZEw,5Gyp41oLVo7Gg7vF4vpmggWP5MU70QO6,9,12,6,0,2,0,2,0,22,3.142857142857143,1,0.0,1,6,0,2,11,0,0,2,0,9,13,1
12792,116601,6AFt8yaUkyVNpqQJOaGl7qwUgbH5JqKc,5Gyp41oLVo7Gg7vF4vpmggWP5MU70QO6,18,39,17,8,13,1,8,0,86,12.285714285714286,2,0.0,21,17,4,13,18,1,4,8,0,55,31,1
12793,116618,6TmTcNQyMYVAXbtK6HsQ96Mn7OGENU3z,5Gyp41oLVo7Gg7vF4vpmggWP5MU70QO6,7,4,3,0,3,0,2,0,12,1.7142857142857142,1,0.0,0,3,0,3,4,0,0,2,0,6,6,0
12794,116627,XYBLB5vnJS2TawgpFm2PqudALg5wF8Kg,5Gyp41oLVo7Gg7vF4vpmggWP5MU70QO6,1,0,0,0,0,0,1,0,1,0.14285714285714285,1,0.0,0,0,0,0,0,0,0,1,0,0,1,1
12795,116646,lxKYdDOq1adV5jGN5i0lYRRTeDyNW3Hr,5Gyp41oLVo7Gg7vF4vpmggWP5MU70QO6,46,238,146,49,9,683,62,5,1192,170.28571428571428,21,0.0,50,146,25,9,188,683,24,62,5,230,962,0
12796,116656,IDyO5Qr8w2rNSDKNwQkfLYbF0UjXTHLz,5Gyp41oLVo7Gg7vF4vpmggWP5MU70QO6,19,27,10,16,8,0,4,0,65,9.285714285714286,4,0.0,12,10,8,8,15,0,8,4,0,38,27,0
12797,116690,zJY0yOGJGPWV8ealRZ1xpBJyPwZpwm0y,5Gyp41oLVo7Gg7vF4vpmggWP5MU70QO6,1,0,0,0,0,0,1,0,1,0.14285714285714285,1,0.0,0,0,0,0,0,0,0,1,0,0,1,1
12798,116695,XYKEbaRABcMuBHmMB2I3YkBepzCp0swB,5Gyp41oLVo7Gg7vF4vpmggWP5MU70QO6,36,114,9,22,18,137,20,0,320,45.714285714285715,16,0.0,21,9,19,18,93,137,3,20,0,67,253,0
12799,116700,ULHb24x7E8rtGbCKyM1P4nt2HiX2afa3,5Gyp41oLVo7Gg7vF4vpmggWP5MU70QO6,5,2,1,0,1,0,3,0,7,1.0,1,0.0,0,1,0,1,2,0,0,3,0,2,5,1
12800,116703,WMUAVPy5nfF78EeZwI6Q7YdOMfqjaE1q,5Gyp41oLVo7Gg7vF4vpmggWP5MU70QO6,2,0,0,0,0,0,2,0,2,0.2857142857142857,1,0.0,0,0,0,0,0,0,0,2,0,0,2,1
12801,116711,3ZjYCc5MLjmqQO8I0BbV7xsRs5qoWXrX,5Gyp41oLVo7Gg7vF4vpmggWP5MU70QO6,11,23,12,0,8,0,7,0,50,7.142857142857143,4,0.0,4,12,0,8,19,0,0,7,0,24,26,0
12802,116734,BoXSuGXDZEH8EQNVPHOVOXaNZkjSq3cI,5Gyp41oLVo7Gg7vF4vpmggWP5MU70QO6,1,0,0,0,0,0,1,0,1,0.14285714285714285,1,0.0,0,0,0,0,0,0,0,1,0,0,1,1
12803,116757,BxboaJOjL0lutiA0WAavvZGy50ryt6dU,5Gyp41oLVo7Gg7vF4vpmggWP5MU70QO6,36,54,31,40,9,30,7,0,171,24.428571428571427,5,0.0,15,31,31,9,39,30,9,7,0,86,85,1
12804,116781,kJKPmsgnAo2a0lGHjzSIUIt3KbVa9yEm,5Gyp41oLVo7Gg7vF4vpmggWP5MU70QO6,8,4,2,0,2,0,2,0,10,1.4285714285714286,1,0.0,0,2,0,2,4,0,0,2,0,4,6,0
12805,116802,9TscsuxCtaNqXywaQXQeXHji1tYxcqIS,5Gyp41oLVo7Gg7vF4vpmggWP5MU70QO6,6,5,2,0,0,0,4,0,11,1.5714285714285714,3,0.0,0,2,0,0,5,0,0,4,0,2,9,1
12806,116804,3uU9hzp6POZeWb9TkpjJweQiyjZgKmLY,5Gyp41oLVo7Gg7vF4vpmggWP5MU70QO6,10,28,5,2,1,11,7,0,54,7.714285714285714,2,0.0,9,5,1,1,19,11,1,7,0,16,38,1
12807,116808,vdP2KzIF3CpofXr5k7RfTY3XkM0wS3qY,5Gyp41oLVo7Gg7vF4vpmggWP5MU70QO6,17,40,16,10,7,14,13,3,103,14.714285714285714,4,0.0,9,16,7,7,31,14,3,13,3,39,64,0
12808,116818,0LSuujEhRDqXVIY1bmT0rfkeWeUk8Hxd,5Gyp41oLVo7Gg7vF4vpmggWP5MU70QO6,6,1,1,0,1,0,3,0,6,0.8571428571428571,1,0.0,0,1,0,1,1,0,0,3,0,2,4,1
12809,116833,CJISoHtkGNnkB0CRrvBDw2uUj4sPNv5j,5Gyp41oLVo7Gg7vF4vpmggWP5MU70QO6,2,0,0,0,0,0,2,0,2,0.2857142857142857,1,0.0,0,0,0,0,0,0,0,2,0,0,2,1
12810,116847,c8TFm45r0bfBe26eBlEeUAKDBoTJT9yV,5Gyp41oLVo7Gg7vF4vpmggWP5MU70QO6,41,50,29,1,13,1,11,1,106,15.142857142857142,5,0.0,8,29,1,13,42,1,0,11,1,51,55,1
12811,116848,Xdurokd2SSgNf25hifq07OxoiHEDcyiq,5Gyp41oLVo7Gg7vF4vpmggWP5MU70QO6,5,3,2,0,0,0,2,0,7,1.0,1,0.0,0,2,0,0,3,0,0,2,0,2,5,1
12812,116860,MbB5RCe5n2jb2LHuR2EVxJKj3yTz460S,5Gyp41oLVo7Gg7vF4vpmggWP5MU70QO6,2,0,0,0,0,0,2,0,2,0.2857142857142857,1,0.0,0,0,0,0,0,0,0,2,0,0,2,1
12813,116872,HIaaOq9UrLvo3UC4FIJStVsYhdTvdkJ9,5Gyp41oLVo7Gg7vF4vpmggWP5MU70QO6,3,3,0,0,0,0,1,0,4,0.5714285714285714,1,0.0,0,0,0,0,3,0,0,1,0,0,4,1
12814,116885,RuAmBkKx2yGGe0I63ZT9zLq0egXER5uf,5Gyp41oLVo7Gg7vF4vpmggWP5MU70QO6,1,0,0,0,0,0,1,0,1,0.14285714285714285,1,0.0,0,0,0,0,0,0,0,1,0,0,1,1
12815,116888,Wh8hCdMajmbQYRdk0kC3itffbAwh1ipD,5Gyp41oLVo7Gg7vF4vpmggWP5MU70QO6,8,3,2,0,2,0,4,0,11,1.5714285714285714,1,0.0,0,2,0,2,3,0,0,4,0,4,7,1
12816,116891,xnjBe3q3IPnwGwUqh4nt5DYbmFucWMBn,5Gyp41oLVo7Gg7vF4vpmggWP5MU70QO6,1,0,0,0,0,0,1,0,1,0.14285714285714285,1,0.0,0,0,0,0,0,0,0,1,0,0,1,0
12817,116911,yPANNiQQMnN6yMtp5OhnGyYLdZrKDZ9V,5Gyp41oLVo7Gg7vF4vpmggWP5MU70QO6,7,6,2,0,5,0,3,0,16,2.2857142857142856,1,0.0,3,2,0,5,3,0,0,3,0,10,6,1
12818,116916,8xQNB57dWwxSgB7Cdmu4JTHSbpW9JnZk,5Gyp41oLVo7Gg7vF4vpmggWP5MU70QO6,7,8,4,0,1,0,3,0,16,2.2857142857142856,2,0.0,0,4,0,1,8,0,0,3,0,5,11,1
12819,116919,CWDKRVVm01sfgssULmzIPwx9dbULLbqB,5Gyp41oLVo7Gg7vF4vpmggWP5MU70QO6,51,115,60,65,21,0,19,0,280,40.0,11,0.0,34,60,54,21,81,0,11,19,0,169,111,0
12820,116939,Usfkocwm4lSZYVvNYLfyY0NGVEBUaZqO,5Gyp41oLVo7Gg7vF4vpmggWP5MU70QO6,1,0,0,0,0,0,1,0,1,0.14285714285714285,1,0.0,0,0,0,0,0,0,0,1,0,0,1,1
12821,116947,uRoRagoJb7klyYml2W2nJUADMGnmCLCh,5Gyp41oLVo7Gg7vF4vpmggWP5MU70QO6,1,0,0,0,0,0,1,0,1,0.14285714285714285,1,0.0,0,0,0,0,0,0,0,1,0,0,1,0
12822,116980,I2ghGumCKIaVsnJOGZA0xyJzTnEm5KtW,5Gyp41oLVo7Gg7vF4vpmggWP5MU70QO6,37,69,46,14,11,23,20,8,191,27.285714285714285,10,0.0,8,46,11,11,61,23,3,20,8,76,115,1
12823,117008,2DccYKlqpoQf6OVf4P499VuvWPHZoTTu,5Gyp41oLVo7Gg7vF4vpmggWP5MU70QO6,14,29,11,0,9,0,4,0,53,7.571428571428571,2,0.0,4,11,0,9,25,0,0,4,0,24,29,1
12824,117023,ADL0cXowUMs4wyiAOHKMOrtTHu5tmUqi,5Gyp41oLVo7Gg7vF4vpmggWP5MU70QO6,15,47,19,1,11,9,28,3,118,16.857142857142858,11,0.0,9,19,1,11,38,9,0,28,3,40,78,0
12825,117041,9SuXYl1IjiZODU1TMPwvrrvK6owZlUNe,5Gyp41oLVo7Gg7vF4vpmggWP5MU70QO6,1,0,0,0,0,0,1,0,1,0.14285714285714285,1,0.0,0,0,0,0,0,0,0,1,0,0,1,1
12826,117063,9b2fchNyVZPjqpmxjleqzL9edi9EOH23,5Gyp41oLVo7Gg7vF4vpmggWP5MU70QO6,10,8,3,0,1,2,10,2,26,3.7142857142857144,3,0.0,4,3,0,1,4,2,0,10,2,8,18,1
12827,117065,WUAnxOxSR8pysjIM781IoAjfv22J6fXT,5Gyp41oLVo7Gg7vF4vpmggWP5MU70QO6,1,0,0,0,0,0,1,0,1,0.14285714285714285,1,0.0,0,0,0,0,0,0,0,1,0,0,1,1
12828,117089,QyLVPf4M60EkZ1E7DsOzioCPS0UDQt1T,5Gyp41oLVo7Gg7vF4vpmggWP5MU70QO6,1,0,1,0,0,0,0,0,1,0.14285714285714285,1,0.0,0,1,0,0,0,0,0,0,0,1,0,1
12829,117095,fzJt7cMbQdDsYbjvGumpSBsSoIPDPhLX,5Gyp41oLVo7Gg7vF4vpmggWP5MU70QO6,1,0,0,0,0,0,1,0,1,0.14285714285714285,1,0.0,0,0,0,0,0,0,0,1,0,0,1,1
12830,117107,W5WXdjEPXec3kWgxusS4TQK5qUCtW9Gr,5Gyp41oLVo7Gg7vF4vpmggWP5MU70QO6,8,9,4,0,2,0,5,0,20,2.857142857142857,1,0.0,0,4,0,2,9,0,0,5,0,6,14,1
12831,117121,YkDfLiDseHtCR7dJh5rdSPT60rVAbQA9,5Gyp41oLVo7Gg7vF4vpmggWP5MU70QO6,2,0,0,0,0,0,2,0,2,0.2857142857142857,1,0.0,0,0,0,0,0,0,0,2,0,0,2,1
12832,117123,3sb6dkTzjyaoPHIVxOcX6QurrsU6bA7l,5Gyp41oLVo7Gg7vF4vpmggWP5MU70QO6,1,0,0,0,0,0,1,0,1,0.14285714285714285,1,0.0,0,0,0,0,0,0,0,1,0,0,1,1
12833,117135,3lgijIek2SmmNtHkgDCJTbZxGPkqedht,5Gyp41oLVo7Gg7vF4vpmggWP5MU70QO6,8,4,2,0,1,6,8,0,21,3.0,2,0.0,0,2,0,1,4,6,0,8,0,3,18,1
12834,117138,PHRCx9wyKQjGXWbcIfUScN2q5ez7aVqM,5Gyp41oLVo7Gg7vF4vpmggWP5MU70QO6,10,15,8,0,4,0,4,0,31,4.428571428571429,2,0.0,2,8,0,4,13,0,0,4,0,14,17,1
12835,117156,NbVCWnNRkOvejswZDVYPJBSUeg9KlOhj,5Gyp41oLVo7Gg7vF4vpmggWP5MU70QO6,1,0,0,0,0,0,1,0,1,0.14285714285714285,1,0.0,0,0,0,0,0,0,0,1,0,0,1,1
12836,117165,IhZdPOtOeXyg0OwsQIkD0XHc4IVBLzMp,5Gyp41oLVo7Gg7vF4vpmggWP5MU70QO6,10,6,3,0,3,2,8,0,22,3.142857142857143,3,0.0,1,3,0,3,5,2,0,8,0,7,15,1
12837,117180,bxhBGxneaqGOWkm51njJK4ynLGNp1dFr,5Gyp41oLVo7Gg7vF4vpmggWP5MU70QO6,1,0,0,0,0,0,1,0,1,0.14285714285714285,1,0.0,0,0,0,0,0,0,0,1,0,0,1,1
12838,117185,GNXJ3DgKpOCI8ASwOajRaheU6QheqqG0,5Gyp41oLVo7Gg7vF4vpmggWP5MU70QO6,1,0,0,0,0,0,1,0,1,0.14285714285714285,1,0.0,0,0,0,0,0,0,0,1,0,0,1,1
12839,117222,gSg4PIaWl0hBhOgVlpN9o8YrQn4pTOeq,5Gyp41oLVo7Gg7vF4vpmggWP5MU70QO6,1,0,0,0,0,0,1,0,1,0.14285714285714285,1,0.0,0,0,0,0,0,0,0,1,0,0,1,0
12840,117224,rT1OrFQC18rdvYkTGYqwRgC7eDvihHsc,5Gyp41oLVo7Gg7vF4vpmggWP5MU70QO6,21,37,24,0,12,0,12,0,85,12.142857142857142,8,0.0,1,24,0,12,36,0,0,12,0,37,48,1
12841,117227,8qABUnBBHxxZkfUhEQNUn5NNMSRrqvPC,5Gyp41oLVo7Gg7vF4vpmggWP5MU70QO6,15,42,24,0,0,1,12,2,81,11.571428571428571,1,0.0,15,24,0,0,27,1,0,12,2,39,42,1
12842,117255,VQRCM2WfTOxPVqL1wfHrLv0YRxF7pqR5,5Gyp41oLVo7Gg7vF4vpmggWP5MU70QO6,7,2,2,0,1,0,3,0,8,1.1428571428571428,1,0.0,0,2,0,1,2,0,0,3,0,3,5,1
12843,117262,E9LvqT83AyaleYfbFG9vVblj5qFDj4pH,5Gyp41oLVo7Gg7vF4vpmggWP5MU70QO6,1,0,0,0,0,0,1,0,1,0.14285714285714285,1,0.0,0,0,0,0,0,0,0,1,0,0,1,1
12844,117272,eN3Zet0tDUonovGa1sjqSTY5JzjDSKDq,5Gyp41oLVo7Gg7vF4vpmggWP5MU70QO6,1,0,0,0,0,0,1,0,1,0.14285714285714285,1,0.0,0,0,0,0,0,0,0,1,0,0,1,0
12845,117283,cwi1EqbseaNkWdLsJKfCfX0do77ptlsN,5Gyp41oLVo7Gg7vF4vpmggWP5MU70QO6,5,2,1,0,1,0,2,0,6,0.8571428571428571,1,0.0,0,1,0,1,2,0,0,2,0,2,4,1
12846,117294,qI10Bv6M8yDADmXGFHo8Ci0xEtFKxZnK,5Gyp41oLVo7Gg7vF4vpmggWP5MU70QO6,1,0,0,0,0,0,1,0,1,0.14285714285714285,1,0.0,0,0,0,0,0,0,0,1,0,0,1,1
12847,117306,XDhMhAgbTguQNFGPykY6IJEQSl3DEa3i,5Gyp41oLVo7Gg7vF4vpmggWP5MU70QO6,1,0,0,0,0,0,1,0,1,0.14285714285714285,1,0.0,0,0,0,0,0,0,0,1,0,0,1,1
12848,117307,0TVIMteBCisXYqQmhAVCzijts3EjTj9F,5Gyp41oLVo7Gg7vF4vpmggWP5MU70QO6,14,11,6,2,6,0,8,0,33,4.714285714285714,3,0.0,4,6,1,6,7,0,1,8,0,17,16,0
12849,117312,Ys9Sq9z0Ayx7HAA2bEWIYOIRrgTfYson,5Gyp41oLVo7Gg7vF4vpmggWP5MU70QO6,5,2,1,0,1,0,2,0,6,0.8571428571428571,1,0.0,0,1,0,1,2,0,0,2,0,2,4,1
12850,117313,AOjqu8OTCPaKqT40dsKKHuXenHhl1lM6,5Gyp41oLVo7Gg7vF4vpmggWP5MU70QO6,8,6,4,0,3,0,4,0,17,2.4285714285714284,2,0.0,0,4,0,3,6,0,0,4,0,7,10,1
12851,117319,BvJFDLjt3ftWMc7x9UAbMlTnLGgBI3OG,5Gyp41oLVo7Gg7vF4vpmggWP5MU70QO6,11,20,0,0,0,8,3,0,31,4.428571428571429,2,0.0,0,0,0,0,20,8,0,3,0,0,31,1
12852,117325,UCVAz5InEePYpw1xYZPlWtu2UGJ8pFLc,5Gyp41oLVo7Gg7vF4vpmggWP5MU70QO6,7,2,1,0,1,0,6,2,12,1.7142857142857142,1,0.0,0,1,0,1,2,0,0,6,2,2,10,1
12853,117346,5tL0goZ0bMjNeuGHJZ9VZymSM6PzqaXn,5Gyp41oLVo7Gg7vF4vpmggWP5MU70QO6,1,0,0,0,0,0,2,0,2,0.2857142857142857,2,0.0,0,0,0,0,0,0,0,2,0,0,2,1
12854,117347,Lmy48LaZfIr9H2JGohLJKVaIoB8r8qji,fbPkOYLVPtPgIt0MxizjfFJov3JbHyAi,7,3,2,0,2,0,4,0,11,1.5714285714285714,1,0.0,0,2,0,2,3,0,0,4,0,4,7,1
12855,117348,5qhlEY7iczknBOw4qaTj0oiHyjQVe9rT,fbPkOYLVPtPgIt0MxizjfFJov3JbHyAi,4,2,1,0,1,0,1,0,5,0.7142857142857143,1,0.0,0,1,0,1,2,0,0,1,0,2,3,1
12856,117349,CcuDWPt1eyW7M86jUsYuAZO2EZvkv343,fbPkOYLVPtPgIt0MxizjfFJov3JbHyAi,2,0,0,0,0,0,2,0,2,0.2857142857142857,1,0.0,0,0,0,0,0,0,0,2,0,0,2,1
12857,117350,THBV67QwrR4fvYsMOGo7siHXFao0S7M8,fbPkOYLVPtPgIt0MxizjfFJov3JbHyAi,4,2,1,0,1,0,1,0,5,0.7142857142857143,1,0.0,0,1,0,1,2,0,0,1,0,2,3,1
12858,117351,S6eQGQp3K76RS5VMtIsaLuIm5UHtwYF7,fbPkOYLVPtPgIt0MxizjfFJov3JbHyAi,5,2,1,0,1,0,4,0,8,1.1428571428571428,1,0.0,0,1,0,1,2,0,0,4,0,2,6,1
12859,117352,W8LiHDfUOd6JJS4l21H06gvkeAd3UQzA,fbPkOYLVPtPgIt0MxizjfFJov3JbHyAi,8,6,2,0,3,0,6,0,17,2.4285714285714284,2,0.0,3,2,0,3,3,0,0,6,0,8,9,1
12860,117353,qsIC4v5Dx0AC8V7VvfXbXh1Orc1wEb3w,fbPkOYLVPtPgIt0MxizjfFJov3JbHyAi,2,0,0,0,0,0,4,0,4,0.5714285714285714,2,0.0,0,0,0,0,0,0,0,4,0,0,4,1
12861,117354,wJflvpFe05Aoyiv7JkqhQs7iDcvnIpoZ,fbPkOYLVPtPgIt0MxizjfFJov3JbHyAi,23,95,36,22,66,45,14,0,278,39.714285714285715,4,0.0,16,36,19,66,79,45,3,14,0,137,141,0
12862,117355,HymjYRZjO8zO0eFKC26krqimHj67lbM0,fbPkOYLVPtPgIt0MxizjfFJov3JbHyAi,9,3,2,0,2,12,13,1,33,4.714285714285714,1,0.0,0,2,0,2,3,12,0,13,1,4,29,1
12863,117356,BEpwi711y09XyC4DFTNZ8NMJ5PwUJeE1,fbPkOYLVPtPgIt0MxizjfFJov3JbHyAi,76,259,115,72,29,128,65,7,675,96.42857142857143,17,0.0,42,115,67,29,217,128,5,65,7,253,422,0
12864,117357,jdo8ZaITXdNg3iaXD5IuBNuDQn99Df8w,fbPkOYLVPtPgIt0MxizjfFJov3JbHyAi,6,6,3,0,1,0,2,0,12,1.7142857142857142,2,0.0,0,3,0,1,6,0,0,2,0,4,8,1
12865,117358,VIIC2sfSYNNzIhFTDhqx6glGRp1LLtBP,fbPkOYLVPtPgIt0MxizjfFJov3JbHyAi,1,0,0,0,0,0,1,0,1,0.14285714285714285,1,0.0,0,0,0,0,0,0,0,1,0,0,1,1
12866,117359,1fv3phUYFf4MQkWpDcJllU01xcW0vo3W,fbPkOYLVPtPgIt0MxizjfFJov3JbHyAi,4,2,1,0,1,0,1,0,5,0.7142857142857143,1,0.0,0,1,0,1,2,0,0,1,0,2,3,1
12867,117360,u8qSA6tNYpciCcX3NsOlG8kpTSmTzvQW,fbPkOYLVPtPgIt0MxizjfFJov3JbHyAi,1,0,0,0,0,0,1,0,1,0.14285714285714285,1,0.0,0,0,0,0,0,0,0,1,0,0,1,1
12868,117361,YmW9sTTkl6fJ0hETvvamJqK86iqzkJtX,fbPkOYLVPtPgIt0MxizjfFJov3JbHyAi,9,12,7,0,4,3,3,0,29,4.142857142857143,2,0.0,0,7,0,4,12,3,0,3,0,11,18,1
12869,117362,GhH23XxJCtHV5BHmHgLHMs1bT51czMlK,fbPkOYLVPtPgIt0MxizjfFJov3JbHyAi,2,0,0,0,0,0,8,0,8,1.1428571428571428,1,0.0,0,0,0,0,0,0,0,8,0,0,8,1
12870,117363,jpOV5NTWg54y4Oc7tw4bVLxYduaerIGO,fbPkOYLVPtPgIt0MxizjfFJov3JbHyAi,5,2,1,0,1,0,4,0,8,1.1428571428571428,1,0.0,0,1,0,1,2,0,0,4,0,2,6,1
12871,117364,gVDka1k86106F8RxhzEk3T4GWmptct3j,fbPkOYLVPtPgIt0MxizjfFJov3JbHyAi,5,2,1,0,1,0,5,0,9,1.2857142857142858,1,0.0,0,1,0,1,2,0,0,5,0,2,7,1
12872,117365,Jab5g3oUGQ9SaeNRnULqHnW16VXqaDjO,fbPkOYLVPtPgIt0MxizjfFJov3JbHyAi,5,3,1,0,1,0,4,0,9,1.2857142857142858,1,0.0,0,1,0,1,3,0,0,4,0,2,7,0
12873,117366,dzyBEAqhGTXZ2XFaP0jn5Y8xrnIodQ3R,fbPkOYLVPtPgIt0MxizjfFJov3JbHyAi,1,0,0,0,0,0,1,0,1,0.14285714285714285,1,0.0,0,0,0,0,0,0,0,1,0,0,1,1
12874,117369,84MmPDpZ0YkQ5nQqNX1rbALt0YU3wNuB,fbPkOYLVPtPgIt0MxizjfFJov3JbHyAi,6,1,0,0,0,0,8,1,10,1.4285714285714286,1,0.0,0,0,0,0,1,0,0,8,1,0,10,1
12875,117371,yr7gisoB3gNrf1PYumUdBsd83AKA13gw,fbPkOYLVPtPgIt0MxizjfFJov3JbHyAi,2,0,0,0,0,0,4,0,4,0.5714285714285714,1,0.0,0,0,0,0,0,0,0,4,0,0,4,1
12876,117372,frevGWOFyf2Wo6uQjpFNvZnyWeFbKP0E,fbPkOYLVPtPgIt0MxizjfFJov3JbHyAi,42,32,17,28,14,5,7,0,103,14.714285714285714,3,0.0,12,17,26,14,20,5,2,7,0,69,34,1
12877,117373,FAatoUEhCvhRpOYbmvA32pbUt7RdzYRu,fbPkOYLVPtPgIt0MxizjfFJov3JbHyAi,5,2,1,0,1,0,5,0,9,1.2857142857142858,1,0.0,0,1,0,1,2,0,0,5,0,2,7,1
12878,117374,ZMs9DXI7ESTFKW1YBMWs95iQQk6J7X2z,fbPkOYLVPtPgIt0MxizjfFJov3JbHyAi,5,3,1,0,1,2,4,0,11,1.5714285714285714,1,0.0,0,1,0,1,3,2,0,4,0,2,9,1
12879,117375,70RbSAVcGIyny9mWjCd20wt9FfgzeOIU,fbPkOYLVPtPgIt0MxizjfFJov3JbHyAi,12,25,12,0,4,12,16,1,70,10.0,4,0.0,0,12,0,4,25,12,0,16,1,16,54,1
12880,117376,7RSTSE7CX0EZRW2RDRnKS7CJkHtK7gJx,fbPkOYLVPtPgIt0MxizjfFJov3JbHyAi,4,3,1,0,1,3,1,0,9,1.2857142857142858,1,0.0,0,1,0,1,3,3,0,1,0,2,7,0
12881,117378,9jhH7wrMd3Eqw0VV440Dc9UHr2dQD82o,fbPkOYLVPtPgIt0MxizjfFJov3JbHyAi,6,1,1,0,1,0,5,0,8,1.1428571428571428,1,0.0,0,1,0,1,1,0,0,5,0,2,6,1
12882,117381,WeKk3LPA70V1znb6M7iSuaLFtRvTgv4L,fbPkOYLVPtPgIt0MxizjfFJov3JbHyAi,4,2,1,0,1,0,1,0,5,0.7142857142857143,1,0.0,0,1,0,1,2,0,0,1,0,2,3,1
12883,117383,cgR6Sk6i1HisakMjtLETZQtfL4e89Msk,fbPkOYLVPtPgIt0MxizjfFJov3JbHyAi,2,0,0,0,0,0,2,0,2,0.2857142857142857,1,0.0,0,0,0,0,0,0,0,2,0,0,2,1
12884,117384,QE7VYemIj4pMHXuEl2xp801KoSOaKbg6,fbPkOYLVPtPgIt0MxizjfFJov3JbHyAi,10,10,5,0,4,0,7,0,26,3.7142857142857144,2,0.0,2,5,0,4,8,0,0,7,0,11,15,1
12885,117387,Q6xW7zlgn9B8VyFUYRYPAiN0jH5lh0YZ,fbPkOYLVPtPgIt0MxizjfFJov3JbHyAi,5,3,1,0,1,0,5,0,10,1.4285714285714286,1,0.0,0,1,0,1,3,0,0,5,0,2,8,1
12886,117388,cdL4DEn7NceHWkENWhz16RxoYhvN1B4t,fbPkOYLVPtPgIt0MxizjfFJov3JbHyAi,9,9,4,0,3,3,7,1,27,3.857142857142857,1,0.0,3,4,0,3,6,3,0,7,1,10,17,1
12887,117390,CadKUf2Mul3ALexXlY5uWvTQFtSrVs8p,fbPkOYLVPtPgIt0MxizjfFJov3JbHyAi,5,2,1,0,1,0,2,0,6,0.8571428571428571,1,0.0,0,1,0,1,2,0,0,2,0,2,4,1
12888,117391,dGox9f4ZDlHQwjKRHa3wEmIJzGDWDxPX,fbPkOYLVPtPgIt0MxizjfFJov3JbHyAi,15,21,7,17,10,10,9,0,74,10.571428571428571,2,0.0,12,7,12,10,9,10,5,9,0,41,33,1
12889,117392,A3rmkE1bnOg1XwxjYHudD7UFmCyTX4Vy,fbPkOYLVPtPgIt0MxizjfFJov3JbHyAi,5,2,1,0,1,0,2,0,6,0.8571428571428571,1,0.0,0,1,0,1,2,0,0,2,0,2,4,1
12890,117393,1NRhqP9avvdGMFKMKghbEOxv5wnexLIt,fbPkOYLVPtPgIt0MxizjfFJov3JbHyAi,2,0,0,0,0,0,4,0,4,0.5714285714285714,1,0.0,0,0,0,0,0,0,0,4,0,0,4,1
12891,117394,x61GVEFoUQZEIHnVsxBCw0kitfDOhP0p,fbPkOYLVPtPgIt0MxizjfFJov3JbHyAi,43,92,53,10,37,96,29,1,318,45.42857142857143,6,0.0,20,53,9,37,72,96,1,29,1,119,199,1
12892,117395,Mh66DLCMXZ6dBObZWAREClnDkNcjPB4t,fbPkOYLVPtPgIt0MxizjfFJov3JbHyAi,5,2,1,0,1,0,4,0,8,1.1428571428571428,1,0.0,0,1,0,1,2,0,0,4,0,2,6,1
12893,117398,RToZJlmZ1SKeCpqwz31BArcaj4qy0SaF,fbPkOYLVPtPgIt0MxizjfFJov3JbHyAi,2,0,0,0,0,0,2,0,2,0.2857142857142857,1,0.0,0,0,0,0,0,0,0,2,0,0,2,1
12894,117400,DYhAozmaoJyITokVWonroVftsEgv5K6H,fbPkOYLVPtPgIt0MxizjfFJov3JbHyAi,7,3,2,0,2,0,4,0,11,1.5714285714285714,1,0.0,0,2,0,2,3,0,0,4,0,4,7,1
12895,117401,8loJZqV93UIB0LVEOgs0qIcfMBhyuVR4,fbPkOYLVPtPgIt0MxizjfFJov3JbHyAi,5,2,1,0,1,0,2,0,6,0.8571428571428571,1,0.0,0,1,0,1,2,0,0,2,0,2,4,1
12896,117402,BdMHqR5WAKDssANXDMso5QusZ7X7eexo,fbPkOYLVPtPgIt0MxizjfFJov3JbHyAi,25,89,34,11,20,37,10,1,202,28.857142857142858,3,0.0,31,34,10,20,58,37,1,10,1,95,107,1
12897,117403,AyVFKMWjzC4gPpDsd8ofzYs7TtpYPztD,fbPkOYLVPtPgIt0MxizjfFJov3JbHyAi,7,4,2,0,1,0,5,0,12,1.7142857142857142,1,0.0,0,2,0,1,4,0,0,5,0,3,9,1
12898,117404,C89edYjc0egHm9DK0UhG6TICXc3cgfYt,fbPkOYLVPtPgIt0MxizjfFJov3JbHyAi,5,5,2,0,0,0,3,0,10,1.4285714285714286,2,0.0,0,2,0,0,5,0,0,3,0,2,8,1
12899,117406,skfYGEKD2YfFTJGYxEqRg06NVhsZf6hd,fbPkOYLVPtPgIt0MxizjfFJov3JbHyAi,2,0,0,0,0,0,2,0,2,0.2857142857142857,1,0.0,0,0,0,0,0,0,0,2,0,0,2,1
12900,117411,K22VFryh5Od9V1LL0eOyTaqPsCNGJ8v3,fbPkOYLVPtPgIt0MxizjfFJov3JbHyAi,5,1,1,0,1,0,2,0,5,0.7142857142857143,1,0.0,0,1,0,1,1,0,0,2,0,2,3,1
12901,117412,27mdD0tYMMLTpcK2D7h6xnCOldDDzHch,fbPkOYLVPtPgIt0MxizjfFJov3JbHyAi,8,17,6,0,3,0,2,0,28,4.0,2,0.0,2,6,0,3,15,0,0,2,0,11,17,1
12902,117413,ZcypYnlQeadTdUIaT74Rv3xxhxFofUjh,fbPkOYLVPtPgIt0MxizjfFJov3JbHyAi,5,2,1,0,1,0,6,0,10,1.4285714285714286,1,0.0,0,1,0,1,2,0,0,6,0,2,8,1
12903,117414,u601bf5LgTloUnzWrvF8VsEbNdAIplE1,fbPkOYLVPtPgIt0MxizjfFJov3JbHyAi,7,3,2,0,2,0,4,0,11,1.5714285714285714,1,0.0,0,2,0,2,3,0,0,4,0,4,7,1
12904,117415,4Qo7Z1J3GHBpS2AY75HBdWU9Il8Ha5mP,fbPkOYLVPtPgIt0MxizjfFJov3JbHyAi,13,17,6,1,8,9,10,1,52,7.428571428571429,1,0.0,9,6,1,8,8,9,0,10,1,24,28,1
12905,117416,no2ug7TKVsupL4LU2a5jY2GhYHkskTdw,fbPkOYLVPtPgIt0MxizjfFJov3JbHyAi,45,83,45,30,19,9,20,0,206,29.428571428571427,9,0.0,22,45,24,19,61,9,6,20,0,110,96,1
12906,117417,MWcyYl4VKJ6gXYTCZ6GsdLjzmXlJRZpp,fbPkOYLVPtPgIt0MxizjfFJov3JbHyAi,10,9,2,0,3,21,12,4,51,7.285714285714286,2,0.0,2,2,0,3,7,21,0,12,4,7,44,1
12907,117418,xO9ez1QwXcTHUWvk9yY6tpiPg2NpvI40,fbPkOYLVPtPgIt0MxizjfFJov3JbHyAi,7,3,2,0,2,0,2,0,9,1.2857142857142858,1,0.0,0,2,0,2,3,0,0,2,0,4,5,1
12908,117419,EDx8dOeIuSiG4dzn3b6IyJq074mUoFqU,fbPkOYLVPtPgIt0MxizjfFJov3JbHyAi,2,0,0,0,0,0,4,0,4,0.5714285714285714,1,0.0,0,0,0,0,0,0,0,4,0,0,4,1
12909,117422,3ufcPQa9fE8hNqWpP8Ewk6MLJ169ewYG,fbPkOYLVPtPgIt0MxizjfFJov3JbHyAi,9,15,3,0,2,0,4,0,24,3.4285714285714284,2,0.0,0,3,0,2,15,0,0,4,0,5,19,1
12910,117423,NXEwBXbU6vvce77sujWgRB6LivhFJvRb,fbPkOYLVPtPgIt0MxizjfFJov3JbHyAi,12,20,14,4,8,0,6,0,52,7.428571428571429,4,0.0,1,14,3,8,19,0,1,6,0,26,26,1
12911,117424,ksf7O5VoxfMEE12hvGca3f6KoMnOQ3Bh,fbPkOYLVPtPgIt0MxizjfFJov3JbHyAi,5,5,0,0,0,0,7,0,12,1.7142857142857142,1,0.0,0,0,0,0,5,0,0,7,0,0,12,1
12912,117427,bGLdkKassDYyZB9t4bgBBFjAHmjUsNSR,fbPkOYLVPtPgIt0MxizjfFJov3JbHyAi,7,3,1,0,1,1,7,1,14,2.0,1,0.0,0,1,0,1,3,1,0,7,1,2,12,1
12913,117428,es5zwE1DJ3gcng5ye9rbNjDc6YGVZjjA,fbPkOYLVPtPgIt0MxizjfFJov3JbHyAi,7,4,3,0,2,0,4,0,13,1.8571428571428572,1,0.0,0,3,0,2,4,0,0,4,0,5,8,1
12914,117431,da6MhMlDFSRLmIrClGzjJtU8eL0pm2dy,fbPkOYLVPtPgIt0MxizjfFJov3JbHyAi,5,2,1,0,1,0,2,0,6,0.8571428571428571,1,0.0,0,1,0,1,2,0,0,2,0,2,4,1
12915,117433,M75L90OOMTV1kEiI3n7vM0ty47YBFna9,fbPkOYLVPtPgIt0MxizjfFJov3JbHyAi,7,6,3,0,2,0,2,0,13,1.8571428571428572,2,0.0,0,3,0,2,6,0,0,2,0,5,8,1
12916,117435,Mal0OrUqylh9gVaeGBMc9fi4hOm7CY1j,fbPkOYLVPtPgIt0MxizjfFJov3JbHyAi,5,3,1,0,1,0,4,0,9,1.2857142857142858,1,0.0,0,1,0,1,3,0,0,4,0,2,7,1
12917,117436,CarlVCnkEuEWdxEFIyhyUfB0cb91lk3u,fbPkOYLVPtPgIt0MxizjfFJov3JbHyAi,5,2,1,0,1,1,4,0,9,1.2857142857142858,1,0.0,0,1,0,1,2,1,0,4,0,2,7,1
12918,117438,tD6MzN5QxvGBHQOVcmWLTvbMypNYMcey,fbPkOYLVPtPgIt0MxizjfFJov3JbHyAi,6,3,2,0,2,0,1,0,8,1.1428571428571428,1,0.0,0,2,0,2,3,0,0,1,0,4,4,1
12919,117439,vEs30RoWqgpB6hECbcLmFiwxEohGiKSd,fbPkOYLVPtPgIt0MxizjfFJov3JbHyAi,5,2,0,0,0,8,3,0,13,1.8571428571428572,1,0.0,0,0,0,0,2,8,0,3,0,0,13,1
12920,117440,IvHnLbw6NP6LhhQqreTJbhNQU5Zs6JCF,fbPkOYLVPtPgIt0MxizjfFJov3JbHyAi,4,2,1,0,1,0,2,0,6,0.8571428571428571,1,0.0,0,1,0,1,2,0,0,2,0,2,4,1
12921,117441,HptEZjRmdOpiqQNtiQtuC0XhWeQWrU1F,fbPkOYLVPtPgIt0MxizjfFJov3JbHyAi,2,0,0,0,0,0,2,0,2,0.2857142857142857,1,0.0,0,0,0,0,0,0,0,2,0,0,2,1
12922,117448,EVLibPakJPGsb5a9opPnLRzSILBMV36m,fbPkOYLVPtPgIt0MxizjfFJov3JbHyAi,7,2,1,0,1,1,7,1,13,1.8571428571428572,1,0.0,0,1,0,1,2,1,0,7,1,2,11,1
12923,117449,jfWbgHyvVBGKbleke3IOJ4RuvBB6sx7J,fbPkOYLVPtPgIt0MxizjfFJov3JbHyAi,9,5,3,0,3,0,3,0,14,2.0,2,0.0,0,3,0,3,5,0,0,3,0,6,8,1
12924,117450,NTi3RF6xGnkzsfYTj8D33u4sH3LbVAHE,fbPkOYLVPtPgIt0MxizjfFJov3JbHyAi,23,56,26,46,0,0,12,0,140,20.0,3,0.0,20,26,40,0,36,0,6,12,0,86,54,1
12925,117451,8TpvgxjbFSiTX0WEWOAldouvOlu5hbct,fbPkOYLVPtPgIt0MxizjfFJov3JbHyAi,5,2,0,0,0,22,4,0,28,4.0,1,0.0,0,0,0,0,2,22,0,4,0,0,28,1
12926,117453,GOoApgMbqW9QFX07cCt2mUBIZ8txh6qT,fbPkOYLVPtPgIt0MxizjfFJov3JbHyAi,9,17,9,0,9,15,1,0,51,7.285714285714286,1,0.0,6,9,0,9,11,15,0,1,0,24,27,1
12927,117455,HTst2SMNdS0XNA43FeobA5o05v7CUlNA,fbPkOYLVPtPgIt0MxizjfFJov3JbHyAi,25,42,17,22,18,2,6,1,108,15.428571428571429,1,0.0,22,17,21,18,20,2,1,6,1,78,30,0
12928,117456,PgMYw44fTh4Xx5U2R8ETG8pzBeXCE15Z,fbPkOYLVPtPgIt0MxizjfFJov3JbHyAi,1,0,0,0,0,0,1,0,1,0.14285714285714285,1,0.0,0,0,0,0,0,0,0,1,0,0,1,1
12929,117457,AFgD1DLeorByrsoA4AU51GpZfc6uZUVB,fbPkOYLVPtPgIt0MxizjfFJov3JbHyAi,6,7,3,0,2,0,1,0,13,1.8571428571428572,1,0.0,0,3,0,2,7,0,0,1,0,5,8,1
12930,117458,Uc3HK5Q0vMTy3ljdUcEzfnFcMiWvgtMK,fbPkOYLVPtPgIt0MxizjfFJov3JbHyAi,5,1,1,0,1,0,2,0,5,0.7142857142857143,1,0.0,0,1,0,1,1,0,0,2,0,2,3,1
12931,117459,8BPmxHv8u8jXk5HWBs0qXnY9uZ2rLMGq,fbPkOYLVPtPgIt0MxizjfFJov3JbHyAi,5,10,3,0,2,0,2,0,17,2.4285714285714284,4,0.0,0,3,0,2,10,0,0,2,0,5,12,0
12932,117461,OakZIwMalw5UgG2N0rTydClOEPiV8rki,fbPkOYLVPtPgIt0MxizjfFJov3JbHyAi,16,37,15,10,9,6,4,0,81,11.571428571428571,3,0.0,5,15,10,9,32,6,0,4,0,39,42,1
12933,117462,t9DYQDh2NoshF6BVBhwjK6lRvYfkvSI9,fbPkOYLVPtPgIt0MxizjfFJov3JbHyAi,5,2,1,0,1,0,4,0,8,1.1428571428571428,1,0.0,0,1,0,1,2,0,0,4,0,2,6,1
12934,117463,KMNMpAumo6Yq2T1usaL4CulVhqgN4Ggl,fbPkOYLVPtPgIt0MxizjfFJov3JbHyAi,10,4,3,0,3,0,5,0,15,2.142857142857143,1,0.0,0,3,0,3,4,0,0,5,0,6,9,1
12935,117464,SiySM3c36hCdKDVaWJXLlC2PBQXet4s6,fbPkOYLVPtPgIt0MxizjfFJov3JbHyAi,5,3,2,0,1,0,1,0,7,1.0,1,0.0,0,2,0,1,3,0,0,1,0,3,4,1
12936,117465,c0uK7fknnbIb1l1yn1QtakefMn1Gi8lI,fbPkOYLVPtPgIt0MxizjfFJov3JbHyAi,5,11,4,4,0,5,2,0,26,3.7142857142857144,2,0.0,6,4,4,0,5,5,0,2,0,14,12,1
12937,117466,f46TsvwYgA023En7b0jRPEBnKcXc3eeY,fbPkOYLVPtPgIt0MxizjfFJov3JbHyAi,1,0,0,0,0,0,1,0,1,0.14285714285714285,1,0.0,0,0,0,0,0,0,0,1,0,0,1,1
12938,117468,AyISABpEkA6iYSuwBUoEgieVOrxLsxsQ,fbPkOYLVPtPgIt0MxizjfFJov3JbHyAi,4,2,1,0,0,0,3,0,6,0.8571428571428571,1,0.0,0,1,0,0,2,0,0,3,0,1,5,1
12939,117469,L3IzrZCeDOJTtm8wqYhXyjKAgit0WIBa,fbPkOYLVPtPgIt0MxizjfFJov3JbHyAi,1,0,0,0,0,0,1,0,1,0.14285714285714285,1,0.0,0,0,0,0,0,0,0,1,0,0,1,1
12940,117471,yDbqTKS1iAgd89Ji6xK8IoXm0GxGr49P,fbPkOYLVPtPgIt0MxizjfFJov3JbHyAi,2,0,0,0,0,0,4,0,4,0.5714285714285714,1,0.0,0,0,0,0,0,0,0,4,0,0,4,1
12941,117473,5eQJepE2igmBlMYZK0syg6BGCi1adOu4,fbPkOYLVPtPgIt0MxizjfFJov3JbHyAi,5,2,1,0,1,0,2,0,6,0.8571428571428571,1,0.0,0,1,0,1,2,0,0,2,0,2,4,1
12942,117474,1HKWuDclbOiSiuIlQVduMPq7fJCJ9Rls,fbPkOYLVPtPgIt0MxizjfFJov3JbHyAi,8,27,10,0,2,0,6,0,45,6.428571428571429,3,0.0,3,10,0,2,24,0,0,6,0,15,30,1
12943,117475,SBljO82TZdHeWzc47l4IthlHIwfXwoH3,fbPkOYLVPtPgIt0MxizjfFJov3JbHyAi,7,5,3,0,3,0,6,0,17,2.4285714285714284,1,0.0,0,3,0,3,5,0,0,6,0,6,11,1
12944,117479,Hc79IVDWbH7OTe9ljIsaEhHZLqPrPrds,fbPkOYLVPtPgIt0MxizjfFJov3JbHyAi,7,4,3,0,3,0,2,0,12,1.7142857142857142,1,0.0,0,3,0,3,4,0,0,2,0,6,6,1
12945,117480,O85WftB5NCrDTb9pXVSgYQyFNgKq9cya,fbPkOYLVPtPgIt0MxizjfFJov3JbHyAi,8,6,4,0,3,0,5,0,18,2.5714285714285716,2,0.0,0,4,0,3,6,0,0,5,0,7,11,1
12946,117481,58Jq6K3XLZtch5ZG85QFaonKOWfQNCcP,fbPkOYLVPtPgIt0MxizjfFJov3JbHyAi,7,3,2,0,2,0,2,0,9,1.2857142857142858,1,0.0,0,2,0,2,3,0,0,2,0,4,5,1
12947,117482,ueh8Q0J414FE7Xmjqeh6AbzlK27RwSRw,fbPkOYLVPtPgIt0MxizjfFJov3JbHyAi,1,0,0,0,0,0,1,0,1,0.14285714285714285,1,0.0,0,0,0,0,0,0,0,1,0,0,1,1
12948,117486,XDj6kE9olAchZwfUS0dXzHZTiPPM5bec,fbPkOYLVPtPgIt0MxizjfFJov3JbHyAi,4,4,2,0,2,0,1,0,9,1.2857142857142858,1,0.0,0,2,0,2,4,0,0,1,0,4,5,1
12949,117487,UvYdE00Z5Ts8a6wK0WxKxxpGT2cAkrRh,fbPkOYLVPtPgIt0MxizjfFJov3JbHyAi,47,141,48,26,38,0,15,0,268,38.285714285714285,8,0.0,58,48,23,38,83,0,3,15,0,167,101,0
12950,117488,1CyCTZgUsAiY8PwSyUmbGce1pgpqezgo,fbPkOYLVPtPgIt0MxizjfFJov3JbHyAi,11,9,6,0,4,1,6,3,29,4.142857142857143,1,0.0,0,6,0,4,9,1,0,6,3,10,19,1
12951,117489,36E8EgprLSCZHQtlY5yjvPm97JUh2cfX,fbPkOYLVPtPgIt0MxizjfFJov3JbHyAi,1,0,0,0,0,0,1,0,1,0.14285714285714285,1,0.0,0,0,0,0,0,0,0,1,0,0,1,1
12952,117490,yCzdfwMA9QCcmr5ztirsmSQYamCmcIS7,fbPkOYLVPtPgIt0MxizjfFJov3JbHyAi,1,0,0,0,0,0,1,0,1,0.14285714285714285,1,0.0,0,0,0,0,0,0,0,1,0,0,1,1
12953,117491,WDD9a1qNUJX21r5OnYzYbe9snqA1PiYA,fbPkOYLVPtPgIt0MxizjfFJov3JbHyAi,9,4,3,0,3,0,2,0,12,1.7142857142857142,1,0.0,0,3,0,3,4,0,0,2,0,6,6,1
12954,117492,nsluEqDvvOEPdz5RzSmy7fU8guuqWKfm,fbPkOYLVPtPgIt0MxizjfFJov3JbHyAi,11,11,7,6,5,0,4,0,33,4.714285714285714,2,0.0,1,7,4,5,10,0,2,4,0,17,16,1
12955,117493,Cn5FQ7TJ9erBCpMOguGrs26OG5h6UtTt,fbPkOYLVPtPgIt0MxizjfFJov3JbHyAi,11,12,5,0,4,0,8,0,29,4.142857142857143,3,0.0,2,5,0,4,10,0,0,8,0,11,18,1
12956,117494,bXLdnFxUVQAW3oOCSdQxNLLTqr9NOtgu,fbPkOYLVPtPgIt0MxizjfFJov3JbHyAi,6,1,1,0,1,0,5,0,8,1.1428571428571428,3,0.0,0,1,0,1,1,0,0,5,0,2,6,1
12957,117495,ETdIqr5m0JR2Poccag4YWGY81ays6ejO,fbPkOYLVPtPgIt0MxizjfFJov3JbHyAi,4,2,0,0,0,0,6,0,8,1.1428571428571428,1,0.0,0,0,0,0,2,0,0,6,0,0,8,1
12958,117496,Hoitr98hXhrf7xDGgACEFamKhiarA3wg,fbPkOYLVPtPgIt0MxizjfFJov3JbHyAi,7,4,2,0,2,0,2,0,10,1.4285714285714286,1,0.0,1,2,0,2,3,0,0,2,0,5,5,0
12959,117501,Djtv0PgEw9uZSQc7WiXmZsJgnFOxrvrt,A3fsA9Zfv1X2fVEQhTw51lKENdNrEqT3,1,0,0,0,0,0,1,0,1,0.14285714285714285,1,0.0,0,0,0,0,0,0,0,1,0,0,1,1
12960,117509,ydSu1htsBf3RzcwY9UTcwNk58kfOh1CK,SpATywNh6bZuzm8s1ceuBUnMUAeoAHHw,23,43,2,18,1,0,9,0,73,10.428571428571429,7,0.0,2,2,16,1,41,0,2,9,0,21,52,0
12961,117515,Djtv0PgEw9uZSQc7WiXmZsJgnFOxrvrt,RXDvfPUBYFlVdlueBFbLW0mhhAyGEqpt,1,0,0,0,0,0,2,0,2,0.2857142857142857,2,0.0,0,0,0,0,0,0,0,2,0,0,2,1
12962,117517,s6b6Agzyi3Or4EEcsJYYkdvPZgCCL57f,A3fsA9Zfv1X2fVEQhTw51lKENdNrEqT3,20,14,9,0,7,0,7,0,37,5.285714285714286,2,0.0,0,9,0,7,14,0,0,7,0,16,21,1
12963,117534,qX3w4IgztgXyu9swieirFObama3kJyza,bWdj2GDclj5ofokWjzoa5jAwMkxCykd6,24,37,4,70,6,0,12,0,129,18.428571428571427,4,0.0,13,4,64,6,24,0,6,12,0,87,42,1
12964,117535,dB6JlfpSJir7ay6MgDMKvaO3E6lmbl8u,bWdj2GDclj5ofokWjzoa5jAwMkxCykd6,5,7,0,0,0,0,1,0,8,1.1428571428571428,1,0.0,0,0,0,0,7,0,0,1,0,0,8,1
12965,117536,f07Kut7kBpGHis5iRAbMzHKfd6CS5vLr,A3fsA9Zfv1X2fVEQhTw51lKENdNrEqT3,32,144,96,2,4,430,69,3,748,106.85714285714286,13,0.0,11,96,1,4,133,430,1,69,3,112,636,0
12966,117543,EX3gOxFqlG8z0KCJnBCBLiCIiQRkFF4q,bWdj2GDclj5ofokWjzoa5jAwMkxCykd6,4,1,0,0,0,0,4,0,5,0.7142857142857143,1,0.0,0,0,0,0,1,0,0,4,0,0,5,1
12967,117545,EX3gOxFqlG8z0KCJnBCBLiCIiQRkFF4q,G8EPVSXsOYB5YQWZGiz1aVq5Pgr2GrQu,15,8,4,8,3,0,6,0,29,4.142857142857143,1,0.0,3,4,5,3,5,0,3,6,0,15,14,1
12968,117546,EX3gOxFqlG8z0KCJnBCBLiCIiQRkFF4q,A3fsA9Zfv1X2fVEQhTw51lKENdNrEqT3,9,3,2,0,2,0,4,0,11,1.5714285714285714,1,0.0,0,2,0,2,3,0,0,4,0,4,7,1
12969,117552,wKSiPD3ccCI47tDYWhx56Wd2BJP8ki2L,SpATywNh6bZuzm8s1ceuBUnMUAeoAHHw,26,71,16,11,10,18,13,0,139,19.857142857142858,9,0.0,14,16,11,10,57,18,0,13,0,51,88,0
12970,117557,Z9nbZek76s4RBuA56w1WtME3e9ClZkaP,SpATywNh6bZuzm8s1ceuBUnMUAeoAHHw,44,32,23,31,15,23,6,2,132,18.857142857142858,2,0.0,7,23,25,15,25,23,6,6,2,70,62,0
12971,117561,ADL0cXowUMs4wyiAOHKMOrtTHu5tmUqi,A3fsA9Zfv1X2fVEQhTw51lKENdNrEqT3,39,34,18,100,1,0,29,0,182,26.0,10,0.0,2,18,93,1,32,0,7,29,0,114,68,0
12972,117563,W5xQOH5MemwXn7klqn6rjd1MM4WzuzQi,SpATywNh6bZuzm8s1ceuBUnMUAeoAHHw,45,39,21,36,12,0,13,0,121,17.285714285714285,6,0.0,13,21,32,12,26,0,4,13,0,78,43,0
12973,117564,ADL0cXowUMs4wyiAOHKMOrtTHu5tmUqi,5X6FeZozNMgE2VRi3MJYjkkFK8SETtu2,18,16,7,10,5,2,12,1,53,7.571428571428571,5,0.0,5,7,10,5,11,2,0,12,1,27,26,1
12974,117573,0i4PCdH5yACfB3MbD4JgsC2DeGE0OI6C,SpATywNh6bZuzm8s1ceuBUnMUAeoAHHw,5,3,2,0,1,0,1,0,7,1.0,1,0.0,0,2,0,1,3,0,0,1,0,3,4,1
12975,117586,23MV7Tf2OIT2UG3xeA8mvmRw6rIFBd81,A3fsA9Zfv1X2fVEQhTw51lKENdNrEqT3,30,27,20,6,13,8,22,2,98,14.0,4,0.0,0,20,6,13,27,8,0,22,2,39,59,1
12976,117602,BcsAFxTYYWhC1bNDfK977UfoS17oCWvP,SpATywNh6bZuzm8s1ceuBUnMUAeoAHHw,35,66,4,38,0,6,15,2,131,18.714285714285715,6,0.0,22,4,32,0,44,6,6,15,2,58,73,0
12977,117611,BbvGM92sGSMMIrRMXDFdD1GEnySzXRYT,SpATywNh6bZuzm8s1ceuBUnMUAeoAHHw,29,78,7,32,3,0,17,0,137,19.571428571428573,13,0.0,13,7,30,3,65,0,2,17,0,53,84,0
12978,117616,GLClE8eg40BpWvmEfcSMwSvtSTOkzETn,SpATywNh6bZuzm8s1ceuBUnMUAeoAHHw,34,61,8,44,4,5,16,0,138,19.714285714285715,9,0.0,12,8,39,4,49,5,5,16,0,63,75,0
12979,117626,wj1Ce3w6RyUCBwI2hTV32GMvTMsHncyy,SpATywNh6bZuzm8s1ceuBUnMUAeoAHHw,14,11,5,17,3,0,2,0,38,5.428571428571429,1,0.0,5,5,15,3,6,0,2,2,0,28,10,1
12980,117653,xdxiKeJYKflgdr88D3HSJXuR1e81YpjG,A3fsA9Zfv1X2fVEQhTw51lKENdNrEqT3,25,21,16,0,11,0,7,0,55,7.857142857142857,4,0.0,0,16,0,11,21,0,0,7,0,27,28,1
12981,117662,1ujJ0EpnNLNXPSSRc7XEx7I0RReWnlus,SpATywNh6bZuzm8s1ceuBUnMUAeoAHHw,9,7,1,3,0,0,3,0,14,2.0,2,0.0,0,1,3,0,7,0,0,3,0,4,10,1
12982,117664,wbMM6yL6hpsJkBDUrCRoi5Fuo2kgSUdK,SpATywNh6bZuzm8s1ceuBUnMUAeoAHHw,22,25,1,14,1,0,3,0,44,6.285714285714286,4,0.0,7,1,14,1,18,0,0,3,0,23,21,1
12983,117668,ZvlB6WVwV84B3g1S1DABzlXirXgL69kV,SpATywNh6bZuzm8s1ceuBUnMUAeoAHHw,14,16,5,19,4,0,13,0,57,8.142857142857142,6,0.0,11,5,16,4,5,0,3,13,0,36,21,1
12984,117669,3xN41ERTxK2f1CGWRDLSjBdLqp0aeXRu,SpATywNh6bZuzm8s1ceuBUnMUAeoAHHw,26,93,32,37,2,76,55,10,305,43.57142857142857,7,0.0,22,32,32,2,71,76,5,55,10,88,217,1
12985,117674,5MqtNGumkUVehW5cfaAfZ7nPmHPSTQ7V,bWdj2GDclj5ofokWjzoa5jAwMkxCykd6,1,0,0,0,0,0,1,0,1,0.14285714285714285,1,0.0,0,0,0,0,0,0,0,1,0,0,1,1
12986,117698,JjO25OOm89Iye7MTZHSNIwd1wvv7Llpy,bWdj2GDclj5ofokWjzoa5jAwMkxCykd6,8,2,1,0,1,2,8,1,15,2.142857142857143,2,0.0,0,1,0,1,2,2,0,8,1,2,13,1
12987,117703,70SrKRY1oWl5d62cNgc8OZe8Ra3cen1a,SpATywNh6bZuzm8s1ceuBUnMUAeoAHHw,34,102,3,37,1,38,28,1,210,30.0,12,0.0,43,3,32,1,59,38,5,28,1,79,131,0
12988,117724,IspEVPShBbjx8d4IihOvyrT9DEmhjxUS,SpATywNh6bZuzm8s1ceuBUnMUAeoAHHw,1,0,0,0,0,0,2,0,2,0.2857142857142857,1,0.0,0,0,0,0,0,0,0,2,0,0,2,1
12989,117730,ZRcEnEYSSBQbkjzMu7sidjbxasfrmw8l,A3fsA9Zfv1X2fVEQhTw51lKENdNrEqT3,65,73,36,150,2,0,15,0,276,39.42857142857143,5,0.0,4,36,125,2,69,0,25,15,0,167,109,0
12990,117732,cQJEH4N9NA86ElT2x4zkE6ToN6rVT4MQ,A3fsA9Zfv1X2fVEQhTw51lKENdNrEqT3,41,34,32,18,23,0,3,0,110,15.714285714285714,4,0.0,0,32,16,23,34,0,2,3,0,71,39,1
12991,117744,UqgvfgWyOQuTxiMgyBKfmUFRwGDD6lWb,SpATywNh6bZuzm8s1ceuBUnMUAeoAHHw,9,8,4,0,2,0,2,0,16,2.2857142857142856,1,0.0,3,4,0,2,5,0,0,2,0,9,7,0
12992,117749,yNygMjDRQbsmQrkdzv6Ni3gEhrA9rC9T,G8EPVSXsOYB5YQWZGiz1aVq5Pgr2GrQu,11,28,15,6,2,0,6,0,57,8.142857142857142,4,0.0,7,15,3,2,21,0,3,6,0,27,30,1
12993,117763,VeWfrT5492g1p7PzRa92mFX1sE44kxoq,bWdj2GDclj5ofokWjzoa5jAwMkxCykd6,5,2,1,0,1,0,2,0,6,0.8571428571428571,1,0.0,0,1,0,1,2,0,0,2,0,2,4,1
12994,117776,8EDi9ELIY5NaafGr5ul94OArAKYSlPLk,SpATywNh6bZuzm8s1ceuBUnMUAeoAHHw,36,60,30,41,13,3,18,0,165,23.571428571428573,6,0.0,20,30,39,13,40,3,2,18,0,102,63,0
12995,117782,usFuTvFQpKrRjDwn3CiAVcIq4WWtoKl0,RXDvfPUBYFlVdlueBFbLW0mhhAyGEqpt,84,145,95,170,66,153,97,86,812,116.0,17,0.0,24,95,159,66,121,153,11,97,86,344,468,0
12996,117794,koupoV2Bo5oQSD6MVvXaJhUITtX0e3bf,bWdj2GDclj5ofokWjzoa5jAwMkxCykd6,10,10,7,0,5,2,13,2,39,5.571428571428571,1,0.0,0,7,0,5,10,2,0,13,2,12,27,1
12997,117796,2HxuGhGQGzCNLHdg582isvj2k1uv2pCi,SpATywNh6bZuzm8s1ceuBUnMUAeoAHHw,31,105,5,29,3,36,28,4,210,30.0,3,0.0,54,5,27,3,51,36,2,28,4,89,121,0
12998,117802,n4PMPT9vVmStYaQ48auvwvWym2rE6F0p,bWdj2GDclj5ofokWjzoa5jAwMkxCykd6,1,0,0,0,0,0,1,0,1,0.14285714285714285,1,0.0,0,0,0,0,0,0,0,1,0,0,1,1
12999,117813,wKbSE55kexrWAbxmePgEr4VHk4YSiEaC,A3fsA9Zfv1X2fVEQhTw51lKENdNrEqT3,1,0,0,0,0,0,1,0,1,0.14285714285714285,1,0.0,0,0,0,0,0,0,0,1,0,0,1,1
13000,117830,2RJ8BBRkfXWUgOvINgxOSXP2ac2oP7fh,SpATywNh6bZuzm8s1ceuBUnMUAeoAHHw,8,7,3,0,1,0,6,0,17,2.4285714285714284,1,0.0,2,3,0,1,5,0,0,6,0,6,11,1
13001,117833,sDtEwaD6losyMUPLsmLS1gJz6VpRuXBt,G8EPVSXsOYB5YQWZGiz1aVq5Pgr2GrQu,6,3,1,0,1,0,2,0,7,1.0,1,0.0,0,1,0,1,3,0,0,2,0,2,5,1
13002,117834,R81t3oSweiKsqxrzFQTifbMpcqBh0IJe,SpATywNh6bZuzm8s1ceuBUnMUAeoAHHw,6,3,1,0,1,0,2,0,7,1.0,1,0.0,0,1,0,1,3,0,0,2,0,2,5,1
13003,117838,E6GtLgX3I7VGOpV74LvaV5V5J9ND1jUQ,SpATywNh6bZuzm8s1ceuBUnMUAeoAHHw,8,14,6,0,2,0,7,0,29,4.142857142857143,5,0.0,0,6,0,2,14,0,0,7,0,8,21,1
13004,117865,57P5UbCfzn8GLpyzVkqMDPp8kp3hFIaz,bWdj2GDclj5ofokWjzoa5jAwMkxCykd6,15,49,11,0,5,0,12,0,77,11.0,8,0.0,0,11,0,5,49,0,0,12,0,16,61,1
13005,117866,o7ztEzN1VLXMPiKeM3Eu4FDhVLhHjR47,A3fsA9Zfv1X2fVEQhTw51lKENdNrEqT3,19,14,11,0,7,35,10,0,77,11.0,2,0.0,0,11,0,7,14,35,0,10,0,18,59,1
13006,117906,NoA9xueUUthCTfidqnFplOKsMZsY3DHa,A3fsA9Zfv1X2fVEQhTw51lKENdNrEqT3,43,29,20,68,10,0,11,0,138,19.714285714285715,6,0.0,2,20,62,10,27,0,6,11,0,94,44,1
13007,117907,Z3bFvTwttDZ4bCfkqeyPSBE9NPAPKPqN,SpATywNh6bZuzm8s1ceuBUnMUAeoAHHw,20,71,7,36,0,1,16,0,131,18.714285714285715,8,0.0,21,7,32,0,50,1,4,16,0,60,71,0
13008,117908,hDWTDNoM8bIQS3Q25EYxxHniqW2wmxDn,5X6FeZozNMgE2VRi3MJYjkkFK8SETtu2,9,19,4,10,3,0,2,0,38,5.428571428571429,1,0.0,7,4,9,3,12,0,1,2,0,23,15,1
13009,117910,QtoTN2OyyTcqe6Us4ENFLFoSg3hJkA40,SpATywNh6bZuzm8s1ceuBUnMUAeoAHHw,38,121,6,48,3,25,38,2,243,34.714285714285715,10,0.0,35,6,40,3,86,25,8,38,2,84,159,0
13010,117917,ch9tY2TtGdyg7x6KOapt9NQCSfX2sV8p,SpATywNh6bZuzm8s1ceuBUnMUAeoAHHw,2,0,0,0,0,0,2,0,2,0.2857142857142857,1,0.0,0,0,0,0,0,0,0,2,0,0,2,1
13011,117920,Tsqz3H4jIOz4dWir6zrZDbKSFYTGo0K7,G8EPVSXsOYB5YQWZGiz1aVq5Pgr2GrQu,32,81,11,46,9,1,36,3,187,26.714285714285715,5,0.0,11,11,40,9,70,1,6,36,3,71,116,0
13012,117927,M45J6fNUaggda3LzoFU6r4v9Do7R8HkV,bWdj2GDclj5ofokWjzoa5jAwMkxCykd6,53,162,104,36,25,22,29,2,380,54.285714285714285,9,0.0,28,104,19,25,134,22,17,29,2,176,204,0
13013,117931,2FyRSMemMx0WQNXDNdLObUL8ox2VWXod,G8EPVSXsOYB5YQWZGiz1aVq5Pgr2GrQu,2,0,0,0,0,0,3,0,3,0.42857142857142855,2,0.0,0,0,0,0,0,0,0,3,0,0,3,1
13014,117940,JYCXGTBUXKAgLYAuYSVkBAkWpoJ7TYUE,G8EPVSXsOYB5YQWZGiz1aVq5Pgr2GrQu,70,103,46,142,12,57,64,4,428,61.142857142857146,14,0.0,31,46,95,12,72,57,47,64,4,184,244,0
13015,117944,Lx03w1Z7uki61iSuRTBJrJMgf0kqOIrF,SpATywNh6bZuzm8s1ceuBUnMUAeoAHHw,31,31,13,25,8,7,15,2,101,14.428571428571429,3,0.0,12,13,21,8,19,7,4,15,2,54,47,0
13016,117946,yXqCA1yQnzskdA15yvjJGzN0ZJtznFpO,RXDvfPUBYFlVdlueBFbLW0mhhAyGEqpt,35,63,7,68,6,0,15,0,159,22.714285714285715,6,0.0,11,7,68,6,52,0,0,15,0,92,67,1
13017,117948,1AlOrbJ2y8dS4ycbJ2sP2OTCfMGEqZ01,SpATywNh6bZuzm8s1ceuBUnMUAeoAHHw,34,74,33,54,13,28,24,2,228,32.57142857142857,6,0.0,24,33,41,13,50,28,13,24,2,111,117,0
13018,117952,bAb84TA4vcs2wtZNieDCHeBDjeqCrQIp,SpATywNh6bZuzm8s1ceuBUnMUAeoAHHw,1,0,0,0,0,0,1,0,1,0.14285714285714285,1,0.0,0,0,0,0,0,0,0,1,0,0,1,1
13019,117954,jFYWygr5nLqLhHkXltZRkT0S1zQoLEVR,SpATywNh6bZuzm8s1ceuBUnMUAeoAHHw,41,38,20,34,11,0,6,0,109,15.571428571428571,4,0.0,9,20,30,11,29,0,4,6,0,70,39,0
13020,117963,YMxXtA5A6XX1bdm998q3OXZqnuIpo8I0,5X6FeZozNMgE2VRi3MJYjkkFK8SETtu2,1,0,0,0,0,0,1,0,1,0.14285714285714285,1,0.0,0,0,0,0,0,0,0,1,0,0,1,1
13021,117985,LL81eYdCoRvNJLX5R1NjId0q1BUIEnQb,SpATywNh6bZuzm8s1ceuBUnMUAeoAHHw,2,0,0,0,0,0,2,0,2,0.2857142857142857,1,0.0,0,0,0,0,0,0,0,2,0,0,2,1
13022,117998,NbBykb0b9cShqzgiHDyBRNbubH18qJTN,SpATywNh6bZuzm8s1ceuBUnMUAeoAHHw,7,3,2,0,2,0,2,0,9,1.2857142857142858,1,0.0,0,2,0,2,3,0,0,2,0,4,5,1
13023,118025,DBl0Whn7bz7gT7myQMnidYa3zRNL4McA,SpATywNh6bZuzm8s1ceuBUnMUAeoAHHw,18,64,23,44,0,20,18,3,172,24.571428571428573,7,0.0,28,23,38,0,36,20,6,18,3,89,83,1
13024,118032,VE9HD5yzeCmqc2pNGfTQWsVbRdaqJBIV,A3fsA9Zfv1X2fVEQhTw51lKENdNrEqT3,4,2,1,0,1,0,1,0,5,0.7142857142857143,1,0.0,0,1,0,1,2,0,0,1,0,2,3,1
13025,118033,86F6XnjIRLQFbYrnQo4SUAq6YeqsWqJH,SpATywNh6bZuzm8s1ceuBUnMUAeoAHHw,20,22,12,15,5,26,19,17,116,16.571428571428573,3,0.0,5,12,12,5,17,26,3,19,17,34,82,1
13026,118043,ZfEmNtZnnnOMQU2ZxafVmay1LudDsU5A,bWdj2GDclj5ofokWjzoa5jAwMkxCykd6,11,15,2,0,2,1,10,1,31,4.428571428571429,3,0.0,2,2,0,2,13,1,0,10,1,6,25,0
13027,118051,PHrtg3UspIdS1qc6Vp5GAq4YFnlF3cc7,G8EPVSXsOYB5YQWZGiz1aVq5Pgr2GrQu,13,30,9,10,4,0,6,0,59,8.428571428571429,4,0.0,9,9,6,4,21,0,4,6,0,28,31,1
13028,118068,pXBqbLwIa6tUreJmexqQxucHgaflXECZ,5X6FeZozNMgE2VRi3MJYjkkFK8SETtu2,2,0,0,0,0,0,2,0,2,0.2857142857142857,1,0.0,0,0,0,0,0,0,0,2,0,0,2,1
13029,118070,nqDX1tmEeTnbqCn9T8Crn5CYQgmIy9Eq,RXDvfPUBYFlVdlueBFbLW0mhhAyGEqpt,48,70,43,91,14,34,15,0,267,38.142857142857146,4,0.0,15,43,83,14,55,34,8,15,0,155,112,0
13030,118081,E0Vc68zQyaBo1QGFDy3X2ztIvkjoKV3F,SpATywNh6bZuzm8s1ceuBUnMUAeoAHHw,4,3,0,0,0,0,1,0,4,0.5714285714285714,1,0.0,0,0,0,0,3,0,0,1,0,0,4,1
13031,118083,hJwtwnOzJaTrAeP4eXJAEwz2xbKsgc4M,SpATywNh6bZuzm8s1ceuBUnMUAeoAHHw,4,2,0,0,0,0,16,0,18,2.5714285714285716,12,0.0,0,0,0,0,2,0,0,16,0,0,18,0
13032,118101,bwCuicApqXH6S91HqGdXTXLfYA9d5SDK,SpATywNh6bZuzm8s1ceuBUnMUAeoAHHw,30,29,0,28,0,0,10,0,67,9.571428571428571,3,0.0,8,0,26,0,21,0,2,10,0,34,33,0
13033,118122,kQLFlWsDSg3FfLQ3EFfSSjFDdN5HLm8p,SpATywNh6bZuzm8s1ceuBUnMUAeoAHHw,6,6,1,0,0,0,1,0,8,1.1428571428571428,1,0.0,0,1,0,0,6,0,0,1,0,1,7,1
13034,118124,11qZqrXXcQbdqet0TC5DW03t5yp66Tzn,SpATywNh6bZuzm8s1ceuBUnMUAeoAHHw,43,28,19,27,12,0,8,0,94,13.428571428571429,5,0.0,6,19,27,12,22,0,0,8,0,64,30,0
13035,118135,JMvgr9jBzvLjspIkuYALsrL220eD0j0v,bWdj2GDclj5ofokWjzoa5jAwMkxCykd6,8,4,3,0,3,0,6,0,16,2.2857142857142856,1,0.0,0,3,0,3,4,0,0,6,0,6,10,1
13036,118136,9YxIQGUlsiIIuBjadM8J3jzezyJ6kq36,G8EPVSXsOYB5YQWZGiz1aVq5Pgr2GrQu,4,2,0,0,0,0,2,0,4,0.5714285714285714,1,0.0,0,0,0,0,2,0,0,2,0,0,4,1
13037,118139,MCdk5fbqZJDVd57ZlCNh9qbInGbcl8Me,5X6FeZozNMgE2VRi3MJYjkkFK8SETtu2,18,31,9,14,16,0,9,0,79,11.285714285714286,2,0.0,17,9,13,16,14,0,1,9,0,55,24,1
13038,118145,CUEyHbsjLlbX6I7tsbnNjxFI1v5Lj4iD,SpATywNh6bZuzm8s1ceuBUnMUAeoAHHw,34,99,39,10,23,0,22,0,193,27.571428571428573,9,0.0,3,39,10,23,96,0,0,22,0,75,118,0
13039,118153,UwereIH21fVhvJGOSErkxB1cQ9i013xS,SpATywNh6bZuzm8s1ceuBUnMUAeoAHHw,9,8,5,0,2,1,7,3,26,3.7142857142857144,4,0.0,0,5,0,2,8,1,0,7,3,7,19,0
13040,118159,Wwe1S3XdwkCpnmMkWe7RNAVs8cVL63mN,RXDvfPUBYFlVdlueBFbLW0mhhAyGEqpt,11,14,1,0,1,0,5,0,21,3.0,1,0.0,0,1,0,1,14,0,0,5,0,2,19,1
13041,118165,cQJEH4N9NA86ElT2x4zkE6ToN6rVT4MQ,RXDvfPUBYFlVdlueBFbLW0mhhAyGEqpt,19,19,15,16,7,0,3,0,60,8.571428571428571,5,0.0,2,15,15,7,17,0,1,3,0,39,21,1
13042,118171,U3R4m4eLMm2lirgI7HLueBKsNpxhFpn9,A3fsA9Zfv1X2fVEQhTw51lKENdNrEqT3,15,19,12,4,3,0,7,0,45,6.428571428571429,7,0.0,1,12,4,3,18,0,0,7,0,20,25,0
13043,118178,qAVFbR5cx9X92KNDPDJmLoSTth8nEsRM,RXDvfPUBYFlVdlueBFbLW0mhhAyGEqpt,103,158,62,264,21,79,49,2,635,90.71428571428571,18,0.0,27,62,242,21,131,79,22,49,2,352,283,0
13044,118201,P6CjwZWiHeS0SJlPQAf4bN1TR1u7fnyP,bWdj2GDclj5ofokWjzoa5jAwMkxCykd6,1,0,0,0,0,0,1,0,1,0.14285714285714285,1,0.0,0,0,0,0,0,0,0,1,0,0,1,1
13045,118207,K1IFYdQkJo7QdfpjXetMWMiwm2r5nqZr,SpATywNh6bZuzm8s1ceuBUnMUAeoAHHw,5,3,1,0,0,0,3,0,7,1.0,1,0.0,0,1,0,0,3,0,0,3,0,1,6,1
13046,118209,5R4HgbQ9BkBXMi8Hq5UrA8kCLhbx6Nxh,SpATywNh6bZuzm8s1ceuBUnMUAeoAHHw,21,15,11,9,6,0,2,0,43,6.142857142857143,2,0.0,0,11,7,6,15,0,2,2,0,24,19,1
13047,118220,XzisIBOnMp6oTIH0sCLKHdwnfcGCSxLi,SpATywNh6bZuzm8s1ceuBUnMUAeoAHHw,5,2,1,0,1,0,4,0,8,1.1428571428571428,1,0.0,0,1,0,1,2,0,0,4,0,2,6,1
13048,118222,IONYwfWuSLUzRHMHVpaPTPvGauCNosjD,SpATywNh6bZuzm8s1ceuBUnMUAeoAHHw,15,74,48,4,30,1,17,0,174,24.857142857142858,7,0.0,10,48,3,30,64,1,1,17,0,91,83,1
13049,118237,rT3zpA0g6rjJ1jZXfn6mCIcHmMcmU756,SpATywNh6bZuzm8s1ceuBUnMUAeoAHHw,6,8,6,0,3,8,3,0,28,4.0,2,0.0,0,6,0,3,8,8,0,3,0,9,19,1
13050,118241,5R4HgbQ9BkBXMi8Hq5UrA8kCLhbx6Nxh,G8EPVSXsOYB5YQWZGiz1aVq5Pgr2GrQu,8,4,3,0,3,0,1,0,11,1.5714285714285714,1,0.0,0,3,0,3,4,0,0,1,0,6,5,1
13051,118247,j7aoEpW6aHY6ARo8v41e8m4DhCg6TYM9,SpATywNh6bZuzm8s1ceuBUnMUAeoAHHw,20,19,9,5,7,0,3,0,43,6.142857142857143,1,0.0,2,9,4,7,17,0,1,3,0,22,21,1
13052,118260,5rpYxIaCTDb4PhszkJWpACOx5VMpNGcQ,A3fsA9Zfv1X2fVEQhTw51lKENdNrEqT3,54,23,18,82,13,31,23,4,194,27.714285714285715,6,0.0,1,18,68,13,22,31,14,23,4,100,94,1
13053,118265,TEIb1UAPMCR88ygV44aJQSA84qq0H3a7,5X6FeZozNMgE2VRi3MJYjkkFK8SETtu2,7,21,0,11,1,0,5,0,38,5.428571428571429,2,0.0,6,0,9,1,15,0,2,5,0,16,22,0
13054,118267,GyWTABuPpZEqO585EnNTIpM2B2faPYN3,SpATywNh6bZuzm8s1ceuBUnMUAeoAHHw,29,33,20,14,14,2,4,0,87,12.428571428571429,2,0.0,11,20,14,14,22,2,0,4,0,59,28,1
13055,118277,LULTOx14kVdHaym020tyvEUUMDRXiDOf,SpATywNh6bZuzm8s1ceuBUnMUAeoAHHw,8,10,6,0,1,0,10,0,27,3.857142857142857,3,0.0,0,6,0,1,10,0,0,10,0,7,20,1
13056,118284,iRkGn6DaWx0LZKTkLTjixCrksMnftQiz,SpATywNh6bZuzm8s1ceuBUnMUAeoAHHw,13,14,1,12,1,0,2,0,30,4.285714285714286,2,0.0,2,1,10,1,12,0,2,2,0,14,16,1
13057,118295,wlSHoMLYlXnNV9DeRulnbWIuryuBkIhv,RXDvfPUBYFlVdlueBFbLW0mhhAyGEqpt,1,0,0,0,0,0,1,0,1,0.14285714285714285,1,0.0,0,0,0,0,0,0,0,1,0,0,1,1
13058,118297,jSCfroddrqNUSCH6KjU0nXMDCSxYb3do,A3fsA9Zfv1X2fVEQhTw51lKENdNrEqT3,1,0,0,0,0,0,1,0,1,0.14285714285714285,1,0.0,0,0,0,0,0,0,0,1,0,0,1,1
13059,118321,vCel5g8zGhrngsDNZ5YOyxEmQk5qV7ac,bWdj2GDclj5ofokWjzoa5jAwMkxCykd6,9,14,0,0,1,5,8,1,29,4.142857142857143,4,0.0,5,0,0,1,9,5,0,8,1,6,23,1
13060,118324,QRV1oI1S8Ffuh8TqoOSVsQ6W4xedCLat,SpATywNh6bZuzm8s1ceuBUnMUAeoAHHw,4,12,1,0,0,0,4,0,17,2.4285714285714284,4,0.0,0,1,0,0,12,0,0,4,0,1,16,0
13061,118328,oyFfPK6y9oPPwQR5mbsXW98FJaEnU88b,RXDvfPUBYFlVdlueBFbLW0mhhAyGEqpt,24,19,14,25,8,0,2,0,68,9.714285714285714,2,0.0,2,14,22,8,17,0,3,2,0,46,22,1
13062,118336,50cUUtrBaOZeeifZra0Sj4seKRuBEyFS,SpATywNh6bZuzm8s1ceuBUnMUAeoAHHw,29,113,15,41,5,2,12,1,189,27.0,15,0.0,46,15,34,5,67,2,7,12,1,100,89,0
13063,118363,FOCCuGaJ7zYTl7CCCo7T3PqrLtxGVeiU,SpATywNh6bZuzm8s1ceuBUnMUAeoAHHw,44,57,16,43,9,8,20,2,155,22.142857142857142,7,0.0,15,16,36,9,42,8,7,20,2,76,79,0
13064,118375,iCakYP1w40pz3A1o7VgcbnomKTMQfUiT,SpATywNh6bZuzm8s1ceuBUnMUAeoAHHw,13,9,6,0,5,0,2,0,22,3.142857142857143,2,0.0,0,6,0,5,9,0,0,2,0,11,11,1
13065,118395,LVTU4qA4F3wWkxH81iGfu4ZuIt77nyhh,A3fsA9Zfv1X2fVEQhTw51lKENdNrEqT3,9,15,4,0,2,1,14,0,36,5.142857142857143,4,0.0,0,4,0,2,15,1,0,14,0,6,30,0
13066,118399,DMK7oEoztjNgXbVpWXavlWU4oVL3bMJ2,bWdj2GDclj5ofokWjzoa5jAwMkxCykd6,1,0,0,0,0,0,1,0,1,0.14285714285714285,1,0.0,0,0,0,0,0,0,0,1,0,0,1,1
13067,118423,9iGaqBGS5kkoXjLd87hUL2eIJMVUVKfU,bWdj2GDclj5ofokWjzoa5jAwMkxCykd6,6,8,4,0,2,0,4,0,18,2.5714285714285716,3,0.0,0,4,0,2,8,0,0,4,0,6,12,1
13068,118427,ycOAtB1gwFcaAwvsqsJPeGAqm0EVwIDN,G8EPVSXsOYB5YQWZGiz1aVq5Pgr2GrQu,22,25,9,16,6,0,18,0,74,10.571428571428571,3,0.0,11,9,14,6,14,0,2,18,0,40,34,1
13069,118432,LFsOk9gu14yLVtdY9pNmboBkRA6YhVq4,SpATywNh6bZuzm8s1ceuBUnMUAeoAHHw,1,0,0,0,0,0,2,0,2,0.2857142857142857,2,0.0,0,0,0,0,0,0,0,2,0,0,2,1
13070,118433,U4egSBuIz4Tp2aExbhUIhaem6H1lHi4I,A3fsA9Zfv1X2fVEQhTw51lKENdNrEqT3,1,0,0,0,0,0,1,0,1,0.14285714285714285,1,0.0,0,0,0,0,0,0,0,1,0,0,1,0
13071,118453,X285XxvFlCKmuDlV3vzMxZpCu1V9X67P,G8EPVSXsOYB5YQWZGiz1aVq5Pgr2GrQu,34,54,29,46,15,0,6,0,150,21.428571428571427,3,0.0,20,29,39,15,34,0,7,6,0,103,47,1
13072,118464,zGN54ktgVO57s42kNnMz1KyURivx1q9t,bWdj2GDclj5ofokWjzoa5jAwMkxCykd6,1,0,0,0,0,0,1,0,1,0.14285714285714285,1,0.0,0,0,0,0,0,0,0,1,0,0,1,1
13073,118469,HlHSVt6QwV3D8zM3oQa4RZqHTHgBTeDb,G8EPVSXsOYB5YQWZGiz1aVq5Pgr2GrQu,7,4,3,0,0,1,6,1,15,2.142857142857143,2,0.0,0,3,0,0,4,1,0,6,1,3,12,1
13074,118484,grhneBVDCBhvBD53OXACTDGfdH3pEWQ2,SpATywNh6bZuzm8s1ceuBUnMUAeoAHHw,34,69,6,40,0,1,16,1,133,19.0,12,0.0,17,6,33,0,52,1,7,16,1,56,77,0
13075,118497,D42av4RgpD46CqlOrc3UqYUQGU69fX7w,SpATywNh6bZuzm8s1ceuBUnMUAeoAHHw,14,22,11,7,7,0,1,0,48,6.857142857142857,3,0.0,0,11,6,7,22,0,1,1,0,24,24,1
13076,118502,3LQaIdIg6rrcDyh404eeBez61pVLg6z4,5X6FeZozNMgE2VRi3MJYjkkFK8SETtu2,1,0,0,0,0,0,1,0,1,0.14285714285714285,1,0.0,0,0,0,0,0,0,0,1,0,0,1,1
13077,118503,AT8SDkvzrK4J3OL7I6ScWwycekA3DBUB,bWdj2GDclj5ofokWjzoa5jAwMkxCykd6,2,0,0,0,0,0,3,0,3,0.42857142857142855,1,0.0,0,0,0,0,0,0,0,3,0,0,3,1
13078,118510,JfftjOGdDbpgbrupi0Gwr899R0jzXikJ,5X6FeZozNMgE2VRi3MJYjkkFK8SETtu2,4,3,2,0,2,0,2,0,9,1.2857142857142858,1,0.0,0,2,0,2,3,0,0,2,0,4,5,1
13079,118517,AADHk2CnqIXqU54SVoJYYzHXkzsT7VVX,SpATywNh6bZuzm8s1ceuBUnMUAeoAHHw,50,215,99,100,4,66,60,25,569,81.28571428571429,12,0.0,74,99,84,4,141,66,16,60,25,261,308,0
13080,118525,ZPaxHFRYfWHILqdYYtzCUV3i0tOspO75,SpATywNh6bZuzm8s1ceuBUnMUAeoAHHw,9,3,2,0,1,3,10,2,21,3.0,1,0.0,0,2,0,1,3,3,0,10,2,3,18,1
13081,118542,bwCuicApqXH6S91HqGdXTXLfYA9d5SDK,RXDvfPUBYFlVdlueBFbLW0mhhAyGEqpt,1,0,0,0,0,0,1,0,1,0.14285714285714285,1,0.0,0,0,0,0,0,0,0,1,0,0,1,1
13082,118552,bQgvxTEfpKkG7faV4J3DTFNYdIGmaRJn,A3fsA9Zfv1X2fVEQhTw51lKENdNrEqT3,2,0,0,0,0,0,2,0,2,0.2857142857142857,1,0.0,0,0,0,0,0,0,0,2,0,0,2,1
13083,118557,p5WcSuRgNcVvsptKJrB8fiizrHjqBhQI,bWdj2GDclj5ofokWjzoa5jAwMkxCykd6,1,0,0,0,0,0,1,0,1,0.14285714285714285,1,0.0,0,0,0,0,0,0,0,1,0,0,1,1
13084,118561,Go1ERHGiNnYVc6rXpAjttQ9IaXemOnqN,A3fsA9Zfv1X2fVEQhTw51lKENdNrEqT3,4,3,2,0,0,0,1,0,6,0.8571428571428571,1,0.0,0,2,0,0,3,0,0,1,0,2,4,1
13085,118567,TQy9wSoPujib2kvNE4TTZJIA8yQmRsFr,bWdj2GDclj5ofokWjzoa5jAwMkxCykd6,3,5,0,0,0,0,1,0,6,0.8571428571428571,2,0.0,0,0,0,0,5,0,0,1,0,0,6,1
13086,118582,P27ziZ47DXA6Hi97vj6kZGIGFjWpnnsR,SpATywNh6bZuzm8s1ceuBUnMUAeoAHHw,8,4,2,0,2,0,2,0,10,1.4285714285714286,1,0.0,0,2,0,2,4,0,0,2,0,4,6,1
13087,118589,r0yZNwEG828V0TMkCl61Reya5Y5HO5aR,bWdj2GDclj5ofokWjzoa5jAwMkxCykd6,7,11,5,0,1,0,4,0,21,3.0,3,0.0,0,5,0,1,11,0,0,4,0,6,15,0
13088,118592,RiCs84yGV6JCwVfBOhcXa8oCpUMbIJNf,SpATywNh6bZuzm8s1ceuBUnMUAeoAHHw,37,113,5,47,3,40,42,12,262,37.42857142857143,12,0.0,34,5,43,3,79,40,4,42,12,85,177,0
13089,118594,r0yZNwEG828V0TMkCl61Reya5Y5HO5aR,A3fsA9Zfv1X2fVEQhTw51lKENdNrEqT3,3,3,1,0,0,0,2,0,6,0.8571428571428571,1,0.0,0,1,0,0,3,0,0,2,0,1,5,1
13090,118599,tp9GLoYyljDV6mILQxrtrv1Iw4qcPl5Z,A3fsA9Zfv1X2fVEQhTw51lKENdNrEqT3,7,4,2,0,2,0,3,0,11,1.5714285714285714,1,0.0,1,2,0,2,3,0,0,3,0,5,6,1
13091,118611,OPuJXMBkJWOSkPuaVgsFtLgnzHpMTbpE,SpATywNh6bZuzm8s1ceuBUnMUAeoAHHw,7,2,1,0,1,0,4,0,8,1.1428571428571428,1,0.0,0,1,0,1,2,0,0,4,0,2,6,1
13092,118618,TQ8OFVc2xBKvPKyjEssWVNNgqzlZ0PAa,bWdj2GDclj5ofokWjzoa5jAwMkxCykd6,39,67,38,197,15,2,14,0,333,47.57142857142857,8,0.0,11,38,172,15,56,2,25,14,0,236,97,0
13093,118626,sjQQWItXAp5E8ocdOnRRzFCiZKv0PVqn,SpATywNh6bZuzm8s1ceuBUnMUAeoAHHw,28,36,7,22,0,0,8,0,73,10.428571428571429,6,0.0,4,7,21,0,32,0,1,8,0,32,41,0
13094,118627,PpZEAa1Mdati01h1lf363alLOjmVtvBB,bWdj2GDclj5ofokWjzoa5jAwMkxCykd6,5,0,0,0,0,1,4,1,6,0.8571428571428571,1,0.0,0,0,0,0,0,1,0,4,1,0,6,1
13095,118629,f4eElh7NTKGsWnUHRO9BuyTOQtrsnWlM,SpATywNh6bZuzm8s1ceuBUnMUAeoAHHw,17,16,9,19,4,3,7,0,58,8.285714285714286,2,0.0,6,9,17,4,10,3,2,7,0,36,22,1
13096,118633,NuFKQkAxfn2PT3wbGN0i3erkBYbjqkix,A3fsA9Zfv1X2fVEQhTw51lKENdNrEqT3,65,36,2,170,2,2,13,1,226,32.285714285714285,5,0.0,2,2,148,2,34,2,22,13,1,154,72,0
13097,118634,vbghp1PVpZxFaWqasEyQzIEfPKBk8vPh,5X6FeZozNMgE2VRi3MJYjkkFK8SETtu2,1,0,0,0,0,0,1,0,1,0.14285714285714285,1,0.0,0,0,0,0,0,0,0,1,0,0,1,0
13098,118635,U6N64321JOuc5ylM9RcniwscGjdKavd0,bWdj2GDclj5ofokWjzoa5jAwMkxCykd6,1,0,0,0,0,0,1,0,1,0.14285714285714285,1,0.0,0,0,0,0,0,0,0,1,0,0,1,1
13099,118651,ANtHTaCISHkEW6ENLanE6G1HEnRFLZdw,SpATywNh6bZuzm8s1ceuBUnMUAeoAHHw,3,2,1,0,0,0,2,0,5,0.7142857142857143,2,0.0,0,1,0,0,2,0,0,2,0,1,4,1
13100,118653,YmAogTXGoaSGS2jBtwsCLUVebiwWGuMB,A3fsA9Zfv1X2fVEQhTw51lKENdNrEqT3,17,18,15,0,13,4,4,0,54,7.714285714285714,3,0.0,0,15,0,13,18,4,0,4,0,28,26,1
13101,118662,ANtHTaCISHkEW6ENLanE6G1HEnRFLZdw,RXDvfPUBYFlVdlueBFbLW0mhhAyGEqpt,4,4,2,0,0,0,3,0,9,1.2857142857142858,3,0.0,0,2,0,0,4,0,0,3,0,2,7,1
13102,118665,eNgDL8k9xOLyBlZ3UNlseJHly8SfPZZu,A3fsA9Zfv1X2fVEQhTw51lKENdNrEqT3,59,109,77,76,33,45,40,1,381,54.42857142857143,18,0.0,6,77,58,33,103,45,18,40,1,174,207,0
13103,118667,oamKaVYtYcTWlWXxR9gjWFZVaqJSv9QD,RXDvfPUBYFlVdlueBFbLW0mhhAyGEqpt,104,286,8,228,64,6,14,0,606,86.57142857142857,7,0.0,166,8,220,64,120,6,8,14,0,458,148,0
13104,118668,vbghp1PVpZxFaWqasEyQzIEfPKBk8vPh,A3fsA9Zfv1X2fVEQhTw51lKENdNrEqT3,12,7,4,0,4,0,3,0,18,2.5714285714285716,2,0.0,1,4,0,4,6,0,0,3,0,9,9,1
13105,118672,dtI4aHSJprK2Oz02958rC7RUVW99jWdh,SpATywNh6bZuzm8s1ceuBUnMUAeoAHHw,10,5,4,7,2,0,2,0,20,2.857142857142857,1,0.0,0,4,6,2,5,0,1,2,0,12,8,1
13106,118673,NAeglY8cYFpzQKpSfjAgfrtdD2qzmpB5,5X6FeZozNMgE2VRi3MJYjkkFK8SETtu2,5,2,1,0,1,0,3,0,7,1.0,1,0.0,0,1,0,1,2,0,0,3,0,2,5,1
13107,118691,DvqqmzfQOqhniG6rRYaSYRCVzVLc6KPG,A3fsA9Zfv1X2fVEQhTw51lKENdNrEqT3,5,3,2,0,1,0,1,0,7,1.0,1,0.0,0,2,0,1,3,0,0,1,0,3,4,1
13108,118692,34Xbf7uBGJ4LnJBXPtvvptwjUQQdkYUg,A3fsA9Zfv1X2fVEQhTw51lKENdNrEqT3,100,150,62,184,19,10,69,3,497,71.0,11,0.0,10,62,164,19,140,10,20,69,3,255,242,0
13109,118695,DvqqmzfQOqhniG6rRYaSYRCVzVLc6KPG,bWdj2GDclj5ofokWjzoa5jAwMkxCykd6,4,3,1,0,1,0,2,0,7,1.0,2,0.0,1,1,0,1,2,0,0,2,0,3,4,1
13110,118697,xMj985YGbnpmmaLLf9WHP3PHD8Af4HUa,SpATywNh6bZuzm8s1ceuBUnMUAeoAHHw,7,2,1,0,1,0,6,1,11,1.5714285714285714,1,0.0,0,1,0,1,2,0,0,6,1,2,9,1
13111,118711,uIfDz0U6olmuGEmtRQWevpWq94B8FOe9,SpATywNh6bZuzm8s1ceuBUnMUAeoAHHw,5,2,1,0,1,0,2,0,6,0.8571428571428571,1,0.0,0,1,0,1,2,0,0,2,0,2,4,1
13112,118713,GzZqgl4giqqW7TCBTX5a2jDyy6Q646Os,SpATywNh6bZuzm8s1ceuBUnMUAeoAHHw,25,60,3,39,2,14,23,4,145,20.714285714285715,5,0.0,18,3,34,2,42,14,5,23,4,57,88,1
13113,118722,DHhoczdtvn37Fynebgh7tMkKtF0dh4jQ,A3fsA9Zfv1X2fVEQhTw51lKENdNrEqT3,1,0,0,0,0,0,1,0,1,0.14285714285714285,1,0.0,0,0,0,0,0,0,0,1,0,0,1,1
13114,118726,l5LfU8gApOG72AnBkdAbfOLQLwFH7Zo2,5X6FeZozNMgE2VRi3MJYjkkFK8SETtu2,7,9,1,2,1,3,2,0,18,2.5714285714285716,1,0.0,5,1,2,1,4,3,0,2,0,9,9,0
13115,118738,I3IAdtd399keUxdhVZ1J3PIkz3kC7zL8,RXDvfPUBYFlVdlueBFbLW0mhhAyGEqpt,22,23,2,34,7,0,4,0,70,10.0,3,0.0,14,2,31,7,9,0,3,4,0,54,16,1
13116,118752,v5ZzaFsvASHZHFHDQx30X4bWu2OAn0TJ,bWdj2GDclj5ofokWjzoa5jAwMkxCykd6,11,18,1,30,5,1,8,1,64,9.142857142857142,2,0.0,10,1,30,5,8,1,0,8,1,46,18,1
13117,118763,5ccVO0DXIbSzn48qO0PlyxYK6uXvmUBC,5X6FeZozNMgE2VRi3MJYjkkFK8SETtu2,1,0,0,0,0,0,1,0,1,0.14285714285714285,1,0.0,0,0,0,0,0,0,0,1,0,0,1,1
13118,118765,GGymFCz4p00DxUzTcaDeYIcqN4hoSzTk,SpATywNh6bZuzm8s1ceuBUnMUAeoAHHw,1,0,0,0,0,0,1,0,1,0.14285714285714285,1,0.0,0,0,0,0,0,0,0,1,0,0,1,1
13119,118771,lrp5AGJUh69hKuCI5IYUEU19E2beipwd,A3fsA9Zfv1X2fVEQhTw51lKENdNrEqT3,60,83,7,126,4,18,16,0,254,36.285714285714285,15,0.0,1,7,106,4,82,18,20,16,0,118,136,1
13120,118774,DqNAxwTcrk055KEf1va6hv0cFfrqGSiY,A3fsA9Zfv1X2fVEQhTw51lKENdNrEqT3,14,24,14,0,8,0,4,0,50,7.142857142857143,3,0.0,0,14,0,8,24,0,0,4,0,22,28,1
13121,118783,bKVslXuzEQ1pv4c6iV5mVjs6X6avUbmL,G8EPVSXsOYB5YQWZGiz1aVq5Pgr2GrQu,7,4,2,0,1,0,6,0,13,1.8571428571428572,5,0.0,0,2,0,1,4,0,0,6,0,3,10,0
13122,118800,AXOBQLaknxwaGBasKpj34YfhU436HR6z,G8EPVSXsOYB5YQWZGiz1aVq5Pgr2GrQu,25,34,14,10,11,0,21,1,91,13.0,5,0.0,8,14,5,11,26,0,5,21,1,38,53,0
13123,118816,v25EcAT5A0ySpzSARJj7hsNjPFXZUc3f,bWdj2GDclj5ofokWjzoa5jAwMkxCykd6,8,10,2,98,3,0,11,0,124,17.714285714285715,1,0.0,6,2,97,3,4,0,1,11,0,108,16,1
13124,118817,tLb8Xi221e5NaJvytwcAD3V04AqBaAZQ,5X6FeZozNMgE2VRi3MJYjkkFK8SETtu2,2,0,0,0,0,0,2,0,2,0.2857142857142857,1,0.0,0,0,0,0,0,0,0,2,0,0,2,1
13125,118825,j9NZdBIxAXb3GeboncXceewydTlKXuYz,bWdj2GDclj5ofokWjzoa5jAwMkxCykd6,6,4,3,0,3,0,1,0,11,1.5714285714285714,1,0.0,0,3,0,3,4,0,0,1,0,6,5,1
13126,118828,QXEPfF2pAnokf1BSO0tTVCPJ0yWgZtcC,SpATywNh6bZuzm8s1ceuBUnMUAeoAHHw,6,5,1,0,0,0,2,1,9,1.2857142857142858,1,0.0,0,1,0,0,5,0,0,2,1,1,8,1
13127,118829,oYXc35V0j0DGRrciqWRUFfGtnQPnDhaQ,A3fsA9Zfv1X2fVEQhTw51lKENdNrEqT3,10,18,2,0,0,0,6,0,26,3.7142857142857144,2,0.0,0,2,0,0,18,0,0,6,0,2,24,1
13128,118843,eNgDL8k9xOLyBlZ3UNlseJHly8SfPZZu,5X6FeZozNMgE2VRi3MJYjkkFK8SETtu2,1,0,0,0,0,0,2,0,2,0.2857142857142857,2,0.0,0,0,0,0,0,0,0,2,0,0,2,1
13129,118858,uvmnuTMWO7CUJMGmbknJbfcrAcbdWpqR,SpATywNh6bZuzm8s1ceuBUnMUAeoAHHw,1,0,0,0,0,0,1,0,1,0.14285714285714285,1,0.0,0,0,0,0,0,0,0,1,0,0,1,1
13130,118862,uvmnuTMWO7CUJMGmbknJbfcrAcbdWpqR,bWdj2GDclj5ofokWjzoa5jAwMkxCykd6,1,0,0,0,0,0,1,0,1,0.14285714285714285,1,0.0,0,0,0,0,0,0,0,1,0,0,1,1
13131,118863,uvmnuTMWO7CUJMGmbknJbfcrAcbdWpqR,RXDvfPUBYFlVdlueBFbLW0mhhAyGEqpt,1,0,0,0,0,0,1,0,1,0.14285714285714285,1,0.0,0,0,0,0,0,0,0,1,0,0,1,1
13132,118876,eLhnZqVqldawLLuaLdbS0XPiIKiZAief,RXDvfPUBYFlVdlueBFbLW0mhhAyGEqpt,37,58,3,0,0,30,21,1,113,16.142857142857142,4,0.0,0,3,0,0,58,30,0,21,1,3,110,0
13133,118879,wuMhhjy7NxtqcBPxbigACLOqg9Xy71R7,SpATywNh6bZuzm8s1ceuBUnMUAeoAHHw,31,61,27,38,9,1,19,0,155,22.142857142857142,7,0.0,20,27,32,9,41,1,6,19,0,88,67,0
13134,118885,a3fDqs2SnQqVu7YeLa2fNuIYzGrHnHDE,SpATywNh6bZuzm8s1ceuBUnMUAeoAHHw,7,8,0,0,0,1,4,0,13,1.8571428571428572,1,0.0,0,0,0,0,8,1,0,4,0,0,13,1
13135,118889,a3fDqs2SnQqVu7YeLa2fNuIYzGrHnHDE,bWdj2GDclj5ofokWjzoa5jAwMkxCykd6,5,2,0,0,0,0,3,0,5,0.7142857142857143,1,0.0,0,0,0,0,2,0,0,3,0,0,5,1
13136,118913,xUhDcXiX03QQg1jNR3Lksh9CrGcRUkPg,A3fsA9Zfv1X2fVEQhTw51lKENdNrEqT3,87,148,76,222,30,166,37,0,679,97.0,15,0.0,16,76,178,30,132,166,44,37,0,300,379,0
13137,118918,TOHE2cn8sx2ym4g7cRhp3c9gQIpGV4UB,SpATywNh6bZuzm8s1ceuBUnMUAeoAHHw,10,10,5,0,2,1,8,1,27,3.857142857142857,2,0.0,2,5,0,2,8,1,0,8,1,9,18,1
13138,118919,TOHE2cn8sx2ym4g7cRhp3c9gQIpGV4UB,A3fsA9Zfv1X2fVEQhTw51lKENdNrEqT3,1,0,0,0,0,0,1,0,1,0.14285714285714285,1,0.0,0,0,0,0,0,0,0,1,0,0,1,1
13139,118923,FcPFK6OTsUF1j3uNGabdzGTvbY8kcO3D,A3fsA9Zfv1X2fVEQhTw51lKENdNrEqT3,15,14,12,0,8,0,2,0,36,5.142857142857143,2,0.0,0,12,0,8,14,0,0,2,0,20,16,1
13140,118926,efygWYkxxUMOGInRZT4qEeuzMRlIpQq6,SpATywNh6bZuzm8s1ceuBUnMUAeoAHHw,45,78,43,22,19,8,26,2,198,28.285714285714285,9,0.0,19,43,21,19,59,8,1,26,2,102,96,0
13141,118930,fiLsrcAU0ZFm61T8xhRUwb5p8PN605CT,SpATywNh6bZuzm8s1ceuBUnMUAeoAHHw,8,8,5,0,2,0,6,0,21,3.0,3,0.0,0,5,0,2,8,0,0,6,0,7,14,1
13142,118931,ZRfFWalEoINhUGe05gZETSGzjQUd6T5n,SpATywNh6bZuzm8s1ceuBUnMUAeoAHHw,29,43,22,23,9,9,7,0,113,16.142857142857142,7,0.0,14,22,18,9,29,9,5,7,0,63,50,1
13143,118943,6hOFMnbpcErHmlwc3MeiSQOkkbkZvsdF,SpATywNh6bZuzm8s1ceuBUnMUAeoAHHw,12,17,7,0,3,1,9,1,38,5.428571428571429,4,0.0,6,7,0,3,11,1,0,9,1,16,22,0
13144,118944,pqKCkJOspd9xXtA4k6IDJS4Js61XmolB,SpATywNh6bZuzm8s1ceuBUnMUAeoAHHw,4,2,1,0,1,0,1,0,5,0.7142857142857143,2,0.0,0,1,0,1,2,0,0,1,0,2,3,1
13145,118950,5eO5trczHn4tezH3o1mHOvzooHGmVWMl,A3fsA9Zfv1X2fVEQhTw51lKENdNrEqT3,11,11,7,0,4,0,4,0,26,3.7142857142857144,3,0.0,0,7,0,4,11,0,0,4,0,11,15,1
13146,118957,28PHU9suTM8EqUKsQwsvQ03DzFXi0yDl,RXDvfPUBYFlVdlueBFbLW0mhhAyGEqpt,1,0,0,0,0,0,3,0,3,0.42857142857142855,2,0.0,0,0,0,0,0,0,0,3,0,0,3,1
13147,118962,UHbjjkoY8eePNp6r324vyfQdD3BvD0KM,G8EPVSXsOYB5YQWZGiz1aVq5Pgr2GrQu,8,5,4,0,1,0,2,0,12,1.7142857142857142,1,0.0,0,4,0,1,5,0,0,2,0,5,7,1
13148,118964,YvVuka2rxSzzYYNnDLtzVMee0hjbsr3Q,SpATywNh6bZuzm8s1ceuBUnMUAeoAHHw,6,4,1,0,1,0,1,0,7,1.0,2,0.0,0,1,0,1,4,0,0,1,0,2,5,1
13149,118966,zQeYO5pZ1xh2UAEMjLOadhLt0hmfHHxb,bWdj2GDclj5ofokWjzoa5jAwMkxCykd6,9,15,7,8,3,1,7,0,41,5.857142857142857,3,0.0,1,7,7,3,14,1,1,7,0,18,23,1
13150,118977,rwmKpdbePJfKvi814EI3msCq1quO9ftl,SpATywNh6bZuzm8s1ceuBUnMUAeoAHHw,6,2,0,0,0,0,5,1,8,1.1428571428571428,1,0.0,0,0,0,0,2,0,0,5,1,0,8,1
13151,118987,u79qFvGauNOAmgDpP2DklDOwG6ISKFXs,SpATywNh6bZuzm8s1ceuBUnMUAeoAHHw,13,32,7,0,3,32,8,2,84,12.0,2,0.0,23,7,0,3,9,32,0,8,2,33,51,1
13152,118993,5R2yvtH9LNaB7I0DFs0y5Dgzft4SPkTz,SpATywNh6bZuzm8s1ceuBUnMUAeoAHHw,27,34,20,32,11,0,15,0,112,16.0,4,0.0,10,20,29,11,24,0,3,15,0,70,42,1
13153,118995,UoQ0PEeqIO4n6Ln8avpcjf2ZoIAx1YCQ,A3fsA9Zfv1X2fVEQhTw51lKENdNrEqT3,111,59,45,246,33,0,13,0,396,56.57142857142857,12,0.0,3,45,212,33,56,0,34,13,0,293,103,0
13154,119001,DXaGQeTbJkNEulVow7g1qYtfMHcxt0Bb,SpATywNh6bZuzm8s1ceuBUnMUAeoAHHw,48,103,8,46,5,18,12,2,194,27.714285714285715,10,0.0,20,8,37,5,83,18,9,12,2,70,124,0
13155,119008,i41wq4JFa1zWjnzk4s4F0u6D3S1UMuDT,bWdj2GDclj5ofokWjzoa5jAwMkxCykd6,1,0,0,0,0,0,1,0,1,0.14285714285714285,1,0.0,0,0,0,0,0,0,0,1,0,0,1,1
13156,119009,c8TFm45r0bfBe26eBlEeUAKDBoTJT9yV,SpATywNh6bZuzm8s1ceuBUnMUAeoAHHw,35,36,15,42,10,0,4,0,107,15.285714285714286,3,0.0,12,15,38,10,24,0,4,4,0,75,32,0
13157,119012,gVK9JFuVehH4w6Ht2Q17t4NUtbNWFPNf,SpATywNh6bZuzm8s1ceuBUnMUAeoAHHw,7,2,0,0,0,0,9,1,12,1.7142857142857142,1,0.0,0,0,0,0,2,0,0,9,1,0,12,1
13158,119026,Pqb8mgUOFwNjSYHZCNAFlv28S1hEJuyW,RXDvfPUBYFlVdlueBFbLW0mhhAyGEqpt,7,3,2,0,1,0,4,0,10,1.4285714285714286,1,0.0,1,2,0,1,2,0,0,4,0,4,6,1
13159,119027,5tL0goZ0bMjNeuGHJZ9VZymSM6PzqaXn,SpATywNh6bZuzm8s1ceuBUnMUAeoAHHw,43,71,39,29,25,12,13,0,189,27.0,7,0.0,24,39,24,25,47,12,5,13,0,112,77,0
13160,119042,lVwgv61cg8fkhW9rg5b1PIPnuUWxb0Vk,bWdj2GDclj5ofokWjzoa5jAwMkxCykd6,22,33,18,24,8,63,19,3,168,24.0,7,0.0,5,18,22,8,28,63,2,19,3,53,115,1
13161,119043,D5jAgVwgvpw2Kr66NxyapnkPl0dnzBLu,A3fsA9Zfv1X2fVEQhTw51lKENdNrEqT3,4,2,0,0,0,0,29,0,31,4.428571428571429,10,0.0,0,0,0,0,2,0,0,29,0,0,31,1
13162,119057,pKoUS2SEKCFMATrFfyk1PMmORYo186Kb,G8EPVSXsOYB5YQWZGiz1aVq5Pgr2GrQu,69,174,4,156,12,1,16,1,364,52.0,4,0.0,91,4,121,12,83,1,35,16,1,228,136,0
13163,119060,vnVRudtEjYlZLumIJaQJj0f2z3slueSl,SpATywNh6bZuzm8s1ceuBUnMUAeoAHHw,12,15,9,10,5,0,5,0,44,6.285714285714286,1,0.0,2,9,9,5,13,0,1,5,0,25,19,1
13164,119071,pcGXxspzr6LCJz7Udn3jdISDvA5WWes9,G8EPVSXsOYB5YQWZGiz1aVq5Pgr2GrQu,4,3,1,0,0,0,1,0,5,0.7142857142857143,1,0.0,0,1,0,0,3,0,0,1,0,1,4,1
13165,119080,iPvQyQrtKaIWy8V9F09NldCS64KhU7EA,G8EPVSXsOYB5YQWZGiz1aVq5Pgr2GrQu,1,0,0,0,0,0,1,0,1,0.14285714285714285,1,0.0,0,0,0,0,0,0,0,1,0,0,1,1
13166,119090,RwiQ9qTlDDbK4m60mKR4JxmbkQn57Rff,RXDvfPUBYFlVdlueBFbLW0mhhAyGEqpt,19,21,14,0,6,46,11,7,105,15.0,4,0.0,2,14,0,6,19,46,0,11,7,22,83,1
13167,119104,jq4JfpgApzrMRuCNvYDPIsQTWPeEZuhJ,G8EPVSXsOYB5YQWZGiz1aVq5Pgr2GrQu,55,78,26,185,11,31,34,4,369,52.714285714285715,4,0.0,25,26,155,11,53,31,30,34,4,217,152,1
13168,119109,PZtj1GnJa5qYIICIjESUcqp401L5vmnR,G8EPVSXsOYB5YQWZGiz1aVq5Pgr2GrQu,59,68,2,156,7,26,23,2,284,40.57142857142857,2,0.0,39,2,121,7,29,26,35,23,2,169,115,1
13169,119117,t1xspb1k3lEGBshWKCwAoW44MsPqXHk5,A3fsA9Zfv1X2fVEQhTw51lKENdNrEqT3,1,0,0,0,0,0,1,0,1,0.14285714285714285,1,0.0,0,0,0,0,0,0,0,1,0,0,1,1
13170,119130,7iwTSJc32zh43nzmRibHZmGv70Vk4Lgo,SpATywNh6bZuzm8s1ceuBUnMUAeoAHHw,5,2,1,0,1,0,4,0,8,1.1428571428571428,1,0.0,0,1,0,1,2,0,0,4,0,2,6,1
13171,119131,NOm4CR7y4Aje7RwR2ZLNwhU4SfabY7lA,SpATywNh6bZuzm8s1ceuBUnMUAeoAHHw,10,63,35,0,3,0,10,0,111,15.857142857142858,2,0.0,20,35,0,3,43,0,0,10,0,58,53,1
13172,119143,YMxXtA5A6XX1bdm998q3OXZqnuIpo8I0,SpATywNh6bZuzm8s1ceuBUnMUAeoAHHw,22,71,30,0,0,27,16,0,144,20.571428571428573,8,0.0,15,30,0,0,56,27,0,16,0,45,99,0
13173,119151,RlfxLmk0H7RVTMayoeG4aa7x6bQD0aZn,SpATywNh6bZuzm8s1ceuBUnMUAeoAHHw,4,2,1,0,1,0,1,0,5,0.7142857142857143,1,0.0,0,1,0,1,2,0,0,1,0,2,3,1
13174,119152,xJut5jnrMH6sobZn5JCJO1JseLVZmDHM,SpATywNh6bZuzm8s1ceuBUnMUAeoAHHw,11,15,6,0,4,0,3,0,28,4.0,1,0.0,0,6,0,4,15,0,0,3,0,10,18,1
13175,119159,rbbo6gYUB5I1wwOafpQCdj4m6UPXHmsz,SpATywNh6bZuzm8s1ceuBUnMUAeoAHHw,8,25,8,0,2,6,10,3,54,7.714285714285714,4,0.0,8,8,0,2,17,6,0,10,3,18,36,0
13176,119170,kd67Lm5QGeYWxcKJYnacCNFbyj5NIxDh,SpATywNh6bZuzm8s1ceuBUnMUAeoAHHw,20,28,7,55,1,0,4,0,95,13.571428571428571,3,0.0,16,7,44,1,12,0,11,4,0,68,27,0
13177,119185,mu7Zdr1ChN6xNMWE8Otd7Si7TQhm7pEQ,SpATywNh6bZuzm8s1ceuBUnMUAeoAHHw,10,32,9,0,6,0,18,1,66,9.428571428571429,5,0.0,2,9,0,6,30,0,0,18,1,17,49,0
13178,119190,oUj6dSGxHzsnU6uTXKwTomk9vwlHt6j0,G8EPVSXsOYB5YQWZGiz1aVq5Pgr2GrQu,15,15,11,0,7,0,6,0,39,5.571428571428571,3,0.0,0,11,0,7,15,0,0,6,0,18,21,1
13179,119192,NoA9xueUUthCTfidqnFplOKsMZsY3DHa,SpATywNh6bZuzm8s1ceuBUnMUAeoAHHw,41,64,28,36,13,0,14,0,155,22.142857142857142,7,0.0,16,28,35,13,48,0,1,14,0,92,63,1
13180,119203,PZqGQ10gijeZZaXj244FlA0iYVn9rzPC,SpATywNh6bZuzm8s1ceuBUnMUAeoAHHw,5,2,1,0,1,0,2,0,6,0.8571428571428571,1,0.0,0,1,0,1,2,0,0,2,0,2,4,1
13181,119204,okqN4nBVKRYYrkYonKicKGOmPqVGYjZh,G8EPVSXsOYB5YQWZGiz1aVq5Pgr2GrQu,11,16,7,0,2,0,17,0,42,6.0,4,0.0,0,7,0,2,16,0,0,17,0,9,33,0
13182,119208,BnCTRJ1O4fVqlnxTGriZkJ9JZEc8p58K,A3fsA9Zfv1X2fVEQhTw51lKENdNrEqT3,1,0,0,0,0,0,2,0,2,0.2857142857142857,1,0.0,0,0,0,0,0,0,0,2,0,0,2,1
13183,119212,ttJwJCfGlOpWVOx9vRULE7UdoGyFI9Ut,SpATywNh6bZuzm8s1ceuBUnMUAeoAHHw,5,6,3,0,2,0,1,0,12,1.7142857142857142,1,0.0,2,3,0,2,4,0,0,1,0,7,5,1
13184,119217,UbE5C1Pto1KvqgPPDmGO0svv7BwAZk15,G8EPVSXsOYB5YQWZGiz1aVq5Pgr2GrQu,12,11,7,0,6,0,3,0,27,3.857142857142857,2,0.0,0,7,0,6,11,0,0,3,0,13,14,1
13185,119224,ieJctBgJj74PFo2P7ymmdVzAX2v62LKu,G8EPVSXsOYB5YQWZGiz1aVq5Pgr2GrQu,12,11,5,0,4,0,6,0,26,3.7142857142857144,1,0.0,0,5,0,4,11,0,0,6,0,9,17,1
13186,119237,63TreuteShRAITxpj6URpYIQ3kURzPmt,bWdj2GDclj5ofokWjzoa5jAwMkxCykd6,8,9,1,0,1,10,7,1,29,4.142857142857143,1,0.0,2,1,0,1,7,10,0,7,1,4,25,1
13187,119239,okqN4nBVKRYYrkYonKicKGOmPqVGYjZh,bWdj2GDclj5ofokWjzoa5jAwMkxCykd6,8,34,16,0,0,13,27,0,90,12.857142857142858,6,0.0,1,16,0,0,33,13,0,27,0,17,73,0
13188,119243,q3pPbgY0JhPpTgQfSrEbBAWd7rbmYjI4,SpATywNh6bZuzm8s1ceuBUnMUAeoAHHw,40,129,4,63,3,18,48,0,265,37.857142857142854,12,0.0,28,4,61,3,101,18,2,48,0,96,169,0
13189,119245,7RIgMHzHpMzY7qBXHPj6WiDKK3U9H2Wz,SpATywNh6bZuzm8s1ceuBUnMUAeoAHHw,47,70,51,13,32,0,32,1,199,28.428571428571427,11,0.0,2,51,11,32,68,0,2,32,1,96,103,0
13190,119251,qujx8xRYXJGJrQ3ruvaaTF7TTwy8KaeC,G8EPVSXsOYB5YQWZGiz1aVq5Pgr2GrQu,9,5,3,0,1,0,4,0,13,1.8571428571428572,1,0.0,0,3,0,1,5,0,0,4,0,4,9,1
13191,119265,8oiFYmMp7IOF1mfFRmhZ7Lug8ImrhTTO,SpATywNh6bZuzm8s1ceuBUnMUAeoAHHw,18,31,13,21,5,9,8,0,87,12.428571428571429,4,0.0,11,13,18,5,20,9,3,8,0,47,40,1
13192,119266,iacqYcgHTn7FZ8NE4roe5kgAUjDF0efr,SpATywNh6bZuzm8s1ceuBUnMUAeoAHHw,46,71,40,51,21,6,35,1,225,32.142857142857146,8,0.0,18,40,42,21,53,6,9,35,1,121,104,0
13193,119267,4eT20gUbOYkq3qXZQOFYEeSPNFVVnLrB,A3fsA9Zfv1X2fVEQhTw51lKENdNrEqT3,2,0,0,0,0,0,2,0,2,0.2857142857142857,1,0.0,0,0,0,0,0,0,0,2,0,0,2,1
13194,119288,NDGU2YEumOCOuP8YkbdyT4JHlfK2eImX,SpATywNh6bZuzm8s1ceuBUnMUAeoAHHw,9,6,4,0,2,0,2,0,14,2.0,1,0.0,0,4,0,2,6,0,0,2,0,6,8,1
13195,119289,ch9jXib8D5Z69PRYwp1WHAUa7SmEdgIr,SpATywNh6bZuzm8s1ceuBUnMUAeoAHHw,18,19,7,11,3,1,10,2,53,7.571428571428571,1,0.0,10,7,11,3,9,1,0,10,2,31,22,1
13196,119290,AJAawUTIK5tTWvBfm3QRQhh9S7SsRdRA,SpATywNh6bZuzm8s1ceuBUnMUAeoAHHw,10,8,2,0,2,1,5,1,19,2.7142857142857144,2,0.0,0,2,0,2,8,1,0,5,1,4,15,1
13197,119293,845wZKTJiCD0zuzvTs70K7NaBfTnltXS,SpATywNh6bZuzm8s1ceuBUnMUAeoAHHw,7,2,1,0,1,10,4,1,19,2.7142857142857144,1,0.0,0,1,0,1,2,10,0,4,1,2,17,1
13198,119294,tdyEqQ928g4zwLz7u1XUELM0nW67gqKU,G8EPVSXsOYB5YQWZGiz1aVq5Pgr2GrQu,36,126,59,42,13,6,32,1,279,39.857142857142854,5,0.0,22,59,40,13,104,6,2,32,1,134,145,1
13199,119295,yuOMBhnDAvRSNCNkI5M8rpsRFdq6dg7T,RXDvfPUBYFlVdlueBFbLW0mhhAyGEqpt,4,2,1,0,1,0,1,0,5,0.7142857142857143,1,0.0,0,1,0,1,2,0,0,1,0,2,3,1
13200,119300,1P5MvFqtZDoED6FWgTnhCj192U5gDdPF,G8EPVSXsOYB5YQWZGiz1aVq5Pgr2GrQu,12,12,0,6,0,19,7,1,45,6.428571428571429,1,0.0,8,0,5,0,4,19,1,7,1,13,32,0
13201,119305,kLbYKjAePyQg6GOXHiVGeoyhhDvXEfjN,SpATywNh6bZuzm8s1ceuBUnMUAeoAHHw,33,90,5,32,1,38,28,7,201,28.714285714285715,9,0.0,38,5,28,1,52,38,4,28,7,72,129,0
13202,119309,kWr0BhoQMxiu9wSeKhtyX0T1P5JfsERH,SpATywNh6bZuzm8s1ceuBUnMUAeoAHHw,49,69,36,55,12,67,48,2,289,41.285714285714285,14,0.0,11,36,48,12,58,67,7,48,2,107,182,0
13203,119325,grNuFIQJF1sOOkw8RJjaExhlwTJt52uU,SpATywNh6bZuzm8s1ceuBUnMUAeoAHHw,61,171,88,37,24,239,89,5,653,93.28571428571429,16,0.0,27,88,35,24,144,239,2,89,5,174,479,0
13204,119330,Xx6t23p3XIha0hNmBziFcHG3GcEwTmQl,SpATywNh6bZuzm8s1ceuBUnMUAeoAHHw,35,43,24,25,11,30,43,2,178,25.428571428571427,4,0.0,7,24,22,11,36,30,3,43,2,64,114,0
13205,119332,FEK5BtdsP2RwxkLYp7U5A0VI3SgJyNlk,SpATywNh6bZuzm8s1ceuBUnMUAeoAHHw,5,7,1,0,1,0,1,0,10,1.4285714285714286,2,0.0,0,1,0,1,7,0,0,1,0,2,8,1
13206,119349,loZxBAFxFplmuCNvi9UHlWI1qnWbS4Xp,A3fsA9Zfv1X2fVEQhTw51lKENdNrEqT3,7,2,1,0,1,0,9,1,14,2.0,2,0.0,0,1,0,1,2,0,0,9,1,2,12,1
13207,119359,DhNEa94k5xGKWUPgWcx5F0CO6u6J4iIb,G8EPVSXsOYB5YQWZGiz1aVq5Pgr2GrQu,33,57,28,96,17,17,11,2,228,32.57142857142857,2,0.0,26,28,75,17,31,17,21,11,2,146,82,1
13208,119361,d0czHY9SleKhWFZVHkBc11jXgenCfeaE,SpATywNh6bZuzm8s1ceuBUnMUAeoAHHw,18,26,20,0,12,7,16,7,88,12.571428571428571,2,0.0,0,20,0,12,26,7,0,16,7,32,56,1
13209,119368,WfocL88obqufkiW8V6EsVJAto3ptM4se,RXDvfPUBYFlVdlueBFbLW0mhhAyGEqpt,13,9,0,0,0,2,11,2,24,3.4285714285714284,2,0.0,0,0,0,0,9,2,0,11,2,0,24,1
13210,119369,w0JXf5IU53zIrRHN4nASHPBtvGw0J3e8,SpATywNh6bZuzm8s1ceuBUnMUAeoAHHw,1,0,0,0,0,0,1,0,1,0.14285714285714285,1,0.0,0,0,0,0,0,0,0,1,0,0,1,1
13211,119372,RwvuGEh3euIR11rktJrGBhzDqcQMkhOC,SpATywNh6bZuzm8s1ceuBUnMUAeoAHHw,48,101,47,25,20,0,26,1,220,31.428571428571427,12,0.0,30,47,23,20,71,0,2,26,1,120,100,0
13212,119382,tiXCEdgwB1xd20Vy4mgIvE207fd2jlXf,SpATywNh6bZuzm8s1ceuBUnMUAeoAHHw,28,35,15,30,8,0,4,0,92,13.142857142857142,2,0.0,17,15,28,8,18,0,2,4,0,68,24,1
13213,119383,v2tR5cCXv44SOe8Z266q9U5FU2iAwtD3,SpATywNh6bZuzm8s1ceuBUnMUAeoAHHw,20,16,11,4,7,0,6,0,44,6.285714285714286,1,0.0,6,11,4,7,10,0,0,6,0,28,16,1
13214,119395,W4swLEiF6xa4CU1Ee5z4jQMNXyEDiyxR,A3fsA9Zfv1X2fVEQhTw51lKENdNrEqT3,8,2,0,0,0,7,7,1,17,2.4285714285714284,1,0.0,0,0,0,0,2,7,0,7,1,0,17,1
13215,119401,rSKz43hYiPnNMTLyx15fL1ocrthBLweg,SpATywNh6bZuzm8s1ceuBUnMUAeoAHHw,9,13,6,0,2,8,10,7,46,6.571428571428571,3,0.0,3,6,0,2,10,8,0,10,7,11,35,1
13216,119406,qL29jh1ARNpuNbjWhIJAl20fDBQmsVJq,A3fsA9Zfv1X2fVEQhTw51lKENdNrEqT3,1,0,0,0,0,0,1,0,1,0.14285714285714285,1,0.0,0,0,0,0,0,0,0,1,0,0,1,1
13217,119408,TDRTbyk0dkUIgXlX1DR0wEGLNYKbj2kE,SpATywNh6bZuzm8s1ceuBUnMUAeoAHHw,5,7,2,0,1,0,1,0,11,1.5714285714285714,1,0.0,2,2,0,1,5,0,0,1,0,5,6,0
13218,119413,HNjmezOX8bu6iW67SYkfKBzixQs4v7AY,SpATywNh6bZuzm8s1ceuBUnMUAeoAHHw,31,53,29,18,8,25,18,2,153,21.857142857142858,6,0.0,16,29,18,8,37,25,0,18,2,71,82,0
13219,119422,8bsgdKFaSfwROHIZCKXm97BMUW4OFzed,SpATywNh6bZuzm8s1ceuBUnMUAeoAHHw,57,68,34,46,17,12,16,0,193,27.571428571428573,7,0.0,13,34,37,17,55,12,9,16,0,101,92,0
13220,119437,WnuLHUQ0J3BeGgl165qL2l7BKuVDR3LS,RXDvfPUBYFlVdlueBFbLW0mhhAyGEqpt,51,66,5,129,5,2,11,2,220,31.428571428571427,4,0.0,12,5,121,5,54,2,8,11,2,143,77,0
13221,119446,XvNNzv39b8VqKid0q4fV9ms2wVNAdWks,A3fsA9Zfv1X2fVEQhTw51lKENdNrEqT3,1,0,0,0,0,0,1,0,1,0.14285714285714285,1,0.0,0,0,0,0,0,0,0,1,0,0,1,1
13222,119456,72z519PMt8GGBXLvF1FG0oMJuciCSWYJ,RXDvfPUBYFlVdlueBFbLW0mhhAyGEqpt,51,78,9,148,7,6,20,0,268,38.285714285714285,10,0.0,11,9,130,7,67,6,18,20,0,157,111,1
13223,119461,6ZwHbtvdiS8islxnPJXOOnLtMpvU3IpT,SpATywNh6bZuzm8s1ceuBUnMUAeoAHHw,31,41,24,4,18,0,13,2,102,14.571428571428571,8,0.0,6,24,4,18,35,0,0,13,2,52,50,0
13224,119482,S2q1gEPtloNcMfcAwTCrDjaeEJ3ox2aC,A3fsA9Zfv1X2fVEQhTw51lKENdNrEqT3,51,74,53,104,30,8,14,0,283,40.42857142857143,6,0.0,6,53,80,30,68,8,24,14,0,169,114,1
13225,119493,50aSuabL02e7lLNBHTRXsMQnBChV2lSX,G8EPVSXsOYB5YQWZGiz1aVq5Pgr2GrQu,4,2,0,0,0,0,2,0,4,0.5714285714285714,1,0.0,0,0,0,0,2,0,0,2,0,0,4,1
13226,119496,HJsFc87NFCDg5yRkkakXIT7nSH8XGxhF,A3fsA9Zfv1X2fVEQhTw51lKENdNrEqT3,9,4,3,0,3,0,2,0,12,1.7142857142857142,1,0.0,0,3,0,3,4,0,0,2,0,6,6,1
13227,119501,iWlNj0RlfLQkFgeY87o4tMiHnUMI1yTI,G8EPVSXsOYB5YQWZGiz1aVq5Pgr2GrQu,29,41,16,14,15,0,19,0,105,15.0,7,0.0,8,16,9,15,33,0,5,19,0,48,57,1
13228,119515,0mqsqXT4HPDOQPxpDnEoZEe1KeuUzpQx,SpATywNh6bZuzm8s1ceuBUnMUAeoAHHw,29,87,12,33,8,1,21,0,162,23.142857142857142,10,0.0,17,12,28,8,70,1,5,21,0,65,97,0
13229,119520,ZQcWT47pZxjNboL0V0inwxjvImMCbKfc,SpATywNh6bZuzm8s1ceuBUnMUAeoAHHw,31,130,37,28,14,0,25,0,234,33.42857142857143,10,0.0,6,37,23,14,124,0,5,25,0,80,154,0
13230,119528,BnWzYOrzXkQQKpdPflOsG06i68fZaDTp,SpATywNh6bZuzm8s1ceuBUnMUAeoAHHw,8,5,0,0,0,0,6,0,11,1.5714285714285714,1,0.0,0,0,0,0,5,0,0,6,0,0,11,1
13231,119537,OHgepWjzcLmDHpgOxR6c8DhDBUqi1HDm,G8EPVSXsOYB5YQWZGiz1aVq5Pgr2GrQu,2,0,0,0,0,0,2,0,2,0.2857142857142857,1,0.0,0,0,0,0,0,0,0,2,0,0,2,1
13232,119540,OHgepWjzcLmDHpgOxR6c8DhDBUqi1HDm,bWdj2GDclj5ofokWjzoa5jAwMkxCykd6,7,2,1,0,1,0,4,0,8,1.1428571428571428,1,0.0,0,1,0,1,2,0,0,4,0,2,6,1
13233,119544,NHjxa47feJ9sWQnmg6HoO6L78eHIRwnl,A3fsA9Zfv1X2fVEQhTw51lKENdNrEqT3,3,2,0,0,0,0,1,0,3,0.42857142857142855,1,0.0,0,0,0,0,2,0,0,1,0,0,3,1
13234,119547,NHjxa47feJ9sWQnmg6HoO6L78eHIRwnl,RXDvfPUBYFlVdlueBFbLW0mhhAyGEqpt,16,24,1,0,0,0,9,0,34,4.857142857142857,3,0.0,1,1,0,0,23,0,0,9,0,2,32,1
13235,119555,72z519PMt8GGBXLvF1FG0oMJuciCSWYJ,A3fsA9Zfv1X2fVEQhTw51lKENdNrEqT3,7,8,1,0,1,0,1,0,11,1.5714285714285714,1,0.0,0,1,0,1,8,0,0,1,0,2,9,0
13236,119556,ZQcWT47pZxjNboL0V0inwxjvImMCbKfc,A3fsA9Zfv1X2fVEQhTw51lKENdNrEqT3,54,93,29,68,14,0,24,1,229,32.714285714285715,6,0.0,2,29,58,14,91,0,10,24,1,103,126,1
13237,119563,HbDZBLuVJ2GX78KybFnufJtg8yn0zj71,SpATywNh6bZuzm8s1ceuBUnMUAeoAHHw,24,22,17,17,11,0,3,0,70,10.0,2,0.0,3,17,13,11,19,0,4,3,0,44,26,1
13238,119570,vuz6r1wL6cSmPMYDw5wsdIxwDVSbQPGA,SpATywNh6bZuzm8s1ceuBUnMUAeoAHHw,17,26,16,16,6,1,5,0,70,10.0,3,0.0,5,16,14,6,21,1,2,5,0,41,29,1
13239,119577,ZtIdVQN3EYruDP82MkDXBV4HsWJ99nHc,SpATywNh6bZuzm8s1ceuBUnMUAeoAHHw,33,29,1,16,1,11,24,1,83,11.857142857142858,5,0.0,0,1,14,1,29,11,2,24,1,16,67,1
13240,119580,TnET23MWjnuobi5dYEzVGlV9qd1ZWPbL,A3fsA9Zfv1X2fVEQhTw51lKENdNrEqT3,41,68,25,0,15,0,2,0,110,15.714285714285714,2,0.0,0,25,0,15,68,0,0,2,0,40,70,0
13241,119590,hWuNPhEBxnKOOJFguUTUYW5SrQ5ZI8jY,SpATywNh6bZuzm8s1ceuBUnMUAeoAHHw,5,2,1,0,1,0,2,0,6,0.8571428571428571,1,0.0,0,1,0,1,2,0,0,2,0,2,4,1
13242,119595,GPzUdrAeOhUs39B3OZTNuOkoEWda0QRy,G8EPVSXsOYB5YQWZGiz1aVq5Pgr2GrQu,9,6,0,0,0,3,10,0,19,2.7142857142857144,1,0.0,0,0,0,0,6,3,0,10,0,0,19,1
13243,119601,VW1NSXHsRBHsQFDrAdwMVKxbl0FK1kSa,SpATywNh6bZuzm8s1ceuBUnMUAeoAHHw,12,16,10,0,7,0,3,0,36,5.142857142857143,3,0.0,1,10,0,7,15,0,0,3,0,18,18,0
13244,119603,RwVsCYe1en11KhE66sG3vEW9DQBctFlb,SpATywNh6bZuzm8s1ceuBUnMUAeoAHHw,58,99,46,48,27,0,19,0,239,34.142857142857146,8,0.0,22,46,44,27,77,0,4,19,0,139,100,1
13245,119629,nIvIddlMAmTQagaACOulbZ6PInxlyOy2,G8EPVSXsOYB5YQWZGiz1aVq5Pgr2GrQu,5,3,2,0,1,1,2,0,9,1.2857142857142858,2,0.0,0,2,0,1,3,1,0,2,0,3,6,1
13246,119630,nIvIddlMAmTQagaACOulbZ6PInxlyOy2,RXDvfPUBYFlVdlueBFbLW0mhhAyGEqpt,1,0,0,0,0,0,2,0,2,0.2857142857142857,2,0.0,0,0,0,0,0,0,0,2,0,0,2,1
13247,119633,owff2SMFy8taj2Sp3iBe2dPorkqov8kW,SpATywNh6bZuzm8s1ceuBUnMUAeoAHHw,49,79,53,32,37,16,23,5,245,35.0,15,0.0,12,53,27,37,67,16,5,23,5,129,116,0
13248,119636,ocTIjxG8zBs0mQRpUtpuAKc7MDpzU7Sd,RXDvfPUBYFlVdlueBFbLW0mhhAyGEqpt,5,2,1,0,1,0,3,0,7,1.0,1,0.0,0,1,0,1,2,0,0,3,0,2,5,1
13249,119662,sImBATl7O8yGkyet4MbeHdX4JDcSvSmd,SpATywNh6bZuzm8s1ceuBUnMUAeoAHHw,6,4,1,0,1,0,2,0,8,1.1428571428571428,1,0.0,0,1,0,1,4,0,0,2,0,2,6,1
13250,119668,Iydx83GAroCbGGGXrOpRJJuSwZtmEEM2,G8EPVSXsOYB5YQWZGiz1aVq5Pgr2GrQu,4,2,1,0,1,2,1,0,7,1.0,1,0.0,0,1,0,1,2,2,0,1,0,2,5,0
13251,119670,zVRAzbnjBCQDkq8v9znUSK3YAm6GKwXz,SpATywNh6bZuzm8s1ceuBUnMUAeoAHHw,13,22,1,6,0,1,7,1,38,5.428571428571429,2,0.0,2,1,5,0,20,1,1,7,1,8,30,0
13252,119681,528WImnBRwlpaJrHx5YESmcymECT8QVd,SpATywNh6bZuzm8s1ceuBUnMUAeoAHHw,7,6,4,0,3,0,2,0,15,2.142857142857143,1,0.0,0,4,0,3,6,0,0,2,0,7,8,1
13253,119685,OOIu03NBEHePUSUIFa86FGFP5M136EAn,SpATywNh6bZuzm8s1ceuBUnMUAeoAHHw,46,72,31,12,20,0,14,0,149,21.285714285714285,9,0.0,15,31,12,20,57,0,0,14,0,78,71,0
13254,119699,poqFOGQT2LdvIPHVhQsrQlPpawp1crlg,RXDvfPUBYFlVdlueBFbLW0mhhAyGEqpt,32,104,44,11,40,5,2,0,206,29.428571428571427,5,0.0,0,44,10,40,104,5,1,2,0,94,112,0
13255,119700,6PXcyDdGgas03jfN9GNBg7eDbTNLi58b,A3fsA9Zfv1X2fVEQhTw51lKENdNrEqT3,42,27,13,66,9,0,8,0,123,17.571428571428573,1,0.0,2,13,56,9,25,0,10,8,0,80,43,1
13256,119705,jyrCU8C7BRBPvFcEuIthOI2idRHtzC9e,RXDvfPUBYFlVdlueBFbLW0mhhAyGEqpt,3,0,0,0,0,0,3,0,3,0.42857142857142855,1,0.0,0,0,0,0,0,0,0,3,0,0,3,1
13257,119706,4aBimyYkJ2UKqGpkp7oZ1zAX2svcfueq,SpATywNh6bZuzm8s1ceuBUnMUAeoAHHw,16,17,7,19,5,0,4,0,52,7.428571428571429,4,0.0,10,7,17,5,7,0,2,4,0,39,13,1
13258,119713,6PXcyDdGgas03jfN9GNBg7eDbTNLi58b,bWdj2GDclj5ofokWjzoa5jAwMkxCykd6,2,0,0,0,0,0,2,0,2,0.2857142857142857,1,0.0,0,0,0,0,0,0,0,2,0,0,2,1
13259,119718,GB4yB9EIEjt1Ja66w5VOBhvDfHhUpkZn,G8EPVSXsOYB5YQWZGiz1aVq5Pgr2GrQu,14,13,9,0,8,0,4,0,34,4.857142857142857,3,0.0,0,9,0,8,13,0,0,4,0,17,17,1
13260,119720,k6RJ44LpfDefc4BqSfb5Ks3bqRLzpbPs,A3fsA9Zfv1X2fVEQhTw51lKENdNrEqT3,14,12,0,10,0,0,4,0,26,3.7142857142857144,2,0.0,0,0,9,0,12,0,1,4,0,9,17,1
13261,119726,crYeYmekM522NBCXMSSwnlz38sA9PXwb,SpATywNh6bZuzm8s1ceuBUnMUAeoAHHw,1,0,0,0,0,0,1,0,1,0.14285714285714285,1,0.0,0,0,0,0,0,0,0,1,0,0,1,1
13262,119730,6ap3DhKROc7tFODwClFOjVJl3s3EA3mu,G8EPVSXsOYB5YQWZGiz1aVq5Pgr2GrQu,18,32,21,10,22,0,24,0,109,15.571428571428571,5,0.0,7,21,7,22,25,0,3,24,0,57,52,1
13263,119735,7spTo5lIRwZxDBcGilRyFIwiDfkCxjQE,SpATywNh6bZuzm8s1ceuBUnMUAeoAHHw,20,38,1,24,0,22,13,0,98,14.0,4,0.0,16,1,20,0,22,22,4,13,0,37,61,1
13264,119738,mu5O3Y2ITikjmKkPmDursRzlvrhHDXTz,SpATywNh6bZuzm8s1ceuBUnMUAeoAHHw,2,0,0,0,0,0,2,0,2,0.2857142857142857,1,0.0,0,0,0,0,0,0,0,2,0,0,2,1
13265,119742,PHTS4r6mOEHpVZfm3SzAd9KLg785EPpx,SpATywNh6bZuzm8s1ceuBUnMUAeoAHHw,46,151,69,37,32,79,45,4,417,59.57142857142857,19,0.0,9,69,35,32,142,79,2,45,4,145,272,0
13266,119748,wIXH3gEY2v8CIGUg8D6sapoHRbIUXs86,SpATywNh6bZuzm8s1ceuBUnMUAeoAHHw,21,21,2,17,0,1,4,0,45,6.428571428571429,2,0.0,5,2,17,0,16,1,0,4,0,24,21,1
13267,119749,r81fu0o4ondjTT64GPXMD4igVXZTnWR1,G8EPVSXsOYB5YQWZGiz1aVq5Pgr2GrQu,15,18,1,22,0,0,4,0,45,6.428571428571429,2,0.0,3,1,17,0,15,0,5,4,0,21,24,1
13268,119758,VbCHzxhJd8ennilHHm3zMG389MZjcR4g,SpATywNh6bZuzm8s1ceuBUnMUAeoAHHw,36,51,31,30,16,10,12,0,150,21.428571428571427,11,0.0,10,31,28,16,41,10,2,12,0,85,65,0
13269,119759,eXv6ACzt62C4hMSoDSIQMvmz4LEnGBtm,SpATywNh6bZuzm8s1ceuBUnMUAeoAHHw,23,59,25,42,4,23,41,4,198,28.285714285714285,14,0.0,20,25,33,4,39,23,9,41,4,82,116,0
13270,119765,pTILTxXRSQA3FxWLi5P70kOpV3SZ6Qdg,SpATywNh6bZuzm8s1ceuBUnMUAeoAHHw,1,0,0,0,0,0,1,0,1,0.14285714285714285,1,0.0,0,0,0,0,0,0,0,1,0,0,1,1
13271,119767,OXe0TiHLRyjl3AO2ffihLeA3ZfDF07jU,SpATywNh6bZuzm8s1ceuBUnMUAeoAHHw,12,12,3,0,2,0,2,0,19,2.7142857142857144,2,0.0,0,3,0,2,12,0,0,2,0,5,14,1
13272,119775,Hvo87huFBpCunolEWjcvbDUcmX9h25rT,SpATywNh6bZuzm8s1ceuBUnMUAeoAHHw,30,37,23,9,13,1,10,1,94,13.428571428571429,2,0.0,6,23,9,13,31,1,0,10,1,51,43,1
13273,119777,6r9w9XrCXpAInFHxfDIxOD9m18cX5jcd,SpATywNh6bZuzm8s1ceuBUnMUAeoAHHw,9,9,1,0,1,0,3,0,14,2.0,1,0.0,0,1,0,1,9,0,0,3,0,2,12,1
13274,119783,XRCyFAenNfq06SRijoW2bL3eLeq7TTnH,SpATywNh6bZuzm8s1ceuBUnMUAeoAHHw,2,0,0,0,0,0,2,0,2,0.2857142857142857,1,0.0,0,0,0,0,0,0,0,2,0,0,2,1
13275,119789,s5PM22AMhoKbdj4BvXCXSb2DG7kHVY83,bWdj2GDclj5ofokWjzoa5jAwMkxCykd6,7,9,2,0,1,0,1,0,13,1.8571428571428572,1,0.0,0,2,0,1,9,0,0,1,0,3,10,1
13276,119791,WdCL06lQKY0BoTH9YYJuYqUtT5XtLkKl,A3fsA9Zfv1X2fVEQhTw51lKENdNrEqT3,1,0,0,0,0,0,1,0,1,0.14285714285714285,1,0.0,0,0,0,0,0,0,0,1,0,0,1,1
13277,119801,jORRvCSUTQr1FHykD1dmWMVMdAoKMUmG,RXDvfPUBYFlVdlueBFbLW0mhhAyGEqpt,8,3,2,0,2,0,4,1,12,1.7142857142857142,1,0.0,0,2,0,2,3,0,0,4,1,4,8,1
13278,119802,pgn1580cn8cQemEJzrm47II2SqctZZrK,G8EPVSXsOYB5YQWZGiz1aVq5Pgr2GrQu,36,27,18,0,17,0,3,0,65,9.285714285714286,3,0.0,2,18,0,17,25,0,0,3,0,37,28,0
13279,119807,ABAPRQWSFErhHUFQsJmCoj4Rpg4DtQ8w,bWdj2GDclj5ofokWjzoa5jAwMkxCykd6,2,0,0,0,0,0,6,0,6,0.8571428571428571,2,0.0,0,0,0,0,0,0,0,6,0,0,6,1
13280,119825,xwG9GgMrPHgbqqrlvclpGJMpSPdOCjxQ,A3fsA9Zfv1X2fVEQhTw51lKENdNrEqT3,6,6,0,0,0,0,2,0,8,1.1428571428571428,2,0.0,1,0,0,0,5,0,0,2,0,1,7,1
13281,119833,DhGcyoTp73fKDVPL51XtXQlMqfdtfXVc,SpATywNh6bZuzm8s1ceuBUnMUAeoAHHw,6,3,2,0,2,7,3,0,17,2.4285714285714284,2,0.0,0,2,0,2,3,7,0,3,0,4,13,1
13282,119836,GyWTABuPpZEqO585EnNTIpM2B2faPYN3,A3fsA9Zfv1X2fVEQhTw51lKENdNrEqT3,8,7,5,0,3,0,3,0,18,2.5714285714285716,1,0.0,0,5,0,3,7,0,0,3,0,8,10,1
13283,119867,bCILkQHxUJub9H7cxxmSR5zqZAu3BvHB,SpATywNh6bZuzm8s1ceuBUnMUAeoAHHw,24,19,15,0,8,0,5,0,47,6.714285714285714,2,0.0,0,15,0,8,19,0,0,5,0,23,24,1
13284,119878,T7izEMyckZ14Dpb0HXCCbCEgRCtemG2v,A3fsA9Zfv1X2fVEQhTw51lKENdNrEqT3,7,10,2,0,0,0,8,0,20,2.857142857142857,4,0.0,0,2,0,0,10,0,0,8,0,2,18,1
13285,119879,ClHMnOLy9vZKRtNjcA9yPWajeNvRCNdE,RXDvfPUBYFlVdlueBFbLW0mhhAyGEqpt,1,0,0,0,0,0,1,0,1,0.14285714285714285,1,0.0,0,0,0,0,0,0,0,1,0,0,1,1
13286,119888,pgB6pQ9DmcVMwAXk0gVwFSTwyA4alFe0,SpATywNh6bZuzm8s1ceuBUnMUAeoAHHw,7,4,3,0,0,1,5,0,13,1.8571428571428572,2,0.0,0,3,0,0,4,1,0,5,0,3,10,1
13287,119892,6PXcyDdGgas03jfN9GNBg7eDbTNLi58b,SpATywNh6bZuzm8s1ceuBUnMUAeoAHHw,5,3,1,0,1,1,3,0,9,1.2857142857142858,1,0.0,0,1,0,1,3,1,0,3,0,2,7,1
13288,119895,JAh5RXKrssqx6aZ2Y0OKL2tpBD86qsyv,SpATywNh6bZuzm8s1ceuBUnMUAeoAHHw,10,8,1,0,1,0,9,0,19,2.7142857142857144,1,0.0,0,1,0,1,8,0,0,9,0,2,17,1
13289,119896,c4MI9OfbyJ0RGX9j0ZiKqfaHb3fSOPCp,SpATywNh6bZuzm8s1ceuBUnMUAeoAHHw,9,28,1,11,0,0,10,0,50,7.142857142857143,4,0.0,10,1,11,0,18,0,0,10,0,22,28,1
13290,119898,7nQB7cjVdr2HijR82OoX1oMRPa42JjfY,A3fsA9Zfv1X2fVEQhTw51lKENdNrEqT3,13,7,5,0,2,2,8,1,25,3.5714285714285716,2,0.0,0,5,0,2,7,2,0,8,1,7,18,1
13291,119905,alePu0FhXWTyAf3z1TbtScq1Obpgwyvj,SpATywNh6bZuzm8s1ceuBUnMUAeoAHHw,14,13,2,0,2,1,13,1,32,4.571428571428571,2,0.0,0,2,0,2,13,1,0,13,1,4,28,0
13292,119907,Tlrkgpa05toeVrZOHafHN5HVS3Ley7hG,A3fsA9Zfv1X2fVEQhTw51lKENdNrEqT3,51,37,25,46,13,1,14,1,137,19.571428571428573,5,0.0,6,25,46,13,31,1,0,14,1,90,47,1
13293,119923,nrDkIZH2wqEVh6i4pBxcbRBJIMc9s20b,SpATywNh6bZuzm8s1ceuBUnMUAeoAHHw,32,117,4,65,2,0,31,0,219,31.285714285714285,14,0.0,31,4,57,2,86,0,8,31,0,94,125,0
13294,119933,nHnSkTZVeRCsQFFRAJ2tasC3JodYcJAU,SpATywNh6bZuzm8s1ceuBUnMUAeoAHHw,14,25,11,0,8,0,3,0,47,6.714285714285714,1,0.0,0,11,0,8,25,0,0,3,0,19,28,1
13295,119935,4uCHoIviHPzCtwadirbZDGuLNqx4H5qx,SpATywNh6bZuzm8s1ceuBUnMUAeoAHHw,28,48,23,44,6,0,11,0,132,18.857142857142858,5,0.0,17,23,37,6,31,0,7,11,0,83,49,0
13296,119937,l70wRZ2DS0s6LjbT7C4gRoGrF27x9p2H,bWdj2GDclj5ofokWjzoa5jAwMkxCykd6,1,0,0,0,0,0,1,0,1,0.14285714285714285,1,0.0,0,0,0,0,0,0,0,1,0,0,1,1
13297,119938,hdh7f9dbamC5OLbnjQIw5ciTwmy2oqSe,A3fsA9Zfv1X2fVEQhTw51lKENdNrEqT3,29,29,23,0,19,0,8,0,79,11.285714285714286,4,0.0,0,23,0,19,29,0,0,8,0,42,37,1
13298,119942,D9eQoamtTDpiMV0b0OdGca728kthGUV3,SpATywNh6bZuzm8s1ceuBUnMUAeoAHHw,15,16,0,22,0,0,5,0,43,6.142857142857143,4,0.0,5,0,22,0,11,0,0,5,0,27,16,0
13299,119947,jnIQMhy9SQ2YnxY9vLXkaYJhqSTRkdV3,SpATywNh6bZuzm8s1ceuBUnMUAeoAHHw,24,40,17,7,9,0,8,0,81,11.571428571428571,3,0.0,18,17,7,9,22,0,0,8,0,51,30,1
13300,119949,3dRJytFtMTBsljPJJKUMWZqWEGtFd6rm,SpATywNh6bZuzm8s1ceuBUnMUAeoAHHw,14,16,4,17,3,0,2,0,42,6.0,1,0.0,10,4,14,3,6,0,3,2,0,31,11,1
13301,119953,ixEbiSQCdFYvedCjd9ZSVhkHMvgSKaLG,SpATywNh6bZuzm8s1ceuBUnMUAeoAHHw,8,6,4,0,3,0,3,0,16,2.2857142857142856,2,0.0,0,4,0,3,6,0,0,3,0,7,9,1
13302,119958,lm0zg2eARlzCRkKcI4nbhfozsZEvEhl3,SpATywNh6bZuzm8s1ceuBUnMUAeoAHHw,11,8,1,12,0,0,2,0,23,3.2857142857142856,1,0.0,2,1,11,0,6,0,1,2,0,14,9,1
13303,119960,4TtGjmtd4ISORDD5okRgx7kXAcGUW8IN,RXDvfPUBYFlVdlueBFbLW0mhhAyGEqpt,9,4,3,0,1,4,5,1,18,2.5714285714285716,2,0.0,0,3,0,1,4,4,0,5,1,4,14,1
13304,119969,RpC8ahxzmHtiHrtEolXbAvhs5yymX13F,SpATywNh6bZuzm8s1ceuBUnMUAeoAHHw,5,4,3,0,2,0,2,0,11,1.5714285714285714,1,0.0,0,3,0,2,4,0,0,2,0,5,6,1
13305,119970,4kQU73UJCeVbdLolFE0fE9baW58Y34lz,SpATywNh6bZuzm8s1ceuBUnMUAeoAHHw,11,8,5,0,3,0,8,1,25,3.5714285714285716,1,0.0,0,5,0,3,8,0,0,8,1,8,17,1
13306,119973,0NGZq9HZW5KOrSfzSGGipuN20pCRDMWu,RXDvfPUBYFlVdlueBFbLW0mhhAyGEqpt,13,9,6,0,4,3,4,0,26,3.7142857142857144,1,0.0,0,6,0,4,9,3,0,4,0,10,16,0
13307,119974,VLq5RjmauxaFZfPnx2f9r9Dehjw868o9,SpATywNh6bZuzm8s1ceuBUnMUAeoAHHw,24,61,39,11,16,17,20,2,166,23.714285714285715,10,0.0,2,39,11,16,59,17,0,20,2,68,98,0
13308,119981,hNJz0qbOhrUgajUkzqSdDbybHkuRglfs,A3fsA9Zfv1X2fVEQhTw51lKENdNrEqT3,39,21,15,56,9,1,8,1,111,15.857142857142858,2,0.0,3,15,48,9,18,1,8,8,1,75,36,0
13309,119983,8ZvgmVWPuU4xKWq9tw3YZdhhMDnHsFgT,SpATywNh6bZuzm8s1ceuBUnMUAeoAHHw,57,102,46,51,23,37,63,3,325,46.42857142857143,18,0.0,18,46,45,23,84,37,6,63,3,132,193,0
13310,119991,EjqS3A2Iv9J8JTjinbKy3gdtrrXaSQyJ,bWdj2GDclj5ofokWjzoa5jAwMkxCykd6,4,4,2,0,0,0,2,0,8,1.1428571428571428,2,0.0,0,2,0,0,4,0,0,2,0,2,6,1
13311,119993,GMzSpgZQ6jzVsfHn8W8i83JsYNxnP00b,A3fsA9Zfv1X2fVEQhTw51lKENdNrEqT3,5,3,2,0,1,0,1,0,7,1.0,1,0.0,0,2,0,1,3,0,0,1,0,3,4,1
13312,119994,O4934ANB2qMTFJBwUqvZeG7DbnQJCsce,SpATywNh6bZuzm8s1ceuBUnMUAeoAHHw,27,28,11,29,7,0,3,0,78,11.142857142857142,2,0.0,8,11,27,7,20,0,2,3,0,53,25,1
13313,120004,4mdszhiojUd6ka3AsjiiGyQ3X7W5E7uc,A3fsA9Zfv1X2fVEQhTw51lKENdNrEqT3,1,0,0,0,0,0,2,0,2,0.2857142857142857,2,0.0,0,0,0,0,0,0,0,2,0,0,2,1
13314,120015,4YCZfbR5vSUmQm9JKU53CaLT4o7zzhD5,A3fsA9Zfv1X2fVEQhTw51lKENdNrEqT3,1,0,0,0,0,0,1,0,1,0.14285714285714285,1,0.0,0,0,0,0,0,0,0,1,0,0,1,1
13315,120019,eC4QFVNRkDMJURDQ2ZX8Orvtuy3F8ILJ,SpATywNh6bZuzm8s1ceuBUnMUAeoAHHw,15,18,3,24,1,0,8,0,54,7.714285714285714,2,0.0,8,3,19,1,10,0,5,8,0,31,23,1
13316,120021,xr2T8ak6swOOfU9oanYvPbQ4STab9s9f,bWdj2GDclj5ofokWjzoa5jAwMkxCykd6,11,30,2,0,2,0,16,0,50,7.142857142857143,5,0.0,7,2,0,2,23,0,0,16,0,11,39,1
13317,120022,npXfYqxF0TCNN5vliwdRJdFcBk0rmfXv,bWdj2GDclj5ofokWjzoa5jAwMkxCykd6,13,20,6,16,7,6,15,2,72,10.285714285714286,5,0.0,5,6,14,7,15,6,2,15,2,32,40,0
13318,120026,ZH0VWJ7XJWogjYH6Qq2Nr4TMh6fe5JGW,SpATywNh6bZuzm8s1ceuBUnMUAeoAHHw,38,132,8,29,0,0,20,0,189,27.0,10,0.0,12,8,27,0,120,0,2,20,0,47,142,0
13319,120032,n58OZShh1DSriRlOeR7KzkMLpM8Ixh01,A3fsA9Zfv1X2fVEQhTw51lKENdNrEqT3,2,0,0,0,0,0,3,0,3,0.42857142857142855,1,0.0,0,0,0,0,0,0,0,3,0,0,3,1
13320,120052,2VfZF4h8v7eR70PfxTwoJImij1XH3cw0,SpATywNh6bZuzm8s1ceuBUnMUAeoAHHw,9,5,4,0,3,1,13,0,26,3.7142857142857144,1,0.0,0,4,0,3,5,1,0,13,0,7,19,1
13321,120053,WELjmgdsP962Pc1teJ96xvofKraKe6qa,RXDvfPUBYFlVdlueBFbLW0mhhAyGEqpt,6,5,3,0,1,9,2,0,20,2.857142857142857,1,0.0,0,3,0,1,5,9,0,2,0,4,16,1
13322,120056,fzsHY2LgfBXg8YsHOoWkwNUOqIdUaJDy,bWdj2GDclj5ofokWjzoa5jAwMkxCykd6,2,0,0,0,0,0,3,0,3,0.42857142857142855,1,0.0,0,0,0,0,0,0,0,3,0,0,3,1
13323,120069,md1Mf60Z4ySa4NKHKWMKq8Bxh8C0w3Ro,SpATywNh6bZuzm8s1ceuBUnMUAeoAHHw,10,12,6,0,2,4,7,0,31,4.428571428571429,2,0.0,2,6,0,2,10,4,0,7,0,10,21,1
13324,120070,JkGUdKB9J1ONvSF3GWx5guW4dzLf3fLB,RXDvfPUBYFlVdlueBFbLW0mhhAyGEqpt,6,4,3,0,1,0,2,0,10,1.4285714285714286,1,0.0,0,3,0,1,4,0,0,2,0,4,6,1
13325,120071,3n6ajKAkQu8rgtUnNpdWOfMF8VSNsMVs,G8EPVSXsOYB5YQWZGiz1aVq5Pgr2GrQu,6,5,3,0,0,0,3,0,11,1.5714285714285714,2,0.0,0,3,0,0,5,0,0,3,0,3,8,1
13326,120073,2VfZF4h8v7eR70PfxTwoJImij1XH3cw0,RXDvfPUBYFlVdlueBFbLW0mhhAyGEqpt,5,2,1,0,1,0,2,0,6,0.8571428571428571,1,0.0,0,1,0,1,2,0,0,2,0,2,4,1
13327,120075,OwDVM5C0ZIkYKCNBKi1eBMmRNb7I7ptI,bWdj2GDclj5ofokWjzoa5jAwMkxCykd6,2,0,0,0,0,0,5,0,5,0.7142857142857143,1,0.0,0,0,0,0,0,0,0,5,0,0,5,1
13328,120076,4YCZfbR5vSUmQm9JKU53CaLT4o7zzhD5,G8EPVSXsOYB5YQWZGiz1aVq5Pgr2GrQu,1,0,0,0,0,0,1,0,1,0.14285714285714285,1,0.0,0,0,0,0,0,0,0,1,0,0,1,1
13329,120078,saXRSf4MnhO78zgLoljZlslavqJjBtLm,bWdj2GDclj5ofokWjzoa5jAwMkxCykd6,20,80,7,60,7,48,31,0,233,33.285714285714285,6,0.0,20,7,54,7,60,48,6,31,0,88,145,1
13330,120085,SozLQk8695JG7fvj1Enp26s5ACJQjjq5,RXDvfPUBYFlVdlueBFbLW0mhhAyGEqpt,1,0,0,0,0,0,1,0,1,0.14285714285714285,1,0.0,0,0,0,0,0,0,0,1,0,0,1,1
13331,120088,ZOVfvlm206voHlGJ4V6McNGjtxTxB7JQ,A3fsA9Zfv1X2fVEQhTw51lKENdNrEqT3,16,12,10,0,8,0,4,0,34,4.857142857142857,4,0.0,0,10,0,8,12,0,0,4,0,18,16,1
13332,120097,5pfeeYLWSB4wCSWnPZbrmiSBS3yXgMsk,bWdj2GDclj5ofokWjzoa5jAwMkxCykd6,7,9,1,0,1,8,5,0,24,3.4285714285714284,3,0.0,0,1,0,1,9,8,0,5,0,2,22,1
13333,120100,JdKnU2sktk6AZyjwyIqgEXYK8OtgPCn2,bWdj2GDclj5ofokWjzoa5jAwMkxCykd6,16,27,10,0,15,2,10,0,64,9.142857142857142,4,0.0,4,10,0,15,23,2,0,10,0,29,35,0
13334,120111,aGyzysUQgcpficWqTygk8rcuo677dPZU,SpATywNh6bZuzm8s1ceuBUnMUAeoAHHw,35,114,19,51,10,30,27,3,254,36.285714285714285,9,0.0,35,19,43,10,79,30,8,27,3,107,147,0
13335,120118,cPZ5ch8V46zptI5nnRGh9SfMnAQrVDUi,bWdj2GDclj5ofokWjzoa5jAwMkxCykd6,14,37,20,0,12,7,12,0,88,12.571428571428571,5,0.0,4,20,0,12,33,7,0,12,0,36,52,0
13336,120124,Ga7iU5IP3f6oL4nXlygCBVszreMPGCt3,G8EPVSXsOYB5YQWZGiz1aVq5Pgr2GrQu,1,0,0,0,0,0,1,0,1,0.14285714285714285,1,0.0,0,0,0,0,0,0,0,1,0,0,1,1
13337,120126,c6XaDpje2iQSWpoXkTtf00BW6tACh6Q9,SpATywNh6bZuzm8s1ceuBUnMUAeoAHHw,47,103,51,47,23,41,39,4,308,44.0,7,0.0,15,51,41,23,88,41,6,39,4,130,178,0
13338,120129,nDUXGSBgQyo69KyzDsvsphUp6qKxv1Ib,SpATywNh6bZuzm8s1ceuBUnMUAeoAHHw,5,2,1,0,1,0,2,0,6,0.8571428571428571,1,0.0,0,1,0,1,2,0,0,2,0,2,4,1
13339,120134,nKMPTOF6v1sp7aVmO78zmSRg9f9QXrTf,A3fsA9Zfv1X2fVEQhTw51lKENdNrEqT3,70,54,39,147,22,1,10,0,273,39.0,6,0.0,4,39,131,22,50,1,16,10,0,196,77,1
13340,120142,Uxom3QvnZvmlcNVTXDTJG0YgMkZr2hhX,SpATywNh6bZuzm8s1ceuBUnMUAeoAHHw,7,3,2,0,2,0,2,0,9,1.2857142857142858,1,0.0,0,2,0,2,3,0,0,2,0,4,5,1
13341,120149,LY15AitabC9VNRy9N91XwsKL39G9Yhym,SpATywNh6bZuzm8s1ceuBUnMUAeoAHHw,35,40,26,14,14,14,11,4,123,17.571428571428573,5,0.0,6,26,11,14,34,14,3,11,4,57,66,1
13342,120153,la15uCtK5VeDQX41dystrGx2B895Oqjw,RXDvfPUBYFlVdlueBFbLW0mhhAyGEqpt,45,68,38,82,25,9,8,3,233,33.285714285714285,4,0.0,19,38,79,25,49,9,3,8,3,161,72,1
13343,120158,durZRNVeZgKGbNDftJUmwBeNsWC0AnPo,SpATywNh6bZuzm8s1ceuBUnMUAeoAHHw,1,0,0,0,0,0,1,0,1,0.14285714285714285,1,0.0,0,0,0,0,0,0,0,1,0,0,1,1
13344,120170,80Av2RXrFoxNOdv7EQUM2TDOM0gyNH0J,bWdj2GDclj5ofokWjzoa5jAwMkxCykd6,4,2,1,0,1,0,2,0,6,0.8571428571428571,1,0.0,0,1,0,1,2,0,0,2,0,2,4,1
13345,120171,ThGblU6q4nWmu3ORXgM7eQc8q9vcBP4r,A3fsA9Zfv1X2fVEQhTw51lKENdNrEqT3,37,39,5,56,1,0,28,0,129,18.428571428571427,5,0.0,4,5,49,1,35,0,7,28,0,59,70,1
13346,120177,83cBV2IXkwoW1nUaa1kxaJ98L3bxFsPn,A3fsA9Zfv1X2fVEQhTw51lKENdNrEqT3,80,100,79,74,6,7,20,0,286,40.857142857142854,16,0.0,2,79,74,6,98,7,0,20,0,161,125,0
13347,120181,yBsDX1Dsw9hy8f2NuaeMfD0tvX413Igw,bWdj2GDclj5ofokWjzoa5jAwMkxCykd6,5,2,1,0,1,3,4,0,11,1.5714285714285714,3,0.0,0,1,0,1,2,3,0,4,0,2,9,0
13348,120194,Uylyq7LmmNSvSWdWZxt9uRF9NmGdfp0A,RXDvfPUBYFlVdlueBFbLW0mhhAyGEqpt,1,0,0,0,0,0,1,0,1,0.14285714285714285,1,0.0,0,0,0,0,0,0,0,1,0,0,1,1
13349,120196,qLscbApWydA7z1h7Ht7RN2UnF0mvGZpF,SpATywNh6bZuzm8s1ceuBUnMUAeoAHHw,17,33,1,20,1,0,7,0,62,8.857142857142858,2,0.0,7,1,16,1,26,0,4,7,0,25,37,1
13350,120204,cQbl9j85owwXzcR0zsrhIz1wkEuaLsqG,A3fsA9Zfv1X2fVEQhTw51lKENdNrEqT3,1,0,0,0,0,0,1,0,1,0.14285714285714285,1,0.0,0,0,0,0,0,0,0,1,0,0,1,1
13351,120211,WfK8spzPGQgUUjtYsrbByJpvEEqSCjRx,A3fsA9Zfv1X2fVEQhTw51lKENdNrEqT3,1,0,0,0,0,0,1,0,1,0.14285714285714285,1,0.0,0,0,0,0,0,0,0,1,0,0,1,1
13352,120219,Yp8yvTzeMvocSqLvL15ovVwipej5zHiT,SpATywNh6bZuzm8s1ceuBUnMUAeoAHHw,1,0,0,0,0,0,1,0,1,0.14285714285714285,1,0.0,0,0,0,0,0,0,0,1,0,0,1,1
13353,120228,zVgOUCulbNx05te9mrJWZeO6VJGrw5WO,G8EPVSXsOYB5YQWZGiz1aVq5Pgr2GrQu,14,19,10,8,1,0,9,0,47,6.714285714285714,2,0.0,3,10,5,1,16,0,3,9,0,19,28,1
13354,120230,LY15AitabC9VNRy9N91XwsKL39G9Yhym,G8EPVSXsOYB5YQWZGiz1aVq5Pgr2GrQu,22,43,11,0,11,0,10,0,75,10.714285714285714,6,0.0,8,11,0,11,35,0,0,10,0,30,45,1
13355,120234,1Rj37m2TWBRQIZjAlVjTge1bBoqghnB2,bWdj2GDclj5ofokWjzoa5jAwMkxCykd6,6,0,0,0,0,1,6,1,8,1.1428571428571428,1,0.0,0,0,0,0,0,1,0,6,1,0,8,1
13356,120240,YYie2sncdtzNtDvv2HrWAX3WcnBaHhtH,A3fsA9Zfv1X2fVEQhTw51lKENdNrEqT3,10,3,2,0,2,0,5,1,13,1.8571428571428572,1,0.0,0,2,0,2,3,0,0,5,1,4,9,1
13357,120251,qY3mO9VSgbSXrTZIckLWUEq4U741QpCT,SpATywNh6bZuzm8s1ceuBUnMUAeoAHHw,33,78,17,47,4,4,22,1,173,24.714285714285715,3,0.0,37,17,42,4,41,4,5,22,1,100,73,0
13358,120255,3nXqsLutTeQFNz1Ya8GTFnWUmV4VnYmX,SpATywNh6bZuzm8s1ceuBUnMUAeoAHHw,15,19,2,17,1,1,6,1,47,6.714285714285714,3,0.0,6,2,15,1,13,1,2,6,1,24,23,1
13359,120257,FsHh7NEicgBmDLs5h5Swts1JnEA5erYu,A3fsA9Zfv1X2fVEQhTw51lKENdNrEqT3,1,0,0,0,0,0,2,0,2,0.2857142857142857,1,0.0,0,0,0,0,0,0,0,2,0,0,2,1
13360,120262,x2vyDUpFuVAQOVEKoczKBtYvi1pP4Hfq,SpATywNh6bZuzm8s1ceuBUnMUAeoAHHw,1,0,0,0,0,0,1,0,1,0.14285714285714285,1,0.0,0,0,0,0,0,0,0,1,0,0,1,1
13361,120263,farPAnvPmsSrd5ovHg0tlsOgoAj5LoAg,SpATywNh6bZuzm8s1ceuBUnMUAeoAHHw,4,2,1,0,1,0,1,0,5,0.7142857142857143,1,0.0,0,1,0,1,2,0,0,1,0,2,3,1
13362,120270,oh70wjHZNiJm6YMEO2zTeIrDQMUiqmDd,A3fsA9Zfv1X2fVEQhTw51lKENdNrEqT3,11,15,1,0,1,0,2,0,19,2.7142857142857144,2,0.0,1,1,0,1,14,0,0,2,0,3,16,1
13363,120279,1cxiENcEp3mVuj0hieZU2n66DvVX0lKj,bWdj2GDclj5ofokWjzoa5jAwMkxCykd6,1,0,0,0,0,0,1,0,1,0.14285714285714285,1,0.0,0,0,0,0,0,0,0,1,0,0,1,1
13364,120284,1cxiENcEp3mVuj0hieZU2n66DvVX0lKj,A3fsA9Zfv1X2fVEQhTw51lKENdNrEqT3,8,2,0,0,0,2,10,1,15,2.142857142857143,1,0.0,0,0,0,0,2,2,0,10,1,0,15,1
13365,120285,G6cW0d2bzLHgB0vreFbhNx3GSiMBKbtv,A3fsA9Zfv1X2fVEQhTw51lKENdNrEqT3,40,23,10,48,9,0,3,0,93,13.285714285714286,2,0.0,2,10,46,9,21,0,2,3,0,67,26,1
13366,120287,JdKnU2sktk6AZyjwyIqgEXYK8OtgPCn2,A3fsA9Zfv1X2fVEQhTw51lKENdNrEqT3,11,11,5,0,3,0,3,1,23,3.2857142857142856,1,0.0,0,5,0,3,11,0,0,3,1,8,15,1
13367,120296,WnLVBva4oiF8muizYYbe8GP2LesbDaQA,SpATywNh6bZuzm8s1ceuBUnMUAeoAHHw,9,4,3,0,3,0,2,0,12,1.7142857142857142,1,0.0,0,3,0,3,4,0,0,2,0,6,6,1
13368,120318,Z01b5ZH1XnM8VywoaG2LGeoRdMPqFc6F,SpATywNh6bZuzm8s1ceuBUnMUAeoAHHw,9,9,4,0,3,0,7,1,24,3.4285714285714284,1,0.0,5,4,0,3,4,0,0,7,1,12,12,1
13369,120323,HZLnsnoiGm4WW2vjutmDoR0ipnBBZA4G,A3fsA9Zfv1X2fVEQhTw51lKENdNrEqT3,23,25,19,0,15,0,9,0,68,9.714285714285714,2,0.0,0,19,0,15,25,0,0,9,0,34,34,1
13370,120325,iG6MpbqzKA4jDaDFNYLj8a74oKQT8YWZ,A3fsA9Zfv1X2fVEQhTw51lKENdNrEqT3,2,0,0,0,0,0,4,0,4,0.5714285714285714,1,0.0,0,0,0,0,0,0,0,4,0,0,4,1
13371,120337,KDeaSgZ6wTHm30JcQgLQFVdVYbxH0KHc,SpATywNh6bZuzm8s1ceuBUnMUAeoAHHw,8,18,7,0,3,0,4,0,32,4.571428571428571,3,0.0,2,7,0,3,16,0,0,4,0,12,20,1
13372,120345,DsvMkutBFtLefRL1hsHU5bFQpdJBtlsH,SpATywNh6bZuzm8s1ceuBUnMUAeoAHHw,15,13,1,11,1,0,4,0,30,4.285714285714286,2,0.0,2,1,9,1,11,0,2,4,0,13,17,1
13373,120365,aXiJW8ayzWdjAFuCXJZEkZEM0lQLoZYD,bWdj2GDclj5ofokWjzoa5jAwMkxCykd6,9,16,4,0,2,5,12,1,40,5.714285714285714,2,0.0,4,4,0,2,12,5,0,12,1,10,30,1
13374,120369,Z0j9vlmYA8vddl2WEYwRJJAGu9WTMzZU,SpATywNh6bZuzm8s1ceuBUnMUAeoAHHw,6,3,2,0,2,0,1,0,8,1.1428571428571428,1,0.0,0,2,0,2,3,0,0,1,0,4,4,1
13375,120371,XQgYe2uvAKPXdUiz5f6AHKp9LdPbPxAU,A3fsA9Zfv1X2fVEQhTw51lKENdNrEqT3,5,4,2,0,1,0,2,0,9,1.2857142857142858,2,0.0,0,2,0,1,4,0,0,2,0,3,6,1
13376,120374,ePOpOKycvORTPdc6DfieYb44dd8ej3gR,SpATywNh6bZuzm8s1ceuBUnMUAeoAHHw,8,7,6,0,6,0,1,0,20,2.857142857142857,1,0.0,0,6,0,6,7,0,0,1,0,12,8,1
13377,120390,snoVfOu7m3uQyb0rtN2hVEbVR2VoIt0E,SpATywNh6bZuzm8s1ceuBUnMUAeoAHHw,1,0,0,0,0,0,1,0,1,0.14285714285714285,1,0.0,0,0,0,0,0,0,0,1,0,0,1,1
13378,120399,tQgPfoIxEUrRTpkUJ12lc7yYMouZEU13,SpATywNh6bZuzm8s1ceuBUnMUAeoAHHw,8,11,3,0,3,0,8,0,25,3.5714285714285716,2,0.0,0,3,0,3,11,0,0,8,0,6,19,1
13379,120400,STgJR8QT5S3NDhZTGanzgxzj1oLmNnCR,SpATywNh6bZuzm8s1ceuBUnMUAeoAHHw,19,10,8,0,7,3,6,0,34,4.857142857142857,1,0.0,0,8,0,7,10,3,0,6,0,15,19,1
13380,120402,Y2MWDCkue2rmZywdTMYpTi8OGrxwTILf,A3fsA9Zfv1X2fVEQhTw51lKENdNrEqT3,1,0,0,0,0,0,1,0,1,0.14285714285714285,1,0.0,0,0,0,0,0,0,0,1,0,0,1,1
13381,120404,NYt3HW4iIDKFfkoDHUmE2GfhEi6C8Rqu,A3fsA9Zfv1X2fVEQhTw51lKENdNrEqT3,8,9,3,0,2,0,6,0,20,2.857142857142857,2,0.0,1,3,0,2,8,0,0,6,0,6,14,1
13382,120406,7Tzl2OTGekrrZ1AXSNaODNbj4vnVdNB2,G8EPVSXsOYB5YQWZGiz1aVq5Pgr2GrQu,22,32,3,20,4,25,19,2,105,15.0,3,0.0,13,3,11,4,19,25,9,19,2,31,74,0
13383,120412,JPQfQe2O1MgBbogZcbI6qUWraQxSj98z,A3fsA9Zfv1X2fVEQhTw51lKENdNrEqT3,1,0,0,0,0,0,1,0,1,0.14285714285714285,1,0.0,0,0,0,0,0,0,0,1,0,0,1,1
13384,120415,lk6sSo2mEoREiTaQjIlY6dKahZkFRKmP,bWdj2GDclj5ofokWjzoa5jAwMkxCykd6,19,22,10,66,6,0,10,0,114,16.285714285714285,3,0.0,6,10,60,6,16,0,6,10,0,82,32,1
13385,120416,vQlqRATWFUYVohKNm8Qpw3XkVdJ2DmuJ,SpATywNh6bZuzm8s1ceuBUnMUAeoAHHw,14,18,0,17,0,0,1,0,36,5.142857142857143,1,0.0,7,0,14,0,11,0,3,1,0,21,15,1
13386,120417,DHUv7XpIZcPp2QYGNmTXjhgg7Zq4BpJ7,G8EPVSXsOYB5YQWZGiz1aVq5Pgr2GrQu,4,2,1,0,1,0,1,0,5,0.7142857142857143,1,0.0,0,1,0,1,2,0,0,1,0,2,3,1
13387,120419,ozv3HO6eArxO9HBSOsAR70hZyYDwrV65,A3fsA9Zfv1X2fVEQhTw51lKENdNrEqT3,6,2,1,0,1,0,5,0,9,1.2857142857142858,1,0.0,0,1,0,1,2,0,0,5,0,2,7,1
13388,120421,ouTwCUFDa5PRzaHQSaChM41Y1q02nIPV,SpATywNh6bZuzm8s1ceuBUnMUAeoAHHw,17,16,1,4,1,2,9,1,34,4.857142857142857,3,0.0,2,1,3,1,14,2,1,9,1,7,27,1
13389,120425,uEDnklEhnnZbnvzJYYw9brmjh3D3gkF9,SpATywNh6bZuzm8s1ceuBUnMUAeoAHHw,1,0,0,0,0,0,1,0,1,0.14285714285714285,1,0.0,0,0,0,0,0,0,0,1,0,0,1,1
13390,120435,OifsLGRBGBgFFNsSrNDnK5W8Vbn9qLGX,SpATywNh6bZuzm8s1ceuBUnMUAeoAHHw,11,28,1,0,0,0,0,0,29,4.142857142857143,6,0.0,0,1,0,0,28,0,0,0,0,1,28,1
13391,120437,do3bUhF7O0txAhPkHUppSnV3jZUZ9sqF,SpATywNh6bZuzm8s1ceuBUnMUAeoAHHw,5,2,1,0,1,0,2,0,6,0.8571428571428571,1,0.0,0,1,0,1,2,0,0,2,0,2,4,1
13392,120457,1La5rp9ZSz9cfpqCRJiC01Rwvuq5VVrf,SpATywNh6bZuzm8s1ceuBUnMUAeoAHHw,23,25,11,36,4,0,11,0,87,12.428571428571429,6,0.0,10,11,35,4,15,0,1,11,0,60,27,0
13393,120460,5MOHfgPntZIsRWkQebauzpUgUSaHvhFJ,bWdj2GDclj5ofokWjzoa5jAwMkxCykd6,6,9,5,0,1,0,6,0,21,3.0,4,0.0,0,5,0,1,9,0,0,6,0,6,15,1
13394,120465,oldypK1fqRkEbCk0bKZUJxOdwxxRRKXf,A3fsA9Zfv1X2fVEQhTw51lKENdNrEqT3,9,6,1,0,1,0,4,0,12,1.7142857142857142,1,0.0,0,1,0,1,6,0,0,4,0,2,10,1
13395,120471,I6qoCcohBrCkqxmkans73ezft5aIvcN6,SpATywNh6bZuzm8s1ceuBUnMUAeoAHHw,33,90,20,33,8,2,16,0,169,24.142857142857142,7,0.0,29,20,30,8,61,2,3,16,0,87,82,1
13396,120480,GJdrQdNnhszyte4F0GpLkVjDN5SstsoH,SpATywNh6bZuzm8s1ceuBUnMUAeoAHHw,32,75,12,35,10,2,18,2,154,22.0,9,0.0,6,12,33,10,69,2,2,18,2,61,93,0
13397,120489,MgS6WK9esRya9QyP2ZOjbNdLSIL7NuM9,bWdj2GDclj5ofokWjzoa5jAwMkxCykd6,19,25,15,22,5,2,10,0,79,11.285714285714286,3,0.0,5,15,22,5,20,2,0,10,0,47,32,0
13398,120505,QZQvnzqgk3ZJQavig3cFuZehXC8CHrPm,bWdj2GDclj5ofokWjzoa5jAwMkxCykd6,16,46,13,64,17,0,12,0,152,21.714285714285715,4,0.0,28,13,60,17,18,0,4,12,0,118,34,1
13399,120524,MgS6WK9esRya9QyP2ZOjbNdLSIL7NuM9,RXDvfPUBYFlVdlueBFbLW0mhhAyGEqpt,7,7,4,0,1,0,2,0,14,2.0,2,0.0,0,4,0,1,7,0,0,2,0,5,9,1
13400,120531,Fkd43qYCuPn5hi79UziIpsXZru3xZf0R,SpATywNh6bZuzm8s1ceuBUnMUAeoAHHw,4,2,1,0,1,0,1,0,5,0.7142857142857143,1,0.0,0,1,0,1,2,0,0,1,0,2,3,1
13401,120533,vEaXPhyTYPOxUDFFnNSxdj1qZ39pJLBH,A3fsA9Zfv1X2fVEQhTw51lKENdNrEqT3,6,3,2,0,2,0,5,0,12,1.7142857142857142,1,0.0,0,2,0,2,3,0,0,5,0,4,8,1
13402,120538,kJkXo4nSNqbMETrXDpi6P9tfSt1mYjrM,SpATywNh6bZuzm8s1ceuBUnMUAeoAHHw,31,66,32,17,16,0,31,0,162,23.142857142857142,10,0.0,12,32,15,16,54,0,2,31,0,75,87,1
13403,120540,U0zx3N1uSd1t4oNG6aeia4oGy5qrTYII,SpATywNh6bZuzm8s1ceuBUnMUAeoAHHw,15,14,8,9,4,0,4,0,39,5.571428571428571,2,0.0,4,8,9,4,10,0,0,4,0,25,14,1
13404,120547,6T4qq3cdISFF5pyvVKMrcmEINY6BysCY,A3fsA9Zfv1X2fVEQhTw51lKENdNrEqT3,71,42,19,218,2,52,22,2,357,51.0,9,0.0,10,19,189,2,32,52,29,22,2,220,137,0
13405,120550,SiUZQJJjUWzItu4TetvbGbgpJYIYKjWr,SpATywNh6bZuzm8s1ceuBUnMUAeoAHHw,4,2,1,0,1,0,1,0,5,0.7142857142857143,1,0.0,0,1,0,1,2,0,0,1,0,2,3,1
13406,120554,33YJhO56Hz6X3YkBaXAE8jLXj3hGQz0E,RXDvfPUBYFlVdlueBFbLW0mhhAyGEqpt,4,2,1,0,1,0,1,0,5,0.7142857142857143,1,0.0,0,1,0,1,2,0,0,1,0,2,3,1
13407,120559,4YCZfbR5vSUmQm9JKU53CaLT4o7zzhD5,SpATywNh6bZuzm8s1ceuBUnMUAeoAHHw,1,0,0,0,0,0,2,0,2,0.2857142857142857,1,0.0,0,0,0,0,0,0,0,2,0,0,2,1
13408,120567,VL7NPBJuyzF1uV3nhlsl7JEimjvq8BIB,SpATywNh6bZuzm8s1ceuBUnMUAeoAHHw,49,115,70,23,36,7,28,0,279,39.857142857142854,10,0.0,17,70,21,36,98,7,2,28,0,144,135,0
13409,120570,EIpkB0c46fQRf924Hrf1SRiPLyg6N4rm,RXDvfPUBYFlVdlueBFbLW0mhhAyGEqpt,11,7,2,0,2,2,4,0,17,2.4285714285714284,2,0.0,0,2,0,2,7,2,0,4,0,4,13,1
13410,120571,ZcwgBhx2C5CsYaUWf4YQ2u1SWzTYaxss,A3fsA9Zfv1X2fVEQhTw51lKENdNrEqT3,20,29,18,0,13,1,18,1,80,11.428571428571429,5,0.0,6,18,0,13,23,1,0,18,1,37,43,0
13411,120576,WIgM6nvV9YFBo82xFhtQp6923xmcbs69,SpATywNh6bZuzm8s1ceuBUnMUAeoAHHw,35,59,36,22,10,0,14,0,141,20.142857142857142,9,0.0,15,36,22,10,44,0,0,14,0,83,58,0
13412,120580,tepLda5wSKMdrl1YSxQ7o9ErmWSmjLIs,SpATywNh6bZuzm8s1ceuBUnMUAeoAHHw,47,114,70,30,16,43,73,0,346,49.42857142857143,16,0.0,17,70,28,16,97,43,2,73,0,131,215,0
13413,120581,lggvGpvA9S46sPyt7OTjASGRNtpXIFQL,SpATywNh6bZuzm8s1ceuBUnMUAeoAHHw,1,0,0,0,0,0,1,0,1,0.14285714285714285,1,0.0,0,0,0,0,0,0,0,1,0,0,1,1
13414,120586,cOTtp4pVPpt9GEFdMZaLCIG1IBXouqo8,A3fsA9Zfv1X2fVEQhTw51lKENdNrEqT3,1,0,0,0,0,0,1,0,1,0.14285714285714285,1,0.0,0,0,0,0,0,0,0,1,0,0,1,1
13415,120592,eS2KrqTdusBuI6pcIMw5VPgc4bcyJ1eG,bWdj2GDclj5ofokWjzoa5jAwMkxCykd6,2,0,0,0,0,0,2,0,2,0.2857142857142857,1,0.0,0,0,0,0,0,0,0,2,0,0,2,1
13416,120599,yhSGXw7EnYX7J3WWxRb9piBAfJaOtRLJ,SpATywNh6bZuzm8s1ceuBUnMUAeoAHHw,1,0,0,0,0,0,1,0,1,0.14285714285714285,1,0.0,0,0,0,0,0,0,0,1,0,0,1,1
13417,120621,7rzvmKtANOU8M4posmrNW445K28DcImr,SpATywNh6bZuzm8s1ceuBUnMUAeoAHHw,39,70,2,31,1,2,6,2,114,16.285714285714285,4,0.0,10,2,30,1,60,2,1,6,2,43,71,0
13418,120628,T84tM0SY1NeTwy8ZOUv1K7SYM12l3y0u,SpATywNh6bZuzm8s1ceuBUnMUAeoAHHw,17,24,9,0,5,14,11,2,65,9.285714285714286,5,0.0,9,9,0,5,15,14,0,11,2,23,42,1
13419,120633,IU1lGseLxckCGwI4nmuh7Ca5kBungyEP,SpATywNh6bZuzm8s1ceuBUnMUAeoAHHw,14,35,2,25,2,0,2,0,66,9.428571428571429,1,0.0,17,2,21,2,18,0,4,2,0,42,24,1
13420,120634,EDLvNoRIb3gHoThJ1NoAuBrT3yJGczm3,A3fsA9Zfv1X2fVEQhTw51lKENdNrEqT3,2,0,0,0,0,0,4,0,4,0.5714285714285714,1,0.0,0,0,0,0,0,0,0,4,0,0,4,1
13421,120647,RrUICdqzzS6uEuuuo42x7DWjiBSOVyuw,RXDvfPUBYFlVdlueBFbLW0mhhAyGEqpt,11,7,6,0,2,2,4,0,21,3.0,1,0.0,0,6,0,2,7,2,0,4,0,8,13,1
13422,120650,AqOYZE1KwO9ElxY4ESIL8wZt1KCX4QiQ,SpATywNh6bZuzm8s1ceuBUnMUAeoAHHw,44,75,31,36,16,16,21,1,196,28.0,9,0.0,11,31,32,16,64,16,4,21,1,90,106,0
13423,120654,8eYQfp27L4KqSIcQS2lfdmoY7VEE1qFC,RXDvfPUBYFlVdlueBFbLW0mhhAyGEqpt,6,7,1,0,0,0,6,0,14,2.0,2,0.0,0,1,0,0,7,0,0,6,0,1,13,1
13424,120680,Mv7oSGs75OaCjYLhHCNmqqrqaAjjO5gs,A3fsA9Zfv1X2fVEQhTw51lKENdNrEqT3,1,0,0,0,0,0,1,0,1,0.14285714285714285,1,0.0,0,0,0,0,0,0,0,1,0,0,1,1
13425,120683,1U4BCdHxNjp4LH6S6L2sowJaRSmQKYKF,A3fsA9Zfv1X2fVEQhTw51lKENdNrEqT3,5,8,1,0,1,0,5,0,15,2.142857142857143,2,0.0,0,1,0,1,8,0,0,5,0,2,13,1
13426,120685,dWpBguIfALUazWbTuRqWRbI4Z6RC5ZA1,SpATywNh6bZuzm8s1ceuBUnMUAeoAHHw,12,5,2,0,2,3,16,2,30,4.285714285714286,1,0.0,0,2,0,2,5,3,0,16,2,4,26,1
13427,120692,yPANNiQQMnN6yMtp5OhnGyYLdZrKDZ9V,RXDvfPUBYFlVdlueBFbLW0mhhAyGEqpt,9,4,3,0,2,0,3,0,12,1.7142857142857142,1,0.0,0,3,0,2,4,0,0,3,0,5,7,1
13428,120706,RrLCYgvxi3oib8ZNMGweT91KCXFbFqgQ,A3fsA9Zfv1X2fVEQhTw51lKENdNrEqT3,8,8,3,0,1,0,3,0,15,2.142857142857143,1,0.0,0,3,0,1,8,0,0,3,0,4,11,1
13429,120707,YBlpuOz29CjjHYq0RuGLiSzLtjKLdYy2,RXDvfPUBYFlVdlueBFbLW0mhhAyGEqpt,39,61,10,29,5,0,26,0,131,18.714285714285715,11,0.0,6,10,28,5,55,0,1,26,0,49,82,0
13430,120715,ucFGb4sKO6LhsbUaWhFjc3yaUOdGfmQa,RXDvfPUBYFlVdlueBFbLW0mhhAyGEqpt,7,2,2,0,2,0,2,0,8,1.1428571428571428,1,0.0,0,2,0,2,2,0,0,2,0,4,4,1
13431,120724,s4dtgJUQtJkEKTGiW6rNu8EDXRkyQStr,bWdj2GDclj5ofokWjzoa5jAwMkxCykd6,1,0,0,0,0,0,1,0,1,0.14285714285714285,1,0.0,0,0,0,0,0,0,0,1,0,0,1,1
13432,120736,niznzPsNcmf0qkvKVIABVzsBAFOWmMfr,SpATywNh6bZuzm8s1ceuBUnMUAeoAHHw,20,21,1,8,1,1,7,1,40,5.714285714285714,1,0.0,2,1,8,1,19,1,0,7,1,12,28,1
13433,120743,es5GTyNQHE6XqsHqRasxkSTkn6q7y8k2,SpATywNh6bZuzm8s1ceuBUnMUAeoAHHw,29,49,22,40,5,13,14,1,144,20.571428571428573,7,0.0,16,22,34,5,33,13,6,14,1,77,67,0
13434,120744,dvGlk7sqlRtsNklrx9jTekm5CnQWuhDQ,SpATywNh6bZuzm8s1ceuBUnMUAeoAHHw,21,23,13,17,6,0,8,0,67,9.571428571428571,4,0.0,6,13,17,6,17,0,0,8,0,42,25,1
13435,120755,PQyLGsdBWhEy27jacipkmntLAvcsGeQa,SpATywNh6bZuzm8s1ceuBUnMUAeoAHHw,45,51,30,43,17,7,14,0,162,23.142857142857142,5,0.0,17,30,35,17,34,7,8,14,0,99,63,0
13436,120768,lu6LWsHgfburMRdWsFabIR2bIQ3MFD6f,RXDvfPUBYFlVdlueBFbLW0mhhAyGEqpt,52,43,20,80,15,4,14,0,176,25.142857142857142,7,0.0,12,20,72,15,31,4,8,14,0,119,57,0
13437,120769,9ejhHF65VDeA89TY7yPYCEx8qdV4K69n,A3fsA9Zfv1X2fVEQhTw51lKENdNrEqT3,29,22,14,28,10,0,9,0,83,11.857142857142858,2,0.0,1,14,24,10,21,0,4,9,0,49,34,1
13438,120773,uiXIZg9P7E1egIRj5Sno619DS7IwlQY9,SpATywNh6bZuzm8s1ceuBUnMUAeoAHHw,1,0,0,0,0,0,1,0,1,0.14285714285714285,1,0.0,0,0,0,0,0,0,0,1,0,0,1,1
13439,120776,9ejhHF65VDeA89TY7yPYCEx8qdV4K69n,bWdj2GDclj5ofokWjzoa5jAwMkxCykd6,1,0,0,0,0,0,2,0,2,0.2857142857142857,1,0.0,0,0,0,0,0,0,0,2,0,0,2,1
13440,120785,Axaz2TU9iWJqggZ8S9ZVW7y3xhVfFBfg,SpATywNh6bZuzm8s1ceuBUnMUAeoAHHw,9,4,3,0,1,7,6,1,22,3.142857142857143,1,0.0,0,3,0,1,4,7,0,6,1,4,18,1
13441,120787,JBH4PfoUtr8SFyt6u3u3ciODwm9LbhKT,SpATywNh6bZuzm8s1ceuBUnMUAeoAHHw,8,2,1,0,1,0,5,1,10,1.4285714285714286,1,0.0,0,1,0,1,2,0,0,5,1,2,8,1
13442,120792,vSEsL1qLMsR8cNJOX6mMDcN6nVaHqWNR,bWdj2GDclj5ofokWjzoa5jAwMkxCykd6,1,0,0,0,0,0,1,0,1,0.14285714285714285,1,0.0,0,0,0,0,0,0,0,1,0,0,1,1
13443,120800,7bnGjPq4sg9VhmEEoEqqXHNgeEpEuUDV,bWdj2GDclj5ofokWjzoa5jAwMkxCykd6,11,12,6,0,2,23,8,4,55,7.857142857142857,2,0.0,0,6,0,2,12,23,0,8,4,8,47,0
13444,120807,KHl8vTLwoQOTsjJg2pVXTnG0Is0a8K1K,SpATywNh6bZuzm8s1ceuBUnMUAeoAHHw,12,9,5,0,4,0,5,2,25,3.5714285714285716,3,0.0,0,5,0,4,9,0,0,5,2,9,16,1
13445,120809,bWtnIrdbQPafPqPLZtocbxJYk8IfZ76X,SpATywNh6bZuzm8s1ceuBUnMUAeoAHHw,7,3,2,0,2,0,2,0,9,1.2857142857142858,1,0.0,0,2,0,2,3,0,0,2,0,4,5,1
13446,120825,tQAgy689j7VgAO7nbWHE1fj0JJjMUDvF,SpATywNh6bZuzm8s1ceuBUnMUAeoAHHw,4,2,0,0,0,0,2,0,4,0.5714285714285714,1,0.0,0,0,0,0,2,0,0,2,0,0,4,1
13447,120827,tCQ9JALurTpI0v0jgUfmOoOzw21YvN4S,RXDvfPUBYFlVdlueBFbLW0mhhAyGEqpt,10,4,3,0,1,2,6,1,17,2.4285714285714284,1,0.0,0,3,0,1,4,2,0,6,1,4,13,1
13448,120831,JLn36xalC1eIUd4jm6gux9oEgx3gpDxA,SpATywNh6bZuzm8s1ceuBUnMUAeoAHHw,19,40,0,17,0,1,9,1,68,9.714285714285714,4,0.0,6,0,15,0,34,1,2,9,1,21,47,1
13449,120833,72z519PMt8GGBXLvF1FG0oMJuciCSWYJ,SpATywNh6bZuzm8s1ceuBUnMUAeoAHHw,5,4,1,0,0,0,4,0,9,1.2857142857142858,3,0.0,0,1,0,0,4,0,0,4,0,1,8,1
13450,120844,JjOxJWvSLO4lglPA5ATD8doF5KAfdZlo,G8EPVSXsOYB5YQWZGiz1aVq5Pgr2GrQu,1,0,0,0,0,0,1,0,1,0.14285714285714285,1,0.0,0,0,0,0,0,0,0,1,0,0,1,1
13451,120846,UkERsue63b46ZbS092pGmdIWYcMFC2bg,SpATywNh6bZuzm8s1ceuBUnMUAeoAHHw,7,7,1,0,0,0,4,0,12,1.7142857142857142,2,0.0,0,1,0,0,7,0,0,4,0,1,11,1
13452,120851,dJq8sIYKCGcPSHpIrI20rFWCk7jAqAdY,A3fsA9Zfv1X2fVEQhTw51lKENdNrEqT3,8,4,3,0,3,0,1,0,11,1.5714285714285714,1,0.0,0,3,0,3,4,0,0,1,0,6,5,1
13453,120852,EPmLjBxeWpwhjwoRgtmLV8RkhFOu2zzj,G8EPVSXsOYB5YQWZGiz1aVq5Pgr2GrQu,1,0,0,0,0,0,1,0,1,0.14285714285714285,1,0.0,0,0,0,0,0,0,0,1,0,0,1,1
13454,120874,c7JueNv3hDicP8Z6SVI5VQqnBM3V6CD4,SpATywNh6bZuzm8s1ceuBUnMUAeoAHHw,8,7,3,0,2,2,15,3,32,4.571428571428571,1,0.0,0,3,0,2,7,2,0,15,3,5,27,1
13455,120878,edVuZXQuYE4LHUfAzzB1uGhpYsPr0vJx,SpATywNh6bZuzm8s1ceuBUnMUAeoAHHw,61,67,29,64,18,11,21,3,213,30.428571428571427,7,0.0,13,29,52,18,54,11,12,21,3,112,101,0
13456,120881,Ow20UOjVruC0CURQijQixRuf9scGhyUK,G8EPVSXsOYB5YQWZGiz1aVq5Pgr2GrQu,5,2,2,0,2,0,3,0,9,1.2857142857142858,2,0.0,0,2,0,2,2,0,0,3,0,4,5,1
13457,120893,xb9WJcv3uIYBfZD9WqegvIpYdxaUF3h5,bWdj2GDclj5ofokWjzoa5jAwMkxCykd6,8,8,4,0,3,0,3,0,18,2.5714285714285716,2,0.0,0,4,0,3,8,0,0,3,0,7,11,1
13458,120896,u5ObOMoHUcvVsOQTGkiv0BRKKcn8v2w8,A3fsA9Zfv1X2fVEQhTw51lKENdNrEqT3,19,31,19,0,12,0,10,0,72,10.285714285714286,3,0.0,2,19,0,12,29,0,0,10,0,33,39,0
13459,120904,kFp6IoufrvIevAVHehiSDqUBNzpbkI6L,bWdj2GDclj5ofokWjzoa5jAwMkxCykd6,23,49,26,34,11,25,29,2,176,25.142857142857142,8,0.0,6,26,32,11,43,25,2,29,2,75,101,0
13460,120919,DahdU3m64q9GHbzMvs6TdHVFTDo4asbt,SpATywNh6bZuzm8s1ceuBUnMUAeoAHHw,3,0,0,0,0,0,5,0,5,0.7142857142857143,3,0.0,0,0,0,0,0,0,0,5,0,0,5,1
13461,120924,ocmyq6MXRULfgpYdGM8QGfWnP2Queprt,SpATywNh6bZuzm8s1ceuBUnMUAeoAHHw,28,48,28,15,15,0,19,4,129,18.428571428571427,4,0.0,5,28,15,15,43,0,0,19,4,63,66,1
13462,120927,4bcOXBC1lhgwF9Pg3IMx9vJFVwNtFyik,SpATywNh6bZuzm8s1ceuBUnMUAeoAHHw,24,70,14,2,5,1,28,0,120,17.142857142857142,7,0.0,0,14,2,5,70,1,0,28,0,21,99,1
13463,120936,i0ksX07HnsV5rQlWqOr1uKEuc7yNU24c,A3fsA9Zfv1X2fVEQhTw51lKENdNrEqT3,77,65,41,168,18,35,40,3,370,52.857142857142854,11,0.0,9,41,139,18,56,35,29,40,3,207,163,0
13464,120940,KkBPwixR7onoXlZ2HnK8cYokgUE3P396,bWdj2GDclj5ofokWjzoa5jAwMkxCykd6,6,4,0,0,0,0,7,0,11,1.5714285714285714,3,0.0,0,0,0,0,4,0,0,7,0,0,11,1
13465,120948,TevGcL3mCy823FJCU3MpLHqDSnMlx8KC,SpATywNh6bZuzm8s1ceuBUnMUAeoAHHw,28,21,14,29,8,0,4,0,76,10.857142857142858,3,0.0,4,14,22,8,17,0,7,4,0,48,28,0
13466,120953,HGkuwdB1J817cl9wl529SZa2OTu14HFB,SpATywNh6bZuzm8s1ceuBUnMUAeoAHHw,61,69,42,55,26,8,29,1,230,32.857142857142854,7,0.0,17,42,47,26,52,8,8,29,1,132,98,0
13467,120964,JCDOEMgsanA2Wd8RJtg9ctpT52Gae7ak,SpATywNh6bZuzm8s1ceuBUnMUAeoAHHw,1,0,0,0,0,0,1,0,1,0.14285714285714285,1,0.0,0,0,0,0,0,0,0,1,0,0,1,1
13468,120967,nToY9YbKok17BpaPlTxZF9mLZdFu0iiS,G8EPVSXsOYB5YQWZGiz1aVq5Pgr2GrQu,17,19,12,0,9,0,6,0,46,6.571428571428571,3,0.0,3,12,0,9,16,0,0,6,0,24,22,1
13469,120969,hNYqJEuS1AXT481SIEkT37fZObOmjXuX,G8EPVSXsOYB5YQWZGiz1aVq5Pgr2GrQu,7,9,5,0,1,0,5,0,20,2.857142857142857,2,0.0,0,5,0,1,9,0,0,5,0,6,14,1
13470,120983,Tg9kFmEr6KGEyzeoopWvQ3WCSPhx01lk,SpATywNh6bZuzm8s1ceuBUnMUAeoAHHw,46,51,33,38,14,6,34,5,181,25.857142857142858,7,0.0,7,33,36,14,44,6,2,34,5,90,91,1
13471,120986,OcU9jyzQQ3iLPmO8KqVEvCwQSxQdBoZu,SpATywNh6bZuzm8s1ceuBUnMUAeoAHHw,11,15,7,0,5,1,10,1,39,5.571428571428571,2,0.0,4,7,0,5,11,1,0,10,1,16,23,1
13472,120998,y7Z8jSjEija2cXP8zDhgGRVfac5fnMAR,SpATywNh6bZuzm8s1ceuBUnMUAeoAHHw,11,19,1,2,1,0,5,0,28,4.0,6,0.0,1,1,2,1,18,0,0,5,0,5,23,1
13473,121001,k2w7Fl2HRg9SZoDIHFnK8RXCKuBBE2y7,A3fsA9Zfv1X2fVEQhTw51lKENdNrEqT3,92,53,31,142,19,27,15,0,287,41.0,6,0.0,3,31,126,19,50,27,16,15,0,179,108,1
13474,121014,5sovUdBY4AsVUtXY7BWDVXxvHAPsWkZb,A3fsA9Zfv1X2fVEQhTw51lKENdNrEqT3,9,5,4,0,3,0,1,0,13,1.8571428571428572,1,0.0,0,4,0,3,5,0,0,1,0,7,6,1
13475,121017,iW5zRjJuIjvxlxhDULlodfhsU8gFYbbs,SpATywNh6bZuzm8s1ceuBUnMUAeoAHHw,8,7,6,0,0,0,2,0,15,2.142857142857143,1,0.0,0,6,0,0,7,0,0,2,0,6,9,1
13476,121039,QaKdVtbgjSMpkDFYeFcsaL5O2NEtGRQz,SpATywNh6bZuzm8s1ceuBUnMUAeoAHHw,1,0,0,0,0,0,1,0,1,0.14285714285714285,1,0.0,0,0,0,0,0,0,0,1,0,0,1,1
13477,121053,npZiJYBXIvuULdTyVSfZOjhsnEdX6i82,SpATywNh6bZuzm8s1ceuBUnMUAeoAHHw,45,69,34,49,18,0,10,0,180,25.714285714285715,7,0.0,29,34,42,18,40,0,7,10,0,123,57,0
13478,121085,hWWjbjEJOX0Ph07p1EJp8Ya48hU8wP5v,SpATywNh6bZuzm8s1ceuBUnMUAeoAHHw,46,115,55,55,30,0,23,0,278,39.714285714285715,9,0.0,15,55,50,30,100,0,5,23,0,150,128,0
13479,121096,ZtA9pLb0sfgqk6iLVTJtOHVhh3oHeQLC,SpATywNh6bZuzm8s1ceuBUnMUAeoAHHw,5,2,0,0,0,0,3,0,5,0.7142857142857143,1,0.0,0,0,0,0,2,0,0,3,0,0,5,1
13480,121099,cHpOktJabOMVpsE04dze5ePRZnN7bWdJ,A3fsA9Zfv1X2fVEQhTw51lKENdNrEqT3,14,8,6,0,5,0,3,0,22,3.142857142857143,2,0.0,0,6,0,5,8,0,0,3,0,11,11,1
13481,121101,34fQh4AyuAWML6hByTmQJCsftdAFH2Hu,SpATywNh6bZuzm8s1ceuBUnMUAeoAHHw,20,39,16,18,4,0,11,1,89,12.714285714285714,4,0.0,16,16,15,4,23,0,3,11,1,51,38,1
13482,121118,vTTrcE2RlYlajsEul9ylLY6DUQNcdNgN,SpATywNh6bZuzm8s1ceuBUnMUAeoAHHw,7,6,4,0,2,0,2,0,14,2.0,2,0.0,0,4,0,2,6,0,0,2,0,6,8,1
13483,121122,GlVmjWGZ8XsOuLGdZvtzRw0xzELGNzxx,bWdj2GDclj5ofokWjzoa5jAwMkxCykd6,4,12,6,0,0,0,2,0,20,2.857142857142857,6,0.0,0,6,0,0,12,0,0,2,0,6,14,1
13484,121137,5uUrNOrq1vz8XtHDv1LWcBc27EEqbO5u,SpATywNh6bZuzm8s1ceuBUnMUAeoAHHw,19,43,4,22,1,0,7,0,77,11.0,4,0.0,3,4,20,1,40,0,2,7,0,28,49,1
13485,121140,QAb8PmUj3McyQuaW6daHNk0NhlxSWKuO,SpATywNh6bZuzm8s1ceuBUnMUAeoAHHw,1,0,0,0,0,0,2,0,2,0.2857142857142857,2,0.0,0,0,0,0,0,0,0,2,0,0,2,1
13486,121141,YhSlQp6TZH2sVWIgjyn2YxpekmOBzjQt,SpATywNh6bZuzm8s1ceuBUnMUAeoAHHw,27,30,16,25,8,0,11,0,90,12.857142857142858,4,0.0,11,16,23,8,19,0,2,11,0,58,32,0
13487,121142,xlx6h4vTU14b0zR9O9NKqKPZoDtNmECc,A3fsA9Zfv1X2fVEQhTw51lKENdNrEqT3,10,8,4,0,2,0,3,0,17,2.4285714285714284,1,0.0,2,4,0,2,6,0,0,3,0,8,9,1
13488,121143,rik0F1mWVOeGz53BJ3pfmg90EeuTpONo,bWdj2GDclj5ofokWjzoa5jAwMkxCykd6,5,5,1,0,1,0,2,0,9,1.2857142857142858,1,0.0,0,1,0,1,5,0,0,2,0,2,7,1
13489,121145,atoEVjauO8UqqxbDs90qm3bNJMwCLIt0,SpATywNh6bZuzm8s1ceuBUnMUAeoAHHw,49,43,24,37,18,6,10,0,138,19.714285714285715,4,0.0,14,24,31,18,29,6,6,10,0,87,51,0
13490,121156,ZPtKMZp2cxlBd5CcEcoCaraY1yoC22cg,SpATywNh6bZuzm8s1ceuBUnMUAeoAHHw,30,21,14,44,8,1,7,0,95,13.571428571428571,2,0.0,4,14,38,8,17,1,6,7,0,64,31,0
13491,121161,Yl3fWDphM6Ifhmu0NrJgclA0dIl02Kms,A3fsA9Zfv1X2fVEQhTw51lKENdNrEqT3,41,20,13,54,8,5,9,0,109,15.571428571428571,4,0.0,3,13,48,8,17,5,6,9,0,72,37,1
13492,121165,Sp3nYt5ii7nPRoxqEiVcKwwIa973Pnnr,A3fsA9Zfv1X2fVEQhTw51lKENdNrEqT3,29,11,6,64,2,0,4,0,87,12.428571428571429,2,0.0,4,6,54,2,7,0,10,4,0,66,21,1
13493,121169,WJs2oS3DHmzLGumW31DTiDLH77aXdb4Z,G8EPVSXsOYB5YQWZGiz1aVq5Pgr2GrQu,1,0,0,0,0,0,1,0,1,0.14285714285714285,1,0.0,0,0,0,0,0,0,0,1,0,0,1,1
13494,121171,w81M8LsxqroaoVvhuOiOu12ogu2TTrVp,SpATywNh6bZuzm8s1ceuBUnMUAeoAHHw,8,8,2,0,3,0,4,0,17,2.4285714285714284,3,0.0,0,2,0,3,8,0,0,4,0,5,12,1
13495,121172,J7iejq5NtsfdHjPTK3MrPhGPRoJN9WrB,bWdj2GDclj5ofokWjzoa5jAwMkxCykd6,1,0,0,0,0,0,1,0,1,0.14285714285714285,1,0.0,0,0,0,0,0,0,0,1,0,0,1,1
13496,121195,rrD2k9raPTugWiiZJjKTcEpxfKzXPOoh,A3fsA9Zfv1X2fVEQhTw51lKENdNrEqT3,5,2,1,0,1,0,2,0,6,0.8571428571428571,1,0.0,0,1,0,1,2,0,0,2,0,2,4,1
13497,121200,xyoj4G3pVqlUCzQtS2iNDV55nyPLJkyp,A3fsA9Zfv1X2fVEQhTw51lKENdNrEqT3,8,5,4,0,4,0,1,0,14,2.0,1,0.0,0,4,0,4,5,0,0,1,0,8,6,1
13498,121201,osRqgZRzeeCEid1eYNHbUWEZePoVbqKO,SpATywNh6bZuzm8s1ceuBUnMUAeoAHHw,6,3,1,0,1,0,2,0,7,1.0,1,0.0,0,1,0,1,3,0,0,2,0,2,5,1
13499,121205,irUhnQtLaQWO9Ilnw5LLg2nfVwuwwh1f,SpATywNh6bZuzm8s1ceuBUnMUAeoAHHw,5,5,0,0,0,0,6,1,12,1.7142857142857142,3,0.0,0,0,0,0,5,0,0,6,1,0,12,1
13500,121225,6lL0tobxamv6kkGYMIOtqqnjmWQC4apa,A3fsA9Zfv1X2fVEQhTw51lKENdNrEqT3,71,30,23,138,16,3,9,1,220,31.428571428571427,3,0.0,2,23,123,16,28,3,15,9,1,164,56,1
13501,121226,RdjpcuNJHcq9iKd6LdCp1m7jbwau68ud,SpATywNh6bZuzm8s1ceuBUnMUAeoAHHw,2,0,0,0,0,1,2,0,3,0.42857142857142855,1,0.0,0,0,0,0,0,1,0,2,0,0,3,1
13502,121232,lojhMqQRO46DZsZEpJYUmk4ki07ZAOFG,SpATywNh6bZuzm8s1ceuBUnMUAeoAHHw,1,0,0,0,0,0,1,0,1,0.14285714285714285,1,0.0,0,0,0,0,0,0,0,1,0,0,1,1
13503,121261,YPxQmDfYnmHgiT7CBa1xK3KUyMZAnQfd,A3fsA9Zfv1X2fVEQhTw51lKENdNrEqT3,8,4,3,0,2,0,2,0,11,1.5714285714285714,1,0.0,0,3,0,2,4,0,0,2,0,5,6,1
13504,121269,OifsLGRBGBgFFNsSrNDnK5W8Vbn9qLGX,A3fsA9Zfv1X2fVEQhTw51lKENdNrEqT3,2,2,0,0,0,0,0,0,2,0.2857142857142857,1,0.0,0,0,0,0,2,0,0,0,0,0,2,1
13505,121279,iSSrSd8vVxBC2JC6ajviRFDfdtqLCuym,A3fsA9Zfv1X2fVEQhTw51lKENdNrEqT3,1,0,0,0,0,0,1,0,1,0.14285714285714285,1,0.0,0,0,0,0,0,0,0,1,0,0,1,1
13506,121286,go4j7bRhXINgA1WuC2lRA0Hee8dTMRV5,SpATywNh6bZuzm8s1ceuBUnMUAeoAHHw,8,6,4,0,2,0,6,0,18,2.5714285714285716,2,0.0,0,4,0,2,6,0,0,6,0,6,12,1
13507,121292,b4JhdDZuiMoCYMffFqg7ALO9K4ZBVn12,A3fsA9Zfv1X2fVEQhTw51lKENdNrEqT3,32,29,23,0,15,1,15,0,83,11.857142857142858,3,0.0,0,23,0,15,29,1,0,15,0,38,45,1
13508,121298,ONVx5VkCTs6D7RWJGi0oaLbXvf1yyHqy,bWdj2GDclj5ofokWjzoa5jAwMkxCykd6,1,0,0,0,0,0,1,0,1,0.14285714285714285,1,0.0,0,0,0,0,0,0,0,1,0,0,1,1
13509,121308,vFTyJ5TiVtOMNTDle7WFtHDAgvur1Shs,SpATywNh6bZuzm8s1ceuBUnMUAeoAHHw,7,4,3,0,3,0,2,0,12,1.7142857142857142,1,0.0,0,3,0,3,4,0,0,2,0,6,6,1
13510,121315,20miIbW6puYcFBNRUpHWBfGdgoL7IsKl,A3fsA9Zfv1X2fVEQhTw51lKENdNrEqT3,2,0,0,0,0,0,3,0,3,0.42857142857142855,1,0.0,0,0,0,0,0,0,0,3,0,0,3,1
13511,121316,AOiSjL4Nis9M3s1AhiMS89hfMIvo6CLU,SpATywNh6bZuzm8s1ceuBUnMUAeoAHHw,1,0,0,0,0,0,1,0,1,0.14285714285714285,1,0.0,0,0,0,0,0,0,0,1,0,0,1,1
13512,121325,togvLGeHHJalLzAy7gb7bMJngLXYGAjs,bWdj2GDclj5ofokWjzoa5jAwMkxCykd6,6,2,1,0,1,0,3,0,7,1.0,1,0.0,0,1,0,1,2,0,0,3,0,2,5,1
13513,121327,togvLGeHHJalLzAy7gb7bMJngLXYGAjs,A3fsA9Zfv1X2fVEQhTw51lKENdNrEqT3,2,0,0,0,0,0,2,0,2,0.2857142857142857,1,0.0,0,0,0,0,0,0,0,2,0,0,2,1
13514,121329,zJaHqs5kxeHEJuK4mQU1DIdrSDzLOTmW,bWdj2GDclj5ofokWjzoa5jAwMkxCykd6,1,0,0,0,0,0,1,0,1,0.14285714285714285,1,0.0,0,0,0,0,0,0,0,1,0,0,1,1
13515,121334,X9tesPfVRQu9R7pVopuvpFNecLnZt8Km,SpATywNh6bZuzm8s1ceuBUnMUAeoAHHw,26,36,13,13,5,3,21,2,93,13.285714285714286,5,0.0,8,13,11,5,28,3,2,21,2,37,56,1
13516,121335,rcQSbcF05AQYvzQJmDOGu4MfsQVuu05l,SpATywNh6bZuzm8s1ceuBUnMUAeoAHHw,29,27,16,33,7,2,7,1,93,13.285714285714286,3,0.0,8,16,29,7,19,2,4,7,1,60,33,0
13517,121350,OaR2omePx63fXdBiAV1sA954f6IcbIvq,A3fsA9Zfv1X2fVEQhTw51lKENdNrEqT3,52,55,37,58,21,5,25,0,201,28.714285714285715,8,0.0,4,37,57,21,51,5,1,25,0,119,82,0
13518,121354,EIHhmYlRU23gD32AsZHHvSXzjtFCo0yL,SpATywNh6bZuzm8s1ceuBUnMUAeoAHHw,12,18,2,14,0,2,4,0,40,5.714285714285714,3,0.0,3,2,12,0,15,2,2,4,0,17,23,1
13519,121375,JwzCuKRnJiCboJiRTMovpzJhdCfcNETm,A3fsA9Zfv1X2fVEQhTw51lKENdNrEqT3,12,14,1,0,2,0,1,0,18,2.5714285714285716,1,0.0,0,1,0,2,14,0,0,1,0,3,15,1
13520,121382,Kgm7zLW8p8Jc9BDI12KiHyoMRqlC0TXl,SpATywNh6bZuzm8s1ceuBUnMUAeoAHHw,1,0,0,0,0,0,1,0,1,0.14285714285714285,1,0.0,0,0,0,0,0,0,0,1,0,0,1,1
13521,121383,7af3IyECXIPSWoeM4guaEGHMHNE9EYdr,SpATywNh6bZuzm8s1ceuBUnMUAeoAHHw,1,0,0,0,0,0,1,0,1,0.14285714285714285,1,0.0,0,0,0,0,0,0,0,1,0,0,1,1
13522,121385,3pMXqJaEYEy2mxtFTggtjQ8mcRHGvdLr,SpATywNh6bZuzm8s1ceuBUnMUAeoAHHw,5,4,3,0,0,0,2,0,9,1.2857142857142858,2,0.0,0,3,0,0,4,0,0,2,0,3,6,1
13523,121390,3jWLQZ2XpNpB2H4UFvKRCVfzgbIsEanY,A3fsA9Zfv1X2fVEQhTw51lKENdNrEqT3,1,0,0,0,0,0,1,0,1,0.14285714285714285,1,0.0,0,0,0,0,0,0,0,1,0,0,1,1
13524,121395,Xn0msswMya4DdeH7Dc0xTOd0ODvYwWM7,SpATywNh6bZuzm8s1ceuBUnMUAeoAHHw,5,3,0,0,0,0,3,0,6,0.8571428571428571,2,0.0,0,0,0,0,3,0,0,3,0,0,6,1
13525,121400,BMjIPGqtYoLatxXDEHrhiIMt72Ckp0Wf,SpATywNh6bZuzm8s1ceuBUnMUAeoAHHw,14,41,3,18,0,5,12,2,81,11.571428571428571,3,0.0,6,3,16,0,35,5,2,12,2,25,56,1
13526,121403,Uf8FY0gZoVytp6K7SsDRXVZeOCL2hDEX,bWdj2GDclj5ofokWjzoa5jAwMkxCykd6,13,11,7,0,3,6,13,1,41,5.857142857142857,2,0.0,0,7,0,3,11,6,0,13,1,10,31,1
13527,121409,vi8rW5hK5fGcrIxB8UA7uUUfvDXFcBEr,SpATywNh6bZuzm8s1ceuBUnMUAeoAHHw,6,3,2,0,2,0,1,0,8,1.1428571428571428,1,0.0,0,2,0,2,3,0,0,1,0,4,4,1
13528,121411,VytsQ5XFduK8xsP7edRPe1GY948fNELc,SpATywNh6bZuzm8s1ceuBUnMUAeoAHHw,6,3,2,0,2,0,6,1,14,2.0,3,0.0,0,2,0,2,3,0,0,6,1,4,10,1
13529,121418,HSjT6fK4xHlufEG141acXPeMw5gqxgnK,RXDvfPUBYFlVdlueBFbLW0mhhAyGEqpt,1,0,0,0,0,0,1,0,1,0.14285714285714285,1,0.0,0,0,0,0,0,0,0,1,0,0,1,1
13530,121419,I6qGclNEImKeNJdvIwY5PrrMknw1zeQu,SpATywNh6bZuzm8s1ceuBUnMUAeoAHHw,33,57,28,31,9,4,18,0,147,21.0,6,0.0,10,28,27,9,47,4,4,18,0,74,73,0
13531,121430,wmNYHs69T6CHydhCxfzhydbjA79LMuTD,A3fsA9Zfv1X2fVEQhTw51lKENdNrEqT3,11,7,5,0,4,0,3,0,19,2.7142857142857144,2,0.0,0,5,0,4,7,0,0,3,0,9,10,1
13532,121432,SZ5q3TqDiWq8s23sHXWpsG5po2IH5JPk,A3fsA9Zfv1X2fVEQhTw51lKENdNrEqT3,42,18,12,64,10,0,5,0,109,15.571428571428571,1,0.0,4,12,58,10,14,0,6,5,0,84,25,1
13533,121448,TdEOLyaFODrUztdbfcJuA9ZwFd0i4XD2,SpATywNh6bZuzm8s1ceuBUnMUAeoAHHw,4,3,2,0,0,0,1,0,6,0.8571428571428571,1,0.0,0,2,0,0,3,0,0,1,0,2,4,1
13534,121457,ZBXcY1yn7nPU5Nfb3hlu4PDRbw4uvT17,bWdj2GDclj5ofokWjzoa5jAwMkxCykd6,5,2,1,0,1,0,2,0,6,0.8571428571428571,1,0.0,0,1,0,1,2,0,0,2,0,2,4,1
13535,121491,YydaZKjlAxGfDjMV5cfCRvsT4mycBKZj,SpATywNh6bZuzm8s1ceuBUnMUAeoAHHw,2,0,0,0,0,0,2,0,2,0.2857142857142857,1,0.0,0,0,0,0,0,0,0,2,0,0,2,1
13536,121499,4pJSh8LpNyCkIEyBWC74bNGXhEuDFen1,A3fsA9Zfv1X2fVEQhTw51lKENdNrEqT3,7,3,2,0,2,0,2,0,9,1.2857142857142858,1,0.0,0,2,0,2,3,0,0,2,0,4,5,1
13537,121506,8MuDfPMTQjGdTGCwKyaBRuguRPTmkIOy,SpATywNh6bZuzm8s1ceuBUnMUAeoAHHw,1,0,0,0,0,0,1,0,1,0.14285714285714285,1,0.0,0,0,0,0,0,0,0,1,0,0,1,1
13538,121507,gt5tqcVggdqz1dxVZeHDF843i5ITQdCe,SpATywNh6bZuzm8s1ceuBUnMUAeoAHHw,4,0,0,0,0,0,8,0,8,1.1428571428571428,1,0.0,0,0,0,0,0,0,0,8,0,0,8,1
13539,121533,H4AuaeZGDkkLMPXUAyZX0i8XXk2BDNyk,G8EPVSXsOYB5YQWZGiz1aVq5Pgr2GrQu,6,6,4,0,2,0,1,0,13,1.8571428571428572,1,0.0,0,4,0,2,6,0,0,1,0,6,7,1
13540,121556,D2GfCnbuT86TYful9fFSzT7T5yZ1f04f,A3fsA9Zfv1X2fVEQhTw51lKENdNrEqT3,34,22,15,30,13,0,6,0,86,12.285714285714286,2,0.0,5,15,26,13,17,0,4,6,0,59,27,1
13541,121558,YPFriT4OfareXOz7G4xpBUwlcCA03JlS,SpATywNh6bZuzm8s1ceuBUnMUAeoAHHw,21,22,17,0,13,0,8,0,60,8.571428571428571,2,0.0,0,17,0,13,22,0,0,8,0,30,30,1
13542,121569,4fggBiTulBMhqyvK9Klo3I0joX8sXLqR,RXDvfPUBYFlVdlueBFbLW0mhhAyGEqpt,7,6,3,0,1,0,3,1,14,2.0,2,0.0,0,3,0,1,6,0,0,3,1,4,10,1
13543,121571,LhjMbgeFB1ZSL6HIgJEVDb0SZxar7EsN,A3fsA9Zfv1X2fVEQhTw51lKENdNrEqT3,1,0,0,0,0,0,1,0,1,0.14285714285714285,1,0.0,0,0,0,0,0,0,0,1,0,0,1,1
13544,121573,kj5o7wMZl1s4q0cggcmipnm7O7L6g4Ps,G8EPVSXsOYB5YQWZGiz1aVq5Pgr2GrQu,1,0,0,0,0,0,1,0,1,0.14285714285714285,1,0.0,0,0,0,0,0,0,0,1,0,0,1,1
13545,121590,9iGaqBGS5kkoXjLd87hUL2eIJMVUVKfU,RXDvfPUBYFlVdlueBFbLW0mhhAyGEqpt,9,15,8,0,0,0,4,0,27,3.857142857142857,3,0.0,0,8,0,0,15,0,0,4,0,8,19,1
13546,121598,CtUi7t368xVR51EojyElWFRq57eG1Gx1,bWdj2GDclj5ofokWjzoa5jAwMkxCykd6,6,2,1,0,1,0,3,1,8,1.1428571428571428,1,0.0,0,1,0,1,2,0,0,3,1,2,6,1
13547,121606,qbhlqWnlMqLEJtHv0AQDrobM0lY6ZQwu,SpATywNh6bZuzm8s1ceuBUnMUAeoAHHw,1,0,0,0,0,0,1,0,1,0.14285714285714285,1,0.0,0,0,0,0,0,0,0,1,0,0,1,1
13548,121611,bDlowck7PoswtmYozGMoa41g1GVEejKh,RXDvfPUBYFlVdlueBFbLW0mhhAyGEqpt,113,185,125,134,81,66,31,1,623,89.0,12,0.0,35,125,131,81,150,66,3,31,1,372,251,0
13549,121619,JfftjOGdDbpgbrupi0Gwr899R0jzXikJ,A3fsA9Zfv1X2fVEQhTw51lKENdNrEqT3,17,22,13,0,6,1,14,1,57,8.142857142857142,4,0.0,0,13,0,6,22,1,0,14,1,19,38,1
13550,121641,ThGblU6q4nWmu3ORXgM7eQc8q9vcBP4r,G8EPVSXsOYB5YQWZGiz1aVq5Pgr2GrQu,2,0,0,0,0,0,5,0,5,0.7142857142857143,1,0.0,0,0,0,0,0,0,0,5,0,0,5,1
13551,121643,ZULomXsITwM6vNxcJN8imzU1pyfKn8Cw,bWdj2GDclj5ofokWjzoa5jAwMkxCykd6,4,2,1,0,1,0,1,0,5,0.7142857142857143,1,0.0,0,1,0,1,2,0,0,1,0,2,3,1
13552,121648,jXl4Q6TFlYw71Bn9dguW333wEk83ysVq,SpATywNh6bZuzm8s1ceuBUnMUAeoAHHw,19,87,1,18,1,17,30,2,156,22.285714285714285,4,0.0,30,1,13,1,57,17,5,30,2,45,111,1
13553,121655,h0mYz4sCKBTfszMtgSo44TDhg1SbrdKo,SpATywNh6bZuzm8s1ceuBUnMUAeoAHHw,1,0,0,0,0,0,1,0,1,0.14285714285714285,1,0.0,0,0,0,0,0,0,0,1,0,0,1,1
13554,121662,5HXdL6OatNrhiY174KvxQUp0tpTJ3ory,SpATywNh6bZuzm8s1ceuBUnMUAeoAHHw,18,40,0,8,0,0,16,0,64,9.142857142857142,7,0.0,7,0,7,0,33,0,1,16,0,14,50,0
13555,121671,aCa6UD5e0XT0F0IHI4OQnRXRULZbtISA,SpATywNh6bZuzm8s1ceuBUnMUAeoAHHw,6,2,1,0,1,0,3,0,7,1.0,1,0.0,0,1,0,1,2,0,0,3,0,2,5,1
13556,121698,4QwjE5TQhZzqrIrmgTxr1bYCO2SVUQg8,SpATywNh6bZuzm8s1ceuBUnMUAeoAHHw,5,2,1,0,1,0,2,0,6,0.8571428571428571,1,0.0,0,1,0,1,2,0,0,2,0,2,4,1
13557,121707,4Mn2tC0xP3jJpRjJYgW6V342Z3uScDbd,A3fsA9Zfv1X2fVEQhTw51lKENdNrEqT3,6,3,1,0,1,0,3,0,8,1.1428571428571428,1,0.0,0,1,0,1,3,0,0,3,0,2,6,1
13558,121708,UBz29jsG8rR9fxGJ07ON7jTRlCVHOAv0,A3fsA9Zfv1X2fVEQhTw51lKENdNrEqT3,11,6,4,0,4,0,1,0,15,2.142857142857143,1,0.0,0,4,0,4,6,0,0,1,0,8,7,0
13559,121722,u92r3WC1YEXgmCIXMjFGJYvXTQBxOYhd,SpATywNh6bZuzm8s1ceuBUnMUAeoAHHw,13,11,4,17,3,0,2,0,37,5.285714285714286,1,0.0,6,4,16,3,5,0,1,2,0,29,8,1
13560,121729,ZrDgEyfoUHLa5uf0N0ml9T9xO22FqwKE,SpATywNh6bZuzm8s1ceuBUnMUAeoAHHw,36,76,7,78,3,9,33,2,208,29.714285714285715,8,0.0,28,7,64,3,48,9,14,33,2,102,106,0
13561,121734,x6OLIz4hMM0ByyN6TmY57kyFyEddmJ4M,A3fsA9Zfv1X2fVEQhTw51lKENdNrEqT3,6,9,4,0,0,0,4,0,17,2.4285714285714284,2,0.0,0,4,0,0,9,0,0,4,0,4,13,1
13562,121761,x6OLIz4hMM0ByyN6TmY57kyFyEddmJ4M,bWdj2GDclj5ofokWjzoa5jAwMkxCykd6,21,30,11,64,11,1,8,1,126,18.0,2,0.0,11,11,58,11,19,1,6,8,1,91,35,1
13563,121765,v4KRIvW2fm59UFurmYoSZsK2mZZrmnsA,bWdj2GDclj5ofokWjzoa5jAwMkxCykd6,9,6,3,0,1,10,11,2,33,4.714285714285714,3,0.0,0,3,0,1,6,10,0,11,2,4,29,1
13564,121767,v4KRIvW2fm59UFurmYoSZsK2mZZrmnsA,A3fsA9Zfv1X2fVEQhTw51lKENdNrEqT3,6,3,2,0,2,0,1,0,8,1.1428571428571428,1,0.0,0,2,0,2,3,0,0,1,0,4,4,1
13565,121775,jqFdSJ7Rp5LdpTT9xaXcYyPDgZuP8K28,SpATywNh6bZuzm8s1ceuBUnMUAeoAHHw,8,6,1,0,1,0,3,0,11,1.5714285714285714,1,0.0,0,1,0,1,6,0,0,3,0,2,9,1
13566,121787,x4Txzgd0OUi5yqi55NtM21eJpZWiZeEW,A3fsA9Zfv1X2fVEQhTw51lKENdNrEqT3,40,36,14,44,10,0,9,0,113,16.142857142857142,3,0.0,2,14,43,10,34,0,1,9,0,69,44,1
13567,121807,FAflDmZ5UbfFzu5Y3WrugBr3CXMWVehE,bWdj2GDclj5ofokWjzoa5jAwMkxCykd6,1,0,0,0,0,0,1,0,1,0.14285714285714285,1,0.0,0,0,0,0,0,0,0,1,0,0,1,1
13568,121808,QhQuu2NMHYcgj0YP3onmnea8Jv814Mc8,SpATywNh6bZuzm8s1ceuBUnMUAeoAHHw,4,3,1,0,1,0,1,0,6,0.8571428571428571,1,0.0,0,1,0,1,3,0,0,1,0,2,4,1
13569,121817,qZUSZi93i2Ee9CUC34HmFgFywQL2ImeW,SpATywNh6bZuzm8s1ceuBUnMUAeoAHHw,22,50,6,0,5,0,19,1,81,11.571428571428571,2,0.0,3,6,0,5,47,0,0,19,1,14,67,1
13570,121819,PmBLjK8JCE0PzpkrJAjhhCm5nVqtWEV1,A3fsA9Zfv1X2fVEQhTw51lKENdNrEqT3,1,0,0,0,0,0,1,0,1,0.14285714285714285,1,0.0,0,0,0,0,0,0,0,1,0,0,1,1
13571,121821,qsqfA7OOnk8HnDIdBoWsK3JLpkRs9fc7,A3fsA9Zfv1X2fVEQhTw51lKENdNrEqT3,1,0,0,0,0,0,1,0,1,0.14285714285714285,1,0.0,0,0,0,0,0,0,0,1,0,0,1,1
13572,121831,SiH274DFlaeNzsDPV8qquK4qRpZHyEyM,SpATywNh6bZuzm8s1ceuBUnMUAeoAHHw,30,28,18,22,8,8,9,0,93,13.285714285714286,3,0.0,6,18,19,8,22,8,3,9,0,51,42,1
13573,121832,smSHdwJ1UOXCOwbwU1gE5ygVGM1XcWJI,SpATywNh6bZuzm8s1ceuBUnMUAeoAHHw,10,6,3,0,2,0,4,2,17,2.4285714285714284,1,0.0,0,3,0,2,6,0,0,4,2,5,12,1
13574,121833,QhQuu2NMHYcgj0YP3onmnea8Jv814Mc8,G8EPVSXsOYB5YQWZGiz1aVq5Pgr2GrQu,5,3,1,0,1,0,3,0,8,1.1428571428571428,1,0.0,0,1,0,1,3,0,0,3,0,2,6,1
13575,121840,A3FGIvcpmP9UeVzECTe66iC9lFbKmHRb,RXDvfPUBYFlVdlueBFbLW0mhhAyGEqpt,45,70,36,124,21,42,18,31,342,48.857142857142854,8,0.0,21,36,102,21,49,42,22,18,31,180,162,0
13576,121845,k6ujPs3A9T0AUvcnn4NYjtPRZDclle8p,SpATywNh6bZuzm8s1ceuBUnMUAeoAHHw,1,0,0,0,0,0,1,0,1,0.14285714285714285,1,0.0,0,0,0,0,0,0,0,1,0,0,1,1
13577,121846,986WgoFI0AZSDPIvWwBI8MUZveW4E4Xu,SpATywNh6bZuzm8s1ceuBUnMUAeoAHHw,1,0,0,0,0,0,1,0,1,0.14285714285714285,1,0.0,0,0,0,0,0,0,0,1,0,0,1,1
13578,121853,6kheVQ9HoYcmvRy4m74n5u7AB6nlCIYR,SpATywNh6bZuzm8s1ceuBUnMUAeoAHHw,7,3,2,0,2,0,2,0,9,1.2857142857142858,1,0.0,0,2,0,2,3,0,0,2,0,4,5,1
13579,121859,IcRuYze0CzOpE4oHF70ukHAkSTPB9bCH,SpATywNh6bZuzm8s1ceuBUnMUAeoAHHw,24,59,5,29,0,10,13,1,117,16.714285714285715,7,0.0,23,5,27,0,36,10,2,13,1,55,62,1
13580,121873,nHMoTKw6ss0dSnBzmsq0keGpHH2NjvR7,SpATywNh6bZuzm8s1ceuBUnMUAeoAHHw,43,56,26,49,16,1,21,3,172,24.571428571428573,10,0.0,11,26,44,16,45,1,5,21,3,97,75,1
13581,121889,PhJ8qm8JsHCEW9dAikvHznDiB4SDMYD6,A3fsA9Zfv1X2fVEQhTw51lKENdNrEqT3,6,3,2,0,2,0,1,0,8,1.1428571428571428,1,0.0,0,2,0,2,3,0,0,1,0,4,4,1
13582,121891,lyKWlQXSsOSx9dJ1ME8N6mLGOkZhDx56,SpATywNh6bZuzm8s1ceuBUnMUAeoAHHw,17,33,13,6,7,1,7,0,67,9.571428571428571,4,0.0,15,13,6,7,18,1,0,7,0,41,26,1
13583,121893,Q8D1GMU9DUO6Nj6ySx5rrvLwl2bu2DGZ,SpATywNh6bZuzm8s1ceuBUnMUAeoAHHw,47,115,47,42,19,66,22,1,312,44.57142857142857,8,0.0,49,47,38,19,66,66,4,22,1,153,159,0
13584,121896,IDVV2jtBUYHXvZRwUeupKpLFwBDZmMvi,bWdj2GDclj5ofokWjzoa5jAwMkxCykd6,8,2,2,0,2,0,5,0,11,1.5714285714285714,1,0.0,0,2,0,2,2,0,0,5,0,4,7,1
13585,121903,x2eztv69vavhwR6qv43AthcyQwI14YNr,SpATywNh6bZuzm8s1ceuBUnMUAeoAHHw,16,17,9,12,4,2,5,0,49,7.0,4,0.0,4,9,9,4,13,2,3,5,0,26,23,0
13586,121906,DPTAQ5lGsvjESrb4v1mwHpMaZuqLNytl,SpATywNh6bZuzm8s1ceuBUnMUAeoAHHw,41,53,15,37,6,4,17,1,133,19.0,6,0.0,14,15,29,6,39,4,8,17,1,64,69,0
13587,121937,Ks3akoPw8lV1qZsYDHC2B3y9yzMeHmnf,SpATywNh6bZuzm8s1ceuBUnMUAeoAHHw,1,0,0,0,0,0,2,0,2,0.2857142857142857,1,0.0,0,0,0,0,0,0,0,2,0,0,2,1
13588,121952,x98jQugu3yASfETi9tV0JU7AQJM0sBk6,A3fsA9Zfv1X2fVEQhTw51lKENdNrEqT3,1,0,0,0,0,0,1,0,1,0.14285714285714285,1,0.0,0,0,0,0,0,0,0,1,0,0,1,1
13589,121961,oW9L7CxP0sDxYCxol70CUfkBpdozjWLb,SpATywNh6bZuzm8s1ceuBUnMUAeoAHHw,7,4,3,0,3,0,3,0,13,1.8571428571428572,2,0.0,0,3,0,3,4,0,0,3,0,6,7,0
13590,121984,XGd8OaVZcFiceiXpuPYWv2tDLfwrfQG1,SpATywNh6bZuzm8s1ceuBUnMUAeoAHHw,4,4,2,0,2,0,1,0,9,1.2857142857142858,1,0.0,0,2,0,2,4,0,0,1,0,4,5,1
13591,122008,C7BxnTntfGXjkSosgH12xJ8S1pNqiUlY,SpATywNh6bZuzm8s1ceuBUnMUAeoAHHw,8,4,4,0,3,0,7,0,18,2.5714285714285716,3,0.0,0,4,0,3,4,0,0,7,0,7,11,1
13592,122009,DPTAQ5lGsvjESrb4v1mwHpMaZuqLNytl,G8EPVSXsOYB5YQWZGiz1aVq5Pgr2GrQu,1,0,0,0,0,0,1,0,1,0.14285714285714285,1,0.0,0,0,0,0,0,0,0,1,0,0,1,1
13593,122011,rwCHpAN1sY0GvFYG7zQQk2qpgkOBz9O3,SpATywNh6bZuzm8s1ceuBUnMUAeoAHHw,7,6,3,0,0,2,6,0,17,2.4285714285714284,2,0.0,0,3,0,0,6,2,0,6,0,3,14,1
13594,122031,CfiZ4fswch8CYfHMLc9SAlgLprJRdAVO,SpATywNh6bZuzm8s1ceuBUnMUAeoAHHw,15,16,8,0,16,0,5,0,45,6.428571428571429,2,0.0,0,8,0,16,16,0,0,5,0,24,21,1
13595,122035,PFXaSbylT2XRWmnFTzI7TT06KKEcrU02,G8EPVSXsOYB5YQWZGiz1aVq5Pgr2GrQu,5,2,1,0,1,0,4,0,8,1.1428571428571428,2,0.0,0,1,0,1,2,0,0,4,0,2,6,1
13596,122049,IDVV2jtBUYHXvZRwUeupKpLFwBDZmMvi,A3fsA9Zfv1X2fVEQhTw51lKENdNrEqT3,10,5,5,0,5,0,5,0,20,2.857142857142857,1,0.0,0,5,0,5,5,0,0,5,0,10,10,1
13597,122055,cgc8DGkd3Jwqn7jWLS8pFiVfUMBb7Shb,bWdj2GDclj5ofokWjzoa5jAwMkxCykd6,9,18,0,0,2,3,6,0,29,4.142857142857143,2,0.0,8,0,0,2,10,3,0,6,0,10,19,1
13598,122060,Cyazs2KNzeLH7rwO0YD9wLQWGHR2SXrB,SpATywNh6bZuzm8s1ceuBUnMUAeoAHHw,5,6,3,0,1,0,3,0,13,1.8571428571428572,3,0.0,0,3,0,1,6,0,0,3,0,4,9,1
13599,122062,Cyazs2KNzeLH7rwO0YD9wLQWGHR2SXrB,A3fsA9Zfv1X2fVEQhTw51lKENdNrEqT3,5,7,2,0,1,0,3,0,13,1.8571428571428572,4,0.0,0,2,0,1,7,0,0,3,0,3,10,1
13600,122063,Cyazs2KNzeLH7rwO0YD9wLQWGHR2SXrB,bWdj2GDclj5ofokWjzoa5jAwMkxCykd6,5,6,3,0,1,0,3,0,13,1.8571428571428572,3,0.0,0,3,0,1,6,0,0,3,0,4,9,1
13601,122072,UdIMXWwMbB1F8xXEtwt8g56Lh72G96hQ,SpATywNh6bZuzm8s1ceuBUnMUAeoAHHw,9,10,9,0,9,0,2,0,30,4.285714285714286,1,0.0,0,9,0,9,10,0,0,2,0,18,12,1
13602,122074,JbB7hpnQ5hVzqELznLtzJLRyOZ2rdnyH,SpATywNh6bZuzm8s1ceuBUnMUAeoAHHw,21,42,14,32,7,0,9,0,104,14.857142857142858,4,0.0,25,14,29,7,17,0,3,9,0,75,29,1
13603,122079,cderIDaWBR3ykedbqXoG7yh75mThXkpL,A3fsA9Zfv1X2fVEQhTw51lKENdNrEqT3,47,61,25,84,3,20,25,1,219,31.285714285714285,7,0.0,3,25,71,3,58,20,13,25,1,102,117,1
13604,122080,2dTQ27kTyKMSAN4dn7cbjnuDmdSbybLJ,SpATywNh6bZuzm8s1ceuBUnMUAeoAHHw,39,44,22,42,11,8,21,1,149,21.285714285714285,4,0.0,15,22,42,11,29,8,0,21,1,90,59,0
13605,124650,efygWYkxxUMOGInRZT4qEeuzMRlIpQq6,7GRhBDsirIGkRZBtSMEzNTyDr2JQm4xx,39,114,67,2,65,0,19,2,269,38.42857142857143,7,0.0,35,67,1,65,79,0,1,19,2,168,101,0
13606,124655,znF1cjtWo1KGLXEIK5C3NJfQlk7HZ3U1,7GRhBDsirIGkRZBtSMEzNTyDr2JQm4xx,32,71,19,68,6,35,9,1,209,29.857142857142858,4,0.0,44,19,57,6,27,35,11,9,1,126,83,1
13607,124664,sL5jw3pLWZoRI7avI17oM60mfF67Acgz,7GRhBDsirIGkRZBtSMEzNTyDr2JQm4xx,1,0,0,0,0,0,2,0,2,0.2857142857142857,2,0.0,0,0,0,0,0,0,0,2,0,0,2,1
13608,124666,sL5jw3pLWZoRI7avI17oM60mfF67Acgz,5X6FeZozNMgE2VRi3MJYjkkFK8SETtu2,1,0,0,0,0,0,2,0,2,0.2857142857142857,2,0.0,0,0,0,0,0,0,0,2,0,0,2,1
13609,124672,SglSA2qg6fizXrvdkABD6ypMwWhttZ4P,7GRhBDsirIGkRZBtSMEzNTyDr2JQm4xx,1,0,0,0,0,0,1,0,1,0.14285714285714285,1,0.0,0,0,0,0,0,0,0,1,0,0,1,1
13610,124702,Xv0DoRVy2WPaq7NGSTl3PflvzGmHzjVJ,7GRhBDsirIGkRZBtSMEzNTyDr2JQm4xx,66,232,28,128,24,31,72,0,515,73.57142857142857,12,0.0,138,28,109,24,94,31,19,72,0,299,216,0
13611,124731,kAnFbfXpbNeJLwDkVeY9dBv06ssaFoQQ,7GRhBDsirIGkRZBtSMEzNTyDr2JQm4xx,7,5,4,0,4,0,10,0,23,3.2857142857142856,3,0.0,0,4,0,4,5,0,0,10,0,8,15,1
13612,124735,jlC3YerbEJPhQPclqGgy1CC0ljiFJl8o,5X6FeZozNMgE2VRi3MJYjkkFK8SETtu2,6,2,1,0,1,1,5,0,10,1.4285714285714286,1,0.0,0,1,0,1,2,1,0,5,0,2,8,0
13613,124761,ioaeb7d1U29jI9wsI7DHJ7aiuWWVX3KB,7GRhBDsirIGkRZBtSMEzNTyDr2JQm4xx,1,0,0,0,0,0,1,0,1,0.14285714285714285,1,0.0,0,0,0,0,0,0,0,1,0,0,1,1
13614,124773,GRrERNARfPmHJJ23nleKGef7ZYXS6qd5,5X6FeZozNMgE2VRi3MJYjkkFK8SETtu2,6,13,6,0,1,0,4,0,24,3.4285714285714284,2,0.0,0,6,0,1,13,0,0,4,0,7,17,1
13615,124784,Eh1GmQ1l1uLUtTdjFKV3N8aG3h7KeTZw,7GRhBDsirIGkRZBtSMEzNTyDr2JQm4xx,16,14,9,0,6,11,8,0,48,6.857142857142857,4,0.0,0,9,0,6,14,11,0,8,0,15,33,1
13616,124806,Th577tzrUuQ2mCFol11GPYRTSP1uxDgy,7GRhBDsirIGkRZBtSMEzNTyDr2JQm4xx,1,0,0,0,0,0,10,0,10,1.4285714285714286,7,0.0,0,0,0,0,0,0,0,10,0,0,10,1
13617,124836,axvNuGFei1wBoMeftuvLVoxMq7VwfK2Y,5X6FeZozNMgE2VRi3MJYjkkFK8SETtu2,16,26,0,24,8,2,11,2,73,10.428571428571429,2,0.0,21,0,20,8,5,2,4,11,2,49,24,1
13618,124883,YglOmvsVjCCnNnyOM9hw1BozNvavt4Yw,7GRhBDsirIGkRZBtSMEzNTyDr2JQm4xx,10,10,5,4,5,0,4,0,28,4.0,2,0.0,3,5,3,5,7,0,1,4,0,16,12,1
13619,124907,dy1kaQWxoXWQcnMIwUbIVvY0VEkR7Bs3,5X6FeZozNMgE2VRi3MJYjkkFK8SETtu2,12,29,0,6,5,0,2,0,42,6.0,1,0.0,14,0,6,5,15,0,0,2,0,25,17,1
13620,124914,Jjmm0y7q4AQOSfmS8g0ehDtEqybh04ZX,7GRhBDsirIGkRZBtSMEzNTyDr2JQm4xx,1,0,0,0,0,0,1,0,1,0.14285714285714285,1,0.0,0,0,0,0,0,0,0,1,0,0,1,1
13621,124916,mpVn51vIxcFHSSmrFHwBhXrXBYaAZHXF,5X6FeZozNMgE2VRi3MJYjkkFK8SETtu2,11,12,2,0,5,0,7,1,27,3.857142857142857,3,0.0,8,2,0,5,4,0,0,7,1,15,12,1
13622,124920,gZWf27ETcHz4bBmwZPjiPumw55JZ4IOR,7GRhBDsirIGkRZBtSMEzNTyDr2JQm4xx,5,4,0,0,0,0,4,0,8,1.1428571428571428,2,0.0,0,0,0,0,4,0,0,4,0,0,8,1
13623,124926,v5eLUYR1i3YADviojKZNFPbyLtvvjLpV,5X6FeZozNMgE2VRi3MJYjkkFK8SETtu2,2,0,0,0,0,0,2,0,2,0.2857142857142857,1,0.0,0,0,0,0,0,0,0,2,0,0,2,1
13624,124929,h1vlE6V01uCOV61SCqflFhgAa0WJlRTd,5X6FeZozNMgE2VRi3MJYjkkFK8SETtu2,4,5,2,0,2,0,2,0,11,1.5714285714285714,1,0.0,0,2,0,2,5,0,0,2,0,4,7,1
13625,124935,VRS5uIqYlw2SwZ8kUgzPCb9ckuRb5DEy,7GRhBDsirIGkRZBtSMEzNTyDr2JQm4xx,51,163,1,149,18,2,25,1,359,51.285714285714285,5,0.0,81,1,131,18,82,2,18,25,1,231,128,1
13626,124949,sQym1SSnuvlV9rWhfoiNBuvnxQoSSsrc,7GRhBDsirIGkRZBtSMEzNTyDr2JQm4xx,48,112,40,30,20,12,20,3,237,33.857142857142854,5,0.0,29,40,16,20,83,12,14,20,3,105,132,0
13627,124950,Xn0FkHI67ejumzKXwubbQ6h7XBOcvKHb,7GRhBDsirIGkRZBtSMEzNTyDr2JQm4xx,1,0,0,0,0,0,2,0,2,0.2857142857142857,2,0.0,0,0,0,0,0,0,0,2,0,0,2,1
13628,124961,MQKEfJfHQjDI3xyJjnjmz4WwmQkpOvq2,7GRhBDsirIGkRZBtSMEzNTyDr2JQm4xx,5,5,3,0,2,4,3,0,17,2.4285714285714284,3,0.0,0,3,0,2,5,4,0,3,0,5,12,1
13629,124994,MSCPBeMOma5Q14pYmHkWhGqvOSejEmha,5X6FeZozNMgE2VRi3MJYjkkFK8SETtu2,6,2,1,0,1,2,3,0,9,1.2857142857142858,1,0.0,0,1,0,1,2,2,0,3,0,2,7,1
13630,125011,yvD0Nz5opCTF1LRVqbZEAfslgCLS23uR,5X6FeZozNMgE2VRi3MJYjkkFK8SETtu2,1,0,0,0,0,0,1,0,1,0.14285714285714285,1,0.0,0,0,0,0,0,0,0,1,0,0,1,1
13631,125015,wuCb3DAs0UTa3nnL6gSfoBgjTkpbfyNt,7GRhBDsirIGkRZBtSMEzNTyDr2JQm4xx,2,0,0,0,0,0,10,0,10,1.4285714285714286,5,0.0,0,0,0,0,0,0,0,10,0,0,10,0
13632,125055,GjKIGij44vr1LmHxaYp53Ww7DNMH4X51,7GRhBDsirIGkRZBtSMEzNTyDr2JQm4xx,1,0,0,0,0,0,1,0,1,0.14285714285714285,1,0.0,0,0,0,0,0,0,0,1,0,0,1,1
13633,125056,GjKIGij44vr1LmHxaYp53Ww7DNMH4X51,5X6FeZozNMgE2VRi3MJYjkkFK8SETtu2,1,0,0,0,0,0,1,0,1,0.14285714285714285,1,0.0,0,0,0,0,0,0,0,1,0,0,1,1
13634,125115,nnatF6b6B4eAZHghUjobwQEGoTPTe7ie,5X6FeZozNMgE2VRi3MJYjkkFK8SETtu2,21,53,14,4,4,37,11,0,123,17.571428571428573,8,0.0,3,14,2,4,50,37,2,11,0,23,100,1
13635,125140,IPtj28AIODSKhv67PqVJ25ztTgrx2y8Y,5X6FeZozNMgE2VRi3MJYjkkFK8SETtu2,47,156,25,54,27,1,13,1,277,39.57142857142857,3,0.0,62,25,42,27,94,1,12,13,1,156,121,0
13636,125141,Bh56YjgPG1aYs0o5T2OK5m2v5NWxpiqv,7GRhBDsirIGkRZBtSMEzNTyDr2JQm4xx,1,0,0,0,0,0,1,0,1,0.14285714285714285,1,0.0,0,0,0,0,0,0,0,1,0,0,1,1
13637,125160,ydJO5TQWFF3ccN5IAMRV8tSf6TzPXb3q,5X6FeZozNMgE2VRi3MJYjkkFK8SETtu2,26,25,20,0,16,1,10,1,73,10.428571428571429,3,0.0,1,20,0,16,24,1,0,10,1,37,36,0
13638,125168,lJUTJBRxdmUZMtpc6Z00drkXv7sphS3I,7GRhBDsirIGkRZBtSMEzNTyDr2JQm4xx,1,0,0,0,0,0,1,0,1,0.14285714285714285,1,0.0,0,0,0,0,0,0,0,1,0,0,1,1
13639,125177,lJUTJBRxdmUZMtpc6Z00drkXv7sphS3I,5X6FeZozNMgE2VRi3MJYjkkFK8SETtu2,1,0,0,0,0,0,1,0,1,0.14285714285714285,1,0.0,0,0,0,0,0,0,0,1,0,0,1,1
13640,125180,MlERBU07RIzNVvfWDAfKEm5wuCRo0zhc,5X6FeZozNMgE2VRi3MJYjkkFK8SETtu2,5,2,1,0,1,0,2,0,6,0.8571428571428571,1,0.0,0,1,0,1,2,0,0,2,0,2,4,1
13641,125181,1PtbOwiaYzdbDKR4jwxYZygX1EDGwXDv,5X6FeZozNMgE2VRi3MJYjkkFK8SETtu2,2,0,0,0,0,0,2,0,2,0.2857142857142857,1,0.0,0,0,0,0,0,0,0,2,0,0,2,1
13642,125192,GCOHYGlzOItFnghKeaWS09bGB70fHDaY,7GRhBDsirIGkRZBtSMEzNTyDr2JQm4xx,3,1,0,0,0,0,2,0,3,0.42857142857142855,1,0.0,0,0,0,0,1,0,0,2,0,0,3,1
13643,125200,mHrUva1gb67lEBisDVtTMu9unAmjerQl,5X6FeZozNMgE2VRi3MJYjkkFK8SETtu2,3,1,0,0,0,0,2,0,3,0.42857142857142855,1,0.0,0,0,0,0,1,0,0,2,0,0,3,1
13644,125230,oSabIe7L5topw6hwV4H4ZV0Ug7ZVNxfV,5X6FeZozNMgE2VRi3MJYjkkFK8SETtu2,1,0,0,0,0,0,2,0,2,0.2857142857142857,1,0.0,0,0,0,0,0,0,0,2,0,0,2,1
13645,125231,LKQx76DscP8cMaadDZLCOsushv3ygeRX,7GRhBDsirIGkRZBtSMEzNTyDr2JQm4xx,1,0,0,0,0,0,2,0,2,0.2857142857142857,2,0.0,0,0,0,0,0,0,0,2,0,0,2,1
13646,125245,eOxm8XEI11Xs6eiBi1Nu5QzIagZXwEm9,7GRhBDsirIGkRZBtSMEzNTyDr2JQm4xx,7,0,0,0,0,2,7,0,9,1.2857142857142858,2,0.0,0,0,0,0,0,2,0,7,0,0,9,1
13647,125259,BGrU91p3SJR2EobOQ7G1wG17DcXaN4qI,7GRhBDsirIGkRZBtSMEzNTyDr2JQm4xx,6,5,3,0,2,0,3,0,13,1.8571428571428572,2,0.0,0,3,0,2,5,0,0,3,0,5,8,1
13648,125303,b7PuwalmdIR7gI2f0kgWK9mhLJEyGy0c,7GRhBDsirIGkRZBtSMEzNTyDr2JQm4xx,5,2,1,0,1,0,4,0,8,1.1428571428571428,2,0.0,0,1,0,1,2,0,0,4,0,2,6,1
13649,125376,Im85u8aENweba95uFnFOR6zdQWFnfDOq,7GRhBDsirIGkRZBtSMEzNTyDr2JQm4xx,6,10,6,0,3,0,6,0,25,3.5714285714285716,2,0.0,0,6,0,3,10,0,0,6,0,9,16,1
13650,125417,EApv9HeMdrTOqAiEQ2b8Pe6dV7nBgttc,7GRhBDsirIGkRZBtSMEzNTyDr2JQm4xx,25,30,10,14,12,0,4,0,70,10.0,1,0.0,19,10,11,12,11,0,3,4,0,52,18,1
13651,125427,eRoc2wJbq7MhBPMEmeCelGVn6NCoE6rW,7GRhBDsirIGkRZBtSMEzNTyDr2JQm4xx,5,2,1,0,1,0,2,0,6,0.8571428571428571,1,0.0,0,1,0,1,2,0,0,2,0,2,4,1
13652,125428,7tmNprOSiahGzByaY8XiUnCFEIQfWwuf,7GRhBDsirIGkRZBtSMEzNTyDr2JQm4xx,49,228,37,66,27,10,17,0,385,55.0,9,0.0,122,37,59,27,106,10,7,17,0,245,140,0
13653,125495,idU4PBrRhkhRSQxacAs4twJhArJhSxu3,7GRhBDsirIGkRZBtSMEzNTyDr2JQm4xx,1,0,0,0,0,0,1,0,1,0.14285714285714285,1,0.0,0,0,0,0,0,0,0,1,0,0,1,1
13654,125497,PBb82RihjctDhPv3TdRmoDOf1nw7NrF1,7GRhBDsirIGkRZBtSMEzNTyDr2JQm4xx,7,7,4,0,2,0,4,0,17,2.4285714285714284,2,0.0,0,4,0,2,7,0,0,4,0,6,11,1
13655,125503,EihYm2z8SiHLHxWvKz7i6RRNVdYLw99f,7GRhBDsirIGkRZBtSMEzNTyDr2JQm4xx,2,0,0,0,0,0,4,0,4,0.5714285714285714,1,0.0,0,0,0,0,0,0,0,4,0,0,4,1
13656,125524,v7pdrt6SOAQ5FMXohVYmR0yZQdsegJw7,5X6FeZozNMgE2VRi3MJYjkkFK8SETtu2,13,17,5,10,4,5,21,4,66,9.428571428571429,3,0.0,7,5,9,4,10,5,1,21,4,25,41,1
13657,125535,25EaS6JKE4Hk4CM94OaijCcGTo9ukC8B,5X6FeZozNMgE2VRi3MJYjkkFK8SETtu2,10,17,14,0,1,0,7,1,40,5.714285714285714,2,0.0,0,14,0,1,17,0,0,7,1,15,25,1
13658,125547,QnyfwZyfjleoLWOw3jVeDLlIVv3UkBPV,5X6FeZozNMgE2VRi3MJYjkkFK8SETtu2,8,10,3,0,1,4,4,0,22,3.142857142857143,1,0.0,6,3,0,1,4,4,0,4,0,10,12,1
13659,125585,KN2cc8h9ZKfIgxIX3NczsQQI5NEtrUt5,5X6FeZozNMgE2VRi3MJYjkkFK8SETtu2,23,52,3,0,2,18,14,1,90,12.857142857142858,5,0.0,0,3,0,2,52,18,0,14,1,5,85,0
13660,125611,WTq3F20r9svKD0KV9I01NPhpISpfA3HB,5X6FeZozNMgE2VRi3MJYjkkFK8SETtu2,16,17,7,0,9,0,3,0,36,5.142857142857143,1,0.0,9,7,0,9,8,0,0,3,0,25,11,1
13661,125626,xAPFTLGOI6MhRuvYnyw4iYAuIk60vENo,7GRhBDsirIGkRZBtSMEzNTyDr2JQm4xx,5,9,5,0,0,0,6,0,20,2.857142857142857,1,0.0,0,5,0,0,9,0,0,6,0,5,15,1
13662,125633,FDR62LyL2NPX1eDLrbTp7iEOk4qB3llp,7GRhBDsirIGkRZBtSMEzNTyDr2JQm4xx,26,37,17,10,26,1,15,0,106,15.142857142857142,3,0.0,18,17,10,26,19,1,0,15,0,71,35,1
13663,125658,cUvcpWppohUVKz8Tban8cv5QfXMTXadW,7GRhBDsirIGkRZBtSMEzNTyDr2JQm4xx,1,0,0,0,0,0,2,0,2,0.2857142857142857,2,0.0,0,0,0,0,0,0,0,2,0,0,2,1
13664,125680,tRu7kc3B7i0xOP4FswhcDsdZx5KznD0T,7GRhBDsirIGkRZBtSMEzNTyDr2JQm4xx,2,0,0,0,0,0,3,0,3,0.42857142857142855,1,0.0,0,0,0,0,0,0,0,3,0,0,3,1
13665,125693,Z1sZhLd0yuKMu6iVzogIpx0JDek3jyqT,7GRhBDsirIGkRZBtSMEzNTyDr2JQm4xx,1,0,0,0,0,0,1,0,1,0.14285714285714285,1,0.0,0,0,0,0,0,0,0,1,0,0,1,1
13666,125753,YvYIJVn17sxZcNrdNHi37J2cH2xlqBWH,5X6FeZozNMgE2VRi3MJYjkkFK8SETtu2,1,0,0,0,0,0,1,0,1,0.14285714285714285,1,0.0,0,0,0,0,0,0,0,1,0,0,1,1
13667,125756,ScNAsndZpkOb6xTMDq2TkU95eVmTkUfl,7GRhBDsirIGkRZBtSMEzNTyDr2JQm4xx,4,2,0,0,0,0,2,0,4,0.5714285714285714,1,0.0,0,0,0,0,2,0,0,2,0,0,4,1
13668,125793,xpwei0fjDTwQJLJhl5FjMPXksqpuR5GG,7GRhBDsirIGkRZBtSMEzNTyDr2JQm4xx,105,103,40,111,31,0,29,1,315,45.0,5,0.0,53,40,110,31,50,0,1,29,1,234,81,0
13669,125803,UgRvVqO3twMvJzAlD49rqrTbxTS8yLpX,7GRhBDsirIGkRZBtSMEzNTyDr2JQm4xx,5,4,1,0,1,0,2,0,8,1.1428571428571428,2,0.0,0,1,0,1,4,0,0,2,0,2,6,1
13670,125812,V0uiGOMmu8omN1SkGAlLskA1ec4HbVnU,5X6FeZozNMgE2VRi3MJYjkkFK8SETtu2,2,0,0,0,0,0,4,0,4,0.5714285714285714,1,0.0,0,0,0,0,0,0,0,4,0,0,4,1
13671,125837,k0z6RGGewAn8TOLu7gTAfbvZpKAlaO9s,7GRhBDsirIGkRZBtSMEzNTyDr2JQm4xx,1,0,0,0,0,0,1,0,1,0.14285714285714285,1,0.0,0,0,0,0,0,0,0,1,0,0,1,1
13672,125844,PmtrviA6hBub1PH85YXqVyZgghNsuc4g,7GRhBDsirIGkRZBtSMEzNTyDr2JQm4xx,1,0,0,0,0,0,1,0,1,0.14285714285714285,1,0.0,0,0,0,0,0,0,0,1,0,0,1,1
13673,125846,PmtrviA6hBub1PH85YXqVyZgghNsuc4g,5X6FeZozNMgE2VRi3MJYjkkFK8SETtu2,1,0,0,0,0,0,1,0,1,0.14285714285714285,1,0.0,0,0,0,0,0,0,0,1,0,0,1,1
13674,125847,z1ruPoQWI2YQpUKGJMJN29iqd6Mz8fk8,7GRhBDsirIGkRZBtSMEzNTyDr2JQm4xx,8,8,0,4,2,1,2,0,17,2.4285714285714284,1,0.0,4,0,3,2,4,1,1,2,0,9,8,1
13675,125865,PKH12j56WyhhHbwNNO7EjzMEo1oeOneA,7GRhBDsirIGkRZBtSMEzNTyDr2JQm4xx,1,0,0,0,0,0,1,0,1,0.14285714285714285,1,0.0,0,0,0,0,0,0,0,1,0,0,1,1
13676,125894,nmlYjXdaqWSjPWm2kQhmjZqjjBKhkQAm,5X6FeZozNMgE2VRi3MJYjkkFK8SETtu2,13,32,10,16,7,0,5,0,70,10.0,4,0.0,9,10,14,7,23,0,2,5,0,40,30,0
13677,125906,hZVR7WDKIq3zqJvcwhd3nm8W6syJwx1x,5X6FeZozNMgE2VRi3MJYjkkFK8SETtu2,2,0,0,0,0,0,2,0,2,0.2857142857142857,1,0.0,0,0,0,0,0,0,0,2,0,0,2,1
13678,125943,AGqTzsgnX6vVGxhMaRoHP08rIDTXwtJC,5X6FeZozNMgE2VRi3MJYjkkFK8SETtu2,1,0,0,0,0,0,2,0,2,0.2857142857142857,2,0.0,0,0,0,0,0,0,0,2,0,0,2,1
13679,125947,T286STFeqJDQxeE6WPssgBKbrMMMWoux,5X6FeZozNMgE2VRi3MJYjkkFK8SETtu2,1,0,0,0,0,0,1,0,1,0.14285714285714285,1,0.0,0,0,0,0,0,0,0,1,0,0,1,1
13680,125959,d8nG3CRjdRKOgHNCQ97Y2ebOYVCkXw4D,7GRhBDsirIGkRZBtSMEzNTyDr2JQm4xx,2,0,0,0,0,0,2,0,2,0.2857142857142857,2,0.0,0,0,0,0,0,0,0,2,0,0,2,1
13681,125993,YNJKXpmmDE2uZ1c64Ovdnu4MZUQJ0A5j,7GRhBDsirIGkRZBtSMEzNTyDr2JQm4xx,1,0,0,0,0,0,1,0,1,0.14285714285714285,1,0.0,0,0,0,0,0,0,0,1,0,0,1,1
13682,126003,Vao6JycAVhIhWbjbxKbLXiDUK1ZHKwjo,7GRhBDsirIGkRZBtSMEzNTyDr2JQm4xx,25,34,15,36,2,7,3,0,97,13.857142857142858,2,0.0,9,15,33,2,25,7,3,3,0,59,38,1
13683,126028,zuz5zWSULJWik2s9CGpLrSxy1Iohz1Pf,3VkHkmOtom3jM2wCu94xgzzu1d6Dn7or,5,8,1,0,2,0,2,0,13,1.8571428571428572,1,0.0,6,1,0,2,2,0,0,2,0,9,4,1
13684,126038,Wvy7aTjkVfGR2AI5Thyddx9t5OocikeK,3VkHkmOtom3jM2wCu94xgzzu1d6Dn7or,12,16,7,2,5,3,7,0,40,5.714285714285714,2,0.0,4,7,2,5,12,3,0,7,0,18,22,1
13685,126068,Qx6qZWjPDUKeRPCTEgdIrw1kQo1HZ6cS,3VkHkmOtom3jM2wCu94xgzzu1d6Dn7or,6,2,1,0,1,0,3,1,8,1.1428571428571428,1,0.0,0,1,0,1,2,0,0,3,1,2,6,1
13686,126078,XmAzNK7iGixs3BUw8vyslVqvQxna4SOq,3VkHkmOtom3jM2wCu94xgzzu1d6Dn7or,52,192,50,42,48,26,19,17,394,56.285714285714285,8,0.0,67,50,39,48,125,26,3,19,17,204,190,0
13687,126122,znUdeSZWEmqlyIfXyRjGAECXlMyw5OjY,3VkHkmOtom3jM2wCu94xgzzu1d6Dn7or,4,2,1,0,0,0,3,0,6,0.8571428571428571,1,0.0,0,1,0,0,2,0,0,3,0,1,5,1
13688,126126,zhsA5AWZBFuPp3bkPdAFn7TsTLHqu5n7,3VkHkmOtom3jM2wCu94xgzzu1d6Dn7or,1,0,0,0,0,0,1,0,1,0.14285714285714285,1,0.0,0,0,0,0,0,0,0,1,0,0,1,1
13689,126129,pucJsqwQA7WoZPnFXbRNaqe2LORp0GYI,3VkHkmOtom3jM2wCu94xgzzu1d6Dn7or,78,200,69,60,64,97,24,3,517,73.85714285714286,15,0.0,102,69,53,64,98,97,7,24,3,288,229,0
13690,126160,VjL20uhB0vsgG5TsdPT1FRcMljUbA2A1,3VkHkmOtom3jM2wCu94xgzzu1d6Dn7or,12,7,5,3,5,0,4,0,24,3.4285714285714284,1,0.0,2,5,3,5,5,0,0,4,0,15,9,1
13691,126202,lUnwmGFCSXlOUiII3teJ5zEBeBVUD7WB,3VkHkmOtom3jM2wCu94xgzzu1d6Dn7or,11,7,4,0,4,0,5,0,20,2.857142857142857,1,0.0,0,4,0,4,7,0,0,5,0,8,12,1
13692,126218,6RFMdqS7WGODpRlMSRGkPKo918itHm2G,3VkHkmOtom3jM2wCu94xgzzu1d6Dn7or,12,13,5,5,3,15,32,5,78,11.142857142857142,4,0.0,3,5,4,3,10,15,1,32,5,15,63,1
13693,126219,4dtcI1PUeI5oWIETRkEcEio5CmFfMXLK,3VkHkmOtom3jM2wCu94xgzzu1d6Dn7or,1,0,0,0,0,0,1,0,1,0.14285714285714285,1,0.0,0,0,0,0,0,0,0,1,0,0,1,1
13694,126220,ypU3t9MvytSmk7TAfWOFmnh4mr6TtaFt,3VkHkmOtom3jM2wCu94xgzzu1d6Dn7or,1,0,0,0,0,0,1,0,1,0.14285714285714285,1,0.0,0,0,0,0,0,0,0,1,0,0,1,1
13695,126223,zUCvt1Jo98lqHnxp63DwEHYQVaba0Hj8,3VkHkmOtom3jM2wCu94xgzzu1d6Dn7or,8,7,5,0,3,0,9,0,24,3.4285714285714284,1,0.0,0,5,0,3,7,0,0,9,0,8,16,1
13696,126235,6FSZFmVWEFB26reRPWm9j7oObVdlCuAi,3VkHkmOtom3jM2wCu94xgzzu1d6Dn7or,76,146,63,60,52,20,29,9,379,54.142857142857146,10,0.0,57,63,52,52,89,20,8,29,9,224,155,0
13697,126237,9pT6N4se7KH1WHb9dFs199S3yl7jYfAi,3VkHkmOtom3jM2wCu94xgzzu1d6Dn7or,30,86,22,22,38,23,27,3,221,31.571428571428573,3,0.0,53,22,19,38,33,23,3,27,3,132,89,0
13698,126250,fkQDwAL4gdIPRd4aB7Ol9vgxBJ1hw6Rx,3VkHkmOtom3jM2wCu94xgzzu1d6Dn7or,78,185,52,48,65,6,15,2,373,53.285714285714285,7,0.0,110,52,45,65,75,6,3,15,2,272,101,0
13699,126266,z1HsWLWwZrPH9DdqT5jFIKgFzSaNslpx,3VkHkmOtom3jM2wCu94xgzzu1d6Dn7or,24,51,27,8,10,19,14,2,131,18.714285714285715,4,0.0,9,27,6,10,42,19,2,14,2,52,79,1
13700,126267,lvgatvWcTJcoIRcLajVyWwx2yDaci7m3,3VkHkmOtom3jM2wCu94xgzzu1d6Dn7or,1,0,0,0,0,0,1,0,1,0.14285714285714285,1,0.0,0,0,0,0,0,0,0,1,0,0,1,1
13701,126272,NKKgqSSwnJpenRYnE59UQVVdasPdam0Z,3VkHkmOtom3jM2wCu94xgzzu1d6Dn7or,2,0,0,0,0,0,2,0,2,0.2857142857142857,1,0.0,0,0,0,0,0,0,0,2,0,0,2,1
13702,126278,gd3qxCUQPHYg9xbk9czFLqQh5KKHvjVi,3VkHkmOtom3jM2wCu94xgzzu1d6Dn7or,3,0,0,0,0,0,6,0,6,0.8571428571428571,1,0.0,0,0,0,0,0,0,0,6,0,0,6,1
13703,126287,mSKZDzZ8nLtSXSbILUv2gFiVfzyMEj8E,3VkHkmOtom3jM2wCu94xgzzu1d6Dn7or,1,0,0,0,0,0,1,0,1,0.14285714285714285,1,0.0,0,0,0,0,0,0,0,1,0,0,1,1
13704,126288,6LGn0r67LPmDJWxy2EgNkRFWlZEuKQ3F,3VkHkmOtom3jM2wCu94xgzzu1d6Dn7or,1,0,0,0,0,0,1,0,1,0.14285714285714285,1,0.0,0,0,0,0,0,0,0,1,0,0,1,1
13705,126295,VCflSr4QP1G7vByazykiqPCwJcfGGXL3,3VkHkmOtom3jM2wCu94xgzzu1d6Dn7or,5,2,1,0,1,0,3,0,7,1.0,1,0.0,0,1,0,1,2,0,0,3,0,2,5,1
13706,126312,ldP6KYSVrcc8QpjmvGLsrIWx13SOq0iw,3VkHkmOtom3jM2wCu94xgzzu1d6Dn7or,10,23,8,5,6,4,9,0,55,7.857142857142857,3,0.0,9,8,5,6,14,4,0,9,0,28,27,1
13707,126315,9Zk8SoA9HHXiIf1DkPLEkG6RlHRl1ciY,3VkHkmOtom3jM2wCu94xgzzu1d6Dn7or,13,7,6,0,5,3,9,3,33,4.714285714285714,2,0.0,0,6,0,5,7,3,0,9,3,11,22,1
13708,126323,l4QykzFcC41mVGOdUpTYCbuYnqmkZCXe,3VkHkmOtom3jM2wCu94xgzzu1d6Dn7or,27,18,16,0,14,1,7,1,57,8.142857142857142,4,0.0,0,16,0,14,18,1,0,7,1,30,27,1
13709,126332,ethHdMFOR2OQzHLQgGv8NXjeXYMKOEF1,3VkHkmOtom3jM2wCu94xgzzu1d6Dn7or,9,5,2,0,2,3,6,1,19,2.7142857142857144,1,0.0,2,2,0,2,3,3,0,6,1,6,13,1
13710,126383,wHUI8Q6SegxZkCwExAXl4undimdqHK22,3VkHkmOtom3jM2wCu94xgzzu1d6Dn7or,24,26,15,18,9,17,11,0,96,13.714285714285714,3,0.0,6,15,15,9,20,17,3,11,0,45,51,1
13711,126390,UGDkIyb93lIOfXgnofEbeXQUEtyJawN6,3VkHkmOtom3jM2wCu94xgzzu1d6Dn7or,1,0,0,0,0,0,1,0,1,0.14285714285714285,1,0.0,0,0,0,0,0,0,0,1,0,0,1,1
13712,126432,CxdjVRiGSdnkWYlXct3ijBA50Iwgs01Y,3VkHkmOtom3jM2wCu94xgzzu1d6Dn7or,33,53,17,17,20,4,17,0,128,18.285714285714285,3,0.0,22,17,16,20,31,4,1,17,0,75,53,1
13713,126438,6GElgwafDWFNhJQts2kIN5CQZ1KMOLfa,3VkHkmOtom3jM2wCu94xgzzu1d6Dn7or,38,67,21,56,29,1,11,0,185,26.428571428571427,2,0.0,41,21,49,29,26,1,7,11,0,140,45,0
13714,126442,yAlfFIK62QmTvatWaLp7UjMyJRbbz8ld,3VkHkmOtom3jM2wCu94xgzzu1d6Dn7or,5,11,4,5,4,8,1,0,33,4.714285714285714,4,0.0,2,4,4,4,9,8,1,1,0,14,19,1
13715,126455,1ZCd9N2WnPv96p0luhKiPnK2aqn9GWZB,3VkHkmOtom3jM2wCu94xgzzu1d6Dn7or,7,21,2,4,5,1,3,0,36,5.142857142857143,1,0.0,18,2,3,5,3,1,1,3,0,28,8,1
13716,126463,Bk3oyYaru5lQmJNdOTm1m91MudS3u40V,3VkHkmOtom3jM2wCu94xgzzu1d6Dn7or,12,17,4,11,8,17,18,3,78,11.142857142857142,3,0.0,12,4,10,8,5,17,1,18,3,34,44,0
13717,126477,Gj2OXlBFPGaDRaBfe5Zh60wktBkAXNUX,3VkHkmOtom3jM2wCu94xgzzu1d6Dn7or,1,0,0,0,0,0,2,0,2,0.2857142857142857,1,0.0,0,0,0,0,0,0,0,2,0,0,2,1
13718,126517,aGaqi9cnQPCgRc9cproX6qrgPoZwH926,3VkHkmOtom3jM2wCu94xgzzu1d6Dn7or,49,102,55,13,40,25,32,1,268,38.285714285714285,11,0.0,26,55,12,40,76,25,1,32,1,133,135,1
13719,126538,OcchkIht8b8QIrrapp5dUsDP9GE3Vfdw,3VkHkmOtom3jM2wCu94xgzzu1d6Dn7or,17,12,5,14,6,8,30,0,75,10.714285714285714,7,0.0,6,5,13,6,6,8,1,30,0,30,45,1
13720,126568,vqfmFiF7QLn36tSO5BXTsgSuCRtEMXHE,3VkHkmOtom3jM2wCu94xgzzu1d6Dn7or,1,0,0,0,0,0,3,0,3,0.42857142857142855,1,0.0,0,0,0,0,0,0,0,3,0,0,3,1
13721,126574,Pzc5qQ1UDgVe00Q6u9rA78OkekMtRbKr,3VkHkmOtom3jM2wCu94xgzzu1d6Dn7or,6,7,2,0,2,0,4,0,15,2.142857142857143,4,0.0,0,2,0,2,7,0,0,4,0,4,11,0
13722,126612,OvRHQPlJQt08MjvBAsm9o6SalVx0kpxp,fbPkOYLVPtPgIt0MxizjfFJov3JbHyAi,6,15,1,0,1,0,5,0,22,3.142857142857143,1,0.0,2,1,0,1,13,0,0,5,0,4,18,1
13723,126613,Zl05tzo85snAXIri6adShvvUNKe0OymE,fbPkOYLVPtPgIt0MxizjfFJov3JbHyAi,6,9,3,0,2,0,7,0,21,3.0,1,0.0,4,3,0,2,5,0,0,7,0,9,12,1
13724,126614,heqH52ArHeSze97HDhxIHtMU3K7IMrRM,fbPkOYLVPtPgIt0MxizjfFJov3JbHyAi,9,7,3,0,3,0,6,0,19,2.7142857142857144,1,0.0,2,3,0,3,5,0,0,6,0,8,11,1
13725,126615,YxqQc0FBDNSpG3MFOKGx9ekKufVhxrPh,fbPkOYLVPtPgIt0MxizjfFJov3JbHyAi,17,12,8,0,8,0,4,0,32,4.571428571428571,2,0.0,0,8,0,8,12,0,0,4,0,16,16,1
13726,126616,uieKgiKz9M2OwhKZvR7kKiTuoDNfJUlP,fbPkOYLVPtPgIt0MxizjfFJov3JbHyAi,2,0,0,0,0,0,5,0,5,0.7142857142857143,1,0.0,0,0,0,0,0,0,0,5,0,0,5,1
13727,126617,ysDhewvMwqkWHpjR0j6mtjJo9sLvpRAM,fbPkOYLVPtPgIt0MxizjfFJov3JbHyAi,16,23,9,2,11,15,18,1,79,11.285714285714286,2,0.0,11,9,2,11,12,15,0,18,1,33,46,1
13728,126618,fbJQhb9qJhxn4GPcwi4AErVjPsHJbyL7,fbPkOYLVPtPgIt0MxizjfFJov3JbHyAi,7,12,4,0,5,0,5,0,26,3.7142857142857144,2,0.0,2,4,0,5,10,0,0,5,0,11,15,1
13729,126620,LSVa2jpU1dF8RnC5rzovm0tv2cSNIe8I,fbPkOYLVPtPgIt0MxizjfFJov3JbHyAi,10,9,6,4,4,0,3,0,26,3.7142857142857144,2,0.0,1,6,3,4,8,0,1,3,0,14,12,1
13730,126621,L1D39t7woJJ3WRGAxRtS5wF9BZQP2EYr,fbPkOYLVPtPgIt0MxizjfFJov3JbHyAi,6,5,3,0,3,0,3,0,14,2.0,1,0.0,0,3,0,3,5,0,0,3,0,6,8,1
13731,126625,arRLaw4hZnmx5zrjvIy48oXkTK5DrU7i,fbPkOYLVPtPgIt0MxizjfFJov3JbHyAi,6,4,2,0,1,2,7,0,16,2.2857142857142856,2,0.0,0,2,0,1,4,2,0,7,0,3,13,1
13732,126626,0PTt7yojLQH47Ob79awcf5jvqfHw2L3I,fbPkOYLVPtPgIt0MxizjfFJov3JbHyAi,43,53,27,40,21,18,11,2,172,24.571428571428573,5,0.0,11,27,33,21,42,18,7,11,2,92,80,1
13733,126627,810MRx7l0r4ApLZ3yM1jRSAg5LUkiCFn,fbPkOYLVPtPgIt0MxizjfFJov3JbHyAi,4,2,1,0,1,0,1,0,5,0.7142857142857143,1,0.0,0,1,0,1,2,0,0,1,0,2,3,1
13734,126628,gdWTcSZVoKN1pGf7JyovC0vqfcnT9h18,fbPkOYLVPtPgIt0MxizjfFJov3JbHyAi,8,10,5,0,6,0,15,0,36,5.142857142857143,4,0.0,2,5,0,6,8,0,0,15,0,13,23,1
13735,126629,0hd5ExdLnNdKHQRTwwTLHmDaSlTLMdvd,fbPkOYLVPtPgIt0MxizjfFJov3JbHyAi,5,2,1,0,1,0,4,0,8,1.1428571428571428,1,0.0,0,1,0,1,2,0,0,4,0,2,6,1
13736,126631,I2ghGumCKIaVsnJOGZA0xyJzTnEm5KtW,fbPkOYLVPtPgIt0MxizjfFJov3JbHyAi,14,13,8,4,4,10,7,1,47,6.714285714285714,3,0.0,1,8,3,4,12,10,1,7,1,16,31,1
13737,126634,euBhTje23sMDM8PPQbKVpH6OVKTfG91O,fbPkOYLVPtPgIt0MxizjfFJov3JbHyAi,1,0,0,0,0,0,1,0,1,0.14285714285714285,1,0.0,0,0,0,0,0,0,0,1,0,0,1,1
13738,126635,bA4tnPZD0UU4XAL3OkL7nUjtkAzbgj9d,fbPkOYLVPtPgIt0MxizjfFJov3JbHyAi,7,4,2,0,2,6,2,0,16,2.2857142857142856,1,0.0,0,2,0,2,4,6,0,2,0,4,12,1
13739,126636,P2xHl8oxJOV4TMoYrxym6L2dPSAdMMJs,fbPkOYLVPtPgIt0MxizjfFJov3JbHyAi,4,2,1,0,1,0,1,0,5,0.7142857142857143,1,0.0,0,1,0,1,2,0,0,1,0,2,3,1
13740,126637,c8TFm45r0bfBe26eBlEeUAKDBoTJT9yV,fbPkOYLVPtPgIt0MxizjfFJov3JbHyAi,8,4,3,0,3,0,1,0,11,1.5714285714285714,1,0.0,0,3,0,3,4,0,0,1,0,6,5,0
13741,126638,IBEBjXb2AhSAQmCEtwVxNy77qVPKcclm,fbPkOYLVPtPgIt0MxizjfFJov3JbHyAi,6,4,2,0,1,2,3,0,12,1.7142857142857142,1,0.0,0,2,0,1,4,2,0,3,0,3,9,1
13742,126639,x6BtQH70uuLHaxqzHA21U9wmfT0SxzD9,fbPkOYLVPtPgIt0MxizjfFJov3JbHyAi,6,2,0,0,0,0,5,1,8,1.1428571428571428,2,0.0,0,0,0,0,2,0,0,5,1,0,8,1
13743,126640,99YWSjgqR4hZD4KPEunWhlG5MDGBBYbJ,fbPkOYLVPtPgIt0MxizjfFJov3JbHyAi,6,3,1,0,1,0,2,0,7,1.0,1,0.0,0,1,0,1,3,0,0,2,0,2,5,1
13744,126642,OseLd0Vj4CawbZPfZRznLZH5tivxQP68,fbPkOYLVPtPgIt0MxizjfFJov3JbHyAi,7,4,2,0,2,0,4,0,12,1.7142857142857142,2,0.0,1,2,0,2,3,0,0,4,0,5,7,1
13745,126643,lRTCAuzQcWWtA62pbQwh7xYqG6ghwvm9,fbPkOYLVPtPgIt0MxizjfFJov3JbHyAi,12,17,5,9,10,3,8,0,52,7.428571428571429,1,0.0,11,5,7,10,6,3,2,8,0,33,19,1
13746,126644,N1bQ5aFhcb1yr21loPYJqu2BbdxHrcfB,fbPkOYLVPtPgIt0MxizjfFJov3JbHyAi,11,8,6,0,2,1,6,1,24,3.4285714285714284,1,0.0,0,6,0,2,8,1,0,6,1,8,16,1
13747,126646,mb7Zd70aH6w6tsEQr8q9cAr4RlsgpSEG,fbPkOYLVPtPgIt0MxizjfFJov3JbHyAi,2,0,0,0,0,0,7,0,7,1.0,1,0.0,0,0,0,0,0,0,0,7,0,0,7,1
13748,126647,1tMY1MpuZPW690JnedcAZZYFmf6foWjL,fbPkOYLVPtPgIt0MxizjfFJov3JbHyAi,7,5,3,0,2,7,2,0,19,2.7142857142857144,1,0.0,0,3,0,2,5,7,0,2,0,5,14,1
13749,126649,wdjY1oC33XqL52RaIYWlfwM88qICxfHB,fbPkOYLVPtPgIt0MxizjfFJov3JbHyAi,8,9,5,0,5,4,3,0,26,3.7142857142857144,1,0.0,2,5,0,5,7,4,0,3,0,12,14,0
13750,126650,LD7pbuVHju3VTu9U8udNh6I7JCsw9ECG,fbPkOYLVPtPgIt0MxizjfFJov3JbHyAi,64,84,43,59,32,0,16,0,234,33.42857142857143,6,0.0,30,43,49,32,54,0,10,16,0,154,80,0
13751,126651,ctraTKVJ2JhUCIHyavrJWUiIknGdQbqc,fbPkOYLVPtPgIt0MxizjfFJov3JbHyAi,13,16,9,0,7,0,9,0,41,5.857142857142857,2,0.0,4,9,0,7,12,0,0,9,0,20,21,1
13752,126654,YLJf06fjaksgc6NESkSC4nTSBafk5Yoh,fbPkOYLVPtPgIt0MxizjfFJov3JbHyAi,7,9,2,0,2,0,2,0,15,2.142857142857143,1,0.0,0,2,0,2,9,0,0,2,0,4,11,1
13753,126656,vXwf4MSRd0xkinwiIqWQdnJoLNdmsOvm,fbPkOYLVPtPgIt0MxizjfFJov3JbHyAi,7,3,2,0,2,0,5,0,12,1.7142857142857142,1,0.0,0,2,0,2,3,0,0,5,0,4,8,1
13754,126657,A6zX6I2GfUhXHkfxx6hY7fkYNihUgWzR,fbPkOYLVPtPgIt0MxizjfFJov3JbHyAi,6,6,2,0,2,0,1,0,11,1.5714285714285714,1,0.0,1,2,0,2,5,0,0,1,0,5,6,1
13755,126658,bwZYXSIDocrsg9B80u5hz1s4TUzxdjem,fbPkOYLVPtPgIt0MxizjfFJov3JbHyAi,8,6,2,0,3,0,5,0,16,2.2857142857142856,1,0.0,2,2,0,3,4,0,0,5,0,7,9,1
13756,126659,lUOW63ZIGkmagy3rVXMv25n4vumPKUfs,fbPkOYLVPtPgIt0MxizjfFJov3JbHyAi,5,2,1,0,1,0,3,0,7,1.0,1,0.0,0,1,0,1,2,0,0,3,0,2,5,1
13757,126660,e2CxwSKYgRRxAYL99ajalycn9caM2cox,fbPkOYLVPtPgIt0MxizjfFJov3JbHyAi,5,2,1,0,1,2,6,0,12,1.7142857142857142,1,0.0,0,1,0,1,2,2,0,6,0,2,10,1
13758,126661,7dkSnitaOk46bh4JzUzQh70jkQ2SBZcu,fbPkOYLVPtPgIt0MxizjfFJov3JbHyAi,3,2,1,0,0,0,1,0,4,0.5714285714285714,1,0.0,0,1,0,0,2,0,0,1,0,1,3,1
13759,126662,wUoZ0jO9cvYMtyUP7nefHwtNjYQG7VUS,fbPkOYLVPtPgIt0MxizjfFJov3JbHyAi,2,0,0,0,0,0,7,0,7,1.0,1,0.0,0,0,0,0,0,0,0,7,0,0,7,1
13760,126663,AAbYMvj6N4kPLfJSTWdxJHOFF7gGokhv,fbPkOYLVPtPgIt0MxizjfFJov3JbHyAi,7,3,2,0,2,0,5,0,12,1.7142857142857142,1,0.0,0,2,0,2,3,0,0,5,0,4,8,1
13761,126665,paTNeCrMrWcChojlLsspaorcmQjiSxoH,fbPkOYLVPtPgIt0MxizjfFJov3JbHyAi,2,0,0,0,0,0,3,0,3,0.42857142857142855,1,0.0,0,0,0,0,0,0,0,3,0,0,3,1
13762,126668,GbCaM9AUbbkCquP0Qap7xohw6uCLXYPC,fbPkOYLVPtPgIt0MxizjfFJov3JbHyAi,6,9,0,0,0,3,7,2,21,3.0,2,0.0,0,0,0,0,9,3,0,7,2,0,21,1
13763,126669,pEzMNyrul10BaiwI0ZVRc6CziruRKt37,fbPkOYLVPtPgIt0MxizjfFJov3JbHyAi,1,0,0,0,0,0,1,0,1,0.14285714285714285,1,0.0,0,0,0,0,0,0,0,1,0,0,1,1
13764,126670,G4gv3psLUg6DraQbf90HcUcwjZl74koo,fbPkOYLVPtPgIt0MxizjfFJov3JbHyAi,7,2,2,0,2,0,2,0,8,1.1428571428571428,1,0.0,0,2,0,2,2,0,0,2,0,4,4,1
13765,126672,cAt3kAq8A4nBNACWncm3aidYAQ1d8bbM,fbPkOYLVPtPgIt0MxizjfFJov3JbHyAi,7,6,4,0,2,0,2,0,14,2.0,2,0.0,0,4,0,2,6,0,0,2,0,6,8,1
13766,126673,9iDcxmHxr3SmvjvcATJP2YvHEz7UDHIB,fbPkOYLVPtPgIt0MxizjfFJov3JbHyAi,1,0,0,0,0,0,1,0,1,0.14285714285714285,1,0.0,0,0,0,0,0,0,0,1,0,0,1,1
13767,126674,LqQpVFQv4lJ36VdzJ4TLAuyE3Ov82MrP,fbPkOYLVPtPgIt0MxizjfFJov3JbHyAi,14,13,8,0,6,9,6,1,43,6.142857142857143,2,0.0,1,8,0,6,12,9,0,6,1,15,28,1
13768,126675,IDaqGyhjD6ErPQOFlyvvPqvNK1bXBxI0,fbPkOYLVPtPgIt0MxizjfFJov3JbHyAi,5,3,2,0,2,5,0,0,12,1.7142857142857142,1,0.0,0,2,0,2,3,5,0,0,0,4,8,1
13769,126676,wmND65rZOV8Cdq3Mq9MmFLy7XUHHSgIW,fbPkOYLVPtPgIt0MxizjfFJov3JbHyAi,1,0,0,0,0,0,1,0,1,0.14285714285714285,1,0.0,0,0,0,0,0,0,0,1,0,0,1,1
13770,126682,gCWKTntdRCeMdOtUiFg2mfCjgrvO2vpV,fbPkOYLVPtPgIt0MxizjfFJov3JbHyAi,10,7,5,0,3,0,2,0,17,2.4285714285714284,1,0.0,0,5,0,3,7,0,0,2,0,8,9,1
13771,126684,4nv50J1wZS6kPdidLB1Y9lmEShhD8gDr,fbPkOYLVPtPgIt0MxizjfFJov3JbHyAi,4,2,1,0,1,0,1,0,5,0.7142857142857143,1,0.0,0,1,0,1,2,0,0,1,0,2,3,1
13772,126686,twUid3xG1muFotfbhs814Ag7sscFy0p2,fbPkOYLVPtPgIt0MxizjfFJov3JbHyAi,8,7,3,0,3,0,2,0,15,2.142857142857143,1,0.0,2,3,0,3,5,0,0,2,0,8,7,1
13773,126687,h5bSBTzGWadYMvrkMiapQR2U8CQzOFmW,fbPkOYLVPtPgIt0MxizjfFJov3JbHyAi,6,3,1,0,1,0,2,0,7,1.0,1,0.0,0,1,0,1,3,0,0,2,0,2,5,1
13774,126690,RhUtXI34T3ZAxfPNMapta5ryhpUSWnVk,fbPkOYLVPtPgIt0MxizjfFJov3JbHyAi,4,2,0,0,0,0,3,0,5,0.7142857142857143,2,0.0,0,0,0,0,2,0,0,3,0,0,5,1
13775,126693,v6oH0XZ7BYoM6ZOy0T23nm7pBiES9NPB,fbPkOYLVPtPgIt0MxizjfFJov3JbHyAi,8,10,4,0,4,8,9,0,35,5.0,2,0.0,2,4,0,4,8,8,0,9,0,10,25,1
13776,126694,zn2X74vvqUQRINz90WjZLsSsFglpYr7o,fbPkOYLVPtPgIt0MxizjfFJov3JbHyAi,10,9,6,0,3,6,8,1,33,4.714285714285714,3,0.0,0,6,0,3,9,6,0,8,1,9,24,1
13777,126695,HSi3yW2yFW0jz9rvJLhKsLbntRdoY32a,fbPkOYLVPtPgIt0MxizjfFJov3JbHyAi,8,4,3,0,3,0,1,0,11,1.5714285714285714,1,0.0,0,3,0,3,4,0,0,1,0,6,5,1
13778,126696,XMNENeqGvf1rZdMY0iLZGJZMfiQXuZuC,fbPkOYLVPtPgIt0MxizjfFJov3JbHyAi,9,12,5,0,4,0,3,0,24,3.4285714285714284,2,0.0,2,5,0,4,10,0,0,3,0,11,13,1
13779,126698,9LD2dY2JJUiq4N2gerCXLTVCO162xgQP,fbPkOYLVPtPgIt0MxizjfFJov3JbHyAi,11,14,7,0,0,21,18,2,62,8.857142857142858,2,0.0,0,7,0,0,14,21,0,18,2,7,55,1
13780,126700,ltYfR4c85t4WE2sNzApQ2jUPBpU7b957,fbPkOYLVPtPgIt0MxizjfFJov3JbHyAi,7,6,3,0,2,0,8,0,19,2.7142857142857144,2,0.0,0,3,0,2,6,0,0,8,0,5,14,1
13781,126702,dUZiaQQxyKZymoXkd4PU7n1DsSWSaoIy,fbPkOYLVPtPgIt0MxizjfFJov3JbHyAi,8,4,1,0,1,3,15,0,24,3.4285714285714284,2,0.0,0,1,0,1,4,3,0,15,0,2,22,1
13782,126704,T8cbb1vJp70svkAiDdRu3fMjKB52qGra,fbPkOYLVPtPgIt0MxizjfFJov3JbHyAi,18,20,14,0,11,2,4,0,51,7.285714285714286,2,0.0,0,14,0,11,20,2,0,4,0,25,26,1
13783,126706,wRfmNw7A5BDFV6ZZ1hHimgxOa1BKzUIG,fbPkOYLVPtPgIt0MxizjfFJov3JbHyAi,5,2,1,0,1,0,4,0,8,1.1428571428571428,1,0.0,0,1,0,1,2,0,0,4,0,2,6,1
13784,126707,J1iCM60eAwVKTPRoP9hdyFlEQf6db3YF,fbPkOYLVPtPgIt0MxizjfFJov3JbHyAi,10,18,11,0,4,3,7,0,43,6.142857142857143,2,0.0,2,11,0,4,16,3,0,7,0,17,26,1
13785,126709,xJHRW2pP02hpKUueg876ng5RKQuuRj6e,fbPkOYLVPtPgIt0MxizjfFJov3JbHyAi,7,2,1,0,1,5,5,2,16,2.2857142857142856,1,0.0,0,1,0,1,2,5,0,5,2,2,14,1
13786,126710,74SN75RPs9smmLOI0EXp2s3BwIneUL6f,fbPkOYLVPtPgIt0MxizjfFJov3JbHyAi,7,5,3,0,2,0,2,0,12,1.7142857142857142,2,0.0,0,3,0,2,5,0,0,2,0,5,7,1
13787,126716,nKDNYUTGPAPqMmlfE7Ub4Qe4fIY0CgoN,fbPkOYLVPtPgIt0MxizjfFJov3JbHyAi,7,3,2,0,2,0,2,0,9,1.2857142857142858,1,0.0,0,2,0,2,3,0,0,2,0,4,5,1
13788,126719,ubotMSWIUOxiTHzx65PiC1ieC4BwcBY3,fbPkOYLVPtPgIt0MxizjfFJov3JbHyAi,7,6,4,0,3,0,8,0,21,3.0,1,0.0,0,4,0,3,6,0,0,8,0,7,14,1
13789,126720,ILgj2bRC3L9liHZTpRi1J62GsWMdjm7i,fbPkOYLVPtPgIt0MxizjfFJov3JbHyAi,46,63,42,27,28,40,12,0,212,30.285714285714285,4,0.0,11,42,23,28,52,40,4,12,0,104,108,0
13790,126721,svRBzwXocvDcjjQhiBGtiJ9xaG6TSovy,fbPkOYLVPtPgIt0MxizjfFJov3JbHyAi,7,13,3,0,3,0,2,0,21,3.0,1,0.0,6,3,0,3,7,0,0,2,0,12,9,1
13791,126723,CEB1n53vwmUc8FHZoBrt4V9IQdrhTfqS,fbPkOYLVPtPgIt0MxizjfFJov3JbHyAi,1,0,0,0,0,0,1,0,1,0.14285714285714285,1,0.0,0,0,0,0,0,0,0,1,0,0,1,1
13792,126725,qad1013ZPW8FX2puHq0BQB5FRF6ADJuZ,fbPkOYLVPtPgIt0MxizjfFJov3JbHyAi,1,0,0,0,0,0,1,0,1,0.14285714285714285,1,0.0,0,0,0,0,0,0,0,1,0,0,1,1
13793,126726,jwPZuNOmAMKPf75y5B5RjmpRb6aVkyKO,fbPkOYLVPtPgIt0MxizjfFJov3JbHyAi,8,5,2,0,2,0,4,0,13,1.8571428571428572,1,0.0,0,2,0,2,5,0,0,4,0,4,9,1
13794,126727,okqN4nBVKRYYrkYonKicKGOmPqVGYjZh,fbPkOYLVPtPgIt0MxizjfFJov3JbHyAi,31,65,32,0,30,0,35,0,162,23.142857142857142,8,0.0,0,32,0,30,65,0,0,35,0,62,100,0
13795,126732,c3bBGCRAwL0HZQ0vFzkQ6CAecfLWPbLO,fbPkOYLVPtPgIt0MxizjfFJov3JbHyAi,7,3,2,0,2,0,6,0,13,1.8571428571428572,1,0.0,0,2,0,2,3,0,0,6,0,4,9,1
13796,126733,eGYk5KFWT4Pvjbd5cX2RH5CTBhiHI9SQ,fbPkOYLVPtPgIt0MxizjfFJov3JbHyAi,17,32,6,25,15,0,6,0,84,12.0,1,0.0,25,6,21,15,7,0,4,6,0,67,17,1
13797,126734,AbrmwZ5WdO7ReOka4PEAhehW5B0axP5g,fbPkOYLVPtPgIt0MxizjfFJov3JbHyAi,10,4,2,0,2,4,10,1,23,3.2857142857142856,1,0.0,1,2,0,2,3,4,0,10,1,5,18,1
13798,126735,FXETNH4OzV3fwI4YkwpBpnk1E19ob1X2,fbPkOYLVPtPgIt0MxizjfFJov3JbHyAi,2,0,0,0,0,0,3,0,3,0.42857142857142855,2,0.0,0,0,0,0,0,0,0,3,0,0,3,1
13799,126736,rrBwc9DqMP8jnv9AB7ljubWYdmiLkI0q,fbPkOYLVPtPgIt0MxizjfFJov3JbHyAi,1,0,0,0,0,0,1,0,1,0.14285714285714285,1,0.0,0,0,0,0,0,0,0,1,0,0,1,1
13800,126738,7M93OdpUvlNXQzkFgbb1jjdCwfDx9GtM,fbPkOYLVPtPgIt0MxizjfFJov3JbHyAi,13,7,5,0,5,0,7,0,24,3.4285714285714284,1,0.0,0,5,0,5,7,0,0,7,0,10,14,1
13801,126740,5lk9vcvlk4ZCLjblktkMYKVUtSVMBE5E,fbPkOYLVPtPgIt0MxizjfFJov3JbHyAi,6,8,1,0,2,3,6,0,20,2.857142857142857,1,0.0,2,1,0,2,6,3,0,6,0,5,15,1
13802,126741,lkSkVgerjbY9elu2HritmYHEIObp7PjN,fbPkOYLVPtPgIt0MxizjfFJov3JbHyAi,20,30,13,12,12,0,12,0,79,11.285714285714286,5,0.0,14,13,10,12,16,0,2,12,0,49,30,1
13803,126743,lkPumIFIPcAu2WGl2L8VJbRmISnkyI8O,fbPkOYLVPtPgIt0MxizjfFJov3JbHyAi,1,0,0,0,0,0,1,0,1,0.14285714285714285,1,0.0,0,0,0,0,0,0,0,1,0,0,1,1
13804,126744,oGufUk3TlimKTfZlaD6U33grjPc0CIXa,fbPkOYLVPtPgIt0MxizjfFJov3JbHyAi,1,0,0,0,0,0,1,0,1,0.14285714285714285,1,0.0,0,0,0,0,0,0,0,1,0,0,1,1
13805,126745,LNdimqsJkOxQDP9dT4IGwewg9YvH7zfV,fbPkOYLVPtPgIt0MxizjfFJov3JbHyAi,1,0,0,0,0,0,1,0,1,0.14285714285714285,1,0.0,0,0,0,0,0,0,0,1,0,0,1,1
13806,126747,N8IThlIYSn8Fy4uyyTQSpl5K0TGz5NzT,fbPkOYLVPtPgIt0MxizjfFJov3JbHyAi,1,0,0,0,0,0,1,0,1,0.14285714285714285,1,0.0,0,0,0,0,0,0,0,1,0,0,1,1
13807,126749,dhYRwzeTF8ZdKZPmARZOAee0piLEqFbu,fbPkOYLVPtPgIt0MxizjfFJov3JbHyAi,10,12,5,0,3,3,11,0,34,4.857142857142857,1,0.0,1,5,0,3,11,3,0,11,0,9,25,1
13808,126752,WIgM6nvV9YFBo82xFhtQp6923xmcbs69,fbPkOYLVPtPgIt0MxizjfFJov3JbHyAi,1,0,0,0,0,0,1,0,1,0.14285714285714285,1,0.0,0,0,0,0,0,0,0,1,0,0,1,1
13809,126754,xGbsJo4oJvVhF60tIqZnizNX71bTSMlF,fbPkOYLVPtPgIt0MxizjfFJov3JbHyAi,5,3,1,0,1,0,2,0,7,1.0,1,0.0,0,1,0,1,3,0,0,2,0,2,5,1
13810,126755,sfmDw8Mu24TwJAISRGKb3tkGixPCex4a,fbPkOYLVPtPgIt0MxizjfFJov3JbHyAi,1,0,0,0,0,0,1,0,1,0.14285714285714285,1,0.0,0,0,0,0,0,0,0,1,0,0,1,1
13811,126757,6Rep3wtvxTeRNedCLfqY7iMeUZ3V82V5,fbPkOYLVPtPgIt0MxizjfFJov3JbHyAi,1,0,0,0,0,0,1,0,1,0.14285714285714285,1,0.0,0,0,0,0,0,0,0,1,0,0,1,1
13812,126758,bATDoM6JXGnyb4V3IABuJhs4a0vjJZc3,fbPkOYLVPtPgIt0MxizjfFJov3JbHyAi,7,3,2,0,2,0,2,0,9,1.2857142857142858,1,0.0,0,2,0,2,3,0,0,2,0,4,5,1
13813,126760,VAqYNROCUp4auixkrMgowB877fUTXjiq,fbPkOYLVPtPgIt0MxizjfFJov3JbHyAi,9,4,2,0,1,0,5,1,13,1.8571428571428572,1,0.0,0,2,0,1,4,0,0,5,1,3,10,1
13814,126762,tedGThhHMqVARfBh6zyzyocTKbTJYJpB,fbPkOYLVPtPgIt0MxizjfFJov3JbHyAi,10,13,9,0,5,11,9,0,47,6.714285714285714,4,0.0,0,9,0,5,13,11,0,9,0,14,33,0
13815,126763,paw4uFNhxlmHKr4qI1FVQJCklV7n0vFs,fbPkOYLVPtPgIt0MxizjfFJov3JbHyAi,2,0,0,0,0,0,3,0,3,0.42857142857142855,1,0.0,0,0,0,0,0,0,0,3,0,0,3,1
13816,126764,dzZvmhMBCZUS7A4bdHQZaWrZNWx9wlnR,fbPkOYLVPtPgIt0MxizjfFJov3JbHyAi,5,2,1,0,1,0,2,0,6,0.8571428571428571,1,0.0,0,1,0,1,2,0,0,2,0,2,4,0
13817,126766,YDTJdQorIvDsVBFXmCLdVqB4blieQHew,fbPkOYLVPtPgIt0MxizjfFJov3JbHyAi,8,3,1,0,1,0,6,0,11,1.5714285714285714,1,0.0,0,1,0,1,3,0,0,6,0,2,9,1
13818,126767,xPpQ4dt3yAtdD8kr7bwSICTMyO3G9j2v,fbPkOYLVPtPgIt0MxizjfFJov3JbHyAi,2,0,0,0,0,0,2,0,2,0.2857142857142857,1,0.0,0,0,0,0,0,0,0,2,0,0,2,1
13819,126768,0WQD9JgXnh1Oc60hHZOmb4uDwk3oDBzG,fbPkOYLVPtPgIt0MxizjfFJov3JbHyAi,1,0,0,0,0,0,1,0,1,0.14285714285714285,1,0.0,0,0,0,0,0,0,0,1,0,0,1,1
13820,126771,xMKGcYeHMuhMu436Dx8qNr2iLxqOhlEy,fbPkOYLVPtPgIt0MxizjfFJov3JbHyAi,6,6,3,0,1,0,4,0,14,2.0,1,0.0,0,3,0,1,6,0,0,4,0,4,10,1
13821,126773,BD211S7WnIRsylhDTuEdNrGmy3W7uQ04,fbPkOYLVPtPgIt0MxizjfFJov3JbHyAi,4,2,1,0,0,0,2,0,5,0.7142857142857143,1,0.0,0,1,0,0,2,0,0,2,0,1,4,1
13822,126774,4FlFuHK6TBPGfbsvWig6oHoWLKBiaFvx,fbPkOYLVPtPgIt0MxizjfFJov3JbHyAi,29,42,17,20,20,5,10,1,115,16.428571428571427,4,0.0,20,17,17,20,22,5,3,10,1,74,41,1
13823,126778,ukV83h2gop6RgQ4r0p0CZA73Nn6q15H2,fbPkOYLVPtPgIt0MxizjfFJov3JbHyAi,9,5,4,0,3,0,5,0,17,2.4285714285714284,1,0.0,0,4,0,3,5,0,0,5,0,7,10,1
13824,126780,k0j1JTbNvF4wEJZ0EFYHSB55VWnrDKJ0,fbPkOYLVPtPgIt0MxizjfFJov3JbHyAi,7,3,2,0,2,0,3,0,10,1.4285714285714286,2,0.0,0,2,0,2,3,0,0,3,0,4,6,1
13825,126783,fZTrS29Fp3monLBfDxON161JJDMC3kWz,fbPkOYLVPtPgIt0MxizjfFJov3JbHyAi,8,7,0,0,0,2,5,0,14,2.0,2,0.0,0,0,0,0,7,2,0,5,0,0,14,1
13826,126786,2urzmdkueRAEgx9jksBRYegBWc6qjd5N,fbPkOYLVPtPgIt0MxizjfFJov3JbHyAi,7,3,2,0,2,0,2,0,9,1.2857142857142858,1,0.0,0,2,0,2,3,0,0,2,0,4,5,1
13827,126787,SudTrjctDId1aP2BFyvfpzdEUNt4tVpn,fbPkOYLVPtPgIt0MxizjfFJov3JbHyAi,1,0,0,0,0,0,1,0,1,0.14285714285714285,1,0.0,0,0,0,0,0,0,0,1,0,0,1,1
13828,126788,oAeA1FcKJgCgppNdDO8cyAq9ijjrn0WR,fbPkOYLVPtPgIt0MxizjfFJov3JbHyAi,7,2,1,0,1,0,5,0,9,1.2857142857142858,1,0.0,0,1,0,1,2,0,0,5,0,2,7,1
13829,126789,9TAoWA17iJi4aGxReuxcPCWmtwK9xK5D,fbPkOYLVPtPgIt0MxizjfFJov3JbHyAi,4,2,1,0,0,0,2,0,5,0.7142857142857143,1,0.0,0,1,0,0,2,0,0,2,0,1,4,1
13830,126790,bXfZmQuCdk4kcCEmwkhxKTGNfBpAQ8z2,fbPkOYLVPtPgIt0MxizjfFJov3JbHyAi,6,3,2,0,2,0,1,0,8,1.1428571428571428,1,0.0,0,2,0,2,3,0,0,1,0,4,4,1
13831,126791,fx2VHlFzMiSpt4HdfnAJod2kZRWQGzoD,fbPkOYLVPtPgIt0MxizjfFJov3JbHyAi,8,5,3,0,2,1,9,0,20,2.857142857142857,2,0.0,0,3,0,2,5,1,0,9,0,5,15,0
13832,126792,i2PPXz5Z5PB2ZfiVAI64TcWxYgJR1QQ1,fbPkOYLVPtPgIt0MxizjfFJov3JbHyAi,10,7,5,0,4,0,4,0,20,2.857142857142857,2,0.0,0,5,0,4,7,0,0,4,0,9,11,1
13833,126793,w81M8LsxqroaoVvhuOiOu12ogu2TTrVp,fbPkOYLVPtPgIt0MxizjfFJov3JbHyAi,10,5,3,0,2,0,6,0,16,2.2857142857142856,1,0.0,0,3,0,2,5,0,0,6,0,5,11,1
13834,126794,9og5l3kBrvNmeUS7WEJnLIW5U5JOFnlr,fbPkOYLVPtPgIt0MxizjfFJov3JbHyAi,1,0,0,0,0,0,1,0,1,0.14285714285714285,1,0.0,0,0,0,0,0,0,0,1,0,0,1,1
13835,126795,dlcs3mIk1dQaLsNVv2V1gEVdgllvLwJb,fbPkOYLVPtPgIt0MxizjfFJov3JbHyAi,1,0,0,0,0,0,1,0,1,0.14285714285714285,1,0.0,0,0,0,0,0,0,0,1,0,0,1,1
13836,126796,nRLTavEl1bXxEwhFINnyKEh9SYy7D5ak,fbPkOYLVPtPgIt0MxizjfFJov3JbHyAi,5,3,1,0,1,0,1,0,6,0.8571428571428571,1,0.0,0,1,0,1,3,0,0,1,0,2,4,1
13837,126799,GZEmn2jDYiPNelTXdP84Wl4gxgVXz7UQ,fbPkOYLVPtPgIt0MxizjfFJov3JbHyAi,7,7,4,0,2,0,3,0,16,2.2857142857142856,1,0.0,1,4,0,2,6,0,0,3,0,7,9,1
13838,126800,03LSJMJGCEPYScMXgYv3wZ9A4zZCWROs,fbPkOYLVPtPgIt0MxizjfFJov3JbHyAi,5,2,1,0,1,0,3,0,7,1.0,2,0.0,0,1,0,1,2,0,0,3,0,2,5,1
13839,126802,Ae7TpzHEpVWIeUEcofOMHxfQYB9IZpIZ,fbPkOYLVPtPgIt0MxizjfFJov3JbHyAi,4,3,0,0,0,0,2,0,5,0.7142857142857143,1,0.0,1,0,0,0,2,0,0,2,0,1,4,1
13840,126803,baVXGFYC1QSmRnztVLPGhtEiVUNUt9jm,fbPkOYLVPtPgIt0MxizjfFJov3JbHyAi,9,13,8,0,4,7,5,0,37,5.285714285714286,2,0.0,0,8,0,4,13,7,0,5,0,12,25,1
13841,126804,udjvqTKwWnl3kdnagqtGxHOib49LhYFP,fbPkOYLVPtPgIt0MxizjfFJov3JbHyAi,1,0,0,0,0,0,1,0,1,0.14285714285714285,1,0.0,0,0,0,0,0,0,0,1,0,0,1,1
13842,126805,tb2OgRXfqTZBzkHrdlQDSZ9zV3ijuuxF,fbPkOYLVPtPgIt0MxizjfFJov3JbHyAi,9,3,2,0,2,2,18,5,32,4.571428571428571,3,0.0,0,2,0,2,3,2,0,18,5,4,28,1
13843,126807,9a82SEYCdqbKx1WLnzqNRiSe6ROiwLtA,fbPkOYLVPtPgIt0MxizjfFJov3JbHyAi,8,2,1,0,1,1,6,1,12,1.7142857142857142,1,0.0,0,1,0,1,2,1,0,6,1,2,10,1
13844,126808,fwOw0LJBQGN43wSD5bc3nLA7e72R3dmo,fbPkOYLVPtPgIt0MxizjfFJov3JbHyAi,1,0,0,0,0,0,1,0,1,0.14285714285714285,1,0.0,0,0,0,0,0,0,0,1,0,0,1,1
13845,126809,hcIMsJjzliCUSfKNV7VjadwRGqNrlbcK,fbPkOYLVPtPgIt0MxizjfFJov3JbHyAi,5,7,6,0,0,0,2,0,15,2.142857142857143,1,0.0,0,6,0,0,7,0,0,2,0,6,9,0
13846,126812,HO2p5gxVWMQedHP7d588CVyHIhMACwbO,fbPkOYLVPtPgIt0MxizjfFJov3JbHyAi,7,4,2,0,2,0,7,0,15,2.142857142857143,1,0.0,0,2,0,2,4,0,0,7,0,4,11,1
13847,126818,UKVpy6yMY2LOCbd33JRDxwPZtMJSUcsq,fbPkOYLVPtPgIt0MxizjfFJov3JbHyAi,1,0,0,0,0,0,1,0,1,0.14285714285714285,1,0.0,0,0,0,0,0,0,0,1,0,0,1,1
13848,126819,bmUODmp9W7t1pFfRc25oTW8BqLenSXaz,fbPkOYLVPtPgIt0MxizjfFJov3JbHyAi,4,2,0,0,0,0,2,0,4,0.5714285714285714,1,0.0,0,0,0,0,2,0,0,2,0,0,4,1
13849,126820,qDTU2XGTiB220mLDzlsck7xSj3wUhIhe,fbPkOYLVPtPgIt0MxizjfFJov3JbHyAi,8,3,1,0,1,3,7,1,16,2.2857142857142856,2,0.0,0,1,0,1,3,3,0,7,1,2,14,1
13850,128989,wGXRcY0FS7DP9yn6e6xwYPxjUYuVv96W,3VkHkmOtom3jM2wCu94xgzzu1d6Dn7or,1,0,0,0,0,0,1,0,1,0.14285714285714285,1,0.0,0,0,0,0,0,0,0,1,0,0,1,1
13851,129026,QHo6eCbZPurDQOD6Hj3LGJQeeCrdfONe,3VkHkmOtom3jM2wCu94xgzzu1d6Dn7or,1,0,0,0,0,0,1,0,1,0.14285714285714285,1,0.0,0,0,0,0,0,0,0,1,0,0,1,1
13852,129028,vqyUfMHVjh3PMmyCVP9rZQOWb16mVmq4,3VkHkmOtom3jM2wCu94xgzzu1d6Dn7or,16,13,7,0,7,0,6,0,33,4.714285714285714,3,0.0,2,7,0,7,11,0,0,6,0,16,17,1
13853,129031,bK5dB6XLLefth27wEbBznMtGWWZKosCZ,3VkHkmOtom3jM2wCu94xgzzu1d6Dn7or,1,0,0,0,0,0,1,0,1,0.14285714285714285,1,0.0,0,0,0,0,0,0,0,1,0,0,1,1
13854,129042,kPX9M8mB8UxEeE9jcVhOS9PqeLggeK4l,3VkHkmOtom3jM2wCu94xgzzu1d6Dn7or,72,158,40,61,60,2,24,1,346,49.42857142857143,4,0.0,102,40,51,60,56,2,10,24,1,253,93,1
13855,129080,O7rTwuedLzkXiP070SRIZMN4LVu1Y5BM,3VkHkmOtom3jM2wCu94xgzzu1d6Dn7or,1,0,0,0,0,0,1,0,1,0.14285714285714285,1,0.0,0,0,0,0,0,0,0,1,0,0,1,1
13856,129081,xrjsm6YfbyxY5UUbMLVIqx1kBBCjFHQg,3VkHkmOtom3jM2wCu94xgzzu1d6Dn7or,4,2,1,0,1,0,2,0,6,0.8571428571428571,1,0.0,0,1,0,1,2,0,0,2,0,2,4,1
13857,129117,viyNPajhAF8K8n3Et7FkffYemVMNr8ED,3VkHkmOtom3jM2wCu94xgzzu1d6Dn7or,1,0,0,0,0,0,1,0,1,0.14285714285714285,1,0.0,0,0,0,0,0,0,0,1,0,0,1,1
13858,129160,yq5rHqpCTagxs6XCaAXxmCSySzn2U3u8,3VkHkmOtom3jM2wCu94xgzzu1d6Dn7or,1,0,0,0,0,0,1,0,1,0.14285714285714285,1,0.0,0,0,0,0,0,0,0,1,0,0,1,1
13859,129197,gQsmNIeCaoVH51itICApF5D0SGicGYzJ,3VkHkmOtom3jM2wCu94xgzzu1d6Dn7or,53,54,35,25,26,3,3,0,146,20.857142857142858,1,0.0,18,35,24,26,36,3,1,3,0,103,43,0
13860,129206,rVj6vxysUjIV1kazIkMsUDn3ShTXOA8U,3VkHkmOtom3jM2wCu94xgzzu1d6Dn7or,3,0,0,0,0,6,4,0,10,1.4285714285714286,1,0.0,0,0,0,0,0,6,0,4,0,0,10,1
13861,129239,3geK90SxF3Ka4Yp1gHRsHpT2bX3beLG8,3VkHkmOtom3jM2wCu94xgzzu1d6Dn7or,1,0,0,0,0,0,1,0,1,0.14285714285714285,1,0.0,0,0,0,0,0,0,0,1,0,0,1,1
13862,129243,BoMrnaRzWiLLbhZUihKQP6MURkcvYuJ9,3VkHkmOtom3jM2wCu94xgzzu1d6Dn7or,6,19,4,0,2,2,12,0,39,5.571428571428571,5,0.0,2,4,0,2,17,2,0,12,0,8,31,1
13863,129266,FxeUJuPs6ysWciAwjmUQ9QK1bVjyL5zJ,3VkHkmOtom3jM2wCu94xgzzu1d6Dn7or,6,1,1,0,1,2,5,1,11,1.5714285714285714,1,0.0,0,1,0,1,1,2,0,5,1,2,9,1
13864,129300,naBWlAaVhKzaB4UxMnusqlKuJq8E34Em,3VkHkmOtom3jM2wCu94xgzzu1d6Dn7or,95,226,54,107,75,3,32,5,502,71.71428571428571,7,0.0,152,54,96,75,74,3,11,32,5,377,125,0
13865,129309,D6kPXsYNeloFJlizvuS8VgDOBs1ZiXV0,3VkHkmOtom3jM2wCu94xgzzu1d6Dn7or,18,40,11,11,14,6,6,0,88,12.571428571428571,1,0.0,24,11,9,14,16,6,2,6,0,58,30,0
13866,129311,M5ernKy5CAGuMQO0T1yqEDMDeBZk6gT2,3VkHkmOtom3jM2wCu94xgzzu1d6Dn7or,1,0,0,0,0,0,2,0,2,0.2857142857142857,1,0.0,0,0,0,0,0,0,0,2,0,0,2,1
13867,129320,5teoqA7yYDJ6iOdf13CnCMC31MsySOLX,3VkHkmOtom3jM2wCu94xgzzu1d6Dn7or,8,5,4,0,4,0,1,0,14,2.0,1,0.0,0,4,0,4,5,0,0,1,0,8,6,1
13868,129321,9QiT7u9riee5JBZugpfAEC3uXfHPsvNT,3VkHkmOtom3jM2wCu94xgzzu1d6Dn7or,1,0,0,0,0,0,1,0,1,0.14285714285714285,1,0.0,0,0,0,0,0,0,0,1,0,0,1,1
13869,129345,vIx47VWIzorbn5U0gEWpmVpzO0I3garP,3VkHkmOtom3jM2wCu94xgzzu1d6Dn7or,6,6,2,0,1,0,3,0,12,1.7142857142857142,2,0.0,1,2,0,1,5,0,0,3,0,4,8,1
13870,129379,N8e8TX5f8OfPjOu3ngCuXkApyUMeZAHw,3VkHkmOtom3jM2wCu94xgzzu1d6Dn7or,7,1,0,0,0,0,7,5,13,1.8571428571428572,1,0.0,0,0,0,0,1,0,0,7,5,0,13,0
13871,129381,Ce9Cu1nB2NnV2nsci12KY71J1CUXvQNG,3VkHkmOtom3jM2wCu94xgzzu1d6Dn7or,1,0,0,0,0,0,4,0,4,0.5714285714285714,1,0.0,0,0,0,0,0,0,0,4,0,0,4,1
13872,129405,pR0rEzd43YPn1ujQN1oHxqL0z3U4G8ju,3VkHkmOtom3jM2wCu94xgzzu1d6Dn7or,1,0,0,0,0,0,1,0,1,0.14285714285714285,1,0.0,0,0,0,0,0,0,0,1,0,0,1,1
13873,129413,1wWTB4HU3MzRinvCDTb5dH3lsMHzazH1,3VkHkmOtom3jM2wCu94xgzzu1d6Dn7or,1,0,0,0,0,0,1,0,1,0.14285714285714285,1,0.0,0,0,0,0,0,0,0,1,0,0,1,1
13874,129414,embL8Tbq5qf21DkWYUrPYi30NHnJIy30,3VkHkmOtom3jM2wCu94xgzzu1d6Dn7or,6,1,1,0,1,0,3,0,6,0.8571428571428571,1,0.0,0,1,0,1,1,0,0,3,0,2,4,1
13875,129425,MG4jUeuE0KPWDpaZzVJcrXNbJRZNdqB2,3VkHkmOtom3jM2wCu94xgzzu1d6Dn7or,6,2,1,0,1,1,4,0,9,1.2857142857142858,2,0.0,0,1,0,1,2,1,0,4,0,2,7,1
13876,129434,vPf12Tl1uQJmLqMumaDi4EdOZY1gQoDQ,3VkHkmOtom3jM2wCu94xgzzu1d6Dn7or,6,3,2,0,2,0,1,0,8,1.1428571428571428,1,0.0,0,2,0,2,3,0,0,1,0,4,4,0
13877,129461,9fKCM48WCwLwvCl1vZ5Sx66ep0GEs87k,3VkHkmOtom3jM2wCu94xgzzu1d6Dn7or,48,99,26,50,17,12,14,1,219,31.285714285714285,4,0.0,29,26,50,17,70,12,0,14,1,122,97,0
13878,129520,cpI0ujfE9qc2VegGvSTGkQAzKjVboyfv,3VkHkmOtom3jM2wCu94xgzzu1d6Dn7or,4,2,1,0,1,0,1,0,5,0.7142857142857143,1,0.0,0,1,0,1,2,0,0,1,0,2,3,1
13879,129536,yXJKQRpuSTzVLxTIIubiutcR6kaMuN28,3VkHkmOtom3jM2wCu94xgzzu1d6Dn7or,1,0,0,0,0,0,1,0,1,0.14285714285714285,1,0.0,0,0,0,0,0,0,0,1,0,0,1,1
13880,129579,rvDRu9XJN8FG6L4Tz1QJEpneNN9bSp3T,5Gyp41oLVo7Gg7vF4vpmggWP5MU70QO6,5,3,1,0,1,0,1,0,6,0.8571428571428571,1,0.0,0,1,0,1,3,0,0,1,0,2,4,1
13881,129580,e69OiaWe3NlAbjDSu6TxenqA8FkyC0Xp,5Gyp41oLVo7Gg7vF4vpmggWP5MU70QO6,1,0,0,0,0,0,1,0,1,0.14285714285714285,1,0.0,0,0,0,0,0,0,0,1,0,0,1,1
13882,129601,CUEyHbsjLlbX6I7tsbnNjxFI1v5Lj4iD,5Gyp41oLVo7Gg7vF4vpmggWP5MU70QO6,12,18,7,6,2,0,6,0,39,5.571428571428571,4,0.0,3,7,3,2,15,0,3,6,0,15,24,1
13883,129640,sgp3n5bawfHVtq2l28nBhsWFsV7axBcX,5Gyp41oLVo7Gg7vF4vpmggWP5MU70QO6,12,8,5,0,2,1,8,2,26,3.7142857142857144,1,0.0,0,5,0,2,8,1,0,8,2,7,19,1
13884,129646,nxYspCMKoh1EgeU8TSzckR1n89C3pksS,5Gyp41oLVo7Gg7vF4vpmggWP5MU70QO6,8,4,1,0,1,0,6,0,12,1.7142857142857142,1,0.0,0,1,0,1,4,0,0,6,0,2,10,1
13885,129650,keJ8U0gke02i1Nqlu5m5DMRYUhjtcs9p,5Gyp41oLVo7Gg7vF4vpmggWP5MU70QO6,1,0,0,0,0,0,2,0,2,0.2857142857142857,1,0.0,0,0,0,0,0,0,0,2,0,0,2,1
13886,129659,VCcF1BG0pb9rDAtZE9QDlEi07JsyAvv0,5Gyp41oLVo7Gg7vF4vpmggWP5MU70QO6,38,85,37,0,39,88,26,11,286,40.857142857142854,2,0.0,41,37,0,39,44,88,0,26,11,117,169,0
13887,129672,5lcsln2CQflX1rHNpVSI4TBAnz24ClGg,5Gyp41oLVo7Gg7vF4vpmggWP5MU70QO6,3,0,0,0,0,0,5,0,5,0.7142857142857143,1,0.0,0,0,0,0,0,0,0,5,0,0,5,1
13888,129683,bzGwSI71FKavx1KKfw4gtgfIAR7xeSGd,5Gyp41oLVo7Gg7vF4vpmggWP5MU70QO6,21,28,14,0,8,0,6,0,56,8.0,2,0.0,0,14,0,8,28,0,0,6,0,22,34,0
13889,129685,OwHNM1X6FZRH3dfyuEBaD26lm0C9uvFE,5Gyp41oLVo7Gg7vF4vpmggWP5MU70QO6,1,0,0,0,0,0,1,0,1,0.14285714285714285,1,0.0,0,0,0,0,0,0,0,1,0,0,1,1
13890,129686,Y6pknKHCVZ8CEuDItfa44feZRRcUGvo5,5Gyp41oLVo7Gg7vF4vpmggWP5MU70QO6,6,5,1,0,1,0,2,0,9,1.2857142857142858,1,0.0,1,1,0,1,4,0,0,2,0,3,6,1
13891,129701,upQj9khHopjCTpqEAvv7wn2wHHft2R6S,5Gyp41oLVo7Gg7vF4vpmggWP5MU70QO6,7,3,2,0,2,0,2,0,9,1.2857142857142858,1,0.0,0,2,0,2,3,0,0,2,0,4,5,1
13892,129702,tLtVcoK2CUjzuLyqPUDfH9vifV5fLtIY,5Gyp41oLVo7Gg7vF4vpmggWP5MU70QO6,1,0,0,0,0,0,1,0,1,0.14285714285714285,1,0.0,0,0,0,0,0,0,0,1,0,0,1,1
13893,129718,c8utHKDVx91Sqo9Xx9dO8KITIcLfHIOU,5Gyp41oLVo7Gg7vF4vpmggWP5MU70QO6,5,3,1,0,1,0,1,0,6,0.8571428571428571,1,0.0,0,1,0,1,3,0,0,1,0,2,4,1
13894,129721,s3QR8H3FuFlDzkn72xcJDtmxJmA3dZA9,5Gyp41oLVo7Gg7vF4vpmggWP5MU70QO6,32,74,44,0,25,0,10,0,153,21.857142857142858,4,0.0,14,44,0,25,60,0,0,10,0,83,70,0
13895,129739,whxWCs3PqUO3lpi8j65TapLCue79ZU0A,5Gyp41oLVo7Gg7vF4vpmggWP5MU70QO6,3,0,0,0,0,0,4,0,4,0.5714285714285714,1,0.0,0,0,0,0,0,0,0,4,0,0,4,1
13896,129792,ci5Gz3lr84RC6CNYVu43me8PGcSphSvT,5Gyp41oLVo7Gg7vF4vpmggWP5MU70QO6,5,2,1,0,1,0,2,0,6,0.8571428571428571,1,0.0,0,1,0,1,2,0,0,2,0,2,4,1
13897,129804,yJTitpr4DIL3cTqxIQWNZFbPmpUPB9xt,5Gyp41oLVo7Gg7vF4vpmggWP5MU70QO6,1,0,0,0,0,0,1,0,1,0.14285714285714285,1,0.0,0,0,0,0,0,0,0,1,0,0,1,1
13898,129809,Dha6i4inJ8jK0OySEa9I85ooFkmSQR0f,5Gyp41oLVo7Gg7vF4vpmggWP5MU70QO6,18,25,13,10,3,7,7,0,65,9.285714285714286,7,0.0,6,13,9,3,19,7,1,7,0,31,34,1
13899,129822,C4q4gNQYEpjKh7pq1qjN8i3L7uSpUX9d,5Gyp41oLVo7Gg7vF4vpmggWP5MU70QO6,55,143,60,60,31,33,34,9,370,52.857142857142854,9,0.0,33,60,48,31,110,33,12,34,9,172,198,0
13900,129840,G6ewnesZkCYCx9FmLoCQuLhuGQlAIKz3,5Gyp41oLVo7Gg7vF4vpmggWP5MU70QO6,1,0,0,0,0,0,1,0,1,0.14285714285714285,1,0.0,0,0,0,0,0,0,0,1,0,0,1,1
13901,129841,N6XqEWJ9H7Pd7b9x8011vf67AyRVG2Hy,5Gyp41oLVo7Gg7vF4vpmggWP5MU70QO6,1,0,0,0,0,0,1,0,1,0.14285714285714285,1,0.0,0,0,0,0,0,0,0,1,0,0,1,1
13902,129871,OZaq72DmJH6bReA6lKvO4XbWYjmwsu42,5Gyp41oLVo7Gg7vF4vpmggWP5MU70QO6,11,24,10,0,5,15,13,2,69,9.857142857142858,6,0.0,2,10,0,5,22,15,0,13,2,17,52,1
13903,129872,MDKhyuLDe5vvBGQ0G0k2B0X5FpLVsFhn,5Gyp41oLVo7Gg7vF4vpmggWP5MU70QO6,8,2,2,0,2,0,3,0,9,1.2857142857142858,1,0.0,0,2,0,2,2,0,0,3,0,4,5,1
13904,129878,1ZxIq2EElt84sjQ7d0VZrg3vpxtlpcZe,5Gyp41oLVo7Gg7vF4vpmggWP5MU70QO6,1,0,0,0,0,0,1,0,1,0.14285714285714285,1,0.0,0,0,0,0,0,0,0,1,0,0,1,1
13905,129879,jTHsduF8LgX3LdRMKkbTJ0XspXdH24wv,5Gyp41oLVo7Gg7vF4vpmggWP5MU70QO6,8,5,3,0,2,0,4,0,14,2.0,4,0.0,0,3,0,2,5,0,0,4,0,5,9,1
13906,129920,inWJABZOHdPSTR3u9DIiF4psiCjCH8yf,5Gyp41oLVo7Gg7vF4vpmggWP5MU70QO6,6,5,2,0,1,0,4,0,12,1.7142857142857142,1,0.0,0,2,0,1,5,0,0,4,0,3,9,0
13907,129947,DhVdg9a1fiPo2TZQbUa7Xi0Xt11ecMm7,5Gyp41oLVo7Gg7vF4vpmggWP5MU70QO6,2,0,0,0,0,0,2,0,2,0.2857142857142857,1,0.0,0,0,0,0,0,0,0,2,0,0,2,1
13908,129949,Mkg3edlcIM5Vrzxuk3dtXhytcqCucfXI,5Gyp41oLVo7Gg7vF4vpmggWP5MU70QO6,5,2,1,0,1,0,3,0,7,1.0,1,0.0,0,1,0,1,2,0,0,3,0,2,5,0
13909,129954,hqh6ySViVHtgDq8aiHphVYPr16SuPhaK,5Gyp41oLVo7Gg7vF4vpmggWP5MU70QO6,21,38,17,18,7,1,9,2,92,13.142857142857142,4,0.0,14,17,14,7,24,1,4,9,2,52,40,0
13910,129966,x1RDUiG4hzdFvWaarIV1g7s3ecNKiDPi,5Gyp41oLVo7Gg7vF4vpmggWP5MU70QO6,12,16,6,0,3,0,4,0,29,4.142857142857143,1,0.0,0,6,0,3,16,0,0,4,0,9,20,0
13911,130026,xsgiGrnZhEwy8oG8TA0vaM6DsmjiZPXl,7GRhBDsirIGkRZBtSMEzNTyDr2JQm4xx,5,2,1,0,1,0,2,0,6,0.8571428571428571,1,0.0,0,1,0,1,2,0,0,2,0,2,4,1
13912,130033,XwOO8ac2656vyYzoHSdxVfStEQa3w4iM,7GRhBDsirIGkRZBtSMEzNTyDr2JQm4xx,10,3,2,0,2,0,12,2,21,3.0,3,0.0,0,2,0,2,3,0,0,12,2,4,17,0
13913,130035,GWG8afsUfRei9CIZYg1Y2sBsF64D5J9k,7GRhBDsirIGkRZBtSMEzNTyDr2JQm4xx,6,4,1,0,0,0,6,0,11,1.5714285714285714,4,0.0,0,1,0,0,4,0,0,6,0,1,10,1
13914,130039,Z5sEt151hX78nE6qWmPF09aVI6QGewvL,7GRhBDsirIGkRZBtSMEzNTyDr2JQm4xx,47,113,4,33,12,1,23,1,187,26.714285714285715,11,0.0,45,4,22,12,68,1,11,23,1,83,104,0
13915,130041,tlBnmsKf0J20KHkh9Qq2FoTYGO7e78wj,7GRhBDsirIGkRZBtSMEzNTyDr2JQm4xx,37,33,13,140,5,0,10,0,201,28.714285714285715,3,0.0,20,13,113,5,13,0,27,10,0,151,50,1
13916,130043,XGEZ2G0L3Qev9gwj03jnL3Sj42uCvFKQ,7GRhBDsirIGkRZBtSMEzNTyDr2JQm4xx,1,0,0,0,0,0,1,0,1,0.14285714285714285,1,0.0,0,0,0,0,0,0,0,1,0,0,1,1
13917,130047,jcZzyelmNOUxuY7TWiZZyoS3gSdLYxDW,7GRhBDsirIGkRZBtSMEzNTyDr2JQm4xx,28,30,10,8,14,4,7,0,73,10.428571428571429,2,0.0,20,10,4,14,10,4,4,7,0,48,25,1
13918,130048,YpfDBKk4h7tgq60FuSxK0f3S5bBmXXPo,7GRhBDsirIGkRZBtSMEzNTyDr2JQm4xx,79,210,81,2,103,15,3,0,414,59.142857142857146,5,0.0,122,81,1,103,88,15,1,3,0,307,107,0
13919,130049,OJM4VKDtlO7QCM03o6fe5QYYKek35kXV,7GRhBDsirIGkRZBtSMEzNTyDr2JQm4xx,36,55,22,10,19,2,9,0,117,16.714285714285715,2,0.0,25,22,5,19,30,2,5,9,0,71,46,0
13920,130051,V6I2tWMT4J6OaEfYWYGJXMvy6YbJ0vQk,7GRhBDsirIGkRZBtSMEzNTyDr2JQm4xx,68,82,26,99,0,0,5,0,212,30.285714285714285,6,0.0,35,26,96,0,47,0,3,5,0,157,55,0
13921,130052,zJ1cXp5NsbaO1h7ITMq3mqJ8kisUpMMv,7GRhBDsirIGkRZBtSMEzNTyDr2JQm4xx,87,69,20,188,21,0,3,0,301,43.0,3,0.0,46,20,171,21,23,0,17,3,0,258,43,1
13922,130053,oov2Lz1eyG9bCCe8SK6HQBH98kSF2SNU,7GRhBDsirIGkRZBtSMEzNTyDr2JQm4xx,4,5,1,0,0,0,2,0,8,1.1428571428571428,2,0.0,0,1,0,0,5,0,0,2,0,1,7,1
13923,130059,1xcKG4Eeqo6PRlQtqz4lRNBDzvKhe7qL,7GRhBDsirIGkRZBtSMEzNTyDr2JQm4xx,56,120,14,76,19,31,43,3,306,43.714285714285715,11,0.0,57,14,56,19,63,31,20,43,3,146,160,0
13924,130074,v1AqHfMoNhUox9GyIOrxftKibIp07zrt,7GRhBDsirIGkRZBtSMEzNTyDr2JQm4xx,8,6,4,0,4,0,1,0,15,2.142857142857143,1,0.0,1,4,0,4,5,0,0,1,0,9,6,1
13925,130095,WT9W6GJEVLixXgoI8DFL9RMlg4D9oeTa,7GRhBDsirIGkRZBtSMEzNTyDr2JQm4xx,23,24,10,16,8,1,7,1,67,9.571428571428571,1,0.0,12,10,8,8,12,1,8,7,1,38,29,1
13926,130113,Ohb4i5oHqjZ8IM21D8Irpch9JeRvSvVx,7GRhBDsirIGkRZBtSMEzNTyDr2JQm4xx,4,3,0,0,0,0,2,0,5,0.7142857142857143,1,0.0,0,0,0,0,3,0,0,2,0,0,5,1
13927,130126,Kt9qeiacR1tBDeKKHUR6O60ehH5pm7C9,7GRhBDsirIGkRZBtSMEzNTyDr2JQm4xx,38,60,3,42,6,1,9,0,121,17.285714285714285,5,0.0,23,3,39,6,37,1,3,9,0,71,50,1
13928,130170,bVkBiR8Ol1DpipPI05IgYIPbLOO6oZNi,7GRhBDsirIGkRZBtSMEzNTyDr2JQm4xx,110,223,64,118,51,67,41,5,569,81.28571428571429,5,0.0,84,64,102,51,139,67,16,41,5,301,268,0
13929,130194,d2YnkO2hmo3aVw6HN5hcBIHWHhDiSjB1,7GRhBDsirIGkRZBtSMEzNTyDr2JQm4xx,11,5,2,6,1,0,5,0,19,2.7142857142857144,1,0.0,2,2,3,1,3,0,3,5,0,8,11,1
13930,130205,D5GqwXfacfySSvxPJ9v7ORjiX9Oa23f1,7GRhBDsirIGkRZBtSMEzNTyDr2JQm4xx,113,145,52,191,51,12,44,7,502,71.71428571428571,9,0.0,82,52,164,51,63,12,27,44,7,349,153,1
13931,130214,k2w7Fl2HRg9SZoDIHFnK8RXCKuBBE2y7,7GRhBDsirIGkRZBtSMEzNTyDr2JQm4xx,9,7,3,4,2,0,5,0,21,3.0,1,0.0,1,3,3,2,6,0,1,5,0,9,12,1
13932,130219,qppbwIX77a7g0SZNFPbNFRfXGteVBkut,7GRhBDsirIGkRZBtSMEzNTyDr2JQm4xx,15,13,1,0,1,0,2,0,17,2.4285714285714284,1,0.0,1,1,0,1,12,0,0,2,0,3,14,1
13933,130228,itycNCCvd4Cws5pdd4hKIkDKI4KaE5Jt,7GRhBDsirIGkRZBtSMEzNTyDr2JQm4xx,1,0,0,0,0,0,1,0,1,0.14285714285714285,1,0.0,0,0,0,0,0,0,0,1,0,0,1,1
13934,130233,5iaVnotpymFcumonl8g2gZO9P5jogtd2,7GRhBDsirIGkRZBtSMEzNTyDr2JQm4xx,3,0,0,0,0,0,4,0,4,0.5714285714285714,1,0.0,0,0,0,0,0,0,0,4,0,0,4,1
13935,130239,ECkqmAuIkv3ncN9wNJby8oOn15qTd9kR,7GRhBDsirIGkRZBtSMEzNTyDr2JQm4xx,1,0,0,0,0,0,3,0,3,0.42857142857142855,3,0.0,0,0,0,0,0,0,0,3,0,0,3,0
13936,130281,Xk0aXqHKuSgZhNiXq8RgJPrtVhmUprw8,7GRhBDsirIGkRZBtSMEzNTyDr2JQm4xx,4,0,0,0,0,0,5,0,5,0.7142857142857143,1,0.0,0,0,0,0,0,0,0,5,0,0,5,1
13937,130308,EzGPRLsUlIo5IP2I72eusCvmoWbZVrJa,7GRhBDsirIGkRZBtSMEzNTyDr2JQm4xx,20,18,10,2,12,0,3,1,46,6.571428571428571,1,0.0,7,10,1,12,11,0,1,3,1,30,16,1
13938,130318,Mms6sMIkW4Omst3uLD38oJJ4C0ZCQcDW,7GRhBDsirIGkRZBtSMEzNTyDr2JQm4xx,16,33,1,0,1,0,9,0,44,6.285714285714286,3,0.0,1,1,0,1,32,0,0,9,0,3,41,1
13939,130321,gzS6aH9DKKq1TfiY1ctxHgUplSbkMYNf,7GRhBDsirIGkRZBtSMEzNTyDr2JQm4xx,11,8,4,6,1,0,12,0,31,4.428571428571429,2,0.0,4,4,5,1,4,0,1,12,0,14,17,1
13940,130344,SgAQznFMH2vEpxp7awjlaNSuRoraIyRm,7GRhBDsirIGkRZBtSMEzNTyDr2JQm4xx,5,1,1,0,0,0,3,0,5,0.7142857142857143,1,0.0,0,1,0,0,1,0,0,3,0,1,4,1
13941,130345,v7pdrt6SOAQ5FMXohVYmR0yZQdsegJw7,7GRhBDsirIGkRZBtSMEzNTyDr2JQm4xx,43,77,1,28,6,2,15,0,129,18.428571428571427,2,0.0,39,1,15,6,38,2,13,15,0,61,68,0
13942,130365,eVgT2CbOLxsuiNPb72WZgTO5ceO1TpuV,7GRhBDsirIGkRZBtSMEzNTyDr2JQm4xx,42,50,25,20,19,0,17,1,132,18.857142857142858,5,0.0,16,25,12,19,34,0,8,17,1,72,60,0
13943,130366,vLemTwwt8xP5QLIcPBq52mNmGrvOEG3u,7GRhBDsirIGkRZBtSMEzNTyDr2JQm4xx,5,3,2,0,0,0,2,0,7,1.0,1,0.0,0,2,0,0,3,0,0,2,0,2,5,1
13944,130380,6YiRUK7GTmmYg38edmBU3I2zGY5J1nt6,7GRhBDsirIGkRZBtSMEzNTyDr2JQm4xx,1,0,0,0,0,0,1,0,1,0.14285714285714285,1,0.0,0,0,0,0,0,0,0,1,0,0,1,1
13945,130406,VVltscgfR96aweHb5nQdD1Q7dsOwuOJz,5Gyp41oLVo7Gg7vF4vpmggWP5MU70QO6,13,56,8,8,2,0,11,0,85,12.142857142857142,7,0.0,5,8,6,2,51,0,2,11,0,21,64,1
13946,130430,bilSeR9mObpPcP1PUZ8Is5qUZjsLPMqS,5Gyp41oLVo7Gg7vF4vpmggWP5MU70QO6,20,19,0,13,4,4,6,1,47,6.714285714285714,3,0.0,2,0,8,4,17,4,5,6,1,14,33,1
13947,130431,jImHfNEIObE674KdIbKVj7cCJ4ufqzHJ,5Gyp41oLVo7Gg7vF4vpmggWP5MU70QO6,30,207,101,11,22,653,130,12,1136,162.28571428571428,12,0.0,38,101,10,22,169,653,1,130,12,171,965,1
13948,130481,z5rMlNd1woSStootPqy2Qp5Ts5VQeUHq,5Gyp41oLVo7Gg7vF4vpmggWP5MU70QO6,41,165,40,20,32,18,15,1,291,41.57142857142857,7,0.0,46,40,16,32,119,18,4,15,1,134,157,1
13949,130506,eR5PV0dYbD8ueDcYifFqdqN2AUdg11VW,5Gyp41oLVo7Gg7vF4vpmggWP5MU70QO6,7,7,2,1,1,0,7,0,18,2.5714285714285716,2,0.0,5,2,1,1,2,0,0,7,0,9,9,1
13950,130509,frKeUuwARUyvMz8S597LQJwYmVKBozSX,5Gyp41oLVo7Gg7vF4vpmggWP5MU70QO6,12,8,3,4,2,0,5,0,22,3.142857142857143,2,0.0,2,3,3,2,6,0,1,5,0,10,12,1
13951,130524,h3uJUtBmEvmKgQr2Q8BC6FJ5GRugm894,5Gyp41oLVo7Gg7vF4vpmggWP5MU70QO6,27,44,20,22,10,9,32,1,138,19.714285714285715,7,0.0,22,20,13,10,22,9,9,32,1,65,73,1
13952,130557,YVn9jdODWjYH4ISnssulh0fF4C7UEmSV,5Gyp41oLVo7Gg7vF4vpmggWP5MU70QO6,20,76,37,34,5,17,25,1,195,27.857142857142858,8,0.0,7,37,28,5,69,17,6,25,1,77,118,1
13953,130590,Vl7M6B6ZHcsJwfxY8qrbGK9Mzkw1RYzj,5Gyp41oLVo7Gg7vF4vpmggWP5MU70QO6,21,39,1,15,10,6,9,0,80,11.428571428571429,6,0.0,17,1,11,10,22,6,4,9,0,39,41,1
13954,130592,72Upod5KbmkLZabDythfsA8OtoLEgJE6,5Gyp41oLVo7Gg7vF4vpmggWP5MU70QO6,6,4,2,0,1,0,3,0,10,1.4285714285714286,1,0.0,0,2,0,1,4,0,0,3,0,3,7,1
13955,130601,ENpayG4OENRGG5E8exbUiTYpkyVQE1B4,5Gyp41oLVo7Gg7vF4vpmggWP5MU70QO6,13,23,11,0,6,0,4,0,44,6.285714285714286,2,0.0,6,11,0,6,17,0,0,4,0,23,21,1
13956,130602,tDtQGbIKD1W16PxqdlyEI8G7TTcAazQv,5Gyp41oLVo7Gg7vF4vpmggWP5MU70QO6,35,129,61,31,24,7,50,1,303,43.285714285714285,7,0.0,27,61,22,24,102,7,9,50,1,134,169,1
13957,130619,S0xcmkew9ISn4kX66Vvp2Q83evEecsY7,5Gyp41oLVo7Gg7vF4vpmggWP5MU70QO6,14,23,11,10,3,3,14,4,68,9.714285714285714,1,0.0,6,11,8,3,17,3,2,14,4,28,40,1
13958,130639,pvDccy74bXOMlvEEOXbZuBTpbP3bqi6z,5Gyp41oLVo7Gg7vF4vpmggWP5MU70QO6,15,41,4,10,12,0,11,1,79,11.285714285714286,4,0.0,5,4,7,12,36,0,3,11,1,28,51,0
13959,130655,5LjPqUcQMvx0ZAsBkoGPPYeORJ2JDTt8,5Gyp41oLVo7Gg7vF4vpmggWP5MU70QO6,18,38,20,20,10,12,11,2,113,16.142857142857142,3,0.0,11,20,15,10,27,12,5,11,2,56,57,1
13960,130656,m3T1hUISINGlAKUGxWLh1SWeWS2g3vwW,5Gyp41oLVo7Gg7vF4vpmggWP5MU70QO6,6,5,3,0,2,0,6,0,16,2.2857142857142856,2,0.0,0,3,0,2,5,0,0,6,0,5,11,0
13961,130657,B9yncBKLvS1GgfzwUEshAvwYXATyMrwA,5Gyp41oLVo7Gg7vF4vpmggWP5MU70QO6,5,5,2,0,3,0,2,0,12,1.7142857142857142,2,0.0,0,2,0,3,5,0,0,2,0,5,7,1
13962,130672,uNxXycqvM6TaaSbzDjbWtwKtomL95t5y,5Gyp41oLVo7Gg7vF4vpmggWP5MU70QO6,8,4,2,0,2,0,2,0,10,1.4285714285714286,1,0.0,0,2,0,2,4,0,0,2,0,4,6,1
13963,130683,4wGoSTuzJXBCojeNmaxk9GbR1KaCV7ql,5Gyp41oLVo7Gg7vF4vpmggWP5MU70QO6,53,228,27,78,39,11,49,7,439,62.714285714285715,13,0.0,48,27,55,39,180,11,23,49,7,169,270,0
13964,130684,Xn7qmjNToAa0VyKnSO1kny1HaDOvLlmh,5Gyp41oLVo7Gg7vF4vpmggWP5MU70QO6,10,10,6,0,3,1,12,3,35,5.0,3,0.0,0,6,0,3,10,1,0,12,3,9,26,1
13965,130691,FtmLWfuXgFTxK2NwWBKqImBR5ELSkMfl,5Gyp41oLVo7Gg7vF4vpmggWP5MU70QO6,27,46,18,40,10,4,9,1,128,18.285714285714285,6,0.0,14,18,27,10,32,4,13,9,1,69,59,1
13966,130693,YoRqoOzvuzCTaiYWYaAvvKsbRs610g1g,5Gyp41oLVo7Gg7vF4vpmggWP5MU70QO6,6,3,1,0,2,0,4,0,10,1.4285714285714286,1,0.0,0,1,0,2,3,0,0,4,0,3,7,1
13967,130717,BVAGgEW2EKxBtO91Mx2JXGMuAkZ96aI3,5Gyp41oLVo7Gg7vF4vpmggWP5MU70QO6,23,24,14,6,6,0,6,0,56,8.0,3,0.0,3,14,3,6,21,0,3,6,0,26,30,1
13968,130722,EzZp58qK2EXfSMYVozpDOT2RLEnP7Wyg,5Gyp41oLVo7Gg7vF4vpmggWP5MU70QO6,8,3,2,0,2,0,3,1,11,1.5714285714285714,1,0.0,0,2,0,2,3,0,0,3,1,4,7,1
13969,130723,P7Sqste9zYZatocGsg7sskoMOdPP5Gj1,5Gyp41oLVo7Gg7vF4vpmggWP5MU70QO6,10,14,7,0,4,0,5,0,30,4.285714285714286,2,0.0,1,7,0,4,13,0,0,5,0,12,18,1
13970,130731,7m2wO5YcqDaefqUONLXd7alpzzzbzO2U,5Gyp41oLVo7Gg7vF4vpmggWP5MU70QO6,9,9,3,8,2,0,1,0,23,3.2857142857142856,2,0.0,3,3,5,2,6,0,3,1,0,13,10,1
13971,130740,QcWlQqN59ymnFchBH8yJKMhkaLaoYrxe,5Gyp41oLVo7Gg7vF4vpmggWP5MU70QO6,14,18,10,3,4,1,10,1,47,6.714285714285714,6,0.0,1,10,2,4,17,1,1,10,1,17,30,0
13972,130775,tbSNaNTCXjjk5FJbZQdQoCO9D9WtzbXl,5Gyp41oLVo7Gg7vF4vpmggWP5MU70QO6,31,102,47,13,12,52,25,0,251,35.857142857142854,8,0.0,39,47,10,12,63,52,3,25,0,108,143,0
13973,130777,PYwEpaHAsATpUCq9rLQ9XKcLHyYqMpBU,5Gyp41oLVo7Gg7vF4vpmggWP5MU70QO6,24,61,43,16,21,7,5,0,153,21.857142857142858,10,0.0,10,43,12,21,51,7,4,5,0,86,67,1
13974,130808,tlAKUfcYPe8Fd8ANUeuNTnqfHMJlTvn5,5Gyp41oLVo7Gg7vF4vpmggWP5MU70QO6,32,110,64,18,12,25,38,1,268,38.285714285714285,8,0.0,11,64,12,12,99,25,6,38,1,99,169,1
13975,130812,oGQiEqdGpCsuqJcbVdZnpo24K0PsLrJi,5Gyp41oLVo7Gg7vF4vpmggWP5MU70QO6,10,49,8,0,0,17,13,3,90,12.857142857142858,5,0.0,31,8,0,0,18,17,0,13,3,39,51,1
13976,130818,RqdDZ59hZyptwdavZ7BebY7MyinitbUb,5Gyp41oLVo7Gg7vF4vpmggWP5MU70QO6,8,5,3,0,2,0,4,0,14,2.0,2,0.0,0,3,0,2,5,0,0,4,0,5,9,1
13977,130824,eFYXzugx3CSocMfDr913tnmbbGlpvtVI,5Gyp41oLVo7Gg7vF4vpmggWP5MU70QO6,18,24,9,6,3,2,7,4,55,7.857142857142857,1,0.0,7,9,3,3,17,2,3,7,4,22,33,1
13978,130841,udMhHHYhrWPSXlHAeBMBnxFP5fCV1rfY,5Gyp41oLVo7Gg7vF4vpmggWP5MU70QO6,2,0,0,0,0,0,3,0,3,0.42857142857142855,2,0.0,0,0,0,0,0,0,0,3,0,0,3,1
13979,130846,OGP50ek5EQjpi2zh30ktLm4U34Pswm87,5Gyp41oLVo7Gg7vF4vpmggWP5MU70QO6,14,18,9,18,3,12,7,0,67,9.571428571428571,4,0.0,4,9,11,3,14,12,7,7,0,27,40,1
13980,130861,27KU7J0xhwne5RAwWlMtoP7JA6sMyYoP,5Gyp41oLVo7Gg7vF4vpmggWP5MU70QO6,13,13,6,7,2,0,3,0,31,4.428571428571429,2,0.0,3,6,5,2,10,0,2,3,0,16,15,1
13981,130875,Tp8JPIsnyTxn7ayN9BTTjHy1pMsJa0Vc,5Gyp41oLVo7Gg7vF4vpmggWP5MU70QO6,1,0,0,0,0,0,1,0,1,0.14285714285714285,1,0.0,0,0,0,0,0,0,0,1,0,0,1,1
13982,130883,AzwZEXamtdgLpo6unNtxDELRunLHhXR8,5Gyp41oLVo7Gg7vF4vpmggWP5MU70QO6,18,45,17,18,11,4,15,1,111,15.857142857142858,3,0.0,9,17,14,11,36,4,4,15,1,51,60,1
13983,130896,kYfOIu5uflk2rQ8wLoaBsOg3FtspwBHu,5Gyp41oLVo7Gg7vF4vpmggWP5MU70QO6,4,2,0,0,2,0,3,0,7,1.0,1,0.0,0,0,0,2,2,0,0,3,0,2,5,1
13984,130903,WI9rk8aS11tBAJzjcX0JSIgomYYRQVjW,5Gyp41oLVo7Gg7vF4vpmggWP5MU70QO6,12,8,6,0,4,1,5,1,25,3.5714285714285716,1,0.0,1,6,0,4,7,1,0,5,1,11,14,1
13985,130928,P0jTr6KeEArwoDtyTCyFDVA7APW9Mr2X,5Gyp41oLVo7Gg7vF4vpmggWP5MU70QO6,1,0,0,0,0,0,1,0,1,0.14285714285714285,1,0.0,0,0,0,0,0,0,0,1,0,0,1,1
13986,130943,RuS9pbpGiIPFu0lqA2IZoNwqWqyO5edb,5Gyp41oLVo7Gg7vF4vpmggWP5MU70QO6,23,70,31,0,18,17,22,8,166,23.714285714285715,7,0.0,26,31,0,18,44,17,0,22,8,75,91,1
13987,130958,P3P2f1k41OHmAOZyTHWhlLrinAgXyMwc,5Gyp41oLVo7Gg7vF4vpmggWP5MU70QO6,45,55,29,159,4,14,16,0,277,39.57142857142857,4,0.0,20,29,139,4,35,14,20,16,0,192,85,1
13988,130967,Qnzs7MQvDdrlT4xr5UXbcEcJunB4iJGk,5Gyp41oLVo7Gg7vF4vpmggWP5MU70QO6,5,1,1,0,1,0,3,0,6,0.8571428571428571,1,0.0,0,1,0,1,1,0,0,3,0,2,4,1
13989,130971,VVPQtMkwOc5Rpx6fMA3qUfZufjuUWJdd,5Gyp41oLVo7Gg7vF4vpmggWP5MU70QO6,8,18,0,7,1,0,1,0,27,3.857142857142857,1,0.0,13,0,5,1,5,0,2,1,0,19,8,1
13990,131008,zNnqmF2sQm5pVrk4EjykARlvIbp0hTq0,5Gyp41oLVo7Gg7vF4vpmggWP5MU70QO6,13,26,14,6,4,14,15,0,79,11.285714285714286,3,0.0,6,14,5,4,20,14,1,15,0,29,50,1
13991,131016,rC4Pc8SlsYV1vuCEoQDOK6VUDBUpjTvY,5Gyp41oLVo7Gg7vF4vpmggWP5MU70QO6,4,2,1,0,1,0,2,0,6,0.8571428571428571,1,0.0,0,1,0,1,2,0,0,2,0,2,4,1
13992,131025,g9c2xUyd7tiFCZxNiP08zbr6vrteI2C3,5Gyp41oLVo7Gg7vF4vpmggWP5MU70QO6,18,32,29,0,8,0,10,0,79,11.285714285714286,3,0.0,0,29,0,8,32,0,0,10,0,37,42,1
13993,131032,0QSMkT1dSojdga3gOUuLnnXcPZoPeqgp,5Gyp41oLVo7Gg7vF4vpmggWP5MU70QO6,9,8,6,6,4,0,2,0,26,3.7142857142857144,1,0.0,1,6,3,4,7,0,3,2,0,14,12,1
13994,131066,L2ebvKGgpcX4BC43tbs0EBdlfqS17H7s,5Gyp41oLVo7Gg7vF4vpmggWP5MU70QO6,15,25,11,0,4,4,24,2,70,10.0,3,0.0,2,11,0,4,23,4,0,24,2,17,53,1
13995,131086,LbIxn9M7zi5eJAVKHJk4SUmWIrBjRpyC,5Gyp41oLVo7Gg7vF4vpmggWP5MU70QO6,32,69,44,26,11,11,12,8,181,25.857142857142858,7,0.0,17,44,16,11,52,11,10,12,8,88,93,1
13996,131103,v8EL49Rw5uIBfTnluJIiynUhJSONuHZw,5Gyp41oLVo7Gg7vF4vpmggWP5MU70QO6,19,50,13,8,1,0,8,1,81,11.571428571428571,5,0.0,13,13,5,1,37,0,3,8,1,32,49,1
13997,131121,UG5RbMOVznG8udS8GWsbT5jzf3cvnOYI,5Gyp41oLVo7Gg7vF4vpmggWP5MU70QO6,5,3,2,0,1,0,1,0,7,1.0,1,0.0,0,2,0,1,3,0,0,1,0,3,4,1
13998,131151,bqWpav7ocOhCfb3xc4QgAvBDK5g8BmiZ,5Gyp41oLVo7Gg7vF4vpmggWP5MU70QO6,26,73,34,19,37,21,21,3,208,29.714285714285715,5,0.0,32,34,13,37,41,21,6,21,3,116,92,1
13999,131154,NZr7ZreoMfrfsvmVD8zC4zd8vweniEIo,5Gyp41oLVo7Gg7vF4vpmggWP5MU70QO6,13,23,10,6,4,6,14,0,63,9.0,2,0.0,5,10,4,4,18,6,2,14,0,23,40,1
14000,131161,h4WGgOBVQGLmMIXc7haVdsTOd5L5ucTp,5Gyp41oLVo7Gg7vF4vpmggWP5MU70QO6,4,2,1,0,0,1,2,1,7,1.0,1,0.0,0,1,0,0,2,1,0,2,1,1,6,1
14001,131175,L8lHLh6Mth1S7I3sErP5oDZD885a1BOh,5Gyp41oLVo7Gg7vF4vpmggWP5MU70QO6,26,48,22,9,8,24,19,0,130,18.571428571428573,6,0.0,18,22,7,8,30,24,2,19,0,55,75,1
14002,131185,VAPb5dw6WtnSykbRSlbEIs6DWlruq9Fk,5Gyp41oLVo7Gg7vF4vpmggWP5MU70QO6,1,0,0,0,0,0,1,0,1,0.14285714285714285,1,0.0,0,0,0,0,0,0,0,1,0,0,1,1
14003,131197,1BUzzAo0Z6oAutmyjoxe5eSgUumBRi8v,5Gyp41oLVo7Gg7vF4vpmggWP5MU70QO6,3,2,1,0,0,1,1,0,5,0.7142857142857143,1,0.0,0,1,0,0,2,1,0,1,0,1,4,1
14004,131203,X4C2nx3UVUJgm6ZryQmz9YJ8R87beh5i,5Gyp41oLVo7Gg7vF4vpmggWP5MU70QO6,8,4,2,0,3,0,2,0,11,1.5714285714285714,1,0.0,1,2,0,3,3,0,0,2,0,6,5,1
14005,131207,DD3RB9vWEpLhfNx2699s29qSfhYix0qh,5Gyp41oLVo7Gg7vF4vpmggWP5MU70QO6,8,6,4,0,3,0,3,0,16,2.2857142857142856,1,0.0,0,4,0,3,6,0,0,3,0,7,9,1
14006,131218,uKuE1pqPLKBLlaDHpMsHUJvLz6lxiokY,5Gyp41oLVo7Gg7vF4vpmggWP5MU70QO6,8,20,7,0,2,0,11,0,40,5.714285714285714,6,0.0,0,7,0,2,20,0,0,11,0,9,31,1
14007,131253,Tvd2bCFlWrRCvuUw3oRJ0Jgdh4hPpig5,5Gyp41oLVo7Gg7vF4vpmggWP5MU70QO6,24,31,1,0,12,0,11,2,57,8.142857142857142,3,0.0,1,1,0,12,30,0,0,11,2,14,43,1
14008,131273,SqgJOgaP4pFZ2p8zfRA0U72LErM41cgu,5Gyp41oLVo7Gg7vF4vpmggWP5MU70QO6,10,8,4,0,5,2,7,1,27,3.857142857142857,1,0.0,2,4,0,5,6,2,0,7,1,11,16,1
14009,131274,dWr5zNgWfiFnNbhTePYEGNlYVTa6QiXF,5Gyp41oLVo7Gg7vF4vpmggWP5MU70QO6,25,44,29,17,8,6,21,1,126,18.0,6,0.0,3,29,11,8,41,6,6,21,1,51,75,1
14010,131289,emctPMiDvkxJz5RzkFwPKDxs9Mbgtxhm,5Gyp41oLVo7Gg7vF4vpmggWP5MU70QO6,16,19,1,11,3,5,9,1,49,7.0,3,0.0,6,1,9,3,13,5,2,9,1,19,30,1
14011,131308,YAOH779hblcwv4rEXplae8dobLTCbNL7,5Gyp41oLVo7Gg7vF4vpmggWP5MU70QO6,9,14,3,9,2,0,1,0,29,4.142857142857143,1,0.0,10,3,6,2,4,0,3,1,0,21,8,1
14012,131320,3BitdRzRFgj4ua4IH2jOKy9wxW0orDjs,5Gyp41oLVo7Gg7vF4vpmggWP5MU70QO6,25,40,22,18,11,0,8,0,99,14.142857142857142,5,0.0,11,22,12,11,29,0,6,8,0,56,43,1
14013,131367,wk03KQOcp9ENxMFqWwXTeb33Zq9dBs9v,5Gyp41oLVo7Gg7vF4vpmggWP5MU70QO6,13,28,14,10,9,0,5,0,66,9.428571428571429,2,0.0,10,14,6,9,18,0,4,5,0,39,27,1
14014,131370,uT81Ni5WobE49DtbtOYKsHp3O02xlZuC,5Gyp41oLVo7Gg7vF4vpmggWP5MU70QO6,4,2,1,0,1,0,1,0,5,0.7142857142857143,1,0.0,0,1,0,1,2,0,0,1,0,2,3,1
14015,131383,YCItyuScKutYm9NH0VZVrLSZhJ4BWiOI,5Gyp41oLVo7Gg7vF4vpmggWP5MU70QO6,29,69,34,20,14,3,16,0,156,22.285714285714285,6,0.0,15,34,15,14,54,3,5,16,0,78,78,0
14016,131391,QPoypIc1fBONo2zEXZGrqFPP68plPMOG,5Gyp41oLVo7Gg7vF4vpmggWP5MU70QO6,48,77,36,28,37,1,23,1,203,29.0,6,0.0,28,36,19,37,49,1,9,23,1,120,83,1
14017,131408,bP4doJ33skv60jUwMG3ksI1SOLMo5v6M,5Gyp41oLVo7Gg7vF4vpmggWP5MU70QO6,1,0,0,0,0,0,1,0,1,0.14285714285714285,1,0.0,0,0,0,0,0,0,0,1,0,0,1,1
14018,131419,P0rhRDVe1EcDkj0SvoOB5GNxqem9hFvy,5Gyp41oLVo7Gg7vF4vpmggWP5MU70QO6,14,37,18,18,8,9,9,0,99,14.142857142857142,7,0.0,9,18,13,8,28,9,5,9,0,48,51,0
14019,131429,OJscREFZ2I30mlxoCsbPJEVsdd0F4XgB,5Gyp41oLVo7Gg7vF4vpmggWP5MU70QO6,10,7,5,0,2,2,6,0,22,3.142857142857143,2,0.0,0,5,0,2,7,2,0,6,0,7,15,1
14020,131432,hN36MWe31guSb7pSDaWhTmCCv4ltTr0z,5Gyp41oLVo7Gg7vF4vpmggWP5MU70QO6,6,6,3,0,1,0,4,0,14,2.0,2,0.0,0,3,0,1,6,0,0,4,0,4,10,1
14021,131442,EaDnLkVMEsYfdUTQmjKMTMipeDYtU7tW,5Gyp41oLVo7Gg7vF4vpmggWP5MU70QO6,5,2,1,0,1,0,3,0,7,1.0,2,0.0,0,1,0,1,2,0,0,3,0,2,5,1
14022,131455,H6wVUr01scr0KSyeWOeZJo6Ppyqo4vfx,5Gyp41oLVo7Gg7vF4vpmggWP5MU70QO6,15,15,10,7,7,3,6,0,48,6.857142857142857,2,0.0,2,10,4,7,13,3,3,6,0,23,25,1
14023,131460,JFKX7aipG9ohO3LoTtLaVlpaWRUwxfwA,5Gyp41oLVo7Gg7vF4vpmggWP5MU70QO6,11,10,6,0,2,0,4,0,22,3.142857142857143,3,0.0,1,6,0,2,9,0,0,4,0,9,13,1
14024,131464,DRhlp1eJHQqsxjCL0bRD6kkHN20HbJ4w,5Gyp41oLVo7Gg7vF4vpmggWP5MU70QO6,7,5,3,0,2,0,2,0,12,1.7142857142857142,2,0.0,0,3,0,2,5,0,0,2,0,5,7,1
14025,131483,zvVFDTjz1IMLrQSJ5FVA60EmZ6t1TpeJ,5Gyp41oLVo7Gg7vF4vpmggWP5MU70QO6,6,5,3,0,2,0,3,0,13,1.8571428571428572,1,0.0,0,3,0,2,5,0,0,3,0,5,8,1
14026,131499,x3ZcCHvytIJQEMLj5E05tgfA0i9bCC3E,5Gyp41oLVo7Gg7vF4vpmggWP5MU70QO6,9,7,4,0,2,1,7,1,22,3.142857142857143,2,0.0,0,4,0,2,7,1,0,7,1,6,16,1
14027,131514,s1TeLy1FGEb0X1vS2VTZ5I3G8yYusIJM,5Gyp41oLVo7Gg7vF4vpmggWP5MU70QO6,1,0,0,0,0,0,1,0,1,0.14285714285714285,1,0.0,0,0,0,0,0,0,0,1,0,0,1,0
14028,131521,D9VUUHG8JE4zHfpiuvARnOVEhmtfjBRZ,5Gyp41oLVo7Gg7vF4vpmggWP5MU70QO6,6,3,0,0,2,0,1,0,6,0.8571428571428571,1,0.0,0,0,0,2,3,0,0,1,0,2,4,1
14029,131532,CC63ymfgF4EYO3IIdOkBcne8yDI17q8n,5Gyp41oLVo7Gg7vF4vpmggWP5MU70QO6,12,11,6,0,5,0,4,0,26,3.7142857142857144,2,0.0,0,6,0,5,11,0,0,4,0,11,15,1
14030,131545,2s1w2v8MgoByNGqR51pltJWsiHzHAFZ1,5Gyp41oLVo7Gg7vF4vpmggWP5MU70QO6,13,20,12,5,6,0,4,0,47,6.714285714285714,4,0.0,4,12,3,6,16,0,2,4,0,25,22,1
14031,131548,Q6FiYurGL03EdY7pGI3iMkFDIkxD4zO6,5Gyp41oLVo7Gg7vF4vpmggWP5MU70QO6,15,24,13,6,4,5,15,2,69,9.857142857142858,4,0.0,5,13,4,4,19,5,2,15,2,26,43,1
14032,131555,wXFfHtwd9smrvhh9NQW7SmEEo1001LDW,5Gyp41oLVo7Gg7vF4vpmggWP5MU70QO6,18,41,19,11,9,14,24,3,121,17.285714285714285,10,0.0,9,19,7,9,32,14,4,24,3,44,77,0
14033,131556,PTYhYCx0lXKOfswUXa0bNi4VYNIzIve4,5Gyp41oLVo7Gg7vF4vpmggWP5MU70QO6,10,3,2,0,2,5,6,1,19,2.7142857142857144,1,0.0,0,2,0,2,3,5,0,6,1,4,15,1
14034,131558,IgexhZ9xriCDdGfY04wPYqqhzLtdPh8J,5Gyp41oLVo7Gg7vF4vpmggWP5MU70QO6,24,43,25,4,8,1,9,0,90,12.857142857142858,4,0.0,11,25,3,8,32,1,1,9,0,47,43,1
14035,131579,D8q3p28oNnCDKOIbiGQbgveHVNlF4K29,5Gyp41oLVo7Gg7vF4vpmggWP5MU70QO6,31,79,39,1,23,0,13,0,155,22.142857142857142,6,0.0,22,39,1,23,57,0,0,13,0,85,70,1
14036,131604,wOfyVIJKuk4vmpOTIf49KeZ8OsxoFrNZ,5Gyp41oLVo7Gg7vF4vpmggWP5MU70QO6,9,13,5,1,1,0,5,0,25,3.5714285714285716,3,0.0,3,5,1,1,10,0,0,5,0,10,15,1
14037,131608,xUjsmVq4wk1vW0iAypz5SwAatQZxGZJN,5Gyp41oLVo7Gg7vF4vpmggWP5MU70QO6,9,11,2,8,2,0,1,0,24,3.4285714285714284,1,0.0,3,2,5,2,8,0,3,1,0,12,12,1
14038,131610,BFrfDseDfXCBvtTfCsJAy36Ogk6b0Rfx,5Gyp41oLVo7Gg7vF4vpmggWP5MU70QO6,16,30,19,0,4,0,5,0,58,8.285714285714286,5,0.0,0,19,0,4,30,0,0,5,0,23,35,0
14039,131616,ww05exVvqmTpHRLpMlcyyiyf25IJQarF,5Gyp41oLVo7Gg7vF4vpmggWP5MU70QO6,11,34,22,0,11,0,13,0,80,11.428571428571429,6,0.0,0,22,0,11,34,0,0,13,0,33,47,1
14040,131619,HK63snN9qbxmD5swy0CbmdWWUnBqMpfV,5Gyp41oLVo7Gg7vF4vpmggWP5MU70QO6,12,9,4,5,5,0,5,2,30,4.285714285714286,2,0.0,4,4,3,5,5,0,2,5,2,16,14,1
14041,131634,G461L6IqW9kRppIDUrOTTZPYwnPenSFz,5Gyp41oLVo7Gg7vF4vpmggWP5MU70QO6,19,38,16,9,8,3,14,0,88,12.571428571428571,4,0.0,15,16,7,8,23,3,2,14,0,46,42,1
14042,131646,hefQlDeoTkFAJkCwSIMRgQRBdm5PYiVH,5Gyp41oLVo7Gg7vF4vpmggWP5MU70QO6,1,0,0,0,0,0,3,0,3,0.42857142857142855,2,0.0,0,0,0,0,0,0,0,3,0,0,3,1
14043,131658,KIgAXwSSNMrV9xvvWDPKGpC4t6I5z7W3,5Gyp41oLVo7Gg7vF4vpmggWP5MU70QO6,9,11,2,4,2,0,3,0,22,3.142857142857143,2,0.0,3,2,2,2,8,0,2,3,0,9,13,1
14044,131683,CSh5hGbaSFu2yCb31iVMOVwKocrH471Q,5Gyp41oLVo7Gg7vF4vpmggWP5MU70QO6,12,28,8,0,6,0,9,1,52,7.428571428571429,4,0.0,9,8,0,6,19,0,0,9,1,23,29,1
14045,131704,pgpJvSAjsHKd3kT9nQoOTfo24SVV2VIt,5Gyp41oLVo7Gg7vF4vpmggWP5MU70QO6,15,28,9,0,3,1,9,0,50,7.142857142857143,4,0.0,2,9,0,3,26,1,0,9,0,14,36,1
14046,131717,pzpWAA9mk4uNhMIFCnnenGE5a1mdDNf3,5Gyp41oLVo7Gg7vF4vpmggWP5MU70QO6,31,64,44,37,14,0,15,0,174,24.857142857142858,3,0.0,9,44,25,14,55,0,12,15,0,92,82,1
14047,131768,nWqxqrZieFu5PiKqDCSzyLuUaohKvtIs,5Gyp41oLVo7Gg7vF4vpmggWP5MU70QO6,13,7,5,4,4,0,5,1,26,3.7142857142857144,1,0.0,1,5,2,4,6,0,2,5,1,12,14,1
14048,131772,qKB2XQNbRVqqDMhQPlQh48h20NofWfSV,5Gyp41oLVo7Gg7vF4vpmggWP5MU70QO6,1,0,0,0,0,0,1,0,1,0.14285714285714285,1,0.0,0,0,0,0,0,0,0,1,0,0,1,1
14049,131774,p6SfsKU1ItjlJAGItngkr3XWispWnBPx,5Gyp41oLVo7Gg7vF4vpmggWP5MU70QO6,72,225,112,124,48,47,25,1,582,83.14285714285714,8,0.0,83,112,92,48,142,47,32,25,1,335,247,0
14050,131784,9DudB7SDh1sCxzok7LxIa0mk2N4qIA3p,5Gyp41oLVo7Gg7vF4vpmggWP5MU70QO6,13,16,12,0,8,0,3,0,39,5.571428571428571,2,0.0,0,12,0,8,16,0,0,3,0,20,19,0
14051,131794,odgZyA83xPYS0Ppo5I8WTTJmNdIGI867,5Gyp41oLVo7Gg7vF4vpmggWP5MU70QO6,1,0,0,0,0,0,1,0,1,0.14285714285714285,1,0.0,0,0,0,0,0,0,0,1,0,0,1,1
14052,131826,iDAI1Vho9XZTTivESwKNINgCsnyoVvF9,5Gyp41oLVo7Gg7vF4vpmggWP5MU70QO6,6,4,3,0,1,0,2,0,10,1.4285714285714286,1,0.0,0,3,0,1,4,0,0,2,0,4,6,1
14053,131847,I6LjJf7gac8MetwrPjXxym7t0NixHmVY,5Gyp41oLVo7Gg7vF4vpmggWP5MU70QO6,25,102,42,10,26,28,33,4,245,35.0,6,0.0,23,42,7,26,79,28,3,33,4,98,147,1
14054,131866,6MpBt1ikbHLEMzYvCtOKVw0lV31pnZtK,5Gyp41oLVo7Gg7vF4vpmggWP5MU70QO6,11,29,16,3,9,0,8,0,65,9.285714285714286,5,0.0,2,16,2,9,27,0,1,8,0,29,36,1
14055,131869,KT5lan1W2tpQSImfn2FRNqdsy6GrGc1j,5Gyp41oLVo7Gg7vF4vpmggWP5MU70QO6,10,8,4,0,4,4,10,3,33,4.714285714285714,2,0.0,2,4,0,4,6,4,0,10,3,10,23,1
14056,131874,lfEnOibu2rkQo0inX5gNisoEBgLAfH8d,5Gyp41oLVo7Gg7vF4vpmggWP5MU70QO6,8,4,3,0,3,0,1,0,11,1.5714285714285714,1,0.0,0,3,0,3,4,0,0,1,0,6,5,1
14057,131877,xY7Egq7HpAqbXGGKweN3pllHOWoiO1V5,5Gyp41oLVo7Gg7vF4vpmggWP5MU70QO6,6,3,2,0,1,0,2,0,8,1.1428571428571428,1,0.0,0,2,0,1,3,0,0,2,0,3,5,1
14058,131896,BDftrCCcwc58ghs1NH41Jo6ySFdVhm4G,5Gyp41oLVo7Gg7vF4vpmggWP5MU70QO6,24,49,27,19,6,1,15,0,117,16.714285714285715,5,0.0,6,27,12,6,43,1,7,15,0,51,66,0
14059,131904,RKevUFoWjA4gBXEFiCKb5AP4PJvgxsMD,5Gyp41oLVo7Gg7vF4vpmggWP5MU70QO6,8,6,3,0,3,0,3,0,15,2.142857142857143,2,0.0,2,3,0,3,4,0,0,3,0,8,7,1
14060,131905,fYlMJFRbxFagGbb5ktu9JqLCT7VrJ7D2,5Gyp41oLVo7Gg7vF4vpmggWP5MU70QO6,7,5,4,0,3,0,2,0,14,2.0,1,0.0,0,4,0,3,5,0,0,2,0,7,7,1
14061,131909,GNrTu0wsmzabBYmg0mo2K8b2CbSRTSSW,5Gyp41oLVo7Gg7vF4vpmggWP5MU70QO6,29,85,36,29,10,19,27,0,206,29.428571428571427,8,0.0,27,36,19,10,58,19,10,27,0,92,114,0
14062,131913,upRu9nrHp4NUCGUbqZPoDIFEKbWtFzvh,5Gyp41oLVo7Gg7vF4vpmggWP5MU70QO6,1,0,0,0,0,0,1,0,1,0.14285714285714285,1,0.0,0,0,0,0,0,0,0,1,0,0,1,1
14063,131916,lM0ucDVFeyYkJQk3xrGXENajqWkqmPdx,5Gyp41oLVo7Gg7vF4vpmggWP5MU70QO6,8,3,2,0,1,3,5,0,14,2.0,1,0.0,0,2,0,1,3,3,0,5,0,3,11,1
14064,131929,4NUGABfnQkRS9FoH90Vgnhdha4tRSmOB,5Gyp41oLVo7Gg7vF4vpmggWP5MU70QO6,7,6,4,0,3,0,2,0,15,2.142857142857143,2,0.0,0,4,0,3,6,0,0,2,0,7,8,1
14065,131948,nH0lkFol42tc1HdPy0iz2y4LpmqwxJvr,5Gyp41oLVo7Gg7vF4vpmggWP5MU70QO6,23,60,19,7,4,14,15,5,124,17.714285714285715,5,0.0,10,19,6,4,50,14,1,15,5,39,85,1
14066,131966,AK9AYLB4kIemtKYLZfiWKFUQw90dJSvG,5Gyp41oLVo7Gg7vF4vpmggWP5MU70QO6,1,0,0,0,0,0,1,0,1,0.14285714285714285,1,0.0,0,0,0,0,0,0,0,1,0,0,1,1
14067,131973,WDMP5c2Ubx8vVSFegA0mXeU23cYb0qCY,5Gyp41oLVo7Gg7vF4vpmggWP5MU70QO6,22,21,12,0,9,3,5,1,51,7.285714285714286,2,0.0,2,12,0,9,19,3,0,5,1,23,28,1
14068,131974,eeYgUeHIQERDYwF1mxwVIZYsVaVSgwlV,5Gyp41oLVo7Gg7vF4vpmggWP5MU70QO6,34,151,84,28,15,45,42,1,366,52.285714285714285,8,0.0,25,84,19,15,126,45,9,42,1,143,223,1
14069,131985,UvXzL0vUPrxaxHA5h9pxdKMGm9qnxElT,5Gyp41oLVo7Gg7vF4vpmggWP5MU70QO6,7,5,4,0,3,0,1,0,13,1.8571428571428572,1,0.0,0,4,0,3,5,0,0,1,0,7,6,1
14070,131988,SfvT6FHCLeajKH96s2LkoIO8YQ9sAqIE,5Gyp41oLVo7Gg7vF4vpmggWP5MU70QO6,10,4,4,7,2,0,9,0,26,3.7142857142857144,1,0.0,0,4,4,2,4,0,3,9,0,10,16,1
14071,131999,aPVDb4sNGwKLaY1hfU7JY9uA4JfVNNbx,5Gyp41oLVo7Gg7vF4vpmggWP5MU70QO6,9,3,2,0,2,0,6,1,14,2.0,1,0.0,0,2,0,2,3,0,0,6,1,4,10,1
14072,132016,hFtcfhyjjjBDieZaGgPB0PH2Awp8ntcE,5Gyp41oLVo7Gg7vF4vpmggWP5MU70QO6,4,4,0,0,0,0,3,0,7,1.0,2,0.0,0,0,0,0,4,0,0,3,0,0,7,1
14073,132051,bxybXAkYqJdxWDLSPlh74sjGoIJub8gI,5Gyp41oLVo7Gg7vF4vpmggWP5MU70QO6,20,45,29,15,12,26,21,2,150,21.428571428571427,4,0.0,6,29,11,12,39,26,4,21,2,58,92,1
14074,132072,lcxEu4F2dIRGolbGM8J7dkDro6hPXvBJ,5Gyp41oLVo7Gg7vF4vpmggWP5MU70QO6,10,12,7,0,3,0,6,0,28,4.0,4,0.0,1,7,0,3,11,0,0,6,0,11,17,1
14075,132073,PaukganhsE4s0igvkxOHXQMS87FhGsNK,5Gyp41oLVo7Gg7vF4vpmggWP5MU70QO6,5,3,1,0,1,0,3,0,8,1.1428571428571428,1,0.0,0,1,0,1,3,0,0,3,0,2,6,0
14076,132083,X4KSPkBIdPEeXdEy4Fa5NvixCQZdfNj3,5Gyp41oLVo7Gg7vF4vpmggWP5MU70QO6,9,16,8,0,2,0,7,0,33,4.714285714285714,5,0.0,0,8,0,2,16,0,0,7,0,10,23,1
14077,132085,feNPir78VVJeRswqjlWE2OxH2LDmYPpA,5Gyp41oLVo7Gg7vF4vpmggWP5MU70QO6,4,0,0,0,0,2,3,3,8,1.1428571428571428,1,0.0,0,0,0,0,0,2,0,3,3,0,8,1
14078,132107,EjwuVaTggwTtvS9pkP7PgQgHWsuSl5LH,5Gyp41oLVo7Gg7vF4vpmggWP5MU70QO6,16,23,13,7,8,3,14,2,70,10.0,2,0.0,4,13,6,8,19,3,1,14,2,31,39,1
14079,132119,kAQFM0dEgOQIxOG9jTMe5puRtNxZZWMN,5Gyp41oLVo7Gg7vF4vpmggWP5MU70QO6,14,21,10,14,2,0,2,0,49,7.0,2,0.0,9,10,9,2,12,0,5,2,0,30,19,1
14080,132120,vDpzh3zahVtaOFqzE17Za28Atm0h0iTn,5Gyp41oLVo7Gg7vF4vpmggWP5MU70QO6,5,2,1,0,1,0,3,0,7,1.0,1,0.0,0,1,0,1,2,0,0,3,0,2,5,1
14081,132127,DUlJiICKk2WTix9aZC2LySN8fBhR1R6j,5Gyp41oLVo7Gg7vF4vpmggWP5MU70QO6,7,4,1,0,1,0,3,1,10,1.4285714285714286,1,0.0,0,1,0,1,4,0,0,3,1,2,8,1
14082,132131,Ov1eEIsyiq4NpsQyBb4m5rDEEYvFdikk,5Gyp41oLVo7Gg7vF4vpmggWP5MU70QO6,7,3,2,0,2,0,2,0,9,1.2857142857142858,1,0.0,0,2,0,2,3,0,0,2,0,4,5,1
14083,132159,fA5v1LpeiBHoiljToqVDWTjlSPX5We7J,5Gyp41oLVo7Gg7vF4vpmggWP5MU70QO6,30,37,4,12,5,23,16,1,98,14.0,6,0.0,5,4,8,5,32,23,4,16,1,22,76,1
14084,132189,soWGR1SawLCzN6cibKKzyucjERyiqFtX,5Gyp41oLVo7Gg7vF4vpmggWP5MU70QO6,13,13,8,2,4,0,8,0,35,5.0,1,0.0,1,8,1,4,12,0,1,8,0,14,21,1
14085,132259,NBO0yNvnHWn0H2rwDHJWaDKXLarWBIxP,5Gyp41oLVo7Gg7vF4vpmggWP5MU70QO6,5,1,1,0,1,0,2,0,5,0.7142857142857143,1,0.0,0,1,0,1,1,0,0,2,0,2,3,1
14086,132267,y1wesbVvgs3ixRYIB7nEK595dCq4m0ql,5Gyp41oLVo7Gg7vF4vpmggWP5MU70QO6,14,13,7,10,4,0,5,0,39,5.571428571428571,2,0.0,2,7,6,4,11,0,4,5,0,19,20,1
14087,132293,8f874eWGU5uAHPVWKUx2IReY71ci0kSY,5Gyp41oLVo7Gg7vF4vpmggWP5MU70QO6,39,50,22,11,17,7,19,0,126,18.0,5,0.0,25,22,11,17,25,7,0,19,0,75,51,1
14088,132296,Gymn0DusIH3v58mQ2B78566w329hD5p0,5Gyp41oLVo7Gg7vF4vpmggWP5MU70QO6,1,0,0,0,0,0,1,0,1,0.14285714285714285,1,0.0,0,0,0,0,0,0,0,1,0,0,1,1
14089,132307,13YFV8lBcWdo0oc2jiupTdAnWOuzwYbw,5Gyp41oLVo7Gg7vF4vpmggWP5MU70QO6,21,43,23,4,13,4,12,1,100,14.285714285714286,4,0.0,10,23,2,13,33,4,2,12,1,48,52,1
14090,132320,mwLZNpLHscHAOslKyQsPop6UIX5aSty3,5Gyp41oLVo7Gg7vF4vpmggWP5MU70QO6,9,4,3,0,3,0,2,1,13,1.8571428571428572,1,0.0,0,3,0,3,4,0,0,2,1,6,7,1
14091,132332,boaUpp9caIOmNwHhM4OMeLQDu0K6DUm2,5Gyp41oLVo7Gg7vF4vpmggWP5MU70QO6,8,8,3,5,2,0,3,0,21,3.0,1,0.0,3,3,4,2,5,0,1,3,0,12,9,1
14092,132342,g7OVRMshhiJLWezGVm8ZCxzqx4keijVJ,5Gyp41oLVo7Gg7vF4vpmggWP5MU70QO6,6,6,4,0,3,0,1,0,14,2.0,1,0.0,0,4,0,3,6,0,0,1,0,7,7,1
14093,132346,wIXH3gEY2v8CIGUg8D6sapoHRbIUXs86,5Gyp41oLVo7Gg7vF4vpmggWP5MU70QO6,28,82,42,14,16,173,24,2,353,50.42857142857143,6,0.0,14,42,10,16,68,173,4,24,2,82,271,1
14094,132348,Z0qsyLcA97qhAjqLPteqkusKnVAgvbF3,5Gyp41oLVo7Gg7vF4vpmggWP5MU70QO6,1,0,0,0,0,0,1,0,1,0.14285714285714285,1,0.0,0,0,0,0,0,0,0,1,0,0,1,1
14095,132369,wyABPyRfC1DXsBWN1FdgxSykc7fuCErP,5Gyp41oLVo7Gg7vF4vpmggWP5MU70QO6,8,6,3,0,2,1,6,1,19,2.7142857142857144,1,0.0,0,3,0,2,6,1,0,6,1,5,14,1
14096,132376,PLNAK5eO2jDldFb2P1VVgW3GLNYSW1XE,5Gyp41oLVo7Gg7vF4vpmggWP5MU70QO6,12,14,7,3,4,0,4,0,32,4.571428571428571,2,0.0,4,7,2,4,10,0,1,4,0,17,15,1
14097,132381,COy3W6Fm6ztNo7BoqXC77wJ3dpy0Idid,5Gyp41oLVo7Gg7vF4vpmggWP5MU70QO6,8,12,4,2,1,0,2,0,21,3.0,1,0.0,4,4,1,1,8,0,1,2,0,10,11,1
14098,132384,ihhIt4g3pf3Wao2zD7aziRWPnxuXhNfE,5Gyp41oLVo7Gg7vF4vpmggWP5MU70QO6,34,79,33,30,22,38,9,1,212,30.285714285714285,6,0.0,15,33,20,22,64,38,10,9,1,90,122,0
14099,132414,MoJEcZ3PrCXcO0CYW48XDV0zGeC8vGWI,5Gyp41oLVo7Gg7vF4vpmggWP5MU70QO6,32,113,8,14,7,5,20,2,169,24.142857142857142,7,0.0,21,8,11,7,92,5,3,20,2,47,122,1
14100,132426,XyMejM5OpRE6Mj05vo1mbZJVHgqqS3OY,5Gyp41oLVo7Gg7vF4vpmggWP5MU70QO6,1,0,0,0,0,0,1,0,1,0.14285714285714285,1,0.0,0,0,0,0,0,0,0,1,0,0,1,1
14101,132439,oBAEbwlQUsjw2fhD7RK0N1KBBvDbCzDf,5Gyp41oLVo7Gg7vF4vpmggWP5MU70QO6,8,4,2,0,1,4,10,0,21,3.0,2,0.0,0,2,0,1,4,4,0,10,0,3,18,1
14102,132444,jeDT3XKbaVhjSKMN8tSVhrU0lh7ai1Yw,5Gyp41oLVo7Gg7vF4vpmggWP5MU70QO6,2,0,0,0,0,0,3,0,3,0.42857142857142855,2,0.0,0,0,0,0,0,0,0,3,0,0,3,0
14103,132454,Hmn8w69KzIe3R3h44o7VyFC01BFXwK3X,5Gyp41oLVo7Gg7vF4vpmggWP5MU70QO6,8,2,1,0,1,1,7,1,13,1.8571428571428572,3,0.0,0,1,0,1,2,1,0,7,1,2,11,1
14104,132465,e0buQlxlHVWdQd03EOAehldJOI8AeFTm,5Gyp41oLVo7Gg7vF4vpmggWP5MU70QO6,25,78,41,30,19,5,26,0,199,28.428571428571427,7,0.0,18,41,22,19,60,5,8,26,0,100,99,1
14105,132469,Z5YirzjAdjPmLoyQV4PkNolvIfTj8EgX,5Gyp41oLVo7Gg7vF4vpmggWP5MU70QO6,6,3,2,0,1,1,3,0,10,1.4285714285714286,1,0.0,0,2,0,1,3,1,0,3,0,3,7,1
14106,132478,2CgYcmO1GACt32FxJPjz0SBU8VVHrh2b,5Gyp41oLVo7Gg7vF4vpmggWP5MU70QO6,6,9,4,0,0,0,4,0,17,2.4285714285714284,1,0.0,4,4,0,0,5,0,0,4,0,8,9,1
14107,132480,a6IXAisoGYVGIG3yaQVHn4K8Qt4RkLGp,5Gyp41oLVo7Gg7vF4vpmggWP5MU70QO6,10,15,6,0,2,1,5,0,29,4.142857142857143,3,0.0,2,6,0,2,13,1,0,5,0,10,19,1
14108,132495,I9yi1jZjIznCPzP5fpMJEhPDMiUaetUu,5Gyp41oLVo7Gg7vF4vpmggWP5MU70QO6,7,9,4,0,3,0,1,0,17,2.4285714285714284,1,0.0,0,4,0,3,9,0,0,1,0,7,10,1
14109,132503,G7nmaHMm6kY7xtLIEqr8hTV81gk3z57q,5Gyp41oLVo7Gg7vF4vpmggWP5MU70QO6,1,0,0,0,0,0,1,0,1,0.14285714285714285,1,0.0,0,0,0,0,0,0,0,1,0,0,1,1
14110,132504,xe2wzMhAvNNl4WFLalDysto0z3MkK9cl,5Gyp41oLVo7Gg7vF4vpmggWP5MU70QO6,26,74,5,23,13,64,19,3,201,28.714285714285715,5,0.0,15,5,16,13,59,64,7,19,3,49,152,1
14111,132538,eDSND9aVmxhnZJa0kERwiyCA50eVabzR,5Gyp41oLVo7Gg7vF4vpmggWP5MU70QO6,1,0,0,0,0,0,1,0,1,0.14285714285714285,1,0.0,0,0,0,0,0,0,0,1,0,0,1,1
14112,132555,5OFklK90Prgvd0eqyybyLqlp4DdBRTP2,5Gyp41oLVo7Gg7vF4vpmggWP5MU70QO6,8,12,6,0,3,0,4,0,25,3.5714285714285716,3,0.0,0,6,0,3,12,0,0,4,0,9,16,1
14113,132559,y9wPfGAwhUyEzMcLzeImEmShSOKx49Im,5Gyp41oLVo7Gg7vF4vpmggWP5MU70QO6,11,5,5,0,4,0,10,0,24,3.4285714285714284,2,0.0,0,5,0,4,5,0,0,10,0,9,15,1
14114,132576,3nvYm1DKrH5EOHAw44wBVldk53PpV7TA,5Gyp41oLVo7Gg7vF4vpmggWP5MU70QO6,22,57,33,0,14,13,15,0,132,18.857142857142858,6,0.0,11,33,0,14,46,13,0,15,0,58,74,1
14115,132613,7cXmolpTFQKnmQzgabjXZRbBMU6zPryU,5Gyp41oLVo7Gg7vF4vpmggWP5MU70QO6,17,14,11,3,2,2,5,1,38,5.428571428571429,2,0.0,1,11,2,2,13,2,1,5,1,16,22,1
14116,132632,pdbjkshNkCdKgKlb65eT3NLGorQmQAKA,5Gyp41oLVo7Gg7vF4vpmggWP5MU70QO6,10,9,6,0,4,0,9,0,28,4.0,1,0.0,0,6,0,4,9,0,0,9,0,10,18,1
14117,132640,DKe2GInb7SCNSrksG80cnhQaLYFATj0E,5Gyp41oLVo7Gg7vF4vpmggWP5MU70QO6,1,0,0,0,0,0,1,0,1,0.14285714285714285,1,0.0,0,0,0,0,0,0,0,1,0,0,1,1
14118,132655,9wYwWdPqN0SRbLcrBzTUv3Vt4Ozm2cqW,5Gyp41oLVo7Gg7vF4vpmggWP5MU70QO6,9,8,1,0,3,1,4,1,18,2.5714285714285716,1,0.0,3,1,0,3,5,1,0,4,1,7,11,1
14119,132683,XCEK2se7opoV7sjn5cmHSo7CvzSkKYlL,5Gyp41oLVo7Gg7vF4vpmggWP5MU70QO6,7,4,3,0,3,0,1,0,11,1.5714285714285714,1,0.0,0,3,0,3,4,0,0,1,0,6,5,1
14120,132692,IFqWOl32JJm0W3Ap2jxVCpJeXeLJlYDp,5Gyp41oLVo7Gg7vF4vpmggWP5MU70QO6,12,12,6,3,3,0,5,0,29,4.142857142857143,2,0.0,4,6,2,3,8,0,1,5,0,15,14,1
14121,132704,JXMSZBKSTDpEGXqmHuCDSmsA3kQYV2pH,5Gyp41oLVo7Gg7vF4vpmggWP5MU70QO6,1,0,0,0,0,0,2,0,2,0.2857142857142857,2,0.0,0,0,0,0,0,0,0,2,0,0,2,1
14122,132705,sdrRyi3Bx383RXfkTMsh3u2wuJiBI99C,5Gyp41oLVo7Gg7vF4vpmggWP5MU70QO6,24,43,20,20,8,8,11,0,110,15.714285714285714,5,0.0,11,20,15,8,32,8,5,11,0,54,56,1
14123,132710,EucoLTT3NIODI51xT6HenetUBqP6oyOI,5Gyp41oLVo7Gg7vF4vpmggWP5MU70QO6,6,3,2,0,2,0,1,0,8,1.1428571428571428,1,0.0,0,2,0,2,3,0,0,1,0,4,4,1
14124,132732,BKs08mJzEBABTQ7q2m9CMbq8Ej6GEzZu,5Gyp41oLVo7Gg7vF4vpmggWP5MU70QO6,6,3,2,0,2,0,1,0,8,1.1428571428571428,1,0.0,0,2,0,2,3,0,0,1,0,4,4,1
14125,132745,WbVYlGFTP5qkuVvKMq8XhPYjGas87gaW,5Gyp41oLVo7Gg7vF4vpmggWP5MU70QO6,21,33,16,3,11,0,6,0,69,9.857142857142858,4,0.0,4,16,2,11,29,0,1,6,0,33,36,1
14126,132752,i2raPzmlvNePAOSFdEUwI0BA2bKyQ3vM,5Gyp41oLVo7Gg7vF4vpmggWP5MU70QO6,37,179,70,26,38,1,19,0,333,47.57142857142857,11,0.0,73,70,22,38,106,1,4,19,0,203,130,0
14127,132755,tlJNepTGGOi8ovF7QAiJxRkVTp4zYSeD,5Gyp41oLVo7Gg7vF4vpmggWP5MU70QO6,7,3,2,0,2,0,4,0,11,1.5714285714285714,1,0.0,0,2,0,2,3,0,0,4,0,4,7,1
14128,132759,cwg9sECm21xM465omHALHnZIByL0kCoG,5Gyp41oLVo7Gg7vF4vpmggWP5MU70QO6,19,17,10,13,6,0,2,0,48,6.857142857142857,2,0.0,5,10,11,6,12,0,2,2,0,32,16,0
14129,132770,rzUPX25qXPcUJGYbh6MkxuKJx5sbGl5q,5Gyp41oLVo7Gg7vF4vpmggWP5MU70QO6,10,6,4,1,2,0,4,0,17,2.4285714285714284,1,0.0,1,4,1,2,5,0,0,4,0,8,9,1
14130,132777,RFEAx8yelAgvfPsQekcPEQ1kwjrp5Mon,5Gyp41oLVo7Gg7vF4vpmggWP5MU70QO6,1,0,0,0,0,0,1,0,1,0.14285714285714285,1,0.0,0,0,0,0,0,0,0,1,0,0,1,1
14131,132782,1aSZZjNRIlSk2N1niFK67pvW5hrrFdOk,5Gyp41oLVo7Gg7vF4vpmggWP5MU70QO6,12,18,13,0,3,6,12,2,54,7.714285714285714,1,0.0,0,13,0,3,18,6,0,12,2,16,38,1
14132,132784,TOnSUH2TrhmaSVJBIvM0e6QZcFDQqMZg,5Gyp41oLVo7Gg7vF4vpmggWP5MU70QO6,22,48,28,2,17,30,20,5,150,21.428571428571427,3,0.0,10,28,2,17,38,30,0,20,5,57,93,1
14133,132787,5zmdkrLCsYposTlmADCtPSCtqJszOFSq,5Gyp41oLVo7Gg7vF4vpmggWP5MU70QO6,14,17,11,0,4,0,7,0,39,5.571428571428571,4,0.0,2,11,0,4,15,0,0,7,0,17,22,1
14134,132797,3DXpDmYAbqOTUiKxY44g8SjQwtTkd2rO,5Gyp41oLVo7Gg7vF4vpmggWP5MU70QO6,9,6,5,0,5,0,2,0,18,2.5714285714285716,1,0.0,0,5,0,5,6,0,0,2,0,10,8,1
14135,132806,bfDSQ3vzU9egOngeApVA2Og6CGBoeEWY,5Gyp41oLVo7Gg7vF4vpmggWP5MU70QO6,1,0,0,0,0,0,1,0,1,0.14285714285714285,1,0.0,0,0,0,0,0,0,0,1,0,0,1,1
14136,132831,L9G46vSsgrMITbTbwTD9eVe8PZeEU8Bv,5Gyp41oLVo7Gg7vF4vpmggWP5MU70QO6,8,9,3,0,2,0,3,0,17,2.4285714285714284,2,0.0,0,3,0,2,9,0,0,3,0,5,12,1
14137,132837,KqGkK66L9Z01z5JYoEydzCtObtfYjG7x,5Gyp41oLVo7Gg7vF4vpmggWP5MU70QO6,3,2,0,0,0,0,1,0,3,0.42857142857142855,1,0.0,0,0,0,0,2,0,0,1,0,0,3,1
14138,132842,33YJhO56Hz6X3YkBaXAE8jLXj3hGQz0E,5Gyp41oLVo7Gg7vF4vpmggWP5MU70QO6,5,2,1,0,1,0,2,0,6,0.8571428571428571,1,0.0,0,1,0,1,2,0,0,2,0,2,4,1
14139,132856,gtomiUNdtGtruDBQ9M0mqdd1I3gHFwtw,5Gyp41oLVo7Gg7vF4vpmggWP5MU70QO6,18,14,7,12,4,3,6,1,47,6.714285714285714,1,0.0,6,7,9,4,8,3,3,6,1,26,21,1
14140,132872,dgf9B0BYXZoUUDCON0UDpcT22L2RlQ7g,5Gyp41oLVo7Gg7vF4vpmggWP5MU70QO6,1,0,0,0,0,0,1,0,1,0.14285714285714285,1,0.0,0,0,0,0,0,0,0,1,0,0,1,1
14141,132885,J7OzjvXIyBcNlAU0cMqVwzttWM9JdrwO,5Gyp41oLVo7Gg7vF4vpmggWP5MU70QO6,7,3,2,0,2,0,2,0,9,1.2857142857142858,1,0.0,0,2,0,2,3,0,0,2,0,4,5,1
14142,132913,vVntTx7SVuGrQLeVI9sXms04tE061UAW,5Gyp41oLVo7Gg7vF4vpmggWP5MU70QO6,35,47,4,17,13,6,6,1,94,13.428571428571429,3,0.0,21,4,12,13,26,6,5,6,1,50,44,1
14143,132919,0IX1Oa0Z1GaXCaGzOOt47o06NpYNVkTP,5Gyp41oLVo7Gg7vF4vpmggWP5MU70QO6,9,7,3,2,2,0,2,0,16,2.2857142857142856,1,0.0,3,3,1,2,4,0,1,2,0,9,7,1
14144,132935,Ys5FH0nq7NeLEdwGoDUOp7Sz8iAMAB3d,5Gyp41oLVo7Gg7vF4vpmggWP5MU70QO6,6,3,1,0,1,0,3,0,8,1.1428571428571428,1,0.0,0,1,0,1,3,0,0,3,0,2,6,1
14145,132941,gGPwEyB8WM9RKY8d6MZCxjfZZkbEQNgr,5Gyp41oLVo7Gg7vF4vpmggWP5MU70QO6,14,16,11,0,7,0,9,0,43,6.142857142857143,3,0.0,0,11,0,7,16,0,0,9,0,18,25,1
14146,132982,Pbr5aSJDI6hWVSe2mgnpvht08jTDxoyv,5Gyp41oLVo7Gg7vF4vpmggWP5MU70QO6,5,2,1,0,1,0,3,0,7,1.0,1,0.0,0,1,0,1,2,0,0,3,0,2,5,1
14147,133006,neYnRDZzxRsfSqQHzFDdOdC9LxuGvJCl,5Gyp41oLVo7Gg7vF4vpmggWP5MU70QO6,1,0,0,0,0,0,2,0,2,0.2857142857142857,2,0.0,0,0,0,0,0,0,0,2,0,0,2,1
14148,133017,Zu0u723RoHXT6Cndj96vNOQ1emcUEK1a,5Gyp41oLVo7Gg7vF4vpmggWP5MU70QO6,10,10,4,0,3,0,3,1,21,3.0,1,0.0,2,4,0,3,8,0,0,3,1,9,12,1
14149,133022,ncT8oGxKTMRqVxe3XEF5xOrCySGYuHpk,5Gyp41oLVo7Gg7vF4vpmggWP5MU70QO6,15,22,12,4,6,0,4,0,48,6.857142857142857,3,0.0,7,12,2,6,15,0,2,4,0,27,21,1
14150,133029,70BNVptBNpsHI5UYkAWorZh5hHHXwEl0,5Gyp41oLVo7Gg7vF4vpmggWP5MU70QO6,14,13,6,3,5,0,5,0,32,4.571428571428571,2,0.0,5,6,2,5,8,0,1,5,0,18,14,1
14151,133044,BoMrnaRzWiLLbhZUihKQP6MURkcvYuJ9,5Gyp41oLVo7Gg7vF4vpmggWP5MU70QO6,3,0,0,0,0,1,7,0,8,1.1428571428571428,4,0.0,0,0,0,0,0,1,0,7,0,0,8,1
14152,133046,2AJqZ8dhClk5ETxstQ75PSPxn4v3KOvQ,5Gyp41oLVo7Gg7vF4vpmggWP5MU70QO6,7,2,1,0,2,0,3,0,8,1.1428571428571428,1,0.0,1,1,0,2,1,0,0,3,0,4,4,1
14153,133053,5IM8g7YMOYo5qH7Yu3x31T3JkVOH9iqe,5Gyp41oLVo7Gg7vF4vpmggWP5MU70QO6,20,39,16,1,12,22,12,1,103,14.714285714285714,5,0.0,11,16,1,12,28,22,0,12,1,40,63,1
14154,133070,SXGSrK93LJViX1VmVZVCFkMLdrBoNCvI,5Gyp41oLVo7Gg7vF4vpmggWP5MU70QO6,46,113,45,35,25,41,19,1,279,39.857142857142854,11,0.0,39,45,24,25,74,41,11,19,1,133,146,0
14155,133076,osCj80dZl2wGSeLT3ksGLNRaqvjByuJ9,5Gyp41oLVo7Gg7vF4vpmggWP5MU70QO6,23,37,20,16,11,1,10,1,96,13.714285714285714,6,0.0,10,20,11,11,27,1,5,10,1,52,44,1
14156,133091,96mXDEHAys0u0Plnb32C3zUTsAT5Tkkd,5Gyp41oLVo7Gg7vF4vpmggWP5MU70QO6,1,0,0,0,0,0,1,0,1,0.14285714285714285,1,0.0,0,0,0,0,0,0,0,1,0,0,1,1
14157,133126,duArRwhYpB9eHlRx5aAqkissf3ZxaFK5,5Gyp41oLVo7Gg7vF4vpmggWP5MU70QO6,10,10,7,0,5,0,4,0,26,3.7142857142857144,3,0.0,0,7,0,5,10,0,0,4,0,12,14,1
14158,133145,AzNGxLM19O89VQy66cmgkZxDbMxjrAs3,5Gyp41oLVo7Gg7vF4vpmggWP5MU70QO6,12,18,13,0,7,0,4,0,42,6.0,3,0.0,1,13,0,7,17,0,0,4,0,21,21,1
14159,133183,S4NxvJQGwl4G80TxSJ4cMwHKt8lPSR9p,5Gyp41oLVo7Gg7vF4vpmggWP5MU70QO6,19,34,14,6,3,13,13,4,87,12.428571428571429,4,0.0,7,14,3,3,27,13,3,13,4,27,60,0
14160,133185,lz9DwlpT70vEt7hSzkBDHhnuPOjihC36,5Gyp41oLVo7Gg7vF4vpmggWP5MU70QO6,4,1,1,0,0,0,2,0,4,0.5714285714285714,1,0.0,0,1,0,0,1,0,0,2,0,1,3,1
14161,133186,guIKxJFMsPEjbbc4jx25pWEGKtRIqgdA,5Gyp41oLVo7Gg7vF4vpmggWP5MU70QO6,7,4,2,0,2,0,5,0,13,1.8571428571428572,1,0.0,0,2,0,2,4,0,0,5,0,4,9,1
14162,133189,RQljJaGUuH5OcYT8gaJW7964lbgNyY1n,5Gyp41oLVo7Gg7vF4vpmggWP5MU70QO6,1,0,0,0,0,0,1,0,1,0.14285714285714285,1,0.0,0,0,0,0,0,0,0,1,0,0,1,1
14163,133196,BJqHNXVOuknKXVN8kWe148UD34ryhX5w,5Gyp41oLVo7Gg7vF4vpmggWP5MU70QO6,7,4,3,0,2,0,5,0,14,2.0,1,0.0,0,3,0,2,4,0,0,5,0,5,9,1
14164,133199,s1rtWkZP0wFdJ0WRHT6EwX3hwc8p3Aeo,5Gyp41oLVo7Gg7vF4vpmggWP5MU70QO6,5,2,1,0,1,0,2,0,6,0.8571428571428571,1,0.0,0,1,0,1,2,0,0,2,0,2,4,1
14165,133216,VsOc7LofXdwwVmICgpVVycvv0BQ41l3j,5Gyp41oLVo7Gg7vF4vpmggWP5MU70QO6,6,3,2,0,1,0,3,0,9,1.2857142857142858,1,0.0,0,2,0,1,3,0,0,3,0,3,6,1
14166,133240,1KWD8U2yUGemNG4lzmFiXTuBlY4jZcCK,5Gyp41oLVo7Gg7vF4vpmggWP5MU70QO6,19,31,17,5,10,14,6,0,83,11.857142857142858,3,0.0,10,17,3,10,21,14,2,6,0,40,43,0
14167,133241,a2e4h32rsnosgvoyI4da4dlx7oen7sJh,5Gyp41oLVo7Gg7vF4vpmggWP5MU70QO6,8,6,3,0,2,1,3,0,15,2.142857142857143,1,0.0,0,3,0,2,6,1,0,3,0,5,10,1
14168,133257,PVencLbfncSD8xfkLux19f8VCbg1K15h,5Gyp41oLVo7Gg7vF4vpmggWP5MU70QO6,12,26,3,4,4,0,4,0,41,5.857142857142857,3,0.0,7,3,2,4,19,0,2,4,0,16,25,0
14169,133262,rmqyFhovBvZJEPGr9dvTmnCKigZvYxPu,5Gyp41oLVo7Gg7vF4vpmggWP5MU70QO6,1,0,0,0,0,0,1,0,1,0.14285714285714285,1,0.0,0,0,0,0,0,0,0,1,0,0,1,1
14170,133289,mboXYgGduGMfQoUGFBNUe8XD9mw4Jyzk,5Gyp41oLVo7Gg7vF4vpmggWP5MU70QO6,2,0,0,0,0,0,3,0,3,0.42857142857142855,1,0.0,0,0,0,0,0,0,0,3,0,0,3,1
14171,133300,Vvmg4GFkxtES0j2sr2rm1vhisTqz0hYp,5Gyp41oLVo7Gg7vF4vpmggWP5MU70QO6,11,11,5,0,3,0,4,0,23,3.2857142857142856,2,0.0,0,5,0,3,11,0,0,4,0,8,15,0
14172,133302,7Brc0TESybTvrmuCCvDaRZ4xaX6BgLau,5Gyp41oLVo7Gg7vF4vpmggWP5MU70QO6,12,10,5,7,3,0,3,0,28,4.0,2,0.0,3,5,4,3,7,0,3,3,0,15,13,1
14173,133324,Gur5FuhE9EyV9K1F0qLPk7AenhoY8PBS,5Gyp41oLVo7Gg7vF4vpmggWP5MU70QO6,18,39,20,4,3,6,22,0,94,13.428571428571429,5,0.0,6,20,2,3,33,6,2,22,0,31,63,1
14174,133343,NxkkVgqpWSpGsLHJn72gpt4C1PtUl4UQ,5Gyp41oLVo7Gg7vF4vpmggWP5MU70QO6,26,30,17,0,11,0,9,0,67,9.571428571428571,5,0.0,6,17,0,11,24,0,0,9,0,34,33,1
14175,133376,ecYwOKQaqCwKgwjlBCREC5ekFPF9vGst,5Gyp41oLVo7Gg7vF4vpmggWP5MU70QO6,1,0,0,0,0,0,2,0,2,0.2857142857142857,1,0.0,0,0,0,0,0,0,0,2,0,0,2,1
14176,133383,LSCXX4w5IiPx7aQ4wmkLZzZogMkFC4va,5Gyp41oLVo7Gg7vF4vpmggWP5MU70QO6,5,3,2,0,2,0,2,0,9,1.2857142857142858,1,0.0,0,2,0,2,3,0,0,2,0,4,5,1
14177,133395,vORvIVYHwKmymVFgzFhz48csezUlt7Kh,5Gyp41oLVo7Gg7vF4vpmggWP5MU70QO6,21,17,11,10,5,0,5,0,48,6.857142857142857,3,0.0,2,11,8,5,15,0,2,5,0,26,22,1
14178,133396,5Tx0aoNMgZmEMBl0k1hFtw0VwO1vqb6n,5Gyp41oLVo7Gg7vF4vpmggWP5MU70QO6,6,3,1,0,2,0,2,0,8,1.1428571428571428,1,0.0,0,1,0,2,3,0,0,2,0,3,5,1
14179,133465,mYSYq9VbEBBIvljygNQmWRgpoWM9p7zq,5Gyp41oLVo7Gg7vF4vpmggWP5MU70QO6,1,0,0,0,0,0,1,0,1,0.14285714285714285,1,0.0,0,0,0,0,0,0,0,1,0,0,1,1
14180,133476,Cf7GCeUZzG7WjvUIyGfwv9hfcwXPVq5G,5Gyp41oLVo7Gg7vF4vpmggWP5MU70QO6,15,13,7,14,3,0,3,0,40,5.714285714285714,1,0.0,4,7,9,3,9,0,5,3,0,23,17,1
14181,133482,v14lvx2kJvNWvCMFJ7Bx2ipE0ptO51OZ,5Gyp41oLVo7Gg7vF4vpmggWP5MU70QO6,1,0,0,0,0,0,2,0,2,0.2857142857142857,1,0.0,0,0,0,0,0,0,0,2,0,0,2,1
14182,133488,CpEqJ8Pou1Ow1oK9IZkd7yTmxIxi54B4,5Gyp41oLVo7Gg7vF4vpmggWP5MU70QO6,8,5,2,7,2,0,1,0,17,2.4285714285714284,1,0.0,1,2,5,2,4,0,2,1,0,10,7,1
14183,133492,yesikXRZpFYEGoXWRi2rEHboJsFyCCGG,5Gyp41oLVo7Gg7vF4vpmggWP5MU70QO6,12,15,7,0,7,18,9,0,56,8.0,4,0.0,2,7,0,7,13,18,0,9,0,16,40,1
14184,133497,69S4nSU8gofOvk1eb5h4gjGkayN6QGSb,5Gyp41oLVo7Gg7vF4vpmggWP5MU70QO6,13,22,2,6,8,0,5,0,43,6.142857142857143,2,0.0,8,2,5,8,14,0,1,5,0,23,20,1
14185,133502,y4C09JELGArMkj7EYnAM5VIhmCekYYoO,5Gyp41oLVo7Gg7vF4vpmggWP5MU70QO6,5,6,0,0,0,0,2,0,8,1.1428571428571428,1,0.0,0,0,0,0,6,0,0,2,0,0,8,1
14186,133510,MEAK3CtWNpeCicplOKHcDUkHm4e2Gnat,5Gyp41oLVo7Gg7vF4vpmggWP5MU70QO6,22,53,25,45,11,0,10,0,144,20.571428571428573,6,0.0,13,25,41,11,40,0,4,10,0,90,54,1
14187,133515,VK6VYsFJEy8hhWdKq52KmrJkO3b6jNbn,5Gyp41oLVo7Gg7vF4vpmggWP5MU70QO6,12,21,12,0,5,2,22,1,63,9.0,4,0.0,0,12,0,5,21,2,0,22,1,17,46,1
14188,133543,nr8Ko3wpWj615smFgIrRYqb9Gs4PawZh,5Gyp41oLVo7Gg7vF4vpmggWP5MU70QO6,1,0,0,0,0,0,1,0,1,0.14285714285714285,1,0.0,0,0,0,0,0,0,0,1,0,0,1,1
14189,133546,O4hHufjOTPLz1EGr9R9jzRFriheucazi,5Gyp41oLVo7Gg7vF4vpmggWP5MU70QO6,21,20,11,18,7,3,7,1,67,9.571428571428571,2,0.0,5,11,12,7,15,3,6,7,1,35,32,1
14190,133552,HKmx8shJ58SwVCIOfowOtDw2VVMie4AS,5Gyp41oLVo7Gg7vF4vpmggWP5MU70QO6,12,17,7,0,6,2,11,1,44,6.285714285714286,5,0.0,5,7,0,6,12,2,0,11,1,18,26,1
14191,133583,s3je4DygiZylT7jjrLByLhYZDcCgwIih,5Gyp41oLVo7Gg7vF4vpmggWP5MU70QO6,10,24,12,4,4,0,8,0,52,7.428571428571429,4,0.0,4,12,2,4,20,0,2,8,0,22,30,1
14192,133594,cySIPFLvl5v9LEAz5G5KYs1V5gt4cZXS,5Gyp41oLVo7Gg7vF4vpmggWP5MU70QO6,1,0,0,0,0,0,1,0,1,0.14285714285714285,1,0.0,0,0,0,0,0,0,0,1,0,0,1,1
14193,133610,IXJ5LEr8XgwhXJCbT31mpiUDsiLxwH0g,5Gyp41oLVo7Gg7vF4vpmggWP5MU70QO6,1,0,0,0,0,0,1,0,1,0.14285714285714285,1,0.0,0,0,0,0,0,0,0,1,0,0,1,1
14194,133646,lBljSQvIVCpw7S5SELQHg4JfMSTvCBRe,5Gyp41oLVo7Gg7vF4vpmggWP5MU70QO6,6,7,0,0,0,0,2,0,9,1.2857142857142858,1,0.0,0,0,0,0,7,0,0,2,0,0,9,1
14195,133660,Dgvs4YDwVqKDTJra6xmfhYYyJ0YPsggo,5Gyp41oLVo7Gg7vF4vpmggWP5MU70QO6,11,6,4,0,3,0,3,0,16,2.2857142857142856,1,0.0,1,4,0,3,5,0,0,3,0,8,8,1
14196,133702,ZNBGAlJve4TYJ3FcDlTLBdyuklADldDZ,5Gyp41oLVo7Gg7vF4vpmggWP5MU70QO6,16,28,2,8,6,20,8,0,72,10.285714285714286,3,0.0,5,2,6,6,23,20,2,8,0,19,53,0
14197,133735,P9N4rDQUrFgLSulNcNTOV1uQ40rNPLNy,5Gyp41oLVo7Gg7vF4vpmggWP5MU70QO6,8,8,3,0,2,0,4,0,17,2.4285714285714284,1,0.0,0,3,0,2,8,0,0,4,0,5,12,0
14198,133744,kuzbMxcePL2szeInnouQIyDbUEq9uTMT,5Gyp41oLVo7Gg7vF4vpmggWP5MU70QO6,7,11,7,0,6,0,2,0,26,3.7142857142857144,2,0.0,0,7,0,6,11,0,0,2,0,13,13,1
14199,133771,DRObiunnWxzOw4DFCmzC7BYQDKFtF4cJ,5Gyp41oLVo7Gg7vF4vpmggWP5MU70QO6,9,7,3,4,2,0,2,0,18,2.5714285714285716,1,0.0,3,3,2,2,4,0,2,2,0,10,8,1
14200,133787,4SbF4DhXcYorYYyJ4XmwwPJZFVh1ZUhY,5Gyp41oLVo7Gg7vF4vpmggWP5MU70QO6,13,9,4,16,3,0,5,0,37,5.285714285714286,1,0.0,5,4,10,3,4,0,6,5,0,22,15,1
14201,133803,GSB0EWv7FMXRgg8fUNIQCJ36j91yg7BA,5Gyp41oLVo7Gg7vF4vpmggWP5MU70QO6,28,106,50,26,17,0,25,0,224,32.0,5,0.0,41,50,20,17,65,0,6,25,0,128,96,1
14202,133808,UxYzELvK2KxlL0hD5kxKSPxIBAFCdRLe,5Gyp41oLVo7Gg7vF4vpmggWP5MU70QO6,8,7,1,1,1,1,3,0,14,2.0,2,0.0,1,1,1,1,6,1,0,3,0,4,10,1
14203,133819,YJfKWA2kqHzjYEc66kIYvrpFxvk8Xk9m,5Gyp41oLVo7Gg7vF4vpmggWP5MU70QO6,8,9,4,3,2,0,1,0,19,2.7142857142857144,1,0.0,4,4,2,2,5,0,1,1,0,12,7,1
14204,133825,35tyNa3GqEtWUet4hkv2004bwls7oKD6,5Gyp41oLVo7Gg7vF4vpmggWP5MU70QO6,8,6,4,0,3,0,3,0,16,2.2857142857142856,2,0.0,0,4,0,3,6,0,0,3,0,7,9,1
14205,133827,vha1HcyvkfVseQManTnYSL3gu0khzZZB,5Gyp41oLVo7Gg7vF4vpmggWP5MU70QO6,34,60,30,37,14,17,25,5,188,26.857142857142858,5,0.0,16,30,29,14,44,17,8,25,5,89,99,0
14206,133848,yHOVQ8LEFZiQRD5Quj5Ct86OqEMEwTme,5Gyp41oLVo7Gg7vF4vpmggWP5MU70QO6,1,0,0,0,0,0,1,0,1,0.14285714285714285,1,0.0,0,0,0,0,0,0,0,1,0,0,1,1
14207,133869,vMOdVeqb266f21sYdhxbN4Shplb3TDGL,5Gyp41oLVo7Gg7vF4vpmggWP5MU70QO6,13,23,11,0,4,4,16,4,62,8.857142857142858,1,0.0,1,11,0,4,22,4,0,16,4,16,46,1
14208,133885,JLpYHpRsamf04qcVxCPYwLYYhT8v6H5r,5Gyp41oLVo7Gg7vF4vpmggWP5MU70QO6,7,4,2,0,2,0,2,0,10,1.4285714285714286,1,0.0,0,2,0,2,4,0,0,2,0,4,6,1
14209,133899,K7f4rbkZ4zpJXBwmVkXYyusOfW3d659K,5Gyp41oLVo7Gg7vF4vpmggWP5MU70QO6,1,0,0,0,0,0,1,0,1,0.14285714285714285,1,0.0,0,0,0,0,0,0,0,1,0,0,1,1
14210,133913,9OIml0SV4dEAJAFAwgEIKnYzkcxrQvU3,5Gyp41oLVo7Gg7vF4vpmggWP5MU70QO6,4,4,1,0,0,0,2,0,7,1.0,1,0.0,0,1,0,0,4,0,0,2,0,1,6,1
14211,133929,JZ8D07WpMQUIA2O2a3f2Q2gV7h70rqbC,5Gyp41oLVo7Gg7vF4vpmggWP5MU70QO6,4,2,1,0,1,0,1,0,5,0.7142857142857143,1,0.0,0,1,0,1,2,0,0,1,0,2,3,1
14212,133933,futHw5ylJYoore6oNuefdx05Xc1Es6E8,5Gyp41oLVo7Gg7vF4vpmggWP5MU70QO6,1,0,0,0,0,0,1,0,1,0.14285714285714285,1,0.0,0,0,0,0,0,0,0,1,0,0,1,1
14213,133939,TjArGeWj61CTlQRH6nS7DOeQFdhZwaVR,5Gyp41oLVo7Gg7vF4vpmggWP5MU70QO6,6,3,2,0,2,0,4,0,11,1.5714285714285714,1,0.0,0,2,0,2,3,0,0,4,0,4,7,1
14214,133942,g2zZYnTJ1Pk3cSjsVP5SH4UjJdsbDJv7,5Gyp41oLVo7Gg7vF4vpmggWP5MU70QO6,1,0,0,0,0,0,1,0,1,0.14285714285714285,1,0.0,0,0,0,0,0,0,0,1,0,0,1,1
14215,133954,9EnYFnK7dRrx23JecbRusbUbJedxJQqT,5Gyp41oLVo7Gg7vF4vpmggWP5MU70QO6,24,49,24,26,9,0,13,1,122,17.428571428571427,4,0.0,13,24,21,9,36,0,5,13,1,67,55,0
14216,133966,r70Wv7ehGphM0ksJO1rywGbRYud5AcSJ,5Gyp41oLVo7Gg7vF4vpmggWP5MU70QO6,6,3,2,0,2,0,1,0,8,1.1428571428571428,1,0.0,0,2,0,2,3,0,0,1,0,4,4,1
14217,133998,JjpjetsHT42uLapLy1HEIH9jFdBHozD9,5Gyp41oLVo7Gg7vF4vpmggWP5MU70QO6,1,0,0,0,0,0,1,0,1,0.14285714285714285,1,0.0,0,0,0,0,0,0,0,1,0,0,1,1
14218,134005,ef7qnYFsdVxa96TdDzGizm7tXmxq7QDV,5Gyp41oLVo7Gg7vF4vpmggWP5MU70QO6,7,4,3,0,3,3,5,0,18,2.5714285714285716,1,0.0,0,3,0,3,4,3,0,5,0,6,12,1
14219,134061,a5EgdVQip8RR2HL5bCBPhAmfK1Tiw2TB,5Gyp41oLVo7Gg7vF4vpmggWP5MU70QO6,1,0,0,0,0,0,2,0,2,0.2857142857142857,1,0.0,0,0,0,0,0,0,0,2,0,0,2,1
14220,134063,isREfnusXioFlXK1R4tw2vT4IosRAXVA,5Gyp41oLVo7Gg7vF4vpmggWP5MU70QO6,10,22,10,0,5,1,10,0,48,6.857142857142857,5,0.0,0,10,0,5,22,1,0,10,0,15,33,1
14221,134073,iQzOW09s8hoh4dOTNTFxheAs18Dipz15,5Gyp41oLVo7Gg7vF4vpmggWP5MU70QO6,11,10,5,0,3,6,2,0,26,3.7142857142857144,1,0.0,4,5,0,3,6,6,0,2,0,12,14,1
14222,134089,5RFOQWsY9ZOa18PmIgdopEz8uvDZD4Cc,5Gyp41oLVo7Gg7vF4vpmggWP5MU70QO6,3,0,0,0,0,0,4,0,4,0.5714285714285714,1,0.0,0,0,0,0,0,0,0,4,0,0,4,1
14223,134107,p4aS553VfWGCl0Q8nrggvjySuakRRXPS,5Gyp41oLVo7Gg7vF4vpmggWP5MU70QO6,5,5,2,0,1,0,1,0,9,1.2857142857142858,1,0.0,2,2,0,1,3,0,0,1,0,5,4,1
14224,134110,CGMPF3X0YeZx8JgQgP1MF0k04hmYnEFe,5Gyp41oLVo7Gg7vF4vpmggWP5MU70QO6,7,11,6,0,0,0,7,0,24,3.4285714285714284,1,0.0,2,6,0,0,9,0,0,7,0,8,16,1
14225,134111,sT7d9Rzd07OMXHp343L0wLrLWjqRYw9F,5Gyp41oLVo7Gg7vF4vpmggWP5MU70QO6,6,4,2,0,2,0,3,0,11,1.5714285714285714,1,0.0,0,2,0,2,4,0,0,3,0,4,7,1
14226,134112,QRSg0Qjo8G9M9eRRghKUMjmMUZEnxHCH,5Gyp41oLVo7Gg7vF4vpmggWP5MU70QO6,6,3,0,0,2,0,1,0,6,0.8571428571428571,1,0.0,0,0,0,2,3,0,0,1,0,2,4,1
14227,134121,BrLXDuvoA4KsM1lobMNSSKoqo46bH2gE,5Gyp41oLVo7Gg7vF4vpmggWP5MU70QO6,6,1,1,0,1,0,8,0,11,1.5714285714285714,1,0.0,0,1,0,1,1,0,0,8,0,2,9,1
14228,134123,Ayc6WctI6Dznkhzc1RhvbHOs7QGAiu2D,5Gyp41oLVo7Gg7vF4vpmggWP5MU70QO6,8,5,4,0,4,3,17,10,43,6.142857142857143,2,0.0,0,4,0,4,5,3,0,17,10,8,35,1
14229,134141,vsJnnbOJbRiDeSpDiIwKNu51zxudWq74,5Gyp41oLVo7Gg7vF4vpmggWP5MU70QO6,1,0,0,0,0,0,1,0,1,0.14285714285714285,1,0.0,0,0,0,0,0,0,0,1,0,0,1,1
14230,134153,qy4bKhXqNBlINsljPVNLHwKIsvlS56JE,5Gyp41oLVo7Gg7vF4vpmggWP5MU70QO6,9,15,9,0,3,2,3,0,32,4.571428571428571,3,0.0,2,9,0,3,13,2,0,3,0,14,18,1
14231,134159,ZuaBm8fqMnxcUDIovpFi3BOp4vzgmLMv,5Gyp41oLVo7Gg7vF4vpmggWP5MU70QO6,7,3,2,0,2,0,2,0,9,1.2857142857142858,1,0.0,0,2,0,2,3,0,0,2,0,4,5,1
14232,134163,eZwtgHeQ7iT718LkBUaEsaXSh6hqAR2J,5Gyp41oLVo7Gg7vF4vpmggWP5MU70QO6,44,86,55,39,25,1,15,0,221,31.571428571428573,5,0.0,22,55,30,25,64,1,9,15,0,132,89,1
14233,134176,5uSodITNhVNpn93ZRNQ5nXSTBs8A9EDI,5Gyp41oLVo7Gg7vF4vpmggWP5MU70QO6,3,1,0,0,0,0,3,0,4,0.5714285714285714,1,0.0,0,0,0,0,1,0,0,3,0,0,4,1
14234,134180,2Bk5pVNjcJmG3piHcBPqqQpme5KIQCyZ,5Gyp41oLVo7Gg7vF4vpmggWP5MU70QO6,18,25,3,10,7,6,11,3,65,9.285714285714286,2,0.0,8,3,7,7,17,6,3,11,3,25,40,0
14235,134217,wisu77b2OWghPT42ju4QbBWizBy4Q7oQ,5Gyp41oLVo7Gg7vF4vpmggWP5MU70QO6,5,2,1,0,1,0,3,0,7,1.0,1,0.0,0,1,0,1,2,0,0,3,0,2,5,1
14236,134223,KJSKTGAkJJbQ24c0Aas5HLuEGsIosbw0,5Gyp41oLVo7Gg7vF4vpmggWP5MU70QO6,5,5,2,0,1,0,1,0,9,1.2857142857142858,1,0.0,0,2,0,1,5,0,0,1,0,3,6,1
14237,134224,DIYlLDsIX3rRB00v33V6F050gdzNiYGy,5Gyp41oLVo7Gg7vF4vpmggWP5MU70QO6,12,17,9,10,1,6,8,0,51,7.285714285714286,3,0.0,1,9,9,1,16,6,1,8,0,20,31,0
14238,134229,qvtInMrLBR6bdvEzt6dQtEtd7Pst8guk,5Gyp41oLVo7Gg7vF4vpmggWP5MU70QO6,1,0,0,0,0,0,2,0,2,0.2857142857142857,1,0.0,0,0,0,0,0,0,0,2,0,0,2,1
14239,134243,Ik6D0zrdg6WujAdAQUUV98BKQ3zjot33,5Gyp41oLVo7Gg7vF4vpmggWP5MU70QO6,15,12,7,2,3,1,12,1,38,5.428571428571429,2,0.0,1,7,1,3,11,1,1,12,1,12,26,1
14240,134290,dKK9EC54YmH9aw327UmselD4tlPN3Fh0,5Gyp41oLVo7Gg7vF4vpmggWP5MU70QO6,8,5,3,0,2,0,6,0,16,2.2857142857142856,1,0.0,0,3,0,2,5,0,0,6,0,5,11,1
14241,134296,rVj6vxysUjIV1kazIkMsUDn3ShTXOA8U,5Gyp41oLVo7Gg7vF4vpmggWP5MU70QO6,9,9,5,5,3,0,2,0,24,3.4285714285714284,2,0.0,1,5,3,3,8,0,2,2,0,12,12,1
14242,134309,FjigfNfNTRUOLbUBoCZOEMnxdbNYqSu7,5Gyp41oLVo7Gg7vF4vpmggWP5MU70QO6,1,0,0,0,0,0,1,0,1,0.14285714285714285,1,0.0,0,0,0,0,0,0,0,1,0,0,1,1
14243,134313,uUBnxYTE9UFDvFQurPbYAVjLIr23a3oF,5Gyp41oLVo7Gg7vF4vpmggWP5MU70QO6,11,19,9,0,2,2,12,1,45,6.428571428571429,2,0.0,7,9,0,2,12,2,0,12,1,18,27,1
14244,134317,2Xae5QrypYMLnsnjtSIaxiiTzIgpb1cP,5Gyp41oLVo7Gg7vF4vpmggWP5MU70QO6,22,22,12,16,4,3,12,1,70,10.0,2,0.0,6,12,11,4,16,3,5,12,1,33,37,1
14245,134349,YdelRUsXSmnjTg0Jdl7PsPpHH4xM6sBq,5Gyp41oLVo7Gg7vF4vpmggWP5MU70QO6,1,0,0,0,0,0,1,0,1,0.14285714285714285,1,0.0,0,0,0,0,0,0,0,1,0,0,1,1
14246,134364,lAFgPHTj1eYoojG1m1Fl5TOLDGmxGFGh,5Gyp41oLVo7Gg7vF4vpmggWP5MU70QO6,34,35,27,0,14,5,17,0,98,14.0,4,0.0,2,27,0,14,33,5,0,17,0,43,55,1
14247,134367,zB8sR41xg78eDx4ZwTTw26heGRlLVk6e,5Gyp41oLVo7Gg7vF4vpmggWP5MU70QO6,7,3,2,0,2,0,2,0,9,1.2857142857142858,1,0.0,0,2,0,2,3,0,0,2,0,4,5,1
14248,134371,TP9y9Uxikn9UpXYIOqkrwZMtlujuZAde,5Gyp41oLVo7Gg7vF4vpmggWP5MU70QO6,1,0,0,0,0,0,1,0,1,0.14285714285714285,1,0.0,0,0,0,0,0,0,0,1,0,0,1,1
14249,134388,wMnlqrN8uEDEYbIAwvYIu8Ru2uKGahlk,5Gyp41oLVo7Gg7vF4vpmggWP5MU70QO6,19,32,14,11,7,11,8,1,84,12.0,3,0.0,10,14,8,7,22,11,3,8,1,39,45,1
14250,134394,wmwDf7eIRrKPL0l8cNmMygnEPd5vzoqs,5Gyp41oLVo7Gg7vF4vpmggWP5MU70QO6,11,12,4,0,5,0,6,4,31,4.428571428571429,3,0.0,1,4,0,5,11,0,0,6,4,10,21,1
14251,134431,1HV2FFOPqBW9aoRRKrPAZKUMTyRb8sfE,5Gyp41oLVo7Gg7vF4vpmggWP5MU70QO6,20,49,26,23,14,26,5,0,143,20.428571428571427,2,0.0,17,26,14,14,32,26,9,5,0,71,72,1
14252,134433,MgfuFMRy7QeKL6ytuXJ2JwURDgsSa0RX,5Gyp41oLVo7Gg7vF4vpmggWP5MU70QO6,8,11,2,0,2,1,4,0,20,2.857142857142857,1,0.0,5,2,0,2,6,1,0,4,0,9,11,1
14253,134440,ARjA18eVGGzkTxQWaMMAIZUVRMvVrvTf,5Gyp41oLVo7Gg7vF4vpmggWP5MU70QO6,2,0,0,0,0,0,2,0,2,0.2857142857142857,1,0.0,0,0,0,0,0,0,0,2,0,0,2,1
14254,134442,3bqYNHEttQnrSXCOjNHPi8cuvQEsNCSU,5Gyp41oLVo7Gg7vF4vpmggWP5MU70QO6,2,0,0,0,0,0,2,0,2,0.2857142857142857,1,0.0,0,0,0,0,0,0,0,2,0,0,2,1
14255,134467,eDUQDYzLIlr06g8NVX85hPNIanIljruu,5Gyp41oLVo7Gg7vF4vpmggWP5MU70QO6,3,3,0,0,0,0,3,0,6,0.8571428571428571,1,0.0,0,0,0,0,3,0,0,3,0,0,6,1
14256,134469,fC6pYirhrCOV42Ez3D2U2noD1QExW639,5Gyp41oLVo7Gg7vF4vpmggWP5MU70QO6,14,31,14,0,7,0,3,0,55,7.857142857142857,2,0.0,6,14,0,7,25,0,0,3,0,27,28,1
14257,134501,SgNxAg6Nf1FuCdt6LSsttgVmgLxouQjj,5Gyp41oLVo7Gg7vF4vpmggWP5MU70QO6,1,0,0,0,0,0,1,0,1,0.14285714285714285,1,0.0,0,0,0,0,0,0,0,1,0,0,1,1
14258,134513,pvLp8fJAJaMpP8RFak6evkjwtGvYpGCi,5Gyp41oLVo7Gg7vF4vpmggWP5MU70QO6,6,3,2,0,2,0,1,0,8,1.1428571428571428,1,0.0,0,2,0,2,3,0,0,1,0,4,4,0
14259,134519,sC5OGaEBUw2bubMs0afR4nlVohAmCaTQ,5Gyp41oLVo7Gg7vF4vpmggWP5MU70QO6,10,24,14,4,0,0,1,0,43,6.142857142857143,1,0.0,8,14,3,0,16,0,1,1,0,25,18,1
14260,134533,MLAi45Q3iuhiLIwrpX5bcnMCBSTwL11k,5Gyp41oLVo7Gg7vF4vpmggWP5MU70QO6,4,2,1,0,1,0,1,0,5,0.7142857142857143,1,0.0,0,1,0,1,2,0,0,1,0,2,3,1
14261,134548,FO0v5g6WrFl0t9Z2dbTriCUo6TxSgWka,5Gyp41oLVo7Gg7vF4vpmggWP5MU70QO6,18,41,27,17,7,0,19,1,112,16.0,7,0.0,14,27,11,7,27,0,6,19,1,59,53,1
14262,134559,ksNfAVxRMEES8VLMzIksZIeYctUCSThx,5Gyp41oLVo7Gg7vF4vpmggWP5MU70QO6,29,79,41,39,4,3,14,0,180,25.714285714285715,6,0.0,28,41,27,4,51,3,12,14,0,100,80,1
14263,134563,kh8VE8UOBKbQxAf60fsu5P6AQI3Mg2SI,5Gyp41oLVo7Gg7vF4vpmggWP5MU70QO6,5,2,1,0,1,0,2,0,6,0.8571428571428571,1,0.0,0,1,0,1,2,0,0,2,0,2,4,1
14264,134567,hiNjDCDcv1JzPRBZRj9QRfU9Ul6vxYgf,5Gyp41oLVo7Gg7vF4vpmggWP5MU70QO6,7,15,4,10,0,0,3,0,32,4.571428571428571,1,0.0,6,4,6,0,9,0,4,3,0,16,16,1
14265,134584,RqcoioXsh3XKcIvjfwDLLEg81fRmvmHR,5Gyp41oLVo7Gg7vF4vpmggWP5MU70QO6,17,26,17,11,7,15,8,0,84,12.0,4,0.0,3,17,7,7,23,15,4,8,0,34,50,1
14266,134594,9MoU4mYyLxZGlkWzRJvMH33Asx3kJrUp,5Gyp41oLVo7Gg7vF4vpmggWP5MU70QO6,1,0,0,0,0,0,1,0,1,0.14285714285714285,1,0.0,0,0,0,0,0,0,0,1,0,0,1,1
14267,134633,zKAhrujOiGZfEsROTNpBbZd0Qdis77Bp,5Gyp41oLVo7Gg7vF4vpmggWP5MU70QO6,10,3,2,0,2,1,9,1,18,2.5714285714285716,2,0.0,0,2,0,2,3,1,0,9,1,4,14,1
14268,134650,ddbvtBwQl3kZk0fkpLUfsVJDob0WKbwL,5Gyp41oLVo7Gg7vF4vpmggWP5MU70QO6,29,62,30,4,15,18,19,3,151,21.571428571428573,3,0.0,7,30,3,15,55,18,1,19,3,55,96,0
14269,134659,Oa3Yn1JDw25rNnHn2BNCxgiCAj54mdbE,5Gyp41oLVo7Gg7vF4vpmggWP5MU70QO6,13,15,8,2,2,0,2,0,29,4.142857142857143,1,0.0,1,8,1,2,14,0,1,2,0,12,17,1
14270,134662,gx5FGMroHWzRZAbfuAPz9BaAmYOVh1Wq,5Gyp41oLVo7Gg7vF4vpmggWP5MU70QO6,15,31,9,19,7,13,9,0,88,12.571428571428571,2,0.0,9,9,12,7,22,13,7,9,0,37,51,1
14271,134672,Upcsxs7PutcCAS0HYRGaNIEVa9NRKtxE,5Gyp41oLVo7Gg7vF4vpmggWP5MU70QO6,6,3,1,0,0,0,5,0,9,1.2857142857142858,1,0.0,1,1,0,0,2,0,0,5,0,2,7,1
14272,134675,moMMzrfQ7CU0tpyLDn2Hjh25aplXRW25,5Gyp41oLVo7Gg7vF4vpmggWP5MU70QO6,5,2,1,0,1,0,3,0,7,1.0,1,0.0,0,1,0,1,2,0,0,3,0,2,5,0
14273,134689,HH3HV5HDJ35z2ldQAEIDXBOSBTxLd6O9,5Gyp41oLVo7Gg7vF4vpmggWP5MU70QO6,8,5,4,0,2,0,3,0,14,2.0,2,0.0,0,4,0,2,5,0,0,3,0,6,8,1
14274,134693,kbBgYhAlCKyFUlNYYt4LArBWnUY9UyTM,5Gyp41oLVo7Gg7vF4vpmggWP5MU70QO6,20,27,12,8,16,0,11,1,75,10.714285714285714,5,0.0,10,12,6,16,17,0,2,11,1,44,31,1
14275,134697,Gn1QSm7WrSyhbej7tThohiyBKeBu1xtD,5Gyp41oLVo7Gg7vF4vpmggWP5MU70QO6,4,3,1,0,1,0,1,0,6,0.8571428571428571,1,0.0,0,1,0,1,3,0,0,1,0,2,4,1
14276,134721,WjOFL5fY7PnyGZ70shrhMlWXmSvOiiOF,5Gyp41oLVo7Gg7vF4vpmggWP5MU70QO6,16,17,13,4,8,0,6,0,48,6.857142857142857,3,0.0,0,13,2,8,17,0,2,6,0,23,25,1
14277,134732,WH2y6e5kNFN4KOU417IKr0Asm4FsSjc2,5Gyp41oLVo7Gg7vF4vpmggWP5MU70QO6,1,0,0,0,0,0,1,0,1,0.14285714285714285,1,0.0,0,0,0,0,0,0,0,1,0,0,1,1
14278,134775,w9OodY2DkN07ZOHp6V82rUeA2gts5jzg,5Gyp41oLVo7Gg7vF4vpmggWP5MU70QO6,5,3,1,0,1,0,2,0,7,1.0,1,0.0,1,1,0,1,2,0,0,2,0,3,4,1
14279,134780,SW7bpg7OnUpxZetcs9FXYocyVw4y5DC2,5Gyp41oLVo7Gg7vF4vpmggWP5MU70QO6,1,0,0,0,0,0,1,0,1,0.14285714285714285,1,0.0,0,0,0,0,0,0,0,1,0,0,1,1
14280,134783,UqUa9ycmfLRKCs1W6GNZrMpv4zQCpB0Z,5Gyp41oLVo7Gg7vF4vpmggWP5MU70QO6,4,1,1,0,0,2,2,0,6,0.8571428571428571,1,0.0,0,1,0,0,1,2,0,2,0,1,5,1
14281,134805,83JPfkin3GX4GLKqML2uaHSZ5KvsuJhM,5Gyp41oLVo7Gg7vF4vpmggWP5MU70QO6,7,3,2,0,2,0,2,0,9,1.2857142857142858,1,0.0,0,2,0,2,3,0,0,2,0,4,5,1
14282,134809,c6MvLohhRSOHpXmj2KJIEEUU9Ko3DsAE,5Gyp41oLVo7Gg7vF4vpmggWP5MU70QO6,10,6,3,0,2,0,6,2,19,2.7142857142857144,1,0.0,0,3,0,2,6,0,0,6,2,5,14,1
14283,134815,iNNgCVjnPK0MGKfhlyKj8GoKOMB3W92D,5Gyp41oLVo7Gg7vF4vpmggWP5MU70QO6,14,15,5,11,3,0,2,0,36,5.142857142857143,1,0.0,7,5,9,3,8,0,2,2,0,24,12,1
14284,134827,tPYh43YRHAzuf09xESxSKtWvST0aCsjn,5Gyp41oLVo7Gg7vF4vpmggWP5MU70QO6,6,4,1,0,1,0,2,0,8,1.1428571428571428,2,0.0,1,1,0,1,3,0,0,2,0,3,5,1
14285,134840,XcU2XTxeLZ8F89uBFmVFyW4cnWhjcEiA,5Gyp41oLVo7Gg7vF4vpmggWP5MU70QO6,8,11,5,0,4,0,5,0,25,3.5714285714285716,3,0.0,0,5,0,4,11,0,0,5,0,9,16,1
14286,134844,pYMEq6adAaeFJxcPpdDbnbqDzfuRI1mt,5Gyp41oLVo7Gg7vF4vpmggWP5MU70QO6,2,0,0,0,0,0,2,0,2,0.2857142857142857,1,0.0,0,0,0,0,0,0,0,2,0,0,2,1
14287,134854,KJqUOLVAd1FyK5g7kqbZ8lY5N2SYBafA,5Gyp41oLVo7Gg7vF4vpmggWP5MU70QO6,9,10,5,0,3,0,2,0,20,2.857142857142857,2,0.0,2,5,0,3,8,0,0,2,0,10,10,1
14288,134858,5noipPo5VTPoPCMnJr7wHe0HAODyBacQ,5Gyp41oLVo7Gg7vF4vpmggWP5MU70QO6,3,2,0,0,0,0,1,0,3,0.42857142857142855,1,0.0,0,0,0,0,2,0,0,1,0,0,3,1
14289,134861,N4fyUnhISdHnkeTlPumn2X5ScJFZ9i7p,5Gyp41oLVo7Gg7vF4vpmggWP5MU70QO6,4,2,1,0,1,0,2,0,6,0.8571428571428571,1,0.0,0,1,0,1,2,0,0,2,0,2,4,0
14290,134867,CJsdnbZnXaaflhjI7MJG4OBPTfx5Ftd2,5Gyp41oLVo7Gg7vF4vpmggWP5MU70QO6,19,36,13,0,15,0,5,1,70,10.0,4,0.0,15,13,0,15,21,0,0,5,1,43,27,1
14291,134870,w8QmJ9keTdAkvalvfgb4RcvfzqWsy2d6,5Gyp41oLVo7Gg7vF4vpmggWP5MU70QO6,1,0,0,0,0,0,1,0,1,0.14285714285714285,1,0.0,0,0,0,0,0,0,0,1,0,0,1,1
14292,134873,2p83wyVdSqhGAvxVO3TZHSqVlPrrZUal,5Gyp41oLVo7Gg7vF4vpmggWP5MU70QO6,5,3,1,0,1,0,1,0,6,0.8571428571428571,1,0.0,0,1,0,1,3,0,0,1,0,2,4,1
14293,134878,ii2A13wfEFESJFjBwmeLdddKw9K2NSuJ,5Gyp41oLVo7Gg7vF4vpmggWP5MU70QO6,7,11,6,0,3,0,7,0,27,3.857142857142857,3,0.0,0,6,0,3,11,0,0,7,0,9,18,1
14294,134882,aZ8T0PIqtCkHj0f6n6hIT9Eb58yHz02G,5Gyp41oLVo7Gg7vF4vpmggWP5MU70QO6,24,52,28,14,8,59,18,2,181,25.857142857142858,4,0.0,10,28,12,8,42,59,2,18,2,58,123,1
14295,134884,yrcAK1UDzOveofVcHCH4rjr6H1189vM3,5Gyp41oLVo7Gg7vF4vpmggWP5MU70QO6,1,0,0,0,0,0,1,0,1,0.14285714285714285,1,0.0,0,0,0,0,0,0,0,1,0,0,1,1
14296,134898,D9LfxzYr3RBoIHDv0ptNmGtJFETAdaea,5Gyp41oLVo7Gg7vF4vpmggWP5MU70QO6,18,29,12,14,5,0,6,0,66,9.428571428571429,4,0.0,7,12,12,5,22,0,2,6,0,36,30,1
14297,134909,GfFjXeeiX86hNL5LrfmBqRsIDiX1X26k,SpATywNh6bZuzm8s1ceuBUnMUAeoAHHw,28,46,26,30,10,1,8,0,121,17.285714285714285,4,0.0,10,26,27,10,36,1,3,8,0,73,48,1
14298,134917,yNC8T7gdWO96Y2q3tzTQeJUMY0F51xnO,RXDvfPUBYFlVdlueBFbLW0mhhAyGEqpt,42,27,16,52,8,0,5,0,108,15.428571428571429,4,0.0,7,16,52,8,20,0,0,5,0,83,25,1
14299,134918,IFqWOl32JJm0W3Ap2jxVCpJeXeLJlYDp,A3fsA9Zfv1X2fVEQhTw51lKENdNrEqT3,8,11,6,0,0,0,6,0,23,3.2857142857142856,4,0.0,0,6,0,0,11,0,0,6,0,6,17,1
14300,134919,DLOMX6N4LOgxba8fGitXr3UEhtTSXCQd,bWdj2GDclj5ofokWjzoa5jAwMkxCykd6,7,9,1,0,2,0,3,0,15,2.142857142857143,2,0.0,2,1,0,2,7,0,0,3,0,5,10,1
14301,134934,mWx2Nz03jP9JKc9PS0gQU6sG6k2C9F0d,SpATywNh6bZuzm8s1ceuBUnMUAeoAHHw,15,31,1,22,1,24,2,0,81,11.571428571428571,2,0.0,9,1,20,1,22,24,2,2,0,31,50,0
14302,134936,NOmOOlAJE5nKLDW211ZOVqBtRY1AgNoT,bWdj2GDclj5ofokWjzoa5jAwMkxCykd6,12,21,2,0,0,1,7,0,31,4.428571428571429,1,0.0,1,2,0,0,20,1,0,7,0,3,28,1
14303,134958,vZY5RTyvAOyjF1AYeCntOYrEo9bIz6lQ,G8EPVSXsOYB5YQWZGiz1aVq5Pgr2GrQu,1,0,0,0,0,0,1,0,1,0.14285714285714285,1,0.0,0,0,0,0,0,0,0,1,0,0,1,1
14304,134959,pvIpspZXePJsFKRHWlM49ptwJQDbUcRt,SpATywNh6bZuzm8s1ceuBUnMUAeoAHHw,3,2,0,0,0,0,1,0,3,0.42857142857142855,1,0.0,0,0,0,0,2,0,0,1,0,0,3,1
14305,134961,oqS6zzIbAzdLBJLSTonEDuhKDtanqUaf,SpATywNh6bZuzm8s1ceuBUnMUAeoAHHw,22,25,0,31,0,17,7,0,80,11.428571428571429,2,0.0,7,0,26,0,18,17,5,7,0,33,47,1
14306,134982,CW7Zlsz0NoDYd7q0tu1Krgi9b7wpQUwQ,A3fsA9Zfv1X2fVEQhTw51lKENdNrEqT3,11,11,6,4,1,0,12,0,34,4.857142857142857,4,0.0,0,6,3,1,11,0,1,12,0,10,24,0
14307,134994,eSBIcO9jl3TmHpUt3HWb9pXo82kpOmfn,bWdj2GDclj5ofokWjzoa5jAwMkxCykd6,7,4,2,0,2,0,1,0,9,1.2857142857142858,1,0.0,0,2,0,2,4,0,0,1,0,4,5,1
14308,135002,Vr0kaKAkI4p2upUYNB1MMKsTShBZob66,A3fsA9Zfv1X2fVEQhTw51lKENdNrEqT3,10,10,5,0,2,13,6,0,36,5.142857142857143,3,0.0,0,5,0,2,10,13,0,6,0,7,29,1
14309,135005,8roapIDCTFIdbLoaqBbYR8jsy1UP5sGP,RXDvfPUBYFlVdlueBFbLW0mhhAyGEqpt,11,9,6,0,3,1,4,0,23,3.2857142857142856,1,0.0,0,6,0,3,9,1,0,4,0,9,14,1
14310,135010,ABF7qktVQ6rBIirYNSz5GNtRM330ID0h,A3fsA9Zfv1X2fVEQhTw51lKENdNrEqT3,1,0,0,0,0,0,2,0,2,0.2857142857142857,1,0.0,0,0,0,0,0,0,0,2,0,0,2,1
14311,135021,TCrdvmbavAJVW5bPiEeyt89TcS6pYL1D,A3fsA9Zfv1X2fVEQhTw51lKENdNrEqT3,2,0,0,0,0,0,3,0,3,0.42857142857142855,1,0.0,0,0,0,0,0,0,0,3,0,0,3,1
14312,135022,f0rWHmI4rV7ssYizy9jzg3UxqKTtG19Y,SpATywNh6bZuzm8s1ceuBUnMUAeoAHHw,30,59,0,38,0,1,28,0,126,18.0,9,0.0,23,0,32,0,36,1,6,28,0,55,71,0
14313,135025,tedGThhHMqVARfBh6zyzyocTKbTJYJpB,SpATywNh6bZuzm8s1ceuBUnMUAeoAHHw,23,31,16,15,5,12,10,1,90,12.857142857142858,5,0.0,10,16,12,5,21,12,3,10,1,43,47,1
14314,135026,Cue1j1CEK4ByBYziFbTJAskjanGgrJp6,SpATywNh6bZuzm8s1ceuBUnMUAeoAHHw,33,39,0,44,0,9,7,0,99,14.142857142857142,3,0.0,6,0,44,0,33,9,0,7,0,50,49,0
14315,135035,wQjDRlC3tPpszGzQ3Dfiq7I6azQztJ02,A3fsA9Zfv1X2fVEQhTw51lKENdNrEqT3,13,9,6,4,4,0,3,0,26,3.7142857142857144,2,0.0,2,6,4,4,7,0,0,3,0,16,10,1
14316,135040,QflUMQYqgKuyQPnCteHvz3LqhJ9AwCga,A3fsA9Zfv1X2fVEQhTw51lKENdNrEqT3,2,0,0,0,0,0,9,0,9,1.2857142857142858,1,0.0,0,0,0,0,0,0,0,9,0,0,9,1
14317,135060,UJeg7gRsnH7RZFT5Iv8Y0tTilR96sXcV,A3fsA9Zfv1X2fVEQhTw51lKENdNrEqT3,3,2,0,0,0,0,2,0,4,0.5714285714285714,1,0.0,0,0,0,0,2,0,0,2,0,0,4,1
14318,135065,g9QyBrQkEVh9IC3JA81b7KgVa01DwgUa,SpATywNh6bZuzm8s1ceuBUnMUAeoAHHw,35,34,22,26,12,5,9,2,110,15.714285714285714,3,0.0,8,22,25,12,26,5,1,9,2,67,43,1
14319,135079,GFArLd1huQSmyLkNR2x5AlhFrFWDXs0N,SpATywNh6bZuzm8s1ceuBUnMUAeoAHHw,14,44,12,26,3,0,3,0,88,12.571428571428571,7,0.0,24,12,21,3,20,0,5,3,0,60,28,0
14320,135095,e09uq36QgLuBVK5DERoejsHeMH2uPMRM,bWdj2GDclj5ofokWjzoa5jAwMkxCykd6,1,0,0,0,0,0,1,0,1,0.14285714285714285,1,0.0,0,0,0,0,0,0,0,1,0,0,1,1
14321,135097,EbZIIypapfDMAa5QP57XCFF2cfAshgSo,RXDvfPUBYFlVdlueBFbLW0mhhAyGEqpt,1,0,0,0,0,0,2,0,2,0.2857142857142857,1,0.0,0,0,0,0,0,0,0,2,0,0,2,1
14322,135104,gZWf27ETcHz4bBmwZPjiPumw55JZ4IOR,A3fsA9Zfv1X2fVEQhTw51lKENdNrEqT3,1,0,0,0,0,0,1,0,1,0.14285714285714285,1,0.0,0,0,0,0,0,0,0,1,0,0,1,1
14323,135115,qknWf2eBme9z3XgVNwZwbwdoI0FKipkj,A3fsA9Zfv1X2fVEQhTw51lKENdNrEqT3,40,25,16,70,12,4,13,0,140,20.0,3,0.0,6,16,55,12,19,4,15,13,0,89,51,1
14324,135119,czraR8jl3tjb5vvHKbMcAmZkpcCxXmtq,bWdj2GDclj5ofokWjzoa5jAwMkxCykd6,7,3,2,0,2,1,3,0,11,1.5714285714285714,1,0.0,0,2,0,2,3,1,0,3,0,4,7,1
14325,135128,jbfQf8j93qEc8QCxEb0dikXBABlkLrcO,G8EPVSXsOYB5YQWZGiz1aVq5Pgr2GrQu,1,0,0,0,0,0,1,0,1,0.14285714285714285,1,0.0,0,0,0,0,0,0,0,1,0,0,1,1
14326,135137,A3FGIvcpmP9UeVzECTe66iC9lFbKmHRb,A3fsA9Zfv1X2fVEQhTw51lKENdNrEqT3,48,34,26,68,14,4,7,0,153,21.857142857142858,5,0.0,1,26,60,14,33,4,8,7,0,101,52,1
14327,135143,LbQhhYRYGsyaTkO1QusAxgXnsVSB1OSE,SpATywNh6bZuzm8s1ceuBUnMUAeoAHHw,7,1,1,0,1,1,6,1,11,1.5714285714285714,1,0.0,0,1,0,1,1,1,0,6,1,2,9,1
14328,135168,wMQxNrryGKgbGXsy17gJPlh2fJdDvt8s,bWdj2GDclj5ofokWjzoa5jAwMkxCykd6,13,19,6,72,5,9,3,0,114,16.285714285714285,2,0.0,8,6,65,5,11,9,7,3,0,84,30,1
14329,135172,qLscbApWydA7z1h7Ht7RN2UnF0mvGZpF,RXDvfPUBYFlVdlueBFbLW0mhhAyGEqpt,16,25,2,0,1,1,9,1,39,5.571428571428571,4,0.0,0,2,0,1,25,1,0,9,1,3,36,1
14330,135188,qhmgArW8a15UOGQrFTosGi03wE1TjPeN,G8EPVSXsOYB5YQWZGiz1aVq5Pgr2GrQu,32,54,2,38,6,0,3,0,103,14.714285714285714,2,0.0,34,2,24,6,20,0,14,3,0,66,37,1
14331,135190,wLSijvQvjlVUQosga79Y2P2NJWJt5aXA,SpATywNh6bZuzm8s1ceuBUnMUAeoAHHw,15,24,11,20,4,3,3,0,65,9.285714285714286,1,0.0,4,11,16,4,20,3,4,3,0,35,30,0
14332,135205,ps2zbzmz8NQnCm6f0pvJpkBQkQh2tR1v,bWdj2GDclj5ofokWjzoa5jAwMkxCykd6,23,67,48,50,21,0,12,0,198,28.285714285714285,3,0.0,6,48,43,21,61,0,7,12,0,118,80,1
14333,135209,XPNYQB8BXxVJKoqXsnIXNkzgmqWM9Jf1,bWdj2GDclj5ofokWjzoa5jAwMkxCykd6,1,0,0,0,0,0,1,0,1,0.14285714285714285,1,0.0,0,0,0,0,0,0,0,1,0,0,1,0
14334,135219,njjQXvcpocYF8aiLDJ8yZfLnv69cMgqm,SpATywNh6bZuzm8s1ceuBUnMUAeoAHHw,18,10,9,0,8,0,2,0,29,4.142857142857143,1,0.0,0,9,0,8,10,0,0,2,0,17,12,1
14335,135222,MpTAgw3ozhmeD7C8xc95FgAYRb7j4nGM,SpATywNh6bZuzm8s1ceuBUnMUAeoAHHw,6,2,1,0,1,0,3,0,7,1.0,1,0.0,0,1,0,1,2,0,0,3,0,2,5,1
14336,135232,ZfIQYurnR6gJbWxLJ81cU3ZqzX4mpHm0,A3fsA9Zfv1X2fVEQhTw51lKENdNrEqT3,34,73,36,4,21,2,34,2,172,24.571428571428573,4,0.0,3,36,4,21,70,2,0,34,2,64,108,1
14337,135234,8JTz84ZDdJm6tvsd7hgyCl1RB6wU6r2e,A3fsA9Zfv1X2fVEQhTw51lKENdNrEqT3,9,6,4,0,2,0,4,0,16,2.2857142857142856,2,0.0,0,4,0,2,6,0,0,4,0,6,10,1
14338,135242,JJ57bFsns5I0rz7X8YoOwiZazG9JNmlR,SpATywNh6bZuzm8s1ceuBUnMUAeoAHHw,1,0,0,0,0,0,1,0,1,0.14285714285714285,1,0.0,0,0,0,0,0,0,0,1,0,0,1,1
14339,135247,n67Q6gA8OyrfjvaOwbClftMWf4trlmyC,A3fsA9Zfv1X2fVEQhTw51lKENdNrEqT3,16,12,8,0,7,0,5,0,32,4.571428571428571,2,0.0,0,8,0,7,12,0,0,5,0,15,17,1
14340,135252,1umo7etGwkx7NcpFxVialzDD37NdyqRT,G8EPVSXsOYB5YQWZGiz1aVq5Pgr2GrQu,43,77,35,58,8,0,4,0,182,26.0,2,0.0,38,35,37,8,39,0,21,4,0,118,64,0
14341,135271,orkLWN7Jw88UrSJVImY9WyAA9wO3axVi,A3fsA9Zfv1X2fVEQhTw51lKENdNrEqT3,1,0,0,0,0,0,1,0,1,0.14285714285714285,1,0.0,0,0,0,0,0,0,0,1,0,0,1,1
14342,135272,MZomFQTbHAKaDGd0B9fv7KQ9MRsZJ7m6,bWdj2GDclj5ofokWjzoa5jAwMkxCykd6,4,4,1,0,0,0,2,0,7,1.0,1,0.0,0,1,0,0,4,0,0,2,0,1,6,1
14343,135304,43KrXQWA5nPYKCMGBRnIKMf2ytZWgrcW,bWdj2GDclj5ofokWjzoa5jAwMkxCykd6,1,0,0,0,0,0,1,0,1,0.14285714285714285,1,0.0,0,0,0,0,0,0,0,1,0,0,1,1
14344,135305,43KrXQWA5nPYKCMGBRnIKMf2ytZWgrcW,A3fsA9Zfv1X2fVEQhTw51lKENdNrEqT3,1,0,0,0,0,0,2,0,2,0.2857142857142857,1,0.0,0,0,0,0,0,0,0,2,0,0,2,1
14345,135319,XRgwz0GPwgb7aVdSZ4HGlz0QU2iMHxW2,A3fsA9Zfv1X2fVEQhTw51lKENdNrEqT3,8,3,2,0,2,1,3,2,13,1.8571428571428572,1,0.0,0,2,0,2,3,1,0,3,2,4,9,1
14346,135335,NXrRVU4FxMGO3zABXLL6x3AW8OEzmOAP,SpATywNh6bZuzm8s1ceuBUnMUAeoAHHw,3,0,0,0,0,0,3,0,3,0.42857142857142855,1,0.0,0,0,0,0,0,0,0,3,0,0,3,1
14347,135337,1Qo7KMYcvZsuiBzdvEuPj5kKA7qUbqJV,RXDvfPUBYFlVdlueBFbLW0mhhAyGEqpt,1,0,0,0,0,0,1,0,1,0.14285714285714285,1,0.0,0,0,0,0,0,0,0,1,0,0,1,1
14348,135358,ENiSmEGDuCang79gWrzmkKVXvQ2o3noj,SpATywNh6bZuzm8s1ceuBUnMUAeoAHHw,13,21,3,0,3,0,4,0,31,4.428571428571429,4,0.0,0,3,0,3,21,0,0,4,0,6,25,1
14349,135377,ZfIQYurnR6gJbWxLJ81cU3ZqzX4mpHm0,SpATywNh6bZuzm8s1ceuBUnMUAeoAHHw,40,80,33,21,13,3,15,0,165,23.571428571428573,6,0.0,18,33,16,13,62,3,5,15,0,80,85,0
14350,135390,IGFSjvLtGQCYdnhMcrAQcaIreY53ybWv,bWdj2GDclj5ofokWjzoa5jAwMkxCykd6,70,162,64,194,38,40,29,2,529,75.57142857142857,12,0.0,30,64,166,38,132,40,28,29,2,298,231,0
14351,135396,g5cfvDvYqz1BC4LMGanzPaVPPBmwbapa,SpATywNh6bZuzm8s1ceuBUnMUAeoAHHw,15,12,9,0,6,0,4,0,31,4.428571428571429,3,0.0,0,9,0,6,12,0,0,4,0,15,16,0
14352,135399,46rTxBSjCmRWQay8Ou4hIiZJB66kf2no,RXDvfPUBYFlVdlueBFbLW0mhhAyGEqpt,6,1,1,0,1,0,6,0,9,1.2857142857142858,1,0.0,0,1,0,1,1,0,0,6,0,2,7,1
14353,135412,kdSYbpVWFVGC6Yy5JRVMZRVsatOK3Lvr,SpATywNh6bZuzm8s1ceuBUnMUAeoAHHw,14,8,5,11,3,0,2,0,29,4.142857142857143,1,0.0,2,5,11,3,6,0,0,2,0,21,8,1
14354,135415,HshUJf4SCu4uNEnMGOCihwqMFgpruX2A,bWdj2GDclj5ofokWjzoa5jAwMkxCykd6,13,13,7,20,7,11,4,1,63,9.0,1,0.0,3,7,17,7,10,11,3,4,1,34,29,0
14355,135418,OdctoiqHnsBGK57e7GpH3g9wz0WU5g5f,SpATywNh6bZuzm8s1ceuBUnMUAeoAHHw,1,0,0,0,0,0,1,0,1,0.14285714285714285,1,0.0,0,0,0,0,0,0,0,1,0,0,1,1
14356,135420,58eQNUjs318sjON50Y8nkDIw70NM1q5r,SpATywNh6bZuzm8s1ceuBUnMUAeoAHHw,15,24,0,17,0,1,6,0,48,6.857142857142857,3,0.0,12,0,14,0,12,1,3,6,0,26,22,1
14357,135425,LoyL1dLg21zF03lUMGts7AHY1XLphBvU,SpATywNh6bZuzm8s1ceuBUnMUAeoAHHw,30,54,17,29,10,1,11,1,123,17.571428571428573,4,0.0,16,17,27,10,38,1,2,11,1,70,53,1
14358,135428,yNBmodc8EXXXXDprMuN3jSh3qPXFcpn8,bWdj2GDclj5ofokWjzoa5jAwMkxCykd6,3,5,1,0,0,0,1,0,7,1.0,1,0.0,0,1,0,0,5,0,0,1,0,1,6,1
14359,135442,x6BtQH70uuLHaxqzHA21U9wmfT0SxzD9,RXDvfPUBYFlVdlueBFbLW0mhhAyGEqpt,10,17,1,0,1,2,13,1,35,5.0,4,0.0,0,1,0,1,17,2,0,13,1,2,33,1
14360,135447,ivxBGUbA7UT7tzED0gKK31cJU8Lv97zd,A3fsA9Zfv1X2fVEQhTw51lKENdNrEqT3,6,5,1,0,1,0,3,1,11,1.5714285714285714,1,0.0,0,1,0,1,5,0,0,3,1,2,9,1
14361,135458,l3gXcoEEAi47BjXtnIC98tO9tYDIMoBh,SpATywNh6bZuzm8s1ceuBUnMUAeoAHHw,1,0,0,0,0,0,1,0,1,0.14285714285714285,1,0.0,0,0,0,0,0,0,0,1,0,0,1,1
14362,135459,EXZ81qqSldwR1xdBEwBZ7wmgbTHF86sl,bWdj2GDclj5ofokWjzoa5jAwMkxCykd6,72,122,75,252,51,26,16,4,546,78.0,5,0.0,20,75,208,51,102,26,44,16,4,354,192,0
14363,135464,LpEtIb2L9alLwOQca0Li1HTQlgRpqszP,SpATywNh6bZuzm8s1ceuBUnMUAeoAHHw,5,2,1,0,1,0,2,0,6,0.8571428571428571,1,0.0,0,1,0,1,2,0,0,2,0,2,4,0
14364,135482,AbI9GGAE5Qd4SVmAdr7BeGuvfhPX7Wtw,SpATywNh6bZuzm8s1ceuBUnMUAeoAHHw,9,9,0,6,1,0,2,0,18,2.5714285714285716,1,0.0,0,0,5,1,9,0,1,2,0,6,12,1
14365,135484,gPVsxFydsCsfu82yACdpzeHHS3WY2N6x,SpATywNh6bZuzm8s1ceuBUnMUAeoAHHw,5,2,1,0,1,0,2,0,6,0.8571428571428571,1,0.0,0,1,0,1,2,0,0,2,0,2,4,1
14366,135499,MgBJbfRXH0QNEJmIiGY28SpmFvbhxSoF,A3fsA9Zfv1X2fVEQhTw51lKENdNrEqT3,4,2,1,0,0,5,2,0,10,1.4285714285714286,1,0.0,0,1,0,0,2,5,0,2,0,1,9,1
14367,135507,irZDaKqT4KdxcZGgiOHoDpvTtZyUugWP,A3fsA9Zfv1X2fVEQhTw51lKENdNrEqT3,21,11,5,60,2,0,4,0,82,11.714285714285714,2,0.0,0,5,49,2,11,0,11,4,0,56,26,1
14368,135529,ibuUKEEpKQv3Ka1yViFkKH0Ap8k9qs3g,SpATywNh6bZuzm8s1ceuBUnMUAeoAHHw,3,4,0,0,0,0,1,0,5,0.7142857142857143,1,0.0,0,0,0,0,4,0,0,1,0,0,5,1
14369,135533,oM7zTsGBhypmiyvXB06I1GE7QqwfEoSV,SpATywNh6bZuzm8s1ceuBUnMUAeoAHHw,1,0,0,0,0,0,1,0,1,0.14285714285714285,1,0.0,0,0,0,0,0,0,0,1,0,0,1,1
14370,135535,oM7zTsGBhypmiyvXB06I1GE7QqwfEoSV,bWdj2GDclj5ofokWjzoa5jAwMkxCykd6,1,0,0,0,0,0,1,0,1,0.14285714285714285,1,0.0,0,0,0,0,0,0,0,1,0,0,1,1
14371,135536,oM7zTsGBhypmiyvXB06I1GE7QqwfEoSV,A3fsA9Zfv1X2fVEQhTw51lKENdNrEqT3,2,0,0,0,0,0,3,0,3,0.42857142857142855,1,0.0,0,0,0,0,0,0,0,3,0,0,3,1
14372,135547,XuaSoIyzQwXQTlS6fvGcmzTRqL1S8Nnj,A3fsA9Zfv1X2fVEQhTw51lKENdNrEqT3,6,4,0,0,0,0,7,0,11,1.5714285714285714,1,0.0,0,0,0,0,4,0,0,7,0,0,11,1
14373,135552,oaQkoDjpR1FzyXXhOzFvMONGKXrM2zS0,SpATywNh6bZuzm8s1ceuBUnMUAeoAHHw,6,3,1,0,1,0,2,0,7,1.0,1,0.0,0,1,0,1,3,0,0,2,0,2,5,1
14374,135553,HQ9RppyfbU41Pv363qQe8zqkh0OzGsvv,SpATywNh6bZuzm8s1ceuBUnMUAeoAHHw,21,20,11,14,5,0,5,0,55,7.857142857142857,3,0.0,2,11,13,5,18,0,1,5,0,31,24,1
14375,135554,nrNRU1bochGfgxXZNdc89zA9KtJYIKVZ,SpATywNh6bZuzm8s1ceuBUnMUAeoAHHw,29,47,28,14,15,0,9,0,113,16.142857142857142,5,0.0,11,28,14,15,36,0,0,9,0,68,45,0
14376,135560,p7o6CUVxTvhF5zDZdbTejHoySKfqycmC,A3fsA9Zfv1X2fVEQhTw51lKENdNrEqT3,7,5,3,0,1,0,3,0,12,1.7142857142857142,2,0.0,0,3,0,1,5,0,0,3,0,4,8,1
14377,135566,vycvLwIlVlbz3tEwZzvFj0YINSM3Ga0S,A3fsA9Zfv1X2fVEQhTw51lKENdNrEqT3,2,0,0,0,0,0,5,0,5,0.7142857142857143,1,0.0,0,0,0,0,0,0,0,5,0,0,5,1
14378,135570,JoLD64z5yUuFbScCfKMnv8dODXOTXhRU,RXDvfPUBYFlVdlueBFbLW0mhhAyGEqpt,51,54,3,91,7,5,9,3,172,24.571428571428573,4,0.0,15,3,84,7,39,5,7,9,3,109,63,1
14379,135590,VYMfm0tgVS6x4Eosz9NPpRPYpCrgFsMy,RXDvfPUBYFlVdlueBFbLW0mhhAyGEqpt,86,137,39,258,20,18,22,0,494,70.57142857142857,8,0.0,39,39,229,20,98,18,29,22,0,327,167,0
14380,135613,8lCrBaMkcXk8KsL7M8AYgjnsyFuSP4yK,SpATywNh6bZuzm8s1ceuBUnMUAeoAHHw,17,17,8,13,4,6,8,1,57,8.142857142857142,5,0.0,4,8,11,4,13,6,2,8,1,27,30,0
14381,135614,jWsLxS98Uf5iPgurn9PRvQM3beT2rSkF,RXDvfPUBYFlVdlueBFbLW0mhhAyGEqpt,8,5,4,0,2,0,1,0,12,1.7142857142857142,1,0.0,0,4,0,2,5,0,0,1,0,6,6,1
14382,135619,dmVv4oc5Gy8IXIoX1c6y61vCY7ZjC5c1,SpATywNh6bZuzm8s1ceuBUnMUAeoAHHw,29,45,21,12,6,7,19,0,110,15.714285714285714,7,0.0,7,21,12,6,38,7,0,19,0,46,64,1
14383,135624,MwZAtUJAIGUF9YvAxz812Aiz5L37mA7l,A3fsA9Zfv1X2fVEQhTw51lKENdNrEqT3,8,3,0,0,0,0,9,1,13,1.8571428571428572,1,0.0,0,0,0,0,3,0,0,9,1,0,13,1
14384,135627,p8PDk7PIRcdv8OilLQ1EB9K2d3Uc8Sea,SpATywNh6bZuzm8s1ceuBUnMUAeoAHHw,23,41,21,0,9,0,10,0,81,11.571428571428571,8,0.0,9,21,0,9,32,0,0,10,0,39,42,1
14385,135651,8E88mVxxHiSEV3ReMbiLkIuYAxJ6YXeO,A3fsA9Zfv1X2fVEQhTw51lKENdNrEqT3,19,25,17,0,5,0,9,0,56,8.0,6,0.0,0,17,0,5,25,0,0,9,0,22,34,0
14386,135653,ZtI7VkDL2OGaTLjYGXUs2OJh9j1CJRBG,A3fsA9Zfv1X2fVEQhTw51lKENdNrEqT3,1,0,0,0,0,0,1,0,1,0.14285714285714285,1,0.0,0,0,0,0,0,0,0,1,0,0,1,1
14387,135660,700mBNy8Tl4Vnb1y2ttxNbwsqHUl4IAM,RXDvfPUBYFlVdlueBFbLW0mhhAyGEqpt,2,0,0,0,0,0,3,0,3,0.42857142857142855,2,0.0,0,0,0,0,0,0,0,3,0,0,3,0
14388,135683,tK1ujwYOutLxYQ1M2MwQkyt3NUvkvmdS,SpATywNh6bZuzm8s1ceuBUnMUAeoAHHw,7,3,2,0,2,0,2,0,9,1.2857142857142858,1,0.0,0,2,0,2,3,0,0,2,0,4,5,1
14389,135687,txe41Ukj2eG7YicOJ2zPZM0lmaXGVXJ2,bWdj2GDclj5ofokWjzoa5jAwMkxCykd6,2,0,0,0,0,0,3,0,3,0.42857142857142855,1,0.0,0,0,0,0,0,0,0,3,0,0,3,1
14390,135692,txe41Ukj2eG7YicOJ2zPZM0lmaXGVXJ2,A3fsA9Zfv1X2fVEQhTw51lKENdNrEqT3,1,0,0,0,0,0,2,0,2,0.2857142857142857,1,0.0,0,0,0,0,0,0,0,2,0,0,2,1
14391,135701,0JlJQUp9pPJEAtzsQAEQWYAKuWMKB5Wj,SpATywNh6bZuzm8s1ceuBUnMUAeoAHHw,1,0,0,0,0,0,1,0,1,0.14285714285714285,1,0.0,0,0,0,0,0,0,0,1,0,0,1,1
14392,135703,1i94xoT1OVM1lTP3R294JlD5odSrEcP5,SpATywNh6bZuzm8s1ceuBUnMUAeoAHHw,16,34,0,0,0,3,10,1,48,6.857142857142857,5,0.0,7,0,0,0,27,3,0,10,1,7,41,1
14393,135709,EvNxwwShcQXgwZllGhuS7z5fGOL08A9A,SpATywNh6bZuzm8s1ceuBUnMUAeoAHHw,42,156,66,16,27,24,46,7,342,48.857142857142854,14,0.0,20,66,15,27,136,24,1,46,7,128,214,0
14394,135710,W1eC8dDo2Br41T5aJYgOhKyFK29UHKkl,bWdj2GDclj5ofokWjzoa5jAwMkxCykd6,1,0,0,0,0,0,1,0,1,0.14285714285714285,1,0.0,0,0,0,0,0,0,0,1,0,0,1,1
14395,135713,uw4petWia8mRNE3kHXaUdR4MrfrMeMii,SpATywNh6bZuzm8s1ceuBUnMUAeoAHHw,26,32,18,0,10,0,6,0,66,9.428571428571429,6,0.0,3,18,0,10,29,0,0,6,0,31,35,0
14396,135718,P3c6lZK14dvErTUVPURdGKdrWTycrHyk,SpATywNh6bZuzm8s1ceuBUnMUAeoAHHw,8,5,2,0,2,0,3,0,12,1.7142857142857142,1,0.0,0,2,0,2,5,0,0,3,0,4,8,1
14397,135730,H8XaU1gbefHT7MZ45ya2B80ofczKeIUJ,bWdj2GDclj5ofokWjzoa5jAwMkxCykd6,51,83,46,170,20,26,51,1,397,56.714285714285715,9,0.0,17,46,149,20,66,26,21,51,1,232,165,0
14398,135731,NBdBSIIhFodg28Tlkf7g5CN58dT0AVfw,A3fsA9Zfv1X2fVEQhTw51lKENdNrEqT3,5,1,1,0,0,6,11,0,19,2.7142857142857144,3,0.0,0,1,0,0,1,6,0,11,0,1,18,1
14399,135750,S9HR7eC8Gw4zo138FI1zxgIn4ZjLPEI1,RXDvfPUBYFlVdlueBFbLW0mhhAyGEqpt,2,0,0,0,0,0,5,0,5,0.7142857142857143,1,0.0,0,0,0,0,0,0,0,5,0,0,5,1
14400,135760,S9HR7eC8Gw4zo138FI1zxgIn4ZjLPEI1,SpATywNh6bZuzm8s1ceuBUnMUAeoAHHw,1,0,0,0,0,0,1,0,1,0.14285714285714285,1,0.0,0,0,0,0,0,0,0,1,0,0,1,1
14401,135772,B5AczbKF5ZPxp6QPkgM4LlavowE2gAlY,bWdj2GDclj5ofokWjzoa5jAwMkxCykd6,1,0,0,0,0,0,1,0,1,0.14285714285714285,1,0.0,0,0,0,0,0,0,0,1,0,0,1,1
14402,135789,PCI2iKpgTMjPS1xfOSmpWNe7sqLAlttf,G8EPVSXsOYB5YQWZGiz1aVq5Pgr2GrQu,1,0,0,0,0,0,1,0,1,0.14285714285714285,1,0.0,0,0,0,0,0,0,0,1,0,0,1,1
14403,135794,FpBG6AfbqT8rtlNKLvRAodERdOKPGQfD,A3fsA9Zfv1X2fVEQhTw51lKENdNrEqT3,7,3,2,0,2,0,2,0,9,1.2857142857142858,1,0.0,0,2,0,2,3,0,0,2,0,4,5,1
14404,135795,CAnNKDdlHhDJqz95kWpWwBuKgmoUwH3k,RXDvfPUBYFlVdlueBFbLW0mhhAyGEqpt,5,2,1,0,1,0,2,0,6,0.8571428571428571,1,0.0,0,1,0,1,2,0,0,2,0,2,4,1
14405,135813,E4hjF5LL5g3DmDyETJzEmj6OhjarBopN,A3fsA9Zfv1X2fVEQhTw51lKENdNrEqT3,7,3,1,0,0,1,11,1,17,2.4285714285714284,2,0.0,0,1,0,0,3,1,0,11,1,1,16,1
14406,135826,ETvKJXrBLwN7msxC91B5PIQrzaf0kAW1,A3fsA9Zfv1X2fVEQhTw51lKENdNrEqT3,1,0,0,0,0,0,1,0,1,0.14285714285714285,1,0.0,0,0,0,0,0,0,0,1,0,0,1,1
14407,135829,iyNW22GLVn7ltcBOUiQmam3mjjq9r9cL,A3fsA9Zfv1X2fVEQhTw51lKENdNrEqT3,7,7,1,0,1,0,3,0,12,1.7142857142857142,3,0.0,0,1,0,1,7,0,0,3,0,2,10,1
14408,135840,Pk1zvEWPdVckXHLEawuIZZjckq66QamN,A3fsA9Zfv1X2fVEQhTw51lKENdNrEqT3,14,18,4,0,2,0,17,1,42,6.0,4,0.0,0,4,0,2,18,0,0,17,1,6,36,1
14409,135841,Pk1zvEWPdVckXHLEawuIZZjckq66QamN,5X6FeZozNMgE2VRi3MJYjkkFK8SETtu2,13,24,2,0,3,0,10,0,39,5.571428571428571,3,0.0,1,2,0,3,23,0,0,10,0,6,33,1
14410,135843,QGuKTIBC2KLaYpPdOnB4nXCWgxMM1Dog,bWdj2GDclj5ofokWjzoa5jAwMkxCykd6,27,69,35,38,17,0,16,0,175,25.0,9,0.0,10,35,32,17,59,0,6,16,0,94,81,0
14411,135845,2Xqni7LSMWD8x13lDJQiPucRiXMjxJoU,SpATywNh6bZuzm8s1ceuBUnMUAeoAHHw,44,87,32,52,14,0,9,0,194,27.714285714285715,2,0.0,25,32,43,14,62,0,9,9,0,114,80,0
14412,135849,xn2e8QAPLTKhGQZStwXhUOgjA9bf3xHv,SpATywNh6bZuzm8s1ceuBUnMUAeoAHHw,11,18,1,5,0,6,5,1,36,5.142857142857143,1,0.0,7,1,5,0,11,6,0,5,1,13,23,0
14413,135862,vVomSgkHkyw3sqrRqYKc3zE1eWaa2d4G,A3fsA9Zfv1X2fVEQhTw51lKENdNrEqT3,165,98,77,410,62,118,63,1,829,118.42857142857143,8,0.0,19,77,347,62,79,118,63,63,1,505,324,0
14414,135865,4qEc82DhaeJuxSG1re8zPgEROlFltHL5,SpATywNh6bZuzm8s1ceuBUnMUAeoAHHw,37,57,32,38,23,0,7,0,157,22.428571428571427,5,0.0,15,32,32,23,42,0,6,7,0,102,55,0
14415,135875,24fGHeKkFcKUohpd2rziJRSIJ4SrDKtC,RXDvfPUBYFlVdlueBFbLW0mhhAyGEqpt,9,7,5,0,3,0,2,0,17,2.4285714285714284,1,0.0,1,5,0,3,6,0,0,2,0,9,8,0
14416,135882,tTG3Ne3P3A1gAXhNVMiXz0Ee3ILsYPsk,7GRhBDsirIGkRZBtSMEzNTyDr2JQm4xx,1,0,0,0,0,0,1,0,1,0.14285714285714285,1,0.0,0,0,0,0,0,0,0,1,0,0,1,1
14417,135886,gmM0J4w8n6qKhDnAM2MwKDXTUMCCwDIV,SpATywNh6bZuzm8s1ceuBUnMUAeoAHHw,10,13,1,14,0,0,2,0,30,4.285714285714286,1,0.0,8,1,13,0,5,0,1,2,0,22,8,1
14418,135890,L4RizFe7sTSIk0fwYQceBQCkzU4YI9f8,5X6FeZozNMgE2VRi3MJYjkkFK8SETtu2,1,0,0,0,0,0,1,0,1,0.14285714285714285,1,0.0,0,0,0,0,0,0,0,1,0,0,1,1
14419,135894,gMjUjoj7lChD8J5g7c3W6YLbo2nPVjuD,SpATywNh6bZuzm8s1ceuBUnMUAeoAHHw,1,0,0,0,0,0,1,0,1,0.14285714285714285,1,0.0,0,0,0,0,0,0,0,1,0,0,1,1
14420,135902,bjYQe6htagSVxSwarZfLS2CglzR1VJVW,SpATywNh6bZuzm8s1ceuBUnMUAeoAHHw,20,17,7,32,1,5,5,0,67,9.571428571428571,1,0.0,8,7,28,1,9,5,4,5,0,44,23,1
14421,135905,YNfGmODVWZ9Dsat8A5knWQhPiQd6NNVe,5X6FeZozNMgE2VRi3MJYjkkFK8SETtu2,2,0,0,0,0,0,3,0,3,0.42857142857142855,1,0.0,0,0,0,0,0,0,0,3,0,0,3,1
14422,135909,s1vgWbMezqTHWPlvrms0WJFKvZbaN3cw,7GRhBDsirIGkRZBtSMEzNTyDr2JQm4xx,22,24,13,16,7,3,6,0,69,9.857142857142858,3,0.0,5,13,13,7,19,3,3,6,0,38,31,1
14423,135911,Qb2VAk3EqflWvF2aBP5imzRDjkUce9e9,5X6FeZozNMgE2VRi3MJYjkkFK8SETtu2,7,2,1,0,1,0,10,1,15,2.142857142857143,1,0.0,0,1,0,1,2,0,0,10,1,2,13,1
14424,135917,jThN2fUIAYaL9Gu4llat9u94XkdISlbQ,A3fsA9Zfv1X2fVEQhTw51lKENdNrEqT3,8,6,3,0,1,3,6,1,20,2.857142857142857,1,0.0,0,3,0,1,6,3,0,6,1,4,16,1
14425,135923,xC1fO9XXT3Iratd3KBQhzTB1rjClmcJ6,SpATywNh6bZuzm8s1ceuBUnMUAeoAHHw,1,0,0,0,0,0,1,0,1,0.14285714285714285,1,0.0,0,0,0,0,0,0,0,1,0,0,1,1
14426,135932,lZ2VhV25LolxMF5drRCLEdlcMBg33ClU,SpATywNh6bZuzm8s1ceuBUnMUAeoAHHw,5,2,1,0,1,0,2,0,6,0.8571428571428571,1,0.0,0,1,0,1,2,0,0,2,0,2,4,1
14427,135935,sHOnkDTcrFCU5Jo5xXpxGND4wJy0klei,SpATywNh6bZuzm8s1ceuBUnMUAeoAHHw,6,5,2,0,1,0,3,0,11,1.5714285714285714,2,0.0,0,2,0,1,5,0,0,3,0,3,8,0
14428,135945,XmVfu8b0NT585Rk8rPE03AjpricGuNHv,SpATywNh6bZuzm8s1ceuBUnMUAeoAHHw,2,0,0,0,0,0,3,0,3,0.42857142857142855,1,0.0,0,0,0,0,0,0,0,3,0,0,3,1
14429,135962,sd2HYLRck3MQjoR7Fod62oDtNeNgK3C5,A3fsA9Zfv1X2fVEQhTw51lKENdNrEqT3,16,26,18,0,11,0,10,0,65,9.285714285714286,3,0.0,1,18,0,11,25,0,0,10,0,30,35,1
14430,135964,5IM8g7YMOYo5qH7Yu3x31T3JkVOH9iqe,5X6FeZozNMgE2VRi3MJYjkkFK8SETtu2,3,6,1,0,2,0,1,0,10,1.4285714285714286,3,0.0,4,1,0,2,2,0,0,1,0,7,3,1
14431,135969,QiJcxNGmLOdmB6eeGiBPeeCTz8AUKVVD,A3fsA9Zfv1X2fVEQhTw51lKENdNrEqT3,6,5,1,0,1,1,2,0,10,1.4285714285714286,2,0.0,0,1,0,1,5,1,0,2,0,2,8,1
14432,135979,EUmZ5qzjwgko2PIWEnctkvYh7APnUrX9,RXDvfPUBYFlVdlueBFbLW0mhhAyGEqpt,1,0,0,0,0,0,1,0,1,0.14285714285714285,1,0.0,0,0,0,0,0,0,0,1,0,0,1,1
14433,135990,0GwZKbglv2axpDLt9t1EIlEZPdi9oKMJ,SpATywNh6bZuzm8s1ceuBUnMUAeoAHHw,2,0,0,0,0,0,2,0,2,0.2857142857142857,1,0.0,0,0,0,0,0,0,0,2,0,0,2,1
14434,136004,XpLwBNjV7lkbo9HRLwBFqy6jHSpPfym2,SpATywNh6bZuzm8s1ceuBUnMUAeoAHHw,27,31,20,4,8,0,11,0,74,10.571428571428571,8,0.0,0,20,4,8,31,0,0,11,0,32,42,0
14435,136010,7bBbNS8igBUmtAlhgWeyPaLpz7A08m0l,7GRhBDsirIGkRZBtSMEzNTyDr2JQm4xx,23,43,18,35,16,2,3,0,117,16.714285714285715,2,0.0,21,18,31,16,22,2,4,3,0,86,31,1
14436,136012,LaO7E37BdY8VqMXTF49jfx8d5McZiaHN,bWdj2GDclj5ofokWjzoa5jAwMkxCykd6,6,6,0,0,1,0,3,0,10,1.4285714285714286,1,0.0,2,0,0,1,4,0,0,3,0,3,7,0
14437,136017,bxVkqjPmTpKkwZ9Y0agYRXY3zPgPsTDB,G8EPVSXsOYB5YQWZGiz1aVq5Pgr2GrQu,18,19,8,18,6,0,13,1,65,9.285714285714286,1,0.0,6,8,11,6,13,0,7,13,1,31,34,1
14438,136019,tsxz81bRlBY4gWUPDrcO93vpZmKMgcU8,5X6FeZozNMgE2VRi3MJYjkkFK8SETtu2,13,13,3,14,4,0,4,0,38,5.428571428571429,1,0.0,9,3,13,4,4,0,1,4,0,29,9,1
14439,136020,OEx9XlzSJPvCfbdzSv0p8sreAOhdWSET,bWdj2GDclj5ofokWjzoa5jAwMkxCykd6,5,3,1,0,0,5,3,0,12,1.7142857142857142,2,0.0,0,1,0,0,3,5,0,3,0,1,11,1
14440,136048,xWwql10Poq2nC5ehRq5ahsRV2QaMLare,SpATywNh6bZuzm8s1ceuBUnMUAeoAHHw,2,0,0,0,0,0,2,0,2,0.2857142857142857,1,0.0,0,0,0,0,0,0,0,2,0,0,2,0
14441,136056,jZ0eoqf68jVZDAR48vBfzauQgdjvrEqJ,G8EPVSXsOYB5YQWZGiz1aVq5Pgr2GrQu,20,44,1,50,0,0,3,0,98,14.0,1,0.0,23,1,31,0,21,0,19,3,0,55,43,1
14442,136060,K6gZA7sjhdZCSz3L5n4Avap9MqiCE3Mp,7GRhBDsirIGkRZBtSMEzNTyDr2JQm4xx,1,0,0,0,0,0,1,0,1,0.14285714285714285,1,0.0,0,0,0,0,0,0,0,1,0,0,1,1
14443,136074,MTeW6df78qysZ1Jvgm5EKkKFkGm6msW0,5X6FeZozNMgE2VRi3MJYjkkFK8SETtu2,4,2,1,0,0,0,2,0,5,0.7142857142857143,1,0.0,0,1,0,0,2,0,0,2,0,1,4,1
14444,136077,MTeW6df78qysZ1Jvgm5EKkKFkGm6msW0,RXDvfPUBYFlVdlueBFbLW0mhhAyGEqpt,5,0,0,0,0,1,6,1,8,1.1428571428571428,1,0.0,0,0,0,0,0,1,0,6,1,0,8,1
14445,136081,NXeIrAtl4TJPBDinWk0pYLhNqLRjiyXI,5X6FeZozNMgE2VRi3MJYjkkFK8SETtu2,6,3,2,0,1,0,2,0,8,1.1428571428571428,1,0.0,0,2,0,1,3,0,0,2,0,3,5,1
14446,136085,ISRJxWtuG9U7GF6GcMl2UZgUHAWLyOgM,A3fsA9Zfv1X2fVEQhTw51lKENdNrEqT3,12,6,4,0,3,7,15,3,38,5.428571428571429,5,0.0,0,4,0,3,6,7,0,15,3,7,31,0
14447,136086,ISRJxWtuG9U7GF6GcMl2UZgUHAWLyOgM,bWdj2GDclj5ofokWjzoa5jAwMkxCykd6,12,12,8,0,4,42,8,0,74,10.571428571428571,4,0.0,0,8,0,4,12,42,0,8,0,12,62,0
14448,136090,1ml1ZIUtZXpkL0JmFSahYiWnT7jKIk9A,7GRhBDsirIGkRZBtSMEzNTyDr2JQm4xx,35,100,41,64,23,28,14,4,274,39.142857142857146,4,0.0,49,41,58,23,51,28,6,14,4,171,103,1
14449,136095,uXyiNHzEVwnpCSssM0aWRjomS3dwzYaL,SpATywNh6bZuzm8s1ceuBUnMUAeoAHHw,13,20,0,0,0,0,2,0,22,3.142857142857143,1,0.0,3,0,0,0,17,0,0,2,0,3,19,0
14450,136110,4hir3Sv8g9bUyBqCpr3Vgjb1N07LRCPz,A3fsA9Zfv1X2fVEQhTw51lKENdNrEqT3,2,0,0,0,0,0,2,0,2,0.2857142857142857,1,0.0,0,0,0,0,0,0,0,2,0,0,2,1
14451,136114,3exvyw11zltqnBdt86hlE5k5NZvsKC1z,RXDvfPUBYFlVdlueBFbLW0mhhAyGEqpt,4,2,0,0,0,0,2,0,4,0.5714285714285714,1,0.0,0,0,0,0,2,0,0,2,0,0,4,1
14452,136120,tsxz81bRlBY4gWUPDrcO93vpZmKMgcU8,SpATywNh6bZuzm8s1ceuBUnMUAeoAHHw,4,3,2,0,1,0,1,0,7,1.0,1,0.0,0,2,0,1,3,0,0,1,0,3,4,1
14453,136130,666OQYHx8i8d2hinFlAK7dxUOOZcApAj,SpATywNh6bZuzm8s1ceuBUnMUAeoAHHw,1,0,0,0,0,0,1,0,1,0.14285714285714285,1,0.0,0,0,0,0,0,0,0,1,0,0,1,1
14454,136131,b4Feba3LJSWsgarojVs0WLNWDZ1jrcmd,SpATywNh6bZuzm8s1ceuBUnMUAeoAHHw,2,0,0,0,0,0,2,0,2,0.2857142857142857,1,0.0,0,0,0,0,0,0,0,2,0,0,2,1
14455,136136,xO7vYxMID7HxPGLvxbV5LQ1jK9mDso5R,SpATywNh6bZuzm8s1ceuBUnMUAeoAHHw,2,0,0,0,0,0,2,0,2,0.2857142857142857,1,0.0,0,0,0,0,0,0,0,2,0,0,2,1
14456,136148,RP2jV6jjwQkPvCJ29dWOhHWofGNeYm6i,SpATywNh6bZuzm8s1ceuBUnMUAeoAHHw,2,0,0,0,0,0,3,0,3,0.42857142857142855,1,0.0,0,0,0,0,0,0,0,3,0,0,3,1
14457,136150,7aQ6rvmUrAZhXOumaP4VW6FvjX4qSmMG,SpATywNh6bZuzm8s1ceuBUnMUAeoAHHw,28,24,15,14,7,4,3,0,67,9.571428571428571,2,0.0,6,15,14,7,18,4,0,3,0,42,25,1
14458,136153,UTOVD7URrJRdTcIox1GiNWQleZgjmsMx,SpATywNh6bZuzm8s1ceuBUnMUAeoAHHw,22,86,43,4,22,4,15,0,174,24.857142857142858,5,0.0,7,43,4,22,79,4,0,15,0,76,98,0
14459,136155,GgCLl5NjwqMgkh5JCvkbSguhpqbBPXLG,7GRhBDsirIGkRZBtSMEzNTyDr2JQm4xx,18,29,1,12,4,1,7,0,54,7.714285714285714,3,0.0,11,1,10,4,18,1,2,7,0,26,28,1
14460,136171,k78W30WU6hGeuM4l1VhrFhC8Jch0QJdh,A3fsA9Zfv1X2fVEQhTw51lKENdNrEqT3,19,11,1,30,0,4,8,1,55,7.857142857142857,1,0.0,2,1,27,0,9,4,3,8,1,30,25,1
14461,136180,UqksMVZ1lLvn2u7s6dT9SU5OFeNJnaAy,bWdj2GDclj5ofokWjzoa5jAwMkxCykd6,9,9,4,0,3,0,4,1,21,3.0,2,0.0,0,4,0,3,9,0,0,4,1,7,14,1
14462,136190,6AOP0TbDCcGOu9XhtyzhNlxsPVcDEYNy,bWdj2GDclj5ofokWjzoa5jAwMkxCykd6,7,5,1,0,0,0,2,0,8,1.1428571428571428,1,0.0,0,1,0,0,5,0,0,2,0,1,7,1
14463,136220,kJR7SORW78mX9yl9TvMAdIrYcwnnZz4r,7GRhBDsirIGkRZBtSMEzNTyDr2JQm4xx,27,62,30,28,11,0,6,0,137,19.571428571428573,4,0.0,28,30,28,11,34,0,0,6,0,97,40,1
14464,136245,Ovk8jBBHwwhBttek79ARCgIpAVxMH1wF,SpATywNh6bZuzm8s1ceuBUnMUAeoAHHw,4,3,1,0,1,0,1,0,6,0.8571428571428571,1,0.0,0,1,0,1,3,0,0,1,0,2,4,0
14465,136249,g53rlFGTNWSVgS4daSHwoJU8msIth7kH,5X6FeZozNMgE2VRi3MJYjkkFK8SETtu2,5,12,2,0,2,0,1,0,17,2.4285714285714284,1,0.0,1,2,0,2,11,0,0,1,0,5,12,1
14466,136257,8uSQsFhnhoJeSVZylwMfyqKR37MO9Qyr,SpATywNh6bZuzm8s1ceuBUnMUAeoAHHw,19,33,14,26,2,24,16,0,115,16.428571428571427,7,0.0,10,14,25,2,23,24,1,16,0,51,64,0
14467,136275,khelYX1bk51SSadsVaUzKR0zRRNCX0tK,7GRhBDsirIGkRZBtSMEzNTyDr2JQm4xx,37,99,36,121,1,0,21,1,279,39.857142857142854,5,0.0,49,36,109,1,50,0,12,21,1,195,84,1
14468,136280,1pbL8yRf5isuKA2AbZrt88AKZzNS9VL8,SpATywNh6bZuzm8s1ceuBUnMUAeoAHHw,6,6,4,0,3,0,4,0,17,2.4285714285714284,3,0.0,0,4,0,3,6,0,0,4,0,7,10,1
14469,136282,no2ug7TKVsupL4LU2a5jY2GhYHkskTdw,SpATywNh6bZuzm8s1ceuBUnMUAeoAHHw,30,44,27,18,14,1,11,0,115,16.428571428571427,6,0.0,7,27,17,14,37,1,1,11,0,65,50,0
14470,136298,wGXRcY0FS7DP9yn6e6xwYPxjUYuVv96W,SpATywNh6bZuzm8s1ceuBUnMUAeoAHHw,7,3,2,0,2,0,2,0,9,1.2857142857142858,1,0.0,0,2,0,2,3,0,0,2,0,4,5,1
14471,136299,4R8cjmGXnx8F1dFD5UPDPTI5U03hvnfJ,G8EPVSXsOYB5YQWZGiz1aVq5Pgr2GrQu,14,11,9,0,8,0,8,1,37,5.285714285714286,2,0.0,0,9,0,8,11,0,0,8,1,17,20,1
14472,136328,hPJzs2Znzz5zy7cTuvUrQwTmAG1EpX7Y,SpATywNh6bZuzm8s1ceuBUnMUAeoAHHw,1,0,0,0,0,0,1,0,1,0.14285714285714285,1,0.0,0,0,0,0,0,0,0,1,0,0,1,1
14473,136336,QcbB4zGNvIA8Hos1EmgULZPHy4JycNs5,bWdj2GDclj5ofokWjzoa5jAwMkxCykd6,1,0,0,0,0,0,1,0,1,0.14285714285714285,1,0.0,0,0,0,0,0,0,0,1,0,0,1,0
14474,136338,QcbB4zGNvIA8Hos1EmgULZPHy4JycNs5,A3fsA9Zfv1X2fVEQhTw51lKENdNrEqT3,1,0,0,0,0,0,1,0,1,0.14285714285714285,1,0.0,0,0,0,0,0,0,0,1,0,0,1,0
14475,136339,xFOMKgrHGqKyL5uPk9RcNRWczzZxvoeN,SpATywNh6bZuzm8s1ceuBUnMUAeoAHHw,1,0,0,0,0,0,1,0,1,0.14285714285714285,1,0.0,0,0,0,0,0,0,0,1,0,0,1,1
14476,136346,xFOMKgrHGqKyL5uPk9RcNRWczzZxvoeN,5X6FeZozNMgE2VRi3MJYjkkFK8SETtu2,1,0,0,0,0,0,1,0,1,0.14285714285714285,1,0.0,0,0,0,0,0,0,0,1,0,0,1,1
14477,136349,xFOMKgrHGqKyL5uPk9RcNRWczzZxvoeN,bWdj2GDclj5ofokWjzoa5jAwMkxCykd6,1,0,0,0,0,0,1,0,1,0.14285714285714285,1,0.0,0,0,0,0,0,0,0,1,0,0,1,1
14478,136352,xFOMKgrHGqKyL5uPk9RcNRWczzZxvoeN,G8EPVSXsOYB5YQWZGiz1aVq5Pgr2GrQu,1,0,0,0,0,0,1,0,1,0.14285714285714285,1,0.0,0,0,0,0,0,0,0,1,0,0,1,1
14479,136355,xFOMKgrHGqKyL5uPk9RcNRWczzZxvoeN,A3fsA9Zfv1X2fVEQhTw51lKENdNrEqT3,1,0,0,0,0,0,1,0,1,0.14285714285714285,1,0.0,0,0,0,0,0,0,0,1,0,0,1,1
14480,136362,Mw4t3dXzBgtXgl1Dgl3JStk2pBYNem1r,5X6FeZozNMgE2VRi3MJYjkkFK8SETtu2,5,10,1,0,2,0,17,0,30,4.285714285714286,2,0.0,3,1,0,2,7,0,0,17,0,6,24,1
14481,136368,3RPGU51kghTa1yQ8sk1JkQkDTlLpjaeu,A3fsA9Zfv1X2fVEQhTw51lKENdNrEqT3,37,28,3,64,2,0,8,0,105,15.0,4,0.0,3,3,50,2,25,0,14,8,0,58,47,1
14482,136382,j9lNHQGLA7OPE7lvH45cTyJTdanzS09h,A3fsA9Zfv1X2fVEQhTw51lKENdNrEqT3,11,5,4,0,4,0,2,0,15,2.142857142857143,1,0.0,0,4,0,4,5,0,0,2,0,8,7,1
14483,136386,FM7LvWy0SQdmiC09CRsUT44n0BqWWa2S,SpATywNh6bZuzm8s1ceuBUnMUAeoAHHw,26,103,30,0,23,0,13,0,169,24.142857142857142,9,0.0,0,30,0,23,103,0,0,13,0,53,116,0
14484,136409,ljhfk5EzYux6UZXtMstOyqxrBX64Rvre,SpATywNh6bZuzm8s1ceuBUnMUAeoAHHw,3,2,0,0,0,0,7,0,9,1.2857142857142858,1,0.0,0,0,0,0,2,0,0,7,0,0,9,0
14485,136410,4veNYFa5yTlgZEZ3CkxGfwseJV8Djm6t,bWdj2GDclj5ofokWjzoa5jAwMkxCykd6,9,10,1,0,0,0,11,0,22,3.142857142857143,3,0.0,0,1,0,0,10,0,0,11,0,1,21,1
14486,136411,AUmfgp7YjPBzDSEEKYtmp5NT1ZaUbwCu,A3fsA9Zfv1X2fVEQhTw51lKENdNrEqT3,138,114,77,328,47,50,25,3,644,92.0,6,0.0,8,77,281,47,106,50,47,25,3,413,231,0
14487,136420,8jpbZSOP0aE5k9lcpChp2bvVbSS59iit,SpATywNh6bZuzm8s1ceuBUnMUAeoAHHw,36,30,20,28,15,0,6,1,100,14.285714285714286,2,0.0,7,20,23,15,23,0,5,6,1,65,35,0
14488,136421,hB4yTUnQMne1LtjUUKgpcnhj6jq7S5Co,SpATywNh6bZuzm8s1ceuBUnMUAeoAHHw,58,78,42,28,22,1,19,0,190,27.142857142857142,9,0.0,16,42,27,22,62,1,1,19,0,107,83,0
14489,136422,4veNYFa5yTlgZEZ3CkxGfwseJV8Djm6t,A3fsA9Zfv1X2fVEQhTw51lKENdNrEqT3,41,31,4,82,7,0,7,0,131,18.714285714285715,2,0.0,4,4,70,7,27,0,12,7,0,85,46,0
14490,136425,jM1yIagOMV2CwD8o07UMrVdo7z0hqKJ4,5X6FeZozNMgE2VRi3MJYjkkFK8SETtu2,6,19,10,0,1,4,7,0,41,5.857142857142857,5,0.0,1,10,0,1,18,4,0,7,0,12,29,0
14491,136435,weCw07EYZU6NaXQgOr28J3dXwtDDCJwg,5X6FeZozNMgE2VRi3MJYjkkFK8SETtu2,6,3,2,0,2,0,1,0,8,1.1428571428571428,1,0.0,0,2,0,2,3,0,0,1,0,4,4,1
14492,136438,HyMGoDUSgioYVPglnQqdB8DhnJM0oHcU,A3fsA9Zfv1X2fVEQhTw51lKENdNrEqT3,1,0,0,0,0,0,1,0,1,0.14285714285714285,1,0.0,0,0,0,0,0,0,0,1,0,0,1,1
14493,136440,DVIil2NM7ZWOtqe6rhlMzwEUAb2wuaeh,5X6FeZozNMgE2VRi3MJYjkkFK8SETtu2,1,0,0,0,0,0,1,0,1,0.14285714285714285,1,0.0,0,0,0,0,0,0,0,1,0,0,1,1
14494,136442,TOTNiRasgzo7kH1hlyiehLV3DbzVA61v,7GRhBDsirIGkRZBtSMEzNTyDr2JQm4xx,56,81,20,104,25,56,25,0,311,44.42857142857143,5,0.0,56,20,87,25,25,56,17,25,0,188,123,1
14495,136446,weCw07EYZU6NaXQgOr28J3dXwtDDCJwg,RXDvfPUBYFlVdlueBFbLW0mhhAyGEqpt,9,4,3,0,3,0,2,0,12,1.7142857142857142,1,0.0,0,3,0,3,4,0,0,2,0,6,6,1
14496,136447,ecut1h0rhjLzcs1jrL1hILYqwNtlJCKC,7GRhBDsirIGkRZBtSMEzNTyDr2JQm4xx,59,176,55,100,27,16,17,1,392,56.0,6,0.0,62,55,95,27,114,16,5,17,1,239,153,1
14497,136460,66UIy9DsqvecX9deVURN28A6eUmaxM2O,7GRhBDsirIGkRZBtSMEzNTyDr2JQm4xx,7,3,1,0,1,2,8,0,15,2.142857142857143,2,0.0,0,1,0,1,3,2,0,8,0,2,13,1
14498,136461,hZR4MwcYec4g0GoOyJFngJGEyWOySpv2,5X6FeZozNMgE2VRi3MJYjkkFK8SETtu2,7,6,3,4,1,36,16,0,66,9.428571428571429,7,0.0,1,3,3,1,5,36,1,16,0,8,58,0
14499,136466,qXoRddrZtWOuvSZYQLEOpoSpuxUBUiL4,A3fsA9Zfv1X2fVEQhTw51lKENdNrEqT3,1,0,0,0,0,0,1,0,1,0.14285714285714285,1,0.0,0,0,0,0,0,0,0,1,0,0,1,1
14500,136473,uKUfxynVzKG6LprgAyIbTEdFcLOGHJ0Q,SpATywNh6bZuzm8s1ceuBUnMUAeoAHHw,11,13,1,4,1,0,3,0,22,3.142857142857143,2,0.0,0,1,3,1,13,0,1,3,0,5,17,0
14501,136478,TOr969xO1bNpukaioQsMN4lfT6tTyvHI,SpATywNh6bZuzm8s1ceuBUnMUAeoAHHw,37,51,22,16,14,0,16,0,119,17.0,3,0.0,7,22,14,14,44,0,2,16,0,57,62,0
14502,136483,uPKlyTEifU6j6OWoUY390CiDaPPnL9qV,SpATywNh6bZuzm8s1ceuBUnMUAeoAHHw,6,1,1,0,1,0,3,0,6,0.8571428571428571,1,0.0,0,1,0,1,1,0,0,3,0,2,4,1
14503,136485,TgUwmkEhin9XZ6XzvWTyPMnTPIOGlXFZ,SpATywNh6bZuzm8s1ceuBUnMUAeoAHHw,2,0,0,0,0,0,2,0,2,0.2857142857142857,1,0.0,0,0,0,0,0,0,0,2,0,0,2,0
14504,136491,NcracMTfiaTPMbO6SSDnt9CDc4SnvBs9,7GRhBDsirIGkRZBtSMEzNTyDr2JQm4xx,12,29,7,0,7,0,2,0,45,6.428571428571429,1,0.0,21,7,0,7,8,0,0,2,0,35,10,1
14505,136493,g7heOlGZNASGuqQAq1vtv2tfdSi2ygyQ,SpATywNh6bZuzm8s1ceuBUnMUAeoAHHw,8,2,1,0,1,1,5,1,11,1.5714285714285714,1,0.0,0,1,0,1,2,1,0,5,1,2,9,1
14506,136494,63wtRrFP2u8VxjDoieh7TgM1REKECzZu,SpATywNh6bZuzm8s1ceuBUnMUAeoAHHw,1,0,0,0,0,0,1,0,1,0.14285714285714285,1,0.0,0,0,0,0,0,0,0,1,0,0,1,1
14507,136495,EbKjJZq8GOECUxJBvCCbIZN8O8RweU4z,A3fsA9Zfv1X2fVEQhTw51lKENdNrEqT3,6,5,2,0,1,0,3,0,11,1.5714285714285714,2,0.0,0,2,0,1,5,0,0,3,0,3,8,1
14508,136501,GuXg5t1KOGV3M6CZF2IvtkvJXCDk9jtc,SpATywNh6bZuzm8s1ceuBUnMUAeoAHHw,11,10,1,0,1,1,9,1,23,3.2857142857142856,1,0.0,0,1,0,1,10,1,0,9,1,2,21,1
14509,136513,hZR4MwcYec4g0GoOyJFngJGEyWOySpv2,bWdj2GDclj5ofokWjzoa5jAwMkxCykd6,9,12,8,0,2,14,9,0,45,6.428571428571429,3,0.0,1,8,0,2,11,14,0,9,0,11,34,0
14510,136514,ODBJIDcvWCzkG2XoiGFYE0mdoqG7tfRb,7GRhBDsirIGkRZBtSMEzNTyDr2JQm4xx,2,0,0,0,0,0,2,0,2,0.2857142857142857,1,0.0,0,0,0,0,0,0,0,2,0,0,2,1
14511,136521,i15PHia6n9agkYRoEhdWcUwrhqvX8pmC,7GRhBDsirIGkRZBtSMEzNTyDr2JQm4xx,1,0,0,0,0,0,1,0,1,0.14285714285714285,1,0.0,0,0,0,0,0,0,0,1,0,0,1,1
14512,136522,GmS9IJ1tMx7OD6choQVEGJmTtycHZhqQ,bWdj2GDclj5ofokWjzoa5jAwMkxCykd6,1,0,0,0,0,0,1,0,1,0.14285714285714285,1,0.0,0,0,0,0,0,0,0,1,0,0,1,1
14513,136528,rv34ybrhOrkX6Z4MXzYyRTcPq51q6XCl,SpATywNh6bZuzm8s1ceuBUnMUAeoAHHw,9,21,12,0,6,0,12,0,51,7.285714285714286,2,0.0,0,12,0,6,21,0,0,12,0,18,33,1
14514,136529,jia7n6yiGa4HNwul2FwX7WuWnOCMgFMl,7GRhBDsirIGkRZBtSMEzNTyDr2JQm4xx,21,39,10,21,6,5,1,0,82,11.714285714285714,1,0.0,27,10,21,6,12,5,0,1,0,64,18,1
14515,136530,hZR4MwcYec4g0GoOyJFngJGEyWOySpv2,G8EPVSXsOYB5YQWZGiz1aVq5Pgr2GrQu,20,32,15,0,9,16,14,0,86,12.285714285714286,3,0.0,9,15,0,9,23,16,0,14,0,33,53,0
14516,136533,ZC5rnhfF0O0RN6wj4xnmSbFJHTipD7b4,7GRhBDsirIGkRZBtSMEzNTyDr2JQm4xx,2,0,0,0,0,0,2,0,2,0.2857142857142857,1,0.0,0,0,0,0,0,0,0,2,0,0,2,1
14517,136538,8jpbZSOP0aE5k9lcpChp2bvVbSS59iit,RXDvfPUBYFlVdlueBFbLW0mhhAyGEqpt,1,0,0,0,0,0,1,0,1,0.14285714285714285,1,0.0,0,0,0,0,0,0,0,1,0,0,1,1
14518,136558,Cv1aavObJnuABKfipF6OGePzg0BnGPFs,7GRhBDsirIGkRZBtSMEzNTyDr2JQm4xx,8,6,3,4,0,0,4,0,17,2.4285714285714284,1,0.0,3,3,4,0,3,0,0,4,0,10,7,1
14519,136559,6MMO6p1gWBmDJN4eS7QrAi6Zg4mTPljX,G8EPVSXsOYB5YQWZGiz1aVq5Pgr2GrQu,14,30,0,4,1,2,11,0,48,6.857142857142857,4,0.0,10,0,3,1,20,2,1,11,0,14,34,0
14520,136562,UUf7W9nrVz0icOeIhIvztvvypaJKgHhN,SpATywNh6bZuzm8s1ceuBUnMUAeoAHHw,27,32,17,29,4,0,16,0,98,14.0,9,0.0,6,17,27,4,26,0,2,16,0,54,44,1
14521,136566,wamlK8Nx9pa9kXzI19EF5HF3fhJv3sWN,7GRhBDsirIGkRZBtSMEzNTyDr2JQm4xx,4,2,0,0,0,0,2,0,4,0.5714285714285714,1,0.0,0,0,0,0,2,0,0,2,0,0,4,1
14522,136568,JHhY30IKFzw4LWcyrHuTEglWNqRkqdDU,5X6FeZozNMgE2VRi3MJYjkkFK8SETtu2,55,28,11,159,1,0,6,0,205,29.285714285714285,2,0.0,17,11,143,1,11,0,16,6,0,172,33,1
14523,136570,2GOnPZDHl4kPVWWzVJnEzynacGNkygXw,A3fsA9Zfv1X2fVEQhTw51lKENdNrEqT3,11,7,5,0,3,0,4,0,19,2.7142857142857144,1,0.0,0,5,0,3,7,0,0,4,0,8,11,0
14524,136571,fJnj3Gs4y1E0GRQDA0b4nicT5IqNhAL7,A3fsA9Zfv1X2fVEQhTw51lKENdNrEqT3,1,0,0,0,0,0,1,0,1,0.14285714285714285,1,0.0,0,0,0,0,0,0,0,1,0,0,1,1
14525,136576,wmN4PPC7Vh1X3pevAvwrqSI7HI55oZD6,A3fsA9Zfv1X2fVEQhTw51lKENdNrEqT3,34,19,12,50,9,0,14,1,105,15.0,2,0.0,1,12,46,9,18,0,4,14,1,68,37,1
14526,136586,XvNNzv39b8VqKid0q4fV9ms2wVNAdWks,7GRhBDsirIGkRZBtSMEzNTyDr2JQm4xx,3,3,1,0,0,0,2,0,6,0.8571428571428571,2,0.0,0,1,0,0,3,0,0,2,0,1,5,1
14527,136588,KdKmzuUNmhXxN946vW23lms2nowQCTiW,7GRhBDsirIGkRZBtSMEzNTyDr2JQm4xx,6,0,0,0,0,0,17,2,19,2.7142857142857144,1,0.0,0,0,0,0,0,0,0,17,2,0,19,1
14528,136591,o0iuVvrYPTZySn5yEHYo73kuRxBFTMxe,SpATywNh6bZuzm8s1ceuBUnMUAeoAHHw,1,0,0,0,0,0,1,0,1,0.14285714285714285,1,0.0,0,0,0,0,0,0,0,1,0,0,1,1
14529,136594,QRtm7L0oKi8rvP2PG9liN1Ys67kuGLCZ,RXDvfPUBYFlVdlueBFbLW0mhhAyGEqpt,1,0,0,0,0,0,1,0,1,0.14285714285714285,1,0.0,0,0,0,0,0,0,0,1,0,0,1,1
14530,136597,iahhmqoMx53j5nO5miK92n3wdWI8ut4z,SpATywNh6bZuzm8s1ceuBUnMUAeoAHHw,7,5,4,0,4,2,5,0,20,2.857142857142857,3,0.0,0,4,0,4,5,2,0,5,0,8,12,0
14531,136610,Cv1aavObJnuABKfipF6OGePzg0BnGPFs,5X6FeZozNMgE2VRi3MJYjkkFK8SETtu2,54,30,10,78,1,0,8,0,127,18.142857142857142,3,0.0,17,10,78,1,13,0,0,8,0,106,21,1
14532,136611,X7TCdJnOYqrDdC7umXZiC7RNUdfK8e7D,7GRhBDsirIGkRZBtSMEzNTyDr2JQm4xx,5,3,1,0,1,0,1,0,6,0.8571428571428571,1,0.0,0,1,0,1,3,0,0,1,0,2,4,1
14533,136615,Cv1aavObJnuABKfipF6OGePzg0BnGPFs,RXDvfPUBYFlVdlueBFbLW0mhhAyGEqpt,78,45,25,111,1,3,15,0,200,28.571428571428573,3,0.0,18,25,111,1,27,3,0,15,0,155,45,1
14534,136620,bfFEc23kVgHyKqDcshH2CO7qZiUnZhfQ,bWdj2GDclj5ofokWjzoa5jAwMkxCykd6,7,7,4,0,2,1,1,0,15,2.142857142857143,2,0.0,0,4,0,2,7,1,0,1,0,6,9,1
14535,136641,ndSSvoqRP9UOBqRicNUijfD0pPNDqiTJ,7GRhBDsirIGkRZBtSMEzNTyDr2JQm4xx,70,149,84,83,87,3,36,2,444,63.42857142857143,10,0.0,56,84,78,87,93,3,5,36,2,305,139,0
14536,136643,z408zpaGYl7G62VwJXlIGs5keiUdQ81y,SpATywNh6bZuzm8s1ceuBUnMUAeoAHHw,1,0,0,0,0,0,1,0,1,0.14285714285714285,1,0.0,0,0,0,0,0,0,0,1,0,0,1,1
14537,136647,3Jrj6bKUtFj34BYovmjDUontE8TUY429,SpATywNh6bZuzm8s1ceuBUnMUAeoAHHw,22,26,9,10,6,4,11,1,67,9.571428571428571,2,0.0,10,9,8,6,16,4,2,11,1,33,34,1
14538,136653,LlgrfCdWy7IdZo4zpIOZQ4vT5Xv5Wwbk,5X6FeZozNMgE2VRi3MJYjkkFK8SETtu2,1,0,0,0,0,0,1,0,1,0.14285714285714285,1,0.0,0,0,0,0,0,0,0,1,0,0,1,1
14539,136656,KN2cc8h9ZKfIgxIX3NczsQQI5NEtrUt5,SpATywNh6bZuzm8s1ceuBUnMUAeoAHHw,1,0,0,0,0,0,1,0,1,0.14285714285714285,1,0.0,0,0,0,0,0,0,0,1,0,0,1,0
14540,136658,i6Z64SjIvtG8bIYKBDvv4gEAv5H6yeWe,7GRhBDsirIGkRZBtSMEzNTyDr2JQm4xx,1,0,0,0,0,0,2,0,2,0.2857142857142857,1,0.0,0,0,0,0,0,0,0,2,0,0,2,1
14541,136669,j54JBLGJIJ4pHZN5w24SsPoFU8DYGtev,SpATywNh6bZuzm8s1ceuBUnMUAeoAHHw,33,46,20,26,16,0,7,0,115,16.428571428571427,3,0.0,9,20,23,16,37,0,3,7,0,68,47,0
14542,136675,uQ8WwfJ7Kl3wLihefH5YIiAfDrgYf8YH,bWdj2GDclj5ofokWjzoa5jAwMkxCykd6,14,21,3,0,4,3,4,0,35,5.0,3,0.0,4,3,0,4,17,3,0,4,0,11,24,1
14543,136676,Qcmt6nwyac7kgzMGN63sluFXEZK788J1,A3fsA9Zfv1X2fVEQhTw51lKENdNrEqT3,1,0,0,0,0,0,1,0,1,0.14285714285714285,1,0.0,0,0,0,0,0,0,0,1,0,0,1,1
14544,136682,ZaYBly9HAeW4dviaZWb57mDYf3bYgYN7,A3fsA9Zfv1X2fVEQhTw51lKENdNrEqT3,9,2,2,0,2,0,8,1,15,2.142857142857143,1,0.0,0,2,0,2,2,0,0,8,1,4,11,1
14545,136683,J3FKLxbUlPTor4lyG8lMpHc8oUQEjfcp,RXDvfPUBYFlVdlueBFbLW0mhhAyGEqpt,54,85,45,14,36,8,29,2,219,31.285714285714285,8,0.0,11,45,13,36,74,8,1,29,2,105,114,0
14546,136686,ukPe6HZ0ITB9hheAlC2b7rfm3linyaBd,5X6FeZozNMgE2VRi3MJYjkkFK8SETtu2,1,0,0,0,0,0,1,0,1,0.14285714285714285,1,0.0,0,0,0,0,0,0,0,1,0,0,1,1
14547,136693,fylXIx1ixG3vXbV9AuGqPT7SpNyyk9u6,5X6FeZozNMgE2VRi3MJYjkkFK8SETtu2,6,7,0,0,0,0,2,0,9,1.2857142857142858,1,0.0,0,0,0,0,7,0,0,2,0,0,9,1
14548,136696,k6RJ44LpfDefc4BqSfb5Ks3bqRLzpbPs,bWdj2GDclj5ofokWjzoa5jAwMkxCykd6,6,3,0,0,0,0,4,0,7,1.0,1,0.0,0,0,0,0,3,0,0,4,0,0,7,1
14549,136697,ZbpLZuhcPXDt8MCBlzIEU31Qmn57Ldle,G8EPVSXsOYB5YQWZGiz1aVq5Pgr2GrQu,75,75,28,222,18,0,8,0,351,50.142857142857146,7,0.0,41,28,178,18,34,0,44,8,0,265,86,0
14550,136700,8rUphvLiXZqbGu38CKKOCcJ5A3GrLiLP,5X6FeZozNMgE2VRi3MJYjkkFK8SETtu2,8,22,7,0,2,0,4,0,35,5.0,2,0.0,0,7,0,2,22,0,0,4,0,9,26,1
14551,136701,0Vr5nGGnd8VQ31kkuDTufqDyRIq6gvkS,RXDvfPUBYFlVdlueBFbLW0mhhAyGEqpt,100,142,56,140,41,2,13,0,394,56.285714285714285,4,0.0,33,56,138,41,109,2,2,13,0,268,126,1
14552,136707,UbbAGEN2mQZMJ0AqNca8pK3Yb0j4mf0a,5X6FeZozNMgE2VRi3MJYjkkFK8SETtu2,1,0,0,0,0,0,2,0,2,0.2857142857142857,1,0.0,0,0,0,0,0,0,0,2,0,0,2,1
14553,136709,gx5zIbRkvVmYAkHaGQMR5zm5BpTwVwIe,A3fsA9Zfv1X2fVEQhTw51lKENdNrEqT3,13,10,1,8,0,0,3,0,22,3.142857142857143,2,0.0,0,1,7,0,10,0,1,3,0,8,14,0
14554,136712,fnlh0vT4Ypc7FeWWn0jzqbr2uXSv59hi,A3fsA9Zfv1X2fVEQhTw51lKENdNrEqT3,2,0,0,0,0,0,2,0,2,0.2857142857142857,1,0.0,0,0,0,0,0,0,0,2,0,0,2,1
14555,136714,8mWm5xzce8wK28AEpPpWzDCgRcswbNyu,RXDvfPUBYFlVdlueBFbLW0mhhAyGEqpt,12,8,5,0,3,1,5,1,23,3.2857142857142856,1,0.0,2,5,0,3,6,1,0,5,1,10,13,1
14556,136732,SVZqJHiWjzEAtrLc64poVCOKM6DkmsSo,5X6FeZozNMgE2VRi3MJYjkkFK8SETtu2,4,2,0,0,0,0,2,0,4,0.5714285714285714,2,0.0,0,0,0,0,2,0,0,2,0,0,4,1
14557,136738,SsiBwdLtgBlftQTMaumuPfeXEp9eUN1X,A3fsA9Zfv1X2fVEQhTw51lKENdNrEqT3,11,7,5,0,2,0,5,0,19,2.7142857142857144,1,0.0,0,5,0,2,7,0,0,5,0,7,12,1
14558,136749,bmxQ66AsItv9EBQTswW4vQGNA82BElw3,SpATywNh6bZuzm8s1ceuBUnMUAeoAHHw,7,11,5,0,2,0,2,0,20,2.857142857142857,1,0.0,0,5,0,2,11,0,0,2,0,7,13,1
14559,136761,WrTcJrUgklWyxOaBnf20Rowk6qaKbzit,SpATywNh6bZuzm8s1ceuBUnMUAeoAHHw,8,3,2,0,2,0,4,0,11,1.5714285714285714,1,0.0,0,2,0,2,3,0,0,4,0,4,7,1
14560,136765,Jpxsd7AQ90urdftfAf3y5kTy6w3x8OIk,7GRhBDsirIGkRZBtSMEzNTyDr2JQm4xx,1,0,0,0,0,0,1,0,1,0.14285714285714285,1,0.0,0,0,0,0,0,0,0,1,0,0,1,1
14561,136784,3gjsZAnS1zBXs93F1SFYpXewdnodPnot,SpATywNh6bZuzm8s1ceuBUnMUAeoAHHw,11,14,7,0,5,4,11,1,42,6.0,2,0.0,0,7,0,5,14,4,0,11,1,12,30,1
14562,136789,78OI7ZWst9j81Ckpf0W24CIpBfLrKIYQ,SpATywNh6bZuzm8s1ceuBUnMUAeoAHHw,1,0,0,0,0,0,1,0,1,0.14285714285714285,1,0.0,0,0,0,0,0,0,0,1,0,0,1,1
14563,136798,i8t7Go6rdZ7c7uD9bC7IIvAKxqbWTCzk,7GRhBDsirIGkRZBtSMEzNTyDr2JQm4xx,9,10,3,0,3,0,4,0,20,2.857142857142857,1,0.0,0,3,0,3,10,0,0,4,0,6,14,1
14564,136800,8rUphvLiXZqbGu38CKKOCcJ5A3GrLiLP,SpATywNh6bZuzm8s1ceuBUnMUAeoAHHw,4,4,0,0,0,0,2,0,6,0.8571428571428571,1,0.0,1,0,0,0,3,0,0,2,0,1,5,0
14565,136805,WrTcJrUgklWyxOaBnf20Rowk6qaKbzit,RXDvfPUBYFlVdlueBFbLW0mhhAyGEqpt,1,0,0,0,0,0,1,0,1,0.14285714285714285,1,0.0,0,0,0,0,0,0,0,1,0,0,1,1
14566,136808,yBHGUjuGWSAO5vgDHwIPJCcfy3rr5zp9,bWdj2GDclj5ofokWjzoa5jAwMkxCykd6,1,0,0,0,0,0,1,0,1,0.14285714285714285,1,0.0,0,0,0,0,0,0,0,1,0,0,1,0
14567,136811,MgBJbfRXH0QNEJmIiGY28SpmFvbhxSoF,7GRhBDsirIGkRZBtSMEzNTyDr2JQm4xx,4,2,0,0,0,1,3,0,6,0.8571428571428571,2,0.0,0,0,0,0,2,1,0,3,0,0,6,1
14568,136823,LKQx76DscP8cMaadDZLCOsushv3ygeRX,A3fsA9Zfv1X2fVEQhTw51lKENdNrEqT3,1,0,0,0,0,0,1,0,1,0.14285714285714285,1,0.0,0,0,0,0,0,0,0,1,0,0,1,0
14569,136845,OmBhuxpgNHza1UgJ4sJoDmhlFXyn8dEO,SpATywNh6bZuzm8s1ceuBUnMUAeoAHHw,37,121,18,52,10,1,28,3,233,33.285714285714285,7,0.0,20,18,44,10,101,1,8,28,3,92,141,0
14570,136893,Oq4muIuPqX11q3v3A24DkHmXbw9NrZW6,SpATywNh6bZuzm8s1ceuBUnMUAeoAHHw,5,3,0,0,0,0,2,0,5,0.7142857142857143,1,0.0,0,0,0,0,3,0,0,2,0,0,5,1
14571,136895,a9TBP79htFPYcv3LD77KH0Nt4oybRXBR,bWdj2GDclj5ofokWjzoa5jAwMkxCykd6,5,4,3,0,0,0,3,2,12,1.7142857142857142,1,0.0,0,3,0,0,4,0,0,3,2,3,9,1
14572,136896,0CZrf1rdgKFCFIVyDqGwyjQ94p1TBewg,SpATywNh6bZuzm8s1ceuBUnMUAeoAHHw,15,24,1,18,1,19,22,2,87,12.428571428571429,4,0.0,5,1,16,1,19,19,2,22,2,23,64,1
14573,136899,24JoyBPXMOnmsLOfMafb36RTU9UCRDoT,SpATywNh6bZuzm8s1ceuBUnMUAeoAHHw,1,0,0,0,0,0,1,0,1,0.14285714285714285,1,0.0,0,0,0,0,0,0,0,1,0,0,1,1
14574,136903,a9TBP79htFPYcv3LD77KH0Nt4oybRXBR,SpATywNh6bZuzm8s1ceuBUnMUAeoAHHw,7,6,5,0,0,0,2,0,13,1.8571428571428572,1,0.0,0,5,0,0,6,0,0,2,0,5,8,1
14575,136925,nWxqZ9qOnSiwmKKTQWD8DHRfGKfO0Peo,SpATywNh6bZuzm8s1ceuBUnMUAeoAHHw,18,18,15,0,7,0,6,0,46,6.571428571428571,2,0.0,0,15,0,7,18,0,0,6,0,22,24,1
14576,136938,efygWYkxxUMOGInRZT4qEeuzMRlIpQq6,G8EPVSXsOYB5YQWZGiz1aVq5Pgr2GrQu,1,0,0,0,0,0,1,0,1,0.14285714285714285,1,0.0,0,0,0,0,0,0,0,1,0,0,1,1
14577,136943,r7oxHVTNN8doW10wgne7GkgxiedysXDT,A3fsA9Zfv1X2fVEQhTw51lKENdNrEqT3,9,7,3,0,2,0,5,0,17,2.4285714285714284,3,0.0,0,3,0,2,7,0,0,5,0,5,12,1
14578,136949,BJcIgaOnWdAOKf7jzUg9DKOlERmjwn2s,SpATywNh6bZuzm8s1ceuBUnMUAeoAHHw,1,0,0,0,0,0,1,0,1,0.14285714285714285,1,0.0,0,0,0,0,0,0,0,1,0,0,1,1
14579,136955,tBidKjiqQ5KFuEaFTLCdOSCSZAqiqEig,RXDvfPUBYFlVdlueBFbLW0mhhAyGEqpt,7,2,2,0,1,0,7,0,12,1.7142857142857142,1,0.0,0,2,0,1,2,0,0,7,0,3,9,1
14580,136961,Cx9UgN9CA3ZQNCspfULD8FGJJpSFtxJF,bWdj2GDclj5ofokWjzoa5jAwMkxCykd6,75,108,61,168,24,8,39,3,411,58.714285714285715,9,0.0,25,61,156,24,83,8,12,39,3,266,145,0
14581,136963,BJcIgaOnWdAOKf7jzUg9DKOlERmjwn2s,bWdj2GDclj5ofokWjzoa5jAwMkxCykd6,1,0,0,0,0,0,1,0,1,0.14285714285714285,1,0.0,0,0,0,0,0,0,0,1,0,0,1,1
14582,136966,BJcIgaOnWdAOKf7jzUg9DKOlERmjwn2s,G8EPVSXsOYB5YQWZGiz1aVq5Pgr2GrQu,1,0,0,0,0,0,1,0,1,0.14285714285714285,1,0.0,0,0,0,0,0,0,0,1,0,0,1,1
14583,136967,BJcIgaOnWdAOKf7jzUg9DKOlERmjwn2s,RXDvfPUBYFlVdlueBFbLW0mhhAyGEqpt,1,0,0,0,0,0,1,0,1,0.14285714285714285,1,0.0,0,0,0,0,0,0,0,1,0,0,1,1
14584,136970,BJcIgaOnWdAOKf7jzUg9DKOlERmjwn2s,A3fsA9Zfv1X2fVEQhTw51lKENdNrEqT3,1,0,0,0,0,0,1,0,1,0.14285714285714285,1,0.0,0,0,0,0,0,0,0,1,0,0,1,1
14585,136981,AJ67zJxwtIT663v0SjoBzB1oAmD7q2P6,SpATywNh6bZuzm8s1ceuBUnMUAeoAHHw,4,2,0,0,0,0,3,0,5,0.7142857142857143,1,0.0,0,0,0,0,2,0,0,3,0,0,5,1
14586,136988,9580xqem5skLGzPdMFTPdLPT5HlErJVM,bWdj2GDclj5ofokWjzoa5jAwMkxCykd6,3,0,0,0,0,6,3,0,9,1.2857142857142858,2,0.0,0,0,0,0,0,6,0,3,0,0,9,1
14587,136994,UaiNqahLufAkWkzNVXpp9zyadIeXFDQ2,7GRhBDsirIGkRZBtSMEzNTyDr2JQm4xx,2,0,0,0,0,0,4,0,4,0.5714285714285714,1,0.0,0,0,0,0,0,0,0,4,0,0,4,1
14588,136997,azSMvYaBlxi8sVQgX0j44wgyxslA1ZOv,bWdj2GDclj5ofokWjzoa5jAwMkxCykd6,34,21,8,48,8,61,8,0,154,22.0,2,0.0,10,8,37,8,11,61,11,8,0,63,91,0
14589,137001,wy2vY5aiYwg0C5zglGAXrG2vaWLSbGC9,A3fsA9Zfv1X2fVEQhTw51lKENdNrEqT3,7,5,1,0,1,0,1,0,8,1.1428571428571428,1,0.0,0,1,0,1,5,0,0,1,0,2,6,1
14590,137007,1vvo0r6a7F7cnmAi2geIjNYeLW8STOBo,bWdj2GDclj5ofokWjzoa5jAwMkxCykd6,49,57,22,99,1,56,27,3,265,37.857142857142854,5,0.0,16,22,92,1,41,56,7,27,3,131,134,0
14591,137015,C7bvV9WgtivYIxdtA0RvlWoiA6KPa8KB,A3fsA9Zfv1X2fVEQhTw51lKENdNrEqT3,9,11,2,0,2,0,5,0,20,2.857142857142857,3,0.0,0,2,0,2,11,0,0,5,0,4,16,1
14592,137018,xwVxmiN6s5Ty9myiVUNDBrV8mOb9D8yx,7GRhBDsirIGkRZBtSMEzNTyDr2JQm4xx,6,13,3,0,1,0,1,0,18,2.5714285714285716,1,0.0,9,3,0,1,4,0,0,1,0,13,5,1
14593,137027,qggUO4B0NhIPqMhJwgIAZM8ZaIbpr9nE,A3fsA9Zfv1X2fVEQhTw51lKENdNrEqT3,102,66,53,180,35,9,32,3,378,54.0,4,0.0,5,53,167,35,61,9,13,32,3,260,118,0
14594,137039,oUtJwYt8sa3kOoE5VCZnryoMeLtLEWT7,SpATywNh6bZuzm8s1ceuBUnMUAeoAHHw,1,0,0,0,0,0,1,0,1,0.14285714285714285,1,0.0,0,0,0,0,0,0,0,1,0,0,1,1
14595,137066,ysgn6TuMNCSCCc3YWRE4ykee40CF0ytw,SpATywNh6bZuzm8s1ceuBUnMUAeoAHHw,17,45,18,32,5,0,15,1,116,16.571428571428573,2,0.0,20,18,23,5,25,0,9,15,1,66,50,0
14596,137067,3AKxcSEV1jrslQIrEuinY7HEzBYlVr1w,7GRhBDsirIGkRZBtSMEzNTyDr2JQm4xx,1,0,0,0,0,0,1,0,1,0.14285714285714285,1,0.0,0,0,0,0,0,0,0,1,0,0,1,1
14597,137075,D5GqwXfacfySSvxPJ9v7ORjiX9Oa23f1,A3fsA9Zfv1X2fVEQhTw51lKENdNrEqT3,11,6,4,0,2,1,9,1,23,3.2857142857142856,2,0.0,0,4,0,2,6,1,0,9,1,6,17,1
14598,137079,2zPhdAsLsu77lfpQJMqGvZTeUBoWRvYj,A3fsA9Zfv1X2fVEQhTw51lKENdNrEqT3,4,2,1,0,1,0,1,0,5,0.7142857142857143,1,0.0,0,1,0,1,2,0,0,1,0,2,3,1
14599,137088,XEF36i36eMRNZiPBT0BZnH2MwEKG9uoI,5X6FeZozNMgE2VRi3MJYjkkFK8SETtu2,5,2,1,0,1,0,2,0,6,0.8571428571428571,1,0.0,0,1,0,1,2,0,0,2,0,2,4,1
14600,137097,K8iyo1zjmUVYyneIljrW5LXHYSVc2KTu,bWdj2GDclj5ofokWjzoa5jAwMkxCykd6,5,2,1,0,1,0,2,0,6,0.8571428571428571,1,0.0,0,1,0,1,2,0,0,2,0,2,4,1
14601,137106,ysgn6TuMNCSCCc3YWRE4ykee40CF0ytw,G8EPVSXsOYB5YQWZGiz1aVq5Pgr2GrQu,8,5,3,0,2,0,8,1,19,2.7142857142857144,2,0.0,0,3,0,2,5,0,0,8,1,5,14,1
14602,137107,XWnCbgeYVoaeV4iWRMUFAsMH4LdV0YRz,7GRhBDsirIGkRZBtSMEzNTyDr2JQm4xx,19,21,8,20,1,0,8,0,58,8.285714285714286,2,0.0,5,8,18,1,16,0,2,8,0,32,26,1
14603,137109,hTUTGix3tq45IjQs1VC6q6z8vUJkTGrj,SpATywNh6bZuzm8s1ceuBUnMUAeoAHHw,7,1,1,0,1,0,7,1,11,1.5714285714285714,1,0.0,0,1,0,1,1,0,0,7,1,2,9,1
14604,137117,TXBaUi0GpvXZWCDXsKlkFWTtfaT87UMz,A3fsA9Zfv1X2fVEQhTw51lKENdNrEqT3,7,4,2,0,0,3,6,1,16,2.2857142857142856,2,0.0,1,2,0,0,3,3,0,6,1,3,13,1
14605,137120,TXBaUi0GpvXZWCDXsKlkFWTtfaT87UMz,7GRhBDsirIGkRZBtSMEzNTyDr2JQm4xx,1,0,0,0,0,0,1,0,1,0.14285714285714285,1,0.0,0,0,0,0,0,0,0,1,0,0,1,1
14606,137125,qrcZVupskPQ3r4i17tFBTVUKSJOS0tny,G8EPVSXsOYB5YQWZGiz1aVq5Pgr2GrQu,33,51,30,14,12,0,10,0,117,16.714285714285715,2,0.0,16,30,13,12,35,0,1,10,0,71,46,1
14607,137126,7R7i7Tl6hQVhHuW9EDKI5hP3KMblyMnQ,bWdj2GDclj5ofokWjzoa5jAwMkxCykd6,14,34,19,0,7,0,8,0,68,9.714285714285714,2,0.0,2,19,0,7,32,0,0,8,0,28,40,0
14608,137138,vJqquhDApWmZKT0O91wuZoyK7VHuuogv,G8EPVSXsOYB5YQWZGiz1aVq5Pgr2GrQu,3,2,1,0,0,0,1,0,4,0.5714285714285714,1,0.0,0,1,0,0,2,0,0,1,0,1,3,1
14609,137143,pvc8Q0fgukpLHQtQV7WyWJtaaZKe5il3,A3fsA9Zfv1X2fVEQhTw51lKENdNrEqT3,14,5,4,16,3,0,2,0,30,4.285714285714286,1,0.0,0,4,14,3,5,0,2,2,0,21,9,1
14610,137147,7Mw4vaDC7DEeScsxjISACITxqLi97SBZ,SpATywNh6bZuzm8s1ceuBUnMUAeoAHHw,4,2,1,0,0,0,4,0,7,1.0,2,0.0,0,1,0,0,2,0,0,4,0,1,6,1
14611,137152,042EgGVh69v5hFZCwLUBrVmkW58yUGoj,A3fsA9Zfv1X2fVEQhTw51lKENdNrEqT3,2,0,0,0,0,0,2,0,2,0.2857142857142857,1,0.0,0,0,0,0,0,0,0,2,0,0,2,1
14612,137160,Vbb39EBG6fQbcqfccG5sxgb8bg7sFwhQ,SpATywNh6bZuzm8s1ceuBUnMUAeoAHHw,44,62,25,52,16,18,14,3,190,27.142857142857142,4,0.0,29,25,43,16,33,18,9,14,3,113,77,0
14613,137187,Jh63Yx7P2KG3mJaB2UxXBx2DtcJ6DTS6,SpATywNh6bZuzm8s1ceuBUnMUAeoAHHw,9,14,2,1,1,0,3,0,21,3.0,1,0.0,3,2,1,1,11,0,0,3,0,7,14,1
14614,137193,PmtrviA6hBub1PH85YXqVyZgghNsuc4g,RXDvfPUBYFlVdlueBFbLW0mhhAyGEqpt,8,10,2,0,1,0,3,0,16,2.2857142857142856,2,0.0,0,2,0,1,10,0,0,3,0,3,13,0
14615,137194,9yxOirOWFARsrkPVEfTkEk3tj0G1eEr7,SpATywNh6bZuzm8s1ceuBUnMUAeoAHHw,33,53,4,42,1,7,14,1,122,17.428571428571427,5,0.0,10,4,37,1,43,7,5,14,1,52,70,0
14616,137201,xHyTBb0oAY3Apc4pTvqPrWVv46063zDF,bWdj2GDclj5ofokWjzoa5jAwMkxCykd6,7,2,1,0,1,7,9,2,22,3.142857142857143,2,0.0,0,1,0,1,2,7,0,9,2,2,20,1
14617,137211,EWCtjEAyugZmgyZfRj1CnWJoYkKUEbbn,5X6FeZozNMgE2VRi3MJYjkkFK8SETtu2,3,2,0,0,0,0,1,0,3,0.42857142857142855,1,0.0,0,0,0,0,2,0,0,1,0,0,3,1
14618,137212,vbMN1rzhGdmFkomRrJirrfajP9CU9h8U,5X6FeZozNMgE2VRi3MJYjkkFK8SETtu2,1,0,0,0,0,0,1,0,1,0.14285714285714285,1,0.0,0,0,0,0,0,0,0,1,0,0,1,1
14619,137231,ZSEIlb9ma209LSHLrk2K3oKNlkQui4gF,7GRhBDsirIGkRZBtSMEzNTyDr2JQm4xx,38,55,22,43,16,4,7,0,147,21.0,3,0.0,28,22,38,16,27,4,5,7,0,104,43,1
14620,137236,8IqLsxST5k0rUat32tSUg01EGRNfd0qi,SpATywNh6bZuzm8s1ceuBUnMUAeoAHHw,6,9,3,0,3,2,3,0,20,2.857142857142857,1,0.0,0,3,0,3,9,2,0,3,0,6,14,1
14621,137239,cSIzFDJuNIbXURUzpnDwj3nKpvAD5jUb,bWdj2GDclj5ofokWjzoa5jAwMkxCykd6,1,0,0,0,0,0,1,0,1,0.14285714285714285,1,0.0,0,0,0,0,0,0,0,1,0,0,1,1
14622,137243,OLEqwRXafj333FNrgBNSnfXgRYdpAvmq,SpATywNh6bZuzm8s1ceuBUnMUAeoAHHw,6,5,2,0,2,0,2,0,11,1.5714285714285714,2,0.0,0,2,0,2,5,0,0,2,0,4,7,0
14623,137244,v8s2hAX8tQgFD6i9MrUt2cuWPYPq3DuN,7GRhBDsirIGkRZBtSMEzNTyDr2JQm4xx,30,72,32,31,19,12,10,0,176,25.142857142857142,9,0.0,30,32,28,19,42,12,3,10,0,109,67,0
14624,137256,3tUwJI9fq5MBYvk22zmtcZQjmB4I2cFy,SpATywNh6bZuzm8s1ceuBUnMUAeoAHHw,2,0,0,0,0,0,2,0,2,0.2857142857142857,1,0.0,0,0,0,0,0,0,0,2,0,0,2,1
14625,137259,jx3H6f2miwKbLN02Gt82PEqx2tCxuPiz,SpATywNh6bZuzm8s1ceuBUnMUAeoAHHw,28,39,9,22,6,5,28,1,110,15.714285714285714,6,0.0,9,9,22,6,30,5,0,28,1,46,64,0
14626,137268,qDignCY8ZSbFAHDmfGr6um90qnmxvInL,7GRhBDsirIGkRZBtSMEzNTyDr2JQm4xx,7,5,2,4,2,0,1,0,14,2.0,1,0.0,2,2,3,2,3,0,1,1,0,9,5,1
14627,137277,bAAKqYTvNa29c4TuCorKR61JLnTy6u4P,SpATywNh6bZuzm8s1ceuBUnMUAeoAHHw,17,18,0,0,0,4,5,0,27,3.857142857142857,3,0.0,0,0,0,0,18,4,0,5,0,0,27,1
14628,137278,mX1EPUwBuVJskkKXxy0ZHAUgsFReCgzo,bWdj2GDclj5ofokWjzoa5jAwMkxCykd6,3,0,0,0,0,4,2,0,6,0.8571428571428571,1,0.0,0,0,0,0,0,4,0,2,0,0,6,1
14629,137291,zhx9FAttDf9KfTt4QYbmf4kGhKS1JatC,fbPkOYLVPtPgIt0MxizjfFJov3JbHyAi,6,2,0,0,0,8,8,1,19,2.7142857142857144,1,0.0,0,0,0,0,2,8,0,8,1,0,19,1
14630,137293,aJRPciowZ4Uphw6R6OHAqScxIuuZ6bxP,fbPkOYLVPtPgIt0MxizjfFJov3JbHyAi,1,0,0,0,0,0,1,0,1,0.14285714285714285,1,0.0,0,0,0,0,0,0,0,1,0,0,1,0
14631,137294,2AVqf09WA2itMEZz0u7FX3Fi3x3FZzPg,fbPkOYLVPtPgIt0MxizjfFJov3JbHyAi,32,54,31,0,22,5,10,0,122,17.428571428571427,5,0.0,8,31,0,22,46,5,0,10,0,61,61,1
14632,137295,VaoxktacOI8C5q8hn2iIjPvNhrMgUBA1,fbPkOYLVPtPgIt0MxizjfFJov3JbHyAi,1,0,0,0,0,0,1,0,1,0.14285714285714285,1,0.0,0,0,0,0,0,0,0,1,0,0,1,1
14633,137297,YkKsB5X9vnptYYEdKXeE2TLVCO4MMdOc,fbPkOYLVPtPgIt0MxizjfFJov3JbHyAi,6,6,3,0,2,0,3,0,14,2.0,1,0.0,0,3,0,2,6,0,0,3,0,5,9,1
14634,137298,c8WJAdYLV71mOx4ZXSglpCNd0dBUR3Om,fbPkOYLVPtPgIt0MxizjfFJov3JbHyAi,10,8,3,3,2,3,5,0,24,3.4285714285714284,1,0.0,1,3,2,2,7,3,1,5,0,8,16,1
14635,137302,qfe1MUR6a62dAgiCJR4API4cCHsYlsVO,fbPkOYLVPtPgIt0MxizjfFJov3JbHyAi,6,4,3,0,3,0,1,0,11,1.5714285714285714,1,0.0,0,3,0,3,4,0,0,1,0,6,5,1
14636,137303,RUYKIgG46teji8tqIoyMK9d2o6MFKma5,fbPkOYLVPtPgIt0MxizjfFJov3JbHyAi,10,5,3,0,3,0,6,0,17,2.4285714285714284,1,0.0,0,3,0,3,5,0,0,6,0,6,11,1
14637,137305,Z1uIScALT37BtyCtbFy33E9DuvHO2hks,fbPkOYLVPtPgIt0MxizjfFJov3JbHyAi,12,47,8,3,5,2,15,1,81,11.571428571428571,1,0.0,10,8,3,5,37,2,0,15,1,26,55,1
14638,137307,CgQYjUs70RSn4QebA63eL3Qm5MtCUzhj,fbPkOYLVPtPgIt0MxizjfFJov3JbHyAi,6,4,2,0,2,0,1,0,9,1.2857142857142858,1,0.0,1,2,0,2,3,0,0,1,0,5,4,0
14639,137310,3dtK0EXsDFiqPIgXhR4S028y6RGCztxN,fbPkOYLVPtPgIt0MxizjfFJov3JbHyAi,9,6,2,0,3,0,7,0,18,2.5714285714285716,1,0.0,3,2,0,3,3,0,0,7,0,8,10,1
14640,137311,bAltXvR0FBKFy91atPslJEMIb77R3lRC,fbPkOYLVPtPgIt0MxizjfFJov3JbHyAi,5,3,2,0,2,3,6,0,16,2.2857142857142856,2,0.0,0,2,0,2,3,3,0,6,0,4,12,1
14641,137312,yG9o9nU1hVydCMiwULHDO2ptGPwb3jNJ,fbPkOYLVPtPgIt0MxizjfFJov3JbHyAi,10,7,4,0,5,0,6,0,22,3.142857142857143,1,0.0,2,4,0,5,5,0,0,6,0,11,11,1
14642,137314,yQcq1gJWEi9sb58vjqz4cWvz65K4he0Q,fbPkOYLVPtPgIt0MxizjfFJov3JbHyAi,5,2,1,0,1,0,7,0,11,1.5714285714285714,1,0.0,0,1,0,1,2,0,0,7,0,2,9,1
14643,137316,xmbjcbay9FhXPDAWN6ffVRxetrr8jeM4,fbPkOYLVPtPgIt0MxizjfFJov3JbHyAi,16,9,7,0,6,11,14,1,48,6.857142857142857,1,0.0,0,7,0,6,9,11,0,14,1,13,35,1
14644,137317,55wDwHImP2KSV7dhBC7nPdVPLu4YizxX,fbPkOYLVPtPgIt0MxizjfFJov3JbHyAi,5,3,1,0,1,0,6,0,11,1.5714285714285714,1,0.0,0,1,0,1,3,0,0,6,0,2,9,1
14645,137318,5R4vzdx33VN10wY0ny2PCajdeF7dJThU,fbPkOYLVPtPgIt0MxizjfFJov3JbHyAi,5,2,1,0,1,0,3,0,7,1.0,1,0.0,0,1,0,1,2,0,0,3,0,2,5,1
14646,137320,8XstJLDa8agdHppUFVVZbvtgkIjc1hSo,fbPkOYLVPtPgIt0MxizjfFJov3JbHyAi,8,6,3,0,2,3,5,0,19,2.7142857142857144,2,0.0,0,3,0,2,6,3,0,5,0,5,14,1
14647,137322,7YUms5oSq8SOTxahUEH4CgK97RwpzrJL,fbPkOYLVPtPgIt0MxizjfFJov3JbHyAi,1,0,0,0,0,0,1,0,1,0.14285714285714285,1,0.0,0,0,0,0,0,0,0,1,0,0,1,1
14648,137327,4QLYsScyK6MU5AtBG0Whf2A1TPnb1x0x,fbPkOYLVPtPgIt0MxizjfFJov3JbHyAi,4,2,1,0,1,0,1,0,5,0.7142857142857143,1,0.0,0,1,0,1,2,0,0,1,0,2,3,1
14649,137328,DRsh16n3YrIgDiEC23najFM1m1jqkwJO,fbPkOYLVPtPgIt0MxizjfFJov3JbHyAi,5,3,1,0,1,0,1,0,6,0.8571428571428571,1,0.0,0,1,0,1,3,0,0,1,0,2,4,1
14650,137330,VThmvfwuMXDnKChVAYvsJFXoC4zUM0D9,fbPkOYLVPtPgIt0MxizjfFJov3JbHyAi,4,2,1,0,1,0,1,0,5,0.7142857142857143,1,0.0,0,1,0,1,2,0,0,1,0,2,3,1
14651,137333,gctoOufeRjSEdr00xmWUSLYVm7c6Ovl4,fbPkOYLVPtPgIt0MxizjfFJov3JbHyAi,2,0,0,0,0,0,4,0,4,0.5714285714285714,1,0.0,0,0,0,0,0,0,0,4,0,0,4,1
14652,137334,bzOuF27O1YGS02SMyouUKFo24T7mHVXd,fbPkOYLVPtPgIt0MxizjfFJov3JbHyAi,8,6,3,0,4,0,4,0,17,2.4285714285714284,1,0.0,1,3,0,4,5,0,0,4,0,8,9,1
14653,137337,SO9qUKDjuES2bMkck2Ro41uio1RDDMn4,fbPkOYLVPtPgIt0MxizjfFJov3JbHyAi,4,2,0,0,0,0,2,0,4,0.5714285714285714,1,0.0,0,0,0,0,2,0,0,2,0,0,4,1
14654,137338,i1dAtk6qr0Yjyjyw021VWnqB4cTdL0zR,fbPkOYLVPtPgIt0MxizjfFJov3JbHyAi,20,16,11,0,9,12,10,3,61,8.714285714285714,1,0.0,0,11,0,9,16,12,0,10,3,20,41,1
14655,137344,UUY3BPLR7A3Xa6FGsztMCn6xCbxtdCYu,fbPkOYLVPtPgIt0MxizjfFJov3JbHyAi,4,2,1,0,1,0,1,0,5,0.7142857142857143,1,0.0,0,1,0,1,2,0,0,1,0,2,3,1
14656,137346,LhTbpdQPj8McUYLExnN4ONQebEAJlctK,fbPkOYLVPtPgIt0MxizjfFJov3JbHyAi,5,2,1,0,1,0,2,0,6,0.8571428571428571,1,0.0,0,1,0,1,2,0,0,2,0,2,4,1
14657,137347,OilNA0H2OqGoAWakPxAdVr8srp2M8Kk5,fbPkOYLVPtPgIt0MxizjfFJov3JbHyAi,5,2,1,0,1,0,9,0,13,1.8571428571428572,2,0.0,0,1,0,1,2,0,0,9,0,2,11,1
14658,137349,hTAo9KiAJdTi42ZGMp48lMwTSPkKJERF,fbPkOYLVPtPgIt0MxizjfFJov3JbHyAi,2,0,0,0,0,0,4,0,4,0.5714285714285714,1,0.0,0,0,0,0,0,0,0,4,0,0,4,1
14659,137350,LUzWKYsqqChsro86iNB09MI9Og8MojLk,fbPkOYLVPtPgIt0MxizjfFJov3JbHyAi,6,6,2,0,2,0,4,0,14,2.0,1,0.0,3,2,0,2,3,0,0,4,0,7,7,1
14660,137351,wOJGPiHQhntwjEFJywVCc6H0XBUUrn4W,fbPkOYLVPtPgIt0MxizjfFJov3JbHyAi,5,2,1,0,1,0,4,0,8,1.1428571428571428,1,0.0,0,1,0,1,2,0,0,4,0,2,6,1
14661,137352,cuefNHr7cmtAeAOTeZH62xK2M7JgCzzm,fbPkOYLVPtPgIt0MxizjfFJov3JbHyAi,6,3,1,0,1,0,4,0,9,1.2857142857142858,1,0.0,0,1,0,1,3,0,0,4,0,2,7,1
14662,137354,WtDMxixQmy03wB9jEWr2xYQPm36rgbzM,fbPkOYLVPtPgIt0MxizjfFJov3JbHyAi,12,23,4,6,5,0,11,0,49,7.0,2,0.0,9,4,6,5,14,0,0,11,0,24,25,1
14663,137356,ADL0cXowUMs4wyiAOHKMOrtTHu5tmUqi,fbPkOYLVPtPgIt0MxizjfFJov3JbHyAi,6,7,5,0,2,0,5,0,19,2.7142857142857144,2,0.0,0,5,0,2,7,0,0,5,0,7,12,1
14664,137359,tg3C5tAthjtIE6hVso6iXfcLGroduOx8,fbPkOYLVPtPgIt0MxizjfFJov3JbHyAi,6,4,1,0,1,0,3,0,9,1.2857142857142858,1,0.0,0,1,0,1,4,0,0,3,0,2,7,1
14665,137360,NEKO6BLQdSSPIkqL9Q7yxqF7YpsLWJ2i,fbPkOYLVPtPgIt0MxizjfFJov3JbHyAi,7,4,2,0,1,1,8,0,16,2.2857142857142856,1,0.0,0,2,0,1,4,1,0,8,0,3,13,1
14666,137362,6OO2RXg4fKLY0L2CDQWPbDzS9qYFNLhY,fbPkOYLVPtPgIt0MxizjfFJov3JbHyAi,7,2,1,0,1,2,11,1,18,2.5714285714285716,1,0.0,0,1,0,1,2,2,0,11,1,2,16,1
14667,137363,PG5DcX6LvCCrfUIpAzQI5ebaNfLqaT2x,fbPkOYLVPtPgIt0MxizjfFJov3JbHyAi,9,8,4,0,3,19,6,1,41,5.857142857142857,1,0.0,3,4,0,3,5,19,0,6,1,10,31,1
14668,137364,PNltRKReLHuKml6LKXYu0Xf2LLMAke1h,fbPkOYLVPtPgIt0MxizjfFJov3JbHyAi,5,5,0,0,0,0,4,0,9,1.2857142857142858,1,0.0,0,0,0,0,5,0,0,4,0,0,9,1
14669,137365,X285XxvFlCKmuDlV3vzMxZpCu1V9X67P,fbPkOYLVPtPgIt0MxizjfFJov3JbHyAi,7,8,4,0,3,7,1,0,23,3.2857142857142856,1,0.0,2,4,0,3,6,7,0,1,0,9,14,1
14670,137366,0TSJej9rL1Sb8axummfeQPMEkUPlnJtY,fbPkOYLVPtPgIt0MxizjfFJov3JbHyAi,4,2,1,0,1,0,1,0,5,0.7142857142857143,1,0.0,0,1,0,1,2,0,0,1,0,2,3,1
14671,137367,yUbOTxLRPrMBKeEJQgeZAYWE44xjkzqj,fbPkOYLVPtPgIt0MxizjfFJov3JbHyAi,3,0,0,0,0,7,5,0,12,1.7142857142857142,1,0.0,0,0,0,0,0,7,0,5,0,0,12,1
14672,137368,fWcDM7NTKsDIL7vPWRWhQ3HiIwO7ubW6,fbPkOYLVPtPgIt0MxizjfFJov3JbHyAi,5,3,2,0,1,0,4,0,10,1.4285714285714286,1,0.0,0,2,0,1,3,0,0,4,0,3,7,1
14673,137369,llbduCly6ZFemSI4OiW2PWc2ZsNUujfV,fbPkOYLVPtPgIt0MxizjfFJov3JbHyAi,5,2,1,0,1,2,2,0,8,1.1428571428571428,1,0.0,0,1,0,1,2,2,0,2,0,2,6,1
14674,137371,IDAegjDGT88IxffhIlPXozfrAIyenr6d,fbPkOYLVPtPgIt0MxizjfFJov3JbHyAi,9,11,5,0,3,8,16,0,43,6.142857142857143,1,0.0,3,5,0,3,8,8,0,16,0,11,32,0
14675,137374,XnBCBUkc42wLmZebmQm45ZhzN8434GYt,fbPkOYLVPtPgIt0MxizjfFJov3JbHyAi,9,3,2,0,2,1,8,1,17,2.4285714285714284,1,0.0,0,2,0,2,3,1,0,8,1,4,13,1
14676,137376,xudT2FGfOf7lnAynFZztXlYI3LpEGyZP,fbPkOYLVPtPgIt0MxizjfFJov3JbHyAi,6,5,3,0,2,2,7,0,19,2.7142857142857144,1,0.0,0,3,0,2,5,2,0,7,0,5,14,1
14677,137378,1wIqcRX58Bpw6RXvGnbxsc6WbPwWGwXd,fbPkOYLVPtPgIt0MxizjfFJov3JbHyAi,5,7,4,0,2,4,5,0,22,3.142857142857143,3,0.0,0,4,0,2,7,4,0,5,0,6,16,1
14678,137380,yNFkVq3WBH36gbFucxZddTEItgWhR2NG,fbPkOYLVPtPgIt0MxizjfFJov3JbHyAi,7,5,2,0,3,0,2,0,12,1.7142857142857142,1,0.0,2,2,0,3,3,0,0,2,0,7,5,1
14679,137381,XE05vZThEHf17O6FM08AySNf2qZFgNWa,fbPkOYLVPtPgIt0MxizjfFJov3JbHyAi,7,6,3,1,4,0,1,0,15,2.142857142857143,1,0.0,2,3,1,4,4,0,0,1,0,10,5,1
14680,137382,nkm4i9oKKVu0C5FrCnxvTBLSuiaAGdZs,fbPkOYLVPtPgIt0MxizjfFJov3JbHyAi,6,3,2,0,2,0,1,0,8,1.1428571428571428,1,0.0,0,2,0,2,3,0,0,1,0,4,4,1
14681,137385,Cil3ne7R9WaXD5p2VZEmRDvLwX0ITQx4,fbPkOYLVPtPgIt0MxizjfFJov3JbHyAi,5,2,1,0,1,1,3,0,8,1.1428571428571428,1,0.0,0,1,0,1,2,1,0,3,0,2,6,1
14682,137387,KpMidRbqlnB1jsFzzXeXD9SSZ9cT4DEn,fbPkOYLVPtPgIt0MxizjfFJov3JbHyAi,2,0,0,0,0,0,2,0,2,0.2857142857142857,1,0.0,0,0,0,0,0,0,0,2,0,0,2,1
14683,137389,tsTDNHtkzUQqr6Le5CiKzEb1J3ub8XpE,fbPkOYLVPtPgIt0MxizjfFJov3JbHyAi,1,0,0,0,0,0,1,0,1,0.14285714285714285,1,0.0,0,0,0,0,0,0,0,1,0,0,1,1
14684,137390,WGBXR80uiaxU0rQGqPRIQBTLpC89XbJW,fbPkOYLVPtPgIt0MxizjfFJov3JbHyAi,2,0,0,0,0,0,2,0,2,0.2857142857142857,1,0.0,0,0,0,0,0,0,0,2,0,0,2,1
14685,137392,5iWOSqpJMywqKPlLQJ5aQLOawtvw8Iyp,fbPkOYLVPtPgIt0MxizjfFJov3JbHyAi,5,2,1,0,1,0,8,0,12,1.7142857142857142,1,0.0,0,1,0,1,2,0,0,8,0,2,10,1
14686,137393,iRCtUk9qJG1ZNpyYOkrIzRzmwV1jkfTG,fbPkOYLVPtPgIt0MxizjfFJov3JbHyAi,2,0,0,0,0,0,6,0,6,0.8571428571428571,1,0.0,0,0,0,0,0,0,0,6,0,0,6,1
14687,137394,C8zDhaG0vPsQegBtS55u3JZHiYuueFnE,fbPkOYLVPtPgIt0MxizjfFJov3JbHyAi,5,2,1,0,1,0,4,0,8,1.1428571428571428,1,0.0,0,1,0,1,2,0,0,4,0,2,6,1
14688,137395,174L1V9TprbRTHroQ9FWwbu1TqCVlQjk,fbPkOYLVPtPgIt0MxizjfFJov3JbHyAi,5,2,1,0,1,0,2,0,6,0.8571428571428571,1,0.0,0,1,0,1,2,0,0,2,0,2,4,1
14689,137396,mSgxVbbf83kCrpd2JLuv7BfCExmUt2C4,fbPkOYLVPtPgIt0MxizjfFJov3JbHyAi,8,4,2,0,2,2,4,1,15,2.142857142857143,1,0.0,1,2,0,2,3,2,0,4,1,5,10,0
14690,137398,Kc3YlgMAuK3aPMXYbr7Lb1W7MBNaKMiR,fbPkOYLVPtPgIt0MxizjfFJov3JbHyAi,6,3,2,0,2,0,1,0,8,1.1428571428571428,1,0.0,0,2,0,2,3,0,0,1,0,4,4,1
14691,137400,a5h0uXVhrD32xi14HjckmWeHNJHW3EMf,fbPkOYLVPtPgIt0MxizjfFJov3JbHyAi,4,15,2,0,0,0,1,0,18,2.5714285714285716,1,0.0,0,2,0,0,15,0,0,1,0,2,16,1
14692,137401,kQsVPicmVfwF40LR0Bwbh20EXwnKbn92,fbPkOYLVPtPgIt0MxizjfFJov3JbHyAi,18,42,13,9,16,20,17,2,119,17.0,3,0.0,28,13,8,16,14,20,1,17,2,65,54,1
14693,137402,C8KvwWwhKVcH5gZKcH7dQig9dEhWoVOu,fbPkOYLVPtPgIt0MxizjfFJov3JbHyAi,2,0,0,0,0,0,3,0,3,0.42857142857142855,1,0.0,0,0,0,0,0,0,0,3,0,0,3,1
14694,137403,3rZRyyAqQR0LHT7iXSTyhR4wZI7IzOpN,fbPkOYLVPtPgIt0MxizjfFJov3JbHyAi,6,6,2,0,3,0,1,0,12,1.7142857142857142,1,0.0,3,2,0,3,3,0,0,1,0,8,4,1
14695,137404,nOvIog5xbz5ZKA2OUeEwDTOaSy9QOHTT,fbPkOYLVPtPgIt0MxizjfFJov3JbHyAi,8,8,4,0,3,0,12,0,27,3.857142857142857,1,0.0,0,4,0,3,8,0,0,12,0,7,20,1
14696,137409,OD1pqN8En0iNd52vQpaf4DwGLH3W4dof,fbPkOYLVPtPgIt0MxizjfFJov3JbHyAi,9,7,5,0,3,0,3,0,18,2.5714285714285716,2,0.0,0,5,0,3,7,0,0,3,0,8,10,1
14697,137413,uCu7X2FM1qO7UaWcT7yafBpyCKsVxRuo,fbPkOYLVPtPgIt0MxizjfFJov3JbHyAi,7,2,1,0,1,3,6,1,14,2.0,1,0.0,0,1,0,1,2,3,0,6,1,2,12,1
14698,137416,A41hdT15T7mumzDW53QCDXRUsOilvTI0,fbPkOYLVPtPgIt0MxizjfFJov3JbHyAi,32,55,39,0,23,15,13,0,145,20.714285714285715,4,0.0,0,39,0,23,55,15,0,13,0,62,83,0
14699,137419,wCdkG2gdJ13TsTuESZCgsx6c9HoUuD9s,fbPkOYLVPtPgIt0MxizjfFJov3JbHyAi,8,10,4,7,4,0,1,0,26,3.7142857142857144,1,0.0,4,4,6,4,6,0,1,1,0,18,8,1
14700,137422,cH7MXJwZ1B11Byd6oixA8vDtJ38H8Xie,fbPkOYLVPtPgIt0MxizjfFJov3JbHyAi,5,1,1,0,1,0,3,0,6,0.8571428571428571,1,0.0,0,1,0,1,1,0,0,3,0,2,4,1
14701,137423,BEEx400Zym1Adj0LXV9O094DcgDYxMgU,fbPkOYLVPtPgIt0MxizjfFJov3JbHyAi,4,2,1,0,1,0,1,0,5,0.7142857142857143,1,0.0,0,1,0,1,2,0,0,1,0,2,3,1
14702,137424,bqKMJ5OUNpA2Wgq0oxWCoJ7xNwTYKmHM,fbPkOYLVPtPgIt0MxizjfFJov3JbHyAi,12,9,7,0,6,0,1,0,23,3.2857142857142856,1,0.0,0,7,0,6,9,0,0,1,0,13,10,1
14703,137425,X6JW84BYI57qMmiEsexKiPAn78X5H1sY,fbPkOYLVPtPgIt0MxizjfFJov3JbHyAi,3,2,0,0,0,0,1,0,3,0.42857142857142855,1,0.0,0,0,0,0,2,0,0,1,0,0,3,1
14704,137426,45lJHu4OdGTQsQvp0urXXWXHjLHgbztG,fbPkOYLVPtPgIt0MxizjfFJov3JbHyAi,2,0,0,0,0,0,2,0,2,0.2857142857142857,1,0.0,0,0,0,0,0,0,0,2,0,0,2,1
14705,137428,Q7kz14DBsTywLRi7Bx0P7HkElJgTxbaA,fbPkOYLVPtPgIt0MxizjfFJov3JbHyAi,4,3,2,0,0,0,3,0,8,1.1428571428571428,1,0.0,0,2,0,0,3,0,0,3,0,2,6,1
14706,137430,zEaDEiE5fac9Y3NT8JaitlDl9a7ILbFn,fbPkOYLVPtPgIt0MxizjfFJov3JbHyAi,6,1,1,0,1,0,9,0,12,1.7142857142857142,1,0.0,0,1,0,1,1,0,0,9,0,2,10,1
14707,137432,4foS4JAYOnNJdWly53kH9VyAeI8ZpoB9,fbPkOYLVPtPgIt0MxizjfFJov3JbHyAi,8,5,3,0,2,0,4,0,14,2.0,1,0.0,0,3,0,2,5,0,0,4,0,5,9,1
14708,137433,MXpZg6Y3WvwOURUS1VvgXTxhk1pXKVY7,fbPkOYLVPtPgIt0MxizjfFJov3JbHyAi,7,6,2,0,3,3,2,0,16,2.2857142857142856,1,0.0,3,2,0,3,3,3,0,2,0,8,8,1
14709,137435,2kGVAArEEN0LJBurgHk38pEMZThzj1T0,fbPkOYLVPtPgIt0MxizjfFJov3JbHyAi,6,3,2,0,2,0,1,0,8,1.1428571428571428,1,0.0,0,2,0,2,3,0,0,1,0,4,4,1
14710,137436,NOuxSmdis5r1BA64zbAkvC5MyhRcV1wd,fbPkOYLVPtPgIt0MxizjfFJov3JbHyAi,2,0,0,0,0,0,11,0,11,1.5714285714285714,1,0.0,0,0,0,0,0,0,0,11,0,0,11,1
14711,137437,tQSlSaSXXQMbulfRrarng77t6SPsEo7N,fbPkOYLVPtPgIt0MxizjfFJov3JbHyAi,6,7,4,0,5,0,1,0,17,2.4285714285714284,1,0.0,2,4,0,5,5,0,0,1,0,11,6,1
14712,137439,0PoVNnWMSVMNUD7YbDeAnDdYFFtJNZml,fbPkOYLVPtPgIt0MxizjfFJov3JbHyAi,5,2,1,0,1,0,2,0,6,0.8571428571428571,1,0.0,0,1,0,1,2,0,0,2,0,2,4,1
14713,137441,4hHmnOenTXav8CdwQUU4bXbhMHCuz22G,fbPkOYLVPtPgIt0MxizjfFJov3JbHyAi,12,29,5,8,7,3,12,2,66,9.428571428571429,2,0.0,12,5,8,7,17,3,0,12,2,32,34,1
14714,137442,1LtLQwRGDjWRPORAmpPeWuHr93qsG62M,fbPkOYLVPtPgIt0MxizjfFJov3JbHyAi,3,3,0,0,0,4,1,0,8,1.1428571428571428,1,0.0,0,0,0,0,3,4,0,1,0,0,8,1
14715,137444,7J7CDZ99WfuIWgF8UjFLGxW2Gw1ELsrr,fbPkOYLVPtPgIt0MxizjfFJov3JbHyAi,5,3,1,0,1,0,2,0,7,1.0,1,0.0,1,1,0,1,2,0,0,2,0,3,4,1
14716,137445,CuHzzfkniWARJNGhM9Z8TfGkX4QBNw5S,fbPkOYLVPtPgIt0MxizjfFJov3JbHyAi,2,0,0,0,0,0,5,0,5,0.7142857142857143,1,0.0,0,0,0,0,0,0,0,5,0,0,5,1
14717,137447,ucnh7Je2Ujv5K3Q3wjC5gWq40jwh8dv6,fbPkOYLVPtPgIt0MxizjfFJov3JbHyAi,8,10,4,0,1,0,6,1,22,3.142857142857143,2,0.0,0,4,0,1,10,0,0,6,1,5,17,1
14718,137448,ELrr1JfnDsWjEvT48HXDtL9YqiQpfZmF,fbPkOYLVPtPgIt0MxizjfFJov3JbHyAi,6,2,1,0,1,0,9,0,13,1.8571428571428572,1,0.0,0,1,0,1,2,0,0,9,0,2,11,1
14719,137450,nGWRzCfLEHu3fioeTp2MrUVqCTeaWKKh,fbPkOYLVPtPgIt0MxizjfFJov3JbHyAi,8,3,2,0,2,1,5,0,13,1.8571428571428572,1,0.0,0,2,0,2,3,1,0,5,0,4,9,1
14720,137452,OyUzOGgEg3D1ADlF5EJGg06nY3QmnkdW,fbPkOYLVPtPgIt0MxizjfFJov3JbHyAi,2,0,0,0,0,0,4,0,4,0.5714285714285714,1,0.0,0,0,0,0,0,0,0,4,0,0,4,1
14721,137454,U324n6nKpAIcARSxYaybih33hdfe43Hg,fbPkOYLVPtPgIt0MxizjfFJov3JbHyAi,1,0,0,0,0,0,1,0,1,0.14285714285714285,1,0.0,0,0,0,0,0,0,0,1,0,0,1,1
14722,137455,LLnSYhSyIZOYJyyJOzJg3NGJiWH34163,fbPkOYLVPtPgIt0MxizjfFJov3JbHyAi,1,0,0,0,0,0,1,0,1,0.14285714285714285,1,0.0,0,0,0,0,0,0,0,1,0,0,1,1
14723,137456,lYv59CqFZ5WNS1LpSdwbwYgAB1AnSa2W,fbPkOYLVPtPgIt0MxizjfFJov3JbHyAi,10,5,3,0,2,4,7,2,23,3.2857142857142856,1,0.0,0,3,0,2,5,4,0,7,2,5,18,1
14724,137457,5hA99qfStHjQqEYR2bkieX1UEObLPtIn,fbPkOYLVPtPgIt0MxizjfFJov3JbHyAi,5,3,0,0,0,0,2,0,5,0.7142857142857143,1,0.0,0,0,0,0,3,0,0,2,0,0,5,1
14725,137458,ccrvrr39fWp2aVbnA3k1bH1sjmwx7FQs,fbPkOYLVPtPgIt0MxizjfFJov3JbHyAi,8,25,2,0,0,0,9,0,36,5.142857142857143,2,0.0,0,2,0,0,25,0,0,9,0,2,34,1
14726,137459,Rr92BzwqUyCtPYHU3DwB1aivajxBRTFz,fbPkOYLVPtPgIt0MxizjfFJov3JbHyAi,4,2,1,0,1,0,1,0,5,0.7142857142857143,1,0.0,0,1,0,1,2,0,0,1,0,2,3,1
14727,137501,23qYgK59sBhKVlqVOyc6Eo1KSrAZuYOK,5Gyp41oLVo7Gg7vF4vpmggWP5MU70QO6,22,63,37,8,12,41,15,5,181,25.857142857142858,6,0.0,5,37,7,12,58,41,1,15,5,61,120,0
14728,137516,VbFV7aXWy1Ed7AF5LEbPtndF4SopBroV,5Gyp41oLVo7Gg7vF4vpmggWP5MU70QO6,7,3,2,0,2,1,2,0,10,1.4285714285714286,1,0.0,0,2,0,2,3,1,0,2,0,4,6,1
14729,137517,WSCktYZqeZlAr4CBsNsYbm97xd94qsUC,5Gyp41oLVo7Gg7vF4vpmggWP5MU70QO6,12,7,4,6,4,0,2,0,23,3.2857142857142856,2,0.0,2,4,3,4,5,0,3,2,0,13,10,1
14730,137535,Rzov4Yy9du1MxHJWr8ZSxSme8NlDvLvV,5Gyp41oLVo7Gg7vF4vpmggWP5MU70QO6,12,8,5,0,5,0,5,0,23,3.2857142857142856,2,0.0,1,5,0,5,7,0,0,5,0,11,12,0
14731,137552,DgxlqcsVCQDYe21h4YRsQPN4DqjKpjtX,5Gyp41oLVo7Gg7vF4vpmggWP5MU70QO6,6,1,1,0,1,0,3,0,6,0.8571428571428571,1,0.0,0,1,0,1,1,0,0,3,0,2,4,1
14732,137553,JYjqQWzRkQGlz0fASDON6Nnhdq6VSXiT,5Gyp41oLVo7Gg7vF4vpmggWP5MU70QO6,7,3,2,0,2,0,2,0,9,1.2857142857142858,1,0.0,0,2,0,2,3,0,0,2,0,4,5,1
14733,137574,58eQNUjs318sjON50Y8nkDIw70NM1q5r,5Gyp41oLVo7Gg7vF4vpmggWP5MU70QO6,5,2,0,0,0,0,3,0,5,0.7142857142857143,1,0.0,0,0,0,0,2,0,0,3,0,0,5,1
14734,137627,RVf6e28k6GsRGb8DN1lRFhzAihWj6uwr,5Gyp41oLVo7Gg7vF4vpmggWP5MU70QO6,10,11,2,0,3,3,8,0,27,3.857142857142857,2,0.0,0,2,0,3,11,3,0,8,0,5,22,1
14735,137673,m7jVXavImQfCN3lFSWDciGDkPXsfDWjY,5Gyp41oLVo7Gg7vF4vpmggWP5MU70QO6,7,5,2,0,2,0,3,0,12,1.7142857142857142,1,0.0,0,2,0,2,5,0,0,3,0,4,8,1
14736,137690,zfdDmTfjfw6TH19X3JvrWruhv3HK3wH5,5Gyp41oLVo7Gg7vF4vpmggWP5MU70QO6,8,11,2,0,2,0,8,0,23,3.2857142857142856,1,0.0,1,2,0,2,10,0,0,8,0,5,18,1
14737,137696,moOuTHX6EPV8dXCWOBnALGJBIKv8mXx0,5Gyp41oLVo7Gg7vF4vpmggWP5MU70QO6,12,11,6,4,4,0,10,0,35,5.0,2,0.0,1,6,2,4,10,0,2,10,0,13,22,1
14738,137702,WGFi654VXLxPTGBrVG8nl9P18l5AogE9,5Gyp41oLVo7Gg7vF4vpmggWP5MU70QO6,1,0,0,0,0,0,1,0,1,0.14285714285714285,1,0.0,0,0,0,0,0,0,0,1,0,0,1,1
14739,137731,68di0dJM35xmTuimhyTkyzCIZ2XRQ9UC,5Gyp41oLVo7Gg7vF4vpmggWP5MU70QO6,1,0,0,0,0,0,1,0,1,0.14285714285714285,1,0.0,0,0,0,0,0,0,0,1,0,0,1,1
14740,137734,UwNh19bGTGX7YEBtcKZFqxDpmh2gUs3A,5Gyp41oLVo7Gg7vF4vpmggWP5MU70QO6,1,0,0,0,0,0,1,0,1,0.14285714285714285,1,0.0,0,0,0,0,0,0,0,1,0,0,1,1
14741,137745,pzWsPfYmJYrT9X6UPf6wVCREiyQ24iPl,5Gyp41oLVo7Gg7vF4vpmggWP5MU70QO6,43,99,42,70,31,30,25,3,300,42.857142857142854,3,0.0,45,42,57,31,54,30,13,25,3,175,125,1
14742,137763,RPs2tKrisA27ObcW2SBs1xNMfhflcdme,5Gyp41oLVo7Gg7vF4vpmggWP5MU70QO6,31,60,36,48,15,24,13,0,196,28.0,7,0.0,15,36,35,15,45,24,13,13,0,101,95,1
14743,137766,x7J1Kb3wAgruXqW9nGWP0GwZa9eKiuoO,5Gyp41oLVo7Gg7vF4vpmggWP5MU70QO6,1,0,0,0,0,0,1,0,1,0.14285714285714285,1,0.0,0,0,0,0,0,0,0,1,0,0,1,1
14744,137783,CJctzi3vaTvn6AdxsKxfRIS0CweUmN8j,5Gyp41oLVo7Gg7vF4vpmggWP5MU70QO6,24,42,18,7,9,1,7,0,84,12.0,4,0.0,16,18,6,9,26,1,1,7,0,49,35,1
14745,137799,xbfHRTwQRbinLUstZARwQhQi9ympHy3t,5Gyp41oLVo7Gg7vF4vpmggWP5MU70QO6,16,30,22,5,4,3,11,0,75,10.714285714285714,7,0.0,0,22,5,4,30,3,0,11,0,31,44,1
14746,137843,8nT76hrzyl8ZAUdI7W6kfrIzHxI3puKM,5Gyp41oLVo7Gg7vF4vpmggWP5MU70QO6,6,1,0,0,0,0,8,2,11,1.5714285714285714,3,0.0,0,0,0,0,1,0,0,8,2,0,11,0
14747,137864,Lcc8QujJbkTuweBtBrKCB15IfiVLUIVq,5Gyp41oLVo7Gg7vF4vpmggWP5MU70QO6,34,64,40,11,21,15,22,1,174,24.857142857142858,5,0.0,7,40,7,21,57,15,4,22,1,75,99,1
14748,137902,g5cfvDvYqz1BC4LMGanzPaVPPBmwbapa,5Gyp41oLVo7Gg7vF4vpmggWP5MU70QO6,1,0,0,0,0,0,2,0,2,0.2857142857142857,2,0.0,0,0,0,0,0,0,0,2,0,0,2,1
14749,137904,TcuUuOMUA0rnssmvuX7CLScapgs7yDzA,5Gyp41oLVo7Gg7vF4vpmggWP5MU70QO6,2,3,1,0,0,0,0,0,4,0.5714285714285714,1,0.0,1,1,0,0,2,0,0,0,0,2,2,1
14750,137914,MuLsknYI07nq0YCcw2chy4suLHjpTMcP,5Gyp41oLVo7Gg7vF4vpmggWP5MU70QO6,1,0,0,0,0,0,2,0,2,0.2857142857142857,1,0.0,0,0,0,0,0,0,0,2,0,0,2,1
14751,137915,BeyfLbwb8pdDQU6WTI5ee3FkxRPRP7B2,5Gyp41oLVo7Gg7vF4vpmggWP5MU70QO6,7,9,4,0,2,0,2,0,17,2.4285714285714284,3,0.0,0,4,0,2,9,0,0,2,0,6,11,1
14752,137928,76Vc8xBrjpIAsCVLOBGpcAye16ciDBR2,5Gyp41oLVo7Gg7vF4vpmggWP5MU70QO6,14,16,12,4,11,0,4,0,47,6.714285714285714,1,0.0,2,12,2,11,14,0,2,4,0,27,20,1
14753,137930,fRdFgfpO9luII5SSFsjpQjNEcDlIPFJO,5Gyp41oLVo7Gg7vF4vpmggWP5MU70QO6,8,5,3,0,2,0,3,0,13,1.8571428571428572,2,0.0,0,3,0,2,5,0,0,3,0,5,8,1
14754,137963,wIfFdxlznXLGjd43eEdFblftB68OmNYA,3VkHkmOtom3jM2wCu94xgzzu1d6Dn7or,23,32,25,0,12,0,16,4,89,12.714285714285714,5,0.0,0,25,0,12,32,0,0,16,4,37,52,0
14755,137978,YnKbQ3SOScGwuCGX3synWY2TyMWLCnkl,3VkHkmOtom3jM2wCu94xgzzu1d6Dn7or,1,0,0,0,0,0,2,0,2,0.2857142857142857,1,0.0,0,0,0,0,0,0,0,2,0,0,2,1
14756,137982,7cyLQzghErKC28Qgc0MBFeY3jCN7OOfs,3VkHkmOtom3jM2wCu94xgzzu1d6Dn7or,1,0,0,0,0,0,1,0,1,0.14285714285714285,1,0.0,0,0,0,0,0,0,0,1,0,0,1,1
14757,137985,NkWR8qAbSP1GErqF95otiqzHZZxmVq5b,3VkHkmOtom3jM2wCu94xgzzu1d6Dn7or,4,2,0,0,0,2,4,0,8,1.1428571428571428,2,0.0,0,0,0,0,2,2,0,4,0,0,8,1
14758,137998,RCdcltNaQLfcoxT7YKTjQxAYUbCmzzKd,3VkHkmOtom3jM2wCu94xgzzu1d6Dn7or,4,2,1,0,1,0,1,0,5,0.7142857142857143,1,0.0,0,1,0,1,2,0,0,1,0,2,3,1
14759,138013,kEcxWGzawejnXckUe9770Kmia80cJVRb,3VkHkmOtom3jM2wCu94xgzzu1d6Dn7or,22,30,27,0,0,3,5,0,65,9.285714285714286,3,0.0,0,27,0,0,30,3,0,5,0,27,38,1
14760,138016,rkeWD62NaMO23zx3rvtVWVhQONUAEfmd,3VkHkmOtom3jM2wCu94xgzzu1d6Dn7or,5,2,1,0,1,0,3,0,7,1.0,1,0.0,0,1,0,1,2,0,0,3,0,2,5,0
14761,138034,6twJb7OM0lVxnHtdQbt8d0K7pBf1n6K0,3VkHkmOtom3jM2wCu94xgzzu1d6Dn7or,8,10,3,3,5,3,2,0,26,3.7142857142857144,1,0.0,6,3,3,5,4,3,0,2,0,17,9,1
14762,138037,pYkHP5x7PpicYIBiYksxqTU4ENpqxiV1,3VkHkmOtom3jM2wCu94xgzzu1d6Dn7or,4,1,0,0,0,0,6,0,7,1.0,1,0.0,0,0,0,0,1,0,0,6,0,0,7,1
14763,138074,avoglTQYC4DCKpMnGcRw7Ok57lEHfs0W,3VkHkmOtom3jM2wCu94xgzzu1d6Dn7or,1,0,0,0,0,0,1,0,1,0.14285714285714285,1,0.0,0,0,0,0,0,0,0,1,0,0,1,0
14764,138099,iQQAx7M2oD5FMqM5kA5zi1nJ6LBPePEx,3VkHkmOtom3jM2wCu94xgzzu1d6Dn7or,1,0,0,0,0,0,1,0,1,0.14285714285714285,1,0.0,0,0,0,0,0,0,0,1,0,0,1,1
14765,138107,3oa1UsUctLMAomvPDApNdL7P3WUJSL0E,3VkHkmOtom3jM2wCu94xgzzu1d6Dn7or,4,3,0,0,0,0,2,0,5,0.7142857142857143,2,0.0,0,0,0,0,3,0,0,2,0,0,5,0
14766,138113,AWCCZmfvTZNSvcBxmsMY0cPZtpbqQAwA,3VkHkmOtom3jM2wCu94xgzzu1d6Dn7or,29,27,17,0,15,0,3,0,62,8.857142857142858,2,0.0,0,17,0,15,27,0,0,3,0,32,30,0
14767,138117,aUexCGYt3oLeKKwXVGR6OlbnwLZ0wFk7,3VkHkmOtom3jM2wCu94xgzzu1d6Dn7or,4,2,1,0,0,0,2,0,5,0.7142857142857143,1,0.0,0,1,0,0,2,0,0,2,0,1,4,1
14768,138134,4qjH6bYJrz1dToj1ZCKGSJUSJ41mF132,3VkHkmOtom3jM2wCu94xgzzu1d6Dn7or,7,5,2,0,2,0,5,0,14,2.0,1,0.0,2,2,0,2,3,0,0,5,0,6,8,1
14769,138150,PiI0KgV0HpzloKv45OCqpvuWRWy6We0f,3VkHkmOtom3jM2wCu94xgzzu1d6Dn7or,1,0,0,0,0,0,1,0,1,0.14285714285714285,1,0.0,0,0,0,0,0,0,0,1,0,0,1,1
14770,138154,yB6WBMTLFGGr2WaSrIYLPpH4djA6zlv6,3VkHkmOtom3jM2wCu94xgzzu1d6Dn7or,1,0,0,0,0,0,1,0,1,0.14285714285714285,1,0.0,0,0,0,0,0,0,0,1,0,0,1,1
14771,138168,K22VFryh5Od9V1LL0eOyTaqPsCNGJ8v3,3VkHkmOtom3jM2wCu94xgzzu1d6Dn7or,1,0,0,0,0,0,1,0,1,0.14285714285714285,1,0.0,0,0,0,0,0,0,0,1,0,0,1,1
14772,138172,jb9pTa916Vn2VeH0D7ExYaf2JyoI9zrO,7GRhBDsirIGkRZBtSMEzNTyDr2JQm4xx,117,342,11,175,32,69,47,1,677,96.71428571428571,8,0.0,177,11,128,32,165,69,47,47,1,348,329,0
14773,138175,mLD9g4ezOv6SvPMWLaj047DaKrptKosJ,7GRhBDsirIGkRZBtSMEzNTyDr2JQm4xx,46,54,23,34,24,5,3,0,143,20.428571428571427,3,0.0,28,23,18,24,26,5,16,3,0,93,50,1
14774,138179,35TfeVSp4flNgxPYk58l34g9vBVr1z8h,7GRhBDsirIGkRZBtSMEzNTyDr2JQm4xx,31,40,1,25,3,0,9,0,78,11.142857142857142,2,0.0,21,1,13,3,19,0,12,9,0,38,40,1
14775,138181,Ya9ImAuYg40ZVitFPXjW5w7btwU9PgQC,7GRhBDsirIGkRZBtSMEzNTyDr2JQm4xx,1,0,0,0,0,0,2,0,2,0.2857142857142857,1,0.0,0,0,0,0,0,0,0,2,0,0,2,1
14776,138182,Q459I6WtHQ4LYscZN5C0n5NrNaEwzARk,7GRhBDsirIGkRZBtSMEzNTyDr2JQm4xx,1,0,0,0,0,0,1,0,1,0.14285714285714285,1,0.0,0,0,0,0,0,0,0,1,0,0,1,1
14777,138199,x29OOChdmJGXK62DnUpwKbwJurqULmnD,7GRhBDsirIGkRZBtSMEzNTyDr2JQm4xx,13,13,7,0,6,0,6,0,32,4.571428571428571,3,0.0,3,7,0,6,10,0,0,6,0,16,16,0
14778,138201,irIVLRvkXyea4TMdg5wZQ17APoQLOStn,7GRhBDsirIGkRZBtSMEzNTyDr2JQm4xx,8,6,2,0,1,0,5,1,15,2.142857142857143,2,0.0,0,2,0,1,6,0,0,5,1,3,12,1
14779,138211,6CZNpLhEjhPt0wvOAMcoN0nqY9s1WSWS,7GRhBDsirIGkRZBtSMEzNTyDr2JQm4xx,2,0,0,0,0,0,2,0,2,0.2857142857142857,1,0.0,0,0,0,0,0,0,0,2,0,0,2,0
14780,138213,7kqwVTi8J1vkksyD7DuULlscPDGZl1gf,7GRhBDsirIGkRZBtSMEzNTyDr2JQm4xx,1,0,0,0,0,0,1,0,1,0.14285714285714285,1,0.0,0,0,0,0,0,0,0,1,0,0,1,1
14781,138215,RgBHZtppWNmiRr4zn4KqEhMkv6vEscGZ,7GRhBDsirIGkRZBtSMEzNTyDr2JQm4xx,39,68,30,69,22,7,3,0,199,28.428571428571427,3,0.0,28,30,59,22,40,7,10,3,0,139,60,0
14782,138216,31ylinJXeudea9CV3K99OYNFlev2HboL,7GRhBDsirIGkRZBtSMEzNTyDr2JQm4xx,1,0,0,0,0,0,2,0,2,0.2857142857142857,1,0.0,0,0,0,0,0,0,0,2,0,0,2,1
14783,138217,AufaDc7nEuEUGsIcvsJ4qTP7zAlLmyFt,7GRhBDsirIGkRZBtSMEzNTyDr2JQm4xx,1,0,0,0,0,0,1,0,1,0.14285714285714285,1,0.0,0,0,0,0,0,0,0,1,0,0,1,1
14784,138224,fKMTMHW5HJA5wm0UXPvrkod7JaDoIvWG,7GRhBDsirIGkRZBtSMEzNTyDr2JQm4xx,2,0,0,0,0,0,3,0,3,0.42857142857142855,1,0.0,0,0,0,0,0,0,0,3,0,0,3,0
14785,138228,iIZJjkWNE7IT80tlrFqq6usnQI5kIYfv,7GRhBDsirIGkRZBtSMEzNTyDr2JQm4xx,6,5,0,0,0,0,2,0,7,1.0,1,0.0,0,0,0,0,5,0,0,2,0,0,7,1
14786,138232,MfzRriitP2kzeiTWJO2r85qGclUEFMNK,7GRhBDsirIGkRZBtSMEzNTyDr2JQm4xx,6,3,1,0,1,0,5,0,10,1.4285714285714286,1,0.0,0,1,0,1,3,0,0,5,0,2,8,1
14787,138240,JEJrnVrKGVjrX2yiet4Z0AOP8Myw4oGI,SpATywNh6bZuzm8s1ceuBUnMUAeoAHHw,1,0,0,0,0,0,1,0,1,0.14285714285714285,1,0.0,0,0,0,0,0,0,0,1,0,0,1,1
14788,138248,92TVODkqWtTMaGGihgBsUR7wsg2cHNWw,bWdj2GDclj5ofokWjzoa5jAwMkxCykd6,1,0,0,0,0,0,2,0,2,0.2857142857142857,2,0.0,0,0,0,0,0,0,0,2,0,0,2,0
14789,138256,Mm4qww92wRWuqacQYzVAcK0gE3bfzr4C,5X6FeZozNMgE2VRi3MJYjkkFK8SETtu2,9,11,1,0,0,0,10,0,22,3.142857142857143,2,0.0,0,1,0,0,11,0,0,10,0,1,21,1
14790,138264,45E6hpwDMHp9Q3Pt1xT8q04bbowKk87g,7GRhBDsirIGkRZBtSMEzNTyDr2JQm4xx,62,148,42,70,42,2,11,0,315,45.0,4,0.0,96,42,48,42,52,2,22,11,0,228,87,0
14791,138266,pAkhnLI0s5vboktZycO7Tobv6jbspULh,G8EPVSXsOYB5YQWZGiz1aVq5Pgr2GrQu,24,23,14,6,13,0,3,0,59,8.428571428571429,3,0.0,5,14,5,13,18,0,1,3,0,37,22,0
14792,138267,pAkhnLI0s5vboktZycO7Tobv6jbspULh,7GRhBDsirIGkRZBtSMEzNTyDr2JQm4xx,3,2,1,0,0,0,1,0,4,0.5714285714285714,1,0.0,0,1,0,0,2,0,0,1,0,1,3,1
14793,138275,TltI4tFnIUt2Ilw9fmBmSMvm8ptnCBUB,RXDvfPUBYFlVdlueBFbLW0mhhAyGEqpt,5,2,1,0,1,0,2,0,6,0.8571428571428571,1,0.0,0,1,0,1,2,0,0,2,0,2,4,1
14794,138302,pipMQ1pwWDBMapqBdWoTVq67fUR9oaSj,RXDvfPUBYFlVdlueBFbLW0mhhAyGEqpt,7,4,3,0,1,0,2,0,10,1.4285714285714286,1,0.0,0,3,0,1,4,0,0,2,0,4,6,1
14795,138309,UbhuTMEAqMzZPm1igvnyAuhc02uqoSax,SpATywNh6bZuzm8s1ceuBUnMUAeoAHHw,1,0,0,0,0,0,1,0,1,0.14285714285714285,1,0.0,0,0,0,0,0,0,0,1,0,0,1,1
14796,138313,9w5gHPsgcElW4QuPTdd7Y7NaIc3zL312,5X6FeZozNMgE2VRi3MJYjkkFK8SETtu2,8,5,2,0,2,15,6,1,31,4.428571428571429,4,0.0,0,2,0,2,5,15,0,6,1,4,27,1
14797,138314,W6AT73CXG4URTyD2I7QWXXVZx4oeh86N,7GRhBDsirIGkRZBtSMEzNTyDr2JQm4xx,16,24,13,0,7,0,11,0,55,7.857142857142857,3,0.0,4,13,0,7,20,0,0,11,0,24,31,1
14798,138317,r6obx9IpFukvGBmi45WFhJJxXeJI27LQ,bWdj2GDclj5ofokWjzoa5jAwMkxCykd6,2,0,0,0,0,0,3,0,3,0.42857142857142855,1,0.0,0,0,0,0,0,0,0,3,0,0,3,1
14799,138319,yq5rHqpCTagxs6XCaAXxmCSySzn2U3u8,SpATywNh6bZuzm8s1ceuBUnMUAeoAHHw,22,25,16,18,10,1,6,0,76,10.857142857142858,3,0.0,3,16,14,10,22,1,4,6,0,43,33,1
14800,138321,lVwgv61cg8fkhW9rg5b1PIPnuUWxb0Vk,5X6FeZozNMgE2VRi3MJYjkkFK8SETtu2,1,0,0,0,0,0,1,0,1,0.14285714285714285,1,0.0,0,0,0,0,0,0,0,1,0,0,1,1
14801,138324,lVwgv61cg8fkhW9rg5b1PIPnuUWxb0Vk,7GRhBDsirIGkRZBtSMEzNTyDr2JQm4xx,1,0,0,0,0,0,1,0,1,0.14285714285714285,1,0.0,0,0,0,0,0,0,0,1,0,0,1,1
14802,138326,t4tnBhQAPqBnCFRCjzr4Y2gSOW7MaWb7,SpATywNh6bZuzm8s1ceuBUnMUAeoAHHw,8,20,9,0,1,7,15,1,53,7.571428571428571,6,0.0,0,9,0,1,20,7,0,15,1,10,43,0
14803,138327,yq5rHqpCTagxs6XCaAXxmCSySzn2U3u8,A3fsA9Zfv1X2fVEQhTw51lKENdNrEqT3,103,15,8,366,1,0,10,0,400,57.142857142857146,2,0.0,5,8,311,1,10,0,55,10,0,325,75,1
14804,138330,o3T0K8ec78cQHSHsSLzMA1PbvYi8mwTI,A3fsA9Zfv1X2fVEQhTw51lKENdNrEqT3,64,21,1,188,0,1,5,0,216,30.857142857142858,2,0.0,9,1,167,0,12,1,21,5,0,177,39,1
14805,138335,LEAOHJPHpYdkuGGT4C2KU9sm9M4N9guA,bWdj2GDclj5ofokWjzoa5jAwMkxCykd6,11,17,1,0,1,0,5,0,24,3.4285714285714284,1,0.0,0,1,0,1,17,0,0,5,0,2,22,1
14806,138336,Oi0GqKYhNtMDJ1j5HhgzUgmNLW1tCwni,SpATywNh6bZuzm8s1ceuBUnMUAeoAHHw,29,39,20,3,11,0,4,0,77,11.0,2,0.0,0,20,3,11,39,0,0,4,0,34,43,0
14807,138338,V8TGMBMhFLQdnr9mQNCNr5CucGxVWBvw,RXDvfPUBYFlVdlueBFbLW0mhhAyGEqpt,47,39,33,0,27,5,5,0,109,15.571428571428571,4,0.0,2,33,0,27,37,5,0,5,0,62,47,1
14808,138346,dd7Jtt1fMMutX1RG7iWTpWNKUpGu8Lqf,SpATywNh6bZuzm8s1ceuBUnMUAeoAHHw,43,114,47,54,0,35,15,3,268,38.285714285714285,4,0.0,25,47,50,0,89,35,4,15,3,122,146,0
14809,138347,Cw0FoLzIDNyQ045YrBplMRkU4k8BOdoy,SpATywNh6bZuzm8s1ceuBUnMUAeoAHHw,60,54,32,91,18,4,15,0,214,30.571428571428573,2,0.0,16,32,82,18,38,4,9,15,0,148,66,0
14810,138351,drMAzq4nC1GseQmyuPqctPxioPnjLJpD,A3fsA9Zfv1X2fVEQhTw51lKENdNrEqT3,6,9,0,0,0,1,9,1,20,2.857142857142857,3,0.0,0,0,0,0,9,1,0,9,1,0,20,1
14811,138358,8RGLvfdludl70fdPksu2JYtYCxSVr9FR,SpATywNh6bZuzm8s1ceuBUnMUAeoAHHw,18,26,1,20,1,0,4,0,52,7.428571428571429,3,0.0,2,1,16,1,24,0,4,4,0,20,32,1
14812,138360,vutd5xOA0I3oZzggjpSPRu322ASlJa8M,5X6FeZozNMgE2VRi3MJYjkkFK8SETtu2,13,28,1,14,7,0,4,0,54,7.714285714285714,2,0.0,17,1,13,7,11,0,1,4,0,38,16,1
14813,138364,PP4UKfn39ZoKLWFw2leT5G41zKS9D3au,SpATywNh6bZuzm8s1ceuBUnMUAeoAHHw,1,0,0,0,0,0,1,0,1,0.14285714285714285,1,0.0,0,0,0,0,0,0,0,1,0,0,1,1
14814,138367,KAW52VBDXCvurEAry0tITiLWjcxVkV8S,SpATywNh6bZuzm8s1ceuBUnMUAeoAHHw,60,87,42,53,19,63,26,1,291,41.57142857142857,8,0.0,23,42,48,19,64,63,5,26,1,132,159,0
14815,138373,0I055s9vaRQ6PXqeLKyD6l9kPxlReBT2,7GRhBDsirIGkRZBtSMEzNTyDr2JQm4xx,1,0,0,0,0,0,1,0,1,0.14285714285714285,1,0.0,0,0,0,0,0,0,0,1,0,0,1,1
14816,138374,KEJJHIMmL4dWZfXMcnnYliutxFAkeezZ,bWdj2GDclj5ofokWjzoa5jAwMkxCykd6,37,18,16,21,14,8,4,0,81,11.571428571428571,2,0.0,1,16,19,14,17,8,2,4,0,50,31,0
14817,138379,NgtHGelgTuQd8iaakUkaIRT8CwQkRy7Z,SpATywNh6bZuzm8s1ceuBUnMUAeoAHHw,60,56,36,57,23,10,10,1,193,27.571428571428573,2,0.0,13,36,53,23,43,10,4,10,1,125,68,1
14818,138391,uBhod65yy67o51lZxzdiIJO4njBJ2VdC,SpATywNh6bZuzm8s1ceuBUnMUAeoAHHw,5,2,1,0,1,0,2,0,6,0.8571428571428571,1,0.0,0,1,0,1,2,0,0,2,0,2,4,0
14819,138393,GuloJL0KPAXccVBFbD64oIsX2EupuwV0,SpATywNh6bZuzm8s1ceuBUnMUAeoAHHw,46,34,26,30,19,0,5,0,114,16.285714285714285,1,0.0,4,26,28,19,30,0,2,5,0,77,37,0
14820,138406,73Lo5aiYTeasg8R5eGVwIsechNk0OHx6,SpATywNh6bZuzm8s1ceuBUnMUAeoAHHw,16,10,7,0,5,0,7,0,29,4.142857142857143,3,0.0,0,7,0,5,10,0,0,7,0,12,17,1
14821,138409,9BgQxlrJHLSftkwUDKA3hmgF0QPDtIyc,SpATywNh6bZuzm8s1ceuBUnMUAeoAHHw,6,2,0,0,1,0,4,1,8,1.1428571428571428,1,0.0,0,0,0,1,2,0,0,4,1,1,7,1
14822,138420,GGf1UPTxgLShqKb7PDIL9hAwpCBcU4fs,SpATywNh6bZuzm8s1ceuBUnMUAeoAHHw,14,12,9,4,5,0,3,0,33,4.714285714285714,3,0.0,0,9,4,5,12,0,0,3,0,18,15,1
14823,138429,rXCyIAZUSGx3FRINqiP6ViaZECSgS16z,bWdj2GDclj5ofokWjzoa5jAwMkxCykd6,10,10,0,0,1,0,2,0,13,1.8571428571428572,1,0.0,0,0,0,1,10,0,0,2,0,1,12,1
14824,138431,YTOBF6rM3F1fTkDq9LaNboDjZEu7zsXn,SpATywNh6bZuzm8s1ceuBUnMUAeoAHHw,1,0,0,0,0,0,1,0,1,0.14285714285714285,1,0.0,0,0,0,0,0,0,0,1,0,0,1,1
14825,138446,HbkgIsgEIymNiRyXrJMB9mrDP6ahzsjU,SpATywNh6bZuzm8s1ceuBUnMUAeoAHHw,9,7,2,0,2,0,5,0,16,2.2857142857142856,1,0.0,0,2,0,2,7,0,0,5,0,4,12,0
14826,138456,jSWk10JJ0OWajXDG9k2ujEK46fA1leIF,7GRhBDsirIGkRZBtSMEzNTyDr2JQm4xx,2,0,0,0,0,0,2,0,2,0.2857142857142857,1,0.0,0,0,0,0,0,0,0,2,0,0,2,1
14827,138463,byZchbfFcja3MPJAUOAqCEjjJyYmAgdz,SpATywNh6bZuzm8s1ceuBUnMUAeoAHHw,41,38,20,21,11,0,4,0,94,13.428571428571429,3,0.0,15,20,19,11,23,0,2,4,0,65,29,0
14828,138464,hFSLp8dP9IaOj1hzVZj5ZXOHY6VYm2m9,bWdj2GDclj5ofokWjzoa5jAwMkxCykd6,2,0,0,0,0,0,2,0,2,0.2857142857142857,1,0.0,0,0,0,0,0,0,0,2,0,0,2,1
14829,138467,LN6esXV3qnIoLg44h6fXbTBvNC9pi5Ym,7GRhBDsirIGkRZBtSMEzNTyDr2JQm4xx,1,0,0,0,0,0,1,0,1,0.14285714285714285,1,0.0,0,0,0,0,0,0,0,1,0,0,1,1
14830,138470,F0GZauOZl5SQ5SSX2PLewCWNOAV63pop,RXDvfPUBYFlVdlueBFbLW0mhhAyGEqpt,13,11,4,6,3,1,3,0,28,4.0,2,0.0,2,4,6,3,9,1,0,3,0,15,13,1
14831,138474,LN6esXV3qnIoLg44h6fXbTBvNC9pi5Ym,A3fsA9Zfv1X2fVEQhTw51lKENdNrEqT3,2,0,0,0,0,0,4,0,4,0.5714285714285714,1,0.0,0,0,0,0,0,0,0,4,0,0,4,1
14832,138484,YbQfcgwKrjskWW3wyOzQUUJYzdeHmY82,bWdj2GDclj5ofokWjzoa5jAwMkxCykd6,32,27,22,0,17,0,4,0,70,10.0,1,0.0,2,22,0,17,25,0,0,4,0,41,29,0
14833,138493,mmwy46SxulcFPXdkpDL2rsDLyABm0kYD,G8EPVSXsOYB5YQWZGiz1aVq5Pgr2GrQu,1,0,0,0,0,0,1,0,1,0.14285714285714285,1,0.0,0,0,0,0,0,0,0,1,0,0,1,1
14834,138494,9W7krcQjxHzGneO4ukXmCK8o9LZUjHFG,SpATywNh6bZuzm8s1ceuBUnMUAeoAHHw,1,0,0,0,0,0,1,0,1,0.14285714285714285,1,0.0,0,0,0,0,0,0,0,1,0,0,1,0
14835,138495,phUbJgbIGGa7ctfmqKFL5A4ez8Y8gbBs,SpATywNh6bZuzm8s1ceuBUnMUAeoAHHw,36,32,24,6,17,0,10,0,89,12.714285714285714,4,0.0,0,24,5,17,32,0,1,10,0,46,43,1
14836,138507,MpirycsifxnqK6u8Sn5hIRSvmckHkzCA,SpATywNh6bZuzm8s1ceuBUnMUAeoAHHw,9,11,5,0,1,0,2,0,19,2.7142857142857144,1,0.0,0,5,0,1,11,0,0,2,0,6,13,1
14837,138510,eh4s2O0xG3K7bB3gC9QI2pZbmOHi0FkP,7GRhBDsirIGkRZBtSMEzNTyDr2JQm4xx,6,2,1,0,1,0,3,0,7,1.0,1,0.0,0,1,0,1,2,0,0,3,0,2,5,1
14838,138515,2Vr8sMi8Nmtw7GvPlYj3ww9EzMgjDWh8,SpATywNh6bZuzm8s1ceuBUnMUAeoAHHw,44,206,80,31,28,19,37,3,404,57.714285714285715,10,0.0,48,80,30,28,158,19,1,37,3,186,218,0
14839,138523,BhCvmy8WtOEti83wDjK9xOLWP4oCctij,RXDvfPUBYFlVdlueBFbLW0mhhAyGEqpt,22,34,2,34,3,2,5,0,80,11.428571428571429,4,0.0,11,2,32,3,23,2,2,5,0,48,32,1
14840,138534,ilUzpPaeFISeGNY7Nt0DehBLL3wxQX0O,7GRhBDsirIGkRZBtSMEzNTyDr2JQm4xx,9,1,1,0,1,0,8,0,11,1.5714285714285714,1,0.0,0,1,0,1,1,0,0,8,0,2,9,1
14841,138537,e3wyIozlRLlcs7B7d4wJ9CCyj0Cy9HNB,7GRhBDsirIGkRZBtSMEzNTyDr2JQm4xx,7,2,1,0,1,0,4,1,9,1.2857142857142858,1,0.0,0,1,0,1,2,0,0,4,1,2,7,1
14842,138553,okqN4nBVKRYYrkYonKicKGOmPqVGYjZh,SpATywNh6bZuzm8s1ceuBUnMUAeoAHHw,15,34,17,15,6,0,18,0,90,12.857142857142858,6,0.0,3,17,14,6,31,0,1,18,0,40,50,0
14843,138559,WNxlasM9yolV5j0jIrxkqf7jn6zMrkGu,SpATywNh6bZuzm8s1ceuBUnMUAeoAHHw,34,54,25,35,9,2,12,0,137,19.571428571428573,8,0.0,21,25,33,9,33,2,2,12,0,88,49,0
14844,138592,GMf4nDF86vAQn7o32sgKeW8Q5bPvplyR,SpATywNh6bZuzm8s1ceuBUnMUAeoAHHw,1,0,0,0,0,0,1,0,1,0.14285714285714285,1,0.0,0,0,0,0,0,0,0,1,0,0,1,1
14845,138596,D6KOlmquo7I0tYjdBYopRvmG8dULoSiy,SpATywNh6bZuzm8s1ceuBUnMUAeoAHHw,1,0,0,0,0,0,1,0,1,0.14285714285714285,1,0.0,0,0,0,0,0,0,0,1,0,0,1,1
14846,138597,S5iRqyOmmXNAeHlaI33tGlS1KWic6aj1,A3fsA9Zfv1X2fVEQhTw51lKENdNrEqT3,7,2,1,0,1,0,6,0,10,1.4285714285714286,1,0.0,0,1,0,1,2,0,0,6,0,2,8,1
14847,138605,0TwmbDZ9MIyhTy6dnWnLvFIAROrnAMuZ,A3fsA9Zfv1X2fVEQhTw51lKENdNrEqT3,16,16,11,0,7,0,13,0,47,6.714285714285714,2,0.0,1,11,0,7,15,0,0,13,0,19,28,0
14848,138607,XDhMhAgbTguQNFGPykY6IJEQSl3DEa3i,SpATywNh6bZuzm8s1ceuBUnMUAeoAHHw,28,33,15,20,10,1,4,0,83,11.857142857142858,2,0.0,7,15,19,10,26,1,1,4,0,51,32,0
14849,138617,Godw4MPsn7e3CY6DWEArhTuLJcMvjBtb,SpATywNh6bZuzm8s1ceuBUnMUAeoAHHw,26,35,2,0,2,0,3,0,42,6.0,1,0.0,3,2,0,2,32,0,0,3,0,7,35,0
14850,138621,dgFOOUSNfQK8xIrT47Av0Q04bBFeE21W,RXDvfPUBYFlVdlueBFbLW0mhhAyGEqpt,1,0,0,0,0,0,2,0,2,0.2857142857142857,2,0.0,0,0,0,0,0,0,0,2,0,0,2,1
14851,138627,QZoi4xpkEVVH2rbYL53oYFfYungIuUup,7GRhBDsirIGkRZBtSMEzNTyDr2JQm4xx,35,42,13,63,11,5,15,3,152,21.714285714285715,3,0.0,24,13,56,11,18,5,7,15,3,104,48,1
14852,138628,pobtqs5WzDAQy06CllYnfSilz3k396iM,5X6FeZozNMgE2VRi3MJYjkkFK8SETtu2,5,2,1,0,1,0,3,0,7,1.0,1,0.0,0,1,0,1,2,0,0,3,0,2,5,1
14853,138635,fUQHFT4QEMRSPqJAQlXlvlyNwca9Q0dU,5X6FeZozNMgE2VRi3MJYjkkFK8SETtu2,2,0,0,0,0,0,2,0,2,0.2857142857142857,1,0.0,0,0,0,0,0,0,0,2,0,0,2,1
14854,138636,rQBPx7NxAW8uUENR4ioCffkqkz2l2Zdk,SpATywNh6bZuzm8s1ceuBUnMUAeoAHHw,14,12,2,0,3,0,9,0,26,3.7142857142857144,1,0.0,0,2,0,3,12,0,0,9,0,5,21,0
14855,138638,fUQHFT4QEMRSPqJAQlXlvlyNwca9Q0dU,7GRhBDsirIGkRZBtSMEzNTyDr2JQm4xx,2,0,0,0,0,0,2,0,2,0.2857142857142857,1,0.0,0,0,0,0,0,0,0,2,0,0,2,1
14856,138668,C9M4L6lmYvlB2RHCf26FkWqXSt1Mshvm,SpATywNh6bZuzm8s1ceuBUnMUAeoAHHw,1,0,0,0,0,0,1,0,1,0.14285714285714285,1,0.0,0,0,0,0,0,0,0,1,0,0,1,1
14857,138669,ocJfmop89q8wSvbacXliS7aVaEtu1fL9,SpATywNh6bZuzm8s1ceuBUnMUAeoAHHw,14,13,6,0,2,0,7,1,29,4.142857142857143,1,0.0,2,6,0,2,11,0,0,7,1,10,19,1
14858,138676,54s32diFNl04mUbmkn3h7tEt4XEhQ65w,SpATywNh6bZuzm8s1ceuBUnMUAeoAHHw,45,63,0,73,0,25,10,0,171,24.428571428571427,3,0.0,11,0,67,0,52,25,6,10,0,78,93,1
14859,138682,LVgGKe8GEjU3xNkkgcLCws2DFML8rckJ,G8EPVSXsOYB5YQWZGiz1aVq5Pgr2GrQu,9,10,3,0,2,0,4,0,19,2.7142857142857144,2,0.0,0,3,0,2,10,0,0,4,0,5,14,1
14860,138683,FjU6QtF6tkFpwGWrgtA1sVqJ0AzkSd7O,SpATywNh6bZuzm8s1ceuBUnMUAeoAHHw,1,0,0,0,0,0,1,0,1,0.14285714285714285,1,0.0,0,0,0,0,0,0,0,1,0,0,1,1
14861,138685,w5dGML1pfjDAMxCnLd2PebUfpsrNLp1J,SpATywNh6bZuzm8s1ceuBUnMUAeoAHHw,8,12,6,0,0,0,12,0,30,4.285714285714286,2,0.0,3,6,0,0,9,0,0,12,0,9,21,1
14862,138692,ixs1CEJxkJS0gIphbPcsPzQNrY8VNX7l,bWdj2GDclj5ofokWjzoa5jAwMkxCykd6,33,62,30,54,22,59,22,3,252,36.0,4,0.0,11,30,52,22,51,59,2,22,3,115,137,1
14863,138697,hqCEmHevHWO3zOOJGQPPXN8yqCSfkWdM,SpATywNh6bZuzm8s1ceuBUnMUAeoAHHw,11,21,15,0,12,1,2,0,51,7.285714285714286,1,0.0,4,15,0,12,17,1,0,2,0,31,20,1
14864,138706,pbrp10nKU3FSv5db8NaDnlmsVOuCQ4Jk,SpATywNh6bZuzm8s1ceuBUnMUAeoAHHw,1,0,0,0,0,0,1,0,1,0.14285714285714285,1,0.0,0,0,0,0,0,0,0,1,0,0,1,1
14865,138711,2mcFXXl5IuZRP6QuFfHO1XF6KcVjhONf,SpATywNh6bZuzm8s1ceuBUnMUAeoAHHw,24,29,20,14,12,0,7,0,82,11.714285714285714,6,0.0,0,20,11,12,29,0,3,7,0,43,39,0
14866,138716,bWXDTeHwMBrcFvsHEHi16Kcz6vnkKBkc,SpATywNh6bZuzm8s1ceuBUnMUAeoAHHw,2,0,0,0,0,0,4,0,4,0.5714285714285714,2,0.0,0,0,0,0,0,0,0,4,0,0,4,1
14867,138723,nqLRPpborGO3IzbD5YxVONrZGqxfXpwO,SpATywNh6bZuzm8s1ceuBUnMUAeoAHHw,5,2,1,0,1,0,2,0,6,0.8571428571428571,1,0.0,0,1,0,1,2,0,0,2,0,2,4,1
14868,138725,IreR9lbRJ0OvrS5Rrkgo4wb8DgdRtNqY,G8EPVSXsOYB5YQWZGiz1aVq5Pgr2GrQu,7,5,0,0,0,0,3,0,8,1.1428571428571428,1,0.0,0,0,0,0,5,0,0,3,0,0,8,1
14869,138728,kcajSl3XvPJzA8r8jTipqgj4EAGyDqJf,7GRhBDsirIGkRZBtSMEzNTyDr2JQm4xx,15,47,1,16,5,1,4,0,74,10.571428571428571,2,0.0,23,1,14,5,24,1,2,4,0,43,31,1
14870,138731,Za7TsRG0IgcPg4zI5JWLKyABDBTbji9K,7GRhBDsirIGkRZBtSMEzNTyDr2JQm4xx,25,64,2,64,5,0,5,0,140,20.0,3,0.0,33,2,56,5,31,0,8,5,0,96,44,1
14871,138736,Sz9JtbyfGasFOcDw3qsqx6peODd97ECd,7GRhBDsirIGkRZBtSMEzNTyDr2JQm4xx,5,2,1,0,1,0,2,0,6,0.8571428571428571,2,0.0,0,1,0,1,2,0,0,2,0,2,4,1
14872,138746,IvlJ5Ne8x58imY8N2ImajFJcbQ8NSddM,SpATywNh6bZuzm8s1ceuBUnMUAeoAHHw,7,8,5,0,3,0,4,1,21,3.0,1,0.0,0,5,0,3,8,0,0,4,1,8,13,1
14873,138752,IvlJ5Ne8x58imY8N2ImajFJcbQ8NSddM,G8EPVSXsOYB5YQWZGiz1aVq5Pgr2GrQu,5,2,1,0,1,0,2,0,6,0.8571428571428571,1,0.0,0,1,0,1,2,0,0,2,0,2,4,1
14874,138773,KgI4N8obM77BN2pWGuwW2XEP0R0bVgvd,SpATywNh6bZuzm8s1ceuBUnMUAeoAHHw,1,0,0,0,0,0,1,0,1,0.14285714285714285,1,0.0,0,0,0,0,0,0,0,1,0,0,1,1
14875,138779,hSiX0gsGM42qIOLoQHVi7PexCDmJMGeO,SpATywNh6bZuzm8s1ceuBUnMUAeoAHHw,21,39,20,0,9,1,19,4,92,13.142857142857142,2,0.0,0,20,0,9,39,1,0,19,4,29,63,0
14876,138784,Cht8Ar5rNwhCbXwxQlDDBBiX3UVSTbja,G8EPVSXsOYB5YQWZGiz1aVq5Pgr2GrQu,1,0,0,0,0,0,1,0,1,0.14285714285714285,1,0.0,0,0,0,0,0,0,0,1,0,0,1,1
14877,138787,7hJ2ePjWExHA9UJ56RXVpLrBuHR3eqnW,SpATywNh6bZuzm8s1ceuBUnMUAeoAHHw,5,2,1,0,1,0,3,0,7,1.0,2,0.0,0,1,0,1,2,0,0,3,0,2,5,0
14878,138806,mEHAVnTSPxrqijaXglU7YL6yhhw9zDNh,SpATywNh6bZuzm8s1ceuBUnMUAeoAHHw,5,2,1,0,1,0,2,0,6,0.8571428571428571,1,0.0,0,1,0,1,2,0,0,2,0,2,4,1
14879,138808,wZxGcsfZmDyO3eZaMEp8V4Qxwmu1n6lt,A3fsA9Zfv1X2fVEQhTw51lKENdNrEqT3,148,79,61,332,41,17,21,0,551,78.71428571428571,8,0.0,6,61,263,41,73,17,69,21,0,371,180,0
14880,138810,KarP5JDxaA55wR1ThEFPoGYFsHmbBCZf,SpATywNh6bZuzm8s1ceuBUnMUAeoAHHw,14,14,6,6,3,0,4,0,33,4.714285714285714,3,0.0,3,6,6,3,11,0,0,4,0,18,15,1
14881,138833,3dQnEtCSBapAIfvKu6nxUNhPLUtc5bv5,SpATywNh6bZuzm8s1ceuBUnMUAeoAHHw,2,0,0,0,0,0,3,0,3,0.42857142857142855,2,0.0,0,0,0,0,0,0,0,3,0,0,3,1
14882,138841,DZpFukg3Xf0cnebae81BlsdASyy3V2qH,SpATywNh6bZuzm8s1ceuBUnMUAeoAHHw,1,0,0,0,0,0,1,0,1,0.14285714285714285,1,0.0,0,0,0,0,0,0,0,1,0,0,1,1
14883,138860,nZH2h9tRgS1XihszFT0Gsl3zQK5yTzdn,G8EPVSXsOYB5YQWZGiz1aVq5Pgr2GrQu,8,3,1,0,1,0,8,0,13,1.8571428571428572,1,0.0,0,1,0,1,3,0,0,8,0,2,11,1
14884,138864,2YnAwfYuSOt3uEyCQgsGW618p6jbN0IY,SpATywNh6bZuzm8s1ceuBUnMUAeoAHHw,6,3,1,0,1,0,2,0,7,1.0,1,0.0,0,1,0,1,3,0,0,2,0,2,5,1
14885,138866,e26S3yWE4iC2a5gPCzthjRLKEGyf631u,A3fsA9Zfv1X2fVEQhTw51lKENdNrEqT3,1,0,0,0,0,0,1,0,1,0.14285714285714285,1,0.0,0,0,0,0,0,0,0,1,0,0,1,1
14886,138873,lLp4bdT6ycggmaUdjHCcgWeQnh0T1b1d,SpATywNh6bZuzm8s1ceuBUnMUAeoAHHw,15,32,13,0,6,0,5,0,56,8.0,4,0.0,8,13,0,6,24,0,0,5,0,27,29,1
14887,138880,VsfU7jeSb2K8k0CBzCZzXJjDlMye1sB1,RXDvfPUBYFlVdlueBFbLW0mhhAyGEqpt,11,8,4,0,1,1,8,1,23,3.2857142857142856,2,0.0,0,4,0,1,8,1,0,8,1,5,18,0
14888,138890,fO1rPCd8LF1QZM5kj2eXZwLqI6uO4Zpz,SpATywNh6bZuzm8s1ceuBUnMUAeoAHHw,6,3,2,0,2,0,1,0,8,1.1428571428571428,1,0.0,0,2,0,2,3,0,0,1,0,4,4,1
14889,138896,kjBA6VJ4qmelOBTnvk6RkA4J30dOR7mL,RXDvfPUBYFlVdlueBFbLW0mhhAyGEqpt,1,0,0,0,0,0,1,0,1,0.14285714285714285,1,0.0,0,0,0,0,0,0,0,1,0,0,1,1
14890,138898,mSs5bB1Rxg3xYWjWjJY9pVTt7WAiMgyu,RXDvfPUBYFlVdlueBFbLW0mhhAyGEqpt,8,11,6,0,1,0,13,0,31,4.428571428571429,2,0.0,0,6,0,1,11,0,0,13,0,7,24,0
14891,138899,o2SXMMuwkAchmNytI57JyhMVRzDpUVn5,SpATywNh6bZuzm8s1ceuBUnMUAeoAHHw,8,5,4,0,2,0,2,0,13,1.8571428571428572,1,0.0,0,4,0,2,5,0,0,2,0,6,7,1
14892,138907,uzPUKUi7vVAcTKZXvlLeqjC4erxz8WBI,RXDvfPUBYFlVdlueBFbLW0mhhAyGEqpt,1,0,0,0,0,0,1,0,1,0.14285714285714285,1,0.0,0,0,0,0,0,0,0,1,0,0,1,1
14893,138915,hKt77EvNF2V8dULpUFYS5RKu3nxqT9mr,SpATywNh6bZuzm8s1ceuBUnMUAeoAHHw,9,9,3,0,1,0,6,1,20,2.857142857142857,2,0.0,2,3,0,1,7,0,0,6,1,6,14,1
14894,138921,SdmxANaN4VeJNVCXABSOs77O0krJ65nl,SpATywNh6bZuzm8s1ceuBUnMUAeoAHHw,56,77,46,65,21,10,27,5,251,35.857142857142854,6,0.0,8,46,57,21,69,10,8,27,5,132,119,1
14895,138925,EoOFKLnEYmufwMQdHqSZZDxomOFT0KCX,G8EPVSXsOYB5YQWZGiz1aVq5Pgr2GrQu,1,0,0,0,0,0,1,0,1,0.14285714285714285,1,0.0,0,0,0,0,0,0,0,1,0,0,1,1
14896,138929,E140VfvbscDqlcRAWBL1Py2bsKG92tJe,SpATywNh6bZuzm8s1ceuBUnMUAeoAHHw,5,5,1,0,0,0,5,0,11,1.5714285714285714,2,0.0,0,1,0,0,5,0,0,5,0,1,10,0
14897,138932,mSs5bB1Rxg3xYWjWjJY9pVTt7WAiMgyu,5X6FeZozNMgE2VRi3MJYjkkFK8SETtu2,5,0,0,0,0,9,4,1,14,2.0,2,0.0,0,0,0,0,0,9,0,4,1,0,14,1
14898,138933,YbQfcgwKrjskWW3wyOzQUUJYzdeHmY82,7GRhBDsirIGkRZBtSMEzNTyDr2JQm4xx,18,37,8,6,9,0,2,0,62,8.857142857142858,1,0.0,18,8,6,9,19,0,0,2,0,41,21,1
14899,138940,fO1rPCd8LF1QZM5kj2eXZwLqI6uO4Zpz,bWdj2GDclj5ofokWjzoa5jAwMkxCykd6,6,6,4,2,3,0,2,0,17,2.4285714285714284,1,0.0,1,4,2,3,5,0,0,2,0,10,7,0
14900,138964,A9y7TPUaNly8tUFOq4q4aCFlU3ogHi28,SpATywNh6bZuzm8s1ceuBUnMUAeoAHHw,5,2,1,0,1,0,2,0,6,0.8571428571428571,1,0.0,0,1,0,1,2,0,0,2,0,2,4,1
14901,138979,9Mbi6CksSOlTvzJd1jV7pzorOP4mmF9E,SpATywNh6bZuzm8s1ceuBUnMUAeoAHHw,37,46,23,6,13,0,15,0,103,14.714285714285714,9,0.0,3,23,5,13,43,0,1,15,0,44,59,0
14902,138984,Dxd5J10xLvv5WcPvQgJwM2KUHZjk0MHz,A3fsA9Zfv1X2fVEQhTw51lKENdNrEqT3,11,5,4,0,4,0,2,0,15,2.142857142857143,1,0.0,0,4,0,4,5,0,0,2,0,8,7,1
14903,138998,oho8eUx0qt2QgQUM9H4Puo64w9V5nVUl,bWdj2GDclj5ofokWjzoa5jAwMkxCykd6,25,26,10,60,8,1,14,2,121,17.285714285714285,2,0.0,12,10,56,8,14,1,4,14,2,86,35,1
14904,139001,PLKaanKvHCtHMqtCskLE9sVgrYP9vmXy,SpATywNh6bZuzm8s1ceuBUnMUAeoAHHw,34,58,24,48,7,4,11,1,153,21.857142857142858,7,0.0,24,24,43,7,34,4,5,11,1,98,55,0
14905,139009,ucdoEtZyBMBpMuHw7eldMzgNsB5u9NZD,7GRhBDsirIGkRZBtSMEzNTyDr2JQm4xx,2,0,0,0,0,0,2,0,2,0.2857142857142857,1,0.0,0,0,0,0,0,0,0,2,0,0,2,1
14906,139010,JZlzHSkEZVINL2AGduN6dQZUtjTJ410F,SpATywNh6bZuzm8s1ceuBUnMUAeoAHHw,1,0,0,0,0,0,1,0,1,0.14285714285714285,1,0.0,0,0,0,0,0,0,0,1,0,0,1,1
14907,139023,Uxd7sramSgOYbTkMuTemo7Lms4lBJja0,G8EPVSXsOYB5YQWZGiz1aVq5Pgr2GrQu,27,34,23,0,21,0,8,0,86,12.285714285714286,1,0.0,2,23,0,21,32,0,0,8,0,46,40,0
14908,139030,nZH2h9tRgS1XihszFT0Gsl3zQK5yTzdn,7GRhBDsirIGkRZBtSMEzNTyDr2JQm4xx,1,0,0,0,0,0,2,0,2,0.2857142857142857,1,0.0,0,0,0,0,0,0,0,2,0,0,2,1
14909,139033,AADHk2CnqIXqU54SVoJYYzHXkzsT7VVX,bWdj2GDclj5ofokWjzoa5jAwMkxCykd6,5,7,4,0,0,0,3,0,14,2.0,2,0.0,0,4,0,0,7,0,0,3,0,4,10,1
14910,139038,l7NRPJc4rUDr4y6zY2SQw5RLUlkDSz6O,SpATywNh6bZuzm8s1ceuBUnMUAeoAHHw,5,2,1,0,1,0,2,0,6,0.8571428571428571,1,0.0,0,1,0,1,2,0,0,2,0,2,4,1
14911,139042,8zAtOSKV7R70cZuke03f42P9Tj2cyqBy,SpATywNh6bZuzm8s1ceuBUnMUAeoAHHw,1,0,0,0,0,0,1,0,1,0.14285714285714285,1,0.0,0,0,0,0,0,0,0,1,0,0,1,1
14912,139077,sTlxlEkJ3MbMUAeSajnaHOGfpyW9hgq1,7GRhBDsirIGkRZBtSMEzNTyDr2JQm4xx,4,3,1,0,1,0,1,0,6,0.8571428571428571,1,0.0,0,1,0,1,3,0,0,1,0,2,4,1
14913,139083,nVzZqtkPutJNXrjSnq18UP0Fihh22RZh,5X6FeZozNMgE2VRi3MJYjkkFK8SETtu2,2,0,0,0,0,0,2,0,2,0.2857142857142857,1,0.0,0,0,0,0,0,0,0,2,0,0,2,1
14914,139091,FqxZInDGuTXmPgpy2HmrKGvUbRHydqL9,A3fsA9Zfv1X2fVEQhTw51lKENdNrEqT3,54,51,37,96,18,12,13,3,230,32.857142857142854,4,0.0,4,37,76,18,47,12,20,13,3,135,95,1
14915,139097,rJa06nlcyBimvgL7PoPXhuOUbmR9mddR,7GRhBDsirIGkRZBtSMEzNTyDr2JQm4xx,1,0,0,0,0,0,1,0,1,0.14285714285714285,1,0.0,0,0,0,0,0,0,0,1,0,0,1,1
14916,139100,ufkSOeGuf3AfIrzMjRVDs6ilWKaIwHHV,SpATywNh6bZuzm8s1ceuBUnMUAeoAHHw,36,54,8,40,4,0,14,0,120,17.142857142857142,4,0.0,14,8,37,4,40,0,3,14,0,63,57,1
14917,139110,CbHE8hCSYPvdgYMpDUO4zyKrMGfMTSJS,RXDvfPUBYFlVdlueBFbLW0mhhAyGEqpt,1,0,0,0,0,0,1,0,1,0.14285714285714285,1,0.0,0,0,0,0,0,0,0,1,0,0,1,1
14918,139122,FIYIY0le6IgAtT64SQdOQ9wlHEZCwQOO,bWdj2GDclj5ofokWjzoa5jAwMkxCykd6,1,0,0,0,0,0,2,0,2,0.2857142857142857,1,0.0,0,0,0,0,0,0,0,2,0,0,2,1
14919,139128,QaUj3eOwCavlOK096M7ra3BPeu9HLHwH,SpATywNh6bZuzm8s1ceuBUnMUAeoAHHw,15,17,3,10,3,0,8,0,41,5.857142857142857,4,0.0,2,3,9,3,15,0,1,8,0,17,24,0
14920,139130,EcFLaX7m7PzXKDd48eR92uOnZACA5T7k,SpATywNh6bZuzm8s1ceuBUnMUAeoAHHw,4,2,1,0,0,0,2,0,5,0.7142857142857143,1,0.0,0,1,0,0,2,0,0,2,0,1,4,1
14921,139138,pLMdR2T5UiKa0jLlBQ6JAVdYxLS2oAZC,7GRhBDsirIGkRZBtSMEzNTyDr2JQm4xx,9,8,6,0,5,0,3,0,22,3.142857142857143,2,0.0,0,6,0,5,8,0,0,3,0,11,11,1
14922,139142,uHDgildzp3tPJLxwWBJTKE08lfp58kYr,SpATywNh6bZuzm8s1ceuBUnMUAeoAHHw,19,13,9,6,7,0,3,0,38,5.428571428571429,2,0.0,0,9,5,7,13,0,1,3,0,21,17,0
14923,139147,8FRW3fq2kTtq4r8tmTLCvi2IiJ0rjp3S,5X6FeZozNMgE2VRi3MJYjkkFK8SETtu2,5,2,1,0,1,0,4,0,8,1.1428571428571428,1,0.0,0,1,0,1,2,0,0,4,0,2,6,1
14924,139152,SsP0xcwMwuo4obRVxCDjDqMOPLlv2HNO,SpATywNh6bZuzm8s1ceuBUnMUAeoAHHw,8,12,9,0,8,0,5,0,34,4.857142857142857,1,0.0,0,9,0,8,12,0,0,5,0,17,17,1
14925,139155,j54JBLGJIJ4pHZN5w24SsPoFU8DYGtev,bWdj2GDclj5ofokWjzoa5jAwMkxCykd6,4,2,1,0,1,0,1,0,5,0.7142857142857143,1,0.0,0,1,0,1,2,0,0,1,0,2,3,1
14926,139165,emLy0wxTS6s6x2ntzW39vmfcR0P0HK07,G8EPVSXsOYB5YQWZGiz1aVq5Pgr2GrQu,11,19,9,8,4,0,3,0,43,6.142857142857143,3,0.0,7,9,5,4,12,0,3,3,0,25,18,1
14927,139166,RilPnDVnlT9lfSJkTtPGJBpYx1VNW6Lv,RXDvfPUBYFlVdlueBFbLW0mhhAyGEqpt,23,14,13,0,9,0,2,0,38,5.428571428571429,1,0.0,0,13,0,9,14,0,0,2,0,22,16,0
14928,139172,vQiAys6oOekX5OV9gzy071CxobZT5OY1,7GRhBDsirIGkRZBtSMEzNTyDr2JQm4xx,1,0,0,0,0,0,1,0,1,0.14285714285714285,1,0.0,0,0,0,0,0,0,0,1,0,0,1,1
14929,139195,O6WL6sxvoPCZnvTLyTPxdXbnpOz3wcJ4,SpATywNh6bZuzm8s1ceuBUnMUAeoAHHw,1,0,0,0,0,0,1,0,1,0.14285714285714285,1,0.0,0,0,0,0,0,0,0,1,0,0,1,0
14930,139207,RIjNzTzWwuMpVu0vcsF9N8cORAAtLFQn,bWdj2GDclj5ofokWjzoa5jAwMkxCykd6,7,11,1,0,4,0,7,0,23,3.2857142857142856,2,0.0,5,1,0,4,6,0,0,7,0,10,13,1
14931,139217,OOIu03NBEHePUSUIFa86FGFP5M136EAn,RXDvfPUBYFlVdlueBFbLW0mhhAyGEqpt,97,141,61,206,38,12,38,4,500,71.42857142857143,10,0.0,22,61,191,38,119,12,15,38,4,312,188,0
14932,139222,St6usTSSgX5U9v7wchuMWqmBKoCcDwN2,bWdj2GDclj5ofokWjzoa5jAwMkxCykd6,9,10,0,20,0,0,3,0,33,4.714285714285714,3,0.0,2,0,20,0,8,0,0,3,0,22,11,1
14933,139230,Az3rIdfQyspbBZOuftkV0XmT1mpRRVMU,G8EPVSXsOYB5YQWZGiz1aVq5Pgr2GrQu,13,7,4,0,4,0,5,0,20,2.857142857142857,2,0.0,0,4,0,4,7,0,0,5,0,8,12,1
14934,139232,S4NIV7rLz6yEEE3xTS1sucASvuOIiFcC,5X6FeZozNMgE2VRi3MJYjkkFK8SETtu2,1,0,0,0,0,0,1,0,1,0.14285714285714285,1,0.0,0,0,0,0,0,0,0,1,0,0,1,1
14935,139246,3nkAYJy31glMu7RttArFOqU7gmkfxNPM,SpATywNh6bZuzm8s1ceuBUnMUAeoAHHw,22,56,11,53,3,0,16,3,142,20.285714285714285,7,0.0,44,11,48,3,12,0,5,16,3,106,36,0
14936,139250,NLUFE7ndaVQ8A2tkIa8xBpPqWZbahAYT,5X6FeZozNMgE2VRi3MJYjkkFK8SETtu2,30,40,15,54,15,9,6,1,140,20.0,2,0.0,22,15,41,15,18,9,13,6,1,93,47,1
14937,139252,AKVd0gnvEJlgz6OnGwqybMUQOVjHL58y,SpATywNh6bZuzm8s1ceuBUnMUAeoAHHw,50,74,52,54,35,7,14,0,236,33.714285714285715,9,0.0,7,52,46,35,67,7,8,14,0,140,96,0
14938,139256,oho8eUx0qt2QgQUM9H4Puo64w9V5nVUl,A3fsA9Zfv1X2fVEQhTw51lKENdNrEqT3,1,0,0,0,0,0,1,0,1,0.14285714285714285,1,0.0,0,0,0,0,0,0,0,1,0,0,1,0
14939,139262,CQI3ipMoYWvyV7ZuewrTlOYAM3gikvMq,7GRhBDsirIGkRZBtSMEzNTyDr2JQm4xx,14,16,8,4,5,0,5,0,38,5.428571428571429,2,0.0,4,8,4,5,12,0,0,5,0,21,17,1
14940,139268,QCD1u7mUCxrAs3C6jTFrAgxI51q3Q7rz,RXDvfPUBYFlVdlueBFbLW0mhhAyGEqpt,1,0,0,0,0,0,1,0,1,0.14285714285714285,1,0.0,0,0,0,0,0,0,0,1,0,0,1,1
14941,139270,9W6HDa8nbr3i4rkBKbOa5qCJz73HRO2D,7GRhBDsirIGkRZBtSMEzNTyDr2JQm4xx,18,20,9,25,8,0,4,0,66,9.428571428571429,2,0.0,9,9,21,8,11,0,4,4,0,47,19,1
14942,139272,izfjE6NG3af26sY3NuLKpzoBmikc8i1O,A3fsA9Zfv1X2fVEQhTw51lKENdNrEqT3,5,2,1,0,1,0,4,0,8,1.1428571428571428,1,0.0,0,1,0,1,2,0,0,4,0,2,6,1
14943,139275,XqfKw12BYBxvQyUszKCvSmcUn4H9qRJJ,bWdj2GDclj5ofokWjzoa5jAwMkxCykd6,5,5,3,0,2,0,2,0,12,1.7142857142857142,2,0.0,0,3,0,2,5,0,0,2,0,5,7,1
14944,139277,S4NIV7rLz6yEEE3xTS1sucASvuOIiFcC,RXDvfPUBYFlVdlueBFbLW0mhhAyGEqpt,1,0,0,0,0,0,1,0,1,0.14285714285714285,1,0.0,0,0,0,0,0,0,0,1,0,0,1,1
14945,139285,XqfKw12BYBxvQyUszKCvSmcUn4H9qRJJ,A3fsA9Zfv1X2fVEQhTw51lKENdNrEqT3,9,14,9,0,2,0,5,0,30,4.285714285714286,2,0.0,1,9,0,2,13,0,0,5,0,12,18,1
14946,139294,Gei04etgXyrCJnYW4R2aEBjKo3aqgVnG,SpATywNh6bZuzm8s1ceuBUnMUAeoAHHw,5,2,1,0,1,0,2,0,6,0.8571428571428571,1,0.0,0,1,0,1,2,0,0,2,0,2,4,1
14947,139322,AAAvWauitKfXD0xRpNsfpOKQu223kCXG,A3fsA9Zfv1X2fVEQhTw51lKENdNrEqT3,13,12,7,0,3,1,6,0,29,4.142857142857143,3,0.0,1,7,0,3,11,1,0,6,0,11,18,1
14948,139324,hT3A3NhtOhvHOWKsgHNINVDyTB0qBxh1,SpATywNh6bZuzm8s1ceuBUnMUAeoAHHw,21,56,15,31,7,3,13,1,126,18.0,4,0.0,14,15,27,7,42,3,4,13,1,63,63,0
14949,139331,jIQxdn4syEISmeL05XWgww3FZktzs7MC,SpATywNh6bZuzm8s1ceuBUnMUAeoAHHw,61,86,52,73,20,9,32,0,272,38.857142857142854,9,0.0,19,52,68,20,67,9,5,32,0,159,113,0
14950,139332,IAgEmatHzKUXARhFStPcCuJqOEJArzMq,SpATywNh6bZuzm8s1ceuBUnMUAeoAHHw,31,49,26,20,13,12,9,0,129,18.428571428571427,3,0.0,15,26,18,13,34,12,2,9,0,72,57,0
14951,139336,6rH08L3lN0NWDbzJa4w6QS7ZCcNaTo1u,SpATywNh6bZuzm8s1ceuBUnMUAeoAHHw,42,52,24,44,13,0,3,0,136,19.428571428571427,3,0.0,24,24,38,13,28,0,6,3,0,99,37,0
14952,139340,DqEghpE9KPv2P7lR2sFssI7iqD8k80gK,5X6FeZozNMgE2VRi3MJYjkkFK8SETtu2,1,0,0,0,0,0,1,0,1,0.14285714285714285,1,0.0,0,0,0,0,0,0,0,1,0,0,1,1
14953,139342,iO8wfk9CJpGr60f1tg17Yoor3BIrLyLv,bWdj2GDclj5ofokWjzoa5jAwMkxCykd6,2,0,0,0,0,0,4,0,4,0.5714285714285714,2,0.0,0,0,0,0,0,0,0,4,0,0,4,1
14954,139344,h4B8ffuSXL9NZaxc0msh2EYaxC0hStsr,7GRhBDsirIGkRZBtSMEzNTyDr2JQm4xx,5,2,0,0,0,0,3,1,6,0.8571428571428571,1,0.0,0,0,0,0,2,0,0,3,1,0,6,1
14955,139348,A72Fa3XS93rMwEK1aHoBEvc3t9L2XsxB,SpATywNh6bZuzm8s1ceuBUnMUAeoAHHw,2,0,0,0,0,0,3,0,3,0.42857142857142855,1,0.0,0,0,0,0,0,0,0,3,0,0,3,1
14956,139356,mLuDEu9s65x5hAW4ThAGLYVNud4kQVNC,RXDvfPUBYFlVdlueBFbLW0mhhAyGEqpt,18,31,17,21,11,0,4,0,84,12.0,1,0.0,7,17,19,11,24,0,2,4,0,54,30,0
14957,139358,Zi07wsUlv6JaA1UnVePCC5W9D6L8zwtC,G8EPVSXsOYB5YQWZGiz1aVq5Pgr2GrQu,1,0,0,0,0,0,1,0,1,0.14285714285714285,1,0.0,0,0,0,0,0,0,0,1,0,0,1,1
14958,139365,zidBG8DYrB5FUPcHiIjJwJg81Cz0xkbI,RXDvfPUBYFlVdlueBFbLW0mhhAyGEqpt,5,4,0,0,0,0,3,1,8,1.1428571428571428,1,0.0,0,0,0,0,4,0,0,3,1,0,8,0
14959,139369,aXYyJMDvVYwwKBbiO4CB25XlnDBfWYNg,A3fsA9Zfv1X2fVEQhTw51lKENdNrEqT3,8,7,4,0,1,10,4,0,26,3.7142857142857144,2,0.0,1,4,0,1,6,10,0,4,0,6,20,1
14960,139371,LHMz4Z1aIT7X203UBFQJGAdpl2c2Pnqz,SpATywNh6bZuzm8s1ceuBUnMUAeoAHHw,3,2,0,0,0,0,2,0,4,0.5714285714285714,1,0.0,0,0,0,0,2,0,0,2,0,0,4,0
14961,139376,wx3mAGKFM6cge9w8piWfsYKppmWVhkYO,7GRhBDsirIGkRZBtSMEzNTyDr2JQm4xx,5,10,2,0,2,0,1,0,15,2.142857142857143,1,0.0,0,2,0,2,10,0,0,1,0,4,11,1
14962,139379,xM4BoPjpAZOnLWP1jIeLJ07UUf6rY0Bo,G8EPVSXsOYB5YQWZGiz1aVq5Pgr2GrQu,4,3,1,0,0,0,2,0,6,0.8571428571428571,2,0.0,0,1,0,0,3,0,0,2,0,1,5,1
14963,139380,LIoGzJO9iWdcU74H9UnplKXzxcDk8cHj,SpATywNh6bZuzm8s1ceuBUnMUAeoAHHw,16,19,3,12,2,0,3,0,39,5.571428571428571,3,0.0,4,3,10,2,15,0,2,3,0,19,20,0
14964,139395,zTl9sraD9wqiuzOUBuj4ORVo1KvzZJQZ,SpATywNh6bZuzm8s1ceuBUnMUAeoAHHw,7,5,1,0,1,1,4,0,12,1.7142857142857142,1,0.0,1,1,0,1,4,1,0,4,0,3,9,1
14965,139397,GJU8L7zpC13yJeUsnL1O83fEI4FTEcNw,SpATywNh6bZuzm8s1ceuBUnMUAeoAHHw,2,0,0,0,0,0,4,0,4,0.5714285714285714,2,0.0,0,0,0,0,0,0,0,4,0,0,4,0
14966,139404,fgEJIqkp4SMlTSJ7SAm1OLRW7sHHzj7J,RXDvfPUBYFlVdlueBFbLW0mhhAyGEqpt,30,35,21,48,10,0,6,1,121,17.285714285714285,3,0.0,7,21,48,10,28,0,0,6,1,86,35,0
14967,139419,UnYWhkEUM28aufKl6iE422jz3645yuzl,RXDvfPUBYFlVdlueBFbLW0mhhAyGEqpt,41,47,5,58,3,0,14,6,133,19.0,2,0.0,7,5,56,3,40,0,2,14,6,71,62,0
14968,139428,abzlLtUVw5Pp8kU9DAXNl6SvnA5wbEox,7GRhBDsirIGkRZBtSMEzNTyDr2JQm4xx,1,0,0,0,0,0,2,0,2,0.2857142857142857,1,0.0,0,0,0,0,0,0,0,2,0,0,2,1
14969,139436,YOvd9uht0tZm889aIFQH8jd68xtH7inE,bWdj2GDclj5ofokWjzoa5jAwMkxCykd6,51,89,36,126,16,2,24,0,293,41.857142857142854,9,0.0,28,36,107,16,61,2,19,24,0,187,106,0
14970,139462,uyV5v8i6DnVDO3WtU4s2nn4PGzjM1DJi,RXDvfPUBYFlVdlueBFbLW0mhhAyGEqpt,1,0,0,0,0,0,1,0,1,0.14285714285714285,1,0.0,0,0,0,0,0,0,0,1,0,0,1,1
14971,139465,zbo9FGjTmUUlBLDkbpFTLQYtMVFawINZ,7GRhBDsirIGkRZBtSMEzNTyDr2JQm4xx,1,0,0,0,0,0,2,0,2,0.2857142857142857,1,0.0,0,0,0,0,0,0,0,2,0,0,2,1
14972,139467,d40G6C9cb6Xi6RVyNy2Bmtx1OxVs6H6W,bWdj2GDclj5ofokWjzoa5jAwMkxCykd6,2,0,0,0,0,0,2,0,2,0.2857142857142857,1,0.0,0,0,0,0,0,0,0,2,0,0,2,1
14973,139506,n7YwcJxwfuUXRRrR0Y0hk0nqog6FrsWi,SpATywNh6bZuzm8s1ceuBUnMUAeoAHHw,2,0,0,0,0,0,2,0,2,0.2857142857142857,1,0.0,0,0,0,0,0,0,0,2,0,0,2,1
14974,139509,CX2agbMAxnGpDXHjpSp2SGL5oAXroQo8,bWdj2GDclj5ofokWjzoa5jAwMkxCykd6,6,5,2,0,1,0,7,0,15,2.142857142857143,1,0.0,1,2,0,1,4,0,0,7,0,4,11,1
14975,139517,4CoGSxhhHWTO7EDjl5nO5mW4CLM3ADy3,G8EPVSXsOYB5YQWZGiz1aVq5Pgr2GrQu,6,5,1,4,1,2,2,0,15,2.142857142857143,1,0.0,3,1,3,1,2,2,1,2,0,8,7,1
14976,139530,CtxTw5QfyzMFgeuUDk7xEyh7qXDCcYsK,SpATywNh6bZuzm8s1ceuBUnMUAeoAHHw,36,21,18,0,16,0,6,0,61,8.714285714285714,3,0.0,0,18,0,16,21,0,0,6,0,34,27,0
14977,139535,S33lH053HmB7Cz0IWipiL27cwx1QXBWr,SpATywNh6bZuzm8s1ceuBUnMUAeoAHHw,23,45,3,15,1,0,16,0,80,11.428571428571429,4,0.0,4,3,13,1,41,0,2,16,0,21,59,0
14978,139542,Xv0DoRVy2WPaq7NGSTl3PflvzGmHzjVJ,5X6FeZozNMgE2VRi3MJYjkkFK8SETtu2,1,0,0,0,0,0,1,0,1,0.14285714285714285,1,0.0,0,0,0,0,0,0,0,1,0,0,1,1
14979,139544,G8fLPL9uAaHZvdz6ZdYfgDC2jOIdMG4b,7GRhBDsirIGkRZBtSMEzNTyDr2JQm4xx,1,0,0,0,0,0,1,0,1,0.14285714285714285,1,0.0,0,0,0,0,0,0,0,1,0,0,1,1
14980,139554,8iImyyS3GD4CMDnaLhe4nYGG4OYOw3ov,bWdj2GDclj5ofokWjzoa5jAwMkxCykd6,2,0,0,0,0,0,2,0,2,0.2857142857142857,1,0.0,0,0,0,0,0,0,0,2,0,0,2,1
14981,139558,G8fLPL9uAaHZvdz6ZdYfgDC2jOIdMG4b,SpATywNh6bZuzm8s1ceuBUnMUAeoAHHw,1,0,0,0,0,0,1,0,1,0.14285714285714285,1,0.0,0,0,0,0,0,0,0,1,0,0,1,1
14982,139580,cvmDTGaAfjrnwgN0V8fkhCZ7nO1t5O8G,G8EPVSXsOYB5YQWZGiz1aVq5Pgr2GrQu,6,6,1,0,2,0,2,0,11,1.5714285714285714,1,0.0,3,1,0,2,3,0,0,2,0,6,5,1
14983,139583,7DHotsyQCKbl4ztV48mHeF13yzgtZs4m,SpATywNh6bZuzm8s1ceuBUnMUAeoAHHw,1,0,0,0,0,0,1,0,1,0.14285714285714285,1,0.0,0,0,0,0,0,0,0,1,0,0,1,1
14984,139588,hWYN1KMRf8YD8e96RxZErJ2xkz7NvTte,A3fsA9Zfv1X2fVEQhTw51lKENdNrEqT3,7,0,0,0,0,1,12,1,14,2.0,1,0.0,0,0,0,0,0,1,0,12,1,0,14,1
14985,139596,7u3azzypzNqPYEFxf0DcbGOgDVhkOXos,7GRhBDsirIGkRZBtSMEzNTyDr2JQm4xx,32,37,8,42,8,4,9,0,108,15.428571428571429,2,0.0,21,8,37,8,16,4,5,9,0,74,34,1
14986,139598,bHMSPD6TpG4I9IyQFzHZ8oywImP9IiZd,7GRhBDsirIGkRZBtSMEzNTyDr2JQm4xx,1,0,0,0,0,0,1,0,1,0.14285714285714285,1,0.0,0,0,0,0,0,0,0,1,0,0,1,1
14987,139614,rrw2WJkAL0R5jcfwKMTsm56jlh9a5ial,G8EPVSXsOYB5YQWZGiz1aVq5Pgr2GrQu,5,3,2,0,2,0,2,0,9,1.2857142857142858,1,0.0,0,2,0,2,3,0,0,2,0,4,5,1
14988,139617,NHjxa47feJ9sWQnmg6HoO6L78eHIRwnl,5X6FeZozNMgE2VRi3MJYjkkFK8SETtu2,1,0,0,0,0,0,1,0,1,0.14285714285714285,1,0.0,0,0,0,0,0,0,0,1,0,0,1,0
14989,139651,lbuK5gzlmtjdJwaA3m8yvkycLwxfJOpy,SpATywNh6bZuzm8s1ceuBUnMUAeoAHHw,19,36,14,13,7,0,3,0,73,10.428571428571429,2,0.0,9,14,12,7,27,0,1,3,0,42,31,0
14990,139653,fpQ0ez3rb7sqHqcoB5Q6L9iCWdGA4aex,SpATywNh6bZuzm8s1ceuBUnMUAeoAHHw,1,0,0,0,0,0,1,0,1,0.14285714285714285,1,0.0,0,0,0,0,0,0,0,1,0,0,1,1
14991,139659,rrw2WJkAL0R5jcfwKMTsm56jlh9a5ial,A3fsA9Zfv1X2fVEQhTw51lKENdNrEqT3,7,11,2,0,1,0,10,0,24,3.4285714285714284,2,0.0,0,2,0,1,11,0,0,10,0,3,21,1
14992,139662,SY4uzYHWkMA1yShUbP5621gRVjO4W9UX,SpATywNh6bZuzm8s1ceuBUnMUAeoAHHw,12,6,5,0,4,0,2,0,17,2.4285714285714284,1,0.0,0,5,0,4,6,0,0,2,0,9,8,1
14993,139665,LUIzAJFVL2bM2iV5yPmJrJDybpB7HbwU,bWdj2GDclj5ofokWjzoa5jAwMkxCykd6,16,28,1,0,1,0,3,0,33,4.714285714285714,2,0.0,0,1,0,1,28,0,0,3,0,2,31,1
14994,139666,OiCP77rDGj7m0OeIgoy8NyAC1iklb2Wq,A3fsA9Zfv1X2fVEQhTw51lKENdNrEqT3,5,2,1,0,0,0,4,0,7,1.0,2,0.0,0,1,0,0,2,0,0,4,0,1,6,1
14995,139673,VVgqDLLa7j66k9tQU3M7wVOF4BEse4lo,A3fsA9Zfv1X2fVEQhTw51lKENdNrEqT3,1,0,0,0,0,0,1,0,1,0.14285714285714285,1,0.0,0,0,0,0,0,0,0,1,0,0,1,1
14996,139694,hShVfXi5CDkkf6vDlaLmVJ6jHLXUmY8S,SpATywNh6bZuzm8s1ceuBUnMUAeoAHHw,6,4,2,0,1,1,3,0,11,1.5714285714285714,1,0.0,0,2,0,1,4,1,0,3,0,3,8,1
14997,139702,bDbKEMrZzcFQTQT7Qrji0QYF25s6ADsY,5X6FeZozNMgE2VRi3MJYjkkFK8SETtu2,1,0,0,0,0,0,1,0,1,0.14285714285714285,1,0.0,0,0,0,0,0,0,0,1,0,0,1,1
14998,139703,MDn3CtIIZuEXDPhMfThc5BfvVlOiIwwt,7GRhBDsirIGkRZBtSMEzNTyDr2JQm4xx,9,7,1,0,0,1,9,1,19,2.7142857142857144,1,0.0,0,1,0,0,7,1,0,9,1,1,18,1
14999,139706,BGq4CkiKFU4S6hRTjQFWEyJE9fTf2RIS,7GRhBDsirIGkRZBtSMEzNTyDr2JQm4xx,2,0,0,0,0,0,2,0,2,0.2857142857142857,1,0.0,0,0,0,0,0,0,0,2,0,0,2,1
15000,139713,n51reZ5FTJkHLnQwBqURrmxGDzwEsEjy,7GRhBDsirIGkRZBtSMEzNTyDr2JQm4xx,4,2,1,0,1,0,1,0,5,0.7142857142857143,1,0.0,0,1,0,1,2,0,0,1,0,2,3,1
15001,139731,3Jrj6bKUtFj34BYovmjDUontE8TUY429,3VkHkmOtom3jM2wCu94xgzzu1d6Dn7or,1,0,0,0,0,0,1,0,1,0.14285714285714285,1,0.0,0,0,0,0,0,0,0,1,0,0,1,1
15002,139738,OnGeUrzcVBncOK9oiyCK2Q06jpa9wwtU,3VkHkmOtom3jM2wCu94xgzzu1d6Dn7or,1,0,0,0,0,0,1,0,1,0.14285714285714285,1,0.0,0,0,0,0,0,0,0,1,0,0,1,1
15003,139755,4mVyAHk6nJWY1aYACG2ghxNyXqOb7rRH,3VkHkmOtom3jM2wCu94xgzzu1d6Dn7or,1,0,0,0,0,0,1,0,1,0.14285714285714285,1,0.0,0,0,0,0,0,0,0,1,0,0,1,0
15004,139756,zVf2fbD3OAyHoecoptMpgRjWQvGBAzlW,3VkHkmOtom3jM2wCu94xgzzu1d6Dn7or,21,144,55,33,0,62,27,8,329,47.0,4,0.0,35,55,32,0,109,62,1,27,8,122,207,1
15005,139763,2RSFVpVVzDPG0pENjLm6YEyKA12b0b4R,3VkHkmOtom3jM2wCu94xgzzu1d6Dn7or,1,0,0,0,0,0,1,0,1,0.14285714285714285,1,0.0,0,0,0,0,0,0,0,1,0,0,1,1
15006,139782,pGKgkIWDcbsahpf36tFo1CJT2p9hUlYG,3VkHkmOtom3jM2wCu94xgzzu1d6Dn7or,1,0,0,0,0,0,1,0,1,0.14285714285714285,1,0.0,0,0,0,0,0,0,0,1,0,0,1,1
15007,139790,LkcNwIfD9AQcECvPKNRo6NYZBfTeqSea,3VkHkmOtom3jM2wCu94xgzzu1d6Dn7or,20,16,14,0,14,0,37,2,83,11.857142857142858,2,0.0,0,14,0,14,16,0,0,37,2,28,55,1
15008,139791,3Zng3LF8UaCQUhGfuDnz21zu1Mkn8oec,3VkHkmOtom3jM2wCu94xgzzu1d6Dn7or,94,255,100,60,91,19,44,4,573,81.85714285714286,10,0.0,116,100,56,91,139,19,4,44,4,363,210,0
15009,139797,Ib5HAhdZpZuw7ejnKfyxEV3fBWn2phbN,3VkHkmOtom3jM2wCu94xgzzu1d6Dn7or,1,0,0,0,0,0,1,0,1,0.14285714285714285,1,0.0,0,0,0,0,0,0,0,1,0,0,1,1
15010,139809,ZKc55uDFhhCUdxKRVXUYkGlPolPbYDgo,3VkHkmOtom3jM2wCu94xgzzu1d6Dn7or,11,4,3,0,2,6,6,1,22,3.142857142857143,1,0.0,0,3,0,2,4,6,0,6,1,5,17,1
15011,139813,A1rAxc1wvorqZ7Wpim4MjIknl60MdvF1,3VkHkmOtom3jM2wCu94xgzzu1d6Dn7or,4,3,1,0,1,0,1,0,6,0.8571428571428571,1,0.0,1,1,0,1,2,0,0,1,0,3,3,1
15012,139814,eVxlZAXx1ABaY992tgMSrWXi4e9YKziP,3VkHkmOtom3jM2wCu94xgzzu1d6Dn7or,11,35,9,2,14,4,18,0,82,11.714285714285714,3,0.0,20,9,2,14,15,4,0,18,0,45,37,1
15013,139818,HpF0UZEery954r2Wy0wJFt4xXtp25FUM,3VkHkmOtom3jM2wCu94xgzzu1d6Dn7or,30,68,23,23,25,18,15,2,174,24.857142857142858,6,0.0,35,23,20,25,33,18,3,15,2,103,71,1
15014,139833,KA5h5czFk68VoEgzUY80WD480p5Rvsbz,3VkHkmOtom3jM2wCu94xgzzu1d6Dn7or,4,4,0,0,0,0,2,0,6,0.8571428571428571,1,0.0,2,0,0,0,2,0,0,2,0,2,4,1
15015,139843,JCuWcaGCu6lFvDIz9NbN1LQ2JL2iB31e,3VkHkmOtom3jM2wCu94xgzzu1d6Dn7or,6,7,2,0,0,0,4,0,13,1.8571428571428572,2,0.0,1,2,0,0,6,0,0,4,0,3,10,1
15016,139849,auNWijCxVrad57WqY6P30feFdigjhjzZ,3VkHkmOtom3jM2wCu94xgzzu1d6Dn7or,8,4,2,0,2,0,2,0,10,1.4285714285714286,1,0.0,0,2,0,2,4,0,0,2,0,4,6,1
15017,139854,axblY4rn2CPgjAwzBfbbXleDAK5uGDmQ,3VkHkmOtom3jM2wCu94xgzzu1d6Dn7or,8,6,4,0,4,0,3,0,17,2.4285714285714284,1,0.0,2,4,0,4,4,0,0,3,0,10,7,1
15018,139864,hB89Q2sgxzgPKiSqNP9qA0G3CtEv3RVA,3VkHkmOtom3jM2wCu94xgzzu1d6Dn7or,5,5,3,0,2,0,3,0,13,1.8571428571428572,1,0.0,0,3,0,2,5,0,0,3,0,5,8,1
15019,139865,LDZwy5zCY34V3PhuvUwq1WLCZ2XKFncb,3VkHkmOtom3jM2wCu94xgzzu1d6Dn7or,6,6,2,0,3,2,9,0,22,3.142857142857143,1,0.0,2,2,0,3,4,2,0,9,0,7,15,1
15020,139868,lsxgm2IBPEWgYIUtXADaUExIJ5QnoNKC,3VkHkmOtom3jM2wCu94xgzzu1d6Dn7or,8,12,7,0,0,0,1,0,20,2.857142857142857,1,0.0,0,7,0,0,12,0,0,1,0,7,13,1
15021,139870,cXGNVbaSGbcTRRdWFoRN70Rg4SniEolO,3VkHkmOtom3jM2wCu94xgzzu1d6Dn7or,17,43,17,7,11,12,15,0,105,15.0,3,0.0,17,17,6,11,26,12,1,15,0,51,54,1
15022,139882,mUrv5nyEATwaFjJtzCivF2vi0xW8oHdn,3VkHkmOtom3jM2wCu94xgzzu1d6Dn7or,23,35,16,23,15,2,2,0,93,13.285714285714286,3,0.0,14,16,17,15,21,2,6,2,0,62,31,1
15023,139890,6PusrGKQHsCpCjXEorRwIAKdI3yZerO7,3VkHkmOtom3jM2wCu94xgzzu1d6Dn7or,1,0,0,0,0,0,1,0,1,0.14285714285714285,1,0.0,0,0,0,0,0,0,0,1,0,0,1,1
15024,139893,DEBk8bTqc8UvXWoysh3hshBMHr9yuJPk,3VkHkmOtom3jM2wCu94xgzzu1d6Dn7or,68,191,85,43,60,30,27,3,439,62.714285714285715,14,0.0,72,85,42,60,119,30,1,27,3,259,180,0
15025,139907,XYr54DnYnYf3KEqTg2BYiHKXF3QdVRtB,3VkHkmOtom3jM2wCu94xgzzu1d6Dn7or,9,4,3,0,3,0,2,0,12,1.7142857142857142,1,0.0,0,3,0,3,4,0,0,2,0,6,6,1
15026,139910,H6aVkKkXOQXduiOaAvGFvpQo6aKIezV3,3VkHkmOtom3jM2wCu94xgzzu1d6Dn7or,80,164,60,61,50,31,31,4,401,57.285714285714285,9,0.0,56,60,57,50,108,31,4,31,4,223,178,0
15027,139921,zrKRk265OLBkV6Oc81RVajvBqlX0lvOG,3VkHkmOtom3jM2wCu94xgzzu1d6Dn7or,1,0,0,0,0,0,1,0,1,0.14285714285714285,1,0.0,0,0,0,0,0,0,0,1,0,0,1,1
15028,139951,ppBsN7y5vmDt7R3QrUF73vfYphAgu58q,3VkHkmOtom3jM2wCu94xgzzu1d6Dn7or,1,0,0,0,0,0,1,0,1,0.14285714285714285,1,0.0,0,0,0,0,0,0,0,1,0,0,1,1
15029,139959,C4KlGFER1YlHMtKQcExiXEE4aKaD0tn6,3VkHkmOtom3jM2wCu94xgzzu1d6Dn7or,2,0,0,0,0,0,2,0,2,0.2857142857142857,1,0.0,0,0,0,0,0,0,0,2,0,0,2,1
15030,139990,rPjVddy7wXfZ2brJmjkgv7pdL7sJ7UCw,3VkHkmOtom3jM2wCu94xgzzu1d6Dn7or,20,69,39,0,12,0,15,2,137,19.571428571428573,7,0.0,0,39,0,12,69,0,0,15,2,51,86,0
15031,139991,0gibTItQAcu7GiaxYIHVLpnqkpIcuR30,3VkHkmOtom3jM2wCu94xgzzu1d6Dn7or,9,5,5,0,0,0,3,0,13,1.8571428571428572,1,0.0,0,5,0,0,5,0,0,3,0,5,8,1
15032,140001,MavjFefH4SOjoXYnsOcQcdhNCSL7FlvY,3VkHkmOtom3jM2wCu94xgzzu1d6Dn7or,1,0,0,0,0,0,4,0,4,0.5714285714285714,3,0.0,0,0,0,0,0,0,0,4,0,0,4,1
15033,140018,qCAmkptIYE0gl0mPzjDyJJItff4aq5fy,3VkHkmOtom3jM2wCu94xgzzu1d6Dn7or,8,8,3,0,2,1,6,1,21,3.0,1,0.0,1,3,0,2,7,1,0,6,1,6,15,1
15034,140052,bP4PnFhF8rWV4oUOVCJCEUN38pc56N1l,3VkHkmOtom3jM2wCu94xgzzu1d6Dn7or,4,0,0,0,0,4,3,3,10,1.4285714285714286,2,0.0,0,0,0,0,0,4,0,3,3,0,10,0
15035,140056,sBcxk0mGJlFkd4WvpVtecNmqZIBzoHn2,3VkHkmOtom3jM2wCu94xgzzu1d6Dn7or,1,0,0,0,0,0,3,0,3,0.42857142857142855,1,0.0,0,0,0,0,0,0,0,3,0,0,3,1
15036,140068,dRD1DS5DuggVygcG59W7832HdVYwtgOn,7GRhBDsirIGkRZBtSMEzNTyDr2JQm4xx,7,6,1,0,1,0,7,0,15,2.142857142857143,4,0.0,0,1,0,1,6,0,0,7,0,2,13,1
15037,140111,IEz09p8uVqrNsb9NFfclugzgkCqh5nUn,5X6FeZozNMgE2VRi3MJYjkkFK8SETtu2,55,48,9,94,22,0,2,0,175,25.0,1,0.0,36,9,79,22,12,0,15,2,0,146,29,1
15038,140123,P7X0JLDF7H4Sgmj4O7MpRz6ca0ndbc9Q,5X6FeZozNMgE2VRi3MJYjkkFK8SETtu2,1,0,0,0,0,0,1,0,1,0.14285714285714285,1,0.0,0,0,0,0,0,0,0,1,0,0,1,1
15039,140129,OEm3RfkF7zW7QGdEGDuqH9AvGYPU4cwb,7GRhBDsirIGkRZBtSMEzNTyDr2JQm4xx,1,0,0,0,0,0,1,0,1,0.14285714285714285,1,0.0,0,0,0,0,0,0,0,1,0,0,1,1
15040,140136,SzHyVEPONSslDMujP3r42FOEaBM1wLth,7GRhBDsirIGkRZBtSMEzNTyDr2JQm4xx,11,9,2,0,1,0,9,2,23,3.2857142857142856,2,0.0,0,2,0,1,9,0,0,9,2,3,20,1
15041,140141,EAibjZcnMEl7Giq03ulFFl7NUllRXm8X,7GRhBDsirIGkRZBtSMEzNTyDr2JQm4xx,1,0,0,0,0,0,2,0,2,0.2857142857142857,2,0.0,0,0,0,0,0,0,0,2,0,0,2,1
15042,140151,KFG6G55toGAeaWBt5UmyioW5n1NVxSjT,7GRhBDsirIGkRZBtSMEzNTyDr2JQm4xx,1,0,0,0,0,0,1,0,1,0.14285714285714285,1,0.0,0,0,0,0,0,0,0,1,0,0,1,1
15043,140155,B0ju9Oei4oSfT1FPNsvUdPiFSJAhjLX7,7GRhBDsirIGkRZBtSMEzNTyDr2JQm4xx,4,2,1,0,0,0,3,0,6,0.8571428571428571,2,0.0,0,1,0,0,2,0,0,3,0,1,5,1
15044,140161,QP61WzTD88M7Z43YJUY0WRxs9mL5DaLN,7GRhBDsirIGkRZBtSMEzNTyDr2JQm4xx,8,1,0,0,0,1,12,0,14,2.0,2,0.0,0,0,0,0,1,1,0,12,0,0,14,1
15045,140165,4NbBJgtOnvI4dKJO6U04PsO19ilNdxDa,7GRhBDsirIGkRZBtSMEzNTyDr2JQm4xx,8,2,1,0,1,1,6,2,13,1.8571428571428572,1,0.0,0,1,0,1,2,1,0,6,2,2,11,1
15046,140213,usnj2XaWdnmusZczBB9Vbk759oOFMaOM,5X6FeZozNMgE2VRi3MJYjkkFK8SETtu2,2,10,0,0,0,0,10,0,20,2.857142857142857,4,0.0,0,0,0,0,10,0,0,10,0,0,20,1
15047,140231,FOCCuGaJ7zYTl7CCCo7T3PqrLtxGVeiU,5X6FeZozNMgE2VRi3MJYjkkFK8SETtu2,13,16,6,2,6,0,4,0,34,4.857142857142857,3,0.0,5,6,2,6,11,0,0,4,0,19,15,1
15048,140261,Q981NTq529R8G7YkogVE9XU6kPHMJTKu,5X6FeZozNMgE2VRi3MJYjkkFK8SETtu2,1,0,0,0,0,0,1,0,1,0.14285714285714285,1,0.0,0,0,0,0,0,0,0,1,0,0,1,1
15049,140264,QhJu71wKas1S5H0wZxCSNuscbyYbzhPp,5X6FeZozNMgE2VRi3MJYjkkFK8SETtu2,12,10,1,0,5,0,5,1,22,3.142857142857143,1,0.0,5,1,0,5,5,0,0,5,1,11,11,1
15050,140282,xcD6YWhnGA2xukGmX4eaYrm6VS9ffz1H,7GRhBDsirIGkRZBtSMEzNTyDr2JQm4xx,65,218,8,106,25,18,35,5,415,59.285714285714285,6,0.0,105,8,90,25,113,18,16,35,5,228,187,0
15051,140284,j6kcxmKxOQajIGRYDGpkTlGlZyghzMDl,5X6FeZozNMgE2VRi3MJYjkkFK8SETtu2,19,28,11,0,8,3,8,1,59,8.428571428571429,1,0.0,14,11,0,8,14,3,0,8,1,33,26,1
15052,140286,lmTzsZ1dVt4Xl8uCpslvBuFKl656ogFZ,5X6FeZozNMgE2VRi3MJYjkkFK8SETtu2,4,3,1,0,0,0,3,0,7,1.0,1,0.0,0,1,0,0,3,0,0,3,0,1,6,1
15053,140296,v0bjy2OSIQbTrvwUcnNYuv9Kj8xgAI1w,5X6FeZozNMgE2VRi3MJYjkkFK8SETtu2,4,2,0,0,0,0,4,0,6,0.8571428571428571,1,0.0,0,0,0,0,2,0,0,4,0,0,6,0
15054,140306,Ob79Za99PdIwrqcyAnuLEFhl9GSQ6Xz6,7GRhBDsirIGkRZBtSMEzNTyDr2JQm4xx,1,0,0,0,0,0,1,0,1,0.14285714285714285,1,0.0,0,0,0,0,0,0,0,1,0,0,1,1
15055,140323,su8pPW4fByR0aUGBHBqcvvXPYCeAukSy,5X6FeZozNMgE2VRi3MJYjkkFK8SETtu2,25,48,12,12,13,5,8,0,98,14.0,3,0.0,24,12,12,13,24,5,0,8,0,61,37,0
15056,140329,H3cyUU6nxPSmVjGMKYWWKOtYQjRDHxeD,7GRhBDsirIGkRZBtSMEzNTyDr2JQm4xx,1,0,0,0,0,0,1,0,1,0.14285714285714285,1,0.0,0,0,0,0,0,0,0,1,0,0,1,1
15057,140331,EkpYyl5FvOIbAuPgHjdTptqbWAlVTTOe,5X6FeZozNMgE2VRi3MJYjkkFK8SETtu2,3,3,0,0,0,0,1,0,4,0.5714285714285714,1,0.0,0,0,0,0,3,0,0,1,0,0,4,1
15058,140341,IUMl6TF9SZyzdSkTs0p0M3q4lvkSdDmi,7GRhBDsirIGkRZBtSMEzNTyDr2JQm4xx,13,15,5,0,6,4,19,4,53,7.571428571428571,1,0.0,8,5,0,6,7,4,0,19,4,19,34,1
15059,140358,XawXAsPAfBtlXBQzpKPcgk3ZhHAMJWNJ,7GRhBDsirIGkRZBtSMEzNTyDr2JQm4xx,81,118,28,132,24,1,38,0,341,48.714285714285715,6,0.0,55,28,111,24,63,1,21,38,0,218,123,1
15060,140364,RlksremLnZnegphNH2LaChOFTKkvCYuy,3VkHkmOtom3jM2wCu94xgzzu1d6Dn7or,1,0,0,0,0,0,1,0,1,0.14285714285714285,1,0.0,0,0,0,0,0,0,0,1,0,0,1,1
15061,140365,NB98JVtAv4s5E59EqEW6wDqm2WK5JUUN,3VkHkmOtom3jM2wCu94xgzzu1d6Dn7or,1,0,0,0,0,0,1,0,1,0.14285714285714285,1,0.0,0,0,0,0,0,0,0,1,0,0,1,1
15062,140370,ENIZ2L4MS1QlXu0BPdR9HqNOcSsZY7Ja,3VkHkmOtom3jM2wCu94xgzzu1d6Dn7or,1,0,0,0,0,0,1,0,1,0.14285714285714285,1,0.0,0,0,0,0,0,0,0,1,0,0,1,1
15063,140373,72XvwjxD8EvhX6fS9PSKcDV5sn1GxGDW,3VkHkmOtom3jM2wCu94xgzzu1d6Dn7or,1,0,0,0,0,0,1,0,1,0.14285714285714285,1,0.0,0,0,0,0,0,0,0,1,0,0,1,1
15064,140375,3DDW3Kgkt9lXJYvqDRuWGsfnRB8OjtGj,3VkHkmOtom3jM2wCu94xgzzu1d6Dn7or,9,5,4,0,3,2,9,1,24,3.4285714285714284,1,0.0,0,4,0,3,5,2,0,9,1,7,17,1
15065,140379,ZLYQsgr2iqvuCHs4JabG76V0rA5NRHN8,3VkHkmOtom3jM2wCu94xgzzu1d6Dn7or,14,17,9,0,9,1,3,0,39,5.571428571428571,1,0.0,0,9,0,9,17,1,0,3,0,18,21,1
15066,140381,9i8xsrw5nELlhgK7M2SPkQhTBKk2LB57,3VkHkmOtom3jM2wCu94xgzzu1d6Dn7or,26,33,13,19,10,14,3,0,92,13.142857142857142,3,0.0,13,13,17,10,20,14,2,3,0,53,39,1
15067,140387,SVwfCRY50hd9Fz0klab9XqT7QROcyhqY,3VkHkmOtom3jM2wCu94xgzzu1d6Dn7or,7,3,2,0,2,0,3,0,10,1.4285714285714286,1,0.0,0,2,0,2,3,0,0,3,0,4,6,1
15068,140390,izk8FGIuiNvH8lGG6nSF42zAQ72sY0Rq,3VkHkmOtom3jM2wCu94xgzzu1d6Dn7or,7,2,1,0,1,0,4,0,8,1.1428571428571428,1,0.0,0,1,0,1,2,0,0,4,0,2,6,1
15069,140393,slPSzcmuyMkhnrFZA6no3eGjyYYXnPVu,3VkHkmOtom3jM2wCu94xgzzu1d6Dn7or,4,3,1,0,1,4,2,0,11,1.5714285714285714,1,0.0,1,1,0,1,2,4,0,2,0,3,8,1
15070,140396,imxsKASoFyEFfbdentz1PAdwXF5L7k4s,3VkHkmOtom3jM2wCu94xgzzu1d6Dn7or,8,16,8,0,0,1,7,0,32,4.571428571428571,1,0.0,6,8,0,0,10,1,0,7,0,14,18,1
15071,140399,y7S6xhVXmXM0sU8Ve84oSvHKoWoG3N0e,3VkHkmOtom3jM2wCu94xgzzu1d6Dn7or,1,0,0,0,0,0,1,0,1,0.14285714285714285,1,0.0,0,0,0,0,0,0,0,1,0,0,1,1
15072,140405,jROOT2Cdh6avmNzUsyyyqrcbrDgJvWnY,3VkHkmOtom3jM2wCu94xgzzu1d6Dn7or,2,0,0,0,0,0,3,0,3,0.42857142857142855,2,0.0,0,0,0,0,0,0,0,3,0,0,3,1
15073,140408,D9LHDvhRktzandnhVnnKHDzcmS5ePgPp,3VkHkmOtom3jM2wCu94xgzzu1d6Dn7or,3,0,0,0,0,0,5,0,5,0.7142857142857143,1,0.0,0,0,0,0,0,0,0,5,0,0,5,1
15074,140409,iENi6w0QSJgqltqaCJ1A9qJOl3YUFZjB,3VkHkmOtom3jM2wCu94xgzzu1d6Dn7or,7,4,1,2,2,1,5,0,15,2.142857142857143,1,0.0,3,1,2,2,1,1,0,5,0,8,7,1
15075,140410,LxRDCP5Eq1P5wgmm87iPryUauJcZKIXs,3VkHkmOtom3jM2wCu94xgzzu1d6Dn7or,6,6,4,0,3,0,4,0,17,2.4285714285714284,1,0.0,0,4,0,3,6,0,0,4,0,7,10,1
15076,140413,VReX5u1i4gBRRFZaND4cgaHsptX1uAo2,3VkHkmOtom3jM2wCu94xgzzu1d6Dn7or,1,0,0,0,0,0,1,0,1,0.14285714285714285,1,0.0,0,0,0,0,0,0,0,1,0,0,1,1
15077,140415,cAt3kAq8A4nBNACWncm3aidYAQ1d8bbM,3VkHkmOtom3jM2wCu94xgzzu1d6Dn7or,4,1,1,0,0,0,3,0,5,0.7142857142857143,2,0.0,0,1,0,0,1,0,0,3,0,1,4,1
15078,140417,tX42cnMKf7McktYgW8VipQijsaArmDfp,3VkHkmOtom3jM2wCu94xgzzu1d6Dn7or,2,0,0,0,0,0,3,0,3,0.42857142857142855,1,0.0,0,0,0,0,0,0,0,3,0,0,3,1
15079,140418,gF5GHRga1xoLyKseUD8WhYIkTsxq7Q4v,3VkHkmOtom3jM2wCu94xgzzu1d6Dn7or,4,3,1,0,1,0,1,0,6,0.8571428571428571,1,0.0,1,1,0,1,2,0,0,1,0,3,3,1
15080,140420,0TbyUQxto8KKblNBjDQHPvdRtd1afpbW,3VkHkmOtom3jM2wCu94xgzzu1d6Dn7or,62,99,49,33,34,0,52,2,269,38.42857142857143,7,0.0,34,49,28,34,65,0,5,52,2,145,124,1
15081,140421,XkTNIh3vMVj2jAbMrbN7RZ4Jdx93xaiN,3VkHkmOtom3jM2wCu94xgzzu1d6Dn7or,5,3,0,0,0,0,5,1,9,1.2857142857142858,1,0.0,0,0,0,0,3,0,0,5,1,0,9,1
15082,140422,ayYwkVVyQzBhEdDijb7wioBgii6fAdFU,3VkHkmOtom3jM2wCu94xgzzu1d6Dn7or,28,67,33,13,22,22,14,0,171,24.428571428571427,2,0.0,29,33,12,22,38,22,1,14,0,96,75,0
15083,140427,umFRjjRou5lxb9SCAQ56IcPskPM6alkQ,3VkHkmOtom3jM2wCu94xgzzu1d6Dn7or,1,0,0,0,0,0,2,0,2,0.2857142857142857,2,0.0,0,0,0,0,0,0,0,2,0,0,2,0
15084,140428,HwprieYTjztd5VfZmCNFVBpTmvUmX5k0,3VkHkmOtom3jM2wCu94xgzzu1d6Dn7or,1,0,0,0,0,0,1,0,1,0.14285714285714285,1,0.0,0,0,0,0,0,0,0,1,0,0,1,1
15085,140430,ZkLDwb0oDs9fI898QcbMSCUPXt3MKl6y,3VkHkmOtom3jM2wCu94xgzzu1d6Dn7or,2,0,0,0,0,0,2,0,2,0.2857142857142857,1,0.0,0,0,0,0,0,0,0,2,0,0,2,1
15086,140432,cDw5Bih4aop3TeganFm5TP9bhOPGFGLY,3VkHkmOtom3jM2wCu94xgzzu1d6Dn7or,1,0,0,0,0,0,1,0,1,0.14285714285714285,1,0.0,0,0,0,0,0,0,0,1,0,0,1,1
15087,140435,xoyGA896PloO5EamnN9cHqF5GWwqzweS,3VkHkmOtom3jM2wCu94xgzzu1d6Dn7or,16,60,15,18,8,18,11,1,131,18.714285714285715,3,0.0,24,15,15,8,36,18,3,11,1,62,69,1
15088,140436,SM6cK5Cg2fEwre0wlT2sdrjGVJ8kdb3v,3VkHkmOtom3jM2wCu94xgzzu1d6Dn7or,9,7,3,0,0,0,13,2,25,3.5714285714285716,1,0.0,0,3,0,0,7,0,0,13,2,3,22,1
15089,140448,XnMRErhNsyt8ltc2CUas03WmPc2QKewJ,3VkHkmOtom3jM2wCu94xgzzu1d6Dn7or,6,2,0,0,0,1,11,1,15,2.142857142857143,1,0.0,0,0,0,0,2,1,0,11,1,0,15,1
15090,140449,p3DAVhqt31EYG8DAAYyA1pGMEdryuq5o,3VkHkmOtom3jM2wCu94xgzzu1d6Dn7or,8,2,1,0,1,3,7,1,15,2.142857142857143,1,0.0,0,1,0,1,2,3,0,7,1,2,13,1
15091,140459,IHvMg7Tadd9sFYx7mselBuYbwseapx3S,3VkHkmOtom3jM2wCu94xgzzu1d6Dn7or,1,0,0,0,0,0,1,0,1,0.14285714285714285,1,0.0,0,0,0,0,0,0,0,1,0,0,1,1
15092,140462,UY47Qvvj5GzzK75Hy3vx6CLdDrrD8mYX,3VkHkmOtom3jM2wCu94xgzzu1d6Dn7or,1,0,0,0,0,0,1,0,1,0.14285714285714285,1,0.0,0,0,0,0,0,0,0,1,0,0,1,1
15093,140465,yrVhoyF1ElfgK9I88jo92akJfvXA5L1B,3VkHkmOtom3jM2wCu94xgzzu1d6Dn7or,6,2,1,0,1,0,4,2,10,1.4285714285714286,1,0.0,0,1,0,1,2,0,0,4,2,2,8,1
15094,140517,Kwa203KDglCHHPWD00CQDRByzdexFKi1,7GRhBDsirIGkRZBtSMEzNTyDr2JQm4xx,1,0,0,0,0,0,1,0,1,0.14285714285714285,1,0.0,0,0,0,0,0,0,0,1,0,0,1,1
15095,140544,kdV5KOjKsWVFrLFSEW8Gh60grROKpU4O,7GRhBDsirIGkRZBtSMEzNTyDr2JQm4xx,1,0,0,0,0,0,1,0,1,0.14285714285714285,1,0.0,0,0,0,0,0,0,0,1,0,0,1,1
15096,140546,d5sj03eapUjVHG148jWqtnH3hcfDnVNW,7GRhBDsirIGkRZBtSMEzNTyDr2JQm4xx,1,0,0,0,0,0,1,0,1,0.14285714285714285,1,0.0,0,0,0,0,0,0,0,1,0,0,1,0
15097,140569,qLy5db5coyBML38ejBnFxz6JIzL7tCZq,7GRhBDsirIGkRZBtSMEzNTyDr2JQm4xx,4,0,0,0,0,0,4,0,4,0.5714285714285714,1,0.0,0,0,0,0,0,0,0,4,0,0,4,1
15098,140573,HdEsiFKzBi0FBJgauJnK9KKUc3iGfMCp,7GRhBDsirIGkRZBtSMEzNTyDr2JQm4xx,1,0,0,0,0,0,1,0,1,0.14285714285714285,1,0.0,0,0,0,0,0,0,0,1,0,0,1,1
15099,140592,fIUtty8H8VUNQ4tIszobjBNqpEeTsLt0,7GRhBDsirIGkRZBtSMEzNTyDr2JQm4xx,5,2,1,0,1,0,2,0,6,0.8571428571428571,1,0.0,0,1,0,1,2,0,0,2,0,2,4,0
15100,140604,GyWTABuPpZEqO585EnNTIpM2B2faPYN3,7GRhBDsirIGkRZBtSMEzNTyDr2JQm4xx,5,3,1,0,1,1,1,0,7,1.0,1,0.0,0,1,0,1,3,1,0,1,0,2,5,1
15101,140617,jxqH1Y0Ll1dSqJHW2X4uLUdvrbgDj0Cd,7GRhBDsirIGkRZBtSMEzNTyDr2JQm4xx,7,5,3,0,2,0,4,0,14,2.0,2,0.0,0,3,0,2,5,0,0,4,0,5,9,1
15102,140621,wy22AmUswVy7G8MnQOBBXFE3h9ovD8hW,7GRhBDsirIGkRZBtSMEzNTyDr2JQm4xx,1,0,0,0,0,0,1,0,1,0.14285714285714285,1,0.0,0,0,0,0,0,0,0,1,0,0,1,1
15103,140630,TYNUH36wQX48EZFChTHsXflAW5aqSPOs,7GRhBDsirIGkRZBtSMEzNTyDr2JQm4xx,3,0,0,0,0,3,3,0,6,0.8571428571428571,2,0.0,0,0,0,0,0,3,0,3,0,0,6,1
15104,140633,FM9F7roZRXjjLVpKJMa3bf9FDgpJfg8g,7GRhBDsirIGkRZBtSMEzNTyDr2JQm4xx,3,0,0,0,0,0,3,0,3,0.42857142857142855,1,0.0,0,0,0,0,0,0,0,3,0,0,3,1
15105,140636,2lTrV3r5iXOtPSrHMTWqISMwiAr82ziw,7GRhBDsirIGkRZBtSMEzNTyDr2JQm4xx,8,5,3,0,2,0,3,0,13,1.8571428571428572,2,0.0,0,3,0,2,5,0,0,3,0,5,8,1
15106,140638,yWz2TsI3P3NeaKv8ZdOPSvyfXMqCWYbY,7GRhBDsirIGkRZBtSMEzNTyDr2JQm4xx,3,2,1,0,0,0,1,0,4,0.5714285714285714,1,0.0,0,1,0,0,2,0,0,1,0,1,3,1
15107,140644,pphlOy25ER1zV5iLb44eAIBmMhXAx725,7GRhBDsirIGkRZBtSMEzNTyDr2JQm4xx,1,0,0,0,0,0,1,0,1,0.14285714285714285,1,0.0,0,0,0,0,0,0,0,1,0,0,1,1
15108,140659,nW3nuCeVT2zzpIYCkcsoDFQTZ20yLIbg,7GRhBDsirIGkRZBtSMEzNTyDr2JQm4xx,8,6,0,0,1,0,4,1,12,1.7142857142857142,1,0.0,2,0,0,1,4,0,0,4,1,3,9,1
15109,140660,w8Pvw8WQP7Chw590vs3wc2RvlZ6Vvee0,7GRhBDsirIGkRZBtSMEzNTyDr2JQm4xx,40,52,2,32,1,6,13,1,107,15.285714285714286,4,0.0,11,2,16,1,41,6,16,13,1,30,77,0
15110,140667,yq9vHLk2LjPpNFyoMkV6FPLMiEC0nSyT,7GRhBDsirIGkRZBtSMEzNTyDr2JQm4xx,26,25,14,4,8,5,10,1,67,9.571428571428571,2,0.0,7,14,3,8,18,5,1,10,1,32,35,1
15111,140676,TjxIzgKfqaY2A9zC1ctzzg8kJ4qt9ZS4,7GRhBDsirIGkRZBtSMEzNTyDr2JQm4xx,2,0,0,0,0,0,2,0,2,0.2857142857142857,1,0.0,0,0,0,0,0,0,0,2,0,0,2,1
15112,142574,O5yE35etOfpaMEJAOdIhiLm6o0DonEdv,5Gyp41oLVo7Gg7vF4vpmggWP5MU70QO6,9,30,9,0,0,1,7,0,47,6.714285714285714,1,0.0,8,9,0,0,22,1,0,7,0,17,30,1
15113,142576,rfWnSBHvE8yh3Tywx8mmVWeQrMCvchJc,5Gyp41oLVo7Gg7vF4vpmggWP5MU70QO6,15,24,14,15,9,0,6,0,68,9.714285714285714,2,0.0,7,14,10,9,17,0,5,6,0,40,28,1
15114,142578,PmtrviA6hBub1PH85YXqVyZgghNsuc4g,5Gyp41oLVo7Gg7vF4vpmggWP5MU70QO6,7,4,1,0,2,0,3,0,10,1.4285714285714286,2,0.0,1,1,0,2,3,0,0,3,0,4,6,1
15115,142582,uFAwXIcuVZUrzooQS3i05Ojiq5CkITl5,5Gyp41oLVo7Gg7vF4vpmggWP5MU70QO6,10,6,3,1,3,0,3,0,16,2.2857142857142856,1,0.0,2,3,1,3,4,0,0,3,0,9,7,0
15116,142586,j7bASIUMnf4CT11rRWorZg0FZhBTc03O,5Gyp41oLVo7Gg7vF4vpmggWP5MU70QO6,40,124,44,31,25,70,43,2,339,48.42857142857143,9,0.0,26,44,21,25,98,70,10,43,2,116,223,0
15117,142593,BaZtBX3UXp9aB7tEo3OUb5is15oBn3PP,5Gyp41oLVo7Gg7vF4vpmggWP5MU70QO6,18,24,8,26,5,1,9,1,74,10.571428571428571,1,0.0,14,8,18,5,10,1,8,9,1,45,29,1
15118,142595,H98Hl4y5LLB5tkiYORr7T1bKGvHA1hhn,5Gyp41oLVo7Gg7vF4vpmggWP5MU70QO6,8,17,8,0,0,0,7,0,32,4.571428571428571,3,0.0,0,8,0,0,17,0,0,7,0,8,24,1
15119,142597,64n92jE3wjhkzrUuaoAofS3KCIIoaMCe,5Gyp41oLVo7Gg7vF4vpmggWP5MU70QO6,15,12,8,0,5,1,7,1,34,4.857142857142857,2,0.0,0,8,0,5,12,1,0,7,1,13,21,1
15120,142598,flg6LuX2lo5kBneWTJPNzduxEddLhdQs,5Gyp41oLVo7Gg7vF4vpmggWP5MU70QO6,9,15,6,0,6,0,4,0,31,4.428571428571429,2,0.0,5,6,0,6,10,0,0,4,0,17,14,1
15121,142603,mXPxrsF57oO38yN9LzzHebHuhPQ79Etc,5Gyp41oLVo7Gg7vF4vpmggWP5MU70QO6,4,2,1,0,1,0,1,0,5,0.7142857142857143,1,0.0,0,1,0,1,2,0,0,1,0,2,3,1
15122,142608,2V1Q8xWPDqxMQ0PN3fgI9M2Bd7PiUfwc,5Gyp41oLVo7Gg7vF4vpmggWP5MU70QO6,31,134,30,25,14,31,37,0,271,38.714285714285715,10,0.0,44,30,15,14,90,31,10,37,0,103,168,1
15123,142620,GvoTsyIjaRWmnn2HYhInekPHBmhC8xW6,5Gyp41oLVo7Gg7vF4vpmggWP5MU70QO6,6,3,2,0,1,0,2,0,8,1.1428571428571428,1,0.0,0,2,0,1,3,0,0,2,0,3,5,1
15124,142626,t1rBPktICnweh1oj25VAsk0qY4bnF5gj,5Gyp41oLVo7Gg7vF4vpmggWP5MU70QO6,16,35,17,5,5,8,14,2,86,12.285714285714286,3,0.0,10,17,3,5,25,8,2,14,2,35,51,1
15125,142627,bzmxtcJxTZaQstaThaOLNe3q3vt8huBb,5Gyp41oLVo7Gg7vF4vpmggWP5MU70QO6,9,11,7,0,4,0,6,0,28,4.0,1,0.0,0,7,0,4,11,0,0,6,0,11,17,1
15126,142631,LGP5T3wCnpPmjUQtkBXMiMfa5aEzHypm,5Gyp41oLVo7Gg7vF4vpmggWP5MU70QO6,10,18,5,2,5,0,2,0,32,4.571428571428571,1,0.0,8,5,1,5,10,0,1,2,0,19,13,1
15127,142633,IcRcmfd0Ewe0HA0CWiqOBOh4Xg0NgKk2,5Gyp41oLVo7Gg7vF4vpmggWP5MU70QO6,7,4,0,0,0,1,11,1,17,2.4285714285714284,1,0.0,0,0,0,0,4,1,0,11,1,0,17,1
15128,142636,KHfJKluR4nAXY9ajkRhOmddDvD3PKXvN,5Gyp41oLVo7Gg7vF4vpmggWP5MU70QO6,12,15,10,0,4,0,5,0,34,4.857142857142857,2,0.0,2,10,0,4,13,0,0,5,0,16,18,1
15129,142638,YK93a5SKUh9rXdkIcxUKSHL7xQd5iQ0n,5Gyp41oLVo7Gg7vF4vpmggWP5MU70QO6,4,3,0,0,0,0,1,0,4,0.5714285714285714,1,0.0,0,0,0,0,3,0,0,1,0,0,4,1
15130,142640,k6VE25IacC5A5bOtFadAjL3Xm1pymwJc,5Gyp41oLVo7Gg7vF4vpmggWP5MU70QO6,11,35,4,0,0,27,17,5,88,12.571428571428571,1,0.0,4,4,0,0,31,27,0,17,5,8,80,1
15131,142641,ppvrg0GpVdMJ9ddQ6kjPpUNwltJ5sR5M,5Gyp41oLVo7Gg7vF4vpmggWP5MU70QO6,4,2,1,0,1,0,1,0,5,0.7142857142857143,1,0.0,0,1,0,1,2,0,0,1,0,2,3,1
15132,142644,fB3DyOy7bKYSKuxXRQXJzFHF37cWFGQ5,5Gyp41oLVo7Gg7vF4vpmggWP5MU70QO6,6,1,1,0,1,0,6,0,9,1.2857142857142858,1,0.0,0,1,0,1,1,0,0,6,0,2,7,1
15133,142646,sfqvF95To7i1ThhKyLc0mACXepDNEYL4,5Gyp41oLVo7Gg7vF4vpmggWP5MU70QO6,7,6,3,0,2,0,3,0,14,2.0,1,0.0,0,3,0,2,6,0,0,3,0,5,9,1
15134,142647,nYs1sbg1xDvHBSjwMJsmfzLojMFX3FXF,5Gyp41oLVo7Gg7vF4vpmggWP5MU70QO6,7,5,2,0,2,1,5,1,16,2.2857142857142856,1,0.0,1,2,0,2,4,1,0,5,1,5,11,1
15135,142649,dmS1uSIt3rluUyxfvsaENZe28gYYDvht,5Gyp41oLVo7Gg7vF4vpmggWP5MU70QO6,4,3,1,0,1,0,2,0,7,1.0,1,0.0,0,1,0,1,3,0,0,2,0,2,5,1
15136,142651,dpHLF21uvMbokNNTJHdbSyHoiwNjC5Qc,5Gyp41oLVo7Gg7vF4vpmggWP5MU70QO6,8,6,4,0,3,0,3,0,16,2.2857142857142856,1,0.0,0,4,0,3,6,0,0,3,0,7,9,1
15137,142653,0LwDHFmAVNrLRObswUadijdXXF0SPVCN,5Gyp41oLVo7Gg7vF4vpmggWP5MU70QO6,1,0,0,0,0,0,2,0,2,0.2857142857142857,1,0.0,0,0,0,0,0,0,0,2,0,0,2,1
15138,142657,Qe9YJgJ8XzQGeKrwp0Jj4cvm7JZeGtag,5Gyp41oLVo7Gg7vF4vpmggWP5MU70QO6,26,29,16,40,6,5,9,0,105,15.0,3,0.0,5,16,31,6,24,5,9,9,0,58,47,1
15139,142659,8pUP3PC2D5o62fUt3uU0gxVoyZnQmoiT,5Gyp41oLVo7Gg7vF4vpmggWP5MU70QO6,10,5,4,0,4,0,1,0,14,2.0,1,0.0,0,4,0,4,5,0,0,1,0,8,6,1
15140,142660,IEfUasRNK7F4OXmh9ZRgY5RLlk7j6VcY,5Gyp41oLVo7Gg7vF4vpmggWP5MU70QO6,7,6,4,0,3,0,2,0,15,2.142857142857143,2,0.0,0,4,0,3,6,0,0,2,0,7,8,0
15141,142662,Crk1vy7eBi1Xl2Uarp8ep82lR1YagTJM,5Gyp41oLVo7Gg7vF4vpmggWP5MU70QO6,12,42,9,3,0,1,8,0,63,9.0,1,0.0,7,9,2,0,35,1,1,8,0,18,45,1
15142,142664,L8p6pEudWnyObOwuFgS2uvmaDIutjOXt,5Gyp41oLVo7Gg7vF4vpmggWP5MU70QO6,5,3,2,0,2,0,2,0,9,1.2857142857142858,1,0.0,0,2,0,2,3,0,0,2,0,4,5,1
15143,142666,uZgEpWXy2F5yap0vusNOagcr5ERWbtuv,5Gyp41oLVo7Gg7vF4vpmggWP5MU70QO6,1,0,0,0,0,0,1,0,1,0.14285714285714285,1,0.0,0,0,0,0,0,0,0,1,0,0,1,1
15144,142668,NuHXRw8LsHOzEf8UzxgphWPT1nN9lpjp,5Gyp41oLVo7Gg7vF4vpmggWP5MU70QO6,10,5,4,0,4,0,1,0,14,2.0,1,0.0,0,4,0,4,5,0,0,1,0,8,6,1
15145,142669,gTPCI6huAUuiP7nPIsLqRx5IrfMPTn4w,5Gyp41oLVo7Gg7vF4vpmggWP5MU70QO6,10,5,3,0,2,5,5,3,23,3.2857142857142856,1,0.0,0,3,0,2,5,5,0,5,3,5,18,1
15146,142670,WIrTjpVCzz7XcODBSnhpv1IaMIHCXUkV,5Gyp41oLVo7Gg7vF4vpmggWP5MU70QO6,6,4,2,0,2,0,1,0,9,1.2857142857142858,1,0.0,1,2,0,2,3,0,0,1,0,5,4,1
15147,142677,c8WJAdYLV71mOx4ZXSglpCNd0dBUR3Om,5Gyp41oLVo7Gg7vF4vpmggWP5MU70QO6,4,2,1,0,1,0,1,0,5,0.7142857142857143,1,0.0,0,1,0,1,2,0,0,1,0,2,3,1
15148,142682,sCyMhRrGl3ADQMkJt03FjWLj6QvMIH5j,5Gyp41oLVo7Gg7vF4vpmggWP5MU70QO6,14,16,7,12,3,0,1,0,39,5.571428571428571,1,0.0,5,7,9,3,11,0,3,1,0,24,15,1
15149,142684,bkpX3X63wjQnlz6DxzQQEHE4mDg6F4fK,5Gyp41oLVo7Gg7vF4vpmggWP5MU70QO6,13,7,5,2,3,0,3,1,21,3.0,1,0.0,1,5,1,3,6,0,1,3,1,10,11,1
15150,142685,ALJrdfxhuEJKAJDKiZZsQHg5OqngoK94,5Gyp41oLVo7Gg7vF4vpmggWP5MU70QO6,6,4,1,0,1,0,2,0,8,1.1428571428571428,1,0.0,0,1,0,1,4,0,0,2,0,2,6,1
15151,142686,OqZf3fP0SX8loEXLDfHJedTy0cDaEAtU,5Gyp41oLVo7Gg7vF4vpmggWP5MU70QO6,9,3,2,0,2,2,4,1,14,2.0,1,0.0,0,2,0,2,3,2,0,4,1,4,10,1
15152,142691,CHZU2xxyCnP9nRERNMfZvqrPWpUYtrOe,5Gyp41oLVo7Gg7vF4vpmggWP5MU70QO6,8,13,5,0,5,0,4,0,27,3.857142857142857,2,0.0,2,5,0,5,11,0,0,4,0,12,15,1
15153,142694,zz36zJCSJsYqPJvDq6cIEQUfbW5SvzyM,5Gyp41oLVo7Gg7vF4vpmggWP5MU70QO6,9,3,2,0,2,0,5,1,13,1.8571428571428572,1,0.0,0,2,0,2,3,0,0,5,1,4,9,1
15154,142697,Ss0RSYchYhP0t3zTLYiGe5TYwAwk16bi,5Gyp41oLVo7Gg7vF4vpmggWP5MU70QO6,5,1,1,0,1,1,4,0,8,1.1428571428571428,1,0.0,0,1,0,1,1,1,0,4,0,2,6,1
15155,142699,XDPvGyFLLEYwbNEQik2MM4yiADs5rrYJ,5Gyp41oLVo7Gg7vF4vpmggWP5MU70QO6,17,40,16,20,14,0,8,0,98,14.0,4,0.0,16,16,13,14,24,0,7,8,0,59,39,1
15156,142700,jvPaH5IzRaoEL7vH3sZhzdSWAjz8Y84y,5Gyp41oLVo7Gg7vF4vpmggWP5MU70QO6,11,26,11,12,0,1,4,0,54,7.714285714285714,1,0.0,7,11,8,0,19,1,4,4,0,26,28,1
15157,142701,HhvQOu36AUwxS3HBXRWzCwV2HEANGBv6,5Gyp41oLVo7Gg7vF4vpmggWP5MU70QO6,22,19,8,50,0,0,7,0,84,12.0,2,0.0,11,8,39,0,8,0,11,7,0,58,26,1
15158,142702,xc941KV31IdfcQUaf6U9BbTDKPbt0s2i,5Gyp41oLVo7Gg7vF4vpmggWP5MU70QO6,5,4,2,0,1,0,1,0,8,1.1428571428571428,1,0.0,0,2,0,1,4,0,0,1,0,3,5,1
15159,142704,gpH2Monf32bCBbR9eOiusBymAeQmysVf,5Gyp41oLVo7Gg7vF4vpmggWP5MU70QO6,12,21,5,8,3,0,14,0,51,7.285714285714286,2,0.0,9,5,6,3,12,0,2,14,0,23,28,1
15160,142705,5wfiCJMdbkN7MkoUGvo3cfz8jV3jCktA,5Gyp41oLVo7Gg7vF4vpmggWP5MU70QO6,8,4,3,0,2,0,2,0,11,1.5714285714285714,1,0.0,0,3,0,2,4,0,0,2,0,5,6,1
15161,142707,uactsyQE35ggqrf8jGo8BD22JXCOvko5,5Gyp41oLVo7Gg7vF4vpmggWP5MU70QO6,9,16,6,10,4,0,2,0,38,5.428571428571429,1,0.0,5,6,7,4,11,0,3,2,0,22,16,0
15162,142709,QRq9SneqdOEdNrPCbzGfNOJsUrpMzzSX,5Gyp41oLVo7Gg7vF4vpmggWP5MU70QO6,10,10,3,0,1,2,5,0,21,3.0,1,0.0,0,3,0,1,10,2,0,5,0,4,17,1
15163,142710,dSuuhuijJZPTkTnHpEnWdbOsESCF7Ilu,5Gyp41oLVo7Gg7vF4vpmggWP5MU70QO6,6,4,2,0,1,0,1,0,8,1.1428571428571428,1,0.0,0,2,0,1,4,0,0,1,0,3,5,1
15164,142715,aTM8g4rbVmgmqSlbdFoile3z2S6Tt4FV,5Gyp41oLVo7Gg7vF4vpmggWP5MU70QO6,5,5,2,0,1,0,1,0,9,1.2857142857142858,1,0.0,2,2,0,1,3,0,0,1,0,5,4,1
15165,142717,Vq01Qe9ezKRBh4OctFgKtJTVZAI04MYh,5Gyp41oLVo7Gg7vF4vpmggWP5MU70QO6,20,18,9,8,5,6,17,0,63,9.0,3,0.0,7,9,6,5,11,6,2,17,0,27,36,1
15166,142718,S8UBDpVVq71qFIkAG8NIrDJCPw9bOJC9,5Gyp41oLVo7Gg7vF4vpmggWP5MU70QO6,30,33,18,8,12,2,9,1,83,11.857142857142858,5,0.0,8,18,6,12,25,2,2,9,1,44,39,0
15167,142721,MVweobqKO6VRipppxOBKuMyARMMpjzND,5Gyp41oLVo7Gg7vF4vpmggWP5MU70QO6,6,5,3,0,2,0,3,0,13,1.8571428571428572,1,0.0,0,3,0,2,5,0,0,3,0,5,8,1
15168,142724,Efy5POBnAHZiNqoN59CVRlkZH9Pz7rCY,5Gyp41oLVo7Gg7vF4vpmggWP5MU70QO6,10,6,3,3,2,1,4,0,19,2.7142857142857144,1,0.0,3,3,2,2,3,1,1,4,0,10,9,1
15169,142727,J92sYRLsoMdDD2Az5iaVe0NUZaKjSMyZ,5Gyp41oLVo7Gg7vF4vpmggWP5MU70QO6,6,3,2,0,2,0,3,0,10,1.4285714285714286,1,0.0,0,2,0,2,3,0,0,3,0,4,6,1
15170,142733,TcRKIMJqRfdjM97Y7fCXlsxmWnhndgv2,5Gyp41oLVo7Gg7vF4vpmggWP5MU70QO6,4,7,3,0,0,0,1,0,11,1.5714285714285714,1,0.0,2,3,0,0,5,0,0,1,0,5,6,1
15171,142734,PDl4enofGH9bhdY5M64G2uXNLw0R8XVT,5Gyp41oLVo7Gg7vF4vpmggWP5MU70QO6,19,20,9,12,6,8,5,1,61,8.714285714285714,2,0.0,8,9,8,6,12,8,4,5,1,31,30,1
15172,142735,MKo7OYMhbYLjj1dv71j15SfNzO14s5yL,5Gyp41oLVo7Gg7vF4vpmggWP5MU70QO6,9,9,4,0,2,2,14,2,33,4.714285714285714,3,0.0,0,4,0,2,9,2,0,14,2,6,27,1
15173,142738,GzdkdndaIrm7p0iy7XY8ZrMeUOKthJaf,5Gyp41oLVo7Gg7vF4vpmggWP5MU70QO6,5,2,1,0,1,0,2,0,6,0.8571428571428571,1,0.0,0,1,0,1,2,0,0,2,0,2,4,1
15174,142741,jFYWygr5nLqLhHkXltZRkT0S1zQoLEVR,5Gyp41oLVo7Gg7vF4vpmggWP5MU70QO6,10,15,7,0,4,0,8,0,34,4.857142857142857,1,0.0,4,7,0,4,11,0,0,8,0,15,19,1
15175,142744,8ywFLY0dric1Gqf9TeDpbNAAWX5EK1Et,5Gyp41oLVo7Gg7vF4vpmggWP5MU70QO6,27,45,19,24,4,0,13,1,106,15.142857142857142,4,0.0,20,19,17,4,25,0,7,13,1,60,46,1
15176,142747,1ecyEsbpVIEWGslkFzQmwDlIWRkggyyT,5Gyp41oLVo7Gg7vF4vpmggWP5MU70QO6,6,4,2,0,2,0,1,0,9,1.2857142857142858,1,0.0,0,2,0,2,4,0,0,1,0,4,5,1
15177,142749,AOLanxdaj25VHPpIoAr4JHOLnbRwmUeC,5Gyp41oLVo7Gg7vF4vpmggWP5MU70QO6,15,25,14,0,4,25,24,1,93,13.285714285714286,3,0.0,1,14,0,4,24,25,0,24,1,19,74,1
15178,142750,Os1M69LV2IV3cvo61TLi4oBx4zb5NgjR,5Gyp41oLVo7Gg7vF4vpmggWP5MU70QO6,6,4,3,0,3,0,1,0,11,1.5714285714285714,1,0.0,0,3,0,3,4,0,0,1,0,6,5,1
15179,142755,JijbcO7wMC3H8jX3AIAMeKa5y6Yx30jd,5Gyp41oLVo7Gg7vF4vpmggWP5MU70QO6,15,23,11,0,1,7,8,1,51,7.285714285714286,3,0.0,4,11,0,1,19,7,0,8,1,16,35,1
15180,142758,yrhM0f9eUaBZaXRFDDEWObfycFYGq3Vg,5Gyp41oLVo7Gg7vF4vpmggWP5MU70QO6,4,2,1,0,1,0,1,0,5,0.7142857142857143,1,0.0,0,1,0,1,2,0,0,1,0,2,3,1
15181,142760,UAggpZPNL1hZ0kLwEDSUplsT3ghk1d6y,5Gyp41oLVo7Gg7vF4vpmggWP5MU70QO6,13,11,4,3,3,1,4,1,27,3.857142857142857,2,0.0,4,4,2,3,7,1,1,4,1,13,14,1
15182,142762,B47i3EzhxUZkTowzEjHth2XT13SO0c2c,5Gyp41oLVo7Gg7vF4vpmggWP5MU70QO6,9,10,4,0,4,0,2,0,20,2.857142857142857,2,0.0,4,4,0,4,6,0,0,2,0,12,8,1
15183,142764,as39QGy2Taol6QjOlHPo3H1pEHHUWJAb,5Gyp41oLVo7Gg7vF4vpmggWP5MU70QO6,13,14,5,10,3,2,4,3,41,5.857142857142857,1,0.0,4,5,7,3,10,2,3,4,3,19,22,1
15184,142770,0ZCmmgRqSZJZrAmOpx3kfkWQLZuDtvzs,5Gyp41oLVo7Gg7vF4vpmggWP5MU70QO6,6,3,1,0,0,10,4,1,19,2.7142857142857144,1,0.0,0,1,0,0,3,10,0,4,1,1,18,1
15185,142773,C9nwYY5vil88Qp4KSoVNYtbqZjoJ3YE9,5Gyp41oLVo7Gg7vF4vpmggWP5MU70QO6,17,33,15,0,7,11,11,2,79,11.285714285714286,1,0.0,3,15,0,7,30,11,0,11,2,25,54,0
15186,142774,9k3wgqD1eLHF7SKMxPzLDLpWfBNrOuvD,5Gyp41oLVo7Gg7vF4vpmggWP5MU70QO6,6,7,3,0,2,0,1,0,13,1.8571428571428572,1,0.0,1,3,0,2,6,0,0,1,0,6,7,1
15187,142779,U9fRwgomIJaGo9IN517YcyMvUgckUdad,5Gyp41oLVo7Gg7vF4vpmggWP5MU70QO6,4,3,2,0,0,0,1,0,6,0.8571428571428571,1,0.0,0,2,0,0,3,0,0,1,0,2,4,1
15188,142782,ATZroMPn5aj5E55u4Qf7bbAE17kAj4Ek,5Gyp41oLVo7Gg7vF4vpmggWP5MU70QO6,11,9,6,2,4,0,2,0,23,3.2857142857142856,1,0.0,1,6,1,4,8,0,1,2,0,12,11,0
15189,142786,qQXHaDv5XCxR4Th7bsEbu6dhUGiULo1i,5Gyp41oLVo7Gg7vF4vpmggWP5MU70QO6,9,9,6,0,4,0,4,0,23,3.2857142857142856,2,0.0,0,6,0,4,9,0,0,4,0,10,13,1
15190,142787,FeXF4CdXo9VnZHL5ropZVBUAaN6Jph36,5Gyp41oLVo7Gg7vF4vpmggWP5MU70QO6,4,2,1,0,1,0,1,0,5,0.7142857142857143,1,0.0,0,1,0,1,2,0,0,1,0,2,3,1
15191,142788,ISQViQMMbYMxUymj0UzcgKDBKu1RpFFM,5Gyp41oLVo7Gg7vF4vpmggWP5MU70QO6,13,17,7,10,4,0,3,0,41,5.857142857142857,3,0.0,6,7,6,4,11,0,4,3,0,23,18,0
15192,142790,3WVNf1jvl5kky7gDcuyuchNBzYM1t9Ux,5Gyp41oLVo7Gg7vF4vpmggWP5MU70QO6,28,67,32,19,26,0,32,0,176,25.142857142857142,8,0.0,32,32,14,26,35,0,5,32,0,104,72,1
15193,142791,xxrOGCGHttgspdn3oyUYezbmYdy3uvTL,5Gyp41oLVo7Gg7vF4vpmggWP5MU70QO6,5,2,1,0,1,0,2,0,6,0.8571428571428571,1,0.0,0,1,0,1,2,0,0,2,0,2,4,1
15194,142793,zMKsMOqXrTxUx07QbehwPdsXhKg2VMjk,5Gyp41oLVo7Gg7vF4vpmggWP5MU70QO6,19,34,5,0,11,0,6,0,56,8.0,2,0.0,9,5,0,11,25,0,0,6,0,25,31,1
15195,142794,hMpjQWUM9HC9Xyo28mzOKcAfAW0WtZ6L,5Gyp41oLVo7Gg7vF4vpmggWP5MU70QO6,7,5,2,0,2,0,3,0,12,1.7142857142857142,1,0.0,0,2,0,2,5,0,0,3,0,4,8,1
15196,142795,M8C9BDFICk4ida59GU0jjp556zazDEi1,5Gyp41oLVo7Gg7vF4vpmggWP5MU70QO6,9,12,4,0,3,0,6,0,25,3.5714285714285716,3,0.0,1,4,0,3,11,0,0,6,0,8,17,1
15197,142801,3ZzhbGHk0AMavVBVS0pUAaZvWnLoQODp,5Gyp41oLVo7Gg7vF4vpmggWP5MU70QO6,7,9,2,0,2,0,3,0,16,2.2857142857142856,2,0.0,0,2,0,2,9,0,0,3,0,4,12,1
15198,142802,38KASKYfDNVp59SAe2YkbN8MkYWzQ9xL,5Gyp41oLVo7Gg7vF4vpmggWP5MU70QO6,13,8,4,0,4,0,12,0,28,4.0,2,0.0,3,4,0,4,5,0,0,12,0,11,17,1
15199,142803,Nqpr56I7BC3ItaUSHAdAOInyCMxfFx8M,5Gyp41oLVo7Gg7vF4vpmggWP5MU70QO6,2,0,0,0,0,0,2,0,2,0.2857142857142857,1,0.0,0,0,0,0,0,0,0,2,0,0,2,1
15200,142807,UyGxbLGpzWj9nUt4zlv3JQ4QXzLJV2bP,5Gyp41oLVo7Gg7vF4vpmggWP5MU70QO6,9,7,3,3,2,0,1,0,16,2.2857142857142856,1,0.0,3,3,2,2,4,0,1,1,0,10,6,1
15201,142808,MW8Y3n3B2StCbZQXTLnrtO8wwOpI9WF8,5Gyp41oLVo7Gg7vF4vpmggWP5MU70QO6,12,10,5,0,4,11,5,1,36,5.142857142857143,1,0.0,3,5,0,4,7,11,0,5,1,12,24,1
15202,142812,bNNfoay22NeH9BCitqHR3TXn5OQQC6UY,5Gyp41oLVo7Gg7vF4vpmggWP5MU70QO6,19,20,8,8,6,2,7,1,52,7.428571428571429,1,0.0,10,8,5,6,10,2,3,7,1,29,23,1
15203,142813,B7F3lTeILE76KsZtWoqyvqR22YUe8YeJ,5Gyp41oLVo7Gg7vF4vpmggWP5MU70QO6,5,2,1,0,1,0,3,0,7,1.0,1,0.0,0,1,0,1,2,0,0,3,0,2,5,1
15204,142824,IF3MFybGElafhX7jbbDfSBov8mktXBWH,5Gyp41oLVo7Gg7vF4vpmggWP5MU70QO6,10,10,4,3,2,0,7,0,26,3.7142857142857144,1,0.0,5,4,2,2,5,0,1,7,0,13,13,1
15205,142828,VG95oODwNEkjCI3szesfLNqRNyP4cVEb,5Gyp41oLVo7Gg7vF4vpmggWP5MU70QO6,14,17,0,18,2,0,4,0,41,5.857142857142857,4,0.0,3,0,12,2,14,0,6,4,0,17,24,0
15206,142830,8hq02goyJj4fNhknuQanzJ3MeLr8HN04,5Gyp41oLVo7Gg7vF4vpmggWP5MU70QO6,5,2,1,0,1,0,3,0,7,1.0,2,0.0,0,1,0,1,2,0,0,3,0,2,5,1
15207,142833,8JlRR0J0RUyxysqoH6sZLq5xVrlZWRp1,5Gyp41oLVo7Gg7vF4vpmggWP5MU70QO6,7,9,2,5,1,0,2,0,19,2.7142857142857144,1,0.0,6,2,3,1,3,0,2,2,0,12,7,1
15208,142834,nI2lsokWUEO6650kzyzTT0eGvDlAlyHa,5Gyp41oLVo7Gg7vF4vpmggWP5MU70QO6,7,5,3,0,2,0,1,0,11,1.5714285714285714,1,0.0,0,3,0,2,5,0,0,1,0,5,6,1
15209,142835,caAgMtwKkAQFiS6DHpWiCegc918t4IRr,5Gyp41oLVo7Gg7vF4vpmggWP5MU70QO6,8,16,11,2,1,0,3,0,33,4.714285714285714,2,0.0,1,11,1,1,15,0,1,3,0,14,19,1
15210,142837,RUAH37bGyuBeXQjBS6NwapgrBGkrBGTv,5Gyp41oLVo7Gg7vF4vpmggWP5MU70QO6,13,12,5,2,5,2,6,1,33,4.714285714285714,1,0.0,5,5,1,5,7,2,1,6,1,16,17,1
15211,142839,pMaElq6QfFkzEK9UpuWlI5Z36ojw0yzC,5Gyp41oLVo7Gg7vF4vpmggWP5MU70QO6,10,10,2,13,3,0,1,0,29,4.142857142857143,1,0.0,6,2,9,3,4,0,4,1,0,20,9,1
15212,142841,r7EcjZitzTY8Tailt2jIOrxuI3cJdJPM,5Gyp41oLVo7Gg7vF4vpmggWP5MU70QO6,10,16,8,0,2,1,4,0,31,4.428571428571429,1,0.0,0,8,0,2,16,1,0,4,0,10,21,1
15213,142842,Myt16IMVzxwRTOZLb6UMMq0vewiso7Vm,5Gyp41oLVo7Gg7vF4vpmggWP5MU70QO6,1,0,0,0,0,0,1,0,1,0.14285714285714285,1,0.0,0,0,0,0,0,0,0,1,0,0,1,1
15214,142844,bgBEVIT7lED5jwl9T1xbuywAm7JQXaqp,5Gyp41oLVo7Gg7vF4vpmggWP5MU70QO6,6,3,0,0,2,0,1,0,6,0.8571428571428571,1,0.0,0,0,0,2,3,0,0,1,0,2,4,1
15215,142847,rLOm82ZYOyQDfpgqtJlmBnLMVDmBeDjH,5Gyp41oLVo7Gg7vF4vpmggWP5MU70QO6,8,5,3,0,2,0,5,1,16,2.2857142857142856,2,0.0,0,3,0,2,5,0,0,5,1,5,11,1
15216,142848,KNZBV0Gkhm2LFK5DvbdYNqZKr7lI7OII,5Gyp41oLVo7Gg7vF4vpmggWP5MU70QO6,6,3,2,0,2,0,1,0,8,1.1428571428571428,1,0.0,0,2,0,2,3,0,0,1,0,4,4,1
15217,142849,G8UuvQJgC9RedtA6dEqqEDxZX9cP7O2N,5Gyp41oLVo7Gg7vF4vpmggWP5MU70QO6,15,32,12,16,10,3,5,0,78,11.142857142857142,2,0.0,12,12,11,10,20,3,5,5,0,45,33,1
15218,142850,6ZT2wBcC2W2UO1T7QWFqFW30I0k8Ws5P,5Gyp41oLVo7Gg7vF4vpmggWP5MU70QO6,5,5,4,0,0,0,5,0,14,2.0,2,0.0,0,4,0,0,5,0,0,5,0,4,10,1
15219,142854,lqWDQbrIKDwpIQudqD9IJI01BXWfaIuR,5Gyp41oLVo7Gg7vF4vpmggWP5MU70QO6,10,12,3,0,4,2,2,0,23,3.2857142857142856,1,0.0,4,3,0,4,8,2,0,2,0,11,12,1
15220,142865,gGlGKQGgPdzw79rnBTsHW2kQh2pkhlVW,5Gyp41oLVo7Gg7vF4vpmggWP5MU70QO6,6,3,2,0,2,0,2,0,9,1.2857142857142858,2,0.0,0,2,0,2,3,0,0,2,0,4,5,1
15221,142872,pmCkVIwVheDfGvtgMxp3hRlMszaozL1q,5Gyp41oLVo7Gg7vF4vpmggWP5MU70QO6,6,10,2,0,0,0,2,0,14,2.0,2,0.0,1,2,0,0,9,0,0,2,0,3,11,1
15222,142874,L0BCRsOFVFux7H1DqTlmsPHtynyE6PWh,5Gyp41oLVo7Gg7vF4vpmggWP5MU70QO6,4,2,1,0,1,0,1,0,5,0.7142857142857143,1,0.0,0,1,0,1,2,0,0,1,0,2,3,1
15223,142876,ZWuMpyI0ifOpLKV6A0au7a8XxkBSjmW8,5Gyp41oLVo7Gg7vF4vpmggWP5MU70QO6,7,3,2,0,2,0,2,0,9,1.2857142857142858,1,0.0,0,2,0,2,3,0,0,2,0,4,5,1
15224,142878,wPSiEPK9Fi84VB7By341ddDHJUpDgRi3,5Gyp41oLVo7Gg7vF4vpmggWP5MU70QO6,8,6,4,0,3,0,2,0,15,2.142857142857143,1,0.0,0,4,0,3,6,0,0,2,0,7,8,1
15225,142879,p0fw4v0FzqDHoIprXWv2PhAw9MEKisrS,5Gyp41oLVo7Gg7vF4vpmggWP5MU70QO6,4,2,1,0,0,87,11,0,101,14.428571428571429,5,0.0,0,1,0,0,2,87,0,11,0,1,100,0
15226,142881,6lxqO6gucEPo0iFbRZ4Psmditgm2GZdr,5Gyp41oLVo7Gg7vF4vpmggWP5MU70QO6,9,14,9,0,0,0,5,0,28,4.0,2,0.0,1,9,0,0,13,0,0,5,0,10,18,1
15227,142883,j8UeSZFNUzzfzk2DFBytx4Rkr6FApV94,5Gyp41oLVo7Gg7vF4vpmggWP5MU70QO6,8,6,4,0,3,0,4,0,17,2.4285714285714284,1,0.0,0,4,0,3,6,0,0,4,0,7,10,1
15228,142892,suiW3DnmY7IjzxYGHIbP9XZX1wmuymDO,5Gyp41oLVo7Gg7vF4vpmggWP5MU70QO6,12,16,9,4,5,3,5,1,43,6.142857142857143,2,0.0,3,9,3,5,13,3,1,5,1,20,23,1
15229,142905,KsA8ooBzwXieh7lKUkWn3INwNv7tnXGE,5Gyp41oLVo7Gg7vF4vpmggWP5MU70QO6,11,23,9,0,4,17,9,0,62,8.857142857142858,2,0.0,0,9,0,4,23,17,0,9,0,13,49,1
15230,142915,xqJQGPcuFpaDvsnvTKjqo4rGu7icAOJH,5Gyp41oLVo7Gg7vF4vpmggWP5MU70QO6,7,4,3,0,3,0,3,0,13,1.8571428571428572,1,0.0,0,3,0,3,4,0,0,3,0,6,7,1
15231,142916,OGWTywqD3YlVP7vYo3Y0izf1JAFxQTll,5Gyp41oLVo7Gg7vF4vpmggWP5MU70QO6,33,45,24,17,13,8,15,3,125,17.857142857142858,6,0.0,16,24,12,13,29,8,5,15,3,65,60,1
15232,142927,SNU33gChMp1lTvMCw8gcdFroNytSgZDI,5Gyp41oLVo7Gg7vF4vpmggWP5MU70QO6,10,5,2,0,1,1,9,3,21,3.0,2,0.0,0,2,0,1,5,1,0,9,3,3,18,1
15233,142930,cnIZtD2TkFxg65gflPFMb4t2kmxrdp9X,5Gyp41oLVo7Gg7vF4vpmggWP5MU70QO6,1,0,0,0,0,0,1,0,1,0.14285714285714285,1,0.0,0,0,0,0,0,0,0,1,0,0,1,1
15234,142932,pfDFnPhEzJOaJRRGHUyMyZvpV64BRVF5,5Gyp41oLVo7Gg7vF4vpmggWP5MU70QO6,15,34,3,3,1,26,9,1,77,11.0,2,0.0,4,3,2,1,30,26,1,9,1,10,67,0
15235,142935,FM9F7roZRXjjLVpKJMa3bf9FDgpJfg8g,5Gyp41oLVo7Gg7vF4vpmggWP5MU70QO6,9,9,6,0,4,1,3,0,23,3.2857142857142856,2,0.0,1,6,0,4,8,1,0,3,0,11,12,1
15236,142949,5b7vUXmWhN89ZGFsAOK97Z2P0dkwpDxp,5Gyp41oLVo7Gg7vF4vpmggWP5MU70QO6,6,2,1,0,1,2,4,0,10,1.4285714285714286,1,0.0,0,1,0,1,2,2,0,4,0,2,8,1
15237,142967,g6loW2VoON94gkUidTjl3Rc73OlFLAiK,5Gyp41oLVo7Gg7vF4vpmggWP5MU70QO6,17,18,8,4,5,18,10,1,64,9.142857142857142,2,0.0,4,8,2,5,14,18,2,10,1,19,45,1
15238,142975,7qsaEci0HIhmesmJa8LcxLiADi1nROZ7,5Gyp41oLVo7Gg7vF4vpmggWP5MU70QO6,14,22,10,10,6,0,3,0,51,7.285714285714286,3,0.0,6,10,7,6,16,0,3,3,0,29,22,1
15239,142984,BH0g3wVCilU6qeEv507COxWXunEVyQCt,5Gyp41oLVo7Gg7vF4vpmggWP5MU70QO6,14,36,13,0,4,0,7,0,60,8.571428571428571,5,0.0,9,13,0,4,27,0,0,7,0,26,34,1
15240,142987,MvjFU26ODt0ILsX9Hjqccm6mRkn5hHAE,5Gyp41oLVo7Gg7vF4vpmggWP5MU70QO6,1,0,0,0,0,0,1,0,1,0.14285714285714285,1,0.0,0,0,0,0,0,0,0,1,0,0,1,1
15241,142991,Dp3MToYleLMspzHaSQGdnKc9ndk6SXb6,5Gyp41oLVo7Gg7vF4vpmggWP5MU70QO6,10,21,6,2,2,0,7,0,38,5.428571428571429,4,0.0,5,6,1,2,16,0,1,7,0,14,24,1
15242,142994,un94uG6qteutb9C79ekNZ3A4PBcceSuD,5Gyp41oLVo7Gg7vF4vpmggWP5MU70QO6,1,0,0,0,0,0,2,0,2,0.2857142857142857,1,0.0,0,0,0,0,0,0,0,2,0,0,2,1
15243,143001,6s7Fztpt96rPS7sygATaH1vhQWiiu6TM,5Gyp41oLVo7Gg7vF4vpmggWP5MU70QO6,5,3,2,0,2,0,3,0,10,1.4285714285714286,1,0.0,0,2,0,2,3,0,0,3,0,4,6,1
15244,143009,SDnmOhyhUqRdpMYDOgOHLbgShn3XKHMw,5Gyp41oLVo7Gg7vF4vpmggWP5MU70QO6,6,3,2,0,2,0,1,0,8,1.1428571428571428,1,0.0,0,2,0,2,3,0,0,1,0,4,4,1
15245,143011,m19Z5qXkBWG6glBh43LnAgq9wHnncSxM,5Gyp41oLVo7Gg7vF4vpmggWP5MU70QO6,9,9,1,0,2,0,1,0,13,1.8571428571428572,1,0.0,3,1,0,2,6,0,0,1,0,6,7,1
15246,143012,lCjHVTs2UO2dfUph2RAs3RCnw4I8AAnn,5Gyp41oLVo7Gg7vF4vpmggWP5MU70QO6,1,0,0,0,0,0,1,0,1,0.14285714285714285,1,0.0,0,0,0,0,0,0,0,1,0,0,1,1
15247,143023,Dpj1ute7yeokptEET2ZfYuubDiXNwLXm,5Gyp41oLVo7Gg7vF4vpmggWP5MU70QO6,14,23,12,0,7,9,12,1,64,9.142857142857142,3,0.0,1,12,0,7,22,9,0,12,1,20,44,1
15248,143027,2fqSxqAVilSfIg4sQ6fD6J1JY6ZshTCe,5Gyp41oLVo7Gg7vF4vpmggWP5MU70QO6,8,2,2,0,2,2,4,3,15,2.142857142857143,1,0.0,0,2,0,2,2,2,0,4,3,4,11,1
15249,143028,YHgJ6X0orrZrcgeXM2oJnYKidrTwftvX,5Gyp41oLVo7Gg7vF4vpmggWP5MU70QO6,15,39,18,5,2,27,9,1,101,14.428571428571429,3,0.0,5,18,3,2,34,27,2,9,1,28,73,1
15250,143031,3KjnZ3S4S95rwgXw0mLP4J41XhNDBesp,5Gyp41oLVo7Gg7vF4vpmggWP5MU70QO6,3,5,2,0,0,2,1,0,10,1.4285714285714286,1,0.0,0,2,0,0,5,2,0,1,0,2,8,1
15251,143032,yiX0lNiEyuJnsK7G0Hy1jjUqzZwKTcF0,5Gyp41oLVo7Gg7vF4vpmggWP5MU70QO6,9,8,0,0,2,0,6,0,16,2.2857142857142856,3,0.0,0,0,0,2,8,0,0,6,0,2,14,1
15252,143036,DRIsdfmYpSxbWwFUHIOIzf4BRoke0ZZE,5Gyp41oLVo7Gg7vF4vpmggWP5MU70QO6,17,26,12,9,6,10,8,1,72,10.285714285714286,2,0.0,10,12,7,6,16,10,2,8,1,35,37,1
15253,143041,JQXwg5oDrXSY89Ir81YvGqw3RQTrtmLb,5Gyp41oLVo7Gg7vF4vpmggWP5MU70QO6,12,33,10,0,11,3,10,1,68,9.714285714285714,3,0.0,6,10,0,11,27,3,0,10,1,27,41,1
15254,143061,XuaSoIyzQwXQTlS6fvGcmzTRqL1S8Nnj,5Gyp41oLVo7Gg7vF4vpmggWP5MU70QO6,17,18,11,11,8,2,7,1,58,8.285714285714286,1,0.0,3,11,8,8,15,2,3,7,1,30,28,1
15255,143063,b7ewJdm3mar5i6uoQA5ZMhd1hcPb1nbE,5Gyp41oLVo7Gg7vF4vpmggWP5MU70QO6,9,3,2,0,2,0,6,0,13,1.8571428571428572,1,0.0,0,2,0,2,3,0,0,6,0,4,9,1
15256,143071,TIVivi0oFusM7y9wcn0UQtXgRbbsyKFg,5Gyp41oLVo7Gg7vF4vpmggWP5MU70QO6,9,4,3,0,3,1,2,0,13,1.8571428571428572,1,0.0,0,3,0,3,4,1,0,2,0,6,7,1
15257,143075,do1Z4vmEY3IfXSZbYlXlN4QavaoSDH7E,5Gyp41oLVo7Gg7vF4vpmggWP5MU70QO6,4,2,1,0,1,0,1,0,5,0.7142857142857143,1,0.0,0,1,0,1,2,0,0,1,0,2,3,1
15258,143080,pvSD567ywc6ozL5cSGngcmAAsEaD239g,5Gyp41oLVo7Gg7vF4vpmggWP5MU70QO6,8,5,3,0,2,0,3,0,13,1.8571428571428572,1,0.0,0,3,0,2,5,0,0,3,0,5,8,1
15259,143082,5VrubMohFJRs2uBLHqjjujzimTw2JUmG,5Gyp41oLVo7Gg7vF4vpmggWP5MU70QO6,9,5,3,0,2,0,4,0,14,2.0,1,0.0,0,3,0,2,5,0,0,4,0,5,9,1
15260,143086,rEvKP9b6qegELe0wgljw2rw7nsonmRLv,5Gyp41oLVo7Gg7vF4vpmggWP5MU70QO6,6,4,3,0,3,5,2,0,17,2.4285714285714284,1,0.0,0,3,0,3,4,5,0,2,0,6,11,1
15261,143087,gVKYwt7a5YfFnHCVbaJMFEr2HRbS5Dys,5Gyp41oLVo7Gg7vF4vpmggWP5MU70QO6,5,1,1,0,1,0,2,0,5,0.7142857142857143,1,0.0,0,1,0,1,1,0,0,2,0,2,3,1
15262,143094,KdYI01F9Xc7qTt82weazWGHtHsUvxDB7,5Gyp41oLVo7Gg7vF4vpmggWP5MU70QO6,28,100,65,30,8,137,44,6,390,55.714285714285715,7,0.0,13,65,24,8,87,137,6,44,6,110,280,1
15263,143098,DPe55xPITU47YaO3l7sFO9C6BhqHfcWz,5Gyp41oLVo7Gg7vF4vpmggWP5MU70QO6,9,9,3,11,2,0,1,0,26,3.7142857142857144,1,0.0,5,3,7,2,4,0,4,1,0,17,9,1
15264,143105,MgtK46EfcHVMVAxIq7hS5UFlePotashl,5Gyp41oLVo7Gg7vF4vpmggWP5MU70QO6,5,4,3,0,1,0,2,0,10,1.4285714285714286,2,0.0,0,3,0,1,4,0,0,2,0,4,6,1
15265,143116,9OJN8dVuGmNkppZgs9QV6MNMRzqLs9aB,5Gyp41oLVo7Gg7vF4vpmggWP5MU70QO6,21,35,16,5,13,6,13,1,89,12.714285714285714,2,0.0,13,16,3,13,22,6,2,13,1,45,44,1
15266,143125,AxLMXe4mhxK1wpAy63LabW5ekOJueEXq,5Gyp41oLVo7Gg7vF4vpmggWP5MU70QO6,1,0,0,0,0,0,2,0,2,0.2857142857142857,1,0.0,0,0,0,0,0,0,0,2,0,0,2,1
15267,143128,qC7z0hkyxIqr1VA8jwfHLMApVzGohUEr,5Gyp41oLVo7Gg7vF4vpmggWP5MU70QO6,17,13,6,4,6,17,4,1,51,7.285714285714286,1,0.0,4,6,2,6,9,17,2,4,1,18,33,1
15268,143129,iNaNVKPSNQcQDAXEsk3oID2h2qCn4Blu,5Gyp41oLVo7Gg7vF4vpmggWP5MU70QO6,20,29,15,15,7,6,8,0,80,11.428571428571429,3,0.0,7,15,10,7,22,6,5,8,0,39,41,1
15269,143131,bhmI4wUi4dYE8RHNnBf6ZaTcRPmT22ih,5Gyp41oLVo7Gg7vF4vpmggWP5MU70QO6,7,5,3,0,2,4,2,0,16,2.2857142857142856,2,0.0,0,3,0,2,5,4,0,2,0,5,11,1
15270,143132,MIuFMHu4QqmngBMuxZXIQYGoRPab86df,5Gyp41oLVo7Gg7vF4vpmggWP5MU70QO6,6,2,1,0,1,5,3,0,12,1.7142857142857142,2,0.0,0,1,0,1,2,5,0,3,0,2,10,1
15271,143135,BPWa0SjleiqllaywZCKubwGSdtmQ6n1j,5Gyp41oLVo7Gg7vF4vpmggWP5MU70QO6,10,4,3,0,2,1,4,1,15,2.142857142857143,1,0.0,0,3,0,2,4,1,0,4,1,5,10,0
15272,143136,xaRe3CQMiQ8ZbXtCbysZy6CuK7CM1LuZ,5Gyp41oLVo7Gg7vF4vpmggWP5MU70QO6,17,22,14,0,5,1,12,0,54,7.714285714285714,4,0.0,0,14,0,5,22,1,0,12,0,19,35,1
15273,143137,k3ESPEouELka4zGY7vPbxqjbeg15ztGg,5Gyp41oLVo7Gg7vF4vpmggWP5MU70QO6,2,0,0,0,0,0,2,0,2,0.2857142857142857,1,0.0,0,0,0,0,0,0,0,2,0,0,2,1
15274,143141,Ne9g2jvBNvHBd7CLIx87kYELPmw8ecmQ,5Gyp41oLVo7Gg7vF4vpmggWP5MU70QO6,1,0,0,0,0,0,1,0,1,0.14285714285714285,1,0.0,0,0,0,0,0,0,0,1,0,0,1,1
15275,143142,mWsuj8DW13tbV72OzJtb95DEj9IR58xK,5Gyp41oLVo7Gg7vF4vpmggWP5MU70QO6,25,62,32,37,0,22,11,2,166,23.714285714285715,2,0.0,22,32,24,0,40,22,13,11,2,78,88,1
15276,143150,o4osOJvgQ93Ymu9ZCa30DQTnm2Hl0dnw,5Gyp41oLVo7Gg7vF4vpmggWP5MU70QO6,9,6,3,2,3,0,1,0,15,2.142857142857143,1,0.0,2,3,1,3,4,0,1,1,0,9,6,1
15277,143156,e1CSwKLgflGiW7QjzYRNEoHjbDEH3F2k,5Gyp41oLVo7Gg7vF4vpmggWP5MU70QO6,7,6,4,0,2,0,1,0,13,1.8571428571428572,1,0.0,1,4,0,2,5,0,0,1,0,7,6,1
15278,143158,gACW4eW6IndswRGYovdbuYWVGeoweSw7,5Gyp41oLVo7Gg7vF4vpmggWP5MU70QO6,7,6,4,0,3,0,2,0,15,2.142857142857143,2,0.0,0,4,0,3,6,0,0,2,0,7,8,1
15279,143159,KQYI71SI6FLFL334CmUIcZdj9iEl8sIP,5Gyp41oLVo7Gg7vF4vpmggWP5MU70QO6,8,3,2,0,2,1,4,1,13,1.8571428571428572,1,0.0,0,2,0,2,3,1,0,4,1,4,9,1
15280,143162,FNNkYJBcgO6TAypEWaG77LaITnunLt0h,5Gyp41oLVo7Gg7vF4vpmggWP5MU70QO6,5,6,3,0,3,0,4,0,16,2.2857142857142856,2,0.0,0,3,0,3,6,0,0,4,0,6,10,1
15281,143163,FinP9VOv1FLjqjsGPeYAQ4N1be1w2MaA,5Gyp41oLVo7Gg7vF4vpmggWP5MU70QO6,6,3,2,0,2,0,1,0,8,1.1428571428571428,1,0.0,0,2,0,2,3,0,0,1,0,4,4,0
15282,143167,n71gQ4Qv60Nh3YO1KMa8VvSFJjnagfeK,5Gyp41oLVo7Gg7vF4vpmggWP5MU70QO6,17,28,10,9,6,0,11,2,66,9.428571428571429,3,0.0,7,10,6,6,21,0,3,11,2,29,37,1
15283,143169,RFUaC76ud2WlPM67fqme1nijMfLoBAhZ,5Gyp41oLVo7Gg7vF4vpmggWP5MU70QO6,11,16,8,0,3,8,6,0,41,5.857142857142857,3,0.0,1,8,0,3,15,8,0,6,0,12,29,1
15284,143170,Xrg8uTG8xcwYWrI9nvpuvAMovoPGgJm6,5Gyp41oLVo7Gg7vF4vpmggWP5MU70QO6,21,39,18,0,16,16,17,2,108,15.428571428571429,5,0.0,13,18,0,16,26,16,0,17,2,47,61,1
15285,143186,Jo7MgvP2yvxgxeh3IzpiPyl5ecjaSE54,5Gyp41oLVo7Gg7vF4vpmggWP5MU70QO6,10,17,12,0,0,2,10,1,42,6.0,1,0.0,4,12,0,0,13,2,0,10,1,16,26,1
15286,143189,nhgQOFSJq5AGoImDBS3vpfkFxQeI95h6,5Gyp41oLVo7Gg7vF4vpmggWP5MU70QO6,6,3,1,0,1,0,4,0,9,1.2857142857142858,1,0.0,2,1,0,1,1,0,0,4,0,4,5,1
15287,143191,igGKVn9hnrrkFHCdS1VW8OE1QaCagHjl,5Gyp41oLVo7Gg7vF4vpmggWP5MU70QO6,9,14,6,2,2,5,2,0,31,4.428571428571429,1,0.0,6,6,1,2,8,5,1,2,0,15,16,1
15288,143193,KDeaSgZ6wTHm30JcQgLQFVdVYbxH0KHc,5Gyp41oLVo7Gg7vF4vpmggWP5MU70QO6,5,2,0,0,1,0,2,0,5,0.7142857142857143,1,0.0,0,0,0,1,2,0,0,2,0,1,4,1
15289,143195,ZuzQyeRHP6ylyX1kz2ZCSK5JTnFY7jgw,5Gyp41oLVo7Gg7vF4vpmggWP5MU70QO6,8,9,5,0,2,0,8,0,24,3.4285714285714284,3,0.0,0,5,0,2,9,0,0,8,0,7,17,1
15290,143202,rSfDnEZb6MyQWJXH3EUiEdy4QB5YcYIT,5Gyp41oLVo7Gg7vF4vpmggWP5MU70QO6,13,19,2,8,3,1,5,1,39,5.571428571428571,2,0.0,8,2,6,3,11,1,2,5,1,19,20,1
15291,143207,6TbaXLQH43LhwCQqxfDoHT2dkIqoIZiA,5Gyp41oLVo7Gg7vF4vpmggWP5MU70QO6,5,2,1,0,1,0,3,0,7,1.0,1,0.0,0,1,0,1,2,0,0,3,0,2,5,1
15292,143210,q19r0zRKq7Kj0yuHwlucxw9Qfz0p8wj4,5Gyp41oLVo7Gg7vF4vpmggWP5MU70QO6,10,8,3,0,5,1,4,3,24,3.4285714285714284,2,0.0,3,3,0,5,5,1,0,4,3,11,13,1
15293,143217,I91CCtQfetYUPwkEXIvTFBP6tbrp1spN,5Gyp41oLVo7Gg7vF4vpmggWP5MU70QO6,5,0,0,0,0,1,5,1,7,1.0,1,0.0,0,0,0,0,0,1,0,5,1,0,7,1
15294,143220,zop3YH9KYZDCX1f11SNUdASXvNJ8iRxo,5Gyp41oLVo7Gg7vF4vpmggWP5MU70QO6,16,20,8,26,2,1,11,1,69,9.857142857142858,4,0.0,9,8,21,2,11,1,5,11,1,40,29,1
15295,143222,BkCm44eyCVgiloopsbEDQiCYUYpXhFhh,5Gyp41oLVo7Gg7vF4vpmggWP5MU70QO6,1,0,0,0,0,0,1,0,1,0.14285714285714285,1,0.0,0,0,0,0,0,0,0,1,0,0,1,1
15296,143223,bABhSukD4jvNJV7pWKllTDyiMRnwm2FE,5Gyp41oLVo7Gg7vF4vpmggWP5MU70QO6,7,4,3,0,2,0,1,0,10,1.4285714285714286,1,0.0,0,3,0,2,4,0,0,1,0,5,5,1
15297,143228,b9SPkVIIqTyWdNmHLqb2i5EFW3ZlPY6f,5Gyp41oLVo7Gg7vF4vpmggWP5MU70QO6,6,5,3,0,2,0,3,0,13,1.8571428571428572,2,0.0,0,3,0,2,5,0,0,3,0,5,8,1
15298,143230,EVKTxmdXvqH9f0V4XuFLHjVRnnUWi9xh,5Gyp41oLVo7Gg7vF4vpmggWP5MU70QO6,5,3,1,0,1,0,1,0,6,0.8571428571428571,1,0.0,0,1,0,1,3,0,0,1,0,2,4,1
15299,143232,XMiI0KwF5fhEpV0sZdwn5oRV5TdRMBIA,5Gyp41oLVo7Gg7vF4vpmggWP5MU70QO6,1,0,0,0,0,0,1,0,1,0.14285714285714285,1,0.0,0,0,0,0,0,0,0,1,0,0,1,1
15300,143238,GiWhb0QNRLQ5Tf1KkKsrbfKJpHMBwk1v,5Gyp41oLVo7Gg7vF4vpmggWP5MU70QO6,8,3,3,0,2,1,3,0,12,1.7142857142857142,1,0.0,0,3,0,2,3,1,0,3,0,5,7,1
15301,143240,ll3V03b2wof8nPyeyz9vdroyCyymz3Oc,5Gyp41oLVo7Gg7vF4vpmggWP5MU70QO6,13,20,6,23,3,0,4,0,56,8.0,2,0.0,11,6,14,3,9,0,9,4,0,34,22,1
15302,143243,pRKlNyr7aXvrIlMSBQ4BrpxDuTk5IyTG,5Gyp41oLVo7Gg7vF4vpmggWP5MU70QO6,7,5,3,0,1,0,7,0,16,2.2857142857142856,2,0.0,0,3,0,1,5,0,0,7,0,4,12,1
15303,143246,YxEAEqB4R6GTRBWDvga1GWE0URAxGc6U,5Gyp41oLVo7Gg7vF4vpmggWP5MU70QO6,9,20,12,0,0,0,6,0,38,5.428571428571429,6,0.0,2,12,0,0,18,0,0,6,0,14,24,1
15304,143247,lnwcZZk4BoCpUHQGJaYy0V8i6237rzzn,5Gyp41oLVo7Gg7vF4vpmggWP5MU70QO6,10,14,5,6,4,0,1,0,30,4.285714285714286,1,0.0,8,5,4,4,6,0,2,1,0,21,9,1
15305,143249,rwFmQoyHOvEHdWgjpm2nmsyB1JSa6M1i,5Gyp41oLVo7Gg7vF4vpmggWP5MU70QO6,1,0,0,0,0,0,1,0,1,0.14285714285714285,1,0.0,0,0,0,0,0,0,0,1,0,0,1,1
15306,143253,SneJ0NYk7aqDC5qkSniBWVl1uaTDa5aK,5Gyp41oLVo7Gg7vF4vpmggWP5MU70QO6,19,16,9,20,5,7,6,1,64,9.142857142857142,1,0.0,6,9,16,5,10,7,4,6,1,36,28,1
15307,143255,rb8svWOVmV3WiCo1KHfqDPOhTEw2h6Ly,5Gyp41oLVo7Gg7vF4vpmggWP5MU70QO6,7,9,4,0,1,0,4,0,18,2.5714285714285716,2,0.0,0,4,0,1,9,0,0,4,0,5,13,1
15308,143270,MfPI39sufXLCYqLL798nCefcxWtCKM9I,5Gyp41oLVo7Gg7vF4vpmggWP5MU70QO6,5,2,1,0,1,0,2,0,6,0.8571428571428571,1,0.0,0,1,0,1,2,0,0,2,0,2,4,1
15309,143271,q2xQCstASp96wpspi8iqsuaqJ7gzfsux,5Gyp41oLVo7Gg7vF4vpmggWP5MU70QO6,11,9,4,12,0,0,1,0,26,3.7142857142857144,1,0.0,3,4,9,0,6,0,3,1,0,16,10,1
15310,143273,Zkoaalg5gR5VRpuQYCw0O6lY2zjL7QUk,5Gyp41oLVo7Gg7vF4vpmggWP5MU70QO6,6,3,3,0,2,0,2,0,10,1.4285714285714286,1,0.0,0,3,0,2,3,0,0,2,0,5,5,1
15311,143274,cEJWzD9dGTS2EAlcBmSG0h9GwpdVCcKs,5Gyp41oLVo7Gg7vF4vpmggWP5MU70QO6,14,20,10,8,7,10,12,1,68,9.714285714285714,1,0.0,10,10,5,7,10,10,3,12,1,32,36,1
15312,143289,Do8hbesbT6OBtmo3AMshqQTnDUWGEYzY,5Gyp41oLVo7Gg7vF4vpmggWP5MU70QO6,11,17,9,5,5,8,7,0,51,7.285714285714286,3,0.0,4,9,3,5,13,8,2,7,0,21,30,1
15313,143293,KeJ2Uvhd6Kdyp7EsZknmz1m41xlCNZ2d,5Gyp41oLVo7Gg7vF4vpmggWP5MU70QO6,4,2,0,0,1,0,2,0,5,0.7142857142857143,1,0.0,0,0,0,1,2,0,0,2,0,1,4,1
15314,143297,MCi65wdv0LbmAT0IkqfYGVJG2oSDQ0M5,5Gyp41oLVo7Gg7vF4vpmggWP5MU70QO6,11,8,4,0,3,0,5,0,20,2.857142857142857,2,0.0,1,4,0,3,7,0,0,5,0,8,12,1
15315,143298,j8HMNSvqsRTZYEHc4rRzkD2YAQLorjQF,5Gyp41oLVo7Gg7vF4vpmggWP5MU70QO6,5,6,3,0,1,0,3,0,13,1.8571428571428572,3,0.0,0,3,0,1,6,0,0,3,0,4,9,1
15316,143300,oSjFmNzquetC0sVtfmLtjT8TDy2BmlHN,5Gyp41oLVo7Gg7vF4vpmggWP5MU70QO6,12,20,8,0,5,4,9,1,47,6.714285714285714,4,0.0,4,8,0,5,16,4,0,9,1,17,30,1
15317,143301,sOVkx7jjk0gU5YuQasoQUBg1lLSDWgd7,5Gyp41oLVo7Gg7vF4vpmggWP5MU70QO6,7,5,3,0,3,12,5,0,28,4.0,1,0.0,0,3,0,3,5,12,0,5,0,6,22,1
15318,143304,ZuK89GHN4bqTYIiZNVMqTHhEUKl9OagO,5Gyp41oLVo7Gg7vF4vpmggWP5MU70QO6,15,19,11,2,4,1,10,1,48,6.857142857142857,2,0.0,4,11,1,4,15,1,1,10,1,20,28,1
15319,143310,Srzx9DkAQVhPqTB5VQGPf5BuKlWhqg6D,5Gyp41oLVo7Gg7vF4vpmggWP5MU70QO6,10,7,4,8,3,0,1,0,23,3.2857142857142856,1,0.0,2,4,6,3,5,0,2,1,0,15,8,1
15320,143313,RU275VOgQR3hXH7M7a8ifKkCevQFU0OB,5Gyp41oLVo7Gg7vF4vpmggWP5MU70QO6,19,37,13,33,5,11,4,0,103,14.714285714285714,5,0.0,19,13,27,5,18,11,6,4,0,64,39,1
15321,143327,BCsXMTXMkLglsocuyOC8JkAlV0urSlKL,5Gyp41oLVo7Gg7vF4vpmggWP5MU70QO6,1,0,0,0,0,0,2,0,2,0.2857142857142857,1,0.0,0,0,0,0,0,0,0,2,0,0,2,1
15322,143331,TOGouapafKnIxFk4WgVAiDrJCoEswpDO,5Gyp41oLVo7Gg7vF4vpmggWP5MU70QO6,14,21,12,3,4,0,8,0,48,6.857142857142857,3,0.0,2,12,2,4,19,0,1,8,0,20,28,1
15323,143332,G4oYYTqga05amYF2WyoajbCZn7qaA015,5Gyp41oLVo7Gg7vF4vpmggWP5MU70QO6,4,2,1,0,1,0,1,0,5,0.7142857142857143,1,0.0,0,1,0,1,2,0,0,1,0,2,3,0
15324,143333,RSvPQSF8RarDsP4aI3ftScWWjvINqjc5,5Gyp41oLVo7Gg7vF4vpmggWP5MU70QO6,19,20,12,21,7,11,1,0,72,10.285714285714286,4,0.0,5,12,15,7,15,11,6,1,0,39,33,0
15325,143348,4FpBAFbkTW74GTZijuH1arPakK1chUuB,5Gyp41oLVo7Gg7vF4vpmggWP5MU70QO6,10,9,5,3,2,0,3,0,22,3.142857142857143,2,0.0,1,5,2,2,8,0,1,3,0,10,12,1
15326,143352,afxPPujIq38QOJZWzKAUwDfPhgssooFj,5Gyp41oLVo7Gg7vF4vpmggWP5MU70QO6,14,13,8,0,2,1,5,1,30,4.285714285714286,1,0.0,3,8,0,2,10,1,0,5,1,13,17,1
15327,143358,qguXCGauBLRxB42arUsmMf4qY2P6nLSI,5Gyp41oLVo7Gg7vF4vpmggWP5MU70QO6,7,29,11,0,1,11,1,0,53,7.571428571428571,1,0.0,3,11,0,1,26,11,0,1,0,15,38,1
15328,143365,vGcLxIxx9hPQmjm92Kj3O9RHGwvxcHnD,5Gyp41oLVo7Gg7vF4vpmggWP5MU70QO6,5,3,1,0,1,0,1,0,6,0.8571428571428571,1,0.0,0,1,0,1,3,0,0,1,0,2,4,1
15329,143373,94TaJxTGa6mk96QWRsvTPAlZKuIwFWgW,5Gyp41oLVo7Gg7vF4vpmggWP5MU70QO6,6,4,3,0,2,0,3,0,12,1.7142857142857142,2,0.0,0,3,0,2,4,0,0,3,0,5,7,1
15330,143379,XNOL59MqQcKgU2TbdVogAc500SlZ5TMF,5Gyp41oLVo7Gg7vF4vpmggWP5MU70QO6,12,11,5,2,3,1,5,1,28,4.0,1,0.0,5,5,1,3,6,1,1,5,1,14,14,1
15331,143385,ExaahXOdmDkG9h6C6IWQiCEgqVTIynrC,5Gyp41oLVo7Gg7vF4vpmggWP5MU70QO6,23,58,20,32,12,23,11,2,158,22.571428571428573,3,0.0,16,20,23,12,42,23,9,11,2,71,87,1
15332,143386,YvC95tMRyMsPtnV4Slqh3o5qWPTRuglH,5Gyp41oLVo7Gg7vF4vpmggWP5MU70QO6,2,0,0,0,0,0,3,0,3,0.42857142857142855,1,0.0,0,0,0,0,0,0,0,3,0,0,3,1
15333,143387,BMMb4uocaM6eiWDVgy8d5o4GBcNjaw64,5Gyp41oLVo7Gg7vF4vpmggWP5MU70QO6,9,5,2,5,1,0,2,0,15,2.142857142857143,1,0.0,1,2,3,1,4,0,2,2,0,7,8,1
15334,143388,DjgwD62xw4j6X1coWv63B21KAYnYeIjl,5Gyp41oLVo7Gg7vF4vpmggWP5MU70QO6,10,3,2,0,2,1,11,0,19,2.7142857142857144,2,0.0,0,2,0,2,3,1,0,11,0,4,15,1
15335,143398,yBRQxjQxDogEAqCykYWmOYDonWjRgkgU,5Gyp41oLVo7Gg7vF4vpmggWP5MU70QO6,23,31,18,13,11,9,5,0,87,12.428571428571429,3,0.0,7,18,9,11,24,9,4,5,0,45,42,1
15336,143399,NMciPbdIeB9uIZwCMcw6mXU2i3BtnB5v,5Gyp41oLVo7Gg7vF4vpmggWP5MU70QO6,6,4,3,0,2,0,1,0,10,1.4285714285714286,1,0.0,0,3,0,2,4,0,0,1,0,5,5,1
15337,143402,jrrPGAGvqCY4RzoZv6xNS5Oy0eqBPv6a,5Gyp41oLVo7Gg7vF4vpmggWP5MU70QO6,9,7,4,0,2,2,4,0,19,2.7142857142857144,1,0.0,0,4,0,2,7,2,0,4,0,6,13,1
15338,143407,CfSlJrmN1EB0CEB1WxXzFR3OkgiWGjng,5Gyp41oLVo7Gg7vF4vpmggWP5MU70QO6,6,2,1,0,1,0,4,0,8,1.1428571428571428,1,0.0,0,1,0,1,2,0,0,4,0,2,6,1
15339,143421,m56xLBiglZRYuDGduwjGoqOggwDDVCSs,5Gyp41oLVo7Gg7vF4vpmggWP5MU70QO6,10,11,6,0,3,0,3,0,23,3.2857142857142856,2,0.0,2,6,0,3,9,0,0,3,0,11,12,1
15340,143426,bSilfLBZdynq5nBBUkXoRk3OZyrStUPG,5Gyp41oLVo7Gg7vF4vpmggWP5MU70QO6,11,12,3,0,2,0,7,0,24,3.4285714285714284,2,0.0,1,3,0,2,11,0,0,7,0,6,18,1
15341,143429,eMkeOhzQLpxe3t7i8Nqij0jVxwAl4Ukd,5Gyp41oLVo7Gg7vF4vpmggWP5MU70QO6,8,4,3,0,2,0,9,1,19,2.7142857142857144,1,0.0,0,3,0,2,4,0,0,9,1,5,14,1
15342,143430,25vk7TvXQBJyp4rmBUz0jP6klf8GkyI0,5Gyp41oLVo7Gg7vF4vpmggWP5MU70QO6,10,15,6,6,3,0,3,0,33,4.714285714285714,2,0.0,3,6,4,3,12,0,2,3,0,16,17,1
15343,143439,7BMABdHPfKbAuFunFMP8IJnOb1JXGtd2,5Gyp41oLVo7Gg7vF4vpmggWP5MU70QO6,6,3,2,0,2,0,1,0,8,1.1428571428571428,1,0.0,0,2,0,2,3,0,0,1,0,4,4,1
15344,143441,NFwkvwlecWBzcgNCOvBMTCkkUA7P9cK8,5Gyp41oLVo7Gg7vF4vpmggWP5MU70QO6,14,13,8,2,5,7,3,0,38,5.428571428571429,2,0.0,0,8,1,5,13,7,1,3,0,14,24,1
15345,143443,DlJ9FnLAg8KLlOcJpKGz0ybaZuj1qVBp,5Gyp41oLVo7Gg7vF4vpmggWP5MU70QO6,5,3,1,0,1,0,1,0,6,0.8571428571428571,1,0.0,0,1,0,1,3,0,0,1,0,2,4,1
15346,143448,oJ33i7feUDdmWItlK0CBqa7RDgE1Pw5q,5Gyp41oLVo7Gg7vF4vpmggWP5MU70QO6,8,19,12,0,7,0,5,0,43,6.142857142857143,3,0.0,1,12,0,7,18,0,0,5,0,20,23,1
15347,143462,G0y998PBz3ExjEmB0ZTxVJ62JVKsEgPS,5Gyp41oLVo7Gg7vF4vpmggWP5MU70QO6,13,20,9,0,6,0,3,0,38,5.428571428571429,2,0.0,6,9,0,6,14,0,0,3,0,21,17,1
15348,143469,w8rep73swbwnVZBmuaUtSx1urGRd9SFt,5Gyp41oLVo7Gg7vF4vpmggWP5MU70QO6,9,6,4,0,3,0,6,1,20,2.857142857142857,1,0.0,0,4,0,3,6,0,0,6,1,7,13,1
15349,143473,ntA6YQWe5fxYDVE2cXKSrH7F2lF2TfcV,5Gyp41oLVo7Gg7vF4vpmggWP5MU70QO6,16,28,19,9,9,13,3,0,81,11.571428571428571,3,0.0,4,19,6,9,24,13,3,3,0,38,43,1
15350,143478,eLQqW2JOLUxobMgymK6OqjXFKQCr78ec,5Gyp41oLVo7Gg7vF4vpmggWP5MU70QO6,1,0,0,0,0,0,1,0,1,0.14285714285714285,1,0.0,0,0,0,0,0,0,0,1,0,0,1,1
15351,143483,lpIlNFXqycXbQQddlt9RaXJPBJNqHIww,5Gyp41oLVo7Gg7vF4vpmggWP5MU70QO6,4,2,1,0,1,0,2,0,6,0.8571428571428571,1,0.0,0,1,0,1,2,0,0,2,0,2,4,1
15352,143486,OYWBopBO2n38CA6GRAaDJRfIHV9b0dQs,5Gyp41oLVo7Gg7vF4vpmggWP5MU70QO6,26,41,22,17,7,22,15,7,131,18.714285714285715,3,0.0,14,22,10,7,27,22,7,15,7,53,78,1
15353,143487,Bha7QMGmONKAqxvqVmMzYDzgn03rupB9,5Gyp41oLVo7Gg7vF4vpmggWP5MU70QO6,11,17,9,2,6,2,10,0,46,6.571428571428571,2,0.0,4,9,1,6,13,2,1,10,0,20,26,0
15354,143493,Ooe9SpvA9vL8fZI7YLdrPaZtM6Unwf0C,5Gyp41oLVo7Gg7vF4vpmggWP5MU70QO6,8,5,1,0,2,0,4,0,12,1.7142857142857142,2,0.0,0,1,0,2,5,0,0,4,0,3,9,1
15355,143494,Ip3irZsxFvOeGg8WSppVhJArbPhoH3qm,5Gyp41oLVo7Gg7vF4vpmggWP5MU70QO6,7,4,2,0,2,0,1,0,9,1.2857142857142858,1,0.0,0,2,0,2,4,0,0,1,0,4,5,1
15356,143495,j79CPp6e09l3A1MeqgSV5ajYlxbk9Ixy,5Gyp41oLVo7Gg7vF4vpmggWP5MU70QO6,7,23,7,0,0,0,4,0,34,4.857142857142857,3,0.0,0,7,0,0,23,0,0,4,0,7,27,1
15357,143499,cWoy5QWZfuqmIk8DYz59g7gA3SWqJuxp,5Gyp41oLVo7Gg7vF4vpmggWP5MU70QO6,9,8,3,3,2,1,2,0,19,2.7142857142857144,1,0.0,3,3,2,2,5,1,1,2,0,10,9,1
15358,143505,dvmUEJYzbcSyy3vJBwmbV1q6GkcgXkyo,5Gyp41oLVo7Gg7vF4vpmggWP5MU70QO6,1,0,0,0,0,0,1,0,1,0.14285714285714285,1,0.0,0,0,0,0,0,0,0,1,0,0,1,1
15359,143506,y31hLJookNfhewMV4zJieB9drJ6uJOM8,5Gyp41oLVo7Gg7vF4vpmggWP5MU70QO6,4,3,2,0,2,0,1,0,8,1.1428571428571428,1,0.0,0,2,0,2,3,0,0,1,0,4,4,1
15360,143512,FXVpQoS8mavqcQRGTmrN03ngBkUOH7AA,5Gyp41oLVo7Gg7vF4vpmggWP5MU70QO6,11,25,8,19,3,12,16,0,83,11.857142857142858,4,0.0,14,8,13,3,11,12,6,16,0,38,45,1
15361,143514,uLMNzHudktr2AZyuuPvX47miD1HKSZey,5Gyp41oLVo7Gg7vF4vpmggWP5MU70QO6,7,3,2,0,2,0,2,1,10,1.4285714285714286,1,0.0,0,2,0,2,3,0,0,2,1,4,6,1
15362,143518,exZQCwNpb5GlUZp9D9aXiDpNVUddiSXX,5Gyp41oLVo7Gg7vF4vpmggWP5MU70QO6,2,0,0,0,0,0,2,0,2,0.2857142857142857,1,0.0,0,0,0,0,0,0,0,2,0,0,2,1
15363,143519,hA5iAFa3mduviu6W1NXrCwxPt2uneIZZ,5Gyp41oLVo7Gg7vF4vpmggWP5MU70QO6,1,0,0,0,0,0,1,0,1,0.14285714285714285,1,0.0,0,0,0,0,0,0,0,1,0,0,1,1
15364,143524,JGhL9OPc6cmN3pd3UPdgTkDHdCrRxIq9,5Gyp41oLVo7Gg7vF4vpmggWP5MU70QO6,5,2,1,0,1,0,3,0,7,1.0,1,0.0,0,1,0,1,2,0,0,3,0,2,5,1
15365,143529,tswNF0dP53SwO8GrnkKo6hfFh502X3nQ,5Gyp41oLVo7Gg7vF4vpmggWP5MU70QO6,7,4,2,0,1,5,8,0,20,2.857142857142857,1,0.0,0,2,0,1,4,5,0,8,0,3,17,1
15366,143530,AsKItWOk6yONkGOduP0vUaGEDxnOlUCN,5Gyp41oLVo7Gg7vF4vpmggWP5MU70QO6,1,0,0,0,0,0,1,0,1,0.14285714285714285,1,0.0,0,0,0,0,0,0,0,1,0,0,1,1
15367,143532,DKvwWgsnzXTxLcvnyFd3ScosQnv8YPop,5Gyp41oLVo7Gg7vF4vpmggWP5MU70QO6,7,11,4,0,1,3,3,0,22,3.142857142857143,1,0.0,0,4,0,1,11,3,0,3,0,5,17,1
15368,143541,FZWt1vapJFvo3kXFvlr3Pcq5dqSsXIdl,5Gyp41oLVo7Gg7vF4vpmggWP5MU70QO6,16,29,17,2,4,8,15,1,76,10.857142857142858,4,0.0,4,17,1,4,25,8,1,15,1,26,50,1
15369,143550,T6EWQ7jVP89JlHzj41KN1gEtGYevpSQM,5Gyp41oLVo7Gg7vF4vpmggWP5MU70QO6,1,0,0,0,0,0,1,0,1,0.14285714285714285,1,0.0,0,0,0,0,0,0,0,1,0,0,1,1
15370,143551,1u5RJ3ohzI9I8TYHEG8zy2n2QjuVVCRw,5Gyp41oLVo7Gg7vF4vpmggWP5MU70QO6,17,41,22,0,6,1,12,0,82,11.714285714285714,7,0.0,8,22,0,6,33,1,0,12,0,36,46,0
15371,143553,7qDBI7pI0SQ1bfBBjf175GzJeqNA6CgO,5Gyp41oLVo7Gg7vF4vpmggWP5MU70QO6,10,11,9,0,3,0,3,0,26,3.7142857142857144,2,0.0,0,9,0,3,11,0,0,3,0,12,14,0
15372,143565,fMkV32K36nG6sEguObUImrUVGuVnClMZ,5Gyp41oLVo7Gg7vF4vpmggWP5MU70QO6,6,6,4,2,1,0,1,0,14,2.0,1,0.0,1,4,1,1,5,0,1,1,0,7,7,1
15373,143568,pMv1oQj1T6gZE30FoEj4M5Nwt7Fl1qeo,5Gyp41oLVo7Gg7vF4vpmggWP5MU70QO6,1,0,0,0,0,0,1,0,1,0.14285714285714285,1,0.0,0,0,0,0,0,0,0,1,0,0,1,1
15374,143570,ejWSFSNW1jOTCFDROUQkAUS6uY6mX6CR,5Gyp41oLVo7Gg7vF4vpmggWP5MU70QO6,6,7,0,0,0,0,3,0,10,1.4285714285714286,1,0.0,0,0,0,0,7,0,0,3,0,0,10,1
15375,143573,W4egQ0tAp72v44pF53MInCDaTEirYMVh,5Gyp41oLVo7Gg7vF4vpmggWP5MU70QO6,1,0,0,0,0,0,1,0,1,0.14285714285714285,1,0.0,0,0,0,0,0,0,0,1,0,0,1,1
15376,143597,0cz0w0x5qzuunbgfeQV0i5L0OMvyWFxQ,SpATywNh6bZuzm8s1ceuBUnMUAeoAHHw,13,10,7,0,5,3,17,4,46,6.571428571428571,2,0.0,0,7,0,5,10,3,0,17,4,12,34,1
15377,143602,Jm4nQ05ndX10jbofbWx6S0r9VXrqia6S,A3fsA9Zfv1X2fVEQhTw51lKENdNrEqT3,10,9,6,0,2,0,2,0,19,2.7142857142857144,1,0.0,0,6,0,2,9,0,0,2,0,8,11,0
15378,143603,nWxN8tjySUVOGOns5lP09DIo5v1ke7EL,A3fsA9Zfv1X2fVEQhTw51lKENdNrEqT3,8,9,4,0,3,0,2,0,18,2.5714285714285716,1,0.0,0,4,0,3,9,0,0,2,0,7,11,1
15379,143605,nWxN8tjySUVOGOns5lP09DIo5v1ke7EL,bWdj2GDclj5ofokWjzoa5jAwMkxCykd6,8,4,2,0,1,2,11,2,22,3.142857142857143,1,0.0,0,2,0,1,4,2,0,11,2,3,19,1
15380,143607,3iJrlZJEv2h7DgWBpz6wZtSXPXEy6IAY,bWdj2GDclj5ofokWjzoa5jAwMkxCykd6,8,9,5,0,3,0,4,0,21,3.0,4,0.0,0,5,0,3,9,0,0,4,0,8,13,1
15381,143614,n2GF9Yeq4eisQG7nka32xYSXt9etqVaZ,G8EPVSXsOYB5YQWZGiz1aVq5Pgr2GrQu,6,5,3,0,0,1,2,0,11,1.5714285714285714,1,0.0,0,3,0,0,5,1,0,2,0,3,8,1
15382,143623,HtMha1d9fNJoHGbwIKcB3HWdDU94w7Lj,SpATywNh6bZuzm8s1ceuBUnMUAeoAHHw,18,25,14,17,6,0,7,1,70,10.0,3,0.0,6,14,16,6,19,0,1,7,1,42,28,1
15383,143629,tkMGC5CG4kemHaNbBo6MMddbuqCxk8Qb,SpATywNh6bZuzm8s1ceuBUnMUAeoAHHw,5,5,3,0,1,0,2,0,11,1.5714285714285714,3,0.0,0,3,0,1,5,0,0,2,0,4,7,1
15384,143631,GNXZVEHsVeYck60C0KBPWHG0mMcY0UQQ,SpATywNh6bZuzm8s1ceuBUnMUAeoAHHw,36,38,17,12,14,9,4,0,94,13.428571428571429,8,0.0,2,17,12,14,36,9,0,4,0,45,49,0
15385,143641,Uux0jHna4HKcvE72hnPMG7xrHByftJPh,bWdj2GDclj5ofokWjzoa5jAwMkxCykd6,5,2,1,0,1,0,2,0,6,0.8571428571428571,1,0.0,0,1,0,1,2,0,0,2,0,2,4,1
15386,143650,iyNW22GLVn7ltcBOUiQmam3mjjq9r9cL,bWdj2GDclj5ofokWjzoa5jAwMkxCykd6,1,0,0,0,0,0,1,0,1,0.14285714285714285,1,0.0,0,0,0,0,0,0,0,1,0,0,1,1
15387,143652,NNxm4wTuqK3vBr5exeeaxNmVWigp9kZd,RXDvfPUBYFlVdlueBFbLW0mhhAyGEqpt,9,9,1,0,0,0,4,0,14,2.0,2,0.0,0,1,0,0,9,0,0,4,0,1,13,1
15388,143653,E7W9iVWrVUAUJsVKnfZDdWhC9kKNiFWd,A3fsA9Zfv1X2fVEQhTw51lKENdNrEqT3,4,2,1,0,1,0,1,0,5,0.7142857142857143,1,0.0,0,1,0,1,2,0,0,1,0,2,3,0
15389,143683,oArXTDKLwWKfXkZ74yUJJtvr4UhDGsgG,SpATywNh6bZuzm8s1ceuBUnMUAeoAHHw,7,4,0,0,1,0,2,0,7,1.0,1,0.0,0,0,0,1,4,0,0,2,0,1,6,1
15390,143687,zXaIFCKxfdY9z9fVBcdJ9CKQhYz4fcsP,A3fsA9Zfv1X2fVEQhTw51lKENdNrEqT3,8,4,1,8,1,0,2,0,16,2.2857142857142856,1,0.0,1,1,8,1,3,0,0,2,0,11,5,1
15391,143689,ZaW4RrWrF9gJ30CuAjw5a2IkcpF7An5C,G8EPVSXsOYB5YQWZGiz1aVq5Pgr2GrQu,10,8,3,0,2,5,12,2,32,4.571428571428571,2,0.0,2,3,0,2,6,5,0,12,2,7,25,1
15392,143690,9l6PGZqklFaIeCC4cIui4TvC3Cf7mMtA,G8EPVSXsOYB5YQWZGiz1aVq5Pgr2GrQu,8,3,2,0,2,1,8,1,17,2.4285714285714284,1,0.0,0,2,0,2,3,1,0,8,1,4,13,1
15393,143695,MiA88xKunqu6yy0duOdvLI06Oy5UMt4X,RXDvfPUBYFlVdlueBFbLW0mhhAyGEqpt,4,2,1,0,1,0,1,0,5,0.7142857142857143,1,0.0,0,1,0,1,2,0,0,1,0,2,3,1
15394,143715,vFHaopWeOsxXSRudDrGgOuVKmzwec37W,SpATywNh6bZuzm8s1ceuBUnMUAeoAHHw,13,19,0,9,1,0,4,0,33,4.714285714285714,1,0.0,4,0,9,1,15,0,0,4,0,14,19,1
15395,143722,VzxoAK96NBZMonMzFBNCEGPOgDpcMczp,A3fsA9Zfv1X2fVEQhTw51lKENdNrEqT3,8,2,1,0,1,10,6,1,21,3.0,1,0.0,0,1,0,1,2,10,0,6,1,2,19,1
15396,143731,X2xaI3ENq0OZDZ0s1ETxwXOMaEJnZn8K,A3fsA9Zfv1X2fVEQhTw51lKENdNrEqT3,8,4,3,0,3,0,1,0,11,1.5714285714285714,2,0.0,0,3,0,3,4,0,0,1,0,6,5,1
15397,143736,a2kYXY4DZduwKkGJa8fQrbG6TxHBB94I,A3fsA9Zfv1X2fVEQhTw51lKENdNrEqT3,6,2,1,0,1,0,9,0,13,1.8571428571428572,1,0.0,0,1,0,1,2,0,0,9,0,2,11,1
15398,143739,j1ZwHmxsEQ0TgQEQqgxbWG7UscEDky1c,SpATywNh6bZuzm8s1ceuBUnMUAeoAHHw,13,22,0,11,0,0,8,0,41,5.857142857142857,2,0.0,10,0,10,0,12,0,1,8,0,20,21,1
15399,143745,ravD1f2MIgZP9srRrYJQsdPSYhRi83XU,SpATywNh6bZuzm8s1ceuBUnMUAeoAHHw,16,27,4,21,1,2,13,1,69,9.857142857142858,3,0.0,9,4,18,1,18,2,3,13,1,32,37,0
15400,143749,cZbR6FMlSKlEaK0BZQEtqLknk5lBVQRh,SpATywNh6bZuzm8s1ceuBUnMUAeoAHHw,14,16,1,12,1,12,8,1,51,7.285714285714286,1,0.0,5,1,10,1,11,12,2,8,1,17,34,1
15401,143750,ldpyoNVLH614iuNg2P99R7SYjvFOfdM2,G8EPVSXsOYB5YQWZGiz1aVq5Pgr2GrQu,11,14,6,0,4,1,4,0,29,4.142857142857143,3,0.0,3,6,0,4,11,1,0,4,0,13,16,1
15402,143762,m7fPOqd4GotPyK3pn7xq2eK9izwTqrAR,A3fsA9Zfv1X2fVEQhTw51lKENdNrEqT3,5,1,1,0,1,1,2,0,6,0.8571428571428571,1,0.0,0,1,0,1,1,1,0,2,0,2,4,1
15403,143766,CDMI3gQZrAOAZ9Cf4jB5NzA4daPYwjjn,A3fsA9Zfv1X2fVEQhTw51lKENdNrEqT3,20,16,13,0,7,5,11,4,56,8.0,2,0.0,0,13,0,7,16,5,0,11,4,20,36,1
15404,143772,D0Q5uZnA6QMJZo17g9opktHEQj6b5d5E,SpATywNh6bZuzm8s1ceuBUnMUAeoAHHw,3,0,0,0,0,0,3,0,3,0.42857142857142855,1,0.0,0,0,0,0,0,0,0,3,0,0,3,0
15405,143796,JGBLBGhiZQ8K0PQBUKKu5a6jYm04SHA0,A3fsA9Zfv1X2fVEQhTw51lKENdNrEqT3,2,0,0,0,0,0,2,0,2,0.2857142857142857,1,0.0,0,0,0,0,0,0,0,2,0,0,2,1
15406,143804,qmiNvBvBVayyfYSGvn9Ww6fyfbmmg8Ju,SpATywNh6bZuzm8s1ceuBUnMUAeoAHHw,1,0,0,0,0,0,1,0,1,0.14285714285714285,1,0.0,0,0,0,0,0,0,0,1,0,0,1,1
15407,143810,bACQsAWyyrjdiMPqSUjAzVKv7ajw33ro,SpATywNh6bZuzm8s1ceuBUnMUAeoAHHw,8,7,5,0,4,2,5,1,24,3.4285714285714284,1,0.0,0,5,0,4,7,2,0,5,1,9,15,1
15408,143814,65NT4Vy4CWsCo0yJt0Ser3pgvYWBcuzx,G8EPVSXsOYB5YQWZGiz1aVq5Pgr2GrQu,10,4,2,0,2,1,4,1,14,2.0,1,0.0,0,2,0,2,4,1,0,4,1,4,10,1
15409,143816,dmgKCClueSUfvNvbgn76P7yZNOrcqS51,SpATywNh6bZuzm8s1ceuBUnMUAeoAHHw,5,5,2,0,0,0,5,0,12,1.7142857142857142,1,0.0,0,2,0,0,5,0,0,5,0,2,10,1
15410,143826,vWKarVz9MLdkaeCnowC5zORVIjWhxnGT,A3fsA9Zfv1X2fVEQhTw51lKENdNrEqT3,41,17,11,56,8,1,10,1,104,14.857142857142858,1,0.0,4,11,49,8,13,1,7,10,1,72,32,1
15411,143827,icWbBG6yTFIZ32qTSFWaJeU4GOLom0j8,SpATywNh6bZuzm8s1ceuBUnMUAeoAHHw,12,12,8,0,3,6,12,2,43,6.142857142857143,2,0.0,0,8,0,3,12,6,0,12,2,11,32,1
15412,143828,e0M6WM1PijCu34LKse7mmvSD1YWuaWbQ,SpATywNh6bZuzm8s1ceuBUnMUAeoAHHw,13,10,1,5,1,1,6,1,25,3.5714285714285716,1,0.0,4,1,5,1,6,1,0,6,1,11,14,1
15413,143833,O8HOTucc0KEJXoqiM5XCMFFloSFDXkri,SpATywNh6bZuzm8s1ceuBUnMUAeoAHHw,10,8,3,0,2,0,6,0,19,2.7142857142857144,3,0.0,0,3,0,2,8,0,0,6,0,5,14,0
15414,143840,kuZwBvEdgeUtKZ495C2FptBbxEtLtmVH,bWdj2GDclj5ofokWjzoa5jAwMkxCykd6,6,14,5,0,1,0,6,0,26,3.7142857142857144,3,0.0,2,5,0,1,12,0,0,6,0,8,18,1
15415,143841,U9j28kbZjF4W0VB5A2yieyyacPtOxvwt,bWdj2GDclj5ofokWjzoa5jAwMkxCykd6,11,69,23,10,11,2,18,1,134,19.142857142857142,4,0.0,28,23,10,11,41,2,0,18,1,72,62,1
15416,143856,k5QrgarfuSQsGSVQQrcJTwJdAAKzf9gw,A3fsA9Zfv1X2fVEQhTw51lKENdNrEqT3,2,0,0,0,0,0,2,0,2,0.2857142857142857,1,0.0,0,0,0,0,0,0,0,2,0,0,2,1
15417,143858,uVezMKauDUYUFjTOlrwzQHcegaGFiPmr,A3fsA9Zfv1X2fVEQhTw51lKENdNrEqT3,35,26,2,62,2,0,10,0,102,14.571428571428571,2,0.0,1,2,58,2,25,0,4,10,0,63,39,1
15418,143860,kMzMJEHy7fAHiNUZU0um3I2BsPC7gMll,SpATywNh6bZuzm8s1ceuBUnMUAeoAHHw,1,0,0,0,0,0,2,0,2,0.2857142857142857,2,0.0,0,0,0,0,0,0,0,2,0,0,2,1
15419,143863,cQR8w7MfHX2zVKP2ObrWt7YmSX4BnmzU,SpATywNh6bZuzm8s1ceuBUnMUAeoAHHw,5,3,2,0,0,0,2,0,7,1.0,1,0.0,0,2,0,0,3,0,0,2,0,2,5,1
15420,143864,RCdcltNaQLfcoxT7YKTjQxAYUbCmzzKd,bWdj2GDclj5ofokWjzoa5jAwMkxCykd6,9,13,9,0,8,2,5,0,37,5.285714285714286,2,0.0,3,9,0,8,10,2,0,5,0,20,17,1
15421,143865,wovmcysU3CVvWe03Rf3D2PLI3no54RS2,SpATywNh6bZuzm8s1ceuBUnMUAeoAHHw,5,2,1,0,1,0,3,0,7,1.0,1,0.0,0,1,0,1,2,0,0,3,0,2,5,1
15422,143866,cQR8w7MfHX2zVKP2ObrWt7YmSX4BnmzU,bWdj2GDclj5ofokWjzoa5jAwMkxCykd6,1,0,0,0,0,0,1,0,1,0.14285714285714285,1,0.0,0,0,0,0,0,0,0,1,0,0,1,1
15423,143867,Pnezq6slEV4CIBxIFIPqhlGLNILa8T8M,SpATywNh6bZuzm8s1ceuBUnMUAeoAHHw,52,74,24,38,12,4,16,0,168,24.0,8,0.0,12,24,35,12,62,4,3,16,0,83,85,0
15424,143880,zAobqpIInEgToh5g3mHxVZCEkz5XFqde,SpATywNh6bZuzm8s1ceuBUnMUAeoAHHw,10,23,1,18,0,0,3,0,45,6.428571428571429,2,0.0,13,1,17,0,10,0,1,3,0,31,14,1
15425,143881,g5rASgrCPlNIsJec3wFullHkMrOBGptd,SpATywNh6bZuzm8s1ceuBUnMUAeoAHHw,10,7,5,4,4,0,2,0,22,3.142857142857143,1,0.0,0,5,3,4,7,0,1,2,0,12,10,1
15426,143887,SKJH5bhXUHUXBV3YRjTcw0Oe5kVFAmnw,SpATywNh6bZuzm8s1ceuBUnMUAeoAHHw,17,34,13,18,2,10,7,4,88,12.571428571428571,3,0.0,13,13,15,2,21,10,3,7,4,43,45,1
15427,143888,CdBS5mGJVzgaGDeY8NzEjALJKus99MGR,SpATywNh6bZuzm8s1ceuBUnMUAeoAHHw,21,44,13,16,6,8,16,0,103,14.714285714285714,4,0.0,6,13,14,6,38,8,2,16,0,39,64,1
15428,143891,UpT5KvhktZoGfL90nOmM9gx3GU38kT3j,bWdj2GDclj5ofokWjzoa5jAwMkxCykd6,17,14,1,38,3,11,16,1,84,12.0,4,0.0,5,1,33,3,9,11,5,16,1,42,42,0
15429,143897,BhOp2rSiJ2q2zT4ZZzNtPz6Fovfll5Yb,SpATywNh6bZuzm8s1ceuBUnMUAeoAHHw,13,12,7,1,3,0,8,2,33,4.714285714285714,4,0.0,2,7,1,3,10,0,0,8,2,13,20,1
15430,143900,NWUbBzN3rFqJYQQKuHujeEDgr8fxabPr,SpATywNh6bZuzm8s1ceuBUnMUAeoAHHw,37,67,11,69,4,42,17,0,210,30.0,9,0.0,18,11,56,4,49,42,13,17,0,89,121,0
15431,143901,mvgC6breSmhPTVyyPyUMeu7XoIQqVA6J,bWdj2GDclj5ofokWjzoa5jAwMkxCykd6,1,0,0,0,0,0,1,0,1,0.14285714285714285,1,0.0,0,0,0,0,0,0,0,1,0,0,1,1
15432,143902,qDW8D89X9oTRJFDDcQZTLb3PUIxnDi04,bWdj2GDclj5ofokWjzoa5jAwMkxCykd6,5,2,1,0,1,0,2,0,6,0.8571428571428571,1,0.0,0,1,0,1,2,0,0,2,0,2,4,1
15433,143908,nwFT4lnmg30fCvHRB6tbALo9FpcanuLx,SpATywNh6bZuzm8s1ceuBUnMUAeoAHHw,17,17,6,0,4,0,11,0,38,5.428571428571429,6,0.0,2,6,0,4,15,0,0,11,0,12,26,0
15434,143909,nwFT4lnmg30fCvHRB6tbALo9FpcanuLx,A3fsA9Zfv1X2fVEQhTw51lKENdNrEqT3,24,23,16,0,12,0,10,0,61,8.714285714285714,6,0.0,0,16,0,12,23,0,0,10,0,28,33,1
15435,143927,2WRiAgv5S6kcFPY2blVGjs9g0YNkJyLP,A3fsA9Zfv1X2fVEQhTw51lKENdNrEqT3,12,6,5,0,5,0,1,0,17,2.4285714285714284,1,0.0,0,5,0,5,6,0,0,1,0,10,7,1
15436,143933,Mi4V9PN04XHkOYjYbsNOyLc2HUiygd5R,SpATywNh6bZuzm8s1ceuBUnMUAeoAHHw,19,35,1,18,1,0,7,0,62,8.857142857142858,4,0.0,0,1,16,1,35,0,2,7,0,18,44,1
15437,143940,rMQIZQBxSTMFTRmvcfmpoYqCAUhMol3Y,A3fsA9Zfv1X2fVEQhTw51lKENdNrEqT3,11,11,2,0,2,0,3,0,18,2.5714285714285716,3,0.0,0,2,0,2,11,0,0,3,0,4,14,1
15438,143941,QZzKa5b6BbNwk1LIn6xlSQQLnIzRsZka,SpATywNh6bZuzm8s1ceuBUnMUAeoAHHw,13,15,0,16,0,2,14,3,50,7.142857142857143,3,0.0,2,0,14,0,13,2,2,14,3,16,34,1
15439,143945,U0EvfjsY5qqb8sRRReWuk6YqXYpCTRVc,SpATywNh6bZuzm8s1ceuBUnMUAeoAHHw,31,64,26,32,11,0,9,0,142,20.285714285714285,5,0.0,30,26,30,11,34,0,2,9,0,97,45,0
15440,143948,PM49kyPCpZaIfMyV0vVvEZLNApBiy9hl,G8EPVSXsOYB5YQWZGiz1aVq5Pgr2GrQu,18,16,11,22,3,4,29,7,92,13.142857142857142,2,0.0,0,11,17,3,16,4,5,29,7,31,61,0
15441,143956,BjRnjY2o7a3tMcpDhDIkBnAHWrC67ajb,bWdj2GDclj5ofokWjzoa5jAwMkxCykd6,11,13,1,30,4,0,1,0,49,7.0,1,0.0,8,1,28,4,5,0,2,1,0,41,8,1
15442,143959,qE4hwNlGPGhoA6O5q5uX2JQSuwb75VXN,SpATywNh6bZuzm8s1ceuBUnMUAeoAHHw,13,9,6,0,2,5,9,1,32,4.571428571428571,3,0.0,1,6,0,2,8,5,0,9,1,9,23,1
15443,143964,J4CQZgZBlOmytRfPs9vqhW9gDDIzfvcP,SpATywNh6bZuzm8s1ceuBUnMUAeoAHHw,14,14,8,9,5,0,2,0,38,5.428571428571429,2,0.0,4,8,9,5,10,0,0,2,0,26,12,1
15444,143970,yepbpI2oB7GcEIjPPhcQSpqMxzy4YG1o,A3fsA9Zfv1X2fVEQhTw51lKENdNrEqT3,17,16,11,0,9,0,3,0,39,5.571428571428571,2,0.0,0,11,0,9,16,0,0,3,0,20,19,1
15445,143971,nVB1o73xluQXZjoI2dUYHGxbCDG8qiCL,SpATywNh6bZuzm8s1ceuBUnMUAeoAHHw,11,16,11,0,6,18,15,0,66,9.428571428571429,5,0.0,0,11,0,6,16,18,0,15,0,17,49,0
15446,143981,sNbuAEBvvCL9s1FspvGXLJVjQkFzxwpw,A3fsA9Zfv1X2fVEQhTw51lKENdNrEqT3,2,0,0,0,0,0,3,0,3,0.42857142857142855,2,0.0,0,0,0,0,0,0,0,3,0,0,3,1
15447,143982,4GJSwwikGuUWXSajcKoSlvfsoiC8eEZq,SpATywNh6bZuzm8s1ceuBUnMUAeoAHHw,8,11,2,0,1,0,3,0,17,2.4285714285714284,2,0.0,3,2,0,1,8,0,0,3,0,6,11,1
15448,144006,BNzSA1bHraXMmngTyyc8aHsRdjDVh5h7,bWdj2GDclj5ofokWjzoa5jAwMkxCykd6,7,2,0,0,0,1,9,1,13,1.8571428571428572,2,0.0,0,0,0,0,2,1,0,9,1,0,13,1
15449,144007,jSNLRK8jxSbbcqhbWW7DXZqoGlvGgXDY,SpATywNh6bZuzm8s1ceuBUnMUAeoAHHw,17,48,6,10,0,8,12,0,84,12.0,7,0.0,8,6,9,0,40,8,1,12,0,23,61,0
15450,144009,xbYSqp0T7Uu69VoCNyfTCvQcS3HV3UeU,A3fsA9Zfv1X2fVEQhTw51lKENdNrEqT3,7,15,8,0,0,12,8,0,43,6.142857142857143,4,0.0,1,8,0,0,14,12,0,8,0,9,34,1
15451,144012,tShEWwQUmNvdJJLgb6IWQwSvspfEXM5K,A3fsA9Zfv1X2fVEQhTw51lKENdNrEqT3,4,2,1,0,1,0,1,0,5,0.7142857142857143,1,0.0,0,1,0,1,2,0,0,1,0,2,3,1
15452,144016,pV3LNiRBcnB0okGlxsutPlVeupVbHeL3,SpATywNh6bZuzm8s1ceuBUnMUAeoAHHw,6,3,2,0,1,0,2,0,8,1.1428571428571428,1,0.0,0,2,0,1,3,0,0,2,0,3,5,1
15453,144037,nCjvWGBuFy5INkXPz8A7SRdydYBldjvQ,SpATywNh6bZuzm8s1ceuBUnMUAeoAHHw,4,2,0,0,0,0,2,0,4,0.5714285714285714,1,0.0,0,0,0,0,2,0,0,2,0,0,4,1
15454,144041,oqyavd6F0mKguMPCfvp0hDFA1MAPWGfD,SpATywNh6bZuzm8s1ceuBUnMUAeoAHHw,16,21,10,17,7,0,2,0,57,8.142857142857142,3,0.0,8,10,14,7,13,0,3,2,0,39,18,0
15455,144045,X6wKs7o7iaOCvuOiKVJE8ObJhZymqim9,A3fsA9Zfv1X2fVEQhTw51lKENdNrEqT3,2,0,0,0,0,0,2,0,2,0.2857142857142857,1,0.0,0,0,0,0,0,0,0,2,0,0,2,1
15456,144054,3gXxAS6JQyT6kaPyX2q9IFEYv8Hv4qpf,SpATywNh6bZuzm8s1ceuBUnMUAeoAHHw,1,0,0,0,0,0,2,0,2,0.2857142857142857,1,0.0,0,0,0,0,0,0,0,2,0,0,2,1
15457,144058,JaYbgvhgx43SysY9J8DaCR3IcdUzCcUf,A3fsA9Zfv1X2fVEQhTw51lKENdNrEqT3,14,26,2,0,2,0,4,0,34,4.857142857142857,3,0.0,0,2,0,2,26,0,0,4,0,4,30,1
15458,144068,lWBDQVwIQrjtFGVOoBxPlW4CU3O2tpal,bWdj2GDclj5ofokWjzoa5jAwMkxCykd6,52,39,19,86,12,8,9,1,174,24.857142857142858,2,0.0,18,19,70,12,21,8,16,9,1,119,55,0
15459,144071,N3PF6286hfkTToYfzWd10OYG6jiYeyxL,A3fsA9Zfv1X2fVEQhTw51lKENdNrEqT3,34,20,10,76,6,2,8,0,122,17.428571428571427,3,0.0,4,10,65,6,16,2,11,8,0,85,37,1
15460,144073,J308vOrLkdYqLmDeq0FXdJXMsr1GuQ4w,SpATywNh6bZuzm8s1ceuBUnMUAeoAHHw,6,4,2,0,1,0,2,0,9,1.2857142857142858,1,0.0,0,2,0,1,4,0,0,2,0,3,6,1
15461,144076,M8cV3FHZsXmaSmJz43zOWXbhj6ecftQ6,A3fsA9Zfv1X2fVEQhTw51lKENdNrEqT3,1,0,0,0,0,0,1,0,1,0.14285714285714285,1,0.0,0,0,0,0,0,0,0,1,0,0,1,1
15462,144079,0MJO2AqnpIZ1IQnC9vPe2n4pS7b47XJt,bWdj2GDclj5ofokWjzoa5jAwMkxCykd6,5,10,8,0,6,0,2,0,26,3.7142857142857144,3,0.0,0,8,0,6,10,0,0,2,0,14,12,1
15463,144084,oM7kzBqhrhvKM9TULmlTbBtomZs2uMAz,bWdj2GDclj5ofokWjzoa5jAwMkxCykd6,7,7,1,0,1,0,3,0,12,1.7142857142857142,1,0.0,1,1,0,1,6,0,0,3,0,3,9,1
15464,144093,xOQ7AnZhBVXWatzUYsH22obdE4ihFc1J,bWdj2GDclj5ofokWjzoa5jAwMkxCykd6,6,12,5,0,2,0,5,0,24,3.4285714285714284,3,0.0,4,5,0,2,8,0,0,5,0,11,13,1
15465,144104,8wj2Kr145taRtViYKZRdPMwAZeP9BDRs,A3fsA9Zfv1X2fVEQhTw51lKENdNrEqT3,17,61,3,0,3,0,8,0,75,10.714285714285714,3,0.0,0,3,0,3,61,0,0,8,0,6,69,1
15466,144107,QR8UITZg856bsXeO3qqb9HBw7LvT4WYt,G8EPVSXsOYB5YQWZGiz1aVq5Pgr2GrQu,14,15,2,6,2,1,7,1,34,4.857142857142857,1,0.0,6,2,5,2,9,1,1,7,1,15,19,1
15467,144112,A41hdT15T7mumzDW53QCDXRUsOilvTI0,A3fsA9Zfv1X2fVEQhTw51lKENdNrEqT3,11,15,8,0,5,0,7,0,35,5.0,4,0.0,0,8,0,5,15,0,0,7,0,13,22,0
15468,144120,rqoGLMWp7ee8Ppu4OdHSBl6vmRxDZvKU,A3fsA9Zfv1X2fVEQhTw51lKENdNrEqT3,7,8,2,0,2,0,1,0,13,1.8571428571428572,2,0.0,0,2,0,2,8,0,0,1,0,4,9,1
15469,144140,5F9PaqbFd1lCE07rWZ8QBm5IEOOVBjgP,G8EPVSXsOYB5YQWZGiz1aVq5Pgr2GrQu,48,16,13,96,10,0,5,0,140,20.0,1,0.0,1,13,75,10,15,0,21,5,0,99,41,1
15470,144144,IXIS4Shtcigf6RcvylwWobSKfmofV0Nt,SpATywNh6bZuzm8s1ceuBUnMUAeoAHHw,6,6,3,0,1,0,3,0,13,1.8571428571428572,2,0.0,0,3,0,1,6,0,0,3,0,4,9,1
15471,144158,LfOTQoQ2fSLvFDTNyvPm8DKwqfdrfE91,SpATywNh6bZuzm8s1ceuBUnMUAeoAHHw,17,20,10,6,5,0,4,1,46,6.571428571428571,1,0.0,8,10,6,5,12,0,0,4,1,29,17,1
15472,144159,vSPx0Rg8IfOWpaATb7kkPj0mZPaLkdwk,A3fsA9Zfv1X2fVEQhTw51lKENdNrEqT3,7,7,0,0,0,0,5,0,12,1.7142857142857142,1,0.0,0,0,0,0,7,0,0,5,0,0,12,1
15473,144162,vSPx0Rg8IfOWpaATb7kkPj0mZPaLkdwk,bWdj2GDclj5ofokWjzoa5jAwMkxCykd6,6,6,2,0,3,0,2,0,13,1.8571428571428572,1,0.0,2,2,0,3,4,0,0,2,0,7,6,1
15474,144163,Mi04UWZgqcHrMSZckQSYxOftI8OPYCzT,G8EPVSXsOYB5YQWZGiz1aVq5Pgr2GrQu,71,33,2,260,2,6,14,0,317,45.285714285714285,2,0.0,6,2,222,2,27,6,38,14,0,232,85,0
15475,144168,TTLR6K3ZlbSrGOfX2kjd2U4ChldGiopU,A3fsA9Zfv1X2fVEQhTw51lKENdNrEqT3,9,25,0,0,0,0,4,0,29,4.142857142857143,2,0.0,1,0,0,0,24,0,0,4,0,1,28,1
15476,144172,mSs5bB1Rxg3xYWjWjJY9pVTt7WAiMgyu,G8EPVSXsOYB5YQWZGiz1aVq5Pgr2GrQu,1,0,0,0,0,0,3,0,3,0.42857142857142855,2,0.0,0,0,0,0,0,0,0,3,0,0,3,0
15477,144173,mSs5bB1Rxg3xYWjWjJY9pVTt7WAiMgyu,A3fsA9Zfv1X2fVEQhTw51lKENdNrEqT3,9,6,4,0,2,2,12,0,26,3.7142857142857144,2,0.0,0,4,0,2,6,2,0,12,0,6,20,0
15478,144177,vang2CBp79w46FuP8PHdcPzohOKhBOq7,SpATywNh6bZuzm8s1ceuBUnMUAeoAHHw,8,3,2,0,2,0,3,0,10,1.4285714285714286,2,0.0,0,2,0,2,3,0,0,3,0,4,6,1
15479,144182,vaHtIA00RCulwKK7VIyzWyzyLmevfcyF,RXDvfPUBYFlVdlueBFbLW0mhhAyGEqpt,1,0,0,0,0,0,1,0,1,0.14285714285714285,1,0.0,0,0,0,0,0,0,0,1,0,0,1,1
15480,144190,lxaN8cMu58kiTAIgLqzjn8LLROF5HL13,SpATywNh6bZuzm8s1ceuBUnMUAeoAHHw,1,0,0,0,0,0,2,0,2,0.2857142857142857,2,0.0,0,0,0,0,0,0,0,2,0,0,2,1
15481,144195,TLRNemgJ2qb9k6dqDLHmoeJOx0QEylHX,A3fsA9Zfv1X2fVEQhTw51lKENdNrEqT3,7,3,2,0,2,0,4,0,11,1.5714285714285714,1,0.0,0,2,0,2,3,0,0,4,0,4,7,1
15482,144201,qz846pl1l6yGERGHSFYtB9X4bZxpZ3Ym,SpATywNh6bZuzm8s1ceuBUnMUAeoAHHw,4,2,1,0,1,0,1,0,5,0.7142857142857143,1,0.0,0,1,0,1,2,0,0,1,0,2,3,1
15483,144203,Dd8BaN0Npmwg2omUrerhRcBJi9Zv0QF5,G8EPVSXsOYB5YQWZGiz1aVq5Pgr2GrQu,22,27,16,34,8,1,16,1,103,14.714285714285714,3,0.0,0,16,30,8,27,1,4,16,1,54,49,0
15484,144208,7fciuEa5Xf2g36Xi6ZmKVyrNCJiVORwj,G8EPVSXsOYB5YQWZGiz1aVq5Pgr2GrQu,1,0,0,0,0,0,1,0,1,0.14285714285714285,1,0.0,0,0,0,0,0,0,0,1,0,0,1,1
15485,144209,7fciuEa5Xf2g36Xi6ZmKVyrNCJiVORwj,RXDvfPUBYFlVdlueBFbLW0mhhAyGEqpt,1,0,0,0,0,0,1,0,1,0.14285714285714285,1,0.0,0,0,0,0,0,0,0,1,0,0,1,1
15486,144212,vIAdh2clW8FkvdVniXHQiMyPfgIo07gQ,SpATywNh6bZuzm8s1ceuBUnMUAeoAHHw,4,0,0,0,0,0,3,1,4,0.5714285714285714,1,0.0,0,0,0,0,0,0,0,3,1,0,4,1
15487,144213,P89UxuMs18mdXj4DGhJJSZRF8BUJV2uZ,A3fsA9Zfv1X2fVEQhTw51lKENdNrEqT3,34,13,11,40,10,0,4,0,78,11.142857142857142,2,0.0,1,11,36,10,12,0,4,4,0,58,20,1
15488,144222,s2jX5TZHNhVfY48YU4SNM5eF0Y5PZev6,SpATywNh6bZuzm8s1ceuBUnMUAeoAHHw,5,2,1,0,1,0,2,0,6,0.8571428571428571,1,0.0,0,1,0,1,2,0,0,2,0,2,4,1
15489,144223,lnkkWGyIr1b44KiKgAFL6qVeebRfNJt3,SpATywNh6bZuzm8s1ceuBUnMUAeoAHHw,5,2,1,0,1,0,3,0,7,1.0,2,0.0,0,1,0,1,2,0,0,3,0,2,5,1
15490,144237,YCrhaujUJb2ysdJEAlnTFggfP634EwtZ,bWdj2GDclj5ofokWjzoa5jAwMkxCykd6,1,0,0,0,0,0,1,0,1,0.14285714285714285,1,0.0,0,0,0,0,0,0,0,1,0,0,1,1
15491,144240,BPLF5bOPHidVrP3JGHCr9npCCCPEhz1g,SpATywNh6bZuzm8s1ceuBUnMUAeoAHHw,29,61,22,32,10,6,20,2,153,21.857142857142858,4,0.0,31,22,30,10,30,6,2,20,2,93,60,1
15492,144244,y3GJh8xEC6iboTvFOS91chZLMqYyEapH,G8EPVSXsOYB5YQWZGiz1aVq5Pgr2GrQu,22,35,4,0,4,1,9,2,55,7.857142857142857,4,0.0,7,4,0,4,28,1,0,9,2,15,40,1
15493,144259,PGj1B7s4Yw1PBLMA6crSiWk0Zk66XU5n,SpATywNh6bZuzm8s1ceuBUnMUAeoAHHw,1,0,0,0,0,0,1,0,1,0.14285714285714285,1,0.0,0,0,0,0,0,0,0,1,0,0,1,1
15494,144260,NxRna5VYeAvwKdtdFMhqdPkmD703DSHi,SpATywNh6bZuzm8s1ceuBUnMUAeoAHHw,17,40,19,18,7,13,15,0,112,16.0,5,0.0,10,19,16,7,30,13,2,15,0,52,60,1
15495,144290,QX3ApvDJvO9Hor69Bz89tLVK3rkHTGIJ,SpATywNh6bZuzm8s1ceuBUnMUAeoAHHw,2,0,0,0,0,0,2,0,2,0.2857142857142857,1,0.0,0,0,0,0,0,0,0,2,0,0,2,1
15496,144292,ObRNFdACerskEaO6OwPXBsUqKEYRJtIa,SpATywNh6bZuzm8s1ceuBUnMUAeoAHHw,7,3,2,0,2,0,2,0,9,1.2857142857142858,1,0.0,0,2,0,2,3,0,0,2,0,4,5,1
15497,144302,pWZNevyPOl4ouTcnYPIT4PYWT7cW7Aq7,SpATywNh6bZuzm8s1ceuBUnMUAeoAHHw,1,0,0,0,0,0,1,0,1,0.14285714285714285,1,0.0,0,0,0,0,0,0,0,1,0,0,1,1
15498,144315,8lCrBaMkcXk8KsL7M8AYgjnsyFuSP4yK,A3fsA9Zfv1X2fVEQhTw51lKENdNrEqT3,18,18,16,0,16,0,1,0,51,7.285714285714286,1,0.0,0,16,0,16,18,0,0,1,0,32,19,1
15499,144325,IKQYwh1PoPanPyuEqIIRzDtzc0tOUD2x,SpATywNh6bZuzm8s1ceuBUnMUAeoAHHw,36,55,6,43,2,1,23,1,131,18.714285714285715,8,0.0,15,6,40,2,40,1,3,23,1,63,68,0
15500,144327,SKemaavr5OG5spO92jXls0zhTMuWKDja,A3fsA9Zfv1X2fVEQhTw51lKENdNrEqT3,61,57,31,118,13,0,9,2,230,32.857142857142854,5,0.0,4,31,107,13,53,0,11,9,2,155,75,1
15501,144331,G4MfAXnz0EbVaCbavnksnUIxHSPSMOp9,SpATywNh6bZuzm8s1ceuBUnMUAeoAHHw,7,7,1,0,1,0,2,0,11,1.5714285714285714,2,0.0,0,1,0,1,7,0,0,2,0,2,9,0
15502,144349,0Xxh6UWDrWwPPLaMpUv0ZEdnE00mPUSR,A3fsA9Zfv1X2fVEQhTw51lKENdNrEqT3,16,12,5,0,3,1,10,1,32,4.571428571428571,3,0.0,0,5,0,3,12,1,0,10,1,8,24,0
15503,144357,Ie7mkAUCVVaLYxvosre748ADQJqirOJg,SpATywNh6bZuzm8s1ceuBUnMUAeoAHHw,8,6,2,0,2,0,4,0,14,2.0,2,0.0,0,2,0,2,6,0,0,4,0,4,10,1
15504,144363,svmQRfMWV47ki33Dy8s4c1zTDx5xyqqy,SpATywNh6bZuzm8s1ceuBUnMUAeoAHHw,22,27,0,29,0,1,5,0,62,8.857142857142858,2,0.0,9,0,26,0,18,1,3,5,0,35,27,1
15505,144370,BdodnRCsey53xS6PtugKwlzojwI7pwLX,bWdj2GDclj5ofokWjzoa5jAwMkxCykd6,6,5,3,0,2,0,3,0,13,1.8571428571428572,2,0.0,0,3,0,2,5,0,0,3,0,5,8,0
15506,144381,fcKXv9ZhNMmLocipK5ZZiRQ1LDYoPfgB,G8EPVSXsOYB5YQWZGiz1aVq5Pgr2GrQu,10,5,4,0,4,0,3,1,17,2.4285714285714284,2,0.0,0,4,0,4,5,0,0,3,1,8,9,1
15507,144387,sxauqKQQUFpXy4JZb43frlkE4bOqyCWY,G8EPVSXsOYB5YQWZGiz1aVq5Pgr2GrQu,9,5,3,0,2,0,8,0,18,2.5714285714285716,1,0.0,0,3,0,2,5,0,0,8,0,5,13,1
15508,144395,o8axHOLhofevJLu5TvKmRFieQionk0uo,bWdj2GDclj5ofokWjzoa5jAwMkxCykd6,6,10,1,0,2,0,3,0,16,2.2857142857142856,2,0.0,0,1,0,2,10,0,0,3,0,3,13,1
15509,144401,4xrSOv0Zb9s9Mfulum5aoHlVB6c6SKgp,RXDvfPUBYFlVdlueBFbLW0mhhAyGEqpt,24,21,6,37,9,5,13,5,96,13.714285714285714,3,0.0,9,6,32,9,12,5,5,13,5,56,40,1
15510,144405,m0LuTHIjrSW3BF8YSCNgkHg0UqSBwWqE,bWdj2GDclj5ofokWjzoa5jAwMkxCykd6,7,23,6,0,5,0,7,0,41,5.857142857142857,3,0.0,6,6,0,5,17,0,0,7,0,17,24,1
15511,144413,SG7N8DhpCuhIu06IIzLX0CSolbyIDsIx,bWdj2GDclj5ofokWjzoa5jAwMkxCykd6,11,11,5,0,2,1,10,1,30,4.285714285714286,4,0.0,1,5,0,2,10,1,0,10,1,8,22,1
15512,144415,6ElmeAobgOVWMQKbfyTe96fhVbG33C2X,SpATywNh6bZuzm8s1ceuBUnMUAeoAHHw,5,2,1,0,1,0,3,0,7,1.0,3,0.0,0,1,0,1,2,0,0,3,0,2,5,1
15513,144420,yntRyPnV06sPev3xKXJHMzKiUHpX97Sd,bWdj2GDclj5ofokWjzoa5jAwMkxCykd6,4,3,1,0,0,0,4,0,8,1.1428571428571428,1,0.0,0,1,0,0,3,0,0,4,0,1,7,1
15514,144425,cDfX3cMJgUCBkullLQDAvI97VlFeM2Mm,SpATywNh6bZuzm8s1ceuBUnMUAeoAHHw,1,0,0,0,0,0,2,0,2,0.2857142857142857,2,0.0,0,0,0,0,0,0,0,2,0,0,2,1
15515,144427,tVItbLut2hv4GIKzxM0DVZ7s3PzDPaT6,A3fsA9Zfv1X2fVEQhTw51lKENdNrEqT3,1,0,0,0,0,0,1,0,1,0.14285714285714285,1,0.0,0,0,0,0,0,0,0,1,0,0,1,1
15516,144430,04LxEQ3nhSzj7dXc7lrpbpcFvVUWGlZI,SpATywNh6bZuzm8s1ceuBUnMUAeoAHHw,16,17,9,18,4,4,10,1,63,9.0,2,0.0,4,9,15,4,13,4,3,10,1,32,31,0
15517,144435,v8vHTBb2c8b6hXbbCm3oZZxhG00wE2vP,SpATywNh6bZuzm8s1ceuBUnMUAeoAHHw,14,14,0,15,0,0,8,0,37,5.285714285714286,2,0.0,5,0,14,0,9,0,1,8,0,19,18,1
15518,144441,SSjG9q1bzvgdf9EkFqx8YjsCqQBg1XFt,A3fsA9Zfv1X2fVEQhTw51lKENdNrEqT3,21,12,9,0,7,0,8,1,37,5.285714285714286,2,0.0,0,9,0,7,12,0,0,8,1,16,21,0
15519,144464,lZNtuG4kxIFp0PJuciNw1EckZr8BFEk1,G8EPVSXsOYB5YQWZGiz1aVq5Pgr2GrQu,9,8,3,0,3,0,2,0,16,2.2857142857142856,1,0.0,4,3,0,3,4,0,0,2,0,10,6,1
15520,144468,mU6A1Eh1Sbu4ybvtOk62E6H19PAtCNgh,SpATywNh6bZuzm8s1ceuBUnMUAeoAHHw,29,40,22,31,8,4,23,2,130,18.571428571428573,6,0.0,8,22,25,8,32,4,6,23,2,63,67,1
15521,144470,3DA03ejzzYcn7ZLRW08jG2ITijpoufwN,G8EPVSXsOYB5YQWZGiz1aVq5Pgr2GrQu,12,17,1,6,1,0,4,1,30,4.285714285714286,1,0.0,7,1,3,1,10,0,3,4,1,12,18,1
15522,144475,JyrEAC8QBM1FImevyuACZ1OHrDsTde69,G8EPVSXsOYB5YQWZGiz1aVq5Pgr2GrQu,5,3,1,0,1,0,1,0,6,0.8571428571428571,1,0.0,0,1,0,1,3,0,0,1,0,2,4,1
15523,144476,uCAoWg5FaKwY0ioNKZmmoCVVstQhRxsa,SpATywNh6bZuzm8s1ceuBUnMUAeoAHHw,6,2,1,0,1,2,6,2,14,2.0,1,0.0,0,1,0,1,2,2,0,6,2,2,12,1
15524,144477,Lrv4yyy1oRPtpNW8S56NcLTs3dActQgc,SpATywNh6bZuzm8s1ceuBUnMUAeoAHHw,10,3,2,0,2,14,5,4,30,4.285714285714286,1,0.0,0,2,0,2,3,14,0,5,4,4,26,1
15525,144479,85biSqbQ9pgTGTSoZq3mDHUWbBBUYgJi,SpATywNh6bZuzm8s1ceuBUnMUAeoAHHw,20,29,18,12,13,5,8,0,85,12.142857142857142,3,0.0,8,18,11,13,21,5,1,8,0,50,35,0
15526,144491,liAQef8wjw79hEo9eOQyUXxysuTaQycU,A3fsA9Zfv1X2fVEQhTw51lKENdNrEqT3,2,0,0,0,0,0,2,0,2,0.2857142857142857,1,0.0,0,0,0,0,0,0,0,2,0,0,2,1
15527,144501,rFLQgLWbBhSut44kCW6TkgnVsL5AzEC5,SpATywNh6bZuzm8s1ceuBUnMUAeoAHHw,11,9,3,0,3,0,2,0,17,2.4285714285714284,2,0.0,0,3,0,3,9,0,0,2,0,6,11,1
15528,144506,bEN4cDdCBNI6z1gBK5oUDg5Tkh0maAFl,SpATywNh6bZuzm8s1ceuBUnMUAeoAHHw,9,6,5,0,3,0,2,0,16,2.2857142857142856,1,0.0,0,5,0,3,6,0,0,2,0,8,8,1
15529,144513,CDMI3gQZrAOAZ9Cf4jB5NzA4daPYwjjn,SpATywNh6bZuzm8s1ceuBUnMUAeoAHHw,1,0,0,0,0,0,1,0,1,0.14285714285714285,1,0.0,0,0,0,0,0,0,0,1,0,0,1,1
15530,144521,uCAoWg5FaKwY0ioNKZmmoCVVstQhRxsa,G8EPVSXsOYB5YQWZGiz1aVq5Pgr2GrQu,2,0,0,0,0,0,2,0,2,0.2857142857142857,1,0.0,0,0,0,0,0,0,0,2,0,0,2,1
15531,144526,9lksmcPg7FQE2FGQIA9VvWum1Z9DYrHM,G8EPVSXsOYB5YQWZGiz1aVq5Pgr2GrQu,1,0,0,0,0,0,1,0,1,0.14285714285714285,1,0.0,0,0,0,0,0,0,0,1,0,0,1,1
15532,144527,V76hQrNxMwZx40IX3yjuclMj7tgBsXTX,G8EPVSXsOYB5YQWZGiz1aVq5Pgr2GrQu,2,0,0,0,0,0,2,0,2,0.2857142857142857,1,0.0,0,0,0,0,0,0,0,2,0,0,2,1
15533,144536,393Iwr9LCShShn3ZP9MDE1iyGNI2KLnH,A3fsA9Zfv1X2fVEQhTw51lKENdNrEqT3,13,7,4,0,3,0,6,1,21,3.0,1,0.0,0,4,0,3,7,0,0,6,1,7,14,1
15534,144568,oBzLCci1yorqxivOBJW1dKnQofqyR5pw,A3fsA9Zfv1X2fVEQhTw51lKENdNrEqT3,2,0,0,0,0,0,2,0,2,0.2857142857142857,1,0.0,0,0,0,0,0,0,0,2,0,0,2,1
15535,144578,OUsTbnD6QZatQvggR5YjMxWOH6TYQEkw,SpATywNh6bZuzm8s1ceuBUnMUAeoAHHw,11,11,5,0,5,1,7,2,31,4.428571428571429,5,0.0,0,5,0,5,11,1,0,7,2,10,21,1
15536,144590,aiKrSmMzCgtO0agHJchvzxr28vyUxQZz,G8EPVSXsOYB5YQWZGiz1aVq5Pgr2GrQu,8,3,2,0,2,0,3,1,11,1.5714285714285714,1,0.0,0,2,0,2,3,0,0,3,1,4,7,1
15537,144593,K938KGiMd2B4Ec49syEZjpINF1qucFfC,A3fsA9Zfv1X2fVEQhTw51lKENdNrEqT3,6,3,2,0,2,0,2,0,9,1.2857142857142858,1,0.0,0,2,0,2,3,0,0,2,0,4,5,1
15538,144599,KkSinTdG2PbGrJIRATMZos8HES46UawO,SpATywNh6bZuzm8s1ceuBUnMUAeoAHHw,5,3,1,0,1,0,2,0,7,1.0,2,0.0,0,1,0,1,3,0,0,2,0,2,5,1
15539,144600,9loONblFsvKeToe2mgBZCeASeNdXOJTu,A3fsA9Zfv1X2fVEQhTw51lKENdNrEqT3,1,0,0,0,0,0,1,0,1,0.14285714285714285,1,0.0,0,0,0,0,0,0,0,1,0,0,1,1
15540,144604,5ehf4EFN8WhDbvmb2WvfZwpaBD0cj1oj,A3fsA9Zfv1X2fVEQhTw51lKENdNrEqT3,72,33,4,158,2,0,10,0,207,29.571428571428573,3,0.0,8,4,156,2,25,0,2,10,0,170,37,1
15541,144606,AeCrxYByugIwu4XUBpI0LhoTguBozLAa,SpATywNh6bZuzm8s1ceuBUnMUAeoAHHw,18,36,17,15,9,1,19,1,98,14.0,3,0.0,3,17,14,9,33,1,1,19,1,43,55,1
15542,144610,6oCDtYWE1YbVTX7pVBS5Cflb4KyRNNI9,bWdj2GDclj5ofokWjzoa5jAwMkxCykd6,7,2,0,0,0,1,7,1,11,1.5714285714285714,1,0.0,0,0,0,0,2,1,0,7,1,0,11,1
15543,144633,qpV3C2IZjB1ICwVxeuRFosLbHBid3MJt,A3fsA9Zfv1X2fVEQhTw51lKENdNrEqT3,22,14,10,0,8,1,6,1,40,5.714285714285714,1,0.0,2,10,0,8,12,1,0,6,1,20,20,1
15544,144638,PUdcV8hfT4fAKFK5ZdHY1Ahxf6WKmDC8,A3fsA9Zfv1X2fVEQhTw51lKENdNrEqT3,6,5,2,0,2,0,1,0,10,1.4285714285714286,1,0.0,0,2,0,2,5,0,0,1,0,4,6,1
15545,144639,VY7imgBCSjRZotznUQIcU9HEMteCD7Vu,SpATywNh6bZuzm8s1ceuBUnMUAeoAHHw,8,3,1,0,1,1,5,0,11,1.5714285714285714,2,0.0,0,1,0,1,3,1,0,5,0,2,9,1
15546,144642,9qlyY7aaGl7nuKeZpypgQ9ZpHmFszatV,A3fsA9Zfv1X2fVEQhTw51lKENdNrEqT3,50,32,23,62,18,1,15,1,152,21.714285714285715,3,0.0,3,23,53,18,29,1,9,15,1,97,55,1
15547,144648,2LaA70mUgBYc8D3OKr2EYK4J2QrpGRxB,A3fsA9Zfv1X2fVEQhTw51lKENdNrEqT3,30,9,6,54,4,0,4,0,77,11.0,2,0.0,2,6,48,4,7,0,6,4,0,60,17,1
15548,144650,nv8B6ZD44hAnu4T6PFDyOO5rZhYIZjTq,SpATywNh6bZuzm8s1ceuBUnMUAeoAHHw,8,10,2,0,2,0,6,0,20,2.857142857142857,3,0.0,0,2,0,2,10,0,0,6,0,4,16,1
15549,144659,ObnmYfTIiUEvUBHUZwAwe98p78F42lKP,SpATywNh6bZuzm8s1ceuBUnMUAeoAHHw,11,23,1,17,0,0,1,0,42,6.0,1,0.0,13,1,15,0,10,0,2,1,0,29,13,0
15550,144661,K1P5HkkD06S9UwpMzKhPLUcedpL6qD5q,G8EPVSXsOYB5YQWZGiz1aVq5Pgr2GrQu,1,0,0,0,0,0,1,0,1,0.14285714285714285,1,0.0,0,0,0,0,0,0,0,1,0,0,1,1
15551,144664,ZZTvad4Qf03uG7FsvH1m57TKBNy8UI9m,SpATywNh6bZuzm8s1ceuBUnMUAeoAHHw,6,5,2,0,1,0,5,0,13,1.8571428571428572,2,0.0,2,2,0,1,3,0,0,5,0,5,8,1
15552,144667,uk1SKekwkpaHXYRLjN8ZintRuJ2tncOb,SpATywNh6bZuzm8s1ceuBUnMUAeoAHHw,54,84,30,22,22,0,6,0,164,23.428571428571427,5,0.0,19,30,22,22,65,0,0,6,0,93,71,0
15553,144669,IX7RiRPOSUbuV2fcXoS0ynYb5Bmt0H4j,G8EPVSXsOYB5YQWZGiz1aVq5Pgr2GrQu,13,8,2,16,2,2,6,1,37,5.285714285714286,1,0.0,5,2,13,2,3,2,3,6,1,22,15,0
15554,144671,2LaA70mUgBYc8D3OKr2EYK4J2QrpGRxB,bWdj2GDclj5ofokWjzoa5jAwMkxCykd6,8,5,3,0,2,0,8,0,18,2.5714285714285716,2,0.0,0,3,0,2,5,0,0,8,0,5,13,1
15555,144683,qpL2vcjziNlnSRSNpZZmRQfFObDSNaQD,A3fsA9Zfv1X2fVEQhTw51lKENdNrEqT3,2,0,0,0,0,0,2,0,2,0.2857142857142857,1,0.0,0,0,0,0,0,0,0,2,0,0,2,1
15556,144686,mp93D5T5EosRPeX8VQcgmycIpnu3UAVQ,SpATywNh6bZuzm8s1ceuBUnMUAeoAHHw,10,6,4,0,3,0,3,0,16,2.2857142857142856,1,0.0,0,4,0,3,6,0,0,3,0,7,9,1
15557,144695,BWZzwZgEWlPhZ8O1NZ0qWUnIi8M3MM7E,RXDvfPUBYFlVdlueBFbLW0mhhAyGEqpt,2,0,0,0,0,0,2,0,2,0.2857142857142857,1,0.0,0,0,0,0,0,0,0,2,0,0,2,1
15558,144700,SgWqRh3XmeJpz6RfUb8yXu2ZkH0AleuJ,A3fsA9Zfv1X2fVEQhTw51lKENdNrEqT3,1,0,0,0,0,0,1,0,1,0.14285714285714285,1,0.0,0,0,0,0,0,0,0,1,0,0,1,1
15559,144702,Edq6Echk8wEs8ShX5RBw5c8Yx8ANHVje,SpATywNh6bZuzm8s1ceuBUnMUAeoAHHw,4,2,0,0,0,0,3,0,5,0.7142857142857143,2,0.0,0,0,0,0,2,0,0,3,0,0,5,1
15560,144703,Edq6Echk8wEs8ShX5RBw5c8Yx8ANHVje,A3fsA9Zfv1X2fVEQhTw51lKENdNrEqT3,6,8,3,0,0,0,5,0,16,2.2857142857142856,3,0.0,0,3,0,0,8,0,0,5,0,3,13,1
15561,144708,Edq6Echk8wEs8ShX5RBw5c8Yx8ANHVje,G8EPVSXsOYB5YQWZGiz1aVq5Pgr2GrQu,5,2,1,0,1,0,3,0,7,1.0,2,0.0,0,1,0,1,2,0,0,3,0,2,5,1
15562,144709,Edq6Echk8wEs8ShX5RBw5c8Yx8ANHVje,RXDvfPUBYFlVdlueBFbLW0mhhAyGEqpt,9,12,5,0,0,0,8,1,26,3.7142857142857144,4,0.0,0,5,0,0,12,0,0,8,1,5,21,1
15563,144711,5W6zUlMsjNEU65Ree05lYmcDiOLewtR2,A3fsA9Zfv1X2fVEQhTw51lKENdNrEqT3,13,14,0,0,0,0,4,0,18,2.5714285714285716,2,0.0,0,0,0,0,14,0,0,4,0,0,18,1
15564,144722,0PHNMn5JYsQigYaNxUJgIv4qow2cWlQK,A3fsA9Zfv1X2fVEQhTw51lKENdNrEqT3,2,0,0,0,0,0,2,0,2,0.2857142857142857,1,0.0,0,0,0,0,0,0,0,2,0,0,2,1
15565,144723,TkLeStjoXAMG5nRKUJ5tMauLM6wlBb8U,SpATywNh6bZuzm8s1ceuBUnMUAeoAHHw,16,13,5,16,3,0,4,0,41,5.857142857142857,1,0.0,6,5,14,3,7,0,2,4,0,28,13,1
15566,144729,Myt16IMVzxwRTOZLb6UMMq0vewiso7Vm,SpATywNh6bZuzm8s1ceuBUnMUAeoAHHw,15,27,1,12,1,8,9,2,60,8.571428571428571,3,0.0,15,1,9,1,12,8,3,9,2,26,34,1
15567,144733,X7TtqcEziDolV47iXb7vXuzoIflttREX,A3fsA9Zfv1X2fVEQhTw51lKENdNrEqT3,2,0,0,0,0,0,2,0,2,0.2857142857142857,1,0.0,0,0,0,0,0,0,0,2,0,0,2,1
15568,144739,i3sBPnecqsJtCmiHMtv0ri41qFT4LGFd,SpATywNh6bZuzm8s1ceuBUnMUAeoAHHw,1,0,0,0,0,0,1,0,1,0.14285714285714285,1,0.0,0,0,0,0,0,0,0,1,0,0,1,1
15569,144750,CWRrmCimMLwDXZTgPsiO3B49woTmmP7J,SpATywNh6bZuzm8s1ceuBUnMUAeoAHHw,4,3,0,0,0,0,2,0,5,0.7142857142857143,1,0.0,0,0,0,0,3,0,0,2,0,0,5,1
15570,144755,0eMlSFoZScU7zUCIgAM0BWfQh50FQz3i,RXDvfPUBYFlVdlueBFbLW0mhhAyGEqpt,22,18,15,10,9,1,2,0,55,7.857142857142857,3,0.0,1,15,8,9,17,1,2,2,0,33,22,1
15571,144758,iEsrSdCjyin4iFARTXOj17FWObSkkW7Y,A3fsA9Zfv1X2fVEQhTw51lKENdNrEqT3,10,10,0,0,0,0,7,0,17,2.4285714285714284,2,0.0,0,0,0,0,10,0,0,7,0,0,17,1
15572,144761,0xrj8jMy7DRmz2206OV6CH0SXBZh0mT4,SpATywNh6bZuzm8s1ceuBUnMUAeoAHHw,7,3,2,0,2,0,2,0,9,1.2857142857142858,1,0.0,0,2,0,2,3,0,0,2,0,4,5,1
15573,144772,yB2j2tPO2DVKCBBdsLv8a1lbHtfWINMh,A3fsA9Zfv1X2fVEQhTw51lKENdNrEqT3,29,29,23,0,18,0,8,0,78,11.142857142857142,6,0.0,0,23,0,18,29,0,0,8,0,41,37,0
15574,144775,WQI2O3Oijx2QlB8hE2TltFPDzjM5E22B,A3fsA9Zfv1X2fVEQhTw51lKENdNrEqT3,1,0,0,0,0,0,1,0,1,0.14285714285714285,1,0.0,0,0,0,0,0,0,0,1,0,0,1,1
15575,144776,jOKGDo32k5y1tQ1HBtDhmlq3GlvnMuW4,RXDvfPUBYFlVdlueBFbLW0mhhAyGEqpt,5,2,1,0,1,0,2,0,6,0.8571428571428571,1,0.0,0,1,0,1,2,0,0,2,0,2,4,1
15576,144791,qhMicTW8kXbgpTyOx2V27yOmKQOouISe,SpATywNh6bZuzm8s1ceuBUnMUAeoAHHw,17,19,8,19,3,5,7,1,62,8.857142857142858,2,0.0,8,8,16,3,11,5,3,7,1,35,27,1
15577,144792,PbpiZjozcQl91esiggJPwCEQesHzXMge,SpATywNh6bZuzm8s1ceuBUnMUAeoAHHw,4,2,0,0,0,0,3,0,5,0.7142857142857143,1,0.0,0,0,0,0,2,0,0,3,0,0,5,1
15578,144793,Q4yECXO7W1LpqtiMAu4zBn3zpNL7asTt,RXDvfPUBYFlVdlueBFbLW0mhhAyGEqpt,54,61,9,83,7,5,18,3,186,26.571428571428573,11,0.0,10,9,78,7,51,5,5,18,3,104,82,1
15579,144807,jOmJWWKjeEAibobmUGCNZpRQTVi2zu3q,SpATywNh6bZuzm8s1ceuBUnMUAeoAHHw,5,2,1,0,1,0,3,0,7,1.0,1,0.0,0,1,0,1,2,0,0,3,0,2,5,1
15580,144812,2plfHoT1TmtCwY9OYRzSThXWtZ22ORll,SpATywNh6bZuzm8s1ceuBUnMUAeoAHHw,4,3,1,0,1,0,1,0,6,0.8571428571428571,1,0.0,0,1,0,1,3,0,0,1,0,2,4,1
15581,144816,kQbCL3ZvWis8hkLoQgkRd3flhuUVeNwO,SpATywNh6bZuzm8s1ceuBUnMUAeoAHHw,5,2,0,0,1,0,2,0,5,0.7142857142857143,1,0.0,0,0,0,1,2,0,0,2,0,1,4,1
15582,144821,CQWretzMoQOL7mDTUjZusG4cd4L6wPQK,SpATywNh6bZuzm8s1ceuBUnMUAeoAHHw,11,8,6,0,4,0,3,0,21,3.0,2,0.0,0,6,0,4,8,0,0,3,0,10,11,1
15583,144822,0xrj8jMy7DRmz2206OV6CH0SXBZh0mT4,A3fsA9Zfv1X2fVEQhTw51lKENdNrEqT3,7,3,2,0,2,0,2,0,9,1.2857142857142858,1,0.0,0,2,0,2,3,0,0,2,0,4,5,0
15584,144828,KiabjnGWKx4XDSpmz6cnPElBww0X3aaK,SpATywNh6bZuzm8s1ceuBUnMUAeoAHHw,16,21,7,22,3,0,5,0,58,8.285714285714286,1,0.0,9,7,19,3,12,0,3,5,0,38,20,1
15585,144838,afGDIbGbSLFIkIVgYTcsM0nZrlLAYXP9,SpATywNh6bZuzm8s1ceuBUnMUAeoAHHw,10,9,6,0,5,1,20,1,42,6.0,2,0.0,0,6,0,5,9,1,0,20,1,11,31,1
15586,144839,59I5in7ieFGusS8qxVtrv60LZ3ifOtyr,A3fsA9Zfv1X2fVEQhTw51lKENdNrEqT3,3,3,0,0,0,0,2,0,5,0.7142857142857143,2,0.0,0,0,0,0,3,0,0,2,0,0,5,1
15587,144841,5o27t78wmU6kJM7l11bepi10qooi6vTp,A3fsA9Zfv1X2fVEQhTw51lKENdNrEqT3,3,0,0,0,0,2,2,0,4,0.5714285714285714,1,0.0,0,0,0,0,0,2,0,2,0,0,4,1
15588,144845,FfUXMT7mZqZTunyhx99wOtQUuUI4jlLj,A3fsA9Zfv1X2fVEQhTw51lKENdNrEqT3,11,7,4,0,4,0,2,0,17,2.4285714285714284,2,0.0,0,4,0,4,7,0,0,2,0,8,9,1
15589,144851,Msnkbi5gSjnXMGVMwapulzDXPJT7PsEO,RXDvfPUBYFlVdlueBFbLW0mhhAyGEqpt,2,0,0,0,0,0,2,0,2,0.2857142857142857,1,0.0,0,0,0,0,0,0,0,2,0,0,2,1
15590,144856,raoWM7iEQ4dq4BWNCSh69Fo9jIIvs47M,RXDvfPUBYFlVdlueBFbLW0mhhAyGEqpt,1,0,0,0,0,0,1,0,1,0.14285714285714285,1,0.0,0,0,0,0,0,0,0,1,0,0,1,1
15591,144861,ytxaMMjv4jRoSu72s5GHMltMaCAqKKcw,A3fsA9Zfv1X2fVEQhTw51lKENdNrEqT3,6,4,1,0,0,0,4,0,9,1.2857142857142858,1,0.0,0,1,0,0,4,0,0,4,0,1,8,1
15592,144862,7ZV5hVKM33Il4ZphKUROohrBCk5SoM3Q,RXDvfPUBYFlVdlueBFbLW0mhhAyGEqpt,8,25,14,0,0,0,1,0,40,5.714285714285714,1,0.0,8,14,0,0,17,0,0,1,0,22,18,1
15593,144865,T9c92JfvB6Kfucc01WIFC70LXWVeMAod,SpATywNh6bZuzm8s1ceuBUnMUAeoAHHw,15,23,0,18,0,13,9,1,64,9.142857142857142,1,0.0,8,0,15,0,15,13,3,9,1,23,41,1
15594,144877,ooFElJ4ZPOLTBMQwigtvKfnHk0DNrR2R,bWdj2GDclj5ofokWjzoa5jAwMkxCykd6,2,0,0,0,0,0,2,0,2,0.2857142857142857,1,0.0,0,0,0,0,0,0,0,2,0,0,2,1
15595,144882,ng2LeRo6bYVrW9ExHXJ3akhqh2xVsMqB,G8EPVSXsOYB5YQWZGiz1aVq5Pgr2GrQu,6,4,0,0,1,4,2,0,11,1.5714285714285714,1,0.0,0,0,0,1,4,4,0,2,0,1,10,1
15596,144904,oIHEiOwjcaMd5CeWZdkq4rXU3yelDWwT,bWdj2GDclj5ofokWjzoa5jAwMkxCykd6,1,0,0,0,0,0,1,0,1,0.14285714285714285,1,0.0,0,0,0,0,0,0,0,1,0,0,1,1
15597,144918,PZdxFgKpeQmexjsFXHDQYKHzq3CXEabo,SpATywNh6bZuzm8s1ceuBUnMUAeoAHHw,7,2,2,0,2,0,2,0,8,1.1428571428571428,1,0.0,0,2,0,2,2,0,0,2,0,4,4,1
15598,144921,1ygmKyxuE9zTchPBrLxYZHBa3CxHnvGx,SpATywNh6bZuzm8s1ceuBUnMUAeoAHHw,1,0,0,0,0,0,1,0,1,0.14285714285714285,1,0.0,0,0,0,0,0,0,0,1,0,0,1,1
15599,144922,1whtO6jrHXBMnMCSb8vftfOcDZoI6lpk,SpATywNh6bZuzm8s1ceuBUnMUAeoAHHw,2,0,0,0,0,0,2,0,2,0.2857142857142857,1,0.0,0,0,0,0,0,0,0,2,0,0,2,1
15600,144930,0ItSpPGfnBPXWyzwV4fknfpLDkx7tWJ8,SpATywNh6bZuzm8s1ceuBUnMUAeoAHHw,1,0,0,0,0,0,1,0,1,0.14285714285714285,1,0.0,0,0,0,0,0,0,0,1,0,0,1,1
15601,144934,WiWr9LeARPPUMTXasnYbOZNxI6vKEOag,SpATywNh6bZuzm8s1ceuBUnMUAeoAHHw,9,12,8,0,6,0,3,0,29,4.142857142857143,1,0.0,0,8,0,6,12,0,0,3,0,14,15,0
15602,144942,sJvbEmQSLPUSlzQVliesQ54qeaDrLfvx,A3fsA9Zfv1X2fVEQhTw51lKENdNrEqT3,1,0,0,0,0,0,1,0,1,0.14285714285714285,1,0.0,0,0,0,0,0,0,0,1,0,0,1,0
15603,144962,Tknw6wFyBHibLmhWsLFULGANgYkknQHe,bWdj2GDclj5ofokWjzoa5jAwMkxCykd6,8,6,0,0,0,0,6,0,12,1.7142857142857142,2,0.0,0,0,0,0,6,0,0,6,0,0,12,1
15604,144964,5x6p4rljKsrejQoWBLOKiqqWs4gJF7v5,bWdj2GDclj5ofokWjzoa5jAwMkxCykd6,4,2,0,0,0,0,2,0,4,0.5714285714285714,1,0.0,0,0,0,0,2,0,0,2,0,0,4,1
15605,144979,AO5lBD55aLiSGI6wc1OCl02CqUcrTOsS,G8EPVSXsOYB5YQWZGiz1aVq5Pgr2GrQu,7,6,2,2,3,0,2,0,15,2.142857142857143,1,0.0,3,2,1,3,3,0,1,2,0,9,6,0
15606,144984,mco1H2E00EJyxVOQ1f2JUOahUZWPVYSV,G8EPVSXsOYB5YQWZGiz1aVq5Pgr2GrQu,12,16,11,0,5,1,9,0,42,6.0,3,0.0,0,11,0,5,16,1,0,9,0,16,26,1
15607,144988,r2BlY5kx3gPU1opGlfjFI0ngbnfS5jKE,bWdj2GDclj5ofokWjzoa5jAwMkxCykd6,1,0,0,0,0,0,2,0,2,0.2857142857142857,1,0.0,0,0,0,0,0,0,0,2,0,0,2,1
15608,144998,QbBXesiuS3b5lRVZqzzdKh71YLAIKh1k,A3fsA9Zfv1X2fVEQhTw51lKENdNrEqT3,25,19,12,0,8,2,13,2,56,8.0,3,0.0,0,12,0,8,19,2,0,13,2,20,36,0
15609,144999,KQvub9kHQ3XpwpO5JgmmZp67zs4af3TX,SpATywNh6bZuzm8s1ceuBUnMUAeoAHHw,9,7,4,0,1,2,8,1,23,3.2857142857142856,1,0.0,0,4,0,1,7,2,0,8,1,5,18,1
15610,145000,FsN3EYiAfRxm9msVQNiGujMlmaZjdiLV,A3fsA9Zfv1X2fVEQhTw51lKENdNrEqT3,10,5,3,0,2,0,6,0,16,2.2857142857142856,2,0.0,0,3,0,2,5,0,0,6,0,5,11,1
15611,145001,cZxcDNlAnm0tcnrjnkTKyh2S3nRuNP2Z,G8EPVSXsOYB5YQWZGiz1aVq5Pgr2GrQu,7,5,1,0,1,0,3,0,10,1.4285714285714286,1,0.0,2,1,0,1,3,0,0,3,0,4,6,1
15612,145005,GkMFrAPlA6A09ccGhHn8t14lF9MeMrXS,SpATywNh6bZuzm8s1ceuBUnMUAeoAHHw,4,5,2,0,0,0,1,0,8,1.1428571428571428,1,0.0,0,2,0,0,5,0,0,1,0,2,6,1
15613,145008,1ORn2IwJawkKgC86QfIvIvcPRotoBurY,RXDvfPUBYFlVdlueBFbLW0mhhAyGEqpt,1,0,0,0,0,0,1,0,1,0.14285714285714285,1,0.0,0,0,0,0,0,0,0,1,0,0,1,1
15614,145013,yIWNRaHiP3wQHGf1Y6WI0xVXEdSpULNT,SpATywNh6bZuzm8s1ceuBUnMUAeoAHHw,6,3,2,0,2,0,1,0,8,1.1428571428571428,1,0.0,0,2,0,2,3,0,0,1,0,4,4,1
15615,145018,sPPWsacmUhKicl9IkMyPoW9C9Hv6wkAR,SpATywNh6bZuzm8s1ceuBUnMUAeoAHHw,11,13,2,0,1,0,4,0,20,2.857142857142857,2,0.0,0,2,0,1,13,0,0,4,0,3,17,1
15616,145030,ZvJHkcI26nhwqsVV9yaOoOyrIpy66iPT,A3fsA9Zfv1X2fVEQhTw51lKENdNrEqT3,6,6,1,0,1,0,1,0,9,1.2857142857142858,1,0.0,0,1,0,1,6,0,0,1,0,2,7,1
15617,145041,yIWNRaHiP3wQHGf1Y6WI0xVXEdSpULNT,bWdj2GDclj5ofokWjzoa5jAwMkxCykd6,5,2,1,0,1,0,2,0,6,0.8571428571428571,1,0.0,0,1,0,1,2,0,0,2,0,2,4,1
15618,145052,xvgAWMkP6HI1IM5orrHyjEEETuOd15kx,A3fsA9Zfv1X2fVEQhTw51lKENdNrEqT3,1,0,0,0,0,0,1,0,1,0.14285714285714285,1,0.0,0,0,0,0,0,0,0,1,0,0,1,1
15619,145055,rL34nWMQELY22w9bM5KXtMtPPdNRd6Vz,bWdj2GDclj5ofokWjzoa5jAwMkxCykd6,8,4,3,0,3,0,2,0,12,1.7142857142857142,1,0.0,0,3,0,3,4,0,0,2,0,6,6,1
15620,145059,0ZuqaZpF1uAdriF9eidLtJ5iuMfVy2xj,SpATywNh6bZuzm8s1ceuBUnMUAeoAHHw,11,16,4,0,2,10,5,0,37,5.285714285714286,2,0.0,0,4,0,2,16,10,0,5,0,6,31,1
15621,145106,DyTFy9Maa2ONHa1kuv16yd2JfoXtDQiQ,A3fsA9Zfv1X2fVEQhTw51lKENdNrEqT3,2,0,0,0,0,0,2,0,2,0.2857142857142857,1,0.0,0,0,0,0,0,0,0,2,0,0,2,1
15622,145109,PnK7IG5mVnL9F5P0hCKqF8uvfGfnI7Zr,SpATywNh6bZuzm8s1ceuBUnMUAeoAHHw,18,15,8,14,3,1,23,4,68,9.714285714285714,2,0.0,5,8,11,3,10,1,3,23,4,27,41,1
15623,145115,s4uxePGHFu7vUUg0QFSUrIPUr6ntECxH,SpATywNh6bZuzm8s1ceuBUnMUAeoAHHw,11,4,3,0,2,1,8,1,19,2.7142857142857144,2,0.0,0,3,0,2,4,1,0,8,1,5,14,1
15624,145116,TQ3ME8oXFjG9uPuJF9DlrWFS3Mh17Asw,SpATywNh6bZuzm8s1ceuBUnMUAeoAHHw,12,14,1,12,0,7,7,1,42,6.0,1,0.0,6,1,9,0,8,7,3,7,1,16,26,1
15625,145118,QoxAfK1F7spDZI2801beWPeXZSdQfP03,SpATywNh6bZuzm8s1ceuBUnMUAeoAHHw,9,14,1,9,0,16,5,0,45,6.428571428571429,2,0.0,10,1,9,0,4,16,0,5,0,20,25,1
15626,145120,iMAPtNJrTh9vdZVbGuGpFbwdggkaxy45,SpATywNh6bZuzm8s1ceuBUnMUAeoAHHw,13,14,9,0,5,4,6,0,38,5.428571428571429,2,0.0,2,9,0,5,12,4,0,6,0,16,22,1
15627,145134,nA58ZDkDJW4coPbkDAFQTIrhFRBe6rSy,G8EPVSXsOYB5YQWZGiz1aVq5Pgr2GrQu,8,14,2,0,0,0,4,0,20,2.857142857142857,2,0.0,4,2,0,0,10,0,0,4,0,6,14,1
15628,145135,ryorMC5bEintyqBNOh5gLfjxAx4QoH5u,A3fsA9Zfv1X2fVEQhTw51lKENdNrEqT3,17,22,13,0,4,12,19,3,73,10.428571428571429,2,0.0,1,13,0,4,21,12,0,19,3,18,55,1
15629,145137,yCZXjIGq001xO7v4MWCrl9HykbxmZHu1,SpATywNh6bZuzm8s1ceuBUnMUAeoAHHw,21,52,21,58,0,0,8,0,139,19.857142857142858,5,0.0,24,21,47,0,28,0,11,8,0,92,47,0
15630,145143,sytW49I21SJ70ElOkXGU5SHeeHl1E3fL,RXDvfPUBYFlVdlueBFbLW0mhhAyGEqpt,1,0,0,0,0,0,1,0,1,0.14285714285714285,1,0.0,0,0,0,0,0,0,0,1,0,0,1,1
15631,145155,BohRHH2vBIgnEZGZjM3WnHwJbVFmITRG,bWdj2GDclj5ofokWjzoa5jAwMkxCykd6,7,5,1,0,1,0,5,0,12,1.7142857142857142,2,0.0,0,1,0,1,5,0,0,5,0,2,10,1
15632,145161,K9rvD8Iu0wq956P4CDD0WYKLX5TfMvJ0,SpATywNh6bZuzm8s1ceuBUnMUAeoAHHw,7,3,2,0,2,0,3,0,10,1.4285714285714286,2,0.0,0,2,0,2,3,0,0,3,0,4,6,1
15633,145165,6h1KbHhbSaGcIKRFEHiX0UdDPCB3E5BQ,A3fsA9Zfv1X2fVEQhTw51lKENdNrEqT3,7,3,2,0,2,0,3,0,10,1.4285714285714286,1,0.0,0,2,0,2,3,0,0,3,0,4,6,1
15634,145167,q1fsTZpD3tHg9RFkIri5aJQcs8ZtVzZU,A3fsA9Zfv1X2fVEQhTw51lKENdNrEqT3,1,0,0,0,0,0,1,0,1,0.14285714285714285,1,0.0,0,0,0,0,0,0,0,1,0,0,1,1
15635,145182,JkokNSOVQ0CmVMNuEphopYOXBxfXEJtF,SpATywNh6bZuzm8s1ceuBUnMUAeoAHHw,16,38,13,19,3,0,10,0,83,11.857142857142858,4,0.0,19,13,17,3,19,0,2,10,0,52,31,1
15636,145183,l5XRpi9H4fQ2XUHeEPRXRHL6Y4BckIOB,bWdj2GDclj5ofokWjzoa5jAwMkxCykd6,7,14,5,0,6,0,2,0,27,3.857142857142857,5,0.0,4,5,0,6,10,0,0,2,0,15,12,1
15637,145195,XOKsEN36DokXwcr1smPc9nspsVQlK0Oq,bWdj2GDclj5ofokWjzoa5jAwMkxCykd6,5,2,1,0,0,0,3,0,6,0.8571428571428571,1,0.0,0,1,0,0,2,0,0,3,0,1,5,1
15638,145204,HnmJeuwsJxtO6k1CT8974Qo3Mu0GibPm,SpATywNh6bZuzm8s1ceuBUnMUAeoAHHw,6,3,1,0,1,0,3,0,8,1.1428571428571428,1,0.0,0,1,0,1,3,0,0,3,0,2,6,1
15639,145206,GQtHf5FrRCd4lKlDjEvxcTzFdncOzUUt,SpATywNh6bZuzm8s1ceuBUnMUAeoAHHw,4,2,0,0,0,0,3,0,5,0.7142857142857143,2,0.0,0,0,0,0,2,0,0,3,0,0,5,1
15640,145208,oGbJmKuU02t3nWH0tibgF9TroQlaGQUL,SpATywNh6bZuzm8s1ceuBUnMUAeoAHHw,13,14,8,0,3,0,10,0,35,5.0,1,0.0,2,8,0,3,12,0,0,10,0,13,22,1
15641,145217,TvUMV7rQqIP7XtKwTDDoLxmalP29Ttuw,SpATywNh6bZuzm8s1ceuBUnMUAeoAHHw,15,15,5,20,3,0,3,0,46,6.571428571428571,1,0.0,9,5,17,3,6,0,3,3,0,34,12,1
15642,145226,OpGwtUbMGweipJr0vMybah9tM3IHgiea,G8EPVSXsOYB5YQWZGiz1aVq5Pgr2GrQu,7,8,0,0,0,0,3,0,11,1.5714285714285714,1,0.0,0,0,0,0,8,0,0,3,0,0,11,1
15643,145236,DaYS7gf8DVgCD84ya5YqgMFFiGYw1ps2,bWdj2GDclj5ofokWjzoa5jAwMkxCykd6,10,14,1,0,3,0,7,1,26,3.7142857142857144,2,0.0,5,1,0,3,9,0,0,7,1,9,17,1
15644,145239,OtjE6pGePvcycREQhVmfTMoFJDvUV70D,SpATywNh6bZuzm8s1ceuBUnMUAeoAHHw,11,6,5,2,2,0,3,0,18,2.5714285714285716,1,0.0,0,5,2,2,6,0,0,3,0,9,9,1
15645,145253,5CjxInsWcHYdL9qJZYHVK4nh5ZsDhwos,A3fsA9Zfv1X2fVEQhTw51lKENdNrEqT3,6,3,1,0,1,0,2,0,7,1.0,1,0.0,0,1,0,1,3,0,0,2,0,2,5,1
15646,145259,5CjxInsWcHYdL9qJZYHVK4nh5ZsDhwos,bWdj2GDclj5ofokWjzoa5jAwMkxCykd6,10,16,3,0,3,2,7,1,32,4.571428571428571,2,0.0,0,3,0,3,16,2,0,7,1,6,26,1
15647,145264,EvNxwwShcQXgwZllGhuS7z5fGOL08A9A,G8EPVSXsOYB5YQWZGiz1aVq5Pgr2GrQu,1,0,0,0,0,0,1,0,1,0.14285714285714285,1,0.0,0,0,0,0,0,0,0,1,0,0,1,1
15648,145306,gB1oK8asvoVWRzgcHWrM4vY7Z3TLvmEu,G8EPVSXsOYB5YQWZGiz1aVq5Pgr2GrQu,14,29,2,0,2,1,14,1,49,7.0,2,0.0,0,2,0,2,29,1,0,14,1,4,45,1
15649,145308,UdRvlfQEjfzv2meiEECQoQ6VdSnYEWcK,bWdj2GDclj5ofokWjzoa5jAwMkxCykd6,1,0,0,0,0,0,1,0,1,0.14285714285714285,1,0.0,0,0,0,0,0,0,0,1,0,0,1,1
15650,145314,0G4cec511TtDyNtXCTS7DRIqOcOGSzxj,bWdj2GDclj5ofokWjzoa5jAwMkxCykd6,2,0,0,0,0,0,4,0,4,0.5714285714285714,2,0.0,0,0,0,0,0,0,0,4,0,0,4,1
15651,145324,eb3SHueTE6ugnDkhYnh0RBSPDS20VwLZ,SpATywNh6bZuzm8s1ceuBUnMUAeoAHHw,10,13,6,0,3,0,4,0,26,3.7142857142857144,2,0.0,2,6,0,3,11,0,0,4,0,11,15,1
15652,145327,fB0i7xObEYSWbMZwNEun6y9gdH9iF6Ca,bWdj2GDclj5ofokWjzoa5jAwMkxCykd6,6,4,1,0,0,0,3,0,8,1.1428571428571428,1,0.0,0,1,0,0,4,0,0,3,0,1,7,1
15653,145344,rrHRbXLg6i4u3JAIzGOFXJzGViekqHta,A3fsA9Zfv1X2fVEQhTw51lKENdNrEqT3,5,4,2,0,1,1,3,0,11,1.5714285714285714,2,0.0,0,2,0,1,4,1,0,3,0,3,8,1
15654,145354,KF5OPToc2HXGCGomze0nhcEx5XKSQ0eb,A3fsA9Zfv1X2fVEQhTw51lKENdNrEqT3,1,0,0,0,0,0,1,0,1,0.14285714285714285,1,0.0,0,0,0,0,0,0,0,1,0,0,1,1
15655,145359,KF5OPToc2HXGCGomze0nhcEx5XKSQ0eb,bWdj2GDclj5ofokWjzoa5jAwMkxCykd6,8,9,2,0,1,0,7,1,20,2.857142857142857,3,0.0,0,2,0,1,9,0,0,7,1,3,17,1
15656,145362,UTEysxng8QdAA1HDzCSMUfK51MYoUK0I,SpATywNh6bZuzm8s1ceuBUnMUAeoAHHw,18,23,8,17,3,1,9,1,62,8.857142857142858,2,0.0,10,8,15,3,13,1,2,9,1,36,26,1
15657,145365,pG2ElR6wLgS0VIoYkLxmyVPOZz4q1huq,SpATywNh6bZuzm8s1ceuBUnMUAeoAHHw,5,3,1,0,1,0,4,0,9,1.2857142857142858,1,0.0,0,1,0,1,3,0,0,4,0,2,7,1
15658,145367,D9K6eWkEOoVrLczNZaGo49KoERtz2c6V,SpATywNh6bZuzm8s1ceuBUnMUAeoAHHw,16,23,13,11,4,0,6,0,57,8.142857142857142,4,0.0,4,13,10,4,19,0,1,6,0,31,26,1
15659,145368,705a1tvxnZT7omctMx7Fjakho000VDxN,A3fsA9Zfv1X2fVEQhTw51lKENdNrEqT3,1,0,0,0,0,0,2,0,2,0.2857142857142857,1,0.0,0,0,0,0,0,0,0,2,0,0,2,1
15660,145378,cMwTVyssxspl1RAprFyXqPmiVK2Z3yGe,SpATywNh6bZuzm8s1ceuBUnMUAeoAHHw,6,3,1,0,1,0,2,0,7,1.0,1,0.0,0,1,0,1,3,0,0,2,0,2,5,1
15661,145380,hZsYKh9WLvB4Wt2hCg4xVcKygpRAuxj7,A3fsA9Zfv1X2fVEQhTw51lKENdNrEqT3,25,10,9,16,8,0,4,0,47,6.714285714285714,2,0.0,0,9,14,8,10,0,2,4,0,31,16,1
15662,145389,TRYKApgWJsELbbCq5WSkTNwaxvbHHyCj,A3fsA9Zfv1X2fVEQhTw51lKENdNrEqT3,2,0,0,0,0,0,3,0,3,0.42857142857142855,1,0.0,0,0,0,0,0,0,0,3,0,0,3,1
15663,145391,H1aKLEBJtpAOAOCXptqn2WzikG0W6HkP,SpATywNh6bZuzm8s1ceuBUnMUAeoAHHw,3,0,0,0,0,0,2,1,3,0.42857142857142855,1,0.0,0,0,0,0,0,0,0,2,1,0,3,1
15664,145403,NO22WSq5lVGwq6WPEcqalEaMjYIZxX3u,SpATywNh6bZuzm8s1ceuBUnMUAeoAHHw,4,2,0,0,0,0,2,0,4,0.5714285714285714,2,0.0,0,0,0,0,2,0,0,2,0,0,4,1
15665,145411,sETZmDR5b3CheYe2K5IvWb1lrRsZmOT8,bWdj2GDclj5ofokWjzoa5jAwMkxCykd6,7,4,0,0,0,0,6,1,11,1.5714285714285714,2,0.0,0,0,0,0,4,0,0,6,1,0,11,1
15666,145461,XGghmqZSDFp0iwrgmPDUKXBdusY5a7fx,bWdj2GDclj5ofokWjzoa5jAwMkxCykd6,4,3,1,0,1,0,1,0,6,0.8571428571428571,1,0.0,0,1,0,1,3,0,0,1,0,2,4,1
15667,145471,cRlXLJdkIX4KH74JKLBjP86zQb3lppxR,A3fsA9Zfv1X2fVEQhTw51lKENdNrEqT3,9,4,3,0,3,0,2,0,12,1.7142857142857142,1,0.0,0,3,0,3,4,0,0,2,0,6,6,1
15668,145473,UNqMz63UOiLuXMnJzd7YWyfD3qIuNdaK,A3fsA9Zfv1X2fVEQhTw51lKENdNrEqT3,109,33,28,176,23,0,15,0,275,39.285714285714285,5,0.0,3,28,158,23,30,0,18,15,0,212,63,1
15669,145474,cRlXLJdkIX4KH74JKLBjP86zQb3lppxR,SpATywNh6bZuzm8s1ceuBUnMUAeoAHHw,5,2,1,0,1,0,2,0,6,0.8571428571428571,1,0.0,0,1,0,1,2,0,0,2,0,2,4,1
15670,145483,wAirqcgeWs2CREKJhWAsWOo902skDwiw,SpATywNh6bZuzm8s1ceuBUnMUAeoAHHw,1,0,0,0,0,0,1,0,1,0.14285714285714285,1,0.0,0,0,0,0,0,0,0,1,0,0,1,1
15671,145487,3nvYm1DKrH5EOHAw44wBVldk53PpV7TA,A3fsA9Zfv1X2fVEQhTw51lKENdNrEqT3,14,10,7,0,5,2,2,0,26,3.7142857142857144,1,0.0,0,7,0,5,10,2,0,2,0,12,14,1
15672,145490,cKkpvGwYNdrpPwFgGI1Q3ssqlyxAIVaB,SpATywNh6bZuzm8s1ceuBUnMUAeoAHHw,7,7,4,0,3,0,1,0,15,2.142857142857143,1,0.0,2,4,0,3,5,0,0,1,0,9,6,1
15673,145493,BQyaQ0QwoGWbtLuf0oWIdmIpVjKe7O2x,A3fsA9Zfv1X2fVEQhTw51lKENdNrEqT3,7,4,3,0,2,0,2,0,11,1.5714285714285714,1,0.0,0,3,0,2,4,0,0,2,0,5,6,1
15674,145494,ySy2zYThCkVZr5MjEXuKxq60wfOynxkJ,bWdj2GDclj5ofokWjzoa5jAwMkxCykd6,1,0,0,0,0,0,1,0,1,0.14285714285714285,1,0.0,0,0,0,0,0,0,0,1,0,0,1,1
15675,145496,zhoGGW9mWTf0e7saIpd0Zh4kN5TE5GWq,SpATywNh6bZuzm8s1ceuBUnMUAeoAHHw,10,8,2,0,1,0,7,0,18,2.5714285714285716,1,0.0,0,2,0,1,8,0,0,7,0,3,15,1
15676,145522,vbUXBKy2vKu4AOOOd2rJki0btGiFQNDk,G8EPVSXsOYB5YQWZGiz1aVq5Pgr2GrQu,1,0,0,0,0,0,1,0,1,0.14285714285714285,1,0.0,0,0,0,0,0,0,0,1,0,0,1,1
15677,145525,x9kyeNXnVmIKLkyrDIOwE7AbD5ZpbAEs,RXDvfPUBYFlVdlueBFbLW0mhhAyGEqpt,1,0,0,0,0,0,1,0,1,0.14285714285714285,1,0.0,0,0,0,0,0,0,0,1,0,0,1,1
15678,145545,2CCQpD8tgu5ha7nXCDy4k1uINvkP56Wv,7GRhBDsirIGkRZBtSMEzNTyDr2JQm4xx,2,0,0,0,0,0,5,0,5,0.7142857142857143,1,0.0,0,0,0,0,0,0,0,5,0,0,5,1
15679,145546,OUbrW18OgibVb4I41eHFiFhkobpgjEP2,5X6FeZozNMgE2VRi3MJYjkkFK8SETtu2,67,112,36,0,64,0,19,0,231,33.0,8,0.0,50,36,0,64,62,0,0,19,0,150,81,0
15680,145547,rT3zpA0g6rjJ1jZXfn6mCIcHmMcmU756,7GRhBDsirIGkRZBtSMEzNTyDr2JQm4xx,44,62,22,54,23,1,14,0,176,25.142857142857142,3,0.0,30,22,44,23,32,1,10,14,0,119,57,0
15681,145550,RuTxY8DaJW8mZYxEAeQrQJD3l4wbq41Q,7GRhBDsirIGkRZBtSMEzNTyDr2JQm4xx,6,3,0,0,0,0,3,0,6,0.8571428571428571,1,0.0,0,0,0,0,3,0,0,3,0,0,6,0
15682,145552,J9NhhdMcyji8QpxegDrg5mXOQMf3xBRf,7GRhBDsirIGkRZBtSMEzNTyDr2JQm4xx,1,0,0,0,0,0,1,0,1,0.14285714285714285,1,0.0,0,0,0,0,0,0,0,1,0,0,1,1
15683,145560,vGQAID39BKk1FvQYReBWX247x3QlYrgz,7GRhBDsirIGkRZBtSMEzNTyDr2JQm4xx,6,15,4,0,1,0,2,0,22,3.142857142857143,1,0.0,6,4,0,1,9,0,0,2,0,11,11,1
15684,145583,iiP1QVGLP2M3sIU07s5hEwnMnf9UaC7w,7GRhBDsirIGkRZBtSMEzNTyDr2JQm4xx,5,3,1,0,1,0,1,0,6,0.8571428571428571,1,0.0,0,1,0,1,3,0,0,1,0,2,4,1
15685,145608,3kzqQ9nu0puySXndbv8HvzuMPwBlBjfc,7GRhBDsirIGkRZBtSMEzNTyDr2JQm4xx,25,68,19,31,6,9,25,1,159,22.714285714285715,4,0.0,32,19,22,6,36,9,9,25,1,79,80,1
15686,145620,S9UJJr8IVX3RcksPSP43kxazIyd4D4o5,7GRhBDsirIGkRZBtSMEzNTyDr2JQm4xx,1,0,0,0,0,0,1,0,1,0.14285714285714285,1,0.0,0,0,0,0,0,0,0,1,0,0,1,1
15687,145622,520kTOJ5a6HoTMe30flreSub2cyQqOhY,7GRhBDsirIGkRZBtSMEzNTyDr2JQm4xx,30,79,31,52,19,11,6,0,198,28.285714285714285,3,0.0,37,31,45,19,42,11,7,6,0,132,66,1
15688,145653,NCnx21IrphITLHEQy42s0jDfFa8Z92Kq,7GRhBDsirIGkRZBtSMEzNTyDr2JQm4xx,27,32,0,48,6,3,2,0,91,13.0,1,0.0,21,0,43,6,11,3,5,2,0,70,21,1
15689,145656,MhPFQAgWNzlZ6Teq1DlKr26Z8E6wW1AP,5X6FeZozNMgE2VRi3MJYjkkFK8SETtu2,5,2,1,0,1,0,2,0,6,0.8571428571428571,1,0.0,0,1,0,1,2,0,0,2,0,2,4,1
15690,145662,SBDjqcJAy98nKfERlylEgYbif3PemxS8,5X6FeZozNMgE2VRi3MJYjkkFK8SETtu2,4,3,1,0,0,0,3,0,7,1.0,2,0.0,0,1,0,0,3,0,0,3,0,1,6,1
15691,145667,dNsNKeQao2yeFH4xZSLIDRMA5I5s2F7t,7GRhBDsirIGkRZBtSMEzNTyDr2JQm4xx,10,4,1,4,0,1,8,1,19,2.7142857142857144,1,0.0,2,1,3,0,2,1,1,8,1,6,13,1
15692,145672,J2mZhHnfnDU9Z2NM0dfjKg8jCciGVkrO,7GRhBDsirIGkRZBtSMEzNTyDr2JQm4xx,1,0,0,0,0,0,1,0,1,0.14285714285714285,1,0.0,0,0,0,0,0,0,0,1,0,0,1,1
15693,145700,4w6yJxocEKgAV94E61slsyKYrolKgTdS,7GRhBDsirIGkRZBtSMEzNTyDr2JQm4xx,2,0,0,0,0,0,2,0,2,0.2857142857142857,1,0.0,0,0,0,0,0,0,0,2,0,0,2,1
15694,145706,VQbP5QE49Z71QPyvJxZhD4TLO56u1QUG,7GRhBDsirIGkRZBtSMEzNTyDr2JQm4xx,10,11,3,9,2,0,2,0,27,3.857142857142857,1,0.0,7,3,8,2,4,0,1,2,0,20,7,1
15695,145721,pxgIaZZAbkQ5oFydUV3lLrUkd7x4pWT5,5X6FeZozNMgE2VRi3MJYjkkFK8SETtu2,5,2,0,0,0,0,12,1,15,2.142857142857143,4,0.0,0,0,0,0,2,0,0,12,1,0,15,1
15696,145730,yB2j2tPO2DVKCBBdsLv8a1lbHtfWINMh,5X6FeZozNMgE2VRi3MJYjkkFK8SETtu2,1,0,0,0,0,0,2,0,2,0.2857142857142857,1,0.0,0,0,0,0,0,0,0,2,0,0,2,1
15697,145733,j2PX858BWhrQRgl6BBT72xW4SDvQKpBb,7GRhBDsirIGkRZBtSMEzNTyDr2JQm4xx,1,0,0,0,0,0,1,0,1,0.14285714285714285,1,0.0,0,0,0,0,0,0,0,1,0,0,1,1
15698,145753,6UQSgDDlbey2YMMKaSOEpDJ0KQllZPpX,7GRhBDsirIGkRZBtSMEzNTyDr2JQm4xx,4,0,0,0,0,0,4,0,4,0.5714285714285714,1,0.0,0,0,0,0,0,0,0,4,0,0,4,1
15699,145756,tFAmYxyKHBwgE3PLGd3A2TrV0pERnGhA,5X6FeZozNMgE2VRi3MJYjkkFK8SETtu2,1,0,0,0,0,0,1,0,1,0.14285714285714285,1,0.0,0,0,0,0,0,0,0,1,0,0,1,1
15700,145763,lnkkWGyIr1b44KiKgAFL6qVeebRfNJt3,7GRhBDsirIGkRZBtSMEzNTyDr2JQm4xx,17,28,0,37,0,0,4,0,69,9.857142857142858,2,0.0,16,0,32,0,12,0,5,4,0,48,21,1
15701,145764,IL2QJO9D8DzgZ0CQ8CMzPpcGTIPKd3bR,5X6FeZozNMgE2VRi3MJYjkkFK8SETtu2,1,0,0,0,0,0,1,0,1,0.14285714285714285,1,0.0,0,0,0,0,0,0,0,1,0,0,1,1
15702,145766,IL2QJO9D8DzgZ0CQ8CMzPpcGTIPKd3bR,7GRhBDsirIGkRZBtSMEzNTyDr2JQm4xx,1,0,0,0,0,0,1,0,1,0.14285714285714285,1,0.0,0,0,0,0,0,0,0,1,0,0,1,1
15703,145774,UtbznsHbbIxKlUqw2M2px85X4bXZRgMG,7GRhBDsirIGkRZBtSMEzNTyDr2JQm4xx,1,0,0,0,0,0,1,0,1,0.14285714285714285,1,0.0,0,0,0,0,0,0,0,1,0,0,1,1
15704,145783,lfRqSKrZDdqhfB8Fp83G9pBOvFDy0kAs,5X6FeZozNMgE2VRi3MJYjkkFK8SETtu2,4,3,1,0,1,0,4,0,9,1.2857142857142858,2,0.0,0,1,0,1,3,0,0,4,0,2,7,0
15705,145785,r1hSpHaWwriGvone6pflJV8zZcv0Gdcl,7GRhBDsirIGkRZBtSMEzNTyDr2JQm4xx,2,0,0,0,0,0,2,0,2,0.2857142857142857,1,0.0,0,0,0,0,0,0,0,2,0,0,2,1
15706,145795,yEBTzrvNFAmfa9M4QYcbmiIM6sJKI3UY,7GRhBDsirIGkRZBtSMEzNTyDr2JQm4xx,2,0,0,0,0,0,4,0,4,0.5714285714285714,1,0.0,0,0,0,0,0,0,0,4,0,0,4,1
15707,145817,sqxWpMhcYtYMOXwrr0icUXKE79UdB0Zx,7GRhBDsirIGkRZBtSMEzNTyDr2JQm4xx,16,28,2,2,2,0,10,1,45,6.428571428571429,3,0.0,1,2,2,2,27,0,0,10,1,7,38,1
15708,145818,N6ImAosJzAVWR7oHFfpVfe8E1VJdiGsb,5X6FeZozNMgE2VRi3MJYjkkFK8SETtu2,5,0,0,0,0,0,6,1,7,1.0,1,0.0,0,0,0,0,0,0,0,6,1,0,7,1
15709,145827,dgFOOUSNfQK8xIrT47Av0Q04bBFeE21W,7GRhBDsirIGkRZBtSMEzNTyDr2JQm4xx,1,0,0,0,0,0,1,0,1,0.14285714285714285,1,0.0,0,0,0,0,0,0,0,1,0,0,1,0
15710,145897,amg8X8B8QF6NtkilqTdjsvKuhYv7sNrc,7GRhBDsirIGkRZBtSMEzNTyDr2JQm4xx,5,7,2,0,0,0,2,0,11,1.5714285714285714,1,0.0,0,2,0,0,7,0,0,2,0,2,9,1
15711,145967,S7Q03OvsYAC6WJ82BtJjyFFd4ZbHVwsc,5X6FeZozNMgE2VRi3MJYjkkFK8SETtu2,4,2,1,0,1,0,1,0,5,0.7142857142857143,1,0.0,0,1,0,1,2,0,0,1,0,2,3,1
15712,145972,mKd3zvTJo9oK9No6ynOqanGANGXWRpQi,5X6FeZozNMgE2VRi3MJYjkkFK8SETtu2,1,0,0,0,0,0,1,0,1,0.14285714285714285,1,0.0,0,0,0,0,0,0,0,1,0,0,1,1
15713,145980,HAj954mCjfBGJQsjyOUvywwmDcTn3cfv,7GRhBDsirIGkRZBtSMEzNTyDr2JQm4xx,3,2,1,0,0,0,1,0,4,0.5714285714285714,1,0.0,0,1,0,0,2,0,0,1,0,1,3,1
15714,145993,FTJVq9TWMdAK3okD5xbyDXGZ8r3m7Y4p,7GRhBDsirIGkRZBtSMEzNTyDr2JQm4xx,3,2,0,0,0,0,1,0,3,0.42857142857142855,1,0.0,0,0,0,0,2,0,0,1,0,0,3,1
15715,145997,xZ2FRlEfvjMgYQGaQTIBwdHmWyFrjfGH,7GRhBDsirIGkRZBtSMEzNTyDr2JQm4xx,2,1,0,0,0,0,2,0,3,0.42857142857142855,1,0.0,0,0,0,0,1,0,0,2,0,0,3,0
15716,146003,0Jy5agBaIEKZmcjIoKNgJ60hHPcSDAap,7GRhBDsirIGkRZBtSMEzNTyDr2JQm4xx,1,0,0,0,0,0,1,0,1,0.14285714285714285,1,0.0,0,0,0,0,0,0,0,1,0,0,1,1
15717,146040,W7w7kukRb5fyeDJG4hJEoYfw8z4oB9h4,3VkHkmOtom3jM2wCu94xgzzu1d6Dn7or,1,0,0,0,0,0,2,0,2,0.2857142857142857,1,0.0,0,0,0,0,0,0,0,2,0,0,2,1
15718,146061,2cuuFNfohxs6RAvZ8iFNkg7NwDHCUV7q,3VkHkmOtom3jM2wCu94xgzzu1d6Dn7or,6,4,2,0,1,0,3,0,10,1.4285714285714286,1,0.0,0,2,0,1,4,0,0,3,0,3,7,1
15719,146067,mEM8A2kmVuHC4sV6scGcy1odYGPgKuNu,3VkHkmOtom3jM2wCu94xgzzu1d6Dn7or,7,22,4,4,8,12,5,0,55,7.857142857142857,1,0.0,14,4,3,8,8,12,1,5,0,29,26,1
15720,146076,G7iw8Ow2rKfIJGgfBaIsUdrogzfflfzZ,3VkHkmOtom3jM2wCu94xgzzu1d6Dn7or,9,4,2,4,2,4,4,1,21,3.0,1,0.0,1,2,3,2,3,4,1,4,1,8,13,0
15721,146092,Kb9FWY0PsicXQgmzcMWxDWQGO7HlnhVG,3VkHkmOtom3jM2wCu94xgzzu1d6Dn7or,1,0,0,0,0,0,1,0,1,0.14285714285714285,1,0.0,0,0,0,0,0,0,0,1,0,0,1,1
15722,146124,KNNNASIFe9S4SmZEB0V1HUsimvNnV07D,3VkHkmOtom3jM2wCu94xgzzu1d6Dn7or,1,0,0,0,0,0,1,0,1,0.14285714285714285,1,0.0,0,0,0,0,0,0,0,1,0,0,1,1
15723,146151,JyOwpTqxlZyOZXFXAlv3kcbVV4zSYrRf,3VkHkmOtom3jM2wCu94xgzzu1d6Dn7or,63,49,43,0,31,0,8,0,131,18.714285714285715,1,0.0,0,43,0,31,49,0,0,8,0,74,57,1
15724,146156,HQX8GqAOKadmMWeHvhaF2p1OxKS3RM1p,3VkHkmOtom3jM2wCu94xgzzu1d6Dn7or,1,0,0,0,0,0,1,0,1,0.14285714285714285,1,0.0,0,0,0,0,0,0,0,1,0,0,1,1
15725,146168,dhfR4wGmOusRZWUPfjGh9lEKBfvvwgMt,3VkHkmOtom3jM2wCu94xgzzu1d6Dn7or,3,3,1,0,0,0,1,0,5,0.7142857142857143,1,0.0,0,1,0,0,3,0,0,1,0,1,4,1
15726,146175,cp3YBtv3LBPQsC9KSWwASci6TDzE2JIe,3VkHkmOtom3jM2wCu94xgzzu1d6Dn7or,9,7,4,0,3,4,15,1,34,4.857142857142857,1,0.0,1,4,0,3,6,4,0,15,1,8,26,0
15727,146238,uBtyLiWsbGp5ayAjbKWHJUEBC32rdTAZ,3VkHkmOtom3jM2wCu94xgzzu1d6Dn7or,1,0,0,0,0,0,1,0,1,0.14285714285714285,1,0.0,0,0,0,0,0,0,0,1,0,0,1,1
15728,146247,hq2dtaLjlwQ3cWU40bwr3Yz49cPq72t0,3VkHkmOtom3jM2wCu94xgzzu1d6Dn7or,1,0,0,0,0,0,1,0,1,0.14285714285714285,1,0.0,0,0,0,0,0,0,0,1,0,0,1,1
15729,146255,D6qj8t4GpKIMJAhLDD9jVxzUKaC5jI3i,3VkHkmOtom3jM2wCu94xgzzu1d6Dn7or,1,0,0,0,0,0,1,0,1,0.14285714285714285,1,0.0,0,0,0,0,0,0,0,1,0,0,1,1
15730,146264,tedGThhHMqVARfBh6zyzyocTKbTJYJpB,3VkHkmOtom3jM2wCu94xgzzu1d6Dn7or,13,13,7,0,5,7,9,0,41,5.857142857142857,5,0.0,1,7,0,5,12,7,0,9,0,13,28,0
15731,146267,qRGD5V0PdKSE2CFS7KLfMNLwdcSPFFnk,3VkHkmOtom3jM2wCu94xgzzu1d6Dn7or,93,217,141,128,72,26,21,2,607,86.71428571428571,10,0.0,46,141,120,72,171,26,8,21,2,379,228,0
15732,146275,nWnbhwHC6PAr74R8YCMXr6P4cjLNmd8R,3VkHkmOtom3jM2wCu94xgzzu1d6Dn7or,1,0,0,0,0,0,1,0,1,0.14285714285714285,1,0.0,0,0,0,0,0,0,0,1,0,0,1,1
15733,146290,O1c2CdbmcokDMtE3wXdu8jRs8pHCPANC,3VkHkmOtom3jM2wCu94xgzzu1d6Dn7or,1,0,0,0,0,0,1,0,1,0.14285714285714285,1,0.0,0,0,0,0,0,0,0,1,0,0,1,1
15734,146340,B6r6xBRcq9KnEwfJjEXKyZmquNqAin1X,3VkHkmOtom3jM2wCu94xgzzu1d6Dn7or,2,0,0,0,0,0,2,0,2,0.2857142857142857,1,0.0,0,0,0,0,0,0,0,2,0,0,2,1
15735,146344,2jiAw07SSoTp1cSsnG5DFrNlB8ZMTyTU,3VkHkmOtom3jM2wCu94xgzzu1d6Dn7or,2,0,0,0,0,0,2,0,2,0.2857142857142857,1,0.0,0,0,0,0,0,0,0,2,0,0,2,1
15736,146421,XPiIClmT9wmfbXtRommDRylOKqnUiWUh,3VkHkmOtom3jM2wCu94xgzzu1d6Dn7or,1,0,0,0,0,0,1,0,1,0.14285714285714285,1,0.0,0,0,0,0,0,0,0,1,0,0,1,1
15737,146436,5nsHG8ICnkRR2COH9CWk24a5jN4hps4A,3VkHkmOtom3jM2wCu94xgzzu1d6Dn7or,1,0,0,0,0,0,1,0,1,0.14285714285714285,1,0.0,0,0,0,0,0,0,0,1,0,0,1,1
15738,146438,InrSVF06p54GdJVp4rx5fFLgKthLjcPL,3VkHkmOtom3jM2wCu94xgzzu1d6Dn7or,1,0,0,0,0,0,1,0,1,0.14285714285714285,1,0.0,0,0,0,0,0,0,0,1,0,0,1,1
15739,146447,xZe5DWH0zyw28K4d6bC5DtWJN9b7w3SQ,3VkHkmOtom3jM2wCu94xgzzu1d6Dn7or,4,2,0,0,0,0,3,0,5,0.7142857142857143,2,0.0,0,0,0,0,2,0,0,3,0,0,5,0
15740,146463,W1dSTT9OrjhPeTl1UkP5xTii4aGqoMdD,3VkHkmOtom3jM2wCu94xgzzu1d6Dn7or,12,5,4,0,4,3,6,1,23,3.2857142857142856,1,0.0,0,4,0,4,5,3,0,6,1,8,15,1
15741,146467,mRaBEX7ZDfkFg6XYznVptg421BJGPS3w,3VkHkmOtom3jM2wCu94xgzzu1d6Dn7or,15,13,9,0,8,0,4,0,34,4.857142857142857,1,0.0,3,9,0,8,10,0,0,4,0,20,14,1
15742,146468,qqPYpd4V7fk70e4jFmsmBaSrfw8MV5oj,3VkHkmOtom3jM2wCu94xgzzu1d6Dn7or,10,11,5,0,1,0,9,1,27,3.857142857142857,1,0.0,3,5,0,1,8,0,0,9,1,9,18,1
15743,146479,TMdWz6KdPeUNjOfe2e47rXJreHutuNaG,3VkHkmOtom3jM2wCu94xgzzu1d6Dn7or,1,0,0,0,0,0,1,0,1,0.14285714285714285,1,0.0,0,0,0,0,0,0,0,1,0,0,1,0
15744,146523,QX4EKNbQ37sGymaBxyT9Ir3XbHOte346,3VkHkmOtom3jM2wCu94xgzzu1d6Dn7or,1,0,0,0,0,0,1,0,1,0.14285714285714285,1,0.0,0,0,0,0,0,0,0,1,0,0,1,1
15745,146550,W19NNaEb3YniuIHuoxhT6ig1vLTkLr1C,3VkHkmOtom3jM2wCu94xgzzu1d6Dn7or,7,3,1,0,1,5,6,1,17,2.4285714285714284,1,0.0,1,1,0,1,2,5,0,6,1,3,14,1
15746,146555,gqNraF3wWOQlSmRusk4t8x2p5vnofR8Z,3VkHkmOtom3jM2wCu94xgzzu1d6Dn7or,9,6,3,0,0,1,8,1,19,2.7142857142857144,1,0.0,0,3,0,0,6,1,0,8,1,3,16,1
15747,146556,Cub6N4R0eA9LTVmbHFyEMOSQZzjgSk0k,3VkHkmOtom3jM2wCu94xgzzu1d6Dn7or,1,0,0,0,0,0,1,0,1,0.14285714285714285,1,0.0,0,0,0,0,0,0,0,1,0,0,1,1
15748,146560,w0ZedS6yzDUKJT3yGrp9CDoxetDDlx17,3VkHkmOtom3jM2wCu94xgzzu1d6Dn7or,1,0,0,0,0,0,1,0,1,0.14285714285714285,1,0.0,0,0,0,0,0,0,0,1,0,0,1,1
15749,146568,ANC0sI5rGZOptNQXEXeynoEKn2Bpk1PU,3VkHkmOtom3jM2wCu94xgzzu1d6Dn7or,4,3,1,0,1,0,1,0,6,0.8571428571428571,1,0.0,1,1,0,1,2,0,0,1,0,3,3,1
15750,146587,bsCqmtAqNaQCj21SXSVvraawvK1Xs7lq,7GRhBDsirIGkRZBtSMEzNTyDr2JQm4xx,28,23,13,85,1,0,2,0,124,17.714285714285715,1,0.0,9,13,73,1,14,0,12,2,0,96,28,1
15751,146593,dnF4V3J1QcZ16kz7ecUJEPAkM9rOV7wb,7GRhBDsirIGkRZBtSMEzNTyDr2JQm4xx,15,15,1,0,1,3,10,1,31,4.428571428571429,2,0.0,5,1,0,1,10,3,0,10,1,7,24,1
15752,146594,dzZvmhMBCZUS7A4bdHQZaWrZNWx9wlnR,7GRhBDsirIGkRZBtSMEzNTyDr2JQm4xx,1,0,0,0,0,0,1,0,1,0.14285714285714285,1,0.0,0,0,0,0,0,0,0,1,0,0,1,1
15753,146595,8RnmMwVYLkHQpIdFveSYXWCrUhHSKLGY,7GRhBDsirIGkRZBtSMEzNTyDr2JQm4xx,6,4,2,0,1,0,6,0,13,1.8571428571428572,1,0.0,0,2,0,1,4,0,0,6,0,3,10,0
15754,146597,hZ1mlUhiSpFjS9yt4BS7Q5R6oePk7XBR,7GRhBDsirIGkRZBtSMEzNTyDr2JQm4xx,9,3,2,4,2,0,6,0,17,2.4285714285714284,2,0.0,1,2,4,2,2,0,0,6,0,9,8,1
15755,146600,71W7HhcDinTUP0zgE4rLxxkJdz6hC2Hz,7GRhBDsirIGkRZBtSMEzNTyDr2JQm4xx,6,3,1,0,1,0,3,0,8,1.1428571428571428,1,0.0,1,1,0,1,2,0,0,3,0,3,5,1
15756,146601,9hgjLw4OD5u1XjZx0s9EMRnEguVXBlYy,7GRhBDsirIGkRZBtSMEzNTyDr2JQm4xx,5,4,1,0,1,0,1,0,7,1.0,1,0.0,0,1,0,1,4,0,0,1,0,2,5,1
15757,146604,ZsPJdwoEQb8InRLejOPcuY6swJrV6oQ3,7GRhBDsirIGkRZBtSMEzNTyDr2JQm4xx,13,13,8,2,5,0,8,0,36,5.142857142857143,1,0.0,1,8,1,5,12,0,1,8,0,15,21,0
15758,146606,NYjjMR7l6NyIwfJbId13oZriDSjO5w76,7GRhBDsirIGkRZBtSMEzNTyDr2JQm4xx,1,0,0,0,0,0,1,0,1,0.14285714285714285,1,0.0,0,0,0,0,0,0,0,1,0,0,1,1
15759,146611,l5helk32hI4ETTN4VOrcFpTlNH3wMw1m,7GRhBDsirIGkRZBtSMEzNTyDr2JQm4xx,1,0,0,0,0,0,1,0,1,0.14285714285714285,1,0.0,0,0,0,0,0,0,0,1,0,0,1,1
15760,146614,nYSFDE8RCbcZhD46fRSvPHUvA1ahfupi,7GRhBDsirIGkRZBtSMEzNTyDr2JQm4xx,1,0,0,0,0,0,1,0,1,0.14285714285714285,1,0.0,0,0,0,0,0,0,0,1,0,0,1,1
15761,146615,rmeg7X4GVDaLpVKMtXig1xBKyxmbOLNP,7GRhBDsirIGkRZBtSMEzNTyDr2JQm4xx,1,0,0,0,0,0,3,0,3,0.42857142857142855,2,0.0,0,0,0,0,0,0,0,3,0,0,3,0
15762,146620,Ie7mkAUCVVaLYxvosre748ADQJqirOJg,7GRhBDsirIGkRZBtSMEzNTyDr2JQm4xx,8,5,1,0,1,0,2,0,9,1.2857142857142858,1,0.0,0,1,0,1,5,0,0,2,0,2,7,0
15763,146623,0wC4PI4jS8ky1aVZrvOcvqnDnLi9NA2C,7GRhBDsirIGkRZBtSMEzNTyDr2JQm4xx,6,3,2,0,1,0,2,0,8,1.1428571428571428,1,0.0,0,2,0,1,3,0,0,2,0,3,5,1
15764,146624,YZyIrMXjSXhxrboobatJpuyyjWv0Oyj3,7GRhBDsirIGkRZBtSMEzNTyDr2JQm4xx,6,3,2,0,2,5,2,0,14,2.0,1,0.0,0,2,0,2,3,5,0,2,0,4,10,1
15765,146625,7MQqMUzAoBFEcqTatVu5Epa9H5xTJ6XT,7GRhBDsirIGkRZBtSMEzNTyDr2JQm4xx,7,3,2,0,2,0,2,0,9,1.2857142857142858,1,0.0,0,2,0,2,3,0,0,2,0,4,5,1
15766,146628,tXuRcAFaFByvXNxKsim61bqHMbW9oqtL,7GRhBDsirIGkRZBtSMEzNTyDr2JQm4xx,1,0,0,0,0,0,1,0,1,0.14285714285714285,1,0.0,0,0,0,0,0,0,0,1,0,0,1,1
15767,146629,8oJyzVb7BFYqXnIt8AZYBXv4pJ9iKX3G,7GRhBDsirIGkRZBtSMEzNTyDr2JQm4xx,2,0,0,0,0,0,2,0,2,0.2857142857142857,1,0.0,0,0,0,0,0,0,0,2,0,0,2,1
15768,146631,tVeEOWzSe7CPIDaNGoR1pPsk6HdeV1KT,7GRhBDsirIGkRZBtSMEzNTyDr2JQm4xx,5,3,1,0,1,0,1,0,6,0.8571428571428571,1,0.0,0,1,0,1,3,0,0,1,0,2,4,1
15769,146637,dY86ZxPBqjSMgAFRimg8dBRyb7lxvpAc,7GRhBDsirIGkRZBtSMEzNTyDr2JQm4xx,7,6,2,0,2,0,2,0,12,1.7142857142857142,1,0.0,0,2,0,2,6,0,0,2,0,4,8,1
15770,146644,bUoqFmbvMs2kDsdZ9ItKtLQ4XhI3NVJ3,7GRhBDsirIGkRZBtSMEzNTyDr2JQm4xx,4,0,0,0,0,0,4,1,5,0.7142857142857143,1,0.0,0,0,0,0,0,0,0,4,1,0,5,1
15771,146645,Izb8o21mmgCymJU96D1xtmXn2EAii5B9,7GRhBDsirIGkRZBtSMEzNTyDr2JQm4xx,2,0,0,0,0,0,2,0,2,0.2857142857142857,1,0.0,0,0,0,0,0,0,0,2,0,0,2,1
15772,146812,XagDu4hkCzepqbjuDS4lv6tXrIbANJ7d,3VkHkmOtom3jM2wCu94xgzzu1d6Dn7or,2,0,0,0,0,0,2,0,2,0.2857142857142857,1,0.0,0,0,0,0,0,0,0,2,0,0,2,1
15773,146813,aUc1hVYkIr3Bi8ayWwGmSU1k3jUQaTvk,3VkHkmOtom3jM2wCu94xgzzu1d6Dn7or,1,0,0,0,0,0,1,0,1,0.14285714285714285,1,0.0,0,0,0,0,0,0,0,1,0,0,1,1
15774,146819,N8lQ6CLzYLC3ZV1TIYvwSWjVTWycwKRr,3VkHkmOtom3jM2wCu94xgzzu1d6Dn7or,2,0,0,0,0,0,3,0,3,0.42857142857142855,2,0.0,0,0,0,0,0,0,0,3,0,0,3,1
15775,146821,vqyeWA2we44qvUIUFbVF8qhKfl0zvOXp,3VkHkmOtom3jM2wCu94xgzzu1d6Dn7or,49,34,16,15,16,0,4,0,85,12.142857142857142,3,0.0,15,16,15,16,19,0,0,4,0,62,23,1
15776,146823,8VkeQ6vW7DtspliemGGIOjJjjMTn28pE,3VkHkmOtom3jM2wCu94xgzzu1d6Dn7or,1,0,0,0,0,0,1,0,1,0.14285714285714285,1,0.0,0,0,0,0,0,0,0,1,0,0,1,1
15777,146824,jjOAKjtYOBkL8yZNAsflMgsU9RfSym9D,3VkHkmOtom3jM2wCu94xgzzu1d6Dn7or,5,10,3,0,3,0,3,0,19,2.7142857142857144,2,0.0,2,3,0,3,8,0,0,3,0,8,11,1
15778,146825,Tp2D7V75NteN6dQFehs9hNMrJBRpkxPX,3VkHkmOtom3jM2wCu94xgzzu1d6Dn7or,25,70,17,16,28,1,10,0,142,20.285714285714285,5,0.0,31,17,14,28,39,1,2,10,0,90,52,1
15779,146830,ctoPdFOBJpg0nTxrKk5e7epPXQMxn4iX,3VkHkmOtom3jM2wCu94xgzzu1d6Dn7or,12,11,3,0,4,2,8,1,29,4.142857142857143,2,0.0,0,3,0,4,11,2,0,8,1,7,22,1
15780,146833,V2iUVnY3CSvMzlrZ0MyTxlkeJjQz5mpT,3VkHkmOtom3jM2wCu94xgzzu1d6Dn7or,1,0,0,0,0,0,1,0,1,0.14285714285714285,1,0.0,0,0,0,0,0,0,0,1,0,0,1,1
15781,146835,VKiBSqrYzJuFe5S2BZbuXH48FUC79Gtr,3VkHkmOtom3jM2wCu94xgzzu1d6Dn7or,1,0,0,0,0,0,1,0,1,0.14285714285714285,1,0.0,0,0,0,0,0,0,0,1,0,0,1,1
15782,146839,YtCuvR5UYZ8LxqORGQ1uRsqkW1gtkDSJ,3VkHkmOtom3jM2wCu94xgzzu1d6Dn7or,14,15,6,2,6,3,20,1,53,7.571428571428571,2,0.0,6,6,2,6,9,3,0,20,1,20,33,1
15783,146846,An7AClehL7KKsUMywV24moWRw87BMWvj,3VkHkmOtom3jM2wCu94xgzzu1d6Dn7or,1,0,0,0,0,0,2,0,2,0.2857142857142857,1,0.0,0,0,0,0,0,0,0,2,0,0,2,1
15784,146855,1nspOxKjeqkzbhkH0i88IGU57XOmdJC9,3VkHkmOtom3jM2wCu94xgzzu1d6Dn7or,1,0,0,0,0,0,1,0,1,0.14285714285714285,1,0.0,0,0,0,0,0,0,0,1,0,0,1,1
15785,146856,BSqSPuPzdThO0IEloLvzaEvo8wlsTmWV,3VkHkmOtom3jM2wCu94xgzzu1d6Dn7or,1,0,0,0,0,0,1,0,1,0.14285714285714285,1,0.0,0,0,0,0,0,0,0,1,0,0,1,1
15786,146858,zP3de4W3VukAs6WLm1x1S3emx69koHez,3VkHkmOtom3jM2wCu94xgzzu1d6Dn7or,15,9,7,0,6,0,10,0,32,4.571428571428571,2,0.0,0,7,0,6,9,0,0,10,0,13,19,1
15787,146866,DEmzKJKEa87bk5Nj3kLKZfbzlMFWSTyw,3VkHkmOtom3jM2wCu94xgzzu1d6Dn7or,6,2,1,0,1,0,4,0,8,1.1428571428571428,1,0.0,0,1,0,1,2,0,0,4,0,2,6,0
15788,146867,8YR0tcT3D8d0JlIytw4LxKfYYQekJyvj,3VkHkmOtom3jM2wCu94xgzzu1d6Dn7or,6,8,3,0,0,0,4,0,15,2.142857142857143,1,0.0,0,3,0,0,8,0,0,4,0,3,12,1
15789,146869,kgifad5hWbJa54UiSAdJkYmaxfCMApM0,3VkHkmOtom3jM2wCu94xgzzu1d6Dn7or,18,16,8,1,7,3,6,0,41,5.857142857142857,2,0.0,5,8,1,7,11,3,0,6,0,21,20,1
15790,146873,snoVfOu7m3uQyb0rtN2hVEbVR2VoIt0E,3VkHkmOtom3jM2wCu94xgzzu1d6Dn7or,4,3,1,0,1,0,3,0,8,1.1428571428571428,1,0.0,0,1,0,1,3,0,0,3,0,2,6,1
15791,146878,cvqWICHAvT6CaBGvYZUWhvOAiDb9j0Me,3VkHkmOtom3jM2wCu94xgzzu1d6Dn7or,1,0,0,0,0,0,1,0,1,0.14285714285714285,1,0.0,0,0,0,0,0,0,0,1,0,0,1,1
15792,146881,h3aXpApcY8jToOsnJLXRcKr3ekv98gLc,3VkHkmOtom3jM2wCu94xgzzu1d6Dn7or,15,65,18,11,17,12,18,1,142,20.285714285714285,4,0.0,34,18,10,17,31,12,1,18,1,79,63,1
15793,146882,c1uYia723nClxDKNu9rmnYCUymt3ImcO,3VkHkmOtom3jM2wCu94xgzzu1d6Dn7or,8,3,2,0,2,0,3,0,10,1.4285714285714286,1,0.0,0,2,0,2,3,0,0,3,0,4,6,1
15794,146884,0EaAPD8sDKYTUVUuY5hfwfTg95KpJwaS,3VkHkmOtom3jM2wCu94xgzzu1d6Dn7or,4,2,1,0,0,0,3,0,6,0.8571428571428571,1,0.0,0,1,0,0,2,0,0,3,0,1,5,1
15795,146885,OZTh4ep7z08AOS3ZsuCu3y1D1zR5lDdF,3VkHkmOtom3jM2wCu94xgzzu1d6Dn7or,1,0,0,0,0,0,2,0,2,0.2857142857142857,1,0.0,0,0,0,0,0,0,0,2,0,0,2,1
15796,146886,RpeDfJx5VsHPwt60dv6agumhYI1jfzKU,3VkHkmOtom3jM2wCu94xgzzu1d6Dn7or,1,0,0,0,0,0,1,0,1,0.14285714285714285,1,0.0,0,0,0,0,0,0,0,1,0,0,1,1
15797,146889,Z9XzWzse1KPDWCqWuVan0KrksXlGEkQ7,3VkHkmOtom3jM2wCu94xgzzu1d6Dn7or,4,4,1,0,0,0,1,0,6,0.8571428571428571,1,0.0,0,1,0,0,4,0,0,1,0,1,5,1
15798,146900,UrENN1zIfJIc4hCxDDWe8c7coKokiTdF,3VkHkmOtom3jM2wCu94xgzzu1d6Dn7or,12,22,7,0,5,14,7,1,56,8.0,2,0.0,12,7,0,5,10,14,0,7,1,24,32,1
15799,146916,nC3nlEcInfZBkfWiBAFT0QImutSJIRDp,RXDvfPUBYFlVdlueBFbLW0mhhAyGEqpt,1,0,0,0,0,0,1,0,1,0.14285714285714285,1,0.0,0,0,0,0,0,0,0,1,0,0,1,1
15800,146924,gNoniBDFX51Yjk2gJg2vMlrLeNPSUasm,G8EPVSXsOYB5YQWZGiz1aVq5Pgr2GrQu,1,0,0,0,0,0,2,0,2,0.2857142857142857,1,0.0,0,0,0,0,0,0,0,2,0,0,2,1
15801,146944,w8NrkUwgMqb3O2jCUrmWBqs2yypNb8dq,RXDvfPUBYFlVdlueBFbLW0mhhAyGEqpt,18,28,3,28,1,0,11,0,71,10.142857142857142,3,0.0,3,3,26,1,25,0,2,11,0,33,38,1
15802,147012,T9AvdYMob6A7XymtAVQOWMZ2VKIDwWSx,RXDvfPUBYFlVdlueBFbLW0mhhAyGEqpt,8,4,0,0,0,1,9,2,16,2.2857142857142856,3,0.0,0,0,0,0,4,1,0,9,2,0,16,1
15803,147075,wVwBkRoAPUoV5PewFP4svSYnl1ZXoHnc,G8EPVSXsOYB5YQWZGiz1aVq5Pgr2GrQu,1,0,0,0,0,0,1,0,1,0.14285714285714285,1,0.0,0,0,0,0,0,0,0,1,0,0,1,1
15804,147096,MZsWffL53WPYhfyCR8aX3Mp9egHMC4ie,RXDvfPUBYFlVdlueBFbLW0mhhAyGEqpt,1,0,0,0,0,0,1,0,1,0.14285714285714285,1,0.0,0,0,0,0,0,0,0,1,0,0,1,1
15805,147103,114X1vLT3OTzchhxfRGg24FTsgrs6Boi,RXDvfPUBYFlVdlueBFbLW0mhhAyGEqpt,1,0,0,0,0,0,2,0,2,0.2857142857142857,1,0.0,0,0,0,0,0,0,0,2,0,0,2,1
15806,147112,sL5jw3pLWZoRI7avI17oM60mfF67Acgz,G8EPVSXsOYB5YQWZGiz1aVq5Pgr2GrQu,1,0,0,0,0,0,3,0,3,0.42857142857142855,3,0.0,0,0,0,0,0,0,0,3,0,0,3,0
15807,147144,a91ewPLjlp1X8KqwrnZISs7xgERRXuh7,RXDvfPUBYFlVdlueBFbLW0mhhAyGEqpt,1,0,0,0,0,0,1,0,1,0.14285714285714285,1,0.0,0,0,0,0,0,0,0,1,0,0,1,1
15808,147223,uUyznY5p2fw7hVKlngBtP5z29uUZt16H,RXDvfPUBYFlVdlueBFbLW0mhhAyGEqpt,1,0,0,0,0,0,1,0,1,0.14285714285714285,1,0.0,0,0,0,0,0,0,0,1,0,0,1,1
15809,147232,bkdCLvSthS1MubyKzxMCvPKPGG70pOZC,G8EPVSXsOYB5YQWZGiz1aVq5Pgr2GrQu,1,0,0,0,0,0,1,0,1,0.14285714285714285,1,0.0,0,0,0,0,0,0,0,1,0,0,1,0
15810,147287,yB2j2tPO2DVKCBBdsLv8a1lbHtfWINMh,RXDvfPUBYFlVdlueBFbLW0mhhAyGEqpt,1,0,0,0,0,0,1,0,1,0.14285714285714285,1,0.0,0,0,0,0,0,0,0,1,0,0,1,1
15811,147309,UfUYHtn7EFCFULfAAiVnfhKrcOfMt4Ug,G8EPVSXsOYB5YQWZGiz1aVq5Pgr2GrQu,1,0,0,0,0,0,1,0,1,0.14285714285714285,1,0.0,0,0,0,0,0,0,0,1,0,0,1,1
15812,147318,GONTKb318b2pNzO4RSf2Oav2TmqJo6yi,G8EPVSXsOYB5YQWZGiz1aVq5Pgr2GrQu,1,0,0,0,0,0,1,0,1,0.14285714285714285,1,0.0,0,0,0,0,0,0,0,1,0,0,1,1
15813,147344,fE8AsLCA0TCwN2lFIpEAgt949Oz2zi2M,G8EPVSXsOYB5YQWZGiz1aVq5Pgr2GrQu,1,0,0,0,0,0,1,0,1,0.14285714285714285,1,0.0,0,0,0,0,0,0,0,1,0,0,1,1
15814,147349,hRH67nWa9zgJtoi4yrmT3KmNMJoVcNRr,G8EPVSXsOYB5YQWZGiz1aVq5Pgr2GrQu,1,0,0,0,0,0,1,0,1,0.14285714285714285,1,0.0,0,0,0,0,0,0,0,1,0,0,1,1
15815,147376,aBcd5xuaSGFcCFUKcCSjEaSoJEfIPYAN,G8EPVSXsOYB5YQWZGiz1aVq5Pgr2GrQu,1,0,0,0,0,0,1,0,1,0.14285714285714285,1,0.0,0,0,0,0,0,0,0,1,0,0,1,1
15816,147407,SVxtFny9oPYbtoixSK2PAs9XNkM3e8hn,RXDvfPUBYFlVdlueBFbLW0mhhAyGEqpt,12,11,1,2,3,0,6,1,24,3.4285714285714284,2,0.0,4,1,2,3,7,0,0,6,1,10,14,1
15817,147416,Wi6NsYPSasqtq71046KwRwCUoJ7gSxqZ,G8EPVSXsOYB5YQWZGiz1aVq5Pgr2GrQu,29,42,24,44,0,38,28,3,179,25.571428571428573,3,0.0,12,24,30,0,30,38,14,28,3,66,113,1
15818,147480,SLkozwcHBufe0UPB64m4o1Ao551WfuNu,G8EPVSXsOYB5YQWZGiz1aVq5Pgr2GrQu,1,0,0,0,0,0,1,0,1,0.14285714285714285,1,0.0,0,0,0,0,0,0,0,1,0,0,1,1
15819,147501,Rw0pJvwCeS9P2HJebYz4vjMvliFwRI8o,G8EPVSXsOYB5YQWZGiz1aVq5Pgr2GrQu,9,2,1,0,1,0,7,2,13,1.8571428571428572,2,0.0,0,1,0,1,2,0,0,7,2,2,11,1
15820,147517,t3323TFWjEAQScP83AS7oMF9sZ2WNapI,G8EPVSXsOYB5YQWZGiz1aVq5Pgr2GrQu,1,0,0,0,0,0,1,0,1,0.14285714285714285,1,0.0,0,0,0,0,0,0,0,1,0,0,1,1
15821,147588,USLTnsAwagwK2c83KXd1SNEeENnzkTTo,RXDvfPUBYFlVdlueBFbLW0mhhAyGEqpt,1,0,0,0,0,0,1,0,1,0.14285714285714285,1,0.0,0,0,0,0,0,0,0,1,0,0,1,1
15822,147597,jN2uzyXO5CSzMfW3pp82AVUf4pDPwJuY,RXDvfPUBYFlVdlueBFbLW0mhhAyGEqpt,1,0,0,0,0,0,1,0,1,0.14285714285714285,1,0.0,0,0,0,0,0,0,0,1,0,0,1,1
15823,147600,cvwnd07iniLpbhx37I857HZu05eA9OFE,RXDvfPUBYFlVdlueBFbLW0mhhAyGEqpt,16,24,15,2,5,15,13,2,76,10.857142857142858,2,0.0,1,15,2,5,23,15,0,13,2,23,53,1
15824,147610,xLkdbbKQJbd2pVZCFImtrA3GPATvYGgD,G8EPVSXsOYB5YQWZGiz1aVq5Pgr2GrQu,1,0,0,0,0,0,1,0,1,0.14285714285714285,1,0.0,0,0,0,0,0,0,0,1,0,0,1,1
15825,147639,MU6JKjzSFjezaWPFdc0IJW3L2fftgaQZ,RXDvfPUBYFlVdlueBFbLW0mhhAyGEqpt,1,0,0,0,0,0,1,0,1,0.14285714285714285,1,0.0,0,0,0,0,0,0,0,1,0,0,1,1
15826,147658,htYzFBi86rzWlzEtyu7aNqTtL2SW6jzn,G8EPVSXsOYB5YQWZGiz1aVq5Pgr2GrQu,1,0,0,0,0,0,1,0,1,0.14285714285714285,1,0.0,0,0,0,0,0,0,0,1,0,0,1,1
15827,147673,5kCR1wjWWz9eEHdizA4crFyxKTH4mIdl,RXDvfPUBYFlVdlueBFbLW0mhhAyGEqpt,1,0,0,0,0,0,1,0,1,0.14285714285714285,1,0.0,0,0,0,0,0,0,0,1,0,0,1,1
15828,147711,Z96ghDF2SEO6eJyjMUuyfBwUaW4sni8D,G8EPVSXsOYB5YQWZGiz1aVq5Pgr2GrQu,12,25,5,4,4,0,6,1,45,6.428571428571429,3,0.0,11,5,2,4,14,0,2,6,1,22,23,1
15829,147717,i4fgy4BVHlpEBMVrUkI9gWLihOonqgFN,G8EPVSXsOYB5YQWZGiz1aVq5Pgr2GrQu,15,13,4,16,2,2,9,1,47,6.714285714285714,3,0.0,5,4,14,2,8,2,2,9,1,25,22,1
15830,147725,DJXPEOqclxMbkJva0g6MJfihz48JHIVn,G8EPVSXsOYB5YQWZGiz1aVq5Pgr2GrQu,1,0,0,0,0,0,1,0,1,0.14285714285714285,1,0.0,0,0,0,0,0,0,0,1,0,0,1,1
15831,147730,J5FkxM9o8L4y51xbaKwQjZuay8KpJMzH,G8EPVSXsOYB5YQWZGiz1aVq5Pgr2GrQu,1,0,0,0,0,0,1,0,1,0.14285714285714285,1,0.0,0,0,0,0,0,0,0,1,0,0,1,1
15832,147737,eXv6ACzt62C4hMSoDSIQMvmz4LEnGBtm,G8EPVSXsOYB5YQWZGiz1aVq5Pgr2GrQu,1,0,0,0,0,0,1,0,1,0.14285714285714285,1,0.0,0,0,0,0,0,0,0,1,0,0,1,1
15833,147758,jEGqrC42iEC0MkvaQaekkhZsW8YPZGtW,fbPkOYLVPtPgIt0MxizjfFJov3JbHyAi,1,0,0,0,0,0,1,0,1,0.14285714285714285,1,0.0,0,0,0,0,0,0,0,1,0,0,1,1
15834,147759,pFE82fh5DH8NUVtvV1y83suNQP2lNeAe,fbPkOYLVPtPgIt0MxizjfFJov3JbHyAi,7,11,5,0,2,0,4,0,22,3.142857142857143,3,0.0,1,5,0,2,10,0,0,4,0,8,14,1
15835,147761,6lr9avMLLLHkFmJUiXzIeIFidbBgUCxs,fbPkOYLVPtPgIt0MxizjfFJov3JbHyAi,9,12,6,0,4,0,4,0,26,3.7142857142857144,2,0.0,0,6,0,4,12,0,0,4,0,10,16,1
15836,147762,h6gp6OLQCLhKTyjanK3TbnUuf19NH0Ob,fbPkOYLVPtPgIt0MxizjfFJov3JbHyAi,1,0,0,0,0,0,1,0,1,0.14285714285714285,1,0.0,0,0,0,0,0,0,0,1,0,0,1,1
15837,147763,Eth5NiW62QeegjonEwzsKZ7huvzhHIVn,fbPkOYLVPtPgIt0MxizjfFJov3JbHyAi,1,0,0,0,0,0,1,0,1,0.14285714285714285,1,0.0,0,0,0,0,0,0,0,1,0,0,1,1
15838,147764,J2kOdVfbOVzDYlg6JttZzYj1ijMbmOfa,fbPkOYLVPtPgIt0MxizjfFJov3JbHyAi,9,5,3,0,3,0,2,0,13,1.8571428571428572,1,0.0,1,3,0,3,4,0,0,2,0,7,6,1
15839,147768,1YQhKlVbSWSyRB9mcpedGa7M41YWFSmU,fbPkOYLVPtPgIt0MxizjfFJov3JbHyAi,8,2,1,0,1,3,7,1,15,2.142857142857143,1,0.0,0,1,0,1,2,3,0,7,1,2,13,1
15840,147769,KDxyrbt1mVWE3rzc84dyTK3d2hDl8n9y,fbPkOYLVPtPgIt0MxizjfFJov3JbHyAi,5,0,0,0,0,0,5,1,6,0.8571428571428571,1,0.0,0,0,0,0,0,0,0,5,1,0,6,1
15841,147770,tKs772tHpR5tE8Ceee9VXQcqKPNhx6zt,fbPkOYLVPtPgIt0MxizjfFJov3JbHyAi,1,0,0,0,0,0,1,0,1,0.14285714285714285,1,0.0,0,0,0,0,0,0,0,1,0,0,1,1
15842,147771,o1Z0mcnOVXV8qXjqUo78WebzsF68mpLE,fbPkOYLVPtPgIt0MxizjfFJov3JbHyAi,6,5,3,0,3,0,3,0,14,2.0,1,0.0,1,3,0,3,4,0,0,3,0,7,7,1
15843,147772,mFN7ZQWOcVa7LiP8Oo1W0WPTVxvqcwqO,fbPkOYLVPtPgIt0MxizjfFJov3JbHyAi,13,11,8,0,5,3,1,0,28,4.0,1,0.0,2,8,0,5,9,3,0,1,0,15,13,1
15844,147773,PvYWxw3yEbAoadQAkzpd3k3f7OpG6DoE,fbPkOYLVPtPgIt0MxizjfFJov3JbHyAi,5,2,1,0,1,0,2,0,6,0.8571428571428571,1,0.0,0,1,0,1,2,0,0,2,0,2,4,1
15845,147774,GwBsELCYAYNo2pcJ3Hwab6UtiG3ye1Qj,fbPkOYLVPtPgIt0MxizjfFJov3JbHyAi,22,23,15,0,9,6,14,0,67,9.571428571428571,6,0.0,0,15,0,9,23,6,0,14,0,24,43,1
15846,147775,wm3H7yjZZekKOdpMLsAK0Ro798c59IP1,fbPkOYLVPtPgIt0MxizjfFJov3JbHyAi,5,2,1,0,1,0,2,0,6,0.8571428571428571,1,0.0,0,1,0,1,2,0,0,2,0,2,4,1
15847,147776,aeUD1Q8xXZqlrQjVnPDT03gNdmvseEAG,fbPkOYLVPtPgIt0MxizjfFJov3JbHyAi,1,0,0,0,0,0,1,0,1,0.14285714285714285,1,0.0,0,0,0,0,0,0,0,1,0,0,1,1
15848,147778,UqdW6exgqWwrDooHrQBPDZ2CP0Vab4m7,fbPkOYLVPtPgIt0MxizjfFJov3JbHyAi,5,2,1,0,1,0,2,0,6,0.8571428571428571,1,0.0,0,1,0,1,2,0,0,2,0,2,4,1
15849,147780,Ov4mGbTBr19epZTdyb8WcJdW9YbNKnAm,fbPkOYLVPtPgIt0MxizjfFJov3JbHyAi,6,4,1,0,1,0,4,0,10,1.4285714285714286,1,0.0,0,1,0,1,4,0,0,4,0,2,8,1
15850,147781,5xOYe3GtSFIz24skQDwp2bS5mtMryo1i,fbPkOYLVPtPgIt0MxizjfFJov3JbHyAi,5,2,1,0,1,0,3,0,7,1.0,1,0.0,0,1,0,1,2,0,0,3,0,2,5,1
15851,147782,D1P1Hsf44r0eDI7GpWUjS6UCddknnKAg,fbPkOYLVPtPgIt0MxizjfFJov3JbHyAi,1,0,0,0,0,0,1,0,1,0.14285714285714285,1,0.0,0,0,0,0,0,0,0,1,0,0,1,1
15852,147783,T24KPVGcghdv6P7ytQKE6lhStbj1tDHE,fbPkOYLVPtPgIt0MxizjfFJov3JbHyAi,7,3,2,0,2,0,2,0,9,1.2857142857142858,1,0.0,0,2,0,2,3,0,0,2,0,4,5,1
15853,147784,K1OObDgsc7SijBamTjkwfIoFyHtZ3ZU6,fbPkOYLVPtPgIt0MxizjfFJov3JbHyAi,11,14,8,0,6,1,7,1,37,5.285714285714286,1,0.0,2,8,0,6,12,1,0,7,1,16,21,1
15854,147785,hOKkjeN6nHMO6D4VBHXzVFHaUdaVhrEZ,fbPkOYLVPtPgIt0MxizjfFJov3JbHyAi,6,3,1,0,1,6,6,0,17,2.4285714285714284,1,0.0,0,1,0,1,3,6,0,6,0,2,15,1
15855,147786,TuaZjf9Q9UcuuonmpyeQa8sFOZhELQm1,fbPkOYLVPtPgIt0MxizjfFJov3JbHyAi,8,3,2,0,2,0,9,0,16,2.2857142857142856,1,0.0,0,2,0,2,3,0,0,9,0,4,12,1
15856,147787,H69WO9aanRW4gzX23LgvL4SatIAdfXLh,fbPkOYLVPtPgIt0MxizjfFJov3JbHyAi,1,0,0,0,0,0,1,0,1,0.14285714285714285,1,0.0,0,0,0,0,0,0,0,1,0,0,1,1
15857,147789,xJLiT7aQ8wJaqtjbqZPuNyUe7xsRIYUx,fbPkOYLVPtPgIt0MxizjfFJov3JbHyAi,10,5,2,0,3,0,8,2,20,2.857142857142857,1,0.0,2,2,0,3,3,0,0,8,2,7,13,1
15858,147790,EQQGIzDw0KP7FL3ru9SVFlekfV91SRlx,fbPkOYLVPtPgIt0MxizjfFJov3JbHyAi,7,3,2,0,2,0,2,0,9,1.2857142857142858,1,0.0,0,2,0,2,3,0,0,2,0,4,5,1
15859,147791,UGbvFlSQXPNfRziPAOx4kHkl79A7jmGG,fbPkOYLVPtPgIt0MxizjfFJov3JbHyAi,18,29,9,12,12,1,3,0,66,9.428571428571429,2,0.0,8,9,12,12,21,1,0,3,0,41,25,1
15860,147793,UHhf3OS5KTsSmirrMDTBosghF0Ip6ptz,fbPkOYLVPtPgIt0MxizjfFJov3JbHyAi,1,0,0,0,0,0,1,0,1,0.14285714285714285,1,0.0,0,0,0,0,0,0,0,1,0,0,1,1
15861,147794,KsHIB2XNLK7Fs02PF75Xmf4i3fa72rIT,fbPkOYLVPtPgIt0MxizjfFJov3JbHyAi,2,0,0,0,0,0,2,0,2,0.2857142857142857,1,0.0,0,0,0,0,0,0,0,2,0,0,2,1
15862,147821,vwPF6VT57NbHM7qmKbjBBFqRnUSU14SJ,5Gyp41oLVo7Gg7vF4vpmggWP5MU70QO6,6,12,1,0,1,0,3,0,17,2.4285714285714284,1,0.0,4,1,0,1,8,0,0,3,0,6,11,1
15863,147848,mcSjHTQSOL9z6LfIHOZuth326lgoEoEd,5Gyp41oLVo7Gg7vF4vpmggWP5MU70QO6,1,0,0,0,0,0,1,0,1,0.14285714285714285,1,0.0,0,0,0,0,0,0,0,1,0,0,1,1
15864,147861,r7ZNKfyPfaB5iuFN7dBvabbfUQsnLLIa,5Gyp41oLVo7Gg7vF4vpmggWP5MU70QO6,7,5,3,0,2,0,2,0,12,1.7142857142857142,1,0.0,0,3,0,2,5,0,0,2,0,5,7,1
15865,147862,hNGJlyUB2P1CG5JnrmgJCmY3fcQNspAh,5Gyp41oLVo7Gg7vF4vpmggWP5MU70QO6,1,0,0,0,0,0,1,0,1,0.14285714285714285,1,0.0,0,0,0,0,0,0,0,1,0,0,1,1
15866,147864,cYSbDpXSgB0u0usGKf1fSijPCnFEetgi,5Gyp41oLVo7Gg7vF4vpmggWP5MU70QO6,7,3,2,0,2,0,3,0,10,1.4285714285714286,2,0.0,0,2,0,2,3,0,0,3,0,4,6,1
15867,147897,GEeTuFvLbFBqRdEaOrJebonF0k4gv8Hl,5Gyp41oLVo7Gg7vF4vpmggWP5MU70QO6,7,4,2,0,1,0,2,0,9,1.2857142857142858,1,0.0,0,2,0,1,4,0,0,2,0,3,6,1
15868,147914,LFilEku9rIeW4NBW6GdXkxreRXuabrx6,5Gyp41oLVo7Gg7vF4vpmggWP5MU70QO6,1,0,0,0,0,0,1,0,1,0.14285714285714285,1,0.0,0,0,0,0,0,0,0,1,0,0,1,1
15869,147940,2jLM7Yi5RJYMPqOXOcapsjfy9JxX4cwG,5Gyp41oLVo7Gg7vF4vpmggWP5MU70QO6,1,0,0,0,0,0,1,0,1,0.14285714285714285,1,0.0,0,0,0,0,0,0,0,1,0,0,1,1
15870,147953,lgIEHykE0pF9d9IoqRRn9VtJnlpY5HJm,5Gyp41oLVo7Gg7vF4vpmggWP5MU70QO6,12,10,6,0,5,0,3,0,24,3.4285714285714284,2,0.0,1,6,0,5,9,0,0,3,0,12,12,1
15871,147977,4IEJgFckVDYyK0TdJX6AWQo7iRJxKRjO,5Gyp41oLVo7Gg7vF4vpmggWP5MU70QO6,4,2,1,0,1,0,1,0,5,0.7142857142857143,1,0.0,0,1,0,1,2,0,0,1,0,2,3,0
15872,147980,AHKBTPZSPkJAg7haUc3x41qrONIJZttH,5Gyp41oLVo7Gg7vF4vpmggWP5MU70QO6,7,3,2,0,2,0,2,0,9,1.2857142857142858,1,0.0,0,2,0,2,3,0,0,2,0,4,5,1
15873,147995,Kk4qLSQ2AxVjTd7A6tnZX4CxeQDvcBV6,5Gyp41oLVo7Gg7vF4vpmggWP5MU70QO6,1,0,0,0,0,0,1,0,1,0.14285714285714285,1,0.0,0,0,0,0,0,0,0,1,0,0,1,1
15874,147996,bfBxNQMcuVNW7LDD2R5yMC1xIByfnHXU,5Gyp41oLVo7Gg7vF4vpmggWP5MU70QO6,12,14,8,4,6,12,13,0,57,8.142857142857142,2,0.0,6,8,3,6,8,12,1,13,0,23,34,1
15875,148016,liVcNKuy8NKldEWBSMczxU7EXyV6T6hK,5Gyp41oLVo7Gg7vF4vpmggWP5MU70QO6,9,11,4,0,1,0,2,0,18,2.5714285714285716,1,0.0,0,4,0,1,11,0,0,2,0,5,13,1
15876,148018,kLbYKjAePyQg6GOXHiVGeoyhhDvXEfjN,5Gyp41oLVo7Gg7vF4vpmggWP5MU70QO6,8,10,5,0,4,9,6,0,34,4.857142857142857,2,0.0,1,5,0,4,9,9,0,6,0,10,24,1
15877,148045,EhHrinjt1AkEWC09AFZwBuP61S5NJgjn,5Gyp41oLVo7Gg7vF4vpmggWP5MU70QO6,5,3,2,0,1,0,2,0,8,1.1428571428571428,1,0.0,0,2,0,1,3,0,0,2,0,3,5,1
15878,148058,ZWfn9Qrexzw0TlKEc4xN96rrMrARFmjm,5Gyp41oLVo7Gg7vF4vpmggWP5MU70QO6,15,52,21,19,3,22,11,1,129,18.428571428571427,5,0.0,17,21,13,3,35,22,6,11,1,54,75,1
15879,148074,hAI9XjsP1LdynF1kDeMzEsHlT2S6mHfF,5Gyp41oLVo7Gg7vF4vpmggWP5MU70QO6,5,3,2,0,0,0,2,0,7,1.0,1,0.0,0,2,0,0,3,0,0,2,0,2,5,1
15880,148095,S6eQGQp3K76RS5VMtIsaLuIm5UHtwYF7,5Gyp41oLVo7Gg7vF4vpmggWP5MU70QO6,5,3,0,0,0,0,2,0,5,0.7142857142857143,1,0.0,0,0,0,0,3,0,0,2,0,0,5,1
15881,148101,VIOyemRRFrXWntjMeQE5BIDDfZKrmIOJ,5Gyp41oLVo7Gg7vF4vpmggWP5MU70QO6,16,19,7,34,1,0,3,0,64,9.142857142857142,2,0.0,9,7,30,1,10,0,4,3,0,47,17,1
15882,148145,9wg9m774iuq3pR6rOrvscc7iujIj3xXq,5Gyp41oLVo7Gg7vF4vpmggWP5MU70QO6,9,5,4,0,2,4,6,1,22,3.142857142857143,2,0.0,0,4,0,2,5,4,0,6,1,6,16,1
15883,148149,EfDeDofZCstYQkNYYHKFaYZxqK08b71W,5Gyp41oLVo7Gg7vF4vpmggWP5MU70QO6,10,10,4,2,2,0,3,0,21,3.0,1,0.0,3,4,1,2,7,0,1,3,0,10,11,1
15884,148185,nxuexUreiYSzpSapqT3MF6tzgH9I1i5D,5Gyp41oLVo7Gg7vF4vpmggWP5MU70QO6,1,0,0,0,0,0,1,0,1,0.14285714285714285,1,0.0,0,0,0,0,0,0,0,1,0,0,1,1
15885,148210,r0ZdlKlEsmKZY094aSTCPxTKx82Pv4jZ,5Gyp41oLVo7Gg7vF4vpmggWP5MU70QO6,1,0,0,0,0,0,2,0,2,0.2857142857142857,2,0.0,0,0,0,0,0,0,0,2,0,0,2,1
15886,148219,fdTsFUNyxhV3QSWRE8RUmvDPSdhQdl21,5Gyp41oLVo7Gg7vF4vpmggWP5MU70QO6,1,0,0,0,0,0,2,0,2,0.2857142857142857,1,0.0,0,0,0,0,0,0,0,2,0,0,2,1
15887,148228,oNZ3DXCkk7XW6inyhpsoUnmkrA33Svnv,5Gyp41oLVo7Gg7vF4vpmggWP5MU70QO6,1,0,0,0,0,0,1,0,1,0.14285714285714285,1,0.0,0,0,0,0,0,0,0,1,0,0,1,1
15888,148237,bABqZWLgkTHxk42Q4d3YNsSf4EbJAvcM,5Gyp41oLVo7Gg7vF4vpmggWP5MU70QO6,1,0,0,0,0,0,1,0,1,0.14285714285714285,1,0.0,0,0,0,0,0,0,0,1,0,0,1,1
15889,148249,9vLumExx1xl0nhuk7uTK1p4k831n5pUZ,5Gyp41oLVo7Gg7vF4vpmggWP5MU70QO6,5,5,2,0,0,0,2,0,9,1.2857142857142858,2,0.0,0,2,0,0,5,0,0,2,0,2,7,1
15890,148270,N8VKFfYaHOHH283pnOeVqQHkFc9l2CFJ,5Gyp41oLVo7Gg7vF4vpmggWP5MU70QO6,8,11,7,0,2,0,5,0,25,3.5714285714285716,4,0.0,0,7,0,2,11,0,0,5,0,9,16,1
15891,148282,JaeJlL8VWrTrl4h8J5ZbrhqwTWf0YYii,5Gyp41oLVo7Gg7vF4vpmggWP5MU70QO6,1,0,0,0,0,0,1,0,1,0.14285714285714285,1,0.0,0,0,0,0,0,0,0,1,0,0,1,1
15892,148299,eE1Ts31Y4vQL30WuFQSepkqre5sjHOf7,7GRhBDsirIGkRZBtSMEzNTyDr2JQm4xx,1,0,0,0,0,0,1,0,1,0.14285714285714285,1,0.0,0,0,0,0,0,0,0,1,0,0,1,1
15893,148301,elqCSd4eO0A49ONvuqE5ggawcusF9OMd,7GRhBDsirIGkRZBtSMEzNTyDr2JQm4xx,2,0,0,0,0,0,3,0,3,0.42857142857142855,1,0.0,0,0,0,0,0,0,0,3,0,0,3,1
15894,148304,6KxCV7VkkZIrRaqYpSYY89Ir7cXH4xtD,7GRhBDsirIGkRZBtSMEzNTyDr2JQm4xx,2,0,0,0,0,0,2,0,2,0.2857142857142857,1,0.0,0,0,0,0,0,0,0,2,0,0,2,1
15895,148315,jjzQh09Stl6cVXi1ZQo3Pv6tq0jdTVVF,7GRhBDsirIGkRZBtSMEzNTyDr2JQm4xx,15,9,6,0,7,0,4,0,26,3.7142857142857144,1,0.0,2,6,0,7,7,0,0,4,0,15,11,1
15896,148322,F0RLgmYiXL15kHHj9b0Z5YMHlqPfXUde,7GRhBDsirIGkRZBtSMEzNTyDr2JQm4xx,2,0,0,0,0,0,2,0,2,0.2857142857142857,1,0.0,0,0,0,0,0,0,0,2,0,0,2,1
15897,148327,gTiKF0u9RAj0oY7KbpTkxLnUSHlbIBy0,7GRhBDsirIGkRZBtSMEzNTyDr2JQm4xx,6,4,2,0,1,0,3,0,10,1.4285714285714286,1,0.0,0,2,0,1,4,0,0,3,0,3,7,0
15898,148334,7gxdF7npc77h7z0KnU9ezGYqtBJqY4fQ,7GRhBDsirIGkRZBtSMEzNTyDr2JQm4xx,40,58,22,52,18,3,11,2,166,23.714285714285715,5,0.0,30,22,48,18,28,3,4,11,2,118,48,0
15899,148335,o5YWOidjiSfpyoPVxXwOOyp6YMlu6cLI,7GRhBDsirIGkRZBtSMEzNTyDr2JQm4xx,8,2,2,0,2,0,3,0,9,1.2857142857142858,1,0.0,0,2,0,2,2,0,0,3,0,4,5,1
15900,148336,TeZXUSutbsmNXdzi2NrkH6J9hvtArj9z,7GRhBDsirIGkRZBtSMEzNTyDr2JQm4xx,1,0,0,0,0,0,1,0,1,0.14285714285714285,1,0.0,0,0,0,0,0,0,0,1,0,0,1,1
15901,148338,WAcTGSdYMLZyVm3rvDYowMxo60tUby3f,7GRhBDsirIGkRZBtSMEzNTyDr2JQm4xx,5,2,0,0,0,0,3,0,5,0.7142857142857143,1,0.0,0,0,0,0,2,0,0,3,0,0,5,0
15902,148343,N1Llejjvx4rBl0rzI2QI7SJmJJvL8DQz,7GRhBDsirIGkRZBtSMEzNTyDr2JQm4xx,8,6,1,0,1,0,2,0,10,1.4285714285714286,1,0.0,0,1,0,1,6,0,0,2,0,2,8,0
15903,148345,e12yxd6uz73QWrdry5pnSZL6kz47BqeT,7GRhBDsirIGkRZBtSMEzNTyDr2JQm4xx,1,0,0,0,0,0,1,0,1,0.14285714285714285,1,0.0,0,0,0,0,0,0,0,1,0,0,1,1
15904,148351,UuZ3VzxMOcv1pgBQfP1NUeudFRRQ1mRU,fbPkOYLVPtPgIt0MxizjfFJov3JbHyAi,8,3,2,0,2,0,4,0,11,1.5714285714285714,1,0.0,0,2,0,2,3,0,0,4,0,4,7,1
15905,148352,jHtmhjYvIQCrHvgDxRflQ5IxXJSVFYuQ,fbPkOYLVPtPgIt0MxizjfFJov3JbHyAi,5,6,2,0,0,0,2,0,10,1.4285714285714286,2,0.0,0,2,0,0,6,0,0,2,0,2,8,1
15906,148354,l20aBHleNKjK0XwZQWFPyPJB0cuojdw9,fbPkOYLVPtPgIt0MxizjfFJov3JbHyAi,5,2,1,0,1,0,4,0,8,1.1428571428571428,1,0.0,0,1,0,1,2,0,0,4,0,2,6,1
15907,148355,8PiAS0TmnQl9QEf7dgpgPmWaNztmfJVP,fbPkOYLVPtPgIt0MxizjfFJov3JbHyAi,9,7,4,0,4,0,3,0,18,2.5714285714285716,1,0.0,2,4,0,4,5,0,0,3,0,10,8,1
15908,148356,1FMoEHMl48zOO2kttHN9vLOQurH54seC,fbPkOYLVPtPgIt0MxizjfFJov3JbHyAi,6,7,3,0,2,0,4,0,16,2.2857142857142856,1,0.0,0,3,0,2,7,0,0,4,0,5,11,1
15909,148357,fyc4dkjFagB2LcZciRyqSJPoegzypBzy,fbPkOYLVPtPgIt0MxizjfFJov3JbHyAi,6,5,3,0,2,0,3,0,13,1.8571428571428572,1,0.0,0,3,0,2,5,0,0,3,0,5,8,1
15910,148359,uZ1O39GxSmePAndNprQEBYYChQSQNkhB,fbPkOYLVPtPgIt0MxizjfFJov3JbHyAi,23,30,18,13,11,0,9,1,82,11.714285714285714,4,0.0,4,18,11,11,26,0,2,9,1,44,38,1
15911,148360,wJP9G4aa97RALoz7jgfom2Is1dozR5XV,fbPkOYLVPtPgIt0MxizjfFJov3JbHyAi,8,10,7,0,4,0,3,0,24,3.4285714285714284,2,0.0,0,7,0,4,10,0,0,3,0,11,13,1
15912,148361,X0S4TDZgj5AsEY7rj0bHgFBmM1wEHl8g,fbPkOYLVPtPgIt0MxizjfFJov3JbHyAi,5,2,1,0,1,0,3,0,7,1.0,1,0.0,0,1,0,1,2,0,0,3,0,2,5,1
15913,148362,zo3To03Q5Rdok3x4Zu1wNdsKqNDBlzyd,fbPkOYLVPtPgIt0MxizjfFJov3JbHyAi,7,3,2,0,2,0,4,0,11,1.5714285714285714,1,0.0,0,2,0,2,3,0,0,4,0,4,7,1
15914,148363,mvWG8WfFoikkAB9Wg1mtbCZJVje4NMeg,fbPkOYLVPtPgIt0MxizjfFJov3JbHyAi,2,0,0,0,0,2,1,0,3,0.42857142857142855,1,0.0,0,0,0,0,0,2,0,1,0,0,3,1
15915,148364,8TsC1FJM6vJWYXxMn4XOpAyFu9uyBcwT,fbPkOYLVPtPgIt0MxizjfFJov3JbHyAi,3,0,0,0,0,0,3,0,3,0.42857142857142855,1,0.0,0,0,0,0,0,0,0,3,0,0,3,1
15916,148365,lQTp6SekPVZwhVL0coTG7jI0NerwwRXX,fbPkOYLVPtPgIt0MxizjfFJov3JbHyAi,1,0,0,0,0,0,1,0,1,0.14285714285714285,1,0.0,0,0,0,0,0,0,0,1,0,0,1,1
15917,148369,BZslXVbbVc1YaW2k5ccBUS6eiDl1WM07,fbPkOYLVPtPgIt0MxizjfFJov3JbHyAi,5,4,1,0,1,0,5,0,11,1.5714285714285714,1,0.0,2,1,0,1,2,0,0,5,0,4,7,1
15918,148370,O3TF3GdRfaqFBn0EbABVcwycS92XFqQI,fbPkOYLVPtPgIt0MxizjfFJov3JbHyAi,8,2,1,0,1,0,4,1,9,1.2857142857142858,1,0.0,0,1,0,1,2,0,0,4,1,2,7,1
15919,148372,RVf6e28k6GsRGb8DN1lRFhzAihWj6uwr,fbPkOYLVPtPgIt0MxizjfFJov3JbHyAi,6,6,1,0,2,0,2,0,11,1.5714285714285714,1,0.0,3,1,0,2,3,0,0,2,0,6,5,1
15920,148373,ajZe5IV50P9q1MwLuSJJxiEXkVsZl5Va,fbPkOYLVPtPgIt0MxizjfFJov3JbHyAi,9,4,2,0,3,0,2,0,11,1.5714285714285714,1,0.0,0,2,0,3,4,0,0,2,0,5,6,1
15921,148374,SkGT6P4CYkjpyqSl3XDsa9OtVYpbNLKc,fbPkOYLVPtPgIt0MxizjfFJov3JbHyAi,5,2,1,0,1,0,2,0,6,0.8571428571428571,1,0.0,0,1,0,1,2,0,0,2,0,2,4,1
15922,148376,OektSQ9TNN3cEy3ZKuUs35c7BdSOqtaQ,fbPkOYLVPtPgIt0MxizjfFJov3JbHyAi,6,5,3,0,2,0,5,0,15,2.142857142857143,1,0.0,0,3,0,2,5,0,0,5,0,5,10,1
15923,148377,9DQIIj4A47ahx19xY3qY5HPiF8T9NzKd,fbPkOYLVPtPgIt0MxizjfFJov3JbHyAi,5,3,1,0,1,0,2,0,7,1.0,1,0.0,0,1,0,1,3,0,0,2,0,2,5,1
15924,148380,mmXnUf3Xp68sXzzvqqAwsEL8YCYNkHx6,fbPkOYLVPtPgIt0MxizjfFJov3JbHyAi,12,11,7,0,6,0,6,0,30,4.285714285714286,2,0.0,2,7,0,6,9,0,0,6,0,15,15,1
15925,148386,3J1rNe3uRvedZitqeCdyMGosrBYsQChl,fbPkOYLVPtPgIt0MxizjfFJov3JbHyAi,43,71,40,1,28,0,16,0,156,22.285714285714285,5,0.0,15,40,1,28,56,0,0,16,0,84,72,0
15926,148387,LZ4FjsgtwzNif1KtUcVyAos1pH68eZ72,fbPkOYLVPtPgIt0MxizjfFJov3JbHyAi,1,0,0,0,0,0,1,0,1,0.14285714285714285,1,0.0,0,0,0,0,0,0,0,1,0,0,1,1
15927,148389,CSh5hGbaSFu2yCb31iVMOVwKocrH471Q,fbPkOYLVPtPgIt0MxizjfFJov3JbHyAi,5,2,1,0,1,0,2,0,6,0.8571428571428571,1,0.0,0,1,0,1,2,0,0,2,0,2,4,1
15928,148454,te56qI7gFuKkLlkl183DRyiCJEOrbcwN,G8EPVSXsOYB5YQWZGiz1aVq5Pgr2GrQu,21,8,7,26,5,0,5,0,51,7.285714285714286,2,0.0,0,7,22,5,8,0,4,5,0,34,17,1
15929,148458,VMUftRICmOOnQZ0My9Or4atgcbBsD9Pm,A3fsA9Zfv1X2fVEQhTw51lKENdNrEqT3,11,5,4,0,4,0,3,0,16,2.2857142857142856,2,0.0,0,4,0,4,5,0,0,3,0,8,8,1
15930,148471,kvxGydllm6BLbdP0nm9jaxgMVk1FHTYp,bWdj2GDclj5ofokWjzoa5jAwMkxCykd6,7,6,4,0,0,6,6,0,22,3.142857142857143,3,0.0,0,4,0,0,6,6,0,6,0,4,18,1
15931,148482,RyilkQdPLBJZ4lFr5oZI0Ei4sfkfiESh,A3fsA9Zfv1X2fVEQhTw51lKENdNrEqT3,11,5,4,0,4,0,2,0,15,2.142857142857143,1,0.0,0,4,0,4,5,0,0,2,0,8,7,1
15932,148501,4Tr4zS1WTYozCucBhtide31lwvTCWT44,SpATywNh6bZuzm8s1ceuBUnMUAeoAHHw,18,18,1,0,1,0,6,0,26,3.7142857142857144,1,0.0,0,1,0,1,18,0,0,6,0,2,24,0
15933,148536,uUMzdUTmgEhjr2EnA8XtLfriryCG2TOf,SpATywNh6bZuzm8s1ceuBUnMUAeoAHHw,33,35,0,25,0,14,12,2,88,12.571428571428571,3,0.0,11,0,23,0,24,14,2,12,2,34,54,0
15934,148537,Wz31P9oU8oqAKC2lD9NdSTmdPqPDYHDG,SpATywNh6bZuzm8s1ceuBUnMUAeoAHHw,22,24,14,2,8,0,6,0,54,7.714285714285714,3,0.0,0,14,2,8,24,0,0,6,0,24,30,0
15935,148582,57XEpd7q9eLjUEqADz7df27SQD70MfYe,bWdj2GDclj5ofokWjzoa5jAwMkxCykd6,1,0,0,0,0,0,1,0,1,0.14285714285714285,1,0.0,0,0,0,0,0,0,0,1,0,0,1,1
15936,148584,57XEpd7q9eLjUEqADz7df27SQD70MfYe,A3fsA9Zfv1X2fVEQhTw51lKENdNrEqT3,1,0,0,0,0,0,1,0,1,0.14285714285714285,1,0.0,0,0,0,0,0,0,0,1,0,0,1,1
15937,148587,LIH6u87VTR1542727Uc42mhP2iK5GaFP,SpATywNh6bZuzm8s1ceuBUnMUAeoAHHw,49,135,5,72,6,84,20,13,335,47.857142857142854,5,0.0,33,5,60,6,102,84,12,20,13,104,231,0
15938,148636,YGIT86NvFI4VgCaWYbdXDpMicnXWdkpA,SpATywNh6bZuzm8s1ceuBUnMUAeoAHHw,6,3,0,0,0,1,4,0,8,1.1428571428571428,1,0.0,0,0,0,0,3,1,0,4,0,0,8,1
15939,148653,fO1rPCd8LF1QZM5kj2eXZwLqI6uO4Zpz,A3fsA9Zfv1X2fVEQhTw51lKENdNrEqT3,58,57,43,54,19,6,14,1,194,27.714285714285715,5,0.0,2,43,43,19,55,6,11,14,1,107,87,1
15940,148664,8kDMxN2jxnl0uIdlggQjT6QmHT7F6WvQ,bWdj2GDclj5ofokWjzoa5jAwMkxCykd6,7,7,0,0,1,0,6,0,14,2.0,1,0.0,2,0,0,1,5,0,0,6,0,3,11,0
15941,148675,yIj21E2mCqn2XcQ0nicOfMS257aUaO89,SpATywNh6bZuzm8s1ceuBUnMUAeoAHHw,4,2,1,0,0,0,2,0,5,0.7142857142857143,1,0.0,0,1,0,0,2,0,0,2,0,1,4,1
15942,148683,yIj21E2mCqn2XcQ0nicOfMS257aUaO89,A3fsA9Zfv1X2fVEQhTw51lKENdNrEqT3,1,0,0,0,0,0,1,0,1,0.14285714285714285,1,0.0,0,0,0,0,0,0,0,1,0,0,1,1
15943,148692,XydvMA0BgL1Al10q3L0D2wz1Y6wVb2rC,A3fsA9Zfv1X2fVEQhTw51lKENdNrEqT3,21,21,13,0,9,0,6,0,49,7.0,3,0.0,0,13,0,9,21,0,0,6,0,22,27,0
15944,148693,X87AkROV0ttGnQ3ululsZr5YLOH5E6sv,SpATywNh6bZuzm8s1ceuBUnMUAeoAHHw,7,5,0,0,0,0,4,1,10,1.4285714285714286,1,0.0,0,0,0,0,5,0,0,4,1,0,10,1
15945,148694,XydvMA0BgL1Al10q3L0D2wz1Y6wVb2rC,bWdj2GDclj5ofokWjzoa5jAwMkxCykd6,25,29,21,0,14,0,8,1,73,10.428571428571429,4,0.0,2,21,0,14,27,0,0,8,1,37,36,0
15946,148703,8QMdlZxyKAn04Pw5BIZ4rThXz4ELvpac,5X6FeZozNMgE2VRi3MJYjkkFK8SETtu2,3,2,1,0,0,0,1,0,4,0.5714285714285714,1,0.0,0,1,0,0,2,0,0,1,0,1,3,1
15947,148706,uhhlffPGiUyqHwKWs4eYUM0KXbbqijwF,A3fsA9Zfv1X2fVEQhTw51lKENdNrEqT3,52,31,20,74,13,0,14,0,152,21.714285714285715,5,0.0,1,20,70,13,30,0,4,14,0,104,48,1
15948,148719,N3OsF9jMX2xD2050jaDhIqxda4oH2JqK,SpATywNh6bZuzm8s1ceuBUnMUAeoAHHw,6,1,1,0,1,0,4,0,7,1.0,1,0.0,0,1,0,1,1,0,0,4,0,2,5,1
15949,148727,ztmaclrddFYSGIsZoWSUrGCZBLNiuvyf,A3fsA9Zfv1X2fVEQhTw51lKENdNrEqT3,10,13,3,0,3,0,6,0,25,3.5714285714285716,4,0.0,0,3,0,3,13,0,0,6,0,6,19,1
15950,148759,wPfoqCyL8nnMnw3aXjeD5ZCbRsGcflJj,5X6FeZozNMgE2VRi3MJYjkkFK8SETtu2,8,2,1,0,1,1,6,1,12,1.7142857142857142,1,0.0,0,1,0,1,2,1,0,6,1,2,10,1
15951,148764,H8ezTdcT6g0YnTiYoF3JufrrIki7TyuK,SpATywNh6bZuzm8s1ceuBUnMUAeoAHHw,1,0,0,0,0,0,1,0,1,0.14285714285714285,1,0.0,0,0,0,0,0,0,0,1,0,0,1,1
15952,148771,TzODuX5kuf2iqGNG9vk0uMzeGNqx5LsA,5X6FeZozNMgE2VRi3MJYjkkFK8SETtu2,1,0,0,0,0,0,1,0,1,0.14285714285714285,1,0.0,0,0,0,0,0,0,0,1,0,0,1,1
15953,148774,IUpZNQQ76AoR385Wqa8vebjq7ArbhJTb,SpATywNh6bZuzm8s1ceuBUnMUAeoAHHw,2,0,0,0,0,0,3,0,3,0.42857142857142855,1,0.0,0,0,0,0,0,0,0,3,0,0,3,1
15954,148775,ekMrVrkv40HZdLDo9tqIMgEIyZWOta2b,SpATywNh6bZuzm8s1ceuBUnMUAeoAHHw,2,0,0,0,0,0,4,0,4,0.5714285714285714,1,0.0,0,0,0,0,0,0,0,4,0,0,4,1
15955,148782,aEQ5RWk2htbuTN4mvNYSDzvWipN5MIrs,SpATywNh6bZuzm8s1ceuBUnMUAeoAHHw,4,3,2,0,0,0,1,0,6,0.8571428571428571,1,0.0,0,2,0,0,3,0,0,1,0,2,4,1
15956,148830,9Se0fuNtnF0aDoUMyiU1YG9IfxiIm4MD,SpATywNh6bZuzm8s1ceuBUnMUAeoAHHw,6,6,1,0,0,1,5,0,13,1.8571428571428572,2,0.0,0,1,0,0,6,1,0,5,0,1,12,1
15957,148843,El7h5k9dEnkCTNiRD6ocpDGK1aq9r5Q4,SpATywNh6bZuzm8s1ceuBUnMUAeoAHHw,44,68,0,82,1,22,20,8,201,28.714285714285715,4,0.0,20,0,74,1,48,22,8,20,8,95,106,1
15958,148848,R2arBlVQ5DlnqBrwRZJfviZdapFQUxuy,A3fsA9Zfv1X2fVEQhTw51lKENdNrEqT3,7,4,3,0,3,0,6,0,16,2.2857142857142856,2,0.0,0,3,0,3,4,0,0,6,0,6,10,1
15959,148850,PBxGz02oVqhnVrBe7XS94DBCYm6qdsBz,5X6FeZozNMgE2VRi3MJYjkkFK8SETtu2,6,9,1,0,1,1,5,1,18,2.5714285714285716,2,0.0,4,1,0,1,5,1,0,5,1,6,12,1
15960,148853,GMzSpgZQ6jzVsfHn8W8i83JsYNxnP00b,SpATywNh6bZuzm8s1ceuBUnMUAeoAHHw,30,44,22,38,11,3,9,0,127,18.142857142857142,6,0.0,13,22,31,11,31,3,7,9,0,77,50,0
15961,148855,i7oHLg2mT287Keuj3rMh6YGhkeP2LXJu,SpATywNh6bZuzm8s1ceuBUnMUAeoAHHw,14,24,8,20,0,0,5,0,57,8.142857142857142,2,0.0,8,8,18,0,16,0,2,5,0,34,23,0
15962,148860,19rBJNWc3TdUmLpZx1LViNSUBx0S4WJI,RXDvfPUBYFlVdlueBFbLW0mhhAyGEqpt,43,109,3,94,4,22,16,2,250,35.714285714285715,5,0.0,18,3,78,4,91,22,16,16,2,103,147,0
15963,148862,tokl4cbgqenBB3p80DKDbEkMdt5UNKcq,bWdj2GDclj5ofokWjzoa5jAwMkxCykd6,1,0,0,0,0,0,1,0,1,0.14285714285714285,1,0.0,0,0,0,0,0,0,0,1,0,0,1,1
15964,148866,GMzSpgZQ6jzVsfHn8W8i83JsYNxnP00b,5X6FeZozNMgE2VRi3MJYjkkFK8SETtu2,7,19,6,0,6,0,7,0,38,5.428571428571429,5,0.0,10,6,0,6,9,0,0,7,0,22,16,0
15965,148872,qVcmGkb48Jwwh6kGDe1CyZ7Dz9mYTEB0,5X6FeZozNMgE2VRi3MJYjkkFK8SETtu2,18,42,10,25,17,6,14,1,115,16.428571428571427,2,0.0,29,10,21,17,13,6,4,14,1,77,38,1
15966,148887,3ZefMxrbuS4ZPh42woxBoX8qAAYX0xUm,SpATywNh6bZuzm8s1ceuBUnMUAeoAHHw,24,36,21,0,9,0,7,0,73,10.428571428571429,4,0.0,0,21,0,9,36,0,0,7,0,30,43,1
15967,148889,FfcTObRCiOI4G2Wr1mPTKVvYF2y6uaxX,SpATywNh6bZuzm8s1ceuBUnMUAeoAHHw,46,50,29,12,16,3,16,1,127,18.142857142857142,4,0.0,13,29,9,16,37,3,3,16,1,67,60,0
15968,148891,NeX5WIvNO61tAJ0N6KZLQNKDzSgefHyw,SpATywNh6bZuzm8s1ceuBUnMUAeoAHHw,9,4,3,0,3,0,2,0,12,1.7142857142857142,1,0.0,0,3,0,3,4,0,0,2,0,6,6,1
15969,148898,dmiS38puwcnYb2MLpVYDLXrff1rXPclk,SpATywNh6bZuzm8s1ceuBUnMUAeoAHHw,16,10,8,0,7,0,3,0,28,4.0,2,0.0,0,8,0,7,10,0,0,3,0,15,13,1
15970,148904,xIxATd7wQJbG534PldlbQAAGp3iomo3s,SpATywNh6bZuzm8s1ceuBUnMUAeoAHHw,44,63,24,41,11,0,7,0,146,20.857142857142858,3,0.0,22,24,39,11,41,0,2,7,0,96,50,1
15971,148914,LbPeDWFrn9j3yYrmiVi11XwmZSkXkuCH,RXDvfPUBYFlVdlueBFbLW0mhhAyGEqpt,7,1,1,0,1,0,4,0,7,1.0,1,0.0,0,1,0,1,1,0,0,4,0,2,5,1
15972,148932,f0CZWgfk8f6S4ovPwdy7Xv8E5izRkjyc,5X6FeZozNMgE2VRi3MJYjkkFK8SETtu2,14,24,1,16,5,0,6,0,52,7.428571428571429,3,0.0,11,1,14,5,13,0,2,6,0,31,21,1
15973,148949,KVBhg9xLiQ9g29dG7acnqU2JhAhcB1WP,SpATywNh6bZuzm8s1ceuBUnMUAeoAHHw,6,7,5,0,1,12,6,0,31,4.428571428571429,3,0.0,0,5,0,1,7,12,0,6,0,6,25,1
15974,148953,KVBhg9xLiQ9g29dG7acnqU2JhAhcB1WP,bWdj2GDclj5ofokWjzoa5jAwMkxCykd6,2,0,0,0,0,1,1,0,2,0.2857142857142857,1,0.0,0,0,0,0,0,1,0,1,0,0,2,1
15975,148956,ryiQYyVYMdwKFXJfIVJiBqI3D0XwNLw1,5X6FeZozNMgE2VRi3MJYjkkFK8SETtu2,1,0,0,0,0,0,1,0,1,0.14285714285714285,1,0.0,0,0,0,0,0,0,0,1,0,0,1,1
15976,148972,nCi2pdM7sw91EDGAoZtmNoRGljKaB4FL,SpATywNh6bZuzm8s1ceuBUnMUAeoAHHw,41,59,34,48,19,0,6,0,166,23.714285714285715,3,0.0,17,34,42,19,42,0,6,6,0,112,54,0
15977,148990,20I5SaS0igQRUVi5mJhXJNLvLOuP8SMJ,RXDvfPUBYFlVdlueBFbLW0mhhAyGEqpt,1,0,0,0,0,0,1,0,1,0.14285714285714285,1,0.0,0,0,0,0,0,0,0,1,0,0,1,1
15978,149000,Yb0bWnMJwOMhFqTdED4i9VTc62YQyUpV,SpATywNh6bZuzm8s1ceuBUnMUAeoAHHw,1,0,0,0,0,0,1,0,1,0.14285714285714285,1,0.0,0,0,0,0,0,0,0,1,0,0,1,1
15979,149016,BXEKxoXoxulJe6lVUNmBzkuoxML0RzPQ,SpATywNh6bZuzm8s1ceuBUnMUAeoAHHw,21,34,1,1,1,0,1,0,38,5.428571428571429,1,0.0,2,1,1,1,32,0,0,1,0,5,33,1
15980,149024,7FIeNTQkn5xTpBcMu7fzrbX3yIgG7ERg,SpATywNh6bZuzm8s1ceuBUnMUAeoAHHw,21,52,45,0,35,1,18,0,151,21.571428571428573,8,0.0,0,45,0,35,52,1,0,18,0,80,71,0
15981,149027,3aZ1iGazVEuu24IRiWpZVTgWZ6Q7Vofo,SpATywNh6bZuzm8s1ceuBUnMUAeoAHHw,22,32,17,37,0,2,3,0,91,13.0,2,0.0,13,17,31,0,19,2,6,3,0,61,30,1
15982,149033,SfdcNKoJXbzDoiv0d6m3J1MnlTZjsesZ,SpATywNh6bZuzm8s1ceuBUnMUAeoAHHw,8,14,2,0,1,0,4,0,21,3.0,3,0.0,2,2,0,1,12,0,0,4,0,5,16,1
15983,149052,SFeCvEaCETQJeu3FFmauW0GXxvNsOKkb,bWdj2GDclj5ofokWjzoa5jAwMkxCykd6,14,19,6,42,3,2,8,0,80,11.428571428571429,2,0.0,3,6,41,3,16,2,1,8,0,53,27,1
15984,149057,M2hSpM7Q5cwse5dwZYryzZEZOolQRWV5,5X6FeZozNMgE2VRi3MJYjkkFK8SETtu2,10,10,4,0,7,0,3,0,24,3.4285714285714284,1,0.0,4,4,0,7,6,0,0,3,0,15,9,1
15985,149077,tvs2CHlzCZXNqvPsCXS6KuyuottEQsCw,A3fsA9Zfv1X2fVEQhTw51lKENdNrEqT3,11,20,6,0,2,3,15,1,47,6.714285714285714,4,0.0,0,6,0,2,20,3,0,15,1,8,39,1
15986,149084,s3jLTFp9Aa0FyGIk76qh9bCcU2OTAS9C,SpATywNh6bZuzm8s1ceuBUnMUAeoAHHw,6,4,2,0,1,0,2,0,9,1.2857142857142858,1,0.0,1,2,0,1,3,0,0,2,0,4,5,0
15987,149087,SneRH8JK6KCMhHOEHp7Zi9NRJB5DLBI8,SpATywNh6bZuzm8s1ceuBUnMUAeoAHHw,15,31,2,17,2,6,3,0,61,8.714285714285714,2,0.0,13,2,14,2,18,6,3,3,0,31,30,1
15988,149088,VdBr9evtUZMzf2druMXhbLcZsJI81UOn,A3fsA9Zfv1X2fVEQhTw51lKENdNrEqT3,43,25,14,50,11,0,6,0,106,15.142857142857142,2,0.0,4,14,46,11,21,0,4,6,0,75,31,1
15989,149100,L6Z8ewPMlWVkLltZWo9qRrYBvHNEsyN9,SpATywNh6bZuzm8s1ceuBUnMUAeoAHHw,14,24,4,0,3,0,9,1,41,5.857142857142857,4,0.0,1,4,0,3,23,0,0,9,1,8,33,0
15990,149107,VBqVRYvmHSTJrZSLtOkPGmPd4zMnmfIN,G8EPVSXsOYB5YQWZGiz1aVq5Pgr2GrQu,1,0,0,0,0,0,1,0,1,0.14285714285714285,1,0.0,0,0,0,0,0,0,0,1,0,0,1,1
15991,149109,5is3QPvmCTb2wCYPovTArJero2U5eHRU,SpATywNh6bZuzm8s1ceuBUnMUAeoAHHw,23,44,17,41,0,10,13,1,126,18.0,6,0.0,20,17,33,0,24,10,8,13,1,70,56,0
15992,149136,lEJmKdFXtAaM5CwkVi4nzr2tROq80rBD,SpATywNh6bZuzm8s1ceuBUnMUAeoAHHw,13,12,1,10,1,0,1,0,25,3.5714285714285716,1,0.0,2,1,9,1,10,0,1,1,0,13,12,1
15993,149141,1Px8mT6Y4qLxWKg6f0R4TCxt82IPdFCu,5X6FeZozNMgE2VRi3MJYjkkFK8SETtu2,6,4,2,0,1,0,3,0,10,1.4285714285714286,1,0.0,0,2,0,1,4,0,0,3,0,3,7,1
15994,149147,CttUHIFDXoWTFOldpxfPnv8kQdVn6WXf,SpATywNh6bZuzm8s1ceuBUnMUAeoAHHw,34,27,21,0,16,13,9,1,87,12.428571428571429,1,0.0,0,21,0,16,27,13,0,9,1,37,50,1
15995,149160,aJHRT3LiLupkaY9OS8kHMvtwJmIsdmDj,A3fsA9Zfv1X2fVEQhTw51lKENdNrEqT3,1,0,0,0,0,0,1,0,1,0.14285714285714285,1,0.0,0,0,0,0,0,0,0,1,0,0,1,1
15996,149168,g1J6BQ7EhQE8jfd7gZPRzLZeukbRbkuA,SpATywNh6bZuzm8s1ceuBUnMUAeoAHHw,41,52,32,41,16,28,11,0,180,25.714285714285715,3,0.0,10,32,35,16,42,28,6,11,0,93,87,0
15997,149169,SG7N8DhpCuhIu06IIzLX0CSolbyIDsIx,A3fsA9Zfv1X2fVEQhTw51lKENdNrEqT3,16,10,7,0,7,0,4,0,28,4.0,4,0.0,0,7,0,7,10,0,0,4,0,14,14,1
15998,149170,Ne6uLEjSnwCkPDzKncZNflLBYo8N5PJH,SpATywNh6bZuzm8s1ceuBUnMUAeoAHHw,1,0,0,0,0,0,1,0,1,0.14285714285714285,1,0.0,0,0,0,0,0,0,0,1,0,0,1,1
15999,149173,MTBFJm3bIEaE6OQdIPJiDEIIoJhDDIeA,A3fsA9Zfv1X2fVEQhTw51lKENdNrEqT3,33,15,1,50,1,0,6,0,73,10.428571428571429,2,0.0,1,1,49,1,14,0,1,6,0,52,21,1
16000,149181,k9qkAQfy4XeOmkerjzzETP2NbMFDwdHY,bWdj2GDclj5ofokWjzoa5jAwMkxCykd6,1,0,0,0,0,0,1,0,1,0.14285714285714285,1,0.0,0,0,0,0,0,0,0,1,0,0,1,1
16001,149200,WNMY3WRE1kSjqqBi1gkUrP92tDh9JpnU,5X6FeZozNMgE2VRi3MJYjkkFK8SETtu2,18,15,6,16,10,0,2,0,49,7.0,1,0.0,8,6,14,10,7,0,2,2,0,38,11,1
16002,149220,PFMimFJA39XFKECXR8jGss6ZeLs5bQDv,G8EPVSXsOYB5YQWZGiz1aVq5Pgr2GrQu,5,11,5,0,2,0,2,0,20,2.857142857142857,1,0.0,0,5,0,2,11,0,0,2,0,7,13,0
16003,149251,nK3rDT3I0HOsKd8MAJyaw5mnBzHCmQCb,SpATywNh6bZuzm8s1ceuBUnMUAeoAHHw,14,28,1,24,1,0,4,0,58,8.285714285714286,2,0.0,4,1,21,1,24,0,3,4,0,27,31,1
16004,149272,NdGT0aUaY1CUUJSOG5FJEMeCynmm9MTf,SpATywNh6bZuzm8s1ceuBUnMUAeoAHHw,1,0,0,0,0,0,1,0,1,0.14285714285714285,1,0.0,0,0,0,0,0,0,0,1,0,0,1,1
16005,149278,xYR4QT7D1Ir7IcXwoJG6glCObnq7r3cB,SpATywNh6bZuzm8s1ceuBUnMUAeoAHHw,14,24,17,0,11,6,8,0,66,9.428571428571429,3,0.0,0,17,0,11,24,6,0,8,0,28,38,0
16006,149281,SSmzTwHw2pJ3n53tqYFDDB8Zh2JeAHoz,SpATywNh6bZuzm8s1ceuBUnMUAeoAHHw,34,48,21,34,9,1,14,1,128,18.285714285714285,3,0.0,23,21,31,9,25,1,3,14,1,84,44,1
16007,149287,XqrZf8R9BrkWGkETcqhxlHJsow5TwWGG,SpATywNh6bZuzm8s1ceuBUnMUAeoAHHw,11,13,6,0,5,0,4,0,28,4.0,2,0.0,4,6,0,5,9,0,0,4,0,15,13,1
16008,149303,qVL008tAQyHTveNNTUZJN2fiJMviNw9f,A3fsA9Zfv1X2fVEQhTw51lKENdNrEqT3,11,14,1,0,1,12,8,1,37,5.285714285714286,2,0.0,0,1,0,1,14,12,0,8,1,2,35,1
16009,149310,BzvsdR9I1rO5avcH9pAAdWx2ykx9DGYJ,SpATywNh6bZuzm8s1ceuBUnMUAeoAHHw,5,2,1,0,1,0,2,0,6,0.8571428571428571,1,0.0,0,1,0,1,2,0,0,2,0,2,4,1
16010,149325,clBoQvHF7hj2lt9aMKUGNE4YYTF1KNgv,5X6FeZozNMgE2VRi3MJYjkkFK8SETtu2,5,5,3,0,1,0,1,0,10,1.4285714285714286,1,0.0,0,3,0,1,5,0,0,1,0,4,6,1
16011,149332,9d8tCYKPfh5NHPKNlwRKmrZh3Cuf1Ls2,SpATywNh6bZuzm8s1ceuBUnMUAeoAHHw,41,115,45,15,16,5,23,4,223,31.857142857142858,7,0.0,3,45,12,16,112,5,3,23,4,76,147,0
16012,149337,w0fdzIIE8x2qbpek78nlo1eBbvbnmDpR,5X6FeZozNMgE2VRi3MJYjkkFK8SETtu2,1,0,0,0,0,0,1,0,1,0.14285714285714285,1,0.0,0,0,0,0,0,0,0,1,0,0,1,1
16013,149359,C5JjdaA2TpnbGFuMIjvBUyS5u6COBRuh,RXDvfPUBYFlVdlueBFbLW0mhhAyGEqpt,1,0,0,0,0,0,1,0,1,0.14285714285714285,1,0.0,0,0,0,0,0,0,0,1,0,0,1,1
16014,149362,5xmqtrbfbOcPs8SegyLeUDYY1VS45Di7,SpATywNh6bZuzm8s1ceuBUnMUAeoAHHw,7,2,0,0,0,0,6,1,9,1.2857142857142858,1,0.0,0,0,0,0,2,0,0,6,1,0,9,1
16015,149365,TiIxJTIN7tI8yF4YwMuZjwFItOZJF5Yy,A3fsA9Zfv1X2fVEQhTw51lKENdNrEqT3,4,2,0,0,0,0,2,0,4,0.5714285714285714,1,0.0,0,0,0,0,2,0,0,2,0,0,4,1
16016,149369,HbdIEiZ1jslj2pBp8czn7lhBbxLYjtpj,bWdj2GDclj5ofokWjzoa5jAwMkxCykd6,8,4,2,4,2,0,2,0,14,2.0,1,0.0,1,2,4,2,3,0,0,2,0,9,5,1
16017,149374,sTlxlEkJ3MbMUAeSajnaHOGfpyW9hgq1,5X6FeZozNMgE2VRi3MJYjkkFK8SETtu2,5,3,1,0,1,0,3,0,8,1.1428571428571428,2,0.0,0,1,0,1,3,0,0,3,0,2,6,1
16018,149375,Vh7yX7EtLuJVk9a93lhHFszTGZCV3lfy,G8EPVSXsOYB5YQWZGiz1aVq5Pgr2GrQu,1,0,0,0,0,0,1,0,1,0.14285714285714285,1,0.0,0,0,0,0,0,0,0,1,0,0,1,1
16019,149387,DqNAxwTcrk055KEf1va6hv0cFfrqGSiY,5X6FeZozNMgE2VRi3MJYjkkFK8SETtu2,2,0,0,0,0,0,2,0,2,0.2857142857142857,1,0.0,0,0,0,0,0,0,0,2,0,0,2,1
16020,149403,rA6mPEjcnShXmHCoEHgThQ4NwtVmX6Le,SpATywNh6bZuzm8s1ceuBUnMUAeoAHHw,16,15,11,2,6,0,6,0,40,5.714285714285714,3,0.0,0,11,2,6,15,0,0,6,0,19,21,1
16021,149415,Yg66KIeW6HpW8A6McI69z4EhaoNPdMGp,SpATywNh6bZuzm8s1ceuBUnMUAeoAHHw,11,13,1,15,0,1,2,0,32,4.571428571428571,1,0.0,6,1,13,0,7,1,2,2,0,20,12,1
16022,149416,PFJhF2sNLYftHHb21pjL43RM5viviTlT,SpATywNh6bZuzm8s1ceuBUnMUAeoAHHw,53,80,40,23,25,0,5,0,173,24.714285714285715,5,0.0,11,40,23,25,69,0,0,5,0,99,74,0
16023,149423,Pdvh6UTK9FXuCE4WVrV5Y121aJBdVbkt,RXDvfPUBYFlVdlueBFbLW0mhhAyGEqpt,31,80,50,21,13,48,18,1,231,33.0,5,0.0,13,50,21,13,67,48,0,18,1,97,134,0
16024,149431,I45Q3yivyiRN2kHVhbV8bUCfrXvtpUvU,SpATywNh6bZuzm8s1ceuBUnMUAeoAHHw,32,31,17,17,10,0,9,0,84,12.0,6,0.0,5,17,17,10,26,0,0,9,0,49,35,0
16025,149442,x0VzAeYdlywtGLqE1HF68qQMYZTLfsw9,RXDvfPUBYFlVdlueBFbLW0mhhAyGEqpt,1,0,0,0,0,0,1,0,1,0.14285714285714285,1,0.0,0,0,0,0,0,0,0,1,0,0,1,1
16026,149449,RthO8kTkOrnZ3vUDn574hHyfG3vroBt1,RXDvfPUBYFlVdlueBFbLW0mhhAyGEqpt,61,123,70,43,42,8,17,0,303,43.285714285714285,6,0.0,34,70,35,42,89,8,8,17,0,181,122,0
16027,149451,MxG2Ev7XiiMWM1pXw5Ve1ZD2Aymhanp7,G8EPVSXsOYB5YQWZGiz1aVq5Pgr2GrQu,1,0,0,0,0,0,1,0,1,0.14285714285714285,1,0.0,0,0,0,0,0,0,0,1,0,0,1,1
16028,149456,bw2aO24aZZlJC7FupBFz9UeLH8ZisJZV,bWdj2GDclj5ofokWjzoa5jAwMkxCykd6,1,0,0,0,0,0,1,0,1,0.14285714285714285,1,0.0,0,0,0,0,0,0,0,1,0,0,1,1
16029,149458,bw2aO24aZZlJC7FupBFz9UeLH8ZisJZV,A3fsA9Zfv1X2fVEQhTw51lKENdNrEqT3,1,0,0,0,0,0,1,0,1,0.14285714285714285,1,0.0,0,0,0,0,0,0,0,1,0,0,1,1
16030,149492,Ev6KS9MaK9gTGqPDnT9PUK5kybHZnCjh,RXDvfPUBYFlVdlueBFbLW0mhhAyGEqpt,55,128,60,21,41,21,33,14,318,45.42857142857143,6,0.0,2,60,15,41,126,21,6,33,14,118,200,1
16031,149496,ll005HPG7ZaR3qtTeRKa2vtc0cIY9x5g,SpATywNh6bZuzm8s1ceuBUnMUAeoAHHw,1,0,0,0,0,0,1,0,1,0.14285714285714285,1,0.0,0,0,0,0,0,0,0,1,0,0,1,1
16032,149522,WqAusnIIyrtKc88YNA1pWn9FFnkfXjMW,A3fsA9Zfv1X2fVEQhTw51lKENdNrEqT3,12,20,2,0,1,0,12,0,35,5.0,1,0.0,0,2,0,1,20,0,0,12,0,3,32,1
16033,149525,HPkALZZsSIxF1Lb5N1jgVgi94EMe9pvG,SpATywNh6bZuzm8s1ceuBUnMUAeoAHHw,14,11,4,19,2,0,9,0,45,6.428571428571429,3,0.0,7,4,16,2,4,0,3,9,0,29,16,1
16034,149526,CW7Zlsz0NoDYd7q0tu1Krgi9b7wpQUwQ,bWdj2GDclj5ofokWjzoa5jAwMkxCykd6,32,51,22,26,16,46,19,1,181,25.857142857142858,4,0.0,6,22,25,16,45,46,1,19,1,69,112,0
16035,149534,M6hmghWj9c26PhfYNN6D8AlzAKngSx0i,SpATywNh6bZuzm8s1ceuBUnMUAeoAHHw,11,8,7,0,4,0,3,0,22,3.142857142857143,4,0.0,0,7,0,4,8,0,0,3,0,11,11,0
16036,149536,HjhpW9eEgpgE58Xb0OPgU4Zbnp9D0GcO,SpATywNh6bZuzm8s1ceuBUnMUAeoAHHw,4,2,1,0,1,0,1,0,5,0.7142857142857143,1,0.0,0,1,0,1,2,0,0,1,0,2,3,1
16037,149554,0aomsNaDMmIRvMUNvKVIFXzFDfLWKysB,5X6FeZozNMgE2VRi3MJYjkkFK8SETtu2,5,5,2,0,2,0,3,0,12,1.7142857142857142,1,0.0,0,2,0,2,5,0,0,3,0,4,8,1
16038,149558,z5ywFg739wUMUKifaVGawZHvuIjyjgqA,SpATywNh6bZuzm8s1ceuBUnMUAeoAHHw,1,0,0,0,0,0,1,0,1,0.14285714285714285,1,0.0,0,0,0,0,0,0,0,1,0,0,1,0
16039,149561,TrByXrngJFQBlFEAy6ff6mNvizdClNy5,G8EPVSXsOYB5YQWZGiz1aVq5Pgr2GrQu,1,0,0,0,0,0,1,0,1,0.14285714285714285,1,0.0,0,0,0,0,0,0,0,1,0,0,1,1
16040,149572,PD0QXI0Ip2PVwJ6kJaKkkINkj7BvGZMC,A3fsA9Zfv1X2fVEQhTw51lKENdNrEqT3,3,1,0,0,0,0,12,0,13,1.8571428571428572,2,0.0,0,0,0,0,1,0,0,12,0,0,13,1
16041,149582,7404CggR60r0Jai2AiihoTIyQA4fQf7E,SpATywNh6bZuzm8s1ceuBUnMUAeoAHHw,27,36,17,2,11,14,5,0,85,12.142857142857142,2,0.0,2,17,2,11,34,14,0,5,0,32,53,0
16042,149612,dhNL51CrFkHxhMt1kiIq7Iu6BdYInJEB,RXDvfPUBYFlVdlueBFbLW0mhhAyGEqpt,28,46,4,12,2,24,9,15,112,16.0,4,0.0,0,4,10,2,46,24,2,9,15,16,96,1
16043,149621,C5vYoxVhGjVcDS1VlSbcj49VaHI9Xyqh,G8EPVSXsOYB5YQWZGiz1aVq5Pgr2GrQu,26,57,22,82,6,0,4,0,171,24.428571428571427,2,0.0,31,22,57,6,26,0,25,4,0,116,55,0
16044,149642,BvI5CiGNtYcKpjVG9fTMezMQs6vWmHfH,A3fsA9Zfv1X2fVEQhTw51lKENdNrEqT3,6,2,0,0,0,0,6,0,8,1.1428571428571428,2,0.0,0,0,0,0,2,0,0,6,0,0,8,1
16045,149663,zwfKDhPDJMb4V7XkEzph01CVUguniguo,bWdj2GDclj5ofokWjzoa5jAwMkxCykd6,1,0,0,0,0,0,1,0,1,0.14285714285714285,1,0.0,0,0,0,0,0,0,0,1,0,0,1,1
16046,149665,0k9erSYQLRK4wIQFPxo1tbDP6EMqZIo0,A3fsA9Zfv1X2fVEQhTw51lKENdNrEqT3,43,14,12,56,11,3,18,1,115,16.428571428571427,2,0.0,2,12,51,11,12,3,5,18,1,76,39,1
16047,149666,pAkhnLI0s5vboktZycO7Tobv6jbspULh,A3fsA9Zfv1X2fVEQhTw51lKENdNrEqT3,1,0,0,0,0,0,1,0,1,0.14285714285714285,1,0.0,0,0,0,0,0,0,0,1,0,0,1,1
16048,149696,MqwnRwvGOsrvVA4Qz9wyqfLYN5id1NHE,5X6FeZozNMgE2VRi3MJYjkkFK8SETtu2,1,0,0,0,0,0,1,0,1,0.14285714285714285,1,0.0,0,0,0,0,0,0,0,1,0,0,1,1
16049,149743,E7Frt6tr6owhsgLSRkD2PqDaTSKmNLId,RXDvfPUBYFlVdlueBFbLW0mhhAyGEqpt,1,0,0,0,0,0,2,0,2,0.2857142857142857,2,0.0,0,0,0,0,0,0,0,2,0,0,2,1
16050,149756,3gPbGxzoDDN9YTm77syKKM4Upb2G3bUj,A3fsA9Zfv1X2fVEQhTw51lKENdNrEqT3,18,13,8,0,6,0,6,0,33,4.714285714285714,1,0.0,0,8,0,6,13,0,0,6,0,14,19,1
16051,149761,QRKDYncXtzqUo7eYzl5ZNiNJ63G2lU5V,5X6FeZozNMgE2VRi3MJYjkkFK8SETtu2,4,9,1,5,2,0,1,0,18,2.5714285714285716,1,0.0,4,1,4,2,5,0,1,1,0,11,7,1
16052,149764,nKMPTOF6v1sp7aVmO78zmSRg9f9QXrTf,bWdj2GDclj5ofokWjzoa5jAwMkxCykd6,32,76,47,30,20,28,23,3,227,32.42857142857143,9,0.0,8,47,27,20,68,28,3,23,3,102,125,0
16053,149765,Q1kCLLQ1BtcGOGkbHuLMJ0kDU10M0QTF,bWdj2GDclj5ofokWjzoa5jAwMkxCykd6,1,0,0,0,0,0,1,0,1,0.14285714285714285,1,0.0,0,0,0,0,0,0,0,1,0,0,1,1
16054,149766,Q1kCLLQ1BtcGOGkbHuLMJ0kDU10M0QTF,5X6FeZozNMgE2VRi3MJYjkkFK8SETtu2,1,0,0,0,0,0,1,0,1,0.14285714285714285,1,0.0,0,0,0,0,0,0,0,1,0,0,1,1
16055,149769,9D6xPhMl6a6uIrJy4YEJKWzjU7r4dYlS,SpATywNh6bZuzm8s1ceuBUnMUAeoAHHw,31,32,2,52,1,1,3,0,91,13.0,2,0.0,10,2,43,1,22,1,9,3,0,56,35,0
16056,149798,xdSWJOkklt1feMPe59TTfCkpvZpm9Xg2,bWdj2GDclj5ofokWjzoa5jAwMkxCykd6,1,0,0,0,0,0,1,0,1,0.14285714285714285,1,0.0,0,0,0,0,0,0,0,1,0,0,1,1
16057,149815,wGN3pCdk72KFTm52vXIRH474TFtQqduI,5X6FeZozNMgE2VRi3MJYjkkFK8SETtu2,1,0,0,0,0,0,1,0,1,0.14285714285714285,1,0.0,0,0,0,0,0,0,0,1,0,0,1,1
16058,149820,iSiPEDuhdTDGTEOpkEJzXCeneTDhblqT,A3fsA9Zfv1X2fVEQhTw51lKENdNrEqT3,10,6,4,0,3,0,8,0,21,3.0,2,0.0,0,4,0,3,6,0,0,8,0,7,14,1
16059,149821,j7cR8MulZ7sIljFq9IIvuWVX0W2fGIFM,SpATywNh6bZuzm8s1ceuBUnMUAeoAHHw,28,40,20,24,8,12,17,0,121,17.285714285714285,8,0.0,6,20,20,8,34,12,4,17,0,54,67,0
16060,149825,H2B0ZVh2RYo5LjimmBQ15UDjcAOL7h2y,bWdj2GDclj5ofokWjzoa5jAwMkxCykd6,1,0,0,0,0,0,1,0,1,0.14285714285714285,1,0.0,0,0,0,0,0,0,0,1,0,0,1,1
16061,149848,C8zDhaG0vPsQegBtS55u3JZHiYuueFnE,RXDvfPUBYFlVdlueBFbLW0mhhAyGEqpt,9,12,2,0,2,0,6,0,22,3.142857142857143,4,0.0,0,2,0,2,12,0,0,6,0,4,18,1
16062,149850,WDMP5c2Ubx8vVSFegA0mXeU23cYb0qCY,5X6FeZozNMgE2VRi3MJYjkkFK8SETtu2,11,12,1,0,2,0,4,0,19,2.7142857142857144,2,0.0,2,1,0,2,10,0,0,4,0,5,14,1
16063,149868,LdPn5darYz0CtMZoZhN9Ts9NtxqTUSCW,G8EPVSXsOYB5YQWZGiz1aVq5Pgr2GrQu,7,1,1,0,1,1,5,1,10,1.4285714285714286,1,0.0,0,1,0,1,1,1,0,5,1,2,8,1
16064,149870,SBz1G9CPNh7b1YKxwzjWQ2S8H7JkEfYW,G8EPVSXsOYB5YQWZGiz1aVq5Pgr2GrQu,1,0,0,0,0,0,1,0,1,0.14285714285714285,1,0.0,0,0,0,0,0,0,0,1,0,0,1,1
16065,149880,0qIOrR65l5zNKz33fvwR4iUAwdU1mo6q,5X6FeZozNMgE2VRi3MJYjkkFK8SETtu2,1,0,0,0,0,0,1,0,1,0.14285714285714285,1,0.0,0,0,0,0,0,0,0,1,0,0,1,0
16066,149884,Z95Ku89uNGg04oFkXKdLR1VrvyAEL044,SpATywNh6bZuzm8s1ceuBUnMUAeoAHHw,28,32,1,30,0,9,6,1,79,11.285714285714286,2,0.0,8,1,28,0,24,9,2,6,1,37,42,0
16067,149893,h2B1FNld0JpBpcquk0mIhlA42aMWBy5C,G8EPVSXsOYB5YQWZGiz1aVq5Pgr2GrQu,1,0,0,0,0,0,2,0,2,0.2857142857142857,1,0.0,0,0,0,0,0,0,0,2,0,0,2,1
16068,149928,BRoMr6vuNj25y7f6Ps9m5C5BvYm4Gx6P,bWdj2GDclj5ofokWjzoa5jAwMkxCykd6,5,3,1,0,1,0,3,0,8,1.1428571428571428,1,0.0,0,1,0,1,3,0,0,3,0,2,6,1
16069,149938,zEQiQScIpc1hSOgBtA0a2snrDFq0NA2H,SpATywNh6bZuzm8s1ceuBUnMUAeoAHHw,22,24,8,44,2,9,11,0,98,14.0,3,0.0,15,8,38,2,9,9,6,11,0,63,35,1
16070,149976,6gWNl8crhOxwgA0Ij5LzJgWFSYDFCzaS,G8EPVSXsOYB5YQWZGiz1aVq5Pgr2GrQu,1,0,0,0,0,0,1,0,1,0.14285714285714285,1,0.0,0,0,0,0,0,0,0,1,0,0,1,1
16071,149984,0Qr6LYqQ87hJQw0Vk4piVrMBdlzeBLMC,SpATywNh6bZuzm8s1ceuBUnMUAeoAHHw,5,2,1,0,1,0,2,0,6,0.8571428571428571,1,0.0,0,1,0,1,2,0,0,2,0,2,4,1
16072,149994,VazJRpUfnmR6XNAcZmdWx2mIb59m7oil,SpATywNh6bZuzm8s1ceuBUnMUAeoAHHw,5,8,0,0,0,0,2,0,10,1.4285714285714286,1,0.0,2,0,0,0,6,0,0,2,0,2,8,1
16073,150003,VKJjUOOe4hHNRYTnf34iUAPfHZJRzDEL,SpATywNh6bZuzm8s1ceuBUnMUAeoAHHw,1,0,0,0,0,0,1,0,1,0.14285714285714285,1,0.0,0,0,0,0,0,0,0,1,0,0,1,1
16074,150005,D5IkCYseUCO88GE1B1rMaRAAZyqCPk5T,SpATywNh6bZuzm8s1ceuBUnMUAeoAHHw,18,81,17,16,3,8,28,2,155,22.142857142857142,7,0.0,20,17,14,3,61,8,2,28,2,54,101,0
16075,150011,YZSZ4TOtqHUreAioK1x0YBDmIRumwoti,RXDvfPUBYFlVdlueBFbLW0mhhAyGEqpt,14,9,6,22,0,0,2,0,39,5.571428571428571,1,0.0,2,6,20,0,7,0,2,2,0,28,11,1
16076,150022,xlQaV1k3cIE4ajIy7pLBjRvlUya2da9J,SpATywNh6bZuzm8s1ceuBUnMUAeoAHHw,1,0,0,0,0,0,1,0,1,0.14285714285714285,1,0.0,0,0,0,0,0,0,0,1,0,0,1,1
16077,150027,rlxEJaX8MPFosGD2TJpTUsaXJqED2SzG,SpATywNh6bZuzm8s1ceuBUnMUAeoAHHw,1,0,0,0,0,0,1,0,1,0.14285714285714285,1,0.0,0,0,0,0,0,0,0,1,0,0,1,1
16078,150034,dU7DqQeRV0VJw1owh3rH0rASxy6mSG05,RXDvfPUBYFlVdlueBFbLW0mhhAyGEqpt,8,5,2,0,2,2,3,0,14,2.0,2,0.0,0,2,0,2,5,2,0,3,0,4,10,1
16079,150066,kFq2dX2idryINNQb9BQiBNQL0jaWL2j5,A3fsA9Zfv1X2fVEQhTw51lKENdNrEqT3,17,13,9,0,8,0,10,0,40,5.714285714285714,2,0.0,0,9,0,8,13,0,0,10,0,17,23,1
16080,150069,FWX9YkLyj47mhurdCZuuv2217ViDfzCr,bWdj2GDclj5ofokWjzoa5jAwMkxCykd6,2,0,0,0,0,0,3,0,3,0.42857142857142855,1,0.0,0,0,0,0,0,0,0,3,0,0,3,1
16081,150094,SQ9o8jmVxrsXDCSp6tUg4ljuZWybDROh,SpATywNh6bZuzm8s1ceuBUnMUAeoAHHw,4,2,1,0,1,0,1,0,5,0.7142857142857143,1,0.0,0,1,0,1,2,0,0,1,0,2,3,1
16082,150105,G2qtWwR1edRN2N5qfu1AgRch8m00Htg9,SpATywNh6bZuzm8s1ceuBUnMUAeoAHHw,43,50,23,27,14,9,10,0,133,19.0,7,0.0,7,23,26,14,43,9,1,10,0,70,63,1
16083,150109,gi01S7jVC7j5JiJq4Tw62NMLgY0GYZHL,A3fsA9Zfv1X2fVEQhTw51lKENdNrEqT3,45,28,17,80,10,15,9,2,161,23.0,2,0.0,2,17,62,10,26,15,18,9,2,91,70,1
16084,150112,kvTHl55PsMKRRknO7mk3MdHzvNMAhKWW,G8EPVSXsOYB5YQWZGiz1aVq5Pgr2GrQu,73,108,40,231,0,6,24,0,409,58.42857142857143,4,0.0,56,40,172,0,52,6,59,24,0,268,141,0
16085,150117,hRgjZS8yzI2W3b7txu2qLb9XapYY2R7B,SpATywNh6bZuzm8s1ceuBUnMUAeoAHHw,1,0,0,0,0,0,2,0,2,0.2857142857142857,2,0.0,0,0,0,0,0,0,0,2,0,0,2,1
16086,150122,TRBNObHWjWIJybiaNzbPzTRx9rqmfcI5,5Gyp41oLVo7Gg7vF4vpmggWP5MU70QO6,4,1,0,0,0,0,4,0,5,0.7142857142857143,1,0.0,0,0,0,0,1,0,0,4,0,0,5,1
16087,150141,vHiRvEU4iKG66pgKVJkoG6qQeXm9Pv8Z,5Gyp41oLVo7Gg7vF4vpmggWP5MU70QO6,7,3,2,0,2,0,3,0,10,1.4285714285714286,3,0.0,0,2,0,2,3,0,0,3,0,4,6,0
16088,150159,u9t7L5ADqPlElboUfvRm6YfZ1n226qPR,5Gyp41oLVo7Gg7vF4vpmggWP5MU70QO6,1,0,0,0,0,0,1,0,1,0.14285714285714285,1,0.0,0,0,0,0,0,0,0,1,0,0,1,1
16089,150165,ojAJidCORLagMUkoeibYALlr3Dd119Eb,5Gyp41oLVo7Gg7vF4vpmggWP5MU70QO6,1,0,0,0,0,0,2,0,2,0.2857142857142857,2,0.0,0,0,0,0,0,0,0,2,0,0,2,1
16090,150170,cParK6VylJM5zDPedDQJj1iHaLQmTUkO,5Gyp41oLVo7Gg7vF4vpmggWP5MU70QO6,5,2,1,0,1,0,2,0,6,0.8571428571428571,2,0.0,0,1,0,1,2,0,0,2,0,2,4,1
16091,150218,Oqfkhjg6t51PZcyyCwvjWtQ6bDHYceB1,5Gyp41oLVo7Gg7vF4vpmggWP5MU70QO6,14,13,8,0,4,4,6,2,37,5.285714285714286,1,0.0,2,8,0,4,11,4,0,6,2,14,23,1
16092,150227,PbgdUFB40mRi05voFmqaPWh8FWsQSZBC,5Gyp41oLVo7Gg7vF4vpmggWP5MU70QO6,7,3,2,2,1,0,2,0,10,1.4285714285714286,1,0.0,0,2,1,1,3,0,1,2,0,4,6,1
16093,150234,hU8N8VVEHrSIWqoQgU73zqdMqJqog2Kf,5Gyp41oLVo7Gg7vF4vpmggWP5MU70QO6,6,4,2,0,1,0,3,0,10,1.4285714285714286,2,0.0,0,2,0,1,4,0,0,3,0,3,7,1
16094,150238,xlQaV1k3cIE4ajIy7pLBjRvlUya2da9J,5Gyp41oLVo7Gg7vF4vpmggWP5MU70QO6,1,0,0,0,0,0,1,0,1,0.14285714285714285,1,0.0,0,0,0,0,0,0,0,1,0,0,1,1
16095,150240,IBQysHUoQXmLOs1Zq1ObfjjQgLUHbetv,5Gyp41oLVo7Gg7vF4vpmggWP5MU70QO6,9,15,5,0,1,0,14,1,36,5.142857142857143,2,0.0,0,5,0,1,15,0,0,14,1,6,30,1
16096,150259,pBAt7KM50uZ5CSaZdFcjJhWNyJU1a49b,5Gyp41oLVo7Gg7vF4vpmggWP5MU70QO6,1,0,0,0,0,0,2,0,2,0.2857142857142857,1,0.0,0,0,0,0,0,0,0,2,0,0,2,1
16097,150289,6MtNOoE4DT84neYSq4FacOIfH9AJawPv,5Gyp41oLVo7Gg7vF4vpmggWP5MU70QO6,5,2,1,0,1,0,4,0,8,1.1428571428571428,1,0.0,0,1,0,1,2,0,0,4,0,2,6,1
16098,150305,6LSxEzHekfBjzdBuVJRrkvGn3CBVWXBO,5Gyp41oLVo7Gg7vF4vpmggWP5MU70QO6,12,14,7,0,3,4,8,1,37,5.285714285714286,3,0.0,0,7,0,3,14,4,0,8,1,10,27,1
16099,150336,ounIJVGj3D0OEROlO3D5y4OClv9XSROt,5Gyp41oLVo7Gg7vF4vpmggWP5MU70QO6,12,14,7,2,3,2,6,1,35,5.0,2,0.0,3,7,1,3,11,2,1,6,1,14,21,1
16100,150346,8uxWfB8oDdu0sXPUJZJL94EyUXC56QcI,5Gyp41oLVo7Gg7vF4vpmggWP5MU70QO6,11,11,5,0,2,0,4,0,22,3.142857142857143,1,0.0,2,5,0,2,9,0,0,4,0,9,13,0
16101,150369,AsCRvwtleeGS6D6WD7MD0zpcijqiUpJg,5Gyp41oLVo7Gg7vF4vpmggWP5MU70QO6,7,12,4,0,1,23,8,1,49,7.0,4,0.0,0,4,0,1,12,23,0,8,1,5,44,1
16102,150378,m7LPs49nHZUcvz2esAX8UbdKFZVSnWet,5Gyp41oLVo7Gg7vF4vpmggWP5MU70QO6,10,11,5,2,2,1,3,0,24,3.4285714285714284,3,0.0,1,5,1,2,10,1,1,3,0,9,15,1
16103,150384,9T6sJuPiEkwFHn4VyREnKyR6Ni1hFol4,5Gyp41oLVo7Gg7vF4vpmggWP5MU70QO6,9,6,1,0,0,1,6,1,15,2.142857142857143,1,0.0,0,1,0,0,6,1,0,6,1,1,14,1
16104,150407,YRvoydpc37Vpysmtw8O9rzowfgsZu7lO,5Gyp41oLVo7Gg7vF4vpmggWP5MU70QO6,8,5,3,0,2,0,2,0,12,1.7142857142857142,1,0.0,1,3,0,2,4,0,0,2,0,6,6,1
16105,150445,Q2lItPo8BYO6wobNvEQvbxDBBHBQ9kpC,5Gyp41oLVo7Gg7vF4vpmggWP5MU70QO6,1,0,0,0,0,0,1,0,1,0.14285714285714285,1,0.0,0,0,0,0,0,0,0,1,0,0,1,1
16106,150448,M4ZErUfwHYj5OXVgTBrfDNh3oNvQb92M,5Gyp41oLVo7Gg7vF4vpmggWP5MU70QO6,14,23,9,0,7,1,16,1,57,8.142857142857142,2,0.0,7,9,0,7,16,1,0,16,1,23,34,1
16107,150494,73RkwvOyVW3UHI251B2fOqBc8HlBGm1T,5Gyp41oLVo7Gg7vF4vpmggWP5MU70QO6,1,0,0,0,0,0,1,0,1,0.14285714285714285,1,0.0,0,0,0,0,0,0,0,1,0,0,1,1
16108,150509,QbtYUbBGIlNsSyTF9a1cqHwNS423I4zq,5Gyp41oLVo7Gg7vF4vpmggWP5MU70QO6,7,4,2,0,1,0,3,0,10,1.4285714285714286,2,0.0,0,2,0,1,4,0,0,3,0,3,7,1
16109,150512,C8siiCYreGRtwXrrqTKm8G2sId3UVfIz,5Gyp41oLVo7Gg7vF4vpmggWP5MU70QO6,7,3,2,0,2,0,2,0,9,1.2857142857142858,1,0.0,0,2,0,2,3,0,0,2,0,4,5,1
16110,150524,fJzMxSRB3WKUuLuE0D3bPFKYkkxD2yF6,5Gyp41oLVo7Gg7vF4vpmggWP5MU70QO6,5,2,1,0,1,0,2,0,6,0.8571428571428571,1,0.0,0,1,0,1,2,0,0,2,0,2,4,1
16111,150541,Ear5cTswifRZVshIanxSafkKiBm15Bfw,5Gyp41oLVo7Gg7vF4vpmggWP5MU70QO6,8,6,4,0,3,3,3,0,19,2.7142857142857144,2,0.0,0,4,0,3,6,3,0,3,0,7,12,1
16112,150544,XoXjEl7H7ZQGZLpYuhcIjuNQzpghD8Gl,5Gyp41oLVo7Gg7vF4vpmggWP5MU70QO6,1,0,0,0,0,0,1,0,1,0.14285714285714285,1,0.0,0,0,0,0,0,0,0,1,0,0,1,1
16113,150587,I97ZkJq1xt7pItpDNG8lgAeSX27lyLIB,5Gyp41oLVo7Gg7vF4vpmggWP5MU70QO6,1,0,0,0,0,0,1,0,1,0.14285714285714285,1,0.0,0,0,0,0,0,0,0,1,0,0,1,1
16114,150598,ZlXHJfoZMD5PykRnqIfcXnGutzqj3HS4,5Gyp41oLVo7Gg7vF4vpmggWP5MU70QO6,6,5,2,0,0,0,3,0,10,1.4285714285714286,2,0.0,0,2,0,0,5,0,0,3,0,2,8,1
16115,150637,oK8MXqkNHg6R0zgjZMn5TIW5ujaCXo9P,5Gyp41oLVo7Gg7vF4vpmggWP5MU70QO6,9,5,4,0,3,0,1,0,13,1.8571428571428572,1,0.0,0,4,0,3,5,0,0,1,0,7,6,1
16116,150646,hQQKu1XLTkk3Z1qm4WNBWkjmc5yKmP4O,5Gyp41oLVo7Gg7vF4vpmggWP5MU70QO6,7,6,2,0,2,0,2,0,12,1.7142857142857142,2,0.0,3,2,0,2,3,0,0,2,0,7,5,1
16117,150650,naxKR41ibDRek43Y5XpbLNi2FZgIDzJx,5Gyp41oLVo7Gg7vF4vpmggWP5MU70QO6,1,0,0,0,0,0,1,0,1,0.14285714285714285,1,0.0,0,0,0,0,0,0,0,1,0,0,1,1
16118,150652,YhAiXC8zlbufbcQ4dz0bTgKxFmv60Ja7,5Gyp41oLVo7Gg7vF4vpmggWP5MU70QO6,1,0,0,0,0,0,1,0,1,0.14285714285714285,1,0.0,0,0,0,0,0,0,0,1,0,0,1,1
16119,150656,hjIy2H4nj9jJ4fRj6OOsBlq6scMJN14Z,5Gyp41oLVo7Gg7vF4vpmggWP5MU70QO6,5,2,1,0,1,0,2,0,6,0.8571428571428571,1,0.0,0,1,0,1,2,0,0,2,0,2,4,1
16120,150660,wTVoO7ik0Mrv1QANtDwL7WrVwrAPOmpI,5Gyp41oLVo7Gg7vF4vpmggWP5MU70QO6,5,2,1,0,1,0,2,0,6,0.8571428571428571,1,0.0,0,1,0,1,2,0,0,2,0,2,4,1
16121,150674,zxNHBsmZ7DplWkpoX0woIpaENodcvDoT,5Gyp41oLVo7Gg7vF4vpmggWP5MU70QO6,2,0,0,0,0,0,2,0,2,0.2857142857142857,1,0.0,0,0,0,0,0,0,0,2,0,0,2,1
16122,150702,mbwwdEuMHREswI2AlXkMk45wqGiM3Wfu,5Gyp41oLVo7Gg7vF4vpmggWP5MU70QO6,6,2,1,0,1,0,3,1,8,1.1428571428571428,1,0.0,0,1,0,1,2,0,0,3,1,2,6,1
16123,150705,bXo13OaSVSZVdc3p9j9yvsI2MVmJRSiI,5Gyp41oLVo7Gg7vF4vpmggWP5MU70QO6,9,6,4,2,2,0,2,0,16,2.2857142857142856,1,0.0,1,4,1,2,5,0,1,2,0,8,8,1
16124,150734,6D9tNiLYL0h3Qh7QJGbRexG5UNsHPfh9,5Gyp41oLVo7Gg7vF4vpmggWP5MU70QO6,7,5,2,0,0,0,4,0,11,1.5714285714285714,1,0.0,0,2,0,0,5,0,0,4,0,2,9,1
16125,150742,JT1KLYqogflJatgOFWcpvS2M0BVTy9fT,5Gyp41oLVo7Gg7vF4vpmggWP5MU70QO6,1,0,0,0,0,0,1,0,1,0.14285714285714285,1,0.0,0,0,0,0,0,0,0,1,0,0,1,1
16126,150749,Z9MT3znePHqRtluyjqfGhwSG9lSs3uQe,5Gyp41oLVo7Gg7vF4vpmggWP5MU70QO6,6,2,1,0,1,0,3,0,7,1.0,1,0.0,0,1,0,1,2,0,0,3,0,2,5,1
16127,150757,FCG6YWuKaaz2zD1Uj2uT7JnTQhXHO8IA,5Gyp41oLVo7Gg7vF4vpmggWP5MU70QO6,1,0,0,0,0,0,1,0,1,0.14285714285714285,1,0.0,0,0,0,0,0,0,0,1,0,0,1,1
16128,150770,xJPU1inHXZ7edp2ELm8jFSIERF7GmDJa,5Gyp41oLVo7Gg7vF4vpmggWP5MU70QO6,1,0,0,0,0,0,1,0,1,0.14285714285714285,1,0.0,0,0,0,0,0,0,0,1,0,0,1,1
16129,150793,xGc3CvpmhP8QhiMIjVwsr77PvLypuJv1,5Gyp41oLVo7Gg7vF4vpmggWP5MU70QO6,6,4,3,0,3,0,2,0,12,1.7142857142857142,2,0.0,0,3,0,3,4,0,0,2,0,6,6,0
16130,150801,XLTSdKQeT3pb8W8DFBEWLQtEuZ5Vg9BF,5Gyp41oLVo7Gg7vF4vpmggWP5MU70QO6,6,4,2,0,1,0,3,0,10,1.4285714285714286,1,0.0,0,2,0,1,4,0,0,3,0,3,7,1
16131,150805,eAArxLyCThtu9N3Mv8rQculKbGSa66j9,5Gyp41oLVo7Gg7vF4vpmggWP5MU70QO6,1,0,0,0,0,0,1,0,1,0.14285714285714285,1,0.0,0,0,0,0,0,0,0,1,0,0,1,0
16132,150809,ozMzx95utaM6t0vWRUNZm19Q7oZfoujc,5Gyp41oLVo7Gg7vF4vpmggWP5MU70QO6,8,7,4,0,4,6,4,0,25,3.5714285714285716,1,0.0,1,4,0,4,6,6,0,4,0,9,16,1
16133,150812,E5MJZ8cVeLx5MNrppgSH419w5vJk7BV3,5Gyp41oLVo7Gg7vF4vpmggWP5MU70QO6,7,9,5,0,0,1,10,1,26,3.7142857142857144,3,0.0,1,5,0,0,8,1,0,10,1,6,20,1
16134,150834,4FSpxyFHWNPCO3VKgofAroygyZ2dAjfA,5Gyp41oLVo7Gg7vF4vpmggWP5MU70QO6,8,5,3,4,1,0,2,0,15,2.142857142857143,1,0.0,1,3,2,1,4,0,2,2,0,7,8,1
16135,150837,BcMya4rKMXEm8PNyZTAmOJyexYS6hlD9,5Gyp41oLVo7Gg7vF4vpmggWP5MU70QO6,1,0,0,0,0,0,1,0,1,0.14285714285714285,1,0.0,0,0,0,0,0,0,0,1,0,0,1,1
16136,150851,I0b0CtUQszlJ9piQ6aa7rx3ZTzdFEAMU,5Gyp41oLVo7Gg7vF4vpmggWP5MU70QO6,1,0,0,0,0,0,1,0,1,0.14285714285714285,1,0.0,0,0,0,0,0,0,0,1,0,0,1,1
16137,150859,HbfcxoEnjbnvh5Ba03UuGWAFpvOKtWbG,5Gyp41oLVo7Gg7vF4vpmggWP5MU70QO6,5,2,1,0,1,0,2,0,6,0.8571428571428571,1,0.0,0,1,0,1,2,0,0,2,0,2,4,1
16138,150889,PDJ5YLnuZaNj8cBZG1e2jb8NgKqeCz9q,5Gyp41oLVo7Gg7vF4vpmggWP5MU70QO6,10,7,3,0,4,0,2,0,16,2.2857142857142856,1,0.0,1,3,0,4,6,0,0,2,0,8,8,1
16139,150892,wFgvsPZQfTe43ahpGQxOtYpPA6mMKhw9,5Gyp41oLVo7Gg7vF4vpmggWP5MU70QO6,1,0,0,0,0,0,1,0,1,0.14285714285714285,1,0.0,0,0,0,0,0,0,0,1,0,0,1,1
16140,150900,3N5sXtJHk0S0MyzqJoRxaXFTELV1xCPn,5Gyp41oLVo7Gg7vF4vpmggWP5MU70QO6,2,0,0,0,0,0,2,0,2,0.2857142857142857,1,0.0,0,0,0,0,0,0,0,2,0,0,2,1
16141,150901,yCaliTyLawz9hD9gW2I8AmOOpqQxHz55,5Gyp41oLVo7Gg7vF4vpmggWP5MU70QO6,1,0,0,0,0,0,1,0,1,0.14285714285714285,1,0.0,0,0,0,0,0,0,0,1,0,0,1,1
16142,150918,PFS1tuIfRtU18K7PccBDMoq3Gsd5HBEc,5Gyp41oLVo7Gg7vF4vpmggWP5MU70QO6,1,0,0,0,0,0,1,0,1,0.14285714285714285,1,0.0,0,0,0,0,0,0,0,1,0,0,1,1
16143,150935,uoLP1IuLLWOUXnvrQb8tFCvhd6fERrCM,5Gyp41oLVo7Gg7vF4vpmggWP5MU70QO6,7,3,2,0,2,0,2,0,9,1.2857142857142858,1,0.0,0,2,0,2,3,0,0,2,0,4,5,1
16144,150940,m9tv0IeMj9CV2J0VEBDncZxDLDKZ5gBY,5Gyp41oLVo7Gg7vF4vpmggWP5MU70QO6,8,7,3,0,2,6,4,0,22,3.142857142857143,1,0.0,0,3,0,2,7,6,0,4,0,5,17,1
16145,150942,BtUSjqKrhPvRDopuX3NRI7Fb7WfFlULw,5Gyp41oLVo7Gg7vF4vpmggWP5MU70QO6,1,0,0,0,0,0,1,0,1,0.14285714285714285,1,0.0,0,0,0,0,0,0,0,1,0,0,1,1
16146,150952,J0agIiDPDsO7EgNBs76RsZQyZ6XLl2nX,5Gyp41oLVo7Gg7vF4vpmggWP5MU70QO6,1,0,0,0,0,0,1,0,1,0.14285714285714285,1,0.0,0,0,0,0,0,0,0,1,0,0,1,0
16147,150974,xLggdOYVuVd1fIIjw7WQvlgt6RgJEHij,5Gyp41oLVo7Gg7vF4vpmggWP5MU70QO6,5,2,1,0,1,0,2,0,6,0.8571428571428571,1,0.0,0,1,0,1,2,0,0,2,0,2,4,1
16148,150989,q0NJUxHMJLDeMKw16TmcVP4uYG4F0aIp,5Gyp41oLVo7Gg7vF4vpmggWP5MU70QO6,8,7,3,0,2,0,2,0,14,2.0,1,0.0,1,3,0,2,6,0,0,2,0,6,8,1
16149,150998,LYzYyf5ekuqUYXgYvm7fMfxJTfQmHHsI,5Gyp41oLVo7Gg7vF4vpmggWP5MU70QO6,3,0,0,0,0,0,5,0,5,0.7142857142857143,1,0.0,0,0,0,0,0,0,0,5,0,0,5,1
16150,151003,fB67G1QnjAF1nyJgxD5AAGinUNf5WvmI,5Gyp41oLVo7Gg7vF4vpmggWP5MU70QO6,8,22,0,0,4,0,4,0,30,4.285714285714286,1,0.0,9,0,0,4,13,0,0,4,0,13,17,1
16151,151035,Ma8Y6R8O5fnjHuA9SPo0MefKBe3j2968,5Gyp41oLVo7Gg7vF4vpmggWP5MU70QO6,4,2,0,0,0,0,3,0,5,0.7142857142857143,1,0.0,0,0,0,0,2,0,0,3,0,0,5,1
16152,151038,Fl4jIGQ8ffw2cSzVWGpGPBUNLDruFr99,5Gyp41oLVo7Gg7vF4vpmggWP5MU70QO6,1,0,0,0,0,0,3,0,3,0.42857142857142855,1,0.0,0,0,0,0,0,0,0,3,0,0,3,1
16153,151078,mvq6LTOHbvs5NukuzHDhNx6V4S7m8iJL,5Gyp41oLVo7Gg7vF4vpmggWP5MU70QO6,1,0,0,0,0,0,1,0,1,0.14285714285714285,1,0.0,0,0,0,0,0,0,0,1,0,0,1,1
16154,151084,2Wbpl8eSK90XFueeERqAaymoCfhK5Qkn,5Gyp41oLVo7Gg7vF4vpmggWP5MU70QO6,6,3,2,0,2,0,1,0,8,1.1428571428571428,1,0.0,0,2,0,2,3,0,0,1,0,4,4,1
16155,151087,7bsuvzVp0P34SLnobMPoETPRtIq3WvzP,5Gyp41oLVo7Gg7vF4vpmggWP5MU70QO6,18,21,10,1,5,18,18,2,75,10.714285714285714,1,0.0,5,10,1,5,16,18,0,18,2,21,54,1
16156,151090,bMfqJh0a1bGWrPSVl7sbbOnpybflF7eg,5Gyp41oLVo7Gg7vF4vpmggWP5MU70QO6,8,5,2,0,2,0,4,0,13,1.8571428571428572,2,0.0,0,2,0,2,5,0,0,4,0,4,9,1
16157,151094,tuhGi1oeg1PgtdLeBtHv6xmUelT6HYFY,5Gyp41oLVo7Gg7vF4vpmggWP5MU70QO6,21,52,20,21,7,12,12,2,126,18.0,1,0.0,27,20,15,7,25,12,6,12,2,69,57,1
16158,151128,GN5gQNFJDFdC9kETtKfVvAPxPOJUtgn1,5Gyp41oLVo7Gg7vF4vpmggWP5MU70QO6,7,7,2,0,2,0,2,0,13,1.8571428571428572,1,0.0,0,2,0,2,7,0,0,2,0,4,9,1
16159,151162,tRpsBmszN2GKJQ5Nw00w7MILm5RfCZWU,5Gyp41oLVo7Gg7vF4vpmggWP5MU70QO6,7,4,3,0,2,0,1,0,10,1.4285714285714286,1,0.0,0,3,0,2,4,0,0,1,0,5,5,1
16160,151179,eriNxzF5MJlwuGXsLjvkj8eJHFzarWtA,5Gyp41oLVo7Gg7vF4vpmggWP5MU70QO6,31,60,38,4,22,1,16,1,142,20.285714285714285,3,0.0,3,38,3,22,57,1,1,16,1,66,76,0
16161,151188,bzt9F7dE3QSyc99YmNCJSPBUUrAEZHrz,5Gyp41oLVo7Gg7vF4vpmggWP5MU70QO6,3,2,1,0,0,0,1,0,4,0.5714285714285714,1,0.0,0,1,0,0,2,0,0,1,0,1,3,1
16162,151199,m86kw79XbXLYY6QkjilycJRjjgKPxNcQ,5Gyp41oLVo7Gg7vF4vpmggWP5MU70QO6,5,2,1,0,1,0,2,0,6,0.8571428571428571,1,0.0,1,1,0,1,1,0,0,2,0,3,3,1
16163,151223,bLreCdAEY4M3FFqqRGQ9kLZjTYBSKbwL,5Gyp41oLVo7Gg7vF4vpmggWP5MU70QO6,7,3,2,0,2,0,2,0,9,1.2857142857142858,1,0.0,0,2,0,2,3,0,0,2,0,4,5,1
16164,151230,7jNUWYjbHo3nUZfu7saNwLxIufvdLe1s,5Gyp41oLVo7Gg7vF4vpmggWP5MU70QO6,1,0,0,0,0,0,1,0,1,0.14285714285714285,1,0.0,0,0,0,0,0,0,0,1,0,0,1,1
16165,151234,3x63reHnPUEpxvneROppT18TTVHKvgH3,5Gyp41oLVo7Gg7vF4vpmggWP5MU70QO6,17,28,11,7,13,0,4,1,64,9.142857142857142,2,0.0,11,11,5,13,17,0,2,4,1,40,24,1
16166,151244,VPCWV7vv7mSXLXdyKv2YQuYNd5q5tnVr,5Gyp41oLVo7Gg7vF4vpmggWP5MU70QO6,6,6,2,0,1,0,8,0,17,2.4285714285714284,1,0.0,0,2,0,1,6,0,0,8,0,3,14,0
16167,151253,Wsm1V4cfzELCIOcUH2wqmAYWXqkRELSb,5Gyp41oLVo7Gg7vF4vpmggWP5MU70QO6,1,0,0,0,0,0,1,0,1,0.14285714285714285,1,0.0,0,0,0,0,0,0,0,1,0,0,1,1
16168,151267,hutehqqFsHkTDVYtn3UPDM1X1MaRXFfq,5Gyp41oLVo7Gg7vF4vpmggWP5MU70QO6,5,2,1,0,1,1,2,1,8,1.1428571428571428,1,0.0,0,1,0,1,2,1,0,2,1,2,6,1
16169,151279,HfYUlZx1414CF0vVzzckHc3Zl0Q1sP07,5Gyp41oLVo7Gg7vF4vpmggWP5MU70QO6,6,1,1,0,1,0,4,0,7,1.0,2,0.0,0,1,0,1,1,0,0,4,0,2,5,1
16170,151292,I7S3rirnByKcuYHarusIwlT2GOLphfpj,5Gyp41oLVo7Gg7vF4vpmggWP5MU70QO6,6,5,0,0,0,0,3,0,8,1.1428571428571428,1,0.0,0,0,0,0,5,0,0,3,0,0,8,1
16171,151307,HvKDZIgtTrTVPi7sgcFSCpQYAlS5Fw2P,5Gyp41oLVo7Gg7vF4vpmggWP5MU70QO6,6,3,2,0,2,0,2,0,9,1.2857142857142858,1,0.0,0,2,0,2,3,0,0,2,0,4,5,1
16172,151320,LccNeIfK8nW5n5kUCDP0tvJVwpBeyYvE,5Gyp41oLVo7Gg7vF4vpmggWP5MU70QO6,1,0,0,0,0,0,1,0,1,0.14285714285714285,1,0.0,0,0,0,0,0,0,0,1,0,0,1,1
16173,151330,TKZgNsJlgM9z2jU0Un36JpUX1NEfLj9f,5Gyp41oLVo7Gg7vF4vpmggWP5MU70QO6,8,7,4,0,2,3,4,0,20,2.857142857142857,3,0.0,0,4,0,2,7,3,0,4,0,6,14,1
16174,151352,Hh7gmGE0gxxFDGZgOYpIIb1ZT5fDGBgk,5Gyp41oLVo7Gg7vF4vpmggWP5MU70QO6,1,0,0,0,0,0,1,0,1,0.14285714285714285,1,0.0,0,0,0,0,0,0,0,1,0,0,1,0
16175,151358,UPyXn56GTiamHniIOeD79gmXdLiowzXH,5Gyp41oLVo7Gg7vF4vpmggWP5MU70QO6,1,0,0,0,0,0,1,0,1,0.14285714285714285,1,0.0,0,0,0,0,0,0,0,1,0,0,1,1
16176,151371,rmlZ7x6O4i4xKnqcPnFuEHPQ5kp2xB2g,5Gyp41oLVo7Gg7vF4vpmggWP5MU70QO6,15,19,6,29,2,3,12,3,74,10.571428571428571,1,0.0,12,6,21,2,7,3,8,12,3,41,33,1
16177,151373,PUmV9uRuFVROTlnbrxJwOENyVx54i3f7,5Gyp41oLVo7Gg7vF4vpmggWP5MU70QO6,7,3,2,0,2,0,2,0,9,1.2857142857142858,1,0.0,0,2,0,2,3,0,0,2,0,4,5,1
16178,151376,ESZbkcdVULrci8JLWRpfJDPEFHTO8Ce0,5Gyp41oLVo7Gg7vF4vpmggWP5MU70QO6,7,1,1,0,1,0,4,0,7,1.0,1,0.0,0,1,0,1,1,0,0,4,0,2,5,1
16179,151397,G3JkrC91hydeYLKmvsrmbi6QdG0TgmMU,5Gyp41oLVo7Gg7vF4vpmggWP5MU70QO6,10,2,2,0,2,1,9,1,17,2.4285714285714284,1,0.0,0,2,0,2,2,1,0,9,1,4,13,1
16180,151406,OAovxCY5AcOhvhBf2zZgSZWneuufIS5b,5Gyp41oLVo7Gg7vF4vpmggWP5MU70QO6,5,4,2,0,1,0,2,0,9,1.2857142857142858,2,0.0,0,2,0,1,4,0,0,2,0,3,6,1
16181,151414,RCdcltNaQLfcoxT7YKTjQxAYUbCmzzKd,5Gyp41oLVo7Gg7vF4vpmggWP5MU70QO6,6,7,3,0,2,0,5,0,17,2.4285714285714284,3,0.0,0,3,0,2,7,0,0,5,0,5,12,0
16182,151426,OqqHplJQj7uH9fg7jI2Ikj5dp2hHyb4U,5Gyp41oLVo7Gg7vF4vpmggWP5MU70QO6,15,23,7,30,3,13,7,1,84,12.0,1,0.0,14,7,24,3,9,13,6,7,1,48,36,1
16183,151434,r7oEwOybiZG5UQZ1QZ0AiTrJNKaNvs7r,5Gyp41oLVo7Gg7vF4vpmggWP5MU70QO6,1,0,0,0,0,0,2,0,2,0.2857142857142857,1,0.0,0,0,0,0,0,0,0,2,0,0,2,1
16184,151440,xnV7sxoOD25FPwZ7ZFAn8tAdwhJiicZK,5Gyp41oLVo7Gg7vF4vpmggWP5MU70QO6,7,5,2,0,1,0,6,0,14,2.0,2,0.0,0,2,0,1,5,0,0,6,0,3,11,1
16185,151443,dNgxUPyBXng4Hn7f7H5Q5a2hxaMrrYLl,5Gyp41oLVo7Gg7vF4vpmggWP5MU70QO6,5,6,0,0,0,0,4,0,10,1.4285714285714286,1,0.0,0,0,0,0,6,0,0,4,0,0,10,1
16186,151451,UIrNobVAbeP9pBiCTAyjWT0vxEb24tGY,5Gyp41oLVo7Gg7vF4vpmggWP5MU70QO6,15,17,9,14,6,0,8,0,54,7.714285714285714,1,0.0,6,9,9,6,11,0,5,8,0,30,24,1
16187,151488,uoMVAH3rqvuHTrwiSe2SewRx9Bpc9srI,5Gyp41oLVo7Gg7vF4vpmggWP5MU70QO6,1,0,0,0,0,0,1,0,1,0.14285714285714285,1,0.0,0,0,0,0,0,0,0,1,0,0,1,1
16188,151489,2K1Z8MHkxSfa3IoXQMOOkvPRYry0VFvS,5Gyp41oLVo7Gg7vF4vpmggWP5MU70QO6,6,2,1,0,1,0,3,0,7,1.0,2,0.0,0,1,0,1,2,0,0,3,0,2,5,1
16189,151493,YPjZmyKjQkTrFwew3ILyyCKC6JN7YvY6,5Gyp41oLVo7Gg7vF4vpmggWP5MU70QO6,5,2,1,0,1,0,3,0,7,1.0,1,0.0,0,1,0,1,2,0,0,3,0,2,5,1
16190,151515,xLsstPG4sh6BOKWjwGwQnQICDDoIsKTd,5Gyp41oLVo7Gg7vF4vpmggWP5MU70QO6,12,11,6,0,3,0,4,0,24,3.4285714285714284,3,0.0,0,6,0,3,11,0,0,4,0,9,15,0
16191,151522,l49Uwtjoh75ZqUzcGjRfE9XtSg6Z1AGt,5Gyp41oLVo7Gg7vF4vpmggWP5MU70QO6,10,6,3,0,2,0,6,1,18,2.5714285714285716,1,0.0,2,3,0,2,4,0,0,6,1,7,11,1
16192,151538,pR0rEzd43YPn1ujQN1oHxqL0z3U4G8ju,5Gyp41oLVo7Gg7vF4vpmggWP5MU70QO6,2,0,0,0,0,0,2,0,2,0.2857142857142857,1,0.0,0,0,0,0,0,0,0,2,0,0,2,1
16193,151548,gNTGzjcOmHTKgzmUa0veV0Pk7aaKxz1N,5Gyp41oLVo7Gg7vF4vpmggWP5MU70QO6,6,9,2,0,3,0,1,0,15,2.142857142857143,1,0.0,2,2,0,3,7,0,0,1,0,7,8,1
16194,151580,Nzwv6Dxi9vrWIBjDR2tlTcPdhkCBGjfn,5Gyp41oLVo7Gg7vF4vpmggWP5MU70QO6,5,3,1,0,1,0,7,0,12,1.7142857142857142,1,0.0,1,1,0,1,2,0,0,7,0,3,9,1
16195,151592,hsJU1V7A4FsBfqrLbVEjA8WHyh23x6My,5Gyp41oLVo7Gg7vF4vpmggWP5MU70QO6,6,4,3,0,3,0,1,0,11,1.5714285714285714,1,0.0,0,3,0,3,4,0,0,1,0,6,5,1
16196,151596,TzoVeR6jxsM11FbzWcSJJwiHvbw0Vsix,5Gyp41oLVo7Gg7vF4vpmggWP5MU70QO6,6,3,0,0,2,0,6,9,20,2.857142857142857,1,0.0,0,0,0,2,3,0,0,6,9,2,18,1
16197,151598,lHz8g2aWVjKPT0qlJ69PaMkh1gnb9fpG,5Gyp41oLVo7Gg7vF4vpmggWP5MU70QO6,8,10,5,0,2,3,6,0,26,3.7142857142857144,1,0.0,2,5,0,2,8,3,0,6,0,9,17,1
16198,151634,VBKLySr69l31PijlEB7BTJk2zu02CGoB,5Gyp41oLVo7Gg7vF4vpmggWP5MU70QO6,4,4,0,0,0,0,2,0,6,0.8571428571428571,2,0.0,0,0,0,0,4,0,0,2,0,0,6,1
16199,151656,PIClOJA6j5sUehEuGxHwIeSy1ij4bGue,5Gyp41oLVo7Gg7vF4vpmggWP5MU70QO6,8,2,2,0,2,0,4,0,10,1.4285714285714286,2,0.0,0,2,0,2,2,0,0,4,0,4,6,1
16200,151678,iB94FmRZcyFJht4SeU2JKlyJEQJg6zKL,5Gyp41oLVo7Gg7vF4vpmggWP5MU70QO6,10,5,3,4,2,2,3,0,19,2.7142857142857144,1,0.0,1,3,3,2,4,2,1,3,0,9,10,1
16201,151684,TRW1xx4Nk9zW31jMDe5ae1YBst6a2yFQ,5Gyp41oLVo7Gg7vF4vpmggWP5MU70QO6,6,3,2,0,2,0,1,0,8,1.1428571428571428,1,0.0,0,2,0,2,3,0,0,1,0,4,4,1
16202,151695,6pq8MXYf9FGRuIYUMUOQpp4FppiElIYr,5Gyp41oLVo7Gg7vF4vpmggWP5MU70QO6,5,3,1,0,1,0,2,0,7,1.0,1,0.0,0,1,0,1,3,0,0,2,0,2,5,1
16203,151703,KVC7h242x0PZCn7VJTYGsUtQjLXoKjKz,5Gyp41oLVo7Gg7vF4vpmggWP5MU70QO6,7,4,1,0,1,0,7,0,13,1.8571428571428572,2,0.0,0,1,0,1,4,0,0,7,0,2,11,1
16204,151709,OWNvUZSL7GgHRtQ93QCtolaAfBVqHh0d,5Gyp41oLVo7Gg7vF4vpmggWP5MU70QO6,5,4,2,0,1,0,2,0,9,1.2857142857142858,2,0.0,0,2,0,1,4,0,0,2,0,3,6,1
16205,151719,0EjCkQ9M6hgPHEq5GsObVKxB1tOo7vu7,5Gyp41oLVo7Gg7vF4vpmggWP5MU70QO6,5,2,1,0,1,0,3,1,8,1.1428571428571428,1,0.0,0,1,0,1,2,0,0,3,1,2,6,1
16206,151732,cWKmRi1tl61WJPbunii5uuuTocwPJJxm,5Gyp41oLVo7Gg7vF4vpmggWP5MU70QO6,8,10,4,3,2,0,1,0,20,2.857142857142857,1,0.0,4,4,2,2,6,0,1,1,0,12,8,1
16207,151736,MeEaJBPHOhvJedyLYbLqfHjYqs2UmsHw,5Gyp41oLVo7Gg7vF4vpmggWP5MU70QO6,12,18,7,8,3,0,2,0,38,5.428571428571429,3,0.0,6,7,5,3,12,0,3,2,0,21,17,1
16208,151759,N8YavScnynmN17xwRDaWr06pi0Njsdwq,5Gyp41oLVo7Gg7vF4vpmggWP5MU70QO6,15,17,9,0,5,0,7,0,38,5.428571428571429,3,0.0,0,9,0,5,17,0,0,7,0,14,24,1
16209,151817,KfoZ69zTNu1FkbuybYuVyLqWQTXsDAu5,5Gyp41oLVo7Gg7vF4vpmggWP5MU70QO6,24,57,30,30,12,37,23,6,195,27.857142857142858,2,0.0,9,30,21,12,48,37,9,23,6,72,123,0
16210,151831,2FPCJ9l6CyULWDMJ7I3XgGilh8se7rpF,5Gyp41oLVo7Gg7vF4vpmggWP5MU70QO6,5,2,1,0,1,0,2,0,6,0.8571428571428571,1,0.0,0,1,0,1,2,0,0,2,0,2,4,1
16211,151841,96rI6chLVrZXlvSRGcYlcVVN1yH7CeLn,5Gyp41oLVo7Gg7vF4vpmggWP5MU70QO6,10,9,3,0,1,0,5,0,18,2.5714285714285716,1,0.0,0,3,0,1,9,0,0,5,0,4,14,1
16212,151843,xA4aRzfOsZxYOYwTl2YiACpOGfDUqBdK,5Gyp41oLVo7Gg7vF4vpmggWP5MU70QO6,4,2,1,0,1,0,1,0,5,0.7142857142857143,1,0.0,0,1,0,1,2,0,0,1,0,2,3,1
16213,151868,IH1GHsZkw6pd0ET9R0AxS98ZlpHOijrz,5Gyp41oLVo7Gg7vF4vpmggWP5MU70QO6,5,4,3,0,1,0,1,0,9,1.2857142857142858,1,0.0,0,3,0,1,4,0,0,1,0,4,5,1
16214,151883,X78n2HoCUAiF9oMLfhP6UzCbg1d845Fc,5Gyp41oLVo7Gg7vF4vpmggWP5MU70QO6,4,4,1,0,0,0,4,0,9,1.2857142857142858,1,0.0,0,1,0,0,4,0,0,4,0,1,8,1
16215,151885,SatTXnx8kRcL6R9GMVodkDdfLaTcz43o,5Gyp41oLVo7Gg7vF4vpmggWP5MU70QO6,9,3,0,0,2,5,4,1,15,2.142857142857143,1,0.0,0,0,0,2,3,5,0,4,1,2,13,1
16216,151916,CwyOL3RMOVLomxrxyN9D4jPa9R0iWrS5,5Gyp41oLVo7Gg7vF4vpmggWP5MU70QO6,7,3,2,0,2,0,2,0,9,1.2857142857142858,1,0.0,0,2,0,2,3,0,0,2,0,4,5,1
16217,151924,076qzRBzR2zoTFPTpDElhPZwWu7C9KFj,5Gyp41oLVo7Gg7vF4vpmggWP5MU70QO6,5,2,1,0,1,0,2,0,6,0.8571428571428571,1,0.0,0,1,0,1,2,0,0,2,0,2,4,1
16218,151941,jCJUFuYu6GiUETXHF64p0zXYK72Mujfp,5Gyp41oLVo7Gg7vF4vpmggWP5MU70QO6,6,3,2,0,2,0,1,0,8,1.1428571428571428,1,0.0,0,2,0,2,3,0,0,1,0,4,4,1
16219,151946,7dLPegA4nKNLVosIhQODby7r7kJfh6oT,5Gyp41oLVo7Gg7vF4vpmggWP5MU70QO6,7,3,2,0,2,0,5,0,12,1.7142857142857142,1,0.0,0,2,0,2,3,0,0,5,0,4,8,1
16220,151965,30OTrxxbLTvIBMGCHkejc2VBCNgO8W5g,5Gyp41oLVo7Gg7vF4vpmggWP5MU70QO6,1,0,0,0,0,0,1,0,1,0.14285714285714285,1,0.0,0,0,0,0,0,0,0,1,0,0,1,1
16221,151974,blaKT90TeOTAa2RsAkTxWQqeLxEi93Qu,5Gyp41oLVo7Gg7vF4vpmggWP5MU70QO6,8,4,0,0,4,0,3,0,11,1.5714285714285714,1,0.0,2,0,0,4,2,0,0,3,0,6,5,1
16222,151981,C5INU4vEMoZCKeZLh5aelqFa9vdxDX8v,5Gyp41oLVo7Gg7vF4vpmggWP5MU70QO6,1,0,0,0,0,0,1,0,1,0.14285714285714285,1,0.0,0,0,0,0,0,0,0,1,0,0,1,1
16223,151990,OiROY8remVwcW5HPFwHuu5bKwEILqKWi,5Gyp41oLVo7Gg7vF4vpmggWP5MU70QO6,4,2,1,0,1,0,2,0,6,0.8571428571428571,2,0.0,0,1,0,1,2,0,0,2,0,2,4,1
16224,151996,6qKlxn8nCsHY0aHiNsGMyAiNmdUjrEo2,5Gyp41oLVo7Gg7vF4vpmggWP5MU70QO6,4,2,1,0,1,0,1,0,5,0.7142857142857143,1,0.0,0,1,0,1,2,0,0,1,0,2,3,1
16225,151997,utLNCqYllw6MM0LigvprePILK1WVTbt6,5Gyp41oLVo7Gg7vF4vpmggWP5MU70QO6,7,2,2,0,2,0,2,0,8,1.1428571428571428,1,0.0,0,2,0,2,2,0,0,2,0,4,4,1
16226,152009,ugg2wjUMXHuBgknMy9mAhjjiioWQfh8W,5Gyp41oLVo7Gg7vF4vpmggWP5MU70QO6,13,8,4,0,4,0,17,0,33,4.714285714285714,2,0.0,2,4,0,4,6,0,0,17,0,10,23,1
16227,152011,2eLTV9KmB3UnAhEXXI78r75iehfTvtic,5Gyp41oLVo7Gg7vF4vpmggWP5MU70QO6,11,12,7,0,2,0,3,0,24,3.4285714285714284,1,0.0,2,7,0,2,10,0,0,3,0,11,13,1
16228,152018,0EjPW445CKgaymeQ2qj6yLWLiAttBpmv,5Gyp41oLVo7Gg7vF4vpmggWP5MU70QO6,2,0,0,0,0,0,3,0,3,0.42857142857142855,1,0.0,0,0,0,0,0,0,0,3,0,0,3,1
16229,152038,ONghHwhwAX2IyqpHHX698rW0VH9BRcsu,5Gyp41oLVo7Gg7vF4vpmggWP5MU70QO6,10,9,4,0,4,0,5,0,22,3.142857142857143,2,0.0,3,4,0,4,6,0,0,5,0,11,11,1
16230,152039,8CEJhib8SusSPBX6mLFbg3l2buN3uo4C,5Gyp41oLVo7Gg7vF4vpmggWP5MU70QO6,7,3,2,0,2,0,2,0,9,1.2857142857142858,1,0.0,0,2,0,2,3,0,0,2,0,4,5,1
16231,152046,xtshUC69TVdVKcM1M70T2Bi1LpuNKwMG,5Gyp41oLVo7Gg7vF4vpmggWP5MU70QO6,5,2,1,0,1,0,2,0,6,0.8571428571428571,1,0.0,0,1,0,1,2,0,0,2,0,2,4,1
16232,152049,6pPM8viRBsZ5riApK3StH7gctEnt9yOW,5Gyp41oLVo7Gg7vF4vpmggWP5MU70QO6,6,4,1,0,0,0,3,0,8,1.1428571428571428,1,0.0,0,1,0,0,4,0,0,3,0,1,7,1
16233,152052,omogDjehriHed7WOB06lowOCzWJT5HFG,5Gyp41oLVo7Gg7vF4vpmggWP5MU70QO6,11,11,4,0,5,1,6,1,28,4.0,3,0.0,4,4,0,5,7,1,0,6,1,13,15,1
16234,152054,f1SJwjxXune3pk3OX8O5QJBrdKVLp9My,5Gyp41oLVo7Gg7vF4vpmggWP5MU70QO6,6,5,3,0,2,1,3,0,14,2.0,1,0.0,0,3,0,2,5,1,0,3,0,5,9,1
16235,152077,hvjeWwkeBVWsCuQiAiwgXKaku9nMJg9s,5Gyp41oLVo7Gg7vF4vpmggWP5MU70QO6,8,4,2,0,1,0,7,1,15,2.142857142857143,1,0.0,0,2,0,1,4,0,0,7,1,3,12,1
16236,152082,huJ4RGS1d7VtRcmbsICWMWQhw8jgo9HW,5Gyp41oLVo7Gg7vF4vpmggWP5MU70QO6,3,2,1,0,0,0,1,0,4,0.5714285714285714,1,0.0,0,1,0,0,2,0,0,1,0,1,3,1
16237,152128,lsROVrQeyHSAuyukaA0G0zN8QO9HqyH4,5Gyp41oLVo7Gg7vF4vpmggWP5MU70QO6,11,12,4,9,2,0,1,0,28,4.0,1,0.0,6,4,6,2,6,0,3,1,0,18,10,1
16238,152137,Qx9UDZ9u4rlicMPhOyre1Uzu81os2EuR,5Gyp41oLVo7Gg7vF4vpmggWP5MU70QO6,11,5,4,0,4,0,2,0,15,2.142857142857143,1,0.0,0,4,0,4,5,0,0,2,0,8,7,1
16239,152148,Zmu4feWExffgJhdo86JIkh5yM6yOEV9y,5Gyp41oLVo7Gg7vF4vpmggWP5MU70QO6,10,3,3,2,2,1,3,1,15,2.142857142857143,1,0.0,0,3,1,2,3,1,1,3,1,6,9,1
16240,152202,kU22DGnuGpDa4awKp7Oe0zbcu4isBbHL,5Gyp41oLVo7Gg7vF4vpmggWP5MU70QO6,5,5,1,0,4,0,2,0,12,1.7142857142857142,1,0.0,0,1,0,4,5,0,0,2,0,5,7,1
16241,152227,bGSf4Dv41LrPDFgbxGTmHZXMfhKccKJy,5Gyp41oLVo7Gg7vF4vpmggWP5MU70QO6,1,0,0,0,0,0,1,0,1,0.14285714285714285,1,0.0,0,0,0,0,0,0,0,1,0,0,1,1
16242,152229,RZ5wQWccvFAvYnggcAEAEGFxSPpaYGdj,5Gyp41oLVo7Gg7vF4vpmggWP5MU70QO6,1,0,0,0,0,0,1,0,1,0.14285714285714285,1,0.0,0,0,0,0,0,0,0,1,0,0,1,1
16243,152230,57qzgJAwfROYPxzSOrsA3G5DLHP95ajU,5Gyp41oLVo7Gg7vF4vpmggWP5MU70QO6,4,2,1,0,1,0,2,0,6,0.8571428571428571,1,0.0,0,1,0,1,2,0,0,2,0,2,4,0
16244,152269,kYCiC9sjJhVea0nSa72pTn7A2eOhjLmI,5Gyp41oLVo7Gg7vF4vpmggWP5MU70QO6,11,13,8,8,4,0,4,0,37,5.285714285714286,4,0.0,1,8,4,4,12,0,4,4,0,17,20,0
16245,152271,vNZLW4Mhl5fYWyn37Qu07nmCjWe7nwBC,5Gyp41oLVo7Gg7vF4vpmggWP5MU70QO6,5,3,0,0,0,0,3,1,7,1.0,1,0.0,0,0,0,0,3,0,0,3,1,0,7,1
16246,152294,lmaQ7sjb790aXLd2hgtVOpl4vHcpNivc,5Gyp41oLVo7Gg7vF4vpmggWP5MU70QO6,10,5,3,0,3,1,5,0,17,2.4285714285714284,1,0.0,1,3,0,3,4,1,0,5,0,7,10,1
16247,152295,Uf1qigQqXVxNALjpI0OUPGkslBlud9Ut,5Gyp41oLVo7Gg7vF4vpmggWP5MU70QO6,15,12,9,0,4,0,2,0,27,3.857142857142857,2,0.0,0,9,0,4,12,0,0,2,0,13,14,0
16248,152322,5vUuq5ZeDCNce4LmvH0naoUjpb3qbNOp,5Gyp41oLVo7Gg7vF4vpmggWP5MU70QO6,2,0,0,0,0,0,4,0,4,0.5714285714285714,2,0.0,0,0,0,0,0,0,0,4,0,0,4,1
16249,152338,l3yPbqlYTfWOgaxqaqE6scvK7rLOR7cQ,5Gyp41oLVo7Gg7vF4vpmggWP5MU70QO6,9,10,3,0,3,0,3,1,20,2.857142857142857,1,0.0,0,3,0,3,10,0,0,3,1,6,14,1
16250,152380,D7fF4POaHjzdqVaKTgpTS73i9DkdFXd4,5Gyp41oLVo7Gg7vF4vpmggWP5MU70QO6,15,23,14,14,5,10,8,0,74,10.571428571428571,2,0.0,6,14,9,5,17,10,5,8,0,34,40,1
16251,152385,1nu2wF0Wb8q5X2YUWZC6BMd7XRS5JE6T,5Gyp41oLVo7Gg7vF4vpmggWP5MU70QO6,6,3,2,0,0,1,5,1,12,1.7142857142857142,1,0.0,0,2,0,0,3,1,0,5,1,2,10,1
16252,152392,EP1XQRGS4HZOG1hdGzNZdD1HFhJcHpos,5Gyp41oLVo7Gg7vF4vpmggWP5MU70QO6,10,10,5,0,2,2,3,0,22,3.142857142857143,2,0.0,1,5,0,2,9,2,0,3,0,8,14,1
16253,152393,w79oIXxJA51xRJ7RWNha0P7ISQqedK5M,5Gyp41oLVo7Gg7vF4vpmggWP5MU70QO6,6,4,3,0,3,0,1,0,11,1.5714285714285714,1,0.0,0,3,0,3,4,0,0,1,0,6,5,1
16254,152396,vD39RgDh9o9HorljV8AcLJc0rny8tMWn,5Gyp41oLVo7Gg7vF4vpmggWP5MU70QO6,1,0,0,0,0,0,1,0,1,0.14285714285714285,1,0.0,0,0,0,0,0,0,0,1,0,0,1,1
16255,152421,gkQFQmICZ0u4XigX9mjHpGoN6sbIP3K4,5Gyp41oLVo7Gg7vF4vpmggWP5MU70QO6,12,21,12,6,6,2,3,0,50,7.142857142857143,2,0.0,2,12,3,6,19,2,3,3,0,23,27,1
16256,152432,PRlac1sh0f4uW8rEARh8qc5dcv1ibeHq,5Gyp41oLVo7Gg7vF4vpmggWP5MU70QO6,5,2,1,0,1,0,2,0,6,0.8571428571428571,1,0.0,0,1,0,1,2,0,0,2,0,2,4,1
16257,152456,fn4MGeBxmuVod8SI7mfp3VQUaoNd59EU,5Gyp41oLVo7Gg7vF4vpmggWP5MU70QO6,15,10,5,11,3,0,3,0,32,4.571428571428571,2,0.0,2,5,7,3,8,0,4,3,0,17,15,1
16258,152470,zOr0niRplBKfkwpPHNykN96u1FhzegfK,5Gyp41oLVo7Gg7vF4vpmggWP5MU70QO6,1,0,0,0,0,0,1,0,1,0.14285714285714285,1,0.0,0,0,0,0,0,0,0,1,0,0,1,1
16259,152475,K22VFryh5Od9V1LL0eOyTaqPsCNGJ8v3,5Gyp41oLVo7Gg7vF4vpmggWP5MU70QO6,8,4,3,0,3,0,7,0,17,2.4285714285714284,2,0.0,0,3,0,3,4,0,0,7,0,6,11,1
16260,152476,0d9QTHxHI38QwsI8Nrfe3h4nIFkKB9wm,5Gyp41oLVo7Gg7vF4vpmggWP5MU70QO6,4,2,1,0,1,0,1,0,5,0.7142857142857143,1,0.0,0,1,0,1,2,0,0,1,0,2,3,1
16261,152494,BospP3Bm2EgHpdgaaoSLxMneaaDyM8fo,5Gyp41oLVo7Gg7vF4vpmggWP5MU70QO6,7,3,2,0,2,2,2,0,11,1.5714285714285714,1,0.0,0,2,0,2,3,2,0,2,0,4,7,1
16262,152498,iXEJ1rfu68zDKDu3FiFKj2kPpqtT5dfz,5Gyp41oLVo7Gg7vF4vpmggWP5MU70QO6,7,3,1,0,2,0,2,0,8,1.1428571428571428,1,0.0,0,1,0,2,3,0,0,2,0,3,5,1
16263,152500,eiGGLBymM1p4bVlwpT4sWkdz6AcVphJo,5Gyp41oLVo7Gg7vF4vpmggWP5MU70QO6,10,12,5,5,3,5,6,0,36,5.142857142857143,3,0.0,4,5,3,3,8,5,2,6,0,15,21,1
16264,152506,FsN3EYiAfRxm9msVQNiGujMlmaZjdiLV,5Gyp41oLVo7Gg7vF4vpmggWP5MU70QO6,4,2,1,0,1,0,1,0,5,0.7142857142857143,1,0.0,0,1,0,1,2,0,0,1,0,2,3,1
16265,152537,aCfqKpyizkWVRtIyUI2vsWY2Cb09yHMB,5Gyp41oLVo7Gg7vF4vpmggWP5MU70QO6,18,100,36,0,1,0,28,1,166,23.714285714285715,4,0.0,12,36,0,1,88,0,0,28,1,49,117,1
16266,152555,PwLbv5h5IP5F0KdwgVJoDfAiwMZsoA8P,5Gyp41oLVo7Gg7vF4vpmggWP5MU70QO6,16,16,9,9,5,0,6,7,52,7.428571428571429,2,0.0,5,9,6,5,11,0,3,6,7,25,27,1
16267,152569,O9vCDs3Q32DEJ6GAN31HsZu74WF9oFYW,5Gyp41oLVo7Gg7vF4vpmggWP5MU70QO6,6,3,1,0,1,0,2,0,7,1.0,1,0.0,0,1,0,1,3,0,0,2,0,2,5,1
16268,152610,0IfdWa7sUumEN6EHXjLqFdgP3I3lCMu6,5Gyp41oLVo7Gg7vF4vpmggWP5MU70QO6,14,14,6,5,4,0,6,1,36,5.142857142857143,2,0.0,5,6,3,4,9,0,2,6,1,18,18,1
16269,152642,isHlzTZhxk4cqf66hkvwTqXlkBml3duZ,5Gyp41oLVo7Gg7vF4vpmggWP5MU70QO6,1,0,0,0,0,0,3,0,3,0.42857142857142855,1,0.0,0,0,0,0,0,0,0,3,0,0,3,1
16270,152650,5SYMX62EU0fTgauNduABVoLxd6a2qPFl,5Gyp41oLVo7Gg7vF4vpmggWP5MU70QO6,8,13,6,0,2,0,3,0,24,3.4285714285714284,2,0.0,0,6,0,2,13,0,0,3,0,8,16,1
16271,152655,HHRmRRTDc1HXofbADbdvq38XiSbmjOI2,5Gyp41oLVo7Gg7vF4vpmggWP5MU70QO6,1,0,0,0,0,0,1,0,1,0.14285714285714285,1,0.0,0,0,0,0,0,0,0,1,0,0,1,1
16272,152662,8Bh4X8x9tbx01mYXJaqcIoTEqUCbSq2f,5Gyp41oLVo7Gg7vF4vpmggWP5MU70QO6,5,2,1,0,1,0,2,0,6,0.8571428571428571,1,0.0,0,1,0,1,2,0,0,2,0,2,4,1
16273,152671,rDBZw8ApsiHlrc5StlvYPE9A5f0mUyOy,5Gyp41oLVo7Gg7vF4vpmggWP5MU70QO6,10,8,4,0,3,0,4,0,19,2.7142857142857144,1,0.0,0,4,0,3,8,0,0,4,0,7,12,1
16274,152687,9lKad9GgZ33IQc9EXgqQ1nba8j7bVZdv,5Gyp41oLVo7Gg7vF4vpmggWP5MU70QO6,11,7,4,0,2,2,7,1,23,3.2857142857142856,1,0.0,2,4,0,2,5,2,0,7,1,8,15,1
16275,152689,CWfEuozBd4liyBTvOMVgNSWJo0S8l1jG,5Gyp41oLVo7Gg7vF4vpmggWP5MU70QO6,5,4,1,0,0,0,1,0,6,0.8571428571428571,1,0.0,0,1,0,0,4,0,0,1,0,1,5,1
16276,152702,lDkAOe2pGUkP1ca3JwSWBVJoUdsiFRPV,5Gyp41oLVo7Gg7vF4vpmggWP5MU70QO6,1,0,0,0,0,0,1,0,1,0.14285714285714285,1,0.0,0,0,0,0,0,0,0,1,0,0,1,1
16277,152710,KBmTf7WYCa0svgFNepaA95qTJIR6E1ZO,5Gyp41oLVo7Gg7vF4vpmggWP5MU70QO6,4,2,0,0,1,0,3,0,6,0.8571428571428571,1,0.0,0,0,0,1,2,0,0,3,0,1,5,1
16278,152711,ckifcd5IEMKJyn2lfnSGbBrmlVdPcyOj,5Gyp41oLVo7Gg7vF4vpmggWP5MU70QO6,9,7,3,0,4,6,6,0,26,3.7142857142857144,1,0.0,1,3,0,4,6,6,0,6,0,8,18,1
16279,152717,Ni5bteM7WARzZAwwtJCSBEmehpeOn2OA,5Gyp41oLVo7Gg7vF4vpmggWP5MU70QO6,7,3,2,0,2,0,2,0,9,1.2857142857142858,1,0.0,0,2,0,2,3,0,0,2,0,4,5,1
16280,152721,ZX4lhV9dWj1P8mNqKyeqbe9dmDE0K15a,5Gyp41oLVo7Gg7vF4vpmggWP5MU70QO6,10,6,3,0,3,0,3,0,15,2.142857142857143,1,0.0,2,3,0,3,4,0,0,3,0,8,7,1
16281,152726,OFOEYOS8uxGx97U32kdz0XyRq1O1PMD0,5Gyp41oLVo7Gg7vF4vpmggWP5MU70QO6,6,3,2,0,2,0,1,0,8,1.1428571428571428,1,0.0,0,2,0,2,3,0,0,1,0,4,4,1
16282,152736,JPhJwvyrN7DZQhMFX7BMe7XmlxjsWqk8,5Gyp41oLVo7Gg7vF4vpmggWP5MU70QO6,6,4,2,0,2,0,1,0,9,1.2857142857142858,1,0.0,1,2,0,2,3,0,0,1,0,5,4,1
16283,152748,e3uqzENACxEsDe0WATOVvMr7tkVC768H,5Gyp41oLVo7Gg7vF4vpmggWP5MU70QO6,5,1,1,0,1,0,4,0,7,1.0,1,0.0,0,1,0,1,1,0,0,4,0,2,5,1
16284,152750,pwCPzTmHoSwZ6HrF3cLVOb8UqBlJpBBW,5Gyp41oLVo7Gg7vF4vpmggWP5MU70QO6,6,4,2,0,1,0,3,0,10,1.4285714285714286,1,0.0,0,2,0,1,4,0,0,3,0,3,7,1
16285,152753,cgDKSNH45Mrl03dZiqmVtDWiojulUNN5,5Gyp41oLVo7Gg7vF4vpmggWP5MU70QO6,4,2,1,0,1,0,1,0,5,0.7142857142857143,1,0.0,0,1,0,1,2,0,0,1,0,2,3,1
16286,152771,bJOyNfQql7s0NySd8xPqJe0iH1TSF4ku,5Gyp41oLVo7Gg7vF4vpmggWP5MU70QO6,9,5,3,0,4,0,1,0,13,1.8571428571428572,1,0.0,1,3,0,4,4,0,0,1,0,8,5,1
16287,152773,duVRqnj8JL1j8ogNbpoeMnkfG8VUSgFg,5Gyp41oLVo7Gg7vF4vpmggWP5MU70QO6,13,20,8,2,3,3,8,1,45,6.428571428571429,2,0.0,9,8,1,3,11,3,1,8,1,21,24,1
16288,152782,iP3M15TChtZoTU2W8weDGMA2fr7tnTCt,5Gyp41oLVo7Gg7vF4vpmggWP5MU70QO6,5,6,0,0,0,0,2,0,8,1.1428571428571428,1,0.0,0,0,0,0,6,0,0,2,0,0,8,1
16289,152791,iMqHiXfdYvPMULl8VYyOXwJF8trdBBXq,5Gyp41oLVo7Gg7vF4vpmggWP5MU70QO6,15,31,22,14,7,10,11,1,96,13.714285714285714,4,0.0,3,22,10,7,28,10,4,11,1,42,54,1
16290,152809,JfTOfcf15FK7jTKVpQgFx9rCClmYQ1Py,5Gyp41oLVo7Gg7vF4vpmggWP5MU70QO6,8,6,4,0,3,0,3,0,16,2.2857142857142856,2,0.0,0,4,0,3,6,0,0,3,0,7,9,1
16291,152813,3zvHKS6M4U1m424fRhI52J9JeELqakS5,5Gyp41oLVo7Gg7vF4vpmggWP5MU70QO6,11,13,1,2,3,0,6,3,28,4.0,3,0.0,1,1,1,3,12,0,1,6,3,6,22,0
16292,152826,JaY583iEzhUh1H375yAqlbYi0f6zdDLM,5Gyp41oLVo7Gg7vF4vpmggWP5MU70QO6,1,0,0,0,0,0,1,0,1,0.14285714285714285,1,0.0,0,0,0,0,0,0,0,1,0,0,1,1
16293,152831,EcVZjhzxCfpLfl9VfLyd7XBDTTX4afqq,5Gyp41oLVo7Gg7vF4vpmggWP5MU70QO6,22,55,22,26,17,2,15,1,138,19.714285714285715,3,0.0,23,22,17,17,32,2,9,15,1,79,59,1
16294,152855,GPbq86k98Rz9tUbijEEopIymy9u0Fcyf,7GRhBDsirIGkRZBtSMEzNTyDr2JQm4xx,7,6,1,2,1,0,3,0,13,1.8571428571428572,3,0.0,3,1,2,1,3,0,0,3,0,7,6,1
16295,152864,hCBb0btCYW2ppCBVarI67JyCO4pJ7eb9,7GRhBDsirIGkRZBtSMEzNTyDr2JQm4xx,1,0,0,0,0,0,1,0,1,0.14285714285714285,1,0.0,0,0,0,0,0,0,0,1,0,0,1,1
16296,152879,dqSfWCCLLdDoawrlG8LB6YtjPp851gTf,7GRhBDsirIGkRZBtSMEzNTyDr2JQm4xx,1,0,0,0,0,0,1,0,1,0.14285714285714285,1,0.0,0,0,0,0,0,0,0,1,0,0,1,1
16297,152887,MDFjVXgtYzZVyK4QPMD7X2zkYyaEYCUs,5X6FeZozNMgE2VRi3MJYjkkFK8SETtu2,2,0,0,0,0,0,3,0,3,0.42857142857142855,1,0.0,0,0,0,0,0,0,0,3,0,0,3,1
16298,152897,Ora02944NsUtAGSKWplRuKmq6bV7dPd0,5X6FeZozNMgE2VRi3MJYjkkFK8SETtu2,5,4,0,0,0,0,3,0,7,1.0,1,0.0,0,0,0,0,4,0,0,3,0,0,7,1
16299,152931,bKVslXuzEQ1pv4c6iV5mVjs6X6avUbmL,7GRhBDsirIGkRZBtSMEzNTyDr2JQm4xx,39,83,21,60,16,3,5,0,188,26.857142857142858,5,0.0,26,21,51,16,57,3,9,5,0,114,74,1
16300,152938,Lf93y7eBw6lMLWUxl2k8Aa6sTuqt3rkX,7GRhBDsirIGkRZBtSMEzNTyDr2JQm4xx,42,72,20,57,21,2,19,3,194,27.714285714285715,2,0.0,31,20,51,21,41,2,6,19,3,123,71,1
16301,152954,sITNvJWxCzf6WaNIdOh2TIdks7kOsSJ9,7GRhBDsirIGkRZBtSMEzNTyDr2JQm4xx,1,0,0,0,0,0,1,0,1,0.14285714285714285,1,0.0,0,0,0,0,0,0,0,1,0,0,1,1
16302,152963,1qA8a5iVvPnhwEF9sRv1kIfsUyLQnW2P,5X6FeZozNMgE2VRi3MJYjkkFK8SETtu2,1,0,0,0,0,0,1,0,1,0.14285714285714285,1,0.0,0,0,0,0,0,0,0,1,0,0,1,1
16303,152987,AzVjKFfX4LhEl6lfJyI7leulN5tgJJFC,7GRhBDsirIGkRZBtSMEzNTyDr2JQm4xx,2,0,0,0,0,0,2,0,2,0.2857142857142857,1,0.0,0,0,0,0,0,0,0,2,0,0,2,1
16304,152991,8x5LnIwANrYRfzVuO8KI6hCDTjG995Zm,7GRhBDsirIGkRZBtSMEzNTyDr2JQm4xx,36,34,9,214,0,0,2,0,259,37.0,1,0.0,16,9,191,0,18,0,23,2,0,216,43,1
16305,152997,Bos3zEEnAcYzPXQktMkJJ0ak5mhGWCAf,7GRhBDsirIGkRZBtSMEzNTyDr2JQm4xx,40,44,15,170,0,0,3,0,232,33.142857142857146,1,0.0,17,15,159,0,27,0,11,3,0,191,41,1
16306,153006,S2jcDn3vCeFbqJDKmfQ5CtCJMDMc0dCL,7GRhBDsirIGkRZBtSMEzNTyDr2JQm4xx,1,0,0,0,0,0,1,0,1,0.14285714285714285,1,0.0,0,0,0,0,0,0,0,1,0,0,1,1
16307,153011,MU2dpqeoXpRCc5hjW6jEYEhmjukPgsDA,7GRhBDsirIGkRZBtSMEzNTyDr2JQm4xx,1,0,0,0,0,0,1,0,1,0.14285714285714285,1,0.0,0,0,0,0,0,0,0,1,0,0,1,1
16308,153055,DQfW4bOWdBOe4SfBmetTmbxwKFxrUYju,7GRhBDsirIGkRZBtSMEzNTyDr2JQm4xx,29,51,2,68,4,17,9,1,152,21.714285714285715,1,0.0,24,2,58,4,27,17,10,9,1,88,64,1
16309,153108,BfoIsQXdmfYhoAzytmfllMYGIk5v6NxW,5X6FeZozNMgE2VRi3MJYjkkFK8SETtu2,6,2,1,0,1,0,6,0,10,1.4285714285714286,3,0.0,0,1,0,1,2,0,0,6,0,2,8,1
16310,153110,G1Fi5Ihmt1UntL9sxYjXIiKyHUtRhwud,7GRhBDsirIGkRZBtSMEzNTyDr2JQm4xx,1,0,0,0,0,0,1,0,1,0.14285714285714285,1,0.0,0,0,0,0,0,0,0,1,0,0,1,1
16311,153161,wFvodFqghxL7iISMFbYXkYNq6P6eK5gH,7GRhBDsirIGkRZBtSMEzNTyDr2JQm4xx,1,0,0,0,0,0,1,0,1,0.14285714285714285,1,0.0,0,0,0,0,0,0,0,1,0,0,1,1
16312,153171,UGYGSfRkJhOkgkdlCI6YSCshpNvwBF31,5X6FeZozNMgE2VRi3MJYjkkFK8SETtu2,5,2,1,0,1,0,2,0,6,0.8571428571428571,1,0.0,0,1,0,1,2,0,0,2,0,2,4,1
16313,153173,HuLHCkffx7NTEjFGXpjyYhc55925sZcQ,5X6FeZozNMgE2VRi3MJYjkkFK8SETtu2,13,7,6,0,5,0,1,0,19,2.7142857142857144,1,0.0,0,6,0,5,7,0,0,1,0,11,8,1
16314,153184,VhcJDUnonrNMNnFkqYhfbm6haKp8kch0,7GRhBDsirIGkRZBtSMEzNTyDr2JQm4xx,10,16,4,0,5,4,4,0,33,4.714285714285714,1,0.0,5,4,0,5,11,4,0,4,0,14,19,1
16315,153191,eYNvtk5CsI9HdFompLA9hNZLZOidbC7w,7GRhBDsirIGkRZBtSMEzNTyDr2JQm4xx,2,0,0,0,0,0,2,0,2,0.2857142857142857,1,0.0,0,0,0,0,0,0,0,2,0,0,2,1
16316,153201,HycevJIm7cBjf1oJ5QCBMMXEBTG8jyRF,5X6FeZozNMgE2VRi3MJYjkkFK8SETtu2,1,0,0,0,0,0,1,0,1,0.14285714285714285,1,0.0,0,0,0,0,0,0,0,1,0,0,1,1
16317,153231,cYX89S5aEiRwSUpLGmwi2u7t2zEOcoD7,SpATywNh6bZuzm8s1ceuBUnMUAeoAHHw,6,5,3,0,2,0,3,0,13,1.8571428571428572,2,0.0,0,3,0,2,5,0,0,3,0,5,8,1
16318,153253,DKdrh8xgsWflkjgGhFow61asDvGQGw1P,bWdj2GDclj5ofokWjzoa5jAwMkxCykd6,13,33,11,98,4,3,10,2,161,23.0,2,0.0,6,11,96,4,27,3,2,10,2,117,44,1
16319,153256,KLnx64Dkkv51tfpLPbQ8sIJ698FwQUkp,bWdj2GDclj5ofokWjzoa5jAwMkxCykd6,4,2,0,0,0,0,4,0,6,0.8571428571428571,1,0.0,0,0,0,0,2,0,0,4,0,0,6,1
16320,153264,yN30P4SLRbmDewtu5A5YdbrNC6oNgNQn,SpATywNh6bZuzm8s1ceuBUnMUAeoAHHw,22,33,1,26,1,3,7,0,71,10.142857142857142,2,0.0,8,1,25,1,25,3,1,7,0,35,36,1
16321,153286,qzyzNBM5k9TrDdDhv4o4ZBzLquisQf0j,bWdj2GDclj5ofokWjzoa5jAwMkxCykd6,5,11,1,0,0,0,2,0,14,2.0,2,0.0,2,1,0,0,9,0,0,2,0,3,11,1
16322,153297,vljlAhHGhHZt2ciFpy2bQxMoEL2SUwdk,A3fsA9Zfv1X2fVEQhTw51lKENdNrEqT3,7,6,0,0,0,0,2,0,8,1.1428571428571428,1,0.0,0,0,0,0,6,0,0,2,0,0,8,1
16323,153306,I45Q3yivyiRN2kHVhbV8bUCfrXvtpUvU,A3fsA9Zfv1X2fVEQhTw51lKENdNrEqT3,9,4,3,0,3,0,2,0,12,1.7142857142857142,1,0.0,0,3,0,3,4,0,0,2,0,6,6,1
16324,153308,erktNoGO81kr4QkrHCOsCmKD0qcxd37Z,bWdj2GDclj5ofokWjzoa5jAwMkxCykd6,5,2,1,0,1,0,2,0,6,0.8571428571428571,1,0.0,0,1,0,1,2,0,0,2,0,2,4,1
16325,153326,AZlc6zt0IWDCnhebkR8dcDm8Jn7On2BO,G8EPVSXsOYB5YQWZGiz1aVq5Pgr2GrQu,3,0,0,0,0,31,9,0,40,5.714285714285714,2,0.0,0,0,0,0,0,31,0,9,0,0,40,1
16326,153339,kgtwfSxV6DlyR7XWJO7BpLSg33UPKjB8,SpATywNh6bZuzm8s1ceuBUnMUAeoAHHw,1,0,0,0,0,0,1,0,1,0.14285714285714285,1,0.0,0,0,0,0,0,0,0,1,0,0,1,1
16327,153348,rew0c3O7roxnm8EfAzYQGMCDX1NNxnod,bWdj2GDclj5ofokWjzoa5jAwMkxCykd6,5,2,1,0,1,0,2,0,6,0.8571428571428571,1,0.0,0,1,0,1,2,0,0,2,0,2,4,1
16328,153362,NAuTAy6LFtpkSTeaDzpzRRxCaq6qJCQ5,bWdj2GDclj5ofokWjzoa5jAwMkxCykd6,1,0,0,0,0,0,1,0,1,0.14285714285714285,1,0.0,0,0,0,0,0,0,0,1,0,0,1,1
16329,153375,EnaSTRqxkWjMR8pSWQe4ipdWniwPtGKE,A3fsA9Zfv1X2fVEQhTw51lKENdNrEqT3,1,0,0,0,0,0,1,0,1,0.14285714285714285,1,0.0,0,0,0,0,0,0,0,1,0,0,1,1
16330,153391,afQkAxUvdLu532EqkP2BO2E822Re7HYk,SpATywNh6bZuzm8s1ceuBUnMUAeoAHHw,1,0,0,0,0,0,1,0,1,0.14285714285714285,1,0.0,0,0,0,0,0,0,0,1,0,0,1,1
16331,153397,HQm7nMTOyi7HCPaL4vs2tkbd4DWxfE67,A3fsA9Zfv1X2fVEQhTw51lKENdNrEqT3,8,4,2,0,2,0,5,0,13,1.8571428571428572,1,0.0,1,2,0,2,3,0,0,5,0,5,8,1
16332,153405,SQBW44VzMb5zXQWTfzFzAP2RU7qxP2su,A3fsA9Zfv1X2fVEQhTw51lKENdNrEqT3,4,3,2,0,1,0,1,0,7,1.0,2,0.0,0,2,0,1,3,0,0,1,0,3,4,1
16333,153410,0akUPLtvQvvS6uDU84fTYZNIPYPvoH52,A3fsA9Zfv1X2fVEQhTw51lKENdNrEqT3,8,4,1,0,1,1,5,1,13,1.8571428571428572,1,0.0,0,1,0,1,4,1,0,5,1,2,11,1
16334,153427,BtyJK9nVdN1kc0SoyvBwk9Why1olo9fX,SpATywNh6bZuzm8s1ceuBUnMUAeoAHHw,4,2,1,0,0,0,2,0,5,0.7142857142857143,1,0.0,0,1,0,0,2,0,0,2,0,1,4,1
16335,153440,piC2LAhWCCsSJOB3RH6MaHzy9gHIudvG,RXDvfPUBYFlVdlueBFbLW0mhhAyGEqpt,1,0,0,0,0,0,1,0,1,0.14285714285714285,1,0.0,0,0,0,0,0,0,0,1,0,0,1,1
16336,153480,pwnvfCtqibSBzw9gewKZFVOUFkyHecrp,RXDvfPUBYFlVdlueBFbLW0mhhAyGEqpt,1,0,0,0,0,0,1,0,1,0.14285714285714285,1,0.0,0,0,0,0,0,0,0,1,0,0,1,1
16337,153509,EzJJd1vaXRdhAvKq2Q0XoWVWiA4HWk5i,bWdj2GDclj5ofokWjzoa5jAwMkxCykd6,7,4,1,6,1,0,7,0,19,2.7142857142857144,2,0.0,1,1,4,1,3,0,2,7,0,7,12,1
16338,153514,63urTnMQ6906ju0tncFpKl8xLgyyTd5d,SpATywNh6bZuzm8s1ceuBUnMUAeoAHHw,12,9,2,0,2,2,9,1,25,3.5714285714285716,2,0.0,0,2,0,2,9,2,0,9,1,4,21,1
16339,153534,am1ujnojA2ZUYWhKXji6KHqg6kwAFj5z,SpATywNh6bZuzm8s1ceuBUnMUAeoAHHw,7,3,2,0,2,0,2,0,9,1.2857142857142858,1,0.0,0,2,0,2,3,0,0,2,0,4,5,1
16340,153550,CfbsMYGg57bCv0HnMFe2zrw0mAeXuZTI,SpATywNh6bZuzm8s1ceuBUnMUAeoAHHw,2,0,0,0,0,0,2,0,2,0.2857142857142857,1,0.0,0,0,0,0,0,0,0,2,0,0,2,1
16341,153555,YqtqVDKc4pZH2IHRYh05LZbT8NkeJ2tA,bWdj2GDclj5ofokWjzoa5jAwMkxCykd6,10,8,3,0,2,1,8,1,23,3.2857142857142856,1,0.0,3,3,0,2,5,1,0,8,1,8,15,1
16342,153561,AxjnggPTKyT2aYQCBpgnjenDZZbNsOpc,G8EPVSXsOYB5YQWZGiz1aVq5Pgr2GrQu,6,6,2,0,2,0,5,0,15,2.142857142857143,1,0.0,0,2,0,2,6,0,0,5,0,4,11,1
16343,153566,UBlBWZ3qSNiPpjfNB2f0HBLc8JT09fQp,A3fsA9Zfv1X2fVEQhTw51lKENdNrEqT3,13,9,6,0,4,0,11,3,33,4.714285714285714,1,0.0,0,6,0,4,9,0,0,11,3,10,23,1
16344,153568,jR4AfVlqsecU2OD2EAAPnmIP3mzjfI1q,RXDvfPUBYFlVdlueBFbLW0mhhAyGEqpt,3,0,0,0,0,0,3,0,3,0.42857142857142855,1,0.0,0,0,0,0,0,0,0,3,0,0,3,1
16345,153581,6VwrXuZWbgcjNNDx17wfxtM1n4lp5Lty,SpATywNh6bZuzm8s1ceuBUnMUAeoAHHw,5,3,1,0,1,0,2,0,7,1.0,1,0.0,0,1,0,1,3,0,0,2,0,2,5,1
16346,153583,ManuYhUk0ydtDbFYHqGK5HcrqUDdhmXT,A3fsA9Zfv1X2fVEQhTw51lKENdNrEqT3,17,9,1,12,1,2,7,1,33,4.714285714285714,1,0.0,0,1,10,1,9,2,2,7,1,12,21,1
16347,153586,JtIk3EAEhmwR0FR2ilwFzJTkMTjDzXA6,bWdj2GDclj5ofokWjzoa5jAwMkxCykd6,5,4,2,0,2,0,2,0,10,1.4285714285714286,1,0.0,1,2,0,2,3,0,0,2,0,5,5,1
16348,153597,6eigRKdKORgy46hn8ZqOQWxZJBzNbSVK,SpATywNh6bZuzm8s1ceuBUnMUAeoAHHw,18,21,1,67,0,10,2,0,101,14.428571428571429,2,0.0,12,1,57,0,9,10,10,2,0,70,31,0
16349,153624,TQ1Tb2cgiG68xs6aUf696l3C3zHYq6fS,A3fsA9Zfv1X2fVEQhTw51lKENdNrEqT3,4,3,2,0,0,0,1,0,6,0.8571428571428571,1,0.0,0,2,0,0,3,0,0,1,0,2,4,1
16350,153627,Cx9UgN9CA3ZQNCspfULD8FGJJpSFtxJF,A3fsA9Zfv1X2fVEQhTw51lKENdNrEqT3,46,44,37,0,27,0,15,0,123,17.571428571428573,4,0.0,0,37,0,27,44,0,0,15,0,64,59,1
16351,153633,IRpbgsWkgoZJzwjoe9EnoRzUlAbnuMfL,SpATywNh6bZuzm8s1ceuBUnMUAeoAHHw,7,10,3,0,2,0,1,0,16,2.2857142857142856,1,0.0,0,3,0,2,10,0,0,1,0,5,11,1
16352,153667,htua1xywlnpsMMY7EJSOsurL86GI912X,SpATywNh6bZuzm8s1ceuBUnMUAeoAHHw,31,41,22,24,9,2,10,1,109,15.571428571428571,3,0.0,10,22,18,9,31,2,6,10,1,59,50,1
16353,153670,9CQfIvDiQz4gDArSnTXOgxNKUwJW75pD,G8EPVSXsOYB5YQWZGiz1aVq5Pgr2GrQu,32,53,20,32,11,0,14,0,130,18.571428571428573,4,0.0,21,20,22,11,32,0,10,14,0,74,56,1
16354,153672,GLPmzj5hXdU3lPOHJ5T9KsJUoi44XCjZ,bWdj2GDclj5ofokWjzoa5jAwMkxCykd6,8,3,2,0,2,0,3,1,11,1.5714285714285714,1,0.0,0,2,0,2,3,0,0,3,1,4,7,1
16355,153675,ncZpzPYvUtQjJgcrnY99CiTzo4JQVsl8,A3fsA9Zfv1X2fVEQhTw51lKENdNrEqT3,1,0,0,0,0,0,1,0,1,0.14285714285714285,1,0.0,0,0,0,0,0,0,0,1,0,0,1,1
16356,153676,rMQIZQBxSTMFTRmvcfmpoYqCAUhMol3Y,bWdj2GDclj5ofokWjzoa5jAwMkxCykd6,14,38,1,58,4,2,18,8,129,18.428571428571427,3,0.0,13,1,54,4,25,2,4,18,8,72,57,0
16357,153677,ncZpzPYvUtQjJgcrnY99CiTzo4JQVsl8,RXDvfPUBYFlVdlueBFbLW0mhhAyGEqpt,1,0,0,0,0,0,1,0,1,0.14285714285714285,1,0.0,0,0,0,0,0,0,0,1,0,0,1,1
16358,153683,X9vm4W9jxNs3PEUtGGsO0Yn0aFWIbkg5,SpATywNh6bZuzm8s1ceuBUnMUAeoAHHw,11,21,8,0,0,0,2,0,31,4.428571428571429,1,0.0,6,8,0,0,15,0,0,2,0,14,17,1
16359,153696,kQrbauxiC7YRwJ9kMbwlTSfqUjp3UrEF,SpATywNh6bZuzm8s1ceuBUnMUAeoAHHw,15,12,5,19,3,0,3,0,42,6.0,3,0.0,4,5,17,3,8,0,2,3,0,29,13,1
16360,153712,GQQgnryyOjGmrLa2rKAbo7L18aO95YIN,SpATywNh6bZuzm8s1ceuBUnMUAeoAHHw,8,6,4,0,4,0,1,0,15,2.142857142857143,1,0.0,0,4,0,4,6,0,0,1,0,8,7,1
16361,153714,hMspMrStrcDDx9Uzg5qhswDwr2Wyqchl,bWdj2GDclj5ofokWjzoa5jAwMkxCykd6,5,5,4,0,1,0,1,0,11,1.5714285714285714,1,0.0,0,4,0,1,5,0,0,1,0,5,6,1
16362,153717,ikhBAd1BuMTyBJimuuSlAf6s44URi8zu,A3fsA9Zfv1X2fVEQhTw51lKENdNrEqT3,14,6,4,0,3,6,10,5,34,4.857142857142857,1,0.0,1,4,0,3,5,6,0,10,5,8,26,1
16363,153719,9AI5pszWPE25mtEwaHMtbhaDZrYN4oZ9,SpATywNh6bZuzm8s1ceuBUnMUAeoAHHw,5,2,1,0,1,0,2,0,6,0.8571428571428571,1,0.0,0,1,0,1,2,0,0,2,0,2,4,1
16364,153723,TqRaDvXJpdWXGkJNi0RDsTtg47jRUl81,bWdj2GDclj5ofokWjzoa5jAwMkxCykd6,1,0,0,0,0,0,1,0,1,0.14285714285714285,1,0.0,0,0,0,0,0,0,0,1,0,0,1,0
16365,153728,58eQNUjs318sjON50Y8nkDIw70NM1q5r,A3fsA9Zfv1X2fVEQhTw51lKENdNrEqT3,3,1,0,0,0,0,2,0,3,0.42857142857142855,1,0.0,0,0,0,0,1,0,0,2,0,0,3,1
16366,153736,PjOclk6Yw0TIvLC3mHiumPaKYTUJC7i8,G8EPVSXsOYB5YQWZGiz1aVq5Pgr2GrQu,1,0,0,0,0,0,2,0,2,0.2857142857142857,1,0.0,0,0,0,0,0,0,0,2,0,0,2,1
16367,153740,EVmZGFFbud1idCrJ2HZ0M1Xnc7jp4QF2,SpATywNh6bZuzm8s1ceuBUnMUAeoAHHw,1,0,0,0,0,0,1,0,1,0.14285714285714285,1,0.0,0,0,0,0,0,0,0,1,0,0,1,1
16368,153751,sUtQh78DXyhh3vE9rxqMUoIBjqNSKrC0,A3fsA9Zfv1X2fVEQhTw51lKENdNrEqT3,9,4,3,0,3,0,2,1,13,1.8571428571428572,1,0.0,0,3,0,3,4,0,0,2,1,6,7,1
16369,153752,sUtQh78DXyhh3vE9rxqMUoIBjqNSKrC0,bWdj2GDclj5ofokWjzoa5jAwMkxCykd6,2,0,0,0,0,0,2,0,2,0.2857142857142857,1,0.0,0,0,0,0,0,0,0,2,0,0,2,1
16370,153760,sUtQh78DXyhh3vE9rxqMUoIBjqNSKrC0,RXDvfPUBYFlVdlueBFbLW0mhhAyGEqpt,1,0,0,0,0,0,1,0,1,0.14285714285714285,1,0.0,0,0,0,0,0,0,0,1,0,0,1,1
16371,153765,JTN1G4IwNqBxpxjKApCtLeoFv6NT4I58,SpATywNh6bZuzm8s1ceuBUnMUAeoAHHw,18,28,11,18,5,10,9,1,82,11.714285714285714,3,0.0,10,11,15,5,18,10,3,9,1,41,41,1
16372,153767,mUDgTVmygSuewvWeFS0TPPpUtE7wznA7,SpATywNh6bZuzm8s1ceuBUnMUAeoAHHw,5,2,1,0,1,0,2,0,6,0.8571428571428571,1,0.0,0,1,0,1,2,0,0,2,0,2,4,0
16373,153791,qScEGLnewgguP1Ewzar5maJbQBA27NyN,SpATywNh6bZuzm8s1ceuBUnMUAeoAHHw,13,21,0,17,0,6,5,0,49,7.0,1,0.0,9,0,14,0,12,6,3,5,0,23,26,1
16374,153809,57xBvLPGpSkzxqkLuJgHQNjPmsEoPQJW,A3fsA9Zfv1X2fVEQhTw51lKENdNrEqT3,5,6,1,0,0,0,2,0,9,1.2857142857142858,2,0.0,0,1,0,0,6,0,0,2,0,1,8,1
16375,153818,LM1rmZxY7OzUOcYjeqeOXcU9AGsbnd9q,SpATywNh6bZuzm8s1ceuBUnMUAeoAHHw,5,2,1,0,1,0,2,0,6,0.8571428571428571,1,0.0,0,1,0,1,2,0,0,2,0,2,4,1
16376,153819,HkcPmWCSdk3INCYsquWGQGZKijdTCD0w,SpATywNh6bZuzm8s1ceuBUnMUAeoAHHw,15,14,2,8,1,3,9,1,38,5.428571428571429,3,0.0,2,2,7,1,12,3,1,9,1,12,26,1
16377,153821,57xBvLPGpSkzxqkLuJgHQNjPmsEoPQJW,bWdj2GDclj5ofokWjzoa5jAwMkxCykd6,3,6,0,0,0,2,1,0,9,1.2857142857142858,1,0.0,1,0,0,0,5,2,0,1,0,1,8,1
16378,153822,GmUgGkHH917kYWGPPkvD4RSeUx3CJaej,SpATywNh6bZuzm8s1ceuBUnMUAeoAHHw,15,17,0,14,0,5,7,1,44,6.285714285714286,1,0.0,10,0,11,0,7,5,3,7,1,21,23,1
16379,153823,wsHwZ3NkY1tqHKUuOn0buAOnr2acx1MP,bWdj2GDclj5ofokWjzoa5jAwMkxCykd6,3,0,0,0,0,0,3,0,3,0.42857142857142855,1,0.0,0,0,0,0,0,0,0,3,0,0,3,1
16380,153831,uhU9XFMHqXe19d0SBpTzsSNqTtdSMXBT,bWdj2GDclj5ofokWjzoa5jAwMkxCykd6,1,0,0,0,0,0,1,0,1,0.14285714285714285,1,0.0,0,0,0,0,0,0,0,1,0,0,1,1
16381,153842,bdZOWERl4VN1w1rz4KfnRlahupg4gIpq,bWdj2GDclj5ofokWjzoa5jAwMkxCykd6,10,17,10,64,0,16,7,2,116,16.571428571428573,1,0.0,3,10,62,0,14,16,2,7,2,75,41,1
16382,153862,WCBxImuXCQhe4JCGgmUbhM2fHJqNW9fo,A3fsA9Zfv1X2fVEQhTw51lKENdNrEqT3,8,11,5,0,3,0,2,0,21,3.0,1,0.0,0,5,0,3,11,0,0,2,0,8,13,1
16383,153869,Ya9PqShf5x9jueZxN5yIDpfhkNWrfHAh,RXDvfPUBYFlVdlueBFbLW0mhhAyGEqpt,9,4,4,0,3,1,3,0,15,2.142857142857143,1,0.0,0,4,0,3,4,1,0,3,0,7,8,1
16384,153871,kyU7VEeDwoGKq58Y5h10sPBzrIAFqfVi,bWdj2GDclj5ofokWjzoa5jAwMkxCykd6,5,2,1,0,1,0,2,0,6,0.8571428571428571,1,0.0,0,1,0,1,2,0,0,2,0,2,4,1
16385,153873,lHqG7UT3evpRhAVEeXMKWozC3OBfRB6b,A3fsA9Zfv1X2fVEQhTw51lKENdNrEqT3,1,0,0,0,0,0,1,0,1,0.14285714285714285,1,0.0,0,0,0,0,0,0,0,1,0,0,1,1
16386,153874,KSxx5GQKyHs39JznmMANF7eJRsaveHfw,A3fsA9Zfv1X2fVEQhTw51lKENdNrEqT3,7,8,2,0,0,5,9,2,26,3.7142857142857144,2,0.0,0,2,0,0,8,5,0,9,2,2,24,1
16387,153892,d2NzzaJnxOD8hORDU0JQIrwAo12srVeO,SpATywNh6bZuzm8s1ceuBUnMUAeoAHHw,14,17,10,0,6,12,17,7,69,9.857142857142858,4,0.0,0,10,0,6,17,12,0,17,7,16,53,1
16388,153895,f3YcaJisiu4LNXF8c0nltyQqDOirQ4G3,bWdj2GDclj5ofokWjzoa5jAwMkxCykd6,8,7,4,0,2,5,5,1,24,3.4285714285714284,1,0.0,0,4,0,2,7,5,0,5,1,6,18,1
16389,153899,RuTxY8DaJW8mZYxEAeQrQJD3l4wbq41Q,bWdj2GDclj5ofokWjzoa5jAwMkxCykd6,5,3,1,0,1,0,2,0,7,1.0,1,0.0,0,1,0,1,3,0,0,2,0,2,5,1
16390,153900,idxxWwMKAxBMibSoM88bXM2M515R6wYi,SpATywNh6bZuzm8s1ceuBUnMUAeoAHHw,5,2,1,0,1,0,2,0,6,0.8571428571428571,1,0.0,0,1,0,1,2,0,0,2,0,2,4,1
16391,153903,XmbkXRvCaUzUbqcHrpRU9UVMv582qDRu,G8EPVSXsOYB5YQWZGiz1aVq5Pgr2GrQu,17,7,4,20,2,2,9,1,45,6.428571428571429,1,0.0,0,4,18,2,7,2,2,9,1,24,21,1
16392,153928,rWCtYQJxLY6x4HYR2cUOUU68SSwJtOXD,SpATywNh6bZuzm8s1ceuBUnMUAeoAHHw,1,0,0,0,0,0,1,0,1,0.14285714285714285,1,0.0,0,0,0,0,0,0,0,1,0,0,1,1
16393,153935,xCtx9oK39TlKlw1wuTfbxFcC7lD8Tvmu,SpATywNh6bZuzm8s1ceuBUnMUAeoAHHw,6,11,3,0,1,0,3,0,18,2.5714285714285716,1,0.0,0,3,0,1,11,0,0,3,0,4,14,1
16394,153936,UU4MEikmCGklRVK3djHNSk7yxxkesa3p,SpATywNh6bZuzm8s1ceuBUnMUAeoAHHw,6,5,0,0,1,0,2,0,8,1.1428571428571428,1,0.0,0,0,0,1,5,0,0,2,0,1,7,1
16395,153941,ECkqmAuIkv3ncN9wNJby8oOn15qTd9kR,A3fsA9Zfv1X2fVEQhTw51lKENdNrEqT3,1,0,0,0,0,0,1,0,1,0.14285714285714285,1,0.0,0,0,0,0,0,0,0,1,0,0,1,1
16396,153950,4IJ56QlJSL8avuRQEkrBcEyhUIO3LIP3,A3fsA9Zfv1X2fVEQhTw51lKENdNrEqT3,53,31,16,72,5,0,21,0,145,20.714285714285715,5,0.0,6,16,72,5,25,0,0,21,0,99,46,0
16397,153951,QcAEBwtOda13Q2hwEpOzUuFeV6Y52Ggz,SpATywNh6bZuzm8s1ceuBUnMUAeoAHHw,15,27,2,20,0,0,4,0,53,7.571428571428571,3,0.0,9,2,17,0,18,0,3,4,0,28,25,1
16398,153958,LhMGo1H458StfoGsiIJMkiDJEIOqqbKe,SpATywNh6bZuzm8s1ceuBUnMUAeoAHHw,19,23,17,0,9,0,3,0,52,7.428571428571429,2,0.0,3,17,0,9,20,0,0,3,0,29,23,0
16399,153988,vN0Rkga5RDQhnR6Qd8HVKAqnd5DqO9Q9,G8EPVSXsOYB5YQWZGiz1aVq5Pgr2GrQu,6,3,1,0,1,0,5,0,10,1.4285714285714286,2,0.0,0,1,0,1,3,0,0,5,0,2,8,1
16400,153989,lqbdGj6Vu3etzwWvEelu4TAXnkcY6ywX,SpATywNh6bZuzm8s1ceuBUnMUAeoAHHw,5,2,1,0,1,0,2,0,6,0.8571428571428571,1,0.0,0,1,0,1,2,0,0,2,0,2,4,1
16401,153990,wUS4QMZENKgcJOovrFGfoZniw3fDJWWg,SpATywNh6bZuzm8s1ceuBUnMUAeoAHHw,21,25,13,36,2,0,10,0,86,12.285714285714286,8,0.0,7,13,32,2,18,0,4,10,0,54,32,0
16402,153995,Bj2SxvASGVcIXgTPxMzZPlX3DzMVAgje,bWdj2GDclj5ofokWjzoa5jAwMkxCykd6,6,4,1,2,2,0,3,0,12,1.7142857142857142,1,0.0,2,1,2,2,2,0,0,3,0,7,5,1
16403,153996,7IjzbYGXgciR2DhqsqrtMeDkNMFINoYx,SpATywNh6bZuzm8s1ceuBUnMUAeoAHHw,20,37,15,5,5,1,23,1,87,12.428571428571429,2,0.0,13,15,5,5,24,1,0,23,1,38,49,1
16404,153997,zdA78Dg0BGWLvIRxkEt1PHhxNyG6hsIH,SpATywNh6bZuzm8s1ceuBUnMUAeoAHHw,1,0,0,0,0,0,1,0,1,0.14285714285714285,1,0.0,0,0,0,0,0,0,0,1,0,0,1,1
16405,154002,oO8PkmS40wsHMDT2LhD46mYGdAQ8FooI,bWdj2GDclj5ofokWjzoa5jAwMkxCykd6,15,28,11,48,8,14,5,0,114,16.285714285714285,2,0.0,10,11,45,8,18,14,3,5,0,74,40,1
16406,154011,u1aZFlVWlqtE11RPrh292EwKCdah7ek7,SpATywNh6bZuzm8s1ceuBUnMUAeoAHHw,4,2,0,0,0,0,2,0,4,0.5714285714285714,1,0.0,0,0,0,0,2,0,0,2,0,0,4,1
16407,154040,zWXhTxTG418YOfBpnhuFBg2UPPJXEdZa,SpATywNh6bZuzm8s1ceuBUnMUAeoAHHw,5,3,1,0,1,0,1,0,6,0.8571428571428571,1,0.0,0,1,0,1,3,0,0,1,0,2,4,1
16408,154056,3v4pf4Z2sq302espsMpIgHq4VUPDIN8A,SpATywNh6bZuzm8s1ceuBUnMUAeoAHHw,5,2,1,0,1,1,2,0,7,1.0,1,0.0,0,1,0,1,2,1,0,2,0,2,5,1
16409,154062,TSAIY3YjXsZdZc9oVcWWYSbgnOAvAP3E,G8EPVSXsOYB5YQWZGiz1aVq5Pgr2GrQu,5,3,1,0,1,0,2,0,7,1.0,1,0.0,0,1,0,1,3,0,0,2,0,2,5,1
16410,154066,BJOmIWRDihyZz3o40vbdAfCNe0WIbLc5,SpATywNh6bZuzm8s1ceuBUnMUAeoAHHw,6,2,1,0,1,0,3,0,7,1.0,1,0.0,0,1,0,1,2,0,0,3,0,2,5,1
16411,154076,22YNnFMji9XXRm4684KBVp3G0eZTCIft,A3fsA9Zfv1X2fVEQhTw51lKENdNrEqT3,13,8,5,0,4,0,8,0,25,3.5714285714285716,1,0.0,0,5,0,4,8,0,0,8,0,9,16,1
16412,154091,3FZ7859u0AJ285S0tHRE6ylhfDMJda8K,SpATywNh6bZuzm8s1ceuBUnMUAeoAHHw,1,0,0,0,0,0,1,0,1,0.14285714285714285,1,0.0,0,0,0,0,0,0,0,1,0,0,1,1
16413,154093,p6TgFJdLQMaMzbR16kycIPcRPnBj3paK,SpATywNh6bZuzm8s1ceuBUnMUAeoAHHw,4,2,1,0,1,0,2,0,6,0.8571428571428571,2,0.0,0,1,0,1,2,0,0,2,0,2,4,1
16414,154101,SS2LhAp5I5Z43oIfHH4Ih7CTNU5vDf5h,SpATywNh6bZuzm8s1ceuBUnMUAeoAHHw,1,0,0,0,0,0,1,0,1,0.14285714285714285,1,0.0,0,0,0,0,0,0,0,1,0,0,1,1
16415,154104,9Jy1wR1kNKfVIlzkWjf6DnrfYfDGnPzT,SpATywNh6bZuzm8s1ceuBUnMUAeoAHHw,20,31,19,12,11,16,12,1,102,14.571428571428571,4,0.0,7,19,12,11,24,16,0,12,1,49,53,0
16416,154109,Cx9AvhpaoGF7JJ71AI7APeANc2Vipt9I,SpATywNh6bZuzm8s1ceuBUnMUAeoAHHw,1,0,0,0,0,0,1,0,1,0.14285714285714285,1,0.0,0,0,0,0,0,0,0,1,0,0,1,1
16417,154111,fKBgr7W6Vaq7CaM5NPYdwouK9aGfjKnk,SpATywNh6bZuzm8s1ceuBUnMUAeoAHHw,4,3,0,0,0,0,5,0,8,1.1428571428571428,1,0.0,0,0,0,0,3,0,0,5,0,0,8,1
16418,154128,bw9Orpcerztec7DXXrZLdtk0pUJ9Agjc,RXDvfPUBYFlVdlueBFbLW0mhhAyGEqpt,12,6,1,3,1,1,3,0,15,2.142857142857143,1,0.0,1,1,3,1,5,1,0,3,0,6,9,1
16419,154145,MUAq8cgExXjyCvVsMiE64RjE0HwCMEx8,A3fsA9Zfv1X2fVEQhTw51lKENdNrEqT3,7,2,1,0,1,0,6,1,11,1.5714285714285714,1,0.0,0,1,0,1,2,0,0,6,1,2,9,1
16420,154161,YtJbqHCfQeko1zihs9n6E1Ly00ndbcI5,bWdj2GDclj5ofokWjzoa5jAwMkxCykd6,4,1,0,0,0,0,4,0,5,0.7142857142857143,1,0.0,0,0,0,0,1,0,0,4,0,0,5,1
16421,154171,2m1f0GkzC3lXY6f5kS8aatrSNoeQ2Cc4,SpATywNh6bZuzm8s1ceuBUnMUAeoAHHw,11,17,10,0,6,3,12,0,48,6.857142857142857,2,0.0,3,10,0,6,14,3,0,12,0,19,29,1
16422,154190,fZpfLVVUEp7GXISLcNFyxWveiOP0dldp,SpATywNh6bZuzm8s1ceuBUnMUAeoAHHw,8,15,0,0,0,0,1,0,16,2.2857142857142856,1,0.0,1,0,0,0,14,0,0,1,0,1,15,0
16423,154193,6HPRmmMDN5OSycgmfnsrqG7YAJbfsWTK,SpATywNh6bZuzm8s1ceuBUnMUAeoAHHw,19,25,8,29,3,0,3,0,68,9.714285714285714,2,0.0,8,8,27,3,17,0,2,3,0,46,22,1
16424,154199,bZtNzDzO2qmGZ75gSzCr8t2M40vhOtlI,A3fsA9Zfv1X2fVEQhTw51lKENdNrEqT3,9,4,2,0,1,2,10,1,20,2.857142857142857,2,0.0,0,2,0,1,4,2,0,10,1,3,17,0
16425,154200,ADL0cXowUMs4wyiAOHKMOrtTHu5tmUqi,bWdj2GDclj5ofokWjzoa5jAwMkxCykd6,15,23,14,0,7,3,18,1,66,9.428571428571429,8,0.0,0,14,0,7,23,3,0,18,1,21,45,1
16426,154205,VkP2FMJkYtjRnWEjWjvJiNyMgDQRBrMl,SpATywNh6bZuzm8s1ceuBUnMUAeoAHHw,2,0,0,0,0,0,2,0,2,0.2857142857142857,1,0.0,0,0,0,0,0,0,0,2,0,0,2,1
16427,154211,RcsMEES0IQ1NHP2Ss1VxXk92ez6mhLug,bWdj2GDclj5ofokWjzoa5jAwMkxCykd6,4,3,1,0,0,0,3,0,7,1.0,1,0.0,0,1,0,0,3,0,0,3,0,1,6,1
16428,154221,1L7XwCOwn8nIJFjaEmGoI47SzrXbe8CM,SpATywNh6bZuzm8s1ceuBUnMUAeoAHHw,39,70,8,54,5,71,44,7,259,37.0,7,0.0,17,8,44,5,53,71,10,44,7,74,185,0
16429,154223,BMt1sMJKW8lUV5XsrUOWqq2qoU33TZEw,SpATywNh6bZuzm8s1ceuBUnMUAeoAHHw,5,2,1,0,1,0,3,0,7,1.0,2,0.0,0,1,0,1,2,0,0,3,0,2,5,0
16430,154228,VJhm6I36LQr0FmcUOAokoIcRg6PaQgVK,5X6FeZozNMgE2VRi3MJYjkkFK8SETtu2,11,10,4,16,1,0,1,0,32,4.571428571428571,1,0.0,5,4,13,1,5,0,3,1,0,23,9,1
16431,154231,K0hgN6EPFKAMVeEw5GxRK0vYsf24AoLe,SpATywNh6bZuzm8s1ceuBUnMUAeoAHHw,9,10,1,0,1,0,2,0,14,2.0,1,0.0,0,1,0,1,10,0,0,2,0,2,12,1
16432,154246,doq0SIEfuXLh3rhMgIRl48ziIEgIAsIt,bWdj2GDclj5ofokWjzoa5jAwMkxCykd6,2,0,0,0,0,0,5,0,5,0.7142857142857143,1,0.0,0,0,0,0,0,0,0,5,0,0,5,1
16433,154247,P6B9efDEJGlP1ORO2WrplfGvOXQTSwgH,SpATywNh6bZuzm8s1ceuBUnMUAeoAHHw,8,5,0,10,0,0,3,0,18,2.5714285714285716,1,0.0,2,0,9,0,3,0,1,3,0,11,7,1
16434,154249,vMZukU2eTrxJbVM8jQ4bYVexnS3K2zdf,RXDvfPUBYFlVdlueBFbLW0mhhAyGEqpt,1,0,0,0,0,0,1,0,1,0.14285714285714285,1,0.0,0,0,0,0,0,0,0,1,0,0,1,1
16435,154250,vMZukU2eTrxJbVM8jQ4bYVexnS3K2zdf,A3fsA9Zfv1X2fVEQhTw51lKENdNrEqT3,1,0,0,0,0,0,1,0,1,0.14285714285714285,1,0.0,0,0,0,0,0,0,0,1,0,0,1,1
16436,154251,oq792xm7gmyCP2WQE7GtJSHRmKgIoEc3,A3fsA9Zfv1X2fVEQhTw51lKENdNrEqT3,8,4,2,0,2,0,4,0,12,1.7142857142857142,1,0.0,0,2,0,2,4,0,0,4,0,4,8,1
16437,154253,QweH7yTZRdri03OUSokKH99D0caZDv7H,7GRhBDsirIGkRZBtSMEzNTyDr2JQm4xx,7,4,1,0,2,1,3,0,11,1.5714285714285714,1,0.0,2,1,0,2,2,1,0,3,0,5,6,1
16438,154265,lHNqd6KTSO9CrJzRDAqosVITLVN3mMHR,A3fsA9Zfv1X2fVEQhTw51lKENdNrEqT3,4,2,1,0,1,0,2,0,6,0.8571428571428571,1,0.0,0,1,0,1,2,0,0,2,0,2,4,1
16439,154284,QCIxkwrtd7EyHnigeiQpqn6l0kVuCgK4,7GRhBDsirIGkRZBtSMEzNTyDr2JQm4xx,9,6,2,0,1,2,6,1,18,2.5714285714285716,1,0.0,0,2,0,1,6,2,0,6,1,3,15,1
16440,154301,Q95csmmf8N84WQQSbOMc5rN6dm3wzDuG,SpATywNh6bZuzm8s1ceuBUnMUAeoAHHw,27,105,3,25,1,2,7,0,143,20.428571428571427,3,0.0,1,3,20,1,104,2,5,7,0,25,118,0
16441,154312,j5n34dhJSAsFAv6KAw4rsAZTfhL07lCD,SpATywNh6bZuzm8s1ceuBUnMUAeoAHHw,2,0,0,0,0,0,4,0,4,0.5714285714285714,1,0.0,0,0,0,0,0,0,0,4,0,0,4,0
16442,154314,ulqdtzoaFKnUas51E4T9qwtZYnxyLzzg,7GRhBDsirIGkRZBtSMEzNTyDr2JQm4xx,3,0,0,0,0,0,9,0,9,1.2857142857142858,1,0.0,0,0,0,0,0,0,0,9,0,0,9,1
16443,154323,8wj2Kr145taRtViYKZRdPMwAZeP9BDRs,bWdj2GDclj5ofokWjzoa5jAwMkxCykd6,7,22,0,0,0,0,2,0,24,3.4285714285714284,1,0.0,0,0,0,0,22,0,0,2,0,0,24,1
16444,154333,bwcAzG6YdKhEVab04avTnWUikImaTY8v,RXDvfPUBYFlVdlueBFbLW0mhhAyGEqpt,1,0,0,0,0,0,1,0,1,0.14285714285714285,1,0.0,0,0,0,0,0,0,0,1,0,0,1,1
16445,154334,bwcAzG6YdKhEVab04avTnWUikImaTY8v,A3fsA9Zfv1X2fVEQhTw51lKENdNrEqT3,9,2,1,0,1,1,18,2,25,3.5714285714285716,1,0.0,0,1,0,1,2,1,0,18,2,2,23,1
16446,154354,4WoTXmD4gNpFhGlNTy7sFsNpyMYm6Dkz,RXDvfPUBYFlVdlueBFbLW0mhhAyGEqpt,6,2,1,0,1,0,3,0,7,1.0,1,0.0,0,1,0,1,2,0,0,3,0,2,5,1
16447,154361,Zz1hYW3bIv4cloYkUjUfNR6Tk0kO8ZBM,7GRhBDsirIGkRZBtSMEzNTyDr2JQm4xx,1,0,0,0,0,0,1,0,1,0.14285714285714285,1,0.0,0,0,0,0,0,0,0,1,0,0,1,1
16448,154362,borLfwQKnWQDaKpJWf2eYB7K9O0eDbfg,SpATywNh6bZuzm8s1ceuBUnMUAeoAHHw,7,5,2,0,1,0,2,0,10,1.4285714285714286,1,0.0,0,2,0,1,5,0,0,2,0,3,7,1
16449,154366,3qfZ2A9FxIJejbK8qk5S90EK3qjlCNkC,bWdj2GDclj5ofokWjzoa5jAwMkxCykd6,2,0,0,0,0,0,2,0,2,0.2857142857142857,1,0.0,0,0,0,0,0,0,0,2,0,0,2,1
16450,154367,EqDMtLRDV3YTsfyNsZW3gWT7QJ22Zgxb,7GRhBDsirIGkRZBtSMEzNTyDr2JQm4xx,1,0,0,0,0,0,1,0,1,0.14285714285714285,1,0.0,0,0,0,0,0,0,0,1,0,0,1,1
16451,154378,0bzBCQH8D9DXq9uXmykneuVKZUsPAEIB,A3fsA9Zfv1X2fVEQhTw51lKENdNrEqT3,1,0,0,0,0,0,1,0,1,0.14285714285714285,1,0.0,0,0,0,0,0,0,0,1,0,0,1,1
16452,154388,yn2Ij88V2wSgGFNHE75cImAmp292E61N,bWdj2GDclj5ofokWjzoa5jAwMkxCykd6,4,2,1,0,1,0,1,0,5,0.7142857142857143,1,0.0,0,1,0,1,2,0,0,1,0,2,3,1
16453,154398,5dFDKTPyqIzDoJ1o2UMmJJhGPtehK3JJ,7GRhBDsirIGkRZBtSMEzNTyDr2JQm4xx,3,0,0,0,0,0,3,0,3,0.42857142857142855,1,0.0,0,0,0,0,0,0,0,3,0,0,3,1
16454,154403,Mh44KtMgRmYCujGM63SxGn0CwanNqhA0,SpATywNh6bZuzm8s1ceuBUnMUAeoAHHw,8,6,3,0,2,0,4,0,15,2.142857142857143,1,0.0,0,3,0,2,6,0,0,4,0,5,10,1
16455,154407,sL5jw3pLWZoRI7avI17oM60mfF67Acgz,SpATywNh6bZuzm8s1ceuBUnMUAeoAHHw,1,0,0,0,0,0,2,0,2,0.2857142857142857,2,0.0,0,0,0,0,0,0,0,2,0,0,2,0
16456,154411,olQfS2P1K3wp42EzSupsJTTzmMQfpa8x,bWdj2GDclj5ofokWjzoa5jAwMkxCykd6,1,0,0,0,0,0,1,0,1,0.14285714285714285,1,0.0,0,0,0,0,0,0,0,1,0,0,1,1
16457,154416,sL5jw3pLWZoRI7avI17oM60mfF67Acgz,A3fsA9Zfv1X2fVEQhTw51lKENdNrEqT3,1,0,0,0,0,0,2,0,2,0.2857142857142857,2,0.0,0,0,0,0,0,0,0,2,0,0,2,0
16458,154417,J7xI7D1ZLw62w7Lpu84mgS9dLOc8YAMh,SpATywNh6bZuzm8s1ceuBUnMUAeoAHHw,5,2,1,0,1,0,2,0,6,0.8571428571428571,1,0.0,0,1,0,1,2,0,0,2,0,2,4,1
16459,154427,OykLnAMH2CQ2oGjpNacvJNT6LnoApkhT,7GRhBDsirIGkRZBtSMEzNTyDr2JQm4xx,2,0,0,0,0,0,2,0,2,0.2857142857142857,1,0.0,0,0,0,0,0,0,0,2,0,0,2,1
16460,154428,Xbjcs0h4iqswHrts5r1qniR6WxCj6WXz,SpATywNh6bZuzm8s1ceuBUnMUAeoAHHw,9,5,2,0,2,1,8,1,19,2.7142857142857144,2,0.0,0,2,0,2,5,1,0,8,1,4,15,1
16461,154442,1w3T4A4bbOqj5R90btAgoZLx68QfKlnC,SpATywNh6bZuzm8s1ceuBUnMUAeoAHHw,1,0,0,0,0,0,1,0,1,0.14285714285714285,1,0.0,0,0,0,0,0,0,0,1,0,0,1,1
16462,154444,3YtkDWwirpMDJnuKbd3WSxL09KJDQLqD,SpATywNh6bZuzm8s1ceuBUnMUAeoAHHw,7,3,2,0,2,0,2,0,9,1.2857142857142858,1,0.0,0,2,0,2,3,0,0,2,0,4,5,1
16463,154448,lhlon92qtIm50z28ydik0v6JhWIxsC1U,7GRhBDsirIGkRZBtSMEzNTyDr2JQm4xx,1,0,0,0,0,0,1,0,1,0.14285714285714285,1,0.0,0,0,0,0,0,0,0,1,0,0,1,1
16464,154459,EbUgzFZQuqMLq3Ycl8KSraeAAdFrDcJ5,SpATywNh6bZuzm8s1ceuBUnMUAeoAHHw,1,0,0,0,0,0,1,0,1,0.14285714285714285,1,0.0,0,0,0,0,0,0,0,1,0,0,1,1
16465,154460,OEx9XlzSJPvCfbdzSv0p8sreAOhdWSET,5X6FeZozNMgE2VRi3MJYjkkFK8SETtu2,1,0,0,0,0,0,1,0,1,0.14285714285714285,1,0.0,0,0,0,0,0,0,0,1,0,0,1,1
16466,154469,bI0Q5X85yfYg1Yc91nn45oYI5ITZRXL9,SpATywNh6bZuzm8s1ceuBUnMUAeoAHHw,5,7,3,0,0,0,2,0,12,1.7142857142857142,1,0.0,0,3,0,0,7,0,0,2,0,3,9,1
16467,154474,iZp3ALNWwOETx9Rhz5RySkBkkPAlDqst,7GRhBDsirIGkRZBtSMEzNTyDr2JQm4xx,28,54,16,38,10,9,3,0,130,18.571428571428573,1,0.0,36,16,32,10,18,9,6,3,0,94,36,1
16468,154475,wMQxNrryGKgbGXsy17gJPlh2fJdDvt8s,7GRhBDsirIGkRZBtSMEzNTyDr2JQm4xx,11,10,6,0,5,0,3,0,24,3.4285714285714284,2,0.0,2,6,0,5,8,0,0,3,0,13,11,1
16469,154478,JCNZU9htEer2NbGrICdyG89BFjfxR5oQ,SpATywNh6bZuzm8s1ceuBUnMUAeoAHHw,36,26,15,32,10,0,2,0,85,12.142857142857142,1,0.0,10,15,29,10,16,0,3,2,0,64,21,0
16470,154484,iacqYcgHTn7FZ8NE4roe5kgAUjDF0efr,7GRhBDsirIGkRZBtSMEzNTyDr2JQm4xx,13,18,10,6,5,1,16,1,57,8.142857142857142,5,0.0,2,10,5,5,16,1,1,16,1,22,35,1
16471,154517,oT3mLzHF4Tpr8bcFPMHSPaLobLxRQRsd,7GRhBDsirIGkRZBtSMEzNTyDr2JQm4xx,1,0,0,0,0,0,1,0,1,0.14285714285714285,1,0.0,0,0,0,0,0,0,0,1,0,0,1,1
16472,154521,BFTedJpOGn9f3lzS2daZGbUvWzaKCeH4,RXDvfPUBYFlVdlueBFbLW0mhhAyGEqpt,7,2,2,0,2,0,3,0,9,1.2857142857142858,2,0.0,0,2,0,2,2,0,0,3,0,4,5,1
16473,154524,lmBC1dNZwqemvW2IDczAxkPjOIjaeRwM,A3fsA9Zfv1X2fVEQhTw51lKENdNrEqT3,1,0,0,0,0,0,1,0,1,0.14285714285714285,1,0.0,0,0,0,0,0,0,0,1,0,0,1,1
16474,154539,xZKocCFxH13wvUu4XlTWKN88QVCTtFi0,bWdj2GDclj5ofokWjzoa5jAwMkxCykd6,11,13,7,0,3,1,13,0,37,5.285714285714286,1,0.0,0,7,0,3,13,1,0,13,0,10,27,1
16475,154544,4Zj3rSr4SVLur34IbcdhBk6xi5qGX4FT,SpATywNh6bZuzm8s1ceuBUnMUAeoAHHw,1,0,0,0,0,0,1,0,1,0.14285714285714285,1,0.0,0,0,0,0,0,0,0,1,0,0,1,1
16476,154551,REu6I5HKZ7L3HGMQ4JYIwxBklFnvOom7,A3fsA9Zfv1X2fVEQhTw51lKENdNrEqT3,2,0,0,0,0,0,4,0,4,0.5714285714285714,1,0.0,0,0,0,0,0,0,0,4,0,0,4,1
16477,154560,KXPsJNzb3MNK5rxQc94IXJdmXF0ziWwA,bWdj2GDclj5ofokWjzoa5jAwMkxCykd6,7,4,2,0,1,0,3,0,10,1.4285714285714286,1,0.0,0,2,0,1,4,0,0,3,0,3,7,0
16478,154565,hUoOQP103jtoSjE8huNXPy5FlXS050j3,5X6FeZozNMgE2VRi3MJYjkkFK8SETtu2,1,0,0,0,0,0,1,0,1,0.14285714285714285,1,0.0,0,0,0,0,0,0,0,1,0,0,1,1
16479,154566,hUoOQP103jtoSjE8huNXPy5FlXS050j3,A3fsA9Zfv1X2fVEQhTw51lKENdNrEqT3,1,0,0,0,0,0,1,0,1,0.14285714285714285,1,0.0,0,0,0,0,0,0,0,1,0,0,1,1
16480,154583,asAtaJoAJHlf2G0ikRIi1BJt6dsbnxvW,7GRhBDsirIGkRZBtSMEzNTyDr2JQm4xx,19,44,2,26,4,0,15,0,91,13.0,6,0.0,16,2,22,4,28,0,4,15,0,44,47,1
16481,154584,CpJFUzNBBad8gxGQfFWcVCTdakqtlRdi,SpATywNh6bZuzm8s1ceuBUnMUAeoAHHw,1,0,0,0,0,0,1,0,1,0.14285714285714285,1,0.0,0,0,0,0,0,0,0,1,0,0,1,0
16482,154590,ssvdsBgwcBaykgmvf8ppxZPzAKCun6bj,RXDvfPUBYFlVdlueBFbLW0mhhAyGEqpt,1,0,0,0,0,0,1,0,1,0.14285714285714285,1,0.0,0,0,0,0,0,0,0,1,0,0,1,1
16483,154591,vso8N8C6SGS9FKZBYRQzzSzH6hqVT7IH,A3fsA9Zfv1X2fVEQhTw51lKENdNrEqT3,2,0,0,0,0,0,2,0,2,0.2857142857142857,1,0.0,0,0,0,0,0,0,0,2,0,0,2,1
16484,154596,LKQRwZ0wiIjNtxj2rwmRK6v48vwGtrYE,7GRhBDsirIGkRZBtSMEzNTyDr2JQm4xx,1,0,0,0,0,0,1,0,1,0.14285714285714285,1,0.0,0,0,0,0,0,0,0,1,0,0,1,1
16485,154598,LKQRwZ0wiIjNtxj2rwmRK6v48vwGtrYE,A3fsA9Zfv1X2fVEQhTw51lKENdNrEqT3,1,0,0,0,0,0,1,0,1,0.14285714285714285,1,0.0,0,0,0,0,0,0,0,1,0,0,1,1
16486,154604,YSnKbrlImP4pvrhieOIt3sEPDgO5Vl1a,5X6FeZozNMgE2VRi3MJYjkkFK8SETtu2,3,3,0,0,0,0,2,0,5,0.7142857142857143,1,0.0,0,0,0,0,3,0,0,2,0,0,5,1
16487,154635,futyrc5ZKHBBJxaxN8pRQj4FOD0yyEl8,7GRhBDsirIGkRZBtSMEzNTyDr2JQm4xx,38,107,26,64,36,2,4,0,239,34.142857142857146,3,0.0,42,26,58,36,65,2,6,4,0,162,77,1
16488,154641,0nScgbbn10u6m6AtEv5NZACOHoXfwiE1,A3fsA9Zfv1X2fVEQhTw51lKENdNrEqT3,5,2,1,0,1,0,2,0,6,0.8571428571428571,1,0.0,0,1,0,1,2,0,0,2,0,2,4,1
16489,154643,78awNsb2gv1BNI14errPUoSJXoVpCdJH,5X6FeZozNMgE2VRi3MJYjkkFK8SETtu2,4,2,1,0,1,0,1,0,5,0.7142857142857143,1,0.0,0,1,0,1,2,0,0,1,0,2,3,1
16490,154644,efygWYkxxUMOGInRZT4qEeuzMRlIpQq6,5X6FeZozNMgE2VRi3MJYjkkFK8SETtu2,9,19,5,0,11,0,3,0,38,5.428571428571429,1,0.0,12,5,0,11,7,0,0,3,0,28,10,1
16491,154664,wmND65rZOV8Cdq3Mq9MmFLy7XUHHSgIW,7GRhBDsirIGkRZBtSMEzNTyDr2JQm4xx,4,2,1,0,1,0,2,0,6,0.8571428571428571,1,0.0,0,1,0,1,2,0,0,2,0,2,4,1
16492,154665,wmND65rZOV8Cdq3Mq9MmFLy7XUHHSgIW,RXDvfPUBYFlVdlueBFbLW0mhhAyGEqpt,23,24,11,28,5,8,8,0,84,12.0,2,0.0,4,11,24,5,20,8,4,8,0,44,40,1
16493,154667,kXKedIAlLk4nnLOObHVKEfusEbZyfe2f,SpATywNh6bZuzm8s1ceuBUnMUAeoAHHw,14,17,10,17,5,1,1,0,51,7.285714285714286,1,0.0,4,10,16,5,13,1,1,1,0,35,16,1
16494,154669,HrLh8JEm4n69pNmCXCEexqU3Iv3PlzAM,5X6FeZozNMgE2VRi3MJYjkkFK8SETtu2,8,3,1,0,1,0,13,2,20,2.857142857142857,1,0.0,1,1,0,1,2,0,0,13,2,3,17,1
16495,154673,Bb6y6KL5R1oXKLejmEf2ogmY60nmHSEg,7GRhBDsirIGkRZBtSMEzNTyDr2JQm4xx,15,19,0,4,0,1,6,0,30,4.285714285714286,1,0.0,4,0,4,0,15,1,0,6,0,8,22,1
16496,154683,MHJvZPnhmnZTjSPJQtFU0MT0vplye5Bv,G8EPVSXsOYB5YQWZGiz1aVq5Pgr2GrQu,5,2,1,0,1,0,2,0,6,0.8571428571428571,1,0.0,0,1,0,1,2,0,0,2,0,2,4,1
16497,154684,ZnPDiA6jmqQOIbODvVYNoIgZSaO1dso9,bWdj2GDclj5ofokWjzoa5jAwMkxCykd6,7,3,1,6,0,0,2,0,12,1.7142857142857142,1,0.0,0,1,5,0,3,0,1,2,0,6,6,1
16498,154688,O5KBwdPnEkmA9netVr9aGipw3OlgkQS8,SpATywNh6bZuzm8s1ceuBUnMUAeoAHHw,4,3,1,0,1,0,1,0,6,0.8571428571428571,1,0.0,0,1,0,1,3,0,0,1,0,2,4,0
16499,154697,baJe2qLGs3Ip92Th7HUsdUzkULF4fldq,SpATywNh6bZuzm8s1ceuBUnMUAeoAHHw,5,4,1,0,1,0,2,0,8,1.1428571428571428,1,0.0,0,1,0,1,4,0,0,2,0,2,6,1
16500,154702,51qEFZOUTGpCzgn45qQPhHW3j42BvDye,SpATywNh6bZuzm8s1ceuBUnMUAeoAHHw,1,0,0,0,0,0,1,0,1,0.14285714285714285,1,0.0,0,0,0,0,0,0,0,1,0,0,1,1
16501,154704,Egdy45SajGfwa36GhPAOZxJnoTDau3yk,bWdj2GDclj5ofokWjzoa5jAwMkxCykd6,6,4,1,0,0,0,2,0,7,1.0,1,0.0,0,1,0,0,4,0,0,2,0,1,6,1
16502,154710,DpmftUmsDQQIOqNkNnczWDyK6dR9ueCw,SpATywNh6bZuzm8s1ceuBUnMUAeoAHHw,2,0,0,0,0,0,3,0,3,0.42857142857142855,1,0.0,0,0,0,0,0,0,0,3,0,0,3,1
16503,154719,bQS9TypVeSJHdaY7Zz5SfbkFkeJ7Xy7P,G8EPVSXsOYB5YQWZGiz1aVq5Pgr2GrQu,14,13,2,0,1,3,11,1,31,4.428571428571429,2,0.0,0,2,0,1,13,3,0,11,1,3,28,1
16504,154721,JkBKsyFO0Yc8vpbIVFPRsgPENSXQYzwJ,7GRhBDsirIGkRZBtSMEzNTyDr2JQm4xx,7,4,3,0,3,0,3,0,13,1.8571428571428572,1,0.0,0,3,0,3,4,0,0,3,0,6,7,1
16505,154728,QTkjMZ2x2XpQJLg858rH1nCjMIxPq1Ot,A3fsA9Zfv1X2fVEQhTw51lKENdNrEqT3,2,0,0,0,0,0,2,0,2,0.2857142857142857,1,0.0,0,0,0,0,0,0,0,2,0,0,2,1
16506,154733,x6NoW0QQVYu5T8LkblNNdQuYhCF6tniR,bWdj2GDclj5ofokWjzoa5jAwMkxCykd6,2,0,0,0,0,0,3,0,3,0.42857142857142855,1,0.0,0,0,0,0,0,0,0,3,0,0,3,1
16507,154750,9022MHPvnYCQFW4Qbw5KRQ2IXKBbqJc6,7GRhBDsirIGkRZBtSMEzNTyDr2JQm4xx,9,4,3,0,0,6,7,1,21,3.0,1,0.0,0,3,0,0,4,6,0,7,1,3,18,1
16508,154753,lX00Qx4mrcf92rmBX6j1aDrAydficDZP,RXDvfPUBYFlVdlueBFbLW0mhhAyGEqpt,1,0,0,0,0,0,1,0,1,0.14285714285714285,1,0.0,0,0,0,0,0,0,0,1,0,0,1,1
16509,154759,9g6cYAmFbDY0CjADcdMWUoQ4H4YvgLXQ,7GRhBDsirIGkRZBtSMEzNTyDr2JQm4xx,1,0,0,0,0,0,1,0,1,0.14285714285714285,1,0.0,0,0,0,0,0,0,0,1,0,0,1,1
16510,154762,9g6cYAmFbDY0CjADcdMWUoQ4H4YvgLXQ,A3fsA9Zfv1X2fVEQhTw51lKENdNrEqT3,1,0,0,0,0,0,1,0,1,0.14285714285714285,1,0.0,0,0,0,0,0,0,0,1,0,0,1,1
16511,154764,BPDxtvSmkKR4nTdKjes8gGxzoOprTkK2,SpATywNh6bZuzm8s1ceuBUnMUAeoAHHw,19,26,15,19,9,8,9,1,87,12.428571428571429,3,0.0,6,15,16,9,20,8,3,9,1,46,41,1
16512,154766,wwBHIx7ffu8zUvCJvQINAS5LfS3Nmyh1,SpATywNh6bZuzm8s1ceuBUnMUAeoAHHw,1,0,0,0,0,0,1,0,1,0.14285714285714285,1,0.0,0,0,0,0,0,0,0,1,0,0,1,1
16513,154775,Q3zkClKdiEJIkoKspwBuSNOwYXuxalAX,A3fsA9Zfv1X2fVEQhTw51lKENdNrEqT3,1,0,0,0,0,0,1,0,1,0.14285714285714285,1,0.0,0,0,0,0,0,0,0,1,0,0,1,1
16514,154789,bWTCgLlWI05nNVcVRoVSZYxP5KtyHgRM,5X6FeZozNMgE2VRi3MJYjkkFK8SETtu2,1,0,0,0,0,0,1,0,1,0.14285714285714285,1,0.0,0,0,0,0,0,0,0,1,0,0,1,1
16515,154792,bWTCgLlWI05nNVcVRoVSZYxP5KtyHgRM,G8EPVSXsOYB5YQWZGiz1aVq5Pgr2GrQu,1,0,0,0,0,0,1,0,1,0.14285714285714285,1,0.0,0,0,0,0,0,0,0,1,0,0,1,1
16516,154808,qk3k8D6g4BBZslMQhuZKH29auh1oUGgB,SpATywNh6bZuzm8s1ceuBUnMUAeoAHHw,18,29,15,25,2,2,4,0,77,11.0,2,0.0,11,15,23,2,18,2,2,4,0,51,26,0
16517,154820,Xf0Og50NXKhKGIY0WPfCy8ERJ7r6XgJl,7GRhBDsirIGkRZBtSMEzNTyDr2JQm4xx,1,0,0,0,0,0,1,0,1,0.14285714285714285,1,0.0,0,0,0,0,0,0,0,1,0,0,1,1
16518,154832,RZF5krqbIaFqIutwBTONAy0kqy0VOuUh,A3fsA9Zfv1X2fVEQhTw51lKENdNrEqT3,5,4,0,0,0,0,9,0,13,1.8571428571428572,1,0.0,0,0,0,0,4,0,0,9,0,0,13,1
16519,154840,RZF5krqbIaFqIutwBTONAy0kqy0VOuUh,bWdj2GDclj5ofokWjzoa5jAwMkxCykd6,2,0,0,0,0,0,4,0,4,0.5714285714285714,1,0.0,0,0,0,0,0,0,0,4,0,0,4,1
16520,154846,Ife7vY8hAB8t9rfmTwXK28czbepIbFsG,G8EPVSXsOYB5YQWZGiz1aVq5Pgr2GrQu,1,0,0,0,0,0,1,0,1,0.14285714285714285,1,0.0,0,0,0,0,0,0,0,1,0,0,1,1
16521,154862,I1340YsGXK2BIG96XRWppOvFniqpKDu7,7GRhBDsirIGkRZBtSMEzNTyDr2JQm4xx,1,0,0,0,0,0,1,0,1,0.14285714285714285,1,0.0,0,0,0,0,0,0,0,1,0,0,1,1
16522,154863,dbJ3S8TbbYbIZ5r4bCB0isavbQKpwDdZ,A3fsA9Zfv1X2fVEQhTw51lKENdNrEqT3,10,7,5,0,4,0,2,0,18,2.5714285714285716,1,0.0,1,5,0,4,6,0,0,2,0,10,8,0
16523,154865,I1340YsGXK2BIG96XRWppOvFniqpKDu7,SpATywNh6bZuzm8s1ceuBUnMUAeoAHHw,4,3,1,0,0,0,2,0,6,0.8571428571428571,1,0.0,0,1,0,0,3,0,0,2,0,1,5,1
16524,154870,jfVLsvKFkaWqAxR3s7Wt4wSauciS7FpV,SpATywNh6bZuzm8s1ceuBUnMUAeoAHHw,6,5,0,0,0,0,1,0,6,0.8571428571428571,1,0.0,0,0,0,0,5,0,0,1,0,0,6,1
16525,154895,qZCURwy8JtTyuwzOv8VNGZdlPKRFUQ4x,SpATywNh6bZuzm8s1ceuBUnMUAeoAHHw,6,5,1,0,0,0,5,0,11,1.5714285714285714,2,0.0,0,1,0,0,5,0,0,5,0,1,10,0
16526,154907,8pbex9YW7IEj2SIgZ25rRD3x0PLaEriE,A3fsA9Zfv1X2fVEQhTw51lKENdNrEqT3,1,0,0,0,0,0,1,0,1,0.14285714285714285,1,0.0,0,0,0,0,0,0,0,1,0,0,1,1
16527,154911,yGvIE15GH4VA1DDC2IJtfMXXasgYhTMz,7GRhBDsirIGkRZBtSMEzNTyDr2JQm4xx,1,0,0,0,0,0,1,0,1,0.14285714285714285,1,0.0,0,0,0,0,0,0,0,1,0,0,1,1
16528,154912,NqtJWYw7DQZw2JWGP131p1dqc9m7i7vh,RXDvfPUBYFlVdlueBFbLW0mhhAyGEqpt,45,34,15,107,14,1,2,0,173,24.714285714285715,1,0.0,18,15,98,14,16,1,9,2,0,145,28,0
16529,154913,j9DMqIZkavMsFdWoxVo3EuIrdKBeRzf9,RXDvfPUBYFlVdlueBFbLW0mhhAyGEqpt,104,91,55,105,37,11,15,0,314,44.857142857142854,3,0.0,23,55,105,37,68,11,0,15,0,220,94,1
16530,154940,MxhxHMlOpo3bTyeulVXY5tLPOxuKgX9g,RXDvfPUBYFlVdlueBFbLW0mhhAyGEqpt,12,11,5,0,2,2,6,3,29,4.142857142857143,3,0.0,0,5,0,2,11,2,0,6,3,7,22,1
16531,154941,fPjkzYppwTWkalkc9Php6lYeEO8LNcjO,G8EPVSXsOYB5YQWZGiz1aVq5Pgr2GrQu,5,2,1,0,1,0,2,0,6,0.8571428571428571,1,0.0,0,1,0,1,2,0,0,2,0,2,4,1
16532,154942,ZzGpC0eNIcIIxJZ248D7OmNflJvxxp85,5X6FeZozNMgE2VRi3MJYjkkFK8SETtu2,1,0,0,0,0,0,1,0,1,0.14285714285714285,1,0.0,0,0,0,0,0,0,0,1,0,0,1,1
16533,154977,ek29LkWtDxA0v7lJYLGDshBZKC6XqZUG,bWdj2GDclj5ofokWjzoa5jAwMkxCykd6,2,0,0,0,0,0,2,0,2,0.2857142857142857,1,0.0,0,0,0,0,0,0,0,2,0,0,2,1
16534,154980,m9i2Su10H7rTersut82vK6JunWbBEwmT,bWdj2GDclj5ofokWjzoa5jAwMkxCykd6,4,2,0,0,0,0,2,0,4,0.5714285714285714,1,0.0,0,0,0,0,2,0,0,2,0,0,4,1
16535,154984,ek29LkWtDxA0v7lJYLGDshBZKC6XqZUG,A3fsA9Zfv1X2fVEQhTw51lKENdNrEqT3,7,3,2,0,2,0,2,0,9,1.2857142857142858,1,0.0,0,2,0,2,3,0,0,2,0,4,5,1
16536,154994,goiRqBTuj08U0GnNk0C4bEGsdFhlNKfO,SpATywNh6bZuzm8s1ceuBUnMUAeoAHHw,1,0,0,0,0,0,1,0,1,0.14285714285714285,1,0.0,0,0,0,0,0,0,0,1,0,0,1,1
16537,155004,jAL7XyDmeuhiQajqPFo22fTlsGcBQwVk,SpATywNh6bZuzm8s1ceuBUnMUAeoAHHw,14,18,8,15,0,0,9,0,50,7.142857142857143,2,0.0,3,8,14,0,15,0,1,9,0,25,25,0
16538,155015,j1APsmZGLFH2gSdJ48obb2yQGO5jtDpT,A3fsA9Zfv1X2fVEQhTw51lKENdNrEqT3,26,15,12,0,11,0,6,0,44,6.285714285714286,1,0.0,0,12,0,11,15,0,0,6,0,23,21,1
16539,155019,5T1VvKaGWS2hZ5BZhBGk8NjgRaaz6DhR,5X6FeZozNMgE2VRi3MJYjkkFK8SETtu2,5,6,1,0,0,0,2,0,9,1.2857142857142858,1,0.0,0,1,0,0,6,0,0,2,0,1,8,1
16540,155027,PexOV0LWT1fDCzyfhjsaD6ViAyGfZwtP,SpATywNh6bZuzm8s1ceuBUnMUAeoAHHw,31,33,8,34,6,0,9,1,91,13.0,4,0.0,6,8,29,6,27,0,5,9,1,49,42,1
16541,155032,QhTOy4xyyUtTSkonbjsd0Qe7t71cRAgW,5X6FeZozNMgE2VRi3MJYjkkFK8SETtu2,5,2,1,0,1,0,2,0,6,0.8571428571428571,1,0.0,0,1,0,1,2,0,0,2,0,2,4,1
16542,155048,OqBkXI62rrUk2ckZzlCRqJd1hz7KQTiD,7GRhBDsirIGkRZBtSMEzNTyDr2JQm4xx,15,27,1,12,3,0,3,1,47,6.714285714285714,1,0.0,15,1,10,3,12,0,2,3,1,29,18,1
16543,155050,791uZs1oletLjsDrEfx07tDuNe91zVsB,7GRhBDsirIGkRZBtSMEzNTyDr2JQm4xx,7,3,2,0,2,0,2,0,9,1.2857142857142858,1,0.0,0,2,0,2,3,0,0,2,0,4,5,1
16544,155076,m7LPs49nHZUcvz2esAX8UbdKFZVSnWet,A3fsA9Zfv1X2fVEQhTw51lKENdNrEqT3,8,4,2,0,2,0,4,0,12,1.7142857142857142,1,0.0,0,2,0,2,4,0,0,4,0,4,8,1
16545,155086,0a6XgcasA9uTwm3tHxuEmdygchIIdwyp,SpATywNh6bZuzm8s1ceuBUnMUAeoAHHw,11,8,1,17,0,0,2,0,28,4.0,1,0.0,2,1,14,0,6,0,3,2,0,17,11,1
16546,155089,VdNVtOVHu3uq36SFu7mu40diveL7bnVd,5X6FeZozNMgE2VRi3MJYjkkFK8SETtu2,2,0,0,0,0,3,1,0,4,0.5714285714285714,1,0.0,0,0,0,0,0,3,0,1,0,0,4,1
16547,155095,LVgGKe8GEjU3xNkkgcLCws2DFML8rckJ,A3fsA9Zfv1X2fVEQhTw51lKENdNrEqT3,2,0,0,0,0,0,2,0,2,0.2857142857142857,1,0.0,0,0,0,0,0,0,0,2,0,0,2,1
16548,155101,JbB7hpnQ5hVzqELznLtzJLRyOZ2rdnyH,A3fsA9Zfv1X2fVEQhTw51lKENdNrEqT3,27,21,11,58,0,19,15,1,125,17.857142857142858,3,0.0,3,11,50,0,18,19,8,15,1,64,61,1
16549,155102,JbB7hpnQ5hVzqELznLtzJLRyOZ2rdnyH,7GRhBDsirIGkRZBtSMEzNTyDr2JQm4xx,4,2,1,0,1,0,1,0,5,0.7142857142857143,1,0.0,0,1,0,1,2,0,0,1,0,2,3,1
16550,155116,gFlxrmDkVSVGn1QoqvuvED5jcjjyxp3w,A3fsA9Zfv1X2fVEQhTw51lKENdNrEqT3,12,7,5,0,5,0,1,0,18,2.5714285714285716,1,0.0,1,5,0,5,6,0,0,1,0,11,7,1
16551,155129,t8qBiDTvOvYmrxcVIErRuEOf38tywm6t,7GRhBDsirIGkRZBtSMEzNTyDr2JQm4xx,26,46,22,30,13,36,4,1,152,21.714285714285715,1,0.0,19,22,25,13,27,36,5,4,1,79,73,1
16552,155137,v2qco953Z21cQ5MzJrZ1eVzwRDnupmBG,A3fsA9Zfv1X2fVEQhTw51lKENdNrEqT3,1,0,0,0,0,0,1,0,1,0.14285714285714285,1,0.0,0,0,0,0,0,0,0,1,0,0,1,1
16553,155141,PUySp8Qi7ahosRvBWR6xsbTAmeC3pRdT,SpATywNh6bZuzm8s1ceuBUnMUAeoAHHw,24,50,25,14,10,3,16,0,118,16.857142857142858,6,0.0,6,25,12,10,44,3,2,16,0,53,65,0
16554,155145,wjhz373pmxMxtWLbVSRdPzWp2Q3TigoZ,SpATywNh6bZuzm8s1ceuBUnMUAeoAHHw,1,0,0,0,0,0,1,0,1,0.14285714285714285,1,0.0,0,0,0,0,0,0,0,1,0,0,1,1
16555,155157,YBxdZNwXHdHfvV2eXmAcEoLMgpOYOPHS,7GRhBDsirIGkRZBtSMEzNTyDr2JQm4xx,9,8,5,8,5,0,2,0,28,4.0,1,0.0,3,5,7,5,5,0,1,2,0,20,8,1
16556,155171,nnZu4w9Qwc4nNKT0fLzc9WXoz4HdLggH,SpATywNh6bZuzm8s1ceuBUnMUAeoAHHw,3,0,0,0,0,0,3,0,3,0.42857142857142855,1,0.0,0,0,0,0,0,0,0,3,0,0,3,1
16557,155173,JHfmlel9KNxicHtEPCs7j50mTEJgnt8P,7GRhBDsirIGkRZBtSMEzNTyDr2JQm4xx,1,0,0,0,0,0,1,0,1,0.14285714285714285,1,0.0,0,0,0,0,0,0,0,1,0,0,1,1
16558,155176,2h9OXmdAT6bB7n7KOPBoiXeNjQhlOCR5,SpATywNh6bZuzm8s1ceuBUnMUAeoAHHw,1,0,0,0,0,0,1,0,1,0.14285714285714285,1,0.0,0,0,0,0,0,0,0,1,0,0,1,1
16559,155178,DH7Hc1PL02MQVFEY0L3pJVvxe76LbPlH,SpATywNh6bZuzm8s1ceuBUnMUAeoAHHw,2,0,0,0,0,0,2,0,2,0.2857142857142857,1,0.0,0,0,0,0,0,0,0,2,0,0,2,1
16560,155185,11GhYVig00IPn7lSasEKzVfjBwtsXP8u,5X6FeZozNMgE2VRi3MJYjkkFK8SETtu2,2,0,0,0,0,0,2,0,2,0.2857142857142857,1,0.0,0,0,0,0,0,0,0,2,0,0,2,1
16561,155189,YNuPTGQy9mt9Y3HmbbpFFMvKSZhUusVu,bWdj2GDclj5ofokWjzoa5jAwMkxCykd6,1,0,0,0,0,0,1,0,1,0.14285714285714285,1,0.0,0,0,0,0,0,0,0,1,0,0,1,1
16562,155198,lmPRzPwyLk4LZriJ4YYlBQcJ6H90U7J3,SpATywNh6bZuzm8s1ceuBUnMUAeoAHHw,1,0,0,0,0,0,1,0,1,0.14285714285714285,1,0.0,0,0,0,0,0,0,0,1,0,0,1,1
16563,155247,NfNQzrIJhmgRP7158cjFmvfhx6PtMoIG,7GRhBDsirIGkRZBtSMEzNTyDr2JQm4xx,7,0,0,0,0,2,6,1,9,1.2857142857142858,1,0.0,0,0,0,0,0,2,0,6,1,0,9,1
16564,155262,B1DHRbN7OgYmrICROsReSgvpNCm4AE9D,A3fsA9Zfv1X2fVEQhTw51lKENdNrEqT3,1,0,0,0,0,0,2,0,2,0.2857142857142857,2,0.0,0,0,0,0,0,0,0,2,0,0,2,1
16565,155268,5WJ9TRmJQHZjCB6N96s5yxRqedfFf2EC,7GRhBDsirIGkRZBtSMEzNTyDr2JQm4xx,5,2,1,0,1,0,2,0,6,0.8571428571428571,1,0.0,0,1,0,1,2,0,0,2,0,2,4,1
16566,155271,BQtG7mwMFIK7eTxl5OIdt4PhyPzprQ2h,SpATywNh6bZuzm8s1ceuBUnMUAeoAHHw,2,0,0,0,0,0,2,0,2,0.2857142857142857,1,0.0,0,0,0,0,0,0,0,2,0,0,2,1
16567,155288,0aNsJYUr3bQMcRtgUvbI1dETfhSFeYEi,5X6FeZozNMgE2VRi3MJYjkkFK8SETtu2,5,4,2,0,1,0,1,0,8,1.1428571428571428,1,0.0,0,2,0,1,4,0,0,1,0,3,5,1
16568,155301,PlXazMadzuvOEbxiBFMxdXqBjCYsxLnr,G8EPVSXsOYB5YQWZGiz1aVq5Pgr2GrQu,9,13,1,4,2,0,4,2,26,3.7142857142857144,1,0.0,8,1,4,2,5,0,0,4,2,15,11,1
16569,155304,Mc1x8qc2ag2ssiz0qfYSRk8wfa0Gy5Kt,RXDvfPUBYFlVdlueBFbLW0mhhAyGEqpt,2,0,0,0,0,0,2,0,2,0.2857142857142857,1,0.0,0,0,0,0,0,0,0,2,0,0,2,1
16570,155313,qCt5ANSKPqeu8yA2D88Oh4sjJN8qIxHb,SpATywNh6bZuzm8s1ceuBUnMUAeoAHHw,4,3,1,0,0,0,2,0,6,0.8571428571428571,1,0.0,0,1,0,0,3,0,0,2,0,1,5,1
16571,155315,2DvkJl9UVozMaO0xGaO2ndEJOUw63HiE,7GRhBDsirIGkRZBtSMEzNTyDr2JQm4xx,4,2,1,0,1,0,1,0,5,0.7142857142857143,1,0.0,0,1,0,1,2,0,0,1,0,2,3,1
16572,155317,2DvkJl9UVozMaO0xGaO2ndEJOUw63HiE,A3fsA9Zfv1X2fVEQhTw51lKENdNrEqT3,6,4,3,0,1,0,1,0,9,1.2857142857142858,1,0.0,0,3,0,1,4,0,0,1,0,4,5,1
16573,155324,Bw1W3aypNX1U28lPbdggaNPof0tcfoYy,7GRhBDsirIGkRZBtSMEzNTyDr2JQm4xx,12,27,7,10,6,0,3,0,53,7.571428571428571,2,0.0,6,7,8,6,21,0,2,3,0,27,26,1
16574,155332,4EUcos24EvmQADqilrZaeka59sr4Z1yr,G8EPVSXsOYB5YQWZGiz1aVq5Pgr2GrQu,1,0,0,0,0,0,1,0,1,0.14285714285714285,1,0.0,0,0,0,0,0,0,0,1,0,0,1,1
16575,155333,4EUcos24EvmQADqilrZaeka59sr4Z1yr,A3fsA9Zfv1X2fVEQhTw51lKENdNrEqT3,1,0,0,0,0,0,1,0,1,0.14285714285714285,1,0.0,0,0,0,0,0,0,0,1,0,0,1,1
16576,155339,HCAOiU8xAVMVIqXLxXu2zf6ngFo1SrS9,SpATywNh6bZuzm8s1ceuBUnMUAeoAHHw,13,10,1,24,0,0,2,0,37,5.285714285714286,1,0.0,4,1,21,0,6,0,3,2,0,26,11,1
16577,155340,kESUWYZhNdCYchDMD2BhJwQOrXwcqWDK,SpATywNh6bZuzm8s1ceuBUnMUAeoAHHw,5,4,2,0,1,0,2,0,9,1.2857142857142858,1,0.0,0,2,0,1,4,0,0,2,0,3,6,1
16578,155348,MTVSM1YvrsLrM15cX6nefZv7wPGqQR1y,bWdj2GDclj5ofokWjzoa5jAwMkxCykd6,1,0,0,0,0,0,1,0,1,0.14285714285714285,1,0.0,0,0,0,0,0,0,0,1,0,0,1,1
16579,155351,yQFJbwjipZPuCNg0BGBhkstFCLA1Phw4,RXDvfPUBYFlVdlueBFbLW0mhhAyGEqpt,1,0,0,0,0,0,1,0,1,0.14285714285714285,1,0.0,0,0,0,0,0,0,0,1,0,0,1,1
16580,155359,EZg27UOE3C8Imuu3swXTGejJA3xd7Feg,SpATywNh6bZuzm8s1ceuBUnMUAeoAHHw,7,3,2,0,2,0,4,0,11,1.5714285714285714,1,0.0,0,2,0,2,3,0,0,4,0,4,7,1
16581,155368,LSvU72CFq1TrHd9SCZOiKQ0qcV2oa2Ok,5X6FeZozNMgE2VRi3MJYjkkFK8SETtu2,14,32,9,16,5,0,6,0,68,9.714285714285714,3,0.0,13,9,14,5,19,0,2,6,0,41,27,1
16582,155372,Iet2Dgawpa0Ak4mecoEMAcFitulCRVfT,A3fsA9Zfv1X2fVEQhTw51lKENdNrEqT3,1,0,0,0,0,0,1,0,1,0.14285714285714285,1,0.0,0,0,0,0,0,0,0,1,0,0,1,1
16583,155374,0B7Lg7kBiHggKw9Wk7X0Ew4GVuXGGcvN,bWdj2GDclj5ofokWjzoa5jAwMkxCykd6,4,3,1,0,1,0,2,0,7,1.0,1,0.0,0,1,0,1,3,0,0,2,0,2,5,1
16584,155378,QZoi4xpkEVVH2rbYL53oYFfYungIuUup,A3fsA9Zfv1X2fVEQhTw51lKENdNrEqT3,28,19,13,0,10,3,9,1,55,7.857142857142857,3,0.0,2,13,0,10,17,3,0,9,1,25,30,1
16585,155388,p4jDcAmq3BCmPDrihi5iwS37tcic5dv0,SpATywNh6bZuzm8s1ceuBUnMUAeoAHHw,8,6,4,0,2,0,5,0,17,2.4285714285714284,1,0.0,0,4,0,2,6,0,0,5,0,6,11,1
16586,155394,CgAG6B49eGwrDT53ilR8A7Csv8j3BICz,SpATywNh6bZuzm8s1ceuBUnMUAeoAHHw,3,3,0,0,0,0,3,0,6,0.8571428571428571,1,0.0,0,0,0,0,3,0,0,3,0,0,6,1
16587,155398,V6OdAS3CbYkwbVZibmDB3Td15gp0rTCi,7GRhBDsirIGkRZBtSMEzNTyDr2JQm4xx,4,2,1,0,1,0,1,0,5,0.7142857142857143,1,0.0,0,1,0,1,2,0,0,1,0,2,3,1
16588,155404,qwhxcjW9iIMBAQoGSWDtst34AFkcFQoV,RXDvfPUBYFlVdlueBFbLW0mhhAyGEqpt,16,24,13,10,4,22,12,0,85,12.142857142857142,3,0.0,1,13,9,4,23,22,1,12,0,27,58,0
16589,155406,i4POwlixDERLlMr6WsVDkGXvvyY9RG7A,SpATywNh6bZuzm8s1ceuBUnMUAeoAHHw,33,60,3,45,2,8,5,0,123,17.571428571428573,4,0.0,21,3,43,2,39,8,2,5,0,69,54,0
16590,155427,CORJXNhWUR52sdjQNNf8qLspXXnCgswJ,A3fsA9Zfv1X2fVEQhTw51lKENdNrEqT3,4,3,3,0,0,0,4,0,10,1.4285714285714286,1,0.0,0,3,0,0,3,0,0,4,0,3,7,1
16591,155458,anKy5XeCNcJg717tYlt4WP7NvJptZoH3,RXDvfPUBYFlVdlueBFbLW0mhhAyGEqpt,37,24,22,0,17,0,26,1,90,12.857142857142858,5,0.0,0,22,0,17,24,0,0,26,1,39,51,1
16592,155485,QjfVyTofFZLLFWX1ehKLt5ilQSOSAPiY,SpATywNh6bZuzm8s1ceuBUnMUAeoAHHw,28,30,16,38,7,9,4,0,104,14.857142857142858,1,0.0,13,16,33,7,17,9,5,4,0,69,35,1
16593,155497,QXCbenecbpNtho5u82xZRFTWClxbJ6H8,bWdj2GDclj5ofokWjzoa5jAwMkxCykd6,7,2,1,0,1,0,5,1,10,1.4285714285714286,1,0.0,0,1,0,1,2,0,0,5,1,2,8,1
16594,155502,4fggBiTulBMhqyvK9Klo3I0joX8sXLqR,G8EPVSXsOYB5YQWZGiz1aVq5Pgr2GrQu,1,0,0,0,0,0,1,0,1,0.14285714285714285,1,0.0,0,0,0,0,0,0,0,1,0,0,1,1
16595,155526,90qbve2c7woP8H6gtxTaHw527Ldlfcdt,SpATywNh6bZuzm8s1ceuBUnMUAeoAHHw,1,0,0,0,0,0,1,0,1,0.14285714285714285,1,0.0,0,0,0,0,0,0,0,1,0,0,1,1
16596,155529,90qbve2c7woP8H6gtxTaHw527Ldlfcdt,G8EPVSXsOYB5YQWZGiz1aVq5Pgr2GrQu,1,0,0,0,0,0,1,0,1,0.14285714285714285,1,0.0,0,0,0,0,0,0,0,1,0,0,1,1
16597,155530,j46DNjv2CGqL26N5PDFntx4e9zPVHO6p,G8EPVSXsOYB5YQWZGiz1aVq5Pgr2GrQu,2,0,0,0,0,0,2,0,2,0.2857142857142857,1,0.0,0,0,0,0,0,0,0,2,0,0,2,1
16598,155552,M3hg5TCyBFjaInA6DUnH93lf18qdYvu6,SpATywNh6bZuzm8s1ceuBUnMUAeoAHHw,10,3,2,0,2,8,8,1,24,3.4285714285714284,1,0.0,1,2,0,2,2,8,0,8,1,5,19,1
16599,155562,f7tZxTkA0B7yOxMWeydGO2hW0y86mAhD,RXDvfPUBYFlVdlueBFbLW0mhhAyGEqpt,14,9,6,0,5,0,5,0,25,3.5714285714285716,2,0.0,1,6,0,5,8,0,0,5,0,12,13,1
16600,155577,zvUmozhQnyXBySuAzEdyMCBcHeR55dKC,A3fsA9Zfv1X2fVEQhTw51lKENdNrEqT3,18,6,5,22,3,2,9,0,47,6.714285714285714,1,0.0,0,5,17,3,6,2,5,9,0,25,22,1
16601,155581,2ZRBFnStzt5cjrck9eS6oYGoTRuicZMh,G8EPVSXsOYB5YQWZGiz1aVq5Pgr2GrQu,10,12,3,0,3,0,2,0,20,2.857142857142857,4,0.0,0,3,0,3,12,0,0,2,0,6,14,1
16602,155587,SKemaavr5OG5spO92jXls0zhTMuWKDja,bWdj2GDclj5ofokWjzoa5jAwMkxCykd6,1,0,0,0,0,0,1,0,1,0.14285714285714285,1,0.0,0,0,0,0,0,0,0,1,0,0,1,1
16603,155596,0qCFkatyVPL7csU80HaaNwiBF9ooLuJC,A3fsA9Zfv1X2fVEQhTw51lKENdNrEqT3,1,0,0,0,0,0,1,0,1,0.14285714285714285,1,0.0,0,0,0,0,0,0,0,1,0,0,1,1
16604,155605,SMXR6YI3QoKLXckr7byjkvJilyN0KrgC,bWdj2GDclj5ofokWjzoa5jAwMkxCykd6,5,7,2,0,3,0,5,0,17,2.4285714285714284,1,0.0,3,2,0,3,4,0,0,5,0,8,9,1
16605,155606,2rS9ufrltSIJVkQHjlKCjTvqcoR7anzz,bWdj2GDclj5ofokWjzoa5jAwMkxCykd6,4,3,1,0,1,0,1,0,6,0.8571428571428571,1,0.0,1,1,0,1,2,0,0,1,0,3,3,1
16606,155616,k0sbAnWIfD9ltAd5PyrJMhpQMWff3kVq,SpATywNh6bZuzm8s1ceuBUnMUAeoAHHw,10,18,7,0,7,0,1,0,33,4.714285714285714,3,0.0,0,7,0,7,18,0,0,1,0,14,19,1
16607,155617,VgnlAlKyJJS2tvM35xxyHRWLD1lxYQBK,SpATywNh6bZuzm8s1ceuBUnMUAeoAHHw,10,17,7,0,0,5,12,3,44,6.285714285714286,2,0.0,3,7,0,0,14,5,0,12,3,10,34,1
16608,155618,s6FY1tnJFeJCup1Eko54ROGWiTGeTtYm,SpATywNh6bZuzm8s1ceuBUnMUAeoAHHw,6,3,2,0,1,3,3,2,14,2.0,2,0.0,0,2,0,1,3,3,0,3,2,3,11,0
16609,155629,R5PVQLHQfRcyGqt0KVpTkwcmfBgB3rs1,A3fsA9Zfv1X2fVEQhTw51lKENdNrEqT3,4,0,0,0,0,0,11,0,11,1.5714285714285714,2,0.0,0,0,0,0,0,0,0,11,0,0,11,0
16610,155640,dd7Jtt1fMMutX1RG7iWTpWNKUpGu8Lqf,bWdj2GDclj5ofokWjzoa5jAwMkxCykd6,8,13,7,18,0,11,13,0,62,8.857142857142858,3,0.0,2,7,17,0,11,11,1,13,0,26,36,1
16611,155648,RDFpcJ9K2LX0Y5xHquXqcoe5PIHy9Vd3,A3fsA9Zfv1X2fVEQhTw51lKENdNrEqT3,46,56,22,68,18,12,11,3,190,27.142857142857142,1,0.0,3,22,65,18,53,12,3,11,3,108,82,1
16612,155665,8958pt2z4OHwTl32JK0k9CAPziEN4Bzu,A3fsA9Zfv1X2fVEQhTw51lKENdNrEqT3,17,16,10,0,5,1,6,0,38,5.428571428571429,3,0.0,0,10,0,5,16,1,0,6,0,15,23,1
16613,155671,3s8l6Oo3c1fXiiE9X1tB8PxtDiwQqFs1,SpATywNh6bZuzm8s1ceuBUnMUAeoAHHw,12,10,0,36,0,0,1,0,47,6.714285714285714,1,0.0,5,0,31,0,5,0,5,1,0,36,11,1
16614,155672,wjS8ie6ACTxewSCQo7zpBy0tu4z4RYPD,5X6FeZozNMgE2VRi3MJYjkkFK8SETtu2,1,0,0,0,0,0,1,0,1,0.14285714285714285,1,0.0,0,0,0,0,0,0,0,1,0,0,1,1
16615,155683,8958pt2z4OHwTl32JK0k9CAPziEN4Bzu,bWdj2GDclj5ofokWjzoa5jAwMkxCykd6,19,32,14,20,4,22,27,3,122,17.428571428571427,3,0.0,3,14,14,4,29,22,6,27,3,35,87,1
16616,155689,f7tZxTkA0B7yOxMWeydGO2hW0y86mAhD,SpATywNh6bZuzm8s1ceuBUnMUAeoAHHw,1,0,0,0,0,0,1,0,1,0.14285714285714285,1,0.0,0,0,0,0,0,0,0,1,0,0,1,1
16617,155693,f7tZxTkA0B7yOxMWeydGO2hW0y86mAhD,G8EPVSXsOYB5YQWZGiz1aVq5Pgr2GrQu,1,0,0,0,0,0,1,0,1,0.14285714285714285,1,0.0,0,0,0,0,0,0,0,1,0,0,1,1
16618,155695,PFQeRq3Dsbcn80aUj0YZWAW88oFDtPF9,SpATywNh6bZuzm8s1ceuBUnMUAeoAHHw,2,0,0,0,0,0,2,0,2,0.2857142857142857,1,0.0,0,0,0,0,0,0,0,2,0,0,2,1
16619,155704,CFhLEVkKrtcBJJ6gRh8HSuSfw1jMfUb7,bWdj2GDclj5ofokWjzoa5jAwMkxCykd6,2,0,0,0,0,0,2,0,2,0.2857142857142857,1,0.0,0,0,0,0,0,0,0,2,0,0,2,1
16620,155706,vxDKJhpoE0ZU5RIXhXpWK5bdxd3obhJ3,SpATywNh6bZuzm8s1ceuBUnMUAeoAHHw,1,0,0,0,0,0,1,0,1,0.14285714285714285,1,0.0,0,0,0,0,0,0,0,1,0,0,1,1
16621,155758,t5V0ixfffVZaZSFsWXyfGfVsjL4VioUW,A3fsA9Zfv1X2fVEQhTw51lKENdNrEqT3,2,0,0,0,0,0,2,0,2,0.2857142857142857,1,0.0,0,0,0,0,0,0,0,2,0,0,2,1
16622,155760,JBAytsWAbTeV6GWhSZsHWNpJgF2JgbBV,5X6FeZozNMgE2VRi3MJYjkkFK8SETtu2,1,0,0,0,0,0,1,0,1,0.14285714285714285,1,0.0,0,0,0,0,0,0,0,1,0,0,1,1
16623,155802,rdXoyX5PzGEa2IlOBAhmWFuNeQw6DxzT,SpATywNh6bZuzm8s1ceuBUnMUAeoAHHw,1,0,0,0,0,0,3,0,3,0.42857142857142855,1,0.0,0,0,0,0,0,0,0,3,0,0,3,1
16624,155808,rdXoyX5PzGEa2IlOBAhmWFuNeQw6DxzT,A3fsA9Zfv1X2fVEQhTw51lKENdNrEqT3,1,0,0,0,0,0,1,0,1,0.14285714285714285,1,0.0,0,0,0,0,0,0,0,1,0,0,1,1
16625,155810,IzKetdEf2SXOpqRxnB5y7Dzf3jbTkLdh,SpATywNh6bZuzm8s1ceuBUnMUAeoAHHw,2,0,0,0,0,1,1,0,2,0.2857142857142857,1,0.0,0,0,0,0,0,1,0,1,0,0,2,1
16626,155814,JlBcK2LKfnCBQn41BaZyu4VHnRO1Fg7Y,SpATywNh6bZuzm8s1ceuBUnMUAeoAHHw,8,9,2,14,0,0,4,0,29,4.142857142857143,1,0.0,6,2,13,0,3,0,1,4,0,21,8,0
16627,155840,ONg1SelorbsBSSFMlaPS8zkHzOEuFXME,RXDvfPUBYFlVdlueBFbLW0mhhAyGEqpt,10,13,1,0,1,0,6,0,21,3.0,1,0.0,0,1,0,1,13,0,0,6,0,2,19,1
16628,155852,2hFUtWkuc2dxIm3EniXMbBFapm5m6LBh,RXDvfPUBYFlVdlueBFbLW0mhhAyGEqpt,13,8,7,0,3,0,2,0,20,2.857142857142857,1,0.0,0,7,0,3,8,0,0,2,0,10,10,1
16629,155869,A5TywkowEbOHLvVVnqjs9APzsGZaYsjO,SpATywNh6bZuzm8s1ceuBUnMUAeoAHHw,7,3,2,0,2,0,2,0,9,1.2857142857142858,1,0.0,0,2,0,2,3,0,0,2,0,4,5,1
16630,155880,N9KQH02KbukvyuWvom0gbDomFEZReA7X,SpATywNh6bZuzm8s1ceuBUnMUAeoAHHw,13,10,2,0,2,0,6,1,21,3.0,1,0.0,0,2,0,2,10,0,0,6,1,4,17,1
16631,155893,4G4cusC28dHeOh2Typ91i1q3Okbvvqth,SpATywNh6bZuzm8s1ceuBUnMUAeoAHHw,18,27,14,24,7,0,5,0,77,11.0,2,0.0,6,14,20,7,21,0,4,5,0,47,30,0
16632,155904,mbBmZOvWFQnr2jr80Xest0JLKlAyyOuX,A3fsA9Zfv1X2fVEQhTw51lKENdNrEqT3,27,23,19,0,14,1,13,2,72,10.285714285714286,2,0.0,0,19,0,14,23,1,0,13,2,33,39,1
16633,155908,kui6N1aCNXaCsOCuisWh9NWzU01ICH8U,A3fsA9Zfv1X2fVEQhTw51lKENdNrEqT3,1,0,0,0,0,0,1,0,1,0.14285714285714285,1,0.0,0,0,0,0,0,0,0,1,0,0,1,1
16634,155948,4fYqS5i8zH5iFL9FCzQ9Jw4wAZdnrAvU,A3fsA9Zfv1X2fVEQhTw51lKENdNrEqT3,7,4,3,0,3,0,2,0,12,1.7142857142857142,1,0.0,0,3,0,3,4,0,0,2,0,6,6,1
16635,155949,27kP6FdDHuUVxPZHHeymFgogwQfiPjhl,RXDvfPUBYFlVdlueBFbLW0mhhAyGEqpt,10,9,6,0,3,9,4,0,31,4.428571428571429,2,0.0,0,6,0,3,9,9,0,4,0,9,22,1
16636,155965,i6hU5SR8XgkqdPxlmxtV7dYt9PZfaBTn,5X6FeZozNMgE2VRi3MJYjkkFK8SETtu2,8,7,3,0,2,0,2,0,14,2.0,1,0.0,0,3,0,2,7,0,0,2,0,5,9,1
16637,155984,CCCbrBYe8XRHX4ZhfNEK7mAQPHEjIWLc,A3fsA9Zfv1X2fVEQhTw51lKENdNrEqT3,10,6,3,0,2,1,7,0,19,2.7142857142857144,1,0.0,0,3,0,2,6,1,0,7,0,5,14,1
16638,155994,xSvCHzbSKemMKYEdGEAC5YZv1OdVf9nN,A3fsA9Zfv1X2fVEQhTw51lKENdNrEqT3,2,0,0,0,0,0,3,0,3,0.42857142857142855,2,0.0,0,0,0,0,0,0,0,3,0,0,3,1
16639,156005,AEtcQOknCsZXTvFkJ2Dw6PQ26CmvNLPh,SpATywNh6bZuzm8s1ceuBUnMUAeoAHHw,1,0,0,0,0,0,1,0,1,0.14285714285714285,1,0.0,0,0,0,0,0,0,0,1,0,0,1,1
16640,156021,PTBT7vCebvS4BFc8gXeo7jxunCeWBjOU,SpATywNh6bZuzm8s1ceuBUnMUAeoAHHw,2,0,0,0,0,0,2,0,2,0.2857142857142857,1,0.0,0,0,0,0,0,0,0,2,0,0,2,1
16641,156050,LIH6u87VTR1542727Uc42mhP2iK5GaFP,RXDvfPUBYFlVdlueBFbLW0mhhAyGEqpt,1,0,0,0,0,0,2,0,2,0.2857142857142857,2,0.0,0,0,0,0,0,0,0,2,0,0,2,1
16642,156071,gSloYsDed4N39YdVhV4tNTApSxYbZ2HF,A3fsA9Zfv1X2fVEQhTw51lKENdNrEqT3,1,0,0,0,0,0,1,0,1,0.14285714285714285,1,0.0,0,0,0,0,0,0,0,1,0,0,1,1
16643,156076,kJbPd4KyCeUkny294dkEDUG2lkV9m74w,RXDvfPUBYFlVdlueBFbLW0mhhAyGEqpt,6,3,1,0,0,0,5,0,9,1.2857142857142858,1,0.0,0,1,0,0,3,0,0,5,0,1,8,1
16644,156079,NLfKoJ9aC8i7mKu1ZdgdkE6zG1FgejH0,SpATywNh6bZuzm8s1ceuBUnMUAeoAHHw,4,3,1,0,0,0,2,0,6,0.8571428571428571,1,0.0,0,1,0,0,3,0,0,2,0,1,5,1
16645,156083,65WrAm7LwtsX3nVDTLh1bnXt0L79cL04,bWdj2GDclj5ofokWjzoa5jAwMkxCykd6,9,11,6,0,1,2,8,1,29,4.142857142857143,2,0.0,0,6,0,1,11,2,0,8,1,7,22,0
16646,156096,VPJtyjlRgoD1Uh96mtOqMndW9SwTakqy,bWdj2GDclj5ofokWjzoa5jAwMkxCykd6,11,11,2,4,0,2,6,1,26,3.7142857142857144,2,0.0,3,2,4,0,8,2,0,6,1,9,17,0
16647,156099,GxWg4h8gAiKctUf8VxaJMnstU2gEPNkZ,SpATywNh6bZuzm8s1ceuBUnMUAeoAHHw,13,15,6,36,0,0,2,0,59,8.428571428571429,2,0.0,6,6,31,0,9,0,5,2,0,43,16,1
16648,156107,UTQI3stNnZIKednJcKCTrHPD5NsTO42m,5X6FeZozNMgE2VRi3MJYjkkFK8SETtu2,10,4,3,0,3,0,4,0,14,2.0,1,0.0,0,3,0,3,4,0,0,4,0,6,8,1
16649,156119,RK4dzyspr24Rnz8TQ13QOCSoSUcsVTY4,SpATywNh6bZuzm8s1ceuBUnMUAeoAHHw,5,4,2,0,0,0,4,0,10,1.4285714285714286,2,0.0,0,2,0,0,4,0,0,4,0,2,8,1
16650,156131,AxvvX1cOvgvh5SLc8LDUicNhxVuDl8Ea,5X6FeZozNMgE2VRi3MJYjkkFK8SETtu2,1,0,0,0,0,0,2,0,2,0.2857142857142857,2,0.0,0,0,0,0,0,0,0,2,0,0,2,1
16651,156145,15UKel3wmzTW7LtBYJPrTEQPhHIKX4AO,A3fsA9Zfv1X2fVEQhTw51lKENdNrEqT3,2,0,0,0,0,0,2,0,2,0.2857142857142857,1,0.0,0,0,0,0,0,0,0,2,0,0,2,1
16652,156168,COpqi7PB37yJZ0BYYjHIpqMxiJ4vAe0U,bWdj2GDclj5ofokWjzoa5jAwMkxCykd6,1,0,0,0,0,0,1,0,1,0.14285714285714285,1,0.0,0,0,0,0,0,0,0,1,0,0,1,1
16653,156179,sGlMvtHnoZ3VKCRj86vjviJ0RxBg0FOx,SpATywNh6bZuzm8s1ceuBUnMUAeoAHHw,34,48,0,53,0,11,10,1,123,17.571428571428573,2,0.0,12,0,46,0,36,11,7,10,1,58,65,0
16654,156188,8o3Hi98AoLvhH8lRB2OWB562ZTdBh0M9,A3fsA9Zfv1X2fVEQhTw51lKENdNrEqT3,1,0,0,0,0,0,1,0,1,0.14285714285714285,1,0.0,0,0,0,0,0,0,0,1,0,0,1,1
16655,156211,KDWP2k3afTGhSxEaH7oA3UMXbJchV5C0,SpATywNh6bZuzm8s1ceuBUnMUAeoAHHw,8,7,3,0,2,0,3,0,15,2.142857142857143,2,0.0,0,3,0,2,7,0,0,3,0,5,10,0
16656,156223,EgnWqiW3LiA7qLbsztCmkjoYm253Rxt1,SpATywNh6bZuzm8s1ceuBUnMUAeoAHHw,1,0,0,0,0,0,1,0,1,0.14285714285714285,1,0.0,0,0,0,0,0,0,0,1,0,0,1,1
16657,156248,2rcvhx1rR5YxLdJduMzgm4BAqYgFhtji,G8EPVSXsOYB5YQWZGiz1aVq5Pgr2GrQu,6,3,1,0,1,0,4,0,9,1.2857142857142858,2,0.0,0,1,0,1,3,0,0,4,0,2,7,1
16658,156255,3MlpYZJz2aixs29anq45r6qVwlCBHq0f,G8EPVSXsOYB5YQWZGiz1aVq5Pgr2GrQu,8,3,1,0,1,1,4,0,10,1.4285714285714286,1,0.0,0,1,0,1,3,1,0,4,0,2,8,1
16659,156260,TVPORDuXFZycPf0Vi3wZKRTY1n2f7P3G,A3fsA9Zfv1X2fVEQhTw51lKENdNrEqT3,17,18,7,14,2,14,26,3,84,12.0,3,0.0,1,7,13,2,17,14,1,26,3,23,61,1
16660,156309,u9zCfF0AEyeJ0Gy01Mk2XfY0UT4XckvE,5X6FeZozNMgE2VRi3MJYjkkFK8SETtu2,1,0,0,0,0,0,1,0,1,0.14285714285714285,1,0.0,0,0,0,0,0,0,0,1,0,0,1,1
16661,156335,GMYiFsIWS5fNg7F5TvdvcvWY8TKSFKZz,SpATywNh6bZuzm8s1ceuBUnMUAeoAHHw,2,0,0,0,0,0,3,0,3,0.42857142857142855,1,0.0,0,0,0,0,0,0,0,3,0,0,3,1
16662,156339,4j0oreGLK5cXhR86icYUGacmhPp1TTs2,5X6FeZozNMgE2VRi3MJYjkkFK8SETtu2,1,0,0,0,0,0,1,0,1,0.14285714285714285,1,0.0,0,0,0,0,0,0,0,1,0,0,1,1
16663,156341,4j0oreGLK5cXhR86icYUGacmhPp1TTs2,G8EPVSXsOYB5YQWZGiz1aVq5Pgr2GrQu,7,3,2,0,2,0,3,0,10,1.4285714285714286,1,0.0,0,2,0,2,3,0,0,3,0,4,6,1
16664,156384,eQeAZJfAlQDBFNhBayGkUGtYxXtMJqJ1,A3fsA9Zfv1X2fVEQhTw51lKENdNrEqT3,20,39,23,4,9,1,13,0,89,12.714285714285714,5,0.0,0,23,3,9,39,1,1,13,0,35,54,1
16665,156391,HptaxHcLRNNIglVlBAbROpX7eNhSXE5r,G8EPVSXsOYB5YQWZGiz1aVq5Pgr2GrQu,3,0,0,0,0,0,3,0,3,0.42857142857142855,1,0.0,0,0,0,0,0,0,0,3,0,0,3,1
16666,156411,wVyNNZlShsUBKENfExM0aYsh2zqsJcHZ,SpATywNh6bZuzm8s1ceuBUnMUAeoAHHw,1,0,0,0,0,0,1,0,1,0.14285714285714285,1,0.0,0,0,0,0,0,0,0,1,0,0,1,1
16667,156418,BJqHNXVOuknKXVN8kWe148UD34ryhX5w,A3fsA9Zfv1X2fVEQhTw51lKENdNrEqT3,9,5,3,0,3,0,1,0,12,1.7142857142857142,1,0.0,0,3,0,3,5,0,0,1,0,6,6,1
16668,156442,yLIplHU7bk7trasZvaOCHx4t4qY5x8AA,A3fsA9Zfv1X2fVEQhTw51lKENdNrEqT3,4,0,0,0,0,0,6,0,6,0.8571428571428571,1,0.0,0,0,0,0,0,0,0,6,0,0,6,1
16669,156446,grhneBVDCBhvBD53OXACTDGfdH3pEWQ2,G8EPVSXsOYB5YQWZGiz1aVq5Pgr2GrQu,3,2,0,0,0,0,1,0,3,0.42857142857142855,1,0.0,0,0,0,0,2,0,0,1,0,0,3,1
16670,156452,kiukAy7oxipXUU8Ys4wcsL36Pp7URsoj,RXDvfPUBYFlVdlueBFbLW0mhhAyGEqpt,21,21,2,0,2,0,5,0,30,4.285714285714286,3,0.0,0,2,0,2,21,0,0,5,0,4,26,0
16671,156454,Uylyq7LmmNSvSWdWZxt9uRF9NmGdfp0A,A3fsA9Zfv1X2fVEQhTw51lKENdNrEqT3,12,13,10,0,7,0,5,0,35,5.0,2,0.0,0,10,0,7,13,0,0,5,0,17,18,1
16672,156455,e2xISjGUnUd5kxkj4EP9L59IdMd1R2EQ,SpATywNh6bZuzm8s1ceuBUnMUAeoAHHw,5,2,1,0,1,0,3,0,7,1.0,1,0.0,0,1,0,1,2,0,0,3,0,2,5,1
16673,156458,Xv79C7MvAlcrBgCLn9VASALUsdTDRY9k,A3fsA9Zfv1X2fVEQhTw51lKENdNrEqT3,1,0,0,0,0,0,1,0,1,0.14285714285714285,1,0.0,0,0,0,0,0,0,0,1,0,0,1,1
16674,156460,Xv79C7MvAlcrBgCLn9VASALUsdTDRY9k,bWdj2GDclj5ofokWjzoa5jAwMkxCykd6,4,3,1,0,0,0,2,0,6,0.8571428571428571,1,0.0,1,1,0,0,2,0,0,2,0,2,4,1
16675,156467,TqZSbKLYcFD5gfQ0wHk9V7SVlkqO9WOv,5X6FeZozNMgE2VRi3MJYjkkFK8SETtu2,6,0,0,0,0,0,10,1,11,1.5714285714285714,1,0.0,0,0,0,0,0,0,0,10,1,0,11,1
16676,156481,1MYBio9DblM2ma2YQCVmpn2rr8cupAiN,A3fsA9Zfv1X2fVEQhTw51lKENdNrEqT3,1,0,0,0,0,0,1,0,1,0.14285714285714285,1,0.0,0,0,0,0,0,0,0,1,0,0,1,1
16677,156483,1MYBio9DblM2ma2YQCVmpn2rr8cupAiN,G8EPVSXsOYB5YQWZGiz1aVq5Pgr2GrQu,1,0,0,0,0,0,1,0,1,0.14285714285714285,1,0.0,0,0,0,0,0,0,0,1,0,0,1,1
16678,156484,QCbtKC2wY9sgozuVQgVgy7Djz4UhLkqZ,SpATywNh6bZuzm8s1ceuBUnMUAeoAHHw,5,2,1,0,1,0,2,0,6,0.8571428571428571,1,0.0,0,1,0,1,2,0,0,2,0,2,4,1
16679,156488,1MYBio9DblM2ma2YQCVmpn2rr8cupAiN,5X6FeZozNMgE2VRi3MJYjkkFK8SETtu2,1,0,0,0,0,0,2,0,2,0.2857142857142857,1,0.0,0,0,0,0,0,0,0,2,0,0,2,1
16680,156522,pOXPjpm9uh7g9vxK8UCO5j9l2hW4sztB,G8EPVSXsOYB5YQWZGiz1aVq5Pgr2GrQu,5,1,1,0,1,0,4,0,7,1.0,1,0.0,0,1,0,1,1,0,0,4,0,2,5,1
16681,156559,Un3EzEE4Sz8i5Z84q9e50URbIAEkkVSB,bWdj2GDclj5ofokWjzoa5jAwMkxCykd6,11,9,3,0,3,1,16,2,34,4.857142857142857,4,0.0,0,3,0,3,9,1,0,16,2,6,28,1
16682,156565,MTBFJm3bIEaE6OQdIPJiDEIIoJhDDIeA,SpATywNh6bZuzm8s1ceuBUnMUAeoAHHw,8,2,2,0,2,0,3,0,9,1.2857142857142858,1,0.0,0,2,0,2,2,0,0,3,0,4,5,1
16683,156571,OLSxCkluLildKVrVnzRIsj47tt9tVHj9,RXDvfPUBYFlVdlueBFbLW0mhhAyGEqpt,5,2,1,0,1,0,4,0,8,1.1428571428571428,2,0.0,0,1,0,1,2,0,0,4,0,2,6,1
16684,156582,Vdk84P68xIHXBGrWqw3oEozZYT063dLv,SpATywNh6bZuzm8s1ceuBUnMUAeoAHHw,5,2,1,0,1,0,2,0,6,0.8571428571428571,1,0.0,0,1,0,1,2,0,0,2,0,2,4,0
16685,156591,j7YtZasgspNNzi8PoR1n8xBZYl8hPf0G,bWdj2GDclj5ofokWjzoa5jAwMkxCykd6,1,0,0,0,0,0,2,0,2,0.2857142857142857,1,0.0,0,0,0,0,0,0,0,2,0,0,2,1
16686,156596,OLSxCkluLildKVrVnzRIsj47tt9tVHj9,5X6FeZozNMgE2VRi3MJYjkkFK8SETtu2,1,0,0,0,0,0,1,0,1,0.14285714285714285,1,0.0,0,0,0,0,0,0,0,1,0,0,1,1
16687,156611,zCl6F2bpK7NJ4O3NtU8qe3DgIKVmj35C,SpATywNh6bZuzm8s1ceuBUnMUAeoAHHw,5,2,1,0,1,0,2,0,6,0.8571428571428571,1,0.0,0,1,0,1,2,0,0,2,0,2,4,1
16688,156627,yoNF71FjmlchDw8CrVsPoTImtdirrSh8,SpATywNh6bZuzm8s1ceuBUnMUAeoAHHw,12,11,1,7,1,0,1,0,21,3.0,1,0.0,2,1,6,1,9,0,1,1,0,10,11,1
16689,156629,mDHr8WvVVX9KSvXMqxtLvZ6vP4uuNF6E,5X6FeZozNMgE2VRi3MJYjkkFK8SETtu2,6,6,1,0,2,0,1,0,10,1.4285714285714286,2,0.0,1,1,0,2,5,0,0,1,0,4,6,1
16690,156691,YSuxkE1Xqan24aiv5kdAAXS5OHLY0Aml,A3fsA9Zfv1X2fVEQhTw51lKENdNrEqT3,16,12,9,18,5,1,5,0,50,7.142857142857143,2,0.0,1,9,15,5,11,1,3,5,0,30,20,0
16691,156708,qzgqMBszLUnJd9ZV8Zyg9x0an59yJyuH,A3fsA9Zfv1X2fVEQhTw51lKENdNrEqT3,63,71,48,104,19,12,31,2,287,41.0,5,0.0,6,48,89,19,65,12,15,31,2,162,125,1
16692,156714,gLb9HBNsGES4iiLngE7LJlzcsHLIiWPc,bWdj2GDclj5ofokWjzoa5jAwMkxCykd6,6,5,0,0,1,0,2,0,8,1.1428571428571428,1,0.0,0,0,0,1,5,0,0,2,0,1,7,1
16693,156721,CUbueK74RGsaWBcRtztdoMN84Z7TxEjm,A3fsA9Zfv1X2fVEQhTw51lKENdNrEqT3,1,0,0,0,0,0,1,0,1,0.14285714285714285,1,0.0,0,0,0,0,0,0,0,1,0,0,1,0
16694,156738,OektSQ9TNN3cEy3ZKuUs35c7BdSOqtaQ,A3fsA9Zfv1X2fVEQhTw51lKENdNrEqT3,6,4,2,0,1,0,4,0,11,1.5714285714285714,2,0.0,0,2,0,1,4,0,0,4,0,3,8,1
16695,156741,uafClU57KYzpGT2uPAu1Hr0wJXO4izc7,bWdj2GDclj5ofokWjzoa5jAwMkxCykd6,2,0,0,0,0,0,3,0,3,0.42857142857142855,1,0.0,0,0,0,0,0,0,0,3,0,0,3,1
16696,156745,QtwtavP81h42E4zJzMznn2bf4MZADbs3,A3fsA9Zfv1X2fVEQhTw51lKENdNrEqT3,4,1,0,0,0,0,4,0,5,0.7142857142857143,1,0.0,0,0,0,0,1,0,0,4,0,0,5,1
16697,156757,MOcMwRKo0dtFqZ5xWBgRzquuZGKtQyf4,bWdj2GDclj5ofokWjzoa5jAwMkxCykd6,5,4,2,0,1,0,2,0,9,1.2857142857142858,2,0.0,0,2,0,1,4,0,0,2,0,3,6,1
16698,156758,Bt5rX9oXtFoN3UVn5z9aey4iI5wtlrvh,A3fsA9Zfv1X2fVEQhTw51lKENdNrEqT3,41,18,10,80,6,0,5,0,119,17.0,2,0.0,5,10,71,6,13,0,9,5,0,92,27,0
16699,156771,509hMngiUm6zrKoE3SecqGuN8tx0I6r6,SpATywNh6bZuzm8s1ceuBUnMUAeoAHHw,4,5,0,0,0,0,0,0,5,0.7142857142857143,1,0.0,0,0,0,0,5,0,0,0,0,0,5,1
16700,156772,509hMngiUm6zrKoE3SecqGuN8tx0I6r6,A3fsA9Zfv1X2fVEQhTw51lKENdNrEqT3,3,3,0,0,0,0,0,0,3,0.42857142857142855,1,0.0,0,0,0,0,3,0,0,0,0,0,3,1
16701,156782,5vvAIYSZAT26IXVwYTJynoQoKJk6ajG9,SpATywNh6bZuzm8s1ceuBUnMUAeoAHHw,7,3,2,0,2,0,3,0,10,1.4285714285714286,1,0.0,0,2,0,2,3,0,0,3,0,4,6,1
16702,156784,foHHzg8y8kVV0aOnqOspjjxNSKCSJYQ9,SpATywNh6bZuzm8s1ceuBUnMUAeoAHHw,9,7,5,0,3,0,3,0,18,2.5714285714285716,2,0.0,0,5,0,3,7,0,0,3,0,8,10,1
16703,156811,nqSXUXXEr4UIgbMex1vOrc4sZti4WIMg,bWdj2GDclj5ofokWjzoa5jAwMkxCykd6,4,4,2,0,0,0,2,0,8,1.1428571428571428,1,0.0,1,2,0,0,3,0,0,2,0,3,5,1
16704,156816,3yoGJn4wINiLioKDt9oLKFssOQfyQK8Z,SpATywNh6bZuzm8s1ceuBUnMUAeoAHHw,18,22,1,28,0,5,6,1,63,9.0,1,0.0,5,1,25,0,17,5,3,6,1,31,32,1
16705,156848,3DOywPe0JHdRdmtWhQwYFlAgvwXRAQOv,3VkHkmOtom3jM2wCu94xgzzu1d6Dn7or,7,3,1,0,1,0,6,0,11,1.5714285714285714,1,0.0,1,1,0,1,2,0,0,6,0,3,8,1
16706,156850,oQBpblElSoO3Vqvvh9Xdd3HeDB6VZdai,3VkHkmOtom3jM2wCu94xgzzu1d6Dn7or,8,2,1,0,1,1,6,1,12,1.7142857142857142,1,0.0,0,1,0,1,2,1,0,6,1,2,10,1
16707,156858,1sESD9iEkXgTa0jiav7WBnyoYdcyYkDH,3VkHkmOtom3jM2wCu94xgzzu1d6Dn7or,6,4,1,0,1,1,2,0,9,1.2857142857142858,1,0.0,0,1,0,1,4,1,0,2,0,2,7,1
16708,156859,E4407AoESgmy6Z5RqocCNXptPIkGCKrE,3VkHkmOtom3jM2wCu94xgzzu1d6Dn7or,1,0,0,0,0,0,1,0,1,0.14285714285714285,1,0.0,0,0,0,0,0,0,0,1,0,0,1,1
16709,156879,jvG6RW3X6AqmQihQCB2pzHMKYR6AGED3,3VkHkmOtom3jM2wCu94xgzzu1d6Dn7or,23,84,25,29,15,18,10,0,181,25.857142857142858,3,0.0,25,25,27,15,59,18,2,10,0,92,89,0
16710,156899,0bzZbZHkLNuxUgyCO7kphg8pZrwxOXX5,3VkHkmOtom3jM2wCu94xgzzu1d6Dn7or,7,2,2,0,2,2,4,1,13,1.8571428571428572,1,0.0,0,2,0,2,2,2,0,4,1,4,9,1
16711,156906,ecyMKEwCol1CsOTtEjA0TmA0ug5yhLgo,3VkHkmOtom3jM2wCu94xgzzu1d6Dn7or,8,19,5,0,6,0,2,0,32,4.571428571428571,1,0.0,11,5,0,6,8,0,0,2,0,22,10,1
16712,156918,6kObL26hEJOoKwl5cvMnefprVRNzNLL1,3VkHkmOtom3jM2wCu94xgzzu1d6Dn7or,6,1,1,0,1,0,3,0,6,0.8571428571428571,1,0.0,0,1,0,1,1,0,0,3,0,2,4,1
16713,156936,6l5rNdJjVuOCdIyZv4RcOHzbywv2VcJk,3VkHkmOtom3jM2wCu94xgzzu1d6Dn7or,5,2,1,0,1,0,4,0,8,1.1428571428571428,2,0.0,0,1,0,1,2,0,0,4,0,2,6,1
16714,156947,CIR8CBPpjAuojVkyBWHWMOBRWnHtRU0H,3VkHkmOtom3jM2wCu94xgzzu1d6Dn7or,2,0,0,0,0,0,2,0,2,0.2857142857142857,1,0.0,0,0,0,0,0,0,0,2,0,0,2,1
16715,156976,8MJZPDEqC0FEpOK9sDbC1L41oI4iMwLw,3VkHkmOtom3jM2wCu94xgzzu1d6Dn7or,1,0,0,0,0,0,1,0,1,0.14285714285714285,1,0.0,0,0,0,0,0,0,0,1,0,0,1,1
16716,156989,45yfbnarXLY6Jtgynu1Xeg2zt9QQstcT,3VkHkmOtom3jM2wCu94xgzzu1d6Dn7or,1,0,0,0,0,0,1,0,1,0.14285714285714285,1,0.0,0,0,0,0,0,0,0,1,0,0,1,1
16717,156998,xSPI4pqueci7OIkuI9BEhClCsXyXQY9x,3VkHkmOtom3jM2wCu94xgzzu1d6Dn7or,3,0,0,0,0,0,3,0,3,0.42857142857142855,1,0.0,0,0,0,0,0,0,0,3,0,0,3,1
16718,157004,GCmVg4GQ7sTGsEQ8hxY6xROLCOMlMxWn,3VkHkmOtom3jM2wCu94xgzzu1d6Dn7or,11,13,6,0,4,0,3,0,26,3.7142857142857144,2,0.0,0,6,0,4,13,0,0,3,0,10,16,1
16719,157018,2tcuR2KxaK8WRZGfM6udlEdiV4BPFQkF,3VkHkmOtom3jM2wCu94xgzzu1d6Dn7or,4,2,1,0,0,0,2,1,6,0.8571428571428571,1,0.0,0,1,0,0,2,0,0,2,1,1,5,1
16720,157030,YAxKO80zPAjKGAsN0aDL5bYrUlrGkHcw,3VkHkmOtom3jM2wCu94xgzzu1d6Dn7or,1,0,0,0,0,0,2,0,2,0.2857142857142857,1,0.0,0,0,0,0,0,0,0,2,0,0,2,1
16721,157043,UgTMaOmXzZisJLVjoZZhQnLG7nLc3m9R,3VkHkmOtom3jM2wCu94xgzzu1d6Dn7or,5,1,1,0,1,0,2,0,5,0.7142857142857143,1,0.0,0,1,0,1,1,0,0,2,0,2,3,1
16722,157046,2Ueq99WOxFkvLjKvdAbi1TRY9isnfhGR,3VkHkmOtom3jM2wCu94xgzzu1d6Dn7or,1,0,0,0,0,0,1,0,1,0.14285714285714285,1,0.0,0,0,0,0,0,0,0,1,0,0,1,1
16723,157049,TUNzhMk7KYKLZ5t96SpbfpiSfMKW1lgg,3VkHkmOtom3jM2wCu94xgzzu1d6Dn7or,7,4,1,0,1,0,4,0,10,1.4285714285714286,2,0.0,0,1,0,1,4,0,0,4,0,2,8,0
16724,157088,unIZPWGEs4SMmqxgQqmO7WzQDtIXBNkL,3VkHkmOtom3jM2wCu94xgzzu1d6Dn7or,6,6,3,0,2,0,3,0,14,2.0,2,0.0,0,3,0,2,6,0,0,3,0,5,9,0
16725,157102,DPluFJfFEDLWsyQ8WcWPeyz0ccI0HVP0,3VkHkmOtom3jM2wCu94xgzzu1d6Dn7or,1,0,0,0,0,0,1,0,1,0.14285714285714285,1,0.0,0,0,0,0,0,0,0,1,0,0,1,1
16726,157126,Vn7oh8Zmlq5Mb29RmziqYla5AQoDWGby,3VkHkmOtom3jM2wCu94xgzzu1d6Dn7or,1,0,0,0,0,0,1,0,1,0.14285714285714285,1,0.0,0,0,0,0,0,0,0,1,0,0,1,1
16727,157128,AzzlZTan85NtpWN7Tw6er163M4eAWMcs,3VkHkmOtom3jM2wCu94xgzzu1d6Dn7or,1,0,0,0,0,0,4,0,4,0.5714285714285714,2,0.0,0,0,0,0,0,0,0,4,0,0,4,1
16728,157134,HEH8dbj1GoIbvkDQ9wJJ8yflgce0drSA,3VkHkmOtom3jM2wCu94xgzzu1d6Dn7or,1,0,0,0,0,0,1,0,1,0.14285714285714285,1,0.0,0,0,0,0,0,0,0,1,0,0,1,1
16729,157140,IE2fQ2gvms7KbELbWuciIFHxKaviUlJy,3VkHkmOtom3jM2wCu94xgzzu1d6Dn7or,6,2,1,0,1,0,3,1,8,1.1428571428571428,1,0.0,0,1,0,1,2,0,0,3,1,2,6,1
16730,157148,9yxgaT1T5BgEz11zZsh86J9ewAfn0TIj,3VkHkmOtom3jM2wCu94xgzzu1d6Dn7or,6,3,1,0,2,0,6,0,12,1.7142857142857142,1,0.0,2,1,0,2,1,0,0,6,0,5,7,1
16731,157149,cU8GrdhaRhAqB82AuZWKIL5LDmG7psnJ,3VkHkmOtom3jM2wCu94xgzzu1d6Dn7or,2,0,0,0,0,10,1,0,11,1.5714285714285714,1,0.0,0,0,0,0,0,10,0,1,0,0,11,1
16732,157163,8phz9AYz0BvRx5nlymKhm4uf6SL2rKlM,3VkHkmOtom3jM2wCu94xgzzu1d6Dn7or,1,0,0,0,0,0,1,0,1,0.14285714285714285,1,0.0,0,0,0,0,0,0,0,1,0,0,1,1
16733,157175,ZzYVZYoFRu6qmqfcBrYTS7mqaBTKsIny,7GRhBDsirIGkRZBtSMEzNTyDr2JQm4xx,1,0,0,0,0,0,1,0,1,0.14285714285714285,1,0.0,0,0,0,0,0,0,0,1,0,0,1,1
16734,157186,z6ogSWESGLxUuhgsxETNGPj2TtNqAMAt,7GRhBDsirIGkRZBtSMEzNTyDr2JQm4xx,2,0,0,0,0,0,2,0,2,0.2857142857142857,1,0.0,0,0,0,0,0,0,0,2,0,0,2,1
16735,157192,caQBTqoYm97O8lwsyp08CNg4MqbUA2Eo,7GRhBDsirIGkRZBtSMEzNTyDr2JQm4xx,7,6,3,0,1,0,5,0,15,2.142857142857143,1,0.0,0,3,0,1,6,0,0,5,0,4,11,1
16736,157193,i7vqGsozRewVYx6giRpm4P211SLUVjxQ,7GRhBDsirIGkRZBtSMEzNTyDr2JQm4xx,1,0,0,0,0,0,1,0,1,0.14285714285714285,1,0.0,0,0,0,0,0,0,0,1,0,0,1,1
16737,157196,YrBOxIkMDTPHtQeP4ha6MwTNuOzQva6q,7GRhBDsirIGkRZBtSMEzNTyDr2JQm4xx,2,0,0,0,0,0,8,0,8,1.1428571428571428,1,0.0,0,0,0,0,0,0,0,8,0,0,8,1
16738,157197,LpTOzhB0melA572OJERO4db65eD7w0cu,7GRhBDsirIGkRZBtSMEzNTyDr2JQm4xx,6,4,2,0,0,1,4,0,11,1.5714285714285714,1,0.0,1,2,0,0,3,1,0,4,0,3,8,1
16739,157201,0XtimRygN8aPS4UsgNYsDLh7g7VQkUin,7GRhBDsirIGkRZBtSMEzNTyDr2JQm4xx,2,0,0,0,0,0,3,0,3,0.42857142857142855,1,0.0,0,0,0,0,0,0,0,3,0,0,3,1
16740,157205,c3IQaJpJUkPE2qecKNSJwAyLl2PKb8yr,7GRhBDsirIGkRZBtSMEzNTyDr2JQm4xx,2,0,0,0,0,0,4,0,4,0.5714285714285714,1,0.0,0,0,0,0,0,0,0,4,0,0,4,1
16741,157207,1q7fbJprMr3n3JslWMG8Y37W51nC2LZB,7GRhBDsirIGkRZBtSMEzNTyDr2JQm4xx,5,3,1,0,1,1,4,0,10,1.4285714285714286,1,0.0,0,1,0,1,3,1,0,4,0,2,8,1
16742,157208,u1kEY9BTucDdRevAFNS3TzvwB9cnTuyG,7GRhBDsirIGkRZBtSMEzNTyDr2JQm4xx,2,0,0,0,0,0,2,0,2,0.2857142857142857,1,0.0,0,0,0,0,0,0,0,2,0,0,2,1
16743,157216,Bjd7KT9uiITTUGwvPeEVfIbMoFjGLRXD,5X6FeZozNMgE2VRi3MJYjkkFK8SETtu2,18,20,3,26,8,2,3,1,63,9.0,1,0.0,17,3,20,8,3,2,6,3,1,48,15,1
16744,157226,h6N9SyV6dQj6If7QxGp31IQ94XXyWUIO,5X6FeZozNMgE2VRi3MJYjkkFK8SETtu2,5,2,0,0,0,0,4,0,6,0.8571428571428571,1,0.0,0,0,0,0,2,0,0,4,0,0,6,1
16745,157244,hrE2wqQITNDujGOu31qZ9nVLSRudlDFi,7GRhBDsirIGkRZBtSMEzNTyDr2JQm4xx,70,124,32,38,86,25,9,0,314,44.857142857142854,5,0.0,39,32,24,86,85,25,14,9,0,181,133,0
16746,157269,ZW10p50itaf2NuSU5aKpQEE3l8rBuIkc,7GRhBDsirIGkRZBtSMEzNTyDr2JQm4xx,1,0,0,0,0,0,1,0,1,0.14285714285714285,1,0.0,0,0,0,0,0,0,0,1,0,0,1,0
16747,157276,rw1CeO1TCa8fgCdp1zXNf3dRKMz7g6nk,7GRhBDsirIGkRZBtSMEzNTyDr2JQm4xx,2,0,0,0,0,0,2,0,2,0.2857142857142857,1,0.0,0,0,0,0,0,0,0,2,0,0,2,1
16748,157293,0Rc9QmalpGXvwxh2iIaT1Kf7aHCEMOJW,7GRhBDsirIGkRZBtSMEzNTyDr2JQm4xx,4,3,1,0,1,0,1,0,6,0.8571428571428571,1,0.0,0,1,0,1,3,0,0,1,0,2,4,1
16749,157295,RkMMgfrDoCy0k6xciXBqfQqum2o9XEow,7GRhBDsirIGkRZBtSMEzNTyDr2JQm4xx,5,2,0,0,0,0,4,0,6,0.8571428571428571,1,0.0,0,0,0,0,2,0,0,4,0,0,6,1
16750,157300,0a6HihupPBi4xpjolN637qOYG6WSN1Gx,7GRhBDsirIGkRZBtSMEzNTyDr2JQm4xx,10,9,5,0,5,0,4,0,23,3.2857142857142856,1,0.0,2,5,0,5,7,0,0,4,0,12,11,1
16751,157312,9FHojamNYxBNrQ6PYQ6fNVNJw4Al6wFf,7GRhBDsirIGkRZBtSMEzNTyDr2JQm4xx,30,72,5,8,8,3,19,2,117,16.714285714285715,2,0.0,28,5,6,8,44,3,2,19,2,47,70,1
16752,157338,cOx2ivO0cjd2S3OxGikx2UdSMlRcgy0Q,7GRhBDsirIGkRZBtSMEzNTyDr2JQm4xx,1,0,0,0,0,0,3,0,3,0.42857142857142855,2,0.0,0,0,0,0,0,0,0,3,0,0,3,1
16753,157354,5ehf4EFN8WhDbvmb2WvfZwpaBD0cj1oj,5X6FeZozNMgE2VRi3MJYjkkFK8SETtu2,6,3,1,0,1,0,2,0,7,1.0,1,0.0,0,1,0,1,3,0,0,2,0,2,5,1
16754,157363,lBHUi5hQhqG9vQMxFTu02cmFxiJKc01u,7GRhBDsirIGkRZBtSMEzNTyDr2JQm4xx,2,0,0,0,0,0,2,0,2,0.2857142857142857,1,0.0,0,0,0,0,0,0,0,2,0,0,2,1
16755,157422,9FaPBbsYKn0C9myyRYf9vYNhns2eJDpD,5X6FeZozNMgE2VRi3MJYjkkFK8SETtu2,3,3,1,0,0,0,2,0,6,0.8571428571428571,1,0.0,0,1,0,0,3,0,0,2,0,1,5,1
16756,157423,DBiaK9DSvH9MwTDzoUhyasBgiPY2wQB4,5X6FeZozNMgE2VRi3MJYjkkFK8SETtu2,1,0,0,0,0,0,1,0,1,0.14285714285714285,1,0.0,0,0,0,0,0,0,0,1,0,0,1,1
16757,157434,IZiNyXwRBQbk0M6blWUnLJQIqlWZxamb,5X6FeZozNMgE2VRi3MJYjkkFK8SETtu2,14,12,8,0,6,0,1,0,27,3.857142857142857,1,0.0,0,8,0,6,12,0,0,1,0,14,13,1
16758,157441,cOx2ivO0cjd2S3OxGikx2UdSMlRcgy0Q,5X6FeZozNMgE2VRi3MJYjkkFK8SETtu2,1,0,0,0,0,0,1,0,1,0.14285714285714285,1,0.0,0,0,0,0,0,0,0,1,0,0,1,1
16759,157463,v5ZclElew7ejFho1P7oX3s4a7TxNLCyF,5X6FeZozNMgE2VRi3MJYjkkFK8SETtu2,1,0,0,0,0,0,1,0,1,0.14285714285714285,1,0.0,0,0,0,0,0,0,0,1,0,0,1,1
16760,157493,oBNu1yheXNm4QzvTpRG6uVhpeMCjpi7n,7GRhBDsirIGkRZBtSMEzNTyDr2JQm4xx,21,18,14,10,10,0,3,0,55,7.857142857142857,2,0.0,2,14,10,10,16,0,0,3,0,36,19,1
16761,157525,1cJ3IiBP3iso6zCDFOfl79OCcoYhGWhv,7GRhBDsirIGkRZBtSMEzNTyDr2JQm4xx,1,0,0,0,0,0,1,0,1,0.14285714285714285,1,0.0,0,0,0,0,0,0,0,1,0,0,1,1
16762,157538,Qzxs3prleGy5HanVMqS0iFlTNJtBW0w6,7GRhBDsirIGkRZBtSMEzNTyDr2JQm4xx,1,0,0,0,0,0,1,0,1,0.14285714285714285,1,0.0,0,0,0,0,0,0,0,1,0,0,1,1
16763,157547,knSbNmB3B4D7WDjxqoR5ogJCHbYuCvFK,5X6FeZozNMgE2VRi3MJYjkkFK8SETtu2,1,0,0,0,0,0,2,0,2,0.2857142857142857,1,0.0,0,0,0,0,0,0,0,2,0,0,2,1
16764,157552,HkZ9cpNX2CkQYteixnJNqLUCAlpOg3MZ,7GRhBDsirIGkRZBtSMEzNTyDr2JQm4xx,1,0,0,0,0,0,1,0,1,0.14285714285714285,1,0.0,0,0,0,0,0,0,0,1,0,0,1,1
16765,157561,HD18aUeI83TGpCqkfevoF6pzoLyLfF7f,5X6FeZozNMgE2VRi3MJYjkkFK8SETtu2,8,5,4,0,4,0,1,0,14,2.0,2,0.0,0,4,0,4,5,0,0,1,0,8,6,1
16766,157566,k3v7Eyu7Dh3B7oRJvMZeSglihGPbIbyB,7GRhBDsirIGkRZBtSMEzNTyDr2JQm4xx,2,0,0,0,0,0,2,0,2,0.2857142857142857,1,0.0,0,0,0,0,0,0,0,2,0,0,2,1
16767,157567,ECbTw58nDutHihiUsnPXkHt9qTO2jtWr,5X6FeZozNMgE2VRi3MJYjkkFK8SETtu2,1,0,0,0,0,0,1,0,1,0.14285714285714285,1,0.0,0,0,0,0,0,0,0,1,0,0,1,1
16768,157576,V1tEn8Shi0xM6f4Xd1g5Spwc7qOHvOqG,7GRhBDsirIGkRZBtSMEzNTyDr2JQm4xx,5,3,2,0,2,0,4,0,11,1.5714285714285714,2,0.0,0,2,0,2,3,0,0,4,0,4,7,1
16769,157614,LpKc0q3vwtZx2tbV2GItCPMY7oFOnDvF,5X6FeZozNMgE2VRi3MJYjkkFK8SETtu2,10,17,7,0,0,8,2,0,34,4.857142857142857,1,0.0,9,7,0,0,8,8,0,2,0,16,18,1
16770,157622,mUDgTVmygSuewvWeFS0TPPpUtE7wznA7,7GRhBDsirIGkRZBtSMEzNTyDr2JQm4xx,13,27,14,0,1,1,2,0,45,6.428571428571429,1,0.0,7,14,0,1,20,1,0,2,0,22,23,1
16771,157632,BHVI7hOZl1DwvVUvB9py5Yfc5VOm18uV,5Gyp41oLVo7Gg7vF4vpmggWP5MU70QO6,12,8,4,3,3,1,4,2,25,3.5714285714285716,3,0.0,2,4,2,3,6,1,1,4,2,11,14,1
16772,157635,b9K9pq41f7QaJ15GpQHgFYfB4YcHSKuj,5Gyp41oLVo7Gg7vF4vpmggWP5MU70QO6,12,11,6,7,3,2,5,1,35,5.0,2,0.0,3,6,5,3,8,2,2,5,1,17,18,1
16773,157642,e4mytzLJHmGiSnWVJseSD624dEoLq3Sh,5Gyp41oLVo7Gg7vF4vpmggWP5MU70QO6,7,6,0,0,3,0,2,0,11,1.5714285714285714,3,0.0,0,0,0,3,6,0,0,2,0,3,8,1
16774,157649,8YR0tcT3D8d0JlIytw4LxKfYYQekJyvj,5Gyp41oLVo7Gg7vF4vpmggWP5MU70QO6,6,4,2,0,2,0,1,0,9,1.2857142857142858,1,0.0,0,2,0,2,4,0,0,1,0,4,5,1
16775,157664,zXaIFCKxfdY9z9fVBcdJ9CKQhYz4fcsP,5Gyp41oLVo7Gg7vF4vpmggWP5MU70QO6,13,14,6,7,1,17,10,0,55,7.857142857142857,1,0.0,5,6,4,1,9,17,3,10,0,16,39,1
16776,157677,J9op6VmaAPI3mRg3zaq4XvDsesER8r08,5Gyp41oLVo7Gg7vF4vpmggWP5MU70QO6,3,0,0,0,0,0,3,0,3,0.42857142857142855,1,0.0,0,0,0,0,0,0,0,3,0,0,3,1
16777,157680,mEHAVnTSPxrqijaXglU7YL6yhhw9zDNh,5Gyp41oLVo7Gg7vF4vpmggWP5MU70QO6,3,2,1,0,0,0,1,0,4,0.5714285714285714,1,0.0,0,1,0,0,2,0,0,1,0,1,3,1
16778,157684,bupF78TICGiaq6b1Vsb3JvHLuPgK0vHR,5Gyp41oLVo7Gg7vF4vpmggWP5MU70QO6,5,2,1,0,1,6,4,0,14,2.0,1,0.0,0,1,0,1,2,6,0,4,0,2,12,1
16779,157687,ggEy8RvbTCh4JSUdb7xJ6pw5CVRursGj,5Gyp41oLVo7Gg7vF4vpmggWP5MU70QO6,11,11,6,0,4,13,15,1,50,7.142857142857143,3,0.0,0,6,0,4,11,13,0,15,1,10,40,1
16780,157689,kYy5EHsDUpLzMmIwn2uBsPfas2cjBUTm,5Gyp41oLVo7Gg7vF4vpmggWP5MU70QO6,7,4,3,2,1,0,2,0,12,1.7142857142857142,1,0.0,0,3,2,1,4,0,0,2,0,6,6,1
16781,157704,FmxYCqadwk8A3bSxqqiVTuWZIX7DqlxE,5Gyp41oLVo7Gg7vF4vpmggWP5MU70QO6,6,8,0,0,0,0,1,0,9,1.2857142857142858,1,0.0,0,0,0,0,8,0,0,1,0,0,9,1
16782,157705,ov3rFO0SWh2vtYBGPTxN35QJKYJzF6Rm,5Gyp41oLVo7Gg7vF4vpmggWP5MU70QO6,8,4,3,0,2,0,2,0,11,1.5714285714285714,1,0.0,0,3,0,2,4,0,0,2,0,5,6,1
16783,157708,4Nbx3b827QgbSwlChql19z0Neh3M3aRD,5Gyp41oLVo7Gg7vF4vpmggWP5MU70QO6,14,17,9,0,4,1,15,1,47,6.714285714285714,4,0.0,1,9,0,4,16,1,0,15,1,14,33,1
16784,157716,DelEAapcZRepqLkOzx1OfRUs9n7ZC2tB,5Gyp41oLVo7Gg7vF4vpmggWP5MU70QO6,5,7,4,0,0,0,2,0,13,1.8571428571428572,2,0.0,0,4,0,0,7,0,0,2,0,4,9,1
16785,157721,kAv65kdRhACG1cGYJPQ3UUN1jnjQbw30,5Gyp41oLVo7Gg7vF4vpmggWP5MU70QO6,6,3,2,0,2,0,1,0,8,1.1428571428571428,1,0.0,0,2,0,2,3,0,0,1,0,4,4,1
16786,157725,TuJrZ9qQp5b2qpTGGmQsmYcn7kQGqQe7,5Gyp41oLVo7Gg7vF4vpmggWP5MU70QO6,12,7,4,0,2,4,13,1,31,4.428571428571429,1,0.0,1,4,0,2,6,4,0,13,1,7,24,1
16787,157733,YC4hsBd06ZXn7dhTBoDlcdcvMFwoDU9J,5Gyp41oLVo7Gg7vF4vpmggWP5MU70QO6,1,0,0,0,0,0,1,0,1,0.14285714285714285,1,0.0,0,0,0,0,0,0,0,1,0,0,1,1
16788,157744,tbHK6wGgpSOKq5xS4Q6iKGoMVFXVb1up,5Gyp41oLVo7Gg7vF4vpmggWP5MU70QO6,5,2,1,0,1,1,4,1,10,1.4285714285714286,1,0.0,0,1,0,1,2,1,0,4,1,2,8,1
16789,157748,okVg9Xp1vC7Go36hSISNctuRi91rDjBa,5Gyp41oLVo7Gg7vF4vpmggWP5MU70QO6,1,0,0,0,0,0,1,0,1,0.14285714285714285,1,0.0,0,0,0,0,0,0,0,1,0,0,1,1
16790,157766,4VatEksX4g9JbVdH7nK8z1dcoLKQFuf1,5Gyp41oLVo7Gg7vF4vpmggWP5MU70QO6,7,3,2,0,2,0,3,0,10,1.4285714285714286,2,0.0,0,2,0,2,3,0,0,3,0,4,6,1
16791,157774,J59qmd35qLZG6cBcMkq86dcL05FYYlzn,5Gyp41oLVo7Gg7vF4vpmggWP5MU70QO6,6,4,2,0,1,0,4,0,11,1.5714285714285714,1,0.0,0,2,0,1,4,0,0,4,0,3,8,1
16792,157797,AimhZ5CMd3cWY2DlhFQJu8yaAkNoh3Dt,5Gyp41oLVo7Gg7vF4vpmggWP5MU70QO6,5,2,1,0,1,0,2,0,6,0.8571428571428571,1,0.0,0,1,0,1,2,0,0,2,0,2,4,1
16793,157809,sKM09JboTzop9XVHOkRwt7eh2M7KwmLM,5Gyp41oLVo7Gg7vF4vpmggWP5MU70QO6,1,0,0,0,0,0,1,0,1,0.14285714285714285,1,0.0,0,0,0,0,0,0,0,1,0,0,1,1
16794,157813,iahpkAlCoeyIcu10FEddjQTJ1RfU7hmc,5Gyp41oLVo7Gg7vF4vpmggWP5MU70QO6,1,0,0,0,0,0,1,0,1,0.14285714285714285,1,0.0,0,0,0,0,0,0,0,1,0,0,1,1
16795,157823,d1PB4qSSQBrllOXpAbPL3ermVaLJMq8w,5Gyp41oLVo7Gg7vF4vpmggWP5MU70QO6,11,20,13,5,4,0,7,1,50,7.142857142857143,2,0.0,1,13,3,4,19,0,2,7,1,21,29,1
16796,157825,tWBara106Yb76ojRSsVDGXcZTx6mFZQp,5Gyp41oLVo7Gg7vF4vpmggWP5MU70QO6,15,26,14,0,4,3,12,1,60,8.571428571428571,4,0.0,6,14,0,4,20,3,0,12,1,24,36,1
16797,157834,Oiijrt01HwezoanXSGLPQDRMfxgyzCrB,5Gyp41oLVo7Gg7vF4vpmggWP5MU70QO6,13,16,9,2,6,0,5,0,38,5.428571428571429,3,0.0,4,9,1,6,12,0,1,5,0,20,18,1
16798,157844,fP3JH1rakMmApdJ9kHO0r7cUhQDWLHT9,5Gyp41oLVo7Gg7vF4vpmggWP5MU70QO6,5,2,1,0,1,0,4,0,8,1.1428571428571428,1,0.0,0,1,0,1,2,0,0,4,0,2,6,1
16799,157848,apsgaZdkBse4QA8p5DlU0N1hwDlYFwlq,5Gyp41oLVo7Gg7vF4vpmggWP5MU70QO6,4,2,1,0,1,0,1,0,5,0.7142857142857143,1,0.0,0,1,0,1,2,0,0,1,0,2,3,1
16800,157879,hZtYMC0K38gXqBKrTDOxWf2kSwG06wA4,5Gyp41oLVo7Gg7vF4vpmggWP5MU70QO6,1,0,0,0,0,0,1,0,1,0.14285714285714285,1,0.0,0,0,0,0,0,0,0,1,0,0,1,1
16801,157880,O6XTfrmBXPHHKFN07CLCPWqyMP9NsQuf,5Gyp41oLVo7Gg7vF4vpmggWP5MU70QO6,7,4,2,0,1,0,4,0,11,1.5714285714285714,2,0.0,0,2,0,1,4,0,0,4,0,3,8,1
16802,157881,cQingcIr6b1ihV5kJhN5qPmtxp0KcxRT,5Gyp41oLVo7Gg7vF4vpmggWP5MU70QO6,4,2,1,0,1,0,1,0,5,0.7142857142857143,1,0.0,0,1,0,1,2,0,0,1,0,2,3,1
16803,157908,uAys1rabaSRG9ZlJG9TTFZxVEMEfDyRx,5Gyp41oLVo7Gg7vF4vpmggWP5MU70QO6,11,9,4,5,2,10,4,1,35,5.0,2,0.0,3,4,3,2,6,10,2,4,1,12,23,1
16804,157914,KEOiu4CQ5ywd8Pj18j9arhzSkJFxftlo,5Gyp41oLVo7Gg7vF4vpmggWP5MU70QO6,10,10,4,0,3,0,4,0,21,3.0,1,0.0,0,4,0,3,10,0,0,4,0,7,14,1
16805,157919,16nqpcDiyA6t4Yxn8gwQJ18qqQObgDiE,5Gyp41oLVo7Gg7vF4vpmggWP5MU70QO6,13,32,11,5,9,4,9,1,71,10.142857142857142,3,0.0,15,11,3,9,17,4,2,9,1,38,33,1
16806,157929,4Y77BzghNGgdSw2ZmEg0ICv6ndSkqSaa,5Gyp41oLVo7Gg7vF4vpmggWP5MU70QO6,1,0,0,0,0,0,2,0,2,0.2857142857142857,2,0.0,0,0,0,0,0,0,0,2,0,0,2,1
16807,157931,9w6D7jmIL0dPlWxoQU6UeaATKkwWl1pB,5Gyp41oLVo7Gg7vF4vpmggWP5MU70QO6,4,2,1,0,1,0,1,0,5,0.7142857142857143,1,0.0,0,1,0,1,2,0,0,1,0,2,3,1
16808,157941,afQkAxUvdLu532EqkP2BO2E822Re7HYk,5Gyp41oLVo7Gg7vF4vpmggWP5MU70QO6,10,12,8,0,2,0,6,0,28,4.0,3,0.0,0,8,0,2,12,0,0,6,0,10,18,1
16809,157949,TPDzBQ9rpNjeqli3KFaktTuUnc3ZEdFK,5Gyp41oLVo7Gg7vF4vpmggWP5MU70QO6,5,5,0,0,2,11,2,0,20,2.857142857142857,2,0.0,0,0,0,2,5,11,0,2,0,2,18,1
16810,157955,nRqoHIzNlBQT35aDwOmcapQeGMx0uV89,5Gyp41oLVo7Gg7vF4vpmggWP5MU70QO6,19,19,5,20,4,0,4,0,52,7.428571428571429,1,0.0,6,5,16,4,13,0,4,4,0,31,21,1
16811,157964,fhAX1Pecxh11KxhbFWCogtFJtJo6WZ97,5Gyp41oLVo7Gg7vF4vpmggWP5MU70QO6,3,0,0,0,0,0,5,0,5,0.7142857142857143,1,0.0,0,0,0,0,0,0,0,5,0,0,5,1
16812,157977,8HJiZoOTUArj8ouKObToEc9cbZd1p0Hh,5Gyp41oLVo7Gg7vF4vpmggWP5MU70QO6,13,22,7,6,8,0,6,0,49,7.0,3,0.0,10,7,5,8,12,0,1,6,0,30,19,1
16813,157983,gEZmhmelZ5ZF9BWTd9v2drvTc7xbVgWw,5Gyp41oLVo7Gg7vF4vpmggWP5MU70QO6,8,7,3,3,2,0,2,0,17,2.4285714285714284,1,0.0,3,3,2,2,4,0,1,2,0,10,7,1
16814,157984,7b6JC6PB4wrSLqIqGZaL6Y3UW5eVh0fp,5Gyp41oLVo7Gg7vF4vpmggWP5MU70QO6,18,38,19,7,6,27,8,0,105,15.0,3,0.0,9,19,4,6,29,27,3,8,0,38,67,1
16815,157986,Fagg3gyXrN4D8JqYlwX5flyuRv3gjkDW,5Gyp41oLVo7Gg7vF4vpmggWP5MU70QO6,5,5,3,0,2,0,3,0,13,1.8571428571428572,2,0.0,0,3,0,2,5,0,0,3,0,5,8,1
16816,157994,aJGGfOGJukSWlKFU5E1xCsbgsuwcp8Ll,5Gyp41oLVo7Gg7vF4vpmggWP5MU70QO6,7,6,3,0,2,0,2,0,13,1.8571428571428572,2,0.0,0,3,0,2,6,0,0,2,0,5,8,1
16817,158000,a1svP3KabnWtKyguhrrFt1OpGsti3I8K,5Gyp41oLVo7Gg7vF4vpmggWP5MU70QO6,13,14,9,0,6,0,8,0,37,5.285714285714286,2,0.0,2,9,0,6,12,0,0,8,0,17,20,1
16818,158011,iF0kA8I0vlcx5ATIU1VJWq0mDEgJRsUa,5Gyp41oLVo7Gg7vF4vpmggWP5MU70QO6,14,9,7,0,4,0,2,0,22,3.142857142857143,1,0.0,1,7,0,4,8,0,0,2,0,12,10,1
16819,158025,POGRFFRZzlPiBHiCHXnlCDCb459JTEzc,5Gyp41oLVo7Gg7vF4vpmggWP5MU70QO6,16,39,20,23,11,0,3,0,96,13.714285714285714,2,0.0,14,20,18,11,25,0,5,3,0,63,33,0
16820,158041,tMPZYG0DCvDSDEuO4KsQAdk0iwwmXKYt,5Gyp41oLVo7Gg7vF4vpmggWP5MU70QO6,8,5,4,0,1,1,8,2,21,3.0,2,0.0,0,4,0,1,5,1,0,8,2,5,16,1
16821,158043,RZPRe4XeIuwxw9CRRpKNRhZim4M7Y9vn,5Gyp41oLVo7Gg7vF4vpmggWP5MU70QO6,1,0,0,0,0,0,1,0,1,0.14285714285714285,1,0.0,0,0,0,0,0,0,0,1,0,0,1,1
16822,158047,E98B6VnsSgdhlvIT1b5qEE2jpZCrqTUr,5Gyp41oLVo7Gg7vF4vpmggWP5MU70QO6,7,3,2,0,2,0,2,0,9,1.2857142857142858,1,0.0,0,2,0,2,3,0,0,2,0,4,5,0
16823,158061,kCtKqphdIaaMaYiK2fd3FEPmUrXltDWR,5Gyp41oLVo7Gg7vF4vpmggWP5MU70QO6,7,1,1,0,1,7,5,1,16,2.2857142857142856,1,0.0,0,1,0,1,1,7,0,5,1,2,14,1
16824,158078,bLpYLG8DNCzVH3Ke9fLYhx9K744IifF0,5Gyp41oLVo7Gg7vF4vpmggWP5MU70QO6,4,2,1,0,1,0,1,0,5,0.7142857142857143,1,0.0,0,1,0,1,2,0,0,1,0,2,3,1
16825,158100,4avQmOrJuAzF46A93q5wyJBzd0GjayGm,5Gyp41oLVo7Gg7vF4vpmggWP5MU70QO6,5,1,1,0,1,0,2,0,5,0.7142857142857143,1,0.0,0,1,0,1,1,0,0,2,0,2,3,1
16826,158135,kCgmIS6JJhPuUOfuXsMwr39cI30MSyLb,5Gyp41oLVo7Gg7vF4vpmggWP5MU70QO6,13,18,8,2,4,0,3,0,35,5.0,2,0.0,4,8,1,4,14,0,1,3,0,17,18,1
16827,158153,esIpnxD65xUDDSaabDUGo5kswqkVqxR9,5Gyp41oLVo7Gg7vF4vpmggWP5MU70QO6,6,5,2,0,1,0,2,0,10,1.4285714285714286,2,0.0,0,2,0,1,5,0,0,2,0,3,7,1
16828,158164,uNWPqSX4UadZDpxwxprdlCLM0lIsWAjR,5Gyp41oLVo7Gg7vF4vpmggWP5MU70QO6,8,7,2,0,2,0,8,0,19,2.7142857142857144,2,0.0,0,2,0,2,7,0,0,8,0,4,15,1
16829,158172,Jv08t8fpcawyaZCw9f0bMJgjS8SuUKfb,5Gyp41oLVo7Gg7vF4vpmggWP5MU70QO6,1,0,0,0,0,0,1,0,1,0.14285714285714285,1,0.0,0,0,0,0,0,0,0,1,0,0,1,1
16830,158173,3cllbPYEJp74HYn7HHNMKMzXQxN8axkY,5Gyp41oLVo7Gg7vF4vpmggWP5MU70QO6,8,12,3,0,5,0,2,0,22,3.142857142857143,2,0.0,6,3,0,5,6,0,0,2,0,14,8,1
16831,158175,mvWG8WfFoikkAB9Wg1mtbCZJVje4NMeg,5Gyp41oLVo7Gg7vF4vpmggWP5MU70QO6,1,0,0,0,0,0,1,0,1,0.14285714285714285,1,0.0,0,0,0,0,0,0,0,1,0,0,1,0
16832,158182,IendqOMjPHM6PkjZNjaNDvRL7G48SMcS,5Gyp41oLVo7Gg7vF4vpmggWP5MU70QO6,18,22,11,7,5,2,8,2,57,8.142857142857142,1,0.0,7,11,6,5,15,2,1,8,2,29,28,1
16833,158183,vgPKjVSOWfFrIw9s3qyaLhpjQw13QENQ,5Gyp41oLVo7Gg7vF4vpmggWP5MU70QO6,11,15,7,4,4,0,2,0,32,4.571428571428571,2,0.0,4,7,2,4,11,0,2,2,0,17,15,1
16834,158188,xiHLAVx1lOeJhtdb9rNdxGApg3TIwPUZ,5Gyp41oLVo7Gg7vF4vpmggWP5MU70QO6,5,5,3,0,2,0,2,0,12,1.7142857142857142,2,0.0,0,3,0,2,5,0,0,2,0,5,7,1
16835,158189,jWibrywbdVGwrhQqgWdfjz3eC0hZq3Hp,5Gyp41oLVo7Gg7vF4vpmggWP5MU70QO6,5,2,1,0,1,0,2,0,6,0.8571428571428571,1,0.0,0,1,0,1,2,0,0,2,0,2,4,1
16836,158204,e5StAiQU2dGDqXL2MV912xoW6lsblG4i,5Gyp41oLVo7Gg7vF4vpmggWP5MU70QO6,14,15,8,1,4,12,7,3,50,7.142857142857143,2,0.0,4,8,1,4,11,12,0,7,3,17,33,1
16837,158206,YxV1DfMhtzoTbuIPgqeQiq3VUSpK0BqG,5Gyp41oLVo7Gg7vF4vpmggWP5MU70QO6,1,0,0,0,0,0,1,0,1,0.14285714285714285,1,0.0,0,0,0,0,0,0,0,1,0,0,1,1
16838,158209,Y9YzwTET1OUYhHsLt97DLY5Tl5O9atqy,5Gyp41oLVo7Gg7vF4vpmggWP5MU70QO6,8,7,3,0,2,0,3,0,15,2.142857142857143,3,0.0,1,3,0,2,6,0,0,3,0,6,9,1
16839,158214,R2fgEp6ZGIiEqrX6MpszWpZdnD6L8t0H,5Gyp41oLVo7Gg7vF4vpmggWP5MU70QO6,8,9,5,0,2,0,4,0,20,2.857142857142857,2,0.0,1,5,0,2,8,0,0,4,0,8,12,1
16840,158219,meMtAHW3ZOkonYX5TnwkdJmYGSglaFar,5Gyp41oLVo7Gg7vF4vpmggWP5MU70QO6,21,41,18,7,14,9,7,0,96,13.714285714285714,3,0.0,18,18,5,14,23,9,2,7,0,55,41,1
16841,158225,rT3zpA0g6rjJ1jZXfn6mCIcHmMcmU756,5Gyp41oLVo7Gg7vF4vpmggWP5MU70QO6,1,0,0,0,0,0,1,0,1,0.14285714285714285,1,0.0,0,0,0,0,0,0,0,1,0,0,1,1
16842,158245,FduuspqSLcDtrdIO2h0zRGA11CETecNX,5Gyp41oLVo7Gg7vF4vpmggWP5MU70QO6,1,0,0,0,0,0,1,0,1,0.14285714285714285,1,0.0,0,0,0,0,0,0,0,1,0,0,1,1
16843,158258,tBAHp8zjHfnlAwUDiyYlyw5unRg5QNVk,5Gyp41oLVo7Gg7vF4vpmggWP5MU70QO6,1,0,0,0,0,0,3,0,3,0.42857142857142855,1,0.0,0,0,0,0,0,0,0,3,0,0,3,1
16844,158260,h8BXRBzyL3fC2J31O1ozQ0OSoOmsk0kY,5Gyp41oLVo7Gg7vF4vpmggWP5MU70QO6,1,0,0,0,0,0,1,0,1,0.14285714285714285,1,0.0,0,0,0,0,0,0,0,1,0,0,1,1
16845,158265,bKTHB44I9NA1AlCs4T2fPG1UUI9vB5QD,5Gyp41oLVo7Gg7vF4vpmggWP5MU70QO6,14,23,12,8,7,1,2,0,53,7.571428571428571,1,0.0,9,12,7,7,14,1,1,2,0,35,18,1
16846,158269,MT0QR6jpBlQbjVhcPxF0XxHi7Yc3Nyuf,5Gyp41oLVo7Gg7vF4vpmggWP5MU70QO6,1,0,0,0,0,0,1,0,1,0.14285714285714285,1,0.0,0,0,0,0,0,0,0,1,0,0,1,1
16847,158271,TKFKCVKwvrOanp4kCnDFaQK6BpP2dGlY,5Gyp41oLVo7Gg7vF4vpmggWP5MU70QO6,14,13,7,10,3,24,4,1,62,8.857142857142858,1,0.0,3,7,7,3,10,24,3,4,1,20,42,1
16848,158278,bPrEBQILvyBjp3odJGGZ7KxlAV5Gu9sz,5Gyp41oLVo7Gg7vF4vpmggWP5MU70QO6,1,0,0,0,0,0,1,0,1,0.14285714285714285,1,0.0,0,0,0,0,0,0,0,1,0,0,1,1
16849,158298,IXrLVJjodB615NE3nTgPKqPt8WaHKw26,5Gyp41oLVo7Gg7vF4vpmggWP5MU70QO6,8,7,3,7,1,0,1,0,19,2.7142857142857144,1,0.0,3,3,4,1,4,0,3,1,0,11,8,1
16850,158302,RIny2MW6RqEP7xhtFxJv3B1aXVgJY8Kb,5Gyp41oLVo7Gg7vF4vpmggWP5MU70QO6,9,3,3,0,2,1,3,0,12,1.7142857142857142,1,0.0,0,3,0,2,3,1,0,3,0,5,7,1
16851,158307,dYbZNYxO0nAgHa5V5N8JCn1RF7JGyv4D,5Gyp41oLVo7Gg7vF4vpmggWP5MU70QO6,5,2,1,0,0,0,3,0,6,0.8571428571428571,1,0.0,0,1,0,0,2,0,0,3,0,1,5,1
16852,158315,vEqCVQMEkFA9jAkToxTDdY0fNSaSUQ9D,5Gyp41oLVo7Gg7vF4vpmggWP5MU70QO6,7,7,4,4,0,0,3,0,18,2.5714285714285716,2,0.0,1,4,3,0,6,0,1,3,0,8,10,1
16853,158319,D1N0ONIJFdYniASKJjZ0ujwEVr50txl7,5Gyp41oLVo7Gg7vF4vpmggWP5MU70QO6,16,30,13,2,5,1,6,1,58,8.285714285714286,1,0.0,8,13,1,5,22,1,1,6,1,27,31,1
16854,158327,mPvXVlGo9bSTwMgpTYZ4iSSEx1nYBz0y,5Gyp41oLVo7Gg7vF4vpmggWP5MU70QO6,10,11,5,0,5,4,4,1,30,4.285714285714286,1,0.0,4,5,0,5,7,4,0,4,1,14,16,1
16855,158334,X2GdbfrOlCpRv8wMx5HzvbudX41aMYE8,5Gyp41oLVo7Gg7vF4vpmggWP5MU70QO6,6,3,1,0,1,0,2,0,7,1.0,1,0.0,0,1,0,1,3,0,0,2,0,2,5,1
16856,158366,ICjb9YpLQQYBLFzFmkyCMZI5LNU5C4Fb,5Gyp41oLVo7Gg7vF4vpmggWP5MU70QO6,5,2,0,0,0,0,3,0,5,0.7142857142857143,1,0.0,0,0,0,0,2,0,0,3,0,0,5,1
16857,158368,jgTQGQ00AW13KIzXKnXpxkMCJOtGM2ZD,5Gyp41oLVo7Gg7vF4vpmggWP5MU70QO6,1,0,0,0,0,0,1,0,1,0.14285714285714285,1,0.0,0,0,0,0,0,0,0,1,0,0,1,1
16858,158371,fObaRfbtHaNloqqusul6bmMsSWbuzvXC,5Gyp41oLVo7Gg7vF4vpmggWP5MU70QO6,4,3,1,0,0,2,2,0,8,1.1428571428571428,1,0.0,0,1,0,0,3,2,0,2,0,1,7,1
16859,158392,NZRigOdbBm5L1F5X34hgYO92Vp7JjaX3,5Gyp41oLVo7Gg7vF4vpmggWP5MU70QO6,11,15,0,5,0,2,6,1,29,4.142857142857143,3,0.0,0,0,4,0,15,2,1,6,1,4,25,1
16860,158397,latsXX2CZqBxsak0y2yj9qi2bgjzhjJg,5Gyp41oLVo7Gg7vF4vpmggWP5MU70QO6,6,4,1,2,0,0,7,0,14,2.0,4,0.0,3,1,1,0,1,0,1,7,0,5,9,1
16861,158428,VPcKjCFv5uj1KHy6ikFvFUjZnehBQnkG,5Gyp41oLVo7Gg7vF4vpmggWP5MU70QO6,1,0,0,0,0,0,1,0,1,0.14285714285714285,1,0.0,0,0,0,0,0,0,0,1,0,0,1,1
16862,158446,j7fxdaSY4VkaXgXfrlAoPQl6rG0QNxwy,5Gyp41oLVo7Gg7vF4vpmggWP5MU70QO6,11,6,3,0,2,7,10,1,29,4.142857142857143,1,0.0,0,3,0,2,6,7,0,10,1,5,24,1
16863,158448,1lJkwHSG2PGCCRTCX9irDtb1w49OiLJh,5Gyp41oLVo7Gg7vF4vpmggWP5MU70QO6,11,10,3,6,4,0,2,0,25,3.5714285714285716,1,0.0,5,3,4,4,5,0,2,2,0,16,9,1
16864,158449,aKtqxPEfMnVhEPAMX3aHrnYTfbYN9i8f,5Gyp41oLVo7Gg7vF4vpmggWP5MU70QO6,6,7,1,0,2,0,1,0,11,1.5714285714285714,1,0.0,4,1,0,2,3,0,0,1,0,7,4,1
16865,158451,1syK9UG7Y4VPCyZBn9Q2mdOHpXjUfHgM,5Gyp41oLVo7Gg7vF4vpmggWP5MU70QO6,8,8,5,0,3,0,2,0,18,2.5714285714285716,1,0.0,0,5,0,3,8,0,0,2,0,8,10,1
16866,158465,iGwzujU2fvfaIrqdvBqmTILGKXNCvtST,5Gyp41oLVo7Gg7vF4vpmggWP5MU70QO6,4,3,2,0,2,0,2,0,9,1.2857142857142858,1,0.0,0,2,0,2,3,0,0,2,0,4,5,1
16867,158471,pQnR1td8vlxsKseVpfzZVvCBdR2iP4U6,5Gyp41oLVo7Gg7vF4vpmggWP5MU70QO6,12,11,6,0,5,0,4,0,26,3.7142857142857144,2,0.0,3,6,0,5,8,0,0,4,0,14,12,0
16868,158475,tU7GYHVcqvPAhXeEzR3nSmazmN6x1pBo,5Gyp41oLVo7Gg7vF4vpmggWP5MU70QO6,14,9,6,0,3,1,8,1,28,4.0,1,0.0,2,6,0,3,7,1,0,8,1,11,17,1
16869,158482,HMY5UQZiJ6ibeUNVihGwzdWGFcnwmp2R,5Gyp41oLVo7Gg7vF4vpmggWP5MU70QO6,1,0,0,0,0,0,1,0,1,0.14285714285714285,1,0.0,0,0,0,0,0,0,0,1,0,0,1,0
16870,158499,cjeJHDkfxPviww43UjeYlqmXXhxoPUfS,5Gyp41oLVo7Gg7vF4vpmggWP5MU70QO6,14,26,14,7,5,0,6,0,58,8.285714285714286,2,0.0,7,14,5,5,19,0,2,6,0,31,27,1
16871,158503,GhKn6zUEcIeiQ84zL2foYnGEKfw1oGjR,5Gyp41oLVo7Gg7vF4vpmggWP5MU70QO6,5,2,1,0,1,0,2,0,6,0.8571428571428571,1,0.0,0,1,0,1,2,0,0,2,0,2,4,1
16872,158518,VaAMzeJRo1p0krJhWA06tbTQQnzM9iwl,5Gyp41oLVo7Gg7vF4vpmggWP5MU70QO6,5,5,2,0,2,0,1,0,10,1.4285714285714286,1,0.0,0,2,0,2,5,0,0,1,0,4,6,1
16873,158532,XGiXK0tbneDlArbNNTMSAdB0dlmDCbAa,5Gyp41oLVo7Gg7vF4vpmggWP5MU70QO6,4,2,1,0,1,0,1,0,5,0.7142857142857143,1,0.0,0,1,0,1,2,0,0,1,0,2,3,1
16874,158548,LUNvU0WN1ejHZl1ho5KHC757d4vEnJq2,5Gyp41oLVo7Gg7vF4vpmggWP5MU70QO6,1,0,0,0,0,0,1,0,1,0.14285714285714285,1,0.0,0,0,0,0,0,0,0,1,0,0,1,1
16875,158550,N3yVimC4aRoIqkJhHmANqT86FYt5td7u,5Gyp41oLVo7Gg7vF4vpmggWP5MU70QO6,7,3,2,0,2,1,2,0,10,1.4285714285714286,1,0.0,0,2,0,2,3,1,0,2,0,4,6,1
16876,158562,o5YWOidjiSfpyoPVxXwOOyp6YMlu6cLI,5Gyp41oLVo7Gg7vF4vpmggWP5MU70QO6,10,8,5,0,6,0,14,0,33,4.714285714285714,3,0.0,3,5,0,6,5,0,0,14,0,14,19,0
16877,158590,kf0lhHnugT1vtE41zPkmCTmOp2QZF7bf,5Gyp41oLVo7Gg7vF4vpmggWP5MU70QO6,1,0,0,0,0,0,1,0,1,0.14285714285714285,1,0.0,0,0,0,0,0,0,0,1,0,0,1,1
16878,158591,VXBTEalT0R9120bnGfzjxPXNZh5Vbgmq,5Gyp41oLVo7Gg7vF4vpmggWP5MU70QO6,6,1,1,0,1,3,4,0,10,1.4285714285714286,1,0.0,0,1,0,1,1,3,0,4,0,2,8,1
16879,158594,67ART2vkl2t74M325EVjIJhRx1ejvS40,5Gyp41oLVo7Gg7vF4vpmggWP5MU70QO6,5,3,0,0,1,0,1,0,5,0.7142857142857143,1,0.0,0,0,0,1,3,0,0,1,0,1,4,1
16880,158626,0mg5UfmflBvw9f6RP57AlBJRO9poj3Bs,5Gyp41oLVo7Gg7vF4vpmggWP5MU70QO6,10,12,6,10,5,0,1,0,34,4.857142857142857,3,0.0,4,6,8,5,8,0,2,1,0,23,11,1
16881,158630,99faj0kcVuT7kHv9nA0d6tnRL3ttmjCW,5Gyp41oLVo7Gg7vF4vpmggWP5MU70QO6,13,15,5,6,3,10,12,3,54,7.714285714285714,1,0.0,6,5,4,3,9,10,2,12,3,18,36,1
16882,158636,hs5j7ZRJAVz8N5EC1FkbvoiXWPD8IL3z,5Gyp41oLVo7Gg7vF4vpmggWP5MU70QO6,12,10,4,0,4,0,4,0,22,3.142857142857143,2,0.0,1,4,0,4,9,0,0,4,0,9,13,1
16883,158639,BVhlqa9pkjc6pOJk0LRKjvBb1yF4UDBq,5Gyp41oLVo7Gg7vF4vpmggWP5MU70QO6,8,7,3,5,2,0,1,0,18,2.5714285714285716,1,0.0,1,3,4,2,6,0,1,1,0,10,8,1
16884,158640,3mV71SeXD3qDtzaWL89u9LU777oDMbT1,5Gyp41oLVo7Gg7vF4vpmggWP5MU70QO6,7,4,2,0,3,0,1,0,10,1.4285714285714286,1,0.0,1,2,0,3,3,0,0,1,0,6,4,1
16885,158647,3oFdgEmlxQicwDGRxacbBjJfGG2f7Sm0,5Gyp41oLVo7Gg7vF4vpmggWP5MU70QO6,1,0,0,0,0,0,1,0,1,0.14285714285714285,1,0.0,0,0,0,0,0,0,0,1,0,0,1,1
16886,158648,6LaYV30mJA6DDxEWjdfiMe6PHSVBFoww,5Gyp41oLVo7Gg7vF4vpmggWP5MU70QO6,1,0,0,0,0,0,1,0,1,0.14285714285714285,1,0.0,0,0,0,0,0,0,0,1,0,0,1,1
16887,158655,mxIDhIfkfZRmyKvgS40aefoFvvMqvCbq,5Gyp41oLVo7Gg7vF4vpmggWP5MU70QO6,7,3,2,0,2,0,2,0,9,1.2857142857142858,1,0.0,0,2,0,2,3,0,0,2,0,4,5,1
16888,158657,JERgMmFADxaPxEUdcYHhaMN4ZwNAyErv,5Gyp41oLVo7Gg7vF4vpmggWP5MU70QO6,8,7,4,0,3,12,2,0,28,4.0,3,0.0,1,4,0,3,6,12,0,2,0,8,20,0
16889,158668,NXySuzojhc1I0F7FiD9yLOqmBISmCQMB,5Gyp41oLVo7Gg7vF4vpmggWP5MU70QO6,1,0,0,0,0,0,1,0,1,0.14285714285714285,1,0.0,0,0,0,0,0,0,0,1,0,0,1,1
16890,158673,LaK1JduURkjj2lyFeEeEE5FM3J5L76tw,5Gyp41oLVo7Gg7vF4vpmggWP5MU70QO6,11,7,6,0,2,0,6,0,21,3.0,1,0.0,0,6,0,2,7,0,0,6,0,8,13,1
16891,158678,curm7DJyoZd1VeR71yWbpk0F1NDxBCrb,5Gyp41oLVo7Gg7vF4vpmggWP5MU70QO6,3,0,0,0,0,0,2,1,3,0.42857142857142855,1,0.0,0,0,0,0,0,0,0,2,1,0,3,1
16892,158695,DSSmckcZEOaCq2Uyy2Q5soLDN4iq3zmj,5Gyp41oLVo7Gg7vF4vpmggWP5MU70QO6,1,0,0,0,0,0,1,0,1,0.14285714285714285,1,0.0,0,0,0,0,0,0,0,1,0,0,1,1
16893,158707,blAP8wVtw28JBPhy4b1uSGqPMok7iJQm,5Gyp41oLVo7Gg7vF4vpmggWP5MU70QO6,15,16,8,7,3,7,7,1,49,7.0,1,0.0,6,8,4,3,10,7,3,7,1,21,28,1
16894,158710,WMzC7kjJJNCQ87Hj1SoFAZe7rj5HHPPM,5Gyp41oLVo7Gg7vF4vpmggWP5MU70QO6,1,0,0,0,0,0,1,0,1,0.14285714285714285,1,0.0,0,0,0,0,0,0,0,1,0,0,1,1
16895,158712,U5tkSGsuOdb2NICMgmncfIQF9sXcaWQo,5Gyp41oLVo7Gg7vF4vpmggWP5MU70QO6,1,0,0,0,0,0,1,0,1,0.14285714285714285,1,0.0,0,0,0,0,0,0,0,1,0,0,1,1
16896,158730,FYx6GSMXxl2y0jnssFnEJ9FCCIx9jizb,5Gyp41oLVo7Gg7vF4vpmggWP5MU70QO6,7,5,2,3,1,0,2,0,13,1.8571428571428572,1,0.0,3,2,2,1,2,0,1,2,0,8,5,1
16897,158741,accsGsynbzT9uxup2dTgGKxq1XsrGccD,5Gyp41oLVo7Gg7vF4vpmggWP5MU70QO6,5,3,0,0,0,1,2,1,7,1.0,1,0.0,0,0,0,0,3,1,0,2,1,0,7,1
16898,158743,UtpZFkJuvwL79mpOvm9h0KMX43ak3HFN,5Gyp41oLVo7Gg7vF4vpmggWP5MU70QO6,13,12,8,3,5,2,2,0,32,4.571428571428571,1,0.0,2,8,2,5,10,2,1,2,0,17,15,1
16899,158754,X0mwoxg874EbVxrlqwujNOOtlWsV2BZT,5Gyp41oLVo7Gg7vF4vpmggWP5MU70QO6,1,0,0,0,0,0,1,0,1,0.14285714285714285,1,0.0,0,0,0,0,0,0,0,1,0,0,1,1
16900,158776,WxvV8906xHzUZ8rq9etrY9Z1AOFyKSuT,5Gyp41oLVo7Gg7vF4vpmggWP5MU70QO6,14,11,4,3,3,2,7,1,31,4.428571428571429,1,0.0,6,4,2,3,5,2,1,7,1,15,16,1
16901,158783,vgN66F9Psm9Sxn9XT8nXYF0PS9BmAZED,5Gyp41oLVo7Gg7vF4vpmggWP5MU70QO6,1,0,0,0,0,0,2,0,2,0.2857142857142857,1,0.0,0,0,0,0,0,0,0,2,0,0,2,1
16902,158789,QXdd4a8KUTENAhNG79XpK4nmy1a07jeZ,5Gyp41oLVo7Gg7vF4vpmggWP5MU70QO6,1,0,0,0,0,0,1,0,1,0.14285714285714285,1,0.0,0,0,0,0,0,0,0,1,0,0,1,1
16903,158791,rGMEgQUkx4ST8bcPlJudg4FrbwvvvQJI,5Gyp41oLVo7Gg7vF4vpmggWP5MU70QO6,6,7,3,0,3,4,2,0,19,2.7142857142857144,2,0.0,1,3,0,3,6,4,0,2,0,7,12,1
16904,158814,VQIYnKO2473Bm22Gvh9VUHJtN81C8R1U,5Gyp41oLVo7Gg7vF4vpmggWP5MU70QO6,1,0,0,0,0,0,1,0,1,0.14285714285714285,1,0.0,0,0,0,0,0,0,0,1,0,0,1,1
16905,158826,QOuPgB8Uq3vJXh3zZBsjHkUOKOuZTKi8,5Gyp41oLVo7Gg7vF4vpmggWP5MU70QO6,4,2,1,0,1,0,2,0,6,0.8571428571428571,1,0.0,0,1,0,1,2,0,0,2,0,2,4,1
16906,158828,l2ByLqWzNHTFUGbglB0LunZR7pyhyPYC,5Gyp41oLVo7Gg7vF4vpmggWP5MU70QO6,4,0,0,0,0,3,3,0,6,0.8571428571428571,1,0.0,0,0,0,0,0,3,0,3,0,0,6,1
16907,158838,8cOlXXCu1kqO1hQan6tXksLaEW2dHkep,5Gyp41oLVo7Gg7vF4vpmggWP5MU70QO6,2,0,0,0,0,0,2,0,2,0.2857142857142857,2,0.0,0,0,0,0,0,0,0,2,0,0,2,1
16908,158844,MXomTGoseq9wn0Aqsho7Zdv6GaZ97tyh,5Gyp41oLVo7Gg7vF4vpmggWP5MU70QO6,5,4,2,0,1,0,2,0,9,1.2857142857142858,2,0.0,0,2,0,1,4,0,0,2,0,3,6,1
16909,158846,U3LGmFCOR4N6RHfV58LImyY8zsM7dVCO,5Gyp41oLVo7Gg7vF4vpmggWP5MU70QO6,21,33,14,11,12,0,4,0,74,10.571428571428571,4,0.0,10,14,8,12,23,0,3,4,0,44,30,1
16910,158849,hsaEJHgxwdJ8kMXFbLBAZN911WXVYvlZ,5Gyp41oLVo7Gg7vF4vpmggWP5MU70QO6,1,0,0,0,0,0,2,0,2,0.2857142857142857,2,0.0,0,0,0,0,0,0,0,2,0,0,2,1
16911,158861,NWP6ZOPeJjqRYoRHKneJjRxHdYMJ5lE2,5Gyp41oLVo7Gg7vF4vpmggWP5MU70QO6,1,0,0,0,0,0,1,0,1,0.14285714285714285,1,0.0,0,0,0,0,0,0,0,1,0,0,1,1
16912,158870,OWSRbTsro9ti37TwJJKCZuCImpFAWRwD,5Gyp41oLVo7Gg7vF4vpmggWP5MU70QO6,11,10,5,0,6,0,4,0,25,3.5714285714285716,2,0.0,2,5,0,6,8,0,0,4,0,13,12,1
16913,158878,ckJ0RkYemmBif8oGKbwb3NyOiUntCAqy,5Gyp41oLVo7Gg7vF4vpmggWP5MU70QO6,8,3,2,3,1,0,3,0,12,1.7142857142857142,1,0.0,1,2,2,1,2,0,1,3,0,6,6,1
16914,158885,ysT116AH0RAvrhgY1lcceDaQox5uWZBY,5Gyp41oLVo7Gg7vF4vpmggWP5MU70QO6,11,16,4,2,3,0,2,0,27,3.857142857142857,2,0.0,9,4,1,3,7,0,1,2,0,17,10,1
16915,158895,qFgmf2eWenRKI7RhiC0TqfbCuuuMuyte,5Gyp41oLVo7Gg7vF4vpmggWP5MU70QO6,8,6,0,3,1,0,3,0,13,1.8571428571428572,1,0.0,3,0,2,1,3,0,1,3,0,6,7,1
16916,158917,i8awVzU04ciSrvVwgkzWUNZdKmI93ibt,5Gyp41oLVo7Gg7vF4vpmggWP5MU70QO6,1,0,0,0,0,0,1,0,1,0.14285714285714285,1,0.0,0,0,0,0,0,0,0,1,0,0,1,1
16917,158930,g9o8p9s62M8GfoXopST7UXpfG3HNkigg,5Gyp41oLVo7Gg7vF4vpmggWP5MU70QO6,10,11,4,0,5,0,2,0,22,3.142857142857143,2,0.0,5,4,0,5,6,0,0,2,0,14,8,1
16918,158935,QVQfEfVeeb06g03UbNMBczsOzsyST5bd,5Gyp41oLVo7Gg7vF4vpmggWP5MU70QO6,6,3,1,0,0,0,5,0,9,1.2857142857142858,1,0.0,0,1,0,0,3,0,0,5,0,1,8,1
16919,158944,mdgoC0NXnOy13qU6nfb5wwenc30x0YGj,5Gyp41oLVo7Gg7vF4vpmggWP5MU70QO6,36,45,17,82,1,0,10,0,155,22.142857142857142,4,0.0,24,17,64,1,21,0,18,10,0,106,49,0
16920,158948,jQGozXgCDEtih8n0QNDjwOxHGubLTjEt,5Gyp41oLVo7Gg7vF4vpmggWP5MU70QO6,21,60,23,7,0,13,11,2,116,16.571428571428573,6,0.0,12,23,6,0,48,13,1,11,2,41,75,1
16921,158954,9WhaE5N2XNUEN1LCjhiVifbADUz45LGY,5Gyp41oLVo7Gg7vF4vpmggWP5MU70QO6,1,0,0,0,0,0,1,0,1,0.14285714285714285,1,0.0,0,0,0,0,0,0,0,1,0,0,1,1
16922,158963,U5AVDljh153RMBqEeJz3uJoBcMeMiYU5,5Gyp41oLVo7Gg7vF4vpmggWP5MU70QO6,5,2,1,0,1,0,3,0,7,1.0,1,0.0,0,1,0,1,2,0,0,3,0,2,5,1
16923,158972,VgqtLD6MfoPupojpPQ1cprPeqz3iEXGs,5Gyp41oLVo7Gg7vF4vpmggWP5MU70QO6,7,3,2,1,0,0,8,0,14,2.0,2,0.0,1,2,1,0,2,0,0,8,0,4,10,1
16924,159000,pFuosLkfepKjMBmx8O2Ec2TV2AOueKhk,5Gyp41oLVo7Gg7vF4vpmggWP5MU70QO6,1,0,0,0,0,0,1,0,1,0.14285714285714285,1,0.0,0,0,0,0,0,0,0,1,0,0,1,1
16925,159023,QuWcIwHbQGr3JemjCJ3sqFodY7dYEjCA,5Gyp41oLVo7Gg7vF4vpmggWP5MU70QO6,9,6,4,0,3,0,4,1,18,2.5714285714285716,1,0.0,0,4,0,3,6,0,0,4,1,7,11,1
16926,159062,KtSnhyXFi6bevwD38L0oZAkqxHVX0Rkl,5Gyp41oLVo7Gg7vF4vpmggWP5MU70QO6,11,7,4,2,2,9,9,6,39,5.571428571428571,1,0.0,1,4,1,2,6,9,1,9,6,8,31,1
16927,159066,5rJzUauE9ryyUD651U4q6g9NlbcQ3byr,5Gyp41oLVo7Gg7vF4vpmggWP5MU70QO6,9,12,5,3,2,0,2,0,24,3.4285714285714284,1,0.0,4,5,2,2,8,0,1,2,0,13,11,1
16928,159067,29lVEZFZAjCojpdMgxYvJN3otXj3PLWe,5Gyp41oLVo7Gg7vF4vpmggWP5MU70QO6,10,19,7,10,1,14,2,0,53,7.571428571428571,1,0.0,7,7,6,1,12,14,4,2,0,21,32,1
16929,159077,d4XXuJnMGWTN1dlwfFP2TLeVQbGEL5nV,5Gyp41oLVo7Gg7vF4vpmggWP5MU70QO6,1,0,0,0,0,0,1,0,1,0.14285714285714285,1,0.0,0,0,0,0,0,0,0,1,0,0,1,1
16930,159095,967P3nBM3EV9TdOVicGWkXEefW3fOsPT,5Gyp41oLVo7Gg7vF4vpmggWP5MU70QO6,1,0,0,0,0,0,1,0,1,0.14285714285714285,1,0.0,0,0,0,0,0,0,0,1,0,0,1,1
16931,159113,Hbftg5rbgdpHCJBfcLzthEBIMS9IG9KN,5Gyp41oLVo7Gg7vF4vpmggWP5MU70QO6,4,3,0,0,0,2,2,0,7,1.0,1,0.0,0,0,0,0,3,2,0,2,0,0,7,1
16932,159129,X3SAXegdLn475KkijByoM5BR9n74pQSC,5Gyp41oLVo7Gg7vF4vpmggWP5MU70QO6,6,4,2,0,1,0,3,1,11,1.5714285714285714,1,0.0,0,2,0,1,4,0,0,3,1,3,8,1
16933,159138,vG3M5JLO0gRotnItxOh8CvNNDagvaG8a,5Gyp41oLVo7Gg7vF4vpmggWP5MU70QO6,6,3,2,0,2,2,1,0,10,1.4285714285714286,1,0.0,0,2,0,2,3,2,0,1,0,4,6,1
16934,159140,3NzpVqr104XA43YTAM8shxzlfnDxKz19,5Gyp41oLVo7Gg7vF4vpmggWP5MU70QO6,4,2,0,0,1,0,4,0,7,1.0,1,0.0,0,0,0,1,2,0,0,4,0,1,6,1
16935,159152,Noa68GvfyEA47DCtuZAZ77yxgZfEUUFu,5Gyp41oLVo7Gg7vF4vpmggWP5MU70QO6,5,3,1,0,1,0,2,0,7,1.0,1,0.0,0,1,0,1,3,0,0,2,0,2,5,1
16936,159173,urVw10ZOKTw1O1zHFnsutUzT6EcZdTal,5Gyp41oLVo7Gg7vF4vpmggWP5MU70QO6,10,14,5,0,4,0,4,0,27,3.857142857142857,1,0.0,3,5,0,4,11,0,0,4,0,12,15,1
16937,159181,QRNZCYPVLmCISEPDuklXJvVOWAcJbKvm,5Gyp41oLVo7Gg7vF4vpmggWP5MU70QO6,1,0,0,0,0,0,1,0,1,0.14285714285714285,1,0.0,0,0,0,0,0,0,0,1,0,0,1,1
16938,159188,QCg3b9fGCe5yEcGGE9opNGK1SexzbVNd,5Gyp41oLVo7Gg7vF4vpmggWP5MU70QO6,4,3,2,0,0,0,2,0,7,1.0,1,0.0,0,2,0,0,3,0,0,2,0,2,5,1
16939,159189,fIJG5tNQwz0BZT33WXfZyUjrmdrvWWdQ,5Gyp41oLVo7Gg7vF4vpmggWP5MU70QO6,1,0,0,0,0,0,1,0,1,0.14285714285714285,1,0.0,0,0,0,0,0,0,0,1,0,0,1,1
16940,159232,xVu6NAX59MOmpApYDfs9WPe7YPPVhsFD,5Gyp41oLVo7Gg7vF4vpmggWP5MU70QO6,7,3,2,0,2,0,2,0,9,1.2857142857142858,1,0.0,0,2,0,2,3,0,0,2,0,4,5,1
16941,159242,YHvNkCivjRHH8EGu64ewmhgCCSxDxlLo,5Gyp41oLVo7Gg7vF4vpmggWP5MU70QO6,1,0,0,0,0,0,1,0,1,0.14285714285714285,1,0.0,0,0,0,0,0,0,0,1,0,0,1,1
16942,159245,2WzexY9OFeSixTrWc6uIGFmWjEnf6pcG,5Gyp41oLVo7Gg7vF4vpmggWP5MU70QO6,7,5,3,0,2,0,5,0,15,2.142857142857143,1,0.0,1,3,0,2,4,0,0,5,0,6,9,1
16943,159246,1ZH3IzOKvwfAvTNs2hBivrhkbs1U4aYk,5Gyp41oLVo7Gg7vF4vpmggWP5MU70QO6,4,5,2,0,0,0,1,0,8,1.1428571428571428,1,0.0,2,2,0,0,3,0,0,1,0,4,4,1
16944,159260,Hivv7BiBIp2lJJMsXCfOLJSRzfV9PZBW,5Gyp41oLVo7Gg7vF4vpmggWP5MU70QO6,9,6,4,0,3,0,4,0,17,2.4285714285714284,1,0.0,1,4,0,3,5,0,0,4,0,8,9,1
16945,159268,wNrMk5m00WQRXqvjv11kHeMVGGYxeJKx,5Gyp41oLVo7Gg7vF4vpmggWP5MU70QO6,6,3,2,0,2,0,1,0,8,1.1428571428571428,1,0.0,0,2,0,2,3,0,0,1,0,4,4,1
16946,159283,ChM4xDWfsNc1gxX7Rr8rWn3LIMVmB93b,5Gyp41oLVo7Gg7vF4vpmggWP5MU70QO6,4,2,1,0,1,0,2,0,6,0.8571428571428571,1,0.0,0,1,0,1,2,0,0,2,0,2,4,1
16947,159299,5wKzDgoaRUDR7JnVq8Rlsqj2aBlh0arD,5Gyp41oLVo7Gg7vF4vpmggWP5MU70QO6,1,0,0,0,0,0,1,0,1,0.14285714285714285,1,0.0,0,0,0,0,0,0,0,1,0,0,1,1
16948,159307,nYSFDE8RCbcZhD46fRSvPHUvA1ahfupi,5Gyp41oLVo7Gg7vF4vpmggWP5MU70QO6,16,27,16,0,7,0,7,0,57,8.142857142857142,4,0.0,0,16,0,7,27,0,0,7,0,23,34,1
16949,159310,2hSq1bkVvTSVSDFgRzwQhvmkM4fwiFNB,5Gyp41oLVo7Gg7vF4vpmggWP5MU70QO6,5,3,1,0,1,0,3,0,8,1.1428571428571428,1,0.0,0,1,0,1,3,0,0,3,0,2,6,1
16950,159313,2LtYZOjxB2pNkaXT76uGWds8mjls10j1,5Gyp41oLVo7Gg7vF4vpmggWP5MU70QO6,9,7,3,2,2,0,2,0,16,2.2857142857142856,2,0.0,3,3,1,2,4,0,1,2,0,9,7,1
16951,159336,cylVpn6BHNf8kPweB7o4j0HSX2fVNwi5,5Gyp41oLVo7Gg7vF4vpmggWP5MU70QO6,1,0,0,0,0,0,1,0,1,0.14285714285714285,1,0.0,0,0,0,0,0,0,0,1,0,0,1,1
16952,159362,vhOo9Hucfrf0SGFbToD9FkXxIs8rxeEc,5Gyp41oLVo7Gg7vF4vpmggWP5MU70QO6,5,2,1,0,1,0,2,0,6,0.8571428571428571,1,0.0,0,1,0,1,2,0,0,2,0,2,4,1
16953,159363,DopiUmKHL5PYH4L9s4SOnc9o6UExYgCw,5Gyp41oLVo7Gg7vF4vpmggWP5MU70QO6,5,2,1,0,1,0,3,0,7,1.0,1,0.0,0,1,0,1,2,0,0,3,0,2,5,1
16954,159389,eJj5JseFYNst7BY37oSEoHmO6OuUF5RV,5Gyp41oLVo7Gg7vF4vpmggWP5MU70QO6,9,11,5,0,3,0,1,0,20,2.857142857142857,1,0.0,0,5,0,3,11,0,0,1,0,8,12,1
16955,159430,PyeKdLyIaTDrn5HSeSXlpLU3ndq8YFOb,5Gyp41oLVo7Gg7vF4vpmggWP5MU70QO6,10,8,5,0,3,0,2,0,18,2.5714285714285716,1,0.0,2,5,0,3,6,0,0,2,0,10,8,1
16956,159467,TYR1iv9nm6adrwA9qvDB8QeOl5MRonVb,5Gyp41oLVo7Gg7vF4vpmggWP5MU70QO6,3,3,1,0,0,0,1,0,5,0.7142857142857143,1,0.0,0,1,0,0,3,0,0,1,0,1,4,1
16957,159472,HiGZLdeZRYtIjPAzubAbGiFih6ux0sb7,5Gyp41oLVo7Gg7vF4vpmggWP5MU70QO6,6,5,2,0,2,0,1,0,10,1.4285714285714286,1,0.0,0,2,0,2,5,0,0,1,0,4,6,1
16958,159502,B43CklOat00y9Wg2Il14gb5uOzGmEKhV,5Gyp41oLVo7Gg7vF4vpmggWP5MU70QO6,8,5,3,0,2,0,2,0,12,1.7142857142857142,1,0.0,0,3,0,2,5,0,0,2,0,5,7,1
16959,159520,jyaiZRchqKabVkvpbZb23UrKdvMdU3nb,5Gyp41oLVo7Gg7vF4vpmggWP5MU70QO6,3,3,1,0,0,0,1,0,5,0.7142857142857143,1,0.0,0,1,0,0,3,0,0,1,0,1,4,1
16960,159525,unG4C0Ae6YJ39WbV1xtmGVvK7bPgQLG7,5Gyp41oLVo7Gg7vF4vpmggWP5MU70QO6,4,2,1,0,1,0,2,0,6,0.8571428571428571,1,0.0,0,1,0,1,2,0,0,2,0,2,4,0
16961,159541,zQuoYbxMGLzlCOnlKPSBbmIjoqCIUWrm,5Gyp41oLVo7Gg7vF4vpmggWP5MU70QO6,11,5,4,0,3,3,5,0,20,2.857142857142857,1,0.0,0,4,0,3,5,3,0,5,0,7,13,1
16962,159576,Zir9lHWQ9bVexbJ0KzuWALSFFwHLNkKC,5Gyp41oLVo7Gg7vF4vpmggWP5MU70QO6,9,8,4,0,4,0,4,0,20,2.857142857142857,2,0.0,2,4,0,4,6,0,0,4,0,10,10,1
16963,159612,w3155Vkw5wpuKOK6WeWXLmPGCsMeqo9R,5Gyp41oLVo7Gg7vF4vpmggWP5MU70QO6,9,6,2,0,5,1,4,1,19,2.7142857142857144,1,0.0,3,2,0,5,3,1,0,4,1,10,9,1
16964,159632,ct83Qv94t9TQPl3Un0msY2hQIEvMuagv,5Gyp41oLVo7Gg7vF4vpmggWP5MU70QO6,8,6,4,0,2,0,4,0,16,2.2857142857142856,1,0.0,1,4,0,2,5,0,0,4,0,7,9,1
16965,159639,15WVuDgxppV6WeAB10xXsEAXeOmHb2uY,5Gyp41oLVo7Gg7vF4vpmggWP5MU70QO6,9,4,3,0,2,0,5,0,14,2.0,1,0.0,0,3,0,2,4,0,0,5,0,5,9,1
16966,159641,cfgpXsy2XrwK0vXt98s9wG0gOlB9vQtp,5Gyp41oLVo7Gg7vF4vpmggWP5MU70QO6,7,14,4,0,2,0,1,0,21,3.0,1,0.0,0,4,0,2,14,0,0,1,0,6,15,1
16967,159670,yTR25TcJUEADShe175bgEmLpP7tfblHz,5Gyp41oLVo7Gg7vF4vpmggWP5MU70QO6,1,0,0,0,0,0,1,0,1,0.14285714285714285,1,0.0,0,0,0,0,0,0,0,1,0,0,1,1
16968,159672,VDLlgOqW7FFpT6uHqFXXlnnZR1JOz0x8,5Gyp41oLVo7Gg7vF4vpmggWP5MU70QO6,7,5,2,0,2,0,2,0,11,1.5714285714285714,1,0.0,0,2,0,2,5,0,0,2,0,4,7,1
16969,159679,y33eMbXY1VlbmqKcmxbgktxjSAbFBdW9,5Gyp41oLVo7Gg7vF4vpmggWP5MU70QO6,4,3,1,0,2,0,3,0,9,1.2857142857142858,1,0.0,0,1,0,2,3,0,0,3,0,3,6,1
16970,159687,yjfB9txE0BWOZJoQv13P8CrvW2TkHsmS,5Gyp41oLVo7Gg7vF4vpmggWP5MU70QO6,7,7,4,0,2,0,7,0,20,2.857142857142857,3,0.0,0,4,0,2,7,0,0,7,0,6,14,1
16971,159688,AzzlZTan85NtpWN7Tw6er163M4eAWMcs,5Gyp41oLVo7Gg7vF4vpmggWP5MU70QO6,1,0,0,0,0,0,1,0,1,0.14285714285714285,1,0.0,0,0,0,0,0,0,0,1,0,0,1,1
16972,159695,ett4RSqrxzIV8EYuhd1Xe4BYirxYbVDx,5Gyp41oLVo7Gg7vF4vpmggWP5MU70QO6,7,4,3,0,3,2,2,0,14,2.0,1,0.0,0,3,0,3,4,2,0,2,0,6,8,1
16973,159708,u4BkBK8HWmjRZPrK4zcxe58fHdGGfFNp,5Gyp41oLVo7Gg7vF4vpmggWP5MU70QO6,7,3,2,0,2,0,2,0,9,1.2857142857142858,1,0.0,0,2,0,2,3,0,0,2,0,4,5,1
16974,159716,c89GCI4T9UcMbWU1kL7agsdCDAa4AkWS,5Gyp41oLVo7Gg7vF4vpmggWP5MU70QO6,8,5,3,0,2,0,3,0,13,1.8571428571428572,1,0.0,0,3,0,2,5,0,0,3,0,5,8,1
16975,159719,HBFgStpuQalhsLiCWI2Sn4sRFT5nvY4k,5Gyp41oLVo7Gg7vF4vpmggWP5MU70QO6,1,0,0,0,0,0,1,0,1,0.14285714285714285,1,0.0,0,0,0,0,0,0,0,1,0,0,1,1
16976,159722,TSstpRXnNkTPjLUvEsYaaDQsqpwgAdqr,5Gyp41oLVo7Gg7vF4vpmggWP5MU70QO6,8,2,1,0,1,1,5,1,11,1.5714285714285714,1,0.0,0,1,0,1,2,1,0,5,1,2,9,1
16977,159730,kuvvE2inYNYJSuXFQV1lIziKGSL6TqjZ,5Gyp41oLVo7Gg7vF4vpmggWP5MU70QO6,1,0,0,0,0,0,1,0,1,0.14285714285714285,1,0.0,0,0,0,0,0,0,0,1,0,0,1,1
16978,159740,7iVjX5slboUIidbmRRQjBPOKlP8TGLsY,5Gyp41oLVo7Gg7vF4vpmggWP5MU70QO6,1,0,0,0,0,0,1,0,1,0.14285714285714285,1,0.0,0,0,0,0,0,0,0,1,0,0,1,1
16979,159749,IqGyAMGyf3a5Zz7YiOGhpP1rd6TlLb1Z,5Gyp41oLVo7Gg7vF4vpmggWP5MU70QO6,1,0,0,0,0,0,1,0,1,0.14285714285714285,1,0.0,0,0,0,0,0,0,0,1,0,0,1,1
16980,159763,X033fyIoYJw0V0oiVitDJiomc3Zn6SXp,5Gyp41oLVo7Gg7vF4vpmggWP5MU70QO6,1,0,0,0,0,0,1,0,1,0.14285714285714285,1,0.0,0,0,0,0,0,0,0,1,0,0,1,1
16981,159806,zcTiccZJd2MTPFUSrtaiC1AfTUMC6Noi,5Gyp41oLVo7Gg7vF4vpmggWP5MU70QO6,1,0,0,0,0,0,1,0,1,0.14285714285714285,1,0.0,0,0,0,0,0,0,0,1,0,0,1,1
16982,159819,VHC0cJ6sdoxMeOTeT3TNsv8Qapi5L5BP,5Gyp41oLVo7Gg7vF4vpmggWP5MU70QO6,11,14,5,10,3,0,3,0,35,5.0,2,0.0,4,5,6,3,10,0,4,3,0,18,17,1
16983,159830,Qn4oQ1lJoD4ucx7ZxtRp3oFmTZaTCpvg,5Gyp41oLVo7Gg7vF4vpmggWP5MU70QO6,6,9,0,0,0,0,3,0,12,1.7142857142857142,1,0.0,0,0,0,0,9,0,0,3,0,0,12,1
16984,159832,auRdcj2vNiPfP2I5Om077ELvYeYb3Zl1,5Gyp41oLVo7Gg7vF4vpmggWP5MU70QO6,10,5,4,0,2,1,5,1,18,2.5714285714285716,2,0.0,0,4,0,2,5,1,0,5,1,6,12,1
16985,159842,QnAJxZKWmT5HVK2wsvkPfuBWQdcX78Rd,5Gyp41oLVo7Gg7vF4vpmggWP5MU70QO6,1,0,0,0,0,0,1,0,1,0.14285714285714285,1,0.0,0,0,0,0,0,0,0,1,0,0,1,0
16986,159867,jVVIXc6QhfFVc9Q2rtxQWruXQ4o0HCjv,5Gyp41oLVo7Gg7vF4vpmggWP5MU70QO6,1,0,0,0,0,0,1,0,1,0.14285714285714285,1,0.0,0,0,0,0,0,0,0,1,0,0,1,1
16987,159871,Uh4whLcptRuZuhdtjFruuYJY4YmOeYlV,5Gyp41oLVo7Gg7vF4vpmggWP5MU70QO6,14,19,8,4,7,0,5,0,43,6.142857142857143,3,0.0,7,8,3,7,12,0,1,5,0,25,18,1
16988,159874,bPD0WmDhx9OSgfXrv45xct1pk2tKsQXo,5Gyp41oLVo7Gg7vF4vpmggWP5MU70QO6,15,39,14,8,2,0,4,0,67,9.571428571428571,2,0.0,7,14,5,2,32,0,3,4,0,28,39,1
16989,159877,S6bRDWt0mg6bcMdrXi5pSSeTKgbfILwL,5Gyp41oLVo7Gg7vF4vpmggWP5MU70QO6,7,2,1,0,1,2,4,1,11,1.5714285714285714,1,0.0,0,1,0,1,2,2,0,4,1,2,9,1
16990,159880,An4Cs2oUOz8lYcIplHFLdygweoh5kMIV,5Gyp41oLVo7Gg7vF4vpmggWP5MU70QO6,15,21,9,0,12,32,4,0,78,11.142857142857142,1,0.0,10,9,0,12,11,32,0,4,0,31,47,1
16991,159907,vn6QiPL2hNfbQVlbP4Lnj04J2ZQusfUk,5Gyp41oLVo7Gg7vF4vpmggWP5MU70QO6,1,0,0,0,0,0,1,0,1,0.14285714285714285,1,0.0,0,0,0,0,0,0,0,1,0,0,1,1
16992,159925,h6oAjCi4h1GDTBi9n1s3EpArbdJGicBR,5Gyp41oLVo7Gg7vF4vpmggWP5MU70QO6,17,24,10,20,3,1,4,0,62,8.857142857142858,2,0.0,9,10,12,3,15,1,8,4,0,34,28,1
16993,159927,xWhdBnWFeXY9jZr3thhJIHBv8kNZjPAL,5Gyp41oLVo7Gg7vF4vpmggWP5MU70QO6,6,1,1,0,1,0,5,0,8,1.1428571428571428,1,0.0,0,1,0,1,1,0,0,5,0,2,6,1
16994,159944,GYPXhcvZqACuBKl71xTfXCfLOrfVfM3E,5Gyp41oLVo7Gg7vF4vpmggWP5MU70QO6,12,12,7,4,4,7,3,0,37,5.285714285714286,1,0.0,1,7,3,4,11,7,1,3,0,15,22,1
16995,159946,M4qxCm572dyAklYyW6rlwVA2xGuuy2h9,5Gyp41oLVo7Gg7vF4vpmggWP5MU70QO6,7,5,3,0,2,0,1,0,11,1.5714285714285714,1,0.0,0,3,0,2,5,0,0,1,0,5,6,1
16996,159998,1LSeBBzhGFTI9Y8bdsnswnbTVi1ldS97,5Gyp41oLVo7Gg7vF4vpmggWP5MU70QO6,6,3,2,0,2,1,1,0,9,1.2857142857142858,1,0.0,0,2,0,2,3,1,0,1,0,4,5,1
16997,160000,xZ3oCC931fdVSB0J29saeHfF5mIZlue8,5Gyp41oLVo7Gg7vF4vpmggWP5MU70QO6,5,2,1,0,1,0,2,0,6,0.8571428571428571,1,0.0,0,1,0,1,2,0,0,2,0,2,4,1
16998,160028,WmED4bMmNp41bkJ3snn9To3WokKLctdK,5Gyp41oLVo7Gg7vF4vpmggWP5MU70QO6,8,7,3,0,3,0,3,0,16,2.2857142857142856,1,0.0,3,3,0,3,4,0,0,3,0,9,7,1
16999,160030,1YrURc2g9Q9Bah4F5ddMZdbHdZCZkgqC,5Gyp41oLVo7Gg7vF4vpmggWP5MU70QO6,7,4,3,0,3,0,2,0,12,1.7142857142857142,1,0.0,0,3,0,3,4,0,0,2,0,6,6,1
17000,160033,dXqdfo9M4XFoTTNnKOGmnhmMz5oAXnEP,5Gyp41oLVo7Gg7vF4vpmggWP5MU70QO6,9,6,3,3,2,0,1,0,15,2.142857142857143,1,0.0,2,3,2,2,4,0,1,1,0,9,6,1
17001,160040,wcKFpvP8o06tSEqk6ISQICB28mahw0xB,5Gyp41oLVo7Gg7vF4vpmggWP5MU70QO6,7,5,2,0,1,0,2,1,11,1.5714285714285714,1,0.0,0,2,0,1,5,0,0,2,1,3,8,1
17002,160080,6itHejzsvHKM0bxFx1r8d8uHB1MGvhbh,5Gyp41oLVo7Gg7vF4vpmggWP5MU70QO6,9,7,1,3,2,0,2,0,15,2.142857142857143,1,0.0,3,1,2,2,4,0,1,2,0,8,7,1
17003,160084,xvBPiGwgzZvXW90yqsEGOxNtxynylEmQ,5Gyp41oLVo7Gg7vF4vpmggWP5MU70QO6,3,0,0,0,0,1,3,1,5,0.7142857142857143,1,0.0,0,0,0,0,0,1,0,3,1,0,5,1
17004,160085,bGVVh5mMYkn1gHW6CnpRuYzXwIcX6sC6,5Gyp41oLVo7Gg7vF4vpmggWP5MU70QO6,5,3,1,0,1,0,1,0,6,0.8571428571428571,1,0.0,0,1,0,1,3,0,0,1,0,2,4,1
17005,160094,WFLWEfQrQsuFMQB4h1DfinKxHOxaJgRw,5Gyp41oLVo7Gg7vF4vpmggWP5MU70QO6,8,5,2,0,1,2,4,0,14,2.0,1,0.0,0,2,0,1,5,2,0,4,0,3,11,0
17006,160099,Jqa9RxDwsQCM63qe4gzUBufHE7ckfXFv,5Gyp41oLVo7Gg7vF4vpmggWP5MU70QO6,17,37,8,11,2,0,7,0,65,9.285714285714286,2,0.0,9,8,8,2,28,0,3,7,0,27,38,1
17007,160119,aeg75UgFRA8ym4ySf49NGJnbhXGbV1bx,5Gyp41oLVo7Gg7vF4vpmggWP5MU70QO6,12,11,7,0,5,0,16,0,39,5.571428571428571,1,0.0,4,7,0,5,7,0,0,16,0,16,23,1
17008,160126,bR9OXRJ2475h6p8Gd2lf8xedbdOrDfAy,5Gyp41oLVo7Gg7vF4vpmggWP5MU70QO6,15,16,8,0,9,0,5,0,38,5.428571428571429,2,0.0,6,8,0,9,10,0,0,5,0,23,15,1
17009,160134,s2DHezS6V0fqgsBvlp59eRuwZhHpM8Vx,5Gyp41oLVo7Gg7vF4vpmggWP5MU70QO6,1,0,0,0,0,0,1,0,1,0.14285714285714285,1,0.0,0,0,0,0,0,0,0,1,0,0,1,1
17010,160142,peutEeFLpwHZll4NroVaoI7vEprCs9oo,5Gyp41oLVo7Gg7vF4vpmggWP5MU70QO6,13,9,5,2,3,4,8,2,33,4.714285714285714,1,0.0,1,5,1,3,8,4,1,8,2,10,23,1
17011,160144,lPlWLKHahAxwmGJE6cQVHruqHSF8nu1m,5Gyp41oLVo7Gg7vF4vpmggWP5MU70QO6,5,0,0,0,0,1,5,1,7,1.0,1,0.0,0,0,0,0,0,1,0,5,1,0,7,1
17012,160160,Glw0sdVKar4BTl3SUj2bFb23uoyJwJeN,5Gyp41oLVo7Gg7vF4vpmggWP5MU70QO6,4,2,1,0,1,0,1,0,5,0.7142857142857143,1,0.0,0,1,0,1,2,0,0,1,0,2,3,1
17013,160166,JC0KMNlyTwpwgjaVWIKSR5kWCFTPgBul,5Gyp41oLVo7Gg7vF4vpmggWP5MU70QO6,8,8,6,0,4,0,2,0,20,2.857142857142857,1,0.0,0,6,0,4,8,0,0,2,0,10,10,0
17014,160183,WCBxImuXCQhe4JCGgmUbhM2fHJqNW9fo,5Gyp41oLVo7Gg7vF4vpmggWP5MU70QO6,6,5,2,0,2,0,1,0,10,1.4285714285714286,1,0.0,0,2,0,2,5,0,0,1,0,4,6,1
17015,160221,j6j4FSCwiwqQXzEZJqluv2QvpitGuWOQ,5Gyp41oLVo7Gg7vF4vpmggWP5MU70QO6,2,0,0,0,0,0,2,0,2,0.2857142857142857,1,0.0,0,0,0,0,0,0,0,2,0,0,2,1
17016,160227,iakVJOwUlF2W3X06c03NXVlYoccvTl6G,5Gyp41oLVo7Gg7vF4vpmggWP5MU70QO6,13,17,8,5,2,1,11,0,44,6.285714285714286,2,0.0,3,8,3,2,14,1,2,11,0,16,28,1
17017,160254,OpC5sap2tAysVI4r8GHKcirTisziT9Sd,5Gyp41oLVo7Gg7vF4vpmggWP5MU70QO6,1,0,0,0,0,0,1,0,1,0.14285714285714285,1,0.0,0,0,0,0,0,0,0,1,0,0,1,1
17018,160256,yn2Ij88V2wSgGFNHE75cImAmp292E61N,5Gyp41oLVo7Gg7vF4vpmggWP5MU70QO6,8,10,4,0,3,0,1,0,18,2.5714285714285716,1,0.0,5,4,0,3,5,0,0,1,0,12,6,1
17019,160265,3liXI2TaHzRGVElpagKe3CCayjM1hCfU,5Gyp41oLVo7Gg7vF4vpmggWP5MU70QO6,1,0,0,0,0,0,1,0,1,0.14285714285714285,1,0.0,0,0,0,0,0,0,0,1,0,0,1,1
17020,160275,cMkZHhqT3aqaoU0tTxCIcH41Ep4BUBXX,5Gyp41oLVo7Gg7vF4vpmggWP5MU70QO6,11,8,5,0,3,5,9,1,31,4.428571428571429,1,0.0,0,5,0,3,8,5,0,9,1,8,23,1
17021,160284,yXIAbgjR7S4042oicRyG8kfTX0pG8yI5,5Gyp41oLVo7Gg7vF4vpmggWP5MU70QO6,6,7,0,0,0,0,2,0,9,1.2857142857142858,1,0.0,1,0,0,0,6,0,0,2,0,1,8,1
17022,160287,DlOlCACdDW2AnBt69t6IZa6KA7zxGy5D,5Gyp41oLVo7Gg7vF4vpmggWP5MU70QO6,1,0,0,0,0,0,1,0,1,0.14285714285714285,1,0.0,0,0,0,0,0,0,0,1,0,0,1,1
17023,160291,9vCHgKuY10o5HPF3YCSUYO4TU52wqZHL,5Gyp41oLVo7Gg7vF4vpmggWP5MU70QO6,7,1,0,0,1,0,9,2,13,1.8571428571428572,2,0.0,0,0,0,1,1,0,0,9,2,1,12,0
17024,160295,C8zDhaG0vPsQegBtS55u3JZHiYuueFnE,5Gyp41oLVo7Gg7vF4vpmggWP5MU70QO6,7,4,3,0,3,0,2,0,12,1.7142857142857142,1,0.0,0,3,0,3,4,0,0,2,0,6,6,1
17025,160311,0dBn4alo7QBTd62VD5XO0yNMbQ5QN2OQ,7GRhBDsirIGkRZBtSMEzNTyDr2JQm4xx,8,10,7,0,0,0,5,0,22,3.142857142857143,2,0.0,0,7,0,0,10,0,0,5,0,7,15,1
17026,160314,bYyTnDMNQRdh2PC2RrU7V8pT6TWKO7Eq,5X6FeZozNMgE2VRi3MJYjkkFK8SETtu2,7,5,2,0,3,0,2,0,12,1.7142857142857142,1,0.0,2,2,0,3,3,0,0,2,0,7,5,1
17027,160315,bwArOOJKwGOF13mHU5aKU9fUr71McJvH,7GRhBDsirIGkRZBtSMEzNTyDr2JQm4xx,5,2,1,0,1,0,2,0,6,0.8571428571428571,1,0.0,0,1,0,1,2,0,0,2,0,2,4,1
17028,160320,DJenb7iikHj085JzrOjjcdsjyfa241f7,7GRhBDsirIGkRZBtSMEzNTyDr2JQm4xx,24,21,14,0,12,0,2,0,49,7.0,3,0.0,5,14,0,12,16,0,0,2,0,31,18,1
17029,160329,vXDFPMCmOrOiDmbI0WjUFcVHHrjWOFJG,5X6FeZozNMgE2VRi3MJYjkkFK8SETtu2,1,0,0,0,0,0,2,0,2,0.2857142857142857,1,0.0,0,0,0,0,0,0,0,2,0,0,2,1
17030,160344,HIaaOq9UrLvo3UC4FIJStVsYhdTvdkJ9,5X6FeZozNMgE2VRi3MJYjkkFK8SETtu2,1,0,0,0,0,0,1,0,1,0.14285714285714285,1,0.0,0,0,0,0,0,0,0,1,0,0,1,1
17031,160384,k0UdEkfpJlSzidBudzci9vFF4yrsXxgQ,7GRhBDsirIGkRZBtSMEzNTyDr2JQm4xx,1,0,0,0,0,0,1,0,1,0.14285714285714285,1,0.0,0,0,0,0,0,0,0,1,0,0,1,0
17032,160389,4TYIBYUjGx5Az0xYJI94tEHK7klSyatr,7GRhBDsirIGkRZBtSMEzNTyDr2JQm4xx,40,50,16,28,23,0,3,0,120,17.142857142857142,1,0.0,31,16,19,23,19,0,9,3,0,89,31,1
17033,160390,8QWoRkYbUDz1r9tDz8JHpEYuquw4PH6N,5X6FeZozNMgE2VRi3MJYjkkFK8SETtu2,5,2,1,0,1,0,2,0,6,0.8571428571428571,1,0.0,0,1,0,1,2,0,0,2,0,2,4,1
17034,160396,zO6yqNtTJB4M08etRFNDLB7i6krzXD0l,7GRhBDsirIGkRZBtSMEzNTyDr2JQm4xx,3,0,0,0,0,0,5,0,5,0.7142857142857143,1,0.0,0,0,0,0,0,0,0,5,0,0,5,1
17035,160398,WAC7RGZ1uYeT92igfYiLgTnHWPEtN2IA,5X6FeZozNMgE2VRi3MJYjkkFK8SETtu2,5,2,1,0,1,0,3,0,7,1.0,2,0.0,0,1,0,1,2,0,0,3,0,2,5,1
17036,160401,rPClLoAvWie6mQgFe052QTDjrbW05Z38,7GRhBDsirIGkRZBtSMEzNTyDr2JQm4xx,9,9,6,0,4,7,4,0,30,4.285714285714286,1,0.0,1,6,0,4,8,7,0,4,0,11,19,1
17037,160411,5D8TCJus8jJePlvJzQ7Sr3SBFEIyS2MR,7GRhBDsirIGkRZBtSMEzNTyDr2JQm4xx,2,0,0,0,0,0,2,0,2,0.2857142857142857,1,0.0,0,0,0,0,0,0,0,2,0,0,2,1
17038,160432,uPwo7A29gDp2eZiRxT2ZvOEZhimArTNp,7GRhBDsirIGkRZBtSMEzNTyDr2JQm4xx,2,0,0,0,0,0,2,0,2,0.2857142857142857,1,0.0,0,0,0,0,0,0,0,2,0,0,2,1
17039,160442,YkNwKcv9lSDkBPqsMb0WziNidETs7ep9,7GRhBDsirIGkRZBtSMEzNTyDr2JQm4xx,2,0,0,0,0,0,2,0,2,0.2857142857142857,1,0.0,0,0,0,0,0,0,0,2,0,0,2,1
17040,160444,KBuOxjKuU610PCeSJDQZDprlbjuZT4li,7GRhBDsirIGkRZBtSMEzNTyDr2JQm4xx,21,36,14,8,11,0,3,0,72,10.285714285714286,1,0.0,19,14,4,11,17,0,4,3,0,48,24,1
17041,160462,dCmeuLqbJmbADgjGxqkGRl3NTRmieZ1v,5X6FeZozNMgE2VRi3MJYjkkFK8SETtu2,30,36,14,21,19,0,2,0,92,13.142857142857142,1,0.0,21,14,20,19,15,0,1,2,0,74,18,1
17042,160471,PBSAJnWnXGHZ7IVhIZxN6aQTQb0G2vO7,7GRhBDsirIGkRZBtSMEzNTyDr2JQm4xx,1,0,0,0,0,0,1,0,1,0.14285714285714285,1,0.0,0,0,0,0,0,0,0,1,0,0,1,1
17043,160476,hD4u7K20MkeesFqmBh9Esq7QUUZdGCv9,7GRhBDsirIGkRZBtSMEzNTyDr2JQm4xx,3,0,0,0,0,0,4,0,4,0.5714285714285714,2,0.0,0,0,0,0,0,0,0,4,0,0,4,1
17044,160480,oYErMzphr0xt2i2tKTG42QELMDaumLkL,7GRhBDsirIGkRZBtSMEzNTyDr2JQm4xx,6,7,3,0,1,0,2,0,13,1.8571428571428572,1,0.0,1,3,0,1,6,0,0,2,0,5,8,1
17045,160485,ITkxDxE80MnM3R1P6Tny4qeXU1QIqBHa,5X6FeZozNMgE2VRi3MJYjkkFK8SETtu2,1,0,0,0,0,0,1,0,1,0.14285714285714285,1,0.0,0,0,0,0,0,0,0,1,0,0,1,1
17046,160486,GGB9bCfhLsvvSPzNJWyTOJucbjEzgrET,7GRhBDsirIGkRZBtSMEzNTyDr2JQm4xx,1,0,0,0,0,0,1,0,1,0.14285714285714285,1,0.0,0,0,0,0,0,0,0,1,0,0,1,1
17047,160490,CCgnS551kIRskNkrEIX6IfculoW0n8YO,5X6FeZozNMgE2VRi3MJYjkkFK8SETtu2,1,0,0,0,0,0,2,0,2,0.2857142857142857,2,0.0,0,0,0,0,0,0,0,2,0,0,2,1
17048,160496,jgJwseE0WxsNWZcNzhtAucTIUehcAJZy,5X6FeZozNMgE2VRi3MJYjkkFK8SETtu2,5,4,1,0,0,0,3,0,8,1.1428571428571428,1,0.0,0,1,0,0,4,0,0,3,0,1,7,1
17049,160500,KOlXIysOb8VF04tCZjd1kg0II2kb2mYu,7GRhBDsirIGkRZBtSMEzNTyDr2JQm4xx,1,0,0,0,0,0,1,0,1,0.14285714285714285,1,0.0,0,0,0,0,0,0,0,1,0,0,1,1
17050,160506,VJsbRtMXxy8aqyccEZDzV7pPAGBosBu1,7GRhBDsirIGkRZBtSMEzNTyDr2JQm4xx,1,0,0,0,0,0,1,0,1,0.14285714285714285,1,0.0,0,0,0,0,0,0,0,1,0,0,1,1
17051,160508,RoGFusJTdgK8k3Zd6iMFweLZIxW5k7pS,7GRhBDsirIGkRZBtSMEzNTyDr2JQm4xx,6,6,4,0,1,0,4,0,15,2.142857142857143,1,0.0,0,4,0,1,6,0,0,4,0,5,10,1
17052,160518,PRY10k18YynTwKp6d8DErN4q5S6hJbG0,7GRhBDsirIGkRZBtSMEzNTyDr2JQm4xx,3,2,0,0,0,0,1,0,3,0.42857142857142855,1,0.0,0,0,0,0,2,0,0,1,0,0,3,1
17053,160528,56J91Yo5ifJy5MJXjIh6Ft8DpaRkdQsg,7GRhBDsirIGkRZBtSMEzNTyDr2JQm4xx,1,0,0,0,0,0,1,0,1,0.14285714285714285,1,0.0,0,0,0,0,0,0,0,1,0,0,1,1
17054,160533,93Zm4nrRg1wL0XUZJzZZ7TfOboLDGoxJ,7GRhBDsirIGkRZBtSMEzNTyDr2JQm4xx,5,0,0,0,0,0,4,2,6,0.8571428571428571,1,0.0,0,0,0,0,0,0,0,4,2,0,6,1
17055,160536,jV3IFI6hAwcYex0pw7Nq9u1gcioXGewT,7GRhBDsirIGkRZBtSMEzNTyDr2JQm4xx,1,0,0,0,0,0,1,0,1,0.14285714285714285,1,0.0,0,0,0,0,0,0,0,1,0,0,1,1
17056,160548,eBSvxL0R8Q3voWeT1zBNYoMs227j8TN1,3VkHkmOtom3jM2wCu94xgzzu1d6Dn7or,16,24,10,23,0,2,3,0,62,8.857142857142858,2,0.0,10,10,23,0,14,2,0,3,0,43,19,1
17057,160550,wdxdPEvE36xfIB9lBB6iyJ74SRM2Pv8t,3VkHkmOtom3jM2wCu94xgzzu1d6Dn7or,4,9,3,0,3,4,1,0,20,2.857142857142857,1,0.0,5,3,0,3,4,4,0,1,0,11,9,1
17058,160554,8RsUWVhT21wU3hqZiuarsy4LdzVsaOkQ,3VkHkmOtom3jM2wCu94xgzzu1d6Dn7or,1,0,0,0,0,0,2,0,2,0.2857142857142857,1,0.0,0,0,0,0,0,0,0,2,0,0,2,1
17059,160555,Ta0cFZTRj95kjDl5GmHXWM25lW5JIkJf,3VkHkmOtom3jM2wCu94xgzzu1d6Dn7or,9,17,6,5,8,3,1,0,40,5.714285714285714,1,0.0,10,6,4,8,7,3,1,1,0,28,12,1
17060,160556,DY2up4tKnGeREyFMKlTR0yPpnZHUGeIJ,3VkHkmOtom3jM2wCu94xgzzu1d6Dn7or,1,0,0,0,0,0,2,0,2,0.2857142857142857,1,0.0,0,0,0,0,0,0,0,2,0,0,2,1
17061,160558,JdJ1SwT93OWgPbpS5GdJzD3RLASaE4SR,3VkHkmOtom3jM2wCu94xgzzu1d6Dn7or,1,0,0,0,0,0,1,0,1,0.14285714285714285,1,0.0,0,0,0,0,0,0,0,1,0,0,1,1
17062,160563,twGKEN7pLmrCddVKPrE08enGUkhaSMrX,3VkHkmOtom3jM2wCu94xgzzu1d6Dn7or,37,70,32,32,27,1,11,1,174,24.857142857142858,3,0.0,21,32,27,27,49,1,5,11,1,107,67,1
17063,160564,vI8IuaWn8GFY4xjhYpIM4bR2WseIJjMM,3VkHkmOtom3jM2wCu94xgzzu1d6Dn7or,5,2,1,0,1,0,2,0,6,0.8571428571428571,1,0.0,0,1,0,1,2,0,0,2,0,2,4,1
17064,160568,AbKYfqEQXjUR8gnQxcdgXaNxS2Ot8STL,3VkHkmOtom3jM2wCu94xgzzu1d6Dn7or,7,9,1,0,1,4,3,0,18,2.5714285714285716,1,0.0,0,1,0,1,9,4,0,3,0,2,16,1
17065,160569,su9V3cj7GzV7BMJTODtLyGaeGX7THzN8,3VkHkmOtom3jM2wCu94xgzzu1d6Dn7or,2,0,0,0,0,0,2,0,2,0.2857142857142857,1,0.0,0,0,0,0,0,0,0,2,0,0,2,1
17066,160575,nnLgUswwSxDZI0WAANeV7kiVkBqo2rYn,3VkHkmOtom3jM2wCu94xgzzu1d6Dn7or,17,48,17,20,17,16,10,0,128,18.285714285714285,4,0.0,26,17,17,17,22,16,3,10,0,77,51,1
17067,160578,5hFoF7Ey3CgzVLMi9mWcRI4lYZT69VON,3VkHkmOtom3jM2wCu94xgzzu1d6Dn7or,5,2,1,0,1,0,3,0,7,1.0,1,0.0,0,1,0,1,2,0,0,3,0,2,5,1
17068,160580,vyPFUWYot0zlmxw218nG9m2URrYdTITu,3VkHkmOtom3jM2wCu94xgzzu1d6Dn7or,1,0,0,0,0,0,1,0,1,0.14285714285714285,1,0.0,0,0,0,0,0,0,0,1,0,0,1,1
17069,160582,4zFYvh8Dra1dWDjTOlCuluSkB8UaHBGB,3VkHkmOtom3jM2wCu94xgzzu1d6Dn7or,14,17,10,0,8,1,4,1,41,5.857142857142857,1,0.0,3,10,0,8,14,1,0,4,1,21,20,1
17070,160590,umlPagtObd1nFSATZImSkHZJqZul544q,3VkHkmOtom3jM2wCu94xgzzu1d6Dn7or,11,14,7,0,4,0,6,0,31,4.428571428571429,3,0.0,0,7,0,4,14,0,0,6,0,11,20,1
17071,160591,Ha7c5VaWgAphltuYxnvX199Tjc0NFLTm,3VkHkmOtom3jM2wCu94xgzzu1d6Dn7or,2,0,0,0,0,0,2,0,2,0.2857142857142857,1,0.0,0,0,0,0,0,0,0,2,0,0,2,1
17072,160592,DaotIZvqRq8CbS1IYHQYwRpTWvK0ecmj,3VkHkmOtom3jM2wCu94xgzzu1d6Dn7or,1,0,0,0,0,0,3,0,3,0.42857142857142855,1,0.0,0,0,0,0,0,0,0,3,0,0,3,1
17073,160593,c8TFm45r0bfBe26eBlEeUAKDBoTJT9yV,3VkHkmOtom3jM2wCu94xgzzu1d6Dn7or,1,0,0,0,0,0,1,0,1,0.14285714285714285,1,0.0,0,0,0,0,0,0,0,1,0,0,1,1
17074,160602,bIkNtsuWOvgS5QK0U8Mmyvgqbj0FVVWQ,3VkHkmOtom3jM2wCu94xgzzu1d6Dn7or,13,12,10,0,0,0,5,2,29,4.142857142857143,2,0.0,0,10,0,0,12,0,0,5,2,10,19,1
17075,160604,7PMXBADuwo8nUSllCdBsa2nUjpHivQgP,3VkHkmOtom3jM2wCu94xgzzu1d6Dn7or,9,3,2,0,2,1,7,1,16,2.2857142857142856,1,0.0,0,2,0,2,3,1,0,7,1,4,12,1
17076,160605,kYEJXXhL2nVmzsq7ryJcoFk6ijuUWEJ8,3VkHkmOtom3jM2wCu94xgzzu1d6Dn7or,1,0,0,0,0,0,1,0,1,0.14285714285714285,1,0.0,0,0,0,0,0,0,0,1,0,0,1,1
17077,160607,sBUc6zD5dwvlQamygCFhDETRbipp92Uf,3VkHkmOtom3jM2wCu94xgzzu1d6Dn7or,13,32,13,0,6,23,49,8,131,18.714285714285715,1,0.0,9,13,0,6,23,23,0,49,8,28,103,1
17078,160609,unzM2fr5FICf2pkciDBx8ML6d1ZFN8Ox,3VkHkmOtom3jM2wCu94xgzzu1d6Dn7or,12,14,8,3,5,20,12,2,64,9.142857142857142,2,0.0,2,8,3,5,12,20,0,12,2,18,46,1
17079,160610,r2kL34j9XTVTdF5cCzQAeF8rL4nDRK5t,3VkHkmOtom3jM2wCu94xgzzu1d6Dn7or,22,62,25,9,22,12,21,0,151,21.571428571428573,8,0.0,25,25,9,22,37,12,0,21,0,81,70,1
17080,160612,BYlCbfakv0JnNg2h1Npd6R0qOoZSzfR7,3VkHkmOtom3jM2wCu94xgzzu1d6Dn7or,1,0,0,0,0,0,1,0,1,0.14285714285714285,1,0.0,0,0,0,0,0,0,0,1,0,0,1,1
17081,160613,mSbHXGd7wu84Kztv806n2JOoCUP5FmbE,3VkHkmOtom3jM2wCu94xgzzu1d6Dn7or,1,0,0,0,0,0,1,0,1,0.14285714285714285,1,0.0,0,0,0,0,0,0,0,1,0,0,1,1
17082,160615,3HC1D1DG8BjKUNFZlgm7gcIQVOGrzi6J,3VkHkmOtom3jM2wCu94xgzzu1d6Dn7or,9,6,2,0,2,0,2,0,12,1.7142857142857142,1,0.0,0,2,0,2,6,0,0,2,0,4,8,1
17083,160618,kn6Hs13Qj2B81fZC4tvAYTue2uxrpuDz,3VkHkmOtom3jM2wCu94xgzzu1d6Dn7or,16,28,11,0,8,0,3,0,50,7.142857142857143,2,0.0,2,11,0,8,26,0,0,3,0,21,29,0
17084,160622,TIMqx2gcwCCJ6ynyo9tGcvUWY9qctKOg,3VkHkmOtom3jM2wCu94xgzzu1d6Dn7or,23,42,11,23,1,5,11,0,93,13.285714285714286,2,0.0,10,11,18,1,32,5,5,11,0,40,53,1
17085,160627,xvcKkkK5JV17xBJf26r9BZRnVlqNQ6F6,3VkHkmOtom3jM2wCu94xgzzu1d6Dn7or,6,2,1,0,1,2,4,0,10,1.4285714285714286,1,0.0,0,1,0,1,2,2,0,4,0,2,8,1
17086,160628,UyX7nNmF6wGhy0d7beXB2sIT5I4J2s3C,3VkHkmOtom3jM2wCu94xgzzu1d6Dn7or,6,6,2,0,3,0,4,0,15,2.142857142857143,2,0.0,0,2,0,3,6,0,0,4,0,5,10,0
17087,160632,YGBQrGfSypROjlaNALEXgn4JBHmgIbfe,3VkHkmOtom3jM2wCu94xgzzu1d6Dn7or,4,2,1,0,1,0,1,0,5,0.7142857142857143,1,0.0,0,1,0,1,2,0,0,1,0,2,3,1
17088,160636,kIwVgOwXVLkGIsqKT00ytpZlpUgyryAe,3VkHkmOtom3jM2wCu94xgzzu1d6Dn7or,1,0,0,0,0,0,1,0,1,0.14285714285714285,1,0.0,0,0,0,0,0,0,0,1,0,0,1,1
17089,160638,sNGcbUmFY6aztxE4Hv7JlrqOIaAeV0nL,3VkHkmOtom3jM2wCu94xgzzu1d6Dn7or,5,4,1,0,0,0,3,0,8,1.1428571428571428,1,0.0,0,1,0,0,4,0,0,3,0,1,7,1
17090,160639,UijNr3To2coP0HvSNlidJgYuMGopc2MU,3VkHkmOtom3jM2wCu94xgzzu1d6Dn7or,1,0,0,0,0,0,1,0,1,0.14285714285714285,1,0.0,0,0,0,0,0,0,0,1,0,0,1,1
17091,160640,WR8Ujwo8LuGUeKfDuRC6pVq5SGQhaUdB,3VkHkmOtom3jM2wCu94xgzzu1d6Dn7or,1,0,0,0,0,0,1,0,1,0.14285714285714285,1,0.0,0,0,0,0,0,0,0,1,0,0,1,0
17092,160641,tClD64M9R0FogweD3PzbznlW4I247oJ0,3VkHkmOtom3jM2wCu94xgzzu1d6Dn7or,4,2,0,0,1,0,1,0,4,0.5714285714285714,1,0.0,0,0,0,1,2,0,0,1,0,1,3,1
17093,160646,V6XdC6tC3vHWuI4yJEyiTS9H06BrdWKA,3VkHkmOtom3jM2wCu94xgzzu1d6Dn7or,1,0,0,0,0,0,1,0,1,0.14285714285714285,1,0.0,0,0,0,0,0,0,0,1,0,0,1,1
17094,160650,TX6WaheSubX4Jh5OPfhz8yucBohGOx3b,3VkHkmOtom3jM2wCu94xgzzu1d6Dn7or,6,3,1,0,1,1,3,1,10,1.4285714285714286,1,0.0,0,1,0,1,3,1,0,3,1,2,8,1
17095,160663,SH3THvT9ATqMny80GD63EuK5GGnf8XMU,3VkHkmOtom3jM2wCu94xgzzu1d6Dn7or,10,16,2,8,1,3,7,1,38,5.428571428571429,2,0.0,7,2,6,1,9,3,2,7,1,16,22,1
17096,160673,c6XaDpje2iQSWpoXkTtf00BW6tACh6Q9,3VkHkmOtom3jM2wCu94xgzzu1d6Dn7or,7,3,2,0,2,2,6,1,16,2.2857142857142856,2,0.0,0,2,0,2,3,2,0,6,1,4,12,1
17097,160678,08OTJovI4mN1P4AUjCgqGCGzY3HAu3jj,A3fsA9Zfv1X2fVEQhTw51lKENdNrEqT3,9,6,3,0,0,1,11,2,23,3.2857142857142856,2,0.0,2,3,0,0,4,1,0,11,2,5,18,1
17098,160689,maRYQr4yWNxVM9p4XKMWLQDUgjnfGEOV,SpATywNh6bZuzm8s1ceuBUnMUAeoAHHw,9,7,2,0,2,0,3,0,14,2.0,2,0.0,0,2,0,2,7,0,0,3,0,4,10,1
17099,160695,jVMhwZeU5vDgj3wVrGtqm4E7AFHhfK0R,bWdj2GDclj5ofokWjzoa5jAwMkxCykd6,5,9,2,0,3,0,2,0,16,2.2857142857142856,1,0.0,3,2,0,3,6,0,0,2,0,8,8,1
17100,160700,Y4UU3fLGxizfdyHNAtldrHung8ggH7YH,SpATywNh6bZuzm8s1ceuBUnMUAeoAHHw,2,0,0,0,0,0,2,0,2,0.2857142857142857,1,0.0,0,0,0,0,0,0,0,2,0,0,2,0
17101,160744,ulShWa7eRXZVcz2EYwR44GuwsfoLQCba,SpATywNh6bZuzm8s1ceuBUnMUAeoAHHw,1,0,0,0,0,0,1,0,1,0.14285714285714285,1,0.0,0,0,0,0,0,0,0,1,0,0,1,1
17102,160760,3qxjUYnIYNKewMm8FEnsaaY7IZkJWvME,A3fsA9Zfv1X2fVEQhTw51lKENdNrEqT3,1,0,0,0,0,0,1,0,1,0.14285714285714285,1,0.0,0,0,0,0,0,0,0,1,0,0,1,1
17103,160762,JqVdWoQHyNqeUwMTtrPuJeUxrm3Ef7QH,SpATywNh6bZuzm8s1ceuBUnMUAeoAHHw,29,45,14,19,8,0,10,0,96,13.714285714285714,3,0.0,11,14,18,8,34,0,1,10,0,51,45,1
17104,160772,wcY75Km16WlFjiueDkOBUhqeNxcDUZEC,SpATywNh6bZuzm8s1ceuBUnMUAeoAHHw,5,2,1,0,1,0,2,0,6,0.8571428571428571,1,0.0,0,1,0,1,2,0,0,2,0,2,4,1
17105,160775,ZgNdO7hyoQRmg00lVh0JR0YxTL2sBLXr,SpATywNh6bZuzm8s1ceuBUnMUAeoAHHw,23,29,9,31,8,0,54,1,132,18.857142857142858,6,0.0,6,9,28,8,23,0,3,54,1,51,81,0
17106,160779,ayXSJHlkjoyFUB4Y9YHZnlOXt35wvwwu,5X6FeZozNMgE2VRi3MJYjkkFK8SETtu2,1,0,0,0,0,0,1,0,1,0.14285714285714285,1,0.0,0,0,0,0,0,0,0,1,0,0,1,1
17107,160799,EUJXMkzFSEo17STajcXmmFEGLLejuzHK,SpATywNh6bZuzm8s1ceuBUnMUAeoAHHw,7,9,5,0,2,2,2,0,20,2.857142857142857,1,0.0,0,5,0,2,9,2,0,2,0,7,13,1
17108,160813,YrKW89w90qznhQzq68o8LzP2wDxTZoQ7,SpATywNh6bZuzm8s1ceuBUnMUAeoAHHw,1,0,0,0,0,0,1,0,1,0.14285714285714285,1,0.0,0,0,0,0,0,0,0,1,0,0,1,1
17109,160814,MYCZGZUUB6h2kR5SWwXC3erQhe8wj439,A3fsA9Zfv1X2fVEQhTw51lKENdNrEqT3,4,3,1,0,1,0,2,0,7,1.0,1,0.0,0,1,0,1,3,0,0,2,0,2,5,0
17110,160831,ycYabaRFVayOcZp1HtLrl0En4pTKGtZt,5X6FeZozNMgE2VRi3MJYjkkFK8SETtu2,1,0,0,0,0,0,1,0,1,0.14285714285714285,1,0.0,0,0,0,0,0,0,0,1,0,0,1,1
17111,160833,ycYabaRFVayOcZp1HtLrl0En4pTKGtZt,bWdj2GDclj5ofokWjzoa5jAwMkxCykd6,1,0,0,0,0,0,1,0,1,0.14285714285714285,1,0.0,0,0,0,0,0,0,0,1,0,0,1,1
17112,160837,3f8TEYsxw8fTx61szmPewZsIJHdQMPuP,SpATywNh6bZuzm8s1ceuBUnMUAeoAHHw,49,55,35,31,16,13,19,1,170,24.285714285714285,2,0.0,9,35,30,16,46,13,1,19,1,90,80,0
17113,160842,ffjWC7PpsqUyQ4g8h9cR2OgJ4csHrEGY,7GRhBDsirIGkRZBtSMEzNTyDr2JQm4xx,1,0,0,0,0,0,1,0,1,0.14285714285714285,1,0.0,0,0,0,0,0,0,0,1,0,0,1,1
17114,160848,gbm2CIpey5BIwuF4GxSVVzkrIqxOpVxg,5X6FeZozNMgE2VRi3MJYjkkFK8SETtu2,1,0,0,0,0,0,1,0,1,0.14285714285714285,1,0.0,0,0,0,0,0,0,0,1,0,0,1,1
17115,160854,PWnc2bfhRdIfnUvCUBXCzFhD501NoXOI,SpATywNh6bZuzm8s1ceuBUnMUAeoAHHw,1,0,0,0,0,0,2,0,2,0.2857142857142857,1,0.0,0,0,0,0,0,0,0,2,0,0,2,1
17116,160875,3brvPLG28YLDueYV1AJHr2UrCWHsXO6w,SpATywNh6bZuzm8s1ceuBUnMUAeoAHHw,1,0,0,0,0,0,1,0,1,0.14285714285714285,1,0.0,0,0,0,0,0,0,0,1,0,0,1,1
17117,160885,gD8Q5HJC6S9Ahio3YuKn2MokdLQZr6bN,5X6FeZozNMgE2VRi3MJYjkkFK8SETtu2,10,5,3,0,2,2,11,1,24,3.4285714285714284,3,0.0,0,3,0,2,5,2,0,11,1,5,19,1
17118,160893,D0kyC5FJUDgGdAHjRh4Zvl046XDRRxWf,5X6FeZozNMgE2VRi3MJYjkkFK8SETtu2,2,0,0,0,0,0,2,0,2,0.2857142857142857,1,0.0,0,0,0,0,0,0,0,2,0,0,2,1
17119,160896,QorrHnxXo6JAqrXzWymDFHVcsHjUyyen,SpATywNh6bZuzm8s1ceuBUnMUAeoAHHw,1,0,0,0,0,0,1,0,1,0.14285714285714285,1,0.0,0,0,0,0,0,0,0,1,0,0,1,1
17120,160900,pwfJpYbVX39CeSzvJ7qw09YbBPUS5HaZ,SpATywNh6bZuzm8s1ceuBUnMUAeoAHHw,5,1,1,0,1,0,2,0,5,0.7142857142857143,1,0.0,0,1,0,1,1,0,0,2,0,2,3,1
17121,160906,Tld0Cp8nhQFMldHTc4wNbAWPalDRQyks,SpATywNh6bZuzm8s1ceuBUnMUAeoAHHw,52,78,50,20,38,5,8,3,202,28.857142857142858,3,0.0,6,50,17,38,72,5,3,8,3,111,91,0
17122,160911,UtNvwiEIu7iQRo2Po9FxglHJbAYaDW68,A3fsA9Zfv1X2fVEQhTw51lKENdNrEqT3,2,0,0,0,0,0,2,0,2,0.2857142857142857,1,0.0,0,0,0,0,0,0,0,2,0,0,2,1
17123,160912,RLZmn6mGPjHwRDtRmi28Ublb23MmEBlO,SpATywNh6bZuzm8s1ceuBUnMUAeoAHHw,8,8,1,0,1,2,4,0,16,2.2857142857142856,1,0.0,0,1,0,1,8,2,0,4,0,2,14,1
17124,160932,OAT2DaBS2qqaVHQUCn9wipcvqj5Upvl2,A3fsA9Zfv1X2fVEQhTw51lKENdNrEqT3,2,0,0,0,0,0,2,0,2,0.2857142857142857,2,0.0,0,0,0,0,0,0,0,2,0,0,2,1
17125,160948,ioaeb7d1U29jI9wsI7DHJ7aiuWWVX3KB,SpATywNh6bZuzm8s1ceuBUnMUAeoAHHw,1,0,0,0,0,0,1,0,1,0.14285714285714285,1,0.0,0,0,0,0,0,0,0,1,0,0,1,1
17126,160953,qF5FUAIl9vj6sKJZzYBK4dYgOrKuXUyJ,bWdj2GDclj5ofokWjzoa5jAwMkxCykd6,1,0,0,0,0,0,1,0,1,0.14285714285714285,1,0.0,0,0,0,0,0,0,0,1,0,0,1,1
17127,160956,3G8UKlMnri0uMjx4kTUdEFUnuVu9MqyS,7GRhBDsirIGkRZBtSMEzNTyDr2JQm4xx,4,4,1,0,2,0,2,0,9,1.2857142857142858,1,0.0,2,1,0,2,2,0,0,2,0,5,4,1
17128,160963,W4swLEiF6xa4CU1Ee5z4jQMNXyEDiyxR,SpATywNh6bZuzm8s1ceuBUnMUAeoAHHw,10,12,5,0,3,2,6,0,28,4.0,2,0.0,0,5,0,3,12,2,0,6,0,8,20,1
17129,160966,MbuXqf7C13S68Qf0iCIWEHpPecEoxyR2,bWdj2GDclj5ofokWjzoa5jAwMkxCykd6,6,4,2,0,1,0,1,0,8,1.1428571428571428,1,0.0,0,2,0,1,4,0,0,1,0,3,5,1
17130,160971,GzsM7mUybvaWblQFpF1LhbuoVXQUHvXC,SpATywNh6bZuzm8s1ceuBUnMUAeoAHHw,6,3,1,0,1,0,2,0,7,1.0,1,0.0,0,1,0,1,3,0,0,2,0,2,5,1
17131,160976,vGz6lC8qPi2eLnEFPzWw51wpCxsgPBs3,SpATywNh6bZuzm8s1ceuBUnMUAeoAHHw,6,2,1,0,1,0,3,0,7,1.0,1,0.0,1,1,0,1,1,0,0,3,0,3,4,1
17132,160982,GqCGIGFGFhTKfbwDU3SVdL9uLBEMMF8w,SpATywNh6bZuzm8s1ceuBUnMUAeoAHHw,9,23,7,0,2,0,3,0,35,5.0,1,0.0,0,7,0,2,23,0,0,3,0,9,26,0
17133,160988,DJKl3Qg8a347WT9VIamdSjXAowCvpC9t,SpATywNh6bZuzm8s1ceuBUnMUAeoAHHw,36,22,17,14,13,0,6,1,73,10.428571428571429,2,0.0,3,17,13,13,19,0,1,6,1,46,27,1
17134,160991,fDaxh7N7NdJHdXsnAIuELHd50CNN3hz9,7GRhBDsirIGkRZBtSMEzNTyDr2JQm4xx,2,0,0,0,0,0,2,0,2,0.2857142857142857,1,0.0,0,0,0,0,0,0,0,2,0,0,2,1
17135,160998,NDPKqXKOmpAXA3c3gsKRZCfXFZLtbtM8,A3fsA9Zfv1X2fVEQhTw51lKENdNrEqT3,6,2,1,0,1,0,4,0,8,1.1428571428571428,2,0.0,0,1,0,1,2,0,0,4,0,2,6,1
17136,161027,CetRT5zy2dJHyaPU2zMnW0reXnT8Dv2y,bWdj2GDclj5ofokWjzoa5jAwMkxCykd6,10,17,9,0,4,0,13,1,44,6.285714285714286,2,0.0,0,9,0,4,17,0,0,13,1,13,31,0
17137,161032,IFE6qWbdZl6uYZhohe6KYJqe5ZPXYuuR,SpATywNh6bZuzm8s1ceuBUnMUAeoAHHw,5,2,1,0,1,0,2,0,6,0.8571428571428571,1,0.0,0,1,0,1,2,0,0,2,0,2,4,1
17138,161034,Am4KYOUcnhkB8aqlcwil5l2ZNhMiS2yt,SpATywNh6bZuzm8s1ceuBUnMUAeoAHHw,5,4,3,0,3,0,3,0,13,1.8571428571428572,2,0.0,0,3,0,3,4,0,0,3,0,6,7,1
17139,161044,MvxZ4LrwMNK4bX2id6mJDwMa1OsD3cXN,SpATywNh6bZuzm8s1ceuBUnMUAeoAHHw,2,0,0,0,0,0,2,0,2,0.2857142857142857,1,0.0,0,0,0,0,0,0,0,2,0,0,2,0
17140,161071,kD7KrEgPns8NN7pPH4RunWGvMBAYF6OW,7GRhBDsirIGkRZBtSMEzNTyDr2JQm4xx,4,2,0,0,0,0,3,0,5,0.7142857142857143,1,0.0,0,0,0,0,2,0,0,3,0,0,5,1
17141,161076,BbvGM92sGSMMIrRMXDFdD1GEnySzXRYT,A3fsA9Zfv1X2fVEQhTw51lKENdNrEqT3,6,7,2,0,1,0,3,0,13,1.8571428571428572,3,0.0,0,2,0,1,7,0,0,3,0,3,10,0
17142,161079,JDFQZtkjaBhYZM0MLFNIDJC3MmDM3j4N,SpATywNh6bZuzm8s1ceuBUnMUAeoAHHw,21,21,12,10,7,12,16,1,79,11.285714285714286,5,0.0,6,12,8,7,15,12,2,16,1,33,46,0
17143,161105,LqKnbXKS585SEKpwP1WxJYJOgqsH3tlg,SpATywNh6bZuzm8s1ceuBUnMUAeoAHHw,6,2,1,0,1,0,3,0,7,1.0,1,0.0,0,1,0,1,2,0,0,3,0,2,5,1
17144,161117,UAE7k3whY8BUnHHgiIeFo6Rzc8eEYhRN,bWdj2GDclj5ofokWjzoa5jAwMkxCykd6,1,0,0,0,0,0,1,0,1,0.14285714285714285,1,0.0,0,0,0,0,0,0,0,1,0,0,1,1
17145,161120,bAABlYXwSxLGjyoM2mZWwlEcMoay9TKF,7GRhBDsirIGkRZBtSMEzNTyDr2JQm4xx,34,49,20,36,13,13,25,8,164,23.428571428571427,1,0.0,23,20,33,13,26,13,3,25,8,89,75,1
17146,161140,194jqOV6jnj4prH3N2CqRtpc9qi9vfln,bWdj2GDclj5ofokWjzoa5jAwMkxCykd6,8,7,1,0,2,1,9,1,21,3.0,1,0.0,2,1,0,2,5,1,0,9,1,5,16,1
17147,161146,wKtjicmtXDLrlymiwnuOgL0XJQtQSxfX,7GRhBDsirIGkRZBtSMEzNTyDr2JQm4xx,2,0,0,0,0,0,2,0,2,0.2857142857142857,1,0.0,0,0,0,0,0,0,0,2,0,0,2,1
17148,161162,OsVH6GaCH0fFhbcpJ8VTZdDPBSjPAjjC,bWdj2GDclj5ofokWjzoa5jAwMkxCykd6,5,2,1,0,1,0,2,0,6,0.8571428571428571,1,0.0,0,1,0,1,2,0,0,2,0,2,4,1
17149,161163,uDnJLAi73zveRN4zlXZiPfuCVzPc0SnS,SpATywNh6bZuzm8s1ceuBUnMUAeoAHHw,16,15,10,0,5,8,14,7,59,8.428571428571429,1,0.0,0,10,0,5,15,8,0,14,7,15,44,0
17150,161167,zwULmFeRowgNxt1Wa0GovPX5gRTGXecE,SpATywNh6bZuzm8s1ceuBUnMUAeoAHHw,5,2,1,0,1,0,2,0,6,0.8571428571428571,1,0.0,0,1,0,1,2,0,0,2,0,2,4,0
17151,161176,iFmthN4O8PvK0KN8KGxvlHIavkzlrfwZ,5X6FeZozNMgE2VRi3MJYjkkFK8SETtu2,1,0,0,0,0,0,1,0,1,0.14285714285714285,1,0.0,0,0,0,0,0,0,0,1,0,0,1,1
17152,161178,7xpmz6LF4dl35fFKZgRU70OZyF8UO4PL,5X6FeZozNMgE2VRi3MJYjkkFK8SETtu2,8,7,3,0,2,0,2,0,14,2.0,1,0.0,0,3,0,2,7,0,0,2,0,5,9,1
17153,161186,5BE6mWnwPv7tHKPQBwq1Lu0ezQBICw4i,SpATywNh6bZuzm8s1ceuBUnMUAeoAHHw,6,9,6,0,0,0,4,0,19,2.7142857142857144,2,0.0,0,6,0,0,9,0,0,4,0,6,13,1
17154,161193,FKqGzWb3VsmU7jpYPJbCVaVAzRrOMrbY,A3fsA9Zfv1X2fVEQhTw51lKENdNrEqT3,5,2,1,0,1,0,2,0,6,0.8571428571428571,1,0.0,0,1,0,1,2,0,0,2,0,2,4,1
17155,161197,coZTr10eytnE55me2AxqRWq6qrVXEB7M,5X6FeZozNMgE2VRi3MJYjkkFK8SETtu2,23,39,21,18,20,0,7,0,105,15.0,3,0.0,13,21,17,20,26,0,1,7,0,71,34,1
17156,161202,Bz9DFXP5IfsdY1GquZ326aHTKHeY7tPX,A3fsA9Zfv1X2fVEQhTw51lKENdNrEqT3,7,3,1,0,1,1,4,1,11,1.5714285714285714,1,0.0,0,1,0,1,3,1,0,4,1,2,9,1
17157,161208,FgKGJkcyrlk2UGTZTaDtYvcpTKr0lNLA,7GRhBDsirIGkRZBtSMEzNTyDr2JQm4xx,11,12,6,10,4,0,7,0,39,5.571428571428571,2,0.0,4,6,8,4,8,0,2,7,0,22,17,1
17158,161210,fkUbRiFpn0phnbHLf3l8N7hPSHaKlqPT,SpATywNh6bZuzm8s1ceuBUnMUAeoAHHw,1,0,0,0,0,0,1,0,1,0.14285714285714285,1,0.0,0,0,0,0,0,0,0,1,0,0,1,0
17159,161214,RPO64II9N8Vv1clUea5ir9miWSludB2S,SpATywNh6bZuzm8s1ceuBUnMUAeoAHHw,10,7,2,12,0,5,4,0,30,4.285714285714286,1,0.0,2,2,10,0,5,5,2,4,0,14,16,0
17160,161228,vlXDkJyZcNlW4DjqMuBZT0NEzx7fdVMZ,SpATywNh6bZuzm8s1ceuBUnMUAeoAHHw,7,5,0,0,0,0,4,0,9,1.2857142857142858,1,0.0,0,0,0,0,5,0,0,4,0,0,9,1
17161,161233,AiZBCpHbXnyOWKg8HynBZIF9HQ0QhVjR,SpATywNh6bZuzm8s1ceuBUnMUAeoAHHw,6,1,1,0,1,0,3,0,6,0.8571428571428571,1,0.0,0,1,0,1,1,0,0,3,0,2,4,1
17162,161235,9OJ5A7uGdzNYawJUDofemHIUlKea4Sz4,bWdj2GDclj5ofokWjzoa5jAwMkxCykd6,1,0,0,0,0,0,1,0,1,0.14285714285714285,1,0.0,0,0,0,0,0,0,0,1,0,0,1,1
17163,161241,ClKwabqP8QQ4V4BPHK5zBEKrYzP6TxXZ,SpATywNh6bZuzm8s1ceuBUnMUAeoAHHw,1,0,0,0,0,0,1,0,1,0.14285714285714285,1,0.0,0,0,0,0,0,0,0,1,0,0,1,1
17164,161246,B5jlZpEDxUNGCe4UQsaYbJ99Z8y5d2lN,A3fsA9Zfv1X2fVEQhTw51lKENdNrEqT3,30,17,14,0,12,0,7,0,50,7.142857142857143,3,0.0,0,14,0,12,17,0,0,7,0,26,24,0
17165,161251,d8nG3CRjdRKOgHNCQ97Y2ebOYVCkXw4D,bWdj2GDclj5ofokWjzoa5jAwMkxCykd6,1,0,0,0,0,0,1,0,1,0.14285714285714285,1,0.0,0,0,0,0,0,0,0,1,0,0,1,1
17166,161252,cjIjalOkynRvNiMkIirdnL3eRD5dBGGC,A3fsA9Zfv1X2fVEQhTw51lKENdNrEqT3,5,2,1,0,1,0,3,0,7,1.0,1,0.0,0,1,0,1,2,0,0,3,0,2,5,1
17167,161272,Azsuwdl5atG1kex3bL6Sp3cE2kQP65dh,5X6FeZozNMgE2VRi3MJYjkkFK8SETtu2,2,0,0,0,0,0,2,0,2,0.2857142857142857,1,0.0,0,0,0,0,0,0,0,2,0,0,2,1
17168,161273,vuVnTFCBfdzSvUffWnstx1XETLzOHwWp,SpATywNh6bZuzm8s1ceuBUnMUAeoAHHw,34,47,33,33,21,1,5,0,140,20.0,2,0.0,7,33,30,21,40,1,3,5,0,91,49,0
17169,161286,ZfEmNtZnnnOMQU2ZxafVmay1LudDsU5A,A3fsA9Zfv1X2fVEQhTw51lKENdNrEqT3,8,7,1,0,1,0,3,0,12,1.7142857142857142,2,0.0,0,1,0,1,7,0,0,3,0,2,10,1
17170,161290,jMYQxsCNKY5cLAg44E5z2BIKSAvgdfQc,7GRhBDsirIGkRZBtSMEzNTyDr2JQm4xx,5,2,1,0,1,0,2,0,6,0.8571428571428571,1,0.0,0,1,0,1,2,0,0,2,0,2,4,1
17171,161302,UwPa8KNwh7Sk253EeLtMmDO2eQSxh5Ah,5X6FeZozNMgE2VRi3MJYjkkFK8SETtu2,3,0,0,0,0,0,3,0,3,0.42857142857142855,1,0.0,0,0,0,0,0,0,0,3,0,0,3,1
17172,161309,c45tGE4X33f1wuWJww6KL4YDWdrZudFS,SpATywNh6bZuzm8s1ceuBUnMUAeoAHHw,1,0,0,0,0,0,1,0,1,0.14285714285714285,1,0.0,0,0,0,0,0,0,0,1,0,0,1,1
17173,161315,cT4LJPe0XxOcIidQWBVnNsALPzrk3WFu,A3fsA9Zfv1X2fVEQhTw51lKENdNrEqT3,2,0,0,0,0,0,4,0,4,0.5714285714285714,1,0.0,0,0,0,0,0,0,0,4,0,0,4,1
17174,161320,ic5l4x1XKbzNP4iiyqvz1kk9aIQYNWYg,SpATywNh6bZuzm8s1ceuBUnMUAeoAHHw,15,16,5,24,0,0,3,0,48,6.857142857142857,1,0.0,7,5,24,0,9,0,0,3,0,36,12,1
17175,161329,GDHvw72iSHIz6VwsSteleP4praXBxk8h,A3fsA9Zfv1X2fVEQhTw51lKENdNrEqT3,1,0,0,0,0,0,2,0,2,0.2857142857142857,1,0.0,0,0,0,0,0,0,0,2,0,0,2,1
17176,161334,5dwhOYeq6DRSGIBZohMlMunxrKsjka7v,bWdj2GDclj5ofokWjzoa5jAwMkxCykd6,5,10,7,0,5,1,2,0,25,3.5714285714285716,1,0.0,0,7,0,5,10,1,0,2,0,12,13,1
17177,161340,r2fvnP5HQ65QQyLJ7ftCWFPVDeKlz5Bf,SpATywNh6bZuzm8s1ceuBUnMUAeoAHHw,19,25,6,13,4,2,6,3,59,8.428571428571429,1,0.0,8,6,10,4,17,2,3,6,3,28,31,1
17178,161344,qVXQ5twJYvpmkyoNBZEpQT0hJrzlvtzo,A3fsA9Zfv1X2fVEQhTw51lKENdNrEqT3,6,5,2,0,1,0,5,0,13,1.8571428571428572,1,0.0,0,2,0,1,5,0,0,5,0,3,10,1
17179,161354,8mGbGwW0kqMWmEPWmvTNX7d3rQGPeEB8,SpATywNh6bZuzm8s1ceuBUnMUAeoAHHw,31,28,14,6,12,0,3,0,63,9.0,2,0.0,0,14,5,12,28,0,1,3,0,31,32,0
17180,161357,rNE6Mu311rQY458X8XtgRw0hCP6H0U1S,bWdj2GDclj5ofokWjzoa5jAwMkxCykd6,5,3,1,0,1,0,2,0,7,1.0,1,0.0,0,1,0,1,3,0,0,2,0,2,5,1
17181,161363,XtB8OQxKTJMzAyetXDHpSCOE9CGXWhJc,SpATywNh6bZuzm8s1ceuBUnMUAeoAHHw,5,2,0,0,0,1,5,0,8,1.1428571428571428,1,0.0,0,0,0,0,2,1,0,5,0,0,8,1
17182,161367,vkVcAL32x89gCUbijn0COpSie0zSVcTg,bWdj2GDclj5ofokWjzoa5jAwMkxCykd6,3,0,0,0,0,0,3,0,3,0.42857142857142855,1,0.0,0,0,0,0,0,0,0,3,0,0,3,0
17183,161376,KV34bsRuo2sXW3PLX4hZvmgrR9GRM7T6,5X6FeZozNMgE2VRi3MJYjkkFK8SETtu2,5,2,1,0,1,0,3,0,7,1.0,1,0.0,0,1,0,1,2,0,0,3,0,2,5,1
17184,161386,adfbW7xBPY784GRXAIq3fInFogIbD6ro,SpATywNh6bZuzm8s1ceuBUnMUAeoAHHw,45,70,36,34,0,2,18,2,162,23.142857142857142,6,0.0,13,36,31,0,57,2,3,18,2,80,82,0
17185,161387,eiRHLVhBf0olv6rTPAoGgaOAwfeRlIDL,SpATywNh6bZuzm8s1ceuBUnMUAeoAHHw,1,0,0,0,0,0,1,0,1,0.14285714285714285,1,0.0,0,0,0,0,0,0,0,1,0,0,1,1
17186,161390,NMciPbdIeB9uIZwCMcw6mXU2i3BtnB5v,A3fsA9Zfv1X2fVEQhTw51lKENdNrEqT3,12,6,5,0,5,0,1,0,17,2.4285714285714284,1,0.0,0,5,0,5,6,0,0,1,0,10,7,1
17187,161398,unkieT2T5FX60wyYAIsaTG56kPfWLfWp,SpATywNh6bZuzm8s1ceuBUnMUAeoAHHw,4,2,1,0,1,0,1,0,5,0.7142857142857143,1,0.0,0,1,0,1,2,0,0,1,0,2,3,0
17188,161412,uqHSgHtPqI0pLXHTpUBns1eF4e9jsvt1,7GRhBDsirIGkRZBtSMEzNTyDr2JQm4xx,1,0,0,0,0,0,1,0,1,0.14285714285714285,1,0.0,0,0,0,0,0,0,0,1,0,0,1,1
17189,161414,uqHSgHtPqI0pLXHTpUBns1eF4e9jsvt1,SpATywNh6bZuzm8s1ceuBUnMUAeoAHHw,5,2,1,0,1,0,5,0,9,1.2857142857142858,1,0.0,0,1,0,1,2,0,0,5,0,2,7,1
17190,161417,Oxmoejo3hSWTZiTWOnJwuUCK8VDHRfg9,A3fsA9Zfv1X2fVEQhTw51lKENdNrEqT3,2,0,0,0,0,0,2,0,2,0.2857142857142857,1,0.0,0,0,0,0,0,0,0,2,0,0,2,1
17191,161421,WP2ym6laNmJWuc1dFKEHBcyv5Oxzzjqp,A3fsA9Zfv1X2fVEQhTw51lKENdNrEqT3,8,4,2,0,2,0,4,0,12,1.7142857142857142,1,0.0,0,2,0,2,4,0,0,4,0,4,8,1
17192,161422,xIo4n5tt7YUC0wGdrIg4QgxF1OMrY5DB,SpATywNh6bZuzm8s1ceuBUnMUAeoAHHw,7,3,2,0,2,0,2,0,9,1.2857142857142858,1,0.0,0,2,0,2,3,0,0,2,0,4,5,1
17193,161427,YwMASqqYJxzRjuKe9JI9rWFNQbTS5tSD,5X6FeZozNMgE2VRi3MJYjkkFK8SETtu2,2,0,0,0,0,0,2,0,2,0.2857142857142857,1,0.0,0,0,0,0,0,0,0,2,0,0,2,1
17194,161429,YwMASqqYJxzRjuKe9JI9rWFNQbTS5tSD,A3fsA9Zfv1X2fVEQhTw51lKENdNrEqT3,4,2,1,0,0,0,5,0,8,1.1428571428571428,1,0.0,0,1,0,0,2,0,0,5,0,1,7,1
17195,161432,7Y5C8uyNuEClb8hOu715XyJadaHTCp61,SpATywNh6bZuzm8s1ceuBUnMUAeoAHHw,11,12,1,0,1,2,7,2,25,3.5714285714285716,2,0.0,0,1,0,1,12,2,0,7,2,2,23,1
17196,161443,CfUHqy5TfjBtRxjNztsGxyFua9jISd0Q,SpATywNh6bZuzm8s1ceuBUnMUAeoAHHw,1,0,0,0,0,0,1,0,1,0.14285714285714285,1,0.0,0,0,0,0,0,0,0,1,0,0,1,0
17197,161447,zx7r7me6FiVbbABDOlQkLj20mb4SMp5e,bWdj2GDclj5ofokWjzoa5jAwMkxCykd6,7,2,1,0,1,0,4,0,8,1.1428571428571428,1,0.0,0,1,0,1,2,0,0,4,0,2,6,1
17198,161465,QwzgqwSHCQGBlqpFzwe8sYcM8CZG7iZ9,SpATywNh6bZuzm8s1ceuBUnMUAeoAHHw,7,14,2,0,1,0,5,0,22,3.142857142857143,3,0.0,0,2,0,1,14,0,0,5,0,3,19,1
17199,161482,yBMHADlfH84svjxYAPJHefy94rOxozvf,A3fsA9Zfv1X2fVEQhTw51lKENdNrEqT3,6,3,2,0,1,0,2,0,8,1.1428571428571428,1,0.0,0,2,0,1,3,0,0,2,0,3,5,1
17200,161496,FakJ1HnIHb157ubEfS1cl0AV2JD4N08k,SpATywNh6bZuzm8s1ceuBUnMUAeoAHHw,15,17,5,10,3,0,3,0,38,5.428571428571429,1,0.0,2,5,9,3,15,0,1,3,0,19,19,0
17201,161501,ztlNh3618sIHrGoj9bVbBw9E0ZrHkNpd,bWdj2GDclj5ofokWjzoa5jAwMkxCykd6,1,0,0,0,0,0,1,0,1,0.14285714285714285,1,0.0,0,0,0,0,0,0,0,1,0,0,1,1
17202,161505,IGWRz8xQdPwjKqBNKTjONoXgcj0XdulM,A3fsA9Zfv1X2fVEQhTw51lKENdNrEqT3,7,2,1,0,1,0,8,0,12,1.7142857142857142,3,0.0,1,1,0,1,1,0,0,8,0,3,9,0
17203,161528,4TaJuNI7ILCokDHtRq2KU7kBpdPPodLL,SpATywNh6bZuzm8s1ceuBUnMUAeoAHHw,5,2,1,0,1,0,2,0,6,0.8571428571428571,1,0.0,0,1,0,1,2,0,0,2,0,2,4,0
17204,161539,rEX169KR1uPOXxOd63dC71tgeR3NoRN8,SpATywNh6bZuzm8s1ceuBUnMUAeoAHHw,1,0,0,0,0,0,1,0,1,0.14285714285714285,1,0.0,0,0,0,0,0,0,0,1,0,0,1,1
17205,161551,j6udTPKi1ZJjvturgRQnFv50v6HTvf83,bWdj2GDclj5ofokWjzoa5jAwMkxCykd6,1,0,0,0,0,0,1,0,1,0.14285714285714285,1,0.0,0,0,0,0,0,0,0,1,0,0,1,1
17206,161555,tPgSJ4wzFz4lJ86dWZJQnEehGB8O0lXp,SpATywNh6bZuzm8s1ceuBUnMUAeoAHHw,6,5,2,0,0,0,3,0,10,1.4285714285714286,1,0.0,2,2,0,0,3,0,0,3,0,4,6,1
17207,161556,xFJ4FqhPrDZtiK7YNN9cG7wcwWnghLn1,bWdj2GDclj5ofokWjzoa5jAwMkxCykd6,1,0,0,0,0,0,1,0,1,0.14285714285714285,1,0.0,0,0,0,0,0,0,0,1,0,0,1,1
17208,161574,N70KXoq5ZzjUfXX93vdYF9bSRDAdFuPe,SpATywNh6bZuzm8s1ceuBUnMUAeoAHHw,2,0,0,0,0,0,4,0,4,0.5714285714285714,1,0.0,0,0,0,0,0,0,0,4,0,0,4,0
17209,161577,Khe9KlmSoSTsax6cgkl9d8UgiAE6YdMj,7GRhBDsirIGkRZBtSMEzNTyDr2JQm4xx,8,6,3,0,1,0,3,0,13,1.8571428571428572,1,0.0,0,3,0,1,6,0,0,3,0,4,9,1
17210,161591,Khe9KlmSoSTsax6cgkl9d8UgiAE6YdMj,A3fsA9Zfv1X2fVEQhTw51lKENdNrEqT3,8,6,3,0,1,0,4,0,14,2.0,1,0.0,1,3,0,1,5,0,0,4,0,5,9,1
17211,161600,oz6Hu9tzPP7XCtmtbbzc5Jfq0UCKNXl3,SpATywNh6bZuzm8s1ceuBUnMUAeoAHHw,5,2,1,0,1,0,2,0,6,0.8571428571428571,1,0.0,0,1,0,1,2,0,0,2,0,2,4,1
17212,161606,JyZKV6Cx4T3sb5lEewrPu89ztBDJpjHB,7GRhBDsirIGkRZBtSMEzNTyDr2JQm4xx,1,0,0,0,0,0,1,0,1,0.14285714285714285,1,0.0,0,0,0,0,0,0,0,1,0,0,1,1
17213,161622,0PgvslXgC0pgpIZFL5uHzeqmbNWkjEcF,7GRhBDsirIGkRZBtSMEzNTyDr2JQm4xx,15,17,1,0,1,6,7,1,33,4.714285714285714,1,0.0,2,1,0,1,15,6,0,7,1,4,29,1
17214,161634,rm52Ts2OWqvT4Vv3xYPH49SI4hdPJFK7,A3fsA9Zfv1X2fVEQhTw51lKENdNrEqT3,8,9,4,0,2,0,2,0,17,2.4285714285714284,1,0.0,0,4,0,2,9,0,0,2,0,6,11,0
17215,161635,LWWGMAVHUf3PF6BlKef9Rc6itscQOf6h,SpATywNh6bZuzm8s1ceuBUnMUAeoAHHw,2,0,0,0,0,0,2,0,2,0.2857142857142857,1,0.0,0,0,0,0,0,0,0,2,0,0,2,0
17216,161636,4Uch8gV3zXJTiJlx4pumO9oYPkK7ZxIn,SpATywNh6bZuzm8s1ceuBUnMUAeoAHHw,10,12,1,0,1,0,1,0,15,2.142857142857143,1,0.0,0,1,0,1,12,0,0,1,0,2,13,0
17217,161638,gYbj41sQR2TGb4wIl3ifG5wEnRLxOAau,SpATywNh6bZuzm8s1ceuBUnMUAeoAHHw,2,0,0,0,0,0,2,0,2,0.2857142857142857,1,0.0,0,0,0,0,0,0,0,2,0,0,2,1
17218,161639,QZoi4xpkEVVH2rbYL53oYFfYungIuUup,5X6FeZozNMgE2VRi3MJYjkkFK8SETtu2,1,0,0,0,0,0,1,0,1,0.14285714285714285,1,0.0,0,0,0,0,0,0,0,1,0,0,1,1
17219,161653,oSXN7qCh7a4VZeybHFMwMNkk4Bbemi4m,A3fsA9Zfv1X2fVEQhTw51lKENdNrEqT3,8,2,1,0,1,0,6,1,11,1.5714285714285714,1,0.0,0,1,0,1,2,0,0,6,1,2,9,1
17220,161659,MjdRbWesvhmbtKRkEDgkVTz7Gw1rgmgQ,SpATywNh6bZuzm8s1ceuBUnMUAeoAHHw,31,28,11,26,9,0,3,0,77,11.0,1,0.0,5,11,24,9,23,0,2,3,0,49,28,0
17221,161667,q1QqcOJEpZrZKGZXfigMjZ8ytnCI74VX,7GRhBDsirIGkRZBtSMEzNTyDr2JQm4xx,2,0,0,0,0,0,2,0,2,0.2857142857142857,1,0.0,0,0,0,0,0,0,0,2,0,0,2,1
17222,161669,ww05exVvqmTpHRLpMlcyyiyf25IJQarF,SpATywNh6bZuzm8s1ceuBUnMUAeoAHHw,1,0,0,0,0,0,1,0,1,0.14285714285714285,1,0.0,0,0,0,0,0,0,0,1,0,0,1,1
17223,161693,5UJZmEar1AX3gQXOzkh3MnQcYdErI17M,A3fsA9Zfv1X2fVEQhTw51lKENdNrEqT3,4,2,1,0,1,0,1,0,5,0.7142857142857143,1,0.0,0,1,0,1,2,0,0,1,0,2,3,1
17224,161706,2XDpaAo3slMsrFQXFgtVX89IlqkzpX74,7GRhBDsirIGkRZBtSMEzNTyDr2JQm4xx,25,46,4,45,0,9,4,0,108,15.428571428571429,2,0.0,23,4,37,0,23,9,8,4,0,64,44,1
17225,161712,t6oiAnEEEikYJIMTq7MRNsGJSWW6NrOH,5X6FeZozNMgE2VRi3MJYjkkFK8SETtu2,5,1,1,0,1,0,3,0,6,0.8571428571428571,1,0.0,0,1,0,1,1,0,0,3,0,2,4,1
17226,161713,ySy2zYThCkVZr5MjEXuKxq60wfOynxkJ,7GRhBDsirIGkRZBtSMEzNTyDr2JQm4xx,1,0,0,0,0,0,1,0,1,0.14285714285714285,1,0.0,0,0,0,0,0,0,0,1,0,0,1,1
17227,161720,xdxiKeJYKflgdr88D3HSJXuR1e81YpjG,7GRhBDsirIGkRZBtSMEzNTyDr2JQm4xx,11,10,3,6,3,0,4,1,27,3.857142857142857,2,0.0,5,3,6,3,5,0,0,4,1,17,10,1
17228,161747,i7uheDJIh5lOS1HvZimsF1kp1fKEvbnh,7GRhBDsirIGkRZBtSMEzNTyDr2JQm4xx,1,0,0,0,0,0,1,0,1,0.14285714285714285,1,0.0,0,0,0,0,0,0,0,1,0,0,1,1
17229,161754,Xipj7T5lLiw1KZ1W0l4R2RMWExB1p24F,7GRhBDsirIGkRZBtSMEzNTyDr2JQm4xx,1,0,0,0,0,0,2,0,2,0.2857142857142857,2,0.0,0,0,0,0,0,0,0,2,0,0,2,1
17230,161786,eP5N1v22IPemudSlwCB0Ny9hISuL6JNI,A3fsA9Zfv1X2fVEQhTw51lKENdNrEqT3,5,3,1,0,0,0,5,0,9,1.2857142857142858,1,0.0,0,1,0,0,3,0,0,5,0,1,8,0
17231,161788,gygDS63yTosGUEHtiJyQxAu1JinA0G6n,5X6FeZozNMgE2VRi3MJYjkkFK8SETtu2,5,3,1,0,1,0,4,0,9,1.2857142857142858,1,0.0,0,1,0,1,3,0,0,4,0,2,7,1
17232,161790,yGPmCGGKSj19cj9m7eHc6GAPG84cOL7F,A3fsA9Zfv1X2fVEQhTw51lKENdNrEqT3,8,4,3,0,2,0,2,0,11,1.5714285714285714,2,0.0,0,3,0,2,4,0,0,2,0,5,6,1
17233,161797,iLSmgijjawkZ4gpTay6CThOQq0O9r9QD,A3fsA9Zfv1X2fVEQhTw51lKENdNrEqT3,6,3,2,0,2,0,1,0,8,1.1428571428571428,1,0.0,0,2,0,2,3,0,0,1,0,4,4,1
17234,161799,c4jAIERCX1qBZDNXx6SmHB55hKphsx81,A3fsA9Zfv1X2fVEQhTw51lKENdNrEqT3,103,17,8,272,2,0,2,0,301,43.0,1,0.0,5,8,271,2,12,0,1,2,0,286,15,1
17235,161833,CNf41AhEnfCudvGgCmj1b21pvkGa3fVj,A3fsA9Zfv1X2fVEQhTw51lKENdNrEqT3,1,0,0,0,0,0,2,0,2,0.2857142857142857,1,0.0,0,0,0,0,0,0,0,2,0,0,2,1
17236,161850,VeFENcSXAiXgJQaSjlXiodtIBxgSrzaH,5X6FeZozNMgE2VRi3MJYjkkFK8SETtu2,5,2,1,0,1,0,2,0,6,0.8571428571428571,1,0.0,0,1,0,1,2,0,0,2,0,2,4,0
17237,161865,ZFgJH3XPKn6EjDuXV9VLOpKftzENCqEZ,A3fsA9Zfv1X2fVEQhTw51lKENdNrEqT3,1,0,0,0,0,0,1,0,1,0.14285714285714285,1,0.0,0,0,0,0,0,0,0,1,0,0,1,0
17238,161876,rwuM6JXyr9NW5skD2mjToJGXTpHNXOXm,7GRhBDsirIGkRZBtSMEzNTyDr2JQm4xx,14,11,5,4,4,4,11,0,39,5.571428571428571,2,0.0,3,5,3,4,8,4,1,11,0,15,24,1
17239,161903,UtNvwiEIu7iQRo2Po9FxglHJbAYaDW68,7GRhBDsirIGkRZBtSMEzNTyDr2JQm4xx,34,69,4,81,1,23,10,0,188,26.857142857142858,4,0.0,39,4,65,1,30,23,16,10,0,109,79,0
17240,161916,UwYS4S13mN9PKtlnG61IUx3MqUPXsSwd,7GRhBDsirIGkRZBtSMEzNTyDr2JQm4xx,1,0,0,0,0,0,1,0,1,0.14285714285714285,1,0.0,0,0,0,0,0,0,0,1,0,0,1,1
17241,161917,ClHMnOLy9vZKRtNjcA9yPWajeNvRCNdE,7GRhBDsirIGkRZBtSMEzNTyDr2JQm4xx,56,109,23,119,17,1,4,0,273,39.0,2,0.0,48,23,106,17,61,1,13,4,0,194,79,1
17242,161935,uKGXhzbiDEpxCHjVlf9dmkGcQbxLosVe,7GRhBDsirIGkRZBtSMEzNTyDr2JQm4xx,18,16,11,0,8,1,9,1,46,6.571428571428571,2,0.0,0,11,0,8,16,1,0,9,1,19,27,1
17243,161939,5kEshmgSAUGvBEOsnsKU8IViB0lkOwoD,7GRhBDsirIGkRZBtSMEzNTyDr2JQm4xx,10,5,0,48,0,0,2,0,55,7.857142857142857,1,0.0,2,0,43,0,3,0,5,2,0,45,10,1
17244,161962,wuCb3DAs0UTa3nnL6gSfoBgjTkpbfyNt,A3fsA9Zfv1X2fVEQhTw51lKENdNrEqT3,1,0,0,0,0,0,1,0,1,0.14285714285714285,1,0.0,0,0,0,0,0,0,0,1,0,0,1,0
17245,161972,MXpZg6Y3WvwOURUS1VvgXTxhk1pXKVY7,7GRhBDsirIGkRZBtSMEzNTyDr2JQm4xx,13,11,5,12,6,0,1,0,35,5.0,1,0.0,5,5,10,6,6,0,2,1,0,26,9,1
17246,161991,okqN4nBVKRYYrkYonKicKGOmPqVGYjZh,A3fsA9Zfv1X2fVEQhTw51lKENdNrEqT3,10,25,12,0,0,0,10,0,47,6.714285714285714,1,0.0,0,12,0,0,25,0,0,10,0,12,35,0
17247,161994,ePOpOKycvORTPdc6DfieYb44dd8ej3gR,7GRhBDsirIGkRZBtSMEzNTyDr2JQm4xx,1,0,0,0,0,0,1,0,1,0.14285714285714285,1,0.0,0,0,0,0,0,0,0,1,0,0,1,1
17248,162040,ljX4THfec0iaVpl2l8F599zDiKVqZpK6,A3fsA9Zfv1X2fVEQhTw51lKENdNrEqT3,2,0,0,0,0,0,4,0,4,0.5714285714285714,1,0.0,0,0,0,0,0,0,0,4,0,0,4,1
17249,162062,J8ozccvPLhHs7wXw9VrsAZ8xFj3qhhGw,7GRhBDsirIGkRZBtSMEzNTyDr2JQm4xx,9,14,6,4,1,1,3,0,29,4.142857142857143,2,0.0,2,6,3,1,12,1,1,3,0,12,17,1
17250,162080,FsMHOscTVODbpYdAffAhuuXsQ63LCkVz,5X6FeZozNMgE2VRi3MJYjkkFK8SETtu2,7,5,1,4,2,0,2,0,14,2.0,1,0.0,2,1,3,2,3,0,1,2,0,8,6,1
17251,162105,iJS4NO25TGJOkDkxwNThNbes0mRasAmQ,7GRhBDsirIGkRZBtSMEzNTyDr2JQm4xx,19,19,11,16,12,0,4,0,62,8.857142857142858,2,0.0,4,11,14,12,15,0,2,4,0,41,21,1
17252,162117,oBhK6ZD6VFllj6i4Noya3bCJzaI8iNet,A3fsA9Zfv1X2fVEQhTw51lKENdNrEqT3,1,0,0,0,0,0,1,0,1,0.14285714285714285,1,0.0,0,0,0,0,0,0,0,1,0,0,1,1
17253,162121,jjgQ4rbsYW6nenx45QcLulM61xyCV5lA,7GRhBDsirIGkRZBtSMEzNTyDr2JQm4xx,1,0,0,0,0,0,1,0,1,0.14285714285714285,1,0.0,0,0,0,0,0,0,0,1,0,0,1,1
17254,162124,pSzhuUpWpfZJPijy3Bgn04mmCNcKuKcZ,A3fsA9Zfv1X2fVEQhTw51lKENdNrEqT3,2,0,0,0,0,0,2,0,2,0.2857142857142857,1,0.0,0,0,0,0,0,0,0,2,0,0,2,0
17255,162133,d2uTyoX8GsJTijOZ2YwLrQ9V4yvysuAD,A3fsA9Zfv1X2fVEQhTw51lKENdNrEqT3,1,0,0,0,0,0,1,0,1,0.14285714285714285,1,0.0,0,0,0,0,0,0,0,1,0,0,1,1
17256,162142,LY9nTJ3l87DIdhCcp8BvVsM9WvKuQkhN,A3fsA9Zfv1X2fVEQhTw51lKENdNrEqT3,1,0,0,0,0,0,1,0,1,0.14285714285714285,1,0.0,0,0,0,0,0,0,0,1,0,0,1,1
17257,162144,3vT4zJ39DstZlKPcmpcZTRrY5vbUxYe0,5X6FeZozNMgE2VRi3MJYjkkFK8SETtu2,27,26,6,23,17,0,4,0,76,10.857142857142858,1,0.0,19,6,18,17,7,0,5,4,0,60,16,1
17258,162150,bqpZwouZwQ5xHmLGiTtvVWcQOPxhka8z,A3fsA9Zfv1X2fVEQhTw51lKENdNrEqT3,1,0,0,0,0,0,1,0,1,0.14285714285714285,1,0.0,0,0,0,0,0,0,0,1,0,0,1,1
17259,162160,oBhK6ZD6VFllj6i4Noya3bCJzaI8iNet,7GRhBDsirIGkRZBtSMEzNTyDr2JQm4xx,1,0,0,0,0,0,1,0,1,0.14285714285714285,1,0.0,0,0,0,0,0,0,0,1,0,0,1,1
17260,162168,o69BaNn8nNwkn0WRwXTNaYgGrUvOyxv9,A3fsA9Zfv1X2fVEQhTw51lKENdNrEqT3,5,2,1,0,1,0,2,0,6,0.8571428571428571,1,0.0,0,1,0,1,2,0,0,2,0,2,4,1
17261,162190,t6ztTYDVbVNMRBeH7Gb2WlLivAtzAzp1,A3fsA9Zfv1X2fVEQhTw51lKENdNrEqT3,1,0,0,0,0,0,2,0,2,0.2857142857142857,1,0.0,0,0,0,0,0,0,0,2,0,0,2,1
17262,162193,4RiemE5r88jWq9gaL0lVYzjeUhWq3sNP,5X6FeZozNMgE2VRi3MJYjkkFK8SETtu2,1,0,0,0,0,0,1,0,1,0.14285714285714285,1,0.0,0,0,0,0,0,0,0,1,0,0,1,1
17263,162228,9FHojamNYxBNrQ6PYQ6fNVNJw4Al6wFf,A3fsA9Zfv1X2fVEQhTw51lKENdNrEqT3,2,0,0,0,0,0,2,0,2,0.2857142857142857,1,0.0,0,0,0,0,0,0,0,2,0,0,2,1
17264,162230,jimulXvpj9ggyKpMhPHOONMmf8Jnmqkr,A3fsA9Zfv1X2fVEQhTw51lKENdNrEqT3,1,0,0,0,0,0,1,0,1,0.14285714285714285,1,0.0,0,0,0,0,0,0,0,1,0,0,1,1
17265,162259,ZttplEH5TKj1WzPyzoO9Df2vFzi15P8B,7GRhBDsirIGkRZBtSMEzNTyDr2JQm4xx,5,2,1,0,1,0,2,0,6,0.8571428571428571,1,0.0,0,1,0,1,2,0,0,2,0,2,4,0
17266,162270,CXpq1UcG0elhHuiCZeD2FXcwR7rCcPqM,7GRhBDsirIGkRZBtSMEzNTyDr2JQm4xx,1,0,0,0,0,0,1,0,1,0.14285714285714285,1,0.0,0,0,0,0,0,0,0,1,0,0,1,1
17267,162272,CXpq1UcG0elhHuiCZeD2FXcwR7rCcPqM,A3fsA9Zfv1X2fVEQhTw51lKENdNrEqT3,1,0,0,0,0,0,3,0,3,0.42857142857142855,1,0.0,0,0,0,0,0,0,0,3,0,0,3,1
17268,162277,0D6hqHK4bxIFi4VUAoCI5xw3MhWFUe8Q,A3fsA9Zfv1X2fVEQhTw51lKENdNrEqT3,4,2,0,0,0,0,2,0,4,0.5714285714285714,2,0.0,0,0,0,0,2,0,0,2,0,0,4,1
17269,162296,y9BxmAhm0ieCF6b0HaF7gMrGu5BDtZs5,A3fsA9Zfv1X2fVEQhTw51lKENdNrEqT3,5,3,1,0,1,0,2,0,7,1.0,1,0.0,0,1,0,1,3,0,0,2,0,2,5,1
17270,162310,IY2XGmMLdQpnN2CAArJJlJXjbbQc8pm5,7GRhBDsirIGkRZBtSMEzNTyDr2JQm4xx,9,3,3,0,3,0,4,1,14,2.0,1,0.0,0,3,0,3,3,0,0,4,1,6,8,1
17271,162311,gmqCuQTX0aljJXYwlMbQKWVNQXzJBU7z,A3fsA9Zfv1X2fVEQhTw51lKENdNrEqT3,2,0,0,0,0,0,2,0,2,0.2857142857142857,1,0.0,0,0,0,0,0,0,0,2,0,0,2,1
17272,162313,Ql4EosuzRo0tVj3lvTLhkLOyEsWZly6m,7GRhBDsirIGkRZBtSMEzNTyDr2JQm4xx,18,17,6,27,7,3,4,0,64,9.142857142857142,1,0.0,8,6,24,7,9,3,3,4,0,45,19,1
17273,162315,eLddk0FueVUEJUwpfOsyoO4vLUtPFHIZ,7GRhBDsirIGkRZBtSMEzNTyDr2JQm4xx,2,0,0,0,0,0,2,0,2,0.2857142857142857,1,0.0,0,0,0,0,0,0,0,2,0,0,2,1
17274,162321,FRqEtBjptiNhO97ht9j9vzryGlyCBOWn,7GRhBDsirIGkRZBtSMEzNTyDr2JQm4xx,1,0,0,0,0,0,1,0,1,0.14285714285714285,1,0.0,0,0,0,0,0,0,0,1,0,0,1,1
17275,162337,0nFyUZaDVH1PSi5FtCjV36vvFavCp4ho,A3fsA9Zfv1X2fVEQhTw51lKENdNrEqT3,13,7,6,2,5,0,2,0,22,3.142857142857143,1,0.0,0,6,2,5,7,0,0,2,0,13,9,0
17276,162339,vr7UNhViMDdJF7B4rxUsG86xKgSPETfh,A3fsA9Zfv1X2fVEQhTw51lKENdNrEqT3,2,0,0,0,0,0,4,0,4,0.5714285714285714,1,0.0,0,0,0,0,0,0,0,4,0,0,4,0
17277,162361,SRWyybFCyRnJ5WkAnmW9p9zBXOYVWjli,7GRhBDsirIGkRZBtSMEzNTyDr2JQm4xx,8,4,3,0,3,0,3,1,14,2.0,1,0.0,0,3,0,3,4,0,0,3,1,6,8,1
17278,162368,1YVvREjW4GG7vGtDdZTgfavzuWoJyEQ1,7GRhBDsirIGkRZBtSMEzNTyDr2JQm4xx,3,2,1,0,0,0,1,0,4,0.5714285714285714,1,0.0,0,1,0,0,2,0,0,1,0,1,3,1
17279,162369,1YVvREjW4GG7vGtDdZTgfavzuWoJyEQ1,5X6FeZozNMgE2VRi3MJYjkkFK8SETtu2,1,0,0,0,0,0,1,0,1,0.14285714285714285,1,0.0,0,0,0,0,0,0,0,1,0,0,1,1
17280,162378,uOV3GBCPhULZPBZnCwKgG0YBOJnOfVml,3VkHkmOtom3jM2wCu94xgzzu1d6Dn7or,7,3,2,0,2,0,2,0,9,1.2857142857142858,1,0.0,0,2,0,2,3,0,0,2,0,4,5,1
17281,162385,SgKrhpJALurepOABWGyRDMg2VKaiEXGw,3VkHkmOtom3jM2wCu94xgzzu1d6Dn7or,1,0,0,0,0,0,2,0,2,0.2857142857142857,1,0.0,0,0,0,0,0,0,0,2,0,0,2,1
17282,162387,u6UCPJeMEh5WJztDUwvAuENbXAf4tGi5,3VkHkmOtom3jM2wCu94xgzzu1d6Dn7or,5,2,1,0,1,0,2,0,6,0.8571428571428571,1,0.0,0,1,0,1,2,0,0,2,0,2,4,1
17283,162410,diOjRyJTE5fcnt28dWvk5tAqd4L0ApRl,3VkHkmOtom3jM2wCu94xgzzu1d6Dn7or,1,0,0,0,0,0,1,0,1,0.14285714285714285,1,0.0,0,0,0,0,0,0,0,1,0,0,1,1
17284,162429,CanH85coLijOUn4q3pdFOsHu83jlCEIK,3VkHkmOtom3jM2wCu94xgzzu1d6Dn7or,5,2,1,0,1,0,2,0,6,0.8571428571428571,1,0.0,0,1,0,1,2,0,0,2,0,2,4,1
17285,162434,xd0lwkEB3jsQMwhsGMBi7U480TqLt7kG,3VkHkmOtom3jM2wCu94xgzzu1d6Dn7or,3,0,0,0,0,0,3,1,4,0.5714285714285714,1,0.0,0,0,0,0,0,0,0,3,1,0,4,1
17286,162448,2i6mfSeYIJuVvHSJlIbgdshMI8YRpVao,3VkHkmOtom3jM2wCu94xgzzu1d6Dn7or,2,0,0,0,0,0,3,0,3,0.42857142857142855,1,0.0,0,0,0,0,0,0,0,3,0,0,3,1
17287,162465,4wXrBdzSw8jxJgXxPDlRDHjWz9op89qK,3VkHkmOtom3jM2wCu94xgzzu1d6Dn7or,1,0,0,0,0,0,1,0,1,0.14285714285714285,1,0.0,0,0,0,0,0,0,0,1,0,0,1,1
17288,162470,sEjCSxiV4U3FouTICvcD4zFUuMByUanv,3VkHkmOtom3jM2wCu94xgzzu1d6Dn7or,1,0,0,0,0,0,1,0,1,0.14285714285714285,1,0.0,0,0,0,0,0,0,0,1,0,0,1,1
17289,162477,WGacPM6qZFCWGlZ0G4KuqZ9fCoWNwA7p,3VkHkmOtom3jM2wCu94xgzzu1d6Dn7or,8,6,1,0,2,1,5,1,16,2.2857142857142856,1,0.0,1,1,0,2,5,1,0,5,1,4,12,1
17290,162501,fFPhCaxB3mxzV0UdDbvnXIgDUrhjU2Bc,3VkHkmOtom3jM2wCu94xgzzu1d6Dn7or,6,7,1,0,1,0,4,0,13,1.8571428571428572,2,0.0,2,1,0,1,5,0,0,4,0,4,9,1
17291,162509,pB0FiLfIyBa7HD5W1vjx0uRVNEM62PCY,3VkHkmOtom3jM2wCu94xgzzu1d6Dn7or,5,6,1,0,2,3,3,0,15,2.142857142857143,2,0.0,1,1,0,2,5,3,0,3,0,4,11,1
17292,162518,iRO6vDma14A8G1ldmHvBCjBm026HQCox,3VkHkmOtom3jM2wCu94xgzzu1d6Dn7or,5,9,3,0,1,0,1,0,14,2.0,1,0.0,0,3,0,1,9,0,0,1,0,4,10,1
17293,162529,zzh7OhB1yuFx7KNMW6cKx1t3e2ezVcvZ,3VkHkmOtom3jM2wCu94xgzzu1d6Dn7or,7,11,0,0,3,0,4,0,18,2.5714285714285716,1,0.0,0,0,0,3,11,0,0,4,0,3,15,1
17294,162531,Aw00VvkW9rmqasUs0q7ZSvy1Gg7Z6ebd,3VkHkmOtom3jM2wCu94xgzzu1d6Dn7or,1,0,0,0,0,0,1,0,1,0.14285714285714285,1,0.0,0,0,0,0,0,0,0,1,0,0,1,1
17295,162553,2Y3h62Lps0fU6B3C4MXM4YNVNDf25XBr,3VkHkmOtom3jM2wCu94xgzzu1d6Dn7or,1,0,0,0,0,0,1,0,1,0.14285714285714285,1,0.0,0,0,0,0,0,0,0,1,0,0,1,1
17296,162554,ci2ik5flSMTiMTZcnxXAKT9yXYBEPMmU,3VkHkmOtom3jM2wCu94xgzzu1d6Dn7or,2,0,0,0,0,0,2,0,2,0.2857142857142857,1,0.0,0,0,0,0,0,0,0,2,0,0,2,1
17297,162600,qOyslTiakZd1Jt0NRefFu3YFDZVo5cgp,3VkHkmOtom3jM2wCu94xgzzu1d6Dn7or,1,0,0,0,0,0,1,0,1,0.14285714285714285,1,0.0,0,0,0,0,0,0,0,1,0,0,1,1
17298,162611,JQU9lWLQJmOjD6zJfnfdXPo0FGrEYCG2,3VkHkmOtom3jM2wCu94xgzzu1d6Dn7or,8,2,1,0,1,4,8,2,18,2.5714285714285716,1,0.0,0,1,0,1,2,4,0,8,2,2,16,1
17299,162626,ZEwv3NBFks1XktlhlOtqVFJ0Zf9N8CgP,3VkHkmOtom3jM2wCu94xgzzu1d6Dn7or,1,0,0,0,0,0,1,0,1,0.14285714285714285,1,0.0,0,0,0,0,0,0,0,1,0,0,1,1
17300,162647,bKnFyTIy0p7ANwTaSX7Db0o0G6jk2VUf,3VkHkmOtom3jM2wCu94xgzzu1d6Dn7or,5,4,2,0,2,0,3,0,11,1.5714285714285714,1,0.0,1,2,0,2,3,0,0,3,0,5,6,1
17301,162648,Nc3ZZeizgzMQ7ljgRcfUdDiH0EOAXMpI,fbPkOYLVPtPgIt0MxizjfFJov3JbHyAi,10,19,12,2,7,0,7,0,47,6.714285714285714,5,0.0,1,12,2,7,18,0,0,7,0,22,25,1
17302,162649,0KUBjckzhPh04pcpref906kWaVGOckIo,fbPkOYLVPtPgIt0MxizjfFJov3JbHyAi,1,0,0,0,0,0,1,0,1,0.14285714285714285,1,0.0,0,0,0,0,0,0,0,1,0,0,1,1
17303,162650,V6E1tx9saR5jAji0JFYWv5QlYX2evnTz,fbPkOYLVPtPgIt0MxizjfFJov3JbHyAi,5,4,1,0,1,0,1,0,7,1.0,1,0.0,0,1,0,1,4,0,0,1,0,2,5,1
17304,162651,YowQZlyvBksxQT6KgTXhQMJmbU93kRLD,fbPkOYLVPtPgIt0MxizjfFJov3JbHyAi,9,4,3,0,2,0,6,0,15,2.142857142857143,2,0.0,0,3,0,2,4,0,0,6,0,5,10,1
17305,162652,ez8FDX1i0b7pyEME5JxBBRyGHo5i1NxT,fbPkOYLVPtPgIt0MxizjfFJov3JbHyAi,5,2,1,0,1,0,11,0,15,2.142857142857143,1,0.0,0,1,0,1,2,0,0,11,0,2,13,1
17306,162656,KSRVmTGtqcEHSDvxEeA6R7dUXFztkOiS,fbPkOYLVPtPgIt0MxizjfFJov3JbHyAi,9,3,2,0,2,1,10,0,18,2.5714285714285716,1,0.0,0,2,0,2,3,1,0,10,0,4,14,1
17307,162657,2D1HXSTD406ltsrZw4ApG5jDeXzE2KN2,fbPkOYLVPtPgIt0MxizjfFJov3JbHyAi,9,4,3,0,3,0,6,1,17,2.4285714285714284,1,0.0,0,3,0,3,4,0,0,6,1,6,11,1
17308,162658,xC5auIx5EjJCsJXVxhOLOCVWQh5LEXXH,fbPkOYLVPtPgIt0MxizjfFJov3JbHyAi,6,7,4,0,0,0,1,0,12,1.7142857142857142,1,0.0,0,4,0,0,7,0,0,1,0,4,8,1
17309,162659,WSgIm6djd7gHeBntYx8K78vnaXdzEUiL,fbPkOYLVPtPgIt0MxizjfFJov3JbHyAi,1,0,0,0,0,0,1,0,1,0.14285714285714285,1,0.0,0,0,0,0,0,0,0,1,0,0,1,1
17310,162660,llYG1mfEDeV8Y5AFdIVbdEPymP3mr3rj,fbPkOYLVPtPgIt0MxizjfFJov3JbHyAi,6,2,1,0,1,0,3,0,7,1.0,1,0.0,0,1,0,1,2,0,0,3,0,2,5,1
17311,162661,KZBxo2oXfcrXYFa3c9hEkQ12gjuvG6yO,fbPkOYLVPtPgIt0MxizjfFJov3JbHyAi,15,28,12,0,5,0,9,0,54,7.714285714285714,2,0.0,2,12,0,5,26,0,0,9,0,19,35,1
17312,162666,naFnVVivN8IeDypOt2hjD9CIwDCj76XP,fbPkOYLVPtPgIt0MxizjfFJov3JbHyAi,9,4,3,0,3,0,4,0,14,2.0,1,0.0,0,3,0,3,4,0,0,4,0,6,8,1
17313,162671,MH888ZUNYQEtzY7davmN9IOBnnNRrZa7,fbPkOYLVPtPgIt0MxizjfFJov3JbHyAi,2,0,0,0,0,0,6,0,6,0.8571428571428571,1,0.0,0,0,0,0,0,0,0,6,0,0,6,1
17314,162673,7l3GpI16MslYkR5zIHoJyawqfDaUFhUp,fbPkOYLVPtPgIt0MxizjfFJov3JbHyAi,15,33,10,16,13,7,8,0,87,12.428571428571429,3,0.0,15,10,13,13,18,7,3,8,0,51,36,1
17315,162676,yYnx2Djc2xdWmysqfYS5LaytJ644aZht,fbPkOYLVPtPgIt0MxizjfFJov3JbHyAi,10,14,7,0,6,3,6,1,37,5.285714285714286,1,0.0,4,7,0,6,10,3,0,6,1,17,20,1
17316,162678,QLkjPbhzjYBuoRyN6jpM1zgzPhFcXPgV,fbPkOYLVPtPgIt0MxizjfFJov3JbHyAi,7,2,1,0,1,0,6,1,11,1.5714285714285714,1,0.0,0,1,0,1,2,0,0,6,1,2,9,1
17317,162679,4wGoSTuzJXBCojeNmaxk9GbR1KaCV7ql,fbPkOYLVPtPgIt0MxizjfFJov3JbHyAi,1,0,0,0,0,0,1,0,1,0.14285714285714285,1,0.0,0,0,0,0,0,0,0,1,0,0,1,1
17318,162680,Zt0s8z7D4BOSO5NcolkhNghzd1kCk6hq,fbPkOYLVPtPgIt0MxizjfFJov3JbHyAi,1,0,0,0,0,0,1,0,1,0.14285714285714285,1,0.0,0,0,0,0,0,0,0,1,0,0,1,1
17319,162681,uoKTE5T5YjIuFpYd6T7OJca437ewpV5r,fbPkOYLVPtPgIt0MxizjfFJov3JbHyAi,7,4,3,0,2,1,5,0,15,2.142857142857143,1,0.0,0,3,0,2,4,1,0,5,0,5,10,1
17320,162682,pvA5hAXeC4hqGygcnZUaZJq577cEj1jy,fbPkOYLVPtPgIt0MxizjfFJov3JbHyAi,4,2,0,0,0,0,4,0,6,0.8571428571428571,1,0.0,0,0,0,0,2,0,0,4,0,0,6,1
17321,162685,VW6QI6YQieHfuGH7gHn8hEJuMvSxxHAp,fbPkOYLVPtPgIt0MxizjfFJov3JbHyAi,7,6,4,0,3,0,2,0,15,2.142857142857143,1,0.0,0,4,0,3,6,0,0,2,0,7,8,1
17322,162687,y8AdDSbHENRUD5ii0AuyONW5YY98sBlv,fbPkOYLVPtPgIt0MxizjfFJov3JbHyAi,2,0,0,0,0,0,2,0,2,0.2857142857142857,1,0.0,0,0,0,0,0,0,0,2,0,0,2,1
17323,162689,OY5aMjVZYmvVnPhf0Ien1tS1qoTzYCve,fbPkOYLVPtPgIt0MxizjfFJov3JbHyAi,1,0,0,0,0,0,1,0,1,0.14285714285714285,1,0.0,0,0,0,0,0,0,0,1,0,0,1,1
17324,162690,4fAtuZyf3pqLNg4NAgnHL2LTveUsNAHR,fbPkOYLVPtPgIt0MxizjfFJov3JbHyAi,12,13,0,0,0,0,10,2,25,3.5714285714285716,2,0.0,1,0,0,0,12,0,0,10,2,1,24,1
17325,162691,RXL48ch4QpTtcFwRepyduTfKEKrGyTKN,fbPkOYLVPtPgIt0MxizjfFJov3JbHyAi,9,16,8,0,4,2,10,0,40,5.714285714285714,2,0.0,1,8,0,4,15,2,0,10,0,13,27,1
17326,162692,gwOQCfMjy3mPEOM9frEBJIEoEp54k479,fbPkOYLVPtPgIt0MxizjfFJov3JbHyAi,7,5,2,0,2,0,4,0,13,1.8571428571428572,1,0.0,2,2,0,2,3,0,0,4,0,6,7,1
17327,162693,cAiYY43X2fHcaVTtJkfbXwU4uE2YSYcT,fbPkOYLVPtPgIt0MxizjfFJov3JbHyAi,1,0,0,0,0,0,1,0,1,0.14285714285714285,1,0.0,0,0,0,0,0,0,0,1,0,0,1,1
17328,162694,Ht6ACDtkBUDQYG2zJ9PW4yD5omwx8FOt,fbPkOYLVPtPgIt0MxizjfFJov3JbHyAi,14,13,10,0,7,1,10,0,41,5.857142857142857,2,0.0,0,10,0,7,13,1,0,10,0,17,24,1
17329,162695,HjTLxjkRtxfAyk5V8KdvHAETDClCPqM8,fbPkOYLVPtPgIt0MxizjfFJov3JbHyAi,2,0,0,0,0,0,2,0,2,0.2857142857142857,1,0.0,0,0,0,0,0,0,0,2,0,0,2,1
17330,162696,d0rOxeHVhXN56S1SdxDqutEizIO79l17,fbPkOYLVPtPgIt0MxizjfFJov3JbHyAi,7,2,1,0,1,0,5,0,9,1.2857142857142858,1,0.0,0,1,0,1,2,0,0,5,0,2,7,1
17331,162697,itGGfLzW4kinBqXhqpdYcm0uN1rV3AUu,fbPkOYLVPtPgIt0MxizjfFJov3JbHyAi,8,2,1,0,1,35,10,1,50,7.142857142857143,1,0.0,0,1,0,1,2,35,0,10,1,2,48,1
17332,162698,Qkc0CJeX5rSUk4cMC7WmTWxFf636HopV,fbPkOYLVPtPgIt0MxizjfFJov3JbHyAi,7,3,2,0,2,0,2,0,9,1.2857142857142858,2,0.0,0,2,0,2,3,0,0,2,0,4,5,1
17333,162699,zOMqB2xbzDTe4odeoQFhdTt3CHQxy4f2,fbPkOYLVPtPgIt0MxizjfFJov3JbHyAi,5,2,1,0,1,0,3,0,7,1.0,1,0.0,0,1,0,1,2,0,0,3,0,2,5,1
17334,162701,CqDZkF3Y4Ub1OGba7JosAdKhIi9VL2wR,fbPkOYLVPtPgIt0MxizjfFJov3JbHyAi,8,3,2,0,2,0,3,0,10,1.4285714285714286,1,0.0,0,2,0,2,3,0,0,3,0,4,6,1
17335,162703,Vvmg4GFkxtES0j2sr2rm1vhisTqz0hYp,fbPkOYLVPtPgIt0MxizjfFJov3JbHyAi,1,0,0,0,0,0,1,0,1,0.14285714285714285,1,0.0,0,0,0,0,0,0,0,1,0,0,1,1
17336,162705,EXeNK59x0ypZcTmicRInOt3hG7yAskPL,fbPkOYLVPtPgIt0MxizjfFJov3JbHyAi,1,0,0,0,0,0,1,0,1,0.14285714285714285,1,0.0,0,0,0,0,0,0,0,1,0,0,1,1
17337,162707,cqdnmjbJq0lDv2xgeKuzXqVr5xQytWr0,fbPkOYLVPtPgIt0MxizjfFJov3JbHyAi,1,0,0,0,0,0,1,0,1,0.14285714285714285,1,0.0,0,0,0,0,0,0,0,1,0,0,1,1
17338,162709,gD7dR7qYBA1tFY5jHEs9UR01plTA8iId,fbPkOYLVPtPgIt0MxizjfFJov3JbHyAi,8,8,5,0,2,0,4,0,19,2.7142857142857144,1,0.0,0,5,0,2,8,0,0,4,0,7,12,1
17339,162712,cXYqUXWJSTT7g3JkZOD6VVFxaOdV583i,fbPkOYLVPtPgIt0MxizjfFJov3JbHyAi,12,10,7,0,7,0,1,0,25,3.5714285714285716,1,0.0,1,7,0,7,9,0,0,1,0,15,10,1
17340,162714,HwZxiuOTyvjMb92UmTQViLX9URtxzqcc,fbPkOYLVPtPgIt0MxizjfFJov3JbHyAi,5,3,1,0,1,0,2,0,7,1.0,1,0.0,0,1,0,1,3,0,0,2,0,2,5,1
17341,162718,lFYUqaC8DDbyzlpsvaLNmtptRSgKf6hQ,5Gyp41oLVo7Gg7vF4vpmggWP5MU70QO6,14,27,11,4,8,0,6,0,56,8.0,1,0.0,6,11,2,8,21,0,2,6,0,27,29,1
17342,162722,nlSetL9gA8PdgMyBwWPmXIZKvL389Wvz,5Gyp41oLVo7Gg7vF4vpmggWP5MU70QO6,8,8,3,0,2,0,10,0,23,3.2857142857142856,1,0.0,0,3,0,2,8,0,0,10,0,5,18,1
17343,162731,zOpl1QLMdi3RN3ezftwBd305gEk9qlj4,5Gyp41oLVo7Gg7vF4vpmggWP5MU70QO6,7,3,2,0,2,0,3,0,10,1.4285714285714286,1,0.0,0,2,0,2,3,0,0,3,0,4,6,1
17344,162735,9QTkMOaMHVfS6J8nswauls4qIiVW28S7,5Gyp41oLVo7Gg7vF4vpmggWP5MU70QO6,6,2,1,0,1,0,6,1,11,1.5714285714285714,2,0.0,0,1,0,1,2,0,0,6,1,2,9,1
17345,162737,xVCW9o5KqxAPnPVb1aenUpUZ6QWvEQCo,5Gyp41oLVo7Gg7vF4vpmggWP5MU70QO6,7,2,1,0,1,5,4,0,13,1.8571428571428572,1,0.0,0,1,0,1,2,5,0,4,0,2,11,1
17346,162746,dpsnO2nFdLg9XmGy3JleJNGIQPzaFF4U,5Gyp41oLVo7Gg7vF4vpmggWP5MU70QO6,4,2,0,0,0,0,3,0,5,0.7142857142857143,1,0.0,0,0,0,0,2,0,0,3,0,0,5,1
17347,162748,qJ6pGAhU9YH3dWsgEUqoanPcdcAk0sbr,5Gyp41oLVo7Gg7vF4vpmggWP5MU70QO6,8,6,4,0,3,0,5,0,18,2.5714285714285716,1,0.0,0,4,0,3,6,0,0,5,0,7,11,1
17348,162757,97rKVY7VtULS5cSVVXRfvKL2xj2p2K2g,5Gyp41oLVo7Gg7vF4vpmggWP5MU70QO6,10,6,2,0,1,1,8,1,19,2.7142857142857144,1,0.0,1,2,0,1,5,1,0,8,1,4,15,1
17349,162783,YvHnKE6OimroKzuRehZQSn9RJI3E9BpN,5Gyp41oLVo7Gg7vF4vpmggWP5MU70QO6,5,3,1,0,1,0,2,0,7,1.0,1,0.0,0,1,0,1,3,0,0,2,0,2,5,1
17350,162794,OysKzR1UEVPCXl0wSCjn9V0QgLV5NmCX,5Gyp41oLVo7Gg7vF4vpmggWP5MU70QO6,8,6,3,0,1,0,5,1,16,2.2857142857142856,1,0.0,0,3,0,1,6,0,0,5,1,4,12,1
17351,162800,K8tVmp5wiFryD3jk9LqI5fYSc6Xw95fz,5Gyp41oLVo7Gg7vF4vpmggWP5MU70QO6,1,0,0,0,0,0,1,0,1,0.14285714285714285,1,0.0,0,0,0,0,0,0,0,1,0,0,1,1
17352,162820,ChzLHYLLy0NerR7PrLzbpfdlhEVUipcm,5Gyp41oLVo7Gg7vF4vpmggWP5MU70QO6,9,3,2,0,2,0,4,0,11,1.5714285714285714,1,0.0,0,2,0,2,3,0,0,4,0,4,7,1
17353,162827,qAm5iTgVCKBmprSEwabFbnK8oXs3FFjT,5Gyp41oLVo7Gg7vF4vpmggWP5MU70QO6,1,0,0,0,0,0,1,0,1,0.14285714285714285,1,0.0,0,0,0,0,0,0,0,1,0,0,1,1
17354,162830,V5n4KmrCt6qTaNCHvn8AZsixldOhtrqM,5Gyp41oLVo7Gg7vF4vpmggWP5MU70QO6,8,9,6,0,4,0,5,0,24,3.4285714285714284,3,0.0,0,6,0,4,9,0,0,5,0,10,14,1
17355,162843,DUnTFXJLyJskCQxxzcdjCS794PUvsnpf,5Gyp41oLVo7Gg7vF4vpmggWP5MU70QO6,9,10,5,0,5,0,4,0,24,3.4285714285714284,1,0.0,2,5,0,5,8,0,0,4,0,12,12,1
17356,162857,jpeaz6SjEWnSbarewJDpBrwhKD14EETZ,5Gyp41oLVo7Gg7vF4vpmggWP5MU70QO6,7,3,2,0,2,1,2,0,10,1.4285714285714286,1,0.0,0,2,0,2,3,1,0,2,0,4,6,1
17357,162892,ghDdCHMpenNSgQDj8zPLL5gQmRbVZb3W,5Gyp41oLVo7Gg7vF4vpmggWP5MU70QO6,12,10,5,3,2,0,6,1,27,3.857142857142857,2,0.0,3,5,2,2,7,0,1,6,1,12,15,1
17358,162894,yI6TnEdeRXOHoLYUJXYNBvoqqL23yrRt,5Gyp41oLVo7Gg7vF4vpmggWP5MU70QO6,1,0,0,0,0,0,1,0,1,0.14285714285714285,1,0.0,0,0,0,0,0,0,0,1,0,0,1,1
17359,162925,CfIEXK3xglklk8przSjO3ca2uY3X9RYV,5Gyp41oLVo7Gg7vF4vpmggWP5MU70QO6,11,6,5,0,5,0,2,0,18,2.5714285714285716,1,0.0,0,5,0,5,6,0,0,2,0,10,8,1
17360,162932,vdRCC0h1jyX5w0Fdkdj4bKRro4Amx6xH,5Gyp41oLVo7Gg7vF4vpmggWP5MU70QO6,6,2,1,0,1,0,3,0,7,1.0,1,0.0,0,1,0,1,2,0,0,3,0,2,5,1
17361,162933,dRlbPCu3UtdgQ7UtujQP87Y5bL1jXTJw,5Gyp41oLVo7Gg7vF4vpmggWP5MU70QO6,1,0,0,0,0,0,1,0,1,0.14285714285714285,1,0.0,0,0,0,0,0,0,0,1,0,0,1,1
17362,162936,f7neqK5VAQO37ru5uhidAaG8lJCjXCKS,5Gyp41oLVo7Gg7vF4vpmggWP5MU70QO6,1,0,0,0,0,0,1,0,1,0.14285714285714285,1,0.0,0,0,0,0,0,0,0,1,0,0,1,1
17363,162940,W10A8T2jCGdEgLVGHe6uM3Tii0X2ffH8,5Gyp41oLVo7Gg7vF4vpmggWP5MU70QO6,7,3,2,0,2,0,2,0,9,1.2857142857142858,1,0.0,0,2,0,2,3,0,0,2,0,4,5,1
17364,162950,5zW5PyiJVNvMfg9iMsdCsoLMsm2pszwe,5Gyp41oLVo7Gg7vF4vpmggWP5MU70QO6,1,0,0,0,0,0,1,0,1,0.14285714285714285,1,0.0,0,0,0,0,0,0,0,1,0,0,1,1
17365,163119,roYkXgGyx3GWrvCQLlmWjFgv8fXNpbMZ,7GRhBDsirIGkRZBtSMEzNTyDr2JQm4xx,15,13,4,74,2,0,2,0,95,13.571428571428571,1,0.0,6,4,66,2,7,0,8,2,0,78,17,1
17366,163123,Fyuejl2dlbgFcYdGhx8H5nzT5OEI84Gi,7GRhBDsirIGkRZBtSMEzNTyDr2JQm4xx,14,23,0,12,1,6,1,0,43,6.142857142857143,1,0.0,14,0,6,1,9,6,6,1,0,21,22,1
17367,163126,jcZzyelmNOUxuY7TWiZZyoS3gSdLYxDW,5X6FeZozNMgE2VRi3MJYjkkFK8SETtu2,2,0,0,0,0,0,3,0,3,0.42857142857142855,1,0.0,0,0,0,0,0,0,0,3,0,0,3,1
17368,163131,MyVMQFGo6UgMVH1DFRBNDeO95qBhMkx2,5X6FeZozNMgE2VRi3MJYjkkFK8SETtu2,1,0,0,0,0,0,1,0,1,0.14285714285714285,1,0.0,0,0,0,0,0,0,0,1,0,0,1,1
17369,163140,yRnajANt7LOq4B1hOGSgC8hdBn0DyFi6,5X6FeZozNMgE2VRi3MJYjkkFK8SETtu2,1,0,0,0,0,0,2,0,2,0.2857142857142857,1,0.0,0,0,0,0,0,0,0,2,0,0,2,1
17370,163143,0Hsb4jmfnz1a6io2949XgCNHeNRXVX7s,7GRhBDsirIGkRZBtSMEzNTyDr2JQm4xx,2,0,0,0,0,0,2,0,2,0.2857142857142857,1,0.0,0,0,0,0,0,0,0,2,0,0,2,1
17371,163164,OnCJ5oUOuIvHHhQxtwxg0lrLrlAmNpUv,5X6FeZozNMgE2VRi3MJYjkkFK8SETtu2,19,29,1,16,5,1,5,0,57,8.142857142857142,2,0.0,13,1,15,5,16,1,1,5,0,34,23,1
17372,163169,tZMtcgGsCq7JvLpFL4lhYMv0agvGaZe2,7GRhBDsirIGkRZBtSMEzNTyDr2JQm4xx,10,6,1,0,1,1,6,0,15,2.142857142857143,2,0.0,0,1,0,1,6,1,0,6,0,2,13,1
17373,163179,s6B1c6HsYtYgFfNQaANtHBiEvk3BxrNI,7GRhBDsirIGkRZBtSMEzNTyDr2JQm4xx,4,1,0,0,0,5,4,0,10,1.4285714285714286,1,0.0,0,0,0,0,1,5,0,4,0,0,10,1
17374,163201,3Mkd8wUIycmVOp3bXkQhrkLLJQvE7obi,7GRhBDsirIGkRZBtSMEzNTyDr2JQm4xx,1,0,0,0,0,0,2,0,2,0.2857142857142857,1,0.0,0,0,0,0,0,0,0,2,0,0,2,1
17375,163212,qPinNnuwG11dRyXbHR9eoc8JbfTOf2YH,7GRhBDsirIGkRZBtSMEzNTyDr2JQm4xx,1,0,0,0,0,0,1,0,1,0.14285714285714285,1,0.0,0,0,0,0,0,0,0,1,0,0,1,1
17376,163213,qPinNnuwG11dRyXbHR9eoc8JbfTOf2YH,5X6FeZozNMgE2VRi3MJYjkkFK8SETtu2,1,0,0,0,0,0,2,0,2,0.2857142857142857,1,0.0,0,0,0,0,0,0,0,2,0,0,2,1
17377,163220,8Cr8Vd1mU7TZdVM3CmCM42IjN2PAOQUN,7GRhBDsirIGkRZBtSMEzNTyDr2JQm4xx,32,42,14,24,11,0,2,0,93,13.285714285714286,1,0.0,22,14,13,11,20,0,11,2,0,60,33,0
17378,163260,xWEkYGAfNptAwZnPYzVBCVMgcZk3qKaB,7GRhBDsirIGkRZBtSMEzNTyDr2JQm4xx,7,21,1,2,0,0,2,0,26,3.7142857142857144,1,0.0,5,1,1,0,16,0,1,2,0,7,19,1
17379,163270,qnvX4ck8f7yWnykYmnmSide0xnZ2M9gG,7GRhBDsirIGkRZBtSMEzNTyDr2JQm4xx,7,5,2,0,3,0,4,1,15,2.142857142857143,1,0.0,2,2,0,3,3,0,0,4,1,7,8,1
17380,163297,QjCKOuadW7uvxwklu6VUWdeXSYG5ZySL,7GRhBDsirIGkRZBtSMEzNTyDr2JQm4xx,5,2,1,0,1,0,2,0,6,0.8571428571428571,1,0.0,0,1,0,1,2,0,0,2,0,2,4,1
17381,163306,Wd5Y51TL4njlLeYHUjz5D9nrsHvDXUZ8,7GRhBDsirIGkRZBtSMEzNTyDr2JQm4xx,1,0,0,0,0,0,1,0,1,0.14285714285714285,1,0.0,0,0,0,0,0,0,0,1,0,0,1,1
17382,163445,xXU9KJwMH5fbM7NnMKoHs3jEsDiPaALW,bWdj2GDclj5ofokWjzoa5jAwMkxCykd6,8,9,0,4,1,0,11,0,25,3.5714285714285716,2,0.0,5,0,3,1,4,0,1,11,0,9,16,1
17383,163449,vrjYYhgraDUMACavD1Jq29AQHFh2bMGk,SpATywNh6bZuzm8s1ceuBUnMUAeoAHHw,10,17,0,14,0,0,2,0,33,4.714285714285714,2,0.0,11,0,13,0,6,0,1,2,0,24,9,1
17384,163466,ASnkRnrOf1WwhiZJlBu5Rdb7kpMknjcy,SpATywNh6bZuzm8s1ceuBUnMUAeoAHHw,1,0,0,0,0,0,1,0,1,0.14285714285714285,1,0.0,0,0,0,0,0,0,0,1,0,0,1,1
17385,163470,vbOiF6cnlAMZD8LbHyglMTSugmHV6DHA,RXDvfPUBYFlVdlueBFbLW0mhhAyGEqpt,17,31,13,0,7,0,24,5,80,11.428571428571429,5,0.0,2,13,0,7,29,0,0,24,5,22,58,1
17386,163475,H8YHtkra0xamWmCl1rG6GNG1DeiG8zbG,bWdj2GDclj5ofokWjzoa5jAwMkxCykd6,15,32,0,104,0,14,9,0,159,22.714285714285715,1,0.0,6,0,97,0,26,14,7,9,0,103,56,1
17387,163480,6hX10Wu1E2KDRE7mYGP1VPoNRkdF7lrL,RXDvfPUBYFlVdlueBFbLW0mhhAyGEqpt,6,6,3,0,2,0,2,0,13,1.8571428571428572,1,0.0,0,3,0,2,6,0,0,2,0,5,8,1
17388,163483,pDYlcAIvVnBJ5nJ6t9DMrTdONniDYlEW,RXDvfPUBYFlVdlueBFbLW0mhhAyGEqpt,4,4,0,0,0,3,2,0,9,1.2857142857142858,1,0.0,0,0,0,0,4,3,0,2,0,0,9,1
17389,163490,QP9mUTxIKar5wOD0pjJi5ToJRWI6Qe58,G8EPVSXsOYB5YQWZGiz1aVq5Pgr2GrQu,9,11,0,0,0,0,6,0,17,2.4285714285714284,1,0.0,2,0,0,0,9,0,0,6,0,2,15,0
17390,163507,kGtpt8jv2taW68U9XPA4K4mRWM6eie4a,SpATywNh6bZuzm8s1ceuBUnMUAeoAHHw,9,7,5,0,4,0,4,1,21,3.0,1,0.0,0,5,0,4,7,0,0,4,1,9,12,1
17391,163509,z98RxEOJ89VINRwVTX4KbTlJYz09XMrh,SpATywNh6bZuzm8s1ceuBUnMUAeoAHHw,1,0,0,0,0,0,1,0,1,0.14285714285714285,1,0.0,0,0,0,0,0,0,0,1,0,0,1,1
17392,163510,5oLMWOENowYuBiosAAPZhmNDox994GEM,SpATywNh6bZuzm8s1ceuBUnMUAeoAHHw,14,25,13,16,0,6,26,8,94,13.428571428571429,2,0.0,5,13,13,0,20,6,3,26,8,31,63,1
17393,163514,VulnA8EYzLxbOoYdrjgIqZbvSkkMTK23,RXDvfPUBYFlVdlueBFbLW0mhhAyGEqpt,9,11,1,0,1,0,1,0,14,2.0,1,0.0,0,1,0,1,11,0,0,1,0,2,12,1
17394,163516,cnF5YfjX3CQt7JMSCL8P4leqdmCPbBni,bWdj2GDclj5ofokWjzoa5jAwMkxCykd6,5,2,1,0,1,0,2,0,6,0.8571428571428571,1,0.0,0,1,0,1,2,0,0,2,0,2,4,1
17395,163518,ljvQidttDf2jbMq0Dhco00ANs1OMPP2n,SpATywNh6bZuzm8s1ceuBUnMUAeoAHHw,7,2,1,0,1,1,6,0,11,1.5714285714285714,1,0.0,0,1,0,1,2,1,0,6,0,2,9,1
17396,163533,fkHyrrcfJ6oe60xqsar56Gz0YRl5rHzC,SpATywNh6bZuzm8s1ceuBUnMUAeoAHHw,1,0,0,0,0,0,2,0,2,0.2857142857142857,1,0.0,0,0,0,0,0,0,0,2,0,0,2,1
17397,163542,CSh5hGbaSFu2yCb31iVMOVwKocrH471Q,G8EPVSXsOYB5YQWZGiz1aVq5Pgr2GrQu,5,2,1,0,1,0,3,0,7,1.0,3,0.0,0,1,0,1,2,0,0,3,0,2,5,1
17398,163549,kD7KrEgPns8NN7pPH4RunWGvMBAYF6OW,RXDvfPUBYFlVdlueBFbLW0mhhAyGEqpt,10,8,4,0,2,0,6,0,20,2.857142857142857,3,0.0,0,4,0,2,8,0,0,6,0,6,14,0
17399,163562,H7BcZUb2MJ3mV3eWcUeltHh62X1WzBrw,SpATywNh6bZuzm8s1ceuBUnMUAeoAHHw,1,0,0,0,0,0,1,0,1,0.14285714285714285,1,0.0,0,0,0,0,0,0,0,1,0,0,1,1
17400,163569,C5uVsSF0OJOzgwE9vgQEq40axD3ffZTd,RXDvfPUBYFlVdlueBFbLW0mhhAyGEqpt,7,6,2,0,1,0,8,0,17,2.4285714285714284,2,0.0,0,2,0,1,6,0,0,8,0,3,14,1
17401,163571,F3TqBHACHIYM9Yg9wui66QV7ygJkp22V,bWdj2GDclj5ofokWjzoa5jAwMkxCykd6,7,1,1,0,1,2,6,1,12,1.7142857142857142,1,0.0,0,1,0,1,1,2,0,6,1,2,10,1
17402,163577,Uy2krOPQuopj6gsLDrvSnNpCmzlDZ3lx,G8EPVSXsOYB5YQWZGiz1aVq5Pgr2GrQu,35,44,2,70,0,0,6,0,122,17.428571428571427,2,0.0,24,2,48,0,20,0,22,6,0,74,48,1
17403,163582,eYxD3pCXsuNAtHKPOm6JQVNldqcoc61X,RXDvfPUBYFlVdlueBFbLW0mhhAyGEqpt,9,6,2,0,2,4,5,1,20,2.857142857142857,2,0.0,0,2,0,2,6,4,0,5,1,4,16,1
17404,163588,pvAe37z1FjLTGYdwlJFjXex25zlpyHtu,RXDvfPUBYFlVdlueBFbLW0mhhAyGEqpt,1,0,0,0,0,0,1,0,1,0.14285714285714285,1,0.0,0,0,0,0,0,0,0,1,0,0,1,1
17405,163589,lQAYhw1UzsQa6D4iHlC81XAZ1ajKb7gC,SpATywNh6bZuzm8s1ceuBUnMUAeoAHHw,5,2,1,0,1,1,2,0,7,1.0,1,0.0,0,1,0,1,2,1,0,2,0,2,5,1
17406,163590,vagG6fUZaIryVQfvx8v2uowaOCAY1cdW,G8EPVSXsOYB5YQWZGiz1aVq5Pgr2GrQu,7,5,1,0,1,0,4,0,11,1.5714285714285714,1,0.0,0,1,0,1,5,0,0,4,0,2,9,1
17407,163600,S1y1GaZipa7CZ4Lvwv6Z3UIIwux9mVs2,SpATywNh6bZuzm8s1ceuBUnMUAeoAHHw,6,3,2,0,2,0,1,0,8,1.1428571428571428,1,0.0,0,2,0,2,3,0,0,1,0,4,4,1
17408,163601,XqqzFQNJmn3Nj5uaNCNXStUfXUCSgi1X,SpATywNh6bZuzm8s1ceuBUnMUAeoAHHw,6,3,2,0,2,0,1,0,8,1.1428571428571428,1,0.0,0,2,0,2,3,0,0,1,0,4,4,1
17409,163614,cfOhX0waxJYI0ZiTf440b9KQ8z56ZELH,SpATywNh6bZuzm8s1ceuBUnMUAeoAHHw,13,10,5,0,3,0,7,5,30,4.285714285714286,2,0.0,4,5,0,3,6,0,0,7,5,12,18,1
17410,163618,w1CA5COiIiNblmqtUGzNLlwoBIorG5nj,SpATywNh6bZuzm8s1ceuBUnMUAeoAHHw,13,14,0,7,0,1,6,1,29,4.142857142857143,2,0.0,5,0,7,0,9,1,0,6,1,12,17,1
17411,163619,Fa1mAVxGk4kVn9jd6eDkxLNhUbCZP7qX,G8EPVSXsOYB5YQWZGiz1aVq5Pgr2GrQu,16,8,6,0,5,0,6,0,25,3.5714285714285716,2,0.0,0,6,0,5,8,0,0,6,0,11,14,1
17412,163622,L1AaE8JRIRIV3lw2DVe2AIMIzykmc89e,G8EPVSXsOYB5YQWZGiz1aVq5Pgr2GrQu,26,68,22,26,15,1,11,3,146,20.857142857142858,1,0.0,29,22,23,15,39,1,3,11,3,89,57,1
17413,163625,YMDTxwTCTCMBG5LWHOVv3uaqDpUsACxE,SpATywNh6bZuzm8s1ceuBUnMUAeoAHHw,1,0,0,0,0,0,1,0,1,0.14285714285714285,1,0.0,0,0,0,0,0,0,0,1,0,0,1,1
17414,163631,F3LkPjPg6vCRHLtL3FvDerZrs5n7emOU,SpATywNh6bZuzm8s1ceuBUnMUAeoAHHw,7,6,5,0,5,0,3,0,19,2.7142857142857144,2,0.0,0,5,0,5,6,0,0,3,0,10,9,1
17415,163632,PCPmtsqEtkHe7GooXQswbqyH8cnukgFn,SpATywNh6bZuzm8s1ceuBUnMUAeoAHHw,5,2,0,0,0,0,3,0,5,0.7142857142857143,1,0.0,0,0,0,0,2,0,0,3,0,0,5,1
17416,163638,DyoNdvHG07mU6Bz7r3h8R4ubHxjNBfTA,SpATywNh6bZuzm8s1ceuBUnMUAeoAHHw,6,5,2,0,1,1,2,0,11,1.5714285714285714,1,0.0,0,2,0,1,5,1,0,2,0,3,8,1
17417,163643,C4OZeIeoVWL85YLgAEXLqPH3ncq3XA6k,SpATywNh6bZuzm8s1ceuBUnMUAeoAHHw,8,2,1,0,1,1,6,1,12,1.7142857142857142,1,0.0,0,1,0,1,2,1,0,6,1,2,10,1
17418,163650,wi94HT3Va3Hif8CpMS1WVbL5a71j9CMb,RXDvfPUBYFlVdlueBFbLW0mhhAyGEqpt,15,10,7,8,2,15,6,8,56,8.0,1,0.0,1,7,7,2,9,15,1,6,8,17,39,1
17419,163654,mlnhYrciKajvXbMdJptDLVlFyYAjST94,G8EPVSXsOYB5YQWZGiz1aVq5Pgr2GrQu,7,3,0,0,0,8,5,13,29,4.142857142857143,1,0.0,0,0,0,0,3,8,0,5,13,0,29,1
17420,163656,hsKZoLrdrvPaRbEyzj2NgfRJmBw1qqW5,SpATywNh6bZuzm8s1ceuBUnMUAeoAHHw,11,34,17,0,0,11,23,4,89,12.714285714285714,2,0.0,11,17,0,0,23,11,0,23,4,28,61,1
17421,163660,WIulMAW8PLfyLvnliYk0w4Xs9IJHKZPS,bWdj2GDclj5ofokWjzoa5jAwMkxCykd6,6,2,1,0,0,1,5,1,10,1.4285714285714286,2,0.0,0,1,0,0,2,1,0,5,1,1,9,1
17422,163675,0kNhy59h1x4o0Ij6YScRdNhibpvh4SDd,SpATywNh6bZuzm8s1ceuBUnMUAeoAHHw,1,0,0,0,0,0,1,0,1,0.14285714285714285,1,0.0,0,0,0,0,0,0,0,1,0,0,1,0
17423,163678,u40Wnz941IKPEKg6evh8MfJNEbnPlztD,bWdj2GDclj5ofokWjzoa5jAwMkxCykd6,5,2,1,0,1,6,2,0,12,1.7142857142857142,1,0.0,0,1,0,1,2,6,0,2,0,2,10,1
17424,163681,lyMxC1IigTgGwaO3VxYbmlReQwCiDGpV,RXDvfPUBYFlVdlueBFbLW0mhhAyGEqpt,11,14,0,0,0,4,5,2,25,3.5714285714285716,1,0.0,0,0,0,0,14,4,0,5,2,0,25,1
17425,163684,ewJfXKCM3UIjcsxxypCAlFJ00OIwALVK,SpATywNh6bZuzm8s1ceuBUnMUAeoAHHw,16,26,15,23,6,18,11,2,101,14.428571428571429,2,0.0,6,15,19,6,20,18,4,11,2,46,55,1
17426,163689,Ex7M4i0hxnSRXjh3Gag0IYca3K61Kn2n,SpATywNh6bZuzm8s1ceuBUnMUAeoAHHw,13,10,6,10,5,0,3,0,34,4.857142857142857,1,0.0,3,6,8,5,7,0,2,3,0,22,12,1
17427,163699,QZzKa5b6BbNwk1LIn6xlSQQLnIzRsZka,RXDvfPUBYFlVdlueBFbLW0mhhAyGEqpt,9,6,2,0,2,0,4,0,14,2.0,1,0.0,0,2,0,2,6,0,0,4,0,4,10,1
17428,163702,wf4tYLDC26NonKlhHYQJXmb4zsRVp9vv,RXDvfPUBYFlVdlueBFbLW0mhhAyGEqpt,2,1,0,0,0,0,2,0,3,0.42857142857142855,1,0.0,0,0,0,0,1,0,0,2,0,0,3,1
17429,163705,Np4pKivCInwrNv4VDIJNvSdKsE4Ykhes,SpATywNh6bZuzm8s1ceuBUnMUAeoAHHw,7,2,1,0,1,1,4,1,10,1.4285714285714286,1,0.0,0,1,0,1,2,1,0,4,1,2,8,1
17430,163709,pdSGmGjIheArtjBU79xTfiS3vhBu2KPT,SpATywNh6bZuzm8s1ceuBUnMUAeoAHHw,6,2,1,0,1,0,3,0,7,1.0,1,0.0,0,1,0,1,2,0,0,3,0,2,5,1
17431,163717,s7VOudb8mAmGtu7aUQI1pKU0VJWMkjoX,G8EPVSXsOYB5YQWZGiz1aVq5Pgr2GrQu,5,2,1,0,1,0,2,0,6,0.8571428571428571,1,0.0,0,1,0,1,2,0,0,2,0,2,4,1
17432,163721,qefyjSYUZQgFnIvwhQLXYc5FeLuyNtLR,SpATywNh6bZuzm8s1ceuBUnMUAeoAHHw,4,2,0,0,0,0,2,0,4,0.5714285714285714,1,0.0,0,0,0,0,2,0,0,2,0,0,4,1
17433,163725,2jbBgSBiRnod35BsxMp6TsDQi1nWOPvD,SpATywNh6bZuzm8s1ceuBUnMUAeoAHHw,7,3,2,0,2,0,2,0,9,1.2857142857142858,1,0.0,0,2,0,2,3,0,0,2,0,4,5,1
17434,163726,GEJT2aBPUnilxjCoBwgHhTPS1ahoPkLE,RXDvfPUBYFlVdlueBFbLW0mhhAyGEqpt,8,6,5,0,5,0,1,0,17,2.4285714285714284,3,0.0,0,5,0,5,6,0,0,1,0,10,7,1
17435,163732,CEHfXzpDz8lIH5e7jnl07zaS2wVnOurM,bWdj2GDclj5ofokWjzoa5jAwMkxCykd6,1,0,0,0,0,0,2,0,2,0.2857142857142857,1,0.0,0,0,0,0,0,0,0,2,0,0,2,1
17436,163733,XlmyWP3uzEka8XsoWFimEg5Beb9mAoVO,SpATywNh6bZuzm8s1ceuBUnMUAeoAHHw,13,9,2,21,2,1,3,0,38,5.428571428571429,1,0.0,4,2,19,2,5,1,2,3,0,27,11,0
17437,163737,ltg49XAFIsj12MvcvVinx0U6nQzosGwX,SpATywNh6bZuzm8s1ceuBUnMUAeoAHHw,1,0,0,0,0,0,1,0,1,0.14285714285714285,1,0.0,0,0,0,0,0,0,0,1,0,0,1,1
17438,163742,p0fw4v0FzqDHoIprXWv2PhAw9MEKisrS,SpATywNh6bZuzm8s1ceuBUnMUAeoAHHw,11,35,29,0,16,9,8,0,97,13.857142857142858,2,0.0,2,29,0,16,33,9,0,8,0,47,50,1
17439,163746,T40Q6IsSToScgVshLJURvbaPdMvC0SSz,SpATywNh6bZuzm8s1ceuBUnMUAeoAHHw,3,2,0,0,0,0,2,0,4,0.5714285714285714,1,0.0,0,0,0,0,2,0,0,2,0,0,4,1
17440,163749,fyTJxX25s6bGEKgBLCJRWjXtah1KWf2a,SpATywNh6bZuzm8s1ceuBUnMUAeoAHHw,7,3,2,0,0,1,5,1,12,1.7142857142857142,1,0.0,0,2,0,0,3,1,0,5,1,2,10,1
17441,163751,WIulMAW8PLfyLvnliYk0w4Xs9IJHKZPS,RXDvfPUBYFlVdlueBFbLW0mhhAyGEqpt,2,0,0,0,0,0,3,0,3,0.42857142857142855,2,0.0,0,0,0,0,0,0,0,3,0,0,3,1
17442,163755,ePj7Vg45LclsHx65E6l7TrkRBcgJnatl,SpATywNh6bZuzm8s1ceuBUnMUAeoAHHw,16,22,9,23,3,1,5,1,64,9.142857142857142,1,0.0,10,9,19,3,12,1,4,5,1,41,23,1
17443,163762,8frCsvLNU0A4TOJYDtM515jTF7T871uZ,SpATywNh6bZuzm8s1ceuBUnMUAeoAHHw,1,0,0,0,0,0,1,0,1,0.14285714285714285,1,0.0,0,0,0,0,0,0,0,1,0,0,1,1
17444,163764,J1eFEaKfAoVdTBUtGJyjHKFZqTtKoDt7,SpATywNh6bZuzm8s1ceuBUnMUAeoAHHw,2,0,0,0,0,0,2,0,2,0.2857142857142857,2,0.0,0,0,0,0,0,0,0,2,0,0,2,1
17445,163772,4IvlesNs2H0RowHre7RAgbEkJVMxR7AN,SpATywNh6bZuzm8s1ceuBUnMUAeoAHHw,10,8,5,0,4,5,5,0,27,3.857142857142857,1,0.0,0,5,0,4,8,5,0,5,0,9,18,1
17446,163774,MByqWSIhrOuR5hLDV5SDwmnefy1Zfii8,SpATywNh6bZuzm8s1ceuBUnMUAeoAHHw,15,20,3,19,0,2,13,1,58,8.285714285714286,4,0.0,3,3,15,0,17,2,4,13,1,21,37,1
17447,163782,mxBhue6G5uamvaszDl3iuMbiHnjieccs,SpATywNh6bZuzm8s1ceuBUnMUAeoAHHw,6,4,1,0,1,0,2,0,8,1.1428571428571428,2,0.0,1,1,0,1,3,0,0,2,0,3,5,1
17448,163783,uPwSB0CSQ1ut2moqiJ7QCNXIo4WCZY1E,bWdj2GDclj5ofokWjzoa5jAwMkxCykd6,1,0,0,0,0,0,1,0,1,0.14285714285714285,1,0.0,0,0,0,0,0,0,0,1,0,0,1,1
17449,163785,9d3JQQBsPcAu5WcxhfhApcP84UgGH4MP,SpATywNh6bZuzm8s1ceuBUnMUAeoAHHw,6,3,2,0,2,0,1,0,8,1.1428571428571428,1,0.0,0,2,0,2,3,0,0,1,0,4,4,1
17450,163787,8VYVEiIEY85awvLQk1iQtn3EDF8rq6g1,RXDvfPUBYFlVdlueBFbLW0mhhAyGEqpt,1,0,0,0,0,0,1,0,1,0.14285714285714285,1,0.0,0,0,0,0,0,0,0,1,0,0,1,1
17451,163791,D42av4RgpD46CqlOrc3UqYUQGU69fX7w,G8EPVSXsOYB5YQWZGiz1aVq5Pgr2GrQu,10,14,5,8,3,0,2,0,32,4.571428571428571,2,0.0,3,5,5,3,11,0,3,2,0,16,16,1
17452,163803,OTTt0WwDCNei2O0TEm6JKkoSswKCnrig,bWdj2GDclj5ofokWjzoa5jAwMkxCykd6,7,4,2,0,1,2,3,1,13,1.8571428571428572,1,0.0,0,2,0,1,4,2,0,3,1,3,10,1
17453,163805,RGr3DE14hb7Ufb3qkxo2JnrYRs9POJfu,bWdj2GDclj5ofokWjzoa5jAwMkxCykd6,2,0,0,0,0,0,2,0,2,0.2857142857142857,1,0.0,0,0,0,0,0,0,0,2,0,0,2,1
17454,163806,VROspqrlv0dK4X4QLAJe4l0nslgLETjg,SpATywNh6bZuzm8s1ceuBUnMUAeoAHHw,11,21,13,0,0,0,7,1,42,6.0,1,0.0,5,13,0,0,16,0,0,7,1,18,24,1
17455,163808,Zt87siQCmnS8kLlyv5Y5utZhnc1bMPCO,SpATywNh6bZuzm8s1ceuBUnMUAeoAHHw,4,2,0,0,0,0,2,0,4,0.5714285714285714,1,0.0,0,0,0,0,2,0,0,2,0,0,4,1
17456,163814,RmNdouduvikY6rwKOzMijwxrRPvXpOqe,SpATywNh6bZuzm8s1ceuBUnMUAeoAHHw,1,0,0,0,0,0,1,0,1,0.14285714285714285,1,0.0,0,0,0,0,0,0,0,1,0,0,1,1
17457,163822,RGr3DE14hb7Ufb3qkxo2JnrYRs9POJfu,RXDvfPUBYFlVdlueBFbLW0mhhAyGEqpt,2,0,0,0,0,0,2,0,2,0.2857142857142857,1,0.0,0,0,0,0,0,0,0,2,0,0,2,1
17458,163824,8VGorZlY7mV29XrBVXKId31ils1jK6e4,SpATywNh6bZuzm8s1ceuBUnMUAeoAHHw,11,10,1,16,0,0,3,0,30,4.285714285714286,1,0.0,5,1,14,0,5,0,2,3,0,20,10,1
17459,163831,TRkoMMGdlwDWhj0QSrRowmh4NkQmbVQQ,RXDvfPUBYFlVdlueBFbLW0mhhAyGEqpt,7,5,0,0,0,0,2,0,7,1.0,1,0.0,0,0,0,0,5,0,0,2,0,0,7,1
17460,163832,PiD5rrce1Y4GmQw7bDUPO9xN5t3xVeMb,bWdj2GDclj5ofokWjzoa5jAwMkxCykd6,1,0,0,0,0,0,1,0,1,0.14285714285714285,1,0.0,0,0,0,0,0,0,0,1,0,0,1,1
17461,163833,KVtMqoPC0QDsoF45TzGd0BaG4fzRLrFd,SpATywNh6bZuzm8s1ceuBUnMUAeoAHHw,14,18,4,0,1,5,5,0,33,4.714285714285714,2,0.0,0,4,0,1,18,5,0,5,0,5,28,1
17462,163836,SQBW44VzMb5zXQWTfzFzAP2RU7qxP2su,SpATywNh6bZuzm8s1ceuBUnMUAeoAHHw,7,13,5,0,2,0,3,0,23,3.2857142857142856,3,0.0,4,5,0,2,9,0,0,3,0,11,12,1
17463,163841,VOYGsHw00bDlJPevH6j2b9TjHm4MTXPJ,bWdj2GDclj5ofokWjzoa5jAwMkxCykd6,7,5,4,0,4,0,4,0,17,2.4285714285714284,1,0.0,0,4,0,4,5,0,0,4,0,8,9,0
17464,163865,5OhxkZY6VrmzMIEqEJk4w0eM2XdsVdBQ,bWdj2GDclj5ofokWjzoa5jAwMkxCykd6,1,0,0,0,0,0,1,0,1,0.14285714285714285,1,0.0,0,0,0,0,0,0,0,1,0,0,1,1
17465,163879,nu1pV8lIFpyulfHtXPUt3mWowV7EAjTM,SpATywNh6bZuzm8s1ceuBUnMUAeoAHHw,1,0,0,0,0,0,2,0,2,0.2857142857142857,1,0.0,0,0,0,0,0,0,0,2,0,0,2,1
17466,163886,Bos3zEEnAcYzPXQktMkJJ0ak5mhGWCAf,bWdj2GDclj5ofokWjzoa5jAwMkxCykd6,14,31,10,32,3,2,7,1,86,12.285714285714286,3,0.0,9,10,31,3,22,2,1,7,1,53,33,0
17467,163895,IdPX4c7Aq1sETI8RH1NYOE4mt2Ch4lHK,G8EPVSXsOYB5YQWZGiz1aVq5Pgr2GrQu,12,6,5,16,2,0,3,0,32,4.571428571428571,1,0.0,0,5,14,2,6,0,2,3,0,21,11,1
17468,163900,3RcsrMTbPrb8ZHYXLlgwoRK7zrqTGSuq,SpATywNh6bZuzm8s1ceuBUnMUAeoAHHw,1,0,0,0,0,0,1,0,1,0.14285714285714285,1,0.0,0,0,0,0,0,0,0,1,0,0,1,1
17469,163902,35YnYP4Tkn7xvOTt0M51AeVR3m7l2sIt,G8EPVSXsOYB5YQWZGiz1aVq5Pgr2GrQu,7,5,1,0,1,0,2,0,9,1.2857142857142858,2,0.0,0,1,0,1,5,0,0,2,0,2,7,1
17470,163908,NrHk4qmJXuD0TsjkQSnghKpk9ZjGAOyU,RXDvfPUBYFlVdlueBFbLW0mhhAyGEqpt,5,3,2,0,2,0,2,0,9,1.2857142857142858,1,0.0,0,2,0,2,3,0,0,2,0,4,5,1
17471,163909,omRh5Z9AcNowwMlq7wsAXczLrDoDOAwv,bWdj2GDclj5ofokWjzoa5jAwMkxCykd6,8,14,7,2,2,0,2,0,27,3.857142857142857,2,0.0,2,7,2,2,12,0,0,2,0,13,14,1
17472,163911,O1GQCvqX78WHj4bvuBKl7CpHmRzidVy9,SpATywNh6bZuzm8s1ceuBUnMUAeoAHHw,4,6,3,0,0,0,1,0,10,1.4285714285714286,1,0.0,2,3,0,0,4,0,0,1,0,5,5,1
17473,163914,ncIBIt1kRS23NRG3HklaOrwS2ep1UY7z,G8EPVSXsOYB5YQWZGiz1aVq5Pgr2GrQu,14,15,6,12,3,0,1,0,37,5.285714285714286,1,0.0,6,6,7,3,9,0,5,1,0,22,15,1
17474,163916,lntlNyrTcmBgMyWfooLFXfRIXX7mctQs,bWdj2GDclj5ofokWjzoa5jAwMkxCykd6,3,1,0,0,0,0,2,0,3,0.42857142857142855,1,0.0,0,0,0,0,1,0,0,2,0,0,3,1
17475,163922,ncIBIt1kRS23NRG3HklaOrwS2ep1UY7z,bWdj2GDclj5ofokWjzoa5jAwMkxCykd6,5,4,1,0,0,0,3,0,8,1.1428571428571428,1,0.0,0,1,0,0,4,0,0,3,0,1,7,1
17476,163925,TbdeJU00oP9V3i4nJearCAXrCR8nfsK3,SpATywNh6bZuzm8s1ceuBUnMUAeoAHHw,7,9,4,0,2,1,2,0,18,2.5714285714285716,2,0.0,0,4,0,2,9,1,0,2,0,6,12,1
17477,163928,VjsjgdvHeFwreLXV4d0cm1ICJk30LzPH,bWdj2GDclj5ofokWjzoa5jAwMkxCykd6,1,0,0,0,0,0,2,0,2,0.2857142857142857,1,0.0,0,0,0,0,0,0,0,2,0,0,2,1
17478,163934,5NIrDL6VpBxdJ6CyWDkvlKDqSlFChzvA,SpATywNh6bZuzm8s1ceuBUnMUAeoAHHw,36,31,24,12,13,0,7,0,87,12.428571428571429,5,0.0,0,24,12,13,31,0,0,7,0,49,38,0
17479,163936,58CuB3m4LabodooAfWkSdyPNtGlVJfdv,SpATywNh6bZuzm8s1ceuBUnMUAeoAHHw,2,0,0,0,0,0,2,0,2,0.2857142857142857,1,0.0,0,0,0,0,0,0,0,2,0,0,2,1
17480,163940,Kt9qeiacR1tBDeKKHUR6O60ehH5pm7C9,RXDvfPUBYFlVdlueBFbLW0mhhAyGEqpt,1,0,0,0,0,0,1,0,1,0.14285714285714285,1,0.0,0,0,0,0,0,0,0,1,0,0,1,1
17481,163944,k8NseCRyuonMJqIA9r5ZttySeYFCZkvS,bWdj2GDclj5ofokWjzoa5jAwMkxCykd6,2,0,0,0,0,0,2,0,2,0.2857142857142857,1,0.0,0,0,0,0,0,0,0,2,0,0,2,1
17482,163961,NNIDIi1G7HKDU1709vBEwzpydUygCNLC,SpATywNh6bZuzm8s1ceuBUnMUAeoAHHw,15,25,9,21,4,0,7,0,66,9.428571428571429,3,0.0,12,9,18,4,13,0,3,7,0,43,23,1
17483,163972,83J9IXuPcwdDBJoFENdSQFWzvgELVzeu,SpATywNh6bZuzm8s1ceuBUnMUAeoAHHw,1,0,0,0,0,0,1,0,1,0.14285714285714285,1,0.0,0,0,0,0,0,0,0,1,0,0,1,1
17484,163975,dbtlJh8uWixqUAz5pHAMwXOZNVVUTuzi,bWdj2GDclj5ofokWjzoa5jAwMkxCykd6,7,9,4,0,3,0,5,0,21,3.0,1,0.0,2,4,0,3,7,0,0,5,0,9,12,1
17485,163982,cikSh880jtc26b154AaVhDiV1L6H6F3g,SpATywNh6bZuzm8s1ceuBUnMUAeoAHHw,45,58,36,45,22,1,19,0,181,25.857142857142858,6,0.0,14,36,42,22,44,1,3,19,0,114,67,0
17486,163983,Is7lqncTs1EDN9QmzrTbcU6KnB0BCGNX,bWdj2GDclj5ofokWjzoa5jAwMkxCykd6,5,2,1,0,1,0,2,0,6,0.8571428571428571,1,0.0,0,1,0,1,2,0,0,2,0,2,4,1
17487,163986,YgxPec9PZk03SxcMpde0DWwnbgHU13wT,RXDvfPUBYFlVdlueBFbLW0mhhAyGEqpt,1,0,0,0,0,0,1,0,1,0.14285714285714285,1,0.0,0,0,0,0,0,0,0,1,0,0,1,1
17488,163993,EQtZU9INEuWvmS0EVA02NQr3rav8vOCw,SpATywNh6bZuzm8s1ceuBUnMUAeoAHHw,1,0,0,0,0,0,1,0,1,0.14285714285714285,1,0.0,0,0,0,0,0,0,0,1,0,0,1,1
17489,163995,EQtZU9INEuWvmS0EVA02NQr3rav8vOCw,bWdj2GDclj5ofokWjzoa5jAwMkxCykd6,1,0,0,0,0,0,1,0,1,0.14285714285714285,1,0.0,0,0,0,0,0,0,0,1,0,0,1,1
17490,163996,HE0yFYNeyW3jGh5EhXv7uoc6O18ATk5R,bWdj2GDclj5ofokWjzoa5jAwMkxCykd6,9,8,4,0,2,0,4,0,18,2.5714285714285716,3,0.0,0,4,0,2,8,0,0,4,0,6,12,1
17491,163997,KZBxo2oXfcrXYFa3c9hEkQ12gjuvG6yO,SpATywNh6bZuzm8s1ceuBUnMUAeoAHHw,5,3,1,0,1,0,1,0,6,0.8571428571428571,1,0.0,0,1,0,1,3,0,0,1,0,2,4,1
17492,164001,XFqiUKRJW4dHHhbAyhg0HRvuoT5jA7Ib,SpATywNh6bZuzm8s1ceuBUnMUAeoAHHw,8,9,7,0,5,0,3,0,24,3.4285714285714284,2,0.0,0,7,0,5,9,0,0,3,0,12,12,1
17493,164004,RcOO7zh8NeavIcr1ab7xjfpMRrA97BXt,G8EPVSXsOYB5YQWZGiz1aVq5Pgr2GrQu,6,2,1,0,1,0,3,0,7,1.0,1,0.0,0,1,0,1,2,0,0,3,0,2,5,1
17494,164005,DhiB4cJ1TCjmSH3ZWP9m0OqNyBdGeS5P,SpATywNh6bZuzm8s1ceuBUnMUAeoAHHw,10,14,1,16,1,0,1,0,33,4.714285714285714,3,0.0,4,1,14,1,10,0,2,1,0,20,13,1
17495,164006,BMjIPGqtYoLatxXDEHrhiIMt72Ckp0Wf,RXDvfPUBYFlVdlueBFbLW0mhhAyGEqpt,19,16,1,26,0,0,5,1,49,7.0,1,0.0,5,1,25,0,11,0,1,5,1,31,18,1
17496,164008,0sPJG21Jmy137j2MeTN2RYjy8hYUDlLs,G8EPVSXsOYB5YQWZGiz1aVq5Pgr2GrQu,10,11,2,16,1,0,3,0,33,4.714285714285714,1,0.0,4,2,13,1,7,0,3,3,0,20,13,1
17497,164009,g3902agYIRHzac78MKVZlvljLMXXNpQ7,bWdj2GDclj5ofokWjzoa5jAwMkxCykd6,6,3,2,0,2,0,5,0,12,1.7142857142857142,1,0.0,0,2,0,2,3,0,0,5,0,4,8,1
17498,164013,1l8gTBWE0zew7p1xhFmmlqlIh8QPXivD,RXDvfPUBYFlVdlueBFbLW0mhhAyGEqpt,1,0,0,0,0,0,1,0,1,0.14285714285714285,1,0.0,0,0,0,0,0,0,0,1,0,0,1,1
17499,164024,s5CJLvNaNPk4PiGqc6NTFvObROYB0OQQ,SpATywNh6bZuzm8s1ceuBUnMUAeoAHHw,22,46,0,27,0,20,14,0,107,15.285714285714286,6,0.0,12,0,25,0,34,20,2,14,0,37,70,0
17500,164030,1KSlK2xXHUc3PjC1CsQEQaomGBagqDXf,bWdj2GDclj5ofokWjzoa5jAwMkxCykd6,5,2,1,0,1,0,2,0,6,0.8571428571428571,1,0.0,0,1,0,1,2,0,0,2,0,2,4,1
17501,164032,zQ5BnttGrAYjfbNnxAVeHGUEjC3wWZZU,SpATywNh6bZuzm8s1ceuBUnMUAeoAHHw,32,53,32,28,19,8,26,0,166,23.714285714285715,7,0.0,4,32,24,19,49,8,4,26,0,79,87,0
17502,164035,HnIhmL6C5c5V3yK8mmGh4fDvVHyYVu6T,SpATywNh6bZuzm8s1ceuBUnMUAeoAHHw,17,27,4,18,4,0,13,1,67,9.571428571428571,2,0.0,9,4,15,4,18,0,3,13,1,32,35,1
17503,164038,muYojhkvYaqc1I2tE62ZyLEtlEpDYqtR,SpATywNh6bZuzm8s1ceuBUnMUAeoAHHw,10,8,2,0,2,1,6,1,20,2.857142857142857,1,0.0,0,2,0,2,8,1,0,6,1,4,16,1
17504,164048,ZhPOxBDoDGtWvBUdn6MZkcPVAapzwktO,SpATywNh6bZuzm8s1ceuBUnMUAeoAHHw,15,32,1,22,0,2,11,1,69,9.857142857142858,3,0.0,13,1,19,0,19,2,3,11,1,33,36,1
17505,164050,frevGWOFyf2Wo6uQjpFNvZnyWeFbKP0E,bWdj2GDclj5ofokWjzoa5jAwMkxCykd6,3,3,0,0,0,0,1,0,4,0.5714285714285714,1,0.0,1,0,0,0,2,0,0,1,0,1,3,1
17506,164051,frevGWOFyf2Wo6uQjpFNvZnyWeFbKP0E,RXDvfPUBYFlVdlueBFbLW0mhhAyGEqpt,9,13,1,0,0,0,1,0,15,2.142857142857143,1,0.0,4,1,0,0,9,0,0,1,0,5,10,1
17507,164053,C0k0i5iW9Kp3SljhwW4D102xschKnWU2,RXDvfPUBYFlVdlueBFbLW0mhhAyGEqpt,1,0,0,0,0,0,1,0,1,0.14285714285714285,1,0.0,0,0,0,0,0,0,0,1,0,0,1,1
17508,164059,KNSr5UQyphUzZdobhnLn0kvEqH22GN8U,G8EPVSXsOYB5YQWZGiz1aVq5Pgr2GrQu,2,0,0,0,0,0,2,0,2,0.2857142857142857,1,0.0,0,0,0,0,0,0,0,2,0,0,2,1
17509,164064,uuxrUSHn3GpYFneZnY8GpLgr5XiyDABs,bWdj2GDclj5ofokWjzoa5jAwMkxCykd6,9,19,7,0,6,13,10,3,58,8.285714285714286,1,0.0,8,7,0,6,11,13,0,10,3,21,37,1
17510,164068,83H2FVc0DUlyPpMlZsbpGsFQRMFc6fan,bWdj2GDclj5ofokWjzoa5jAwMkxCykd6,3,4,0,0,0,0,2,0,6,0.8571428571428571,1,0.0,0,0,0,0,4,0,0,2,0,0,6,1
17511,164072,KRDbzApPGunbpzFiIxAlDnKcVqmXz93Z,SpATywNh6bZuzm8s1ceuBUnMUAeoAHHw,9,9,0,0,0,1,5,1,16,2.2857142857142856,1,0.0,0,0,0,0,9,1,0,5,1,0,16,1
17512,164075,Qfoj47ZFH9kFoOklCPtfSf7qImKKODGj,bWdj2GDclj5ofokWjzoa5jAwMkxCykd6,1,0,0,0,0,0,1,0,1,0.14285714285714285,1,0.0,0,0,0,0,0,0,0,1,0,0,1,1
17513,164078,WsP1VDhZbOPlkd3sbnAsknbzVniUGVR6,SpATywNh6bZuzm8s1ceuBUnMUAeoAHHw,11,18,6,12,3,0,2,0,41,5.857142857142857,1,0.0,6,6,11,3,12,0,1,2,0,26,15,1
17514,164089,O3lqSpngMxAwSEkWjBn3tk145jZG19Vi,SpATywNh6bZuzm8s1ceuBUnMUAeoAHHw,8,8,5,0,4,1,5,1,24,3.4285714285714284,1,0.0,0,5,0,4,8,1,0,5,1,9,15,1
17515,164094,ndz80WiJUz0adE8axEB4JuY9X6KNPO7X,SpATywNh6bZuzm8s1ceuBUnMUAeoAHHw,1,0,0,0,0,0,1,0,1,0.14285714285714285,1,0.0,0,0,0,0,0,0,0,1,0,0,1,1
17516,164095,yPIqHEe4AecQ4GX5I2LJPYqjiV9xQfx2,SpATywNh6bZuzm8s1ceuBUnMUAeoAHHw,7,3,2,0,2,0,2,0,9,1.2857142857142858,1,0.0,0,2,0,2,3,0,0,2,0,4,5,1
17517,164097,yKlpCOv4oX3vHTFVM0BhF8OwgGT3xUhB,G8EPVSXsOYB5YQWZGiz1aVq5Pgr2GrQu,11,22,0,2,0,0,1,0,25,3.5714285714285716,1,0.0,6,0,2,0,16,0,0,1,0,8,17,0
17518,164105,UjuYob8V8C70Onzp78W1rkt8ybxbAbwx,RXDvfPUBYFlVdlueBFbLW0mhhAyGEqpt,9,4,3,0,1,2,5,1,16,2.2857142857142856,1,0.0,1,3,0,1,3,2,0,5,1,5,11,0
17519,164114,7ynsHGhJ1N4494Hez57ckblgtBNGbed9,bWdj2GDclj5ofokWjzoa5jAwMkxCykd6,7,2,1,0,0,24,12,2,41,5.857142857142857,1,0.0,0,1,0,0,2,24,0,12,2,1,40,1
17520,164128,3iB62eqNt3nRiXslxHuT1UtvhrRX1eLs,SpATywNh6bZuzm8s1ceuBUnMUAeoAHHw,14,19,14,0,8,10,11,3,65,9.285714285714286,2,0.0,0,14,0,8,19,10,0,11,3,22,43,0
17521,164135,blaKT90TeOTAa2RsAkTxWQqeLxEi93Qu,G8EPVSXsOYB5YQWZGiz1aVq5Pgr2GrQu,16,28,1,0,1,0,3,0,33,4.714285714285714,1,0.0,6,1,0,1,22,0,0,3,0,8,25,0
17522,164143,Rfx55so0bnrgOG7iRmEYhpikxS2TaZXD,SpATywNh6bZuzm8s1ceuBUnMUAeoAHHw,6,6,4,0,2,0,4,0,16,2.2857142857142856,1,0.0,0,4,0,2,6,0,0,4,0,6,10,1
17523,164152,DFbejjY7iFDbzUdxXNh2pDwgdrX3wa4i,SpATywNh6bZuzm8s1ceuBUnMUAeoAHHw,14,28,8,24,3,10,5,1,79,11.285714285714286,2,0.0,12,8,18,3,16,10,6,5,1,41,38,1
17524,164156,RJbtfdnDfiKYbXA54RnQnnmr6xKZwlkg,bWdj2GDclj5ofokWjzoa5jAwMkxCykd6,8,9,1,20,1,3,6,0,40,5.714285714285714,1,0.0,4,1,18,1,5,3,2,6,0,24,16,1
17525,164158,uZwtgzrFploohPWTfTTW4oFbLgraM3NM,RXDvfPUBYFlVdlueBFbLW0mhhAyGEqpt,5,6,4,0,1,0,1,0,12,1.7142857142857142,2,0.0,0,4,0,1,6,0,0,1,0,5,7,1
17526,164162,8rrasDTB21WkgxqQeAJWm6ZLoQBQi4Tp,SpATywNh6bZuzm8s1ceuBUnMUAeoAHHw,9,3,2,0,1,1,7,1,15,2.142857142857143,1,0.0,0,2,0,1,3,1,0,7,1,3,12,1
17527,164163,GY3gjlGW984FFVVjyCHJw8AVsx1rzHGL,SpATywNh6bZuzm8s1ceuBUnMUAeoAHHw,1,0,0,0,0,0,2,0,2,0.2857142857142857,1,0.0,0,0,0,0,0,0,0,2,0,0,2,1
17528,164167,g8GaCwXJUf6SPnVxk3h41vOpn1g2rMNj,SpATywNh6bZuzm8s1ceuBUnMUAeoAHHw,17,26,11,17,5,0,7,0,66,9.428571428571429,2,0.0,8,11,15,5,18,0,2,7,0,39,27,1
17529,164173,o3O6sFZEm4uYUPzBaiRjRHoiv6fwyQLX,bWdj2GDclj5ofokWjzoa5jAwMkxCykd6,11,7,5,0,3,0,6,0,21,3.0,2,0.0,1,5,0,3,6,0,0,6,0,9,12,1
17530,164180,Lwf7mfGJ3FePZ7LRuU8J3HhoGD7wCy3e,bWdj2GDclj5ofokWjzoa5jAwMkxCykd6,6,0,0,0,0,3,11,1,15,2.142857142857143,1,0.0,0,0,0,0,0,3,0,11,1,0,15,1
17531,164181,9Gcg3d2ByGJfHaOgn8q1nODMxGfTga0V,SpATywNh6bZuzm8s1ceuBUnMUAeoAHHw,4,2,1,0,1,0,1,0,5,0.7142857142857143,1,0.0,0,1,0,1,2,0,0,1,0,2,3,1
17532,164182,ztJdAnCpBgEgLx5fhRggF88Y3Pxlvyek,SpATywNh6bZuzm8s1ceuBUnMUAeoAHHw,5,5,1,0,1,0,1,0,8,1.1428571428571428,1,0.0,0,1,0,1,5,0,0,1,0,2,6,1
17533,164189,vFfdM0ONqhREkb5cy2nDN88l9Gb7gZxp,SpATywNh6bZuzm8s1ceuBUnMUAeoAHHw,12,14,7,9,4,2,17,0,53,7.571428571428571,1,0.0,3,7,7,4,11,2,2,17,0,21,32,1
17534,164190,9ygKD7mdzmGQqRwlKeL15CcGPS61a1pB,SpATywNh6bZuzm8s1ceuBUnMUAeoAHHw,1,0,0,0,0,0,1,0,1,0.14285714285714285,1,0.0,0,0,0,0,0,0,0,1,0,0,1,1
17535,164196,CXOtKVmMQojq2XNTO0iupqinfdnG9ZHO,SpATywNh6bZuzm8s1ceuBUnMUAeoAHHw,12,23,5,13,0,19,4,0,64,9.142857142857142,1,0.0,13,5,11,0,10,19,2,4,0,29,35,1
17536,164198,w0MOevkqL7TIdK3soXlSk0InhRt5D2OI,SpATywNh6bZuzm8s1ceuBUnMUAeoAHHw,7,15,0,0,0,10,5,0,30,4.285714285714286,3,0.0,1,0,0,0,14,10,0,5,0,1,29,1
17537,164199,Fk4hjEUqgyLHxBlk1cbfR9hWyVsJsJLo,bWdj2GDclj5ofokWjzoa5jAwMkxCykd6,9,10,5,0,2,0,2,0,19,2.7142857142857144,2,0.0,0,5,0,2,10,0,0,2,0,7,12,1
17538,164202,BlqNhk6hbhpwG32KfW3xxRFbNDrCRljo,bWdj2GDclj5ofokWjzoa5jAwMkxCykd6,9,18,11,0,0,16,19,3,67,9.571428571428571,2,0.0,0,11,0,0,18,16,0,19,3,11,56,1
17539,164204,Yp9LyEPv40Da5bhTi9YoLgYAzGahNHA7,RXDvfPUBYFlVdlueBFbLW0mhhAyGEqpt,13,19,14,0,6,2,5,0,46,6.571428571428571,2,0.0,1,14,0,6,18,2,0,5,0,21,25,1
17540,164211,o4jfOgo2dfLmNdqfH47BtVPD4gDTd4tS,RXDvfPUBYFlVdlueBFbLW0mhhAyGEqpt,3,0,0,0,0,4,5,0,9,1.2857142857142858,2,0.0,0,0,0,0,0,4,0,5,0,0,9,1
17541,164212,BqQvzvKumSuXZDEF5Fpfkr95tleas1E0,bWdj2GDclj5ofokWjzoa5jAwMkxCykd6,1,0,0,0,0,0,1,0,1,0.14285714285714285,1,0.0,0,0,0,0,0,0,0,1,0,0,1,1
17542,164213,wFvodFqghxL7iISMFbYXkYNq6P6eK5gH,RXDvfPUBYFlVdlueBFbLW0mhhAyGEqpt,6,5,0,0,0,0,6,0,11,1.5714285714285714,1,0.0,0,0,0,0,5,0,0,6,0,0,11,1
17543,164214,HDmenaP9dq5AQ9fnpOe9TUOGtyNR5hfW,bWdj2GDclj5ofokWjzoa5jAwMkxCykd6,5,2,1,0,1,0,4,0,8,1.1428571428571428,1,0.0,0,1,0,1,2,0,0,4,0,2,6,1
17544,164218,a8UKs1NxAK1Rc6mTIgzTKX0mHyAKUP88,G8EPVSXsOYB5YQWZGiz1aVq5Pgr2GrQu,12,14,5,8,4,0,1,0,32,4.571428571428571,1,0.0,8,5,5,4,6,0,3,1,0,22,10,1
17545,164219,cderIDaWBR3ykedbqXoG7yh75mThXkpL,SpATywNh6bZuzm8s1ceuBUnMUAeoAHHw,7,2,1,0,1,0,5,1,10,1.4285714285714286,1,0.0,0,1,0,1,2,0,0,5,1,2,8,1
17546,164223,dXCvdD4j2gSkM89QjHdpheWOht9HZ4w4,SpATywNh6bZuzm8s1ceuBUnMUAeoAHHw,13,12,4,20,3,0,2,0,41,5.857142857142857,1,0.0,7,4,16,3,5,0,4,2,0,30,11,1
17547,164226,ylaFiKTL5M7uyaxbJV4j95mbCqvhbcFS,G8EPVSXsOYB5YQWZGiz1aVq5Pgr2GrQu,26,98,3,26,8,26,8,1,170,24.285714285714285,2,0.0,27,3,23,8,71,26,3,8,1,61,109,1
17548,164229,m7lUxDgRiiqzb1cDzFb6FRFrHWjmnS0E,bWdj2GDclj5ofokWjzoa5jAwMkxCykd6,15,21,10,28,6,2,11,1,79,11.285714285714286,2,0.0,5,10,25,6,16,2,3,11,1,46,33,1
17549,164237,ZfIQYurnR6gJbWxLJ81cU3ZqzX4mpHm0,RXDvfPUBYFlVdlueBFbLW0mhhAyGEqpt,6,4,2,0,1,0,3,0,10,1.4285714285714286,1,0.0,0,2,0,1,4,0,0,3,0,3,7,1
17550,164238,mQPNS4mAXxHsb5X4ulTZ0rUofu82I30M,SpATywNh6bZuzm8s1ceuBUnMUAeoAHHw,4,0,0,0,0,1,4,0,5,0.7142857142857143,1,0.0,0,0,0,0,0,1,0,4,0,0,5,1
17551,164243,wFvodFqghxL7iISMFbYXkYNq6P6eK5gH,G8EPVSXsOYB5YQWZGiz1aVq5Pgr2GrQu,1,0,0,0,0,0,1,0,1,0.14285714285714285,1,0.0,0,0,0,0,0,0,0,1,0,0,1,1
17552,164253,s53Goue7PBVQuWwuk4njE0FTuXBFYzWT,bWdj2GDclj5ofokWjzoa5jAwMkxCykd6,5,2,1,0,1,0,2,0,6,0.8571428571428571,1,0.0,0,1,0,1,2,0,0,2,0,2,4,1
17553,164257,yLdwUTmew1kIx5gdbRjo7r2vOLkom0w2,RXDvfPUBYFlVdlueBFbLW0mhhAyGEqpt,1,0,0,0,0,0,1,0,1,0.14285714285714285,1,0.0,0,0,0,0,0,0,0,1,0,0,1,1
17554,164266,JHhY30IKFzw4LWcyrHuTEglWNqRkqdDU,G8EPVSXsOYB5YQWZGiz1aVq5Pgr2GrQu,44,18,12,110,3,0,9,0,152,21.714285714285715,2,0.0,6,12,95,3,12,0,15,9,0,116,36,1
17555,164273,wg7LkabhS9jTmBy5bEF3lQSLJkluKGUF,SpATywNh6bZuzm8s1ceuBUnMUAeoAHHw,5,2,1,0,1,0,2,0,6,0.8571428571428571,1,0.0,0,1,0,1,2,0,0,2,0,2,4,1
17556,164276,mdAxXzEXQEyyjCtALtGRFZS9oxIIimgr,G8EPVSXsOYB5YQWZGiz1aVq5Pgr2GrQu,1,0,0,0,0,0,5,0,5,0.7142857142857143,1,0.0,0,0,0,0,0,0,0,5,0,0,5,1
17557,164277,VCOGW9OE6DqAZaAneJJM4ZOSOc2aI6o3,SpATywNh6bZuzm8s1ceuBUnMUAeoAHHw,1,0,0,0,0,0,1,0,1,0.14285714285714285,1,0.0,0,0,0,0,0,0,0,1,0,0,1,1
17558,164283,44FzEVxwFpCY2dQQ0BkdyMwLoRQRjARq,bWdj2GDclj5ofokWjzoa5jAwMkxCykd6,5,2,1,0,1,0,2,0,6,0.8571428571428571,1,0.0,0,1,0,1,2,0,0,2,0,2,4,1
17559,164288,VD6TkymcxBFMdB1MoYEexj8K6lT6eEyR,SpATywNh6bZuzm8s1ceuBUnMUAeoAHHw,13,9,6,14,5,5,3,0,42,6.0,2,0.0,2,6,11,5,7,5,3,3,0,24,18,1
17560,164293,5iSY38QlsciL98g4h2hbNSbA8fYeSyCj,SpATywNh6bZuzm8s1ceuBUnMUAeoAHHw,5,6,2,0,1,0,2,0,11,1.5714285714285714,2,0.0,1,2,0,1,5,0,0,2,0,4,7,1
17561,164295,R6At1oAc7WZXNfKoQsgcMko62fJQGIiO,SpATywNh6bZuzm8s1ceuBUnMUAeoAHHw,2,0,0,0,0,0,2,0,2,0.2857142857142857,1,0.0,0,0,0,0,0,0,0,2,0,0,2,1
17562,164297,XpHgf5hU50AoSdtBhnyxR1OezCcdtpcw,SpATywNh6bZuzm8s1ceuBUnMUAeoAHHw,2,0,0,0,0,0,2,0,2,0.2857142857142857,1,0.0,0,0,0,0,0,0,0,2,0,0,2,1
17563,164299,4PiVkHMvtEasaFMOjyfke8CDtZnJS1Ch,G8EPVSXsOYB5YQWZGiz1aVq5Pgr2GrQu,5,1,1,0,1,0,2,0,5,0.7142857142857143,1,0.0,0,1,0,1,1,0,0,2,0,2,3,1
17564,164300,4pta5bIC2z8xvBYipNvHjqZfFKDEeM7X,SpATywNh6bZuzm8s1ceuBUnMUAeoAHHw,3,2,0,0,0,0,1,0,3,0.42857142857142855,1,0.0,0,0,0,0,2,0,0,1,0,0,3,0
17565,164304,P61EBU96iANevNQaamAZ1nmVdv1hlahG,RXDvfPUBYFlVdlueBFbLW0mhhAyGEqpt,5,2,1,0,1,0,2,0,6,0.8571428571428571,1,0.0,0,1,0,1,2,0,0,2,0,2,4,1
17566,164310,3kLiq8d9Yk709I1l6E6cFZpYQ45LBOgu,bWdj2GDclj5ofokWjzoa5jAwMkxCykd6,13,13,5,24,5,8,4,1,60,8.571428571428571,1,0.0,6,5,22,5,7,8,2,4,1,38,22,1
17567,164321,u889jcGO7u4YLeZfY23r5rctOxqBf6PA,SpATywNh6bZuzm8s1ceuBUnMUAeoAHHw,4,2,1,0,1,0,1,0,5,0.7142857142857143,1,0.0,0,1,0,1,2,0,0,1,0,2,3,1
17568,164323,KhocfHwmF39ufDx3XWH1QBLAW0hrIea9,SpATywNh6bZuzm8s1ceuBUnMUAeoAHHw,5,2,1,0,1,0,2,0,6,0.8571428571428571,1,0.0,0,1,0,1,2,0,0,2,0,2,4,1
17569,164326,Elyv0DBesmIDtda22RvPoYHZeyVOycgU,SpATywNh6bZuzm8s1ceuBUnMUAeoAHHw,13,16,5,13,3,0,5,0,42,6.0,2,0.0,6,5,13,3,10,0,0,5,0,27,15,0
17570,164333,pDmI6y2Fn3FHC3y8A6z8rbPnUAwXuAZ7,bWdj2GDclj5ofokWjzoa5jAwMkxCykd6,5,12,1,0,2,0,1,0,16,2.2857142857142856,2,0.0,2,1,0,2,10,0,0,1,0,5,11,1
17571,164338,vcmcxuoPWSwobaWPUxsfdhKEplWa2ces,SpATywNh6bZuzm8s1ceuBUnMUAeoAHHw,1,0,0,0,0,0,1,0,1,0.14285714285714285,1,0.0,0,0,0,0,0,0,0,1,0,0,1,1
17572,164341,vxGkTn6WfGBki29hwuSV6Xuc1hbgzs4I,bWdj2GDclj5ofokWjzoa5jAwMkxCykd6,1,0,0,0,0,0,1,0,1,0.14285714285714285,1,0.0,0,0,0,0,0,0,0,1,0,0,1,1
17573,164346,yB2j2tPO2DVKCBBdsLv8a1lbHtfWINMh,SpATywNh6bZuzm8s1ceuBUnMUAeoAHHw,7,14,7,0,5,0,3,0,29,4.142857142857143,3,0.0,1,7,0,5,13,0,0,3,0,13,16,1
17574,164356,MVnPWBm2d0gRS2GY8sfJnIUDF0K4iyE8,SpATywNh6bZuzm8s1ceuBUnMUAeoAHHw,1,0,0,0,0,0,1,0,1,0.14285714285714285,1,0.0,0,0,0,0,0,0,0,1,0,0,1,1
17575,164357,JsqrqubnjjSuqmmuivzKTDyASkdX1tsp,bWdj2GDclj5ofokWjzoa5jAwMkxCykd6,4,2,1,0,1,0,1,0,5,0.7142857142857143,1,0.0,0,1,0,1,2,0,0,1,0,2,3,1
17576,164378,Gt7xzQhw88EwESh7Xb4lU1zFZmxNJNIK,SpATywNh6bZuzm8s1ceuBUnMUAeoAHHw,9,7,4,0,1,2,7,1,22,3.142857142857143,2,0.0,0,4,0,1,7,2,0,7,1,5,17,1
17577,164387,ocTIjxG8zBs0mQRpUtpuAKc7MDpzU7Sd,SpATywNh6bZuzm8s1ceuBUnMUAeoAHHw,18,37,15,16,4,54,21,4,151,21.571428571428573,5,0.0,12,15,14,4,25,54,2,21,4,45,106,0
17578,164395,TAkEj78WoaHvO22LXzTn955rJBXiVudz,SpATywNh6bZuzm8s1ceuBUnMUAeoAHHw,1,0,0,0,0,0,1,0,1,0.14285714285714285,1,0.0,0,0,0,0,0,0,0,1,0,0,1,1
17579,164400,PUS8mu8K3BWjJGC8YlXjmQjHGQC9v5P9,SpATywNh6bZuzm8s1ceuBUnMUAeoAHHw,6,6,1,0,0,0,2,0,9,1.2857142857142858,1,0.0,0,1,0,0,6,0,0,2,0,1,8,1
17580,164403,ORIXOLqWtzi0s28E5aG42qOb01NSXSRE,SpATywNh6bZuzm8s1ceuBUnMUAeoAHHw,1,0,0,0,0,0,1,0,1,0.14285714285714285,1,0.0,0,0,0,0,0,0,0,1,0,0,1,1
17581,164404,mR38LOzPkDgy4Z7CZO92yHt4TSlNwfzC,bWdj2GDclj5ofokWjzoa5jAwMkxCykd6,14,31,1,50,1,12,23,6,124,17.714285714285715,3,0.0,10,1,45,1,21,12,5,23,6,57,67,1
17582,164407,KFG6G55toGAeaWBt5UmyioW5n1NVxSjT,SpATywNh6bZuzm8s1ceuBUnMUAeoAHHw,6,6,4,0,3,0,3,0,16,2.2857142857142856,1,0.0,0,4,0,3,6,0,0,3,0,7,9,1
17583,164411,y0PkAopIdLmRFrkWC9eBHvWT77KfVWMh,G8EPVSXsOYB5YQWZGiz1aVq5Pgr2GrQu,7,15,8,0,6,4,11,0,44,6.285714285714286,2,0.0,1,8,0,6,14,4,0,11,0,15,29,1
17584,164412,Z8r3kWGF2ZuWSy5TZGg00SEG4qfRh2Ag,bWdj2GDclj5ofokWjzoa5jAwMkxCykd6,5,6,3,0,1,0,5,0,15,2.142857142857143,3,0.0,0,3,0,1,6,0,0,5,0,4,11,1
17585,164415,GJ6G7nOOlt6NQXt3GWs6ppYe9Y1fZaES,bWdj2GDclj5ofokWjzoa5jAwMkxCykd6,1,0,0,0,0,0,1,0,1,0.14285714285714285,1,0.0,0,0,0,0,0,0,0,1,0,0,1,1
17586,164425,GJ6G7nOOlt6NQXt3GWs6ppYe9Y1fZaES,SpATywNh6bZuzm8s1ceuBUnMUAeoAHHw,1,0,0,0,0,0,1,0,1,0.14285714285714285,1,0.0,0,0,0,0,0,0,0,1,0,0,1,1
17587,164433,kaAc9OSRmTYmUacyuwJF8uvWHTHZhU6I,RXDvfPUBYFlVdlueBFbLW0mhhAyGEqpt,27,17,11,35,8,0,1,0,72,10.285714285714286,1,0.0,5,11,31,8,12,0,4,1,0,55,17,1
17588,164435,notZnFUBIqcbpWIYWbyK9wwcfdCEbsj2,RXDvfPUBYFlVdlueBFbLW0mhhAyGEqpt,6,2,1,0,1,0,3,0,7,1.0,1,0.0,0,1,0,1,2,0,0,3,0,2,5,1
17589,164436,Dqr6qIWfTOfWtI2PbseZL8Rm5WmdZOyL,SpATywNh6bZuzm8s1ceuBUnMUAeoAHHw,8,12,0,15,0,23,1,0,51,7.285714285714286,1,0.0,6,0,14,0,6,23,1,1,0,20,31,1
17590,164444,R7nlNg2K1A6D7NxbdpuHIgXqttVlWJcu,RXDvfPUBYFlVdlueBFbLW0mhhAyGEqpt,1,0,0,0,0,0,1,0,1,0.14285714285714285,1,0.0,0,0,0,0,0,0,0,1,0,0,1,1
17591,164447,JfftjOGdDbpgbrupi0Gwr899R0jzXikJ,bWdj2GDclj5ofokWjzoa5jAwMkxCykd6,11,16,8,0,4,5,9,2,44,6.285714285714286,4,0.0,0,8,0,4,16,5,0,9,2,12,32,1
17592,164452,LLZV0fRwNBkHHCO0iJlbUS4AGPQGvo8C,SpATywNh6bZuzm8s1ceuBUnMUAeoAHHw,10,15,0,14,1,0,2,0,32,4.571428571428571,1,0.0,8,0,13,1,7,0,1,2,0,22,10,1
17593,164456,QYjw7Y4e4Czbt9G691x4dA9fq3fXHjUR,bWdj2GDclj5ofokWjzoa5jAwMkxCykd6,6,2,1,0,1,7,6,0,17,2.4285714285714284,2,0.0,0,1,0,1,2,7,0,6,0,2,15,1
17594,164457,RNMplhTvSIPFgFZTfBAvIrYzbjwGfRpO,RXDvfPUBYFlVdlueBFbLW0mhhAyGEqpt,16,17,9,6,6,0,8,8,54,7.714285714285714,2,0.0,2,9,6,6,15,0,0,8,8,23,31,1
17595,164474,WLXtV9xU02TWrBcV5JQ79YomKzdOBWBA,bWdj2GDclj5ofokWjzoa5jAwMkxCykd6,4,5,2,0,0,0,2,0,9,1.2857142857142858,2,0.0,0,2,0,0,5,0,0,2,0,2,7,1
17596,164475,PrXGfRfcXAOp5eyOk9i7xyvPZyDLOEXf,SpATywNh6bZuzm8s1ceuBUnMUAeoAHHw,1,0,0,0,0,0,1,0,1,0.14285714285714285,1,0.0,0,0,0,0,0,0,0,1,0,0,1,1
17597,164476,1QkcpD1DfxC2p3XNS9AeGnCICPIyGC1C,SpATywNh6bZuzm8s1ceuBUnMUAeoAHHw,6,3,2,0,2,0,1,0,8,1.1428571428571428,1,0.0,0,2,0,2,3,0,0,1,0,4,4,1
17598,164478,lcxEu4F2dIRGolbGM8J7dkDro6hPXvBJ,SpATywNh6bZuzm8s1ceuBUnMUAeoAHHw,12,21,9,8,1,4,11,0,54,7.714285714285714,2,0.0,8,9,8,1,13,4,0,11,0,26,28,0
17599,164487,NA8Wgtfbm0wtXt1SByxQO0XvsqhkLzxE,SpATywNh6bZuzm8s1ceuBUnMUAeoAHHw,5,3,1,0,1,0,1,0,6,0.8571428571428571,1,0.0,0,1,0,1,3,0,0,1,0,2,4,1
17600,164489,rZSqEDajDij6VIcQBEDrdSlRO8swoKNK,SpATywNh6bZuzm8s1ceuBUnMUAeoAHHw,7,1,1,0,1,1,4,1,9,1.2857142857142858,1,0.0,0,1,0,1,1,1,0,4,1,2,7,1
17601,164491,Gcm2rqLAF1kWEJPfH2gzQRI0pndoww3G,bWdj2GDclj5ofokWjzoa5jAwMkxCykd6,8,8,5,0,3,0,6,0,22,3.142857142857143,2,0.0,0,5,0,3,8,0,0,6,0,8,14,1
17602,164492,p3tXqS62uMFoMZgoBWInrsBqScyEVB75,RXDvfPUBYFlVdlueBFbLW0mhhAyGEqpt,9,13,6,0,4,1,13,3,40,5.714285714285714,1,0.0,0,6,0,4,13,1,0,13,3,10,30,1
17603,164497,r0yZNwEG828V0TMkCl61Reya5Y5HO5aR,SpATywNh6bZuzm8s1ceuBUnMUAeoAHHw,13,24,12,0,7,2,9,2,56,8.0,3,0.0,0,12,0,7,24,2,0,9,2,19,37,1
17604,164505,yL460nvgMDqeAUMg6jxieurwSdj92YoI,SpATywNh6bZuzm8s1ceuBUnMUAeoAHHw,12,17,0,20,1,35,5,1,79,11.285714285714286,3,0.0,5,0,16,1,12,35,4,5,1,22,57,1
17605,164513,AaS8GsfaaiK26oA6b0QdGhs8opVCkjvV,RXDvfPUBYFlVdlueBFbLW0mhhAyGEqpt,1,0,0,0,0,0,1,0,1,0.14285714285714285,1,0.0,0,0,0,0,0,0,0,1,0,0,1,1
17606,164515,7wCkCmm5cR5EEXcCUnyxM6sXtrHGDdV9,SpATywNh6bZuzm8s1ceuBUnMUAeoAHHw,6,3,0,0,1,0,2,0,6,0.8571428571428571,1,0.0,0,0,0,1,3,0,0,2,0,1,5,1
17607,164516,kdAMRS8ek5nIImAJzh3SQaTESbJTFYQj,SpATywNh6bZuzm8s1ceuBUnMUAeoAHHw,14,10,5,9,3,0,5,2,34,4.857142857142857,1,0.0,3,5,8,3,7,0,1,5,2,19,15,1
17608,164522,KsAGy1yiN8nYXJpS6DHcH3mgCmV9iuno,RXDvfPUBYFlVdlueBFbLW0mhhAyGEqpt,19,14,12,0,8,0,2,0,36,5.142857142857143,2,0.0,0,12,0,8,14,0,0,2,0,20,16,1
17609,164523,plzzrHT4KCGyPPQGvIdYTvuIq5SPXcu1,RXDvfPUBYFlVdlueBFbLW0mhhAyGEqpt,7,1,1,0,1,2,9,2,16,2.2857142857142856,1,0.0,0,1,0,1,1,2,0,9,2,2,14,1
17610,164524,T9Cyxm8vF5hMWVEQAwASNLuJdzjdg5o1,SpATywNh6bZuzm8s1ceuBUnMUAeoAHHw,1,0,0,0,0,0,1,0,1,0.14285714285714285,1,0.0,0,0,0,0,0,0,0,1,0,0,1,1
17611,164529,Ldp7KDHbr0atRXYQ3DSiKhwRPw9nfvPl,SpATywNh6bZuzm8s1ceuBUnMUAeoAHHw,1,0,0,0,0,0,1,0,1,0.14285714285714285,1,0.0,0,0,0,0,0,0,0,1,0,0,1,1
17612,164534,8yNyyy8aPKd19nuqwaynaLkU67KuROpn,SpATywNh6bZuzm8s1ceuBUnMUAeoAHHw,4,3,1,0,1,0,1,0,6,0.8571428571428571,1,0.0,0,1,0,1,3,0,0,1,0,2,4,1
17613,164537,9poFqdhDn1jEwJp6tGIQlD3gMA14zAqO,RXDvfPUBYFlVdlueBFbLW0mhhAyGEqpt,15,38,0,13,1,0,8,0,60,8.571428571428571,4,0.0,2,0,13,1,36,0,0,8,0,16,44,1
17614,164539,TMVDThY2bkgDg7sHqM0GQP2XTTPMcYfY,SpATywNh6bZuzm8s1ceuBUnMUAeoAHHw,8,6,3,0,2,7,4,0,22,3.142857142857143,1,0.0,0,3,0,2,6,7,0,4,0,5,17,1
17615,164542,8p1yDT05QCsKrFjaE90DCIRByQyt5uxS,bWdj2GDclj5ofokWjzoa5jAwMkxCykd6,5,2,0,0,0,0,3,0,5,0.7142857142857143,1,0.0,0,0,0,0,2,0,0,3,0,0,5,1
17616,164552,SOZQ09msP4gFSDHArJmMSKrG8q4wIkm6,bWdj2GDclj5ofokWjzoa5jAwMkxCykd6,5,3,1,0,1,0,2,0,7,1.0,1,0.0,0,1,0,1,3,0,0,2,0,2,5,1
17617,164557,xN8qQh9NkfWvTtFHmPyQN8TpX680eL1v,SpATywNh6bZuzm8s1ceuBUnMUAeoAHHw,8,4,3,0,3,0,1,0,11,1.5714285714285714,1,0.0,0,3,0,3,4,0,0,1,0,6,5,1
17618,164565,s6KPq1RjdqeVgQrh8kntPjnSOHQAM1j3,SpATywNh6bZuzm8s1ceuBUnMUAeoAHHw,4,4,1,0,0,2,2,0,9,1.2857142857142858,2,0.0,0,1,0,0,4,2,0,2,0,1,8,1
17619,164568,y79Bz5Pe0nNA2zswV3Szg0JL3sj7FjTw,SpATywNh6bZuzm8s1ceuBUnMUAeoAHHw,7,8,0,10,0,1,1,0,20,2.857142857142857,1,0.0,4,0,9,0,4,1,1,1,0,13,7,1
17620,164575,bNBhDpviOcrLuVFG9Qda6S7fiYJ6jIvc,RXDvfPUBYFlVdlueBFbLW0mhhAyGEqpt,16,16,12,11,7,0,5,0,51,7.285714285714286,1,0.0,1,12,9,7,15,0,2,5,0,29,22,1
17621,164576,mFgVeo284zyRw0AHsEf7Tlutzf0jRu5y,G8EPVSXsOYB5YQWZGiz1aVq5Pgr2GrQu,38,42,24,38,15,0,12,2,133,19.0,3,0.0,12,24,26,15,30,0,12,12,2,77,56,1
17622,164583,4M7imMvvjejITdlkdL2tmwikUUTIrCPh,SpATywNh6bZuzm8s1ceuBUnMUAeoAHHw,5,2,1,0,1,3,2,0,9,1.2857142857142858,1,0.0,0,1,0,1,2,3,0,2,0,2,7,1
17623,164586,z1G7LpYxsjwTZY4hppMJzutv7SFcW56t,bWdj2GDclj5ofokWjzoa5jAwMkxCykd6,5,8,5,0,3,1,3,0,20,2.857142857142857,2,0.0,0,5,0,3,8,1,0,3,0,8,12,1
17624,164588,LqURTBP4yk5vSqNo0hCLASnfQyzdI5Pp,SpATywNh6bZuzm8s1ceuBUnMUAeoAHHw,5,7,0,0,0,1,2,0,10,1.4285714285714286,1,0.0,0,0,0,0,7,1,0,2,0,0,10,1
17625,164596,huVRXsZzo8sJwzNaUCXkQqT8IVauIRmI,G8EPVSXsOYB5YQWZGiz1aVq5Pgr2GrQu,5,3,1,0,1,0,1,0,6,0.8571428571428571,1,0.0,0,1,0,1,3,0,0,1,0,2,4,1
17626,164599,3eIemZUCKErDOaY2n5eaZc2Nb7KmqL3h,SpATywNh6bZuzm8s1ceuBUnMUAeoAHHw,7,3,1,0,1,0,4,0,9,1.2857142857142858,1,0.0,0,1,0,1,3,0,0,4,0,2,7,1
17627,164604,D5T00vfAoymuLZctUEYUqWRUSFLxc6S2,SpATywNh6bZuzm8s1ceuBUnMUAeoAHHw,17,13,8,6,5,0,16,9,57,8.142857142857142,1,0.0,2,8,6,5,11,0,0,16,9,21,36,1
17628,164609,KGwvzr0w0g2Ui1Ce7HWqcTPb5LubNTcC,bWdj2GDclj5ofokWjzoa5jAwMkxCykd6,16,26,11,132,7,0,7,0,183,26.142857142857142,1,0.0,14,11,128,7,12,0,4,7,0,160,23,1
17629,164612,vMgdrowUhfs65egdim3M3Ibio1bafxKv,SpATywNh6bZuzm8s1ceuBUnMUAeoAHHw,3,2,0,0,0,0,1,0,3,0.42857142857142855,1,0.0,0,0,0,0,2,0,0,1,0,0,3,1
17630,164614,Ia1CTpUugiWywdlf9kz3F5HfoicyRI2a,SpATywNh6bZuzm8s1ceuBUnMUAeoAHHw,10,12,0,22,0,0,8,0,42,6.0,1,0.0,6,0,17,0,6,0,5,8,0,23,19,1
17631,164618,GMzSpgZQ6jzVsfHn8W8i83JsYNxnP00b,bWdj2GDclj5ofokWjzoa5jAwMkxCykd6,3,2,0,0,0,0,1,0,3,0.42857142857142855,1,0.0,0,0,0,0,2,0,0,1,0,0,3,1
17632,164621,OK36i7c8u9GmSfG9DXL0YN94pRFkcmzE,bWdj2GDclj5ofokWjzoa5jAwMkxCykd6,10,14,4,62,3,0,3,1,87,12.428571428571429,1,0.0,9,4,62,3,5,0,0,3,1,78,9,1
17633,164623,rk9NUxSXr4iC638u7CUrQUKNTm3BCpYr,bWdj2GDclj5ofokWjzoa5jAwMkxCykd6,5,5,0,0,0,0,2,0,7,1.0,1,0.0,0,0,0,0,5,0,0,2,0,0,7,1
17634,164624,h3Oxw2qM6MZeJxbxgclKfxWrkznzqR3o,SpATywNh6bZuzm8s1ceuBUnMUAeoAHHw,1,0,0,0,0,0,1,0,1,0.14285714285714285,1,0.0,0,0,0,0,0,0,0,1,0,0,1,1
17635,164625,9BDe6DEjC6kCZdUf85MYhGs6ssX3Yd66,SpATywNh6bZuzm8s1ceuBUnMUAeoAHHw,2,0,0,0,0,0,2,0,2,0.2857142857142857,1,0.0,0,0,0,0,0,0,0,2,0,0,2,1
17636,164629,SVcpJb6gXZcQDuOEWDQYFqv2P86R1Xaj,bWdj2GDclj5ofokWjzoa5jAwMkxCykd6,1,0,0,0,0,0,2,0,2,0.2857142857142857,1,0.0,0,0,0,0,0,0,0,2,0,0,2,1
17637,164630,MWkXS8wTteiq3wnUOJQXQCzRJDoS4fUl,SpATywNh6bZuzm8s1ceuBUnMUAeoAHHw,8,11,1,0,1,2,8,2,25,3.5714285714285716,2,0.0,0,1,0,1,11,2,0,8,2,2,23,1
17638,164633,jQaCxlcrIW3B0ti76HtzjtRZOLJHPbzy,SpATywNh6bZuzm8s1ceuBUnMUAeoAHHw,6,8,4,0,0,0,1,0,13,1.8571428571428572,1,0.0,0,4,0,0,8,0,0,1,0,4,9,1
17639,164639,ZRcEnEYSSBQbkjzMu7sidjbxasfrmw8l,bWdj2GDclj5ofokWjzoa5jAwMkxCykd6,3,6,1,0,1,0,1,0,9,1.2857142857142858,1,0.0,2,1,0,1,4,0,0,1,0,4,5,1
17640,164650,WQKKwzu8xDLLktMRV89tUbRag4kJ87WF,SpATywNh6bZuzm8s1ceuBUnMUAeoAHHw,11,6,3,0,2,1,5,1,18,2.5714285714285716,1,0.0,0,3,0,2,6,1,0,5,1,5,13,1
17641,164652,pOBmP02v5rRyUAaKAfr6us8i87HHPyHg,G8EPVSXsOYB5YQWZGiz1aVq5Pgr2GrQu,8,6,3,0,3,0,7,0,19,2.7142857142857144,3,0.0,0,3,0,3,6,0,0,7,0,6,13,1
17642,164654,kW1xniKv3zwqO5oh82gt2iROU6EwbCnD,bWdj2GDclj5ofokWjzoa5jAwMkxCykd6,9,5,1,18,1,0,3,0,28,4.0,1,0.0,2,1,17,1,3,0,1,3,0,21,7,1
17643,164662,4lIBX7jVNURqeuVw7y54KWNhg5lYseZ6,SpATywNh6bZuzm8s1ceuBUnMUAeoAHHw,8,7,5,0,1,0,3,0,16,2.2857142857142856,2,0.0,0,5,0,1,7,0,0,3,0,6,10,1
17644,164669,Ib8KHMHKfyTwrkbnwsSOuVq4nV1vOamx,bWdj2GDclj5ofokWjzoa5jAwMkxCykd6,7,8,2,0,2,0,3,0,15,2.142857142857143,2,0.0,3,2,0,2,5,0,0,3,0,7,8,1
17645,164672,JnItsaXrVUFk1SorJ52og61s5dE3TwDr,SpATywNh6bZuzm8s1ceuBUnMUAeoAHHw,13,18,2,15,0,0,7,1,43,6.142857142857143,2,0.0,8,2,14,0,10,0,1,7,1,24,19,1
17646,164694,uUMf8oHT3hYC8oh9guwKDiIUlL3eooGH,RXDvfPUBYFlVdlueBFbLW0mhhAyGEqpt,6,5,0,0,0,0,1,0,6,0.8571428571428571,1,0.0,0,0,0,0,5,0,0,1,0,0,6,1
17647,164698,xKvX1ldWoix080dPRcCCrhtY6KsUvocI,SpATywNh6bZuzm8s1ceuBUnMUAeoAHHw,6,3,2,0,1,0,3,0,9,1.2857142857142858,2,0.0,0,2,0,1,3,0,0,3,0,3,6,1
17648,164708,QRKDYncXtzqUo7eYzl5ZNiNJ63G2lU5V,bWdj2GDclj5ofokWjzoa5jAwMkxCykd6,3,3,1,0,0,0,2,0,6,0.8571428571428571,1,0.0,0,1,0,0,3,0,0,2,0,1,5,1
17649,164710,T4zdcGe48q1WGzA0YIvniMTWo2k6dk59,SpATywNh6bZuzm8s1ceuBUnMUAeoAHHw,3,2,0,0,0,0,1,0,3,0.42857142857142855,1,0.0,0,0,0,0,2,0,0,1,0,0,3,1
17650,164715,D5IkCYseUCO88GE1B1rMaRAAZyqCPk5T,G8EPVSXsOYB5YQWZGiz1aVq5Pgr2GrQu,1,0,0,0,0,0,1,0,1,0.14285714285714285,1,0.0,0,0,0,0,0,0,0,1,0,0,1,1
17651,164718,YHt0dZJFvCE3vP08l7NFcQ3cbtNDgaRS,SpATywNh6bZuzm8s1ceuBUnMUAeoAHHw,7,6,3,0,2,0,3,0,14,2.0,1,0.0,0,3,0,2,6,0,0,3,0,5,9,1
17652,164720,6CAW15U7onmNe5U8VRNHyhImgcvFA6AP,G8EPVSXsOYB5YQWZGiz1aVq5Pgr2GrQu,7,3,2,0,2,0,2,0,9,1.2857142857142858,1,0.0,0,2,0,2,3,0,0,2,0,4,5,1
17653,164721,WhbpJZxh93gnEo0Bkb56Vi4OStNv0BeR,G8EPVSXsOYB5YQWZGiz1aVq5Pgr2GrQu,6,4,2,0,1,0,2,0,9,1.2857142857142858,1,0.0,0,2,0,1,4,0,0,2,0,3,6,1
17654,164725,dpMiuMIGfVjkJNBGAa2GW5Vztul0ul4C,SpATywNh6bZuzm8s1ceuBUnMUAeoAHHw,14,26,6,23,2,19,6,0,82,11.714285714285714,2,0.0,15,6,20,2,11,19,3,6,0,43,39,1
17655,164731,haO9EV3Nk4mk3OeBYKT0QOiPfUTqVhFn,SpATywNh6bZuzm8s1ceuBUnMUAeoAHHw,10,16,0,6,0,0,2,0,24,3.4285714285714284,1,0.0,4,0,6,0,12,0,0,2,0,10,14,1
17656,164737,IaoTQrvjcHkJTQC9F8CfKXXVgVZXu8JB,SpATywNh6bZuzm8s1ceuBUnMUAeoAHHw,5,2,1,0,1,0,5,0,9,1.2857142857142858,1,0.0,0,1,0,1,2,0,0,5,0,2,7,1
17657,164746,ikRlhkwZCU39UKjMqWVQGSSX3n2hrElG,SpATywNh6bZuzm8s1ceuBUnMUAeoAHHw,1,0,0,0,0,0,2,0,2,0.2857142857142857,1,0.0,0,0,0,0,0,0,0,2,0,0,2,1
17658,164749,DVyimdGTTnbLGYwEpoGlJAG1kt7yY9fR,SpATywNh6bZuzm8s1ceuBUnMUAeoAHHw,4,2,1,0,1,0,1,0,5,0.7142857142857143,1,0.0,0,1,0,1,2,0,0,1,0,2,3,1
17659,164755,hgQRm8OL4JkmLyk7gplu1M4NKLxrHiyO,SpATywNh6bZuzm8s1ceuBUnMUAeoAHHw,4,2,1,0,1,0,1,0,5,0.7142857142857143,1,0.0,0,1,0,1,2,0,0,1,0,2,3,1
17660,164769,w14rTBVaKAEl5wo1WnNS26mWscctUzrO,SpATywNh6bZuzm8s1ceuBUnMUAeoAHHw,17,14,8,14,7,1,2,0,46,6.571428571428571,2,0.0,5,8,12,7,9,1,2,2,0,32,14,1
17661,164771,qOfaZTBIbb7J17xXt4ZWUinnClou9TNY,SpATywNh6bZuzm8s1ceuBUnMUAeoAHHw,13,19,0,17,0,11,11,2,60,8.571428571428571,1,0.0,13,0,15,0,6,11,2,11,2,28,32,1
17662,164775,s8rbNwiDb6Ued6nUvpbwuDl2s256fOiD,bWdj2GDclj5ofokWjzoa5jAwMkxCykd6,8,4,1,0,1,1,5,1,13,1.8571428571428572,1,0.0,0,1,0,1,4,1,0,5,1,2,11,1
17663,164791,6aBFBdVzdNrq3IlbLV8DRjoHXWBDTkRv,bWdj2GDclj5ofokWjzoa5jAwMkxCykd6,1,0,0,0,0,0,1,0,1,0.14285714285714285,1,0.0,0,0,0,0,0,0,0,1,0,0,1,1
17664,164793,VD6TkymcxBFMdB1MoYEexj8K6lT6eEyR,bWdj2GDclj5ofokWjzoa5jAwMkxCykd6,9,6,2,18,2,13,5,1,47,6.714285714285714,1,0.0,3,2,18,2,3,13,0,5,1,25,22,1
17665,164798,jmSgKLjYRvCwLEN3cPhxDpejaRW1URFZ,SpATywNh6bZuzm8s1ceuBUnMUAeoAHHw,4,2,1,0,1,0,1,0,5,0.7142857142857143,1,0.0,0,1,0,1,2,0,0,1,0,2,3,1
17666,164799,pPZkiQmDPKqQ9IZ0jTf8ExIfHdZSz9Tp,SpATywNh6bZuzm8s1ceuBUnMUAeoAHHw,14,18,7,18,4,11,5,1,64,9.142857142857142,2,0.0,9,7,15,4,9,11,3,5,1,35,29,1
17667,164800,Exq64VXC5vAwuYwY4YHzQg0BjMOxcioB,G8EPVSXsOYB5YQWZGiz1aVq5Pgr2GrQu,1,0,0,0,0,0,1,0,1,0.14285714285714285,1,0.0,0,0,0,0,0,0,0,1,0,0,1,1
17668,164805,BBfiARXlf8DQ4mmAXStqrzMqGcJUzid6,bWdj2GDclj5ofokWjzoa5jAwMkxCykd6,4,4,0,0,0,1,1,0,6,0.8571428571428571,1,0.0,0,0,0,0,4,1,0,1,0,0,6,1
17669,164807,aKmGG28IIMsmRYbcnkO5kp7ipo4I9wj0,bWdj2GDclj5ofokWjzoa5jAwMkxCykd6,1,0,0,0,0,0,1,0,1,0.14285714285714285,1,0.0,0,0,0,0,0,0,0,1,0,0,1,1
17670,164813,cZWFemuqv22LyBzJ62hqYFI8OPrcmsVO,RXDvfPUBYFlVdlueBFbLW0mhhAyGEqpt,1,0,0,0,0,0,1,0,1,0.14285714285714285,1,0.0,0,0,0,0,0,0,0,1,0,0,1,1
17671,164816,2uLwwxMo6zi7FYS0noJqK7cA1dw8HmPb,SpATywNh6bZuzm8s1ceuBUnMUAeoAHHw,1,0,0,0,0,0,1,0,1,0.14285714285714285,1,0.0,0,0,0,0,0,0,0,1,0,0,1,1
17672,164817,WTwb8dUqzcP0BlBT1I9MZd2r9gTEXFM0,bWdj2GDclj5ofokWjzoa5jAwMkxCykd6,5,2,1,0,1,0,2,0,6,0.8571428571428571,1,0.0,0,1,0,1,2,0,0,2,0,2,4,1
17673,164818,7xT79xUxciGCPT2px4CYK4DLm3lIDEn8,bWdj2GDclj5ofokWjzoa5jAwMkxCykd6,3,2,1,0,0,0,1,0,4,0.5714285714285714,1,0.0,0,1,0,0,2,0,0,1,0,1,3,1
17674,164819,td1qPqbY65yQMbPFzvqLZhtQGNGi89Aa,SpATywNh6bZuzm8s1ceuBUnMUAeoAHHw,21,25,11,25,4,0,16,1,82,11.714285714285714,3,0.0,11,11,21,4,14,0,4,16,1,47,35,1
17675,164820,opdILbT2IBFIYJvyIT5NXM7ymKeuMTcM,bWdj2GDclj5ofokWjzoa5jAwMkxCykd6,4,3,2,0,2,0,4,0,11,1.5714285714285714,2,0.0,0,2,0,2,3,0,0,4,0,4,7,1
17676,164823,xdClWt95AonMUbXmVncDz7pyQAF4u9BG,SpATywNh6bZuzm8s1ceuBUnMUAeoAHHw,4,2,0,0,0,0,3,0,5,0.7142857142857143,1,0.0,0,0,0,0,2,0,0,3,0,0,5,1
17677,164825,IfM7NFN1EcMfjBhCGt0UvdSV1gN33bRZ,bWdj2GDclj5ofokWjzoa5jAwMkxCykd6,2,0,0,0,0,0,4,0,4,0.5714285714285714,1,0.0,0,0,0,0,0,0,0,4,0,0,4,1
17678,164828,v7OTUgukPaXTchqClaPcgxRHfeAHlZs8,SpATywNh6bZuzm8s1ceuBUnMUAeoAHHw,9,4,3,0,2,0,3,1,13,1.8571428571428572,1,0.0,0,3,0,2,4,0,0,3,1,5,8,1
17679,164831,yNygMjDRQbsmQrkdzv6Ni3gEhrA9rC9T,RXDvfPUBYFlVdlueBFbLW0mhhAyGEqpt,2,0,0,0,0,0,2,0,2,0.2857142857142857,1,0.0,0,0,0,0,0,0,0,2,0,0,2,1
17680,164832,DmjOQ53VXOobMBTmNf8WzrNOpoPBXteN,G8EPVSXsOYB5YQWZGiz1aVq5Pgr2GrQu,10,9,3,0,3,0,3,0,18,2.5714285714285716,2,0.0,0,3,0,3,9,0,0,3,0,6,12,1
17681,164833,Vdk84P68xIHXBGrWqw3oEozZYT063dLv,bWdj2GDclj5ofokWjzoa5jAwMkxCykd6,6,2,1,0,1,0,3,0,7,1.0,1,0.0,0,1,0,1,2,0,0,3,0,2,5,1
17682,164839,k0fNZidBUd2gbryk31YveUTLLwvsjsHF,bWdj2GDclj5ofokWjzoa5jAwMkxCykd6,6,5,2,56,1,0,1,0,65,9.285714285714286,1,0.0,2,2,55,1,3,0,1,1,0,60,5,1
17683,164840,MSOPexvB5Mxvh6qEAn5PDvoAxMalQijS,SpATywNh6bZuzm8s1ceuBUnMUAeoAHHw,8,3,2,0,2,0,3,0,10,1.4285714285714286,1,0.0,0,2,0,2,3,0,0,3,0,4,6,1
17684,164843,oVaXXkgNP2VtEgRht0YdjYINkh8LeLTs,bWdj2GDclj5ofokWjzoa5jAwMkxCykd6,7,4,1,0,0,0,4,0,9,1.2857142857142858,1,0.0,0,1,0,0,4,0,0,4,0,1,8,1
17685,164854,iCakYP1w40pz3A1o7VgcbnomKTMQfUiT,RXDvfPUBYFlVdlueBFbLW0mhhAyGEqpt,1,0,0,0,0,0,1,0,1,0.14285714285714285,1,0.0,0,0,0,0,0,0,0,1,0,0,1,1
17686,164859,dgFOOUSNfQK8xIrT47Av0Q04bBFeE21W,SpATywNh6bZuzm8s1ceuBUnMUAeoAHHw,6,3,1,0,1,0,4,0,9,1.2857142857142858,2,0.0,0,1,0,1,3,0,0,4,0,2,7,1
17687,164870,6lI1WuhNHXlfVKzmWVMcaMqLcjUDqRef,SpATywNh6bZuzm8s1ceuBUnMUAeoAHHw,13,17,10,0,6,4,12,1,50,7.142857142857143,2,0.0,5,10,0,6,12,4,0,12,1,21,29,1
17688,164877,jqdafBVztOaU7B8oBuajiXxvz1FDItGv,RXDvfPUBYFlVdlueBFbLW0mhhAyGEqpt,1,0,0,0,0,0,1,0,1,0.14285714285714285,1,0.0,0,0,0,0,0,0,0,1,0,0,1,1
17689,164884,1vSzQDGr3DRQD3m17X46GyHlBw9UnL8Y,SpATywNh6bZuzm8s1ceuBUnMUAeoAHHw,5,2,1,0,1,0,2,0,6,0.8571428571428571,1,0.0,0,1,0,1,2,0,0,2,0,2,4,1
17690,164885,qOfaZTBIbb7J17xXt4ZWUinnClou9TNY,G8EPVSXsOYB5YQWZGiz1aVq5Pgr2GrQu,1,0,0,0,0,0,1,0,1,0.14285714285714285,1,0.0,0,0,0,0,0,0,0,1,0,0,1,1
17691,164894,d1YpWm8ZrJHw6yZFmSUUfwiG1uncdFaC,SpATywNh6bZuzm8s1ceuBUnMUAeoAHHw,7,8,6,0,5,0,2,0,21,3.0,2,0.0,0,6,0,5,8,0,0,2,0,11,10,1
17692,164897,OfowGKzB14DtDFMAzalSIqF59FGJmwsI,SpATywNh6bZuzm8s1ceuBUnMUAeoAHHw,7,4,3,0,2,0,1,0,10,1.4285714285714286,1,0.0,0,3,0,2,4,0,0,1,0,5,5,1
17693,164899,hJaHVe8Xh44z9hukeLNeR2pNBHqQdjsc,SpATywNh6bZuzm8s1ceuBUnMUAeoAHHw,8,5,2,0,2,0,2,0,11,1.5714285714285714,1,0.0,0,2,0,2,5,0,0,2,0,4,7,1
17694,164901,i7nraLaHwBYgXZfTke5TbxgaFvaS9vbl,SpATywNh6bZuzm8s1ceuBUnMUAeoAHHw,9,9,2,0,0,3,8,1,23,3.2857142857142856,2,0.0,2,2,0,0,7,3,0,8,1,4,19,1
17695,164902,kBQcF47B5gP441lpSW9ys93OU4QAjKEG,RXDvfPUBYFlVdlueBFbLW0mhhAyGEqpt,1,0,0,0,0,0,1,0,1,0.14285714285714285,1,0.0,0,0,0,0,0,0,0,1,0,0,1,1
17696,164903,kBQcF47B5gP441lpSW9ys93OU4QAjKEG,G8EPVSXsOYB5YQWZGiz1aVq5Pgr2GrQu,2,0,0,0,0,0,2,0,2,0.2857142857142857,1,0.0,0,0,0,0,0,0,0,2,0,0,2,1
17697,164905,plHbrJsV4vYGjRBOcUzcsYwkbv9wQX5B,SpATywNh6bZuzm8s1ceuBUnMUAeoAHHw,7,3,2,0,1,0,6,1,13,1.8571428571428572,1,0.0,0,2,0,1,3,0,0,6,1,3,10,1
17698,164913,0Gs9Qa1O3WvMBUAbfZOfCgWR0kizA6yM,bWdj2GDclj5ofokWjzoa5jAwMkxCykd6,6,2,0,0,0,0,8,0,10,1.4285714285714286,1,0.0,0,0,0,0,2,0,0,8,0,0,10,1
17699,164921,ID4lEXkhsumNcBZAAsLvwOjDHErWPU9z,RXDvfPUBYFlVdlueBFbLW0mhhAyGEqpt,7,7,2,0,2,0,2,0,13,1.8571428571428572,1,0.0,0,2,0,2,7,0,0,2,0,4,9,1
17700,164925,AI4uNtWiMMh2sMzoXDYV3Lbf88yJL8Br,SpATywNh6bZuzm8s1ceuBUnMUAeoAHHw,14,24,10,17,7,2,11,0,71,10.142857142857142,2,0.0,4,10,15,7,20,2,2,11,0,36,35,1
17701,164933,oz2lIvXgN1G19jRJoPetgndSl9b9808T,bWdj2GDclj5ofokWjzoa5jAwMkxCykd6,9,13,6,0,6,0,2,0,27,3.857142857142857,3,0.0,4,6,0,6,9,0,0,2,0,16,11,1
17702,164941,j0ueLtQ2R4YY5IElzCXogrNJYFltC4bt,G8EPVSXsOYB5YQWZGiz1aVq5Pgr2GrQu,13,21,4,0,5,0,5,0,35,5.0,3,0.0,3,4,0,5,18,0,0,5,0,12,23,1
17703,164948,aGKf0W7DbO5pZNcjJ5sGrg9jyzAmLXkB,bWdj2GDclj5ofokWjzoa5jAwMkxCykd6,8,11,4,0,2,0,8,0,25,3.5714285714285716,1,0.0,0,4,0,2,11,0,0,8,0,6,19,1
17704,164949,QJffKxs9lkFscQquMcfEw8hYo0ArYTkN,SpATywNh6bZuzm8s1ceuBUnMUAeoAHHw,6,7,1,0,1,0,3,0,12,1.7142857142857142,4,0.0,0,1,0,1,7,0,0,3,0,2,10,1
17705,164952,oZPmpjOeoiaunM2zVcQx8binL7fSfr4d,SpATywNh6bZuzm8s1ceuBUnMUAeoAHHw,1,0,0,0,0,0,1,0,1,0.14285714285714285,1,0.0,0,0,0,0,0,0,0,1,0,0,1,1
17706,164955,5BBW4T6qopgkCdcRVxFBI93aopzlZ3Vz,bWdj2GDclj5ofokWjzoa5jAwMkxCykd6,5,5,3,0,1,0,2,0,11,1.5714285714285714,2,0.0,0,3,0,1,5,0,0,2,0,4,7,1
17707,164957,1d49ijo1gfMUzl6uYLthfVZwQuAtGF5H,SpATywNh6bZuzm8s1ceuBUnMUAeoAHHw,1,0,0,0,0,0,1,0,1,0.14285714285714285,1,0.0,0,0,0,0,0,0,0,1,0,0,1,1
17708,164958,d9MkkuCn04Toz7g1JpLdUJWD9xM5braA,SpATywNh6bZuzm8s1ceuBUnMUAeoAHHw,1,0,0,0,0,0,1,0,1,0.14285714285714285,1,0.0,0,0,0,0,0,0,0,1,0,0,1,1
17709,164962,IwDrIHJtpM1SKA7Se5PnSGFRi77bmt0i,G8EPVSXsOYB5YQWZGiz1aVq5Pgr2GrQu,1,0,0,0,0,0,1,0,1,0.14285714285714285,1,0.0,0,0,0,0,0,0,0,1,0,0,1,1
17710,164963,IwDrIHJtpM1SKA7Se5PnSGFRi77bmt0i,bWdj2GDclj5ofokWjzoa5jAwMkxCykd6,2,0,0,0,0,0,2,0,2,0.2857142857142857,1,0.0,0,0,0,0,0,0,0,2,0,0,2,1
17711,164967,Jk09qA6alwSJzVuIqHppbDvZyk5u7ZHA,SpATywNh6bZuzm8s1ceuBUnMUAeoAHHw,23,26,0,33,0,10,13,3,85,12.142857142857142,3,0.0,10,0,29,0,16,10,4,13,3,39,46,1
17712,164978,NimtbKU9auo6KOsWhgU5KdNhvgw88gOw,bWdj2GDclj5ofokWjzoa5jAwMkxCykd6,5,2,1,0,1,0,2,0,6,0.8571428571428571,1,0.0,0,1,0,1,2,0,0,2,0,2,4,1
17713,164983,idGQZu8btUqvVr9UadRnlmVq4UYW0mU2,SpATywNh6bZuzm8s1ceuBUnMUAeoAHHw,1,0,0,0,0,0,1,0,1,0.14285714285714285,1,0.0,0,0,0,0,0,0,0,1,0,0,1,1
17714,164999,muJ6MIRhOdDL6SrbHsZ7Ks5a50Iz9AeC,G8EPVSXsOYB5YQWZGiz1aVq5Pgr2GrQu,64,90,35,24,27,1,12,0,189,27.0,2,0.0,12,35,13,27,78,1,11,12,0,87,102,0
17715,165000,nazeZS8BdRMOGGuVriyb5M21Pn5Qng36,G8EPVSXsOYB5YQWZGiz1aVq5Pgr2GrQu,1,0,0,0,0,0,1,0,1,0.14285714285714285,1,0.0,0,0,0,0,0,0,0,1,0,0,1,1
17716,165009,z79FxI6IxKXksSKIwsXSYM1kOlaP8f6r,A3fsA9Zfv1X2fVEQhTw51lKENdNrEqT3,3,3,0,0,0,0,1,0,4,0.5714285714285714,1,0.0,0,0,0,0,3,0,0,1,0,0,4,1
17717,165020,D1bGDJ4bL5x58ejhrACWlbqkfYdH5dQ6,G8EPVSXsOYB5YQWZGiz1aVq5Pgr2GrQu,2,0,0,0,0,0,5,0,5,0.7142857142857143,1,0.0,0,0,0,0,0,0,0,5,0,0,5,1
17718,165028,l1eQ9gI2TTb4dmIRNT0TZDzdHfiIL8H7,SpATywNh6bZuzm8s1ceuBUnMUAeoAHHw,4,2,1,0,1,0,1,0,5,0.7142857142857143,1,0.0,0,1,0,1,2,0,0,1,0,2,3,1
17719,165035,qKfZusm0R8jxltESvgi15dswdw73Gjlp,SpATywNh6bZuzm8s1ceuBUnMUAeoAHHw,4,6,3,0,0,0,2,0,11,1.5714285714285714,1,0.0,2,3,0,0,4,0,0,2,0,5,6,1
17720,165038,Im85u8aENweba95uFnFOR6zdQWFnfDOq,A3fsA9Zfv1X2fVEQhTw51lKENdNrEqT3,2,0,0,0,0,0,2,0,2,0.2857142857142857,1,0.0,0,0,0,0,0,0,0,2,0,0,2,1
17721,165043,WLEMGeSXBUEafvCWOKhfcrxNQOC05nqM,bWdj2GDclj5ofokWjzoa5jAwMkxCykd6,6,2,1,0,1,0,5,1,10,1.4285714285714286,1,0.0,0,1,0,1,2,0,0,5,1,2,8,1
17722,165045,WzO2F8mFL9S6WyVuaBKRnAo7AfpK6MFq,SpATywNh6bZuzm8s1ceuBUnMUAeoAHHw,7,8,3,0,4,0,2,0,17,2.4285714285714284,2,0.0,0,3,0,4,8,0,0,2,0,7,10,1
17723,165056,AOCx0foyQMeiMTgZQ1N4fT75yVQcQ0J9,A3fsA9Zfv1X2fVEQhTw51lKENdNrEqT3,13,15,7,0,3,0,3,0,28,4.0,2,0.0,0,7,0,3,15,0,0,3,0,10,18,0
17724,165064,PXNipZTrm6ag7nUFRb8wDcb09bEqCKm5,bWdj2GDclj5ofokWjzoa5jAwMkxCykd6,16,7,4,72,1,0,3,0,87,12.428571428571429,1,0.0,0,4,62,1,7,0,10,3,0,67,20,1
17725,165066,jaOmqqWd0RurZsiyeEDBNOhHZZXgisPQ,G8EPVSXsOYB5YQWZGiz1aVq5Pgr2GrQu,124,123,60,300,20,14,34,2,553,79.0,5,0.0,47,60,238,20,76,14,62,34,2,365,188,1
17726,165067,Wm4d7ifDaTgcR0GfUqwJt5OZKbYglRCq,bWdj2GDclj5ofokWjzoa5jAwMkxCykd6,1,0,0,0,0,0,1,0,1,0.14285714285714285,1,0.0,0,0,0,0,0,0,0,1,0,0,1,1
17727,165074,ij6lhOw7nYbJY8ZynpI4C6NhJmjCSNsH,bWdj2GDclj5ofokWjzoa5jAwMkxCykd6,12,13,7,0,6,1,6,1,34,4.857142857142857,2,0.0,3,7,0,6,10,1,0,6,1,16,18,1
17728,165075,ij6lhOw7nYbJY8ZynpI4C6NhJmjCSNsH,A3fsA9Zfv1X2fVEQhTw51lKENdNrEqT3,2,0,0,0,0,0,2,0,2,0.2857142857142857,1,0.0,0,0,0,0,0,0,0,2,0,0,2,1
17729,165079,5B9CBBwEycq9mrKyjhnz4JxWbxAUtqXx,bWdj2GDclj5ofokWjzoa5jAwMkxCykd6,2,0,0,0,0,0,3,0,3,0.42857142857142855,1,0.0,0,0,0,0,0,0,0,3,0,0,3,1
17730,165087,M4k2b8losoqUFktWiKn58aOnUoYhQVU3,A3fsA9Zfv1X2fVEQhTw51lKENdNrEqT3,9,5,4,0,4,0,12,0,25,3.5714285714285716,4,0.0,0,4,0,4,5,0,0,12,0,8,17,0
17731,165098,zX1TLWT3E7MpbG4kzvZO6rEOvxyi9iAE,SpATywNh6bZuzm8s1ceuBUnMUAeoAHHw,4,2,1,0,1,0,1,0,5,0.7142857142857143,1,0.0,0,1,0,1,2,0,0,1,0,2,3,1
17732,165102,8IsnQQnfLzKrobCqyqui1F07ZqYQDg46,G8EPVSXsOYB5YQWZGiz1aVq5Pgr2GrQu,41,102,6,90,13,1,15,2,229,32.714285714285715,3,0.0,54,6,62,13,48,1,28,15,2,135,94,1
17733,165103,Tc9HVYhVH0mbvYBIDHqjba6NetUmurJg,SpATywNh6bZuzm8s1ceuBUnMUAeoAHHw,1,0,0,0,0,0,1,0,1,0.14285714285714285,1,0.0,0,0,0,0,0,0,0,1,0,0,1,1
17734,165110,o0yBW91wJfDjK5Q4nsWKulavXcIg9y1s,SpATywNh6bZuzm8s1ceuBUnMUAeoAHHw,1,0,0,0,0,0,1,0,1,0.14285714285714285,1,0.0,0,0,0,0,0,0,0,1,0,0,1,1
17735,165112,Ml3VPfyUCPhgR4WxRurT5TFwkYDGbSwH,SpATywNh6bZuzm8s1ceuBUnMUAeoAHHw,13,8,6,0,3,2,6,1,26,3.7142857142857144,1,0.0,0,6,0,3,8,2,0,6,1,9,17,1
17736,165114,o0yBW91wJfDjK5Q4nsWKulavXcIg9y1s,bWdj2GDclj5ofokWjzoa5jAwMkxCykd6,1,0,0,0,0,0,1,0,1,0.14285714285714285,1,0.0,0,0,0,0,0,0,0,1,0,0,1,1
17737,165115,o0yBW91wJfDjK5Q4nsWKulavXcIg9y1s,A3fsA9Zfv1X2fVEQhTw51lKENdNrEqT3,1,0,0,0,0,0,1,0,1,0.14285714285714285,1,0.0,0,0,0,0,0,0,0,1,0,0,1,1
17738,165124,h3uJUtBmEvmKgQr2Q8BC6FJ5GRugm894,bWdj2GDclj5ofokWjzoa5jAwMkxCykd6,3,0,0,0,0,0,3,0,3,0.42857142857142855,1,0.0,0,0,0,0,0,0,0,3,0,0,3,1
17739,165134,kaAc9OSRmTYmUacyuwJF8uvWHTHZhU6I,SpATywNh6bZuzm8s1ceuBUnMUAeoAHHw,3,2,0,0,0,0,1,0,3,0.42857142857142855,1,0.0,0,0,0,0,2,0,0,1,0,0,3,1
17740,165142,6PDeQOxrHkZQRUh0DA1ORZrJ9fgsXVig,SpATywNh6bZuzm8s1ceuBUnMUAeoAHHw,6,1,1,0,1,0,3,0,6,0.8571428571428571,1,0.0,0,1,0,1,1,0,0,3,0,2,4,1
17741,165148,pdZm7VuSx559JxocpNxvzJ1tzNwrAivH,SpATywNh6bZuzm8s1ceuBUnMUAeoAHHw,11,6,3,2,2,0,5,0,18,2.5714285714285716,1,0.0,2,3,2,2,4,0,0,5,0,9,9,1
17742,165152,KOUX6K1HiyGmH7Bu8fXQloWlM5ql067i,SpATywNh6bZuzm8s1ceuBUnMUAeoAHHw,1,0,0,0,0,0,1,0,1,0.14285714285714285,1,0.0,0,0,0,0,0,0,0,1,0,0,1,1
17743,165164,OhaXK8lO0kUyQn9GvgyzAKVV6q7Nf881,G8EPVSXsOYB5YQWZGiz1aVq5Pgr2GrQu,17,17,9,6,7,2,6,0,47,6.714285714285714,1,0.0,5,9,3,7,12,2,3,6,0,24,23,1
17744,165183,oBIU2QyRoi1Laa10XMgxHQ2fgzYMbfW0,RXDvfPUBYFlVdlueBFbLW0mhhAyGEqpt,11,7,5,0,2,0,5,0,19,2.7142857142857144,2,0.0,0,5,0,2,7,0,0,5,0,7,12,1
17745,165187,Wm4d7ifDaTgcR0GfUqwJt5OZKbYglRCq,SpATywNh6bZuzm8s1ceuBUnMUAeoAHHw,12,12,6,0,4,0,3,0,25,3.5714285714285716,2,0.0,0,6,0,4,12,0,0,3,0,10,15,1
17746,165190,gR8vpBOtEmg1p0U3mlFoyPZ2gKmD8M8k,bWdj2GDclj5ofokWjzoa5jAwMkxCykd6,1,0,0,0,0,0,1,0,1,0.14285714285714285,1,0.0,0,0,0,0,0,0,0,1,0,0,1,1
17747,165194,Qn3OccgDXQpcut9yLA9jXfau6FPbS72n,bWdj2GDclj5ofokWjzoa5jAwMkxCykd6,1,0,0,0,0,0,3,0,3,0.42857142857142855,2,0.0,0,0,0,0,0,0,0,3,0,0,3,1
17748,165204,gfT397rHr4ZgHPLGZxZdcWxic55z4KQu,A3fsA9Zfv1X2fVEQhTw51lKENdNrEqT3,5,4,1,0,0,0,3,0,8,1.1428571428571428,2,0.0,0,1,0,0,4,0,0,3,0,1,7,1
17749,165205,EP7JoIZBfkdGbLwYL5xgvZ6bevF26Inu,SpATywNh6bZuzm8s1ceuBUnMUAeoAHHw,10,7,5,0,4,1,6,1,24,3.4285714285714284,1,0.0,0,5,0,4,7,1,0,6,1,9,15,1
17750,165208,kERhRnhdT9O0KrRIFldGxnMdaroWZIzP,bWdj2GDclj5ofokWjzoa5jAwMkxCykd6,8,4,0,0,0,2,6,1,13,1.8571428571428572,1,0.0,0,0,0,0,4,2,0,6,1,0,13,1
17751,165211,xNRLLiS6E0KC8Qrwk7McgtlhyqJ4FeFj,SpATywNh6bZuzm8s1ceuBUnMUAeoAHHw,1,0,0,0,0,0,1,0,1,0.14285714285714285,1,0.0,0,0,0,0,0,0,0,1,0,0,1,1
17752,165214,PaIBEPuJYWYGsLlp86uNBuTjQqpfezDI,G8EPVSXsOYB5YQWZGiz1aVq5Pgr2GrQu,6,3,1,0,1,0,2,0,7,1.0,1,0.0,0,1,0,1,3,0,0,2,0,2,5,1
17753,165215,1ak0eRZu8M5MlKljzewZoOjF7rom18Lp,SpATywNh6bZuzm8s1ceuBUnMUAeoAHHw,14,13,5,19,3,0,2,0,42,6.0,1,0.0,6,5,16,3,7,0,3,2,0,30,12,1
17754,165216,wricgx1QoMh70qtCt5pQGc1O8zgAKC8W,SpATywNh6bZuzm8s1ceuBUnMUAeoAHHw,6,2,2,0,0,1,3,0,8,1.1428571428571428,1,0.0,0,2,0,0,2,1,0,3,0,2,6,1
17755,165225,ofD9EgkVhROhMeSiR6CvxPzrkKAVlk9e,SpATywNh6bZuzm8s1ceuBUnMUAeoAHHw,4,2,0,0,0,0,2,0,4,0.5714285714285714,1,0.0,0,0,0,0,2,0,0,2,0,0,4,1
17756,165230,frKiIgyfjqTyVCSr7oHYXE3h3ahmBYPu,SpATywNh6bZuzm8s1ceuBUnMUAeoAHHw,9,4,3,0,3,0,2,0,12,1.7142857142857142,1,0.0,0,3,0,3,4,0,0,2,0,6,6,1
17757,165231,kERhRnhdT9O0KrRIFldGxnMdaroWZIzP,A3fsA9Zfv1X2fVEQhTw51lKENdNrEqT3,6,3,1,0,1,0,2,0,7,1.0,1,0.0,0,1,0,1,3,0,0,2,0,2,5,1
17758,165232,0tHH7qf3NqLHNPGNzZQ6gb0TO9yXFipC,SpATywNh6bZuzm8s1ceuBUnMUAeoAHHw,6,2,1,0,1,0,3,0,7,1.0,1,0.0,0,1,0,1,2,0,0,3,0,2,5,1
17759,165233,dVeRIohjfohGjzEkLsaU11h0LM0FLGYK,A3fsA9Zfv1X2fVEQhTw51lKENdNrEqT3,1,0,0,0,0,0,1,0,1,0.14285714285714285,1,0.0,0,0,0,0,0,0,0,1,0,0,1,1
17760,165249,luS4LypZudLH1I2R9ITqSmx2yCBqIuBV,A3fsA9Zfv1X2fVEQhTw51lKENdNrEqT3,5,0,0,0,0,0,10,2,12,1.7142857142857142,1,0.0,0,0,0,0,0,0,0,10,2,0,12,1
17761,165251,pQwQ7lq50KHnzLX18552MmFyRyK2NBh3,SpATywNh6bZuzm8s1ceuBUnMUAeoAHHw,16,34,16,19,6,0,3,0,78,11.142857142857142,3,0.0,13,16,18,6,21,0,1,3,0,53,25,1
17762,165254,SHOQyzWMzeXzTVojp4arGhfbJLLjl3Lx,A3fsA9Zfv1X2fVEQhTw51lKENdNrEqT3,33,20,11,68,4,0,6,0,109,15.571428571428571,2,0.0,1,11,68,4,19,0,0,6,0,84,25,1
17763,165256,z9oiQyplHlMmhFVKenfY0OjMOlRO24Ty,SpATywNh6bZuzm8s1ceuBUnMUAeoAHHw,10,20,9,0,6,0,3,0,38,5.428571428571429,2,0.0,0,9,0,6,20,0,0,3,0,15,23,0
17764,165259,5pl9QZtfcLF7zmReytidQLwrDKpwL5AY,G8EPVSXsOYB5YQWZGiz1aVq5Pgr2GrQu,18,14,10,0,9,0,5,1,39,5.571428571428571,1,0.0,2,10,0,9,12,0,0,5,1,21,18,1
17765,165269,NrHk4qmJXuD0TsjkQSnghKpk9ZjGAOyU,bWdj2GDclj5ofokWjzoa5jAwMkxCykd6,17,16,12,0,9,3,7,1,48,6.857142857142857,2,0.0,0,12,0,9,16,3,0,7,1,21,27,1
17766,165274,2EVUeEjVIM9F9OWjZ4WZKUdJeVQtpas5,SpATywNh6bZuzm8s1ceuBUnMUAeoAHHw,1,0,0,0,0,0,1,0,1,0.14285714285714285,1,0.0,0,0,0,0,0,0,0,1,0,0,1,0
17767,165275,nIaUSG86MljehwfWdoHPVChPOF3VCDSs,SpATywNh6bZuzm8s1ceuBUnMUAeoAHHw,7,2,0,0,0,1,7,1,11,1.5714285714285714,3,0.0,0,0,0,0,2,1,0,7,1,0,11,1
17768,165277,2HOmNQE0nDdyZUXCoC3g1k9N8rwQhnPY,RXDvfPUBYFlVdlueBFbLW0mhhAyGEqpt,3,1,0,0,0,0,2,0,3,0.42857142857142855,1,0.0,0,0,0,0,1,0,0,2,0,0,3,1
17769,165314,k1lsxE5YiR3LJaUe06e2F2PB8Llyh0eb,SpATywNh6bZuzm8s1ceuBUnMUAeoAHHw,7,3,2,0,2,0,2,0,9,1.2857142857142858,1,0.0,0,2,0,2,3,0,0,2,0,4,5,1
17770,165315,SZwbwmX9qJUPYLRS3g1l8moP7xnTFUCL,G8EPVSXsOYB5YQWZGiz1aVq5Pgr2GrQu,7,2,0,0,0,0,7,3,12,1.7142857142857142,1,0.0,0,0,0,0,2,0,0,7,3,0,12,1
17771,165316,QjeOsFvzphzL2UBVpgKTVxr9nbyzd09u,SpATywNh6bZuzm8s1ceuBUnMUAeoAHHw,5,4,3,0,3,0,2,0,12,1.7142857142857142,1,0.0,0,3,0,3,4,0,0,2,0,6,6,1
17772,165318,H5hq1RXMZvjdgAVV42G1HlcBUWfqaAQD,SpATywNh6bZuzm8s1ceuBUnMUAeoAHHw,10,16,3,0,1,2,13,0,35,5.0,2,0.0,0,3,0,1,16,2,0,13,0,4,31,1
17773,165319,ELnpGakFfMjgNeN5VeZv7LPxT1yvRGG2,SpATywNh6bZuzm8s1ceuBUnMUAeoAHHw,16,8,4,10,3,1,8,1,35,5.0,2,0.0,3,4,10,3,5,1,0,8,1,20,15,1
17774,165320,mvS4OjvaKNqVV60dVhvpTVSSCBc97FlN,A3fsA9Zfv1X2fVEQhTw51lKENdNrEqT3,1,0,0,0,0,0,2,0,2,0.2857142857142857,1,0.0,0,0,0,0,0,0,0,2,0,0,2,1
17775,165333,Vi6OE1s5C9epsDKkpv5rYzlTigz225uK,SpATywNh6bZuzm8s1ceuBUnMUAeoAHHw,7,3,2,0,2,1,2,0,10,1.4285714285714286,1,0.0,0,2,0,2,3,1,0,2,0,4,6,1
17776,165334,FsXs9JXJ9sX8GX6pr0IRKZCa3w12SCYq,G8EPVSXsOYB5YQWZGiz1aVq5Pgr2GrQu,5,2,1,0,1,0,3,0,7,1.0,1,0.0,0,1,0,1,2,0,0,3,0,2,5,1
17777,165337,SiDEVAV0vWeEC76b25xnijgEBNeEhRJy,SpATywNh6bZuzm8s1ceuBUnMUAeoAHHw,1,0,0,0,0,0,1,0,1,0.14285714285714285,1,0.0,0,0,0,0,0,0,0,1,0,0,1,1
17778,165340,oaoj9be4jW2Hot8wYgYrzLRvB0RU4KYy,SpATywNh6bZuzm8s1ceuBUnMUAeoAHHw,14,14,6,14,1,0,7,0,42,6.0,4,0.0,4,6,14,1,10,0,0,7,0,25,17,1
17779,165342,oaoj9be4jW2Hot8wYgYrzLRvB0RU4KYy,A3fsA9Zfv1X2fVEQhTw51lKENdNrEqT3,5,8,4,0,1,0,5,0,18,2.5714285714285716,4,0.0,0,4,0,1,8,0,0,5,0,5,13,0
17780,165353,SiDEVAV0vWeEC76b25xnijgEBNeEhRJy,bWdj2GDclj5ofokWjzoa5jAwMkxCykd6,1,0,0,0,0,0,1,0,1,0.14285714285714285,1,0.0,0,0,0,0,0,0,0,1,0,0,1,1
17781,165359,SiDEVAV0vWeEC76b25xnijgEBNeEhRJy,A3fsA9Zfv1X2fVEQhTw51lKENdNrEqT3,1,0,0,0,0,0,1,0,1,0.14285714285714285,1,0.0,0,0,0,0,0,0,0,1,0,0,1,1
17782,165373,PhwD1ZKLhvgbOMQEx5zAfzeK2oPW1QkC,SpATywNh6bZuzm8s1ceuBUnMUAeoAHHw,1,0,0,0,0,0,1,0,1,0.14285714285714285,1,0.0,0,0,0,0,0,0,0,1,0,0,1,1
17783,165376,yR0NraAWygNs5cts7Fvc0zvbt2sGOVtI,SpATywNh6bZuzm8s1ceuBUnMUAeoAHHw,30,22,19,0,16,0,8,0,65,9.285714285714286,4,0.0,0,19,0,16,22,0,0,8,0,35,30,1
17784,165378,H3h5uLXB3vbpRqjJs3VxBW591kIrIfb3,SpATywNh6bZuzm8s1ceuBUnMUAeoAHHw,4,3,1,0,1,0,2,0,7,1.0,1,0.0,0,1,0,1,3,0,0,2,0,2,5,0
17785,165390,QNGWdAKV7t5cBffSfxkRIBFN3DRIwrkT,SpATywNh6bZuzm8s1ceuBUnMUAeoAHHw,5,2,1,0,1,0,2,0,6,0.8571428571428571,1,0.0,0,1,0,1,2,0,0,2,0,2,4,1
17786,165393,yfeIcWRmFLjQgBIM196kRoHXCKG0ateC,A3fsA9Zfv1X2fVEQhTw51lKENdNrEqT3,24,21,14,0,9,3,11,0,58,8.285714285714286,3,0.0,3,14,0,9,18,3,0,11,0,26,32,1
17787,165398,4BWY4WoZwowebQpACrizuzaSUpqFUPYV,A3fsA9Zfv1X2fVEQhTw51lKENdNrEqT3,1,0,0,0,0,0,2,0,2,0.2857142857142857,1,0.0,0,0,0,0,0,0,0,2,0,0,2,1
17788,165402,RDChRApYRv6Sfe9dw6iFymmd1hK0JhGY,A3fsA9Zfv1X2fVEQhTw51lKENdNrEqT3,1,0,0,0,0,0,1,0,1,0.14285714285714285,1,0.0,0,0,0,0,0,0,0,1,0,0,1,1
17789,165419,G6cW0d2bzLHgB0vreFbhNx3GSiMBKbtv,bWdj2GDclj5ofokWjzoa5jAwMkxCykd6,4,3,1,0,1,0,1,0,6,0.8571428571428571,1,0.0,0,1,0,1,3,0,0,1,0,2,4,1
17790,165422,rROYd0uArbh5iBXaNezR5YmAESEuia7u,bWdj2GDclj5ofokWjzoa5jAwMkxCykd6,2,0,0,0,0,0,2,0,2,0.2857142857142857,1,0.0,0,0,0,0,0,0,0,2,0,0,2,1
17791,165427,QDpN8D19Mr8RZumTONWpZNlCWcHCCTbH,RXDvfPUBYFlVdlueBFbLW0mhhAyGEqpt,1,0,0,0,0,0,1,0,1,0.14285714285714285,1,0.0,0,0,0,0,0,0,0,1,0,0,1,1
17792,165428,MCX6PserzHPOVcVElkM3aC5c5GhSLDKg,SpATywNh6bZuzm8s1ceuBUnMUAeoAHHw,7,6,4,0,1,0,4,0,15,2.142857142857143,1,0.0,0,4,0,1,6,0,0,4,0,5,10,1
17793,165431,DrolXxynktOsAUhkf2q3qgLe9PvqdRq3,A3fsA9Zfv1X2fVEQhTw51lKENdNrEqT3,1,0,0,0,0,0,1,0,1,0.14285714285714285,1,0.0,0,0,0,0,0,0,0,1,0,0,1,1
17794,165432,171vdjJg3ZQqEKQGGQqQb3EXy77TiE88,SpATywNh6bZuzm8s1ceuBUnMUAeoAHHw,2,0,0,0,0,0,2,0,2,0.2857142857142857,1,0.0,0,0,0,0,0,0,0,2,0,0,2,1
17795,165446,bWVYIzoXIGQmlYVnRkh7UPWZa7BftJJn,SpATywNh6bZuzm8s1ceuBUnMUAeoAHHw,2,0,0,0,0,0,2,0,2,0.2857142857142857,1,0.0,0,0,0,0,0,0,0,2,0,0,2,1
17796,165458,MQKEfJfHQjDI3xyJjnjmz4WwmQkpOvq2,bWdj2GDclj5ofokWjzoa5jAwMkxCykd6,6,4,2,0,1,0,4,0,11,1.5714285714285714,2,0.0,0,2,0,1,4,0,0,4,0,3,8,1
17797,165462,0RrAM7mPLzd3skZgaRP9NKB2Gqbiiam3,SpATywNh6bZuzm8s1ceuBUnMUAeoAHHw,3,2,0,0,0,0,2,0,4,0.5714285714285714,1,0.0,0,0,0,0,2,0,0,2,0,0,4,1
17798,165485,WXsAy1py6xNoAtmIQsPWN4rhdvzggrq1,SpATywNh6bZuzm8s1ceuBUnMUAeoAHHw,1,0,0,0,0,0,1,0,1,0.14285714285714285,1,0.0,0,0,0,0,0,0,0,1,0,0,1,1
17799,165489,WXsAy1py6xNoAtmIQsPWN4rhdvzggrq1,RXDvfPUBYFlVdlueBFbLW0mhhAyGEqpt,16,28,4,0,4,0,7,0,43,6.142857142857143,4,0.0,0,4,0,4,28,0,0,7,0,8,35,1
17800,165491,wg9kzusa79hS4fFC5hU9Laht66GWJcDA,RXDvfPUBYFlVdlueBFbLW0mhhAyGEqpt,1,0,0,0,0,0,1,0,1,0.14285714285714285,1,0.0,0,0,0,0,0,0,0,1,0,0,1,1
17801,165509,E7ohNiXaqWq4qLMuCCQXRkjiO7PGgPyS,A3fsA9Zfv1X2fVEQhTw51lKENdNrEqT3,1,0,0,0,0,0,1,0,1,0.14285714285714285,1,0.0,0,0,0,0,0,0,0,1,0,0,1,1
17802,165524,8wyKs5vTbaPjVAzqiPgYkv71kXMupepX,SpATywNh6bZuzm8s1ceuBUnMUAeoAHHw,6,3,1,0,1,2,2,0,9,1.2857142857142858,1,0.0,0,1,0,1,3,2,0,2,0,2,7,1
17803,165525,pLYG36p2jiNeVIQQxkAjPMCy7LTje21i,bWdj2GDclj5ofokWjzoa5jAwMkxCykd6,1,0,0,0,0,0,1,0,1,0.14285714285714285,1,0.0,0,0,0,0,0,0,0,1,0,0,1,1
17804,165530,2g49Uxh0o7UNSAoA6NR0GAmfGLF8JjXt,SpATywNh6bZuzm8s1ceuBUnMUAeoAHHw,11,14,0,23,1,7,3,0,48,6.857142857142857,1,0.0,8,0,20,1,6,7,3,3,0,29,19,1
17805,165531,srCZOXVyb44qlEge30QR25H9jokNeHzQ,SpATywNh6bZuzm8s1ceuBUnMUAeoAHHw,3,2,0,0,0,0,1,0,3,0.42857142857142855,1,0.0,0,0,0,0,2,0,0,1,0,0,3,0
17806,165536,1ImGMKyV7Di3tjZEdKRuDKDVzc7buyQG,SpATywNh6bZuzm8s1ceuBUnMUAeoAHHw,6,7,1,0,1,0,2,0,11,1.5714285714285714,1,0.0,0,1,0,1,7,0,0,2,0,2,9,1
17807,165539,GKKPaN5cNHTg4FgODePiiUlUMrULEfiu,SpATywNh6bZuzm8s1ceuBUnMUAeoAHHw,8,6,4,0,3,0,2,0,15,2.142857142857143,1,0.0,0,4,0,3,6,0,0,2,0,7,8,1
17808,165563,OIJqLsLQ0l4P9wwH2Os3C8W1InCTTS4l,SpATywNh6bZuzm8s1ceuBUnMUAeoAHHw,1,0,0,0,0,0,1,0,1,0.14285714285714285,1,0.0,0,0,0,0,0,0,0,1,0,0,1,1
17809,165566,Ml5BpcJCzlIYi0qFUUXB9FVaOk4IObDm,SpATywNh6bZuzm8s1ceuBUnMUAeoAHHw,5,4,0,0,0,0,2,0,6,0.8571428571428571,1,0.0,0,0,0,0,4,0,0,2,0,0,6,1
17810,165576,5fYqTmVKkWf8WeRMHDLJyPdR1zqgEtLM,SpATywNh6bZuzm8s1ceuBUnMUAeoAHHw,6,2,1,0,1,0,3,0,7,1.0,1,0.0,0,1,0,1,2,0,0,3,0,2,5,1
17811,165581,cp1vQuxrP7S8Bxj7ORUE5wjTIrRPfe4O,SpATywNh6bZuzm8s1ceuBUnMUAeoAHHw,7,8,0,0,0,0,5,1,14,2.0,1,0.0,2,0,0,0,6,0,0,5,1,2,12,1
17812,165592,JWwJ8KbdNh7FB84c1h8AD4pHgPCC9uj6,SpATywNh6bZuzm8s1ceuBUnMUAeoAHHw,8,4,3,0,3,0,1,0,11,1.5714285714285714,1,0.0,0,3,0,3,4,0,0,1,0,6,5,1
17813,165596,QqNuARzccJUP5HNszzjljOhC9t53eZLk,A3fsA9Zfv1X2fVEQhTw51lKENdNrEqT3,46,30,15,66,10,5,12,8,146,20.857142857142858,3,0.0,4,15,57,10,26,5,9,12,8,86,60,1
17814,165606,XmbLwxmQRLXz9T2ULgWW6uwVskMK6ds2,SpATywNh6bZuzm8s1ceuBUnMUAeoAHHw,17,23,0,12,0,0,1,0,36,5.142857142857143,1,0.0,4,0,12,0,19,0,0,1,0,16,20,1
17815,165612,KL4xQqmMI37CKNQsNsMM9emaoJIOAgLu,SpATywNh6bZuzm8s1ceuBUnMUAeoAHHw,8,9,2,0,1,0,3,0,15,2.142857142857143,1,0.0,0,2,0,1,9,0,0,3,0,3,12,1
17816,165617,fB4iAxEUCZ6aGoIPtPsbdJRsMMg2k42A,SpATywNh6bZuzm8s1ceuBUnMUAeoAHHw,10,8,5,2,1,0,3,0,19,2.7142857142857144,1,0.0,1,5,2,1,7,0,0,3,0,9,10,1
17817,165620,llrEAs9SMv6dYcefFrAK178vmmmglVzw,SpATywNh6bZuzm8s1ceuBUnMUAeoAHHw,9,5,3,0,2,1,6,1,18,2.5714285714285716,1,0.0,0,3,0,2,5,1,0,6,1,5,13,1
17818,165626,85DVIn1pw5TUgdo2ZtmymnwN8xrWNYCJ,G8EPVSXsOYB5YQWZGiz1aVq5Pgr2GrQu,1,0,0,0,0,0,1,0,1,0.14285714285714285,1,0.0,0,0,0,0,0,0,0,1,0,0,1,1
17819,165635,OLNUzQUHvlNsi2WFlH5eEyaieqKXrEz7,RXDvfPUBYFlVdlueBFbLW0mhhAyGEqpt,1,0,0,0,0,0,1,0,1,0.14285714285714285,1,0.0,0,0,0,0,0,0,0,1,0,0,1,1
17820,165636,OLNUzQUHvlNsi2WFlH5eEyaieqKXrEz7,A3fsA9Zfv1X2fVEQhTw51lKENdNrEqT3,1,0,0,0,0,0,1,0,1,0.14285714285714285,1,0.0,0,0,0,0,0,0,0,1,0,0,1,1
17821,165640,GOWvSpqnQlbRYn3L1ovF5Dk4awbNrqjv,bWdj2GDclj5ofokWjzoa5jAwMkxCykd6,8,6,3,0,3,0,1,0,13,1.8571428571428572,1,0.0,0,3,0,3,6,0,0,1,0,6,7,1
17822,165648,45RDvtjbfAzQUYoMqYnUCNheNvdQTBQf,SpATywNh6bZuzm8s1ceuBUnMUAeoAHHw,1,0,0,0,0,0,1,0,1,0.14285714285714285,1,0.0,0,0,0,0,0,0,0,1,0,0,1,1
17823,165678,u5R8HPCpot8dC2SKEeIgSJg3TYEfNk6j,SpATywNh6bZuzm8s1ceuBUnMUAeoAHHw,5,2,1,0,1,0,2,0,6,0.8571428571428571,1,0.0,0,1,0,1,2,0,0,2,0,2,4,1
17824,165681,zZk0zQJxr08CnTp44rAPtrScPbsUq7U7,SpATywNh6bZuzm8s1ceuBUnMUAeoAHHw,7,5,3,0,1,0,6,0,15,2.142857142857143,2,0.0,0,3,0,1,5,0,0,6,0,4,11,0
17825,165689,WVNZbdoXW7KA02SSLbuMYRv36MSZshQF,SpATywNh6bZuzm8s1ceuBUnMUAeoAHHw,5,3,2,0,2,0,2,0,9,1.2857142857142858,1,0.0,0,2,0,2,3,0,0,2,0,4,5,1
17826,165692,VKQwP2UGxFr8cW02yW69JgEmp944MwNR,SpATywNh6bZuzm8s1ceuBUnMUAeoAHHw,12,13,8,0,5,0,2,0,28,4.0,2,0.0,2,8,0,5,11,0,0,2,0,15,13,0
17827,165693,h7XFnfSxsjydwMPLvMejh0cg5xL1ZDd5,SpATywNh6bZuzm8s1ceuBUnMUAeoAHHw,5,2,1,0,1,0,2,0,6,0.8571428571428571,1,0.0,0,1,0,1,2,0,0,2,0,2,4,1
17828,165694,oNStIislotbuK2XCCskaFe8CInb3EbrY,SpATywNh6bZuzm8s1ceuBUnMUAeoAHHw,4,2,0,0,0,0,2,0,4,0.5714285714285714,1,0.0,0,0,0,0,2,0,0,2,0,0,4,1
17829,165697,0gS5Q732yxgOQo1BReYmVwLNG0PEmJtw,RXDvfPUBYFlVdlueBFbLW0mhhAyGEqpt,1,0,0,0,0,0,2,0,2,0.2857142857142857,1,0.0,0,0,0,0,0,0,0,2,0,0,2,1
17830,165703,9gwK2SMO9RzFmbR3NVs20xNig2HGOi8l,SpATywNh6bZuzm8s1ceuBUnMUAeoAHHw,16,21,7,18,4,0,3,0,53,7.571428571428571,2,0.0,11,7,14,4,10,0,4,3,0,36,17,1
17831,165705,jFvQpyb1OqXqTZx0rW1xHWEtpgyxk2Lr,A3fsA9Zfv1X2fVEQhTw51lKENdNrEqT3,1,0,0,0,0,0,1,0,1,0.14285714285714285,1,0.0,0,0,0,0,0,0,0,1,0,0,1,1
17832,165707,XOhs3C3hEbYCXLCkazKW0gKNbUWn1jg2,G8EPVSXsOYB5YQWZGiz1aVq5Pgr2GrQu,1,0,0,0,0,0,1,0,1,0.14285714285714285,1,0.0,0,0,0,0,0,0,0,1,0,0,1,1
17833,165710,ZSl6vjDvuQwmk9tpCIu9AiiDVVFMdktp,bWdj2GDclj5ofokWjzoa5jAwMkxCykd6,3,2,1,0,0,0,2,0,5,0.7142857142857143,2,0.0,0,1,0,0,2,0,0,2,0,1,4,1
17834,165713,0beqYHGnxE1kTUwjVs54066oNfD5qFpw,A3fsA9Zfv1X2fVEQhTw51lKENdNrEqT3,4,3,1,0,1,0,1,0,6,0.8571428571428571,1,0.0,0,1,0,1,3,0,0,1,0,2,4,1
17835,165723,M2gu56p2gwP0LePGc68gh6Y3xSriA9x3,A3fsA9Zfv1X2fVEQhTw51lKENdNrEqT3,2,2,0,0,0,0,0,0,2,0.2857142857142857,1,0.0,0,0,0,0,2,0,0,0,0,0,2,1
17836,165738,rHhFTy1MHghalNQn9kKgxeI72dfIAI1Z,SpATywNh6bZuzm8s1ceuBUnMUAeoAHHw,35,46,0,41,0,17,15,2,121,17.285714285714285,2,0.0,13,0,36,0,33,17,5,15,2,49,72,0
17837,165748,GrUpT0uWeNhnYmy4WRpw1EFafAAAhhi9,SpATywNh6bZuzm8s1ceuBUnMUAeoAHHw,22,39,0,31,1,10,9,0,90,12.857142857142858,2,0.0,10,0,31,1,29,10,0,9,0,42,48,0
17838,165758,BqlRpJCqwZj92xSZouRWh3sD1AZZKBEX,G8EPVSXsOYB5YQWZGiz1aVq5Pgr2GrQu,1,0,0,0,0,0,1,0,1,0.14285714285714285,1,0.0,0,0,0,0,0,0,0,1,0,0,1,1
17839,165760,zfQZFTiqHKQUgpAItjpYn7ZjkbIcP825,G8EPVSXsOYB5YQWZGiz1aVq5Pgr2GrQu,10,6,4,4,2,0,10,0,26,3.7142857142857144,2,0.0,0,4,3,2,6,0,1,10,0,9,17,1
17840,165762,6WkOKMKB5P2APoB7vbWWLXwAR3emifoG,A3fsA9Zfv1X2fVEQhTw51lKENdNrEqT3,44,38,25,68,12,0,9,0,152,21.714285714285715,4,0.0,6,25,58,12,32,0,10,9,0,101,51,1
17841,165763,ON4mKUtTdsRS7Qi2xUjPqd2ovm0Dg75e,SpATywNh6bZuzm8s1ceuBUnMUAeoAHHw,9,11,5,6,0,1,4,0,27,3.857142857142857,2,0.0,1,5,5,0,10,1,1,4,0,11,16,1
17842,165768,hbzbE3YW3TFJZGn3KQWHVTTu9qGbrE8v,A3fsA9Zfv1X2fVEQhTw51lKENdNrEqT3,2,0,0,0,0,0,2,0,2,0.2857142857142857,1,0.0,0,0,0,0,0,0,0,2,0,0,2,1
17843,165781,hyGNNqxhAyFxbHW9ng6YRyMeUCWAgj0x,A3fsA9Zfv1X2fVEQhTw51lKENdNrEqT3,3,2,0,0,0,0,1,0,3,0.42857142857142855,1,0.0,0,0,0,0,2,0,0,1,0,0,3,0
17844,165785,rh0SgumcqbNnCp7Kv0VptrPMVPtrWDm8,A3fsA9Zfv1X2fVEQhTw51lKENdNrEqT3,7,8,2,0,1,0,4,0,15,2.142857142857143,1,0.0,2,2,0,1,6,0,0,4,0,5,10,1
17845,165793,NKdzAvohqx5ZB0phtZyAtuBxXKa68OBU,SpATywNh6bZuzm8s1ceuBUnMUAeoAHHw,8,8,0,0,0,0,4,0,12,1.7142857142857142,2,0.0,0,0,0,0,8,0,0,4,0,0,12,1
17846,165799,tWEnJYIhXMJ03Foo959mubaAJUHZPTw0,RXDvfPUBYFlVdlueBFbLW0mhhAyGEqpt,1,0,0,0,0,0,2,0,2,0.2857142857142857,2,0.0,0,0,0,0,0,0,0,2,0,0,2,1
17847,165814,0vxIliccHyPsFqS3FXAcl5CXDHX5ju89,SpATywNh6bZuzm8s1ceuBUnMUAeoAHHw,1,0,0,0,0,0,1,0,1,0.14285714285714285,1,0.0,0,0,0,0,0,0,0,1,0,0,1,1
17848,165819,RgSsBQ3nqtDrfLpSobr2YuUHRErLTR4s,RXDvfPUBYFlVdlueBFbLW0mhhAyGEqpt,11,7,6,0,5,0,1,0,19,2.7142857142857144,1,0.0,0,6,0,5,7,0,0,1,0,11,8,1
17849,165820,wcSIko8HPcmbs4cOPlImi3EyazICOLlR,A3fsA9Zfv1X2fVEQhTw51lKENdNrEqT3,1,0,0,0,0,0,2,0,2,0.2857142857142857,1,0.0,0,0,0,0,0,0,0,2,0,0,2,1
17850,165828,HJsFc87NFCDg5yRkkakXIT7nSH8XGxhF,3VkHkmOtom3jM2wCu94xgzzu1d6Dn7or,5,7,1,2,3,1,2,0,16,2.2857142857142856,1,0.0,5,1,2,3,2,1,0,2,0,11,5,1
17851,165835,scXnpGCF4DjXznxAKg71nYuRNUGXBYFN,3VkHkmOtom3jM2wCu94xgzzu1d6Dn7or,8,4,2,0,1,3,7,1,18,2.5714285714285716,1,0.0,0,2,0,1,4,3,0,7,1,3,15,1
17852,165836,Ne6brb2UYCH1YzQNJgL9sEkqnfN8PyF2,3VkHkmOtom3jM2wCu94xgzzu1d6Dn7or,5,2,1,0,1,0,2,0,6,0.8571428571428571,1,0.0,0,1,0,1,2,0,0,2,0,2,4,1
17853,165842,qpS6wb9uNTGVCgcwuCy8SzUwVyxXXF3H,3VkHkmOtom3jM2wCu94xgzzu1d6Dn7or,4,0,0,0,0,0,5,5,10,1.4285714285714286,2,0.0,0,0,0,0,0,0,0,5,5,0,10,1
17854,165849,ur6otp02L4PjsOJUEuj3EyXPhlHA15vm,3VkHkmOtom3jM2wCu94xgzzu1d6Dn7or,11,9,4,0,3,0,5,1,22,3.142857142857143,1,0.0,0,4,0,3,9,0,0,5,1,7,15,1
17855,165850,4aZT7iDmzz1ZA3Xi3FdFLegy7WbquyGH,3VkHkmOtom3jM2wCu94xgzzu1d6Dn7or,9,13,5,6,6,3,3,0,36,5.142857142857143,1,0.0,6,5,5,6,7,3,1,3,0,22,14,1
17856,165851,L8GepxGnZH9aQkkBlOp07iXjAUHLfNwr,3VkHkmOtom3jM2wCu94xgzzu1d6Dn7or,32,70,13,24,28,23,21,1,180,25.714285714285715,3,0.0,52,13,20,28,18,23,4,21,1,113,67,1
17857,165854,2oHi0xAwpU9rO0gdJkKqphbQcbEZ8anJ,3VkHkmOtom3jM2wCu94xgzzu1d6Dn7or,6,8,3,5,0,1,3,0,20,2.857142857142857,1,0.0,3,3,5,0,5,1,0,3,0,11,9,1
17858,165859,ne28zQQU7Tf8QiWSefnQ5dt27DfxaD8u,3VkHkmOtom3jM2wCu94xgzzu1d6Dn7or,2,0,0,0,0,0,3,0,3,0.42857142857142855,1,0.0,0,0,0,0,0,0,0,3,0,0,3,1
17859,165863,VVeFIhEvBtfe6VEs5n9mjvOb5qzGsf3B,3VkHkmOtom3jM2wCu94xgzzu1d6Dn7or,17,10,8,0,8,0,2,0,28,4.0,1,0.0,0,8,0,8,10,0,0,2,0,16,12,1
17860,165867,LFDmoNuImvyTX1w7R8m5PoVy8NtQSHTv,3VkHkmOtom3jM2wCu94xgzzu1d6Dn7or,5,2,1,0,1,0,2,0,6,0.8571428571428571,1,0.0,0,1,0,1,2,0,0,2,0,2,4,1
17861,165868,YSosgGRdY3GsluD1ZsgtqlAxXh5hZvxN,3VkHkmOtom3jM2wCu94xgzzu1d6Dn7or,5,2,1,0,1,0,3,0,7,1.0,1,0.0,0,1,0,1,2,0,0,3,0,2,5,1
17862,165869,H33pWhAKBmNqSFMSH8ndKQLrzOJYOscK,3VkHkmOtom3jM2wCu94xgzzu1d6Dn7or,11,17,8,12,7,0,5,0,49,7.0,1,0.0,5,8,9,7,12,0,3,5,0,29,20,1
17863,165872,vUcUGgyXHqLsb7h4n9fC89fi5JA9Umuj,3VkHkmOtom3jM2wCu94xgzzu1d6Dn7or,5,3,1,0,1,0,4,0,9,1.2857142857142858,2,0.0,0,1,0,1,3,0,0,4,0,2,7,1
17864,165873,gNJl55vDmpOKZnXzMeerC7XmAKIxq3n7,3VkHkmOtom3jM2wCu94xgzzu1d6Dn7or,5,2,0,0,0,0,3,0,5,0.7142857142857143,1,0.0,0,0,0,0,2,0,0,3,0,0,5,1
17865,165876,81TO5Y7JfDnyj2pNSZt7lBWBv0V271Pw,3VkHkmOtom3jM2wCu94xgzzu1d6Dn7or,5,2,1,0,1,0,2,0,6,0.8571428571428571,1,0.0,0,1,0,1,2,0,0,2,0,2,4,1
17866,165879,V2ci9KgtZ1q49NCXtKq8kCFPu0MV7kSx,3VkHkmOtom3jM2wCu94xgzzu1d6Dn7or,17,82,20,16,19,20,14,1,172,24.571428571428573,1,0.0,37,20,14,19,45,20,2,14,1,90,82,1
17867,165881,cWxwU28azibnDhRCdHe1upvu1jB34yGl,3VkHkmOtom3jM2wCu94xgzzu1d6Dn7or,5,2,0,0,1,0,4,0,7,1.0,1,0.0,0,0,0,1,2,0,0,4,0,1,6,1
17868,165885,xYfupN0QhuD5qeauSxlH6zzcZWFDwz2t,3VkHkmOtom3jM2wCu94xgzzu1d6Dn7or,4,0,0,0,0,1,8,0,9,1.2857142857142858,1,0.0,0,0,0,0,0,1,0,8,0,0,9,1
17869,165886,C94z3WWDcKWwvRiPZfri807udMluMNGM,3VkHkmOtom3jM2wCu94xgzzu1d6Dn7or,5,4,1,0,1,0,2,0,8,1.1428571428571428,1,0.0,2,1,0,1,2,0,0,2,0,4,4,1
17870,165889,lGARUusLq5vJ42G3PYCkjR61ReGU6X2A,3VkHkmOtom3jM2wCu94xgzzu1d6Dn7or,1,0,0,0,0,0,2,0,2,0.2857142857142857,1,0.0,0,0,0,0,0,0,0,2,0,0,2,1
17871,165890,QTHrclzp4UenGXgfGLVh4rdVGMe32BR2,3VkHkmOtom3jM2wCu94xgzzu1d6Dn7or,1,0,0,0,0,0,1,0,1,0.14285714285714285,1,0.0,0,0,0,0,0,0,0,1,0,0,1,1
17872,165894,nENIWKoNUkUWNfPzRSSO3B9znbsB8RDC,3VkHkmOtom3jM2wCu94xgzzu1d6Dn7or,1,0,0,0,0,0,1,0,1,0.14285714285714285,1,0.0,0,0,0,0,0,0,0,1,0,0,1,1
17873,165896,vN6thurDqmKL38ReBRWW6noXXKc2gjvG,3VkHkmOtom3jM2wCu94xgzzu1d6Dn7or,1,0,0,0,0,0,1,0,1,0.14285714285714285,1,0.0,0,0,0,0,0,0,0,1,0,0,1,1
17874,165898,akhpCIhs4QDwPZmMFVJzKLZYSTieJLuY,3VkHkmOtom3jM2wCu94xgzzu1d6Dn7or,4,4,2,0,0,0,2,0,8,1.1428571428571428,1,0.0,0,2,0,0,4,0,0,2,0,2,6,1
17875,165905,AYmIyfrL2B0FoP3BGfmuiCSDj3HmGe7k,3VkHkmOtom3jM2wCu94xgzzu1d6Dn7or,5,2,1,0,1,0,2,0,6,0.8571428571428571,1,0.0,0,1,0,1,2,0,0,2,0,2,4,1
17876,165908,W5GzZWf3RMdsUdwwScphnOauhikBFz9e,3VkHkmOtom3jM2wCu94xgzzu1d6Dn7or,5,2,1,0,1,0,3,0,7,1.0,1,0.0,0,1,0,1,2,0,0,3,0,2,5,1
17877,165910,ThCRB1MJgGWsbnx3pwElV5x318Rjjfam,3VkHkmOtom3jM2wCu94xgzzu1d6Dn7or,8,5,2,3,2,11,12,1,36,5.142857142857143,1,0.0,2,2,3,2,3,11,0,12,1,9,27,1
17878,165911,OdVV14h77xHPkWuABVGCbihUGAXK9ZCH,3VkHkmOtom3jM2wCu94xgzzu1d6Dn7or,1,0,0,0,0,0,1,0,1,0.14285714285714285,1,0.0,0,0,0,0,0,0,0,1,0,0,1,1
17879,165917,j3c6K94i9dgmcXc2NErAuVxnWFJZj8tT,3VkHkmOtom3jM2wCu94xgzzu1d6Dn7or,1,0,0,0,0,0,1,0,1,0.14285714285714285,1,0.0,0,0,0,0,0,0,0,1,0,0,1,1
17880,165921,WFMHWRweXwiWpUWxRMl8OMA5DB0GUNtv,3VkHkmOtom3jM2wCu94xgzzu1d6Dn7or,3,2,0,0,0,0,2,0,4,0.5714285714285714,1,0.0,0,0,0,0,2,0,0,2,0,0,4,1
17881,165922,qal9tEID3y1vYsBIv69vQRjnAVCAr7bG,3VkHkmOtom3jM2wCu94xgzzu1d6Dn7or,4,2,1,0,1,0,2,0,6,0.8571428571428571,2,0.0,0,1,0,1,2,0,0,2,0,2,4,1
17882,165925,rPvLSBoy5Xxf5EmxbjvWGnOcsq8vXrWM,fbPkOYLVPtPgIt0MxizjfFJov3JbHyAi,7,2,1,0,1,0,4,1,9,1.2857142857142858,1,0.0,0,1,0,1,2,0,0,4,1,2,7,1
17883,165926,904Wr172N0WscSeMXJsTOyh1uuS7vDSG,fbPkOYLVPtPgIt0MxizjfFJov3JbHyAi,18,29,1,22,3,20,26,3,104,14.857142857142858,2,0.0,10,1,15,3,19,20,7,26,3,29,75,1
17884,165927,I527mLJhEnsnDN6Y7GHh8lgX5gYIWWow,fbPkOYLVPtPgIt0MxizjfFJov3JbHyAi,5,2,1,0,1,0,2,0,6,0.8571428571428571,1,0.0,0,1,0,1,2,0,0,2,0,2,4,1
17885,165928,KxL8nW6SNMH0yE9CjF6IkKPffZ4Ij1gU,fbPkOYLVPtPgIt0MxizjfFJov3JbHyAi,1,0,0,0,0,0,1,0,1,0.14285714285714285,1,0.0,0,0,0,0,0,0,0,1,0,0,1,1
17886,165930,W3Xzt3Uf7lx9itZ3S5DNN9hHwJZa9KRt,fbPkOYLVPtPgIt0MxizjfFJov3JbHyAi,7,3,2,0,2,0,3,0,10,1.4285714285714286,1,0.0,0,2,0,2,3,0,0,3,0,4,6,1
17887,165931,gS1462mjlX01iqp5mKCqQb48nCyM3t3B,fbPkOYLVPtPgIt0MxizjfFJov3JbHyAi,2,0,0,0,0,0,4,0,4,0.5714285714285714,1,0.0,0,0,0,0,0,0,0,4,0,0,4,1
17888,165934,b7To0QTiTYgZuoVzyuSEPS7F21SjVad4,fbPkOYLVPtPgIt0MxizjfFJov3JbHyAi,1,0,0,0,0,0,1,0,1,0.14285714285714285,1,0.0,0,0,0,0,0,0,0,1,0,0,1,1
17889,165939,ZNl8B1FHwYbYTfFDFqmJVkUQSDcZskKg,fbPkOYLVPtPgIt0MxizjfFJov3JbHyAi,9,9,6,0,3,0,6,0,24,3.4285714285714284,1,0.0,0,6,0,3,9,0,0,6,0,9,15,1
17890,165942,XGHgNQW6UqpJ7yEgcu0NHkLF9rVPokqB,fbPkOYLVPtPgIt0MxizjfFJov3JbHyAi,5,2,1,0,1,0,2,0,6,0.8571428571428571,1,0.0,0,1,0,1,2,0,0,2,0,2,4,1
17891,165943,a3LnV0Oo3dtcjCRZGppIsWuGj51V5eh2,fbPkOYLVPtPgIt0MxizjfFJov3JbHyAi,1,0,0,0,0,0,1,0,1,0.14285714285714285,1,0.0,0,0,0,0,0,0,0,1,0,0,1,1
17892,165944,6sTapLZsQ6AY8DHIM1OkTraivy1QDm3b,fbPkOYLVPtPgIt0MxizjfFJov3JbHyAi,11,7,6,0,6,0,2,0,21,3.0,1,0.0,0,6,0,6,7,0,0,2,0,12,9,1
17893,165947,PUhxV7BpYunwLMY1Fopzcxx9OAbpHDbj,fbPkOYLVPtPgIt0MxizjfFJov3JbHyAi,5,2,1,0,1,0,3,0,7,1.0,1,0.0,0,1,0,1,2,0,0,3,0,2,5,1
17894,165949,8WeCoc3LtA2zjcaZdCNg8zvUfjT2Msxf,fbPkOYLVPtPgIt0MxizjfFJov3JbHyAi,1,0,0,0,0,0,1,0,1,0.14285714285714285,1,0.0,0,0,0,0,0,0,0,1,0,0,1,1
17895,165951,P1bfM85NxrtE5GDV4Jjq3FQWhmzLv4fy,fbPkOYLVPtPgIt0MxizjfFJov3JbHyAi,1,0,0,0,0,0,1,0,1,0.14285714285714285,1,0.0,0,0,0,0,0,0,0,1,0,0,1,1
17896,165954,uFdzPnm0JPIeUpj3xMTZBNmEB1ozRTVJ,fbPkOYLVPtPgIt0MxizjfFJov3JbHyAi,5,2,1,0,1,0,2,0,6,0.8571428571428571,1,0.0,0,1,0,1,2,0,0,2,0,2,4,1
17897,165955,FDszCioKrM3p5Ww8Z6KhIumuxTlgQRlZ,fbPkOYLVPtPgIt0MxizjfFJov3JbHyAi,11,17,10,0,7,4,10,1,49,7.0,1,0.0,3,10,0,7,14,4,0,10,1,20,29,1
17898,165956,S1v43tmmk9czADWjyf7UYULOIOI7xfyL,fbPkOYLVPtPgIt0MxizjfFJov3JbHyAi,8,5,3,0,2,0,12,0,22,3.142857142857143,2,0.0,0,3,0,2,5,0,0,12,0,5,17,1
17899,165957,p45WUPIH3G1AOOJwU2wuCfHKdtB0xm6o,fbPkOYLVPtPgIt0MxizjfFJov3JbHyAi,8,2,1,0,1,2,5,1,12,1.7142857142857142,1,0.0,0,1,0,1,2,2,0,5,1,2,10,1
17900,165958,8SNKPwETcHAWtjYz28VSsqsWvRN9FLFQ,fbPkOYLVPtPgIt0MxizjfFJov3JbHyAi,1,0,0,0,0,0,1,0,1,0.14285714285714285,1,0.0,0,0,0,0,0,0,0,1,0,0,1,1
17901,165961,u889jcGO7u4YLeZfY23r5rctOxqBf6PA,fbPkOYLVPtPgIt0MxizjfFJov3JbHyAi,1,0,0,0,0,0,1,0,1,0.14285714285714285,1,0.0,0,0,0,0,0,0,0,1,0,0,1,1
17902,165963,HagPPbBJUvEmCdoqrDllEDEMmLNeq2iZ,fbPkOYLVPtPgIt0MxizjfFJov3JbHyAi,9,4,3,0,2,0,5,0,14,2.0,1,0.0,0,3,0,2,4,0,0,5,0,5,9,1
17903,165964,fR1Af80YYdXTiASRMfpJrGeUuotptcVr,fbPkOYLVPtPgIt0MxizjfFJov3JbHyAi,6,4,2,0,1,0,4,0,11,1.5714285714285714,1,0.0,0,2,0,1,4,0,0,4,0,3,8,1
17904,165965,Ni1JLdqzOxkLUpUAAhMXu8rPflxVDz5x,fbPkOYLVPtPgIt0MxizjfFJov3JbHyAi,1,0,0,0,0,0,1,0,1,0.14285714285714285,1,0.0,0,0,0,0,0,0,0,1,0,0,1,1
17905,165967,wDiJr7mYUlLmlRXPgZ91Gun6O95gTskL,fbPkOYLVPtPgIt0MxizjfFJov3JbHyAi,2,0,0,0,0,0,4,0,4,0.5714285714285714,1,0.0,0,0,0,0,0,0,0,4,0,0,4,1
17906,165969,spNi8Q5WiDgxakh0uckmQbexani6DCOh,fbPkOYLVPtPgIt0MxizjfFJov3JbHyAi,2,0,0,0,0,0,2,0,2,0.2857142857142857,1,0.0,0,0,0,0,0,0,0,2,0,0,2,0
17907,165970,iwWfjFQpV0JEdS2sLknknEHjLyTBDPKw,fbPkOYLVPtPgIt0MxizjfFJov3JbHyAi,9,5,2,0,2,1,4,1,15,2.142857142857143,1,0.0,2,2,0,2,3,1,0,4,1,6,9,1
17908,165974,hCvYtvOSJvPXrRc5VlUnEsp4YsplFn8e,fbPkOYLVPtPgIt0MxizjfFJov3JbHyAi,1,0,0,0,0,0,1,0,1,0.14285714285714285,1,0.0,0,0,0,0,0,0,0,1,0,0,1,1
17909,165975,qPpO6ViDO8p9Brl7zj83O8kE30x6kZ9T,fbPkOYLVPtPgIt0MxizjfFJov3JbHyAi,6,3,0,0,0,0,4,2,9,1.2857142857142858,1,0.0,0,0,0,0,3,0,0,4,2,0,9,1
17910,165976,5y3Cd3dGN1d00I5lwTujgeZECpSTe7zr,fbPkOYLVPtPgIt0MxizjfFJov3JbHyAi,1,0,0,0,0,0,1,0,1,0.14285714285714285,1,0.0,0,0,0,0,0,0,0,1,0,0,1,1
17911,165977,37ndc95rjuQyww4myZAV2pRajSa1vaet,fbPkOYLVPtPgIt0MxizjfFJov3JbHyAi,6,5,1,0,1,0,2,0,9,1.2857142857142858,1,0.0,0,1,0,1,5,0,0,2,0,2,7,1
17912,165978,0seZo711Nu6ZHdbNw0yAvl5v1wAAFkoU,fbPkOYLVPtPgIt0MxizjfFJov3JbHyAi,7,7,1,0,1,1,2,0,12,1.7142857142857142,1,0.0,0,1,0,1,7,1,0,2,0,2,10,1
17913,165979,1uzmYtVGAWS7t6COUTYsC7mZnu6avern,fbPkOYLVPtPgIt0MxizjfFJov3JbHyAi,5,2,1,0,1,0,2,0,6,0.8571428571428571,1,0.0,0,1,0,1,2,0,0,2,0,2,4,1
17914,165982,8EUQcb1E8DABiNIX80rEHPv9Sif56saE,fbPkOYLVPtPgIt0MxizjfFJov3JbHyAi,1,0,0,0,0,0,1,0,1,0.14285714285714285,1,0.0,0,0,0,0,0,0,0,1,0,0,1,1
17915,165983,h0jqPvJTofkhvn5R8iQDcsLGVojVRAC5,fbPkOYLVPtPgIt0MxizjfFJov3JbHyAi,8,4,3,0,3,0,1,0,11,1.5714285714285714,1,0.0,0,3,0,3,4,0,0,1,0,6,5,1
17916,165986,vUR2Rb4rC27WC9JMCKdgkNsSu9OE2g4Q,fbPkOYLVPtPgIt0MxizjfFJov3JbHyAi,8,6,4,0,3,0,3,0,16,2.2857142857142856,1,0.0,0,4,0,3,6,0,0,3,0,7,9,1
17917,165987,Z9EzO8SxShTXDAFqt77CSsGSze2gBnhK,fbPkOYLVPtPgIt0MxizjfFJov3JbHyAi,5,2,0,0,1,0,2,0,5,0.7142857142857143,1,0.0,0,0,0,1,2,0,0,2,0,1,4,1
17918,165990,ALLdRiupr5XE7F2FwbjCFY7Qd3WjBiQd,fbPkOYLVPtPgIt0MxizjfFJov3JbHyAi,10,3,2,0,2,1,6,2,16,2.2857142857142856,1,0.0,0,2,0,2,3,1,0,6,2,4,12,1
17919,165991,kr4lZ3nLoz0aX6j9TExEEntiFfGYyCjd,fbPkOYLVPtPgIt0MxizjfFJov3JbHyAi,1,0,0,0,0,0,1,0,1,0.14285714285714285,1,0.0,0,0,0,0,0,0,0,1,0,0,1,1
17920,165997,EGFrdPbQlZ45sFe1ldxnO4L7OBI2JHpu,fbPkOYLVPtPgIt0MxizjfFJov3JbHyAi,1,0,0,0,0,0,1,0,1,0.14285714285714285,1,0.0,0,0,0,0,0,0,0,1,0,0,1,1
17921,165998,F9bdhIa6mSzXfjRuqNv5xPUxLFQQSQPN,fbPkOYLVPtPgIt0MxizjfFJov3JbHyAi,1,0,0,0,0,0,1,0,1,0.14285714285714285,1,0.0,0,0,0,0,0,0,0,1,0,0,1,1
17922,165999,hvRHXkr5ZlhMWU7A6w9HeJGvJ6CsaNfS,fbPkOYLVPtPgIt0MxizjfFJov3JbHyAi,5,5,2,0,2,0,2,0,11,1.5714285714285714,1,0.0,0,2,0,2,5,0,0,2,0,4,7,1
17923,166002,caJeHwBfKoz4X9ir6E77hAcZOUW1xE69,fbPkOYLVPtPgIt0MxizjfFJov3JbHyAi,11,7,4,0,2,3,9,1,26,3.7142857142857144,1,0.0,1,4,0,2,6,3,0,9,1,7,19,1
17924,166003,sUgRMzV2VHvt6HuQejcpp5Z8McRxUZjg,fbPkOYLVPtPgIt0MxizjfFJov3JbHyAi,1,0,0,0,0,0,1,0,1,0.14285714285714285,1,0.0,0,0,0,0,0,0,0,1,0,0,1,1
17925,166005,PGGGHjUA1ku4qHrXObJrJMvRvyQ4ONL0,fbPkOYLVPtPgIt0MxizjfFJov3JbHyAi,5,2,0,0,0,0,5,0,7,1.0,2,0.0,0,0,0,0,2,0,0,5,0,0,7,1
17926,166006,Nc7kINeTdCLSL76oJ5133gWG2CsY0W54,fbPkOYLVPtPgIt0MxizjfFJov3JbHyAi,2,0,0,0,0,0,3,0,3,0.42857142857142855,2,0.0,0,0,0,0,0,0,0,3,0,0,3,1
17927,166009,mXNyb3sDzfYTKd0Jgpoq0ZfQhY7qZUdq,fbPkOYLVPtPgIt0MxizjfFJov3JbHyAi,6,3,2,0,1,0,2,0,8,1.1428571428571428,1,0.0,0,2,0,1,3,0,0,2,0,3,5,1
17928,166012,e312Bg0txOy7uWpjDbFsC3TLW38EvbT4,fbPkOYLVPtPgIt0MxizjfFJov3JbHyAi,7,2,1,0,1,1,6,1,12,1.7142857142857142,1,0.0,0,1,0,1,2,1,0,6,1,2,10,1
17929,166013,FIkFMKcyvR9UWi0Myle8WGVGpGy1qcBD,fbPkOYLVPtPgIt0MxizjfFJov3JbHyAi,5,2,1,0,1,0,2,0,6,0.8571428571428571,1,0.0,0,1,0,1,2,0,0,2,0,2,4,1
17930,166014,g3902agYIRHzac78MKVZlvljLMXXNpQ7,fbPkOYLVPtPgIt0MxizjfFJov3JbHyAi,1,0,0,0,0,0,1,0,1,0.14285714285714285,1,0.0,0,0,0,0,0,0,0,1,0,0,1,1
17931,166015,FcnD0Ciq8TWyjGNFUvJIbmP6wTYBGqdt,fbPkOYLVPtPgIt0MxizjfFJov3JbHyAi,2,0,0,0,0,0,5,0,5,0.7142857142857143,1,0.0,0,0,0,0,0,0,0,5,0,0,5,1
17932,166018,uAiXtjZln558M2i3rYEEm2XkgYlhSfMT,fbPkOYLVPtPgIt0MxizjfFJov3JbHyAi,5,2,1,0,1,0,2,0,6,0.8571428571428571,1,0.0,0,1,0,1,2,0,0,2,0,2,4,1
17933,166019,OdutB2jwjn089D8EX2NAa3HnsFlikWQS,fbPkOYLVPtPgIt0MxizjfFJov3JbHyAi,6,3,2,0,2,0,1,0,8,1.1428571428571428,1,0.0,0,2,0,2,3,0,0,1,0,4,4,1
17934,166036,wCZGolOXIHC0m5ValHsltDi5uu5i6G63,fbPkOYLVPtPgIt0MxizjfFJov3JbHyAi,4,3,1,0,1,0,1,0,6,0.8571428571428571,1,0.0,0,1,0,1,3,0,0,1,0,2,4,1
17935,166037,wc8ABOXSHDqwIaE5k0JYlZP66W8tdlRo,fbPkOYLVPtPgIt0MxizjfFJov3JbHyAi,12,12,6,0,2,8,13,1,42,6.0,2,0.0,0,6,0,2,12,8,0,13,1,8,34,1
17936,166038,FFaLaJRa89FKW6pVYuJ3dXumxZUbwjZC,fbPkOYLVPtPgIt0MxizjfFJov3JbHyAi,1,0,0,0,0,0,1,0,1,0.14285714285714285,1,0.0,0,0,0,0,0,0,0,1,0,0,1,1
17937,166039,ESUjI9FMN0bUSmI9r3u304t5lebCsXMM,fbPkOYLVPtPgIt0MxizjfFJov3JbHyAi,6,2,1,0,0,1,5,1,10,1.4285714285714286,1,0.0,0,1,0,0,2,1,0,5,1,1,9,1
17938,166040,fcgIoTowNoXtysmcakqXD5rIrFDMOLMS,fbPkOYLVPtPgIt0MxizjfFJov3JbHyAi,4,2,1,0,1,0,1,0,5,0.7142857142857143,1,0.0,0,1,0,1,2,0,0,1,0,2,3,1
17939,166042,fTFCMd76UjKBUrosPwesoa2JcVylSbm0,fbPkOYLVPtPgIt0MxizjfFJov3JbHyAi,15,60,2,14,7,1,10,2,96,13.714285714285714,2,0.0,15,2,11,7,45,1,3,10,2,35,61,1
17940,166044,yImV3f0xQc91646kWaaTCoHPHfLcFyiE,fbPkOYLVPtPgIt0MxizjfFJov3JbHyAi,4,2,1,0,1,0,1,0,5,0.7142857142857143,1,0.0,0,1,0,1,2,0,0,1,0,2,3,1
17941,166045,fOR5X73Jlz0p1e9noRgVbo5kXcgdZJVO,fbPkOYLVPtPgIt0MxizjfFJov3JbHyAi,7,3,2,0,2,0,2,0,9,1.2857142857142858,1,0.0,0,2,0,2,3,0,0,2,0,4,5,1
17942,166047,vqP7fSXyXiWaT2K7Qf3eA0zXPxAvIBz4,fbPkOYLVPtPgIt0MxizjfFJov3JbHyAi,6,3,2,0,2,0,1,0,8,1.1428571428571428,1,0.0,0,2,0,2,3,0,0,1,0,4,4,1
17943,166048,aih3bUgUWJe7LHDxPrKqUKv7M1PtyZMy,fbPkOYLVPtPgIt0MxizjfFJov3JbHyAi,7,3,2,0,2,0,2,0,9,1.2857142857142858,1,0.0,0,2,0,2,3,0,0,2,0,4,5,1
17944,166049,wDXghK2BIM2TBsqSOrjDvr9Ut4FXTmRS,fbPkOYLVPtPgIt0MxizjfFJov3JbHyAi,7,3,2,0,2,0,3,0,10,1.4285714285714286,1,0.0,0,2,0,2,3,0,0,3,0,4,6,1
17945,166053,DhiB4cJ1TCjmSH3ZWP9m0OqNyBdGeS5P,fbPkOYLVPtPgIt0MxizjfFJov3JbHyAi,3,0,0,0,0,1,2,0,3,0.42857142857142855,1,0.0,0,0,0,0,0,1,0,2,0,0,3,1
17946,166057,y23uUtZASm6un1sOo8Z3FtFtr7wmEBUC,fbPkOYLVPtPgIt0MxizjfFJov3JbHyAi,8,3,1,0,1,2,5,1,13,1.8571428571428572,1,0.0,0,1,0,1,3,2,0,5,1,2,11,1
17947,166058,u3Es5hUyjf5nk8KFgVLYAoNUWyPWxnEj,fbPkOYLVPtPgIt0MxizjfFJov3JbHyAi,6,7,4,0,2,0,6,0,19,2.7142857142857144,1,0.0,0,4,0,2,7,0,0,6,0,6,13,1
17948,166059,tDLUr7SnRwxXyYOlr1OOOB7neeYu2GfR,fbPkOYLVPtPgIt0MxizjfFJov3JbHyAi,2,0,0,0,0,0,3,0,3,0.42857142857142855,1,0.0,0,0,0,0,0,0,0,3,0,0,3,1
17949,166060,NcjYJr1XLJ9a71yX9v2oEtoXLbIWWmNa,fbPkOYLVPtPgIt0MxizjfFJov3JbHyAi,7,10,1,1,2,0,4,0,18,2.5714285714285716,1,0.0,4,1,1,2,6,0,0,4,0,8,10,1
17950,166062,RQ6jHOF0XaVCtNO9cGrCBZ0SdqPrnq0p,fbPkOYLVPtPgIt0MxizjfFJov3JbHyAi,5,2,1,0,1,0,2,0,6,0.8571428571428571,1,0.0,0,1,0,1,2,0,0,2,0,2,4,1
17951,166066,0nSJm9RR2EHSZbxafc9dMAvqeh04T45l,fbPkOYLVPtPgIt0MxizjfFJov3JbHyAi,18,10,9,0,8,0,2,0,29,4.142857142857143,1,0.0,0,9,0,8,10,0,0,2,0,17,12,1
17952,166071,wdYj6Nt0ckfUFBd2Af4u2WMsP126y1D7,fbPkOYLVPtPgIt0MxizjfFJov3JbHyAi,7,2,2,0,1,0,3,0,8,1.1428571428571428,1,0.0,0,2,0,1,2,0,0,3,0,3,5,1
17953,166072,xzTUXMkATDrzXhPVq5lWKfyqNyH6U4X9,fbPkOYLVPtPgIt0MxizjfFJov3JbHyAi,1,0,0,0,0,0,1,0,1,0.14285714285714285,1,0.0,0,0,0,0,0,0,0,1,0,0,1,1
17954,166074,Xy9hY2jzdaXdVDhVwpfMWrmwNRASq6RF,fbPkOYLVPtPgIt0MxizjfFJov3JbHyAi,7,3,2,0,2,0,3,0,10,1.4285714285714286,1,0.0,0,2,0,2,3,0,0,3,0,4,6,1
17955,166075,AeNkuMZiCOxqxMy4dCnuYLHaK5F326HO,fbPkOYLVPtPgIt0MxizjfFJov3JbHyAi,1,0,0,0,0,0,1,0,1,0.14285714285714285,1,0.0,0,0,0,0,0,0,0,1,0,0,1,1
17956,166078,TJ7CV32O4GjDDzJFZO7c0xw8OlGRWvRD,fbPkOYLVPtPgIt0MxizjfFJov3JbHyAi,5,2,1,0,1,0,3,0,7,1.0,1,0.0,0,1,0,1,2,0,0,3,0,2,5,1
17957,166079,LA4t1deFlCblJM9N6fBAbaIwYjVRMO2R,fbPkOYLVPtPgIt0MxizjfFJov3JbHyAi,7,5,4,0,2,0,2,0,13,1.8571428571428572,1,0.0,0,4,0,2,5,0,0,2,0,6,7,1
17958,166081,Q7Lww1kbMQad2WXChnd9KWxucmXe04CU,fbPkOYLVPtPgIt0MxizjfFJov3JbHyAi,81,66,37,29,24,11,9,1,177,25.285714285714285,2,0.0,22,37,27,24,44,11,2,9,1,110,67,1
17959,166082,3BgG8HlWQ0SR0oNUBGA5GcFVqx1VBIse,fbPkOYLVPtPgIt0MxizjfFJov3JbHyAi,12,19,7,6,8,0,3,0,43,6.142857142857143,1,0.0,4,7,4,8,15,0,2,3,0,23,20,1
17960,166083,uRfXubMeyVWXKFxPyKQCZ45cC46rUIuh,fbPkOYLVPtPgIt0MxizjfFJov3JbHyAi,1,0,0,0,0,0,1,0,1,0.14285714285714285,1,0.0,0,0,0,0,0,0,0,1,0,0,1,1
17961,166084,niHjNQJblOPbPbrg09uvwwpljTObAHSz,fbPkOYLVPtPgIt0MxizjfFJov3JbHyAi,7,2,1,0,1,0,5,1,10,1.4285714285714286,1,0.0,0,1,0,1,2,0,0,5,1,2,8,1
17962,166085,hne1Z7uPNxHKtOSgT2rxpmt4dGtlsF3d,fbPkOYLVPtPgIt0MxizjfFJov3JbHyAi,7,6,2,0,3,0,2,0,13,1.8571428571428572,1,0.0,2,2,0,3,4,0,0,2,0,7,6,1
17963,166087,uPNpQwnvEtjDufLcIcScg8qVljQjes1y,fbPkOYLVPtPgIt0MxizjfFJov3JbHyAi,5,4,3,0,1,0,2,0,10,1.4285714285714286,2,0.0,0,3,0,1,4,0,0,2,0,4,6,1
17964,166088,uCXsL4wx2V39dXm8Sw1MQn2iWfWjGwcq,fbPkOYLVPtPgIt0MxizjfFJov3JbHyAi,7,5,2,0,1,0,3,0,11,1.5714285714285714,1,0.0,0,2,0,1,5,0,0,3,0,3,8,1
17965,166090,g5pprVZU2PNABNs3JzKVJKMKGrPFXIk3,fbPkOYLVPtPgIt0MxizjfFJov3JbHyAi,7,2,1,0,1,3,5,1,13,1.8571428571428572,1,0.0,0,1,0,1,2,3,0,5,1,2,11,1
17966,166093,t6mTw4N76Mem065myGcGY8Fhohbwba7Q,fbPkOYLVPtPgIt0MxizjfFJov3JbHyAi,1,0,0,0,0,0,1,0,1,0.14285714285714285,1,0.0,0,0,0,0,0,0,0,1,0,0,1,1
17967,166097,vuVnTFCBfdzSvUffWnstx1XETLzOHwWp,fbPkOYLVPtPgIt0MxizjfFJov3JbHyAi,1,0,0,0,0,0,1,0,1,0.14285714285714285,1,0.0,0,0,0,0,0,0,0,1,0,0,1,1
17968,166098,FGCLu23qz5rUrelYuCtqPnMTqZtXAAMw,fbPkOYLVPtPgIt0MxizjfFJov3JbHyAi,1,0,0,0,0,0,3,0,3,0.42857142857142855,3,0.0,0,0,0,0,0,0,0,3,0,0,3,1
17969,166099,MWE377O2Li2ZFTgbdfnJVTVnbBfqy4jA,fbPkOYLVPtPgIt0MxizjfFJov3JbHyAi,1,0,0,0,0,0,1,0,1,0.14285714285714285,1,0.0,0,0,0,0,0,0,0,1,0,0,1,1
17970,166101,ccJAb1xsBFlxk4bnyUyZWEcDFKaDRrrN,fbPkOYLVPtPgIt0MxizjfFJov3JbHyAi,1,0,0,0,0,0,1,0,1,0.14285714285714285,1,0.0,0,0,0,0,0,0,0,1,0,0,1,1
17971,166102,IA27Knz0RQBhba167ySTdEbnqRZ3B4AP,fbPkOYLVPtPgIt0MxizjfFJov3JbHyAi,1,0,0,0,0,0,1,0,1,0.14285714285714285,1,0.0,0,0,0,0,0,0,0,1,0,0,1,1
17972,166103,qMFAmPw34z5IViYTtA1Kkpcn2uEg1WBM,fbPkOYLVPtPgIt0MxizjfFJov3JbHyAi,13,16,11,5,8,0,3,0,43,6.142857142857143,2,0.0,2,11,4,8,14,0,1,3,0,25,18,1
17973,166104,iPrzdF2eVEdRHCiD9WvkMRf87gtIEGMk,fbPkOYLVPtPgIt0MxizjfFJov3JbHyAi,3,0,0,0,0,0,5,0,5,0.7142857142857143,1,0.0,0,0,0,0,0,0,0,5,0,0,5,1
17974,166105,bjBPkmWjYG1t3drl5gryiSwz5yQdVwAZ,fbPkOYLVPtPgIt0MxizjfFJov3JbHyAi,1,0,0,0,0,0,1,0,1,0.14285714285714285,1,0.0,0,0,0,0,0,0,0,1,0,0,1,1
17975,166106,hndVkXjnMlUx6Wx46vZ4lU1lCLK80xXY,fbPkOYLVPtPgIt0MxizjfFJov3JbHyAi,1,0,0,0,0,0,1,0,1,0.14285714285714285,1,0.0,0,0,0,0,0,0,0,1,0,0,1,1
17976,166131,3qQdqfR3bXaxIIbbDNHql7PNKozwWJ0T,fbPkOYLVPtPgIt0MxizjfFJov3JbHyAi,7,5,2,0,2,0,2,0,11,1.5714285714285714,1,0.0,0,2,0,2,5,0,0,2,0,4,7,1
17977,166132,QH6lZrx6rTkTliuU8RlNmWQ26j8fabUH,fbPkOYLVPtPgIt0MxizjfFJov3JbHyAi,5,2,1,0,1,0,2,0,6,0.8571428571428571,1,0.0,0,1,0,1,2,0,0,2,0,2,4,1
17978,166133,IzageoSKsdXfc6SUEzsqUc9gQrqXXlhN,fbPkOYLVPtPgIt0MxizjfFJov3JbHyAi,18,34,16,25,15,6,10,2,108,15.428571428571429,1,0.0,13,16,21,15,21,6,4,10,2,65,43,1
17979,166134,M9r7XEg2B3D5ZR9GVCwEti8ZRWwHOp49,fbPkOYLVPtPgIt0MxizjfFJov3JbHyAi,1,0,0,0,0,0,1,0,1,0.14285714285714285,1,0.0,0,0,0,0,0,0,0,1,0,0,1,1
17980,166135,rH5NF332Zl0fvCKU7fDfkywLMxP5O2d8,fbPkOYLVPtPgIt0MxizjfFJov3JbHyAi,31,44,20,17,16,5,9,1,112,16.0,2,0.0,21,20,14,16,23,5,3,9,1,71,41,1
17981,166138,Rdvgrardg53H2oeCgmOt8vFxIUu5nogb,fbPkOYLVPtPgIt0MxizjfFJov3JbHyAi,11,10,5,4,4,0,2,0,25,3.5714285714285716,1,0.0,2,5,3,4,8,0,1,2,0,14,11,1
17982,166139,D8yJX6fJMCIpExk8o6FLH29T9XoXppFE,fbPkOYLVPtPgIt0MxizjfFJov3JbHyAi,3,0,0,0,0,0,3,0,3,0.42857142857142855,1,0.0,0,0,0,0,0,0,0,3,0,0,3,1
17983,166140,uM0mO72xR8FGxE8Qbk3uLYE3hJhpQzfR,fbPkOYLVPtPgIt0MxizjfFJov3JbHyAi,12,8,4,8,4,0,5,0,29,4.142857142857143,1,0.0,2,4,6,4,6,0,2,5,0,16,13,1
17984,166141,5onphScHMomc2vbgBcVESDnXfbNkWfY9,fbPkOYLVPtPgIt0MxizjfFJov3JbHyAi,1,0,0,0,0,0,1,0,1,0.14285714285714285,1,0.0,0,0,0,0,0,0,0,1,0,0,1,1
17985,166142,PsafF2SVukKJJLRMVxFeBBFQRkjLQ2oJ,fbPkOYLVPtPgIt0MxizjfFJov3JbHyAi,1,0,0,0,0,0,2,0,2,0.2857142857142857,1,0.0,0,0,0,0,0,0,0,2,0,0,2,1
17986,166143,Dc0PKVAv0QU3JBz2nVIWZwdXyqJ69QN3,fbPkOYLVPtPgIt0MxizjfFJov3JbHyAi,2,0,0,0,0,0,4,0,4,0.5714285714285714,1,0.0,0,0,0,0,0,0,0,4,0,0,4,1
17987,166144,aNJE1B7Om5LHj59YkXIa7Cp0ZqypQHhy,fbPkOYLVPtPgIt0MxizjfFJov3JbHyAi,1,0,0,0,0,0,1,0,1,0.14285714285714285,1,0.0,0,0,0,0,0,0,0,1,0,0,1,1
17988,166150,jEHens5h7cgKFnZtp09sIGIhAFBD7Jkg,fbPkOYLVPtPgIt0MxizjfFJov3JbHyAi,7,7,0,0,0,0,6,0,13,1.8571428571428572,1,0.0,0,0,0,0,7,0,0,6,0,0,13,1
17989,166151,BfWyYyUZnv5SdLMFrh8TGsAFKZNgKNeG,fbPkOYLVPtPgIt0MxizjfFJov3JbHyAi,8,5,4,0,3,0,5,0,17,2.4285714285714284,1,0.0,0,4,0,3,5,0,0,5,0,7,10,1
17990,166152,FXa0AcfgcW9wGv6x58fnAsUuMIzAEhoi,fbPkOYLVPtPgIt0MxizjfFJov3JbHyAi,9,9,4,0,3,0,4,0,20,2.857142857142857,1,0.0,0,4,0,3,9,0,0,4,0,7,13,1
17991,166159,9k6LwDB3o9YdtwgjHMlgmEiFhRXLRRJ9,fbPkOYLVPtPgIt0MxizjfFJov3JbHyAi,6,2,1,0,1,0,3,0,7,1.0,1,0.0,0,1,0,1,2,0,0,3,0,2,5,1
17992,166161,30rq8lRkOZXWqMCfPyVsaAPbaaM041Av,fbPkOYLVPtPgIt0MxizjfFJov3JbHyAi,11,9,6,0,4,17,9,3,48,6.857142857142857,1,0.0,0,6,0,4,9,17,0,9,3,10,38,1
17993,166162,NJgJq3P8IUUdiKHxAPOJ9vpHV39AmbrT,fbPkOYLVPtPgIt0MxizjfFJov3JbHyAi,10,7,4,0,3,0,8,0,22,3.142857142857143,1,0.0,0,4,0,3,7,0,0,8,0,7,15,1
17994,166165,4G4kKKQKhb6jz9KfkGMaSkBm1b7Ng8Fb,fbPkOYLVPtPgIt0MxizjfFJov3JbHyAi,9,6,4,0,3,1,8,4,26,3.7142857142857144,1,0.0,0,4,0,3,6,1,0,8,4,7,19,1
17995,166166,jUkfka13Wwz7qRRzZH3uNtDuXxBE9Awx,fbPkOYLVPtPgIt0MxizjfFJov3JbHyAi,9,4,2,0,1,1,7,1,16,2.2857142857142856,1,0.0,0,2,0,1,4,1,0,7,1,3,13,1
17996,166167,APZilLYYSE3pgnSCxo2zN4jsnzixmfIm,fbPkOYLVPtPgIt0MxizjfFJov3JbHyAi,8,13,4,0,2,0,4,0,23,3.2857142857142856,2,0.0,0,4,0,2,13,0,0,4,0,6,17,1
17997,166169,XR3klDTIaDghb3t3EKC7lItRK7pmZtK2,fbPkOYLVPtPgIt0MxizjfFJov3JbHyAi,5,2,1,0,1,0,2,0,6,0.8571428571428571,1,0.0,0,1,0,1,2,0,0,2,0,2,4,1
17998,166171,hTJ6uBnBZrjcmQsSdLFl27Z53HcqXPhu,fbPkOYLVPtPgIt0MxizjfFJov3JbHyAi,5,3,2,0,0,0,2,0,7,1.0,1,0.0,0,2,0,0,3,0,0,2,0,2,5,1
17999,166172,7APFlbQcu9slKLT1djMsjN8yfRoP5SXu,fbPkOYLVPtPgIt0MxizjfFJov3JbHyAi,5,2,1,0,1,0,4,0,8,1.1428571428571428,1,0.0,0,1,0,1,2,0,0,4,0,2,6,1
18000,166173,D7q0MzB6OQnySW7fFe0PsdLrln5h0cWD,fbPkOYLVPtPgIt0MxizjfFJov3JbHyAi,2,0,0,0,0,0,4,0,4,0.5714285714285714,1,0.0,0,0,0,0,0,0,0,4,0,0,4,1
18001,166174,PcwkLBV8GqMq4LN5muiU92scrdGQ7V6h,fbPkOYLVPtPgIt0MxizjfFJov3JbHyAi,7,3,1,0,1,3,6,0,14,2.0,1,0.0,0,1,0,1,3,3,0,6,0,2,12,1
18002,166176,4qYb0mwN1QXf1hE7gaSGAEjSfScRbt40,fbPkOYLVPtPgIt0MxizjfFJov3JbHyAi,1,0,0,0,0,0,1,0,1,0.14285714285714285,1,0.0,0,0,0,0,0,0,0,1,0,0,1,1
18003,166178,pE4phvQUtMVk8HRczaNhPWPwQSM1R9mD,fbPkOYLVPtPgIt0MxizjfFJov3JbHyAi,1,0,0,0,0,0,1,0,1,0.14285714285714285,1,0.0,0,0,0,0,0,0,0,1,0,0,1,1
18004,166179,VskbKna85vnBg6NRvImzwmzgF97qcqNl,fbPkOYLVPtPgIt0MxizjfFJov3JbHyAi,1,0,0,0,0,0,1,0,1,0.14285714285714285,1,0.0,0,0,0,0,0,0,0,1,0,0,1,1
18005,166180,gx7Co0YFNqJP8BvMpO5sc6zAa3XLv4OC,fbPkOYLVPtPgIt0MxizjfFJov3JbHyAi,1,0,0,0,0,0,1,0,1,0.14285714285714285,1,0.0,0,0,0,0,0,0,0,1,0,0,1,1
18006,166181,WavpPVbOYUl8MN821vVFxD4UKy4r5Gk2,fbPkOYLVPtPgIt0MxizjfFJov3JbHyAi,9,10,6,0,4,0,5,0,25,3.5714285714285716,1,0.0,2,6,0,4,8,0,0,5,0,12,13,1
18007,166183,pYc3zOC10Ig1Wz1Rc4vkJqpNCY1sRttg,fbPkOYLVPtPgIt0MxizjfFJov3JbHyAi,1,0,0,0,0,0,1,0,1,0.14285714285714285,1,0.0,0,0,0,0,0,0,0,1,0,0,1,1
18008,166184,PCr9TFHQnY1v0mGiWpUIzzoDKl5BgvEm,fbPkOYLVPtPgIt0MxizjfFJov3JbHyAi,7,5,2,0,2,0,2,0,11,1.5714285714285714,1,0.0,0,2,0,2,5,0,0,2,0,4,7,1
18009,166185,0AOM3Xsog3TT6hti2vJTJuPdhrxxQzqx,fbPkOYLVPtPgIt0MxizjfFJov3JbHyAi,1,0,0,0,0,0,1,0,1,0.14285714285714285,1,0.0,0,0,0,0,0,0,0,1,0,0,1,1
18010,166190,m0ftathRLrGnJCnhmZSV8vDms8QzsQ7P,fbPkOYLVPtPgIt0MxizjfFJov3JbHyAi,41,30,15,41,12,0,3,0,101,14.428571428571429,2,0.0,12,15,33,12,18,0,8,3,0,72,29,1
18011,166191,LSYyQey0vUBbPFiPb4RkXPSgn5CNqwVT,fbPkOYLVPtPgIt0MxizjfFJov3JbHyAi,5,2,1,0,1,0,2,0,6,0.8571428571428571,1,0.0,0,1,0,1,2,0,0,2,0,2,4,1
18012,166192,4WOIlm8GAd1KWxkI5IGSFyO5T1vsPvxi,fbPkOYLVPtPgIt0MxizjfFJov3JbHyAi,6,5,1,0,1,0,2,0,9,1.2857142857142858,1,0.0,0,1,0,1,5,0,0,2,0,2,7,1
18013,166193,rTT3Jo5pfzKPV7jQyyGPjKpE7vCtTnIg,fbPkOYLVPtPgIt0MxizjfFJov3JbHyAi,6,3,1,0,1,0,2,0,7,1.0,1,0.0,0,1,0,1,3,0,0,2,0,2,5,1
18014,166195,zswbtSZTlApL8NcRWKlBizb4x3nFlj4t,fbPkOYLVPtPgIt0MxizjfFJov3JbHyAi,1,0,0,0,0,0,1,0,1,0.14285714285714285,1,0.0,0,0,0,0,0,0,0,1,0,0,1,1
18015,166196,ajmRO2ByCJVVIxORXq9TY2juCehadeoK,fbPkOYLVPtPgIt0MxizjfFJov3JbHyAi,1,0,0,0,0,0,1,0,1,0.14285714285714285,1,0.0,0,0,0,0,0,0,0,1,0,0,1,1
18016,166197,7cis0UjQRmYBnfx6HjOswg5edwgBgCpE,fbPkOYLVPtPgIt0MxizjfFJov3JbHyAi,1,0,0,0,0,0,1,0,1,0.14285714285714285,1,0.0,0,0,0,0,0,0,0,1,0,0,1,1
18017,166199,Z2csWIUYxogRjTAASMgDj8yUhj5wsQf6,fbPkOYLVPtPgIt0MxizjfFJov3JbHyAi,1,0,0,0,0,0,1,0,1,0.14285714285714285,1,0.0,0,0,0,0,0,0,0,1,0,0,1,1
18018,166200,oFHquhoEL97QZy2GgeAYH2i1t5qjNxiI,fbPkOYLVPtPgIt0MxizjfFJov3JbHyAi,1,0,0,0,0,0,1,0,1,0.14285714285714285,1,0.0,0,0,0,0,0,0,0,1,0,0,1,1
18019,166201,WdyV9xz939F7AYWm4x7LDb09zLG7KCGo,fbPkOYLVPtPgIt0MxizjfFJov3JbHyAi,5,0,0,0,0,1,4,0,5,0.7142857142857143,1,0.0,0,0,0,0,0,1,0,4,0,0,5,1
18020,166202,iRTkgYZLUCCMjEju8FAVkQmJQ4dxsVf6,fbPkOYLVPtPgIt0MxizjfFJov3JbHyAi,7,3,2,0,2,0,2,0,9,1.2857142857142858,1,0.0,0,2,0,2,3,0,0,2,0,4,5,1
18021,166205,wu2GU267aApPVHAuPTRg0Nigjmr9Z1gM,fbPkOYLVPtPgIt0MxizjfFJov3JbHyAi,5,2,0,0,0,0,3,0,5,0.7142857142857143,1,0.0,0,0,0,0,2,0,0,3,0,0,5,1
18022,166206,jHAeFRHIxhlq1VuAgQnHiSkHKEAGqDQQ,fbPkOYLVPtPgIt0MxizjfFJov3JbHyAi,1,0,0,0,0,0,1,0,1,0.14285714285714285,1,0.0,0,0,0,0,0,0,0,1,0,0,1,1
18023,166208,c5e9iH45YdJ4nzTDABvuqRhlji3DhWTZ,fbPkOYLVPtPgIt0MxizjfFJov3JbHyAi,1,0,0,0,0,0,1,0,1,0.14285714285714285,1,0.0,0,0,0,0,0,0,0,1,0,0,1,1
18024,166209,ZhQM1oVDGLY3PxKguad7zSF6itqVpVMw,fbPkOYLVPtPgIt0MxizjfFJov3JbHyAi,6,0,0,0,0,0,5,1,6,0.8571428571428571,1,0.0,0,0,0,0,0,0,0,5,1,0,6,1
18025,166211,535rqCxCBVvAkDc6bSBePBKNVyS23A04,fbPkOYLVPtPgIt0MxizjfFJov3JbHyAi,7,5,3,0,4,0,2,0,14,2.0,2,0.0,0,3,0,4,5,0,0,2,0,7,7,1
18026,166212,fvgTgMEEp9KwLpfVkpXX8oOhoWnoroKM,fbPkOYLVPtPgIt0MxizjfFJov3JbHyAi,4,2,1,0,0,0,2,0,5,0.7142857142857143,1,0.0,0,1,0,0,2,0,0,2,0,1,4,1
18027,166214,yDrPM411aoK4cy4pMUjRFGutYfIXnaY7,fbPkOYLVPtPgIt0MxizjfFJov3JbHyAi,9,4,3,0,3,0,2,0,12,1.7142857142857142,1,0.0,0,3,0,3,4,0,0,2,0,6,6,1
18028,166216,CYPNBoGwuLNGB9o6c5ymOZ8c1CNfYFkE,fbPkOYLVPtPgIt0MxizjfFJov3JbHyAi,5,2,1,0,1,1,4,0,9,1.2857142857142858,1,0.0,0,1,0,1,2,1,0,4,0,2,7,1
18029,166218,KFATKUNqDDFsPoUS8ZrDkYqpQpRP4f4L,fbPkOYLVPtPgIt0MxizjfFJov3JbHyAi,2,0,0,0,0,0,2,0,2,0.2857142857142857,1,0.0,0,0,0,0,0,0,0,2,0,0,2,1
18030,166219,pbVSIAGDAO8zkre7dnH0sTveAs2oHKDL,fbPkOYLVPtPgIt0MxizjfFJov3JbHyAi,5,3,2,0,0,1,2,0,8,1.1428571428571428,1,0.0,0,2,0,0,3,1,0,2,0,2,6,1
18031,166221,FCQ3GzlLjljyV0TB5O3VUpS5tYpT90fC,fbPkOYLVPtPgIt0MxizjfFJov3JbHyAi,1,0,0,0,0,0,1,0,1,0.14285714285714285,1,0.0,0,0,0,0,0,0,0,1,0,0,1,1
18032,166223,zn0OAApVYD2Uy6WJtu6WKbBPSOUAbiQP,fbPkOYLVPtPgIt0MxizjfFJov3JbHyAi,5,2,1,0,1,0,2,0,6,0.8571428571428571,1,0.0,0,1,0,1,2,0,0,2,0,2,4,1
18033,166224,VzrtRKXjnxu3j4Ng8zH1lMIMaH7VXugk,fbPkOYLVPtPgIt0MxizjfFJov3JbHyAi,11,8,5,0,3,9,9,2,36,5.142857142857143,1,0.0,0,5,0,3,8,9,0,9,2,8,28,1
18034,166226,Jc1XpiNQCchHcqFzVFHc90zIRXa0BSrx,fbPkOYLVPtPgIt0MxizjfFJov3JbHyAi,1,0,0,0,0,0,1,0,1,0.14285714285714285,1,0.0,0,0,0,0,0,0,0,1,0,0,1,1
18035,166228,lwLS4JZCmr2Z32OMnVpRrqT2jg66CVWM,fbPkOYLVPtPgIt0MxizjfFJov3JbHyAi,4,2,1,0,0,0,2,0,5,0.7142857142857143,1,0.0,0,1,0,0,2,0,0,2,0,1,4,1
18036,166234,cobl7A5HnM7LyfJMOxE7IO6H5ynMSZHE,fbPkOYLVPtPgIt0MxizjfFJov3JbHyAi,20,21,11,0,9,1,14,1,57,8.142857142857142,2,0.0,6,11,0,9,15,1,0,14,1,26,31,1
18037,166235,bZyPcrH7OrkATlDjIsQifL6bmPAhovyA,fbPkOYLVPtPgIt0MxizjfFJov3JbHyAi,1,0,0,0,0,0,1,0,1,0.14285714285714285,1,0.0,0,0,0,0,0,0,0,1,0,0,1,1
18038,166236,jZTOrC76oKbilWqOTQaLbKbRc8Z13tjL,fbPkOYLVPtPgIt0MxizjfFJov3JbHyAi,2,0,0,0,0,0,4,0,4,0.5714285714285714,1,0.0,0,0,0,0,0,0,0,4,0,0,4,1
18039,166238,K2ZkeKtW7K8uncjR7BZKciYiqiq9yWln,fbPkOYLVPtPgIt0MxizjfFJov3JbHyAi,1,0,0,0,0,0,1,0,1,0.14285714285714285,1,0.0,0,0,0,0,0,0,0,1,0,0,1,1
18040,166240,lGwFkUBS8Ax5ZfSjmM23Vm33yIAwYDi5,fbPkOYLVPtPgIt0MxizjfFJov3JbHyAi,3,0,0,0,0,0,4,0,4,0.5714285714285714,1,0.0,0,0,0,0,0,0,0,4,0,0,4,1
18041,166243,UO4mrSrrMyolBODgCqJnfueJEWhli7II,fbPkOYLVPtPgIt0MxizjfFJov3JbHyAi,1,0,0,0,0,0,2,0,2,0.2857142857142857,1,0.0,0,0,0,0,0,0,0,2,0,0,2,1
18042,166245,2jYgAHtB8HMROduTNzSC8WwjfYYRrdrW,fbPkOYLVPtPgIt0MxizjfFJov3JbHyAi,7,7,2,0,0,1,6,1,17,2.4285714285714284,1,0.0,0,2,0,0,7,1,0,6,1,2,15,1
18043,166246,DjTBWAUbIg70BCHJh9sAtqxHus5ltwy7,fbPkOYLVPtPgIt0MxizjfFJov3JbHyAi,7,2,1,0,1,1,5,0,10,1.4285714285714286,1,0.0,0,1,0,1,2,1,0,5,0,2,8,1
18044,166247,A0zXPJodVr0E8hKOlKGfpSvxe7QILd2e,fbPkOYLVPtPgIt0MxizjfFJov3JbHyAi,8,9,5,0,3,0,6,0,23,3.2857142857142856,1,0.0,0,5,0,3,9,0,0,6,0,8,15,1
18045,166248,RMepYbdXgEw3uPAlKurEbNiPXr5gNPWt,fbPkOYLVPtPgIt0MxizjfFJov3JbHyAi,10,10,4,0,5,0,2,0,21,3.0,1,0.0,2,4,0,5,8,0,0,2,0,11,10,1
18046,166249,4IRetwwONx8QH1sGkNwhu5Kz3lKUue7Z,fbPkOYLVPtPgIt0MxizjfFJov3JbHyAi,13,11,7,0,4,13,6,0,41,5.857142857142857,1,0.0,0,7,0,4,11,13,0,6,0,11,30,1
18047,166250,KlA2x8wP6TBpECd0ZN1eFvozBu7s4Isi,fbPkOYLVPtPgIt0MxizjfFJov3JbHyAi,7,3,2,0,2,0,2,0,9,1.2857142857142858,1,0.0,0,2,0,2,3,0,0,2,0,4,5,1
18048,166252,CA0MkNgNmIkfEXL0dnDRrevPXK8YBuup,fbPkOYLVPtPgIt0MxizjfFJov3JbHyAi,18,35,22,9,12,0,7,0,85,12.142857142857142,1,0.0,10,22,8,12,25,0,1,7,0,52,33,1
18049,166253,7IMXfuLxE8gGKFgkWFaN1RvRbpf1UO2y,fbPkOYLVPtPgIt0MxizjfFJov3JbHyAi,2,0,0,0,0,0,2,0,2,0.2857142857142857,1,0.0,0,0,0,0,0,0,0,2,0,0,2,1
18050,166255,kowHY6WB64zBwKrTN3ILoCz5UNyxhnFJ,fbPkOYLVPtPgIt0MxizjfFJov3JbHyAi,8,3,2,0,2,0,4,0,11,1.5714285714285714,1,0.0,0,2,0,2,3,0,0,4,0,4,7,1
18051,166257,wqiVx47rXEFqYvMIBdEO3TZz5x4INOeH,fbPkOYLVPtPgIt0MxizjfFJov3JbHyAi,1,0,0,0,0,0,2,0,2,0.2857142857142857,1,0.0,0,0,0,0,0,0,0,2,0,0,2,1
18052,166258,UOnQZubkkaxGovWrfoxkBtdZ1OIJQqVB,fbPkOYLVPtPgIt0MxizjfFJov3JbHyAi,10,6,3,0,2,1,5,1,18,2.5714285714285716,1,0.0,1,3,0,2,5,1,0,5,1,6,12,1
18053,166259,MnSTippsWfG9Oaeik7VL8PjJAAryn478,fbPkOYLVPtPgIt0MxizjfFJov3JbHyAi,1,0,0,0,0,0,1,0,1,0.14285714285714285,1,0.0,0,0,0,0,0,0,0,1,0,0,1,1
18054,166260,lgavhxj31ME1Vj5ukLJHRWTlXwDGQoVr,fbPkOYLVPtPgIt0MxizjfFJov3JbHyAi,5,3,1,0,1,0,5,0,10,1.4285714285714286,1,0.0,0,1,0,1,3,0,0,5,0,2,8,1
18055,166261,dVdgfUMBulFX4jVAvRAGPzBu21Uo5ky5,fbPkOYLVPtPgIt0MxizjfFJov3JbHyAi,2,0,0,0,0,0,2,0,2,0.2857142857142857,1,0.0,0,0,0,0,0,0,0,2,0,0,2,1
18056,166262,yKKt8zt4iB4hr1OVUIw42HenRNY3LaDc,fbPkOYLVPtPgIt0MxizjfFJov3JbHyAi,1,0,0,0,0,0,1,0,1,0.14285714285714285,1,0.0,0,0,0,0,0,0,0,1,0,0,1,1
18057,166263,9wJidXC6DsBSt4XJeGmG8tllGZ0Bh2yE,fbPkOYLVPtPgIt0MxizjfFJov3JbHyAi,5,0,0,0,0,1,5,1,7,1.0,1,0.0,0,0,0,0,0,1,0,5,1,0,7,1
18058,166264,h7D7NcJeqnvOSuVnZSj39Mgs0UPnBWOp,fbPkOYLVPtPgIt0MxizjfFJov3JbHyAi,11,19,9,0,6,3,9,1,47,6.714285714285714,1,0.0,2,9,0,6,17,3,0,9,1,17,30,1
18059,166267,2mlxTydWoLZJ5NQWesHHKUelrVUBGoHh,fbPkOYLVPtPgIt0MxizjfFJov3JbHyAi,6,4,2,0,2,0,2,0,10,1.4285714285714286,1,0.0,0,2,0,2,4,0,0,2,0,4,6,1
18060,166282,EUmZ5qzjwgko2PIWEnctkvYh7APnUrX9,SpATywNh6bZuzm8s1ceuBUnMUAeoAHHw,2,0,0,0,0,0,3,0,3,0.42857142857142855,1,0.0,0,0,0,0,0,0,0,3,0,0,3,1
18061,166294,kayFAsNlLJHsRlX0XZpPHYGvL0bJckz3,5X6FeZozNMgE2VRi3MJYjkkFK8SETtu2,3,0,0,0,0,0,3,0,3,0.42857142857142855,1,0.0,0,0,0,0,0,0,0,3,0,0,3,1
18062,166296,0OgHQAVhQz83ex7oEMaYHMGoui5vuRU7,5X6FeZozNMgE2VRi3MJYjkkFK8SETtu2,6,4,1,0,1,0,7,0,13,1.8571428571428572,2,0.0,2,1,0,1,2,0,0,7,0,4,9,1
18063,166304,cr6Tgf9hnYbWIgXq8hI7G8mwIYtkpuPn,SpATywNh6bZuzm8s1ceuBUnMUAeoAHHw,9,13,9,0,0,0,14,0,36,5.142857142857143,5,0.0,0,9,0,0,13,0,0,14,0,9,27,1
18064,166307,C1W6BmVEm6dSkmMKEomLuJgZ8sQ5WGlZ,SpATywNh6bZuzm8s1ceuBUnMUAeoAHHw,10,16,5,0,3,0,2,0,26,3.7142857142857144,2,0.0,4,5,0,3,12,0,0,2,0,12,14,1
18065,166323,9xFxSbbQUc3N03I1VXFxrUyAcv76iE10,5X6FeZozNMgE2VRi3MJYjkkFK8SETtu2,6,4,2,0,1,0,4,0,11,1.5714285714285714,2,0.0,0,2,0,1,4,0,0,4,0,3,8,1
18066,166334,O9GgLjRVV0VZ4XM2UvjBFBWJXBSS6aK0,SpATywNh6bZuzm8s1ceuBUnMUAeoAHHw,19,25,15,15,10,5,10,0,80,11.428571428571429,3,0.0,4,15,13,10,21,5,2,10,0,42,38,1
18067,166336,dy0MHAcBl717YgRGnv4iZjdkJ8Cv0Ubw,SpATywNh6bZuzm8s1ceuBUnMUAeoAHHw,5,2,1,0,1,0,2,0,6,0.8571428571428571,1,0.0,0,1,0,1,2,0,0,2,0,2,4,1
18068,166338,VGpsDdnTGsfrp3adgxkdRhxpkaNF7Bg2,SpATywNh6bZuzm8s1ceuBUnMUAeoAHHw,15,14,7,0,6,0,5,0,32,4.571428571428571,2,0.0,0,7,0,6,14,0,0,5,0,13,19,1
18069,166345,eBrNdoyiSxVd9fyLx3AqJC03wGlgXEr8,SpATywNh6bZuzm8s1ceuBUnMUAeoAHHw,2,0,0,0,0,0,2,0,2,0.2857142857142857,1,0.0,0,0,0,0,0,0,0,2,0,0,2,1
18070,166348,LdN96v488mT9MyrF8Dltq2COgz4qXNUV,SpATywNh6bZuzm8s1ceuBUnMUAeoAHHw,2,0,0,0,0,0,3,0,3,0.42857142857142855,1,0.0,0,0,0,0,0,0,0,3,0,0,3,1
18071,166382,aMWucSAl7KcOtmgcqhgckjtfv6QnsKKi,G8EPVSXsOYB5YQWZGiz1aVq5Pgr2GrQu,8,8,1,0,1,0,4,0,14,2.0,1,0.0,1,1,0,1,7,0,0,4,0,3,11,1
18072,166387,WO9GKA0lZwTMWZPNOUikUeUkOH5TeVRT,A3fsA9Zfv1X2fVEQhTw51lKENdNrEqT3,19,10,9,0,9,0,3,0,31,4.428571428571429,1,0.0,0,9,0,9,10,0,0,3,0,18,13,1
18073,166392,FR3djrgj8pkYcAIqYiRiT862Pvu77Ath,A3fsA9Zfv1X2fVEQhTw51lKENdNrEqT3,1,0,0,0,0,0,1,0,1,0.14285714285714285,1,0.0,0,0,0,0,0,0,0,1,0,0,1,1
18074,166398,KSpo19A6th76vdA61eFiN0BiY6Yi086y,bWdj2GDclj5ofokWjzoa5jAwMkxCykd6,6,2,1,0,1,0,4,0,8,1.1428571428571428,1,0.0,0,1,0,1,2,0,0,4,0,2,6,1
18075,166400,aJMNcTer76nTaYZZR58xtdmLr8BYq1Op,G8EPVSXsOYB5YQWZGiz1aVq5Pgr2GrQu,13,17,7,8,4,0,6,1,43,6.142857142857143,2,0.0,3,7,5,4,14,0,3,6,1,19,24,0
18076,166409,iIkBXne7Ob9Fgz6Oa5wXMKZwMdTiJR2o,SpATywNh6bZuzm8s1ceuBUnMUAeoAHHw,9,7,6,0,6,2,5,1,27,3.857142857142857,2,0.0,0,6,0,6,7,2,0,5,1,12,15,1
18077,166414,NkHKP7XmU89AhYrwGvkJ0gX5lfpDGkiJ,G8EPVSXsOYB5YQWZGiz1aVq5Pgr2GrQu,6,1,1,0,1,0,3,0,6,0.8571428571428571,1,0.0,0,1,0,1,1,0,0,3,0,2,4,1
18078,166445,yOLWJeEIp9ncdhH4y673tuFZt1rt1tLc,G8EPVSXsOYB5YQWZGiz1aVq5Pgr2GrQu,25,46,0,32,1,0,4,0,83,11.857142857142858,1,0.0,26,0,16,1,20,0,16,4,0,43,40,1
18079,166469,EpdHS9GR8oqIUKzHvPkVQRgoyyohb0m0,SpATywNh6bZuzm8s1ceuBUnMUAeoAHHw,3,2,1,0,0,0,1,0,4,0.5714285714285714,1,0.0,0,1,0,0,2,0,0,1,0,1,3,1
18080,166473,qMHt2pvEDzVNHM7ZHWzleDlEr3OuwQXq,SpATywNh6bZuzm8s1ceuBUnMUAeoAHHw,17,14,11,2,4,7,7,1,46,6.571428571428571,1,0.0,2,11,2,4,12,7,0,7,1,19,27,1
18081,166482,L7V90oxKH6hMT4ofGnoics5L5B12YDEc,5X6FeZozNMgE2VRi3MJYjkkFK8SETtu2,7,3,2,0,2,0,2,0,9,1.2857142857142858,1,0.0,0,2,0,2,3,0,0,2,0,4,5,1
18082,166486,oGxuj25E6wfFXJnzkTIOBzgSMs7mphqX,SpATywNh6bZuzm8s1ceuBUnMUAeoAHHw,4,7,3,0,0,0,1,0,11,1.5714285714285714,1,0.0,3,3,0,0,4,0,0,1,0,6,5,1
18083,166495,YbJnM4aRUVyy4lj5U7KoiyOh79gNSdfq,A3fsA9Zfv1X2fVEQhTw51lKENdNrEqT3,9,5,4,0,4,0,2,0,15,2.142857142857143,2,0.0,0,4,0,4,5,0,0,2,0,8,7,1
18084,166507,lJQiDaJvMiupKv6v8L85WToj3Rei5ozq,SpATywNh6bZuzm8s1ceuBUnMUAeoAHHw,10,5,4,0,3,1,3,0,16,2.2857142857142856,1,0.0,0,4,0,3,5,1,0,3,0,7,9,1
18085,166508,8yNx2UHmvaqcPAlV7kUX1ya1n3dGGkKQ,SpATywNh6bZuzm8s1ceuBUnMUAeoAHHw,1,0,0,0,0,0,1,0,1,0.14285714285714285,1,0.0,0,0,0,0,0,0,0,1,0,0,1,1
18086,166523,QjfVyTofFZLLFWX1ehKLt5ilQSOSAPiY,G8EPVSXsOYB5YQWZGiz1aVq5Pgr2GrQu,24,19,12,22,9,0,4,1,67,9.571428571428571,1,0.0,0,12,19,9,19,0,3,4,1,40,27,1
18087,166543,5UIbCqH63Z5JY1aEquv4Lx7GZPK1n1Oz,RXDvfPUBYFlVdlueBFbLW0mhhAyGEqpt,1,0,0,0,0,0,1,0,1,0.14285714285714285,1,0.0,0,0,0,0,0,0,0,1,0,0,1,1
18088,166582,L3RDijFpI0BxbfI282CDkn8oc75EdrdD,SpATywNh6bZuzm8s1ceuBUnMUAeoAHHw,1,0,0,0,0,0,1,0,1,0.14285714285714285,1,0.0,0,0,0,0,0,0,0,1,0,0,1,1
18089,166584,EUmZ5qzjwgko2PIWEnctkvYh7APnUrX9,A3fsA9Zfv1X2fVEQhTw51lKENdNrEqT3,12,15,0,0,0,0,3,0,18,2.5714285714285716,1,0.0,0,0,0,0,15,0,0,3,0,0,18,1
18090,166631,XXGnjStFLZ9sx615YBVWt5w8zGA5PvJ7,SpATywNh6bZuzm8s1ceuBUnMUAeoAHHw,9,17,0,0,0,0,4,0,21,3.0,1,0.0,0,0,0,0,17,0,0,4,0,0,21,1
18091,166681,EQyfXomfeQ2aGwvJID8K9GdghyNxd6oh,bWdj2GDclj5ofokWjzoa5jAwMkxCykd6,14,27,12,60,6,1,6,0,112,16.0,2,0.0,6,12,59,6,21,1,1,6,0,83,29,1
18092,166691,Plovj3UdbSJXyESPLaHVaVRAVAVFjh4G,bWdj2GDclj5ofokWjzoa5jAwMkxCykd6,1,0,0,0,0,0,1,0,1,0.14285714285714285,1,0.0,0,0,0,0,0,0,0,1,0,0,1,1
18093,166751,ywzPrbVlDcrG4QIQVcquX0yb7l2KxUz1,SpATywNh6bZuzm8s1ceuBUnMUAeoAHHw,1,0,0,0,0,0,1,0,1,0.14285714285714285,1,0.0,0,0,0,0,0,0,0,1,0,0,1,1
18094,166755,e8Y4G90611rG6C14GJNj4shj65JVFISl,A3fsA9Zfv1X2fVEQhTw51lKENdNrEqT3,60,19,9,140,0,0,3,0,171,24.428571428571427,2,0.0,3,9,136,0,16,0,4,3,0,148,23,1
18095,166763,PtZQYu2omSISCEPobEkK00G9lPsFCpAH,SpATywNh6bZuzm8s1ceuBUnMUAeoAHHw,1,0,0,0,0,0,1,0,1,0.14285714285714285,1,0.0,0,0,0,0,0,0,0,1,0,0,1,1
18096,166767,CNzOzTxB6slz6reBTGQew76XrENqSZZu,A3fsA9Zfv1X2fVEQhTw51lKENdNrEqT3,6,6,0,0,0,0,5,0,11,1.5714285714285714,1,0.0,0,0,0,0,6,0,0,5,0,0,11,1
18097,166769,F5WXvUA8z1Vfdvlva1pujweut7tGE04r,bWdj2GDclj5ofokWjzoa5jAwMkxCykd6,5,0,0,0,0,2,4,1,7,1.0,1,0.0,0,0,0,0,0,2,0,4,1,0,7,1
18098,166778,AtDlkFSnWTgMt7xJ3PkbVdpoMvsEJuZd,SpATywNh6bZuzm8s1ceuBUnMUAeoAHHw,9,6,2,0,2,0,3,0,13,1.8571428571428572,2,0.0,0,2,0,2,6,0,0,3,0,4,9,1
18099,166787,35YnYP4Tkn7xvOTt0M51AeVR3m7l2sIt,SpATywNh6bZuzm8s1ceuBUnMUAeoAHHw,21,18,7,10,7,1,7,1,51,7.285714285714286,2,0.0,4,7,9,7,14,1,1,7,1,27,24,1
18100,166850,TeBMvAv5VyOBol7RYdEZZqCEFBEIGxYI,SpATywNh6bZuzm8s1ceuBUnMUAeoAHHw,8,4,3,0,3,0,1,0,11,1.5714285714285714,1,0.0,0,3,0,3,4,0,0,1,0,6,5,1
18101,166855,7EXxZBxaHj6q1B0SK4ceBEflKEmD8hvL,bWdj2GDclj5ofokWjzoa5jAwMkxCykd6,3,0,0,0,0,0,8,0,8,1.1428571428571428,2,0.0,0,0,0,0,0,0,0,8,0,0,8,1
18102,166860,oJHnnpnFBdflow5PBV5uje04XEG79lqu,A3fsA9Zfv1X2fVEQhTw51lKENdNrEqT3,12,8,0,0,0,1,17,1,27,3.857142857142857,4,0.0,0,0,0,0,8,1,0,17,1,0,27,0
18103,166873,PDNsiMyTk72mYrcSTgVVhe2c68BJ17Ar,bWdj2GDclj5ofokWjzoa5jAwMkxCykd6,29,24,17,0,14,1,17,2,75,10.714285714285714,2,0.0,2,17,0,14,22,1,0,17,2,33,42,1
18104,166924,S2Kd9VGJ7wj54OKeEh5Yf8NI7V1Tw4JO,5X6FeZozNMgE2VRi3MJYjkkFK8SETtu2,5,2,1,0,1,0,2,0,6,0.8571428571428571,1,0.0,0,1,0,1,2,0,0,2,0,2,4,1
18105,166928,my33FPQMSZttKqR0p8zRP2Bz5eCFTYNb,bWdj2GDclj5ofokWjzoa5jAwMkxCykd6,16,21,4,6,4,1,15,0,51,7.285714285714286,3,0.0,3,4,6,4,18,1,0,15,0,17,34,1
18106,166942,4kvP66ucXESl9aXSUioaBWcuWa5i6uFa,SpATywNh6bZuzm8s1ceuBUnMUAeoAHHw,1,0,0,0,0,0,1,0,1,0.14285714285714285,1,0.0,0,0,0,0,0,0,0,1,0,0,1,1
18107,166970,LkEFlCqQYkjvIKgJmv3NaW67JKbg7cls,5X6FeZozNMgE2VRi3MJYjkkFK8SETtu2,1,0,0,0,0,0,2,0,2,0.2857142857142857,1,0.0,0,0,0,0,0,0,0,2,0,0,2,1
18108,166981,KoUza1X6kek4yLxwsTzshNuuseZEHFu6,bWdj2GDclj5ofokWjzoa5jAwMkxCykd6,1,0,0,0,0,0,1,0,1,0.14285714285714285,1,0.0,0,0,0,0,0,0,0,1,0,0,1,1
18109,166987,49oypRKmbhsESvRt5ynYhyueQezYQsCQ,A3fsA9Zfv1X2fVEQhTw51lKENdNrEqT3,1,0,0,0,0,0,1,0,1,0.14285714285714285,1,0.0,0,0,0,0,0,0,0,1,0,0,1,1
18110,166991,H1TM0tfwQGan808kaqC5vLvGV8fCUgtO,SpATywNh6bZuzm8s1ceuBUnMUAeoAHHw,13,8,6,0,3,3,7,1,28,4.0,1,0.0,0,6,0,3,8,3,0,7,1,9,19,1
18111,167005,NLhSHOlvNcAzXTnIuTXBlyWdelKO6Po8,SpATywNh6bZuzm8s1ceuBUnMUAeoAHHw,1,0,0,0,0,0,1,0,1,0.14285714285714285,1,0.0,0,0,0,0,0,0,0,1,0,0,1,1
18112,167006,Sn4V2T6RAiQ47UvRCtMkFCdxnmF36LZI,G8EPVSXsOYB5YQWZGiz1aVq5Pgr2GrQu,4,4,2,0,2,0,1,0,9,1.2857142857142858,1,0.0,1,2,0,2,3,0,0,1,0,5,4,0
18113,167012,6x1ORFJhWxzWx07uL4IvCItSXSuL8CVc,G8EPVSXsOYB5YQWZGiz1aVq5Pgr2GrQu,6,3,1,0,1,0,2,0,7,1.0,1,0.0,0,1,0,1,3,0,0,2,0,2,5,1
18114,167024,lSXJXGWdv2XbDDcmfVzMwBcHxgsJFtm2,SpATywNh6bZuzm8s1ceuBUnMUAeoAHHw,1,0,0,0,0,0,1,0,1,0.14285714285714285,1,0.0,0,0,0,0,0,0,0,1,0,0,1,1
18115,167032,xMKGcYeHMuhMu436Dx8qNr2iLxqOhlEy,SpATywNh6bZuzm8s1ceuBUnMUAeoAHHw,10,6,4,2,3,0,1,0,16,2.2857142857142856,1,0.0,1,4,2,3,5,0,0,1,0,10,6,1
18116,167038,C3LGGw6vM3GlX5Dw8258DOqpO1L1iYv7,A3fsA9Zfv1X2fVEQhTw51lKENdNrEqT3,15,17,8,0,3,1,10,2,41,5.857142857142857,1,0.0,0,8,0,3,17,1,0,10,2,11,30,0
18117,167045,CNckAsfMKSEbkBf2UCjHJpPoGTdJKeyS,SpATywNh6bZuzm8s1ceuBUnMUAeoAHHw,1,0,0,0,0,0,1,0,1,0.14285714285714285,1,0.0,0,0,0,0,0,0,0,1,0,0,1,1
18118,167055,tcOuPvspwR8RIsYVlB8hdFhNn4mHp1dB,A3fsA9Zfv1X2fVEQhTw51lKENdNrEqT3,6,5,2,0,1,0,2,0,10,1.4285714285714286,1,0.0,0,2,0,1,5,0,0,2,0,3,7,1
18119,167070,hfflCpa9jLkmfdXytJuPOg7rRc5Xg9VZ,G8EPVSXsOYB5YQWZGiz1aVq5Pgr2GrQu,1,0,0,0,0,0,1,0,1,0.14285714285714285,1,0.0,0,0,0,0,0,0,0,1,0,0,1,1
18120,167084,OtGMx6eKyVYjbz3L87VVmC99kyg1WjEl,SpATywNh6bZuzm8s1ceuBUnMUAeoAHHw,31,61,24,46,8,28,18,4,189,27.0,5,0.0,20,24,36,8,41,28,10,18,4,88,101,0
18121,167105,pGwYJRrX7MfzhhSwNLSQAMurehSIgkJ9,5X6FeZozNMgE2VRi3MJYjkkFK8SETtu2,4,2,1,0,1,0,1,0,5,0.7142857142857143,1,0.0,0,1,0,1,2,0,0,1,0,2,3,1
18122,167109,riXqOkhR5seretWfUGQsZViiD6naR0Fb,G8EPVSXsOYB5YQWZGiz1aVq5Pgr2GrQu,14,17,9,0,3,5,4,0,38,5.428571428571429,2,0.0,0,9,0,3,17,5,0,4,0,12,26,1
18123,167110,EcPuYKhDy2VQKZUDtISpnuVnvHl1yyoH,A3fsA9Zfv1X2fVEQhTw51lKENdNrEqT3,11,8,2,0,2,0,6,0,18,2.5714285714285716,2,0.0,0,2,0,2,8,0,0,6,0,4,14,1
18124,167126,b4AoytcALKo93jkUt1ENhVQij09dmis3,5X6FeZozNMgE2VRi3MJYjkkFK8SETtu2,6,7,2,0,1,0,1,0,11,1.5714285714285714,1,0.0,0,2,0,1,7,0,0,1,0,3,8,1
18125,167153,zLzrsjVhPiaEb3EDibB8rvomdeM0jowN,A3fsA9Zfv1X2fVEQhTw51lKENdNrEqT3,6,8,1,0,0,0,2,0,11,1.5714285714285714,1,0.0,0,1,0,0,8,0,0,2,0,1,10,1
18126,167160,qWdJx4ntsNtLd8GM8vVdR8CfHZUb8VJ1,SpATywNh6bZuzm8s1ceuBUnMUAeoAHHw,7,7,0,0,0,0,4,5,16,2.2857142857142856,1,0.0,0,0,0,0,7,0,0,4,5,0,16,0
18127,167164,AMZsJ16nuDGvS9hfq5BFOrn6l1y3GwHs,bWdj2GDclj5ofokWjzoa5jAwMkxCykd6,1,0,0,0,0,0,1,0,1,0.14285714285714285,1,0.0,0,0,0,0,0,0,0,1,0,0,1,1
18128,167174,jQg5UakMQRKmdDEXjxxf2nAUZSauWzhl,bWdj2GDclj5ofokWjzoa5jAwMkxCykd6,1,0,0,0,0,0,1,0,1,0.14285714285714285,1,0.0,0,0,0,0,0,0,0,1,0,0,1,1
18129,167177,UMYeL3JvH5xCKyH0vQfSARajUrJikDyh,SpATywNh6bZuzm8s1ceuBUnMUAeoAHHw,1,0,0,0,0,0,1,0,1,0.14285714285714285,1,0.0,0,0,0,0,0,0,0,1,0,0,1,1
18130,167207,l6rkobnqEUKXFQnaBVgonlwU5l25TkcG,A3fsA9Zfv1X2fVEQhTw51lKENdNrEqT3,30,9,6,54,4,1,5,1,80,11.428571428571429,2,0.0,1,6,53,4,8,1,1,5,1,64,16,0
18131,167210,6ihb1oofKKDBkRZUjaHYZlnMwyNG8Px4,SpATywNh6bZuzm8s1ceuBUnMUAeoAHHw,11,5,4,0,4,0,3,0,16,2.2857142857142856,1,0.0,0,4,0,4,5,0,0,3,0,8,8,1
18132,167213,M3at3k1rzNLIb1jD1sERLP1bmTcUThqC,A3fsA9Zfv1X2fVEQhTw51lKENdNrEqT3,13,20,0,0,0,0,15,2,37,5.285714285714286,2,0.0,0,0,0,0,20,0,0,15,2,0,37,1
18133,167220,Me95BqnMi7W18LuJ9CGsC9vdXTLZ2e0Y,bWdj2GDclj5ofokWjzoa5jAwMkxCykd6,6,2,1,0,1,0,4,0,8,1.1428571428571428,1,0.0,0,1,0,1,2,0,0,4,0,2,6,1
18134,167228,3wg8Fx16VgJsTbW93ZS5qb0oY4bANqoR,A3fsA9Zfv1X2fVEQhTw51lKENdNrEqT3,52,29,13,164,2,0,17,0,225,32.142857142857146,2,0.0,3,13,135,2,26,0,29,17,0,153,72,1
18135,167229,gzXWUmBbfvFR7PGGJvrwCH6citOFTVWD,5X6FeZozNMgE2VRi3MJYjkkFK8SETtu2,1,0,0,0,0,0,1,0,1,0.14285714285714285,1,0.0,0,0,0,0,0,0,0,1,0,0,1,1
18136,167230,EIH1YpezRj2Lrs71q1s3kjWajWGWK1FM,bWdj2GDclj5ofokWjzoa5jAwMkxCykd6,4,3,1,0,0,0,2,0,6,0.8571428571428571,1,0.0,0,1,0,0,3,0,0,2,0,1,5,1
18137,167243,XFT0aKbgPIc1KxMgUm9PqHuvehKJNjDt,A3fsA9Zfv1X2fVEQhTw51lKENdNrEqT3,1,0,0,0,0,0,1,0,1,0.14285714285714285,1,0.0,0,0,0,0,0,0,0,1,0,0,1,1
18138,167265,srnnzUkIJr2Uisav8LfnV4SnpbNw9CLp,RXDvfPUBYFlVdlueBFbLW0mhhAyGEqpt,1,0,0,0,0,0,1,0,1,0.14285714285714285,1,0.0,0,0,0,0,0,0,0,1,0,0,1,1
18139,167271,SG7N8DhpCuhIu06IIzLX0CSolbyIDsIx,RXDvfPUBYFlVdlueBFbLW0mhhAyGEqpt,1,0,0,0,0,0,1,0,1,0.14285714285714285,1,0.0,0,0,0,0,0,0,0,1,0,0,1,1
18140,167274,dU7DqQeRV0VJw1owh3rH0rASxy6mSG05,5X6FeZozNMgE2VRi3MJYjkkFK8SETtu2,1,0,0,0,0,0,1,0,1,0.14285714285714285,1,0.0,0,0,0,0,0,0,0,1,0,0,1,1
18141,167277,mYprTaruBDuUvLXNdxUEBezQgZtrye7I,5X6FeZozNMgE2VRi3MJYjkkFK8SETtu2,5,3,2,0,2,0,4,0,11,1.5714285714285714,1,0.0,0,2,0,2,3,0,0,4,0,4,7,1
18142,167283,ilday4HM3BCIYcolQVgtTOYVZxbISCZm,G8EPVSXsOYB5YQWZGiz1aVq5Pgr2GrQu,15,21,9,6,7,3,11,0,57,8.142857142857142,3,0.0,4,9,3,7,17,3,3,11,0,23,34,1
18143,167288,sm9cSvIl5TlGsEwD0oTwnhmYMTLPLj8P,bWdj2GDclj5ofokWjzoa5jAwMkxCykd6,7,3,2,0,2,0,2,0,9,1.2857142857142858,1,0.0,0,2,0,2,3,0,0,2,0,4,5,1
18144,167295,4uAdkCJ4XUaD1NQGV93nNifOuyurJNKS,bWdj2GDclj5ofokWjzoa5jAwMkxCykd6,5,3,1,0,1,0,2,0,7,1.0,1,0.0,0,1,0,1,3,0,0,2,0,2,5,1
18145,167312,8MuGb55gUM18pukCITXgZoTSobqXs9G4,5X6FeZozNMgE2VRi3MJYjkkFK8SETtu2,2,0,0,0,0,0,4,0,4,0.5714285714285714,3,0.0,0,0,0,0,0,0,0,4,0,0,4,1
18146,167326,yAxjMvvPF3HDitgCGIcnFlXrbnOszGcQ,A3fsA9Zfv1X2fVEQhTw51lKENdNrEqT3,1,0,0,0,0,0,1,0,1,0.14285714285714285,1,0.0,0,0,0,0,0,0,0,1,0,0,1,1
18147,167329,cGTjqosEXx9XAIsx39Oilmuyj8U0yqfw,A3fsA9Zfv1X2fVEQhTw51lKENdNrEqT3,2,0,0,0,0,0,2,0,2,0.2857142857142857,1,0.0,0,0,0,0,0,0,0,2,0,0,2,1
18148,167340,3wg8Fx16VgJsTbW93ZS5qb0oY4bANqoR,bWdj2GDclj5ofokWjzoa5jAwMkxCykd6,1,0,0,0,0,0,1,0,1,0.14285714285714285,1,0.0,0,0,0,0,0,0,0,1,0,0,1,1
18149,167358,dr13KuqOo10EJH5V4oOgMy17ewEUhD7o,bWdj2GDclj5ofokWjzoa5jAwMkxCykd6,8,5,3,0,3,0,1,0,12,1.7142857142857142,1,0.0,1,3,0,3,4,0,0,1,0,7,5,1
18150,167361,IrJFtwV20e4gt61fm0xRhF7i2xKfc3Wt,SpATywNh6bZuzm8s1ceuBUnMUAeoAHHw,6,3,1,0,1,0,3,0,8,1.1428571428571428,1,0.0,0,1,0,1,3,0,0,3,0,2,6,1
18151,167380,OId7ihHovZuj6RIQGiERiMwv6zBqdO48,SpATywNh6bZuzm8s1ceuBUnMUAeoAHHw,18,16,10,0,5,1,5,0,37,5.285714285714286,4,0.0,1,10,0,5,15,1,0,5,0,16,21,1
18152,167394,igrS7a4fgJSjVbKCLW8mOgk95ysQ2GkN,A3fsA9Zfv1X2fVEQhTw51lKENdNrEqT3,3,3,0,0,0,0,2,0,5,0.7142857142857143,1,0.0,0,0,0,0,3,0,0,2,0,0,5,1
18153,167407,eyR9iuqRP6NAP1R3ifarfP0UWEdrKp8A,A3fsA9Zfv1X2fVEQhTw51lKENdNrEqT3,2,0,0,0,0,0,2,0,2,0.2857142857142857,1,0.0,0,0,0,0,0,0,0,2,0,0,2,1
18154,167431,Yq1D9nN2WOKWLjCOIlbnWTVJWZSUTem6,5X6FeZozNMgE2VRi3MJYjkkFK8SETtu2,6,5,3,0,2,0,3,0,13,1.8571428571428572,1,0.0,0,3,0,2,5,0,0,3,0,5,8,1
18155,167432,hb0tSuKbMyuHgl5YJ3vO5EnQOpHuAODO,SpATywNh6bZuzm8s1ceuBUnMUAeoAHHw,1,0,0,0,0,0,1,0,1,0.14285714285714285,1,0.0,0,0,0,0,0,0,0,1,0,0,1,1
18156,167440,6ne76rFv6J6TLXUe0mStK4MXCR4J8Kt5,A3fsA9Zfv1X2fVEQhTw51lKENdNrEqT3,6,5,2,0,2,0,4,0,13,1.8571428571428572,1,0.0,0,2,0,2,5,0,0,4,0,4,9,1
18157,167449,1sNCO2I2ugkApY4LVRJ2DyXeH2mxSN1W,G8EPVSXsOYB5YQWZGiz1aVq5Pgr2GrQu,5,12,0,0,0,0,2,0,14,2.0,1,0.0,0,0,0,0,12,0,0,2,0,0,14,1
18158,167464,XTOZBwO5vG1hcHef4AbuiTP7iSg27hS9,5X6FeZozNMgE2VRi3MJYjkkFK8SETtu2,2,0,0,0,0,0,2,0,2,0.2857142857142857,1,0.0,0,0,0,0,0,0,0,2,0,0,2,1
18159,167465,sQxRXgPzRqzU7G3Pdnh2A5U6A9WnaHY5,bWdj2GDclj5ofokWjzoa5jAwMkxCykd6,7,1,1,0,1,0,4,0,7,1.0,1,0.0,0,1,0,1,1,0,0,4,0,2,5,1
18160,167491,qT76Xe5xaEtKYZkUI7rFvt9ufvg3XeEH,SpATywNh6bZuzm8s1ceuBUnMUAeoAHHw,7,5,4,0,1,0,1,0,11,1.5714285714285714,1,0.0,0,4,0,1,5,0,0,1,0,5,6,0
18161,167492,kMJdIf6lyKBj8d5FH5wYfeAvXu9zJZ2k,A3fsA9Zfv1X2fVEQhTw51lKENdNrEqT3,26,8,4,86,0,0,10,0,108,15.428571428571429,3,0.0,1,4,71,0,7,0,15,10,0,76,32,1
18162,167496,Yq1D9nN2WOKWLjCOIlbnWTVJWZSUTem6,A3fsA9Zfv1X2fVEQhTw51lKENdNrEqT3,2,0,0,0,0,0,2,0,2,0.2857142857142857,1,0.0,0,0,0,0,0,0,0,2,0,0,2,1
18163,167503,Mg6dUwdl29Cw5DED2LH0q16XcuO0xYuD,SpATywNh6bZuzm8s1ceuBUnMUAeoAHHw,8,6,2,0,2,1,4,0,15,2.142857142857143,2,0.0,0,2,0,2,6,1,0,4,0,4,11,1
18164,167509,pqW9PtvFaMrdSQupCOglYiHhuFKzGBi5,RXDvfPUBYFlVdlueBFbLW0mhhAyGEqpt,13,8,7,0,5,0,2,0,22,3.142857142857143,1,0.0,0,7,0,5,8,0,0,2,0,12,10,0
18165,167523,qT76Xe5xaEtKYZkUI7rFvt9ufvg3XeEH,G8EPVSXsOYB5YQWZGiz1aVq5Pgr2GrQu,4,2,1,0,1,0,1,0,5,0.7142857142857143,1,0.0,0,1,0,1,2,0,0,1,0,2,3,0
18166,167525,ySjZqVrtQh1EozvnE2NZCLTibblBWXx9,RXDvfPUBYFlVdlueBFbLW0mhhAyGEqpt,1,0,0,0,0,0,1,0,1,0.14285714285714285,1,0.0,0,0,0,0,0,0,0,1,0,0,1,1
18167,167544,9eohUJjz99qBfLZrerzU9mvxKvUKHTKa,SpATywNh6bZuzm8s1ceuBUnMUAeoAHHw,7,5,2,0,2,0,2,0,11,1.5714285714285714,1,0.0,0,2,0,2,5,0,0,2,0,4,7,1
18168,167558,gKnyqrdfTVsXquWsv3SHAmERz5CaeqZp,SpATywNh6bZuzm8s1ceuBUnMUAeoAHHw,6,2,1,0,1,0,3,1,8,1.1428571428571428,1,0.0,0,1,0,1,2,0,0,3,1,2,6,1
18169,167561,E8lMjkJcqZcrPtGwbo8pVkzTRx8M7QkS,A3fsA9Zfv1X2fVEQhTw51lKENdNrEqT3,1,0,0,0,0,0,1,0,1,0.14285714285714285,1,0.0,0,0,0,0,0,0,0,1,0,0,1,1
18170,167562,MtRhvdyfNAmKhL1ceR2tOMUJmXukJ2x3,5X6FeZozNMgE2VRi3MJYjkkFK8SETtu2,7,40,7,0,11,0,5,0,63,9.0,2,0.0,31,7,0,11,9,0,0,5,0,49,14,1
18171,167569,YfnUrAEbnMAPhZfA8XApGAMCNnmussT1,SpATywNh6bZuzm8s1ceuBUnMUAeoAHHw,1,0,0,0,0,0,2,0,2,0.2857142857142857,1,0.0,0,0,0,0,0,0,0,2,0,0,2,1
18172,167584,f8jfFGo37bmeRi1spfYTASayMTQa0E3F,A3fsA9Zfv1X2fVEQhTw51lKENdNrEqT3,7,8,1,0,0,0,4,0,13,1.8571428571428572,1,0.0,0,1,0,0,8,0,0,4,0,1,12,1
18173,167605,mkvoAcdNQZUqkTrSjEQHebVQkgmiPVSS,SpATywNh6bZuzm8s1ceuBUnMUAeoAHHw,6,6,0,0,0,0,2,0,8,1.1428571428571428,1,0.0,2,0,0,0,4,0,0,2,0,2,6,1
18174,167633,JRUKMEmBZ3p5F0JpSVHv1lQEiMQUvro3,bWdj2GDclj5ofokWjzoa5jAwMkxCykd6,1,0,0,0,0,0,1,0,1,0.14285714285714285,1,0.0,0,0,0,0,0,0,0,1,0,0,1,1
18175,167636,DTg7EG4lfjPjfkpYaGZXFcsjykgIpZH4,RXDvfPUBYFlVdlueBFbLW0mhhAyGEqpt,16,14,7,0,5,0,5,0,31,4.428571428571429,2,0.0,0,7,0,5,14,0,0,5,0,12,19,1
18176,167638,JRUKMEmBZ3p5F0JpSVHv1lQEiMQUvro3,RXDvfPUBYFlVdlueBFbLW0mhhAyGEqpt,1,0,0,0,0,0,1,0,1,0.14285714285714285,1,0.0,0,0,0,0,0,0,0,1,0,0,1,1
18177,167656,j5JRftGHwmY5lwmELzjqtaSr20rFNwcA,SpATywNh6bZuzm8s1ceuBUnMUAeoAHHw,1,0,0,0,0,0,1,0,1,0.14285714285714285,1,0.0,0,0,0,0,0,0,0,1,0,0,1,1
18178,167659,ySL3N6leUYq4FJsPfm5psrr8vOc4j4V7,5X6FeZozNMgE2VRi3MJYjkkFK8SETtu2,14,12,4,16,3,1,9,1,46,6.571428571428571,1,0.0,5,4,13,3,7,1,3,9,1,25,21,1
18179,167678,IoHuXwpFj6jpaLOU2cjm2xo4xL3oc4iA,G8EPVSXsOYB5YQWZGiz1aVq5Pgr2GrQu,2,0,0,0,0,0,2,0,2,0.2857142857142857,1,0.0,0,0,0,0,0,0,0,2,0,0,2,1
18180,167684,IwkHnS79j7DCN6kQlSDresD36YsGD4iB,G8EPVSXsOYB5YQWZGiz1aVq5Pgr2GrQu,1,0,0,0,0,0,1,0,1,0.14285714285714285,1,0.0,0,0,0,0,0,0,0,1,0,0,1,1
18181,167693,bEOs2EB6LytAmhUESt0L1yFXZPfFAnOp,A3fsA9Zfv1X2fVEQhTw51lKENdNrEqT3,9,4,1,0,1,0,7,1,14,2.0,1,0.0,0,1,0,1,4,0,0,7,1,2,12,1
18182,167700,Ujm7XeJHYzYOVDc0hFmfxPzKGkFTVoYw,SpATywNh6bZuzm8s1ceuBUnMUAeoAHHw,10,5,1,0,1,3,7,1,18,2.5714285714285716,1,0.0,1,1,0,1,4,3,0,7,1,3,15,1
18183,167701,YEYMa1UeAbDmjG2cCwIOrTIjhyXHc5JO,SpATywNh6bZuzm8s1ceuBUnMUAeoAHHw,5,2,1,0,1,0,3,0,7,1.0,1,0.0,0,1,0,1,2,0,0,3,0,2,5,1
18184,167712,JhqtKTVVZhx2wzcUoD48zfOf7XJtvv55,SpATywNh6bZuzm8s1ceuBUnMUAeoAHHw,9,9,5,0,2,0,7,0,23,3.2857142857142856,2,0.0,0,5,0,2,9,0,0,7,0,7,16,1
18185,167714,nyH7Jx4kN1AdDJdwkZQoUDqYoovHgbk5,G8EPVSXsOYB5YQWZGiz1aVq5Pgr2GrQu,17,39,19,12,13,0,4,0,87,12.428571428571429,4,0.0,13,19,8,13,26,0,4,4,0,53,34,1
18186,167723,W5xQOH5MemwXn7klqn6rjd1MM4WzuzQi,G8EPVSXsOYB5YQWZGiz1aVq5Pgr2GrQu,1,0,0,0,0,0,1,0,1,0.14285714285714285,1,0.0,0,0,0,0,0,0,0,1,0,0,1,1
18187,167725,4SwPkRwXa5n6GEnAhisQz0yWI5GHdoml,SpATywNh6bZuzm8s1ceuBUnMUAeoAHHw,1,0,0,0,0,0,1,0,1,0.14285714285714285,1,0.0,0,0,0,0,0,0,0,1,0,0,1,1
18188,167730,eJb0xHKhoVkWPAATxA33vCcHjeoUzUdU,SpATywNh6bZuzm8s1ceuBUnMUAeoAHHw,1,0,0,0,0,0,1,0,1,0.14285714285714285,1,0.0,0,0,0,0,0,0,0,1,0,0,1,1
18189,167732,KTO4rcwcNqZCBYJ04kXZU7uzHTeP1Eer,bWdj2GDclj5ofokWjzoa5jAwMkxCykd6,1,0,0,0,0,0,1,0,1,0.14285714285714285,1,0.0,0,0,0,0,0,0,0,1,0,0,1,1
18190,167733,qj8NUYtUMoWd1xGdKnBiRi4xrQOuNSyr,SpATywNh6bZuzm8s1ceuBUnMUAeoAHHw,7,4,0,0,0,11,8,2,25,3.5714285714285716,1,0.0,0,0,0,0,4,11,0,8,2,0,25,0
18191,167734,KTO4rcwcNqZCBYJ04kXZU7uzHTeP1Eer,A3fsA9Zfv1X2fVEQhTw51lKENdNrEqT3,51,12,7,122,0,0,7,0,148,21.142857142857142,2,0.0,3,7,107,0,9,0,15,7,0,117,31,1
18192,167736,T9568NbVeTbUTmE4rk1xM0kbLMHudWM2,SpATywNh6bZuzm8s1ceuBUnMUAeoAHHw,2,0,0,0,0,0,2,0,2,0.2857142857142857,1,0.0,0,0,0,0,0,0,0,2,0,0,2,1
18193,167738,8MuGb55gUM18pukCITXgZoTSobqXs9G4,A3fsA9Zfv1X2fVEQhTw51lKENdNrEqT3,44,5,0,154,0,0,6,0,165,23.571428571428573,3,0.0,0,0,154,0,5,0,0,6,0,154,11,1
18194,167739,mzdlx6QFLX0FKvpMfsWw3ZhcYcqCwlK5,SpATywNh6bZuzm8s1ceuBUnMUAeoAHHw,25,34,12,34,4,9,8,1,102,14.571428571428571,2,0.0,16,12,29,4,18,9,5,8,1,61,41,0
18195,167745,wTfd2gVG5QduDxubL2XCUf2GyqSTHM2h,5X6FeZozNMgE2VRi3MJYjkkFK8SETtu2,1,0,0,0,0,0,1,0,1,0.14285714285714285,1,0.0,0,0,0,0,0,0,0,1,0,0,1,1
18196,167752,X7ZRKY7iYfh1hBkF13Zq6r3vncHYgHEH,A3fsA9Zfv1X2fVEQhTw51lKENdNrEqT3,1,0,0,0,0,0,1,0,1,0.14285714285714285,1,0.0,0,0,0,0,0,0,0,1,0,0,1,1
18197,167762,HubxyoHMVvWQ9uDYtdMVwcYvuPNvagty,SpATywNh6bZuzm8s1ceuBUnMUAeoAHHw,7,4,3,0,3,0,2,0,12,1.7142857142857142,1,0.0,0,3,0,3,4,0,0,2,0,6,6,1
18198,167767,8MuGb55gUM18pukCITXgZoTSobqXs9G4,bWdj2GDclj5ofokWjzoa5jAwMkxCykd6,4,3,0,0,0,0,4,0,7,1.0,3,0.0,0,0,0,0,3,0,0,4,0,0,7,1
18199,167771,dv5Xzy3RizPqbGvGIMXlJIDl0kMrBVlb,5X6FeZozNMgE2VRi3MJYjkkFK8SETtu2,4,2,1,0,0,0,2,0,5,0.7142857142857143,1,0.0,0,1,0,0,2,0,0,2,0,1,4,1
18200,167777,BWZyBrJDBbkcDEXyE3CSVFoVlT2CRRku,bWdj2GDclj5ofokWjzoa5jAwMkxCykd6,5,3,0,0,0,3,7,0,13,1.8571428571428572,2,0.0,1,0,0,0,2,3,0,7,0,1,12,1
18201,167781,HhHFHVl0FdyFAQQ7F70xD2HQyGMqv85Q,G8EPVSXsOYB5YQWZGiz1aVq5Pgr2GrQu,26,30,5,0,2,0,15,1,53,7.571428571428571,3,0.0,0,5,0,2,30,0,0,15,1,7,46,1
18202,167800,0LL9QDirPHiGZNR0VQr3Nl4vTFkZYpx9,SpATywNh6bZuzm8s1ceuBUnMUAeoAHHw,1,0,0,0,0,0,1,0,1,0.14285714285714285,1,0.0,0,0,0,0,0,0,0,1,0,0,1,1
18203,167802,RPbVtB8AwN8yynuRyP2nQSNV9Qygwfwj,bWdj2GDclj5ofokWjzoa5jAwMkxCykd6,1,0,0,0,0,0,1,0,1,0.14285714285714285,1,0.0,0,0,0,0,0,0,0,1,0,0,1,1
18204,167804,t1cN3fKfmsp5Xu7Bxx5kMtJx0UaXo72h,A3fsA9Zfv1X2fVEQhTw51lKENdNrEqT3,1,0,0,0,0,0,1,0,1,0.14285714285714285,1,0.0,0,0,0,0,0,0,0,1,0,0,1,1
18205,167809,cec6apEZZ4OuI8Z1bq3hYVAQOrfIot0q,G8EPVSXsOYB5YQWZGiz1aVq5Pgr2GrQu,5,2,1,0,1,0,5,0,9,1.2857142857142858,1,0.0,0,1,0,1,2,0,0,5,0,2,7,0
18206,167815,5sps38f5Y5pZOFcONQeuy3Uw9461fahZ,bWdj2GDclj5ofokWjzoa5jAwMkxCykd6,5,2,1,0,1,0,2,0,6,0.8571428571428571,1,0.0,0,1,0,1,2,0,0,2,0,2,4,1
18207,167830,9d73It9dbU3oxDfTI8oeXV5S5dv2fy6Z,3VkHkmOtom3jM2wCu94xgzzu1d6Dn7or,1,0,0,0,0,0,2,0,2,0.2857142857142857,1,0.0,0,0,0,0,0,0,0,2,0,0,2,1
18208,167833,6Wxu7ROOUIUrDpts0GNT0b9BdXqvS8rN,3VkHkmOtom3jM2wCu94xgzzu1d6Dn7or,11,8,6,0,4,0,2,0,20,2.857142857142857,2,0.0,0,6,0,4,8,0,0,2,0,10,10,1
18209,167836,H2SI8xiP6AfGLtLXDoA9AXn8QdorX1Ui,3VkHkmOtom3jM2wCu94xgzzu1d6Dn7or,3,0,0,0,0,2,6,0,8,1.1428571428571428,1,0.0,0,0,0,0,0,2,0,6,0,0,8,1
18210,167837,EJfyGdJ9yd6yxlMqB9gc1CbaKkAoFcAP,3VkHkmOtom3jM2wCu94xgzzu1d6Dn7or,1,0,0,0,0,0,1,0,1,0.14285714285714285,1,0.0,0,0,0,0,0,0,0,1,0,0,1,1
18211,167838,BBxAjBZ6FgoUiaQ5bz1Iv3FndLCl7M0a,3VkHkmOtom3jM2wCu94xgzzu1d6Dn7or,8,5,3,0,0,1,6,0,15,2.142857142857143,1,0.0,0,3,0,0,5,1,0,6,0,3,12,1
18212,167843,EhIHkuSHqi99btgO8zXl3qd7FaPXyt4O,3VkHkmOtom3jM2wCu94xgzzu1d6Dn7or,8,10,4,0,2,0,4,0,20,2.857142857142857,3,0.0,0,4,0,2,10,0,0,4,0,6,14,1
18213,167844,jg1izKcLOCQQccVtb0xwXEbSh8NkGjGq,3VkHkmOtom3jM2wCu94xgzzu1d6Dn7or,1,0,0,0,0,0,1,0,1,0.14285714285714285,1,0.0,0,0,0,0,0,0,0,1,0,0,1,1
18214,167846,Mz4tCq48F8Vo6f66hsgQjWbSQTLdHbUu,3VkHkmOtom3jM2wCu94xgzzu1d6Dn7or,5,6,1,0,1,0,1,0,9,1.2857142857142858,1,0.0,0,1,0,1,6,0,0,1,0,2,7,1
18215,167850,05eYd6nVS80B4zVtMeSuzaTtmBSCZOK3,3VkHkmOtom3jM2wCu94xgzzu1d6Dn7or,5,4,1,0,1,1,2,0,9,1.2857142857142858,1,0.0,1,1,0,1,3,1,0,2,0,3,6,1
18216,167856,cTRvr9OwCf92tEyWCswhS4evpjr692re,3VkHkmOtom3jM2wCu94xgzzu1d6Dn7or,7,9,3,0,2,0,5,0,19,2.7142857142857144,2,0.0,1,3,0,2,8,0,0,5,0,6,13,1
18217,167858,04lCRShTAc7quEzrn2ou8mv2nCigZbgp,3VkHkmOtom3jM2wCu94xgzzu1d6Dn7or,6,5,3,0,2,0,5,0,15,2.142857142857143,1,0.0,0,3,0,2,5,0,0,5,0,5,10,1
18218,167864,TOaINpcBLCJfZ2I2QbCp4abwufWoQUhj,3VkHkmOtom3jM2wCu94xgzzu1d6Dn7or,18,23,8,14,9,6,8,0,68,9.714285714285714,1,0.0,10,8,12,9,13,6,2,8,0,39,29,1
18219,167870,YoD5TStKk1uJ5sTkRhrgG9ZhOoogdtvY,3VkHkmOtom3jM2wCu94xgzzu1d6Dn7or,15,8,6,0,6,0,2,0,22,3.142857142857143,1,0.0,1,6,0,6,7,0,0,2,0,13,9,1
18220,167873,SZqQgJTwnT4DdAmdFLsmCSu8pOi8l278,3VkHkmOtom3jM2wCu94xgzzu1d6Dn7or,1,0,0,0,0,0,2,0,2,0.2857142857142857,1,0.0,0,0,0,0,0,0,0,2,0,0,2,1
18221,167876,cXWvF2D7w4W534TQNivVGR20evKWHdmC,3VkHkmOtom3jM2wCu94xgzzu1d6Dn7or,2,0,0,0,0,0,2,0,2,0.2857142857142857,1,0.0,0,0,0,0,0,0,0,2,0,0,2,1
18222,167877,nz7SdGwmWTnUgJHbI5SHYAxdoSxPn3v9,3VkHkmOtom3jM2wCu94xgzzu1d6Dn7or,2,0,0,0,0,0,3,0,3,0.42857142857142855,1,0.0,0,0,0,0,0,0,0,3,0,0,3,1
18223,167885,w0MOevkqL7TIdK3soXlSk0InhRt5D2OI,3VkHkmOtom3jM2wCu94xgzzu1d6Dn7or,4,10,0,0,1,1,1,0,13,1.8571428571428572,1,0.0,5,0,0,1,5,1,0,1,0,6,7,1
18224,167886,T6EWQ7jVP89JlHzj41KN1gEtGYevpSQM,3VkHkmOtom3jM2wCu94xgzzu1d6Dn7or,1,0,0,0,0,0,1,0,1,0.14285714285714285,1,0.0,0,0,0,0,0,0,0,1,0,0,1,1
18225,167889,rwhwaTH9sh2CIA4lrAOreMZ4DcHbdGSX,3VkHkmOtom3jM2wCu94xgzzu1d6Dn7or,4,3,1,0,1,0,1,0,6,0.8571428571428571,1,0.0,0,1,0,1,3,0,0,1,0,2,4,1
18226,167897,TbUheYwTeREPT5Z3hVrDk5WemURCeERw,3VkHkmOtom3jM2wCu94xgzzu1d6Dn7or,1,0,0,0,0,0,1,0,1,0.14285714285714285,1,0.0,0,0,0,0,0,0,0,1,0,0,1,1
18227,167900,wuhaNytEMshRvZHy4v0wfMQMUoUf2C0I,3VkHkmOtom3jM2wCu94xgzzu1d6Dn7or,1,0,0,0,0,0,1,0,1,0.14285714285714285,1,0.0,0,0,0,0,0,0,0,1,0,0,1,1
18228,167906,BsUjBDhdyUXYaK2TdnMst3sGgcJsTcFj,3VkHkmOtom3jM2wCu94xgzzu1d6Dn7or,17,64,25,16,0,22,8,1,136,19.428571428571427,1,0.0,21,25,15,0,43,22,1,8,1,61,75,1
18229,167911,QYfu0Yy3chzMh9N27M3NdjRKbhRbX6KZ,3VkHkmOtom3jM2wCu94xgzzu1d6Dn7or,15,15,7,6,8,2,21,1,60,8.571428571428571,2,0.0,6,7,5,8,9,2,1,21,1,26,34,1
18230,167912,y5qGGV7k07NOQfMigLDYbjv0jILDYgkC,3VkHkmOtom3jM2wCu94xgzzu1d6Dn7or,12,12,7,0,7,0,3,0,29,4.142857142857143,2,0.0,2,7,0,7,10,0,0,3,0,16,13,1
18231,167917,I4MqqOGxKO8aJcsCgOUnBSAMs2KCIFJB,3VkHkmOtom3jM2wCu94xgzzu1d6Dn7or,6,17,4,0,4,0,2,0,27,3.857142857142857,1,0.0,7,4,0,4,10,0,0,2,0,15,12,1
18232,167918,OhHmRP3AJk4AhYrz2RzDrm3BTMGEusSV,3VkHkmOtom3jM2wCu94xgzzu1d6Dn7or,5,2,1,0,1,0,2,0,6,0.8571428571428571,1,0.0,0,1,0,1,2,0,0,2,0,2,4,1
18233,167921,bBDozteTX4D4ORk9XFCupn0FLtyYS5su,3VkHkmOtom3jM2wCu94xgzzu1d6Dn7or,2,0,0,0,0,0,3,0,3,0.42857142857142855,1,0.0,0,0,0,0,0,0,0,3,0,0,3,1
18234,167925,B1tG9d6vAm1cRb4gczt46vEuvymg0cAG,3VkHkmOtom3jM2wCu94xgzzu1d6Dn7or,1,0,0,0,0,0,1,0,1,0.14285714285714285,1,0.0,0,0,0,0,0,0,0,1,0,0,1,1
18235,167929,0lqOZSX7cmSd4rlWa8O2CvuGbKanDhKJ,3VkHkmOtom3jM2wCu94xgzzu1d6Dn7or,1,0,0,0,0,0,1,0,1,0.14285714285714285,1,0.0,0,0,0,0,0,0,0,1,0,0,1,1
18236,167933,UiS73jMKlU4Br8R1hIRvjExZc4uRiQjd,3VkHkmOtom3jM2wCu94xgzzu1d6Dn7or,1,0,0,0,0,0,1,0,1,0.14285714285714285,1,0.0,0,0,0,0,0,0,0,1,0,0,1,1
18237,167946,9X8ssnk1S6QNY201gYXI4DoJg7mLdbbk,3VkHkmOtom3jM2wCu94xgzzu1d6Dn7or,11,17,8,0,4,0,7,0,36,5.142857142857143,3,0.0,3,8,0,4,14,0,0,7,0,15,21,1
18238,167951,zX8EipUM7J0ifhENZyJ19KxHpsJKH6Ul,3VkHkmOtom3jM2wCu94xgzzu1d6Dn7or,2,0,0,0,0,0,5,0,5,0.7142857142857143,1,0.0,0,0,0,0,0,0,0,5,0,0,5,1
18239,168003,y1x8e9Sqq47SjNlkaBvMyt0S6tF2mWwv,fbPkOYLVPtPgIt0MxizjfFJov3JbHyAi,4,3,1,0,1,0,1,0,6,0.8571428571428571,1,0.0,0,1,0,1,3,0,0,1,0,2,4,1
18240,168004,nK13dP33HOsCMcudkGT9g2i4LS1y6QrD,fbPkOYLVPtPgIt0MxizjfFJov3JbHyAi,9,6,4,0,2,0,3,0,15,2.142857142857143,1,0.0,0,4,0,2,6,0,0,3,0,6,9,1
18241,168005,XpdwIP2CAxCi5EEwdtYqsnWn1GswP4MJ,fbPkOYLVPtPgIt0MxizjfFJov3JbHyAi,25,23,15,26,10,0,3,0,77,11.0,2,0.0,6,15,25,10,17,0,1,3,0,56,21,1
18242,168006,a8QEUUyZeFybf89xc7mwLuT0kKVfakw4,fbPkOYLVPtPgIt0MxizjfFJov3JbHyAi,1,0,0,0,0,0,1,0,1,0.14285714285714285,1,0.0,0,0,0,0,0,0,0,1,0,0,1,1
18243,168007,cFg7b49sFJZmDzd2wumcUexf3Q4M4csm,fbPkOYLVPtPgIt0MxizjfFJov3JbHyAi,5,2,1,0,1,0,2,0,6,0.8571428571428571,1,0.0,0,1,0,1,2,0,0,2,0,2,4,1
18244,168008,Es60P2jDBCO8AUpFrcBtniYYzniYIciC,fbPkOYLVPtPgIt0MxizjfFJov3JbHyAi,8,9,5,0,4,5,2,0,25,3.5714285714285716,1,0.0,0,5,0,4,9,5,0,2,0,9,16,1
18245,168009,HzIanfTE4wgwHrp1kwNpPTkpGpp6pHZj,fbPkOYLVPtPgIt0MxizjfFJov3JbHyAi,1,0,0,0,0,0,1,0,1,0.14285714285714285,1,0.0,0,0,0,0,0,0,0,1,0,0,1,1
18246,168010,dHobMPF85CwLnL5PBGltrpvI7vF4buSv,fbPkOYLVPtPgIt0MxizjfFJov3JbHyAi,1,0,0,0,0,0,1,0,1,0.14285714285714285,1,0.0,0,0,0,0,0,0,0,1,0,0,1,1
18247,168011,4cJUuVTAIhyyuSqreV0gX0h7VcUA6TDH,fbPkOYLVPtPgIt0MxizjfFJov3JbHyAi,1,0,0,0,0,0,2,0,2,0.2857142857142857,2,0.0,0,0,0,0,0,0,0,2,0,0,2,1
18248,168012,z2mvsBsVSR04tXPZpruVlEbUTspLhDcg,fbPkOYLVPtPgIt0MxizjfFJov3JbHyAi,16,15,6,12,7,0,8,1,49,7.0,1,0.0,7,6,8,7,8,0,4,8,1,28,21,1
18249,168013,nYSFDE8RCbcZhD46fRSvPHUvA1ahfupi,fbPkOYLVPtPgIt0MxizjfFJov3JbHyAi,7,3,2,0,2,0,2,0,9,1.2857142857142858,1,0.0,0,2,0,2,3,0,0,2,0,4,5,0
18250,168014,4mlUaTkpZXC4iECGR0SaagnPGaT0J0Vl,fbPkOYLVPtPgIt0MxizjfFJov3JbHyAi,8,14,5,0,5,0,4,0,28,4.0,1,0.0,5,5,0,5,9,0,0,4,0,15,13,1
18251,168016,Xdurokd2SSgNf25hifq07OxoiHEDcyiq,fbPkOYLVPtPgIt0MxizjfFJov3JbHyAi,8,8,5,0,0,2,11,1,27,3.857142857142857,2,0.0,0,5,0,0,8,2,0,11,1,5,22,1
18252,168017,HOg8IFud3YOeqibycclJf11M4k8RWkqi,fbPkOYLVPtPgIt0MxizjfFJov3JbHyAi,2,0,0,0,0,0,2,0,2,0.2857142857142857,1,0.0,0,0,0,0,0,0,0,2,0,0,2,1
18253,168018,VXagNOkZu5u5I8qpPT9MJuCTffG8dhWL,fbPkOYLVPtPgIt0MxizjfFJov3JbHyAi,12,6,4,0,2,5,6,1,24,3.4285714285714284,1,0.0,0,4,0,2,6,5,0,6,1,6,18,1
18254,168022,lmNEyMpBiUCXqFMVYwQrEECYmQuekARf,fbPkOYLVPtPgIt0MxizjfFJov3JbHyAi,7,4,1,0,1,0,9,0,15,2.142857142857143,2,0.0,0,1,0,1,4,0,0,9,0,2,13,1
18255,168024,IgtxjUuJpTq8y2IFrRLOetFo0KHctvB1,fbPkOYLVPtPgIt0MxizjfFJov3JbHyAi,1,0,0,0,0,0,1,0,1,0.14285714285714285,1,0.0,0,0,0,0,0,0,0,1,0,0,1,1
18256,168025,t0lnsmteGxhchvfn5egpM8riZQppmKLf,fbPkOYLVPtPgIt0MxizjfFJov3JbHyAi,11,22,4,8,11,0,2,0,47,6.714285714285714,1,0.0,17,4,6,11,5,0,2,2,0,38,9,1
18257,168026,2viub6InFwMLthqb8hJjmGF9NgF8w6Xs,fbPkOYLVPtPgIt0MxizjfFJov3JbHyAi,1,0,0,0,0,0,2,0,2,0.2857142857142857,1,0.0,0,0,0,0,0,0,0,2,0,0,2,1
18258,168027,JmbMCXw3MrYzCKQfBJj8oDR9fKlwh8X1,fbPkOYLVPtPgIt0MxizjfFJov3JbHyAi,6,3,1,0,1,0,2,0,7,1.0,1,0.0,0,1,0,1,3,0,0,2,0,2,5,1
18259,168029,hdKqkkWKrDzbKE9btGChBqiCfsTwp68E,fbPkOYLVPtPgIt0MxizjfFJov3JbHyAi,3,0,0,0,0,0,3,0,3,0.42857142857142855,1,0.0,0,0,0,0,0,0,0,3,0,0,3,0
18260,168030,TDBIQnqVyutxiXfwsNyCSusIbuDGxAUR,fbPkOYLVPtPgIt0MxizjfFJov3JbHyAi,18,28,11,15,5,0,4,0,63,9.0,1,0.0,11,11,12,5,17,0,3,4,0,39,24,1
18261,168033,OquQs3UlUuQySKKaB7T4hGbXWUMNQkYa,fbPkOYLVPtPgIt0MxizjfFJov3JbHyAi,1,0,0,0,0,0,1,0,1,0.14285714285714285,1,0.0,0,0,0,0,0,0,0,1,0,0,1,1
18262,168037,yBA6ehs866IQnEEGqpirUYIaPzkZZLJ6,3VkHkmOtom3jM2wCu94xgzzu1d6Dn7or,5,0,0,0,0,0,5,1,6,0.8571428571428571,1,0.0,0,0,0,0,0,0,0,5,1,0,6,1
18263,168046,iv81Q81guaacxQhe1lswOCJQhpTUkWGC,3VkHkmOtom3jM2wCu94xgzzu1d6Dn7or,6,1,1,0,1,0,3,0,6,0.8571428571428571,1,0.0,0,1,0,1,1,0,0,3,0,2,4,1
18264,168047,W204KyzLRJNYs8mmnLeuVypzQYU0ofDZ,3VkHkmOtom3jM2wCu94xgzzu1d6Dn7or,4,3,1,0,0,0,3,0,7,1.0,1,0.0,0,1,0,0,3,0,0,3,0,1,6,1
18265,168048,dhwdX4XTrnywKgn5lEC6WNcR4fGKk4cG,3VkHkmOtom3jM2wCu94xgzzu1d6Dn7or,7,4,2,0,1,0,4,0,11,1.5714285714285714,1,0.0,0,2,0,1,4,0,0,4,0,3,8,1
18266,168058,tQOAN9y1JNiE2HSkTuq37TMkk9NkfGoI,3VkHkmOtom3jM2wCu94xgzzu1d6Dn7or,3,2,1,0,0,0,2,0,5,0.7142857142857143,1,0.0,0,1,0,0,2,0,0,2,0,1,4,1
18267,168062,xBiO9124vyKa32Mt0b9RCRnNOHBsxMrI,3VkHkmOtom3jM2wCu94xgzzu1d6Dn7or,7,3,1,0,1,9,5,1,20,2.857142857142857,1,0.0,0,1,0,1,3,9,0,5,1,2,18,1
18268,168063,yQSxaM62MKQt9Zo5qHSYFAN1KQP78OWK,3VkHkmOtom3jM2wCu94xgzzu1d6Dn7or,4,4,1,0,1,0,2,0,8,1.1428571428571428,1,0.0,1,1,0,1,3,0,0,2,0,3,5,1
18269,168064,8r1wO8douiG9wPFG7rg5WG5F0cpQdW2l,3VkHkmOtom3jM2wCu94xgzzu1d6Dn7or,1,0,0,0,0,0,5,0,5,0.7142857142857143,1,0.0,0,0,0,0,0,0,0,5,0,0,5,1
18270,168070,rEOQ3Awf5wtqfh22N4NGB0n7ep7F1Fxc,3VkHkmOtom3jM2wCu94xgzzu1d6Dn7or,13,15,4,5,4,6,6,1,41,5.857142857142857,1,0.0,6,4,5,4,9,6,0,6,1,19,22,1
18271,168073,qxM3np03v0HLILLQ0O4ivkrRKIURuEyI,3VkHkmOtom3jM2wCu94xgzzu1d6Dn7or,1,0,0,0,0,0,1,0,1,0.14285714285714285,1,0.0,0,0,0,0,0,0,0,1,0,0,1,0
18272,168075,C06Ud48QDIYOx7TH16k0jctmZ3ytNfUL,3VkHkmOtom3jM2wCu94xgzzu1d6Dn7or,3,2,1,0,0,1,2,0,6,0.8571428571428571,1,0.0,0,1,0,0,2,1,0,2,0,1,5,1
18273,168081,X8G5fdVVuPNoIiQKh4Ql7xFEGqHtVJdj,3VkHkmOtom3jM2wCu94xgzzu1d6Dn7or,9,6,3,0,2,1,5,1,18,2.5714285714285716,1,0.0,1,3,0,2,5,1,0,5,1,6,12,1
18274,168083,eRwAFWCpqN9m5JKZkkSIBHjyWcmU0NBC,3VkHkmOtom3jM2wCu94xgzzu1d6Dn7or,8,4,2,0,2,0,6,0,14,2.0,1,0.0,1,2,0,2,3,0,0,6,0,5,9,1
18275,168084,gja6YDDPL23ymxplMJ54bjIUaxr2GJww,3VkHkmOtom3jM2wCu94xgzzu1d6Dn7or,1,0,0,0,0,0,1,0,1,0.14285714285714285,1,0.0,0,0,0,0,0,0,0,1,0,0,1,1
18276,168086,vIZn10kjlyTUVoHhXIJOQucbfcLECr3W,3VkHkmOtom3jM2wCu94xgzzu1d6Dn7or,1,0,0,0,0,0,1,0,1,0.14285714285714285,1,0.0,0,0,0,0,0,0,0,1,0,0,1,1
18277,168090,bEF1Fjv4hCvZiIgEMiMXXPgFMz45YnrU,3VkHkmOtom3jM2wCu94xgzzu1d6Dn7or,1,0,0,0,0,0,1,0,1,0.14285714285714285,1,0.0,0,0,0,0,0,0,0,1,0,0,1,1
18278,168093,zwovE2UaujWuziUcUkYkqCQmn4CoHvRg,3VkHkmOtom3jM2wCu94xgzzu1d6Dn7or,5,15,3,0,1,0,5,0,24,3.4285714285714284,3,0.0,6,3,0,1,9,0,0,5,0,10,14,0
18279,168095,FR5tV9pEC96uXG4YgIIydXwP3bvsMqeW,3VkHkmOtom3jM2wCu94xgzzu1d6Dn7or,1,0,0,0,0,0,1,0,1,0.14285714285714285,1,0.0,0,0,0,0,0,0,0,1,0,0,1,1
18280,168097,3rhZjtaGSRI9L4woS8aldfdcClzzHTms,3VkHkmOtom3jM2wCu94xgzzu1d6Dn7or,17,35,11,9,10,10,14,1,90,12.857142857142858,1,0.0,16,11,7,10,19,10,2,14,1,44,46,1
18281,168098,YFhxdgCv825lGNZgMqxJBBxsVK16uCWj,3VkHkmOtom3jM2wCu94xgzzu1d6Dn7or,1,0,0,0,0,0,1,0,1,0.14285714285714285,1,0.0,0,0,0,0,0,0,0,1,0,0,1,1
18282,168100,DBSkznK5g5GyJVMJBIMHvO8oMI18vDSt,3VkHkmOtom3jM2wCu94xgzzu1d6Dn7or,6,4,2,0,1,2,3,0,12,1.7142857142857142,1,0.0,0,2,0,1,4,2,0,3,0,3,9,1
18283,168107,Ox6nN4HiRipUWxmVCBCPlVELFdZUFRfc,3VkHkmOtom3jM2wCu94xgzzu1d6Dn7or,1,0,0,0,0,0,2,0,2,0.2857142857142857,1,0.0,0,0,0,0,0,0,0,2,0,0,2,1
18284,168110,6sGUhPoisOkT2lXHT8neZ8zYn2yneVpQ,3VkHkmOtom3jM2wCu94xgzzu1d6Dn7or,16,23,9,16,10,4,13,4,79,11.285714285714286,2,0.0,12,9,12,10,11,4,4,13,4,43,36,1
18285,168115,BCBD5gR7OPhkrIrwv07fYZ8qI8lOiKfh,3VkHkmOtom3jM2wCu94xgzzu1d6Dn7or,5,3,1,0,1,0,2,0,7,1.0,1,0.0,1,1,0,1,2,0,0,2,0,3,4,1
18286,168120,MjvRR6RwQrwPwA7GzMV5Yj7dhQX7Hhlc,3VkHkmOtom3jM2wCu94xgzzu1d6Dn7or,7,5,3,0,1,0,6,0,15,2.142857142857143,1,0.0,0,3,0,1,5,0,0,6,0,4,11,1
18287,168121,6dTqxIFVnVmNgJwbnUg7wwmRvmNmw63p,3VkHkmOtom3jM2wCu94xgzzu1d6Dn7or,1,0,0,0,0,0,3,0,3,0.42857142857142855,2,0.0,0,0,0,0,0,0,0,3,0,0,3,1
18288,168132,IgexhZ9xriCDdGfY04wPYqqhzLtdPh8J,3VkHkmOtom3jM2wCu94xgzzu1d6Dn7or,4,2,1,0,1,0,1,0,5,0.7142857142857143,1,0.0,0,1,0,1,2,0,0,1,0,2,3,1
18289,168134,89QHMWhXsxXRliuaCUUwCtuK3CRrIyHu,3VkHkmOtom3jM2wCu94xgzzu1d6Dn7or,4,3,0,0,1,0,1,0,5,0.7142857142857143,1,0.0,0,0,0,1,3,0,0,1,0,1,4,1
18290,168136,HjEi0gkLp3inXyNF6Iip7gKrjiv5W7sn,3VkHkmOtom3jM2wCu94xgzzu1d6Dn7or,4,2,1,0,1,0,1,0,5,0.7142857142857143,1,0.0,0,1,0,1,2,0,0,1,0,2,3,1
18291,168137,GmLvsHRNVBLlsqFG2X5F2zo5DCtQqyMZ,3VkHkmOtom3jM2wCu94xgzzu1d6Dn7or,28,36,23,33,16,18,5,0,131,18.714285714285715,1,0.0,9,23,25,16,27,18,8,5,0,73,58,1
18292,168139,shc7uF4KqbgQOwuvfxvtyeDkoT0qwCL8,3VkHkmOtom3jM2wCu94xgzzu1d6Dn7or,5,5,2,0,1,2,2,0,12,1.7142857142857142,1,0.0,0,2,0,1,5,2,0,2,0,3,9,1
18293,168143,PKw8c6ORRRQTFuJkbH1BpRyfxkDFNvqA,3VkHkmOtom3jM2wCu94xgzzu1d6Dn7or,3,0,0,0,0,0,6,0,6,0.8571428571428571,1,0.0,0,0,0,0,0,0,0,6,0,0,6,1
18294,168148,O52kxKMXNR07VQE3q6LCLzHeQQgosJva,3VkHkmOtom3jM2wCu94xgzzu1d6Dn7or,5,3,2,0,2,0,2,0,9,1.2857142857142858,1,0.0,0,2,0,2,3,0,0,2,0,4,5,1
18295,168149,luBkIXZ29F78l8NfQh7jHzsnHIHWT9U3,3VkHkmOtom3jM2wCu94xgzzu1d6Dn7or,1,0,0,0,0,0,1,0,1,0.14285714285714285,1,0.0,0,0,0,0,0,0,0,1,0,0,1,1
18296,168150,9OIaKMciRYSBKojjJkSVxRY14rxnAGm9,3VkHkmOtom3jM2wCu94xgzzu1d6Dn7or,1,0,0,0,0,0,1,0,1,0.14285714285714285,1,0.0,0,0,0,0,0,0,0,1,0,0,1,1
18297,168153,klAUBDLmli7j7KhjhK35fgAxH41JA6QX,3VkHkmOtom3jM2wCu94xgzzu1d6Dn7or,1,0,0,0,0,0,1,0,1,0.14285714285714285,1,0.0,0,0,0,0,0,0,0,1,0,0,1,1
18298,168155,ARdFSWQ1GxaNn6PBNKVf6I4toWBTAKik,3VkHkmOtom3jM2wCu94xgzzu1d6Dn7or,6,4,1,0,1,1,3,0,10,1.4285714285714286,1,0.0,0,1,0,1,4,1,0,3,0,2,8,1
18299,168173,DOqW7ZgNB5RF5NBR6Owtbo9ht5tRzQN0,3VkHkmOtom3jM2wCu94xgzzu1d6Dn7or,1,0,0,0,0,0,1,0,1,0.14285714285714285,1,0.0,0,0,0,0,0,0,0,1,0,0,1,1
18300,169705,Qty87BeKrf3ZgzVA2PT9rBe28vADAPbJ,fbPkOYLVPtPgIt0MxizjfFJov3JbHyAi,1,0,0,0,0,0,2,0,2,0.2857142857142857,2,0.0,0,0,0,0,0,0,0,2,0,0,2,1
18301,169706,fOakfJTYCPFebY0FybXtYL6idxxEyzTF,fbPkOYLVPtPgIt0MxizjfFJov3JbHyAi,1,0,0,0,0,0,1,0,1,0.14285714285714285,1,0.0,0,0,0,0,0,0,0,1,0,0,1,1
18302,169707,nLrM8vScjpmrQXQxsgmVq01jtpvffZ5f,fbPkOYLVPtPgIt0MxizjfFJov3JbHyAi,15,14,10,0,10,16,22,4,76,10.857142857142858,2,0.0,4,10,0,10,10,16,0,22,4,24,52,1
18303,169708,vjQXzrFvLaQwZyfHQ9fXD06sgIXRTXIb,fbPkOYLVPtPgIt0MxizjfFJov3JbHyAi,7,3,3,0,0,2,5,0,13,1.8571428571428572,1,0.0,0,3,0,0,3,2,0,5,0,3,10,1
18304,169710,bJL1sGEdg6Wyh9EeL6PIHUn7Crptl1QG,fbPkOYLVPtPgIt0MxizjfFJov3JbHyAi,1,0,0,0,0,0,1,0,1,0.14285714285714285,1,0.0,0,0,0,0,0,0,0,1,0,0,1,1
18305,169713,pyfZ41TFTxhSHzDt2S7t9VZz1MMWuxRA,fbPkOYLVPtPgIt0MxizjfFJov3JbHyAi,5,2,1,0,1,0,6,0,10,1.4285714285714286,1,0.0,0,1,0,1,2,0,0,6,0,2,8,1
18306,169714,PRN4T27S0Ed1KQDhQvjLLGSSAs9PlL8U,fbPkOYLVPtPgIt0MxizjfFJov3JbHyAi,5,0,0,0,0,2,5,1,8,1.1428571428571428,1,0.0,0,0,0,0,0,2,0,5,1,0,8,1
18307,169716,sFNhRUf2M3OzBPb8K2dNpryYFfLRe3zg,fbPkOYLVPtPgIt0MxizjfFJov3JbHyAi,1,0,0,0,0,0,1,0,1,0.14285714285714285,1,0.0,0,0,0,0,0,0,0,1,0,0,1,1
18308,169720,dMZ9S55l3tq5M3A71U0KoWxXWAhXsFH4,fbPkOYLVPtPgIt0MxizjfFJov3JbHyAi,5,2,1,0,1,0,2,0,6,0.8571428571428571,1,0.0,0,1,0,1,2,0,0,2,0,2,4,1
18309,169724,e3UIGG7UQFKXGRFOxu4N5schAIY0VK0V,fbPkOYLVPtPgIt0MxizjfFJov3JbHyAi,16,8,7,0,7,0,1,0,23,3.2857142857142856,1,0.0,0,7,0,7,8,0,0,1,0,14,9,1
18310,169725,udxFfabXtaVUvVlT3wEleIvfDBGe9yE2,fbPkOYLVPtPgIt0MxizjfFJov3JbHyAi,8,5,3,0,2,0,4,0,14,2.0,2,0.0,0,3,0,2,5,0,0,4,0,5,9,1
18311,169726,Jz6wD2B02Np9coR4hOXdRVlsstbtLmqi,fbPkOYLVPtPgIt0MxizjfFJov3JbHyAi,1,0,0,0,0,0,1,0,1,0.14285714285714285,1,0.0,0,0,0,0,0,0,0,1,0,0,1,1
18312,169727,C3Pi5p6u9Sqfn49wxkMeoM5LROfgAWhp,fbPkOYLVPtPgIt0MxizjfFJov3JbHyAi,1,0,0,0,0,0,1,0,1,0.14285714285714285,1,0.0,0,0,0,0,0,0,0,1,0,0,1,1
18313,169728,HNHPAxeVn8lGduUI2P4q9tnmqhZb68Gj,fbPkOYLVPtPgIt0MxizjfFJov3JbHyAi,1,0,0,0,0,0,1,0,1,0.14285714285714285,1,0.0,0,0,0,0,0,0,0,1,0,0,1,1
18314,169730,DU0dRtEpZksA4ySXAez5UVn9g5rHoTAA,fbPkOYLVPtPgIt0MxizjfFJov3JbHyAi,7,4,2,0,2,0,3,0,11,1.5714285714285714,1,0.0,0,2,0,2,4,0,0,3,0,4,7,1
18315,169731,yOmriI6ep4L8AeXfk2CRItQ1EOEJgSeE,fbPkOYLVPtPgIt0MxizjfFJov3JbHyAi,7,4,3,0,3,0,2,0,12,1.7142857142857142,1,0.0,0,3,0,3,4,0,0,2,0,6,6,1
18316,169735,5IM8g7YMOYo5qH7Yu3x31T3JkVOH9iqe,7GRhBDsirIGkRZBtSMEzNTyDr2JQm4xx,5,2,1,0,1,0,2,0,6,0.8571428571428571,2,0.0,0,1,0,1,2,0,0,2,0,2,4,1
18317,169744,OvyzBsMeHykQgpohtqeEozx2gUjeaz4W,SpATywNh6bZuzm8s1ceuBUnMUAeoAHHw,1,0,0,0,0,0,1,0,1,0.14285714285714285,1,0.0,0,0,0,0,0,0,0,1,0,0,1,1
18318,169748,y2Rnds9c7epbZfY5NmTcovxVs1C2E7IV,bWdj2GDclj5ofokWjzoa5jAwMkxCykd6,8,8,5,0,3,0,7,0,23,3.2857142857142856,1,0.0,0,5,0,3,8,0,0,7,0,8,15,1
18319,169756,nq8bR2L0RLlBhmbma1mjdqiNKrD7Hg6k,SpATywNh6bZuzm8s1ceuBUnMUAeoAHHw,13,5,4,0,4,0,4,1,18,2.5714285714285716,1,0.0,0,4,0,4,5,0,0,4,1,8,10,1
18320,169772,l1rg3D8Gp1lv7dbBBYKvzTS3OZ5DRjWH,A3fsA9Zfv1X2fVEQhTw51lKENdNrEqT3,7,11,3,0,1,0,3,0,18,2.5714285714285716,3,0.0,0,3,0,1,11,0,0,3,0,4,14,1
18321,169794,cylVpn6BHNf8kPweB7o4j0HSX2fVNwi5,A3fsA9Zfv1X2fVEQhTw51lKENdNrEqT3,4,2,1,0,0,0,2,0,5,0.7142857142857143,1,0.0,0,1,0,0,2,0,0,2,0,1,4,1
18322,169795,FccHEWO9KmdNPDXhN4XXwGkY9yUcoH8v,SpATywNh6bZuzm8s1ceuBUnMUAeoAHHw,5,4,2,0,1,0,1,0,8,1.1428571428571428,1,0.0,1,2,0,1,3,0,0,1,0,4,4,1
18323,169800,g3902agYIRHzac78MKVZlvljLMXXNpQ7,7GRhBDsirIGkRZBtSMEzNTyDr2JQm4xx,10,7,4,4,2,0,6,0,23,3.2857142857142856,1,0.0,1,4,4,2,6,0,0,6,0,11,12,1
18324,169809,nq8bR2L0RLlBhmbma1mjdqiNKrD7Hg6k,A3fsA9Zfv1X2fVEQhTw51lKENdNrEqT3,1,0,0,0,0,0,1,0,1,0.14285714285714285,1,0.0,0,0,0,0,0,0,0,1,0,0,1,1
18325,169829,6GeExq2Om9NgCQlFWmX6OmXCDvqcKYNs,SpATywNh6bZuzm8s1ceuBUnMUAeoAHHw,1,0,0,0,0,0,1,0,1,0.14285714285714285,1,0.0,0,0,0,0,0,0,0,1,0,0,1,1
18326,169865,FUKsUHV3URSaK57Jrek7EonPjAGWSjXW,7GRhBDsirIGkRZBtSMEzNTyDr2JQm4xx,3,2,1,0,0,0,2,0,5,0.7142857142857143,1,0.0,0,1,0,0,2,0,0,2,0,1,4,1
18327,169875,lHbmOzIWgsm3PCeLav5Cu1g7w64ZHBaT,A3fsA9Zfv1X2fVEQhTw51lKENdNrEqT3,2,0,0,0,0,0,2,0,2,0.2857142857142857,1,0.0,0,0,0,0,0,0,0,2,0,0,2,1
18328,169881,WuM67GwQW9M3d1mnuGHuvAdo907S9qb5,RXDvfPUBYFlVdlueBFbLW0mhhAyGEqpt,1,0,0,0,0,0,1,0,1,0.14285714285714285,1,0.0,0,0,0,0,0,0,0,1,0,0,1,1
18329,169883,9d8tCYKPfh5NHPKNlwRKmrZh3Cuf1Ls2,5X6FeZozNMgE2VRi3MJYjkkFK8SETtu2,5,2,1,0,1,0,2,0,6,0.8571428571428571,1,0.0,0,1,0,1,2,0,0,2,0,2,4,1
18330,169885,BSj3AAnB5ipEkdnoMrRkK2tTYOV9mAFC,7GRhBDsirIGkRZBtSMEzNTyDr2JQm4xx,9,9,3,4,1,2,5,0,24,3.4285714285714284,2,0.0,2,3,3,1,7,2,1,5,0,9,15,1
18331,169911,2j6SiYhVaWD27toQPxUbfR6IzUCgWGsO,7GRhBDsirIGkRZBtSMEzNTyDr2JQm4xx,1,0,0,0,0,0,1,0,1,0.14285714285714285,1,0.0,0,0,0,0,0,0,0,1,0,0,1,1
18332,169914,EX4mN8VqjmDrg8vjZaJJar6Z7qHJihO0,SpATywNh6bZuzm8s1ceuBUnMUAeoAHHw,45,53,29,41,16,1,14,1,155,22.142857142857142,3,0.0,15,29,40,16,38,1,1,14,1,100,55,0
18333,169917,yFXHvM6fTTugrF5MDphTCRW2RH58bXB8,SpATywNh6bZuzm8s1ceuBUnMUAeoAHHw,1,0,0,0,0,0,1,0,1,0.14285714285714285,1,0.0,0,0,0,0,0,0,0,1,0,0,1,1
18334,169931,pNxzaJ7czZs2paRXphWc0CFfqptKuUuk,SpATywNh6bZuzm8s1ceuBUnMUAeoAHHw,2,0,0,0,0,0,2,0,2,0.2857142857142857,1,0.0,0,0,0,0,0,0,0,2,0,0,2,1
18335,169937,0pwRthAyOuKJqUTbZQ5B9PuHR9GODfUb,bWdj2GDclj5ofokWjzoa5jAwMkxCykd6,2,0,0,0,0,0,2,0,2,0.2857142857142857,1,0.0,0,0,0,0,0,0,0,2,0,0,2,1
18336,169938,Im85u8aENweba95uFnFOR6zdQWFnfDOq,SpATywNh6bZuzm8s1ceuBUnMUAeoAHHw,12,20,12,0,9,0,5,0,46,6.571428571428571,2,0.0,0,12,0,9,20,0,0,5,0,21,25,0
18337,169940,psOlazQpS8qVFhUihS96dMxKvzvfbEdG,SpATywNh6bZuzm8s1ceuBUnMUAeoAHHw,1,0,0,0,0,0,1,0,1,0.14285714285714285,1,0.0,0,0,0,0,0,0,0,1,0,0,1,1
18338,169943,BLyKMpisIDss4MmDNKRytNOAQZEOycAU,7GRhBDsirIGkRZBtSMEzNTyDr2JQm4xx,1,0,0,0,0,0,1,0,1,0.14285714285714285,1,0.0,0,0,0,0,0,0,0,1,0,0,1,1
18339,169955,ZQcqpVyhrZVshH7yyuAn3ze3B9JEoNBU,SpATywNh6bZuzm8s1ceuBUnMUAeoAHHw,1,0,0,0,0,0,2,0,2,0.2857142857142857,2,0.0,0,0,0,0,0,0,0,2,0,0,2,1
18340,169959,YiYJ3RnpzhhfakeMA3KKlM5DPKZuE0U2,A3fsA9Zfv1X2fVEQhTw51lKENdNrEqT3,2,0,0,0,0,0,2,0,2,0.2857142857142857,1,0.0,0,0,0,0,0,0,0,2,0,0,2,1
18341,169970,8TgDXDhPJbH42a4mgSX8yE2cBRK4rk9E,A3fsA9Zfv1X2fVEQhTw51lKENdNrEqT3,8,11,4,0,2,0,1,0,18,2.5714285714285716,1,0.0,0,4,0,2,11,0,0,1,0,6,12,1
18342,169971,bNG7kJA3jy4DW8PDzMNAT9OoyHwhutqS,7GRhBDsirIGkRZBtSMEzNTyDr2JQm4xx,3,2,1,0,0,0,1,0,4,0.5714285714285714,1,0.0,0,1,0,0,2,0,0,1,0,1,3,1
18343,169972,nd6FN1uteQdMlgn7WFsm0cYOCn3qlNSp,5X6FeZozNMgE2VRi3MJYjkkFK8SETtu2,8,14,7,0,0,0,2,0,23,3.2857142857142856,1,0.0,2,7,0,0,12,0,0,2,0,9,14,1
18344,169973,CaAAtghbZXcO6X5eGK5X6sBmcGDS3kOP,SpATywNh6bZuzm8s1ceuBUnMUAeoAHHw,6,3,2,0,1,0,2,0,8,1.1428571428571428,1,0.0,0,2,0,1,3,0,0,2,0,3,5,0
18345,169974,ENwYZFktafF6DBkaetRsi3gHPfNB3tq4,A3fsA9Zfv1X2fVEQhTw51lKENdNrEqT3,9,5,0,0,0,1,14,1,21,3.0,1,0.0,0,0,0,0,5,1,0,14,1,0,21,1
18346,169975,ENwYZFktafF6DBkaetRsi3gHPfNB3tq4,SpATywNh6bZuzm8s1ceuBUnMUAeoAHHw,1,0,0,0,0,0,1,0,1,0.14285714285714285,1,0.0,0,0,0,0,0,0,0,1,0,0,1,1
18347,169983,0HWrPPCNu1lUYotaev8lq3oZQkQoCkpc,SpATywNh6bZuzm8s1ceuBUnMUAeoAHHw,9,14,1,0,0,0,3,0,18,2.5714285714285716,2,0.0,5,1,0,0,9,0,0,3,0,6,12,1
18348,169991,nd6FN1uteQdMlgn7WFsm0cYOCn3qlNSp,RXDvfPUBYFlVdlueBFbLW0mhhAyGEqpt,1,0,0,0,0,0,1,0,1,0.14285714285714285,1,0.0,0,0,0,0,0,0,0,1,0,0,1,1
18349,169992,efMhgnP3jiriRpyWL0XFnZyh43mtSTkz,A3fsA9Zfv1X2fVEQhTw51lKENdNrEqT3,8,5,4,0,4,0,2,0,15,2.142857142857143,1,0.0,0,4,0,4,5,0,0,2,0,8,7,1
18350,170003,DcKXSEeQ89ZeT8g7MRCe0oPVKpSmR5Hy,SpATywNh6bZuzm8s1ceuBUnMUAeoAHHw,9,8,4,0,3,0,3,0,18,2.5714285714285716,1,0.0,0,4,0,3,8,0,0,3,0,7,11,1
18351,170009,c1BXmJNemroOPh6WUefTBD28s2WzSNwi,bWdj2GDclj5ofokWjzoa5jAwMkxCykd6,1,0,0,0,0,0,1,0,1,0.14285714285714285,1,0.0,0,0,0,0,0,0,0,1,0,0,1,1
18352,170012,qNeNwZ0RiirpZr2svt3nSu4cMQA6rxfD,SpATywNh6bZuzm8s1ceuBUnMUAeoAHHw,1,0,0,0,0,0,1,0,1,0.14285714285714285,1,0.0,0,0,0,0,0,0,0,1,0,0,1,1
18353,170020,nVB1o73xluQXZjoI2dUYHGxbCDG8qiCL,7GRhBDsirIGkRZBtSMEzNTyDr2JQm4xx,5,2,1,0,1,0,10,0,14,2.0,3,0.0,0,1,0,1,2,0,0,10,0,2,12,1
18354,170022,nVB1o73xluQXZjoI2dUYHGxbCDG8qiCL,bWdj2GDclj5ofokWjzoa5jAwMkxCykd6,1,0,0,0,0,0,2,0,2,0.2857142857142857,2,0.0,0,0,0,0,0,0,0,2,0,0,2,1
18355,170025,nVB1o73xluQXZjoI2dUYHGxbCDG8qiCL,G8EPVSXsOYB5YQWZGiz1aVq5Pgr2GrQu,1,0,0,0,0,0,2,0,2,0.2857142857142857,2,0.0,0,0,0,0,0,0,0,2,0,0,2,1
18356,170032,GlWFWKrBQhsgqjbmoDsRUa17h8chqAsd,G8EPVSXsOYB5YQWZGiz1aVq5Pgr2GrQu,12,10,4,14,3,0,3,0,34,4.857142857142857,2,0.0,3,4,11,3,7,0,3,3,0,21,13,1
18357,170036,qzripbhm6sAPdZP3rld8n0avyAjcFNv4,SpATywNh6bZuzm8s1ceuBUnMUAeoAHHw,33,60,0,39,0,3,12,1,115,16.428571428571427,1,0.0,15,0,36,0,45,3,3,12,1,51,64,0
18358,170040,qqtHlVJpcH8uxc5327KA4fBoZNP0U5Xd,7GRhBDsirIGkRZBtSMEzNTyDr2JQm4xx,6,4,3,0,0,0,2,0,9,1.2857142857142858,1,0.0,0,3,0,0,4,0,0,2,0,3,6,1
18359,170044,lfES8Qg22nHD1A4W64dBxO7ocyuixyz5,A3fsA9Zfv1X2fVEQhTw51lKENdNrEqT3,4,4,0,0,0,0,2,0,6,0.8571428571428571,1,0.0,0,0,0,0,4,0,0,2,0,0,6,1
18360,170048,doHdEOs0q82jLy28L6Hfv3zDwo9QjYO3,RXDvfPUBYFlVdlueBFbLW0mhhAyGEqpt,37,19,10,94,3,0,3,0,129,18.428571428571427,1,0.0,8,10,84,3,11,0,10,3,0,105,24,1
18361,170052,0BZoLcfKf9byPVgIWe4JIdaHfKcl2a1l,SpATywNh6bZuzm8s1ceuBUnMUAeoAHHw,4,3,1,0,0,1,3,0,8,1.1428571428571428,1,0.0,0,1,0,0,3,1,0,3,0,1,7,1
18362,170061,tfoakS3EMOjWuYWNRSgWZTjBxe3Mf9Te,7GRhBDsirIGkRZBtSMEzNTyDr2JQm4xx,1,0,0,0,0,0,1,0,1,0.14285714285714285,1,0.0,0,0,0,0,0,0,0,1,0,0,1,1
18363,170067,eID9376EiTPMkaHLktJPJzqn752gqP8g,SpATywNh6bZuzm8s1ceuBUnMUAeoAHHw,1,0,0,0,0,0,1,0,1,0.14285714285714285,1,0.0,0,0,0,0,0,0,0,1,0,0,1,1
18364,170074,kVKn79Dzw2HLlceEVegtxNVWxEZTMxtD,SpATywNh6bZuzm8s1ceuBUnMUAeoAHHw,1,0,0,0,0,0,1,0,1,0.14285714285714285,1,0.0,0,0,0,0,0,0,0,1,0,0,1,1
18365,170075,nmifCUUA8im6jjkFk86bK5knz02SLRlN,7GRhBDsirIGkRZBtSMEzNTyDr2JQm4xx,7,4,2,0,2,0,2,0,10,1.4285714285714286,1,0.0,0,2,0,2,4,0,0,2,0,4,6,1
18366,170099,eswvbpHhxCUZC3kUIoEHkNpn6ukXHFpo,bWdj2GDclj5ofokWjzoa5jAwMkxCykd6,9,4,2,0,1,1,6,1,15,2.142857142857143,1,0.0,0,2,0,1,4,1,0,6,1,3,12,1
18367,170100,R0iGmWkfHC0JwSUufNxBJOtu3BmW7cey,7GRhBDsirIGkRZBtSMEzNTyDr2JQm4xx,10,21,6,0,4,2,3,0,36,5.142857142857143,1,0.0,13,6,0,4,8,2,0,3,0,23,13,1
18368,170112,eswvbpHhxCUZC3kUIoEHkNpn6ukXHFpo,A3fsA9Zfv1X2fVEQhTw51lKENdNrEqT3,1,0,0,0,0,0,1,0,1,0.14285714285714285,1,0.0,0,0,0,0,0,0,0,1,0,0,1,1
18369,170118,OqGnqzQVMnpIm866A4pewjS1mh1kb791,SpATywNh6bZuzm8s1ceuBUnMUAeoAHHw,12,7,5,0,4,0,2,0,18,2.5714285714285716,1,0.0,0,5,0,4,7,0,0,2,0,9,9,1
18370,170119,cnn74KELZnn17sK4hLaiUHoOBX1WWhRX,SpATywNh6bZuzm8s1ceuBUnMUAeoAHHw,5,2,1,0,1,0,2,0,6,0.8571428571428571,1,0.0,0,1,0,1,2,0,0,2,0,2,4,1
18371,170123,qzE4xRGg4xgP1uXuFdpBCVtFm7DMRWEv,RXDvfPUBYFlVdlueBFbLW0mhhAyGEqpt,1,0,0,0,0,0,1,0,1,0.14285714285714285,1,0.0,0,0,0,0,0,0,0,1,0,0,1,1
18372,170139,pX6AUa5JIwjW9c9ABN9fhrsE8rh9KfQD,A3fsA9Zfv1X2fVEQhTw51lKENdNrEqT3,3,2,0,0,0,0,2,0,4,0.5714285714285714,1,0.0,0,0,0,0,2,0,0,2,0,0,4,1
18373,170144,9usGYeWOVibHFz0rEL6E7CP6Ct5S1DH0,SpATywNh6bZuzm8s1ceuBUnMUAeoAHHw,21,35,11,26,6,19,6,1,104,14.857142857142858,1,0.0,21,11,21,6,14,19,5,6,1,59,45,0
18374,170185,xsymAvmYlqD9inxrUoE03K3fiSLIg6Ue,G8EPVSXsOYB5YQWZGiz1aVq5Pgr2GrQu,12,4,3,10,1,0,3,0,21,3.0,1,0.0,0,3,10,1,4,0,0,3,0,14,7,1
18375,170191,jmLTCTXsN9WLVzoZhDc3zVaQMsxr0zEd,SpATywNh6bZuzm8s1ceuBUnMUAeoAHHw,2,0,0,0,0,0,2,0,2,0.2857142857142857,1,0.0,0,0,0,0,0,0,0,2,0,0,2,1
18376,170195,4EXVYteC2ptv9b4cBjlMiXkbTqF5aUrJ,bWdj2GDclj5ofokWjzoa5jAwMkxCykd6,8,17,9,0,7,0,6,0,39,5.571428571428571,2,0.0,0,9,0,7,17,0,0,6,0,16,23,0
18377,170199,xn7AAZAQcVYNGAzyVQ0EYGs1M3dKXdIP,5X6FeZozNMgE2VRi3MJYjkkFK8SETtu2,1,0,0,0,0,0,1,0,1,0.14285714285714285,1,0.0,0,0,0,0,0,0,0,1,0,0,1,1
18378,170205,mKHQM9iW9olu6z2WamdxK7ySH3UwX3JX,A3fsA9Zfv1X2fVEQhTw51lKENdNrEqT3,8,6,3,0,3,0,1,0,13,1.8571428571428572,1,0.0,0,3,0,3,6,0,0,1,0,6,7,1
18379,170206,mKHQM9iW9olu6z2WamdxK7ySH3UwX3JX,bWdj2GDclj5ofokWjzoa5jAwMkxCykd6,5,3,2,0,2,0,3,0,10,1.4285714285714286,2,0.0,0,2,0,2,3,0,0,3,0,4,6,1
18380,170210,aTjvPI2iFI189YCZUCxZxvdMjy8al9W5,bWdj2GDclj5ofokWjzoa5jAwMkxCykd6,6,3,1,0,1,3,3,1,12,1.7142857142857142,1,0.0,0,1,0,1,3,3,0,3,1,2,10,1
18381,170213,dRpHvWsltBuE4KgJgZUdCQKV5v7VQuHh,7GRhBDsirIGkRZBtSMEzNTyDr2JQm4xx,10,2,1,0,1,3,8,4,19,2.7142857142857144,1,0.0,0,1,0,1,2,3,0,8,4,2,17,1
18382,170214,HRAHfkJWDcqgd2I7oG554GqTRMzsGK4Y,SpATywNh6bZuzm8s1ceuBUnMUAeoAHHw,6,4,3,0,3,0,1,0,11,1.5714285714285714,1,0.0,0,3,0,3,4,0,0,1,0,6,5,1
18383,170217,YlkBfY3JYnCVTegjhYYLbUIucjxFlohz,SpATywNh6bZuzm8s1ceuBUnMUAeoAHHw,4,6,2,0,2,0,1,0,11,1.5714285714285714,1,0.0,0,2,0,2,6,0,0,1,0,4,7,1
18384,170232,b2YuB9tGGneJ6gHz59BSLslOC7EMmDny,5X6FeZozNMgE2VRi3MJYjkkFK8SETtu2,2,0,0,0,0,0,2,0,2,0.2857142857142857,1,0.0,0,0,0,0,0,0,0,2,0,0,2,1
18385,170237,2rkVSHJoohi3dFRGQS0yfCMFa6MXi3Zo,G8EPVSXsOYB5YQWZGiz1aVq5Pgr2GrQu,5,2,1,0,1,0,2,0,6,0.8571428571428571,1,0.0,0,1,0,1,2,0,0,2,0,2,4,0
18386,170244,GdGI6ZUeHNfDd16CDy7Y3YMvqdJfsIRh,7GRhBDsirIGkRZBtSMEzNTyDr2JQm4xx,1,0,0,0,0,0,2,0,2,0.2857142857142857,1,0.0,0,0,0,0,0,0,0,2,0,0,2,1
18387,170245,VXBTEalT0R9120bnGfzjxPXNZh5Vbgmq,SpATywNh6bZuzm8s1ceuBUnMUAeoAHHw,7,6,3,0,3,4,2,0,18,2.5714285714285716,1,0.0,1,3,0,3,5,4,0,2,0,7,11,1
18388,170247,vaWLVKWyrsUzDV0qs20ZUq8M3VNW01Uk,7GRhBDsirIGkRZBtSMEzNTyDr2JQm4xx,9,4,2,6,2,5,3,0,22,3.142857142857143,2,0.0,1,2,5,2,3,5,1,3,0,10,12,1
18389,170250,7jkKKf5Pb7FrtJ3WnuF11G7ePioUPJm3,bWdj2GDclj5ofokWjzoa5jAwMkxCykd6,9,9,4,8,2,1,2,0,26,3.7142857142857144,2,0.0,2,4,7,2,7,1,1,2,0,15,11,1
18390,170256,swwz7JrCk6SSVzLZGIACLItBCrSwx9u5,G8EPVSXsOYB5YQWZGiz1aVq5Pgr2GrQu,5,2,1,0,1,1,2,0,7,1.0,1,0.0,0,1,0,1,2,1,0,2,0,2,5,1
18391,170257,UYAHgDyJ2Tcd8fTB7PMLIt7CemKCJ2QW,SpATywNh6bZuzm8s1ceuBUnMUAeoAHHw,6,6,2,0,2,0,3,0,13,1.8571428571428572,2,0.0,0,2,0,2,6,0,0,3,0,4,9,0
18392,170261,UtDl3V8DNRzEFcwy9KRNynJ2PmttEbfZ,A3fsA9Zfv1X2fVEQhTw51lKENdNrEqT3,1,0,0,0,0,0,1,0,1,0.14285714285714285,1,0.0,0,0,0,0,0,0,0,1,0,0,1,1
18393,170262,RHsk3gHUm8VEfb9FwEFf8vBDNKZZ0LWe,bWdj2GDclj5ofokWjzoa5jAwMkxCykd6,42,58,35,118,22,19,20,1,273,39.0,4,0.0,13,35,92,22,45,19,26,20,1,162,111,0
18394,170267,fsa5eUp1FAxhAJPW5saWrncHzv3fRgY9,G8EPVSXsOYB5YQWZGiz1aVq5Pgr2GrQu,5,3,1,0,1,0,2,0,7,1.0,1,0.0,0,1,0,1,3,0,0,2,0,2,5,1
18395,170270,iLrqT1cSiRqHGveKnknegGGgRshrAyXQ,5X6FeZozNMgE2VRi3MJYjkkFK8SETtu2,1,0,0,0,0,0,1,0,1,0.14285714285714285,1,0.0,0,0,0,0,0,0,0,1,0,0,1,1
18396,170274,eb3SHueTE6ugnDkhYnh0RBSPDS20VwLZ,7GRhBDsirIGkRZBtSMEzNTyDr2JQm4xx,16,26,12,0,7,0,2,0,47,6.714285714285714,2,0.0,0,12,0,7,26,0,0,2,0,19,28,1
18397,170280,NCBu044YJ6cJynCHYXs0OvCxWHZI0vpq,G8EPVSXsOYB5YQWZGiz1aVq5Pgr2GrQu,26,27,1,42,1,0,6,0,77,11.0,1,0.0,10,1,30,1,17,0,12,6,0,42,35,1
18398,170284,3RtHMyLQOrBsDYp6yo5VYdmS72cr3PBJ,bWdj2GDclj5ofokWjzoa5jAwMkxCykd6,5,1,1,0,1,0,4,0,7,1.0,2,0.0,0,1,0,1,1,0,0,4,0,2,5,1
18399,170285,o56PfLr9PVlnT6N93Wz2ZLd3CTVky6be,5X6FeZozNMgE2VRi3MJYjkkFK8SETtu2,2,0,0,0,0,0,2,0,2,0.2857142857142857,1,0.0,0,0,0,0,0,0,0,2,0,0,2,1
18400,170289,X5lHw1AxbbdtGtMwcFokHHx0DhgrLuga,A3fsA9Zfv1X2fVEQhTw51lKENdNrEqT3,7,4,1,0,1,0,4,0,10,1.4285714285714286,1,0.0,0,1,0,1,4,0,0,4,0,2,8,1
18401,170292,Er5Dx1VYZA5KPMIiofLN6XXsRVBHZC9O,bWdj2GDclj5ofokWjzoa5jAwMkxCykd6,4,6,0,0,2,0,3,0,11,1.5714285714285714,1,0.0,4,0,0,2,2,0,0,3,0,6,5,1
18402,170296,wRbgPPUvYB6ZlrnmYszdH1VnMwMSKbo2,5X6FeZozNMgE2VRi3MJYjkkFK8SETtu2,7,14,4,0,3,1,3,0,25,3.5714285714285716,1,0.0,5,4,0,3,9,1,0,3,0,12,13,1
18403,170303,iUkHDNKZ4bOUlO8vGO6PBLpFErxQEC8i,G8EPVSXsOYB5YQWZGiz1aVq5Pgr2GrQu,11,8,3,0,3,2,12,1,29,4.142857142857143,2,0.0,4,3,0,3,4,2,0,12,1,10,19,1
18404,170306,Wx7ETkleaL3Fyykpu37NhlN4Ie0dZ7pu,SpATywNh6bZuzm8s1ceuBUnMUAeoAHHw,16,12,5,14,2,1,7,1,42,6.0,1,0.0,5,5,13,2,7,1,1,7,1,25,17,1
18405,170320,pqBs8sN0PT2UoBL7VKu89PIVTchItwDs,7GRhBDsirIGkRZBtSMEzNTyDr2JQm4xx,4,2,0,0,0,0,5,0,7,1.0,1,0.0,0,0,0,0,2,0,0,5,0,0,7,1
18406,170325,uQxbjtHxFoHot71DeFcBUm8Aql3Ydxlf,A3fsA9Zfv1X2fVEQhTw51lKENdNrEqT3,1,0,0,0,0,0,1,0,1,0.14285714285714285,1,0.0,0,0,0,0,0,0,0,1,0,0,1,1
18407,170328,rH2Cjv1VlyMXQ27h94dZK6rpepTfi6AT,G8EPVSXsOYB5YQWZGiz1aVq5Pgr2GrQu,6,4,1,0,1,0,3,0,9,1.2857142857142858,1,0.0,0,1,0,1,4,0,0,3,0,2,7,0
18408,170331,KPslRN2YAOypBl73zfwv2LjX4ZpoUZbN,SpATywNh6bZuzm8s1ceuBUnMUAeoAHHw,1,0,0,0,0,0,1,0,1,0.14285714285714285,1,0.0,0,0,0,0,0,0,0,1,0,0,1,1
18409,170335,FhVGWSUXUeZGSguiLBd186fsM4sRhpPL,5X6FeZozNMgE2VRi3MJYjkkFK8SETtu2,1,0,0,0,0,0,1,0,1,0.14285714285714285,1,0.0,0,0,0,0,0,0,0,1,0,0,1,1
18410,170336,evowo3Yg2sbVP9DdhhK3sw1dGIBBhaou,5X6FeZozNMgE2VRi3MJYjkkFK8SETtu2,4,2,1,0,0,0,3,0,6,0.8571428571428571,1,0.0,0,1,0,0,2,0,0,3,0,1,5,0
18411,170338,psMTfW7QvxtgOLRP4q0lNv6630lUr3rk,bWdj2GDclj5ofokWjzoa5jAwMkxCykd6,1,0,0,0,0,0,1,0,1,0.14285714285714285,1,0.0,0,0,0,0,0,0,0,1,0,0,1,1
18412,170340,psMTfW7QvxtgOLRP4q0lNv6630lUr3rk,G8EPVSXsOYB5YQWZGiz1aVq5Pgr2GrQu,1,0,0,0,0,0,2,0,2,0.2857142857142857,1,0.0,0,0,0,0,0,0,0,2,0,0,2,1
18413,170347,ung1DnQyYgd0tfz7mAKTwJrrm5UPHWt1,7GRhBDsirIGkRZBtSMEzNTyDr2JQm4xx,1,0,0,0,0,0,1,0,1,0.14285714285714285,1,0.0,0,0,0,0,0,0,0,1,0,0,1,1
18414,170354,ung1DnQyYgd0tfz7mAKTwJrrm5UPHWt1,5X6FeZozNMgE2VRi3MJYjkkFK8SETtu2,1,0,0,0,0,0,1,0,1,0.14285714285714285,1,0.0,0,0,0,0,0,0,0,1,0,0,1,1
18415,170355,ung1DnQyYgd0tfz7mAKTwJrrm5UPHWt1,bWdj2GDclj5ofokWjzoa5jAwMkxCykd6,1,0,0,0,0,0,1,0,1,0.14285714285714285,1,0.0,0,0,0,0,0,0,0,1,0,0,1,1
18416,170358,vaWLVKWyrsUzDV0qs20ZUq8M3VNW01Uk,5X6FeZozNMgE2VRi3MJYjkkFK8SETtu2,1,0,0,0,0,0,1,0,1,0.14285714285714285,1,0.0,0,0,0,0,0,0,0,1,0,0,1,1
18417,170366,6pDumvu8BZSGMSLuGPFtyDgiupPPSlqU,SpATywNh6bZuzm8s1ceuBUnMUAeoAHHw,2,0,0,0,0,0,2,0,2,0.2857142857142857,1,0.0,0,0,0,0,0,0,0,2,0,0,2,1
18418,170368,6pDumvu8BZSGMSLuGPFtyDgiupPPSlqU,A3fsA9Zfv1X2fVEQhTw51lKENdNrEqT3,1,0,0,0,0,0,1,0,1,0.14285714285714285,1,0.0,0,0,0,0,0,0,0,1,0,0,1,1
18419,170378,Wx7ETkleaL3Fyykpu37NhlN4Ie0dZ7pu,5X6FeZozNMgE2VRi3MJYjkkFK8SETtu2,1,0,0,0,0,0,1,0,1,0.14285714285714285,1,0.0,0,0,0,0,0,0,0,1,0,0,1,1
18420,170397,fW4fbh90nu73Q6G9ndiED1PUrE0wupYF,A3fsA9Zfv1X2fVEQhTw51lKENdNrEqT3,2,0,0,0,0,0,2,0,2,0.2857142857142857,1,0.0,0,0,0,0,0,0,0,2,0,0,2,1
18421,170400,qlV7NVEcCnAsxKC17kpoGCtCEpV1bUS5,A3fsA9Zfv1X2fVEQhTw51lKENdNrEqT3,11,4,3,0,3,3,8,0,21,3.0,2,0.0,0,3,0,3,4,3,0,8,0,6,15,1
18422,170402,XE3LSwpMCRZZGzcKtnVar50VzWsD5gVI,SpATywNh6bZuzm8s1ceuBUnMUAeoAHHw,12,18,3,0,4,0,6,0,31,4.428571428571429,2,0.0,0,3,0,4,18,0,0,6,0,7,24,1
18423,170403,TY1XSpzUxZYHUqU0tQYtstvuwKCsGYpR,SpATywNh6bZuzm8s1ceuBUnMUAeoAHHw,4,5,1,0,0,0,3,0,9,1.2857142857142858,2,0.0,0,1,0,0,5,0,0,3,0,1,8,1
18424,170411,QUAD8F1Sq1DKmhs6zkaRy7xSaSvEw9YZ,A3fsA9Zfv1X2fVEQhTw51lKENdNrEqT3,1,0,0,0,0,0,1,0,1,0.14285714285714285,1,0.0,0,0,0,0,0,0,0,1,0,0,1,1
18425,170412,Z6SakRvyvh7ZuaV4DHEE1b3QLOpPcfOm,SpATywNh6bZuzm8s1ceuBUnMUAeoAHHw,23,29,2,36,0,0,10,1,78,11.142857142857142,5,0.0,6,2,35,0,23,0,1,10,1,43,35,0
18426,170422,VvP04bcu30Fnz43GLgwdKHeQEInNAaGy,5X6FeZozNMgE2VRi3MJYjkkFK8SETtu2,1,0,0,0,0,0,1,0,1,0.14285714285714285,1,0.0,0,0,0,0,0,0,0,1,0,0,1,1
18427,170425,iKgnPLhvVQse7oL8jh4sOm9046t6sK9B,bWdj2GDclj5ofokWjzoa5jAwMkxCykd6,5,3,1,6,0,0,2,0,12,1.7142857142857142,1,0.0,1,1,6,0,2,0,0,2,0,8,4,1
18428,170426,2e7MDrs8EueOP7qJPm2dG8jdhtuWqNSF,5X6FeZozNMgE2VRi3MJYjkkFK8SETtu2,2,0,0,0,0,0,2,0,2,0.2857142857142857,1,0.0,0,0,0,0,0,0,0,2,0,0,2,1
18429,170430,ilUzpPaeFISeGNY7Nt0DehBLL3wxQX0O,SpATywNh6bZuzm8s1ceuBUnMUAeoAHHw,1,0,0,0,0,0,1,0,1,0.14285714285714285,1,0.0,0,0,0,0,0,0,0,1,0,0,1,1
18430,170432,CDy3wblikhG2TGdNI3LhbAglknKqeMeq,7GRhBDsirIGkRZBtSMEzNTyDr2JQm4xx,1,0,0,0,0,0,1,0,1,0.14285714285714285,1,0.0,0,0,0,0,0,0,0,1,0,0,1,1
18431,170433,CDy3wblikhG2TGdNI3LhbAglknKqeMeq,bWdj2GDclj5ofokWjzoa5jAwMkxCykd6,1,0,0,0,0,0,1,0,1,0.14285714285714285,1,0.0,0,0,0,0,0,0,0,1,0,0,1,1
18432,170434,CDy3wblikhG2TGdNI3LhbAglknKqeMeq,G8EPVSXsOYB5YQWZGiz1aVq5Pgr2GrQu,1,0,0,0,0,0,1,0,1,0.14285714285714285,1,0.0,0,0,0,0,0,0,0,1,0,0,1,0
18433,170458,DIfj5Ba2axfDE4LFDWqKjVBCgesW8XXW,A3fsA9Zfv1X2fVEQhTw51lKENdNrEqT3,10,18,5,0,3,0,5,0,31,4.428571428571429,3,0.0,0,5,0,3,18,0,0,5,0,8,23,1
18434,170460,m8tZWvMesr1zQS0esJJogsiMlXHxe2Cd,7GRhBDsirIGkRZBtSMEzNTyDr2JQm4xx,1,0,0,0,0,0,1,0,1,0.14285714285714285,1,0.0,0,0,0,0,0,0,0,1,0,0,1,1
18435,170462,dPRqQnPaOK2cLqC8FD45Cje7upJIkPFz,RXDvfPUBYFlVdlueBFbLW0mhhAyGEqpt,11,20,1,0,1,3,3,1,29,4.142857142857143,1,0.0,0,1,0,1,20,3,0,3,1,2,27,1
18436,170467,m8tZWvMesr1zQS0esJJogsiMlXHxe2Cd,RXDvfPUBYFlVdlueBFbLW0mhhAyGEqpt,1,0,0,0,0,0,1,0,1,0.14285714285714285,1,0.0,0,0,0,0,0,0,0,1,0,0,1,1
18437,170469,m8tZWvMesr1zQS0esJJogsiMlXHxe2Cd,A3fsA9Zfv1X2fVEQhTw51lKENdNrEqT3,1,0,0,0,0,0,1,0,1,0.14285714285714285,1,0.0,0,0,0,0,0,0,0,1,0,0,1,1
18438,170477,ClkySnys8q9iZwwIB1GHdIZUIZTYWQzy,SpATywNh6bZuzm8s1ceuBUnMUAeoAHHw,6,1,1,0,1,0,3,0,6,0.8571428571428571,1,0.0,0,1,0,1,1,0,0,3,0,2,4,1
18439,170481,QUAD8F1Sq1DKmhs6zkaRy7xSaSvEw9YZ,5X6FeZozNMgE2VRi3MJYjkkFK8SETtu2,6,5,0,4,1,0,4,2,16,2.2857142857142856,1,0.0,2,0,3,1,3,0,1,4,2,6,10,1
18440,170490,2H6KbsPWrpdsyjI0g4q0nnMN85W6it1n,7GRhBDsirIGkRZBtSMEzNTyDr2JQm4xx,1,0,0,0,0,0,1,0,1,0.14285714285714285,1,0.0,0,0,0,0,0,0,0,1,0,0,1,1
18441,170492,2H6KbsPWrpdsyjI0g4q0nnMN85W6it1n,RXDvfPUBYFlVdlueBFbLW0mhhAyGEqpt,1,0,0,0,0,0,1,0,1,0.14285714285714285,1,0.0,0,0,0,0,0,0,0,1,0,0,1,0
18442,170497,rujAdcRYDNcOdNAYamPPJcVCyaKAIiLP,SpATywNh6bZuzm8s1ceuBUnMUAeoAHHw,10,8,3,0,2,1,5,1,20,2.857142857142857,1,0.0,0,3,0,2,8,1,0,5,1,5,15,1
18443,170498,yjSLpu9rXQ5LHtGm8PnDgnJW6R5BYmgU,5X6FeZozNMgE2VRi3MJYjkkFK8SETtu2,1,0,0,0,0,0,1,0,1,0.14285714285714285,1,0.0,0,0,0,0,0,0,0,1,0,0,1,1
18444,170506,o4osOJvgQ93Ymu9ZCa30DQTnm2Hl0dnw,5X6FeZozNMgE2VRi3MJYjkkFK8SETtu2,4,3,1,0,0,0,2,0,6,0.8571428571428571,1,0.0,0,1,0,0,3,0,0,2,0,1,5,1
18445,170507,e7CJKTxK2fHzkKAqxRbF4w3Yx9Cc3hBw,SpATywNh6bZuzm8s1ceuBUnMUAeoAHHw,13,24,0,13,1,3,9,1,51,7.285714285714286,1,0.0,13,0,13,1,11,3,0,9,1,27,24,1
18446,170512,M66RbMOSrj4328MjTEjMdJ6THFVBTtut,SpATywNh6bZuzm8s1ceuBUnMUAeoAHHw,2,0,0,0,0,0,2,0,2,0.2857142857142857,1,0.0,0,0,0,0,0,0,0,2,0,0,2,1
18447,170516,ElX5Sy8TuzS1PFSnkh4VB3EIzoERGXU4,SpATywNh6bZuzm8s1ceuBUnMUAeoAHHw,1,0,0,0,0,0,1,0,1,0.14285714285714285,1,0.0,0,0,0,0,0,0,0,1,0,0,1,1
18448,170525,24VtpSEyjNziAqnGWNWJJAL3omRP6Ck7,SpATywNh6bZuzm8s1ceuBUnMUAeoAHHw,3,3,0,0,0,0,1,0,4,0.5714285714285714,1,0.0,0,0,0,0,3,0,0,1,0,0,4,1
18449,170536,AYoYqmMVts3Jos5MlcHwS4c0GaWIO0qr,A3fsA9Zfv1X2fVEQhTw51lKENdNrEqT3,5,0,0,0,0,0,6,0,6,0.8571428571428571,1,0.0,0,0,0,0,0,0,0,6,0,0,6,1
18450,170538,iw2Z0CZWwaxm4RYS9eYs4psAOivvGaBR,SpATywNh6bZuzm8s1ceuBUnMUAeoAHHw,6,3,1,0,1,0,2,0,7,1.0,1,0.0,0,1,0,1,3,0,0,2,0,2,5,1
18451,170554,NA7DOpQvJZlbMekjhpkQkPqGIPJQL8nu,bWdj2GDclj5ofokWjzoa5jAwMkxCykd6,1,0,0,0,0,0,1,0,1,0.14285714285714285,1,0.0,0,0,0,0,0,0,0,1,0,0,1,1
18452,170559,PwLIj6o8z5EIVeMRrdzlGP97RUwQ6OQA,A3fsA9Zfv1X2fVEQhTw51lKENdNrEqT3,5,2,1,0,1,0,3,0,7,1.0,1,0.0,0,1,0,1,2,0,0,3,0,2,5,1
18453,170569,67ART2vkl2t74M325EVjIJhRx1ejvS40,5X6FeZozNMgE2VRi3MJYjkkFK8SETtu2,4,2,1,0,1,0,1,0,5,0.7142857142857143,1,0.0,0,1,0,1,2,0,0,1,0,2,3,1
18454,170572,lyUyYIfExuGOGDXTlbgjuS96P5Iv4Fw9,SpATywNh6bZuzm8s1ceuBUnMUAeoAHHw,24,43,15,21,5,21,21,5,131,18.714285714285715,3,0.0,14,15,18,5,29,21,3,21,5,52,79,1
18455,170577,rIjZ3i5ppcr4GwVYuKGWcaMRKqUdWp8Z,SpATywNh6bZuzm8s1ceuBUnMUAeoAHHw,7,3,2,0,2,0,2,0,9,1.2857142857142858,1,0.0,0,2,0,2,3,0,0,2,0,4,5,1
18456,170590,0TVIMteBCisXYqQmhAVCzijts3EjTj9F,5X6FeZozNMgE2VRi3MJYjkkFK8SETtu2,8,4,1,6,2,0,3,1,17,2.4285714285714284,1,0.0,3,1,5,2,1,0,1,3,1,11,6,1
18457,170593,WNMY3WRE1kSjqqBi1gkUrP92tDh9JpnU,A3fsA9Zfv1X2fVEQhTw51lKENdNrEqT3,7,4,3,0,3,0,3,0,13,1.8571428571428572,1,0.0,0,3,0,3,4,0,0,3,0,6,7,1
18458,170600,9fVN74CosCSsezn8P3MpQSVmSGkY5xCm,SpATywNh6bZuzm8s1ceuBUnMUAeoAHHw,7,6,1,0,0,3,4,0,14,2.0,1,0.0,0,1,0,0,6,3,0,4,0,1,13,1
18459,170602,MH8MIbGRBOcwRh7o5KLXTJghF8Lfi17k,5X6FeZozNMgE2VRi3MJYjkkFK8SETtu2,12,15,2,6,3,2,8,1,37,5.285714285714286,1,0.0,6,2,6,3,9,2,0,8,1,17,20,1
18460,170603,Yg9hgHRSCdpITsjHOmkyqEwp1aNMC9ra,SpATywNh6bZuzm8s1ceuBUnMUAeoAHHw,1,0,0,0,0,0,1,0,1,0.14285714285714285,1,0.0,0,0,0,0,0,0,0,1,0,0,1,1
18461,170619,SSjJLhqPp3KtEjhygN5aGwtbWcKsJk4h,7GRhBDsirIGkRZBtSMEzNTyDr2JQm4xx,1,0,0,0,0,0,2,0,2,0.2857142857142857,1,0.0,0,0,0,0,0,0,0,2,0,0,2,1
18462,170630,BkFKNCSuaFkJKkL8VqeRPxKqLfFGSUAo,5X6FeZozNMgE2VRi3MJYjkkFK8SETtu2,7,3,2,0,2,0,2,0,9,1.2857142857142858,1,0.0,0,2,0,2,3,0,0,2,0,4,5,1
18463,170634,yNeIUKhEuJHTBsPD5kABjlBuASduqZHz,bWdj2GDclj5ofokWjzoa5jAwMkxCykd6,8,6,4,0,2,0,3,0,15,2.142857142857143,1,0.0,0,4,0,2,6,0,0,3,0,6,9,1
18464,170650,WJvUM8vrAZx3jP5SMFm1lAFz7l2iXld4,7GRhBDsirIGkRZBtSMEzNTyDr2JQm4xx,5,2,1,0,1,0,2,0,6,0.8571428571428571,1,0.0,0,1,0,1,2,0,0,2,0,2,4,1
18465,170655,o51Y4SLAGY9EUpnbYlzlny2aYMXKv66D,SpATywNh6bZuzm8s1ceuBUnMUAeoAHHw,2,0,0,0,0,0,2,0,2,0.2857142857142857,1,0.0,0,0,0,0,0,0,0,2,0,0,2,1
18466,170665,BzOMHXhy39ViSG5m80jlFY2Dylr0IW9h,RXDvfPUBYFlVdlueBFbLW0mhhAyGEqpt,1,0,0,0,0,0,1,0,1,0.14285714285714285,1,0.0,0,0,0,0,0,0,0,1,0,0,1,1
18467,170669,uxpPi5YjzalklY0lH8OBSyWxa4yOJr6b,bWdj2GDclj5ofokWjzoa5jAwMkxCykd6,1,0,0,0,0,0,1,0,1,0.14285714285714285,1,0.0,0,0,0,0,0,0,0,1,0,0,1,1
18468,170674,GfrMOiCcFGorw9y2zYLBWSI6Ij42MMT7,7GRhBDsirIGkRZBtSMEzNTyDr2JQm4xx,1,0,0,0,0,0,1,0,1,0.14285714285714285,1,0.0,0,0,0,0,0,0,0,1,0,0,1,1
18469,170681,cJJis1Eo88AzCRowxVa7rzvY4ZLonXwZ,A3fsA9Zfv1X2fVEQhTw51lKENdNrEqT3,10,4,1,0,1,5,13,1,25,3.5714285714285716,2,0.0,0,1,0,1,4,5,0,13,1,2,23,1
18470,170691,Hm7TJQq1vAhYsYwItY96s4Me02Vfs6zP,RXDvfPUBYFlVdlueBFbLW0mhhAyGEqpt,9,10,0,0,0,0,7,0,17,2.4285714285714284,1,0.0,0,0,0,0,10,0,0,7,0,0,17,1
18471,170692,Hm7TJQq1vAhYsYwItY96s4Me02Vfs6zP,7GRhBDsirIGkRZBtSMEzNTyDr2JQm4xx,1,0,0,0,0,0,1,0,1,0.14285714285714285,1,0.0,0,0,0,0,0,0,0,1,0,0,1,1
18472,170698,ZouOLIcJ3Tj5ZIpKyHpqXZhY7RgZvMZA,SpATywNh6bZuzm8s1ceuBUnMUAeoAHHw,6,3,1,0,1,0,2,0,7,1.0,1,0.0,0,1,0,1,3,0,0,2,0,2,5,1
18473,170699,vJzksHQIgTjsZcFPkhlyJTG6u9xDgpeq,5X6FeZozNMgE2VRi3MJYjkkFK8SETtu2,1,0,0,0,0,0,1,0,1,0.14285714285714285,1,0.0,0,0,0,0,0,0,0,1,0,0,1,1
18474,170708,T24fR7tLfvFk1dDcUZ1sfKSW4mn6QkuF,7GRhBDsirIGkRZBtSMEzNTyDr2JQm4xx,4,0,0,0,0,0,4,1,5,0.7142857142857143,1,0.0,0,0,0,0,0,0,0,4,1,0,5,1
18475,170712,MOumV4gnnC04de5uAKnQrbg5Oxg7krQz,7GRhBDsirIGkRZBtSMEzNTyDr2JQm4xx,1,0,0,0,0,0,1,0,1,0.14285714285714285,1,0.0,0,0,0,0,0,0,0,1,0,0,1,1
18476,170717,vgU7HjSSKESb53rYK6QCA7euO8AD5F4F,7GRhBDsirIGkRZBtSMEzNTyDr2JQm4xx,2,0,0,0,0,0,2,0,2,0.2857142857142857,1,0.0,0,0,0,0,0,0,0,2,0,0,2,1
18477,170721,7l0SAmotFhhGX3L1NZSrUuyNyYqkAHiK,7GRhBDsirIGkRZBtSMEzNTyDr2JQm4xx,1,0,0,0,0,0,1,0,1,0.14285714285714285,1,0.0,0,0,0,0,0,0,0,1,0,0,1,1
18478,170722,3AZPazkjjeT8Y1N7eVF61WlLjHIsm9tf,7GRhBDsirIGkRZBtSMEzNTyDr2JQm4xx,1,0,0,0,0,0,1,0,1,0.14285714285714285,1,0.0,0,0,0,0,0,0,0,1,0,0,1,1
18479,170731,wfEV62Pm9Lmqm4ea1Gm09tOY6g7FO2lH,7GRhBDsirIGkRZBtSMEzNTyDr2JQm4xx,2,0,0,0,0,0,2,0,2,0.2857142857142857,1,0.0,0,0,0,0,0,0,0,2,0,0,2,0
18480,170736,tRgtCcxMmOOOAHwv6NjcGkY1uP7qTVjb,7GRhBDsirIGkRZBtSMEzNTyDr2JQm4xx,1,0,0,0,0,0,1,0,1,0.14285714285714285,1,0.0,0,0,0,0,0,0,0,1,0,0,1,1
18481,170740,v6v1hayEEXofBruMyo9TZ2ggXeu5UD3T,7GRhBDsirIGkRZBtSMEzNTyDr2JQm4xx,1,0,0,0,0,0,1,0,1,0.14285714285714285,1,0.0,0,0,0,0,0,0,0,1,0,0,1,1
18482,170741,6wr6dBOxcvGA1j07rybem8uoLQOkR2xX,7GRhBDsirIGkRZBtSMEzNTyDr2JQm4xx,10,11,9,0,7,0,4,0,31,4.428571428571429,1,0.0,0,9,0,7,11,0,0,4,0,16,15,1
18483,170743,L2BBredG3CUlz8Grd7ibENxWG096di5u,7GRhBDsirIGkRZBtSMEzNTyDr2JQm4xx,3,0,0,0,0,0,3,0,3,0.42857142857142855,1,0.0,0,0,0,0,0,0,0,3,0,0,3,1
18484,170745,zAEo1mbhu0cLq63pob9NdFw47a0nIS3j,7GRhBDsirIGkRZBtSMEzNTyDr2JQm4xx,4,0,0,0,0,1,3,0,4,0.5714285714285714,1,0.0,0,0,0,0,0,1,0,3,0,0,4,1
18485,170751,NZIKCwZrLpCubV1To1IkAO0xVGXouuGz,7GRhBDsirIGkRZBtSMEzNTyDr2JQm4xx,1,0,0,0,0,0,1,0,1,0.14285714285714285,1,0.0,0,0,0,0,0,0,0,1,0,0,1,1
18486,170755,3s8l6Oo3c1fXiiE9X1tB8PxtDiwQqFs1,7GRhBDsirIGkRZBtSMEzNTyDr2JQm4xx,1,0,0,0,0,0,1,0,1,0.14285714285714285,1,0.0,0,0,0,0,0,0,0,1,0,0,1,1
18487,170760,yau38b5UXLNmzsSxrtZsXYfKt6l52ZSP,7GRhBDsirIGkRZBtSMEzNTyDr2JQm4xx,5,4,2,0,2,0,4,0,12,1.7142857142857142,1,0.0,0,2,0,2,4,0,0,4,0,4,8,1
18488,170765,BMIB6E91kmKyP88uGea4mN2MFpt4XLzp,5Gyp41oLVo7Gg7vF4vpmggWP5MU70QO6,6,3,1,0,1,0,6,0,11,1.5714285714285714,1,0.0,0,1,0,1,3,0,0,6,0,2,9,1
18489,170771,p4TvboUbx4FA7g7XUInoNWnGsmXFv56Y,5Gyp41oLVo7Gg7vF4vpmggWP5MU70QO6,1,0,0,0,0,0,2,0,2,0.2857142857142857,1,0.0,0,0,0,0,0,0,0,2,0,0,2,1
18490,170775,cfkf9Jwx7uWwwcBeVbchoLTRlD1rMmEz,5Gyp41oLVo7Gg7vF4vpmggWP5MU70QO6,4,3,1,0,1,0,1,0,6,0.8571428571428571,1,0.0,0,1,0,1,3,0,0,1,0,2,4,1
18491,170781,eRiW1rLnl4Qab6ywCt3YY5W8VtRqftP8,5Gyp41oLVo7Gg7vF4vpmggWP5MU70QO6,1,0,0,0,0,0,1,0,1,0.14285714285714285,1,0.0,0,0,0,0,0,0,0,1,0,0,1,1
18492,170784,UynNO0WxP0l7zqIo8Pjz2oz0nyu9QGkO,5Gyp41oLVo7Gg7vF4vpmggWP5MU70QO6,8,5,1,0,3,0,3,1,13,1.8571428571428572,1,0.0,2,1,0,3,3,0,0,3,1,6,7,1
18493,170785,eT9OhUahWhAeZfHPEbxGN9qGHwvkkQvs,5Gyp41oLVo7Gg7vF4vpmggWP5MU70QO6,1,0,0,0,0,0,1,0,1,0.14285714285714285,1,0.0,0,0,0,0,0,0,0,1,0,0,1,1
18494,170791,L0Nlz1jizXmJnw798XjZ6Ux26duL0HVo,5Gyp41oLVo7Gg7vF4vpmggWP5MU70QO6,6,4,2,0,1,0,3,0,10,1.4285714285714286,1,0.0,0,2,0,1,4,0,0,3,0,3,7,1
18495,170803,C869rqapV6yDWHSEwWrISTYhrx1OX9El,5Gyp41oLVo7Gg7vF4vpmggWP5MU70QO6,1,0,0,0,0,0,1,0,1,0.14285714285714285,1,0.0,0,0,0,0,0,0,0,1,0,0,1,1
18496,170807,hc3dSrci35Dy3FgQbfVD88Ol0CqYSCR2,5Gyp41oLVo7Gg7vF4vpmggWP5MU70QO6,11,11,1,6,3,0,2,0,23,3.2857142857142856,1,0.0,3,1,4,3,8,0,2,2,0,11,12,1
18497,170869,tHCozFCW7DNfZaJgecFLiDg68dSXh8ov,5Gyp41oLVo7Gg7vF4vpmggWP5MU70QO6,3,0,0,0,0,1,3,0,4,0.5714285714285714,1,0.0,0,0,0,0,0,1,0,3,0,0,4,1
18498,170882,j6HeRAsU4WuPEEEDUyCOznbm2Lpajkq3,5Gyp41oLVo7Gg7vF4vpmggWP5MU70QO6,1,0,0,0,0,0,1,0,1,0.14285714285714285,1,0.0,0,0,0,0,0,0,0,1,0,0,1,1
18499,170901,Yk6MmpUW28r4Uq8l3GnoMSWdv4jJs4LT,5Gyp41oLVo7Gg7vF4vpmggWP5MU70QO6,1,0,0,0,0,0,1,0,1,0.14285714285714285,1,0.0,0,0,0,0,0,0,0,1,0,0,1,1
18500,170915,NTdWlLSimx7GyW5yR8OxrZ4z4iFhcpVa,5Gyp41oLVo7Gg7vF4vpmggWP5MU70QO6,3,0,0,0,0,0,7,0,7,1.0,2,0.0,0,0,0,0,0,0,0,7,0,0,7,1
18501,170916,LRbWwyXhZPTAEjCqXqBiUY3zpucwFnJU,5Gyp41oLVo7Gg7vF4vpmggWP5MU70QO6,14,7,6,2,4,0,3,0,22,3.142857142857143,1,0.0,0,6,1,4,7,0,1,3,0,11,11,1
18502,170923,5j9EQkqR4CZfRV8sku9HLld3NnlBiUj6,5Gyp41oLVo7Gg7vF4vpmggWP5MU70QO6,5,1,1,0,0,0,3,0,5,0.7142857142857143,1,0.0,0,1,0,0,1,0,0,3,0,1,4,1
18503,170930,827VZ0CzsfF9ZeGQVo5aa4aZucptPdlC,5Gyp41oLVo7Gg7vF4vpmggWP5MU70QO6,4,2,1,0,1,0,3,0,7,1.0,1,0.0,0,1,0,1,2,0,0,3,0,2,5,1
18504,170931,G3goDZZ2o1vGeIpYovlANIGzxlyY4qqb,5Gyp41oLVo7Gg7vF4vpmggWP5MU70QO6,6,5,0,0,0,0,4,0,9,1.2857142857142858,1,0.0,0,0,0,0,5,0,0,4,0,0,9,1
18505,170936,taWxuJJEcneO1cGlCIbqiVREl8xjxX6Y,5Gyp41oLVo7Gg7vF4vpmggWP5MU70QO6,9,11,2,9,2,0,2,0,26,3.7142857142857144,1,0.0,5,2,5,2,6,0,4,2,0,14,12,1
18506,170937,aNviqaUsa8tjM9b6nMwh7ketdx2tdX99,5Gyp41oLVo7Gg7vF4vpmggWP5MU70QO6,1,0,0,0,0,0,1,0,1,0.14285714285714285,1,0.0,0,0,0,0,0,0,0,1,0,0,1,1
18507,170959,rQsFYzutvg9uveyvYwDFb5eVD15msCTa,5Gyp41oLVo7Gg7vF4vpmggWP5MU70QO6,1,0,0,0,0,0,1,0,1,0.14285714285714285,1,0.0,0,0,0,0,0,0,0,1,0,0,1,1
18508,171003,3CDy2SDum4kZFSNpibLk6Z5qeQ6EBDAC,5Gyp41oLVo7Gg7vF4vpmggWP5MU70QO6,1,0,0,0,0,0,1,0,1,0.14285714285714285,1,0.0,0,0,0,0,0,0,0,1,0,0,1,1
18509,171009,Z94hXsSNjGhWZCps7Ojjt5LXq9lu8p6b,5Gyp41oLVo7Gg7vF4vpmggWP5MU70QO6,4,2,1,0,1,1,1,0,6,0.8571428571428571,1,0.0,0,1,0,1,2,1,0,1,0,2,4,1
18510,171011,bLcbvKDRM6lji8wmeDJkPOBB2b9eyXBH,5Gyp41oLVo7Gg7vF4vpmggWP5MU70QO6,24,30,13,23,12,0,3,0,81,11.571428571428571,2,0.0,12,13,18,12,18,0,5,3,0,55,26,1
18511,171022,s0NbpPWS5IfVPx4eIbu1aTZt1wrsgXjI,5Gyp41oLVo7Gg7vF4vpmggWP5MU70QO6,1,0,0,0,0,0,1,0,1,0.14285714285714285,1,0.0,0,0,0,0,0,0,0,1,0,0,1,1
18512,171028,bnRbBUe4PkB0syLrQhPtKseWIhmvrSXx,5Gyp41oLVo7Gg7vF4vpmggWP5MU70QO6,5,3,2,0,1,0,2,0,8,1.1428571428571428,1,0.0,0,2,0,1,3,0,0,2,0,3,5,1
18513,171040,yyGBOhHbxMfX8BmR51wetDPOc6VNAvkc,5Gyp41oLVo7Gg7vF4vpmggWP5MU70QO6,4,2,1,0,1,0,1,0,5,0.7142857142857143,1,0.0,0,1,0,1,2,0,0,1,0,2,3,1
18514,171046,hs8vsSC20AJis83syUtViS2CCOVGp4Ud,5Gyp41oLVo7Gg7vF4vpmggWP5MU70QO6,13,34,24,10,12,3,7,0,90,12.857142857142858,4,0.0,5,24,8,12,29,3,2,7,0,49,41,0
18515,171065,7LvYUTiLkSebmokg9rczNx6BFI3AKTvk,5Gyp41oLVo7Gg7vF4vpmggWP5MU70QO6,6,5,3,0,2,0,4,0,14,2.0,2,0.0,0,3,0,2,5,0,0,4,0,5,9,1
18516,171095,SbhlOYaVvrkli2oKR3zLMXUUMLmLA3uq,5Gyp41oLVo7Gg7vF4vpmggWP5MU70QO6,10,6,2,0,5,0,2,0,15,2.142857142857143,1,0.0,3,2,0,5,3,0,0,2,0,10,5,1
18517,171096,ni3nXbs7dtyAlyweFOqGHdQNp2mMhFwt,5Gyp41oLVo7Gg7vF4vpmggWP5MU70QO6,21,35,15,20,8,10,9,1,98,14.0,1,0.0,15,15,14,8,20,10,6,9,1,52,46,1
18518,171121,DjMX7azMu4IpY69OrQdIh3IGz92j1lxo,5Gyp41oLVo7Gg7vF4vpmggWP5MU70QO6,8,2,2,0,1,3,5,3,16,2.2857142857142856,1,0.0,0,2,0,1,2,3,0,5,3,3,13,1
18519,171137,Rdy0CfUudmhWbIZliyDoiy2Dx48DROrp,5Gyp41oLVo7Gg7vF4vpmggWP5MU70QO6,8,6,4,2,3,0,1,0,16,2.2857142857142856,1,0.0,1,4,1,3,5,0,1,1,0,9,7,1
18520,171157,9URbBMbYW0bGrqgN35My2oF5c5hnglz3,5Gyp41oLVo7Gg7vF4vpmggWP5MU70QO6,17,15,8,0,7,0,4,0,34,4.857142857142857,2,0.0,3,8,0,7,12,0,0,4,0,18,16,1
18521,171160,UTQBVZwwRuN7bMqGkwJeqpNJF2PPrsFV,5Gyp41oLVo7Gg7vF4vpmggWP5MU70QO6,17,27,13,21,10,9,5,0,85,12.142857142857142,3,0.0,9,13,13,10,18,9,8,5,0,45,40,1
18522,171177,no2ug7TKVsupL4LU2a5jY2GhYHkskTdw,5Gyp41oLVo7Gg7vF4vpmggWP5MU70QO6,1,0,0,0,0,0,1,0,1,0.14285714285714285,1,0.0,0,0,0,0,0,0,0,1,0,0,1,1
18523,171178,NuWa1wNN62sioyREqwjInndithPqIOD8,5Gyp41oLVo7Gg7vF4vpmggWP5MU70QO6,10,13,9,0,7,0,2,0,31,4.428571428571429,2,0.0,2,9,0,7,11,0,0,2,0,18,13,1
18524,171189,eFyHUXeItRdU1K0bXmgVXfPmw1ZUD7pD,5Gyp41oLVo7Gg7vF4vpmggWP5MU70QO6,2,0,0,0,0,1,1,0,2,0.2857142857142857,1,0.0,0,0,0,0,0,1,0,1,0,0,2,1
18525,171193,qGK1tc93dD45zv8dcvRi536upoDHrRB7,5Gyp41oLVo7Gg7vF4vpmggWP5MU70QO6,14,8,7,0,6,0,2,0,23,3.2857142857142856,1,0.0,0,7,0,6,8,0,0,2,0,13,10,1
18526,171207,sPeU2djYNxHt1uDOGgBQyrpsbiWrJaDT,5Gyp41oLVo7Gg7vF4vpmggWP5MU70QO6,6,1,1,0,1,0,6,0,9,1.2857142857142858,1,0.0,0,1,0,1,1,0,0,6,0,2,7,1
18527,171215,vQxwNbtZgUat9SDZRmE7MEKdvAizpBwk,5Gyp41oLVo7Gg7vF4vpmggWP5MU70QO6,12,18,6,9,4,0,1,0,38,5.428571428571429,1,0.0,10,6,6,4,8,0,3,1,0,26,12,1
18528,171219,DP5pgERMZWRSN5a5SkQU3UnPeMBW2C59,5Gyp41oLVo7Gg7vF4vpmggWP5MU70QO6,5,2,1,0,1,0,3,0,7,1.0,2,0.0,0,1,0,1,2,0,0,3,0,2,5,1
18529,171260,abycdjSvUJMf23ooe01pNyMBFOcEZ7y0,5Gyp41oLVo7Gg7vF4vpmggWP5MU70QO6,4,2,1,0,1,0,1,0,5,0.7142857142857143,1,0.0,0,1,0,1,2,0,0,1,0,2,3,1
18530,171267,kfF2Z2lGAIzpstHoILdRDWLQUgS5KmZW,5Gyp41oLVo7Gg7vF4vpmggWP5MU70QO6,5,1,1,0,1,0,2,0,5,0.7142857142857143,1,0.0,0,1,0,1,1,0,0,2,0,2,3,1
18531,171280,xjK36HJFPi8iEkTq1KMrB8c6lE6mZK4D,5Gyp41oLVo7Gg7vF4vpmggWP5MU70QO6,6,5,2,0,2,0,2,0,11,1.5714285714285714,1,0.0,0,2,0,2,5,0,0,2,0,4,7,1
18532,171283,ocrybaLaQmK6tkKYPThp5V4sWJ2JBAoj,5Gyp41oLVo7Gg7vF4vpmggWP5MU70QO6,8,3,2,0,1,0,4,0,10,1.4285714285714286,1,0.0,0,2,0,1,3,0,0,4,0,3,7,1
18533,171289,KmDevCA0Fd1b8hBvX2cQviMAVGGzUN4h,5Gyp41oLVo7Gg7vF4vpmggWP5MU70QO6,8,4,2,0,2,0,7,0,15,2.142857142857143,1,0.0,0,2,0,2,4,0,0,7,0,4,11,1
18534,171307,avUYMdaaaXWvY0rHrFeagZk5hxdyWCx7,5Gyp41oLVo7Gg7vF4vpmggWP5MU70QO6,20,20,11,2,8,3,7,0,51,7.285714285714286,2,0.0,4,11,1,8,16,3,1,7,0,24,27,1
18535,171318,7ee06WiF4bXJHzzIAwVSoqVatXFhyov9,5Gyp41oLVo7Gg7vF4vpmggWP5MU70QO6,4,2,1,0,1,0,2,0,6,0.8571428571428571,1,0.0,0,1,0,1,2,0,0,2,0,2,4,1
18536,171326,pY7eBIYQnNrRDqMqusFhdWhyjWW02r9S,5Gyp41oLVo7Gg7vF4vpmggWP5MU70QO6,9,12,0,0,0,0,8,3,23,3.2857142857142856,1,0.0,2,0,0,0,10,0,0,8,3,2,21,1
18537,171333,v1rqQmEjSAVxogtdzkPThPbJaR6b0Gnq,5Gyp41oLVo7Gg7vF4vpmggWP5MU70QO6,7,3,2,0,2,0,2,0,9,1.2857142857142858,1,0.0,0,2,0,2,3,0,0,2,0,4,5,1
18538,171340,GMzSpgZQ6jzVsfHn8W8i83JsYNxnP00b,5Gyp41oLVo7Gg7vF4vpmggWP5MU70QO6,13,39,18,4,1,1,13,0,76,10.857142857142858,3,0.0,7,18,3,1,32,1,1,13,0,29,47,1
18539,171354,JArfhUdQiCDJUGGF1GUzH6iybvkKVezF,5Gyp41oLVo7Gg7vF4vpmggWP5MU70QO6,3,0,0,0,0,3,2,0,5,0.7142857142857143,1,0.0,0,0,0,0,0,3,0,2,0,0,5,1
18540,171363,trgMDAY9uIKniIj7MNKMFlYvq2puOBqS,5Gyp41oLVo7Gg7vF4vpmggWP5MU70QO6,28,41,22,18,9,3,7,0,100,14.285714285714286,3,0.0,14,22,13,9,27,3,5,7,0,58,42,1
18541,171387,iQUKcnL77lKYF7iiJiwEDvheVVvDz9HU,5Gyp41oLVo7Gg7vF4vpmggWP5MU70QO6,4,2,1,0,1,0,2,0,6,0.8571428571428571,1,0.0,0,1,0,1,2,0,0,2,0,2,4,1
18542,171395,aXJ6fzZZAhXxp1C0craLTVKLc0N7EkCB,5Gyp41oLVo7Gg7vF4vpmggWP5MU70QO6,1,0,0,0,0,0,1,0,1,0.14285714285714285,1,0.0,0,0,0,0,0,0,0,1,0,0,1,1
18543,171406,XNiJFsPS4pWS29Iwww7aTDuzD3ZtCIBA,5Gyp41oLVo7Gg7vF4vpmggWP5MU70QO6,9,5,2,4,2,0,2,0,15,2.142857142857143,1,0.0,1,2,3,2,4,0,1,2,0,8,7,1
18544,171408,HtjEbvgOOBBVriL8HmozgEGA6fnYXsGi,5Gyp41oLVo7Gg7vF4vpmggWP5MU70QO6,1,0,0,0,0,0,1,0,1,0.14285714285714285,1,0.0,0,0,0,0,0,0,0,1,0,0,1,1
18545,171416,LFHy42gGUY0ra7u86Eijp2ZrHEmwJejY,5Gyp41oLVo7Gg7vF4vpmggWP5MU70QO6,1,0,0,0,0,0,1,0,1,0.14285714285714285,1,0.0,0,0,0,0,0,0,0,1,0,0,1,1
18546,171424,LdTABddaoG9xBYcPuQ1k6qsARenE47fZ,5Gyp41oLVo7Gg7vF4vpmggWP5MU70QO6,5,2,1,0,1,0,2,0,6,0.8571428571428571,1,0.0,0,1,0,1,2,0,0,2,0,2,4,1
18547,171444,EOtg7SeGapdjcfmgZb6gcgTDKiiO1H0w,5Gyp41oLVo7Gg7vF4vpmggWP5MU70QO6,6,2,2,0,0,0,3,0,7,1.0,1,0.0,0,2,0,0,2,0,0,3,0,2,5,1
18548,171460,erekz3vGKNrk60zKOdRickSTuufbMf9j,5Gyp41oLVo7Gg7vF4vpmggWP5MU70QO6,7,2,1,0,1,0,4,1,9,1.2857142857142858,1,0.0,0,1,0,1,2,0,0,4,1,2,7,1
18549,171468,rQHZugBVJiSclJ7S9BzroTFpeTd0gpCq,5Gyp41oLVo7Gg7vF4vpmggWP5MU70QO6,6,3,2,0,2,0,1,0,8,1.1428571428571428,1,0.0,0,2,0,2,3,0,0,1,0,4,4,1
18550,171480,a0LIICaoiHuLSU4stcBsZb8wt2BRDZvP,5Gyp41oLVo7Gg7vF4vpmggWP5MU70QO6,1,0,0,0,0,0,1,0,1,0.14285714285714285,1,0.0,0,0,0,0,0,0,0,1,0,0,1,1
18551,171499,NGQ6HXbhxwBlJxikVxca5noX2u8xI9AV,5Gyp41oLVo7Gg7vF4vpmggWP5MU70QO6,13,28,0,4,2,2,6,0,42,6.0,1,0.0,6,0,3,2,22,2,1,6,0,11,31,1
18552,171502,syRXQgZ68k4Lu6fGAyDxMb2MzSTLmk5X,5Gyp41oLVo7Gg7vF4vpmggWP5MU70QO6,6,7,3,0,1,0,2,0,13,1.8571428571428572,2,0.0,2,3,0,1,5,0,0,2,0,6,7,1
18553,171507,KvPxlUI4LixXy5PjTz37hzmMB0UPrljM,5Gyp41oLVo7Gg7vF4vpmggWP5MU70QO6,4,2,1,0,1,0,2,0,6,0.8571428571428571,1,0.0,0,1,0,1,2,0,0,2,0,2,4,1
18554,171545,yKg6Gy57ErBEhKmfgsVWKCnvQy3s0q3B,5Gyp41oLVo7Gg7vF4vpmggWP5MU70QO6,7,6,2,0,4,0,1,0,13,1.8571428571428572,1,0.0,3,2,0,4,3,0,0,1,0,9,4,1
18555,171548,VG6lME1wYQEAWT3RMObNaXwuAoVt3ojn,5Gyp41oLVo7Gg7vF4vpmggWP5MU70QO6,3,3,1,0,0,0,1,0,5,0.7142857142857143,1,0.0,0,1,0,0,3,0,0,1,0,1,4,1
18556,171556,ta1c0rHn1PLWJ22QrYmkbMjTzbZREroJ,5Gyp41oLVo7Gg7vF4vpmggWP5MU70QO6,7,6,3,0,2,0,2,0,13,1.8571428571428572,1,0.0,1,3,0,2,5,0,0,2,0,6,7,1
18557,171605,rPtP72DMEyNlpUomeqVVqrg44j30SIpW,5Gyp41oLVo7Gg7vF4vpmggWP5MU70QO6,9,5,3,0,1,0,5,0,14,2.0,2,0.0,0,3,0,1,5,0,0,5,0,4,10,1
18558,171606,meIJ5fWFXqkx5qH8JeWlAp9Z7hg5xZ9c,5Gyp41oLVo7Gg7vF4vpmggWP5MU70QO6,8,4,2,0,1,4,7,1,19,2.7142857142857144,1,0.0,0,2,0,1,4,4,0,7,1,3,16,1
18559,171608,HoR3vqXgbzj6tIBJ3biNSM9ngz6njRvX,5Gyp41oLVo7Gg7vF4vpmggWP5MU70QO6,10,6,4,0,4,0,4,0,18,2.5714285714285716,1,0.0,1,4,0,4,5,0,0,4,0,9,9,1
18560,171630,9Wx1wvfBU3tliMSpRcfAd6me8ZV4kjBX,5Gyp41oLVo7Gg7vF4vpmggWP5MU70QO6,6,2,1,0,1,0,3,0,7,1.0,1,0.0,0,1,0,1,2,0,0,3,0,2,5,1
18561,171634,9sWl1POptoLbF2x8NBawVIAksiyrPUSp,5Gyp41oLVo7Gg7vF4vpmggWP5MU70QO6,8,7,4,0,2,0,3,0,16,2.2857142857142856,1,0.0,0,4,0,2,7,0,0,3,0,6,10,1
18562,171674,2WVyaq5BHzTwZ8qnlD9DMzt5ERVZhrZj,5Gyp41oLVo7Gg7vF4vpmggWP5MU70QO6,1,0,0,0,0,0,1,0,1,0.14285714285714285,1,0.0,0,0,0,0,0,0,0,1,0,0,1,1
18563,171689,BiREs4YxU1vt2gu7sZkVBaymqql0vWGE,5Gyp41oLVo7Gg7vF4vpmggWP5MU70QO6,6,11,0,0,1,0,2,0,14,2.0,1,0.0,1,0,0,1,10,0,0,2,0,2,12,1
18564,171708,rG8IAsvC5z6AKaPGHhUGX7vqxRs7JWXy,5Gyp41oLVo7Gg7vF4vpmggWP5MU70QO6,5,1,1,0,1,0,2,0,5,0.7142857142857143,1,0.0,0,1,0,1,1,0,0,2,0,2,3,0
18565,171710,sLGaPfom5sNxoC8eYlrQX0cxaol8qNJq,5Gyp41oLVo7Gg7vF4vpmggWP5MU70QO6,3,2,0,0,0,0,1,0,3,0.42857142857142855,1,0.0,0,0,0,0,2,0,0,1,0,0,3,1
18566,171718,lVSG902cLe1CW73E0Hoc4xiT416HaV83,5Gyp41oLVo7Gg7vF4vpmggWP5MU70QO6,15,28,14,0,6,0,6,0,54,7.714285714285714,2,0.0,5,14,0,6,23,0,0,6,0,25,29,1
18567,171725,b3nI48MewVFUxM8jH50bPwNToxR3d2Xc,5Gyp41oLVo7Gg7vF4vpmggWP5MU70QO6,1,0,0,0,0,0,1,0,1,0.14285714285714285,1,0.0,0,0,0,0,0,0,0,1,0,0,1,1
18568,171728,jjxQxNuEbbhaS9MitVf0jBmN5zgdr6CO,5Gyp41oLVo7Gg7vF4vpmggWP5MU70QO6,1,0,0,0,0,0,2,0,2,0.2857142857142857,1,0.0,0,0,0,0,0,0,0,2,0,0,2,1
18569,171729,6MSYodwGYcwd9yRZIV9mZL7DhjFIlsBW,5Gyp41oLVo7Gg7vF4vpmggWP5MU70QO6,8,7,3,0,2,0,2,0,14,2.0,1,0.0,3,3,0,2,4,0,0,2,0,8,6,1
18570,171741,gAdtqRV2WTq9brK7JyARtVKycCReXSnK,5Gyp41oLVo7Gg7vF4vpmggWP5MU70QO6,8,16,9,0,0,0,5,0,30,4.285714285714286,2,0.0,7,9,0,0,9,0,0,5,0,16,14,1
18571,171755,3twxJJAOjVM4q3xTctfONpi3ytR09f2J,5Gyp41oLVo7Gg7vF4vpmggWP5MU70QO6,6,1,1,0,1,0,3,0,6,0.8571428571428571,1,0.0,0,1,0,1,1,0,0,3,0,2,4,1
18572,171757,DBDJsHu8m0mygajWSHGxgRt9n3Rmx9gx,5Gyp41oLVo7Gg7vF4vpmggWP5MU70QO6,16,20,16,0,6,0,8,0,50,7.142857142857143,2,0.0,0,16,0,6,20,0,0,8,0,22,28,1
18573,171774,VxFnPnt5rim5O8RtDlF7wSXMJRGsfRAY,5Gyp41oLVo7Gg7vF4vpmggWP5MU70QO6,5,2,1,0,1,0,3,0,7,1.0,1,0.0,0,1,0,1,2,0,0,3,0,2,5,1
18574,171814,2LHnW0IJwerL0URh9evHYpYX9y6FKsRc,5Gyp41oLVo7Gg7vF4vpmggWP5MU70QO6,18,15,6,6,5,2,7,1,42,6.0,3,0.0,4,6,4,5,11,2,2,7,1,19,23,1
18575,171823,z6zy2HEFUX1BqomXd3UFqWumh4qIFZPI,5Gyp41oLVo7Gg7vF4vpmggWP5MU70QO6,7,3,2,0,2,0,2,0,9,1.2857142857142858,1,0.0,0,2,0,2,3,0,0,2,0,4,5,1
18576,171824,awwh8BVpi9HaABaIyISpNOMgFy0X4GpH,5Gyp41oLVo7Gg7vF4vpmggWP5MU70QO6,6,5,0,0,0,9,2,0,16,2.2857142857142856,1,0.0,0,0,0,0,5,9,0,2,0,0,16,1
18577,171825,S8G6hxeFaGb8kBCTRNlN7IM5e1Mut23r,5Gyp41oLVo7Gg7vF4vpmggWP5MU70QO6,1,0,0,0,0,0,1,0,1,0.14285714285714285,1,0.0,0,0,0,0,0,0,0,1,0,0,1,1
18578,171844,RJW2y0gnZZP4Xx4orJbqrG7gRq8Qm9cV,5Gyp41oLVo7Gg7vF4vpmggWP5MU70QO6,8,11,6,0,3,0,6,0,26,3.7142857142857144,1,0.0,1,6,0,3,10,0,0,6,0,10,16,1
18579,171867,QweACcbiHHHCzgWrkXlP6tkpsdwE8OVo,5Gyp41oLVo7Gg7vF4vpmggWP5MU70QO6,6,6,3,0,2,0,3,0,14,2.0,1,0.0,0,3,0,2,6,0,0,3,0,5,9,1
18580,171921,DuATnvBmuC2fZ2ZU7jnqtlU3mz3sdckv,5Gyp41oLVo7Gg7vF4vpmggWP5MU70QO6,4,2,1,0,1,0,1,0,5,0.7142857142857143,1,0.0,0,1,0,1,2,0,0,1,0,2,3,1
18581,171922,okyoisoOO6wvnkb7PnvdYaNSdWtxEaB3,5Gyp41oLVo7Gg7vF4vpmggWP5MU70QO6,7,8,1,0,2,0,3,0,14,2.0,1,0.0,0,1,0,2,8,0,0,3,0,3,11,1
18582,171924,BH0sucFBGAVdL6PteB266LGj7gAODQdC,5Gyp41oLVo7Gg7vF4vpmggWP5MU70QO6,1,0,0,0,0,0,1,0,1,0.14285714285714285,1,0.0,0,0,0,0,0,0,0,1,0,0,1,1
18583,171943,wIX6Xm6W1PLbNsugFVhL4SUuV61h0VdL,5Gyp41oLVo7Gg7vF4vpmggWP5MU70QO6,18,16,13,0,7,10,2,1,49,7.0,1,0.0,1,13,0,7,15,10,0,2,1,21,28,1
18584,171948,slLayrgewQwI4ovDGVB7kVUP7oY6JbhG,5Gyp41oLVo7Gg7vF4vpmggWP5MU70QO6,20,32,16,15,3,7,14,5,92,13.142857142857142,1,0.0,9,16,11,3,23,7,4,14,5,39,53,1
18585,171949,pItq3bFxeu5w71VK8K1sPKwhEUiyoKaP,5Gyp41oLVo7Gg7vF4vpmggWP5MU70QO6,6,3,2,0,1,0,2,0,8,1.1428571428571428,1,0.0,0,2,0,1,3,0,0,2,0,3,5,1
18586,171975,2tlXbRsdeTZKctb2koJVcptDiwymcPny,5Gyp41oLVo7Gg7vF4vpmggWP5MU70QO6,11,8,6,0,4,0,4,1,23,3.2857142857142856,2,0.0,0,6,0,4,8,0,0,4,1,10,13,1
18587,171976,CDTPeilgCkfrS3rzAW5jO0MF05nzaCsc,5Gyp41oLVo7Gg7vF4vpmggWP5MU70QO6,9,6,3,0,2,4,5,1,21,3.0,1,0.0,0,3,0,2,6,4,0,5,1,5,16,1
18588,171992,li1RAuplYdJUb6MArmDyNCuCLN26Dq80,5Gyp41oLVo7Gg7vF4vpmggWP5MU70QO6,4,2,1,0,1,0,1,0,5,0.7142857142857143,1,0.0,0,1,0,1,2,0,0,1,0,2,3,1
18589,171993,Mh9NICTvL9zw9pa45HSgcXaVDdrGiixJ,5Gyp41oLVo7Gg7vF4vpmggWP5MU70QO6,5,1,1,0,1,0,2,0,5,0.7142857142857143,1,0.0,0,1,0,1,1,0,0,2,0,2,3,1
18590,171995,OTsrWlpB4HEsglCviXcYcVMf94EGwyap,5Gyp41oLVo7Gg7vF4vpmggWP5MU70QO6,4,3,0,0,1,0,2,0,6,0.8571428571428571,1,0.0,0,0,0,1,3,0,0,2,0,1,5,1
18591,172036,zZWPxlDYqF21YiirhZBZVP7fDkVIwo9C,5Gyp41oLVo7Gg7vF4vpmggWP5MU70QO6,4,5,1,0,0,0,1,0,7,1.0,1,0.0,0,1,0,0,5,0,0,1,0,1,6,1
18592,172046,219ZtkRovyFfuoCR6XGJofrvIluZkPPk,5Gyp41oLVo7Gg7vF4vpmggWP5MU70QO6,10,6,3,3,2,4,5,0,23,3.2857142857142856,1,0.0,3,3,2,2,3,4,1,5,0,10,13,1
18593,172052,jK4Ev0LljQS9dRmYWftmSBJQGeKXxMDQ,5Gyp41oLVo7Gg7vF4vpmggWP5MU70QO6,12,22,0,7,0,0,4,0,33,4.714285714285714,2,0.0,4,0,4,0,18,0,3,4,0,8,25,1
18594,172054,D3Ec64UjlioWBq9s6QHemsTVoIO83t3S,5Gyp41oLVo7Gg7vF4vpmggWP5MU70QO6,4,5,0,0,0,0,1,0,6,0.8571428571428571,1,0.0,0,0,0,0,5,0,0,1,0,0,6,1
18595,172060,MeEpYOfbvivW6ZzcHgNKGn0HRaJkwsZQ,5Gyp41oLVo7Gg7vF4vpmggWP5MU70QO6,12,12,5,0,4,0,5,0,26,3.7142857142857144,2,0.0,2,5,0,4,10,0,0,5,0,11,15,1
18596,172119,nPRsjektHdbQkeAf1fIK4JbhrESPbPsA,5Gyp41oLVo7Gg7vF4vpmggWP5MU70QO6,14,13,8,2,6,6,4,0,39,5.571428571428571,3,0.0,2,8,1,6,11,6,1,4,0,17,22,0
18597,172122,syMQAAbvPWf5dOGGKWR7dlKKtLdoqo8z,5Gyp41oLVo7Gg7vF4vpmggWP5MU70QO6,5,3,1,0,1,0,1,0,6,0.8571428571428571,1,0.0,0,1,0,1,3,0,0,1,0,2,4,1
18598,172123,gUo5HnisULurDMKaeZ751PCJ1d0iYJyW,5Gyp41oLVo7Gg7vF4vpmggWP5MU70QO6,6,4,1,0,1,0,3,0,9,1.2857142857142858,1,0.0,1,1,0,1,3,0,0,3,0,3,6,1
18599,172128,41eAyCcalJFuAGeA9PeN6EH0etDrJoiS,5Gyp41oLVo7Gg7vF4vpmggWP5MU70QO6,5,9,0,0,0,0,1,0,10,1.4285714285714286,1,0.0,0,0,0,0,9,0,0,1,0,0,10,1
18600,172137,M9KnY1dyuXUV8pcf2nvnRDy7cXHn2kvf,5Gyp41oLVo7Gg7vF4vpmggWP5MU70QO6,13,8,6,0,4,0,6,1,25,3.5714285714285716,1,0.0,0,6,0,4,8,0,0,6,1,10,15,1
18601,172138,WEiHMXq6jANjNt27M5plCf4GscmfAQEf,5Gyp41oLVo7Gg7vF4vpmggWP5MU70QO6,4,3,2,0,0,0,2,0,7,1.0,1,0.0,0,2,0,0,3,0,0,2,0,2,5,1
18602,172175,5qtgeGza9DOaiOnRZufO1t8FYYMM6Mqa,5Gyp41oLVo7Gg7vF4vpmggWP5MU70QO6,1,0,0,0,0,0,2,0,2,0.2857142857142857,1,0.0,0,0,0,0,0,0,0,2,0,0,2,1
18603,172177,JXpFP7Prtzdu0WxRqDqJnTSpnHZKGOLi,5Gyp41oLVo7Gg7vF4vpmggWP5MU70QO6,6,6,3,0,0,1,7,0,17,2.4285714285714284,1,0.0,2,3,0,0,4,1,0,7,0,5,12,1
18604,172188,QXrh4ypkD1QaQAhOuKUOU3kPN6cXVdim,5Gyp41oLVo7Gg7vF4vpmggWP5MU70QO6,16,29,10,0,6,1,11,1,58,8.285714285714286,3,0.0,6,10,0,6,23,1,0,11,1,22,36,1
18605,172189,TgFKV48AUBfCO7r29pTXMZQaHoUdoobZ,5Gyp41oLVo7Gg7vF4vpmggWP5MU70QO6,6,2,1,0,1,0,3,0,7,1.0,1,0.0,0,1,0,1,2,0,0,3,0,2,5,1
18606,172193,4oVGmoGj6DjY5PLg7lM26G3AhR4k3Pm1,5Gyp41oLVo7Gg7vF4vpmggWP5MU70QO6,8,8,5,0,3,0,3,0,19,2.7142857142857144,1,0.0,0,5,0,3,8,0,0,3,0,8,11,1
18607,172233,P8oQ6jrr9sX5ql0sb1GKfSCdC6kiV5yB,5Gyp41oLVo7Gg7vF4vpmggWP5MU70QO6,5,0,0,0,0,0,6,1,7,1.0,1,0.0,0,0,0,0,0,0,0,6,1,0,7,1
18608,172243,gIXV45WkMOjKV6SvlgkVrQlYJRphcrVX,5Gyp41oLVo7Gg7vF4vpmggWP5MU70QO6,5,2,1,0,1,0,2,0,6,0.8571428571428571,1,0.0,0,1,0,1,2,0,0,2,0,2,4,0
18609,172265,CNGYybwj0lTeNQHTl7ZDNIxBHTW6Ensw,5Gyp41oLVo7Gg7vF4vpmggWP5MU70QO6,17,47,26,10,7,4,11,0,105,15.0,2,0.0,13,26,7,7,34,4,3,11,0,53,52,1
18610,172316,88KqNXt49dXQV1iTpH5dKGaXzbVtpY63,5Gyp41oLVo7Gg7vF4vpmggWP5MU70QO6,6,3,2,0,2,0,1,0,8,1.1428571428571428,1,0.0,0,2,0,2,3,0,0,1,0,4,4,1
18611,172320,uD4C9Dhce33zUj6KChwo5RM2vwq3ylcX,5Gyp41oLVo7Gg7vF4vpmggWP5MU70QO6,12,14,8,10,5,6,4,0,47,6.714285714285714,1,0.0,4,8,5,5,10,6,5,4,0,22,25,1
18612,172333,nQLHtvOO0tgGcyKecHvEbBCN8GxgUKXs,5Gyp41oLVo7Gg7vF4vpmggWP5MU70QO6,3,0,0,0,0,0,3,0,3,0.42857142857142855,1,0.0,0,0,0,0,0,0,0,3,0,0,3,1
18613,172343,9DAdKEpHAkUW9tgS718BKvE0nrO7Nhn1,5Gyp41oLVo7Gg7vF4vpmggWP5MU70QO6,24,36,22,0,7,2,16,2,85,12.142857142857142,2,0.0,9,22,0,7,27,2,0,16,2,38,47,1
18614,172347,vmX7frUqL7WeBo3nSAfXYcds7j6dtCCt,5Gyp41oLVo7Gg7vF4vpmggWP5MU70QO6,8,12,4,6,1,0,1,0,24,3.4285714285714284,1,0.0,5,4,3,1,7,0,3,1,0,13,11,1
18615,172353,lRLeqHvYMAoLJKA3aRJuFMxDlpshFZWk,5Gyp41oLVo7Gg7vF4vpmggWP5MU70QO6,9,7,3,2,2,0,2,0,16,2.2857142857142856,1,0.0,1,3,1,2,6,0,1,2,0,7,9,1
18616,172359,SiX02WTa9I1YhsFH9ZdyWriSf8qHIfRQ,5Gyp41oLVo7Gg7vF4vpmggWP5MU70QO6,1,0,0,0,0,0,1,0,1,0.14285714285714285,1,0.0,0,0,0,0,0,0,0,1,0,0,1,1
18617,172376,hqZMegguIBZDS3b0BCwsYFCd4lh9Opy1,5Gyp41oLVo7Gg7vF4vpmggWP5MU70QO6,2,0,0,0,0,0,2,0,2,0.2857142857142857,1,0.0,0,0,0,0,0,0,0,2,0,0,2,1
18618,172382,GtuEelYfNaXxzKOllxbFfafnobOPHIGx,5Gyp41oLVo7Gg7vF4vpmggWP5MU70QO6,7,3,2,0,2,2,2,0,11,1.5714285714285714,1,0.0,0,2,0,2,3,2,0,2,0,4,7,1
18619,172386,XaVaW7zhIkqyN67l1zhcGn8fROLFDNOd,5Gyp41oLVo7Gg7vF4vpmggWP5MU70QO6,13,8,3,10,2,6,5,1,35,5.0,1,0.0,4,3,5,2,4,6,5,5,1,14,21,1
18620,172394,pzFcwZgNrjnx8TfYkiyd9LxaCq2EbrQ8,5Gyp41oLVo7Gg7vF4vpmggWP5MU70QO6,1,0,0,0,0,0,1,0,1,0.14285714285714285,1,0.0,0,0,0,0,0,0,0,1,0,0,1,1
18621,172395,6HZMw8LFd0LgW9tH20x46NBpQ9z7xjs8,5Gyp41oLVo7Gg7vF4vpmggWP5MU70QO6,7,3,2,0,2,0,2,0,9,1.2857142857142858,1,0.0,0,2,0,2,3,0,0,2,0,4,5,1
18622,172399,JyT1UtVlJquq8THK76yjuEbLoY5pkuIB,5Gyp41oLVo7Gg7vF4vpmggWP5MU70QO6,9,7,3,0,4,0,3,0,17,2.4285714285714284,1,0.0,2,3,0,4,5,0,0,3,0,9,8,1
18623,172409,6mOQPHYetbEhBA0tIxsajGc8MOtDRaKo,5Gyp41oLVo7Gg7vF4vpmggWP5MU70QO6,5,2,1,0,1,0,2,0,6,0.8571428571428571,1,0.0,0,1,0,1,2,0,0,2,0,2,4,1
18624,172418,xJMOdATTMorSYDF6CzmTAxofDY32PFm8,5Gyp41oLVo7Gg7vF4vpmggWP5MU70QO6,20,15,9,12,6,0,8,1,51,7.285714285714286,2,0.0,4,9,6,6,11,0,6,8,1,25,26,1
18625,172419,hXZgc5Oc8L3KNvO8ElQE29RF6Exzr76M,5Gyp41oLVo7Gg7vF4vpmggWP5MU70QO6,1,0,0,0,0,0,1,0,1,0.14285714285714285,1,0.0,0,0,0,0,0,0,0,1,0,0,1,1
18626,172422,tAvyfP1C8BhgApDQ1Bw2zxQFiC5YHjrZ,5Gyp41oLVo7Gg7vF4vpmggWP5MU70QO6,5,3,1,0,1,0,1,0,6,0.8571428571428571,1,0.0,0,1,0,1,3,0,0,1,0,2,4,1
18627,172423,tRDAXSjCZAZhK7cnVXkigKhGQk8DLkR5,5Gyp41oLVo7Gg7vF4vpmggWP5MU70QO6,4,3,0,0,0,0,2,0,5,0.7142857142857143,1,0.0,0,0,0,0,3,0,0,2,0,0,5,1
18628,172428,WMyzbme4IPMhK5z5T3Uh6kkzSEUZ7eVu,5Gyp41oLVo7Gg7vF4vpmggWP5MU70QO6,28,27,16,0,15,4,14,4,80,11.428571428571429,1,0.0,8,16,0,15,19,4,0,14,4,39,41,1
18629,172454,fGIeAB7IRJCHxzCo8u4GLaPKxQfHeCdi,5Gyp41oLVo7Gg7vF4vpmggWP5MU70QO6,14,21,11,2,5,1,20,0,60,8.571428571428571,2,0.0,3,11,1,5,18,1,1,20,0,20,40,0
18630,172465,gUiPsIaxYlgBsivuNjPHoDnnrtdL7Cbn,5Gyp41oLVo7Gg7vF4vpmggWP5MU70QO6,8,5,3,0,2,0,3,0,13,1.8571428571428572,1,0.0,0,3,0,2,5,0,0,3,0,5,8,1
18631,172474,1Gv11nS0XCuxdjw8VOmeY5aEETIaIhPq,5Gyp41oLVo7Gg7vF4vpmggWP5MU70QO6,7,4,2,0,3,0,2,0,11,1.5714285714285714,2,0.0,1,2,0,3,3,0,0,2,0,6,5,1
18632,172478,7veRLmOXH6Z7w92gomETN6VvuGcgVtpo,5Gyp41oLVo7Gg7vF4vpmggWP5MU70QO6,7,3,2,0,2,0,2,0,9,1.2857142857142858,1,0.0,0,2,0,2,3,0,0,2,0,4,5,1
18633,172493,OmGw3VG1Kot9ZVAXXHzYH5KLDTxt3KBb,5Gyp41oLVo7Gg7vF4vpmggWP5MU70QO6,5,2,1,0,1,0,2,0,6,0.8571428571428571,1,0.0,0,1,0,1,2,0,0,2,0,2,4,1
18634,172498,6qNWXHct28SXsoCVlzpIHJGmH1udkMRZ,5Gyp41oLVo7Gg7vF4vpmggWP5MU70QO6,12,8,6,0,4,1,7,1,27,3.857142857142857,1,0.0,0,6,0,4,8,1,0,7,1,10,17,1
18635,172515,VrGl46tWb2FJndejFSg5rEj10FD1RSZJ,5Gyp41oLVo7Gg7vF4vpmggWP5MU70QO6,5,2,1,0,1,0,2,0,6,0.8571428571428571,1,0.0,0,1,0,1,2,0,0,2,0,2,4,1
18636,172524,tE5507lMe2f0i5SPUDGg3oFlG9cJ7zGD,5Gyp41oLVo7Gg7vF4vpmggWP5MU70QO6,2,0,0,0,0,0,2,0,2,0.2857142857142857,1,0.0,0,0,0,0,0,0,0,2,0,0,2,1
18637,172526,24L7xvhKlknyF3TFtffk5NsoEEPTVTdN,5Gyp41oLVo7Gg7vF4vpmggWP5MU70QO6,1,0,0,0,0,0,1,0,1,0.14285714285714285,1,0.0,0,0,0,0,0,0,0,1,0,0,1,1
18638,172545,CHHf2P071V6Zt83z3XymyniYuus5PKOR,5Gyp41oLVo7Gg7vF4vpmggWP5MU70QO6,5,2,1,0,1,0,2,0,6,0.8571428571428571,1,0.0,0,1,0,1,2,0,0,2,0,2,4,1
18639,172547,JX4YgGT3KVfxdSZfyB08qYqlgwP14Voi,5Gyp41oLVo7Gg7vF4vpmggWP5MU70QO6,8,2,2,0,2,0,7,0,13,1.8571428571428572,2,0.0,0,2,0,2,2,0,0,7,0,4,9,1
18640,172603,3Qa8OwRnF6RlLJIaj65bDtbQqyemzMgL,7GRhBDsirIGkRZBtSMEzNTyDr2JQm4xx,2,0,0,0,0,0,4,0,4,0.5714285714285714,1,0.0,0,0,0,0,0,0,0,4,0,0,4,1
18641,172607,NzrnPyQE2ugty7kkveeBlkFqr7w3UxlN,7GRhBDsirIGkRZBtSMEzNTyDr2JQm4xx,2,0,0,0,0,0,4,0,4,0.5714285714285714,1,0.0,0,0,0,0,0,0,0,4,0,0,4,1
18642,172625,6rGO7hPQfiSxYr5WLMk6ADh5tZXWjo5G,7GRhBDsirIGkRZBtSMEzNTyDr2JQm4xx,6,1,1,0,1,0,4,0,7,1.0,1,0.0,0,1,0,1,1,0,0,4,0,2,5,1
18643,172633,dbB5wvpXcG9crHY0IBSgcjC2RaEiLaLJ,7GRhBDsirIGkRZBtSMEzNTyDr2JQm4xx,33,44,12,45,7,1,2,0,111,15.857142857142858,1,0.0,30,12,36,7,14,1,9,2,0,85,26,1
18644,172648,4dKHuxqIxqkgnnPsJVGzxbywZwnO5Gk5,7GRhBDsirIGkRZBtSMEzNTyDr2JQm4xx,2,0,0,0,0,0,2,0,2,0.2857142857142857,1,0.0,0,0,0,0,0,0,0,2,0,0,2,1
18645,172664,qVPmJ4VDzezTrYKhrdeTeAkmNVvDpxTN,7GRhBDsirIGkRZBtSMEzNTyDr2JQm4xx,1,0,0,0,0,0,1,0,1,0.14285714285714285,1,0.0,0,0,0,0,0,0,0,1,0,0,1,1
18646,172672,tN0VqNMvyp7i1ARB8nPF5OPuXHimNIVo,7GRhBDsirIGkRZBtSMEzNTyDr2JQm4xx,2,0,0,0,0,0,2,0,2,0.2857142857142857,1,0.0,0,0,0,0,0,0,0,2,0,0,2,1
18647,172674,AEIKxehDViGug4MCURfXcZNkb3lq7o1x,7GRhBDsirIGkRZBtSMEzNTyDr2JQm4xx,19,14,10,0,10,0,4,0,38,5.428571428571429,1,0.0,0,10,0,10,14,0,0,4,0,20,18,1
18648,172706,ExYCcuGVzDNcCtA4rQqosA267qlGxHih,7GRhBDsirIGkRZBtSMEzNTyDr2JQm4xx,7,0,0,0,0,0,8,1,9,1.2857142857142858,2,0.0,0,0,0,0,0,0,0,8,1,0,9,1
18649,172707,JnYcKFBPT6ke8yr2Se5J0qjNCbQC2Yzq,7GRhBDsirIGkRZBtSMEzNTyDr2JQm4xx,7,5,1,0,0,0,6,1,13,1.8571428571428572,1,0.0,0,1,0,0,5,0,0,6,1,1,12,1
18650,172733,oKu6VLpnoojteApzRKKjWrPb4vBoBjWk,7GRhBDsirIGkRZBtSMEzNTyDr2JQm4xx,1,0,0,0,0,0,1,0,1,0.14285714285714285,1,0.0,0,0,0,0,0,0,0,1,0,0,1,1
18651,172761,sL5jw3pLWZoRI7avI17oM60mfF67Acgz,fbPkOYLVPtPgIt0MxizjfFJov3JbHyAi,4,0,0,0,0,1,6,0,7,1.0,3,0.0,0,0,0,0,0,1,0,6,0,0,7,0
18652,172762,wbFZf0vBGr8ZagqGAnXAxrCWXPqmHozC,fbPkOYLVPtPgIt0MxizjfFJov3JbHyAi,2,0,0,0,0,0,2,0,2,0.2857142857142857,1,0.0,0,0,0,0,0,0,0,2,0,0,2,0
18653,172765,FCKT6MkDLYtXjU09PIKyFBtLX8xJDhrf,fbPkOYLVPtPgIt0MxizjfFJov3JbHyAi,7,8,3,0,3,0,3,0,17,2.4285714285714284,1,0.0,2,3,0,3,6,0,0,3,0,8,9,1
18654,172767,fJdUKH8czX92V7yfMeG7e087z1xbQDMc,fbPkOYLVPtPgIt0MxizjfFJov3JbHyAi,8,4,2,8,2,0,3,0,19,2.7142857142857144,1,0.0,1,2,6,2,3,0,2,3,0,11,8,0
18655,172768,fxBTxCWQMcuL1ujf7SabjHZ1ZIFJ9pkF,fbPkOYLVPtPgIt0MxizjfFJov3JbHyAi,9,3,2,0,2,4,5,1,17,2.4285714285714284,1,0.0,0,2,0,2,3,4,0,5,1,4,13,0
18656,172769,FhtwGNNoWtYYBXhYRu77jAPRU1UPxpBL,fbPkOYLVPtPgIt0MxizjfFJov3JbHyAi,6,2,1,0,1,1,6,0,11,1.5714285714285714,1,0.0,0,1,0,1,2,1,0,6,0,2,9,1
18657,172771,KE5lO6aSQLCwVE0O69z4EJfWuRdL7m4s,fbPkOYLVPtPgIt0MxizjfFJov3JbHyAi,4,3,0,0,0,0,2,0,5,0.7142857142857143,1,0.0,0,0,0,0,3,0,0,2,0,0,5,1
18658,172772,LtzhMvffdYGC90eIPWCLXgtedBYYH9fM,fbPkOYLVPtPgIt0MxizjfFJov3JbHyAi,9,10,6,0,4,0,4,0,24,3.4285714285714284,1,0.0,0,6,0,4,10,0,0,4,0,10,14,1
18659,172774,gB5HWH0mOh0kDVOfQI64mBbfnIbkstH2,fbPkOYLVPtPgIt0MxizjfFJov3JbHyAi,1,0,0,0,0,0,2,0,2,0.2857142857142857,1,0.0,0,0,0,0,0,0,0,2,0,0,2,1
18660,172777,auNkHGu4Rt8vZQ9zNGbUczKKhC4c3uzs,fbPkOYLVPtPgIt0MxizjfFJov3JbHyAi,2,0,0,0,0,0,3,0,3,0.42857142857142855,1,0.0,0,0,0,0,0,0,0,3,0,0,3,1
18661,172778,u9U6O6GxVn6L6EV5GIFg6G5cI8qZfIM1,fbPkOYLVPtPgIt0MxizjfFJov3JbHyAi,11,17,8,10,8,0,3,0,46,6.571428571428571,2,0.0,7,8,7,8,10,0,3,3,0,30,16,1
18662,172782,hBqYoPWGXo4KdSE3ypv2nDXmsYrpwKgj,fbPkOYLVPtPgIt0MxizjfFJov3JbHyAi,1,0,0,0,0,0,1,0,1,0.14285714285714285,1,0.0,0,0,0,0,0,0,0,1,0,0,1,1
18663,172785,C87lmiSHSHpPfjMHbWD8ZXVnLweVELbL,fbPkOYLVPtPgIt0MxizjfFJov3JbHyAi,7,5,4,0,4,0,2,0,15,2.142857142857143,1,0.0,0,4,0,4,5,0,0,2,0,8,7,0
18664,172786,W2QJpo3u65dH7Vg4ELU4fWWnd2h7zvJo,fbPkOYLVPtPgIt0MxizjfFJov3JbHyAi,7,3,2,0,2,0,2,0,9,1.2857142857142858,1,0.0,0,2,0,2,3,0,0,2,0,4,5,1
18665,172788,AdGrDPzRCdhLnxw2bXPrqz4KpvoO53Dv,fbPkOYLVPtPgIt0MxizjfFJov3JbHyAi,1,0,0,0,0,0,1,0,1,0.14285714285714285,1,0.0,0,0,0,0,0,0,0,1,0,0,1,1
18666,173101,Sy0IBVghIdDN5uhsYaAtE4EZP4lbDR6C,bWdj2GDclj5ofokWjzoa5jAwMkxCykd6,6,3,2,0,2,0,1,0,8,1.1428571428571428,2,0.0,0,2,0,2,3,0,0,1,0,4,4,1
18667,173108,uRoRagoJb7klyYml2W2nJUADMGnmCLCh,A3fsA9Zfv1X2fVEQhTw51lKENdNrEqT3,5,5,0,0,0,0,2,0,7,1.0,1,0.0,0,0,0,0,5,0,0,2,0,0,7,1
18668,173115,WhBYED4roEqwKdd7WRGAiWGZl1X7zVBC,SpATywNh6bZuzm8s1ceuBUnMUAeoAHHw,22,17,8,18,7,0,2,0,52,7.428571428571429,1,0.0,2,8,15,7,15,0,3,2,0,32,20,1
18669,173122,MeAthuGTC0Mssqzv92bAUQ6CjEcP1h8d,A3fsA9Zfv1X2fVEQhTw51lKENdNrEqT3,71,85,64,188,27,52,18,2,436,62.285714285714285,3,0.0,3,64,139,27,82,52,49,18,2,233,203,0
18670,173128,6qUqUreFzudXqhzjQZQMQuj6XiqDCHSF,bWdj2GDclj5ofokWjzoa5jAwMkxCykd6,9,8,4,0,2,0,3,0,17,2.4285714285714284,1,0.0,0,4,0,2,8,0,0,3,0,6,11,1
18671,173137,jV4bQZTO8NhEnxumKD5qHxnk6auhtohn,SpATywNh6bZuzm8s1ceuBUnMUAeoAHHw,27,34,16,42,4,0,9,0,105,15.0,3,0.0,10,16,37,4,24,0,5,9,0,67,38,0
18672,173147,60Dduz8CDLu92eVkbOGEahQqaVwXLhUV,A3fsA9Zfv1X2fVEQhTw51lKENdNrEqT3,16,10,7,0,7,0,5,0,29,4.142857142857143,2,0.0,0,7,0,7,10,0,0,5,0,14,15,1
18673,173166,84jM92o4oluSWHz68fjJdNU1O5aejzX8,A3fsA9Zfv1X2fVEQhTw51lKENdNrEqT3,1,0,0,0,0,0,1,0,1,0.14285714285714285,1,0.0,0,0,0,0,0,0,0,1,0,0,1,1
18674,173167,R2PVhKsPZcwfUBkw7hJ62cbr2j1XWSh4,SpATywNh6bZuzm8s1ceuBUnMUAeoAHHw,12,17,10,0,6,1,5,2,41,5.857142857142857,2,0.0,4,10,0,6,13,1,0,5,2,20,21,1
18675,173171,HsOuSjJr2KKry0RFy7J8sS4QwH7Xk1dF,SpATywNh6bZuzm8s1ceuBUnMUAeoAHHw,23,27,17,0,12,13,11,1,81,11.571428571428571,2,0.0,7,17,0,12,20,13,0,11,1,36,45,1
18676,173196,Onur1k8BbMmdXS69pUJADE01Ed10y0pN,5X6FeZozNMgE2VRi3MJYjkkFK8SETtu2,14,14,3,16,9,0,5,0,47,6.714285714285714,1,0.0,10,3,13,9,4,0,3,5,0,35,12,1
18677,173197,zqUAGRJeRsAIzVzBuppa7Q4T67s4AWlA,5X6FeZozNMgE2VRi3MJYjkkFK8SETtu2,10,5,3,0,1,7,10,1,27,3.857142857142857,1,0.0,0,3,0,1,5,7,0,10,1,4,23,1
18678,173202,GhGGPl8wZwtcLQZXvpUQjKC1TVd0CdDS,bWdj2GDclj5ofokWjzoa5jAwMkxCykd6,8,1,1,0,1,1,9,1,14,2.0,1,0.0,0,1,0,1,1,1,0,9,1,2,12,1
18679,173205,CXCWo7FvfWmDFvByuj4kADS8SZwH1QxN,SpATywNh6bZuzm8s1ceuBUnMUAeoAHHw,2,0,0,0,0,0,2,0,2,0.2857142857142857,1,0.0,0,0,0,0,0,0,0,2,0,0,2,1
18680,173217,55qFOvzjFp79P87tCKKcDPlhphK7gh3v,A3fsA9Zfv1X2fVEQhTw51lKENdNrEqT3,1,0,0,0,0,0,1,0,1,0.14285714285714285,1,0.0,0,0,0,0,0,0,0,1,0,0,1,1
18681,173218,RXXY4sAswYRo10grAYknhMWNw9Y2YFYb,SpATywNh6bZuzm8s1ceuBUnMUAeoAHHw,16,11,5,11,5,0,20,0,52,7.428571428571429,2,0.0,1,5,10,5,10,0,1,20,0,21,31,0
18682,173228,v7cnqM7vYgsjiGOlSwxgim0qVwuXESGN,RXDvfPUBYFlVdlueBFbLW0mhhAyGEqpt,7,4,2,0,1,0,2,0,9,1.2857142857142858,1,0.0,0,2,0,1,4,0,0,2,0,3,6,1
18683,173243,XPZ2qUEZKADAXZXErutkhGpDp6JKqGtI,SpATywNh6bZuzm8s1ceuBUnMUAeoAHHw,15,13,6,14,4,0,6,0,43,6.142857142857143,1,0.0,6,6,13,4,7,0,1,6,0,29,14,1
18684,173247,WLAmx1xu6Oqj4DvlomeHAJXvMyktUiPG,SpATywNh6bZuzm8s1ceuBUnMUAeoAHHw,28,55,1,19,0,0,12,0,87,12.428571428571429,5,0.0,6,1,19,0,49,0,0,12,0,26,61,0
18685,173251,R5nDIhuemBUVJIMEekOzsWhsz8ABh67H,SpATywNh6bZuzm8s1ceuBUnMUAeoAHHw,3,2,0,0,0,0,2,0,4,0.5714285714285714,1,0.0,0,0,0,0,2,0,0,2,0,0,4,1
18686,173255,Utj92TYHIWVfdmSDWLIJybQdBOyLbHqU,SpATywNh6bZuzm8s1ceuBUnMUAeoAHHw,7,2,0,0,0,0,7,1,10,1.4285714285714286,1,0.0,0,0,0,0,2,0,0,7,1,0,10,1
18687,173261,0S6LD77Xb8NCAw50mR3BuCC8qj8MNTO7,SpATywNh6bZuzm8s1ceuBUnMUAeoAHHw,7,6,1,0,0,2,4,0,13,1.8571428571428572,2,0.0,0,1,0,0,6,2,0,4,0,1,12,1
18688,173271,5uCuxLE5XjM4y4nmjuWckCuNM8tm7Xz4,RXDvfPUBYFlVdlueBFbLW0mhhAyGEqpt,41,40,2,115,3,11,6,1,178,25.428571428571427,2,0.0,15,2,108,3,25,11,7,6,1,128,50,1
18689,173306,8NK3iaPYRi5tDjzHZVNIqLtQMUnR3yyG,SpATywNh6bZuzm8s1ceuBUnMUAeoAHHw,2,0,0,0,0,0,2,0,2,0.2857142857142857,1,0.0,0,0,0,0,0,0,0,2,0,0,2,1
18690,173325,CS2NVGM14Xy1CNBgiOvv29fLyH8Y1bY8,SpATywNh6bZuzm8s1ceuBUnMUAeoAHHw,5,3,2,0,0,0,2,0,7,1.0,1,0.0,0,2,0,0,3,0,0,2,0,2,5,1
18691,173333,ljhELjrE7nbOy1tZAQRzQ0d2zvHLtBFk,bWdj2GDclj5ofokWjzoa5jAwMkxCykd6,4,5,2,0,2,0,1,0,10,1.4285714285714286,1,0.0,0,2,0,2,5,0,0,1,0,4,6,1
18692,173335,XXmlSdsGrMmHZfufZWdeObNOjT4zg6AW,G8EPVSXsOYB5YQWZGiz1aVq5Pgr2GrQu,16,11,1,34,0,0,2,0,48,6.857142857142857,1,0.0,0,1,28,0,11,0,6,2,0,29,19,1
18693,173337,d5wcSNGd1z76FQrsNvFOCxhoOHps5LtC,bWdj2GDclj5ofokWjzoa5jAwMkxCykd6,1,0,0,0,0,0,1,0,1,0.14285714285714285,1,0.0,0,0,0,0,0,0,0,1,0,0,1,1
18694,173338,l1rg3D8Gp1lv7dbBBYKvzTS3OZ5DRjWH,5X6FeZozNMgE2VRi3MJYjkkFK8SETtu2,7,3,2,0,2,0,2,0,9,1.2857142857142858,1,0.0,0,2,0,2,3,0,0,2,0,4,5,1
18695,173342,WsU7antS0XD0DLnUCoai3UEBgeJYqPfD,A3fsA9Zfv1X2fVEQhTw51lKENdNrEqT3,2,0,0,0,0,0,4,0,4,0.5714285714285714,1,0.0,0,0,0,0,0,0,0,4,0,0,4,1
18696,173356,SNwjM74zr1JfG7EVwxCRYPHz9bZcobb2,SpATywNh6bZuzm8s1ceuBUnMUAeoAHHw,1,0,0,0,0,0,1,0,1,0.14285714285714285,1,0.0,0,0,0,0,0,0,0,1,0,0,1,0
18697,173360,yZNPokdjhDRHAxyvIoZvfNcgrX1hi17e,SpATywNh6bZuzm8s1ceuBUnMUAeoAHHw,4,2,1,0,1,0,1,0,5,0.7142857142857143,2,0.0,0,1,0,1,2,0,0,1,0,2,3,1
18698,173369,2k8fsIzv9gal41vCmwSZyNE8PhUZWRlf,SpATywNh6bZuzm8s1ceuBUnMUAeoAHHw,18,16,7,23,3,1,10,1,61,8.714285714285714,1,0.0,4,7,19,3,12,1,4,10,1,33,28,0
18699,173371,gx5zIbRkvVmYAkHaGQMR5zm5BpTwVwIe,SpATywNh6bZuzm8s1ceuBUnMUAeoAHHw,6,3,1,0,1,0,2,0,7,1.0,1,0.0,0,1,0,1,3,0,0,2,0,2,5,1
18700,173377,yXswtM5JLeFOmbJVeZSujYIJ6Bw6uTnK,5X6FeZozNMgE2VRi3MJYjkkFK8SETtu2,1,0,0,0,0,0,1,0,1,0.14285714285714285,1,0.0,0,0,0,0,0,0,0,1,0,0,1,1
18701,173385,6zkfkzRggPwWg3UZoQWcyxzfEM8AGlOj,5X6FeZozNMgE2VRi3MJYjkkFK8SETtu2,1,0,0,0,0,0,1,0,1,0.14285714285714285,1,0.0,0,0,0,0,0,0,0,1,0,0,1,1
18702,173397,PUvUSLbNhJCmhl8hY6hN43xWGmaNTEJm,SpATywNh6bZuzm8s1ceuBUnMUAeoAHHw,4,4,1,0,0,0,3,0,8,1.1428571428571428,2,0.0,0,1,0,0,4,0,0,3,0,1,7,1
18703,173411,Mum77MZ1mdjN6HFQFByj0Ds7jbAp3P8k,G8EPVSXsOYB5YQWZGiz1aVq5Pgr2GrQu,6,0,0,0,0,1,5,0,6,0.8571428571428571,1,0.0,0,0,0,0,0,1,0,5,0,0,6,1
18704,173420,OIunh5VlGgmCbVp6rN8NSUpYr9NyGfUf,SpATywNh6bZuzm8s1ceuBUnMUAeoAHHw,7,6,3,0,2,0,1,0,12,1.7142857142857142,1,0.0,0,3,0,2,6,0,0,1,0,5,7,1
18705,173454,j5Ehqr4JpEaPpLQaRCbPvKZDUsPQTugX,bWdj2GDclj5ofokWjzoa5jAwMkxCykd6,1,0,0,0,0,0,1,0,1,0.14285714285714285,1,0.0,0,0,0,0,0,0,0,1,0,0,1,1
18706,173461,l1rg3D8Gp1lv7dbBBYKvzTS3OZ5DRjWH,G8EPVSXsOYB5YQWZGiz1aVq5Pgr2GrQu,1,0,0,0,0,0,1,0,1,0.14285714285714285,1,0.0,0,0,0,0,0,0,0,1,0,0,1,1
18707,173473,drbDbeyMCCsWxOOyHvPueP03lfvUAkGe,bWdj2GDclj5ofokWjzoa5jAwMkxCykd6,1,0,0,0,0,0,2,0,2,0.2857142857142857,1,0.0,0,0,0,0,0,0,0,2,0,0,2,1
18708,173485,Gj6yrFuP2L0UySRxwG1ZhYaHhmyFPckw,SpATywNh6bZuzm8s1ceuBUnMUAeoAHHw,8,7,4,0,3,0,3,0,17,2.4285714285714284,2,0.0,1,4,0,3,6,0,0,3,0,8,9,1
18709,173497,2XXif95hPztKoUUhClFIQsvkcA4F6WPm,SpATywNh6bZuzm8s1ceuBUnMUAeoAHHw,1,0,0,0,0,0,1,0,1,0.14285714285714285,1,0.0,0,0,0,0,0,0,0,1,0,0,1,1
18710,173503,MCzItgyS8iSbD1IkbXNJceX9NOFHlbyx,SpATywNh6bZuzm8s1ceuBUnMUAeoAHHw,1,0,0,0,0,0,1,0,1,0.14285714285714285,1,0.0,0,0,0,0,0,0,0,1,0,0,1,1
18711,173504,r5DVNivQqR7zEdPGXI8XjDMOM8jGXSCY,bWdj2GDclj5ofokWjzoa5jAwMkxCykd6,14,12,8,10,8,0,3,0,41,5.857142857142857,1,0.0,2,8,8,8,10,0,2,3,0,26,15,1
18712,173505,SZ5q3TqDiWq8s23sHXWpsG5po2IH5JPk,5X6FeZozNMgE2VRi3MJYjkkFK8SETtu2,18,20,5,20,10,0,2,0,57,8.142857142857142,2,0.0,13,5,18,10,7,0,2,2,0,46,11,1
18713,173506,aV96dKmuiAXZCpnpQwDdasPAhwqE3nqd,A3fsA9Zfv1X2fVEQhTw51lKENdNrEqT3,2,0,0,0,0,0,2,0,2,0.2857142857142857,1,0.0,0,0,0,0,0,0,0,2,0,0,2,1
18714,173511,AhSpjmDGb1sSCvDYt3Ot7jjy0f3gxRE7,SpATywNh6bZuzm8s1ceuBUnMUAeoAHHw,9,12,7,0,3,1,9,2,34,4.857142857142857,2,0.0,0,7,0,3,12,1,0,9,2,10,24,1
18715,173512,6bfN4bZg88fPQ84WPMXzkUepeo1lqShn,SpATywNh6bZuzm8s1ceuBUnMUAeoAHHw,18,11,9,10,6,1,4,0,41,5.857142857142857,1,0.0,0,9,9,6,11,1,1,4,0,24,17,1
18716,173522,3g8DXQOSCHdJiP6LWe15l41X630A24i1,SpATywNh6bZuzm8s1ceuBUnMUAeoAHHw,1,0,0,0,0,0,1,0,1,0.14285714285714285,1,0.0,0,0,0,0,0,0,0,1,0,0,1,1
18717,173530,Zf1Jc5QcquhjoJHRxG4pap7I4hzRTYJR,A3fsA9Zfv1X2fVEQhTw51lKENdNrEqT3,7,3,2,0,2,0,2,0,9,1.2857142857142858,1,0.0,0,2,0,2,3,0,0,2,0,4,5,1
18718,173535,uZJ608ZEkxlVFGqNKhsCeDZLWUbA4PD1,SpATywNh6bZuzm8s1ceuBUnMUAeoAHHw,6,4,1,0,1,0,2,0,8,1.1428571428571428,1,0.0,0,1,0,1,4,0,0,2,0,2,6,1
18719,173548,4FxJMUgmuz0VWA8d9le3ZfFA82TMBA1F,SpATywNh6bZuzm8s1ceuBUnMUAeoAHHw,2,0,0,0,0,0,3,0,3,0.42857142857142855,1,0.0,0,0,0,0,0,0,0,3,0,0,3,1
18720,173567,ikPOJW9YXh94C3mCvABDqiGTiH3LcmdS,SpATywNh6bZuzm8s1ceuBUnMUAeoAHHw,7,4,1,0,0,0,3,0,8,1.1428571428571428,1,0.0,0,1,0,0,4,0,0,3,0,1,7,1
18721,173571,G8jKS2LX80mKysjSCHh84D1ShEGtlmZQ,SpATywNh6bZuzm8s1ceuBUnMUAeoAHHw,7,4,3,0,3,0,2,0,12,1.7142857142857142,1,0.0,0,3,0,3,4,0,0,2,0,6,6,1
18722,173591,qggUO4B0NhIPqMhJwgIAZM8ZaIbpr9nE,SpATywNh6bZuzm8s1ceuBUnMUAeoAHHw,4,2,1,0,1,0,1,0,5,0.7142857142857143,1,0.0,0,1,0,1,2,0,0,1,0,2,3,1
18723,173594,fPM57KFy9Z8MO9ygSzYz3vMhCvMUYCpW,SpATywNh6bZuzm8s1ceuBUnMUAeoAHHw,5,5,0,0,0,0,2,0,7,1.0,2,0.0,0,0,0,0,5,0,0,2,0,0,7,1
18724,173599,5tgxttwTGvGdqr8cj2QgTLRxUmP4TAY4,G8EPVSXsOYB5YQWZGiz1aVq5Pgr2GrQu,7,6,4,0,0,0,1,0,11,1.5714285714285714,1,0.0,0,4,0,0,6,0,0,1,0,4,7,1
18725,173608,cVDuOruQUULBpBiSrn6neQHWcaxV13ev,SpATywNh6bZuzm8s1ceuBUnMUAeoAHHw,5,3,0,0,0,0,2,0,5,0.7142857142857143,1,0.0,0,0,0,0,3,0,0,2,0,0,5,1
18726,173619,NEbJzZEXqlwyFwC2i2g8PArymW3iyx3y,SpATywNh6bZuzm8s1ceuBUnMUAeoAHHw,10,10,1,4,0,0,1,0,16,2.2857142857142856,1,0.0,3,1,4,0,7,0,0,1,0,8,8,1
18727,173626,aEIz8d9s1BC7n4fBeFuKK0VhLVqwpGhk,SpATywNh6bZuzm8s1ceuBUnMUAeoAHHw,29,25,14,28,6,38,24,3,138,19.714285714285715,2,0.0,6,14,24,6,19,38,4,24,3,50,88,0
18728,173633,XuL8lTuXJkhtcwxnA03sTLCPIFTjXstS,bWdj2GDclj5ofokWjzoa5jAwMkxCykd6,2,0,0,0,0,0,2,0,2,0.2857142857142857,1,0.0,0,0,0,0,0,0,0,2,0,0,2,0
18729,173640,CP7mFPmxcr1zJrcc0p3DHzVha0nwF2aG,SpATywNh6bZuzm8s1ceuBUnMUAeoAHHw,1,0,0,0,0,0,1,0,1,0.14285714285714285,1,0.0,0,0,0,0,0,0,0,1,0,0,1,1
18730,173668,3HZ5DvQGYoFNduhiKa7ozq49cGyUlk4Z,SpATywNh6bZuzm8s1ceuBUnMUAeoAHHw,6,5,2,0,2,0,2,0,11,1.5714285714285714,1,0.0,0,2,0,2,5,0,0,2,0,4,7,0
18731,173683,zKbFB2XJ8gemmfPKgB0q2D34TEqFCaPJ,SpATywNh6bZuzm8s1ceuBUnMUAeoAHHw,14,15,9,2,5,1,4,0,36,5.142857142857143,2,0.0,2,9,2,5,13,1,0,4,0,18,18,1
18732,173713,egPy9UABAfgaiori25BYfS5YDOglEmVj,5X6FeZozNMgE2VRi3MJYjkkFK8SETtu2,1,0,0,0,0,0,1,0,1,0.14285714285714285,1,0.0,0,0,0,0,0,0,0,1,0,0,1,1
18733,173716,egPy9UABAfgaiori25BYfS5YDOglEmVj,A3fsA9Zfv1X2fVEQhTw51lKENdNrEqT3,2,0,0,0,0,0,3,0,3,0.42857142857142855,1,0.0,0,0,0,0,0,0,0,3,0,0,3,0
18734,173736,4c2V13oAQFO59UU1chPRZLOl7FAujTC1,SpATywNh6bZuzm8s1ceuBUnMUAeoAHHw,6,3,1,0,1,0,2,0,7,1.0,1,0.0,0,1,0,1,3,0,0,2,0,2,5,1
18735,173756,erRTxWjweQfemDfGIdFiZtJElfHYWRHc,bWdj2GDclj5ofokWjzoa5jAwMkxCykd6,7,7,4,0,1,0,1,0,13,1.8571428571428572,1,0.0,1,4,0,1,6,0,0,1,0,6,7,1
18736,173759,OO1JwGoh4BUjbVi8UpZSb7D59mBcs3nt,bWdj2GDclj5ofokWjzoa5jAwMkxCykd6,9,9,4,0,3,0,2,0,18,2.5714285714285716,2,0.0,0,4,0,3,9,0,0,2,0,7,11,1
18737,173769,V1ZkNQzruX55Th98WMMJPdYTYscmY4w6,G8EPVSXsOYB5YQWZGiz1aVq5Pgr2GrQu,4,3,1,0,0,0,2,0,6,0.8571428571428571,1,0.0,0,1,0,0,3,0,0,2,0,1,5,1
18738,173785,0fD6SAnP4saPahYnGKjue5y2gN1ArEeV,SpATywNh6bZuzm8s1ceuBUnMUAeoAHHw,5,5,0,0,0,0,1,0,6,0.8571428571428571,1,0.0,1,0,0,0,4,0,0,1,0,1,5,1
18739,173789,V49kN7knz1Exa9SGBoqDofPGVg1bZJ1X,SpATywNh6bZuzm8s1ceuBUnMUAeoAHHw,5,2,0,0,0,0,4,0,6,0.8571428571428571,1,0.0,0,0,0,0,2,0,0,4,0,0,6,1
18740,173799,4c2V13oAQFO59UU1chPRZLOl7FAujTC1,bWdj2GDclj5ofokWjzoa5jAwMkxCykd6,1,0,0,0,0,0,1,0,1,0.14285714285714285,1,0.0,0,0,0,0,0,0,0,1,0,0,1,1
18741,173800,dGPrMGXdE7T0kXaLgwTiDqQes2xGwEfE,SpATywNh6bZuzm8s1ceuBUnMUAeoAHHw,5,2,1,0,1,0,2,0,6,0.8571428571428571,1,0.0,0,1,0,1,2,0,0,2,0,2,4,1
18742,173809,5hyT5z1JULhKBFcJhS5p5DOzWWc2tHLq,RXDvfPUBYFlVdlueBFbLW0mhhAyGEqpt,4,4,0,0,0,0,2,0,6,0.8571428571428571,1,0.0,0,0,0,0,4,0,0,2,0,0,6,1
18743,173819,wGfXRYqHkdAo1fVEEY9NvW8qy6M9m0mI,5X6FeZozNMgE2VRi3MJYjkkFK8SETtu2,1,0,0,0,0,0,1,0,1,0.14285714285714285,1,0.0,0,0,0,0,0,0,0,1,0,0,1,1
18744,173822,7OJn5p0XJ3SSGp9HZOHLtXBrnpU9Ao4g,SpATywNh6bZuzm8s1ceuBUnMUAeoAHHw,2,0,0,0,0,0,2,0,2,0.2857142857142857,1,0.0,0,0,0,0,0,0,0,2,0,0,2,1
18745,173833,XM8B0k6MFN508SQSrRkwnYc2DfmjmqwC,SpATywNh6bZuzm8s1ceuBUnMUAeoAHHw,6,5,3,0,3,0,1,0,12,1.7142857142857142,1,0.0,0,3,0,3,5,0,0,1,0,6,6,1
18746,173841,L0oAkWkSvsRVgCYEWBvSdFU8AYt2U4nO,A3fsA9Zfv1X2fVEQhTw51lKENdNrEqT3,1,0,0,0,0,0,1,0,1,0.14285714285714285,1,0.0,0,0,0,0,0,0,0,1,0,0,1,1
18747,173846,0OgHQAVhQz83ex7oEMaYHMGoui5vuRU7,A3fsA9Zfv1X2fVEQhTw51lKENdNrEqT3,1,0,0,0,0,0,1,0,1,0.14285714285714285,1,0.0,0,0,0,0,0,0,0,1,0,0,1,1
18748,173849,quIYM1jY47tlZKkC1EmJRDFcBV4a3Pzy,SpATywNh6bZuzm8s1ceuBUnMUAeoAHHw,1,0,0,0,0,0,2,0,2,0.2857142857142857,1,0.0,0,0,0,0,0,0,0,2,0,0,2,1
18749,173851,quIYM1jY47tlZKkC1EmJRDFcBV4a3Pzy,5X6FeZozNMgE2VRi3MJYjkkFK8SETtu2,1,0,0,0,0,0,2,0,2,0.2857142857142857,1,0.0,0,0,0,0,0,0,0,2,0,0,2,1
18750,173856,CZSUlXr6WslbpIsEEc2qwnkdO6NycdZe,G8EPVSXsOYB5YQWZGiz1aVq5Pgr2GrQu,15,21,0,6,1,1,8,0,37,5.285714285714286,3,0.0,6,0,3,1,15,1,3,8,0,10,27,0
18751,173879,8jJMgDkLCzStXvEhF0AcTzprTsXGO4BQ,SpATywNh6bZuzm8s1ceuBUnMUAeoAHHw,6,3,2,0,2,0,1,0,8,1.1428571428571428,1,0.0,0,2,0,2,3,0,0,1,0,4,4,1
18752,173885,worFKZrD9eECXAuz5EQKtbbV0K7MG3Jl,bWdj2GDclj5ofokWjzoa5jAwMkxCykd6,7,3,2,0,2,0,2,0,9,1.2857142857142858,1,0.0,0,2,0,2,3,0,0,2,0,4,5,1
18753,173898,ufiE5JBFPedCyqKTJCAri6PUpUEK2djS,A3fsA9Zfv1X2fVEQhTw51lKENdNrEqT3,9,4,3,0,3,0,2,0,12,1.7142857142857142,1,0.0,0,3,0,3,4,0,0,2,0,6,6,1
18754,173920,5meVJnfzVUZ3TsgkTSkPAZOA5DSRKfSE,SpATywNh6bZuzm8s1ceuBUnMUAeoAHHw,6,3,1,0,1,0,3,0,8,1.1428571428571428,3,0.0,0,1,0,1,3,0,0,3,0,2,6,1
18755,173927,2jcDulxQhwaZp6ERelJB4WRzpPoEb0N3,G8EPVSXsOYB5YQWZGiz1aVq5Pgr2GrQu,28,25,12,46,9,5,12,0,109,15.571428571428571,3,0.0,9,12,38,9,16,5,8,12,0,68,41,1
18756,173940,f05G8U1bqnSeHR5uQ0LJ86uC0GQPzhAD,A3fsA9Zfv1X2fVEQhTw51lKENdNrEqT3,8,3,2,0,2,0,3,1,11,1.5714285714285714,1,0.0,0,2,0,2,3,0,0,3,1,4,7,1
18757,173941,wyGIkmkgUJs3OEbZedPOFJN1j5K0BFAm,SpATywNh6bZuzm8s1ceuBUnMUAeoAHHw,7,3,2,0,2,0,2,0,9,1.2857142857142858,1,0.0,0,2,0,2,3,0,0,2,0,4,5,1
18758,173954,wLc4w0avBex1xIgZCkms6IVr5BNBkA7D,SpATywNh6bZuzm8s1ceuBUnMUAeoAHHw,2,0,0,0,0,0,3,0,3,0.42857142857142855,1,0.0,0,0,0,0,0,0,0,3,0,0,3,1
18759,173962,wLc4w0avBex1xIgZCkms6IVr5BNBkA7D,5X6FeZozNMgE2VRi3MJYjkkFK8SETtu2,1,0,0,0,0,0,1,0,1,0.14285714285714285,1,0.0,0,0,0,0,0,0,0,1,0,0,1,1
18760,173964,my33FPQMSZttKqR0p8zRP2Bz5eCFTYNb,5X6FeZozNMgE2VRi3MJYjkkFK8SETtu2,4,2,0,0,0,0,2,1,5,0.7142857142857143,1,0.0,0,0,0,0,2,0,0,2,1,0,5,1
18761,174004,GEhSrQJnDGIPtxSV48fF8cpqKVHJt54S,RXDvfPUBYFlVdlueBFbLW0mhhAyGEqpt,1,0,0,0,0,0,1,0,1,0.14285714285714285,1,0.0,0,0,0,0,0,0,0,1,0,0,1,1
18762,174006,GEhSrQJnDGIPtxSV48fF8cpqKVHJt54S,G8EPVSXsOYB5YQWZGiz1aVq5Pgr2GrQu,1,0,0,0,0,0,2,0,2,0.2857142857142857,1,0.0,0,0,0,0,0,0,0,2,0,0,2,1
18763,174007,ylJgBhkBjfNNAcgSF9OKq7fmYB5lgYf4,G8EPVSXsOYB5YQWZGiz1aVq5Pgr2GrQu,15,16,0,6,2,1,9,1,35,5.0,1,0.0,8,0,3,2,8,1,3,9,1,13,22,1
18764,174023,qCRa9Z4oZ6HdXxtc9b3V1X8DNEfTKusC,SpATywNh6bZuzm8s1ceuBUnMUAeoAHHw,9,15,6,0,0,0,8,1,30,4.285714285714286,3,0.0,1,6,0,0,14,0,0,8,1,7,23,1
18765,174033,5meVJnfzVUZ3TsgkTSkPAZOA5DSRKfSE,G8EPVSXsOYB5YQWZGiz1aVq5Pgr2GrQu,17,17,3,28,3,0,5,0,56,8.0,4,0.0,1,3,25,3,16,0,3,5,0,32,24,1
18766,174062,LV2ZqzgejnQSlgBX64qrhkASE0YDX4Nk,5X6FeZozNMgE2VRi3MJYjkkFK8SETtu2,4,2,1,0,1,0,1,0,5,0.7142857142857143,1,0.0,0,1,0,1,2,0,0,1,0,2,3,1
18767,174069,kj5o7wMZl1s4q0cggcmipnm7O7L6g4Ps,A3fsA9Zfv1X2fVEQhTw51lKENdNrEqT3,4,2,1,0,1,0,1,0,5,0.7142857142857143,1,0.0,0,1,0,1,2,0,0,1,0,2,3,1
18768,174086,Q3T5Pj9Os86NEqSmgUZNRoi8BUkSoDlj,5X6FeZozNMgE2VRi3MJYjkkFK8SETtu2,4,3,1,0,1,0,1,0,6,0.8571428571428571,1,0.0,0,1,0,1,3,0,0,1,0,2,4,1
18769,174094,YbJnM4aRUVyy4lj5U7KoiyOh79gNSdfq,5X6FeZozNMgE2VRi3MJYjkkFK8SETtu2,1,0,0,0,0,0,1,0,1,0.14285714285714285,1,0.0,0,0,0,0,0,0,0,1,0,0,1,1
18770,174113,exn3Chqg3cdAcaAWKVncMLTyArQT03uh,SpATywNh6bZuzm8s1ceuBUnMUAeoAHHw,1,0,0,0,0,0,1,0,1,0.14285714285714285,1,0.0,0,0,0,0,0,0,0,1,0,0,1,1
18771,174123,vAGOe6e2RHZZ1EaDZrX2SIPJIAyfl840,SpATywNh6bZuzm8s1ceuBUnMUAeoAHHw,16,20,11,14,7,1,6,0,59,8.428571428571429,3,0.0,7,11,14,7,13,1,0,6,0,39,20,1
18772,174129,uqlgX8A7SUtqJk3Mbczq0KHvMYCvfzG2,5X6FeZozNMgE2VRi3MJYjkkFK8SETtu2,2,0,0,0,0,0,2,0,2,0.2857142857142857,1,0.0,0,0,0,0,0,0,0,2,0,0,2,1
18773,174132,JCoigkJDdJ3HsiIMjInfwYucYJL9vwo0,SpATywNh6bZuzm8s1ceuBUnMUAeoAHHw,3,0,0,0,0,3,2,0,5,0.7142857142857143,1,0.0,0,0,0,0,0,3,0,2,0,0,5,1
18774,174137,bpg5GXp9dzB6QmyT9ugqcjAogW2XrJ6V,A3fsA9Zfv1X2fVEQhTw51lKENdNrEqT3,13,21,5,0,3,1,11,1,42,6.0,2,0.0,3,5,0,3,18,1,0,11,1,11,31,1
18775,174145,hkyduknaDdkH1HJr9UkRJTFi9zraFQAD,bWdj2GDclj5ofokWjzoa5jAwMkxCykd6,1,0,0,0,0,0,1,0,1,0.14285714285714285,1,0.0,0,0,0,0,0,0,0,1,0,0,1,1
18776,174150,kj5o7wMZl1s4q0cggcmipnm7O7L6g4Ps,5X6FeZozNMgE2VRi3MJYjkkFK8SETtu2,2,0,0,0,0,0,2,0,2,0.2857142857142857,1,0.0,0,0,0,0,0,0,0,2,0,0,2,0
18777,174161,P6kyYSEKKZ0iHfKyFCH0qmij523H8pkT,5X6FeZozNMgE2VRi3MJYjkkFK8SETtu2,4,2,0,0,0,0,3,0,5,0.7142857142857143,2,0.0,0,0,0,0,2,0,0,3,0,0,5,1
18778,174164,osRDAcCAd45utdgmq4pkwlsU7g3nJpqb,SpATywNh6bZuzm8s1ceuBUnMUAeoAHHw,9,5,3,0,1,1,8,1,19,2.7142857142857144,1,0.0,0,3,0,1,5,1,0,8,1,4,15,1
18779,174176,w0gcF7HyzsXAZFiicWTJytmCnNq4PSCG,bWdj2GDclj5ofokWjzoa5jAwMkxCykd6,2,0,0,0,0,0,2,0,2,0.2857142857142857,1,0.0,0,0,0,0,0,0,0,2,0,0,2,0
18780,174180,IcbiyGfugViHKrRGeKalQAZxzQcRgoyB,A3fsA9Zfv1X2fVEQhTw51lKENdNrEqT3,21,24,12,4,9,0,2,0,51,7.285714285714286,2,0.0,0,12,3,9,24,0,1,2,0,24,27,0
18781,174191,nzlGlMNKXi0UdFirNX3xHB3tsyudhSZw,bWdj2GDclj5ofokWjzoa5jAwMkxCykd6,3,2,0,0,0,0,2,0,4,0.5714285714285714,1,0.0,0,0,0,0,2,0,0,2,0,0,4,1
18782,174199,M4qxCm572dyAklYyW6rlwVA2xGuuy2h9,5X6FeZozNMgE2VRi3MJYjkkFK8SETtu2,1,0,0,0,0,0,1,0,1,0.14285714285714285,1,0.0,0,0,0,0,0,0,0,1,0,0,1,1
18783,174214,VDwK5GjNxjIBIFJ8IiUz3hJdb2yL61fP,5X6FeZozNMgE2VRi3MJYjkkFK8SETtu2,2,0,0,0,0,0,3,0,3,0.42857142857142855,1,0.0,0,0,0,0,0,0,0,3,0,0,3,1
18784,174215,nzlGlMNKXi0UdFirNX3xHB3tsyudhSZw,A3fsA9Zfv1X2fVEQhTw51lKENdNrEqT3,2,0,0,0,0,0,2,0,2,0.2857142857142857,1,0.0,0,0,0,0,0,0,0,2,0,0,2,1
18785,174216,6CvCYVrFGBiuqZvZsIm2rGLzCSub3t09,SpATywNh6bZuzm8s1ceuBUnMUAeoAHHw,1,0,0,0,0,0,1,0,1,0.14285714285714285,1,0.0,0,0,0,0,0,0,0,1,0,0,1,0
18786,174245,AUQbcN6sP8jOc3r7pDcomR6R8baoxLvG,A3fsA9Zfv1X2fVEQhTw51lKENdNrEqT3,1,0,0,0,0,0,1,0,1,0.14285714285714285,1,0.0,0,0,0,0,0,0,0,1,0,0,1,1
18787,174261,9D8Fr85Y0xJSTSvXENunTRQkQQzpKKhe,A3fsA9Zfv1X2fVEQhTw51lKENdNrEqT3,2,0,0,0,0,3,1,0,4,0.5714285714285714,1,0.0,0,0,0,0,0,3,0,1,0,0,4,1
18788,174270,JBAytsWAbTeV6GWhSZsHWNpJgF2JgbBV,SpATywNh6bZuzm8s1ceuBUnMUAeoAHHw,10,10,5,0,3,0,4,0,22,3.142857142857143,1,0.0,0,5,0,3,10,0,0,4,0,8,14,1
18789,174284,Z6SakRvyvh7ZuaV4DHEE1b3QLOpPcfOm,5X6FeZozNMgE2VRi3MJYjkkFK8SETtu2,5,4,0,0,0,0,1,0,5,0.7142857142857143,1,0.0,0,0,0,0,4,0,0,1,0,0,5,1
18790,174307,8cEAUyffHekiZonoKVizh2shGTTIPP8A,5X6FeZozNMgE2VRi3MJYjkkFK8SETtu2,6,14,2,2,4,0,3,0,25,3.5714285714285716,1,0.0,4,2,2,4,10,0,0,3,0,12,13,1
18791,174326,J3VXT3AGxePcqOmM7ZzWzkqh6USRsZv2,5X6FeZozNMgE2VRi3MJYjkkFK8SETtu2,1,0,0,0,0,0,2,0,2,0.2857142857142857,1,0.0,0,0,0,0,0,0,0,2,0,0,2,1
18792,174330,J3VXT3AGxePcqOmM7ZzWzkqh6USRsZv2,bWdj2GDclj5ofokWjzoa5jAwMkxCykd6,1,0,0,0,0,0,1,0,1,0.14285714285714285,1,0.0,0,0,0,0,0,0,0,1,0,0,1,1
18793,174333,J3VXT3AGxePcqOmM7ZzWzkqh6USRsZv2,A3fsA9Zfv1X2fVEQhTw51lKENdNrEqT3,1,0,0,0,0,0,1,0,1,0.14285714285714285,1,0.0,0,0,0,0,0,0,0,1,0,0,1,1
18794,174335,apRBg875HDkrVuiXCnSpAny1kVq4teuC,5X6FeZozNMgE2VRi3MJYjkkFK8SETtu2,1,0,0,0,0,0,1,0,1,0.14285714285714285,1,0.0,0,0,0,0,0,0,0,1,0,0,1,1
18795,174343,z5b37rtZXpcAYDG2omaxcs76JrGc20dV,SpATywNh6bZuzm8s1ceuBUnMUAeoAHHw,14,16,11,0,7,0,4,0,38,5.428571428571429,1,0.0,0,11,0,7,16,0,0,4,0,18,20,0
18796,174360,NiXPZUmEILmWUPwXexYxtHvaIL7QdjCQ,5X6FeZozNMgE2VRi3MJYjkkFK8SETtu2,1,0,0,0,0,0,1,0,1,0.14285714285714285,1,0.0,0,0,0,0,0,0,0,1,0,0,1,1
18797,174366,NiXPZUmEILmWUPwXexYxtHvaIL7QdjCQ,G8EPVSXsOYB5YQWZGiz1aVq5Pgr2GrQu,1,0,0,0,0,0,1,0,1,0.14285714285714285,1,0.0,0,0,0,0,0,0,0,1,0,0,1,1
18798,174374,kv6R7WjolUetaoWMs79hGLWsktu3yDdz,A3fsA9Zfv1X2fVEQhTw51lKENdNrEqT3,6,3,1,0,1,0,2,0,7,1.0,1,0.0,0,1,0,1,3,0,0,2,0,2,5,1
18799,174379,BeoWdDFNsVFqWVq3B4qjYh8vNjNTgwSB,A3fsA9Zfv1X2fVEQhTw51lKENdNrEqT3,9,13,7,0,1,0,18,0,39,5.571428571428571,3,0.0,1,7,0,1,12,0,0,18,0,9,30,1
18800,174420,LKippngJk3cGSHQFQuBifcn7F1qfi1gi,A3fsA9Zfv1X2fVEQhTw51lKENdNrEqT3,7,3,2,0,2,0,2,0,9,1.2857142857142858,1,0.0,0,2,0,2,3,0,0,2,0,4,5,1
18801,174441,TVb48KNX44nTfeYliD6K0aUmcz1Uhqk3,SpATywNh6bZuzm8s1ceuBUnMUAeoAHHw,1,0,0,0,0,0,3,0,3,0.42857142857142855,1,0.0,0,0,0,0,0,0,0,3,0,0,3,1
18802,174444,2dsmXUwyJ6i3C5akCdjurWqi0Hs9JJIw,A3fsA9Zfv1X2fVEQhTw51lKENdNrEqT3,4,2,1,0,1,0,1,0,5,0.7142857142857143,1,0.0,0,1,0,1,2,0,0,1,0,2,3,1
18803,174476,2N9sOZSDFqgItMU0I0RAvak4oCcmSCqn,SpATywNh6bZuzm8s1ceuBUnMUAeoAHHw,1,0,0,0,0,0,1,0,1,0.14285714285714285,1,0.0,0,0,0,0,0,0,0,1,0,0,1,1
18804,174477,2qErfPJEK7aTW1rziy33w8EhOiv9QEBF,5X6FeZozNMgE2VRi3MJYjkkFK8SETtu2,1,0,0,0,0,0,1,0,1,0.14285714285714285,1,0.0,0,0,0,0,0,0,0,1,0,0,1,1
18805,174509,VsE2LeE7ywjA9zrP4rgjvGL9Xd85duLx,5X6FeZozNMgE2VRi3MJYjkkFK8SETtu2,1,0,0,0,0,0,1,0,1,0.14285714285714285,1,0.0,0,0,0,0,0,0,0,1,0,0,1,1
18806,174511,4JCvqkgGduxKKeDEkCNb6gSmycI4iKkL,SpATywNh6bZuzm8s1ceuBUnMUAeoAHHw,6,3,2,0,1,0,2,0,8,1.1428571428571428,1,0.0,0,2,0,1,3,0,0,2,0,3,5,1
18807,174517,w9Tvfxwew7B8bZZNiNcsObnxcSHkChnX,5X6FeZozNMgE2VRi3MJYjkkFK8SETtu2,1,0,0,0,0,0,1,0,1,0.14285714285714285,1,0.0,0,0,0,0,0,0,0,1,0,0,1,1
18808,174524,OHjVywgSVBuE3jor7Q0ui9J2rATPYj5o,bWdj2GDclj5ofokWjzoa5jAwMkxCykd6,8,3,2,0,2,0,5,0,12,1.7142857142857142,1,0.0,0,2,0,2,3,0,0,5,0,4,8,1
18809,174526,YGWpaBK18BI7gxW0S5kJOHKnKUXsGFtx,SpATywNh6bZuzm8s1ceuBUnMUAeoAHHw,1,0,0,0,0,0,1,0,1,0.14285714285714285,1,0.0,0,0,0,0,0,0,0,1,0,0,1,1
18810,174534,uxH2QBwZxSFN9LkkI09Zd3NZx6wgvi3y,A3fsA9Zfv1X2fVEQhTw51lKENdNrEqT3,7,4,1,0,1,0,2,0,8,1.1428571428571428,1,0.0,0,1,0,1,4,0,0,2,0,2,6,1
18811,174562,wtDZ1vT1vZnNtf66B6E3homHnmEWYVrg,RXDvfPUBYFlVdlueBFbLW0mhhAyGEqpt,9,6,0,0,0,0,4,2,12,1.7142857142857142,1,0.0,0,0,0,0,6,0,0,4,2,0,12,1
18812,174567,GvWLI1Mjpde6Jh0s8HrsDR9KjfiyAndZ,5X6FeZozNMgE2VRi3MJYjkkFK8SETtu2,8,3,2,0,2,0,3,0,10,1.4285714285714286,1,0.0,0,2,0,2,3,0,0,3,0,4,6,1
18813,174588,GvWLI1Mjpde6Jh0s8HrsDR9KjfiyAndZ,SpATywNh6bZuzm8s1ceuBUnMUAeoAHHw,1,0,0,0,0,0,1,0,1,0.14285714285714285,1,0.0,0,0,0,0,0,0,0,1,0,0,1,1
18814,174592,Q80okLXehG3FaUclazDQaglICbThrfeN,A3fsA9Zfv1X2fVEQhTw51lKENdNrEqT3,12,4,2,0,2,0,9,1,18,2.5714285714285716,1,0.0,0,2,0,2,4,0,0,9,1,4,14,1
18815,174599,zbOrtc172Sp0ZiF8CTU6kMNb51nYxkNM,G8EPVSXsOYB5YQWZGiz1aVq5Pgr2GrQu,7,3,2,0,2,0,2,0,9,1.2857142857142858,1,0.0,0,2,0,2,3,0,0,2,0,4,5,1
18816,174614,TEtpertndC0kxUAzNDZsnaaHXZ1UiUgn,A3fsA9Zfv1X2fVEQhTw51lKENdNrEqT3,6,2,1,0,1,0,4,3,11,1.5714285714285714,1,0.0,0,1,0,1,2,0,0,4,3,2,9,1
18817,174621,egEAM55ohFZCeKZbLS4kJXezxBBDUuZO,SpATywNh6bZuzm8s1ceuBUnMUAeoAHHw,5,2,1,0,1,0,2,0,6,0.8571428571428571,1,0.0,0,1,0,1,2,0,0,2,0,2,4,1
18818,174624,oGK3c8nk6Ftl3V2u1zOvslszD4LDLr3w,SpATywNh6bZuzm8s1ceuBUnMUAeoAHHw,8,19,12,0,5,0,7,0,43,6.142857142857143,3,0.0,2,12,0,5,17,0,0,7,0,19,24,1
18819,174627,egEAM55ohFZCeKZbLS4kJXezxBBDUuZO,G8EPVSXsOYB5YQWZGiz1aVq5Pgr2GrQu,5,2,1,0,1,0,2,0,6,0.8571428571428571,1,0.0,0,1,0,1,2,0,0,2,0,2,4,1
18820,174640,kxEogtMmiGCs5fUFOyuDzAyzgV6L921E,5X6FeZozNMgE2VRi3MJYjkkFK8SETtu2,6,6,1,4,1,0,2,0,14,2.0,1,0.0,2,1,3,1,4,0,1,2,0,7,7,1
18821,174642,AuxkP8NAszvIKyEBwpG0mQcLLw7Eoojr,SpATywNh6bZuzm8s1ceuBUnMUAeoAHHw,6,4,1,0,1,0,2,0,8,1.1428571428571428,1,0.0,0,1,0,1,4,0,0,2,0,2,6,1
18822,174645,lJdTg9WUYwumFfeQmhmLXhBEAFP0NsAi,A3fsA9Zfv1X2fVEQhTw51lKENdNrEqT3,1,0,0,0,0,0,1,0,1,0.14285714285714285,1,0.0,0,0,0,0,0,0,0,1,0,0,1,1
18823,174652,mKdNKRnKsY7oY3LUCJFqlU9FBtiBixdP,SpATywNh6bZuzm8s1ceuBUnMUAeoAHHw,2,0,0,0,0,0,3,0,3,0.42857142857142855,1,0.0,0,0,0,0,0,0,0,3,0,0,3,1
18824,174664,6FBBfTPa9rAGe2i9z04q5KK2WXVduwvy,bWdj2GDclj5ofokWjzoa5jAwMkxCykd6,5,3,2,0,2,0,2,0,9,1.2857142857142858,1,0.0,0,2,0,2,3,0,0,2,0,4,5,1
18825,174670,Nt2MuvKq8ehhC9cDQZ9wTGuVcTn0ishD,bWdj2GDclj5ofokWjzoa5jAwMkxCykd6,1,0,0,0,0,0,1,0,1,0.14285714285714285,1,0.0,0,0,0,0,0,0,0,1,0,0,1,1
18826,174671,oseHKim5ugRciFh8lXIQ174blllPPfFO,G8EPVSXsOYB5YQWZGiz1aVq5Pgr2GrQu,6,5,2,0,1,0,2,0,10,1.4285714285714286,1,0.0,0,2,0,1,5,0,0,2,0,3,7,1
18827,174672,N5iDERl36Pe29yDG8gDe9a99dYgqwB7y,A3fsA9Zfv1X2fVEQhTw51lKENdNrEqT3,1,0,0,0,0,0,1,0,1,0.14285714285714285,1,0.0,0,0,0,0,0,0,0,1,0,0,1,1
18828,174690,DsHBF70w6SbplBHmPm6nRUC7pSdaJJWa,G8EPVSXsOYB5YQWZGiz1aVq5Pgr2GrQu,10,6,1,0,1,0,3,0,11,1.5714285714285714,1,0.0,0,1,0,1,6,0,0,3,0,2,9,1
18829,174691,5CEPXEXe8kyZX8bu6GUTNCOjuQHWI7O6,G8EPVSXsOYB5YQWZGiz1aVq5Pgr2GrQu,11,15,1,10,0,1,3,0,30,4.285714285714286,1,0.0,9,1,7,0,6,1,3,3,0,17,13,1
18830,174695,mu7Zdr1ChN6xNMWE8Otd7Si7TQhm7pEQ,bWdj2GDclj5ofokWjzoa5jAwMkxCykd6,6,5,3,0,2,0,5,0,15,2.142857142857143,2,0.0,0,3,0,2,5,0,0,5,0,5,10,1
18831,174696,5OhdzLluLI4b0UetZ6QtwaKcHtelD4GM,SpATywNh6bZuzm8s1ceuBUnMUAeoAHHw,1,0,0,0,0,0,1,0,1,0.14285714285714285,1,0.0,0,0,0,0,0,0,0,1,0,0,1,1
18832,174705,Ec3rYw74ZqWh1F7dxiEcLU29Nc2ci1fM,SpATywNh6bZuzm8s1ceuBUnMUAeoAHHw,1,0,0,0,0,0,1,0,1,0.14285714285714285,1,0.0,0,0,0,0,0,0,0,1,0,0,1,1
18833,174721,ogurveh5dgwQ7omkU0IctcIseCFtiniL,bWdj2GDclj5ofokWjzoa5jAwMkxCykd6,1,0,0,0,0,0,1,0,1,0.14285714285714285,1,0.0,0,0,0,0,0,0,0,1,0,0,1,0
18834,174722,ynJJFwajTtaKh2c9i2j2wRxuEmNuGHmW,SpATywNh6bZuzm8s1ceuBUnMUAeoAHHw,15,16,1,0,1,0,4,0,22,3.142857142857143,2,0.0,0,1,0,1,16,0,0,4,0,2,20,1
18835,174743,RGm3JAeEXLRP4KOsIq5BNnrMmXFgjKxb,SpATywNh6bZuzm8s1ceuBUnMUAeoAHHw,6,2,1,0,1,0,6,0,10,1.4285714285714286,1,0.0,0,1,0,1,2,0,0,6,0,2,8,1
18836,174771,wKNO0Jje7WXvAVQ9yfigFflnCrR4q8AL,RXDvfPUBYFlVdlueBFbLW0mhhAyGEqpt,2,0,0,0,0,0,2,0,2,0.2857142857142857,1,0.0,0,0,0,0,0,0,0,2,0,0,2,1
18837,174774,gPm1W1ZGaxTMbwnt8Qfxv6TCL5SZrMk2,SpATywNh6bZuzm8s1ceuBUnMUAeoAHHw,5,3,1,0,1,0,2,0,7,1.0,1,0.0,0,1,0,1,3,0,0,2,0,2,5,1
18838,174803,t0EDN5m0sWGzS7LPSyhC6BROmEBzl1eB,SpATywNh6bZuzm8s1ceuBUnMUAeoAHHw,7,3,2,0,2,0,2,0,9,1.2857142857142858,1,0.0,0,2,0,2,3,0,0,2,0,4,5,1
18839,174807,UqNrOaSixV1onFxLeaR8LpJ04uyM9vCP,SpATywNh6bZuzm8s1ceuBUnMUAeoAHHw,6,5,2,0,1,0,2,0,10,1.4285714285714286,1,0.0,2,2,0,1,3,0,0,2,0,5,5,1
18840,174811,JdEJSTgj9mzyZgP3wbpkgBRlhmZAWyOb,A3fsA9Zfv1X2fVEQhTw51lKENdNrEqT3,8,6,1,0,1,0,3,0,11,1.5714285714285714,1,0.0,0,1,0,1,6,0,0,3,0,2,9,1
18841,174815,EUIAvqEpYGuf3oElkvmsxEBDGD0USQRc,SpATywNh6bZuzm8s1ceuBUnMUAeoAHHw,8,2,1,0,1,1,5,1,11,1.5714285714285714,1,0.0,0,1,0,1,2,1,0,5,1,2,9,1
18842,174834,jlfxlhUtD2UxnrEYxTWNdi2LKtu0owFx,SpATywNh6bZuzm8s1ceuBUnMUAeoAHHw,12,12,1,0,1,0,5,0,19,2.7142857142857144,1,0.0,0,1,0,1,12,0,0,5,0,2,17,1
18843,174850,JsUvqozri9AItThk54BBjEwYIqDey9JK,SpATywNh6bZuzm8s1ceuBUnMUAeoAHHw,29,70,24,34,11,0,8,0,147,21.0,5,0.0,12,24,30,11,58,0,4,8,0,77,70,1
18844,174851,wlfhNc0EqwNzSbWGuR5Gw22PX4idrOB9,bWdj2GDclj5ofokWjzoa5jAwMkxCykd6,6,4,3,0,2,0,2,0,11,1.5714285714285714,1,0.0,0,3,0,2,4,0,0,2,0,5,6,1
18845,174852,B4ycicxBkvAvNmF15lIWWxxW3Xn9MHa9,SpATywNh6bZuzm8s1ceuBUnMUAeoAHHw,1,0,0,0,0,0,1,0,1,0.14285714285714285,1,0.0,0,0,0,0,0,0,0,1,0,0,1,1
18846,174886,JsUvqozri9AItThk54BBjEwYIqDey9JK,5X6FeZozNMgE2VRi3MJYjkkFK8SETtu2,1,0,0,0,0,0,2,0,2,0.2857142857142857,1,0.0,0,0,0,0,0,0,0,2,0,0,2,1
18847,174889,JsUvqozri9AItThk54BBjEwYIqDey9JK,bWdj2GDclj5ofokWjzoa5jAwMkxCykd6,1,0,0,0,0,0,1,0,1,0.14285714285714285,1,0.0,0,0,0,0,0,0,0,1,0,0,1,1
18848,174890,JsUvqozri9AItThk54BBjEwYIqDey9JK,A3fsA9Zfv1X2fVEQhTw51lKENdNrEqT3,1,0,0,0,0,0,1,0,1,0.14285714285714285,1,0.0,0,0,0,0,0,0,0,1,0,0,1,1
18849,174896,W38DcguBOORgyx8AQARyx9O00yMNPg6e,A3fsA9Zfv1X2fVEQhTw51lKENdNrEqT3,24,25,13,0,8,0,4,0,50,7.142857142857143,2,0.0,0,13,0,8,25,0,0,4,0,21,29,1
18850,174919,MkluYfJDefHhcRPY3QsRGiWxg2BDcm18,5X6FeZozNMgE2VRi3MJYjkkFK8SETtu2,1,0,0,0,0,0,1,0,1,0.14285714285714285,1,0.0,0,0,0,0,0,0,0,1,0,0,1,1
18851,174921,MkluYfJDefHhcRPY3QsRGiWxg2BDcm18,G8EPVSXsOYB5YQWZGiz1aVq5Pgr2GrQu,1,0,0,0,0,0,1,0,1,0.14285714285714285,1,0.0,0,0,0,0,0,0,0,1,0,0,1,1
18852,174933,OAGaZXcjJISx6VWaj2xIjx8JDYNnZK9L,SpATywNh6bZuzm8s1ceuBUnMUAeoAHHw,6,3,1,0,1,0,3,1,9,1.2857142857142858,1,0.0,0,1,0,1,3,0,0,3,1,2,7,1
18853,174947,YXkiTHpE2a6E2kDFUh3HT5sKHSlA7gXq,A3fsA9Zfv1X2fVEQhTw51lKENdNrEqT3,21,16,10,0,8,0,3,0,37,5.285714285714286,1,0.0,5,10,0,8,11,0,0,3,0,23,14,1
18854,174954,z8k124y3f3RHISxJ0rlxzPOIGBXwWCJd,5X6FeZozNMgE2VRi3MJYjkkFK8SETtu2,5,4,3,0,1,0,2,0,10,1.4285714285714286,1,0.0,0,3,0,1,4,0,0,2,0,4,6,1
18855,174955,FdYyZ3eUFT2W1b2FuK1FqAPaILYLChJS,SpATywNh6bZuzm8s1ceuBUnMUAeoAHHw,9,6,1,0,0,0,3,2,12,1.7142857142857142,1,0.0,0,1,0,0,6,0,0,3,2,1,11,0
18856,174972,3e3NS2FF76Q2Wd0Q299lzVRy95TZUP9V,SpATywNh6bZuzm8s1ceuBUnMUAeoAHHw,4,2,0,0,0,0,3,0,5,0.7142857142857143,1,0.0,0,0,0,0,2,0,0,3,0,0,5,1
18857,174973,igeK6rUQT7Ehyj7yY5oAEj8DvOITiuBO,G8EPVSXsOYB5YQWZGiz1aVq5Pgr2GrQu,19,11,9,32,6,0,2,0,60,8.571428571428571,1,0.0,0,9,27,6,11,0,5,2,0,42,18,1
18858,174975,ZzaZO5citAcoeYBQ4xnco2bMgq0deP0c,5X6FeZozNMgE2VRi3MJYjkkFK8SETtu2,10,17,0,4,1,7,14,2,45,6.428571428571429,2,0.0,2,0,3,1,15,7,1,14,2,6,39,1
18859,174983,ZzaZO5citAcoeYBQ4xnco2bMgq0deP0c,bWdj2GDclj5ofokWjzoa5jAwMkxCykd6,14,14,0,12,2,6,7,1,42,6.0,2,0.0,5,0,10,2,9,6,2,7,1,17,25,0
18860,174987,U9FricROMjKQqr8IqFFHC3G0wWxulVGt,G8EPVSXsOYB5YQWZGiz1aVq5Pgr2GrQu,4,6,1,0,1,0,2,0,10,1.4285714285714286,1,0.0,2,1,0,1,4,0,0,2,0,4,6,1
18861,175011,fC8iLtYIOHY1gQcgztWp75xXkE8muKRF,bWdj2GDclj5ofokWjzoa5jAwMkxCykd6,6,5,2,0,1,0,3,0,11,1.5714285714285714,1,0.0,1,2,0,1,4,0,0,3,0,4,7,1
18862,175031,fiQPKilJkIFWShuteKFoAKrsoRjAoTQq,G8EPVSXsOYB5YQWZGiz1aVq5Pgr2GrQu,14,14,7,22,2,3,7,0,55,7.857142857142857,3,0.0,1,7,20,2,13,3,2,7,0,30,25,1
18863,175032,7OUEidh05JWByOEFcemhEZFfVFKOEreA,SpATywNh6bZuzm8s1ceuBUnMUAeoAHHw,7,4,2,0,2,0,2,0,10,1.4285714285714286,1,0.0,0,2,0,2,4,0,0,2,0,4,6,1
18864,175034,QXR5sUbv4S12yRWxM4AzFUAlm7Vhd4VU,bWdj2GDclj5ofokWjzoa5jAwMkxCykd6,7,2,1,0,1,0,6,1,11,1.5714285714285714,1,0.0,0,1,0,1,2,0,0,6,1,2,9,1
18865,175038,LeinRShMpys6hI3Pst69nKDdXo0lcJFw,bWdj2GDclj5ofokWjzoa5jAwMkxCykd6,3,2,0,0,0,0,1,0,3,0.42857142857142855,1,0.0,0,0,0,0,2,0,0,1,0,0,3,1
18866,175042,fN9yVRde7R2H7fN2gH8pJh2bfcNVmJQE,SpATywNh6bZuzm8s1ceuBUnMUAeoAHHw,15,19,7,13,3,1,6,1,50,7.142857142857143,2,0.0,9,7,11,3,10,1,2,6,1,30,20,1
18867,175054,WoXtpP4H4ghgkRBv3UuiyrHP7GFAl55y,SpATywNh6bZuzm8s1ceuBUnMUAeoAHHw,1,0,0,0,0,0,1,0,1,0.14285714285714285,1,0.0,0,0,0,0,0,0,0,1,0,0,1,1
18868,175059,WoXtpP4H4ghgkRBv3UuiyrHP7GFAl55y,RXDvfPUBYFlVdlueBFbLW0mhhAyGEqpt,1,0,0,0,0,0,1,0,1,0.14285714285714285,1,0.0,0,0,0,0,0,0,0,1,0,0,1,1
18869,175061,WoXtpP4H4ghgkRBv3UuiyrHP7GFAl55y,A3fsA9Zfv1X2fVEQhTw51lKENdNrEqT3,1,0,0,0,0,0,1,0,1,0.14285714285714285,1,0.0,0,0,0,0,0,0,0,1,0,0,1,1
18870,175080,04NERqmo4Pna5vlN4nEAbOXFR0ZTnfBC,RXDvfPUBYFlVdlueBFbLW0mhhAyGEqpt,1,0,0,0,0,0,0,1,1,0.14285714285714285,1,0.0,0,0,0,0,0,0,0,0,1,0,1,1
18871,175088,tRdhN0lgigOD57KMBTj72ZVM1o7s8RGj,SpATywNh6bZuzm8s1ceuBUnMUAeoAHHw,3,0,0,0,0,1,2,1,4,0.5714285714285714,1,0.0,0,0,0,0,0,1,0,2,1,0,4,1
18872,175089,BCJye2AaALRUT5f6ppYoCiYPMviVlBsr,G8EPVSXsOYB5YQWZGiz1aVq5Pgr2GrQu,1,0,0,0,0,0,1,0,1,0.14285714285714285,1,0.0,0,0,0,0,0,0,0,1,0,0,1,1
18873,175094,8udxV2CUMzjrYKDDJj8ojQtJ8oHj3KH6,SpATywNh6bZuzm8s1ceuBUnMUAeoAHHw,1,0,0,0,0,0,2,0,2,0.2857142857142857,2,0.0,0,0,0,0,0,0,0,2,0,0,2,1
18874,175096,wqGS9CBgLL8X8ANSg0Bc9uExUh5JuoRs,SpATywNh6bZuzm8s1ceuBUnMUAeoAHHw,6,4,1,0,1,1,2,0,9,1.2857142857142858,1,0.0,0,1,0,1,4,1,0,2,0,2,7,1
18875,175099,YaVHU5tTcyyfMEQ1RbrZTjEqZdgwcEOg,SpATywNh6bZuzm8s1ceuBUnMUAeoAHHw,1,0,0,0,0,0,1,0,1,0.14285714285714285,1,0.0,0,0,0,0,0,0,0,1,0,0,1,1
18876,175102,9quScdvVngFePST1NL7WzZK7VxMmTv5I,SpATywNh6bZuzm8s1ceuBUnMUAeoAHHw,2,0,0,0,0,0,2,0,2,0.2857142857142857,1,0.0,0,0,0,0,0,0,0,2,0,0,2,1
18877,175103,GqIgVQOxdNB1N6Xk3EJGvsEMXjZzOyVC,RXDvfPUBYFlVdlueBFbLW0mhhAyGEqpt,1,0,0,0,0,0,1,0,1,0.14285714285714285,1,0.0,0,0,0,0,0,0,0,1,0,0,1,1
18878,175109,cKCzrCCCXe9nkBgWepq9AEXje7SITRTz,SpATywNh6bZuzm8s1ceuBUnMUAeoAHHw,1,0,0,0,0,0,1,0,1,0.14285714285714285,1,0.0,0,0,0,0,0,0,0,1,0,0,1,1
18879,175116,cKCzrCCCXe9nkBgWepq9AEXje7SITRTz,5X6FeZozNMgE2VRi3MJYjkkFK8SETtu2,1,0,0,0,0,0,1,0,1,0.14285714285714285,1,0.0,0,0,0,0,0,0,0,1,0,0,1,1
18880,175119,EssEs0A6tGxDo6Ay7pdYrTC6BG7PsXvp,SpATywNh6bZuzm8s1ceuBUnMUAeoAHHw,3,2,1,0,0,0,1,0,4,0.5714285714285714,1,0.0,0,1,0,0,2,0,0,1,0,1,3,1
18881,175124,bI8WLmS7QAEP1Zf4KEJ36LOr2fpYMzKz,SpATywNh6bZuzm8s1ceuBUnMUAeoAHHw,1,0,0,0,0,0,1,0,1,0.14285714285714285,1,0.0,0,0,0,0,0,0,0,1,0,0,1,1
18882,175139,Vdk84P68xIHXBGrWqw3oEozZYT063dLv,A3fsA9Zfv1X2fVEQhTw51lKENdNrEqT3,12,11,8,0,7,0,6,0,32,4.571428571428571,2,0.0,0,8,0,7,11,0,0,6,0,15,17,1
18883,175145,U6qE2fx7rlT2WEmACzAkhjUhd8LCbR1p,A3fsA9Zfv1X2fVEQhTw51lKENdNrEqT3,8,4,3,0,3,0,1,0,11,1.5714285714285714,1,0.0,0,3,0,3,4,0,0,1,0,6,5,1
18884,175146,JJM4kJdvA7b7ijrHBmkFLiNbnfS1jEmD,bWdj2GDclj5ofokWjzoa5jAwMkxCykd6,16,13,6,84,5,0,7,0,115,16.428571428571427,1,0.0,7,6,80,5,6,0,4,7,0,98,17,1
18885,175161,rgXYdeKsNCNQdUbzf1eDuMPLA1J24DWk,G8EPVSXsOYB5YQWZGiz1aVq5Pgr2GrQu,6,3,2,0,1,0,2,0,8,1.1428571428571428,1,0.0,0,2,0,1,3,0,0,2,0,3,5,1
18886,175167,o9SCOAY5nuSxaVorNF1mq3E0AGKQbCox,SpATywNh6bZuzm8s1ceuBUnMUAeoAHHw,15,17,0,4,1,7,3,0,32,4.571428571428571,1,0.0,6,0,3,1,11,7,1,3,0,10,22,1
18887,175169,lRD6FNYJFilie5IwmFYNqrJax7QPJsdZ,bWdj2GDclj5ofokWjzoa5jAwMkxCykd6,6,2,1,0,1,3,5,0,12,1.7142857142857142,1,0.0,0,1,0,1,2,3,0,5,0,2,10,1
18888,175170,o9SCOAY5nuSxaVorNF1mq3E0AGKQbCox,A3fsA9Zfv1X2fVEQhTw51lKENdNrEqT3,1,0,0,0,0,0,1,0,1,0.14285714285714285,1,0.0,0,0,0,0,0,0,0,1,0,0,1,1
18889,175176,wKRwl5IweKiDuBtEeNntISPadPzFvRK2,SpATywNh6bZuzm8s1ceuBUnMUAeoAHHw,4,2,1,0,0,0,2,0,5,0.7142857142857143,1,0.0,0,1,0,0,2,0,0,2,0,1,4,1
18890,175187,bF4ZkA0Htjy5dPXooPjuHY2mhd8vbWYM,bWdj2GDclj5ofokWjzoa5jAwMkxCykd6,4,3,2,0,2,0,1,0,8,1.1428571428571428,1,0.0,0,2,0,2,3,0,0,1,0,4,4,1
18891,175193,8RK6HQkv51lSsSE1n9EptQjyHrkMwfO0,G8EPVSXsOYB5YQWZGiz1aVq5Pgr2GrQu,1,0,0,0,0,0,1,0,1,0.14285714285714285,1,0.0,0,0,0,0,0,0,0,1,0,0,1,1
18892,175205,ieuEScQs74mRiAwwPAhRyLP4C41miyHf,SpATywNh6bZuzm8s1ceuBUnMUAeoAHHw,4,9,4,0,0,0,1,0,14,2.0,1,0.0,0,4,0,0,9,0,0,1,0,4,10,1
18893,175256,jdfd8H9lnYttHWf9Izxs2MscynFXyhGW,A3fsA9Zfv1X2fVEQhTw51lKENdNrEqT3,4,5,1,0,0,0,1,0,7,1.0,1,0.0,0,1,0,0,5,0,0,1,0,1,6,0
18894,175264,jiPhRLmAJuGQCkjQnkZRItYBXUJwjlNA,RXDvfPUBYFlVdlueBFbLW0mhhAyGEqpt,8,2,1,0,1,1,5,1,11,1.5714285714285714,1,0.0,0,1,0,1,2,1,0,5,1,2,9,1
18895,175272,vmZoErHPHgTkQX32S5GK0CiVkZhSYU5z,bWdj2GDclj5ofokWjzoa5jAwMkxCykd6,1,0,0,0,0,0,1,0,1,0.14285714285714285,1,0.0,0,0,0,0,0,0,0,1,0,0,1,1
18896,175288,0UufwnomhqqyQLnmEpyIsrXn6C4McKHM,SpATywNh6bZuzm8s1ceuBUnMUAeoAHHw,1,0,0,0,0,0,1,0,1,0.14285714285714285,1,0.0,0,0,0,0,0,0,0,1,0,0,1,1
18897,175292,0UufwnomhqqyQLnmEpyIsrXn6C4McKHM,RXDvfPUBYFlVdlueBFbLW0mhhAyGEqpt,1,0,0,0,0,0,1,0,1,0.14285714285714285,1,0.0,0,0,0,0,0,0,0,1,0,0,1,1
18898,175293,m4eQNvYwZjYoMZYM2VsuhiDxtIFSYKWh,RXDvfPUBYFlVdlueBFbLW0mhhAyGEqpt,9,8,1,0,2,0,2,0,13,1.8571428571428572,1,0.0,3,1,0,2,5,0,0,2,0,6,7,1
18899,175304,SZHxM16r0lTBVocJi0Li5OQAgxZ4K7jz,5X6FeZozNMgE2VRi3MJYjkkFK8SETtu2,1,0,0,0,0,0,1,0,1,0.14285714285714285,1,0.0,0,0,0,0,0,0,0,1,0,0,1,1
18900,175305,SZHxM16r0lTBVocJi0Li5OQAgxZ4K7jz,bWdj2GDclj5ofokWjzoa5jAwMkxCykd6,1,0,0,0,0,0,1,0,1,0.14285714285714285,1,0.0,0,0,0,0,0,0,0,1,0,0,1,1
18901,175309,qAxjBZuCZJr25UpKUqhYPsfHWE6cqLNR,bWdj2GDclj5ofokWjzoa5jAwMkxCykd6,6,3,1,0,2,1,4,0,11,1.5714285714285714,1,0.0,2,1,0,2,1,1,0,4,0,5,6,1
18902,175322,YaeMtpEn02jmas25d0067kgG6T0CswLK,A3fsA9Zfv1X2fVEQhTw51lKENdNrEqT3,1,0,0,0,0,0,1,0,1,0.14285714285714285,1,0.0,0,0,0,0,0,0,0,1,0,0,1,1
18903,175335,7NbjM2q5TtspVGtHsqtgwdUTaXZ3QvNC,SpATywNh6bZuzm8s1ceuBUnMUAeoAHHw,7,3,1,0,0,0,4,1,9,1.2857142857142858,1,0.0,0,1,0,0,3,0,0,4,1,1,8,1
18904,175337,4jGp0wM4bWQL7YeW1fZnRYCrYjnWjDPp,A3fsA9Zfv1X2fVEQhTw51lKENdNrEqT3,2,0,0,0,0,0,2,0,2,0.2857142857142857,1,0.0,0,0,0,0,0,0,0,2,0,0,2,1
18905,175344,2uB3uMcrVV3zJUl7YzGLBsKaaqyb6VDm,bWdj2GDclj5ofokWjzoa5jAwMkxCykd6,1,0,0,0,0,0,1,0,1,0.14285714285714285,1,0.0,0,0,0,0,0,0,0,1,0,0,1,1
18906,175349,JISGCdjNZHYHcQ6XpDypgJiHQutxiO7F,bWdj2GDclj5ofokWjzoa5jAwMkxCykd6,1,0,0,0,0,0,1,0,1,0.14285714285714285,1,0.0,0,0,0,0,0,0,0,1,0,0,1,1
18907,175376,JwpnWAbXqqokshNbyxBH2QHaOUPb8wrj,SpATywNh6bZuzm8s1ceuBUnMUAeoAHHw,5,1,1,0,1,0,2,0,5,0.7142857142857143,1,0.0,0,1,0,1,1,0,0,2,0,2,3,0
18908,175380,xyhTJkgGghEribeWkvfmDO529PeI6BOD,A3fsA9Zfv1X2fVEQhTw51lKENdNrEqT3,23,16,11,0,11,0,4,0,42,6.0,1,0.0,0,11,0,11,16,0,0,4,0,22,20,1
18909,175382,YcbMhXf6WOxBHwzY0X9hWTypvQthAicg,SpATywNh6bZuzm8s1ceuBUnMUAeoAHHw,5,3,2,0,1,0,2,0,8,1.1428571428571428,2,0.0,0,2,0,1,3,0,0,2,0,3,5,1
18910,175390,EvySN154YDM9eHA8rncD5Y4XnKitTOWj,SpATywNh6bZuzm8s1ceuBUnMUAeoAHHw,1,0,0,0,0,0,1,0,1,0.14285714285714285,1,0.0,0,0,0,0,0,0,0,1,0,0,1,1
18911,175392,7MT1Ev8neQja0JRLlNFWlmHGJaMzca7N,SpATywNh6bZuzm8s1ceuBUnMUAeoAHHw,1,0,0,0,0,0,1,0,1,0.14285714285714285,1,0.0,0,0,0,0,0,0,0,1,0,0,1,1
18912,175393,EvySN154YDM9eHA8rncD5Y4XnKitTOWj,bWdj2GDclj5ofokWjzoa5jAwMkxCykd6,1,0,0,0,0,0,1,0,1,0.14285714285714285,1,0.0,0,0,0,0,0,0,0,1,0,0,1,1
18913,175396,EvySN154YDM9eHA8rncD5Y4XnKitTOWj,A3fsA9Zfv1X2fVEQhTw51lKENdNrEqT3,1,0,0,0,0,0,1,0,1,0.14285714285714285,1,0.0,0,0,0,0,0,0,0,1,0,0,1,1
18914,175397,MoQLSLdgc8N78DNeGEQHypzHbyf063p0,bWdj2GDclj5ofokWjzoa5jAwMkxCykd6,1,0,0,0,0,0,1,0,1,0.14285714285714285,1,0.0,0,0,0,0,0,0,0,1,0,0,1,1
18915,175398,MoQLSLdgc8N78DNeGEQHypzHbyf063p0,A3fsA9Zfv1X2fVEQhTw51lKENdNrEqT3,1,0,0,0,0,0,1,0,1,0.14285714285714285,1,0.0,0,0,0,0,0,0,0,1,0,0,1,1
18916,175417,kEoxxa2otTzPL6nc12ZeJYYFyGEjvH7q,SpATywNh6bZuzm8s1ceuBUnMUAeoAHHw,1,0,0,0,0,0,1,0,1,0.14285714285714285,1,0.0,0,0,0,0,0,0,0,1,0,0,1,1
18917,175422,JLpYHpRsamf04qcVxCPYwLYYhT8v6H5r,A3fsA9Zfv1X2fVEQhTw51lKENdNrEqT3,9,4,3,0,3,0,2,0,12,1.7142857142857142,1,0.0,0,3,0,3,4,0,0,2,0,6,6,1
18918,175424,qMTyC3MFcCmdQ8Eat2z9hmr6N3Nnskt1,SpATywNh6bZuzm8s1ceuBUnMUAeoAHHw,6,2,1,0,0,3,5,0,11,1.5714285714285714,1,0.0,0,1,0,0,2,3,0,5,0,1,10,1
18919,175437,Ht8gQquuDWuHnE8TA1lycaHJ8C9MVf20,fbPkOYLVPtPgIt0MxizjfFJov3JbHyAi,1,0,0,0,0,0,1,0,1,0.14285714285714285,1,0.0,0,0,0,0,0,0,0,1,0,0,1,1
18920,175438,dcYgKBzujpMIqe60unjrhnmHIEGafOxK,fbPkOYLVPtPgIt0MxizjfFJov3JbHyAi,1,0,0,0,0,0,1,0,1,0.14285714285714285,1,0.0,0,0,0,0,0,0,0,1,0,0,1,1
18921,175441,bcbHJfb8lY4U1KCijmTk7gJHSF0OiBaV,fbPkOYLVPtPgIt0MxizjfFJov3JbHyAi,8,4,4,0,4,0,4,0,16,2.2857142857142856,1,0.0,0,4,0,4,4,0,0,4,0,8,8,1
18922,175442,VMKrpzh7jQOpngYePozoQTNizGUgxuvX,fbPkOYLVPtPgIt0MxizjfFJov3JbHyAi,5,0,0,0,0,3,6,1,10,1.4285714285714286,1,0.0,0,0,0,0,0,3,0,6,1,0,10,0
18923,175443,uOJVnPYi8EJLtbdq5vki7NQKzKS5WxlN,fbPkOYLVPtPgIt0MxizjfFJov3JbHyAi,9,23,2,0,2,0,8,1,36,5.142857142857143,1,0.0,7,2,0,2,16,0,0,8,1,11,25,1
18924,175448,8Ify4dSBeSQhnw6uYnkYU0v4wr7gJcMS,fbPkOYLVPtPgIt0MxizjfFJov3JbHyAi,9,8,2,0,4,0,8,1,23,3.2857142857142856,1,0.0,5,2,0,4,3,0,0,8,1,11,12,1
18925,175449,wR7MeRMuDjqJzIdX6xUDIhHYl6LZetsZ,fbPkOYLVPtPgIt0MxizjfFJov3JbHyAi,1,0,0,0,0,0,1,0,1,0.14285714285714285,1,0.0,0,0,0,0,0,0,0,1,0,0,1,1
18926,175452,UGrzFFoMUY8lyETY7WUVQiSf705Madpt,fbPkOYLVPtPgIt0MxizjfFJov3JbHyAi,1,0,0,0,0,0,1,0,1,0.14285714285714285,1,0.0,0,0,0,0,0,0,0,1,0,0,1,1
18927,175454,xMTEKIKt8iJP63Gwx7tRgqa1pIDmZgMk,fbPkOYLVPtPgIt0MxizjfFJov3JbHyAi,1,0,0,0,0,0,1,0,1,0.14285714285714285,1,0.0,0,0,0,0,0,0,0,1,0,0,1,1
18928,175455,QLDHYthOyr0cclZ1Sc6usIODjIEumKpI,fbPkOYLVPtPgIt0MxizjfFJov3JbHyAi,7,3,2,0,2,0,2,0,9,1.2857142857142858,1,0.0,0,2,0,2,3,0,0,2,0,4,5,1
18929,175456,OTIaOWnuQGJS24y1xroPuPud7cEKSrq6,fbPkOYLVPtPgIt0MxizjfFJov3JbHyAi,7,8,2,0,4,0,2,0,16,2.2857142857142856,1,0.0,5,2,0,4,3,0,0,2,0,11,5,1
18930,175457,5p4xnVU1oXqeHfhqOsPC09VPLJWVQgy1,fbPkOYLVPtPgIt0MxizjfFJov3JbHyAi,7,4,3,0,3,0,2,0,12,1.7142857142857142,1,0.0,0,3,0,3,4,0,0,2,0,6,6,1
18931,175461,XB0CsTWEqiEaZYtZLlV2XbWJ8POYjAA4,fbPkOYLVPtPgIt0MxizjfFJov3JbHyAi,7,4,2,0,2,0,4,0,12,1.7142857142857142,1,0.0,1,2,0,2,3,0,0,4,0,5,7,1
18932,175465,YhKyManCtFjOHDUhvEEwYRA6Sue32NUJ,fbPkOYLVPtPgIt0MxizjfFJov3JbHyAi,10,6,4,0,2,6,9,3,30,4.285714285714286,1,0.0,0,4,0,2,6,6,0,9,3,6,24,1
18933,175467,Ato56ooa6y54tphZfyEFBMuiinGkCdDC,fbPkOYLVPtPgIt0MxizjfFJov3JbHyAi,5,3,1,0,1,0,2,0,7,1.0,1,0.0,0,1,0,1,3,0,0,2,0,2,5,1
18934,175468,nV17iCvBE2XN1lp2NOww0UgnrnPkpny4,fbPkOYLVPtPgIt0MxizjfFJov3JbHyAi,13,16,5,11,7,1,13,3,56,8.0,1,0.0,8,5,8,7,8,1,3,13,3,28,28,1
18935,175469,3Un500IqBW3emCZEkVYOgMvAW5xeb1AP,fbPkOYLVPtPgIt0MxizjfFJov3JbHyAi,1,0,0,0,0,0,1,0,1,0.14285714285714285,1,0.0,0,0,0,0,0,0,0,1,0,0,1,1
18936,175471,Ar7wri6od2sIMOfx95hPmMwDttR4wtOC,fbPkOYLVPtPgIt0MxizjfFJov3JbHyAi,1,0,0,0,0,0,1,0,1,0.14285714285714285,1,0.0,0,0,0,0,0,0,0,1,0,0,1,1
18937,175474,Y1jXhPhCX2kJOjFXBIjhhtIcj4SJDjMI,fbPkOYLVPtPgIt0MxizjfFJov3JbHyAi,7,3,2,0,2,0,2,0,9,1.2857142857142858,1,0.0,0,2,0,2,3,0,0,2,0,4,5,1
18938,175475,1w0szCmbk0c8fTIiC10xTGm5aiOfXQpV,fbPkOYLVPtPgIt0MxizjfFJov3JbHyAi,5,2,1,0,1,0,3,0,7,1.0,1,0.0,0,1,0,1,2,0,0,3,0,2,5,1
18939,175476,CobcodAmjDEWWm8RdgM2qfuZmhHbHRNU,fbPkOYLVPtPgIt0MxizjfFJov3JbHyAi,6,3,1,0,1,0,6,0,11,1.5714285714285714,1,0.0,1,1,0,1,2,0,0,6,0,3,8,1
18940,175477,YK7kIznrzD8DIJpIXSwoLltRvaesCrfj,fbPkOYLVPtPgIt0MxizjfFJov3JbHyAi,6,3,2,0,2,0,2,0,9,1.2857142857142858,1,0.0,0,2,0,2,3,0,0,2,0,4,5,1
18941,175478,FIQFfdFooB5Qr3t4W3Ez4CHK8yaDPL6r,fbPkOYLVPtPgIt0MxizjfFJov3JbHyAi,8,7,3,0,2,5,2,1,20,2.857142857142857,1,0.0,0,3,0,2,7,5,0,2,1,5,15,1
18942,175479,5257BfDOFjjC1F8tPsdm817yJFHm3nJq,fbPkOYLVPtPgIt0MxizjfFJov3JbHyAi,5,2,1,0,1,0,2,0,6,0.8571428571428571,1,0.0,0,1,0,1,2,0,0,2,0,2,4,1
18943,175480,GCbj5MX1kqm8CtGBmbuXpnp1WMiRGaCo,fbPkOYLVPtPgIt0MxizjfFJov3JbHyAi,4,2,0,0,0,0,2,0,4,0.5714285714285714,1,0.0,0,0,0,0,2,0,0,2,0,0,4,1
18944,175481,ofogRZ8rNViMcr7xZw7tGZINwIkOUuzb,fbPkOYLVPtPgIt0MxizjfFJov3JbHyAi,7,3,2,0,2,0,3,0,10,1.4285714285714286,1,0.0,0,2,0,2,3,0,0,3,0,4,6,1
18945,175484,6EaK0gHFiSwbLJpDVBHv9ZNNoyIiEert,fbPkOYLVPtPgIt0MxizjfFJov3JbHyAi,1,0,0,0,0,0,1,0,1,0.14285714285714285,1,0.0,0,0,0,0,0,0,0,1,0,0,1,1
18946,175485,9karhKHktKTUl1g2B756WZohKwl0YF1K,fbPkOYLVPtPgIt0MxizjfFJov3JbHyAi,2,0,0,0,0,0,3,0,3,0.42857142857142855,1,0.0,0,0,0,0,0,0,0,3,0,0,3,1
18947,175486,om0KjvovtBK0gZUSboAPRv5A6Jkm00Ei,fbPkOYLVPtPgIt0MxizjfFJov3JbHyAi,7,5,2,0,2,0,4,0,13,1.8571428571428572,1,0.0,0,2,0,2,5,0,0,4,0,4,9,0
18948,175487,wNSaTBieURYU9eqRBVXTHwg7UnVH1LNG,fbPkOYLVPtPgIt0MxizjfFJov3JbHyAi,7,8,2,0,3,0,4,0,17,2.4285714285714284,1,0.0,2,2,0,3,6,0,0,4,0,7,10,1
18949,175489,gqg82ZlqVKWjlS0c4NNxNoHosWhYfCyK,fbPkOYLVPtPgIt0MxizjfFJov3JbHyAi,7,3,2,0,2,0,2,0,9,1.2857142857142858,1,0.0,0,2,0,2,3,0,0,2,0,4,5,1
18950,175490,PnA6r0X1SYV0NubfDqVTrMnAW0y3wbco,fbPkOYLVPtPgIt0MxizjfFJov3JbHyAi,8,5,2,0,3,0,5,1,16,2.2857142857142856,1,0.0,2,2,0,3,3,0,0,5,1,7,9,1
18951,175492,BsdltKARtL2vwhO9E4jy6NsRDyZPduO2,fbPkOYLVPtPgIt0MxizjfFJov3JbHyAi,6,3,1,0,1,0,2,0,7,1.0,1,0.0,0,1,0,1,3,0,0,2,0,2,5,1
18952,175493,LAOj1accETKmU8VQwigRsaQa5A7qsGPe,fbPkOYLVPtPgIt0MxizjfFJov3JbHyAi,7,5,2,0,2,0,4,0,13,1.8571428571428572,1,0.0,0,2,0,2,5,0,0,4,0,4,9,1
18953,175494,drW0fI24E8OPT5rwVcYcGjFLcooZDvPF,fbPkOYLVPtPgIt0MxizjfFJov3JbHyAi,7,5,3,0,2,0,2,0,12,1.7142857142857142,2,0.0,0,3,0,2,5,0,0,2,0,5,7,1
18954,175496,e5SHaCJ1YwrfRF0jQyBahObK2P8hYPve,fbPkOYLVPtPgIt0MxizjfFJov3JbHyAi,5,2,1,0,1,0,2,0,6,0.8571428571428571,1,0.0,0,1,0,1,2,0,0,2,0,2,4,1
18955,175497,IbpttTpyCGfZ6D6p8wXVxA8GNM8MhK7W,fbPkOYLVPtPgIt0MxizjfFJov3JbHyAi,1,0,0,0,0,0,1,0,1,0.14285714285714285,1,0.0,0,0,0,0,0,0,0,1,0,0,1,1
18956,175499,qbL2YHzrsuMmEiJasxtJywxONtOZbPqY,fbPkOYLVPtPgIt0MxizjfFJov3JbHyAi,5,3,1,0,1,0,4,0,9,1.2857142857142858,1,0.0,0,1,0,1,3,0,0,4,0,2,7,1
18957,175500,052V26a8dvnnaUmI4wUAzyjC2b7PSOrg,fbPkOYLVPtPgIt0MxizjfFJov3JbHyAi,5,5,2,0,2,0,2,0,11,1.5714285714285714,2,0.0,0,2,0,2,5,0,0,2,0,4,7,1
18958,175501,m9TcnazDdqlnNxcGRCE8U6df3FfqDKf1,fbPkOYLVPtPgIt0MxizjfFJov3JbHyAi,4,3,1,0,0,0,2,0,6,0.8571428571428571,1,0.0,0,1,0,0,3,0,0,2,0,1,5,1
18959,175502,CGrFKacz6p4gJHwJ4xqUr7POA26XzDqd,fbPkOYLVPtPgIt0MxizjfFJov3JbHyAi,4,2,1,0,1,0,1,0,5,0.7142857142857143,2,0.0,0,1,0,1,2,0,0,1,0,2,3,1
18960,175503,LTwrn8iO2pRbLrTnW6wOA9gDNQYv9ip1,fbPkOYLVPtPgIt0MxizjfFJov3JbHyAi,6,3,2,0,2,0,1,0,8,1.1428571428571428,1,0.0,0,2,0,2,3,0,0,1,0,4,4,1
18961,175504,3N5sXtJHk0S0MyzqJoRxaXFTELV1xCPn,fbPkOYLVPtPgIt0MxizjfFJov3JbHyAi,7,8,4,0,4,0,1,0,17,2.4285714285714284,1,0.0,2,4,0,4,6,0,0,1,0,10,7,1
18962,175505,WHZrYzY9tohLccoqyQSfSqyUPDUl9WdE,fbPkOYLVPtPgIt0MxizjfFJov3JbHyAi,7,3,2,0,2,0,2,0,9,1.2857142857142858,1,0.0,0,2,0,2,3,0,0,2,0,4,5,1
18963,175506,qTno0LLDbZSn2CC4rZpUMVqkfAX6tLBw,fbPkOYLVPtPgIt0MxizjfFJov3JbHyAi,1,0,0,0,0,0,1,0,1,0.14285714285714285,1,0.0,0,0,0,0,0,0,0,1,0,0,1,1
18964,175507,CFYmGwr95iYII1Xahjw54NZCjdk2d4Wp,fbPkOYLVPtPgIt0MxizjfFJov3JbHyAi,6,6,1,0,1,0,2,0,10,1.4285714285714286,1,0.0,1,1,0,1,5,0,0,2,0,3,7,1
18965,175508,XyCxlADmHDxfuETiOd9Qt3MOPKhTmOlb,fbPkOYLVPtPgIt0MxizjfFJov3JbHyAi,6,4,1,0,1,0,2,0,8,1.1428571428571428,1,0.0,0,1,0,1,4,0,0,2,0,2,6,1
18966,175510,kY9yPgTd7RyYG1qUhQ8Q0xOuR3Fox0Ti,fbPkOYLVPtPgIt0MxizjfFJov3JbHyAi,2,0,0,0,0,0,4,0,4,0.5714285714285714,1,0.0,0,0,0,0,0,0,0,4,0,0,4,1
18967,175515,R3pJN0fTux9sFYOjyzF0EbS2c0Xrmde3,fbPkOYLVPtPgIt0MxizjfFJov3JbHyAi,6,6,3,0,2,0,10,0,21,3.0,1,0.0,2,3,0,2,4,0,0,10,0,7,14,1
18968,175516,ldm7FcdWlJdLvNLq5omS5m0FzdvPxViY,fbPkOYLVPtPgIt0MxizjfFJov3JbHyAi,7,8,3,0,4,0,2,0,17,2.4285714285714284,1,0.0,2,3,0,4,6,0,0,2,0,9,8,1
18969,175518,tLauqU6m7jR9M9FVV91XHWWjOVljDHTA,fbPkOYLVPtPgIt0MxizjfFJov3JbHyAi,18,31,14,16,12,2,6,0,81,11.571428571428571,1,0.0,13,14,12,12,18,2,4,6,0,51,30,1
18970,175520,tkWTBuD8nrYklSlgsF9aKVPineGUm2wd,fbPkOYLVPtPgIt0MxizjfFJov3JbHyAi,7,10,2,0,1,0,3,0,16,2.2857142857142856,1,0.0,0,2,0,1,10,0,0,3,0,3,13,1
18971,175523,cv7s2nnOAGwzgfER5oZNesmUBbRGxCps,fbPkOYLVPtPgIt0MxizjfFJov3JbHyAi,7,3,2,0,2,0,2,0,9,1.2857142857142858,1,0.0,0,2,0,2,3,0,0,2,0,4,5,1
18972,175524,VeDeV6aD6kowERv1ygPjE9YEMgMJMOAv,fbPkOYLVPtPgIt0MxizjfFJov3JbHyAi,1,0,0,0,0,0,1,0,1,0.14285714285714285,1,0.0,0,0,0,0,0,0,0,1,0,0,1,1
18973,175526,ucQjAvDjYoqpSh3nQps3rSAEs5u7Mvtk,fbPkOYLVPtPgIt0MxizjfFJov3JbHyAi,2,0,0,0,0,0,2,0,2,0.2857142857142857,1,0.0,0,0,0,0,0,0,0,2,0,0,2,1
18974,175528,mz46tnsW5yzzVlL3u3XwzrxNaj8Gctbo,fbPkOYLVPtPgIt0MxizjfFJov3JbHyAi,1,0,0,0,0,0,1,0,1,0.14285714285714285,1,0.0,0,0,0,0,0,0,0,1,0,0,1,1
18975,175531,eXM1gBg4CSAoJIkchTxClftGT7trcN3I,fbPkOYLVPtPgIt0MxizjfFJov3JbHyAi,5,2,1,0,1,0,2,0,6,0.8571428571428571,1,0.0,0,1,0,1,2,0,0,2,0,2,4,1
18976,175533,TL1aA8ITe7VP42GX52yE5M5UsjXNCOS3,fbPkOYLVPtPgIt0MxizjfFJov3JbHyAi,7,5,3,0,2,5,2,0,17,2.4285714285714284,2,0.0,0,3,0,2,5,5,0,2,0,5,12,1
18977,175534,UtAqhqB3FX1II4t3OmHm0AmqSdhnUJww,fbPkOYLVPtPgIt0MxizjfFJov3JbHyAi,1,0,0,0,0,0,1,0,1,0.14285714285714285,1,0.0,0,0,0,0,0,0,0,1,0,0,1,1
18978,175535,Bf0qullIcB7YMd6p0ga3kapcfp1HAy4D,fbPkOYLVPtPgIt0MxizjfFJov3JbHyAi,4,2,1,0,1,0,1,0,5,0.7142857142857143,1,0.0,0,1,0,1,2,0,0,1,0,2,3,1
18979,175536,UGeVqsUEeFxkRpYFM0kXm2U5Cm8I1M7Q,fbPkOYLVPtPgIt0MxizjfFJov3JbHyAi,9,5,3,0,3,0,2,0,13,1.8571428571428572,1,0.0,1,3,0,3,4,0,0,2,0,7,6,1
18980,175537,nTUP3gEuwVy2Io3TzQXGmuh9VvJxgHk3,fbPkOYLVPtPgIt0MxizjfFJov3JbHyAi,1,0,0,0,0,0,1,0,1,0.14285714285714285,1,0.0,0,0,0,0,0,0,0,1,0,0,1,1
18981,175539,1CCZmdq6Gb6gZ6uKsuQ6KwhvPKPrUh2U,fbPkOYLVPtPgIt0MxizjfFJov3JbHyAi,5,2,1,0,1,0,4,0,8,1.1428571428571428,1,0.0,0,1,0,1,2,0,0,4,0,2,6,1
18982,175540,xB6Yoh3Jxp1w9CTAondnOiYqF7QVxKDy,fbPkOYLVPtPgIt0MxizjfFJov3JbHyAi,10,10,6,0,3,12,4,0,35,5.0,2,0.0,0,6,0,3,10,12,0,4,0,9,26,1
18983,175542,B02fY98iRJpi5vADl4eH2XHtzf1uLIV2,fbPkOYLVPtPgIt0MxizjfFJov3JbHyAi,5,3,1,0,1,0,2,0,7,1.0,1,0.0,0,1,0,1,3,0,0,2,0,2,5,1
18984,175543,O9Ru4jbLuBmSjAvyVz5x9pDKgWs38Hwv,fbPkOYLVPtPgIt0MxizjfFJov3JbHyAi,5,2,1,0,1,0,2,0,6,0.8571428571428571,1,0.0,0,1,0,1,2,0,0,2,0,2,4,1
18985,175544,U4zrVJHh3FaieGmYntHxuYMlUehDirPp,fbPkOYLVPtPgIt0MxizjfFJov3JbHyAi,4,2,1,0,1,0,1,0,5,0.7142857142857143,1,0.0,0,1,0,1,2,0,0,1,0,2,3,1
18986,175545,1R1CKWtxnh6YgR55bjp2SqlcSVpP0TFg,fbPkOYLVPtPgIt0MxizjfFJov3JbHyAi,5,4,0,0,0,4,4,0,12,1.7142857142857142,1,0.0,0,0,0,0,4,4,0,4,0,0,12,1
18987,175547,KjHPeZFepHZBGvn3dcFcrV9gz6Gs9Ua1,fbPkOYLVPtPgIt0MxizjfFJov3JbHyAi,1,0,0,0,0,0,1,0,1,0.14285714285714285,1,0.0,0,0,0,0,0,0,0,1,0,0,1,1
18988,175553,u63nhWQlMjNxplBlLZJLvDLqiAG5Ii9t,5Gyp41oLVo7Gg7vF4vpmggWP5MU70QO6,2,0,0,0,0,0,2,0,2,0.2857142857142857,1,0.0,0,0,0,0,0,0,0,2,0,0,2,1
18989,175555,t36XNyttEGYEbruJSYQeLq0WrBQsRaPU,5Gyp41oLVo7Gg7vF4vpmggWP5MU70QO6,11,7,3,0,3,0,4,1,18,2.5714285714285716,1,0.0,0,3,0,3,7,0,0,4,1,6,12,1
18990,175563,UFDFWUfRjajJSLhSI9UXvyAfHFYjQony,5Gyp41oLVo7Gg7vF4vpmggWP5MU70QO6,1,0,0,0,0,0,1,0,1,0.14285714285714285,1,0.0,0,0,0,0,0,0,0,1,0,0,1,1
18991,175565,xqBPSJ2eEWnWMWegTkFOclmNnVQwOvHX,5Gyp41oLVo7Gg7vF4vpmggWP5MU70QO6,7,3,2,0,2,0,2,0,9,1.2857142857142858,1,0.0,0,2,0,2,3,0,0,2,0,4,5,1
18992,175566,Elx2cQbVo6qKFXoh3EPlogaaktsTt9KM,5Gyp41oLVo7Gg7vF4vpmggWP5MU70QO6,11,9,4,0,3,1,8,1,26,3.7142857142857144,2,0.0,0,4,0,3,9,1,0,8,1,7,19,1
18993,175600,84UIkLYsQU8mKKaif9FyRob9BPLE2tXb,5Gyp41oLVo7Gg7vF4vpmggWP5MU70QO6,4,2,0,0,0,0,2,0,4,0.5714285714285714,1,0.0,0,0,0,0,2,0,0,2,0,0,4,1
18994,175611,oZMcISGXpf39Ki0OFyNrpBR0qwxKGL5O,5Gyp41oLVo7Gg7vF4vpmggWP5MU70QO6,9,9,3,0,1,0,4,0,17,2.4285714285714284,1,0.0,1,3,0,1,8,0,0,4,0,5,12,1
18995,175662,GpVALwWCULScAJNB9JPTpTgcXMDeMnis,5Gyp41oLVo7Gg7vF4vpmggWP5MU70QO6,9,10,5,0,3,0,4,0,22,3.142857142857143,2,0.0,0,5,0,3,10,0,0,4,0,8,14,1
18996,175665,Dq9IlPGakCKNnQEyVCyfmnYzKLFM3IiV,5Gyp41oLVo7Gg7vF4vpmggWP5MU70QO6,1,0,0,0,0,0,2,0,2,0.2857142857142857,1,0.0,0,0,0,0,0,0,0,2,0,0,2,1
18997,175689,kRiA8zJGRlNfHAF5JnuCp6g9v3Wlutb2,5Gyp41oLVo7Gg7vF4vpmggWP5MU70QO6,1,0,0,0,0,0,1,0,1,0.14285714285714285,1,0.0,0,0,0,0,0,0,0,1,0,0,1,1
18998,175703,1BPGbYKUavDbuG831TPn7gRkKOJIPHCj,5Gyp41oLVo7Gg7vF4vpmggWP5MU70QO6,23,38,18,8,6,3,12,1,86,12.285714285714286,1,0.0,15,18,6,6,23,3,2,12,1,45,41,1
18999,175735,2lzDh3x2KSIEgtLiSmTTTSbzuEstP81K,5Gyp41oLVo7Gg7vF4vpmggWP5MU70QO6,16,19,13,2,0,0,10,1,45,6.428571428571429,2,0.0,1,13,1,0,18,0,1,10,1,15,30,1
19000,175745,zVoKsR8MYsX1JulbW88TK7RKDnCpGIy6,5Gyp41oLVo7Gg7vF4vpmggWP5MU70QO6,20,26,10,9,6,2,4,0,57,8.142857142857142,1,0.0,14,10,7,6,12,2,2,4,0,37,20,1
19001,175856,FISJwOKDHl5L2bwPnRQrQvOIdUTZaN4Z,5Gyp41oLVo7Gg7vF4vpmggWP5MU70QO6,1,0,0,0,0,0,2,0,2,0.2857142857142857,1,0.0,0,0,0,0,0,0,0,2,0,0,2,1
19002,175865,TdYIfwLy6LbeyFMhhypR34oXRcMJhweg,5Gyp41oLVo7Gg7vF4vpmggWP5MU70QO6,8,7,4,0,2,0,2,0,15,2.142857142857143,1,0.0,0,4,0,2,7,0,0,2,0,6,9,1
19003,175879,DirzEgelosWZwAQMMiGy5whzyBBW4Ilk,5Gyp41oLVo7Gg7vF4vpmggWP5MU70QO6,1,0,0,0,0,0,1,0,1,0.14285714285714285,1,0.0,0,0,0,0,0,0,0,1,0,0,1,1
19004,175894,Ai6ToSZgR58w4Ua3zULXQkKe6hfDFbXY,5Gyp41oLVo7Gg7vF4vpmggWP5MU70QO6,1,0,0,0,0,0,1,0,1,0.14285714285714285,1,0.0,0,0,0,0,0,0,0,1,0,0,1,1
19005,175910,KifohttwILmFFF2lY14tsLQ0dfmGpZ3P,5Gyp41oLVo7Gg7vF4vpmggWP5MU70QO6,6,3,2,0,2,0,1,0,8,1.1428571428571428,1,0.0,0,2,0,2,3,0,0,1,0,4,4,1
19006,175920,nk68g4BF2bKYXOULXwqYqKWNlKeo6jEg,5Gyp41oLVo7Gg7vF4vpmggWP5MU70QO6,1,0,0,0,0,0,2,0,2,0.2857142857142857,1,0.0,0,0,0,0,0,0,0,2,0,0,2,1
19007,175921,vUteL5SylYbfSOWO5XzZKIOWa2vtUv73,5Gyp41oLVo7Gg7vF4vpmggWP5MU70QO6,7,3,2,0,2,0,2,0,9,1.2857142857142858,1,0.0,0,2,0,2,3,0,0,2,0,4,5,1
19008,175929,piqwp35xaKMhWL3tWUGgxOuWXOgGDGgO,5Gyp41oLVo7Gg7vF4vpmggWP5MU70QO6,12,7,4,4,2,2,3,0,22,3.142857142857143,1,0.0,1,4,2,2,6,2,2,3,0,9,13,1
19009,175949,FUDQ2uOsJiUsmFwGJcOX1bvtM6hlWBXm,5Gyp41oLVo7Gg7vF4vpmggWP5MU70QO6,9,11,3,2,2,0,2,0,20,2.857142857142857,1,0.0,7,3,1,2,4,0,1,2,0,13,7,1
19010,175959,uqYPsXyywpvPKb8LH9eDPGyl21TTxdxh,5Gyp41oLVo7Gg7vF4vpmggWP5MU70QO6,13,7,5,2,4,0,2,0,20,2.857142857142857,1,0.0,1,5,1,4,6,0,1,2,0,11,9,1
19011,175965,7ftZsfya8jQVLBDKFpvbaYjGSV8eGRSV,5Gyp41oLVo7Gg7vF4vpmggWP5MU70QO6,13,19,10,10,10,0,8,0,57,8.142857142857142,1,0.0,9,10,5,10,10,0,5,8,0,34,23,1
19012,175971,fMHcKCwHRfgj0TyGDe4Zs5DZmJ5yP7f9,5Gyp41oLVo7Gg7vF4vpmggWP5MU70QO6,1,0,0,0,0,0,1,0,1,0.14285714285714285,1,0.0,0,0,0,0,0,0,0,1,0,0,1,1
19013,175980,hic3fl8NTkEwcv4fRIZX50Bq1GBvotTD,5Gyp41oLVo7Gg7vF4vpmggWP5MU70QO6,7,5,2,4,1,1,2,0,15,2.142857142857143,1,0.0,2,2,2,1,3,1,2,2,0,7,8,1
19014,175988,f7b9jaYG3ZonTVVmrdcHmJXqtDuk4uDp,5Gyp41oLVo7Gg7vF4vpmggWP5MU70QO6,7,2,1,0,1,0,4,1,9,1.2857142857142858,1,0.0,0,1,0,1,2,0,0,4,1,2,7,1
19015,176007,ObXxMfJGKfWbFMKlTyZ8lXepPKFlmf7O,5Gyp41oLVo7Gg7vF4vpmggWP5MU70QO6,5,2,1,0,1,0,2,0,6,0.8571428571428571,1,0.0,0,1,0,1,2,0,0,2,0,2,4,1
19016,176009,MeeIYx8PG9U4eJ0fUaEgwUUwBfjTnwBv,5Gyp41oLVo7Gg7vF4vpmggWP5MU70QO6,11,10,8,0,2,0,3,0,23,3.2857142857142856,1,0.0,0,8,0,2,10,0,0,3,0,10,13,1
19017,176016,JeHbCqSsKDyNUBLGsI70pczdTjZOM443,5Gyp41oLVo7Gg7vF4vpmggWP5MU70QO6,7,2,1,0,1,0,4,0,8,1.1428571428571428,1,0.0,0,1,0,1,2,0,0,4,0,2,6,1
19018,176023,uhPNW6SwFQxv8jldkzl8dc8KVG6lDQod,5Gyp41oLVo7Gg7vF4vpmggWP5MU70QO6,5,2,1,0,1,0,3,0,7,1.0,1,0.0,0,1,0,1,2,0,0,3,0,2,5,1
19019,176027,tGx5xdPMJB2mV7gvzfJo4bTZYHo6S1ZI,5Gyp41oLVo7Gg7vF4vpmggWP5MU70QO6,11,6,4,2,3,0,2,0,17,2.4285714285714284,1,0.0,1,4,1,3,5,0,1,2,0,9,8,1
19020,176044,eITC0QO78ckIa0Ac0qBdRA2zdXlT6nZi,5Gyp41oLVo7Gg7vF4vpmggWP5MU70QO6,5,2,1,0,1,0,2,0,6,0.8571428571428571,1,0.0,0,1,0,1,2,0,0,2,0,2,4,1
19021,176054,ARNT70yvoerfF5OniVgYjOOtVO7gcR5y,5Gyp41oLVo7Gg7vF4vpmggWP5MU70QO6,1,0,0,0,0,0,1,0,1,0.14285714285714285,1,0.0,0,0,0,0,0,0,0,1,0,0,1,1
19022,176073,YIP2lGlyHeizVemmX7CB6G13iA5LoUV3,5Gyp41oLVo7Gg7vF4vpmggWP5MU70QO6,9,8,3,4,2,0,2,0,19,2.7142857142857144,1,0.0,4,3,2,2,4,0,2,2,0,11,8,1
19023,176077,JDfKwfMlyOCQxbeSyKM0fmiRtEFW5UHc,5Gyp41oLVo7Gg7vF4vpmggWP5MU70QO6,8,2,1,0,1,1,4,1,10,1.4285714285714286,1,0.0,0,1,0,1,2,1,0,4,1,2,8,1
19024,176086,BNdeN6WqA0qmlaX8IHq825gY7kHHeXPc,5Gyp41oLVo7Gg7vF4vpmggWP5MU70QO6,2,0,0,0,0,0,3,0,3,0.42857142857142855,1,0.0,0,0,0,0,0,0,0,3,0,0,3,1
19025,176112,TSdMB1S3lGhWMmxrdoDVqx8G8xAeKzm9,5Gyp41oLVo7Gg7vF4vpmggWP5MU70QO6,1,0,0,0,0,0,1,0,1,0.14285714285714285,1,0.0,0,0,0,0,0,0,0,1,0,0,1,1
19026,176114,QqNuARzccJUP5HNszzjljOhC9t53eZLk,5Gyp41oLVo7Gg7vF4vpmggWP5MU70QO6,1,0,0,0,0,0,1,0,1,0.14285714285714285,1,0.0,0,0,0,0,0,0,0,1,0,0,1,1
19027,176115,KxgFkXTLAf6Esdw8ag0xHMwGvafkSsCu,5Gyp41oLVo7Gg7vF4vpmggWP5MU70QO6,19,37,15,4,5,46,8,1,116,16.571428571428573,2,0.0,19,15,2,5,18,46,2,8,1,41,75,1
19028,176116,Yuou5IoOdRhjyu5VfIiPne8pzEI4yygt,5Gyp41oLVo7Gg7vF4vpmggWP5MU70QO6,11,9,5,8,0,0,1,0,23,3.2857142857142856,1,0.0,2,5,4,0,7,0,4,1,0,11,12,1
19029,176118,4ikqBBENxt3XhhKUpHGd9SDdjESU1vaO,5Gyp41oLVo7Gg7vF4vpmggWP5MU70QO6,7,3,2,0,2,0,2,0,9,1.2857142857142858,1,0.0,0,2,0,2,3,0,0,2,0,4,5,1
19030,176120,Y1357XabbIWDk01qXtntUOG4FlBDlqWy,5Gyp41oLVo7Gg7vF4vpmggWP5MU70QO6,7,8,2,0,2,0,2,0,14,2.0,1,0.0,0,2,0,2,8,0,0,2,0,4,10,1
19031,176129,IUpvJjgbl643UyF8wULi6B9PKWsV1bsS,5Gyp41oLVo7Gg7vF4vpmggWP5MU70QO6,1,0,0,0,0,0,1,0,1,0.14285714285714285,1,0.0,0,0,0,0,0,0,0,1,0,0,1,1
19032,176135,ZNuOJrCmdbDVwu3316Ns9Xri9mbtOMWp,5Gyp41oLVo7Gg7vF4vpmggWP5MU70QO6,5,3,2,0,2,0,2,0,9,1.2857142857142858,1,0.0,0,2,0,2,3,0,0,2,0,4,5,1
19033,176145,QpBSoSHEl70d7uw9VTolCRX2aYHvdQhX,5Gyp41oLVo7Gg7vF4vpmggWP5MU70QO6,6,1,1,0,1,0,3,0,6,0.8571428571428571,1,0.0,0,1,0,1,1,0,0,3,0,2,4,1
19034,176157,PA5zAI3bEQFeUnwe26PAqLrwJiTm4n2R,5Gyp41oLVo7Gg7vF4vpmggWP5MU70QO6,7,3,2,0,2,0,2,0,9,1.2857142857142858,1,0.0,0,2,0,2,3,0,0,2,0,4,5,1
19035,176161,bvP4VCG0pJjjp00r4CnxF8cuUwkLgH8e,5Gyp41oLVo7Gg7vF4vpmggWP5MU70QO6,12,13,9,0,6,0,15,1,44,6.285714285714286,1,0.0,1,9,0,6,12,0,0,15,1,16,28,1
19036,176169,OD1pqN8En0iNd52vQpaf4DwGLH3W4dof,5Gyp41oLVo7Gg7vF4vpmggWP5MU70QO6,1,0,0,0,0,0,1,0,1,0.14285714285714285,1,0.0,0,0,0,0,0,0,0,1,0,0,1,1
19037,176200,Ti2zUJe9qo9j9ZVP2UEVL9JeUdPOwIHM,5Gyp41oLVo7Gg7vF4vpmggWP5MU70QO6,6,9,6,0,0,0,5,0,20,2.857142857142857,2,0.0,0,6,0,0,9,0,0,5,0,6,14,1
19038,176205,B9aAlpTuKxaBHsrj0RG7kG5QNsYaYsmO,5Gyp41oLVo7Gg7vF4vpmggWP5MU70QO6,1,0,0,0,0,0,1,0,1,0.14285714285714285,1,0.0,0,0,0,0,0,0,0,1,0,0,1,1
19039,176218,c36CHPtUoc6fhEM1NLUSEGc0nqpTev6R,5Gyp41oLVo7Gg7vF4vpmggWP5MU70QO6,7,8,3,0,2,0,1,0,14,2.0,1,0.0,4,3,0,2,4,0,0,1,0,9,5,1
19040,176222,ofGS7KcwxKqmQcoDRP05KNd2lhdqc9OE,5Gyp41oLVo7Gg7vF4vpmggWP5MU70QO6,1,0,0,0,0,0,1,0,1,0.14285714285714285,1,0.0,0,0,0,0,0,0,0,1,0,0,1,1
19041,176230,YUmxw8AhlWaai9qANEKU5JbPFgVk9vKH,5Gyp41oLVo7Gg7vF4vpmggWP5MU70QO6,11,6,3,0,2,0,7,1,19,2.7142857142857144,1,0.0,0,3,0,2,6,0,0,7,1,5,14,1
19042,176236,C3Nk44OWnVsGKuPAx3enIkGku6jeLMIK,5Gyp41oLVo7Gg7vF4vpmggWP5MU70QO6,8,5,3,0,2,0,5,0,15,2.142857142857143,1,0.0,1,3,0,2,4,0,0,5,0,6,9,1
19043,176241,1Dv9y96t10oMZnHhDwrSFZDGRviHNlQf,5Gyp41oLVo7Gg7vF4vpmggWP5MU70QO6,1,0,0,0,0,0,1,0,1,0.14285714285714285,1,0.0,0,0,0,0,0,0,0,1,0,0,1,1
19044,176249,6CMvLh5h5srjVxFWpa9kBiwASsXtHal6,5Gyp41oLVo7Gg7vF4vpmggWP5MU70QO6,4,0,0,0,0,0,5,0,5,0.7142857142857143,1,0.0,0,0,0,0,0,0,0,5,0,0,5,1
19045,176282,G1j3OGbuafsHwZiTquDW8gM0iwcLwj0G,5Gyp41oLVo7Gg7vF4vpmggWP5MU70QO6,1,0,0,0,0,0,2,0,2,0.2857142857142857,1,0.0,0,0,0,0,0,0,0,2,0,0,2,1
19046,176285,upy0zKGQc2Dip5roDfd59XzFwjq2PFEV,5Gyp41oLVo7Gg7vF4vpmggWP5MU70QO6,12,7,4,0,4,6,7,1,29,4.142857142857143,1,0.0,1,4,0,4,6,6,0,7,1,9,20,1
19047,176299,U7XY4QqPO741JpunN73CGK6UMtcgDAi5,5Gyp41oLVo7Gg7vF4vpmggWP5MU70QO6,6,2,1,0,1,1,3,1,9,1.2857142857142858,1,0.0,0,1,0,1,2,1,0,3,1,2,7,1
19048,176300,3UfuCzggNTWXUiVNEYOfqQVufvyqj7kD,5Gyp41oLVo7Gg7vF4vpmggWP5MU70QO6,2,0,0,0,0,0,2,0,2,0.2857142857142857,1,0.0,0,0,0,0,0,0,0,2,0,0,2,1
19049,176306,9vNcgQ5TccJLdeNEo73apzpETn36fL0B,5Gyp41oLVo7Gg7vF4vpmggWP5MU70QO6,7,10,0,0,0,1,14,1,26,3.7142857142857144,1,0.0,0,0,0,0,10,1,0,14,1,0,26,1
19050,176307,czKChsqaxfwVoznY2WnWYH2vLIXb6X34,5Gyp41oLVo7Gg7vF4vpmggWP5MU70QO6,11,12,9,2,6,0,3,0,32,4.571428571428571,1,0.0,2,9,1,6,10,0,1,3,0,18,14,1
19051,176331,dl8GqF7Bxl75akw7CrLpwkZF8TE7q4rA,5Gyp41oLVo7Gg7vF4vpmggWP5MU70QO6,1,0,0,0,0,0,2,0,2,0.2857142857142857,1,0.0,0,0,0,0,0,0,0,2,0,0,2,1
19052,176351,WnfN1AUOAXHdbXdeEDhl2CVqkvTuIggL,fbPkOYLVPtPgIt0MxizjfFJov3JbHyAi,5,7,1,0,1,0,1,0,10,1.4285714285714286,1,0.0,0,1,0,1,7,0,0,1,0,2,8,1
19053,176352,0Tg2flbTUdD7fODqYIfpiJiK0IDdFiOP,fbPkOYLVPtPgIt0MxizjfFJov3JbHyAi,10,11,8,0,3,9,5,1,37,5.285714285714286,2,0.0,0,8,0,3,11,9,0,5,1,11,26,1
19054,176355,KJS7r9EjJHKntMFiDb2wMANmClPA9sbb,fbPkOYLVPtPgIt0MxizjfFJov3JbHyAi,1,0,0,0,0,0,1,0,1,0.14285714285714285,1,0.0,0,0,0,0,0,0,0,1,0,0,1,1
19055,176360,KRoFm4XNv5Pgle2ZS0CeLtv9ebvwgu1y,fbPkOYLVPtPgIt0MxizjfFJov3JbHyAi,9,10,4,0,3,4,4,0,25,3.5714285714285716,1,0.0,1,4,0,3,9,4,0,4,0,8,17,1
19056,176361,BmuAMS4WfX6ydPmjIcZND4OORiH4QIrO,fbPkOYLVPtPgIt0MxizjfFJov3JbHyAi,7,3,2,0,2,0,2,0,9,1.2857142857142858,1,0.0,0,2,0,2,3,0,0,2,0,4,5,1
19057,176365,Cm2FzbnvftvXUAfd52plpEGocR1jnm3F,fbPkOYLVPtPgIt0MxizjfFJov3JbHyAi,7,4,2,0,2,0,2,0,10,1.4285714285714286,1,0.0,1,2,0,2,3,0,0,2,0,5,5,1
19058,176368,p62NLzlqSMU9iNFHUVvUYCz9yDIitTLP,fbPkOYLVPtPgIt0MxizjfFJov3JbHyAi,7,3,0,0,0,0,7,1,11,1.5714285714285714,1,0.0,0,0,0,0,3,0,0,7,1,0,11,1
19059,176370,i9CWvduTcskommMHOeHEvsItP05JGHxW,fbPkOYLVPtPgIt0MxizjfFJov3JbHyAi,1,0,0,0,0,0,2,0,2,0.2857142857142857,1,0.0,0,0,0,0,0,0,0,2,0,0,2,1
19060,176372,ScH0NQfTgHr8NVyVOwPwgUgAUDqKXQgu,fbPkOYLVPtPgIt0MxizjfFJov3JbHyAi,2,0,0,0,0,0,4,0,4,0.5714285714285714,1,0.0,0,0,0,0,0,0,0,4,0,0,4,1
19061,176384,QU5veVGVoBVElxn9NViHXdfKseQ4NUTU,7GRhBDsirIGkRZBtSMEzNTyDr2JQm4xx,25,27,16,12,14,1,2,0,72,10.285714285714286,1,0.0,10,16,7,14,17,1,5,2,0,47,25,1
19062,176401,NwyEsAPgfXRjtBVHC91OfF1dna6dk38d,7GRhBDsirIGkRZBtSMEzNTyDr2JQm4xx,19,26,11,0,9,0,4,0,50,7.142857142857143,1,0.0,0,11,0,9,26,0,0,4,0,20,30,1
19063,176405,b9mxLoVADmerKv5HkkvTTWu7wHJ0K2g8,5X6FeZozNMgE2VRi3MJYjkkFK8SETtu2,4,2,1,0,1,0,1,0,5,0.7142857142857143,1,0.0,0,1,0,1,2,0,0,1,0,2,3,1
19064,176411,f8gEnkOWvMQIzCDEd46i00q4dVKvWUZK,5X6FeZozNMgE2VRi3MJYjkkFK8SETtu2,14,15,1,0,1,5,12,1,35,5.0,2,0.0,4,1,0,1,11,5,0,12,1,6,29,1
19065,176418,LniFNdPaciUOqrTfSPwpZs6KRBHeztca,5X6FeZozNMgE2VRi3MJYjkkFK8SETtu2,2,0,0,0,0,0,2,0,2,0.2857142857142857,1,0.0,0,0,0,0,0,0,0,2,0,0,2,1
19066,176427,38HaiNGogMQZ7XFJyXto2il2akhOzypw,7GRhBDsirIGkRZBtSMEzNTyDr2JQm4xx,4,3,2,0,0,0,1,0,6,0.8571428571428571,1,0.0,0,2,0,0,3,0,0,1,0,2,4,1
19067,176445,KKRopoEnIcVLemmRWp2ZZPu1vshGAf1i,5X6FeZozNMgE2VRi3MJYjkkFK8SETtu2,2,0,0,0,0,0,2,0,2,0.2857142857142857,1,0.0,0,0,0,0,0,0,0,2,0,0,2,1
19068,176450,7rsrCVMWlOWL1EBL5oTIUxzrypr861Ec,7GRhBDsirIGkRZBtSMEzNTyDr2JQm4xx,22,27,11,14,8,1,2,0,63,9.0,1,0.0,14,11,7,8,13,1,7,2,0,40,23,1
19069,176460,oaoj9be4jW2Hot8wYgYrzLRvB0RU4KYy,5X6FeZozNMgE2VRi3MJYjkkFK8SETtu2,5,4,2,0,1,0,3,0,10,1.4285714285714286,2,0.0,0,2,0,1,4,0,0,3,0,3,7,0
19070,176472,H3iVkRV8UPZvsbvYrU1dnbX51IlHemsF,7GRhBDsirIGkRZBtSMEzNTyDr2JQm4xx,1,0,0,0,0,0,1,0,1,0.14285714285714285,1,0.0,0,0,0,0,0,0,0,1,0,0,1,1
19071,176490,pKAeHHDfjWeWKboBDETcUDHa7kpDQYOp,5X6FeZozNMgE2VRi3MJYjkkFK8SETtu2,15,21,1,6,2,0,6,0,36,5.142857142857143,3,0.0,11,1,6,2,10,0,0,6,0,20,16,1
19072,176497,TdvOfODULzKCo3CRrsWuoBlElu9vlzI6,7GRhBDsirIGkRZBtSMEzNTyDr2JQm4xx,12,6,4,0,4,0,2,0,16,2.2857142857142856,1,0.0,0,4,0,4,6,0,0,2,0,8,8,1
19073,176508,7g0rMHEyd47fjq4g3xpElNL7nIAjgCwY,5X6FeZozNMgE2VRi3MJYjkkFK8SETtu2,1,0,0,0,0,0,1,0,1,0.14285714285714285,1,0.0,0,0,0,0,0,0,0,1,0,0,1,1
19074,176512,uymreEOSNmNZtilEkQpiM8TbwZcRYgYz,7GRhBDsirIGkRZBtSMEzNTyDr2JQm4xx,6,7,3,0,3,0,4,0,17,2.4285714285714284,1,0.0,0,3,0,3,7,0,0,4,0,6,11,1
19075,176530,FwNBQnrMN6SVYSed0kgql3TnqU22qpDv,7GRhBDsirIGkRZBtSMEzNTyDr2JQm4xx,11,6,5,0,5,0,2,0,18,2.5714285714285716,1,0.0,0,5,0,5,6,0,0,2,0,10,8,1
19076,176534,AsKItWOk6yONkGOduP0vUaGEDxnOlUCN,5X6FeZozNMgE2VRi3MJYjkkFK8SETtu2,1,0,0,0,0,0,1,0,1,0.14285714285714285,1,0.0,0,0,0,0,0,0,0,1,0,0,1,1
19077,176578,Vrnp33q5W6vex5c7FhvE2pEw2kHEQLPj,SpATywNh6bZuzm8s1ceuBUnMUAeoAHHw,1,0,0,0,0,0,1,0,1,0.14285714285714285,1,0.0,0,0,0,0,0,0,0,1,0,0,1,1
19078,176580,WlyNOREFyee6wG3QSx9dsILJnChCOzeS,SpATywNh6bZuzm8s1ceuBUnMUAeoAHHw,1,0,0,0,0,0,1,0,1,0.14285714285714285,1,0.0,0,0,0,0,0,0,0,1,0,0,1,1
19079,176585,WlyNOREFyee6wG3QSx9dsILJnChCOzeS,bWdj2GDclj5ofokWjzoa5jAwMkxCykd6,1,0,0,0,0,0,1,0,1,0.14285714285714285,1,0.0,0,0,0,0,0,0,0,1,0,0,1,1
19080,176586,WlyNOREFyee6wG3QSx9dsILJnChCOzeS,A3fsA9Zfv1X2fVEQhTw51lKENdNrEqT3,1,0,0,0,0,0,1,0,1,0.14285714285714285,1,0.0,0,0,0,0,0,0,0,1,0,0,1,1
19081,176600,UBShSm8Kqv0e1GzfDduGhtOotQp2uiza,RXDvfPUBYFlVdlueBFbLW0mhhAyGEqpt,43,39,16,144,7,7,6,0,219,31.285714285714285,2,0.0,13,16,138,7,26,7,6,6,0,174,45,1
19082,176611,c2DvyNdtfr8znslTLKffqC7HmPDiSWw0,RXDvfPUBYFlVdlueBFbLW0mhhAyGEqpt,1,0,0,0,0,0,1,0,1,0.14285714285714285,1,0.0,0,0,0,0,0,0,0,1,0,0,1,1
19083,176615,pIooitOY4Kj1UbygmuPfxFwwpH2R7NzD,bWdj2GDclj5ofokWjzoa5jAwMkxCykd6,1,0,0,0,0,0,1,0,1,0.14285714285714285,1,0.0,0,0,0,0,0,0,0,1,0,0,1,1
19084,176631,dgs5q517os0QP00EQ3rFo0TcrFNCs1kW,SpATywNh6bZuzm8s1ceuBUnMUAeoAHHw,13,12,4,13,3,0,2,0,34,4.857142857142857,1,0.0,4,4,13,3,8,0,0,2,0,24,10,1
19085,176634,t0m1BPy97jwvYrf5NqXFqeULLwloyg62,SpATywNh6bZuzm8s1ceuBUnMUAeoAHHw,11,19,0,18,0,0,3,0,40,5.714285714285714,1,0.0,11,0,15,0,8,0,3,3,0,26,14,0
19086,176642,K7nFLJJvhJnytzTEuQJeoArapKXlhdtY,A3fsA9Zfv1X2fVEQhTw51lKENdNrEqT3,3,2,1,0,0,0,2,0,5,0.7142857142857143,1,0.0,0,1,0,0,2,0,0,2,0,1,4,1
19087,176663,wQnqFfzf7T1nceXQBoyROaQMybFqk9YC,A3fsA9Zfv1X2fVEQhTw51lKENdNrEqT3,31,16,0,62,0,0,3,0,81,11.571428571428571,1,0.0,2,0,53,0,14,0,9,3,0,55,26,1
19088,176683,lsVTRIeOvE3c9uyXSsVkOz4L2qHzzgXN,bWdj2GDclj5ofokWjzoa5jAwMkxCykd6,6,4,2,0,1,0,4,0,11,1.5714285714285714,1,0.0,0,2,0,1,4,0,0,4,0,3,8,1
19089,176686,7VmmzXV3A639hzlpZwrx655FqwOsl8uh,RXDvfPUBYFlVdlueBFbLW0mhhAyGEqpt,9,6,0,0,0,0,5,0,11,1.5714285714285714,1,0.0,0,0,0,0,6,0,0,5,0,0,11,1
19090,176693,cZxcDNlAnm0tcnrjnkTKyh2S3nRuNP2Z,SpATywNh6bZuzm8s1ceuBUnMUAeoAHHw,7,3,1,0,1,0,3,1,9,1.2857142857142858,1,0.0,0,1,0,1,3,0,0,3,1,2,7,1
19091,176694,n5TgHqozAvMVxs3uLQhdtzkk63PUtkZ4,SpATywNh6bZuzm8s1ceuBUnMUAeoAHHw,3,2,0,0,0,0,1,0,3,0.42857142857142855,1,0.0,0,0,0,0,2,0,0,1,0,0,3,1
19092,176702,ngw0H084neoLUSHjmsnAwizUxOwdmBjF,SpATywNh6bZuzm8s1ceuBUnMUAeoAHHw,7,3,2,0,2,0,2,0,9,1.2857142857142858,1,0.0,0,2,0,2,3,0,0,2,0,4,5,1
19093,176703,M3Xa5IFPEZiaLK2rAjKqcPYFncjR6IsA,SpATywNh6bZuzm8s1ceuBUnMUAeoAHHw,2,0,0,0,0,0,2,0,2,0.2857142857142857,1,0.0,0,0,0,0,0,0,0,2,0,0,2,1
19094,176707,9wUPj3RdoqjpRwRmAYUumO6JhXkTAipi,5X6FeZozNMgE2VRi3MJYjkkFK8SETtu2,2,0,0,0,0,0,2,0,2,0.2857142857142857,1,0.0,0,0,0,0,0,0,0,2,0,0,2,1
19095,176709,WMHw9zFx2owqfPWjdqgQ3dXmYN0CSXui,SpATywNh6bZuzm8s1ceuBUnMUAeoAHHw,4,3,2,0,0,0,1,0,6,0.8571428571428571,1,0.0,0,2,0,0,3,0,0,1,0,2,4,1
19096,176712,r9RAlcNOEU4tSJ3VTxa7tKQ4IwaYSNfB,A3fsA9Zfv1X2fVEQhTw51lKENdNrEqT3,2,0,0,0,0,0,4,0,4,0.5714285714285714,1,0.0,0,0,0,0,0,0,0,4,0,0,4,1
19097,176724,v4iDqbLy28xt3m4stWuGbxYJ7PMtC6St,G8EPVSXsOYB5YQWZGiz1aVq5Pgr2GrQu,1,0,0,0,0,0,1,0,1,0.14285714285714285,1,0.0,0,0,0,0,0,0,0,1,0,0,1,1
19098,176732,6ifSGyv1OJBX59YUfupEGQzaFg12QLcw,5X6FeZozNMgE2VRi3MJYjkkFK8SETtu2,9,9,7,0,5,0,2,0,23,3.2857142857142856,1,0.0,0,7,0,5,9,0,0,2,0,12,11,1
19099,176733,FzKYBP9DQh3u0w9lQRHJGeubpb75FItD,5X6FeZozNMgE2VRi3MJYjkkFK8SETtu2,5,8,0,0,1,0,1,0,10,1.4285714285714286,1,0.0,3,0,0,1,5,0,0,1,0,4,6,1
19100,176734,44GafVKSjOefcGtCUMS1SAXmrzlFFSGG,SpATywNh6bZuzm8s1ceuBUnMUAeoAHHw,6,4,1,0,1,0,2,0,8,1.1428571428571428,2,0.0,0,1,0,1,4,0,0,2,0,2,6,1
19101,176771,vP6SXmTWZNLDpRliX4cZDs2mXlaBaub0,A3fsA9Zfv1X2fVEQhTw51lKENdNrEqT3,4,0,0,0,0,0,5,0,5,0.7142857142857143,1,0.0,0,0,0,0,0,0,0,5,0,0,5,1
19102,176781,V073dr3Ejc08S0Z4K4o33HIYkTog3ITe,SpATywNh6bZuzm8s1ceuBUnMUAeoAHHw,23,16,13,10,9,0,4,0,52,7.428571428571429,1,0.0,2,13,9,9,14,0,1,4,0,33,19,1
19103,176829,UGilWCcjcjXGcBN3IoOXTqqH7xZPNWuh,A3fsA9Zfv1X2fVEQhTw51lKENdNrEqT3,9,6,0,0,0,10,12,0,28,4.0,1,0.0,0,0,0,0,6,10,0,12,0,0,28,1
19104,176834,1Ud2Nlb0y9uKsOXhkhM9qhPj1Xv6ImgU,SpATywNh6bZuzm8s1ceuBUnMUAeoAHHw,2,0,0,0,0,0,3,0,3,0.42857142857142855,1,0.0,0,0,0,0,0,0,0,3,0,0,3,1
19105,176845,tkxwTpjNIcKspgIQFJ1HEHtxSp5ThNsq,A3fsA9Zfv1X2fVEQhTw51lKENdNrEqT3,16,9,7,0,6,2,2,0,26,3.7142857142857144,1,0.0,0,7,0,6,9,2,0,2,0,13,13,1
19106,176849,IqdQlZEDPmhIudkuSm1qvVaQ2dYiBuyU,SpATywNh6bZuzm8s1ceuBUnMUAeoAHHw,7,3,1,0,1,1,4,0,10,1.4285714285714286,1,0.0,0,1,0,1,3,1,0,4,0,2,8,1
19107,176862,TBj8ERKtARA6ABLjSlKdebgRJkBjpHod,A3fsA9Zfv1X2fVEQhTw51lKENdNrEqT3,2,0,0,0,0,0,2,0,2,0.2857142857142857,1,0.0,0,0,0,0,0,0,0,2,0,0,2,1
19108,176872,tD2t0ZHpAx0YjQwAL8UEB0neif6SIb4V,5X6FeZozNMgE2VRi3MJYjkkFK8SETtu2,1,0,0,0,0,0,1,0,1,0.14285714285714285,1,0.0,0,0,0,0,0,0,0,1,0,0,1,1
19109,176874,wHUsnhrtPSuwmobUglnvlK4BO3Mgdhur,5X6FeZozNMgE2VRi3MJYjkkFK8SETtu2,7,4,1,0,1,0,3,0,9,1.2857142857142858,1,0.0,0,1,0,1,4,0,0,3,0,2,7,1
19110,176897,wjicnAF12JyAapuh15sdon1diUWswaFA,RXDvfPUBYFlVdlueBFbLW0mhhAyGEqpt,6,3,1,0,1,0,2,0,7,1.0,1,0.0,0,1,0,1,3,0,0,2,0,2,5,1
19111,176900,buIoev2zkFP4DoRl01FTndVJ4fGwCvR1,5X6FeZozNMgE2VRi3MJYjkkFK8SETtu2,5,3,1,0,1,0,2,0,7,1.0,1,0.0,0,1,0,1,3,0,0,2,0,2,5,1
19112,176907,RVhulbNKnSbDIMoCPANZFAOa0qbIDxQt,A3fsA9Zfv1X2fVEQhTw51lKENdNrEqT3,1,0,0,0,0,0,1,0,1,0.14285714285714285,1,0.0,0,0,0,0,0,0,0,1,0,0,1,1
19113,176932,oqfmspVsCDU25zVJJu97mvH8ZAyQzgs4,SpATywNh6bZuzm8s1ceuBUnMUAeoAHHw,6,8,0,0,0,0,2,0,10,1.4285714285714286,1,0.0,0,0,0,0,8,0,0,2,0,0,10,1
19114,176945,DnNU68583OkMDFomIoumeRI68tNSmB88,SpATywNh6bZuzm8s1ceuBUnMUAeoAHHw,1,0,0,0,0,0,1,0,1,0.14285714285714285,1,0.0,0,0,0,0,0,0,0,1,0,0,1,1
19115,176946,bgwwZSIxTFRvIry4LocWcmZ15RQwBsJD,5X6FeZozNMgE2VRi3MJYjkkFK8SETtu2,4,2,1,0,0,0,2,0,5,0.7142857142857143,1,0.0,0,1,0,0,2,0,0,2,0,1,4,1
19116,176950,WczGVRZMmNzgMggUe3ZQ1bOs2IuTwUWO,bWdj2GDclj5ofokWjzoa5jAwMkxCykd6,1,0,0,0,0,0,1,0,1,0.14285714285714285,1,0.0,0,0,0,0,0,0,0,1,0,0,1,1
19117,176966,SzAtQzNOap38B7fNAidQGz1HfRyu6YSS,bWdj2GDclj5ofokWjzoa5jAwMkxCykd6,5,0,0,0,0,0,5,1,6,0.8571428571428571,1,0.0,0,0,0,0,0,0,0,5,1,0,6,1
19118,176967,bgwwZSIxTFRvIry4LocWcmZ15RQwBsJD,SpATywNh6bZuzm8s1ceuBUnMUAeoAHHw,1,0,0,0,0,0,1,0,1,0.14285714285714285,1,0.0,0,0,0,0,0,0,0,1,0,0,1,1
19119,176987,5JmpnTGe6ZHNgssYgcMaiqkF3B7C3AfJ,A3fsA9Zfv1X2fVEQhTw51lKENdNrEqT3,2,0,0,0,0,0,2,0,2,0.2857142857142857,1,0.0,0,0,0,0,0,0,0,2,0,0,2,1
19120,176988,AgYA7iHpk58icD4xPuYLYI9kpuqj6y1t,A3fsA9Zfv1X2fVEQhTw51lKENdNrEqT3,10,9,5,0,2,0,6,0,22,3.142857142857143,1,0.0,2,5,0,2,7,0,0,6,0,9,13,1
19121,176989,lBPkWmGWjMVGl7rjICN5T6By1CpF3Oh1,bWdj2GDclj5ofokWjzoa5jAwMkxCykd6,4,3,2,0,2,0,1,0,8,1.1428571428571428,1,0.0,0,2,0,2,3,0,0,1,0,4,4,1
19122,177004,kaNpWuIxNLxZkDfmjMzrYRVzuOgwIf0o,G8EPVSXsOYB5YQWZGiz1aVq5Pgr2GrQu,1,0,0,0,0,0,1,0,1,0.14285714285714285,1,0.0,0,0,0,0,0,0,0,1,0,0,1,1
19123,177051,QTuqQxk5mfpTPo5vfXzRqFyeBm1ocbxg,bWdj2GDclj5ofokWjzoa5jAwMkxCykd6,11,5,4,0,2,4,6,1,22,3.142857142857143,1,0.0,0,4,0,2,5,4,0,6,1,6,16,1
19124,177063,me3X50gZnHqxKqokwhcjCSa6sPS8gx2x,bWdj2GDclj5ofokWjzoa5jAwMkxCykd6,4,2,1,0,1,0,1,0,5,0.7142857142857143,1,0.0,0,1,0,1,2,0,0,1,0,2,3,1
19125,177084,KGMUqHbYYqeF4kil6zUa1qpianJR3FpM,SpATywNh6bZuzm8s1ceuBUnMUAeoAHHw,9,8,1,0,0,0,8,2,19,2.7142857142857144,3,0.0,1,1,0,0,7,0,0,8,2,2,17,1
19126,177087,9G22TFSpifXf2dRYsg4E8vgkMWfro3Ct,bWdj2GDclj5ofokWjzoa5jAwMkxCykd6,6,7,1,0,0,0,9,0,17,2.4285714285714284,2,0.0,0,1,0,0,7,0,0,9,0,1,16,1
19127,177109,EPVEir3f8DxjouE65Q4kYI9YaQMxGE89,A3fsA9Zfv1X2fVEQhTw51lKENdNrEqT3,7,7,1,0,0,4,3,0,15,2.142857142857143,1,0.0,0,1,0,0,7,4,0,3,0,1,14,1
19128,177111,niznzPsNcmf0qkvKVIABVzsBAFOWmMfr,bWdj2GDclj5ofokWjzoa5jAwMkxCykd6,2,0,0,0,0,0,2,0,2,0.2857142857142857,1,0.0,0,0,0,0,0,0,0,2,0,0,2,1
19129,177114,wingMAl29ucopfiyx66jxxaUInzOOQW5,SpATywNh6bZuzm8s1ceuBUnMUAeoAHHw,24,46,14,0,9,2,10,0,81,11.571428571428571,2,0.0,4,14,0,9,42,2,0,10,0,27,54,1
19130,177116,Eaa30ereqeYtcFzjnswlE9j5n8XVdiuw,RXDvfPUBYFlVdlueBFbLW0mhhAyGEqpt,1,0,0,0,0,0,1,0,1,0.14285714285714285,1,0.0,0,0,0,0,0,0,0,1,0,0,1,1
19131,177120,6cITiMTgl3oJ2Te8Gyo0QosHV4ODB0Uw,RXDvfPUBYFlVdlueBFbLW0mhhAyGEqpt,27,26,19,0,12,6,6,0,69,9.857142857142858,1,0.0,0,19,0,12,26,6,0,6,0,31,38,0
19132,177126,v0rc6s78QYYUfWFSx1cNskOtUuDahOBd,5X6FeZozNMgE2VRi3MJYjkkFK8SETtu2,1,0,0,0,0,0,1,0,1,0.14285714285714285,1,0.0,0,0,0,0,0,0,0,1,0,0,1,1
19133,177129,v0rc6s78QYYUfWFSx1cNskOtUuDahOBd,RXDvfPUBYFlVdlueBFbLW0mhhAyGEqpt,8,2,1,0,1,0,5,1,10,1.4285714285714286,1,0.0,0,1,0,1,2,0,0,5,1,2,8,1
19134,177136,sN7SpMjN00gTdmZynEw6AXtweTyZtD7L,5X6FeZozNMgE2VRi3MJYjkkFK8SETtu2,13,20,4,4,9,1,8,1,47,6.714285714285714,2,0.0,14,4,4,9,6,1,0,8,1,31,16,1
19135,177140,sN7SpMjN00gTdmZynEw6AXtweTyZtD7L,A3fsA9Zfv1X2fVEQhTw51lKENdNrEqT3,7,4,2,0,1,0,4,0,11,1.5714285714285714,1,0.0,1,2,0,1,3,0,0,4,0,4,7,1
19136,177146,GHoD8AIr3r5Mp1AqZoXIC9i225P9RubE,bWdj2GDclj5ofokWjzoa5jAwMkxCykd6,5,2,1,0,1,0,2,0,6,0.8571428571428571,1,0.0,0,1,0,1,2,0,0,2,0,2,4,1
19137,177148,eT9OhUahWhAeZfHPEbxGN9qGHwvkkQvs,RXDvfPUBYFlVdlueBFbLW0mhhAyGEqpt,1,0,0,0,0,0,1,0,1,0.14285714285714285,1,0.0,0,0,0,0,0,0,0,1,0,0,1,1
19138,177154,1quHb10fObuEEg4CZXYAqSIkbHHSbI1d,SpATywNh6bZuzm8s1ceuBUnMUAeoAHHw,1,0,0,0,0,0,1,0,1,0.14285714285714285,1,0.0,0,0,0,0,0,0,0,1,0,0,1,1
19139,177170,eT9OhUahWhAeZfHPEbxGN9qGHwvkkQvs,5X6FeZozNMgE2VRi3MJYjkkFK8SETtu2,1,0,0,0,0,0,1,0,1,0.14285714285714285,1,0.0,0,0,0,0,0,0,0,1,0,0,1,1
19140,177179,nURvxLXCCRcUx0rr21CCKt2pPqq3RcJ7,G8EPVSXsOYB5YQWZGiz1aVq5Pgr2GrQu,1,0,0,0,0,0,1,0,1,0.14285714285714285,1,0.0,0,0,0,0,0,0,0,1,0,0,1,1
19141,177191,RzpNewewHDhOLk08WWwTdZBpVAjeuouY,SpATywNh6bZuzm8s1ceuBUnMUAeoAHHw,1,0,0,0,0,0,1,0,1,0.14285714285714285,1,0.0,0,0,0,0,0,0,0,1,0,0,1,1
19142,177194,5K1YQb6WOjDwHsAIqvYsCK3LL78wZoyl,SpATywNh6bZuzm8s1ceuBUnMUAeoAHHw,5,2,1,0,1,0,2,0,6,0.8571428571428571,1,0.0,0,1,0,1,2,0,0,2,0,2,4,1
19143,177220,3iyvvUD6yZB0z0YjGBWx9vW081IJua41,A3fsA9Zfv1X2fVEQhTw51lKENdNrEqT3,4,2,0,0,0,0,4,0,6,0.8571428571428571,1,0.0,0,0,0,0,2,0,0,4,0,0,6,0
19144,177247,QVAnyKdi4bfbM8lryBslY25kPK1liRUQ,5X6FeZozNMgE2VRi3MJYjkkFK8SETtu2,22,22,5,54,0,0,2,0,83,11.857142857142858,1,0.0,11,5,41,0,11,0,13,2,0,57,26,1
19145,177248,VJ6kjzPollQLDbYztoyg8LEnFGMc5bZx,bWdj2GDclj5ofokWjzoa5jAwMkxCykd6,2,0,0,0,0,0,3,0,3,0.42857142857142855,1,0.0,0,0,0,0,0,0,0,3,0,0,3,0
19146,177253,LxsrJ5jQBHgpoDvJjmW7B1PIBB1B9rOy,A3fsA9Zfv1X2fVEQhTw51lKENdNrEqT3,2,0,0,0,0,0,2,0,2,0.2857142857142857,1,0.0,0,0,0,0,0,0,0,2,0,0,2,1
19147,177267,QiYah6MaRTZX43IYRVARS0cRIO6IdBSv,A3fsA9Zfv1X2fVEQhTw51lKENdNrEqT3,1,0,0,0,0,0,1,0,1,0.14285714285714285,1,0.0,0,0,0,0,0,0,0,1,0,0,1,1
19148,177287,GFHYWWeeAuj1pePvOmCpIpIQDTy4Q3Iv,A3fsA9Zfv1X2fVEQhTw51lKENdNrEqT3,1,0,0,0,0,0,1,0,1,0.14285714285714285,1,0.0,0,0,0,0,0,0,0,1,0,0,1,1
19149,177292,MCY34unG8KB7lFkmy7ruLaHeUqkrRhUd,SpATywNh6bZuzm8s1ceuBUnMUAeoAHHw,13,18,6,4,3,0,2,0,33,4.714285714285714,1,0.0,7,6,4,3,11,0,0,2,0,20,13,1
19150,177294,0xRWiMAkDSQyarQpahb5IxRgJIgg5cjl,SpATywNh6bZuzm8s1ceuBUnMUAeoAHHw,1,0,0,0,0,0,1,0,1,0.14285714285714285,1,0.0,0,0,0,0,0,0,0,1,0,0,1,1
19151,177312,Vnz3YQtaGP9Lud4eJsx4REuNf7a7Z6K7,A3fsA9Zfv1X2fVEQhTw51lKENdNrEqT3,8,6,4,0,2,0,8,0,20,2.857142857142857,3,0.0,0,4,0,2,6,0,0,8,0,6,14,1
19152,177338,ls1F2KUi19ehHJYjRRU9ukCpIm6Mq0QX,bWdj2GDclj5ofokWjzoa5jAwMkxCykd6,7,11,3,0,2,2,8,1,27,3.857142857142857,1,0.0,3,3,0,2,8,2,0,8,1,8,19,1
19153,177342,ukV83h2gop6RgQ4r0p0CZA73Nn6q15H2,SpATywNh6bZuzm8s1ceuBUnMUAeoAHHw,15,16,9,8,5,0,4,0,42,6.0,2,0.0,4,9,8,5,12,0,0,4,0,26,16,1
19154,177357,bvUZAD2pQ0JG1rSj4fd4oSXQV1yLwXI1,bWdj2GDclj5ofokWjzoa5jAwMkxCykd6,1,0,0,0,0,0,1,0,1,0.14285714285714285,1,0.0,0,0,0,0,0,0,0,1,0,0,1,1
19155,177359,rrdUVc7PxY1K5CKjH5FZPZeykLw0CqkU,SpATywNh6bZuzm8s1ceuBUnMUAeoAHHw,5,3,1,0,1,0,6,0,11,1.5714285714285714,1,0.0,0,1,0,1,3,0,0,6,0,2,9,1
19156,177362,dGWL5aQxrmUKcXwkRJNonE7KRjTXcSnx,SpATywNh6bZuzm8s1ceuBUnMUAeoAHHw,4,3,0,0,0,0,2,0,5,0.7142857142857143,1,0.0,0,0,0,0,3,0,0,2,0,0,5,0
19157,177399,uhkDcin3PArnCPqTjpaPDSIZjLR3fQYS,5X6FeZozNMgE2VRi3MJYjkkFK8SETtu2,1,0,0,0,0,0,1,0,1,0.14285714285714285,1,0.0,0,0,0,0,0,0,0,1,0,0,1,1
19158,177411,P5T4sFdQt6aGZ3iihRY0M991VNl2H2j2,SpATywNh6bZuzm8s1ceuBUnMUAeoAHHw,7,4,1,0,1,3,5,0,14,2.0,1,0.0,1,1,0,1,3,3,0,5,0,3,11,1
19159,177414,cRvonGDWMKfxHYP6TdkGqL61F16M4yAA,5X6FeZozNMgE2VRi3MJYjkkFK8SETtu2,8,5,0,0,0,9,6,1,21,3.0,1,0.0,0,0,0,0,5,9,0,6,1,0,21,1
19160,177420,3oOqBk0mNUyJOixMnwNMAtDLNYAAzxVe,5X6FeZozNMgE2VRi3MJYjkkFK8SETtu2,1,0,0,0,0,0,1,0,1,0.14285714285714285,1,0.0,0,0,0,0,0,0,0,1,0,0,1,0
19161,177441,uUdFMnM36oHfhjmWTDXFNgr7FNTKYZUv,A3fsA9Zfv1X2fVEQhTw51lKENdNrEqT3,5,2,1,0,1,0,2,0,6,0.8571428571428571,1,0.0,0,1,0,1,2,0,0,2,0,2,4,0
19162,177447,ONzOWoX8tSfcZlukia6Q8bk2oPYRBqMN,bWdj2GDclj5ofokWjzoa5jAwMkxCykd6,1,0,0,0,0,0,1,0,1,0.14285714285714285,1,0.0,0,0,0,0,0,0,0,1,0,0,1,1
19163,177488,5om6eRMcHP5gmynnbtix8k5kZKtSYX2Y,5X6FeZozNMgE2VRi3MJYjkkFK8SETtu2,1,0,0,0,0,0,1,0,1,0.14285714285714285,1,0.0,0,0,0,0,0,0,0,1,0,0,1,1
19164,177493,K3eaSd5rYP9Gkimldqt40pigYQrGeLsH,A3fsA9Zfv1X2fVEQhTw51lKENdNrEqT3,28,26,18,0,8,0,5,0,57,8.142857142857142,2,0.0,0,18,0,8,26,0,0,5,0,26,31,1
19165,177500,UtuMMiTcYdEIPqLGUrTySvaHfGG20tSq,RXDvfPUBYFlVdlueBFbLW0mhhAyGEqpt,1,0,0,0,0,0,1,0,1,0.14285714285714285,1,0.0,0,0,0,0,0,0,0,1,0,0,1,1
19166,177506,TL1aA8ITe7VP42GX52yE5M5UsjXNCOS3,SpATywNh6bZuzm8s1ceuBUnMUAeoAHHw,14,11,7,14,4,23,3,0,62,8.857142857142858,2,0.0,2,7,11,4,9,23,3,3,0,24,38,1
19167,177521,UtuMMiTcYdEIPqLGUrTySvaHfGG20tSq,bWdj2GDclj5ofokWjzoa5jAwMkxCykd6,4,2,1,0,1,0,1,0,5,0.7142857142857143,1,0.0,0,1,0,1,2,0,0,1,0,2,3,1
19168,177534,y4HEate091nZSs6CdPCmi4GDN3wtU4uQ,bWdj2GDclj5ofokWjzoa5jAwMkxCykd6,1,0,0,0,0,0,1,0,1,0.14285714285714285,1,0.0,0,0,0,0,0,0,0,1,0,0,1,1
19169,177538,r4ZoHGMZmqAV8283r1kkNHYmSCMouZ71,SpATywNh6bZuzm8s1ceuBUnMUAeoAHHw,1,0,0,0,0,0,1,0,1,0.14285714285714285,1,0.0,0,0,0,0,0,0,0,1,0,0,1,1
19170,177648,XTgYONXtkRAl3sCFaGFF8e1mU9AMcEwg,A3fsA9Zfv1X2fVEQhTw51lKENdNrEqT3,1,0,0,0,0,0,1,0,1,0.14285714285714285,1,0.0,0,0,0,0,0,0,0,1,0,0,1,1
19171,177656,3EOSgrGzaBOPj9C9GS5Q7Pv420ga9IOi,SpATywNh6bZuzm8s1ceuBUnMUAeoAHHw,16,16,8,0,6,0,2,0,32,4.571428571428571,2,0.0,0,8,0,6,16,0,0,2,0,14,18,1
19172,177671,pGYLDmhkSj1iBp1YljlDSId0XSrjZNZR,G8EPVSXsOYB5YQWZGiz1aVq5Pgr2GrQu,1,0,0,0,0,0,1,0,1,0.14285714285714285,1,0.0,0,0,0,0,0,0,0,1,0,0,1,1
19173,177692,EovGqmWXTyV2r8yAXv2wZ0VYOf33vn0t,SpATywNh6bZuzm8s1ceuBUnMUAeoAHHw,8,9,2,0,2,0,4,0,17,2.4285714285714284,1,0.0,1,2,0,2,8,0,0,4,0,5,12,1
19174,177701,vvZAdi1giBsqNJd2MIMUF2BeNIuSYzIL,A3fsA9Zfv1X2fVEQhTw51lKENdNrEqT3,1,0,0,0,0,0,1,0,1,0.14285714285714285,1,0.0,0,0,0,0,0,0,0,1,0,0,1,1
19175,177704,M2AmcvqhvMtUlyRV6vMvvoM2IhrMmAwT,RXDvfPUBYFlVdlueBFbLW0mhhAyGEqpt,5,2,1,0,1,0,3,0,7,1.0,1,0.0,0,1,0,1,2,0,0,3,0,2,5,1
19176,177705,wlzAgdvhO4A4jv5wZbftQLCtHeMZtcKt,A3fsA9Zfv1X2fVEQhTw51lKENdNrEqT3,8,1,1,0,1,1,11,1,16,2.2857142857142856,1,0.0,0,1,0,1,1,1,0,11,1,2,14,1
19177,177706,Hw8jmGp4VI4tAz6cfKhHDOeLB2t7MJ9z,A3fsA9Zfv1X2fVEQhTw51lKENdNrEqT3,1,0,0,0,0,0,1,0,1,0.14285714285714285,1,0.0,0,0,0,0,0,0,0,1,0,0,1,1
19178,177712,bkuP1EtN8mdTFJXvfsUwoFetipNOKV1x,bWdj2GDclj5ofokWjzoa5jAwMkxCykd6,4,2,0,0,0,0,2,0,4,0.5714285714285714,1,0.0,0,0,0,0,2,0,0,2,0,0,4,0
19179,177716,YeSu5vnyd7NLR6mjoon0rNurw7LtWHKM,SpATywNh6bZuzm8s1ceuBUnMUAeoAHHw,5,2,1,0,1,0,2,0,6,0.8571428571428571,1,0.0,0,1,0,1,2,0,0,2,0,2,4,1
19180,177731,nWfmkEV4YCKZ7mcPyrthk5xsFNQD6yNN,SpATywNh6bZuzm8s1ceuBUnMUAeoAHHw,15,13,2,11,0,0,2,0,28,4.0,1,0.0,0,2,10,0,13,0,1,2,0,12,16,1
19181,177737,F7IgmS7BQy7wghj5xQppsiqo1bYAbUaS,A3fsA9Zfv1X2fVEQhTw51lKENdNrEqT3,2,0,0,0,0,0,3,0,3,0.42857142857142855,1,0.0,0,0,0,0,0,0,0,3,0,0,3,1
19182,177744,7MJ8Lhv2PsjCppkY7orFcs7zn9hmP4MG,A3fsA9Zfv1X2fVEQhTw51lKENdNrEqT3,5,2,1,0,1,0,3,0,7,1.0,2,0.0,0,1,0,1,2,0,0,3,0,2,5,1
19183,177746,FTdbZ3S8aZZ61DWcRvHq8VI8NuRVTtYB,SpATywNh6bZuzm8s1ceuBUnMUAeoAHHw,5,3,1,0,1,0,1,0,6,0.8571428571428571,1,0.0,0,1,0,1,3,0,0,1,0,2,4,1
19184,177781,Fjsr4YVijnhHCyav53zNG4j0ri6wctia,SpATywNh6bZuzm8s1ceuBUnMUAeoAHHw,5,2,1,0,1,1,2,0,7,1.0,1,0.0,0,1,0,1,2,1,0,2,0,2,5,1
19185,177802,IfuP3wsHPcoufqx0FyqFKUytwStvSPv8,SpATywNh6bZuzm8s1ceuBUnMUAeoAHHw,8,7,1,0,1,0,2,0,11,1.5714285714285714,1,0.0,0,1,0,1,7,0,0,2,0,2,9,1
19186,177808,h1QswJ31uhxfyhfP3OhNVJBUvcTub6pW,A3fsA9Zfv1X2fVEQhTw51lKENdNrEqT3,6,2,1,0,1,0,3,0,7,1.0,1,0.0,0,1,0,1,2,0,0,3,0,2,5,1
19187,177815,bntZ4rfkG0kbpKVyaZN5dpSYAjphN7lA,SpATywNh6bZuzm8s1ceuBUnMUAeoAHHw,2,0,0,0,0,0,4,0,4,0.5714285714285714,1,0.0,0,0,0,0,0,0,0,4,0,0,4,1
19188,177823,obnzTYQwwpz4VOaAZpvzueXnEk1orSl6,RXDvfPUBYFlVdlueBFbLW0mhhAyGEqpt,1,0,0,0,0,0,1,0,1,0.14285714285714285,1,0.0,0,0,0,0,0,0,0,1,0,0,1,1
19189,177826,6Orjf1CvaLA2u5CajSzbONgKa1cSGpsp,SpATywNh6bZuzm8s1ceuBUnMUAeoAHHw,5,2,1,0,1,0,2,0,6,0.8571428571428571,1,0.0,0,1,0,1,2,0,0,2,0,2,4,1
19190,177833,WfZHYsGW1JdLRZrh0HxeGf3PWw6Zaiy6,SpATywNh6bZuzm8s1ceuBUnMUAeoAHHw,5,2,1,0,1,0,2,0,6,0.8571428571428571,1,0.0,0,1,0,1,2,0,0,2,0,2,4,1
19191,177838,sJcjGGS4IqxtZ0yUL13beAzln7dowOpj,SpATywNh6bZuzm8s1ceuBUnMUAeoAHHw,1,0,0,0,0,0,1,0,1,0.14285714285714285,1,0.0,0,0,0,0,0,0,0,1,0,0,1,1
19192,177841,M8GvXQvqlItd1uaUuAOKL5aVksmfHCxv,G8EPVSXsOYB5YQWZGiz1aVq5Pgr2GrQu,3,3,1,0,0,0,1,0,5,0.7142857142857143,1,0.0,0,1,0,0,3,0,0,1,0,1,4,1
19193,177874,vCeaWq9tqFyvtajgk87uB8epKyzp49he,SpATywNh6bZuzm8s1ceuBUnMUAeoAHHw,13,12,5,11,2,1,4,0,35,5.0,1,0.0,5,5,9,2,7,1,2,4,0,21,14,1
19194,177879,M8C9BDFICk4ida59GU0jjp556zazDEi1,G8EPVSXsOYB5YQWZGiz1aVq5Pgr2GrQu,7,5,3,0,1,0,4,0,13,1.8571428571428572,2,0.0,0,3,0,1,5,0,0,4,0,4,9,1
19195,177882,EwT4gfO7FSX1b89EA44scYJQueULJfeO,SpATywNh6bZuzm8s1ceuBUnMUAeoAHHw,5,2,1,0,1,0,2,0,6,0.8571428571428571,1,0.0,0,1,0,1,2,0,0,2,0,2,4,1
19196,177889,Ccj8NEsaoMQRZnTXAxQZ3mlzMKhmRScC,SpATywNh6bZuzm8s1ceuBUnMUAeoAHHw,16,23,10,6,4,0,3,0,46,6.571428571428571,1,0.0,6,10,6,4,17,0,0,3,0,26,20,0
19197,177896,A6tOI6UQdaIkkVbh2LcanNew6i5iO2fH,bWdj2GDclj5ofokWjzoa5jAwMkxCykd6,1,0,0,0,0,0,2,0,2,0.2857142857142857,1,0.0,0,0,0,0,0,0,0,2,0,0,2,1
19198,177916,x5efWjoRyi52rQ7JepSo4abkhsClgbZ4,bWdj2GDclj5ofokWjzoa5jAwMkxCykd6,2,0,0,0,0,0,2,0,2,0.2857142857142857,1,0.0,0,0,0,0,0,0,0,2,0,0,2,1
19199,177918,Ck862YJ4TKsW5xBb6Obw9gcSWBzSDmoA,SpATywNh6bZuzm8s1ceuBUnMUAeoAHHw,10,12,0,19,0,0,2,0,33,4.714285714285714,1,0.0,4,0,15,0,8,0,4,2,0,19,14,1
19200,177946,fsYAWTSjas5dj2ZT4ziu6J8GfCN2A543,SpATywNh6bZuzm8s1ceuBUnMUAeoAHHw,8,2,1,0,1,1,5,1,11,1.5714285714285714,1,0.0,0,1,0,1,2,1,0,5,1,2,9,1
19201,177947,t0soD7aQ6w7DGyhmXz7wyAfUbtBWT4NA,RXDvfPUBYFlVdlueBFbLW0mhhAyGEqpt,25,14,13,0,11,0,2,0,40,5.714285714285714,1,0.0,0,13,0,11,14,0,0,2,0,24,16,0
19202,178015,IZxwz54TsYvU9RDBY0Jd0dZSoQSefAFM,SpATywNh6bZuzm8s1ceuBUnMUAeoAHHw,3,0,0,0,0,0,7,0,7,1.0,1,0.0,0,0,0,0,0,0,0,7,0,0,7,1
19203,178018,EQaS3CpcvDJhQrwHEK3TrEH3gvn0Dpxt,A3fsA9Zfv1X2fVEQhTw51lKENdNrEqT3,1,0,0,0,0,0,1,0,1,0.14285714285714285,1,0.0,0,0,0,0,0,0,0,1,0,0,1,1
19204,178031,dH1fJFd4EUa9cDGkzaH97LNe2YTOAGRI,bWdj2GDclj5ofokWjzoa5jAwMkxCykd6,1,0,0,0,0,0,2,0,2,0.2857142857142857,1,0.0,0,0,0,0,0,0,0,2,0,0,2,1
19205,178048,ZnF4cH0Rkfun3Ujybr1tuGGeHps3w9hO,A3fsA9Zfv1X2fVEQhTw51lKENdNrEqT3,20,10,9,0,8,0,3,0,30,4.285714285714286,2,0.0,0,9,0,8,10,0,0,3,0,17,13,1
19206,178057,vOyNIvbmr9YMEBhwQMSd5QWgWHEvzCE0,SpATywNh6bZuzm8s1ceuBUnMUAeoAHHw,9,8,1,10,1,0,3,0,23,3.2857142857142856,1,0.0,2,1,9,1,6,0,1,3,0,13,10,1
19207,178058,xk56WEVJEAYlfTe18KDPHjwyCpm6eESo,G8EPVSXsOYB5YQWZGiz1aVq5Pgr2GrQu,19,37,20,30,10,0,5,0,102,14.571428571428571,2,0.0,7,20,29,10,30,0,1,5,0,66,36,1
19208,178065,Cwlc0kvvLoKXxEuXNQkjFRo818TDMpZS,A3fsA9Zfv1X2fVEQhTw51lKENdNrEqT3,12,6,5,0,5,0,1,0,17,2.4285714285714284,1,0.0,0,5,0,5,6,0,0,1,0,10,7,1
19209,178071,8uKfJT3Ferex7gSStlreZzcbQrGyXHDu,A3fsA9Zfv1X2fVEQhTw51lKENdNrEqT3,13,5,4,22,3,0,1,0,35,5.0,1,0.0,0,4,19,3,5,0,3,1,0,26,9,1
19210,178091,YRvoydpc37Vpysmtw8O9rzowfgsZu7lO,SpATywNh6bZuzm8s1ceuBUnMUAeoAHHw,5,5,2,0,1,3,1,0,12,1.7142857142857142,1,0.0,2,2,0,1,3,3,0,1,0,5,7,1
19211,178094,esEoFNEKF5IP6OxWYdt6tpHD0Qc2cHks,SpATywNh6bZuzm8s1ceuBUnMUAeoAHHw,4,4,1,0,1,0,1,0,7,1.0,1,0.0,0,1,0,1,4,0,0,1,0,2,5,1
19212,178095,44onQpYi5VTnyFsvK7UkRriRlwhqqD0U,SpATywNh6bZuzm8s1ceuBUnMUAeoAHHw,1,0,0,0,0,0,1,0,1,0.14285714285714285,1,0.0,0,0,0,0,0,0,0,1,0,0,1,1
19213,178097,dAqrHPlMsXnPrglFnOZUeJrfWBb2qFZV,G8EPVSXsOYB5YQWZGiz1aVq5Pgr2GrQu,1,0,0,0,0,0,2,0,2,0.2857142857142857,1,0.0,0,0,0,0,0,0,0,2,0,0,2,1
19214,178108,gSVv2aL3mlSaSez3uclTs7guBwBPusEU,A3fsA9Zfv1X2fVEQhTw51lKENdNrEqT3,1,0,0,0,0,0,1,0,1,0.14285714285714285,1,0.0,0,0,0,0,0,0,0,1,0,0,1,1
19215,178129,NMPg56MDKMVC7ti0J9mAofQpqCKjpKCl,bWdj2GDclj5ofokWjzoa5jAwMkxCykd6,8,5,1,0,2,1,6,1,16,2.2857142857142856,1,0.0,3,1,0,2,2,1,0,6,1,6,10,1
19216,178130,NMPg56MDKMVC7ti0J9mAofQpqCKjpKCl,A3fsA9Zfv1X2fVEQhTw51lKENdNrEqT3,1,0,0,0,0,0,1,0,1,0.14285714285714285,1,0.0,0,0,0,0,0,0,0,1,0,0,1,1
19217,178173,yuqt6qA4ywnzzkfFkXqBct0eJDj9XUsS,SpATywNh6bZuzm8s1ceuBUnMUAeoAHHw,6,1,1,0,1,0,3,0,6,0.8571428571428571,1,0.0,0,1,0,1,1,0,0,3,0,2,4,1
19218,178184,fKYKLbyU9DEbtWWdd9SkLOt7DfIpocNH,G8EPVSXsOYB5YQWZGiz1aVq5Pgr2GrQu,10,7,1,0,0,1,9,1,19,2.7142857142857144,1,0.0,0,1,0,0,7,1,0,9,1,1,18,0
19219,178187,3THLA2KuYKQhJc7rfDiBcIyyI3oWoZEW,bWdj2GDclj5ofokWjzoa5jAwMkxCykd6,1,0,0,0,0,0,1,0,1,0.14285714285714285,1,0.0,0,0,0,0,0,0,0,1,0,0,1,1
19220,178206,vYYhKPJ8OWf68zu55Ez1PMsu8DH2KE0M,A3fsA9Zfv1X2fVEQhTw51lKENdNrEqT3,7,5,4,0,4,1,3,0,17,2.4285714285714284,1,0.0,0,4,0,4,5,1,0,3,0,8,9,1
19221,178214,ZgFCLkDPzcdiy0sIzPjvfQAgjdD1TUt9,A3fsA9Zfv1X2fVEQhTw51lKENdNrEqT3,8,6,3,0,1,2,9,2,23,3.2857142857142856,1,0.0,0,3,0,1,6,2,0,9,2,4,19,1
19222,178229,ezHVlzRFOuQzT7lSAjSS77hd9tkWn143,3VkHkmOtom3jM2wCu94xgzzu1d6Dn7or,6,3,1,0,1,0,7,0,12,1.7142857142857142,2,0.0,0,1,0,1,3,0,0,7,0,2,10,1
19223,178236,QwzZyncxIP0xpmvrqq9TI7WpBlSuxEsG,3VkHkmOtom3jM2wCu94xgzzu1d6Dn7or,23,41,16,25,12,12,9,1,116,16.571428571428573,2,0.0,8,16,25,12,33,12,0,9,1,61,55,0
19224,178250,PnK3sHjmp9iurby249pq2KvdttYdQKRW,3VkHkmOtom3jM2wCu94xgzzu1d6Dn7or,1,0,0,0,0,0,1,0,1,0.14285714285714285,1,0.0,0,0,0,0,0,0,0,1,0,0,1,1
19225,178274,1PPzZtvE84TH0okLI8t2giD8i25ahpAC,3VkHkmOtom3jM2wCu94xgzzu1d6Dn7or,6,6,3,0,2,0,2,0,13,1.8571428571428572,1,0.0,2,3,0,2,4,0,0,2,0,7,6,1
19226,178330,b1bRMHIApI9jEpz9P7GuojfUgQMKWP9j,3VkHkmOtom3jM2wCu94xgzzu1d6Dn7or,2,0,0,0,0,0,2,0,2,0.2857142857142857,1,0.0,0,0,0,0,0,0,0,2,0,0,2,1
19227,178334,IKBMW4bSkZ4npwOLOl6WJvZEC1iJEL0t,3VkHkmOtom3jM2wCu94xgzzu1d6Dn7or,9,12,5,0,2,0,1,0,20,2.857142857142857,1,0.0,0,5,0,2,12,0,0,1,0,7,13,1
19228,178340,pEtE3Ipf5t4eY8pKkWwLU9yVmJ1macsG,3VkHkmOtom3jM2wCu94xgzzu1d6Dn7or,41,25,21,0,19,0,7,0,72,10.285714285714286,1,0.0,2,21,0,19,23,0,0,7,0,42,30,1
19229,178352,l24ZwtZ809AvtfPOBjCx2HR4aIhDh45V,3VkHkmOtom3jM2wCu94xgzzu1d6Dn7or,1,0,0,0,0,0,1,0,1,0.14285714285714285,1,0.0,0,0,0,0,0,0,0,1,0,0,1,1
19230,178358,AHCSKPmMNEp9VCnrK1PhazxxaN3PTMex,3VkHkmOtom3jM2wCu94xgzzu1d6Dn7or,5,2,1,0,1,0,2,0,6,0.8571428571428571,2,0.0,0,1,0,1,2,0,0,2,0,2,4,1
19231,178361,lbGQIf1S4RIAk470qNloj5exAOH8Hzu2,3VkHkmOtom3jM2wCu94xgzzu1d6Dn7or,1,0,0,0,0,0,1,0,1,0.14285714285714285,1,0.0,0,0,0,0,0,0,0,1,0,0,1,1
19232,178362,bVc5z7ElsCF7gBlVpAN8Nel6M2Y4UpvO,3VkHkmOtom3jM2wCu94xgzzu1d6Dn7or,1,0,0,0,0,0,1,0,1,0.14285714285714285,1,0.0,0,0,0,0,0,0,0,1,0,0,1,1
19233,178382,J5hTpY1e0eer2IGKDWV5nQcxG5rxKFBt,3VkHkmOtom3jM2wCu94xgzzu1d6Dn7or,12,15,3,8,7,22,7,2,64,9.142857142857142,1,0.0,12,3,6,7,3,22,2,7,2,28,36,1
19234,178391,4jiJ0Jol3B1rJ1uebX4eYHcs9BXBbwSL,3VkHkmOtom3jM2wCu94xgzzu1d6Dn7or,5,3,1,0,0,0,3,0,7,1.0,1,0.0,0,1,0,0,3,0,0,3,0,1,6,1
19235,178393,lDxZrY8xnIav3logF53riVDPRGJ1Gd4Z,3VkHkmOtom3jM2wCu94xgzzu1d6Dn7or,14,8,0,0,7,0,3,0,18,2.5714285714285716,2,0.0,0,0,0,7,8,0,0,3,0,7,11,1
19236,178402,RYmi8ZUtWHOBIR4F8jaoqCqY5vCozh2d,3VkHkmOtom3jM2wCu94xgzzu1d6Dn7or,7,2,1,0,1,0,7,1,12,1.7142857142857142,1,0.0,0,1,0,1,2,0,0,7,1,2,10,1
19237,178410,AfmhIxUMCvJIyQbfn8Qovo5eFNjT4F31,3VkHkmOtom3jM2wCu94xgzzu1d6Dn7or,5,6,1,0,2,1,3,0,13,1.8571428571428572,1,0.0,4,1,0,2,2,1,0,3,0,7,6,1
19238,178414,EqRBdyyXr63lLREwOULob6g26cIydQEU,3VkHkmOtom3jM2wCu94xgzzu1d6Dn7or,1,0,0,0,0,0,1,0,1,0.14285714285714285,1,0.0,0,0,0,0,0,0,0,1,0,0,1,1
19239,178476,5FKNtYsTkByroijTHxSZ2wThgqvXV2F5,3VkHkmOtom3jM2wCu94xgzzu1d6Dn7or,1,0,0,0,0,0,1,0,1,0.14285714285714285,1,0.0,0,0,0,0,0,0,0,1,0,0,1,1
19240,178510,kHTHDNs3AT2qXCtVIr1HORujPqoZzBvC,3VkHkmOtom3jM2wCu94xgzzu1d6Dn7or,1,0,0,0,0,0,1,0,1,0.14285714285714285,1,0.0,0,0,0,0,0,0,0,1,0,0,1,1
19241,178517,YWXRs30LfGeBUUdtbLCSDxfSvS9eXAoE,3VkHkmOtom3jM2wCu94xgzzu1d6Dn7or,1,0,0,0,0,0,1,0,1,0.14285714285714285,1,0.0,0,0,0,0,0,0,0,1,0,0,1,1
19242,178562,Xm0fBjDbhiZ1hqhhgWghtT86qcZao5Le,3VkHkmOtom3jM2wCu94xgzzu1d6Dn7or,2,0,0,0,0,0,6,0,6,0.8571428571428571,1,0.0,0,0,0,0,0,0,0,6,0,0,6,1
19243,178565,WbNaxYlp2khAUuwNRYpsWq2TzeuC7aeM,3VkHkmOtom3jM2wCu94xgzzu1d6Dn7or,1,0,0,0,0,0,1,0,1,0.14285714285714285,1,0.0,0,0,0,0,0,0,0,1,0,0,1,1
19244,178584,4cRZxyVNjv13lU3nu2aK2rwyndExVCGa,3VkHkmOtom3jM2wCu94xgzzu1d6Dn7or,1,0,0,0,0,0,1,0,1,0.14285714285714285,1,0.0,0,0,0,0,0,0,0,1,0,0,1,1
19245,178587,qqziGUkyP0c1UHlUr0NUyhQGDrHZcvM8,3VkHkmOtom3jM2wCu94xgzzu1d6Dn7or,1,0,0,0,0,0,1,0,1,0.14285714285714285,1,0.0,0,0,0,0,0,0,0,1,0,0,1,1
19246,178632,R31xuWG2WIcg7UurtGcD2HSlFHOzOAAM,3VkHkmOtom3jM2wCu94xgzzu1d6Dn7or,1,0,0,0,0,0,2,0,2,0.2857142857142857,1,0.0,0,0,0,0,0,0,0,2,0,0,2,1
19247,178662,4gV9HtunfmOYFa4Y5vDKnozL8KtQZEr8,3VkHkmOtom3jM2wCu94xgzzu1d6Dn7or,1,0,0,0,0,0,1,0,1,0.14285714285714285,1,0.0,0,0,0,0,0,0,0,1,0,0,1,1
19248,178707,cRRRs3d58C19e8J7eY2CMLXg3VRv45Sc,3VkHkmOtom3jM2wCu94xgzzu1d6Dn7or,8,8,3,0,3,0,3,0,17,2.4285714285714284,1,0.0,4,3,0,3,4,0,0,3,0,10,7,1
19249,178711,cRIBlSgBUu5wnHayYLXYGXCywSveNH4q,3VkHkmOtom3jM2wCu94xgzzu1d6Dn7or,7,5,3,0,2,0,5,0,15,2.142857142857143,2,0.0,1,3,0,2,4,0,0,5,0,6,9,1
19250,178742,07vmWpDBCHouqhHbgDjMrw8KyXCN8Jrf,3VkHkmOtom3jM2wCu94xgzzu1d6Dn7or,1,0,0,0,0,0,1,0,1,0.14285714285714285,1,0.0,0,0,0,0,0,0,0,1,0,0,1,1
19251,178778,JTRQvfGtRc9gBfTBY7Oabdk1HOKCCyLc,3VkHkmOtom3jM2wCu94xgzzu1d6Dn7or,1,0,0,0,0,0,1,0,1,0.14285714285714285,1,0.0,0,0,0,0,0,0,0,1,0,0,1,1
19252,178875,CLnxWdrXfHcQbh2wYX7hvr8ePMiTxXWb,3VkHkmOtom3jM2wCu94xgzzu1d6Dn7or,5,2,1,0,1,0,4,0,8,1.1428571428571428,1,0.0,0,1,0,1,2,0,0,4,0,2,6,1
19253,178886,NjJdvoaEm2slzoNjLhqS1xsYViIZpyCY,3VkHkmOtom3jM2wCu94xgzzu1d6Dn7or,1,0,0,0,0,0,1,0,1,0.14285714285714285,1,0.0,0,0,0,0,0,0,0,1,0,0,1,1
19254,178894,4IEUBrnVsXQgXXrlX6hPh5y9QYArGc5Z,3VkHkmOtom3jM2wCu94xgzzu1d6Dn7or,1,0,0,0,0,0,1,0,1,0.14285714285714285,1,0.0,0,0,0,0,0,0,0,1,0,0,1,1
19255,178902,QKFoY6VnyEPdqy4FjBYvw98ymmZAxzgO,3VkHkmOtom3jM2wCu94xgzzu1d6Dn7or,3,0,0,0,0,0,5,0,5,0.7142857142857143,1,0.0,0,0,0,0,0,0,0,5,0,0,5,1
19256,178990,vX3W9boyH9FnYaGERf0Y2U2q4fFQbOYH,3VkHkmOtom3jM2wCu94xgzzu1d6Dn7or,1,0,0,0,0,0,1,0,1,0.14285714285714285,1,0.0,0,0,0,0,0,0,0,1,0,0,1,1
19257,179038,BY9wj7roiUxcr0Kghn3nJYs8OUKxCCE2,3VkHkmOtom3jM2wCu94xgzzu1d6Dn7or,1,0,0,0,0,0,1,0,1,0.14285714285714285,1,0.0,0,0,0,0,0,0,0,1,0,0,1,1
19258,179055,FKroAYBvJIjpEDPtuLwEtwENqpzITIVV,3VkHkmOtom3jM2wCu94xgzzu1d6Dn7or,1,0,0,0,0,0,1,0,1,0.14285714285714285,1,0.0,0,0,0,0,0,0,0,1,0,0,1,1
19259,179080,LnNj9zDI8D38ixGOYTIjTH2iF5m36v9S,SpATywNh6bZuzm8s1ceuBUnMUAeoAHHw,1,0,0,0,0,0,1,0,1,0.14285714285714285,1,0.0,0,0,0,0,0,0,0,1,0,0,1,1
19260,179095,oSzwRDot26Gzbo9Z51q8vW83UZefXQx4,A3fsA9Zfv1X2fVEQhTw51lKENdNrEqT3,1,0,0,0,0,0,1,0,1,0.14285714285714285,1,0.0,0,0,0,0,0,0,0,1,0,0,1,1
19261,179123,NG8wapOLRHPSImjU3DJtnljSG53kZjbZ,bWdj2GDclj5ofokWjzoa5jAwMkxCykd6,3,2,0,0,0,0,2,0,4,0.5714285714285714,1,0.0,0,0,0,0,2,0,0,2,0,0,4,1
19262,179129,rqwp0DRxlrzViX8K4jHTHKpfYZPPmBwb,bWdj2GDclj5ofokWjzoa5jAwMkxCykd6,1,0,0,0,0,0,1,0,1,0.14285714285714285,1,0.0,0,0,0,0,0,0,0,1,0,0,1,1
19263,179137,UDKXRlOwpBxfqLf5s4hL0AzxKxNspgpQ,SpATywNh6bZuzm8s1ceuBUnMUAeoAHHw,1,0,0,0,0,0,1,0,1,0.14285714285714285,1,0.0,0,0,0,0,0,0,0,1,0,0,1,1
19264,179165,ZXiVpybmbL623ANTNPEN3D1nQoaNJaX5,SpATywNh6bZuzm8s1ceuBUnMUAeoAHHw,7,5,0,0,0,1,5,1,12,1.7142857142857142,1,0.0,0,0,0,0,5,1,0,5,1,0,12,1
19265,179172,jvjehhIuix2k8Sj0y3VS2J5KBY57pmmY,RXDvfPUBYFlVdlueBFbLW0mhhAyGEqpt,1,0,0,0,0,0,1,0,1,0.14285714285714285,1,0.0,0,0,0,0,0,0,0,1,0,0,1,1
19266,179173,hlGvzZYaSt1Ra6ylrXWIlb8wt3nPgT2T,SpATywNh6bZuzm8s1ceuBUnMUAeoAHHw,13,12,4,14,0,1,7,1,39,5.571428571428571,1,0.0,6,4,13,0,6,1,1,7,1,23,16,1
19267,179184,cexaEjGIqIaJg5IJprEieaXGoFvFkGAk,5X6FeZozNMgE2VRi3MJYjkkFK8SETtu2,5,0,0,0,0,1,6,3,10,1.4285714285714286,1,0.0,0,0,0,0,0,1,0,6,3,0,10,1
19268,179227,vzM6dR7Mfcsfahv9r0OzvETIp9xJjGU6,SpATywNh6bZuzm8s1ceuBUnMUAeoAHHw,6,2,1,0,1,0,4,0,8,1.1428571428571428,1,0.0,0,1,0,1,2,0,0,4,0,2,6,1
19269,179270,qdIBYHN1oo81Fn2PDQ4pWy5luAxUSnv8,A3fsA9Zfv1X2fVEQhTw51lKENdNrEqT3,2,0,0,0,0,0,2,0,2,0.2857142857142857,1,0.0,0,0,0,0,0,0,0,2,0,0,2,1
19270,179272,XydvMA0BgL1Al10q3L0D2wz1Y6wVb2rC,RXDvfPUBYFlVdlueBFbLW0mhhAyGEqpt,23,15,14,0,10,0,3,0,42,6.0,2,0.0,0,14,0,10,15,0,0,3,0,24,18,1
19271,179280,zeHCiMpomPiZgVEBNBLYszozi2RaN6ma,SpATywNh6bZuzm8s1ceuBUnMUAeoAHHw,8,6,2,0,2,0,5,0,15,2.142857142857143,2,0.0,0,2,0,2,6,0,0,5,0,4,11,0
19272,179288,D9NEjP5of3onbOL7hxFUdKxRWVR3Zio0,A3fsA9Zfv1X2fVEQhTw51lKENdNrEqT3,4,2,1,0,1,0,1,0,5,0.7142857142857143,1,0.0,0,1,0,1,2,0,0,1,0,2,3,1
19273,179289,Yu225AU92v57j3uCc612YKq3vIxaCm7A,A3fsA9Zfv1X2fVEQhTw51lKENdNrEqT3,8,3,2,0,2,0,5,0,12,1.7142857142857142,1,0.0,0,2,0,2,3,0,0,5,0,4,8,1
19274,179318,0islXLiLHhX22socdAlKCtW1OjyrNJz9,SpATywNh6bZuzm8s1ceuBUnMUAeoAHHw,9,7,4,0,3,0,12,0,26,3.7142857142857144,2,0.0,0,4,0,3,7,0,0,12,0,7,19,1
19275,179319,GhuuDV969q2f6oJQGMqn8YHqFqopG9W1,SpATywNh6bZuzm8s1ceuBUnMUAeoAHHw,5,2,1,0,1,0,2,0,6,0.8571428571428571,1,0.0,0,1,0,1,2,0,0,2,0,2,4,1
19276,179322,3gZowHU6Qw1N8nldPT0HUl8W4s6TSDEP,SpATywNh6bZuzm8s1ceuBUnMUAeoAHHw,4,2,0,0,0,0,2,0,4,0.5714285714285714,1,0.0,0,0,0,0,2,0,0,2,0,0,4,1
19277,179323,LIH6u87VTR1542727Uc42mhP2iK5GaFP,bWdj2GDclj5ofokWjzoa5jAwMkxCykd6,1,0,0,0,0,0,1,0,1,0.14285714285714285,1,0.0,0,0,0,0,0,0,0,1,0,0,1,1
19278,179330,G49NvH4tF8kgsPAfy46cXzQCrSoZyFSP,G8EPVSXsOYB5YQWZGiz1aVq5Pgr2GrQu,1,0,0,0,0,0,1,0,1,0.14285714285714285,1,0.0,0,0,0,0,0,0,0,1,0,0,1,1
19279,179335,fsbWFTARUAWxV5m5bgwU1csJ885PYNRf,SpATywNh6bZuzm8s1ceuBUnMUAeoAHHw,2,0,0,0,0,0,2,0,2,0.2857142857142857,1,0.0,0,0,0,0,0,0,0,2,0,0,2,1
19280,179355,dwLERcgUF5e8qc6KTeQUy7jzLbnbnojj,SpATywNh6bZuzm8s1ceuBUnMUAeoAHHw,8,2,1,0,1,1,6,1,12,1.7142857142857142,1,0.0,0,1,0,1,2,1,0,6,1,2,10,1
19281,179359,RNNuxsM5xlYyyu9stwQmqEuw1Q1FUKuB,5X6FeZozNMgE2VRi3MJYjkkFK8SETtu2,2,0,0,0,0,0,2,0,2,0.2857142857142857,1,0.0,0,0,0,0,0,0,0,2,0,0,2,1
19282,179361,dwLERcgUF5e8qc6KTeQUy7jzLbnbnojj,RXDvfPUBYFlVdlueBFbLW0mhhAyGEqpt,42,26,12,102,8,0,2,0,150,21.428571428571427,1,0.0,7,12,87,8,19,0,15,2,0,114,36,1
19283,179369,4s7Pp1HkR1BKGnSREpCdC6xzkb7JZ7RX,A3fsA9Zfv1X2fVEQhTw51lKENdNrEqT3,10,5,4,0,4,0,2,0,15,2.142857142857143,1,0.0,0,4,0,4,5,0,0,2,0,8,7,1
19284,179377,RNNuxsM5xlYyyu9stwQmqEuw1Q1FUKuB,bWdj2GDclj5ofokWjzoa5jAwMkxCykd6,2,0,0,0,0,0,2,0,2,0.2857142857142857,1,0.0,0,0,0,0,0,0,0,2,0,0,2,1
19285,179379,4s7Pp1HkR1BKGnSREpCdC6xzkb7JZ7RX,bWdj2GDclj5ofokWjzoa5jAwMkxCykd6,2,0,0,0,0,0,3,0,3,0.42857142857142855,1,0.0,0,0,0,0,0,0,0,3,0,0,3,1
19286,179382,VOe0SGWkdLEdxTO6yJwM7kycDEogtQzR,5X6FeZozNMgE2VRi3MJYjkkFK8SETtu2,6,5,1,2,2,0,1,0,11,1.5714285714285714,1,0.0,2,1,2,2,3,0,0,1,0,7,4,1
19287,179406,QvbJWpQltbObszIwAlZse9I8csJFcFSS,A3fsA9Zfv1X2fVEQhTw51lKENdNrEqT3,1,0,0,0,0,0,1,0,1,0.14285714285714285,1,0.0,0,0,0,0,0,0,0,1,0,0,1,1
19288,179416,XDzOWUNLzBmGsjdfGLXHCvH3VtT0wXJy,A3fsA9Zfv1X2fVEQhTw51lKENdNrEqT3,2,0,0,0,0,0,2,0,2,0.2857142857142857,1,0.0,0,0,0,0,0,0,0,2,0,0,2,1
19289,179418,1Oa212bncJhKWORThypZLwmAIisj5Woa,SpATywNh6bZuzm8s1ceuBUnMUAeoAHHw,1,0,0,0,0,0,1,0,1,0.14285714285714285,1,0.0,0,0,0,0,0,0,0,1,0,0,1,1
19290,179422,0KUBjckzhPh04pcpref906kWaVGOckIo,SpATywNh6bZuzm8s1ceuBUnMUAeoAHHw,7,5,2,0,2,0,2,0,11,1.5714285714285714,1,0.0,0,2,0,2,5,0,0,2,0,4,7,1
19291,179423,P2OYdgxBYF5HxGzcA6vhmPz346TpPX0X,A3fsA9Zfv1X2fVEQhTw51lKENdNrEqT3,9,4,2,0,2,0,5,0,13,1.8571428571428572,1,0.0,0,2,0,2,4,0,0,5,0,4,9,1
19292,179424,RyFLXBVd2U304JMB6ECFi9FilOybDHpw,SpATywNh6bZuzm8s1ceuBUnMUAeoAHHw,15,10,2,17,1,0,5,2,37,5.285714285714286,2,0.0,3,2,16,1,7,0,1,5,2,22,15,1
19293,179447,sRKFcCOCmJuLZB6RUcOH6aSVKmD3A5OQ,SpATywNh6bZuzm8s1ceuBUnMUAeoAHHw,7,3,2,0,2,0,4,0,11,1.5714285714285714,2,0.0,0,2,0,2,3,0,0,4,0,4,7,1
19294,179452,04bV6MteCOqCB3W0Xq2uorQqe6jWZZSf,SpATywNh6bZuzm8s1ceuBUnMUAeoAHHw,4,2,1,0,1,0,1,0,5,0.7142857142857143,1,0.0,0,1,0,1,2,0,0,1,0,2,3,0
19295,179467,gfiVbZ2BB4wAsOOx7YUS5pKBeDSlW3Qg,SpATywNh6bZuzm8s1ceuBUnMUAeoAHHw,5,0,0,0,0,0,5,1,6,0.8571428571428571,1,0.0,0,0,0,0,0,0,0,5,1,0,6,1
19296,179468,gfiVbZ2BB4wAsOOx7YUS5pKBeDSlW3Qg,RXDvfPUBYFlVdlueBFbLW0mhhAyGEqpt,1,0,0,0,0,0,1,0,1,0.14285714285714285,1,0.0,0,0,0,0,0,0,0,1,0,0,1,1
19297,179498,20eWtdYsYJ2HaokCydmTS0vY6S0PepZS,A3fsA9Zfv1X2fVEQhTw51lKENdNrEqT3,12,14,4,0,2,0,9,0,29,4.142857142857143,3,0.0,0,4,0,2,14,0,0,9,0,6,23,1
19298,179510,LV8vfa5IckYORVtz7AuYJolbeaAdw5WB,SpATywNh6bZuzm8s1ceuBUnMUAeoAHHw,1,0,0,0,0,0,1,0,1,0.14285714285714285,1,0.0,0,0,0,0,0,0,0,1,0,0,1,1
19299,179521,T0qN0JA4KSVLyWchoneodkFuY7QtkdHK,SpATywNh6bZuzm8s1ceuBUnMUAeoAHHw,5,2,1,0,1,2,2,0,8,1.1428571428571428,1,0.0,0,1,0,1,2,2,0,2,0,2,6,1
19300,179527,umNShE6BhRkvuedzRR9bZ3NEa4fzMweQ,SpATywNh6bZuzm8s1ceuBUnMUAeoAHHw,33,48,3,50,0,0,13,4,118,16.857142857142858,3,0.0,18,3,43,0,30,0,7,13,4,64,54,0
19301,179532,VGzBOOGK69MtqzfKnchssFLwlA0NETTZ,SpATywNh6bZuzm8s1ceuBUnMUAeoAHHw,7,6,0,0,0,0,2,0,8,1.1428571428571428,1,0.0,0,0,0,0,6,0,0,2,0,0,8,1
19302,179562,0gS5Q732yxgOQo1BReYmVwLNG0PEmJtw,A3fsA9Zfv1X2fVEQhTw51lKENdNrEqT3,23,16,6,40,1,0,8,0,71,10.142857142857142,1,0.0,0,6,34,1,16,0,6,8,0,41,30,1
19303,179577,muJ6MIRhOdDL6SrbHsZ7Ks5a50Iz9AeC,SpATywNh6bZuzm8s1ceuBUnMUAeoAHHw,1,0,0,0,0,0,1,0,1,0.14285714285714285,1,0.0,0,0,0,0,0,0,0,1,0,0,1,1
19304,179578,sgSB1EsUBw19mWgGeblLKNJdgffkgrqj,A3fsA9Zfv1X2fVEQhTw51lKENdNrEqT3,7,3,2,0,2,0,2,0,9,1.2857142857142858,1,0.0,0,2,0,2,3,0,0,2,0,4,5,1
19305,179610,WKp6oqFCmHpy9TibUqeeOeiX66KXDV5H,SpATywNh6bZuzm8s1ceuBUnMUAeoAHHw,2,0,0,0,0,0,2,0,2,0.2857142857142857,1,0.0,0,0,0,0,0,0,0,2,0,0,2,1
19306,179631,D7BohbL4R10ASgdgNGVTkq1ZlvH2JxrO,SpATywNh6bZuzm8s1ceuBUnMUAeoAHHw,24,27,15,14,10,0,3,0,69,9.857142857142858,1,0.0,8,15,12,10,19,0,2,3,0,45,24,1
19307,179637,MPAnuaCP5m41FvcY5EtWO5xZtCgim3qR,SpATywNh6bZuzm8s1ceuBUnMUAeoAHHw,8,2,2,0,2,0,3,0,9,1.2857142857142858,1,0.0,0,2,0,2,2,0,0,3,0,4,5,1
19308,179640,uUoI8qvE7LwSvUsyrJpLnIqVgu65FLrs,SpATywNh6bZuzm8s1ceuBUnMUAeoAHHw,1,0,0,0,0,0,1,0,1,0.14285714285714285,1,0.0,0,0,0,0,0,0,0,1,0,0,1,1
19309,179658,dqcX0OjTkTaHlc8tqIzvM5g6YMEUMdkh,RXDvfPUBYFlVdlueBFbLW0mhhAyGEqpt,4,5,0,0,0,0,1,0,6,0.8571428571428571,1,0.0,0,0,0,0,5,0,0,1,0,0,6,0
19310,179672,bUAApLDRSsYoejMOs9wtzojFHzl0leoA,A3fsA9Zfv1X2fVEQhTw51lKENdNrEqT3,5,2,1,0,1,0,2,0,6,0.8571428571428571,1,0.0,0,1,0,1,2,0,0,2,0,2,4,1
19311,179679,9t2KBUQ5GiAw5lDqGOd0BuKNW0LVvTVG,SpATywNh6bZuzm8s1ceuBUnMUAeoAHHw,1,0,0,0,0,0,1,0,1,0.14285714285714285,1,0.0,0,0,0,0,0,0,0,1,0,0,1,1
19312,179710,G9HEtDFISznPdvvS77nz7FwZcc6S4CjD,bWdj2GDclj5ofokWjzoa5jAwMkxCykd6,7,7,1,0,0,0,7,0,15,2.142857142857143,1,0.0,0,1,0,0,7,0,0,7,0,1,14,1
19313,179715,gHRMftxFMfKG8FHWISkllbscPcwviNm3,RXDvfPUBYFlVdlueBFbLW0mhhAyGEqpt,2,0,0,0,0,0,2,0,2,0.2857142857142857,1,0.0,0,0,0,0,0,0,0,2,0,0,2,1
19314,179722,StcFIgK5T4YiiLiOpPHFjzohTVz9Jaf7,bWdj2GDclj5ofokWjzoa5jAwMkxCykd6,1,0,0,0,0,0,3,0,3,0.42857142857142855,1,0.0,0,0,0,0,0,0,0,3,0,0,3,1
19315,179724,NqjFMzdUzAzJwedggie2ZM67JdWuAq4g,A3fsA9Zfv1X2fVEQhTw51lKENdNrEqT3,5,5,1,0,0,0,1,0,7,1.0,1,0.0,0,1,0,0,5,0,0,1,0,1,6,1
19316,179730,Z5RnWlIN5rBQfUP7H7AAcjJydHOZvELo,SpATywNh6bZuzm8s1ceuBUnMUAeoAHHw,1,0,0,0,0,0,1,0,1,0.14285714285714285,1,0.0,0,0,0,0,0,0,0,1,0,0,1,1
19317,179732,GnMMDgMkehWbrroCw3WzwugiIkCP2y33,G8EPVSXsOYB5YQWZGiz1aVq5Pgr2GrQu,32,23,17,34,13,7,7,0,101,14.428571428571429,2,0.0,3,17,29,13,20,7,5,7,0,62,39,1
19318,179738,ou8C5n696YF7JZz3ylnGubjoPMMs2Cdd,SpATywNh6bZuzm8s1ceuBUnMUAeoAHHw,5,2,1,0,1,0,2,0,6,0.8571428571428571,1,0.0,0,1,0,1,2,0,0,2,0,2,4,1
19319,179739,yYsW32kCOP4EgbR8poMa9E3lg8DNZAYh,SpATywNh6bZuzm8s1ceuBUnMUAeoAHHw,5,4,3,0,3,0,3,0,13,1.8571428571428572,2,0.0,0,3,0,3,4,0,0,3,0,6,7,1
19320,179740,UExHTYefDNhQrmzfTlJ57LWgxRr48ahn,SpATywNh6bZuzm8s1ceuBUnMUAeoAHHw,4,2,1,0,0,0,2,0,5,0.7142857142857143,1,0.0,0,1,0,0,2,0,0,2,0,1,4,1
19321,179747,ibKckGpxyTPeplIlvvXTpemBsBqeMrxb,RXDvfPUBYFlVdlueBFbLW0mhhAyGEqpt,1,0,0,0,0,0,1,0,1,0.14285714285714285,1,0.0,0,0,0,0,0,0,0,1,0,0,1,1
19322,179749,rUnq7n3p21gBavp6PXoOme6EEG94pTxK,SpATywNh6bZuzm8s1ceuBUnMUAeoAHHw,14,22,6,56,0,0,1,0,85,12.142857142857142,1,0.0,10,6,51,0,12,0,5,1,0,67,18,0
19323,179759,py4BWZSO6h9zrErp57605lt6Inpkg97z,SpATywNh6bZuzm8s1ceuBUnMUAeoAHHw,15,11,7,6,4,0,4,0,32,4.571428571428571,1,0.0,0,7,5,4,11,0,1,4,0,16,16,1
19324,179760,zRPZs2UwyfSKTy0m6wUSjuruRFQuFAvo,SpATywNh6bZuzm8s1ceuBUnMUAeoAHHw,1,0,0,0,0,0,1,0,1,0.14285714285714285,1,0.0,0,0,0,0,0,0,0,1,0,0,1,1
19325,179768,wUp74pHXepx3D052YhA66zL4rpbyPwEw,SpATywNh6bZuzm8s1ceuBUnMUAeoAHHw,1,0,0,0,0,0,1,0,1,0.14285714285714285,1,0.0,0,0,0,0,0,0,0,1,0,0,1,1
19326,179772,StY7mIcclc0vcUIJFTvL9RrXxdUXnEhh,SpATywNh6bZuzm8s1ceuBUnMUAeoAHHw,17,16,9,6,6,3,3,0,43,6.142857142857143,2,0.0,5,9,6,6,11,3,0,3,0,26,17,1
19327,179788,y0PkAopIdLmRFrkWC9eBHvWT77KfVWMh,5X6FeZozNMgE2VRi3MJYjkkFK8SETtu2,4,5,2,0,2,0,1,0,10,1.4285714285714286,1,0.0,0,2,0,2,5,0,0,1,0,4,6,1
19328,179790,nCUsluT33ylMTcWUlwgSWpj3Fjvf5kmG,SpATywNh6bZuzm8s1ceuBUnMUAeoAHHw,13,11,2,14,2,0,3,0,32,4.571428571428571,1,0.0,3,2,13,2,8,0,1,3,0,20,12,1
19329,179796,LUHGaACicOxP60rKS6F2rMGy8wMmqt9J,SpATywNh6bZuzm8s1ceuBUnMUAeoAHHw,45,45,28,29,15,1,6,1,125,17.857142857142858,2,0.0,11,28,27,15,34,1,2,6,1,81,44,1
19330,179801,fIbdXFPoTOYlPmaY1ETJ8qg0oyUmhp0g,A3fsA9Zfv1X2fVEQhTw51lKENdNrEqT3,1,0,0,0,0,0,1,0,1,0.14285714285714285,1,0.0,0,0,0,0,0,0,0,1,0,0,1,1
19331,179802,fIbdXFPoTOYlPmaY1ETJ8qg0oyUmhp0g,bWdj2GDclj5ofokWjzoa5jAwMkxCykd6,6,9,1,0,1,0,4,0,15,2.142857142857143,2,0.0,2,1,0,1,7,0,0,4,0,4,11,1
19332,179808,HsX3fJNWGaAzb4ulAc4fybIoBP3jGVkR,bWdj2GDclj5ofokWjzoa5jAwMkxCykd6,6,7,1,0,0,0,2,0,10,1.4285714285714286,1,0.0,0,1,0,0,7,0,0,2,0,1,9,1
19333,179825,UeMhoIxbaZNEu0tYucIi541fjxr7wtKF,A3fsA9Zfv1X2fVEQhTw51lKENdNrEqT3,2,0,0,0,0,0,2,0,2,0.2857142857142857,1,0.0,0,0,0,0,0,0,0,2,0,0,2,1
19334,179834,ymWpwD3GRW9ut1JiVBQeAWpoDiatjwOa,A3fsA9Zfv1X2fVEQhTw51lKENdNrEqT3,11,13,11,0,8,0,3,0,35,5.0,2,0.0,1,11,0,8,12,0,0,3,0,20,15,1
19335,179836,2sZGSeEPKMgpuspPc9ln3wAme2MWPynt,SpATywNh6bZuzm8s1ceuBUnMUAeoAHHw,2,0,0,0,0,0,2,0,2,0.2857142857142857,1,0.0,0,0,0,0,0,0,0,2,0,0,2,0
19336,179848,SIdEQEXoagJ5WwAcAkPtkVF6pipatiIa,SpATywNh6bZuzm8s1ceuBUnMUAeoAHHw,2,0,0,0,0,0,2,0,2,0.2857142857142857,1,0.0,0,0,0,0,0,0,0,2,0,0,2,1
19337,179870,DpSmnBHbyFDLOFghrV5uBi4M7NaSskUd,SpATywNh6bZuzm8s1ceuBUnMUAeoAHHw,13,11,7,4,5,0,4,0,31,4.428571428571429,1,0.0,0,7,3,5,11,0,1,4,0,15,16,1
19338,179884,UA8vU3s92g3lXc62U363PEO0xor6Mpeg,G8EPVSXsOYB5YQWZGiz1aVq5Pgr2GrQu,5,3,2,0,2,0,2,0,9,1.2857142857142858,1,0.0,0,2,0,2,3,0,0,2,0,4,5,1
19339,179899,lgHJmgh0JeYUwi0Y6M7QxPhO8toY9Xg7,SpATywNh6bZuzm8s1ceuBUnMUAeoAHHw,1,0,0,0,0,0,1,0,1,0.14285714285714285,1,0.0,0,0,0,0,0,0,0,1,0,0,1,1
19340,179910,tJDZI9sjRcU2ZrvrdL12AwFT0OmQXIcr,bWdj2GDclj5ofokWjzoa5jAwMkxCykd6,4,2,0,0,0,0,3,0,5,0.7142857142857143,1,0.0,0,0,0,0,2,0,0,3,0,0,5,1
19341,179913,15cHwrxDyXZ6rDjVRfGF8OQ7r5yWb8ur,SpATywNh6bZuzm8s1ceuBUnMUAeoAHHw,3,2,0,0,0,0,1,0,3,0.42857142857142855,1,0.0,0,0,0,0,2,0,0,1,0,0,3,1
19342,179930,y5aBZF9M42jQ3dd47gvkF1IzOdkUj0pK,A3fsA9Zfv1X2fVEQhTw51lKENdNrEqT3,2,0,0,0,0,0,2,0,2,0.2857142857142857,1,0.0,0,0,0,0,0,0,0,2,0,0,2,0
19343,179940,Atic9bcAYez6iPYGWH9qjmSkP3PGX2jq,A3fsA9Zfv1X2fVEQhTw51lKENdNrEqT3,9,13,5,0,3,6,5,0,32,4.571428571428571,1,0.0,0,5,0,3,13,6,0,5,0,8,24,1
19344,179941,31aB1n1dsQQ1ksrWlX8ZehnLm4yKoPC4,5X6FeZozNMgE2VRi3MJYjkkFK8SETtu2,1,0,0,0,0,0,1,0,1,0.14285714285714285,1,0.0,0,0,0,0,0,0,0,1,0,0,1,1
19345,179964,kBRyBoLw6Gxor2uVTrfB8UIBwxA0kVDV,SpATywNh6bZuzm8s1ceuBUnMUAeoAHHw,7,3,1,0,1,0,3,1,9,1.2857142857142858,1,0.0,0,1,0,1,3,0,0,3,1,2,7,1
19346,179973,N6jiL08wKuyQozkHSfkNoEAfnuGKH5Qp,SpATywNh6bZuzm8s1ceuBUnMUAeoAHHw,7,3,2,0,2,0,2,0,9,1.2857142857142858,1,0.0,0,2,0,2,3,0,0,2,0,4,5,1
19347,179977,SAZRKAldhv9NmeRo6l8G7XnPsnj9TVyU,bWdj2GDclj5ofokWjzoa5jAwMkxCykd6,1,0,0,0,0,0,1,0,1,0.14285714285714285,1,0.0,0,0,0,0,0,0,0,1,0,0,1,1
19348,179981,Xtc1j8RLTUZtmkbiSrt0BVY7ytq2hcRJ,SpATywNh6bZuzm8s1ceuBUnMUAeoAHHw,9,7,4,0,2,0,5,2,20,2.857142857142857,1,0.0,0,4,0,2,7,0,0,5,2,6,14,0
19349,179991,KBhbBOOlfBaI1URRHPSqS2ouhtSJhGfa,bWdj2GDclj5ofokWjzoa5jAwMkxCykd6,1,0,0,0,0,0,1,0,1,0.14285714285714285,1,0.0,0,0,0,0,0,0,0,1,0,0,1,1
19350,179994,kkWliMEtXfeGRYXIWo90e4jrKop2uE5Q,SpATywNh6bZuzm8s1ceuBUnMUAeoAHHw,1,0,0,0,0,0,1,0,1,0.14285714285714285,1,0.0,0,0,0,0,0,0,0,1,0,0,1,1
19351,179998,xI5OWiIHjz0Mm9IrFHWY7FdkKyLqt0kf,A3fsA9Zfv1X2fVEQhTw51lKENdNrEqT3,6,11,2,0,0,0,7,0,20,2.857142857142857,1,0.0,0,2,0,0,11,0,0,7,0,2,18,1
19352,180001,YjhQk8uVemmfeRSs3KEPEdsRtGRrPcBq,bWdj2GDclj5ofokWjzoa5jAwMkxCykd6,6,1,1,0,1,0,3,0,6,0.8571428571428571,1,0.0,0,1,0,1,1,0,0,3,0,2,4,1
19353,180006,5I4Sxxub5eHlZ4uVi2doKTMQ77gD08Kz,SpATywNh6bZuzm8s1ceuBUnMUAeoAHHw,8,10,3,0,2,0,3,0,18,2.5714285714285716,2,0.0,0,3,0,2,10,0,0,3,0,5,13,1
19354,180025,KdOpYQwRTjGuX2z1c0SW0st7uOc9iGrk,bWdj2GDclj5ofokWjzoa5jAwMkxCykd6,5,2,1,0,1,0,3,0,7,1.0,1,0.0,0,1,0,1,2,0,0,3,0,2,5,1
19355,180029,KdOpYQwRTjGuX2z1c0SW0st7uOc9iGrk,A3fsA9Zfv1X2fVEQhTw51lKENdNrEqT3,9,5,4,0,3,0,2,0,14,2.0,1,0.0,0,4,0,3,5,0,0,2,0,7,7,1
19356,180032,J1e23PBxkWxN7oYAdQnQR8wOCx3aE0nY,bWdj2GDclj5ofokWjzoa5jAwMkxCykd6,4,4,0,0,0,0,1,0,5,0.7142857142857143,1,0.0,0,0,0,0,4,0,0,1,0,0,5,1
19357,180033,koNIIdoqi1yUhLIZAXp5I3Fl17qrPzNm,bWdj2GDclj5ofokWjzoa5jAwMkxCykd6,10,19,0,0,0,0,5,0,24,3.4285714285714284,2,0.0,2,0,0,0,17,0,0,5,0,2,22,1
19358,180039,279AIREJbSXhdF4OGkzTGbmlv4S3xwdE,A3fsA9Zfv1X2fVEQhTw51lKENdNrEqT3,19,7,6,0,6,4,7,1,31,4.428571428571429,1,0.0,0,6,0,6,7,4,0,7,1,12,19,0
19359,180043,IB6QwGjfRbp7aWxgSMpIkngT9FviLi1Z,bWdj2GDclj5ofokWjzoa5jAwMkxCykd6,5,2,1,0,1,0,2,0,6,0.8571428571428571,2,0.0,0,1,0,1,2,0,0,2,0,2,4,1
19360,180050,yAFOzDqu62VOeEElP9JgOlIiP2xoZYrS,7GRhBDsirIGkRZBtSMEzNTyDr2JQm4xx,1,0,0,0,0,0,1,0,1,0.14285714285714285,1,0.0,0,0,0,0,0,0,0,1,0,0,1,1
19361,180057,OOg0gQ2ai1NwRlHZA0Zq8uTWsOhkr7nF,5X6FeZozNMgE2VRi3MJYjkkFK8SETtu2,1,0,0,0,0,0,1,0,1,0.14285714285714285,1,0.0,0,0,0,0,0,0,0,1,0,0,1,1
19362,180076,WIulMAW8PLfyLvnliYk0w4Xs9IJHKZPS,5X6FeZozNMgE2VRi3MJYjkkFK8SETtu2,2,0,0,0,0,0,2,0,2,0.2857142857142857,1,0.0,0,0,0,0,0,0,0,2,0,0,2,1
19363,180084,DUhu6EGjxxReF9rQTWACLB6Oy9ZYNZxx,5X6FeZozNMgE2VRi3MJYjkkFK8SETtu2,5,4,0,2,1,0,1,0,8,1.1428571428571428,1,0.0,2,0,2,1,2,0,0,1,0,5,3,1
19364,180097,ro7esQOrjhfB2rfylabVOl2AnjhmuScB,5X6FeZozNMgE2VRi3MJYjkkFK8SETtu2,1,0,0,0,0,0,1,0,1,0.14285714285714285,1,0.0,0,0,0,0,0,0,0,1,0,0,1,1
19365,180099,jrgM1oW0TWS88MYVs7LRUQjqPhGPE54P,7GRhBDsirIGkRZBtSMEzNTyDr2JQm4xx,46,72,36,50,20,32,23,0,233,33.285714285714285,1,0.0,31,36,44,20,41,32,6,23,0,131,102,1
19366,180122,xVBMhEHJSTLajguh18QYS971lwiV8tfV,5X6FeZozNMgE2VRi3MJYjkkFK8SETtu2,4,2,1,0,1,0,1,0,5,0.7142857142857143,1,0.0,0,1,0,1,2,0,0,1,0,2,3,1
19367,180179,SFfKdrEty3lLCn3Lw45FtRZTydUXwmxu,7GRhBDsirIGkRZBtSMEzNTyDr2JQm4xx,5,2,1,0,1,0,2,0,6,0.8571428571428571,1,0.0,0,1,0,1,2,0,0,2,0,2,4,1
19368,180182,QdOtDwNG9PGHroeB3tediNZNcdQgQDXk,5X6FeZozNMgE2VRi3MJYjkkFK8SETtu2,1,0,0,0,0,0,1,0,1,0.14285714285714285,1,0.0,0,0,0,0,0,0,0,1,0,0,1,1
19369,180202,6UuKdeqLBbfnVSLJBlFN5V4JFg0Y4C8c,5X6FeZozNMgE2VRi3MJYjkkFK8SETtu2,9,6,1,0,1,0,2,0,10,1.4285714285714286,1,0.0,0,1,0,1,6,0,0,2,0,2,8,1
19370,180216,QSaImtnwSyIvS5AffCcxoWPOjD7SK8AN,7GRhBDsirIGkRZBtSMEzNTyDr2JQm4xx,1,0,0,0,0,0,1,0,1,0.14285714285714285,1,0.0,0,0,0,0,0,0,0,1,0,0,1,1
19371,180227,rwhsU89MHhRjCVedmQCQbkrGP4GrGepX,5X6FeZozNMgE2VRi3MJYjkkFK8SETtu2,1,0,0,0,0,0,1,0,1,0.14285714285714285,1,0.0,0,0,0,0,0,0,0,1,0,0,1,1
19372,180269,oPqCsuIFtZAPoNsyhKvigrqOFJmD29Ve,7GRhBDsirIGkRZBtSMEzNTyDr2JQm4xx,13,16,7,4,2,10,13,1,53,7.571428571428571,2,0.0,2,7,3,2,14,10,1,13,1,14,39,1
19373,180309,kqgX5Ug7HO5XpWYua7IC9pl2O6MimRva,5X6FeZozNMgE2VRi3MJYjkkFK8SETtu2,1,0,0,0,0,0,1,0,1,0.14285714285714285,1,0.0,0,0,0,0,0,0,0,1,0,0,1,1
19374,180318,Hf0URgVFicQOS2VXZZFuo5o8pUWE4p7E,7GRhBDsirIGkRZBtSMEzNTyDr2JQm4xx,1,0,0,0,0,0,1,0,1,0.14285714285714285,1,0.0,0,0,0,0,0,0,0,1,0,0,1,1
19375,180320,INlSsgBu6U1GHD7zxA6m0Q3NWFMKIwpX,5X6FeZozNMgE2VRi3MJYjkkFK8SETtu2,2,0,0,0,0,0,2,0,2,0.2857142857142857,1,0.0,0,0,0,0,0,0,0,2,0,0,2,1
19376,180326,vIJUyeZxiAlOeYPEqKJHsdkNk5HQVTjW,7GRhBDsirIGkRZBtSMEzNTyDr2JQm4xx,1,0,0,0,0,0,1,0,1,0.14285714285714285,1,0.0,0,0,0,0,0,0,0,1,0,0,1,1
19377,180351,tp4Mrz7JS1onCkKXq1pdOKwHVwV5hzbU,5Gyp41oLVo7Gg7vF4vpmggWP5MU70QO6,4,2,0,0,0,0,2,0,4,0.5714285714285714,1,0.0,0,0,0,0,2,0,0,2,0,0,4,1
19378,180356,fO1rPCd8LF1QZM5kj2eXZwLqI6uO4Zpz,5Gyp41oLVo7Gg7vF4vpmggWP5MU70QO6,11,12,6,0,5,2,1,0,26,3.7142857142857144,1,0.0,5,6,0,5,7,2,0,1,0,16,10,1
19379,180357,aQrIiMSdJ4Cx08U2JeN1D9CI5on0xJMc,5Gyp41oLVo7Gg7vF4vpmggWP5MU70QO6,13,9,5,2,4,3,8,2,33,4.714285714285714,1,0.0,3,5,1,4,6,3,1,8,2,13,20,1
19380,180367,5C1B8xoccZDOMkayPzyUSDJHMCFmbuub,5Gyp41oLVo7Gg7vF4vpmggWP5MU70QO6,1,0,0,0,0,0,1,0,1,0.14285714285714285,1,0.0,0,0,0,0,0,0,0,1,0,0,1,1
19381,180370,TbfzHSMi751rc6U2st0sdW9XdcdcS06v,5Gyp41oLVo7Gg7vF4vpmggWP5MU70QO6,1,0,0,0,0,0,1,0,1,0.14285714285714285,1,0.0,0,0,0,0,0,0,0,1,0,0,1,1
19382,180381,DY4iozZtsj9dCnx4tB6KOsdcWdSVlbqu,5Gyp41oLVo7Gg7vF4vpmggWP5MU70QO6,9,5,3,0,2,3,5,0,18,2.5714285714285716,1,0.0,0,3,0,2,5,3,0,5,0,5,13,1
19383,180388,FWpC051cwqJBH79oqOdfblqN4GlR0u3G,5Gyp41oLVo7Gg7vF4vpmggWP5MU70QO6,5,2,1,0,1,0,2,0,6,0.8571428571428571,1,0.0,0,1,0,1,2,0,0,2,0,2,4,1
19384,180389,j9e3g7ZyA66aMiKukjK0Q8b6mzRu2oKh,5Gyp41oLVo7Gg7vF4vpmggWP5MU70QO6,7,8,5,0,4,4,2,0,23,3.2857142857142856,2,0.0,1,5,0,4,7,4,0,2,0,10,13,1
19385,180394,Ocr7rcGCOIoMBzVduVIm38Gcy1SGj09f,5Gyp41oLVo7Gg7vF4vpmggWP5MU70QO6,1,0,0,0,0,0,1,0,1,0.14285714285714285,1,0.0,0,0,0,0,0,0,0,1,0,0,1,1
19386,180413,8beXvUQwy6T37M9XUfaSlCZgjy9mS9a6,5Gyp41oLVo7Gg7vF4vpmggWP5MU70QO6,4,2,1,0,1,0,1,0,5,0.7142857142857143,1,0.0,0,1,0,1,2,0,0,1,0,2,3,1
19387,180417,U11KhdeSf7Ds7XggaiHnRtu6k7OIQmFC,5Gyp41oLVo7Gg7vF4vpmggWP5MU70QO6,4,5,2,0,0,0,2,0,9,1.2857142857142858,1,0.0,0,2,0,0,5,0,0,2,0,2,7,1
19388,180432,g6NmbWZaZC1YFf57IakO7t7xyqNpTARi,5Gyp41oLVo7Gg7vF4vpmggWP5MU70QO6,6,5,3,0,2,0,4,0,14,2.0,1,0.0,0,3,0,2,5,0,0,4,0,5,9,1
19389,180455,h3qyFO9IWffBeJRM5753bmVRlRirhzYN,5Gyp41oLVo7Gg7vF4vpmggWP5MU70QO6,6,15,7,0,0,3,3,0,28,4.0,1,0.0,0,7,0,0,15,3,0,3,0,7,21,1
19390,180469,8JDldMZVqmRyPhatl5NeaAXs4tXpkPku,5Gyp41oLVo7Gg7vF4vpmggWP5MU70QO6,8,8,3,0,2,0,9,0,22,3.142857142857143,1,0.0,0,3,0,2,8,0,0,9,0,5,17,1
19391,180493,gCd8Sd2RfmBz4ehaj6OBr1FA66u5N9dL,5Gyp41oLVo7Gg7vF4vpmggWP5MU70QO6,6,4,3,0,3,0,2,0,12,1.7142857142857142,1,0.0,0,3,0,3,4,0,0,2,0,6,6,1
19392,180504,FlAkKX6ow9SvOzk0dTWPWgnX5766zY29,5Gyp41oLVo7Gg7vF4vpmggWP5MU70QO6,17,30,15,15,3,0,3,0,66,9.428571428571429,2,0.0,10,15,9,3,20,0,6,3,0,37,29,0
19393,180518,895zoMD6mJwAHj4xfJ9SzevRra7tIeSP,5Gyp41oLVo7Gg7vF4vpmggWP5MU70QO6,6,9,4,0,0,0,2,0,15,2.142857142857143,1,0.0,0,4,0,0,9,0,0,2,0,4,11,1
19394,180522,zteMaJUiElneTG34paE93BZJbhi3Rzxw,5Gyp41oLVo7Gg7vF4vpmggWP5MU70QO6,5,3,1,0,1,0,4,0,9,1.2857142857142858,1,0.0,0,1,0,1,3,0,0,4,0,2,7,1
19395,180524,TIUmJyHLor4PJa4xcm8B1AkzAjgdynnH,5Gyp41oLVo7Gg7vF4vpmggWP5MU70QO6,15,13,6,14,6,5,5,1,50,7.142857142857143,1,0.0,6,6,9,6,7,5,5,5,1,27,23,1
19396,180530,byVNYMbOKXgyBxjBXAalnLjImdLXpgcX,5Gyp41oLVo7Gg7vF4vpmggWP5MU70QO6,4,3,1,0,0,0,6,0,10,1.4285714285714286,1,0.0,0,1,0,0,3,0,0,6,0,1,9,1
19397,180534,p8PDk7PIRcdv8OilLQ1EB9K2d3Uc8Sea,5Gyp41oLVo7Gg7vF4vpmggWP5MU70QO6,9,8,5,0,3,3,1,0,20,2.857142857142857,1,0.0,1,5,0,3,7,3,0,1,0,9,11,1
19398,180541,cRarmD0JG6RFnUZBoJIOdL5LbJ0FnKyk,5Gyp41oLVo7Gg7vF4vpmggWP5MU70QO6,2,0,0,0,0,0,3,0,3,0.42857142857142855,1,0.0,0,0,0,0,0,0,0,3,0,0,3,1
19399,180548,TEUPsGpO9PYEGoOOgGbRc3Q1ojqnng5o,5Gyp41oLVo7Gg7vF4vpmggWP5MU70QO6,1,0,0,0,0,0,2,0,2,0.2857142857142857,1,0.0,0,0,0,0,0,0,0,2,0,0,2,1
19400,180558,XEEElZ9lGvnixcTo6LiEFeFhd6iOx31I,5Gyp41oLVo7Gg7vF4vpmggWP5MU70QO6,5,3,2,0,0,0,6,0,11,1.5714285714285714,1,0.0,0,2,0,0,3,0,0,6,0,2,9,1
19401,180566,NVfQmiRmQ7nMqb7gqpui9U3Yc3gRlVEf,5Gyp41oLVo7Gg7vF4vpmggWP5MU70QO6,2,0,0,0,0,0,2,0,2,0.2857142857142857,1,0.0,0,0,0,0,0,0,0,2,0,0,2,1
19402,180592,GoxoEoUBOnm9t13caQFS2BivjJWPa71N,5Gyp41oLVo7Gg7vF4vpmggWP5MU70QO6,5,4,3,0,0,0,2,0,9,1.2857142857142858,1,0.0,0,3,0,0,4,0,0,2,0,3,6,1
19403,180629,u6YQGD67yzQraOCkQvpFkxe73vsSHBNh,5Gyp41oLVo7Gg7vF4vpmggWP5MU70QO6,8,6,4,0,3,0,3,0,16,2.2857142857142856,2,0.0,0,4,0,3,6,0,0,3,0,7,9,1
19404,180630,ntaprRh8kUd9YrMf6LEtRxqjBXx2Ps6Z,5Gyp41oLVo7Gg7vF4vpmggWP5MU70QO6,10,14,4,3,1,3,3,1,29,4.142857142857143,1,0.0,6,4,2,1,8,3,1,3,1,13,16,1
19405,180645,c4edZCmVfCbIilQg1CO06CjrvxXU9k3D,5Gyp41oLVo7Gg7vF4vpmggWP5MU70QO6,7,3,1,0,1,0,3,0,8,1.1428571428571428,1,0.0,0,1,0,1,3,0,0,3,0,2,6,1
19406,180656,g4IxwWffjsVchGKzA6WMMgRATibGukbl,5Gyp41oLVo7Gg7vF4vpmggWP5MU70QO6,13,10,5,0,5,0,2,0,22,3.142857142857143,1,0.0,4,5,0,5,6,0,0,2,0,14,8,1
19407,180669,aoALWSwPGNR6JIi50OG1GPp6QCiv6mBJ,5Gyp41oLVo7Gg7vF4vpmggWP5MU70QO6,5,2,1,0,1,0,3,0,7,1.0,1,0.0,0,1,0,1,2,0,0,3,0,2,5,1
19408,180673,Z1oVQRPANEnSckPXHT5gs075XuDbxwoH,5Gyp41oLVo7Gg7vF4vpmggWP5MU70QO6,9,14,5,4,2,1,4,0,30,4.285714285714286,1,0.0,1,5,3,2,13,1,1,4,0,11,19,1
19409,180678,N5ZyEwF2fjxmUbb8vyfWMYkhLQ0lBJZV,5Gyp41oLVo7Gg7vF4vpmggWP5MU70QO6,7,6,4,0,3,0,2,0,15,2.142857142857143,1,0.0,0,4,0,3,6,0,0,2,0,7,8,1
19410,180696,1qJTnAtgoTxKrXBLTRNXvpxOoUQnV1EH,5Gyp41oLVo7Gg7vF4vpmggWP5MU70QO6,5,2,1,0,1,3,4,0,11,1.5714285714285714,1,0.0,0,1,0,1,2,3,0,4,0,2,9,1
19411,180729,etZ9xN6Q98IeK8IbSrz3jPFppkZ7vZ62,5Gyp41oLVo7Gg7vF4vpmggWP5MU70QO6,7,6,2,0,2,0,2,0,12,1.7142857142857142,1,0.0,0,2,0,2,6,0,0,2,0,4,8,1
19412,180731,CTWGk58qaudsZSjuVt8Mw9PiKEOsQrxl,5Gyp41oLVo7Gg7vF4vpmggWP5MU70QO6,7,3,2,0,2,0,4,0,11,1.5714285714285714,1,0.0,1,2,0,2,2,0,0,4,0,5,6,1
19413,180735,eqUPkQyn4QKAsHkY6lMCzO5B6Uokx68t,5Gyp41oLVo7Gg7vF4vpmggWP5MU70QO6,3,2,1,0,0,0,1,0,4,0.5714285714285714,1,0.0,0,1,0,0,2,0,0,1,0,1,3,1
19414,180758,Xl8Tem8G8sPah3KAWnbWgv7GNqLZqPFw,5Gyp41oLVo7Gg7vF4vpmggWP5MU70QO6,1,0,0,0,0,0,2,0,2,0.2857142857142857,2,0.0,0,0,0,0,0,0,0,2,0,0,2,1
19415,180768,NC1pdSztpfJLgz1bqVoe5aonviJWe881,5Gyp41oLVo7Gg7vF4vpmggWP5MU70QO6,10,4,2,0,3,0,4,1,14,2.0,1,0.0,1,2,0,3,3,0,0,4,1,6,8,1
19416,180770,ju99oQO0X1snt47cenVSQ4xCWEZAimpG,5Gyp41oLVo7Gg7vF4vpmggWP5MU70QO6,1,0,0,0,0,0,1,0,1,0.14285714285714285,1,0.0,0,0,0,0,0,0,0,1,0,0,1,1
19417,180777,YaXaylbU0z2Ca8zoDx7xLpIEnmW32t84,5Gyp41oLVo7Gg7vF4vpmggWP5MU70QO6,4,0,0,0,0,0,3,1,4,0.5714285714285714,1,0.0,0,0,0,0,0,0,0,3,1,0,4,1
19418,180779,hCSV0kQ0N4T0nXWbclCByP1bLO3jf6Ol,5Gyp41oLVo7Gg7vF4vpmggWP5MU70QO6,11,9,4,5,3,0,3,0,24,3.4285714285714284,2,0.0,2,4,4,3,7,0,1,3,0,13,11,1
19419,180803,vN8kLwMD6SZ5PJYomafeYZdQAazsAsXN,5Gyp41oLVo7Gg7vF4vpmggWP5MU70QO6,1,0,0,0,0,0,1,0,1,0.14285714285714285,1,0.0,0,0,0,0,0,0,0,1,0,0,1,1
19420,180807,u0wxbghmFH2m9FbuFqinbhDUTVmw5e5v,5Gyp41oLVo7Gg7vF4vpmggWP5MU70QO6,2,0,0,0,0,4,1,0,5,0.7142857142857143,1,0.0,0,0,0,0,0,4,0,1,0,0,5,1
19421,180810,wkSwKLvgUmQfzacgilpZAQqvEzLlK9QG,5Gyp41oLVo7Gg7vF4vpmggWP5MU70QO6,1,0,0,0,0,0,1,0,1,0.14285714285714285,1,0.0,0,0,0,0,0,0,0,1,0,0,1,1
19422,180813,lCtRrSIfbNpcK7UHbOtWkZFXQeDuZqwn,5Gyp41oLVo7Gg7vF4vpmggWP5MU70QO6,8,6,3,4,2,0,2,0,17,2.4285714285714284,1,0.0,2,3,4,2,4,0,0,2,0,11,6,1
19423,180840,ijLy6KGq8gHYoyHeqbPHpZ4K6Py1rOui,5Gyp41oLVo7Gg7vF4vpmggWP5MU70QO6,6,3,2,0,1,0,2,0,8,1.1428571428571428,1,0.0,0,2,0,1,3,0,0,2,0,3,5,1
19424,180849,qd4omQG06oI6JyqK8YD1O61SwDe5NQ5J,5Gyp41oLVo7Gg7vF4vpmggWP5MU70QO6,2,0,0,0,0,0,2,0,2,0.2857142857142857,1,0.0,0,0,0,0,0,0,0,2,0,0,2,1
19425,180856,3NEUW6DB5c0uoj1FU0o2TX1sHyRcNdFs,5Gyp41oLVo7Gg7vF4vpmggWP5MU70QO6,7,7,3,0,1,0,3,0,14,2.0,1,0.0,1,3,0,1,6,0,0,3,0,5,9,1
19426,180862,iQa5DqYpqgpqWEY6AT2tJeHiK4XcjzGC,5Gyp41oLVo7Gg7vF4vpmggWP5MU70QO6,9,3,2,0,2,2,4,1,14,2.0,1,0.0,0,2,0,2,3,2,0,4,1,4,10,1
19427,180863,mNZVzyA4iyjUigfGjI4hVzzhXbEdPLdi,5Gyp41oLVo7Gg7vF4vpmggWP5MU70QO6,17,26,15,31,8,0,2,0,82,11.714285714285714,2,0.0,2,15,28,8,24,0,3,2,0,53,29,1
19428,180865,3n55YeHkad5zhsNnBeNXedOp2axGsKDz,5Gyp41oLVo7Gg7vF4vpmggWP5MU70QO6,1,0,0,0,0,0,2,0,2,0.2857142857142857,1,0.0,0,0,0,0,0,0,0,2,0,0,2,1
19429,180867,w5OdJoQZNGUVPiCQDXg0Vd0yo9ewUzmW,5Gyp41oLVo7Gg7vF4vpmggWP5MU70QO6,1,0,0,0,0,0,1,0,1,0.14285714285714285,1,0.0,0,0,0,0,0,0,0,1,0,0,1,1
19430,180881,FDgN6xJX7bDKL36N4IdkQGuWj4yThyjj,5Gyp41oLVo7Gg7vF4vpmggWP5MU70QO6,17,17,8,32,3,0,2,0,62,8.857142857142858,1,0.0,8,8,18,3,9,0,14,2,0,37,25,1
19431,180895,tfToLXBRnnlI6p2zq5iIYC9cW9wdoiPI,5Gyp41oLVo7Gg7vF4vpmggWP5MU70QO6,10,7,1,5,2,0,2,0,17,2.4285714285714284,1,0.0,2,1,3,2,5,0,2,2,0,8,9,1
19432,180898,QzEubPuC198UlvWJh0Tzfty18VwMGjPT,5Gyp41oLVo7Gg7vF4vpmggWP5MU70QO6,2,0,0,0,0,0,3,0,3,0.42857142857142855,1,0.0,0,0,0,0,0,0,0,3,0,0,3,1
19433,180900,baiZ413ok0IFv0hmfRXQcXcSJcWbY9Ym,5Gyp41oLVo7Gg7vF4vpmggWP5MU70QO6,5,2,1,0,1,0,2,0,6,0.8571428571428571,1,0.0,0,1,0,1,2,0,0,2,0,2,4,1
19434,180929,lMCzq9KABU4ZObAQpOfUyaYRWBCtViow,5Gyp41oLVo7Gg7vF4vpmggWP5MU70QO6,1,0,0,0,0,0,1,0,1,0.14285714285714285,1,0.0,0,0,0,0,0,0,0,1,0,0,1,1
19435,180935,MJ2SrqscjryYmTj3MCP6nb18o12yNggY,5Gyp41oLVo7Gg7vF4vpmggWP5MU70QO6,10,7,5,0,2,0,3,0,17,2.4285714285714284,1,0.0,0,5,0,2,7,0,0,3,0,7,10,1
19436,180940,oNVrIUp8rZjEp4WjUiFDIztbFFXtAjUK,5Gyp41oLVo7Gg7vF4vpmggWP5MU70QO6,8,5,3,0,2,0,4,0,14,2.0,2,0.0,0,3,0,2,5,0,0,4,0,5,9,1
19437,180945,e8Y4G90611rG6C14GJNj4shj65JVFISl,5Gyp41oLVo7Gg7vF4vpmggWP5MU70QO6,11,22,10,4,3,0,3,0,42,6.0,2,0.0,5,10,3,3,17,0,1,3,0,21,21,1
19438,180947,vBNj0d0nOCwf15RmbhYipHJn9TIcLqh0,5Gyp41oLVo7Gg7vF4vpmggWP5MU70QO6,1,0,0,0,0,0,1,0,1,0.14285714285714285,1,0.0,0,0,0,0,0,0,0,1,0,0,1,1
19439,180957,f6KkxzzSUmz9USWn2Re2RVELecsuFWbR,5Gyp41oLVo7Gg7vF4vpmggWP5MU70QO6,7,3,2,0,2,0,2,0,9,1.2857142857142858,1,0.0,0,2,0,2,3,0,0,2,0,4,5,1
19440,180973,UqmipTh7NynpaU8jm3r56rLAxgsmSU7I,5Gyp41oLVo7Gg7vF4vpmggWP5MU70QO6,13,24,9,7,9,3,2,0,54,7.714285714285714,2,0.0,12,9,5,9,12,3,2,2,0,35,19,1
19441,180979,YjEaFn5LTfYqjxB6JXUvw4Xb9oLhK631,5Gyp41oLVo7Gg7vF4vpmggWP5MU70QO6,7,6,3,0,2,0,3,0,14,2.0,2,0.0,0,3,0,2,6,0,0,3,0,5,9,1
19442,181010,4j4dS9OHUFGIF8km7oWh3y3j9t8sZ8Ej,5Gyp41oLVo7Gg7vF4vpmggWP5MU70QO6,1,0,0,0,0,0,3,0,3,0.42857142857142855,1,0.0,0,0,0,0,0,0,0,3,0,0,3,1
19443,181014,INyKsxPEFjMfoLoLKZbvDSb4QuapRIcM,5Gyp41oLVo7Gg7vF4vpmggWP5MU70QO6,5,2,1,0,1,0,2,0,6,0.8571428571428571,1,0.0,0,1,0,1,2,0,0,2,0,2,4,1
19444,181025,EA9ScIShElqrnJomZiYBwy227hiQMtOE,5Gyp41oLVo7Gg7vF4vpmggWP5MU70QO6,1,0,0,0,0,0,1,0,1,0.14285714285714285,1,0.0,0,0,0,0,0,0,0,1,0,0,1,1
19445,181049,MOaCjbrS1EASwr9LSifxu0C07WLv1XY8,5Gyp41oLVo7Gg7vF4vpmggWP5MU70QO6,6,5,3,0,3,0,1,0,12,1.7142857142857142,1,0.0,0,3,0,3,5,0,0,1,0,6,6,1
19446,181079,onAfOMsvg39dfSg2G3wfuBHMXF5hH87v,5Gyp41oLVo7Gg7vF4vpmggWP5MU70QO6,5,2,0,0,1,0,4,0,7,1.0,1,0.0,0,0,0,1,2,0,0,4,0,1,6,1
19447,181080,eyibvWPEESD34KffnoHQq6JdNuxCZpXy,5Gyp41oLVo7Gg7vF4vpmggWP5MU70QO6,8,4,3,0,3,0,1,0,11,1.5714285714285714,1,0.0,0,3,0,3,4,0,0,1,0,6,5,1
19448,181085,xEei8XHE92q0Z3XDw2dIdGFY4nbn0Qrf,5Gyp41oLVo7Gg7vF4vpmggWP5MU70QO6,4,3,1,0,0,0,1,0,5,0.7142857142857143,1,0.0,0,1,0,0,3,0,0,1,0,1,4,1
19449,181098,ivxBGUbA7UT7tzED0gKK31cJU8Lv97zd,5Gyp41oLVo7Gg7vF4vpmggWP5MU70QO6,3,2,0,0,0,2,1,0,5,0.7142857142857143,1,0.0,0,0,0,0,2,2,0,1,0,0,5,1
19450,181108,4kNrQYk71rt8ctOVkj0oxu4D43yO7ZQl,5Gyp41oLVo7Gg7vF4vpmggWP5MU70QO6,4,0,0,0,0,0,4,1,5,0.7142857142857143,1,0.0,0,0,0,0,0,0,0,4,1,0,5,1
19451,181113,R1UPXMkdkC5m6bNBQEp17ibdHEF0NiXL,5Gyp41oLVo7Gg7vF4vpmggWP5MU70QO6,10,11,4,10,2,1,8,1,37,5.285714285714286,2,0.0,6,4,8,2,5,1,2,8,1,20,17,1
19452,181120,h6WL9yy6oqssZuhnzDdRSTzfGvEAdOoD,5Gyp41oLVo7Gg7vF4vpmggWP5MU70QO6,1,0,0,0,0,0,1,0,1,0.14285714285714285,1,0.0,0,0,0,0,0,0,0,1,0,0,1,1
19453,181122,DavhuddfOncVkOSScyUap05C7vGz8ges,5Gyp41oLVo7Gg7vF4vpmggWP5MU70QO6,8,5,2,0,1,0,7,2,17,2.4285714285714284,1,0.0,0,2,0,1,5,0,0,7,2,3,14,1
19454,181134,sUWUdA4gFPmP8rdf2ttGN205I2GtCQUM,5Gyp41oLVo7Gg7vF4vpmggWP5MU70QO6,1,0,0,0,0,0,1,0,1,0.14285714285714285,1,0.0,0,0,0,0,0,0,0,1,0,0,1,1
19455,181156,ruiD7M8W9bfM7IoM9icA8ze1GC7rLz7I,5Gyp41oLVo7Gg7vF4vpmggWP5MU70QO6,10,4,2,0,3,0,4,1,14,2.0,1,0.0,1,2,0,3,3,0,0,4,1,6,8,1
19456,181161,erSfmhLG4RlFeRsFEI5yZ5rLqt6tmSeS,5Gyp41oLVo7Gg7vF4vpmggWP5MU70QO6,4,2,1,0,1,0,1,0,5,0.7142857142857143,1,0.0,0,1,0,1,2,0,0,1,0,2,3,1
19457,181166,8gHZyaAa1aVMzIfQafkIyPuWQWfP7F1H,5Gyp41oLVo7Gg7vF4vpmggWP5MU70QO6,13,12,7,2,2,5,9,0,37,5.285714285714286,2,0.0,3,7,1,2,9,5,1,9,0,13,24,1
19458,181171,dhfR4wGmOusRZWUPfjGh9lEKBfvvwgMt,5Gyp41oLVo7Gg7vF4vpmggWP5MU70QO6,6,13,6,0,0,0,1,0,20,2.857142857142857,1,0.0,0,6,0,0,13,0,0,1,0,6,14,1
19459,181172,cKzX1yMeujpajeoP7XLXoMfkqVSh2N9o,5Gyp41oLVo7Gg7vF4vpmggWP5MU70QO6,5,2,1,0,1,0,2,0,6,0.8571428571428571,1,0.0,0,1,0,1,2,0,0,2,0,2,4,1
19460,181196,9bFvPhgoAiKVhf5OQzMZPiwIYftMmTrt,5Gyp41oLVo7Gg7vF4vpmggWP5MU70QO6,2,0,0,0,0,0,2,0,2,0.2857142857142857,1,0.0,0,0,0,0,0,0,0,2,0,0,2,1
19461,181213,rNPw2npFBG0yowcddnm9yNTNtVAZ2hhI,5Gyp41oLVo7Gg7vF4vpmggWP5MU70QO6,1,0,0,0,0,0,1,0,1,0.14285714285714285,1,0.0,0,0,0,0,0,0,0,1,0,0,1,1
19462,181236,1s66T8nC5Brh1WC0avoq9zfAYFmC2cy6,5Gyp41oLVo7Gg7vF4vpmggWP5MU70QO6,6,3,1,0,1,0,6,1,12,1.7142857142857142,1,0.0,1,1,0,1,2,0,0,6,1,3,9,1
19463,181242,CsPknC052wniB1MWNqxmElIo3E5g7l5u,5Gyp41oLVo7Gg7vF4vpmggWP5MU70QO6,5,2,1,0,1,0,2,0,6,0.8571428571428571,1,0.0,0,1,0,1,2,0,0,2,0,2,4,0
19464,181256,dtV2v0hrzgCDVZIuGtCKMKHtiLO2K2lj,5Gyp41oLVo7Gg7vF4vpmggWP5MU70QO6,24,31,15,24,4,1,7,0,82,11.714285714285714,2,0.0,12,15,15,4,19,1,9,7,0,46,36,1
19465,181266,jbfQf8j93qEc8QCxEb0dikXBABlkLrcO,5Gyp41oLVo7Gg7vF4vpmggWP5MU70QO6,4,2,0,0,0,0,4,0,6,0.8571428571428571,1,0.0,0,0,0,0,2,0,0,4,0,0,6,1
19466,181287,bpH9144QxaCP0IuOtJ1htZxY18SoeZkY,5Gyp41oLVo7Gg7vF4vpmggWP5MU70QO6,19,51,20,22,4,3,21,0,121,17.285714285714285,3,0.0,16,20,12,4,35,3,10,21,0,52,69,1
19467,181292,KTxArcU1dHlBSUXs7fRS5tqgeW3QGDVE,5Gyp41oLVo7Gg7vF4vpmggWP5MU70QO6,6,6,1,0,2,1,9,0,19,2.7142857142857144,1,0.0,2,1,0,2,4,1,0,9,0,5,14,1
19468,181293,eYFvYtnVKexSt1Uofy5VGyG9dl1PPAA5,5Gyp41oLVo7Gg7vF4vpmggWP5MU70QO6,9,11,4,3,2,0,1,0,21,3.0,1,0.0,4,4,2,2,7,0,1,1,0,12,9,1
19469,181294,bapf8jpo49GBPQQLhNaP8gArutfX97HO,5Gyp41oLVo7Gg7vF4vpmggWP5MU70QO6,6,6,4,0,1,0,4,1,16,2.2857142857142856,2,0.0,0,4,0,1,6,0,0,4,1,5,11,1
19470,181296,MM0HdGNNpR1lvzEnJBWtFROUtMetYXEg,5Gyp41oLVo7Gg7vF4vpmggWP5MU70QO6,10,5,3,0,2,0,5,1,16,2.2857142857142856,1,0.0,0,3,0,2,5,0,0,5,1,5,11,1
19471,181297,Y2nyPAJyvQ0i6cjbIjZFGOeLk60o9uIg,5Gyp41oLVo7Gg7vF4vpmggWP5MU70QO6,2,0,0,0,0,0,2,0,2,0.2857142857142857,1,0.0,0,0,0,0,0,0,0,2,0,0,2,1
19472,181312,we3JRvtMBQN4lhCJbcBPcxhz7bBBOP3O,5Gyp41oLVo7Gg7vF4vpmggWP5MU70QO6,8,7,0,6,0,0,1,0,14,2.0,1,0.0,0,0,4,0,7,0,2,1,0,4,10,1
19473,181323,0DMSkP31HrkDHBcqvRvQ9Ihr0hx9jYbu,5Gyp41oLVo7Gg7vF4vpmggWP5MU70QO6,7,3,2,0,2,1,3,0,11,1.5714285714285714,1,0.0,0,2,0,2,3,1,0,3,0,4,7,1
19474,181325,HcTSf3sdH9eMcyLU8Gl5AhCTe7KqX4pZ,5Gyp41oLVo7Gg7vF4vpmggWP5MU70QO6,7,8,3,1,1,0,2,0,15,2.142857142857143,2,0.0,2,3,1,1,6,0,0,2,0,7,8,1
19475,181341,SIokyE6JBQNU8m9geSEV0RNjiRe80iZE,5Gyp41oLVo7Gg7vF4vpmggWP5MU70QO6,1,0,0,0,0,0,2,0,2,0.2857142857142857,1,0.0,0,0,0,0,0,0,0,2,0,0,2,1
19476,181345,BjBet1XrpmufRo3nJSBrADvKxDiooNdd,5Gyp41oLVo7Gg7vF4vpmggWP5MU70QO6,1,0,0,0,0,0,1,0,1,0.14285714285714285,1,0.0,0,0,0,0,0,0,0,1,0,0,1,1
19477,181348,GfVwnPyRA7dcSbbIg96mjGdzO73sm11f,5Gyp41oLVo7Gg7vF4vpmggWP5MU70QO6,9,4,1,0,3,0,2,0,10,1.4285714285714286,1,0.0,0,1,0,3,4,0,0,2,0,4,6,1
19478,181363,DXz5mdXrIRuIZ0YXlfzSEvISumQDbm6K,5Gyp41oLVo7Gg7vF4vpmggWP5MU70QO6,5,1,1,0,0,0,5,0,7,1.0,1,0.0,0,1,0,0,1,0,0,5,0,1,6,1
19479,181369,Fo6UXh70ymQtEThJZOzOeH8iNb2MhPJ5,5Gyp41oLVo7Gg7vF4vpmggWP5MU70QO6,13,22,7,4,5,1,4,0,43,6.142857142857143,1,0.0,7,7,2,5,15,1,2,4,0,21,22,1
19480,181394,K6PK8VrzDGjO5ZlkYcRj1Z7SSxo8biOv,5Gyp41oLVo7Gg7vF4vpmggWP5MU70QO6,1,0,0,0,0,0,1,0,1,0.14285714285714285,1,0.0,0,0,0,0,0,0,0,1,0,0,1,1
19481,181397,pSXhm10LQrKWhBodVl5wDf3hGiwH3QOg,5Gyp41oLVo7Gg7vF4vpmggWP5MU70QO6,10,3,2,0,2,0,5,1,13,1.8571428571428572,1,0.0,0,2,0,2,3,0,0,5,1,4,9,1
19482,181400,OIjfrBdtsUvzBnLBAUPi1OLB0nX3QIjX,5Gyp41oLVo7Gg7vF4vpmggWP5MU70QO6,2,0,0,0,0,0,3,0,3,0.42857142857142855,1,0.0,0,0,0,0,0,0,0,3,0,0,3,1
19483,181415,v8jebqrHoVA1JPsuez8pD6IYGdg1Q8yX,5Gyp41oLVo7Gg7vF4vpmggWP5MU70QO6,1,0,0,0,0,0,1,0,1,0.14285714285714285,1,0.0,0,0,0,0,0,0,0,1,0,0,1,1
19484,181441,GT9XZ0eTe8qlg7WeLH7sdHIAlgtnFb8R,5Gyp41oLVo7Gg7vF4vpmggWP5MU70QO6,5,3,1,0,1,0,4,0,9,1.2857142857142858,1,0.0,0,1,0,1,3,0,0,4,0,2,7,1
19485,181442,6j8gZnIOiqrL87utkOxjl50x7Em7cDIm,5Gyp41oLVo7Gg7vF4vpmggWP5MU70QO6,2,0,0,0,0,0,2,0,2,0.2857142857142857,1,0.0,0,0,0,0,0,0,0,2,0,0,2,1
19486,181445,Zk0LslXntRQS58DQnyI3iRGhuocimbNA,5Gyp41oLVo7Gg7vF4vpmggWP5MU70QO6,7,3,2,0,2,1,2,0,10,1.4285714285714286,1,0.0,0,2,0,2,3,1,0,2,0,4,6,1
19487,181454,U3R4m4eLMm2lirgI7HLueBKsNpxhFpn9,5Gyp41oLVo7Gg7vF4vpmggWP5MU70QO6,11,11,7,1,4,0,2,0,25,3.5714285714285716,1,0.0,3,7,1,4,8,0,0,2,0,15,10,1
19488,181463,QSjwCTbJk06PRzmUJhyjhjHmzO6JT8fY,5Gyp41oLVo7Gg7vF4vpmggWP5MU70QO6,11,10,5,2,4,0,1,0,22,3.142857142857143,1,0.0,4,5,1,4,6,0,1,1,0,14,8,1
19489,181468,hnZeNQ4kr8O7YfkdIrZm33I6quuSD4sz,5Gyp41oLVo7Gg7vF4vpmggWP5MU70QO6,11,12,6,0,2,0,4,1,25,3.5714285714285716,1,0.0,0,6,0,2,12,0,0,4,1,8,17,1
19490,181474,y8AdDSbHENRUD5ii0AuyONW5YY98sBlv,5Gyp41oLVo7Gg7vF4vpmggWP5MU70QO6,17,16,7,0,7,2,4,0,36,5.142857142857143,1,0.0,3,7,0,7,13,2,0,4,0,17,19,0
19491,181477,5Sdd90y9f6G1O01oh8dNylP38h97ZkQP,5Gyp41oLVo7Gg7vF4vpmggWP5MU70QO6,8,5,3,0,2,2,2,0,14,2.0,1,0.0,0,3,0,2,5,2,0,2,0,5,9,1
19492,181482,fR5V33zcezmxPgghUktnecG1qNdYVShX,5Gyp41oLVo7Gg7vF4vpmggWP5MU70QO6,5,2,1,0,1,0,2,0,6,0.8571428571428571,1,0.0,0,1,0,1,2,0,0,2,0,2,4,1
19493,181483,QKIhrVBj8aJ2zvxQ51GQM3LX3gexKGZH,5Gyp41oLVo7Gg7vF4vpmggWP5MU70QO6,2,0,0,0,0,0,2,0,2,0.2857142857142857,1,0.0,0,0,0,0,0,0,0,2,0,0,2,1
19494,181488,F5DFfMrxkv1wogCZI6eeGu3qtvMXCudW,5Gyp41oLVo7Gg7vF4vpmggWP5MU70QO6,1,0,0,0,0,0,1,0,1,0.14285714285714285,1,0.0,0,0,0,0,0,0,0,1,0,0,1,1
19495,181490,XOxCWYMm47dwluDpR4uJchgPIaTZUbIk,5Gyp41oLVo7Gg7vF4vpmggWP5MU70QO6,5,2,1,0,1,0,3,0,7,1.0,1,0.0,0,1,0,1,2,0,0,3,0,2,5,1
19496,181503,bhhFIxvevjWYG5LoQYs3AHzKEI0d78fi,5Gyp41oLVo7Gg7vF4vpmggWP5MU70QO6,1,0,0,0,0,0,1,0,1,0.14285714285714285,1,0.0,0,0,0,0,0,0,0,1,0,0,1,1
19497,181520,HEqgGFXylFDP70VGbbq4OKqIIVcnbN6Z,5Gyp41oLVo7Gg7vF4vpmggWP5MU70QO6,20,19,11,13,4,0,1,0,48,6.857142857142857,1,0.0,7,11,8,4,12,0,5,1,0,30,18,1
19498,181534,OpwckdWsEER4l1OJBpcnh3NU2xxoNmjO,5Gyp41oLVo7Gg7vF4vpmggWP5MU70QO6,7,6,5,0,1,0,3,0,15,2.142857142857143,1,0.0,0,5,0,1,6,0,0,3,0,6,9,1
19499,181542,qi7KVNmfKsK3oeS3bRCbOTnPSHK2PSHI,5Gyp41oLVo7Gg7vF4vpmggWP5MU70QO6,7,3,3,0,2,0,3,0,11,1.5714285714285714,1,0.0,0,3,0,2,3,0,0,3,0,5,6,1
19500,181554,RD1kdutFDkiIgUjnQBr2q67R2pCh5GjV,5Gyp41oLVo7Gg7vF4vpmggWP5MU70QO6,10,40,7,0,0,2,8,1,58,8.285714285714286,1,0.0,9,7,0,0,31,2,0,8,1,16,42,1
19501,181577,CxOXTyrVHjSzlA5Fh7HK8tgZgwTPMS3P,5Gyp41oLVo7Gg7vF4vpmggWP5MU70QO6,8,5,4,0,2,5,1,0,17,2.4285714285714284,1,0.0,0,4,0,2,5,5,0,1,0,6,11,1
19502,181604,f7GgnG1EhEYfpTzWdSUpG5mBEhzDlaP6,5Gyp41oLVo7Gg7vF4vpmggWP5MU70QO6,1,0,0,0,0,0,1,0,1,0.14285714285714285,1,0.0,0,0,0,0,0,0,0,1,0,0,1,1
19503,181624,RGYHsRxOSpzGYlOiCyaLeKfeM737nY9S,5Gyp41oLVo7Gg7vF4vpmggWP5MU70QO6,15,17,7,7,3,15,2,0,51,7.285714285714286,1,0.0,6,7,5,3,11,15,2,2,0,21,30,1
19504,181662,NDtcgqo3IqvWktjMfoAkMVK3iMVUj48d,5Gyp41oLVo7Gg7vF4vpmggWP5MU70QO6,13,10,5,5,5,9,5,1,40,5.714285714285714,1,0.0,3,5,4,5,7,9,1,5,1,17,23,1
19505,181667,4LzpC48UjugivGpxDptKLNf1uPCLHda2,5Gyp41oLVo7Gg7vF4vpmggWP5MU70QO6,7,2,1,0,1,21,4,0,29,4.142857142857143,1,0.0,0,1,0,1,2,21,0,4,0,2,27,1
19506,181676,DugKJlrAldkrss433t1vbMjeUQoSebNi,5Gyp41oLVo7Gg7vF4vpmggWP5MU70QO6,4,2,0,0,0,0,2,0,4,0.5714285714285714,2,0.0,0,0,0,0,2,0,0,2,0,0,4,1
19507,181680,bGjzMxOC88rUacNGu6kshAaxdH2zKDK7,5Gyp41oLVo7Gg7vF4vpmggWP5MU70QO6,3,1,0,0,0,0,2,0,3,0.42857142857142855,1,0.0,0,0,0,0,1,0,0,2,0,0,3,1
19508,181746,31lvFKODE2ecliZIHSs4rY4kq62euP4j,5Gyp41oLVo7Gg7vF4vpmggWP5MU70QO6,1,0,0,0,0,0,1,0,1,0.14285714285714285,1,0.0,0,0,0,0,0,0,0,1,0,0,1,1
19509,181765,NtWIu4J0HPOWOANC7ZYns4tsHx1TBJoi,5Gyp41oLVo7Gg7vF4vpmggWP5MU70QO6,5,2,1,0,1,0,2,0,6,0.8571428571428571,1,0.0,0,1,0,1,2,0,0,2,0,2,4,1
19510,181766,49rI5FrlP6bc7Hj3wufdevcQSNKjMKGt,5Gyp41oLVo7Gg7vF4vpmggWP5MU70QO6,16,14,11,0,5,0,4,0,34,4.857142857142857,1,0.0,0,11,0,5,14,0,0,4,0,16,18,1
19511,181770,h2lZPyPsXFExtQUKuL9gmZH1Tuf0BNHB,5Gyp41oLVo7Gg7vF4vpmggWP5MU70QO6,10,13,5,4,3,0,9,0,34,4.857142857142857,2,0.0,6,5,3,3,7,0,1,9,0,17,17,1
19512,181772,2ponQ8n7XN1NDar2kbkmiBemIHnSb6vV,5Gyp41oLVo7Gg7vF4vpmggWP5MU70QO6,6,7,3,0,3,0,1,0,14,2.0,2,0.0,0,3,0,3,7,0,0,1,0,6,8,1
19513,181774,Px1AwKbsjfO7MpLQSICMQMUSA8mNB6no,5Gyp41oLVo7Gg7vF4vpmggWP5MU70QO6,1,0,0,0,0,0,1,0,1,0.14285714285714285,1,0.0,0,0,0,0,0,0,0,1,0,0,1,1
19514,181790,sCKziRJTsOYc4lQfYxPq4wO4jIyYAbxE,5Gyp41oLVo7Gg7vF4vpmggWP5MU70QO6,3,3,1,0,0,0,1,0,5,0.7142857142857143,1,0.0,0,1,0,0,3,0,0,1,0,1,4,1
19515,181825,OKWA86BtkBHcNmHrCmPkMazWWaLGK4gl,5Gyp41oLVo7Gg7vF4vpmggWP5MU70QO6,1,0,0,0,0,0,1,0,1,0.14285714285714285,1,0.0,0,0,0,0,0,0,0,1,0,0,1,1
19516,181830,3t5FakhMXfR4IP8lNBq0c8POHlJOVCmu,5Gyp41oLVo7Gg7vF4vpmggWP5MU70QO6,3,0,0,0,0,1,2,0,3,0.42857142857142855,1,0.0,0,0,0,0,0,1,0,2,0,0,3,1
19517,181850,wnJ5tl9XXv3IeSQ2Cgh7iWVddGChOZ9x,5Gyp41oLVo7Gg7vF4vpmggWP5MU70QO6,6,1,1,0,1,0,4,1,8,1.1428571428571428,1,0.0,0,1,0,1,1,0,0,4,1,2,6,1
19518,181861,Q4NluUWiFaKkxFoBlSsNbkiwOR0VhjEq,5Gyp41oLVo7Gg7vF4vpmggWP5MU70QO6,2,0,0,0,0,0,3,0,3,0.42857142857142855,1,0.0,0,0,0,0,0,0,0,3,0,0,3,1
19519,181863,locU5icaqDOAfRtQOWd1XmQK2Y9k0byx,5Gyp41oLVo7Gg7vF4vpmggWP5MU70QO6,7,4,2,0,3,0,1,0,10,1.4285714285714286,1,0.0,1,2,0,3,3,0,0,1,0,6,4,1
19520,181867,MxUguHhWb2452TUVztjIAFfN9PKMm5iH,5Gyp41oLVo7Gg7vF4vpmggWP5MU70QO6,11,6,4,2,3,0,2,0,17,2.4285714285714284,1,0.0,1,4,1,3,5,0,1,2,0,9,8,1
19521,181885,MawTy0UaNMzLOBBaurqND3JymILXKOHX,5Gyp41oLVo7Gg7vF4vpmggWP5MU70QO6,15,14,9,10,1,0,4,0,38,5.428571428571429,1,0.0,0,9,6,1,14,0,4,4,0,16,22,1
19522,181886,2oHi0xAwpU9rO0gdJkKqphbQcbEZ8anJ,5Gyp41oLVo7Gg7vF4vpmggWP5MU70QO6,8,10,5,10,0,0,4,0,29,4.142857142857143,1,0.0,4,5,9,0,6,0,1,4,0,18,11,1
19523,181890,pmuU4bWjVJ0lq4P8L4015gBgZrLIZM8p,5Gyp41oLVo7Gg7vF4vpmggWP5MU70QO6,6,5,4,0,1,0,1,0,11,1.5714285714285714,1,0.0,0,4,0,1,5,0,0,1,0,5,6,1
19524,181904,W45vVnuMw5fBAycI8BoUEsnE5dwQvAy8,5Gyp41oLVo7Gg7vF4vpmggWP5MU70QO6,6,3,2,0,2,0,1,0,8,1.1428571428571428,1,0.0,0,2,0,2,3,0,0,1,0,4,4,1
19525,181921,LNYrn6xB3rBElpbQNSOCHM0VLOJzqt6i,5Gyp41oLVo7Gg7vF4vpmggWP5MU70QO6,9,5,3,0,2,7,6,0,23,3.2857142857142856,1,0.0,0,3,0,2,5,7,0,6,0,5,18,1
19526,181933,rwzmhiQOlMw9FlgdSOddl4jBOOu67wjg,5Gyp41oLVo7Gg7vF4vpmggWP5MU70QO6,2,0,0,0,0,0,2,0,2,0.2857142857142857,1,0.0,0,0,0,0,0,0,0,2,0,0,2,1
19527,181954,L3hcz7iHh1j4JsmPAhDddHFBFjWN9SzP,5Gyp41oLVo7Gg7vF4vpmggWP5MU70QO6,4,2,1,0,1,0,2,0,6,0.8571428571428571,1,0.0,0,1,0,1,2,0,0,2,0,2,4,1
19528,181957,Ov9SdOcJjrPsko4RxSRp3diSYNiMCffC,5Gyp41oLVo7Gg7vF4vpmggWP5MU70QO6,7,4,2,0,3,0,1,0,10,1.4285714285714286,1,0.0,1,2,0,3,3,0,0,1,0,6,4,1
19529,181966,FbSHedxpIyx1zxNDmX3MtyNonypZQZwK,5Gyp41oLVo7Gg7vF4vpmggWP5MU70QO6,8,6,3,2,1,0,1,0,13,1.8571428571428572,1,0.0,0,3,1,1,6,0,1,1,0,5,8,1
19530,181971,NmYREsaZDERhdTllo0PKFjYlurn0TTI7,5Gyp41oLVo7Gg7vF4vpmggWP5MU70QO6,9,6,3,1,2,0,2,0,14,2.0,1,0.0,2,3,1,2,4,0,0,2,0,8,6,1
19531,182000,JQ0cmdrRVrmZvsr4jAL1KLBXht7wZGtP,5Gyp41oLVo7Gg7vF4vpmggWP5MU70QO6,4,2,1,0,1,0,1,0,5,0.7142857142857143,1,0.0,0,1,0,1,2,0,0,1,0,2,3,1
19532,182006,9A1ZQrzcYlbBSb63MFLqCvCueyg4FsvP,5Gyp41oLVo7Gg7vF4vpmggWP5MU70QO6,7,8,5,0,5,0,2,0,20,2.857142857142857,1,0.0,0,5,0,5,8,0,0,2,0,10,10,1
19533,182011,3KCb4A6amo38Fw6QE756HJn80s8Q1p3u,5Gyp41oLVo7Gg7vF4vpmggWP5MU70QO6,4,2,1,0,1,0,1,0,5,0.7142857142857143,1,0.0,0,1,0,1,2,0,0,1,0,2,3,1
19534,182024,3DiWYAOQjeDtnJZGK8fOdLVqW8Lh6lud,5Gyp41oLVo7Gg7vF4vpmggWP5MU70QO6,2,0,0,0,0,0,4,0,4,0.5714285714285714,1,0.0,0,0,0,0,0,0,0,4,0,0,4,1
19535,182025,nZgMoXQTdwr6mRJaOu9BQK0OQtDdo4la,5Gyp41oLVo7Gg7vF4vpmggWP5MU70QO6,1,0,0,0,0,0,1,0,1,0.14285714285714285,1,0.0,0,0,0,0,0,0,0,1,0,0,1,1
19536,182034,1Z2YS4fNWnbcxpYbnETbTnCL868s8T08,5Gyp41oLVo7Gg7vF4vpmggWP5MU70QO6,8,12,4,0,0,0,2,0,18,2.5714285714285716,1,0.0,0,4,0,0,12,0,0,2,0,4,14,1
19537,182035,7KhKqa63HvVJWSmCO4rE8rP2X8uu5f5I,5Gyp41oLVo7Gg7vF4vpmggWP5MU70QO6,10,11,5,0,4,0,4,0,24,3.4285714285714284,1,0.0,2,5,0,4,9,0,0,4,0,11,13,1
19538,182041,BEoFn5nxSaJGR2KKBSxScQ6BAoe2WAvX,5Gyp41oLVo7Gg7vF4vpmggWP5MU70QO6,2,0,0,0,0,0,2,0,2,0.2857142857142857,1,0.0,0,0,0,0,0,0,0,2,0,0,2,1
19539,182082,V4j9PrCfYtbqCIwmvlNG7xBA7kUHsqZK,5Gyp41oLVo7Gg7vF4vpmggWP5MU70QO6,8,3,0,0,1,0,6,1,11,1.5714285714285714,1,0.0,0,0,0,1,3,0,0,6,1,1,10,1
19540,182083,ki90RZB6Cz17YNoTCBLraq3nBz0Lom7L,5Gyp41oLVo7Gg7vF4vpmggWP5MU70QO6,4,2,1,0,1,0,1,0,5,0.7142857142857143,1,0.0,0,1,0,1,2,0,0,1,0,2,3,1
19541,182096,BvffxX46vpsrzdz3BgWM6oxkgoUuLeGW,5Gyp41oLVo7Gg7vF4vpmggWP5MU70QO6,5,1,1,0,0,1,5,0,8,1.1428571428571428,2,0.0,0,1,0,0,1,1,0,5,0,1,7,1
19542,182100,kJMtZ1ZRFiok4Mw6PIf0eVr6xCFOhu4o,5Gyp41oLVo7Gg7vF4vpmggWP5MU70QO6,1,0,0,0,0,0,2,0,2,0.2857142857142857,1,0.0,0,0,0,0,0,0,0,2,0,0,2,1
19543,182109,Gwa0DmAnwS7uFof0niE4PXKO0jXe3Slf,fbPkOYLVPtPgIt0MxizjfFJov3JbHyAi,1,0,0,0,0,0,1,0,1,0.14285714285714285,1,0.0,0,0,0,0,0,0,0,1,0,0,1,1
19544,182112,zlwQbpNIekZraqM3friulFpxhiOo1ayo,fbPkOYLVPtPgIt0MxizjfFJov3JbHyAi,10,15,5,12,5,0,1,0,38,5.428571428571429,1,0.0,8,5,10,5,7,0,2,1,0,28,10,1
19545,182113,GYgjnVWPCrydBlTq2p9TNsOMewn9I740,fbPkOYLVPtPgIt0MxizjfFJov3JbHyAi,7,3,2,0,2,1,2,0,10,1.4285714285714286,1,0.0,0,2,0,2,3,1,0,2,0,4,6,1
19546,182116,hHZ1kUumh00Z1O4WNdKmul7qhC5wFHpp,fbPkOYLVPtPgIt0MxizjfFJov3JbHyAi,2,0,0,0,0,0,2,0,2,0.2857142857142857,1,0.0,0,0,0,0,0,0,0,2,0,0,2,1
19547,182119,3cxRLD4ivD6Xixr11d6ir7hAedI4FyWB,fbPkOYLVPtPgIt0MxizjfFJov3JbHyAi,4,4,0,0,0,0,2,0,6,0.8571428571428571,1,0.0,0,0,0,0,4,0,0,2,0,0,6,1
19548,182120,6VA6nLOi6ahJ2WGPKX7ioAOUNgqPHvUs,fbPkOYLVPtPgIt0MxizjfFJov3JbHyAi,2,0,0,0,0,0,6,0,6,0.8571428571428571,1,0.0,0,0,0,0,0,0,0,6,0,0,6,1
19549,182121,E6bBR9HWJxY6CHMf6HUGhFy5mb5tOylJ,fbPkOYLVPtPgIt0MxizjfFJov3JbHyAi,11,8,5,0,5,0,7,0,25,3.5714285714285716,1,0.0,0,5,0,5,8,0,0,7,0,10,15,1
19550,182122,5YQOb4e4NWGumJICWtGzlXhZqNgwWRbu,fbPkOYLVPtPgIt0MxizjfFJov3JbHyAi,4,2,1,0,1,0,2,0,6,0.8571428571428571,1,0.0,0,1,0,1,2,0,0,2,0,2,4,1
19551,182123,ymJ3Ly9A46GdjQR1wi3rfZi54oWQxUId,fbPkOYLVPtPgIt0MxizjfFJov3JbHyAi,18,18,10,0,5,3,10,1,47,6.714285714285714,1,0.0,0,10,0,5,18,3,0,10,1,15,32,1
19552,182126,olMbWc9RSQc0Tu4bEWQzOnwezTDWcrs8,fbPkOYLVPtPgIt0MxizjfFJov3JbHyAi,6,5,1,0,1,0,2,0,9,1.2857142857142858,1,0.0,0,1,0,1,5,0,0,2,0,2,7,1
19553,182127,vRSgOJQhE6Dmiwqh3C4hk74qCb0K1GB9,fbPkOYLVPtPgIt0MxizjfFJov3JbHyAi,10,11,3,0,5,6,8,1,34,4.857142857142857,1,0.0,5,3,0,5,6,6,0,8,1,13,21,1
19554,182129,KZwRHcnI3AfT8vnaT6jXgPBnofHOQ7LC,fbPkOYLVPtPgIt0MxizjfFJov3JbHyAi,7,3,2,0,2,0,2,0,9,1.2857142857142858,1,0.0,0,2,0,2,3,0,0,2,0,4,5,1
19555,182130,NYIqoSfm9poo24TZ0kcwGlXtybBgVCOL,fbPkOYLVPtPgIt0MxizjfFJov3JbHyAi,11,13,6,4,6,13,6,1,49,7.0,1,0.0,5,6,4,6,8,13,0,6,1,21,28,1
19556,182131,fNApL5o3nJBE8hTLknxUE86rJy4pC3GT,fbPkOYLVPtPgIt0MxizjfFJov3JbHyAi,4,3,0,0,0,0,8,0,11,1.5714285714285714,1,0.0,0,0,0,0,3,0,0,8,0,0,11,1
19557,182132,hl9NS7ZQVsxPwew9lFoMcbw555xXfA7K,fbPkOYLVPtPgIt0MxizjfFJov3JbHyAi,7,5,2,0,1,4,3,0,15,2.142857142857143,1,0.0,0,2,0,1,5,4,0,3,0,3,12,1
19558,182133,UyFXTBkXJQGbTK6ia4vV9zDaXqtiIBQm,fbPkOYLVPtPgIt0MxizjfFJov3JbHyAi,7,8,2,0,3,0,2,0,15,2.142857142857143,1,0.0,5,2,0,3,3,0,0,2,0,10,5,1
19559,182136,X4KSPkBIdPEeXdEy4Fa5NvixCQZdfNj3,fbPkOYLVPtPgIt0MxizjfFJov3JbHyAi,4,2,1,0,1,2,1,0,7,1.0,1,0.0,0,1,0,1,2,2,0,1,0,2,5,0
19560,182137,y20f09CxhvS55Wblm8XZJQuRockZgjId,fbPkOYLVPtPgIt0MxizjfFJov3JbHyAi,7,6,2,0,3,0,4,0,15,2.142857142857143,1,0.0,3,2,0,3,3,0,0,4,0,8,7,1
19561,182140,CspzBeiHo2fn2vKCGW8HrTuVGO5NjODD,fbPkOYLVPtPgIt0MxizjfFJov3JbHyAi,7,7,4,0,3,1,1,0,16,2.2857142857142856,1,0.0,1,4,0,3,6,1,0,1,0,8,8,1
19562,182141,AauRkOnfsQwSVeed7CUEfyrgZR6O3N4f,fbPkOYLVPtPgIt0MxizjfFJov3JbHyAi,9,3,2,0,2,1,5,1,14,2.0,1,0.0,0,2,0,2,3,1,0,5,1,4,10,1
19563,182142,ZpH2lTvJnGFaqS5AMOBCpvMR4Yj9r7Pd,fbPkOYLVPtPgIt0MxizjfFJov3JbHyAi,9,3,2,0,2,0,6,1,14,2.0,1,0.0,0,2,0,2,3,0,0,6,1,4,10,1
19564,182148,QXkIuj2oxPauvAqRj9R3CrSpnC0ZZZoj,fbPkOYLVPtPgIt0MxizjfFJov3JbHyAi,1,0,0,0,0,0,1,0,1,0.14285714285714285,1,0.0,0,0,0,0,0,0,0,1,0,0,1,1
19565,182149,Gk8pzlz0IYhW1OkJmVAg6JK1p1uZlJAZ,fbPkOYLVPtPgIt0MxizjfFJov3JbHyAi,1,0,0,0,0,0,1,0,1,0.14285714285714285,1,0.0,0,0,0,0,0,0,0,1,0,0,1,1
19566,182150,7DufOZH7uJb86RSw7kwej322YsuvsAOn,fbPkOYLVPtPgIt0MxizjfFJov3JbHyAi,8,7,3,0,2,0,2,0,14,2.0,1,0.0,0,3,0,2,7,0,0,2,0,5,9,1
19567,182151,9IwP7y3bv6FVCnKXUMMCB32M5XkaXZUv,fbPkOYLVPtPgIt0MxizjfFJov3JbHyAi,4,2,1,0,1,3,1,0,8,1.1428571428571428,1,0.0,0,1,0,1,2,3,0,1,0,2,6,1
19568,182153,LYRECt7UvWAQo3p4ZaUgaxhi8hvbxrUh,fbPkOYLVPtPgIt0MxizjfFJov3JbHyAi,8,3,2,0,2,4,5,1,17,2.4285714285714284,2,0.0,0,2,0,2,3,4,0,5,1,4,13,1
19569,182157,qjvNhzawDTohg4QJduwMXhiyYQLWnwRL,fbPkOYLVPtPgIt0MxizjfFJov3JbHyAi,5,2,1,0,1,0,5,0,9,1.2857142857142858,1,0.0,0,1,0,1,2,0,0,5,0,2,7,1
19570,182158,EbhEKkK0InsrxKv61aHGTKOc8r6D96CH,fbPkOYLVPtPgIt0MxizjfFJov3JbHyAi,5,2,1,0,1,4,5,0,13,1.8571428571428572,1,0.0,0,1,0,1,2,4,0,5,0,2,11,1
19571,182161,fnqTxztLKveM5YvxSzdyiaXhOlLMcpQz,fbPkOYLVPtPgIt0MxizjfFJov3JbHyAi,6,3,2,0,2,0,1,0,8,1.1428571428571428,1,0.0,0,2,0,2,3,0,0,1,0,4,4,1
19572,182187,H117GF1k3O9osnwLz3rAg4mYmWstuXU0,3VkHkmOtom3jM2wCu94xgzzu1d6Dn7or,1,0,0,0,0,0,2,0,2,0.2857142857142857,1,0.0,0,0,0,0,0,0,0,2,0,0,2,1
19573,182190,00Kx3J9CRlctJfArDSkdtP8hRdqPFwLf,3VkHkmOtom3jM2wCu94xgzzu1d6Dn7or,1,0,0,0,0,0,1,0,1,0.14285714285714285,1,0.0,0,0,0,0,0,0,0,1,0,0,1,1
19574,182192,GrWRHoB3VWocBjREEumvkOBXvz3lJGxv,3VkHkmOtom3jM2wCu94xgzzu1d6Dn7or,1,0,0,0,0,0,1,0,1,0.14285714285714285,1,0.0,0,0,0,0,0,0,0,1,0,0,1,1
19575,182196,IdmjEEjxaIwYtwaiihXQw24cCOzGMcRI,3VkHkmOtom3jM2wCu94xgzzu1d6Dn7or,5,7,2,0,2,0,2,0,13,1.8571428571428572,1,0.0,4,2,0,2,3,0,0,2,0,8,5,1
19576,182197,CH7rIEiCYJderq7iXskzAGjPNDy8sGGS,3VkHkmOtom3jM2wCu94xgzzu1d6Dn7or,4,2,1,0,1,0,1,0,5,0.7142857142857143,1,0.0,0,1,0,1,2,0,0,1,0,2,3,1
19577,182200,wewT1LcIg9ROwSNoAw0lFo4wxE5uZciO,3VkHkmOtom3jM2wCu94xgzzu1d6Dn7or,9,5,3,4,3,2,9,0,26,3.7142857142857144,1,0.0,2,3,3,3,3,2,1,9,0,11,15,0
19578,182202,KLtToUXPfDnf997XzXyNb6H8vh7LaC9m,3VkHkmOtom3jM2wCu94xgzzu1d6Dn7or,2,0,0,0,0,0,2,0,2,0.2857142857142857,1,0.0,0,0,0,0,0,0,0,2,0,0,2,1
19579,182206,uQtAgJj2Of7B50CCIIAF0x5swLURLwJX,3VkHkmOtom3jM2wCu94xgzzu1d6Dn7or,1,0,0,0,0,0,2,0,2,0.2857142857142857,1,0.0,0,0,0,0,0,0,0,2,0,0,2,1
19580,182208,uMRvOWo3sNjmemkFxMacb4QbfvnWRpMb,3VkHkmOtom3jM2wCu94xgzzu1d6Dn7or,6,1,1,0,0,2,5,1,10,1.4285714285714286,1,0.0,0,1,0,0,1,2,0,5,1,1,9,1
19581,182215,kPSxZZ94rBA1L72EwaJLctu2Ik0HW0q7,3VkHkmOtom3jM2wCu94xgzzu1d6Dn7or,3,2,0,0,0,1,1,0,4,0.5714285714285714,1,0.0,0,0,0,0,2,1,0,1,0,0,4,1
19582,182240,W2db1kjWC1U4zDuCRrsZQTSQpohcCfeK,3VkHkmOtom3jM2wCu94xgzzu1d6Dn7or,5,2,1,0,1,0,2,0,6,0.8571428571428571,1,0.0,0,1,0,1,2,0,0,2,0,2,4,1
19583,182247,emlaLAdmzzEGMpifkpl9WpOOIevlnDOM,3VkHkmOtom3jM2wCu94xgzzu1d6Dn7or,36,24,11,42,11,0,3,0,91,13.0,2,0.0,10,11,32,11,14,0,10,3,0,64,27,1
19584,182250,fNqfDDObJjv6kYtYOM5CvmS2PsuLl3sf,3VkHkmOtom3jM2wCu94xgzzu1d6Dn7or,4,2,0,0,0,0,4,0,6,0.8571428571428571,1,0.0,0,0,0,0,2,0,0,4,0,0,6,1
19585,182254,XStD3S8KQ8bJ4cdsAZYlRFdU3WnvmVed,3VkHkmOtom3jM2wCu94xgzzu1d6Dn7or,1,0,0,0,0,0,1,0,1,0.14285714285714285,1,0.0,0,0,0,0,0,0,0,1,0,0,1,1
19586,182264,20W3KdJ6RNWG2FvhyTnQB2r6IXpufM92,3VkHkmOtom3jM2wCu94xgzzu1d6Dn7or,10,9,5,0,4,0,10,6,34,4.857142857142857,1,0.0,2,5,0,4,7,0,0,10,6,11,23,1
19587,182266,d5N36ltJLuexchMmFNrBfpp3LZsF74JT,3VkHkmOtom3jM2wCu94xgzzu1d6Dn7or,1,0,0,0,0,0,1,0,1,0.14285714285714285,1,0.0,0,0,0,0,0,0,0,1,0,0,1,1
19588,182268,g2zZYnTJ1Pk3cSjsVP5SH4UjJdsbDJv7,3VkHkmOtom3jM2wCu94xgzzu1d6Dn7or,1,0,0,0,0,0,1,0,1,0.14285714285714285,1,0.0,0,0,0,0,0,0,0,1,0,0,1,0
19589,182278,AQ6M5BJYsVJFiSEOtWrHSzMJEU0hwvMR,3VkHkmOtom3jM2wCu94xgzzu1d6Dn7or,7,2,1,0,1,2,16,0,22,3.142857142857143,1,0.0,0,1,0,1,2,2,0,16,0,2,20,1
19590,182279,Yy2T8AQun3h4tOt3dyFcuzCw5XOF0cCp,3VkHkmOtom3jM2wCu94xgzzu1d6Dn7or,4,5,0,0,0,0,3,1,9,1.2857142857142858,2,0.0,0,0,0,0,5,0,0,3,1,0,9,1
19591,182280,FvwBnZjfO1ihX1Ognm9XYc2VlKDdgQWa,3VkHkmOtom3jM2wCu94xgzzu1d6Dn7or,4,3,1,0,1,0,1,0,6,0.8571428571428571,1,0.0,0,1,0,1,3,0,0,1,0,2,4,1
19592,182285,DjLk0aa0OIt3R9DUjosJRHAu7bqj2BBW,3VkHkmOtom3jM2wCu94xgzzu1d6Dn7or,5,4,1,0,0,1,3,0,9,1.2857142857142858,1,0.0,2,1,0,0,2,1,0,3,0,3,6,1
19593,182290,5toCKkjnRq0eSPOLqtFoS578XbzD4wBw,G8EPVSXsOYB5YQWZGiz1aVq5Pgr2GrQu,1,0,0,0,0,0,1,0,1,0.14285714285714285,1,0.0,0,0,0,0,0,0,0,1,0,0,1,1
19594,182291,cQRD9R1lgeOAK9gupu9KhB7dk2fRklcD,SpATywNh6bZuzm8s1ceuBUnMUAeoAHHw,1,0,0,0,0,0,1,0,1,0.14285714285714285,1,0.0,0,0,0,0,0,0,0,1,0,0,1,1
19595,182293,rjvGhIVc59Kfmh4NTR3DXDqHucpB5jFj,SpATywNh6bZuzm8s1ceuBUnMUAeoAHHw,1,0,0,0,0,0,1,0,1,0.14285714285714285,1,0.0,0,0,0,0,0,0,0,1,0,0,1,1
19596,182294,yzxOtAUXbE94zTY0JAZtWSh2NXgDCsgD,RXDvfPUBYFlVdlueBFbLW0mhhAyGEqpt,1,0,0,0,0,0,2,0,2,0.2857142857142857,1,0.0,0,0,0,0,0,0,0,2,0,0,2,1
19597,182295,zDSSBRMWP1Y5CJVqlFdftdl4OIpV063x,G8EPVSXsOYB5YQWZGiz1aVq5Pgr2GrQu,5,5,2,0,2,0,9,0,18,2.5714285714285716,1,0.0,2,2,0,2,3,0,0,9,0,6,12,1
19598,182301,kSqoYJOiSgMSgk1xmaagqD7swBESTNnk,SpATywNh6bZuzm8s1ceuBUnMUAeoAHHw,1,0,0,0,0,0,1,0,1,0.14285714285714285,1,0.0,0,0,0,0,0,0,0,1,0,0,1,1
19599,182303,6V0aEecugZSGEGjp9sOtqKaVX0hdaxfx,SpATywNh6bZuzm8s1ceuBUnMUAeoAHHw,1,0,0,0,0,0,1,0,1,0.14285714285714285,1,0.0,0,0,0,0,0,0,0,1,0,0,1,1
19600,182311,v2pq4xsqndqpApLtzn0qeg9IWIRhaLtH,RXDvfPUBYFlVdlueBFbLW0mhhAyGEqpt,1,0,0,0,0,0,1,0,1,0.14285714285714285,1,0.0,0,0,0,0,0,0,0,1,0,0,1,1
19601,182316,PlkufWXrNLS9iN2k0xnVvGFQQ3lcdAbM,G8EPVSXsOYB5YQWZGiz1aVq5Pgr2GrQu,1,0,0,0,0,0,1,0,1,0.14285714285714285,1,0.0,0,0,0,0,0,0,0,1,0,0,1,1
19602,182317,pCLzLzljqYC5o1UQJ6Cha7geyVzPY5Vr,SpATywNh6bZuzm8s1ceuBUnMUAeoAHHw,6,3,0,0,0,12,12,2,29,4.142857142857143,1,0.0,0,0,0,0,3,12,0,12,2,0,29,1
19603,182319,dVj05AozpSMnDp2rhv4XKLX2a6Zq0Qtw,G8EPVSXsOYB5YQWZGiz1aVq5Pgr2GrQu,1,0,0,0,0,0,1,0,1,0.14285714285714285,1,0.0,0,0,0,0,0,0,0,1,0,0,1,1
19604,182326,Sw8bR12uIoqYzcTEWiNrFu21bYIsPZ21,SpATywNh6bZuzm8s1ceuBUnMUAeoAHHw,8,3,1,0,1,4,11,1,21,3.0,2,0.0,0,1,0,1,3,4,0,11,1,2,19,1
19605,182335,o4d7pEXcgiRK88QgwrazSAkO64S1An1t,SpATywNh6bZuzm8s1ceuBUnMUAeoAHHw,5,0,0,0,0,1,6,1,8,1.1428571428571428,1,0.0,0,0,0,0,0,1,0,6,1,0,8,1
19606,182339,Xx5J61LsGAAIQtOy53VIgrfa1jCLAM7p,SpATywNh6bZuzm8s1ceuBUnMUAeoAHHw,6,4,0,0,0,0,9,3,16,2.2857142857142856,1,0.0,0,0,0,0,4,0,0,9,3,0,16,1
19607,182340,0hNxT6GuoMZdI4yowbLV9KqXkZO6tOr5,bWdj2GDclj5ofokWjzoa5jAwMkxCykd6,2,0,0,0,0,0,2,0,2,0.2857142857142857,1,0.0,0,0,0,0,0,0,0,2,0,0,2,1
19608,182347,HtQh4lek05i0a5loRX7CCHUQbHgEiPqt,G8EPVSXsOYB5YQWZGiz1aVq5Pgr2GrQu,1,0,0,0,0,0,1,0,1,0.14285714285714285,1,0.0,0,0,0,0,0,0,0,1,0,0,1,1
19609,182353,WO9GKA0lZwTMWZPNOUikUeUkOH5TeVRT,bWdj2GDclj5ofokWjzoa5jAwMkxCykd6,5,1,0,0,0,1,3,0,5,0.7142857142857143,1,0.0,0,0,0,0,1,1,0,3,0,0,5,1
19610,182356,Bk9dV86JsBuitZPucHUYfkNksrS8wdwY,G8EPVSXsOYB5YQWZGiz1aVq5Pgr2GrQu,1,0,0,0,0,0,1,0,1,0.14285714285714285,1,0.0,0,0,0,0,0,0,0,1,0,0,1,1
19611,182364,sHXZP4MEjEMzkkOQfvmTepwt8uTqOiyM,bWdj2GDclj5ofokWjzoa5jAwMkxCykd6,1,0,0,0,0,0,2,0,2,0.2857142857142857,1,0.0,0,0,0,0,0,0,0,2,0,0,2,1
19612,182373,JQ5HcehgeZikB3gBiE8cU639NjwVjWKa,SpATywNh6bZuzm8s1ceuBUnMUAeoAHHw,6,2,0,0,0,4,12,1,19,2.7142857142857144,1,0.0,0,0,0,0,2,4,0,12,1,0,19,1
19613,182381,qaaVUOEYbrLxp7YRueHtvaFuKfMUdZFu,SpATywNh6bZuzm8s1ceuBUnMUAeoAHHw,4,1,0,0,0,0,5,0,6,0.8571428571428571,1,0.0,0,0,0,0,1,0,0,5,0,0,6,1
19614,182382,GaGH1fy9jH1iKzXu03szgy9cHdGLnq5i,SpATywNh6bZuzm8s1ceuBUnMUAeoAHHw,5,3,0,0,0,1,8,1,13,1.8571428571428572,1,0.0,0,0,0,0,3,1,0,8,1,0,13,0
19615,182386,qPi2PGJwgnVJqcFYKHdGLm3vb4xL3Vqe,SpATywNh6bZuzm8s1ceuBUnMUAeoAHHw,3,1,0,0,0,0,2,1,4,0.5714285714285714,1,0.0,0,0,0,0,1,0,0,2,1,0,4,1
19616,182390,1b8W57uM2By4uHrSNMMSnzGhkYIXdyHL,SpATywNh6bZuzm8s1ceuBUnMUAeoAHHw,8,12,6,0,0,17,9,1,45,6.428571428571429,1,0.0,0,6,0,0,12,17,0,9,1,6,39,1
19617,182396,zp4PyZk9acvJn0zAHSStMGVB47KHiGqV,SpATywNh6bZuzm8s1ceuBUnMUAeoAHHw,4,2,0,0,0,1,6,0,9,1.2857142857142858,1,0.0,0,0,0,0,2,1,0,6,0,0,9,1
19618,182408,guVBQQJjeYDSTq5MuNRM97IJcEbUqgcR,bWdj2GDclj5ofokWjzoa5jAwMkxCykd6,1,0,0,0,0,0,1,0,1,0.14285714285714285,1,0.0,0,0,0,0,0,0,0,1,0,0,1,1
19619,182409,Ts2aYicZBB6YO6VPNN4UcEdjhKngsoNN,SpATywNh6bZuzm8s1ceuBUnMUAeoAHHw,5,7,2,0,1,0,4,0,14,2.0,1,0.0,0,2,0,1,7,0,0,4,0,3,11,1
19620,182410,LF2KQyoh29W4ySeHppAbd59MSPNMzEhL,SpATywNh6bZuzm8s1ceuBUnMUAeoAHHw,7,4,3,0,3,0,3,0,13,1.8571428571428572,1,0.0,0,3,0,3,4,0,0,3,0,6,7,1
19621,182412,nWBGuFtxvcnIdby83CLlwrZAI2gdEnIT,SpATywNh6bZuzm8s1ceuBUnMUAeoAHHw,12,23,0,32,0,0,5,0,60,8.571428571428571,1,0.0,15,0,31,0,8,0,1,5,0,46,14,1
19622,182413,GXDOLXInBDPENmCe7wGStFtoPK2oUX4s,SpATywNh6bZuzm8s1ceuBUnMUAeoAHHw,1,0,0,0,0,0,7,0,7,1.0,1,0.0,0,0,0,0,0,0,0,7,0,0,7,1
19623,182431,FvzTIFO6hWFbSbURKzXHQcilBAcLEPtg,SpATywNh6bZuzm8s1ceuBUnMUAeoAHHw,7,6,4,0,2,1,1,0,14,2.0,1,0.0,0,4,0,2,6,1,0,1,0,6,8,1
19624,182432,42bX0uPWOXgBHMwF4wqdnl1Ve6wIHNQe,RXDvfPUBYFlVdlueBFbLW0mhhAyGEqpt,1,0,0,0,0,0,1,0,1,0.14285714285714285,1,0.0,0,0,0,0,0,0,0,1,0,0,1,1
19625,182435,HxeyM7hnjqqrHkT4PVJnwDZtWwoxUMiy,SpATywNh6bZuzm8s1ceuBUnMUAeoAHHw,11,10,1,0,1,1,6,1,20,2.857142857142857,1,0.0,2,1,0,1,8,1,0,6,1,4,16,1
19626,182437,6tKFS11agpQ0olDkx5j9iNHGPGSGzhhI,SpATywNh6bZuzm8s1ceuBUnMUAeoAHHw,5,2,1,0,1,0,3,0,7,1.0,1,0.0,0,1,0,1,2,0,0,3,0,2,5,1
19627,182438,Lj5uTbeKi1sufoHMuLZiALNDuJSM9yU6,SpATywNh6bZuzm8s1ceuBUnMUAeoAHHw,8,12,6,0,4,22,6,0,50,7.142857142857143,1,0.0,0,6,0,4,12,22,0,6,0,10,40,1
19628,182440,kEYZryUXXrs1JDEn4cAws8bSjO65yGwg,SpATywNh6bZuzm8s1ceuBUnMUAeoAHHw,10,4,3,0,2,0,5,0,14,2.0,1,0.0,0,3,0,2,4,0,0,5,0,5,9,1
19629,182443,xS1af9TI3CHZS0INarz6NC45nSv9EYbw,SpATywNh6bZuzm8s1ceuBUnMUAeoAHHw,4,3,1,0,0,0,2,0,6,0.8571428571428571,1,0.0,0,1,0,0,3,0,0,2,0,1,5,0
19630,182456,N48ctBBocxdq0KkO9X20oV13gY0Gjyl2,SpATywNh6bZuzm8s1ceuBUnMUAeoAHHw,5,3,2,0,2,0,2,0,9,1.2857142857142858,1,0.0,0,2,0,2,3,0,0,2,0,4,5,1
19631,182460,GjfYG8nVkFnRE6YCq1jd11CdDUHtJYRI,RXDvfPUBYFlVdlueBFbLW0mhhAyGEqpt,2,0,0,0,0,0,2,0,2,0.2857142857142857,1,0.0,0,0,0,0,0,0,0,2,0,0,2,1
19632,182462,SKgefBsbooOLi1DQ2ANZv6uhR5LclYyt,SpATywNh6bZuzm8s1ceuBUnMUAeoAHHw,2,0,0,0,0,0,2,0,2,0.2857142857142857,1,0.0,0,0,0,0,0,0,0,2,0,0,2,1
19633,182469,3kzqQ9nu0puySXndbv8HvzuMPwBlBjfc,SpATywNh6bZuzm8s1ceuBUnMUAeoAHHw,5,2,1,0,1,0,3,0,7,1.0,1,0.0,0,1,0,1,2,0,0,3,0,2,5,1
19634,182474,jhtAULfQ5yICMx2IFQr24sJJ4xrsxsJG,SpATywNh6bZuzm8s1ceuBUnMUAeoAHHw,5,2,1,0,1,0,2,0,6,0.8571428571428571,1,0.0,0,1,0,1,2,0,0,2,0,2,4,1
19635,182475,mN4qYBgpy4Qxh2rSlBkY5ZDyLEZtAHu9,SpATywNh6bZuzm8s1ceuBUnMUAeoAHHw,6,5,3,0,1,4,3,1,17,2.4285714285714284,2,0.0,0,3,0,1,5,4,0,3,1,4,13,1
19636,182481,vyEmNT9CTTZs1s1eotM7mTmxUqBkMZB7,RXDvfPUBYFlVdlueBFbLW0mhhAyGEqpt,1,0,0,0,0,0,1,0,1,0.14285714285714285,1,0.0,0,0,0,0,0,0,0,1,0,0,1,1
19637,182485,z17j9VE8hh3UoPkOgrySRSueL3ju2tA5,SpATywNh6bZuzm8s1ceuBUnMUAeoAHHw,5,2,1,0,1,0,2,0,6,0.8571428571428571,1,0.0,0,1,0,1,2,0,0,2,0,2,4,1
19638,182486,m5upFVNgYoX0YbIT8oOeY2wNVmvYCqj2,SpATywNh6bZuzm8s1ceuBUnMUAeoAHHw,14,16,0,8,0,0,11,1,36,5.142857142857143,2,0.0,2,0,8,0,14,0,0,11,1,10,26,1
19639,182487,nVOg10sq8HgH3D4DlsGdX3NFr8soVHEc,RXDvfPUBYFlVdlueBFbLW0mhhAyGEqpt,3,0,0,0,0,1,2,1,4,0.5714285714285714,1,0.0,0,0,0,0,0,1,0,2,1,0,4,1
19640,182489,NrHk4qmJXuD0TsjkQSnghKpk9ZjGAOyU,SpATywNh6bZuzm8s1ceuBUnMUAeoAHHw,6,4,3,0,3,0,1,0,11,1.5714285714285714,1,0.0,0,3,0,3,4,0,0,1,0,6,5,1
19641,182494,zsHSwvXoubMUxhT2AYVzfcvRGMppEBUX,SpATywNh6bZuzm8s1ceuBUnMUAeoAHHw,1,0,0,0,0,0,1,0,1,0.14285714285714285,1,0.0,0,0,0,0,0,0,0,1,0,0,1,1
19642,182500,VBP5PzVQEKJYFH0y5ffEek5WfP9EW7uc,RXDvfPUBYFlVdlueBFbLW0mhhAyGEqpt,1,0,0,0,0,0,1,0,1,0.14285714285714285,1,0.0,0,0,0,0,0,0,0,1,0,0,1,1
19643,182502,kAraFi42vk7T3fSVrfxFu4iOqntHqrmm,SpATywNh6bZuzm8s1ceuBUnMUAeoAHHw,5,2,1,0,1,0,2,0,6,0.8571428571428571,1,0.0,0,1,0,1,2,0,0,2,0,2,4,1
19644,182505,m0a4B9CqoOZviuEOZZDt94aINv2ug5oe,SpATywNh6bZuzm8s1ceuBUnMUAeoAHHw,12,12,0,18,0,1,5,1,37,5.285714285714286,1,0.0,7,0,16,0,5,1,2,5,1,23,14,1
19645,182512,6hJQXXKt3z1MdoT6ARo6T723NTe1XSxK,SpATywNh6bZuzm8s1ceuBUnMUAeoAHHw,5,3,2,0,0,0,2,0,7,1.0,1,0.0,0,2,0,0,3,0,0,2,0,2,5,1
19646,182517,ks5e3RcWAMPB7dYikwZWJXfUkWO8gZ3N,SpATywNh6bZuzm8s1ceuBUnMUAeoAHHw,4,3,0,0,1,0,1,0,5,0.7142857142857143,1,0.0,0,0,0,1,3,0,0,1,0,1,4,1
19647,182521,T5B0wanX0DF5aMvlnBdjCYkcuibanyPc,SpATywNh6bZuzm8s1ceuBUnMUAeoAHHw,7,3,2,0,2,1,2,0,10,1.4285714285714286,1,0.0,0,2,0,2,3,1,0,2,0,4,6,1
19648,182523,84Vq27rxsidbGJFxLO0cd5e2CSiXRChu,bWdj2GDclj5ofokWjzoa5jAwMkxCykd6,9,5,3,0,2,0,5,0,15,2.142857142857143,2,0.0,0,3,0,2,5,0,0,5,0,5,10,1
19649,182525,cPdYTPvgiw01Ix09y30D3fRJUN12tLct,SpATywNh6bZuzm8s1ceuBUnMUAeoAHHw,4,2,1,0,1,0,1,0,5,0.7142857142857143,1,0.0,0,1,0,1,2,0,0,1,0,2,3,1
19650,182528,9BiLYY350hgtHO5tL7nbMfcZU0JcfZbs,bWdj2GDclj5ofokWjzoa5jAwMkxCykd6,13,32,11,26,8,6,15,3,101,14.428571428571429,2,0.0,7,11,25,8,25,6,1,15,3,51,50,1
19651,182532,hnqQN2i26CUAGHIpVFZ6rAak8SqbOivU,SpATywNh6bZuzm8s1ceuBUnMUAeoAHHw,14,12,7,0,4,12,6,2,43,6.142857142857143,1,0.0,3,7,0,4,9,12,0,6,2,14,29,1
19652,182535,Y6X26XefNz3sdpw3wkwyK5sCZwXPgnq9,G8EPVSXsOYB5YQWZGiz1aVq5Pgr2GrQu,1,0,0,0,0,0,1,0,1,0.14285714285714285,1,0.0,0,0,0,0,0,0,0,1,0,0,1,1
19653,182537,1MlRC5B28v0ZYaZMhNewOGPdpzQmr9tm,G8EPVSXsOYB5YQWZGiz1aVq5Pgr2GrQu,1,0,0,0,0,0,2,0,2,0.2857142857142857,1,0.0,0,0,0,0,0,0,0,2,0,0,2,1
19654,182549,95du6AurTX5krUoy6t3WLkl60ccYr4Yy,SpATywNh6bZuzm8s1ceuBUnMUAeoAHHw,7,6,3,0,2,0,1,0,12,1.7142857142857142,1,0.0,0,3,0,2,6,0,0,1,0,5,7,1
19655,182550,s7vJJA7T1Y0Q1LgIP8wcUZxSj1YxtrKh,SpATywNh6bZuzm8s1ceuBUnMUAeoAHHw,5,2,1,0,1,0,2,0,6,0.8571428571428571,1,0.0,0,1,0,1,2,0,0,2,0,2,4,1
19656,182551,TzUoSJ3pyMjwCKLIHuVSKLad9h9hLr5U,bWdj2GDclj5ofokWjzoa5jAwMkxCykd6,4,4,0,0,0,0,2,0,6,0.8571428571428571,2,0.0,0,0,0,0,4,0,0,2,0,0,6,1
19657,182562,abjQNDbGZHBvhV75LOq4Zq7eUXUW7X3t,SpATywNh6bZuzm8s1ceuBUnMUAeoAHHw,5,2,1,0,1,16,4,0,24,3.4285714285714284,1,0.0,0,1,0,1,2,16,0,4,0,2,22,1
19658,182564,9TiNdK7h4B0s8IwXYYwGBHmjweOZzBSB,SpATywNh6bZuzm8s1ceuBUnMUAeoAHHw,6,3,2,0,2,0,1,0,8,1.1428571428571428,1,0.0,0,2,0,2,3,0,0,1,0,4,4,1
19659,182566,d5l2AueqCUuxelNqQjpUQXmepKxeL9RK,SpATywNh6bZuzm8s1ceuBUnMUAeoAHHw,2,0,0,0,0,0,3,0,3,0.42857142857142855,1,0.0,0,0,0,0,0,0,0,3,0,0,3,1
19660,182578,2lL4O2JkoYHXEIhykvPcKhzBe5EQva7N,SpATywNh6bZuzm8s1ceuBUnMUAeoAHHw,10,6,4,0,3,1,4,0,18,2.5714285714285716,1,0.0,0,4,0,3,6,1,0,4,0,7,11,1
19661,182580,Sg8cI88TycyqBJF3IvR4MAi6ZTHZwK4Y,SpATywNh6bZuzm8s1ceuBUnMUAeoAHHw,8,4,2,0,2,0,2,0,10,1.4285714285714286,1,0.0,0,2,0,2,4,0,0,2,0,4,6,1
19662,182581,jU374KwiA6GV2KDGbAoaF4QnL7rMxEi0,G8EPVSXsOYB5YQWZGiz1aVq5Pgr2GrQu,2,0,0,0,0,0,2,0,2,0.2857142857142857,1,0.0,0,0,0,0,0,0,0,2,0,0,2,1
19663,182585,2a0JX3oGEViqf41bSYpVwPl2biPpAdoF,SpATywNh6bZuzm8s1ceuBUnMUAeoAHHw,1,0,0,0,0,0,2,0,2,0.2857142857142857,1,0.0,0,0,0,0,0,0,0,2,0,0,2,1
19664,182588,0PHNMn5JYsQigYaNxUJgIv4qow2cWlQK,RXDvfPUBYFlVdlueBFbLW0mhhAyGEqpt,1,0,0,0,0,0,1,0,1,0.14285714285714285,1,0.0,0,0,0,0,0,0,0,1,0,0,1,1
19665,182594,i1weaEaafaiWi31Ms4bwoF6JM4IRf714,RXDvfPUBYFlVdlueBFbLW0mhhAyGEqpt,4,2,1,0,1,0,1,0,5,0.7142857142857143,1,0.0,0,1,0,1,2,0,0,1,0,2,3,1
19666,182597,yP6YIcdT0zgy1EQJGlMcTsst8ErbjUGy,SpATywNh6bZuzm8s1ceuBUnMUAeoAHHw,15,12,7,8,4,0,4,0,35,5.0,1,0.0,2,7,8,4,10,0,0,4,0,21,14,1
19667,182601,ryvCYWNER8Ti86HxjplPmDOVtkpCfcHF,SpATywNh6bZuzm8s1ceuBUnMUAeoAHHw,5,2,0,3,0,0,3,0,8,1.1428571428571428,1,0.0,1,0,3,0,1,0,0,3,0,4,4,1
19668,182603,pC6FwYDHxh9swUa6nvJYcLLtE0AYC1Cg,G8EPVSXsOYB5YQWZGiz1aVq5Pgr2GrQu,1,0,0,0,0,0,1,0,1,0.14285714285714285,1,0.0,0,0,0,0,0,0,0,1,0,0,1,1
19669,182606,DgUbD2nFaZ1xgkcPsb7gJ6lYqMu1fGiD,SpATywNh6bZuzm8s1ceuBUnMUAeoAHHw,10,3,3,0,3,1,8,1,19,2.7142857142857144,1,0.0,0,3,0,3,3,1,0,8,1,6,13,1
19670,182607,wMgpdygsXgp7CzOQBDeaQc0sjt2NDO9y,SpATywNh6bZuzm8s1ceuBUnMUAeoAHHw,9,13,6,0,3,0,3,0,25,3.5714285714285716,1,0.0,0,6,0,3,13,0,0,3,0,9,16,1
19671,182612,0hrKpjkp9zkhrQR2RoP7TZCXn5cdSG8v,SpATywNh6bZuzm8s1ceuBUnMUAeoAHHw,9,12,3,1,2,0,5,0,23,3.2857142857142856,1,0.0,3,3,1,2,9,0,0,5,0,9,14,1
19672,182615,gnekWLWeAJ1MVfJL4ZXLvhc4aznPtP4v,RXDvfPUBYFlVdlueBFbLW0mhhAyGEqpt,18,24,18,0,8,0,6,0,56,8.0,1,0.0,2,18,0,8,22,0,0,6,0,28,28,1
19673,182616,8JTz84ZDdJm6tvsd7hgyCl1RB6wU6r2e,SpATywNh6bZuzm8s1ceuBUnMUAeoAHHw,5,3,2,0,1,0,1,0,7,1.0,1,0.0,0,2,0,1,3,0,0,1,0,3,4,1
19674,182620,pmyN5Lpd7zPzDMrdwaddb9OujjdVFpIA,SpATywNh6bZuzm8s1ceuBUnMUAeoAHHw,1,0,0,0,0,0,1,0,1,0.14285714285714285,1,0.0,0,0,0,0,0,0,0,1,0,0,1,1
19675,182621,uLzTTG1K0rlYPSkAfYE7pAYKyeT5Eqlp,bWdj2GDclj5ofokWjzoa5jAwMkxCykd6,14,24,9,78,4,0,4,0,119,17.0,2,0.0,10,9,71,4,14,0,7,4,0,94,25,1
19676,182622,99qhCmy07rsquumjTFRELTtrLHpQpj07,SpATywNh6bZuzm8s1ceuBUnMUAeoAHHw,9,9,4,0,3,0,1,0,17,2.4285714285714284,1,0.0,0,4,0,3,9,0,0,1,0,7,10,1
19677,182625,pmyN5Lpd7zPzDMrdwaddb9OujjdVFpIA,G8EPVSXsOYB5YQWZGiz1aVq5Pgr2GrQu,1,0,0,0,0,0,1,0,1,0.14285714285714285,1,0.0,0,0,0,0,0,0,0,1,0,0,1,1
19678,182631,jvMxvmnfDR2nX2SDb9U9vK3bZQo5n6aS,SpATywNh6bZuzm8s1ceuBUnMUAeoAHHw,8,4,2,0,2,0,2,0,10,1.4285714285714286,1,0.0,0,2,0,2,4,0,0,2,0,4,6,1
19679,182632,JDFQZtkjaBhYZM0MLFNIDJC3MmDM3j4N,G8EPVSXsOYB5YQWZGiz1aVq5Pgr2GrQu,1,0,0,0,0,0,1,0,1,0.14285714285714285,1,0.0,0,0,0,0,0,0,0,1,0,0,1,1
19680,182635,xQkXRLMidDA6kOSlXJCwzS4szskglPiE,SpATywNh6bZuzm8s1ceuBUnMUAeoAHHw,8,2,2,0,2,0,6,0,12,1.7142857142857142,1,0.0,0,2,0,2,2,0,0,6,0,4,8,1
19681,182642,1KbKxaDkaJs93myqaKszRgBW1gxYyrTr,SpATywNh6bZuzm8s1ceuBUnMUAeoAHHw,7,3,2,0,2,0,2,0,9,1.2857142857142858,1,0.0,0,2,0,2,3,0,0,2,0,4,5,1
19682,182652,OvE6fswKcyt8W4X23yrGAT3owgNKqghE,SpATywNh6bZuzm8s1ceuBUnMUAeoAHHw,5,2,1,0,1,1,2,0,7,1.0,1,0.0,0,1,0,1,2,1,0,2,0,2,5,1
19683,182653,kNUYVfCCGHx63xQDhqVhj2cbZ7iw47SV,SpATywNh6bZuzm8s1ceuBUnMUAeoAHHw,15,18,11,12,5,10,8,0,64,9.142857142857142,1,0.0,2,11,12,5,16,10,0,8,0,30,34,1
19684,182656,3jm0outqyG6Dt6oUYnLDUhzCWjwa7f0d,SpATywNh6bZuzm8s1ceuBUnMUAeoAHHw,5,3,1,0,1,0,2,0,7,1.0,1,0.0,0,1,0,1,3,0,0,2,0,2,5,1
19685,182657,NgSAymzGStRSHltSswQtmpS99cSj4EzE,SpATywNh6bZuzm8s1ceuBUnMUAeoAHHw,14,23,8,20,5,2,4,0,62,8.857142857142858,1,0.0,12,8,17,5,11,2,3,4,0,42,20,1
19686,182659,42WJ8lF0jtc8jUDcyiUTsDeA2HGhhgcv,SpATywNh6bZuzm8s1ceuBUnMUAeoAHHw,5,2,1,0,1,0,3,0,7,1.0,1,0.0,0,1,0,1,2,0,0,3,0,2,5,1
19687,182676,Tqsu4RE8c8PTxIWjwbo0acp1R4rHJLQK,G8EPVSXsOYB5YQWZGiz1aVq5Pgr2GrQu,1,0,0,0,0,0,1,0,1,0.14285714285714285,1,0.0,0,0,0,0,0,0,0,1,0,0,1,1
19688,182681,wIYlooJ3PkONzNoU7I0nxWGWuqjalYcP,SpATywNh6bZuzm8s1ceuBUnMUAeoAHHw,7,5,0,0,0,0,2,0,7,1.0,1,0.0,0,0,0,0,5,0,0,2,0,0,7,1
19689,182683,PmtrviA6hBub1PH85YXqVyZgghNsuc4g,bWdj2GDclj5ofokWjzoa5jAwMkxCykd6,5,6,2,0,1,0,3,0,12,1.7142857142857142,1,0.0,0,2,0,1,6,0,0,3,0,3,9,0
19690,182684,u1buUEFv61yp0wROjZxTLttJ3M1La8iE,bWdj2GDclj5ofokWjzoa5jAwMkxCykd6,5,2,1,0,1,0,2,0,6,0.8571428571428571,1,0.0,0,1,0,1,2,0,0,2,0,2,4,1
19691,182691,PhL2ZyLw1V28vd4DfOVSi8FZIcPFQkVx,RXDvfPUBYFlVdlueBFbLW0mhhAyGEqpt,9,9,0,15,0,0,1,0,25,3.5714285714285716,1,0.0,1,0,14,0,8,0,1,1,0,15,10,1
19692,182692,Dtr7OzFhzoVvzJKeK0urGyJsIrB0TIJH,bWdj2GDclj5ofokWjzoa5jAwMkxCykd6,4,2,0,0,0,0,3,0,5,0.7142857142857143,1,0.0,0,0,0,0,2,0,0,3,0,0,5,1
19693,182700,bpGrzhHHu1EmIR8DPqrwGOVi55Jq7xh3,SpATywNh6bZuzm8s1ceuBUnMUAeoAHHw,1,0,0,0,0,0,1,0,1,0.14285714285714285,1,0.0,0,0,0,0,0,0,0,1,0,0,1,1
19694,182707,vCFSDawXLqrnXpNrVBnTFno2SpXSvGWp,SpATywNh6bZuzm8s1ceuBUnMUAeoAHHw,9,4,3,0,3,0,2,0,12,1.7142857142857142,1,0.0,0,3,0,3,4,0,0,2,0,6,6,1
19695,182709,RGPmxfpZ3Hotrw69jr331xicKNruhw9Y,SpATywNh6bZuzm8s1ceuBUnMUAeoAHHw,9,11,0,1,0,0,3,0,15,2.142857142857143,1,0.0,1,0,1,0,10,0,0,3,0,2,13,1
19696,182713,CZTcq7wzEt9ONvni7ZzjQbcLcDeC1DZ4,SpATywNh6bZuzm8s1ceuBUnMUAeoAHHw,1,0,0,0,0,0,1,0,1,0.14285714285714285,1,0.0,0,0,0,0,0,0,0,1,0,0,1,1
19697,182715,l70wRZ2DS0s6LjbT7C4gRoGrF27x9p2H,RXDvfPUBYFlVdlueBFbLW0mhhAyGEqpt,3,2,0,0,0,0,1,0,3,0.42857142857142855,1,0.0,0,0,0,0,2,0,0,1,0,0,3,1
19698,182719,E2SmOalca4Mn2HYnea1ltBRrUmhkEunr,RXDvfPUBYFlVdlueBFbLW0mhhAyGEqpt,2,0,0,0,0,0,2,0,2,0.2857142857142857,1,0.0,0,0,0,0,0,0,0,2,0,0,2,1
19699,182728,YyGH9YI1z47bsz19P5wTavf6fegO5GlF,SpATywNh6bZuzm8s1ceuBUnMUAeoAHHw,7,8,4,0,3,0,1,0,16,2.2857142857142856,1,0.0,3,4,0,3,5,0,0,1,0,10,6,1
19700,182729,AdlQluSNsa5qamKMPw9WD0mzbeMDsH2H,SpATywNh6bZuzm8s1ceuBUnMUAeoAHHw,4,4,0,0,0,0,4,0,8,1.1428571428571428,1,0.0,2,0,0,0,2,0,0,4,0,2,6,1
19701,182732,58s2cb7fdRQwJqQoDBtdpi70NOxjg3qZ,SpATywNh6bZuzm8s1ceuBUnMUAeoAHHw,4,2,1,0,1,0,1,0,5,0.7142857142857143,1,0.0,0,1,0,1,2,0,0,1,0,2,3,1
19702,182733,sTHTvkTsGG8vLnHKJRukF2jRzSiTp03D,SpATywNh6bZuzm8s1ceuBUnMUAeoAHHw,5,0,0,0,0,1,5,1,7,1.0,1,0.0,0,0,0,0,0,1,0,5,1,0,7,1
19703,182734,4CoRulGyQ4icBbm2v9jyxX1ENJFCtIe4,SpATywNh6bZuzm8s1ceuBUnMUAeoAHHw,15,20,11,27,7,15,5,0,85,12.142857142857142,1,0.0,8,11,21,7,12,15,6,5,0,47,38,1
19704,182737,m2BGUVswXHBZPtMgyVgsV42eoIMpIlIe,SpATywNh6bZuzm8s1ceuBUnMUAeoAHHw,4,0,0,0,0,0,4,0,4,0.5714285714285714,1,0.0,0,0,0,0,0,0,0,4,0,0,4,1
19705,182740,mSs5bB1Rxg3xYWjWjJY9pVTt7WAiMgyu,bWdj2GDclj5ofokWjzoa5jAwMkxCykd6,1,0,0,0,0,0,2,0,2,0.2857142857142857,1,0.0,0,0,0,0,0,0,0,2,0,0,2,1
19706,182741,TDJgAusC4tcAuKVU8oHZGKrqhY6Lp4X4,SpATywNh6bZuzm8s1ceuBUnMUAeoAHHw,9,10,1,25,0,0,1,0,37,5.285714285714286,1,0.0,4,1,20,0,6,0,5,1,0,25,12,1
19707,182747,y8tduZmgWrgzcw2L4zthOZlXWzNlHnmJ,SpATywNh6bZuzm8s1ceuBUnMUAeoAHHw,5,2,1,0,1,0,2,0,6,0.8571428571428571,1,0.0,0,1,0,1,2,0,0,2,0,2,4,1
19708,182748,qBpMFzKW2718794c3zfgwmEpIQp9kP8K,SpATywNh6bZuzm8s1ceuBUnMUAeoAHHw,1,0,0,0,0,0,1,0,1,0.14285714285714285,1,0.0,0,0,0,0,0,0,0,1,0,0,1,1
19709,182758,2HbabEHSEnqM0bBaiJs30PG9549v5yOk,bWdj2GDclj5ofokWjzoa5jAwMkxCykd6,6,7,4,0,2,10,5,0,28,4.0,1,0.0,0,4,0,2,7,10,0,5,0,6,22,1
19710,182767,sNbJ7pzaVnDxlASTW0niTKovpFXjQSy0,SpATywNh6bZuzm8s1ceuBUnMUAeoAHHw,5,5,3,0,1,3,2,0,14,2.0,1,0.0,0,3,0,1,5,3,0,2,0,4,10,1
19711,182770,VyinneBSnu52o8UNYSCuv49XXxRYrO53,bWdj2GDclj5ofokWjzoa5jAwMkxCykd6,1,0,0,0,0,0,2,0,2,0.2857142857142857,1,0.0,0,0,0,0,0,0,0,2,0,0,2,1
19712,182774,TzCu0qgQvcoK9kO9NBGEPpkuqzoJ6woq,RXDvfPUBYFlVdlueBFbLW0mhhAyGEqpt,20,15,11,28,4,8,4,0,70,10.0,2,0.0,2,11,26,4,13,8,2,4,0,43,27,1
19713,182780,yMIQHZsn323wNw1rKC7KVgV21MZHgiuz,bWdj2GDclj5ofokWjzoa5jAwMkxCykd6,2,0,0,0,0,0,2,0,2,0.2857142857142857,1,0.0,0,0,0,0,0,0,0,2,0,0,2,1
19714,182782,9tOn7goHN9N7J9eojiuTfPcShVM7kNFp,SpATywNh6bZuzm8s1ceuBUnMUAeoAHHw,5,9,1,0,1,0,1,0,12,1.7142857142857142,1,0.0,0,1,0,1,9,0,0,1,0,2,10,1
19715,182784,VWOXBW9EkYxZ0T2dOO4SxzMKxSN8bgNI,G8EPVSXsOYB5YQWZGiz1aVq5Pgr2GrQu,12,11,3,0,3,6,23,1,47,6.714285714285714,1,0.0,2,3,0,3,9,6,0,23,1,8,39,0
19716,182798,IkIRLi9Hmy3B5WcPYXBnOiu1cJErCZKt,RXDvfPUBYFlVdlueBFbLW0mhhAyGEqpt,8,7,0,13,2,0,5,0,27,3.857142857142857,1,0.0,6,0,10,2,1,0,3,5,0,18,9,1
19717,182808,kCXzR6ce1eaurKGud1Yjcq6ND5eQQb6c,G8EPVSXsOYB5YQWZGiz1aVq5Pgr2GrQu,19,25,13,60,5,3,10,2,118,16.857142857142858,1,0.0,8,13,53,5,17,3,7,10,2,79,39,1
19718,182810,kqM4LD5JOLaYmtsmvPLTUDaTCfv2YPdG,SpATywNh6bZuzm8s1ceuBUnMUAeoAHHw,1,0,0,0,0,0,1,0,1,0.14285714285714285,1,0.0,0,0,0,0,0,0,0,1,0,0,1,1
19719,182813,mSXZKJ9e3RCTXopgrFUphpxYgeKp7tlG,G8EPVSXsOYB5YQWZGiz1aVq5Pgr2GrQu,11,16,7,0,4,7,2,0,36,5.142857142857143,1,0.0,7,7,0,4,9,7,0,2,0,18,18,1
19720,182814,jhJWgDURvdBA1kmFGY4Ezste38F8s208,SpATywNh6bZuzm8s1ceuBUnMUAeoAHHw,6,2,0,0,0,4,6,1,13,1.8571428571428572,1,0.0,0,0,0,0,2,4,0,6,1,0,13,1
19721,182819,p7Mr6Ok0a4vcUFYBslKXHXBRGQMy3QGf,G8EPVSXsOYB5YQWZGiz1aVq5Pgr2GrQu,5,2,0,0,0,0,3,0,5,0.7142857142857143,1,0.0,0,0,0,0,2,0,0,3,0,0,5,1
19722,182820,o3hN6q5KODtoiHqaRQtCHeenQfWWwJmZ,bWdj2GDclj5ofokWjzoa5jAwMkxCykd6,8,3,1,0,1,3,6,1,15,2.142857142857143,1,0.0,1,1,0,1,2,3,0,6,1,3,12,1
19723,182823,YkXExE2iZQg9FZbuDDBEUmC7J16BAywt,SpATywNh6bZuzm8s1ceuBUnMUAeoAHHw,7,3,2,0,2,0,2,0,9,1.2857142857142858,1,0.0,0,2,0,2,3,0,0,2,0,4,5,1
19724,182824,HguVwcZaqEwGXJzY3HP39fA7Ctl2ESJX,SpATywNh6bZuzm8s1ceuBUnMUAeoAHHw,3,0,0,0,0,0,3,0,3,0.42857142857142855,1,0.0,0,0,0,0,0,0,0,3,0,0,3,1
19725,182825,akObaqJGuxjG1OPwZ5IUA6gd9nOx4oJA,SpATywNh6bZuzm8s1ceuBUnMUAeoAHHw,6,3,2,0,2,0,1,0,8,1.1428571428571428,1,0.0,0,2,0,2,3,0,0,1,0,4,4,1
19726,182834,9MvSiFhTOIXzdJdkvHVmHtDUCykt8hMb,RXDvfPUBYFlVdlueBFbLW0mhhAyGEqpt,1,0,0,0,0,0,1,0,1,0.14285714285714285,1,0.0,0,0,0,0,0,0,0,1,0,0,1,1
19727,182835,RkK6wAnzc2qyntdfmCfNZV178HOs8z1G,SpATywNh6bZuzm8s1ceuBUnMUAeoAHHw,7,3,2,0,2,0,2,0,9,1.2857142857142858,1,0.0,0,2,0,2,3,0,0,2,0,4,5,1
19728,182836,vIwO29pFDuU0ivIbuEkS0ajYobih9mJy,SpATywNh6bZuzm8s1ceuBUnMUAeoAHHw,1,0,0,0,0,0,1,0,1,0.14285714285714285,1,0.0,0,0,0,0,0,0,0,1,0,0,1,1
19729,182839,1i94xoT1OVM1lTP3R294JlD5odSrEcP5,G8EPVSXsOYB5YQWZGiz1aVq5Pgr2GrQu,4,8,0,0,1,0,1,0,10,1.4285714285714286,1,0.0,3,0,0,1,5,0,0,1,0,4,6,1
19730,182850,Klt9qoufCaIWdba44x7MkMWwmjaj9rrO,SpATywNh6bZuzm8s1ceuBUnMUAeoAHHw,7,3,2,0,2,0,2,0,9,1.2857142857142858,1,0.0,0,2,0,2,3,0,0,2,0,4,5,1
19731,182854,JO39AO6t7PlfqwBybyNaLNHxe7KK1KKl,SpATywNh6bZuzm8s1ceuBUnMUAeoAHHw,5,2,1,0,1,0,2,0,6,0.8571428571428571,1,0.0,0,1,0,1,2,0,0,2,0,2,4,1
19732,182855,NaGWxZf58IyW9QoVHeBvFF43QTruA6pk,G8EPVSXsOYB5YQWZGiz1aVq5Pgr2GrQu,5,3,1,0,1,0,1,0,6,0.8571428571428571,1,0.0,0,1,0,1,3,0,0,1,0,2,4,1
19733,182863,HXHzL7PqrUL6ax4VV0BL6WUNfIFy8UXd,bWdj2GDclj5ofokWjzoa5jAwMkxCykd6,5,2,1,0,1,0,2,0,6,0.8571428571428571,1,0.0,0,1,0,1,2,0,0,2,0,2,4,1
19734,182874,wfWgaSJojVTsOWnu0Zw38TJ4gTxVsstc,SpATywNh6bZuzm8s1ceuBUnMUAeoAHHw,10,8,5,0,3,0,2,0,18,2.5714285714285716,1,0.0,0,5,0,3,8,0,0,2,0,8,10,1
19735,182875,PdvjXH7022Nj56iHc15p9NRzsFaRES9J,SpATywNh6bZuzm8s1ceuBUnMUAeoAHHw,6,7,2,0,0,0,3,0,12,1.7142857142857142,1,0.0,0,2,0,0,7,0,0,3,0,2,10,1
19736,182886,zcNroqWUiRIsPxABKRrWkwPAId27OxZy,SpATywNh6bZuzm8s1ceuBUnMUAeoAHHw,1,0,0,0,0,0,1,0,1,0.14285714285714285,1,0.0,0,0,0,0,0,0,0,1,0,0,1,1
19737,182891,fdJXQSSucuzaRljy096jXgInnW2TakHQ,G8EPVSXsOYB5YQWZGiz1aVq5Pgr2GrQu,1,0,0,0,0,0,1,0,1,0.14285714285714285,1,0.0,0,0,0,0,0,0,0,1,0,0,1,1
19738,182894,Wm4d7ifDaTgcR0GfUqwJt5OZKbYglRCq,RXDvfPUBYFlVdlueBFbLW0mhhAyGEqpt,1,0,0,0,0,0,1,0,1,0.14285714285714285,1,0.0,0,0,0,0,0,0,0,1,0,0,1,1
19739,182899,LgLijvJ6nDDZDXZheZk4D1S1H0ok87z5,SpATywNh6bZuzm8s1ceuBUnMUAeoAHHw,10,7,5,0,4,0,3,0,19,2.7142857142857144,1,0.0,0,5,0,4,7,0,0,3,0,9,10,1
19740,182900,CqHYUR2wxaYgHzOmefYHdYFAqnjgWzGT,G8EPVSXsOYB5YQWZGiz1aVq5Pgr2GrQu,9,4,1,0,2,1,9,1,18,2.5714285714285716,1,0.0,2,1,0,2,2,1,0,9,1,5,13,1
19741,182906,DYhVLGAPWOAx4wB3gzSHS1w7MxX73feL,RXDvfPUBYFlVdlueBFbLW0mhhAyGEqpt,5,4,1,0,1,0,2,0,8,1.1428571428571428,1,0.0,0,1,0,1,4,0,0,2,0,2,6,1
19742,182912,effsEtqrwknjHEr0npnCFm7KOzCTSt0r,SpATywNh6bZuzm8s1ceuBUnMUAeoAHHw,7,2,1,0,1,0,4,1,9,1.2857142857142858,1,0.0,0,1,0,1,2,0,0,4,1,2,7,0
19743,182916,QBj5ZW5uQiE9SstQccaFKwhAjo1qH9Dk,RXDvfPUBYFlVdlueBFbLW0mhhAyGEqpt,1,0,0,0,0,0,1,0,1,0.14285714285714285,1,0.0,0,0,0,0,0,0,0,1,0,0,1,1
19744,182917,HidChEYUkwCd57tLyDRaYOVeEhFDQ3Gw,bWdj2GDclj5ofokWjzoa5jAwMkxCykd6,5,8,0,53,2,0,1,0,64,9.142857142857142,1,0.0,5,0,52,2,3,0,1,1,0,59,5,1
19745,182918,7kTFcvgxY9P1Hkw99pjiwbkFh98nJXIE,RXDvfPUBYFlVdlueBFbLW0mhhAyGEqpt,6,5,4,0,2,0,1,0,12,1.7142857142857142,1,0.0,0,4,0,2,5,0,0,1,0,6,6,1
19746,182920,Dtrw7jIOc6N9cJtQZ4pVW9s2qBJPFTTc,SpATywNh6bZuzm8s1ceuBUnMUAeoAHHw,7,2,1,0,1,1,4,1,10,1.4285714285714286,1,0.0,0,1,0,1,2,1,0,4,1,2,8,1
19747,182922,TulvnxhxqY9XFV1SbRR2w0EFWo4ahEEO,SpATywNh6bZuzm8s1ceuBUnMUAeoAHHw,10,27,8,0,0,1,21,3,60,8.571428571428571,2,0.0,19,8,0,0,8,1,0,21,3,27,33,1
19748,182924,eCJN0zxGlTEvXWXpm18IFLjiZf0BGvPo,SpATywNh6bZuzm8s1ceuBUnMUAeoAHHw,9,7,4,0,3,0,5,0,19,2.7142857142857144,2,0.0,1,4,0,3,6,0,0,5,0,8,11,1
19749,182925,VU8zmf7Owaz6sNWcWKLdrCl3ZTLYDEQY,SpATywNh6bZuzm8s1ceuBUnMUAeoAHHw,1,0,0,0,0,0,1,0,1,0.14285714285714285,1,0.0,0,0,0,0,0,0,0,1,0,0,1,1
19750,182931,jtsbnKKZ9XPpwCclPqSDCMPCyLbC3Ksj,SpATywNh6bZuzm8s1ceuBUnMUAeoAHHw,12,36,0,13,0,72,11,4,136,19.428571428571427,1,0.0,24,0,11,0,12,72,2,11,4,35,101,0
19751,182940,FIgFPRNDKi4WgyVVOEDupBUIDsQ9EQjV,bWdj2GDclj5ofokWjzoa5jAwMkxCykd6,6,3,2,0,2,0,1,0,8,1.1428571428571428,1,0.0,0,2,0,2,3,0,0,1,0,4,4,1
19752,182941,rwSODbQgRDu2S1bK7vXZWKLJHo1nYnGp,RXDvfPUBYFlVdlueBFbLW0mhhAyGEqpt,5,2,1,0,1,0,3,0,7,1.0,1,0.0,0,1,0,1,2,0,0,3,0,2,5,1
19753,182946,vxHy8fVeIc8PK6sLXnCDyEMZZSM3Rj0M,RXDvfPUBYFlVdlueBFbLW0mhhAyGEqpt,10,9,1,0,1,0,3,0,14,2.0,2,0.0,0,1,0,1,9,0,0,3,0,2,12,1
19754,182948,vag4ySgp6Xv9LLImwgHsnSu0uSrwUg8z,SpATywNh6bZuzm8s1ceuBUnMUAeoAHHw,7,5,1,0,1,0,4,0,11,1.5714285714285714,1,0.0,0,1,0,1,5,0,0,4,0,2,9,1
19755,182949,ffGclPAQxsNqhgZk4UCZvcIXCepIlinY,SpATywNh6bZuzm8s1ceuBUnMUAeoAHHw,4,2,0,0,0,0,4,0,6,0.8571428571428571,1,0.0,0,0,0,0,2,0,0,4,0,0,6,1
19756,182952,IBE9FtQ9x1E7k3ZNC16nikEg5d3E4b8O,bWdj2GDclj5ofokWjzoa5jAwMkxCykd6,14,25,0,51,2,10,11,4,103,14.714285714285714,1,0.0,17,0,48,2,8,10,3,11,4,67,36,1
19757,182954,c6Fui1ajX2dPIYhG2OvpvJJxojMFsXjs,SpATywNh6bZuzm8s1ceuBUnMUAeoAHHw,3,2,0,0,0,0,2,0,4,0.5714285714285714,1,0.0,0,0,0,0,2,0,0,2,0,0,4,1
19758,182968,XARPe6DPXR8KDgKnXuqN5NP0VHFMzwUO,SpATywNh6bZuzm8s1ceuBUnMUAeoAHHw,6,1,1,0,1,0,3,0,6,0.8571428571428571,1,0.0,0,1,0,1,1,0,0,3,0,2,4,1
19759,182984,2hadEUwp57oaCSemFWbiVdojDARXylA4,SpATywNh6bZuzm8s1ceuBUnMUAeoAHHw,16,25,6,6,4,6,5,2,54,7.714285714285714,1,0.0,18,6,6,4,7,6,0,5,2,34,20,1
19760,182985,EHr9i7DrAmLY9IIcFmxYuvipqCAk2sM7,SpATywNh6bZuzm8s1ceuBUnMUAeoAHHw,1,0,0,0,0,0,1,0,1,0.14285714285714285,1,0.0,0,0,0,0,0,0,0,1,0,0,1,1
19761,182987,CflmnNLx1El6KrTaSWqI7nU1TsN8LeKr,G8EPVSXsOYB5YQWZGiz1aVq5Pgr2GrQu,5,2,1,0,1,0,2,0,6,0.8571428571428571,1,0.0,0,1,0,1,2,0,0,2,0,2,4,1
19762,182993,ZxyDDY406MYSLk3FLUMvDHc7n6my0jWC,bWdj2GDclj5ofokWjzoa5jAwMkxCykd6,10,4,2,0,1,21,14,4,46,6.571428571428571,1,0.0,0,2,0,1,4,21,0,14,4,3,43,1
19763,183001,bG2jmidl1bDsU5kwFldO2hSfMzLKGTZ3,SpATywNh6bZuzm8s1ceuBUnMUAeoAHHw,1,0,0,0,0,0,1,0,1,0.14285714285714285,1,0.0,0,0,0,0,0,0,0,1,0,0,1,1
19764,183002,qeZsVtb8AWeyVhfs2hYQ0ujp2PobwrVT,RXDvfPUBYFlVdlueBFbLW0mhhAyGEqpt,6,3,0,0,0,0,4,0,7,1.0,1,0.0,0,0,0,0,3,0,0,4,0,0,7,1
19765,183004,hzI7F4aEa5EKvJiM87cs2lRhWvluO07x,SpATywNh6bZuzm8s1ceuBUnMUAeoAHHw,18,28,13,9,4,2,18,4,78,11.142857142857142,2,0.0,8,13,8,4,20,2,1,18,4,33,45,0
19766,183007,bXjfWJe04qOx78zkMNdSaPRQzOnTNGYL,SpATywNh6bZuzm8s1ceuBUnMUAeoAHHw,4,3,1,0,1,0,1,0,6,0.8571428571428571,1,0.0,0,1,0,1,3,0,0,1,0,2,4,1
19767,183009,hPhWVQjBXU898finCJGmzk0KCmEwCOvP,SpATywNh6bZuzm8s1ceuBUnMUAeoAHHw,1,0,0,0,0,0,1,0,1,0.14285714285714285,1,0.0,0,0,0,0,0,0,0,1,0,0,1,1
19768,183010,5PoE3YvA0iZFEwystRRucVmekQOUvlOx,RXDvfPUBYFlVdlueBFbLW0mhhAyGEqpt,1,0,0,0,0,0,2,0,2,0.2857142857142857,1,0.0,0,0,0,0,0,0,0,2,0,0,2,1
19769,183016,GQxqlKBuTHN1s8soumNB9QXxdu6crGoG,bWdj2GDclj5ofokWjzoa5jAwMkxCykd6,3,1,0,0,0,0,3,0,4,0.5714285714285714,1,0.0,0,0,0,0,1,0,0,3,0,0,4,1
19770,183024,Yb5pEK7VjcxeVZ9fUeqOSZHX1vLfJthY,SpATywNh6bZuzm8s1ceuBUnMUAeoAHHw,9,4,2,0,1,1,9,1,18,2.5714285714285716,1,0.0,0,2,0,1,4,1,0,9,1,3,15,1
19771,183026,rVKS9MvAzj9bHO6qj6FhT80Vyfah5rgx,RXDvfPUBYFlVdlueBFbLW0mhhAyGEqpt,2,0,0,0,0,0,3,0,3,0.42857142857142855,1,0.0,0,0,0,0,0,0,0,3,0,0,3,1
19772,183033,5RiaRbVAffy243QN8cvvydK7FTo8Ge7y,SpATywNh6bZuzm8s1ceuBUnMUAeoAHHw,6,3,2,0,2,0,1,0,8,1.1428571428571428,1,0.0,0,2,0,2,3,0,0,1,0,4,4,1
19773,183038,AvefIGzCaOx0Wgqe3dv7u8LN0NNvyUzu,RXDvfPUBYFlVdlueBFbLW0mhhAyGEqpt,11,3,2,12,2,0,5,0,24,3.4285714285714284,2,0.0,1,2,11,2,2,0,1,5,0,16,8,1
19774,183040,PybrMIHJW5iPpVWCSYrCV4jYePWbXmcH,SpATywNh6bZuzm8s1ceuBUnMUAeoAHHw,4,2,0,0,0,1,4,1,8,1.1428571428571428,1,0.0,0,0,0,0,2,1,0,4,1,0,8,1
19775,183041,b07lyeDRIGTDb23WDQrqmxKnx7uJ6kqa,RXDvfPUBYFlVdlueBFbLW0mhhAyGEqpt,6,2,0,0,0,0,5,2,9,1.2857142857142858,1,0.0,0,0,0,0,2,0,0,5,2,0,9,1
19776,183042,43XnUoAZbDkvxCOgOY8IuFHvhpNa62ol,SpATywNh6bZuzm8s1ceuBUnMUAeoAHHw,1,0,0,0,0,0,1,0,1,0.14285714285714285,1,0.0,0,0,0,0,0,0,0,1,0,0,1,1
19777,183048,oeQ1nHqbsofIU4Gddro5UkGg44HCxqO8,SpATywNh6bZuzm8s1ceuBUnMUAeoAHHw,8,9,3,0,2,0,2,0,16,2.2857142857142856,1,0.0,1,3,0,2,8,0,0,2,0,6,10,1
19778,183050,aBjPpLZjZVQXphzIZ2ZdW0Gy5cspTPuz,SpATywNh6bZuzm8s1ceuBUnMUAeoAHHw,8,3,1,0,1,0,4,2,11,1.5714285714285714,1,0.0,0,1,0,1,3,0,0,4,2,2,9,1
19779,183056,h6N9SyV6dQj6If7QxGp31IQ94XXyWUIO,bWdj2GDclj5ofokWjzoa5jAwMkxCykd6,4,2,1,0,1,0,2,0,6,0.8571428571428571,1,0.0,0,1,0,1,2,0,0,2,0,2,4,0
19780,183059,6xyaVeSZsCu6Nqe5h1ruYj89xweZsGkX,SpATywNh6bZuzm8s1ceuBUnMUAeoAHHw,8,2,1,0,1,0,10,1,15,2.142857142857143,1,0.0,0,1,0,1,2,0,0,10,1,2,13,1
19781,183066,Oq9Z1hsv3NeEDP3Q4F964BpI3HU1uf4u,RXDvfPUBYFlVdlueBFbLW0mhhAyGEqpt,41,87,26,104,14,19,3,0,253,36.142857142857146,1,0.0,28,26,97,14,59,19,7,3,0,165,88,1
19782,183075,8SwolTrUbLeQIryGNwnSraj6AIJcPhi1,RXDvfPUBYFlVdlueBFbLW0mhhAyGEqpt,8,3,2,0,0,1,6,2,14,2.0,1,0.0,0,2,0,0,3,1,0,6,2,2,12,1
19783,183076,kE46GjSqE5uiUhF9LbgXs97FJQSvErKB,SpATywNh6bZuzm8s1ceuBUnMUAeoAHHw,18,14,9,8,5,2,9,1,48,6.857142857142857,3,0.0,2,9,8,5,12,2,0,9,1,24,24,0
19784,183079,UZQMHBD59LcFUBlLzTajpfngFoDhvuqd,bWdj2GDclj5ofokWjzoa5jAwMkxCykd6,2,0,0,0,0,0,2,0,2,0.2857142857142857,1,0.0,0,0,0,0,0,0,0,2,0,0,2,0
19785,183082,IKXwL3bDtlAxjRP4WWhZczJlcbIhG3ib,bWdj2GDclj5ofokWjzoa5jAwMkxCykd6,5,2,1,0,1,0,3,0,7,1.0,1,0.0,0,1,0,1,2,0,0,3,0,2,5,1
19786,183083,EbfkLutG3Wlnfk5dlvXr0Vcdn1M25FU9,bWdj2GDclj5ofokWjzoa5jAwMkxCykd6,13,21,11,0,7,15,10,1,65,9.285714285714286,2,0.0,4,11,0,7,17,15,0,10,1,22,43,1
19787,183092,xrcBYo5W41za7iW83F0KEtd3oYoFiOrz,SpATywNh6bZuzm8s1ceuBUnMUAeoAHHw,6,3,2,0,2,0,2,0,9,1.2857142857142858,1,0.0,0,2,0,2,3,0,0,2,0,4,5,1
19788,183094,LielUY2CViAshyTPFVeBFjcM9c8YHKw6,SpATywNh6bZuzm8s1ceuBUnMUAeoAHHw,4,2,0,0,0,0,2,0,4,0.5714285714285714,1,0.0,0,0,0,0,2,0,0,2,0,0,4,1
19789,183098,iYmkUVGHT7OvfSsIIRGv9c31sCISp6uV,bWdj2GDclj5ofokWjzoa5jAwMkxCykd6,3,2,0,0,0,0,2,0,4,0.5714285714285714,2,0.0,0,0,0,0,2,0,0,2,0,0,4,1
19790,183100,zgTz7w4MQKVAfOVf6tj5uMnkGGy77PYu,SpATywNh6bZuzm8s1ceuBUnMUAeoAHHw,8,3,1,0,1,1,4,1,11,1.5714285714285714,1,0.0,0,1,0,1,3,1,0,4,1,2,9,1
19791,183105,HTGHrKrt9bt2no7NEjeTqA36pNapNLke,bWdj2GDclj5ofokWjzoa5jAwMkxCykd6,1,0,0,0,0,0,1,0,1,0.14285714285714285,1,0.0,0,0,0,0,0,0,0,1,0,0,1,1
19792,183106,5UgB7WrC5inA92uoZPywCX6RsZIYfbPF,SpATywNh6bZuzm8s1ceuBUnMUAeoAHHw,7,5,2,0,2,6,4,0,19,2.7142857142857144,1,0.0,0,2,0,2,5,6,0,4,0,4,15,1
19793,183110,53fG4qjpoEeWdWNP9xPO2S2BFstrPjGH,RXDvfPUBYFlVdlueBFbLW0mhhAyGEqpt,9,5,0,0,0,1,10,11,27,3.857142857142857,2,0.0,0,0,0,0,5,1,0,10,11,0,27,1
19794,183113,PHVZqegG7Zevy6zLiqsCasCOZvoRRNNg,SpATywNh6bZuzm8s1ceuBUnMUAeoAHHw,7,5,4,0,3,0,2,0,14,2.0,1,0.0,0,4,0,3,5,0,0,2,0,7,7,1
19795,183114,g1dFQ3mnVnBiIhnsU4zqK21biH9l5lF9,bWdj2GDclj5ofokWjzoa5jAwMkxCykd6,8,5,1,0,1,0,4,1,12,1.7142857142857142,1,0.0,0,1,0,1,5,0,0,4,1,2,10,1
19796,183117,WDD9a1qNUJX21r5OnYzYbe9snqA1PiYA,G8EPVSXsOYB5YQWZGiz1aVq5Pgr2GrQu,10,7,4,0,3,0,3,0,17,2.4285714285714284,1,0.0,1,4,0,3,6,0,0,3,0,8,9,1
19797,183118,Xebl2a1reCTgb3CZmsapTzbcj94w3H8B,SpATywNh6bZuzm8s1ceuBUnMUAeoAHHw,1,0,0,0,0,0,2,0,2,0.2857142857142857,1,0.0,0,0,0,0,0,0,0,2,0,0,2,1
19798,183125,juPgseiv6fz8BUaq09A165VVR6UHjpbU,SpATywNh6bZuzm8s1ceuBUnMUAeoAHHw,5,2,1,0,1,1,2,1,8,1.1428571428571428,1,0.0,0,1,0,1,2,1,0,2,1,2,6,1
19799,183127,Hm8PhmgumYGSpnWdU16xXCEPyBtXct0m,G8EPVSXsOYB5YQWZGiz1aVq5Pgr2GrQu,6,3,0,0,0,0,3,0,6,0.8571428571428571,1,0.0,0,0,0,0,3,0,0,3,0,0,6,1
19800,183128,JChnJwlkYSD6G5rkj5DhsEWsQiOBTkEx,G8EPVSXsOYB5YQWZGiz1aVq5Pgr2GrQu,8,2,1,0,1,1,6,1,12,1.7142857142857142,1,0.0,0,1,0,1,2,1,0,6,1,2,10,1
19801,183135,TVBdP57RgHmXdzDOQxhhxrruZniECnNa,G8EPVSXsOYB5YQWZGiz1aVq5Pgr2GrQu,10,5,3,0,2,3,11,1,25,3.5714285714285716,2,0.0,0,3,0,2,5,3,0,11,1,5,20,0
19802,183136,Wh6uG1HOxpwP3HtqSjbX0A0Sk2Rn3Ci7,SpATywNh6bZuzm8s1ceuBUnMUAeoAHHw,3,0,0,0,0,0,3,0,3,0.42857142857142855,1,0.0,0,0,0,0,0,0,0,3,0,0,3,1
19803,183137,HIa1PFcWZWr32eqQoCfZvVHM2iyl701E,G8EPVSXsOYB5YQWZGiz1aVq5Pgr2GrQu,8,13,4,0,2,1,3,0,23,3.2857142857142856,1,0.0,3,4,0,2,10,1,0,3,0,9,14,1
19804,183142,DZfIhfsDxjKeEsV2YKbtNB2Ii6s7pc9Z,G8EPVSXsOYB5YQWZGiz1aVq5Pgr2GrQu,5,2,1,0,1,0,2,0,6,0.8571428571428571,1,0.0,0,1,0,1,2,0,0,2,0,2,4,1
19805,183145,Jur8wTdD1tDMuHkI3CFyF52Um8NeR9PV,G8EPVSXsOYB5YQWZGiz1aVq5Pgr2GrQu,37,31,8,71,7,0,1,0,118,16.857142857142858,1,0.0,20,8,48,7,11,0,23,1,0,83,35,1
19806,183155,ZjtLHxVaFYGXpjpGEU4pMEKPyHOa2BQR,SpATywNh6bZuzm8s1ceuBUnMUAeoAHHw,4,3,1,0,1,0,1,0,6,0.8571428571428571,1,0.0,0,1,0,1,3,0,0,1,0,2,4,1
19807,183157,uxG0FJsqPkZSNzWDeidAA0UNFfE5AajW,SpATywNh6bZuzm8s1ceuBUnMUAeoAHHw,17,26,11,22,7,17,9,2,94,13.428571428571429,1,0.0,11,11,19,7,15,17,3,9,2,48,46,1
19808,183159,hiXDc0k3aCbg2PlfMmAMtnsGGLI4iZVQ,SpATywNh6bZuzm8s1ceuBUnMUAeoAHHw,1,0,0,0,0,0,1,0,1,0.14285714285714285,1,0.0,0,0,0,0,0,0,0,1,0,0,1,1
19809,183161,giWgdBNdbd331HsBTghzm2Zz7pyTR32i,bWdj2GDclj5ofokWjzoa5jAwMkxCykd6,7,4,1,0,1,10,8,2,26,3.7142857142857144,1,0.0,2,1,0,1,2,10,0,8,2,4,22,1
19810,183162,OKPZyRTenUKO4uf828hjTvwVhuS9Ozxv,SpATywNh6bZuzm8s1ceuBUnMUAeoAHHw,4,2,1,0,1,0,1,0,5,0.7142857142857143,1,0.0,0,1,0,1,2,0,0,1,0,2,3,1
19811,183164,7RSTSE7CX0EZRW2RDRnKS7CJkHtK7gJx,RXDvfPUBYFlVdlueBFbLW0mhhAyGEqpt,6,5,3,0,0,4,2,0,14,2.0,1,0.0,0,3,0,0,5,4,0,2,0,3,11,1
19812,183165,ZsigjPuCWauQ6fedPh3KulNWQfy4Omyd,bWdj2GDclj5ofokWjzoa5jAwMkxCykd6,16,22,9,34,2,5,10,1,83,11.857142857142858,1,0.0,7,9,30,2,15,5,4,10,1,48,35,1
19813,183168,HwQlDqQYrfHrBUx2SSkCNQ3Dej1xgfkf,bWdj2GDclj5ofokWjzoa5jAwMkxCykd6,6,6,0,0,0,4,3,0,13,1.8571428571428572,1,0.0,0,0,0,0,6,4,0,3,0,0,13,1
19814,183172,8UbjMY8dXKhktWVxiVJfz8pElgxOXJnG,G8EPVSXsOYB5YQWZGiz1aVq5Pgr2GrQu,12,20,10,18,6,0,1,0,55,7.857142857142857,1,0.0,8,10,16,6,12,0,2,1,0,40,15,1
19815,183180,hc7DHMNIyA27xd52J4BHXtmpErxPTaQY,SpATywNh6bZuzm8s1ceuBUnMUAeoAHHw,4,2,1,0,1,0,2,0,6,0.8571428571428571,1,0.0,0,1,0,1,2,0,0,2,0,2,4,1
19816,183184,QBUSyyOSif4bY2k2ASnON62QDLzUWAXK,SpATywNh6bZuzm8s1ceuBUnMUAeoAHHw,6,2,1,0,1,1,3,1,9,1.2857142857142858,1,0.0,0,1,0,1,2,1,0,3,1,2,7,1
19817,183188,CUbueK74RGsaWBcRtztdoMN84Z7TxEjm,SpATywNh6bZuzm8s1ceuBUnMUAeoAHHw,1,0,0,0,0,0,1,0,1,0.14285714285714285,1,0.0,0,0,0,0,0,0,0,1,0,0,1,1
19818,183194,Ck862YJ4TKsW5xBb6Obw9gcSWBzSDmoA,bWdj2GDclj5ofokWjzoa5jAwMkxCykd6,2,0,0,0,0,0,2,0,2,0.2857142857142857,1,0.0,0,0,0,0,0,0,0,2,0,0,2,1
19819,183196,MHxssLIOse4kgwRMC6Bd41Ph9QZkPYqP,SpATywNh6bZuzm8s1ceuBUnMUAeoAHHw,12,7,5,0,3,1,3,1,20,2.857142857142857,1,0.0,0,5,0,3,7,1,0,3,1,8,12,1
19820,183198,Bb87wS5DPfEgqeumUQCP2v4mASdjKigL,RXDvfPUBYFlVdlueBFbLW0mhhAyGEqpt,7,2,1,0,1,7,5,2,18,2.5714285714285716,1,0.0,0,1,0,1,2,7,0,5,2,2,16,1
19821,183200,JxLtKAnMek98G5fWpyeTaKlh0zheuNnU,SpATywNh6bZuzm8s1ceuBUnMUAeoAHHw,8,4,2,0,2,0,4,0,12,1.7142857142857142,1,0.0,0,2,0,2,4,0,0,4,0,4,8,0
19822,183209,OO1JwGoh4BUjbVi8UpZSb7D59mBcs3nt,RXDvfPUBYFlVdlueBFbLW0mhhAyGEqpt,7,5,3,0,1,0,2,0,11,1.5714285714285714,1,0.0,0,3,0,1,5,0,0,2,0,4,7,1
19823,183211,oqLAJu8zdqUr5XPQYn4bKVmvqSIRanjc,bWdj2GDclj5ofokWjzoa5jAwMkxCykd6,9,9,1,0,2,8,6,1,27,3.857142857142857,1,0.0,2,1,0,2,7,8,0,6,1,5,22,1
19824,183214,4zGb8KPKuLvneJBtnBUfe0LzhdWsYBWD,G8EPVSXsOYB5YQWZGiz1aVq5Pgr2GrQu,12,4,3,0,3,3,6,1,20,2.857142857142857,1,0.0,0,3,0,3,4,3,0,6,1,6,14,1
19825,183215,AIHzQdi1VPMOsdN6EyZk6CRIyb9n7SRR,SpATywNh6bZuzm8s1ceuBUnMUAeoAHHw,3,1,0,0,0,0,2,0,3,0.42857142857142855,1,0.0,0,0,0,0,1,0,0,2,0,0,3,1
19826,183220,e3UIGG7UQFKXGRFOxu4N5schAIY0VK0V,SpATywNh6bZuzm8s1ceuBUnMUAeoAHHw,9,9,6,0,3,0,1,0,19,2.7142857142857144,1,0.0,2,6,0,3,7,0,0,1,0,11,8,1
19827,183224,tgGXquDTTGvx5MwsNQ6vkm5pQoRrWFlX,SpATywNh6bZuzm8s1ceuBUnMUAeoAHHw,4,2,0,0,0,0,2,0,4,0.5714285714285714,1,0.0,0,0,0,0,2,0,0,2,0,0,4,1
19828,183231,FBOPqv9eeto5z974B2QRTSbPP2n29lzH,SpATywNh6bZuzm8s1ceuBUnMUAeoAHHw,14,10,1,9,1,5,10,1,37,5.285714285714286,1,0.0,1,1,8,1,9,5,1,10,1,11,26,0
19829,183234,u2dRmVeIaLoDMHF5VEceAEEDchUnRMzS,SpATywNh6bZuzm8s1ceuBUnMUAeoAHHw,2,0,0,0,0,0,2,0,2,0.2857142857142857,1,0.0,0,0,0,0,0,0,0,2,0,0,2,1
19830,183240,5tBgJZtV2IcrOsT8dEGT5vR2wgUVL0Ki,RXDvfPUBYFlVdlueBFbLW0mhhAyGEqpt,7,9,0,0,1,0,1,0,11,1.5714285714285714,1,0.0,0,0,0,1,9,0,0,1,0,1,10,1
19831,183242,bOMNnv3BcmeLvNMeUxuJFunXB0SEjjhL,G8EPVSXsOYB5YQWZGiz1aVq5Pgr2GrQu,6,5,0,0,0,0,1,0,6,0.8571428571428571,1,0.0,0,0,0,0,5,0,0,1,0,0,6,1
19832,183243,FGCLu23qz5rUrelYuCtqPnMTqZtXAAMw,SpATywNh6bZuzm8s1ceuBUnMUAeoAHHw,3,2,0,0,0,0,1,0,3,0.42857142857142855,1,0.0,0,0,0,0,2,0,0,1,0,0,3,1
19833,183246,0XGLQ2e4IRT7VYRVdCJkoQRc2HBjT9PI,SpATywNh6bZuzm8s1ceuBUnMUAeoAHHw,6,3,2,0,2,1,5,4,17,2.4285714285714284,1,0.0,0,2,0,2,3,1,0,5,4,4,13,1
19834,183255,o0L0ZsTU5fXkPgqce1TgnefJury1RfBP,SpATywNh6bZuzm8s1ceuBUnMUAeoAHHw,1,0,0,0,0,0,1,0,1,0.14285714285714285,1,0.0,0,0,0,0,0,0,0,1,0,0,1,1
19835,183256,Hqq2J56mzskAJKg1DKQGyeniCWvGpIGe,G8EPVSXsOYB5YQWZGiz1aVq5Pgr2GrQu,8,5,0,0,0,0,14,1,20,2.857142857142857,1,0.0,0,0,0,0,5,0,0,14,1,0,20,1
19836,183259,oAeA1FcKJgCgppNdDO8cyAq9ijjrn0WR,SpATywNh6bZuzm8s1ceuBUnMUAeoAHHw,1,0,0,0,0,0,1,0,1,0.14285714285714285,1,0.0,0,0,0,0,0,0,0,1,0,0,1,1
19837,183263,sRTon1VBBuP0uvdQE1lWLIce29YVBv8J,G8EPVSXsOYB5YQWZGiz1aVq5Pgr2GrQu,7,8,4,0,0,1,6,0,19,2.7142857142857144,1,0.0,0,4,0,0,8,1,0,6,0,4,15,1
19838,183270,7nQB7cjVdr2HijR82OoX1oMRPa42JjfY,SpATywNh6bZuzm8s1ceuBUnMUAeoAHHw,15,20,7,16,5,4,8,2,62,8.857142857142858,1,0.0,12,7,14,5,8,4,2,8,2,38,24,1
19839,183275,xQCtMoNknB0tylWKH0fJbJooatlzGcif,bWdj2GDclj5ofokWjzoa5jAwMkxCykd6,2,0,0,0,0,0,2,0,2,0.2857142857142857,1,0.0,0,0,0,0,0,0,0,2,0,0,2,1
19840,183278,GPLdxh0c6YlbU65pqQa5Y6COOTFoYUCD,bWdj2GDclj5ofokWjzoa5jAwMkxCykd6,1,0,0,0,0,0,1,0,1,0.14285714285714285,1,0.0,0,0,0,0,0,0,0,1,0,0,1,1
19841,183281,QCcqcVaEKUPWiTK3zDmg4MUzFmU49Qen,G8EPVSXsOYB5YQWZGiz1aVq5Pgr2GrQu,8,8,0,4,0,2,4,0,18,2.5714285714285716,1,0.0,5,0,2,0,3,2,2,4,0,7,11,1
19842,183282,eOxm8XEI11Xs6eiBi1Nu5QzIagZXwEm9,bWdj2GDclj5ofokWjzoa5jAwMkxCykd6,8,9,3,0,3,3,4,0,22,3.142857142857143,1,0.0,4,3,0,3,5,3,0,4,0,10,12,1
19843,183283,3uajdhCj0s2q50MqyB5gJCI3ZNoF8Pn6,SpATywNh6bZuzm8s1ceuBUnMUAeoAHHw,20,33,1,33,0,9,6,0,82,11.714285714285714,3,0.0,12,1,28,0,21,9,5,6,0,41,41,0
19844,183287,myIIBocNFelldmuN47bMrRiORGKDSj7S,bWdj2GDclj5ofokWjzoa5jAwMkxCykd6,5,2,1,0,1,0,2,0,6,0.8571428571428571,1,0.0,0,1,0,1,2,0,0,2,0,2,4,1
19845,183295,pjhJt7Jli5gOZV2lL76izW3SObuDigHu,SpATywNh6bZuzm8s1ceuBUnMUAeoAHHw,6,6,1,0,1,0,1,0,9,1.2857142857142858,1,0.0,0,1,0,1,6,0,0,1,0,2,7,1
19846,183298,JazzJWzkixijQw0lzFOQdWkrQaVq1jug,SpATywNh6bZuzm8s1ceuBUnMUAeoAHHw,1,0,0,0,0,0,1,0,1,0.14285714285714285,1,0.0,0,0,0,0,0,0,0,1,0,0,1,1
19847,183302,UVJV0Z8LgePBFvFPqKCGcnBV2sDOhrhM,SpATywNh6bZuzm8s1ceuBUnMUAeoAHHw,9,9,5,0,2,3,15,2,36,5.142857142857143,1,0.0,0,5,0,2,9,3,0,15,2,7,29,1
19848,183304,xyEiirOhDK1UDi4PZ4UKu6B69xftDWtO,G8EPVSXsOYB5YQWZGiz1aVq5Pgr2GrQu,3,1,0,0,0,0,2,0,3,0.42857142857142855,1,0.0,0,0,0,0,1,0,0,2,0,0,3,1
19849,183314,8lLmfOvYbkWA0I629B3U62LfaD1fwQEn,RXDvfPUBYFlVdlueBFbLW0mhhAyGEqpt,4,3,0,0,0,0,1,0,4,0.5714285714285714,1,0.0,0,0,0,0,3,0,0,1,0,0,4,1
19850,183318,5ZZ7ac02MMtLItQmBAzvselJyRLR3oem,RXDvfPUBYFlVdlueBFbLW0mhhAyGEqpt,13,8,6,14,4,0,1,0,33,4.714285714285714,1,0.0,1,6,13,4,7,0,1,1,0,24,9,1
19851,183322,aoDqbYwTSNONO0ewp0wUEkLRTmINlnHL,bWdj2GDclj5ofokWjzoa5jAwMkxCykd6,4,2,1,0,1,0,2,0,6,0.8571428571428571,1,0.0,0,1,0,1,2,0,0,2,0,2,4,0
19852,183335,DfGFChbBes1JC5MAOGd9A1oO26eP1NW8,SpATywNh6bZuzm8s1ceuBUnMUAeoAHHw,5,2,1,0,1,0,2,0,6,0.8571428571428571,1,0.0,0,1,0,1,2,0,0,2,0,2,4,1
19853,183336,tMAhwsb1zwYUL3evTh1bPfibKP5Qon6G,SpATywNh6bZuzm8s1ceuBUnMUAeoAHHw,14,26,12,23,0,16,12,3,92,13.142857142857142,1,0.0,11,12,19,0,15,16,4,12,3,42,50,1
19854,183338,AwyuEC08S0bk8UcEbhYUOEEzGzNqDKU8,SpATywNh6bZuzm8s1ceuBUnMUAeoAHHw,15,13,7,10,4,0,5,0,39,5.571428571428571,1,0.0,2,7,10,4,11,0,0,5,0,23,16,1
19855,183339,6mOQPHYetbEhBA0tIxsajGc8MOtDRaKo,SpATywNh6bZuzm8s1ceuBUnMUAeoAHHw,14,9,4,12,3,2,4,0,34,4.857142857142857,1,0.0,4,4,9,3,5,2,3,4,0,20,14,1
19856,183341,idNHVa5qTuX7uet3LgzHDgeF9ZtnSDQ3,bWdj2GDclj5ofokWjzoa5jAwMkxCykd6,5,4,2,0,2,0,4,0,12,1.7142857142857142,2,0.0,1,2,0,2,3,0,0,4,0,5,7,1
19857,183349,jM6CIVoPwE4qSBrp1fYyKBxxPBT1cEI7,SpATywNh6bZuzm8s1ceuBUnMUAeoAHHw,13,18,0,13,0,22,5,1,59,8.428571428571429,1,0.0,9,0,11,0,9,22,2,5,1,20,39,1
19858,183352,F60PWu4BLsLJcl06zQNatmmupVqE7UvO,SpATywNh6bZuzm8s1ceuBUnMUAeoAHHw,8,2,1,0,1,41,6,1,52,7.428571428571429,1,0.0,0,1,0,1,2,41,0,6,1,2,50,1
19859,183355,E2ARe3Bjs7AnrUVutsjVawfNV9IbxIpY,SpATywNh6bZuzm8s1ceuBUnMUAeoAHHw,10,2,2,0,2,1,6,1,14,2.0,1,0.0,0,2,0,2,2,1,0,6,1,4,10,1
19860,183356,dgFOOUSNfQK8xIrT47Av0Q04bBFeE21W,bWdj2GDclj5ofokWjzoa5jAwMkxCykd6,5,2,1,0,1,0,3,0,7,1.0,1,0.0,0,1,0,1,2,0,0,3,0,2,5,0
19861,183359,ks16hCmKEY3uCrrfZAVFFF4H8o1iqNYf,SpATywNh6bZuzm8s1ceuBUnMUAeoAHHw,2,0,0,0,0,0,2,0,2,0.2857142857142857,1,0.0,0,0,0,0,0,0,0,2,0,0,2,1
19862,183360,9s0JhEhDR0DB5lchGcAvAZmTtIRHEPQm,G8EPVSXsOYB5YQWZGiz1aVq5Pgr2GrQu,4,3,0,0,0,0,2,0,5,0.7142857142857143,1,0.0,0,0,0,0,3,0,0,2,0,0,5,1
19863,183364,wVXoala8XOb2iYKmDwv4j0mTTabnjV0o,SpATywNh6bZuzm8s1ceuBUnMUAeoAHHw,3,3,0,0,0,1,2,0,6,0.8571428571428571,1,0.0,0,0,0,0,3,1,0,2,0,0,6,1
19864,183366,lRau52E8JZjvrp0KLukaOoqpUzIxzIMQ,bWdj2GDclj5ofokWjzoa5jAwMkxCykd6,1,0,0,0,0,0,1,0,1,0.14285714285714285,1,0.0,0,0,0,0,0,0,0,1,0,0,1,1
19865,183371,kqNwxNjHDwzzgcfuymv6Zjh6rnLpzjX1,G8EPVSXsOYB5YQWZGiz1aVq5Pgr2GrQu,4,2,1,0,1,0,1,0,5,0.7142857142857143,1,0.0,0,1,0,1,2,0,0,1,0,2,3,0
19866,183373,BhK0qN7yCyRENwc0cuo4sVnEheX7uuVm,RXDvfPUBYFlVdlueBFbLW0mhhAyGEqpt,4,2,1,0,1,0,1,0,5,0.7142857142857143,1,0.0,0,1,0,1,2,0,0,1,0,2,3,1
19867,183375,t5Hw0caPG6L3nFHgMe2ewZ65zHyUbUJs,G8EPVSXsOYB5YQWZGiz1aVq5Pgr2GrQu,2,0,0,0,0,0,2,0,2,0.2857142857142857,1,0.0,0,0,0,0,0,0,0,2,0,0,2,1
19868,183376,bBc0KX5JgaSX0V8JzMsfaXljJJH0L4ZY,bWdj2GDclj5ofokWjzoa5jAwMkxCykd6,1,0,0,0,0,0,1,0,1,0.14285714285714285,1,0.0,0,0,0,0,0,0,0,1,0,0,1,0
19869,183377,IEfUasRNK7F4OXmh9ZRgY5RLlk7j6VcY,SpATywNh6bZuzm8s1ceuBUnMUAeoAHHw,5,6,2,0,1,0,1,0,10,1.4285714285714286,1,0.0,3,2,0,1,3,0,0,1,0,6,4,1
19870,183379,qHIKvxolHHwVyfUrUuTQ7lCeMbWX7sYP,RXDvfPUBYFlVdlueBFbLW0mhhAyGEqpt,14,16,2,6,3,1,1,0,29,4.142857142857143,1,0.0,5,2,6,3,11,1,0,1,0,16,13,1
19871,183381,I2UwAjBakgo7ulEE8gv6S9DLeFdNO1pr,bWdj2GDclj5ofokWjzoa5jAwMkxCykd6,3,0,0,0,0,0,2,1,3,0.42857142857142855,1,0.0,0,0,0,0,0,0,0,2,1,0,3,1
19872,183386,O7fzJfuKfqlfMIjfhNwbu2i8Ce4wMF9H,SpATywNh6bZuzm8s1ceuBUnMUAeoAHHw,2,0,0,0,0,0,2,0,2,0.2857142857142857,1,0.0,0,0,0,0,0,0,0,2,0,0,2,1
19873,183387,AT7MUJLyTRujCGftxJSRLnutVHzi2W6K,bWdj2GDclj5ofokWjzoa5jAwMkxCykd6,1,0,0,0,0,0,1,0,1,0.14285714285714285,1,0.0,0,0,0,0,0,0,0,1,0,0,1,1
19874,183394,rEeBeKGH612kEsTNiutHYC8nvtLgJLl3,bWdj2GDclj5ofokWjzoa5jAwMkxCykd6,6,4,1,0,2,8,5,0,20,2.857142857142857,1,0.0,2,1,0,2,2,8,0,5,0,5,15,1
19875,183395,3ypTaFxEmzRhgWt1V6ubGImksm3gaDqi,G8EPVSXsOYB5YQWZGiz1aVq5Pgr2GrQu,6,6,0,0,0,0,3,0,9,1.2857142857142858,1,0.0,1,0,0,0,5,0,0,3,0,1,8,1
19876,183402,uZccjrlfbKn6BDCm3jPoxZprWusdhQYC,RXDvfPUBYFlVdlueBFbLW0mhhAyGEqpt,8,3,2,0,0,2,6,1,14,2.0,1,0.0,0,2,0,0,3,2,0,6,1,2,12,1
19877,183404,StBmEv3I1e5i7om3Qal9RCxtr12zGldK,SpATywNh6bZuzm8s1ceuBUnMUAeoAHHw,3,2,1,0,0,0,1,0,4,0.5714285714285714,1,0.0,0,1,0,0,2,0,0,1,0,1,3,1
19878,183406,6x4B9nu8vwEEwbbJ91dM7syOmh6Wd3T4,RXDvfPUBYFlVdlueBFbLW0mhhAyGEqpt,15,12,8,0,9,0,7,0,36,5.142857142857143,2,0.0,3,8,0,9,9,0,0,7,0,20,16,1
19879,183409,p2WxyRGvLvUMOSoEWtLVx9Ca2AiCwjk0,SpATywNh6bZuzm8s1ceuBUnMUAeoAHHw,10,7,4,10,0,0,2,0,23,3.2857142857142856,1,0.0,2,4,8,0,5,0,2,2,0,14,9,1
19880,183414,e2iZvNKfdNseGOCno9jVScN4rf0x278a,G8EPVSXsOYB5YQWZGiz1aVq5Pgr2GrQu,10,6,2,10,1,0,3,0,22,3.142857142857143,1,0.0,3,2,7,1,3,0,3,3,0,13,9,1
19881,183423,CViRSkXaB71kW0MpqfES8A240EKnhiKp,bWdj2GDclj5ofokWjzoa5jAwMkxCykd6,6,6,3,0,2,0,2,0,13,1.8571428571428572,1,0.0,2,3,0,2,4,0,0,2,0,7,6,1
19882,183427,BYDzZvbHlPLB5l5C8F0sCY7jgUh5E5kF,SpATywNh6bZuzm8s1ceuBUnMUAeoAHHw,4,3,2,0,0,0,1,0,6,0.8571428571428571,1,0.0,0,2,0,0,3,0,0,1,0,2,4,1
19883,183430,MofLU1eAzpaUKN6d2uNrYpUKgP1lpdHE,RXDvfPUBYFlVdlueBFbLW0mhhAyGEqpt,15,16,11,12,3,3,7,1,53,7.571428571428571,1,0.0,0,11,10,3,16,3,2,7,1,24,29,1
19884,183431,8BTLZqMynI47lpeExrpUyf3Ycam7Kqwv,SpATywNh6bZuzm8s1ceuBUnMUAeoAHHw,9,28,10,0,0,0,4,0,42,6.0,1,0.0,3,10,0,0,25,0,0,4,0,13,29,1
19885,183435,t4uSkzpGvWF0mtXEP739NS9nOIoxwvm0,RXDvfPUBYFlVdlueBFbLW0mhhAyGEqpt,6,4,0,0,0,0,2,0,6,0.8571428571428571,1,0.0,0,0,0,0,4,0,0,2,0,0,6,1
19886,183440,EtfxOXHEuVBMaj0eMSXrIIrSQlTvW9sK,bWdj2GDclj5ofokWjzoa5jAwMkxCykd6,1,0,0,0,0,0,1,0,1,0.14285714285714285,1,0.0,0,0,0,0,0,0,0,1,0,0,1,1
19887,183442,v9EzyBMgqrHmKu64Jm356JCxNk5lnRyw,G8EPVSXsOYB5YQWZGiz1aVq5Pgr2GrQu,2,0,0,0,0,0,2,0,2,0.2857142857142857,1,0.0,0,0,0,0,0,0,0,2,0,0,2,1
19888,183452,RnIxYOCcvRkH5SmLcSLbuQiMmbZTCV4X,bWdj2GDclj5ofokWjzoa5jAwMkxCykd6,7,4,2,0,1,2,3,1,13,1.8571428571428572,1,0.0,0,2,0,1,4,2,0,3,1,3,10,1
19889,183456,InAOZGiL3znHtTGfF0VCl2ivku6eLEMF,RXDvfPUBYFlVdlueBFbLW0mhhAyGEqpt,20,30,16,35,14,1,7,11,114,16.285714285714285,1,0.0,12,16,30,14,18,1,5,7,11,72,42,1
19890,183465,Mie6PMLFZ6GTGAAMZLvUdpU4rgeHjvP2,bWdj2GDclj5ofokWjzoa5jAwMkxCykd6,5,2,1,0,1,0,2,0,6,0.8571428571428571,1,0.0,0,1,0,1,2,0,0,2,0,2,4,1
19891,183466,nwVilrO2xxpsCBw1FRKGSujEDxCOupgS,SpATywNh6bZuzm8s1ceuBUnMUAeoAHHw,6,6,2,0,1,1,4,0,14,2.0,1,0.0,0,2,0,1,6,1,0,4,0,3,11,1
19892,183467,PFkCedTA1DArZVlA7QIlGHqePzUVifGy,SpATywNh6bZuzm8s1ceuBUnMUAeoAHHw,1,0,0,0,0,0,1,0,1,0.14285714285714285,1,0.0,0,0,0,0,0,0,0,1,0,0,1,1
19893,183468,SSM7wEvdZo8FZW0zxJcXGwdA1S6Vbn5Q,SpATywNh6bZuzm8s1ceuBUnMUAeoAHHw,10,9,5,13,0,1,3,0,31,4.428571428571429,2,0.0,3,5,11,0,6,1,2,3,0,19,12,0
19894,183471,ZWE0n8BTbJ9FUQALYDITtcmVETezeafV,bWdj2GDclj5ofokWjzoa5jAwMkxCykd6,10,8,2,40,2,1,4,1,58,8.285714285714286,1,0.0,5,2,39,2,3,1,1,4,1,48,10,1
19895,183472,UJgg3Z7RMqrOzehAajABZyrolXDOj0JJ,G8EPVSXsOYB5YQWZGiz1aVq5Pgr2GrQu,3,2,0,0,0,0,2,0,4,0.5714285714285714,1,0.0,0,0,0,0,2,0,0,2,0,0,4,1
19896,183474,pk69em2bhNfGTrrqysMHCMfzjd22WDJE,SpATywNh6bZuzm8s1ceuBUnMUAeoAHHw,13,8,4,2,3,0,4,1,22,3.142857142857143,1,0.0,0,4,2,3,8,0,0,4,1,9,13,1
19897,183475,bz5GKxlsbJHiQ5yHN3mGDylrAg3DXi5E,SpATywNh6bZuzm8s1ceuBUnMUAeoAHHw,9,9,8,0,5,0,2,0,24,3.4285714285714284,1,0.0,0,8,0,5,9,0,0,2,0,13,11,1
19898,183480,pumsIIBvkIDHPLuElv7OSuQxwiyrjr12,SpATywNh6bZuzm8s1ceuBUnMUAeoAHHw,14,27,8,20,4,1,5,0,65,9.285714285714286,1,0.0,9,8,18,4,18,1,2,5,0,39,26,1
19899,183491,hMsNCldAkGadwgGX6yjkMuu7X3GLTjYs,bWdj2GDclj5ofokWjzoa5jAwMkxCykd6,12,14,10,8,7,10,11,0,60,8.571428571428571,2,0.0,1,10,6,7,13,10,2,11,0,24,36,1
19900,183493,wTO6PriqUjklZvIhTLmF52Ryme8SIc0k,SpATywNh6bZuzm8s1ceuBUnMUAeoAHHw,1,0,0,0,0,0,1,0,1,0.14285714285714285,1,0.0,0,0,0,0,0,0,0,1,0,0,1,1
19901,183495,O6uNlqe4D6fw6uKpeBg3BRdXTyp6hhXG,RXDvfPUBYFlVdlueBFbLW0mhhAyGEqpt,1,0,0,0,0,0,1,0,1,0.14285714285714285,1,0.0,0,0,0,0,0,0,0,1,0,0,1,1
19902,183498,cQingcIr6b1ihV5kJhN5qPmtxp0KcxRT,G8EPVSXsOYB5YQWZGiz1aVq5Pgr2GrQu,7,6,3,0,2,3,3,0,17,2.4285714285714284,1,0.0,0,3,0,2,6,3,0,3,0,5,12,1
19903,183506,VtCUQBk0TlN0AJOAq0bEC4tTAH6HVrBA,RXDvfPUBYFlVdlueBFbLW0mhhAyGEqpt,5,3,1,0,1,0,1,0,6,0.8571428571428571,1,0.0,0,1,0,1,3,0,0,1,0,2,4,1
19904,183507,dRkGRhgEz0P6Cj2gSWKZ3jwm6LAB5sTl,RXDvfPUBYFlVdlueBFbLW0mhhAyGEqpt,6,14,10,0,0,0,5,0,29,4.142857142857143,1,0.0,0,10,0,0,14,0,0,5,0,10,19,1
19905,183510,UjlYIZQOEINWayGhC3yn2Cik0ILUnmNg,RXDvfPUBYFlVdlueBFbLW0mhhAyGEqpt,10,11,7,0,4,0,10,0,32,4.571428571428571,1,0.0,0,7,0,4,11,0,0,10,0,11,21,1
19906,183512,DhiB4cJ1TCjmSH3ZWP9m0OqNyBdGeS5P,bWdj2GDclj5ofokWjzoa5jAwMkxCykd6,5,6,0,0,0,0,2,0,8,1.1428571428571428,1,0.0,0,0,0,0,6,0,0,2,0,0,8,1
19907,183515,dRbINtWX4PACMb6CoPwzFcGIwIksepgL,SpATywNh6bZuzm8s1ceuBUnMUAeoAHHw,1,0,0,0,0,0,1,0,1,0.14285714285714285,1,0.0,0,0,0,0,0,0,0,1,0,0,1,1
19908,183516,AwMbVkwoHOO4RwVeu0kWHW1pZCX6cyCm,bWdj2GDclj5ofokWjzoa5jAwMkxCykd6,2,0,0,0,0,0,2,0,2,0.2857142857142857,1,0.0,0,0,0,0,0,0,0,2,0,0,2,1
19909,183519,B4PjpXbBdKDLR1d4bTEW8nYb1XQ8zgOw,RXDvfPUBYFlVdlueBFbLW0mhhAyGEqpt,3,2,1,0,0,0,1,0,4,0.5714285714285714,1,0.0,0,1,0,0,2,0,0,1,0,1,3,1
19910,183520,1D6eUyCJP5alahovvE13UJeLeWGqXCSN,SpATywNh6bZuzm8s1ceuBUnMUAeoAHHw,1,0,0,0,0,0,1,0,1,0.14285714285714285,1,0.0,0,0,0,0,0,0,0,1,0,0,1,0
19911,183522,jdDAkKv7CXlTSONMrkYEJDMOqMZv4NO7,G8EPVSXsOYB5YQWZGiz1aVq5Pgr2GrQu,7,5,1,0,1,0,3,0,10,1.4285714285714286,1,0.0,0,1,0,1,5,0,0,3,0,2,8,1
19912,183523,uvHFiZDnxbLoaMgYUEvYxJ8fEqaBGtVR,SpATywNh6bZuzm8s1ceuBUnMUAeoAHHw,6,3,2,0,1,0,2,0,8,1.1428571428571428,1,0.0,0,2,0,1,3,0,0,2,0,3,5,1
19913,183525,l4fUBbt2UkEBI1IQ0gPXz6asVAEuAAgG,SpATywNh6bZuzm8s1ceuBUnMUAeoAHHw,8,6,6,0,4,0,5,0,21,3.0,3,0.0,0,6,0,4,6,0,0,5,0,10,11,1
19914,183529,Nqn3ANjR8SmFf4pF0O8Kve4CiSpmex7G,SpATywNh6bZuzm8s1ceuBUnMUAeoAHHw,1,0,0,0,0,0,1,0,1,0.14285714285714285,1,0.0,0,0,0,0,0,0,0,1,0,0,1,1
19915,183532,vrlk2ULHn3q7og5F7d4moUFSIP81jWhe,SpATywNh6bZuzm8s1ceuBUnMUAeoAHHw,5,2,1,0,1,0,2,0,6,0.8571428571428571,1,0.0,0,1,0,1,2,0,0,2,0,2,4,1
19916,183533,M75L90OOMTV1kEiI3n7vM0ty47YBFna9,SpATywNh6bZuzm8s1ceuBUnMUAeoAHHw,3,3,0,0,0,0,1,0,4,0.5714285714285714,1,0.0,0,0,0,0,3,0,0,1,0,0,4,1
19917,183544,pIUA4CxUOhlZMOg4cOlVb2la0FCnmRD3,RXDvfPUBYFlVdlueBFbLW0mhhAyGEqpt,11,6,5,0,3,0,2,0,16,2.2857142857142856,1,0.0,0,5,0,3,6,0,0,2,0,8,8,1
19918,183554,4gFDIkwCKsDbUhjdoZqM1BZ32HnFPqUv,bWdj2GDclj5ofokWjzoa5jAwMkxCykd6,2,0,0,0,0,0,2,0,2,0.2857142857142857,1,0.0,0,0,0,0,0,0,0,2,0,0,2,1
19919,183562,AWvgwCQmPH4OGAIYypj87Tg2RKpUEZjK,RXDvfPUBYFlVdlueBFbLW0mhhAyGEqpt,23,42,2,36,4,3,4,2,93,13.285714285714286,1,0.0,29,2,31,4,13,3,5,4,2,66,27,1
19920,183563,Edq6Echk8wEs8ShX5RBw5c8Yx8ANHVje,bWdj2GDclj5ofokWjzoa5jAwMkxCykd6,5,2,1,0,1,0,5,0,9,1.2857142857142858,1,0.0,0,1,0,1,2,0,0,5,0,2,7,1
19921,183564,K7VioOgkoW2bG7ynS7EVbYmEm9sNay8P,bWdj2GDclj5ofokWjzoa5jAwMkxCykd6,8,3,2,0,2,0,3,0,10,1.4285714285714286,1,0.0,0,2,0,2,3,0,0,3,0,4,6,1
19922,183568,lRbeD3dHMTos4W2d1Naqv6Hm53gM6ove,RXDvfPUBYFlVdlueBFbLW0mhhAyGEqpt,5,5,3,0,0,0,3,0,11,1.5714285714285714,1,0.0,0,3,0,0,5,0,0,3,0,3,8,1
19923,183574,kGkU7DU5zOC0IQHNRlo6r0rouCnUfi6R,bWdj2GDclj5ofokWjzoa5jAwMkxCykd6,1,0,0,0,0,0,1,0,1,0.14285714285714285,1,0.0,0,0,0,0,0,0,0,1,0,0,1,1
19924,183575,dTjL08in9jKZ00BA9Kf6biDJuIA4OzlF,bWdj2GDclj5ofokWjzoa5jAwMkxCykd6,1,0,0,0,0,0,1,0,1,0.14285714285714285,1,0.0,0,0,0,0,0,0,0,1,0,0,1,1
19925,183578,b1g4AWG6A2zG5plnQY4paLSHRFnrgObC,bWdj2GDclj5ofokWjzoa5jAwMkxCykd6,3,2,0,0,0,0,2,0,4,0.5714285714285714,1,0.0,0,0,0,0,2,0,0,2,0,0,4,1
19926,183580,3t9ZicXafEarB5kevklUjZj2RJMyb5VH,bWdj2GDclj5ofokWjzoa5jAwMkxCykd6,1,0,0,0,0,0,1,0,1,0.14285714285714285,1,0.0,0,0,0,0,0,0,0,1,0,0,1,1
19927,183583,eDzTwNhYw5qEG2zvbZVjOixJZpRNeUjf,SpATywNh6bZuzm8s1ceuBUnMUAeoAHHw,16,12,6,14,4,3,8,2,49,7.0,1,0.0,4,6,12,4,8,3,2,8,2,26,23,1
19928,183584,9KpScbHudyYdTVutfkp65lLJaFeSgBWp,SpATywNh6bZuzm8s1ceuBUnMUAeoAHHw,4,3,1,0,0,0,2,0,6,0.8571428571428571,1,0.0,0,1,0,0,3,0,0,2,0,1,5,1
19929,183597,Eh6H4i1zHStqzSkD6GI2c0vx2yJEOPJN,RXDvfPUBYFlVdlueBFbLW0mhhAyGEqpt,1,0,0,0,0,0,1,0,1,0.14285714285714285,1,0.0,0,0,0,0,0,0,0,1,0,0,1,1
19930,183600,0ZbsYtS35s7opWGwTDlJClFUqsKIqJ5M,SpATywNh6bZuzm8s1ceuBUnMUAeoAHHw,9,3,2,0,2,1,4,1,13,1.8571428571428572,1,0.0,0,2,0,2,3,1,0,4,1,4,9,1
19931,183602,VRgPAzuxIaYkNO2Qx5nEdyuDaVR0Pn8E,SpATywNh6bZuzm8s1ceuBUnMUAeoAHHw,7,5,4,0,3,0,4,0,16,2.2857142857142856,1,0.0,0,4,0,3,5,0,0,4,0,7,9,1
19932,183604,SKEZ0daa2ls5AsPymaWXx3HMK7ugoFOQ,SpATywNh6bZuzm8s1ceuBUnMUAeoAHHw,3,2,0,0,0,0,2,0,4,0.5714285714285714,1,0.0,0,0,0,0,2,0,0,2,0,0,4,1
19933,183605,u4EZDHauXLY7CQOXsbgjEXdCMOX1ZIIi,bWdj2GDclj5ofokWjzoa5jAwMkxCykd6,8,6,1,0,2,0,9,1,19,2.7142857142857144,1,0.0,3,1,0,2,3,0,0,9,1,6,13,1
19934,183608,5Qb7U49ZGB6vPwkkfqIlX0DILe5PUAX7,SpATywNh6bZuzm8s1ceuBUnMUAeoAHHw,4,3,1,0,0,0,2,0,6,0.8571428571428571,1,0.0,0,1,0,0,3,0,0,2,0,1,5,1
19935,183615,jcXoYFaI9QPcliotiwIgOLeObkrSUvNn,bWdj2GDclj5ofokWjzoa5jAwMkxCykd6,1,0,0,0,0,0,1,0,1,0.14285714285714285,1,0.0,0,0,0,0,0,0,0,1,0,0,1,1
19936,183617,Pv9LrfjnRw1WO1VwPNHCu7aKxUz6zC8i,SpATywNh6bZuzm8s1ceuBUnMUAeoAHHw,9,11,6,8,0,0,4,0,29,4.142857142857143,2,0.0,4,6,6,0,7,0,2,4,0,16,13,1
19937,183618,Fy49pMsTJR4qc7kCFAlWxZsMejdzrbbw,SpATywNh6bZuzm8s1ceuBUnMUAeoAHHw,6,2,1,0,1,0,3,1,8,1.1428571428571428,1,0.0,0,1,0,1,2,0,0,3,1,2,6,1
19938,183620,8f6cUr3CdC0FEH3V0o2H0iLNd9nVyUsV,SpATywNh6bZuzm8s1ceuBUnMUAeoAHHw,6,0,0,0,0,1,7,1,9,1.2857142857142858,1,0.0,0,0,0,0,0,1,0,7,1,0,9,1
19939,183623,7wyfXvc1g99QNmXzEb4w8C1vE0Vi2bHm,bWdj2GDclj5ofokWjzoa5jAwMkxCykd6,4,2,0,0,0,0,4,0,6,0.8571428571428571,1,0.0,0,0,0,0,2,0,0,4,0,0,6,1
19940,183626,Qntf4pjwhrrlpkPkdw7xTOHA3tqEKwZo,SpATywNh6bZuzm8s1ceuBUnMUAeoAHHw,1,0,0,0,0,0,1,0,1,0.14285714285714285,1,0.0,0,0,0,0,0,0,0,1,0,0,1,1
19941,183627,vpIRkrpJz2fnOEDQ7QyDeADagL23RUmm,SpATywNh6bZuzm8s1ceuBUnMUAeoAHHw,5,2,1,0,1,0,3,0,7,1.0,1,0.0,0,1,0,1,2,0,0,3,0,2,5,1
19942,183628,r3xrbycrTBTOJ8lVkbmPIEtnYkwuySp0,G8EPVSXsOYB5YQWZGiz1aVq5Pgr2GrQu,7,7,1,0,1,0,1,0,10,1.4285714285714286,1,0.0,1,1,0,1,6,0,0,1,0,3,7,1
19943,183642,mbEX76fVD9CfdxvS9S0YmboTh2OQRRH9,SpATywNh6bZuzm8s1ceuBUnMUAeoAHHw,9,10,0,10,0,23,1,0,44,6.285714285714286,1,0.0,4,0,9,0,6,23,1,1,0,13,31,1
19944,183647,a4RYqILKcnu8c617gYSbD0KQIm9DqZnc,RXDvfPUBYFlVdlueBFbLW0mhhAyGEqpt,6,5,4,0,2,0,1,0,12,1.7142857142857142,1,0.0,0,4,0,2,5,0,0,1,0,6,6,1
19945,183667,H01qgmsAzE6UZ02rpT0g0cPQbKgigwE6,SpATywNh6bZuzm8s1ceuBUnMUAeoAHHw,1,0,0,0,0,0,1,0,1,0.14285714285714285,1,0.0,0,0,0,0,0,0,0,1,0,0,1,1
19946,183668,NMciPbdIeB9uIZwCMcw6mXU2i3BtnB5v,RXDvfPUBYFlVdlueBFbLW0mhhAyGEqpt,13,8,5,15,3,0,1,0,32,4.571428571428571,1,0.0,1,5,12,3,7,0,3,1,0,21,11,0
19947,183677,3kAfPhBAdLqCd25fZapuQy7eXOe7UiZ6,SpATywNh6bZuzm8s1ceuBUnMUAeoAHHw,2,0,0,0,0,0,3,0,3,0.42857142857142855,1,0.0,0,0,0,0,0,0,0,3,0,0,3,1
19948,183678,00w736SmRTShB1yHSNNQKxZ90wTM71uT,SpATywNh6bZuzm8s1ceuBUnMUAeoAHHw,1,0,0,0,0,0,1,0,1,0.14285714285714285,1,0.0,0,0,0,0,0,0,0,1,0,0,1,1
19949,183681,tUa09YYOUnb3wVzvjQGH0FvIpZ5hsZpt,SpATywNh6bZuzm8s1ceuBUnMUAeoAHHw,13,18,1,0,0,1,6,1,27,3.857142857142857,2,0.0,0,1,0,0,18,1,0,6,1,1,26,1
19950,183683,Hqlgf2n4GScNbLk3LnpSlhqbXS4k1V5Y,bWdj2GDclj5ofokWjzoa5jAwMkxCykd6,2,0,0,0,0,0,2,0,2,0.2857142857142857,1,0.0,0,0,0,0,0,0,0,2,0,0,2,1
19951,183684,PJVOwbqsSqxmbQfiqysBeUsqu2d0RHYt,SpATywNh6bZuzm8s1ceuBUnMUAeoAHHw,1,0,0,0,0,0,1,0,1,0.14285714285714285,1,0.0,0,0,0,0,0,0,0,1,0,0,1,1
19952,183685,srrwedRjbv42svoIh3SiJfl8lc5wqthR,SpATywNh6bZuzm8s1ceuBUnMUAeoAHHw,8,6,1,0,1,0,3,1,12,1.7142857142857142,1,0.0,0,1,0,1,6,0,0,3,1,2,10,1
19953,183690,LrnqEdfBj0D0yEwqlIwYFq7gG4yeMv2F,RXDvfPUBYFlVdlueBFbLW0mhhAyGEqpt,5,3,2,0,2,0,2,0,9,1.2857142857142858,1,0.0,0,2,0,2,3,0,0,2,0,4,5,1
19954,183692,pGwYJRrX7MfzhhSwNLSQAMurehSIgkJ9,bWdj2GDclj5ofokWjzoa5jAwMkxCykd6,9,5,3,16,2,8,7,1,42,6.0,2,0.0,1,3,16,2,4,8,0,7,1,22,20,1
19955,183696,5507vCg0B1i7QYbqjYirkMGFioj9q8do,bWdj2GDclj5ofokWjzoa5jAwMkxCykd6,7,3,3,0,3,0,2,0,11,1.5714285714285714,1,0.0,0,3,0,3,3,0,0,2,0,6,5,1
19956,183697,XTAgcCcMxVaOaQnxZJfZgo5L5IIUp6vo,SpATywNh6bZuzm8s1ceuBUnMUAeoAHHw,7,4,1,0,1,0,4,0,10,1.4285714285714286,1,0.0,0,1,0,1,4,0,0,4,0,2,8,1
19957,183703,0tUsWRwcM5Diph5ritKgQygdUhSNn96x,SpATywNh6bZuzm8s1ceuBUnMUAeoAHHw,6,2,1,0,1,0,2,0,6,0.8571428571428571,1,0.0,0,1,0,1,2,0,0,2,0,2,4,1
19958,183705,fsTTrbfLLX3LLKI2ivzhVe8zchwg73pj,SpATywNh6bZuzm8s1ceuBUnMUAeoAHHw,15,12,6,14,3,1,5,0,41,5.857142857142857,1,0.0,4,6,13,3,8,1,1,5,0,26,15,1
19959,183706,0eu2uHXXHlrxtRapovPIpFp8IooLmBew,SpATywNh6bZuzm8s1ceuBUnMUAeoAHHw,5,2,1,0,1,0,2,0,6,0.8571428571428571,1,0.0,0,1,0,1,2,0,0,2,0,2,4,1
19960,183707,NaRJmQnyQzKeB0w8DDGDf6ZmsPHjlThO,SpATywNh6bZuzm8s1ceuBUnMUAeoAHHw,10,6,0,6,0,0,4,1,17,2.4285714285714284,1,0.0,1,0,5,0,5,0,1,4,1,6,11,1
19961,183721,j77DK4hco4PDLnfPsujP1vD7LFaP7p4V,SpATywNh6bZuzm8s1ceuBUnMUAeoAHHw,10,10,0,0,1,3,5,3,22,3.142857142857143,1,0.0,1,0,0,1,9,3,0,5,3,2,20,1
19962,183725,GfV76YxFEig6L2nHg6sIaPDE5VPf3uRt,SpATywNh6bZuzm8s1ceuBUnMUAeoAHHw,8,4,3,0,3,0,3,0,13,1.8571428571428572,1,0.0,0,3,0,3,4,0,0,3,0,6,7,1
19963,183728,wjS8ie6ACTxewSCQo7zpBy0tu4z4RYPD,RXDvfPUBYFlVdlueBFbLW0mhhAyGEqpt,1,0,0,0,0,0,1,0,1,0.14285714285714285,1,0.0,0,0,0,0,0,0,0,1,0,0,1,1
19964,183730,eDzTwNhYw5qEG2zvbZVjOixJZpRNeUjf,bWdj2GDclj5ofokWjzoa5jAwMkxCykd6,11,14,8,10,4,0,7,0,43,6.142857142857143,1,0.0,1,8,8,4,13,0,2,7,0,21,22,1
19965,183732,Cu4fMSI1LUWMJcNR5zM13WUwE6Hxc1yL,SpATywNh6bZuzm8s1ceuBUnMUAeoAHHw,10,7,4,11,0,0,2,0,24,3.4285714285714284,1,0.0,2,4,10,0,5,0,1,2,0,16,8,1
19966,183733,MlcE1JFENTunAHw0ocZkMchxf8NdWNFO,bWdj2GDclj5ofokWjzoa5jAwMkxCykd6,3,4,1,0,1,0,1,0,7,1.0,1,0.0,2,1,0,1,2,0,0,1,0,4,3,1
19967,183735,68jxA2PUjT1NQfZbUcdmPfGR0u6r2zeM,RXDvfPUBYFlVdlueBFbLW0mhhAyGEqpt,1,0,0,0,0,0,1,0,1,0.14285714285714285,1,0.0,0,0,0,0,0,0,0,1,0,0,1,1
19968,183745,FR3djrgj8pkYcAIqYiRiT862Pvu77Ath,SpATywNh6bZuzm8s1ceuBUnMUAeoAHHw,1,0,0,0,0,0,1,0,1,0.14285714285714285,1,0.0,0,0,0,0,0,0,0,1,0,0,1,1
19969,183748,hD4qEuZFDZPZ2RLgArJFuhYLdzuJCt01,bWdj2GDclj5ofokWjzoa5jAwMkxCykd6,7,5,1,0,0,0,5,0,11,1.5714285714285714,1,0.0,0,1,0,0,5,0,0,5,0,1,10,1
19970,183750,G7MC8DJ4FubRjcyO7f3yIgxskIjZSZjx,SpATywNh6bZuzm8s1ceuBUnMUAeoAHHw,1,0,0,0,0,0,1,0,1,0.14285714285714285,1,0.0,0,0,0,0,0,0,0,1,0,0,1,1
19971,183751,hJq2MbZS4JBSMT1a0Z3Gv6HKBJY6P875,bWdj2GDclj5ofokWjzoa5jAwMkxCykd6,1,0,0,0,0,0,1,0,1,0.14285714285714285,1,0.0,0,0,0,0,0,0,0,1,0,0,1,1
19972,183752,bxybXAkYqJdxWDLSPlh74sjGoIJub8gI,SpATywNh6bZuzm8s1ceuBUnMUAeoAHHw,4,3,1,0,1,0,1,0,6,0.8571428571428571,1,0.0,0,1,0,1,3,0,0,1,0,2,4,1
19973,183756,hJq2MbZS4JBSMT1a0Z3Gv6HKBJY6P875,G8EPVSXsOYB5YQWZGiz1aVq5Pgr2GrQu,1,0,0,0,0,0,1,0,1,0.14285714285714285,1,0.0,0,0,0,0,0,0,0,1,0,0,1,1
19974,183762,o1et1l3gB2UO6Zee7jdvT3mFoSzRmTnv,SpATywNh6bZuzm8s1ceuBUnMUAeoAHHw,11,67,43,0,0,2,18,1,131,18.714285714285715,1,0.0,11,43,0,0,56,2,0,18,1,54,77,1
19975,183763,VeIUrvtz2WpmBOVKmRi9CiIdJh5W97e2,RXDvfPUBYFlVdlueBFbLW0mhhAyGEqpt,6,1,1,0,1,0,4,0,7,1.0,1,0.0,0,1,0,1,1,0,0,4,0,2,5,1
19976,183764,Nlh27vHI7XhT6kQrXYnVdjcOvglbank1,G8EPVSXsOYB5YQWZGiz1aVq5Pgr2GrQu,5,4,1,0,0,0,1,0,6,0.8571428571428571,1,0.0,0,1,0,0,4,0,0,1,0,1,5,1
19977,183765,rQAguOaTDu3xVeM76HB96fgatKOO1sTk,SpATywNh6bZuzm8s1ceuBUnMUAeoAHHw,1,0,0,0,0,0,1,0,1,0.14285714285714285,1,0.0,0,0,0,0,0,0,0,1,0,0,1,1
19978,183769,YV5fQTL2YvQLATfqnj9sLfcWGppiWs4n,bWdj2GDclj5ofokWjzoa5jAwMkxCykd6,9,12,5,0,2,0,6,1,26,3.7142857142857144,1,0.0,0,5,0,2,12,0,0,6,1,7,19,1
19979,183771,rQAguOaTDu3xVeM76HB96fgatKOO1sTk,bWdj2GDclj5ofokWjzoa5jAwMkxCykd6,1,0,0,0,0,0,1,0,1,0.14285714285714285,1,0.0,0,0,0,0,0,0,0,1,0,0,1,1
19980,183772,cYRBWOkDMP7C555Y2eZz5GOKMhCVJBvZ,SpATywNh6bZuzm8s1ceuBUnMUAeoAHHw,8,5,3,0,2,0,4,0,14,2.0,1,0.0,0,3,0,2,5,0,0,4,0,5,9,1
19981,183773,aXiJW8ayzWdjAFuCXJZEkZEM0lQLoZYD,SpATywNh6bZuzm8s1ceuBUnMUAeoAHHw,1,0,0,0,0,0,1,0,1,0.14285714285714285,1,0.0,0,0,0,0,0,0,0,1,0,0,1,1
19982,183776,K8gGtH4J6AjA9U9FV7bczDiv6su7TqD9,SpATywNh6bZuzm8s1ceuBUnMUAeoAHHw,2,0,0,0,0,0,2,0,2,0.2857142857142857,1,0.0,0,0,0,0,0,0,0,2,0,0,2,1
19983,183778,jVE9J6XTbZz7EeUuDkD5BDSnxkl65G8L,bWdj2GDclj5ofokWjzoa5jAwMkxCykd6,6,7,4,0,1,6,4,0,22,3.142857142857143,1,0.0,0,4,0,1,7,6,0,4,0,5,17,1
19984,183782,wzcKXGYxAENlw35KZ5i9A0UYj84yOcRo,SpATywNh6bZuzm8s1ceuBUnMUAeoAHHw,1,0,0,0,0,0,1,0,1,0.14285714285714285,1,0.0,0,0,0,0,0,0,0,1,0,0,1,1
19985,183794,oqyLKKVVYW9EATjohuVL1hNLHTIkDxiu,RXDvfPUBYFlVdlueBFbLW0mhhAyGEqpt,9,6,3,0,1,1,7,1,19,2.7142857142857144,1,0.0,0,3,0,1,6,1,0,7,1,4,15,1
19986,183795,8u2jHFBQdYbssbxd155XumepML5OnCFA,SpATywNh6bZuzm8s1ceuBUnMUAeoAHHw,9,3,2,0,1,1,5,1,13,1.8571428571428572,1,0.0,0,2,0,1,3,1,0,5,1,3,10,1
19987,183797,vlHmtLHxbw7S6zxC5oHlY3I9JCi1BY6K,bWdj2GDclj5ofokWjzoa5jAwMkxCykd6,1,0,0,0,0,0,1,0,1,0.14285714285714285,1,0.0,0,0,0,0,0,0,0,1,0,0,1,1
19988,183799,bxybXAkYqJdxWDLSPlh74sjGoIJub8gI,bWdj2GDclj5ofokWjzoa5jAwMkxCykd6,7,5,2,0,1,0,4,0,12,1.7142857142857142,2,0.0,0,2,0,1,5,0,0,4,0,3,9,1
19989,183807,nB4B19Wi7VjyTtJDPkIXAAww5TaYMuNU,G8EPVSXsOYB5YQWZGiz1aVq5Pgr2GrQu,6,5,3,0,1,0,2,0,11,1.5714285714285714,1,0.0,0,3,0,1,5,0,0,2,0,4,7,0
19990,183809,hr7uGA6N7pm5Wb3vahUIH4sx0GWC6IQD,G8EPVSXsOYB5YQWZGiz1aVq5Pgr2GrQu,5,2,1,0,1,0,3,0,7,1.0,1,0.0,0,1,0,1,2,0,0,3,0,2,5,1
19991,183811,YXm8bq7zaK4Xr5i1u3w8eLm5WwHCxSwx,bWdj2GDclj5ofokWjzoa5jAwMkxCykd6,2,0,0,0,0,4,1,0,5,0.7142857142857143,1,0.0,0,0,0,0,0,4,0,1,0,0,5,1
19992,183814,aOe6ryD5RYplhCYczJ8onj52Uh9OP4Rs,SpATywNh6bZuzm8s1ceuBUnMUAeoAHHw,7,7,1,0,1,1,3,0,13,1.8571428571428572,1,0.0,0,1,0,1,7,1,0,3,0,2,11,1
19993,183815,cfg2dvjgHRrRXnLKehwyxBIarxQiiXUS,bWdj2GDclj5ofokWjzoa5jAwMkxCykd6,4,2,0,0,1,0,1,0,4,0.5714285714285714,1,0.0,0,0,0,1,2,0,0,1,0,1,3,1
19994,183816,1y8Z7kbql2eWHeUppugE1NMIawh69MAq,SpATywNh6bZuzm8s1ceuBUnMUAeoAHHw,1,0,0,0,0,0,2,0,2,0.2857142857142857,1,0.0,0,0,0,0,0,0,0,2,0,0,2,1
19995,183820,RtJIi7yt7eqxxsJXnxUwVJPkYwTwddBt,SpATywNh6bZuzm8s1ceuBUnMUAeoAHHw,1,0,0,0,0,0,1,0,1,0.14285714285714285,1,0.0,0,0,0,0,0,0,0,1,0,0,1,1
19996,183824,ijNpE1ugmA4mkAddk2e3bQh6TJ0jb7HD,RXDvfPUBYFlVdlueBFbLW0mhhAyGEqpt,5,2,1,0,1,10,2,1,17,2.4285714285714284,1,0.0,0,1,0,1,2,10,0,2,1,2,15,1
19997,183826,GZEmn2jDYiPNelTXdP84Wl4gxgVXz7UQ,SpATywNh6bZuzm8s1ceuBUnMUAeoAHHw,7,4,3,0,2,1,2,0,12,1.7142857142857142,1,0.0,0,3,0,2,4,1,0,2,0,5,7,1
19998,183828,KyIbCsqzwxfjreA4vfXflB0Ayn4dl9kJ,SpATywNh6bZuzm8s1ceuBUnMUAeoAHHw,16,15,7,18,3,22,8,2,75,10.714285714285714,1,0.0,6,7,15,3,9,22,3,8,2,31,44,1
19999,183831,G4FZ5Oaaa2T6hGa1xufDgayvfMZLCg3D,bWdj2GDclj5ofokWjzoa5jAwMkxCykd6,2,0,0,0,0,0,2,0,2,0.2857142857142857,1,0.0,0,0,0,0,0,0,0,2,0,0,2,1
20000,183832,114X1vLT3OTzchhxfRGg24FTsgrs6Boi,SpATywNh6bZuzm8s1ceuBUnMUAeoAHHw,6,3,1,0,1,1,2,0,8,1.1428571428571428,1,0.0,0,1,0,1,3,1,0,2,0,2,6,1
20001,183833,vjbajDbPbQrGXYYcs1rbmRr6ezhDtDUy,bWdj2GDclj5ofokWjzoa5jAwMkxCykd6,1,0,0,0,0,0,1,0,1,0.14285714285714285,1,0.0,0,0,0,0,0,0,0,1,0,0,1,1
20002,183837,9veooDPdHGt0QPXOfcP4HtwqJxaobeIU,SpATywNh6bZuzm8s1ceuBUnMUAeoAHHw,11,17,3,14,0,8,5,1,48,6.857142857142857,1,0.0,10,3,13,0,7,8,1,5,1,26,22,1
20003,183838,aHceKEl94riboDVp8PRLPCY1XwhHlQv5,SpATywNh6bZuzm8s1ceuBUnMUAeoAHHw,1,0,0,0,0,0,1,0,1,0.14285714285714285,1,0.0,0,0,0,0,0,0,0,1,0,0,1,1
20004,183840,nxF8oaRxp1kRmW1R62DpnweCKcBsKTqd,SpATywNh6bZuzm8s1ceuBUnMUAeoAHHw,10,17,8,0,3,17,4,0,49,7.0,1,0.0,2,8,0,3,15,17,0,4,0,13,36,1
20005,183841,EytS791DMHkWPyEwKtiaQ332ujzLnBwF,bWdj2GDclj5ofokWjzoa5jAwMkxCykd6,5,10,1,0,1,0,2,0,14,2.0,1,0.0,0,1,0,1,10,0,0,2,0,2,12,1
20006,183846,umctuhbIVZDh6EHjPhWargzhNqVIeFMx,RXDvfPUBYFlVdlueBFbLW0mhhAyGEqpt,2,0,0,0,0,0,2,0,2,0.2857142857142857,1,0.0,0,0,0,0,0,0,0,2,0,0,2,1
20007,183861,DIfWHwFZNZPga0SgQhZ5mLJfHSTndMBk,G8EPVSXsOYB5YQWZGiz1aVq5Pgr2GrQu,4,0,0,0,0,1,3,1,5,0.7142857142857143,1,0.0,0,0,0,0,0,1,0,3,1,0,5,1
20008,183863,OyUzOGgEg3D1ADlF5EJGg06nY3QmnkdW,RXDvfPUBYFlVdlueBFbLW0mhhAyGEqpt,15,10,10,0,8,0,7,0,35,5.0,3,0.0,0,10,0,8,10,0,0,7,0,18,17,1
20009,183866,lLsAMLGXDOsZeatceMnZJfI2N4EJjHne,G8EPVSXsOYB5YQWZGiz1aVq5Pgr2GrQu,1,0,0,0,0,0,4,0,4,0.5714285714285714,1,0.0,0,0,0,0,0,0,0,4,0,0,4,1
20010,183878,EnOE2zcU3adIQka8zXE5uaDcwrIceQaF,bWdj2GDclj5ofokWjzoa5jAwMkxCykd6,3,2,0,0,0,0,2,0,4,0.5714285714285714,1,0.0,0,0,0,0,2,0,0,2,0,0,4,1
20011,183879,5wfiCJMdbkN7MkoUGvo3cfz8jV3jCktA,SpATywNh6bZuzm8s1ceuBUnMUAeoAHHw,4,2,1,0,1,0,1,0,5,0.7142857142857143,1,0.0,0,1,0,1,2,0,0,1,0,2,3,1
20012,183881,8qABUnBBHxxZkfUhEQNUn5NNMSRrqvPC,bWdj2GDclj5ofokWjzoa5jAwMkxCykd6,7,4,1,36,0,0,3,1,45,6.428571428571429,1,0.0,2,1,35,0,2,0,1,3,1,38,7,1
20013,183888,TL1aA8ITe7VP42GX52yE5M5UsjXNCOS3,RXDvfPUBYFlVdlueBFbLW0mhhAyGEqpt,14,6,4,10,2,5,4,3,34,4.857142857142857,1,0.0,1,4,9,2,5,5,1,4,3,16,18,1
20014,183892,4wMgOAufqnPs3VhoygBeCYo4HP5tpnQt,SpATywNh6bZuzm8s1ceuBUnMUAeoAHHw,13,22,0,17,0,27,14,2,82,11.714285714285714,2,0.0,6,0,16,0,16,27,1,14,2,22,60,1
20015,183896,0a6HihupPBi4xpjolN637qOYG6WSN1Gx,bWdj2GDclj5ofokWjzoa5jAwMkxCykd6,1,0,0,0,0,0,1,0,1,0.14285714285714285,1,0.0,0,0,0,0,0,0,0,1,0,0,1,1
20016,183897,0a6HihupPBi4xpjolN637qOYG6WSN1Gx,G8EPVSXsOYB5YQWZGiz1aVq5Pgr2GrQu,1,0,0,0,0,0,1,0,1,0.14285714285714285,1,0.0,0,0,0,0,0,0,0,1,0,0,1,1
20017,183902,Z0eVgz6SGtmMg7DreMuN7iJOutansTOw,SpATywNh6bZuzm8s1ceuBUnMUAeoAHHw,5,2,1,0,1,0,2,0,6,0.8571428571428571,1,0.0,0,1,0,1,2,0,0,2,0,2,4,1
20018,183903,Pe0BOQruXYclUh2pOuaZXsDRh9S1JXgK,G8EPVSXsOYB5YQWZGiz1aVq5Pgr2GrQu,15,19,2,14,2,0,2,0,39,5.571428571428571,2,0.0,0,2,13,2,19,0,1,2,0,17,22,1
20019,183927,1dSFrGV3jJZZA6qD4kOvZZNlB08eN9yU,SpATywNh6bZuzm8s1ceuBUnMUAeoAHHw,5,2,1,0,1,0,2,0,6,0.8571428571428571,1,0.0,0,1,0,1,2,0,0,2,0,2,4,1
20020,183929,BDdKHYPp1edgylVPYUBHaWJ6W3VobGdR,bWdj2GDclj5ofokWjzoa5jAwMkxCykd6,1,0,0,0,0,0,1,0,1,0.14285714285714285,1,0.0,0,0,0,0,0,0,0,1,0,0,1,1
20021,183936,MQT2DULvI9Dh4Sv1Ybk3xSqbqkDpET5t,RXDvfPUBYFlVdlueBFbLW0mhhAyGEqpt,5,1,1,0,1,0,3,0,6,0.8571428571428571,1,0.0,0,1,0,1,1,0,0,3,0,2,4,1
20022,183944,OB9oqmKPpcpFDkINdhqqXHF5hvJxfFBy,RXDvfPUBYFlVdlueBFbLW0mhhAyGEqpt,10,6,3,0,4,4,3,1,21,3.0,1,0.0,2,3,0,4,4,4,0,3,1,9,12,1
20023,183945,eswhmtF9u6PPevIa1f1kWFAOOSBwFxOH,SpATywNh6bZuzm8s1ceuBUnMUAeoAHHw,11,12,0,17,0,6,11,0,46,6.571428571428571,1,0.0,5,0,15,0,7,6,2,11,0,20,26,1
20024,183948,FFv9BpeuCytTk0cAY5ewtWqnPg8thMxr,SpATywNh6bZuzm8s1ceuBUnMUAeoAHHw,6,4,1,0,1,0,2,0,8,1.1428571428571428,1,0.0,0,1,0,1,4,0,0,2,0,2,6,1
20025,183956,qWnVRlOPWMpKhlz6DOCzqOXTcukhQiSA,bWdj2GDclj5ofokWjzoa5jAwMkxCykd6,3,2,0,0,0,0,1,0,3,0.42857142857142855,1,0.0,0,0,0,0,2,0,0,1,0,0,3,1
20026,183960,Q1yHZhB4hdcEznkeMey1ms0QifJ1CmdJ,G8EPVSXsOYB5YQWZGiz1aVq5Pgr2GrQu,1,0,0,0,0,0,1,0,1,0.14285714285714285,1,0.0,0,0,0,0,0,0,0,1,0,0,1,1
20027,183961,EWfsPxhCOXyE5eAI95GRpmzvT2SBrtgo,bWdj2GDclj5ofokWjzoa5jAwMkxCykd6,5,2,1,0,1,0,2,0,6,0.8571428571428571,1,0.0,0,1,0,1,2,0,0,2,0,2,4,1
20028,183975,f87pZCpThW6wNSnbexp1IWcK6VsMLCVr,RXDvfPUBYFlVdlueBFbLW0mhhAyGEqpt,19,11,7,14,4,0,2,0,38,5.428571428571429,1,0.0,3,7,14,4,8,0,0,2,0,28,10,1
20029,183982,Y87S79gsUH7x23XztCpMBa6RocL8Wlfk,bWdj2GDclj5ofokWjzoa5jAwMkxCykd6,5,4,0,0,1,0,5,0,10,1.4285714285714286,1,0.0,2,0,0,1,2,0,0,5,0,3,7,0
20030,183983,SEGJwH5xjhu0GixnmBSSBGNuHPRYimOx,SpATywNh6bZuzm8s1ceuBUnMUAeoAHHw,6,4,3,0,3,0,2,0,12,1.7142857142857142,1,0.0,0,3,0,3,4,0,0,2,0,6,6,1
20031,183985,GkZnrGaNbm07rAcHFJINai1bqc5xBBHT,SpATywNh6bZuzm8s1ceuBUnMUAeoAHHw,13,9,5,14,3,0,2,0,33,4.714285714285714,1,0.0,3,5,12,3,6,0,2,2,0,23,10,1
20032,183986,fNmDgjJniXOszcIHzS3zC4fz25NLjlFC,SpATywNh6bZuzm8s1ceuBUnMUAeoAHHw,1,0,0,0,0,0,1,0,1,0.14285714285714285,1,0.0,0,0,0,0,0,0,0,1,0,0,1,1
20033,183989,m4zdr76CpU472F6wsJffFbslI27LpI4g,SpATywNh6bZuzm8s1ceuBUnMUAeoAHHw,4,2,1,0,1,0,1,0,5,0.7142857142857143,1,0.0,0,1,0,1,2,0,0,1,0,2,3,1
20034,183993,dHF0lmwAWj90dNkEJgjhA3G1B2pjJava,bWdj2GDclj5ofokWjzoa5jAwMkxCykd6,1,0,0,0,0,0,1,0,1,0.14285714285714285,1,0.0,0,0,0,0,0,0,0,1,0,0,1,1
20035,183996,37daqGAbA6x2VvXkiqdWX1nBv2Tqqgte,SpATywNh6bZuzm8s1ceuBUnMUAeoAHHw,5,6,2,0,0,0,4,0,12,1.7142857142857142,1,0.0,0,2,0,0,6,0,0,4,0,2,10,1
20036,184009,wB8pBt76NTGPtrvjIdU3pN9EwIWhKGQo,SpATywNh6bZuzm8s1ceuBUnMUAeoAHHw,1,0,0,0,0,0,1,0,1,0.14285714285714285,1,0.0,0,0,0,0,0,0,0,1,0,0,1,1
20037,184012,mEFKCYz8MVHPZugokUhGo6T9qmLFE897,SpATywNh6bZuzm8s1ceuBUnMUAeoAHHw,16,28,10,13,5,2,8,2,68,9.714285714285714,2,0.0,8,10,13,5,20,2,0,8,2,36,32,1
20038,184033,BMzXa4F1HK4MbDTdR0pGzLHAAodUPJ6y,bWdj2GDclj5ofokWjzoa5jAwMkxCykd6,1,0,0,0,0,0,1,0,1,0.14285714285714285,1,0.0,0,0,0,0,0,0,0,1,0,0,1,1
20039,184038,Q12SmIgxAUIk1yKqjdfp0LXtJMgJdL9G,G8EPVSXsOYB5YQWZGiz1aVq5Pgr2GrQu,4,2,1,0,1,0,1,0,5,0.7142857142857143,1,0.0,0,1,0,1,2,0,0,1,0,2,3,1
20040,184039,GuBhksrnBhutuN529M1YtfTMCYIFJ6lY,G8EPVSXsOYB5YQWZGiz1aVq5Pgr2GrQu,12,10,5,0,4,0,2,0,21,3.0,1,0.0,0,5,0,4,10,0,0,2,0,9,12,1
20041,184047,XGJyrNdICrlEhPA3ZH7TFUF5DLeflEqn,SpATywNh6bZuzm8s1ceuBUnMUAeoAHHw,5,2,1,0,1,0,2,0,6,0.8571428571428571,1,0.0,0,1,0,1,2,0,0,2,0,2,4,1
20042,184048,k03NkUiM55XNDdygu6sbcCzBSQB1ke1d,RXDvfPUBYFlVdlueBFbLW0mhhAyGEqpt,11,17,1,0,1,0,4,0,23,3.2857142857142856,2,0.0,4,1,0,1,13,0,0,4,0,6,17,1
20043,184049,e41xflW3FJ2sfkSYCVTAw1yP2aJoqexe,SpATywNh6bZuzm8s1ceuBUnMUAeoAHHw,8,3,2,0,2,0,3,0,10,1.4285714285714286,1,0.0,0,2,0,2,3,0,0,3,0,4,6,1
20044,184060,BggPiWvKnxZgtt6PObC5h6pkP2Vpotku,SpATywNh6bZuzm8s1ceuBUnMUAeoAHHw,6,6,0,0,0,0,1,0,7,1.0,1,0.0,1,0,0,0,5,0,0,1,0,1,6,1
20045,184061,f5Mcw4567TFpDJkhEoRSw0Jz1pQ2BFAk,bWdj2GDclj5ofokWjzoa5jAwMkxCykd6,8,3,2,0,1,9,6,1,22,3.142857142857143,1,0.0,0,2,0,1,3,9,0,6,1,3,19,1
20046,184062,0CZR6JiyNyPl8nfnIp1u7wOec3poXsdF,SpATywNh6bZuzm8s1ceuBUnMUAeoAHHw,2,0,0,0,0,0,3,0,3,0.42857142857142855,1,0.0,0,0,0,0,0,0,0,3,0,0,3,1
20047,184063,Dpc0zozzlSgsLSateIgSdps1xubS3wT6,SpATywNh6bZuzm8s1ceuBUnMUAeoAHHw,7,3,2,0,2,0,2,0,9,1.2857142857142858,1,0.0,0,2,0,2,3,0,0,2,0,4,5,1
20048,184064,4RuLKPumIDuBK6n356cKgw9GML4wpFFR,SpATywNh6bZuzm8s1ceuBUnMUAeoAHHw,3,2,0,0,0,0,1,0,3,0.42857142857142855,1,0.0,0,0,0,0,2,0,0,1,0,0,3,1
20049,184066,qgG4OU0HRuoi21bBKmy9fO5g8h7KcP6E,SpATywNh6bZuzm8s1ceuBUnMUAeoAHHw,1,0,0,0,0,0,2,0,2,0.2857142857142857,1,0.0,0,0,0,0,0,0,0,2,0,0,2,1
20050,184067,OQfqRWOxxNsIi3nGxNChuaOEpiwW2MKx,RXDvfPUBYFlVdlueBFbLW0mhhAyGEqpt,5,2,1,0,1,0,2,0,6,0.8571428571428571,1,0.0,0,1,0,1,2,0,0,2,0,2,4,1
20051,184068,4RuLKPumIDuBK6n356cKgw9GML4wpFFR,bWdj2GDclj5ofokWjzoa5jAwMkxCykd6,1,0,0,0,0,0,1,0,1,0.14285714285714285,1,0.0,0,0,0,0,0,0,0,1,0,0,1,1
20052,184069,8KiAWlLGlDWFZP4JQG4AIAZhrqwvN88h,SpATywNh6bZuzm8s1ceuBUnMUAeoAHHw,3,2,1,0,0,1,2,0,6,0.8571428571428571,1,0.0,0,1,0,0,2,1,0,2,0,1,5,1
20053,184071,BpUC3MNCHd8FaxSe6moajPD8WZk6dYxr,SpATywNh6bZuzm8s1ceuBUnMUAeoAHHw,8,7,3,0,1,0,5,0,16,2.2857142857142856,2,0.0,1,3,0,1,6,0,0,5,0,5,11,1
20054,184075,ZGG633YrnGbNzVczhlK5S0rasrudTzhc,bWdj2GDclj5ofokWjzoa5jAwMkxCykd6,5,2,1,0,1,0,2,0,6,0.8571428571428571,1,0.0,0,1,0,1,2,0,0,2,0,2,4,1
20055,184076,1WYr5BJIApYgFHMSnNu25YjtJhDOUsgy,SpATywNh6bZuzm8s1ceuBUnMUAeoAHHw,6,3,2,0,2,0,1,0,8,1.1428571428571428,1,0.0,0,2,0,2,3,0,0,1,0,4,4,1
20056,184079,CbIcKD0jazBhPd3ibnu0zTtemqpWb0KP,bWdj2GDclj5ofokWjzoa5jAwMkxCykd6,2,0,0,0,0,0,4,0,4,0.5714285714285714,1,0.0,0,0,0,0,0,0,0,4,0,0,4,1
20057,184083,1KWQQsGdbVWUkaTLPILtfeXnjhFZjqBM,G8EPVSXsOYB5YQWZGiz1aVq5Pgr2GrQu,9,17,5,10,0,0,1,0,33,4.714285714285714,1,0.0,11,5,7,0,6,0,3,1,0,23,10,1
20058,184088,NslicJCNMxB9cZhzoMFtRxmqPnqyw5Ii,bWdj2GDclj5ofokWjzoa5jAwMkxCykd6,2,0,0,0,0,0,2,0,2,0.2857142857142857,1,0.0,0,0,0,0,0,0,0,2,0,0,2,1
20059,184089,OcFLLEI56U80V98vNeJ7LrlE5FWxkkpp,G8EPVSXsOYB5YQWZGiz1aVq5Pgr2GrQu,3,0,0,0,0,0,3,0,3,0.42857142857142855,1,0.0,0,0,0,0,0,0,0,3,0,0,3,1
20060,184094,CJe4pjtrcC0FOMy3krEkccqFJZO0Cqq4,bWdj2GDclj5ofokWjzoa5jAwMkxCykd6,1,0,0,0,0,0,1,0,1,0.14285714285714285,1,0.0,0,0,0,0,0,0,0,1,0,0,1,1
20061,184095,P3USQ4ceul2wiH8GV6NzM8M3iSKwMNo4,SpATywNh6bZuzm8s1ceuBUnMUAeoAHHw,5,4,0,0,0,0,3,0,7,1.0,1,0.0,0,0,0,0,4,0,0,3,0,0,7,1
20062,184098,z6xFpyaGUcaO2LWirVvA3M3GqpWgJhqS,SpATywNh6bZuzm8s1ceuBUnMUAeoAHHw,1,0,0,0,0,0,1,0,1,0.14285714285714285,1,0.0,0,0,0,0,0,0,0,1,0,0,1,1
20063,184101,PgqyyO7ndxsbTeXX946lNioQkjXip4tO,SpATywNh6bZuzm8s1ceuBUnMUAeoAHHw,16,16,5,3,4,2,5,1,36,5.142857142857143,1,0.0,4,5,3,4,12,2,0,5,1,16,20,1
20064,184107,qZ6pNkd000rAjy9LHfRpNpwESWSmgGUc,bWdj2GDclj5ofokWjzoa5jAwMkxCykd6,5,1,1,0,1,0,2,0,5,0.7142857142857143,1,0.0,0,1,0,1,1,0,0,2,0,2,3,1
20065,184110,CDBOTUK7uywn5HAqBz0EsxjWXDFENYqJ,SpATywNh6bZuzm8s1ceuBUnMUAeoAHHw,7,5,3,0,2,2,4,1,17,2.4285714285714284,1,0.0,0,3,0,2,5,2,0,4,1,5,12,1
20066,184113,87SYGQjFYUtEWda0pG12bcNker0JGBy3,G8EPVSXsOYB5YQWZGiz1aVq5Pgr2GrQu,4,5,0,0,0,0,1,0,6,0.8571428571428571,1,0.0,0,0,0,0,5,0,0,1,0,0,6,1
20067,184118,s26PJmkfPL2SwqWbKoi56ybE6GBIg4Tm,SpATywNh6bZuzm8s1ceuBUnMUAeoAHHw,7,2,0,0,0,1,7,1,11,1.5714285714285714,1,0.0,0,0,0,0,2,1,0,7,1,0,11,1
20068,184122,uUI9pQoArlf6QZxuJL0Anm2VUW5XAEuG,SpATywNh6bZuzm8s1ceuBUnMUAeoAHHw,6,2,1,0,1,0,3,0,7,1.0,1,0.0,0,1,0,1,2,0,0,3,0,2,5,1
20069,184126,6MUx7O8xcYuB5a5sYqWaf93meZNmeUNV,SpATywNh6bZuzm8s1ceuBUnMUAeoAHHw,1,0,0,0,0,0,1,0,1,0.14285714285714285,1,0.0,0,0,0,0,0,0,0,1,0,0,1,1
20070,184133,4YlVfpMODnahyqQ3n65BCTHXZpXYZLKw,G8EPVSXsOYB5YQWZGiz1aVq5Pgr2GrQu,6,5,1,0,0,0,4,0,10,1.4285714285714286,1,0.0,0,1,0,0,5,0,0,4,0,1,9,1
20071,184142,drGvqw10fBGceNSK8gYikgxOQZE0vxto,SpATywNh6bZuzm8s1ceuBUnMUAeoAHHw,7,6,4,0,3,0,1,0,14,2.0,1,0.0,0,4,0,3,6,0,0,1,0,7,7,1
20072,184150,Ywa3CoCRvYFskTMBH1zQHBLyzuQWtUYW,RXDvfPUBYFlVdlueBFbLW0mhhAyGEqpt,1,0,0,0,0,0,1,0,1,0.14285714285714285,1,0.0,0,0,0,0,0,0,0,1,0,0,1,1
20073,184153,Pb9hmoXos06ovaJ97f9maK0LR5EwPgFN,SpATywNh6bZuzm8s1ceuBUnMUAeoAHHw,1,0,0,0,0,0,1,0,1,0.14285714285714285,1,0.0,0,0,0,0,0,0,0,1,0,0,1,1
20074,184154,4DUZBFD9Fwl71r8i0SB6pVZCzmNoxKnn,RXDvfPUBYFlVdlueBFbLW0mhhAyGEqpt,4,2,1,0,1,0,1,0,5,0.7142857142857143,1,0.0,0,1,0,1,2,0,0,1,0,2,3,1
20075,184156,4DUZBFD9Fwl71r8i0SB6pVZCzmNoxKnn,bWdj2GDclj5ofokWjzoa5jAwMkxCykd6,6,3,2,0,2,0,1,0,8,1.1428571428571428,1,0.0,0,2,0,2,3,0,0,1,0,4,4,1
20076,184160,h58kvDL22TD1HjsSMB6VxjCw9rBsMnsj,SpATywNh6bZuzm8s1ceuBUnMUAeoAHHw,15,18,9,6,5,4,4,0,46,6.571428571428571,2,0.0,7,9,6,5,11,4,0,4,0,27,19,1
20077,184165,oQLN4c1EqhMjc5I7s4sQvYxTs3qNNEKF,SpATywNh6bZuzm8s1ceuBUnMUAeoAHHw,1,0,0,0,0,0,1,0,1,0.14285714285714285,1,0.0,0,0,0,0,0,0,0,1,0,0,1,1
20078,184169,CalIeuRUuDsI51PX7a2T0B5AXb9dl64K,SpATywNh6bZuzm8s1ceuBUnMUAeoAHHw,1,0,0,0,0,0,1,0,1,0.14285714285714285,1,0.0,0,0,0,0,0,0,0,1,0,0,1,1
20079,184170,zx92A3etlZOmjWi19IMDYlwaWCkvF08z,bWdj2GDclj5ofokWjzoa5jAwMkxCykd6,3,2,0,0,0,0,2,0,4,0.5714285714285714,1,0.0,0,0,0,0,2,0,0,2,0,0,4,0
20080,184180,w0NgQbkpBdIfJsaBSOoX4c1UgwA7dN8N,RXDvfPUBYFlVdlueBFbLW0mhhAyGEqpt,11,5,5,0,4,1,4,2,21,3.0,1,0.0,0,5,0,4,5,1,0,4,2,9,12,1
20081,184182,7EvTIqysZmn3AonROhXlIbdOubKSMiWg,G8EPVSXsOYB5YQWZGiz1aVq5Pgr2GrQu,5,2,1,0,1,0,2,0,6,0.8571428571428571,1,0.0,0,1,0,1,2,0,0,2,0,2,4,1
20082,184183,i39wrwOFUT4cBFVx9tMMQ3lQ2qJwZK9W,bWdj2GDclj5ofokWjzoa5jAwMkxCykd6,11,9,4,38,2,2,4,1,60,8.571428571428571,1,0.0,1,4,35,2,8,2,3,4,1,42,18,1
20083,184189,wTZQy1XFMokTUfJmtWSLn3pA2hHc02jP,G8EPVSXsOYB5YQWZGiz1aVq5Pgr2GrQu,13,13,7,0,1,0,15,1,37,5.285714285714286,1,0.0,0,7,0,1,13,0,0,15,1,8,29,1
20084,184192,t5YYcIeNMVb3RFW5w6rNVr5dnA806rKL,SpATywNh6bZuzm8s1ceuBUnMUAeoAHHw,7,4,3,0,3,8,3,0,21,3.0,1,0.0,0,3,0,3,4,8,0,3,0,6,15,1
20085,184195,pumsIIBvkIDHPLuElv7OSuQxwiyrjr12,bWdj2GDclj5ofokWjzoa5jAwMkxCykd6,4,4,1,0,1,0,1,0,7,1.0,1,0.0,1,1,0,1,3,0,0,1,0,3,4,1
20086,184201,AFZF0g5bqQh2xcoSPcZTvnmo1YmyGZbs,bWdj2GDclj5ofokWjzoa5jAwMkxCykd6,6,5,2,0,2,0,3,0,12,1.7142857142857142,2,0.0,0,2,0,2,5,0,0,3,0,4,8,1
20087,184202,XAN5G2SZeU8Zht7MvC5iqTKg1rYC9VmO,G8EPVSXsOYB5YQWZGiz1aVq5Pgr2GrQu,5,7,0,2,1,0,2,0,12,1.7142857142857142,1,0.0,5,0,1,1,2,0,1,2,0,7,5,1
20088,184203,cCvHnoX6St5OTmXQ2AOInGyMnqlmS6DL,bWdj2GDclj5ofokWjzoa5jAwMkxCykd6,5,2,1,0,1,0,4,0,8,1.1428571428571428,1,0.0,0,1,0,1,2,0,0,4,0,2,6,1
20089,184207,CR6hbwvXPZHEYYcI4AAX4civM4Pp6Aex,SpATywNh6bZuzm8s1ceuBUnMUAeoAHHw,5,2,1,0,1,0,2,0,6,0.8571428571428571,1,0.0,0,1,0,1,2,0,0,2,0,2,4,1
20090,184209,H3w465L7hDzZfQglT7xQ9IAtKqV2E37U,bWdj2GDclj5ofokWjzoa5jAwMkxCykd6,1,0,0,0,0,0,1,0,1,0.14285714285714285,1,0.0,0,0,0,0,0,0,0,1,0,0,1,1
20091,184210,7bvRPEYYTDBXOreNFj9y4lO2i874OSqr,5Gyp41oLVo7Gg7vF4vpmggWP5MU70QO6,7,6,3,0,4,0,2,0,15,2.142857142857143,1,0.0,2,3,0,4,4,0,0,2,0,9,6,1
20092,184219,nRLTavEl1bXxEwhFINnyKEh9SYy7D5ak,5Gyp41oLVo7Gg7vF4vpmggWP5MU70QO6,1,0,0,0,0,0,1,0,1,0.14285714285714285,1,0.0,0,0,0,0,0,0,0,1,0,0,1,1
20093,184226,iZ7oRof6XG94oKpKDEWLYsJz0T3reAxj,5Gyp41oLVo7Gg7vF4vpmggWP5MU70QO6,16,17,8,0,7,0,7,0,39,5.571428571428571,3,0.0,4,8,0,7,13,0,0,7,0,19,20,1
20094,184235,qlzaQ9z7TvE1mLftjvyiINQnnHC8FPLg,5Gyp41oLVo7Gg7vF4vpmggWP5MU70QO6,12,16,6,6,3,0,2,0,33,4.714285714285714,1,0.0,9,6,3,3,7,0,3,2,0,21,12,1
20095,184239,p7E5WenzaLCPubjqWttrcLkeJXAFmBEE,5Gyp41oLVo7Gg7vF4vpmggWP5MU70QO6,30,47,22,4,17,1,10,1,102,14.571428571428571,3,0.0,13,22,2,17,34,1,2,10,1,54,48,1
20096,184248,5EA5jBdNRAYMCxVAAIbQ9BEkwXmNW6e8,5Gyp41oLVo7Gg7vF4vpmggWP5MU70QO6,6,1,1,0,1,0,3,0,6,0.8571428571428571,1,0.0,0,1,0,1,1,0,0,3,0,2,4,1
20097,184253,HwQlDqQYrfHrBUx2SSkCNQ3Dej1xgfkf,5Gyp41oLVo7Gg7vF4vpmggWP5MU70QO6,2,0,0,0,0,0,2,0,2,0.2857142857142857,1,0.0,0,0,0,0,0,0,0,2,0,0,2,1
20098,184261,6k3nF0wSBDpE8ld5di4cKFHOiA6X24CO,5Gyp41oLVo7Gg7vF4vpmggWP5MU70QO6,14,36,2,10,1,1,14,1,65,9.285714285714286,1,0.0,12,2,5,1,24,1,5,14,1,20,45,1
20099,184263,kljbMpKSiyf0BGkQTUWVZEQjOuteaXYS,5Gyp41oLVo7Gg7vF4vpmggWP5MU70QO6,1,0,0,0,0,0,1,0,1,0.14285714285714285,1,0.0,0,0,0,0,0,0,0,1,0,0,1,1
20100,184268,VckH4WJ96SSx6wIhwSpi3Xlnloun2d0o,5Gyp41oLVo7Gg7vF4vpmggWP5MU70QO6,8,1,1,0,1,2,7,1,13,1.8571428571428572,1,0.0,0,1,0,1,1,2,0,7,1,2,11,1
20101,184271,PlmrtTR7uQeuggKkwRFHO3eqd7sy7ewH,5Gyp41oLVo7Gg7vF4vpmggWP5MU70QO6,5,0,0,0,0,0,6,1,7,1.0,1,0.0,0,0,0,0,0,0,0,6,1,0,7,1
20102,184282,Pa6q3GURVMOLQ4UwIHvezCuS8k4QUsk2,5Gyp41oLVo7Gg7vF4vpmggWP5MU70QO6,6,3,1,0,1,0,2,0,7,1.0,1,0.0,0,1,0,1,3,0,0,2,0,2,5,1
20103,184287,DA1oHIB5igyhRc983tgLidUmLqZEjW60,5Gyp41oLVo7Gg7vF4vpmggWP5MU70QO6,7,3,2,0,2,1,3,0,11,1.5714285714285714,1,0.0,0,2,0,2,3,1,0,3,0,4,7,1
20104,184293,SV0dVmzZ9aNkkaStnkvyjzO8rS13Hmyj,5Gyp41oLVo7Gg7vF4vpmggWP5MU70QO6,1,0,0,0,0,0,1,0,1,0.14285714285714285,1,0.0,0,0,0,0,0,0,0,1,0,0,1,1
20105,184300,M9QVnbr7cTEOdDrjV7tSlms6MFtjz4TS,5Gyp41oLVo7Gg7vF4vpmggWP5MU70QO6,1,0,0,0,0,0,1,0,1,0.14285714285714285,1,0.0,0,0,0,0,0,0,0,1,0,0,1,1
20106,184314,XmbLwxmQRLXz9T2ULgWW6uwVskMK6ds2,5Gyp41oLVo7Gg7vF4vpmggWP5MU70QO6,8,5,3,0,2,0,2,0,12,1.7142857142857142,1,0.0,1,3,0,2,4,0,0,2,0,6,6,1
20107,184336,sJGJVFEmmILnCJO6pOFT54G9IGYlntDf,5Gyp41oLVo7Gg7vF4vpmggWP5MU70QO6,9,7,4,0,3,0,4,0,18,2.5714285714285716,1,0.0,0,4,0,3,7,0,0,4,0,7,11,1
20108,184346,dNX4sxsHS3PyeepKusHD7nMAg2KIqXVR,5Gyp41oLVo7Gg7vF4vpmggWP5MU70QO6,1,0,0,0,0,0,1,0,1,0.14285714285714285,1,0.0,0,0,0,0,0,0,0,1,0,0,1,1
20109,184361,jtCtHXWOBSTdlKr2tdadcDS8tG5gL3Cm,5Gyp41oLVo7Gg7vF4vpmggWP5MU70QO6,9,5,3,2,2,1,3,0,16,2.2857142857142856,1,0.0,1,3,1,2,4,1,1,3,0,7,9,1
20110,184363,sMXQ0lkwphZtOVOIVFSXKBg9Mbshvueh,5Gyp41oLVo7Gg7vF4vpmggWP5MU70QO6,1,0,0,0,0,0,1,0,1,0.14285714285714285,1,0.0,0,0,0,0,0,0,0,1,0,0,1,1
20111,184366,p4aeChS8V6sdii1fWMpHqOr9sw3fUVpL,5Gyp41oLVo7Gg7vF4vpmggWP5MU70QO6,13,13,6,2,3,0,7,1,32,4.571428571428571,1,0.0,4,6,1,3,9,0,1,7,1,14,18,1
20112,184394,kD8T4ioGqK698fH7TafuUEANu5M3X5ow,5Gyp41oLVo7Gg7vF4vpmggWP5MU70QO6,6,1,1,0,0,0,6,0,8,1.1428571428571428,1,0.0,0,1,0,0,1,0,0,6,0,1,7,1
20113,184400,fNOKspiygoNPyc9Zya8bx8zgsbzNMYEl,5Gyp41oLVo7Gg7vF4vpmggWP5MU70QO6,6,5,2,0,1,0,2,0,10,1.4285714285714286,1,0.0,1,2,0,1,4,0,0,2,0,4,6,1
20114,184413,3rKo42EDqTNzb1FHWny9vqyq3QGKHWYi,3VkHkmOtom3jM2wCu94xgzzu1d6Dn7or,1,0,0,0,0,0,2,0,2,0.2857142857142857,1,0.0,0,0,0,0,0,0,0,2,0,0,2,1
20115,184414,guLH9RbgvmZyGJHxVlHaGdPm3YO3PNP3,3VkHkmOtom3jM2wCu94xgzzu1d6Dn7or,1,0,0,0,0,0,1,0,1,0.14285714285714285,1,0.0,0,0,0,0,0,0,0,1,0,0,1,1
20116,184420,Uf5uqVmgXOGUVyzUwqRVeif27urJpV9D,3VkHkmOtom3jM2wCu94xgzzu1d6Dn7or,1,0,0,0,0,0,2,0,2,0.2857142857142857,1,0.0,0,0,0,0,0,0,0,2,0,0,2,1
20117,184425,GPYLW7Qeuhldo4zJYdA9fPSL7bxzMkqH,3VkHkmOtom3jM2wCu94xgzzu1d6Dn7or,12,25,13,0,2,0,10,2,52,7.428571428571429,1,0.0,1,13,0,2,24,0,0,10,2,16,36,1
20118,184444,SXvBkPRiDf0mOsIrim49rPjWxu2nZJ38,3VkHkmOtom3jM2wCu94xgzzu1d6Dn7or,1,0,0,0,0,0,1,0,1,0.14285714285714285,1,0.0,0,0,0,0,0,0,0,1,0,0,1,1
20119,184483,dmhkL35doRyRiXlb3XuDnJlpO05GLvg1,3VkHkmOtom3jM2wCu94xgzzu1d6Dn7or,1,0,0,0,0,0,1,0,1,0.14285714285714285,1,0.0,0,0,0,0,0,0,0,1,0,0,1,1
20120,184488,obivpgNgj6Uz2dRJhIgqdDGHGOMzyFaS,3VkHkmOtom3jM2wCu94xgzzu1d6Dn7or,1,0,0,0,0,0,1,0,1,0.14285714285714285,1,0.0,0,0,0,0,0,0,0,1,0,0,1,1
20121,184497,QyJU33UpOIhHeH2JlPisscvkAnmS8XIo,3VkHkmOtom3jM2wCu94xgzzu1d6Dn7or,1,0,0,0,0,0,1,0,1,0.14285714285714285,1,0.0,0,0,0,0,0,0,0,1,0,0,1,1
20122,184503,J8NkUmSvsrLHkKNXPhFg7o0pG3K7Aywh,3VkHkmOtom3jM2wCu94xgzzu1d6Dn7or,27,51,11,30,23,20,7,1,143,20.428571428571427,1,0.0,37,11,27,23,14,20,3,7,1,98,45,1
20123,184551,Wpgt21OSEq4dKkRxDfadQJL5vA48tiTa,3VkHkmOtom3jM2wCu94xgzzu1d6Dn7or,1,0,0,0,0,0,1,0,1,0.14285714285714285,1,0.0,0,0,0,0,0,0,0,1,0,0,1,1
20124,184561,ozNhkkamO29sRihJesqDynSkMc9IakXW,3VkHkmOtom3jM2wCu94xgzzu1d6Dn7or,1,0,0,0,0,0,2,0,2,0.2857142857142857,1,0.0,0,0,0,0,0,0,0,2,0,0,2,1
20125,184584,gVURM5KTzMzvAobuwS47q0liMn7aNDRj,3VkHkmOtom3jM2wCu94xgzzu1d6Dn7or,2,0,0,0,0,0,2,0,2,0.2857142857142857,1,0.0,0,0,0,0,0,0,0,2,0,0,2,1
20126,184589,FHy8g1cEh82PEcyEfOIdRe9C7Etj43yh,3VkHkmOtom3jM2wCu94xgzzu1d6Dn7or,4,0,0,0,0,0,4,0,4,0.5714285714285714,1,0.0,0,0,0,0,0,0,0,4,0,0,4,1
20127,184593,JE4RM1E1GtVC1JJ9Kdz0YYh3efeu94DE,3VkHkmOtom3jM2wCu94xgzzu1d6Dn7or,1,0,0,0,0,0,1,0,1,0.14285714285714285,1,0.0,0,0,0,0,0,0,0,1,0,0,1,1
20128,184599,Y5vbMeMNGfsVjyyEe13ZzpM37CaJrsxM,3VkHkmOtom3jM2wCu94xgzzu1d6Dn7or,14,11,5,0,5,1,23,0,45,6.428571428571429,1,0.0,4,5,0,5,7,1,0,23,0,14,31,1
20129,184602,ssWxad5FsRCaOzAncjBPd10wMjCodzee,3VkHkmOtom3jM2wCu94xgzzu1d6Dn7or,1,0,0,0,0,0,1,0,1,0.14285714285714285,1,0.0,0,0,0,0,0,0,0,1,0,0,1,1
20130,184631,nEdLTHDRzkhr5Ltp2hTJhuuwf36aLCXo,3VkHkmOtom3jM2wCu94xgzzu1d6Dn7or,1,0,0,0,0,0,1,0,1,0.14285714285714285,1,0.0,0,0,0,0,0,0,0,1,0,0,1,1
20131,184635,gqrHNH5DBG72cqSpAcse3l1mSsO9h8ID,3VkHkmOtom3jM2wCu94xgzzu1d6Dn7or,1,0,0,0,0,0,1,0,1,0.14285714285714285,1,0.0,0,0,0,0,0,0,0,1,0,0,1,1
20132,184648,TiN4z0dSpp09iMKqN066qAoKwqCoLlNB,3VkHkmOtom3jM2wCu94xgzzu1d6Dn7or,4,3,2,0,2,0,1,0,8,1.1428571428571428,1,0.0,0,2,0,2,3,0,0,1,0,4,4,1
20133,184657,NBGFp0gUGl7pGZsh0AwbN5ZSq40YlIJ2,3VkHkmOtom3jM2wCu94xgzzu1d6Dn7or,1,0,0,0,0,0,2,0,2,0.2857142857142857,1,0.0,0,0,0,0,0,0,0,2,0,0,2,1
20134,184658,EbMElu3ne7Vb3OjNBzMAyF7HKKBmGMQc,3VkHkmOtom3jM2wCu94xgzzu1d6Dn7or,1,0,0,0,0,0,1,0,1,0.14285714285714285,1,0.0,0,0,0,0,0,0,0,1,0,0,1,1
20135,184660,l9VF7PxUTdTjw9PoeZ8vuGbnxVikaOqm,3VkHkmOtom3jM2wCu94xgzzu1d6Dn7or,3,0,0,0,0,0,4,0,4,0.5714285714285714,1,0.0,0,0,0,0,0,0,0,4,0,0,4,1
20136,184676,hjTlTldX3nv2rdUD7FZwX9ixWL4HYfi0,3VkHkmOtom3jM2wCu94xgzzu1d6Dn7or,7,5,2,0,2,0,2,0,11,1.5714285714285714,1,0.0,0,2,0,2,5,0,0,2,0,4,7,1
20137,184684,DLwvun835EDsVNPiO5RWf5L2mqvJqG24,3VkHkmOtom3jM2wCu94xgzzu1d6Dn7or,1,0,0,0,0,0,2,0,2,0.2857142857142857,1,0.0,0,0,0,0,0,0,0,2,0,0,2,1
20138,184696,K8wSMcFk6kWIslENfngvILH7dw4LUtxA,3VkHkmOtom3jM2wCu94xgzzu1d6Dn7or,1,0,0,0,0,0,1,0,1,0.14285714285714285,1,0.0,0,0,0,0,0,0,0,1,0,0,1,1
20139,184721,FsN3EYiAfRxm9msVQNiGujMlmaZjdiLV,3VkHkmOtom3jM2wCu94xgzzu1d6Dn7or,1,0,0,0,0,0,1,0,1,0.14285714285714285,1,0.0,0,0,0,0,0,0,0,1,0,0,1,1
20140,184733,gk4vmSGzuoTlRCezpW4fwbH64RLSSSIP,3VkHkmOtom3jM2wCu94xgzzu1d6Dn7or,5,2,1,0,1,0,3,0,7,1.0,1,0.0,0,1,0,1,2,0,0,3,0,2,5,1
20141,184760,cKMSHNo94s836f7j8aPXbepJtLJaszYV,3VkHkmOtom3jM2wCu94xgzzu1d6Dn7or,8,6,3,0,2,0,7,0,18,2.5714285714285716,1,0.0,0,3,0,2,6,0,0,7,0,5,13,1
20142,184787,uSToVUcl7sIuWsbjUGg0o72Kpa98eG8A,3VkHkmOtom3jM2wCu94xgzzu1d6Dn7or,1,0,0,0,0,0,1,0,1,0.14285714285714285,1,0.0,0,0,0,0,0,0,0,1,0,0,1,1
20143,184818,ATMWI1P8iLpd6GJhDJ5fN7MDX7N1RYWE,3VkHkmOtom3jM2wCu94xgzzu1d6Dn7or,1,0,0,0,0,0,1,0,1,0.14285714285714285,1,0.0,0,0,0,0,0,0,0,1,0,0,1,1
20144,185697,sZk8u46TtWwCnXAO1CfZDLpjuO4MvayN,SpATywNh6bZuzm8s1ceuBUnMUAeoAHHw,1,0,0,0,0,0,1,0,1,0.14285714285714285,1,0.0,0,0,0,0,0,0,0,1,0,0,1,1
20145,185699,iHtSvehLiNBG0wCDW2WxQ7UVFKpHQkCr,G8EPVSXsOYB5YQWZGiz1aVq5Pgr2GrQu,7,2,0,0,1,0,5,1,9,1.2857142857142858,2,0.0,0,0,0,1,2,0,0,5,1,1,8,1
20146,185701,V02ryEmMmqjGIIiLHIkYu0vvVMLeyKKP,SpATywNh6bZuzm8s1ceuBUnMUAeoAHHw,4,2,0,0,0,0,2,0,4,0.5714285714285714,1,0.0,0,0,0,0,2,0,0,2,0,0,4,1
20147,185711,uhhlffPGiUyqHwKWs4eYUM0KXbbqijwF,bWdj2GDclj5ofokWjzoa5jAwMkxCykd6,5,2,1,0,1,0,3,0,7,1.0,1,0.0,0,1,0,1,2,0,0,3,0,2,5,1
20148,185712,cqvPqhuUpY41CAAgpjP0jUqubyRnUma9,A3fsA9Zfv1X2fVEQhTw51lKENdNrEqT3,12,10,0,10,0,0,4,0,24,3.4285714285714284,1,0.0,0,0,9,0,10,0,1,4,0,9,15,1
20149,185717,xMPYVkKLJasLVs71q8GhDTIiypmAhLbm,bWdj2GDclj5ofokWjzoa5jAwMkxCykd6,4,2,0,0,0,0,2,0,4,0.5714285714285714,1,0.0,0,0,0,0,2,0,0,2,0,0,4,1
20150,185719,DedOVhQ90meYxq6Misau3AEJ23SFBM8N,SpATywNh6bZuzm8s1ceuBUnMUAeoAHHw,3,0,0,0,0,0,3,1,4,0.5714285714285714,1,0.0,0,0,0,0,0,0,0,3,1,0,4,1
20151,185720,pnqwjatzPNd5f8exo5KMAGnQXVJnxQke,bWdj2GDclj5ofokWjzoa5jAwMkxCykd6,1,0,0,0,0,0,1,0,1,0.14285714285714285,1,0.0,0,0,0,0,0,0,0,1,0,0,1,1
20152,185721,9SQvvdARLUcjeNs1HN0rEVcQQDFBRIFU,SpATywNh6bZuzm8s1ceuBUnMUAeoAHHw,13,20,8,22,5,0,6,0,61,8.714285714285714,4,0.0,4,8,18,5,16,0,4,6,0,35,26,0
20153,185735,IO3o6QwloFvMHM9ifw0qIeLDZXWrcK99,G8EPVSXsOYB5YQWZGiz1aVq5Pgr2GrQu,11,25,7,2,4,0,6,0,44,6.285714285714286,1,0.0,7,7,2,4,18,0,0,6,0,20,24,1
20154,185740,alnogGpZqhBWQHh6ZLeZUIXk896ksLOu,A3fsA9Zfv1X2fVEQhTw51lKENdNrEqT3,8,13,1,0,0,0,8,2,24,3.4285714285714284,1,0.0,0,1,0,0,13,0,0,8,2,1,23,1
20155,185749,4iA1ycKJBUtgZZkZgkIUFUIpxxqEAlGx,bWdj2GDclj5ofokWjzoa5jAwMkxCykd6,2,0,0,0,0,0,2,0,2,0.2857142857142857,1,0.0,0,0,0,0,0,0,0,2,0,0,2,1
20156,185751,MbewcgzgToNhp9B6eaNSolme5R0M2nkY,SpATywNh6bZuzm8s1ceuBUnMUAeoAHHw,26,40,3,10,2,0,7,0,62,8.857142857142858,3,0.0,6,3,9,2,34,0,1,7,0,20,42,1
20157,185762,wi94HT3Va3Hif8CpMS1WVbL5a71j9CMb,A3fsA9Zfv1X2fVEQhTw51lKENdNrEqT3,23,3,2,84,0,0,4,0,93,13.285714285714286,1,0.0,1,2,65,0,2,0,19,4,0,68,25,1
20158,185773,VDLlgOqW7FFpT6uHqFXXlnnZR1JOz0x8,SpATywNh6bZuzm8s1ceuBUnMUAeoAHHw,2,0,0,0,0,0,2,0,2,0.2857142857142857,1,0.0,0,0,0,0,0,0,0,2,0,0,2,1
20159,185778,oIHEiOwjcaMd5CeWZdkq4rXU3yelDWwT,A3fsA9Zfv1X2fVEQhTw51lKENdNrEqT3,40,25,13,50,11,0,10,0,109,15.571428571428571,1,0.0,1,13,50,11,24,0,0,10,0,75,34,1
20160,185781,b247UYxQmorWoByqHaWMP4yZ1NRODrQz,SpATywNh6bZuzm8s1ceuBUnMUAeoAHHw,8,4,0,0,0,0,6,1,11,1.5714285714285714,1,0.0,0,0,0,0,4,0,0,6,1,0,11,1
20161,185783,XLVBkGRL2w5Wpk8oB8gzWVUvCGz9Rhlw,SpATywNh6bZuzm8s1ceuBUnMUAeoAHHw,1,0,0,0,0,0,1,0,1,0.14285714285714285,1,0.0,0,0,0,0,0,0,0,1,0,0,1,1
20162,185788,ggqCYexsMA3gqHfUfLE6gTs4JZ2aYAma,G8EPVSXsOYB5YQWZGiz1aVq5Pgr2GrQu,5,2,1,0,1,2,2,0,8,1.1428571428571428,1,0.0,0,1,0,1,2,2,0,2,0,2,6,1
20163,185789,KsZJWOsbWvg6N1GJmMWPndE2481JZ5k3,A3fsA9Zfv1X2fVEQhTw51lKENdNrEqT3,12,9,3,0,2,1,8,0,23,3.2857142857142856,1,0.0,0,3,0,2,9,1,0,8,0,5,18,1
20164,185799,5vZRuON34JUuUxkGF08Mu94iTiQzZas4,A3fsA9Zfv1X2fVEQhTw51lKENdNrEqT3,14,11,7,0,4,0,5,0,27,3.857142857142857,2,0.0,0,7,0,4,11,0,0,5,0,11,16,1
20165,185800,UiNc6Olm5OJvjLtbHiGutXVBHbKcOCGc,G8EPVSXsOYB5YQWZGiz1aVq5Pgr2GrQu,9,5,2,0,2,0,4,1,14,2.0,1,0.0,0,2,0,2,5,0,0,4,1,4,10,1
20166,185802,OuF01YeNHtVi6Jk1MFlWzs0i66xxscb1,bWdj2GDclj5ofokWjzoa5jAwMkxCykd6,4,2,0,0,0,0,3,0,5,0.7142857142857143,1,0.0,0,0,0,0,2,0,0,3,0,0,5,1
20167,185803,p54dVByd9epbS397rAmrAwTW19iwa3UI,A3fsA9Zfv1X2fVEQhTw51lKENdNrEqT3,2,0,0,0,0,0,2,0,2,0.2857142857142857,2,0.0,0,0,0,0,0,0,0,2,0,0,2,1
20168,185805,ggqCYexsMA3gqHfUfLE6gTs4JZ2aYAma,A3fsA9Zfv1X2fVEQhTw51lKENdNrEqT3,1,0,0,0,0,0,1,0,1,0.14285714285714285,1,0.0,0,0,0,0,0,0,0,1,0,0,1,1
20169,185808,ggqCYexsMA3gqHfUfLE6gTs4JZ2aYAma,RXDvfPUBYFlVdlueBFbLW0mhhAyGEqpt,1,0,0,0,0,0,1,0,1,0.14285714285714285,1,0.0,0,0,0,0,0,0,0,1,0,0,1,1
20170,185810,ggqCYexsMA3gqHfUfLE6gTs4JZ2aYAma,bWdj2GDclj5ofokWjzoa5jAwMkxCykd6,1,0,0,0,0,0,1,0,1,0.14285714285714285,1,0.0,0,0,0,0,0,0,0,1,0,0,1,1
20171,185816,lMDmp2qNyRczEhhMTcMnsuhXMIgG5u4z,SpATywNh6bZuzm8s1ceuBUnMUAeoAHHw,8,5,2,0,2,0,4,0,13,1.8571428571428572,1,0.0,0,2,0,2,5,0,0,4,0,4,9,1
20172,185822,xr2T8ak6swOOfU9oanYvPbQ4STab9s9f,A3fsA9Zfv1X2fVEQhTw51lKENdNrEqT3,17,19,1,2,1,0,8,0,31,4.428571428571429,3,0.0,0,1,2,1,19,0,0,8,0,4,27,1
20173,185827,BiROhpVKZVE8DbOW78DzcMxwLwnrk2vP,SpATywNh6bZuzm8s1ceuBUnMUAeoAHHw,4,2,0,0,0,0,2,0,4,0.5714285714285714,1,0.0,0,0,0,0,2,0,0,2,0,0,4,1
20174,185865,KqT70GlMbxQHBXiXc69IrkuqKmM7JyJa,A3fsA9Zfv1X2fVEQhTw51lKENdNrEqT3,1,0,0,0,0,0,1,0,1,0.14285714285714285,1,0.0,0,0,0,0,0,0,0,1,0,0,1,1
20175,185873,fjIKsKO6rizBomnPFn2db56S1nui3RlN,RXDvfPUBYFlVdlueBFbLW0mhhAyGEqpt,10,7,5,0,3,4,5,0,24,3.4285714285714284,1,0.0,1,5,0,3,6,4,0,5,0,9,15,1
20176,185875,a7oEKWybXixFIxItLioFkgXev62XcPSx,SpATywNh6bZuzm8s1ceuBUnMUAeoAHHw,7,3,2,0,2,0,2,0,9,1.2857142857142858,1,0.0,0,2,0,2,3,0,0,2,0,4,5,1
20177,185876,BCr2GOpOyeEKOuzlRV7PJCL1CEnRyr6Q,bWdj2GDclj5ofokWjzoa5jAwMkxCykd6,1,0,0,0,0,0,1,0,1,0.14285714285714285,1,0.0,0,0,0,0,0,0,0,1,0,0,1,1
20178,185888,GHTsld2FtHJjs2ejBig6RPBMNqBTieZV,G8EPVSXsOYB5YQWZGiz1aVq5Pgr2GrQu,1,0,0,0,0,0,1,0,1,0.14285714285714285,1,0.0,0,0,0,0,0,0,0,1,0,0,1,1
20179,185899,HXRY1mkagv1TklYNb6z2U5DQSLEv5d2U,bWdj2GDclj5ofokWjzoa5jAwMkxCykd6,3,2,0,0,0,0,2,0,4,0.5714285714285714,1,0.0,0,0,0,0,2,0,0,2,0,0,4,1
20180,185912,l6rkobnqEUKXFQnaBVgonlwU5l25TkcG,SpATywNh6bZuzm8s1ceuBUnMUAeoAHHw,7,4,3,0,3,0,3,0,13,1.8571428571428572,1,0.0,0,3,0,3,4,0,0,3,0,6,7,1
20181,185917,qU5mfkjhD9M0R49RmBMaCeXLeTqIOyhm,bWdj2GDclj5ofokWjzoa5jAwMkxCykd6,7,8,1,0,0,1,7,2,19,2.7142857142857144,1,0.0,0,1,0,0,8,1,0,7,2,1,18,1
20182,185926,BFrfDseDfXCBvtTfCsJAy36Ogk6b0Rfx,bWdj2GDclj5ofokWjzoa5jAwMkxCykd6,6,5,2,0,2,0,1,0,10,1.4285714285714286,1,0.0,0,2,0,2,5,0,0,1,0,4,6,1
20183,185934,YisM8PtG7Ux1VoDWsMxvoOKtYDxnQIkB,SpATywNh6bZuzm8s1ceuBUnMUAeoAHHw,7,6,1,0,0,0,3,0,10,1.4285714285714286,2,0.0,0,1,0,0,6,0,0,3,0,1,9,0
20184,185935,g3k1QLHPwEzAuA17RgcYJkFPtaOb0o3B,SpATywNh6bZuzm8s1ceuBUnMUAeoAHHw,6,3,1,0,1,0,2,0,7,1.0,1,0.0,0,1,0,1,3,0,0,2,0,2,5,1
20185,185940,JpOYg97nyPxwnn3z2vFN1FK1LYz5DhTY,A3fsA9Zfv1X2fVEQhTw51lKENdNrEqT3,6,2,1,0,1,0,3,0,7,1.0,1,0.0,0,1,0,1,2,0,0,3,0,2,5,1
20186,185947,ztsQNM9uMd9SZEOM5x5YQ0KVKbbr5L7g,SpATywNh6bZuzm8s1ceuBUnMUAeoAHHw,5,2,1,0,1,0,2,0,6,0.8571428571428571,1,0.0,0,1,0,1,2,0,0,2,0,2,4,1
20187,185967,pyMEb6x72KY9mgbYMOoJOte9pQweaRy0,A3fsA9Zfv1X2fVEQhTw51lKENdNrEqT3,4,2,0,0,0,0,2,0,4,0.5714285714285714,1,0.0,0,0,0,0,2,0,0,2,0,0,4,1
20188,185977,q3IBH9ErSFzy7COPLzEQoKQuyHgNCnZt,SpATywNh6bZuzm8s1ceuBUnMUAeoAHHw,4,2,1,0,1,0,2,0,6,0.8571428571428571,1,0.0,0,1,0,1,2,0,0,2,0,2,4,1
20189,185981,9GkiQywusvhD7mWAdJSKQKuF3YnhYHyY,SpATywNh6bZuzm8s1ceuBUnMUAeoAHHw,4,4,0,0,0,0,3,0,7,1.0,1,0.0,0,0,0,0,4,0,0,3,0,0,7,1
20190,185989,HHr7pweQNhEg4xRoOlqDUkqUpKwnfVTC,bWdj2GDclj5ofokWjzoa5jAwMkxCykd6,4,2,1,0,1,0,1,0,5,0.7142857142857143,1,0.0,0,1,0,1,2,0,0,1,0,2,3,1
20191,185993,4lIBX7jVNURqeuVw7y54KWNhg5lYseZ6,A3fsA9Zfv1X2fVEQhTw51lKENdNrEqT3,16,15,10,0,0,6,9,0,40,5.714285714285714,1,0.0,0,10,0,0,15,6,0,9,0,10,30,1
20192,185996,rqLYGFT8OdZ1rVwTL6aA81jhg4BwFBcq,SpATywNh6bZuzm8s1ceuBUnMUAeoAHHw,11,26,15,4,8,7,5,0,65,9.285714285714286,3,0.0,4,15,4,8,22,7,0,5,0,31,34,1
20193,186008,OQ7W8hYEVefBsrV36TMIjyhMvo7kqJ6U,bWdj2GDclj5ofokWjzoa5jAwMkxCykd6,1,0,0,0,0,0,1,0,1,0.14285714285714285,1,0.0,0,0,0,0,0,0,0,1,0,0,1,1
20194,186010,pwdsR2guw7jGBDVAdaksGODr7uJoy6bJ,A3fsA9Zfv1X2fVEQhTw51lKENdNrEqT3,13,5,4,0,4,21,8,1,43,6.142857142857143,1,0.0,0,4,0,4,5,21,0,8,1,8,35,1
20195,186017,3kmVKNRbGOm4fMFsW3dgnHkHEGKHE1G0,SpATywNh6bZuzm8s1ceuBUnMUAeoAHHw,1,0,0,0,0,0,1,0,1,0.14285714285714285,1,0.0,0,0,0,0,0,0,0,1,0,0,1,1
20196,186024,mshtCxMsmXSptJoESXKNMH3UVCFV33v0,bWdj2GDclj5ofokWjzoa5jAwMkxCykd6,7,6,2,0,1,0,5,0,14,2.0,1,0.0,0,2,0,1,6,0,0,5,0,3,11,1
20197,186027,eGRaiLXqwboqQlaTTQYr1FB1cM61jV4I,bWdj2GDclj5ofokWjzoa5jAwMkxCykd6,16,38,8,80,5,0,10,0,141,20.142857142857142,3,0.0,9,8,73,5,29,0,7,10,0,95,46,0
20198,186030,WgIzAwP7DckFZQVcLeYgUBCqWImeGyjc,bWdj2GDclj5ofokWjzoa5jAwMkxCykd6,1,0,0,0,0,0,1,0,1,0.14285714285714285,1,0.0,0,0,0,0,0,0,0,1,0,0,1,1
20199,186033,oBeAGLSBA1xupWifcihdC6keBG4wuecB,SpATywNh6bZuzm8s1ceuBUnMUAeoAHHw,12,14,6,0,4,0,5,5,34,4.857142857142857,1,0.0,6,6,0,4,8,0,0,5,5,16,18,1
20200,186034,VKd5p4d9iO6xk39JhIOj5DwKdihmd0lg,SpATywNh6bZuzm8s1ceuBUnMUAeoAHHw,1,0,0,0,0,0,2,0,2,0.2857142857142857,1,0.0,0,0,0,0,0,0,0,2,0,0,2,1
20201,186053,pwdsR2guw7jGBDVAdaksGODr7uJoy6bJ,G8EPVSXsOYB5YQWZGiz1aVq5Pgr2GrQu,1,0,0,0,0,0,1,0,1,0.14285714285714285,1,0.0,0,0,0,0,0,0,0,1,0,0,1,1
20202,186054,pwdsR2guw7jGBDVAdaksGODr7uJoy6bJ,RXDvfPUBYFlVdlueBFbLW0mhhAyGEqpt,1,0,0,0,0,0,1,0,1,0.14285714285714285,1,0.0,0,0,0,0,0,0,0,1,0,0,1,1
20203,186069,1Qo7KMYcvZsuiBzdvEuPj5kKA7qUbqJV,bWdj2GDclj5ofokWjzoa5jAwMkxCykd6,1,0,0,0,0,0,1,0,1,0.14285714285714285,1,0.0,0,0,0,0,0,0,0,1,0,0,1,1
20204,186070,TCINPpi4BOwqMGx315JhuBgHLWH5YLIC,SpATywNh6bZuzm8s1ceuBUnMUAeoAHHw,11,11,5,0,4,0,3,0,23,3.2857142857142856,1,0.0,0,5,0,4,11,0,0,3,0,9,14,1
20205,186080,k1v3XdotdB8LdO3icpee6tW4PUfHmiil,SpATywNh6bZuzm8s1ceuBUnMUAeoAHHw,1,0,0,0,0,0,1,0,1,0.14285714285714285,1,0.0,0,0,0,0,0,0,0,1,0,0,1,1
20206,186090,RKevUFoWjA4gBXEFiCKb5AP4PJvgxsMD,SpATywNh6bZuzm8s1ceuBUnMUAeoAHHw,7,21,4,0,0,1,2,2,30,4.285714285714286,1,0.0,15,4,0,0,6,1,0,2,2,19,11,1
20207,186093,4RiemE5r88jWq9gaL0lVYzjeUhWq3sNP,bWdj2GDclj5ofokWjzoa5jAwMkxCykd6,5,2,1,0,1,0,2,0,6,0.8571428571428571,1,0.0,0,1,0,1,2,0,0,2,0,2,4,1
20208,186105,H7QRgEunakiQpSkvgA6e0kPLJYMsizvQ,RXDvfPUBYFlVdlueBFbLW0mhhAyGEqpt,20,12,6,20,5,1,4,2,50,7.142857142857143,1,0.0,4,6,17,5,8,1,3,4,2,32,18,1
20209,186108,movFtkKyZ7KF2alge61BByZFH1juXwvn,G8EPVSXsOYB5YQWZGiz1aVq5Pgr2GrQu,6,20,5,0,5,0,3,0,33,4.714285714285714,1,0.0,6,5,0,5,14,0,0,3,0,16,17,0
20210,186126,v7J9oMmutdLnNr3JZvwlkpjW9LXfiVjj,bWdj2GDclj5ofokWjzoa5jAwMkxCykd6,1,0,0,0,0,0,3,0,3,0.42857142857142855,1,0.0,0,0,0,0,0,0,0,3,0,0,3,1
20211,186149,3RleWWZim0t3JTvkySadKrLWZcHXfb0j,SpATywNh6bZuzm8s1ceuBUnMUAeoAHHw,5,2,1,0,1,1,2,0,7,1.0,1,0.0,0,1,0,1,2,1,0,2,0,2,5,1
20212,186152,U7gTTHbgIV4F5dvLWAHaZprd34m8Q6vZ,A3fsA9Zfv1X2fVEQhTw51lKENdNrEqT3,2,0,0,0,0,0,3,0,3,0.42857142857142855,1,0.0,0,0,0,0,0,0,0,3,0,0,3,1
20213,186160,76AvlH3YIWFXw8S2TlpvkGfhwLRoEd9v,G8EPVSXsOYB5YQWZGiz1aVq5Pgr2GrQu,1,0,0,0,0,0,1,0,1,0.14285714285714285,1,0.0,0,0,0,0,0,0,0,1,0,0,1,1
20214,186167,vmgNze76nhe4Mg9lRleNqfB4tioADZEi,SpATywNh6bZuzm8s1ceuBUnMUAeoAHHw,5,2,1,0,1,0,2,0,6,0.8571428571428571,1,0.0,0,1,0,1,2,0,0,2,0,2,4,1
20215,186172,eC7mMb2gTYoACNwQi5SJ70EXu79ikkpz,G8EPVSXsOYB5YQWZGiz1aVq5Pgr2GrQu,15,26,2,16,2,1,11,1,59,8.428571428571429,2,0.0,4,2,12,2,22,1,4,11,1,20,39,0
20216,186188,7I0I1azNl6RTMt3ii9CU0GnkhQk3GlzK,bWdj2GDclj5ofokWjzoa5jAwMkxCykd6,4,2,1,0,1,0,1,0,5,0.7142857142857143,1,0.0,0,1,0,1,2,0,0,1,0,2,3,1
20217,186217,joApt9vAdh8Ppf8VaTUE5PED1Gnaa6Cg,SpATywNh6bZuzm8s1ceuBUnMUAeoAHHw,9,6,3,0,1,0,6,0,16,2.2857142857142856,2,0.0,2,3,0,1,4,0,0,6,0,6,10,1
20218,186219,9hgjLw4OD5u1XjZx0s9EMRnEguVXBlYy,bWdj2GDclj5ofokWjzoa5jAwMkxCykd6,5,3,2,0,1,0,1,0,7,1.0,1,0.0,0,2,0,1,3,0,0,1,0,3,4,1
20219,186226,NJMgv4F05c0UQYudEdfqMGLsHyyDDfGS,bWdj2GDclj5ofokWjzoa5jAwMkxCykd6,1,0,0,0,0,0,1,0,1,0.14285714285714285,1,0.0,0,0,0,0,0,0,0,1,0,0,1,1
20220,186239,6LXzBe3NOudMerEzgOt0MkAbIrREFpjB,SpATywNh6bZuzm8s1ceuBUnMUAeoAHHw,6,2,1,0,1,0,8,0,12,1.7142857142857142,1,0.0,0,1,0,1,2,0,0,8,0,2,10,1
20221,186260,CYN3tl2d8PV3r7FRKTn3DmaQTLhkh777,bWdj2GDclj5ofokWjzoa5jAwMkxCykd6,4,4,0,0,0,0,4,0,8,1.1428571428571428,1,0.0,0,0,0,0,4,0,0,4,0,0,8,1
20222,186262,qtck8S6SMYpkxbIZosuQoFSB26vuEbBy,SpATywNh6bZuzm8s1ceuBUnMUAeoAHHw,12,13,6,0,2,2,6,1,30,4.285714285714286,1,0.0,5,6,0,2,8,2,0,6,1,13,17,1
20223,186265,O54CNBN3NKMMQYcBy9CQbkmesf27d5tK,bWdj2GDclj5ofokWjzoa5jAwMkxCykd6,8,7,3,0,4,0,1,0,15,2.142857142857143,1,0.0,3,3,0,4,4,0,0,1,0,10,5,1
20224,186274,UjdXV2LbbZ78dbdYSbQt8OX1VfVSyWoG,RXDvfPUBYFlVdlueBFbLW0mhhAyGEqpt,1,0,0,0,0,0,1,0,1,0.14285714285714285,1,0.0,0,0,0,0,0,0,0,1,0,0,1,1
20225,186278,tRniyBbP3M0j7k24AHpOwHltcVZ3Mvlp,G8EPVSXsOYB5YQWZGiz1aVq5Pgr2GrQu,19,7,6,10,4,4,12,1,44,6.285714285714286,1,0.0,0,6,9,4,7,4,1,12,1,19,25,1
20226,186282,NbCrL52EtsGx8vVNfWSZpmpE4q33iGMd,bWdj2GDclj5ofokWjzoa5jAwMkxCykd6,1,0,0,0,0,0,1,0,1,0.14285714285714285,1,0.0,0,0,0,0,0,0,0,1,0,0,1,1
20227,186293,dN9FTYZkbDCdtR1BnEY22uyGdtBZPVhu,bWdj2GDclj5ofokWjzoa5jAwMkxCykd6,13,12,7,20,4,0,2,0,45,6.428571428571429,2,0.0,2,7,17,4,10,0,3,2,0,30,15,1
20228,186296,B72h1YINVnIBuQnVvUdewAz5RbHuw445,SpATywNh6bZuzm8s1ceuBUnMUAeoAHHw,7,10,1,0,0,0,5,0,16,2.2857142857142856,1,0.0,0,1,0,0,10,0,0,5,0,1,15,1
20229,186306,4i4PHyTAjN8h3LruWdRgGB0UcB2mKwQS,G8EPVSXsOYB5YQWZGiz1aVq5Pgr2GrQu,7,5,4,0,4,0,2,0,15,2.142857142857143,1,0.0,0,4,0,4,5,0,0,2,0,8,7,1
20230,186307,LDAJhM2EkTXhEhkZMewkMv22tm6tjZRZ,G8EPVSXsOYB5YQWZGiz1aVq5Pgr2GrQu,11,17,7,0,0,1,9,1,35,5.0,1,0.0,6,7,0,0,11,1,0,9,1,13,22,1
20231,186310,oiCPMPa63rog2k5BPZRkJCoJXfrcSy1e,SpATywNh6bZuzm8s1ceuBUnMUAeoAHHw,11,8,5,0,3,0,5,2,23,3.2857142857142856,1,0.0,1,5,0,3,7,0,0,5,2,9,14,1
20232,186315,8UDPY0GORYpQM3S1dtt5YkG0CDkJUfAi,G8EPVSXsOYB5YQWZGiz1aVq5Pgr2GrQu,1,0,0,0,0,0,1,0,1,0.14285714285714285,1,0.0,0,0,0,0,0,0,0,1,0,0,1,1
20233,186316,JKjbqPpgyVuFohWzcaEzU3vXeEuQMCY2,SpATywNh6bZuzm8s1ceuBUnMUAeoAHHw,6,6,2,0,1,0,3,0,12,1.7142857142857142,1,0.0,4,2,0,1,2,0,0,3,0,7,5,1
20234,186326,oXcCXnNaPGvzw5MpNzQ49lDnTqlhdcyO,RXDvfPUBYFlVdlueBFbLW0mhhAyGEqpt,6,4,3,0,2,0,2,0,11,1.5714285714285714,1,0.0,0,3,0,2,4,0,0,2,0,5,6,1
20235,186327,5YRs7upinP21LnBzrkpoBo8Kvhb3lSkQ,SpATywNh6bZuzm8s1ceuBUnMUAeoAHHw,9,14,9,0,7,0,9,0,39,5.571428571428571,1,0.0,2,9,0,7,12,0,0,9,0,18,21,1
20236,186343,hNSGUbGCRW7qjA1g49kHgu4SIBbwJo9q,SpATywNh6bZuzm8s1ceuBUnMUAeoAHHw,9,5,4,0,4,0,2,0,15,2.142857142857143,1,0.0,0,4,0,4,5,0,0,2,0,8,7,1
20237,186346,0tNPU3kkt3CooZ4NeVBPjpcYXq8dTU8q,SpATywNh6bZuzm8s1ceuBUnMUAeoAHHw,5,2,1,0,1,0,3,0,7,1.0,1,0.0,0,1,0,1,2,0,0,3,0,2,5,1
20238,186361,ia27UAQHt7F9XiRQIIX7AOZPA1Z4gISX,G8EPVSXsOYB5YQWZGiz1aVq5Pgr2GrQu,24,16,12,0,13,0,14,4,59,8.428571428571429,1,0.0,3,12,0,13,13,0,0,14,4,28,31,1
20239,186368,ihKJAzCpK1sJmaODICQLggyYKl8s1XF0,A3fsA9Zfv1X2fVEQhTw51lKENdNrEqT3,2,0,0,0,0,0,4,0,4,0.5714285714285714,1,0.0,0,0,0,0,0,0,0,4,0,0,4,1
20240,186369,trBO4BEJIC9uXexHjtiN83f66AEsM41a,RXDvfPUBYFlVdlueBFbLW0mhhAyGEqpt,7,3,2,0,2,0,2,0,9,1.2857142857142858,1,0.0,0,2,0,2,3,0,0,2,0,4,5,1
20241,186372,4lhCwJo7yYXKFlssNpVO8DZHuYKFBvLp,bWdj2GDclj5ofokWjzoa5jAwMkxCykd6,5,2,1,0,1,0,2,0,6,0.8571428571428571,1,0.0,0,1,0,1,2,0,0,2,0,2,4,1
20242,186376,61PsrnqGMh19xjWowe2Lz8ELqYCTUUqE,A3fsA9Zfv1X2fVEQhTw51lKENdNrEqT3,6,5,2,0,1,0,3,0,11,1.5714285714285714,1,0.0,0,2,0,1,5,0,0,3,0,3,8,1
20243,186385,TREm1kp17GnbcApEfZDyA7Kp4fSLmJio,SpATywNh6bZuzm8s1ceuBUnMUAeoAHHw,2,0,0,0,0,0,3,0,3,0.42857142857142855,1,0.0,0,0,0,0,0,0,0,3,0,0,3,1
20244,186390,AeCrxYByugIwu4XUBpI0LhoTguBozLAa,G8EPVSXsOYB5YQWZGiz1aVq5Pgr2GrQu,26,28,6,66,4,0,3,0,107,15.285714285714286,1,0.0,16,6,48,4,12,0,18,3,0,74,33,1
20245,186417,gLeI9VliEYF371soyxZF0epS12DLfvFA,SpATywNh6bZuzm8s1ceuBUnMUAeoAHHw,10,14,1,12,0,0,1,0,28,4.0,1,0.0,6,1,11,0,8,0,1,1,0,18,10,0
20246,186425,Vgv9Vbo4BqJtU7GBUbwfi1DvG0Q1nDxJ,A3fsA9Zfv1X2fVEQhTw51lKENdNrEqT3,6,3,2,0,1,0,2,0,8,1.1428571428571428,1,0.0,0,2,0,1,3,0,0,2,0,3,5,1
20247,186430,s5UknTeAXWW62hajP9UwOYzwqzInPkkx,SpATywNh6bZuzm8s1ceuBUnMUAeoAHHw,7,2,1,0,1,0,4,0,8,1.1428571428571428,1,0.0,0,1,0,1,2,0,0,4,0,2,6,1
20248,186455,ocTIjxG8zBs0mQRpUtpuAKc7MDpzU7Sd,A3fsA9Zfv1X2fVEQhTw51lKENdNrEqT3,7,4,2,0,1,32,10,0,49,7.0,3,0.0,0,2,0,1,4,32,0,10,0,3,46,0
20249,186465,qJgl58YR6SFE9WBZ5w9d3OO6sin62mbS,G8EPVSXsOYB5YQWZGiz1aVq5Pgr2GrQu,5,2,1,0,1,0,2,0,6,0.8571428571428571,1,0.0,0,1,0,1,2,0,0,2,0,2,4,1
20250,186482,xTif7TWTzpmMlOz25LEjdVnoxKR0Djir,bWdj2GDclj5ofokWjzoa5jAwMkxCykd6,1,0,0,0,0,0,1,0,1,0.14285714285714285,1,0.0,0,0,0,0,0,0,0,1,0,0,1,1
20251,186507,Ws3AQXJqw3VTjixWLsavB7mzhprdidTH,G8EPVSXsOYB5YQWZGiz1aVq5Pgr2GrQu,4,2,1,0,1,0,1,0,5,0.7142857142857143,1,0.0,0,1,0,1,2,0,0,1,0,2,3,1
20252,186513,bieYN909hTRWSvc3EaZDiQYQdygsSUNW,SpATywNh6bZuzm8s1ceuBUnMUAeoAHHw,7,6,3,0,3,0,3,0,15,2.142857142857143,1,0.0,0,3,0,3,6,0,0,3,0,6,9,1
20253,186514,bYD2u7vuN3G54awyDYPdRiZI3O4zw6kx,A3fsA9Zfv1X2fVEQhTw51lKENdNrEqT3,9,7,4,0,2,4,5,0,22,3.142857142857143,2,0.0,1,4,0,2,6,4,0,5,0,7,15,1
20254,186522,xe3aQO2zOncGcTg3GZj4Ju1vwkPuneGt,A3fsA9Zfv1X2fVEQhTw51lKENdNrEqT3,26,21,16,6,11,2,7,1,64,9.142857142857142,2,0.0,0,16,5,11,21,2,1,7,1,32,32,1
20255,186541,k9uZHzVbTw2SpPQ5TgMY9urRyaKHQ7D1,SpATywNh6bZuzm8s1ceuBUnMUAeoAHHw,11,10,0,3,0,0,5,0,18,2.5714285714285716,1,0.0,5,0,3,0,5,0,0,5,0,8,10,1
20256,186552,fiJeUe4rD7XOpUxN73ysB6UZAqbfZlmt,SpATywNh6bZuzm8s1ceuBUnMUAeoAHHw,8,2,2,0,2,0,3,0,9,1.2857142857142858,1,0.0,0,2,0,2,2,0,0,3,0,4,5,1
20257,186565,7ho1Tg0rPKs5S3R4MH5byApVMAoQWEXh,RXDvfPUBYFlVdlueBFbLW0mhhAyGEqpt,10,4,3,0,2,12,10,5,36,5.142857142857143,1,0.0,0,3,0,2,4,12,0,10,5,5,31,1
20258,186574,2hFnq94PJL4XDwPjj8ZoE3JMQah41FEA,SpATywNh6bZuzm8s1ceuBUnMUAeoAHHw,5,3,2,0,1,0,2,0,8,1.1428571428571428,2,0.0,0,2,0,1,3,0,0,2,0,3,5,1
20259,186576,dCkOxG7NzEIrFHNAIlnaKMlesPlFB6No,bWdj2GDclj5ofokWjzoa5jAwMkxCykd6,3,0,0,0,0,1,3,0,4,0.5714285714285714,1,0.0,0,0,0,0,0,1,0,3,0,0,4,1
20260,186587,rBTUDXHsyVAHRzecZ0JrUNZO0FdtzEgU,SpATywNh6bZuzm8s1ceuBUnMUAeoAHHw,12,13,0,11,1,0,3,0,28,4.0,1,0.0,4,0,10,1,9,0,1,3,0,15,13,1
20261,186595,QZIRHdwFgibI2SBehTrmLAZxED1F4JL7,bWdj2GDclj5ofokWjzoa5jAwMkxCykd6,3,3,0,0,0,0,2,0,5,0.7142857142857143,1,0.0,0,0,0,0,3,0,0,2,0,0,5,1
20262,186611,aZ82NGvfiihxQfhlR4uS7n77c1b4mi5Z,G8EPVSXsOYB5YQWZGiz1aVq5Pgr2GrQu,6,4,1,0,1,0,3,0,9,1.2857142857142858,1,0.0,0,1,0,1,4,0,0,3,0,2,7,1
20263,186626,0zEvDhRJYIh90RBOGZBHRBqiMwb7D8PK,SpATywNh6bZuzm8s1ceuBUnMUAeoAHHw,1,0,0,0,0,0,1,0,1,0.14285714285714285,1,0.0,0,0,0,0,0,0,0,1,0,0,1,1
20264,186632,65P7KaQODeqWFWqHnCldB0bW07lJUhzD,A3fsA9Zfv1X2fVEQhTw51lKENdNrEqT3,7,5,3,0,1,0,2,0,11,1.5714285714285714,1,0.0,0,3,0,1,5,0,0,2,0,4,7,1
20265,186643,GOc4kNORXKPP2dp4IaPI0qi7cdZjVMoK,bWdj2GDclj5ofokWjzoa5jAwMkxCykd6,1,0,0,0,0,0,1,0,1,0.14285714285714285,1,0.0,0,0,0,0,0,0,0,1,0,0,1,1
20266,186660,G6IoTlb3c3ZQL96Z5jLVHovz7cxEUWx5,SpATywNh6bZuzm8s1ceuBUnMUAeoAHHw,5,2,1,0,1,0,2,0,6,0.8571428571428571,1,0.0,0,1,0,1,2,0,0,2,0,2,4,1
20267,186668,Q3SCEqfg6AiZK4k6l6uETosmZAruIeRz,bWdj2GDclj5ofokWjzoa5jAwMkxCykd6,5,2,1,0,1,0,2,0,6,0.8571428571428571,1,0.0,0,1,0,1,2,0,0,2,0,2,4,1
20268,186671,fWFaAKdCQbV0w3S48FeXgmzcwLTDxziF,RXDvfPUBYFlVdlueBFbLW0mhhAyGEqpt,2,0,0,0,0,0,2,0,2,0.2857142857142857,1,0.0,0,0,0,0,0,0,0,2,0,0,2,1
20269,186690,C7zqVICfiC5LB2CDdZC77m5k2umUb3cp,SpATywNh6bZuzm8s1ceuBUnMUAeoAHHw,18,27,10,9,4,0,13,1,64,9.142857142857142,2,0.0,11,10,9,4,16,0,0,13,1,34,30,1
20270,186696,XWqfdH6YA4Zk74Kdlw1zAAjKNGLWzY2X,A3fsA9Zfv1X2fVEQhTw51lKENdNrEqT3,5,0,0,0,0,1,4,1,6,0.8571428571428571,1,0.0,0,0,0,0,0,1,0,4,1,0,6,1
20271,186698,cdSk14IbXqFAl31nStZhqBGbvhRNZQDG,A3fsA9Zfv1X2fVEQhTw51lKENdNrEqT3,2,0,0,0,0,0,2,0,2,0.2857142857142857,1,0.0,0,0,0,0,0,0,0,2,0,0,2,1
20272,186710,i8nr5dg8z4enS0u6hepa5rlWzI5t4l3G,SpATywNh6bZuzm8s1ceuBUnMUAeoAHHw,6,6,0,0,0,0,7,0,13,1.8571428571428572,2,0.0,0,0,0,0,6,0,0,7,0,0,13,1
20273,186711,VrzXB04D4NAWNSSnAJBQgbBcugtgsrsf,SpATywNh6bZuzm8s1ceuBUnMUAeoAHHw,5,2,1,0,1,0,3,0,7,1.0,1,0.0,0,1,0,1,2,0,0,3,0,2,5,1
20274,186716,yTPe4A1Cw5qKDjYpFW5H73VItf0UPFbm,A3fsA9Zfv1X2fVEQhTw51lKENdNrEqT3,4,2,1,0,1,0,1,0,5,0.7142857142857143,1,0.0,0,1,0,1,2,0,0,1,0,2,3,1
20275,186723,XO4yOVP7eCwBTi6pYIgtRmMh0ft7YdHb,A3fsA9Zfv1X2fVEQhTw51lKENdNrEqT3,9,12,1,0,1,0,4,0,18,2.5714285714285716,1,0.0,0,1,0,1,12,0,0,4,0,2,16,1
20276,186727,rwCHpAN1sY0GvFYG7zQQk2qpgkOBz9O3,A3fsA9Zfv1X2fVEQhTw51lKENdNrEqT3,1,0,0,0,0,0,1,0,1,0.14285714285714285,1,0.0,0,0,0,0,0,0,0,1,0,0,1,1
20277,186740,ctYjDizjossnFRGdONqI7hfhQiNCx3Il,SpATywNh6bZuzm8s1ceuBUnMUAeoAHHw,5,2,1,0,1,0,2,0,6,0.8571428571428571,1,0.0,0,1,0,1,2,0,0,2,0,2,4,1
20278,186744,5QmsfWrr8re1QceHmRAqqM6UDRZ5H0Jh,A3fsA9Zfv1X2fVEQhTw51lKENdNrEqT3,1,0,0,0,0,0,1,0,1,0.14285714285714285,1,0.0,0,0,0,0,0,0,0,1,0,0,1,1
20279,186749,sHd9Ol41vgPIb8hQT0QvUGTmi4Ucq4PU,A3fsA9Zfv1X2fVEQhTw51lKENdNrEqT3,7,5,1,0,1,0,2,1,10,1.4285714285714286,1,0.0,0,1,0,1,5,0,0,2,1,2,8,0
20280,186757,hDObtbeavxijehIK2xeebS18vJ3HSLBF,G8EPVSXsOYB5YQWZGiz1aVq5Pgr2GrQu,20,13,2,28,2,8,9,2,64,9.142857142857142,1,0.0,7,2,22,2,6,8,6,9,2,33,31,1
20281,186771,EEukb1HtBZxlb0jW8bNwwOHInCYodyW7,SpATywNh6bZuzm8s1ceuBUnMUAeoAHHw,16,42,30,8,8,2,7,0,97,13.857142857142858,2,0.0,7,30,6,8,35,2,2,7,0,51,46,1
20282,186772,FfI4UUUkiQJXZUOcZvQpEfxlQuZiIFGh,SpATywNh6bZuzm8s1ceuBUnMUAeoAHHw,16,21,6,19,3,1,7,1,58,8.285714285714286,1,0.0,15,6,16,3,6,1,3,7,1,40,18,1
20283,186778,RPs2tKrisA27ObcW2SBs1xNMfhflcdme,A3fsA9Zfv1X2fVEQhTw51lKENdNrEqT3,26,16,13,0,10,2,7,1,49,7.0,1,0.0,1,13,0,10,15,2,0,7,1,24,25,1
20284,186781,7AJKHqkajNqeFVOiguDrQip0qHhqaIRR,SpATywNh6bZuzm8s1ceuBUnMUAeoAHHw,4,3,0,0,0,0,4,0,7,1.0,1,0.0,0,0,0,0,3,0,0,4,0,0,7,1
20285,186783,gGYcWzk2NzIvua4pLrzA2aQChS7C946h,bWdj2GDclj5ofokWjzoa5jAwMkxCykd6,1,0,0,0,0,0,1,0,1,0.14285714285714285,1,0.0,0,0,0,0,0,0,0,1,0,0,1,1
20286,186784,gGYcWzk2NzIvua4pLrzA2aQChS7C946h,A3fsA9Zfv1X2fVEQhTw51lKENdNrEqT3,1,0,0,0,0,0,1,0,1,0.14285714285714285,1,0.0,0,0,0,0,0,0,0,1,0,0,1,1
20287,186800,5dOCb3tuN0oLC3HIthm7sT5KORDlaOZw,bWdj2GDclj5ofokWjzoa5jAwMkxCykd6,1,0,0,0,0,0,1,0,1,0.14285714285714285,1,0.0,0,0,0,0,0,0,0,1,0,0,1,1
20288,186810,fOtwdZktYnpxoylqFRzXhWQ4IRQZkjMB,bWdj2GDclj5ofokWjzoa5jAwMkxCykd6,2,0,0,0,0,0,2,0,2,0.2857142857142857,1,0.0,0,0,0,0,0,0,0,2,0,0,2,1
20289,186813,YxZ9FmNlyuWdg66eoHTORDjjSmjY5VNG,G8EPVSXsOYB5YQWZGiz1aVq5Pgr2GrQu,1,0,0,0,0,0,1,0,1,0.14285714285714285,1,0.0,0,0,0,0,0,0,0,1,0,0,1,1
20290,186814,CBTOHCGcjccQ2o1Vrrh64wBXcjBq7Z16,SpATywNh6bZuzm8s1ceuBUnMUAeoAHHw,1,0,0,0,0,0,1,0,1,0.14285714285714285,1,0.0,0,0,0,0,0,0,0,1,0,0,1,1
20291,186847,hz69aGX7TSXJFEooFn03184YEuUmyXMU,A3fsA9Zfv1X2fVEQhTw51lKENdNrEqT3,1,0,0,0,0,0,1,0,1,0.14285714285714285,1,0.0,0,0,0,0,0,0,0,1,0,0,1,1
20292,186850,UgDeDsY1WA9fQwWE8jwZFiYA6EyOF0ZW,SpATywNh6bZuzm8s1ceuBUnMUAeoAHHw,8,10,6,0,4,0,5,0,25,3.5714285714285716,2,0.0,0,6,0,4,10,0,0,5,0,10,15,1
20293,186853,LsOIP6tIKtIJyz4AzkO8CiGUDMpbTeCo,A3fsA9Zfv1X2fVEQhTw51lKENdNrEqT3,6,13,2,0,0,0,2,0,17,2.4285714285714284,1,0.0,5,2,0,0,8,0,0,2,0,7,10,1
20294,186855,nxuexUreiYSzpSapqT3MF6tzgH9I1i5D,SpATywNh6bZuzm8s1ceuBUnMUAeoAHHw,2,0,0,0,0,0,2,0,2,0.2857142857142857,1,0.0,0,0,0,0,0,0,0,2,0,0,2,1
20295,186856,LsOIP6tIKtIJyz4AzkO8CiGUDMpbTeCo,bWdj2GDclj5ofokWjzoa5jAwMkxCykd6,3,0,0,0,0,0,5,0,5,0.7142857142857143,1,0.0,0,0,0,0,0,0,0,5,0,0,5,1
20296,186860,6wrpSaMSo2sFDvbkUAkMpT5um9Gim187,RXDvfPUBYFlVdlueBFbLW0mhhAyGEqpt,7,4,2,0,1,0,2,0,9,1.2857142857142858,2,0.0,0,2,0,1,4,0,0,2,0,3,6,1
20297,186863,8Sv91LR7V2lE7Zyit6yFhnYKBfbSa4xP,bWdj2GDclj5ofokWjzoa5jAwMkxCykd6,1,0,0,0,0,0,1,0,1,0.14285714285714285,1,0.0,0,0,0,0,0,0,0,1,0,0,1,1
20298,186871,gCagcmlQCSqfTruAye7CNDK3pgpCGf84,G8EPVSXsOYB5YQWZGiz1aVq5Pgr2GrQu,5,2,1,0,1,0,2,0,6,0.8571428571428571,2,0.0,0,1,0,1,2,0,0,2,0,2,4,1
20299,186872,qyt4OAUG4MKvi1Q9hL19EWAbFxfkdehH,SpATywNh6bZuzm8s1ceuBUnMUAeoAHHw,1,0,0,0,0,0,1,0,1,0.14285714285714285,1,0.0,0,0,0,0,0,0,0,1,0,0,1,1
20300,186890,3eKiIXhRJU4AcaSK2OGxb5hm0pCKaHgd,A3fsA9Zfv1X2fVEQhTw51lKENdNrEqT3,39,13,11,46,10,6,2,0,88,12.571428571428571,2,0.0,1,11,45,10,12,6,1,2,0,67,21,1
20301,186911,DSucldosbIjEAZZwdtdITu0zXAY3IdvD,3VkHkmOtom3jM2wCu94xgzzu1d6Dn7or,17,21,15,0,11,3,21,0,71,10.142857142857142,1,0.0,0,15,0,11,21,3,0,21,0,26,45,1
20302,186924,jF1NUJsBmFXEwkk4UXwN1TfFpCBG6pWD,3VkHkmOtom3jM2wCu94xgzzu1d6Dn7or,1,0,0,0,0,0,1,0,1,0.14285714285714285,1,0.0,0,0,0,0,0,0,0,1,0,0,1,1
20303,186933,fGpbVdlJo5xTjNN6Spc1hhlZUu4OOr7T,3VkHkmOtom3jM2wCu94xgzzu1d6Dn7or,1,0,0,0,0,0,1,0,1,0.14285714285714285,1,0.0,0,0,0,0,0,0,0,1,0,0,1,1
20304,186939,dJg2msyls77AnAm6uajII4KKm8Q8hwC1,3VkHkmOtom3jM2wCu94xgzzu1d6Dn7or,15,20,11,0,10,0,1,0,42,6.0,1,0.0,0,11,0,10,20,0,0,1,0,21,21,1
20305,186944,uiK7hO9pSLrjHQHuySUntwzbR3KU4xGx,3VkHkmOtom3jM2wCu94xgzzu1d6Dn7or,1,0,0,0,0,0,1,0,1,0.14285714285714285,1,0.0,0,0,0,0,0,0,0,1,0,0,1,1
20306,186947,PebrX2202jwFfmxAzdqi3Y0wuv5AlaH5,3VkHkmOtom3jM2wCu94xgzzu1d6Dn7or,2,0,0,0,0,0,3,0,3,0.42857142857142855,2,0.0,0,0,0,0,0,0,0,3,0,0,3,1
20307,186953,F7U9ZHucyu3CV9XHiYJsvH9QXbAT1goG,3VkHkmOtom3jM2wCu94xgzzu1d6Dn7or,5,2,1,0,1,0,3,1,8,1.1428571428571428,1,0.0,0,1,0,1,2,0,0,3,1,2,6,1
20308,186975,rBLgB4SXURK0P1ThVuiQp95AEMKWyvye,3VkHkmOtom3jM2wCu94xgzzu1d6Dn7or,8,2,1,0,1,1,7,2,14,2.0,1,0.0,0,1,0,1,2,1,0,7,2,2,12,0
20309,186992,xjV01NLdh6HESD02zKRZtvjxAfS0TO1x,3VkHkmOtom3jM2wCu94xgzzu1d6Dn7or,8,16,5,2,4,4,2,0,33,4.714285714285714,1,0.0,5,5,2,4,11,4,0,2,0,16,17,1
20310,186999,4DPKOQvuGxYOwlUItONudt9tR0jntQqh,3VkHkmOtom3jM2wCu94xgzzu1d6Dn7or,9,11,3,0,4,0,4,1,23,3.2857142857142856,1,0.0,2,3,0,4,9,0,0,4,1,9,14,1
20311,187013,lBDP0bEGdpXmY1IAvAuALKqFWFlEuPft,3VkHkmOtom3jM2wCu94xgzzu1d6Dn7or,8,4,1,0,1,4,6,3,19,2.7142857142857144,1,0.0,2,1,0,1,2,4,0,6,3,4,15,1
20312,187038,hwI4zqIHvHYPcmQMWVn6dAzcvw5VYKKk,3VkHkmOtom3jM2wCu94xgzzu1d6Dn7or,6,3,1,0,1,1,3,0,9,1.2857142857142858,1,0.0,1,1,0,1,2,1,0,3,0,3,6,1
20313,187045,xaaVsAZ1tR0yEpnQXOKlyxITxN3yh1kD,3VkHkmOtom3jM2wCu94xgzzu1d6Dn7or,4,3,0,0,1,0,5,0,9,1.2857142857142858,2,0.0,1,0,0,1,2,0,0,5,0,2,7,1
20314,187048,Bt0YrpvyveynQfxqkzppqbivsu9tYRaK,3VkHkmOtom3jM2wCu94xgzzu1d6Dn7or,1,0,0,0,0,0,2,0,2,0.2857142857142857,1,0.0,0,0,0,0,0,0,0,2,0,0,2,1
20315,187085,9BFsMQpEVVEqni5ItC1BH9wyokJ4Dl09,3VkHkmOtom3jM2wCu94xgzzu1d6Dn7or,5,5,1,0,0,0,2,0,8,1.1428571428571428,1,0.0,0,1,0,0,5,0,0,2,0,1,7,1
20316,187086,IsTK1MTmWtJuEb82hlXsEZ9eWGGnrqPP,3VkHkmOtom3jM2wCu94xgzzu1d6Dn7or,8,4,3,0,3,0,1,0,11,1.5714285714285714,1,0.0,0,3,0,3,4,0,0,1,0,6,5,1
20317,187088,dlrLIaHXxLuhaK6Dcn0tRGWiM9T19Je3,fbPkOYLVPtPgIt0MxizjfFJov3JbHyAi,6,1,1,0,1,0,3,0,6,0.8571428571428571,1,0.0,0,1,0,1,1,0,0,3,0,2,4,1
20318,187089,0PYlPo8KoOqdfXLmHxHfVVjmiH634i57,fbPkOYLVPtPgIt0MxizjfFJov3JbHyAi,7,3,2,0,2,0,2,0,9,1.2857142857142858,1,0.0,0,2,0,2,3,0,0,2,0,4,5,1
20319,187091,3vC1Avk4MweE6jXdINlfOGwslm7K8miO,fbPkOYLVPtPgIt0MxizjfFJov3JbHyAi,7,3,2,0,2,0,2,0,9,1.2857142857142858,1,0.0,0,2,0,2,3,0,0,2,0,4,5,1
20320,187092,mSXZKJ9e3RCTXopgrFUphpxYgeKp7tlG,fbPkOYLVPtPgIt0MxizjfFJov3JbHyAi,1,0,0,0,0,0,1,0,1,0.14285714285714285,1,0.0,0,0,0,0,0,0,0,1,0,0,1,1
20321,187094,zo3yZSyHQrlqYmJhQx7AWyW8ZBQsx6F5,fbPkOYLVPtPgIt0MxizjfFJov3JbHyAi,1,0,0,0,0,0,1,0,1,0.14285714285714285,1,0.0,0,0,0,0,0,0,0,1,0,0,1,1
20322,187095,7xpmz6LF4dl35fFKZgRU70OZyF8UO4PL,fbPkOYLVPtPgIt0MxizjfFJov3JbHyAi,6,3,2,0,1,0,2,0,8,1.1428571428571428,1,0.0,0,2,0,1,3,0,0,2,0,3,5,1
20323,187098,MVuALw1hJaDtoRSVB68VHL3OEaRsecjE,fbPkOYLVPtPgIt0MxizjfFJov3JbHyAi,8,11,5,8,4,0,1,0,29,4.142857142857143,1,0.0,5,5,6,4,6,0,2,1,0,20,9,1
20324,187100,ppz7CTomjBYQivsr2Dps2PCVRxiD3toN,fbPkOYLVPtPgIt0MxizjfFJov3JbHyAi,1,0,0,0,0,0,1,0,1,0.14285714285714285,1,0.0,0,0,0,0,0,0,0,1,0,0,1,1
20325,187103,ci4gAhZjL2J1kqejbfqEWVVtNgzi36ci,fbPkOYLVPtPgIt0MxizjfFJov3JbHyAi,7,3,2,0,2,0,2,0,9,1.2857142857142858,1,0.0,0,2,0,2,3,0,0,2,0,4,5,1
20326,187104,8WCPZ0bdo5iAWbinwSHd3k1oEK1AHcY6,fbPkOYLVPtPgIt0MxizjfFJov3JbHyAi,1,0,0,0,0,0,1,0,1,0.14285714285714285,1,0.0,0,0,0,0,0,0,0,1,0,0,1,1
20327,187106,L7FfTijl2sEUvCwVWIgdimuCtnJPQB7o,fbPkOYLVPtPgIt0MxizjfFJov3JbHyAi,1,0,0,0,0,0,1,0,1,0.14285714285714285,1,0.0,0,0,0,0,0,0,0,1,0,0,1,1
20328,187108,QOT87ocOuYR2IkmbA3Jyt7pzS8Zs3r2N,fbPkOYLVPtPgIt0MxizjfFJov3JbHyAi,7,6,2,0,2,0,2,0,12,1.7142857142857142,1,0.0,0,2,0,2,6,0,0,2,0,4,8,1
20329,187109,16PZ49GbIBVUoHcK3YWyanucVtonkvq4,fbPkOYLVPtPgIt0MxizjfFJov3JbHyAi,9,6,3,0,2,0,3,0,14,2.0,1,0.0,0,3,0,2,6,0,0,3,0,5,9,1
20330,187110,jQSZrKmukoAGdD1PsGnzsjQnImWdBkqA,fbPkOYLVPtPgIt0MxizjfFJov3JbHyAi,1,0,0,0,0,0,1,0,1,0.14285714285714285,1,0.0,0,0,0,0,0,0,0,1,0,0,1,1
20331,187112,dFTO62uxJHhM2iAeGlKRqSu3846MAtFy,fbPkOYLVPtPgIt0MxizjfFJov3JbHyAi,8,3,2,0,2,3,4,1,15,2.142857142857143,1,0.0,0,2,0,2,3,3,0,4,1,4,11,1
20332,187113,wM5JLG2HTiWJkjaOdIJgInNEHRkSWEDE,fbPkOYLVPtPgIt0MxizjfFJov3JbHyAi,1,0,0,0,0,0,1,0,1,0.14285714285714285,1,0.0,0,0,0,0,0,0,0,1,0,0,1,1
20333,187114,76MsyfoydlyTteuthkqqJhd4o0zqGEPQ,fbPkOYLVPtPgIt0MxizjfFJov3JbHyAi,11,5,4,0,4,0,2,0,15,2.142857142857143,1,0.0,0,4,0,4,5,0,0,2,0,8,7,1
20334,187116,xWNeZUxK8O1kDFvZ0AuZhSKlQ5A39qVr,fbPkOYLVPtPgIt0MxizjfFJov3JbHyAi,1,0,0,0,0,0,1,0,1,0.14285714285714285,1,0.0,0,0,0,0,0,0,0,1,0,0,1,1
20335,187231,KJwbmkoK69ToUHYM3JjYSRGZ65hxphzP,5Gyp41oLVo7Gg7vF4vpmggWP5MU70QO6,6,15,5,0,5,0,1,0,26,3.7142857142857144,1,0.0,0,5,0,5,15,0,0,1,0,10,16,1
20336,187232,cpyogiH7iAig2tMBY5aMQqlSTPCuODq7,5Gyp41oLVo7Gg7vF4vpmggWP5MU70QO6,7,3,2,0,2,0,2,0,9,1.2857142857142858,1,0.0,0,2,0,2,3,0,0,2,0,4,5,1
20337,187238,mGx5ueYQbTbgHY4lfn4jky6mRF7BpJuC,5Gyp41oLVo7Gg7vF4vpmggWP5MU70QO6,1,0,0,0,0,0,1,0,1,0.14285714285714285,1,0.0,0,0,0,0,0,0,0,1,0,0,1,1
20338,187255,AYgSOcnFNUHC4diuBJjhyxFnwGUvydQl,5Gyp41oLVo7Gg7vF4vpmggWP5MU70QO6,1,0,0,0,0,0,1,0,1,0.14285714285714285,1,0.0,0,0,0,0,0,0,0,1,0,0,1,1
20339,187269,n8DEwkzP5bvWTXGQ64ESsgmVoOQcLiKY,5Gyp41oLVo7Gg7vF4vpmggWP5MU70QO6,2,0,0,0,0,0,2,0,2,0.2857142857142857,1,0.0,0,0,0,0,0,0,0,2,0,0,2,1
20340,187289,aukYmO1PjDXsRHpCoYmvSUWYr6Do2QD4,5Gyp41oLVo7Gg7vF4vpmggWP5MU70QO6,1,0,0,0,0,0,2,0,2,0.2857142857142857,1,0.0,0,0,0,0,0,0,0,2,0,0,2,1
20341,187291,MGwCqijPbaECMqR3yBjzMHorAlNOqpXl,5Gyp41oLVo7Gg7vF4vpmggWP5MU70QO6,6,9,7,0,5,15,2,0,38,5.428571428571429,1,0.0,0,7,0,5,9,15,0,2,0,12,26,1
20342,187306,wscwqYf0HkLQPekvnhjR1IJCpLp4XWUe,5Gyp41oLVo7Gg7vF4vpmggWP5MU70QO6,4,2,1,0,1,0,1,0,5,0.7142857142857143,1,0.0,0,1,0,1,2,0,0,1,0,2,3,1
20343,187314,CxsOXh77ynK0lYpDFMGaSL5u6H4vThav,5Gyp41oLVo7Gg7vF4vpmggWP5MU70QO6,5,2,1,0,1,0,2,0,6,0.8571428571428571,1,0.0,0,1,0,1,2,0,0,2,0,2,4,1
20344,187360,YJTmWhg5FwFTBT5yuc8gKsTYE4eaZsY2,5Gyp41oLVo7Gg7vF4vpmggWP5MU70QO6,4,6,1,0,0,0,3,0,10,1.4285714285714286,1,0.0,0,1,0,0,6,0,0,3,0,1,9,1
20345,187370,ZtyTiYj4XdBQnDVICLgwhjMvgpLcUhVS,5Gyp41oLVo7Gg7vF4vpmggWP5MU70QO6,4,2,1,0,1,0,2,0,6,0.8571428571428571,1,0.0,0,1,0,1,2,0,0,2,0,2,4,1
20346,187376,JiewyvYAWlx6gexGik4A5LBXwd7S9X37,5Gyp41oLVo7Gg7vF4vpmggWP5MU70QO6,13,16,3,6,4,0,4,1,34,4.857142857142857,1,0.0,12,3,4,4,4,0,2,4,1,23,11,1
20347,187384,wbFZf0vBGr8ZagqGAnXAxrCWXPqmHozC,5Gyp41oLVo7Gg7vF4vpmggWP5MU70QO6,1,0,0,0,0,0,1,0,1,0.14285714285714285,1,0.0,0,0,0,0,0,0,0,1,0,0,1,1
20348,187390,qpV3C2IZjB1ICwVxeuRFosLbHBid3MJt,5Gyp41oLVo7Gg7vF4vpmggWP5MU70QO6,8,5,3,0,2,0,2,0,12,1.7142857142857142,1,0.0,0,3,0,2,5,0,0,2,0,5,7,1
20349,187421,L1kFTmJDYdpvLc1u6vNcQOn7WLruDpe4,5Gyp41oLVo7Gg7vF4vpmggWP5MU70QO6,4,2,1,0,0,0,2,0,5,0.7142857142857143,1,0.0,0,1,0,0,2,0,0,2,0,1,4,1
20350,187478,D37iLuxt7loQPCePakfmH7GyiB5PvEMk,5Gyp41oLVo7Gg7vF4vpmggWP5MU70QO6,15,25,17,4,3,6,5,0,60,8.571428571428571,1,0.0,4,17,3,3,21,6,1,5,0,27,33,1
20351,187518,b8GI8HzrIl76DGCDw7gwPAfcEuU8gpR5,5Gyp41oLVo7Gg7vF4vpmggWP5MU70QO6,15,19,10,13,4,0,7,0,53,7.571428571428571,1,0.0,4,10,8,4,15,0,5,7,0,26,27,1
20352,187566,wHcO2fuUG30bVlNh2ZpgS5end7Q0W9wU,5Gyp41oLVo7Gg7vF4vpmggWP5MU70QO6,9,4,2,0,1,3,12,1,23,3.2857142857142856,1,0.0,0,2,0,1,4,3,0,12,1,3,20,1
20353,187590,fAp6p9W5rBTQuc3sOQQCK7Lh0pMEnj25,5Gyp41oLVo7Gg7vF4vpmggWP5MU70QO6,13,18,6,0,2,3,8,3,40,5.714285714285714,1,0.0,6,6,0,2,12,3,0,8,3,14,26,1
20354,187591,7Ob4OdeTAKRjQIsUAjssorAsOJaATqXN,5Gyp41oLVo7Gg7vF4vpmggWP5MU70QO6,3,0,0,0,0,0,2,4,6,0.8571428571428571,1,0.0,0,0,0,0,0,0,0,2,4,0,6,1
20355,187597,2qf82Y9baG4R7G8jAYpX9QVmsoyMWhqM,5Gyp41oLVo7Gg7vF4vpmggWP5MU70QO6,6,4,1,0,1,0,3,0,9,1.2857142857142858,1,0.0,0,1,0,1,4,0,0,3,0,2,7,1
20356,187625,Yn25TdLihKYIhyqihvGKu5O4o0bg8SXf,5Gyp41oLVo7Gg7vF4vpmggWP5MU70QO6,7,9,7,0,4,2,10,0,32,4.571428571428571,1,0.0,1,7,0,4,8,2,0,10,0,12,20,1
20357,187632,jJ6H4AGAMcrNyFUtHZ1FlFW8U3hHk9nZ,5Gyp41oLVo7Gg7vF4vpmggWP5MU70QO6,9,7,6,0,3,0,1,0,17,2.4285714285714284,1,0.0,0,6,0,3,7,0,0,1,0,9,8,1
20358,187648,m69B3SgSNcQxtCVoVKKSTOsElUiPbA7t,5Gyp41oLVo7Gg7vF4vpmggWP5MU70QO6,7,3,2,0,2,0,2,0,9,1.2857142857142858,1,0.0,0,2,0,2,3,0,0,2,0,4,5,1
20359,187689,Vu8rN942EwDIOj6iE8IDqvSFXpvGHO9R,5Gyp41oLVo7Gg7vF4vpmggWP5MU70QO6,8,10,5,0,3,0,1,0,19,2.7142857142857144,1,0.0,1,5,0,3,9,0,0,1,0,9,10,1
20360,187721,A0tg4c2oPOVLeO6yZJyRHHatmQr15tSo,5Gyp41oLVo7Gg7vF4vpmggWP5MU70QO6,6,3,2,0,2,0,2,0,9,1.2857142857142858,1,0.0,0,2,0,2,3,0,0,2,0,4,5,1
20361,187722,Z0uiIYjGckCu2uGtFnfk8o06v7Tfu06G,5Gyp41oLVo7Gg7vF4vpmggWP5MU70QO6,6,3,2,0,2,0,1,0,8,1.1428571428571428,1,0.0,0,2,0,2,3,0,0,1,0,4,4,1
20362,187730,XJaKcnkVBI8QunjtQU1MWgScpeVJwWB6,5Gyp41oLVo7Gg7vF4vpmggWP5MU70QO6,9,3,2,0,2,1,4,2,14,2.0,1,0.0,0,2,0,2,3,1,0,4,2,4,10,1
20363,187733,DH3ZDXYOwtm04l7SNlQzyy1uucBnB8el,5Gyp41oLVo7Gg7vF4vpmggWP5MU70QO6,8,6,3,0,2,0,3,0,14,2.0,1,0.0,0,3,0,2,6,0,0,3,0,5,9,1
20364,187735,xwG9GgMrPHgbqqrlvclpGJMpSPdOCjxQ,5Gyp41oLVo7Gg7vF4vpmggWP5MU70QO6,6,3,2,0,2,0,1,0,8,1.1428571428571428,1,0.0,0,2,0,2,3,0,0,1,0,4,4,1
20365,187751,Lnx9qfv9cteMJOlTSwfPI0L1Rjj11T9w,5Gyp41oLVo7Gg7vF4vpmggWP5MU70QO6,10,4,3,0,1,1,6,1,16,2.2857142857142856,1,0.0,0,3,0,1,4,1,0,6,1,4,12,1
20366,187833,9C49qYuvWX3CN7ZTjfCbwdzudgRd6ieI,5Gyp41oLVo7Gg7vF4vpmggWP5MU70QO6,6,8,0,0,0,0,5,0,13,1.8571428571428572,1,0.0,0,0,0,0,8,0,0,5,0,0,13,1
20367,187835,gL404ct0FTiEYon95m5egQXV5s5d3s3Y,5Gyp41oLVo7Gg7vF4vpmggWP5MU70QO6,5,3,1,0,1,0,2,0,7,1.0,1,0.0,0,1,0,1,3,0,0,2,0,2,5,1
20368,187843,A7KWNeLQkkndNIvCdhWgxPt56qJVEywp,5Gyp41oLVo7Gg7vF4vpmggWP5MU70QO6,8,10,5,0,3,0,2,0,20,2.857142857142857,2,0.0,2,5,0,3,8,0,0,2,0,10,10,1
20369,187852,0QlfOSFSvXIm9wHvaQfBOp6BwFpoSBou,5Gyp41oLVo7Gg7vF4vpmggWP5MU70QO6,12,23,5,8,5,0,3,0,44,6.285714285714286,1,0.0,16,5,6,5,7,0,2,3,0,32,12,1
20370,187875,VA4zvww75eVbokKUKFIBvjVtRxGAek2a,5Gyp41oLVo7Gg7vF4vpmggWP5MU70QO6,4,2,1,0,0,0,3,0,6,0.8571428571428571,1,0.0,0,1,0,0,2,0,0,3,0,1,5,1
20371,187893,NgTcbg2BOp0SJ6ucVtVWMLnsvviNigX7,5Gyp41oLVo7Gg7vF4vpmggWP5MU70QO6,9,5,3,0,2,0,3,0,13,1.8571428571428572,1,0.0,0,3,0,2,5,0,0,3,0,5,8,1
20372,187908,8Ma3J2qVEQVCcL3JIoc5G5tjVC70Nx7G,5Gyp41oLVo7Gg7vF4vpmggWP5MU70QO6,21,27,20,5,6,0,3,0,61,8.714285714285714,1,0.0,2,20,3,6,25,0,2,3,0,31,30,1
20373,187913,UUDwBia6o7bnGLf9MCmceg8dt7257Z2a,5Gyp41oLVo7Gg7vF4vpmggWP5MU70QO6,8,5,4,0,0,3,5,1,18,2.5714285714285716,1,0.0,0,4,0,0,5,3,0,5,1,4,14,1
20374,187914,so04UHX42q6jI3lvj3RNVSKJ1VPEH1YP,5Gyp41oLVo7Gg7vF4vpmggWP5MU70QO6,7,3,1,0,2,0,2,0,8,1.1428571428571428,1,0.0,0,1,0,2,3,0,0,2,0,3,5,1
20375,187920,BaYEpyheB5ZN21YYOcUe0rcGnn05lteQ,5Gyp41oLVo7Gg7vF4vpmggWP5MU70QO6,7,4,3,0,2,2,4,0,15,2.142857142857143,1,0.0,0,3,0,2,4,2,0,4,0,5,10,1
20376,187925,lOvvmFbzX3GW24KMAjnXYdwjfcs6WtDl,5Gyp41oLVo7Gg7vF4vpmggWP5MU70QO6,5,2,1,0,1,0,2,0,6,0.8571428571428571,1,0.0,0,1,0,1,2,0,0,2,0,2,4,1
20377,187927,eaviSfmTEk7j37CYqNru3JuRLaAg9VOq,5Gyp41oLVo7Gg7vF4vpmggWP5MU70QO6,6,3,1,0,1,0,3,0,8,1.1428571428571428,1,0.0,1,1,0,1,2,0,0,3,0,3,5,1
20378,187947,uC4WyLpnX5udb1qEUo6mTPhWKzgo83JG,5Gyp41oLVo7Gg7vF4vpmggWP5MU70QO6,1,0,0,0,0,0,2,0,2,0.2857142857142857,1,0.0,0,0,0,0,0,0,0,2,0,0,2,1
20379,187959,YzQntxJ8wtP7KLHQ3esVRl4P3zocy5DG,5Gyp41oLVo7Gg7vF4vpmggWP5MU70QO6,6,5,2,0,2,0,1,0,10,1.4285714285714286,1,0.0,0,2,0,2,5,0,0,1,0,4,6,1
20380,187962,FrgiKI2DEjcm1ldLQtou80RQjRrNaEh9,5Gyp41oLVo7Gg7vF4vpmggWP5MU70QO6,1,0,0,0,0,0,1,0,1,0.14285714285714285,1,0.0,0,0,0,0,0,0,0,1,0,0,1,1
20381,187965,oqwbVEh25hqeZE0Y1kcexH4o8WqmSMNn,5Gyp41oLVo7Gg7vF4vpmggWP5MU70QO6,10,4,2,0,2,5,7,1,21,3.0,1,0.0,0,2,0,2,4,5,0,7,1,4,17,1
20382,187969,Cz8YbZuqlAMA0OaKE0FXfm6tP2nm0keQ,5Gyp41oLVo7Gg7vF4vpmggWP5MU70QO6,8,7,3,0,3,0,1,0,14,2.0,1,0.0,2,3,0,3,5,0,0,1,0,8,6,1
20383,188000,kkPme6dGu7ofLWXsqZkyk5UoyeSjozi6,5Gyp41oLVo7Gg7vF4vpmggWP5MU70QO6,7,5,3,2,2,0,1,0,13,1.8571428571428572,1,0.0,1,3,2,2,4,0,0,1,0,8,5,1
20384,188005,nfS51TNe96GHqM8nL22JKxwIAMwvuxmZ,5Gyp41oLVo7Gg7vF4vpmggWP5MU70QO6,8,6,4,0,3,0,2,0,15,2.142857142857143,1,0.0,0,4,0,3,6,0,0,2,0,7,8,1
20385,188008,EbhEKkK0InsrxKv61aHGTKOc8r6D96CH,5Gyp41oLVo7Gg7vF4vpmggWP5MU70QO6,1,0,0,0,0,0,1,0,1,0.14285714285714285,1,0.0,0,0,0,0,0,0,0,1,0,0,1,1
20386,188010,VsWvOsMJHOlgRBhYoEhQA9GwOYbOPlS0,5Gyp41oLVo7Gg7vF4vpmggWP5MU70QO6,6,1,1,0,1,0,6,0,9,1.2857142857142858,1,0.0,0,1,0,1,1,0,0,6,0,2,7,1
20387,188024,SnQ7aGMt4uZlQyXCfPxKQ3wQgsI8Vuwo,5Gyp41oLVo7Gg7vF4vpmggWP5MU70QO6,1,0,0,0,0,0,1,0,1,0.14285714285714285,1,0.0,0,0,0,0,0,0,0,1,0,0,1,1
20388,188030,UQ4tDNYBiwtltirE3VXKma6eYKFWIZ1n,5Gyp41oLVo7Gg7vF4vpmggWP5MU70QO6,1,0,0,0,0,0,1,0,1,0.14285714285714285,1,0.0,0,0,0,0,0,0,0,1,0,0,1,1
20389,188047,apRBg875HDkrVuiXCnSpAny1kVq4teuC,5Gyp41oLVo7Gg7vF4vpmggWP5MU70QO6,12,17,7,9,8,4,1,0,46,6.571428571428571,1,0.0,8,7,6,8,9,4,3,1,0,29,17,1
20390,188070,5VCrfPcIKKrhaZCO9tkwq4PGRy2D1TeR,5Gyp41oLVo7Gg7vF4vpmggWP5MU70QO6,6,5,2,0,2,0,2,0,11,1.5714285714285714,1,0.0,0,2,0,2,5,0,0,2,0,4,7,1
20391,188085,zRnOVNOS86llNSo73YXoV5gxm1bqsSCm,SpATywNh6bZuzm8s1ceuBUnMUAeoAHHw,5,2,1,0,1,0,2,0,6,0.8571428571428571,1,0.0,0,1,0,1,2,0,0,2,0,2,4,1
20392,188090,ybIzxkMDLWLrDVExEcMDqo8WM6vEGkZZ,SpATywNh6bZuzm8s1ceuBUnMUAeoAHHw,1,0,0,0,0,0,1,0,1,0.14285714285714285,1,0.0,0,0,0,0,0,0,0,1,0,0,1,1
20393,188094,ThbgWOtxqhoj3CitI04NYmRPUH8AcwTc,bWdj2GDclj5ofokWjzoa5jAwMkxCykd6,5,2,1,0,1,0,2,0,6,0.8571428571428571,1,0.0,0,1,0,1,2,0,0,2,0,2,4,1
20394,188109,OH3E8d7hl8qczf2rbzD7q87CuSXHDkzd,SpATywNh6bZuzm8s1ceuBUnMUAeoAHHw,7,3,2,0,2,0,2,0,9,1.2857142857142858,1,0.0,0,2,0,2,3,0,0,2,0,4,5,1
20395,188110,C3IAtr3DP6X43hGuQp5cpcBsS3W9ZHlR,A3fsA9Zfv1X2fVEQhTw51lKENdNrEqT3,9,6,4,0,2,0,4,0,16,2.2857142857142856,3,0.0,0,4,0,2,6,0,0,4,0,6,10,1
20396,188116,MK8k0hhUdWdpYmj0isuX8T1dViy4UCt1,SpATywNh6bZuzm8s1ceuBUnMUAeoAHHw,18,19,6,18,4,0,5,0,52,7.428571428571429,2,0.0,8,6,15,4,11,0,3,5,0,33,19,1
20397,188130,yf5lbvaFDQkrMlGgcstn1q64tRnOCok9,SpATywNh6bZuzm8s1ceuBUnMUAeoAHHw,1,0,0,0,0,0,1,0,1,0.14285714285714285,1,0.0,0,0,0,0,0,0,0,1,0,0,1,1
20398,188131,M16e8QYaHQdZuQp8Y763VwuDYhM2nJCJ,bWdj2GDclj5ofokWjzoa5jAwMkxCykd6,1,0,0,0,0,0,1,0,1,0.14285714285714285,1,0.0,0,0,0,0,0,0,0,1,0,0,1,1
20399,188142,rUr3hxt1niPeDbjT1dWASqAoHDERYMHJ,A3fsA9Zfv1X2fVEQhTw51lKENdNrEqT3,16,3,1,58,0,0,2,0,64,9.142857142857142,1,0.0,0,1,50,0,3,0,8,2,0,51,13,1
20400,188154,iiOxy6ZHzLGvKGuYRdh7FVWh0KnEKqfO,bWdj2GDclj5ofokWjzoa5jAwMkxCykd6,2,0,0,0,0,0,2,0,2,0.2857142857142857,1,0.0,0,0,0,0,0,0,0,2,0,0,2,1
20401,188159,7Yp7JtPvuAevQOAXXsHTKvHnWR7urZQ4,G8EPVSXsOYB5YQWZGiz1aVq5Pgr2GrQu,13,10,6,0,5,1,9,1,32,4.571428571428571,1,0.0,0,6,0,5,10,1,0,9,1,11,21,1
20402,188164,CHnoo745rkdwAbtfBdiAFrd16E9EwOo7,SpATywNh6bZuzm8s1ceuBUnMUAeoAHHw,7,3,2,0,2,0,2,0,9,1.2857142857142858,1,0.0,0,2,0,2,3,0,0,2,0,4,5,1
20403,188166,CHnoo745rkdwAbtfBdiAFrd16E9EwOo7,A3fsA9Zfv1X2fVEQhTw51lKENdNrEqT3,2,0,0,0,0,0,2,0,2,0.2857142857142857,1,0.0,0,0,0,0,0,0,0,2,0,0,2,1
20404,188187,L4jaFu0vxNsfaC1OhafSk08ztmq6goZk,bWdj2GDclj5ofokWjzoa5jAwMkxCykd6,1,0,0,0,0,0,1,0,1,0.14285714285714285,1,0.0,0,0,0,0,0,0,0,1,0,0,1,1
20405,188194,ZbaPpC6DlaDgy5Ic6oj7YX9qkm2j3Pmr,bWdj2GDclj5ofokWjzoa5jAwMkxCykd6,1,0,0,0,0,0,1,0,1,0.14285714285714285,1,0.0,0,0,0,0,0,0,0,1,0,0,1,1
20406,188195,GSVK27iuI3PAZqwurTaJZ7s4wwjamYAo,bWdj2GDclj5ofokWjzoa5jAwMkxCykd6,1,0,0,0,0,0,1,0,1,0.14285714285714285,1,0.0,0,0,0,0,0,0,0,1,0,0,1,1
20407,188217,aXH2LOKFA6E3yNtljCtC3Nc8jVn6ci1H,A3fsA9Zfv1X2fVEQhTw51lKENdNrEqT3,1,0,0,0,0,0,1,0,1,0.14285714285714285,1,0.0,0,0,0,0,0,0,0,1,0,0,1,1
20408,188219,ycZck16llBAZloBk10bwfMcnaMnaXQWK,G8EPVSXsOYB5YQWZGiz1aVq5Pgr2GrQu,8,8,1,4,1,0,3,0,17,2.4285714285714284,1,0.0,0,1,3,1,8,0,1,3,0,5,12,1
20409,188239,zItJ3nxDMUzUt8KfP7wnRxeJL6qP12Ql,SpATywNh6bZuzm8s1ceuBUnMUAeoAHHw,21,16,10,19,7,1,3,1,57,8.142857142857142,1,0.0,5,10,16,7,11,1,3,3,1,38,19,0
20410,188247,BKY6uxinHYYQ0SbTdivOCWOjfYsvPMBo,G8EPVSXsOYB5YQWZGiz1aVq5Pgr2GrQu,21,37,30,36,19,0,7,1,130,18.571428571428573,1,0.0,2,30,35,19,35,0,1,7,1,86,44,1
20411,188261,JxIBkz7Ac4cigQzgeXEdcv5rttnqlmPu,SpATywNh6bZuzm8s1ceuBUnMUAeoAHHw,7,13,6,0,5,0,1,0,25,3.5714285714285716,1,0.0,0,6,0,5,13,0,0,1,0,11,14,1
20412,188265,4M7QUx9Fzm9ZPaWRvEUxQx27jAilEGAL,SpATywNh6bZuzm8s1ceuBUnMUAeoAHHw,1,0,0,0,0,0,1,0,1,0.14285714285714285,1,0.0,0,0,0,0,0,0,0,1,0,0,1,1
20413,188285,VDLlgOqW7FFpT6uHqFXXlnnZR1JOz0x8,bWdj2GDclj5ofokWjzoa5jAwMkxCykd6,5,2,1,0,1,0,2,0,6,0.8571428571428571,1,0.0,0,1,0,1,2,0,0,2,0,2,4,1
20414,188303,jIZxfoiSxH2AO4xoJAniqOuewjPFpPI5,bWdj2GDclj5ofokWjzoa5jAwMkxCykd6,2,0,0,0,0,0,2,0,2,0.2857142857142857,1,0.0,0,0,0,0,0,0,0,2,0,0,2,1
20415,188309,YBtKAFQt6fk6EIukc4Ut5J2kdzYxomaP,G8EPVSXsOYB5YQWZGiz1aVq5Pgr2GrQu,4,2,0,0,0,0,2,1,5,0.7142857142857143,1,0.0,0,0,0,0,2,0,0,2,1,0,5,1
20416,188313,Z34rmr1DW5f5nfzpsFgtbvoODrTWS0gR,A3fsA9Zfv1X2fVEQhTw51lKENdNrEqT3,10,6,5,0,3,0,2,0,16,2.2857142857142856,1,0.0,0,5,0,3,6,0,0,2,0,8,8,1
20417,188317,SgxzSZm3WqSNUUUyFr3EYdvWEPQiCYXc,SpATywNh6bZuzm8s1ceuBUnMUAeoAHHw,5,4,1,0,0,1,3,0,9,1.2857142857142858,1,0.0,0,1,0,0,4,1,0,3,0,1,8,1
20418,188340,lXbqqhFQBJZOyvWBPJdHT24KBsdCctUo,A3fsA9Zfv1X2fVEQhTw51lKENdNrEqT3,2,0,0,0,0,0,2,0,2,0.2857142857142857,1,0.0,0,0,0,0,0,0,0,2,0,0,2,1
20419,188349,OiGglfoFWXujNzXY3OeV6ty8l3z95RBT,G8EPVSXsOYB5YQWZGiz1aVq5Pgr2GrQu,5,2,1,0,1,0,4,0,8,1.1428571428571428,1,0.0,0,1,0,1,2,0,0,4,0,2,6,1
20420,188350,jafkqz7Ls6SMq5HQIDonLkyeZrg5LRjK,bWdj2GDclj5ofokWjzoa5jAwMkxCykd6,2,0,0,0,0,0,3,0,3,0.42857142857142855,1,0.0,0,0,0,0,0,0,0,3,0,0,3,1
20421,188365,4ly9tFjgsKJLiMP1XUHFz2i27nHiXdvU,bWdj2GDclj5ofokWjzoa5jAwMkxCykd6,2,0,0,0,0,0,2,0,2,0.2857142857142857,1,0.0,0,0,0,0,0,0,0,2,0,0,2,1
20422,188366,Qb1CgQ8SxoQQTE8swhxPBVi0nI23eAzb,A3fsA9Zfv1X2fVEQhTw51lKENdNrEqT3,30,15,6,52,2,0,6,0,81,11.571428571428571,2,0.0,2,6,51,2,13,0,1,6,0,61,20,1
20423,188380,YvqXtgBNC43WLi1Y1OHrc4YV5wJZj5BZ,SpATywNh6bZuzm8s1ceuBUnMUAeoAHHw,1,0,0,0,0,0,1,0,1,0.14285714285714285,1,0.0,0,0,0,0,0,0,0,1,0,0,1,1
20424,188395,3RtHMyLQOrBsDYp6yo5VYdmS72cr3PBJ,A3fsA9Zfv1X2fVEQhTw51lKENdNrEqT3,4,4,1,0,0,0,2,0,7,1.0,1,0.0,0,1,0,0,4,0,0,2,0,1,6,1
20425,188404,vN6O2x0QSqyADqu8ib3CnGtyQMSLegp0,SpATywNh6bZuzm8s1ceuBUnMUAeoAHHw,6,5,2,0,1,0,3,0,11,1.5714285714285714,1,0.0,0,2,0,1,5,0,0,3,0,3,8,1
20426,188429,O1acx8tASPAKCowx3gb1g3tmN6Tc39LY,SpATywNh6bZuzm8s1ceuBUnMUAeoAHHw,5,3,1,0,1,0,2,0,7,1.0,1,0.0,0,1,0,1,3,0,0,2,0,2,5,1
20427,188437,xGSY8Cd0Vf3OB8ao8DFjx5u3ZfaDhjub,SpATywNh6bZuzm8s1ceuBUnMUAeoAHHw,4,2,0,0,0,0,3,0,5,0.7142857142857143,1,0.0,0,0,0,0,2,0,0,3,0,0,5,1
20428,188443,2I5ebzNsijWnJvqjKSef4ff3wTM7uHNA,SpATywNh6bZuzm8s1ceuBUnMUAeoAHHw,19,21,13,18,6,1,6,1,66,9.428571428571429,1,0.0,5,13,15,6,16,1,3,6,1,39,27,1
20429,188449,Pp88hiBrGOv2jXNIxXAtL4Okpq7q1gT0,SpATywNh6bZuzm8s1ceuBUnMUAeoAHHw,9,10,4,4,0,0,2,0,20,2.857142857142857,1,0.0,4,4,3,0,6,0,1,2,0,11,9,1
20430,188453,hVaGaJRn8sLkma0vlTnpuIvccDoCcRmU,SpATywNh6bZuzm8s1ceuBUnMUAeoAHHw,11,9,1,10,0,0,3,0,23,3.2857142857142856,1,0.0,1,1,9,0,8,0,1,3,0,11,12,1
20431,188457,gKGgdSFWPcygAewBStBoLPqo60qbmH1E,SpATywNh6bZuzm8s1ceuBUnMUAeoAHHw,6,3,1,0,1,0,2,0,7,1.0,1,0.0,0,1,0,1,3,0,0,2,0,2,5,1
20432,188473,A5GOsdnH2EcjC6B3eZFXiZImo9yFgAgf,SpATywNh6bZuzm8s1ceuBUnMUAeoAHHw,7,5,1,0,1,0,2,0,9,1.2857142857142858,1,0.0,0,1,0,1,5,0,0,2,0,2,7,1
20433,188474,T2bqEEIIeGnaI1g4yvbhFPGfktTUZc7r,A3fsA9Zfv1X2fVEQhTw51lKENdNrEqT3,8,10,3,0,3,0,4,0,20,2.857142857142857,2,0.0,0,3,0,3,10,0,0,4,0,6,14,1
20434,188485,DnH0S2FmhfjVrDlDj5ZYyy4G86Cb3LMh,A3fsA9Zfv1X2fVEQhTw51lKENdNrEqT3,20,8,7,0,7,1,8,1,32,4.571428571428571,1,0.0,0,7,0,7,8,1,0,8,1,14,18,1
20435,188490,V6YPbhCrTroTd2oOIiUcM7kFRRLU5vrj,A3fsA9Zfv1X2fVEQhTw51lKENdNrEqT3,10,5,4,0,4,0,1,0,14,2.0,1,0.0,0,4,0,4,5,0,0,1,0,8,6,1
20436,188492,Bm156uclJazpLCklS4EEwaPxoPGPtFcp,SpATywNh6bZuzm8s1ceuBUnMUAeoAHHw,5,2,1,0,1,0,2,0,6,0.8571428571428571,1,0.0,0,1,0,1,2,0,0,2,0,2,4,1
20437,188500,j6ThnD1jS0Zu8CWEKNbNRNMNGJz47quI,SpATywNh6bZuzm8s1ceuBUnMUAeoAHHw,19,18,13,14,11,3,1,0,60,8.571428571428571,1,0.0,3,13,14,11,15,3,0,1,0,41,19,1
20438,188505,YnmpFl6RHXV2PnbToNbHTDGl7f0k3wEj,SpATywNh6bZuzm8s1ceuBUnMUAeoAHHw,7,3,2,0,2,0,2,0,9,1.2857142857142858,1,0.0,0,2,0,2,3,0,0,2,0,4,5,1
20439,188513,Vr0kaKAkI4p2upUYNB1MMKsTShBZob66,bWdj2GDclj5ofokWjzoa5jAwMkxCykd6,1,0,0,0,0,0,1,0,1,0.14285714285714285,1,0.0,0,0,0,0,0,0,0,1,0,0,1,1
20440,188517,udLbdwzexRvhhTaiAuWi3yugEk6gj6AD,SpATywNh6bZuzm8s1ceuBUnMUAeoAHHw,6,5,4,0,4,0,1,0,14,2.0,1,0.0,0,4,0,4,5,0,0,1,0,8,6,1
20441,188521,bK37SC4aHpDxnD3Rvkijz9Wy2oAlQRmW,bWdj2GDclj5ofokWjzoa5jAwMkxCykd6,6,2,0,0,0,0,7,1,10,1.4285714285714286,1,0.0,0,0,0,0,2,0,0,7,1,0,10,1
20442,188530,1NKuiSaTPUbZFDACCyv5YoUfO7qDer9w,SpATywNh6bZuzm8s1ceuBUnMUAeoAHHw,3,3,1,0,0,0,1,0,5,0.7142857142857143,1,0.0,0,1,0,0,3,0,0,1,0,1,4,1
20443,188532,3sMwGCOGCL2RAMMG6tfFT0UobGq5flFz,SpATywNh6bZuzm8s1ceuBUnMUAeoAHHw,6,3,2,0,2,0,1,0,8,1.1428571428571428,1,0.0,0,2,0,2,3,0,0,1,0,4,4,1
20444,188535,DVNRZ0Vb68sNhFssev2X8FTZcbZTVgAF,RXDvfPUBYFlVdlueBFbLW0mhhAyGEqpt,1,0,0,0,0,0,1,0,1,0.14285714285714285,1,0.0,0,0,0,0,0,0,0,1,0,0,1,1
20445,188543,JV1BgG1khCT6s4RU5oY7ZOSmwW31Qjbp,A3fsA9Zfv1X2fVEQhTw51lKENdNrEqT3,3,0,0,0,0,1,2,0,3,0.42857142857142855,1,0.0,0,0,0,0,0,1,0,2,0,0,3,1
20446,188551,SSoRd5SzkY86SEd4leqERj2oURCXSCvn,SpATywNh6bZuzm8s1ceuBUnMUAeoAHHw,5,2,1,0,1,0,2,0,6,0.8571428571428571,1,0.0,0,1,0,1,2,0,0,2,0,2,4,1
20447,188559,pGYLDmhkSj1iBp1YljlDSId0XSrjZNZR,A3fsA9Zfv1X2fVEQhTw51lKENdNrEqT3,9,7,5,0,4,0,3,0,19,2.7142857142857144,2,0.0,0,5,0,4,7,0,0,3,0,9,10,1
20448,188560,5gty34EJtQfrhgxngYuTOUGIUr24foZa,SpATywNh6bZuzm8s1ceuBUnMUAeoAHHw,2,0,0,0,0,0,2,0,2,0.2857142857142857,1,0.0,0,0,0,0,0,0,0,2,0,0,2,1
20449,188567,j6ThnD1jS0Zu8CWEKNbNRNMNGJz47quI,A3fsA9Zfv1X2fVEQhTw51lKENdNrEqT3,10,7,5,0,5,0,1,0,18,2.5714285714285716,1,0.0,1,5,0,5,6,0,0,1,0,11,7,1
20450,188572,y9xw5DVwyk92GMkn6gBPMifXrAjYvHji,A3fsA9Zfv1X2fVEQhTw51lKENdNrEqT3,13,10,6,0,3,0,6,2,27,3.857142857142857,1,0.0,2,6,0,3,8,0,0,6,2,11,16,1
20451,188593,urj2Kr7Ws5qXQZp6biE11Qihh39xd0AE,SpATywNh6bZuzm8s1ceuBUnMUAeoAHHw,1,0,0,0,0,0,1,0,1,0.14285714285714285,1,0.0,0,0,0,0,0,0,0,1,0,0,1,1
20452,188618,xteF5FHjR9QQQGxa0LyAUB4pHnIcVbG6,SpATywNh6bZuzm8s1ceuBUnMUAeoAHHw,1,0,0,0,0,0,1,0,1,0.14285714285714285,1,0.0,0,0,0,0,0,0,0,1,0,0,1,1
20453,188635,0sfQp4STEjfvmoiPU7wK8kVHvDAbzKnN,SpATywNh6bZuzm8s1ceuBUnMUAeoAHHw,7,3,1,0,2,0,2,0,8,1.1428571428571428,1,0.0,0,1,0,2,3,0,0,2,0,3,5,1
20454,188643,16lFu8CHy4ustz36vrR0Ab5cogeu487w,A3fsA9Zfv1X2fVEQhTw51lKENdNrEqT3,2,0,0,0,0,0,2,0,2,0.2857142857142857,1,0.0,0,0,0,0,0,0,0,2,0,0,2,1
20455,188658,U04y5vFf0AfyJVGIOJHlryTyRQEOm5pT,3VkHkmOtom3jM2wCu94xgzzu1d6Dn7or,1,0,0,0,0,0,1,0,1,0.14285714285714285,1,0.0,0,0,0,0,0,0,0,1,0,0,1,1
20456,188659,lA9ihWWB9sZPFslDp6NhYp0arqpvKh8B,3VkHkmOtom3jM2wCu94xgzzu1d6Dn7or,4,5,0,0,0,0,1,0,6,0.8571428571428571,1,0.0,2,0,0,0,3,0,0,1,0,2,4,1
20457,188662,YbX8fApIBY3HjcLkuDXiUFNKK8oYzceC,3VkHkmOtom3jM2wCu94xgzzu1d6Dn7or,1,0,0,0,0,0,1,0,1,0.14285714285714285,1,0.0,0,0,0,0,0,0,0,1,0,0,1,1
20458,188663,TDl0DtlpN9qej21HjowMH1oiSRLXpU6M,3VkHkmOtom3jM2wCu94xgzzu1d6Dn7or,6,4,0,0,2,0,5,0,11,1.5714285714285714,1,0.0,2,0,0,2,2,0,0,5,0,4,7,1
20459,188669,qTGt3BzwYixjdIMVT6SnF4YbX0lYzCYz,3VkHkmOtom3jM2wCu94xgzzu1d6Dn7or,3,5,1,0,1,0,6,0,13,1.8571428571428572,1,0.0,3,1,0,1,2,0,0,6,0,5,8,1
20460,188670,Q95dTGCZ4ON6KcY8VYaWLipwcRku4Hrg,3VkHkmOtom3jM2wCu94xgzzu1d6Dn7or,1,0,0,0,0,0,1,0,1,0.14285714285714285,1,0.0,0,0,0,0,0,0,0,1,0,0,1,1
20461,188671,AH5OII9dyx9wT5bjdsXGXLQb3KdAdGBY,3VkHkmOtom3jM2wCu94xgzzu1d6Dn7or,4,2,1,0,0,0,3,0,6,0.8571428571428571,1,0.0,0,1,0,0,2,0,0,3,0,1,5,1
20462,188674,maUV1iJW72ILo25uuQHC815ZOBBugLVZ,3VkHkmOtom3jM2wCu94xgzzu1d6Dn7or,4,2,0,0,0,0,2,0,4,0.5714285714285714,1,0.0,0,0,0,0,2,0,0,2,0,0,4,1
20463,188684,CDMI3gQZrAOAZ9Cf4jB5NzA4daPYwjjn,3VkHkmOtom3jM2wCu94xgzzu1d6Dn7or,1,0,0,0,0,0,2,0,2,0.2857142857142857,1,0.0,0,0,0,0,0,0,0,2,0,0,2,1
20464,188690,ewVdenI3ii0QbKb1HvtCMFMP3xCwXPuR,3VkHkmOtom3jM2wCu94xgzzu1d6Dn7or,1,0,0,0,0,0,1,0,1,0.14285714285714285,1,0.0,0,0,0,0,0,0,0,1,0,0,1,1
20465,188692,ixikujvy7OPcGlarThFYWGJcfxiAOSqS,3VkHkmOtom3jM2wCu94xgzzu1d6Dn7or,1,0,0,0,0,0,2,0,2,0.2857142857142857,1,0.0,0,0,0,0,0,0,0,2,0,0,2,1
20466,188693,bFgdU5ETBjM1cv0pmCZmJ30mob6TFCew,3VkHkmOtom3jM2wCu94xgzzu1d6Dn7or,9,13,7,0,4,0,6,0,30,4.285714285714286,1,0.0,0,7,0,4,13,0,0,6,0,11,19,1
20467,188697,pRqPfndktB0iaklPeO3kM9dkkXvJ959B,3VkHkmOtom3jM2wCu94xgzzu1d6Dn7or,1,0,0,0,0,0,1,0,1,0.14285714285714285,1,0.0,0,0,0,0,0,0,0,1,0,0,1,1
20468,188699,5edwsV0rSaO4canq9PmROjVSvIBXaKee,3VkHkmOtom3jM2wCu94xgzzu1d6Dn7or,1,0,0,0,0,0,1,0,1,0.14285714285714285,1,0.0,0,0,0,0,0,0,0,1,0,0,1,1
20469,188700,WJYwHq4MAYpsoxlwld5JmekuEAGtYGxu,3VkHkmOtom3jM2wCu94xgzzu1d6Dn7or,1,0,0,0,0,0,2,0,2,0.2857142857142857,1,0.0,0,0,0,0,0,0,0,2,0,0,2,1
20470,188702,xmBwVbexO2tnK60XF9lhQfssrvUu3EtO,3VkHkmOtom3jM2wCu94xgzzu1d6Dn7or,6,5,3,0,2,0,4,0,14,2.0,1,0.0,0,3,0,2,5,0,0,4,0,5,9,1
20471,188709,gtYDHbXt8R8azkka5kzFsHNwA23A5Hue,3VkHkmOtom3jM2wCu94xgzzu1d6Dn7or,1,0,0,0,0,0,1,0,1,0.14285714285714285,1,0.0,0,0,0,0,0,0,0,1,0,0,1,1
20472,188712,iUkvPv1ADKDFpfINSYIVgOb29QzsFRBv,3VkHkmOtom3jM2wCu94xgzzu1d6Dn7or,18,31,7,24,14,0,7,0,83,11.857142857142858,1,0.0,21,7,18,14,10,0,6,7,0,60,23,1
20473,188713,8VR49myeLl2TVo6pia0O1Ii3XbA9L3S6,3VkHkmOtom3jM2wCu94xgzzu1d6Dn7or,5,4,1,0,2,0,4,0,11,1.5714285714285714,1,0.0,2,1,0,2,2,0,0,4,0,5,6,1
20474,188716,hyhyxhn6qO7nii28PZygBx2DF5Qsnp6b,3VkHkmOtom3jM2wCu94xgzzu1d6Dn7or,15,9,4,12,4,8,2,0,39,5.571428571428571,1,0.0,4,4,11,4,5,8,1,2,0,23,16,1
20475,188717,wqhKrkgXxSAE1Oo3bDIzJT0VXIkqfpG9,3VkHkmOtom3jM2wCu94xgzzu1d6Dn7or,12,25,8,0,1,0,3,0,37,5.285714285714286,1,0.0,0,8,0,1,25,0,0,3,0,9,28,1
20476,188718,QCtfk6tJp7XadjCmtspnvCx7BG9wX5iQ,3VkHkmOtom3jM2wCu94xgzzu1d6Dn7or,6,3,1,0,1,0,9,0,14,2.0,1,0.0,0,1,0,1,3,0,0,9,0,2,12,1
20477,188735,FjtBUAcSkmEqPuMvORlAdNbLQkFsZ2Me,3VkHkmOtom3jM2wCu94xgzzu1d6Dn7or,7,3,1,0,1,0,4,0,9,1.2857142857142858,1,0.0,0,1,0,1,3,0,0,4,0,2,7,1
20478,188736,FUNaelmEa8QQPf1OIStRzYhYYYcyBWNB,3VkHkmOtom3jM2wCu94xgzzu1d6Dn7or,5,2,1,0,1,2,3,1,10,1.4285714285714286,1,0.0,0,1,0,1,2,2,0,3,1,2,8,1
20479,188737,8eK95Lg506H8Frd5DObFf3X5x2dCpTfm,3VkHkmOtom3jM2wCu94xgzzu1d6Dn7or,4,0,0,0,0,1,4,0,5,0.7142857142857143,1,0.0,0,0,0,0,0,1,0,4,0,0,5,1
20480,188747,P70z46uTprZB6z9xVYakXpbukwH7QSkJ,3VkHkmOtom3jM2wCu94xgzzu1d6Dn7or,1,0,0,0,0,0,1,0,1,0.14285714285714285,1,0.0,0,0,0,0,0,0,0,1,0,0,1,1
20481,188750,3tNyA4m16KDqsjcEf4fmjId48Ck65Ay4,3VkHkmOtom3jM2wCu94xgzzu1d6Dn7or,6,5,1,0,2,1,4,1,14,2.0,1,0.0,3,1,0,2,2,1,0,4,1,6,8,1
20482,188756,1hqyThhgIBj0NPMIw4GgUFPsh3dbajdS,3VkHkmOtom3jM2wCu94xgzzu1d6Dn7or,4,2,0,0,1,0,2,0,5,0.7142857142857143,1,0.0,0,0,0,1,2,0,0,2,0,1,4,1
20483,188771,kiLantJiDD44Gb4DDiHa8ctBpYIzNNAl,3VkHkmOtom3jM2wCu94xgzzu1d6Dn7or,1,0,0,0,0,0,2,0,2,0.2857142857142857,1,0.0,0,0,0,0,0,0,0,2,0,0,2,1
20484,188773,GzhPw6gTnuScsMgYuKpeOkfi3m9h7huh,3VkHkmOtom3jM2wCu94xgzzu1d6Dn7or,5,5,2,0,1,0,1,0,9,1.2857142857142858,1,0.0,1,2,0,1,4,0,0,1,0,4,5,1
20485,188776,TK6SHaGDpnyylXHTHrardGGrkWmvQsTG,3VkHkmOtom3jM2wCu94xgzzu1d6Dn7or,7,10,1,0,3,0,2,0,16,2.2857142857142856,1,0.0,0,1,0,3,10,0,0,2,0,4,12,0
20486,188780,Y1hqvH5mAYCdJ0RanCFQwHELZ8kEMEoZ,3VkHkmOtom3jM2wCu94xgzzu1d6Dn7or,1,0,0,0,0,0,1,0,1,0.14285714285714285,1,0.0,0,0,0,0,0,0,0,1,0,0,1,1
20487,188784,rk7MHXhy1HPCViBZ6MqwyHtRLc8mzSRs,3VkHkmOtom3jM2wCu94xgzzu1d6Dn7or,1,0,0,0,0,0,1,0,1,0.14285714285714285,1,0.0,0,0,0,0,0,0,0,1,0,0,1,1
20488,188786,GejrrsPDZacC7IIHMiNBKPgA2uPkulOL,3VkHkmOtom3jM2wCu94xgzzu1d6Dn7or,9,7,2,0,1,1,6,1,18,2.5714285714285716,1,0.0,0,2,0,1,7,1,0,6,1,3,15,1
20489,188789,9zAvIiOTmvwKs5zxDeEGh8xAnj14bMeF,3VkHkmOtom3jM2wCu94xgzzu1d6Dn7or,1,0,0,0,0,0,1,0,1,0.14285714285714285,1,0.0,0,0,0,0,0,0,0,1,0,0,1,1
20490,188791,Wr1EXlwEXZiira3WnrRuVlAZx6ae2UAD,3VkHkmOtom3jM2wCu94xgzzu1d6Dn7or,1,0,0,0,0,0,1,0,1,0.14285714285714285,1,0.0,0,0,0,0,0,0,0,1,0,0,1,1
20491,188796,2IusVSXuZh4ZKixkvvHxyr0x3bM376uT,3VkHkmOtom3jM2wCu94xgzzu1d6Dn7or,1,0,0,0,0,0,1,0,1,0.14285714285714285,1,0.0,0,0,0,0,0,0,0,1,0,0,1,0
20492,188808,NxkMyb1cXhu1RYGIQNAxwZAikxqtRklq,3VkHkmOtom3jM2wCu94xgzzu1d6Dn7or,1,0,0,0,0,0,1,0,1,0.14285714285714285,1,0.0,0,0,0,0,0,0,0,1,0,0,1,1
20493,188843,kmmPSxfhDvRRsDMBheqQFyCMhadkfnef,3VkHkmOtom3jM2wCu94xgzzu1d6Dn7or,1,0,0,0,0,0,1,0,1,0.14285714285714285,1,0.0,0,0,0,0,0,0,0,1,0,0,1,1
20494,188846,I9NL1qTyNfYke8oVwpgv4jZGLSOUwslQ,3VkHkmOtom3jM2wCu94xgzzu1d6Dn7or,1,0,0,0,0,0,1,0,1,0.14285714285714285,1,0.0,0,0,0,0,0,0,0,1,0,0,1,1
20495,188848,Tg9D6IEYNp5BbQ6nAfMOrpQsvaqAV0MU,3VkHkmOtom3jM2wCu94xgzzu1d6Dn7or,4,0,0,0,0,0,3,1,4,0.5714285714285714,1,0.0,0,0,0,0,0,0,0,3,1,0,4,1
20496,188854,7uK5Har2uSZGi9UmezTQ7z0vCs9kGDqJ,3VkHkmOtom3jM2wCu94xgzzu1d6Dn7or,1,0,0,0,0,0,2,0,2,0.2857142857142857,1,0.0,0,0,0,0,0,0,0,2,0,0,2,1
20497,188856,ocD5tMKpDBpYAujAVOgSyUvYv4F4fBmF,3VkHkmOtom3jM2wCu94xgzzu1d6Dn7or,12,21,9,4,7,9,7,1,58,8.285714285714286,2,0.0,8,9,3,7,13,9,1,7,1,27,31,1
20498,188862,IE8AjAMlWpfjXARbWdFfyqNaL0ceGdBs,3VkHkmOtom3jM2wCu94xgzzu1d6Dn7or,1,0,0,0,0,0,1,0,1,0.14285714285714285,1,0.0,0,0,0,0,0,0,0,1,0,0,1,1
20499,188864,NwLvlhItYMV0SldaK6inuNUTu4UFaNjp,3VkHkmOtom3jM2wCu94xgzzu1d6Dn7or,5,2,1,0,1,0,2,0,6,0.8571428571428571,1,0.0,0,1,0,1,2,0,0,2,0,2,4,1
20500,188866,ZTQFYZ2qfDfJQnXGAjW1tyVkHwwdfrmt,3VkHkmOtom3jM2wCu94xgzzu1d6Dn7or,1,0,0,0,0,0,1,0,1,0.14285714285714285,1,0.0,0,0,0,0,0,0,0,1,0,0,1,1
20501,188868,TPDzBQ9rpNjeqli3KFaktTuUnc3ZEdFK,3VkHkmOtom3jM2wCu94xgzzu1d6Dn7or,4,2,1,0,1,0,1,0,5,0.7142857142857143,1,0.0,0,1,0,1,2,0,0,1,0,2,3,1
20502,188871,PHRCx9wyKQjGXWbcIfUScN2q5ez7aVqM,3VkHkmOtom3jM2wCu94xgzzu1d6Dn7or,1,0,0,0,0,0,1,0,1,0.14285714285714285,1,0.0,0,0,0,0,0,0,0,1,0,0,1,1
20503,188873,0Ho4vKPWk3aCMeULKW8jkgKGEXLCR83X,3VkHkmOtom3jM2wCu94xgzzu1d6Dn7or,5,2,1,0,1,0,2,0,6,0.8571428571428571,1,0.0,0,1,0,1,2,0,0,2,0,2,4,1
20504,188877,L39ZdOzVu52b5Nu8u3TuFdomCuDfGlbZ,3VkHkmOtom3jM2wCu94xgzzu1d6Dn7or,9,7,3,0,3,0,2,0,15,2.142857142857143,1,0.0,2,3,0,3,5,0,0,2,0,8,7,1
20505,188878,6qgQAmX6y5wh5nEPRINOiKrZNoTl5yfT,3VkHkmOtom3jM2wCu94xgzzu1d6Dn7or,1,0,0,0,0,0,1,0,1,0.14285714285714285,1,0.0,0,0,0,0,0,0,0,1,0,0,1,1
20506,188880,aA47iNtja2lxoPqFPeHjI7xjYuTmvZjx,3VkHkmOtom3jM2wCu94xgzzu1d6Dn7or,1,0,0,0,0,0,1,0,1,0.14285714285714285,1,0.0,0,0,0,0,0,0,0,1,0,0,1,1
20507,188887,LZWxRbSVnJks5Wtu1M9SRcKFdZS2Pp2o,3VkHkmOtom3jM2wCu94xgzzu1d6Dn7or,1,0,0,0,0,0,1,0,1,0.14285714285714285,1,0.0,0,0,0,0,0,0,0,1,0,0,1,1
20508,188890,ccdfzEdXZgPdB5mpBlvBCguNi5BkPXMi,3VkHkmOtom3jM2wCu94xgzzu1d6Dn7or,9,7,4,0,2,8,3,0,24,3.4285714285714284,1,0.0,1,4,0,2,6,8,0,3,0,7,17,1
20509,188891,OIunh5VlGgmCbVp6rN8NSUpYr9NyGfUf,3VkHkmOtom3jM2wCu94xgzzu1d6Dn7or,1,0,0,0,0,0,1,0,1,0.14285714285714285,1,0.0,0,0,0,0,0,0,0,1,0,0,1,0
20510,188899,lU4swRWZzQKDfCqcF0HkIyAX3M2hMPQF,3VkHkmOtom3jM2wCu94xgzzu1d6Dn7or,2,0,0,0,0,0,2,0,2,0.2857142857142857,1,0.0,0,0,0,0,0,0,0,2,0,0,2,1
20511,188910,E1vVq4GaJ0dO831LRQCFcnkLKgtBE5XJ,3VkHkmOtom3jM2wCu94xgzzu1d6Dn7or,2,0,0,0,0,0,2,0,2,0.2857142857142857,1,0.0,0,0,0,0,0,0,0,2,0,0,2,1
20512,188913,4QSKoi2COLIjISXuWMSgkhYU8OcqVVuy,3VkHkmOtom3jM2wCu94xgzzu1d6Dn7or,3,3,1,0,0,0,6,0,10,1.4285714285714286,1,0.0,0,1,0,0,3,0,0,6,0,1,9,1
20513,188917,doOojwvBSNQrqfeYLOA8pkMINq9DmhqX,5X6FeZozNMgE2VRi3MJYjkkFK8SETtu2,1,0,0,0,0,0,1,0,1,0.14285714285714285,1,0.0,0,0,0,0,0,0,0,1,0,0,1,1
20514,188918,doOojwvBSNQrqfeYLOA8pkMINq9DmhqX,RXDvfPUBYFlVdlueBFbLW0mhhAyGEqpt,1,0,0,0,0,0,1,0,1,0.14285714285714285,1,0.0,0,0,0,0,0,0,0,1,0,0,1,1
20515,188932,DIOAcfUrnrGa4rVzHobRXugj8Ae2jnwK,bWdj2GDclj5ofokWjzoa5jAwMkxCykd6,5,4,1,0,2,0,2,0,9,1.2857142857142858,1,0.0,2,1,0,2,2,0,0,2,0,5,4,0
20516,188933,Xtlrv3IpXCAfEIMntfnxIykrduMXBwb6,7GRhBDsirIGkRZBtSMEzNTyDr2JQm4xx,1,0,0,0,0,0,1,0,1,0.14285714285714285,1,0.0,0,0,0,0,0,0,0,1,0,0,1,1
20517,188937,7gxdF7npc77h7z0KnU9ezGYqtBJqY4fQ,A3fsA9Zfv1X2fVEQhTw51lKENdNrEqT3,1,0,0,0,0,0,3,0,3,0.42857142857142855,2,0.0,0,0,0,0,0,0,0,3,0,0,3,1
20518,188944,Tmy0knxeygbhIfsuJMAS7EjBeIcY7GaB,A3fsA9Zfv1X2fVEQhTw51lKENdNrEqT3,3,2,0,0,0,0,3,0,5,0.7142857142857143,1,0.0,0,0,0,0,2,0,0,3,0,0,5,1
20519,188960,E1o2CPDPeSdQCdvUSK4fkT1XzYkNbbaY,SpATywNh6bZuzm8s1ceuBUnMUAeoAHHw,2,0,0,0,0,0,2,0,2,0.2857142857142857,1,0.0,0,0,0,0,0,0,0,2,0,0,2,1
20520,188961,hlny1PkYo5JEvtbsehOwAyHgv8hye7Vl,bWdj2GDclj5ofokWjzoa5jAwMkxCykd6,4,2,0,0,0,0,4,0,6,0.8571428571428571,1,0.0,0,0,0,0,2,0,0,4,0,0,6,1
20521,188963,bGjzMxOC88rUacNGu6kshAaxdH2zKDK7,7GRhBDsirIGkRZBtSMEzNTyDr2JQm4xx,2,0,0,0,0,0,2,0,2,0.2857142857142857,1,0.0,0,0,0,0,0,0,0,2,0,0,2,1
20522,188974,KcVR47mhsCByukl6kUhifp06p0t9ddmf,7GRhBDsirIGkRZBtSMEzNTyDr2JQm4xx,1,0,0,0,0,0,1,0,1,0.14285714285714285,1,0.0,0,0,0,0,0,0,0,1,0,0,1,1
20523,188976,hlny1PkYo5JEvtbsehOwAyHgv8hye7Vl,7GRhBDsirIGkRZBtSMEzNTyDr2JQm4xx,1,0,0,0,0,0,1,0,1,0.14285714285714285,1,0.0,0,0,0,0,0,0,0,1,0,0,1,1
20524,188979,XoKIP4RGpnZk163890vUyWhLOIUSaapU,7GRhBDsirIGkRZBtSMEzNTyDr2JQm4xx,28,58,22,50,13,2,1,0,146,20.857142857142858,1,0.0,35,22,40,13,23,2,10,1,0,110,36,1
20525,188986,pDtmXyCxgvpAGK1UHOqTKB1Mk4ad0Obx,7GRhBDsirIGkRZBtSMEzNTyDr2JQm4xx,2,0,0,0,0,0,3,0,3,0.42857142857142855,1,0.0,0,0,0,0,0,0,0,3,0,0,3,1
20526,188991,UldIL1DzDiptbquy1FtLVqZpU6749Jps,SpATywNh6bZuzm8s1ceuBUnMUAeoAHHw,6,5,3,0,2,0,4,0,14,2.0,2,0.0,0,3,0,2,5,0,0,4,0,5,9,1
20527,188992,wF8DXQdJZv7SZk0nNMRMmcJSgvwpikPR,SpATywNh6bZuzm8s1ceuBUnMUAeoAHHw,3,0,0,0,0,0,3,0,3,0.42857142857142855,1,0.0,0,0,0,0,0,0,0,3,0,0,3,1
20528,188997,vDLgajPV6eBsq6waPGg2sGMVCdUz10kh,7GRhBDsirIGkRZBtSMEzNTyDr2JQm4xx,6,0,0,0,0,0,9,1,10,1.4285714285714286,1,0.0,0,0,0,0,0,0,0,9,1,0,10,1
20529,189021,RD7hAPb87KYVt93NagDP9Vw7cbq8a6oo,SpATywNh6bZuzm8s1ceuBUnMUAeoAHHw,1,0,0,0,0,0,1,0,1,0.14285714285714285,1,0.0,0,0,0,0,0,0,0,1,0,0,1,1
20530,189022,dNDtzNDGaiacaPHAhGrCyaE0sMH9f5eO,5X6FeZozNMgE2VRi3MJYjkkFK8SETtu2,1,0,0,0,0,0,1,0,1,0.14285714285714285,1,0.0,0,0,0,0,0,0,0,1,0,0,1,1
20531,189030,UcAhBIdVZpMELDlnTcMm9mzDJ1F9Jhg3,RXDvfPUBYFlVdlueBFbLW0mhhAyGEqpt,1,0,0,0,0,0,1,0,1,0.14285714285714285,1,0.0,0,0,0,0,0,0,0,1,0,0,1,1
20532,189038,CaO6lbKucftN7Eu0LZWcCZKQchWcKCTo,7GRhBDsirIGkRZBtSMEzNTyDr2JQm4xx,6,0,0,0,0,0,6,0,6,0.8571428571428571,1,0.0,0,0,0,0,0,0,0,6,0,0,6,1
20533,189048,Lp5Kgg0UtKKwgMnuvlj6sxMiDk9RfZyw,SpATywNh6bZuzm8s1ceuBUnMUAeoAHHw,1,0,0,0,0,0,1,0,1,0.14285714285714285,1,0.0,0,0,0,0,0,0,0,1,0,0,1,1
20534,189057,RZ4LxTkpwGNONWAKNmKhQJBPp4s3H9LB,SpATywNh6bZuzm8s1ceuBUnMUAeoAHHw,1,0,0,0,0,0,2,0,2,0.2857142857142857,1,0.0,0,0,0,0,0,0,0,2,0,0,2,1
20535,189059,RZ4LxTkpwGNONWAKNmKhQJBPp4s3H9LB,G8EPVSXsOYB5YQWZGiz1aVq5Pgr2GrQu,1,0,0,0,0,0,1,0,1,0.14285714285714285,1,0.0,0,0,0,0,0,0,0,1,0,0,1,1
20536,189068,w4jrHVLBGTqYOkQddpvWOsqpbetHaY5D,SpATywNh6bZuzm8s1ceuBUnMUAeoAHHw,17,31,11,18,3,3,4,1,71,10.142857142857142,1,0.0,17,11,15,3,14,3,3,4,1,46,25,0
20537,189070,iXex8IZetCn6l6qnHu5qXE8ueYaXwfDT,SpATywNh6bZuzm8s1ceuBUnMUAeoAHHw,1,0,0,0,0,0,1,0,1,0.14285714285714285,1,0.0,0,0,0,0,0,0,0,1,0,0,1,1
20538,189081,i2raPzmlvNePAOSFdEUwI0BA2bKyQ3vM,A3fsA9Zfv1X2fVEQhTw51lKENdNrEqT3,45,13,7,174,0,0,3,0,197,28.142857142857142,1,0.0,2,7,151,0,11,0,23,3,0,160,37,1
20539,189083,TGFFusA6seimZvuMuvWcJqzDXcH10rby,SpATywNh6bZuzm8s1ceuBUnMUAeoAHHw,24,16,14,0,10,1,7,2,50,7.142857142857143,1,0.0,0,14,0,10,16,1,0,7,2,24,26,1
20540,189093,LZLwXQHuXL4mxhIKYMQYutE6DkMc7FB0,G8EPVSXsOYB5YQWZGiz1aVq5Pgr2GrQu,1,0,0,0,0,0,1,0,1,0.14285714285714285,1,0.0,0,0,0,0,0,0,0,1,0,0,1,1
20541,189096,FlKWU01LZ7CxmzTHmaREVNn6EnjYEnig,SpATywNh6bZuzm8s1ceuBUnMUAeoAHHw,1,0,0,0,0,0,1,0,1,0.14285714285714285,1,0.0,0,0,0,0,0,0,0,1,0,0,1,1
20542,189121,v4Sdqo21VERdMlPPJ5lxFzea2Futc16m,7GRhBDsirIGkRZBtSMEzNTyDr2JQm4xx,10,5,3,7,3,1,2,1,22,3.142857142857143,1,0.0,1,3,6,3,4,1,1,2,1,13,9,1
20543,189123,f3G4rcF7hvAe5fW36C69obxNMOERmdUr,7GRhBDsirIGkRZBtSMEzNTyDr2JQm4xx,2,0,0,0,0,0,2,0,2,0.2857142857142857,1,0.0,0,0,0,0,0,0,0,2,0,0,2,1
20544,189124,Lhw5SXb7o8NhgmbHuWdhAe4GSQCD0WgZ,bWdj2GDclj5ofokWjzoa5jAwMkxCykd6,7,9,0,0,1,0,2,0,12,1.7142857142857142,1,0.0,0,0,0,1,9,0,0,2,0,1,11,1
20545,189125,BlhCYC8woOBcOY9B6dneqhiXvmHLTuKE,7GRhBDsirIGkRZBtSMEzNTyDr2JQm4xx,2,0,0,0,0,0,2,0,2,0.2857142857142857,1,0.0,0,0,0,0,0,0,0,2,0,0,2,1
20546,189133,uP2tPeEXyIbipoH4RC0lBXHlrPC5xpiE,SpATywNh6bZuzm8s1ceuBUnMUAeoAHHw,6,5,1,0,0,0,2,0,8,1.1428571428571428,1,0.0,0,1,0,0,5,0,0,2,0,1,7,1
20547,189137,NQvU0JScNWPY4La90o9jpHJwL7CcZjuw,RXDvfPUBYFlVdlueBFbLW0mhhAyGEqpt,5,0,0,0,0,1,4,1,6,0.8571428571428571,1,0.0,0,0,0,0,0,1,0,4,1,0,6,1
20548,189138,jiFzFGisDkK72ZBTna8wrY4pq5bLzUOt,SpATywNh6bZuzm8s1ceuBUnMUAeoAHHw,7,10,6,0,2,0,3,0,21,3.0,2,0.0,0,6,0,2,10,0,0,3,0,8,13,1
20549,189142,skSnSfH7XcyX8lYXpZBS74pGLHKMwWNm,7GRhBDsirIGkRZBtSMEzNTyDr2JQm4xx,1,0,0,0,0,0,1,0,1,0.14285714285714285,1,0.0,0,0,0,0,0,0,0,1,0,0,1,1
20550,189147,eC4StSuQwImpW962lXYQQlRlP4Dxmsjm,A3fsA9Zfv1X2fVEQhTw51lKENdNrEqT3,2,0,0,0,0,0,2,0,2,0.2857142857142857,1,0.0,0,0,0,0,0,0,0,2,0,0,2,0
20551,189149,RD8IEsnXxFXH4Z6OD9WSAuQqmJ27nHhK,7GRhBDsirIGkRZBtSMEzNTyDr2JQm4xx,2,0,0,0,0,0,2,0,2,0.2857142857142857,1,0.0,0,0,0,0,0,0,0,2,0,0,2,1
20552,189151,6FXn59U6t58D3ljh3ZK4Ravf0jwIveLf,bWdj2GDclj5ofokWjzoa5jAwMkxCykd6,8,13,3,0,2,0,1,0,19,2.7142857142857144,1,0.0,0,3,0,2,13,0,0,1,0,5,14,1
20553,189152,JhlGtzUmqgxqrvs0UEO7cjs9C9vvWlPf,SpATywNh6bZuzm8s1ceuBUnMUAeoAHHw,1,0,0,0,0,0,1,0,1,0.14285714285714285,1,0.0,0,0,0,0,0,0,0,1,0,0,1,0
20554,189153,8AUT1icptxlMHWWQGJy6i9O3KcDsBVE5,G8EPVSXsOYB5YQWZGiz1aVq5Pgr2GrQu,74,58,28,109,23,0,3,0,221,31.571428571428573,2,0.0,30,28,88,23,28,0,21,3,0,169,52,0
20555,189157,KADzrQcaGi7TzZIKCqh7I8E0i863BBoH,7GRhBDsirIGkRZBtSMEzNTyDr2JQm4xx,2,0,0,0,0,0,2,0,2,0.2857142857142857,1,0.0,0,0,0,0,0,0,0,2,0,0,2,1
20556,189159,XqrZf8R9BrkWGkETcqhxlHJsow5TwWGG,bWdj2GDclj5ofokWjzoa5jAwMkxCykd6,7,4,3,0,2,0,1,0,10,1.4285714285714286,1,0.0,0,3,0,2,4,0,0,1,0,5,5,1
20557,189163,YdCaKimqYb8kuFiHEtjPDsCbtIch1tfO,7GRhBDsirIGkRZBtSMEzNTyDr2JQm4xx,8,9,2,0,0,1,5,2,19,2.7142857142857144,1,0.0,5,2,0,0,4,1,0,5,2,7,12,1
20558,189167,GT5aiFfWe6FLX4vRoPpBADiVr8AYj3lG,SpATywNh6bZuzm8s1ceuBUnMUAeoAHHw,1,0,0,0,0,0,1,0,1,0.14285714285714285,1,0.0,0,0,0,0,0,0,0,1,0,0,1,1
20559,189178,UpLwu6T0ULbCdikK3k55n17m75BbWAqs,7GRhBDsirIGkRZBtSMEzNTyDr2JQm4xx,7,4,1,0,2,0,4,0,11,1.5714285714285714,1,0.0,2,1,0,2,2,0,0,4,0,5,6,1
20560,189179,fhmvUcJO8Ug3wTcL8U8JPRrppB0ExD83,G8EPVSXsOYB5YQWZGiz1aVq5Pgr2GrQu,6,4,1,0,1,0,2,0,8,1.1428571428571428,1,0.0,0,1,0,1,4,0,0,2,0,2,6,1
20561,189180,De3af8LDoF4IXXnUzXAiZVCskiGXJoAd,7GRhBDsirIGkRZBtSMEzNTyDr2JQm4xx,11,11,4,4,2,15,9,3,48,6.857142857142857,1,0.0,2,4,3,2,9,15,1,9,3,11,37,1
20562,189183,3pKzHjxu581a25exRFFvTyg6nDHF6pVH,G8EPVSXsOYB5YQWZGiz1aVq5Pgr2GrQu,5,2,1,0,1,0,3,0,7,1.0,1,0.0,0,1,0,1,2,0,0,3,0,2,5,1
20563,189185,waDceRgc2N0BjPJorKWJj1WtKs87R7xP,7GRhBDsirIGkRZBtSMEzNTyDr2JQm4xx,4,2,0,0,0,0,2,0,4,0.5714285714285714,1,0.0,0,0,0,0,2,0,0,2,0,0,4,1
20564,189189,Qan5qFXAXs8GLcj3GbJmOFAYcVVfTLN4,SpATywNh6bZuzm8s1ceuBUnMUAeoAHHw,9,7,1,0,1,0,2,0,11,1.5714285714285714,1,0.0,0,1,0,1,7,0,0,2,0,2,9,1
20565,189190,hz69aGX7TSXJFEooFn03184YEuUmyXMU,7GRhBDsirIGkRZBtSMEzNTyDr2JQm4xx,2,0,0,0,0,0,2,0,2,0.2857142857142857,1,0.0,0,0,0,0,0,0,0,2,0,0,2,1
20566,189193,GKKsdi3H8EmA2d4Vl6453q5sS4zL8ZEv,RXDvfPUBYFlVdlueBFbLW0mhhAyGEqpt,7,3,2,0,2,0,2,0,9,1.2857142857142858,1,0.0,0,2,0,2,3,0,0,2,0,4,5,1
20567,189198,2CBeSl2j3Y4DT097M7qZQeQSj2yig4c8,SpATywNh6bZuzm8s1ceuBUnMUAeoAHHw,8,8,3,0,2,0,6,0,19,2.7142857142857144,1,0.0,0,3,0,2,8,0,0,6,0,5,14,1
20568,189200,jxw4QkqvvdLlUDAf97E2SumJv5ThdQ3m,7GRhBDsirIGkRZBtSMEzNTyDr2JQm4xx,2,0,0,0,0,0,5,0,5,0.7142857142857143,1,0.0,0,0,0,0,0,0,0,5,0,0,5,1
20569,189209,TTnPkHUxPUscUooIZlsVnvEUa4a7xQQH,SpATywNh6bZuzm8s1ceuBUnMUAeoAHHw,2,0,0,0,0,0,3,0,3,0.42857142857142855,1,0.0,0,0,0,0,0,0,0,3,0,0,3,1
20570,189217,S685sFeuH7ep81myXbWJBadTSgXcwR6Q,7GRhBDsirIGkRZBtSMEzNTyDr2JQm4xx,5,2,1,0,1,0,3,0,7,1.0,1,0.0,0,1,0,1,2,0,0,3,0,2,5,1
20571,189225,V1EykxyqrSjJS8SrSU1L9A5qCk92mw9z,7GRhBDsirIGkRZBtSMEzNTyDr2JQm4xx,23,34,18,24,17,1,2,0,96,13.714285714285714,1,0.0,8,18,21,17,26,1,3,2,0,64,32,1
20572,189237,XqzZzhc9uB2wCLtNHGWt7epj98UW1aCq,7GRhBDsirIGkRZBtSMEzNTyDr2JQm4xx,2,0,0,0,0,0,2,0,2,0.2857142857142857,1,0.0,0,0,0,0,0,0,0,2,0,0,2,1
20573,189251,gKEmxl73O6lgpzCm5W5THfmE7UMUjyMT,7GRhBDsirIGkRZBtSMEzNTyDr2JQm4xx,6,1,1,0,0,5,4,3,14,2.0,1,0.0,0,1,0,0,1,5,0,4,3,1,13,1
20574,189255,YSyQ9QbkilbrIosblzvYwH8g0OB4sSVb,bWdj2GDclj5ofokWjzoa5jAwMkxCykd6,16,11,1,0,1,0,6,1,20,2.857142857142857,1,0.0,0,1,0,1,11,0,0,6,1,2,18,1
20575,189256,lEJmKdFXtAaM5CwkVi4nzr2tROq80rBD,bWdj2GDclj5ofokWjzoa5jAwMkxCykd6,6,9,1,46,2,0,1,0,59,8.428571428571429,1,0.0,5,1,45,2,4,0,1,1,0,53,6,1
20576,189257,fdOB5V1ofn0Ctryb3b7icaPyCY3tS2rV,SpATywNh6bZuzm8s1ceuBUnMUAeoAHHw,4,2,1,0,1,0,1,0,5,0.7142857142857143,1,0.0,0,1,0,1,2,0,0,1,0,2,3,1
20577,189258,vKg7m5YebaxRd5kf6WsIAhVoxmBX8DKD,7GRhBDsirIGkRZBtSMEzNTyDr2JQm4xx,2,0,0,0,0,0,2,0,2,0.2857142857142857,1,0.0,0,0,0,0,0,0,0,2,0,0,2,1
20578,189264,cao0jYvVpb9HkTA7b0NC6lvxt4dMGzpm,A3fsA9Zfv1X2fVEQhTw51lKENdNrEqT3,17,13,8,0,6,0,11,0,38,5.428571428571429,2,0.0,1,8,0,6,12,0,0,11,0,15,23,1
20579,189269,srp7eYfIztlS63KDp3UJ1QwZZ188jsNh,SpATywNh6bZuzm8s1ceuBUnMUAeoAHHw,6,2,0,0,0,3,5,0,10,1.4285714285714286,1,0.0,0,0,0,0,2,3,0,5,0,0,10,1
20580,189272,9W6HDa8nbr3i4rkBKbOa5qCJz73HRO2D,A3fsA9Zfv1X2fVEQhTw51lKENdNrEqT3,4,2,1,0,1,0,1,0,5,0.7142857142857143,1,0.0,0,1,0,1,2,0,0,1,0,2,3,1
20581,189282,lw3pe4dKU0kPw4Y2UXHyUqbmb0p06DXW,SpATywNh6bZuzm8s1ceuBUnMUAeoAHHw,4,2,1,0,1,0,1,0,5,0.7142857142857143,1,0.0,0,1,0,1,2,0,0,1,0,2,3,1
20582,189295,BGaRkNhUtySrIq3Ibu2N2S12ZKzZSFdD,SpATywNh6bZuzm8s1ceuBUnMUAeoAHHw,5,2,1,0,1,0,2,0,6,0.8571428571428571,1,0.0,0,1,0,1,2,0,0,2,0,2,4,1
20583,189299,soWKaGVgrPjOXMRfIoHKxglGk54YWoon,RXDvfPUBYFlVdlueBFbLW0mhhAyGEqpt,1,0,0,0,0,0,1,0,1,0.14285714285714285,1,0.0,0,0,0,0,0,0,0,1,0,0,1,1
20584,189301,4D9TO74zb0mHkwi6G9vwCLqeflT8BNm5,bWdj2GDclj5ofokWjzoa5jAwMkxCykd6,8,18,0,0,0,0,1,0,19,2.7142857142857144,1,0.0,7,0,0,0,11,0,0,1,0,7,12,1
20585,189302,sGH3S02gC7Px6nzjUSoCiiPBEx45gkHA,SpATywNh6bZuzm8s1ceuBUnMUAeoAHHw,13,30,9,21,1,1,7,0,69,9.857142857142858,1,0.0,19,9,17,1,11,1,4,7,0,46,23,1
20586,189303,okDiJdSYCcnmEiNK57MM0U050xDu2fc0,A3fsA9Zfv1X2fVEQhTw51lKENdNrEqT3,1,0,0,0,0,0,1,0,1,0.14285714285714285,1,0.0,0,0,0,0,0,0,0,1,0,0,1,1
20587,189329,IDVV2jtBUYHXvZRwUeupKpLFwBDZmMvi,7GRhBDsirIGkRZBtSMEzNTyDr2JQm4xx,3,2,0,0,0,0,1,0,3,0.42857142857142855,1,0.0,0,0,0,0,2,0,0,1,0,0,3,1
20588,189331,vDpJXmGOtozpqHHs0yai7muX5WPA1Mg5,A3fsA9Zfv1X2fVEQhTw51lKENdNrEqT3,13,7,6,6,4,0,2,0,25,3.5714285714285716,1,0.0,0,6,4,4,7,0,2,2,0,14,11,1
20589,189332,xhCV750Vmz3Zc8n6WSG04S1Of863qTkW,7GRhBDsirIGkRZBtSMEzNTyDr2JQm4xx,1,0,0,0,0,0,1,0,1,0.14285714285714285,1,0.0,0,0,0,0,0,0,0,1,0,0,1,1
20590,189336,y71lRBqIdu5iPiLn9Yi5PQm6GFIvgLwB,7GRhBDsirIGkRZBtSMEzNTyDr2JQm4xx,1,0,0,0,0,0,1,0,1,0.14285714285714285,1,0.0,0,0,0,0,0,0,0,1,0,0,1,1
20591,189356,iNXUknYcsccIKS8GgjuItiXxtSErv2BI,bWdj2GDclj5ofokWjzoa5jAwMkxCykd6,6,6,2,0,2,0,5,0,15,2.142857142857143,1,0.0,0,2,0,2,6,0,0,5,0,4,11,1
20592,189357,RAEoz0HlK4aZohECXgoEPPvL3W03Haej,SpATywNh6bZuzm8s1ceuBUnMUAeoAHHw,1,0,0,0,0,0,1,0,1,0.14285714285714285,1,0.0,0,0,0,0,0,0,0,1,0,0,1,1
20593,189364,iNXUknYcsccIKS8GgjuItiXxtSErv2BI,RXDvfPUBYFlVdlueBFbLW0mhhAyGEqpt,1,0,0,0,0,0,1,0,1,0.14285714285714285,1,0.0,0,0,0,0,0,0,0,1,0,0,1,1
20594,189374,iNXUknYcsccIKS8GgjuItiXxtSErv2BI,A3fsA9Zfv1X2fVEQhTw51lKENdNrEqT3,1,0,0,0,0,0,1,0,1,0.14285714285714285,1,0.0,0,0,0,0,0,0,0,1,0,0,1,1
20595,189379,2d9iCsNXUdh58GWuwVHGi4VtNSaIFub5,G8EPVSXsOYB5YQWZGiz1aVq5Pgr2GrQu,1,0,0,0,0,0,2,0,2,0.2857142857142857,1,0.0,0,0,0,0,0,0,0,2,0,0,2,1
20596,189381,d9mMxxcMI65zEdojLuYluBZegkL9kaO9,7GRhBDsirIGkRZBtSMEzNTyDr2JQm4xx,2,0,0,0,0,0,2,0,2,0.2857142857142857,1,0.0,0,0,0,0,0,0,0,2,0,0,2,1
20597,189382,GIjz77vNbkIBUivZosRAJlNv9Kc41Lqw,A3fsA9Zfv1X2fVEQhTw51lKENdNrEqT3,4,4,0,0,0,0,2,0,6,0.8571428571428571,1,0.0,0,0,0,0,4,0,0,2,0,0,6,1
20598,189389,M3Xa5IFPEZiaLK2rAjKqcPYFncjR6IsA,A3fsA9Zfv1X2fVEQhTw51lKENdNrEqT3,1,0,0,0,0,0,1,0,1,0.14285714285714285,1,0.0,0,0,0,0,0,0,0,1,0,0,1,1
20599,189401,PB7h0UvHpsEAKo6BKDI2Oe83oHx4FlRv,7GRhBDsirIGkRZBtSMEzNTyDr2JQm4xx,5,4,1,0,2,0,2,0,9,1.2857142857142858,1,0.0,2,1,0,2,2,0,0,2,0,5,4,1
20600,189406,7QBOr8vQNdmqK12PreYCHK2joGfp7eda,A3fsA9Zfv1X2fVEQhTw51lKENdNrEqT3,36,37,1,0,1,0,1,0,40,5.714285714285714,1,0.0,0,1,0,1,37,0,0,1,0,2,38,1
20601,189408,XsZuRX3JjxC6rjjGF8ce2xx3yowgSNne,7GRhBDsirIGkRZBtSMEzNTyDr2JQm4xx,8,3,2,0,2,0,4,0,11,1.5714285714285714,1,0.0,0,2,0,2,3,0,0,4,0,4,7,1
20602,189412,B8lBbNEso7Bw3KF9oTlYX1eUGmqw99RL,SpATywNh6bZuzm8s1ceuBUnMUAeoAHHw,5,6,3,0,1,0,3,0,13,1.8571428571428572,2,0.0,0,3,0,1,6,0,0,3,0,4,9,1
20603,189420,H5JmWivBEuiQyOyWOrYCNU3Be4rFy6dH,bWdj2GDclj5ofokWjzoa5jAwMkxCykd6,5,2,1,0,1,0,2,0,6,0.8571428571428571,1,0.0,0,1,0,1,2,0,0,2,0,2,4,1
20604,189421,KVrBjT53dn0E9ztl4DzvpfQ0jHMUCFns,bWdj2GDclj5ofokWjzoa5jAwMkxCykd6,2,0,0,0,0,0,2,0,2,0.2857142857142857,1,0.0,0,0,0,0,0,0,0,2,0,0,2,1
20605,189422,4eCXtsyyVYc5CpMFlWbFuHxZ1fq9frpo,A3fsA9Zfv1X2fVEQhTw51lKENdNrEqT3,4,3,0,0,0,0,1,0,4,0.5714285714285714,1,0.0,0,0,0,0,3,0,0,1,0,0,4,1
20606,189425,6F1lKjGTd159lFhX2roWh19Brj0u4Zbh,bWdj2GDclj5ofokWjzoa5jAwMkxCykd6,1,0,0,0,0,0,1,0,1,0.14285714285714285,1,0.0,0,0,0,0,0,0,0,1,0,0,1,1
20607,189432,0SOdii1K37CAmTEfgyjcBvcmanyXJ8Ed,bWdj2GDclj5ofokWjzoa5jAwMkxCykd6,6,6,3,0,2,5,3,0,19,2.7142857142857144,1,0.0,0,3,0,2,6,5,0,3,0,5,14,0
20608,189434,3ySaApz28mPh4l3lvXUNwK9cjrEIv7NY,SpATywNh6bZuzm8s1ceuBUnMUAeoAHHw,5,2,1,0,1,0,2,0,6,0.8571428571428571,1,0.0,0,1,0,1,2,0,0,2,0,2,4,1
20609,189442,ifnHK7elzUrx6FoT7eceCrEZMhAwQ98l,7GRhBDsirIGkRZBtSMEzNTyDr2JQm4xx,5,3,1,4,1,0,2,0,11,1.5714285714285714,1,0.0,1,1,3,1,2,0,1,2,0,6,5,1
20610,189444,HO1jCcwERynGUi1jR0hjkSfXZ85j5jaW,7GRhBDsirIGkRZBtSMEzNTyDr2JQm4xx,1,0,0,0,0,0,1,0,1,0.14285714285714285,1,0.0,0,0,0,0,0,0,0,1,0,0,1,1
20611,189448,opKUJLQunILYTzpA0JfEP9KQkwUgY37v,7GRhBDsirIGkRZBtSMEzNTyDr2JQm4xx,16,8,5,0,3,3,10,1,30,4.285714285714286,1,0.0,0,5,0,3,8,3,0,10,1,8,22,1
20612,189453,CwPtG0pQpatgEgPUJC1fzC45UnY2lgMF,7GRhBDsirIGkRZBtSMEzNTyDr2JQm4xx,10,11,7,10,5,0,4,0,37,5.285714285714286,2,0.0,3,7,8,5,8,0,2,4,0,23,14,1
20613,189459,Vjuc4lOMRBvwiori3ErzIlcfC6jawhKl,bWdj2GDclj5ofokWjzoa5jAwMkxCykd6,5,2,1,0,1,0,3,0,7,1.0,1,0.0,0,1,0,1,2,0,0,3,0,2,5,1
20614,189467,4NRVrPg8fVeenBKvYSGTgbBS0wBpQ172,bWdj2GDclj5ofokWjzoa5jAwMkxCykd6,7,3,1,0,2,0,5,0,11,1.5714285714285714,1,0.0,0,1,0,2,3,0,0,5,0,3,8,1
20615,189479,DlLiMWF3t2ouoZLQ2DOZ0noh9g1ImEr6,A3fsA9Zfv1X2fVEQhTw51lKENdNrEqT3,2,0,0,0,0,0,2,0,2,0.2857142857142857,1,0.0,0,0,0,0,0,0,0,2,0,0,2,1
20616,189487,WMNPStbIUatPzq8T7oCOrTnIBPdRdXbh,A3fsA9Zfv1X2fVEQhTw51lKENdNrEqT3,13,5,4,0,4,1,5,1,20,2.857142857142857,1,0.0,0,4,0,4,5,1,0,5,1,8,12,1
20617,189491,19rBJNWc3TdUmLpZx1LViNSUBx0S4WJI,G8EPVSXsOYB5YQWZGiz1aVq5Pgr2GrQu,1,0,0,0,0,0,1,0,1,0.14285714285714285,1,0.0,0,0,0,0,0,0,0,1,0,0,1,1
20618,189492,19rBJNWc3TdUmLpZx1LViNSUBx0S4WJI,SpATywNh6bZuzm8s1ceuBUnMUAeoAHHw,1,0,0,0,0,0,1,0,1,0.14285714285714285,1,0.0,0,0,0,0,0,0,0,1,0,0,1,1
20619,189497,0HWrPPCNu1lUYotaev8lq3oZQkQoCkpc,5X6FeZozNMgE2VRi3MJYjkkFK8SETtu2,1,0,0,0,0,0,1,0,1,0.14285714285714285,1,0.0,0,0,0,0,0,0,0,1,0,0,1,1
20620,189500,woGl9MRnmPfGzBULiB07cKZ8FQbJyr1m,5X6FeZozNMgE2VRi3MJYjkkFK8SETtu2,3,2,1,0,0,0,1,0,4,0.5714285714285714,1,0.0,0,1,0,0,2,0,0,1,0,1,3,1
20621,189519,W44EUSPSAj1fZWLor5hD25joUoQF1Axq,7GRhBDsirIGkRZBtSMEzNTyDr2JQm4xx,9,6,0,2,1,0,2,0,11,1.5714285714285714,1,0.0,1,0,2,1,5,0,0,2,0,4,7,1
20622,189520,xPkJLyddSzkSguLc8iFCPUKp6SiHPVYA,7GRhBDsirIGkRZBtSMEzNTyDr2JQm4xx,1,0,0,0,0,0,1,0,1,0.14285714285714285,1,0.0,0,0,0,0,0,0,0,1,0,0,1,1
20623,189532,BqQvzvKumSuXZDEF5Fpfkr95tleas1E0,5X6FeZozNMgE2VRi3MJYjkkFK8SETtu2,1,0,0,0,0,0,1,0,1,0.14285714285714285,1,0.0,0,0,0,0,0,0,0,1,0,0,1,1
20624,189576,QGuKTIBC2KLaYpPdOnB4nXCWgxMM1Dog,7GRhBDsirIGkRZBtSMEzNTyDr2JQm4xx,1,0,0,0,0,0,1,0,1,0.14285714285714285,1,0.0,0,0,0,0,0,0,0,1,0,0,1,1
20625,189592,0zVXofbZyvquPNH3umVfQBB1jCjNa4CK,5X6FeZozNMgE2VRi3MJYjkkFK8SETtu2,3,5,0,0,2,0,1,0,8,1.1428571428571428,1,0.0,3,0,0,2,2,0,0,1,0,5,3,1
20626,189593,MgVP6LodMhznTbusy8mYmerhW0RKcSCB,7GRhBDsirIGkRZBtSMEzNTyDr2JQm4xx,1,0,0,0,0,0,1,0,1,0.14285714285714285,1,0.0,0,0,0,0,0,0,0,1,0,0,1,1
20627,189595,gnDGjS7KmDkjYE8QuMSS8QSW2uwA8L2y,SpATywNh6bZuzm8s1ceuBUnMUAeoAHHw,2,0,0,0,0,0,2,0,2,0.2857142857142857,1,0.0,0,0,0,0,0,0,0,2,0,0,2,1
20628,189605,yrczal0ybDrTDoOYd1WvgcBQApn5E29e,7GRhBDsirIGkRZBtSMEzNTyDr2JQm4xx,1,0,0,0,0,0,1,0,1,0.14285714285714285,1,0.0,0,0,0,0,0,0,0,1,0,0,1,1
20629,189608,1HkkpfSVTiT6CtY9J3aLZcX4FRE5LVLz,7GRhBDsirIGkRZBtSMEzNTyDr2JQm4xx,3,0,0,0,0,3,2,0,5,0.7142857142857143,1,0.0,0,0,0,0,0,3,0,2,0,0,5,1
20630,189609,RQw2G6rRJVyLfkJOWxOXKBvD6FtN7kgk,SpATywNh6bZuzm8s1ceuBUnMUAeoAHHw,15,12,5,14,4,0,2,0,37,5.285714285714286,1,0.0,6,5,14,4,6,0,0,2,0,29,8,1
20631,189614,5PZBmKEXGmnHhrok7M9vaGB06CAzFVOO,7GRhBDsirIGkRZBtSMEzNTyDr2JQm4xx,6,4,1,2,1,0,1,0,9,1.2857142857142858,1,0.0,1,1,2,1,3,0,0,1,0,5,4,0
20632,189632,LA49WpJ5ryi73XGSlYt9JjYZ4H7Zw5cU,A3fsA9Zfv1X2fVEQhTw51lKENdNrEqT3,5,2,1,0,1,0,2,0,6,0.8571428571428571,1,0.0,0,1,0,1,2,0,0,2,0,2,4,1
20633,189654,cGJK6WUVRz0lufneVSDgso7nE70DShof,A3fsA9Zfv1X2fVEQhTw51lKENdNrEqT3,7,4,1,0,1,0,2,0,8,1.1428571428571428,1,0.0,0,1,0,1,4,0,0,2,0,2,6,1
20634,189666,lbgTV2YMskSv2TX4EXpaazpMVWfsftEV,7GRhBDsirIGkRZBtSMEzNTyDr2JQm4xx,1,0,0,0,0,0,1,0,1,0.14285714285714285,1,0.0,0,0,0,0,0,0,0,1,0,0,1,1
20635,189670,lbgTV2YMskSv2TX4EXpaazpMVWfsftEV,5X6FeZozNMgE2VRi3MJYjkkFK8SETtu2,1,0,0,0,0,0,1,0,1,0.14285714285714285,1,0.0,0,0,0,0,0,0,0,1,0,0,1,1
20636,189676,lbgTV2YMskSv2TX4EXpaazpMVWfsftEV,A3fsA9Zfv1X2fVEQhTw51lKENdNrEqT3,1,0,0,0,0,0,1,0,1,0.14285714285714285,1,0.0,0,0,0,0,0,0,0,1,0,0,1,1
20637,189696,PMZJ7vxYEpwybeGWTMZuFimiDLzBBGfH,7GRhBDsirIGkRZBtSMEzNTyDr2JQm4xx,9,7,1,0,1,0,2,0,11,1.5714285714285714,1,0.0,0,1,0,1,7,0,0,2,0,2,9,1
20638,189707,aK3nMtEDxGhnhy1C4yOyjUdvZihlJeoh,5X6FeZozNMgE2VRi3MJYjkkFK8SETtu2,1,0,0,0,0,0,1,0,1,0.14285714285714285,1,0.0,0,0,0,0,0,0,0,1,0,0,1,1
20639,189764,WIulMAW8PLfyLvnliYk0w4Xs9IJHKZPS,A3fsA9Zfv1X2fVEQhTw51lKENdNrEqT3,3,2,1,0,0,0,2,0,5,0.7142857142857143,1,0.0,0,1,0,0,2,0,0,2,0,1,4,1
20640,189769,ePLNZPT7XvGhj7aq3pFVjN8dQAsiG3MM,A3fsA9Zfv1X2fVEQhTw51lKENdNrEqT3,2,0,0,0,0,0,2,0,2,0.2857142857142857,1,0.0,0,0,0,0,0,0,0,2,0,0,2,1
20641,189792,tr8E6i6LhPPOpsyObFM4xo1Myl86ILao,A3fsA9Zfv1X2fVEQhTw51lKENdNrEqT3,4,3,0,0,0,0,3,0,6,0.8571428571428571,2,0.0,0,0,0,0,3,0,0,3,0,0,6,1
20642,189826,KEk12K18LvElqA3IQG2ElnZLz0pGsTjq,5X6FeZozNMgE2VRi3MJYjkkFK8SETtu2,7,2,1,0,1,0,5,1,10,1.4285714285714286,1,0.0,0,1,0,1,2,0,0,5,1,2,8,1
20643,189833,KKg2SEYEtAkOTNFOSVRP4B0sBYB2AxaX,A3fsA9Zfv1X2fVEQhTw51lKENdNrEqT3,2,0,0,0,0,0,2,0,2,0.2857142857142857,1,0.0,0,0,0,0,0,0,0,2,0,0,2,1
20644,189835,vXT2w57VYk2IRPGUPSaMsXQX7TQrsaxB,7GRhBDsirIGkRZBtSMEzNTyDr2JQm4xx,1,0,0,0,0,0,1,0,1,0.14285714285714285,1,0.0,0,0,0,0,0,0,0,1,0,0,1,1
20645,189836,xgQYbfvDEw17v13YEvx2pY52YvDa4jfG,7GRhBDsirIGkRZBtSMEzNTyDr2JQm4xx,12,6,5,0,5,0,1,0,17,2.4285714285714284,1,0.0,0,5,0,5,6,0,0,1,0,10,7,0
20646,189841,c6EQxl5Y5srE1l7qShfQ6CExe7ZkgJ6z,7GRhBDsirIGkRZBtSMEzNTyDr2JQm4xx,12,17,7,4,2,2,5,0,37,5.285714285714286,2,0.0,5,7,3,2,12,2,1,5,0,17,20,0
20647,189864,bcTZMZYhsyC9adGaewxs0JBBtqf2gnyH,A3fsA9Zfv1X2fVEQhTw51lKENdNrEqT3,1,0,0,0,0,0,2,0,2,0.2857142857142857,1,0.0,0,0,0,0,0,0,0,2,0,0,2,1
20648,189872,tvbjaq3OPKemCIT5KViqtpbuzjmnk9iv,7GRhBDsirIGkRZBtSMEzNTyDr2JQm4xx,1,0,0,0,0,0,1,0,1,0.14285714285714285,1,0.0,0,0,0,0,0,0,0,1,0,0,1,1
20649,189878,EuByZSROH9lLZ2dnd4GXxahw8RdkgjTd,7GRhBDsirIGkRZBtSMEzNTyDr2JQm4xx,5,2,1,0,1,0,4,0,8,1.1428571428571428,1,0.0,0,1,0,1,2,0,0,4,0,2,6,1
20650,189888,DoaK2UVwvFXvAUAGvwGn2NA7BHsJAQZU,5X6FeZozNMgE2VRi3MJYjkkFK8SETtu2,9,14,1,0,4,0,3,0,22,3.142857142857143,1,0.0,11,1,0,4,3,0,0,3,0,16,6,1
20651,189906,DoaK2UVwvFXvAUAGvwGn2NA7BHsJAQZU,A3fsA9Zfv1X2fVEQhTw51lKENdNrEqT3,6,5,1,0,1,0,1,0,8,1.1428571428571428,1,0.0,0,1,0,1,5,0,0,1,0,2,6,0
20652,189943,7SqBNF8tWHSVbvlzM0EEAveq7vc9hOK8,5X6FeZozNMgE2VRi3MJYjkkFK8SETtu2,1,0,0,0,0,0,1,0,1,0.14285714285714285,1,0.0,0,0,0,0,0,0,0,1,0,0,1,1
20653,189962,vqeyrkQOvY6ito5wie8yXLKkDfcoR2Qk,7GRhBDsirIGkRZBtSMEzNTyDr2JQm4xx,1,0,0,0,0,0,1,0,1,0.14285714285714285,1,0.0,0,0,0,0,0,0,0,1,0,0,1,1
20654,189987,VAnGmjZDe4mKyUygxHcsKkNd3a9DThub,7GRhBDsirIGkRZBtSMEzNTyDr2JQm4xx,9,8,2,4,3,0,3,0,20,2.857142857142857,1,0.0,3,2,3,3,5,0,1,3,0,11,9,1
20655,189988,tMNGYXIFQLxoZULQtNFAcBIfN5Bk8aTB,5X6FeZozNMgE2VRi3MJYjkkFK8SETtu2,13,34,3,0,7,0,4,1,49,7.0,1,0.0,22,3,0,7,12,0,0,4,1,32,17,1
20656,190002,ssd9DBMazioObXDaMrlUaff0ISIOtfor,5X6FeZozNMgE2VRi3MJYjkkFK8SETtu2,1,0,0,0,0,0,1,0,1,0.14285714285714285,1,0.0,0,0,0,0,0,0,0,1,0,0,1,1
20657,190043,9NL6pIdeoq3qoMYjmrqicRwQF6as6xWO,7GRhBDsirIGkRZBtSMEzNTyDr2JQm4xx,6,7,1,0,1,0,3,0,12,1.7142857142857142,1,0.0,0,1,0,1,7,0,0,3,0,2,10,1
20658,190059,zX9pboSJ4vJa1gdfSLlOQHMTjhsQEp32,7GRhBDsirIGkRZBtSMEzNTyDr2JQm4xx,1,0,0,0,0,0,1,0,1,0.14285714285714285,1,0.0,0,0,0,0,0,0,0,1,0,0,1,1
20659,190102,AFgfNSPXxfZS0fJBrV7ZCry6ugLF8Vil,5X6FeZozNMgE2VRi3MJYjkkFK8SETtu2,1,0,0,0,0,0,1,0,1,0.14285714285714285,1,0.0,0,0,0,0,0,0,0,1,0,0,1,1
20660,190113,52eWD8FszxThY7ZZwdN5O4pas8m2gOZa,A3fsA9Zfv1X2fVEQhTw51lKENdNrEqT3,2,0,0,0,0,0,2,0,2,0.2857142857142857,1,0.0,0,0,0,0,0,0,0,2,0,0,2,0
20661,190148,WQMZ2fhdRzqYNsK6k2GeqeA3Ess2PfYw,7GRhBDsirIGkRZBtSMEzNTyDr2JQm4xx,1,0,0,0,0,0,1,0,1,0.14285714285714285,1,0.0,0,0,0,0,0,0,0,1,0,0,1,1
20662,190150,md7xbvlSHLf3epPtrSenVRhvJISfWAAm,5X6FeZozNMgE2VRi3MJYjkkFK8SETtu2,9,6,1,7,3,0,1,0,18,2.5714285714285716,1,0.0,4,1,7,3,2,0,0,1,0,15,3,1
20663,190207,LuEM6Ji2sbchJvZp3E6DXQ6Q9idvBGe0,7GRhBDsirIGkRZBtSMEzNTyDr2JQm4xx,5,1,1,0,1,2,2,0,7,1.0,1,0.0,0,1,0,1,1,2,0,2,0,2,5,1
20664,190257,zvFl2xbV1FDOZwlXYqwJEiTk3EJ0H3Ku,3VkHkmOtom3jM2wCu94xgzzu1d6Dn7or,10,36,5,7,7,7,5,0,67,9.571428571428571,2,0.0,18,5,6,7,18,7,1,5,0,36,31,0
20665,190258,y8AdDSbHENRUD5ii0AuyONW5YY98sBlv,3VkHkmOtom3jM2wCu94xgzzu1d6Dn7or,2,0,0,0,0,0,2,0,2,0.2857142857142857,1,0.0,0,0,0,0,0,0,0,2,0,0,2,1
20666,190284,dw8tMVklgTZK6yDEDAM53OLtjt74HfnR,3VkHkmOtom3jM2wCu94xgzzu1d6Dn7or,4,2,1,0,1,0,2,0,6,0.8571428571428571,1,0.0,0,1,0,1,2,0,0,2,0,2,4,1
20667,190297,dNTZaahqzSBVnWMfb53XFlPZEDPY7jN3,3VkHkmOtom3jM2wCu94xgzzu1d6Dn7or,1,0,0,0,0,0,1,0,1,0.14285714285714285,1,0.0,0,0,0,0,0,0,0,1,0,0,1,1
20668,190326,MChVXa58KVwLwh1inhjdLaJbhU8LqtVW,3VkHkmOtom3jM2wCu94xgzzu1d6Dn7or,5,2,1,0,1,0,2,0,6,0.8571428571428571,1,0.0,0,1,0,1,2,0,0,2,0,2,4,1
20669,190332,6qyOu6a23ro8NiGec29aclYqyemAuAC1,3VkHkmOtom3jM2wCu94xgzzu1d6Dn7or,1,0,0,0,0,0,1,0,1,0.14285714285714285,1,0.0,0,0,0,0,0,0,0,1,0,0,1,1
20670,190333,MbwtI5alasJpU6rlek0scYnNjeDrIyEk,3VkHkmOtom3jM2wCu94xgzzu1d6Dn7or,5,5,0,0,0,1,5,0,11,1.5714285714285714,1,0.0,0,0,0,0,5,1,0,5,0,0,11,1
20671,190342,qIpGIJgJ2NoD1KhKkHYicu6I3IkoWWHY,3VkHkmOtom3jM2wCu94xgzzu1d6Dn7or,12,18,5,6,4,5,5,0,43,6.142857142857143,1,0.0,7,5,5,4,11,5,1,5,0,21,22,1
20672,190345,VbUCl4iA8O7xDz2e4nkyMMNjUwdwgHqn,3VkHkmOtom3jM2wCu94xgzzu1d6Dn7or,2,0,0,0,0,0,2,0,2,0.2857142857142857,1,0.0,0,0,0,0,0,0,0,2,0,0,2,1
20673,190370,2DweV3nINIltWC9fnAUkPKGXug65CERV,3VkHkmOtom3jM2wCu94xgzzu1d6Dn7or,5,5,2,0,1,0,1,0,9,1.2857142857142858,1,0.0,0,2,0,1,5,0,0,1,0,3,6,1
20674,190417,JxL0beXmco8r7lmteTLi8F2omNHEl2Ca,3VkHkmOtom3jM2wCu94xgzzu1d6Dn7or,1,0,0,0,0,0,1,0,1,0.14285714285714285,1,0.0,0,0,0,0,0,0,0,1,0,0,1,1
20675,190418,R2SrWNn6mywF5ut4DLl2r23knmfOF8gl,3VkHkmOtom3jM2wCu94xgzzu1d6Dn7or,7,3,2,0,2,0,2,0,9,1.2857142857142858,1,0.0,0,2,0,2,3,0,0,2,0,4,5,1
20676,190424,H683tMkQp6lFNh1xHTfMz81b5h1W7bC1,3VkHkmOtom3jM2wCu94xgzzu1d6Dn7or,1,0,0,0,0,0,1,0,1,0.14285714285714285,1,0.0,0,0,0,0,0,0,0,1,0,0,1,1
20677,190430,loPOLtsDP2ydmPK7rtuitDNSeKzIMLm2,3VkHkmOtom3jM2wCu94xgzzu1d6Dn7or,4,1,0,0,0,0,3,0,4,0.5714285714285714,1,0.0,0,0,0,0,1,0,0,3,0,0,4,1
20678,190435,QJnyVFXd0gewIQHEbdl6ZVpX79Gmgasm,3VkHkmOtom3jM2wCu94xgzzu1d6Dn7or,44,99,46,0,27,0,16,1,189,27.0,4,0.0,32,46,0,27,67,0,0,16,1,105,84,1
20679,190445,0LXJzqROabJZv3y6yW15E1KiOEkZJTqc,3VkHkmOtom3jM2wCu94xgzzu1d6Dn7or,1,0,0,0,0,0,1,0,1,0.14285714285714285,1,0.0,0,0,0,0,0,0,0,1,0,0,1,1
20680,190456,c0a5kgsgAaSlwSloByZTtqyb6w7GEpak,3VkHkmOtom3jM2wCu94xgzzu1d6Dn7or,6,10,5,0,1,0,3,0,19,2.7142857142857144,1,0.0,3,5,0,1,7,0,0,3,0,9,10,1
20681,190480,62BMeX44VT70sf5SmXhoPpud5koFI3Y8,3VkHkmOtom3jM2wCu94xgzzu1d6Dn7or,1,0,0,0,0,0,2,0,2,0.2857142857142857,1,0.0,0,0,0,0,0,0,0,2,0,0,2,1
20682,190490,xcQasYYe4RsxBoKdrpzhKbDwJF62kZfD,3VkHkmOtom3jM2wCu94xgzzu1d6Dn7or,9,13,4,0,3,0,8,3,31,4.428571428571429,1,0.0,4,4,0,3,9,0,0,8,3,11,20,1
20683,190496,apI7ugJ7I4oLyRGiE161nPDFka4wT5xj,3VkHkmOtom3jM2wCu94xgzzu1d6Dn7or,1,0,0,0,0,0,1,0,1,0.14285714285714285,1,0.0,0,0,0,0,0,0,0,1,0,0,1,1
20684,190510,DGlEyZ0IT4AVA28J85yTcLFtD1UWpsA2,3VkHkmOtom3jM2wCu94xgzzu1d6Dn7or,1,0,0,0,0,0,1,0,1,0.14285714285714285,1,0.0,0,0,0,0,0,0,0,1,0,0,1,1
20685,190516,AqFTP9I95DGAQHiCZtkhxV5lY98NglUH,3VkHkmOtom3jM2wCu94xgzzu1d6Dn7or,9,5,3,0,3,0,4,1,16,2.2857142857142856,1,0.0,1,3,0,3,4,0,0,4,1,7,9,1
20686,190572,LJtcyB32ET1GtKC2SiNyWCb0ttB0fxR3,3VkHkmOtom3jM2wCu94xgzzu1d6Dn7or,7,3,2,0,2,0,3,0,10,1.4285714285714286,1,0.0,0,2,0,2,3,0,0,3,0,4,6,1
20687,190573,WYMTvSSRESaPrlMQXdF4tHfJAYTGFy2A,3VkHkmOtom3jM2wCu94xgzzu1d6Dn7or,2,0,0,0,0,0,2,0,2,0.2857142857142857,1,0.0,0,0,0,0,0,0,0,2,0,0,2,1
20688,190576,k512uodHIm7vMzP162z7tWUxDo7wSSdV,3VkHkmOtom3jM2wCu94xgzzu1d6Dn7or,5,2,1,0,1,0,4,0,8,1.1428571428571428,1,0.0,0,1,0,1,2,0,0,4,0,2,6,1
20689,190583,O8CiMquiVqY3DsyFgTSidDZpnZqdb7Xw,3VkHkmOtom3jM2wCu94xgzzu1d6Dn7or,6,10,1,4,4,1,3,0,23,3.2857142857142856,1,0.0,8,1,3,4,2,1,1,3,0,16,7,1
20690,190611,Y3qAEqzdKJewEkb06n8n2BrJMQzX9urI,3VkHkmOtom3jM2wCu94xgzzu1d6Dn7or,11,5,4,0,4,0,2,0,15,2.142857142857143,1,0.0,0,4,0,4,5,0,0,2,0,8,7,1
20691,190612,jeG7y0hvrnn7zXO893BycRsX9A48NzFD,3VkHkmOtom3jM2wCu94xgzzu1d6Dn7or,1,0,0,0,0,0,1,0,1,0.14285714285714285,1,0.0,0,0,0,0,0,0,0,1,0,0,1,1
20692,190617,KeUmbPeTRA1tmaXd5yuyowyu7cYy5FFN,3VkHkmOtom3jM2wCu94xgzzu1d6Dn7or,1,0,0,0,0,0,1,0,1,0.14285714285714285,1,0.0,0,0,0,0,0,0,0,1,0,0,1,1
20693,190623,tOrDJhbY0ZFR5K4cuMyBpfcNgbvhflbB,3VkHkmOtom3jM2wCu94xgzzu1d6Dn7or,10,16,5,0,4,0,6,0,31,4.428571428571429,1,0.0,5,5,0,4,11,0,0,6,0,14,17,1
20694,190639,Xs00fMQ3BnlIPKFHWCmFrk4I1ISaB7lE,3VkHkmOtom3jM2wCu94xgzzu1d6Dn7or,4,5,1,0,1,0,2,0,9,1.2857142857142858,1,0.0,3,1,0,1,2,0,0,2,0,5,4,1
20695,190642,7hekvV8SH4NkArxoIuWJ5d0sFbDCsYHf,3VkHkmOtom3jM2wCu94xgzzu1d6Dn7or,4,2,1,0,1,0,1,0,5,0.7142857142857143,1,0.0,0,1,0,1,2,0,0,1,0,2,3,1
20696,190656,vs46hPMjy0xWIeJb83l7XTvnDGw8VihI,3VkHkmOtom3jM2wCu94xgzzu1d6Dn7or,1,0,0,0,0,0,1,0,1,0.14285714285714285,1,0.0,0,0,0,0,0,0,0,1,0,0,1,1
20697,190668,bXtEPDfsfKZsqSp6hSciQQ8xxWbvrnfw,3VkHkmOtom3jM2wCu94xgzzu1d6Dn7or,1,0,0,0,0,0,1,0,1,0.14285714285714285,1,0.0,0,0,0,0,0,0,0,1,0,0,1,1
20698,190678,M3IgJFMjL43O6e0cctabP91ddooPQjMV,3VkHkmOtom3jM2wCu94xgzzu1d6Dn7or,7,3,2,0,2,0,3,0,10,1.4285714285714286,2,0.0,0,2,0,2,3,0,0,3,0,4,6,1
20699,190703,BPA9qiiC8H1g3hvpNyl77OvcydP8kn0Y,3VkHkmOtom3jM2wCu94xgzzu1d6Dn7or,1,0,0,0,0,0,1,0,1,0.14285714285714285,1,0.0,0,0,0,0,0,0,0,1,0,0,1,1
20700,190709,x8IFjwCPBRlQP9uuBa1tGX8WpsXCLtes,3VkHkmOtom3jM2wCu94xgzzu1d6Dn7or,5,2,1,0,1,0,2,0,6,0.8571428571428571,1,0.0,0,1,0,1,2,0,0,2,0,2,4,1
20701,190718,DpxuYKp6sa0JAnGuKmqElQRmCDtXLEpJ,SpATywNh6bZuzm8s1ceuBUnMUAeoAHHw,1,0,0,0,0,0,1,0,1,0.14285714285714285,1,0.0,0,0,0,0,0,0,0,1,0,0,1,1
20702,190722,Ms1kL8mhYcPEiDk8tgcaN8I4C5LMNZxp,G8EPVSXsOYB5YQWZGiz1aVq5Pgr2GrQu,11,9,1,19,0,0,1,0,30,4.285714285714286,1,0.0,4,1,15,0,5,0,4,1,0,20,10,1
20703,190727,37BDHc0OYB1UI75qIorGre2ofEZmPc4J,A3fsA9Zfv1X2fVEQhTw51lKENdNrEqT3,1,0,0,0,0,0,1,0,1,0.14285714285714285,1,0.0,0,0,0,0,0,0,0,1,0,0,1,1
20704,190733,qwFC3xpje0fSY3HguoMOOzyv51OIHJQc,SpATywNh6bZuzm8s1ceuBUnMUAeoAHHw,5,2,1,0,1,0,2,0,6,0.8571428571428571,1,0.0,0,1,0,1,2,0,0,2,0,2,4,1
20705,190740,MK8n1r3R3tfWcasYdKrOSnVNYSZNSOlt,SpATywNh6bZuzm8s1ceuBUnMUAeoAHHw,13,33,4,23,0,1,7,2,70,10.0,1,0.0,10,4,20,0,23,1,3,7,2,34,36,1
20706,190746,TCMrwUanMGda0OSNc9BMWUDLbksnXQ2Q,SpATywNh6bZuzm8s1ceuBUnMUAeoAHHw,11,13,7,0,4,5,6,1,36,5.142857142857143,1,0.0,0,7,0,4,13,5,0,6,1,11,25,0
20707,190751,wIcAqiIkhVke6PQk1FQ10LQjFUOa268K,A3fsA9Zfv1X2fVEQhTw51lKENdNrEqT3,1,0,0,0,0,0,2,0,2,0.2857142857142857,1,0.0,0,0,0,0,0,0,0,2,0,0,2,1
20708,190753,d91YjGHVAp34DYQkswrOrvZeIJcGcFNO,SpATywNh6bZuzm8s1ceuBUnMUAeoAHHw,13,13,5,12,4,0,2,0,36,5.142857142857143,1,0.0,6,5,11,4,7,0,1,2,0,26,10,1
20709,190765,3RcsrMTbPrb8ZHYXLlgwoRK7zrqTGSuq,RXDvfPUBYFlVdlueBFbLW0mhhAyGEqpt,4,2,1,0,1,0,1,0,5,0.7142857142857143,1,0.0,0,1,0,1,2,0,0,1,0,2,3,1
20710,190772,HBKLIFAfKd9tCUbnjwmqE9j7uloBEJrv,bWdj2GDclj5ofokWjzoa5jAwMkxCykd6,6,8,1,0,1,5,6,0,21,3.0,2,0.0,0,1,0,1,8,5,0,6,0,2,19,1
20711,190777,Ah2AGzYhaU2T8uPD2EY56TT31dJPAut5,SpATywNh6bZuzm8s1ceuBUnMUAeoAHHw,6,3,1,0,1,0,2,0,7,1.0,1,0.0,0,1,0,1,3,0,0,2,0,2,5,1
20712,190783,jImHfNEIObE674KdIbKVj7cCJ4ufqzHJ,bWdj2GDclj5ofokWjzoa5jAwMkxCykd6,6,6,2,0,0,10,4,0,22,3.142857142857143,1,0.0,1,2,0,0,5,10,0,4,0,3,19,1
20713,190788,ub8WyOqIuzODPtpQPBgjCOsRi8689oKs,bWdj2GDclj5ofokWjzoa5jAwMkxCykd6,9,16,6,34,6,0,3,0,65,9.285714285714286,1,0.0,7,6,33,6,9,0,1,3,0,52,13,1
20714,190789,OVHTSfVPYj0AbzU459n1EpNOKwcVwoC1,SpATywNh6bZuzm8s1ceuBUnMUAeoAHHw,6,1,1,0,1,0,5,0,8,1.1428571428571428,1,0.0,0,1,0,1,1,0,0,5,0,2,6,1
20715,190799,4e4wTy2Vsuz8jVFYgJOgi1kIGDWREiPH,A3fsA9Zfv1X2fVEQhTw51lKENdNrEqT3,1,0,0,0,0,0,1,0,1,0.14285714285714285,1,0.0,0,0,0,0,0,0,0,1,0,0,1,1
20716,190810,kKpnSjKhiG2j5iddaCKIyt4CCm1rwmVr,bWdj2GDclj5ofokWjzoa5jAwMkxCykd6,2,0,0,0,0,0,2,0,2,0.2857142857142857,1,0.0,0,0,0,0,0,0,0,2,0,0,2,0
20717,190812,3GA2inbDa4Qb67FoyO0TodCHsf82hLjI,bWdj2GDclj5ofokWjzoa5jAwMkxCykd6,7,9,0,0,0,0,6,0,15,2.142857142857143,2,0.0,0,0,0,0,9,0,0,6,0,0,15,1
20718,190843,hfNogWjrbSkOb5OMhhVjR3oNpdgCCLmb,SpATywNh6bZuzm8s1ceuBUnMUAeoAHHw,3,0,0,0,0,0,3,0,3,0.42857142857142855,1,0.0,0,0,0,0,0,0,0,3,0,0,3,1
20719,190859,ckUpblr5wnpb1JdYLODP4lr2g04VPwJ3,SpATywNh6bZuzm8s1ceuBUnMUAeoAHHw,6,8,4,0,4,0,1,0,17,2.4285714285714284,1,0.0,3,4,0,4,5,0,0,1,0,11,6,1
20720,190862,6ZrLKRxT6wri7cDqZ6Wete0KvsW58pUp,SpATywNh6bZuzm8s1ceuBUnMUAeoAHHw,3,2,0,0,0,0,1,0,3,0.42857142857142855,1,0.0,0,0,0,0,2,0,0,1,0,0,3,1
20721,190865,tE94PJyjcpdWxXLDLcWw5U2hOs3lOnfb,SpATywNh6bZuzm8s1ceuBUnMUAeoAHHw,12,4,3,0,3,1,5,1,17,2.4285714285714284,1,0.0,0,3,0,3,4,1,0,5,1,6,11,1
20722,190871,DanoP5XpHODQZmwuFGZgNKBiu5nY9yH1,bWdj2GDclj5ofokWjzoa5jAwMkxCykd6,5,3,1,0,1,1,2,1,9,1.2857142857142858,1,0.0,1,1,0,1,2,1,0,2,1,3,6,1
20723,190878,XZVdP9VG9V0aFXSF7pNpI4xf6QSEG5Qi,SpATywNh6bZuzm8s1ceuBUnMUAeoAHHw,1,0,0,0,0,0,1,0,1,0.14285714285714285,1,0.0,0,0,0,0,0,0,0,1,0,0,1,1
20724,190881,qKdcEew3Ozu2wI3f7P370tw3NiiGDkW3,bWdj2GDclj5ofokWjzoa5jAwMkxCykd6,1,0,0,0,0,0,1,0,1,0.14285714285714285,1,0.0,0,0,0,0,0,0,0,1,0,0,1,1
20725,190890,9Yh9BGNzlB70iEC7VABYNXfepXjXz9Ik,A3fsA9Zfv1X2fVEQhTw51lKENdNrEqT3,1,0,0,0,0,0,3,0,3,0.42857142857142855,1,0.0,0,0,0,0,0,0,0,3,0,0,3,1
20726,190896,jGtiVf5HYLqgOasCrKGgOBMBFuA9x4ae,SpATywNh6bZuzm8s1ceuBUnMUAeoAHHw,7,6,2,0,2,0,2,0,12,1.7142857142857142,1,0.0,0,2,0,2,6,0,0,2,0,4,8,1
20727,190918,withnGSnYLu5h0Gra5Fz5vQjZTgJGD3V,SpATywNh6bZuzm8s1ceuBUnMUAeoAHHw,7,3,2,0,2,0,4,0,11,1.5714285714285714,1,0.0,0,2,0,2,3,0,0,4,0,4,7,1
20728,190922,tbFJlVh7YWaPwir5TDxmcNNiJWy4IdR6,SpATywNh6bZuzm8s1ceuBUnMUAeoAHHw,7,8,5,0,3,0,3,0,19,2.7142857142857144,1,0.0,0,5,0,3,8,0,0,3,0,8,11,1
20729,190929,KK8c9Dmj5I63bhg4LxlQHTWu5jCGLVNt,SpATywNh6bZuzm8s1ceuBUnMUAeoAHHw,1,0,0,0,0,0,1,0,1,0.14285714285714285,1,0.0,0,0,0,0,0,0,0,1,0,0,1,1
20730,190932,gWQVeEY6kY0Jw04P2MZyClMk9GLvVaq0,RXDvfPUBYFlVdlueBFbLW0mhhAyGEqpt,14,11,8,19,2,0,11,0,51,7.285714285714286,1,0.0,1,8,16,2,10,0,3,11,0,27,24,1
20731,190938,QxwH5Fww2hdJXhksXEKBkHoArOFw3LA7,bWdj2GDclj5ofokWjzoa5jAwMkxCykd6,1,0,0,0,0,0,1,0,1,0.14285714285714285,1,0.0,0,0,0,0,0,0,0,1,0,0,1,1
20732,190943,2AimReANoYwzi4n9y5GufQBbWWeoLfr2,bWdj2GDclj5ofokWjzoa5jAwMkxCykd6,1,0,0,0,0,0,1,0,1,0.14285714285714285,1,0.0,0,0,0,0,0,0,0,1,0,0,1,1
20733,190946,NzGQ6qHi5I7oDznlM4iA1Evelv3MLoFE,SpATywNh6bZuzm8s1ceuBUnMUAeoAHHw,10,16,5,4,0,2,6,0,33,4.714285714285714,1,0.0,1,5,3,0,15,2,1,6,0,9,24,1
20734,190948,BwqiPFy1sDFuBLb3rSXiF0IO3CLelW7L,SpATywNh6bZuzm8s1ceuBUnMUAeoAHHw,14,14,5,16,2,13,8,4,62,8.857142857142858,2,0.0,8,5,14,2,6,13,2,8,4,29,33,1
20735,190950,9Yh9BGNzlB70iEC7VABYNXfepXjXz9Ik,bWdj2GDclj5ofokWjzoa5jAwMkxCykd6,4,2,0,0,0,3,4,0,9,1.2857142857142858,1,0.0,0,0,0,0,2,3,0,4,0,0,9,1
20736,190952,C4ydYZ7sRMBYk7EGihDGPeJUEQIdQEOw,SpATywNh6bZuzm8s1ceuBUnMUAeoAHHw,8,18,10,0,6,0,4,0,38,5.428571428571429,3,0.0,0,10,0,6,18,0,0,4,0,16,22,0
20737,190956,MBe2FxezhNNSk0O4l1Td85ufwdvtDvm8,SpATywNh6bZuzm8s1ceuBUnMUAeoAHHw,14,7,4,12,3,7,4,0,37,5.285714285714286,1,0.0,2,4,10,3,5,7,2,4,0,19,18,1
20738,190963,AilYGUB2b7U7u3L7JzReiarkucWyF0Uz,SpATywNh6bZuzm8s1ceuBUnMUAeoAHHw,2,0,0,0,0,0,4,0,4,0.5714285714285714,1,0.0,0,0,0,0,0,0,0,4,0,0,4,1
20739,190970,LLbWHvDvBPRMaeOD85m6rAaUvdLFucgj,bWdj2GDclj5ofokWjzoa5jAwMkxCykd6,3,0,0,0,0,0,4,0,4,0.5714285714285714,2,0.0,0,0,0,0,0,0,0,4,0,0,4,1
20740,190979,pMptAyZDeGXiIThstiLzNxB1KwRjAXpm,SpATywNh6bZuzm8s1ceuBUnMUAeoAHHw,1,0,0,0,0,0,1,0,1,0.14285714285714285,1,0.0,0,0,0,0,0,0,0,1,0,0,1,1
20741,190983,FiovvlFjZXQo41RA25FaJ17VJEgdj2le,SpATywNh6bZuzm8s1ceuBUnMUAeoAHHw,9,17,1,20,0,0,1,0,39,5.571428571428571,1,0.0,8,1,17,0,9,0,3,1,0,26,13,0
20742,191003,hupbjCOx448dHGDJQGqmUPOcvI9LWbzv,SpATywNh6bZuzm8s1ceuBUnMUAeoAHHw,4,2,1,0,0,7,3,0,13,1.8571428571428572,2,0.0,0,1,0,0,2,7,0,3,0,1,12,1
20743,191006,Q8nnFnGSO36eBGAiyp2wP0aveYg77DlE,G8EPVSXsOYB5YQWZGiz1aVq5Pgr2GrQu,5,6,1,0,2,1,2,0,12,1.7142857142857142,1,0.0,2,1,0,2,4,1,0,2,0,5,7,1
20744,191018,co3nb33nJ0Krxm21xnzLNxLQgo7GndnG,SpATywNh6bZuzm8s1ceuBUnMUAeoAHHw,1,0,0,0,0,0,1,0,1,0.14285714285714285,1,0.0,0,0,0,0,0,0,0,1,0,0,1,1
20745,191019,NCCp8fTS5s1iyttaNh3WkMeHCOcN3tb4,bWdj2GDclj5ofokWjzoa5jAwMkxCykd6,2,0,0,0,0,0,2,0,2,0.2857142857142857,1,0.0,0,0,0,0,0,0,0,2,0,0,2,1
20746,191021,nNXCDU7pCvXdQPycxWESwEGIIRWvHKWv,SpATywNh6bZuzm8s1ceuBUnMUAeoAHHw,3,2,1,0,0,0,1,0,4,0.5714285714285714,1,0.0,0,1,0,0,2,0,0,1,0,1,3,1
20747,191027,uFHm9PGn5yQICMVzgF44FzRtCVKrar2K,SpATywNh6bZuzm8s1ceuBUnMUAeoAHHw,7,2,1,0,1,1,4,0,9,1.2857142857142858,1,0.0,0,1,0,1,2,1,0,4,0,2,7,0
20748,191029,qSgfNAK24EhdWunFvzpQNvLLVkPV61Hr,A3fsA9Zfv1X2fVEQhTw51lKENdNrEqT3,1,0,0,0,0,0,1,0,1,0.14285714285714285,1,0.0,0,0,0,0,0,0,0,1,0,0,1,1
20749,191038,Sc510MM1IFPp0fhdgDOEyRVvZYZOxuoR,A3fsA9Zfv1X2fVEQhTw51lKENdNrEqT3,1,0,0,0,0,0,1,0,1,0.14285714285714285,1,0.0,0,0,0,0,0,0,0,1,0,0,1,1
20750,191041,trENMyltvkElnFRacDKrV1O2HLSxf35j,A3fsA9Zfv1X2fVEQhTw51lKENdNrEqT3,5,2,1,0,1,0,2,0,6,0.8571428571428571,2,0.0,0,1,0,1,2,0,0,2,0,2,4,1
20751,191050,Y3qAEqzdKJewEkb06n8n2BrJMQzX9urI,SpATywNh6bZuzm8s1ceuBUnMUAeoAHHw,15,13,5,19,3,7,6,1,54,7.714285714285714,1,0.0,8,5,16,3,5,7,3,6,1,32,22,1
20752,191063,nRHQUNRUIsIinoYx4tQlxNnAC0I3YYVk,G8EPVSXsOYB5YQWZGiz1aVq5Pgr2GrQu,41,59,33,88,16,0,11,5,212,30.285714285714285,1,0.0,20,33,75,16,39,0,13,11,5,144,68,1
20753,191064,yB2j2tPO2DVKCBBdsLv8a1lbHtfWINMh,bWdj2GDclj5ofokWjzoa5jAwMkxCykd6,1,0,0,0,0,0,1,0,1,0.14285714285714285,1,0.0,0,0,0,0,0,0,0,1,0,0,1,1
20754,191078,hjK9g2c0CglrLajBSxgIKqI54vivYEKM,SpATywNh6bZuzm8s1ceuBUnMUAeoAHHw,1,0,0,0,0,0,1,0,1,0.14285714285714285,1,0.0,0,0,0,0,0,0,0,1,0,0,1,1
20755,191102,etudbAO9CMrW6LcXYzcIWXUJFoLMbVh9,SpATywNh6bZuzm8s1ceuBUnMUAeoAHHw,10,5,3,0,2,9,5,1,25,3.5714285714285716,1,0.0,0,3,0,2,5,9,0,5,1,5,20,1
20756,191103,917C36aL5o1yjdcDTH5lZyAgXpc01Gk5,SpATywNh6bZuzm8s1ceuBUnMUAeoAHHw,4,2,0,0,0,1,2,1,6,0.8571428571428571,1,0.0,0,0,0,0,2,1,0,2,1,0,6,1
20757,191106,geEAXwfPbJ0MhEZG0COad1UptHNAilTd,bWdj2GDclj5ofokWjzoa5jAwMkxCykd6,2,0,0,0,0,0,2,0,2,0.2857142857142857,1,0.0,0,0,0,0,0,0,0,2,0,0,2,1
20758,191129,SHOQyzWMzeXzTVojp4arGhfbJLLjl3Lx,bWdj2GDclj5ofokWjzoa5jAwMkxCykd6,4,2,1,0,1,0,1,0,5,0.7142857142857143,1,0.0,0,1,0,1,2,0,0,1,0,2,3,1
20759,191131,HcFsEHTYadygQKRPBb3uDSEv8jpRHr6D,A3fsA9Zfv1X2fVEQhTw51lKENdNrEqT3,1,0,0,0,0,0,2,0,2,0.2857142857142857,1,0.0,0,0,0,0,0,0,0,2,0,0,2,1
20760,191132,deraFog8y0MjwcE23P6Rs0pGeytN3xmN,SpATywNh6bZuzm8s1ceuBUnMUAeoAHHw,9,11,0,0,0,2,14,4,31,4.428571428571429,1,0.0,0,0,0,0,11,2,0,14,4,0,31,1
20761,191135,OPQKWFr5Ag3gYEWW9i0rWdZ5Gc0wk3FB,SpATywNh6bZuzm8s1ceuBUnMUAeoAHHw,5,2,1,0,1,0,4,0,8,1.1428571428571428,1,0.0,0,1,0,1,2,0,0,4,0,2,6,1
20762,191143,KarP5JDxaA55wR1ThEFPoGYFsHmbBCZf,bWdj2GDclj5ofokWjzoa5jAwMkxCykd6,5,2,1,0,1,0,2,0,6,0.8571428571428571,1,0.0,0,1,0,1,2,0,0,2,0,2,4,1
20763,191147,21VuQSD13OpzBWnKCJ94z3vzUwy0J7cg,SpATywNh6bZuzm8s1ceuBUnMUAeoAHHw,9,7,3,0,0,0,5,1,16,2.2857142857142856,1,0.0,1,3,0,0,6,0,0,5,1,4,12,1
20764,191149,2KkJ2RPeYYnwpoBmLIbDX3SHVzQ9KAtd,SpATywNh6bZuzm8s1ceuBUnMUAeoAHHw,1,0,0,0,0,0,1,0,1,0.14285714285714285,1,0.0,0,0,0,0,0,0,0,1,0,0,1,1
20765,191155,S1LmT8vUaszGt2C5KVBW9KkkZ6u3e67K,SpATywNh6bZuzm8s1ceuBUnMUAeoAHHw,1,0,0,0,0,0,1,0,1,0.14285714285714285,1,0.0,0,0,0,0,0,0,0,1,0,0,1,1
20766,191165,XKiESHLmmxxFLSNhNTicMKXZo07ga8rR,bWdj2GDclj5ofokWjzoa5jAwMkxCykd6,2,0,0,0,0,0,2,0,2,0.2857142857142857,1,0.0,0,0,0,0,0,0,0,2,0,0,2,1
20767,191170,SfAUcZmUPYD4dsdFfOX7wSpg4mGcve5n,RXDvfPUBYFlVdlueBFbLW0mhhAyGEqpt,1,0,0,0,0,0,1,0,1,0.14285714285714285,1,0.0,0,0,0,0,0,0,0,1,0,0,1,1
20768,191179,wFv26V6AwzjCWPgCKpY50WBZiVw3xNw6,SpATywNh6bZuzm8s1ceuBUnMUAeoAHHw,7,4,3,0,3,0,2,0,12,1.7142857142857142,1,0.0,0,3,0,3,4,0,0,2,0,6,6,1
20769,191183,fXZkHvfRnLNWddfTwlt8RK2cRTiOmg3N,A3fsA9Zfv1X2fVEQhTw51lKENdNrEqT3,1,0,0,0,0,0,1,0,1,0.14285714285714285,1,0.0,0,0,0,0,0,0,0,1,0,0,1,1
20770,191190,aapkW8QMW8TztGeQlTnDfKEKcZX1vbn1,G8EPVSXsOYB5YQWZGiz1aVq5Pgr2GrQu,13,9,5,0,3,4,15,3,39,5.571428571428571,2,0.0,0,5,0,3,9,4,0,15,3,8,31,1
20771,191209,p8HUn53OHQxlBbPvpqicSSSkhMnoLuUk,A3fsA9Zfv1X2fVEQhTw51lKENdNrEqT3,1,0,0,0,0,0,1,0,1,0.14285714285714285,1,0.0,0,0,0,0,0,0,0,1,0,0,1,1
20772,191216,Rrclmw0iWTQ4R8VbZgEecyKPKpTh2o7K,SpATywNh6bZuzm8s1ceuBUnMUAeoAHHw,6,2,0,0,0,12,9,4,27,3.857142857142857,1,0.0,0,0,0,0,2,12,0,9,4,0,27,1
20773,191217,ecMZFfPrfYojsNqJQgwYc4hJSMzDZMZK,A3fsA9Zfv1X2fVEQhTw51lKENdNrEqT3,3,0,0,0,0,0,5,0,5,0.7142857142857143,2,0.0,0,0,0,0,0,0,0,5,0,0,5,1
20774,191224,3g91EUZkauWqcKpU9xr8zVzrn0H8G1A9,bWdj2GDclj5ofokWjzoa5jAwMkxCykd6,1,0,0,0,0,0,1,0,1,0.14285714285714285,1,0.0,0,0,0,0,0,0,0,1,0,0,1,1
20775,191240,z79FxI6IxKXksSKIwsXSYM1kOlaP8f6r,SpATywNh6bZuzm8s1ceuBUnMUAeoAHHw,4,5,0,0,0,0,1,0,6,0.8571428571428571,1,0.0,0,0,0,0,5,0,0,1,0,0,6,1
20776,191243,6lzjvaZGtQnKLrqzhDE3hBesO66bNsQN,SpATywNh6bZuzm8s1ceuBUnMUAeoAHHw,1,0,0,0,0,0,1,0,1,0.14285714285714285,1,0.0,0,0,0,0,0,0,0,1,0,0,1,1
20777,191248,Vl2QqZFE2XGfXDYVL2VXW5So0Zc5MScE,A3fsA9Zfv1X2fVEQhTw51lKENdNrEqT3,1,0,0,0,0,0,1,0,1,0.14285714285714285,1,0.0,0,0,0,0,0,0,0,1,0,0,1,1
20778,191266,eSnXFXUMyU3QpBQqVY71joco7MnEt79W,SpATywNh6bZuzm8s1ceuBUnMUAeoAHHw,8,5,1,0,1,0,2,0,9,1.2857142857142858,1,0.0,0,1,0,1,5,0,0,2,0,2,7,1
20779,191276,VFwcKDLRscQsLZ6sHhxlnjIEC63BsTj9,SpATywNh6bZuzm8s1ceuBUnMUAeoAHHw,5,5,0,0,0,0,1,0,6,0.8571428571428571,1,0.0,0,0,0,0,5,0,0,1,0,0,6,1
20780,191277,rqoGLMWp7ee8Ppu4OdHSBl6vmRxDZvKU,bWdj2GDclj5ofokWjzoa5jAwMkxCykd6,5,2,1,0,1,2,3,0,9,1.2857142857142858,1,0.0,0,1,0,1,2,2,0,3,0,2,7,1
20781,191282,ThbUQJBeO3JBYqtYMPK5UU7NNpR9FBno,SpATywNh6bZuzm8s1ceuBUnMUAeoAHHw,7,2,1,0,0,1,6,1,11,1.5714285714285714,1,0.0,0,1,0,0,2,1,0,6,1,1,10,1
20782,191294,bQTEZZd4jSi2B0W0A1TlEJEWBwzOd8zQ,SpATywNh6bZuzm8s1ceuBUnMUAeoAHHw,1,0,0,0,0,0,2,0,2,0.2857142857142857,1,0.0,0,0,0,0,0,0,0,2,0,0,2,1
20783,191295,kpqLFmJCsamYXFuknK3QXbLEc5jdZhta,RXDvfPUBYFlVdlueBFbLW0mhhAyGEqpt,1,0,0,0,0,0,1,0,1,0.14285714285714285,1,0.0,0,0,0,0,0,0,0,1,0,0,1,1
20784,191296,UfBZxbp3dHdvs4dmjpPF1a599SiVHfq9,SpATywNh6bZuzm8s1ceuBUnMUAeoAHHw,1,0,0,0,0,0,1,0,1,0.14285714285714285,1,0.0,0,0,0,0,0,0,0,1,0,0,1,1
20785,191301,UfBZxbp3dHdvs4dmjpPF1a599SiVHfq9,A3fsA9Zfv1X2fVEQhTw51lKENdNrEqT3,1,0,0,0,0,0,1,0,1,0.14285714285714285,1,0.0,0,0,0,0,0,0,0,1,0,0,1,0
20786,191326,bqKGVuyOqvCYIWLNoZkiDVBShCS1Solh,bWdj2GDclj5ofokWjzoa5jAwMkxCykd6,7,3,2,0,2,0,2,0,9,1.2857142857142858,1,0.0,0,2,0,2,3,0,0,2,0,4,5,1
20787,191328,d5HAnSQkztXQmCBt7mWJteYbuGp9eXK9,SpATywNh6bZuzm8s1ceuBUnMUAeoAHHw,17,11,5,16,3,1,6,1,43,6.142857142857143,1,0.0,4,5,13,3,7,1,3,6,1,25,18,0
20788,191333,u2lFPFqaHTPOsPVzurefGhIungrLsH3I,G8EPVSXsOYB5YQWZGiz1aVq5Pgr2GrQu,4,2,1,0,1,0,1,0,5,0.7142857142857143,1,0.0,0,1,0,1,2,0,0,1,0,2,3,1
20789,191336,2XCqRCsUPBJ1NAgHMrTgcxY6YdxrycrK,G8EPVSXsOYB5YQWZGiz1aVq5Pgr2GrQu,4,2,0,0,0,0,2,0,4,0.5714285714285714,1,0.0,0,0,0,0,2,0,0,2,0,0,4,1
20790,191348,SI69wwcTWVHmHvMK3iTZ6yjmoQxbU7l5,SpATywNh6bZuzm8s1ceuBUnMUAeoAHHw,10,12,0,22,0,8,5,1,48,6.857142857142857,1,0.0,6,0,20,0,6,8,2,5,1,26,22,1
20791,191352,9I8c8L7WQpD9ZtJRhVVfTlPNfkSlIEEb,SpATywNh6bZuzm8s1ceuBUnMUAeoAHHw,14,17,1,22,0,4,9,1,54,7.714285714285714,2,0.0,8,1,20,0,9,4,2,9,1,29,25,0
20792,191361,uvyVPWEsqLIlBRKFxrhWDmK1U2rKG8GE,SpATywNh6bZuzm8s1ceuBUnMUAeoAHHw,18,44,20,20,10,11,17,3,125,17.857142857142858,2,0.0,17,20,16,10,27,11,4,17,3,63,62,1
20793,191363,fayEZWE6L5NpkIRwMpEH7DP3Ho4nLIru,RXDvfPUBYFlVdlueBFbLW0mhhAyGEqpt,7,4,0,0,0,0,3,0,7,1.0,1,0.0,0,0,0,0,4,0,0,3,0,0,7,1
20794,191366,CRRYXyAc4ijr26PN9CuVczNnv8kJ91AK,SpATywNh6bZuzm8s1ceuBUnMUAeoAHHw,9,8,4,0,2,0,5,0,19,2.7142857142857144,1,0.0,2,4,0,2,6,0,0,5,0,8,11,1
20795,191379,Ieqd5itEcYJJN0R1exEtlEqnGZPAbCE6,bWdj2GDclj5ofokWjzoa5jAwMkxCykd6,4,3,1,0,1,0,1,0,6,0.8571428571428571,1,0.0,0,1,0,1,3,0,0,1,0,2,4,1
20796,191384,dmUrk0xMCS6SDyaouVCuyhAM6JJFFbys,SpATywNh6bZuzm8s1ceuBUnMUAeoAHHw,5,3,0,0,0,2,4,0,9,1.2857142857142858,1,0.0,0,0,0,0,3,2,0,4,0,0,9,1
20797,191389,smdC4Gk5L0XnGuMq4y1IOb0E2yVqYROb,SpATywNh6bZuzm8s1ceuBUnMUAeoAHHw,3,0,0,0,0,1,2,0,3,0.42857142857142855,1,0.0,0,0,0,0,0,1,0,2,0,0,3,1
20798,191398,ArHJamcmypPdkqgLXvwA7Xp8QRSvXxlF,SpATywNh6bZuzm8s1ceuBUnMUAeoAHHw,7,3,2,0,2,0,2,0,9,1.2857142857142858,1,0.0,0,2,0,2,3,0,0,2,0,4,5,1
20799,191409,uIv1Q8Ye5xXUaFW9tumYDZDxTsrCfpst,SpATywNh6bZuzm8s1ceuBUnMUAeoAHHw,1,0,0,0,0,0,1,0,1,0.14285714285714285,1,0.0,0,0,0,0,0,0,0,1,0,0,1,1
20800,191419,S4sULDuFAQWAEdmQxVT34py82agUl29W,bWdj2GDclj5ofokWjzoa5jAwMkxCykd6,6,1,1,0,1,0,3,0,6,0.8571428571428571,1,0.0,0,1,0,1,1,0,0,3,0,2,4,1
20801,191424,dnQdmZcm7uKA0vljQm6kJeP4CqW8fiMU,SpATywNh6bZuzm8s1ceuBUnMUAeoAHHw,5,2,1,0,1,0,2,0,6,0.8571428571428571,1,0.0,0,1,0,1,2,0,0,2,0,2,4,1
20802,191440,y1w3D4hQ1692TSq31BiNSwe5l2ooxLrJ,SpATywNh6bZuzm8s1ceuBUnMUAeoAHHw,7,2,1,0,1,0,4,0,8,1.1428571428571428,1,0.0,0,1,0,1,2,0,0,4,0,2,6,1
20803,191458,N9XRkzLdEnO1yDrNCc5jLvv7TriIRXAT,SpATywNh6bZuzm8s1ceuBUnMUAeoAHHw,9,4,2,0,1,0,8,1,16,2.2857142857142856,1,0.0,0,2,0,1,4,0,0,8,1,3,13,1
20804,191479,lcq8rKaAKyasaLAhf4XgwtdTDaLQpKXs,G8EPVSXsOYB5YQWZGiz1aVq5Pgr2GrQu,1,0,0,0,0,0,1,0,1,0.14285714285714285,1,0.0,0,0,0,0,0,0,0,1,0,0,1,1
20805,191482,qV9YvOiEawMvqxu18S9WhO9WLokOJG0e,SpATywNh6bZuzm8s1ceuBUnMUAeoAHHw,16,26,13,16,5,10,11,1,82,11.714285714285714,1,0.0,7,13,14,5,19,10,2,11,1,39,43,1
20806,191505,MRzfDn8Dt6xZQHTAuGEWQiuznoHxxpTX,G8EPVSXsOYB5YQWZGiz1aVq5Pgr2GrQu,1,0,0,0,0,0,1,0,1,0.14285714285714285,1,0.0,0,0,0,0,0,0,0,1,0,0,1,1
20807,191507,JIbJQhNgua4oE3gk86Jkguj8qmM444Gu,A3fsA9Zfv1X2fVEQhTw51lKENdNrEqT3,1,0,0,0,0,0,1,0,1,0.14285714285714285,1,0.0,0,0,0,0,0,0,0,1,0,0,1,1
20808,191531,zFJwABbnu7ecHOUlCE6eTmrBM1zbvMVg,SpATywNh6bZuzm8s1ceuBUnMUAeoAHHw,7,3,2,0,2,0,2,0,9,1.2857142857142858,1,0.0,0,2,0,2,3,0,0,2,0,4,5,1
20809,191534,wme4hkVddg0xzeatj2MinEZLWEQ5E7bR,SpATywNh6bZuzm8s1ceuBUnMUAeoAHHw,1,0,0,0,0,0,1,0,1,0.14285714285714285,1,0.0,0,0,0,0,0,0,0,1,0,0,1,1
20810,191545,xe9PdHtL47ijNdtrDmdC73RUGIc061NJ,SpATywNh6bZuzm8s1ceuBUnMUAeoAHHw,7,5,2,0,2,0,2,0,11,1.5714285714285714,1,0.0,0,2,0,2,5,0,0,2,0,4,7,1
20811,191560,lQY8mxQRqkTrX8U3ZBCC39fTp3ibXjgY,A3fsA9Zfv1X2fVEQhTw51lKENdNrEqT3,1,0,0,0,0,0,1,0,1,0.14285714285714285,1,0.0,0,0,0,0,0,0,0,1,0,0,1,1
20812,191562,LzUunErgfx3QBtzhgVcWGMItAqeQB5qb,bWdj2GDclj5ofokWjzoa5jAwMkxCykd6,10,20,7,44,8,0,16,0,95,13.571428571428571,2,0.0,3,7,42,8,17,0,2,16,0,60,35,1
20813,191570,8O8F8lqVhamnWAYoriozJh1JpqbQqAoe,SpATywNh6bZuzm8s1ceuBUnMUAeoAHHw,15,34,14,18,7,1,7,1,82,11.714285714285714,1,0.0,12,14,17,7,22,1,1,7,1,50,32,1
20814,191577,O9WtdqogfiBdd3zkscxK6K63kFz00EHp,SpATywNh6bZuzm8s1ceuBUnMUAeoAHHw,4,3,1,0,1,0,1,0,6,0.8571428571428571,1,0.0,0,1,0,1,3,0,0,1,0,2,4,1
20815,191578,BPpNiGtPp3VJWjhMdlZulJsFMsfFBZVO,SpATywNh6bZuzm8s1ceuBUnMUAeoAHHw,1,0,0,0,0,0,1,0,1,0.14285714285714285,1,0.0,0,0,0,0,0,0,0,1,0,0,1,1
20816,191579,ZP3SwNjKPikYYkMi8mCd8YXWyZ9QqocI,SpATywNh6bZuzm8s1ceuBUnMUAeoAHHw,15,13,6,16,5,0,6,0,46,6.571428571428571,1,0.0,6,6,13,5,7,0,3,6,0,30,16,1
20817,191585,7GKeqKRq8nTlHW07udIOaXEQQyokdI9X,G8EPVSXsOYB5YQWZGiz1aVq5Pgr2GrQu,12,9,5,6,5,0,2,0,27,3.857142857142857,1,0.0,3,5,3,5,6,0,3,2,0,16,11,1
20818,191591,PowQ1NVYMTVwKWPXrRw8LaXCisXsIuwA,SpATywNh6bZuzm8s1ceuBUnMUAeoAHHw,8,7,2,0,1,0,4,0,14,2.0,1,0.0,0,2,0,1,7,0,0,4,0,3,11,1
20819,191594,HaJu4RsCsmkTJbtFh34ypsakOUnNCikb,SpATywNh6bZuzm8s1ceuBUnMUAeoAHHw,1,0,0,0,0,0,1,0,1,0.14285714285714285,1,0.0,0,0,0,0,0,0,0,1,0,0,1,1
20820,191598,9Gr4ivUbGE9SyepAFZz19vI7kz7neHyv,SpATywNh6bZuzm8s1ceuBUnMUAeoAHHw,4,1,0,0,0,0,4,0,5,0.7142857142857143,1,0.0,0,0,0,0,1,0,0,4,0,0,5,1
20821,191608,K3reDywuca5r3zDnGu7WqoG47Og2VsxH,SpATywNh6bZuzm8s1ceuBUnMUAeoAHHw,8,10,5,0,2,1,12,0,30,4.285714285714286,1,0.0,0,5,0,2,10,1,0,12,0,7,23,0
20822,191621,01qQ2I7uJit5AcT5N3y2JZTjrStNpmSM,A3fsA9Zfv1X2fVEQhTw51lKENdNrEqT3,1,0,0,0,0,0,1,0,1,0.14285714285714285,1,0.0,0,0,0,0,0,0,0,1,0,0,1,1
20823,191628,WlHV3frRLxQmTIY14HccRXj4N1zg8F2y,bWdj2GDclj5ofokWjzoa5jAwMkxCykd6,1,0,0,0,0,0,1,0,1,0.14285714285714285,1,0.0,0,0,0,0,0,0,0,1,0,0,1,1
20824,191645,2m7SzUThbQ51vSBFUnCl1CYaMYSooUEI,bWdj2GDclj5ofokWjzoa5jAwMkxCykd6,4,2,1,0,1,0,1,0,5,0.7142857142857143,1,0.0,0,1,0,1,2,0,0,1,0,2,3,1
20825,191648,Xl3alXCSFw7Pm6L09eZSxygjyh6OTCwK,SpATywNh6bZuzm8s1ceuBUnMUAeoAHHw,7,4,2,0,2,1,2,0,11,1.5714285714285714,1,0.0,0,2,0,2,4,1,0,2,0,4,7,1
20826,191653,5MNPQvl4M43vX9Ck1VibapAl5kRKA0Ky,SpATywNh6bZuzm8s1ceuBUnMUAeoAHHw,5,3,1,0,1,0,1,0,6,0.8571428571428571,1,0.0,0,1,0,1,3,0,0,1,0,2,4,1
20827,191654,pOCc4XSnI7H8LGdDjvbS3fdE3PxuanE9,SpATywNh6bZuzm8s1ceuBUnMUAeoAHHw,4,2,1,0,1,2,2,0,8,1.1428571428571428,1,0.0,0,1,0,1,2,2,0,2,0,2,6,1
20828,191658,rrHRbXLg6i4u3JAIzGOFXJzGViekqHta,bWdj2GDclj5ofokWjzoa5jAwMkxCykd6,1,0,0,0,0,0,1,0,1,0.14285714285714285,1,0.0,0,0,0,0,0,0,0,1,0,0,1,1
20829,191667,jLTXtk76CIwYt4vY9Qrj5n40JdJeuHTk,SpATywNh6bZuzm8s1ceuBUnMUAeoAHHw,10,8,1,20,0,9,7,1,46,6.571428571428571,2,0.0,2,1,16,0,6,9,4,7,1,19,27,1
20830,191673,eEQqKnaUGHJzSnB7MrBGgZfDTYsV36xI,SpATywNh6bZuzm8s1ceuBUnMUAeoAHHw,5,2,1,0,1,0,2,0,6,0.8571428571428571,1,0.0,0,1,0,1,2,0,0,2,0,2,4,1
20831,191681,poTjed6dzFzOdJfGIhM72y1g95A9uYj5,SpATywNh6bZuzm8s1ceuBUnMUAeoAHHw,4,2,1,0,1,0,1,0,5,0.7142857142857143,1,0.0,0,1,0,1,2,0,0,1,0,2,3,1
20832,191683,hzmNiaPcq2EodwDNxyNnOX6tvxR9MJ1N,SpATywNh6bZuzm8s1ceuBUnMUAeoAHHw,5,2,1,0,1,0,2,0,6,0.8571428571428571,1,0.0,0,1,0,1,2,0,0,2,0,2,4,1
20833,191684,voXAnjlRro0uKeE7Bhzlc3B8ctN5va8G,A3fsA9Zfv1X2fVEQhTw51lKENdNrEqT3,1,0,0,0,0,0,1,0,1,0.14285714285714285,1,0.0,0,0,0,0,0,0,0,1,0,0,1,1
20834,191689,KNNMSW3oLxGqEqv2czanNkhQgdUkOWgY,SpATywNh6bZuzm8s1ceuBUnMUAeoAHHw,1,0,0,0,0,0,1,0,1,0.14285714285714285,1,0.0,0,0,0,0,0,0,0,1,0,0,1,1
20835,191694,WpYtemwKZQxcuLGpndx0lQojfh6o5GOv,A3fsA9Zfv1X2fVEQhTw51lKENdNrEqT3,1,0,0,0,0,0,1,0,1,0.14285714285714285,1,0.0,0,0,0,0,0,0,0,1,0,0,1,1
20836,191705,GfTG7Jl5LqR9ys6qGsGxQl3P09Y2SKWt,SpATywNh6bZuzm8s1ceuBUnMUAeoAHHw,6,4,1,0,1,0,2,0,8,1.1428571428571428,1,0.0,0,1,0,1,4,0,0,2,0,2,6,1
20837,191718,eIW9M0Trkt0EiuTzN2HuEtF6QnUOm4E9,G8EPVSXsOYB5YQWZGiz1aVq5Pgr2GrQu,1,0,0,0,0,0,1,0,1,0.14285714285714285,1,0.0,0,0,0,0,0,0,0,1,0,0,1,1
20838,191719,KFU9DDalEkLY57CnYLljzPh20kfkJgg1,SpATywNh6bZuzm8s1ceuBUnMUAeoAHHw,1,0,0,0,0,0,3,0,3,0.42857142857142855,1,0.0,0,0,0,0,0,0,0,3,0,0,3,1
20839,191736,7891kkT0UkgzTiNar1WxxiRFlwbJEBnB,SpATywNh6bZuzm8s1ceuBUnMUAeoAHHw,10,24,10,3,5,0,2,0,44,6.285714285714286,1,0.0,5,10,3,5,19,0,0,2,0,23,21,1
20840,191746,Yy2T8AQun3h4tOt3dyFcuzCw5XOF0cCp,SpATywNh6bZuzm8s1ceuBUnMUAeoAHHw,1,0,0,0,0,0,2,0,2,0.2857142857142857,1,0.0,0,0,0,0,0,0,0,2,0,0,2,1
20841,191756,Nw8BNhwzOdO3iOxqT3HR1nBiyOtFleo0,SpATywNh6bZuzm8s1ceuBUnMUAeoAHHw,1,0,0,0,0,0,1,0,1,0.14285714285714285,1,0.0,0,0,0,0,0,0,0,1,0,0,1,1
20842,191760,xdfT7UfbG0ewFi6FNN3zlNGBGpobyBrO,RXDvfPUBYFlVdlueBFbLW0mhhAyGEqpt,6,6,0,0,0,0,5,2,13,1.8571428571428572,1,0.0,0,0,0,0,6,0,0,5,2,0,13,1
20843,191773,LuPgMCIdX2ugHzDAngaEsA394qOat0id,A3fsA9Zfv1X2fVEQhTw51lKENdNrEqT3,11,10,5,0,1,0,6,0,22,3.142857142857143,2,0.0,0,5,0,1,10,0,0,6,0,6,16,1
20844,191798,HsUrz2Tvq8sRzoPDsx1zZZFVKu21a9Fj,A3fsA9Zfv1X2fVEQhTw51lKENdNrEqT3,1,0,0,0,0,0,1,0,1,0.14285714285714285,1,0.0,0,0,0,0,0,0,0,1,0,0,1,1
20845,191799,sxhiQuS3HfySJYy4LOfQjplyCzgTKScO,SpATywNh6bZuzm8s1ceuBUnMUAeoAHHw,7,8,4,0,0,0,6,3,21,3.0,1,0.0,0,4,0,0,8,0,0,6,3,4,17,1
20846,191802,kadlP2QWuFIFKLOUJo5sW8v7B7XAv9LQ,SpATywNh6bZuzm8s1ceuBUnMUAeoAHHw,5,3,1,0,1,0,2,0,7,1.0,1,0.0,0,1,0,1,3,0,0,2,0,2,5,1
20847,191804,MU4dVyJTD7iIRSTZIdJZ9VoLOxogfKQN,bWdj2GDclj5ofokWjzoa5jAwMkxCykd6,2,0,0,0,0,0,2,0,2,0.2857142857142857,1,0.0,0,0,0,0,0,0,0,2,0,0,2,1
20848,191808,QhgZ8WnXOcD5WE8AKIXP6yesa48bioAv,G8EPVSXsOYB5YQWZGiz1aVq5Pgr2GrQu,1,0,0,0,0,0,1,0,1,0.14285714285714285,1,0.0,0,0,0,0,0,0,0,1,0,0,1,1
20849,191812,glVCC77LfitTkPbkpypiclvPPbAnhs5Z,SpATywNh6bZuzm8s1ceuBUnMUAeoAHHw,1,0,0,0,0,0,1,0,1,0.14285714285714285,1,0.0,0,0,0,0,0,0,0,1,0,0,1,1
20850,191821,IERsxa1qtpNEp0IX6fqnPIs58eKAo4jM,RXDvfPUBYFlVdlueBFbLW0mhhAyGEqpt,3,2,1,0,0,0,1,0,4,0.5714285714285714,1,0.0,0,1,0,0,2,0,0,1,0,1,3,1
20851,191834,xFQWFF18peOPGJbc58SGDlEI5nMMZqZ4,SpATywNh6bZuzm8s1ceuBUnMUAeoAHHw,16,11,4,19,3,1,6,1,45,6.428571428571429,1,0.0,6,4,17,3,5,1,2,6,1,30,15,1
20852,191845,HL02PKMnOIDdiDp79NgTxbZJpjcKEWWT,SpATywNh6bZuzm8s1ceuBUnMUAeoAHHw,5,5,1,0,1,0,1,0,8,1.1428571428571428,1,0.0,0,1,0,1,5,0,0,1,0,2,6,1
20853,191893,F90BMBHCwVLSbJKgbHhGlOavE20yEHNs,SpATywNh6bZuzm8s1ceuBUnMUAeoAHHw,7,1,1,0,1,1,4,1,9,1.2857142857142858,1,0.0,0,1,0,1,1,1,0,4,1,2,7,1
20854,191919,eh0y0gctBGer07yOzwET1ULsjXcAMiHK,A3fsA9Zfv1X2fVEQhTw51lKENdNrEqT3,1,0,0,0,0,0,1,0,1,0.14285714285714285,1,0.0,0,0,0,0,0,0,0,1,0,0,1,1
20855,191927,e7i4vctFK9ije7n1OkadHlIYbLm8AOao,A3fsA9Zfv1X2fVEQhTw51lKENdNrEqT3,1,0,0,0,0,0,1,0,1,0.14285714285714285,1,0.0,0,0,0,0,0,0,0,1,0,0,1,1
20856,191930,Y0uNzgYoq3o4UIUWA7DyI9uIWevNL2UZ,SpATywNh6bZuzm8s1ceuBUnMUAeoAHHw,1,0,0,0,0,0,1,0,1,0.14285714285714285,1,0.0,0,0,0,0,0,0,0,1,0,0,1,1
20857,191936,pVHJZ63Y7JdfMuJUTvroL7qbSGOfkgFO,SpATywNh6bZuzm8s1ceuBUnMUAeoAHHw,1,0,0,0,0,0,1,0,1,0.14285714285714285,1,0.0,0,0,0,0,0,0,0,1,0,0,1,1
20858,191946,X14gKVD1ZKu0qL0NchpqxwhoYSEpz9QI,A3fsA9Zfv1X2fVEQhTw51lKENdNrEqT3,1,0,0,0,0,0,1,0,1,0.14285714285714285,1,0.0,0,0,0,0,0,0,0,1,0,0,1,1
20859,191949,5nY7bkwDkC2HlVFlWmyBFJRNx9a0SeRf,SpATywNh6bZuzm8s1ceuBUnMUAeoAHHw,6,6,2,0,1,0,2,0,11,1.5714285714285714,1,0.0,2,2,0,1,4,0,0,2,0,5,6,1
20860,191957,q8qv4J0WokPksYuUIg2pKKJs5I4YE8LL,bWdj2GDclj5ofokWjzoa5jAwMkxCykd6,7,5,3,0,1,0,4,0,13,1.8571428571428572,1,0.0,0,3,0,1,5,0,0,4,0,4,9,1
20861,191961,XirdNKPxR3QK6AqsS5xwiQuah55CHklz,SpATywNh6bZuzm8s1ceuBUnMUAeoAHHw,6,4,1,0,1,0,2,0,8,1.1428571428571428,1,0.0,0,1,0,1,4,0,0,2,0,2,6,1
20862,191970,guhTAC2wGHeGVbnCgc8qjrM4m2j0yBgB,bWdj2GDclj5ofokWjzoa5jAwMkxCykd6,7,5,2,0,3,0,3,0,13,1.8571428571428572,1,0.0,2,2,0,3,3,0,0,3,0,7,6,1
20863,191977,ECkqmAuIkv3ncN9wNJby8oOn15qTd9kR,SpATywNh6bZuzm8s1ceuBUnMUAeoAHHw,3,2,0,0,0,0,4,0,6,0.8571428571428571,2,0.0,0,0,0,0,2,0,0,4,0,0,6,1
20864,191981,1kpLB0DAS1b0ejanJYSedd5z8Kef2r9d,SpATywNh6bZuzm8s1ceuBUnMUAeoAHHw,6,5,3,0,2,0,3,0,13,1.8571428571428572,2,0.0,0,3,0,2,5,0,0,3,0,5,8,1
20865,191987,guhTAC2wGHeGVbnCgc8qjrM4m2j0yBgB,A3fsA9Zfv1X2fVEQhTw51lKENdNrEqT3,20,11,8,0,5,2,8,1,35,5.0,2,0.0,0,8,0,5,11,2,0,8,1,13,22,0
20866,191992,LW6zzfd6Z7RUZZtZGyYDx5y4SX3cBpdo,SpATywNh6bZuzm8s1ceuBUnMUAeoAHHw,4,6,0,0,0,0,3,0,9,1.2857142857142858,1,0.0,0,0,0,0,6,0,0,3,0,0,9,1
20867,192004,E3N8Ml469xlgFPJmAY5Sxe1V7qT3zvY6,SpATywNh6bZuzm8s1ceuBUnMUAeoAHHw,5,2,1,0,1,0,2,0,6,0.8571428571428571,1,0.0,0,1,0,1,2,0,0,2,0,2,4,1
20868,192005,co2tEDTUQOPBlFecfyW4CBakQdUodp0x,A3fsA9Zfv1X2fVEQhTw51lKENdNrEqT3,1,0,0,0,0,0,1,0,1,0.14285714285714285,1,0.0,0,0,0,0,0,0,0,1,0,0,1,1
20869,192010,tAelht5FQdpcbtZQoKgvZA90XQy6zeRb,SpATywNh6bZuzm8s1ceuBUnMUAeoAHHw,1,0,0,0,0,0,1,0,1,0.14285714285714285,1,0.0,0,0,0,0,0,0,0,1,0,0,1,1
20870,192012,br6ITMcvmAAwree2VNmUR9deXubPoM9q,G8EPVSXsOYB5YQWZGiz1aVq5Pgr2GrQu,3,0,0,0,0,0,3,0,3,0.42857142857142855,1,0.0,0,0,0,0,0,0,0,3,0,0,3,1
20871,192018,eotRm6Y2SbyKhVlLkGLDzSxdsKqSBO9y,SpATywNh6bZuzm8s1ceuBUnMUAeoAHHw,6,3,2,0,2,0,1,0,8,1.1428571428571428,1,0.0,0,2,0,2,3,0,0,1,0,4,4,1
20872,192024,Q12SmIgxAUIk1yKqjdfp0LXtJMgJdL9G,SpATywNh6bZuzm8s1ceuBUnMUAeoAHHw,6,3,2,0,2,0,1,0,8,1.1428571428571428,1,0.0,0,2,0,2,3,0,0,1,0,4,4,1
20873,192034,6BEGVp3lU36uMYUemMIuUfA5VThOFY5Z,SpATywNh6bZuzm8s1ceuBUnMUAeoAHHw,3,2,0,0,0,0,1,0,3,0.42857142857142855,1,0.0,0,0,0,0,2,0,0,1,0,0,3,0
20874,192039,JuuQdyakOE1dmJoAhQzVgyBgj45A1hjb,G8EPVSXsOYB5YQWZGiz1aVq5Pgr2GrQu,6,2,1,0,1,0,3,0,7,1.0,1,0.0,0,1,0,1,2,0,0,3,0,2,5,1
20875,192050,dQYdXrn6Y9f5Ts4mUHKMqkz2QoUbyo9u,SpATywNh6bZuzm8s1ceuBUnMUAeoAHHw,10,16,7,0,0,1,6,1,31,4.428571428571429,1,0.0,6,7,0,0,10,1,0,6,1,13,18,1
20876,192058,rv4ArbR8ug8w4z8sISrvrxALsLkp46Ty,bWdj2GDclj5ofokWjzoa5jAwMkxCykd6,6,23,0,0,0,0,5,0,28,4.0,1,0.0,4,0,0,0,19,0,0,5,0,4,24,1
20877,192065,FaNPo4Qqcy5TdmFUv8WUTRgDMV0ZgbCp,RXDvfPUBYFlVdlueBFbLW0mhhAyGEqpt,19,10,7,22,5,0,2,0,46,6.571428571428571,1,0.0,2,7,20,5,8,0,2,2,0,34,12,1
20878,192091,dmhkL35doRyRiXlb3XuDnJlpO05GLvg1,SpATywNh6bZuzm8s1ceuBUnMUAeoAHHw,4,3,1,0,1,0,2,0,7,1.0,1,0.0,0,1,0,1,3,0,0,2,0,2,5,1
20879,192098,LTXDIL613XcTInp5rf7qYUY6DFOgTe7d,G8EPVSXsOYB5YQWZGiz1aVq5Pgr2GrQu,6,4,1,0,2,0,7,0,14,2.0,1,0.0,2,1,0,2,2,0,0,7,0,5,9,0
20880,192109,BlzehVS9w06tJmaZKz9FlNz9VFUjaNUH,G8EPVSXsOYB5YQWZGiz1aVq5Pgr2GrQu,5,2,0,0,0,0,3,0,5,0.7142857142857143,1,0.0,0,0,0,0,2,0,0,3,0,0,5,1
20881,192117,TiNNJ9dGwnc8LtrTW4Oq8UzJGxXCWpRS,A3fsA9Zfv1X2fVEQhTw51lKENdNrEqT3,1,0,0,0,0,0,1,0,1,0.14285714285714285,1,0.0,0,0,0,0,0,0,0,1,0,0,1,1
20882,192125,PhoKgDlJTLmZpXJ7XlrprWN3ANMNNAAs,SpATywNh6bZuzm8s1ceuBUnMUAeoAHHw,7,3,1,0,1,0,5,0,10,1.4285714285714286,1,0.0,0,1,0,1,3,0,0,5,0,2,8,1
20883,192134,vsDIa2pTzMsANsuFnkRlfs0CNdNFRShO,bWdj2GDclj5ofokWjzoa5jAwMkxCykd6,1,0,0,0,0,0,1,0,1,0.14285714285714285,1,0.0,0,0,0,0,0,0,0,1,0,0,1,1
20884,192141,vsDIa2pTzMsANsuFnkRlfs0CNdNFRShO,RXDvfPUBYFlVdlueBFbLW0mhhAyGEqpt,1,0,0,0,0,0,1,0,1,0.14285714285714285,1,0.0,0,0,0,0,0,0,0,1,0,0,1,1
20885,192147,luNGlNTmJ26UVXohAPNf4yZNgIUDcpxK,RXDvfPUBYFlVdlueBFbLW0mhhAyGEqpt,1,0,0,0,0,0,1,0,1,0.14285714285714285,1,0.0,0,0,0,0,0,0,0,1,0,0,1,1
20886,192149,kz806LJqSjCWsOsMbb4QF8SkTWd8OARr,bWdj2GDclj5ofokWjzoa5jAwMkxCykd6,5,2,0,0,0,0,9,0,11,1.5714285714285714,1,0.0,0,0,0,0,2,0,0,9,0,0,11,1
20887,192150,luNGlNTmJ26UVXohAPNf4yZNgIUDcpxK,A3fsA9Zfv1X2fVEQhTw51lKENdNrEqT3,1,0,0,0,0,0,1,0,1,0.14285714285714285,1,0.0,0,0,0,0,0,0,0,1,0,0,1,1
20888,192176,UAWEvfipqNVrtAY7A1ItWPIZCE9n4bC0,A3fsA9Zfv1X2fVEQhTw51lKENdNrEqT3,1,0,0,0,0,0,1,0,1,0.14285714285714285,1,0.0,0,0,0,0,0,0,0,1,0,0,1,1
20889,192185,REBUdT3PdwenVsbHSd8vx9j28veewpFY,G8EPVSXsOYB5YQWZGiz1aVq5Pgr2GrQu,1,0,0,0,0,0,3,0,3,0.42857142857142855,1,0.0,0,0,0,0,0,0,0,3,0,0,3,1
20890,192186,JQ24AQoZsOQkDbcWerb6XGxtCwcxcjqd,SpATywNh6bZuzm8s1ceuBUnMUAeoAHHw,4,2,0,0,0,0,2,0,4,0.5714285714285714,1,0.0,0,0,0,0,2,0,0,2,0,0,4,1
20891,192194,lHTZAvBbd0zcUoZ0ZCqy0WxYTp3sveXN,SpATywNh6bZuzm8s1ceuBUnMUAeoAHHw,3,2,0,0,0,0,1,0,3,0.42857142857142855,1,0.0,0,0,0,0,2,0,0,1,0,0,3,1
20892,192209,Qws7jSORIWaamW2WkksSfXYG3Zz7g3Xb,SpATywNh6bZuzm8s1ceuBUnMUAeoAHHw,5,2,1,0,1,0,3,0,7,1.0,1,0.0,0,1,0,1,2,0,0,3,0,2,5,1
20893,192216,WqVnvIDeqK0FV6SVy7LE13jQheJAXDUI,SpATywNh6bZuzm8s1ceuBUnMUAeoAHHw,6,3,0,0,1,0,2,0,6,0.8571428571428571,1,0.0,0,0,0,1,3,0,0,2,0,1,5,1
20894,192217,AcQwcLzGnWU6HJG1JegBGJmpymCdTsiJ,SpATywNh6bZuzm8s1ceuBUnMUAeoAHHw,1,0,0,0,0,0,1,0,1,0.14285714285714285,1,0.0,0,0,0,0,0,0,0,1,0,0,1,1
20895,192223,DtCbpRVw6ZPHzvqt3yEtockBy9bOvWMU,SpATywNh6bZuzm8s1ceuBUnMUAeoAHHw,15,31,9,18,5,0,3,0,66,9.428571428571429,1,0.0,13,9,16,5,18,0,2,3,0,43,23,1
20896,192225,RFIYCucE5KCs9Bz4puoVDGPVmKoCQR4H,SpATywNh6bZuzm8s1ceuBUnMUAeoAHHw,1,0,0,0,0,0,1,0,1,0.14285714285714285,1,0.0,0,0,0,0,0,0,0,1,0,0,1,1
20897,192230,SMcFR1tzrGAErGanrAOTaiQacFJ5UscL,SpATywNh6bZuzm8s1ceuBUnMUAeoAHHw,6,2,1,0,1,0,3,1,8,1.1428571428571428,1,0.0,0,1,0,1,2,0,0,3,1,2,6,1
20898,192233,Av0so8JeZkL37S3USay6JyAc2H9w3WcS,SpATywNh6bZuzm8s1ceuBUnMUAeoAHHw,8,8,1,0,1,0,2,0,12,1.7142857142857142,1,0.0,1,1,0,1,7,0,0,2,0,3,9,1
20899,192236,4WRiJt7yDLRdAnLXyL07imUb9PD066er,SpATywNh6bZuzm8s1ceuBUnMUAeoAHHw,7,1,1,0,1,1,9,3,16,2.2857142857142856,2,0.0,0,1,0,1,1,1,0,9,3,2,14,1
20900,192247,HR02YAHzGFr2hdShoIiTumT2tyoMXoiF,SpATywNh6bZuzm8s1ceuBUnMUAeoAHHw,7,5,0,0,0,0,5,1,11,1.5714285714285714,2,0.0,0,0,0,0,5,0,0,5,1,0,11,1
20901,192248,Qb1CgQ8SxoQQTE8swhxPBVi0nI23eAzb,bWdj2GDclj5ofokWjzoa5jAwMkxCykd6,11,21,9,16,6,1,6,1,60,8.571428571428571,2,0.0,3,9,16,6,18,1,0,6,1,34,26,1
20902,192253,HTVs7V0e4g4fF28WOVqp2vXklALtMpIX,RXDvfPUBYFlVdlueBFbLW0mhhAyGEqpt,1,0,0,0,0,0,1,0,1,0.14285714285714285,1,0.0,0,0,0,0,0,0,0,1,0,0,1,1
20903,192265,NE6VVAXhm16C7ZaHLYFeGaAbJXqSbS5P,SpATywNh6bZuzm8s1ceuBUnMUAeoAHHw,1,0,0,0,0,0,1,0,1,0.14285714285714285,1,0.0,0,0,0,0,0,0,0,1,0,0,1,1
20904,192272,AE77uBYkDOA4olq3PELAlnphtU2v0TDL,A3fsA9Zfv1X2fVEQhTw51lKENdNrEqT3,1,0,0,0,0,0,1,0,1,0.14285714285714285,1,0.0,0,0,0,0,0,0,0,1,0,0,1,1
20905,192281,oOq0KGCcuj3zSTyAkLmOA3bz1mpT4Cy2,SpATywNh6bZuzm8s1ceuBUnMUAeoAHHw,1,0,0,0,0,0,1,0,1,0.14285714285714285,1,0.0,0,0,0,0,0,0,0,1,0,0,1,1
20906,192285,DanoP5XpHODQZmwuFGZgNKBiu5nY9yH1,RXDvfPUBYFlVdlueBFbLW0mhhAyGEqpt,6,5,4,0,2,0,1,0,12,1.7142857142857142,1,0.0,0,4,0,2,5,0,0,1,0,6,6,1
20907,192293,k0fNZidBUd2gbryk31YveUTLLwvsjsHF,A3fsA9Zfv1X2fVEQhTw51lKENdNrEqT3,1,0,0,0,0,0,1,0,1,0.14285714285714285,1,0.0,0,0,0,0,0,0,0,1,0,0,1,1
20908,192300,4YD7ENfnhFTRFL7ILKgGgEPnhlw4hbFM,SpATywNh6bZuzm8s1ceuBUnMUAeoAHHw,6,3,1,0,1,0,2,0,7,1.0,1,0.0,0,1,0,1,3,0,0,2,0,2,5,1
20909,192306,ypGCuSMoTu4jFEklb1OmiXvUyZSt3GFy,A3fsA9Zfv1X2fVEQhTw51lKENdNrEqT3,1,0,0,0,0,0,1,0,1,0.14285714285714285,1,0.0,0,0,0,0,0,0,0,1,0,0,1,1
20910,192308,5Vw6FQuIrDyG4P6UKq7rbidOHP4recgB,SpATywNh6bZuzm8s1ceuBUnMUAeoAHHw,1,0,0,0,0,0,1,0,1,0.14285714285714285,1,0.0,0,0,0,0,0,0,0,1,0,0,1,1
20911,192310,pr4S9UwIGe9A49oNuW5UlWpQYB2ZSYV0,SpATywNh6bZuzm8s1ceuBUnMUAeoAHHw,2,0,0,0,0,0,2,0,2,0.2857142857142857,1,0.0,0,0,0,0,0,0,0,2,0,0,2,1
20912,192329,SgmklvgEB9LRwbyM7mjtFwPn2s1gjHGn,A3fsA9Zfv1X2fVEQhTw51lKENdNrEqT3,1,0,0,0,0,0,1,0,1,0.14285714285714285,1,0.0,0,0,0,0,0,0,0,1,0,0,1,1
20913,192356,3T8jD055VA7hJ3tuRSbjf4ntse0zAX7A,bWdj2GDclj5ofokWjzoa5jAwMkxCykd6,8,15,4,0,2,1,8,1,31,4.428571428571429,1,0.0,6,4,0,2,9,1,0,8,1,12,19,1
20914,192365,ooAUGXFOFAguQ9s1QlStBjM610gDeFBk,bWdj2GDclj5ofokWjzoa5jAwMkxCykd6,8,7,4,0,3,0,3,0,17,2.4285714285714284,1,0.0,0,4,0,3,7,0,0,3,0,7,10,1
20915,192376,JuG3mNYUQgxAVzPcc7Ar48FfL6xAPMUZ,SpATywNh6bZuzm8s1ceuBUnMUAeoAHHw,6,6,1,0,1,0,2,0,10,1.4285714285714286,1,0.0,3,1,0,1,3,0,0,2,0,5,5,1
20916,192381,cfgt4lcsD0BLDwVvHK3CK5jqeK8KZQhZ,SpATywNh6bZuzm8s1ceuBUnMUAeoAHHw,8,2,1,0,1,2,5,2,13,1.8571428571428572,1,0.0,0,1,0,1,2,2,0,5,2,2,11,1
20917,192384,eGRaiLXqwboqQlaTTQYr1FB1cM61jV4I,RXDvfPUBYFlVdlueBFbLW0mhhAyGEqpt,2,0,0,0,0,0,2,0,2,0.2857142857142857,1,0.0,0,0,0,0,0,0,0,2,0,0,2,1
20918,192402,waC8kf8PXJ6GslXvkly6fK7T4isyWaN7,bWdj2GDclj5ofokWjzoa5jAwMkxCykd6,11,6,4,0,3,3,8,1,25,3.5714285714285716,2,0.0,0,4,0,3,6,3,0,8,1,7,18,1
20919,192404,FmxPauZCcN5TsI90By7Uh5tN8Q2Qo10j,A3fsA9Zfv1X2fVEQhTw51lKENdNrEqT3,1,0,0,0,0,0,2,0,2,0.2857142857142857,1,0.0,0,0,0,0,0,0,0,2,0,0,2,1
20920,192407,RVzC5vQBqN30AW6Su7sjAfdP0iWczm3N,G8EPVSXsOYB5YQWZGiz1aVq5Pgr2GrQu,13,8,5,0,3,0,9,0,25,3.5714285714285716,1,0.0,0,5,0,3,8,0,0,9,0,8,17,1
20921,192413,1StpqFExawTnYrEXKci6A5cFxEzx53P4,RXDvfPUBYFlVdlueBFbLW0mhhAyGEqpt,3,3,1,0,0,0,1,0,5,0.7142857142857143,1,0.0,0,1,0,0,3,0,0,1,0,1,4,1
20922,192425,GyLB5V57I2KbnfFgZclSqyQAUY6eRpjt,bWdj2GDclj5ofokWjzoa5jAwMkxCykd6,1,0,0,0,0,0,1,0,1,0.14285714285714285,1,0.0,0,0,0,0,0,0,0,1,0,0,1,1
20923,192426,o4zmJwxCaOlZRS6sjq7iHLRJ7DThOMe1,G8EPVSXsOYB5YQWZGiz1aVq5Pgr2GrQu,7,5,1,0,1,0,2,0,9,1.2857142857142858,1,0.0,0,1,0,1,5,0,0,2,0,2,7,1
20924,192431,OZzcwN4ObB1Nk33MS2zCa76PywvXNHRC,SpATywNh6bZuzm8s1ceuBUnMUAeoAHHw,5,5,1,0,1,0,1,0,8,1.1428571428571428,1,0.0,0,1,0,1,5,0,0,1,0,2,6,1
20925,192434,c1BXmJNemroOPh6WUefTBD28s2WzSNwi,G8EPVSXsOYB5YQWZGiz1aVq5Pgr2GrQu,1,0,0,0,0,0,1,0,1,0.14285714285714285,1,0.0,0,0,0,0,0,0,0,1,0,0,1,1
20926,192441,s1qTQc7ciJLP829kxDx1Q2usdHCCY2Ax,SpATywNh6bZuzm8s1ceuBUnMUAeoAHHw,2,0,0,0,0,0,2,0,2,0.2857142857142857,1,0.0,0,0,0,0,0,0,0,2,0,0,2,1
20927,192449,IihMsyE33bR2W1CinvLERaFEike0N1tI,SpATywNh6bZuzm8s1ceuBUnMUAeoAHHw,1,0,0,0,0,0,1,0,1,0.14285714285714285,1,0.0,0,0,0,0,0,0,0,1,0,0,1,1
20928,192450,fm4PPCUPLg6L0eK2GymW6alb9TJFqvnn,SpATywNh6bZuzm8s1ceuBUnMUAeoAHHw,1,0,0,0,0,0,1,0,1,0.14285714285714285,1,0.0,0,0,0,0,0,0,0,1,0,0,1,1
20929,192464,FnLRbhWfyqv6yBzd4jhbaUJyw3LJoL3p,SpATywNh6bZuzm8s1ceuBUnMUAeoAHHw,1,0,0,0,0,0,1,0,1,0.14285714285714285,1,0.0,0,0,0,0,0,0,0,1,0,0,1,0
20930,192468,XKJKqrTlrk5aKXeVOrE6ycEvLm3u912L,SpATywNh6bZuzm8s1ceuBUnMUAeoAHHw,1,0,0,0,0,0,1,0,1,0.14285714285714285,1,0.0,0,0,0,0,0,0,0,1,0,0,1,1
20931,192471,D2lFXeOodglgSTRNVccRvVrNvHlYgfLJ,SpATywNh6bZuzm8s1ceuBUnMUAeoAHHw,1,0,0,0,0,0,1,0,1,0.14285714285714285,1,0.0,0,0,0,0,0,0,0,1,0,0,1,1
20932,192474,cRUmHDnCm3xvppfYUcJkwRqBBl5OBCgi,SpATywNh6bZuzm8s1ceuBUnMUAeoAHHw,1,0,0,0,0,0,1,0,1,0.14285714285714285,1,0.0,0,0,0,0,0,0,0,1,0,0,1,1
20933,192608,AtRokE4GDbrwUzcYfXIbPzAJVRCFfH2F,5Gyp41oLVo7Gg7vF4vpmggWP5MU70QO6,6,1,0,0,0,0,4,1,6,0.8571428571428571,1,0.0,0,0,0,0,1,0,0,4,1,0,6,1
20934,192611,hR3J4g4CWV0kw2ppP2PV2tproNTGcv00,5Gyp41oLVo7Gg7vF4vpmggWP5MU70QO6,1,0,0,0,0,0,1,0,1,0.14285714285714285,1,0.0,0,0,0,0,0,0,0,1,0,0,1,1
20935,192618,Hdpd6bzDCatISjYMgNGeGrNyuK5a6mdg,5Gyp41oLVo7Gg7vF4vpmggWP5MU70QO6,15,8,5,0,4,3,9,1,30,4.285714285714286,1,0.0,0,5,0,4,8,3,0,9,1,9,21,1
20936,192621,6rn8acWWEVJB1wj5sL8CHB7CjvoRuE9n,5Gyp41oLVo7Gg7vF4vpmggWP5MU70QO6,8,3,2,0,2,0,5,1,13,1.8571428571428572,1,0.0,0,2,0,2,3,0,0,5,1,4,9,0
20937,192635,QqE2Xjwy9gUzOvFdkDqAwAaNZLBZkxvd,5Gyp41oLVo7Gg7vF4vpmggWP5MU70QO6,9,5,4,2,1,0,3,0,15,2.142857142857143,1,0.0,0,4,1,1,5,0,1,3,0,6,9,0
20938,192653,WWuaVOQg6HhBy3ZFrwNxYOemRizkw0Iz,5Gyp41oLVo7Gg7vF4vpmggWP5MU70QO6,1,0,0,0,0,0,1,0,1,0.14285714285714285,1,0.0,0,0,0,0,0,0,0,1,0,0,1,1
20939,192669,yD8ecTJ7efEF8WUp9kS25bxSOmV2HnI4,5Gyp41oLVo7Gg7vF4vpmggWP5MU70QO6,6,4,2,0,1,0,3,0,10,1.4285714285714286,2,0.0,0,2,0,1,4,0,0,3,0,3,7,1
20940,192672,TM2Fpf08RSPSZPzEL6NnBreog7ZJPXLB,5Gyp41oLVo7Gg7vF4vpmggWP5MU70QO6,1,0,0,0,0,0,1,0,1,0.14285714285714285,1,0.0,0,0,0,0,0,0,0,1,0,0,1,1
20941,192685,qKfZusm0R8jxltESvgi15dswdw73Gjlp,5Gyp41oLVo7Gg7vF4vpmggWP5MU70QO6,5,2,0,0,0,0,6,0,8,1.1428571428571428,1,0.0,0,0,0,0,2,0,0,6,0,0,8,1
20942,192687,BaBxjEn3TWZ4ftqH98jukKacUK8Z3SVk,5Gyp41oLVo7Gg7vF4vpmggWP5MU70QO6,15,9,7,4,5,0,4,1,30,4.285714285714286,1,0.0,1,7,2,5,8,0,2,4,1,15,15,0
20943,192689,H0MJ7AKLplt2875eLTSZVcXjiXyvHgre,5Gyp41oLVo7Gg7vF4vpmggWP5MU70QO6,7,3,2,0,2,0,2,0,9,1.2857142857142858,1,0.0,0,2,0,2,3,0,0,2,0,4,5,1
20944,192698,dpqC9YadgyW7gCDeIWoSIw8EG62mjzEg,5Gyp41oLVo7Gg7vF4vpmggWP5MU70QO6,10,14,6,4,3,1,2,0,30,4.285714285714286,1,0.0,5,6,2,3,9,1,2,2,0,16,14,1
20945,192700,8cEAUyffHekiZonoKVizh2shGTTIPP8A,5Gyp41oLVo7Gg7vF4vpmggWP5MU70QO6,5,2,1,0,1,0,2,0,6,0.8571428571428571,1,0.0,0,1,0,1,2,0,0,2,0,2,4,1
20946,192703,5h0eNQUncseSZepOFk4gJvoXA1BGcdoJ,5Gyp41oLVo7Gg7vF4vpmggWP5MU70QO6,1,0,0,0,0,0,1,0,1,0.14285714285714285,1,0.0,0,0,0,0,0,0,0,1,0,0,1,1
20947,192705,dxoTIhhPXBvqzWGLltH0slJdxsuyggjI,5Gyp41oLVo7Gg7vF4vpmggWP5MU70QO6,12,5,4,0,3,1,7,1,21,3.0,1,0.0,0,4,0,3,5,1,0,7,1,7,14,1
20948,192712,Smn1MChtzRnNQ2E4yTX9A4LeqmiYYAht,5Gyp41oLVo7Gg7vF4vpmggWP5MU70QO6,13,20,12,0,4,3,2,0,41,5.857142857142857,2,0.0,3,12,0,4,17,3,0,2,0,19,22,0
20949,192728,2Jf50aD58DLzicIOj7SRGccbiA42og4q,5Gyp41oLVo7Gg7vF4vpmggWP5MU70QO6,1,0,0,0,0,0,1,0,1,0.14285714285714285,1,0.0,0,0,0,0,0,0,0,1,0,0,1,1
20950,192735,YdnCtrLP9GUJwqLsBYf5xSwhPg8uPY72,5Gyp41oLVo7Gg7vF4vpmggWP5MU70QO6,2,0,0,0,0,0,2,0,2,0.2857142857142857,1,0.0,0,0,0,0,0,0,0,2,0,0,2,1
20951,192739,a1GIHlsXZFLe52epzSYGPqZ9rbdKGCBc,5Gyp41oLVo7Gg7vF4vpmggWP5MU70QO6,1,0,0,0,0,0,1,0,1,0.14285714285714285,1,0.0,0,0,0,0,0,0,0,1,0,0,1,1
20952,192743,uPHW5wVLJNc5tDPULVOENFWqjj5oTiX0,5Gyp41oLVo7Gg7vF4vpmggWP5MU70QO6,7,3,2,0,2,0,2,0,9,1.2857142857142858,1,0.0,0,2,0,2,3,0,0,2,0,4,5,1
20953,192745,PFladZHBxKsed81P3VF9JVKRBqF9WnYc,5Gyp41oLVo7Gg7vF4vpmggWP5MU70QO6,4,2,1,0,1,0,1,0,5,0.7142857142857143,1,0.0,0,1,0,1,2,0,0,1,0,2,3,1
20954,192758,mSuKGDVu6gs94ljVjWxUojLXXzI5hNOJ,5Gyp41oLVo7Gg7vF4vpmggWP5MU70QO6,27,24,12,13,7,0,3,0,59,8.428571428571429,2,0.0,8,12,8,7,16,0,5,3,0,35,24,1
20955,192759,Lea0U9bXVEWulrpNxb4hDrvkTD6jg3Lj,5Gyp41oLVo7Gg7vF4vpmggWP5MU70QO6,1,0,0,0,0,0,1,0,1,0.14285714285714285,1,0.0,0,0,0,0,0,0,0,1,0,0,1,1
20956,192760,j2usIry8ZvUv4bPkmxlIEr6D1gomHwky,5Gyp41oLVo7Gg7vF4vpmggWP5MU70QO6,9,3,3,0,2,0,4,0,12,1.7142857142857142,1,0.0,0,3,0,2,3,0,0,4,0,5,7,1
20957,192767,XyCz9sIvXJKdwW6DgXAsYNle3ywHbak8,5Gyp41oLVo7Gg7vF4vpmggWP5MU70QO6,7,5,3,0,3,2,2,0,15,2.142857142857143,1,0.0,0,3,0,3,5,2,0,2,0,6,9,1
20958,192773,GkPLpUCCpkc2alGCrZy2giSAHb58J7uB,5Gyp41oLVo7Gg7vF4vpmggWP5MU70QO6,1,0,0,0,0,0,1,0,1,0.14285714285714285,1,0.0,0,0,0,0,0,0,0,1,0,0,1,1
20959,192778,gfBqAJTwMxnGPgiW2oi2HY9LjOcodQEb,5Gyp41oLVo7Gg7vF4vpmggWP5MU70QO6,9,10,3,2,1,0,4,0,20,2.857142857142857,2,0.0,3,3,1,1,7,0,1,4,0,8,12,1
20960,192789,XK5ibrlt4r927TMtcgDDQkno4bFkmpOe,5Gyp41oLVo7Gg7vF4vpmggWP5MU70QO6,8,4,3,0,2,0,3,0,12,1.7142857142857142,1,0.0,0,3,0,2,4,0,0,3,0,5,7,1
20961,192801,VoCeELY2B10ZxPnycmfwdy7Iipalm81O,5Gyp41oLVo7Gg7vF4vpmggWP5MU70QO6,31,64,35,14,20,4,6,2,145,20.714285714285715,2,0.0,20,35,7,20,44,4,7,6,2,82,63,1
20962,192809,TDZqTAe3O03535EQlgLT4WJkveLsaPmx,5Gyp41oLVo7Gg7vF4vpmggWP5MU70QO6,1,0,0,0,0,0,1,0,1,0.14285714285714285,1,0.0,0,0,0,0,0,0,0,1,0,0,1,1
20963,192813,uk7zjDjpWmKoLR9S44KNj1ZRmbxgLrs3,5Gyp41oLVo7Gg7vF4vpmggWP5MU70QO6,1,0,0,0,0,0,1,0,1,0.14285714285714285,1,0.0,0,0,0,0,0,0,0,1,0,0,1,1
20964,192819,bGF8cbH8BJ9hFpv4F5nJ920V3rhyfd17,5Gyp41oLVo7Gg7vF4vpmggWP5MU70QO6,1,0,0,0,0,0,1,0,1,0.14285714285714285,1,0.0,0,0,0,0,0,0,0,1,0,0,1,1
20965,192827,k3mZz4gOE5kxngWJdlg5ZkSuFCPjQxmM,5Gyp41oLVo7Gg7vF4vpmggWP5MU70QO6,7,3,2,0,1,1,3,0,10,1.4285714285714286,1,0.0,1,2,0,1,2,1,0,3,0,4,6,1
20966,192841,R1hDC0cia7W4HzRH6KVPETOXYR9pY6fa,5Gyp41oLVo7Gg7vF4vpmggWP5MU70QO6,15,12,6,4,2,1,6,1,32,4.571428571428571,1,0.0,5,6,2,2,7,1,2,6,1,15,17,1
20967,192847,r9GPeMSp8ArkFnDWYZc9RWiHGAvx3pnQ,5Gyp41oLVo7Gg7vF4vpmggWP5MU70QO6,8,4,2,0,2,0,2,0,10,1.4285714285714286,1,0.0,0,2,0,2,4,0,0,2,0,4,6,1
20968,192860,pOasjcwsDcPzSLMZe3AyFjlAlgIAU2Vb,5Gyp41oLVo7Gg7vF4vpmggWP5MU70QO6,7,3,2,0,2,0,2,0,9,1.2857142857142858,1,0.0,0,2,0,2,3,0,0,2,0,4,5,1
20969,192861,f3sQizxMrZs3wFlm48Xbvnvm8a8gj3sD,5Gyp41oLVo7Gg7vF4vpmggWP5MU70QO6,1,0,0,0,0,0,1,0,1,0.14285714285714285,1,0.0,0,0,0,0,0,0,0,1,0,0,1,1
20970,192908,yiOczBli0rC8Wbolg7ti038mY6lEjUw2,5Gyp41oLVo7Gg7vF4vpmggWP5MU70QO6,7,2,1,0,1,0,5,0,9,1.2857142857142858,1,0.0,0,1,0,1,2,0,0,5,0,2,7,1
20971,192914,WTBW2I80UCafy13vO1xmvJy7d87UvlCP,5Gyp41oLVo7Gg7vF4vpmggWP5MU70QO6,13,11,7,0,4,0,10,0,32,4.571428571428571,1,0.0,0,7,0,4,11,0,0,10,0,11,21,1
20972,192915,YNemkS5dqknHOwehYprPYVkMaqYUO4yA,5Gyp41oLVo7Gg7vF4vpmggWP5MU70QO6,2,0,0,0,0,0,2,0,2,0.2857142857142857,1,0.0,0,0,0,0,0,0,0,2,0,0,2,1
20973,192928,0w8w9MF5tkQU4k0FklIWTLSzbCs1BbZq,5Gyp41oLVo7Gg7vF4vpmggWP5MU70QO6,6,3,1,0,1,2,2,0,9,1.2857142857142858,1,0.0,0,1,0,1,3,2,0,2,0,2,7,1
20974,192953,7lHUJOfOLogRPjLmWkj5y0cgqgu81QwU,5Gyp41oLVo7Gg7vF4vpmggWP5MU70QO6,5,2,0,0,1,0,2,0,5,0.7142857142857143,1,0.0,0,0,0,1,2,0,0,2,0,1,4,1
20975,192959,vcvYL1EZ3hhS8Gh2fPMFYiG1tqg8IKqj,5Gyp41oLVo7Gg7vF4vpmggWP5MU70QO6,10,4,3,0,3,0,7,1,18,2.5714285714285716,1,0.0,0,3,0,3,4,0,0,7,1,6,12,1
20976,192969,dtWMunkwGsNaaLF3lUUY2CJ5PD5WpamE,5Gyp41oLVo7Gg7vF4vpmggWP5MU70QO6,1,0,0,0,0,0,1,0,1,0.14285714285714285,1,0.0,0,0,0,0,0,0,0,1,0,0,1,1
20977,192974,UKBd2uWp6PbjrF0GpeV8V02oqrWC2EWf,5Gyp41oLVo7Gg7vF4vpmggWP5MU70QO6,1,0,0,0,0,0,1,0,1,0.14285714285714285,1,0.0,0,0,0,0,0,0,0,1,0,0,1,1
20978,192990,mpIXHW5sILjjHOwn1u3NkBPJs6lkxDFU,5Gyp41oLVo7Gg7vF4vpmggWP5MU70QO6,1,0,0,0,0,0,2,0,2,0.2857142857142857,1,0.0,0,0,0,0,0,0,0,2,0,0,2,1
20979,192992,1WyvYbGYcrBNj0UGmeuwJim5C3F4cN0m,5Gyp41oLVo7Gg7vF4vpmggWP5MU70QO6,1,0,0,0,0,0,1,0,1,0.14285714285714285,1,0.0,0,0,0,0,0,0,0,1,0,0,1,1
20980,192999,f3YcaJisiu4LNXF8c0nltyQqDOirQ4G3,5Gyp41oLVo7Gg7vF4vpmggWP5MU70QO6,1,0,0,0,0,0,1,0,1,0.14285714285714285,1,0.0,0,0,0,0,0,0,0,1,0,0,1,1
20981,193002,YPkNnlZCzgNSMkr7FjmvOjfpED2o7pKl,5Gyp41oLVo7Gg7vF4vpmggWP5MU70QO6,10,10,4,0,3,4,6,1,28,4.0,1,0.0,0,4,0,3,10,4,0,6,1,7,21,1
20982,193011,xMsPJWz0XQaXvtzEWSRadnhqGEGgxzXP,5Gyp41oLVo7Gg7vF4vpmggWP5MU70QO6,1,0,0,0,0,0,1,0,1,0.14285714285714285,1,0.0,0,0,0,0,0,0,0,1,0,0,1,1
20983,193019,zdzq2oGGblOk5DNSyuiTttgeRbYjL1G9,5Gyp41oLVo7Gg7vF4vpmggWP5MU70QO6,4,0,0,0,0,0,5,0,5,0.7142857142857143,1,0.0,0,0,0,0,0,0,0,5,0,0,5,1
20984,193394,7zYK7nycfEobBL6khQbiClw4A0srgSFs,7GRhBDsirIGkRZBtSMEzNTyDr2JQm4xx,4,4,1,0,0,0,2,0,7,1.0,1,0.0,0,1,0,0,4,0,0,2,0,1,6,1
20985,193399,4KdAT7M1VmdgpSbZAwhIRRtGiw5j0Hwv,7GRhBDsirIGkRZBtSMEzNTyDr2JQm4xx,9,4,3,0,3,0,2,0,12,1.7142857142857142,1,0.0,0,3,0,3,4,0,0,2,0,6,6,1
20986,193415,GAlVju2FoaeKDXk3BG43v2DrV3UNel1E,7GRhBDsirIGkRZBtSMEzNTyDr2JQm4xx,1,0,0,0,0,0,2,0,2,0.2857142857142857,1,0.0,0,0,0,0,0,0,0,2,0,0,2,1
20987,193417,C3Ny6KS3sMtxeuVMnHyYboSejjiB2Wof,7GRhBDsirIGkRZBtSMEzNTyDr2JQm4xx,2,0,0,0,0,0,3,0,3,0.42857142857142855,1,0.0,0,0,0,0,0,0,0,3,0,0,3,1
20988,193419,IKspHwTheoQBPhrwL8GRQAw1d4UBmXld,7GRhBDsirIGkRZBtSMEzNTyDr2JQm4xx,2,0,0,0,0,0,2,0,2,0.2857142857142857,1,0.0,0,0,0,0,0,0,0,2,0,0,2,0
20989,193430,6W0BpjkpO0dAMGUgwI3l3rChjx6l5wlj,7GRhBDsirIGkRZBtSMEzNTyDr2JQm4xx,1,0,0,0,0,0,1,0,1,0.14285714285714285,1,0.0,0,0,0,0,0,0,0,1,0,0,1,1
20990,193441,VARzQVmDzWyeZVMza6XcRnhR9idMVp9n,7GRhBDsirIGkRZBtSMEzNTyDr2JQm4xx,4,2,1,0,0,2,4,0,9,1.2857142857142858,1,0.0,0,1,0,0,2,2,0,4,0,1,8,1
20991,193458,YerAIqIks5QGT3cyYvkkT2PQJt80wdlv,bWdj2GDclj5ofokWjzoa5jAwMkxCykd6,3,2,0,0,0,0,1,0,3,0.42857142857142855,1,0.0,0,0,0,0,2,0,0,1,0,0,3,1
20992,193466,zoOHCo5ZSJYPyewUp3ZVEkAmNnY7HYHv,SpATywNh6bZuzm8s1ceuBUnMUAeoAHHw,8,5,3,0,3,0,3,0,14,2.0,1,0.0,0,3,0,3,5,0,0,3,0,6,8,1
20993,193468,5UJZmEar1AX3gQXOzkh3MnQcYdErI17M,5X6FeZozNMgE2VRi3MJYjkkFK8SETtu2,15,19,6,15,11,0,1,0,52,7.428571428571429,1,0.0,12,6,14,11,7,0,1,1,0,43,9,1
20994,193475,GmYDZTMhI5TgBC2IOLdvnmJEf5uX4LR3,bWdj2GDclj5ofokWjzoa5jAwMkxCykd6,14,15,9,0,8,0,5,0,37,5.285714285714286,1,0.0,2,9,0,8,13,0,0,5,0,19,18,1
20995,193480,13q6Q2ftAOPzmfv0eOg5HLLohXKvBJn0,G8EPVSXsOYB5YQWZGiz1aVq5Pgr2GrQu,39,32,17,90,5,0,6,0,150,21.428571428571427,1,0.0,1,17,74,5,31,0,16,6,0,97,53,1
20996,193491,eDVRcT3oA39R4stYZnLSVwEtXbMKHF03,SpATywNh6bZuzm8s1ceuBUnMUAeoAHHw,3,1,0,0,0,0,2,0,3,0.42857142857142855,1,0.0,0,0,0,0,1,0,0,2,0,0,3,0
20997,193492,bershY3L5dsrOquW1lgM7Vxvmeies3St,A3fsA9Zfv1X2fVEQhTw51lKENdNrEqT3,8,5,1,0,1,0,2,0,9,1.2857142857142858,1,0.0,0,1,0,1,5,0,0,2,0,2,7,1
20998,193493,SBtS69Ct6IHarcvlSoYZArZJi3eatyfh,bWdj2GDclj5ofokWjzoa5jAwMkxCykd6,1,0,0,0,0,0,1,0,1,0.14285714285714285,1,0.0,0,0,0,0,0,0,0,1,0,0,1,1
20999,193497,SBtS69Ct6IHarcvlSoYZArZJi3eatyfh,SpATywNh6bZuzm8s1ceuBUnMUAeoAHHw,1,0,0,0,0,0,1,0,1,0.14285714285714285,1,0.0,0,0,0,0,0,0,0,1,0,0,1,1
21000,193518,cqIrvI5GKO10bpbizT8U9PReNX8yRrno,G8EPVSXsOYB5YQWZGiz1aVq5Pgr2GrQu,19,15,7,34,5,0,6,0,67,9.571428571428571,1,0.0,8,7,31,5,7,0,3,6,0,51,16,1
21001,193519,wpXUynmsiSu4GN2ibkxsqCGp9o4mfy5I,5X6FeZozNMgE2VRi3MJYjkkFK8SETtu2,1,0,0,0,0,0,1,0,1,0.14285714285714285,1,0.0,0,0,0,0,0,0,0,1,0,0,1,1
21002,193542,YTHmQoXSzCJ72wYyD4eBzLYK257HXF0x,5X6FeZozNMgE2VRi3MJYjkkFK8SETtu2,1,0,0,0,0,0,1,0,1,0.14285714285714285,1,0.0,0,0,0,0,0,0,0,1,0,0,1,1
21003,193551,xwBZbOE6F0kqpjHJoYX4YfzqsGNvKWLp,A3fsA9Zfv1X2fVEQhTw51lKENdNrEqT3,2,0,0,0,0,0,2,0,2,0.2857142857142857,1,0.0,0,0,0,0,0,0,0,2,0,0,2,1
21004,193556,E5gNyf8gzkIFqEMMzFfX1babw0jRMtve,G8EPVSXsOYB5YQWZGiz1aVq5Pgr2GrQu,2,0,0,0,0,0,2,0,2,0.2857142857142857,1,0.0,0,0,0,0,0,0,0,2,0,0,2,1
21005,193606,0lEKKJq7wgGTJZ13dxv0HcjHfYwzJrxA,SpATywNh6bZuzm8s1ceuBUnMUAeoAHHw,1,0,0,0,0,0,1,0,1,0.14285714285714285,1,0.0,0,0,0,0,0,0,0,1,0,0,1,1
21006,193612,NpeRs7t4bBCf621U45j2j6LzoAMg7Erp,A3fsA9Zfv1X2fVEQhTw51lKENdNrEqT3,7,9,2,0,1,0,2,0,14,2.0,1,0.0,0,2,0,1,9,0,0,2,0,3,11,1
21007,193619,t7E1vZtGQbSSizV4xYOd5KHhRDOCUCjx,A3fsA9Zfv1X2fVEQhTw51lKENdNrEqT3,1,0,0,0,0,0,1,0,1,0.14285714285714285,1,0.0,0,0,0,0,0,0,0,1,0,0,1,1
21008,193633,zynLWMDwDGZGrMFdec4rl1UB2FSg8e8K,5X6FeZozNMgE2VRi3MJYjkkFK8SETtu2,9,6,3,3,4,0,1,0,17,2.4285714285714284,1,0.0,2,3,3,4,4,0,0,1,0,12,5,1
21009,193635,XWdgQujmo1P2VLjvmb7PkUqKleCwQ4ss,A3fsA9Zfv1X2fVEQhTw51lKENdNrEqT3,11,7,5,0,3,0,4,0,19,2.7142857142857144,1,0.0,0,5,0,3,7,0,0,4,0,8,11,1
21010,193656,e5o0ZhPldcalqrDMbMLWYdrV0kqK4jyi,A3fsA9Zfv1X2fVEQhTw51lKENdNrEqT3,27,18,1,52,1,0,9,0,81,11.571428571428571,1,0.0,0,1,45,1,18,0,7,9,0,47,34,1
21011,193667,598cj7AyOso6FYrmmNL9sAZebmTaquiE,SpATywNh6bZuzm8s1ceuBUnMUAeoAHHw,1,0,0,0,0,0,1,0,1,0.14285714285714285,1,0.0,0,0,0,0,0,0,0,1,0,0,1,1
21012,193676,ICjb9YpLQQYBLFzFmkyCMZI5LNU5C4Fb,5X6FeZozNMgE2VRi3MJYjkkFK8SETtu2,6,2,1,0,1,0,3,0,7,1.0,1,0.0,0,1,0,1,2,0,0,3,0,2,5,1
21013,193685,VAqYNROCUp4auixkrMgowB877fUTXjiq,SpATywNh6bZuzm8s1ceuBUnMUAeoAHHw,31,30,16,18,9,16,9,2,100,14.285714285714286,1,0.0,8,16,17,9,22,16,1,9,2,50,50,1
21014,193691,VwBmQMjyoGFc84WCvHOjmFbeW8jbYRgl,A3fsA9Zfv1X2fVEQhTw51lKENdNrEqT3,1,0,0,0,0,0,1,0,1,0.14285714285714285,1,0.0,0,0,0,0,0,0,0,1,0,0,1,1
21015,193695,GR5uAqC8TkTRctStVcrTSN6GkRpM0Sgw,A3fsA9Zfv1X2fVEQhTw51lKENdNrEqT3,10,9,6,0,4,0,3,0,22,3.142857142857143,1,0.0,0,6,0,4,9,0,0,3,0,10,12,1
21016,193698,VwBmQMjyoGFc84WCvHOjmFbeW8jbYRgl,5X6FeZozNMgE2VRi3MJYjkkFK8SETtu2,1,0,0,0,0,0,1,0,1,0.14285714285714285,1,0.0,0,0,0,0,0,0,0,1,0,0,1,1
21017,193727,9sblSYhBcICCvIfDQzNd8urCtUZhCG20,G8EPVSXsOYB5YQWZGiz1aVq5Pgr2GrQu,4,2,1,0,1,0,1,0,5,0.7142857142857143,1,0.0,0,1,0,1,2,0,0,1,0,2,3,1
21018,193736,sHXZP4MEjEMzkkOQfvmTepwt8uTqOiyM,5X6FeZozNMgE2VRi3MJYjkkFK8SETtu2,1,0,0,0,0,0,1,0,1,0.14285714285714285,1,0.0,0,0,0,0,0,0,0,1,0,0,1,1
21019,193742,dIBmr3CPQOqWuT2RbNcEQBxcZ3iYYFKJ,SpATywNh6bZuzm8s1ceuBUnMUAeoAHHw,5,0,0,0,0,1,4,1,6,0.8571428571428571,1,0.0,0,0,0,0,0,1,0,4,1,0,6,1
21020,193747,GTb2BLvnbd5mZTOqXcKad8NiMQFrBvAc,SpATywNh6bZuzm8s1ceuBUnMUAeoAHHw,18,23,10,14,6,0,6,0,59,8.428571428571429,1,0.0,2,10,11,6,21,0,3,6,0,29,30,1
21021,193748,hjvKRw9pmlUHPnwBerxV034YiZ4Sdtt0,G8EPVSXsOYB5YQWZGiz1aVq5Pgr2GrQu,9,6,5,0,5,0,2,0,18,2.5714285714285716,1,0.0,0,5,0,5,6,0,0,2,0,10,8,1
21022,193760,YbMwXn5lVdcJUwxsrilaG1YZqfrME5Ts,G8EPVSXsOYB5YQWZGiz1aVq5Pgr2GrQu,1,0,0,0,0,0,1,0,1,0.14285714285714285,1,0.0,0,0,0,0,0,0,0,1,0,0,1,1
21023,193761,DooyrB9PbCqKIV8AnNe2Wg3x6dZeRNaT,SpATywNh6bZuzm8s1ceuBUnMUAeoAHHw,7,6,2,0,0,0,3,2,13,1.8571428571428572,1,0.0,0,2,0,0,6,0,0,3,2,2,11,1
21024,193763,rKeYwK2azWmbL5uxRkzD5SXs7NFGZVCo,SpATywNh6bZuzm8s1ceuBUnMUAeoAHHw,6,3,0,0,0,0,4,0,7,1.0,1,0.0,0,0,0,0,3,0,0,4,0,0,7,1
21025,193788,j3WvRsPrA16gNidaQCOf3oXIUr2Xe5Lw,A3fsA9Zfv1X2fVEQhTw51lKENdNrEqT3,5,2,1,0,1,0,3,0,7,1.0,1,0.0,0,1,0,1,2,0,0,3,0,2,5,1
21026,193801,7ZZMGT0pRIPOqiHOaJOX6RxFZ8zRhWxt,A3fsA9Zfv1X2fVEQhTw51lKENdNrEqT3,8,3,2,0,2,1,3,0,11,1.5714285714285714,1,0.0,0,2,0,2,3,1,0,3,0,4,7,1
21027,193802,S0VKX97GoNIs4ZIwm8h0PYaT3QLarXum,5X6FeZozNMgE2VRi3MJYjkkFK8SETtu2,8,2,1,0,1,1,10,4,19,2.7142857142857144,1,0.0,0,1,0,1,2,1,0,10,4,2,17,1
21028,193819,3vhCoT2dzeVdCpmcedhNzxK4VNLZ2l0r,bWdj2GDclj5ofokWjzoa5jAwMkxCykd6,1,0,0,0,0,0,1,0,1,0.14285714285714285,1,0.0,0,0,0,0,0,0,0,1,0,0,1,0
21029,193825,3VQVtsFphnOA3h1KWYRcAEMgfViLsPnF,bWdj2GDclj5ofokWjzoa5jAwMkxCykd6,4,3,1,0,0,0,2,0,6,0.8571428571428571,1,0.0,0,1,0,0,3,0,0,2,0,1,5,1
21030,193829,hvOZRLKsEVBLKIHheUWv5UUSup3awqeH,A3fsA9Zfv1X2fVEQhTw51lKENdNrEqT3,4,3,2,0,0,0,1,0,6,0.8571428571428571,1,0.0,0,2,0,0,3,0,0,1,0,2,4,1
21031,193835,FMDDO6Y1UiugRDKpi0pVbHvW0zsQHjbn,bWdj2GDclj5ofokWjzoa5jAwMkxCykd6,1,0,0,0,0,0,1,0,1,0.14285714285714285,1,0.0,0,0,0,0,0,0,0,1,0,0,1,1
21032,193836,WXzb3Y6xA6QJw9uAvme4qAoRdy9Swxz3,bWdj2GDclj5ofokWjzoa5jAwMkxCykd6,5,2,1,0,1,0,2,0,6,0.8571428571428571,1,0.0,0,1,0,1,2,0,0,2,0,2,4,1
21033,193842,z7DdTbSj1Gj3ZtxvkXQiSHlxkjIq13Om,A3fsA9Zfv1X2fVEQhTw51lKENdNrEqT3,2,0,0,0,0,0,2,0,2,0.2857142857142857,1,0.0,0,0,0,0,0,0,0,2,0,0,2,1
21034,193864,K9qobabPo7pZQt2fKdAjWYuJRDpZrqC7,RXDvfPUBYFlVdlueBFbLW0mhhAyGEqpt,11,5,4,0,4,0,2,0,15,2.142857142857143,1,0.0,0,4,0,4,5,0,0,2,0,8,7,1
21035,193874,ZMuuMhmwz4rPRJ3j5NrhL1ac0b3nmBXc,5X6FeZozNMgE2VRi3MJYjkkFK8SETtu2,1,0,0,0,0,0,1,0,1,0.14285714285714285,1,0.0,0,0,0,0,0,0,0,1,0,0,1,1
21036,193885,F9X9HFVZRhtKo9yeebrZ2KAiEJUTDJRY,G8EPVSXsOYB5YQWZGiz1aVq5Pgr2GrQu,2,0,0,0,0,0,2,0,2,0.2857142857142857,1,0.0,0,0,0,0,0,0,0,2,0,0,2,1
21037,193887,8WWQhxaHRXxYqCPIQW9GmAgjD0ozXXnf,A3fsA9Zfv1X2fVEQhTw51lKENdNrEqT3,4,2,1,0,0,0,3,0,6,0.8571428571428571,1,0.0,0,1,0,0,2,0,0,3,0,1,5,0
21038,193897,45E6hpwDMHp9Q3Pt1xT8q04bbowKk87g,A3fsA9Zfv1X2fVEQhTw51lKENdNrEqT3,1,0,0,0,0,0,1,0,1,0.14285714285714285,1,0.0,0,0,0,0,0,0,0,1,0,0,1,1
21039,193929,e6mMhCeN7w5EZEy3n1NRYNLGTJO2KA59,SpATywNh6bZuzm8s1ceuBUnMUAeoAHHw,1,0,0,0,0,0,1,0,1,0.14285714285714285,1,0.0,0,0,0,0,0,0,0,1,0,0,1,1
21040,193932,B3ZfBfSKmpVIANk9dvhtttx7UlfawxPq,A3fsA9Zfv1X2fVEQhTw51lKENdNrEqT3,1,0,0,0,0,0,1,0,1,0.14285714285714285,1,0.0,0,0,0,0,0,0,0,1,0,0,1,1
21041,193941,Y3dD0pffbJaLSFte0rosi5cTQO2WHCFH,bWdj2GDclj5ofokWjzoa5jAwMkxCykd6,1,0,0,0,0,0,2,0,2,0.2857142857142857,1,0.0,0,0,0,0,0,0,0,2,0,0,2,1
21042,193942,hOgVLmzr652IyemyxTuY6cW83fi0l5Hj,G8EPVSXsOYB5YQWZGiz1aVq5Pgr2GrQu,1,0,0,0,0,0,1,0,1,0.14285714285714285,1,0.0,0,0,0,0,0,0,0,1,0,0,1,1
21043,193973,6KzTREX6cWCQkku3medBN2WKozKVI3fS,SpATywNh6bZuzm8s1ceuBUnMUAeoAHHw,3,2,0,0,0,0,2,0,4,0.5714285714285714,1,0.0,0,0,0,0,2,0,0,2,0,0,4,1
21044,193978,DysXuoUoTtoCjfxHxEQdZhXHC6tNfwru,bWdj2GDclj5ofokWjzoa5jAwMkxCykd6,7,3,2,0,1,0,9,0,15,2.142857142857143,1,0.0,0,2,0,1,3,0,0,9,0,3,12,1
21045,193993,S84ond6hhLSjNul8oHBvYzb7CeUyBJp8,SpATywNh6bZuzm8s1ceuBUnMUAeoAHHw,7,5,0,0,0,2,7,2,16,2.2857142857142856,1,0.0,0,0,0,0,5,2,0,7,2,0,16,1
21046,193996,3IFRUpYOJSQEJERfx1oONgKb2XoWBUXe,A3fsA9Zfv1X2fVEQhTw51lKENdNrEqT3,4,2,1,0,1,0,1,0,5,0.7142857142857143,1,0.0,0,1,0,1,2,0,0,1,0,2,3,1
21047,193997,eOxm8XEI11Xs6eiBi1Nu5QzIagZXwEm9,G8EPVSXsOYB5YQWZGiz1aVq5Pgr2GrQu,11,23,12,6,0,3,2,0,46,6.571428571428571,1,0.0,9,12,6,0,14,3,0,2,0,27,19,0
21048,193998,TV2QJkXjXW9uFHAZ7SV4Umcd3jhniZYh,A3fsA9Zfv1X2fVEQhTw51lKENdNrEqT3,1,0,0,0,0,0,1,0,1,0.14285714285714285,1,0.0,0,0,0,0,0,0,0,1,0,0,1,1
21049,194012,jnzTLvRDRqiUyW9xELuzH3YTLwUlWLlc,A3fsA9Zfv1X2fVEQhTw51lKENdNrEqT3,10,3,2,0,2,0,9,2,18,2.5714285714285716,1,0.0,0,2,0,2,3,0,0,9,2,4,14,1
21050,194028,jnzTLvRDRqiUyW9xELuzH3YTLwUlWLlc,bWdj2GDclj5ofokWjzoa5jAwMkxCykd6,6,0,0,0,0,1,6,2,9,1.2857142857142858,1,0.0,0,0,0,0,0,1,0,6,2,0,9,1
21051,194039,Zi4TkBqsB6TMu9rM1cOGrFhYXBZRNO2C,bWdj2GDclj5ofokWjzoa5jAwMkxCykd6,5,3,1,20,0,0,2,0,26,3.7142857142857144,1,0.0,1,1,19,0,2,0,1,2,0,21,5,1
21052,194043,DIV0XhnvCWVZ3iA9CwmqKCB9ziYsXVmI,A3fsA9Zfv1X2fVEQhTw51lKENdNrEqT3,40,35,13,46,8,1,5,0,108,15.428571428571429,1,0.0,3,13,43,8,32,1,3,5,0,67,41,1
21053,194050,mpIXHW5sILjjHOwn1u3NkBPJs6lkxDFU,bWdj2GDclj5ofokWjzoa5jAwMkxCykd6,7,2,1,0,1,0,7,1,12,1.7142857142857142,1,0.0,0,1,0,1,2,0,0,7,1,2,10,1
21054,194079,CuAHJ0dQPPKM3jbCnUFrdX2jG6XCUieg,G8EPVSXsOYB5YQWZGiz1aVq5Pgr2GrQu,2,0,0,0,0,0,3,0,3,0.42857142857142855,1,0.0,0,0,0,0,0,0,0,3,0,0,3,1
21055,194087,ss3omMaxz8HNXcYUFu5YCrRY08Nxx8VE,bWdj2GDclj5ofokWjzoa5jAwMkxCykd6,1,0,0,0,0,0,1,0,1,0.14285714285714285,1,0.0,0,0,0,0,0,0,0,1,0,0,1,1
21056,194107,usAyN6L7XALOHwgB1OAbVS6qtnhLfW64,5X6FeZozNMgE2VRi3MJYjkkFK8SETtu2,8,3,2,0,2,5,4,0,16,2.2857142857142856,1,0.0,0,2,0,2,3,5,0,4,0,4,12,1
21057,194124,YpnxbgvlHOSkecYk2lPrRwAg5SZiWPmr,bWdj2GDclj5ofokWjzoa5jAwMkxCykd6,1,0,0,0,0,0,1,0,1,0.14285714285714285,1,0.0,0,0,0,0,0,0,0,1,0,0,1,1
21058,194130,JijbcO7wMC3H8jX3AIAMeKa5y6Yx30jd,SpATywNh6bZuzm8s1ceuBUnMUAeoAHHw,3,3,1,0,0,0,2,0,6,0.8571428571428571,1,0.0,0,1,0,0,3,0,0,2,0,1,5,1
21059,194141,AEmia2YozeXaHvFO7t97makRXH4xCDlp,bWdj2GDclj5ofokWjzoa5jAwMkxCykd6,2,0,0,0,0,0,2,0,2,0.2857142857142857,1,0.0,0,0,0,0,0,0,0,2,0,0,2,1
21060,194152,7zIWtEX0UqW89kjtfLjI3UwXu7RlQqmU,SpATywNh6bZuzm8s1ceuBUnMUAeoAHHw,5,1,1,0,0,1,3,0,6,0.8571428571428571,1,0.0,0,1,0,0,1,1,0,3,0,1,5,1
21061,194158,D9eQoamtTDpiMV0b0OdGca728kthGUV3,G8EPVSXsOYB5YQWZGiz1aVq5Pgr2GrQu,38,11,2,140,0,0,4,0,157,22.428571428571427,2,0.0,0,2,120,0,11,0,20,4,0,122,35,0
21062,194167,2Dq9sTJAh9p2mCX2aKqNadJZj5lSg7Gc,SpATywNh6bZuzm8s1ceuBUnMUAeoAHHw,5,2,1,0,1,2,2,0,8,1.1428571428571428,1,0.0,0,1,0,1,2,2,0,2,0,2,6,1
21063,194168,GK7sYKSl1UGrgHpbh9Be7dVcfb79qHt9,SpATywNh6bZuzm8s1ceuBUnMUAeoAHHw,1,0,0,0,0,0,1,0,1,0.14285714285714285,1,0.0,0,0,0,0,0,0,0,1,0,0,1,1
21064,194184,l8hBRAS7ogrjP9TtrcfhUTQvRrT69YER,G8EPVSXsOYB5YQWZGiz1aVq5Pgr2GrQu,5,2,1,0,1,0,2,0,6,0.8571428571428571,1,0.0,0,1,0,1,2,0,0,2,0,2,4,1
21065,194188,OPg8TE3YHncvc9lX5Qzwkp0eoPsxjeaJ,SpATywNh6bZuzm8s1ceuBUnMUAeoAHHw,1,0,0,0,0,0,1,0,1,0.14285714285714285,1,0.0,0,0,0,0,0,0,0,1,0,0,1,1
21066,194198,1GmDhTbDGwGy4bZMeoK4qCn6roKlLWL8,G8EPVSXsOYB5YQWZGiz1aVq5Pgr2GrQu,1,0,0,0,0,0,1,0,1,0.14285714285714285,1,0.0,0,0,0,0,0,0,0,1,0,0,1,1
21067,194207,N3GQz89WFoRVhyYvEOMDsOOoq6FMOJl1,A3fsA9Zfv1X2fVEQhTw51lKENdNrEqT3,7,2,1,0,1,0,4,0,8,1.1428571428571428,1,0.0,0,1,0,1,2,0,0,4,0,2,6,1
21068,194209,2VapaY28kspg4nCvtglCw2KKfbfMlxS8,SpATywNh6bZuzm8s1ceuBUnMUAeoAHHw,5,3,1,0,1,0,1,0,6,0.8571428571428571,1,0.0,0,1,0,1,3,0,0,1,0,2,4,1
21069,194212,OvbupWSPA81Tk7Ur62Bs2bcQ5LB2mCRC,G8EPVSXsOYB5YQWZGiz1aVq5Pgr2GrQu,2,0,0,0,0,0,3,0,3,0.42857142857142855,1,0.0,0,0,0,0,0,0,0,3,0,0,3,0
21070,194214,OvbupWSPA81Tk7Ur62Bs2bcQ5LB2mCRC,A3fsA9Zfv1X2fVEQhTw51lKENdNrEqT3,2,0,0,0,0,0,2,0,2,0.2857142857142857,1,0.0,0,0,0,0,0,0,0,2,0,0,2,1
21071,194219,HFdRVQ3AaPvRF7mZbj3u7qUCAaYBGTcm,SpATywNh6bZuzm8s1ceuBUnMUAeoAHHw,1,0,0,0,0,0,1,0,1,0.14285714285714285,1,0.0,0,0,0,0,0,0,0,1,0,0,1,1
21072,194239,lxKYdDOq1adV5jGN5i0lYRRTeDyNW3Hr,SpATywNh6bZuzm8s1ceuBUnMUAeoAHHw,7,5,3,0,3,0,1,0,12,1.7142857142857142,1,0.0,0,3,0,3,5,0,0,1,0,6,6,1
21073,194245,BX7A5l848o20PbI9pokip60ZP55PjOzN,G8EPVSXsOYB5YQWZGiz1aVq5Pgr2GrQu,4,4,0,0,1,0,2,0,7,1.0,1,0.0,2,0,0,1,2,0,0,2,0,3,4,1
21074,194247,cpjQZOHgh4ZTeyEYZfjNyABlYC6nYoj2,A3fsA9Zfv1X2fVEQhTw51lKENdNrEqT3,7,6,5,0,0,0,3,0,14,2.0,1,0.0,0,5,0,0,6,0,0,3,0,5,9,1
21075,194267,hMqCjJdtfaejzSQ83KyhyoOldYIdBdX3,SpATywNh6bZuzm8s1ceuBUnMUAeoAHHw,1,0,0,0,0,0,1,0,1,0.14285714285714285,1,0.0,0,0,0,0,0,0,0,1,0,0,1,1
21076,194268,kITwW1gHtEbLza4IRMvPlhsE9m2pSgys,SpATywNh6bZuzm8s1ceuBUnMUAeoAHHw,11,7,4,1,3,1,2,0,18,2.5714285714285716,1,0.0,2,4,1,3,5,1,0,2,0,10,8,1
21077,194270,C5PwR3SXfivaQr9O4Dxv6rN0h0XMnUVV,SpATywNh6bZuzm8s1ceuBUnMUAeoAHHw,1,0,0,0,0,0,1,0,1,0.14285714285714285,1,0.0,0,0,0,0,0,0,0,1,0,0,1,1
21078,194286,Otjo8813Dg7RT9KCV4W4ruW1YbtDERlU,SpATywNh6bZuzm8s1ceuBUnMUAeoAHHw,4,2,0,0,0,0,2,0,4,0.5714285714285714,1,0.0,0,0,0,0,2,0,0,2,0,0,4,1
21079,194294,TrGtovPIL2DHRKTJya0pAHN8Ll5iZ4bG,bWdj2GDclj5ofokWjzoa5jAwMkxCykd6,9,7,2,0,3,0,6,0,18,2.5714285714285716,1,0.0,4,2,0,3,3,0,0,6,0,9,9,1
21080,194302,wOwiWQdQ27i4GIc2oZMP91541bkLucBc,SpATywNh6bZuzm8s1ceuBUnMUAeoAHHw,1,0,0,0,0,0,2,0,2,0.2857142857142857,1,0.0,0,0,0,0,0,0,0,2,0,0,2,1
21081,194318,y2Bn8Fz28yytP2MIRmHuQaPFEsenFCug,5X6FeZozNMgE2VRi3MJYjkkFK8SETtu2,1,0,0,0,0,0,1,0,1,0.14285714285714285,1,0.0,0,0,0,0,0,0,0,1,0,0,1,1
21082,194321,y2Bn8Fz28yytP2MIRmHuQaPFEsenFCug,A3fsA9Zfv1X2fVEQhTw51lKENdNrEqT3,1,0,0,0,0,0,1,0,1,0.14285714285714285,1,0.0,0,0,0,0,0,0,0,1,0,0,1,1
21083,194322,OZuOlHrYkbmhjVMCUismPKuxxMPY633r,A3fsA9Zfv1X2fVEQhTw51lKENdNrEqT3,1,0,0,0,0,0,1,0,1,0.14285714285714285,1,0.0,0,0,0,0,0,0,0,1,0,0,1,1
21084,194334,hY4FeHGzGwAjlLDbag2MaeYtVg1riH9c,SpATywNh6bZuzm8s1ceuBUnMUAeoAHHw,8,8,4,0,3,0,2,1,18,2.5714285714285716,1,0.0,0,4,0,3,8,0,0,2,1,7,11,1
21085,194345,1qu57qTStFt2PB3HKgCdjae4zjIQPzMS,SpATywNh6bZuzm8s1ceuBUnMUAeoAHHw,2,0,0,0,0,0,2,0,2,0.2857142857142857,1,0.0,0,0,0,0,0,0,0,2,0,0,2,1
21086,194377,ebb0eUpPkZciTEOOrks9iaKBNMYE9SZU,SpATywNh6bZuzm8s1ceuBUnMUAeoAHHw,2,0,0,0,0,0,2,0,2,0.2857142857142857,1,0.0,0,0,0,0,0,0,0,2,0,0,2,1
21087,194388,hvbDeZzn9OgzafKXcnS1f48LEouOk3BF,bWdj2GDclj5ofokWjzoa5jAwMkxCykd6,1,0,0,0,0,0,1,0,1,0.14285714285714285,1,0.0,0,0,0,0,0,0,0,1,0,0,1,1
21088,194390,hvbDeZzn9OgzafKXcnS1f48LEouOk3BF,A3fsA9Zfv1X2fVEQhTw51lKENdNrEqT3,6,0,0,0,0,1,5,0,6,0.8571428571428571,1,0.0,0,0,0,0,0,1,0,5,0,0,6,1
21089,194393,sTUCiynpym0OYmwd4HYbIIN7BbIAdZsH,5X6FeZozNMgE2VRi3MJYjkkFK8SETtu2,2,0,0,0,0,0,2,0,2,0.2857142857142857,1,0.0,0,0,0,0,0,0,0,2,0,0,2,1
21090,194406,WjTwXU0UqHfY2vRQjeMISV15DHgkpGUt,A3fsA9Zfv1X2fVEQhTw51lKENdNrEqT3,33,11,7,54,4,2,10,0,88,12.571428571428571,1,0.0,1,7,48,4,10,2,6,10,0,60,28,1
21091,194424,q43mSthmSExfF85hVnaL1eLCzsnwUSmi,SpATywNh6bZuzm8s1ceuBUnMUAeoAHHw,1,0,0,0,0,0,1,0,1,0.14285714285714285,1,0.0,0,0,0,0,0,0,0,1,0,0,1,1
21092,194431,1ZMf7BMPt4L0ACovltRnIwtfAQfbX0Vc,5X6FeZozNMgE2VRi3MJYjkkFK8SETtu2,1,0,0,0,0,0,1,0,1,0.14285714285714285,1,0.0,0,0,0,0,0,0,0,1,0,0,1,1
21093,194471,uugcqDT99r37esUG18otF2qi3eWqvBzw,A3fsA9Zfv1X2fVEQhTw51lKENdNrEqT3,1,0,0,0,0,0,1,0,1,0.14285714285714285,1,0.0,0,0,0,0,0,0,0,1,0,0,1,1
21094,194476,48cQDxCvkp2Kfh2llKaDd9ViunV47JS8,SpATywNh6bZuzm8s1ceuBUnMUAeoAHHw,4,3,0,0,0,0,2,0,5,0.7142857142857143,1,0.0,0,0,0,0,3,0,0,2,0,0,5,1
21095,194479,onTUKKbDoguwNYZBVtONhnnEUSuWUV8S,G8EPVSXsOYB5YQWZGiz1aVq5Pgr2GrQu,9,3,1,0,1,0,5,1,11,1.5714285714285714,1,0.0,0,1,0,1,3,0,0,5,1,2,9,1
21096,194483,uWA9XLuGA6XEQSt93Q0BaDvrrOLPsSDK,SpATywNh6bZuzm8s1ceuBUnMUAeoAHHw,7,3,2,0,2,0,2,0,9,1.2857142857142858,1,0.0,0,2,0,2,3,0,0,2,0,4,5,1
21097,194504,Idacmra5qZXQ5ItNCju8xTvAUotHMPrs,SpATywNh6bZuzm8s1ceuBUnMUAeoAHHw,6,8,5,0,0,1,5,0,19,2.7142857142857144,1,0.0,1,5,0,0,7,1,0,5,0,6,13,1
21098,194507,FlQozMQpruyYmAqeyZEzRE9TkM48Rlw4,RXDvfPUBYFlVdlueBFbLW0mhhAyGEqpt,4,2,1,0,1,0,1,0,5,0.7142857142857143,1,0.0,0,1,0,1,2,0,0,1,0,2,3,1
21099,194511,34PiVxaMQlPDCBhflVVNOJYBNiFJq4sd,G8EPVSXsOYB5YQWZGiz1aVq5Pgr2GrQu,4,2,0,0,0,0,2,0,4,0.5714285714285714,1,0.0,0,0,0,0,2,0,0,2,0,0,4,1
21100,194515,YwHqDHYDccXkxjPE1B044eDwvxiVBTeO,SpATywNh6bZuzm8s1ceuBUnMUAeoAHHw,3,2,1,0,0,0,1,0,4,0.5714285714285714,1,0.0,0,1,0,0,2,0,0,1,0,1,3,1
21101,194534,H3KvIatiAwzsCPQBVABALz431TkTR6tW,bWdj2GDclj5ofokWjzoa5jAwMkxCykd6,1,0,0,0,0,0,1,0,1,0.14285714285714285,1,0.0,0,0,0,0,0,0,0,1,0,0,1,1
21102,194544,p8BRO2js5DMFomuFhLGv1L7bXBEJtOjM,SpATywNh6bZuzm8s1ceuBUnMUAeoAHHw,2,0,0,0,0,0,3,0,3,0.42857142857142855,1,0.0,0,0,0,0,0,0,0,3,0,0,3,1
21103,194549,om0KjvovtBK0gZUSboAPRv5A6Jkm00Ei,G8EPVSXsOYB5YQWZGiz1aVq5Pgr2GrQu,1,0,0,0,0,0,2,0,2,0.2857142857142857,1,0.0,0,0,0,0,0,0,0,2,0,0,2,1
21104,194556,AsOrTv5l2WGfE3oCrdncC2RTwz7dm912,bWdj2GDclj5ofokWjzoa5jAwMkxCykd6,2,0,0,0,0,0,3,0,3,0.42857142857142855,1,0.0,0,0,0,0,0,0,0,3,0,0,3,1
21105,194581,XFUUwZmtEN3cKElSp0idT6cWlW88ytvr,SpATywNh6bZuzm8s1ceuBUnMUAeoAHHw,1,0,0,0,0,0,2,0,2,0.2857142857142857,1,0.0,0,0,0,0,0,0,0,2,0,0,2,1
21106,194597,MYuwori4SZLwwApulVomE37Zmv9CBJsc,SpATywNh6bZuzm8s1ceuBUnMUAeoAHHw,1,0,0,0,0,0,1,0,1,0.14285714285714285,1,0.0,0,0,0,0,0,0,0,1,0,0,1,1
21107,194619,8IMVGvB09WRKHeXEjWGkZOVu6CXmlVXA,G8EPVSXsOYB5YQWZGiz1aVq5Pgr2GrQu,1,0,0,0,0,0,1,0,1,0.14285714285714285,1,0.0,0,0,0,0,0,0,0,1,0,0,1,1
21108,194625,cDJMTZrtYqA5Zzp6GydZkLUzHLBofVka,G8EPVSXsOYB5YQWZGiz1aVq5Pgr2GrQu,6,2,1,0,1,5,4,0,13,1.8571428571428572,1,0.0,0,1,0,1,2,5,0,4,0,2,11,0
21109,194626,xxqm3MFvp9JeD1lH1hC9xIrY8O1L8Xjf,SpATywNh6bZuzm8s1ceuBUnMUAeoAHHw,3,2,0,0,0,1,1,0,4,0.5714285714285714,1,0.0,0,0,0,0,2,1,0,1,0,0,4,1
21110,194629,mRThjjGON0zU0Y2plEdpqVN16fEiXwSr,A3fsA9Zfv1X2fVEQhTw51lKENdNrEqT3,1,0,0,0,0,0,2,0,2,0.2857142857142857,1,0.0,0,0,0,0,0,0,0,2,0,0,2,1
21111,194632,mhoMg2u4vZZCHMZwVbOPSr9rKeZ90EyX,SpATywNh6bZuzm8s1ceuBUnMUAeoAHHw,1,0,0,0,0,0,1,0,1,0.14285714285714285,1,0.0,0,0,0,0,0,0,0,1,0,0,1,1
21112,194633,NLv4FgxnCzxez4sx4x5czDhMA2RThzip,G8EPVSXsOYB5YQWZGiz1aVq5Pgr2GrQu,11,8,1,0,1,0,3,0,13,1.8571428571428572,1,0.0,0,1,0,1,8,0,0,3,0,2,11,0
21113,194655,Ntq8V5vAbhpRqfZVmDonWfflMXALrE62,A3fsA9Zfv1X2fVEQhTw51lKENdNrEqT3,7,5,3,0,1,0,4,0,13,1.8571428571428572,1,0.0,0,3,0,1,5,0,0,4,0,4,9,1
21114,194658,YTC5509AOhIkCtNjrBmjv9Yv2oK29NsL,SpATywNh6bZuzm8s1ceuBUnMUAeoAHHw,6,1,1,0,1,0,3,0,6,0.8571428571428571,1,0.0,0,1,0,1,1,0,0,3,0,2,4,1
21115,194667,sbaCeCpavj6HRFMhWrWMN8T04nCg0Bj4,SpATywNh6bZuzm8s1ceuBUnMUAeoAHHw,4,3,1,0,1,0,2,0,7,1.0,1,0.0,0,1,0,1,3,0,0,2,0,2,5,1
21116,194668,1sJ6YPYoSHma92rhmUGAalTdAYX4i2lG,SpATywNh6bZuzm8s1ceuBUnMUAeoAHHw,7,5,3,0,3,0,2,0,13,1.8571428571428572,1,0.0,0,3,0,3,5,0,0,2,0,6,7,1
21117,194674,VK6VYsFJEy8hhWdKq52KmrJkO3b6jNbn,bWdj2GDclj5ofokWjzoa5jAwMkxCykd6,4,2,1,0,1,0,1,0,5,0.7142857142857143,1,0.0,0,1,0,1,2,0,0,1,0,2,3,1
21118,194677,D0i6ZcBzVub6eIaIAw4ckCiIW5ThBWQ4,A3fsA9Zfv1X2fVEQhTw51lKENdNrEqT3,1,0,0,0,0,0,1,0,1,0.14285714285714285,1,0.0,0,0,0,0,0,0,0,1,0,0,1,1
21119,194678,96DWLTPjQt7WYS8cwfEQ2OGqQgPivHHX,SpATywNh6bZuzm8s1ceuBUnMUAeoAHHw,6,5,4,0,2,2,3,0,16,2.2857142857142856,1,0.0,0,4,0,2,5,2,0,3,0,6,10,1
21120,194684,d5TfbEyt4nCHCAaoxySwtX2WVur5Z8A1,A3fsA9Zfv1X2fVEQhTw51lKENdNrEqT3,1,0,0,0,0,0,1,0,1,0.14285714285714285,1,0.0,0,0,0,0,0,0,0,1,0,0,1,1
21121,194685,1YrPSVRax2MbGnGgOZ0qdLQfDXuMb3FP,SpATywNh6bZuzm8s1ceuBUnMUAeoAHHw,4,2,1,0,1,0,1,0,5,0.7142857142857143,1,0.0,0,1,0,1,2,0,0,1,0,2,3,1
21122,194693,8TF2Yz03M0ctxPaKqQO9uTaRyGlE3FTS,bWdj2GDclj5ofokWjzoa5jAwMkxCykd6,1,0,0,0,0,0,1,0,1,0.14285714285714285,1,0.0,0,0,0,0,0,0,0,1,0,0,1,1
21123,194694,6Ypoz1HptUjxpuR7fZtuIow2vA2n53uM,A3fsA9Zfv1X2fVEQhTw51lKENdNrEqT3,1,0,0,0,0,0,1,0,1,0.14285714285714285,1,0.0,0,0,0,0,0,0,0,1,0,0,1,1
21124,194713,aMZE4hDrTfaO5VrIlGdTGgvjbzOnIun0,A3fsA9Zfv1X2fVEQhTw51lKENdNrEqT3,1,0,0,0,0,0,1,0,1,0.14285714285714285,1,0.0,0,0,0,0,0,0,0,1,0,0,1,1
21125,194719,wj7PR2dOTCSENZUxdS1JrjKR8466zZVl,bWdj2GDclj5ofokWjzoa5jAwMkxCykd6,8,2,1,0,1,1,6,1,12,1.7142857142857142,1,0.0,0,1,0,1,2,1,0,6,1,2,10,1
21126,194722,4rwe5BmciR8qkFj7YwyJ3a5aK2xp9xod,A3fsA9Zfv1X2fVEQhTw51lKENdNrEqT3,6,5,3,0,2,0,3,0,13,1.8571428571428572,1,0.0,0,3,0,2,5,0,0,3,0,5,8,1
21127,194729,yWWr0HnJqf4TxBLaD1ZmBW6mPdbU2NXV,SpATywNh6bZuzm8s1ceuBUnMUAeoAHHw,5,4,1,0,1,0,4,0,10,1.4285714285714286,1,0.0,0,1,0,1,4,0,0,4,0,2,8,1
21128,194733,MBzpq6BeyrKVsFmJlf8cgHZW8NmCppoM,bWdj2GDclj5ofokWjzoa5jAwMkxCykd6,5,2,1,0,1,0,2,0,6,0.8571428571428571,1,0.0,0,1,0,1,2,0,0,2,0,2,4,1
21129,194734,55FtCsTJdMN32PE70MZj9DHqTCxXeYP2,SpATywNh6bZuzm8s1ceuBUnMUAeoAHHw,6,3,2,0,2,0,1,0,8,1.1428571428571428,1,0.0,0,2,0,2,3,0,0,1,0,4,4,1
21130,194739,ivSdmGnxv1Uz6NLl4IGvBJeRY1HBPrVZ,SpATywNh6bZuzm8s1ceuBUnMUAeoAHHw,9,4,1,0,1,8,5,1,20,2.857142857142857,1,0.0,0,1,0,1,4,8,0,5,1,2,18,1
21131,194753,Bxz1zTHFCCx9o1kJA9B0Pzm3PnmqKxr5,A3fsA9Zfv1X2fVEQhTw51lKENdNrEqT3,7,3,2,0,2,0,2,0,9,1.2857142857142858,1,0.0,0,2,0,2,3,0,0,2,0,4,5,1
21132,194767,i4NsQYAbaUfmQ6n2VMTiVWggNWktkrDX,bWdj2GDclj5ofokWjzoa5jAwMkxCykd6,5,10,3,0,0,0,5,0,18,2.5714285714285716,1,0.0,0,3,0,0,10,0,0,5,0,3,15,0
21133,194779,KheifBHmTnDsYBIH7TBBDpXQ1Bd1UA3a,SpATywNh6bZuzm8s1ceuBUnMUAeoAHHw,1,0,0,0,0,0,1,0,1,0.14285714285714285,1,0.0,0,0,0,0,0,0,0,1,0,0,1,1
21134,194784,LDPCm5FHAiMLt4xJYeSbtfjm8D9WglxJ,SpATywNh6bZuzm8s1ceuBUnMUAeoAHHw,16,15,7,14,3,0,5,0,44,6.285714285714286,1,0.0,4,7,14,3,11,0,0,5,0,28,16,1
21135,194788,BH0g3wVCilU6qeEv507COxWXunEVyQCt,A3fsA9Zfv1X2fVEQhTw51lKENdNrEqT3,4,6,3,0,0,0,2,0,11,1.5714285714285714,1,0.0,0,3,0,0,6,0,0,2,0,3,8,1
21136,194803,YqqcH0qThFMdLP4k9i9U0gJ4gpbELjkv,SpATywNh6bZuzm8s1ceuBUnMUAeoAHHw,8,8,6,0,0,0,5,2,21,3.0,1,0.0,0,6,0,0,8,0,0,5,2,6,15,1
21137,194806,FF4dRvqzL3V5nW7v3NbN8PsUIVH4lz6F,SpATywNh6bZuzm8s1ceuBUnMUAeoAHHw,1,0,0,0,0,0,1,0,1,0.14285714285714285,1,0.0,0,0,0,0,0,0,0,1,0,0,1,1
21138,194807,tyVcDsPvN4UjeaGnK8HkYLM1DiaISxPh,A3fsA9Zfv1X2fVEQhTw51lKENdNrEqT3,10,10,5,0,1,12,13,0,41,5.857142857142857,2,0.0,2,5,0,1,8,12,0,13,0,8,33,1
21139,194810,mNLR1O6gqXF6Zqi4uIf130gITni9gN1A,SpATywNh6bZuzm8s1ceuBUnMUAeoAHHw,7,3,2,0,2,0,2,0,9,1.2857142857142858,1,0.0,0,2,0,2,3,0,0,2,0,4,5,0
21140,194813,pFd3DZfpKrECGIK8sknjrUy2fJFwKULW,G8EPVSXsOYB5YQWZGiz1aVq5Pgr2GrQu,2,0,0,0,0,0,3,0,3,0.42857142857142855,1,0.0,0,0,0,0,0,0,0,3,0,0,3,1
21141,194817,7HNfi5OY69fAwtBXY2Bx1G7GFcGZh7Ly,SpATywNh6bZuzm8s1ceuBUnMUAeoAHHw,1,0,0,0,0,0,1,0,1,0.14285714285714285,1,0.0,0,0,0,0,0,0,0,1,0,0,1,1
21142,194820,W3q5xabVGlYtHwCF6azkr4rDuBoAdzu5,SpATywNh6bZuzm8s1ceuBUnMUAeoAHHw,4,2,1,0,1,0,1,0,5,0.7142857142857143,1,0.0,0,1,0,1,2,0,0,1,0,2,3,1
21143,194822,oLy9nBdTYL8NCOYS922zyTRG6EziMvh0,SpATywNh6bZuzm8s1ceuBUnMUAeoAHHw,5,2,1,0,1,0,2,0,6,0.8571428571428571,1,0.0,0,1,0,1,2,0,0,2,0,2,4,1
21144,194837,h1POuqYbxnxgGkE4pWe2S8wS54aC8n19,SpATywNh6bZuzm8s1ceuBUnMUAeoAHHw,7,2,1,0,1,1,4,1,10,1.4285714285714286,1,0.0,0,1,0,1,2,1,0,4,1,2,8,1
21145,194844,V6I2tWMT4J6OaEfYWYGJXMvy6YbJ0vQk,RXDvfPUBYFlVdlueBFbLW0mhhAyGEqpt,1,0,0,0,0,0,1,0,1,0.14285714285714285,1,0.0,0,0,0,0,0,0,0,1,0,0,1,1
21146,194852,nq0fTUXEyf4zNsnzbVQxJGqu2ei3Zzxd,SpATywNh6bZuzm8s1ceuBUnMUAeoAHHw,1,0,0,0,0,0,1,0,1,0.14285714285714285,1,0.0,0,0,0,0,0,0,0,1,0,0,1,1
21147,194853,SSxnRLkRY8Nz6yCXbxisiyKLbaiWbjIK,bWdj2GDclj5ofokWjzoa5jAwMkxCykd6,1,0,0,0,0,0,1,0,1,0.14285714285714285,1,0.0,0,0,0,0,0,0,0,1,0,0,1,1
21148,194862,cW4Q7k8uorP2ZaATVwEYmHiYgqZDhGz3,SpATywNh6bZuzm8s1ceuBUnMUAeoAHHw,5,2,1,0,1,2,2,0,8,1.1428571428571428,1,0.0,0,1,0,1,2,2,0,2,0,2,6,1
21149,194870,4sHw1UrsiyaJNXlPeVCwFs89kPI7rFXb,RXDvfPUBYFlVdlueBFbLW0mhhAyGEqpt,1,0,0,0,0,0,1,0,1,0.14285714285714285,1,0.0,0,0,0,0,0,0,0,1,0,0,1,1
21150,194886,AYPzYs86vNA5oOhv1GafopaYTci4zq2u,SpATywNh6bZuzm8s1ceuBUnMUAeoAHHw,3,3,0,0,0,0,2,0,5,0.7142857142857143,1,0.0,0,0,0,0,3,0,0,2,0,0,5,1
21151,194887,QUGraFxtzCQNNKP2kQzaB6kauOeKIjbk,SpATywNh6bZuzm8s1ceuBUnMUAeoAHHw,5,2,1,0,1,0,2,0,6,0.8571428571428571,1,0.0,0,1,0,1,2,0,0,2,0,2,4,1
21152,194888,nfvdVPsl73HsB5v26CK2d3kpAhmyAPaZ,SpATywNh6bZuzm8s1ceuBUnMUAeoAHHw,2,0,0,0,0,0,2,0,2,0.2857142857142857,1,0.0,0,0,0,0,0,0,0,2,0,0,2,1
21153,194896,50aSuabL02e7lLNBHTRXsMQnBChV2lSX,SpATywNh6bZuzm8s1ceuBUnMUAeoAHHw,9,4,3,0,3,0,2,0,12,1.7142857142857142,1,0.0,0,3,0,3,4,0,0,2,0,6,6,0
21154,194907,r8kATVhVTFWwFIt4UfjEkmBJAJ9dIcZn,SpATywNh6bZuzm8s1ceuBUnMUAeoAHHw,11,10,3,0,1,6,8,2,30,4.285714285714286,1,0.0,4,3,0,1,6,6,0,8,2,8,22,1
21155,194908,FtHUJIDgcRIKvAk6G0aJG28BljfTCpR1,SpATywNh6bZuzm8s1ceuBUnMUAeoAHHw,3,0,0,0,0,2,2,0,4,0.5714285714285714,1,0.0,0,0,0,0,0,2,0,2,0,0,4,1
21156,194921,coZTr10eytnE55me2AxqRWq6qrVXEB7M,bWdj2GDclj5ofokWjzoa5jAwMkxCykd6,1,0,0,0,0,0,1,0,1,0.14285714285714285,1,0.0,0,0,0,0,0,0,0,1,0,0,1,1
21157,194930,4pOcM6UwGexWSApv8Q2hzDn3Wxf1tNaX,G8EPVSXsOYB5YQWZGiz1aVq5Pgr2GrQu,2,0,0,0,0,0,4,0,4,0.5714285714285714,1,0.0,0,0,0,0,0,0,0,4,0,0,4,1
21158,194932,XzsCpdFAPGr3HoHuPSOeqUJ9vrQ1cDvx,SpATywNh6bZuzm8s1ceuBUnMUAeoAHHw,1,0,0,0,0,0,1,0,1,0.14285714285714285,1,0.0,0,0,0,0,0,0,0,1,0,0,1,1
21159,194941,WOgCErvth3RYtZvlZwUgSVLnOS4A1Eul,SpATywNh6bZuzm8s1ceuBUnMUAeoAHHw,1,0,0,0,0,0,1,0,1,0.14285714285714285,1,0.0,0,0,0,0,0,0,0,1,0,0,1,1
21160,194948,gDo9M8HDbXmLQPxqqLTsn9N4ZUEPKvcn,SpATywNh6bZuzm8s1ceuBUnMUAeoAHHw,7,10,1,0,0,0,2,0,13,1.8571428571428572,1,0.0,3,1,0,0,7,0,0,2,0,4,9,1
21161,194949,88fLpsc97HhNfdaSPlKqNnhAVgW27BAo,SpATywNh6bZuzm8s1ceuBUnMUAeoAHHw,5,3,0,0,0,0,3,1,7,1.0,1,0.0,0,0,0,0,3,0,0,3,1,0,7,1
21162,194965,FuiskmcpMN6lu4pckLk8iCQBFUYbh2yw,G8EPVSXsOYB5YQWZGiz1aVq5Pgr2GrQu,6,3,1,0,1,0,2,0,7,1.0,1,0.0,0,1,0,1,3,0,0,2,0,2,5,1
21163,194968,Jx42Ejc8m7xjALEiD0Ys2DAnttPYIxMG,A3fsA9Zfv1X2fVEQhTw51lKENdNrEqT3,17,14,0,0,0,12,7,1,34,4.857142857142857,1,0.0,1,0,0,0,13,12,0,7,1,1,33,1
21164,194972,sESOR36K7nBM311FFRUj2nLw7gbYwiJz,SpATywNh6bZuzm8s1ceuBUnMUAeoAHHw,7,7,3,0,2,0,3,0,15,2.142857142857143,1,0.0,1,3,0,2,6,0,0,3,0,6,9,1
21165,194974,Io5gLr8QOxaBw8nFReloAXOpt3IlZ5WE,bWdj2GDclj5ofokWjzoa5jAwMkxCykd6,1,0,0,0,0,0,1,0,1,0.14285714285714285,1,0.0,0,0,0,0,0,0,0,1,0,0,1,1
21166,194975,Io5gLr8QOxaBw8nFReloAXOpt3IlZ5WE,A3fsA9Zfv1X2fVEQhTw51lKENdNrEqT3,1,0,0,0,0,0,1,0,1,0.14285714285714285,1,0.0,0,0,0,0,0,0,0,1,0,0,1,1
21167,194980,z2EPdF3qYcFLBwhpfABa73PTR23asQuU,A3fsA9Zfv1X2fVEQhTw51lKENdNrEqT3,9,3,1,0,1,2,7,1,15,2.142857142857143,1,0.0,0,1,0,1,3,2,0,7,1,2,13,1
21168,194982,1GEou0jUAwSZvf4K9js5E10dDnbmQpAC,A3fsA9Zfv1X2fVEQhTw51lKENdNrEqT3,8,2,1,0,1,0,5,1,10,1.4285714285714286,1,0.0,0,1,0,1,2,0,0,5,1,2,8,1
21169,194988,uiws4KxaJyhkKSkkHMDme11rXJg9xyaL,SpATywNh6bZuzm8s1ceuBUnMUAeoAHHw,11,13,7,0,4,2,13,1,40,5.714285714285714,1,0.0,3,7,0,4,10,2,0,13,1,14,26,1
21170,195002,LfNMIOZFn9FNdYWiUKFIdgjlnXx6yIVQ,SpATywNh6bZuzm8s1ceuBUnMUAeoAHHw,12,14,1,2,1,0,6,0,24,3.4285714285714284,1,0.0,0,1,2,1,14,0,0,6,0,4,20,1
21171,195013,Y8EaHrodQDFZUcVDuYNEubkGRhsaWq8Y,RXDvfPUBYFlVdlueBFbLW0mhhAyGEqpt,6,0,0,0,0,0,10,3,13,1.8571428571428572,1,0.0,0,0,0,0,0,0,0,10,3,0,13,1
21172,195022,0FxfzBL8lExhKYYcGcci82l6xBLomyet,SpATywNh6bZuzm8s1ceuBUnMUAeoAHHw,9,5,4,0,4,0,3,0,16,2.2857142857142856,1,0.0,0,4,0,4,5,0,0,3,0,8,8,1
21173,195029,3bqYNHEttQnrSXCOjNHPi8cuvQEsNCSU,bWdj2GDclj5ofokWjzoa5jAwMkxCykd6,1,0,0,0,0,0,1,0,1,0.14285714285714285,1,0.0,0,0,0,0,0,0,0,1,0,0,1,1
21174,195031,2wS8JVpw1CsKg56Cx9G9VOnhu3l1G4I0,SpATywNh6bZuzm8s1ceuBUnMUAeoAHHw,17,21,11,15,4,9,8,2,70,10.0,1,0.0,4,11,14,4,17,9,1,8,2,33,37,1
21175,195033,IPw8SBo730f13L9fdyPJQsRb6dxi5glI,G8EPVSXsOYB5YQWZGiz1aVq5Pgr2GrQu,7,6,0,0,0,0,2,0,8,1.1428571428571428,1,0.0,0,0,0,0,6,0,0,2,0,0,8,1
21176,195036,A8zAoi2Uw9AkuLfLEgj43RiYhGLMNj18,SpATywNh6bZuzm8s1ceuBUnMUAeoAHHw,5,5,1,0,1,0,1,0,8,1.1428571428571428,1,0.0,0,1,0,1,5,0,0,1,0,2,6,1
21177,195039,I9J4QWiXHWCNKaic0XgJQZKgGASYH4yX,SpATywNh6bZuzm8s1ceuBUnMUAeoAHHw,7,6,4,0,3,0,1,0,14,2.0,1,0.0,0,4,0,3,6,0,0,1,0,7,7,1
21178,195040,B8Q6zzQbCDmmGJ2Jkpuj3FBNKJuawYVo,G8EPVSXsOYB5YQWZGiz1aVq5Pgr2GrQu,4,4,0,0,0,0,2,0,6,0.8571428571428571,1,0.0,0,0,0,0,4,0,0,2,0,0,6,1
21179,195057,NikqZ1qZg3zBUaGWiNf6mGXz34uqYANW,bWdj2GDclj5ofokWjzoa5jAwMkxCykd6,7,3,1,0,1,0,5,6,16,2.2857142857142856,1,0.0,1,1,0,1,2,0,0,5,6,3,13,1
21180,195059,4LHx8JspDAj57obmMYSAAyDYEzuHjEJP,A3fsA9Zfv1X2fVEQhTw51lKENdNrEqT3,2,0,0,0,0,0,2,0,2,0.2857142857142857,1,0.0,0,0,0,0,0,0,0,2,0,0,2,1
21181,195062,9YkZ5i0tAbds4GKPFoxObCx79Yv0yxVA,G8EPVSXsOYB5YQWZGiz1aVq5Pgr2GrQu,22,21,13,26,7,1,4,0,72,10.285714285714286,1,0.0,6,13,19,7,15,1,7,4,0,45,27,0
21182,195066,xsq0NNhfMlJSps1up5uJcRMXvgRrV0sJ,SpATywNh6bZuzm8s1ceuBUnMUAeoAHHw,1,0,0,0,0,0,1,0,1,0.14285714285714285,1,0.0,0,0,0,0,0,0,0,1,0,0,1,1
21183,195089,qX3w4IgztgXyu9swieirFObama3kJyza,SpATywNh6bZuzm8s1ceuBUnMUAeoAHHw,2,0,0,0,0,0,3,0,3,0.42857142857142855,1,0.0,0,0,0,0,0,0,0,3,0,0,3,1
21184,195091,L8lHLh6Mth1S7I3sErP5oDZD885a1BOh,SpATywNh6bZuzm8s1ceuBUnMUAeoAHHw,5,3,2,0,2,0,2,0,9,1.2857142857142858,1,0.0,0,2,0,2,3,0,0,2,0,4,5,1
21185,195092,aBOCGRJtSTLes0jxdeecmLlgi9rWLU2d,SpATywNh6bZuzm8s1ceuBUnMUAeoAHHw,4,1,0,0,0,0,3,0,4,0.5714285714285714,1,0.0,0,0,0,0,1,0,0,3,0,0,4,1
21186,195103,vxGkTn6WfGBki29hwuSV6Xuc1hbgzs4I,SpATywNh6bZuzm8s1ceuBUnMUAeoAHHw,1,0,0,0,0,0,1,0,1,0.14285714285714285,1,0.0,0,0,0,0,0,0,0,1,0,0,1,1
21187,195104,90Hur8PGj0IjqXgPOcR65ST1YxNz0ds7,A3fsA9Zfv1X2fVEQhTw51lKENdNrEqT3,12,9,3,0,2,0,7,1,22,3.142857142857143,2,0.0,0,3,0,2,9,0,0,7,1,5,17,1
21188,195119,aWAFF1Fze4LYlsUU8ERMTgVYzoyOI6Lv,SpATywNh6bZuzm8s1ceuBUnMUAeoAHHw,5,3,0,0,1,0,1,0,5,0.7142857142857143,1,0.0,0,0,0,1,3,0,0,1,0,1,4,1
21189,195127,jg3jOKfanNJPAzYxAIsKTejRcuHuYakD,SpATywNh6bZuzm8s1ceuBUnMUAeoAHHw,2,1,0,0,0,0,1,0,2,0.2857142857142857,1,0.0,0,0,0,0,1,0,0,1,0,0,2,1
21190,195132,TAT1t0HA0deInUIqMQU3qN2hNwJUolWn,SpATywNh6bZuzm8s1ceuBUnMUAeoAHHw,10,8,6,3,4,0,2,0,23,3.2857142857142856,1,0.0,1,6,3,4,7,0,0,2,0,14,9,1
21191,195149,lxP21JAeoGw4N8j8NgjQVcD64XYgvMHQ,SpATywNh6bZuzm8s1ceuBUnMUAeoAHHw,3,2,0,0,0,0,1,0,3,0.42857142857142855,1,0.0,0,0,0,0,2,0,0,1,0,0,3,1
21192,195158,YwfI8H5GXP8M3NnSeLcRy7i15qMPqaXk,SpATywNh6bZuzm8s1ceuBUnMUAeoAHHw,7,4,1,0,1,0,3,1,10,1.4285714285714286,1,0.0,0,1,0,1,4,0,0,3,1,2,8,1
21193,195169,S3f0JK9oaNTPyiRDrmkpSKmLckAAblqI,SpATywNh6bZuzm8s1ceuBUnMUAeoAHHw,6,5,3,0,1,0,1,0,10,1.4285714285714286,1,0.0,0,3,0,1,5,0,0,1,0,4,6,1
21194,195174,iXadVTWz0gSvLWs1uknu7xrsEL401uhz,SpATywNh6bZuzm8s1ceuBUnMUAeoAHHw,3,0,0,0,0,0,3,0,3,0.42857142857142855,1,0.0,0,0,0,0,0,0,0,3,0,0,3,1
21195,195175,02LTWEFxRPP3VB0zkhjBsebsLQ1XAvEO,G8EPVSXsOYB5YQWZGiz1aVq5Pgr2GrQu,1,0,0,0,0,0,1,0,1,0.14285714285714285,1,0.0,0,0,0,0,0,0,0,1,0,0,1,1
21196,195179,xEHo4X1rukdspRGBdfJyX5P4IZVyDEcz,SpATywNh6bZuzm8s1ceuBUnMUAeoAHHw,7,3,2,0,2,0,2,0,9,1.2857142857142858,1,0.0,0,2,0,2,3,0,0,2,0,4,5,1
21197,195184,NtEul7SVttJozgojuYe5lpg4GBGEyM2O,G8EPVSXsOYB5YQWZGiz1aVq5Pgr2GrQu,6,0,0,0,0,1,5,1,7,1.0,1,0.0,0,0,0,0,0,1,0,5,1,0,7,1
21198,195208,L2VtKU10xoYfk9AeXI4ucBlRANoxyJAj,SpATywNh6bZuzm8s1ceuBUnMUAeoAHHw,7,30,3,0,0,0,7,0,40,5.714285714285714,1,0.0,0,3,0,0,30,0,0,7,0,3,37,1
21199,195219,Nvud1QIhR4FBjW055r9HSxywupZk5GAR,RXDvfPUBYFlVdlueBFbLW0mhhAyGEqpt,10,6,1,0,1,0,6,3,17,2.4285714285714284,1,0.0,0,1,0,1,6,0,0,6,3,2,15,0
21200,195223,jtdJ8s2kyNzwf06KTNChcN9oAOS9ZmYk,A3fsA9Zfv1X2fVEQhTw51lKENdNrEqT3,8,5,2,0,2,0,3,0,12,1.7142857142857142,1,0.0,0,2,0,2,5,0,0,3,0,4,8,1
21201,195227,bONRCO0uATZ9orvOXASjWia0swY9AaMZ,A3fsA9Zfv1X2fVEQhTw51lKENdNrEqT3,6,2,1,0,1,0,8,0,12,1.7142857142857142,1,0.0,0,1,0,1,2,0,0,8,0,2,10,1
21202,195231,8qABUnBBHxxZkfUhEQNUn5NNMSRrqvPC,A3fsA9Zfv1X2fVEQhTw51lKENdNrEqT3,7,8,5,0,0,0,2,0,15,2.142857142857143,2,0.0,0,5,0,0,8,0,0,2,0,5,10,1
21203,195235,fIET0xNMcDIlnjd0AnC9TZEnn5s3AA6i,G8EPVSXsOYB5YQWZGiz1aVq5Pgr2GrQu,21,23,5,18,4,1,5,0,56,8.0,1,0.0,15,5,9,4,8,1,9,5,0,33,23,1
21204,195240,nhwZ1i3tBLPpKZ1jf7waw2ZZrzqPTraF,A3fsA9Zfv1X2fVEQhTw51lKENdNrEqT3,1,0,0,0,0,0,2,0,2,0.2857142857142857,1,0.0,0,0,0,0,0,0,0,2,0,0,2,1
21205,195246,hNV2TDc5kXTQn8foo4aRN6FCIXLNr4nn,SpATywNh6bZuzm8s1ceuBUnMUAeoAHHw,6,0,0,0,0,1,6,1,8,1.1428571428571428,1,0.0,0,0,0,0,0,1,0,6,1,0,8,1
21206,195253,K6R10YCm4EKgUGnQY53FYbuIV8YOCHd6,A3fsA9Zfv1X2fVEQhTw51lKENdNrEqT3,14,11,9,0,6,0,3,0,29,4.142857142857143,1,0.0,0,9,0,6,11,0,0,3,0,15,14,1
21207,195255,nFy3S5ktNxWHxSxQEsVxABtdYtTHm2QG,SpATywNh6bZuzm8s1ceuBUnMUAeoAHHw,10,6,1,6,0,0,5,0,18,2.5714285714285716,1,0.0,1,1,5,0,5,0,1,5,0,7,11,1
21208,195259,7dlRqTed9Vz3lG7sCkGqwL4Rf479l4Lf,SpATywNh6bZuzm8s1ceuBUnMUAeoAHHw,3,2,0,0,0,0,1,0,3,0.42857142857142855,1,0.0,0,0,0,0,2,0,0,1,0,0,3,1
21209,195260,sbaJoVFlMLyfg1PbRG67GWzU7ygSqHEa,G8EPVSXsOYB5YQWZGiz1aVq5Pgr2GrQu,4,6,0,0,0,0,4,0,10,1.4285714285714286,1,0.0,0,0,0,0,6,0,0,4,0,0,10,0
21210,195275,JIBg2bFQYc7ncSPQhvBWrAlcobShyiXA,SpATywNh6bZuzm8s1ceuBUnMUAeoAHHw,11,8,1,11,0,0,3,1,24,3.4285714285714284,1,0.0,2,1,10,0,6,0,1,3,1,13,11,1
21211,195278,8cxCnT3STAEth9x4HzjOcerWufkhGlX3,A3fsA9Zfv1X2fVEQhTw51lKENdNrEqT3,1,0,0,0,0,0,1,0,1,0.14285714285714285,1,0.0,0,0,0,0,0,0,0,1,0,0,1,1
21212,195303,ouhJVRUNWH7xFlD4xC7qUWcBbb5kOVSM,SpATywNh6bZuzm8s1ceuBUnMUAeoAHHw,7,3,0,0,0,0,8,0,11,1.5714285714285714,1,0.0,0,0,0,0,3,0,0,8,0,0,11,1
21213,195307,3PN3AyL6tfmtfTSkHxR5sSs7QxGCrkua,SpATywNh6bZuzm8s1ceuBUnMUAeoAHHw,1,0,0,0,0,0,1,0,1,0.14285714285714285,1,0.0,0,0,0,0,0,0,0,1,0,0,1,1
21214,195309,qqPuA4adS4zWJNjZeIJQCgaT64XJRtor,A3fsA9Zfv1X2fVEQhTw51lKENdNrEqT3,32,31,16,14,11,8,8,0,88,12.571428571428571,1,0.0,0,16,13,11,31,8,1,8,0,40,48,1
21215,195318,ee58foeX64HQVEJT3urOlMI7BjSHbs8j,G8EPVSXsOYB5YQWZGiz1aVq5Pgr2GrQu,5,5,0,0,0,0,4,0,9,1.2857142857142858,1,0.0,0,0,0,0,5,0,0,4,0,0,9,1
21216,195323,PQAJu1VB3GuaUzJI11vB182M1L2se1PX,SpATywNh6bZuzm8s1ceuBUnMUAeoAHHw,10,3,2,0,2,1,6,2,16,2.2857142857142856,1,0.0,0,2,0,2,3,1,0,6,2,4,12,1
21217,195326,0Si73COGxildPoctZYuOxLe1rgf9eDaM,RXDvfPUBYFlVdlueBFbLW0mhhAyGEqpt,8,3,1,0,1,0,3,0,8,1.1428571428571428,1,0.0,0,1,0,1,3,0,0,3,0,2,6,1
21218,195328,kKCWVPsmOCuRmD5n3b0FhPNIyXfeeMNV,SpATywNh6bZuzm8s1ceuBUnMUAeoAHHw,3,2,0,0,0,0,1,0,3,0.42857142857142855,1,0.0,0,0,0,0,2,0,0,1,0,0,3,1
21219,195336,cA8asOLHRHcK3Kr0VMyGtrDdcfovAiM5,A3fsA9Zfv1X2fVEQhTw51lKENdNrEqT3,21,11,10,0,8,0,3,0,32,4.571428571428571,1,0.0,1,10,0,8,10,0,0,3,0,19,13,1
21220,195357,rYmd6vnR5Pxkj69jVuGfihv9dJd27d4j,SpATywNh6bZuzm8s1ceuBUnMUAeoAHHw,7,3,2,0,2,0,2,0,9,1.2857142857142858,1,0.0,0,2,0,2,3,0,0,2,0,4,5,1
21221,195359,v4pwVH1VWldeBobir3iEqSHO6IoG1mdb,SpATywNh6bZuzm8s1ceuBUnMUAeoAHHw,14,17,6,12,4,0,2,0,41,5.857142857142857,1,0.0,4,6,11,4,13,0,1,2,0,25,16,1
21222,195361,v4pwVH1VWldeBobir3iEqSHO6IoG1mdb,A3fsA9Zfv1X2fVEQhTw51lKENdNrEqT3,10,9,3,0,3,0,2,0,17,2.4285714285714284,1,0.0,0,3,0,3,9,0,0,2,0,6,11,1
21223,195368,YPWJVK9ueaONJH89FoDwiyUXkyNj3an5,SpATywNh6bZuzm8s1ceuBUnMUAeoAHHw,7,3,2,0,2,0,2,0,9,1.2857142857142858,1,0.0,0,2,0,2,3,0,0,2,0,4,5,1
21224,195397,Px3zRsOzY6lifmzZgnqcwuqsaYej1KKL,A3fsA9Zfv1X2fVEQhTw51lKENdNrEqT3,1,0,0,0,0,0,1,0,1,0.14285714285714285,1,0.0,0,0,0,0,0,0,0,1,0,0,1,0
21225,195413,bvN6XOPoER6NVEf5NoGSs2X6xsEr92h3,SpATywNh6bZuzm8s1ceuBUnMUAeoAHHw,8,3,1,0,1,0,4,1,10,1.4285714285714286,1,0.0,0,1,0,1,3,0,0,4,1,2,8,1
21226,195423,5qPjBVti4pvxDDFGs1UFTjnAG1OLcLcB,RXDvfPUBYFlVdlueBFbLW0mhhAyGEqpt,3,2,0,0,0,0,1,0,3,0.42857142857142855,1,0.0,0,0,0,0,2,0,0,1,0,0,3,1
21227,195425,izM8opj3xJHFbPsERjrPScHIIGoVU3sL,SpATywNh6bZuzm8s1ceuBUnMUAeoAHHw,6,0,0,0,0,1,12,1,14,2.0,1,0.0,0,0,0,0,0,1,0,12,1,0,14,1
21228,195430,fHIOg4CLMDgqxwisMJ0FCaIJdtYNnnlj,SpATywNh6bZuzm8s1ceuBUnMUAeoAHHw,4,2,1,0,1,0,1,0,5,0.7142857142857143,1,0.0,0,1,0,1,2,0,0,1,0,2,3,1
21229,195432,LICyXxeZEgLwXHk4xrNu6rCpPIKDNqKx,bWdj2GDclj5ofokWjzoa5jAwMkxCykd6,4,0,0,0,0,2,3,1,6,0.8571428571428571,1,0.0,0,0,0,0,0,2,0,3,1,0,6,0
21230,195452,k57D5r1HBQsYTFYwjCvC4VLOFbsyC3KY,bWdj2GDclj5ofokWjzoa5jAwMkxCykd6,5,2,1,0,1,0,2,0,6,0.8571428571428571,1,0.0,0,1,0,1,2,0,0,2,0,2,4,1
21231,195453,k57D5r1HBQsYTFYwjCvC4VLOFbsyC3KY,A3fsA9Zfv1X2fVEQhTw51lKENdNrEqT3,9,4,3,0,3,0,2,0,12,1.7142857142857142,1,0.0,0,3,0,3,4,0,0,2,0,6,6,1
21232,195458,fp4riRNidjgqRkLYeMfperPsuliabiil,A3fsA9Zfv1X2fVEQhTw51lKENdNrEqT3,2,0,0,0,0,0,2,0,2,0.2857142857142857,1,0.0,0,0,0,0,0,0,0,2,0,0,2,1
21233,195463,Vc1baHxuYCOF9wXqOziB65UR0NyB8LSm,A3fsA9Zfv1X2fVEQhTw51lKENdNrEqT3,4,2,1,0,1,0,1,0,5,0.7142857142857143,1,0.0,0,1,0,1,2,0,0,1,0,2,3,1
21234,195471,VCHjbUg5mmZIrDffSGKLebg8S6dLXnyn,SpATywNh6bZuzm8s1ceuBUnMUAeoAHHw,2,0,0,0,0,0,2,0,2,0.2857142857142857,1,0.0,0,0,0,0,0,0,0,2,0,0,2,1
21235,195475,VCHjbUg5mmZIrDffSGKLebg8S6dLXnyn,RXDvfPUBYFlVdlueBFbLW0mhhAyGEqpt,2,0,0,0,0,0,2,0,2,0.2857142857142857,1,0.0,0,0,0,0,0,0,0,2,0,0,2,0
21236,195495,s6FY1tnJFeJCup1Eko54ROGWiTGeTtYm,bWdj2GDclj5ofokWjzoa5jAwMkxCykd6,1,0,0,0,0,0,1,0,1,0.14285714285714285,1,0.0,0,0,0,0,0,0,0,1,0,0,1,1
21237,195497,s6FY1tnJFeJCup1Eko54ROGWiTGeTtYm,A3fsA9Zfv1X2fVEQhTw51lKENdNrEqT3,2,0,0,0,0,0,2,0,2,0.2857142857142857,1,0.0,0,0,0,0,0,0,0,2,0,0,2,1
21238,195501,Sy7PnSgnanE6MmRmOk45JZv7731jQKG6,SpATywNh6bZuzm8s1ceuBUnMUAeoAHHw,4,3,0,0,0,0,3,0,6,0.8571428571428571,1,0.0,0,0,0,0,3,0,0,3,0,0,6,1
21239,195511,KzP79COW0J6jugsTdx8JCjyWx6PlJCcn,bWdj2GDclj5ofokWjzoa5jAwMkxCykd6,4,0,0,0,0,1,3,0,4,0.5714285714285714,1,0.0,0,0,0,0,0,1,0,3,0,0,4,1
21240,195530,OuoRlyFtQHB6CBdOhxOFsh6hGiNcDFNC,SpATywNh6bZuzm8s1ceuBUnMUAeoAHHw,1,0,0,0,0,0,1,0,1,0.14285714285714285,1,0.0,0,0,0,0,0,0,0,1,0,0,1,1
21241,195542,BXV7sGq2IrRSqCFuLKgoxpKYDPSPpUSj,SpATywNh6bZuzm8s1ceuBUnMUAeoAHHw,9,3,2,0,1,0,6,1,13,1.8571428571428572,1,0.0,0,2,0,1,3,0,0,6,1,3,10,1
21242,195544,BXV7sGq2IrRSqCFuLKgoxpKYDPSPpUSj,G8EPVSXsOYB5YQWZGiz1aVq5Pgr2GrQu,1,0,0,0,0,0,1,0,1,0.14285714285714285,1,0.0,0,0,0,0,0,0,0,1,0,0,1,1
21243,195552,xNnZt1wpctMu8RWBLbfzbKE1cqLvtEr3,G8EPVSXsOYB5YQWZGiz1aVq5Pgr2GrQu,1,0,0,0,0,0,1,0,1,0.14285714285714285,1,0.0,0,0,0,0,0,0,0,1,0,0,1,1
21244,195557,23A4h0mJIxgdd7Lfc0ogX2OGnwyxoL13,SpATywNh6bZuzm8s1ceuBUnMUAeoAHHw,5,9,1,0,1,0,1,0,12,1.7142857142857142,1,0.0,0,1,0,1,9,0,0,1,0,2,10,1
21245,195558,xUhDcXiX03QQg1jNR3Lksh9CrGcRUkPg,SpATywNh6bZuzm8s1ceuBUnMUAeoAHHw,1,0,0,0,0,0,1,0,1,0.14285714285714285,1,0.0,0,0,0,0,0,0,0,1,0,0,1,0
21246,195562,mfr902ctNImyZnb2hOpmu3P3IkYTM2W3,G8EPVSXsOYB5YQWZGiz1aVq5Pgr2GrQu,37,55,14,64,7,0,1,0,141,20.142857142857142,1,0.0,32,14,43,7,23,0,21,1,0,96,45,1
21247,195570,UcPGwduguQweVEpy1bHMRcDAVjaxDzZ7,G8EPVSXsOYB5YQWZGiz1aVq5Pgr2GrQu,7,3,2,0,2,0,2,0,9,1.2857142857142858,1,0.0,0,2,0,2,3,0,0,2,0,4,5,1
21248,195572,SSpeewBDHUNKkvUJM5ASinNHvMXIOEwr,A3fsA9Zfv1X2fVEQhTw51lKENdNrEqT3,2,0,0,0,0,2,2,0,4,0.5714285714285714,1,0.0,0,0,0,0,0,2,0,2,0,0,4,1
21249,195578,K7h76kiU4XN1zBV50oc4eRwwsA0rbRLb,5X6FeZozNMgE2VRi3MJYjkkFK8SETtu2,2,0,0,0,0,0,5,0,5,0.7142857142857143,1,0.0,0,0,0,0,0,0,0,5,0,0,5,1
21250,195592,hLB5PUIgFnlLvby1vFNFDJpG89oERQ28,5X6FeZozNMgE2VRi3MJYjkkFK8SETtu2,2,0,0,0,0,0,2,0,2,0.2857142857142857,1,0.0,0,0,0,0,0,0,0,2,0,0,2,1
21251,195601,fJHDc0QLJ0UKI9btxXZoKpZDigsPyCSM,5X6FeZozNMgE2VRi3MJYjkkFK8SETtu2,1,0,0,0,0,0,1,0,1,0.14285714285714285,1,0.0,0,0,0,0,0,0,0,1,0,0,1,1
21252,195616,Kcq3gQRtZRNf9DA8M7wqRqrJH838UPPz,7GRhBDsirIGkRZBtSMEzNTyDr2JQm4xx,17,30,12,6,5,17,8,0,78,11.142857142857142,1,0.0,8,12,3,5,22,17,3,8,0,28,50,1
21253,195619,DS74xqPNpZwZQjbZ7YGZYJfVghg7Q9HH,7GRhBDsirIGkRZBtSMEzNTyDr2JQm4xx,5,3,1,0,1,0,2,0,7,1.0,1,0.0,1,1,0,1,2,0,0,2,0,3,4,1
21254,195622,Tcaf2GTbOMScFZKlh1LFlKzosiyvJhfT,7GRhBDsirIGkRZBtSMEzNTyDr2JQm4xx,1,0,0,0,0,0,1,0,1,0.14285714285714285,1,0.0,0,0,0,0,0,0,0,1,0,0,1,1
21255,195627,nZa0Tm4oTt6ndXCyLFJJCwzGAKd2GkTC,5X6FeZozNMgE2VRi3MJYjkkFK8SETtu2,1,0,0,0,0,0,2,0,2,0.2857142857142857,1,0.0,0,0,0,0,0,0,0,2,0,0,2,1
21256,195648,juzfwxHXCKii6ul7funGUBQbDVPCyrBB,7GRhBDsirIGkRZBtSMEzNTyDr2JQm4xx,1,0,0,0,0,0,1,0,1,0.14285714285714285,1,0.0,0,0,0,0,0,0,0,1,0,0,1,1
21257,195706,C800geUBh3GYBhoh4cW6ReKUGj5LAMGi,5X6FeZozNMgE2VRi3MJYjkkFK8SETtu2,1,0,0,0,0,0,1,0,1,0.14285714285714285,1,0.0,0,0,0,0,0,0,0,1,0,0,1,1
21258,195720,GWmVmhZO8RKaiQ4dKIoawnWCScVz2MBi,7GRhBDsirIGkRZBtSMEzNTyDr2JQm4xx,2,0,0,0,0,0,2,0,2,0.2857142857142857,1,0.0,0,0,0,0,0,0,0,2,0,0,2,1
21259,195758,MpTAgw3ozhmeD7C8xc95FgAYRb7j4nGM,7GRhBDsirIGkRZBtSMEzNTyDr2JQm4xx,3,2,1,0,0,0,2,0,5,0.7142857142857143,1,0.0,0,1,0,0,2,0,0,2,0,1,4,1
21260,195772,E61JfTQnEaIkaCE4GRNSaG2A1gMqzhfA,7GRhBDsirIGkRZBtSMEzNTyDr2JQm4xx,1,0,0,0,0,0,1,0,1,0.14285714285714285,1,0.0,0,0,0,0,0,0,0,1,0,0,1,1
21261,195779,5AbPWjZ6ixqm6XZz56tS5VZ41TKzUcUl,7GRhBDsirIGkRZBtSMEzNTyDr2JQm4xx,1,0,0,0,0,0,1,0,1,0.14285714285714285,1,0.0,0,0,0,0,0,0,0,1,0,0,1,1
21262,195780,xyxmqhkuTJtB1dPu1gtPCQSBFbuRU8fb,7GRhBDsirIGkRZBtSMEzNTyDr2JQm4xx,9,6,0,4,0,1,6,3,20,2.857142857142857,1,0.0,2,0,3,0,4,1,1,6,3,5,15,1
21263,196254,VAITXrV1amXe1GhhhwMShh0VTtJzy2Yz,SpATywNh6bZuzm8s1ceuBUnMUAeoAHHw,17,42,1,0,1,0,2,0,46,6.571428571428571,1,0.0,0,1,0,1,42,0,0,2,0,2,44,1
21264,196272,SkecSbZBHKAGo2USROV1WAUf7HvtwuAI,SpATywNh6bZuzm8s1ceuBUnMUAeoAHHw,5,2,1,0,1,0,2,0,6,0.8571428571428571,1,0.0,0,1,0,1,2,0,0,2,0,2,4,1
21265,196273,9rDNIkTtvzF2FwoEIMtwAGkbMy9wjMFp,SpATywNh6bZuzm8s1ceuBUnMUAeoAHHw,1,0,0,0,0,0,1,0,1,0.14285714285714285,1,0.0,0,0,0,0,0,0,0,1,0,0,1,1
21266,196275,d15d0BZarFoBM80SRBgMSmWHMJCUlMK7,SpATywNh6bZuzm8s1ceuBUnMUAeoAHHw,5,1,0,0,1,0,3,0,5,0.7142857142857143,1,0.0,0,0,0,1,1,0,0,3,0,1,4,1
21267,196292,80qMwN2dfd5sERfBYHnuRbrvVaQ5Bk6G,bWdj2GDclj5ofokWjzoa5jAwMkxCykd6,1,0,0,0,0,0,1,0,1,0.14285714285714285,1,0.0,0,0,0,0,0,0,0,1,0,0,1,1
21268,196302,mWxcyMOCNLHJcixnZgZnYBd0dGZ8Df9s,SpATywNh6bZuzm8s1ceuBUnMUAeoAHHw,1,0,0,0,0,0,1,0,1,0.14285714285714285,1,0.0,0,0,0,0,0,0,0,1,0,0,1,1
21269,196325,nnYyB1E87FLd4EjVxJp25lmShfOxTs9x,SpATywNh6bZuzm8s1ceuBUnMUAeoAHHw,6,3,2,0,0,1,4,0,10,1.4285714285714286,1,0.0,0,2,0,0,3,1,0,4,0,2,8,1
21270,196326,Px3JrKmZd41gHkStDjeO27gVhyG6H9Jg,SpATywNh6bZuzm8s1ceuBUnMUAeoAHHw,15,31,12,12,1,0,2,0,58,8.285714285714286,1,0.0,12,12,12,1,19,0,0,2,0,37,21,1
21271,196332,hmQiOXi0OWvn5v2X2zEXr7r54TZskX5l,SpATywNh6bZuzm8s1ceuBUnMUAeoAHHw,5,2,1,0,1,0,2,0,6,0.8571428571428571,1,0.0,0,1,0,1,2,0,0,2,0,2,4,1
21272,196335,BXEKxoXoxulJe6lVUNmBzkuoxML0RzPQ,5X6FeZozNMgE2VRi3MJYjkkFK8SETtu2,1,0,0,0,0,0,1,0,1,0.14285714285714285,1,0.0,0,0,0,0,0,0,0,1,0,0,1,1
21273,196339,BXEKxoXoxulJe6lVUNmBzkuoxML0RzPQ,A3fsA9Zfv1X2fVEQhTw51lKENdNrEqT3,1,0,0,0,0,0,1,0,1,0.14285714285714285,1,0.0,0,0,0,0,0,0,0,1,0,0,1,1
21274,196348,9bpHf7Xj8OcUe4lMVYF5vOWYuwtloOIm,RXDvfPUBYFlVdlueBFbLW0mhhAyGEqpt,1,0,0,0,0,0,1,0,1,0.14285714285714285,1,0.0,0,0,0,0,0,0,0,1,0,0,1,1
21275,196350,lpSvQcQeloogGly9iaYnTUD0jXzht8xx,5X6FeZozNMgE2VRi3MJYjkkFK8SETtu2,8,13,9,0,1,1,6,0,30,4.285714285714286,1,0.0,0,9,0,1,13,1,0,6,0,10,20,1
21276,196360,EHb1g6rHAZsPWF8Gnr1xievV0vdAYt5Q,SpATywNh6bZuzm8s1ceuBUnMUAeoAHHw,14,13,1,0,1,0,2,0,17,2.4285714285714284,1,0.0,0,1,0,1,13,0,0,2,0,2,15,1
21277,196393,iJS4NO25TGJOkDkxwNThNbes0mRasAmQ,A3fsA9Zfv1X2fVEQhTw51lKENdNrEqT3,1,0,0,0,0,0,1,0,1,0.14285714285714285,1,0.0,0,0,0,0,0,0,0,1,0,0,1,1
21278,196425,RGCu1EjFajhpC8KngGiUHu3Aqmv6gwWd,G8EPVSXsOYB5YQWZGiz1aVq5Pgr2GrQu,4,0,0,0,0,0,6,1,7,1.0,1,0.0,0,0,0,0,0,0,0,6,1,0,7,1
21279,196434,qjVw5zdLNaHgDeIlRwuWiy2ktW0DybEV,RXDvfPUBYFlVdlueBFbLW0mhhAyGEqpt,5,2,1,0,1,0,2,0,6,0.8571428571428571,1,0.0,0,1,0,1,2,0,0,2,0,2,4,1
21280,196439,28zXrKQkPDF9YmLfOHrMy7Vkui9nCxRv,5X6FeZozNMgE2VRi3MJYjkkFK8SETtu2,5,0,0,0,0,0,6,1,7,1.0,1,0.0,0,0,0,0,0,0,0,6,1,0,7,1
21281,196441,omC1WQtxbGZUepbncMFIw7Iiq9lxKzdi,bWdj2GDclj5ofokWjzoa5jAwMkxCykd6,3,0,0,0,0,1,3,0,4,0.5714285714285714,1,0.0,0,0,0,0,0,1,0,3,0,0,4,1
21282,196475,XUIrRPCoeh3iLjZyoN7eqA99XDN4JBLH,A3fsA9Zfv1X2fVEQhTw51lKENdNrEqT3,1,0,0,0,0,0,1,0,1,0.14285714285714285,1,0.0,0,0,0,0,0,0,0,1,0,0,1,1
21283,196477,rVZTDDebI0kfxFTSroMAOzS2gGepwkHN,bWdj2GDclj5ofokWjzoa5jAwMkxCykd6,10,8,4,0,4,0,4,0,20,2.857142857142857,1,0.0,2,4,0,4,6,0,0,4,0,10,10,1
21284,196483,Oy0e7VrQWmT0KhQMBb1cQhS7OxdYueSs,SpATywNh6bZuzm8s1ceuBUnMUAeoAHHw,4,2,1,0,0,0,2,0,5,0.7142857142857143,1,0.0,0,1,0,0,2,0,0,2,0,1,4,1
21285,196487,so04UHX42q6jI3lvj3RNVSKJ1VPEH1YP,A3fsA9Zfv1X2fVEQhTw51lKENdNrEqT3,4,2,1,0,1,0,1,0,5,0.7142857142857143,1,0.0,0,1,0,1,2,0,0,1,0,2,3,1
21286,196498,UbPUJOqoO4HGgoQ4ctjETQ7ZwstvMoKV,SpATywNh6bZuzm8s1ceuBUnMUAeoAHHw,6,4,3,0,2,0,1,0,10,1.4285714285714286,1,0.0,0,3,0,2,4,0,0,1,0,5,5,1
21287,196504,f1i57ujvjE56HLLEyVKCTNhM7MGsdKXA,A3fsA9Zfv1X2fVEQhTw51lKENdNrEqT3,1,0,0,0,0,0,2,0,2,0.2857142857142857,1,0.0,0,0,0,0,0,0,0,2,0,0,2,1
21288,196521,sReE8PQxSu0jT8e2E2QnbI2BpiyFk2CX,G8EPVSXsOYB5YQWZGiz1aVq5Pgr2GrQu,13,16,4,18,0,0,2,0,40,5.714285714285714,1,0.0,11,4,11,0,5,0,7,2,0,26,14,1
21289,196531,QtoTN2OyyTcqe6Us4ENFLFoSg3hJkA40,G8EPVSXsOYB5YQWZGiz1aVq5Pgr2GrQu,1,0,0,0,0,0,1,0,1,0.14285714285714285,1,0.0,0,0,0,0,0,0,0,1,0,0,1,1
21290,196546,N1KM8ReNRnVme4r9NBubBSBJnD37tVCM,G8EPVSXsOYB5YQWZGiz1aVq5Pgr2GrQu,11,16,7,8,5,0,2,0,38,5.428571428571429,1,0.0,8,7,5,5,8,0,3,2,0,25,13,0
21291,196555,5IwzZuDN6Y4Qf5xqrDhtpG2TdC7SCWw3,SpATywNh6bZuzm8s1ceuBUnMUAeoAHHw,1,0,0,0,0,0,1,0,1,0.14285714285714285,1,0.0,0,0,0,0,0,0,0,1,0,0,1,1
21292,196583,LvtYQA0DoCvGQV35U4WWLrSMicEWVifD,SpATywNh6bZuzm8s1ceuBUnMUAeoAHHw,1,0,0,0,0,0,1,0,1,0.14285714285714285,1,0.0,0,0,0,0,0,0,0,1,0,0,1,1
21293,196587,zqPiN6fngW7il9FbWkBXYXifniNaXNn1,SpATywNh6bZuzm8s1ceuBUnMUAeoAHHw,7,8,4,0,2,0,3,0,17,2.4285714285714284,1,0.0,0,4,0,2,8,0,0,3,0,6,11,1
21294,196592,3vnu5JUiIQfwcWSSeAtE6dAgHCr6iqRo,5X6FeZozNMgE2VRi3MJYjkkFK8SETtu2,1,0,0,0,0,0,1,0,1,0.14285714285714285,1,0.0,0,0,0,0,0,0,0,1,0,0,1,1
21295,196604,ajdXJNtmFj3djCMALYMagt4EstfNGU3t,5X6FeZozNMgE2VRi3MJYjkkFK8SETtu2,12,9,7,0,3,0,4,0,23,3.2857142857142856,1,0.0,0,7,0,3,9,0,0,4,0,10,13,1
21296,196615,NMXa9Wia2ySruqcJB2iC203fj7cABa4b,SpATywNh6bZuzm8s1ceuBUnMUAeoAHHw,1,0,0,0,0,0,1,0,1,0.14285714285714285,1,0.0,0,0,0,0,0,0,0,1,0,0,1,1
21297,196622,dHF0lmwAWj90dNkEJgjhA3G1B2pjJava,A3fsA9Zfv1X2fVEQhTw51lKENdNrEqT3,8,4,2,0,2,0,2,0,10,1.4285714285714286,1,0.0,0,2,0,2,4,0,0,2,0,4,6,1
21298,196631,i0ksX07HnsV5rQlWqOr1uKEuc7yNU24c,RXDvfPUBYFlVdlueBFbLW0mhhAyGEqpt,1,0,0,0,0,0,1,0,1,0.14285714285714285,1,0.0,0,0,0,0,0,0,0,1,0,0,1,1
21299,196645,woycXT46N9ci40pABOFUjbx9WrsYsrpN,A3fsA9Zfv1X2fVEQhTw51lKENdNrEqT3,3,0,0,0,0,0,3,0,3,0.42857142857142855,1,0.0,0,0,0,0,0,0,0,3,0,0,3,1
21300,196650,Aw5ghdSq194D0D6BaNF7QrXufOcqe5oy,bWdj2GDclj5ofokWjzoa5jAwMkxCykd6,5,2,1,0,1,0,2,0,6,0.8571428571428571,1,0.0,0,1,0,1,2,0,0,2,0,2,4,1
21301,196651,nji88FV6SjKXwBtBz9eoNmfsHCT6XfjA,bWdj2GDclj5ofokWjzoa5jAwMkxCykd6,1,0,0,0,0,0,1,0,1,0.14285714285714285,1,0.0,0,0,0,0,0,0,0,1,0,0,1,1
21302,196652,nji88FV6SjKXwBtBz9eoNmfsHCT6XfjA,A3fsA9Zfv1X2fVEQhTw51lKENdNrEqT3,1,0,0,0,0,0,1,0,1,0.14285714285714285,1,0.0,0,0,0,0,0,0,0,1,0,0,1,1
21303,196663,KDcZpMgh43fWN3yQZLS7ca0RsmMFrFC9,5X6FeZozNMgE2VRi3MJYjkkFK8SETtu2,1,0,0,0,0,0,1,0,1,0.14285714285714285,1,0.0,0,0,0,0,0,0,0,1,0,0,1,1
21304,196665,GuGxPlH8kwap04Ulm0KrrLW9Bhs1eaZe,A3fsA9Zfv1X2fVEQhTw51lKENdNrEqT3,1,0,0,0,0,0,1,0,1,0.14285714285714285,1,0.0,0,0,0,0,0,0,0,1,0,0,1,1
21305,196674,m2vHU6I2vHbIjXkP5syq1gW8Xrvw3Ajn,SpATywNh6bZuzm8s1ceuBUnMUAeoAHHw,6,2,1,0,1,0,3,0,7,1.0,1,0.0,0,1,0,1,2,0,0,3,0,2,5,1
21306,196682,XqMsMG5vyizsvnugMyb3JLunooayeKD3,bWdj2GDclj5ofokWjzoa5jAwMkxCykd6,13,12,4,0,2,0,9,0,27,3.857142857142857,1,0.0,0,4,0,2,12,0,0,9,0,6,21,1
21307,196689,plzzrHT4KCGyPPQGvIdYTvuIq5SPXcu1,bWdj2GDclj5ofokWjzoa5jAwMkxCykd6,4,2,1,0,0,1,3,0,7,1.0,1,0.0,0,1,0,0,2,1,0,3,0,1,6,1
21308,196690,plzzrHT4KCGyPPQGvIdYTvuIq5SPXcu1,A3fsA9Zfv1X2fVEQhTw51lKENdNrEqT3,4,0,0,0,0,0,6,0,6,0.8571428571428571,1,0.0,0,0,0,0,0,0,0,6,0,0,6,1
21309,196696,BDdKHYPp1edgylVPYUBHaWJ6W3VobGdR,5X6FeZozNMgE2VRi3MJYjkkFK8SETtu2,7,16,0,3,6,0,1,0,26,3.7142857142857144,1,0.0,9,0,3,6,7,0,0,1,0,18,8,1
21310,196720,1O7FJIVzsP72uhSpA353FJO0czrlF5YS,bWdj2GDclj5ofokWjzoa5jAwMkxCykd6,3,2,1,0,0,0,2,0,5,0.7142857142857143,1,0.0,0,1,0,0,2,0,0,2,0,1,4,0
21311,196722,D9eNXjxmMhHjCOCB5mVDJmuvO7XywQVj,SpATywNh6bZuzm8s1ceuBUnMUAeoAHHw,3,0,0,0,0,0,2,1,3,0.42857142857142855,1,0.0,0,0,0,0,0,0,0,2,1,0,3,1
21312,196730,ZIU1mdORhQRTpEoPB7YiPLPLKUVNr5Px,SpATywNh6bZuzm8s1ceuBUnMUAeoAHHw,7,4,3,0,2,2,1,0,12,1.7142857142857142,1,0.0,0,3,0,2,4,2,0,1,0,5,7,1
21313,196732,H7DsC4hQdgygkNoyg6qvYR8wETuHnTTe,5X6FeZozNMgE2VRi3MJYjkkFK8SETtu2,3,2,0,0,0,0,1,0,3,0.42857142857142855,1,0.0,0,0,0,0,2,0,0,1,0,0,3,1
21314,196739,afz8pGlhhupRQaDBQjwT8rGM1G2Ff6JT,5X6FeZozNMgE2VRi3MJYjkkFK8SETtu2,6,3,2,0,2,0,1,0,8,1.1428571428571428,1,0.0,0,2,0,2,3,0,0,1,0,4,4,1
21315,196749,QYjw7Y4e4Czbt9G691x4dA9fq3fXHjUR,5X6FeZozNMgE2VRi3MJYjkkFK8SETtu2,10,4,3,0,2,1,9,1,20,2.857142857142857,1,0.0,0,3,0,2,4,1,0,9,1,5,15,1
21316,196755,GTB6EmFhGWrB5YoAF5RdJLLan0vjwhuE,bWdj2GDclj5ofokWjzoa5jAwMkxCykd6,7,3,1,4,1,0,7,11,27,3.857142857142857,1,0.0,1,1,3,1,2,0,1,7,11,6,21,1
21317,196756,hu8eak1Xmf8voE8pnxPzkSD2dZP9Sipf,5X6FeZozNMgE2VRi3MJYjkkFK8SETtu2,3,0,0,0,0,0,5,0,5,0.7142857142857143,1,0.0,0,0,0,0,0,0,0,5,0,0,5,1
21318,196762,KbfT30uvubax3lKEct6iblV8VhlPaIEn,SpATywNh6bZuzm8s1ceuBUnMUAeoAHHw,4,2,1,0,1,0,1,0,5,0.7142857142857143,1,0.0,0,1,0,1,2,0,0,1,0,2,3,1
21319,196763,RKOYrOIIwzYbTMl5NOqZn88YOfnvZ0ak,G8EPVSXsOYB5YQWZGiz1aVq5Pgr2GrQu,6,3,1,0,1,0,2,0,7,1.0,1,0.0,0,1,0,1,3,0,0,2,0,2,5,1
21320,196767,NYagfMVvA1FDdZ7PZwzv8OVDbZ0jsy8R,RXDvfPUBYFlVdlueBFbLW0mhhAyGEqpt,1,0,0,0,0,0,0,1,1,0.14285714285714285,1,0.0,0,0,0,0,0,0,0,0,1,0,1,1
21321,196775,RKzSwI9z6iPxP2o2bYXnPOLiApfWBeuC,SpATywNh6bZuzm8s1ceuBUnMUAeoAHHw,1,0,0,0,0,0,1,0,1,0.14285714285714285,1,0.0,0,0,0,0,0,0,0,1,0,0,1,1
21322,196779,RKzSwI9z6iPxP2o2bYXnPOLiApfWBeuC,A3fsA9Zfv1X2fVEQhTw51lKENdNrEqT3,1,0,0,0,0,0,1,0,1,0.14285714285714285,1,0.0,0,0,0,0,0,0,0,1,0,0,1,1
21323,196781,RKzSwI9z6iPxP2o2bYXnPOLiApfWBeuC,bWdj2GDclj5ofokWjzoa5jAwMkxCykd6,1,0,0,0,0,0,2,0,2,0.2857142857142857,1,0.0,0,0,0,0,0,0,0,2,0,0,2,0
21324,196784,v9C3VnGUCCaLq89LQlmpKAcUn8zTHjde,SpATywNh6bZuzm8s1ceuBUnMUAeoAHHw,8,6,1,0,1,1,3,0,12,1.7142857142857142,1,0.0,0,1,0,1,6,1,0,3,0,2,10,1
21325,196790,2G14apRBdF9cbdNniI1m92cw2effevIo,RXDvfPUBYFlVdlueBFbLW0mhhAyGEqpt,1,0,0,0,0,0,1,0,1,0.14285714285714285,1,0.0,0,0,0,0,0,0,0,1,0,0,1,1
21326,196797,TCIVkyJgzJ4isZH6dzhFoSor2ZwJ5sAN,G8EPVSXsOYB5YQWZGiz1aVq5Pgr2GrQu,9,10,0,2,0,14,2,0,28,4.0,1,0.0,3,0,2,0,7,14,0,2,0,5,23,1
21327,196800,2G14apRBdF9cbdNniI1m92cw2effevIo,G8EPVSXsOYB5YQWZGiz1aVq5Pgr2GrQu,2,0,0,0,0,0,2,0,2,0.2857142857142857,1,0.0,0,0,0,0,0,0,0,2,0,0,2,1
21328,196821,9okn7MlPqrl75GLYfq7rYcsuwwHBKJq1,G8EPVSXsOYB5YQWZGiz1aVq5Pgr2GrQu,5,2,1,0,1,1,2,0,7,1.0,1,0.0,0,1,0,1,2,1,0,2,0,2,5,1
21329,196822,RthO8kTkOrnZ3vUDn574hHyfG3vroBt1,A3fsA9Zfv1X2fVEQhTw51lKENdNrEqT3,1,0,0,0,0,0,1,0,1,0.14285714285714285,1,0.0,0,0,0,0,0,0,0,1,0,0,1,1
21330,196828,hVUqnhGvvkIbg28LhhceS15GaKTK2ldt,SpATywNh6bZuzm8s1ceuBUnMUAeoAHHw,4,2,1,0,1,0,1,0,5,0.7142857142857143,1,0.0,0,1,0,1,2,0,0,1,0,2,3,1
21331,196831,CO9EgyX80USh1QMChwKJwPNFG9kSbsUu,RXDvfPUBYFlVdlueBFbLW0mhhAyGEqpt,1,0,0,0,0,0,1,0,1,0.14285714285714285,1,0.0,0,0,0,0,0,0,0,1,0,0,1,1
21332,196850,lCyf3TRKW0i3K1mBgKz23OONMdCWqNsI,5X6FeZozNMgE2VRi3MJYjkkFK8SETtu2,1,0,0,0,0,0,1,0,1,0.14285714285714285,1,0.0,0,0,0,0,0,0,0,1,0,0,1,1
21333,196857,mW9cT3ovqDXR30FBGWFZjKmJaCzLtUDP,bWdj2GDclj5ofokWjzoa5jAwMkxCykd6,2,0,0,0,0,0,3,0,3,0.42857142857142855,1,0.0,0,0,0,0,0,0,0,3,0,0,3,0
21334,196863,MruaUYvcSXx9bIm3phiSDO7IWZezThw6,bWdj2GDclj5ofokWjzoa5jAwMkxCykd6,5,2,1,0,1,0,2,0,6,0.8571428571428571,1,0.0,0,1,0,1,2,0,0,2,0,2,4,1
21335,196869,K1c5rfeyrGKixNSI1YrnOAmNH7wjwFVd,bWdj2GDclj5ofokWjzoa5jAwMkxCykd6,5,2,1,0,1,0,2,0,6,0.8571428571428571,1,0.0,0,1,0,1,2,0,0,2,0,2,4,1
21336,196872,K1c5rfeyrGKixNSI1YrnOAmNH7wjwFVd,A3fsA9Zfv1X2fVEQhTw51lKENdNrEqT3,9,15,2,0,2,0,4,0,23,3.2857142857142856,1,0.0,0,2,0,2,15,0,0,4,0,4,19,1
21337,196885,esy4b6bETmasLl5DFctrDy15ZWYpffCf,A3fsA9Zfv1X2fVEQhTw51lKENdNrEqT3,2,0,0,0,0,0,3,0,3,0.42857142857142855,1,0.0,0,0,0,0,0,0,0,3,0,0,3,1
21338,196900,T1QrT5UOeU1ksTt3tDnyZ3XgowFwBlaD,SpATywNh6bZuzm8s1ceuBUnMUAeoAHHw,1,0,0,0,0,0,1,0,1,0.14285714285714285,1,0.0,0,0,0,0,0,0,0,1,0,0,1,1
21339,196905,rPGMKO3AhLxN6LWflYbraX7SC5U9X2nK,A3fsA9Zfv1X2fVEQhTw51lKENdNrEqT3,1,0,0,0,0,0,1,0,1,0.14285714285714285,1,0.0,0,0,0,0,0,0,0,1,0,0,1,1
21340,196910,TZebVQukvsBcYdOQxixaRTPhQSwDEkVv,SpATywNh6bZuzm8s1ceuBUnMUAeoAHHw,5,2,1,0,1,0,2,0,6,0.8571428571428571,1,0.0,0,1,0,1,2,0,0,2,0,2,4,1
21341,196932,KlM5BQr0R5RQxLKf8vKCD5vECsgcwVG1,SpATywNh6bZuzm8s1ceuBUnMUAeoAHHw,6,3,1,0,1,0,2,0,7,1.0,1,0.0,0,1,0,1,3,0,0,2,0,2,5,1
21342,196937,eWkJrAlAUQLWG3dtEpMXROzgiD3a1MDK,5X6FeZozNMgE2VRi3MJYjkkFK8SETtu2,1,0,0,0,0,0,1,0,1,0.14285714285714285,1,0.0,0,0,0,0,0,0,0,1,0,0,1,1
21343,196945,qREvGviufJ3VVxNkA2MjB1npr7InnyIq,SpATywNh6bZuzm8s1ceuBUnMUAeoAHHw,1,0,0,0,0,0,1,0,1,0.14285714285714285,1,0.0,0,0,0,0,0,0,0,1,0,0,1,1
21344,196963,ySbpVhOvpB9MuHEn2lEoeA4d5zRYukkl,A3fsA9Zfv1X2fVEQhTw51lKENdNrEqT3,7,3,2,0,2,0,4,0,11,1.5714285714285714,1,0.0,0,2,0,2,3,0,0,4,0,4,7,1
21345,196969,kKBIfyZmN22zBj263eKBa0SA1U5xYMsR,bWdj2GDclj5ofokWjzoa5jAwMkxCykd6,1,0,0,0,0,0,1,0,1,0.14285714285714285,1,0.0,0,0,0,0,0,0,0,1,0,0,1,1
21346,196970,kKBIfyZmN22zBj263eKBa0SA1U5xYMsR,G8EPVSXsOYB5YQWZGiz1aVq5Pgr2GrQu,1,0,0,0,0,0,1,0,1,0.14285714285714285,1,0.0,0,0,0,0,0,0,0,1,0,0,1,1
21347,196983,9AWK7WPV1FK8oZYjbtTZUeHBBeoqLZWS,SpATywNh6bZuzm8s1ceuBUnMUAeoAHHw,1,0,0,0,0,0,1,0,1,0.14285714285714285,1,0.0,0,0,0,0,0,0,0,1,0,0,1,1
21348,196990,XMX9ZzyckuT66ALkAoQ1Ndie7Ls8rbRQ,SpATywNh6bZuzm8s1ceuBUnMUAeoAHHw,15,34,0,0,0,1,6,0,41,5.857142857142857,1,0.0,7,0,0,0,27,1,0,6,0,7,34,0
21349,196998,cao0jYvVpb9HkTA7b0NC6lvxt4dMGzpm,bWdj2GDclj5ofokWjzoa5jAwMkxCykd6,5,2,1,0,1,0,4,0,8,1.1428571428571428,1,0.0,0,1,0,1,2,0,0,4,0,2,6,1
21350,196999,MmSspWh9UIrPZvHRrkVV6uR2B7UAVFMg,A3fsA9Zfv1X2fVEQhTw51lKENdNrEqT3,1,0,0,0,0,0,1,0,1,0.14285714285714285,1,0.0,0,0,0,0,0,0,0,1,0,0,1,1
21351,197003,zX8EipUM7J0ifhENZyJ19KxHpsJKH6Ul,SpATywNh6bZuzm8s1ceuBUnMUAeoAHHw,5,2,1,0,1,0,2,0,6,0.8571428571428571,1,0.0,0,1,0,1,2,0,0,2,0,2,4,1
21352,197008,9Nmjm4BvnbKTQ3ZZwECYdKy9zBNGmQNW,A3fsA9Zfv1X2fVEQhTw51lKENdNrEqT3,1,0,0,0,0,0,1,0,1,0.14285714285714285,1,0.0,0,0,0,0,0,0,0,1,0,0,1,1
21353,197026,vVomSgkHkyw3sqrRqYKc3zE1eWaa2d4G,bWdj2GDclj5ofokWjzoa5jAwMkxCykd6,1,0,0,0,0,0,1,0,1,0.14285714285714285,1,0.0,0,0,0,0,0,0,0,1,0,0,1,1
21354,197029,ZZowuz4uVcnPKwLl2HwtR5fDkL6SykXx,3VkHkmOtom3jM2wCu94xgzzu1d6Dn7or,1,0,0,0,0,0,2,0,2,0.2857142857142857,1,0.0,0,0,0,0,0,0,0,2,0,0,2,1
21355,197046,thHEMa1JeqvmtFrpKqNkntC9EjRmasdH,3VkHkmOtom3jM2wCu94xgzzu1d6Dn7or,1,0,0,0,0,0,1,0,1,0.14285714285714285,1,0.0,0,0,0,0,0,0,0,1,0,0,1,1
21356,197053,Fzj0WxgQZtpi1yL9FPl2GLIeADVOERZd,3VkHkmOtom3jM2wCu94xgzzu1d6Dn7or,5,1,1,0,1,0,3,0,6,0.8571428571428571,1,0.0,0,1,0,1,1,0,0,3,0,2,4,1
21357,197060,WEqUhplW7x1SpLabVjNcI5M4HsCYjumg,3VkHkmOtom3jM2wCu94xgzzu1d6Dn7or,5,2,1,0,1,0,3,2,9,1.2857142857142858,1,0.0,0,1,0,1,2,0,0,3,2,2,7,1
21358,197064,o4jpUfYyugisNuTxStBdnlkGLqss1oz3,3VkHkmOtom3jM2wCu94xgzzu1d6Dn7or,4,2,1,0,1,0,1,0,5,0.7142857142857143,1,0.0,0,1,0,1,2,0,0,1,0,2,3,1
21359,197078,yROHdgEfg5YBunrCMGTpfbdQSjLMPtZM,3VkHkmOtom3jM2wCu94xgzzu1d6Dn7or,2,0,0,0,0,0,5,0,5,0.7142857142857143,1,0.0,0,0,0,0,0,0,0,5,0,0,5,1
21360,197090,2Iz7IRN2SG7NxQwSbdZl0a3sYpcN4Mke,3VkHkmOtom3jM2wCu94xgzzu1d6Dn7or,1,0,0,0,0,0,1,0,1,0.14285714285714285,1,0.0,0,0,0,0,0,0,0,1,0,0,1,1
21361,197092,9B8XNdnBVjU3W5PKErol0e502ujFe9zl,3VkHkmOtom3jM2wCu94xgzzu1d6Dn7or,5,2,1,0,1,0,2,0,6,0.8571428571428571,1,0.0,0,1,0,1,2,0,0,2,0,2,4,1
21362,197120,TdfPQ8Zwlmkv9r9eYq7hz64CoB8G0Fbz,3VkHkmOtom3jM2wCu94xgzzu1d6Dn7or,1,0,0,0,0,0,2,0,2,0.2857142857142857,1,0.0,0,0,0,0,0,0,0,2,0,0,2,1
21363,197135,ic6pjUfgxHe0ndQH7kHuGrLDFqrjZins,3VkHkmOtom3jM2wCu94xgzzu1d6Dn7or,1,0,0,0,0,0,1,0,1,0.14285714285714285,1,0.0,0,0,0,0,0,0,0,1,0,0,1,1
21364,197143,29FuwqBM9NfSWGkyXxZzrOCmx4AYpimY,3VkHkmOtom3jM2wCu94xgzzu1d6Dn7or,4,2,0,0,0,0,4,0,6,0.8571428571428571,2,0.0,0,0,0,0,2,0,0,4,0,0,6,1
21365,197146,WZGplmadmmEtELNPBvysdSm2qcRPQpTm,3VkHkmOtom3jM2wCu94xgzzu1d6Dn7or,1,0,0,0,0,0,1,0,1,0.14285714285714285,1,0.0,0,0,0,0,0,0,0,1,0,0,1,1
21366,197149,em9AtvWzZLkApDA4BdTwYHl7faCKZlUR,3VkHkmOtom3jM2wCu94xgzzu1d6Dn7or,23,18,18,0,0,0,4,0,40,5.714285714285714,1,0.0,0,18,0,0,18,0,0,4,0,18,22,1
21367,197178,R0yZQm01vPxwB1FHTvnE4ExR78BMpKhv,3VkHkmOtom3jM2wCu94xgzzu1d6Dn7or,5,1,1,0,1,0,5,0,8,1.1428571428571428,2,0.0,0,1,0,1,1,0,0,5,0,2,6,0
21368,197186,Ei3c2hqo9KkGhrTsh0pMPLmhpqSfM9Hw,3VkHkmOtom3jM2wCu94xgzzu1d6Dn7or,14,8,3,3,4,5,6,2,31,4.428571428571429,1,0.0,4,3,3,4,4,5,0,6,2,14,17,1
21369,197191,U52HCRlROLk7AsGf0ggclVGz2aYoTy09,3VkHkmOtom3jM2wCu94xgzzu1d6Dn7or,1,0,0,0,0,0,1,0,1,0.14285714285714285,1,0.0,0,0,0,0,0,0,0,1,0,0,1,1
21370,197204,b42x9fEviD2KrosQFgO4BDKrSzPFH9d9,3VkHkmOtom3jM2wCu94xgzzu1d6Dn7or,1,0,0,0,0,0,1,0,1,0.14285714285714285,1,0.0,0,0,0,0,0,0,0,1,0,0,1,1
21371,197225,hKgVqil7KBLHJURLHxVOtikdxysMZkIE,3VkHkmOtom3jM2wCu94xgzzu1d6Dn7or,9,6,3,1,2,0,3,0,15,2.142857142857143,1,0.0,1,3,1,2,5,0,0,3,0,7,8,1
21372,197234,xJCbRVaklom2k9BJ5bRzeCNVTGSyTSLq,3VkHkmOtom3jM2wCu94xgzzu1d6Dn7or,6,6,2,0,2,0,4,0,14,2.0,1,0.0,3,2,0,2,3,0,0,4,0,7,7,1
21373,197268,11WnYceVEuF19QogoEk6NeEMEKIyHta5,3VkHkmOtom3jM2wCu94xgzzu1d6Dn7or,4,3,1,0,1,0,3,0,8,1.1428571428571428,1,0.0,1,1,0,1,2,0,0,3,0,3,5,1
21374,197295,ERlWzeifdR1dZrApgDfsJLPQsR6BHmoR,3VkHkmOtom3jM2wCu94xgzzu1d6Dn7or,1,0,0,0,0,0,1,0,1,0.14285714285714285,1,0.0,0,0,0,0,0,0,0,1,0,0,1,1
21375,197351,KejvQXsC1Zw5WydUIFGrx4U67cLxgUCe,3VkHkmOtom3jM2wCu94xgzzu1d6Dn7or,4,2,1,0,1,0,1,0,5,0.7142857142857143,1,0.0,0,1,0,1,2,0,0,1,0,2,3,1
21376,197358,G9yEvP6FyZQ0TxOmqnRQjmWB8smt21jf,3VkHkmOtom3jM2wCu94xgzzu1d6Dn7or,2,0,0,0,0,0,2,0,2,0.2857142857142857,1,0.0,0,0,0,0,0,0,0,2,0,0,2,1
21377,197382,0hGRrhLCwhSNOstg5hZotkXuqdc5VejE,3VkHkmOtom3jM2wCu94xgzzu1d6Dn7or,7,2,1,0,1,1,7,1,13,1.8571428571428572,1,0.0,0,1,0,1,2,1,0,7,1,2,11,1
21378,197425,Hk8WDWn2QvcOQpks5Fx9WW8sZlnc2HgG,3VkHkmOtom3jM2wCu94xgzzu1d6Dn7or,6,3,1,0,2,0,3,0,9,1.2857142857142858,1,0.0,2,1,0,2,1,0,0,3,0,5,4,1
21379,197433,x8tyR94GbfRfS5lV029Kd0oRdnTeKZWB,3VkHkmOtom3jM2wCu94xgzzu1d6Dn7or,1,0,0,0,0,0,1,0,1,0.14285714285714285,1,0.0,0,0,0,0,0,0,0,1,0,0,1,0
21380,197438,aEs6MQWBV7GUXtIMoKT7PrftJrGVv5ZK,3VkHkmOtom3jM2wCu94xgzzu1d6Dn7or,1,0,0,0,0,0,1,0,1,0.14285714285714285,1,0.0,0,0,0,0,0,0,0,1,0,0,1,1
21381,197469,9UzLImPuSID0ZgW5UVZbILenHfrw26tU,3VkHkmOtom3jM2wCu94xgzzu1d6Dn7or,4,3,1,0,1,0,1,0,6,0.8571428571428571,1,0.0,1,1,0,1,2,0,0,1,0,3,3,1
21382,197485,PwBUlHo08QPxo8Ok2Pwey6PpKeJz63fH,3VkHkmOtom3jM2wCu94xgzzu1d6Dn7or,1,0,0,0,0,0,1,0,1,0.14285714285714285,1,0.0,0,0,0,0,0,0,0,1,0,0,1,1
21383,197513,D2f4XnvAFD8ZIkDvhpGbd6yCstJua9ut,3VkHkmOtom3jM2wCu94xgzzu1d6Dn7or,8,4,2,0,2,0,2,0,10,1.4285714285714286,1,0.0,0,2,0,2,4,0,0,2,0,4,6,0
21384,197522,nrqhmTevBllzRr8nrNjnpvdMDs7GQKjC,3VkHkmOtom3jM2wCu94xgzzu1d6Dn7or,2,0,0,0,0,0,2,0,2,0.2857142857142857,1,0.0,0,0,0,0,0,0,0,2,0,0,2,1
21385,197534,0a3gK0IKIMFMFguGHQqyaQCMfYXZtO1D,3VkHkmOtom3jM2wCu94xgzzu1d6Dn7or,1,0,0,0,0,0,2,0,2,0.2857142857142857,1,0.0,0,0,0,0,0,0,0,2,0,0,2,1
21386,197544,FySmfd2hS941zbI2PjxLl96G2jk3gIlQ,bWdj2GDclj5ofokWjzoa5jAwMkxCykd6,1,0,0,0,0,0,1,0,1,0.14285714285714285,1,0.0,0,0,0,0,0,0,0,1,0,0,1,1
21387,197561,1sxU5u2tB4cfcS6yRjPgL8Lbs961wxI1,A3fsA9Zfv1X2fVEQhTw51lKENdNrEqT3,1,0,0,0,0,0,1,0,1,0.14285714285714285,1,0.0,0,0,0,0,0,0,0,1,0,0,1,1
21388,197565,cSPs7Fdln4Ch49nnOhLrL6tMXQVWaRtw,SpATywNh6bZuzm8s1ceuBUnMUAeoAHHw,1,0,0,0,0,0,1,0,1,0.14285714285714285,1,0.0,0,0,0,0,0,0,0,1,0,0,1,1
21389,197581,3UIhyDBe2cVwfnPbxOe5VWApIlUgpsbX,bWdj2GDclj5ofokWjzoa5jAwMkxCykd6,1,0,0,0,0,0,1,0,1,0.14285714285714285,1,0.0,0,0,0,0,0,0,0,1,0,0,1,1
21390,197585,wrEd0NIQV39m2xEAHNuU1Ww6eryiacbC,SpATywNh6bZuzm8s1ceuBUnMUAeoAHHw,11,15,0,21,0,4,3,0,43,6.142857142857143,1,0.0,7,0,18,0,8,4,3,3,0,25,18,1
21391,197592,ECkqmAuIkv3ncN9wNJby8oOn15qTd9kR,RXDvfPUBYFlVdlueBFbLW0mhhAyGEqpt,1,0,0,0,0,0,2,0,2,0.2857142857142857,1,0.0,0,0,0,0,0,0,0,2,0,0,2,1
21392,197598,RCC0chPMKpWYHBcYuZNQFLP3RQicCreS,SpATywNh6bZuzm8s1ceuBUnMUAeoAHHw,2,0,0,0,0,0,3,0,3,0.42857142857142855,1,0.0,0,0,0,0,0,0,0,3,0,0,3,1
21393,197603,xOGjXyyeq87fCMSZ9z7Yuds9sMvR7Ohh,A3fsA9Zfv1X2fVEQhTw51lKENdNrEqT3,20,12,10,0,10,0,1,0,33,4.714285714285714,1,0.0,0,10,0,10,12,0,0,1,0,20,13,1
21394,197604,xWQhq9RZKw08hANIa0LgFXN2DnwycQf4,bWdj2GDclj5ofokWjzoa5jAwMkxCykd6,5,2,1,0,1,0,2,0,6,0.8571428571428571,1,0.0,0,1,0,1,2,0,0,2,0,2,4,1
21395,197622,d8GXnhJ8BgnDSKpTLyLaGdg2jK5wWL8e,G8EPVSXsOYB5YQWZGiz1aVq5Pgr2GrQu,27,31,11,10,12,0,9,0,73,10.428571428571429,1,0.0,17,11,6,12,14,0,4,9,0,46,27,1
21396,197629,pyv0DnRM0PUGZlRUjUkquPGtUI5wlNKd,bWdj2GDclj5ofokWjzoa5jAwMkxCykd6,3,0,0,0,0,0,3,0,3,0.42857142857142855,1,0.0,0,0,0,0,0,0,0,3,0,0,3,1
21397,197633,klchONEdPI3u3wOB4C8jNpM0hCX3C5RZ,RXDvfPUBYFlVdlueBFbLW0mhhAyGEqpt,24,23,17,7,12,0,4,0,63,9.0,1,0.0,3,17,7,12,20,0,0,4,0,39,24,1
21398,197640,ybqXs1BYgb66Ubmo4CtWBedAmyNUZkNR,SpATywNh6bZuzm8s1ceuBUnMUAeoAHHw,5,2,1,0,1,0,3,0,7,1.0,1,0.0,0,1,0,1,2,0,0,3,0,2,5,1
21399,197645,hbSZ24mH4oabI0uhhWxmu9uILNkjYUT4,SpATywNh6bZuzm8s1ceuBUnMUAeoAHHw,6,1,1,0,1,0,3,0,6,0.8571428571428571,1,0.0,0,1,0,1,1,0,0,3,0,2,4,1
21400,197658,VhMVe0e0vgyahnrJinzgUUFfkUYIGngP,bWdj2GDclj5ofokWjzoa5jAwMkxCykd6,1,0,0,0,0,0,1,0,1,0.14285714285714285,1,0.0,0,0,0,0,0,0,0,1,0,0,1,1
21401,197660,4fYqS5i8zH5iFL9FCzQ9Jw4wAZdnrAvU,RXDvfPUBYFlVdlueBFbLW0mhhAyGEqpt,8,5,4,0,2,0,1,0,12,1.7142857142857142,1,0.0,0,4,0,2,5,0,0,1,0,6,6,1
21402,197671,bRDOwsDzRQZuxjrOsoP53hDwwMbqZqej,SpATywNh6bZuzm8s1ceuBUnMUAeoAHHw,1,0,0,0,0,0,1,0,1,0.14285714285714285,1,0.0,0,0,0,0,0,0,0,1,0,0,1,1
21403,197673,f0YMm9i9boHqaqH06EMyOVgZ4eqVoTpv,SpATywNh6bZuzm8s1ceuBUnMUAeoAHHw,9,10,7,0,0,1,9,1,28,4.0,1,0.0,0,7,0,0,10,1,0,9,1,7,21,0
21404,197674,PpAhko9wN0CoGGKMK5cOihgQKnJKH7vJ,SpATywNh6bZuzm8s1ceuBUnMUAeoAHHw,1,0,0,0,0,0,1,0,1,0.14285714285714285,1,0.0,0,0,0,0,0,0,0,1,0,0,1,1
21405,197684,1oYUpAzbanZgtAfH9FWjQtyhbjb42Xx4,bWdj2GDclj5ofokWjzoa5jAwMkxCykd6,1,0,0,0,0,0,1,0,1,0.14285714285714285,1,0.0,0,0,0,0,0,0,0,1,0,0,1,1
21406,197685,1oYUpAzbanZgtAfH9FWjQtyhbjb42Xx4,RXDvfPUBYFlVdlueBFbLW0mhhAyGEqpt,1,0,0,0,0,0,1,0,1,0.14285714285714285,1,0.0,0,0,0,0,0,0,0,1,0,0,1,1
21407,197695,4fYqS5i8zH5iFL9FCzQ9Jw4wAZdnrAvU,bWdj2GDclj5ofokWjzoa5jAwMkxCykd6,4,2,1,0,1,0,1,0,5,0.7142857142857143,1,0.0,0,1,0,1,2,0,0,1,0,2,3,1
21408,197700,iKVVP8eq0ppb7OxMxmGwiOY8iziYmfHr,A3fsA9Zfv1X2fVEQhTw51lKENdNrEqT3,1,0,0,0,0,0,2,0,2,0.2857142857142857,1,0.0,0,0,0,0,0,0,0,2,0,0,2,1
21409,197708,HE0yFYNeyW3jGh5EhXv7uoc6O18ATk5R,A3fsA9Zfv1X2fVEQhTw51lKENdNrEqT3,19,10,8,0,8,0,1,0,27,3.857142857142857,1,0.0,0,8,0,8,10,0,0,1,0,16,11,1
21410,197723,A2szMVZ2xHQSx9WPUKhhkvBSuScZqBJF,A3fsA9Zfv1X2fVEQhTw51lKENdNrEqT3,13,7,5,0,5,0,1,0,18,2.5714285714285716,1,0.0,0,5,0,5,7,0,0,1,0,10,8,1
21411,197732,jqN3FAeYERU2lkKz9K4K9sLSZnaWl5Zg,SpATywNh6bZuzm8s1ceuBUnMUAeoAHHw,4,3,1,0,1,0,3,0,8,1.1428571428571428,1,0.0,0,1,0,1,3,0,0,3,0,2,6,1
21412,197737,HhuDqntCSTLCVngcOF2eAHqFrhEVuPmX,SpATywNh6bZuzm8s1ceuBUnMUAeoAHHw,4,2,0,0,0,0,2,0,4,0.5714285714285714,1,0.0,0,0,0,0,2,0,0,2,0,0,4,1
21413,197803,vtBnoyzeCC8wZr284IGH2R9KjVsQkSSy,SpATywNh6bZuzm8s1ceuBUnMUAeoAHHw,1,0,0,0,0,0,1,0,1,0.14285714285714285,1,0.0,0,0,0,0,0,0,0,1,0,0,1,1
21414,197827,mVLfrQRFV4YD7pibAFgNSJRdbeuiy0Sw,G8EPVSXsOYB5YQWZGiz1aVq5Pgr2GrQu,1,0,0,0,0,0,1,0,1,0.14285714285714285,1,0.0,0,0,0,0,0,0,0,1,0,0,1,1
21415,197843,1AZmjj77W8BIGEE1Hrm2nLFWlidLNL1Q,G8EPVSXsOYB5YQWZGiz1aVq5Pgr2GrQu,3,1,0,0,0,0,2,0,3,0.42857142857142855,1,0.0,0,0,0,0,1,0,0,2,0,0,3,1
21416,197860,kukBD4x4uH6xHKp8zwbeAlZ5XIJZfUlp,SpATywNh6bZuzm8s1ceuBUnMUAeoAHHw,5,2,1,0,1,0,2,0,6,0.8571428571428571,1,0.0,0,1,0,1,2,0,0,2,0,2,4,1
21417,197865,UmYxiFu6na7ioq4pFJaZYbHcM2Oxxqgd,SpATywNh6bZuzm8s1ceuBUnMUAeoAHHw,11,8,5,8,3,0,5,0,29,4.142857142857143,1,0.0,2,5,8,3,6,0,0,5,0,18,11,1
21418,197867,NvxM2w7KuHaUb4w9IwWeNWL1FPcoZWlg,SpATywNh6bZuzm8s1ceuBUnMUAeoAHHw,4,3,2,0,0,0,1,0,6,0.8571428571428571,1,0.0,0,2,0,0,3,0,0,1,0,2,4,1
21419,197891,ew6rgTKhfFlJk0TBM29erpe2hVQwpNiX,bWdj2GDclj5ofokWjzoa5jAwMkxCykd6,3,0,0,0,0,0,3,0,3,0.42857142857142855,1,0.0,0,0,0,0,0,0,0,3,0,0,3,1
21420,197901,3E2J8oODQN7NkqxkMAgArJcF2FBjPre3,G8EPVSXsOYB5YQWZGiz1aVq5Pgr2GrQu,10,5,3,0,3,0,4,0,15,2.142857142857143,1,0.0,0,3,0,3,5,0,0,4,0,6,9,1
21421,197903,quZIfUvhbgq4XxK5fzctoX77uKRPby0l,SpATywNh6bZuzm8s1ceuBUnMUAeoAHHw,5,4,1,0,1,0,1,0,7,1.0,1,0.0,0,1,0,1,4,0,0,1,0,2,5,1
21422,197906,kSxsrTO5exODRPeD7VJyPIeGcMKlqOQM,A3fsA9Zfv1X2fVEQhTw51lKENdNrEqT3,1,0,0,0,0,0,1,0,1,0.14285714285714285,1,0.0,0,0,0,0,0,0,0,1,0,0,1,1
21423,197912,OM3FARUmSrkVmJXDiM3P0y6LhqqplIHH,SpATywNh6bZuzm8s1ceuBUnMUAeoAHHw,6,2,1,0,1,0,4,0,8,1.1428571428571428,1,0.0,0,1,0,1,2,0,0,4,0,2,6,1
21424,197920,Jmn2E7XgQKFifDbJIxuDxMHLi4YpW3jx,G8EPVSXsOYB5YQWZGiz1aVq5Pgr2GrQu,3,0,0,0,0,4,2,0,6,0.8571428571428571,1,0.0,0,0,0,0,0,4,0,2,0,0,6,1
21425,197928,oqI20pdqFt40phk7jIrltWVMqWvZcban,A3fsA9Zfv1X2fVEQhTw51lKENdNrEqT3,1,0,0,0,0,0,1,0,1,0.14285714285714285,1,0.0,0,0,0,0,0,0,0,1,0,0,1,1
21426,197963,xp0PGlV4qhp60qYyxRe8xCxRmmPbM3Jj,bWdj2GDclj5ofokWjzoa5jAwMkxCykd6,1,0,0,0,0,0,4,0,4,0.5714285714285714,1,0.0,0,0,0,0,0,0,0,4,0,0,4,1
21427,197968,Kc8b3JW1MQKQC6TGWRiZEShHUO8QsHV5,SpATywNh6bZuzm8s1ceuBUnMUAeoAHHw,1,0,0,0,0,0,1,0,1,0.14285714285714285,1,0.0,0,0,0,0,0,0,0,1,0,0,1,1
21428,197975,xlZo0JM0E05KNiKs7UHaCnGkhTzmaKtg,SpATywNh6bZuzm8s1ceuBUnMUAeoAHHw,2,0,0,0,0,0,2,0,2,0.2857142857142857,1,0.0,0,0,0,0,0,0,0,2,0,0,2,1
21429,197977,WbJsJWqKM3lS43E1ayfblK0uOswvkrBy,bWdj2GDclj5ofokWjzoa5jAwMkxCykd6,2,0,0,0,0,0,3,0,3,0.42857142857142855,1,0.0,0,0,0,0,0,0,0,3,0,0,3,1
21430,197984,h4sY8Ph1vbc191O1JmHGbdnyocsoSDQO,G8EPVSXsOYB5YQWZGiz1aVq5Pgr2GrQu,5,10,1,0,0,0,3,0,14,2.0,1,0.0,0,1,0,0,10,0,0,3,0,1,13,1
21431,197985,qMtHlzOZxaTrhiGkJGWyjk6FQrkiMtpo,SpATywNh6bZuzm8s1ceuBUnMUAeoAHHw,4,3,0,0,0,0,3,0,6,0.8571428571428571,1,0.0,0,0,0,0,3,0,0,3,0,0,6,1
21432,197986,UZPajHzpSX5mbiv3Scxfu2s5ueCVoTcN,RXDvfPUBYFlVdlueBFbLW0mhhAyGEqpt,5,0,0,0,0,0,5,1,6,0.8571428571428571,1,0.0,0,0,0,0,0,0,0,5,1,0,6,1
21433,197990,EH79kaJEIeXcrssngPKoTUSLUCjHUazt,A3fsA9Zfv1X2fVEQhTw51lKENdNrEqT3,2,0,0,0,0,0,4,0,4,0.5714285714285714,1,0.0,0,0,0,0,0,0,0,4,0,0,4,1
21434,197996,6hX10Wu1E2KDRE7mYGP1VPoNRkdF7lrL,A3fsA9Zfv1X2fVEQhTw51lKENdNrEqT3,3,0,0,0,0,0,3,0,3,0.42857142857142855,1,0.0,0,0,0,0,0,0,0,3,0,0,3,0
21435,197999,NVzsLV2hJQHxCBnLyaDpT9HrhRSWUOfa,A3fsA9Zfv1X2fVEQhTw51lKENdNrEqT3,2,0,0,0,0,0,2,0,2,0.2857142857142857,1,0.0,0,0,0,0,0,0,0,2,0,0,2,1
21436,198002,Juod2UGp1EISVAlVAqDeLcVK1OmKMlrq,A3fsA9Zfv1X2fVEQhTw51lKENdNrEqT3,5,2,1,0,1,1,4,0,9,1.2857142857142858,1,0.0,0,1,0,1,2,1,0,4,0,2,7,1
21437,198015,G40CqBl9Wk8vBpLpRLZfdLIUELNw0IuK,bWdj2GDclj5ofokWjzoa5jAwMkxCykd6,11,20,7,32,6,1,8,0,74,10.571428571428571,1,0.0,8,7,30,6,12,1,2,8,0,51,23,1
21438,198020,mBkByOktWGTfbLjZh4oUEAyrYqB4PqkG,A3fsA9Zfv1X2fVEQhTw51lKENdNrEqT3,5,3,1,0,1,0,2,0,7,1.0,1,0.0,0,1,0,1,3,0,0,2,0,2,5,1
21439,198037,ptvJrZNOUMqIwb7dgd5momqDwhHuKgqy,A3fsA9Zfv1X2fVEQhTw51lKENdNrEqT3,1,0,0,0,0,0,1,0,1,0.14285714285714285,1,0.0,0,0,0,0,0,0,0,1,0,0,1,1
21440,198039,mBkByOktWGTfbLjZh4oUEAyrYqB4PqkG,bWdj2GDclj5ofokWjzoa5jAwMkxCykd6,7,7,2,10,1,0,2,0,22,3.142857142857143,1,0.0,2,2,9,1,5,0,1,2,0,14,8,1
21441,198040,hwsOMQoQpEm6hpx9rFynsAz9z0b8kZIy,SpATywNh6bZuzm8s1ceuBUnMUAeoAHHw,6,3,1,0,0,0,3,1,8,1.1428571428571428,1,0.0,0,1,0,0,3,0,0,3,1,1,7,1
21442,198057,ZPbUovw1YoDeaWUVrbGEj5A5WdIXTYjf,A3fsA9Zfv1X2fVEQhTw51lKENdNrEqT3,41,20,16,58,10,4,3,0,111,15.857142857142858,1,0.0,1,16,52,10,19,4,6,3,0,79,32,1
21443,198059,THP1XMjHSxStaFTc2EbpYMi7w0ocTWsv,A3fsA9Zfv1X2fVEQhTw51lKENdNrEqT3,2,0,0,0,0,0,2,0,2,0.2857142857142857,1,0.0,0,0,0,0,0,0,0,2,0,0,2,1
21444,198064,FmREEBmKaoWQV1gJ6HLZOzgC3kziEupI,SpATywNh6bZuzm8s1ceuBUnMUAeoAHHw,9,6,3,5,2,0,2,0,18,2.5714285714285716,1,0.0,2,3,4,2,4,0,1,2,0,11,7,1
21445,198072,ydSu1htsBf3RzcwY9UTcwNk58kfOh1CK,A3fsA9Zfv1X2fVEQhTw51lKENdNrEqT3,1,0,0,0,0,0,1,0,1,0.14285714285714285,1,0.0,0,0,0,0,0,0,0,1,0,0,1,1
21446,198075,Zh41FGMVAot9ISpRqN7C51AlQVbP6TRp,G8EPVSXsOYB5YQWZGiz1aVq5Pgr2GrQu,1,0,0,0,0,0,1,0,1,0.14285714285714285,1,0.0,0,0,0,0,0,0,0,1,0,0,1,1
21447,198089,1Y8zyxJNFqsbAxngaSR4MBCJMYy7aumA,A3fsA9Zfv1X2fVEQhTw51lKENdNrEqT3,1,0,0,0,0,0,1,0,1,0.14285714285714285,1,0.0,0,0,0,0,0,0,0,1,0,0,1,1
21448,198092,7qSkKlCfwbOANWGSAwfdpq7Q0evXlyXJ,A3fsA9Zfv1X2fVEQhTw51lKENdNrEqT3,2,0,0,0,0,0,2,0,2,0.2857142857142857,1,0.0,0,0,0,0,0,0,0,2,0,0,2,1
21449,198094,NVHlXFJKdfwucYR5YquGJkYfegUD35pC,bWdj2GDclj5ofokWjzoa5jAwMkxCykd6,1,0,0,0,0,0,1,0,1,0.14285714285714285,1,0.0,0,0,0,0,0,0,0,1,0,0,1,1
21450,198096,gQqEJZs7B37MmzRexP5otRszUHd2KLYy,A3fsA9Zfv1X2fVEQhTw51lKENdNrEqT3,18,11,9,0,7,0,4,0,31,4.428571428571429,1,0.0,0,9,0,7,11,0,0,4,0,16,15,1
21451,198102,UmMUmfW7iDbccQsjMsWCLdabczIvW3k8,G8EPVSXsOYB5YQWZGiz1aVq5Pgr2GrQu,10,20,7,10,4,0,4,0,45,6.428571428571429,1,0.0,10,7,6,4,10,0,4,4,0,27,18,1
21452,198108,tpRB0Y2odcJ8wbxdjaREs5gktwFdDR2h,A3fsA9Zfv1X2fVEQhTw51lKENdNrEqT3,46,72,30,82,21,41,15,3,264,37.714285714285715,1,0.0,1,30,64,21,71,41,18,15,3,116,148,1
21453,198110,Psbjgi8UNl2rcrsYIe1cv0JHA13unwqh,A3fsA9Zfv1X2fVEQhTw51lKENdNrEqT3,9,6,4,0,3,0,1,0,14,2.0,1,0.0,0,4,0,3,6,0,0,1,0,7,7,1
21454,198119,ivQxpA3T4qXcNV0IuvLDkzJLb00vpKY1,A3fsA9Zfv1X2fVEQhTw51lKENdNrEqT3,9,5,4,0,4,0,3,0,16,2.2857142857142856,1,0.0,0,4,0,4,5,0,0,3,0,8,8,1
21455,198123,Bobzv8PFDIeID7NJyzm72ZPzBi51TYoj,G8EPVSXsOYB5YQWZGiz1aVq5Pgr2GrQu,4,1,0,0,0,0,6,0,7,1.0,1,0.0,0,0,0,0,1,0,0,6,0,0,7,1
21456,198126,EuJrP6kozTqtmrZ2kvjKbbdLy1MAtd6Q,G8EPVSXsOYB5YQWZGiz1aVq5Pgr2GrQu,5,2,0,0,0,0,3,0,5,0.7142857142857143,1,0.0,0,0,0,0,2,0,0,3,0,0,5,1
21457,198127,NRHQ3tSUEv4DHf8jZg8RV7YWaKkLB0Yk,A3fsA9Zfv1X2fVEQhTw51lKENdNrEqT3,4,3,0,0,0,0,2,0,5,0.7142857142857143,1,0.0,1,0,0,0,2,0,0,2,0,1,4,1
21458,198148,PumYHOn9wm04kyhWSxqPbI3SWXpAfHRE,bWdj2GDclj5ofokWjzoa5jAwMkxCykd6,5,11,3,0,3,0,2,0,19,2.7142857142857144,1,0.0,4,3,0,3,7,0,0,2,0,10,9,1
21459,198151,1DCeTt0CkcmxoPvN3IFKoXhg62qIczOd,G8EPVSXsOYB5YQWZGiz1aVq5Pgr2GrQu,7,4,1,0,1,0,3,0,9,1.2857142857142858,1,0.0,0,1,0,1,4,0,0,3,0,2,7,1
21460,198157,BnOHUZJJ8tQ0RqiSOgsTvzjr9EqA1Ahw,A3fsA9Zfv1X2fVEQhTw51lKENdNrEqT3,2,0,0,0,0,0,4,0,4,0.5714285714285714,1,0.0,0,0,0,0,0,0,0,4,0,0,4,1
21461,198160,BAyN80jjR5TuHhGoBQcino62lPw8bhBn,A3fsA9Zfv1X2fVEQhTw51lKENdNrEqT3,8,7,5,0,3,0,5,0,20,2.857142857142857,1,0.0,0,5,0,3,7,0,0,5,0,8,12,1
21462,198164,Wm4d7ifDaTgcR0GfUqwJt5OZKbYglRCq,A3fsA9Zfv1X2fVEQhTw51lKENdNrEqT3,1,0,0,0,0,0,1,0,1,0.14285714285714285,1,0.0,0,0,0,0,0,0,0,1,0,0,1,1
21463,198174,sN8O8pu3Q2qKEwnDCRLYVlmO1uAJE4Tm,bWdj2GDclj5ofokWjzoa5jAwMkxCykd6,2,0,0,0,0,0,2,0,2,0.2857142857142857,1,0.0,0,0,0,0,0,0,0,2,0,0,2,1
21464,198185,sAxHVWDxoGkBRa6727BiAQz0xOxKCIGR,A3fsA9Zfv1X2fVEQhTw51lKENdNrEqT3,13,12,6,12,5,0,4,0,39,5.571428571428571,1,0.0,0,6,10,5,12,0,2,4,0,21,18,1
21465,198188,l5G8UW1TXnTSjtyKClgVOnqQm4ApNaj0,SpATywNh6bZuzm8s1ceuBUnMUAeoAHHw,1,0,0,0,0,0,1,0,1,0.14285714285714285,1,0.0,0,0,0,0,0,0,0,1,0,0,1,1
21466,198191,5bHmfN0X9wT3swMDlkpW5ii5MZXZrCFW,SpATywNh6bZuzm8s1ceuBUnMUAeoAHHw,15,22,6,19,4,2,4,0,57,8.142857142857142,1,0.0,15,6,16,4,7,2,3,4,0,41,16,1
21467,198193,LFKsM29SPdpn03mCOLrrK3FdXPUDZBKB,A3fsA9Zfv1X2fVEQhTw51lKENdNrEqT3,5,2,1,0,1,0,5,0,9,1.2857142857142858,1,0.0,0,1,0,1,2,0,0,5,0,2,7,1
21468,198197,SC8FL9WL3BPOx8OCkTnqw5xmr73Pqs8z,A3fsA9Zfv1X2fVEQhTw51lKENdNrEqT3,7,4,3,0,3,0,2,0,12,1.7142857142857142,1,0.0,0,3,0,3,4,0,0,2,0,6,6,1
21469,198198,93Os1dPmyvzf4unZeLzWAm1E98vamZ7f,SpATywNh6bZuzm8s1ceuBUnMUAeoAHHw,5,2,1,0,1,0,2,0,6,0.8571428571428571,1,0.0,0,1,0,1,2,0,0,2,0,2,4,1
21470,198209,xudoA9elSC5Ik0l8XT7ohHiAxUwBFTwg,SpATywNh6bZuzm8s1ceuBUnMUAeoAHHw,14,9,6,11,4,0,2,0,32,4.571428571428571,1,0.0,2,6,9,4,7,0,2,2,0,21,11,1
21471,198227,NXiIb9Dcpvf6m1gIchCaIvmdnXDXN6rC,A3fsA9Zfv1X2fVEQhTw51lKENdNrEqT3,21,10,9,0,9,1,12,1,42,6.0,1,0.0,0,9,0,9,10,1,0,12,1,18,24,1
21472,198228,So8gZ8cXseEZ7lXf4idNMqcN46bXtlIA,bWdj2GDclj5ofokWjzoa5jAwMkxCykd6,4,2,1,0,1,0,1,0,5,0.7142857142857143,1,0.0,0,1,0,1,2,0,0,1,0,2,3,1
21473,198231,tblYMREbAeB7j9qmk5L4ctIeWrhD9ybH,A3fsA9Zfv1X2fVEQhTw51lKENdNrEqT3,1,0,0,0,0,0,1,0,1,0.14285714285714285,1,0.0,0,0,0,0,0,0,0,1,0,0,1,1
21474,198245,qq2f8Akny1ajULPtgXYv9fMRWduKMr9q,A3fsA9Zfv1X2fVEQhTw51lKENdNrEqT3,7,2,1,0,1,0,4,1,9,1.2857142857142858,1,0.0,0,1,0,1,2,0,0,4,1,2,7,1
21475,198253,eZIzehl9YTnThSDhfRvumYM9JAWW8X94,A3fsA9Zfv1X2fVEQhTw51lKENdNrEqT3,9,6,1,0,1,1,5,3,17,2.4285714285714284,1,0.0,0,1,0,1,6,1,0,5,3,2,15,1
21476,198257,FM9F7roZRXjjLVpKJMa3bf9FDgpJfg8g,A3fsA9Zfv1X2fVEQhTw51lKENdNrEqT3,1,0,0,0,0,0,1,0,1,0.14285714285714285,1,0.0,0,0,0,0,0,0,0,1,0,0,1,1
21477,198260,84GcjGYfYBEDW8RMth7eOtG4XRkKowY7,SpATywNh6bZuzm8s1ceuBUnMUAeoAHHw,5,5,2,0,1,0,2,0,10,1.4285714285714286,1,0.0,0,2,0,1,5,0,0,2,0,3,7,1
21478,198261,2dPSdalUbHtu7nWWfNnHcWGVd8UXHjrQ,SpATywNh6bZuzm8s1ceuBUnMUAeoAHHw,16,16,5,11,3,1,4,2,42,6.0,1,0.0,7,5,10,3,9,1,1,4,2,25,17,1
21479,198266,itycNCCvd4Cws5pdd4hKIkDKI4KaE5Jt,A3fsA9Zfv1X2fVEQhTw51lKENdNrEqT3,27,11,10,16,9,0,1,0,47,6.714285714285714,1,0.0,0,10,16,9,11,0,0,1,0,35,12,1
21480,198268,aIL1NEjCe1OHtEKm6JpGdIdTZNDD6Wwu,SpATywNh6bZuzm8s1ceuBUnMUAeoAHHw,1,0,0,0,0,0,1,0,1,0.14285714285714285,1,0.0,0,0,0,0,0,0,0,1,0,0,1,1
21481,198273,3UZJYrArdmpKznqwnck7MTEpjxG34pMK,SpATywNh6bZuzm8s1ceuBUnMUAeoAHHw,5,2,1,0,1,0,2,0,6,0.8571428571428571,1,0.0,0,1,0,1,2,0,0,2,0,2,4,1
21482,198284,TPwZPOPBUdCaLSbv54gObUYtfBQKaJVW,A3fsA9Zfv1X2fVEQhTw51lKENdNrEqT3,1,0,0,0,0,0,1,0,1,0.14285714285714285,1,0.0,0,0,0,0,0,0,0,1,0,0,1,1
21483,198297,bpXV0HZ9yixzCGyJdeSxqm4EvQYi9XKg,SpATywNh6bZuzm8s1ceuBUnMUAeoAHHw,2,0,0,0,0,0,3,0,3,0.42857142857142855,1,0.0,0,0,0,0,0,0,0,3,0,0,3,1
21484,198303,qzSOzKpDnUaSHLwAqVpSpGcUMfaOhDjD,G8EPVSXsOYB5YQWZGiz1aVq5Pgr2GrQu,5,2,1,0,1,0,2,0,6,0.8571428571428571,1,0.0,0,1,0,1,2,0,0,2,0,2,4,1
21485,198310,Cgmx3Ujcxc92HHP4N1UU0TjRl5xBcyRy,A3fsA9Zfv1X2fVEQhTw51lKENdNrEqT3,8,5,3,0,3,0,1,0,12,1.7142857142857142,1,0.0,1,3,0,3,4,0,0,1,0,7,5,1
21486,198312,nrvDpyOlV5T6ZU5wiBAqPXpBwJOtawqO,bWdj2GDclj5ofokWjzoa5jAwMkxCykd6,9,9,3,0,2,6,7,4,31,4.428571428571429,1,0.0,1,3,0,2,8,6,0,7,4,6,25,1
21487,198314,d6GKFo7VpAwS4H9iF45HPuBB7oVkM6uC,SpATywNh6bZuzm8s1ceuBUnMUAeoAHHw,10,8,3,16,2,0,2,0,31,4.428571428571429,1,0.0,4,3,13,2,4,0,3,2,0,22,9,1
21488,198319,hM78zuTWvc2c2WdiFwwJZnLKCiMEzZwE,RXDvfPUBYFlVdlueBFbLW0mhhAyGEqpt,5,4,3,0,2,0,1,0,10,1.4285714285714286,1,0.0,0,3,0,2,4,0,0,1,0,5,5,1
21489,198322,ZdxnlwASEXds7VOuv4UniogqFzAjU71x,G8EPVSXsOYB5YQWZGiz1aVq5Pgr2GrQu,4,0,0,0,0,1,3,0,4,0.5714285714285714,1,0.0,0,0,0,0,0,1,0,3,0,0,4,1
21490,198342,X3X3klM03RXeGUjty93sg2SlkZrg3xpQ,SpATywNh6bZuzm8s1ceuBUnMUAeoAHHw,1,0,0,0,0,0,1,0,1,0.14285714285714285,1,0.0,0,0,0,0,0,0,0,1,0,0,1,1
21491,198343,7XiYdmZTSPhaWzjUuGCUAw2ynyRrmxfl,SpATywNh6bZuzm8s1ceuBUnMUAeoAHHw,8,12,4,0,2,3,2,0,23,3.2857142857142856,1,0.0,6,4,0,2,6,3,0,2,0,12,11,1
21492,198344,walE7JsvJqHl8yLz0PR8Oim32Lz4OIQ0,A3fsA9Zfv1X2fVEQhTw51lKENdNrEqT3,1,0,0,0,0,0,1,0,1,0.14285714285714285,1,0.0,0,0,0,0,0,0,0,1,0,0,1,1
21493,198353,ByX3sCZWzA6bGb4zKqYogAA175eLOyAG,SpATywNh6bZuzm8s1ceuBUnMUAeoAHHw,11,8,6,2,3,0,1,0,20,2.857142857142857,1,0.0,1,6,2,3,7,0,0,1,0,12,8,1
21494,198372,hl3CIQ0lpvTB8gq9L7ARkQJG7PfzlcBL,RXDvfPUBYFlVdlueBFbLW0mhhAyGEqpt,1,0,0,0,0,0,1,0,1,0.14285714285714285,1,0.0,0,0,0,0,0,0,0,1,0,0,1,1
21495,198374,5fiIK7VmqPKr4nf6AwCLv5FpXOs8AmIF,A3fsA9Zfv1X2fVEQhTw51lKENdNrEqT3,4,2,1,0,1,0,2,0,6,0.8571428571428571,1,0.0,0,1,0,1,2,0,0,2,0,2,4,1
21496,198378,xsoPQiWD0DInR2Sgur0NcgW3AIl7NeY0,SpATywNh6bZuzm8s1ceuBUnMUAeoAHHw,5,3,1,0,1,0,2,0,7,1.0,1,0.0,0,1,0,1,3,0,0,2,0,2,5,1
21497,198379,dgFOOUSNfQK8xIrT47Av0Q04bBFeE21W,A3fsA9Zfv1X2fVEQhTw51lKENdNrEqT3,7,3,2,0,2,0,3,0,10,1.4285714285714286,1,0.0,0,2,0,2,3,0,0,3,0,4,6,0
21498,198388,zum8lmwUciqBOjRcsKypiYs2OlSb1h15,A3fsA9Zfv1X2fVEQhTw51lKENdNrEqT3,9,6,1,0,1,0,4,0,12,1.7142857142857142,1,0.0,0,1,0,1,6,0,0,4,0,2,10,0
21499,198398,83TQNbmBQ9BH29WB1QIy1fMhXfCV72jv,A3fsA9Zfv1X2fVEQhTw51lKENdNrEqT3,1,0,0,0,0,0,1,0,1,0.14285714285714285,1,0.0,0,0,0,0,0,0,0,1,0,0,1,1
21500,198400,C23sTQ3IqWj72FdxhbjBadlgfhNvNhLt,bWdj2GDclj5ofokWjzoa5jAwMkxCykd6,4,2,1,0,0,0,2,0,5,0.7142857142857143,1,0.0,0,1,0,0,2,0,0,2,0,1,4,1
21501,198403,Dq2cCGdJlkpRnI9Tq5kE4JyzjGIGvpDz,A3fsA9Zfv1X2fVEQhTw51lKENdNrEqT3,9,5,3,0,3,0,4,0,15,2.142857142857143,1,0.0,0,3,0,3,5,0,0,4,0,6,9,1
21502,198404,hrPjKcL9rUfM1fnC8qta4lu2HmlsBLv6,A3fsA9Zfv1X2fVEQhTw51lKENdNrEqT3,12,6,5,0,5,0,1,0,17,2.4285714285714284,1,0.0,0,5,0,5,6,0,0,1,0,10,7,1
21503,198410,Kkww4jmevg0ZHJyNJmjfSGoxXiVH3qc9,SpATywNh6bZuzm8s1ceuBUnMUAeoAHHw,5,2,1,0,1,3,3,0,10,1.4285714285714286,1,0.0,0,1,0,1,2,3,0,3,0,2,8,1
21504,198411,6dJBpGT7qNr0NTuZjVXnITeb9R9DQeyE,SpATywNh6bZuzm8s1ceuBUnMUAeoAHHw,2,0,0,0,0,0,2,0,2,0.2857142857142857,1,0.0,0,0,0,0,0,0,0,2,0,0,2,1
21505,198416,KhKCxhPBpm8wuQfuIb6HFYBHnnvZJlex,RXDvfPUBYFlVdlueBFbLW0mhhAyGEqpt,1,0,0,0,0,0,1,0,1,0.14285714285714285,1,0.0,0,0,0,0,0,0,0,1,0,0,1,1
21506,198417,2uLHED4iY9VmLy5RW7Mfy2sLsR8ze3u7,RXDvfPUBYFlVdlueBFbLW0mhhAyGEqpt,1,0,0,0,0,0,1,0,1,0.14285714285714285,1,0.0,0,0,0,0,0,0,0,1,0,0,1,1
21507,198429,Fm0KmurJVBFEZiRcw3nlgAYLTArGnQaR,SpATywNh6bZuzm8s1ceuBUnMUAeoAHHw,16,30,1,14,1,20,14,4,84,12.0,1,0.0,7,1,12,1,23,20,2,14,4,21,63,1
21508,198446,P4gIdHzF607L8e8VPH3Qb09lxgNZRJFa,SpATywNh6bZuzm8s1ceuBUnMUAeoAHHw,4,3,0,0,0,0,1,0,4,0.5714285714285714,1,0.0,0,0,0,0,3,0,0,1,0,0,4,0
21509,198448,brW82YOCdOnTyLjpAh6QOg0ROSIhJ2Rz,A3fsA9Zfv1X2fVEQhTw51lKENdNrEqT3,2,0,0,0,0,0,3,0,3,0.42857142857142855,1,0.0,0,0,0,0,0,0,0,3,0,0,3,1
21510,198449,ncZpzPYvUtQjJgcrnY99CiTzo4JQVsl8,SpATywNh6bZuzm8s1ceuBUnMUAeoAHHw,4,2,0,0,0,0,2,0,4,0.5714285714285714,1,0.0,0,0,0,0,2,0,0,2,0,0,4,1
21511,198454,MqwnKklVqrb7jfevVzyfhGQMDPOkys7S,A3fsA9Zfv1X2fVEQhTw51lKENdNrEqT3,6,2,0,0,0,1,7,1,11,1.5714285714285714,1,0.0,0,0,0,0,2,1,0,7,1,0,11,1
21512,198475,Wq2ch7EEtsSKF9Vm0sUqWsaIHScTXudA,SpATywNh6bZuzm8s1ceuBUnMUAeoAHHw,4,2,1,0,1,0,1,0,5,0.7142857142857143,1,0.0,0,1,0,1,2,0,0,1,0,2,3,1
21513,198479,zHNYns4eYsvaD0PCrPbR7JoIqflHxrEv,A3fsA9Zfv1X2fVEQhTw51lKENdNrEqT3,1,0,0,0,0,0,1,0,1,0.14285714285714285,1,0.0,0,0,0,0,0,0,0,1,0,0,1,1
21514,198486,jHa0rWGu66mtR6qdZK3honEGURZjLRQo,SpATywNh6bZuzm8s1ceuBUnMUAeoAHHw,4,4,3,0,3,0,1,0,11,1.5714285714285714,1,0.0,0,3,0,3,4,0,0,1,0,6,5,0
21515,198492,SZnZ9mw8U8WzrYPDnWgxJCTIBCqTF6rB,SpATywNh6bZuzm8s1ceuBUnMUAeoAHHw,2,0,0,0,0,0,2,0,2,0.2857142857142857,1,0.0,0,0,0,0,0,0,0,2,0,0,2,1
21516,198495,OO2Ag6HEFKkZRtZuzzt1ya8SiL4BLCOC,RXDvfPUBYFlVdlueBFbLW0mhhAyGEqpt,1,0,0,0,0,0,1,0,1,0.14285714285714285,1,0.0,0,0,0,0,0,0,0,1,0,0,1,1
21517,198496,byyujsciSYId0rQQrEakxEnXcWLiLPay,SpATywNh6bZuzm8s1ceuBUnMUAeoAHHw,10,9,1,0,1,1,9,1,22,3.142857142857143,1,0.0,0,1,0,1,9,1,0,9,1,2,20,1
21518,198497,AfmdKPTL0IbcupndNMlY5c7PImPraChY,A3fsA9Zfv1X2fVEQhTw51lKENdNrEqT3,13,7,5,0,5,0,1,0,18,2.5714285714285716,1,0.0,0,5,0,5,7,0,0,1,0,10,8,1
21519,198500,dN2hlyHLZZp4dyg60YxnWe6xCUBAX5se,bWdj2GDclj5ofokWjzoa5jAwMkxCykd6,4,3,1,0,1,0,2,0,7,1.0,1,0.0,0,1,0,1,3,0,0,2,0,2,5,1
21520,198501,EwaALzeaojV7pPZOsHFx7jzB7xjVDGvQ,bWdj2GDclj5ofokWjzoa5jAwMkxCykd6,8,4,0,14,0,1,3,1,23,3.2857142857142856,1,0.0,1,0,14,0,3,1,0,3,1,15,8,1
21521,198503,F16OuTgaH1ZbsvG4bVnrHtSG2xmdMXNR,A3fsA9Zfv1X2fVEQhTw51lKENdNrEqT3,7,5,2,0,2,0,2,1,12,1.7142857142857142,1,0.0,0,2,0,2,5,0,0,2,1,4,8,1
21522,198506,sVvZPZ3GVHWR4Hg1FcQf4FWks0TLCNOR,A3fsA9Zfv1X2fVEQhTw51lKENdNrEqT3,14,7,5,0,3,1,8,1,25,3.5714285714285716,1,0.0,0,5,0,3,7,1,0,8,1,8,17,1
21523,198517,xIuD143aD9LhLXzAc6byVmIGYF4SpJsZ,A3fsA9Zfv1X2fVEQhTw51lKENdNrEqT3,1,0,0,0,0,0,1,0,1,0.14285714285714285,1,0.0,0,0,0,0,0,0,0,1,0,0,1,1
21524,198518,eEUIScknc9SimnLuPMm5Vf07ulWcWd92,A3fsA9Zfv1X2fVEQhTw51lKENdNrEqT3,1,0,0,0,0,0,1,0,1,0.14285714285714285,1,0.0,0,0,0,0,0,0,0,1,0,0,1,1
21525,198529,eBQTzPv3v3TV7mZrXSw0RrOHTLWkqz5k,bWdj2GDclj5ofokWjzoa5jAwMkxCykd6,7,4,2,0,2,0,2,0,10,1.4285714285714286,1,0.0,1,2,0,2,3,0,0,2,0,5,5,1
21526,198539,w7s7CbDlE2P2RGY2w8kEYH9keSavEsec,bWdj2GDclj5ofokWjzoa5jAwMkxCykd6,2,0,0,0,0,0,2,0,2,0.2857142857142857,1,0.0,0,0,0,0,0,0,0,2,0,0,2,1
21527,198547,2kSwVlbsGRMwb7boxmMBKvNiRXYYeI1Y,SpATywNh6bZuzm8s1ceuBUnMUAeoAHHw,2,0,0,0,0,0,2,0,2,0.2857142857142857,1,0.0,0,0,0,0,0,0,0,2,0,0,2,1
21528,198550,dYWKoJoBpKPEwdcqoTPZCoTIyvG7V1Tu,A3fsA9Zfv1X2fVEQhTw51lKENdNrEqT3,6,3,1,0,1,6,5,0,16,2.2857142857142856,1,0.0,0,1,0,1,3,6,0,5,0,2,14,1
21529,198555,s37SmpVU3dTE3yD2mQmjjcBs0sjjoAwz,SpATywNh6bZuzm8s1ceuBUnMUAeoAHHw,15,28,0,18,0,4,8,3,61,8.714285714285714,1,0.0,18,0,17,0,10,4,1,8,3,35,26,1
21530,198560,b0mgWZqNzMdtJFxZULQczG8Tc3XpTILP,bWdj2GDclj5ofokWjzoa5jAwMkxCykd6,9,6,3,2,3,0,1,0,15,2.142857142857143,1,0.0,2,3,2,3,4,0,0,1,0,10,5,0
21531,198562,dYWKoJoBpKPEwdcqoTPZCoTIyvG7V1Tu,bWdj2GDclj5ofokWjzoa5jAwMkxCykd6,7,5,2,0,2,0,1,0,10,1.4285714285714286,1,0.0,0,2,0,2,5,0,0,1,0,4,6,1
21532,198566,zhF9aamFaaPbw8uvKpkg1m1HOa3rg91T,A3fsA9Zfv1X2fVEQhTw51lKENdNrEqT3,18,9,8,0,8,0,1,0,26,3.7142857142857144,1,0.0,0,8,0,8,9,0,0,1,0,16,10,1
21533,198567,4GJSwwikGuUWXSajcKoSlvfsoiC8eEZq,A3fsA9Zfv1X2fVEQhTw51lKENdNrEqT3,12,16,14,0,0,0,4,0,34,4.857142857142857,1,0.0,0,14,0,0,16,0,0,4,0,14,20,1
21534,198575,IR9p9WuPGPaaA4f6RkgkUYRRmOTg8aPE,SpATywNh6bZuzm8s1ceuBUnMUAeoAHHw,1,0,0,0,0,0,1,0,1,0.14285714285714285,1,0.0,0,0,0,0,0,0,0,1,0,0,1,1
21535,198576,M75L90OOMTV1kEiI3n7vM0ty47YBFna9,A3fsA9Zfv1X2fVEQhTw51lKENdNrEqT3,5,7,1,0,1,0,2,0,11,1.5714285714285714,1,0.0,0,1,0,1,7,0,0,2,0,2,9,1
21536,198577,QXph4cOoRqm5422pzQXvVGuiJ0zPyE5f,SpATywNh6bZuzm8s1ceuBUnMUAeoAHHw,7,4,3,0,3,0,2,0,12,1.7142857142857142,1,0.0,0,3,0,3,4,0,0,2,0,6,6,1
21537,198580,iJRgFwBj3cEAZI5JrvtGnB3yvPVZ5Cdq,bWdj2GDclj5ofokWjzoa5jAwMkxCykd6,8,2,2,0,2,0,3,0,9,1.2857142857142858,1,0.0,0,2,0,2,2,0,0,3,0,4,5,1
21538,198581,W5wwRspxUk4ZCYBlSnCmonKbHdsPqzQn,SpATywNh6bZuzm8s1ceuBUnMUAeoAHHw,2,0,0,0,0,0,2,0,2,0.2857142857142857,1,0.0,0,0,0,0,0,0,0,2,0,0,2,1
21539,198584,0q3P6YGkZ2dxtBIeVbo5DKpZyIRZVZAM,A3fsA9Zfv1X2fVEQhTw51lKENdNrEqT3,1,0,0,0,0,0,1,0,1,0.14285714285714285,1,0.0,0,0,0,0,0,0,0,1,0,0,1,1
21540,198596,ZfjfwFl0JPdJif1Zgl3u0FEb4C4l2Zxn,A3fsA9Zfv1X2fVEQhTw51lKENdNrEqT3,8,4,2,0,3,0,1,0,10,1.4285714285714286,1,0.0,0,2,0,3,4,0,0,1,0,5,5,1
21541,198603,fsydotVTfs3IO9vO0Vkp2xRbb1WB0CCz,SpATywNh6bZuzm8s1ceuBUnMUAeoAHHw,8,3,1,0,1,0,7,1,13,1.8571428571428572,1,0.0,0,1,0,1,3,0,0,7,1,2,11,1
21542,198605,pnnKMIXc9aatMHlNextjL8MoSsu3IuzR,SpATywNh6bZuzm8s1ceuBUnMUAeoAHHw,5,2,1,0,1,0,2,0,6,0.8571428571428571,1,0.0,0,1,0,1,2,0,0,2,0,2,4,1
21543,198637,CUEyHbsjLlbX6I7tsbnNjxFI1v5Lj4iD,bWdj2GDclj5ofokWjzoa5jAwMkxCykd6,5,2,1,0,1,0,2,0,6,0.8571428571428571,1,0.0,0,1,0,1,2,0,0,2,0,2,4,1
21544,198643,6lxqO6gucEPo0iFbRZ4Psmditgm2GZdr,SpATywNh6bZuzm8s1ceuBUnMUAeoAHHw,10,7,4,6,0,0,3,0,20,2.857142857142857,1,0.0,2,4,6,0,5,0,0,3,0,12,8,1
21545,198646,iCEb35gaygczCVXBPDGlI3sXrSsDaVej,bWdj2GDclj5ofokWjzoa5jAwMkxCykd6,1,0,0,0,0,0,2,0,2,0.2857142857142857,1,0.0,0,0,0,0,0,0,0,2,0,0,2,1
21546,198656,mXfwwTIVjHMqoVKAh2iEQbinKUCJHwTp,A3fsA9Zfv1X2fVEQhTw51lKENdNrEqT3,8,6,3,0,2,0,8,0,19,2.7142857142857144,1,0.0,0,3,0,2,6,0,0,8,0,5,14,1
21547,198671,34cVbMGyVO1SqQjOK9RNk00q4uKA3nIE,SpATywNh6bZuzm8s1ceuBUnMUAeoAHHw,5,2,1,0,1,0,2,0,6,0.8571428571428571,1,0.0,0,1,0,1,2,0,0,2,0,2,4,1
21548,198676,8OMQVFIkmUspkJuyYp0KATDRhux0sdCZ,A3fsA9Zfv1X2fVEQhTw51lKENdNrEqT3,5,0,0,0,0,1,5,1,7,1.0,1,0.0,0,0,0,0,0,1,0,5,1,0,7,1
21549,198682,O1JCj9IRlzuPnXGSMFH3o6nPheXmI0dk,A3fsA9Zfv1X2fVEQhTw51lKENdNrEqT3,5,2,0,0,0,0,3,1,6,0.8571428571428571,1,0.0,0,0,0,0,2,0,0,3,1,0,6,1
21550,198700,iJRgFwBj3cEAZI5JrvtGnB3yvPVZ5Cdq,A3fsA9Zfv1X2fVEQhTw51lKENdNrEqT3,6,1,1,0,1,0,3,0,6,0.8571428571428571,1,0.0,0,1,0,1,1,0,0,3,0,2,4,1
21551,198709,JlndvP2EuIlwJAySHuL6QfQBf6i8elGn,G8EPVSXsOYB5YQWZGiz1aVq5Pgr2GrQu,2,0,0,0,0,0,2,0,2,0.2857142857142857,1,0.0,0,0,0,0,0,0,0,2,0,0,2,1
21552,198711,5Lnagj9S1Vv0G8cjSfxcxK2ro2WrQMdB,G8EPVSXsOYB5YQWZGiz1aVq5Pgr2GrQu,4,2,0,0,0,0,5,0,7,1.0,1,0.0,0,0,0,0,2,0,0,5,0,0,7,1
21553,198722,ITvb0EWV8ZZ88RI4SBwUoVbHLyVcwZRP,A3fsA9Zfv1X2fVEQhTw51lKENdNrEqT3,13,12,1,0,0,0,2,0,15,2.142857142857143,1,0.0,0,1,0,0,12,0,0,2,0,1,14,1
21554,198734,QCY6rb7yvcagouaf25uIFV9RWdPPOb7l,SpATywNh6bZuzm8s1ceuBUnMUAeoAHHw,5,4,0,0,0,0,1,0,5,0.7142857142857143,1,0.0,0,0,0,0,4,0,0,1,0,0,5,1
21555,198739,QvUtN7NvmMmWACtjGZbRh5vUGOqoadOI,SpATywNh6bZuzm8s1ceuBUnMUAeoAHHw,1,0,0,0,0,0,1,0,1,0.14285714285714285,1,0.0,0,0,0,0,0,0,0,1,0,0,1,1
21556,198740,ilMjmMVbiUSUOOjXRXyXhngOcMKQcGhx,G8EPVSXsOYB5YQWZGiz1aVq5Pgr2GrQu,2,0,0,0,0,0,2,0,2,0.2857142857142857,1,0.0,0,0,0,0,0,0,0,2,0,0,2,1
21557,198747,ScmiDI5AINzZbjcs2bWNBHbp8udIsqgh,SpATywNh6bZuzm8s1ceuBUnMUAeoAHHw,7,7,2,0,1,0,3,0,13,1.8571428571428572,1,0.0,0,2,0,1,7,0,0,3,0,3,10,1
21558,198755,l99Zcol89MEEF7ym4ZK8FY1ESaelZnlP,A3fsA9Zfv1X2fVEQhTw51lKENdNrEqT3,8,5,4,0,4,0,1,0,14,2.0,1,0.0,0,4,0,4,5,0,0,1,0,8,6,0
21559,198761,ONe4iInwtHkZ5gtlbWN831JopVHbaD8L,SpATywNh6bZuzm8s1ceuBUnMUAeoAHHw,3,0,0,0,0,2,5,0,7,1.0,1,0.0,0,0,0,0,0,2,0,5,0,0,7,1
21560,198769,XduGpggqMznFnxTLbAhFUOyKgFLNMc8n,SpATywNh6bZuzm8s1ceuBUnMUAeoAHHw,4,2,1,0,1,0,1,0,5,0.7142857142857143,1,0.0,0,1,0,1,2,0,0,1,0,2,3,1
21561,198792,g1dFQ3mnVnBiIhnsU4zqK21biH9l5lF9,A3fsA9Zfv1X2fVEQhTw51lKENdNrEqT3,1,0,0,0,0,0,1,0,1,0.14285714285714285,1,0.0,0,0,0,0,0,0,0,1,0,0,1,1
21562,198793,QrIpd1N2l4iqQkNACgUM7iTDn2RZjb2Z,A3fsA9Zfv1X2fVEQhTw51lKENdNrEqT3,1,0,0,0,0,0,1,0,1,0.14285714285714285,1,0.0,0,0,0,0,0,0,0,1,0,0,1,1
21563,198807,FrcNdFNfLYMOg5fdBzjs15qKbgtHEYZH,A3fsA9Zfv1X2fVEQhTw51lKENdNrEqT3,5,2,1,0,1,0,2,0,6,0.8571428571428571,1,0.0,0,1,0,1,2,0,0,2,0,2,4,0
21564,198812,DxsFVZh699mkeWBLgWLRdSxOs5e2KIgS,SpATywNh6bZuzm8s1ceuBUnMUAeoAHHw,11,8,4,0,2,3,7,1,25,3.5714285714285716,1,0.0,2,4,0,2,6,3,0,7,1,8,17,1
21565,198820,chD7Ekz0CCeTW4cvhA1an0KXokkNIvTf,SpATywNh6bZuzm8s1ceuBUnMUAeoAHHw,1,0,0,0,0,0,1,0,1,0.14285714285714285,1,0.0,0,0,0,0,0,0,0,1,0,0,1,1
21566,198822,uZbzvdzFyR1ceRxI8f80IsSKw8Wzuev1,SpATywNh6bZuzm8s1ceuBUnMUAeoAHHw,7,7,1,0,1,0,2,0,11,1.5714285714285714,1,0.0,0,1,0,1,7,0,0,2,0,2,9,0
21567,198823,2ENDZhPlfPQ7xqwHjrfLuuWg5Duw7ZBj,G8EPVSXsOYB5YQWZGiz1aVq5Pgr2GrQu,4,4,1,0,1,0,1,0,7,1.0,1,0.0,1,1,0,1,3,0,0,1,0,3,4,1
21568,198832,PKdKWqW1VQJFocRWfF0D5fFjfdW8ENqW,SpATywNh6bZuzm8s1ceuBUnMUAeoAHHw,2,0,0,0,0,0,2,0,2,0.2857142857142857,1,0.0,0,0,0,0,0,0,0,2,0,0,2,1
21569,198844,9xn3imvdiJkc9HcKhWV1Hhylco4OVjiR,SpATywNh6bZuzm8s1ceuBUnMUAeoAHHw,2,0,0,0,0,0,2,0,2,0.2857142857142857,1,0.0,0,0,0,0,0,0,0,2,0,0,2,1
21570,198849,9xn3imvdiJkc9HcKhWV1Hhylco4OVjiR,G8EPVSXsOYB5YQWZGiz1aVq5Pgr2GrQu,7,13,0,0,0,0,4,0,17,2.4285714285714284,1,0.0,1,0,0,0,12,0,0,4,0,1,16,1
21571,198863,ZWKBU7cFyL8Xqx9wqUlqIH5ujAlqP1xm,A3fsA9Zfv1X2fVEQhTw51lKENdNrEqT3,8,7,3,0,2,0,3,0,15,2.142857142857143,1,0.0,0,3,0,2,7,0,0,3,0,5,10,1
21572,198865,AUCcjgWVaeHbyOo7n1ZoCM3NX1aTzthI,G8EPVSXsOYB5YQWZGiz1aVq5Pgr2GrQu,7,4,0,0,0,0,5,0,9,1.2857142857142858,1,0.0,0,0,0,0,4,0,0,5,0,0,9,1
21573,198866,cGujrM5GGnHFlTqKFoeVE54jkUOVyngH,A3fsA9Zfv1X2fVEQhTw51lKENdNrEqT3,1,0,0,0,0,0,1,0,1,0.14285714285714285,1,0.0,0,0,0,0,0,0,0,1,0,0,1,1
21574,198868,rlQIqtgsDfEVihltHvVH3EnaOkFIJWY2,A3fsA9Zfv1X2fVEQhTw51lKENdNrEqT3,1,0,0,0,0,0,1,0,1,0.14285714285714285,1,0.0,0,0,0,0,0,0,0,1,0,0,1,1
21575,198869,TSm2R7cUPaXhbTrj1LddmwVL7dduRSSa,A3fsA9Zfv1X2fVEQhTw51lKENdNrEqT3,8,3,2,0,2,8,6,1,22,3.142857142857143,1,0.0,0,2,0,2,3,8,0,6,1,4,18,1
21576,198870,3Ayux0uPJ6ML3SyziM62LSRrG0V1OgIm,SpATywNh6bZuzm8s1ceuBUnMUAeoAHHw,17,18,11,10,6,1,6,1,53,7.571428571428571,1,0.0,5,11,9,6,13,1,1,6,1,31,22,1
21577,198874,JdraUX9nFc2Y8K2LiincPu5HyHjoquI8,A3fsA9Zfv1X2fVEQhTw51lKENdNrEqT3,8,6,0,0,0,1,10,1,18,2.5714285714285716,1,0.0,3,0,0,0,3,1,0,10,1,3,15,1
21578,198894,nKVAY2GHYnzf4BfG261ddlVdtqvsIA9B,A3fsA9Zfv1X2fVEQhTw51lKENdNrEqT3,6,4,2,0,2,0,1,0,9,1.2857142857142858,1,0.0,0,2,0,2,4,0,0,1,0,4,5,1
21579,198899,ctoSfpAfvm3av2aqkT0D3Yq8icDxZKCx,A3fsA9Zfv1X2fVEQhTw51lKENdNrEqT3,1,0,0,0,0,0,1,0,1,0.14285714285714285,1,0.0,0,0,0,0,0,0,0,1,0,0,1,1
21580,198902,pSRqXJrhW3cpcIMqshrNJY13lAR5UPwX,G8EPVSXsOYB5YQWZGiz1aVq5Pgr2GrQu,2,0,0,0,0,0,2,0,2,0.2857142857142857,1,0.0,0,0,0,0,0,0,0,2,0,0,2,1
21581,198903,iUqEEHE7KFlYvrJ9lttneq6sdDOxoE0o,SpATywNh6bZuzm8s1ceuBUnMUAeoAHHw,1,0,0,0,0,0,1,0,1,0.14285714285714285,1,0.0,0,0,0,0,0,0,0,1,0,0,1,0
21582,198910,pSRqXJrhW3cpcIMqshrNJY13lAR5UPwX,A3fsA9Zfv1X2fVEQhTw51lKENdNrEqT3,2,0,0,0,0,0,2,0,2,0.2857142857142857,1,0.0,0,0,0,0,0,0,0,2,0,0,2,1
21583,198915,5RFNEnBqW8mdktbwEzjZ2lPhm72vzWhr,SpATywNh6bZuzm8s1ceuBUnMUAeoAHHw,8,4,3,0,2,0,2,0,11,1.5714285714285714,1,0.0,0,3,0,2,4,0,0,2,0,5,6,1
21584,198936,QO42SHgXwWqLSSYHUVMAX8sjMgYnpZEl,G8EPVSXsOYB5YQWZGiz1aVq5Pgr2GrQu,7,3,2,0,2,0,2,0,9,1.2857142857142858,1,0.0,0,2,0,2,3,0,0,2,0,4,5,1
21585,198955,25eiJkNBguZOcrPXS1ZGiSW1nfaRn05c,SpATywNh6bZuzm8s1ceuBUnMUAeoAHHw,7,3,2,0,2,0,2,0,9,1.2857142857142858,1,0.0,0,2,0,2,3,0,0,2,0,4,5,1
21586,198956,GyLB5V57I2KbnfFgZclSqyQAUY6eRpjt,A3fsA9Zfv1X2fVEQhTw51lKENdNrEqT3,2,0,0,0,0,0,2,0,2,0.2857142857142857,1,0.0,0,0,0,0,0,0,0,2,0,0,2,1
21587,198963,WAnB7c5F1PHHqCCd4HzBf0vmVEoM8DG4,SpATywNh6bZuzm8s1ceuBUnMUAeoAHHw,6,3,0,0,0,2,6,0,11,1.5714285714285714,1,0.0,0,0,0,0,3,2,0,6,0,0,11,1
21588,198965,9og5l3kBrvNmeUS7WEJnLIW5U5JOFnlr,SpATywNh6bZuzm8s1ceuBUnMUAeoAHHw,5,1,1,0,1,0,2,0,5,0.7142857142857143,1,0.0,0,1,0,1,1,0,0,2,0,2,3,1
21589,198975,2oTvbzieHn2y5oozeOgSnruqE6N0BtR5,bWdj2GDclj5ofokWjzoa5jAwMkxCykd6,11,11,6,0,5,7,4,0,33,4.714285714285714,1,0.0,2,6,0,5,9,7,0,4,0,13,20,1
21590,198976,qJSVGIIBKQpzllCeTCwG3pgdEZIo3QRz,bWdj2GDclj5ofokWjzoa5jAwMkxCykd6,1,0,0,0,0,0,1,0,1,0.14285714285714285,1,0.0,0,0,0,0,0,0,0,1,0,0,1,1
21591,198979,U5aocuOsbgg0bKahFwFd1In2DcDc3oBc,G8EPVSXsOYB5YQWZGiz1aVq5Pgr2GrQu,7,5,2,0,2,0,2,0,11,1.5714285714285714,1,0.0,0,2,0,2,5,0,0,2,0,4,7,1
21592,198991,mSWRBlOsrbB7GjQNoTuNmuW3YOy77l6X,bWdj2GDclj5ofokWjzoa5jAwMkxCykd6,1,0,0,0,0,0,1,0,1,0.14285714285714285,1,0.0,0,0,0,0,0,0,0,1,0,0,1,1
21593,198993,mSWRBlOsrbB7GjQNoTuNmuW3YOy77l6X,A3fsA9Zfv1X2fVEQhTw51lKENdNrEqT3,1,0,0,0,0,0,1,0,1,0.14285714285714285,1,0.0,0,0,0,0,0,0,0,1,0,0,1,1
21594,199000,4UScXtt088oGe9dJ2KJws6faWfnlaEO8,G8EPVSXsOYB5YQWZGiz1aVq5Pgr2GrQu,8,12,0,0,0,0,4,0,16,2.2857142857142856,1,0.0,0,0,0,0,12,0,0,4,0,0,16,1
21595,199004,wB1zTvSxiuMnQ6mG62KhRDH75H6JzCKK,G8EPVSXsOYB5YQWZGiz1aVq5Pgr2GrQu,1,0,0,0,0,0,1,0,1,0.14285714285714285,1,0.0,0,0,0,0,0,0,0,1,0,0,1,1
21596,199009,UoLm4A2shVKJTBQjYq1cnhy9CVAb6BPB,SpATywNh6bZuzm8s1ceuBUnMUAeoAHHw,1,0,0,0,0,0,2,0,2,0.2857142857142857,1,0.0,0,0,0,0,0,0,0,2,0,0,2,1
21597,199016,C4ciI1Hxrse5ND4h1rvhsDGjFinNO7RJ,bWdj2GDclj5ofokWjzoa5jAwMkxCykd6,8,9,1,0,1,1,10,5,27,3.857142857142857,1,0.0,5,1,0,1,4,1,0,10,5,7,20,1
21598,199018,YQQ0U1ySGhxQGw2MpzkqAJru8VuefP0L,bWdj2GDclj5ofokWjzoa5jAwMkxCykd6,4,5,2,0,0,0,2,0,9,1.2857142857142858,1,0.0,2,2,0,0,3,0,0,2,0,4,5,1
21599,199029,cderIDaWBR3ykedbqXoG7yh75mThXkpL,bWdj2GDclj5ofokWjzoa5jAwMkxCykd6,1,0,0,0,0,0,1,0,1,0.14285714285714285,1,0.0,0,0,0,0,0,0,0,1,0,0,1,1
21600,199032,aTQ4Ypzwh1rImg9ZYH1ng3j22ZvxNJg3,SpATywNh6bZuzm8s1ceuBUnMUAeoAHHw,1,0,0,0,0,0,1,0,1,0.14285714285714285,1,0.0,0,0,0,0,0,0,0,1,0,0,1,1
21601,199036,Cj6qzoa736NxMqt5KsDr9YuISfsEJCrb,SpATywNh6bZuzm8s1ceuBUnMUAeoAHHw,6,3,1,0,1,0,2,0,7,1.0,1,0.0,0,1,0,1,3,0,0,2,0,2,5,1
21602,199044,nmlYjXdaqWSjPWm2kQhmjZqjjBKhkQAm,bWdj2GDclj5ofokWjzoa5jAwMkxCykd6,6,3,2,0,2,1,4,1,13,1.8571428571428572,1,0.0,0,2,0,2,3,1,0,4,1,4,9,1
21603,199046,xcyypTvwSo3LXkXsaePEIK0Y1mo0nQoS,SpATywNh6bZuzm8s1ceuBUnMUAeoAHHw,13,15,8,4,3,0,2,0,32,4.571428571428571,1,0.0,6,8,4,3,9,0,0,2,0,21,11,1
21604,199049,Yer7ST1oiQQLYYgjANCmG1MBkWuTCohH,bWdj2GDclj5ofokWjzoa5jAwMkxCykd6,1,0,0,0,0,0,1,0,1,0.14285714285714285,1,0.0,0,0,0,0,0,0,0,1,0,0,1,1
21605,199051,uufXnXOfmStAymRAiMYAROVtj5hPlDvd,A3fsA9Zfv1X2fVEQhTw51lKENdNrEqT3,1,0,0,0,0,0,1,0,1,0.14285714285714285,1,0.0,0,0,0,0,0,0,0,1,0,0,1,1
21606,199056,OGCl7FuINJMmIPxVehaSeriK0obhKOqa,SpATywNh6bZuzm8s1ceuBUnMUAeoAHHw,8,6,4,0,3,0,1,0,14,2.0,1,0.0,0,4,0,3,6,0,0,1,0,7,7,1
21607,199057,AW3qB37tEUxBhbQEUxhofJkaUbKF4F7i,bWdj2GDclj5ofokWjzoa5jAwMkxCykd6,2,0,0,0,0,4,1,0,5,0.7142857142857143,1,0.0,0,0,0,0,0,4,0,1,0,0,5,1
21608,199058,VeLCqoeC0RO3eUOAMmBgbUdlxxqFnwbN,SpATywNh6bZuzm8s1ceuBUnMUAeoAHHw,4,4,0,0,0,0,2,0,6,0.8571428571428571,1,0.0,0,0,0,0,4,0,0,2,0,0,6,0
21609,199069,M45QNJ6951iGJajsprAeFVhHViiX50AV,A3fsA9Zfv1X2fVEQhTw51lKENdNrEqT3,22,12,10,0,9,5,5,1,42,6.0,1,0.0,0,10,0,9,12,5,0,5,1,19,23,1
21610,199078,pXGBcTffNYWAUeYw1RFCIuTgQsIvI4OJ,G8EPVSXsOYB5YQWZGiz1aVq5Pgr2GrQu,5,2,1,0,1,0,2,0,6,0.8571428571428571,1,0.0,0,1,0,1,2,0,0,2,0,2,4,0
21611,199082,MDp7DOIvKcLxQwYa7iYETsW6UM7XLKe9,3VkHkmOtom3jM2wCu94xgzzu1d6Dn7or,5,2,1,0,1,0,2,0,6,0.8571428571428571,1,0.0,0,1,0,1,2,0,0,2,0,2,4,0
21612,199097,c6Lk0MnCUGXZQ5o6l8UnHA0XawHnWKca,3VkHkmOtom3jM2wCu94xgzzu1d6Dn7or,1,0,0,0,0,0,1,0,1,0.14285714285714285,1,0.0,0,0,0,0,0,0,0,1,0,0,1,1
21613,199099,D2mqYQzmwXfHmkcpG9YcM985v42dZT5i,3VkHkmOtom3jM2wCu94xgzzu1d6Dn7or,1,0,0,0,0,0,1,0,1,0.14285714285714285,1,0.0,0,0,0,0,0,0,0,1,0,0,1,1
21614,199101,SMdSH6gTeMo8uypLu3FkgYnM2y7eiJMa,3VkHkmOtom3jM2wCu94xgzzu1d6Dn7or,1,0,0,0,0,0,1,0,1,0.14285714285714285,1,0.0,0,0,0,0,0,0,0,1,0,0,1,1
21615,199109,sMynuMhoZTpmWI7JIgM7Zcgv9Nw77yWq,3VkHkmOtom3jM2wCu94xgzzu1d6Dn7or,1,0,0,0,0,0,1,0,1,0.14285714285714285,1,0.0,0,0,0,0,0,0,0,1,0,0,1,1
21616,199111,CY8h7ccBxsJwojp3CaWp3n3pn8ZSTU6a,3VkHkmOtom3jM2wCu94xgzzu1d6Dn7or,5,1,1,0,0,0,5,1,8,1.1428571428571428,1,0.0,0,1,0,0,1,0,0,5,1,1,7,1
21617,199128,YvOc6FqXZMoL0NWYKBDQjwnxonb9FCcf,3VkHkmOtom3jM2wCu94xgzzu1d6Dn7or,1,0,0,0,0,0,1,0,1,0.14285714285714285,1,0.0,0,0,0,0,0,0,0,1,0,0,1,1
21618,199149,O5yzVszMpi9v4YHXoTUnhN19xXR2rb7W,3VkHkmOtom3jM2wCu94xgzzu1d6Dn7or,7,5,4,0,3,0,1,0,13,1.8571428571428572,1,0.0,0,4,0,3,5,0,0,1,0,7,6,1
21619,199177,3LqcIJ5JlXmNniowWV3r1JhnVHNprKQu,3VkHkmOtom3jM2wCu94xgzzu1d6Dn7or,1,0,0,0,0,0,1,0,1,0.14285714285714285,1,0.0,0,0,0,0,0,0,0,1,0,0,1,1
21620,199183,YeSAuHvfgQOhQ4rsBpMBzhc3ZqH7Cx4C,3VkHkmOtom3jM2wCu94xgzzu1d6Dn7or,1,0,0,0,0,0,1,0,1,0.14285714285714285,1,0.0,0,0,0,0,0,0,0,1,0,0,1,1
21621,199192,UWFxLgpn2YLwf0avOCRSvUoV4a2OKFgp,3VkHkmOtom3jM2wCu94xgzzu1d6Dn7or,1,0,0,0,0,0,1,0,1,0.14285714285714285,1,0.0,0,0,0,0,0,0,0,1,0,0,1,1
21622,199193,mEOByHnZF9nPOug98IZyXHx5UUcj0wRG,3VkHkmOtom3jM2wCu94xgzzu1d6Dn7or,1,0,0,0,0,0,1,0,1,0.14285714285714285,1,0.0,0,0,0,0,0,0,0,1,0,0,1,1
21623,199232,heT0yS9sPU51G510IWGk7buTH2YGxkfD,3VkHkmOtom3jM2wCu94xgzzu1d6Dn7or,8,7,4,0,2,1,6,0,20,2.857142857142857,1,0.0,0,4,0,2,7,1,0,6,0,6,14,1
21624,199233,quZIfUvhbgq4XxK5fzctoX77uKRPby0l,3VkHkmOtom3jM2wCu94xgzzu1d6Dn7or,1,0,0,0,0,0,1,0,1,0.14285714285714285,1,0.0,0,0,0,0,0,0,0,1,0,0,1,1
21625,199234,idaNfMnrfdnV5wsQBlzuXwo9SkbzRiqc,3VkHkmOtom3jM2wCu94xgzzu1d6Dn7or,3,2,0,0,0,0,1,0,3,0.42857142857142855,1,0.0,0,0,0,0,2,0,0,1,0,0,3,1
21626,199235,D0vNNvzUXljarIsbaxIO0pFzGpvX9UB3,3VkHkmOtom3jM2wCu94xgzzu1d6Dn7or,1,0,0,0,0,0,1,0,1,0.14285714285714285,1,0.0,0,0,0,0,0,0,0,1,0,0,1,1
21627,199237,Wq5GM9gkMECiU2lxgJ5JOL0av6dT4jvb,3VkHkmOtom3jM2wCu94xgzzu1d6Dn7or,8,7,4,0,3,4,13,1,32,4.571428571428571,1,0.0,1,4,0,3,6,4,0,13,1,8,24,1
21628,199238,9frMePaupEGpnF4HdG7VG4qzCQRn3q5K,3VkHkmOtom3jM2wCu94xgzzu1d6Dn7or,5,2,1,0,1,0,2,2,8,1.1428571428571428,1,0.0,0,1,0,1,2,0,0,2,2,2,6,1
21629,199242,OGWTywqD3YlVP7vYo3Y0izf1JAFxQTll,3VkHkmOtom3jM2wCu94xgzzu1d6Dn7or,1,0,0,0,0,0,1,0,1,0.14285714285714285,1,0.0,0,0,0,0,0,0,0,1,0,0,1,1
21630,199244,L7yS593GwnTtaqImYFPvT6H7t25RyL69,3VkHkmOtom3jM2wCu94xgzzu1d6Dn7or,3,0,0,0,0,0,3,0,3,0.42857142857142855,1,0.0,0,0,0,0,0,0,0,3,0,0,3,1
21631,199245,XCaTFMFkUKCIQiZyvdm8DS9Cwg64hJrs,3VkHkmOtom3jM2wCu94xgzzu1d6Dn7or,6,7,3,0,2,0,4,0,16,2.2857142857142856,1,0.0,2,3,0,2,5,0,0,4,0,7,9,1
21632,199250,nw1HkZWZyhKotur4BMCRyESTL2YNYqjX,3VkHkmOtom3jM2wCu94xgzzu1d6Dn7or,10,8,0,2,3,2,9,1,25,3.5714285714285716,1,0.0,3,0,2,3,5,2,0,9,1,8,17,1
21633,199255,PGj1B7s4Yw1PBLMA6crSiWk0Zk66XU5n,3VkHkmOtom3jM2wCu94xgzzu1d6Dn7or,1,0,0,0,0,0,1,0,1,0.14285714285714285,1,0.0,0,0,0,0,0,0,0,1,0,0,1,1
21634,199256,pXzRndBCWQe1quNNkdgxDsGJhh4GeWS1,3VkHkmOtom3jM2wCu94xgzzu1d6Dn7or,4,7,2,0,3,1,1,0,14,2.0,1,0.0,4,2,0,3,3,1,0,1,0,9,5,1
21635,199259,ViHCQzPRd8xjHcyhoqQACLFm37RiqHC0,3VkHkmOtom3jM2wCu94xgzzu1d6Dn7or,5,3,2,0,1,0,2,0,8,1.1428571428571428,1,0.0,0,2,0,1,3,0,0,2,0,3,5,1
21636,199261,R16KAJbfGGFUn1cMcmpx31ZsldcTlSwP,3VkHkmOtom3jM2wCu94xgzzu1d6Dn7or,1,0,0,0,0,0,1,0,1,0.14285714285714285,1,0.0,0,0,0,0,0,0,0,1,0,0,1,1
21637,199264,FALCit9nnWsURM3iEkGUle8YXOvnt8ti,3VkHkmOtom3jM2wCu94xgzzu1d6Dn7or,1,0,0,0,0,0,1,0,1,0.14285714285714285,1,0.0,0,0,0,0,0,0,0,1,0,0,1,1
21638,199266,rctQAs50XkWV8tImkcwqO3JdbiB1Af0a,3VkHkmOtom3jM2wCu94xgzzu1d6Dn7or,5,2,1,0,1,0,2,0,6,0.8571428571428571,1,0.0,0,1,0,1,2,0,0,2,0,2,4,1
21639,199267,GKwHWGmSvV2pJwT2TgYCkTV7PBLeVyfn,3VkHkmOtom3jM2wCu94xgzzu1d6Dn7or,1,0,0,0,0,0,1,0,1,0.14285714285714285,1,0.0,0,0,0,0,0,0,0,1,0,0,1,1
21640,199271,owp26vkEpLoWsYtRcACCQkruNiSrsbFi,3VkHkmOtom3jM2wCu94xgzzu1d6Dn7or,6,3,2,0,2,0,1,0,8,1.1428571428571428,1,0.0,0,2,0,2,3,0,0,1,0,4,4,1
21641,199273,FA6bKtSEtTCRuOxXtEQwLrTLjnmRCxNG,3VkHkmOtom3jM2wCu94xgzzu1d6Dn7or,1,0,0,0,0,0,1,0,1,0.14285714285714285,1,0.0,0,0,0,0,0,0,0,1,0,0,1,1
21642,199283,mwQt0mxNtgenG4gvb4TlKF1a0rGjgcRZ,3VkHkmOtom3jM2wCu94xgzzu1d6Dn7or,12,76,5,13,12,1,1,0,108,15.428571428571429,1,0.0,46,5,12,12,30,1,1,1,0,75,33,1
21643,199285,HPQAOqe01qpRbHX0lYk1eZACdCkgs8jm,3VkHkmOtom3jM2wCu94xgzzu1d6Dn7or,4,3,1,0,1,0,2,0,7,1.0,1,0.0,1,1,0,1,2,0,0,2,0,3,4,1
21644,199286,iZMRgCC40ecdaIMzrqbtGezxBw2R1223,3VkHkmOtom3jM2wCu94xgzzu1d6Dn7or,4,7,1,0,2,0,1,0,11,1.5714285714285714,1,0.0,3,1,0,2,4,0,0,1,0,6,5,1
21645,199288,Owu7m6Y7WCzGIld8o5eihV0mlwoPEFiq,3VkHkmOtom3jM2wCu94xgzzu1d6Dn7or,6,3,1,4,1,1,2,0,12,1.7142857142857142,1,0.0,1,1,3,1,2,1,1,2,0,6,6,1
21646,199291,CmldrbZ19rS0kZKCSttlmLmxZ5JRCugc,3VkHkmOtom3jM2wCu94xgzzu1d6Dn7or,8,6,2,0,2,0,3,0,13,1.8571428571428572,1,0.0,0,2,0,2,6,0,0,3,0,4,9,1
21647,199292,J3vRJtjr6jwORuHeHZ8zCMyiz1FlmuLj,3VkHkmOtom3jM2wCu94xgzzu1d6Dn7or,5,9,3,0,0,2,3,1,18,2.5714285714285716,1,0.0,0,3,0,0,9,2,0,3,1,3,15,1
21648,199294,LVEod3KU7qteTZ7JZ6vJlksrsdaBotfu,3VkHkmOtom3jM2wCu94xgzzu1d6Dn7or,9,9,4,2,5,1,1,0,22,3.142857142857143,1,0.0,4,4,2,5,5,1,0,1,0,15,7,1
21649,199296,Ii6R7Up398zJqqiQxvfbGdpgK5XPOsKH,3VkHkmOtom3jM2wCu94xgzzu1d6Dn7or,1,0,0,0,0,0,1,0,1,0.14285714285714285,1,0.0,0,0,0,0,0,0,0,1,0,0,1,1
21650,199297,ZxX2gWe9Tsn0HHjfeYqd09FZpjQimtqE,3VkHkmOtom3jM2wCu94xgzzu1d6Dn7or,7,10,4,0,2,1,1,0,18,2.5714285714285716,1,0.0,1,4,0,2,9,1,0,1,0,7,11,1
21651,199300,tD46LDb7FV9clFS7zVlaEduBHsQLKqKP,3VkHkmOtom3jM2wCu94xgzzu1d6Dn7or,4,2,1,0,1,0,1,0,5,0.7142857142857143,1,0.0,0,1,0,1,2,0,0,1,0,2,3,1
21652,199302,xf5PP38VyLUgi7xAbHiquAfrLrCJRmZb,3VkHkmOtom3jM2wCu94xgzzu1d6Dn7or,2,0,0,0,0,0,4,0,4,0.5714285714285714,1,0.0,0,0,0,0,0,0,0,4,0,0,4,1
21653,199318,ZvAjwj1tcN1kBkuJeOXNTN5AkioJ63Mn,3VkHkmOtom3jM2wCu94xgzzu1d6Dn7or,9,6,3,0,1,0,12,1,23,3.2857142857142856,1,0.0,0,3,0,1,6,0,0,12,1,4,19,1
21654,199348,NjOJlHONswcoqqrScXTNSE9VQ70COEUu,3VkHkmOtom3jM2wCu94xgzzu1d6Dn7or,3,0,0,0,0,0,3,0,3,0.42857142857142855,1,0.0,0,0,0,0,0,0,0,3,0,0,3,1
21655,199349,ho2pjRkOUvSFvOH0eDUkqXB8JZFLfrCQ,3VkHkmOtom3jM2wCu94xgzzu1d6Dn7or,8,13,5,0,1,0,10,1,30,4.285714285714286,1,0.0,0,5,0,1,13,0,0,10,1,6,24,1
21656,199379,ZbIkYpB9TNj3p0s8LGpk23E3tkrT0Csv,3VkHkmOtom3jM2wCu94xgzzu1d6Dn7or,9,7,3,0,2,2,5,1,20,2.857142857142857,1,0.0,2,3,0,2,5,2,0,5,1,7,13,1
21657,199382,51cj9dTWcB2YrIOxHeQIeROKythB7StW,3VkHkmOtom3jM2wCu94xgzzu1d6Dn7or,1,0,0,0,0,0,1,0,1,0.14285714285714285,1,0.0,0,0,0,0,0,0,0,1,0,0,1,1
21658,199385,ik0xMPFwPk7Hp9Z1nWhE3kXp0C9XX2JI,3VkHkmOtom3jM2wCu94xgzzu1d6Dn7or,1,0,0,0,0,0,1,0,1,0.14285714285714285,1,0.0,0,0,0,0,0,0,0,1,0,0,1,1
21659,199388,XHbLeQS7SuzlwKQYTfIjSivKqKgoNdUd,3VkHkmOtom3jM2wCu94xgzzu1d6Dn7or,5,2,1,0,1,0,4,0,8,1.1428571428571428,1,0.0,0,1,0,1,2,0,0,4,0,2,6,1
21660,199396,VPKFayk1a3k3k8GVZ9cHnlyYOYnFLDbo,3VkHkmOtom3jM2wCu94xgzzu1d6Dn7or,1,0,0,0,0,0,1,0,1,0.14285714285714285,1,0.0,0,0,0,0,0,0,0,1,0,0,1,1
21661,199409,Z0RcAq8Lz8Tge9yALRp5sOKSW4Q9g8kz,3VkHkmOtom3jM2wCu94xgzzu1d6Dn7or,4,4,0,0,2,0,1,0,7,1.0,1,0.0,2,0,0,2,2,0,0,1,0,4,3,1
21662,199417,XqqTtwtZ8esH2ShRf0zzxW6HefKyd53W,3VkHkmOtom3jM2wCu94xgzzu1d6Dn7or,2,0,0,0,0,0,5,0,5,0.7142857142857143,1,0.0,0,0,0,0,0,0,0,5,0,0,5,1
21663,199433,VQwvObbbEsoQKGDAeVk1Jrtbpp6CI9u4,3VkHkmOtom3jM2wCu94xgzzu1d6Dn7or,1,0,0,0,0,0,1,0,1,0.14285714285714285,1,0.0,0,0,0,0,0,0,0,1,0,0,1,1
21664,199438,KovRcxrWLNFYVBPtBqFI3vlUuYrufR0Z,3VkHkmOtom3jM2wCu94xgzzu1d6Dn7or,4,2,1,0,1,0,1,0,5,0.7142857142857143,1,0.0,0,1,0,1,2,0,0,1,0,2,3,1
21665,199455,WK11XP7TUkyoldC0WOFH2UB992OA9hur,3VkHkmOtom3jM2wCu94xgzzu1d6Dn7or,7,5,3,0,2,2,4,1,17,2.4285714285714284,1,0.0,0,3,0,2,5,2,0,4,1,5,12,1
21666,199458,EpFhCzt5fuMlGaCvzJfjDXMXbXrQWtig,3VkHkmOtom3jM2wCu94xgzzu1d6Dn7or,6,4,1,0,2,0,6,0,13,1.8571428571428572,1,0.0,2,1,0,2,2,0,0,6,0,5,8,1
21667,199477,bm8Dbz1QQHqZM2ELT3sFAfBn0ahr4krY,3VkHkmOtom3jM2wCu94xgzzu1d6Dn7or,1,0,0,0,0,0,1,0,1,0.14285714285714285,1,0.0,0,0,0,0,0,0,0,1,0,0,1,1
21668,199500,t9Gvguu2Ai390f3CGcABFs61SKAyGgVA,5Gyp41oLVo7Gg7vF4vpmggWP5MU70QO6,5,1,1,0,1,0,2,0,5,0.7142857142857143,1,0.0,0,1,0,1,1,0,0,2,0,2,3,1
21669,199504,4RiemE5r88jWq9gaL0lVYzjeUhWq3sNP,5Gyp41oLVo7Gg7vF4vpmggWP5MU70QO6,8,2,2,0,2,0,3,0,9,1.2857142857142858,1,0.0,0,2,0,2,2,0,0,3,0,4,5,1
21670,199507,SL64UzpB7mMbNHUSlMD5sHgnAqUAgKbx,5Gyp41oLVo7Gg7vF4vpmggWP5MU70QO6,1,0,0,0,0,0,1,0,1,0.14285714285714285,1,0.0,0,0,0,0,0,0,0,1,0,0,1,1
21671,199513,o4elzktEK9p16tV09uIOTDR5KrpuPNMl,5Gyp41oLVo7Gg7vF4vpmggWP5MU70QO6,1,0,0,0,0,0,1,0,1,0.14285714285714285,1,0.0,0,0,0,0,0,0,0,1,0,0,1,1
21672,199533,TmcXoxCT48jZhYzJE3XlHytbzJ2TbpDY,5Gyp41oLVo7Gg7vF4vpmggWP5MU70QO6,10,13,9,4,0,0,9,0,35,5.0,1,0.0,3,9,2,0,10,0,2,9,0,14,21,1
21673,199545,6NFz33fKVon4f4sOjYdlPKOQ1V49PvQc,5Gyp41oLVo7Gg7vF4vpmggWP5MU70QO6,7,3,2,0,2,0,2,0,9,1.2857142857142858,1,0.0,0,2,0,2,3,0,0,2,0,4,5,1
21674,199556,9qRvgqss6kKFETpsAzp6CdIovsa4fKh5,5Gyp41oLVo7Gg7vF4vpmggWP5MU70QO6,1,0,0,0,0,0,1,0,1,0.14285714285714285,1,0.0,0,0,0,0,0,0,0,1,0,0,1,1
21675,199558,LTNkaPp4W4SY7K4OnD4wGhfve8kd0iqv,5Gyp41oLVo7Gg7vF4vpmggWP5MU70QO6,19,29,14,0,12,1,13,1,70,10.0,1,0.0,8,14,0,12,21,1,0,13,1,34,36,1
21676,199572,t5SLXVnYNYK6h15znYBWovYFldQ8hVQb,5Gyp41oLVo7Gg7vF4vpmggWP5MU70QO6,4,3,1,0,1,0,1,0,6,0.8571428571428571,1,0.0,0,1,0,1,3,0,0,1,0,2,4,1
21677,199588,6Qk8wCR0cykyu4cNDO7szKzXCcdM3dA4,5Gyp41oLVo7Gg7vF4vpmggWP5MU70QO6,5,4,2,0,1,0,3,0,10,1.4285714285714286,1,0.0,0,2,0,1,4,0,0,3,0,3,7,1
21678,199596,kvmtYWzTMPDcSeRrV3gjQPSQDQP6i5nz,5Gyp41oLVo7Gg7vF4vpmggWP5MU70QO6,11,8,6,0,4,0,3,0,21,3.0,1,0.0,1,6,0,4,7,0,0,3,0,11,10,1
21679,199617,WYF6gnZ4xRpre5Df26WMDKWFofwrAPRG,5Gyp41oLVo7Gg7vF4vpmggWP5MU70QO6,1,0,0,0,0,0,1,0,1,0.14285714285714285,1,0.0,0,0,0,0,0,0,0,1,0,0,1,1
21680,199629,uZO5PhedIimEU4NDxccoQOJRW5LJmuW8,5Gyp41oLVo7Gg7vF4vpmggWP5MU70QO6,5,2,1,0,1,0,2,0,6,0.8571428571428571,1,0.0,0,1,0,1,2,0,0,2,0,2,4,1
21681,199660,4p7pAUI1XYsqegAZiBvgomxVZdl3wyjA,5Gyp41oLVo7Gg7vF4vpmggWP5MU70QO6,7,5,1,0,1,0,4,0,11,1.5714285714285714,1,0.0,0,1,0,1,5,0,0,4,0,2,9,1
21682,199663,Ml60GNShoNs2pvt0lXoBEyALZNRb4RrW,5Gyp41oLVo7Gg7vF4vpmggWP5MU70QO6,1,0,0,0,0,0,1,0,1,0.14285714285714285,1,0.0,0,0,0,0,0,0,0,1,0,0,1,1
21683,199691,78awNsb2gv1BNI14errPUoSJXoVpCdJH,5Gyp41oLVo7Gg7vF4vpmggWP5MU70QO6,5,1,1,0,1,0,2,0,5,0.7142857142857143,1,0.0,0,1,0,1,1,0,0,2,0,2,3,1
21684,199702,Xlu2qT74x5h2jgxC7XMmLvWcDpKJdFTo,5Gyp41oLVo7Gg7vF4vpmggWP5MU70QO6,1,0,0,0,0,0,1,0,1,0.14285714285714285,1,0.0,0,0,0,0,0,0,0,1,0,0,1,1
21685,199719,ufk8FCBpI5vYfstuZlggO1Y28eb7bImN,5Gyp41oLVo7Gg7vF4vpmggWP5MU70QO6,7,3,2,0,2,0,2,0,9,1.2857142857142858,1,0.0,0,2,0,2,3,0,0,2,0,4,5,1
21686,199738,CFUx7WKUxHEsW0H7zKcUairzxQEPJJ9t,5Gyp41oLVo7Gg7vF4vpmggWP5MU70QO6,1,0,0,0,0,0,1,0,1,0.14285714285714285,1,0.0,0,0,0,0,0,0,0,1,0,0,1,1
21687,199752,01tPVj9GhpLYaFfBODjF6HKJRtUeoeRD,5Gyp41oLVo7Gg7vF4vpmggWP5MU70QO6,8,7,4,0,5,0,2,0,18,2.5714285714285716,1,0.0,1,4,0,5,6,0,0,2,0,10,8,1
21688,199773,VtALT7PCDyJDsdPo6puj2SULDyuNrsZ2,5Gyp41oLVo7Gg7vF4vpmggWP5MU70QO6,1,0,0,0,0,0,1,0,1,0.14285714285714285,1,0.0,0,0,0,0,0,0,0,1,0,0,1,1
21689,199780,QoZkGYnpYNMmElyQszMTfInxv7WtXYlp,5Gyp41oLVo7Gg7vF4vpmggWP5MU70QO6,6,3,1,0,1,0,2,0,7,1.0,1,0.0,0,1,0,1,3,0,0,2,0,2,5,1
21690,199781,0lNj4wOPU5aLVoC1NJRAY6ITZrtT0j79,5Gyp41oLVo7Gg7vF4vpmggWP5MU70QO6,3,0,0,0,0,0,3,0,3,0.42857142857142855,1,0.0,0,0,0,0,0,0,0,3,0,0,3,1
21691,199788,pwdsR2guw7jGBDVAdaksGODr7uJoy6bJ,5Gyp41oLVo7Gg7vF4vpmggWP5MU70QO6,7,7,2,0,2,3,3,1,18,2.5714285714285716,1,0.0,4,2,0,2,3,3,0,3,1,8,10,1
21692,199789,6n0F9Fc2AE4Y8ya0XBqCqVk34NAxOjFe,5Gyp41oLVo7Gg7vF4vpmggWP5MU70QO6,7,6,1,0,1,0,2,0,10,1.4285714285714286,1,0.0,0,1,0,1,6,0,0,2,0,2,8,1
21693,199795,p4N5T6ghxdMOFXG3asenPRANHZgM9jg5,5Gyp41oLVo7Gg7vF4vpmggWP5MU70QO6,2,0,0,0,0,0,2,0,2,0.2857142857142857,1,0.0,0,0,0,0,0,0,0,2,0,0,2,1
21694,199807,NHGmMinB9WoQusKCx50F4M4nJF124Ms4,5Gyp41oLVo7Gg7vF4vpmggWP5MU70QO6,7,3,3,0,2,0,2,0,10,1.4285714285714286,1,0.0,0,3,0,2,3,0,0,2,0,5,5,1
21695,199812,XE68NKSR0NgsUmxAP8OC135kqBLzzb9D,5Gyp41oLVo7Gg7vF4vpmggWP5MU70QO6,7,4,3,0,3,0,2,0,12,1.7142857142857142,1,0.0,0,3,0,3,4,0,0,2,0,6,6,1
21696,199823,orm5m8NPSgOnZgNd4Q6MIMwBtdbdV8s8,5Gyp41oLVo7Gg7vF4vpmggWP5MU70QO6,1,0,0,0,0,0,1,0,1,0.14285714285714285,1,0.0,0,0,0,0,0,0,0,1,0,0,1,1
21697,199824,YLA48gUHn1Dc2R5xXAOe8bpBqZ5RWVW4,5Gyp41oLVo7Gg7vF4vpmggWP5MU70QO6,2,1,0,0,0,0,1,0,2,0.2857142857142857,1,0.0,0,0,0,0,1,0,0,1,0,0,2,1
21698,199846,SgAa84aajahM2sd2hvCdYRfO014ocPV5,5Gyp41oLVo7Gg7vF4vpmggWP5MU70QO6,6,4,2,0,2,0,2,0,10,1.4285714285714286,1,0.0,0,2,0,2,4,0,0,2,0,4,6,1
21699,199868,uMav2T5lYpadzN2W5cHO5Dgm0OCXqQcd,5Gyp41oLVo7Gg7vF4vpmggWP5MU70QO6,7,1,1,0,1,1,4,1,9,1.2857142857142858,1,0.0,0,1,0,1,1,1,0,4,1,2,7,1
21700,199888,w6wOsUixK1NR3DxQ6OAwLtGPzWjW0RT5,5Gyp41oLVo7Gg7vF4vpmggWP5MU70QO6,5,2,1,0,1,0,2,0,6,0.8571428571428571,1,0.0,0,1,0,1,2,0,0,2,0,2,4,1
21701,199916,7YimjZuYz1aFS1ixr3OljmqX6zHZZJdP,5Gyp41oLVo7Gg7vF4vpmggWP5MU70QO6,10,6,4,0,3,0,3,0,16,2.2857142857142856,1,0.0,0,4,0,3,6,0,0,3,0,7,9,1
21702,199917,9xXPu4XrxUEQD4kiDWTsMvTkTFxGkYzI,5Gyp41oLVo7Gg7vF4vpmggWP5MU70QO6,8,2,1,0,1,7,6,1,18,2.5714285714285716,1,0.0,0,1,0,1,2,7,0,6,1,2,16,1
21703,199942,LGZMukYq1H8wyuvk1p8UwJXL5xcvPKMm,5Gyp41oLVo7Gg7vF4vpmggWP5MU70QO6,1,0,0,0,0,0,1,0,1,0.14285714285714285,1,0.0,0,0,0,0,0,0,0,1,0,0,1,1
21704,199944,GkJR3TNQR5bDjgiA7ByPHRWSb3vgtDKO,5Gyp41oLVo7Gg7vF4vpmggWP5MU70QO6,1,0,0,0,0,0,1,0,1,0.14285714285714285,1,0.0,0,0,0,0,0,0,0,1,0,0,1,1
21705,199951,i5M9T8TAb1vyeNb72SH3VcSoeMeKzcTe,5Gyp41oLVo7Gg7vF4vpmggWP5MU70QO6,7,9,3,0,0,1,6,1,20,2.857142857142857,1,0.0,4,3,0,0,5,1,0,6,1,7,13,1
21706,199974,zbVrmGy9kpOt2q8xeIclHo9H8afE2cMh,5Gyp41oLVo7Gg7vF4vpmggWP5MU70QO6,22,45,16,27,7,4,11,0,110,15.714285714285714,2,0.0,14,16,15,7,31,4,12,11,0,52,58,1
21707,199984,cIZHxVEY0KMW5jNfevk6tD1l0twzy792,5Gyp41oLVo7Gg7vF4vpmggWP5MU70QO6,1,0,0,0,0,0,1,0,1,0.14285714285714285,1,0.0,0,0,0,0,0,0,0,1,0,0,1,1
21708,199987,aosFpeLMqBiLLcyUKYcbUuWGCjQbFGiD,5Gyp41oLVo7Gg7vF4vpmggWP5MU70QO6,6,3,2,0,2,0,1,0,8,1.1428571428571428,1,0.0,0,2,0,2,3,0,0,1,0,4,4,1
21709,199988,YWXRs30LfGeBUUdtbLCSDxfSvS9eXAoE,5Gyp41oLVo7Gg7vF4vpmggWP5MU70QO6,1,0,0,0,0,0,1,0,1,0.14285714285714285,1,0.0,0,0,0,0,0,0,0,1,0,0,1,1
21710,200010,bpb79QcMnqEiK7pdyDV2FpbHALODyYBK,5Gyp41oLVo7Gg7vF4vpmggWP5MU70QO6,5,2,1,0,1,0,2,0,6,0.8571428571428571,1,0.0,0,1,0,1,2,0,0,2,0,2,4,1
21711,200019,qkrz4xqDsOIKpgHmkwAPZKnMJeJkGh5u,5Gyp41oLVo7Gg7vF4vpmggWP5MU70QO6,1,0,0,0,0,0,2,0,2,0.2857142857142857,1,0.0,0,0,0,0,0,0,0,2,0,0,2,1
21712,200061,m9hBCbCGqWnTHkomkJRkDEF5Rs7431xS,5Gyp41oLVo7Gg7vF4vpmggWP5MU70QO6,6,3,2,0,1,0,2,0,8,1.1428571428571428,1,0.0,0,2,0,1,3,0,0,2,0,3,5,1
21713,200082,vbTgITzq6jZRj0oUV5gFotgOlwSXnjML,5Gyp41oLVo7Gg7vF4vpmggWP5MU70QO6,1,0,0,0,0,0,1,0,1,0.14285714285714285,1,0.0,0,0,0,0,0,0,0,1,0,0,1,1
21714,200110,eRNQUxT50UHdqbKWWfRjAd8yBYQxBOWR,5Gyp41oLVo7Gg7vF4vpmggWP5MU70QO6,1,0,0,0,0,0,1,0,1,0.14285714285714285,1,0.0,0,0,0,0,0,0,0,1,0,0,1,1
21715,200113,5gIOl4VVMqHfJKBD7MIuXVUZFf8N8fHp,5Gyp41oLVo7Gg7vF4vpmggWP5MU70QO6,7,8,3,0,1,0,4,0,16,2.2857142857142856,1,0.0,0,3,0,1,8,0,0,4,0,4,12,1
21716,200129,D9sfxkCYKuMIPdl3RlcDud6AoT19593x,5Gyp41oLVo7Gg7vF4vpmggWP5MU70QO6,8,2,2,0,1,0,4,0,9,1.2857142857142858,1,0.0,0,2,0,1,2,0,0,4,0,3,6,1
21717,200135,t4CFQYAfhtGm7YidMVtJaWh5UIAFkdUL,5Gyp41oLVo7Gg7vF4vpmggWP5MU70QO6,6,4,2,0,2,0,1,0,9,1.2857142857142858,1,0.0,0,2,0,2,4,0,0,1,0,4,5,1
21718,200149,tMkwIpO7ZKCsu2OGBTSLe31c2jqzYinJ,5Gyp41oLVo7Gg7vF4vpmggWP5MU70QO6,1,0,0,0,0,0,1,0,1,0.14285714285714285,1,0.0,0,0,0,0,0,0,0,1,0,0,1,1
21719,200157,CykijlBvrfCnopTb9AaXgis5gSkvGwzC,fbPkOYLVPtPgIt0MxizjfFJov3JbHyAi,7,1,1,0,1,1,7,1,12,1.7142857142857142,1,0.0,0,1,0,1,1,1,0,7,1,2,10,1
21720,200159,t9QYODxZ0thus7iFGBwx6fkPWEXFSW7S,fbPkOYLVPtPgIt0MxizjfFJov3JbHyAi,7,5,2,0,2,0,2,0,11,1.5714285714285714,1,0.0,0,2,0,2,5,0,0,2,0,4,7,1
21721,200162,dzURuE7IlCH80LFSI2yTw30zsMgWkp29,fbPkOYLVPtPgIt0MxizjfFJov3JbHyAi,6,2,0,0,0,0,8,0,10,1.4285714285714286,1,0.0,0,0,0,0,2,0,0,8,0,0,10,1
21722,200163,bNjBiMsX33gdPcYQXoqSFOjUJgLcFbHE,fbPkOYLVPtPgIt0MxizjfFJov3JbHyAi,9,4,2,0,2,0,10,1,19,2.7142857142857144,2,0.0,1,2,0,2,3,0,0,10,1,5,14,1
21723,200165,SwWiPD24oHM8AndfY3AAAjHvKl9MggTk,fbPkOYLVPtPgIt0MxizjfFJov3JbHyAi,2,0,0,0,0,0,2,0,2,0.2857142857142857,1,0.0,0,0,0,0,0,0,0,2,0,0,2,1
21724,200166,Gv890Y8tWqdQL73srFfKZXsLtPUpIe2C,fbPkOYLVPtPgIt0MxizjfFJov3JbHyAi,8,3,1,0,1,0,5,0,10,1.4285714285714286,1,0.0,0,1,0,1,3,0,0,5,0,2,8,1
21725,200169,LiyIa3B6QhI7xyW0IVAj2eKqmqAeHza7,fbPkOYLVPtPgIt0MxizjfFJov3JbHyAi,10,3,2,0,2,0,8,1,16,2.2857142857142856,1,0.0,0,2,0,2,3,0,0,8,1,4,12,1
21726,200171,b42x9fEviD2KrosQFgO4BDKrSzPFH9d9,fbPkOYLVPtPgIt0MxizjfFJov3JbHyAi,29,29,13,20,15,3,9,1,90,12.857142857142858,1,0.0,14,13,15,15,15,3,5,9,1,57,33,1
21727,200173,uQYu0hHVc5jntgCyzuDA9TaZrd7lJp3t,fbPkOYLVPtPgIt0MxizjfFJov3JbHyAi,1,0,0,0,0,0,1,0,1,0.14285714285714285,1,0.0,0,0,0,0,0,0,0,1,0,0,1,1
21728,200175,D8LAFp7BvA55dAaLzF6AX6GIJkGB1HJQ,fbPkOYLVPtPgIt0MxizjfFJov3JbHyAi,1,0,0,0,0,0,1,0,1,0.14285714285714285,1,0.0,0,0,0,0,0,0,0,1,0,0,1,1
21729,200177,I463Z3P8xxMeNa2OIR0bwDIF8VjojVtU,fbPkOYLVPtPgIt0MxizjfFJov3JbHyAi,2,0,0,0,0,0,2,0,2,0.2857142857142857,1,0.0,0,0,0,0,0,0,0,2,0,0,2,1
21730,200178,kdbKnHrfUetCNFpkVPUjd1YS7pY3Y1xS,fbPkOYLVPtPgIt0MxizjfFJov3JbHyAi,7,4,3,0,3,0,2,0,12,1.7142857142857142,1,0.0,0,3,0,3,4,0,0,2,0,6,6,1
21731,200179,nONpoqUpw0PURu6ZnXs9gQtQMOWOg8ue,fbPkOYLVPtPgIt0MxizjfFJov3JbHyAi,7,3,2,0,2,0,2,0,9,1.2857142857142858,1,0.0,0,2,0,2,3,0,0,2,0,4,5,1
21732,200180,N1H6FHZ3dNzEs8oMwW9QQdJ6c3gTcjMQ,fbPkOYLVPtPgIt0MxizjfFJov3JbHyAi,1,0,0,0,0,0,1,0,1,0.14285714285714285,1,0.0,0,0,0,0,0,0,0,1,0,0,1,1
21733,200181,5AVv64HGNDPJGZDwAOSJQtcGvZuBdS1I,fbPkOYLVPtPgIt0MxizjfFJov3JbHyAi,1,0,0,0,0,0,1,0,1,0.14285714285714285,1,0.0,0,0,0,0,0,0,0,1,0,0,1,1
21734,200182,4TP43TWBhiZRfTTi5JD8xgUB7xZqttTW,fbPkOYLVPtPgIt0MxizjfFJov3JbHyAi,1,0,0,0,0,0,1,0,1,0.14285714285714285,1,0.0,0,0,0,0,0,0,0,1,0,0,1,1
21735,200184,Ue5cow6t4KF20pqucY8OJ5GlmvhnVJez,fbPkOYLVPtPgIt0MxizjfFJov3JbHyAi,1,0,0,0,0,0,1,0,1,0.14285714285714285,1,0.0,0,0,0,0,0,0,0,1,0,0,1,1
21736,200185,8WJKmjHpUZK5OxShg0TbHn2M6D7oIMfb,fbPkOYLVPtPgIt0MxizjfFJov3JbHyAi,1,0,0,0,0,0,1,0,1,0.14285714285714285,1,0.0,0,0,0,0,0,0,0,1,0,0,1,1
21737,200186,Gihs79xPOl1Mw60wZHHvlRDExkwTizeS,fbPkOYLVPtPgIt0MxizjfFJov3JbHyAi,1,0,0,0,0,0,1,0,1,0.14285714285714285,1,0.0,0,0,0,0,0,0,0,1,0,0,1,1
21738,200188,vBH0dHu4NmOj62y1ASafcuCscurKeDfE,fbPkOYLVPtPgIt0MxizjfFJov3JbHyAi,8,3,2,0,2,5,4,0,16,2.2857142857142856,1,0.0,0,2,0,2,3,5,0,4,0,4,12,1
21739,200189,IjfLv0ELgzYvkhMJtEEnngYxIv6R7Pp9,fbPkOYLVPtPgIt0MxizjfFJov3JbHyAi,6,2,1,0,1,0,3,0,7,1.0,1,0.0,0,1,0,1,2,0,0,3,0,2,5,1
21740,200191,eVBudonm9LHQus01HY2DPSy51yaVu1Ef,fbPkOYLVPtPgIt0MxizjfFJov3JbHyAi,7,4,2,0,2,0,4,0,12,1.7142857142857142,1,0.0,1,2,0,2,3,0,0,4,0,5,7,1
21741,200192,rgJ72otfhXY7oBVDdxB02Qogw63Ky7IK,fbPkOYLVPtPgIt0MxizjfFJov3JbHyAi,9,8,3,0,1,5,12,1,30,4.285714285714286,1,0.0,2,3,0,1,6,5,0,12,1,6,24,1
21742,200193,YaP2AuckukEZITP3IVvIt6Z8ci6RHew7,fbPkOYLVPtPgIt0MxizjfFJov3JbHyAi,6,7,3,0,2,0,4,0,16,2.2857142857142856,1,0.0,0,3,0,2,7,0,0,4,0,5,11,1
21743,200194,SC4osWBdol7GBH5uXCMUl6bcwZHPFUg5,fbPkOYLVPtPgIt0MxizjfFJov3JbHyAi,4,3,2,0,0,0,1,0,6,0.8571428571428571,1,0.0,0,2,0,0,3,0,0,1,0,2,4,1
21744,200198,71hGYkw2Gq02SC91zhSD2oXzHC2DaTWy,fbPkOYLVPtPgIt0MxizjfFJov3JbHyAi,6,2,1,0,1,2,3,1,10,1.4285714285714286,1,0.0,0,1,0,1,2,2,0,3,1,2,8,0
21745,200199,yNC8T7gdWO96Y2q3tzTQeJUMY0F51xnO,fbPkOYLVPtPgIt0MxizjfFJov3JbHyAi,4,2,0,0,0,0,2,0,4,0.5714285714285714,1,0.0,0,0,0,0,2,0,0,2,0,0,4,1
21746,200201,UjuEtRsjqzZUPoZRstdypYoVba7fqqz2,fbPkOYLVPtPgIt0MxizjfFJov3JbHyAi,1,0,0,0,0,0,1,0,1,0.14285714285714285,1,0.0,0,0,0,0,0,0,0,1,0,0,1,1
21747,200202,vG8XNGwZrUgilL0e4qiRKZWEfkDfD3oN,fbPkOYLVPtPgIt0MxizjfFJov3JbHyAi,1,0,0,0,0,0,1,0,1,0.14285714285714285,1,0.0,0,0,0,0,0,0,0,1,0,0,1,1
21748,200211,3cnrMFTNVdxeAntVpE4in3WqfgjUqSxl,5Gyp41oLVo7Gg7vF4vpmggWP5MU70QO6,3,0,0,0,0,0,3,0,3,0.42857142857142855,1,0.0,0,0,0,0,0,0,0,3,0,0,3,1
21749,200252,Ktw4zhSf7Wd8RujcJrq9R6zJYYz9aaXP,5Gyp41oLVo7Gg7vF4vpmggWP5MU70QO6,16,11,8,2,6,0,4,0,31,4.428571428571429,1,0.0,1,8,1,6,10,0,1,4,0,16,15,1
21750,200255,gEejwPFTytiAGdASkrbtLMHig0Q6esg4,5Gyp41oLVo7Gg7vF4vpmggWP5MU70QO6,12,10,6,0,2,6,9,2,35,5.0,1,0.0,0,6,0,2,10,6,0,9,2,8,27,1
21751,200274,ELJa8A81VOfiqD4Bg0Px962sx2WBYvb0,5Gyp41oLVo7Gg7vF4vpmggWP5MU70QO6,6,3,2,0,2,0,1,0,8,1.1428571428571428,1,0.0,0,2,0,2,3,0,0,1,0,4,4,1
21752,200277,tv7cYpYVSeOM2iwwUtv8upqaYBqILo2o,5Gyp41oLVo7Gg7vF4vpmggWP5MU70QO6,1,0,0,0,0,0,1,0,1,0.14285714285714285,1,0.0,0,0,0,0,0,0,0,1,0,0,1,1
21753,200279,o9uh3QfQeuOpEmCNnuDCmUwYmEbvIcHf,5Gyp41oLVo7Gg7vF4vpmggWP5MU70QO6,3,2,1,0,0,0,1,0,4,0.5714285714285714,1,0.0,0,1,0,0,2,0,0,1,0,1,3,1
21754,200290,nH6yoa7qb6QqJNzKj6PiD6a9jZn3yJfX,5Gyp41oLVo7Gg7vF4vpmggWP5MU70QO6,1,0,0,0,0,0,1,0,1,0.14285714285714285,1,0.0,0,0,0,0,0,0,0,1,0,0,1,1
21755,200332,aQ75JNLXDKBHcA4utiTYh0zB4CWJRKKL,5Gyp41oLVo7Gg7vF4vpmggWP5MU70QO6,1,0,0,0,0,0,1,0,1,0.14285714285714285,1,0.0,0,0,0,0,0,0,0,1,0,0,1,1
21756,200347,ppqE75IH6R0l4QuLkT31ZlDESsrHarIu,5Gyp41oLVo7Gg7vF4vpmggWP5MU70QO6,4,2,1,0,1,0,1,0,5,0.7142857142857143,1,0.0,0,1,0,1,2,0,0,1,0,2,3,1
21757,200349,xwzSNCBVwP1nh6QJnkmgm26Rb34x32EB,5Gyp41oLVo7Gg7vF4vpmggWP5MU70QO6,6,5,2,0,1,0,3,0,11,1.5714285714285714,1,0.0,0,2,0,1,5,0,0,3,0,3,8,1
21758,200426,4Dp7LLp7t1gYbdcN4ZxWGwhRKXqsnWGQ,5Gyp41oLVo7Gg7vF4vpmggWP5MU70QO6,5,3,1,0,1,0,2,0,7,1.0,1,0.0,0,1,0,1,3,0,0,2,0,2,5,0
21759,200433,CXDFvBGg10x2RDdl5BC09Fv76dN9FJm7,5Gyp41oLVo7Gg7vF4vpmggWP5MU70QO6,1,0,0,0,0,0,1,0,1,0.14285714285714285,1,0.0,0,0,0,0,0,0,0,1,0,0,1,1
21760,200490,emcnHMjxxgkRj9af1NUqizehRFaPmw2q,5Gyp41oLVo7Gg7vF4vpmggWP5MU70QO6,9,10,4,0,3,0,1,0,18,2.5714285714285716,1,0.0,5,4,0,3,5,0,0,1,0,12,6,1
21761,200507,3C0RNflDAI8FmTdsE1mhjUkpDZ4xUri7,5Gyp41oLVo7Gg7vF4vpmggWP5MU70QO6,17,23,12,8,1,5,11,1,61,8.714285714285714,1,0.0,6,12,6,1,17,5,2,11,1,25,36,1
21762,200513,mhBMXLJxEXMw4vJPtGhHPAjT49QRStZx,5Gyp41oLVo7Gg7vF4vpmggWP5MU70QO6,6,4,3,0,3,0,3,0,13,1.8571428571428572,1,0.0,0,3,0,3,4,0,0,3,0,6,7,1
21763,200514,aZAiWgHdC9uFqUTIQMHTVIPp3kq4rrxn,5Gyp41oLVo7Gg7vF4vpmggWP5MU70QO6,6,3,1,0,2,0,1,0,7,1.0,1,0.0,0,1,0,2,3,0,0,1,0,3,4,1
21764,200520,nha5ZKtXNHbSXPEQ5LMNVji34sdiUf9F,5Gyp41oLVo7Gg7vF4vpmggWP5MU70QO6,4,2,1,0,0,0,2,0,5,0.7142857142857143,1,0.0,0,1,0,0,2,0,0,2,0,1,4,1
21765,200525,Nh5O2pUrRzVk0GcyP9XE6lIyNm5IcpCa,5Gyp41oLVo7Gg7vF4vpmggWP5MU70QO6,2,0,0,0,0,0,2,0,2,0.2857142857142857,1,0.0,0,0,0,0,0,0,0,2,0,0,2,1
21766,200533,7ho1Tg0rPKs5S3R4MH5byApVMAoQWEXh,5Gyp41oLVo7Gg7vF4vpmggWP5MU70QO6,9,3,2,0,2,9,4,1,21,3.0,1,0.0,0,2,0,2,3,9,0,4,1,4,17,1
21767,200546,YLLq9nLffaF9TP2dJ2OpMZwhKv5cSnoB,5Gyp41oLVo7Gg7vF4vpmggWP5MU70QO6,6,2,1,0,1,0,4,0,8,1.1428571428571428,1,0.0,0,1,0,1,2,0,0,4,0,2,6,1
21768,200551,CEvYRnACKahkbonOgacXt7pALaNftiKp,5Gyp41oLVo7Gg7vF4vpmggWP5MU70QO6,4,3,0,0,0,0,2,0,5,0.7142857142857143,1,0.0,0,0,0,0,3,0,0,2,0,0,5,1
21769,200561,9YSGzfO7GL2BruPlhTICs0MSCuTmoYij,5Gyp41oLVo7Gg7vF4vpmggWP5MU70QO6,4,3,2,0,2,0,4,0,11,1.5714285714285714,1,0.0,0,2,0,2,3,0,0,4,0,4,7,1
21770,200590,wyv1iE5T6UZ7MmVeuRNtYmCx3UEBYVPH,5Gyp41oLVo7Gg7vF4vpmggWP5MU70QO6,2,0,0,0,0,0,2,0,2,0.2857142857142857,1,0.0,0,0,0,0,0,0,0,2,0,0,2,0
21771,200621,5dyDRUBTyWyNpCqBUThrUzCpraBPJLoP,5Gyp41oLVo7Gg7vF4vpmggWP5MU70QO6,4,2,0,0,0,0,2,0,4,0.5714285714285714,1,0.0,0,0,0,0,2,0,0,2,0,0,4,1
21772,200626,O80qwjwmPYyt37x5I83BP0nxbxfQGTvO,5Gyp41oLVo7Gg7vF4vpmggWP5MU70QO6,3,3,0,0,0,0,1,0,4,0.5714285714285714,1,0.0,0,0,0,0,3,0,0,1,0,0,4,1
21773,200627,gZSP3OXpEbKxvyj0ivbYZOkQ4gs23L7f,5Gyp41oLVo7Gg7vF4vpmggWP5MU70QO6,1,0,0,0,0,0,1,0,1,0.14285714285714285,1,0.0,0,0,0,0,0,0,0,1,0,0,1,1
21774,200635,zwzhI7xKJqbLX8Cn6JAtyj5eUdJBzFCm,5Gyp41oLVo7Gg7vF4vpmggWP5MU70QO6,1,0,0,0,0,0,1,0,1,0.14285714285714285,1,0.0,0,0,0,0,0,0,0,1,0,0,1,1
21775,200636,BZvEZ94lfgGngpJK1X6949ki1lFxWwFY,5Gyp41oLVo7Gg7vF4vpmggWP5MU70QO6,7,4,2,0,1,0,4,0,11,1.5714285714285714,1,0.0,0,2,0,1,4,0,0,4,0,3,8,1
21776,200640,QsfvQSR2bWYlIufdhtoipEOSHfKt9MYV,5Gyp41oLVo7Gg7vF4vpmggWP5MU70QO6,1,0,0,0,0,0,1,0,1,0.14285714285714285,1,0.0,0,0,0,0,0,0,0,1,0,0,1,1
21777,200649,iq2s6XEtLNjMdyc7MReRkWOgf3bnXnky,5Gyp41oLVo7Gg7vF4vpmggWP5MU70QO6,1,0,0,0,0,0,1,0,1,0.14285714285714285,1,0.0,0,0,0,0,0,0,0,1,0,0,1,1
21778,200674,Zshvnpi3gKHls4tWYAhrHjPdqOWE9eAq,5Gyp41oLVo7Gg7vF4vpmggWP5MU70QO6,12,7,7,0,4,1,5,0,24,3.4285714285714284,1,0.0,0,7,0,4,7,1,0,5,0,11,13,1
21779,200687,iysEaAaeQU9ULnAIVWQxyonskhHfsgrB,5Gyp41oLVo7Gg7vF4vpmggWP5MU70QO6,9,6,3,0,2,9,3,6,29,4.142857142857143,1,0.0,0,3,0,2,6,9,0,3,6,5,24,0
21780,200689,4sdPJJwZWD6zWSEwfAoFOiiNSkkT5tdF,5Gyp41oLVo7Gg7vF4vpmggWP5MU70QO6,4,2,1,0,1,0,1,0,5,0.7142857142857143,1,0.0,0,1,0,1,2,0,0,1,0,2,3,1
21781,200694,PdNNEF1w9pZVUItoPwkFXStEApUp40kt,5Gyp41oLVo7Gg7vF4vpmggWP5MU70QO6,7,10,5,0,1,0,1,0,17,2.4285714285714284,1,0.0,0,5,0,1,10,0,0,1,0,6,11,1
21782,200710,Kv2QTX8Bp145P6ep9Nk8x89BSyjg1SDC,5Gyp41oLVo7Gg7vF4vpmggWP5MU70QO6,1,0,0,0,0,0,1,0,1,0.14285714285714285,1,0.0,0,0,0,0,0,0,0,1,0,0,1,1
21783,200717,BfyHpsFcf5SdJtDDEokJ2DaJODuDhRyN,5Gyp41oLVo7Gg7vF4vpmggWP5MU70QO6,7,3,2,0,2,0,2,0,9,1.2857142857142858,1,0.0,0,2,0,2,3,0,0,2,0,4,5,1
21784,200758,Y9sDwuA6ol1NiBJ2RVhVaMLZPZz4ipOb,5Gyp41oLVo7Gg7vF4vpmggWP5MU70QO6,6,3,2,0,2,1,1,0,9,1.2857142857142858,1,0.0,0,2,0,2,3,1,0,1,0,4,5,1
21785,200775,nyIo9LsksiFrMb7XxTgx773xWcDAIiQQ,5Gyp41oLVo7Gg7vF4vpmggWP5MU70QO6,9,5,2,0,4,0,2,0,13,1.8571428571428572,1,0.0,0,2,0,4,5,0,0,2,0,6,7,1
21786,200780,VuTuBAJiGcrrbSkaUxqWxt1xbqL8a3NS,7GRhBDsirIGkRZBtSMEzNTyDr2JQm4xx,3,4,0,0,0,0,1,0,5,0.7142857142857143,1,0.0,2,0,0,0,2,0,0,1,0,2,3,0
21787,200781,Kw92JTRLSCQpjDbdykKr2UkGn8EcDD30,7GRhBDsirIGkRZBtSMEzNTyDr2JQm4xx,8,7,1,0,0,0,1,0,9,1.2857142857142858,1,0.0,0,1,0,0,7,0,0,1,0,1,8,1
21788,200786,QgtS4pwTfCcnUet7wEFIaa3mI34JWeze,7GRhBDsirIGkRZBtSMEzNTyDr2JQm4xx,1,0,0,0,0,0,1,0,1,0.14285714285714285,1,0.0,0,0,0,0,0,0,0,1,0,0,1,1
21789,200791,m32hK7SShSI6GU8twpfqx1DswVGk0Vpq,7GRhBDsirIGkRZBtSMEzNTyDr2JQm4xx,1,0,0,0,0,0,1,0,1,0.14285714285714285,1,0.0,0,0,0,0,0,0,0,1,0,0,1,0
21790,200795,S91PWx0V5j7dyuZWAavjt1byiE0NQ5Ta,7GRhBDsirIGkRZBtSMEzNTyDr2JQm4xx,2,0,0,0,0,0,2,0,2,0.2857142857142857,1,0.0,0,0,0,0,0,0,0,2,0,0,2,1
21791,200826,ejQ6gPILOqZQAfakVpcpBhnipDtNVKba,7GRhBDsirIGkRZBtSMEzNTyDr2JQm4xx,2,0,0,0,0,0,2,0,2,0.2857142857142857,1,0.0,0,0,0,0,0,0,0,2,0,0,2,1
