,enrollment_id,username,course_id,no_of_objects12,bno_access12,bno_pageclose12,bno_problem12,bno_video12,bno_discussion12,bno_navigate12,bno_wiki12,bno_total12,bno_avg12,no_of_active_days12,time_consumption12,browser_access12,browser_pageclose12,browser_problem12,browser_video12,server_access12,server_discussion12,server_problem12,server_navigate12,server_wiki12,bno_browser12,bno_server12,label
0,3,1qXC7Fjbwp66GPQc6pHLfEuO8WKozxG4,7GRhBDsirIGkRZBtSMEzNTyDr2JQm4xx,46,36,14,55,5,0,9,0,119,17.0,5,-1759501.0,16,14,55,5,20,0,0,9,0,90,29,0
1,5,p1Mp7WkVfzUijX0peVQKSHbgd5pXyl4c,7GRhBDsirIGkRZBtSMEzNTyDr2JQm4xx,68,143,61,112,47,20,20,0,403,57.57142857142857,6,0.0,71,61,90,47,72,20,22,20,0,269,134,0
2,7,I1KwJ6EdCZnEPLfC8Q7yWpIkLOHn7h02,7GRhBDsirIGkRZBtSMEzNTyDr2JQm4xx,39,108,34,48,31,18,13,0,252,36.0,4,0.0,63,34,42,31,45,18,6,13,0,170,82,1
3,22,dPBUV0FPFjTZZK079rPAeq0WXhW4DUkF,7GRhBDsirIGkRZBtSMEzNTyDr2JQm4xx,49,66,38,64,36,0,1,0,205,29.285714285714285,2,0.0,26,38,56,36,40,0,8,1,0,156,49,1
4,45,5Tz6BGN7p1lkmdoopAY1Z5ufYTrUsi9E,7GRhBDsirIGkRZBtSMEzNTyDr2JQm4xx,34,57,21,35,18,8,10,0,149,21.285714285714285,4,0.0,30,21,33,18,27,8,2,10,0,102,47,0
5,49,2oTvbzieHn2y5oozeOgSnruqE6N0BtR5,7GRhBDsirIGkRZBtSMEzNTyDr2JQm4xx,75,207,101,58,30,877,94,0,1367,195.28571428571428,14,0.0,46,101,29,30,161,877,29,94,0,206,1161,0
6,50,LnNj9zDI8D38ixGOYTIjTH2iF5m36v9S,7GRhBDsirIGkRZBtSMEzNTyDr2JQm4xx,20,40,18,28,0,0,6,0,92,13.142857142857142,5,0.0,15,18,26,0,25,0,2,6,0,59,33,1
7,58,l9KseRU4xYtwOzoILYmGcicF0iiXQqxl,7GRhBDsirIGkRZBtSMEzNTyDr2JQm4xx,63,158,58,103,16,40,37,2,414,59.142857142857146,10,0.0,50,58,95,16,108,40,8,37,2,219,195,0
8,96,KXi2lu4GlKmrO1lJTLg3t4l701rvNXNZ,7GRhBDsirIGkRZBtSMEzNTyDr2JQm4xx,31,60,25,34,22,1,5,0,147,21.0,5,0.0,28,25,29,22,32,1,5,5,0,104,43,1
9,134,Q5TmTVdy8nnH2vTL73s67ZseaCMO3k91,7GRhBDsirIGkRZBtSMEzNTyDr2JQm4xx,28,20,9,24,8,0,10,0,71,10.142857142857142,2,0.0,9,9,24,8,11,0,0,10,0,50,21,1
10,141,CB4JYroUtmiKv572P6g4vrvJCi6Pzr9h,7GRhBDsirIGkRZBtSMEzNTyDr2JQm4xx,33,54,21,48,12,2,13,0,150,21.428571428571427,1,0.0,32,21,42,12,22,2,6,13,0,107,43,1
11,192,hCxbmPBmjgsEuMY36HnZH4x3BwWFnCUn,7GRhBDsirIGkRZBtSMEzNTyDr2JQm4xx,41,67,23,24,23,0,23,0,160,22.857142857142858,7,0.0,44,23,21,23,23,0,3,23,0,111,49,0
12,199,OEQBiRbbo3yEBzKSHcNX9ESBTSUy08ze,7GRhBDsirIGkRZBtSMEzNTyDr2JQm4xx,68,137,42,121,28,129,29,4,490,70.0,3,0.0,90,42,102,28,47,129,19,29,4,262,228,0
13,219,088SASUPOVYUGhoEly8vlrkGvRBJoNwp,7GRhBDsirIGkRZBtSMEzNTyDr2JQm4xx,61,513,167,159,17,250,103,13,1222,174.57142857142858,11,0.0,252,167,138,17,261,250,21,103,13,574,648,0
14,248,BTWrAWjg41jpM1wlPsS1mmQbZAFIvx2o,7GRhBDsirIGkRZBtSMEzNTyDr2JQm4xx,2,0,0,0,0,0,4,0,4,0.5714285714285714,1,0.0,0,0,0,0,0,0,0,4,0,0,4,1
15,255,O6WL6sxvoPCZnvTLyTPxdXbnpOz3wcJ4,7GRhBDsirIGkRZBtSMEzNTyDr2JQm4xx,21,46,17,10,8,0,7,0,88,12.571428571428571,2,0.0,8,17,9,8,38,0,1,7,0,42,46,0
16,284,L9qMLlGWAeAI6zWAZIyJtn0wISNa3dxg,7GRhBDsirIGkRZBtSMEzNTyDr2JQm4xx,97,116,37,6,55,240,53,0,507,72.42857142857143,13,0.0,45,37,5,55,71,240,1,53,0,142,365,0
17,320,2zijdtZPcsrYvyvmgApN5PnCXULBsIBX,7GRhBDsirIGkRZBtSMEzNTyDr2JQm4xx,1,0,0,0,0,0,1,0,1,0.14285714285714285,1,0.0,0,0,0,0,0,0,0,1,0,0,1,1
18,373,XUkSDdNHWcdano4aRGWpLSTI2IF8D1IH,7GRhBDsirIGkRZBtSMEzNTyDr2JQm4xx,48,139,55,68,3,50,32,3,350,50.0,6,0.0,37,55,59,3,102,50,9,32,3,154,196,0
19,433,PEDnL2c66c2DN92O9BTVM9D6p19gGbT6,7GRhBDsirIGkRZBtSMEzNTyDr2JQm4xx,33,64,27,30,15,5,14,1,156,22.285714285714285,8,0.0,33,27,27,15,31,5,3,14,1,102,54,0
20,493,xNkIHhqS8GZXIqyoWwwS3ZeYfSmUsNJo,7GRhBDsirIGkRZBtSMEzNTyDr2JQm4xx,35,70,19,54,19,0,3,0,165,23.571428571428573,4,0.0,26,19,44,19,44,0,10,3,0,108,57,0
21,555,tiLrccMjeOBHHBLooSoPfc0IKYtAsyXK,7GRhBDsirIGkRZBtSMEzNTyDr2JQm4xx,2,0,0,0,0,0,3,0,3,0.42857142857142855,2,0.0,0,0,0,0,0,0,0,3,0,0,3,1
22,630,BbZEGv8zMCuD8c0LXrenf9W1lGSlVd04,7GRhBDsirIGkRZBtSMEzNTyDr2JQm4xx,10,39,5,0,0,0,9,0,53,7.571428571428571,1,0.0,0,5,0,0,39,0,0,9,0,5,48,1
23,777,bLIF0ETNcg7fjkutu8YBWJptM3zxtu2Z,7GRhBDsirIGkRZBtSMEzNTyDr2JQm4xx,38,68,33,49,30,7,26,0,213,30.428571428571427,7,0.0,31,33,44,30,37,7,5,26,0,138,75,0
24,780,anqtRE1JbVfWjk9aVYgpNXBcTCoFe9WO,7GRhBDsirIGkRZBtSMEzNTyDr2JQm4xx,43,97,39,82,20,5,23,1,267,38.142857142857146,7,0.0,31,39,71,20,66,5,11,23,1,161,106,1
25,796,6gLqDWyaI2NtlxSWPzL6286Swi1mEUeL,7GRhBDsirIGkRZBtSMEzNTyDr2JQm4xx,2,0,0,0,0,0,2,0,2,0.2857142857142857,1,0.0,0,0,0,0,0,0,0,2,0,0,2,1
26,833,TOPojNiMH24da1PoGtHTHtr3v40hc02S,7GRhBDsirIGkRZBtSMEzNTyDr2JQm4xx,10,7,0,19,0,0,6,0,32,4.571428571428571,1,0.0,3,0,16,0,4,0,3,6,0,19,13,1
27,845,bY5BU72AucM53Ivc1aSf6rn9i7DKfcQZ,7GRhBDsirIGkRZBtSMEzNTyDr2JQm4xx,1,0,0,0,0,0,1,0,1,0.14285714285714285,1,0.0,0,0,0,0,0,0,0,1,0,0,1,1
28,884,c3CVim2QZeSVk1wACFUHDmf9ZjEIwtuP,7GRhBDsirIGkRZBtSMEzNTyDr2JQm4xx,32,46,17,54,9,0,7,0,133,19.0,1,0.0,29,17,47,9,17,0,7,7,0,102,31,0
29,936,Z4uUjFPFbGNbmcg4E2opeBQCoO0nQyZe,7GRhBDsirIGkRZBtSMEzNTyDr2JQm4xx,19,68,31,0,6,5,17,0,127,18.142857142857142,7,0.0,21,31,0,6,47,5,0,17,0,58,69,1
30,937,uQjl8NGtIQkRfoe9edBiMgtYYmdkzVXR,7GRhBDsirIGkRZBtSMEzNTyDr2JQm4xx,34,81,26,62,11,6,9,0,195,27.857142857142858,7,0.0,32,26,53,11,49,6,9,9,0,122,73,0
31,956,SIuVkNKTY2J1cPfs6wUSNXAjh8XyxgwI,7GRhBDsirIGkRZBtSMEzNTyDr2JQm4xx,1,0,0,0,0,0,1,0,1,0.14285714285714285,1,0.0,0,0,0,0,0,0,0,1,0,0,1,1
32,966,uVv1ioGVvP0A5CGQgSQhVTbH75lJRG4O,7GRhBDsirIGkRZBtSMEzNTyDr2JQm4xx,8,11,1,0,2,2,8,1,25,3.5714285714285716,4,0.0,2,1,0,2,9,2,0,8,1,5,20,1
33,991,HvUs11HJgqndKBOynrg9yliToxZs6PoS,7GRhBDsirIGkRZBtSMEzNTyDr2JQm4xx,20,26,12,0,10,0,3,0,51,7.285714285714286,1,0.0,6,12,0,10,20,0,0,3,0,28,23,0
34,999,sGrMSEzmd0nQ8tazrPYbRhLOuMlMN34w,7GRhBDsirIGkRZBtSMEzNTyDr2JQm4xx,5,4,2,0,0,0,5,0,11,1.5714285714285714,1,0.0,1,2,0,0,3,0,0,5,0,3,8,1
35,1030,uDdfaOyae5qLVYC8BQlj5xLhiV3is9wS,7GRhBDsirIGkRZBtSMEzNTyDr2JQm4xx,65,215,109,7,74,251,34,1,691,98.71428571428571,10,0.0,89,109,5,74,126,251,2,34,1,277,414,0
36,1052,db3m19q36pgCYtTdKoL3kV4Ubidysmpw,7GRhBDsirIGkRZBtSMEzNTyDr2JQm4xx,1,0,0,0,0,0,1,0,1,0.14285714285714285,1,0.0,0,0,0,0,0,0,0,1,0,0,1,1
37,1090,9ct6Fth9rRpjZJrFIHs9xOnW9W5hBHw6,7GRhBDsirIGkRZBtSMEzNTyDr2JQm4xx,28,53,20,75,4,3,7,0,162,23.142857142857142,2,0.0,27,20,66,4,26,3,9,7,0,117,45,1
38,1134,Q3zkClKdiEJIkoKspwBuSNOwYXuxalAX,7GRhBDsirIGkRZBtSMEzNTyDr2JQm4xx,33,48,16,16,11,6,16,0,113,16.142857142857142,4,0.0,22,16,16,11,26,6,0,16,0,65,48,1
39,1147,gCxbOVEJ7FeSqOiwKbB6HzPEL3I9x6ca,7GRhBDsirIGkRZBtSMEzNTyDr2JQm4xx,69,113,48,127,22,48,18,1,377,53.857142857142854,5,0.0,53,48,103,22,60,48,24,18,1,226,151,0
40,1206,ymJGsoe3Y9XwSfD9UhxMG8gRl87RdPUe,7GRhBDsirIGkRZBtSMEzNTyDr2JQm4xx,35,65,26,40,16,1,7,0,155,22.142857142857142,5,0.0,28,26,34,16,37,1,6,7,0,104,51,1
41,1223,o7MfiO1X5Ui1AYG08PXFhTcXSShcuNhK,7GRhBDsirIGkRZBtSMEzNTyDr2JQm4xx,27,19,14,32,12,0,6,0,83,11.857142857142858,3,0.0,3,14,28,12,16,0,4,6,0,57,26,0
42,1227,RuOAeaUVW53IP9AqfP0jxaXbNkmd7lKN,7GRhBDsirIGkRZBtSMEzNTyDr2JQm4xx,22,25,1,24,3,0,7,0,60,8.571428571428571,3,0.0,16,1,22,3,9,0,2,7,0,42,18,0
43,1252,mZIaM3Lmux7GERtSm258BKPOSUYFlwyy,7GRhBDsirIGkRZBtSMEzNTyDr2JQm4xx,51,130,16,91,19,24,18,0,298,42.57142857142857,9,0.0,58,16,78,19,72,24,13,18,0,171,127,0
44,1255,jB9rh6QoUWlta1KDWb4mdWzYIut8deHu,7GRhBDsirIGkRZBtSMEzNTyDr2JQm4xx,6,3,1,0,1,0,2,0,7,1.0,1,0.0,0,1,0,1,3,0,0,2,0,2,5,1
45,1260,beV03mdN2n7VoZwDqBMCKGETqOChXWUx,7GRhBDsirIGkRZBtSMEzNTyDr2JQm4xx,50,267,85,73,37,64,29,1,556,79.42857142857143,5,0.0,86,85,68,37,181,64,5,29,1,276,280,0
46,1269,RSJQ68OFisJaYDiRNDqeLSdLFyonAIP1,7GRhBDsirIGkRZBtSMEzNTyDr2JQm4xx,4,3,1,0,0,0,2,0,6,0.8571428571428571,1,0.0,0,1,0,0,3,0,0,2,0,1,5,1
47,1289,zlsPhArkUaQ0CCdgZTO1797WJjiciHBk,7GRhBDsirIGkRZBtSMEzNTyDr2JQm4xx,55,147,51,75,41,50,19,0,383,54.714285714285715,8,0.0,52,51,65,41,95,50,10,19,0,209,174,0
48,1315,kNG9cn23NW62SZcqQSqyW9wMtO0GajdN,7GRhBDsirIGkRZBtSMEzNTyDr2JQm4xx,20,24,8,36,11,2,1,0,82,11.714285714285714,2,0.0,14,8,33,11,10,2,3,1,0,66,16,0
49,1345,eyksoE4AUoKYBpwx782vtNzuK4dwKRY9,7GRhBDsirIGkRZBtSMEzNTyDr2JQm4xx,10,15,4,0,2,1,6,1,29,4.142857142857143,1,0.0,9,4,0,2,6,1,0,6,1,15,14,1
50,1381,8W0dKFntzVy5gs8nAvO6lyUGOY4SLHwO,7GRhBDsirIGkRZBtSMEzNTyDr2JQm4xx,4,2,0,0,0,0,2,0,4,0.5714285714285714,1,0.0,0,0,0,0,2,0,0,2,0,0,4,1
51,1429,YbP52dGau1RB8H6599HdGbUKOVHWxxw1,7GRhBDsirIGkRZBtSMEzNTyDr2JQm4xx,39,77,31,31,21,13,5,0,178,25.428571428571427,2,0.0,33,31,31,21,44,13,0,5,0,116,62,0
52,1450,q88579uTDrz7tsNTbZoL3mbWXAP4ClqK,7GRhBDsirIGkRZBtSMEzNTyDr2JQm4xx,33,112,43,42,21,26,27,8,279,39.857142857142854,7,0.0,56,43,36,21,56,26,6,27,8,156,123,0
53,1472,Qc7qhDYnMQ0se5itn8lyxOFjZ1zzyfhE,7GRhBDsirIGkRZBtSMEzNTyDr2JQm4xx,33,80,23,62,15,9,19,1,209,29.857142857142858,3,0.0,27,23,51,15,53,9,11,19,1,116,93,0
54,1491,lCyf3TRKW0i3K1mBgKz23OONMdCWqNsI,7GRhBDsirIGkRZBtSMEzNTyDr2JQm4xx,37,133,8,92,10,36,53,8,340,48.57142857142857,6,0.0,79,8,78,10,54,36,14,53,8,175,165,0
55,1502,1rAHmNrxrqnzHEQFMlydmQ968LsZW0oG,7GRhBDsirIGkRZBtSMEzNTyDr2JQm4xx,28,60,19,29,7,4,4,0,123,17.571428571428573,2,0.0,37,19,27,7,23,4,2,4,0,90,33,0
56,1529,DT600yQDJaU6nnkoEQdVx5gZnWz5FfNY,7GRhBDsirIGkRZBtSMEzNTyDr2JQm4xx,47,211,3,112,12,10,32,1,381,54.42857142857143,4,0.0,75,3,97,12,136,10,15,32,1,187,194,0
57,1541,Ydg0lHV8igjCQUoXTu9LI2axWzXgXWvH,7GRhBDsirIGkRZBtSMEzNTyDr2JQm4xx,5,2,1,0,0,0,3,0,6,0.8571428571428571,1,0.0,0,1,0,0,2,0,0,3,0,1,5,1
58,1576,d9rEzZ3v1PmiMyudpVDJ4ystf1RU9dCH,7GRhBDsirIGkRZBtSMEzNTyDr2JQm4xx,16,30,6,8,2,1,20,2,69,9.857142857142858,5,0.0,8,6,7,2,22,1,1,20,2,23,46,1
59,1593,rLQXRKLwDTvBugA3fH8VUxASy31pAAsE,7GRhBDsirIGkRZBtSMEzNTyDr2JQm4xx,65,242,78,152,37,76,16,5,606,86.57142857142857,9,0.0,145,78,126,37,97,76,26,16,5,386,220,1
60,1594,argwyep7vMTLtgODtMQ0gxLXJNoq9csR,7GRhBDsirIGkRZBtSMEzNTyDr2JQm4xx,35,92,17,59,9,0,14,0,191,27.285714285714285,7,0.0,37,17,50,9,55,0,9,14,0,113,78,1
61,1616,Bi4hHmeTLwTbUCScu9tC6ZZN7frLUhVP,7GRhBDsirIGkRZBtSMEzNTyDr2JQm4xx,7,4,2,0,2,0,4,0,12,1.7142857142857142,2,0.0,0,2,0,2,4,0,0,4,0,4,8,0
62,1630,BN8wlDCfm46NLUt2P4jjdpJvase6IJc9,7GRhBDsirIGkRZBtSMEzNTyDr2JQm4xx,46,146,40,56,18,20,21,0,301,43.0,7,0.0,69,40,53,18,77,20,3,21,0,180,121,1
63,1651,iR2FNNwwVPECfrAWwxLxHcw8art5BqJj,7GRhBDsirIGkRZBtSMEzNTyDr2JQm4xx,28,22,9,38,11,0,2,0,82,11.714285714285714,1,0.0,10,9,36,11,12,0,2,2,0,66,16,0
64,1685,rAPaguNT0tnoFK76JileqLEbVcmAD9at,7GRhBDsirIGkRZBtSMEzNTyDr2JQm4xx,1,0,0,0,0,0,1,0,1,0.14285714285714285,1,0.0,0,0,0,0,0,0,0,1,0,0,1,1
65,1697,LdIFMEp4Gma3xMuOQ2mpp1BJ3jFvB9c2,7GRhBDsirIGkRZBtSMEzNTyDr2JQm4xx,34,62,18,50,12,3,5,0,150,21.428571428571427,4,0.0,27,18,40,12,35,3,10,5,0,97,53,0
66,1708,PVIjAE0m0OeJAYOHc5gIjzktRijtXdS4,7GRhBDsirIGkRZBtSMEzNTyDr2JQm4xx,20,21,8,29,10,0,2,0,70,10.0,1,0.0,11,8,24,10,10,0,5,2,0,53,17,1
67,1724,yXGb0Kuxvr3gyMDMjDKW3Llv1qZCYjSd,7GRhBDsirIGkRZBtSMEzNTyDr2JQm4xx,1,0,0,0,0,0,1,0,1,0.14285714285714285,1,0.0,0,0,0,0,0,0,0,1,0,0,1,1
68,1728,B6EpScn9lSCPa3RR6ElGV7QvO5jse6Q3,7GRhBDsirIGkRZBtSMEzNTyDr2JQm4xx,1,0,0,0,0,0,1,0,1,0.14285714285714285,1,0.0,0,0,0,0,0,0,0,1,0,0,1,1
69,1755,qLrXKwo0jPQz47eKqKRnMiywjqEMxYd1,7GRhBDsirIGkRZBtSMEzNTyDr2JQm4xx,2,0,0,0,0,0,2,0,2,0.2857142857142857,1,0.0,0,0,0,0,0,0,0,2,0,0,2,0
70,1756,wc32nzp9MMjroUa1gifXyCPIfYwLXy9J,7GRhBDsirIGkRZBtSMEzNTyDr2JQm4xx,36,58,25,39,18,10,28,2,180,25.714285714285715,8,0.0,22,25,34,18,36,10,5,28,2,99,81,1
71,1788,ZsmdkNcVTPviDi6RDTzc0nnIspFki9Ld,7GRhBDsirIGkRZBtSMEzNTyDr2JQm4xx,17,20,5,14,4,0,5,0,48,6.857142857142857,3,0.0,12,5,13,4,8,0,1,5,0,34,14,0
72,1801,wy2vY5aiYwg0C5zglGAXrG2vaWLSbGC9,fbPkOYLVPtPgIt0MxizjfFJov3JbHyAi,7,3,2,0,2,0,2,0,9,1.2857142857142858,1,0.0,0,2,0,2,3,0,0,2,0,4,5,1
73,1803,MlHPKmdi90dDdvX24jYoFlYEp8xS4RGn,fbPkOYLVPtPgIt0MxizjfFJov3JbHyAi,4,0,0,0,0,0,4,0,4,0.5714285714285714,1,0.0,0,0,0,0,0,0,0,4,0,0,4,1
74,1804,qRMvc4T53dkwmyfrgm76E5HygPUZo2vr,fbPkOYLVPtPgIt0MxizjfFJov3JbHyAi,44,134,57,31,27,141,47,5,442,63.142857142857146,12,0.0,40,57,26,27,94,141,5,47,5,150,292,0
75,1807,tvXgoUvFgvHT9SyDah6Ue0bK2mvIbZdy,fbPkOYLVPtPgIt0MxizjfFJov3JbHyAi,44,135,85,53,38,88,26,0,425,60.714285714285715,6,0.0,37,85,40,38,98,88,13,26,0,200,225,0
76,1811,466PN9Ek5iJamUCk5pZUwazAoeVcTj9e,fbPkOYLVPtPgIt0MxizjfFJov3JbHyAi,7,11,6,0,4,0,4,0,25,3.5714285714285716,2,0.0,2,6,0,4,9,0,0,4,0,12,13,1
77,1815,EZXku3HiM8iDGMBMsO2RMLHj3AEpHhBq,fbPkOYLVPtPgIt0MxizjfFJov3JbHyAi,9,20,3,0,3,0,2,0,28,4.0,2,0.0,3,3,0,3,17,0,0,2,0,9,19,0
78,1817,bXMaalfz1ZqHKnJWw6VXCAoemSeuw45Q,fbPkOYLVPtPgIt0MxizjfFJov3JbHyAi,2,0,0,0,0,0,2,0,2,0.2857142857142857,1,0.0,0,0,0,0,0,0,0,2,0,0,2,0
79,1818,pIBqJuNsqTHvkyItKwWF6wLVRjCC6EZu,fbPkOYLVPtPgIt0MxizjfFJov3JbHyAi,10,34,17,0,9,5,23,0,88,12.571428571428571,2,0.0,7,17,0,9,27,5,0,23,0,33,55,1
80,1821,dovSPYooNHmzLLH97Ddy4FG7Uxhw5XJl,fbPkOYLVPtPgIt0MxizjfFJov3JbHyAi,5,4,2,0,1,0,1,0,8,1.1428571428571428,1,0.0,0,2,0,1,4,0,0,1,0,3,5,1
81,1822,v1Dw0XqubI6wLrO1l5puralkQ2Aofi2j,fbPkOYLVPtPgIt0MxizjfFJov3JbHyAi,44,117,48,50,33,174,48,13,483,69.0,10,0.0,45,48,37,33,72,174,13,48,13,163,320,0
82,1826,5BwluL2iwK0HgKhM8FgXFAWZQHsXkB8V,fbPkOYLVPtPgIt0MxizjfFJov3JbHyAi,41,70,15,27,17,39,25,3,196,28.0,6,0.0,23,15,26,17,47,39,1,25,3,81,115,0
83,1827,tfcv93vJo2GySad9H44VOkIGpLaZ6vJT,fbPkOYLVPtPgIt0MxizjfFJov3JbHyAi,17,31,14,15,8,7,9,0,84,12.0,2,0.0,12,14,11,8,19,7,4,9,0,45,39,0
84,1830,dtAiYXul2PNEQLlJvo6qGgg8Rx9ORbY3,fbPkOYLVPtPgIt0MxizjfFJov3JbHyAi,7,2,1,0,1,1,7,1,13,1.8571428571428572,1,0.0,0,1,0,1,2,1,0,7,1,2,11,1
85,1832,IIfD9UPHJEG512IBEQGZwkZbr6HRQ12X,fbPkOYLVPtPgIt0MxizjfFJov3JbHyAi,9,2,2,0,2,6,12,0,24,3.4285714285714284,2,0.0,0,2,0,2,2,6,0,12,0,4,20,1
86,1844,FSrU0Uh74oBwrZKS577R74m2Rk2Lst8A,fbPkOYLVPtPgIt0MxizjfFJov3JbHyAi,12,11,9,0,7,0,9,0,36,5.142857142857143,1,0.0,0,9,0,7,11,0,0,9,0,16,20,1
87,1845,oaoj9be4jW2Hot8wYgYrzLRvB0RU4KYy,fbPkOYLVPtPgIt0MxizjfFJov3JbHyAi,5,14,5,0,1,0,5,0,25,3.5714285714285716,5,0.0,0,5,0,1,14,0,0,5,0,6,19,0
88,1852,srnnzUkIJr2Uisav8LfnV4SnpbNw9CLp,fbPkOYLVPtPgIt0MxizjfFJov3JbHyAi,8,10,5,0,3,1,4,0,23,3.2857142857142856,1,0.0,3,5,0,3,7,1,0,4,0,11,12,1
89,1856,ScOtpH9Zf7UmvFfXBxi9XtXFmhGO9CpS,fbPkOYLVPtPgIt0MxizjfFJov3JbHyAi,45,95,46,37,30,115,52,4,379,54.142857142857146,11,0.0,22,46,34,30,73,115,3,52,4,132,247,0
90,1859,renLevNnf6MkkqeGAoBcuGxp4Cuebb9X,fbPkOYLVPtPgIt0MxizjfFJov3JbHyAi,20,65,36,13,15,66,70,12,277,39.57142857142857,6,0.0,6,36,10,15,59,66,3,70,12,67,210,0
91,1861,wHW6M4zJx3WQvnkWxa8NK7bA13uSffjE,fbPkOYLVPtPgIt0MxizjfFJov3JbHyAi,45,204,116,47,56,77,33,5,538,76.85714285714286,9,0.0,55,116,37,56,149,77,10,33,5,264,274,0
92,1862,w85QVmINOIyrXRzegh8uuBeGTw3K4uG8,fbPkOYLVPtPgIt0MxizjfFJov3JbHyAi,27,61,27,8,18,33,14,2,163,23.285714285714285,5,0.0,24,27,8,18,37,33,0,14,2,77,86,0
93,1863,2HxHgYZUxjcTVAkRZXALZPpAKp12AIkW,fbPkOYLVPtPgIt0MxizjfFJov3JbHyAi,29,66,23,13,22,35,28,4,191,27.285714285714285,6,0.0,16,23,9,22,50,35,4,28,4,70,121,1
94,1875,NmOI6yuIgn0ShW8ps51AeOISH4CX20PY,fbPkOYLVPtPgIt0MxizjfFJov3JbHyAi,2,0,0,0,0,0,3,0,3,0.42857142857142855,1,0.0,0,0,0,0,0,0,0,3,0,0,3,1
95,1878,0UPVw8ecIiIpfGXqAIUJXTbKxiiOJqXC,fbPkOYLVPtPgIt0MxizjfFJov3JbHyAi,12,17,8,4,6,4,3,0,42,6.0,2,0.0,2,8,3,6,15,4,1,3,0,19,23,1
96,1880,DSWjfYVjIvEWi0MzNQ04NT3mnhbcHkJI,fbPkOYLVPtPgIt0MxizjfFJov3JbHyAi,18,9,8,0,7,0,2,0,26,3.7142857142857144,1,0.0,0,8,0,7,9,0,0,2,0,15,11,0
97,1888,lbgTV2YMskSv2TX4EXpaazpMVWfsftEV,fbPkOYLVPtPgIt0MxizjfFJov3JbHyAi,9,14,9,0,4,0,8,0,35,5.0,1,0.0,0,9,0,4,14,0,0,8,0,13,22,0
98,1891,s6iksgptFmyh2vfiarKdJkiKnp6RLi3f,fbPkOYLVPtPgIt0MxizjfFJov3JbHyAi,22,50,17,0,8,138,20,1,234,33.42857142857143,7,0.0,3,17,0,8,47,138,0,20,1,28,206,0
99,1894,Vc4rFh1HQZiO6qLgOrealEeiZYYPbmOY,fbPkOYLVPtPgIt0MxizjfFJov3JbHyAi,43,83,38,54,17,44,14,0,250,35.714285714285715,8,0.0,13,38,45,17,70,44,9,14,0,113,137,0
100,1899,CXDFvBGg10x2RDdl5BC09Fv76dN9FJm7,fbPkOYLVPtPgIt0MxizjfFJov3JbHyAi,44,83,24,50,19,19,13,0,208,29.714285714285715,4,0.0,28,24,48,19,55,19,2,13,0,119,89,0
101,1903,TkQQvYTOoXkFjbJKIO2v3OeQa3imG4fA,fbPkOYLVPtPgIt0MxizjfFJov3JbHyAi,46,100,39,23,35,96,35,2,330,47.142857142857146,7,0.0,52,39,20,35,48,96,3,35,2,146,184,0
102,1910,CtgLRd04Cnda49EWlN19NulXjkuBNDXd,fbPkOYLVPtPgIt0MxizjfFJov3JbHyAi,42,50,19,32,18,31,4,0,154,22.0,3,0.0,21,19,28,18,29,31,4,4,0,86,68,0
103,1922,ddq0oVEKEWGKWnbGS4cfbzVZj0yFimxw,fbPkOYLVPtPgIt0MxizjfFJov3JbHyAi,28,23,19,10,15,0,5,0,72,10.285714285714286,2,0.0,2,19,7,15,21,0,3,5,0,43,29,0
104,1923,UgNr6maIjrTPAjpLAvEGxJ6P02hrpr0j,fbPkOYLVPtPgIt0MxizjfFJov3JbHyAi,44,126,48,45,32,17,28,1,297,42.42857142857143,11,0.0,29,48,42,32,97,17,3,28,1,151,146,0
105,1926,5ZyvCd3AP7a8azCiLN5JfLAP53iZpAyD,fbPkOYLVPtPgIt0MxizjfFJov3JbHyAi,1,0,0,0,0,0,1,0,1,0.14285714285714285,1,0.0,0,0,0,0,0,0,0,1,0,0,1,1
106,1929,v9mjKPlqj9n2M1xFKzFtpQVo3yi6HxGV,fbPkOYLVPtPgIt0MxizjfFJov3JbHyAi,5,3,2,0,1,0,2,0,8,1.1428571428571428,1,0.0,0,2,0,1,3,0,0,2,0,3,5,1
107,1931,gUUf0vmNg6gEFqYol91VXQX0Cn6Mly3v,fbPkOYLVPtPgIt0MxizjfFJov3JbHyAi,46,155,104,26,62,60,6,0,413,59.0,11,0.0,32,104,23,62,123,60,3,6,0,221,192,0
108,1933,mNLR1O6gqXF6Zqi4uIf130gITni9gN1A,fbPkOYLVPtPgIt0MxizjfFJov3JbHyAi,44,95,55,17,28,18,24,2,239,34.142857142857146,10,0.0,15,55,17,28,80,18,0,24,2,115,124,0
109,1936,YLLq9nLffaF9TP2dJ2OpMZwhKv5cSnoB,fbPkOYLVPtPgIt0MxizjfFJov3JbHyAi,13,16,7,2,6,2,1,0,34,4.857142857142857,1,0.0,5,7,2,6,11,2,0,1,0,20,14,1
110,1940,a7VEIs7rhyootOFOxpi9zJBtM0N2POJ5,fbPkOYLVPtPgIt0MxizjfFJov3JbHyAi,4,2,1,0,1,0,1,0,5,0.7142857142857143,1,0.0,0,1,0,1,2,0,0,1,0,2,3,1
111,1943,S1MqxZA8wNnn30FSBfJ8uK4pTicj2Ko9,fbPkOYLVPtPgIt0MxizjfFJov3JbHyAi,33,69,46,20,24,20,28,5,212,30.285714285714285,8,0.0,7,46,17,24,62,20,3,28,5,94,118,0
112,1945,KM3IAf1A23ZYRH7BjTN3a6rzUKD52rd8,fbPkOYLVPtPgIt0MxizjfFJov3JbHyAi,9,12,7,0,3,0,16,0,38,5.428571428571429,3,0.0,0,7,0,3,12,0,0,16,0,10,28,1
113,1951,dq3iqibSI5OSwCbWRZv7tfgbiuLwOgjh,fbPkOYLVPtPgIt0MxizjfFJov3JbHyAi,19,37,21,0,14,6,8,3,89,12.714285714285714,3,0.0,2,21,0,14,35,6,0,8,3,37,52,0
114,3982,Dw289XdbVPARtBCp3XyIbEXKo6sChudi,fbPkOYLVPtPgIt0MxizjfFJov3JbHyAi,12,15,5,5,5,8,7,1,46,6.571428571428571,1,0.0,5,5,4,5,10,8,1,7,1,19,27,1
115,3986,lri3Bm6mGdJ1wEpJO4c8fcTdLtxpvXa6,fbPkOYLVPtPgIt0MxizjfFJov3JbHyAi,32,103,31,27,17,51,32,1,262,37.42857142857143,5,0.0,32,31,25,17,71,51,2,32,1,105,157,0
116,3987,RvRsXzYULX8CJPXHa5mzL8AcNhscf6wx,fbPkOYLVPtPgIt0MxizjfFJov3JbHyAi,5,7,3,0,2,8,5,0,25,3.5714285714285716,2,0.0,0,3,0,2,7,8,0,5,0,5,20,1
117,3988,n6g50uYKXPDZP0tI3HvDI3sQlgkEYQ9t,fbPkOYLVPtPgIt0MxizjfFJov3JbHyAi,2,0,0,0,0,0,5,0,5,0.7142857142857143,1,0.0,0,0,0,0,0,0,0,5,0,0,5,1
118,3989,WQvAdilRxsksKqQWzKEILUwddYnT927z,fbPkOYLVPtPgIt0MxizjfFJov3JbHyAi,8,19,7,0,5,4,11,0,46,6.571428571428571,3,0.0,0,7,0,5,19,4,0,11,0,12,34,1
119,3990,IjNUKB7dvHimeVQdJPcMV9GHh8X3ACi4,fbPkOYLVPtPgIt0MxizjfFJov3JbHyAi,9,3,2,0,2,0,7,1,15,2.142857142857143,1,0.0,0,2,0,2,3,0,0,7,1,4,11,1
120,3991,affppoxqvCZhtMd3A1khAMJ6PTtvZhf9,fbPkOYLVPtPgIt0MxizjfFJov3JbHyAi,22,57,17,13,26,85,5,0,203,29.0,4,0.0,33,17,11,26,24,85,2,5,0,87,116,1
121,3992,uzWBIpHNnLP0Ck2jFJb3dlQmKW50Edgg,fbPkOYLVPtPgIt0MxizjfFJov3JbHyAi,9,7,4,0,3,0,12,0,26,3.7142857142857144,1,0.0,0,4,0,3,7,0,0,12,0,7,19,1
122,3993,LBiRwhykvYlkPokFukwKE3pfXRl4e4Nw,fbPkOYLVPtPgIt0MxizjfFJov3JbHyAi,10,50,30,0,12,1,17,1,111,15.857142857142858,6,0.0,3,30,0,12,47,1,0,17,1,45,66,1
123,3994,CAJTHZgER1cUEaMoS6UrUkuHNZZbsU9M,fbPkOYLVPtPgIt0MxizjfFJov3JbHyAi,43,63,27,45,23,23,10,2,193,27.571428571428573,4,0.0,27,27,35,23,36,23,10,10,2,112,81,1
124,3995,TYu8VgV6TkJO1pWVABdfXnpa6VWQUK0O,fbPkOYLVPtPgIt0MxizjfFJov3JbHyAi,11,15,6,3,9,1,7,1,42,6.0,3,0.0,8,6,3,9,7,1,0,7,1,26,16,1
125,3999,4IkxYjTflPhoHxhEdrFyf3T4ZXNMTaKd,fbPkOYLVPtPgIt0MxizjfFJov3JbHyAi,16,48,24,4,11,17,11,0,115,16.428571428571427,5,0.0,12,24,4,11,36,17,0,11,0,51,64,0
126,4000,A8rz0vMThAU17OyS7TiHPCSZ088mScoQ,fbPkOYLVPtPgIt0MxizjfFJov3JbHyAi,7,6,2,0,3,0,3,0,14,2.0,1,0.0,3,2,0,3,3,0,0,3,0,8,6,1
127,4001,NKzNFHK6LaJqjMec69ZX5HfBigF4yyJV,fbPkOYLVPtPgIt0MxizjfFJov3JbHyAi,21,45,4,14,2,48,14,1,128,18.285714285714285,4,0.0,9,4,12,2,36,48,2,14,1,27,101,1
128,4002,MoOt0pLc6LPrRtSRaIbD7yJ5rRpkSxQh,fbPkOYLVPtPgIt0MxizjfFJov3JbHyAi,9,9,3,0,5,10,7,2,36,5.142857142857143,1,0.0,5,3,0,5,4,10,0,7,2,13,23,1
129,4003,DgaifwdXOeOWB23pZZjNIgSww1uVv3vI,fbPkOYLVPtPgIt0MxizjfFJov3JbHyAi,6,5,2,0,1,0,9,0,17,2.4285714285714284,1,0.0,0,2,0,1,5,0,0,9,0,3,14,1
130,4005,HAPPxnLUjIhcauBZnnWBFk3JE6gETTxa,fbPkOYLVPtPgIt0MxizjfFJov3JbHyAi,8,5,3,0,2,0,4,0,14,2.0,2,0.0,0,3,0,2,5,0,0,4,0,5,9,0
131,4006,McVFksjsd7gqjfpNdRYswxB6Ly7zMDUI,fbPkOYLVPtPgIt0MxizjfFJov3JbHyAi,11,26,11,22,7,24,23,1,114,16.285714285714285,2,0.0,9,11,13,7,17,24,9,23,1,40,74,1
132,4010,tCXUYAVw455MAJWBfBlKD9PaArTnum6K,fbPkOYLVPtPgIt0MxizjfFJov3JbHyAi,5,2,1,0,1,0,3,0,7,1.0,1,0.0,0,1,0,1,2,0,0,3,0,2,5,1
133,4013,mDG9Rxl75Wy9jJLHldZXeLQnqCWbJnNh,fbPkOYLVPtPgIt0MxizjfFJov3JbHyAi,9,10,6,0,4,0,7,0,27,3.857142857142857,1,0.0,0,6,0,4,10,0,0,7,0,10,17,1
134,4014,cDTJe7mzABgZuuhVrbXbLDlWeF860dTW,fbPkOYLVPtPgIt0MxizjfFJov3JbHyAi,5,4,2,0,1,2,2,0,11,1.5714285714285714,1,0.0,0,2,0,1,4,2,0,2,0,3,8,1
135,4015,Sqb9rCT9CzMY8ZiGPrmmTQHW8dIqJZBT,fbPkOYLVPtPgIt0MxizjfFJov3JbHyAi,1,0,0,0,0,0,1,0,1,0.14285714285714285,1,0.0,0,0,0,0,0,0,0,1,0,0,1,1
136,4016,0OQWZBG0W4kepi8nreWMZMMypwSc3KLe,fbPkOYLVPtPgIt0MxizjfFJov3JbHyAi,30,95,59,16,24,60,23,2,279,39.857142857142854,9,0.0,22,59,14,24,73,60,2,23,2,119,160,0
137,4017,R0BF3k8rl0hN1Xjq59ZjmegVjqcKX9oA,fbPkOYLVPtPgIt0MxizjfFJov3JbHyAi,12,25,8,9,3,6,4,0,55,7.857142857142857,4,0.0,6,8,7,3,19,6,2,4,0,24,31,1
138,4018,PueCTOZid1NIenGrGQNvEExDupERGR94,fbPkOYLVPtPgIt0MxizjfFJov3JbHyAi,6,13,1,0,0,21,4,0,39,5.571428571428571,2,0.0,1,1,0,0,12,21,0,4,0,2,37,1
139,4019,dFrBZuKOTxv7Ek84BAuACScgZVHLiPRz,fbPkOYLVPtPgIt0MxizjfFJov3JbHyAi,27,89,50,15,30,40,17,1,242,34.57142857142857,6,0.0,18,50,12,30,71,40,3,17,1,110,132,0
140,4021,2txyeJeVHewFPGKztIs7LVNsRtu62SIj,fbPkOYLVPtPgIt0MxizjfFJov3JbHyAi,12,24,16,10,12,0,9,0,71,10.142857142857142,5,0.0,3,16,9,12,21,0,1,9,0,40,31,0
141,4022,CNy8nHnus6ReY45d9zqNv8rRJDfMythS,fbPkOYLVPtPgIt0MxizjfFJov3JbHyAi,10,11,5,0,5,0,5,0,26,3.7142857142857144,2,0.0,2,5,0,5,9,0,0,5,0,12,14,1
142,4024,UInMBEH8f1h2vxXVslRsWyLOTv8ggYq3,fbPkOYLVPtPgIt0MxizjfFJov3JbHyAi,48,184,89,20,53,255,31,4,636,90.85714285714286,9,0.0,47,89,15,53,137,255,5,31,4,204,432,0
143,4025,0XUEmNa1QlvbJ6h0wBm0Vh8YELQW58i8,fbPkOYLVPtPgIt0MxizjfFJov3JbHyAi,2,0,0,0,0,0,3,0,3,0.42857142857142855,1,0.0,0,0,0,0,0,0,0,3,0,0,3,1
144,4026,OMzzJICpXQ12vN2QhxiLmWbQhc59H2Je,fbPkOYLVPtPgIt0MxizjfFJov3JbHyAi,19,30,13,0,10,118,13,0,184,26.285714285714285,3,0.0,8,13,0,10,22,118,0,13,0,31,153,1
145,4028,BJaK31XM4DCMgldXltRIhwlSVt79ImvN,fbPkOYLVPtPgIt0MxizjfFJov3JbHyAi,1,0,0,0,0,0,2,0,2,0.2857142857142857,2,0.0,0,0,0,0,0,0,0,2,0,0,2,1
146,4029,Wkp6iolUyaZoJ05flcS8uKmcM1K0sTAZ,fbPkOYLVPtPgIt0MxizjfFJov3JbHyAi,6,7,4,0,2,1,3,0,17,2.4285714285714284,1,0.0,0,4,0,2,7,1,0,3,0,6,11,1
147,4030,qdFvSvAu7YEiiOuRfROhUegKEcAw8WjI,fbPkOYLVPtPgIt0MxizjfFJov3JbHyAi,9,7,3,0,3,0,5,0,18,2.5714285714285716,2,0.0,0,3,0,3,7,0,0,5,0,6,12,1
148,4031,l5LfU8gApOG72AnBkdAbfOLQLwFH7Zo2,fbPkOYLVPtPgIt0MxizjfFJov3JbHyAi,18,39,6,9,3,13,12,0,82,11.714285714285714,8,0.0,5,6,7,3,34,13,2,12,0,21,61,0
149,4035,YJ5mxpUsuGnox6GEy3E35b75l1Yuk6TC,fbPkOYLVPtPgIt0MxizjfFJov3JbHyAi,1,0,0,0,0,0,1,0,1,0.14285714285714285,1,0.0,0,0,0,0,0,0,0,1,0,0,1,1
150,4036,Y75HPUfsmJFX2l4CIc47CvtaKqz7eTTH,fbPkOYLVPtPgIt0MxizjfFJov3JbHyAi,5,2,1,0,1,0,2,0,6,0.8571428571428571,1,0.0,0,1,0,1,2,0,0,2,0,2,4,1
151,4039,nPGsjt6sk2qCL2FY7YNDGlVui96j8qhd,fbPkOYLVPtPgIt0MxizjfFJov3JbHyAi,24,22,10,14,11,0,7,0,64,9.142857142857142,2,0.0,10,10,13,11,12,0,1,7,0,44,20,0
152,4040,tmmvczbZLiPw6t5Ru9DTWRYnvMI3hKxN,fbPkOYLVPtPgIt0MxizjfFJov3JbHyAi,7,28,11,0,7,5,9,1,61,8.714285714285714,2,0.0,0,11,0,7,28,5,0,9,1,18,43,1
153,4042,03I1lWZt67ECKkJOIVeqAmBCKjZopH4v,fbPkOYLVPtPgIt0MxizjfFJov3JbHyAi,15,26,15,7,9,11,13,0,81,11.571428571428571,8,0.0,4,15,5,9,22,11,2,13,0,33,48,1
154,4044,dQeQGMqD2AfjLt9WMqT1wjR4i8srmTVY,fbPkOYLVPtPgIt0MxizjfFJov3JbHyAi,7,6,4,0,3,0,2,0,15,2.142857142857143,2,0.0,0,4,0,3,6,0,0,2,0,7,8,1
155,4046,FUyt82uYcKeXe5a1uDqi5Za4PXy0kx7h,fbPkOYLVPtPgIt0MxizjfFJov3JbHyAi,9,8,2,3,4,0,6,0,23,3.2857142857142856,1,0.0,5,2,2,4,3,0,1,6,0,13,10,1
156,4048,pWZNevyPOl4ouTcnYPIT4PYWT7cW7Aq7,fbPkOYLVPtPgIt0MxizjfFJov3JbHyAi,12,29,13,1,11,7,9,1,71,10.142857142857142,4,0.0,10,13,1,11,19,7,0,9,1,35,36,1
157,4052,e1CSwKLgflGiW7QjzYRNEoHjbDEH3F2k,fbPkOYLVPtPgIt0MxizjfFJov3JbHyAi,6,9,0,0,0,0,4,1,14,2.0,3,0.0,0,0,0,0,9,0,0,4,1,0,14,1
158,4054,hOv5RKQK1RGRxpJJGcW0k2cA3RwQ8Rk5,fbPkOYLVPtPgIt0MxizjfFJov3JbHyAi,12,30,12,5,8,22,10,0,87,12.428571428571429,3,0.0,9,12,4,8,21,22,1,10,0,33,54,1
159,4056,jcyuD7rFE4XO7CpWU6qjqHSzjWdDLgUn,fbPkOYLVPtPgIt0MxizjfFJov3JbHyAi,12,19,9,4,6,7,13,0,58,8.285714285714286,2,0.0,7,9,3,6,12,7,1,13,0,25,33,1
160,4060,vag0mKRhWPXqyPdrs8UzxFb02sZFFg3Z,fbPkOYLVPtPgIt0MxizjfFJov3JbHyAi,6,1,1,0,1,1,3,1,8,1.1428571428571428,1,0.0,0,1,0,1,1,1,0,3,1,2,6,1
161,4061,A7tHWOZtAjCVDU6Pkr6MtHjmqydOP5Uv,fbPkOYLVPtPgIt0MxizjfFJov3JbHyAi,8,5,3,0,2,0,2,0,12,1.7142857142857142,1,0.0,1,3,0,2,4,0,0,2,0,6,6,1
162,4062,GfQva8AQrZlwGbvyDGDInKzkvq0dln6l,fbPkOYLVPtPgIt0MxizjfFJov3JbHyAi,10,9,6,0,3,0,5,0,23,3.2857142857142856,2,0.0,0,6,0,3,9,0,0,5,0,9,14,1
163,4064,IhporhjBpD87E7pLhYtc9YRC8PipZyt6,fbPkOYLVPtPgIt0MxizjfFJov3JbHyAi,21,58,35,3,19,15,34,4,168,24.0,8,0.0,6,35,3,19,52,15,0,34,4,63,105,1
164,4065,6khySUugasTypUZbIissXWV1lXFT1d5n,fbPkOYLVPtPgIt0MxizjfFJov3JbHyAi,8,5,3,0,2,8,8,1,27,3.857142857142857,1,0.0,0,3,0,2,5,8,0,8,1,5,22,1
165,4066,0m3zP8nDyi6TxYSAa3KOP4WzeZItFG3V,fbPkOYLVPtPgIt0MxizjfFJov3JbHyAi,5,2,1,0,1,0,11,0,15,2.142857142857143,1,0.0,0,1,0,1,2,0,0,11,0,2,13,1
166,4070,bUizg9a7xaQ9xo39EDPwubco3asipi0e,fbPkOYLVPtPgIt0MxizjfFJov3JbHyAi,27,21,17,0,12,4,12,2,68,9.714285714285714,4,0.0,0,17,0,12,21,4,0,12,2,29,39,1
167,4071,HH3HV5HDJ35z2ldQAEIDXBOSBTxLd6O9,fbPkOYLVPtPgIt0MxizjfFJov3JbHyAi,23,35,24,12,10,24,15,0,120,17.142857142857142,5,0.0,4,24,10,10,31,24,2,15,0,48,72,1
168,4072,kHp5QZURLzbWn4koqFYZnQmO0kliz5hb,fbPkOYLVPtPgIt0MxizjfFJov3JbHyAi,45,72,41,25,20,33,17,1,209,29.857142857142858,8,0.0,16,41,22,20,56,33,3,17,1,99,110,0
169,4077,reYWWuBxz5Nnxq3jAGjfGe1NyMEEto5R,fbPkOYLVPtPgIt0MxizjfFJov3JbHyAi,27,62,20,12,22,47,37,31,231,33.0,6,0.0,31,20,11,22,31,47,1,37,31,84,147,1
170,4081,GXuacM1G2BzxiXouSVLnDv1V97NGwCCe,fbPkOYLVPtPgIt0MxizjfFJov3JbHyAi,10,17,8,0,3,0,9,1,38,5.428571428571429,2,0.0,0,8,0,3,17,0,0,9,1,11,27,1
171,4083,5tD3trtPQ6jzqFRimP1PMPhgvFtRmfA4,fbPkOYLVPtPgIt0MxizjfFJov3JbHyAi,14,64,7,5,6,6,13,1,102,14.571428571428571,6,0.0,10,7,4,6,54,6,1,13,1,27,75,1
172,4084,a4RYqILKcnu8c617gYSbD0KQIm9DqZnc,fbPkOYLVPtPgIt0MxizjfFJov3JbHyAi,3,4,0,0,0,0,1,0,5,0.7142857142857143,1,0.0,0,0,0,0,4,0,0,1,0,0,5,1
173,4088,czTQ5ELSy91Dy79vk5MgxZdL9nunJtpb,fbPkOYLVPtPgIt0MxizjfFJov3JbHyAi,4,3,0,0,0,0,7,0,10,1.4285714285714286,1,0.0,0,0,0,0,3,0,0,7,0,0,10,1
174,4090,1nooHXMbJhGPsGTrHpT4esI4WCkiFA2H,fbPkOYLVPtPgIt0MxizjfFJov3JbHyAi,8,8,5,0,3,0,6,0,22,3.142857142857143,1,0.0,0,5,0,3,8,0,0,6,0,8,14,1
175,4091,BbZEGv8zMCuD8c0LXrenf9W1lGSlVd04,fbPkOYLVPtPgIt0MxizjfFJov3JbHyAi,18,22,9,8,10,0,3,0,52,7.428571428571429,2,0.0,4,9,5,10,18,0,3,3,0,28,24,1
176,4093,zLfLf7Y2Kf0HyKtBcK0c943FFMXMBiGO,fbPkOYLVPtPgIt0MxizjfFJov3JbHyAi,12,23,7,0,6,7,4,0,47,6.714285714285714,2,0.0,3,7,0,6,20,7,0,4,0,16,31,1
177,4095,ijFjDmHOLiyu54Ko0v4roRDWdDCIX5i1,fbPkOYLVPtPgIt0MxizjfFJov3JbHyAi,37,67,38,6,28,2,14,1,156,22.285714285714285,9,0.0,12,38,6,28,55,2,0,14,1,84,72,0
178,4097,CVQI4y90zNEQKnbziqeit6sPoxhPlPMP,fbPkOYLVPtPgIt0MxizjfFJov3JbHyAi,7,2,1,0,1,0,3,0,7,1.0,1,0.0,0,1,0,1,2,0,0,3,0,2,5,1
179,4101,pWkLIEFKVWp1dpRpiw46ybvs7QZ4nDA4,fbPkOYLVPtPgIt0MxizjfFJov3JbHyAi,7,5,2,0,0,0,7,0,14,2.0,2,0.0,0,2,0,0,5,0,0,7,0,2,12,1
180,4103,Y1ppxEgbx61jNTLCoOABIFXnW04QUYST,fbPkOYLVPtPgIt0MxizjfFJov3JbHyAi,7,3,2,0,2,0,4,0,11,1.5714285714285714,1,0.0,0,2,0,2,3,0,0,4,0,4,7,1
181,4105,VJ15PTmNAjfB6ipRCoKMs7aSjJuraSNv,fbPkOYLVPtPgIt0MxizjfFJov3JbHyAi,37,69,27,28,13,46,14,1,198,28.285714285714285,8,0.0,16,27,25,13,53,46,3,14,1,81,117,1
182,4106,TMVzoCHYEzB4dA3dJFO0jufgXr0xWoMt,fbPkOYLVPtPgIt0MxizjfFJov3JbHyAi,6,7,1,0,1,0,2,0,11,1.5714285714285714,1,0.0,3,1,0,1,4,0,0,2,0,5,6,1
183,4108,ILcXhWva6fUJAzRZSl16N8h2AK8Jjf9I,fbPkOYLVPtPgIt0MxizjfFJov3JbHyAi,7,8,2,0,2,0,3,0,15,2.142857142857143,1,0.0,0,2,0,2,8,0,0,3,0,4,11,1
184,4111,blTEANBNlwleHMZh60k5xSk9rNOJZKek,fbPkOYLVPtPgIt0MxizjfFJov3JbHyAi,2,0,0,0,0,0,6,0,6,0.8571428571428571,2,0.0,0,0,0,0,0,0,0,6,0,0,6,1
185,4112,FM7f8SmryrQv0xQWmeGBOm7E9JzAE7cF,fbPkOYLVPtPgIt0MxizjfFJov3JbHyAi,12,17,6,0,5,20,10,1,59,8.428571428571429,2,0.0,4,6,0,5,13,20,0,10,1,15,44,1
186,4113,uYnLLjFhtmRLfdb6UnGOhZKWKwE2Sz7S,fbPkOYLVPtPgIt0MxizjfFJov3JbHyAi,1,0,0,0,0,0,3,0,3,0.42857142857142855,1,0.0,0,0,0,0,0,0,0,3,0,0,3,1
187,4114,XqcIbo9pkzTiouZzC4CsMH0T57ZrJT7c,fbPkOYLVPtPgIt0MxizjfFJov3JbHyAi,12,21,8,11,5,8,7,1,61,8.714285714285714,3,0.0,3,8,8,5,18,8,3,7,1,24,37,1
188,4116,SbxWcDAQO1PnIdll82O1Qa8HqEHuIfT7,fbPkOYLVPtPgIt0MxizjfFJov3JbHyAi,5,5,1,0,1,0,1,0,8,1.1428571428571428,1,0.0,0,1,0,1,5,0,0,1,0,2,6,1
189,4117,DIqOhojonPjb3L0MafoRC4vbkm2ZgCPT,fbPkOYLVPtPgIt0MxizjfFJov3JbHyAi,15,13,4,13,5,7,6,2,50,7.142857142857143,2,0.0,6,4,9,5,7,7,4,6,2,24,26,1
190,4121,jcdJUvdxIg03VTKugjVUNiWSl6LwbiFS,fbPkOYLVPtPgIt0MxizjfFJov3JbHyAi,6,3,2,0,2,10,1,0,18,2.5714285714285716,1,0.0,0,2,0,2,3,10,0,1,0,4,14,1
191,4122,Uo5Is5U7melZAv7xg2Req57LK7O8TGT8,fbPkOYLVPtPgIt0MxizjfFJov3JbHyAi,30,41,25,0,16,1,14,3,100,14.285714285714286,3,0.0,2,25,0,16,39,1,0,14,3,43,57,1
192,4124,gml56PidNECJRV7FxBwKkFjPhRALq3yM,fbPkOYLVPtPgIt0MxizjfFJov3JbHyAi,9,8,5,0,4,0,10,0,27,3.857142857142857,2,0.0,0,5,0,4,8,0,0,10,0,9,18,1
193,4125,bGXe45VQE79P82jCvYbfBiOeISe1I8HL,fbPkOYLVPtPgIt0MxizjfFJov3JbHyAi,1,0,0,0,0,0,1,0,1,0.14285714285714285,1,0.0,0,0,0,0,0,0,0,1,0,0,1,1
194,4126,u4TNxfYOFL4kSz0gq3emLn9aOKma8Z0X,fbPkOYLVPtPgIt0MxizjfFJov3JbHyAi,11,7,5,3,2,0,0,0,17,2.4285714285714284,3,0.0,0,5,3,2,7,0,0,0,0,10,7,1
195,4127,iMXZvpdXIEwupZ3KLZs1wDk19TeUIZDi,fbPkOYLVPtPgIt0MxizjfFJov3JbHyAi,15,56,29,16,14,54,30,4,203,29.0,3,0.0,12,29,11,14,44,54,5,30,4,66,137,1
196,4129,Xl7O5Es6VpkB2PrTgzArkv7OwJ7XzlEg,fbPkOYLVPtPgIt0MxizjfFJov3JbHyAi,17,33,10,5,9,5,13,2,77,11.0,4,0.0,5,10,4,9,28,5,1,13,2,28,49,1
197,4130,8h1kpVFWyv776a7gZ8tw0jpXvK9G6pQ2,fbPkOYLVPtPgIt0MxizjfFJov3JbHyAi,10,9,4,0,3,0,7,0,23,3.2857142857142856,1,0.0,0,4,0,3,9,0,0,7,0,7,16,1
198,4133,sT9hGAnww95aeGvqwQpJlS3ORhWDT49F,fbPkOYLVPtPgIt0MxizjfFJov3JbHyAi,42,58,29,22,20,8,13,0,150,21.428571428571427,6,0.0,23,29,20,20,35,8,2,13,0,92,58,0
199,4134,bRG3KNKPz8MtEb5G1Duc4i5IiNMa8ZLU,fbPkOYLVPtPgIt0MxizjfFJov3JbHyAi,10,17,5,2,1,10,10,2,47,6.714285714285714,2,0.0,1,5,2,1,16,10,0,10,2,9,38,1
200,4135,Y9GqNI8HKN8AZelF8dSXK2b9zuzFq9b9,fbPkOYLVPtPgIt0MxizjfFJov3JbHyAi,4,2,1,0,1,0,1,0,5,0.7142857142857143,1,0.0,0,1,0,1,2,0,0,1,0,2,3,1
201,4136,WfTazznjeVMuts1c6fhfvqWuaprKs7C3,fbPkOYLVPtPgIt0MxizjfFJov3JbHyAi,29,41,27,0,18,51,24,4,165,23.571428571428573,6,0.0,0,27,0,18,41,51,0,24,4,45,120,1
202,4137,Z9qi5pq1C1bndfjP0mrTCfL8YAf6Qiv7,fbPkOYLVPtPgIt0MxizjfFJov3JbHyAi,11,14,9,0,6,11,13,1,54,7.714285714285714,3,0.0,0,9,0,6,14,11,0,13,1,15,39,0
203,4138,9tBhYjIXbTBZ0n8EA8LPV9H9GyKFjXEe,fbPkOYLVPtPgIt0MxizjfFJov3JbHyAi,9,4,3,0,3,0,2,0,12,1.7142857142857142,1,0.0,0,3,0,3,4,0,0,2,0,6,6,1
204,4140,JqdbZyx8jQDjvl0RCDBDldcliaXwceyv,fbPkOYLVPtPgIt0MxizjfFJov3JbHyAi,8,5,3,0,2,0,4,0,14,2.0,2,0.0,0,3,0,2,5,0,0,4,0,5,9,1
205,4141,3n39NQ5LzQS0QCcr9JZOE6aTUD48ZbAa,fbPkOYLVPtPgIt0MxizjfFJov3JbHyAi,7,3,2,0,2,0,6,0,13,1.8571428571428572,1,0.0,0,2,0,2,3,0,0,6,0,4,9,1
206,4143,9sFMHkQmozo76x80tFTC9ms1LtFpAvDD,fbPkOYLVPtPgIt0MxizjfFJov3JbHyAi,26,41,13,35,19,22,16,0,146,20.857142857142858,4,0.0,25,13,26,19,16,22,9,16,0,83,63,0
207,4145,AIdvsyhxoVQRPe3inEZOul3GszLWUII0,fbPkOYLVPtPgIt0MxizjfFJov3JbHyAi,7,3,2,0,2,0,5,0,12,1.7142857142857142,1,0.0,0,2,0,2,3,0,0,5,0,4,8,1
208,4146,UzWWq61d6vy3b9FQ0Zm3Qt9Ks0lmq3Qw,fbPkOYLVPtPgIt0MxizjfFJov3JbHyAi,9,4,3,0,3,0,5,0,15,2.142857142857143,1,0.0,0,3,0,3,4,0,0,5,0,6,9,1
209,4147,pUAX44GhkdnMgwkbpKeIXW1XZgu0a3SV,fbPkOYLVPtPgIt0MxizjfFJov3JbHyAi,5,2,1,0,1,0,4,0,8,1.1428571428571428,1,0.0,0,1,0,1,2,0,0,4,0,2,6,1
210,4148,V2KAeU5M9aZ71MSOJMPq9O99rHGzmKaR,fbPkOYLVPtPgIt0MxizjfFJov3JbHyAi,9,33,5,0,5,0,7,0,50,7.142857142857143,4,0.0,3,5,0,5,30,0,0,7,0,13,37,1
211,4149,dTHHrNH4JPIQjJnYjUmUZmHrgYHdCxcs,fbPkOYLVPtPgIt0MxizjfFJov3JbHyAi,6,5,2,0,3,0,1,0,11,1.5714285714285714,1,0.0,2,2,0,3,3,0,0,1,0,7,4,1
212,4150,mkfe4TuGJEOOkk4BSi5C0OnTlC842bEi,fbPkOYLVPtPgIt0MxizjfFJov3JbHyAi,26,51,15,13,22,0,8,1,110,15.714285714285714,3,0.0,33,15,11,22,18,0,2,8,1,81,29,1
213,4152,SBELepDdWchL6dd3B4yF17bQJZRyBGmW,fbPkOYLVPtPgIt0MxizjfFJov3JbHyAi,4,2,0,0,0,2,2,0,6,0.8571428571428571,1,0.0,0,0,0,0,2,2,0,2,0,0,6,1
214,4155,82WiuHoB3dVqYkf2UKsu9ogC0IsQQnqa,fbPkOYLVPtPgIt0MxizjfFJov3JbHyAi,13,57,22,1,10,6,10,0,106,15.142857142857142,5,0.0,10,22,1,10,47,6,0,10,0,43,63,1
215,4157,ZfaQRDpYRWxr1tKliyWhtiIkOEpZJsx1,fbPkOYLVPtPgIt0MxizjfFJov3JbHyAi,8,10,6,0,1,2,3,0,22,3.142857142857143,2,0.0,2,6,0,1,8,2,0,3,0,9,13,1
216,4160,nLSyDmuwtZ9VcSdeL7kW6FG97w0wmm94,fbPkOYLVPtPgIt0MxizjfFJov3JbHyAi,6,2,1,0,1,2,4,1,11,1.5714285714285714,1,0.0,0,1,0,1,2,2,0,4,1,2,9,1
217,4161,gT3kB48dwTiT117VlKJVDNNpHcWl18uZ,fbPkOYLVPtPgIt0MxizjfFJov3JbHyAi,5,0,0,0,0,1,5,1,7,1.0,1,0.0,0,0,0,0,0,1,0,5,1,0,7,1
218,4162,w9kAk351HcnpUdtlF40UgfJ8nmtrjk1M,fbPkOYLVPtPgIt0MxizjfFJov3JbHyAi,3,3,0,0,0,0,2,0,5,0.7142857142857143,1,0.0,0,0,0,0,3,0,0,2,0,0,5,1
219,4163,PBd2c59pI8ZCJwc4iQjHYNeQj4K3oGvT,fbPkOYLVPtPgIt0MxizjfFJov3JbHyAi,12,10,6,0,4,6,13,1,40,5.714285714285714,2,0.0,0,6,0,4,10,6,0,13,1,10,30,1
220,4164,6PFF6a3rTtp143lPxgdGFZZ0CCZBKH49,fbPkOYLVPtPgIt0MxizjfFJov3JbHyAi,10,10,5,0,5,4,9,3,36,5.142857142857143,1,0.0,3,5,0,5,7,4,0,9,3,13,23,1
221,4168,heWUPIsxtHSwXQGmJMsYqzGkbNQihssP,fbPkOYLVPtPgIt0MxizjfFJov3JbHyAi,4,2,1,0,1,0,1,0,5,0.7142857142857143,1,0.0,0,1,0,1,2,0,0,1,0,2,3,1
222,4169,z9oFzf9xIbCN4mhupPeK6qv2AnZTqp8G,fbPkOYLVPtPgIt0MxizjfFJov3JbHyAi,6,1,1,0,1,0,3,0,6,0.8571428571428571,1,0.0,0,1,0,1,1,0,0,3,0,2,4,1
223,4170,cJuR6mykFWWefoh4qiG9O6BBEr08qxSv,fbPkOYLVPtPgIt0MxizjfFJov3JbHyAi,8,13,4,0,4,18,6,3,48,6.857142857142857,2,0.0,4,4,0,4,9,18,0,6,3,12,36,1
224,4171,uHgH8m4GJET0eE5mE8JCyLZD7HEKwM4t,SpATywNh6bZuzm8s1ceuBUnMUAeoAHHw,27,59,29,26,4,39,39,3,199,28.428571428571427,10,0.0,14,29,23,4,45,39,3,39,3,70,129,0
225,4182,HgeZmyLysCZF827lPwLNCfqcskKVvNDd,SpATywNh6bZuzm8s1ceuBUnMUAeoAHHw,16,29,2,19,2,2,15,2,71,10.142857142857142,3,0.0,10,2,16,2,19,2,3,15,2,30,41,0
226,4218,EReWp6ilgaQY61GGX2jAkIc5IQisheJq,SpATywNh6bZuzm8s1ceuBUnMUAeoAHHw,8,8,4,0,3,0,3,0,18,2.5714285714285716,2,0.0,0,4,0,3,8,0,0,3,0,7,11,1
227,4219,Jm4nQ05ndX10jbofbWx6S0r9VXrqia6S,bWdj2GDclj5ofokWjzoa5jAwMkxCykd6,11,28,14,46,2,14,11,0,115,16.428571428571427,3,0.0,3,14,44,2,25,14,2,11,0,63,52,0
228,4237,SVFfJJhaWd2RlHPtvg5SWBRGj8N0paMQ,SpATywNh6bZuzm8s1ceuBUnMUAeoAHHw,23,49,4,34,1,2,18,0,108,15.428571428571429,5,0.0,20,4,30,1,29,2,4,18,0,55,53,0
229,4238,hevZgCUVQAVwtaivzco7bLaVpTOAAfiG,SpATywNh6bZuzm8s1ceuBUnMUAeoAHHw,26,31,17,18,10,1,7,0,84,12.0,2,0.0,9,17,15,10,22,1,3,7,0,51,33,0
230,4243,83p9ejSELsW1j5wNlAyUXF2YWFL8Z8tc,A3fsA9Zfv1X2fVEQhTw51lKENdNrEqT3,66,32,16,118,13,1,13,0,193,27.571428571428573,4,0.0,2,16,112,13,30,1,6,13,0,143,50,0
231,4247,0NGZq9HZW5KOrSfzSGGipuN20pCRDMWu,G8EPVSXsOYB5YQWZGiz1aVq5Pgr2GrQu,28,48,15,17,12,42,24,2,160,22.857142857142858,5,0.0,21,15,13,12,27,42,4,24,2,61,99,0
232,4250,DHUv7XpIZcPp2QYGNmTXjhgg7Zq4BpJ7,SpATywNh6bZuzm8s1ceuBUnMUAeoAHHw,16,12,9,2,6,0,4,0,33,4.714285714285714,2,0.0,1,9,2,6,11,0,0,4,0,18,15,1
233,4254,J5PQMceXoOVyN05md7NqKfAhSfcgJgVJ,SpATywNh6bZuzm8s1ceuBUnMUAeoAHHw,24,53,2,37,0,143,23,2,260,37.142857142857146,9,0.0,18,2,32,0,35,143,5,23,2,52,208,0
234,4268,nYFWhKbFKiXgZ193lmJEmg3xQ65UNrPv,SpATywNh6bZuzm8s1ceuBUnMUAeoAHHw,24,45,18,26,6,3,11,1,110,15.714285714285714,4,0.0,20,18,24,6,25,3,2,11,1,68,42,1
235,4278,iVNWfvqx80bYGUpxbD5kOVH2Fugs6QtQ,SpATywNh6bZuzm8s1ceuBUnMUAeoAHHw,26,37,23,14,14,3,6,0,97,13.857142857142858,2,0.0,7,23,14,14,30,3,0,6,0,58,39,0
236,4286,i9UIJe9BPLqUSVYMtAIMhpSeBf6cbruQ,SpATywNh6bZuzm8s1ceuBUnMUAeoAHHw,15,21,9,11,4,0,5,0,50,7.142857142857143,2,0.0,8,9,11,4,13,0,0,5,0,32,18,0
237,4290,EVhDvNThWnvwe7HGJiMKoMo6EeAXDH9R,bWdj2GDclj5ofokWjzoa5jAwMkxCykd6,9,11,7,0,4,1,15,0,38,5.428571428571429,2,0.0,0,7,0,4,11,1,0,15,0,11,27,1
238,4291,UTQBVZwwRuN7bMqGkwJeqpNJF2PPrsFV,A3fsA9Zfv1X2fVEQhTw51lKENdNrEqT3,18,12,9,0,8,0,2,0,31,4.428571428571429,1,0.0,0,9,0,8,12,0,0,2,0,17,14,0
239,4292,5IOZn10arhSe83Sz47oGoyNxbAFXZkA2,SpATywNh6bZuzm8s1ceuBUnMUAeoAHHw,12,35,12,0,3,16,14,0,80,11.428571428571429,4,0.0,2,12,0,3,33,16,0,14,0,17,63,1
240,4301,QOK5LHvwN0A5g3JhxMPHBffh5Rh2wZF8,SpATywNh6bZuzm8s1ceuBUnMUAeoAHHw,12,15,4,0,2,1,10,1,33,4.714285714285714,2,0.0,1,4,0,2,14,1,0,10,1,7,26,1
241,4313,l80sDXQh6tFmRSRsJvWJgP55drvQUfT2,SpATywNh6bZuzm8s1ceuBUnMUAeoAHHw,20,37,15,14,9,0,9,0,84,12.0,4,0.0,12,15,13,9,25,0,1,9,0,49,35,1
242,4327,glS180WZt8C6hB13WP6NUijid7zN96cg,SpATywNh6bZuzm8s1ceuBUnMUAeoAHHw,26,41,16,22,4,4,9,1,97,13.857142857142858,4,0.0,18,16,20,4,23,4,2,9,1,58,39,0
243,4342,gqe5NXbZbf5uXY0rPviLeIFOMpQyekdp,G8EPVSXsOYB5YQWZGiz1aVq5Pgr2GrQu,24,31,2,30,3,16,10,0,92,13.142857142857142,3,0.0,0,2,26,3,31,16,4,10,0,31,61,1
244,4352,3OBHdoV61de7ICMrnWAXr689Eb2AyuN0,SpATywNh6bZuzm8s1ceuBUnMUAeoAHHw,19,18,7,20,5,2,6,0,58,8.285714285714286,2,0.0,7,7,16,5,11,2,4,6,0,35,23,0
245,4361,jygZDxdNc5vnyQVPVME6xQbLWCY2Zptq,SpATywNh6bZuzm8s1ceuBUnMUAeoAHHw,6,9,5,0,5,0,5,0,24,3.4285714285714284,1,0.0,0,5,0,5,9,0,0,5,0,10,14,1
246,4365,ebO6e76NCFlMeek1yPjM9gz3mJBPl1yH,RXDvfPUBYFlVdlueBFbLW0mhhAyGEqpt,10,10,2,0,2,0,3,0,17,2.4285714285714284,1,0.0,0,2,0,2,10,0,0,3,0,4,13,1
247,4395,C6xrhZPOmVH2gCVNP26gSSPka2CcwgB5,SpATywNh6bZuzm8s1ceuBUnMUAeoAHHw,21,18,10,12,5,1,11,0,57,8.142857142857142,4,0.0,7,10,12,5,11,1,0,11,0,34,23,1
248,4396,5c5BMuD35oybcLij9FEBpLM3FZXJ5QAD,G8EPVSXsOYB5YQWZGiz1aVq5Pgr2GrQu,35,85,4,25,0,23,15,6,158,22.571428571428573,3,0.0,4,4,22,0,81,23,3,15,6,30,128,0
249,4406,U0MChqulsymiJYCtbj873TXGFuXiZDFk,SpATywNh6bZuzm8s1ceuBUnMUAeoAHHw,31,55,30,24,12,14,19,1,155,22.142857142857142,9,0.0,16,30,22,12,39,14,2,19,1,80,75,0
250,4430,sWkTuB7KUS6C7uaxH84rlQvKN8aRF9JC,bWdj2GDclj5ofokWjzoa5jAwMkxCykd6,6,4,2,0,1,0,6,0,13,1.8571428571428572,2,0.0,0,2,0,1,4,0,0,6,0,3,10,1
251,4432,kdQVQcPehC1WZyKhleQe5vDaCQv1dpj8,SpATywNh6bZuzm8s1ceuBUnMUAeoAHHw,17,21,12,21,6,4,12,3,79,11.285714285714286,4,0.0,4,12,19,6,17,4,2,12,3,41,38,0
252,4435,bN6JhUz4s97Xsh7eq2ZH1ilTMaKJDuUF,bWdj2GDclj5ofokWjzoa5jAwMkxCykd6,39,129,42,113,12,33,34,1,364,52.0,7,0.0,16,42,99,12,113,33,14,34,1,169,195,0
253,4440,ZhTCqX8GMUcn0a0betuEauHNuCk1aRhm,bWdj2GDclj5ofokWjzoa5jAwMkxCykd6,39,103,38,126,15,92,20,0,394,56.285714285714285,4,0.0,22,38,112,15,81,92,14,20,0,187,207,0
254,4453,4sZlPbPnBCwNHbrOUXcVAiPkTKHriJTV,SpATywNh6bZuzm8s1ceuBUnMUAeoAHHw,26,65,5,36,1,52,56,4,219,31.285714285714285,8,0.0,14,5,32,1,51,52,4,56,4,52,167,0
255,4454,lMy0A59BRo4770ALzvOjsBS5HJkCRV78,bWdj2GDclj5ofokWjzoa5jAwMkxCykd6,34,66,2,108,0,20,37,1,234,33.42857142857143,6,0.0,8,2,97,0,58,20,11,37,1,107,127,1
256,4481,XjrP1VAGwJCwkRm4KgImIkZYNjnvGQN9,RXDvfPUBYFlVdlueBFbLW0mhhAyGEqpt,74,212,101,172,55,73,109,31,753,107.57142857142857,14,0.0,44,101,155,55,168,73,17,109,31,355,398,0
257,4498,dxoTIhhPXBvqzWGLltH0slJdxsuyggjI,G8EPVSXsOYB5YQWZGiz1aVq5Pgr2GrQu,47,97,73,0,37,53,57,4,321,45.857142857142854,10,0.0,1,73,0,37,96,53,0,57,4,111,210,0
258,4499,2ZP4iw9joeRPfEuWLWQQFnKchFtuqx5l,SpATywNh6bZuzm8s1ceuBUnMUAeoAHHw,14,19,10,12,7,3,3,0,54,7.714285714285714,2,0.0,6,10,11,7,13,3,1,3,0,34,20,0
259,4506,j1jdy8OF5VQw4rqSYOkbK2pQplvvvz37,G8EPVSXsOYB5YQWZGiz1aVq5Pgr2GrQu,71,210,23,142,9,204,122,5,715,102.14285714285714,14,0.0,26,23,116,9,184,204,26,122,5,174,541,0
260,4507,HuDaXYBstQFpbEGg5tkyPhxLKzB3hVSB,SpATywNh6bZuzm8s1ceuBUnMUAeoAHHw,32,179,81,47,12,115,101,6,541,77.28571428571429,14,0.0,45,81,35,12,134,115,12,101,6,173,368,0
261,4524,j1jdy8OF5VQw4rqSYOkbK2pQplvvvz37,bWdj2GDclj5ofokWjzoa5jAwMkxCykd6,38,103,25,160,6,68,55,3,420,60.0,10,0.0,12,25,141,6,91,68,19,55,3,184,236,1
262,4547,fczke4UuC99kQHbLPBF9eDbT99FMycXd,SpATywNh6bZuzm8s1ceuBUnMUAeoAHHw,4,0,0,0,0,0,4,0,4,0.5714285714285714,1,0.0,0,0,0,0,0,0,0,4,0,0,4,0
263,4548,kla9cpzzaIqMfwRx5dULfeceoZisiJXJ,SpATywNh6bZuzm8s1ceuBUnMUAeoAHHw,31,125,41,36,14,47,70,10,343,49.0,8,0.0,55,41,32,14,70,47,4,70,10,142,201,0
264,4571,PUW0i4IuafllkJEtV0GCqmTDeLHkDmH3,bWdj2GDclj5ofokWjzoa5jAwMkxCykd6,40,98,9,114,8,416,79,7,731,104.42857142857143,12,0.0,15,9,95,8,83,416,19,79,7,127,604,0
265,4585,HqsJVGNbokPBStWiDvKZXbvoLlDHixpp,SpATywNh6bZuzm8s1ceuBUnMUAeoAHHw,22,31,3,24,1,0,7,0,66,9.428571428571429,1,0.0,14,3,21,1,17,0,3,7,0,39,27,0
266,4598,izDb8XjXh0aaLsv56xtUKjGq4nGYtog4,G8EPVSXsOYB5YQWZGiz1aVq5Pgr2GrQu,48,119,64,48,23,49,47,12,362,51.714285714285715,3,0.0,34,64,24,23,85,49,24,47,12,145,217,0
267,4610,sZNhT3IqtfFMwMod3w0cGQK1HKvrIFwI,SpATywNh6bZuzm8s1ceuBUnMUAeoAHHw,17,8,6,4,5,0,4,0,27,3.857142857142857,2,0.0,0,6,4,5,8,0,0,4,0,15,12,1
268,4613,aVE6FAaI67jjqObdfL3BkKQUvDsOp43M,SpATywNh6bZuzm8s1ceuBUnMUAeoAHHw,32,99,62,26,20,66,48,1,322,46.0,4,0.0,14,62,24,20,85,66,2,48,1,120,202,0
269,4614,D77mYRAEHVmHmrch91cWflZwkGfWXMn3,SpATywNh6bZuzm8s1ceuBUnMUAeoAHHw,16,33,6,0,5,0,8,0,52,7.428571428571429,4,0.0,0,6,0,5,33,0,0,8,0,11,41,1
270,4625,qRy2DimM9SNsqYvrYrrnIw2oQKcYB3wP,SpATywNh6bZuzm8s1ceuBUnMUAeoAHHw,21,33,1,27,1,0,6,0,68,9.714285714285714,4,0.0,8,1,23,1,25,0,4,6,0,33,35,0
271,4641,8oxFWBumsNA4SJ0CIJujNkjFW8ZzMgtQ,SpATywNh6bZuzm8s1ceuBUnMUAeoAHHw,17,56,2,18,2,39,23,4,144,20.571428571428573,6,0.0,22,2,15,2,34,39,3,23,4,41,103,0
272,4647,MKlpymF14KtyI236a0RjVjNdDlFXwHJE,SpATywNh6bZuzm8s1ceuBUnMUAeoAHHw,26,63,8,20,3,42,18,3,157,22.428571428571427,5,0.0,15,8,19,3,48,42,1,18,3,45,112,0
273,4652,D1N0ONIJFdYniASKJjZ0ujwEVr50txl7,A3fsA9Zfv1X2fVEQhTw51lKENdNrEqT3,8,7,5,0,5,0,2,0,19,2.7142857142857144,1,0.0,0,5,0,5,7,0,0,2,0,10,9,1
274,4664,kMN5uYNaj23K9PVTrdyiL9iDB1lCye57,SpATywNh6bZuzm8s1ceuBUnMUAeoAHHw,20,66,22,17,7,47,21,1,181,25.857142857142858,8,0.0,18,22,15,7,48,47,2,21,1,62,119,0
275,4667,hjlIy32j2vlgUCGRsMhZTr5gQN9bE8Ko,A3fsA9Zfv1X2fVEQhTw51lKENdNrEqT3,3,3,1,0,0,0,1,0,5,0.7142857142857143,1,0.0,0,1,0,0,3,0,0,1,0,1,4,1
276,4713,2d73pTPKGJeE59DtbgirchSdsN0c5ZX8,G8EPVSXsOYB5YQWZGiz1aVq5Pgr2GrQu,56,141,47,158,17,9,34,2,408,58.285714285714285,8,0.0,70,47,125,17,71,9,33,34,2,259,149,1
277,4717,pYVXRlnQ0YvWKNjc7FEDAmE4Ai0Z428V,SpATywNh6bZuzm8s1ceuBUnMUAeoAHHw,13,9,4,13,4,3,9,0,42,6.0,2,0.0,3,4,11,4,6,3,2,9,0,22,20,1
278,4724,CjC2ROZAsG20pDynA7ZPw7kC7J3IUQLv,SpATywNh6bZuzm8s1ceuBUnMUAeoAHHw,17,32,17,16,6,19,19,1,110,15.714285714285714,3,0.0,4,17,14,6,28,19,2,19,1,41,69,0
279,4728,pteLC5OQ4se3k1DPDEwaYOBtzSkv9plY,A3fsA9Zfv1X2fVEQhTw51lKENdNrEqT3,8,6,2,0,2,0,5,0,15,2.142857142857143,2,0.0,0,2,0,2,6,0,0,5,0,4,11,1
280,4731,LgFsEu5TARkqPf6cgrTX0NqpOzewq5Lk,SpATywNh6bZuzm8s1ceuBUnMUAeoAHHw,27,27,14,23,8,3,9,2,86,12.285714285714286,3,0.0,6,14,20,8,21,3,3,9,2,48,38,0
281,4747,2YrfQZgyUPdiZGXhplgKBSkvHochAfw6,SpATywNh6bZuzm8s1ceuBUnMUAeoAHHw,22,77,32,29,10,0,18,0,166,23.714285714285715,6,0.0,9,32,22,10,68,0,7,18,0,73,93,0
282,4767,OLNUzQUHvlNsi2WFlH5eEyaieqKXrEz7,SpATywNh6bZuzm8s1ceuBUnMUAeoAHHw,10,15,6,0,2,1,5,0,29,4.142857142857143,3,0.0,2,6,0,2,13,1,0,5,0,10,19,1
283,4773,29ctmAiYEOKj7HqUZOWS8Kj1hgVEvKs8,bWdj2GDclj5ofokWjzoa5jAwMkxCykd6,6,6,0,0,0,0,5,0,11,1.5714285714285714,1,0.0,0,0,0,0,6,0,0,5,0,0,11,1
284,4774,urHq1UPtLFVLJW8r9uUffDflKlN7AYRL,SpATywNh6bZuzm8s1ceuBUnMUAeoAHHw,32,42,20,31,7,5,15,0,120,17.142857142857142,5,0.0,11,20,26,7,31,5,5,15,0,64,56,0
285,4801,uvl7kPB3Po3jrDtnQvCsunCWcJhdeQPU,A3fsA9Zfv1X2fVEQhTw51lKENdNrEqT3,50,48,27,103,17,0,15,1,211,30.142857142857142,4,0.0,4,27,88,17,44,0,15,15,1,136,75,1
286,4802,aI2WbSCktVyijPTHCbgAdpzpfdnFGcq9,RXDvfPUBYFlVdlueBFbLW0mhhAyGEqpt,34,61,31,0,13,1,34,6,146,20.857142857142858,7,0.0,4,31,0,13,57,1,0,34,6,48,98,0
287,4806,iGjPcJm3i62KsWTQKhrsxcQv7n97iair,G8EPVSXsOYB5YQWZGiz1aVq5Pgr2GrQu,105,125,10,287,5,86,16,1,530,75.71428571428571,6,0.0,56,10,193,5,69,86,94,16,1,264,266,0
288,4825,q3SjGV3d1qwn1q3ehoXsAmC01281iVQV,SpATywNh6bZuzm8s1ceuBUnMUAeoAHHw,16,23,9,14,8,8,16,1,79,11.285714285714286,2,0.0,8,9,13,8,15,8,1,16,1,38,41,0
289,4827,yNygMjDRQbsmQrkdzv6Ni3gEhrA9rC9T,SpATywNh6bZuzm8s1ceuBUnMUAeoAHHw,13,30,14,12,7,2,6,0,71,10.142857142857142,3,0.0,10,14,9,7,20,2,3,6,0,40,31,0
290,4852,bvRAS0uJ0Teq8mZcNb9rxcXigDj59DTa,RXDvfPUBYFlVdlueBFbLW0mhhAyGEqpt,9,19,13,0,0,0,6,0,38,5.428571428571429,4,0.0,0,13,0,0,19,0,0,6,0,13,25,0
291,4903,jJEQAKDG1yT0OS9qRBZrNXlEJDxE8Etq,A3fsA9Zfv1X2fVEQhTw51lKENdNrEqT3,30,41,11,32,1,114,37,2,238,34.0,10,0.0,5,11,28,1,36,114,4,37,2,45,193,0
292,4907,24hyIKTWvGbDpRNiVA2hNdG9ApRuVKWS,SpATywNh6bZuzm8s1ceuBUnMUAeoAHHw,30,49,26,19,12,14,21,1,142,20.285714285714285,8,0.0,10,26,17,12,39,14,2,21,1,65,77,0
293,4910,FlH4hJdTFopI7d7C8aCFmJunlCxyAcSh,SpATywNh6bZuzm8s1ceuBUnMUAeoAHHw,6,3,2,0,2,0,1,0,8,1.1428571428571428,1,0.0,0,2,0,2,3,0,0,1,0,4,4,1
294,4919,QDpN8D19Mr8RZumTONWpZNlCWcHCCTbH,bWdj2GDclj5ofokWjzoa5jAwMkxCykd6,14,24,2,44,2,14,8,0,94,13.428571428571429,4,0.0,5,2,42,2,19,14,2,8,0,51,43,1
295,4927,WYPfgLKE9VINcT4gmCjKg6KY4hGmzmxN,SpATywNh6bZuzm8s1ceuBUnMUAeoAHHw,22,27,14,12,5,3,6,0,67,9.571428571428571,2,0.0,8,14,10,5,19,3,2,6,0,37,30,0
296,4931,eiL4sJzBUqNqEAwJXavGTHQchRgg0E9e,G8EPVSXsOYB5YQWZGiz1aVq5Pgr2GrQu,54,68,6,121,2,25,32,4,258,36.857142857142854,8,0.0,5,6,97,2,63,25,24,32,4,110,148,0
297,4934,RkupeBiDJM8eQAHegSIZXnYfypYMPCFs,SpATywNh6bZuzm8s1ceuBUnMUAeoAHHw,12,46,28,3,10,0,17,0,104,14.857142857142858,6,0.0,3,28,3,10,43,0,0,17,0,44,60,0
298,4937,aZcgamrUxwqX7Nt2qxeI2ZGGKhcvbWIt,SpATywNh6bZuzm8s1ceuBUnMUAeoAHHw,20,42,3,24,1,2,30,1,103,14.714285714285714,5,0.0,12,3,21,1,30,2,3,30,1,37,66,0
299,4948,D8SfZbudbfX5pEFjOEna12FQCnvrJwde,SpATywNh6bZuzm8s1ceuBUnMUAeoAHHw,3,3,1,0,0,0,3,0,7,1.0,1,0.0,0,1,0,0,3,0,0,3,0,1,6,1
300,4956,w9jybkX7jENxFw2ZN48ruQIJfCGfUCTe,A3fsA9Zfv1X2fVEQhTw51lKENdNrEqT3,56,58,1,226,1,0,4,0,290,41.42857142857143,3,0.0,8,1,183,1,50,0,43,4,0,193,97,1
301,4967,W4dUmcINvn4EmYk22ZRR3EuEX8WaEqL8,A3fsA9Zfv1X2fVEQhTw51lKENdNrEqT3,9,6,4,0,2,0,3,0,15,2.142857142857143,1,0.0,0,4,0,2,6,0,0,3,0,6,9,1
302,4979,dSloiolTuQA1YnIVrIEZb5m23cL24cRw,bWdj2GDclj5ofokWjzoa5jAwMkxCykd6,7,6,2,0,2,0,2,0,12,1.7142857142857142,2,0.0,0,2,0,2,6,0,0,2,0,4,8,1
303,4982,3ZzNkdWgGb47Go07PRKPf0XZ6jjhVCB4,A3fsA9Zfv1X2fVEQhTw51lKENdNrEqT3,31,28,20,30,10,25,15,0,128,18.285714285714285,4,0.0,0,20,24,10,28,25,6,15,0,54,74,0
304,4984,3h1zqwMTeQWdhoWHPgvllPWyD6P0qFtr,SpATywNh6bZuzm8s1ceuBUnMUAeoAHHw,7,13,7,0,4,0,3,0,27,3.857142857142857,4,0.0,1,7,0,4,12,0,0,3,0,12,15,0
305,4989,WxVM9kOqNmenlQy1YKMo3yVYKYKkewCz,A3fsA9Zfv1X2fVEQhTw51lKENdNrEqT3,70,37,25,170,13,22,22,0,289,41.285714285714285,5,0.0,6,25,133,13,31,22,37,22,0,177,112,0
306,5009,lgip049r6Eu24ga2SPdixKHu4ShoVkOP,SpATywNh6bZuzm8s1ceuBUnMUAeoAHHw,27,21,13,23,8,0,7,0,72,10.285714285714286,2,0.0,4,13,21,8,17,0,2,7,0,46,26,0
307,5028,v1AqHfMoNhUox9GyIOrxftKibIp07zrt,RXDvfPUBYFlVdlueBFbLW0mhhAyGEqpt,18,15,13,0,9,0,2,0,39,5.571428571428571,1,0.0,0,13,0,9,15,0,0,2,0,22,17,1
308,5042,QP1Im9jEj4yDlujZ0cdksBwzi1qoq6uz,A3fsA9Zfv1X2fVEQhTw51lKENdNrEqT3,14,11,9,0,8,0,7,1,36,5.142857142857143,2,0.0,0,9,0,8,11,0,0,7,1,17,19,1
309,5058,UJNew1tDOTKAwtlVI7Xin0dzgnQGk4oE,SpATywNh6bZuzm8s1ceuBUnMUAeoAHHw,28,85,32,39,6,16,20,0,198,28.285714285714285,7,0.0,37,32,35,6,48,16,4,20,0,110,88,0
310,5084,kMzMJEHy7fAHiNUZU0um3I2BsPC7gMll,bWdj2GDclj5ofokWjzoa5jAwMkxCykd6,40,99,73,145,52,34,47,2,452,64.57142857142857,12,0.0,11,73,124,52,88,34,21,47,2,260,192,0
311,5092,EiO5bky9R1Iqlpv4ItUpPBUgGb1eJItE,A3fsA9Zfv1X2fVEQhTw51lKENdNrEqT3,32,116,11,20,6,216,79,0,448,64.0,11,0.0,3,11,17,6,113,216,3,79,0,37,411,1
312,5112,eXHbDnPXGOepjGY8R1QdCMeSWp9NDZZc,SpATywNh6bZuzm8s1ceuBUnMUAeoAHHw,27,63,28,19,7,4,5,0,126,18.0,2,0.0,16,28,17,7,47,4,2,5,0,68,58,0
313,5114,3SWDgl41jXPWPBCB5sVpNEwmW9L3MerS,SpATywNh6bZuzm8s1ceuBUnMUAeoAHHw,27,27,15,20,11,0,4,0,77,11.0,4,0.0,5,15,18,11,22,0,2,4,0,49,28,0
314,5136,35QP8hkG1fMgJT5B2mWO7L1K5UDzKccP,SpATywNh6bZuzm8s1ceuBUnMUAeoAHHw,10,14,0,0,0,0,15,1,30,4.285714285714286,3,0.0,4,0,0,0,10,0,0,15,1,4,26,1
315,5148,uN992cfJ2NJqNQmns1XgyEcZyWUiJR0U,SpATywNh6bZuzm8s1ceuBUnMUAeoAHHw,25,63,5,20,1,11,20,2,122,17.428571428571427,5,0.0,21,5,20,1,42,11,0,20,2,47,75,0
316,5163,nOBQYWrG3xrA9IeoO0kkFbpfztBbno3g,A3fsA9Zfv1X2fVEQhTw51lKENdNrEqT3,10,5,3,0,3,0,3,0,14,2.0,1,0.0,0,3,0,3,5,0,0,3,0,6,8,1
317,5168,UWuyaaoLwLnyFDmtW8yT3lff7bHBBBqe,SpATywNh6bZuzm8s1ceuBUnMUAeoAHHw,25,77,7,36,6,6,24,6,162,23.142857142857142,8,0.0,12,7,33,6,65,6,3,24,6,58,104,0
318,5205,VhlYBZ7MZgP2ChzlwqizJv2MimYYdGta,SpATywNh6bZuzm8s1ceuBUnMUAeoAHHw,24,28,16,15,9,0,10,4,82,11.714285714285714,3,0.0,2,16,15,9,26,0,0,10,4,42,40,1
319,5245,17IsanlXziT2tczTSDkapcsRHmSWuCWH,SpATywNh6bZuzm8s1ceuBUnMUAeoAHHw,11,37,6,0,8,0,9,0,60,8.571428571428571,4,0.0,10,6,0,8,27,0,0,9,0,24,36,0
320,5249,TCQ7j55cp3iQY2crxSrod75YneerL94o,SpATywNh6bZuzm8s1ceuBUnMUAeoAHHw,29,35,16,29,7,4,13,0,104,14.857142857142858,5,0.0,12,16,27,7,23,4,2,13,0,62,42,1
321,5255,0NbLYZNvmNdh82upKkBVVwJoa5b6RKVj,SpATywNh6bZuzm8s1ceuBUnMUAeoAHHw,17,20,9,18,4,17,13,6,87,12.428571428571429,2,0.0,2,9,15,4,18,17,3,13,6,30,57,0
322,5280,nsvq9MYt4IahoN4kXXFtAP2mFM9VmORm,SpATywNh6bZuzm8s1ceuBUnMUAeoAHHw,16,19,9,18,5,20,7,0,78,11.142857142857142,1,0.0,6,9,16,5,13,20,2,7,0,36,42,1
323,5284,QqE2Xjwy9gUzOvFdkDqAwAaNZLBZkxvd,RXDvfPUBYFlVdlueBFbLW0mhhAyGEqpt,54,279,16,89,10,155,81,1,631,90.14285714285714,14,0.0,19,16,83,10,260,155,6,81,1,128,503,0
324,5290,4xEpIgR9alQqM4xeSug69KmBmO9gpD69,A3fsA9Zfv1X2fVEQhTw51lKENdNrEqT3,51,112,62,42,35,70,53,5,379,54.142857142857146,7,0.0,7,62,41,35,105,70,1,53,5,145,234,0
325,5311,SFbTZDEo0JTOG7VHfxeJz2kz3qSzlHq4,SpATywNh6bZuzm8s1ceuBUnMUAeoAHHw,19,39,2,40,0,0,6,0,87,12.428571428571429,3,0.0,18,2,35,0,21,0,5,6,0,55,32,0
326,5316,0tT4cQq52T8bu4irQ9KewNXtlD33hVZo,SpATywNh6bZuzm8s1ceuBUnMUAeoAHHw,17,30,17,15,5,4,16,1,88,12.571428571428571,5,0.0,2,17,14,5,28,4,1,16,1,38,50,0
327,5337,a6f3gPi6axX0cfBnUGVliBDQrPx92l1r,bWdj2GDclj5ofokWjzoa5jAwMkxCykd6,39,174,72,165,54,42,26,2,535,76.42857142857143,9,0.0,63,72,141,54,111,42,24,26,2,330,205,1
328,5368,dXV6CXhMuL2MovsaBcVnWuwVAfDnBy3D,A3fsA9Zfv1X2fVEQhTw51lKENdNrEqT3,10,8,0,0,0,0,6,0,14,2.0,2,0.0,0,0,0,0,8,0,0,6,0,0,14,1
329,5369,AcgDUm5SSEb0zgM8tYKiOFvTewc0KRAc,SpATywNh6bZuzm8s1ceuBUnMUAeoAHHw,18,17,10,8,5,0,7,0,47,6.714285714285714,3,0.0,5,10,8,5,12,0,0,7,0,28,19,0
330,5416,nds56JS5tgInTRshD1ZJkwXi4oW5Ln7a,RXDvfPUBYFlVdlueBFbLW0mhhAyGEqpt,66,102,59,143,24,67,35,1,431,61.57142857142857,9,0.0,13,59,126,24,89,67,17,35,1,222,209,0
331,5431,VnkZQ14wQqfipOllRb5zJLKqrvJ7kfcr,A3fsA9Zfv1X2fVEQhTw51lKENdNrEqT3,1,0,0,0,0,0,2,0,2,0.2857142857142857,2,0.0,0,0,0,0,0,0,0,2,0,0,2,1
332,5435,90Sn7UxaiRTmCSrIbSNevcUMokJI9XYS,A3fsA9Zfv1X2fVEQhTw51lKENdNrEqT3,11,14,1,0,1,0,3,0,19,2.7142857142857144,2,0.0,0,1,0,1,14,0,0,3,0,2,17,1
333,5439,vUerya30clLdh9EQX34ayPT3Cr8C7lb8,A3fsA9Zfv1X2fVEQhTw51lKENdNrEqT3,6,7,0,0,0,0,3,0,10,1.4285714285714286,1,0.0,0,0,0,0,7,0,0,3,0,0,10,1
334,5470,acVvGaaH1iVFQOYF94V9THpGPkF7EIj3,SpATywNh6bZuzm8s1ceuBUnMUAeoAHHw,17,37,19,22,10,10,21,3,122,17.428571428571427,3,0.0,11,19,19,10,26,10,3,21,3,59,63,0
335,5471,ZWj0iRzT4HOMV032BfEyYj9IEk1Rdo03,SpATywNh6bZuzm8s1ceuBUnMUAeoAHHw,25,104,1,41,0,64,18,3,231,33.0,2,0.0,48,1,34,0,56,64,7,18,3,83,148,0
336,5482,lfAQ0nsHdkBDoIcTW4jXyPy4wOsVYtMB,RXDvfPUBYFlVdlueBFbLW0mhhAyGEqpt,27,24,13,22,6,2,21,4,92,13.142857142857142,3,0.0,6,13,20,6,18,2,2,21,4,45,47,1
337,5484,DjQWiwlbqq88H7QziTtErXo3yBTqRc6U,A3fsA9Zfv1X2fVEQhTw51lKENdNrEqT3,9,10,4,0,0,1,7,1,23,3.2857142857142856,6,0.0,0,4,0,0,10,1,0,7,1,4,19,1
338,5495,xsW19PmjvHmfOgtSCjdxnkpzOWqbKfLn,SpATywNh6bZuzm8s1ceuBUnMUAeoAHHw,32,87,36,27,12,31,35,3,231,33.0,7,0.0,38,36,25,12,49,31,2,35,3,111,120,0
339,5519,BsWy5ImeTPQvYgOCRPYHOm3gBOyZfxYj,SpATywNh6bZuzm8s1ceuBUnMUAeoAHHw,8,9,5,0,4,0,3,0,21,3.0,2,0.0,0,5,0,4,9,0,0,3,0,9,12,0
340,5523,njb10SfHXKB30cApzPJzWBcqA8VQx0HA,SpATywNh6bZuzm8s1ceuBUnMUAeoAHHw,2,0,0,0,0,0,2,0,2,0.2857142857142857,1,0.0,0,0,0,0,0,0,0,2,0,0,2,1
341,5546,sc5S8mzwcw7LbcetViv5Dahuhyet4uF1,SpATywNh6bZuzm8s1ceuBUnMUAeoAHHw,5,6,1,0,0,0,6,0,13,1.8571428571428572,2,0.0,0,1,0,0,6,0,0,6,0,1,12,0
342,5584,Qt99KRFUK6FY5ovJvB9yRLziSf5bEirX,SpATywNh6bZuzm8s1ceuBUnMUAeoAHHw,9,7,3,0,1,0,7,1,19,2.7142857142857144,1,0.0,0,3,0,1,7,0,0,7,1,4,15,1
343,5621,3rCZba8eKP7jaFsDjNb32WoGn9BjnrjN,A3fsA9Zfv1X2fVEQhTw51lKENdNrEqT3,38,44,21,86,13,35,11,0,210,30.0,4,0.0,7,21,68,13,37,35,18,11,0,109,101,1
344,5642,IAvuP4GGmvnNj3Zisz3jDfo3mSmXiJSb,A3fsA9Zfv1X2fVEQhTw51lKENdNrEqT3,30,77,2,56,1,0,9,0,145,20.714285714285715,5,0.0,0,2,44,1,77,0,12,9,0,47,98,1
345,5644,J388HMX5pYHjqXdA7jEUkFec6orRQtIq,A3fsA9Zfv1X2fVEQhTw51lKENdNrEqT3,26,40,21,0,6,0,15,0,82,11.714285714285714,3,0.0,0,21,0,6,40,0,0,15,0,27,55,0
346,5655,PztWYF4ZTLP8rvUvCUcN3hQiYuYJPY9t,bWdj2GDclj5ofokWjzoa5jAwMkxCykd6,7,12,4,0,1,0,5,0,22,3.142857142857143,2,0.0,0,4,0,1,12,0,0,5,0,5,17,1
347,5660,CZZkgDgsqVR6ftNFrTmx0jPpBHh2f3Zo,SpATywNh6bZuzm8s1ceuBUnMUAeoAHHw,26,135,8,33,3,97,50,2,328,46.857142857142854,10,0.0,31,8,32,3,104,97,1,50,2,74,254,0
348,5663,1QA0SqfAW0hFBv6FjoAHgHRHfBlvLSPL,A3fsA9Zfv1X2fVEQhTw51lKENdNrEqT3,4,2,0,0,0,0,3,0,5,0.7142857142857143,2,0.0,0,0,0,0,2,0,0,3,0,0,5,1
349,5671,HbDaABEakQmE8DQEoFoIphu2SH13rFRy,A3fsA9Zfv1X2fVEQhTw51lKENdNrEqT3,41,21,16,78,12,0,4,0,131,18.714285714285715,4,0.0,1,16,67,12,20,0,11,4,0,96,35,1
350,5672,HbDaABEakQmE8DQEoFoIphu2SH13rFRy,bWdj2GDclj5ofokWjzoa5jAwMkxCykd6,4,2,1,0,1,0,2,0,6,0.8571428571428571,2,0.0,0,1,0,1,2,0,0,2,0,2,4,1
351,5675,HbDaABEakQmE8DQEoFoIphu2SH13rFRy,RXDvfPUBYFlVdlueBFbLW0mhhAyGEqpt,1,0,0,0,0,0,1,0,1,0.14285714285714285,1,0.0,0,0,0,0,0,0,0,1,0,0,1,1
352,5702,C6xrhZPOmVH2gCVNP26gSSPka2CcwgB5,bWdj2GDclj5ofokWjzoa5jAwMkxCykd6,17,17,11,62,9,13,9,0,121,17.285714285714285,2,0.0,6,11,59,9,11,13,3,9,0,85,36,1
353,5705,TwYAYdYU7yn5FjnP72W4DEwE8N7Dqkqq,bWdj2GDclj5ofokWjzoa5jAwMkxCykd6,5,4,0,0,0,1,3,0,8,1.1428571428571428,1,0.0,0,0,0,0,4,1,0,3,0,0,8,1
354,5740,PizUKf6mRUas66X3VMYXf9aygnN1CUCf,SpATywNh6bZuzm8s1ceuBUnMUAeoAHHw,15,31,12,24,11,18,5,5,106,15.142857142857142,1,0.0,18,12,20,11,13,18,4,5,5,61,45,1
355,5743,57qzgJAwfROYPxzSOrsA3G5DLHP95ajU,RXDvfPUBYFlVdlueBFbLW0mhhAyGEqpt,36,38,31,0,19,0,8,0,96,13.714285714285714,2,0.0,2,31,0,19,36,0,0,8,0,52,44,0
356,5746,seRgjh60dHSex83x3yaP07EkHkNZ3zq1,SpATywNh6bZuzm8s1ceuBUnMUAeoAHHw,17,31,15,22,5,11,9,1,94,13.428571428571429,4,0.0,11,15,19,5,20,11,3,9,1,50,44,0
357,5781,D2S5bjWjmtwLivqx7n7FZWso5Kd6We5x,bWdj2GDclj5ofokWjzoa5jAwMkxCykd6,26,48,9,83,2,1,10,0,153,21.857142857142858,4,0.0,14,9,74,2,34,1,9,10,0,99,54,0
358,5785,Llzpy0Dk1LPSE6nBLZ8vNVNgQXCzGpc1,SpATywNh6bZuzm8s1ceuBUnMUAeoAHHw,31,52,31,26,17,0,18,2,146,20.857142857142858,6,0.0,6,31,22,17,46,0,4,18,2,76,70,1
359,5788,zysr84QD6b78mLaezXoryEdhH6kH14EQ,SpATywNh6bZuzm8s1ceuBUnMUAeoAHHw,14,17,10,11,6,0,4,0,48,6.857142857142857,3,0.0,4,10,9,6,13,0,2,4,0,29,19,0
360,5792,GIb3glgYrsEfHWtEWPWpwONqwE7RMf6f,bWdj2GDclj5ofokWjzoa5jAwMkxCykd6,39,114,54,112,10,74,57,4,425,60.714285714285715,11,0.0,12,54,103,10,102,74,9,57,4,179,246,0
361,5802,8tzllCaQFf5FO2XcYgqoYiMGBjUwujYx,A3fsA9Zfv1X2fVEQhTw51lKENdNrEqT3,5,3,0,0,0,0,4,0,7,1.0,1,0.0,0,0,0,0,3,0,0,4,0,0,7,1
362,5803,sD3rDh1CtXsAdfDDyFRBf917K7ELQzHQ,SpATywNh6bZuzm8s1ceuBUnMUAeoAHHw,6,12,1,0,0,0,8,0,21,3.0,3,0.0,2,1,0,0,10,0,0,8,0,3,18,0
363,5805,VUYRWxIK25dyFla7xdkPw6qN6gZPPejU,SpATywNh6bZuzm8s1ceuBUnMUAeoAHHw,11,20,10,0,3,0,12,0,45,6.428571428571429,2,0.0,2,10,0,3,18,0,0,12,0,15,30,0
364,5822,yXIAbgjR7S4042oicRyG8kfTX0pG8yI5,SpATywNh6bZuzm8s1ceuBUnMUAeoAHHw,6,8,0,0,0,0,2,0,10,1.4285714285714286,1,0.0,2,0,0,0,6,0,0,2,0,2,8,0
365,5826,zTf8XOQnwWWl1KDwh9NJmoY9QiDPt6oU,SpATywNh6bZuzm8s1ceuBUnMUAeoAHHw,29,66,40,32,14,0,19,1,172,24.571428571428573,9,0.0,15,40,31,14,51,0,1,19,1,100,72,0
366,5827,IXG6Mrr8VTjEEQIqeVi1KlyYwZ2T4ziy,A3fsA9Zfv1X2fVEQhTw51lKENdNrEqT3,4,2,1,0,1,0,1,0,5,0.7142857142857143,1,0.0,0,1,0,1,2,0,0,1,0,2,3,0
367,5865,Ojf2FGMPjkgcQ8cOS7KSlXqYowZOsPoh,A3fsA9Zfv1X2fVEQhTw51lKENdNrEqT3,8,7,3,0,2,2,3,0,17,2.4285714285714284,2,0.0,0,3,0,2,7,2,0,3,0,5,12,0
368,5890,8c2gk77rfHeG4kEZpifVHT547X2ayTNE,RXDvfPUBYFlVdlueBFbLW0mhhAyGEqpt,48,79,48,101,21,28,28,1,306,43.714285714285715,6,0.0,18,48,98,21,61,28,3,28,1,185,121,0
369,5892,1YxknoiTrSwQgclDlSAh4oMYHRyARhLv,SpATywNh6bZuzm8s1ceuBUnMUAeoAHHw,9,13,3,4,0,0,6,0,26,3.7142857142857144,4,0.0,5,3,4,0,8,0,0,6,0,12,14,0
370,5902,7o8xhk1rh0BQyK6zL1slDKappRA3D8Mk,SpATywNh6bZuzm8s1ceuBUnMUAeoAHHw,11,10,6,0,4,1,6,1,28,4.0,1,0.0,2,6,0,4,8,1,0,6,1,12,16,0
371,5927,vYyC3PI9WOfKd54xBrxSVvrhn62CQxzz,SpATywNh6bZuzm8s1ceuBUnMUAeoAHHw,17,17,11,6,5,0,3,0,42,6.0,3,0.0,2,11,6,5,15,0,0,3,0,24,18,1
372,5934,hdKqkkWKrDzbKE9btGChBqiCfsTwp68E,A3fsA9Zfv1X2fVEQhTw51lKENdNrEqT3,33,23,13,28,9,33,30,2,138,19.714285714285715,8,0.0,2,13,23,9,21,33,5,30,2,47,91,0
373,6018,cJcuhtji0eqLhfXtnFSDlw6v5huTlvOS,SpATywNh6bZuzm8s1ceuBUnMUAeoAHHw,25,37,1,28,1,5,8,1,81,11.571428571428571,4,0.0,13,1,22,1,24,5,6,8,1,37,44,0
374,6031,H2B0ZVh2RYo5LjimmBQ15UDjcAOL7h2y,A3fsA9Zfv1X2fVEQhTw51lKENdNrEqT3,7,1,1,0,1,0,6,1,10,1.4285714285714286,1,0.0,0,1,0,1,1,0,0,6,1,2,8,1
375,6048,hf7YI3B1kTTuvmd2vS9DIoiPGXbrQyBH,SpATywNh6bZuzm8s1ceuBUnMUAeoAHHw,26,47,4,18,4,59,21,0,153,21.857142857142858,5,0.0,17,4,15,4,30,59,3,21,0,40,113,0
376,6058,KrIVcXIiCdwRGUI4WguKXHPsvZChbtIb,A3fsA9Zfv1X2fVEQhTw51lKENdNrEqT3,62,48,33,154,18,97,18,0,368,52.57142857142857,7,0.0,2,33,118,18,46,97,36,18,0,171,197,0
377,6059,RDBly29xbybxfRPXjsOP81xd2Sgww6yI,bWdj2GDclj5ofokWjzoa5jAwMkxCykd6,6,5,2,0,2,0,6,0,15,2.142857142857143,2,0.0,0,2,0,2,5,0,0,6,0,4,11,1
378,6069,imazrFpyX68kLUAydat119Z5XKshja9y,SpATywNh6bZuzm8s1ceuBUnMUAeoAHHw,24,28,18,26,6,0,7,0,85,12.142857142857142,5,0.0,4,18,25,6,24,0,1,7,0,53,32,0
379,6084,egIcBO9xXh5XDAWBOR2C58eTHcHVaPTq,SpATywNh6bZuzm8s1ceuBUnMUAeoAHHw,4,2,1,0,0,31,4,0,38,5.428571428571429,3,0.0,0,1,0,0,2,31,0,4,0,1,37,1
380,6086,ZL7VsgZBlKFfi6BGNSyN1gGJros1L9ra,SpATywNh6bZuzm8s1ceuBUnMUAeoAHHw,18,42,13,11,3,40,22,1,132,18.857142857142858,3,0.0,14,13,10,3,28,40,1,22,1,40,92,1
381,6087,uUWoPLkJSFKbD6KppcebOwMXezopCcLj,SpATywNh6bZuzm8s1ceuBUnMUAeoAHHw,24,174,24,40,8,25,38,1,310,44.285714285714285,6,0.0,53,24,33,8,121,25,7,38,1,118,192,0
382,6090,Qsrx4kwwBFByqyYPAbCeTAurBzPDhOG4,SpATywNh6bZuzm8s1ceuBUnMUAeoAHHw,4,2,1,0,1,0,1,0,5,0.7142857142857143,1,0.0,0,1,0,1,2,0,0,1,0,2,3,1
383,6136,sF8Qur7NIXPGJG744QNBCJLJgM51K1cT,SpATywNh6bZuzm8s1ceuBUnMUAeoAHHw,9,10,4,0,2,1,4,0,21,3.0,1,0.0,3,4,0,2,7,1,0,4,0,9,12,1
384,6197,6A2JLpLWnCwUlo9pD1HHlgEwNLvzcllv,SpATywNh6bZuzm8s1ceuBUnMUAeoAHHw,14,14,8,12,5,0,2,0,41,5.857142857142857,3,0.0,4,8,9,5,10,0,3,2,0,26,15,1
385,6203,qwOn6svjZUr6PbEPbdgCynJcocJs2Tff,SpATywNh6bZuzm8s1ceuBUnMUAeoAHHw,32,43,24,18,12,19,18,1,135,19.285714285714285,4,0.0,9,24,18,12,34,19,0,18,1,63,72,0
386,6215,FgYPvBwLri7YiFI9og6clP9FuKJ08jX7,SpATywNh6bZuzm8s1ceuBUnMUAeoAHHw,14,28,12,14,5,1,4,0,64,9.142857142857142,3,0.0,9,12,13,5,19,1,1,4,0,39,25,1
387,6217,xVu6NAX59MOmpApYDfs9WPe7YPPVhsFD,A3fsA9Zfv1X2fVEQhTw51lKENdNrEqT3,44,35,8,62,7,5,11,1,129,18.428571428571427,3,0.0,1,8,53,7,34,5,9,11,1,69,60,1
388,6222,2CJPniJdzPQB2xVD7usFld4N6998DubA,SpATywNh6bZuzm8s1ceuBUnMUAeoAHHw,30,57,27,34,11,33,27,2,191,27.285714285714285,7,0.0,21,27,27,11,36,33,7,27,2,86,105,0
389,6235,ywdL3xkp7d2PSjbvnflAvIe7Wp6Q4SRe,A3fsA9Zfv1X2fVEQhTw51lKENdNrEqT3,65,36,15,170,9,0,15,0,245,35.0,6,0.0,2,15,151,9,34,0,19,15,0,177,68,0
390,6241,JOowoFboUWVsMh86KvKaqn28cyqJccLu,SpATywNh6bZuzm8s1ceuBUnMUAeoAHHw,22,58,5,37,1,32,17,1,151,21.571428571428573,8,0.0,27,5,32,1,31,32,5,17,1,65,86,1
391,6251,xHZbSROhwP4RRQerUVWvcNTfOGc2DHWf,A3fsA9Zfv1X2fVEQhTw51lKENdNrEqT3,64,74,24,195,8,49,31,0,381,54.42857142857143,9,0.0,6,24,150,8,68,49,45,31,0,188,193,0
392,6276,e05jFgKTpMKrOATktordZrOlXAadcmLm,bWdj2GDclj5ofokWjzoa5jAwMkxCykd6,4,2,1,0,1,0,1,0,5,0.7142857142857143,1,0.0,0,1,0,1,2,0,0,1,0,2,3,1
393,6297,IBlNXwDR3MmRt5PBvnP44ynAugPBAbiq,A3fsA9Zfv1X2fVEQhTw51lKENdNrEqT3,8,12,5,0,0,0,5,0,22,3.142857142857143,4,0.0,0,5,0,0,12,0,0,5,0,5,17,1
394,6301,4NUGABfnQkRS9FoH90Vgnhdha4tRSmOB,A3fsA9Zfv1X2fVEQhTw51lKENdNrEqT3,50,56,35,58,17,0,16,0,182,26.0,9,0.0,5,35,47,17,51,0,11,16,0,104,78,0
395,6310,K0OSl2yDmHYQ9TtZdxy9shErNwx3ga0n,SpATywNh6bZuzm8s1ceuBUnMUAeoAHHw,5,5,2,0,1,0,1,0,9,1.2857142857142858,1,0.0,2,2,0,1,3,0,0,1,0,5,4,1
396,6322,2IvFgMw0NfaiiFt35dmyYrQHt1TRMHZA,SpATywNh6bZuzm8s1ceuBUnMUAeoAHHw,31,77,29,28,11,93,78,7,323,46.142857142857146,5,0.0,26,29,26,11,51,93,2,78,7,92,231,0
397,6333,VRqncpDBm1hyq75gsrR3U5uyrx0nFI6D,G8EPVSXsOYB5YQWZGiz1aVq5Pgr2GrQu,8,10,6,0,3,0,3,0,22,3.142857142857143,1,0.0,0,6,0,3,10,0,0,3,0,9,13,0
398,6360,S6vBzHKpSh31SFGGZmwgKaOH2RvW3RpH,A3fsA9Zfv1X2fVEQhTw51lKENdNrEqT3,10,10,8,0,7,0,3,0,28,4.0,3,0.0,0,8,0,7,10,0,0,3,0,15,13,0
399,6361,8nT76hrzyl8ZAUdI7W6kfrIzHxI3puKM,A3fsA9Zfv1X2fVEQhTw51lKENdNrEqT3,57,49,0,132,0,0,16,0,197,28.142857142857142,6,0.0,2,0,130,0,47,0,2,16,0,132,65,0
400,6386,sgU8bYbkNg27HLTOfRzwWIg1HmjCd9Xd,SpATywNh6bZuzm8s1ceuBUnMUAeoAHHw,25,41,1,41,1,2,18,3,107,15.285714285714286,4,0.0,14,1,35,1,27,2,6,18,3,51,56,0
401,6391,VWT0erf4AD2BzAGMlVwaBcrhUFyVXGW3,SpATywNh6bZuzm8s1ceuBUnMUAeoAHHw,24,54,2,28,0,48,23,4,159,22.714285714285715,5,0.0,21,2,26,0,33,48,2,23,4,49,110,0
402,6396,mXsmDArxUTe9rMFHp3cGPJEx5ACYKD90,SpATywNh6bZuzm8s1ceuBUnMUAeoAHHw,28,61,26,35,9,21,7,0,159,22.714285714285715,4,0.0,26,26,30,9,35,21,5,7,0,91,68,0
403,6407,y7mamutAMELy79Bgdj0zOeVjiQ071oNX,SpATywNh6bZuzm8s1ceuBUnMUAeoAHHw,26,53,16,23,8,0,7,0,107,15.285714285714286,4,0.0,23,16,20,8,30,0,3,7,0,67,40,0
404,6427,vuqnfFRpmwKE9RdxK6XJMNF9m6H6VyTM,RXDvfPUBYFlVdlueBFbLW0mhhAyGEqpt,74,116,75,177,33,49,27,12,489,69.85714285714286,7,0.0,25,75,159,33,91,49,18,27,12,292,197,0
405,6453,thQSVbeIiNRLplpbUVbYa004tKe0jz1z,SpATywNh6bZuzm8s1ceuBUnMUAeoAHHw,12,22,3,14,0,0,7,0,46,6.571428571428571,3,0.0,2,3,12,0,20,0,2,7,0,17,29,1
406,6473,QYNtwRXZGk0TiZU9fvvZmyYTg9wzmVe8,bWdj2GDclj5ofokWjzoa5jAwMkxCykd6,38,120,11,141,5,259,106,4,646,92.28571428571429,12,0.0,21,11,120,5,99,259,21,106,4,157,489,0
407,6475,4NUGABfnQkRS9FoH90Vgnhdha4tRSmOB,SpATywNh6bZuzm8s1ceuBUnMUAeoAHHw,18,44,18,12,3,7,32,1,117,16.714285714285715,9,0.0,12,18,9,3,32,7,3,32,1,42,75,0
408,6476,5l7JbkjmfBonHdF7CbCa3GMejToAwTQZ,SpATywNh6bZuzm8s1ceuBUnMUAeoAHHw,20,39,6,24,0,8,22,2,101,14.428571428571429,4,0.0,15,6,21,0,24,8,3,22,2,42,59,1
409,6480,fFnDSL1hWADv25SE5UTFI35tGRTcYBEF,SpATywNh6bZuzm8s1ceuBUnMUAeoAHHw,7,4,1,0,1,0,2,0,8,1.1428571428571428,1,0.0,0,1,0,1,4,0,0,2,0,2,6,0
410,6490,CozZoSX7AwprtwyJFCAeFUYiCq7OSEAP,G8EPVSXsOYB5YQWZGiz1aVq5Pgr2GrQu,3,3,0,0,0,0,1,0,4,0.5714285714285714,1,0.0,0,0,0,0,3,0,0,1,0,0,4,0
411,6494,w1o1S1rsKOagmFCmrSXvpPsO3fHW3lAq,A3fsA9Zfv1X2fVEQhTw51lKENdNrEqT3,57,41,27,108,14,16,22,4,232,33.142857142857146,4,0.0,4,27,86,14,37,16,22,22,4,131,101,1
412,6497,QYNtwRXZGk0TiZU9fvvZmyYTg9wzmVe8,A3fsA9Zfv1X2fVEQhTw51lKENdNrEqT3,62,131,3,172,2,426,124,3,861,123.0,12,0.0,9,3,136,2,122,426,36,124,3,150,711,0
413,6502,MFUbiMqXEmfaBzK7hirtX5aBXDvqfQ39,RXDvfPUBYFlVdlueBFbLW0mhhAyGEqpt,15,20,13,0,5,2,10,1,51,7.285714285714286,3,0.0,2,13,0,5,18,2,0,10,1,20,31,0
414,6527,iYw8kPkvjn3xb3wtZEyAytTepRhqUlKj,SpATywNh6bZuzm8s1ceuBUnMUAeoAHHw,28,55,24,28,10,4,17,1,139,19.857142857142858,5,0.0,6,24,26,10,49,4,2,17,1,66,73,0
415,6542,wSw0H7eAN6dfAeYMaWU4nG5bgtRJyFlj,SpATywNh6bZuzm8s1ceuBUnMUAeoAHHw,18,59,0,10,0,20,11,1,101,14.428571428571429,7,0.0,5,0,9,0,54,20,1,11,1,14,87,0
416,6547,6U06x0rZdU2wXE04MeChX934BjpYCGYO,A3fsA9Zfv1X2fVEQhTw51lKENdNrEqT3,64,45,25,108,8,30,14,2,232,33.142857142857146,4,0.0,7,25,97,8,38,30,11,14,2,137,95,0
417,6551,uiGGvm5bzelA6YjURZYgSYljUTVOBIB1,A3fsA9Zfv1X2fVEQhTw51lKENdNrEqT3,2,0,0,0,0,0,3,0,3,0.42857142857142855,2,0.0,0,0,0,0,0,0,0,3,0,0,3,1
418,6556,xeRiyg2Y5ZgvqPGiWyjXk0hLMBeGkeoJ,RXDvfPUBYFlVdlueBFbLW0mhhAyGEqpt,10,13,8,0,5,0,4,0,30,4.285714285714286,4,0.0,2,8,0,5,11,0,0,4,0,15,15,0
419,6562,KnR9Rn7adHv02cUeYZsmQrRux2GhqbgV,SpATywNh6bZuzm8s1ceuBUnMUAeoAHHw,17,11,9,0,7,0,2,0,29,4.142857142857143,2,0.0,0,9,0,7,11,0,0,2,0,16,13,1
420,6563,5zX31TZPkBQ4nxGKP7lPYFABTGNW6PHa,A3fsA9Zfv1X2fVEQhTw51lKENdNrEqT3,51,51,23,122,9,57,25,1,288,41.142857142857146,8,0.0,4,23,95,9,47,57,27,25,1,131,157,1
421,6576,X1EwqmDy4MdORdVb79oGgVGVtNlVZgX3,A3fsA9Zfv1X2fVEQhTw51lKENdNrEqT3,8,1,1,0,0,1,14,2,19,2.7142857142857144,2,0.0,0,1,0,0,1,1,0,14,2,1,18,1
422,6579,FxyjnTbjAUnINdJgNqjfUflUXLEYBAKC,SpATywNh6bZuzm8s1ceuBUnMUAeoAHHw,24,71,7,12,2,6,9,0,107,15.285714285714286,5,0.0,33,7,12,2,38,6,0,9,0,54,53,0
423,6606,vqNQHlaqBAqN0Ghl4wYJYkeoe3u1AJkM,SpATywNh6bZuzm8s1ceuBUnMUAeoAHHw,4,2,1,0,1,0,5,0,9,1.2857142857142858,1,0.0,0,1,0,1,2,0,0,5,0,2,7,1
424,6619,TgtZeZ58ebuFniTgQX061K6ibFhvtBpU,SpATywNh6bZuzm8s1ceuBUnMUAeoAHHw,31,66,31,34,12,3,16,3,165,23.571428571428573,8,0.0,8,31,31,12,58,3,3,16,3,82,83,0
425,6633,hu8eak1Xmf8voE8pnxPzkSD2dZP9Sipf,SpATywNh6bZuzm8s1ceuBUnMUAeoAHHw,12,11,1,6,1,2,12,0,33,4.714285714285714,2,0.0,5,1,6,1,6,2,0,12,0,13,20,0
426,6635,xKsPjk1jm2BE3h1iJlr6XUhvP4lcDdRk,RXDvfPUBYFlVdlueBFbLW0mhhAyGEqpt,71,94,57,177,34,14,18,2,396,56.57142857142857,7,0.0,23,57,163,34,71,14,14,18,2,277,119,0
427,6645,jzhfcjSJMALhuWl4kOoGHRTc9xbTfPXO,SpATywNh6bZuzm8s1ceuBUnMUAeoAHHw,10,15,0,0,0,0,2,0,17,2.4285714285714284,2,0.0,0,0,0,0,15,0,0,2,0,0,17,0
428,6646,JV1BgG1khCT6s4RU5oY7ZOSmwW31Qjbp,SpATywNh6bZuzm8s1ceuBUnMUAeoAHHw,29,51,26,30,9,22,22,3,163,23.285714285714285,7,0.0,5,26,24,9,46,22,6,22,3,64,99,0
429,6651,imazrFpyX68kLUAydat119Z5XKshja9y,G8EPVSXsOYB5YQWZGiz1aVq5Pgr2GrQu,23,33,27,50,13,0,5,0,128,18.285714285714285,4,0.0,0,27,45,13,33,0,5,5,0,85,43,1
430,6654,WIULTFMTHtU9DH0SABu7cidImBPYBDLB,SpATywNh6bZuzm8s1ceuBUnMUAeoAHHw,28,36,6,28,5,0,14,1,90,12.857142857142858,2,0.0,5,6,26,5,31,0,2,14,1,42,48,1
431,6664,7nQB7cjVdr2HijR82OoX1oMRPa42JjfY,bWdj2GDclj5ofokWjzoa5jAwMkxCykd6,38,60,37,94,16,39,24,0,270,38.57142857142857,5,0.0,10,37,84,16,50,39,10,24,0,147,123,0
432,6666,MFUbiMqXEmfaBzK7hirtX5aBXDvqfQ39,A3fsA9Zfv1X2fVEQhTw51lKENdNrEqT3,11,6,5,0,5,0,2,0,18,2.5714285714285716,2,0.0,0,5,0,5,6,0,0,2,0,10,8,1
433,6682,hl9NS7ZQVsxPwew9lFoMcbw555xXfA7K,SpATywNh6bZuzm8s1ceuBUnMUAeoAHHw,18,21,10,14,5,0,6,0,56,8.0,3,0.0,7,10,11,5,14,0,3,6,0,33,23,1
434,6712,7FUJzRatex45Tiw3cL91Uz5fZD5gpQMy,A3fsA9Zfv1X2fVEQhTw51lKENdNrEqT3,2,0,0,0,0,0,3,0,3,0.42857142857142855,1,0.0,0,0,0,0,0,0,0,3,0,0,3,1
435,6721,5EbadEY64E8d6mWCOGPXe4HNciATivZW,SpATywNh6bZuzm8s1ceuBUnMUAeoAHHw,28,75,30,16,11,10,14,1,157,22.428571428571427,3,0.0,36,30,16,11,39,10,0,14,1,93,64,0
436,6722,r5hJNp3FkX6JOBVI5bSeTBPneDl7PaKl,A3fsA9Zfv1X2fVEQhTw51lKENdNrEqT3,12,11,1,0,1,4,28,3,48,6.857142857142857,4,0.0,0,1,0,1,11,4,0,28,3,2,46,1
437,6723,e12uQn96OlYfknMdqSXCXdImglIj4IRR,A3fsA9Zfv1X2fVEQhTw51lKENdNrEqT3,33,118,67,0,17,325,130,10,667,95.28571428571429,13,0.0,12,67,0,17,106,325,0,130,10,96,571,0
438,6725,2LSIOP9EwUlEUMR84kNdXwxCTBof59AV,SpATywNh6bZuzm8s1ceuBUnMUAeoAHHw,27,28,15,20,8,1,15,1,88,12.571428571428571,5,0.0,2,15,16,8,26,1,4,15,1,41,47,0
439,6734,XxYK4zbyqtm9UELp1oR6gZVKRAER78zL,A3fsA9Zfv1X2fVEQhTw51lKENdNrEqT3,20,18,13,0,9,29,18,1,88,12.571428571428571,3,0.0,0,13,0,9,18,29,0,18,1,22,66,1
440,6739,D5mwgoAPtfwdsFrdNADBqEJQSy8E0CUi,SpATywNh6bZuzm8s1ceuBUnMUAeoAHHw,30,65,41,16,11,12,31,2,178,25.428571428571427,8,0.0,10,41,16,11,55,12,0,31,2,78,100,0
441,6740,YkHlvsvfON124uz3tNHCqQavCTgfzIIn,SpATywNh6bZuzm8s1ceuBUnMUAeoAHHw,16,16,6,13,3,0,7,2,47,6.714285714285714,1,0.0,5,6,11,3,11,0,2,7,2,25,22,1
442,6741,uOAgQLQslSL4cABC9ZqhaeK1XrisqlGh,SpATywNh6bZuzm8s1ceuBUnMUAeoAHHw,19,21,9,14,6,0,6,0,56,8.0,2,0.0,9,9,11,6,12,0,3,6,0,35,21,0
443,6761,DTS3O3ZujmzMefQXzAvfnTTqItcbsW8A,SpATywNh6bZuzm8s1ceuBUnMUAeoAHHw,23,43,4,28,0,38,12,2,127,18.142857142857142,3,0.0,13,4,24,0,30,38,4,12,2,41,86,0
444,6778,lVgq3gYt1tDiZq5EPAUcQ3qHGrMei1Rm,SpATywNh6bZuzm8s1ceuBUnMUAeoAHHw,32,48,31,36,12,27,39,14,207,29.571428571428573,4,0.0,10,31,30,12,38,27,6,39,14,83,124,0
445,6781,eWIsTbhL2p3ztTyrIxD7wf9RK1qPkZuf,SpATywNh6bZuzm8s1ceuBUnMUAeoAHHw,19,22,17,6,0,21,9,2,77,11.0,3,0.0,0,17,6,0,22,21,0,9,2,23,54,0
446,6783,hjSv3nB1dzB315OJ0MdIWlJoWmd5FDgm,bWdj2GDclj5ofokWjzoa5jAwMkxCykd6,9,21,6,60,5,4,10,0,106,15.142857142857142,1,0.0,11,6,58,5,10,4,2,10,0,80,26,1
447,6785,ptoBkN66Bt2QtZB1aEXx1ZVYWGKSe4nx,SpATywNh6bZuzm8s1ceuBUnMUAeoAHHw,13,19,4,5,3,19,14,0,64,9.142857142857142,2,0.0,0,4,4,3,19,19,1,14,0,11,53,0
448,6790,QZbPGbTnAqz8GS6cm25XcpeiETovvLN6,A3fsA9Zfv1X2fVEQhTw51lKENdNrEqT3,1,0,0,0,0,0,1,0,1,0.14285714285714285,1,0.0,0,0,0,0,0,0,0,1,0,0,1,1
449,6794,Yh46fozwerObqlP4OOrKTS69VvjT8dK1,A3fsA9Zfv1X2fVEQhTw51lKENdNrEqT3,40,14,10,90,8,0,8,0,130,18.571428571428573,5,0.0,2,10,86,8,12,0,4,8,0,106,24,1
450,6823,DeZ9eduD0lM3aHUAAOCnUrOhgp8jUmje,SpATywNh6bZuzm8s1ceuBUnMUAeoAHHw,11,25,2,4,0,0,8,0,39,5.571428571428571,3,0.0,8,2,3,0,17,0,1,8,0,13,26,0
451,6825,QwrR0O4UOobB3AXjFyYOVMeWzFnayzmx,SpATywNh6bZuzm8s1ceuBUnMUAeoAHHw,17,40,13,18,5,72,60,9,217,31.0,5,0.0,23,13,15,5,17,72,3,60,9,56,161,1
452,6862,JtMmp5BCDQnYE7CMI3NvnX4aRCZsQW9K,A3fsA9Zfv1X2fVEQhTw51lKENdNrEqT3,35,165,83,0,25,264,175,4,716,102.28571428571429,12,0.0,12,83,0,25,153,264,0,175,4,120,596,0
453,6878,7fC3V6ivG07wUIMOmiYFzSlyjWvbYnYf,SpATywNh6bZuzm8s1ceuBUnMUAeoAHHw,17,19,0,28,0,11,9,0,67,9.571428571428571,4,0.0,5,0,26,0,14,11,2,9,0,31,36,0
454,6895,z69L6knExrBf5gtr9B70Dgt3D9Xtp8CH,A3fsA9Zfv1X2fVEQhTw51lKENdNrEqT3,46,38,25,146,16,4,14,0,243,34.714285714285715,2,0.0,7,25,126,16,31,4,20,14,0,174,69,1
455,6896,WVOs4Pi3ll5FpomkXlRuIpcugHN3f0rV,SpATywNh6bZuzm8s1ceuBUnMUAeoAHHw,30,64,21,20,12,31,16,1,165,23.571428571428573,5,0.0,31,21,20,12,33,31,0,16,1,84,81,0
456,6907,CjvViMn5KClGeXFftICAvm8SWkvn3LHW,A3fsA9Zfv1X2fVEQhTw51lKENdNrEqT3,64,25,18,118,12,33,13,3,222,31.714285714285715,3,0.0,3,18,108,12,22,33,10,13,3,141,81,1
457,6915,V29AZJRcvBxCayax5I99yuRivRNPAZjj,SpATywNh6bZuzm8s1ceuBUnMUAeoAHHw,8,3,2,0,2,1,4,1,13,1.8571428571428572,1,0.0,0,2,0,2,3,1,0,4,1,4,9,0
458,6920,V29AZJRcvBxCayax5I99yuRivRNPAZjj,A3fsA9Zfv1X2fVEQhTw51lKENdNrEqT3,10,10,6,0,2,13,15,1,47,6.714285714285714,3,0.0,0,6,0,2,10,13,0,15,1,8,39,0
459,6923,FXwY1YS9Ue01cJBRQTifvzVPDx1ARw9E,SpATywNh6bZuzm8s1ceuBUnMUAeoAHHw,3,2,0,0,0,0,1,0,3,0.42857142857142855,1,0.0,0,0,0,0,2,0,0,1,0,0,3,1
460,6934,nsZMAREUaN1W79W768VHLU7EdYuf3Qrp,G8EPVSXsOYB5YQWZGiz1aVq5Pgr2GrQu,66,123,14,147,21,42,39,2,388,55.42857142857143,11,0.0,32,14,106,21,91,42,41,39,2,173,215,0
461,6935,JR1R4x5j4WkP10KgaKlpdN5JIGsgsmdk,SpATywNh6bZuzm8s1ceuBUnMUAeoAHHw,14,13,6,10,4,0,3,0,36,5.142857142857143,2,0.0,4,6,9,4,9,0,1,3,0,23,13,1
462,6944,cG2zraudtV44kPzel5abcAzgwVOUaAs4,A3fsA9Zfv1X2fVEQhTw51lKENdNrEqT3,7,8,0,6,0,0,3,0,17,2.4285714285714284,1,0.0,1,0,5,0,7,0,1,3,0,6,11,1
463,6972,ySy2zYThCkVZr5MjEXuKxq60wfOynxkJ,RXDvfPUBYFlVdlueBFbLW0mhhAyGEqpt,56,76,1,122,6,11,15,0,231,33.0,3,0.0,19,1,118,6,57,11,4,15,0,144,87,0
464,6977,EO1ssFp8oIj0TSE3bDdD8GeuhxRs5RVg,SpATywNh6bZuzm8s1ceuBUnMUAeoAHHw,27,104,12,42,7,32,57,3,257,36.714285714285715,8,0.0,27,12,37,7,77,32,5,57,3,83,174,0
465,6982,R0LbBsHoep5Au5A4mW7do32jHSfgQD8E,SpATywNh6bZuzm8s1ceuBUnMUAeoAHHw,18,67,21,20,5,45,26,1,185,26.428571428571427,4,0.0,34,21,16,5,33,45,4,26,1,76,109,1
466,6986,7fC3V6ivG07wUIMOmiYFzSlyjWvbYnYf,bWdj2GDclj5ofokWjzoa5jAwMkxCykd6,33,36,1,202,0,4,13,0,256,36.57142857142857,5,0.0,6,1,174,0,30,4,28,13,0,181,75,0
467,6996,Ah63NhKhS4EP98tjvGlVfvoLlBn6V6BJ,A3fsA9Zfv1X2fVEQhTw51lKENdNrEqT3,13,7,4,0,2,1,14,1,29,4.142857142857143,2,0.0,0,4,0,2,7,1,0,14,1,6,23,1
468,7009,oBSB2zh7bYN4yELh7x5ItqnxR463BvKC,bWdj2GDclj5ofokWjzoa5jAwMkxCykd6,38,256,82,142,61,3,35,0,579,82.71428571428571,11,0.0,66,82,127,61,190,3,15,35,0,336,243,0
469,7025,EFMEoi5W4mceo8rjft5LKrYvvT3E2eat,bWdj2GDclj5ofokWjzoa5jAwMkxCykd6,11,16,6,10,3,61,3,4,103,14.714285714285714,2,0.0,3,6,9,3,13,61,1,3,4,21,82,1
470,7030,AntKijOf83pltCnII9LLX8PQYe0F20yO,G8EPVSXsOYB5YQWZGiz1aVq5Pgr2GrQu,7,2,1,0,1,0,5,0,9,1.2857142857142858,1,0.0,0,1,0,1,2,0,0,5,0,2,7,0
471,7033,hplRuUXyLFhHcMqMJcb12YjqquTYp3Qw,A3fsA9Zfv1X2fVEQhTw51lKENdNrEqT3,43,38,17,80,11,0,5,0,151,21.571428571428573,3,0.0,5,17,64,11,33,0,16,5,0,97,54,0
472,7037,1pusTPLSLF5m0UuZqZkNpGlAq8VrQ1KA,SpATywNh6bZuzm8s1ceuBUnMUAeoAHHw,1,0,0,0,0,0,1,0,1,0.14285714285714285,1,0.0,0,0,0,0,0,0,0,1,0,0,1,0
473,7045,Qo4EYwRduG0qocv3scjgK3zQnLtIvid1,SpATywNh6bZuzm8s1ceuBUnMUAeoAHHw,19,106,22,0,8,4,41,7,188,26.857142857142858,6,0.0,0,22,0,8,106,4,0,41,7,30,158,0
474,7060,dGqImSq9UHavQbhAMWmMoDizcuOefX1Y,SpATywNh6bZuzm8s1ceuBUnMUAeoAHHw,13,32,0,16,0,26,8,2,84,12.0,2,0.0,16,0,13,0,16,26,3,8,2,29,55,0
475,7080,KqUCRL8ws5CG5PQvlspSHJpgFexIO4Jl,SpATywNh6bZuzm8s1ceuBUnMUAeoAHHw,23,83,3,38,2,0,3,0,129,18.428571428571427,3,0.0,32,3,32,2,51,0,6,3,0,69,60,0
476,7083,k85NFhuORfuDcrrXLAFWOhl0dHDWmC1t,bWdj2GDclj5ofokWjzoa5jAwMkxCykd6,6,5,2,0,2,0,2,0,11,1.5714285714285714,2,0.0,2,2,0,2,3,0,0,2,0,6,5,1
477,7117,RHl3DsvAX7TisJ7qBptmgrrtDAQvH7mr,A3fsA9Zfv1X2fVEQhTw51lKENdNrEqT3,20,39,20,6,9,5,19,0,98,14.0,5,0.0,4,20,5,9,35,5,1,19,0,38,60,0
478,7124,DRhlp1eJHQqsxjCL0bRD6kkHN20HbJ4w,SpATywNh6bZuzm8s1ceuBUnMUAeoAHHw,27,43,22,20,15,0,5,0,105,15.0,5,0.0,15,22,19,15,28,0,1,5,0,71,34,0
479,7129,mgwquciozkhcF0WnEEHOJYDb1rZHthNN,A3fsA9Zfv1X2fVEQhTw51lKENdNrEqT3,5,4,0,0,0,0,3,0,7,1.0,1,0.0,0,0,0,0,4,0,0,3,0,0,7,1
480,7137,rT1OrFQC18rdvYkTGYqwRgC7eDvihHsc,bWdj2GDclj5ofokWjzoa5jAwMkxCykd6,14,67,34,0,4,358,96,6,565,80.71428571428571,14,0.0,3,34,0,4,64,358,0,96,6,41,524,0
481,7142,YE22fRNdaFtk3nhWfjSOMHWERX5O7Ymi,A3fsA9Zfv1X2fVEQhTw51lKENdNrEqT3,59,29,4,82,3,0,8,0,126,18.0,2,0.0,3,4,79,3,26,0,3,8,0,89,37,0
482,7171,QzVwezWUOBpl33EMiprsTWQNwkGzpYUZ,A3fsA9Zfv1X2fVEQhTw51lKENdNrEqT3,7,4,2,0,2,0,4,0,12,1.7142857142857142,2,0.0,1,2,0,2,3,0,0,4,0,5,7,0
483,7179,3HOnjRDe3XaKpyhDvtGYWIvTQ5R0B6U5,RXDvfPUBYFlVdlueBFbLW0mhhAyGEqpt,15,12,8,0,4,1,10,0,35,5.0,2,0.0,1,8,0,4,11,1,0,10,0,13,22,1
484,7181,29zlPnPFaHRpKhWmQq4cQrKoDn0GEyMA,SpATywNh6bZuzm8s1ceuBUnMUAeoAHHw,18,64,28,15,8,8,37,1,161,23.0,6,0.0,13,28,13,8,51,8,2,37,1,62,99,1
485,7197,yiOlNWWu3p4vJ73FHFCmMYCNgzMDTrne,A3fsA9Zfv1X2fVEQhTw51lKENdNrEqT3,44,14,11,60,9,0,12,1,107,15.285714285714286,3,0.0,1,11,50,9,13,0,10,12,1,71,36,1
486,7219,t0cRwLqt3PES7T3WXJUMfvNkz6DOAsQy,G8EPVSXsOYB5YQWZGiz1aVq5Pgr2GrQu,33,61,18,74,11,31,10,1,206,29.428571428571427,3,0.0,28,18,50,11,33,31,24,10,1,107,99,0
487,7222,7abxlkdMiNWAIk78NzVnHWo2fZI6eMvl,SpATywNh6bZuzm8s1ceuBUnMUAeoAHHw,23,15,11,0,7,33,12,1,79,11.285714285714286,2,0.0,2,11,0,7,13,33,0,12,1,20,59,1
488,7229,iZlqOil8HuQgM9wIdCp3EDJlfdWSJRmO,SpATywNh6bZuzm8s1ceuBUnMUAeoAHHw,24,37,1,33,1,30,8,5,115,16.428571428571427,4,0.0,8,1,29,1,29,30,4,8,5,39,76,0
489,7232,Kv9yM6Ye606xOusGmqGDWX6SW9fdHP2Q,A3fsA9Zfv1X2fVEQhTw51lKENdNrEqT3,1,0,0,0,0,0,1,0,1,0.14285714285714285,1,0.0,0,0,0,0,0,0,0,1,0,0,1,1
490,7240,HJ4qDtw6u2JHJE7qmEDgWJOzWUYAv4mG,A3fsA9Zfv1X2fVEQhTw51lKENdNrEqT3,58,36,29,120,17,12,18,0,232,33.142857142857146,8,0.0,1,29,107,17,35,12,13,18,0,154,78,0
491,7256,D1NRZnTG0gvNQpfa2XPRkdGhYZVx3Bz8,RXDvfPUBYFlVdlueBFbLW0mhhAyGEqpt,70,85,61,155,33,10,12,8,364,52.0,6,0.0,16,61,136,33,69,10,19,12,8,246,118,0
492,7274,YZ1MgmwJiUridNKhbKx061bAjGk955T1,G8EPVSXsOYB5YQWZGiz1aVq5Pgr2GrQu,36,82,5,58,3,16,16,4,184,26.285714285714285,5,0.0,4,5,51,3,78,16,7,16,4,63,121,0
493,7296,ObMYjZj16p1bGCa8nmaBIv8cDUPUXE5o,SpATywNh6bZuzm8s1ceuBUnMUAeoAHHw,25,54,1,28,1,14,15,3,116,16.571428571428573,3,0.0,15,1,23,1,39,14,5,15,3,40,76,0
494,7297,bAkMyE6uCR0gc04pERZmDJrGVqJ4Z2Yi,G8EPVSXsOYB5YQWZGiz1aVq5Pgr2GrQu,61,68,17,98,15,12,7,0,217,31.0,4,0.0,37,17,65,15,31,12,33,7,0,134,83,0
495,7298,VSEOcWZYpZiKC2PUmidzj4VqbBnc3GAo,bWdj2GDclj5ofokWjzoa5jAwMkxCykd6,38,63,33,115,17,77,100,3,408,58.285714285714285,12,0.0,18,33,101,17,45,77,14,100,3,169,239,0
496,7303,Yby0It9Tj4ASosIcvg72qeavqJKBNZLT,A3fsA9Zfv1X2fVEQhTw51lKENdNrEqT3,2,0,0,0,0,0,2,0,2,0.2857142857142857,1,0.0,0,0,0,0,0,0,0,2,0,0,2,1
497,7325,3jh7S7idreXg4tLgwxk2JirIFS2kxatr,SpATywNh6bZuzm8s1ceuBUnMUAeoAHHw,17,41,17,22,8,7,17,1,113,16.142857142857142,4,0.0,7,17,18,8,34,7,4,17,1,50,63,0
498,7328,83p9ejSELsW1j5wNlAyUXF2YWFL8Z8tc,bWdj2GDclj5ofokWjzoa5jAwMkxCykd6,40,56,20,190,12,9,16,1,304,43.42857142857143,6,0.0,16,20,174,12,40,9,16,16,1,222,82,0
499,7344,B9KqNNxXBxHFUsJnQKQysblL3f8zF7sg,A3fsA9Zfv1X2fVEQhTw51lKENdNrEqT3,39,64,1,69,0,7,16,0,157,22.428571428571427,9,0.0,7,1,55,0,57,7,14,16,0,63,94,0
500,7356,uXSmZuPz2xNXPk2qFBcPykAtedr98vP4,RXDvfPUBYFlVdlueBFbLW0mhhAyGEqpt,41,34,18,80,12,3,3,0,150,21.428571428571427,2,0.0,10,18,75,12,24,3,5,3,0,115,35,0
501,7372,32uJBAomTJQIXKZnCX4K7PYoVfESGbct,A3fsA9Zfv1X2fVEQhTw51lKENdNrEqT3,46,33,5,122,3,0,5,0,168,24.0,8,0.0,2,5,101,3,31,0,21,5,0,111,57,1
502,7385,ErlOpSNxC1ZbmJguJSp3ZjxFq4nCmwgx,G8EPVSXsOYB5YQWZGiz1aVq5Pgr2GrQu,16,38,9,2,3,0,19,2,73,10.428571428571429,3,0.0,5,9,1,3,33,0,1,19,2,18,55,0
503,7391,7L5unYIhab1TebFiFv55Vd3f3JppE4WH,A3fsA9Zfv1X2fVEQhTw51lKENdNrEqT3,4,2,1,0,1,0,2,0,6,0.8571428571428571,1,0.0,0,1,0,1,2,0,0,2,0,2,4,0
504,7422,WKdxdVcCk0v6q8w6qEVoDAEpoNH9nq1b,A3fsA9Zfv1X2fVEQhTw51lKENdNrEqT3,43,39,19,66,10,4,14,0,152,21.714285714285715,4,0.0,3,19,53,10,36,4,13,14,0,85,67,1
505,7428,dTkPxaFmNowU6Qk7fnasqvgAevZOuRY9,RXDvfPUBYFlVdlueBFbLW0mhhAyGEqpt,43,17,10,78,7,9,4,0,125,17.857142857142858,2,0.0,7,10,77,7,10,9,1,4,0,101,24,1
506,7439,yK7fQWYLG0RsBbgokh3BoTMU9oScdsOd,bWdj2GDclj5ofokWjzoa5jAwMkxCykd6,4,3,2,0,2,0,1,0,8,1.1428571428571428,1,0.0,0,2,0,2,3,0,0,1,0,4,4,1
507,7440,5TRqp5WlxU778HZGbnj0S6xLTaRfUJxG,SpATywNh6bZuzm8s1ceuBUnMUAeoAHHw,21,38,3,6,3,18,18,2,88,12.571428571428571,7,0.0,1,3,5,3,37,18,1,18,2,12,76,0
508,7463,zdqliI4eCBGH6nGv4KKIRZFL1YFXBytK,SpATywNh6bZuzm8s1ceuBUnMUAeoAHHw,31,78,34,36,11,145,52,2,358,51.142857142857146,8,0.0,26,34,31,11,52,145,5,52,2,102,256,0
509,7464,lFMYqumkG36iLJm9YwVpbzadzxUvswUa,bWdj2GDclj5ofokWjzoa5jAwMkxCykd6,1,0,0,0,0,0,3,0,3,0.42857142857142855,2,0.0,0,0,0,0,0,0,0,3,0,0,3,1
510,7466,lFMYqumkG36iLJm9YwVpbzadzxUvswUa,SpATywNh6bZuzm8s1ceuBUnMUAeoAHHw,13,21,12,11,0,5,9,0,58,8.285714285714286,4,0.0,6,12,9,0,15,5,2,9,0,27,31,0
511,7475,vRHTfFGO3STxLwMRkIw1geBTPnARvg2o,SpATywNh6bZuzm8s1ceuBUnMUAeoAHHw,15,21,13,6,6,8,14,0,68,9.714285714285714,4,0.0,1,13,5,6,20,8,1,14,0,25,43,0
512,7488,uUSTKM8g1hIskJbYHh1UiIQ6epHTSTNR,A3fsA9Zfv1X2fVEQhTw51lKENdNrEqT3,30,28,13,78,2,0,11,0,132,18.857142857142858,6,0.0,4,13,64,2,24,0,14,11,0,83,49,1
513,7491,uUSTKM8g1hIskJbYHh1UiIQ6epHTSTNR,RXDvfPUBYFlVdlueBFbLW0mhhAyGEqpt,45,62,35,90,22,2,12,0,223,31.857142857142858,5,0.0,15,35,85,22,47,2,5,12,0,157,66,0
514,7496,6qVy3H4VOdeTnu4v49EIcz51mS5B3gWH,SpATywNh6bZuzm8s1ceuBUnMUAeoAHHw,24,66,37,19,0,143,58,8,331,47.285714285714285,10,0.0,12,37,16,0,54,143,3,58,8,65,266,0
515,7503,0PrF4PViZdaRQhbt6FYXwLbcetJ8RnwC,A3fsA9Zfv1X2fVEQhTw51lKENdNrEqT3,33,28,1,80,1,0,13,0,123,17.571428571428573,5,0.0,1,1,69,1,27,0,11,13,0,72,51,0
516,7504,NH2DAS5rCP8HjIcwHAZxDBAjUjjdHeyM,SpATywNh6bZuzm8s1ceuBUnMUAeoAHHw,29,24,19,18,9,29,19,0,118,16.857142857142858,3,0.0,5,19,17,9,19,29,1,19,0,50,68,0
517,7521,a3StgABPgimfVHzW1FR4usG9kIA0tZV5,bWdj2GDclj5ofokWjzoa5jAwMkxCykd6,10,67,2,6,4,0,14,0,93,13.285714285714286,7,0.0,13,2,6,4,54,0,0,14,0,25,68,1
518,7525,xNkIHhqS8GZXIqyoWwwS3ZeYfSmUsNJo,A3fsA9Zfv1X2fVEQhTw51lKENdNrEqT3,42,35,14,80,9,8,9,1,156,22.285714285714285,3,0.0,1,14,62,9,34,8,18,9,1,86,70,0
519,7535,8a9f5zlAzg00IZpxpFpd0Yys1Z1UDN82,RXDvfPUBYFlVdlueBFbLW0mhhAyGEqpt,42,84,53,31,25,2,16,0,211,30.142857142857142,5,0.0,2,53,27,25,82,2,4,16,0,107,104,1
520,7539,p6HxMfZynarvwZflE5DcOWxdvhYhrFbF,G8EPVSXsOYB5YQWZGiz1aVq5Pgr2GrQu,6,2,1,0,1,0,3,0,7,1.0,1,0.0,0,1,0,1,2,0,0,3,0,2,5,1
521,7540,oRVMh8MBvWswMrCZYZVSC4ANhRghr3SC,RXDvfPUBYFlVdlueBFbLW0mhhAyGEqpt,25,41,20,13,7,5,14,2,102,14.571428571428571,6,0.0,3,20,13,7,38,5,0,14,2,43,59,1
522,7550,EGswqlieknT0DkOMjaOEPr1kJjoddSSw,G8EPVSXsOYB5YQWZGiz1aVq5Pgr2GrQu,32,69,8,42,8,82,26,7,242,34.57142857142857,8,0.0,8,8,33,8,61,82,9,26,7,57,185,0
523,7552,ljmWZCzWPqv1RXsn1q2wpsQtrnA1zct2,SpATywNh6bZuzm8s1ceuBUnMUAeoAHHw,25,43,16,24,6,7,10,0,106,15.142857142857142,4,0.0,10,16,20,6,33,7,4,10,0,52,54,0
524,7562,606SeIKBIFg9vt3BinDbRysHBP3GLEGI,bWdj2GDclj5ofokWjzoa5jAwMkxCykd6,11,10,2,0,3,7,11,2,35,5.0,1,0.0,2,2,0,3,8,7,0,11,2,7,28,1
525,7571,hPtqAQmVA3C7MVQi98nPJLfZYLyZ86Qe,SpATywNh6bZuzm8s1ceuBUnMUAeoAHHw,4,2,1,0,1,0,1,0,5,0.7142857142857143,2,0.0,0,1,0,1,2,0,0,1,0,2,3,1
526,7579,7KQcIrOp3KoypOTvziMED7rHtDH1CXtE,SpATywNh6bZuzm8s1ceuBUnMUAeoAHHw,14,11,0,18,0,11,9,0,49,7.0,2,0.0,3,0,15,0,8,11,3,9,0,18,31,1
527,7581,QoKkWqCz9JSPf2G2l4XrJl2BfFSq9X9B,RXDvfPUBYFlVdlueBFbLW0mhhAyGEqpt,22,43,3,44,2,23,14,7,136,19.428571428571427,4,0.0,7,3,37,2,36,23,7,14,7,49,87,0
528,7589,ljmWZCzWPqv1RXsn1q2wpsQtrnA1zct2,A3fsA9Zfv1X2fVEQhTw51lKENdNrEqT3,42,16,13,68,9,1,4,0,111,15.857142857142858,2,0.0,1,13,56,9,15,1,12,4,0,79,32,1
529,7628,hRBUrY0Ipi1X9aVKI1Gcp4xJWynJPCa6,SpATywNh6bZuzm8s1ceuBUnMUAeoAHHw,28,25,13,26,8,0,3,0,75,10.714285714285714,3,0.0,8,13,25,8,17,0,1,3,0,54,21,0
530,7632,YpYAswD6xdR70kiD53LA7ygDBkdDLMQF,SpATywNh6bZuzm8s1ceuBUnMUAeoAHHw,11,13,6,2,3,4,2,0,30,4.285714285714286,2,0.0,1,6,2,3,12,4,0,2,0,12,18,1
531,7633,11ljuSLdnPtPyfemLE7b9qn6qXcmssv1,SpATywNh6bZuzm8s1ceuBUnMUAeoAHHw,18,44,16,42,2,9,16,0,129,18.428571428571427,6,0.0,19,16,33,2,25,9,9,16,0,70,59,1
532,7634,I4noBaz6GyRD2PZe6j4LCRYlVDmmxoLh,SpATywNh6bZuzm8s1ceuBUnMUAeoAHHw,12,17,2,1,0,1,8,1,30,4.285714285714286,1,0.0,2,2,1,0,15,1,0,8,1,5,25,1
533,7642,WZSiXPjEuCIRtzYUNEK3DyAuPVNMLJ4a,SpATywNh6bZuzm8s1ceuBUnMUAeoAHHw,15,15,7,29,4,8,4,0,67,9.571428571428571,1,0.0,6,7,24,4,9,8,5,4,0,41,26,1
534,7647,ylrXVJAuag501sD5FTvKV7DusuU60h41,SpATywNh6bZuzm8s1ceuBUnMUAeoAHHw,5,2,0,0,1,0,3,0,6,0.8571428571428571,1,0.0,0,0,0,1,2,0,0,3,0,1,5,1
535,7652,PQ7ibn4CoD7R92qj9CnBXvU4YpUOqVHi,SpATywNh6bZuzm8s1ceuBUnMUAeoAHHw,27,54,32,16,14,4,28,4,152,21.714285714285715,5,0.0,19,32,16,14,35,4,0,28,4,81,71,0
536,7653,v9Jp2iBPSFTVxP8FrUe1odwfz8Hd1wS3,RXDvfPUBYFlVdlueBFbLW0mhhAyGEqpt,72,60,40,92,21,11,20,2,246,35.142857142857146,5,0.0,13,40,87,21,47,11,5,20,2,161,85,0
537,7675,LiEDHNjd9tDT7NPtKiOjuDJtkaP8cSxY,bWdj2GDclj5ofokWjzoa5jAwMkxCykd6,25,84,47,32,15,66,26,5,275,39.285714285714285,6,0.0,12,47,27,15,72,66,5,26,5,101,174,0
538,7679,GjmRL85Fx59ASzosh0kQzycWTmRCzek4,SpATywNh6bZuzm8s1ceuBUnMUAeoAHHw,14,31,1,17,1,1,5,0,56,8.0,3,0.0,19,1,16,1,12,1,1,5,0,37,19,1
539,7702,ulNRkVxxtx7SLWYKYYIDWhAGHHFqHWWG,SpATywNh6bZuzm8s1ceuBUnMUAeoAHHw,28,41,19,24,7,3,21,1,116,16.571428571428573,6,0.0,11,19,23,7,30,3,1,21,1,60,56,0
540,7707,Om7TmUpRVXmKCq1XRkQCdyE9M7r8n9tE,SpATywNh6bZuzm8s1ceuBUnMUAeoAHHw,11,20,0,14,0,4,6,1,45,6.428571428571429,1,0.0,7,0,14,0,13,4,0,6,1,21,24,0
541,7711,U4GXlaQk4qQjr2K7P59OKvXX0vv1Pxee,SpATywNh6bZuzm8s1ceuBUnMUAeoAHHw,15,45,7,21,1,0,20,2,96,13.714285714285714,8,0.0,11,7,18,1,34,0,3,20,2,37,59,0
542,7713,0W4XScVx81tfxJ0Qr09mHB39FqA62JyS,SpATywNh6bZuzm8s1ceuBUnMUAeoAHHw,13,17,4,19,2,2,4,0,48,6.857142857142857,3,0.0,6,4,17,2,11,2,2,4,0,29,19,1
543,7716,yG9o9nU1hVydCMiwULHDO2ptGPwb3jNJ,SpATywNh6bZuzm8s1ceuBUnMUAeoAHHw,22,31,15,12,5,2,6,0,71,10.142857142857142,6,0.0,10,15,12,5,21,2,0,6,0,42,29,1
544,7721,MAlRgKpZXlP3WrMKjRw2YskqEALVtCKw,SpATywNh6bZuzm8s1ceuBUnMUAeoAHHw,20,33,0,17,0,5,13,0,68,9.714285714285714,6,0.0,7,0,17,0,26,5,0,13,0,24,44,0
545,7727,h5vEAVTb94xGNGjpn4Ohi5mNcXfM0rMl,RXDvfPUBYFlVdlueBFbLW0mhhAyGEqpt,18,29,3,6,2,1,11,5,57,8.142857142857142,2,0.0,4,3,6,2,25,1,0,11,5,15,42,1
546,7742,zu1WAijSG0F2wy5x45xxD1w2SrPWGtuK,RXDvfPUBYFlVdlueBFbLW0mhhAyGEqpt,59,72,23,70,16,26,50,9,266,38.0,3,0.0,16,23,64,16,56,26,6,50,9,119,147,0
547,7748,cXt4yzdeLQWJ2a8N3WCCOFlxmV6sHALc,bWdj2GDclj5ofokWjzoa5jAwMkxCykd6,28,34,14,182,11,0,7,0,248,35.42857142857143,3,0.0,16,14,173,11,18,0,9,7,0,214,34,1
548,7752,nIJT2WzxvFmAAdv0mMRGLvQiPT819gU3,SpATywNh6bZuzm8s1ceuBUnMUAeoAHHw,29,123,23,36,10,132,72,1,397,56.714285714285715,9,0.0,24,23,28,10,99,132,8,72,1,85,312,0
549,7753,kzQ1HmHoPnIhyiOH3J5g0gxiDZh4kW6J,RXDvfPUBYFlVdlueBFbLW0mhhAyGEqpt,69,54,33,129,23,2,31,0,272,38.857142857142854,5,0.0,16,33,116,23,38,2,13,31,0,188,84,1
550,7762,2Sqmg51RWZnvGf1B4BEysn1wJm7yLaQl,G8EPVSXsOYB5YQWZGiz1aVq5Pgr2GrQu,41,44,8,90,3,3,14,0,162,23.142857142857142,3,0.0,4,8,88,3,40,3,2,14,0,103,59,0
551,7769,QV7Z9LfpjzP9d797QCfKxmoOjdo08shd,SpATywNh6bZuzm8s1ceuBUnMUAeoAHHw,30,35,19,15,11,21,9,1,111,15.857142857142858,4,0.0,9,19,15,11,26,21,0,9,1,54,57,0
552,7770,4dVGo2nGpdhjYgYbTYmjlligu2kflHn7,RXDvfPUBYFlVdlueBFbLW0mhhAyGEqpt,50,105,35,77,13,4,20,3,257,36.714285714285715,2,0.0,24,35,73,13,81,4,4,20,3,145,112,1
553,7782,EJ52dc9s4CYydLeBR3nGlXxXka6Fltqj,A3fsA9Zfv1X2fVEQhTw51lKENdNrEqT3,7,5,2,0,2,0,7,0,16,2.2857142857142856,2,0.0,0,2,0,2,5,0,0,7,0,4,12,0
554,7784,Y96AzEZtgYGN39EPdmAzdYPvLhv1Tzsf,SpATywNh6bZuzm8s1ceuBUnMUAeoAHHw,30,29,18,33,10,16,17,1,124,17.714285714285715,3,0.0,8,18,28,10,21,16,5,17,1,64,60,0
555,7787,b87ksD29UBdF2YCxTtUOCsx5OJsZrMS6,SpATywNh6bZuzm8s1ceuBUnMUAeoAHHw,10,17,1,0,0,4,6,0,28,4.0,2,0.0,2,1,0,0,15,4,0,6,0,3,25,1
556,7808,xG6pQFBC9YTxYi6joCJjOh2c6LkI7Trq,SpATywNh6bZuzm8s1ceuBUnMUAeoAHHw,5,2,1,0,1,0,2,0,6,0.8571428571428571,1,0.0,0,1,0,1,2,0,0,2,0,2,4,1
557,7816,rbxp4ygAJiuJravRmpeSgvTRbWslY8KE,G8EPVSXsOYB5YQWZGiz1aVq5Pgr2GrQu,43,47,18,102,12,2,12,2,195,27.857142857142858,3,0.0,25,18,75,12,22,2,27,12,2,130,65,1
558,7817,KLERBlLR5to2IuMEV6VaweaoU18ID2Ks,SpATywNh6bZuzm8s1ceuBUnMUAeoAHHw,16,20,9,11,4,0,10,0,54,7.714285714285714,2,0.0,5,9,10,4,15,0,1,10,0,28,26,1
559,7818,LMGbvXS3ZBgtTcKCRLMcqBHrfADBxwXe,SpATywNh6bZuzm8s1ceuBUnMUAeoAHHw,29,53,29,16,14,2,23,0,137,19.571428571428573,9,0.0,8,29,14,14,45,2,2,23,0,65,72,0
560,7819,hHscGHEjmeiL8NswOTKn3P6KxplprGQ7,SpATywNh6bZuzm8s1ceuBUnMUAeoAHHw,4,3,2,0,0,0,1,0,6,0.8571428571428571,1,0.0,0,2,0,0,3,0,0,1,0,2,4,1
561,7832,RNgrmqPicYezsE4BsF8Au4WfPdSMWP6C,G8EPVSXsOYB5YQWZGiz1aVq5Pgr2GrQu,12,13,7,0,1,2,13,1,37,5.285714285714286,2,0.0,2,7,0,1,11,2,0,13,1,10,27,1
562,7835,3iSbhZU0XFdJUgUA6Ry01TQ9T4nPzP7c,SpATywNh6bZuzm8s1ceuBUnMUAeoAHHw,11,24,6,0,2,0,10,0,42,6.0,3,0.0,0,6,0,2,24,0,0,10,0,8,34,1
563,7838,S10grfxrn0tXcuL6DSaVTf7wyvXspCvq,SpATywNh6bZuzm8s1ceuBUnMUAeoAHHw,7,15,1,0,0,22,9,0,47,6.714285714285714,2,0.0,2,1,0,0,13,22,0,9,0,3,44,0
564,7839,WYNpj52NyIePFOfUouGRXkQmACPQnP2J,SpATywNh6bZuzm8s1ceuBUnMUAeoAHHw,30,303,148,38,15,1442,229,10,2185,312.14285714285717,12,0.0,38,148,32,15,265,1442,6,229,10,233,1952,0
565,7853,70BrIR23BcsI705EZj4LSyr7fHWI0Xjf,A3fsA9Zfv1X2fVEQhTw51lKENdNrEqT3,25,34,22,0,17,0,7,0,80,11.428571428571429,3,0.0,0,22,0,17,34,0,0,7,0,39,41,0
566,7855,FOHqSST3UlMcK0PZ2G62CXA809f8BW7i,bWdj2GDclj5ofokWjzoa5jAwMkxCykd6,5,2,1,0,1,0,2,0,6,0.8571428571428571,1,0.0,0,1,0,1,2,0,0,2,0,2,4,1
567,7857,Z6YQS36VdHJFF4DkVSTcUgmOIdlOITNE,SpATywNh6bZuzm8s1ceuBUnMUAeoAHHw,28,50,20,36,9,1,7,0,123,17.571428571428573,5,0.0,22,20,30,9,28,1,6,7,0,81,42,0
568,7858,Ak0ru019Ynz1X1qhUbDFCskGZavLrHBc,SpATywNh6bZuzm8s1ceuBUnMUAeoAHHw,30,71,36,33,16,24,10,2,192,27.428571428571427,2,0.0,27,36,31,16,44,24,2,10,2,110,82,0
569,7860,rWA9BhwEXXwDdj5p5FXRqP1JA3HaX1US,SpATywNh6bZuzm8s1ceuBUnMUAeoAHHw,29,47,23,31,14,2,5,0,122,17.428571428571427,3,0.0,17,23,28,14,30,2,3,5,0,82,40,1
570,7863,bDqqR2hng29QNjexgLbMGRH4AJBfyli8,SpATywNh6bZuzm8s1ceuBUnMUAeoAHHw,19,23,17,10,7,5,10,1,73,10.428571428571429,4,0.0,0,17,8,7,23,5,2,10,1,32,41,1
571,7868,ptvDGcVFI5vzF4lBwRLTADNrenNp2tF2,SpATywNh6bZuzm8s1ceuBUnMUAeoAHHw,25,45,13,24,3,4,25,0,114,16.285714285714285,4,0.0,10,13,21,3,35,4,3,25,0,47,67,0
572,7870,sj7wQJWVAxmId67LlkoaFzAmqWKmeC7I,SpATywNh6bZuzm8s1ceuBUnMUAeoAHHw,21,135,8,8,4,119,68,1,343,49.0,7,0.0,25,8,8,4,110,119,0,68,1,45,298,0
573,7882,0zObXmoXHP7rszDYuu8m5842mUKzCfEP,G8EPVSXsOYB5YQWZGiz1aVq5Pgr2GrQu,12,16,1,38,0,0,3,0,58,8.285714285714286,1,0.0,2,1,33,0,14,0,5,3,0,36,22,1
574,7883,JiNN6rHoPfwH1fuAk6q9tmTGqAFVjob4,SpATywNh6bZuzm8s1ceuBUnMUAeoAHHw,16,14,8,12,5,2,6,1,48,6.857142857142857,2,0.0,4,8,10,5,10,2,2,6,1,27,21,0
575,7909,fbuy5iqzFkLuifp42uT7tvssNinDwhQ9,G8EPVSXsOYB5YQWZGiz1aVq5Pgr2GrQu,19,12,5,0,5,0,5,0,27,3.857142857142857,1,0.0,2,5,0,5,10,0,0,5,0,12,15,1
576,7923,pJUI0Hs11rZxgXk3r1clZCyuDCtGsbvH,SpATywNh6bZuzm8s1ceuBUnMUAeoAHHw,31,43,19,31,8,0,9,1,111,15.857142857142858,3,0.0,18,19,29,8,25,0,2,9,1,74,37,1
577,7933,dEPUxcdyZTnKUVP0o2JXv6VWX3ETnwmr,SpATywNh6bZuzm8s1ceuBUnMUAeoAHHw,26,77,39,32,3,18,48,7,224,32.0,5,0.0,34,39,26,3,43,18,6,48,7,102,122,1
578,7937,ywdL3xkp7d2PSjbvnflAvIe7Wp6Q4SRe,SpATywNh6bZuzm8s1ceuBUnMUAeoAHHw,29,71,27,35,10,0,20,1,164,23.428571428571427,7,0.0,22,27,30,10,49,0,5,20,1,89,75,0
579,7942,JNo2rLqKe6aBGDwGzu8tXd13uOC5tEnq,bWdj2GDclj5ofokWjzoa5jAwMkxCykd6,14,23,11,52,0,18,35,2,141,20.142857142857142,3,0.0,8,11,51,0,15,18,1,35,2,70,71,0
580,7949,FnY3or5QaQRvUAAgyu53eYBfcMnduugT,SpATywNh6bZuzm8s1ceuBUnMUAeoAHHw,26,52,9,22,3,11,18,1,116,16.571428571428573,7,0.0,12,9,20,3,40,11,2,18,1,44,72,0
581,7952,CI12SZIYH2QOfgaDvq8F4VKXwDinb334,SpATywNh6bZuzm8s1ceuBUnMUAeoAHHw,32,46,27,25,12,1,8,1,120,17.142857142857142,5,0.0,13,27,22,12,33,1,3,8,1,74,46,0
582,7954,WzyWOzB7f8AVbQvaWeU3O4gxEwZ13sIC,RXDvfPUBYFlVdlueBFbLW0mhhAyGEqpt,49,67,35,113,25,3,12,2,257,36.714285714285715,7,0.0,18,35,107,25,49,3,6,12,2,185,72,0
583,7956,ljmWZCzWPqv1RXsn1q2wpsQtrnA1zct2,G8EPVSXsOYB5YQWZGiz1aVq5Pgr2GrQu,102,104,15,322,13,24,10,0,488,69.71428571428571,3,0.0,53,15,226,13,51,24,96,10,0,307,181,1
584,7962,mtW8rWxW2XwZIB5TM8b8gUVmE4UACp0R,SpATywNh6bZuzm8s1ceuBUnMUAeoAHHw,22,26,15,14,5,0,6,0,66,9.428571428571429,6,0.0,6,15,14,5,20,0,0,6,0,40,26,0
585,7964,z8zMi50azvRwAPUNW2f5Gt0F6WOr8PI9,A3fsA9Zfv1X2fVEQhTw51lKENdNrEqT3,11,7,6,0,4,0,2,0,19,2.7142857142857144,2,0.0,0,6,0,4,7,0,0,2,0,10,9,1
586,7967,Wyji6pvgj7unEJ4mD7FWwu0Sma8fUdv4,SpATywNh6bZuzm8s1ceuBUnMUAeoAHHw,25,45,29,15,15,20,23,2,149,21.285714285714285,2,0.0,9,29,15,15,36,20,0,23,2,68,81,0
587,7970,2mdoNlBiXpgUVSmoihAheHl3NISmi738,SpATywNh6bZuzm8s1ceuBUnMUAeoAHHw,3,0,0,0,0,14,2,0,16,2.2857142857142856,1,0.0,0,0,0,0,0,14,0,2,0,0,16,1
588,7973,SUqHrTqjE8jHVpASqCaMjjR6iZ17k2Gq,SpATywNh6bZuzm8s1ceuBUnMUAeoAHHw,29,44,22,36,8,1,19,1,131,18.714285714285715,7,0.0,10,22,31,8,34,1,5,19,1,71,60,0
589,7975,EwJz8sdPLnTPbvCqxQKV7YueKEdP0wYf,SpATywNh6bZuzm8s1ceuBUnMUAeoAHHw,22,31,19,15,11,4,9,0,89,12.714285714285714,4,0.0,6,19,13,11,25,4,2,9,0,49,40,0
590,7999,j55CnsxXtuPHDTIgqOvx7oExU3RRtQ4I,SpATywNh6bZuzm8s1ceuBUnMUAeoAHHw,31,37,18,31,7,11,23,1,128,18.285714285714285,4,0.0,12,18,29,7,25,11,2,23,1,66,62,1
591,8000,YiNeIrEOhZYEzsuuN5nQKcsVr5To2nDU,SpATywNh6bZuzm8s1ceuBUnMUAeoAHHw,28,31,17,30,9,2,16,0,105,15.0,5,0.0,13,17,27,9,18,2,3,16,0,66,39,0
592,8001,DI3YZyhWTKxhZZnQuVUpGne2QEEoyvnw,SpATywNh6bZuzm8s1ceuBUnMUAeoAHHw,32,52,23,32,13,1,15,18,154,22.0,3,0.0,24,23,30,13,28,1,2,15,18,90,64,0
593,8016,0wTvjguYOmHTRx6CgVlID5lRmd6At3zN,RXDvfPUBYFlVdlueBFbLW0mhhAyGEqpt,7,3,2,0,2,1,2,0,10,1.4285714285714286,1,0.0,0,2,0,2,3,1,0,2,0,4,6,0
594,8026,KtSnhyXFi6bevwD38L0oZAkqxHVX0Rkl,RXDvfPUBYFlVdlueBFbLW0mhhAyGEqpt,31,55,10,43,17,13,6,19,163,23.285714285714285,3,0.0,18,10,41,17,37,13,2,6,19,86,77,1
595,8029,cuDL2ISAKT9SiekAD9CQynXiu9fQTVyV,G8EPVSXsOYB5YQWZGiz1aVq5Pgr2GrQu,67,66,11,218,7,8,37,5,352,50.285714285714285,11,0.0,0,11,175,7,66,8,43,37,5,193,159,0
596,8031,Ra8GzsxOGVkAaMFXN2T6V1Y5fgtJJH5X,SpATywNh6bZuzm8s1ceuBUnMUAeoAHHw,19,54,1,31,1,4,13,0,104,14.857142857142858,6,0.0,10,1,28,1,44,4,3,13,0,40,64,0
597,8051,HZ6Si9PJ3YYyrZuVsVHlXbrETWWPILa2,SpATywNh6bZuzm8s1ceuBUnMUAeoAHHw,30,30,13,39,7,4,17,1,111,15.857142857142858,3,0.0,12,13,33,7,18,4,6,17,1,65,46,1
598,8059,W8K4VS8rPvnPTNUJrqgtS2FKH93KmR91,bWdj2GDclj5ofokWjzoa5jAwMkxCykd6,40,70,33,251,16,5,17,1,393,56.142857142857146,6,0.0,6,33,228,16,64,5,23,17,1,283,110,1
599,8061,eDdFtfGTTqvukOdpQCeNfhpEnZacRMyL,SpATywNh6bZuzm8s1ceuBUnMUAeoAHHw,28,28,17,20,8,0,16,0,89,12.714285714285714,4,0.0,5,17,19,8,23,0,1,16,0,49,40,0
600,8065,F4JRzQAurYVB0YRhdceJcfWH3R0QimyF,A3fsA9Zfv1X2fVEQhTw51lKENdNrEqT3,6,9,0,0,0,1,4,0,14,2.0,1,0.0,0,0,0,0,9,1,0,4,0,0,14,1
601,8070,Hk1cgW0d6IHp4JJgdPvorinTv3vI8Eld,bWdj2GDclj5ofokWjzoa5jAwMkxCykd6,2,0,0,0,0,0,2,0,2,0.2857142857142857,1,0.0,0,0,0,0,0,0,0,2,0,0,2,1
602,8078,nD2aR2lBTYEZ05tUWGjogkwgt2d7zeNx,bWdj2GDclj5ofokWjzoa5jAwMkxCykd6,24,47,3,108,3,25,19,1,206,29.428571428571427,3,0.0,8,3,101,3,39,25,7,19,1,115,91,1
603,8087,3nOS3JEH08BgwunQqioyEFfja4qIND4p,A3fsA9Zfv1X2fVEQhTw51lKENdNrEqT3,37,26,3,58,2,0,7,0,96,13.714285714285714,2,0.0,5,3,51,2,21,0,7,7,0,61,35,1
604,8106,MyaVABM4nYDk4vd54igotJktuGSzZ2QZ,SpATywNh6bZuzm8s1ceuBUnMUAeoAHHw,4,2,0,0,0,0,2,0,4,0.5714285714285714,1,0.0,0,0,0,0,2,0,0,2,0,0,4,1
605,8120,9vfzrI57qoGmouqr760GeuDugjxYZgDg,A3fsA9Zfv1X2fVEQhTw51lKENdNrEqT3,2,0,0,0,0,0,2,0,2,0.2857142857142857,1,0.0,0,0,0,0,0,0,0,2,0,0,2,1
606,8124,aFQfsfvTRloUF4eJLXlE0V3FUzRLFNv8,RXDvfPUBYFlVdlueBFbLW0mhhAyGEqpt,11,10,6,0,3,0,5,0,24,3.4285714285714284,2,0.0,2,6,0,3,8,0,0,5,0,11,13,1
607,8131,0chnDCxU68X7ybwDimwVoWcTfCUDrb8j,SpATywNh6bZuzm8s1ceuBUnMUAeoAHHw,21,23,12,18,7,74,16,5,155,22.142857142857142,2,0.0,7,12,15,7,16,74,3,16,5,41,114,1
608,8150,0QzhB266MffxtP4NW9xGCK2aFIanQJEL,SpATywNh6bZuzm8s1ceuBUnMUAeoAHHw,17,50,22,16,6,190,37,6,327,46.714285714285715,6,0.0,18,22,13,6,32,190,3,37,6,59,268,1
609,8155,S6HVmLPlerZStE1FmYWcP13FOlr0Ldio,SpATywNh6bZuzm8s1ceuBUnMUAeoAHHw,23,38,1,20,0,4,20,2,85,12.142857142857142,5,0.0,15,1,18,0,23,4,2,20,2,34,51,1
610,8159,rLDZGBeZrRdOkLUUwzLb6ezyjai8N3vb,G8EPVSXsOYB5YQWZGiz1aVq5Pgr2GrQu,9,3,2,0,1,2,8,0,16,2.2857142857142856,1,0.0,0,2,0,1,3,2,0,8,0,3,13,1
611,8164,OvIrFDXnTf7lPGXHN37tKh2m9dXSHGJK,RXDvfPUBYFlVdlueBFbLW0mhhAyGEqpt,59,106,61,112,19,159,55,17,529,75.57142857142857,9,0.0,15,61,109,19,91,159,3,55,17,204,325,0
612,8167,4OFy9ZLb1svxpVgXkgI60wOGeiU4V4oA,SpATywNh6bZuzm8s1ceuBUnMUAeoAHHw,19,46,20,20,5,2,19,1,113,16.142857142857142,3,0.0,8,20,16,5,38,2,4,19,1,49,64,1
613,8171,Agc8I1aREEPfi2PqA7NK0aenTcuvE1HC,SpATywNh6bZuzm8s1ceuBUnMUAeoAHHw,29,41,26,27,13,21,11,4,143,20.428571428571427,4,0.0,8,26,23,13,33,21,4,11,4,70,73,0
614,8174,ZFeBOOLKgUUTF7XgzMMbqDAJmFSviC7K,SpATywNh6bZuzm8s1ceuBUnMUAeoAHHw,31,56,26,26,15,1,20,1,145,20.714285714285715,5,0.0,17,26,24,15,39,1,2,20,1,82,63,0
615,8182,LVZNwk74X0NnQqnGU1Um0MYH9C8V0Gpb,A3fsA9Zfv1X2fVEQhTw51lKENdNrEqT3,29,28,22,4,17,1,10,1,83,11.857142857142858,1,0.0,0,22,3,17,28,1,1,10,1,42,41,1
616,8183,FFyynYy7wGQKjNauntgybGuFHItz8juf,G8EPVSXsOYB5YQWZGiz1aVq5Pgr2GrQu,78,70,35,217,24,0,10,0,356,50.857142857142854,5,0.0,3,35,183,24,67,0,34,10,0,245,111,0
617,8189,vJz36xQo6TWpiQM1Na1nFu4lVJoSD2XQ,A3fsA9Zfv1X2fVEQhTw51lKENdNrEqT3,11,5,1,0,1,1,8,1,17,2.4285714285714284,2,0.0,0,1,0,1,5,1,0,8,1,2,15,1
618,8190,yFLanYq8p4sf6NFSB1Td9ag6632plY4t,bWdj2GDclj5ofokWjzoa5jAwMkxCykd6,20,35,21,12,11,0,14,0,93,13.285714285714286,5,0.0,7,21,11,11,28,0,1,14,0,50,43,1
619,8193,95EnvGi27MT4ra7RQ8eLxKyAZNUVPzZY,G8EPVSXsOYB5YQWZGiz1aVq5Pgr2GrQu,4,0,0,0,0,0,5,0,5,0.7142857142857143,1,0.0,0,0,0,0,0,0,0,5,0,0,5,1
620,8194,I2GJVZ7RHpZycmvh6r4mj8R0Y34OZpBl,SpATywNh6bZuzm8s1ceuBUnMUAeoAHHw,25,52,3,32,2,11,22,1,123,17.571428571428573,6,0.0,11,3,26,2,41,11,6,22,1,42,81,1
621,8200,myPDU4mr5TIDvQCh3WcoSxbhe6fCunPv,SpATywNh6bZuzm8s1ceuBUnMUAeoAHHw,23,38,13,16,8,1,8,1,85,12.142857142857142,3,0.0,6,13,14,8,32,1,2,8,1,41,44,0
622,8216,PR09vSIT2XyOVxXQjGmEX911FaSVIYTE,SpATywNh6bZuzm8s1ceuBUnMUAeoAHHw,17,22,9,14,4,3,11,1,64,9.142857142857142,5,0.0,6,9,13,4,16,3,1,11,1,32,32,1
623,8223,nx1z63DgmeEAxW8gQgEbpcNs34kbRne4,bWdj2GDclj5ofokWjzoa5jAwMkxCykd6,2,0,0,0,0,0,10,0,10,1.4285714285714286,5,0.0,0,0,0,0,0,0,0,10,0,0,10,1
624,8224,5u57vWlYBlYDQJhbIpJzLY4ZLMAv0Mtf,SpATywNh6bZuzm8s1ceuBUnMUAeoAHHw,28,38,12,29,10,34,13,5,141,20.142857142857142,3,0.0,16,12,27,10,22,34,2,13,5,65,76,1
625,8234,1IMOvf9v1bRH0tUTRkiIkzGe833lnAgf,SpATywNh6bZuzm8s1ceuBUnMUAeoAHHw,27,33,14,20,7,2,4,0,80,11.428571428571429,2,0.0,14,14,16,7,19,2,4,4,0,51,29,1
626,8235,gNTGzjcOmHTKgzmUa0veV0Pk7aaKxz1N,SpATywNh6bZuzm8s1ceuBUnMUAeoAHHw,15,27,3,28,0,12,3,0,73,10.428571428571429,1,0.0,14,3,23,0,13,12,5,3,0,40,33,0
627,8241,EV3yvBrX41XoJgzc87hp5TvHhhtAvyFn,SpATywNh6bZuzm8s1ceuBUnMUAeoAHHw,26,38,19,28,8,0,8,0,101,14.428571428571429,3,0.0,8,19,26,8,30,0,2,8,0,61,40,1
628,8242,3mL78JhEm154Hwp0XQW8ZVuzbvUw5uCk,SpATywNh6bZuzm8s1ceuBUnMUAeoAHHw,24,56,29,3,14,2,11,1,116,16.571428571428573,5,0.0,9,29,3,14,47,2,0,11,1,55,61,0
629,8252,HKDSRzc7MQzCfJsk49D6xFQK4oFHHvy7,SpATywNh6bZuzm8s1ceuBUnMUAeoAHHw,21,59,0,38,0,7,32,1,137,19.571428571428573,5,0.0,28,0,32,0,31,7,6,32,1,60,77,0
630,8258,JTNAXWhf5PjT17BvIH89SNZsmQ5O87y8,SpATywNh6bZuzm8s1ceuBUnMUAeoAHHw,17,22,7,21,4,0,2,0,56,8.0,1,0.0,14,7,21,4,8,0,0,2,0,46,10,1
631,8259,DVIil2NM7ZWOtqe6rhlMzwEUAb2wuaeh,bWdj2GDclj5ofokWjzoa5jAwMkxCykd6,16,39,24,46,14,7,7,0,137,19.571428571428573,4,0.0,10,24,46,14,29,7,0,7,0,94,43,0
632,8260,DVIil2NM7ZWOtqe6rhlMzwEUAb2wuaeh,A3fsA9Zfv1X2fVEQhTw51lKENdNrEqT3,44,76,54,39,21,15,14,0,219,31.285714285714285,5,0.0,4,54,39,21,72,15,0,14,0,118,101,0
633,8271,Bf5XnSmEHpp62KAmmEq9Qh5nAQvits8I,SpATywNh6bZuzm8s1ceuBUnMUAeoAHHw,17,26,17,7,11,7,9,1,78,11.142857142857142,4,0.0,9,17,7,11,17,7,0,9,1,44,34,1
634,8274,wcD7BoyQ6hUK2AqYmriY7H2V7sWuy6kP,G8EPVSXsOYB5YQWZGiz1aVq5Pgr2GrQu,6,2,0,0,0,1,6,1,10,1.4285714285714286,1,0.0,0,0,0,0,2,1,0,6,1,0,10,1
635,8275,GHabqgRgi0KXSBTYXxIc3mcQESEOp0QM,SpATywNh6bZuzm8s1ceuBUnMUAeoAHHw,10,8,4,2,1,23,14,1,53,7.571428571428571,3,0.0,1,4,2,1,7,23,0,14,1,8,45,0
636,8276,V7y3ErWDx79HQwDxdGqBqCI3nEwG2a9C,SpATywNh6bZuzm8s1ceuBUnMUAeoAHHw,16,25,2,8,1,37,23,1,97,13.857142857142858,4,0.0,2,2,7,1,23,37,1,23,1,12,85,0
637,8280,41Lg2hcbw0N9iuSjhrPTYqB7aTnux5zG,SpATywNh6bZuzm8s1ceuBUnMUAeoAHHw,28,44,20,24,7,0,16,0,111,15.857142857142858,8,0.0,4,20,23,7,40,0,1,16,0,54,57,0
638,8299,SYTowVKdp8XatPrqrpe4A3JAMuYI5Sox,A3fsA9Zfv1X2fVEQhTw51lKENdNrEqT3,3,3,0,0,0,0,2,0,5,0.7142857142857143,1,0.0,0,0,0,0,3,0,0,2,0,0,5,1
639,8306,cpsVaqCE0ju1HgyRTcGi2lL27KFxQlQV,G8EPVSXsOYB5YQWZGiz1aVq5Pgr2GrQu,13,38,2,0,2,33,16,0,91,13.0,3,0.0,0,2,0,2,38,33,0,16,0,4,87,1
640,8307,U091mKrbkiTDzf4rGIqu8muSeBSZhUjL,A3fsA9Zfv1X2fVEQhTw51lKENdNrEqT3,37,18,10,76,6,0,4,0,114,16.285714285714285,2,0.0,5,10,61,6,13,0,15,4,0,82,32,1
641,8319,VzKWDpKk4q6OejBxKl56odCKiGjlmGba,SpATywNh6bZuzm8s1ceuBUnMUAeoAHHw,7,3,2,0,2,0,2,0,9,1.2857142857142858,1,0.0,0,2,0,2,3,0,0,2,0,4,5,1
642,8327,Rxx8uEqY3FOt7Egy2EEEwihJJCyVsQKy,G8EPVSXsOYB5YQWZGiz1aVq5Pgr2GrQu,86,112,48,129,35,15,28,4,371,53.0,6,0.0,49,48,93,35,63,15,36,28,4,225,146,0
643,8330,RPoQoiLJoTfoUXTEomWL6iW4S8GRhX7J,SpATywNh6bZuzm8s1ceuBUnMUAeoAHHw,13,23,8,17,3,0,5,0,56,8.0,4,0.0,4,8,14,3,19,0,3,5,0,29,27,0
644,8335,2tvGCUYYinrGZmVDaUEHPItUSSMqiKmY,SpATywNh6bZuzm8s1ceuBUnMUAeoAHHw,29,44,28,29,15,0,9,0,125,17.857142857142858,5,0.0,8,28,27,15,36,0,2,9,0,78,47,0
645,8336,UgRvVqO3twMvJzAlD49rqrTbxTS8yLpX,A3fsA9Zfv1X2fVEQhTw51lKENdNrEqT3,23,18,14,0,9,0,7,0,48,6.857142857142857,3,0.0,0,14,0,9,18,0,0,7,0,23,25,1
646,8337,SP1OGXx7XA1zodabwHSZpThCzaY2Fjl2,SpATywNh6bZuzm8s1ceuBUnMUAeoAHHw,20,33,6,22,2,21,11,0,95,13.571428571428571,8,0.0,6,6,21,2,27,21,1,11,0,35,60,0
647,8347,jMKMopo0fDIDt1YMaxiGrP1SNRt3VtFz,SpATywNh6bZuzm8s1ceuBUnMUAeoAHHw,16,24,11,14,6,3,4,0,62,8.857142857142858,1,0.0,11,11,13,6,13,3,1,4,0,41,21,0
648,8359,xI8Nr9tpm5UYMfkPTEK7ZnHqHm9s1zwr,SpATywNh6bZuzm8s1ceuBUnMUAeoAHHw,15,28,0,19,0,2,7,1,57,8.142857142857142,4,0.0,6,0,16,0,22,2,3,7,1,22,35,1
649,8372,Ja8xgxpUQSylPcWwfGyX1RUCUJ6MhJqT,SpATywNh6bZuzm8s1ceuBUnMUAeoAHHw,6,3,1,0,1,0,2,0,7,1.0,1,0.0,0,1,0,1,3,0,0,2,0,2,5,0
650,8374,eA2IVnHLbAPJoKRWHDe6zYszLSF4Gt3f,SpATywNh6bZuzm8s1ceuBUnMUAeoAHHw,5,2,1,0,1,1,2,0,7,1.0,1,0.0,0,1,0,1,2,1,0,2,0,2,5,1
651,8386,UkUsH963uedhLI1tDU35ug9sCdholLWP,SpATywNh6bZuzm8s1ceuBUnMUAeoAHHw,1,0,0,0,0,0,1,0,1,0.14285714285714285,1,0.0,0,0,0,0,0,0,0,1,0,0,1,1
652,8389,NngMZQTGAdrhmbSK51CUolNQSpFXDhiO,SpATywNh6bZuzm8s1ceuBUnMUAeoAHHw,31,70,34,21,12,6,32,1,176,25.142857142857142,6,0.0,15,34,18,12,55,6,3,32,1,79,97,0
653,8391,tF8i4h1a2Nm3JCN3xA7kONOWBOERcJ4Q,SpATywNh6bZuzm8s1ceuBUnMUAeoAHHw,29,40,19,47,8,2,11,0,127,18.142857142857142,4,0.0,16,19,38,8,24,2,9,11,0,81,46,0
654,8393,4sCPuVlkq4rBRlBYNyTR5EDg94co1oy4,bWdj2GDclj5ofokWjzoa5jAwMkxCykd6,7,5,2,0,1,0,5,0,13,1.8571428571428572,2,0.0,0,2,0,1,5,0,0,5,0,3,10,0
655,8400,LutlROyPHhGEkAfetUikskFihdvWMQNQ,SpATywNh6bZuzm8s1ceuBUnMUAeoAHHw,7,2,1,0,1,0,9,0,13,1.8571428571428572,3,0.0,0,1,0,1,2,0,0,9,0,2,11,1
656,8405,kWUbu8oK1dFJKpHhiF15MwcSzNzv8GaS,bWdj2GDclj5ofokWjzoa5jAwMkxCykd6,18,49,25,96,12,25,13,0,220,31.428571428571427,5,0.0,10,25,91,12,39,25,5,13,0,138,82,0
657,8416,mrUvSMVJRVrLlCOcTH6rs5HGHSxrWvwY,A3fsA9Zfv1X2fVEQhTw51lKENdNrEqT3,42,28,16,60,11,1,8,1,125,17.857142857142858,3,0.0,7,16,50,11,21,1,10,8,1,84,41,1
658,8431,7CBtPeICctNtzQffl1jHApp4Y7WIYc5w,SpATywNh6bZuzm8s1ceuBUnMUAeoAHHw,7,6,5,0,2,0,2,0,15,2.142857142857143,1,0.0,0,5,0,2,6,0,0,2,0,7,8,1
659,8435,j1jdy8OF5VQw4rqSYOkbK2pQplvvvz37,A3fsA9Zfv1X2fVEQhTw51lKENdNrEqT3,55,93,16,70,12,13,47,0,251,35.857142857142854,10,0.0,4,16,58,12,89,13,12,47,0,90,161,0
660,8437,12tfSRcVHU1LY6VYbYjnNdGrVUGUAhWB,SpATywNh6bZuzm8s1ceuBUnMUAeoAHHw,30,44,24,16,11,3,13,1,112,16.0,5,0.0,13,24,14,11,31,3,2,13,1,62,50,0
661,8446,oDnQYjxji4p3XVFJMOGI9NvIvASqoqC1,A3fsA9Zfv1X2fVEQhTw51lKENdNrEqT3,31,18,15,34,12,0,17,0,96,13.714285714285714,5,0.0,0,15,28,12,18,0,6,17,0,55,41,1
662,8447,gok0oMg5xY1pC9HgrOtGpZy6NUwXLxlf,SpATywNh6bZuzm8s1ceuBUnMUAeoAHHw,9,30,0,6,0,1,13,0,50,7.142857142857143,4,0.0,2,0,5,0,28,1,1,13,0,7,43,1
663,8456,Ve3uiMw5Q81FgfkGuxFl4mQAXBScEtc6,G8EPVSXsOYB5YQWZGiz1aVq5Pgr2GrQu,3,0,0,0,0,0,5,0,5,0.7142857142857143,1,0.0,0,0,0,0,0,0,0,5,0,0,5,1
664,8461,tH916xRbn4bSZXJ6Z57PlnTAPQfz04PX,SpATywNh6bZuzm8s1ceuBUnMUAeoAHHw,22,20,12,2,6,0,8,0,48,6.857142857142857,4,0.0,1,12,2,6,19,0,0,8,0,21,27,0
665,8473,wfFQgTOVxHIMKx1Ficu9NrZPRH0gMksQ,bWdj2GDclj5ofokWjzoa5jAwMkxCykd6,3,3,0,0,0,0,1,0,4,0.5714285714285714,1,0.0,0,0,0,0,3,0,0,1,0,0,4,1
666,8476,iUNH7SHIFk6NFV7H1Nzzf4QPKBlc8jre,SpATywNh6bZuzm8s1ceuBUnMUAeoAHHw,9,5,4,0,4,0,2,0,15,2.142857142857143,1,0.0,0,4,0,4,5,0,0,2,0,8,7,1
667,8486,BeZnyZhcScrHr8WAPYtxUxDjMPiK7yK1,SpATywNh6bZuzm8s1ceuBUnMUAeoAHHw,19,37,20,0,10,0,10,0,77,11.0,6,0.0,4,20,0,10,33,0,0,10,0,34,43,0
668,8492,ttr9a170CwLt0wxJRJXz9h6pCGNxEiGM,SpATywNh6bZuzm8s1ceuBUnMUAeoAHHw,8,11,0,0,0,0,6,0,17,2.4285714285714284,4,0.0,0,0,0,0,11,0,0,6,0,0,17,1
669,8494,gir9E9ZUbwj6bCUNLD2kQmOx1nsVwG4J,SpATywNh6bZuzm8s1ceuBUnMUAeoAHHw,26,52,22,14,11,13,15,1,128,18.285714285714285,5,0.0,15,22,14,11,37,13,0,15,1,62,66,1
670,8503,PtXR7nBc6ugMebaEp6mKjp0TYO5kZtvE,SpATywNh6bZuzm8s1ceuBUnMUAeoAHHw,32,76,40,36,17,21,19,1,210,30.0,9,0.0,23,40,30,17,53,21,6,19,1,110,100,0
671,8511,FjbDR3UaxcNBkb6IH3GDQCUcWtWdh8Qq,A3fsA9Zfv1X2fVEQhTw51lKENdNrEqT3,17,8,5,46,2,0,3,0,64,9.142857142857142,2,0.0,1,5,37,2,7,0,9,3,0,45,19,1
672,8519,doRePDFWyZgA5bRcL7NARsAGKc9EfIRX,SpATywNh6bZuzm8s1ceuBUnMUAeoAHHw,1,0,0,0,0,0,1,0,1,0.14285714285714285,1,0.0,0,0,0,0,0,0,0,1,0,0,1,1
673,8534,sYJH30p3sjRgvjLciMuuEKpuHxukMGmh,bWdj2GDclj5ofokWjzoa5jAwMkxCykd6,13,13,4,12,4,2,11,2,48,6.857142857142857,2,0.0,5,4,10,4,8,2,2,11,2,23,25,1
674,8539,ApFdQQBcLqTLoA4wIvtlnnwFs4FrlVS1,A3fsA9Zfv1X2fVEQhTw51lKENdNrEqT3,53,34,27,84,17,1,22,1,186,26.571428571428573,6,0.0,3,27,72,17,31,1,12,22,1,119,67,0
675,8542,DALf49Q7nGCtSxipmkha0WYpWi5x67si,SpATywNh6bZuzm8s1ceuBUnMUAeoAHHw,26,51,5,33,5,9,32,4,139,19.857142857142858,3,0.0,14,5,29,5,37,9,4,32,4,53,86,1
676,8552,pSX00XUyCx7VlmgWGN0d39OwC9BZ8bRV,A3fsA9Zfv1X2fVEQhTw51lKENdNrEqT3,44,19,14,46,9,3,8,0,99,14.142857142857142,2,0.0,1,14,43,9,18,3,3,8,0,67,32,1
677,8554,R2LGboNcUADM1LGFGgPuEpT43AraZJb1,SpATywNh6bZuzm8s1ceuBUnMUAeoAHHw,2,0,0,0,0,0,2,0,2,0.2857142857142857,1,0.0,0,0,0,0,0,0,0,2,0,0,2,1
678,8562,2YohZ5UKGzy1qUgVAShosLdhgm3pfvsR,RXDvfPUBYFlVdlueBFbLW0mhhAyGEqpt,21,26,4,21,3,0,7,11,72,10.285714285714286,4,0.0,5,4,20,3,21,0,1,7,11,32,40,1
679,8576,HHsJECDPslzJS0fyoCEbSGrnL1evzSJb,SpATywNh6bZuzm8s1ceuBUnMUAeoAHHw,10,13,5,0,3,3,7,2,33,4.714285714285714,3,0.0,3,5,0,3,10,3,0,7,2,11,22,0
680,8578,ctoSfpAfvm3av2aqkT0D3Yq8icDxZKCx,SpATywNh6bZuzm8s1ceuBUnMUAeoAHHw,7,7,2,0,2,0,6,0,17,2.4285714285714284,4,0.0,1,2,0,2,6,0,0,6,0,5,12,1
681,8579,5SaN6rc1Jws1AbkuHmPyLN82qDTc23Xp,SpATywNh6bZuzm8s1ceuBUnMUAeoAHHw,8,6,0,10,0,1,7,0,24,3.4285714285714284,2,0.0,0,0,7,0,6,1,3,7,0,7,17,1
682,8580,NbSKhx4CxJyTkjcYgC3wEU9PLylFddj5,SpATywNh6bZuzm8s1ceuBUnMUAeoAHHw,26,84,2,25,3,47,27,6,194,27.714285714285715,5,0.0,43,2,22,3,41,47,3,27,6,70,124,0
683,8589,QiGOPB8shOtQ5nbvOvvOxzT1SShMMuAf,SpATywNh6bZuzm8s1ceuBUnMUAeoAHHw,28,34,11,45,7,5,5,0,107,15.285714285714286,2,0.0,13,11,37,7,21,5,8,5,0,68,39,0
684,8590,tQHFI5lya7DKbCzO4oTkHd2600sh8kNe,G8EPVSXsOYB5YQWZGiz1aVq5Pgr2GrQu,20,20,7,38,5,0,3,0,73,10.428571428571429,2,0.0,9,7,30,5,11,0,8,3,0,51,22,1
685,8603,NDWoO09mCIeS4HdBeNYH7dNkyhIv3eXv,SpATywNh6bZuzm8s1ceuBUnMUAeoAHHw,25,30,2,23,1,14,9,2,81,11.571428571428571,3,0.0,8,2,21,1,22,14,2,9,2,32,49,1
686,8610,YPO9VbNOFh7KZMXyxOJMSk1iTNwVpJOe,SpATywNh6bZuzm8s1ceuBUnMUAeoAHHw,11,12,0,12,0,0,6,0,30,4.285714285714286,1,0.0,6,0,11,0,6,0,1,6,0,17,13,0
687,8617,ls4yyZ7MYyWiEmQ5nJV5QAmKdBgFaV8n,G8EPVSXsOYB5YQWZGiz1aVq5Pgr2GrQu,51,99,35,114,16,0,17,0,281,40.142857142857146,5,0.0,61,35,81,16,38,0,33,17,0,193,88,1
688,8622,Y7IgoRAqVJfNlsulCSI4HObujHPSzoLA,A3fsA9Zfv1X2fVEQhTw51lKENdNrEqT3,13,8,6,0,5,0,2,0,21,3.0,2,0.0,0,6,0,5,8,0,0,2,0,11,10,1
689,8626,yq8YyMugEpZrcWzhPtzidXoqQsPJ81ZJ,G8EPVSXsOYB5YQWZGiz1aVq5Pgr2GrQu,4,2,0,0,0,1,3,0,6,0.8571428571428571,2,0.0,0,0,0,0,2,1,0,3,0,0,6,1
690,8635,jH123vWnpYTVLfmuSyled9Oau0AYvcx6,G8EPVSXsOYB5YQWZGiz1aVq5Pgr2GrQu,40,18,1,118,1,0,6,0,144,20.571428571428573,2,0.0,0,1,103,1,18,0,15,6,0,105,39,1
691,8637,YeutUTPU1KeBL2Vd5ZhxL2fFNQ8D7NVG,SpATywNh6bZuzm8s1ceuBUnMUAeoAHHw,17,43,13,12,3,11,18,3,103,14.714285714285714,2,0.0,21,13,12,3,22,11,0,18,3,49,54,1
692,8638,kXndrjnvT5RUWACXG428KqXdIpBxsEit,A3fsA9Zfv1X2fVEQhTw51lKENdNrEqT3,12,22,0,0,0,2,11,1,36,5.142857142857143,3,0.0,1,0,0,0,21,2,0,11,1,1,35,1
693,8639,xqboiFlp42vyY93nDStsbVWBCL5sgIRH,SpATywNh6bZuzm8s1ceuBUnMUAeoAHHw,5,2,1,0,1,0,4,0,8,1.1428571428571428,1,0.0,0,1,0,1,2,0,0,4,0,2,6,1
694,8644,4PVAcJZJLiNhJa8rMcHaqBMuPaZIl5Nm,SpATywNh6bZuzm8s1ceuBUnMUAeoAHHw,27,30,17,27,11,0,13,0,98,14.0,4,0.0,7,17,23,11,23,0,4,13,0,58,40,1
695,8647,pZDK7WA5fQeGMPFsats2GLmFnZbZQ7ed,SpATywNh6bZuzm8s1ceuBUnMUAeoAHHw,24,49,22,26,6,15,14,1,133,19.0,5,0.0,16,22,23,6,33,15,3,14,1,67,66,1
696,8654,nquBmikiqPFYvs17N894M5iUc88scoVO,SpATywNh6bZuzm8s1ceuBUnMUAeoAHHw,21,70,4,38,1,40,28,2,183,26.142857142857142,4,0.0,8,4,31,1,62,40,7,28,2,44,139,0
697,8661,CxzZVyClE1BEgH3USSirqOtKD3HSH7vg,SpATywNh6bZuzm8s1ceuBUnMUAeoAHHw,17,17,8,12,4,0,6,2,49,7.0,2,0.0,2,8,11,4,15,0,1,6,2,25,24,1
698,8679,kyUPY0MEVeZNvkmrQxOn0CHNXLZiD03b,A3fsA9Zfv1X2fVEQhTw51lKENdNrEqT3,10,24,2,0,1,10,8,0,45,6.428571428571429,5,0.0,3,2,0,1,21,10,0,8,0,6,39,1
699,8691,ESjXyWS3x5wlkZHp5KISOO9gy5mDNyIG,SpATywNh6bZuzm8s1ceuBUnMUAeoAHHw,9,21,10,0,5,0,10,0,46,6.571428571428571,5,0.0,2,10,0,5,19,0,0,10,0,17,29,1
700,8700,je9A6l6tP7wnbFhNJD7vbbHTYhqshuqB,G8EPVSXsOYB5YQWZGiz1aVq5Pgr2GrQu,46,127,46,76,16,5,13,0,283,40.42857142857143,9,0.0,36,46,57,16,91,5,19,13,0,155,128,0
701,8701,kxC3AAELak9RRmJoG2dzH7rfP0Xyo0FH,SpATywNh6bZuzm8s1ceuBUnMUAeoAHHw,15,24,16,4,7,0,6,0,57,8.142857142857142,3,0.0,0,16,4,7,24,0,0,6,0,27,30,1
702,8706,4G8PB07c1AYOLDoNxj95BoxFXM7YCCci,SpATywNh6bZuzm8s1ceuBUnMUAeoAHHw,3,2,0,0,0,0,1,0,3,0.42857142857142855,1,0.0,0,0,0,0,2,0,0,1,0,0,3,1
703,8708,nzGzo6fW6QPE9hjoabI90qrzv3llY1Fg,G8EPVSXsOYB5YQWZGiz1aVq5Pgr2GrQu,12,17,6,0,3,0,5,0,31,4.428571428571429,2,0.0,2,6,0,3,15,0,0,5,0,11,20,1
704,8711,MQxVHrLqN67CEKfOyyeFlttLUKuqvrcv,RXDvfPUBYFlVdlueBFbLW0mhhAyGEqpt,1,0,0,0,0,0,1,0,1,0.14285714285714285,1,0.0,0,0,0,0,0,0,0,1,0,0,1,0
705,8730,JoruyAOmEeM1qjcSEWRUjLvQUHpNPZGp,RXDvfPUBYFlVdlueBFbLW0mhhAyGEqpt,52,116,3,107,8,88,37,9,368,52.57142857142857,7,0.0,24,3,91,8,92,88,16,37,9,126,242,1
706,8735,WNT8mFhPmDPRuQT8JLsnindelSr1MnST,SpATywNh6bZuzm8s1ceuBUnMUAeoAHHw,30,42,22,34,8,39,21,3,169,24.142857142857142,4,0.0,14,22,29,8,28,39,5,21,3,73,96,1
707,8747,WuOqx5J7nUG7M0CzOeQJHpDiW7DgSS7B,SpATywNh6bZuzm8s1ceuBUnMUAeoAHHw,16,31,1,24,1,2,3,0,62,8.857142857142858,1,0.0,15,1,20,1,16,2,4,3,0,37,25,1
708,8758,NCbFqYNTEfc5vPQvAyBwDtnbS3ENYJY7,bWdj2GDclj5ofokWjzoa5jAwMkxCykd6,12,22,1,37,3,3,14,2,82,11.714285714285714,2,0.0,7,1,35,3,15,3,2,14,2,46,36,1
709,8759,9SPQ1jfplQbke9byQIAxTVMFCooGS54y,A3fsA9Zfv1X2fVEQhTw51lKENdNrEqT3,16,10,5,0,4,4,8,1,32,4.571428571428571,1,0.0,2,5,0,4,8,4,0,8,1,11,21,1
710,8761,7ye3FQXc4XBmC7UwnNQWxsWGDnaNcvG6,SpATywNh6bZuzm8s1ceuBUnMUAeoAHHw,23,32,0,34,0,3,6,1,76,10.857142857142858,2,0.0,5,0,29,0,27,3,5,6,1,34,42,1
711,8780,l7cIWSn2QdqLoOKMFO8yNQGKfk999nJh,A3fsA9Zfv1X2fVEQhTw51lKENdNrEqT3,5,7,3,0,0,0,2,0,12,1.7142857142857142,2,0.0,2,3,0,0,5,0,0,2,0,5,7,1
712,8791,E2VKNfvaS8HbcvRZooqcq8161JUOvad2,RXDvfPUBYFlVdlueBFbLW0mhhAyGEqpt,14,23,12,0,4,0,5,0,44,6.285714285714286,3,0.0,1,12,0,4,22,0,0,5,0,17,27,1
713,8793,Ga4lr67F0RIjyUetWH1EgQ3xzSHDnViF,bWdj2GDclj5ofokWjzoa5jAwMkxCykd6,19,28,16,64,7,3,9,1,128,18.285714285714285,3,0.0,7,16,62,7,21,3,2,9,1,92,36,0
714,8794,br8lmEhz6IHlXV0QfsU4Spi9BczfMT8x,SpATywNh6bZuzm8s1ceuBUnMUAeoAHHw,20,29,12,32,0,0,4,0,77,11.0,2,0.0,15,12,29,0,14,0,3,4,0,56,21,0
715,8803,RFvs5NuNtACNU2U9ElWUm5Jw7rHjvZwP,SpATywNh6bZuzm8s1ceuBUnMUAeoAHHw,6,5,4,0,2,0,1,0,12,1.7142857142857142,1,0.0,0,4,0,2,5,0,0,1,0,6,6,1
716,8809,ivdkzhYPhrTUKnU1xY68Yfp2rdDhgD3h,SpATywNh6bZuzm8s1ceuBUnMUAeoAHHw,18,52,21,16,10,31,38,3,171,24.428571428571427,4,0.0,17,21,15,10,35,31,1,38,3,63,108,0
717,8814,8IuzZOXaXVUql9pLZtNuJIyLoDJ8ZL4V,SpATywNh6bZuzm8s1ceuBUnMUAeoAHHw,15,23,8,6,3,1,6,0,47,6.714285714285714,4,0.0,4,8,6,3,19,1,0,6,0,21,26,0
718,8815,Ga4lr67F0RIjyUetWH1EgQ3xzSHDnViF,A3fsA9Zfv1X2fVEQhTw51lKENdNrEqT3,1,0,0,0,0,0,1,0,1,0.14285714285714285,1,0.0,0,0,0,0,0,0,0,1,0,0,1,1
719,8852,1sf1a7OMEvwky5hvLFD12TaOsmoNw2Qb,SpATywNh6bZuzm8s1ceuBUnMUAeoAHHw,25,51,21,24,9,0,6,0,111,15.857142857142858,4,0.0,10,21,24,9,41,0,0,6,0,64,47,0
720,8860,IwB6SmnBZExRlnmOtkIDRkNteqe5iWyf,SpATywNh6bZuzm8s1ceuBUnMUAeoAHHw,1,0,0,0,0,0,1,0,1,0.14285714285714285,1,0.0,0,0,0,0,0,0,0,1,0,0,1,1
721,8865,Up0SfqXbbz6NGY2S4ku6GM2FOwYrzCdN,SpATywNh6bZuzm8s1ceuBUnMUAeoAHHw,1,0,0,0,0,0,1,0,1,0.14285714285714285,1,0.0,0,0,0,0,0,0,0,1,0,0,1,1
722,8870,ZNWyxGsQnaw3e5XPyIUr5rwKsBrD0VQe,G8EPVSXsOYB5YQWZGiz1aVq5Pgr2GrQu,8,21,1,0,2,0,4,0,28,4.0,1,0.0,8,1,0,2,13,0,0,4,0,11,17,0
723,8900,fY0uxi2rFKNgoTYTvIZdgXrk3XKUTjS3,SpATywNh6bZuzm8s1ceuBUnMUAeoAHHw,14,20,5,13,3,0,2,0,43,6.142857142857143,1,0.0,4,5,13,3,16,0,0,2,0,25,18,0
724,8904,0QFADiD6IvsCiGKcRzsLQbDvaZGh6BVG,SpATywNh6bZuzm8s1ceuBUnMUAeoAHHw,9,9,2,0,2,0,3,0,16,2.2857142857142856,2,0.0,0,2,0,2,9,0,0,3,0,4,12,0
725,8917,5vUuq5ZeDCNce4LmvH0naoUjpb3qbNOp,SpATywNh6bZuzm8s1ceuBUnMUAeoAHHw,18,17,9,14,3,8,14,1,66,9.428571428571429,6,0.0,3,9,11,3,14,8,3,14,1,26,40,1
726,8925,PenDUeO0eoR8hyLVdfPN6H7q2FnTGMus,A3fsA9Zfv1X2fVEQhTw51lKENdNrEqT3,12,16,8,0,1,32,22,1,80,11.428571428571429,4,0.0,0,8,0,1,16,32,0,22,1,9,71,0
727,8929,1oBn81XXDSWJtnCZIRPmhZcBWe7qP0iB,RXDvfPUBYFlVdlueBFbLW0mhhAyGEqpt,61,103,65,145,28,2,27,0,370,52.857142857142854,8,0.0,19,65,133,28,84,2,12,27,0,245,125,1
728,8934,H3CmwGihecRb7lZltIA7orKjensSqIgF,RXDvfPUBYFlVdlueBFbLW0mhhAyGEqpt,16,21,3,0,4,12,2,0,42,6.0,3,0.0,2,3,0,4,19,12,0,2,0,9,33,1
729,8935,pYasYOOyUapjKdoqnDhFpArs52eNDPLb,SpATywNh6bZuzm8s1ceuBUnMUAeoAHHw,25,31,19,34,8,1,11,0,104,14.857142857142858,6,0.0,5,19,29,8,26,1,5,11,0,61,43,0
730,8945,Iupcx1vHh7MTin0aJweHjQkwiErp9HHL,SpATywNh6bZuzm8s1ceuBUnMUAeoAHHw,5,2,1,0,1,0,2,0,6,0.8571428571428571,1,0.0,0,1,0,1,2,0,0,2,0,2,4,1
731,8956,JtMmp5BCDQnYE7CMI3NvnX4aRCZsQW9K,bWdj2GDclj5ofokWjzoa5jAwMkxCykd6,16,32,14,0,8,9,55,2,120,17.142857142857142,12,0.0,4,14,0,8,28,9,0,55,2,26,94,0
732,8966,qFpdcx3mtZSSE0KVCMsIlMdOIeoOzyoo,SpATywNh6bZuzm8s1ceuBUnMUAeoAHHw,21,54,14,19,1,2,28,2,120,17.142857142857142,10,0.0,11,14,15,1,43,2,4,28,2,41,79,0
733,8971,p04QzukP32kpPk8EGoBhDUGJJQqJUoNz,SpATywNh6bZuzm8s1ceuBUnMUAeoAHHw,28,69,10,18,6,30,33,6,172,24.571428571428573,8,0.0,14,10,18,6,55,30,0,33,6,48,124,0
734,8990,d50bzrDUj3g2Xiqt1t5CNiAegqkJwLeY,SpATywNh6bZuzm8s1ceuBUnMUAeoAHHw,15,19,2,0,2,1,7,1,32,4.571428571428571,1,0.0,5,2,0,2,14,1,0,7,1,9,23,1
735,8991,N16QHS59cTDWe3hpSKjuHvn5eRO4wcEE,SpATywNh6bZuzm8s1ceuBUnMUAeoAHHw,7,6,3,0,2,0,3,0,14,2.0,1,0.0,0,3,0,2,6,0,0,3,0,5,9,1
736,9002,L534Da3JB50xKXQoTXrCa1H5GVkKxZyU,SpATywNh6bZuzm8s1ceuBUnMUAeoAHHw,8,5,2,0,2,0,4,0,13,1.8571428571428572,1,0.0,0,2,0,2,5,0,0,4,0,4,9,1
737,9011,sNZ43ghPU2QwNk3cu7wYztVZWvmkGmKL,SpATywNh6bZuzm8s1ceuBUnMUAeoAHHw,25,36,18,28,5,4,5,0,96,13.714285714285714,4,0.0,8,18,27,5,28,4,1,5,0,58,38,0
738,9015,3BQ5hO2xolpwYa13L4VN9VBwShRsjOB9,A3fsA9Zfv1X2fVEQhTw51lKENdNrEqT3,17,9,7,0,6,0,4,0,26,3.7142857142857144,1,0.0,0,7,0,6,9,0,0,4,0,13,13,1
739,9017,a5tgLYkHndhh8Yb10TacQs9Vi34mi45u,RXDvfPUBYFlVdlueBFbLW0mhhAyGEqpt,14,10,6,1,3,1,8,1,30,4.285714285714286,1,0.0,3,6,1,3,7,1,0,8,1,13,17,0
740,9018,pVooF8yxRpciMTpPCaLN6jM2lWrWpauA,SpATywNh6bZuzm8s1ceuBUnMUAeoAHHw,7,4,2,0,0,2,7,1,16,2.2857142857142856,1,0.0,1,2,0,0,3,2,0,7,1,3,13,1
741,9023,K7xeVolEtXE0AogXgMn5GEzQ96UioEwW,SpATywNh6bZuzm8s1ceuBUnMUAeoAHHw,16,16,8,0,8,0,1,0,33,4.714285714285714,1,0.0,4,8,0,8,12,0,0,1,0,20,13,1
742,9031,L534Da3JB50xKXQoTXrCa1H5GVkKxZyU,bWdj2GDclj5ofokWjzoa5jAwMkxCykd6,5,2,1,0,1,0,2,0,6,0.8571428571428571,1,0.0,0,1,0,1,2,0,0,2,0,2,4,1
743,9040,AoGNGJBevj5UJJAo0rhBglhkcP4W6WBy,bWdj2GDclj5ofokWjzoa5jAwMkxCykd6,1,0,0,0,0,0,1,0,1,0.14285714285714285,1,0.0,0,0,0,0,0,0,0,1,0,0,1,1
744,9041,L534Da3JB50xKXQoTXrCa1H5GVkKxZyU,RXDvfPUBYFlVdlueBFbLW0mhhAyGEqpt,5,2,1,0,1,0,2,0,6,0.8571428571428571,1,0.0,0,1,0,1,2,0,0,2,0,2,4,1
745,9047,bssQsmzoNxPtkllVsM0XyYElvtsPU1iO,A3fsA9Zfv1X2fVEQhTw51lKENdNrEqT3,6,10,1,0,1,0,1,0,13,1.8571428571428572,1,0.0,0,1,0,1,10,0,0,1,0,2,11,1
746,9048,8IYoAw78mc8ysNlcBgXt630ETnnEuaUM,SpATywNh6bZuzm8s1ceuBUnMUAeoAHHw,14,22,1,23,1,0,10,0,57,8.142857142857142,3,0.0,8,1,22,1,14,0,1,10,0,32,25,0
747,9056,WJoD89Bo9NFFK86vx66y3rksOk6ixc2b,SpATywNh6bZuzm8s1ceuBUnMUAeoAHHw,21,30,19,0,11,0,9,0,69,9.857142857142858,2,0.0,2,19,0,11,28,0,0,9,0,32,37,1
748,9064,J782awhmjhWAohIOvWifbZTNvhSxGcmf,RXDvfPUBYFlVdlueBFbLW0mhhAyGEqpt,32,45,29,0,19,0,7,0,100,14.285714285714286,4,0.0,2,29,0,19,43,0,0,7,0,50,50,1
749,9065,6Dq4LTGgUzJAJPwYkedRMadSEQwnkyG3,SpATywNh6bZuzm8s1ceuBUnMUAeoAHHw,7,27,15,0,1,0,11,0,54,7.714285714285714,2,0.0,0,15,0,1,27,0,0,11,0,16,38,1
750,9072,xBNDEDD7fMER9fNR4W15k6QiKRrdBf4x,G8EPVSXsOYB5YQWZGiz1aVq5Pgr2GrQu,51,79,8,116,3,1,15,1,223,31.857142857142858,4,0.0,37,8,81,3,42,1,35,15,1,129,94,1
751,9079,Cb1aR5BeXGrDewkPGGzseNCh6yBNhS9Z,G8EPVSXsOYB5YQWZGiz1aVq5Pgr2GrQu,18,22,8,20,5,0,6,0,61,8.714285714285714,3,0.0,7,8,13,5,15,0,7,6,0,33,28,1
752,9085,q78BjeBORwDIcVH7lRGRd3WfImLmduN4,G8EPVSXsOYB5YQWZGiz1aVq5Pgr2GrQu,18,9,8,0,8,0,3,0,28,4.0,1,0.0,0,8,0,8,9,0,0,3,0,16,12,1
753,9100,0K6JPqiivQzicxY4EV4nqMLCL3a08A97,bWdj2GDclj5ofokWjzoa5jAwMkxCykd6,13,19,6,10,8,0,18,0,61,8.714285714285714,4,0.0,6,6,10,8,13,0,0,18,0,30,31,0
754,9112,XDPvGyFLLEYwbNEQik2MM4yiADs5rrYJ,bWdj2GDclj5ofokWjzoa5jAwMkxCykd6,9,7,4,0,3,0,2,0,16,2.2857142857142856,1,0.0,1,4,0,3,6,0,0,2,0,8,8,0
755,9118,ZPIRNChg4KaoHQC5y65LKyeBd78COsQH,A3fsA9Zfv1X2fVEQhTw51lKENdNrEqT3,8,4,3,0,3,0,1,0,11,1.5714285714285714,1,0.0,0,3,0,3,4,0,0,1,0,6,5,1
756,9124,0mJoMFAp6vm88Kg6ltLw74tsdf8pNH48,SpATywNh6bZuzm8s1ceuBUnMUAeoAHHw,8,6,2,0,2,0,2,0,12,1.7142857142857142,1,0.0,0,2,0,2,6,0,0,2,0,4,8,0
757,9125,8NRsKZ3hMeinWXhN3qtntd7OTP25jyWY,bWdj2GDclj5ofokWjzoa5jAwMkxCykd6,13,13,6,14,5,0,3,0,41,5.857142857142857,2,0.0,3,6,14,5,10,0,0,3,0,28,13,1
758,9128,bZSiNUbAIuydDBd77IMAJ15Hy6k2A1kT,bWdj2GDclj5ofokWjzoa5jAwMkxCykd6,11,17,10,30,3,6,7,1,74,10.571428571428571,2,0.0,1,10,28,3,16,6,2,7,1,42,32,1
759,9129,x8EozFE9amTkjsgRipu221C7Pejcw9dl,RXDvfPUBYFlVdlueBFbLW0mhhAyGEqpt,37,83,23,18,13,42,46,3,228,32.57142857142857,7,0.0,0,23,17,13,83,42,1,46,3,53,175,1
760,9132,AkJ8njZZaMlqYX3miC2oUBlMGg9ZSm2E,SpATywNh6bZuzm8s1ceuBUnMUAeoAHHw,23,34,0,31,0,9,15,1,90,12.857142857142858,3,0.0,12,0,29,0,22,9,2,15,1,41,49,1
761,9137,rD3x5Ovuza1MLiqkvaHksaL42hepSLSa,A3fsA9Zfv1X2fVEQhTw51lKENdNrEqT3,24,39,19,0,11,5,10,0,84,12.0,4,0.0,3,19,0,11,36,5,0,10,0,33,51,1
762,9145,RFW46IpEEo40HQZmVwQOMd3VcTSwzvKz,SpATywNh6bZuzm8s1ceuBUnMUAeoAHHw,23,65,15,16,3,0,14,0,113,16.142857142857142,6,0.0,20,15,15,3,45,0,1,14,0,53,60,0
763,9147,FTc6jHk7ojdVaEQtsGdTEiSOrQxUe2mX,SpATywNh6bZuzm8s1ceuBUnMUAeoAHHw,7,6,1,0,1,0,1,0,9,1.2857142857142858,1,0.0,0,1,0,1,6,0,0,1,0,2,7,0
764,9148,9DysAmMC3i4TW1eruWnww7wyDSDGRjXp,bWdj2GDclj5ofokWjzoa5jAwMkxCykd6,9,17,11,0,6,0,7,0,41,5.857142857142857,2,0.0,0,11,0,6,17,0,0,7,0,17,24,1
765,9158,DbhhTMdVqWIBI3VwdAesh5LxfMFeyK5c,SpATywNh6bZuzm8s1ceuBUnMUAeoAHHw,7,3,2,0,2,0,2,0,9,1.2857142857142858,1,0.0,0,2,0,2,3,0,0,2,0,4,5,1
766,9163,Hv1gke8Z6oPKIjxv7227ovS4ZRFTrLpp,bWdj2GDclj5ofokWjzoa5jAwMkxCykd6,4,2,1,0,1,0,1,0,5,0.7142857142857143,1,0.0,0,1,0,1,2,0,0,1,0,2,3,1
767,9165,fnvAURpBgndjkYxbDVVMCKsNQuRUMiGS,SpATywNh6bZuzm8s1ceuBUnMUAeoAHHw,20,44,22,0,9,6,16,2,99,14.142857142857142,6,0.0,0,22,0,9,44,6,0,16,2,31,68,0
768,9171,9cDsgjqaFerwqRiPgBxIO3HH5FKzzgdj,RXDvfPUBYFlVdlueBFbLW0mhhAyGEqpt,28,22,19,0,16,2,2,0,61,8.714285714285714,1,0.0,2,19,0,16,20,2,0,2,0,37,24,1
769,9182,aqcsR8SNbfax2wKqSkYdDU8hi71eVqW9,A3fsA9Zfv1X2fVEQhTw51lKENdNrEqT3,7,10,2,0,1,0,4,0,17,2.4285714285714284,1,0.0,1,2,0,1,9,0,0,4,0,4,13,0
770,9202,TnBvipzpsoJKVSP9HO76PUA5bg5zcHA5,SpATywNh6bZuzm8s1ceuBUnMUAeoAHHw,1,0,0,0,0,0,1,0,1,0.14285714285714285,1,0.0,0,0,0,0,0,0,0,1,0,0,1,1
771,9214,cw1zp7V2E9LtJgGgHmRoYt6oelCovAzM,bWdj2GDclj5ofokWjzoa5jAwMkxCykd6,21,37,20,118,5,36,19,2,237,33.857142857142854,3,0.0,8,20,112,5,29,36,6,19,2,145,92,1
772,9217,ZWsQt8qxIk0ozpqBcSOvnGxYevyvwXWW,SpATywNh6bZuzm8s1ceuBUnMUAeoAHHw,4,4,0,0,0,0,1,0,5,0.7142857142857143,1,0.0,0,0,0,0,4,0,0,1,0,0,5,1
773,9218,llxTRiluZGftr8xJaXSwJljp3xP1zOiw,SpATywNh6bZuzm8s1ceuBUnMUAeoAHHw,6,3,2,0,2,0,1,0,8,1.1428571428571428,1,0.0,0,2,0,2,3,0,0,1,0,4,4,1
774,9221,DHqQemLc6gAFLZmIcghnnHYSJ9DiwwJJ,A3fsA9Zfv1X2fVEQhTw51lKENdNrEqT3,13,6,2,14,2,1,7,1,33,4.714285714285714,2,0.0,0,2,12,2,6,1,2,7,1,16,17,1
775,9223,DHqQemLc6gAFLZmIcghnnHYSJ9DiwwJJ,G8EPVSXsOYB5YQWZGiz1aVq5Pgr2GrQu,4,2,0,0,0,0,2,0,4,0.5714285714285714,1,0.0,0,0,0,0,2,0,0,2,0,0,4,1
776,9225,bBiJ7ASlGThY8sK9BrJtoHZicOYFZngs,SpATywNh6bZuzm8s1ceuBUnMUAeoAHHw,9,17,0,4,0,0,4,0,25,3.5714285714285716,4,0.0,0,0,3,0,17,0,1,4,0,3,22,1
777,9249,0px3bu53b0JtWfgR2HZboUVCWvKPFWbh,SpATywNh6bZuzm8s1ceuBUnMUAeoAHHw,16,32,0,27,0,2,9,1,71,10.142857142857142,4,0.0,16,0,21,0,16,2,6,9,1,37,34,1
778,9252,9YWFnwknNOzyIUIKR7l51R7vKAyWFRtw,SpATywNh6bZuzm8s1ceuBUnMUAeoAHHw,11,9,6,0,6,1,2,0,24,3.4285714285714284,1,0.0,1,6,0,6,8,1,0,2,0,13,11,1
779,9256,tfcOvcMIVTpughZ66Us0P1WhX9cxijTo,SpATywNh6bZuzm8s1ceuBUnMUAeoAHHw,31,53,31,16,15,8,20,1,144,20.571428571428573,6,0.0,15,31,15,15,38,8,1,20,1,76,68,1
780,9261,QC8X6HHWWr8l8BhOv6dcxn8F38OGn4O4,bWdj2GDclj5ofokWjzoa5jAwMkxCykd6,19,28,12,48,11,8,15,0,122,17.428571428571427,3,0.0,11,12,43,11,17,8,5,15,0,77,45,1
781,9263,cgHFcM0rIMOzMpGf6lXZssDwXCb8l7YM,SpATywNh6bZuzm8s1ceuBUnMUAeoAHHw,27,35,20,12,11,174,28,3,283,40.42857142857143,10,0.0,4,20,10,11,31,174,2,28,3,45,238,0
782,9266,9Gijx5H37DPofktlpBMoMZTbguUDFGMv,SpATywNh6bZuzm8s1ceuBUnMUAeoAHHw,31,49,26,14,8,16,17,1,131,18.714285714285715,9,0.0,9,26,13,8,40,16,1,17,1,56,75,0
783,9280,S33pdehUgQXmm7BALY2AI5GkXomITIjp,SpATywNh6bZuzm8s1ceuBUnMUAeoAHHw,10,10,6,0,2,5,13,8,44,6.285714285714286,1,0.0,0,6,0,2,10,5,0,13,8,8,36,1
784,9284,nmePotX0raTb5EFn0d2G6sYKXgcl2u96,SpATywNh6bZuzm8s1ceuBUnMUAeoAHHw,30,33,15,24,7,26,16,1,122,17.428571428571427,4,0.0,12,15,21,7,21,26,3,16,1,55,67,1
785,9300,V2BC6P9m08ZwtWifNk1sABHW864l2OQe,SpATywNh6bZuzm8s1ceuBUnMUAeoAHHw,20,19,8,13,5,0,4,1,50,7.142857142857143,2,0.0,8,8,12,5,11,0,1,4,1,33,17,0
786,9319,7KQcIrOp3KoypOTvziMED7rHtDH1CXtE,bWdj2GDclj5ofokWjzoa5jAwMkxCykd6,14,20,2,34,5,0,4,0,65,9.285714285714286,2,0.0,11,2,29,5,9,0,5,4,0,47,18,1
787,9326,cw1zp7V2E9LtJgGgHmRoYt6oelCovAzM,A3fsA9Zfv1X2fVEQhTw51lKENdNrEqT3,42,55,33,66,12,13,37,2,218,31.142857142857142,4,0.0,9,33,52,12,46,13,14,37,2,106,112,0
788,9331,U5AVDljh153RMBqEeJz3uJoBcMeMiYU5,RXDvfPUBYFlVdlueBFbLW0mhhAyGEqpt,17,24,15,6,8,0,6,0,59,8.428571428571429,5,0.0,2,15,6,8,22,0,0,6,0,31,28,0
789,9337,6W9L2N1NV5yWuM4zWKiNN7jncCdBZXs0,SpATywNh6bZuzm8s1ceuBUnMUAeoAHHw,14,18,1,19,1,0,3,0,42,6.0,2,0.0,3,1,16,1,15,0,3,3,0,21,21,1
790,9348,yh14zaFitCUTgvBPqRXiaZ6cUijtktL4,SpATywNh6bZuzm8s1ceuBUnMUAeoAHHw,10,8,4,0,4,0,3,0,19,2.7142857142857144,2,0.0,0,4,0,4,8,0,0,3,0,8,11,1
791,9359,aR6DmUHNNFHdBeCRliKxXxLUoIhOd6AH,SpATywNh6bZuzm8s1ceuBUnMUAeoAHHw,29,64,22,22,7,45,21,1,182,26.0,8,0.0,11,22,20,7,53,45,2,21,1,60,122,1
792,9361,8Eqf4bSicFmRziRU1kFgF89C5yGB8WDX,A3fsA9Zfv1X2fVEQhTw51lKENdNrEqT3,38,63,7,54,2,4,44,4,178,25.428571428571427,8,0.0,7,7,49,2,56,4,5,44,4,65,113,0
793,9368,gGSMkNgPdXpBQgdZzyjzifomyCxFSNyt,RXDvfPUBYFlVdlueBFbLW0mhhAyGEqpt,50,98,42,89,23,9,22,1,284,40.57142857142857,6,0.0,13,42,80,23,85,9,9,22,1,158,126,1
794,9373,y94TMklf7UHNxvOoBChAR2OERrGRdiJq,G8EPVSXsOYB5YQWZGiz1aVq5Pgr2GrQu,21,20,6,18,4,0,8,0,56,8.0,2,0.0,9,6,12,4,11,0,6,8,0,31,25,0
795,9385,8fvsCrC8dcOje6DxrGntnTxmufYXJCrq,RXDvfPUBYFlVdlueBFbLW0mhhAyGEqpt,6,4,3,0,1,0,4,0,12,1.7142857142857142,2,0.0,0,3,0,1,4,0,0,4,0,4,8,1
796,9388,67TNJl3Pfj4UvDY0EpzZyKupN8wfhq1l,SpATywNh6bZuzm8s1ceuBUnMUAeoAHHw,18,26,15,14,5,1,22,7,90,12.857142857142858,3,0.0,5,15,13,5,21,1,1,22,7,38,52,1
797,9407,iY3PnTi5AY3h01aMZ0ccsJOuRXfKtImU,SpATywNh6bZuzm8s1ceuBUnMUAeoAHHw,30,57,25,24,10,4,8,0,128,18.285714285714285,3,0.0,22,25,24,10,35,4,0,8,0,81,47,0
798,9412,ZoicU1K1NYxoyDJQjMEMlarFqaZkNBQL,SpATywNh6bZuzm8s1ceuBUnMUAeoAHHw,20,31,4,17,2,0,19,0,73,10.428571428571429,5,0.0,3,4,16,2,28,0,1,19,0,25,48,0
799,9413,7LCuPqBIUzStV6rbjpGGsRhhNGaAe94J,G8EPVSXsOYB5YQWZGiz1aVq5Pgr2GrQu,5,2,1,0,1,0,2,0,6,0.8571428571428571,1,0.0,0,1,0,1,2,0,0,2,0,2,4,1
800,9421,mVo6pZlclrtmbfR2GbQ4wq8gZuK7O36S,SpATywNh6bZuzm8s1ceuBUnMUAeoAHHw,29,44,24,27,11,5,5,1,117,16.714285714285715,4,0.0,13,24,21,11,31,5,6,5,1,69,48,0
801,9443,mt466qDcj0vZCLdMYFtb42Vnaf84dHao,SpATywNh6bZuzm8s1ceuBUnMUAeoAHHw,32,74,46,24,14,3,41,2,204,29.142857142857142,9,0.0,12,46,18,14,62,3,6,41,2,90,114,1
802,9451,3tkFTpynSNaQLF6kINch4bQXEK1IrheG,SpATywNh6bZuzm8s1ceuBUnMUAeoAHHw,19,34,16,12,4,2,12,0,80,11.428571428571429,7,0.0,9,16,9,4,25,2,3,12,0,38,42,0
803,9461,L22HEShRU3FqNfdzTYdzEWxS4vfndGJu,SpATywNh6bZuzm8s1ceuBUnMUAeoAHHw,18,31,1,31,0,19,22,2,106,15.142857142857142,8,0.0,13,1,28,0,18,19,3,22,2,42,64,0
804,9496,lzjn3SIRVbYq5ZVBPCRXRd4xV1z1jylE,SpATywNh6bZuzm8s1ceuBUnMUAeoAHHw,30,60,33,47,13,21,23,0,197,28.142857142857142,7,0.0,15,33,38,13,45,21,9,23,0,99,98,0
805,9498,tNcQJSYfIwP0RRLCMvpsyr5j06z8N8iO,G8EPVSXsOYB5YQWZGiz1aVq5Pgr2GrQu,67,129,7,154,7,15,24,6,342,48.857142857142854,6,0.0,53,7,112,7,76,15,42,24,6,179,163,0
806,9513,onGGlsMh4Ah4OxYC5tqGXHHp3fKlLcL2,RXDvfPUBYFlVdlueBFbLW0mhhAyGEqpt,21,19,14,0,9,0,3,0,45,6.428571428571429,3,0.0,0,14,0,9,19,0,0,3,0,23,22,1
807,9515,FK87Mh9LEgwj1VU4pstPcNLLVrRCTWuM,SpATywNh6bZuzm8s1ceuBUnMUAeoAHHw,31,69,38,30,18,28,15,3,201,28.714285714285715,4,0.0,22,38,30,18,47,28,0,15,3,108,93,0
808,9524,qLAmicSwiz2res8NbViiztvss1lFMGpj,SpATywNh6bZuzm8s1ceuBUnMUAeoAHHw,14,30,6,15,2,1,13,1,68,9.714285714285714,6,0.0,8,6,13,2,22,1,2,13,1,29,39,1
809,9527,zdZzILDgH724BR2ZZqHskjwJPcqfxq36,SpATywNh6bZuzm8s1ceuBUnMUAeoAHHw,1,0,0,0,0,0,1,0,1,0.14285714285714285,1,0.0,0,0,0,0,0,0,0,1,0,0,1,1
810,9531,KwyWbYzWCyNQryHYqWYU5PuARebCENlh,SpATywNh6bZuzm8s1ceuBUnMUAeoAHHw,23,27,15,3,9,0,10,0,64,9.142857142857142,4,0.0,5,15,3,9,22,0,0,10,0,32,32,0
811,9554,qLhvnFj4NLk8zjpoDXsgy2yaKup2la0b,SpATywNh6bZuzm8s1ceuBUnMUAeoAHHw,8,9,3,0,2,0,1,0,15,2.142857142857143,1,0.0,0,3,0,2,9,0,0,1,0,5,10,1
812,9561,CS0wlcwiXBGjNBCCxbQaVvPkChe2nnOH,SpATywNh6bZuzm8s1ceuBUnMUAeoAHHw,4,2,1,0,1,0,1,0,5,0.7142857142857143,1,0.0,0,1,0,1,2,0,0,1,0,2,3,1
813,9562,ELMHLkq0bytqwO03zO0z2h1fRq8v5uwM,RXDvfPUBYFlVdlueBFbLW0mhhAyGEqpt,6,7,0,0,0,0,2,0,9,1.2857142857142858,1,0.0,0,0,0,0,7,0,0,2,0,0,9,0
814,9570,kRNs7iQ9Dcre5KLj8rtojE3fVWuqCtop,SpATywNh6bZuzm8s1ceuBUnMUAeoAHHw,24,31,3,26,0,2,14,2,78,11.142857142857142,2,0.0,11,3,25,0,20,2,1,14,2,39,39,0
815,9576,8L1ZpuGtJGJkgFF34DS0HYPQNaVRqmzv,G8EPVSXsOYB5YQWZGiz1aVq5Pgr2GrQu,7,1,1,0,1,1,5,1,10,1.4285714285714286,1,0.0,0,1,0,1,1,1,0,5,1,2,8,1
816,9583,InTDVHpDSVoZu5vOSvueBLdJOgZb9Qu8,bWdj2GDclj5ofokWjzoa5jAwMkxCykd6,10,8,4,12,3,0,4,0,31,4.428571428571429,1,0.0,2,4,10,3,6,0,2,4,0,19,12,0
817,9589,oJ9j9ejTgKixczg3tSE8Sg8DPI7YQpJq,A3fsA9Zfv1X2fVEQhTw51lKENdNrEqT3,16,9,6,0,4,1,5,1,26,3.7142857142857144,1,0.0,1,6,0,4,8,1,0,5,1,11,15,0
818,9596,8fvsCrC8dcOje6DxrGntnTxmufYXJCrq,G8EPVSXsOYB5YQWZGiz1aVq5Pgr2GrQu,2,0,0,0,0,0,3,0,3,0.42857142857142855,2,0.0,0,0,0,0,0,0,0,3,0,0,3,1
819,9597,op6fYsDSJ7UTrHBvFtSBIo32ykj3vZlc,SpATywNh6bZuzm8s1ceuBUnMUAeoAHHw,23,50,8,29,2,35,24,1,149,21.285714285714285,7,0.0,17,8,25,2,33,35,4,24,1,52,97,0
820,9601,op6fYsDSJ7UTrHBvFtSBIo32ykj3vZlc,A3fsA9Zfv1X2fVEQhTw51lKENdNrEqT3,4,2,2,0,0,0,4,0,8,1.1428571428571428,2,0.0,0,2,0,0,2,0,0,4,0,2,6,1
821,9602,op6fYsDSJ7UTrHBvFtSBIo32ykj3vZlc,bWdj2GDclj5ofokWjzoa5jAwMkxCykd6,4,2,1,0,0,0,7,0,10,1.4285714285714286,4,0.0,1,1,0,0,1,0,0,7,0,2,8,1
822,9626,foCA7ZrrJkil1q7yKxvukoHCZEz5fz8N,bWdj2GDclj5ofokWjzoa5jAwMkxCykd6,14,32,1,32,1,0,9,0,75,10.714285714285714,3,0.0,13,1,29,1,19,0,3,9,0,44,31,0
823,9629,RMdVVE71rvbt2Qm5k09H4IClAre95rfd,SpATywNh6bZuzm8s1ceuBUnMUAeoAHHw,7,2,1,0,1,1,5,1,11,1.5714285714285714,1,0.0,0,1,0,1,2,1,0,5,1,2,9,1
824,9631,ZkR2H9b56Jhek553JSEuRtj1fnuwaa03,SpATywNh6bZuzm8s1ceuBUnMUAeoAHHw,1,0,0,0,0,0,1,0,1,0.14285714285714285,1,0.0,0,0,0,0,0,0,0,1,0,0,1,1
825,9646,op6fYsDSJ7UTrHBvFtSBIo32ykj3vZlc,G8EPVSXsOYB5YQWZGiz1aVq5Pgr2GrQu,1,0,0,0,0,0,1,0,1,0.14285714285714285,1,0.0,0,0,0,0,0,0,0,1,0,0,1,1
826,9647,bPCZpicN2hhnN8uELNOuVf328EONwoA2,SpATywNh6bZuzm8s1ceuBUnMUAeoAHHw,15,44,16,4,3,1,16,1,85,12.142857142857142,4,0.0,23,16,4,3,21,1,0,16,1,46,39,1
827,9649,EH4LxHwYpFQLq5kesgWPY21JUpYpymba,SpATywNh6bZuzm8s1ceuBUnMUAeoAHHw,1,0,0,0,0,0,1,0,1,0.14285714285714285,1,0.0,0,0,0,0,0,0,0,1,0,0,1,1
828,9654,EH4LxHwYpFQLq5kesgWPY21JUpYpymba,A3fsA9Zfv1X2fVEQhTw51lKENdNrEqT3,1,0,0,0,0,0,1,0,1,0.14285714285714285,1,0.0,0,0,0,0,0,0,0,1,0,0,1,1
829,9662,tRu7kc3B7i0xOP4FswhcDsdZx5KznD0T,SpATywNh6bZuzm8s1ceuBUnMUAeoAHHw,9,31,10,0,6,0,5,0,52,7.428571428571429,3,0.0,0,10,0,6,31,0,0,5,0,16,36,0
830,9673,Bi4hHmeTLwTbUCScu9tC6ZZN7frLUhVP,bWdj2GDclj5ofokWjzoa5jAwMkxCykd6,38,39,23,82,11,0,15,0,170,24.285714285714285,3,0.0,7,23,79,11,32,0,3,15,0,120,50,0
831,9684,LdhLlSD36AR268yKf0v6JE8vG5XYPHSF,RXDvfPUBYFlVdlueBFbLW0mhhAyGEqpt,65,111,26,117,25,11,17,2,309,44.142857142857146,5,0.0,43,26,109,25,68,11,8,17,2,203,106,0
832,9707,5GS5OD1cmKWecEPymf3UVauvWYXb9WHE,SpATywNh6bZuzm8s1ceuBUnMUAeoAHHw,8,12,3,0,1,0,5,0,21,3.0,2,0.0,3,3,0,1,9,0,0,5,0,7,14,0
833,9713,KFNYz6Dhe7c7sjFmDdHR2V6Cj3vv7anD,SpATywNh6bZuzm8s1ceuBUnMUAeoAHHw,27,20,10,28,5,0,14,1,78,11.142857142857142,2,0.0,8,10,24,5,12,0,4,14,1,47,31,1
834,9718,0dBn4alo7QBTd62VD5XO0yNMbQ5QN2OQ,A3fsA9Zfv1X2fVEQhTw51lKENdNrEqT3,35,47,13,64,5,0,4,0,133,19.0,2,0.0,2,13,61,5,45,0,3,4,0,81,52,0
835,9719,STRzNG5Wp366HphlQVfWFRMC5QrerXCb,SpATywNh6bZuzm8s1ceuBUnMUAeoAHHw,23,51,16,10,11,0,3,0,91,13.0,2,0.0,2,16,10,11,49,0,0,3,0,39,52,0
836,9735,gL9bGH4cIhlV7ZeZxNKPKl7YRjV9LvBk,bWdj2GDclj5ofokWjzoa5jAwMkxCykd6,8,7,2,94,1,0,5,0,109,15.571428571428571,2,0.0,1,2,92,1,6,0,2,5,0,96,13,1
837,9745,ITkxDxE80MnM3R1P6Tny4qeXU1QIqBHa,bWdj2GDclj5ofokWjzoa5jAwMkxCykd6,25,38,22,38,11,78,22,2,211,30.142857142857142,6,0.0,8,22,34,11,30,78,4,22,2,75,136,1
838,9754,UhHoLs8knx0jlEPi8SMFvlBmI0lPgR6y,SpATywNh6bZuzm8s1ceuBUnMUAeoAHHw,20,49,1,12,2,15,21,2,102,14.571428571428571,8,0.0,14,1,11,2,35,15,1,21,2,28,74,1
839,9770,Z719Tc3zuVfTrBRe6VKkZp0coC11gNCc,SpATywNh6bZuzm8s1ceuBUnMUAeoAHHw,9,20,11,0,8,0,1,0,40,5.714285714285714,5,0.0,0,11,0,8,20,0,0,1,0,19,21,1
840,9785,gm1mCfFqKN0eTkg2YXDowzQf6xnuANVZ,SpATywNh6bZuzm8s1ceuBUnMUAeoAHHw,15,36,1,12,1,2,9,0,61,8.714285714285714,2,0.0,17,1,12,1,19,2,0,9,0,31,30,1
841,9786,LcO86mxxL8cZOPJBDybTSOoI4LZ5qE2M,SpATywNh6bZuzm8s1ceuBUnMUAeoAHHw,18,35,24,0,16,0,5,0,80,11.428571428571429,5,0.0,0,24,0,16,35,0,0,5,0,40,40,0
842,9787,EYniy2nQGNpFME0mRi8PdZNA2QjnXIxY,RXDvfPUBYFlVdlueBFbLW0mhhAyGEqpt,59,96,1,151,6,8,20,3,285,40.714285714285715,4,0.0,28,1,142,6,68,8,9,20,3,177,108,0
843,9792,M7EQ6UxOsXQjbu4WIJCWam7cgbYToC2D,bWdj2GDclj5ofokWjzoa5jAwMkxCykd6,1,0,0,0,0,0,1,0,1,0.14285714285714285,1,0.0,0,0,0,0,0,0,0,1,0,0,1,1
844,9799,oIeIfwhQt9r1G6uZ62W7p7DLvDQ1KzcN,SpATywNh6bZuzm8s1ceuBUnMUAeoAHHw,4,0,0,0,0,0,4,1,5,0.7142857142857143,1,0.0,0,0,0,0,0,0,0,4,1,0,5,0
845,9806,q0a8XSQyj8ok2HbWv28MubA9x20SFg4i,SpATywNh6bZuzm8s1ceuBUnMUAeoAHHw,20,24,4,12,5,0,19,0,64,9.142857142857142,4,0.0,2,4,10,5,22,0,2,19,0,21,43,0
846,9820,aHRdc7lsBBp8F9aMkgntONfsLpIf0i6y,SpATywNh6bZuzm8s1ceuBUnMUAeoAHHw,28,33,16,37,8,0,9,0,103,14.714285714285714,3,0.0,12,16,35,8,21,0,2,9,0,71,32,0
847,9833,31jhVyZsYwM3i4SgxR1MFYrhxZjgzlJ8,SpATywNh6bZuzm8s1ceuBUnMUAeoAHHw,27,30,17,38,10,2,7,0,104,14.857142857142858,4,0.0,7,17,31,10,23,2,7,7,0,65,39,0
848,9834,SVcpJb6gXZcQDuOEWDQYFqv2P86R1Xaj,A3fsA9Zfv1X2fVEQhTw51lKENdNrEqT3,16,7,6,0,4,4,11,1,33,4.714285714285714,2,0.0,0,6,0,4,7,4,0,11,1,10,23,1
849,9835,a9OOTcAZgZGDa68djsRaJXsHoRuNVOvz,SpATywNh6bZuzm8s1ceuBUnMUAeoAHHw,29,122,66,33,15,80,38,3,357,51.0,9,0.0,16,66,27,15,106,80,6,38,3,124,233,1
850,9836,nknXXbQsC6Q6nMDyRKc0MDJZg6KtAXBE,SpATywNh6bZuzm8s1ceuBUnMUAeoAHHw,28,68,29,18,9,9,7,0,140,20.0,5,0.0,27,29,16,9,41,9,2,7,0,81,59,0
851,9842,MVF65xcT9c1o85EvDPizEzpYwxjeii1v,SpATywNh6bZuzm8s1ceuBUnMUAeoAHHw,26,55,7,35,1,7,18,1,124,17.714285714285715,4,0.0,9,7,30,1,46,7,5,18,1,47,77,1
852,9857,qDhyxHmDfIFLWQlPUBxWy3YNuv335dWU,SpATywNh6bZuzm8s1ceuBUnMUAeoAHHw,15,42,17,8,8,15,9,0,99,14.142857142857142,6,0.0,8,17,8,8,34,15,0,9,0,41,58,0
853,9866,0KmXUOal7sGDR9cJbaeaj8aaBpdVW5sk,bWdj2GDclj5ofokWjzoa5jAwMkxCykd6,6,6,2,0,1,0,6,0,15,2.142857142857143,2,0.0,0,2,0,1,6,0,0,6,0,3,12,1
854,9867,Cv6IwnmHzYzI7Znom4eT6Rs7brgvVn5U,SpATywNh6bZuzm8s1ceuBUnMUAeoAHHw,7,10,2,0,1,0,3,0,16,2.2857142857142856,2,0.0,0,2,0,1,10,0,0,3,0,3,13,1
855,9874,mZIaM3Lmux7GERtSm258BKPOSUYFlwyy,SpATywNh6bZuzm8s1ceuBUnMUAeoAHHw,30,61,19,32,7,12,20,1,152,21.714285714285715,7,0.0,19,19,30,7,42,12,2,20,1,75,77,0
856,9878,iw5QtMAk2wyMi9Kh4hTv1WAFOj2rnxVj,SpATywNh6bZuzm8s1ceuBUnMUAeoAHHw,15,14,2,17,0,0,7,2,42,6.0,2,0.0,3,2,16,0,11,0,1,7,2,21,21,0
857,9894,MarhO8rhsTXcbFpvat4mcEiSQvbAftxM,SpATywNh6bZuzm8s1ceuBUnMUAeoAHHw,2,0,0,0,0,0,2,0,2,0.2857142857142857,2,0.0,0,0,0,0,0,0,0,2,0,0,2,1
858,9896,47Lhswr4ZfAxhCMxQ5kAgIIaZKdQ7ZYE,SpATywNh6bZuzm8s1ceuBUnMUAeoAHHw,22,54,20,34,6,99,23,1,237,33.857142857142854,5,0.0,15,20,28,6,39,99,6,23,1,69,168,0
859,9903,wHRp5VFhSRE1ez0DDg63jhbDbNE6ujgu,bWdj2GDclj5ofokWjzoa5jAwMkxCykd6,1,0,0,0,0,0,2,0,2,0.2857142857142857,2,0.0,0,0,0,0,0,0,0,2,0,0,2,1
860,9910,FUkw8gvbqykqbH4tdSuG6VwP03f4pQvB,SpATywNh6bZuzm8s1ceuBUnMUAeoAHHw,31,48,26,15,12,1,15,0,117,16.714285714285715,8,0.0,13,26,15,12,35,1,0,15,0,66,51,0
861,9911,Jd5OP6GIsguRdsq9k3eSYNENmzhPbdGe,bWdj2GDclj5ofokWjzoa5jAwMkxCykd6,8,13,5,0,2,0,8,0,28,4.0,4,0.0,2,5,0,2,11,0,0,8,0,9,19,1
862,9916,CJe4pjtrcC0FOMy3krEkccqFJZO0Cqq4,RXDvfPUBYFlVdlueBFbLW0mhhAyGEqpt,34,54,15,68,3,69,40,21,270,38.57142857142857,5,0.0,14,15,59,3,40,69,9,40,21,91,179,1
863,9919,YwojqO58bCgaotjJoOTtpKH2oiEFOZyB,SpATywNh6bZuzm8s1ceuBUnMUAeoAHHw,19,18,10,21,7,0,6,0,62,8.857142857142858,2,0.0,6,10,18,7,12,0,3,6,0,41,21,1
864,9921,Mv7oSGs75OaCjYLhHCNmqqrqaAjjO5gs,RXDvfPUBYFlVdlueBFbLW0mhhAyGEqpt,56,126,16,139,14,13,31,10,349,49.857142857142854,8,0.0,33,16,125,14,93,13,14,31,10,188,161,1
865,9926,TgheOgj9khTgshxaHKtqDHWb3smGHeUA,SpATywNh6bZuzm8s1ceuBUnMUAeoAHHw,22,21,2,18,0,1,9,1,52,7.428571428571429,2,0.0,6,2,16,0,15,1,2,9,1,24,28,1
866,9937,lZ58Ty5L7QhiK80QjmlI7dd3eLrrNLr0,A3fsA9Zfv1X2fVEQhTw51lKENdNrEqT3,7,3,2,0,2,0,3,0,10,1.4285714285714286,1,0.0,0,2,0,2,3,0,0,3,0,4,6,1
867,9944,IUn6MADAjAYkGlJisA1WiDvCeNlJd5Xd,G8EPVSXsOYB5YQWZGiz1aVq5Pgr2GrQu,84,88,30,137,18,0,7,0,280,40.0,10,0.0,47,30,91,18,41,0,46,7,0,186,94,1
868,9945,5NIu7B9o5GAsLAdx3xyl9xnxkK6Z7Hn1,SpATywNh6bZuzm8s1ceuBUnMUAeoAHHw,1,0,0,0,0,0,1,0,1,0.14285714285714285,1,0.0,0,0,0,0,0,0,0,1,0,0,1,1
869,9965,XL8OObjZsaGHAKex6gNHyGuTbyi42iwz,SpATywNh6bZuzm8s1ceuBUnMUAeoAHHw,16,40,0,13,0,30,12,6,101,14.428571428571429,2,0.0,19,0,12,0,21,30,1,12,6,31,70,1
870,9973,pqAmXCZ0vs0c5YNrZSPIZNZIkmuJCMBN,RXDvfPUBYFlVdlueBFbLW0mhhAyGEqpt,70,55,37,173,19,38,16,5,343,49.0,5,0.0,12,37,160,19,43,38,13,16,5,228,115,0
871,9986,hM3OejyZim6cDpiFQsjtqNuKMzh1dYaY,SpATywNh6bZuzm8s1ceuBUnMUAeoAHHw,12,11,0,24,0,0,4,0,39,5.571428571428571,2,0.0,2,0,20,0,9,0,4,4,0,22,17,1
872,9989,GVRJN4wkoooaXJUVmwnX983A87KsrZPK,A3fsA9Zfv1X2fVEQhTw51lKENdNrEqT3,51,31,17,110,6,10,13,0,187,26.714285714285715,7,0.0,7,17,96,6,24,10,14,13,0,126,61,0
873,9993,oThgY0TV97t9DlLv4WWVQ93RXTQBQvf5,SpATywNh6bZuzm8s1ceuBUnMUAeoAHHw,1,0,0,0,0,0,2,0,2,0.2857142857142857,1,0.0,0,0,0,0,0,0,0,2,0,0,2,1
874,10001,vsk33lNJbFXN2L68Y5R9TSkfONwNMOQ8,SpATywNh6bZuzm8s1ceuBUnMUAeoAHHw,27,53,18,30,6,86,18,6,217,31.0,4,0.0,21,18,26,6,32,86,4,18,6,71,146,0
875,10002,HjIrUt1Ax8b3fBkdKQupL2gDMbKYgLrZ,bWdj2GDclj5ofokWjzoa5jAwMkxCykd6,5,5,3,0,2,0,2,0,12,1.7142857142857142,2,0.0,0,3,0,2,5,0,0,2,0,5,7,1
876,10011,gGIYUaDzHtuVAdLHD7FaG5z9ih7s8ZFV,SpATywNh6bZuzm8s1ceuBUnMUAeoAHHw,6,1,1,0,1,0,3,1,7,1.0,1,0.0,0,1,0,1,1,0,0,3,1,2,5,1
877,10012,vqSgORDp5PsEpveQVJoPh4dnJvR6AQkK,RXDvfPUBYFlVdlueBFbLW0mhhAyGEqpt,65,97,58,102,26,39,27,1,350,50.0,9,0.0,20,58,95,26,77,39,7,27,1,199,151,0
878,10013,NYNmhRIaW3AmhvVQt7ReXvH6yAc7z73U,RXDvfPUBYFlVdlueBFbLW0mhhAyGEqpt,7,22,11,0,0,117,32,4,186,26.571428571428573,6,0.0,0,11,0,0,22,117,0,32,4,11,175,1
879,10021,oX8Y4icCGan10HVW1mtOWEP3pxrvK1WZ,RXDvfPUBYFlVdlueBFbLW0mhhAyGEqpt,39,53,33,47,8,156,15,5,317,45.285714285714285,5,0.0,8,33,46,8,45,156,1,15,5,95,222,0
880,10029,sdNkCaSqYSgtx1tSTEHqB38WFlBnpR89,SpATywNh6bZuzm8s1ceuBUnMUAeoAHHw,16,17,11,5,6,0,5,0,44,6.285714285714286,1,0.0,4,11,4,6,13,0,1,5,0,25,19,1
881,10036,M0OuzdgM82B7CvwoM2EBQihSEuKyfCoB,G8EPVSXsOYB5YQWZGiz1aVq5Pgr2GrQu,16,7,1,26,1,3,16,0,54,7.714285714285714,2,0.0,0,1,22,1,7,3,4,16,0,24,30,1
882,10042,RCWIrGGQZDVLNIofIMbc1GdSrqA961jg,RXDvfPUBYFlVdlueBFbLW0mhhAyGEqpt,23,48,28,4,4,246,67,4,401,57.285714285714285,6,0.0,3,28,3,4,45,246,1,67,4,38,363,1
883,10044,Wigd4PnyDnjfDcFOxsTBcEnXo7kl9GSg,bWdj2GDclj5ofokWjzoa5jAwMkxCykd6,21,91,26,74,8,22,28,0,249,35.57142857142857,5,0.0,15,26,69,8,76,22,5,28,0,118,131,1
884,10048,X8GmwqDtWUFSMSOGWtivlDRmblWXusTi,SpATywNh6bZuzm8s1ceuBUnMUAeoAHHw,13,13,9,7,3,12,8,0,52,7.428571428571429,4,0.0,2,9,7,3,11,12,0,8,0,21,31,0
885,10065,GV5J9MUmZdHez5d6vsAQtSAbOI4jKQlj,bWdj2GDclj5ofokWjzoa5jAwMkxCykd6,25,43,24,68,13,11,14,2,175,25.0,3,0.0,9,24,58,13,34,11,10,14,2,104,71,0
886,10067,IkfMHDVbFGQIQxWjHsEqTwjNnrBCaA7O,SpATywNh6bZuzm8s1ceuBUnMUAeoAHHw,31,91,44,27,15,43,28,1,249,35.57142857142857,9,0.0,19,44,26,15,72,43,1,28,1,104,145,0
887,10068,GV5J9MUmZdHez5d6vsAQtSAbOI4jKQlj,A3fsA9Zfv1X2fVEQhTw51lKENdNrEqT3,9,6,4,0,2,0,3,0,15,2.142857142857143,2,0.0,0,4,0,2,6,0,0,3,0,6,9,1
888,10069,EdSyqy374rFTTRmoH6AfOLgRNsPjxdOm,A3fsA9Zfv1X2fVEQhTw51lKENdNrEqT3,19,14,10,0,6,0,6,0,36,5.142857142857143,2,0.0,0,10,0,6,14,0,0,6,0,16,20,1
889,10070,FkxhG6zHFqigfK7M5JQhv4MT6lPE3kxN,RXDvfPUBYFlVdlueBFbLW0mhhAyGEqpt,61,101,65,135,35,6,20,18,380,54.285714285714285,8,0.0,16,65,124,35,85,6,11,20,18,240,140,0
890,10071,ivII4h55QUeXOce5qbbvWPv1IAJ1FXtO,SpATywNh6bZuzm8s1ceuBUnMUAeoAHHw,17,22,1,18,0,0,8,0,49,7.0,1,0.0,7,1,17,0,15,0,1,8,0,25,24,1
891,10073,3VQVtsFphnOA3h1KWYRcAEMgfViLsPnF,A3fsA9Zfv1X2fVEQhTw51lKENdNrEqT3,15,32,1,0,4,0,5,0,42,6.0,3,0.0,5,1,0,4,27,0,0,5,0,10,32,1
892,10075,EdSyqy374rFTTRmoH6AfOLgRNsPjxdOm,bWdj2GDclj5ofokWjzoa5jAwMkxCykd6,8,11,7,0,4,0,4,0,26,3.7142857142857144,3,0.0,1,7,0,4,10,0,0,4,0,12,14,1
893,10081,2LiXT3Fppj80YAOl6K8p0HtAK0LHy6KG,SpATywNh6bZuzm8s1ceuBUnMUAeoAHHw,28,35,24,22,13,6,11,0,111,15.857142857142858,3,0.0,7,24,22,13,28,6,0,11,0,66,45,0
894,10095,JQVJEgOcL8lOPq9QqGxWJ7NUVC20wQ1o,SpATywNh6bZuzm8s1ceuBUnMUAeoAHHw,15,13,8,0,7,2,5,0,35,5.0,2,0.0,2,8,0,7,11,2,0,5,0,17,18,0
895,10112,D1iAkJgGLDV90w339eOp4Bqd5z6wvBY6,bWdj2GDclj5ofokWjzoa5jAwMkxCykd6,1,0,0,0,0,0,1,0,1,0.14285714285714285,1,0.0,0,0,0,0,0,0,0,1,0,0,1,1
896,10114,D1iAkJgGLDV90w339eOp4Bqd5z6wvBY6,A3fsA9Zfv1X2fVEQhTw51lKENdNrEqT3,1,0,0,0,0,0,1,0,1,0.14285714285714285,1,0.0,0,0,0,0,0,0,0,1,0,0,1,1
897,10119,8IVnhzyRJrPiaCjSSJli9bG8p44dgy3T,SpATywNh6bZuzm8s1ceuBUnMUAeoAHHw,14,18,7,0,5,0,6,0,36,5.142857142857143,2,0.0,1,7,0,5,17,0,0,6,0,13,23,1
898,10120,9Dm5yt1s5sm1v7MbrzCfMpw138AkercO,RXDvfPUBYFlVdlueBFbLW0mhhAyGEqpt,44,38,24,105,18,41,14,5,245,35.0,3,0.0,13,24,98,18,25,41,7,14,5,153,92,0
899,10122,NiXPZUmEILmWUPwXexYxtHvaIL7QdjCQ,RXDvfPUBYFlVdlueBFbLW0mhhAyGEqpt,67,86,52,92,20,82,21,13,366,52.285714285714285,7,0.0,18,52,87,20,68,82,5,21,13,177,189,0
900,10129,7rP408Gy6dVEeyQ5Me3hr5GFRnqOotmL,A3fsA9Zfv1X2fVEQhTw51lKENdNrEqT3,12,10,6,0,5,0,9,1,31,4.428571428571429,1,0.0,2,6,0,5,8,0,0,9,1,13,18,1
901,10130,u3iTsADy3VjWLwiWIPabdGKGPi8ZLAbJ,SpATywNh6bZuzm8s1ceuBUnMUAeoAHHw,12,15,3,0,2,0,7,0,27,3.857142857142857,4,0.0,0,3,0,2,15,0,0,7,0,5,22,0
902,10137,CUHsvexAAfaCEMKsM3644JTxXL5DgSss,bWdj2GDclj5ofokWjzoa5jAwMkxCykd6,4,2,1,0,1,0,1,0,5,0.7142857142857143,1,0.0,0,1,0,1,2,0,0,1,0,2,3,1
903,10147,ng7eSUGwAsEpodxFM2MoBV45uXU9cRkh,SpATywNh6bZuzm8s1ceuBUnMUAeoAHHw,1,0,0,0,0,0,2,0,2,0.2857142857142857,1,0.0,0,0,0,0,0,0,0,2,0,0,2,1
904,10161,n4cJEUTWqAxTpul10x8ZDTmIRIbytL0a,SpATywNh6bZuzm8s1ceuBUnMUAeoAHHw,31,58,20,38,8,4,13,1,142,20.285714285714285,6,0.0,24,20,35,8,34,4,3,13,1,87,55,1
905,10164,w7s7CbDlE2P2RGY2w8kEYH9keSavEsec,A3fsA9Zfv1X2fVEQhTw51lKENdNrEqT3,8,6,3,0,2,0,4,0,15,2.142857142857143,3,0.0,0,3,0,2,6,0,0,4,0,5,10,1
906,10165,PzZ2nmySEoPT9qSsl3Z3wqf8hhgEC7RR,bWdj2GDclj5ofokWjzoa5jAwMkxCykd6,10,12,2,0,3,0,7,2,26,3.7142857142857144,3,0.0,4,2,0,3,8,0,0,7,2,9,17,1
907,10171,IceoOG9Um0Dwn1hM2FcjjE3CJhGCpTrp,SpATywNh6bZuzm8s1ceuBUnMUAeoAHHw,1,0,0,0,0,0,1,0,1,0.14285714285714285,1,0.0,0,0,0,0,0,0,0,1,0,0,1,1
908,10190,h81tMgwEiasc4dN2MBVSIam9UKAPfs93,A3fsA9Zfv1X2fVEQhTw51lKENdNrEqT3,34,56,6,74,1,0,7,0,144,20.571428571428573,5,0.0,9,6,59,1,47,0,15,7,0,75,69,0
909,10193,T6JL6sNT8M40gVvb059fgHfBQIftQwIF,SpATywNh6bZuzm8s1ceuBUnMUAeoAHHw,24,82,34,26,0,3,31,0,176,25.142857142857142,9,0.0,33,34,23,0,49,3,3,31,0,90,86,1
910,10200,Sb9hMB1NLdfMmS0ToFmgrY6MZEZ6TYgo,SpATywNh6bZuzm8s1ceuBUnMUAeoAHHw,30,53,21,26,10,3,8,1,122,17.428571428571427,4,0.0,20,21,22,10,33,3,4,8,1,73,49,0
911,10202,BiB7jdHiaAHugRlYDLxmiYyQzifAAliU,SpATywNh6bZuzm8s1ceuBUnMUAeoAHHw,12,34,16,0,3,1,15,1,70,10.0,3,0.0,2,16,0,3,32,1,0,15,1,21,49,1
912,10204,nJbKKV1iJX5hAlKTzoiNMNIkB5aNJcfW,G8EPVSXsOYB5YQWZGiz1aVq5Pgr2GrQu,41,48,35,40,16,2,19,3,163,23.285714285714285,5,0.0,0,35,37,16,48,2,3,19,3,88,75,0
913,10207,Qf6P6bxCyzplkdXIQa3YsHmpzfUnMGYL,SpATywNh6bZuzm8s1ceuBUnMUAeoAHHw,18,41,18,11,9,2,16,3,100,14.285714285714286,4,0.0,13,18,11,9,28,2,0,16,3,51,49,0
914,10210,qVH2miiWM8Lf3bY2iypzRXLuMojA4gKB,SpATywNh6bZuzm8s1ceuBUnMUAeoAHHw,26,23,15,15,9,3,8,1,74,10.571428571428571,3,0.0,5,15,12,9,18,3,3,8,1,41,33,1
915,10212,IKkLcanOfBFv8w6vw2fYzBwzbCJQZq5m,SpATywNh6bZuzm8s1ceuBUnMUAeoAHHw,23,27,12,12,7,9,7,1,75,10.714285714285714,2,0.0,4,12,12,7,23,9,0,7,1,35,40,0
916,10214,X71Zy6g4fufrJXrIbNfXtlVdtViubQUc,G8EPVSXsOYB5YQWZGiz1aVq5Pgr2GrQu,5,6,1,0,3,0,2,0,12,1.7142857142857142,1,0.0,3,1,0,3,3,0,0,2,0,7,5,1
917,10218,JN0hu6OtICcRlrPNS3Zt5hNT8ffEQP2J,bWdj2GDclj5ofokWjzoa5jAwMkxCykd6,12,29,12,0,5,1,12,1,60,8.571428571428571,2,0.0,2,12,0,5,27,1,0,12,1,19,41,1
918,10227,SnivjdMp3HL6G23yPscSnzZlAD2Rbyt6,A3fsA9Zfv1X2fVEQhTw51lKENdNrEqT3,24,8,3,58,1,0,2,0,72,10.285714285714286,2,0.0,3,3,53,1,5,0,5,2,0,60,12,0
919,10230,X9IfBkBBoI1jhyhTI5cK6hEB3eMT1rI2,SpATywNh6bZuzm8s1ceuBUnMUAeoAHHw,22,49,28,23,0,84,12,0,196,28.0,4,0.0,15,28,21,0,34,84,2,12,0,64,132,0
920,10232,zXzBBpTV9epJ0NK0fVVhqGAiB4MQXdB4,SpATywNh6bZuzm8s1ceuBUnMUAeoAHHw,30,35,19,18,9,18,18,1,118,16.857142857142858,5,0.0,9,19,18,9,26,18,0,18,1,55,63,0
921,10236,zMsdFc2bNoJ6urVmU6g31AhzZMFpCEEM,SpATywNh6bZuzm8s1ceuBUnMUAeoAHHw,16,14,1,19,1,0,6,1,42,6.0,3,0.0,2,1,16,1,12,0,3,6,1,20,22,1
922,10244,5gwirWhcaVB1Z2yy4RRslODx7MsCrRca,SpATywNh6bZuzm8s1ceuBUnMUAeoAHHw,30,49,25,38,13,16,14,2,157,22.428571428571427,4,0.0,15,25,34,13,34,16,4,14,2,87,70,0
923,10250,GhXXCYV4l3r313zlwGPyJpPeGLc4qMAC,bWdj2GDclj5ofokWjzoa5jAwMkxCykd6,8,3,2,0,2,0,3,0,10,1.4285714285714286,1,0.0,0,2,0,2,3,0,0,3,0,4,6,1
924,10263,Gy6MuuTSUxAvObvL74Ev0uen9bQJO61p,SpATywNh6bZuzm8s1ceuBUnMUAeoAHHw,7,5,3,0,3,1,8,3,23,3.2857142857142856,2,0.0,0,3,0,3,5,1,0,8,3,6,17,1
925,10271,1kFTVSLESXiimtERcEyClh5CUMgpZbSa,SpATywNh6bZuzm8s1ceuBUnMUAeoAHHw,16,24,7,15,3,4,8,2,63,9.0,2,0.0,11,7,15,3,13,4,0,8,2,36,27,0
926,10276,6pYrzEgLAB7Gx24u5Kn0l64uyJLXY41J,SpATywNh6bZuzm8s1ceuBUnMUAeoAHHw,3,0,0,0,0,0,9,0,9,1.2857142857142858,3,0.0,0,0,0,0,0,0,0,9,0,0,9,0
927,10280,dtlGqEkxytgl4rvxvygVAnxqgcqdYicp,SpATywNh6bZuzm8s1ceuBUnMUAeoAHHw,28,53,12,20,8,6,13,0,112,16.0,6,0.0,7,12,19,8,46,6,1,13,0,46,66,0
928,10289,83H2FVc0DUlyPpMlZsbpGsFQRMFc6fan,SpATywNh6bZuzm8s1ceuBUnMUAeoAHHw,15,14,12,6,6,0,4,0,42,6.0,2,0.0,0,12,5,6,14,0,1,4,0,23,19,0
929,10307,ZBhV1m5APkbtG3EQZyk5pMZqkJsFLe6t,SpATywNh6bZuzm8s1ceuBUnMUAeoAHHw,8,22,13,0,8,1,9,0,53,7.571428571428571,2,0.0,1,13,0,8,21,1,0,9,0,22,31,1
930,10310,nTUP3gEuwVy2Io3TzQXGmuh9VvJxgHk3,bWdj2GDclj5ofokWjzoa5jAwMkxCykd6,18,35,19,90,5,27,4,0,180,25.714285714285715,3,0.0,3,19,86,5,32,27,4,4,0,113,67,1
931,10328,GSkYUOcl4XzYMWSWhE6gXRGQ9kqPeXsi,SpATywNh6bZuzm8s1ceuBUnMUAeoAHHw,29,36,19,32,9,1,10,0,107,15.285714285714286,4,0.0,12,19,29,9,24,1,3,10,0,69,38,0
932,10340,afCicX2FGCc7YS72xtNmCsPkAgJ0p3xk,SpATywNh6bZuzm8s1ceuBUnMUAeoAHHw,5,2,0,0,0,0,7,0,9,1.2857142857142858,1,0.0,0,0,0,0,2,0,0,7,0,0,9,1
933,10342,snAYYuMQqGAkhlZMfAgAWobAumSD4u2s,SpATywNh6bZuzm8s1ceuBUnMUAeoAHHw,8,5,3,0,2,0,3,0,13,1.8571428571428572,1,0.0,0,3,0,2,5,0,0,3,0,5,8,1
934,10358,Nzrw7pk0OZ13UV7zfdLy7gEMwvTA7qqG,SpATywNh6bZuzm8s1ceuBUnMUAeoAHHw,32,105,43,32,13,132,53,8,386,55.142857142857146,12,0.0,36,43,31,13,69,132,1,53,8,123,263,0
935,10365,xg8dkQPzve0MzcpgxvEsbKyY4VwKrxAC,SpATywNh6bZuzm8s1ceuBUnMUAeoAHHw,13,34,1,0,0,0,5,0,40,5.714285714285714,3,0.0,5,1,0,0,29,0,0,5,0,6,34,1
936,10380,ziZWaDkSdnYYFQL9rVa6Bhv9eL7a9wWX,SpATywNh6bZuzm8s1ceuBUnMUAeoAHHw,19,49,7,21,4,27,22,1,131,18.714285714285715,4,0.0,9,7,17,4,40,27,4,22,1,37,94,0
937,10382,wONMmUHIYwPBmEB9lgpOY3KCldKiuZFl,SpATywNh6bZuzm8s1ceuBUnMUAeoAHHw,13,23,13,0,11,4,13,1,65,9.285714285714286,5,0.0,6,13,0,11,17,4,0,13,1,30,35,0
938,10383,1wBdrtLehQQJkXlNE5BI48cxv9PbJtLD,bWdj2GDclj5ofokWjzoa5jAwMkxCykd6,1,0,0,0,0,0,1,0,1,0.14285714285714285,1,0.0,0,0,0,0,0,0,0,1,0,0,1,1
939,10388,SaHrUfZXnTghdXjrd2g1gBsj8aUTXhNX,SpATywNh6bZuzm8s1ceuBUnMUAeoAHHw,28,43,10,20,6,12,17,1,109,15.571428571428571,5,0.0,19,10,19,6,24,12,1,17,1,54,55,0
940,10395,HYP3Q558qDipVvMi5tV4os7veHPJBNBQ,bWdj2GDclj5ofokWjzoa5jAwMkxCykd6,8,13,6,0,2,0,6,0,27,3.857142857142857,3,0.0,0,6,0,2,13,0,0,6,0,8,19,0
941,10403,VgIpHnZLrMLRtvQcwLJvvhrvLtLKds8Y,SpATywNh6bZuzm8s1ceuBUnMUAeoAHHw,18,27,2,6,2,0,8,0,45,6.428571428571429,2,0.0,1,2,5,2,26,0,1,8,0,10,35,1
942,10407,xLsstPG4sh6BOKWjwGwQnQICDDoIsKTd,SpATywNh6bZuzm8s1ceuBUnMUAeoAHHw,21,63,31,3,14,20,16,8,155,22.142857142857142,8,0.0,14,31,3,14,49,20,0,16,8,62,93,0
943,10416,9jZsAxMdQXvLjxKIorcfAyZ7kTyyk2m3,bWdj2GDclj5ofokWjzoa5jAwMkxCykd6,21,43,16,22,11,3,14,2,111,15.857142857142858,6,0.0,9,16,21,11,34,3,1,14,2,57,54,1
944,10422,Eu9HoDt3WhECHgcXaERosbI6lMj7Hipb,RXDvfPUBYFlVdlueBFbLW0mhhAyGEqpt,65,91,52,135,35,44,16,6,379,54.142857142857146,8,0.0,26,52,124,35,65,44,11,16,6,237,142,0
945,10423,0bGsOnbsTfgtcrUHSL9Ba6RYBtQEiaAR,SpATywNh6bZuzm8s1ceuBUnMUAeoAHHw,5,2,1,0,1,0,3,0,7,1.0,2,0.0,0,1,0,1,2,0,0,3,0,2,5,1
946,10427,Daw06K1PSOXldo19kBgHP5sewulb7Vu5,SpATywNh6bZuzm8s1ceuBUnMUAeoAHHw,25,44,1,18,0,8,10,1,82,11.714285714285714,6,0.0,9,1,18,0,35,8,0,10,1,28,54,1
947,10441,KRLjLXKoKEagD4g49Zuzvz0geq7JPqfn,bWdj2GDclj5ofokWjzoa5jAwMkxCykd6,8,25,12,0,7,1,10,1,56,8.0,3,0.0,6,12,0,7,19,1,0,10,1,25,31,0
948,10462,PERCKVrZOUZ9ZmdU3J0Mwd1TZrMvK8yc,RXDvfPUBYFlVdlueBFbLW0mhhAyGEqpt,38,76,40,0,40,5,9,1,171,24.428571428571427,3,0.0,25,40,0,40,51,5,0,9,1,105,66,0
949,10481,4baDuWDcygh3I7gf3DfgmuPMN0Tyoi19,SpATywNh6bZuzm8s1ceuBUnMUAeoAHHw,27,44,8,29,2,3,25,3,114,16.285714285714285,6,0.0,12,8,23,2,32,3,6,25,3,45,69,0
950,10489,VC1Fuf9dV49znO9PkMawj1ZQqMcKHAjm,SpATywNh6bZuzm8s1ceuBUnMUAeoAHHw,26,54,6,32,2,30,24,1,149,21.285714285714285,9,0.0,21,6,28,2,33,30,4,24,1,57,92,0
951,10502,vx1j5ZdbVcqMnaq8fewmENptts2XnB9X,SpATywNh6bZuzm8s1ceuBUnMUAeoAHHw,25,24,9,8,5,11,11,1,69,9.857142857142858,2,0.0,1,9,7,5,23,11,1,11,1,22,47,0
952,10509,gtq5s5jDEXDrRLbMZLZJIjHVD4oTJM3K,SpATywNh6bZuzm8s1ceuBUnMUAeoAHHw,19,24,1,14,1,1,8,1,50,7.142857142857143,1,0.0,7,1,11,1,17,1,3,8,1,20,30,1
953,10510,Dz5Gcjm5wFySM7nVbkILZVfr9rOqjoD4,bWdj2GDclj5ofokWjzoa5jAwMkxCykd6,1,0,0,0,0,0,1,0,1,0.14285714285714285,1,0.0,0,0,0,0,0,0,0,1,0,0,1,1
954,10518,rzGwtyhvOohTorRAFSpekt9j8KJVn1Nq,SpATywNh6bZuzm8s1ceuBUnMUAeoAHHw,29,52,25,34,11,3,18,0,143,20.428571428571427,5,0.0,15,25,31,11,37,3,3,18,0,82,61,0
955,10522,6rHs7FPoWFgbGCrOeJU6CnRQs9oaZ934,SpATywNh6bZuzm8s1ceuBUnMUAeoAHHw,1,0,0,0,0,0,1,0,1,0.14285714285714285,1,0.0,0,0,0,0,0,0,0,1,0,0,1,0
956,10523,jUBhH6RhAb1JtOUdjtvZ9A8khJilFTTv,RXDvfPUBYFlVdlueBFbLW0mhhAyGEqpt,9,14,4,0,1,4,8,0,31,4.428571428571429,1,0.0,9,4,0,1,5,4,0,8,0,14,17,1
957,10527,VYMfm0tgVS6x4Eosz9NPpRPYpCrgFsMy,A3fsA9Zfv1X2fVEQhTw51lKENdNrEqT3,66,61,41,235,29,2,18,0,386,55.142857142857146,7,0.0,8,41,212,29,53,2,23,18,0,290,96,0
958,10528,WubsiWqf9HrcjL91VrCtUc1j3k8esFc2,G8EPVSXsOYB5YQWZGiz1aVq5Pgr2GrQu,13,10,4,4,3,7,5,0,33,4.714285714285714,2,0.0,0,4,3,3,10,7,1,5,0,10,23,1
959,10535,TyLciGh9B6yO4eY9EZiNs3MwXyb1sWVv,SpATywNh6bZuzm8s1ceuBUnMUAeoAHHw,16,19,2,21,2,2,5,0,51,7.285714285714286,3,0.0,8,2,17,2,11,2,4,5,0,29,22,1
960,10540,Cwlc0kvvLoKXxEuXNQkjFRo818TDMpZS,SpATywNh6bZuzm8s1ceuBUnMUAeoAHHw,30,60,19,23,9,16,9,4,140,20.0,4,0.0,29,19,23,9,31,16,0,9,4,80,60,0
961,10542,r2u5KF0HWbXOmPd8SinNo3Ik67swOdP7,SpATywNh6bZuzm8s1ceuBUnMUAeoAHHw,16,23,14,6,9,1,8,0,61,8.714285714285714,2,0.0,7,14,6,9,16,1,0,8,0,36,25,0
962,10555,QqE2Xjwy9gUzOvFdkDqAwAaNZLBZkxvd,bWdj2GDclj5ofokWjzoa5jAwMkxCykd6,10,13,2,0,1,3,13,0,32,4.571428571428571,4,0.0,0,2,0,1,13,3,0,13,0,3,29,0
963,10558,Cvs414mYH2FKto3axCpDhfQljawQ5dk9,SpATywNh6bZuzm8s1ceuBUnMUAeoAHHw,16,27,15,15,4,0,7,0,68,9.714285714285714,3,0.0,4,15,15,4,23,0,0,7,0,38,30,0
964,10567,WubsiWqf9HrcjL91VrCtUc1j3k8esFc2,SpATywNh6bZuzm8s1ceuBUnMUAeoAHHw,1,0,0,0,0,0,2,0,2,0.2857142857142857,2,0.0,0,0,0,0,0,0,0,2,0,0,2,1
965,10580,m1V3ygdnufe369wleiOQ11JelGyARbAF,SpATywNh6bZuzm8s1ceuBUnMUAeoAHHw,30,46,27,34,14,3,22,0,146,20.857142857142858,3,0.0,11,27,28,14,35,3,6,22,0,80,66,1
966,10591,wbbNGhodAmSlYSg7ZSWYtWMdb0rjLgRw,G8EPVSXsOYB5YQWZGiz1aVq5Pgr2GrQu,68,41,23,148,11,43,25,1,292,41.714285714285715,5,0.0,3,23,139,11,38,43,9,25,1,176,116,0
967,10602,v86tUMPiBVyN5RvZX1ZNepQ3NEMTABtY,A3fsA9Zfv1X2fVEQhTw51lKENdNrEqT3,20,21,20,0,20,0,1,0,62,8.857142857142858,1,0.0,0,20,0,20,21,0,0,1,0,40,22,1
968,10604,UKrQdzHwNJRJK7ZoTzKsoWlrkEbsQk7X,G8EPVSXsOYB5YQWZGiz1aVq5Pgr2GrQu,22,19,13,0,8,11,12,0,63,9.0,3,0.0,0,13,0,8,19,11,0,12,0,21,42,1
969,10606,BOBLP6pTmRtpQ8LtVgJyutFMDL3q6xno,SpATywNh6bZuzm8s1ceuBUnMUAeoAHHw,28,32,19,14,7,0,6,0,78,11.142857142857142,5,0.0,7,19,14,7,25,0,0,6,0,47,31,0
970,10608,a3StgABPgimfVHzW1FR4usG9kIA0tZV5,SpATywNh6bZuzm8s1ceuBUnMUAeoAHHw,22,86,0,26,0,4,19,0,135,19.285714285714285,6,0.0,7,0,21,0,79,4,5,19,0,28,107,0
971,10609,VYMfm0tgVS6x4Eosz9NPpRPYpCrgFsMy,bWdj2GDclj5ofokWjzoa5jAwMkxCykd6,35,51,27,198,13,17,12,0,318,45.42857142857143,4,0.0,14,27,177,13,37,17,21,12,0,231,87,1
972,10619,CGB0PTeWY2VA2Nk2INJOsdD7IvpzgObV,G8EPVSXsOYB5YQWZGiz1aVq5Pgr2GrQu,11,12,7,0,3,0,11,0,33,4.714285714285714,3,0.0,0,7,0,3,12,0,0,11,0,10,23,1
973,10620,uhhVn2X7KTVJ0ZZ7uUwG1hMZv4TidRQj,SpATywNh6bZuzm8s1ceuBUnMUAeoAHHw,5,2,1,0,1,0,2,0,6,0.8571428571428571,1,0.0,0,1,0,1,2,0,0,2,0,2,4,1
974,10623,dzaUNwKZy91BtYj96fOhuSgIlp9lXQDU,SpATywNh6bZuzm8s1ceuBUnMUAeoAHHw,9,13,7,0,1,2,7,0,30,4.285714285714286,4,0.0,2,7,0,1,11,2,0,7,0,10,20,0
975,10634,OUOJlObKrXM0JmEUq0o8KzZHzr8jy9dn,bWdj2GDclj5ofokWjzoa5jAwMkxCykd6,9,8,3,0,3,8,12,1,35,5.0,4,0.0,3,3,0,3,5,8,0,12,1,9,26,0
976,10637,uzPUKUi7vVAcTKZXvlLeqjC4erxz8WBI,bWdj2GDclj5ofokWjzoa5jAwMkxCykd6,13,20,14,0,12,6,4,0,56,8.0,5,0.0,0,14,0,12,20,6,0,4,0,26,30,0
977,10642,OnuqqUI42ulcOdv07J5FWiuL2V3DVzCo,RXDvfPUBYFlVdlueBFbLW0mhhAyGEqpt,10,15,8,0,2,0,5,0,30,4.285714285714286,4,0.0,0,8,0,2,15,0,0,5,0,10,20,1
978,10647,JqgIGUKaljto8rJQxV18FonxG0JqVkY4,SpATywNh6bZuzm8s1ceuBUnMUAeoAHHw,13,19,2,0,1,0,5,0,27,3.857142857142857,2,0.0,0,2,0,1,19,0,0,5,0,3,24,1
979,10655,39GYbZ8lJRbKZppnA1dQGPRJvzLTR46Q,SpATywNh6bZuzm8s1ceuBUnMUAeoAHHw,12,29,13,0,5,10,11,1,69,9.857142857142858,5,0.0,0,13,0,5,29,10,0,11,1,18,51,0
980,10658,teqJGecOr4a6oVYU1O9bgvPkX5ZSKA8N,A3fsA9Zfv1X2fVEQhTw51lKENdNrEqT3,3,2,0,0,0,0,1,0,3,0.42857142857142855,1,0.0,0,0,0,0,2,0,0,1,0,0,3,1
981,10666,9G8Z3eYe0C9cQmNRrnywgJDzRVO9yiAU,SpATywNh6bZuzm8s1ceuBUnMUAeoAHHw,10,7,4,0,3,0,2,0,16,2.2857142857142856,1,0.0,0,4,0,3,7,0,0,2,0,7,9,1
982,10667,gvBW2L5p7TFF6lkwpHMNMz6nt7oEVYk1,SpATywNh6bZuzm8s1ceuBUnMUAeoAHHw,15,20,7,14,2,0,10,0,53,7.571428571428571,2,0.0,10,7,14,2,10,0,0,10,0,33,20,0
983,10670,vUBx8sjBPXrETcrwHSfZ0pSQFIH0HPOl,SpATywNh6bZuzm8s1ceuBUnMUAeoAHHw,8,6,3,0,2,0,7,0,18,2.5714285714285716,2,0.0,0,3,0,2,6,0,0,7,0,5,13,1
984,10671,xg8dkQPzve0MzcpgxvEsbKyY4VwKrxAC,A3fsA9Zfv1X2fVEQhTw51lKENdNrEqT3,15,22,1,0,0,0,5,0,28,4.0,2,0.0,1,1,0,0,21,0,0,5,0,2,26,1
985,10676,Bv9FSXvHlE6wLC4E4yrAKqe3BQhrrtfx,SpATywNh6bZuzm8s1ceuBUnMUAeoAHHw,22,50,2,26,2,1,8,0,89,12.714285714285714,4,0.0,16,2,20,2,34,1,6,8,0,40,49,0
986,10677,e3VhXxfZ0vOxuCz75HZxH5mLRjbeafOC,A3fsA9Zfv1X2fVEQhTw51lKENdNrEqT3,46,19,15,66,11,4,14,3,132,18.857142857142858,3,0.0,1,15,57,11,18,4,9,14,3,84,48,1
987,10692,rTYF0meww41Jaf1ZhSKn71dF6UobIHyn,SpATywNh6bZuzm8s1ceuBUnMUAeoAHHw,26,66,4,20,2,10,25,1,128,18.285714285714285,6,0.0,8,4,20,2,58,10,0,25,1,34,94,0
988,10693,ZAehH9zLr3mvrD0qfr21tfeJdYtTkUHf,SpATywNh6bZuzm8s1ceuBUnMUAeoAHHw,20,24,2,10,2,12,16,2,68,9.714285714285714,4,0.0,4,2,9,2,20,12,1,16,2,17,51,1
989,10700,jX1wtG8uym7vm2Ny85W79HCXnEeqhUm4,bWdj2GDclj5ofokWjzoa5jAwMkxCykd6,22,48,23,82,5,51,25,2,236,33.714285714285715,6,0.0,13,23,71,5,35,51,11,25,2,112,124,0
990,10701,01A7cnd3gvCIwCcMkE5K8qeHnbk9l92w,SpATywNh6bZuzm8s1ceuBUnMUAeoAHHw,10,8,1,0,1,0,5,0,15,2.142857142857143,2,0.0,0,1,0,1,8,0,0,5,0,2,13,1
991,10712,IaSb2U7ef1Fkefm60uQQgWhKloK1Rfe8,SpATywNh6bZuzm8s1ceuBUnMUAeoAHHw,28,26,16,26,8,0,10,0,86,12.285714285714286,5,0.0,5,16,23,8,21,0,3,10,0,52,34,0
992,10725,TgheOgj9khTgshxaHKtqDHWb3smGHeUA,G8EPVSXsOYB5YQWZGiz1aVq5Pgr2GrQu,2,0,0,0,0,0,2,0,2,0.2857142857142857,1,0.0,0,0,0,0,0,0,0,2,0,0,2,1
993,10730,mJZNVvZltlGUOWmItS7lca1ZZKMYLgfv,A3fsA9Zfv1X2fVEQhTw51lKENdNrEqT3,25,7,0,54,0,0,4,0,65,9.285714285714286,2,0.0,2,0,54,0,5,0,0,4,0,56,9,1
994,10743,98UEGByxiN7tned6NDQeKfQDq4HCSGvQ,SpATywNh6bZuzm8s1ceuBUnMUAeoAHHw,30,56,21,27,8,19,13,1,145,20.714285714285715,4,0.0,17,21,23,8,39,19,4,13,1,69,76,0
995,10746,FQskTqGJU9GeC9XfemJd5Qp19XhmSu0D,SpATywNh6bZuzm8s1ceuBUnMUAeoAHHw,9,14,4,0,2,1,7,0,28,4.0,3,0.0,2,4,0,2,12,1,0,7,0,8,20,1
996,10747,348VAoiXzNIM3yBiHWYaT9jpmJfwDK3a,SpATywNh6bZuzm8s1ceuBUnMUAeoAHHw,24,14,9,31,7,0,1,0,62,8.857142857142858,1,0.0,4,9,27,7,10,0,4,1,0,47,15,1
997,10758,JjZeMsAmsZa7SQS0vTrtExRB1lmjwAQ2,SpATywNh6bZuzm8s1ceuBUnMUAeoAHHw,17,48,5,7,5,0,17,0,82,11.714285714285714,5,0.0,5,5,7,5,43,0,0,17,0,22,60,0
998,10760,Y2f2dC6l8KkgqmCmVNjopMQFUan6brSz,G8EPVSXsOYB5YQWZGiz1aVq5Pgr2GrQu,5,5,3,0,2,0,2,0,12,1.7142857142857142,2,0.0,0,3,0,2,5,0,0,2,0,5,7,1
999,10761,Grmueh4kYgLYo2kInw23ZHrSQJbjli7D,SpATywNh6bZuzm8s1ceuBUnMUAeoAHHw,19,23,10,26,6,1,7,2,75,10.714285714285714,3,0.0,9,10,20,6,14,1,6,7,2,45,30,0
1000,10763,tby14fMJpDIjTBkK50rauZ0P5DHnQphs,SpATywNh6bZuzm8s1ceuBUnMUAeoAHHw,20,45,16,12,5,2,12,5,97,13.857142857142858,4,0.0,10,16,12,5,35,2,0,12,5,43,54,1
1001,10774,QmKLhFuFtodx97KXUUkaok1RXKwJOs6p,SpATywNh6bZuzm8s1ceuBUnMUAeoAHHw,21,41,19,24,8,6,17,0,115,16.428571428571427,6,0.0,15,19,20,8,26,6,4,17,0,62,53,0
1002,10780,4rsvMJ6Q6FXQkVitKsbveKESjOLTvSkd,bWdj2GDclj5ofokWjzoa5jAwMkxCykd6,5,2,1,0,1,0,3,0,7,1.0,2,0.0,0,1,0,1,2,0,0,3,0,2,5,1
1003,10784,4fg1E2X2Iqab02UjKHSaN93jLrNDtbK1,SpATywNh6bZuzm8s1ceuBUnMUAeoAHHw,5,2,0,0,0,0,3,0,5,0.7142857142857143,1,0.0,0,0,0,0,2,0,0,3,0,0,5,1
1004,10798,8gqnQBccwF9lDaMHj8oF8zZMqUrUX7OJ,SpATywNh6bZuzm8s1ceuBUnMUAeoAHHw,6,2,0,0,0,0,4,0,6,0.8571428571428571,1,0.0,0,0,0,0,2,0,0,4,0,0,6,1
1005,10799,4wGoSTuzJXBCojeNmaxk9GbR1KaCV7ql,G8EPVSXsOYB5YQWZGiz1aVq5Pgr2GrQu,62,107,10,128,9,2,16,3,275,39.285714285714285,5,0.0,42,10,98,9,65,2,30,16,3,159,116,0
1006,10802,7jkKKf5Pb7FrtJ3WnuF11G7ePioUPJm3,SpATywNh6bZuzm8s1ceuBUnMUAeoAHHw,29,56,32,30,16,6,9,0,149,21.285714285714285,5,0.0,17,32,29,16,39,6,1,9,0,94,55,0
1007,10805,mJAgtJKHxy28GsPIeuAEUCIOXmHzCywF,SpATywNh6bZuzm8s1ceuBUnMUAeoAHHw,32,143,72,16,16,149,82,2,480,68.57142857142857,10,0.0,23,72,15,16,120,149,1,82,2,126,354,0
1008,10815,2MQR5LCqimp6aDvlkve2ALXoA292MToK,A3fsA9Zfv1X2fVEQhTw51lKENdNrEqT3,3,3,0,0,0,0,3,0,6,0.8571428571428571,1,0.0,0,0,0,0,3,0,0,3,0,0,6,1
1009,10820,2DRl1D33z6i9gsgW5IB0KBdkJJ1Zsu7a,SpATywNh6bZuzm8s1ceuBUnMUAeoAHHw,8,6,2,12,0,1,3,0,24,3.4285714285714284,1,0.0,4,2,12,0,2,1,0,3,0,18,6,1
1010,10821,NXEwBXbU6vvce77sujWgRB6LivhFJvRb,SpATywNh6bZuzm8s1ceuBUnMUAeoAHHw,8,11,7,0,4,0,6,0,28,4.0,3,0.0,0,7,0,4,11,0,0,6,0,11,17,0
1011,10824,lMRWvZAvduvP2Pz46WY1VVjM0sCfB7T7,A3fsA9Zfv1X2fVEQhTw51lKENdNrEqT3,14,8,7,0,7,0,1,0,23,3.2857142857142856,1,0.0,0,7,0,7,8,0,0,1,0,14,9,1
1012,10825,7WuJYJfQSGYpjK1VOCbNTWx56QRfHZwF,SpATywNh6bZuzm8s1ceuBUnMUAeoAHHw,12,18,8,0,2,2,11,2,43,6.142857142857143,1,0.0,5,8,0,2,13,2,0,11,2,15,28,1
1013,10832,W73xMu8SLqBdMS90qjmpE3wGeT86YnLl,SpATywNh6bZuzm8s1ceuBUnMUAeoAHHw,1,0,0,0,0,0,1,0,1,0.14285714285714285,1,0.0,0,0,0,0,0,0,0,1,0,0,1,1
1014,10850,O4Go02y0WzYwbHIZc8uk50WjYKUP2Q4Y,G8EPVSXsOYB5YQWZGiz1aVq5Pgr2GrQu,8,12,2,0,3,2,7,0,26,3.7142857142857144,2,0.0,5,2,0,3,7,2,0,7,0,10,16,1
1015,10863,SE8wOQdHqwRS7ESACXcTxQAuYFlgu1Py,SpATywNh6bZuzm8s1ceuBUnMUAeoAHHw,16,48,30,15,0,14,14,0,121,17.285714285714285,4,0.0,12,30,11,0,36,14,4,14,0,53,68,1
1016,10867,n6zGNJI1hLWYjlMIVXYesa3jTXjLwizj,SpATywNh6bZuzm8s1ceuBUnMUAeoAHHw,28,59,37,25,8,0,19,1,149,21.285714285714285,6,0.0,13,37,22,8,46,0,3,19,1,80,69,0
1017,10868,d9cbpiPwBULo3iFfJzjTidseoxKi3AEA,SpATywNh6bZuzm8s1ceuBUnMUAeoAHHw,28,73,13,40,5,55,32,7,225,32.142857142857146,7,0.0,13,13,34,5,60,55,6,32,7,65,160,0
1018,10873,YLA48gUHn1Dc2R5xXAOe8bpBqZ5RWVW4,A3fsA9Zfv1X2fVEQhTw51lKENdNrEqT3,7,5,3,0,1,0,4,0,13,1.8571428571428572,2,0.0,0,3,0,1,5,0,0,4,0,4,9,1
1019,10881,31ZWCwEsmLt26QDeYIg9aUSXrbkhFpxl,SpATywNh6bZuzm8s1ceuBUnMUAeoAHHw,14,8,6,12,3,8,5,0,42,6.0,2,0.0,2,6,10,3,6,8,2,5,0,21,21,0
1020,10883,FRmbznbV6x9Ojz1brfaBTFmC2TFyzd4t,SpATywNh6bZuzm8s1ceuBUnMUAeoAHHw,6,2,1,0,1,0,3,0,7,1.0,1,0.0,0,1,0,1,2,0,0,3,0,2,5,1
1021,10889,QYLtTejmIZrOzfj0rdDVGzAjECmBavYx,A3fsA9Zfv1X2fVEQhTw51lKENdNrEqT3,22,12,9,0,7,4,11,1,44,6.285714285714286,4,0.0,0,9,0,7,12,4,0,11,1,16,28,1
1022,10902,wGtQdpTL13GOtTQAxkeOO6rmRR5kG8Nt,G8EPVSXsOYB5YQWZGiz1aVq5Pgr2GrQu,17,19,1,15,1,3,12,1,52,7.428571428571429,2,0.0,6,1,9,1,13,3,6,12,1,17,35,1
1023,10903,896KUUFdpc0Ig8weMXOkWbw7cjXtmIVV,SpATywNh6bZuzm8s1ceuBUnMUAeoAHHw,19,16,6,20,3,0,15,1,61,8.714285714285714,5,0.0,4,6,19,3,12,0,1,15,1,32,29,0
1024,10907,90tR2Jy52lv1kJ6TwJ9Jqo5P6u0CqT0E,SpATywNh6bZuzm8s1ceuBUnMUAeoAHHw,16,25,15,15,10,0,5,0,70,10.0,3,0.0,5,15,13,10,20,0,2,5,0,43,27,0
1025,10959,DgZ8el6keJUnUjxjYHQCrfhij2kpBixa,SpATywNh6bZuzm8s1ceuBUnMUAeoAHHw,6,5,1,0,1,0,6,0,13,1.8571428571428572,3,0.0,0,1,0,1,5,0,0,6,0,2,11,1
1026,10960,0LuT01kLiLvn9XWvvtK0UMLQOoqN4d0O,SpATywNh6bZuzm8s1ceuBUnMUAeoAHHw,7,3,2,0,2,0,2,0,9,1.2857142857142858,1,0.0,0,2,0,2,3,0,0,2,0,4,5,1
1027,10961,1N6nOsYXnkatuA8YMolfRAv0tQpjn2uG,SpATywNh6bZuzm8s1ceuBUnMUAeoAHHw,17,27,13,19,6,5,7,0,77,11.0,4,0.0,8,13,16,6,19,5,3,7,0,43,34,0
1028,10965,Vc1baHxuYCOF9wXqOziB65UR0NyB8LSm,bWdj2GDclj5ofokWjzoa5jAwMkxCykd6,13,12,0,78,0,8,4,0,102,14.571428571428571,2,0.0,3,0,75,0,9,8,3,4,0,78,24,1
1029,10966,DmvuE1XVhhp2s0ZR7GTfZK1NmSM6wJmI,SpATywNh6bZuzm8s1ceuBUnMUAeoAHHw,18,19,8,14,4,2,7,1,55,7.857142857142857,1,0.0,9,8,12,4,10,2,2,7,1,33,22,1
1030,10970,IdRsdksEKIk9aXKOiGRUkjb7QPozokDa,SpATywNh6bZuzm8s1ceuBUnMUAeoAHHw,17,38,2,17,0,0,5,0,62,8.857142857142858,4,0.0,7,2,14,0,31,0,3,5,0,23,39,0
1031,10977,2VCaGNRfRGGtWxoLqznZdBtjcnH6XG28,SpATywNh6bZuzm8s1ceuBUnMUAeoAHHw,6,5,1,0,1,0,3,0,10,1.4285714285714286,2,0.0,0,1,0,1,5,0,0,3,0,2,8,1
1032,10981,gFIubR5L7uAqsUwFMmCtpUtAJn2LXJti,SpATywNh6bZuzm8s1ceuBUnMUAeoAHHw,12,31,12,0,8,0,15,2,68,9.714285714285714,3,0.0,0,12,0,8,31,0,0,15,2,20,48,1
1033,10986,MN4wOgynUY4QcRaraCB5Ym52vNjUttfc,SpATywNh6bZuzm8s1ceuBUnMUAeoAHHw,28,35,20,37,13,9,5,0,119,17.0,2,0.0,11,20,31,13,24,9,6,5,0,75,44,0
1034,10992,EaV63ns250Za7MNTuadlc0JeYoVcm5bM,SpATywNh6bZuzm8s1ceuBUnMUAeoAHHw,26,40,6,25,4,4,11,0,90,12.857142857142858,4,0.0,16,6,22,4,24,4,3,11,0,48,42,0
1035,11000,zyIWmJjaz36PnMZpAzR2HEZCUbJWe8iQ,bWdj2GDclj5ofokWjzoa5jAwMkxCykd6,39,43,18,97,11,1,16,1,187,26.714285714285715,6,0.0,17,18,93,11,26,1,4,16,1,139,48,1
1036,11005,o6ABKk2KTrZIkABXncviG8GWvJhMxPWI,A3fsA9Zfv1X2fVEQhTw51lKENdNrEqT3,23,10,5,60,0,0,5,0,80,11.428571428571429,2,0.0,4,5,55,0,6,0,5,5,0,64,16,1
1037,11007,o6ABKk2KTrZIkABXncviG8GWvJhMxPWI,bWdj2GDclj5ofokWjzoa5jAwMkxCykd6,4,2,1,0,0,0,5,0,8,1.1428571428571428,2,0.0,0,1,0,0,2,0,0,5,0,1,7,1
1038,11009,V9WdcffWyPz5HIrf6AUJoXYLZsZmovZs,bWdj2GDclj5ofokWjzoa5jAwMkxCykd6,8,5,2,0,2,0,6,0,15,2.142857142857143,1,0.0,0,2,0,2,5,0,0,6,0,4,11,1
1039,11018,bjG4XBkL5oSJA9TxyrmgPKXKYOTfiWVp,bWdj2GDclj5ofokWjzoa5jAwMkxCykd6,18,40,20,56,12,11,14,1,154,22.0,3,0.0,9,20,49,12,31,11,7,14,1,90,64,0
1040,11035,oOFCpO143ty3GSSLZVLh2o69NMEyxWhF,A3fsA9Zfv1X2fVEQhTw51lKENdNrEqT3,3,0,0,0,0,0,2,1,3,0.42857142857142855,1,0.0,0,0,0,0,0,0,0,2,1,0,3,1
1041,11039,uukZZIB0DkTcJFX9Kfm5gzAJiaQWt3jq,SpATywNh6bZuzm8s1ceuBUnMUAeoAHHw,25,34,18,12,8,12,21,2,107,15.285714285714286,6,0.0,8,18,10,8,26,12,2,21,2,44,63,1
1042,11063,RlHRJAiYu3Nfz7DEuzJcJRZJq4vbOfQu,SpATywNh6bZuzm8s1ceuBUnMUAeoAHHw,8,5,3,0,2,0,8,0,18,2.5714285714285716,3,0.0,0,3,0,2,5,0,0,8,0,5,13,0
1043,11072,48y8P1mBttkP3u0gtvk3ydvAiO35KU2g,SpATywNh6bZuzm8s1ceuBUnMUAeoAHHw,15,23,13,15,7,0,3,0,61,8.714285714285714,4,0.0,7,13,15,7,16,0,0,3,0,42,19,0
1044,11095,ALXyvdc776DMhlVyaaoPo6cQhevpwTYD,SpATywNh6bZuzm8s1ceuBUnMUAeoAHHw,27,68,10,27,2,2,28,1,138,19.714285714285715,10,0.0,31,10,24,2,37,2,3,28,1,67,71,0
1045,11096,vogj6DdqvLTkNOGuPksobO32JsQUkuqr,SpATywNh6bZuzm8s1ceuBUnMUAeoAHHw,23,70,6,41,0,29,20,1,167,23.857142857142858,8,0.0,29,6,34,0,41,29,7,20,1,69,98,0
1046,11098,R5MIWOdfQPF58rt5zIICrbN58FLsYSLK,SpATywNh6bZuzm8s1ceuBUnMUAeoAHHw,21,32,23,9,15,8,12,0,99,14.142857142857142,5,0.0,0,23,7,15,32,8,2,12,0,45,54,0
1047,11099,EfuhWoaB1h47xaBVO37JU7S7sIj3K77V,SpATywNh6bZuzm8s1ceuBUnMUAeoAHHw,23,44,2,37,1,0,13,0,97,13.857142857142858,5,0.0,8,2,32,1,36,0,5,13,0,43,54,0
1048,11100,qRCFXu9SKQXvPlpvjvNkgxm9VD5k2SNq,G8EPVSXsOYB5YQWZGiz1aVq5Pgr2GrQu,6,14,5,0,2,0,7,0,28,4.0,4,0.0,0,5,0,2,14,0,0,7,0,7,21,1
1049,11102,WCS011LuLB85y1yYsddT54kQDph1Fl5i,SpATywNh6bZuzm8s1ceuBUnMUAeoAHHw,11,5,4,0,4,0,2,0,15,2.142857142857143,1,0.0,0,4,0,4,5,0,0,2,0,8,7,1
1050,11108,kfRiZgRVbY5ABTVoI4HG09f2IgSZ5p9y,SpATywNh6bZuzm8s1ceuBUnMUAeoAHHw,1,0,0,0,0,0,1,0,1,0.14285714285714285,1,0.0,0,0,0,0,0,0,0,1,0,0,1,1
1051,11110,fNM6a78gna3DBlYrxiSuwL1HfiXFBx1X,SpATywNh6bZuzm8s1ceuBUnMUAeoAHHw,4,2,1,0,1,0,1,0,5,0.7142857142857143,1,0.0,0,1,0,1,2,0,0,1,0,2,3,1
1052,11117,yBKClM5or0v37bBK9shMFXqtoOJsEOKi,SpATywNh6bZuzm8s1ceuBUnMUAeoAHHw,31,62,23,27,10,9,12,2,145,20.714285714285715,5,0.0,20,23,24,10,42,9,3,12,2,77,68,0
1053,11118,8G3TIfWeYnotKEBloHzMAvSj0jab6YCE,SpATywNh6bZuzm8s1ceuBUnMUAeoAHHw,22,45,9,23,6,1,11,0,95,13.571428571428571,4,0.0,14,9,22,6,31,1,1,11,0,51,44,0
1054,11132,2YJ5Tv1YViB4JNiKZeHEEz6eSF3MN6um,bWdj2GDclj5ofokWjzoa5jAwMkxCykd6,1,0,0,0,0,0,1,0,1,0.14285714285714285,1,0.0,0,0,0,0,0,0,0,1,0,0,1,1
1055,11133,CdI8eHwhOFOmT1gRfkQHwobJyLn2OtRJ,SpATywNh6bZuzm8s1ceuBUnMUAeoAHHw,8,8,2,0,0,0,8,0,18,2.5714285714285716,3,0.0,0,2,0,0,8,0,0,8,0,2,16,1
1056,11140,kQ63n93d5CTXewyEhcoySFeLgYStuYpO,SpATywNh6bZuzm8s1ceuBUnMUAeoAHHw,27,37,20,37,7,7,11,0,119,17.0,7,0.0,9,20,31,7,28,7,6,11,0,67,52,0
1057,11145,UnV0HDk59T6cuzi8hS829ZOjCdT0CRoB,SpATywNh6bZuzm8s1ceuBUnMUAeoAHHw,15,33,10,13,5,6,4,0,71,10.142857142857142,3,0.0,14,10,12,5,19,6,1,4,0,41,30,0
1058,11152,SuK945tkxadINDtal1yRSiV9QKse6fnl,G8EPVSXsOYB5YQWZGiz1aVq5Pgr2GrQu,65,136,46,102,38,25,12,0,359,51.285714285714285,7,0.0,69,46,60,38,67,25,42,12,0,213,146,0
1059,11153,h8eBexpHr95TQpIPdJzX4ggtrj3rthKs,SpATywNh6bZuzm8s1ceuBUnMUAeoAHHw,26,42,23,24,11,9,7,0,116,16.571428571428573,5,0.0,13,23,22,11,29,9,2,7,0,69,47,0
1060,11156,HIC4ktOJbqbNeF2uNjLeMCsJ9XcoLJFS,SpATywNh6bZuzm8s1ceuBUnMUAeoAHHw,7,9,5,0,5,0,3,0,22,3.142857142857143,2,0.0,0,5,0,5,9,0,0,3,0,10,12,1
1061,11196,0K6JPqiivQzicxY4EV4nqMLCL3a08A97,A3fsA9Zfv1X2fVEQhTw51lKENdNrEqT3,6,1,1,0,1,0,5,0,8,1.1428571428571428,2,0.0,0,1,0,1,1,0,0,5,0,2,6,1
1062,11199,G5krO16D3cyvAnQXVywA0e0QfvmDKyJE,SpATywNh6bZuzm8s1ceuBUnMUAeoAHHw,11,35,13,0,6,2,16,1,73,10.428571428571429,4,0.0,2,13,0,6,33,2,0,16,1,21,52,1
1063,11218,ESIDCh7JUpjIHOXvPcQBcrSs3Att83qK,SpATywNh6bZuzm8s1ceuBUnMUAeoAHHw,21,95,2,27,0,6,38,0,168,24.0,8,0.0,8,2,24,0,87,6,3,38,0,34,134,0
1064,11231,FpAFHYP26eZqx6Z5sDhKdTJPTBgbDKt4,SpATywNh6bZuzm8s1ceuBUnMUAeoAHHw,31,94,36,45,9,127,51,5,367,52.42857142857143,10,0.0,38,36,36,9,56,127,9,51,5,119,248,0
1065,11232,wmD7RtZPHqOfpVEXsJ4kv2jVIQOymIt7,G8EPVSXsOYB5YQWZGiz1aVq5Pgr2GrQu,14,10,5,2,3,5,7,1,33,4.714285714285714,1,0.0,3,5,1,3,7,5,1,7,1,12,21,1
1066,11266,VhukMS7IeX7XDUBwwZYzbVsz6P6yEHKX,RXDvfPUBYFlVdlueBFbLW0mhhAyGEqpt,1,0,0,0,0,0,1,0,1,0.14285714285714285,1,0.0,0,0,0,0,0,0,0,1,0,0,1,1
1067,11267,Zp4vK4oqe1AwFnnOJdy7Uz1AWwNAcdOt,SpATywNh6bZuzm8s1ceuBUnMUAeoAHHw,25,27,16,11,11,0,6,0,71,10.142857142857142,3,0.0,4,16,10,11,23,0,1,6,0,41,30,1
1068,11277,fOGAjxxxpsDuk08vAdjWtxgrvUhA2ic8,SpATywNh6bZuzm8s1ceuBUnMUAeoAHHw,12,23,0,22,0,25,4,0,74,10.571428571428571,2,0.0,11,0,17,0,12,25,5,4,0,28,46,1
1069,11298,gnjZOoI8BeitDTrO8bhWhoFLWjid4LeA,A3fsA9Zfv1X2fVEQhTw51lKENdNrEqT3,8,11,9,0,0,0,1,0,21,3.0,1,0.0,0,9,0,0,11,0,0,1,0,9,12,1
1070,11307,1dxQmK9WwlHWuIG7ZTn4PsJ2vflQBDH3,SpATywNh6bZuzm8s1ceuBUnMUAeoAHHw,14,20,2,6,0,1,2,0,31,4.428571428571429,2,0.0,6,2,6,0,14,1,0,2,0,14,17,0
1071,11316,dw8UeboqdsSC29cEE9urly5h5PKlFfq8,SpATywNh6bZuzm8s1ceuBUnMUAeoAHHw,2,0,0,0,0,0,3,0,3,0.42857142857142855,2,0.0,0,0,0,0,0,0,0,3,0,0,3,1
1072,11325,urVw10ZOKTw1O1zHFnsutUzT6EcZdTal,SpATywNh6bZuzm8s1ceuBUnMUAeoAHHw,27,31,12,24,5,0,11,2,85,12.142857142857142,6,0.0,6,12,22,5,25,0,2,11,2,45,40,0
1073,11336,dEamTHPv2n4UBaBMMzaMVTBu34nRHB8p,SpATywNh6bZuzm8s1ceuBUnMUAeoAHHw,5,0,0,0,0,4,5,1,10,1.4285714285714286,1,0.0,0,0,0,0,0,4,0,5,1,0,10,1
1074,11341,mJAgtJKHxy28GsPIeuAEUCIOXmHzCywF,bWdj2GDclj5ofokWjzoa5jAwMkxCykd6,21,80,45,38,22,9,37,0,231,33.0,8,0.0,11,45,36,22,69,9,2,37,0,114,117,0
1075,11350,OfMabADNCpK7MfQ7IaqBsUw8RvPeHL0S,G8EPVSXsOYB5YQWZGiz1aVq5Pgr2GrQu,1,0,0,0,0,0,1,0,1,0.14285714285714285,1,0.0,0,0,0,0,0,0,0,1,0,0,1,1
1076,11351,1YxknoiTrSwQgclDlSAh4oMYHRyARhLv,A3fsA9Zfv1X2fVEQhTw51lKENdNrEqT3,16,9,6,2,4,0,7,0,28,4.0,4,0.0,0,6,2,4,9,0,0,7,0,12,16,1
1077,11353,8OeiQbuEbEG2DSTpkZJyuKzc1PTNg0ge,SpATywNh6bZuzm8s1ceuBUnMUAeoAHHw,5,3,1,0,1,0,1,0,6,0.8571428571428571,1,0.0,0,1,0,1,3,0,0,1,0,2,4,1
1078,11366,GsMuFjXWxUh2UrLHKPEnIwFvWlVxAcB7,SpATywNh6bZuzm8s1ceuBUnMUAeoAHHw,6,3,2,0,2,0,1,0,8,1.1428571428571428,1,0.0,0,2,0,2,3,0,0,1,0,4,4,0
1079,11367,zEiNHlokNuJTLVoV4Hy4kJd9kzaIjztD,SpATywNh6bZuzm8s1ceuBUnMUAeoAHHw,30,38,18,20,9,1,7,0,93,13.285714285714286,5,0.0,6,18,16,9,32,1,4,7,0,49,44,0
1080,11369,7KNecsubFdywoFPLyTu2kgv5VbQekjao,SpATywNh6bZuzm8s1ceuBUnMUAeoAHHw,21,32,1,29,0,3,6,0,71,10.142857142857142,2,0.0,15,1,26,0,17,3,3,6,0,42,29,1
1081,11382,GDyZ2LKwtCChKfTbObuzefDdka9nIeiE,G8EPVSXsOYB5YQWZGiz1aVq5Pgr2GrQu,1,0,0,0,0,0,1,0,1,0.14285714285714285,1,0.0,0,0,0,0,0,0,0,1,0,0,1,1
1082,11384,U8CJ4eMAocRPzH9a3a2MJhXfikEQ51WM,bWdj2GDclj5ofokWjzoa5jAwMkxCykd6,5,2,1,0,1,0,2,0,6,0.8571428571428571,1,0.0,0,1,0,1,2,0,0,2,0,2,4,1
1083,11385,KKGY1xUUxKUn4nPRs2VmwvVd6JuyBBfA,SpATywNh6bZuzm8s1ceuBUnMUAeoAHHw,3,0,0,0,0,0,2,3,5,0.7142857142857143,1,0.0,0,0,0,0,0,0,0,2,3,0,5,1
1084,11387,8xe55v4hJPUrl0YZIl8G73vP4j2l4PsW,SpATywNh6bZuzm8s1ceuBUnMUAeoAHHw,25,24,5,24,3,0,5,0,61,8.714285714285714,2,0.0,8,5,19,3,16,0,5,5,0,35,26,0
1085,11393,D1fgtFfIsG1EcZQzDGeiCx6sI7k5ShWV,G8EPVSXsOYB5YQWZGiz1aVq5Pgr2GrQu,11,6,1,0,1,9,9,2,28,4.0,1,0.0,0,1,0,1,6,9,0,9,2,2,26,1
1086,11396,rYSxun4NgQnH8EYwHicH82Z91cblITe8,RXDvfPUBYFlVdlueBFbLW0mhhAyGEqpt,1,0,0,0,0,0,1,0,1,0.14285714285714285,1,0.0,0,0,0,0,0,0,0,1,0,0,1,1
1087,11406,rYSxun4NgQnH8EYwHicH82Z91cblITe8,G8EPVSXsOYB5YQWZGiz1aVq5Pgr2GrQu,1,0,0,0,0,0,1,0,1,0.14285714285714285,1,0.0,0,0,0,0,0,0,0,1,0,0,1,1
1088,11407,HYCkyEJhW9QtzilmanJKsxRLSBi9UGoV,RXDvfPUBYFlVdlueBFbLW0mhhAyGEqpt,1,0,0,0,0,0,1,0,1,0.14285714285714285,1,0.0,0,0,0,0,0,0,0,1,0,0,1,1
1089,11418,Km3IX0L3OZADSpnXU3tgLmBjn4mYhfRJ,SpATywNh6bZuzm8s1ceuBUnMUAeoAHHw,23,41,0,35,0,14,16,1,107,15.285714285714286,2,0.0,11,0,34,0,30,14,1,16,1,45,62,0
1090,11423,WeFVkkJO52wtRMBMdihRXPPKstU7E9sn,A3fsA9Zfv1X2fVEQhTw51lKENdNrEqT3,2,0,0,0,0,0,2,0,2,0.2857142857142857,1,0.0,0,0,0,0,0,0,0,2,0,0,2,1
1091,11430,7KNecsubFdywoFPLyTu2kgv5VbQekjao,RXDvfPUBYFlVdlueBFbLW0mhhAyGEqpt,12,13,1,0,1,0,3,0,18,2.5714285714285716,3,0.0,0,1,0,1,13,0,0,3,0,2,16,1
1092,11442,Sz8jNgPmKJ1IbqEEVQqTtQlVUDGarqh2,A3fsA9Zfv1X2fVEQhTw51lKENdNrEqT3,26,30,21,0,15,0,22,0,88,12.571428571428571,6,0.0,0,21,0,15,30,0,0,22,0,36,52,0
1093,11448,tLAxgBhXx0zpE8fWNnwggaJx5LeHI2h1,RXDvfPUBYFlVdlueBFbLW0mhhAyGEqpt,68,79,36,173,14,2,14,2,320,45.714285714285715,3,0.0,13,36,163,14,66,2,10,14,2,226,94,1
1094,11450,HnptwVrdWLkMWuHezQcYS6A0pyVov5BG,SpATywNh6bZuzm8s1ceuBUnMUAeoAHHw,32,54,29,55,11,9,19,6,183,26.142857142857142,6,0.0,16,29,43,11,38,9,12,19,6,99,84,0
1095,11454,G5viWFw6vjc0kZ7aRbev4NG1fp3ajLxi,A3fsA9Zfv1X2fVEQhTw51lKENdNrEqT3,17,13,10,0,9,0,2,0,34,4.857142857142857,3,0.0,0,10,0,9,13,0,0,2,0,19,15,1
1096,11455,5ObfmFiTeuGjRWtYuJy4iGiMBZ3jgU0e,SpATywNh6bZuzm8s1ceuBUnMUAeoAHHw,15,28,15,16,10,0,3,0,72,10.285714285714286,4,0.0,8,15,14,10,20,0,2,3,0,47,25,1
1097,11456,CWDKRVVm01sfgssULmzIPwx9dbULLbqB,A3fsA9Zfv1X2fVEQhTw51lKENdNrEqT3,60,41,27,182,20,19,9,0,298,42.57142857142857,4,0.0,2,27,155,20,39,19,27,9,0,204,94,0
1098,11461,cW0TF0QgesgeR4yvyFNeSG2Tsy7pGtpm,A3fsA9Zfv1X2fVEQhTw51lKENdNrEqT3,49,78,17,84,11,9,23,1,223,31.857142857142858,5,0.0,4,17,65,11,74,9,19,23,1,97,126,1
1099,11472,mN4qYBgpy4Qxh2rSlBkY5ZDyLEZtAHu9,RXDvfPUBYFlVdlueBFbLW0mhhAyGEqpt,57,43,26,82,15,30,11,10,217,31.0,5,0.0,11,26,80,15,32,30,2,11,10,132,85,1
1100,11483,fG7nauhHd6Hp0Y6uPPSQifF45RcZ5wiO,SpATywNh6bZuzm8s1ceuBUnMUAeoAHHw,14,17,2,17,0,1,3,0,40,5.714285714285714,2,0.0,3,2,14,0,14,1,3,3,0,19,21,1
1101,11490,mDEirND7nLzt2vy8e34SZhdfEbglxCWs,SpATywNh6bZuzm8s1ceuBUnMUAeoAHHw,29,81,21,28,9,20,20,1,180,25.714285714285715,4,0.0,21,21,22,9,60,20,6,20,1,73,107,0
1102,11494,nBVpguvJeCUz3AWDoX9CCNT2qyeZb33T,G8EPVSXsOYB5YQWZGiz1aVq5Pgr2GrQu,41,65,44,84,1,8,10,0,212,30.285714285714285,5,0.0,10,44,67,1,55,8,17,10,0,122,90,0
1103,11497,tfkukKUMRkePYIfP864uQoXVHWicLcZ3,A3fsA9Zfv1X2fVEQhTw51lKENdNrEqT3,13,23,12,0,5,0,9,0,49,7.0,2,0.0,1,12,0,5,22,0,0,9,0,18,31,1
1104,11511,zNxhmmLWnSaIABuhKypYetmsDg2VcOK8,SpATywNh6bZuzm8s1ceuBUnMUAeoAHHw,14,12,6,11,5,1,3,0,38,5.428571428571429,3,0.0,4,6,11,5,8,1,0,3,0,26,12,1
1105,11516,aSlIMkfly6xTMJCGTWDQcnFZjajcWM6y,RXDvfPUBYFlVdlueBFbLW0mhhAyGEqpt,21,37,4,0,4,4,8,0,57,8.142857142857142,6,0.0,4,4,0,4,33,4,0,8,0,12,45,0
1106,11541,vIBcYbs1BLdmaaP30fcE2FS7kB7v7QRn,A3fsA9Zfv1X2fVEQhTw51lKENdNrEqT3,7,16,8,0,1,0,11,0,36,5.142857142857143,5,0.0,0,8,0,1,16,0,0,11,0,9,27,1
1107,11546,9PS6Icub6VXkyVUcoskrzajETE7Qoarh,SpATywNh6bZuzm8s1ceuBUnMUAeoAHHw,26,51,20,24,8,6,8,0,117,16.714285714285715,4,0.0,23,20,20,8,28,6,4,8,0,71,46,0
1108,11556,pplAmbuLk2c8g7K4eYBlhKFfYSpZgbNo,SpATywNh6bZuzm8s1ceuBUnMUAeoAHHw,20,39,4,10,1,0,19,1,74,10.571428571428571,6,0.0,6,4,8,1,33,0,2,19,1,19,55,0
1109,11557,mtYhUCuiqvMc7E9n6ZRYWej43jynHbMu,SpATywNh6bZuzm8s1ceuBUnMUAeoAHHw,14,18,12,10,8,0,4,0,52,7.428571428571429,2,0.0,1,12,9,8,17,0,1,4,0,30,22,1
1110,11564,ZPbUovw1YoDeaWUVrbGEj5A5WdIXTYjf,SpATywNh6bZuzm8s1ceuBUnMUAeoAHHw,8,9,5,0,2,0,1,0,17,2.4285714285714284,1,0.0,0,5,0,2,9,0,0,1,0,7,10,1
1111,11568,l1IK9ZY8MbRv8UoeCkxEH7P4W2dtATGX,SpATywNh6bZuzm8s1ceuBUnMUAeoAHHw,26,34,4,22,2,1,9,1,73,10.428571428571429,5,0.0,6,4,22,2,28,1,0,9,1,34,39,0
1112,11574,ypwDBeQLkxtWilMLhemtoXkZG88PSCik,SpATywNh6bZuzm8s1ceuBUnMUAeoAHHw,18,77,33,0,0,1,17,1,129,18.428571428571427,6,0.0,14,33,0,0,63,1,0,17,1,47,82,0
1113,11576,GKKNtfrAHKD2xUEQBz7HLN3kKO9SrWyD,SpATywNh6bZuzm8s1ceuBUnMUAeoAHHw,18,80,44,12,11,42,46,3,238,34.0,6,0.0,10,44,9,11,70,42,3,46,3,74,164,0
1114,11579,MgYx3sTen8piVhQ0ZPLZ6p6e7rh59bPE,SpATywNh6bZuzm8s1ceuBUnMUAeoAHHw,11,18,0,8,0,0,7,0,33,4.714285714285714,2,0.0,5,0,7,0,13,0,1,7,0,12,21,1
1115,11581,PXjkYsNMSYVKdz07qjMtS6mMBWIuSmKF,bWdj2GDclj5ofokWjzoa5jAwMkxCykd6,6,8,0,0,0,1,7,2,18,2.5714285714285716,2,0.0,0,0,0,0,8,1,0,7,2,0,18,1
1116,11586,GIK69AVoFAXQo5stVHHEqOqo5xlrkSOx,SpATywNh6bZuzm8s1ceuBUnMUAeoAHHw,21,44,1,12,1,40,57,7,162,23.142857142857142,11,0.0,6,1,10,1,38,40,2,57,7,18,144,0
1117,11591,nlq4r6xc3rTUqTwcYhL6wudXdN6RIE52,A3fsA9Zfv1X2fVEQhTw51lKENdNrEqT3,30,28,20,0,11,0,9,0,68,9.714285714285714,3,0.0,0,20,0,11,28,0,0,9,0,31,37,0
1118,11593,wmwDf7eIRrKPL0l8cNmMygnEPd5vzoqs,SpATywNh6bZuzm8s1ceuBUnMUAeoAHHw,28,65,9,14,5,1,10,1,105,15.0,5,0.0,23,9,14,5,42,1,0,10,1,51,54,0
1119,11596,2AeMxbMeXomHZjSsEj2bsr8PzPP1Dh6q,bWdj2GDclj5ofokWjzoa5jAwMkxCykd6,16,46,21,32,5,12,21,2,139,19.857142857142858,2,0.0,12,21,30,5,34,12,2,21,2,68,71,1
1120,11599,GD5KzWMBHDnHVJHzVFtf3u7bIC7XYtJH,SpATywNh6bZuzm8s1ceuBUnMUAeoAHHw,25,68,2,36,1,3,41,1,152,21.714285714285715,8,0.0,8,2,28,1,60,3,8,41,1,39,113,0
1121,11600,IroEtJPlvjKfczRi5laeb2DQegyNKOWM,SpATywNh6bZuzm8s1ceuBUnMUAeoAHHw,17,23,13,10,6,7,5,0,64,9.142857142857142,2,0.0,6,13,8,6,17,7,2,5,0,33,31,0
1122,11603,wrdkNhe8GmpsjdZUr22H6zTi43mdouZW,SpATywNh6bZuzm8s1ceuBUnMUAeoAHHw,23,36,2,26,2,0,8,0,74,10.571428571428571,2,0.0,5,2,23,2,31,0,3,8,0,32,42,1
1123,11606,nNXCDU7pCvXdQPycxWESwEGIIRWvHKWv,A3fsA9Zfv1X2fVEQhTw51lKENdNrEqT3,1,0,0,0,0,0,1,0,1,0.14285714285714285,1,0.0,0,0,0,0,0,0,0,1,0,0,1,1
1124,11607,nNXCDU7pCvXdQPycxWESwEGIIRWvHKWv,bWdj2GDclj5ofokWjzoa5jAwMkxCykd6,6,13,3,0,2,14,3,1,36,5.142857142857143,1,0.0,0,3,0,2,13,14,0,3,1,5,31,1
1125,11609,lk3lGbNCFxoPG1OVILbfGp3s2wN91K2M,SpATywNh6bZuzm8s1ceuBUnMUAeoAHHw,3,3,0,0,0,0,1,0,4,0.5714285714285714,1,0.0,0,0,0,0,3,0,0,1,0,0,4,1
1126,11624,Kw83ufYGIFIihz0PdiaJro4hz0pKGozQ,SpATywNh6bZuzm8s1ceuBUnMUAeoAHHw,11,8,0,10,0,0,2,0,20,2.857142857142857,2,0.0,2,0,8,0,6,0,2,2,0,10,10,1
1127,11628,BHczT02DEALJmy7zbrGU6QbzLcOGM0Lz,SpATywNh6bZuzm8s1ceuBUnMUAeoAHHw,23,38,2,10,4,5,8,1,68,9.714285714285714,3,0.0,9,2,10,4,29,5,0,8,1,25,43,0
1128,11630,MR4k3wv95Ttq1fQaT9W4WgxrPezl0N4j,SpATywNh6bZuzm8s1ceuBUnMUAeoAHHw,5,3,1,0,1,0,4,0,9,1.2857142857142858,1,0.0,0,1,0,1,3,0,0,4,0,2,7,1
1129,11637,glYOnGBygagQ3d4VwvOcHKnCEWLKXuzk,SpATywNh6bZuzm8s1ceuBUnMUAeoAHHw,23,95,6,28,1,0,19,0,149,21.285714285714285,4,0.0,38,6,26,1,57,0,2,19,0,71,78,0
1130,11641,WHRYwHaNw8C182lJomkvSukjZ7e91Upo,SpATywNh6bZuzm8s1ceuBUnMUAeoAHHw,30,38,24,25,9,26,11,2,135,19.285714285714285,2,0.0,10,24,19,9,28,26,6,11,2,62,73,1
1131,11650,ilWzYGLWBh9DSc1MV8g2C4Go5wDNgUHX,SpATywNh6bZuzm8s1ceuBUnMUAeoAHHw,21,23,13,20,3,6,5,0,70,10.0,4,0.0,6,13,18,3,17,6,2,5,0,40,30,0
1132,11651,tnLfm9tutF6YoqDXNIONCmii1aynBy80,G8EPVSXsOYB5YQWZGiz1aVq5Pgr2GrQu,59,112,47,126,17,57,46,1,406,58.0,8,0.0,19,47,104,17,93,57,22,46,1,187,219,0
1133,11653,WHRYwHaNw8C182lJomkvSukjZ7e91Upo,G8EPVSXsOYB5YQWZGiz1aVq5Pgr2GrQu,53,58,18,108,10,19,11,2,226,32.285714285714285,2,0.0,32,18,74,10,26,19,34,11,2,134,92,1
1134,11668,3D1G3v8o9ZJD4YifQcvj5oZ6l4EKMMc3,SpATywNh6bZuzm8s1ceuBUnMUAeoAHHw,31,42,12,24,7,13,13,0,111,15.857142857142858,4,0.0,16,12,24,7,26,13,0,13,0,59,52,0
1135,11670,LJnHkVr961LFlbm7Gjo7zRYOv6MZ6dE5,bWdj2GDclj5ofokWjzoa5jAwMkxCykd6,6,4,2,0,1,0,4,0,11,1.5714285714285714,1,0.0,0,2,0,1,4,0,0,4,0,3,8,1
1136,11682,VLIaJAnZiJEAdolQsQ0bq4zJoZaIUmTN,SpATywNh6bZuzm8s1ceuBUnMUAeoAHHw,7,5,1,0,1,0,8,0,15,2.142857142857143,2,0.0,0,1,0,1,5,0,0,8,0,2,13,1
1137,11688,QyLVPf4M60EkZ1E7DsOzioCPS0UDQt1T,SpATywNh6bZuzm8s1ceuBUnMUAeoAHHw,12,17,1,12,1,2,8,0,41,5.857142857142857,3,0.0,0,1,10,1,17,2,2,8,0,12,29,1
1138,11692,relWJA0qYE5Pue4C6aAwg584OGIxhwwx,A3fsA9Zfv1X2fVEQhTw51lKENdNrEqT3,1,0,0,0,0,0,2,0,2,0.2857142857142857,2,0.0,0,0,0,0,0,0,0,2,0,0,2,1
1139,11698,kVkYStq5954wY9YqVoootgnbo59g0CLi,SpATywNh6bZuzm8s1ceuBUnMUAeoAHHw,4,2,0,0,0,0,2,0,4,0.5714285714285714,1,0.0,0,0,0,0,2,0,0,2,0,0,4,1
1140,11699,fJdUKH8czX92V7yfMeG7e087z1xbQDMc,SpATywNh6bZuzm8s1ceuBUnMUAeoAHHw,29,22,13,14,8,3,6,0,66,9.428571428571429,2,0.0,7,13,14,8,15,3,0,6,0,42,24,0
1141,11704,DVIil2NM7ZWOtqe6rhlMzwEUAb2wuaeh,SpATywNh6bZuzm8s1ceuBUnMUAeoAHHw,21,52,26,6,7,11,13,1,116,16.571428571428573,6,0.0,10,26,6,7,42,11,0,13,1,49,67,1
1142,11719,cr12tMBqYKzLJbEmIsyFvFLKAg0DiCbM,SpATywNh6bZuzm8s1ceuBUnMUAeoAHHw,29,55,20,16,11,0,8,0,110,15.714285714285714,6,0.0,10,20,15,11,45,0,1,8,0,56,54,0
1143,11732,6L205IIarnrBFjrCXSXMQhtSJJ5O5hiQ,SpATywNh6bZuzm8s1ceuBUnMUAeoAHHw,29,116,57,26,24,3,25,18,269,38.42857142857143,3,0.0,33,57,21,24,83,3,5,25,18,135,134,0
1144,11737,vn3szbx80pQPfVJU7Et6YnUzTgKJ2evQ,A3fsA9Zfv1X2fVEQhTw51lKENdNrEqT3,8,3,2,0,2,0,5,0,12,1.7142857142857142,2,0.0,0,2,0,2,3,0,0,5,0,4,8,1
1145,11743,relWJA0qYE5Pue4C6aAwg584OGIxhwwx,SpATywNh6bZuzm8s1ceuBUnMUAeoAHHw,1,0,0,0,0,0,1,0,1,0.14285714285714285,1,0.0,0,0,0,0,0,0,0,1,0,0,1,1
1146,11765,CF9EOBndFkwfNq6XdrlnJGwplvjOhGZh,SpATywNh6bZuzm8s1ceuBUnMUAeoAHHw,22,62,4,31,0,23,13,0,133,19.0,2,0.0,25,4,29,0,37,23,2,13,0,58,75,0
1147,11773,gxkoHTlKe7FVuciB5TU7TNQLS1IuXLYY,SpATywNh6bZuzm8s1ceuBUnMUAeoAHHw,25,49,2,32,2,19,11,1,116,16.571428571428573,6,0.0,18,2,28,2,31,19,4,11,1,50,66,1
1148,11782,twnWF0mfZYHjmoqBvUs9g7jWpDxNR6WV,SpATywNh6bZuzm8s1ceuBUnMUAeoAHHw,24,52,16,22,3,17,15,1,126,18.0,3,0.0,32,16,20,3,20,17,2,15,1,71,55,1
1149,11795,iQzwToywLVi52lg7X1CKAqUmrJweCbY4,A3fsA9Zfv1X2fVEQhTw51lKENdNrEqT3,2,0,0,0,0,0,4,0,4,0.5714285714285714,1,0.0,0,0,0,0,0,0,0,4,0,0,4,1
1150,11796,5Pn4uvjsBWdhF0lVc4LtU6HIHnySgqaU,SpATywNh6bZuzm8s1ceuBUnMUAeoAHHw,1,0,0,0,0,0,1,0,1,0.14285714285714285,1,0.0,0,0,0,0,0,0,0,1,0,0,1,1
1151,11797,ejIJpZTu0P4rcWcZmBKl6OiURGceVpiA,SpATywNh6bZuzm8s1ceuBUnMUAeoAHHw,28,39,18,13,7,1,9,0,87,12.428571428571429,5,0.0,8,18,13,7,31,1,0,9,0,46,41,0
1152,11803,jpgFrFPODuxdIxVKUbbelvbFMPtUp7jo,SpATywNh6bZuzm8s1ceuBUnMUAeoAHHw,31,38,17,19,9,29,13,1,126,18.0,4,0.0,15,17,17,9,23,29,2,13,1,58,68,0
1153,11822,neCsLgPwvO3NM22QUF7ePoDh9jooDB1R,G8EPVSXsOYB5YQWZGiz1aVq5Pgr2GrQu,19,30,4,8,3,5,15,1,66,9.428571428571429,5,0.0,5,4,7,3,25,5,1,15,1,19,47,0
1154,11830,OJNek1dgn6lYb4ldZM3hUDbtlOcoRdmG,SpATywNh6bZuzm8s1ceuBUnMUAeoAHHw,14,11,7,11,5,0,3,0,37,5.285714285714286,2,0.0,2,7,10,5,9,0,1,3,0,24,13,0
1155,11866,0Ycdp4l6pgMwD7gJz4jynSnW5FA5aOcj,RXDvfPUBYFlVdlueBFbLW0mhhAyGEqpt,18,31,19,0,11,1,11,3,76,10.857142857142858,1,0.0,6,19,0,11,25,1,0,11,3,36,40,0
1156,11868,grkG64gC1ukbqi3lu9n1P24tGPzF2BzQ,SpATywNh6bZuzm8s1ceuBUnMUAeoAHHw,26,59,37,12,18,20,19,0,165,23.571428571428573,6,0.0,10,37,10,18,49,20,2,19,0,75,90,0
1157,11873,CLsYy7g1hYWHJyj1aROfKK9oTeo5yxJx,SpATywNh6bZuzm8s1ceuBUnMUAeoAHHw,30,42,19,29,8,8,15,1,122,17.428571428571427,6,0.0,13,19,26,8,29,8,3,15,1,66,56,0
1158,11875,s1zoJG6TsTv8LP9PRWCYbeiv4OLIivpy,SpATywNh6bZuzm8s1ceuBUnMUAeoAHHw,21,21,14,0,10,0,5,0,50,7.142857142857143,4,0.0,0,14,0,10,21,0,0,5,0,24,26,0
1159,11882,x5ZyS8ChPKTwgxrKWhGeApVsRxKYNf86,SpATywNh6bZuzm8s1ceuBUnMUAeoAHHw,18,27,0,12,1,2,10,0,52,7.428571428571429,2,0.0,14,0,9,1,13,2,3,10,0,24,28,1
1160,11885,5Yc9dIv7921c7z5p5LW8t3x8iddn1yRC,SpATywNh6bZuzm8s1ceuBUnMUAeoAHHw,30,81,23,35,10,5,20,1,175,25.0,3,0.0,19,23,33,10,62,5,2,20,1,85,90,1
1161,11891,BeyfLbwb8pdDQU6WTI5ee3FkxRPRP7B2,A3fsA9Zfv1X2fVEQhTw51lKENdNrEqT3,8,7,4,0,2,0,4,0,17,2.4285714285714284,2,0.0,0,4,0,2,7,0,0,4,0,6,11,1
1162,11898,pSPFAE8vJ6UClRkBsZEyTga6sVysOokX,SpATywNh6bZuzm8s1ceuBUnMUAeoAHHw,1,0,0,0,0,0,1,0,1,0.14285714285714285,1,0.0,0,0,0,0,0,0,0,1,0,0,1,1
1163,11909,Hh6CQ9eQF89j5a5Oi2NUf2uAs2DZd4QT,A3fsA9Zfv1X2fVEQhTw51lKENdNrEqT3,51,95,63,76,22,122,39,3,420,60.0,11,0.0,2,63,60,22,93,122,16,39,3,147,273,1
1164,11912,5FSqkpRO54sosmyXXDdXixBIUlxd8QNQ,SpATywNh6bZuzm8s1ceuBUnMUAeoAHHw,18,17,10,20,6,1,7,1,62,8.857142857142858,3,0.0,3,10,16,6,14,1,4,7,1,35,27,0
1165,11928,syrttArug8Mpzs9L0IHsvBtATawYF9J2,A3fsA9Zfv1X2fVEQhTw51lKENdNrEqT3,48,22,11,116,1,1,14,0,165,23.571428571428573,5,0.0,4,11,101,1,18,1,15,14,0,117,48,0
1166,11933,OmF4aFe06TkjIpsTgGpQ4vBzMWi2jjQV,bWdj2GDclj5ofokWjzoa5jAwMkxCykd6,40,34,17,122,10,0,24,1,208,29.714285714285715,5,0.0,8,17,102,10,26,0,20,24,1,137,71,0
1167,11955,oyFfPK6y9oPPwQR5mbsXW98FJaEnU88b,SpATywNh6bZuzm8s1ceuBUnMUAeoAHHw,14,21,7,16,5,2,3,0,54,7.714285714285714,2,0.0,10,7,15,5,11,2,1,3,0,37,17,1
1168,11958,HG2MGN3erjLUr4zPCv4UJukzIqIJPVZ2,SpATywNh6bZuzm8s1ceuBUnMUAeoAHHw,23,33,18,19,7,56,13,1,147,21.0,3,0.0,8,18,16,7,25,56,3,13,1,49,98,1
1169,11969,RhMByUF03fgdIuaHANL6m20mbMakGgJs,SpATywNh6bZuzm8s1ceuBUnMUAeoAHHw,22,54,28,0,13,0,8,0,103,14.714285714285714,4,0.0,5,28,0,13,49,0,0,8,0,46,57,0
1170,11975,MAjx1xtQvL5ZiofHx4xuO3WtfmkLHjqM,SpATywNh6bZuzm8s1ceuBUnMUAeoAHHw,8,6,4,0,3,0,3,0,16,2.2857142857142856,2,0.0,0,4,0,3,6,0,0,3,0,7,9,1
1171,11981,FZjjoikxEifQwEx2vf6LYlhg4yyTwbym,A3fsA9Zfv1X2fVEQhTw51lKENdNrEqT3,22,31,16,0,8,8,23,0,86,12.285714285714286,7,0.0,1,16,0,8,30,8,0,23,0,25,61,1
1172,11982,BA5BMBRmhCtFQyjTLAMMLlVS5ABrW2hi,SpATywNh6bZuzm8s1ceuBUnMUAeoAHHw,12,17,5,14,2,0,3,0,41,5.857142857142857,2,0.0,5,5,11,2,12,0,3,3,0,23,18,0
1173,11998,NHPpKvbnrSpxM8e1DORBWJbRCpmrxZw8,SpATywNh6bZuzm8s1ceuBUnMUAeoAHHw,29,42,22,26,11,6,12,0,119,17.0,4,0.0,14,22,20,11,28,6,6,12,0,67,52,0
1174,12000,tncBhgwJEnaybUdK2e3UQ2PdOl85hyHm,SpATywNh6bZuzm8s1ceuBUnMUAeoAHHw,30,58,21,41,9,20,11,2,162,23.142857142857142,3,0.0,29,21,35,9,29,20,6,11,2,94,68,0
1175,12016,matrDCCbXVpxlcX50EwFfEaLRW1d7v0q,SpATywNh6bZuzm8s1ceuBUnMUAeoAHHw,9,13,3,0,1,1,5,0,23,3.2857142857142856,2,0.0,0,3,0,1,13,1,0,5,0,4,19,1
1176,12019,UaSh8dwx8gnofYbXlmpqj9uYDbpJ89pX,bWdj2GDclj5ofokWjzoa5jAwMkxCykd6,9,29,5,0,2,39,28,0,103,14.714285714285714,8,0.0,0,5,0,2,29,39,0,28,0,7,96,0
1177,12022,wHhHCETlsngCbxRgyphDRhWNDaw9hkb5,bWdj2GDclj5ofokWjzoa5jAwMkxCykd6,7,18,1,30,2,0,1,0,52,7.428571428571429,1,0.0,13,1,29,2,5,0,1,1,0,45,7,1
1178,12028,TnWxqbrMUttPbRmFwVduGXC6tM50wXNs,G8EPVSXsOYB5YQWZGiz1aVq5Pgr2GrQu,17,8,6,16,3,0,7,1,41,5.857142857142857,2,0.0,0,6,13,3,8,0,3,7,1,22,19,1
1179,12029,yj09XjzxRqPWNB0AOEufH55lHRijrBGr,A3fsA9Zfv1X2fVEQhTw51lKENdNrEqT3,11,7,3,0,3,0,6,0,19,2.7142857142857144,1,0.0,0,3,0,3,7,0,0,6,0,6,13,1
1180,12051,ECki0IXplihhOXFtHwNEOZv3lgdNQeLX,bWdj2GDclj5ofokWjzoa5jAwMkxCykd6,8,7,4,0,2,1,7,1,22,3.142857142857143,2,0.0,0,4,0,2,7,1,0,7,1,6,16,1
1181,12052,g3902agYIRHzac78MKVZlvljLMXXNpQ7,SpATywNh6bZuzm8s1ceuBUnMUAeoAHHw,31,50,29,34,11,1,21,0,146,20.857142857142858,7,0.0,9,29,30,11,41,1,4,21,0,79,67,0
1182,12058,iPBAJ9CVDCVYdsrujNIhJfrUSnaDCIHG,bWdj2GDclj5ofokWjzoa5jAwMkxCykd6,6,6,2,0,2,0,4,0,14,2.0,2,0.0,1,2,0,2,5,0,0,4,0,5,9,1
1183,12071,aeavxOLfuZgcJqnNwarxFiMVjjeJZrPA,SpATywNh6bZuzm8s1ceuBUnMUAeoAHHw,5,3,1,0,1,0,2,0,7,1.0,1,0.0,0,1,0,1,3,0,0,2,0,2,5,1
1184,12079,ZpZGRrq9otivAzXqSjL90NMLUImGmxsg,SpATywNh6bZuzm8s1ceuBUnMUAeoAHHw,6,7,1,0,0,0,2,0,10,1.4285714285714286,2,0.0,0,1,0,0,7,0,0,2,0,1,9,1
1185,12082,QWRabGXxCqME5Lkb4IAANkZxIcelEiGP,bWdj2GDclj5ofokWjzoa5jAwMkxCykd6,1,0,0,0,0,0,2,0,2,0.2857142857142857,1,0.0,0,0,0,0,0,0,0,2,0,0,2,1
1186,12083,U0kf3qSBRgyWv3qqGgGYInyPjg6gK9O9,RXDvfPUBYFlVdlueBFbLW0mhhAyGEqpt,1,0,0,0,0,0,1,0,1,0.14285714285714285,1,0.0,0,0,0,0,0,0,0,1,0,0,1,1
1187,12088,7yMNJWNsXgPHWgF0rje4LKKgdLbyOw5Y,A3fsA9Zfv1X2fVEQhTw51lKENdNrEqT3,4,3,2,0,0,0,1,0,6,0.8571428571428571,1,0.0,0,2,0,0,3,0,0,1,0,2,4,1
1188,12097,LclkEDGY7WCR76zraNkzkcQywMJivp2l,SpATywNh6bZuzm8s1ceuBUnMUAeoAHHw,31,93,29,42,19,6,17,2,208,29.714285714285715,3,0.0,25,29,36,19,68,6,6,17,2,109,99,1
1189,12100,tCXa4pMsMXRuliZWNM9so3Odte6UmpYj,A3fsA9Zfv1X2fVEQhTw51lKENdNrEqT3,1,0,0,0,0,0,1,0,1,0.14285714285714285,1,0.0,0,0,0,0,0,0,0,1,0,0,1,1
1190,12111,1GWkEwQ90VRdtDsFxjla0MbrnOSbAEId,RXDvfPUBYFlVdlueBFbLW0mhhAyGEqpt,4,2,0,0,0,0,2,0,4,0.5714285714285714,1,0.0,0,0,0,0,2,0,0,2,0,0,4,1
1191,12119,x0VzAeYdlywtGLqE1HF68qQMYZTLfsw9,A3fsA9Zfv1X2fVEQhTw51lKENdNrEqT3,63,52,37,124,12,6,12,0,243,34.714285714285715,6,0.0,4,37,114,12,48,6,10,12,0,167,76,1
1192,12126,32uJBAomTJQIXKZnCX4K7PYoVfESGbct,RXDvfPUBYFlVdlueBFbLW0mhhAyGEqpt,63,94,51,120,35,0,9,0,309,44.142857142857146,6,0.0,29,51,111,35,65,0,9,9,0,226,83,1
1193,12127,HElrq1eSGzBafUMUdvN7RCubKET34OTX,SpATywNh6bZuzm8s1ceuBUnMUAeoAHHw,1,0,0,0,0,0,1,0,1,0.14285714285714285,1,0.0,0,0,0,0,0,0,0,1,0,0,1,1
1194,12137,jkbAnCxwl3OIEg7uH62X9N4RjNwDvZxg,SpATywNh6bZuzm8s1ceuBUnMUAeoAHHw,19,18,10,0,6,0,4,0,38,5.428571428571429,3,0.0,5,10,0,6,13,0,0,4,0,21,17,1
1195,12139,i8WIZSEgsoHBi5QZhvayPbZQldL0txWw,A3fsA9Zfv1X2fVEQhTw51lKENdNrEqT3,7,3,2,0,2,0,3,0,10,1.4285714285714286,1,0.0,0,2,0,2,3,0,0,3,0,4,6,1
1196,12144,4JPTMOEW3QvxnvFVxcqBPUVqTDTMZIow,SpATywNh6bZuzm8s1ceuBUnMUAeoAHHw,1,0,0,0,0,0,2,0,2,0.2857142857142857,1,0.0,0,0,0,0,0,0,0,2,0,0,2,1
1197,12166,x6CSpC8D3vQdEDfFDD93c2HvZ1J8Rtto,RXDvfPUBYFlVdlueBFbLW0mhhAyGEqpt,66,85,56,124,21,31,9,0,326,46.57142857142857,2,0.0,20,56,112,21,65,31,12,9,0,209,117,1
1198,12171,eAArxLyCThtu9N3Mv8rQculKbGSa66j9,SpATywNh6bZuzm8s1ceuBUnMUAeoAHHw,10,12,8,0,2,9,12,0,43,6.142857142857143,6,0.0,0,8,0,2,12,9,0,12,0,10,33,1
1199,12182,rdSWxFhXxAq7LLsaFRDkga5HDqBXvg9z,bWdj2GDclj5ofokWjzoa5jAwMkxCykd6,2,0,0,0,0,0,2,0,2,0.2857142857142857,1,0.0,0,0,0,0,0,0,0,2,0,0,2,1
1200,12193,ajHCgh5jQq7dgoaNHY1H5hSSSFewTHW9,A3fsA9Zfv1X2fVEQhTw51lKENdNrEqT3,2,0,0,0,0,0,2,0,2,0.2857142857142857,1,0.0,0,0,0,0,0,0,0,2,0,0,2,1
1201,12197,RPansaKc9yPYyKahcqLAJO6a0GoBHglr,SpATywNh6bZuzm8s1ceuBUnMUAeoAHHw,31,66,36,17,21,5,21,1,167,23.857142857142858,8,0.0,14,36,16,21,52,5,1,21,1,87,80,0
1202,12202,rdSWxFhXxAq7LLsaFRDkga5HDqBXvg9z,A3fsA9Zfv1X2fVEQhTw51lKENdNrEqT3,7,5,1,0,1,0,2,0,9,1.2857142857142858,1,0.0,0,1,0,1,5,0,0,2,0,2,7,1
1203,12212,KXPHZfgM3L9NmmWzrburRZrpNwRct3s8,SpATywNh6bZuzm8s1ceuBUnMUAeoAHHw,31,49,21,43,8,12,18,2,153,21.857142857142858,4,0.0,22,21,37,8,27,12,6,18,2,88,65,1
1204,12220,9b4Qm8eSvDuZev1N90TcJBdVRXi0Jx1k,SpATywNh6bZuzm8s1ceuBUnMUAeoAHHw,24,24,2,39,1,5,8,1,80,11.428571428571429,2,0.0,10,2,33,1,14,5,6,8,1,46,34,1
1205,12255,lCVPDaggOlwGJsnAJvi5aMCj1weM2Pue,SpATywNh6bZuzm8s1ceuBUnMUAeoAHHw,6,3,2,0,2,0,1,0,8,1.1428571428571428,1,0.0,0,2,0,2,3,0,0,1,0,4,4,1
1206,12257,Htb70W0lnqw4QeBjeePevzE0xRg4O6vF,A3fsA9Zfv1X2fVEQhTw51lKENdNrEqT3,12,11,10,0,0,1,4,0,26,3.7142857142857144,1,0.0,0,10,0,0,11,1,0,4,0,10,16,1
1207,12258,Htb70W0lnqw4QeBjeePevzE0xRg4O6vF,bWdj2GDclj5ofokWjzoa5jAwMkxCykd6,1,0,0,0,0,0,2,0,2,0.2857142857142857,1,0.0,0,0,0,0,0,0,0,2,0,0,2,1
1208,12270,mccn7oMsSoLGVTk06xkhM1ICp7gdLXuk,SpATywNh6bZuzm8s1ceuBUnMUAeoAHHw,20,35,17,19,6,2,13,1,93,13.285714285714286,4,0.0,12,17,16,6,23,2,3,13,1,51,42,1
1209,12276,lCVPDaggOlwGJsnAJvi5aMCj1weM2Pue,A3fsA9Zfv1X2fVEQhTw51lKENdNrEqT3,4,2,1,0,1,0,1,0,5,0.7142857142857143,1,0.0,0,1,0,1,2,0,0,1,0,2,3,1
1210,12281,lCVPDaggOlwGJsnAJvi5aMCj1weM2Pue,bWdj2GDclj5ofokWjzoa5jAwMkxCykd6,6,6,1,0,1,0,2,0,10,1.4285714285714286,1,0.0,0,1,0,1,6,0,0,2,0,2,8,1
1211,12289,j3c6K94i9dgmcXc2NErAuVxnWFJZj8tT,bWdj2GDclj5ofokWjzoa5jAwMkxCykd6,7,4,3,0,2,0,2,0,11,1.5714285714285714,2,0.0,0,3,0,2,4,0,0,2,0,5,6,1
1212,12299,fa6SZdwIb8QmMO5YcB5PQzrN75peDxq7,G8EPVSXsOYB5YQWZGiz1aVq5Pgr2GrQu,5,3,2,0,1,0,1,0,7,1.0,1,0.0,0,2,0,1,3,0,0,1,0,3,4,1
1213,12301,OeLBIzS0gNQ56euxy5b66gAZMzQCGE7n,bWdj2GDclj5ofokWjzoa5jAwMkxCykd6,1,0,0,0,0,0,1,0,1,0.14285714285714285,1,0.0,0,0,0,0,0,0,0,1,0,0,1,1
1214,12308,CQOn4KWCA0duDCOSP1DQzvXZ3yAfq1zW,SpATywNh6bZuzm8s1ceuBUnMUAeoAHHw,32,58,34,40,12,35,23,1,203,29.0,6,0.0,14,34,34,12,44,35,6,23,1,94,109,0
1215,12317,niLMw8MCObO7SSR2V1jNg9WQt5oSjDFJ,A3fsA9Zfv1X2fVEQhTw51lKENdNrEqT3,14,12,7,0,5,0,4,0,28,4.0,3,0.0,0,7,0,5,12,0,0,4,0,12,16,1
1216,12320,niLMw8MCObO7SSR2V1jNg9WQt5oSjDFJ,SpATywNh6bZuzm8s1ceuBUnMUAeoAHHw,9,14,7,0,3,0,7,0,31,4.428571428571429,4,0.0,2,7,0,3,12,0,0,7,0,12,19,1
1217,12321,g3902agYIRHzac78MKVZlvljLMXXNpQ7,A3fsA9Zfv1X2fVEQhTw51lKENdNrEqT3,25,20,14,0,8,2,23,2,69,9.857142857142858,6,0.0,0,14,0,8,20,2,0,23,2,22,47,1
1218,12323,dceX0m9075YvlWaEabJwd03DyXl3MtL8,SpATywNh6bZuzm8s1ceuBUnMUAeoAHHw,22,45,13,22,3,1,10,3,97,13.857142857142858,3,0.0,22,13,19,3,23,1,3,10,3,57,40,0
1219,12328,lCVPDaggOlwGJsnAJvi5aMCj1weM2Pue,RXDvfPUBYFlVdlueBFbLW0mhhAyGEqpt,7,5,4,0,1,0,1,0,11,1.5714285714285714,1,0.0,0,4,0,1,5,0,0,1,0,5,6,1
1220,12332,ncwdVeNEm9rMUWWKD40nNQFCSGSrd8Qu,SpATywNh6bZuzm8s1ceuBUnMUAeoAHHw,1,0,0,0,0,0,1,0,1,0.14285714285714285,1,0.0,0,0,0,0,0,0,0,1,0,0,1,1
1221,12333,8V1FCzMo3zMKQW1ts44FS8gSim8xyz9W,G8EPVSXsOYB5YQWZGiz1aVq5Pgr2GrQu,4,2,1,0,1,0,1,0,5,0.7142857142857143,1,0.0,0,1,0,1,2,0,0,1,0,2,3,1
1222,12348,ZhTCqX8GMUcn0a0betuEauHNuCk1aRhm,A3fsA9Zfv1X2fVEQhTw51lKENdNrEqT3,61,60,29,118,9,62,19,0,297,42.42857142857143,6,0.0,8,29,104,9,52,62,14,19,0,150,147,0
1223,12351,f5nUM7X4snZl1Dwk9DyOLQ7PstRe3yG1,SpATywNh6bZuzm8s1ceuBUnMUAeoAHHw,17,12,8,21,5,0,11,0,57,8.142857142857142,3,0.0,2,8,17,5,10,0,4,11,0,32,25,1
1224,12371,Dx1ZzKpwFtwNhE9gdaLaohssqGyqrqjD,SpATywNh6bZuzm8s1ceuBUnMUAeoAHHw,31,70,31,26,10,57,22,2,218,31.142857142857142,7,0.0,23,31,20,10,47,57,6,22,2,84,134,0
1225,12384,bKVslXuzEQ1pv4c6iV5mVjs6X6avUbmL,RXDvfPUBYFlVdlueBFbLW0mhhAyGEqpt,52,359,158,61,27,574,293,90,1562,223.14285714285714,11,0.0,13,158,53,27,346,574,8,293,90,251,1311,0
1226,12386,Ak5p1JsyLmT4pGKGNb849PzZbmvFekml,SpATywNh6bZuzm8s1ceuBUnMUAeoAHHw,11,15,4,12,2,0,2,0,35,5.0,1,0.0,10,4,11,2,5,0,1,2,0,27,8,1
1227,12389,DNxlKJNm5ao3DSObllNvFwn0RJUn50Hh,SpATywNh6bZuzm8s1ceuBUnMUAeoAHHw,1,0,0,0,0,0,1,0,1,0.14285714285714285,1,0.0,0,0,0,0,0,0,0,1,0,0,1,1
1228,12402,3z0hX7DEeFfsgBAb2GCqLtG7EloWzN4g,bWdj2GDclj5ofokWjzoa5jAwMkxCykd6,5,4,1,0,0,0,3,0,8,1.1428571428571428,2,0.0,0,1,0,0,4,0,0,3,0,1,7,1
1229,12409,Io5gLr8QOxaBw8nFReloAXOpt3IlZ5WE,SpATywNh6bZuzm8s1ceuBUnMUAeoAHHw,6,6,1,0,0,0,7,0,14,2.0,4,0.0,0,1,0,0,6,0,0,7,0,1,13,0
1230,12415,9xXPu4XrxUEQD4kiDWTsMvTkTFxGkYzI,A3fsA9Zfv1X2fVEQhTw51lKENdNrEqT3,44,34,17,64,11,0,3,0,129,18.428571428571427,3,0.0,3,17,55,11,31,0,9,3,0,86,43,1
1231,12430,w62eko3BoCGIpZmfYYoFjoaBC9TFzjaB,SpATywNh6bZuzm8s1ceuBUnMUAeoAHHw,32,34,18,30,9,33,19,1,144,20.571428571428573,4,0.0,9,18,25,9,25,33,5,19,1,61,83,1
1232,12431,dOkXreE5Co54rqG7YecVg356rhQtEiRH,SpATywNh6bZuzm8s1ceuBUnMUAeoAHHw,14,15,1,21,0,1,8,0,46,6.571428571428571,3,0.0,7,1,17,0,8,1,4,8,0,25,21,1
1233,12440,48vx3qHAZvBzdWBXsxihTari5aBTmUGi,SpATywNh6bZuzm8s1ceuBUnMUAeoAHHw,16,12,6,0,4,2,12,2,38,5.428571428571429,1,0.0,0,6,0,4,12,2,0,12,2,10,28,1
1234,12448,AQaaG4AcAnObnM2M4NcHCUkX6lEg0Mlu,SpATywNh6bZuzm8s1ceuBUnMUAeoAHHw,30,33,16,33,8,6,15,1,112,16.0,2,0.0,12,16,29,8,21,6,4,15,1,65,47,1
1235,12473,Jn3Y3EwJczNHkfzTGUpSSJOFpEETB0cw,A3fsA9Zfv1X2fVEQhTw51lKENdNrEqT3,2,0,0,0,0,0,4,0,4,0.5714285714285714,2,0.0,0,0,0,0,0,0,0,4,0,0,4,1
1236,12484,yEuZmA9AbYZaWqEfxA4FratjPoewKT3C,bWdj2GDclj5ofokWjzoa5jAwMkxCykd6,10,14,7,0,6,4,11,2,44,6.285714285714286,2,0.0,4,7,0,6,10,4,0,11,2,17,27,1
1237,12488,UkVp32qxLqsEWmDdG99xhNvtg1mVGbkd,SpATywNh6bZuzm8s1ceuBUnMUAeoAHHw,17,36,14,20,3,7,10,0,90,12.857142857142858,2,0.0,12,14,16,3,24,7,4,10,0,45,45,1
1238,12513,Jn3Y3EwJczNHkfzTGUpSSJOFpEETB0cw,SpATywNh6bZuzm8s1ceuBUnMUAeoAHHw,13,16,5,0,5,0,5,0,31,4.428571428571429,2,0.0,0,5,0,5,16,0,0,5,0,10,21,1
1239,12517,VfrUmEAx0ZYYX6kUXFzpxLwtafRhi7qR,SpATywNh6bZuzm8s1ceuBUnMUAeoAHHw,5,2,1,0,1,0,2,0,6,0.8571428571428571,1,0.0,0,1,0,1,2,0,0,2,0,2,4,1
1240,12518,4IkxYjTflPhoHxhEdrFyf3T4ZXNMTaKd,SpATywNh6bZuzm8s1ceuBUnMUAeoAHHw,27,46,20,26,7,0,4,0,103,14.714285714285714,3,0.0,10,20,25,7,36,0,1,4,0,62,41,0
1241,12521,jCbueeMsegjPu59bj6eGJyYcDxtIb05e,bWdj2GDclj5ofokWjzoa5jAwMkxCykd6,7,4,1,4,1,0,3,0,13,1.8571428571428572,1,0.0,2,1,3,1,2,0,1,3,0,7,6,1
1242,12536,XKtSJUu70kLs3jRiKFAR2MlWI70CZUcv,G8EPVSXsOYB5YQWZGiz1aVq5Pgr2GrQu,30,60,3,2,5,3,18,2,93,13.285714285714286,3,0.0,8,3,1,5,52,3,1,18,2,17,76,0
1243,12540,nlq4r6xc3rTUqTwcYhL6wudXdN6RIE52,bWdj2GDclj5ofokWjzoa5jAwMkxCykd6,12,8,7,0,7,6,5,0,33,4.714285714285714,3,0.0,0,7,0,7,8,6,0,5,0,14,19,1
1244,12546,LRHDYNgQAsG2UssS8TgaqkiYDbFlVrrj,A3fsA9Zfv1X2fVEQhTw51lKENdNrEqT3,24,40,29,0,14,5,17,2,107,15.285714285714286,4,0.0,1,29,0,14,39,5,0,17,2,44,63,1
1245,12547,IImOhpbuTNHI88DulkMnjvsH7H0HMncx,SpATywNh6bZuzm8s1ceuBUnMUAeoAHHw,4,2,1,0,1,0,1,0,5,0.7142857142857143,1,0.0,0,1,0,1,2,0,0,1,0,2,3,1
1246,12556,InTDVHpDSVoZu5vOSvueBLdJOgZb9Qu8,A3fsA9Zfv1X2fVEQhTw51lKENdNrEqT3,8,5,3,0,1,7,4,0,20,2.857142857142857,1,0.0,0,3,0,1,5,7,0,4,0,4,16,1
1247,12557,Vx74c4EnHqTcmxhMcO6kRvadcvYQC7Hl,SpATywNh6bZuzm8s1ceuBUnMUAeoAHHw,24,52,25,11,8,1,19,0,116,16.571428571428573,8,0.0,6,25,10,8,46,1,1,19,0,49,67,0
1248,12564,D59LfxtLBEXUXJuXCGYTJcy2S1d5nPYE,SpATywNh6bZuzm8s1ceuBUnMUAeoAHHw,19,24,4,13,3,0,6,0,50,7.142857142857143,5,0.0,4,4,12,3,20,0,1,6,0,23,27,0
1249,12566,ph8ToQs4xH6gdMMZGt7KWlSytujO4hy7,bWdj2GDclj5ofokWjzoa5jAwMkxCykd6,15,32,16,14,7,0,9,0,78,11.142857142857142,3,0.0,6,16,13,7,26,0,1,9,0,42,36,0
1250,12590,g8m22R7W0Wo8v9RXY0TMbj5qf5RFgvht,A3fsA9Zfv1X2fVEQhTw51lKENdNrEqT3,9,16,9,0,2,0,12,0,39,5.571428571428571,4,0.0,1,9,0,2,15,0,0,12,0,12,27,1
1251,12592,VwUXTBGJaTv5xN1He6TwE1OKxII3IUB4,A3fsA9Zfv1X2fVEQhTw51lKENdNrEqT3,17,13,9,0,5,2,16,2,47,6.714285714285714,2,0.0,1,9,0,5,12,2,0,16,2,15,32,1
1252,12598,0MgLdwlRWQ7TpUbl7lDTcNpvvpvRxwZk,SpATywNh6bZuzm8s1ceuBUnMUAeoAHHw,12,9,6,2,4,0,3,0,24,3.4285714285714284,2,0.0,1,6,2,4,8,0,0,3,0,13,11,1
1253,12602,8g5cBj0Gjzli28QiIdgpvFAz2836fyoV,A3fsA9Zfv1X2fVEQhTw51lKENdNrEqT3,14,20,13,0,7,1,13,1,55,7.857142857142857,3,0.0,0,13,0,7,20,1,0,13,1,20,35,1
1254,12628,JaYbgvhgx43SysY9J8DaCR3IcdUzCcUf,SpATywNh6bZuzm8s1ceuBUnMUAeoAHHw,16,25,0,6,0,0,7,0,38,5.428571428571429,6,0.0,2,0,6,0,23,0,0,7,0,8,30,0
1255,12643,8DlfU1bgriTJuUO8vI8x268Lnn7yRdfp,bWdj2GDclj5ofokWjzoa5jAwMkxCykd6,5,2,1,0,1,3,4,0,11,1.5714285714285714,2,0.0,0,1,0,1,2,3,0,4,0,2,9,1
1256,12665,2DNSh2UatQFpodq67CmKbjqpA6AJb7Oi,SpATywNh6bZuzm8s1ceuBUnMUAeoAHHw,28,30,14,18,8,0,14,0,84,12.0,4,0.0,11,14,17,8,19,0,1,14,0,50,34,0
1257,12671,UcbTdkZF8IIJuBiyaeVa5dJ5AMKloTWJ,A3fsA9Zfv1X2fVEQhTw51lKENdNrEqT3,1,0,0,0,0,0,1,0,1,0.14285714285714285,1,0.0,0,0,0,0,0,0,0,1,0,0,1,1
1258,12676,NGkJealfvLzyvMkO29aSPohtdMh2i3ow,SpATywNh6bZuzm8s1ceuBUnMUAeoAHHw,18,21,13,6,7,1,2,0,50,7.142857142857143,2,0.0,6,13,6,7,15,1,0,2,0,32,18,1
1259,12678,v8Csqzh937f2Vg9ZqHM3p8LLheZjBof3,SpATywNh6bZuzm8s1ceuBUnMUAeoAHHw,13,15,2,0,1,0,2,0,20,2.857142857142857,1,0.0,3,2,0,1,12,0,0,2,0,6,14,0
1260,12691,nUlI6cjptTLAgli6MFzyKD61AHPa0Ow2,SpATywNh6bZuzm8s1ceuBUnMUAeoAHHw,7,4,3,0,2,0,1,0,10,1.4285714285714286,1,0.0,0,3,0,2,4,0,0,1,0,5,5,1
1261,12694,EelXsFqmLbbOgu7NMVlCz136fL2FTkZO,G8EPVSXsOYB5YQWZGiz1aVq5Pgr2GrQu,17,49,18,0,10,0,6,0,83,11.857142857142858,6,0.0,2,18,0,10,47,0,0,6,0,30,53,1
1262,12702,piMSzq394zCurmILy54TdIfNK5vFDgeH,SpATywNh6bZuzm8s1ceuBUnMUAeoAHHw,8,6,3,0,0,1,7,1,18,2.5714285714285716,1,0.0,0,3,0,0,6,1,0,7,1,3,15,1
1263,12717,pXqbqKhLN9u2vMm4aIB5JwL5PRPhZDCp,A3fsA9Zfv1X2fVEQhTw51lKENdNrEqT3,4,2,0,0,0,0,3,0,5,0.7142857142857143,2,0.0,0,0,0,0,2,0,0,3,0,0,5,0
1264,12725,yXkO3eR7yt6I5YPt7SbP4lJC7f4DWsPi,SpATywNh6bZuzm8s1ceuBUnMUAeoAHHw,18,55,6,23,3,12,9,0,108,15.428571428571429,4,0.0,10,6,19,3,45,12,4,9,0,38,70,0
1265,12741,yFLanYq8p4sf6NFSB1Td9ag6632plY4t,A3fsA9Zfv1X2fVEQhTw51lKENdNrEqT3,27,32,25,0,18,1,13,1,90,12.857142857142858,6,0.0,0,25,0,18,32,1,0,13,1,43,47,0
1266,12743,qWbrTjg87QoJMjqclpcgpkGIkTTfGYPg,SpATywNh6bZuzm8s1ceuBUnMUAeoAHHw,1,0,0,0,0,0,1,0,1,0.14285714285714285,1,0.0,0,0,0,0,0,0,0,1,0,0,1,1
1267,12762,u82lBhpDxJIwlZISEntCxj1zgVFdW0vT,A3fsA9Zfv1X2fVEQhTw51lKENdNrEqT3,1,0,0,0,0,0,3,0,3,0.42857142857142855,2,0.0,0,0,0,0,0,0,0,3,0,0,3,1
1268,12781,xI2qMeJnp6aq2CKhFmXJQYegY0eBgJqh,SpATywNh6bZuzm8s1ceuBUnMUAeoAHHw,16,64,24,4,10,0,8,0,110,15.714285714285714,7,0.0,23,24,4,10,41,0,0,8,0,61,49,0
1269,12786,rZSLmwiYX8trzeLsBLeg8r0IN1GBbqOC,RXDvfPUBYFlVdlueBFbLW0mhhAyGEqpt,1,0,0,0,0,0,1,0,1,0.14285714285714285,1,0.0,0,0,0,0,0,0,0,1,0,0,1,1
1270,12788,rZSLmwiYX8trzeLsBLeg8r0IN1GBbqOC,A3fsA9Zfv1X2fVEQhTw51lKENdNrEqT3,50,20,11,104,3,0,14,0,152,21.714285714285715,3,0.0,3,11,92,3,17,0,12,14,0,109,43,0
1271,12797,0r0opwFyJ4N25MV6ZjVs69MBQP4LTfaz,RXDvfPUBYFlVdlueBFbLW0mhhAyGEqpt,49,50,32,113,14,10,9,4,232,33.142857142857146,3,0.0,14,32,107,14,36,10,6,9,4,167,65,0
1272,12798,SZOXOmDilP1KR3OJXHpIlLf61tEoqX1S,SpATywNh6bZuzm8s1ceuBUnMUAeoAHHw,20,31,0,26,0,10,8,2,77,11.0,2,0.0,16,0,23,0,15,10,3,8,2,39,38,1
1273,12801,N5iDERl36Pe29yDG8gDe9a99dYgqwB7y,bWdj2GDclj5ofokWjzoa5jAwMkxCykd6,16,12,5,60,2,0,8,0,87,12.428571428571429,3,0.0,4,5,51,2,8,0,9,8,0,62,25,1
1274,12802,n2H1RsIyXGWShdCbCzwLRVNV0gBoMcRI,bWdj2GDclj5ofokWjzoa5jAwMkxCykd6,2,0,0,0,0,0,4,0,4,0.5714285714285714,2,0.0,0,0,0,0,0,0,0,4,0,0,4,1
1275,12803,P0uW8e7uWJsgVO5MWg1krlEvXljM181Y,A3fsA9Zfv1X2fVEQhTw51lKENdNrEqT3,2,0,0,0,0,0,2,0,2,0.2857142857142857,1,0.0,0,0,0,0,0,0,0,2,0,0,2,1
1276,12817,n2H1RsIyXGWShdCbCzwLRVNV0gBoMcRI,A3fsA9Zfv1X2fVEQhTw51lKENdNrEqT3,2,0,0,0,0,0,3,0,3,0.42857142857142855,2,0.0,0,0,0,0,0,0,0,3,0,0,3,1
1277,12830,L0KQTTHes3X5LPSdqQrdBMVgea19D6tJ,SpATywNh6bZuzm8s1ceuBUnMUAeoAHHw,26,55,28,14,13,0,8,0,118,16.857142857142858,6,0.0,7,28,14,13,48,0,0,8,0,62,56,1
1278,12838,D1VQybdJv05b8bnQWlTwVLnxuzPr9TGg,SpATywNh6bZuzm8s1ceuBUnMUAeoAHHw,32,53,18,38,7,1,24,2,143,20.428571428571427,6,0.0,17,18,33,7,36,1,5,24,2,75,68,0
1279,12850,cVHCYdG6eoXKQe55dLZbvLgwBGbWam7p,SpATywNh6bZuzm8s1ceuBUnMUAeoAHHw,10,12,0,0,0,1,15,1,29,4.142857142857143,2,0.0,2,0,0,0,10,1,0,15,1,2,27,1
1280,12861,clcszcRJ03jiyZ5GYQyVZZ7N7YqBvRWN,G8EPVSXsOYB5YQWZGiz1aVq5Pgr2GrQu,8,12,9,0,5,1,3,0,30,4.285714285714286,1,0.0,0,9,0,5,12,1,0,3,0,14,16,1
1281,12876,birimXAhV5T8auACU6PoAgdoddyc5gxF,SpATywNh6bZuzm8s1ceuBUnMUAeoAHHw,20,16,8,16,4,6,5,1,56,8.0,1,0.0,6,8,15,4,10,6,1,5,1,33,23,1
1282,12878,nxXaLxK1WzKt8vz8gfQ7mw2jj0DmsYuz,SpATywNh6bZuzm8s1ceuBUnMUAeoAHHw,24,29,0,27,1,1,24,2,84,12.0,7,0.0,8,0,23,1,21,1,4,24,2,32,52,0
1283,12886,jitS86VYMmQkiBJMhbTP5ghyPiIbWGe4,SpATywNh6bZuzm8s1ceuBUnMUAeoAHHw,7,13,1,0,0,4,3,1,22,3.142857142857143,1,0.0,2,1,0,0,11,4,0,3,1,3,19,1
1284,12898,P0uW8e7uWJsgVO5MWg1krlEvXljM181Y,RXDvfPUBYFlVdlueBFbLW0mhhAyGEqpt,2,0,0,0,0,0,2,0,2,0.2857142857142857,1,0.0,0,0,0,0,0,0,0,2,0,0,2,1
1285,12911,qAfzRWdcV29MrGV4Q3OpnDw6sMEqxrsX,SpATywNh6bZuzm8s1ceuBUnMUAeoAHHw,6,4,0,0,0,0,3,0,7,1.0,1,0.0,0,0,0,0,4,0,0,3,0,0,7,1
1286,12919,UaSh8dwx8gnofYbXlmpqj9uYDbpJ89pX,SpATywNh6bZuzm8s1ceuBUnMUAeoAHHw,12,31,3,0,0,195,28,5,262,37.42857142857143,5,0.0,7,3,0,0,24,195,0,28,5,10,252,0
1287,12920,C7qRsA5jr1OEmJhfxUyc4ekgHn4q4XXi,SpATywNh6bZuzm8s1ceuBUnMUAeoAHHw,10,62,15,0,0,3,11,0,91,13.0,5,0.0,1,15,0,0,61,3,0,11,0,16,75,1
1288,12922,uqIn0vdfJ1SDJCOeCVEAQPRFBBKQA2eB,A3fsA9Zfv1X2fVEQhTw51lKENdNrEqT3,69,40,20,110,14,0,19,0,203,29.0,5,0.0,2,20,103,14,38,0,7,19,0,139,64,1
1289,12939,BZIh5Ji4WRsl5XFn0vcayrSAt3EwPPq7,SpATywNh6bZuzm8s1ceuBUnMUAeoAHHw,25,39,1,33,1,1,13,2,90,12.857142857142858,3,0.0,14,1,28,1,25,1,5,13,2,44,46,0
1290,12941,agXxlcmOoEfRNuHGmntEOJrJqSCOihJk,SpATywNh6bZuzm8s1ceuBUnMUAeoAHHw,20,27,0,12,0,1,9,1,50,7.142857142857143,6,0.0,5,0,12,0,22,1,0,9,1,17,33,1
1291,12960,QxcB9RiJu5tiHZOch1DPGex1fIsAotsI,SpATywNh6bZuzm8s1ceuBUnMUAeoAHHw,27,71,5,28,3,38,41,6,192,27.428571428571427,10,0.0,23,5,23,3,48,38,5,41,6,54,138,0
1292,12970,GR6VeteR9GEbfhgsQCuQ7IOGLVIdLf6Q,SpATywNh6bZuzm8s1ceuBUnMUAeoAHHw,10,20,1,2,0,0,4,0,27,3.857142857142857,3,0.0,1,1,2,0,19,0,0,4,0,4,23,0
1293,12973,7fFZLbLMI7Ucj1mdrBxpY9hCEcczhOLF,RXDvfPUBYFlVdlueBFbLW0mhhAyGEqpt,52,57,7,100,2,5,21,2,194,27.714285714285715,6,0.0,15,7,98,2,42,5,2,21,2,122,72,0
1294,12987,d1JMD7qxfNKpLgzBvlpfaUYeKyTI6qbc,RXDvfPUBYFlVdlueBFbLW0mhhAyGEqpt,15,9,6,0,5,1,9,0,30,4.285714285714286,2,0.0,0,6,0,5,9,1,0,9,0,11,19,0
1295,12998,MM2B2653YFHORo361rzambfOSuqgdvxU,SpATywNh6bZuzm8s1ceuBUnMUAeoAHHw,27,33,15,20,6,4,11,0,89,12.714285714285714,6,0.0,12,15,17,6,21,4,3,11,0,50,39,1
1296,13002,qBuOYvjWXxAt6x3Clq0Mm94iVtXMfRzl,A3fsA9Zfv1X2fVEQhTw51lKENdNrEqT3,38,15,12,60,11,2,5,1,106,15.142857142857142,1,0.0,2,12,49,11,13,2,11,5,1,74,32,1
1297,13021,rXHS1nVaWODpE4oMoF8GV1PH34kuNjhN,A3fsA9Zfv1X2fVEQhTw51lKENdNrEqT3,50,34,23,68,13,6,14,0,158,22.571428571428573,3,0.0,3,23,63,13,31,6,5,14,0,102,56,1
1298,13024,gdBVlnD2M7V6ljn8vJvT9NnajpxXqL1v,SpATywNh6bZuzm8s1ceuBUnMUAeoAHHw,28,41,15,18,9,1,11,0,95,13.571428571428571,5,0.0,14,15,15,9,27,1,3,11,0,53,42,1
1299,13026,nE3rPlTTHJqOdfeqGlvnz4cddsiodod7,SpATywNh6bZuzm8s1ceuBUnMUAeoAHHw,4,2,0,0,0,0,2,0,4,0.5714285714285714,1,0.0,0,0,0,0,2,0,0,2,0,0,4,0
1300,13038,Ys5FH0nq7NeLEdwGoDUOp7Sz8iAMAB3d,SpATywNh6bZuzm8s1ceuBUnMUAeoAHHw,18,76,22,5,5,0,10,0,118,16.857142857142858,3,0.0,5,22,4,5,71,0,1,10,0,36,82,1
1301,13049,8nRie7othcdG0O4zmQQo2Wo4gx8ixPWA,SpATywNh6bZuzm8s1ceuBUnMUAeoAHHw,8,3,0,0,0,1,6,1,11,1.5714285714285714,1,0.0,0,0,0,0,3,1,0,6,1,0,11,1
1302,13064,FH8uaUgDtH5I6cjMpNACS7MT4OVRdm6l,SpATywNh6bZuzm8s1ceuBUnMUAeoAHHw,25,29,3,26,1,3,12,1,75,10.714285714285714,4,0.0,8,3,23,1,21,3,3,12,1,35,40,0
1303,13068,Oewk1cgUhxDAPgxI9Y8opSnbFrQ56lFp,G8EPVSXsOYB5YQWZGiz1aVq5Pgr2GrQu,6,4,2,0,1,0,4,0,11,1.5714285714285714,2,0.0,0,2,0,1,4,0,0,4,0,3,8,0
1304,13079,UnqeeEn98S2A9CknpatcyHPMxgZC4vhi,bWdj2GDclj5ofokWjzoa5jAwMkxCykd6,12,17,10,56,0,2,9,0,94,13.428571428571429,2,0.0,4,10,53,0,13,2,3,9,0,67,27,1
1305,13084,iKiK6wMQ7FsUhBHmZmA4WSvuLlgoIAIT,SpATywNh6bZuzm8s1ceuBUnMUAeoAHHw,27,31,15,12,7,1,3,0,69,9.857142857142858,2,0.0,13,15,12,7,18,1,0,3,0,47,22,1
1306,13087,JuiV77lwSiyunloCdIxpEqZLnyAIWuGF,SpATywNh6bZuzm8s1ceuBUnMUAeoAHHw,28,93,18,37,8,58,33,0,247,35.285714285714285,7,0.0,31,18,31,8,62,58,6,33,0,88,159,1
1307,13093,X0UQZEMetzdnutZa926McNof6mCEs6hL,bWdj2GDclj5ofokWjzoa5jAwMkxCykd6,19,13,2,220,4,12,8,1,260,37.142857142857146,3,0.0,3,2,214,4,10,12,6,8,1,223,37,0
1308,13096,WkW7xhOBov4cdi1HI8MIcYy2tcL8JIqM,G8EPVSXsOYB5YQWZGiz1aVq5Pgr2GrQu,5,2,2,0,1,0,5,0,10,1.4285714285714286,2,0.0,0,2,0,1,2,0,0,5,0,3,7,0
1309,13097,jSElHDudYQXAurrUrZvr8PEvqza2483p,SpATywNh6bZuzm8s1ceuBUnMUAeoAHHw,17,37,4,15,3,25,38,5,127,18.142857142857142,5,0.0,6,4,13,3,31,25,2,38,5,26,101,0
1310,13118,VSdgqyGl0eURAhfgbcwFZu4zgDm6da40,A3fsA9Zfv1X2fVEQhTw51lKENdNrEqT3,7,8,0,0,0,0,7,0,15,2.142857142857143,1,0.0,0,0,0,0,8,0,0,7,0,0,15,1
1311,13123,DER7joh3KQKE4dEofQirnM23uWHXKmaD,SpATywNh6bZuzm8s1ceuBUnMUAeoAHHw,2,0,0,0,0,0,2,0,2,0.2857142857142857,1,0.0,0,0,0,0,0,0,0,2,0,0,2,1
1312,13126,zEeuqWNlBTdOCPxX0tLPUzZrt62Jaced,SpATywNh6bZuzm8s1ceuBUnMUAeoAHHw,19,32,2,19,2,0,10,0,65,9.285714285714286,1,0.0,14,2,17,2,18,0,2,10,0,35,30,1
1313,13150,5LHFGZp52JmCecbZlM5IR7cocsBDm2vK,A3fsA9Zfv1X2fVEQhTw51lKENdNrEqT3,1,0,0,0,0,0,2,0,2,0.2857142857142857,1,0.0,0,0,0,0,0,0,0,2,0,0,2,1
1314,13160,i9EYjpibuPRn90FUwaEumbd5PTkZZAqq,SpATywNh6bZuzm8s1ceuBUnMUAeoAHHw,1,0,0,0,0,0,1,0,1,0.14285714285714285,1,0.0,0,0,0,0,0,0,0,1,0,0,1,1
1315,13162,PLNAK5eO2jDldFb2P1VVgW3GLNYSW1XE,A3fsA9Zfv1X2fVEQhTw51lKENdNrEqT3,58,25,1,128,0,20,12,1,187,26.714285714285715,4,0.0,3,1,112,0,22,20,16,12,1,116,71,1
1316,13167,c1zDCPDnvv0eep80ND9h9tNicqqWeY8x,SpATywNh6bZuzm8s1ceuBUnMUAeoAHHw,4,2,1,0,1,0,1,0,5,0.7142857142857143,1,0.0,0,1,0,1,2,0,0,1,0,2,3,1
1317,13169,VD51DafWdYqPb9OUf4DGqW0cSE2mdG9x,RXDvfPUBYFlVdlueBFbLW0mhhAyGEqpt,49,49,30,75,15,14,13,0,196,28.0,5,0.0,12,30,70,15,37,14,5,13,0,127,69,0
1318,13171,Xz4KwNrqILWO256erDoEJKlZ22fLi17K,bWdj2GDclj5ofokWjzoa5jAwMkxCykd6,8,11,0,74,2,0,7,0,94,13.428571428571429,3,0.0,6,0,73,2,5,0,1,7,0,81,13,1
1319,13182,Gur5FuhE9EyV9K1F0qLPk7AenhoY8PBS,A3fsA9Zfv1X2fVEQhTw51lKENdNrEqT3,28,36,12,0,9,0,16,0,73,10.428571428571429,3,0.0,0,12,0,9,36,0,0,16,0,21,52,0
1320,13202,Oyq7ji1m15xuxwPKjm7Gg05YiNCQEcyW,A3fsA9Zfv1X2fVEQhTw51lKENdNrEqT3,4,2,1,0,1,0,1,0,5,0.7142857142857143,1,0.0,0,1,0,1,2,0,0,1,0,2,3,1
1321,13205,t0soD7aQ6w7DGyhmXz7wyAfUbtBWT4NA,SpATywNh6bZuzm8s1ceuBUnMUAeoAHHw,6,7,2,0,1,0,3,1,14,2.0,1,0.0,4,2,0,1,3,0,0,3,1,7,7,1
1322,13213,fvcf8Mss4D9M5Dkk5Dn5T9NiTapwZ9dB,A3fsA9Zfv1X2fVEQhTw51lKENdNrEqT3,34,11,6,80,5,0,8,0,110,15.714285714285714,2,0.0,4,6,65,5,7,0,15,8,0,80,30,1
1323,13215,YKsQbxqCbn9zYlM8hXkeyvve9j97h5Fs,SpATywNh6bZuzm8s1ceuBUnMUAeoAHHw,5,2,1,0,1,0,2,0,6,0.8571428571428571,1,0.0,0,1,0,1,2,0,0,2,0,2,4,1
1324,13231,CGCo1ulRSzYrFke9WXpheptgBfQxf2gK,SpATywNh6bZuzm8s1ceuBUnMUAeoAHHw,19,33,15,11,6,13,20,2,100,14.285714285714286,6,0.0,10,15,10,6,23,13,1,20,2,41,59,0
1325,13243,D3y4ChHgB3o0JcWw3QbeyrPnD6ZSD4me,SpATywNh6bZuzm8s1ceuBUnMUAeoAHHw,4,0,0,0,0,8,4,1,13,1.8571428571428572,1,0.0,0,0,0,0,0,8,0,4,1,0,13,1
1326,13268,eAArxLyCThtu9N3Mv8rQculKbGSa66j9,G8EPVSXsOYB5YQWZGiz1aVq5Pgr2GrQu,111,101,37,297,23,26,23,0,507,72.42857142857143,5,0.0,60,37,214,23,41,26,83,23,0,334,173,0
1327,13270,ffLXxfgMU4yir9uI5fIkKo2iZzEw2Lpz,SpATywNh6bZuzm8s1ceuBUnMUAeoAHHw,21,21,14,0,8,4,11,0,58,8.285714285714286,5,0.0,0,14,0,8,21,4,0,11,0,22,36,1
1328,13278,XwU61hOxlE8cqDut2rPIgRseTsxZ07jG,SpATywNh6bZuzm8s1ceuBUnMUAeoAHHw,24,81,12,40,1,8,9,0,151,21.571428571428573,3,0.0,58,12,36,1,23,8,4,9,0,107,44,0
1329,13284,HmCqvdVQxacevQymd3KKpvfG444InuCU,RXDvfPUBYFlVdlueBFbLW0mhhAyGEqpt,57,68,40,144,0,0,7,0,259,37.0,3,0.0,23,40,140,0,45,0,4,7,0,203,56,0
1330,13294,kI6cheDOBy9s4ZYk6wZ8CKNoQdId12d9,SpATywNh6bZuzm8s1ceuBUnMUAeoAHHw,11,13,6,0,2,2,16,6,45,6.428571428571429,2,0.0,0,6,0,2,13,2,0,16,6,8,37,1
1331,13297,0b8UUNX7vDapSg0uCVOk0glpsbuPbDat,SpATywNh6bZuzm8s1ceuBUnMUAeoAHHw,31,82,31,36,14,73,21,2,259,37.0,10,0.0,36,31,30,14,46,73,6,21,2,111,148,0
1332,13305,QIQR6VwK3cpUKM5lDzadEKeQATM23w8z,RXDvfPUBYFlVdlueBFbLW0mhhAyGEqpt,1,0,0,0,0,0,1,0,1,0.14285714285714285,1,0.0,0,0,0,0,0,0,0,1,0,0,1,1
1333,13309,1dxQmK9WwlHWuIG7ZTn4PsJ2vflQBDH3,A3fsA9Zfv1X2fVEQhTw51lKENdNrEqT3,13,10,2,16,1,0,6,0,35,5.0,3,0.0,0,2,12,1,10,0,4,6,0,15,20,0
1334,13312,9aWGLeAVHncegHPXAP1qMMyzvcIDPZKu,A3fsA9Zfv1X2fVEQhTw51lKENdNrEqT3,42,26,21,164,0,7,17,2,237,33.857142857142854,3,0.0,1,21,132,0,25,7,32,17,2,154,83,1
1335,13318,Xzt2w1aRoJeIAP02oHWxu8IVeFzxqDvF,SpATywNh6bZuzm8s1ceuBUnMUAeoAHHw,30,93,29,49,22,9,17,3,222,31.714285714285715,3,0.0,16,29,40,22,77,9,9,17,3,107,115,0
1336,13324,NuZwpz0U4SxzLHddLsrKCkHdkj5yyqPt,A3fsA9Zfv1X2fVEQhTw51lKENdNrEqT3,40,57,3,60,0,0,8,1,129,18.428571428571427,3,0.0,3,3,54,0,54,0,6,8,1,60,69,1
1337,13327,M3xTB6LenTJvMpybZKparVtRZKzrRM1R,SpATywNh6bZuzm8s1ceuBUnMUAeoAHHw,28,78,32,20,8,108,39,3,288,41.142857142857146,3,0.0,21,32,19,8,57,108,1,39,3,80,208,0
1338,13335,BuvcW1QbEkmICBwJsmVk62irFMyFXFIl,SpATywNh6bZuzm8s1ceuBUnMUAeoAHHw,6,4,2,0,1,0,2,0,9,1.2857142857142858,1,0.0,0,2,0,1,4,0,0,2,0,3,6,0
1339,13350,ooqIS0ldRRRaqJrrOHVscbkigkM4wbN5,SpATywNh6bZuzm8s1ceuBUnMUAeoAHHw,15,17,14,0,10,0,5,0,46,6.571428571428571,3,0.0,0,14,0,10,17,0,0,5,0,24,22,0
1340,13353,Aw7PeIkLW9CDHbPpPSjrFUdtBaUuHUXm,A3fsA9Zfv1X2fVEQhTw51lKENdNrEqT3,66,31,24,128,14,4,41,0,242,34.57142857142857,8,0.0,3,24,106,14,28,4,22,41,0,147,95,0
1341,13357,sFfdfS73lXtMTUaBLpEd17ZzknvXcxlF,G8EPVSXsOYB5YQWZGiz1aVq5Pgr2GrQu,5,3,1,0,1,0,2,0,7,1.0,1,0.0,0,1,0,1,3,0,0,2,0,2,5,1
1342,13389,suNtRVoL26o1uoSjCtTBYoEROkIKHNRV,SpATywNh6bZuzm8s1ceuBUnMUAeoAHHw,21,46,6,10,3,10,7,0,82,11.714285714285714,3,0.0,16,6,10,3,30,10,0,7,0,35,47,0
1343,13392,Zp81uMflvqqrfEwxhUzFhFbNFp63e2qq,SpATywNh6bZuzm8s1ceuBUnMUAeoAHHw,25,91,3,33,1,6,17,1,152,21.714285714285715,4,0.0,26,3,30,1,65,6,3,17,1,60,92,0
1344,13395,eq0kQUYo3qpAoZ9JUGvTejR7TbE9dl0n,A3fsA9Zfv1X2fVEQhTw51lKENdNrEqT3,1,0,0,0,0,0,2,0,2,0.2857142857142857,1,0.0,0,0,0,0,0,0,0,2,0,0,2,1
1345,13417,P6cCvRjvbpDjgLjSjFoCoaUi3J3jrMaV,bWdj2GDclj5ofokWjzoa5jAwMkxCykd6,15,37,1,78,4,2,20,1,143,20.428571428571427,3,0.0,13,1,74,4,24,2,4,20,1,92,51,1
1346,13419,zFUDj5TvEjIvvTLimj5EmmmOcToptA99,bWdj2GDclj5ofokWjzoa5jAwMkxCykd6,5,2,1,0,1,0,2,0,6,0.8571428571428571,1,0.0,0,1,0,1,2,0,0,2,0,2,4,1
1347,13426,PfZH4Yubwsve9DvShzAvHjayDN16nhpN,RXDvfPUBYFlVdlueBFbLW0mhhAyGEqpt,2,0,0,0,0,0,2,0,2,0.2857142857142857,1,0.0,0,0,0,0,0,0,0,2,0,0,2,1
1348,13434,xzjKh0on5UQxslbqX3WgWTiQPFL3pvFu,A3fsA9Zfv1X2fVEQhTw51lKENdNrEqT3,9,7,5,0,3,0,3,0,18,2.5714285714285716,2,0.0,0,5,0,3,7,0,0,3,0,8,10,1
1349,13436,0wXXwNeE6W7NBvQ3k3OMvVCCQezsKKgg,SpATywNh6bZuzm8s1ceuBUnMUAeoAHHw,24,43,19,22,14,0,3,0,101,14.428571428571429,2,0.0,6,19,19,14,37,0,3,3,0,58,43,1
1350,13442,Q459I6WtHQ4LYscZN5C0n5NrNaEwzARk,A3fsA9Zfv1X2fVEQhTw51lKENdNrEqT3,1,0,0,0,0,0,1,0,1,0.14285714285714285,1,0.0,0,0,0,0,0,0,0,1,0,0,1,0
1351,13466,G9zssYsMiy0OM7PcLiakkEdvgznZi21h,bWdj2GDclj5ofokWjzoa5jAwMkxCykd6,10,7,4,22,2,0,2,0,37,5.285714285714286,2,0.0,1,4,18,2,6,0,4,2,0,25,12,1
1352,13468,LSqC7qdkRAhbSsajNxT5pt4NlUyn2gsl,SpATywNh6bZuzm8s1ceuBUnMUAeoAHHw,6,5,4,0,4,0,1,0,14,2.0,1,0.0,0,4,0,4,5,0,0,1,0,8,6,1
1353,13488,3szdu9Q6Oikq1zf8fBs2hQUGk7dqskOy,SpATywNh6bZuzm8s1ceuBUnMUAeoAHHw,13,11,2,14,2,0,4,0,33,4.714285714285714,1,0.0,3,2,13,2,8,0,1,4,0,20,13,1
1354,13502,Zdseq1rQmkAi5wZl57d3RwjzOxlL3B5I,A3fsA9Zfv1X2fVEQhTw51lKENdNrEqT3,47,54,36,62,14,18,41,6,231,33.0,7,0.0,4,36,51,14,50,18,11,41,6,105,126,0
1355,13503,2YfvPW4RjjB1wuYNlMfzfMUdSCE4Rwzu,SpATywNh6bZuzm8s1ceuBUnMUAeoAHHw,13,17,0,17,0,24,12,3,73,10.428571428571429,3,0.0,3,0,14,0,14,24,3,12,3,17,56,0
1356,13513,OsjipUObm67JsyJjOy7xHoa32L8CSYg5,RXDvfPUBYFlVdlueBFbLW0mhhAyGEqpt,7,5,1,0,1,0,2,0,9,1.2857142857142858,1,0.0,0,1,0,1,5,0,0,2,0,2,7,0
1357,13514,XDXCn0FDh32qCzKi52Qo5wbWma8m1QWg,SpATywNh6bZuzm8s1ceuBUnMUAeoAHHw,2,0,0,0,0,0,2,0,2,0.2857142857142857,1,0.0,0,0,0,0,0,0,0,2,0,0,2,1
1358,13529,Ge8ZKyoh7v3U8XFFvvntz8tE5dDD1txz,SpATywNh6bZuzm8s1ceuBUnMUAeoAHHw,17,36,14,15,5,11,24,4,109,15.571428571428571,3,0.0,14,14,12,5,22,11,3,24,4,45,64,1
1359,13538,LjMEB9aIUIvEfq4JTf4C9ef9fHbbyj0M,SpATywNh6bZuzm8s1ceuBUnMUAeoAHHw,31,63,22,42,13,17,14,1,172,24.571428571428573,6,0.0,32,22,36,13,31,17,6,14,1,103,69,0
1360,13539,UCcQjKn5wSzQ8Z7Gu1uECZPrSwuRD4I9,SpATywNh6bZuzm8s1ceuBUnMUAeoAHHw,4,3,1,0,1,0,3,0,8,1.1428571428571428,1,0.0,0,1,0,1,3,0,0,3,0,2,6,1
1361,13541,dQ6ARJIxCHLlztvK37NHQ0C1ttipx0zg,SpATywNh6bZuzm8s1ceuBUnMUAeoAHHw,16,22,10,13,4,4,5,0,58,8.285714285714286,4,0.0,8,10,12,4,14,4,1,5,0,34,24,0
1362,13561,i6CSuJ6asUrdPRp5edOkSDBKGwbyCy2y,bWdj2GDclj5ofokWjzoa5jAwMkxCykd6,3,0,0,0,0,1,4,0,5,0.7142857142857143,1,0.0,0,0,0,0,0,1,0,4,0,0,5,1
1363,13562,Du4OhdznDw29gaWDeHXBUWRKyEVAbHaQ,SpATywNh6bZuzm8s1ceuBUnMUAeoAHHw,31,56,27,31,9,1,28,1,153,21.857142857142858,7,0.0,18,27,22,9,38,1,9,28,1,76,77,0
1364,13568,r0yAsNzYkqEPYi6zNhQfzuueDjmcyFRr,G8EPVSXsOYB5YQWZGiz1aVq5Pgr2GrQu,85,80,52,142,19,0,14,1,308,44.0,2,0.0,25,52,115,19,55,0,27,14,1,211,97,1
1365,13571,QFQlbn421RXpUzVVaKhkxpBlvQfTJy18,SpATywNh6bZuzm8s1ceuBUnMUAeoAHHw,29,48,23,40,9,0,10,0,130,18.571428571428573,4,0.0,19,23,34,9,29,0,6,10,0,85,45,0
1366,13574,BOWTvQlkFu3OONGPj2orMpzJbZOzBXuG,SpATywNh6bZuzm8s1ceuBUnMUAeoAHHw,25,43,2,26,0,50,29,4,154,22.0,6,0.0,11,2,23,0,32,50,3,29,4,36,118,0
1367,13577,r9n2Z7iYkL5tKegLJwMIOxTHQqxopYp0,SpATywNh6bZuzm8s1ceuBUnMUAeoAHHw,19,29,20,8,9,0,9,0,75,10.714285714285714,9,0.0,0,20,6,9,29,0,2,9,0,35,40,1
1368,13591,thD3JQHh1xpY9SdL9w6TAUhWjJrPsSHi,SpATywNh6bZuzm8s1ceuBUnMUAeoAHHw,18,42,15,21,6,7,13,1,105,15.0,2,0.0,19,15,18,6,23,7,3,13,1,58,47,0
1369,13596,SuKlsA6xoxq9JGrANP30LMW7qjrc07fy,bWdj2GDclj5ofokWjzoa5jAwMkxCykd6,23,33,21,82,5,0,14,0,155,22.142857142857142,3,0.0,7,21,75,5,26,0,7,14,0,108,47,1
1370,13603,2YfvPW4RjjB1wuYNlMfzfMUdSCE4Rwzu,RXDvfPUBYFlVdlueBFbLW0mhhAyGEqpt,5,7,0,0,0,6,3,0,16,2.2857142857142856,1,0.0,0,0,0,0,7,6,0,3,0,0,16,0
1371,13611,taXwAmoyCNDGaXo8nVRGsDZwnk4if3bF,SpATywNh6bZuzm8s1ceuBUnMUAeoAHHw,24,78,20,14,6,2,16,1,137,19.571428571428573,6,0.0,23,20,13,6,55,2,1,16,1,62,75,0
1372,13615,SFczaSY6Hc3uft6fwzUwvxTQx8AOyArS,G8EPVSXsOYB5YQWZGiz1aVq5Pgr2GrQu,14,46,1,18,8,5,7,1,86,12.285714285714286,1,0.0,30,1,13,8,16,5,5,7,1,52,34,1
1373,13617,q1nSg7gMR4fmcENPvRW7b84TFAk5YaYv,SpATywNh6bZuzm8s1ceuBUnMUAeoAHHw,25,70,1,27,1,17,21,2,139,19.857142857142858,4,0.0,20,1,23,1,50,17,4,21,2,45,94,1
1374,13619,q1nSg7gMR4fmcENPvRW7b84TFAk5YaYv,bWdj2GDclj5ofokWjzoa5jAwMkxCykd6,1,0,0,0,0,0,1,0,1,0.14285714285714285,1,0.0,0,0,0,0,0,0,0,1,0,0,1,1
1375,13625,Df1QcOycdzVWQv3hsgRFSNdSZglUPcB7,SpATywNh6bZuzm8s1ceuBUnMUAeoAHHw,1,0,0,0,0,0,2,0,2,0.2857142857142857,1,0.0,0,0,0,0,0,0,0,2,0,0,2,1
1376,13627,Df1QcOycdzVWQv3hsgRFSNdSZglUPcB7,G8EPVSXsOYB5YQWZGiz1aVq5Pgr2GrQu,1,0,0,0,0,0,1,0,1,0.14285714285714285,1,0.0,0,0,0,0,0,0,0,1,0,0,1,1
1377,13635,ePpfrPKFmuYE4CHcpunEZ73b0FxyOz0q,A3fsA9Zfv1X2fVEQhTw51lKENdNrEqT3,70,38,22,106,14,6,32,1,219,31.285714285714285,6,0.0,3,22,93,14,35,6,13,32,1,132,87,1
1378,13639,6ZFGnTjh94PbXkR7sbTLWokikXbcLQlV,A3fsA9Zfv1X2fVEQhTw51lKENdNrEqT3,12,10,4,8,0,0,12,0,34,4.857142857142857,2,0.0,1,4,8,0,9,0,0,12,0,13,21,0
1379,13643,kF8fYPSPVuf77u2d6KdtH12htaNTxyrR,SpATywNh6bZuzm8s1ceuBUnMUAeoAHHw,5,7,1,0,1,0,2,0,11,1.5714285714285714,2,0.0,0,1,0,1,7,0,0,2,0,2,9,1
1380,13645,FOoOtP9CvNldG35bvwpepCilGCCL9n8O,SpATywNh6bZuzm8s1ceuBUnMUAeoAHHw,24,43,26,15,15,0,16,0,115,16.428571428571427,4,0.0,3,26,13,15,40,0,2,16,0,57,58,1
1381,13646,2gMbFqhNbghdA4J5huVDcJIix3xmMqms,SpATywNh6bZuzm8s1ceuBUnMUAeoAHHw,29,54,14,33,7,20,18,1,147,21.0,6,0.0,17,14,28,7,37,20,5,18,1,66,81,1
1382,13655,5LtufKrJgtzGXPllU5SjGTHr8eJRp7wi,SpATywNh6bZuzm8s1ceuBUnMUAeoAHHw,9,4,3,0,3,0,2,0,12,1.7142857142857142,1,0.0,0,3,0,3,4,0,0,2,0,6,6,1
1383,13658,BRb6GOIqcgYg1e6c431h8FubF4jTJim3,SpATywNh6bZuzm8s1ceuBUnMUAeoAHHw,28,55,5,22,3,3,22,4,114,16.285714285714285,5,0.0,11,5,18,3,44,3,4,22,4,37,77,1
1384,13663,oNStIislotbuK2XCCskaFe8CInb3EbrY,bWdj2GDclj5ofokWjzoa5jAwMkxCykd6,3,3,0,0,0,0,1,0,4,0.5714285714285714,1,0.0,1,0,0,0,2,0,0,1,0,1,3,1
1385,13666,Y0LHIPeN84CX2pJB37p6sblq4PhQo9k4,SpATywNh6bZuzm8s1ceuBUnMUAeoAHHw,22,27,4,30,3,1,7,0,72,10.285714285714286,4,0.0,7,4,29,3,20,1,1,7,0,43,29,1
1386,13668,ZFgJH3XPKn6EjDuXV9VLOpKftzENCqEZ,G8EPVSXsOYB5YQWZGiz1aVq5Pgr2GrQu,33,54,32,36,10,15,16,1,164,23.428571428571427,6,0.0,8,32,29,10,46,15,7,16,1,79,85,0
1387,13677,ZFgJH3XPKn6EjDuXV9VLOpKftzENCqEZ,RXDvfPUBYFlVdlueBFbLW0mhhAyGEqpt,33,54,35,27,9,21,15,0,161,23.0,4,0.0,7,35,27,9,47,21,0,15,0,78,83,0
1388,13688,1TRHxgoibI9N1jVfz15wdiz3VF8KLiZV,G8EPVSXsOYB5YQWZGiz1aVq5Pgr2GrQu,8,5,4,0,4,0,2,0,15,2.142857142857143,1,0.0,0,4,0,4,5,0,0,2,0,8,7,1
1389,13690,XkKS323fFxBVezQ5JyIgzxHDxEKEwwEf,bWdj2GDclj5ofokWjzoa5jAwMkxCykd6,10,12,4,14,3,0,2,0,35,5.0,1,0.0,4,4,14,3,8,0,0,2,0,25,10,1
1390,13692,dB9soxJVmgwXZSiR7r7fYfCigeYZx4rK,SpATywNh6bZuzm8s1ceuBUnMUAeoAHHw,8,6,4,0,3,1,3,0,17,2.4285714285714284,2,0.0,0,4,0,3,6,1,0,3,0,7,10,1
1391,13695,eosk3dY7502Pbg6Dsnx0qWKWUpRTliXK,SpATywNh6bZuzm8s1ceuBUnMUAeoAHHw,14,23,4,12,2,0,4,0,45,6.428571428571429,3,0.0,5,4,9,2,18,0,3,4,0,20,25,1
1392,13722,MFpshextOJLHhySF4C6u9eWxWZPDeRiA,SpATywNh6bZuzm8s1ceuBUnMUAeoAHHw,5,3,1,0,1,0,5,0,10,1.4285714285714286,3,0.0,1,1,0,1,2,0,0,5,0,3,7,1
1393,13725,r0yAsNzYkqEPYi6zNhQfzuueDjmcyFRr,A3fsA9Zfv1X2fVEQhTw51lKENdNrEqT3,2,0,0,0,0,0,3,0,3,0.42857142857142855,1,0.0,0,0,0,0,0,0,0,3,0,0,3,1
1394,13746,QNA44zjiZdozxT5YpeINlRZRlMKPMkhp,A3fsA9Zfv1X2fVEQhTw51lKENdNrEqT3,21,20,17,0,17,0,1,0,55,7.857142857142857,2,0.0,0,17,0,17,20,0,0,1,0,34,21,1
1395,13752,GUhU3sa7QMussHGi4kspdulqSqF9Ft42,SpATywNh6bZuzm8s1ceuBUnMUAeoAHHw,25,67,4,33,3,35,20,1,163,23.285714285714285,8,0.0,22,4,27,3,45,35,6,20,1,56,107,0
1396,13756,zx92A3etlZOmjWi19IMDYlwaWCkvF08z,SpATywNh6bZuzm8s1ceuBUnMUAeoAHHw,6,18,2,0,2,0,3,0,25,3.5714285714285716,3,0.0,2,2,0,2,16,0,0,3,0,6,19,1
1397,13765,rtYqtRTnqUXb6diSp0MKjdA0eLt2BJ3X,A3fsA9Zfv1X2fVEQhTw51lKENdNrEqT3,1,0,0,0,0,0,4,0,4,0.5714285714285714,3,0.0,0,0,0,0,0,0,0,4,0,0,4,1
1398,13770,73akjB4xSPosxH1enrEsMGxNVgbw9q8A,SpATywNh6bZuzm8s1ceuBUnMUAeoAHHw,20,48,20,6,13,2,5,0,94,13.428571428571429,4,0.0,0,20,5,13,48,2,1,5,0,38,56,1
1399,13771,I1KwJ6EdCZnEPLfC8Q7yWpIkLOHn7h02,A3fsA9Zfv1X2fVEQhTw51lKENdNrEqT3,63,65,40,128,21,0,23,1,278,39.714285714285715,7,0.0,4,40,103,21,61,0,25,23,1,168,110,1
1400,13776,PUFh3BsQaDVIJMDvwsFTqkrgAzvjO9ME,A3fsA9Zfv1X2fVEQhTw51lKENdNrEqT3,22,34,23,0,9,7,17,1,91,13.0,4,0.0,1,23,0,9,33,7,0,17,1,33,58,0
1401,13783,LnPF2pHnhCMvVEpluujjfPcHsgc8Fmmk,bWdj2GDclj5ofokWjzoa5jAwMkxCykd6,1,0,0,0,0,0,1,0,1,0.14285714285714285,1,0.0,0,0,0,0,0,0,0,1,0,0,1,1
1402,13793,1Uc6kG05PFkTNzxuWvIFBwjY8EtNBPxQ,A3fsA9Zfv1X2fVEQhTw51lKENdNrEqT3,2,0,0,0,0,0,5,0,5,0.7142857142857143,2,0.0,0,0,0,0,0,0,0,5,0,0,5,1
1403,14546,82UlWF6Fm1gkNum7nNbVw0yOV1BUdNoS,7GRhBDsirIGkRZBtSMEzNTyDr2JQm4xx,32,83,28,52,16,30,9,0,218,31.142857142857142,6,0.0,46,28,43,16,37,30,9,9,0,133,85,1
1404,14552,gmqCuQTX0aljJXYwlMbQKWVNQXzJBU7z,7GRhBDsirIGkRZBtSMEzNTyDr2JQm4xx,13,13,9,0,4,20,23,2,71,10.142857142857142,5,0.0,0,9,0,4,13,20,0,23,2,13,58,0
1405,14609,Q9kdHcV1kbonm0KnIW9OSERwU5lfVZ8s,7GRhBDsirIGkRZBtSMEzNTyDr2JQm4xx,64,199,41,77,34,24,16,2,393,56.142857142857146,7,0.0,94,41,62,34,105,24,15,16,2,231,162,1
1406,14627,wXa3VpbKMQY5nmCqd1pDfzVK4mBWfzPA,7GRhBDsirIGkRZBtSMEzNTyDr2JQm4xx,5,3,1,0,0,6,5,1,16,2.2857142857142856,1,0.0,0,1,0,0,3,6,0,5,1,1,15,1
1407,14654,StcQZMEDAMldF4GFQUzkrPFNVNZnPaeq,7GRhBDsirIGkRZBtSMEzNTyDr2JQm4xx,49,144,44,66,35,42,25,7,363,51.857142857142854,5,0.0,94,44,50,35,50,42,16,25,7,223,140,0
1408,14715,WuM67GwQW9M3d1mnuGHuvAdo907S9qb5,7GRhBDsirIGkRZBtSMEzNTyDr2JQm4xx,1,0,0,0,0,0,1,0,1,0.14285714285714285,1,0.0,0,0,0,0,0,0,0,1,0,0,1,1
1409,14729,vfwAUxRdOnC4hT5Ba9e9XvBRXfww6oyg,7GRhBDsirIGkRZBtSMEzNTyDr2JQm4xx,12,7,5,0,2,0,8,1,23,3.2857142857142856,2,0.0,0,5,0,2,7,0,0,8,1,7,16,1
1410,14738,QqvzSns2WWHJJpRBF1DJin1UI4cHoJM0,7GRhBDsirIGkRZBtSMEzNTyDr2JQm4xx,53,95,24,78,27,3,14,1,242,34.57142857142857,3,0.0,51,24,69,27,44,3,9,14,1,171,71,1
1411,14744,fznl9GLBUcCuiLFhCkHOSxn8Xeb6YOkl,7GRhBDsirIGkRZBtSMEzNTyDr2JQm4xx,45,77,36,76,40,67,13,0,309,44.142857142857146,4,0.0,41,36,62,40,36,67,14,13,0,179,130,1
1412,14778,SxA4qsG4oQiVsK58JS1BnBCuBa1rQRmi,7GRhBDsirIGkRZBtSMEzNTyDr2JQm4xx,36,44,18,62,12,4,4,0,144,20.571428571428573,3,0.0,20,18,52,12,24,4,10,4,0,102,42,1
1413,14816,NJcCHbOJUQpAuhbw958dR9qCvbh6GNk7,7GRhBDsirIGkRZBtSMEzNTyDr2JQm4xx,43,82,27,53,28,0,12,0,202,28.857142857142858,2,0.0,42,27,49,28,40,0,4,12,0,146,56,1
1414,14827,qxbESUsL0xgJYJDfjiKdrZA2VpHvSkr3,7GRhBDsirIGkRZBtSMEzNTyDr2JQm4xx,35,51,18,47,19,1,4,0,140,20.0,3,0.0,29,18,41,19,22,1,6,4,0,107,33,1
1415,14847,1CUoIZB9t7SxaldyOLjOrt0HiuV3YmmT,7GRhBDsirIGkRZBtSMEzNTyDr2JQm4xx,12,25,10,0,5,0,9,0,49,7.0,3,0.0,3,10,0,5,22,0,0,9,0,18,31,0
1416,14900,iG30XkTMNSFjufmkcMfMeTLCQkIO89rL,7GRhBDsirIGkRZBtSMEzNTyDr2JQm4xx,2,0,0,0,0,0,3,0,3,0.42857142857142855,1,0.0,0,0,0,0,0,0,0,3,0,0,3,1
1417,14920,tLb8Xi221e5NaJvytwcAD3V04AqBaAZQ,7GRhBDsirIGkRZBtSMEzNTyDr2JQm4xx,25,31,11,18,12,0,6,0,78,11.142857142857142,1,0.0,16,11,17,12,15,0,1,6,0,56,22,1
1418,15048,YUqXNrT8XQT6xSTrWrerz6EWyspe1b7c,7GRhBDsirIGkRZBtSMEzNTyDr2JQm4xx,63,147,37,149,29,10,9,0,381,54.42857142857143,4,0.0,91,37,132,29,56,10,17,9,0,289,92,0
1419,15051,KXPsJNzb3MNK5rxQc94IXJdmXF0ziWwA,7GRhBDsirIGkRZBtSMEzNTyDr2JQm4xx,1,0,0,0,0,0,1,0,1,0.14285714285714285,1,0.0,0,0,0,0,0,0,0,1,0,0,1,1
1420,15066,6vCR5MIMPnf9UWKZznVOJS5OTo4Gr7Hd,7GRhBDsirIGkRZBtSMEzNTyDr2JQm4xx,56,149,31,75,24,25,10,0,314,44.857142857142854,3,0.0,70,31,68,24,79,25,7,10,0,193,121,1
1421,15082,0ogceMBqbMfusFqG89X9sBzEnUGema9q,7GRhBDsirIGkRZBtSMEzNTyDr2JQm4xx,10,7,5,0,5,0,3,0,20,2.857142857142857,2,0.0,0,5,0,5,7,0,0,3,0,10,10,1
1422,15083,AsBtR21xGFKZ6c2LKvPTdlawgiUBcaPL,7GRhBDsirIGkRZBtSMEzNTyDr2JQm4xx,55,105,47,84,41,11,20,1,309,44.142857142857146,4,0.0,47,47,67,41,58,11,17,20,1,202,107,0
1423,15187,q36eiA77bwwsXGg05ifhgnTFDpR9Ar4V,7GRhBDsirIGkRZBtSMEzNTyDr2JQm4xx,66,168,49,139,39,7,12,0,414,59.142857142857146,2,0.0,99,49,120,39,69,7,19,12,0,307,107,0
1424,15202,ePpfrPKFmuYE4CHcpunEZ73b0FxyOz0q,7GRhBDsirIGkRZBtSMEzNTyDr2JQm4xx,57,72,26,160,19,1,8,0,286,40.857142857142854,4,0.0,36,26,138,19,36,1,22,8,0,219,67,1
1425,15240,9PiJFDewOyLmHT48JZWbbQ236haTndT7,7GRhBDsirIGkRZBtSMEzNTyDr2JQm4xx,54,174,49,68,37,13,35,3,379,54.142857142857146,8,0.0,82,49,64,37,92,13,4,35,3,232,147,1
1426,15242,CYwEz0VhssUEnyi7GLISc2cCNlhTg5eu,7GRhBDsirIGkRZBtSMEzNTyDr2JQm4xx,52,97,2,109,12,2,13,0,235,33.57142857142857,6,0.0,60,2,96,12,37,2,13,13,0,170,65,1
1427,15273,zx92A3etlZOmjWi19IMDYlwaWCkvF08z,7GRhBDsirIGkRZBtSMEzNTyDr2JQm4xx,27,81,0,43,8,17,1,0,150,21.428571428571427,1,0.0,37,0,41,8,44,17,2,1,0,86,64,1
1428,15296,S0OJjF6aof0iTnIX6lUAxekoH3m4w7V0,7GRhBDsirIGkRZBtSMEzNTyDr2JQm4xx,66,217,76,163,28,134,23,0,641,91.57142857142857,8,0.0,121,76,136,28,96,134,27,23,0,361,280,0
1429,15339,C6xrhZPOmVH2gCVNP26gSSPka2CcwgB5,7GRhBDsirIGkRZBtSMEzNTyDr2JQm4xx,42,52,20,42,21,3,12,1,151,21.571428571428573,4,0.0,31,20,39,21,21,3,3,12,1,111,40,1
1430,15361,CrwYq2YvOe70PhTOuriN4QumcrUjBJDI,7GRhBDsirIGkRZBtSMEzNTyDr2JQm4xx,56,181,43,96,20,14,16,0,370,52.857142857142854,4,0.0,118,43,87,20,63,14,9,16,0,268,102,0
1431,15365,sDcc9eMBMovhbCv3mcSbRYupViyMpSXg,7GRhBDsirIGkRZBtSMEzNTyDr2JQm4xx,1,0,0,0,0,0,2,0,2,0.2857142857142857,1,0.0,0,0,0,0,0,0,0,2,0,0,2,1
1432,15367,nnTxxp3z9fcrPPkS4kzYDi6mu4P5bdue,7GRhBDsirIGkRZBtSMEzNTyDr2JQm4xx,66,107,38,150,28,16,22,0,361,51.57142857142857,9,0.0,57,38,129,28,50,16,21,22,0,252,109,0
1433,15401,9iGaqBGS5kkoXjLd87hUL2eIJMVUVKfU,7GRhBDsirIGkRZBtSMEzNTyDr2JQm4xx,4,4,1,0,0,0,4,0,9,1.2857142857142858,2,0.0,0,1,0,0,4,0,0,4,0,1,8,0
1434,15436,OURivxGQBNOdhRVXNUy5pKGguC3x3JGV,7GRhBDsirIGkRZBtSMEzNTyDr2JQm4xx,22,49,13,20,15,1,11,0,109,15.571428571428571,2,0.0,17,13,17,15,32,1,3,11,0,62,47,0
1435,15491,iKE2AmvagEBVkqWumD0qyaUU8HShKvRo,7GRhBDsirIGkRZBtSMEzNTyDr2JQm4xx,1,0,0,0,0,0,1,0,1,0.14285714285714285,1,0.0,0,0,0,0,0,0,0,1,0,0,1,0
1436,15563,VVltscgfR96aweHb5nQdD1Q7dsOwuOJz,7GRhBDsirIGkRZBtSMEzNTyDr2JQm4xx,28,36,2,39,6,2,2,0,87,12.428571428571429,2,0.0,17,2,36,6,19,2,3,2,0,61,26,0
1437,15641,xY5IUgrYconprXri0F5cssyTAsVeuYqD,7GRhBDsirIGkRZBtSMEzNTyDr2JQm4xx,7,18,6,0,0,0,3,0,27,3.857142857142857,2,0.0,8,6,0,0,10,0,0,3,0,14,13,1
1438,15694,ls88dNG7SGcb3wsgc3lZQCJwuuAQTKkF,7GRhBDsirIGkRZBtSMEzNTyDr2JQm4xx,8,14,1,0,2,0,5,0,22,3.142857142857143,3,0.0,2,1,0,2,12,0,0,5,0,5,17,1
1439,15700,p8pFuUg19xWGOlJygMvSlQjonA3l7FUn,7GRhBDsirIGkRZBtSMEzNTyDr2JQm4xx,4,2,1,0,1,0,3,0,7,1.0,2,0.0,0,1,0,1,2,0,0,3,0,2,5,1
1440,15713,UQMPqDnQtELOyig8xWMMs5ktcYwtyCzh,7GRhBDsirIGkRZBtSMEzNTyDr2JQm4xx,17,16,8,0,8,1,6,0,39,5.571428571428571,3,0.0,0,8,0,8,16,1,0,6,0,16,23,0
1441,15716,W2ohBuN5JfRDGloM0s99vkGQJHKKrtyK,7GRhBDsirIGkRZBtSMEzNTyDr2JQm4xx,21,37,17,8,11,1,4,0,78,11.142857142857142,5,0.0,15,17,6,11,22,1,2,4,0,49,29,1
1442,15771,HbdIEiZ1jslj2pBp8czn7lhBbxLYjtpj,7GRhBDsirIGkRZBtSMEzNTyDr2JQm4xx,55,51,12,76,10,0,5,0,154,22.0,3,0.0,29,12,76,10,22,0,0,5,0,127,27,0
1443,15810,WJLMraoon9e2y7OtDk9UrQjU4oqkoa0t,7GRhBDsirIGkRZBtSMEzNTyDr2JQm4xx,39,70,42,43,39,17,14,5,230,32.857142857142854,5,0.0,16,42,37,39,54,17,6,14,5,134,96,0
1444,15814,g7u6ac7DR9jMW4aOouB4W8Gur81b4cDe,7GRhBDsirIGkRZBtSMEzNTyDr2JQm4xx,52,66,24,63,24,0,17,2,196,28.0,4,0.0,39,24,49,24,27,0,14,17,2,136,60,0
1445,15876,rrw2WJkAL0R5jcfwKMTsm56jlh9a5ial,7GRhBDsirIGkRZBtSMEzNTyDr2JQm4xx,34,73,1,55,5,9,19,0,162,23.142857142857142,5,0.0,22,1,48,5,51,9,7,19,0,76,86,1
1446,15878,468cxTIslgaJVBCubZgOneiS2rtqRqqz,7GRhBDsirIGkRZBtSMEzNTyDr2JQm4xx,7,7,1,0,1,0,1,0,10,1.4285714285714286,1,0.0,0,1,0,1,7,0,0,1,0,2,8,1
1447,15881,W8K4VS8rPvnPTNUJrqgtS2FKH93KmR91,7GRhBDsirIGkRZBtSMEzNTyDr2JQm4xx,58,155,48,73,28,3,14,0,321,45.857142857142854,6,0.0,52,48,69,28,103,3,4,14,0,197,124,1
1448,15900,MvkVXPKImqjQobZ7zCJXq4GfQ4IthLq9,7GRhBDsirIGkRZBtSMEzNTyDr2JQm4xx,60,97,25,71,20,22,15,0,250,35.714285714285715,9,0.0,38,25,69,20,59,22,2,15,0,152,98,0
1449,15906,3c8IXjLzAuM9vKLwVwPhkOijPLPnFRJ2,7GRhBDsirIGkRZBtSMEzNTyDr2JQm4xx,1,0,0,0,0,0,1,0,1,0.14285714285714285,1,0.0,0,0,0,0,0,0,0,1,0,0,1,1
1450,15912,hJo1MgKiPZFXuH2ko6hqPTd9dbjMQKDO,7GRhBDsirIGkRZBtSMEzNTyDr2JQm4xx,6,9,5,0,1,0,3,0,18,2.5714285714285716,3,0.0,0,5,0,1,9,0,0,3,0,6,12,1
1451,15919,oho8eUx0qt2QgQUM9H4Puo64w9V5nVUl,7GRhBDsirIGkRZBtSMEzNTyDr2JQm4xx,66,93,34,70,33,1,21,2,254,36.285714285714285,6,0.0,49,34,69,33,44,1,1,21,2,185,69,1
1452,15922,OHdLWfOkVYVSxh9avWbeG6oGLyuN9vvx,7GRhBDsirIGkRZBtSMEzNTyDr2JQm4xx,43,71,25,56,18,21,14,0,205,29.285714285714285,4,0.0,31,25,52,18,40,21,4,14,0,126,79,1
1453,15924,pXzK9E1YOZkyyLlXWv7EKpRMBTF7x1zF,7GRhBDsirIGkRZBtSMEzNTyDr2JQm4xx,1,0,0,0,0,0,1,0,1,0.14285714285714285,1,0.0,0,0,0,0,0,0,0,1,0,0,1,1
1454,15944,i4Ja5POFcbWsTXzyspWne0P4gq0Sndm7,7GRhBDsirIGkRZBtSMEzNTyDr2JQm4xx,29,55,21,27,9,0,13,0,125,17.857142857142858,3,0.0,30,21,22,9,25,0,5,13,0,82,43,1
1455,15947,JvcRsdOfDUJrxbmOeabeYf6ul7MDwm6b,7GRhBDsirIGkRZBtSMEzNTyDr2JQm4xx,22,25,7,19,6,0,3,0,60,8.571428571428571,3,0.0,14,7,17,6,11,0,2,3,0,44,16,1
1456,15956,wg7c1wZNHnWuQEzOFg3X7UO4UvdvZ0Nl,7GRhBDsirIGkRZBtSMEzNTyDr2JQm4xx,26,30,10,108,3,0,5,0,156,22.285714285714285,3,0.0,10,10,96,3,20,0,12,5,0,119,37,1
1457,15959,KD5stEhIDxW0wB7Mr1YVPQQ5AGRkzqAA,7GRhBDsirIGkRZBtSMEzNTyDr2JQm4xx,58,118,45,70,28,22,17,0,300,42.857142857142854,5,0.0,63,45,63,28,55,22,7,17,0,199,101,1
1458,15966,dWGIj0UEkV1WxMBYGHRsdtDhUsNSq5LC,7GRhBDsirIGkRZBtSMEzNTyDr2JQm4xx,45,95,37,26,31,5,15,1,210,30.0,7,0.0,42,37,25,31,53,5,1,15,1,135,75,0
1459,15982,yUo0f8mA9XEAtzr6kcSUh5ydpzcuIcml,7GRhBDsirIGkRZBtSMEzNTyDr2JQm4xx,32,47,16,38,9,5,19,0,134,19.142857142857142,2,0.0,20,16,34,9,27,5,4,19,0,79,55,1
1460,15987,6zXGZtvwHnFZCYFcS3Xzk5yrVH7CXdoJ,7GRhBDsirIGkRZBtSMEzNTyDr2JQm4xx,1,0,0,0,0,0,1,0,1,0.14285714285714285,1,0.0,0,0,0,0,0,0,0,1,0,0,1,1
1461,16020,ywdL3xkp7d2PSjbvnflAvIe7Wp6Q4SRe,7GRhBDsirIGkRZBtSMEzNTyDr2JQm4xx,46,145,20,108,21,0,19,0,313,44.714285714285715,6,0.0,64,20,102,21,81,0,6,19,0,207,106,1
1462,16029,aWq626ehQk5Iuuwzds6iAgtzgkimu1j2,7GRhBDsirIGkRZBtSMEzNTyDr2JQm4xx,60,91,32,130,36,2,15,0,306,43.714285714285715,6,0.0,50,32,113,36,41,2,17,15,0,231,75,1
1463,16038,NoaJNfAZAESYC7salsh3Qwaa5hC3sdBk,7GRhBDsirIGkRZBtSMEzNTyDr2JQm4xx,28,56,14,56,7,18,3,0,154,22.0,1,0.0,38,14,47,7,18,18,9,3,0,106,48,0
1464,16081,Z9zd5ft7NWbOfEUxKVShKB2Y1F3jXBm8,7GRhBDsirIGkRZBtSMEzNTyDr2JQm4xx,13,10,6,2,3,1,10,0,32,4.571428571428571,2,0.0,1,6,2,3,9,1,0,10,0,12,20,1
1465,16087,SIdEQEXoagJ5WwAcAkPtkVF6pipatiIa,7GRhBDsirIGkRZBtSMEzNTyDr2JQm4xx,54,164,47,78,27,4,14,0,334,47.714285714285715,4,0.0,55,47,66,27,109,4,12,14,0,195,139,0
1466,16091,DWloCId6fkO6Ms5BXhdCfDhm96dIK6F3,7GRhBDsirIGkRZBtSMEzNTyDr2JQm4xx,1,0,0,0,0,0,1,0,1,0.14285714285714285,1,0.0,0,0,0,0,0,0,0,1,0,0,1,1
1467,16131,cwM32Iyo8DmzSk0EybXLo5ksFWhXG4Da,7GRhBDsirIGkRZBtSMEzNTyDr2JQm4xx,5,2,1,0,1,0,2,0,6,0.8571428571428571,1,0.0,0,1,0,1,2,0,0,2,0,2,4,0
1468,16134,JmlFAaRVuCFkmr6g7GLFJYPWWHADo3Vp,7GRhBDsirIGkRZBtSMEzNTyDr2JQm4xx,1,0,0,0,0,0,1,0,1,0.14285714285714285,1,0.0,0,0,0,0,0,0,0,1,0,0,1,1
1469,16168,DLDhUvvvfnnYFJuV65Zt2yaS0jPJgvzq,7GRhBDsirIGkRZBtSMEzNTyDr2JQm4xx,36,86,0,80,1,0,12,0,179,25.571428571428573,5,0.0,28,0,67,1,58,0,13,12,0,96,83,1
1470,16238,4NRUo07WkcrdRLUhlPTipY45aaERRn99,7GRhBDsirIGkRZBtSMEzNTyDr2JQm4xx,2,0,0,0,0,0,2,0,2,0.2857142857142857,1,0.0,0,0,0,0,0,0,0,2,0,0,2,0
1471,16285,W8p8vrZuo5elf0zj1Aez8mTMlTcetQ7p,7GRhBDsirIGkRZBtSMEzNTyDr2JQm4xx,6,4,2,0,1,0,2,0,9,1.2857142857142858,1,0.0,0,2,0,1,4,0,0,2,0,3,6,1
1472,16289,moK1GdnqoYxhSRCf5a95lgXdVNdzYrjs,7GRhBDsirIGkRZBtSMEzNTyDr2JQm4xx,49,151,13,72,15,2,46,0,299,42.714285714285715,8,0.0,43,13,64,15,108,2,8,46,0,135,164,1
1473,16303,2WHNpOBPMmOzdjUXQIDdX6w5Bhh6AyHU,7GRhBDsirIGkRZBtSMEzNTyDr2JQm4xx,32,78,7,41,7,0,17,0,150,21.428571428571427,4,0.0,37,7,35,7,41,0,6,17,0,86,64,0
1474,16378,RjbxXw1YYmiUcedHIl1VrXvYXiS6wbOC,7GRhBDsirIGkRZBtSMEzNTyDr2JQm4xx,17,16,2,9,3,0,19,2,51,7.285714285714286,4,0.0,4,2,8,3,12,0,1,19,2,17,34,0
1475,16415,096xYyhB9kL7G6lT7J9rVrXyGNwUToLF,7GRhBDsirIGkRZBtSMEzNTyDr2JQm4xx,20,19,14,0,3,0,6,0,42,6.0,3,0.0,0,14,0,3,19,0,0,6,0,17,25,0
1476,16460,KDzfaWgTSBqeMJLFLmFuh4CMLsva9aWu,7GRhBDsirIGkRZBtSMEzNTyDr2JQm4xx,27,74,0,66,1,0,12,0,153,21.857142857142858,5,0.0,18,0,56,1,56,0,10,12,0,75,78,0
1477,16484,v1iavhjAgOftyRIIBT7pVhYkpNdcTDpm,7GRhBDsirIGkRZBtSMEzNTyDr2JQm4xx,12,11,5,0,2,1,6,1,26,3.7142857142857144,2,0.0,4,5,0,2,7,1,0,6,1,11,15,1
1478,16518,VFg2AN5zsuWpHyPwDEXIcAxQpNCPCOo7,7GRhBDsirIGkRZBtSMEzNTyDr2JQm4xx,66,178,62,99,48,54,43,2,486,69.42857142857143,5,0.0,70,62,86,48,108,54,13,43,2,266,220,1
1479,16541,tDBUBIMhJEJx4Pe5n9oY4eK5G81QRmVq,7GRhBDsirIGkRZBtSMEzNTyDr2JQm4xx,55,160,3,183,13,10,12,0,381,54.42857142857143,6,0.0,76,3,168,13,84,10,15,12,0,260,121,0
1480,16559,WbPhqfwmFYggW432ooC1iHmgUJBCP9Le,7GRhBDsirIGkRZBtSMEzNTyDr2JQm4xx,69,141,57,112,45,31,40,5,431,61.57142857142857,8,0.0,72,57,98,45,69,31,14,40,5,272,159,0
1481,16582,BxR5XM6DXnDlyXChlQFtgsFNvTkRDfGo,7GRhBDsirIGkRZBtSMEzNTyDr2JQm4xx,5,4,1,0,0,0,2,0,7,1.0,1,0.0,1,1,0,0,3,0,0,2,0,2,5,1
1482,16632,uPNpQwnvEtjDufLcIcScg8qVljQjes1y,7GRhBDsirIGkRZBtSMEzNTyDr2JQm4xx,46,72,24,63,18,0,10,0,187,26.714285714285715,6,0.0,30,24,59,18,42,0,4,10,0,131,56,1
1483,16696,EshSTNSaPVDLcPEwlm2e07DrZJhzPNHK,7GRhBDsirIGkRZBtSMEzNTyDr2JQm4xx,68,211,69,122,28,55,38,0,523,74.71428571428571,6,0.0,123,69,99,28,88,55,23,38,0,319,204,0
1484,16712,5nwrdJlhASYfMmSpU3deRRqUrd3ZpMIS,7GRhBDsirIGkRZBtSMEzNTyDr2JQm4xx,6,4,2,0,1,0,4,0,11,1.5714285714285714,2,0.0,0,2,0,1,4,0,0,4,0,3,8,1
1485,16787,ntbB11ay7TxjZmHHl7KvM6m0h5FtxAHR,7GRhBDsirIGkRZBtSMEzNTyDr2JQm4xx,9,8,4,0,5,1,6,1,25,3.5714285714285716,1,0.0,3,4,0,5,5,1,0,6,1,12,13,1
1486,16828,FhnsJdRTpIANrPfAv3Fv2vn7QGHPfOsl,7GRhBDsirIGkRZBtSMEzNTyDr2JQm4xx,13,24,11,0,2,91,35,0,163,23.285714285714285,7,0.0,4,11,0,2,20,91,0,35,0,17,146,0
1487,16923,oSfAVLTcGEmcT7y7OMQrYnvkkm78yh0P,7GRhBDsirIGkRZBtSMEzNTyDr2JQm4xx,66,116,42,204,29,47,12,0,450,64.28571428571429,4,0.0,64,42,175,29,52,47,29,12,0,310,140,1
1488,16957,5fUv2a4WMEi2Bc60cQo0Uzo1I7SufPfI,7GRhBDsirIGkRZBtSMEzNTyDr2JQm4xx,31,58,2,70,6,41,7,0,184,26.285714285714285,4,0.0,22,2,58,6,36,41,12,7,0,88,96,1
1489,16978,9gZpfuq1OK1diJdWcNoIpwo7QJUSplIt,7GRhBDsirIGkRZBtSMEzNTyDr2JQm4xx,55,142,62,69,29,6,29,2,339,48.42857142857143,6,0.0,68,62,63,29,74,6,6,29,2,222,117,1
1490,16979,hdKqkkWKrDzbKE9btGChBqiCfsTwp68E,7GRhBDsirIGkRZBtSMEzNTyDr2JQm4xx,13,7,5,0,0,26,18,2,58,8.285714285714286,3,0.0,0,5,0,0,7,26,0,18,2,5,53,1
1491,16989,76mZXn9JCyY7Mb7TWPGPGPMVCvSrLgze,7GRhBDsirIGkRZBtSMEzNTyDr2JQm4xx,39,74,18,68,27,1,8,1,197,28.142857142857142,2,0.0,44,18,63,27,30,1,5,8,1,152,45,1
1492,16999,Jb792VQeMGhUz59LQDa5JysSU082aNRs,7GRhBDsirIGkRZBtSMEzNTyDr2JQm4xx,25,51,22,28,11,1,3,0,116,16.571428571428573,6,0.0,25,22,25,11,26,1,3,3,0,83,33,0
1493,17028,HF98YPKzT8oi2j9flZW9kstZcvL3ZimG,7GRhBDsirIGkRZBtSMEzNTyDr2JQm4xx,34,81,21,68,11,0,3,0,184,26.285714285714285,2,0.0,26,21,58,11,55,0,10,3,0,116,68,0
1494,17049,4i80ssNqIa74pSBDzjYYryTbL6MBe9I9,7GRhBDsirIGkRZBtSMEzNTyDr2JQm4xx,63,138,43,136,45,60,46,0,468,66.85714285714286,7,0.0,86,43,113,45,52,60,23,46,0,287,181,1
1495,17055,CxUPOQRaQMGLmbOcfniIQOhh24PXLDR6,7GRhBDsirIGkRZBtSMEzNTyDr2JQm4xx,37,132,41,34,23,13,14,2,259,37.0,10,0.0,51,41,27,23,81,13,7,14,2,142,117,0
1496,17104,oxYTAYYaR98reRev5BqLPii4AFJGZbGZ,7GRhBDsirIGkRZBtSMEzNTyDr2JQm4xx,40,68,20,91,20,6,17,1,223,31.857142857142858,4,0.0,28,20,82,20,40,6,9,17,1,150,73,1
1497,17166,aJMNcTer76nTaYZZR58xtdmLr8BYq1Op,7GRhBDsirIGkRZBtSMEzNTyDr2JQm4xx,1,0,0,0,0,0,1,0,1,0.14285714285714285,1,0.0,0,0,0,0,0,0,0,1,0,0,1,1
1498,17267,5nhjk1VnZY8a3OWnkRujRs0BorgiAKUm,7GRhBDsirIGkRZBtSMEzNTyDr2JQm4xx,47,94,2,204,5,29,26,2,362,51.714285714285715,7,0.0,44,2,187,5,50,29,17,26,2,238,124,1
1499,17303,yhSGXw7EnYX7J3WWxRb9piBAfJaOtRLJ,7GRhBDsirIGkRZBtSMEzNTyDr2JQm4xx,50,86,29,151,7,0,6,0,279,39.857142857142854,5,0.0,38,29,133,7,48,0,18,6,0,207,72,1
1500,17332,Dy53HBwqZRiUys0tuL4RoOSu6jKEN99b,7GRhBDsirIGkRZBtSMEzNTyDr2JQm4xx,29,27,3,32,6,0,9,0,77,11.0,2,0.0,14,3,30,6,13,0,2,9,0,53,24,0
1501,17340,TilPXsBtUeInJte9nDlpbC1Ot52Vr9xD,7GRhBDsirIGkRZBtSMEzNTyDr2JQm4xx,6,8,1,0,1,0,3,0,13,1.8571428571428572,1,0.0,0,1,0,1,8,0,0,3,0,2,11,1
1502,17350,3WLDG20nmrHcXqgUBcbAgxTDjIgQgeWc,7GRhBDsirIGkRZBtSMEzNTyDr2JQm4xx,1,0,0,0,0,0,1,0,1,0.14285714285714285,1,0.0,0,0,0,0,0,0,0,1,0,0,1,1
1503,17382,B9q7BVaj4oZ0WT5JELnStUq4yahYsvGS,7GRhBDsirIGkRZBtSMEzNTyDr2JQm4xx,52,157,28,68,34,13,11,0,311,44.42857142857143,8,0.0,72,28,63,34,85,13,5,11,0,197,114,1
1504,17388,QRh7ApSBJNbSH61R3OkAQmXanxVzZM0F,7GRhBDsirIGkRZBtSMEzNTyDr2JQm4xx,20,41,20,30,17,2,3,0,113,16.142857142857142,3,0.0,18,20,26,17,23,2,4,3,0,81,32,0
1505,17389,Qj89AM8R8CzDfUmyoFjU0iKz1g513ZXt,7GRhBDsirIGkRZBtSMEzNTyDr2JQm4xx,71,267,117,198,35,574,97,8,1296,185.14285714285714,12,0.0,67,117,167,35,200,574,31,97,8,386,910,1
1506,17419,RALsNmDC4TIWwMjDij2qj4Bbd4iRP5eW,7GRhBDsirIGkRZBtSMEzNTyDr2JQm4xx,5,2,1,0,1,0,2,0,6,0.8571428571428571,1,0.0,0,1,0,1,2,0,0,2,0,2,4,1
1507,17459,1Ueye4RWWjvz8urTBfWMjk9mmqk3rMDD,7GRhBDsirIGkRZBtSMEzNTyDr2JQm4xx,35,59,23,28,21,13,8,0,152,21.714285714285715,3,0.0,34,23,28,21,25,13,0,8,0,106,46,1
1508,17510,riM9GkB0ajSqpIPlVq4tRzOjk7wJ6NHE,7GRhBDsirIGkRZBtSMEzNTyDr2JQm4xx,35,47,21,47,19,0,6,0,140,20.0,3,0.0,23,21,44,19,24,0,3,6,0,107,33,0
1509,17535,0j1auVPH81fVETuSCGy4JUgrdNva23MX,7GRhBDsirIGkRZBtSMEzNTyDr2JQm4xx,10,10,3,0,2,1,5,0,21,3.0,1,0.0,0,3,0,2,10,1,0,5,0,5,16,1
1510,17536,5EqHj7Yiq3ymf3kXC9ShF9mwG40Y7dpr,7GRhBDsirIGkRZBtSMEzNTyDr2JQm4xx,6,7,1,0,1,0,2,0,11,1.5714285714285714,1,0.0,0,1,0,1,7,0,0,2,0,2,9,1
1511,17540,FAO2ZdiHLpuwiCcIDpRl8MBgRMyFcfQ2,7GRhBDsirIGkRZBtSMEzNTyDr2JQm4xx,7,6,2,0,1,1,3,0,13,1.8571428571428572,2,0.0,0,2,0,1,6,1,0,3,0,3,10,1
1512,17586,TwDUv8vbemLEqdAHMCXeJ0dOJyZMBx6V,7GRhBDsirIGkRZBtSMEzNTyDr2JQm4xx,30,67,19,34,6,5,6,0,137,19.571428571428573,3,0.0,28,19,30,6,39,5,4,6,0,83,54,0
1513,17592,87HjW3xlExsdfk3WF0s7d71nmAzoFuKE,7GRhBDsirIGkRZBtSMEzNTyDr2JQm4xx,2,0,0,0,0,0,2,0,2,0.2857142857142857,1,0.0,0,0,0,0,0,0,0,2,0,0,2,1
1514,17595,3vhCoT2dzeVdCpmcedhNzxK4VNLZ2l0r,7GRhBDsirIGkRZBtSMEzNTyDr2JQm4xx,9,5,1,0,1,0,7,1,15,2.142857142857143,2,0.0,0,1,0,1,5,0,0,7,1,2,13,1
1515,17597,dxt9lWTWbhPZn9mT70zVSi49oFElvqw6,7GRhBDsirIGkRZBtSMEzNTyDr2JQm4xx,28,54,5,68,7,1,7,0,142,20.285714285714285,4,0.0,25,5,60,7,29,1,8,7,0,97,45,1
1516,17612,XarBLnhwPhERC9Lork4s2tIiSLNqD9KT,7GRhBDsirIGkRZBtSMEzNTyDr2JQm4xx,1,0,0,0,0,0,1,0,1,0.14285714285714285,1,0.0,0,0,0,0,0,0,0,1,0,0,1,1
1517,17620,5HX4czL6Sp8ee3UX2kWAHqmFW5CMMTjE,7GRhBDsirIGkRZBtSMEzNTyDr2JQm4xx,45,155,47,70,30,2,14,0,318,45.42857142857143,5,0.0,52,47,63,30,103,2,7,14,0,192,126,0
1518,17626,uol5rXltLKrhjm5SMrTU5qkZcMAMKTe6,7GRhBDsirIGkRZBtSMEzNTyDr2JQm4xx,47,91,40,90,30,23,18,1,293,41.857142857142854,5,0.0,42,40,76,30,49,23,14,18,1,188,105,1
1519,17647,f0IqI5DBlXdS6eUmVFeyauyA8dq5ftiC,7GRhBDsirIGkRZBtSMEzNTyDr2JQm4xx,23,38,19,2,10,8,6,0,83,11.857142857142858,1,0.0,5,19,2,10,33,8,0,6,0,36,47,1
1520,17652,dW2So4dhz8sFwZQzndBoTpsFa69MFo0q,7GRhBDsirIGkRZBtSMEzNTyDr2JQm4xx,1,0,0,0,0,0,1,0,1,0.14285714285714285,1,0.0,0,0,0,0,0,0,0,1,0,0,1,1
1521,17660,UaSh8dwx8gnofYbXlmpqj9uYDbpJ89pX,7GRhBDsirIGkRZBtSMEzNTyDr2JQm4xx,11,26,1,0,2,6,9,0,44,6.285714285714286,4,0.0,12,1,0,2,14,6,0,9,0,15,29,0
1522,17677,7VmmzXV3A639hzlpZwrx655FqwOsl8uh,7GRhBDsirIGkRZBtSMEzNTyDr2JQm4xx,8,8,0,0,0,0,7,0,15,2.142857142857143,4,0.0,0,0,0,0,8,0,0,7,0,0,15,1
1523,17692,xndkXq03AGanha0Zu6RBymqlwrjUbtA1,7GRhBDsirIGkRZBtSMEzNTyDr2JQm4xx,10,5,2,6,3,0,5,0,21,3.0,2,0.0,2,2,6,3,3,0,0,5,0,13,8,1
1524,17706,WJVoKPfDDccrIbPzaP1iqdrTUwOdTQpf,7GRhBDsirIGkRZBtSMEzNTyDr2JQm4xx,43,101,22,4,23,6,12,2,170,24.285714285714285,2,0.0,45,22,4,23,56,6,0,12,2,94,76,1
1525,17707,8hNQWXBoItm3CRzdk0wSJDwYSfUbhUCO,7GRhBDsirIGkRZBtSMEzNTyDr2JQm4xx,29,46,9,34,10,0,2,0,101,14.428571428571429,2,0.0,25,9,30,10,21,0,4,2,0,74,27,1
1526,19577,udnRYxurswpE4GUZcnc80kafg0hn3fpz,fbPkOYLVPtPgIt0MxizjfFJov3JbHyAi,1,0,0,0,0,0,1,0,1,0.14285714285714285,1,0.0,0,0,0,0,0,0,0,1,0,0,1,1
1527,19578,8o4E9PO3r20M8IPbGHnn7ry81or8oVUd,fbPkOYLVPtPgIt0MxizjfFJov3JbHyAi,5,4,1,0,1,0,2,0,8,1.1428571428571428,1,0.0,0,1,0,1,4,0,0,2,0,2,6,1
1528,19579,mK2PenVNfwXeBJzi7mP3HzWchd5fxecA,fbPkOYLVPtPgIt0MxizjfFJov3JbHyAi,7,5,2,0,1,4,8,0,20,2.857142857142857,3,0.0,0,2,0,1,5,4,0,8,0,3,17,1
1529,19580,3W09pasLSoDWuQqGyvECJ7WiykG165j2,fbPkOYLVPtPgIt0MxizjfFJov3JbHyAi,11,50,10,1,3,23,12,0,99,14.142857142857142,6,0.0,7,10,1,3,43,23,0,12,0,21,78,1
1530,19581,VHVVDsLJTPPR7rfPiJMrbsUMa6RdDEDz,fbPkOYLVPtPgIt0MxizjfFJov3JbHyAi,1,0,0,0,0,0,2,0,2,0.2857142857142857,1,0.0,0,0,0,0,0,0,0,2,0,0,2,1
1531,19582,0YyuZCZ9YG2n31hPJCi1E2GmCt5JQVnE,fbPkOYLVPtPgIt0MxizjfFJov3JbHyAi,7,3,2,0,2,2,3,0,12,1.7142857142857142,1,0.0,0,2,0,2,3,2,0,3,0,4,8,0
1532,19584,svaRJHaQGfUR34JQvStVpv5jX9kWWhlQ,fbPkOYLVPtPgIt0MxizjfFJov3JbHyAi,7,5,2,0,2,0,3,0,12,1.7142857142857142,1,0.0,0,2,0,2,5,0,0,3,0,4,8,1
1533,19586,z5Htt0utseDft2JjH8T5zYokNhpAiHNE,fbPkOYLVPtPgIt0MxizjfFJov3JbHyAi,6,21,0,0,4,0,3,0,28,4.0,2,0.0,11,0,0,4,10,0,0,3,0,15,13,0
1534,19587,I45Q3yivyiRN2kHVhbV8bUCfrXvtpUvU,fbPkOYLVPtPgIt0MxizjfFJov3JbHyAi,9,7,5,0,4,0,7,0,23,3.2857142857142856,1,0.0,0,5,0,4,7,0,0,7,0,9,14,1
1535,19588,EFioWHTkYv074j9vSFY7qmw2MvFzZ0mo,fbPkOYLVPtPgIt0MxizjfFJov3JbHyAi,45,91,39,38,29,91,30,1,319,45.57142857142857,10,0.0,34,39,31,29,57,91,7,30,1,133,186,0
1536,19589,SgWqRh3XmeJpz6RfUb8yXu2ZkH0AleuJ,fbPkOYLVPtPgIt0MxizjfFJov3JbHyAi,9,9,1,0,0,10,7,1,28,4.0,2,0.0,1,1,0,0,8,10,0,7,1,2,26,1
1537,19591,I91CCtQfetYUPwkEXIvTFBP6tbrp1spN,fbPkOYLVPtPgIt0MxizjfFJov3JbHyAi,7,26,15,0,5,0,11,0,57,8.142857142857142,9,0.0,0,15,0,5,26,0,0,11,0,20,37,0
1538,19592,dl33BYrB63jF9H7InuQDxo3dQrVdjLGV,fbPkOYLVPtPgIt0MxizjfFJov3JbHyAi,7,3,2,0,2,0,4,0,11,1.5714285714285714,1,0.0,0,2,0,2,3,0,0,4,0,4,7,1
1539,19593,sYGG7Hl1IcaeWwJigpwVXXbQKD0HFEPn,fbPkOYLVPtPgIt0MxizjfFJov3JbHyAi,7,3,2,0,2,0,3,0,10,1.4285714285714286,1,0.0,0,2,0,2,3,0,0,3,0,4,6,1
1540,19595,b3ktGBnxedY4iAdFYIyjERgRCauTInkK,fbPkOYLVPtPgIt0MxizjfFJov3JbHyAi,12,30,13,2,8,48,17,2,120,17.142857142857142,3,0.0,10,13,2,8,20,48,0,17,2,33,87,1
1541,19597,wFWVvTUKN4Nj5vWrbX5PVi6EvLKq8sqa,fbPkOYLVPtPgIt0MxizjfFJov3JbHyAi,24,54,18,29,27,0,5,0,133,19.0,2,0.0,32,18,22,27,22,0,7,5,0,99,34,1
1542,19598,rUHwInfwrT2VCsoj7SngGENcoxIrK2aA,fbPkOYLVPtPgIt0MxizjfFJov3JbHyAi,34,104,31,48,29,97,32,7,348,49.714285714285715,7,0.0,57,31,38,29,47,97,10,32,7,155,193,1
1543,19599,QZNGHI9TocOuANx6bTOdMFrqzeb0fTw3,fbPkOYLVPtPgIt0MxizjfFJov3JbHyAi,1,0,0,0,0,0,1,0,1,0.14285714285714285,1,0.0,0,0,0,0,0,0,0,1,0,0,1,1
1544,19600,YCZ0HSNcZja1vuapbZTjyZlLagijA85V,fbPkOYLVPtPgIt0MxizjfFJov3JbHyAi,7,3,2,0,2,0,3,0,10,1.4285714285714286,1,0.0,0,2,0,2,3,0,0,3,0,4,6,1
1545,19601,gpUff0gJHSKcQDbNnT6UR6klN9yWn4B3,fbPkOYLVPtPgIt0MxizjfFJov3JbHyAi,17,27,12,12,10,1,7,0,69,9.857142857142858,2,0.0,8,12,9,10,19,1,3,7,0,39,30,1
1546,19602,cxXfR155NqvzoUrJxE0tct65N6OEUGW3,fbPkOYLVPtPgIt0MxizjfFJov3JbHyAi,2,0,0,0,0,0,3,0,3,0.42857142857142855,1,0.0,0,0,0,0,0,0,0,3,0,0,3,1
1547,19603,0VxsYnODhio1aXODkLqOGQB4NYdClGaT,fbPkOYLVPtPgIt0MxizjfFJov3JbHyAi,2,1,0,0,0,0,1,0,2,0.2857142857142857,1,0.0,0,0,0,0,1,0,0,1,0,0,2,1
1548,19604,1EQy9mKBCgbz8jG2K6f93LU9GKq65V9v,fbPkOYLVPtPgIt0MxizjfFJov3JbHyAi,7,3,1,0,2,0,3,0,9,1.2857142857142858,1,0.0,0,1,0,2,3,0,0,3,0,3,6,1
1549,19606,CLH6KVxeKfUu9lbHyFm5yc6Qf4HvLCyR,fbPkOYLVPtPgIt0MxizjfFJov3JbHyAi,2,0,0,0,0,0,8,0,8,1.1428571428571428,2,0.0,0,0,0,0,0,0,0,8,0,0,8,1
1550,19607,BCPOhUa2LrfH93ebCE15VbF0VEWEyi7T,fbPkOYLVPtPgIt0MxizjfFJov3JbHyAi,9,5,3,0,2,10,3,1,24,3.4285714285714284,1,0.0,0,3,0,2,5,10,0,3,1,5,19,1
1551,19609,hSrmLZQ0ouEuE46yYppuvpfSWmkaTAsV,fbPkOYLVPtPgIt0MxizjfFJov3JbHyAi,8,5,2,0,2,0,5,0,14,2.0,2,0.0,0,2,0,2,5,0,0,5,0,4,10,1
1552,19610,kLgTb4zs1DK0fasndFOTstbWViutnXRG,fbPkOYLVPtPgIt0MxizjfFJov3JbHyAi,17,37,18,11,12,3,17,2,100,14.285714285714286,3,0.0,11,18,9,12,26,3,2,17,2,50,50,1
1553,19611,jmpbNsd2zzToMH9HZWx8NTyZ25PfYydC,fbPkOYLVPtPgIt0MxizjfFJov3JbHyAi,10,8,5,0,4,7,5,0,29,4.142857142857143,2,0.0,0,5,0,4,8,7,0,5,0,9,20,1
1554,19612,XVNXZTDLYViPgXZBTcX5RWMvf5SNK18Y,fbPkOYLVPtPgIt0MxizjfFJov3JbHyAi,16,9,7,0,7,0,1,0,24,3.4285714285714284,1,0.0,0,7,0,7,9,0,0,1,0,14,10,1
1555,19615,y9ukbIQfB4L7zn5UoeGfcZjZUqTsQsJk,fbPkOYLVPtPgIt0MxizjfFJov3JbHyAi,6,3,2,0,2,3,1,0,11,1.5714285714285714,1,0.0,0,2,0,2,3,3,0,1,0,4,7,1
1556,19616,kyJzGSg3elXhPrIWM8rkZuAZv6RhnLQu,fbPkOYLVPtPgIt0MxizjfFJov3JbHyAi,29,73,49,4,21,91,11,2,251,35.857142857142854,7,0.0,1,49,3,21,72,91,1,11,2,74,177,1
1557,19617,FcPFK6OTsUF1j3uNGabdzGTvbY8kcO3D,fbPkOYLVPtPgIt0MxizjfFJov3JbHyAi,7,20,0,0,2,0,4,0,26,3.7142857142857144,2,0.0,4,0,0,2,16,0,0,4,0,6,20,1
1558,19620,wbbNGhodAmSlYSg7ZSWYtWMdb0rjLgRw,fbPkOYLVPtPgIt0MxizjfFJov3JbHyAi,13,13,7,2,5,8,6,0,41,5.857142857142857,2,0.0,1,7,2,5,12,8,0,6,0,15,26,1
1559,19621,P7cWTzqHbKs2w7IhW7Eb0IWuvmS7VHHm,fbPkOYLVPtPgIt0MxizjfFJov3JbHyAi,37,113,55,20,51,50,12,1,302,43.142857142857146,5,0.0,51,55,17,51,62,50,3,12,1,174,128,0
1560,19622,qGzhVjTxktnI3gvlHnV7uXSPz6cASHXn,fbPkOYLVPtPgIt0MxizjfFJov3JbHyAi,11,10,5,0,4,13,8,1,41,5.857142857142857,4,0.0,0,5,0,4,10,13,0,8,1,9,32,1
1561,19623,GDKy1KAMQHkxWaQDYOeRxnEA0ZpODsn0,fbPkOYLVPtPgIt0MxizjfFJov3JbHyAi,7,3,2,0,2,10,6,0,23,3.2857142857142856,2,0.0,0,2,0,2,3,10,0,6,0,4,19,1
1562,19624,2we3WxltFBT1dd0FjP3YZ8iHf2xpHEei,fbPkOYLVPtPgIt0MxizjfFJov3JbHyAi,8,10,4,0,4,7,4,0,29,4.142857142857143,3,0.0,3,4,0,4,7,7,0,4,0,11,18,1
1563,19626,HnvxqugChFN5yjBU90JTvP996KYT36S0,fbPkOYLVPtPgIt0MxizjfFJov3JbHyAi,25,83,36,11,14,45,23,2,214,30.571428571428573,5,0.0,30,36,10,14,53,45,1,23,2,90,124,1
1564,19627,aNviqaUsa8tjM9b6nMwh7ketdx2tdX99,fbPkOYLVPtPgIt0MxizjfFJov3JbHyAi,1,0,0,0,0,0,1,0,1,0.14285714285714285,1,0.0,0,0,0,0,0,0,0,1,0,0,1,1
1565,19629,G0JgmTQ55TeK9aeblJVq6TYQNTXqJFIQ,fbPkOYLVPtPgIt0MxizjfFJov3JbHyAi,14,19,8,8,7,0,6,0,48,6.857142857142857,3,0.0,2,8,7,7,17,0,1,6,0,24,24,1
1566,19630,peOW1xVaKPULFrN5Gy7l1puUz8vUwyZz,fbPkOYLVPtPgIt0MxizjfFJov3JbHyAi,6,9,5,0,1,12,5,0,32,4.571428571428571,2,0.0,0,5,0,1,9,12,0,5,0,6,26,1
1567,19631,8skbDsuebvai4ARav7dTtpvek1eLVeds,fbPkOYLVPtPgIt0MxizjfFJov3JbHyAi,12,69,47,0,43,15,24,3,201,28.714285714285715,7,0.0,11,47,0,43,58,15,0,24,3,101,100,1
1568,19633,npX3FgekV8W61Z0uW836onGI4m2nQdnG,fbPkOYLVPtPgIt0MxizjfFJov3JbHyAi,4,2,1,0,1,3,1,0,8,1.1428571428571428,1,0.0,0,1,0,1,2,3,0,1,0,2,6,1
1569,19634,jX7tq2pnsDlar9WIdJmOwYa2kqXNP8p5,fbPkOYLVPtPgIt0MxizjfFJov3JbHyAi,26,36,15,23,16,22,18,6,136,19.428571428571427,2,0.0,17,15,19,16,19,22,4,18,6,67,69,1
1570,19636,cFawqBd5fJtkKlCTemtngl3kfpxBO2Oy,fbPkOYLVPtPgIt0MxizjfFJov3JbHyAi,13,23,10,10,9,12,7,1,72,10.285714285714286,4,0.0,8,10,7,9,15,12,3,7,1,34,38,1
1571,19638,VG5BsqnAudb2wrnNFKVoV7tORlRXExaE,fbPkOYLVPtPgIt0MxizjfFJov3JbHyAi,9,26,15,0,6,20,13,3,83,11.857142857142858,4,0.0,2,15,0,6,24,20,0,13,3,23,60,1
1572,19639,nHMKztqwQYqP5QiyWQSLf3rlpTKGeMZ7,fbPkOYLVPtPgIt0MxizjfFJov3JbHyAi,9,6,4,0,3,12,3,2,30,4.285714285714286,1,0.0,0,4,0,3,6,12,0,3,2,7,23,1
1573,19640,qvYnUocR0frsPd3kYwxIbvUGNPr9n1qt,fbPkOYLVPtPgIt0MxizjfFJov3JbHyAi,7,8,5,0,3,0,2,0,18,2.5714285714285716,2,0.0,0,5,0,3,8,0,0,2,0,8,10,1
1574,19641,GoCzFgZtKHP9v4b0WP4lIjCorcS7Jt3F,fbPkOYLVPtPgIt0MxizjfFJov3JbHyAi,23,55,28,15,17,6,7,0,128,18.285714285714285,5,0.0,18,28,12,17,37,6,3,7,0,75,53,1
1575,19642,kQ63n93d5CTXewyEhcoySFeLgYStuYpO,fbPkOYLVPtPgIt0MxizjfFJov3JbHyAi,7,6,4,0,3,0,2,0,15,2.142857142857143,2,0.0,0,4,0,3,6,0,0,2,0,7,8,1
1576,19643,7Wr2VTJWzRxZOKgdu9ZKFIXmTnCI9fnu,fbPkOYLVPtPgIt0MxizjfFJov3JbHyAi,23,72,21,20,16,0,7,0,136,19.428571428571427,2,0.0,35,21,16,16,37,0,4,7,0,88,48,1
1577,19644,No5ifG9v9VDpFVCY05CK70WSRGncERpv,fbPkOYLVPtPgIt0MxizjfFJov3JbHyAi,12,14,5,0,4,1,8,0,32,4.571428571428571,4,0.0,0,5,0,4,14,1,0,8,0,9,23,1
1578,19646,ggEr2STKTwtSSUdtGCmiPr3DBu3TJ34B,fbPkOYLVPtPgIt0MxizjfFJov3JbHyAi,43,87,37,19,36,49,9,0,237,33.857142857142854,4,0.0,39,37,19,36,48,49,0,9,0,131,106,1
1579,19648,wQAzZrNBkZu6TvNOv2yKxdbJtBBRTSuF,fbPkOYLVPtPgIt0MxizjfFJov3JbHyAi,6,6,1,0,1,11,5,0,24,3.4285714285714284,1,0.0,0,1,0,1,6,11,0,5,0,2,22,1
1580,19649,mbP9O9bSfibkETk00N09Osk4AH9tyOW9,fbPkOYLVPtPgIt0MxizjfFJov3JbHyAi,1,0,0,0,0,0,1,0,1,0.14285714285714285,1,0.0,0,0,0,0,0,0,0,1,0,0,1,1
1581,19650,9Q3q5ak3WAEiXRLChbacNd3Hje0Wa6sd,fbPkOYLVPtPgIt0MxizjfFJov3JbHyAi,27,102,37,30,29,72,24,1,295,42.142857142857146,5,0.0,38,37,21,29,64,72,9,24,1,125,170,1
1582,19654,5J6AhQDgqCTdGi4V2FLrPa1uynjLJqbR,fbPkOYLVPtPgIt0MxizjfFJov3JbHyAi,11,33,1,6,1,16,6,1,64,9.142857142857142,1,0.0,7,1,4,1,26,16,2,6,1,13,51,1
1583,19655,9e5dcfJQbPUU8sTcmzE9DWoDPOA9Nhu3,fbPkOYLVPtPgIt0MxizjfFJov3JbHyAi,6,8,3,0,2,0,2,0,15,2.142857142857143,2,0.0,0,3,0,2,8,0,0,2,0,5,10,1
1584,19656,gsUbcjiJXGVEzC0HsE7H7oNZQUP3vN7h,fbPkOYLVPtPgIt0MxizjfFJov3JbHyAi,25,63,35,14,21,57,21,2,213,30.428571428571427,6,0.0,13,35,11,21,50,57,3,21,2,80,133,1
1585,19657,RaBOiV7pbDCxFmg73km3gwoEkG637iTS,fbPkOYLVPtPgIt0MxizjfFJov3JbHyAi,7,3,2,0,2,0,3,0,10,1.4285714285714286,1,0.0,0,2,0,2,3,0,0,3,0,4,6,1
1586,19658,zTv4QKAduCCJ5yquHsz6UKPKumHF7znP,fbPkOYLVPtPgIt0MxizjfFJov3JbHyAi,10,14,9,0,4,0,4,0,31,4.428571428571429,2,0.0,1,9,0,4,13,0,0,4,0,14,17,1
1587,19659,p8vHkfo5SI0V6B4KROfqrnRCgCCEpojM,fbPkOYLVPtPgIt0MxizjfFJov3JbHyAi,16,35,8,14,10,18,8,0,93,13.285714285714286,2,0.0,21,8,10,10,14,18,4,8,0,49,44,1
1588,19660,Fdf5W8Lu9p3zXrwWlt1EPTxeAnJSyNEE,fbPkOYLVPtPgIt0MxizjfFJov3JbHyAi,8,3,2,0,2,2,4,0,13,1.8571428571428572,1,0.0,0,2,0,2,3,2,0,4,0,4,9,1
1589,19661,yJPR0OidzPKNg5Rj1FfQqqXJqCl4r5z8,fbPkOYLVPtPgIt0MxizjfFJov3JbHyAi,1,0,0,0,0,0,1,0,1,0.14285714285714285,1,0.0,0,0,0,0,0,0,0,1,0,0,1,1
1590,19665,NlHO5hXiy7TmVTHiRgExH6y7p9gJG1YF,fbPkOYLVPtPgIt0MxizjfFJov3JbHyAi,5,4,1,0,1,0,1,0,7,1.0,1,0.0,0,1,0,1,4,0,0,1,0,2,5,1
1591,19667,U04y5vFf0AfyJVGIOJHlryTyRQEOm5pT,fbPkOYLVPtPgIt0MxizjfFJov3JbHyAi,21,36,21,10,10,13,10,1,101,14.428571428571429,5,0.0,3,21,8,10,33,13,2,10,1,42,59,1
1592,19668,Xh98I3V3ah7C40wUQRlxQZnzp2hUFzZ9,fbPkOYLVPtPgIt0MxizjfFJov3JbHyAi,7,6,4,0,3,0,2,0,15,2.142857142857143,3,0.0,0,4,0,3,6,0,0,2,0,7,8,1
1593,19671,m38kM2O7Y9dS9qRyh326gVCH42EwGlbN,fbPkOYLVPtPgIt0MxizjfFJov3JbHyAi,6,5,2,0,3,12,2,0,24,3.4285714285714284,1,0.0,2,2,0,3,3,12,0,2,0,7,17,1
1594,19674,ohSArIWJFOjWcw1iipOBHaELVY4dEsuk,fbPkOYLVPtPgIt0MxizjfFJov3JbHyAi,17,19,9,0,5,13,9,4,59,8.428571428571429,2,0.0,0,9,0,5,19,13,0,9,4,14,45,1
1595,19675,2H6KbsPWrpdsyjI0g4q0nnMN85W6it1n,fbPkOYLVPtPgIt0MxizjfFJov3JbHyAi,1,0,0,0,0,0,1,0,1,0.14285714285714285,1,0.0,0,0,0,0,0,0,0,1,0,0,1,1
1596,19678,5zeXp1xbv4d96w4nRSFAsiN01xqmo82u,fbPkOYLVPtPgIt0MxizjfFJov3JbHyAi,2,0,0,0,0,0,7,0,7,1.0,1,0.0,0,0,0,0,0,0,0,7,0,0,7,1
1597,19679,onkD63zW36qWueM4FnIhDEFep4J6xaTB,fbPkOYLVPtPgIt0MxizjfFJov3JbHyAi,2,0,0,0,0,0,7,0,7,1.0,1,0.0,0,0,0,0,0,0,0,7,0,0,7,1
1598,19685,vh8VMxJwpHETuDx8mTcywtcFmJ5lOlZy,fbPkOYLVPtPgIt0MxizjfFJov3JbHyAi,4,3,2,0,2,0,1,0,8,1.1428571428571428,1,0.0,0,2,0,2,3,0,0,1,0,4,4,0
1599,19687,jh0D2keICXHjZlE8o0iWfTU4GtogK2iV,fbPkOYLVPtPgIt0MxizjfFJov3JbHyAi,11,13,6,0,6,10,3,0,38,5.428571428571429,2,0.0,2,6,0,6,11,10,0,3,0,14,24,1
1600,19689,PwY3L0IvWcNAAWE8QgIO3juuVesQg6xr,fbPkOYLVPtPgIt0MxizjfFJov3JbHyAi,6,5,3,0,1,7,5,0,21,3.0,3,0.0,0,3,0,1,5,7,0,5,0,4,17,1
1601,19690,YNemkS5dqknHOwehYprPYVkMaqYUO4yA,fbPkOYLVPtPgIt0MxizjfFJov3JbHyAi,5,3,1,0,1,1,1,0,7,1.0,1,0.0,0,1,0,1,3,1,0,1,0,2,5,1
1602,19692,KkdnagFJtwwq5n9Iuy7rnQaTqa2llFa9,fbPkOYLVPtPgIt0MxizjfFJov3JbHyAi,25,45,19,9,16,22,17,0,128,18.285714285714285,5,0.0,19,19,9,16,26,22,0,17,0,63,65,1
1603,19693,OWBUV30zEQH7Jt1VRLKmraf0vAFBacfv,fbPkOYLVPtPgIt0MxizjfFJov3JbHyAi,9,11,5,0,4,11,12,0,43,6.142857142857143,2,0.0,3,5,0,4,8,11,0,12,0,12,31,1
1604,19694,4GJSwwikGuUWXSajcKoSlvfsoiC8eEZq,fbPkOYLVPtPgIt0MxizjfFJov3JbHyAi,6,7,2,0,1,0,2,0,12,1.7142857142857142,1,0.0,0,2,0,1,7,0,0,2,0,3,9,1
1605,19695,3SP9iNDvUt8m67ZMqC5DpQRe6ekkTpsP,fbPkOYLVPtPgIt0MxizjfFJov3JbHyAi,12,11,7,0,4,5,9,1,37,5.285714285714286,3,0.0,0,7,0,4,11,5,0,9,1,11,26,0
1606,19696,wE17RsVOxdHL75rwI5QafkkqcL3REji3,fbPkOYLVPtPgIt0MxizjfFJov3JbHyAi,4,2,1,0,1,0,1,0,5,0.7142857142857143,1,0.0,0,1,0,1,2,0,0,1,0,2,3,1
1607,19698,vTwbvGW3E1IdqF0HV32uMMc0gGolPCvf,fbPkOYLVPtPgIt0MxizjfFJov3JbHyAi,8,21,12,5,10,5,3,0,56,8.0,2,0.0,4,12,4,10,17,5,1,3,0,30,26,1
1608,19699,ZQS70X3Ksth8gmZtwesyaYzrxIBfpjcf,fbPkOYLVPtPgIt0MxizjfFJov3JbHyAi,10,24,9,2,4,17,6,0,62,8.857142857142858,2,0.0,10,9,2,4,14,17,0,6,0,25,37,1
1609,19701,Zw1bdKbgaMzUzlqlieQSaucEQ8wggZlx,fbPkOYLVPtPgIt0MxizjfFJov3JbHyAi,4,2,1,0,1,0,2,0,6,0.8571428571428571,1,0.0,0,1,0,1,2,0,0,2,0,2,4,0
1610,19702,p4yxCxiqzIMRoAwoOyGnN7P9RZxypnFm,fbPkOYLVPtPgIt0MxizjfFJov3JbHyAi,20,28,17,6,14,6,6,1,78,11.142857142857142,4,0.0,9,17,6,14,19,6,0,6,1,46,32,1
1611,19705,nbIGolByJC5FPssjDvcKL2vGL3vYMGAq,fbPkOYLVPtPgIt0MxizjfFJov3JbHyAi,29,83,39,20,26,53,31,4,256,36.57142857142857,6,0.0,19,39,16,26,64,53,4,31,4,100,156,0
1612,19708,6U0gCtH3epdLuuj59LGYbTzqvsPQ3DiY,fbPkOYLVPtPgIt0MxizjfFJov3JbHyAi,6,5,3,0,2,0,3,0,13,1.8571428571428572,1,0.0,0,3,0,2,5,0,0,3,0,5,8,1
1613,19709,uMtCQ7Qbv3rm9GwFXfsL1kyH8D7nIalM,fbPkOYLVPtPgIt0MxizjfFJov3JbHyAi,6,19,1,0,0,8,5,0,33,4.714285714285714,2,0.0,2,1,0,0,17,8,0,5,0,3,30,0
1614,19713,IxqtjkNiph0SiGkmwfaH729SQtK50jPu,fbPkOYLVPtPgIt0MxizjfFJov3JbHyAi,7,3,0,0,0,14,7,1,25,3.5714285714285716,1,0.0,0,0,0,0,3,14,0,7,1,0,25,1
1615,19714,uuyAyzBNPZJSqNkYTwX3ItAQ7Xcq5lqK,fbPkOYLVPtPgIt0MxizjfFJov3JbHyAi,5,5,3,0,1,13,3,0,25,3.5714285714285716,3,0.0,0,3,0,1,5,13,0,3,0,4,21,1
1616,19715,bGUkoSiHaU85ol0k2itTO3o20n3CqprE,fbPkOYLVPtPgIt0MxizjfFJov3JbHyAi,6,3,2,0,2,0,1,0,8,1.1428571428571428,1,0.0,0,2,0,2,3,0,0,1,0,4,4,1
1617,19719,gl2YVlebVAvCcxsYaIoTwLj5l1IGqntH,fbPkOYLVPtPgIt0MxizjfFJov3JbHyAi,10,12,7,0,3,3,6,1,32,4.571428571428571,3,0.0,1,7,0,3,11,3,0,6,1,11,21,1
1618,19720,VgTzrg40YN89iMQMYp8DL2dsBQiMtIfa,fbPkOYLVPtPgIt0MxizjfFJov3JbHyAi,1,0,0,0,0,0,1,0,1,0.14285714285714285,1,0.0,0,0,0,0,0,0,0,1,0,0,1,1
1619,19721,cAjVoc8wOYDE8lScDAhEgvHdzkmg6Oh2,fbPkOYLVPtPgIt0MxizjfFJov3JbHyAi,10,11,8,0,3,0,11,0,33,4.714285714285714,3,0.0,0,8,0,3,11,0,0,11,0,11,22,1
1620,19722,YchS7FPUUCrsbeC0RlrXHuAg4O0pgdnY,fbPkOYLVPtPgIt0MxizjfFJov3JbHyAi,7,14,9,0,5,0,4,0,32,4.571428571428571,4,0.0,0,9,0,5,14,0,0,4,0,14,18,1
1621,19723,jWMVSdUkBIApMFEIB4X88BTUfxnffWAx,fbPkOYLVPtPgIt0MxizjfFJov3JbHyAi,31,42,33,3,26,0,10,0,114,16.285714285714285,4,0.0,1,33,2,26,41,0,1,10,0,62,52,1
1622,19726,LhzU5apxkgFguqzaBs2la7gJhoIHnun9,fbPkOYLVPtPgIt0MxizjfFJov3JbHyAi,5,2,1,0,1,0,7,0,11,1.5714285714285714,3,0.0,0,1,0,1,2,0,0,7,0,2,9,1
1623,19730,nIvIddlMAmTQagaACOulbZ6PInxlyOy2,fbPkOYLVPtPgIt0MxizjfFJov3JbHyAi,43,53,24,38,20,0,5,1,141,20.142857142857142,3,0.0,23,24,37,20,30,0,1,5,1,104,37,0
1624,19731,RLvJ5u6m28hhUO44ztK3P01H4ZTIxGoD,fbPkOYLVPtPgIt0MxizjfFJov3JbHyAi,6,8,3,0,3,0,2,0,16,2.2857142857142856,2,0.0,2,3,0,3,6,0,0,2,0,8,8,1
1625,19732,z0Q6ONK9gZ6rOpbD6TitX6FkYPuixcug,fbPkOYLVPtPgIt0MxizjfFJov3JbHyAi,41,119,39,31,17,30,23,4,263,37.57142857142857,8,0.0,26,39,26,17,93,30,5,23,4,108,155,1
1626,19733,D83ozkIhUBEzx10ZBkDPuuGHLXGFtU0D,fbPkOYLVPtPgIt0MxizjfFJov3JbHyAi,1,0,0,0,0,0,1,0,1,0.14285714285714285,1,0.0,0,0,0,0,0,0,0,1,0,0,1,1
1627,19735,KcSCnS83JgHtWEXfmBorkn1UBZpKO1nN,fbPkOYLVPtPgIt0MxizjfFJov3JbHyAi,2,0,0,0,0,0,2,0,2,0.2857142857142857,1,0.0,0,0,0,0,0,0,0,2,0,0,2,1
1628,19738,Bt0YrpvyveynQfxqkzppqbivsu9tYRaK,fbPkOYLVPtPgIt0MxizjfFJov3JbHyAi,12,7,6,0,5,0,1,0,19,2.7142857142857144,1,0.0,0,6,0,5,7,0,0,1,0,11,8,0
1629,19742,c2xUxg7vuhPItQZr96ojei2FNm4xg1X0,fbPkOYLVPtPgIt0MxizjfFJov3JbHyAi,44,73,31,18,31,38,16,2,209,29.857142857142858,6,0.0,33,31,18,31,40,38,0,16,2,113,96,1
1630,19743,EUZk7LUBeSnU7Li4WmLt7uKxhlLiKOYq,fbPkOYLVPtPgIt0MxizjfFJov3JbHyAi,11,29,14,0,6,0,15,1,65,9.285714285714286,2,0.0,0,14,0,6,29,0,0,15,1,20,45,1
1631,19744,k2JSp3bkSnFCXfzGP6sNaxUIyLpM06TA,fbPkOYLVPtPgIt0MxizjfFJov3JbHyAi,1,0,0,0,0,0,1,0,1,0.14285714285714285,1,0.0,0,0,0,0,0,0,0,1,0,0,1,1
1632,19745,Y5j2JtsMt3y0lrKil9FIBv8kmvrOLA4X,fbPkOYLVPtPgIt0MxizjfFJov3JbHyAi,7,5,3,0,2,0,4,0,14,2.0,1,0.0,0,3,0,2,5,0,0,4,0,5,9,1
1633,19746,teqJGecOr4a6oVYU1O9bgvPkX5ZSKA8N,fbPkOYLVPtPgIt0MxizjfFJov3JbHyAi,5,2,1,0,1,0,4,0,8,1.1428571428571428,1,0.0,0,1,0,1,2,0,0,4,0,2,6,1
1634,19748,P9CRp0z2n5HfPA3EY25pk86UB1hpP0VE,fbPkOYLVPtPgIt0MxizjfFJov3JbHyAi,5,7,4,0,0,1,6,0,18,2.5714285714285716,2,0.0,0,4,0,0,7,1,0,6,0,4,14,1
1635,19752,97yjJniO9qlZAjgn3gm4HXnkbwnHzt9O,fbPkOYLVPtPgIt0MxizjfFJov3JbHyAi,1,0,0,0,0,0,1,0,1,0.14285714285714285,1,0.0,0,0,0,0,0,0,0,1,0,0,1,1
1636,19753,4xhrCYKdzHUQrqW9iIr0KOeWujKeYIus,fbPkOYLVPtPgIt0MxizjfFJov3JbHyAi,6,7,1,0,1,0,7,0,16,2.2857142857142856,2,0.0,0,1,0,1,7,0,0,7,0,2,14,1
1637,19754,6K3h9aDeHI9AUqOKTvZxzGkKh6WMc7A3,fbPkOYLVPtPgIt0MxizjfFJov3JbHyAi,7,3,2,0,2,0,2,0,9,1.2857142857142858,1,0.0,0,2,0,2,3,0,0,2,0,4,5,1
1638,19757,hbUthRcRktel8CTk5FJE2GFw0tsGaPJX,fbPkOYLVPtPgIt0MxizjfFJov3JbHyAi,9,4,3,0,3,0,4,0,14,2.0,3,0.0,0,3,0,3,4,0,0,4,0,6,8,1
1639,19758,ipOqQyQpg3SQQaHklGxEISyDZxdmtba9,fbPkOYLVPtPgIt0MxizjfFJov3JbHyAi,3,0,0,0,0,0,5,0,5,0.7142857142857143,1,0.0,0,0,0,0,0,0,0,5,0,0,5,1
1640,19759,K2Gev6RW8VKqmC4C4H0XJFrGZeT1JyyW,fbPkOYLVPtPgIt0MxizjfFJov3JbHyAi,9,3,2,0,2,0,4,1,12,1.7142857142857142,1,0.0,0,2,0,2,3,0,0,4,1,4,8,1
1641,19762,haOtWLq8R5iBRxrylu7qsQb4IXuRIQaN,fbPkOYLVPtPgIt0MxizjfFJov3JbHyAi,20,40,19,24,0,3,11,3,100,14.285714285714286,3,0.0,14,19,22,0,26,3,2,11,3,55,45,1
1642,19763,E3VAWhRWNv6BjTckpQB4VpqgHIOmEPoD,fbPkOYLVPtPgIt0MxizjfFJov3JbHyAi,7,3,2,0,2,0,2,0,9,1.2857142857142858,1,0.0,0,2,0,2,3,0,0,2,0,4,5,1
1643,19766,02KikDpeL3BkT1uIl0J4sjaa91Wls8ih,fbPkOYLVPtPgIt0MxizjfFJov3JbHyAi,14,8,5,5,5,0,5,0,28,4.0,1,0.0,3,5,4,5,5,0,1,5,0,17,11,1
1644,19767,GKKNtfrAHKD2xUEQBz7HLN3kKO9SrWyD,fbPkOYLVPtPgIt0MxizjfFJov3JbHyAi,29,77,41,15,9,21,39,6,208,29.714285714285715,8,0.0,17,41,11,9,60,21,4,39,6,78,130,1
1645,19768,Why02UcIH8ZdjwIJwPOElrNVNSec4in6,fbPkOYLVPtPgIt0MxizjfFJov3JbHyAi,9,8,4,0,4,0,4,0,20,2.857142857142857,1,0.0,2,4,0,4,6,0,0,4,0,10,10,1
1646,19769,bgBhXSh8X6pD8mAGuk3zRCZBNqTSqnHJ,fbPkOYLVPtPgIt0MxizjfFJov3JbHyAi,13,30,17,8,13,8,5,0,81,11.571428571428571,4,0.0,8,17,6,13,22,8,2,5,0,44,37,1
1647,19771,9lFnGVb4ngjyCBpAPFF4Py9FZpYTRwoJ,fbPkOYLVPtPgIt0MxizjfFJov3JbHyAi,5,2,1,0,1,0,2,0,6,0.8571428571428571,1,0.0,0,1,0,1,2,0,0,2,0,2,4,1
1648,19776,CfeENerIdAGepleePWSt0SV88ctt0Tmw,fbPkOYLVPtPgIt0MxizjfFJov3JbHyAi,29,26,16,0,13,0,7,0,62,8.857142857142858,5,0.0,1,16,0,13,25,0,0,7,0,30,32,1
1649,19777,yUDnZwj7Yxaj86CQGKHCPnaBfq9O3vcc,fbPkOYLVPtPgIt0MxizjfFJov3JbHyAi,5,2,1,0,1,0,3,0,7,1.0,2,0.0,0,1,0,1,2,0,0,3,0,2,5,1
1650,19779,0nqj6iIWmYxLKHezCs5xwlB8hzJ9Rg2d,fbPkOYLVPtPgIt0MxizjfFJov3JbHyAi,5,5,2,0,1,0,1,0,9,1.2857142857142858,1,0.0,0,2,0,1,5,0,0,1,0,3,6,1
1651,19780,nG5SIna2Yr2MumgRI14CLkOHNh2U0rkm,fbPkOYLVPtPgIt0MxizjfFJov3JbHyAi,7,4,2,0,1,0,3,0,10,1.4285714285714286,1,0.0,0,2,0,1,4,0,0,3,0,3,7,1
1652,19781,Jv08t8fpcawyaZCw9f0bMJgjS8SuUKfb,fbPkOYLVPtPgIt0MxizjfFJov3JbHyAi,6,5,3,0,1,0,4,0,13,1.8571428571428572,2,0.0,0,3,0,1,5,0,0,4,0,4,9,1
1653,19782,UstweopmwuJ2fqnPYowNY0vr3lDWnNEA,fbPkOYLVPtPgIt0MxizjfFJov3JbHyAi,16,24,15,0,10,2,22,1,74,10.571428571428571,3,0.0,2,15,0,10,22,2,0,22,1,27,47,1
1654,19783,LzhmzME7EkyHXpFVu0EENS6JHqvsJLtH,fbPkOYLVPtPgIt0MxizjfFJov3JbHyAi,28,57,28,16,22,9,9,0,141,20.142857142857142,3,0.0,21,28,14,22,36,9,2,9,0,85,56,1
1655,19785,UhCNSbJxDa9CkR9faEu7q44yTurX7YJH,fbPkOYLVPtPgIt0MxizjfFJov3JbHyAi,5,2,1,0,1,0,3,0,7,1.0,1,0.0,0,1,0,1,2,0,0,3,0,2,5,1
1656,19788,gfuRBmlPKlXNn3u69OCkIXEsqvf1vpRo,fbPkOYLVPtPgIt0MxizjfFJov3JbHyAi,11,8,6,0,6,0,2,0,22,3.142857142857143,3,0.0,0,6,0,6,8,0,0,2,0,12,10,1
1657,19789,Ao05SPEEQv1WpXaKhWVTBjeRlniH33AQ,fbPkOYLVPtPgIt0MxizjfFJov3JbHyAi,9,10,2,2,3,0,3,1,21,3.0,1,0.0,2,2,2,3,8,0,0,3,1,9,12,1
1658,19790,9v5FBlkT08VgqPArpwPYDVOHzgkK8DmA,fbPkOYLVPtPgIt0MxizjfFJov3JbHyAi,12,25,11,4,6,6,10,0,62,8.857142857142858,5,0.0,3,11,4,6,22,6,0,10,0,24,38,1
1659,19791,GAIOcbnQvA9qhvhMc6r6zhVuhoFpfQD2,fbPkOYLVPtPgIt0MxizjfFJov3JbHyAi,4,2,0,0,0,0,2,0,4,0.5714285714285714,1,0.0,0,0,0,0,2,0,0,2,0,0,4,1
1660,19793,NiwhcToNaizZtNhA7c6Q1ZKoUp33LASc,fbPkOYLVPtPgIt0MxizjfFJov3JbHyAi,16,28,13,7,9,1,10,0,68,9.714285714285714,4,0.0,7,13,7,9,21,1,0,10,0,36,32,1
1661,19794,i2J6g1YHP6evnvsQatEoUV6Lz662N8Pt,fbPkOYLVPtPgIt0MxizjfFJov3JbHyAi,24,61,14,15,8,6,12,0,116,16.571428571428573,5,0.0,10,14,11,8,51,6,4,12,0,43,73,1
1662,19795,AtTEb2VyFEMuCpu9E7TOV4gAVRLFEpvg,fbPkOYLVPtPgIt0MxizjfFJov3JbHyAi,3,0,0,0,0,4,4,0,8,1.1428571428571428,1,0.0,0,0,0,0,0,4,0,4,0,0,8,1
1663,19798,ghh1dIrprkTKfllDMPy4cIkYxENWN3hG,fbPkOYLVPtPgIt0MxizjfFJov3JbHyAi,9,10,5,7,6,0,1,0,29,4.142857142857143,1,0.0,4,5,5,6,6,0,2,1,0,20,9,1
1664,19799,HmPFRf4HaEfqanP8jptbixb101SDWsz7,fbPkOYLVPtPgIt0MxizjfFJov3JbHyAi,1,0,0,0,0,0,1,0,1,0.14285714285714285,1,0.0,0,0,0,0,0,0,0,1,0,0,1,1
1665,19800,qmuiZWmGa2h5jyuvdl0AMpjDHyWxmqus,fbPkOYLVPtPgIt0MxizjfFJov3JbHyAi,6,3,2,0,2,13,1,0,21,3.0,1,0.0,0,2,0,2,3,13,0,1,0,4,17,1
1666,19803,DAe94MkHTdcPmdhTmwEa78RpI8unH7VU,fbPkOYLVPtPgIt0MxizjfFJov3JbHyAi,1,0,0,0,0,0,1,0,1,0.14285714285714285,1,0.0,0,0,0,0,0,0,0,1,0,0,1,1
1667,19814,lxHUxupmVUuN6U299GOAnBvW4C4Ubp0H,fbPkOYLVPtPgIt0MxizjfFJov3JbHyAi,6,3,1,0,1,0,3,0,8,1.1428571428571428,2,0.0,0,1,0,1,3,0,0,3,0,2,6,1
1668,19829,XQUx3MwVudtjeHmsju8PhHxsdXW0kluK,fbPkOYLVPtPgIt0MxizjfFJov3JbHyAi,12,16,5,4,7,0,5,0,37,5.285714285714286,1,0.0,9,5,4,7,7,0,0,5,0,25,12,1
1669,19842,bKIU4h5S6pxVBBvQYicGGZljVmGThQTZ,fbPkOYLVPtPgIt0MxizjfFJov3JbHyAi,14,41,14,10,17,7,21,6,116,16.571428571428573,5,0.0,16,14,6,17,25,7,4,21,6,53,63,1
1670,19852,4qaBwsaC0pfXg0219Ny01dop8gTlFMu6,fbPkOYLVPtPgIt0MxizjfFJov3JbHyAi,5,2,1,0,1,0,2,0,6,0.8571428571428571,1,0.0,0,1,0,1,2,0,0,2,0,2,4,1
1671,19855,hr3tXA8jmCXsxdUFfi43JuiRTUpoDlMt,fbPkOYLVPtPgIt0MxizjfFJov3JbHyAi,1,0,0,0,0,0,1,0,1,0.14285714285714285,1,0.0,0,0,0,0,0,0,0,1,0,0,1,0
1672,19857,oB66Su2y0fKCmlftIiys81THD7pT5Kwq,fbPkOYLVPtPgIt0MxizjfFJov3JbHyAi,4,2,1,0,1,0,1,0,5,0.7142857142857143,1,0.0,0,1,0,1,2,0,0,1,0,2,3,1
1673,19861,kMADhIGduPqSkYFwoAlaAOq4Z3kg8su8,fbPkOYLVPtPgIt0MxizjfFJov3JbHyAi,10,11,8,0,5,0,5,0,29,4.142857142857143,2,0.0,0,8,0,5,11,0,0,5,0,13,16,0
1674,19866,BOBLP6pTmRtpQ8LtVgJyutFMDL3q6xno,fbPkOYLVPtPgIt0MxizjfFJov3JbHyAi,29,40,21,16,15,9,8,1,110,15.714285714285714,6,0.0,14,21,14,15,26,9,2,8,1,64,46,0
1675,19872,foOeNx7QB7iDsgeA0D657sokODh0QEAw,fbPkOYLVPtPgIt0MxizjfFJov3JbHyAi,8,7,2,0,2,0,3,0,14,2.0,2,0.0,0,2,0,2,7,0,0,3,0,4,10,1
1676,19879,1foSXZwCCr5lR9Aws6pCnQ1ZUbu5TIHp,fbPkOYLVPtPgIt0MxizjfFJov3JbHyAi,4,3,1,0,1,0,1,0,6,0.8571428571428571,1,0.0,0,1,0,1,3,0,0,1,0,2,4,0
1677,19884,NqKjMSY6eOZQ1uSyzlPrquJVqzjvSO7O,fbPkOYLVPtPgIt0MxizjfFJov3JbHyAi,34,66,42,2,35,19,11,1,176,25.142857142857142,5,0.0,10,42,2,35,56,19,0,11,1,89,87,1
1678,19893,NAeglY8cYFpzQKpSfjAgfrtdD2qzmpB5,fbPkOYLVPtPgIt0MxizjfFJov3JbHyAi,25,44,11,0,8,50,17,0,130,18.571428571428573,5,0.0,3,11,0,8,41,50,0,17,0,22,108,0
1679,19926,1InE8cdjhx7tJRBfUjLOpNXVGiOXTrtd,fbPkOYLVPtPgIt0MxizjfFJov3JbHyAi,5,11,0,0,0,6,6,0,23,3.2857142857142856,2,0.0,0,0,0,0,11,6,0,6,0,0,23,1
1680,19933,wnXrCFQnu5K77E0TUKHPXLbEZiXu32Gt,fbPkOYLVPtPgIt0MxizjfFJov3JbHyAi,5,2,1,0,1,0,3,0,7,1.0,1,0.0,0,1,0,1,2,0,0,3,0,2,5,1
1681,19934,GyWTABuPpZEqO585EnNTIpM2B2faPYN3,fbPkOYLVPtPgIt0MxizjfFJov3JbHyAi,10,6,4,0,3,0,3,0,16,2.2857142857142856,3,0.0,0,4,0,3,6,0,0,3,0,7,9,1
1682,19935,wEajQeQse5CzhcFd5XXOtEsUUddZZAU5,fbPkOYLVPtPgIt0MxizjfFJov3JbHyAi,4,3,2,0,2,0,2,0,9,1.2857142857142858,2,0.0,0,2,0,2,3,0,0,2,0,4,5,0
1683,19936,viuKt4GgrX0rYL5EpHoxJbsiC9TblSuk,fbPkOYLVPtPgIt0MxizjfFJov3JbHyAi,28,92,54,1,30,60,37,0,274,39.142857142857146,8,0.0,12,54,1,30,80,60,0,37,0,97,177,0
1684,19942,je9A6l6tP7wnbFhNJD7vbbHTYhqshuqB,fbPkOYLVPtPgIt0MxizjfFJov3JbHyAi,28,73,29,16,17,13,19,1,168,24.0,5,0.0,16,29,11,17,57,13,5,19,1,73,95,1
1685,19949,lulY8D00ct0beDGYE4CRU9KsINnQRaV8,fbPkOYLVPtPgIt0MxizjfFJov3JbHyAi,12,20,10,0,3,0,6,1,40,5.714285714285714,2,0.0,1,10,0,3,19,0,0,6,1,14,26,0
1686,19955,Y7REnesylqzkGeCcXJqxiJ4B25LlDJnj,fbPkOYLVPtPgIt0MxizjfFJov3JbHyAi,1,0,0,0,0,0,2,0,2,0.2857142857142857,1,0.0,0,0,0,0,0,0,0,2,0,0,2,1
1687,21459,NH0hsgo5xcqAdosarQoW4RQUZxH32Gzl,7GRhBDsirIGkRZBtSMEzNTyDr2JQm4xx,44,93,43,63,25,2,13,0,239,34.142857142857146,4,0.0,30,43,58,25,63,2,5,13,0,156,83,0
1688,21468,Hj6wuu6IJzCenxWAs1sLyWNMm32YIpDq,7GRhBDsirIGkRZBtSMEzNTyDr2JQm4xx,26,81,42,33,17,15,18,0,206,29.428571428571427,5,0.0,13,42,27,17,68,15,6,18,0,99,107,0
1689,21473,fd2e5NJVnyVwHFHuiTOOM639ZY1uThtn,7GRhBDsirIGkRZBtSMEzNTyDr2JQm4xx,63,199,55,92,35,46,27,2,456,65.14285714285714,7,0.0,117,55,74,35,82,46,18,27,2,281,175,1
1690,21485,l3mz2aAslwaCLhkdMrM7sQ5OXLzl6A2r,7GRhBDsirIGkRZBtSMEzNTyDr2JQm4xx,49,78,5,123,16,11,14,1,248,35.42857142857143,3,0.0,42,5,112,16,36,11,11,14,1,175,73,0
1691,21496,z6p7uYa25VIrmVARFxz5koBofuqHB2cM,7GRhBDsirIGkRZBtSMEzNTyDr2JQm4xx,2,0,0,0,0,0,2,0,2,0.2857142857142857,1,0.0,0,0,0,0,0,0,0,2,0,0,2,0
1692,21497,NToJOpRtq67cszdyzl1RlLKqGwS5lZl5,7GRhBDsirIGkRZBtSMEzNTyDr2JQm4xx,30,34,8,62,11,0,4,0,119,17.0,2,0.0,23,8,52,11,11,0,10,4,0,94,25,1
1693,21514,ZhTCqX8GMUcn0a0betuEauHNuCk1aRhm,7GRhBDsirIGkRZBtSMEzNTyDr2JQm4xx,55,71,29,72,13,71,22,0,278,39.714285714285715,5,0.0,25,29,66,13,46,71,6,22,0,133,145,0
1694,21518,j5n34dhJSAsFAv6KAw4rsAZTfhL07lCD,7GRhBDsirIGkRZBtSMEzNTyDr2JQm4xx,2,0,0,0,0,0,2,0,2,0.2857142857142857,1,0.0,0,0,0,0,0,0,0,2,0,0,2,1
1695,21524,6Ysh3EXeoiNCd1uXxsjEQronkryNKRU5,7GRhBDsirIGkRZBtSMEzNTyDr2JQm4xx,43,113,53,58,19,5,21,0,269,38.42857142857143,4,0.0,37,53,49,19,76,5,9,21,0,158,111,1
1696,21529,Lf0mThPYOrtlCzgRGBCVTPy1hiGUII8h,7GRhBDsirIGkRZBtSMEzNTyDr2JQm4xx,45,344,109,81,24,70,58,17,703,100.42857142857143,9,0.0,188,109,56,24,156,70,25,58,17,377,326,0
1697,21531,GvY4Z1NOjK4oYpeBStbrl7zpe2zlFqoT,7GRhBDsirIGkRZBtSMEzNTyDr2JQm4xx,44,82,33,80,24,4,6,0,229,32.714285714285715,4,0.0,38,33,66,24,44,4,14,6,0,161,68,0
1698,21545,be7952wawx5BhhJ4vIqX6Vxi48lNKbM1,7GRhBDsirIGkRZBtSMEzNTyDr2JQm4xx,5,10,7,0,6,2,5,0,30,4.285714285714286,6,0.0,0,7,0,6,10,2,0,5,0,13,17,1
1699,21558,dQBjOw3ZDQ2EPHOdT4W6pRAoF6sniGIc,7GRhBDsirIGkRZBtSMEzNTyDr2JQm4xx,42,63,30,65,17,6,25,1,207,29.571428571428573,4,0.0,27,30,58,17,36,6,7,25,1,132,75,1
1700,21561,OaI9ma7KxaY6DFxSwgYhrXCPXva2T3pp,7GRhBDsirIGkRZBtSMEzNTyDr2JQm4xx,4,5,1,0,0,1,5,0,12,1.7142857142857142,1,0.0,0,1,0,0,5,1,0,5,0,1,11,0
1701,21570,y9BxmAhm0ieCF6b0HaF7gMrGu5BDtZs5,7GRhBDsirIGkRZBtSMEzNTyDr2JQm4xx,60,223,91,99,66,2,46,0,527,75.28571428571429,4,0.0,112,91,81,66,111,2,18,46,0,350,177,0
1702,21618,TzODuX5kuf2iqGNG9vk0uMzeGNqx5LsA,7GRhBDsirIGkRZBtSMEzNTyDr2JQm4xx,4,2,0,0,0,0,2,0,4,0.5714285714285714,1,0.0,0,0,0,0,2,0,0,2,0,0,4,0
1703,21638,mwc0YjZS72xD4dO6Zk7KmFewdh7PWkAS,7GRhBDsirIGkRZBtSMEzNTyDr2JQm4xx,54,139,39,77,40,9,10,0,314,44.857142857142854,8,0.0,88,39,74,40,51,9,3,10,0,241,73,0
1704,21659,D5mwgoAPtfwdsFrdNADBqEJQSy8E0CUi,7GRhBDsirIGkRZBtSMEzNTyDr2JQm4xx,69,144,72,99,34,22,68,2,441,63.0,10,0.0,40,72,92,34,104,22,7,68,2,238,203,0
1705,21672,c9jABEJQla4i8vH29nKPFM4cx5bWdrLS,7GRhBDsirIGkRZBtSMEzNTyDr2JQm4xx,10,8,2,0,1,0,10,1,22,3.142857142857143,2,0.0,0,2,0,1,8,0,0,10,1,3,19,0
1706,21690,mezQjcBtwPIB1SXkjHJo9kxjc5UIXdOH,7GRhBDsirIGkRZBtSMEzNTyDr2JQm4xx,29,45,20,36,18,0,3,0,122,17.428571428571427,2,0.0,21,20,30,18,24,0,6,3,0,89,33,1
1707,21692,rf43ZHojMqXQ775bmX3nnHgQ62d9XvGK,7GRhBDsirIGkRZBtSMEzNTyDr2JQm4xx,9,7,2,11,2,0,12,0,34,4.857142857142857,5,0.0,2,2,9,2,5,0,2,12,0,15,19,1
1708,21708,aU6SEeOgxLKetBRDwfHMDunWavvfr54M,7GRhBDsirIGkRZBtSMEzNTyDr2JQm4xx,28,73,2,36,3,5,12,0,131,18.714285714285715,5,0.0,28,2,32,3,45,5,4,12,0,65,66,0
1709,21816,5M2ejSoYrgCHrezYAGX7ObuTLuLA6uzQ,7GRhBDsirIGkRZBtSMEzNTyDr2JQm4xx,4,2,1,0,1,0,1,0,5,0.7142857142857143,1,0.0,0,1,0,1,2,0,0,1,0,2,3,1
1710,21820,GGGVxWw7kUcQH8IveSqLixfu0u0FTfvz,7GRhBDsirIGkRZBtSMEzNTyDr2JQm4xx,6,2,0,0,0,1,6,0,9,1.2857142857142858,1,0.0,0,0,0,0,2,1,0,6,0,0,9,1
1711,21870,3OGm4X1PEnAaZoBoZXt04kXOR4TFtoHS,7GRhBDsirIGkRZBtSMEzNTyDr2JQm4xx,9,5,2,11,3,1,3,0,25,3.5714285714285716,1,0.0,3,2,10,3,2,1,1,3,0,18,7,1
1712,21922,UyrB62TC80PvjIx5mHAqyBQJHo9hnImU,7GRhBDsirIGkRZBtSMEzNTyDr2JQm4xx,2,0,0,0,0,0,3,0,3,0.42857142857142855,1,0.0,0,0,0,0,0,0,0,3,0,0,3,1
1713,21976,MYCZGZUUB6h2kR5SWwXC3erQhe8wj439,7GRhBDsirIGkRZBtSMEzNTyDr2JQm4xx,29,48,22,30,11,14,12,0,137,19.571428571428573,6,0.0,17,22,30,11,31,14,0,12,0,80,57,0
1714,21999,r6bvKJ2a2G72TbQZE3LacWwmKi7rGXEx,7GRhBDsirIGkRZBtSMEzNTyDr2JQm4xx,30,78,24,31,9,19,18,3,182,26.0,3,0.0,34,24,28,9,44,19,3,18,3,95,87,1
1715,22022,wXFfHtwd9smrvhh9NQW7SmEEo1001LDW,7GRhBDsirIGkRZBtSMEzNTyDr2JQm4xx,35,39,16,36,12,11,8,1,123,17.571428571428573,3,0.0,18,16,31,12,21,11,5,8,1,77,46,1
1716,22062,MuwljKZkWjKmChDtxaHsKSqu30ykavpg,7GRhBDsirIGkRZBtSMEzNTyDr2JQm4xx,48,128,39,44,19,3,10,2,245,35.0,5,0.0,52,39,41,19,76,3,3,10,2,151,94,0
1717,22212,ezzV2inIlk654APZ7lOJdt6ubCpUxMCa,7GRhBDsirIGkRZBtSMEzNTyDr2JQm4xx,62,155,25,124,25,123,28,4,484,69.14285714285714,8,0.0,69,25,102,25,86,123,22,28,4,221,263,0
1718,22268,tixL6jRbFRYTnAeCUMfXKIdV2z5MfmCZ,7GRhBDsirIGkRZBtSMEzNTyDr2JQm4xx,32,23,20,14,14,0,9,0,80,11.428571428571429,1,0.0,1,20,11,14,22,0,3,9,0,46,34,1
1719,22640,SXQudUQxotVyHX3jIj58IdonMUWj4z4L,RXDvfPUBYFlVdlueBFbLW0mhhAyGEqpt,17,17,11,0,2,0,5,0,35,5.0,3,0.0,0,11,0,2,17,0,0,5,0,13,22,0
1720,22647,ytmo5vQStkDdkr7G8Cx66kM5tANiVYa8,G8EPVSXsOYB5YQWZGiz1aVq5Pgr2GrQu,20,28,19,0,13,0,8,0,68,9.714285714285714,4,0.0,4,19,0,13,24,0,0,8,0,36,32,1
1721,22651,bPMM8JJVMbo3dHwzrkYwNanOXVlVjIZM,SpATywNh6bZuzm8s1ceuBUnMUAeoAHHw,19,35,29,0,23,0,5,0,92,13.142857142857142,7,0.0,2,29,0,23,33,0,0,5,0,54,38,0
1722,22655,DVzw8nYpE4lnf8MkHHhtHMESTcnd5SSm,A3fsA9Zfv1X2fVEQhTw51lKENdNrEqT3,7,3,2,0,2,0,4,0,11,1.5714285714285714,2,0.0,0,2,0,2,3,0,0,4,0,4,7,1
1723,22656,6r68uLeYBa0U5j97XGrLINpoFwwpiU0a,SpATywNh6bZuzm8s1ceuBUnMUAeoAHHw,23,86,7,5,4,1,14,0,117,16.714285714285715,7,0.0,15,7,5,4,71,1,0,14,0,31,86,0
1724,22658,3SER276qaao5TSZqnt0y9TkdmkGTUUcO,A3fsA9Zfv1X2fVEQhTw51lKENdNrEqT3,42,17,14,62,12,0,3,0,108,15.428571428571429,2,0.0,1,14,54,12,16,0,8,3,0,81,27,1
1725,22661,zgbCsvFYb3b53axsu4K7VNjBEGD1Bru2,G8EPVSXsOYB5YQWZGiz1aVq5Pgr2GrQu,30,94,3,26,3,49,19,3,197,28.142857142857142,2,0.0,12,3,22,3,82,49,4,19,3,40,157,1
1726,22663,v8EL49Rw5uIBfTnluJIiynUhJSONuHZw,A3fsA9Zfv1X2fVEQhTw51lKENdNrEqT3,24,7,2,38,0,0,1,0,48,6.857142857142857,2,0.0,2,2,38,0,5,0,0,1,0,42,6,1
1727,22666,8NZmD5KXyLIfbrDZRanIJvBfumgIsUhW,SpATywNh6bZuzm8s1ceuBUnMUAeoAHHw,10,19,6,8,1,0,4,0,38,5.428571428571429,3,0.0,7,6,7,1,12,0,1,4,0,21,17,0
1728,22672,xtQFPkqe4Pp8hbaCpifaLA8aJ90k2oDs,SpATywNh6bZuzm8s1ceuBUnMUAeoAHHw,20,67,1,12,2,0,4,0,86,12.285714285714286,4,0.0,22,1,9,2,45,0,3,4,0,34,52,0
1729,22675,FZWt1vapJFvo3kXFvlr3Pcq5dqSsXIdl,A3fsA9Zfv1X2fVEQhTw51lKENdNrEqT3,18,19,13,0,7,0,10,0,49,7.0,2,0.0,0,13,0,7,19,0,0,10,0,20,29,1
1730,22688,6aazLDsf7EAZ2t5BIjBNI9Ug5zAk9J2O,SpATywNh6bZuzm8s1ceuBUnMUAeoAHHw,29,29,15,20,6,5,7,0,82,11.714285714285714,2,0.0,4,15,18,6,25,5,2,7,0,43,39,0
1731,22699,f7tZxTkA0B7yOxMWeydGO2hW0y86mAhD,A3fsA9Zfv1X2fVEQhTw51lKENdNrEqT3,57,79,1,90,0,6,12,1,189,27.0,5,0.0,7,1,89,0,72,6,1,12,1,97,92,0
1732,22705,JoQg2qlyTB6aPyv163qnZSLUAy3J9zXZ,bWdj2GDclj5ofokWjzoa5jAwMkxCykd6,9,12,5,6,4,0,2,0,29,4.142857142857143,2,0.0,5,5,6,4,7,0,0,2,0,20,9,1
1733,22706,JoQg2qlyTB6aPyv163qnZSLUAy3J9zXZ,A3fsA9Zfv1X2fVEQhTw51lKENdNrEqT3,6,6,3,0,0,0,3,0,12,1.7142857142857142,3,0.0,0,3,0,0,6,0,0,3,0,3,9,1
1734,22711,TPPsOieQBcwqH8dqABTR3mddQ5gDzlZO,SpATywNh6bZuzm8s1ceuBUnMUAeoAHHw,27,34,14,41,8,0,9,0,106,15.142857142857142,2,0.0,18,14,35,8,16,0,6,9,0,75,31,0
1735,22720,4iz2t15J5bzEPElZVcStT3H8hpTNKJIQ,SpATywNh6bZuzm8s1ceuBUnMUAeoAHHw,13,19,7,14,0,2,3,0,45,6.428571428571429,2,0.0,7,7,12,0,12,2,2,3,0,26,19,0
1736,22733,IQ4ladQoM2x2909mlbY9xWKwXIcK6uEd,A3fsA9Zfv1X2fVEQhTw51lKENdNrEqT3,43,20,17,60,13,1,20,1,132,18.857142857142858,3,0.0,2,17,55,13,18,1,5,20,1,87,45,0
1737,22737,Os09VRrdiO6C7gqaf1B7u0gzmL7FIPJg,SpATywNh6bZuzm8s1ceuBUnMUAeoAHHw,19,75,17,31,0,17,11,1,152,21.714285714285715,3,0.0,54,17,27,0,21,17,4,11,1,98,54,1
1738,22760,xQ0oPcnoBqnptb23qNnWO05KL2jCqFC5,SpATywNh6bZuzm8s1ceuBUnMUAeoAHHw,3,3,0,0,0,1,5,0,9,1.2857142857142858,3,0.0,0,0,0,0,3,1,0,5,0,0,9,1
1739,22779,Di3I8NyVIkGc06HLMDBeTqdX1iL5ZolI,A3fsA9Zfv1X2fVEQhTw51lKENdNrEqT3,6,0,0,0,0,4,12,0,16,2.2857142857142856,1,0.0,0,0,0,0,0,4,0,12,0,0,16,1
1740,22786,6TmTcNQyMYVAXbtK6HsQ96Mn7OGENU3z,bWdj2GDclj5ofokWjzoa5jAwMkxCykd6,4,2,1,0,0,0,2,0,5,0.7142857142857143,1,0.0,0,1,0,0,2,0,0,2,0,1,4,1
1741,22796,NEe9TsP56Xype0U6CLfwX8CaejtfAtDd,SpATywNh6bZuzm8s1ceuBUnMUAeoAHHw,17,46,2,21,0,2,16,1,88,12.571428571428571,2,0.0,20,2,18,0,26,2,3,16,1,40,48,0
1742,22805,6TmTcNQyMYVAXbtK6HsQ96Mn7OGENU3z,A3fsA9Zfv1X2fVEQhTw51lKENdNrEqT3,7,6,1,0,1,0,1,0,9,1.2857142857142858,1,0.0,0,1,0,1,6,0,0,1,0,2,7,1
1743,22822,jt6cAnJpqYCiS3Lj5wNBvifs8WZJznlF,A3fsA9Zfv1X2fVEQhTw51lKENdNrEqT3,9,4,3,0,3,0,3,0,13,1.8571428571428572,1,0.0,0,3,0,3,4,0,0,3,0,6,7,1
1744,22825,pgtfwPx3gBWk0s41FLIY8xNKvQvpnNYF,SpATywNh6bZuzm8s1ceuBUnMUAeoAHHw,25,41,1,25,2,9,13,1,92,13.142857142857142,1,0.0,12,1,19,2,29,9,6,13,1,34,58,0
1745,22828,pgtfwPx3gBWk0s41FLIY8xNKvQvpnNYF,A3fsA9Zfv1X2fVEQhTw51lKENdNrEqT3,10,5,1,0,1,2,10,2,21,3.0,3,0.0,0,1,0,1,5,2,0,10,2,2,19,1
1746,22844,TQIRy5vD7Rgv73APMCqQZ7AssMVX3u4N,A3fsA9Zfv1X2fVEQhTw51lKENdNrEqT3,22,12,10,0,8,0,5,0,35,5.0,3,0.0,0,10,0,8,12,0,0,5,0,18,17,1
1747,22847,uKSoXEJNhPBaLwogtj5AI2INbh67Hhkx,G8EPVSXsOYB5YQWZGiz1aVq5Pgr2GrQu,7,9,0,0,1,0,2,0,12,1.7142857142857142,1,0.0,2,0,0,1,7,0,0,2,0,3,9,1
1748,22849,Wd5Y51TL4njlLeYHUjz5D9nrsHvDXUZ8,A3fsA9Zfv1X2fVEQhTw51lKENdNrEqT3,61,21,15,112,9,3,13,1,174,24.857142857142858,2,0.0,2,15,102,9,19,3,10,13,1,128,46,0
1749,22855,4J9zAQq4ZlZzXgNIT2zhfBx7kGs24C6D,SpATywNh6bZuzm8s1ceuBUnMUAeoAHHw,30,31,16,26,8,21,16,0,118,16.857142857142858,5,0.0,10,16,25,8,21,21,1,16,0,59,59,0
1750,22858,xOeteuxexg2mP8NxgmLBWH8qhXnVfLfh,A3fsA9Zfv1X2fVEQhTw51lKENdNrEqT3,1,0,0,0,0,0,1,0,1,0.14285714285714285,1,0.0,0,0,0,0,0,0,0,1,0,0,1,1
1751,22867,ec87BaRQsrP5IAuQEXYeAFWoVPURyRtj,SpATywNh6bZuzm8s1ceuBUnMUAeoAHHw,30,48,10,28,6,4,13,1,110,15.714285714285714,2,0.0,17,10,25,6,31,4,3,13,1,58,52,0
1752,22882,53VGMeycKD8ekdZB7srikqwK1dcTbnwu,bWdj2GDclj5ofokWjzoa5jAwMkxCykd6,20,41,14,44,13,0,10,0,122,17.428571428571427,5,0.0,19,14,38,13,22,0,6,10,0,84,38,1
1753,22889,VXeEmbu1PPBvvH7wFjnGFaE2yqIFKByx,G8EPVSXsOYB5YQWZGiz1aVq5Pgr2GrQu,23,38,2,0,3,2,14,0,59,8.428571428571429,4,0.0,4,2,0,3,34,2,0,14,0,9,50,1
1754,22891,tnLfm9tutF6YoqDXNIONCmii1aynBy80,SpATywNh6bZuzm8s1ceuBUnMUAeoAHHw,28,62,28,28,7,5,20,0,150,21.428571428571427,5,0.0,7,28,22,7,55,5,6,20,0,64,86,0
1755,22893,fslIhUAreTqu48Va3DJjHuBASqZWV4lb,SpATywNh6bZuzm8s1ceuBUnMUAeoAHHw,9,10,0,3,0,0,2,0,15,2.142857142857143,1,0.0,0,0,3,0,10,0,0,2,0,3,12,0
1756,22896,kwtDMW6kCF4Dj4cVANDmT2RtqpyiMQZT,A3fsA9Zfv1X2fVEQhTw51lKENdNrEqT3,69,114,59,147,31,0,27,0,378,54.0,7,0.0,2,59,120,31,112,0,27,27,0,212,166,0
1757,22909,za2dBkPPLD9IPRBjooK7GJit2ulI5UgN,SpATywNh6bZuzm8s1ceuBUnMUAeoAHHw,19,19,7,43,1,13,10,1,94,13.428571428571429,4,0.0,9,7,36,1,10,13,7,10,1,53,41,0
1758,22916,dLoTMfurIDgppPqjn68MhR8oLIGjxbCC,A3fsA9Zfv1X2fVEQhTw51lKENdNrEqT3,12,26,13,0,5,0,9,1,54,7.714285714285714,4,0.0,0,13,0,5,26,0,0,9,1,18,36,1
1759,22917,faHDojVqWXLiB8t0I6HX2vfFaDqeEAWd,G8EPVSXsOYB5YQWZGiz1aVq5Pgr2GrQu,26,45,3,64,1,0,4,0,117,16.714285714285715,3,0.0,18,3,46,1,27,0,18,4,0,68,49,1
1760,22923,CbShtPgX8EbSEeSUeGV654dzDIai2s5c,G8EPVSXsOYB5YQWZGiz1aVq5Pgr2GrQu,4,8,0,0,1,0,1,0,10,1.4285714285714286,1,0.0,5,0,0,1,3,0,0,1,0,6,4,1
1761,22930,HrbizO8RcI1YFSo093sl97C3MRm3iZSm,SpATywNh6bZuzm8s1ceuBUnMUAeoAHHw,10,7,1,0,1,3,4,0,16,2.2857142857142856,2,0.0,0,1,0,1,7,3,0,4,0,2,14,1
1762,22939,za2dBkPPLD9IPRBjooK7GJit2ulI5UgN,A3fsA9Zfv1X2fVEQhTw51lKENdNrEqT3,12,8,4,0,3,0,5,0,20,2.857142857142857,2,0.0,0,4,0,3,8,0,0,5,0,7,13,1
1763,22960,G7eyYYWDjRzjfvQepcwnefZtLIHlQINA,SpATywNh6bZuzm8s1ceuBUnMUAeoAHHw,28,45,18,35,5,11,18,1,133,19.0,7,0.0,18,18,31,5,27,11,4,18,1,72,61,1
1764,22962,M6VmJD8JYDR5w6GV5uzAgWpIXM5eanml,G8EPVSXsOYB5YQWZGiz1aVq5Pgr2GrQu,118,204,95,204,45,37,26,1,612,87.42857142857143,5,0.0,80,95,147,45,124,37,57,26,1,367,245,0
1765,22969,dT92IjRcuruPiAlpqVUTtu3wNL9IIegT,A3fsA9Zfv1X2fVEQhTw51lKENdNrEqT3,27,44,17,0,10,0,11,0,82,11.714285714285714,3,0.0,2,17,0,10,42,0,0,11,0,29,53,1
1766,22970,dT92IjRcuruPiAlpqVUTtu3wNL9IIegT,bWdj2GDclj5ofokWjzoa5jAwMkxCykd6,40,73,27,122,14,67,22,1,326,46.57142857142857,6,0.0,7,27,106,14,66,67,16,22,1,154,172,1
1767,22988,mYyzW7j4oHjgvbS0hfWvmpiecRMbZDgq,SpATywNh6bZuzm8s1ceuBUnMUAeoAHHw,15,23,12,27,5,4,8,0,79,11.285714285714286,3,0.0,6,12,21,5,17,4,6,8,0,44,35,1
1768,22993,WaZjCMCq9zHT0tGjpLu6Y2rc6ox0JLNd,A3fsA9Zfv1X2fVEQhTw51lKENdNrEqT3,17,13,10,0,9,0,11,0,43,6.142857142857143,1,0.0,0,10,0,9,13,0,0,11,0,19,24,1
1769,22996,W9f8UmYzSEsFhECsZDg6FwyOA22yb0R3,SpATywNh6bZuzm8s1ceuBUnMUAeoAHHw,31,79,30,43,11,259,47,6,475,67.85714285714286,9,0.0,36,30,37,11,43,259,6,47,6,114,361,0
1770,23002,QgNI0yI2W8R4yAAyuaSrYw2RL1D6EBzF,A3fsA9Zfv1X2fVEQhTw51lKENdNrEqT3,5,2,1,0,1,0,2,0,6,0.8571428571428571,1,0.0,0,1,0,1,2,0,0,2,0,2,4,1
1771,23006,UInMBEH8f1h2vxXVslRsWyLOTv8ggYq3,A3fsA9Zfv1X2fVEQhTw51lKENdNrEqT3,70,88,44,172,12,106,33,1,456,65.14285714285714,7,0.0,9,44,137,12,79,106,35,33,1,202,254,1
1772,23014,UInMBEH8f1h2vxXVslRsWyLOTv8ggYq3,bWdj2GDclj5ofokWjzoa5jAwMkxCykd6,23,40,20,134,3,73,23,3,296,42.285714285714285,7,0.0,4,20,127,3,36,73,7,23,3,154,142,0
1773,23049,I2ghGumCKIaVsnJOGZA0xyJzTnEm5KtW,SpATywNh6bZuzm8s1ceuBUnMUAeoAHHw,28,31,18,26,7,27,6,0,115,16.428571428571427,5,0.0,7,18,22,7,24,27,4,6,0,54,61,1
1774,23054,aOK5wIKpKN9ikUy2a1FUGeQDEt1AAFa3,G8EPVSXsOYB5YQWZGiz1aVq5Pgr2GrQu,35,51,35,0,14,11,34,1,146,20.857142857142858,7,0.0,0,35,0,14,51,11,0,34,1,49,97,1
1775,23058,Dp9gZlmwGRMU0Crlqtgk7QHM4JW7fsY6,SpATywNh6bZuzm8s1ceuBUnMUAeoAHHw,18,31,6,28,5,0,6,0,76,10.857142857142858,2,0.0,10,6,22,5,21,0,6,6,0,43,33,0
1776,23061,PzUJiLnP9HZJxQE6JmMTkx1KTzCMtAvI,bWdj2GDclj5ofokWjzoa5jAwMkxCykd6,8,7,4,0,1,0,6,0,18,2.5714285714285716,1,0.0,0,4,0,1,7,0,0,6,0,5,13,1
1777,23063,mekJnkZy13R9odlyEHUcID5pf1ROn3NK,bWdj2GDclj5ofokWjzoa5jAwMkxCykd6,1,0,0,0,0,0,1,0,1,0.14285714285714285,1,0.0,0,0,0,0,0,0,0,1,0,0,1,1
1778,23066,wKKdkZJ3MevUShYy00jn3yNZpY2kcdrV,bWdj2GDclj5ofokWjzoa5jAwMkxCykd6,7,4,2,0,0,1,8,1,16,2.2857142857142856,2,0.0,0,2,0,0,4,1,0,8,1,2,14,1
1779,23068,mekJnkZy13R9odlyEHUcID5pf1ROn3NK,A3fsA9Zfv1X2fVEQhTw51lKENdNrEqT3,2,0,0,0,0,0,2,0,2,0.2857142857142857,1,0.0,0,0,0,0,0,0,0,2,0,0,2,1
1780,23073,gZWf27ETcHz4bBmwZPjiPumw55JZ4IOR,SpATywNh6bZuzm8s1ceuBUnMUAeoAHHw,28,43,0,38,3,67,9,1,161,23.0,2,0.0,22,0,34,3,21,67,4,9,1,59,102,0
1781,23084,mjoKY29bSBUSIg1iJCO4z3ZZIabGnClW,SpATywNh6bZuzm8s1ceuBUnMUAeoAHHw,27,51,21,39,8,42,16,0,177,25.285714285714285,5,0.0,14,21,30,8,37,42,9,16,0,73,104,0
1782,23091,aOhrgEBrLoAbudoZk6lY36jneHxQbWdO,G8EPVSXsOYB5YQWZGiz1aVq5Pgr2GrQu,29,27,18,0,11,0,17,3,76,10.857142857142858,3,0.0,0,18,0,11,27,0,0,17,3,29,47,0
1783,23118,2wKdgTom3CXBb3VapzvEijoKrYgkRC9s,SpATywNh6bZuzm8s1ceuBUnMUAeoAHHw,26,31,26,8,14,13,18,3,113,16.142857142857142,2,0.0,0,26,8,14,31,13,0,18,3,48,65,0
1784,23130,hGDnsprgLmlBuNCzDAhbMdsa7xgZW8Z4,A3fsA9Zfv1X2fVEQhTw51lKENdNrEqT3,50,16,8,136,2,21,14,0,197,28.142857142857142,2,0.0,2,8,113,2,14,21,23,14,0,125,72,1
1785,23135,Emt7DBFLBFlleaJw0CDWZkbz2fh9bCe8,SpATywNh6bZuzm8s1ceuBUnMUAeoAHHw,15,11,8,0,5,0,6,0,30,4.285714285714286,1,0.0,0,8,0,5,11,0,0,6,0,13,17,1
1786,23137,adDGX99l1n1iBt8AmYVD4kO1enVdrmvn,SpATywNh6bZuzm8s1ceuBUnMUAeoAHHw,20,20,12,24,4,0,5,0,65,9.285714285714286,3,0.0,5,12,24,4,15,0,0,5,0,45,20,1
1787,23140,0Tg2flbTUdD7fODqYIfpiJiK0IDdFiOP,RXDvfPUBYFlVdlueBFbLW0mhhAyGEqpt,65,70,33,76,19,39,14,7,258,36.857142857142854,7,0.0,21,33,75,19,49,39,1,14,7,148,110,0
1788,23145,VO6tFMF3YqIQYaW8tkV9BLtheEJyKKQK,SpATywNh6bZuzm8s1ceuBUnMUAeoAHHw,30,37,19,24,9,1,12,0,102,14.571428571428571,4,0.0,11,19,22,9,26,1,2,12,0,61,41,0
1789,23174,dpHLF21uvMbokNNTJHdbSyHoiwNjC5Qc,RXDvfPUBYFlVdlueBFbLW0mhhAyGEqpt,18,15,11,0,5,8,5,4,48,6.857142857142857,2,0.0,0,11,0,5,15,8,0,5,4,16,32,1
1790,23181,PwNax3W8g4wFzRQCUhWcP9EnmZeticjo,SpATywNh6bZuzm8s1ceuBUnMUAeoAHHw,26,25,12,12,8,1,1,0,59,8.428571428571429,2,0.0,12,12,12,8,13,1,0,1,0,44,15,1
1791,23182,CBLeEN4LtKF8I3pqDKXGm8PyJoErUnYX,A3fsA9Zfv1X2fVEQhTw51lKENdNrEqT3,10,9,1,0,1,1,3,0,15,2.142857142857143,1,0.0,0,1,0,1,9,1,0,3,0,2,13,1
1792,23186,jOKGDo32k5y1tQ1HBtDhmlq3GlvnMuW4,A3fsA9Zfv1X2fVEQhTw51lKENdNrEqT3,30,53,41,0,30,2,34,0,160,22.857142857142858,5,0.0,1,41,0,30,52,2,0,34,0,72,88,1
1793,23188,HycevJIm7cBjf1oJ5QCBMMXEBTG8jyRF,RXDvfPUBYFlVdlueBFbLW0mhhAyGEqpt,72,127,77,108,16,74,67,2,471,67.28571428571429,9,0.0,27,77,101,16,100,74,7,67,2,221,250,0
1794,23189,ClKPcHfoSfkiUFto4BTBZmMJfgBwADCv,bWdj2GDclj5ofokWjzoa5jAwMkxCykd6,4,2,1,0,1,0,1,0,5,0.7142857142857143,1,0.0,0,1,0,1,2,0,0,1,0,2,3,1
1795,23203,YBZJfjYuKfwb2VLWbDlKIMN1YSYXBGau,A3fsA9Zfv1X2fVEQhTw51lKENdNrEqT3,14,18,12,0,4,6,7,0,47,6.714285714285714,4,0.0,0,12,0,4,18,6,0,7,0,16,31,1
1796,23216,BdGjvuZcr0pZwpTvi8kd6szBp0GhSFRx,bWdj2GDclj5ofokWjzoa5jAwMkxCykd6,10,10,6,0,5,0,5,0,26,3.7142857142857144,1,0.0,2,6,0,5,8,0,0,5,0,13,13,1
1797,23229,AjE14bAFpRvd1b44PmMUpBPn2loehR8N,SpATywNh6bZuzm8s1ceuBUnMUAeoAHHw,19,31,7,15,7,9,18,0,87,12.428571428571429,3,0.0,5,7,14,7,26,9,1,18,0,33,54,1
1798,23230,qJSVGIIBKQpzllCeTCwG3pgdEZIo3QRz,A3fsA9Zfv1X2fVEQhTw51lKENdNrEqT3,12,9,2,4,1,0,16,0,32,4.571428571428571,3,0.0,0,2,3,1,9,0,1,16,0,6,26,1
1799,23241,wmmgynPgGzw7ypLLU9vcdxog9SI7Juul,RXDvfPUBYFlVdlueBFbLW0mhhAyGEqpt,19,13,8,20,3,0,3,0,47,6.714285714285714,2,0.0,2,8,17,3,11,0,3,3,0,30,17,1
1800,23254,3rBX9dOAFMfNlnyfBe9F26nbNxp33Uvk,G8EPVSXsOYB5YQWZGiz1aVq5Pgr2GrQu,20,21,7,0,6,1,13,1,49,7.0,3,0.0,0,7,0,6,21,1,0,13,1,13,36,1
1801,23255,FfhVetKUzu5KpGrHLPHaynXPJghmm3It,SpATywNh6bZuzm8s1ceuBUnMUAeoAHHw,20,21,1,17,2,0,3,0,44,6.285714285714286,2,0.0,6,1,16,2,15,0,1,3,0,25,19,0
1802,23259,xqwUV9iQK4erbWJ9fEZ3Fau5k4aAZ9DO,SpATywNh6bZuzm8s1ceuBUnMUAeoAHHw,21,59,27,46,7,10,15,2,166,23.714285714285715,5,0.0,22,27,36,7,37,10,10,15,2,92,74,0
1803,23263,tnLfm9tutF6YoqDXNIONCmii1aynBy80,A3fsA9Zfv1X2fVEQhTw51lKENdNrEqT3,9,8,4,0,0,3,12,1,28,4.0,3,0.0,0,4,0,0,8,3,0,12,1,4,24,1
1804,23264,XTgYONXtkRAl3sCFaGFF8e1mU9AMcEwg,SpATywNh6bZuzm8s1ceuBUnMUAeoAHHw,11,10,7,0,5,0,5,0,27,3.857142857142857,2,0.0,0,7,0,5,10,0,0,5,0,12,15,1
1805,23265,knRZtWEcWI5MFAs7PYIJdk2jdyAY8A24,SpATywNh6bZuzm8s1ceuBUnMUAeoAHHw,15,19,6,8,3,0,4,0,40,5.714285714285714,1,0.0,9,6,8,3,10,0,0,4,0,26,14,0
1806,23268,XJpmNtat26NZxNAZqQE63m1qpYdHanqw,RXDvfPUBYFlVdlueBFbLW0mhhAyGEqpt,65,60,34,88,23,7,2,0,214,30.571428571428573,1,0.0,15,34,82,23,45,7,6,2,0,154,60,0
1807,23281,peL7W7HsPQXwJW8IfNPUpznrjT13FLeH,SpATywNh6bZuzm8s1ceuBUnMUAeoAHHw,12,25,0,13,0,0,12,0,50,7.142857142857143,2,0.0,8,0,12,0,17,0,1,12,0,20,30,1
1808,23288,pLQfsJL46iqa9L7UfI8ODNozilMqoPl0,A3fsA9Zfv1X2fVEQhTw51lKENdNrEqT3,7,4,3,0,2,0,2,0,11,1.5714285714285714,1,0.0,0,3,0,2,4,0,0,2,0,5,6,1
1809,23297,3cB0rEpxJxC0jjqfQ9EPT6ntxFajOXrx,A3fsA9Zfv1X2fVEQhTw51lKENdNrEqT3,70,75,49,226,16,35,14,1,416,59.42857142857143,5,0.0,7,49,195,16,68,35,31,14,1,267,149,0
1810,23304,WEwbMamm1WQzZcIYKs7fv3KkFwrZAu4n,SpATywNh6bZuzm8s1ceuBUnMUAeoAHHw,28,41,18,27,9,6,8,0,109,15.571428571428571,5,0.0,18,18,27,9,23,6,0,8,0,72,37,0
1811,23307,S1PbXrIuvwc8AvxDGKhjkWzwRdM8cFN0,SpATywNh6bZuzm8s1ceuBUnMUAeoAHHw,21,31,17,12,0,0,7,0,67,9.571428571428571,6,0.0,5,17,12,0,26,0,0,7,0,34,33,0
1812,23308,P0KoQHPz5chEfkMzzCMKKbnUkwSC15gh,G8EPVSXsOYB5YQWZGiz1aVq5Pgr2GrQu,1,0,0,0,0,0,1,0,1,0.14285714285714285,1,0.0,0,0,0,0,0,0,0,1,0,0,1,1
1813,23311,fE7crtUj4hDSQo6ITE7OJYFi4AN2F95M,A3fsA9Zfv1X2fVEQhTw51lKENdNrEqT3,43,32,16,92,10,2,9,0,161,23.0,2,0.0,1,16,75,10,31,2,17,9,0,102,59,1
1814,23313,TXBaUi0GpvXZWCDXsKlkFWTtfaT87UMz,bWdj2GDclj5ofokWjzoa5jAwMkxCykd6,11,33,5,32,1,1,9,2,83,11.857142857142858,5,0.0,3,5,30,1,30,1,2,9,2,39,44,1
1815,23341,1cMpA6zMPA0affI3yASPkTig9lUEcx1e,G8EPVSXsOYB5YQWZGiz1aVq5Pgr2GrQu,7,11,6,0,1,63,10,0,91,13.0,3,0.0,0,6,0,1,11,63,0,10,0,7,84,1
1816,23358,dob27oJoC3Vd5K1oOuihpbNGBh5pIGaM,SpATywNh6bZuzm8s1ceuBUnMUAeoAHHw,14,30,16,1,7,1,6,0,61,8.714285714285714,3,0.0,6,16,1,7,24,1,0,6,0,30,31,1
1817,23388,HZWZtPkCTeK90eQ90MHe5cWcAqiVgkGk,bWdj2GDclj5ofokWjzoa5jAwMkxCykd6,13,14,6,50,4,23,17,1,115,16.428571428571427,3,0.0,3,6,48,4,11,23,2,17,1,61,54,0
1818,23390,lfrqXPATBesMooHpdCa9ZnxlXhb59rmp,SpATywNh6bZuzm8s1ceuBUnMUAeoAHHw,21,120,72,19,24,2,31,0,268,38.285714285714285,6,0.0,14,72,17,24,106,2,2,31,0,127,141,1
1819,23399,QUw5YB8tw6ArwfIF1vjOH2aXsMxDBB6n,SpATywNh6bZuzm8s1ceuBUnMUAeoAHHw,22,20,12,12,6,18,14,2,84,12.0,5,0.0,2,12,10,6,18,18,2,14,2,30,54,0
1820,23405,3AFvyqpOB7zyiycGY1NpbFOUZUj9K9Bb,SpATywNh6bZuzm8s1ceuBUnMUAeoAHHw,25,23,14,12,7,1,8,0,65,9.285714285714286,4,0.0,4,14,12,7,19,1,0,8,0,37,28,1
1821,23416,1ulA4jhwI0WhLE9MVLjWBxEEeOzdq7WL,SpATywNh6bZuzm8s1ceuBUnMUAeoAHHw,15,35,20,22,7,23,11,0,118,16.857142857142858,4,0.0,7,20,17,7,28,23,5,11,0,51,67,0
1822,23440,lHNqd6KTSO9CrJzRDAqosVITLVN3mMHR,bWdj2GDclj5ofokWjzoa5jAwMkxCykd6,38,40,23,208,9,0,15,0,295,42.142857142857146,4,0.0,10,23,194,9,30,0,14,15,0,236,59,1
1823,23450,RKjVof9Yhxeyyya4gtkZu1fqgIbPHIOB,A3fsA9Zfv1X2fVEQhTw51lKENdNrEqT3,17,16,10,0,5,14,17,5,67,9.571428571428571,4,0.0,1,10,0,5,15,14,0,17,5,16,51,0
1824,23452,iEsDxJ2LNGTFl1t0aAKhf24FeoeDy4PX,G8EPVSXsOYB5YQWZGiz1aVq5Pgr2GrQu,5,4,0,0,1,0,1,0,6,0.8571428571428571,1,0.0,0,0,0,1,4,0,0,1,0,1,5,1
1825,23457,wLAgbiz3XWV6Nef8pQe1TlLxUN8CIoJ8,G8EPVSXsOYB5YQWZGiz1aVq5Pgr2GrQu,1,0,0,0,0,0,1,0,1,0.14285714285714285,1,0.0,0,0,0,0,0,0,0,1,0,0,1,1
1826,23477,wctOEAfOfHjaIn2ukTVBg3NDDfP2Pt1c,SpATywNh6bZuzm8s1ceuBUnMUAeoAHHw,28,70,41,28,11,18,30,5,203,29.0,6,0.0,10,41,24,11,60,18,4,30,5,86,117,0
1827,23490,Id4UmIRRQiLXHoJYSjh5OCO1CRaFgQ2K,SpATywNh6bZuzm8s1ceuBUnMUAeoAHHw,30,53,21,26,10,8,13,1,132,18.857142857142858,4,0.0,16,21,21,10,37,8,5,13,1,68,64,1
1828,23510,GIb3glgYrsEfHWtEWPWpwONqwE7RMf6f,A3fsA9Zfv1X2fVEQhTw51lKENdNrEqT3,71,123,71,124,34,7,42,1,402,57.42857142857143,9,0.0,3,71,113,34,120,7,11,42,1,221,181,0
1829,23515,Oqfkhjg6t51PZcyyCwvjWtQ6bDHYceB1,SpATywNh6bZuzm8s1ceuBUnMUAeoAHHw,29,71,40,24,13,25,12,0,185,26.428571428571427,8,0.0,16,40,19,13,55,25,5,12,0,88,97,0
1830,23516,PzbAAQBdNIO5q0hDkxJETX7v12Y9h0xH,SpATywNh6bZuzm8s1ceuBUnMUAeoAHHw,7,6,1,0,1,0,3,0,11,1.5714285714285714,1,0.0,0,1,0,1,6,0,0,3,0,2,9,0
1831,23519,DsdEYwXt7PO92K8VROCVVtUqrprzaIo4,A3fsA9Zfv1X2fVEQhTw51lKENdNrEqT3,46,26,17,88,10,1,24,1,167,23.857142857142858,2,0.0,2,17,71,10,24,1,17,24,1,100,67,1
1832,23542,d4mvkfcwFcYKWYB1PuCW432MT8LvqlFh,SpATywNh6bZuzm8s1ceuBUnMUAeoAHHw,27,33,20,38,11,0,7,0,109,15.571428571428571,3,0.0,10,20,36,11,23,0,2,7,0,77,32,1
1833,23552,H0WeKsbXeLHWXz7EV7ygxgCQNCt5DOUD,SpATywNh6bZuzm8s1ceuBUnMUAeoAHHw,27,54,19,47,6,7,14,1,148,21.142857142857142,8,0.0,6,19,39,6,48,7,8,14,1,70,78,0
1834,23554,bVCYDQX7pJxff6OyJX4M9s17AtFlpk5i,SpATywNh6bZuzm8s1ceuBUnMUAeoAHHw,10,18,12,0,7,0,6,0,43,6.142857142857143,2,0.0,0,12,0,7,18,0,0,6,0,19,24,1
1835,23573,MwhE2MowwPvamSVFrLUWaatDsrzcIgQY,SpATywNh6bZuzm8s1ceuBUnMUAeoAHHw,5,2,1,0,1,3,2,0,9,1.2857142857142858,1,0.0,0,1,0,1,2,3,0,2,0,2,7,0
1836,23585,NRdQjU0MJFdxtbDqiTrBcJcd064egve1,SpATywNh6bZuzm8s1ceuBUnMUAeoAHHw,17,45,28,15,0,11,24,1,124,17.714285714285715,3,0.0,8,28,13,0,37,11,2,24,1,49,75,1
1837,23588,DHUv7XpIZcPp2QYGNmTXjhgg7Zq4BpJ7,RXDvfPUBYFlVdlueBFbLW0mhhAyGEqpt,1,0,0,0,0,0,1,0,1,0.14285714285714285,1,0.0,0,0,0,0,0,0,0,1,0,0,1,1
1838,23595,0EotlIgKGd3opCDMhDC2aBqeeKmFST46,A3fsA9Zfv1X2fVEQhTw51lKENdNrEqT3,2,0,0,0,0,0,4,0,4,0.5714285714285714,1,0.0,0,0,0,0,0,0,0,4,0,0,4,1
1839,23596,DdGVDKNQwSkPIQKeE1XouOkZR5kVZ7SK,SpATywNh6bZuzm8s1ceuBUnMUAeoAHHw,19,27,7,14,3,0,6,0,57,8.142857142857142,2,0.0,8,7,11,3,19,0,3,6,0,29,28,1
1840,23597,lLz9WbehghUNLRABDjzrIp7BjBkWjoW9,SpATywNh6bZuzm8s1ceuBUnMUAeoAHHw,6,5,2,0,1,0,2,0,10,1.4285714285714286,1,0.0,0,2,0,1,5,0,0,2,0,3,7,1
1841,23603,0wJhtCWK60WPCeRF62m8T80DtNpWhRrg,SpATywNh6bZuzm8s1ceuBUnMUAeoAHHw,26,34,16,32,5,0,7,1,95,13.571428571428571,2,0.0,14,16,28,5,20,0,4,7,1,63,32,0
1842,23633,o6ILANWxUGmdLZhlBol9mZCEolnG5bhy,SpATywNh6bZuzm8s1ceuBUnMUAeoAHHw,28,34,20,3,8,34,18,1,118,16.857142857142858,8,0.0,2,20,3,8,32,34,0,18,1,33,85,1
1843,23639,tMPZYG0DCvDSDEuO4KsQAdk0iwwmXKYt,A3fsA9Zfv1X2fVEQhTw51lKENdNrEqT3,22,48,24,0,8,2,20,0,102,14.571428571428571,5,0.0,1,24,0,8,47,2,0,20,0,33,69,0
1844,23640,9uqkwYb5ddQJIw4su6OaF1hwvWEdLp1S,A3fsA9Zfv1X2fVEQhTw51lKENdNrEqT3,29,29,19,0,13,0,6,0,67,9.571428571428571,4,0.0,0,19,0,13,29,0,0,6,0,32,35,0
1845,23647,3rCZba8eKP7jaFsDjNb32WoGn9BjnrjN,bWdj2GDclj5ofokWjzoa5jAwMkxCykd6,1,0,0,0,0,0,1,0,1,0.14285714285714285,1,0.0,0,0,0,0,0,0,0,1,0,0,1,1
1846,23671,9sTtmQQAXG5XvwtZJPuuRKLnfgaYWfWO,SpATywNh6bZuzm8s1ceuBUnMUAeoAHHw,26,26,11,26,6,0,4,0,73,10.428571428571429,2,0.0,13,11,24,6,13,0,2,4,0,54,19,1
1847,23674,l9KseRU4xYtwOzoILYmGcicF0iiXQqxl,SpATywNh6bZuzm8s1ceuBUnMUAeoAHHw,31,51,19,33,7,21,14,1,146,20.857142857142858,7,0.0,14,19,27,7,37,21,6,14,1,67,79,0
1848,23675,pJj2PU7RZQK2Nwrb96O5DurQcsPoqkDx,bWdj2GDclj5ofokWjzoa5jAwMkxCykd6,1,0,0,0,0,0,2,0,2,0.2857142857142857,1,0.0,0,0,0,0,0,0,0,2,0,0,2,1
1849,23692,zJ99WhK6aN6yEmbpXd5cJuqKo0p9kPsD,RXDvfPUBYFlVdlueBFbLW0mhhAyGEqpt,59,41,22,78,16,2,14,1,174,24.857142857142858,3,0.0,16,22,74,16,25,2,4,14,1,128,46,1
1850,23710,3iJrlZJEv2h7DgWBpz6wZtSXPXEy6IAY,A3fsA9Zfv1X2fVEQhTw51lKENdNrEqT3,14,19,9,0,6,0,9,0,43,6.142857142857143,7,0.0,0,9,0,6,19,0,0,9,0,15,28,0
1851,23711,POOwrt9teJiwgIKzPgqwiwhGp5kUKv01,SpATywNh6bZuzm8s1ceuBUnMUAeoAHHw,29,37,22,27,10,8,12,1,117,16.714285714285715,2,0.0,9,22,23,10,28,8,4,12,1,64,53,0
1852,23716,epEhe5zjAdMHelSWe8cywAVR1iLucvwI,SpATywNh6bZuzm8s1ceuBUnMUAeoAHHw,4,2,0,0,0,0,2,0,4,0.5714285714285714,1,0.0,0,0,0,0,2,0,0,2,0,0,4,1
1853,23723,aX5o3K4conQ4SoTRN7MBCmGaArjn5YFA,SpATywNh6bZuzm8s1ceuBUnMUAeoAHHw,5,2,1,0,1,0,3,0,7,1.0,1,0.0,0,1,0,1,2,0,0,3,0,2,5,1
1854,23725,wNbKFPX6oYsfVEr8buyWthBblPuPZGxv,SpATywNh6bZuzm8s1ceuBUnMUAeoAHHw,1,0,0,0,0,0,1,0,1,0.14285714285714285,1,0.0,0,0,0,0,0,0,0,1,0,0,1,1
1855,23740,oJ9j9ejTgKixczg3tSE8Sg8DPI7YQpJq,SpATywNh6bZuzm8s1ceuBUnMUAeoAHHw,28,44,23,18,6,14,12,0,117,16.714285714285715,6,0.0,14,23,15,6,30,14,3,12,0,58,59,0
1856,23745,Ot8esbQhlnTNYRjqPJ5gBbiW6Aw8bpdE,G8EPVSXsOYB5YQWZGiz1aVq5Pgr2GrQu,1,0,0,0,0,0,1,0,1,0.14285714285714285,1,0.0,0,0,0,0,0,0,0,1,0,0,1,1
1857,23752,oW1SPRE23Cu85GeGZYRmhPcFuXq6dZoG,SpATywNh6bZuzm8s1ceuBUnMUAeoAHHw,27,46,23,15,10,3,13,0,110,15.714285714285714,3,0.0,16,23,14,10,30,3,1,13,0,63,47,0
1858,23754,atxTINx1wNa0Kz1uw7bW34Z47POxkGeq,SpATywNh6bZuzm8s1ceuBUnMUAeoAHHw,29,71,11,34,8,4,52,1,181,25.857142857142858,7,0.0,9,11,29,8,62,4,5,52,1,57,124,0
1859,23760,6uy0rYsVs6ntSHgwhJ1mwDkW5uKAQxi4,SpATywNh6bZuzm8s1ceuBUnMUAeoAHHw,22,61,34,16,15,10,7,0,143,20.428571428571427,6,0.0,12,34,14,15,49,10,2,7,0,75,68,1
1860,23771,zG5wQdjarSEp1xTKP5FU2TvutBYexg1v,bWdj2GDclj5ofokWjzoa5jAwMkxCykd6,6,12,0,0,0,0,4,0,16,2.2857142857142856,1,0.0,1,0,0,0,11,0,0,4,0,1,15,1
1861,23773,35E85h2ExBPeTd1VmxNX0GKo8krIMsCP,SpATywNh6bZuzm8s1ceuBUnMUAeoAHHw,30,64,24,32,13,1,12,0,146,20.857142857142858,4,0.0,32,24,28,13,32,1,4,12,0,97,49,1
1862,23789,i1f7BljhTNgVMfGOHZ66OYaR3kNetCAs,SpATywNh6bZuzm8s1ceuBUnMUAeoAHHw,13,23,0,34,0,19,7,0,83,11.857142857142858,5,0.0,12,0,31,0,11,19,3,7,0,43,40,0
1863,23795,bHKiB8yjzvUwkeHE5fxnHNywx47ldJ6B,SpATywNh6bZuzm8s1ceuBUnMUAeoAHHw,24,51,4,31,2,2,13,0,103,14.714285714285714,7,0.0,15,4,27,2,36,2,4,13,0,48,55,1
1864,23798,GOPMGFz5xoFESgugOmv6JtNIOPfS0GCX,SpATywNh6bZuzm8s1ceuBUnMUAeoAHHw,17,38,1,17,1,13,14,1,85,12.142857142857142,5,0.0,10,1,16,1,28,13,1,14,1,28,57,0
1865,23806,uxWndEUVVRQyohhChNH7OrcMXH2VCOhT,SpATywNh6bZuzm8s1ceuBUnMUAeoAHHw,10,11,2,0,1,0,2,0,16,2.2857142857142856,2,0.0,0,2,0,1,11,0,0,2,0,3,13,1
1866,23812,6GriNnzq8xnsLEV5ztRmUAFnPPewwL0q,A3fsA9Zfv1X2fVEQhTw51lKENdNrEqT3,29,16,8,64,0,0,6,0,94,13.428571428571429,3,0.0,3,8,56,0,13,0,8,6,0,67,27,1
1867,23836,83Gotur1nDdhzZnnscpduWQ3wLNBDtA6,SpATywNh6bZuzm8s1ceuBUnMUAeoAHHw,12,15,1,22,0,0,3,0,41,5.857142857142857,1,0.0,8,1,18,0,7,0,4,3,0,27,14,1
1868,23840,FBu5R2eGEtl9EDw0VwXtH1t5i2ELpdqI,SpATywNh6bZuzm8s1ceuBUnMUAeoAHHw,6,7,2,0,0,0,5,0,14,2.0,1,0.0,0,2,0,0,7,0,0,5,0,2,12,1
1869,23841,7Vj4ziukCVrVZvt93RQ91d2zl9J3pERE,SpATywNh6bZuzm8s1ceuBUnMUAeoAHHw,17,22,13,6,5,0,6,0,52,7.428571428571429,2,0.0,5,13,5,5,17,0,1,6,0,28,24,1
1870,23852,dFrBZuKOTxv7Ek84BAuACScgZVHLiPRz,SpATywNh6bZuzm8s1ceuBUnMUAeoAHHw,5,5,0,0,0,0,3,0,8,1.1428571428571428,2,0.0,0,0,0,0,5,0,0,3,0,0,8,1
1871,23855,4okppsrdnKYxqs2gLNMiS6gb60QmM8WN,RXDvfPUBYFlVdlueBFbLW0mhhAyGEqpt,63,92,69,168,14,9,17,17,386,55.142857142857146,4,0.0,13,69,155,14,79,9,13,17,17,251,135,1
1872,23857,840TvauCMn8hUpsV90vm3IXVVzLXLwLs,A3fsA9Zfv1X2fVEQhTw51lKENdNrEqT3,35,43,1,80,0,0,3,0,127,18.142857142857142,2,0.0,6,1,70,0,37,0,10,3,0,77,50,1
1873,23862,YxEAEqB4R6GTRBWDvga1GWE0URAxGc6U,A3fsA9Zfv1X2fVEQhTw51lKENdNrEqT3,7,8,5,0,0,0,2,0,15,2.142857142857143,2,0.0,0,5,0,0,8,0,0,2,0,5,10,1
1874,23863,3Ta0rfBtrbiqFMIpcV3b3USyW2ELEZd2,bWdj2GDclj5ofokWjzoa5jAwMkxCykd6,14,24,3,6,6,9,16,2,66,9.428571428571429,3,0.0,5,3,5,6,19,9,1,16,2,19,47,1
1875,23872,7iw4UiR57uyLjfIdpxq0wONlaNvYfNiV,SpATywNh6bZuzm8s1ceuBUnMUAeoAHHw,1,0,0,0,0,0,1,0,1,0.14285714285714285,1,0.0,0,0,0,0,0,0,0,1,0,0,1,1
1876,23874,986WgoFI0AZSDPIvWwBI8MUZveW4E4Xu,RXDvfPUBYFlVdlueBFbLW0mhhAyGEqpt,23,63,32,0,15,0,9,0,119,17.0,5,0.0,0,32,0,15,63,0,0,9,0,47,72,0
1877,23891,FBu5R2eGEtl9EDw0VwXtH1t5i2ELpdqI,A3fsA9Zfv1X2fVEQhTw51lKENdNrEqT3,42,53,23,110,10,1,10,0,207,29.571428571428573,4,0.0,4,23,88,10,49,1,22,10,0,125,82,1
1878,23893,dkQw8oK3XR4qlNNv9mJoCG5KMSpfLA0u,SpATywNh6bZuzm8s1ceuBUnMUAeoAHHw,29,20,12,31,7,9,7,1,87,12.428571428571429,2,0.0,6,12,28,7,14,9,3,7,1,53,34,1
1879,23895,g7nx8KecXhqsIkJIviLtJahoCAcu06DW,SpATywNh6bZuzm8s1ceuBUnMUAeoAHHw,2,0,0,0,0,0,2,0,2,0.2857142857142857,1,0.0,0,0,0,0,0,0,0,2,0,0,2,1
1880,23901,4dLqJDBbl4XgAFoagStv97aI3aHRciy5,SpATywNh6bZuzm8s1ceuBUnMUAeoAHHw,13,19,12,0,7,3,10,1,52,7.428571428571429,3,0.0,0,12,0,7,19,3,0,10,1,19,33,1
1881,23909,B7s9DHPpvHggi4c4m5C7RuYNMMAUXQfR,SpATywNh6bZuzm8s1ceuBUnMUAeoAHHw,8,10,6,0,5,0,4,0,25,3.5714285714285716,1,0.0,0,6,0,5,10,0,0,4,0,11,14,1
1882,23920,v5teTtQ61doFtyEryEU1FEZNTQeJUrxX,SpATywNh6bZuzm8s1ceuBUnMUAeoAHHw,25,64,5,26,0,13,31,2,141,20.142857142857142,6,0.0,28,5,25,0,36,13,1,31,2,58,83,0
1883,23926,haBS6HInfRwWNu7SJCbVrmAnlh8blC7U,SpATywNh6bZuzm8s1ceuBUnMUAeoAHHw,1,0,0,0,0,0,1,0,1,0.14285714285714285,1,0.0,0,0,0,0,0,0,0,1,0,0,1,1
1884,23942,yk8HuNxXIum8r8XDIOHqnAVeWfg9tYo1,A3fsA9Zfv1X2fVEQhTw51lKENdNrEqT3,14,16,12,0,6,2,19,2,57,8.142857142857142,3,0.0,0,12,0,6,16,2,0,19,2,18,39,1
1885,23944,ZKAk08L8Iriz8Uv5UOeqSbrNnzg1rlMz,RXDvfPUBYFlVdlueBFbLW0mhhAyGEqpt,26,28,17,27,9,17,14,1,113,16.142857142857142,4,0.0,5,17,27,9,23,17,0,14,1,58,55,0
1886,23955,5mJ1itg2cQYRNscuJuLNd4sNUrdim8JB,bWdj2GDclj5ofokWjzoa5jAwMkxCykd6,26,94,40,63,6,40,36,7,286,40.857142857142854,6,0.0,10,40,60,6,84,40,3,36,7,116,170,0
1887,23975,xCPsccPRbQTL93kwam6OPz5i1lU77hqE,SpATywNh6bZuzm8s1ceuBUnMUAeoAHHw,19,25,1,6,0,3,13,0,48,6.857142857142857,3,0.0,4,1,6,0,21,3,0,13,0,11,37,0
1888,23976,PSJftXZeDfoFySmsRqkLgFson1mEyJqX,SpATywNh6bZuzm8s1ceuBUnMUAeoAHHw,31,94,38,42,12,81,57,4,328,46.857142857142854,8,0.0,42,38,35,12,52,81,7,57,4,127,201,0
1889,23982,3W09pasLSoDWuQqGyvECJ7WiykG165j2,RXDvfPUBYFlVdlueBFbLW0mhhAyGEqpt,11,10,6,0,3,0,5,0,24,3.4285714285714284,4,0.0,1,6,0,3,9,0,0,5,0,10,14,1
1890,23985,T23nrSnpQ3vWpr6CtL4ZskVcSM0KOOu0,A3fsA9Zfv1X2fVEQhTw51lKENdNrEqT3,13,7,6,0,6,0,3,0,22,3.142857142857143,1,0.0,0,6,0,6,7,0,0,3,0,12,10,1
1891,24006,FrLEzodgON5rcdCDFBdqJa5CoY6xgWo9,G8EPVSXsOYB5YQWZGiz1aVq5Pgr2GrQu,2,0,0,0,0,1,1,0,2,0.2857142857142857,1,0.0,0,0,0,0,0,1,0,1,0,0,2,1
1892,24015,op8q14GHWgkmIf6XOfnEOFm5IfQDADrc,SpATywNh6bZuzm8s1ceuBUnMUAeoAHHw,4,2,1,0,1,0,1,0,5,0.7142857142857143,1,0.0,0,1,0,1,2,0,0,1,0,2,3,1
1893,24019,tML4IQ8jFiP4YuH9NbvzKQFqAdof0qcO,G8EPVSXsOYB5YQWZGiz1aVq5Pgr2GrQu,68,94,1,160,1,38,28,2,324,46.285714285714285,8,0.0,12,1,130,1,82,38,30,28,2,144,180,0
1894,24035,j5UlwBty5MOwHf8rgRJk1hdlEvwivM1k,SpATywNh6bZuzm8s1ceuBUnMUAeoAHHw,26,73,32,29,9,38,41,0,222,31.714285714285715,10,0.0,17,32,29,9,56,38,0,41,0,87,135,0
1895,24036,tx5OjuBvtxXu3JLfhVRvs5pDkriVKuCZ,SpATywNh6bZuzm8s1ceuBUnMUAeoAHHw,2,0,0,0,0,0,2,0,2,0.2857142857142857,1,0.0,0,0,0,0,0,0,0,2,0,0,2,1
1896,24046,5C3sCk6rXQc2OvYtSBZh5PoYxtIPWyJ2,SpATywNh6bZuzm8s1ceuBUnMUAeoAHHw,13,18,13,0,5,2,7,0,45,6.428571428571429,3,0.0,5,13,0,5,13,2,0,7,0,23,22,1
1897,24050,vJOEMmX7SHj3LcECHogPAykr3CpSjcOR,SpATywNh6bZuzm8s1ceuBUnMUAeoAHHw,9,7,5,0,4,0,2,0,18,2.5714285714285716,1,0.0,0,5,0,4,7,0,0,2,0,9,9,0
1898,24053,eosk3dY7502Pbg6Dsnx0qWKWUpRTliXK,A3fsA9Zfv1X2fVEQhTw51lKENdNrEqT3,52,35,5,140,0,0,18,0,198,28.285714285714285,8,0.0,4,5,130,0,31,0,10,18,0,139,59,1
1899,24065,DTTxrR88jPl5bCCaxQVsf8wzpnk1CzMM,bWdj2GDclj5ofokWjzoa5jAwMkxCykd6,3,0,0,0,0,0,3,0,3,0.42857142857142855,1,0.0,0,0,0,0,0,0,0,3,0,0,3,1
1900,24066,kXKIMNlMdItv4EM1IWayIAvXYTB44MoC,RXDvfPUBYFlVdlueBFbLW0mhhAyGEqpt,6,5,1,0,1,0,6,0,13,1.8571428571428572,1,0.0,0,1,0,1,5,0,0,6,0,2,11,1
1901,24068,lUdpqcwQn1Cq8H3mwfWcSvZsVHMY64gd,SpATywNh6bZuzm8s1ceuBUnMUAeoAHHw,24,49,4,32,2,0,23,6,116,16.571428571428573,3,0.0,18,4,27,2,31,0,5,23,6,51,65,1
1902,24070,DTTxrR88jPl5bCCaxQVsf8wzpnk1CzMM,A3fsA9Zfv1X2fVEQhTw51lKENdNrEqT3,7,2,0,0,0,0,7,0,9,1.2857142857142858,1,0.0,0,0,0,0,2,0,0,7,0,0,9,1
1903,24077,1xg9Qkt1ODqUyNotraxCzvVYE0R3XRTq,SpATywNh6bZuzm8s1ceuBUnMUAeoAHHw,14,59,32,2,0,4,23,1,121,17.285714285714285,5,0.0,11,32,2,0,48,4,0,23,1,45,76,0
1904,24088,M8ZBCZwMuabH0ACZboTe8kVgLwQBa43E,SpATywNh6bZuzm8s1ceuBUnMUAeoAHHw,7,9,2,0,2,0,2,0,15,2.142857142857143,1,0.0,0,2,0,2,9,0,0,2,0,4,11,1
1905,24095,gIOMjsdC7cxqbaSIU1FRFPikduEMi8Cf,A3fsA9Zfv1X2fVEQhTw51lKENdNrEqT3,1,0,0,0,0,0,1,0,1,0.14285714285714285,1,0.0,0,0,0,0,0,0,0,1,0,0,1,1
1906,24097,quAtav6r2isPETtEaXY0Zey5BbVDiT8E,bWdj2GDclj5ofokWjzoa5jAwMkxCykd6,12,12,4,160,4,1,8,3,192,27.428571428571427,2,0.0,6,4,149,4,6,1,11,8,3,163,29,1
1907,24104,vhdI0CMIgkIrtFphutHmT5NtC4th9ah8,G8EPVSXsOYB5YQWZGiz1aVq5Pgr2GrQu,19,29,15,20,6,8,9,2,89,12.714285714285714,1,0.0,11,15,13,6,18,8,7,9,2,45,44,1
1908,24105,CARvKOUSVZPjSOb5Yfv5PAWmTBO0zJGw,SpATywNh6bZuzm8s1ceuBUnMUAeoAHHw,11,10,5,0,2,0,25,2,44,6.285714285714286,1,0.0,0,5,0,2,10,0,0,25,2,7,37,1
1909,24107,GCaUOiguxLs9b5sngb0RwjOWSkIZZOW6,RXDvfPUBYFlVdlueBFbLW0mhhAyGEqpt,1,0,0,0,0,0,2,0,2,0.2857142857142857,1,0.0,0,0,0,0,0,0,0,2,0,0,2,1
1910,24113,dMrgH440WCDAs3UnYGenYjtBiGOLNMI7,G8EPVSXsOYB5YQWZGiz1aVq5Pgr2GrQu,10,10,1,14,0,0,5,1,31,4.428571428571429,1,0.0,0,1,12,0,10,0,2,5,1,13,18,1
1911,24117,qQwIO2VZC7PFj9cTI7x2EoRtRcwJFk5y,A3fsA9Zfv1X2fVEQhTw51lKENdNrEqT3,17,11,2,24,1,5,7,0,50,7.142857142857143,2,0.0,0,2,19,1,11,5,5,7,0,22,28,1
1912,24130,PweHbRIHs8SwjKQfEtpqIQuZBXBDcuDm,SpATywNh6bZuzm8s1ceuBUnMUAeoAHHw,31,43,22,34,10,0,11,2,122,17.428571428571427,4,0.0,15,22,31,10,28,0,3,11,2,78,44,1
1913,24139,oz1karFupMeBQM5wp1X9Aheb4RKufic7,SpATywNh6bZuzm8s1ceuBUnMUAeoAHHw,28,37,23,39,9,16,10,0,134,19.142857142857142,7,0.0,4,23,34,9,33,16,5,10,0,70,64,0
1914,24140,68BjCXfBFqeZ01fFx1csrFmvef5xs0w2,SpATywNh6bZuzm8s1ceuBUnMUAeoAHHw,15,30,20,0,10,12,8,0,80,11.428571428571429,6,0.0,3,20,0,10,27,12,0,8,0,33,47,1
1915,24142,6zt7VkEpMezYkke6xelTowmnsTySao1Z,SpATywNh6bZuzm8s1ceuBUnMUAeoAHHw,17,12,7,8,5,9,2,0,43,6.142857142857143,2,0.0,3,7,7,5,9,9,1,2,0,22,21,1
1916,24146,W41zjpcR5alpzNzSmbyy9bBZYrT6UXxL,RXDvfPUBYFlVdlueBFbLW0mhhAyGEqpt,26,22,19,0,14,0,15,0,70,10.0,3,0.0,1,19,0,14,21,0,0,15,0,34,36,1
1917,24149,yEc0qGRUsnGavj0JPbk8pVtWktClrURk,SpATywNh6bZuzm8s1ceuBUnMUAeoAHHw,24,32,14,22,4,8,11,0,91,13.0,4,0.0,13,14,17,4,19,8,5,11,0,48,43,0
1918,24150,7mxOgTUP9lSjAUBOPZ9fhNEhVSHMvF2J,bWdj2GDclj5ofokWjzoa5jAwMkxCykd6,17,53,10,58,6,17,17,2,163,23.285714285714285,4,0.0,18,10,52,6,35,17,6,17,2,86,77,0
1919,24154,WTCEOd5LeoB3M6qdd6wv5K0UJQNEdjBy,bWdj2GDclj5ofokWjzoa5jAwMkxCykd6,7,2,1,0,1,7,6,1,18,2.5714285714285716,2,0.0,0,1,0,1,2,7,0,6,1,2,16,1
1920,24161,ZRTZW05J88lidJZzll8LtXVXzVI1deNg,SpATywNh6bZuzm8s1ceuBUnMUAeoAHHw,8,8,0,0,0,1,10,0,19,2.7142857142857144,2,0.0,0,0,0,0,8,1,0,10,0,0,19,1
1921,24172,s4TNdVBVykBR8x72RZEnjBx6ebkwwW3k,A3fsA9Zfv1X2fVEQhTw51lKENdNrEqT3,16,10,9,0,9,0,1,0,29,4.142857142857143,1,0.0,0,9,0,9,10,0,0,1,0,18,11,1
1922,24179,gEzMd6gbgpZIm67NWd6vqHpEEo3Eo4i8,RXDvfPUBYFlVdlueBFbLW0mhhAyGEqpt,1,0,0,0,0,0,1,0,1,0.14285714285714285,1,0.0,0,0,0,0,0,0,0,1,0,0,1,1
1923,24187,GlAlbUSi7bTkQeCE1bsVWDk5GBPq0ZBP,bWdj2GDclj5ofokWjzoa5jAwMkxCykd6,10,11,6,16,3,22,7,0,65,9.285714285714286,4,0.0,1,6,15,3,10,22,1,7,0,25,40,1
1924,24188,6my3HLUJsR66IUqoTOpOu4zu43YWvDxI,A3fsA9Zfv1X2fVEQhTw51lKENdNrEqT3,10,16,4,0,1,0,9,0,30,4.285714285714286,2,0.0,2,4,0,1,14,0,0,9,0,7,23,1
1925,24191,VVltscgfR96aweHb5nQdD1Q7dsOwuOJz,A3fsA9Zfv1X2fVEQhTw51lKENdNrEqT3,33,24,0,48,0,0,5,0,77,11.0,2,0.0,1,0,45,0,23,0,3,5,0,46,31,1
1926,24205,KjugBA6V5bkEA5fAIbJoGnSUlDhZoaIH,SpATywNh6bZuzm8s1ceuBUnMUAeoAHHw,17,39,18,0,7,7,12,0,83,11.857142857142858,4,0.0,2,18,0,7,37,7,0,12,0,27,56,0
1927,24210,LpAsllakvdmHNKkTbI74k56UY22DACic,SpATywNh6bZuzm8s1ceuBUnMUAeoAHHw,4,2,1,0,1,0,2,0,6,0.8571428571428571,1,0.0,0,1,0,1,2,0,0,2,0,2,4,1
1928,24228,Kawdpya8bnbVtCe5VJbkVPFzmayWdtI6,SpATywNh6bZuzm8s1ceuBUnMUAeoAHHw,1,0,0,0,0,0,1,0,1,0.14285714285714285,1,0.0,0,0,0,0,0,0,0,1,0,0,1,1
1929,24250,UPb6839zer74dQL1gRcC95mBDcZeCZUO,bWdj2GDclj5ofokWjzoa5jAwMkxCykd6,4,2,1,0,1,0,1,0,5,0.7142857142857143,1,0.0,0,1,0,1,2,0,0,1,0,2,3,1
1930,24255,SvdoxHaqv4If8vTEQE4Ye6pIzdBuUEi9,G8EPVSXsOYB5YQWZGiz1aVq5Pgr2GrQu,9,10,6,0,4,0,3,0,23,3.2857142857142856,1,0.0,4,6,0,4,6,0,0,3,0,14,9,1
1931,24257,L8lHLh6Mth1S7I3sErP5oDZD885a1BOh,A3fsA9Zfv1X2fVEQhTw51lKENdNrEqT3,45,14,6,117,1,0,6,0,144,20.571428571428573,2,0.0,5,6,111,1,9,0,6,6,0,123,21,1
1932,24258,Ne25k1DU4nK81LWo7930HvBFWlFV2ZKt,SpATywNh6bZuzm8s1ceuBUnMUAeoAHHw,27,52,19,29,9,0,15,0,124,17.714285714285715,9,0.0,11,19,28,9,41,0,1,15,0,67,57,0
1933,24260,RxUvz1VnE0RHae7wTLOzUprYmci0pJ08,bWdj2GDclj5ofokWjzoa5jAwMkxCykd6,6,2,1,0,1,0,4,1,9,1.2857142857142858,1,0.0,0,1,0,1,2,0,0,4,1,2,7,1
1934,24283,yZoviGGxgr5NFf9klHeC5PfXfdVd14QP,A3fsA9Zfv1X2fVEQhTw51lKENdNrEqT3,47,28,19,58,10,2,16,2,135,19.285714285714285,3,0.0,1,19,54,10,27,2,4,16,2,84,51,1
1935,24285,Kd69M9W1nim0woqVm1QxfVaSebsYtFIh,RXDvfPUBYFlVdlueBFbLW0mhhAyGEqpt,16,32,13,12,4,1,10,1,73,10.428571428571429,5,0.0,1,13,12,4,31,1,0,10,1,30,43,1
1936,24289,oMQSjsmH1aRsG8joAcNWi5ozsWLu10HK,bWdj2GDclj5ofokWjzoa5jAwMkxCykd6,5,2,1,0,1,0,2,0,6,0.8571428571428571,1,0.0,0,1,0,1,2,0,0,2,0,2,4,1
1937,24290,Ms0MC4W5moiGJLWP7iE3FImeH9CHN4KT,A3fsA9Zfv1X2fVEQhTw51lKENdNrEqT3,6,9,4,0,0,0,6,0,19,2.7142857142857144,3,0.0,0,4,0,0,9,0,0,6,0,4,15,0
1938,24294,j1LAePLDyUZgKcurnBhMK9q8whbJ98ja,SpATywNh6bZuzm8s1ceuBUnMUAeoAHHw,4,2,0,0,0,0,2,0,4,0.5714285714285714,1,0.0,0,0,0,0,2,0,0,2,0,0,4,1
1939,24302,ew0XpK44UZ9NkpDlIMehLaSdbqgabj65,SpATywNh6bZuzm8s1ceuBUnMUAeoAHHw,4,2,1,0,1,0,2,0,6,0.8571428571428571,1,0.0,0,1,0,1,2,0,0,2,0,2,4,1
1940,24313,Evco2d15cNydZMimph5VWFT3j0HfgNP5,SpATywNh6bZuzm8s1ceuBUnMUAeoAHHw,22,24,16,6,10,0,4,0,60,8.571428571428571,3,0.0,5,16,6,10,19,0,0,4,0,37,23,0
1941,24324,W41zjpcR5alpzNzSmbyy9bBZYrT6UXxL,A3fsA9Zfv1X2fVEQhTw51lKENdNrEqT3,12,8,5,0,5,0,3,0,21,3.0,1,0.0,0,5,0,5,8,0,0,3,0,10,11,1
1942,24351,iugl3Rn3u1ci3BiC2tfekDHOQsD5QVGj,A3fsA9Zfv1X2fVEQhTw51lKENdNrEqT3,9,13,6,0,1,1,9,0,30,4.285714285714286,4,0.0,4,6,0,1,9,1,0,9,0,11,19,1
1943,24356,jb05o2Us6b6SE2vZsRGcabjWWbS3vGCF,SpATywNh6bZuzm8s1ceuBUnMUAeoAHHw,1,0,0,0,0,0,2,0,2,0.2857142857142857,1,0.0,0,0,0,0,0,0,0,2,0,0,2,1
1944,24359,WdQwb0B6ZnAdvXskBHP8stZHsjNTkrqQ,SpATywNh6bZuzm8s1ceuBUnMUAeoAHHw,10,11,5,9,1,0,8,0,34,4.857142857142857,1,0.0,1,5,7,1,10,0,2,8,0,14,20,1
1945,24369,dWVj5G83xAxBDmPzLgLHfDC3pxyIk4K1,SpATywNh6bZuzm8s1ceuBUnMUAeoAHHw,1,0,0,0,0,0,3,0,3,0.42857142857142855,1,0.0,0,0,0,0,0,0,0,3,0,0,3,1
1946,24371,1RLhIao7wKT4YvgWBYzjLBBf7hozJmqb,SpATywNh6bZuzm8s1ceuBUnMUAeoAHHw,8,5,1,0,1,1,6,1,15,2.142857142857143,2,0.0,0,1,0,1,5,1,0,6,1,2,13,1
1947,24375,vx3ISVZde9Js9SAljxLNpat5gkbJKEY2,RXDvfPUBYFlVdlueBFbLW0mhhAyGEqpt,20,24,9,14,3,2,12,2,66,9.428571428571429,2,0.0,6,9,13,3,18,2,1,12,2,31,35,0
1948,24384,j1jdy8OF5VQw4rqSYOkbK2pQplvvvz37,SpATywNh6bZuzm8s1ceuBUnMUAeoAHHw,1,0,0,0,0,0,2,0,2,0.2857142857142857,2,0.0,0,0,0,0,0,0,0,2,0,0,2,1
1949,24391,5tGNQxzw9lFd1DSnmxNCdWwVZfTyj1IB,bWdj2GDclj5ofokWjzoa5jAwMkxCykd6,24,33,21,108,8,0,11,0,181,25.857142857142858,6,0.0,4,21,106,8,29,0,2,11,0,139,42,1
1950,24396,WdQwb0B6ZnAdvXskBHP8stZHsjNTkrqQ,A3fsA9Zfv1X2fVEQhTw51lKENdNrEqT3,10,4,1,0,1,0,7,2,15,2.142857142857143,1,0.0,0,1,0,1,4,0,0,7,2,2,13,1
1951,24397,2ZTBzb1Y4dwuOwNiUUSWB6SyHlRXxNso,SpATywNh6bZuzm8s1ceuBUnMUAeoAHHw,31,63,18,25,9,2,9,1,127,18.142857142857142,5,0.0,33,18,25,9,30,2,0,9,1,85,42,1
1952,24418,a3VUGRBh4vIHU6nTy2I0Dl5D5S8VvzQM,SpATywNh6bZuzm8s1ceuBUnMUAeoAHHw,7,3,2,0,2,0,2,0,9,1.2857142857142858,1,0.0,0,2,0,2,3,0,0,2,0,4,5,1
1953,24431,ADFd6U5gb8MuQY2di0urTV7aR0h11Ir1,RXDvfPUBYFlVdlueBFbLW0mhhAyGEqpt,2,0,0,0,0,0,2,0,2,0.2857142857142857,1,0.0,0,0,0,0,0,0,0,2,0,0,2,1
1954,24432,ADFd6U5gb8MuQY2di0urTV7aR0h11Ir1,A3fsA9Zfv1X2fVEQhTw51lKENdNrEqT3,2,0,0,0,0,0,2,0,2,0.2857142857142857,1,0.0,0,0,0,0,0,0,0,2,0,0,2,1
1955,24445,mFNGHC6aCmhHmhRXFCDO0uvnGnNYaro0,bWdj2GDclj5ofokWjzoa5jAwMkxCykd6,14,17,12,14,6,8,7,0,64,9.142857142857142,2,0.0,2,12,12,6,15,8,2,7,0,32,32,1
1956,24447,bSOq11L6zS91mDTcR42LcWMRdkU0Htpv,SpATywNh6bZuzm8s1ceuBUnMUAeoAHHw,4,2,1,0,1,0,1,0,5,0.7142857142857143,1,0.0,0,1,0,1,2,0,0,1,0,2,3,1
1957,24456,AOtTiaeDNx4G2J0NpAHDjb596RxqAAI3,SpATywNh6bZuzm8s1ceuBUnMUAeoAHHw,19,28,10,14,6,2,13,2,75,10.714285714285714,2,0.0,15,10,11,6,13,2,3,13,2,42,33,1
1958,24475,1yAfuEW0CNQiRXnPO0v79LFUyx4hhTWm,bWdj2GDclj5ofokWjzoa5jAwMkxCykd6,6,2,1,0,1,0,5,0,9,1.2857142857142858,1,0.0,0,1,0,1,2,0,0,5,0,2,7,0
1959,24503,VVgqDLLa7j66k9tQU3M7wVOF4BEse4lo,SpATywNh6bZuzm8s1ceuBUnMUAeoAHHw,16,55,17,13,7,1,10,0,103,14.714285714285714,5,0.0,9,17,13,7,46,1,0,10,0,46,57,0
1960,24505,iXoEMwcJ5o4IM7VKZ5pyam9GxPy4olUQ,G8EPVSXsOYB5YQWZGiz1aVq5Pgr2GrQu,4,3,1,0,0,0,3,0,7,1.0,1,0.0,0,1,0,0,3,0,0,3,0,1,6,1
1961,24517,iXoEMwcJ5o4IM7VKZ5pyam9GxPy4olUQ,bWdj2GDclj5ofokWjzoa5jAwMkxCykd6,1,0,0,0,0,0,2,0,2,0.2857142857142857,1,0.0,0,0,0,0,0,0,0,2,0,0,2,1
1962,24536,tE3Bwjiismxnblg3Eq9l6K3IoXQaklnD,bWdj2GDclj5ofokWjzoa5jAwMkxCykd6,1,0,0,0,0,0,1,0,1,0.14285714285714285,1,0.0,0,0,0,0,0,0,0,1,0,0,1,1
1963,24539,tE3Bwjiismxnblg3Eq9l6K3IoXQaklnD,SpATywNh6bZuzm8s1ceuBUnMUAeoAHHw,11,12,1,0,1,0,3,0,17,2.4285714285714284,1,0.0,3,1,0,1,9,0,0,3,0,5,12,1
1964,24542,GW33fgaq0ndGNQkirzfpXhCeUuV3tuD2,SpATywNh6bZuzm8s1ceuBUnMUAeoAHHw,17,25,11,15,4,3,10,1,69,9.857142857142858,2,0.0,9,11,15,4,16,3,0,10,1,39,30,0
1965,24550,qr1Y8xuPrcpdzScNHYsirGXqasfUdOVa,SpATywNh6bZuzm8s1ceuBUnMUAeoAHHw,8,15,7,0,4,0,6,0,32,4.571428571428571,3,0.0,0,7,0,4,15,0,0,6,0,11,21,1
1966,24551,foJyfq5hSUj3jzVw8TG0nT1wv3hLMMNc,G8EPVSXsOYB5YQWZGiz1aVq5Pgr2GrQu,48,73,55,80,32,0,13,0,253,36.142857142857146,5,0.0,2,55,71,32,71,0,9,13,0,160,93,0
1967,24552,foJyfq5hSUj3jzVw8TG0nT1wv3hLMMNc,SpATywNh6bZuzm8s1ceuBUnMUAeoAHHw,25,39,14,24,4,5,11,0,97,13.857142857142858,4,0.0,5,14,24,4,34,5,0,11,0,47,50,0
1968,24569,VeFENcSXAiXgJQaSjlXiodtIBxgSrzaH,A3fsA9Zfv1X2fVEQhTw51lKENdNrEqT3,8,8,3,0,1,0,6,0,18,2.5714285714285716,3,0.0,0,3,0,1,8,0,0,6,0,4,14,1
1969,24572,QDaW6SyhKIOYnUckUXKfy6A7QKIp9Kb8,A3fsA9Zfv1X2fVEQhTw51lKENdNrEqT3,6,0,0,0,0,1,5,0,6,0.8571428571428571,1,0.0,0,0,0,0,0,1,0,5,0,0,6,1
1970,24587,f7pgA2Hp0s8DkqzKuvE0Kw8QRuoBh3Zv,RXDvfPUBYFlVdlueBFbLW0mhhAyGEqpt,48,64,36,82,18,15,8,0,223,31.857142857142858,3,0.0,17,36,75,18,47,15,7,8,0,146,77,0
1971,24601,rhJzZeMBkfw1Q75cLyvgh9HzDvUXe9cc,SpATywNh6bZuzm8s1ceuBUnMUAeoAHHw,4,3,0,0,0,0,4,0,7,1.0,2,0.0,0,0,0,0,3,0,0,4,0,0,7,1
1972,24602,tBWD1VTj6Jcj3AQ0AXY8eZtUzkjmoiNH,SpATywNh6bZuzm8s1ceuBUnMUAeoAHHw,20,36,10,6,5,22,16,1,96,13.714285714285714,4,0.0,7,10,6,5,29,22,0,16,1,28,68,0
1973,24608,S5LJKm1sQOy9mdQmh7HP7gCjw7krEMbq,A3fsA9Zfv1X2fVEQhTw51lKENdNrEqT3,13,6,3,0,3,0,8,0,20,2.857142857142857,3,0.0,0,3,0,3,6,0,0,8,0,6,14,1
1974,24619,0JvlwMe8wRQNeLJu71UvJCaEJca2naUP,7GRhBDsirIGkRZBtSMEzNTyDr2JQm4xx,6,3,2,0,2,0,1,0,8,1.1428571428571428,2,0.0,0,2,0,2,3,0,0,1,0,4,4,1
1975,24632,zn2X74vvqUQRINz90WjZLsSsFglpYr7o,bWdj2GDclj5ofokWjzoa5jAwMkxCykd6,2,0,0,0,0,0,2,0,2,0.2857142857142857,1,0.0,0,0,0,0,0,0,0,2,0,0,2,1
1976,24661,ZgPDgY8Y43cADkyBad03WZKNqaM99vmp,7GRhBDsirIGkRZBtSMEzNTyDr2JQm4xx,32,88,1,53,6,4,25,1,178,25.428571428571427,4,0.0,41,1,43,6,47,4,10,25,1,91,87,0
1977,24680,1VsjBK2ROnIVYUeDYM5LmXmBSaC6415r,7GRhBDsirIGkRZBtSMEzNTyDr2JQm4xx,4,2,1,0,0,0,2,0,5,0.7142857142857143,1,0.0,0,1,0,0,2,0,0,2,0,1,4,1
1978,24744,S6vBzHKpSh31SFGGZmwgKaOH2RvW3RpH,bWdj2GDclj5ofokWjzoa5jAwMkxCykd6,11,21,13,0,6,0,18,0,58,8.285714285714286,3,0.0,0,13,0,6,21,0,0,18,0,19,39,1
1979,24770,JSUd2wnxbPhnPOoSIVdrMCxy8KhaLF4M,7GRhBDsirIGkRZBtSMEzNTyDr2JQm4xx,20,34,17,17,10,0,9,0,87,12.428571428571429,5,0.0,5,17,14,10,29,0,3,9,0,46,41,1
1980,24771,zOqvR5SeTZmNwN7GW7m4oZ7a32WZgEDz,RXDvfPUBYFlVdlueBFbLW0mhhAyGEqpt,10,9,2,0,2,0,4,0,17,2.4285714285714284,1,0.0,0,2,0,2,9,0,0,4,0,4,13,1
1981,24796,8tSKdZ8K9lE8Sg5tXOt7ENrj00lNonld,SpATywNh6bZuzm8s1ceuBUnMUAeoAHHw,14,16,0,18,0,15,9,2,60,8.571428571428571,2,0.0,5,0,15,0,11,15,3,9,2,20,40,0
1982,24805,KRi80h1uK84snC5HvtQKWlsjwt9i3oa5,SpATywNh6bZuzm8s1ceuBUnMUAeoAHHw,12,15,9,7,4,0,4,0,39,5.571428571428571,3,0.0,3,9,6,4,12,0,1,4,0,22,17,0
1983,24823,FCXkOVtASvwM4OqelAOjh7n6TzPCCzLb,7GRhBDsirIGkRZBtSMEzNTyDr2JQm4xx,7,5,3,0,3,0,2,0,13,1.8571428571428572,1,0.0,1,3,0,3,4,0,0,2,0,7,6,1
1984,24824,JEEkuD8nRyQdFWZOzS8kZ8mhHw8bPQH3,7GRhBDsirIGkRZBtSMEzNTyDr2JQm4xx,2,0,0,0,0,0,2,0,2,0.2857142857142857,1,0.0,0,0,0,0,0,0,0,2,0,0,2,1
1985,24834,NsnGWsRio9JsRS5X1oYgeBjF7tc8iDdA,7GRhBDsirIGkRZBtSMEzNTyDr2JQm4xx,40,95,39,85,27,28,17,1,292,41.714285714285715,4,0.0,44,39,74,27,51,28,11,17,1,184,108,1
1986,24836,wuaIkUodYTr49NZ7BbMPsEdpO0t0C8Nt,7GRhBDsirIGkRZBtSMEzNTyDr2JQm4xx,2,0,0,0,0,0,2,0,2,0.2857142857142857,1,0.0,0,0,0,0,0,0,0,2,0,0,2,1
1987,24901,paRtaUir7BROwVpnw69gcE7HkkiPuHFt,7GRhBDsirIGkRZBtSMEzNTyDr2JQm4xx,34,81,6,70,7,8,43,5,220,31.428571428571427,4,0.0,49,6,61,7,32,8,9,43,5,123,97,1
1988,24929,hCRoH0np1tajD5PHKKgVw7dH4NZJLfD2,A3fsA9Zfv1X2fVEQhTw51lKENdNrEqT3,25,20,15,0,10,8,20,7,80,11.428571428571429,4,0.0,0,15,0,10,20,8,0,20,7,25,55,0
1989,24942,DCwFNk2m7QLqdKcTT3u5CdSnRyl5YCHB,SpATywNh6bZuzm8s1ceuBUnMUAeoAHHw,1,0,0,0,0,0,1,0,1,0.14285714285714285,1,0.0,0,0,0,0,0,0,0,1,0,0,1,1
1990,24984,p8pFuUg19xWGOlJygMvSlQjonA3l7FUn,A3fsA9Zfv1X2fVEQhTw51lKENdNrEqT3,21,11,10,0,9,0,1,0,31,4.428571428571429,1,0.0,0,10,0,9,11,0,0,1,0,19,12,0
1991,24996,tLK32ryOHeiJecBcFzaTeN36vYEmQ8Nk,SpATywNh6bZuzm8s1ceuBUnMUAeoAHHw,30,27,13,42,7,8,9,4,110,15.714285714285714,2,0.0,11,13,37,7,16,8,5,9,4,68,42,1
1992,25033,BuZcYQWwWDSVZcqno1RGBiY1PDnVqtUZ,G8EPVSXsOYB5YQWZGiz1aVq5Pgr2GrQu,16,29,18,20,0,1,4,0,72,10.285714285714286,2,0.0,4,18,19,0,25,1,1,4,0,41,31,1
1993,25049,zkOr0wwuxAzYftPuxG6iQaCtbl1egkTS,A3fsA9Zfv1X2fVEQhTw51lKENdNrEqT3,57,60,40,102,16,19,34,4,275,39.285714285714285,4,0.0,9,40,93,16,51,19,9,34,4,158,117,0
1994,25067,aQ6WrdDe9pTNwVW3vmaMOs1pxy5r3Dxa,A3fsA9Zfv1X2fVEQhTw51lKENdNrEqT3,42,26,14,64,8,26,12,0,150,21.428571428571427,2,0.0,1,14,56,8,25,26,8,12,0,79,71,0
1995,25073,WQKoaWRi4j5EUCfZEZsK4LU6GIHATRae,SpATywNh6bZuzm8s1ceuBUnMUAeoAHHw,19,15,8,15,4,9,7,0,58,8.285714285714286,3,0.0,5,8,12,4,10,9,3,7,0,29,29,1
1996,25075,WQKoaWRi4j5EUCfZEZsK4LU6GIHATRae,7GRhBDsirIGkRZBtSMEzNTyDr2JQm4xx,32,48,17,50,14,10,5,0,144,20.571428571428573,2,0.0,29,17,39,14,19,10,11,5,0,99,45,1
1997,25096,i7qRP2nhuaIR2tcQnQvT86ViNtPopbnz,7GRhBDsirIGkRZBtSMEzNTyDr2JQm4xx,11,13,7,0,4,0,7,0,31,4.428571428571429,3,0.0,1,7,0,4,12,0,0,7,0,12,19,1
1998,25111,XQUx3MwVudtjeHmsju8PhHxsdXW0kluK,SpATywNh6bZuzm8s1ceuBUnMUAeoAHHw,15,24,12,12,4,1,5,0,58,8.285714285714286,3,0.0,9,12,12,4,15,1,0,5,0,37,21,0
1999,25118,mBkByOktWGTfbLjZh4oUEAyrYqB4PqkG,7GRhBDsirIGkRZBtSMEzNTyDr2JQm4xx,6,17,3,0,1,0,3,0,24,3.4285714285714284,6,0.0,0,3,0,1,17,0,0,3,0,4,20,1
2000,25182,hGCwfWh9ySQVbALdmRR0HUMpPic5OOrw,bWdj2GDclj5ofokWjzoa5jAwMkxCykd6,7,2,1,0,1,0,5,0,9,1.2857142857142858,1,0.0,1,1,0,1,1,0,0,5,0,3,6,0
2001,25198,w6Jq91nutnXM9db4LCqDd346NIYOr0ts,7GRhBDsirIGkRZBtSMEzNTyDr2JQm4xx,8,6,3,0,0,0,9,0,18,2.5714285714285716,1,0.0,1,3,0,0,5,0,0,9,0,4,14,1
2002,25212,95whmOrr6ttgAKmA8d5EYFggt87ONgHi,SpATywNh6bZuzm8s1ceuBUnMUAeoAHHw,14,22,2,22,2,3,6,0,57,8.142857142857142,2,0.0,14,2,19,2,8,3,3,6,0,37,20,1
2003,25219,skOScgcMIkYsPXikHjLqvicjdb3rv6St,A3fsA9Zfv1X2fVEQhTw51lKENdNrEqT3,5,2,1,0,1,0,2,0,6,0.8571428571428571,1,0.0,0,1,0,1,2,0,0,2,0,2,4,1
2004,25235,BgFWtuiCvZoByaUpZ5qN1JDEWuWXlm2n,G8EPVSXsOYB5YQWZGiz1aVq5Pgr2GrQu,29,54,23,64,8,2,19,2,172,24.571428571428573,2,0.0,20,23,42,8,34,2,22,19,2,93,79,1
2005,25265,9va79rFsgW625mCi6PBHbhUMC5acSS5i,bWdj2GDclj5ofokWjzoa5jAwMkxCykd6,26,25,11,129,10,0,10,2,187,26.714285714285715,2,0.0,12,11,121,10,13,0,8,10,2,154,33,0
2006,25269,E1ioRxhhohHY3rrHygts052gZKXoxwdE,7GRhBDsirIGkRZBtSMEzNTyDr2JQm4xx,7,3,2,0,2,0,2,0,9,1.2857142857142858,1,0.0,0,2,0,2,3,0,0,2,0,4,5,1
2007,25284,6DpgdlGoKRdZ3TeMwKLdUESj04TqApO6,7GRhBDsirIGkRZBtSMEzNTyDr2JQm4xx,29,39,10,61,14,0,3,0,127,18.142857142857142,1,0.0,28,10,52,14,11,0,9,3,0,104,23,1
2008,25295,ETzcC9n39CwhBb4MTbqq1Ng4NqGIoiPj,bWdj2GDclj5ofokWjzoa5jAwMkxCykd6,5,3,1,0,1,0,1,0,6,0.8571428571428571,1,0.0,0,1,0,1,3,0,0,1,0,2,4,1
2009,25371,tMJpDv6ZjEPz2ELzUVp4mZTT6G7u49T6,bWdj2GDclj5ofokWjzoa5jAwMkxCykd6,6,3,1,0,1,0,4,0,9,1.2857142857142858,2,0.0,1,1,0,1,2,0,0,4,0,3,6,0
2010,25376,Evco2d15cNydZMimph5VWFT3j0HfgNP5,7GRhBDsirIGkRZBtSMEzNTyDr2JQm4xx,8,13,4,2,6,1,2,0,28,4.0,2,0.0,6,4,2,6,7,1,0,2,0,18,10,1
2011,25391,1aQoKDna73jstuOrupWa9Kq8V3FdvbRU,A3fsA9Zfv1X2fVEQhTw51lKENdNrEqT3,8,6,3,0,2,0,4,0,15,2.142857142857143,3,0.0,0,3,0,2,6,0,0,4,0,5,10,1
2012,25393,qfUwpJQAdesy8M2BZDMAUMfg4I7ObmXB,7GRhBDsirIGkRZBtSMEzNTyDr2JQm4xx,8,0,0,0,0,0,7,1,8,1.1428571428571428,1,0.0,0,0,0,0,0,0,0,7,1,0,8,1
2013,25406,Ua8t7GvEqkquREwn5gCoNVwYmIqhqGMw,G8EPVSXsOYB5YQWZGiz1aVq5Pgr2GrQu,47,62,33,66,19,32,21,3,236,33.714285714285715,3,0.0,19,33,50,19,43,32,16,21,3,121,115,0
2014,25409,tvH2SB0L50iCqaXyQDY3u7qaByLbL0rV,RXDvfPUBYFlVdlueBFbLW0mhhAyGEqpt,1,0,0,0,0,0,1,0,1,0.14285714285714285,1,0.0,0,0,0,0,0,0,0,1,0,0,1,1
2015,25410,eLRb35TMSz5mhOV1jFWfgFHXl5MBmODw,SpATywNh6bZuzm8s1ceuBUnMUAeoAHHw,4,10,0,0,0,0,3,0,13,1.8571428571428572,2,0.0,0,0,0,0,10,0,0,3,0,0,13,1
2016,25411,zTKXcgMSZF7JvFUNYP705peyaFADazmR,bWdj2GDclj5ofokWjzoa5jAwMkxCykd6,5,2,1,0,1,0,3,0,7,1.0,1,0.0,0,1,0,1,2,0,0,3,0,2,5,0
2017,25414,JGLccTidDHJDu8gDiATpQDW1eozc4icT,G8EPVSXsOYB5YQWZGiz1aVq5Pgr2GrQu,3,3,0,0,0,0,1,0,4,0.5714285714285714,1,0.0,0,0,0,0,3,0,0,1,0,0,4,1
2018,25442,QLGFenndIPaX8I2vSI7keErJ6m5JCAL7,7GRhBDsirIGkRZBtSMEzNTyDr2JQm4xx,9,5,2,2,3,1,5,0,18,2.5714285714285716,1,0.0,3,2,2,3,2,1,0,5,0,10,8,1
2019,25443,rpvfqHO7dPQYBUZWKnS2wc1t5Qy6pGj6,bWdj2GDclj5ofokWjzoa5jAwMkxCykd6,15,39,0,32,3,0,12,0,86,12.285714285714286,4,0.0,9,0,29,3,30,0,3,12,0,41,45,1
2020,25446,cUmqYT3vXiSNkNfCulTfjg26cA62ehB2,SpATywNh6bZuzm8s1ceuBUnMUAeoAHHw,6,2,0,0,0,1,7,1,11,1.5714285714285714,1,0.0,0,0,0,0,2,1,0,7,1,0,11,1
2021,25463,tCXa4pMsMXRuliZWNM9so3Odte6UmpYj,RXDvfPUBYFlVdlueBFbLW0mhhAyGEqpt,10,9,4,0,2,0,4,0,19,2.7142857142857144,1,0.0,2,4,0,2,7,0,0,4,0,8,11,1
2022,25482,M3Xa5IFPEZiaLK2rAjKqcPYFncjR6IsA,7GRhBDsirIGkRZBtSMEzNTyDr2JQm4xx,10,9,6,0,2,0,8,0,25,3.5714285714285716,3,0.0,0,6,0,2,9,0,0,8,0,8,17,1
2023,25503,XQUx3MwVudtjeHmsju8PhHxsdXW0kluK,G8EPVSXsOYB5YQWZGiz1aVq5Pgr2GrQu,6,6,3,0,2,0,4,0,15,2.142857142857143,1,0.0,0,3,0,2,6,0,0,4,0,5,10,1
2024,25511,RtpaISGKG8FC1poFd4XAu8898XLnl6EI,SpATywNh6bZuzm8s1ceuBUnMUAeoAHHw,22,36,15,16,6,10,14,1,98,14.0,2,0.0,8,15,14,6,28,10,2,14,1,43,55,0
2025,25527,qEjaWdK86bYd7lCS9YD68MsK6migCUpH,SpATywNh6bZuzm8s1ceuBUnMUAeoAHHw,14,9,4,10,3,0,6,0,32,4.571428571428571,2,0.0,2,4,9,3,7,0,1,6,0,18,14,0
2026,25546,rfOApTbQ4xF2665bHZIBhoJqQcTU6i9L,A3fsA9Zfv1X2fVEQhTw51lKENdNrEqT3,15,11,8,0,5,0,6,1,31,4.428571428571429,1,0.0,0,8,0,5,11,0,0,6,1,13,18,1
2027,25551,KArM7gUn52riH9ery2Pt8jVzh161mtd5,7GRhBDsirIGkRZBtSMEzNTyDr2JQm4xx,1,0,0,0,0,0,1,0,1,0.14285714285714285,1,0.0,0,0,0,0,0,0,0,1,0,0,1,1
2028,25552,OL3EuzPtZh7LsYXjzzPmtbrDH2VopR0Y,bWdj2GDclj5ofokWjzoa5jAwMkxCykd6,6,8,4,0,1,0,7,0,20,2.857142857142857,1,0.0,0,4,0,1,8,0,0,7,0,5,15,0
2029,25589,3Oka5GvBd9TakXRvr9D5vxoJEhxwuxJA,SpATywNh6bZuzm8s1ceuBUnMUAeoAHHw,23,37,18,26,4,0,17,0,102,14.571428571428571,6,0.0,11,18,26,4,26,0,0,17,0,59,43,0
2030,25599,tSfB7w0NRlNAlyBUvZCESn8JJeD8KUGH,7GRhBDsirIGkRZBtSMEzNTyDr2JQm4xx,6,2,1,0,0,0,3,0,6,0.8571428571428571,1,0.0,0,1,0,0,2,0,0,3,0,1,5,1
2031,25675,wgifE6A0kxnDEjw7myKTY39TRuCgYxaB,A3fsA9Zfv1X2fVEQhTw51lKENdNrEqT3,6,5,0,0,0,0,2,0,7,1.0,1,0.0,0,0,0,0,5,0,0,2,0,0,7,1
2032,25678,8hHM4gMR8PLgcGE0KxgxZ4wD71iRPNWp,RXDvfPUBYFlVdlueBFbLW0mhhAyGEqpt,48,29,12,58,8,0,4,1,112,16.0,1,0.0,8,12,56,8,21,0,2,4,1,84,28,1
2033,25696,Ufo4AkS2vTW82q9Kpcrkrp0gG0Us5zu9,7GRhBDsirIGkRZBtSMEzNTyDr2JQm4xx,11,17,2,0,2,0,4,0,25,3.5714285714285716,2,0.0,0,2,0,2,17,0,0,4,0,4,21,1
2034,25706,udBjfCluZTte9l6GhqqG4v3kEGoKKcxC,SpATywNh6bZuzm8s1ceuBUnMUAeoAHHw,17,35,16,11,8,27,16,3,116,16.571428571428573,4,0.0,14,16,9,8,21,27,2,16,3,47,69,0
2035,25720,v0qndwa3TlbOqgdTUBH2afnl049VDWzU,SpATywNh6bZuzm8s1ceuBUnMUAeoAHHw,15,19,10,12,3,0,4,0,48,6.857142857142857,4,0.0,4,10,12,3,15,0,0,4,0,29,19,0
2036,25761,Y3GsHv1t2an649bMll1LdxvN2SIICjxG,SpATywNh6bZuzm8s1ceuBUnMUAeoAHHw,6,3,2,0,2,0,2,0,9,1.2857142857142858,2,0.0,0,2,0,2,3,0,0,2,0,4,5,0
2037,25773,xYLJB56SVkFUOdT5vN3Qq6OYNlnP0Fjc,7GRhBDsirIGkRZBtSMEzNTyDr2JQm4xx,40,144,54,36,23,0,14,0,271,38.714285714285715,7,0.0,10,54,33,23,134,0,3,14,0,120,151,1
2038,25804,E7Frt6tr6owhsgLSRkD2PqDaTSKmNLId,7GRhBDsirIGkRZBtSMEzNTyDr2JQm4xx,5,2,1,0,1,0,4,0,8,1.1428571428571428,2,0.0,0,1,0,1,2,0,0,4,0,2,6,1
2039,25816,lMefkcgNh5NMvOXiUOkNuemhw07vFq2i,SpATywNh6bZuzm8s1ceuBUnMUAeoAHHw,5,2,1,0,1,0,2,0,6,0.8571428571428571,1,0.0,0,1,0,1,2,0,0,2,0,2,4,0
2040,25826,mLf710wFmDQbZB0X7jv0DPpqMqjMZwPk,SpATywNh6bZuzm8s1ceuBUnMUAeoAHHw,16,31,19,20,9,22,19,6,126,18.0,1,0.0,4,19,18,9,27,22,2,19,6,50,76,1
2041,25882,N3h2N9w5PnUvhnv2E14KTv0J7vawpbdm,7GRhBDsirIGkRZBtSMEzNTyDr2JQm4xx,1,0,0,0,0,0,1,0,1,0.14285714285714285,1,0.0,0,0,0,0,0,0,0,1,0,0,1,1
2042,25900,NRMzH6tZyLT2qk2QIkwNRbUliCMPz2WK,A3fsA9Zfv1X2fVEQhTw51lKENdNrEqT3,18,13,11,0,9,0,3,0,36,5.142857142857143,2,0.0,0,11,0,9,13,0,0,3,0,20,16,0
2043,25927,OrVbBbY1FlOrLC1xq9uXlMrFdoBE11eg,SpATywNh6bZuzm8s1ceuBUnMUAeoAHHw,17,27,11,6,4,39,13,5,105,15.0,2,0.0,10,11,6,4,17,39,0,13,5,31,74,0
2044,25939,Krxyy23fZ28ymHlUM9cR68oteYOpMEoc,bWdj2GDclj5ofokWjzoa5jAwMkxCykd6,6,7,2,0,0,0,5,0,14,2.0,2,0.0,2,2,0,0,5,0,0,5,0,4,10,0
2045,25944,Q0eCH09NIGOawcyrOKgsrxZbMJuOLuiw,7GRhBDsirIGkRZBtSMEzNTyDr2JQm4xx,1,0,0,0,0,0,3,0,3,0.42857142857142855,1,0.0,0,0,0,0,0,0,0,3,0,0,3,1
2046,25945,Xl7O5Es6VpkB2PrTgzArkv7OwJ7XzlEg,SpATywNh6bZuzm8s1ceuBUnMUAeoAHHw,18,46,17,12,7,24,15,1,122,17.428571428571427,4,0.0,21,17,12,7,25,24,0,15,1,57,65,0
2047,25956,iHFiZ9SvBVcIu7YGo4eFTUpkfFG44jX7,SpATywNh6bZuzm8s1ceuBUnMUAeoAHHw,23,62,21,17,9,4,31,2,146,20.857142857142858,6,0.0,11,21,14,9,51,4,3,31,2,55,91,0
2048,25959,E31WqWw5nCEWlSKgmhsOSj5j4T79ypCl,7GRhBDsirIGkRZBtSMEzNTyDr2JQm4xx,33,87,39,65,18,0,7,0,216,30.857142857142858,3,0.0,39,39,52,18,48,0,13,7,0,148,68,1
2049,26008,HPaJ9EDG8HjC5rpTdpwlfh4gznoH5Kdn,7GRhBDsirIGkRZBtSMEzNTyDr2JQm4xx,5,3,1,0,1,0,6,0,11,1.5714285714285714,1,0.0,0,1,0,1,3,0,0,6,0,2,9,1
2050,26009,RADrfrSrqd2D1lhkJRYdtWMv0TybV2Zk,A3fsA9Zfv1X2fVEQhTw51lKENdNrEqT3,8,7,2,0,2,0,2,0,13,1.8571428571428572,1,0.0,0,2,0,2,7,0,0,2,0,4,9,1
2051,26020,Jag1EXQWfAuTRiCgcVLyhRRkdOL9RtSD,A3fsA9Zfv1X2fVEQhTw51lKENdNrEqT3,45,21,13,58,10,9,10,1,122,17.428571428571427,3,0.0,1,13,51,10,20,9,7,10,1,75,47,1
2052,26024,niLMw8MCObO7SSR2V1jNg9WQt5oSjDFJ,7GRhBDsirIGkRZBtSMEzNTyDr2JQm4xx,13,14,6,6,4,0,6,0,36,5.142857142857143,3,0.0,3,6,6,4,11,0,0,6,0,19,17,1
2053,26045,XDpGoHZOK8VrEEa7PvW4PqKqVXXJAMd4,7GRhBDsirIGkRZBtSMEzNTyDr2JQm4xx,19,22,11,0,10,0,6,0,49,7.0,1,0.0,8,11,0,10,14,0,0,6,0,29,20,1
2054,26064,bmnzCBeFMMY9XczD2LcVJyXeCKQk1fV4,bWdj2GDclj5ofokWjzoa5jAwMkxCykd6,4,0,0,0,0,4,5,0,9,1.2857142857142858,2,0.0,0,0,0,0,0,4,0,5,0,0,9,0
2055,26078,ByDjTuY0oLVzrle7JgW0XGlu5bLAo5Uj,SpATywNh6bZuzm8s1ceuBUnMUAeoAHHw,23,47,1,30,0,7,11,0,96,13.714285714285714,5,0.0,14,1,27,0,33,7,3,11,0,42,54,0
2056,26118,BoHg0aGtLUBHCRED1C89CbXgNAVI0w1o,7GRhBDsirIGkRZBtSMEzNTyDr2JQm4xx,7,5,1,0,0,0,4,0,10,1.4285714285714286,1,0.0,0,1,0,0,5,0,0,4,0,1,9,1
2057,26153,WDOhUt18DNMCYDEG35QkOfLroSJB0yOR,7GRhBDsirIGkRZBtSMEzNTyDr2JQm4xx,31,43,11,78,7,2,10,0,151,21.571428571428573,4,0.0,30,11,66,7,13,2,12,10,0,114,37,0
2058,26214,SB3PBvXY4EEkcNDmtIOX6bpu8RFJOU8W,G8EPVSXsOYB5YQWZGiz1aVq5Pgr2GrQu,40,59,20,65,0,12,9,2,167,23.857142857142858,5,0.0,33,20,43,0,26,12,22,9,2,96,71,1
2059,26240,2EOw8IdpJR7gJqo77SwHRhwFw89UUu0T,7GRhBDsirIGkRZBtSMEzNTyDr2JQm4xx,1,0,0,0,0,0,1,0,1,0.14285714285714285,1,0.0,0,0,0,0,0,0,0,1,0,0,1,1
2060,26245,SrYdmWsdLgR34Xuoeb5msz3OavGm9rEt,SpATywNh6bZuzm8s1ceuBUnMUAeoAHHw,11,10,5,0,4,0,6,0,25,3.5714285714285716,2,0.0,0,5,0,4,10,0,0,6,0,9,16,0
2061,26268,tynbQ4TjTy74SqA5UqLPd55W0CYMmxkv,bWdj2GDclj5ofokWjzoa5jAwMkxCykd6,35,47,26,168,11,42,18,3,315,45.0,3,0.0,10,26,142,11,37,42,26,18,3,189,126,0
2062,26275,PSNpE96w64UzqJ7izDn4zKyoyc3uU8P4,SpATywNh6bZuzm8s1ceuBUnMUAeoAHHw,17,19,11,20,4,7,10,2,73,10.428571428571429,3,0.0,4,11,16,4,15,7,4,10,2,35,38,0
2063,26300,skOScgcMIkYsPXikHjLqvicjdb3rv6St,G8EPVSXsOYB5YQWZGiz1aVq5Pgr2GrQu,5,3,1,0,1,1,6,0,12,1.7142857142857142,1,0.0,0,1,0,1,3,1,0,6,0,2,10,1
2064,26317,Ke04PwAVtaYumEPrCNIyUmIZgpnMElWJ,SpATywNh6bZuzm8s1ceuBUnMUAeoAHHw,19,36,20,9,8,0,7,0,80,11.428571428571429,4,0.0,0,20,8,8,36,0,1,7,0,36,44,1
2065,26327,WXFtCer94iMbYlxH69t15Pw03EngjneX,7GRhBDsirIGkRZBtSMEzNTyDr2JQm4xx,5,3,1,0,0,0,4,0,8,1.1428571428571428,2,0.0,0,1,0,0,3,0,0,4,0,1,7,1
2066,26340,nLSyDmuwtZ9VcSdeL7kW6FG97w0wmm94,SpATywNh6bZuzm8s1ceuBUnMUAeoAHHw,11,19,5,10,1,0,4,0,39,5.571428571428571,2,0.0,9,5,10,1,10,0,0,4,0,25,14,0
2067,26357,BNkiF9A7J88AJfBxuk7BTxSVookFJYSj,SpATywNh6bZuzm8s1ceuBUnMUAeoAHHw,13,19,0,17,0,25,14,2,77,11.0,2,0.0,5,0,15,0,14,25,2,14,2,20,57,0
2068,26390,4BpRE14XuCFERPNFltqE4ojcMHw6pKyT,SpATywNh6bZuzm8s1ceuBUnMUAeoAHHw,17,21,12,10,6,0,3,0,52,7.428571428571429,1,0.0,7,12,9,6,14,0,1,3,0,34,18,0
2069,26398,x4ez09GGWUnioTSf6qckx5goNY5giLKq,7GRhBDsirIGkRZBtSMEzNTyDr2JQm4xx,31,77,39,87,8,11,18,1,241,34.42857142857143,5,0.0,26,39,76,8,51,11,11,18,1,149,92,0
2070,26399,Ke04PwAVtaYumEPrCNIyUmIZgpnMElWJ,A3fsA9Zfv1X2fVEQhTw51lKENdNrEqT3,7,6,4,0,3,0,3,0,16,2.2857142857142856,2,0.0,0,4,0,3,6,0,0,3,0,7,9,1
2071,26424,jDvQIlE5Sz6V9SpiJ3fC38kGJJ76UIjp,7GRhBDsirIGkRZBtSMEzNTyDr2JQm4xx,8,3,1,0,1,1,8,0,14,2.0,1,0.0,0,1,0,1,3,1,0,8,0,2,12,1
2072,26430,LqtuGUVCKWBEA86X4uy5b4ZjnXPoVVJt,SpATywNh6bZuzm8s1ceuBUnMUAeoAHHw,12,14,1,19,1,4,4,0,43,6.142857142857143,2,0.0,6,1,17,1,8,4,2,4,0,25,18,0
2073,26436,J7iejq5NtsfdHjPTK3MrPhGPRoJN9WrB,A3fsA9Zfv1X2fVEQhTw51lKENdNrEqT3,56,33,24,84,15,2,16,1,175,25.0,2,0.0,3,24,81,15,30,2,3,16,1,123,52,0
2074,26453,qIRkU6GTErqHGiePGqqQmQyg81Pc8mmk,SpATywNh6bZuzm8s1ceuBUnMUAeoAHHw,27,22,17,10,10,14,8,1,82,11.714285714285714,2,0.0,0,17,9,10,22,14,1,8,1,36,46,1
2075,26460,oNf6qoW6E6dhoPJKSUjvElFlUKN9drLY,SpATywNh6bZuzm8s1ceuBUnMUAeoAHHw,17,31,16,12,10,1,7,0,77,11.0,2,0.0,11,16,12,10,20,1,0,7,0,49,28,0
2076,26464,xioMf6frC9P8sc1cIrYLanKwZwDuxRiz,G8EPVSXsOYB5YQWZGiz1aVq5Pgr2GrQu,85,78,22,248,14,3,16,1,382,54.57142857142857,4,0.0,55,22,175,14,23,3,73,16,1,266,116,0
2077,26489,PD0QXI0Ip2PVwJ6kJaKkkINkj7BvGZMC,SpATywNh6bZuzm8s1ceuBUnMUAeoAHHw,6,6,0,0,0,0,3,0,9,1.2857142857142858,1,0.0,0,0,0,0,6,0,0,3,0,0,9,0
2078,26497,lHqsd1041AF6CV0C0CnR0FxJTQGWXgTK,SpATywNh6bZuzm8s1ceuBUnMUAeoAHHw,12,14,1,17,0,27,4,0,63,9.0,2,0.0,5,1,15,0,9,27,2,4,0,21,42,1
2079,26500,0jMOLkd6bX5LTqVnq5W50RF0alCjmWfd,SpATywNh6bZuzm8s1ceuBUnMUAeoAHHw,12,15,1,12,0,0,3,0,31,4.428571428571429,2,0.0,6,1,11,0,9,0,1,3,0,18,13,0
2080,26514,IJmtizRHLdF3WotHNxwRcdFjzienWtJz,bWdj2GDclj5ofokWjzoa5jAwMkxCykd6,10,18,11,8,3,0,8,0,48,6.857142857142857,3,0.0,2,11,8,3,16,0,0,8,0,24,24,1
2081,26528,CiVcRubRqdt8MrzyUg75lzZmUZcaVQVo,SpATywNh6bZuzm8s1ceuBUnMUAeoAHHw,17,22,13,14,4,0,3,0,56,8.0,2,0.0,5,13,12,4,17,0,2,3,0,34,22,0
2082,26561,kg6Avyi36lrn1xiUPv7mqR2okQaeNtUx,7GRhBDsirIGkRZBtSMEzNTyDr2JQm4xx,5,5,4,0,3,0,1,0,13,1.8571428571428572,1,0.0,0,4,0,3,5,0,0,1,0,7,6,1
2083,26574,kSTg1JLYdhltSJsPuKhUcTkKXIqnVUW2,SpATywNh6bZuzm8s1ceuBUnMUAeoAHHw,25,69,2,23,1,15,23,2,135,19.285714285714285,3,0.0,6,2,21,1,63,15,2,23,2,30,105,1
2084,26590,5pjAdY5K4FfgQPLSzQKwXaKF78ph9a0y,bWdj2GDclj5ofokWjzoa5jAwMkxCykd6,15,19,8,32,4,0,10,1,74,10.571428571428571,3,0.0,4,8,29,4,15,0,3,10,1,45,29,0
2085,26610,xzPjA6KrslcE6S6chFTjdwgsvoAelzjQ,G8EPVSXsOYB5YQWZGiz1aVq5Pgr2GrQu,87,79,20,180,12,3,17,1,312,44.57142857142857,5,0.0,52,20,119,12,27,3,61,17,1,203,109,0
2086,26624,bwFkbWIAdNVUMLQhE1w1MjvyFVabaAgW,SpATywNh6bZuzm8s1ceuBUnMUAeoAHHw,15,16,6,20,3,1,9,1,56,8.0,2,0.0,7,6,16,3,9,1,4,9,1,32,24,0
2087,26634,rrQbAPV4QBpP2BW10bzZtz96beXLch00,SpATywNh6bZuzm8s1ceuBUnMUAeoAHHw,14,19,14,6,12,17,6,0,74,10.571428571428571,1,0.0,4,14,6,12,15,17,0,6,0,36,38,1
2088,26640,RbUxQb46RHLKt8MRdcRI6KFNQeGEWd4E,7GRhBDsirIGkRZBtSMEzNTyDr2JQm4xx,37,94,36,48,12,23,20,3,236,33.714285714285715,6,0.0,47,36,41,12,47,23,7,20,3,136,100,1
2089,26655,hkI32MAgHvJ4T3I3Up79daEJ8l4sKHaC,7GRhBDsirIGkRZBtSMEzNTyDr2JQm4xx,7,4,2,2,2,0,1,0,11,1.5714285714285714,1,0.0,1,2,2,2,3,0,0,1,0,7,4,1
2090,26657,KPcfuz5VL4gtxrf9oXg3NuCUgo5lfp0J,7GRhBDsirIGkRZBtSMEzNTyDr2JQm4xx,16,26,3,19,0,1,9,1,59,8.428571428571429,3,0.0,8,3,18,0,18,1,1,9,1,29,30,1
2091,26672,XN0YlXkOOCzzQkjkPHbmHYzBt2kMHbPM,G8EPVSXsOYB5YQWZGiz1aVq5Pgr2GrQu,18,25,1,10,1,0,6,0,43,6.142857142857143,1,0.0,4,1,6,1,21,0,4,6,0,12,31,0
2092,26720,DsLjooCLnfZ8B5pzT2arifZ6SOAto1Wc,SpATywNh6bZuzm8s1ceuBUnMUAeoAHHw,8,4,2,0,2,0,3,1,12,1.7142857142857142,1,0.0,0,2,0,2,4,0,0,3,1,4,8,1
2093,26750,7J9JIWVCQG1g6yXh3uTVbrSu3pa18Ezn,A3fsA9Zfv1X2fVEQhTw51lKENdNrEqT3,14,8,6,0,4,3,7,0,28,4.0,1,0.0,0,6,0,4,8,3,0,7,0,10,18,1
2094,26754,GLksmLIo4jY0swb77XkCz4Oz6WJw9kTq,bWdj2GDclj5ofokWjzoa5jAwMkxCykd6,8,6,2,42,3,0,1,0,54,7.714285714285714,1,0.0,3,2,40,3,3,0,2,1,0,48,6,1
2095,26763,6gAyvwJKSeHOrljTS7vTc1U71cPBh7nb,RXDvfPUBYFlVdlueBFbLW0mhhAyGEqpt,60,85,12,116,7,0,8,0,228,32.57142857142857,4,0.0,18,12,107,7,67,0,9,8,0,144,84,0
2096,26770,H7bZ54NuzkB5Nw5q0ZI1nld9qDoHNngL,7GRhBDsirIGkRZBtSMEzNTyDr2JQm4xx,4,2,1,0,0,0,3,0,6,0.8571428571428571,2,0.0,0,1,0,0,2,0,0,3,0,1,5,1
2097,26774,HQOz3dJ2hZ8qbl5l8pp7OKuPIeM9Xh55,G8EPVSXsOYB5YQWZGiz1aVq5Pgr2GrQu,32,50,25,56,10,4,7,3,155,22.142857142857142,1,0.0,19,25,43,10,31,4,13,7,3,97,58,0
2098,26801,q2xQCstASp96wpspi8iqsuaqJ7gzfsux,SpATywNh6bZuzm8s1ceuBUnMUAeoAHHw,19,23,11,24,0,0,5,0,63,9.0,4,0.0,6,11,19,0,17,0,5,5,0,36,27,0
2099,26812,8b4CSrjMjmc5Jmqnv833uCnAad4TIcFZ,A3fsA9Zfv1X2fVEQhTw51lKENdNrEqT3,39,16,14,92,13,3,6,0,144,20.571428571428573,2,0.0,1,14,78,13,15,3,14,6,0,106,38,0
2100,26816,HCwyZ32TalGxA6ZNHNOB04su4fWSeWBj,A3fsA9Zfv1X2fVEQhTw51lKENdNrEqT3,19,15,9,0,6,2,8,1,41,5.857142857142857,3,0.0,0,9,0,6,15,2,0,8,1,15,26,0
2101,26823,oidXTGaCUuuF1QPNvhmiPoqhWsTY245r,7GRhBDsirIGkRZBtSMEzNTyDr2JQm4xx,19,21,12,0,7,0,4,0,44,6.285714285714286,4,0.0,3,12,0,7,18,0,0,4,0,22,22,1
2102,26863,erDgXJOtYMWq3DbmDGyxl8sIhvZ9oKFE,SpATywNh6bZuzm8s1ceuBUnMUAeoAHHw,11,18,0,6,0,1,3,1,29,4.142857142857143,1,0.0,4,0,5,0,14,1,1,3,1,9,20,0
2103,26877,nE23LYiQpabdXkj6YvKSja9sZnHRizmo,bWdj2GDclj5ofokWjzoa5jAwMkxCykd6,7,11,2,0,0,10,6,0,29,4.142857142857143,6,0.0,0,2,0,0,11,10,0,6,0,2,27,0
2104,26902,wlMzjZIA65JiQ9JE1VQhTzG17NZZPeo3,SpATywNh6bZuzm8s1ceuBUnMUAeoAHHw,28,129,26,54,5,54,49,1,318,45.42857142857143,11,0.0,40,26,44,5,89,54,10,49,1,115,203,0
2105,26903,1YVr5Tebgu8QXWBg3164QQg1YdmUcYYo,7GRhBDsirIGkRZBtSMEzNTyDr2JQm4xx,6,9,3,0,1,2,6,0,21,3.0,1,0.0,0,3,0,1,9,2,0,6,0,4,17,1
2106,26907,sTDzO3bjgLIIYNoWgHN2HiaPZw68DTyo,7GRhBDsirIGkRZBtSMEzNTyDr2JQm4xx,8,12,5,0,3,1,6,1,28,4.0,4,0.0,0,5,0,3,12,1,0,6,1,8,20,0
2107,26928,0eeJP6MiDq1cOnP8cGxNMZEXCvgY0tHY,SpATywNh6bZuzm8s1ceuBUnMUAeoAHHw,13,24,8,18,3,1,1,0,55,7.857142857142857,1,0.0,13,8,15,3,11,1,3,1,0,39,16,0
2108,26931,luNGlNTmJ26UVXohAPNf4yZNgIUDcpxK,SpATywNh6bZuzm8s1ceuBUnMUAeoAHHw,21,24,15,2,7,0,8,0,56,8.0,7,0.0,1,15,2,7,23,0,0,8,0,25,31,0
2109,26940,EQUZwbG72sVIvQVavXNV7pB9UhkYp9aI,SpATywNh6bZuzm8s1ceuBUnMUAeoAHHw,32,42,19,30,8,72,11,2,184,26.285714285714285,2,0.0,15,19,26,8,27,72,4,11,2,68,116,0
2110,26955,V44Q36yyz0HxZhlrCwrLJjYwv8UzqoCn,A3fsA9Zfv1X2fVEQhTw51lKENdNrEqT3,4,3,1,0,0,0,1,0,5,0.7142857142857143,1,0.0,0,1,0,0,3,0,0,1,0,1,4,1
2111,27085,Y1uVq657IWCue4abNsh62IVHKtmwsQHQ,SpATywNh6bZuzm8s1ceuBUnMUAeoAHHw,12,6,4,0,3,2,6,1,22,3.142857142857143,1,0.0,0,4,0,3,6,2,0,6,1,7,15,0
2112,27087,1sf1a7OMEvwky5hvLFD12TaOsmoNw2Qb,G8EPVSXsOYB5YQWZGiz1aVq5Pgr2GrQu,47,67,34,176,13,0,12,0,302,43.142857142857146,5,0.0,8,34,148,13,59,0,28,12,0,203,99,0
2113,27114,aI6LGLI5TSvCsqcL1v38BDwXz2AdVe9U,7GRhBDsirIGkRZBtSMEzNTyDr2JQm4xx,1,0,0,0,0,0,1,0,1,0.14285714285714285,1,0.0,0,0,0,0,0,0,0,1,0,0,1,1
2114,27140,9zKzyrDc2ZLmZJn8iNzeeCTIcbRbidfo,A3fsA9Zfv1X2fVEQhTw51lKENdNrEqT3,6,6,2,0,1,0,2,0,11,1.5714285714285714,1,0.0,0,2,0,1,6,0,0,2,0,3,8,0
2115,27145,5pjAdY5K4FfgQPLSzQKwXaKF78ph9a0y,A3fsA9Zfv1X2fVEQhTw51lKENdNrEqT3,27,15,12,6,11,1,9,0,54,7.714285714285714,3,0.0,2,12,6,11,13,1,0,9,0,31,23,0
2116,27154,zi3yOAhUK1J3AbYoEq9VqjXWOhiWlKvY,SpATywNh6bZuzm8s1ceuBUnMUAeoAHHw,26,70,4,33,2,34,11,1,155,22.142857142857142,6,0.0,26,4,28,2,44,34,5,11,1,60,95,0
2117,27206,5pjAdY5K4FfgQPLSzQKwXaKF78ph9a0y,7GRhBDsirIGkRZBtSMEzNTyDr2JQm4xx,7,20,6,0,1,0,6,0,33,4.714285714285714,4,0.0,8,6,0,1,12,0,0,6,0,15,18,0
2118,27209,147kfUKOVzUnQEgEhu4oFkvvuFRbAg9Y,bWdj2GDclj5ofokWjzoa5jAwMkxCykd6,7,8,4,0,1,6,5,1,25,3.5714285714285716,3,0.0,0,4,0,1,8,6,0,5,1,5,20,1
2119,27213,S0nQm2eOAlSxKM1RfeGoUgB4GQEZsJ1U,SpATywNh6bZuzm8s1ceuBUnMUAeoAHHw,29,57,21,30,12,21,33,11,185,26.428571428571427,3,0.0,16,21,28,12,41,21,2,33,11,77,108,0
2120,27220,SqRpmgv1gGFKN06wuAdrCbdyqbZyrZkj,bWdj2GDclj5ofokWjzoa5jAwMkxCykd6,5,4,1,0,0,0,3,0,8,1.1428571428571428,1,0.0,0,1,0,0,4,0,0,3,0,1,7,1
2121,27229,vvW1UkV9WqtfmPMhz7QIGvDdFqIvY2j3,7GRhBDsirIGkRZBtSMEzNTyDr2JQm4xx,1,0,0,0,0,0,1,0,1,0.14285714285714285,1,0.0,0,0,0,0,0,0,0,1,0,0,1,1
2122,27230,uciz4weP1kSziQB1Oe1Psu4CdK1uNqzl,SpATywNh6bZuzm8s1ceuBUnMUAeoAHHw,12,21,9,19,3,5,6,2,65,9.285714285714286,1,0.0,8,9,16,3,13,5,3,6,2,36,29,0
2123,27257,ilQqtG05VEreri5rVwRPOodDRvBSi2Yp,7GRhBDsirIGkRZBtSMEzNTyDr2JQm4xx,6,9,0,2,0,0,2,0,13,1.8571428571428572,1,0.0,1,0,2,0,8,0,0,2,0,3,10,1
2124,27261,xk5bwSTEAMNKyEU3iNkOO0oTip8zPc6K,7GRhBDsirIGkRZBtSMEzNTyDr2JQm4xx,3,0,0,0,0,3,3,0,6,0.8571428571428571,1,0.0,0,0,0,0,0,3,0,3,0,0,6,1
2125,27263,X5ugOWLhdmTxo3CYqfXWDVoDsvjcSnkc,SpATywNh6bZuzm8s1ceuBUnMUAeoAHHw,23,44,19,28,5,7,19,2,124,17.714285714285715,6,0.0,13,19,24,5,31,7,4,19,2,61,63,0
2126,27277,DTD40RjYwLBuwaHKa3c3iphTurXVm83S,7GRhBDsirIGkRZBtSMEzNTyDr2JQm4xx,2,0,0,0,0,0,3,0,3,0.42857142857142855,1,0.0,0,0,0,0,0,0,0,3,0,0,3,1
2127,27284,0vYe49xmwT3tPlTtY6ubPLznONbIxbXe,7GRhBDsirIGkRZBtSMEzNTyDr2JQm4xx,5,6,2,0,0,0,5,0,13,1.8571428571428572,1,0.0,0,2,0,0,6,0,0,5,0,2,11,1
2128,27306,tTMyaWTlizKdT72ief23Wjd2wqSzEHSk,bWdj2GDclj5ofokWjzoa5jAwMkxCykd6,2,0,0,0,0,0,3,0,3,0.42857142857142855,1,0.0,0,0,0,0,0,0,0,3,0,0,3,0
2129,27313,rUrD3vOZKxi004QKs8MuR2Ws6PqRB5Bd,SpATywNh6bZuzm8s1ceuBUnMUAeoAHHw,12,14,6,18,3,0,1,0,42,6.0,1,0.0,7,6,16,3,7,0,2,1,0,32,10,1
2130,27318,qOCeRyabO4TOWDJBtcnFq6ksxPSapJ0M,7GRhBDsirIGkRZBtSMEzNTyDr2JQm4xx,6,6,1,0,1,0,2,0,10,1.4285714285714286,1,0.0,0,1,0,1,6,0,0,2,0,2,8,1
2131,27386,jQaCxlcrIW3B0ti76HtzjtRZOLJHPbzy,RXDvfPUBYFlVdlueBFbLW0mhhAyGEqpt,23,53,30,0,3,162,34,17,299,42.714285714285715,7,0.0,0,30,0,3,53,162,0,34,17,33,266,0
2132,27387,FFlICu8a1PeaY8oKBFESJAT3q6I5h6Xu,SpATywNh6bZuzm8s1ceuBUnMUAeoAHHw,20,36,17,10,5,4,8,0,80,11.428571428571429,5,0.0,8,17,9,5,28,4,1,8,0,39,41,0
2133,27397,bdtPawZirEzy4zJwBHLye0XuKdBDsRNa,7GRhBDsirIGkRZBtSMEzNTyDr2JQm4xx,1,0,0,0,0,0,1,0,1,0.14285714285714285,1,0.0,0,0,0,0,0,0,0,1,0,0,1,1
2134,27401,BvCRPlMfMau2kDEBEjyV1l6RJMQy5B5l,7GRhBDsirIGkRZBtSMEzNTyDr2JQm4xx,14,24,7,42,0,0,4,0,77,11.0,1,0.0,9,7,34,0,15,0,8,4,0,50,27,1
2135,27402,GDOD5H0bl28RO8whBIu6B8qS2nGsRznY,A3fsA9Zfv1X2fVEQhTw51lKENdNrEqT3,4,2,1,0,1,0,2,0,6,0.8571428571428571,2,0.0,0,1,0,1,2,0,0,2,0,2,4,1
2136,27418,46ijefZyx5KF4YGCmdayIapXrAG6omzt,SpATywNh6bZuzm8s1ceuBUnMUAeoAHHw,8,5,2,6,0,0,2,0,15,2.142857142857143,2,0.0,2,2,6,0,3,0,0,2,0,10,5,0
2137,27441,xaMkz5ExnwaMxZxilE1ZpVj0K68325xB,7GRhBDsirIGkRZBtSMEzNTyDr2JQm4xx,31,63,22,42,12,0,6,0,145,20.714285714285715,2,0.0,18,22,36,12,45,0,6,6,0,88,57,1
2138,27445,M5fmtGmpo2DUfH2kBcBzBwkDFjGnGDqf,7GRhBDsirIGkRZBtSMEzNTyDr2JQm4xx,12,19,1,0,0,17,4,0,41,5.857142857142857,1,0.0,1,1,0,0,18,17,0,4,0,2,39,1
2139,27448,h5vEAVTb94xGNGjpn4Ohi5mNcXfM0rMl,7GRhBDsirIGkRZBtSMEzNTyDr2JQm4xx,20,51,6,3,7,0,10,0,77,11.0,4,0.0,15,6,3,7,36,0,0,10,0,31,46,1
2140,27464,XLmXRx6QIJBEWZLK5otMq8wfQNXonT4D,SpATywNh6bZuzm8s1ceuBUnMUAeoAHHw,11,17,5,4,3,0,1,0,30,4.285714285714286,3,0.0,2,5,4,3,15,0,0,1,0,14,16,0
2141,27466,rQQvHNajcjjfIyLOReFtjaD8d9v2FigP,7GRhBDsirIGkRZBtSMEzNTyDr2JQm4xx,3,0,0,0,0,0,5,0,5,0.7142857142857143,1,0.0,0,0,0,0,0,0,0,5,0,0,5,1
2142,27473,xYJiCXQflcZ5NTqhkCBqQygWsRlPt9ao,7GRhBDsirIGkRZBtSMEzNTyDr2JQm4xx,4,4,2,0,0,42,2,0,50,7.142857142857143,2,0.0,1,2,0,0,3,42,0,2,0,3,47,1
2143,27475,mEMC3mPRFcLDpf0MVM7Pji9FNHa590x9,SpATywNh6bZuzm8s1ceuBUnMUAeoAHHw,9,5,2,12,0,7,5,0,31,4.428571428571429,1,0.0,2,2,9,0,3,7,3,5,0,13,18,1
2144,27477,pz4WzmrapGULqEk99lfOZVzJbwiC2Cl1,SpATywNh6bZuzm8s1ceuBUnMUAeoAHHw,13,15,0,12,0,8,6,0,41,5.857142857142857,3,0.0,4,0,12,0,11,8,0,6,0,16,25,0
2145,27478,dgp1qm7PjXoVV4MjyzuvWetQrJ3T9kos,7GRhBDsirIGkRZBtSMEzNTyDr2JQm4xx,37,97,45,48,21,52,29,6,298,42.57142857142857,4,0.0,41,45,45,21,56,52,3,29,6,152,146,1
2146,27491,9Nmjm4BvnbKTQ3ZZwECYdKy9zBNGmQNW,7GRhBDsirIGkRZBtSMEzNTyDr2JQm4xx,1,0,0,0,0,0,1,0,1,0.14285714285714285,1,0.0,0,0,0,0,0,0,0,1,0,0,1,1
2147,27517,9CBq37ANJ7gzpAJJLjvNc0D6JKL0q7QE,SpATywNh6bZuzm8s1ceuBUnMUAeoAHHw,28,31,16,32,10,7,3,0,99,14.142857142857142,1,0.0,13,16,31,10,18,7,1,3,0,70,29,1
2148,27523,8ga3z0NKN1WQ3YzAZr5NtUzbD9BjtY0C,G8EPVSXsOYB5YQWZGiz1aVq5Pgr2GrQu,27,24,10,38,5,0,12,0,89,12.714285714285714,4,0.0,10,10,27,5,14,0,11,12,0,52,37,0
2149,27541,4LLdV2zTWS697dAsOgAPJZPFwfNnrjt6,A3fsA9Zfv1X2fVEQhTw51lKENdNrEqT3,31,19,13,60,4,0,5,0,101,14.428571428571429,4,0.0,1,13,51,4,18,0,9,5,0,69,32,1
2150,30652,c0SE05tRjiEOaThvWcYxSYbAxboLNaZo,7GRhBDsirIGkRZBtSMEzNTyDr2JQm4xx,26,48,2,40,9,7,27,2,135,19.285714285714285,3,0.0,26,2,35,9,22,7,5,27,2,72,63,0
2151,30661,Da2YYkrh9YuRinihWxRQSQhXAdFeKqSb,7GRhBDsirIGkRZBtSMEzNTyDr2JQm4xx,10,7,3,8,4,0,2,0,24,3.4285714285714284,1,0.0,3,3,6,4,4,0,2,2,0,16,8,0
2152,30662,4Y6ySID5iQf80xGHEGKPq13tPSHHOAOF,7GRhBDsirIGkRZBtSMEzNTyDr2JQm4xx,54,140,42,70,19,4,10,0,285,40.714285714285715,5,0.0,32,42,54,19,108,4,16,10,0,147,138,0
2153,30690,AcpmcKbkGL0wHG2z3MmcGuG9z6KsBEJe,7GRhBDsirIGkRZBtSMEzNTyDr2JQm4xx,27,46,24,32,13,4,8,0,127,18.142857142857142,6,0.0,14,24,26,13,32,4,6,8,0,77,50,0
2154,30717,Upqz62cwWKexlUMk4uvP9aosOnbcADgX,7GRhBDsirIGkRZBtSMEzNTyDr2JQm4xx,1,0,0,0,0,0,2,0,2,0.2857142857142857,2,0.0,0,0,0,0,0,0,0,2,0,0,2,0
2155,30722,N0Sos51WanCzoSGKDmMPzQtMlLxY3bFb,7GRhBDsirIGkRZBtSMEzNTyDr2JQm4xx,71,224,89,141,42,65,74,3,638,91.14285714285714,9,0.0,95,89,123,42,129,65,18,74,3,349,289,0
2156,30724,Cdp3gxqrAuRwjOLmDu9YrutxbWvuOM9e,7GRhBDsirIGkRZBtSMEzNTyDr2JQm4xx,1,0,0,0,0,0,1,0,1,0.14285714285714285,1,0.0,0,0,0,0,0,0,0,1,0,0,1,0
2157,30733,9GVWhCbqivE4bnCr9NW81pWzAvrdhoCR,7GRhBDsirIGkRZBtSMEzNTyDr2JQm4xx,2,0,0,0,0,0,2,0,2,0.2857142857142857,1,0.0,0,0,0,0,0,0,0,2,0,0,2,1
2158,30742,m7YQyhtMcEUVm4YEl0ls7E37ljO7KzRy,7GRhBDsirIGkRZBtSMEzNTyDr2JQm4xx,38,122,47,52,17,39,14,0,291,41.57142857142857,7,0.0,57,47,47,17,65,39,5,14,0,168,123,0
2159,30747,tLopTDeUShprCRgfwS3p7Zbir4u3Yxe8,7GRhBDsirIGkRZBtSMEzNTyDr2JQm4xx,10,13,7,6,4,0,1,0,31,4.428571428571429,1,0.0,5,7,5,4,8,0,1,1,0,21,10,1
2160,30750,yk7hISr9k5KlTllac6P28wE1wuN0cd27,7GRhBDsirIGkRZBtSMEzNTyDr2JQm4xx,33,65,1,79,16,6,16,1,184,26.285714285714285,3,0.0,39,1,67,16,26,6,12,16,1,123,61,0
2161,30756,5He5r20lSAk84shJAoxdWcVq0zVfBWNL,7GRhBDsirIGkRZBtSMEzNTyDr2JQm4xx,12,19,8,0,2,17,8,0,54,7.714285714285714,1,0.0,3,8,0,2,16,17,0,8,0,13,41,0
2162,30776,YtymNq1ebo5JQ6VlWg3H52cMIU1je3tP,SpATywNh6bZuzm8s1ceuBUnMUAeoAHHw,14,14,8,16,6,3,3,0,50,7.142857142857143,2,0.0,4,8,14,6,10,3,2,3,0,32,18,0
2163,30797,S0OJjF6aof0iTnIX6lUAxekoH3m4w7V0,bWdj2GDclj5ofokWjzoa5jAwMkxCykd6,39,58,30,80,8,57,18,1,252,36.0,5,0.0,9,30,73,8,49,57,7,18,1,120,132,0
2164,30824,VpttOLX6WfGZBZLZt8acfk7430VwqHRi,RXDvfPUBYFlVdlueBFbLW0mhhAyGEqpt,42,67,2,117,3,7,15,1,212,30.285714285714285,3,0.0,17,2,103,3,50,7,14,15,1,125,87,1
2165,30830,Uj0YzcfvBcWRuM5ooqhtOKSU0RtOgHEO,SpATywNh6bZuzm8s1ceuBUnMUAeoAHHw,1,0,0,0,0,0,2,0,2,0.2857142857142857,1,0.0,0,0,0,0,0,0,0,2,0,0,2,0
2166,30842,aacyvESmAfP5D5oPQjdLdL2QR8GRVLet,SpATywNh6bZuzm8s1ceuBUnMUAeoAHHw,16,51,27,13,16,49,11,1,168,24.0,2,0.0,12,27,11,16,39,49,2,11,1,66,102,0
2167,30844,BzAEXi273boWm5fg8ZX5MfzoC5AJdE3M,SpATywNh6bZuzm8s1ceuBUnMUAeoAHHw,16,17,11,13,6,2,9,0,58,8.285714285714286,2,0.0,2,11,11,6,15,2,2,9,0,30,28,1
2168,30851,dEqFTu442IbDfPtop0GcM4lzz1lxVMo1,7GRhBDsirIGkRZBtSMEzNTyDr2JQm4xx,37,117,45,91,14,2,5,0,274,39.142857142857146,9,0.0,36,45,78,14,81,2,13,5,0,173,101,0
2169,30861,Ip3irZsxFvOeGg8WSppVhJArbPhoH3qm,SpATywNh6bZuzm8s1ceuBUnMUAeoAHHw,30,66,25,38,9,10,22,3,173,24.714285714285715,4,0.0,25,25,33,9,41,10,5,22,3,92,81,0
2170,30870,GpbDOMkrqaLXOPkd8jI4TxThJAZPGWSK,SpATywNh6bZuzm8s1ceuBUnMUAeoAHHw,17,31,13,19,6,17,10,1,97,13.857142857142858,4,0.0,8,13,16,6,23,17,3,10,1,43,54,0
2171,30871,3IgwuZBiVdgdYRQ9ySaEvpMizbjCJFS0,7GRhBDsirIGkRZBtSMEzNTyDr2JQm4xx,62,132,40,110,30,64,19,0,395,56.42857142857143,6,0.0,66,40,86,30,66,64,24,19,0,222,173,1
2172,30887,1NNWgXZojZkqAeoQhcUz4Xc8qgLXmALC,SpATywNh6bZuzm8s1ceuBUnMUAeoAHHw,29,122,60,22,34,16,5,0,259,37.0,7,0.0,42,60,22,34,80,16,0,5,0,158,101,0
2173,30889,9MbsP03nqyzNF8ytIM40Tx9W50TUxwHO,SpATywNh6bZuzm8s1ceuBUnMUAeoAHHw,10,29,2,0,0,0,10,0,41,5.857142857142857,4,0.0,0,2,0,0,29,0,0,10,0,2,39,0
2174,30905,5GkxvaD11peDsZoT8jF1pQZKBzcvYxOV,G8EPVSXsOYB5YQWZGiz1aVq5Pgr2GrQu,23,32,10,40,0,8,13,2,105,15.0,4,0.0,18,10,28,0,14,8,12,13,2,56,49,0
2175,30907,LKEJY5MvP0gj7M4NL5iRnXDBazXBKsOA,SpATywNh6bZuzm8s1ceuBUnMUAeoAHHw,30,164,69,22,13,122,67,9,466,66.57142857142857,8,0.0,38,69,19,13,126,122,3,67,9,139,327,0
2176,30948,CfeENerIdAGepleePWSt0SV88ctt0Tmw,G8EPVSXsOYB5YQWZGiz1aVq5Pgr2GrQu,82,98,27,168,16,0,7,1,317,45.285714285714285,7,0.0,45,27,116,16,53,0,52,7,1,204,113,0
2177,30959,hjUSUM6roI2mLGkMAqBjE0uxFRBSMYHJ,SpATywNh6bZuzm8s1ceuBUnMUAeoAHHw,28,68,45,24,28,9,13,0,187,26.714285714285715,5,0.0,12,45,18,28,56,9,6,13,0,103,84,0
2178,30987,xVvNMYPAdkOMbR8cyTeqVHpVoO8wZQ2b,7GRhBDsirIGkRZBtSMEzNTyDr2JQm4xx,6,9,2,0,1,4,6,0,22,3.142857142857143,2,0.0,1,2,0,1,8,4,0,6,0,4,18,1
2179,31001,oTQ81PqeruuETb6SukxAp0sOazRUpE32,7GRhBDsirIGkRZBtSMEzNTyDr2JQm4xx,30,47,15,48,13,11,6,0,140,20.0,4,0.0,28,15,41,13,19,11,7,6,0,97,43,1
2180,31010,u8YPaORaz1zRBmx3Zp1zm30bQFzwDInM,SpATywNh6bZuzm8s1ceuBUnMUAeoAHHw,16,37,14,33,7,83,24,3,201,28.714285714285715,4,0.0,10,14,27,7,27,83,6,24,3,58,143,0
2181,31012,t069DROGMOy4O12B9Ty0yznUmNUBGFUp,7GRhBDsirIGkRZBtSMEzNTyDr2JQm4xx,4,2,1,0,1,0,1,0,5,0.7142857142857143,1,0.0,0,1,0,1,2,0,0,1,0,2,3,1
2182,31062,CfeENerIdAGepleePWSt0SV88ctt0Tmw,A3fsA9Zfv1X2fVEQhTw51lKENdNrEqT3,1,0,0,0,0,0,2,0,2,0.2857142857142857,2,0.0,0,0,0,0,0,0,0,2,0,0,2,1
2183,31080,6U2xPMo27MRkbrPflG5WrvgHD37CuMpR,7GRhBDsirIGkRZBtSMEzNTyDr2JQm4xx,7,7,3,0,2,0,3,0,15,2.142857142857143,2,0.0,0,3,0,2,7,0,0,3,0,5,10,1
2184,31089,MxVVcAtMSnLQjlvLOx5XySlZblFVugTc,SpATywNh6bZuzm8s1ceuBUnMUAeoAHHw,14,40,1,5,0,0,16,0,62,8.857142857142858,4,0.0,0,1,4,0,40,0,1,16,0,5,57,0
2185,31100,yNeIUKhEuJHTBsPD5kABjlBuASduqZHz,SpATywNh6bZuzm8s1ceuBUnMUAeoAHHw,6,3,2,0,1,0,2,0,8,1.1428571428571428,1,0.0,0,2,0,1,3,0,0,2,0,3,5,1
2186,31137,JP79INNRcQzkUx6dZie4v1QvuMQ7OVUy,RXDvfPUBYFlVdlueBFbLW0mhhAyGEqpt,40,106,0,92,3,26,7,0,234,33.42857142857143,3,0.0,15,0,87,3,91,26,5,7,0,105,129,0
2187,31162,tq5rSafpJQn5saVcMLWCPKYcu2G69rbK,7GRhBDsirIGkRZBtSMEzNTyDr2JQm4xx,9,5,3,0,2,0,7,0,17,2.4285714285714284,1,0.0,0,3,0,2,5,0,0,7,0,5,12,1
2188,31176,In25hAYYA32yjVT3Fete5XUoGWlQgd5t,G8EPVSXsOYB5YQWZGiz1aVq5Pgr2GrQu,5,2,1,0,1,0,3,0,7,1.0,1,0.0,0,1,0,1,2,0,0,3,0,2,5,0
2189,31187,s6iksgptFmyh2vfiarKdJkiKnp6RLi3f,G8EPVSXsOYB5YQWZGiz1aVq5Pgr2GrQu,10,6,3,0,1,6,6,0,22,3.142857142857143,1,0.0,0,3,0,1,6,6,0,6,0,4,18,0
2190,31214,s6iksgptFmyh2vfiarKdJkiKnp6RLi3f,bWdj2GDclj5ofokWjzoa5jAwMkxCykd6,6,5,1,0,1,6,3,0,16,2.2857142857142856,1,0.0,0,1,0,1,5,6,0,3,0,2,14,0
2191,31215,5Gf23uaI2ID1BMi2tbrzYBqwuoTD7nj1,G8EPVSXsOYB5YQWZGiz1aVq5Pgr2GrQu,59,66,30,56,23,3,11,1,190,27.142857142857142,2,0.0,30,30,50,23,36,3,6,11,1,133,57,0
2192,31216,VvIsuXfKScxQtpB88WTGf8JMf9TTXDon,SpATywNh6bZuzm8s1ceuBUnMUAeoAHHw,4,2,1,0,1,0,1,0,5,0.7142857142857143,1,0.0,0,1,0,1,2,0,0,1,0,2,3,0
2193,31271,WL2pmxbGb1jmTh21fuUuAtLcak4ndNX3,SpATywNh6bZuzm8s1ceuBUnMUAeoAHHw,13,21,6,18,2,2,3,0,52,7.428571428571429,1,0.0,8,6,15,2,13,2,3,3,0,31,21,1
2194,31282,U04y5vFf0AfyJVGIOJHlryTyRQEOm5pT,SpATywNh6bZuzm8s1ceuBUnMUAeoAHHw,21,26,8,21,3,0,4,0,62,8.857142857142858,3,0.0,5,8,19,3,21,0,2,4,0,35,27,0
2195,31294,wAJGUOfaMNSu8fVs50XbquwP1qlCP18o,7GRhBDsirIGkRZBtSMEzNTyDr2JQm4xx,69,289,89,149,50,160,32,2,771,110.14285714285714,9,0.0,159,89,108,50,130,160,41,32,2,406,365,0
2196,31315,flpVPPsUWfhNx2m3NGTbdkxp57HITcVF,SpATywNh6bZuzm8s1ceuBUnMUAeoAHHw,32,89,37,38,16,7,25,2,214,30.571428571428573,5,0.0,38,37,30,16,51,7,8,25,2,121,93,0
2197,31322,HgQbl59wfMZ62eOeVscJctviZYi0GAnj,SpATywNh6bZuzm8s1ceuBUnMUAeoAHHw,15,23,11,18,4,3,2,0,61,8.714285714285714,2,0.0,9,11,16,4,14,3,2,2,0,40,21,0
2198,31327,MjVksKClEDbwKLDQ3ID6os0AiFzU5BN2,7GRhBDsirIGkRZBtSMEzNTyDr2JQm4xx,1,0,0,0,0,0,1,0,1,0.14285714285714285,1,0.0,0,0,0,0,0,0,0,1,0,0,1,1
2199,31329,ZuXB7SoEgVCDuS66pcJ2jF54Mdbn2Nuz,SpATywNh6bZuzm8s1ceuBUnMUAeoAHHw,4,5,1,0,0,0,1,0,7,1.0,3,0.0,0,1,0,0,5,0,0,1,0,1,6,0
2200,31335,XqfKw12BYBxvQyUszKCvSmcUn4H9qRJJ,7GRhBDsirIGkRZBtSMEzNTyDr2JQm4xx,19,50,13,40,8,5,13,0,129,18.428571428571427,4,0.0,30,13,33,8,20,5,7,13,0,84,45,1
2201,31349,RAFVAKoL6cQatcQ8rTN5mIwPhy02koDR,A3fsA9Zfv1X2fVEQhTw51lKENdNrEqT3,40,57,29,88,11,12,10,0,207,29.571428571428573,3,0.0,4,29,77,11,53,12,11,10,0,121,86,0
2202,31368,q15es4hix4DJR5zOH0N1aGsdTpjonWNC,SpATywNh6bZuzm8s1ceuBUnMUAeoAHHw,28,60,11,32,4,72,36,3,218,31.142857142857142,9,0.0,13,11,28,4,47,72,4,36,3,56,162,0
2203,31414,StcFIgK5T4YiiLiOpPHFjzohTVz9Jaf7,A3fsA9Zfv1X2fVEQhTw51lKENdNrEqT3,42,50,21,74,12,0,4,0,161,23.0,6,0.0,2,21,56,12,48,0,18,4,0,91,70,0
2204,31419,o7pzdRTO1dnxuhf9kxurH0oMz67aa1kw,SpATywNh6bZuzm8s1ceuBUnMUAeoAHHw,10,8,2,12,0,0,2,0,24,3.4285714285714284,2,0.0,3,2,12,0,5,0,0,2,0,17,7,1
2205,31446,Sg3DXxUJJ7e58r0b7OHd09yiv7acnFU0,SpATywNh6bZuzm8s1ceuBUnMUAeoAHHw,13,23,10,21,7,4,5,0,70,10.0,3,0.0,12,10,18,7,11,4,3,5,0,47,23,0
2206,31455,AX9Hte0A6zp61WUmhFkv1rU3P0cKffFQ,SpATywNh6bZuzm8s1ceuBUnMUAeoAHHw,12,18,5,16,1,0,5,0,45,6.428571428571429,3,0.0,5,5,15,1,13,0,1,5,0,26,19,0
2207,31479,8jqDD2phXiMGQf0XQi1kVRzLj3TILO0y,bWdj2GDclj5ofokWjzoa5jAwMkxCykd6,1,0,0,0,0,0,1,0,1,0.14285714285714285,1,0.0,0,0,0,0,0,0,0,1,0,0,1,1
2208,31493,iGNqI0WQkdTRPPMB99MG4DRoKjQuEfCJ,SpATywNh6bZuzm8s1ceuBUnMUAeoAHHw,10,14,5,0,3,0,5,0,27,3.857142857142857,5,0.0,0,5,0,3,14,0,0,5,0,8,19,0
2209,31509,oyStFfS7Y0XvpvDI8JwDIhnFdZZl3Ixl,SpATywNh6bZuzm8s1ceuBUnMUAeoAHHw,11,11,0,12,0,1,6,0,30,4.285714285714286,2,0.0,6,0,12,0,5,1,0,6,0,18,12,0
2210,31513,XBCkMYdRHaBwbyaKg5wVLPpzX1Jqu9p0,7GRhBDsirIGkRZBtSMEzNTyDr2JQm4xx,8,8,2,0,4,0,2,0,16,2.2857142857142856,1,0.0,4,2,0,4,4,0,0,2,0,10,6,1
2211,31521,SQBW44VzMb5zXQWTfzFzAP2RU7qxP2su,bWdj2GDclj5ofokWjzoa5jAwMkxCykd6,28,34,21,144,13,0,7,0,219,31.285714285714285,5,0.0,7,21,131,13,27,0,13,7,0,172,47,1
2212,31532,oNX40hvUpCseO8BHKhGJvG2jyQpYKQyk,RXDvfPUBYFlVdlueBFbLW0mhhAyGEqpt,57,109,31,110,17,18,28,3,316,45.142857142857146,6,0.0,15,31,107,17,94,18,3,28,3,170,146,0
2213,31540,fenn4oQ5cZO7k0rG5qWqM8q00nrCNGWN,G8EPVSXsOYB5YQWZGiz1aVq5Pgr2GrQu,9,10,2,0,2,2,6,0,22,3.142857142857143,1,0.0,0,2,0,2,10,2,0,6,0,4,18,0
2214,31557,H3GbKrAtFVtLEXWNNdFaZDFbuKQIUVPU,SpATywNh6bZuzm8s1ceuBUnMUAeoAHHw,26,47,31,21,13,10,25,0,147,21.0,8,0.0,6,31,21,13,41,10,0,25,0,71,76,0
2215,31568,c49ANcMlFceMxZBmI2dFNiETx72UlFpt,SpATywNh6bZuzm8s1ceuBUnMUAeoAHHw,26,68,19,37,5,32,35,0,196,28.0,8,0.0,14,19,33,5,54,32,4,35,0,71,125,0
2216,31575,VYkkz2UClMIV09P0Xfa0EEIHkYXDA8gf,SpATywNh6bZuzm8s1ceuBUnMUAeoAHHw,15,33,2,25,2,34,6,1,103,14.714285714285714,2,0.0,13,2,21,2,20,34,4,6,1,38,65,1
2217,31630,uqaaAh63woEl1GEmEsDUSC0vwOZYZP0g,G8EPVSXsOYB5YQWZGiz1aVq5Pgr2GrQu,9,7,3,8,3,0,1,0,22,3.142857142857143,1,0.0,3,3,7,3,4,0,1,1,0,16,6,1
2218,31631,OcchkIht8b8QIrrapp5dUsDP9GE3Vfdw,SpATywNh6bZuzm8s1ceuBUnMUAeoAHHw,2,0,0,0,0,0,2,0,2,0.2857142857142857,1,0.0,0,0,0,0,0,0,0,2,0,0,2,0
2219,31636,8V9pnrkvwK33pI3AiYSlsgxV7TeKgfNZ,G8EPVSXsOYB5YQWZGiz1aVq5Pgr2GrQu,76,162,48,122,23,115,25,5,500,71.42857142857143,7,0.0,68,48,74,23,94,115,48,25,5,213,287,0
2220,31637,5vZRuON34JUuUxkGF08Mu94iTiQzZas4,RXDvfPUBYFlVdlueBFbLW0mhhAyGEqpt,48,57,32,116,13,2,19,12,251,35.857142857142854,3,0.0,14,32,103,13,43,2,13,19,12,162,89,0
2221,31683,YTga640T6i241jGBhxN7pUtNHHrQTFGS,7GRhBDsirIGkRZBtSMEzNTyDr2JQm4xx,10,12,3,14,1,1,1,0,32,4.571428571428571,1,0.0,8,3,12,1,4,1,2,1,0,24,8,1
2222,31695,yWhbSfRhq0GQaIid8lmuGTuOjD7iQVVR,SpATywNh6bZuzm8s1ceuBUnMUAeoAHHw,25,77,21,27,7,38,13,0,183,26.142857142857142,3,0.0,38,21,21,7,39,38,6,13,0,87,96,1
2223,31730,a4RYqILKcnu8c617gYSbD0KQIm9DqZnc,SpATywNh6bZuzm8s1ceuBUnMUAeoAHHw,29,32,14,23,8,1,11,0,89,12.714285714285714,6,0.0,7,14,22,8,25,1,1,11,0,51,38,0
2224,31780,DQDVulqp0h5DfSUqCcuRlUTAbYsaxOXV,7GRhBDsirIGkRZBtSMEzNTyDr2JQm4xx,3,0,0,0,0,4,4,0,8,1.1428571428571428,1,0.0,0,0,0,0,0,4,0,4,0,0,8,1
2225,31785,WMHp5hy6JREfQvjE2o6B3Iu0aAWFRyny,SpATywNh6bZuzm8s1ceuBUnMUAeoAHHw,15,18,9,12,6,0,5,0,50,7.142857142857143,2,0.0,5,9,10,6,13,0,2,5,0,30,20,0
2226,31792,ZNcLOAJ2r3H5DqhbGk1CiPtwI7ixaCeK,A3fsA9Zfv1X2fVEQhTw51lKENdNrEqT3,23,20,15,0,10,0,4,0,49,7.0,3,0.0,0,15,0,10,20,0,0,4,0,25,24,0
2227,31827,JOddnojV0OZrysgzYsnxzhRLS1r6GCxl,SpATywNh6bZuzm8s1ceuBUnMUAeoAHHw,10,16,7,0,4,1,3,0,31,4.428571428571429,2,0.0,4,7,0,4,12,1,0,3,0,15,16,1
2228,31829,861mcqUZ4WyFkrWdyYySCd1kJULdzhG3,SpATywNh6bZuzm8s1ceuBUnMUAeoAHHw,10,8,0,12,0,0,1,0,21,3.0,1,0.0,2,0,12,0,6,0,0,1,0,14,7,1
2229,31854,wLAgbiz3XWV6Nef8pQe1TlLxUN8CIoJ8,7GRhBDsirIGkRZBtSMEzNTyDr2JQm4xx,64,76,24,105,24,7,13,1,250,35.714285714285715,2,0.0,47,24,96,24,29,7,9,13,1,191,59,1
2230,31869,R2cga9JVVM2tXEVs2saYswslfxAU4nMk,SpATywNh6bZuzm8s1ceuBUnMUAeoAHHw,17,10,7,6,4,0,4,0,31,4.428571428571429,2,0.0,2,7,6,4,8,0,0,4,0,19,12,0
2231,31877,ioaeb7d1U29jI9wsI7DHJ7aiuWWVX3KB,RXDvfPUBYFlVdlueBFbLW0mhhAyGEqpt,21,31,11,0,7,6,15,2,72,10.285714285714286,1,0.0,1,11,0,7,30,6,0,15,2,19,53,0
2232,31898,PWcBu9Kt7uTK1WC32ssYHrspf5hPuUjQ,7GRhBDsirIGkRZBtSMEzNTyDr2JQm4xx,8,5,3,0,2,0,4,0,14,2.0,2,0.0,0,3,0,2,5,0,0,4,0,5,9,1
2233,31927,6tkBZTnNxRRRXGSFUHBd7kkZUgcJhsIy,7GRhBDsirIGkRZBtSMEzNTyDr2JQm4xx,2,0,0,0,0,0,2,0,2,0.2857142857142857,1,0.0,0,0,0,0,0,0,0,2,0,0,2,1
2234,31979,XYKAwX2Sl88KhgfkTOpg6K4pRdGN7Orp,7GRhBDsirIGkRZBtSMEzNTyDr2JQm4xx,2,0,0,0,0,0,3,0,3,0.42857142857142855,1,0.0,0,0,0,0,0,0,0,3,0,0,3,1
2235,31983,EwpbggvNdZkeSTjdG48aEltlJYavm02s,A3fsA9Zfv1X2fVEQhTw51lKENdNrEqT3,14,14,1,0,0,0,4,0,19,2.7142857142857144,2,0.0,0,1,0,0,14,0,0,4,0,1,18,0
2236,31996,TZQnDQD4c1wLJcg98vkGC4z0YxJAykwb,SpATywNh6bZuzm8s1ceuBUnMUAeoAHHw,18,60,25,26,11,4,15,1,142,20.285714285714285,6,0.0,24,25,21,11,36,4,5,15,1,81,61,0
2237,32112,Jf77UYIvUtofHBGpvQMQ0qUfMZBh9rRJ,SpATywNh6bZuzm8s1ceuBUnMUAeoAHHw,27,26,15,33,7,0,3,0,84,12.0,3,0.0,8,15,31,7,18,0,2,3,0,61,23,0
2238,32123,xrDGwnLLNa6QlQOfL38MTY3529BaxYjK,RXDvfPUBYFlVdlueBFbLW0mhhAyGEqpt,14,9,7,17,3,0,2,0,38,5.428571428571429,1,0.0,1,7,16,3,8,0,1,2,0,27,11,0
2239,32130,4bLrsVDvLnrTqHqeIpcqQPyvl02eai7n,bWdj2GDclj5ofokWjzoa5jAwMkxCykd6,1,0,0,0,0,0,1,0,1,0.14285714285714285,1,0.0,0,0,0,0,0,0,0,1,0,0,1,1
2240,32135,610PtRFkaYif9s7nz1Kdra5qTHjPTrYT,SpATywNh6bZuzm8s1ceuBUnMUAeoAHHw,27,26,16,28,10,0,6,0,86,12.285714285714286,3,0.0,7,16,26,10,19,0,2,6,0,59,27,0
2241,32141,jagu0OJDhWTGFhfCMk0ghqluLpW3kzdC,bWdj2GDclj5ofokWjzoa5jAwMkxCykd6,6,2,1,0,1,0,6,0,10,1.4285714285714286,2,0.0,0,1,0,1,2,0,0,6,0,2,8,1
2242,32154,JB5wgKgEAIwYsiifcpDf7iv2yPgMBOVA,SpATywNh6bZuzm8s1ceuBUnMUAeoAHHw,14,36,2,12,1,1,11,1,64,9.142857142857142,3,0.0,8,2,12,1,28,1,0,11,1,23,41,0
2243,32162,kAQFM0dEgOQIxOG9jTMe5puRtNxZZWMN,A3fsA9Zfv1X2fVEQhTw51lKENdNrEqT3,55,37,2,152,2,0,4,0,197,28.142857142857142,4,0.0,2,2,136,2,35,0,16,4,0,142,55,0
2244,32165,xVQ88VrIuIA75ygDlevnROobNkwcFnsc,SpATywNh6bZuzm8s1ceuBUnMUAeoAHHw,19,21,5,14,4,7,5,0,56,8.0,2,0.0,0,5,12,4,21,7,2,5,0,21,35,0
2245,32177,kvf1WFygeLGKOFkoertca6J9TDxV9fcY,7GRhBDsirIGkRZBtSMEzNTyDr2JQm4xx,6,6,2,0,3,0,1,0,12,1.7142857142857142,2,0.0,3,2,0,3,3,0,0,1,0,8,4,1
2246,32181,yz5W8rI4J1brvBsiH8Bk8UlG6rKQV6QY,SpATywNh6bZuzm8s1ceuBUnMUAeoAHHw,16,22,10,14,3,0,7,0,56,8.0,2,0.0,7,10,13,3,15,0,1,7,0,33,23,0
2247,32220,dpAJ54wEPUDHZcYRCRrxvDfIakq9pmaQ,SpATywNh6bZuzm8s1ceuBUnMUAeoAHHw,22,29,2,26,0,4,9,1,71,10.142857142857142,3,0.0,10,2,25,0,19,4,1,9,1,37,34,1
2248,32237,qh4tHm7Ijtk0rXK87a1UXx5JdnCnPyij,7GRhBDsirIGkRZBtSMEzNTyDr2JQm4xx,5,3,2,0,0,0,2,0,7,1.0,1,0.0,0,2,0,0,3,0,0,2,0,2,5,1
2249,32248,s54A0hFU7GzRUM0cq0hWJTDlnMIM1TAX,SpATywNh6bZuzm8s1ceuBUnMUAeoAHHw,13,22,9,18,7,0,2,0,58,8.285714285714286,1,0.0,5,9,17,7,17,0,1,2,0,38,20,1
2250,32277,TEmVdQ7zwLYXmbCXgKpcJL6SMosCkEk6,7GRhBDsirIGkRZBtSMEzNTyDr2JQm4xx,13,12,5,4,4,8,9,4,46,6.571428571428571,1,0.0,4,5,3,4,8,8,1,9,4,16,30,1
2251,32281,SSlieJULaqRb1C7jSzOwyPvbJnH3adQv,7GRhBDsirIGkRZBtSMEzNTyDr2JQm4xx,50,75,5,151,15,6,8,0,260,37.142857142857146,6,0.0,36,5,131,15,39,6,20,8,0,187,73,1
2252,32289,5getYNIZ2hnUwVH9nwJiD9At1XFs260U,RXDvfPUBYFlVdlueBFbLW0mhhAyGEqpt,55,80,7,173,7,6,7,0,280,40.0,4,0.0,29,7,155,7,51,6,18,7,0,198,82,0
2253,32350,4Z7KasuRx9CbJCcpGQot8eWIzFoK9Y6e,G8EPVSXsOYB5YQWZGiz1aVq5Pgr2GrQu,14,14,5,14,3,1,6,2,45,6.428571428571429,2,0.0,6,5,12,3,8,1,2,6,2,26,19,0
2254,32378,dnBboDTKZBSq62soTT8p1zFH5HInmJMi,SpATywNh6bZuzm8s1ceuBUnMUAeoAHHw,4,2,1,0,0,0,2,0,5,0.7142857142857143,1,0.0,0,1,0,0,2,0,0,2,0,1,4,0
2255,32387,40BfkvCbbDiXljpQ7TxzzDakjMbYaL3S,SpATywNh6bZuzm8s1ceuBUnMUAeoAHHw,15,19,7,27,1,0,4,0,58,8.285714285714286,3,0.0,9,7,24,1,10,0,3,4,0,41,17,0
2256,32404,w7790lyNDi5biQPgaVfIpYKtROrGndED,SpATywNh6bZuzm8s1ceuBUnMUAeoAHHw,30,104,35,30,14,6,25,0,214,30.571428571428573,5,0.0,16,35,27,14,88,6,3,25,0,92,122,1
2257,32423,FW47VC0lzmys2S4k8Ky52JrXCSFDeyeP,A3fsA9Zfv1X2fVEQhTw51lKENdNrEqT3,9,7,5,0,3,0,2,0,17,2.4285714285714284,1,0.0,0,5,0,3,7,0,0,2,0,8,9,1
2258,32435,QqE2Xjwy9gUzOvFdkDqAwAaNZLBZkxvd,7GRhBDsirIGkRZBtSMEzNTyDr2JQm4xx,33,79,3,76,5,47,23,0,233,33.285714285714285,7,0.0,45,3,64,5,34,47,12,23,0,117,116,1
2259,32437,gGSMkNgPdXpBQgdZzyjzifomyCxFSNyt,A3fsA9Zfv1X2fVEQhTw51lKENdNrEqT3,23,25,15,0,8,24,36,1,109,15.571428571428571,6,0.0,0,15,0,8,25,24,0,36,1,23,86,0
2260,32439,sbafJyL5hxYHWbu0cbLBSCFDQh5Oe8Ww,RXDvfPUBYFlVdlueBFbLW0mhhAyGEqpt,8,10,1,0,1,5,5,0,22,3.142857142857143,1,0.0,1,1,0,1,9,5,0,5,0,3,19,0
2261,32466,JJro1amtaUogvd4Vkbdsh0DmnqfguR8P,SpATywNh6bZuzm8s1ceuBUnMUAeoAHHw,5,3,2,0,0,0,5,0,10,1.4285714285714286,1,0.0,0,2,0,0,3,0,0,5,0,2,8,1
2262,32471,1BEoeS35Ni9RflXqhdHAKpKpQ07oVqkG,SpATywNh6bZuzm8s1ceuBUnMUAeoAHHw,16,59,5,19,0,7,36,4,130,18.571428571428573,4,0.0,11,5,16,0,48,7,3,36,4,32,98,0
2263,32477,LPul7vNnoWP2lahy0vntgg039NwfmlYY,SpATywNh6bZuzm8s1ceuBUnMUAeoAHHw,14,32,3,14,0,11,19,1,80,11.428571428571429,5,0.0,6,3,10,0,26,11,4,19,1,19,61,0
2264,32483,MauXcYq2z30gm4QmDqcfc1IfWjnRlPwg,SpATywNh6bZuzm8s1ceuBUnMUAeoAHHw,12,24,2,0,1,0,7,2,36,5.142857142857143,4,0.0,0,2,0,1,24,0,0,7,2,3,33,0
2265,32520,AFUJTbEqqgSsqCkUsNrjbPAjZvFwpzeW,G8EPVSXsOYB5YQWZGiz1aVq5Pgr2GrQu,84,115,28,222,17,0,8,0,390,55.714285714285715,3,0.0,61,28,145,17,54,0,77,8,0,251,139,0
2266,32530,KbfT30uvubax3lKEct6iblV8VhlPaIEn,G8EPVSXsOYB5YQWZGiz1aVq5Pgr2GrQu,22,22,11,22,7,0,2,0,64,9.142857142857142,1,0.0,0,11,20,7,22,0,2,2,0,38,26,0
2267,32536,13AvYdfA6LYkS80MstJgmNNdfNqd80ja,bWdj2GDclj5ofokWjzoa5jAwMkxCykd6,6,2,1,0,1,1,7,0,12,1.7142857142857142,3,0.0,0,1,0,1,2,1,0,7,0,2,10,0
2268,32547,wkfBzItw0JCH6ZUz2WUZn7ngJ5M4Oksy,SpATywNh6bZuzm8s1ceuBUnMUAeoAHHw,4,3,0,0,0,0,1,0,4,0.5714285714285714,1,0.0,0,0,0,0,3,0,0,1,0,0,4,0
2269,32555,g14jBWDuqUHRwpf4jHpBljeNVwCyjgqd,G8EPVSXsOYB5YQWZGiz1aVq5Pgr2GrQu,16,25,12,0,12,0,4,0,53,7.571428571428571,2,0.0,7,12,0,12,18,0,0,4,0,31,22,1
2270,32579,rQ8twu2Y4JlbZAVSeNSb6mmUSGGvpIAq,SpATywNh6bZuzm8s1ceuBUnMUAeoAHHw,21,40,3,32,0,5,12,0,92,13.142857142857142,3,0.0,6,3,28,0,34,5,4,12,0,37,55,0
2271,32587,dwKCRrq2cYlFl5YxmnjTpirr5PBMVnOq,RXDvfPUBYFlVdlueBFbLW0mhhAyGEqpt,23,38,18,0,11,0,4,0,71,10.142857142857142,2,0.0,5,18,0,11,33,0,0,4,0,34,37,0
2272,32600,jaDaYkvR41YbLhesvf9mW32i93zNzaSK,RXDvfPUBYFlVdlueBFbLW0mhhAyGEqpt,49,56,32,73,10,3,24,1,199,28.428571428571427,6,0.0,9,32,67,10,47,3,6,24,1,118,81,0
2273,32617,ncKGr6xR4Vhs3wPeU0aqO1sSEow8LN64,SpATywNh6bZuzm8s1ceuBUnMUAeoAHHw,26,44,10,26,3,122,43,6,254,36.285714285714285,7,0.0,13,10,23,3,31,122,3,43,6,49,205,0
2274,32633,KSfQPUyfWWfWDmmi6m3KXcKzxz89wkwt,SpATywNh6bZuzm8s1ceuBUnMUAeoAHHw,24,45,10,12,5,6,9,0,87,12.428571428571429,4,0.0,13,10,12,5,32,6,0,9,0,40,47,0
2275,32652,nqDX1tmEeTnbqCn9T8Crn5CYQgmIy9Eq,SpATywNh6bZuzm8s1ceuBUnMUAeoAHHw,17,30,13,13,4,10,13,3,86,12.285714285714286,1,0.0,14,13,11,4,16,10,2,13,3,42,44,0
2276,32654,zQwNebC3qLt6HHOuoG7oSsRj8l42sEdO,7GRhBDsirIGkRZBtSMEzNTyDr2JQm4xx,1,0,0,0,0,0,1,0,1,0.14285714285714285,1,0.0,0,0,0,0,0,0,0,1,0,0,1,1
2277,32661,qKc8EuUOlEzXysFMoXghKaieW3HIaePV,SpATywNh6bZuzm8s1ceuBUnMUAeoAHHw,7,5,3,0,1,0,5,0,14,2.0,2,0.0,0,3,0,1,5,0,0,5,0,4,10,0
2278,32663,RQ7L9CpArhwtUrlKYRf29Ou4YmyW3xpx,A3fsA9Zfv1X2fVEQhTw51lKENdNrEqT3,15,16,9,0,6,0,6,0,37,5.285714285714286,1,0.0,0,9,0,6,16,0,0,6,0,15,22,0
2279,32675,S65yhLgjTGwwuDt6C6cjI82AJbGfYIiK,SpATywNh6bZuzm8s1ceuBUnMUAeoAHHw,16,13,5,12,3,0,14,1,48,6.857142857142857,2,0.0,7,5,11,3,6,0,1,14,1,26,22,1
2280,32680,4m1Dg29Y9pbvJRrOBjNRbyWgB17yJl3U,G8EPVSXsOYB5YQWZGiz1aVq5Pgr2GrQu,2,0,0,0,0,0,2,0,2,0.2857142857142857,1,0.0,0,0,0,0,0,0,0,2,0,0,2,0
2281,32688,vsH3qB64VOSnSTFhrkJQnHqm8c83psRR,SpATywNh6bZuzm8s1ceuBUnMUAeoAHHw,27,41,21,40,9,51,4,0,166,23.714285714285715,3,0.0,6,21,33,9,35,51,7,4,0,69,97,0
2282,32691,zIxh0JW4JCwiox9jMtpfpkw3WRcYtUgv,SpATywNh6bZuzm8s1ceuBUnMUAeoAHHw,13,18,0,8,0,8,8,1,43,6.142857142857143,1,0.0,8,0,8,0,10,8,0,8,1,16,27,0
2283,32693,NrExtDPytZeckpp4FyIosvaEjFjzywmC,A3fsA9Zfv1X2fVEQhTw51lKENdNrEqT3,27,9,0,52,0,0,5,0,66,9.428571428571429,2,0.0,1,0,50,0,8,0,2,5,0,51,15,1
2284,32701,abaCPMr6xWMrCiOErEioyXWBSEERS1tE,7GRhBDsirIGkRZBtSMEzNTyDr2JQm4xx,12,6,3,0,2,1,8,1,21,3.0,1,0.0,0,3,0,2,6,1,0,8,1,5,16,1
2285,32710,HJ2gv3yF0WCJxGH8T6tjLTFYdM4sCizz,RXDvfPUBYFlVdlueBFbLW0mhhAyGEqpt,47,58,25,103,18,26,19,2,251,35.857142857142854,3,0.0,22,25,87,18,36,26,16,19,2,152,99,0
2286,32715,KvjMYuIyC1QuxskkhpxIY7MoDNSU5FMk,7GRhBDsirIGkRZBtSMEzNTyDr2JQm4xx,16,23,14,0,11,0,2,0,50,7.142857142857143,1,0.0,6,14,0,11,17,0,0,2,0,31,19,1
2287,32721,aLRP3ahB5SIcOn5vpM1VPEh9ib2QIioX,A3fsA9Zfv1X2fVEQhTw51lKENdNrEqT3,13,11,8,0,6,0,4,0,29,4.142857142857143,3,0.0,0,8,0,6,11,0,0,4,0,14,15,1
2288,32732,L74tKRZpBi1qsh0NM3EwE5D87acCLK8s,A3fsA9Zfv1X2fVEQhTw51lKENdNrEqT3,64,73,33,163,11,3,35,0,318,45.42857142857143,10,0.0,8,33,157,11,65,3,6,35,0,209,109,0
2289,32746,mXsmDArxUTe9rMFHp3cGPJEx5ACYKD90,7GRhBDsirIGkRZBtSMEzNTyDr2JQm4xx,29,45,19,37,9,6,7,0,123,17.571428571428573,5,0.0,18,19,31,9,27,6,6,7,0,77,46,1
2290,32753,Gn3GzN2xweKhiR4C9qIb4ocllZ2lANYz,SpATywNh6bZuzm8s1ceuBUnMUAeoAHHw,7,9,6,0,4,0,3,0,22,3.142857142857143,2,0.0,0,6,0,4,9,0,0,3,0,10,12,1
2291,32769,vEKYOhRdGZ59kfXY6wTO63YZY4EqPYqX,SpATywNh6bZuzm8s1ceuBUnMUAeoAHHw,22,34,21,10,8,0,5,0,78,11.142857142857142,4,0.0,5,21,9,8,29,0,1,5,0,43,35,0
2292,32837,wZVSpaATIDuE7qW0svZJi84Cpi6PMqWg,SpATywNh6bZuzm8s1ceuBUnMUAeoAHHw,13,22,2,12,1,0,9,0,46,6.571428571428571,2,0.0,5,2,10,1,17,0,2,9,0,18,28,1
2293,32872,XEcLEoVa2SWvlFcbbhIECksb9a6XvMec,RXDvfPUBYFlVdlueBFbLW0mhhAyGEqpt,19,25,14,35,3,9,10,6,102,14.571428571428571,2,0.0,8,14,30,3,17,9,5,10,6,55,47,0
2294,32884,z2Zz9wVXxnQo0wOtqHQc06HPM9iWXDoN,SpATywNh6bZuzm8s1ceuBUnMUAeoAHHw,18,24,8,20,4,24,7,1,88,12.571428571428571,1,0.0,8,8,17,4,16,24,3,7,1,37,51,0
2295,32887,9WVTv7dWHzTCHwCGLSPAioAO2udyHWmu,SpATywNh6bZuzm8s1ceuBUnMUAeoAHHw,16,24,9,18,5,32,17,0,105,15.0,5,0.0,14,9,16,5,10,32,2,17,0,44,61,0
2296,32917,dwKCRrq2cYlFl5YxmnjTpirr5PBMVnOq,SpATywNh6bZuzm8s1ceuBUnMUAeoAHHw,10,29,14,0,6,5,4,0,58,8.285714285714286,2,0.0,9,14,0,6,20,5,0,4,0,29,29,0
2297,32923,NqKjMSY6eOZQ1uSyzlPrquJVqzjvSO7O,SpATywNh6bZuzm8s1ceuBUnMUAeoAHHw,26,43,21,24,5,23,12,4,132,18.857142857142858,5,0.0,9,21,24,5,34,23,0,12,4,59,73,0
2298,32929,OWN7QY4MoQINwciZKacEUOaJkqenbOMp,SpATywNh6bZuzm8s1ceuBUnMUAeoAHHw,5,0,0,0,0,0,4,1,5,0.7142857142857143,1,0.0,0,0,0,0,0,0,0,4,1,0,5,0
2299,32962,gi1cGXmBNmpbe6lA2hzKFh8EEd7gQMCM,7GRhBDsirIGkRZBtSMEzNTyDr2JQm4xx,1,0,0,0,0,0,1,0,1,0.14285714285714285,1,0.0,0,0,0,0,0,0,0,1,0,0,1,1
2300,32969,z4c8EBwIn89viFGIwasAjQhkMGV3BTQj,SpATywNh6bZuzm8s1ceuBUnMUAeoAHHw,16,28,16,14,13,0,2,0,73,10.428571428571429,3,0.0,7,16,10,13,21,0,4,2,0,46,27,0
2301,32970,f9VMkfOoUWXzqEbeO2IX0YOVcNKnSKLo,7GRhBDsirIGkRZBtSMEzNTyDr2JQm4xx,1,0,0,0,0,0,1,0,1,0.14285714285714285,1,0.0,0,0,0,0,0,0,0,1,0,0,1,1
2302,32976,E7QFiJdCviuClYDIfnaKnxTdSk0i534L,7GRhBDsirIGkRZBtSMEzNTyDr2JQm4xx,1,0,0,0,0,0,1,0,1,0.14285714285714285,1,0.0,0,0,0,0,0,0,0,1,0,0,1,1
2303,32983,BtS3BvehCjq4QaGPbzrC7JIugP6OKoPy,7GRhBDsirIGkRZBtSMEzNTyDr2JQm4xx,45,92,40,73,28,30,30,2,295,42.142857142857146,6,0.0,38,40,61,28,54,30,12,30,2,167,128,1
2304,33024,P7HoHyQzVXLghYr6m3MYTEIsDQbHfDfp,SpATywNh6bZuzm8s1ceuBUnMUAeoAHHw,5,3,1,0,1,0,1,0,6,0.8571428571428571,1,0.0,0,1,0,1,3,0,0,1,0,2,4,0
2305,33071,S4x7F2zwGMymIPjPy7YGoWTUwlKzmNvg,7GRhBDsirIGkRZBtSMEzNTyDr2JQm4xx,19,22,8,18,3,7,35,3,96,13.714285714285714,5,0.0,2,8,15,3,20,7,3,35,3,28,68,1
2306,33080,5ADMlR48WDr3F57JEz4JNbgGytxoga6J,SpATywNh6bZuzm8s1ceuBUnMUAeoAHHw,16,30,2,15,1,1,32,1,82,11.714285714285714,7,0.0,16,2,15,1,14,1,0,32,1,34,48,0
2307,33150,vU01Fxors0KlSd7gao1Z0nHesILTHNPI,SpATywNh6bZuzm8s1ceuBUnMUAeoAHHw,23,34,9,8,5,16,22,0,94,13.428571428571429,8,0.0,1,9,8,5,33,16,0,22,0,23,71,0
2308,33164,AJYnlahOLAGVXTJrzU8y7gkOQqLtYt6X,SpATywNh6bZuzm8s1ceuBUnMUAeoAHHw,13,14,6,19,4,3,1,0,47,6.714285714285714,1,0.0,3,6,16,4,11,3,3,1,0,29,18,0
2309,33169,FPQSXji4bDip0jB4obm0vWFPXClGuSyC,7GRhBDsirIGkRZBtSMEzNTyDr2JQm4xx,52,77,32,88,21,24,17,1,260,37.142857142857146,7,0.0,39,32,71,21,38,24,17,17,1,163,97,0
2310,33179,79cpMMK2EsbvkowaPozXyQoZKeC4iKuw,A3fsA9Zfv1X2fVEQhTw51lKENdNrEqT3,5,2,1,0,1,0,5,0,9,1.2857142857142858,2,0.0,0,1,0,1,2,0,0,5,0,2,7,0
2311,33203,6oSvXBiE6hMQm6ur1TzQBxRkuWf4UJ1w,SpATywNh6bZuzm8s1ceuBUnMUAeoAHHw,30,100,39,28,9,17,39,2,234,33.42857142857143,5,0.0,30,39,22,9,70,17,6,39,2,100,134,0
2312,33251,9oofyIqQs4svoCsTL3Pyep7hA30rIFOe,SpATywNh6bZuzm8s1ceuBUnMUAeoAHHw,15,22,10,17,3,3,7,0,62,8.857142857142858,3,0.0,8,10,15,3,14,3,2,7,0,36,26,0
2313,33266,ANj8LPP4QCqsLHbhaQj263PWrIQ9dqGZ,SpATywNh6bZuzm8s1ceuBUnMUAeoAHHw,20,39,0,31,0,0,7,1,78,11.142857142857142,2,0.0,18,0,26,0,21,0,5,7,1,44,34,0
2314,33270,BFrfDseDfXCBvtTfCsJAy36Ogk6b0Rfx,SpATywNh6bZuzm8s1ceuBUnMUAeoAHHw,18,37,20,0,7,0,10,0,74,10.571428571428571,5,0.0,0,20,0,7,37,0,0,10,0,27,47,0
2315,33272,QQyKT0cNRgXjfYZrcyku7Q3OKE07rSzG,A3fsA9Zfv1X2fVEQhTw51lKENdNrEqT3,1,0,0,0,0,0,1,0,1,0.14285714285714285,1,0.0,0,0,0,0,0,0,0,1,0,0,1,1
2316,33284,jRnFs6XBk6vGxxB24JG9v0Qh3pYfUtLh,RXDvfPUBYFlVdlueBFbLW0mhhAyGEqpt,44,103,36,73,13,10,25,15,275,39.285714285714285,7,0.0,12,36,66,13,91,10,7,25,15,127,148,0
2317,33290,0wm7bVyJC7jfhIoeylaV85sHOH5JOhtj,SpATywNh6bZuzm8s1ceuBUnMUAeoAHHw,27,53,15,23,8,13,15,1,128,18.285714285714285,6,0.0,12,15,19,8,41,13,4,15,1,54,74,0
2318,33298,wjqMTSqGRhad7XTyyuysYYbP0x4J6ulv,bWdj2GDclj5ofokWjzoa5jAwMkxCykd6,8,13,3,0,3,2,8,0,29,4.142857142857143,3,0.0,0,3,0,3,13,2,0,8,0,6,23,1
2319,33322,vIBcYbs1BLdmaaP30fcE2FS7kB7v7QRn,SpATywNh6bZuzm8s1ceuBUnMUAeoAHHw,4,2,1,0,0,0,3,0,6,0.8571428571428571,2,0.0,0,1,0,0,2,0,0,3,0,1,5,1
2320,33331,mJNmN9AbVBmhzBfxSlHeSff1yTyr8w50,SpATywNh6bZuzm8s1ceuBUnMUAeoAHHw,22,75,27,0,15,6,26,0,149,21.285714285714285,8,0.0,0,27,0,15,75,6,0,26,0,42,107,0
2321,33348,we9tWnySpl1G7k7FqyXPj8wmC2gUYK0W,SpATywNh6bZuzm8s1ceuBUnMUAeoAHHw,14,15,1,13,1,5,6,3,44,6.285714285714286,2,0.0,5,1,12,1,10,5,1,6,3,19,25,0
2322,33354,0LjNTZG6byvXe7xKDfNEXUTZjqaDOglx,G8EPVSXsOYB5YQWZGiz1aVq5Pgr2GrQu,17,19,9,6,4,0,10,1,49,7.0,3,0.0,3,9,5,4,16,0,1,10,1,21,28,1
2323,33368,hJo1MgKiPZFXuH2ko6hqPTd9dbjMQKDO,bWdj2GDclj5ofokWjzoa5jAwMkxCykd6,7,10,6,0,1,0,5,0,22,3.142857142857143,3,0.0,0,6,0,1,10,0,0,5,0,7,15,0
2324,33370,3EwUg208bV0DvnhKptmbGHdmCctMgvT5,SpATywNh6bZuzm8s1ceuBUnMUAeoAHHw,6,7,2,0,0,1,3,0,13,1.8571428571428572,1,0.0,0,2,0,0,7,1,0,3,0,2,11,1
2325,33431,viuKt4GgrX0rYL5EpHoxJbsiC9TblSuk,A3fsA9Zfv1X2fVEQhTw51lKENdNrEqT3,32,71,34,14,5,10,46,0,180,25.714285714285715,5,0.0,1,34,8,5,70,10,6,46,0,48,132,0
2326,33443,viuKt4GgrX0rYL5EpHoxJbsiC9TblSuk,bWdj2GDclj5ofokWjzoa5jAwMkxCykd6,14,26,17,0,9,27,24,0,103,14.714285714285714,7,0.0,0,17,0,9,26,27,0,24,0,26,77,0
2327,33469,viuKt4GgrX0rYL5EpHoxJbsiC9TblSuk,G8EPVSXsOYB5YQWZGiz1aVq5Pgr2GrQu,16,27,15,0,2,18,18,0,80,11.428571428571429,5,0.0,0,15,0,2,27,18,0,18,0,17,63,0
2328,33481,viuKt4GgrX0rYL5EpHoxJbsiC9TblSuk,RXDvfPUBYFlVdlueBFbLW0mhhAyGEqpt,30,101,35,0,7,87,39,0,269,38.42857142857143,6,0.0,11,35,0,7,90,87,0,39,0,53,216,0
2329,33500,VwUXTBGJaTv5xN1He6TwE1OKxII3IUB4,7GRhBDsirIGkRZBtSMEzNTyDr2JQm4xx,3,6,1,0,1,1,1,0,10,1.4285714285714286,1,0.0,2,1,0,1,4,1,0,1,0,4,6,1
2330,33506,R6mWJ0ZeHkZWWi0xlkZZqK7iozuGXemG,7GRhBDsirIGkRZBtSMEzNTyDr2JQm4xx,8,10,6,0,5,3,9,2,35,5.0,3,0.0,4,6,0,5,6,3,0,9,2,15,20,1
2331,33517,R6mWJ0ZeHkZWWi0xlkZZqK7iozuGXemG,SpATywNh6bZuzm8s1ceuBUnMUAeoAHHw,18,26,12,20,5,6,12,1,82,11.714285714285714,3,0.0,9,12,17,5,17,6,3,12,1,43,39,1
2332,33519,7yKH9idxIZZIHmSby2TlRwglHE2J4AOu,7GRhBDsirIGkRZBtSMEzNTyDr2JQm4xx,28,74,23,22,9,14,12,2,156,22.285714285714285,4,0.0,19,23,20,9,55,14,2,12,2,71,85,1
2333,33521,kOcsNetIsK9HFRaYNeKiWrndfQDPUf2b,7GRhBDsirIGkRZBtSMEzNTyDr2JQm4xx,32,51,25,42,24,3,5,0,150,21.428571428571427,3,0.0,21,25,36,24,30,3,6,5,0,106,44,1
2334,33576,KshwCmsAWd7PYW2Qdxpd0Dd8iC7QTJ5v,SpATywNh6bZuzm8s1ceuBUnMUAeoAHHw,11,10,4,0,3,0,2,0,19,2.7142857142857144,2,0.0,0,4,0,3,10,0,0,2,0,7,12,0
2335,33589,orkcYdEVQqlH9SJjCRUiZ5P3bFy172XW,7GRhBDsirIGkRZBtSMEzNTyDr2JQm4xx,4,7,0,0,0,0,3,0,10,1.4285714285714286,2,0.0,0,0,0,0,7,0,0,3,0,0,10,1
2336,33638,kGNoIC9AxgB9nCs6frsN1R7EeU5BsStD,SpATywNh6bZuzm8s1ceuBUnMUAeoAHHw,10,21,5,16,1,0,2,0,45,6.428571428571429,1,0.0,15,5,13,1,6,0,3,2,0,34,11,1
2337,33644,eE4DAv5aHElS2DPaTad4VXPjk6A3xvPl,G8EPVSXsOYB5YQWZGiz1aVq5Pgr2GrQu,79,68,40,146,26,0,10,1,291,41.57142857142857,4,0.0,15,40,127,26,53,0,19,10,1,208,83,0
2338,33676,csMt1h4jwoK6sZ6rEkcutiAH8F6ocCR4,A3fsA9Zfv1X2fVEQhTw51lKENdNrEqT3,11,12,0,0,0,0,1,0,13,1.8571428571428572,1,0.0,0,0,0,0,12,0,0,1,0,0,13,1
2339,34738,4en36s6M5dWiGXaOz7Ao485PkasQppcC,7GRhBDsirIGkRZBtSMEzNTyDr2JQm4xx,1,0,0,0,0,0,1,0,1,0.14285714285714285,1,0.0,0,0,0,0,0,0,0,1,0,0,1,1
2340,34771,1znu7Xzg4p1qA4YkunjQTwOhXoKFFWr0,7GRhBDsirIGkRZBtSMEzNTyDr2JQm4xx,7,3,1,0,1,0,3,0,8,1.1428571428571428,2,0.0,0,1,0,1,3,0,0,3,0,2,6,0
2341,34808,t6gbXbSU5L3FPpVibBhtf9ABrcXvjFov,7GRhBDsirIGkRZBtSMEzNTyDr2JQm4xx,5,9,6,0,5,0,2,0,22,3.142857142857143,1,0.0,0,6,0,5,9,0,0,2,0,11,11,0
2342,35152,VsfU7jeSb2K8k0CBzCZzXJjDlMye1sB1,7GRhBDsirIGkRZBtSMEzNTyDr2JQm4xx,26,46,27,24,18,4,7,0,126,18.0,4,0.0,13,27,21,18,33,4,3,7,0,79,47,1
2343,35156,WDMP5c2Ubx8vVSFegA0mXeU23cYb0qCY,7GRhBDsirIGkRZBtSMEzNTyDr2JQm4xx,27,37,2,32,5,4,2,0,82,11.714285714285714,3,0.0,18,2,30,5,19,4,2,2,0,55,27,1
2344,35159,dJJJLtI6F18pblO9KPkBPg9ZKTgQPaQc,7GRhBDsirIGkRZBtSMEzNTyDr2JQm4xx,26,65,0,28,6,1,6,0,106,15.142857142857142,5,0.0,32,0,28,6,33,1,0,6,0,66,40,0
2345,35167,eU4MPF9R01ru4sQN9giW756pdpNlnW4H,7GRhBDsirIGkRZBtSMEzNTyDr2JQm4xx,5,4,2,0,1,0,2,0,9,1.2857142857142858,2,0.0,0,2,0,1,4,0,0,2,0,3,6,0
2346,35583,O36QxtTrV6jSigC0QBjRMiqSpx0KHX6w,7GRhBDsirIGkRZBtSMEzNTyDr2JQm4xx,65,118,38,126,29,24,16,0,351,50.142857142857146,4,0.0,68,38,109,29,50,24,17,16,0,244,107,0
2347,35592,WgQR6nrfyl7yDpgHC595JSoog2R9VhVs,7GRhBDsirIGkRZBtSMEzNTyDr2JQm4xx,66,154,62,126,35,12,13,0,402,57.42857142857143,10,0.0,73,62,97,35,81,12,29,13,0,267,135,0
2348,35726,xHZbSROhwP4RRQerUVWvcNTfOGc2DHWf,7GRhBDsirIGkRZBtSMEzNTyDr2JQm4xx,59,163,64,103,30,60,47,1,468,66.85714285714286,11,0.0,45,64,84,30,118,60,19,47,1,223,245,1
2349,35753,aXYyJMDvVYwwKBbiO4CB25XlnDBfWYNg,7GRhBDsirIGkRZBtSMEzNTyDr2JQm4xx,18,27,9,18,1,11,6,0,72,10.285714285714286,3,0.0,14,9,15,1,13,11,3,6,0,39,33,0
2350,35817,Kneva8tRfI6BhvgFMe4i80mebf2hEQk0,7GRhBDsirIGkRZBtSMEzNTyDr2JQm4xx,9,5,4,0,2,0,5,0,16,2.2857142857142856,2,0.0,0,4,0,2,5,0,0,5,0,6,10,1
2351,37571,9jZsAxMdQXvLjxKIorcfAyZ7kTyyk2m3,A3fsA9Zfv1X2fVEQhTw51lKENdNrEqT3,19,25,13,14,2,3,11,0,68,9.714285714285714,4,0.0,0,13,14,2,25,3,0,11,0,29,39,1
2352,37590,ZHGbzWgnUfJJPdovMfpePS97QxPtktWe,SpATywNh6bZuzm8s1ceuBUnMUAeoAHHw,7,2,1,0,1,0,5,0,9,1.2857142857142858,1,0.0,0,1,0,1,2,0,0,5,0,2,7,1
2353,37593,ZmKF4tFBenzCeCXZcmDdE2tsuT4rzLPd,G8EPVSXsOYB5YQWZGiz1aVq5Pgr2GrQu,5,2,1,0,1,0,2,0,6,0.8571428571428571,1,0.0,0,1,0,1,2,0,0,2,0,2,4,1
2354,37599,yVtzjNm7Xgz14yjopuLvCh7VRZR9RBra,bWdj2GDclj5ofokWjzoa5jAwMkxCykd6,7,13,5,2,6,0,7,0,33,4.714285714285714,2,0.0,5,5,2,6,8,0,0,7,0,18,15,1
2355,37600,NHGmMinB9WoQusKCx50F4M4nJF124Ms4,A3fsA9Zfv1X2fVEQhTw51lKENdNrEqT3,19,27,17,0,7,17,33,5,106,15.142857142857142,4,0.0,0,17,0,7,27,17,0,33,5,24,82,1
2356,37607,NvmmlHTgNmxqyrQU3a9c6oM8kVrIYu3Q,SpATywNh6bZuzm8s1ceuBUnMUAeoAHHw,17,23,10,0,8,0,6,0,47,6.714285714285714,3,0.0,0,10,0,8,23,0,0,6,0,18,29,1
2357,37613,deaOh1cCfPHHygo0HX3j8JDIzRZNPF7P,SpATywNh6bZuzm8s1ceuBUnMUAeoAHHw,10,6,3,13,2,0,1,0,25,3.5714285714285716,2,0.0,2,3,12,2,4,0,1,1,0,19,6,0
2358,37618,ABlVlNkPi30ZMlFLrcsAhP5jZW6rJhdZ,A3fsA9Zfv1X2fVEQhTw51lKENdNrEqT3,22,16,13,0,11,0,4,0,44,6.285714285714286,3,0.0,0,13,0,11,16,0,0,4,0,24,20,1
2359,37621,7ynsHGhJ1N4494Hez57ckblgtBNGbed9,A3fsA9Zfv1X2fVEQhTw51lKENdNrEqT3,1,0,0,0,0,0,1,0,1,0.14285714285714285,1,0.0,0,0,0,0,0,0,0,1,0,0,1,1
2360,37622,3hFWpwvaMZB4do5VrkI46WX7phUXE8q9,SpATywNh6bZuzm8s1ceuBUnMUAeoAHHw,1,0,0,0,0,0,2,0,2,0.2857142857142857,1,0.0,0,0,0,0,0,0,0,2,0,0,2,1
2361,37627,61Btwz5kWZaS3OIGnNTMXi3lqbtcLCB7,SpATywNh6bZuzm8s1ceuBUnMUAeoAHHw,26,111,18,17,5,0,49,0,200,28.571428571428573,10,0.0,12,18,17,5,99,0,0,49,0,52,148,1
2362,37628,9S5uoFAiVHVF4D2DNR23wCkbQZ8LhtES,RXDvfPUBYFlVdlueBFbLW0mhhAyGEqpt,31,43,13,36,10,0,8,0,110,15.714285714285714,5,0.0,12,13,34,10,31,0,2,8,0,69,41,0
2363,37655,W68HJCLMGaPDXLquuNsADTmn70KIcSIQ,G8EPVSXsOYB5YQWZGiz1aVq5Pgr2GrQu,2,0,0,0,0,0,4,0,4,0.5714285714285714,1,0.0,0,0,0,0,0,0,0,4,0,0,4,1
2364,37656,BGZaaH5HDVuGvqaegp5MyJblPEuJpcXP,bWdj2GDclj5ofokWjzoa5jAwMkxCykd6,2,0,0,0,0,0,2,0,2,0.2857142857142857,1,0.0,0,0,0,0,0,0,0,2,0,0,2,1
2365,37657,h93nu205LxG6yA79vswKf1FixgIn79rm,G8EPVSXsOYB5YQWZGiz1aVq5Pgr2GrQu,10,11,5,0,0,1,7,1,25,3.5714285714285716,1,0.0,4,5,0,0,7,1,0,7,1,9,16,1
2366,37658,k3sYdhuU0JisiJgPpOdae3U2CoUcaazJ,SpATywNh6bZuzm8s1ceuBUnMUAeoAHHw,16,24,7,12,3,23,7,1,77,11.0,2,0.0,10,7,12,3,14,23,0,7,1,32,45,1
2367,37661,BGZaaH5HDVuGvqaegp5MyJblPEuJpcXP,A3fsA9Zfv1X2fVEQhTw51lKENdNrEqT3,2,0,0,0,0,0,2,0,2,0.2857142857142857,1,0.0,0,0,0,0,0,0,0,2,0,0,2,0
2368,37675,4P8kDd8yuaZj29FYuMADbc9LGiIxpIwD,bWdj2GDclj5ofokWjzoa5jAwMkxCykd6,15,16,5,59,4,3,11,1,99,14.142857142857142,2,0.0,6,5,56,4,10,3,3,11,1,71,28,1
2369,37686,UkQJwGAwu2oSVR7bdUsiWWEqFzH2qHlf,SpATywNh6bZuzm8s1ceuBUnMUAeoAHHw,26,44,8,34,3,0,11,0,100,14.285714285714286,4,0.0,9,8,29,3,35,0,5,11,0,49,51,0
2370,37694,umy7brIUz48bN1VUJsZEuHA9by5FINCa,A3fsA9Zfv1X2fVEQhTw51lKENdNrEqT3,23,27,21,0,13,3,16,0,80,11.428571428571429,2,0.0,0,21,0,13,27,3,0,16,0,34,46,1
2371,37695,KaDaT2PXnsmD67HkbCpFnRySFfo61Clp,A3fsA9Zfv1X2fVEQhTw51lKENdNrEqT3,19,20,15,0,13,0,3,0,51,7.285714285714286,2,0.0,0,15,0,13,20,0,0,3,0,28,23,1
2372,37700,bLIF0ETNcg7fjkutu8YBWJptM3zxtu2Z,A3fsA9Zfv1X2fVEQhTw51lKENdNrEqT3,9,11,11,0,11,1,11,0,45,6.428571428571429,2,0.0,0,11,0,11,11,1,0,11,0,22,23,1
2373,37712,K8l2u7bOqtMijaHas6Baa4xmjexwxyjr,G8EPVSXsOYB5YQWZGiz1aVq5Pgr2GrQu,7,3,2,0,2,0,6,0,13,1.8571428571428572,1,0.0,0,2,0,2,3,0,0,6,0,4,9,0
2374,37715,vfZ107RlnUxktrRHn8r9duLiSNHxQt59,SpATywNh6bZuzm8s1ceuBUnMUAeoAHHw,13,8,6,2,3,8,3,0,30,4.285714285714286,1,0.0,0,6,2,3,8,8,0,3,0,11,19,1
2375,37730,z3YnX73v2uoVHmuLGzQD2gKKBoJqIQxK,bWdj2GDclj5ofokWjzoa5jAwMkxCykd6,36,93,50,184,34,2,28,2,393,56.142857142857146,8,0.0,26,50,166,34,67,2,18,28,2,276,117,0
2376,37740,B1u0c5LDTPlzBAhbGuUr9zut2NBFb4ik,G8EPVSXsOYB5YQWZGiz1aVq5Pgr2GrQu,8,4,3,0,2,0,2,0,11,1.5714285714285714,1,0.0,0,3,0,2,4,0,0,2,0,5,6,1
2377,37743,5IM8g7YMOYo5qH7Yu3x31T3JkVOH9iqe,A3fsA9Zfv1X2fVEQhTw51lKENdNrEqT3,17,26,8,0,7,0,2,0,43,6.142857142857143,1,0.0,0,8,0,7,26,0,0,2,0,15,28,1
2378,37744,YGd4irzc5KMR1PH2KdOtbCkghLMZ2dPk,bWdj2GDclj5ofokWjzoa5jAwMkxCykd6,4,2,2,0,0,0,2,0,6,0.8571428571428571,1,0.0,0,2,0,0,2,0,0,2,0,2,4,1
2379,37750,GpHiOkm3UY3R1sigoD8RZsfbPyCjOvL2,bWdj2GDclj5ofokWjzoa5jAwMkxCykd6,12,38,22,0,17,0,18,1,96,13.714285714285714,9,0.0,0,22,0,17,38,0,0,18,1,39,57,1
2380,37754,qzjZHUzfivuSEB3h2CxO69AUVaBX51Ki,A3fsA9Zfv1X2fVEQhTw51lKENdNrEqT3,2,0,0,0,0,0,5,0,5,0.7142857142857143,2,0.0,0,0,0,0,0,0,0,5,0,0,5,1
2381,37767,b9kodEhA94IDSBT3ykY4QWiqr6rjyws0,G8EPVSXsOYB5YQWZGiz1aVq5Pgr2GrQu,1,0,0,0,0,0,1,0,1,0.14285714285714285,1,0.0,0,0,0,0,0,0,0,1,0,0,1,1
2382,37768,CeSP4PMtab0Lz3R25BXEghWPiV1yY5Ef,SpATywNh6bZuzm8s1ceuBUnMUAeoAHHw,15,22,3,17,0,9,17,2,70,10.0,3,0.0,9,3,15,0,13,9,2,17,2,27,43,1
2383,37778,MT2eJtF59AVNdUs7mwFqputROb2HgEm3,A3fsA9Zfv1X2fVEQhTw51lKENdNrEqT3,70,32,21,160,14,0,11,1,239,34.142857142857146,4,0.0,6,21,131,14,26,0,29,11,1,172,67,0
2384,37792,fXZ6GxDg4jr2jydxDfAmDq6HhmCcTKhM,bWdj2GDclj5ofokWjzoa5jAwMkxCykd6,6,1,1,0,1,0,3,1,7,1.0,1,0.0,0,1,0,1,1,0,0,3,1,2,5,1
2385,37794,uQjl8NGtIQkRfoe9edBiMgtYYmdkzVXR,A3fsA9Zfv1X2fVEQhTw51lKENdNrEqT3,64,91,51,134,20,8,37,1,342,48.857142857142854,8,0.0,11,51,107,20,80,8,27,37,1,189,153,0
2386,37795,AtIH4YI3eYIPCQxtOLtZgwyhSnXOdn2e,A3fsA9Zfv1X2fVEQhTw51lKENdNrEqT3,1,0,0,0,0,0,1,0,1,0.14285714285714285,1,0.0,0,0,0,0,0,0,0,1,0,0,1,1
2387,37796,Zl7A4QMlAs6IcbXcPt0cXmqZJLFzPwcf,SpATywNh6bZuzm8s1ceuBUnMUAeoAHHw,15,14,7,10,5,0,10,0,46,6.571428571428571,2,0.0,4,7,9,5,10,0,1,10,0,25,21,1
2388,37799,t7ddfllmrYfl93sdsVEbTfmmaWswoGkm,bWdj2GDclj5ofokWjzoa5jAwMkxCykd6,11,21,11,0,7,0,11,1,51,7.285714285714286,3,0.0,2,11,0,7,19,0,0,11,1,20,31,1
2389,37806,0FuB48Egjj7khWsNq1DtKTVsB7OEgidM,bWdj2GDclj5ofokWjzoa5jAwMkxCykd6,10,17,9,0,7,0,10,0,43,6.142857142857143,2,0.0,2,9,0,7,15,0,0,10,0,18,25,1
2390,37809,eEE69ZWSNrdmveqNEUHZYk60iG9wpaEc,SpATywNh6bZuzm8s1ceuBUnMUAeoAHHw,18,36,18,11,4,32,11,0,112,16.0,4,0.0,7,18,9,4,29,32,2,11,0,38,74,1
2391,37810,NcPdgwZnF0RkLUxC56tG83zG3V3KP94S,SpATywNh6bZuzm8s1ceuBUnMUAeoAHHw,14,18,10,17,4,4,10,1,64,9.142857142857142,4,0.0,6,10,14,4,12,4,3,10,1,34,30,1
2392,37820,VjekNiOqthnLG6rS8JBJtCSICch28JV9,SpATywNh6bZuzm8s1ceuBUnMUAeoAHHw,11,12,9,0,5,0,8,0,34,4.857142857142857,3,0.0,0,9,0,5,12,0,0,8,0,14,20,0
2393,37823,2Y3h62Lps0fU6B3C4MXM4YNVNDf25XBr,SpATywNh6bZuzm8s1ceuBUnMUAeoAHHw,10,16,11,0,7,0,4,0,38,5.428571428571429,4,0.0,0,11,0,7,16,0,0,4,0,18,20,0
2394,37825,C2tzR0PThnHl9xmZylE5Te8es3KNWViY,SpATywNh6bZuzm8s1ceuBUnMUAeoAHHw,1,0,0,0,0,0,1,0,1,0.14285714285714285,1,0.0,0,0,0,0,0,0,0,1,0,0,1,1
2395,37827,C2tzR0PThnHl9xmZylE5Te8es3KNWViY,bWdj2GDclj5ofokWjzoa5jAwMkxCykd6,8,15,0,0,1,1,6,0,23,3.2857142857142856,5,0.0,0,0,0,1,15,1,0,6,0,1,22,1
2396,37830,0FuB48Egjj7khWsNq1DtKTVsB7OEgidM,A3fsA9Zfv1X2fVEQhTw51lKENdNrEqT3,26,20,15,0,12,0,8,1,56,8.0,2,0.0,0,15,0,12,20,0,0,8,1,27,29,0
2397,37841,H4f84AflSuLjxZbar9MNvTHEIA8lIMO0,G8EPVSXsOYB5YQWZGiz1aVq5Pgr2GrQu,8,2,2,0,2,0,3,0,9,1.2857142857142858,1,0.0,0,2,0,2,2,0,0,3,0,4,5,1
2398,37842,QeQqhAEpCOGJwaPPp0lj3OsPiBcGFat2,SpATywNh6bZuzm8s1ceuBUnMUAeoAHHw,14,52,3,4,3,1,15,0,78,11.142857142857142,5,0.0,14,3,4,3,38,1,0,15,0,24,54,0
2399,37851,6ovqVSF3YZ6bnWJaJ7v2dHPROWXVVlFQ,SpATywNh6bZuzm8s1ceuBUnMUAeoAHHw,15,14,6,10,3,0,4,2,39,5.571428571428571,2,0.0,6,6,10,3,8,0,0,4,2,25,14,1
2400,37857,fhNT15VFhs3gsHOTo44snQYPYn9BDZ0e,A3fsA9Zfv1X2fVEQhTw51lKENdNrEqT3,5,6,3,0,0,3,4,0,16,2.2857142857142856,2,0.0,1,3,0,0,5,3,0,4,0,4,12,1
2401,37862,i454zkNvATiV1XJbjzVrf2ArWE1JYXx7,G8EPVSXsOYB5YQWZGiz1aVq5Pgr2GrQu,6,1,1,0,1,0,5,0,8,1.1428571428571428,1,0.0,0,1,0,1,1,0,0,5,0,2,6,1
2402,37879,xx9GC4KvGKaMlifXkbb8bDYUKB0PSURf,G8EPVSXsOYB5YQWZGiz1aVq5Pgr2GrQu,14,9,6,0,5,0,4,0,24,3.4285714285714284,1,0.0,0,6,0,5,9,0,0,4,0,11,13,1
2403,37900,qZhmmNUvkNXdf3u04DTUQOFEBxxO10p4,SpATywNh6bZuzm8s1ceuBUnMUAeoAHHw,29,74,31,22,7,4,27,0,165,23.571428571428573,10,0.0,13,31,20,7,61,4,2,27,0,71,94,0
2404,37901,blQFA8HzhNQeb8MMYJXyJW6sPMdvZQKn,bWdj2GDclj5ofokWjzoa5jAwMkxCykd6,7,4,2,0,1,0,8,0,15,2.142857142857143,2,0.0,0,2,0,1,4,0,0,8,0,3,12,1
2405,37902,fHWbyI7D8dlYSwaHNTLNlsq8suMt5t3C,SpATywNh6bZuzm8s1ceuBUnMUAeoAHHw,25,83,37,33,10,77,50,4,294,42.0,6,0.0,14,37,30,10,69,77,3,50,4,91,203,1
2406,37917,zov347eGa3QeB2nEEXWZhFIKLoCmgiMD,SpATywNh6bZuzm8s1ceuBUnMUAeoAHHw,10,34,4,0,2,2,8,0,50,7.142857142857143,4,0.0,0,4,0,2,34,2,0,8,0,6,44,0
2407,37922,j3dtYivg2u73ZbuSWbPPpSBQQec6vBYH,A3fsA9Zfv1X2fVEQhTw51lKENdNrEqT3,6,4,2,0,1,0,5,0,12,1.7142857142857142,4,0.0,0,2,0,1,4,0,0,5,0,3,9,0
2408,37923,EHdY3AEgr2nI6jaAM9bjHY2nqgEPned4,SpATywNh6bZuzm8s1ceuBUnMUAeoAHHw,11,12,4,5,2,0,4,0,27,3.857142857142857,2,0.0,2,4,4,2,10,0,1,4,0,12,15,1
2409,37925,v1W3YvgJ0IFCSGXyKmwZ2bb9TVfgDIwv,G8EPVSXsOYB5YQWZGiz1aVq5Pgr2GrQu,6,6,2,0,2,0,1,0,11,1.5714285714285714,1,0.0,3,2,0,2,3,0,0,1,0,7,4,0
2410,37935,OkJ0lKmMXuQ2MGftQ8Isfw1JciMpapRC,SpATywNh6bZuzm8s1ceuBUnMUAeoAHHw,15,32,17,7,9,2,9,0,76,10.857142857142858,5,0.0,3,17,7,9,29,2,0,9,0,36,40,0
2411,37940,QmHQ7ayFECnRsgCVpHpJI6yMYR4kf5re,bWdj2GDclj5ofokWjzoa5jAwMkxCykd6,14,22,13,14,0,7,8,0,64,9.142857142857142,3,0.0,1,13,14,0,21,7,0,8,0,28,36,0
2412,37960,bz2uqvuFRCLaJmY4vFLIXrs9g0cTBHJC,A3fsA9Zfv1X2fVEQhTw51lKENdNrEqT3,42,19,14,52,9,0,12,3,109,15.571428571428571,4,0.0,1,14,46,9,18,0,6,12,3,70,39,1
2413,37973,k0lvFNaTVHTtB1XHBZ8229ej4v1r4rPk,bWdj2GDclj5ofokWjzoa5jAwMkxCykd6,10,9,1,0,1,6,15,1,33,4.714285714285714,3,0.0,0,1,0,1,9,6,0,15,1,2,31,0
2414,37982,OJtJM3YEXIy4oJKwRv1QkycNqhb8JLoi,SpATywNh6bZuzm8s1ceuBUnMUAeoAHHw,6,2,1,0,1,0,3,2,9,1.2857142857142858,1,0.0,0,1,0,1,2,0,0,3,2,2,7,1
2415,37983,YG3IIEQOezPClODg4SNvtFayndWcEJ7a,A3fsA9Zfv1X2fVEQhTw51lKENdNrEqT3,8,11,5,0,1,0,5,0,22,3.142857142857143,2,0.0,0,5,0,1,11,0,0,5,0,6,16,1
2416,37988,fUqxJqppQTNVXv13r4wKORaBU4L22bhx,SpATywNh6bZuzm8s1ceuBUnMUAeoAHHw,5,3,2,0,2,0,2,0,9,1.2857142857142858,1,0.0,0,2,0,2,3,0,0,2,0,4,5,1
2417,37989,jkwnVusgQrKbxfhd5nIkbaklULLOZT9D,A3fsA9Zfv1X2fVEQhTw51lKENdNrEqT3,1,0,0,0,0,0,2,0,2,0.2857142857142857,1,0.0,0,0,0,0,0,0,0,2,0,0,2,1
2418,38003,gxc60X8EJb2yIw8hE5NeguZan8o3YXLZ,SpATywNh6bZuzm8s1ceuBUnMUAeoAHHw,16,14,6,10,3,1,6,1,41,5.857142857142857,2,0.0,2,6,9,3,12,1,1,6,1,20,21,1
2419,38004,QEbMAkKsvpPGPL1XkTiHjXblquVwKrlD,A3fsA9Zfv1X2fVEQhTw51lKENdNrEqT3,17,19,3,0,1,0,13,1,37,5.285714285714286,4,0.0,1,3,0,1,18,0,0,13,1,5,32,1
2420,38006,KRzA1Kk4qiSF9draiukb1XAlRpMcb8Gh,SpATywNh6bZuzm8s1ceuBUnMUAeoAHHw,5,2,1,0,1,0,2,0,6,0.8571428571428571,1,0.0,0,1,0,1,2,0,0,2,0,2,4,1
2421,38016,i9wjeQMhaeiCRSFBW7M0FOy9yJ5VeZZF,SpATywNh6bZuzm8s1ceuBUnMUAeoAHHw,8,15,2,0,0,0,13,0,30,4.285714285714286,2,0.0,0,2,0,0,15,0,0,13,0,2,28,1
2422,38026,u82lBhpDxJIwlZISEntCxj1zgVFdW0vT,G8EPVSXsOYB5YQWZGiz1aVq5Pgr2GrQu,1,0,0,0,0,0,1,0,1,0.14285714285714285,1,0.0,0,0,0,0,0,0,0,1,0,0,1,1
2423,38033,KlQIh6CJiUFTrdMyk4Y8sFKMj5TT9ON4,A3fsA9Zfv1X2fVEQhTw51lKENdNrEqT3,26,20,15,0,10,1,8,1,55,7.857142857142857,2,0.0,2,15,0,10,18,1,0,8,1,27,28,1
2424,38047,KkXSOHPa8OPkVJQjN92ejg7MqYYerSuw,A3fsA9Zfv1X2fVEQhTw51lKENdNrEqT3,5,3,2,0,2,0,5,0,12,1.7142857142857142,2,0.0,0,2,0,2,3,0,0,5,0,4,8,1
2425,38068,PmZJAFj6wJkOD163WkhaJjRHdYOMjBZW,SpATywNh6bZuzm8s1ceuBUnMUAeoAHHw,18,18,6,18,3,59,6,1,111,15.857142857142858,4,0.0,9,6,15,3,9,59,3,6,1,33,78,1
2426,38070,sKmcegdtnOHdb8n0mSxwdw5R2hJqVxhV,SpATywNh6bZuzm8s1ceuBUnMUAeoAHHw,6,3,2,0,2,0,1,0,8,1.1428571428571428,1,0.0,0,2,0,2,3,0,0,1,0,4,4,1
2427,38087,QyvVrWztIgSCCViLyqSM2D5NbMV2fEBm,SpATywNh6bZuzm8s1ceuBUnMUAeoAHHw,1,0,0,0,0,0,1,0,1,0.14285714285714285,1,0.0,0,0,0,0,0,0,0,1,0,0,1,0
2428,38092,32tAPwhpK9bCQqIAiBE9WTs1sTNu9Vyf,A3fsA9Zfv1X2fVEQhTw51lKENdNrEqT3,1,0,0,0,0,0,1,0,1,0.14285714285714285,1,0.0,0,0,0,0,0,0,0,1,0,0,1,1
2429,38097,MkuttLQlAg2ibzg21YKyuq14uYFl6Q9Q,A3fsA9Zfv1X2fVEQhTw51lKENdNrEqT3,10,30,7,0,0,1,12,1,51,7.285714285714286,2,0.0,10,7,0,0,20,1,0,12,1,17,34,1
2430,38100,NsLNEhFZrusC9duqTXuavXuymnAo5QEg,SpATywNh6bZuzm8s1ceuBUnMUAeoAHHw,15,35,3,19,1,4,16,0,78,11.142857142857142,4,0.0,12,3,16,1,23,4,3,16,0,32,46,1
2431,38105,vrESC5Tu2ZaCb3FZy3EK8oGteg0Z9Ni5,SpATywNh6bZuzm8s1ceuBUnMUAeoAHHw,9,10,2,2,1,1,2,0,18,2.5714285714285716,2,0.0,0,2,2,1,10,1,0,2,0,5,13,1
2432,38106,ayqwdyDC23QUsfyE7IPhnu9xrtfBNG6f,A3fsA9Zfv1X2fVEQhTw51lKENdNrEqT3,8,3,2,0,2,0,7,0,14,2.0,1,0.0,0,2,0,2,3,0,0,7,0,4,10,1
2433,38107,LHHlrNsXCuatY288NK6FIa7kJtq4Rtqs,bWdj2GDclj5ofokWjzoa5jAwMkxCykd6,8,5,4,0,3,0,8,0,20,2.857142857142857,1,0.0,0,4,0,3,5,0,0,8,0,7,13,1
2434,38111,QRq9SneqdOEdNrPCbzGfNOJsUrpMzzSX,bWdj2GDclj5ofokWjzoa5jAwMkxCykd6,6,2,1,0,1,1,5,1,11,1.5714285714285714,2,0.0,0,1,0,1,2,1,0,5,1,2,9,1
2435,38123,c0naQwXHS50DG3yNNBzMC8iE3KoRWTjm,SpATywNh6bZuzm8s1ceuBUnMUAeoAHHw,7,1,1,0,1,0,4,1,8,1.1428571428571428,1,0.0,0,1,0,1,1,0,0,4,1,2,6,1
2436,38140,xGWjos5nKrn7rxQEQkV1V6pBI2rS4Q4S,SpATywNh6bZuzm8s1ceuBUnMUAeoAHHw,15,28,17,18,8,10,3,0,84,12.0,2,0.0,7,17,15,8,21,10,3,3,0,47,37,1
2437,38144,0Hl4WpPV6z0OC8rO0L3mZy6harAUBUs7,G8EPVSXsOYB5YQWZGiz1aVq5Pgr2GrQu,74,101,21,178,13,5,24,1,343,49.0,8,0.0,35,21,143,13,66,5,35,24,1,212,131,1
2438,38147,OHOHfGJUvl8C8rOynV86vKj0FrD2jzFO,SpATywNh6bZuzm8s1ceuBUnMUAeoAHHw,15,19,3,14,2,3,19,0,60,8.571428571428571,4,0.0,2,3,11,2,17,3,3,19,0,18,42,1
2439,38154,qazSXcMxbAaqtIZJoNDUrPRsgwDYZFDz,SpATywNh6bZuzm8s1ceuBUnMUAeoAHHw,1,0,0,0,0,0,1,0,1,0.14285714285714285,1,0.0,0,0,0,0,0,0,0,1,0,0,1,1
2440,38155,cqdnmjbJq0lDv2xgeKuzXqVr5xQytWr0,A3fsA9Zfv1X2fVEQhTw51lKENdNrEqT3,6,4,2,0,1,0,2,0,9,1.2857142857142858,1,0.0,0,2,0,1,4,0,0,2,0,3,6,1
2441,38157,tHNSnLtZK1vGs5MVrEoD7S1mcW3GtFm4,SpATywNh6bZuzm8s1ceuBUnMUAeoAHHw,16,20,10,14,4,2,2,0,52,7.428571428571429,2,0.0,3,10,13,4,17,2,1,2,0,30,22,0
2442,38170,vs0vqlNXzuHsqVxOsB15kGfpvGf2pUt3,SpATywNh6bZuzm8s1ceuBUnMUAeoAHHw,19,52,27,24,6,0,10,0,119,17.0,7,0.0,15,27,24,6,37,0,0,10,0,72,47,0
2443,38176,c59GF0I0pecGycS0yL4PRG9aMLNUIigo,bWdj2GDclj5ofokWjzoa5jAwMkxCykd6,5,2,1,0,1,0,3,0,7,1.0,2,0.0,0,1,0,1,2,0,0,3,0,2,5,1
2444,38187,SX4dmJ5a5AfJLGZkCiiWab293xeIyxbW,SpATywNh6bZuzm8s1ceuBUnMUAeoAHHw,29,93,12,29,10,9,41,4,198,28.285714285714285,7,0.0,10,12,25,10,83,9,4,41,4,57,141,0
2445,38192,PfM2UIipqAa1BYASMdmivESfQH5kpXct,RXDvfPUBYFlVdlueBFbLW0mhhAyGEqpt,8,5,4,0,2,0,1,0,12,1.7142857142857142,1,0.0,0,4,0,2,5,0,0,1,0,6,6,0
2446,38201,hUScWllYUJ1urcx9IQ6nI2SqodbYOaw3,SpATywNh6bZuzm8s1ceuBUnMUAeoAHHw,14,23,8,21,5,0,2,0,59,8.428571428571429,2,0.0,8,8,17,5,15,0,4,2,0,38,21,0
2447,38203,fZom2mtwZsSiSJuSBhugfgY0ABzNEmyV,G8EPVSXsOYB5YQWZGiz1aVq5Pgr2GrQu,13,25,13,0,9,2,4,0,53,7.571428571428571,3,0.0,9,13,0,9,16,2,0,4,0,31,22,1
2448,38206,kKH4olslIcMX5RimtmBANWk2T6CuD4cI,G8EPVSXsOYB5YQWZGiz1aVq5Pgr2GrQu,16,11,4,55,2,0,12,0,84,12.0,2,0.0,1,4,46,2,10,0,9,12,0,53,31,1
2449,38219,EwpbggvNdZkeSTjdG48aEltlJYavm02s,bWdj2GDclj5ofokWjzoa5jAwMkxCykd6,7,14,1,0,0,0,3,0,18,2.5714285714285716,2,0.0,1,1,0,0,13,0,0,3,0,2,16,0
2450,38243,dwm6PFLf21BfXk9L9RgwIu033moNrMaZ,A3fsA9Zfv1X2fVEQhTw51lKENdNrEqT3,2,0,0,0,0,0,2,0,2,0.2857142857142857,1,0.0,0,0,0,0,0,0,0,2,0,0,2,1
2451,38245,9d3FbHjuwecHssUlcCF17pB1YrxPmjAd,SpATywNh6bZuzm8s1ceuBUnMUAeoAHHw,5,2,1,0,1,0,2,0,6,0.8571428571428571,1,0.0,0,1,0,1,2,0,0,2,0,2,4,1
2452,38252,S2i0VW7GN0ACeCnuAPN00XONM8w8kvsN,G8EPVSXsOYB5YQWZGiz1aVq5Pgr2GrQu,72,92,47,165,0,11,20,8,343,49.0,5,0.0,35,47,119,0,57,11,46,20,8,201,142,0
2453,38255,EwpbggvNdZkeSTjdG48aEltlJYavm02s,RXDvfPUBYFlVdlueBFbLW0mhhAyGEqpt,1,0,0,0,0,0,1,0,1,0.14285714285714285,1,0.0,0,0,0,0,0,0,0,1,0,0,1,1
2454,38261,h2cFTJnPj8CTdq0hhUdrEDtmsY30xXQA,G8EPVSXsOYB5YQWZGiz1aVq5Pgr2GrQu,10,20,5,2,1,0,5,0,33,4.714285714285714,3,0.0,6,5,1,1,14,0,1,5,0,13,20,1
2455,38264,DPr3Hy8387gfJi0Jc3ohxKBzY0mvhH1G,SpATywNh6bZuzm8s1ceuBUnMUAeoAHHw,15,19,8,16,1,34,9,2,89,12.714285714285714,4,0.0,6,8,16,1,13,34,0,9,2,31,58,0
2456,38267,xnr1pqResnWIFBWHoMthHT4GwMr3vBWt,SpATywNh6bZuzm8s1ceuBUnMUAeoAHHw,15,23,7,11,3,0,5,0,49,7.0,1,0.0,13,7,11,3,10,0,0,5,0,34,15,1
2457,38269,gzTBwYPoQwnODJJ2vedsUKp2EoGao5Fz,bWdj2GDclj5ofokWjzoa5jAwMkxCykd6,10,12,1,0,1,1,8,0,23,3.2857142857142856,4,0.0,0,1,0,1,12,1,0,8,0,2,21,1
2458,38312,PzUJiLnP9HZJxQE6JmMTkx1KTzCMtAvI,A3fsA9Zfv1X2fVEQhTw51lKENdNrEqT3,1,0,0,0,0,0,1,0,1,0.14285714285714285,1,0.0,0,0,0,0,0,0,0,1,0,0,1,1
2459,38319,mGGeZkXtXipHfCgx75xnWUmx7JTil5yZ,SpATywNh6bZuzm8s1ceuBUnMUAeoAHHw,1,0,0,0,0,0,1,0,1,0.14285714285714285,1,0.0,0,0,0,0,0,0,0,1,0,0,1,1
2460,38330,ooLh9t6oSyJHSmVF4HH7sDMAh5QMFRua,bWdj2GDclj5ofokWjzoa5jAwMkxCykd6,7,10,1,0,0,2,15,2,30,4.285714285714286,3,0.0,1,1,0,0,9,2,0,15,2,2,28,1
2461,38342,C8IOBAC7DRHGJ1rz7pC1Kh8zvUK3Uruf,bWdj2GDclj5ofokWjzoa5jAwMkxCykd6,5,2,1,0,1,0,2,0,6,0.8571428571428571,1,0.0,0,1,0,1,2,0,0,2,0,2,4,1
2462,38345,skcEk7TV3jhSAknl5Kr7UawZFeqJNMzy,SpATywNh6bZuzm8s1ceuBUnMUAeoAHHw,9,10,6,0,5,0,3,0,24,3.4285714285714284,2,0.0,0,6,0,5,10,0,0,3,0,11,13,1
2463,38348,DTsOT0NTIRutfokoKq4yB8bQe3U1fEsD,SpATywNh6bZuzm8s1ceuBUnMUAeoAHHw,1,0,0,0,0,0,1,0,1,0.14285714285714285,1,0.0,0,0,0,0,0,0,0,1,0,0,1,0
2464,38362,ngiOS4CfHKeFfCKjGfQvFpxE4ckVZ4zO,A3fsA9Zfv1X2fVEQhTw51lKENdNrEqT3,9,4,3,0,3,0,2,0,12,1.7142857142857142,1,0.0,0,3,0,3,4,0,0,2,0,6,6,1
2465,38369,P4MCLwt6pxkkQ1f3WWeAp7xsGAazOtsm,SpATywNh6bZuzm8s1ceuBUnMUAeoAHHw,4,2,1,0,1,0,3,0,7,1.0,2,0.0,0,1,0,1,2,0,0,3,0,2,5,1
2466,38371,a3kUr1OVNVUUdkmJCjmwPQMV5PtCkdEz,SpATywNh6bZuzm8s1ceuBUnMUAeoAHHw,2,0,0,0,0,0,2,0,2,0.2857142857142857,1,0.0,0,0,0,0,0,0,0,2,0,0,2,1
2467,38377,qkZ3BaC1M1zrdLJXoQVUnE0RxlFverb8,A3fsA9Zfv1X2fVEQhTw51lKENdNrEqT3,1,0,0,0,0,0,1,0,1,0.14285714285714285,1,0.0,0,0,0,0,0,0,0,1,0,0,1,1
2468,38391,MAkHN0TS4uaTPgKLso4eQ3LTCDiU28De,bWdj2GDclj5ofokWjzoa5jAwMkxCykd6,12,30,16,0,10,1,15,0,72,10.285714285714286,2,0.0,2,16,0,10,28,1,0,15,0,28,44,1
2469,38393,NgT4xv3zS3UyiRdDnPLyxI49HQKeMn2D,G8EPVSXsOYB5YQWZGiz1aVq5Pgr2GrQu,59,111,5,116,8,2,24,2,268,38.285714285714285,5,0.0,56,5,85,8,55,2,31,24,2,154,114,1
2470,38407,JJYEr1YA7SClhqsLz61VElUYdghcCxlW,RXDvfPUBYFlVdlueBFbLW0mhhAyGEqpt,1,0,0,0,0,0,1,0,1,0.14285714285714285,1,0.0,0,0,0,0,0,0,0,1,0,0,1,1
2471,38420,YAaB5kbzMpno3yyQhEjSC43PC6r4FUut,bWdj2GDclj5ofokWjzoa5jAwMkxCykd6,3,2,1,0,0,1,4,0,8,1.1428571428571428,1,0.0,0,1,0,0,2,1,0,4,0,1,7,1
2472,38425,bIGq7A9r0Y0NLU65d3TOWeEFWRfABEv0,SpATywNh6bZuzm8s1ceuBUnMUAeoAHHw,17,18,9,14,3,0,13,1,58,8.285714285714286,1,0.0,7,9,12,3,11,0,2,13,1,31,27,1
2473,38431,gjPSUf8VbxmvyczDJCPomXU7IV6RTx1x,SpATywNh6bZuzm8s1ceuBUnMUAeoAHHw,17,28,7,10,3,23,25,4,100,14.285714285714286,2,0.0,10,7,9,3,18,23,1,25,4,29,71,1
2474,38447,dNx7yBBYuWpRM4BeMNLD1yOnUwcueGfB,bWdj2GDclj5ofokWjzoa5jAwMkxCykd6,11,25,5,40,4,5,13,1,93,13.285714285714286,2,0.0,5,5,39,4,20,5,1,13,1,53,40,0
2475,38453,oBHdxxTFsPNGTsDRAnTRpoi8FODO2mxr,SpATywNh6bZuzm8s1ceuBUnMUAeoAHHw,7,3,2,0,2,0,2,0,9,1.2857142857142858,1,0.0,0,2,0,2,3,0,0,2,0,4,5,1
2476,38454,dNx7yBBYuWpRM4BeMNLD1yOnUwcueGfB,SpATywNh6bZuzm8s1ceuBUnMUAeoAHHw,15,31,6,17,4,0,10,0,68,9.714285714285714,2,0.0,4,6,15,4,27,0,2,10,0,29,39,0
2477,38480,Y0R5Jnk5aIi2yBcZ9pxBzdem2y9Lpgok,SpATywNh6bZuzm8s1ceuBUnMUAeoAHHw,10,7,1,0,1,1,6,0,16,2.2857142857142856,1,0.0,0,1,0,1,7,1,0,6,0,2,14,1
2478,38494,nkWrffpo6kobU01lUWepcu6aQb60BdxH,SpATywNh6bZuzm8s1ceuBUnMUAeoAHHw,15,24,14,7,7,0,7,0,59,8.428571428571429,3,0.0,5,14,7,7,19,0,0,7,0,33,26,1
2479,38496,fd1NhQTFxl8TsBhiRc4F6bEwrFxQh7qC,SpATywNh6bZuzm8s1ceuBUnMUAeoAHHw,10,5,4,0,2,0,3,0,14,2.0,1,0.0,0,4,0,2,5,0,0,3,0,6,8,1
2480,38503,KGORZAfEVmjDZyD0eVVyErKdl89uylGc,G8EPVSXsOYB5YQWZGiz1aVq5Pgr2GrQu,5,4,0,0,0,0,1,0,5,0.7142857142857143,1,0.0,0,0,0,0,4,0,0,1,0,0,5,1
2481,38505,Dy0I4gbpbRtwh6YDRhpgGBLDEGUYJgO6,SpATywNh6bZuzm8s1ceuBUnMUAeoAHHw,9,13,5,0,0,2,5,1,26,3.7142857142857144,1,0.0,3,5,0,0,10,2,0,5,1,8,18,1
2482,38514,88mqKZu0uTbuMx2E6ZRqhvo4tmoL4qfn,SpATywNh6bZuzm8s1ceuBUnMUAeoAHHw,16,15,2,18,1,8,20,1,65,9.285714285714286,3,0.0,5,2,15,1,10,8,3,20,1,23,42,1
2483,38520,WRiHtWJX61VUGyAGQFSHJ3czdrgqxeQW,RXDvfPUBYFlVdlueBFbLW0mhhAyGEqpt,1,0,0,0,0,0,3,0,3,0.42857142857142855,3,0.0,0,0,0,0,0,0,0,3,0,0,3,1
2484,38525,859jT8mbwD5IkofIqzzz6ylJUi1ZwOt3,SpATywNh6bZuzm8s1ceuBUnMUAeoAHHw,18,31,14,10,9,21,12,1,98,14.0,3,0.0,9,14,9,9,22,21,1,12,1,41,57,1
2485,38532,8SZ4vKq1qHRfFJV3A51uH46l0c4FRvvR,SpATywNh6bZuzm8s1ceuBUnMUAeoAHHw,16,27,16,13,7,2,17,2,84,12.0,5,0.0,9,16,12,7,18,2,1,17,2,44,40,0
2486,38538,oBHdxxTFsPNGTsDRAnTRpoi8FODO2mxr,RXDvfPUBYFlVdlueBFbLW0mhhAyGEqpt,1,0,0,0,0,0,1,0,1,0.14285714285714285,1,0.0,0,0,0,0,0,0,0,1,0,0,1,1
2487,38541,uarVJhEs6XLW7Dw1D7iBgEK6zPe65WwX,bWdj2GDclj5ofokWjzoa5jAwMkxCykd6,1,0,0,0,0,0,1,0,1,0.14285714285714285,1,0.0,0,0,0,0,0,0,0,1,0,0,1,1
2488,38545,rarzYMzRoT8HAQOSSilddy5adopj22jf,A3fsA9Zfv1X2fVEQhTw51lKENdNrEqT3,8,7,0,0,0,0,1,0,8,1.1428571428571428,1,0.0,0,0,0,0,7,0,0,1,0,0,8,1
2489,38550,Xq1kPqflDNgXwQ2pEniNYUjMpkVzPp1m,A3fsA9Zfv1X2fVEQhTw51lKENdNrEqT3,36,31,16,50,13,2,4,0,116,16.571428571428573,4,0.0,3,16,48,13,28,2,2,4,0,80,36,1
2490,38551,UKG5GO5JWRjFVRMggOgvDIxPiEZzBxAO,bWdj2GDclj5ofokWjzoa5jAwMkxCykd6,5,7,2,0,1,0,2,0,12,1.7142857142857142,2,0.0,0,2,0,1,7,0,0,2,0,3,9,1
2491,38554,tajSblOKlQlXdpIXIOLLEJCHn56vIOfT,bWdj2GDclj5ofokWjzoa5jAwMkxCykd6,19,68,27,80,13,66,30,0,284,40.57142857142857,7,0.0,13,27,70,13,55,66,10,30,0,123,161,1
2492,38556,rajcXZ0kL5d9yXQIc9HHtBEyfRs8vn2R,G8EPVSXsOYB5YQWZGiz1aVq5Pgr2GrQu,6,4,1,0,1,0,3,0,9,1.2857142857142858,2,0.0,0,1,0,1,4,0,0,3,0,2,7,1
2493,38587,NeX0NKDgti39PYJeedkcSvEJfGuCFAhK,SpATywNh6bZuzm8s1ceuBUnMUAeoAHHw,11,5,3,0,3,0,5,0,16,2.2857142857142856,1,0.0,1,3,0,3,4,0,0,5,0,7,9,1
2494,38596,spd8M0wss3Tbv0YQ5WcIllIwTexcZnnW,SpATywNh6bZuzm8s1ceuBUnMUAeoAHHw,13,46,2,22,1,0,10,0,81,11.571428571428571,5,0.0,4,2,18,1,42,0,4,10,0,25,56,0
2495,38602,KbRlzY47exomwt4drbIiBF6s4vNevAUk,A3fsA9Zfv1X2fVEQhTw51lKENdNrEqT3,40,21,16,60,12,0,4,0,113,16.142857142857142,1,0.0,2,16,59,12,19,0,1,4,0,89,24,1
2496,38605,VPjMKah4KBMlWaK4uQInEcrWLVtwuYU3,SpATywNh6bZuzm8s1ceuBUnMUAeoAHHw,8,6,4,0,1,0,8,1,20,2.857142857142857,2,0.0,0,4,0,1,6,0,0,8,1,5,15,1
2497,38610,qatSZvztGH03ZmpAnP6syWYERxxmPTgm,SpATywNh6bZuzm8s1ceuBUnMUAeoAHHw,8,5,4,0,3,0,5,0,17,2.4285714285714284,1,0.0,0,4,0,3,5,0,0,5,0,7,10,1
2498,38618,6zUyeP7S7jGCTdu7QvSdhvgcWdRlZ9vk,A3fsA9Zfv1X2fVEQhTw51lKENdNrEqT3,11,14,5,0,3,0,13,0,35,5.0,2,0.0,0,5,0,3,14,0,0,13,0,8,27,1
2499,38621,C800geUBh3GYBhoh4cW6ReKUGj5LAMGi,SpATywNh6bZuzm8s1ceuBUnMUAeoAHHw,12,15,0,17,0,53,31,0,116,16.571428571428573,4,0.0,3,0,16,0,12,53,1,31,0,19,97,0
2500,38623,aKS3VkxSVtZSsON0tlb1uUJK6seiU1iY,SpATywNh6bZuzm8s1ceuBUnMUAeoAHHw,16,24,13,21,6,0,6,4,74,10.571428571428571,2,0.0,6,13,17,6,18,0,4,6,4,42,32,1
2501,38625,Na52PtAqm4VlTMUv1OPLGNjij0a5votC,A3fsA9Zfv1X2fVEQhTw51lKENdNrEqT3,18,23,11,0,6,15,11,0,66,9.428571428571429,2,0.0,0,11,0,6,23,15,0,11,0,17,49,1
2502,38636,xbw9nCFRWInH7KOVpMVJ0cKpswH8IEpv,SpATywNh6bZuzm8s1ceuBUnMUAeoAHHw,13,20,4,18,0,2,9,0,53,7.571428571428571,3,0.0,2,4,16,0,18,2,2,9,0,22,31,0
2503,38637,aYZOvavq8vAsMixc171e3LCkk7Ck4eQv,SpATywNh6bZuzm8s1ceuBUnMUAeoAHHw,2,0,0,0,0,0,2,0,2,0.2857142857142857,1,0.0,0,0,0,0,0,0,0,2,0,0,2,1
2504,38649,I6Zefk3suQV0ULhgPf2DN9gGAf2yKSKv,SpATywNh6bZuzm8s1ceuBUnMUAeoAHHw,10,17,6,0,0,2,6,0,31,4.428571428571429,2,0.0,0,6,0,0,17,2,0,6,0,6,25,1
2505,38668,NjnyUEkQdbuj3M7NhvY8iDqgWMA59DIH,SpATywNh6bZuzm8s1ceuBUnMUAeoAHHw,14,11,7,3,5,2,6,1,35,5.0,1,0.0,2,7,3,5,9,2,0,6,1,17,18,1
2506,38670,dg0Zm4MjeckxnEiOKa4Gh8nunN8SFI0L,SpATywNh6bZuzm8s1ceuBUnMUAeoAHHw,4,2,1,0,0,0,2,0,5,0.7142857142857143,1,0.0,0,1,0,0,2,0,0,2,0,1,4,1
2507,38676,aWfbena9lEo41V5W87oDDgjvcz4pLKtN,SpATywNh6bZuzm8s1ceuBUnMUAeoAHHw,30,39,16,25,9,1,18,2,110,15.714285714285714,4,0.0,14,16,22,9,25,1,3,18,2,61,49,0
2508,38679,5LOlerEFHf0UNcpvuhvEHGBh6ERlMDur,G8EPVSXsOYB5YQWZGiz1aVq5Pgr2GrQu,9,7,3,0,1,5,9,0,25,3.5714285714285716,4,0.0,0,3,0,1,7,5,0,9,0,4,21,0
2509,38685,FncubT1DgrtJxWo1YRhPHqwgNARiG5Jv,SpATywNh6bZuzm8s1ceuBUnMUAeoAHHw,14,26,3,14,1,0,8,0,52,7.428571428571429,3,0.0,9,3,13,1,17,0,1,8,0,26,26,0
2510,38687,RfCEa3pRuKLOxQiUZgZZMFg3JntXDg1m,SpATywNh6bZuzm8s1ceuBUnMUAeoAHHw,13,28,15,0,9,0,11,0,63,9.0,4,0.0,0,15,0,9,28,0,0,11,0,24,39,0
2511,38688,spd8M0wss3Tbv0YQ5WcIllIwTexcZnnW,A3fsA9Zfv1X2fVEQhTw51lKENdNrEqT3,6,11,0,0,0,0,2,0,13,1.8571428571428572,3,0.0,0,0,0,0,11,0,0,2,0,0,13,1
2512,38692,ktbF3sxXQk0MrToCOKFGvH2bCmfBVgYK,G8EPVSXsOYB5YQWZGiz1aVq5Pgr2GrQu,19,42,2,6,2,1,7,0,60,8.571428571428571,3,0.0,17,2,4,2,25,1,2,7,0,25,35,0
2513,38703,bDOMCQV7nFdKo0pDqOPr3ECLpgkdBCSt,bWdj2GDclj5ofokWjzoa5jAwMkxCykd6,10,9,2,0,1,1,6,1,20,2.857142857142857,2,0.0,0,2,0,1,9,1,0,6,1,3,17,1
2514,38704,LbhBqPcHsayzBPTM5h5jHXG3yJonlt5t,A3fsA9Zfv1X2fVEQhTw51lKENdNrEqT3,44,36,30,72,22,8,14,0,182,26.0,1,0.0,1,30,63,22,35,8,9,14,0,116,66,1
2515,38708,QWAnJ98MRtHXbl78XXr3UpScat4E7MnZ,SpATywNh6bZuzm8s1ceuBUnMUAeoAHHw,11,17,1,9,0,0,3,0,30,4.285714285714286,2,0.0,5,1,9,0,12,0,0,3,0,15,15,0
2516,38719,UIE935UirfemaybvWwRc5Sijo8VfPEYO,SpATywNh6bZuzm8s1ceuBUnMUAeoAHHw,7,6,4,0,2,0,5,0,17,2.4285714285714284,2,0.0,0,4,0,2,6,0,0,5,0,6,11,1
2517,38757,sEqqQzJgfFwEJ59pjhsH9YLQDd58mQLD,SpATywNh6bZuzm8s1ceuBUnMUAeoAHHw,7,13,1,0,0,0,5,0,19,2.7142857142857144,3,0.0,2,1,0,0,11,0,0,5,0,3,16,1
2518,38759,JBGQp737lLGmxKZ5ElVyvCkZ4zEqlLXt,SpATywNh6bZuzm8s1ceuBUnMUAeoAHHw,5,3,0,0,0,0,2,0,5,0.7142857142857143,1,0.0,0,0,0,0,3,0,0,2,0,0,5,1
2519,38769,OygU41dc8lyatpKc4JEBkP0ni21xzfvB,SpATywNh6bZuzm8s1ceuBUnMUAeoAHHw,15,9,5,9,3,0,7,0,33,4.714285714285714,3,0.0,2,5,9,3,7,0,0,7,0,19,14,0
2520,38785,QpfK7z5GdRL9KsohkHQ7AWpk99tKhwdp,SpATywNh6bZuzm8s1ceuBUnMUAeoAHHw,12,25,14,9,0,0,6,0,54,7.714285714285714,4,0.0,6,14,7,0,19,0,2,6,0,27,27,1
2521,38808,xy8Pu3m8OtRxFLhTfix6XvZn0H18zyZc,G8EPVSXsOYB5YQWZGiz1aVq5Pgr2GrQu,9,15,1,0,1,0,6,0,23,3.2857142857142856,3,0.0,0,1,0,1,15,0,0,6,0,2,21,0
2522,38811,T6EWQ7jVP89JlHzj41KN1gEtGYevpSQM,SpATywNh6bZuzm8s1ceuBUnMUAeoAHHw,9,18,8,1,1,0,8,0,36,5.142857142857143,5,0.0,3,8,1,1,15,0,0,8,0,13,23,0
2523,38815,RfVW0lNKrf9tzkgd827lLFW37SMuSXSa,SpATywNh6bZuzm8s1ceuBUnMUAeoAHHw,4,3,0,0,0,0,1,0,4,0.5714285714285714,1,0.0,0,0,0,0,3,0,0,1,0,0,4,1
2524,38825,t8zwYEwnyPi1IDBby2HgJ3IlSwhRkmGy,SpATywNh6bZuzm8s1ceuBUnMUAeoAHHw,15,30,1,21,0,25,12,1,90,12.857142857142858,4,0.0,10,1,18,0,20,25,3,12,1,29,61,0
2525,38826,RLA6GL5vSBJRKc1kwf2CaEaK6FOv9roZ,RXDvfPUBYFlVdlueBFbLW0mhhAyGEqpt,10,19,5,0,3,0,1,0,28,4.0,2,0.0,2,5,0,3,17,0,0,1,0,10,18,0
2526,38827,i5nCgFIHY6Zcmf0CbMZLC0bzGv6djmqm,G8EPVSXsOYB5YQWZGiz1aVq5Pgr2GrQu,7,6,1,0,1,1,7,0,16,2.2857142857142856,1,0.0,0,1,0,1,6,1,0,7,0,2,14,1
2527,38833,v4HIYrR0I8FWtTlaAHD463q83gEr8oUl,RXDvfPUBYFlVdlueBFbLW0mhhAyGEqpt,22,18,11,12,4,1,5,0,51,7.285714285714286,2,0.0,2,11,12,4,16,1,0,5,0,29,22,1
2528,38849,FnrvxXFGCqAMeXxoMCc55xlzH80Et8mi,SpATywNh6bZuzm8s1ceuBUnMUAeoAHHw,7,1,1,0,1,1,5,0,9,1.2857142857142858,1,0.0,0,1,0,1,1,1,0,5,0,2,7,1
2529,38860,aSq9IJ4ZfLUbnD7QSBT8oeA7EtoTrGal,bWdj2GDclj5ofokWjzoa5jAwMkxCykd6,15,28,7,0,7,23,7,1,73,10.428571428571429,3,0.0,0,7,0,7,28,23,0,7,1,14,59,1
2530,38906,U6b5ShGjMWYggq6FsoytPW1feWorMDiT,SpATywNh6bZuzm8s1ceuBUnMUAeoAHHw,1,0,0,0,0,0,1,0,1,0.14285714285714285,1,0.0,0,0,0,0,0,0,0,1,0,0,1,1
2531,38912,35Qckp7squ2ifhCEFcVeQZHmfUAJiaXc,SpATywNh6bZuzm8s1ceuBUnMUAeoAHHw,18,36,15,18,3,12,16,3,103,14.714285714285714,2,0.0,14,15,14,3,22,12,4,16,3,46,57,1
2532,38922,nV21XWIQ3aHCYYV7hPNmU8NbA6rAppIq,G8EPVSXsOYB5YQWZGiz1aVq5Pgr2GrQu,7,6,0,0,0,0,4,0,10,1.4285714285714286,1,0.0,0,0,0,0,6,0,0,4,0,0,10,1
2533,38923,MuiBmNrQSuFDjsexIRPrYiU9583FwFbE,SpATywNh6bZuzm8s1ceuBUnMUAeoAHHw,17,39,18,15,7,15,13,2,109,15.571428571428571,1,0.0,9,18,12,7,30,15,3,13,2,46,63,1
2534,38928,LKo3yUnM07K4Le8KPm2nARMox6nb3a03,SpATywNh6bZuzm8s1ceuBUnMUAeoAHHw,10,12,5,0,2,1,7,1,28,4.0,2,0.0,5,5,0,2,7,1,0,7,1,12,16,1
2535,38940,IXJChwgShKb71VXFYaM4KTehE3VXk7Kg,bWdj2GDclj5ofokWjzoa5jAwMkxCykd6,8,3,2,0,2,0,3,0,10,1.4285714285714286,1,0.0,1,2,0,2,2,0,0,3,0,5,5,1
2536,38942,VrBnKyI7RjgXozKQXJ2DSbj5Gvev22L0,SpATywNh6bZuzm8s1ceuBUnMUAeoAHHw,13,12,6,14,5,0,2,0,39,5.571428571428571,1,0.0,4,6,14,5,8,0,0,2,0,29,10,0
2537,38944,N1N2VoCQ3DCM7YknWLib5UEHyI2wyiAp,A3fsA9Zfv1X2fVEQhTw51lKENdNrEqT3,6,3,2,0,1,0,6,0,12,1.7142857142857142,1,0.0,0,2,0,1,3,0,0,6,0,3,9,1
2538,38954,hWagcbwGHP337RS0iBSta7Eh6v3OAnlN,SpATywNh6bZuzm8s1ceuBUnMUAeoAHHw,17,28,12,15,3,5,12,0,75,10.714285714285714,5,0.0,11,12,14,3,17,5,1,12,0,40,35,1
2539,38955,BE4JaFadHavW9r5xCXpj3M456eZAgaG6,SpATywNh6bZuzm8s1ceuBUnMUAeoAHHw,16,27,9,15,4,1,9,0,65,9.285714285714286,2,0.0,13,9,12,4,14,1,3,9,0,38,27,1
2540,38960,csUQD8kl5B2qOhCgBpUdVV3uOWaYGbyH,A3fsA9Zfv1X2fVEQhTw51lKENdNrEqT3,17,29,1,0,1,1,9,0,41,5.857142857142857,3,0.0,1,1,0,1,28,1,0,9,0,3,38,1
2541,38969,qP7HUxoCtXsXPUg6TOciLBwLDEqZxGLw,SpATywNh6bZuzm8s1ceuBUnMUAeoAHHw,5,3,1,0,1,0,2,0,7,1.0,1,0.0,0,1,0,1,3,0,0,2,0,2,5,1
2542,38976,n7mMvLvnaxc6y3IIFJpmSNUncj3jx1Ev,RXDvfPUBYFlVdlueBFbLW0mhhAyGEqpt,7,2,2,0,2,1,4,2,13,1.8571428571428572,1,0.0,0,2,0,2,2,1,0,4,2,4,9,1
2543,38984,Np3UGgyqJRbdjHAs6eqMYNuWuEJ67rAv,bWdj2GDclj5ofokWjzoa5jAwMkxCykd6,29,38,19,86,7,0,9,0,159,22.714285714285715,5,0.0,5,19,79,7,33,0,7,9,0,110,49,1
2544,38995,7nUtazUwwSnnXJpIKdQBJGpXV6Po42DQ,A3fsA9Zfv1X2fVEQhTw51lKENdNrEqT3,15,17,1,0,0,0,22,1,41,5.857142857142857,3,0.0,0,1,0,0,17,0,0,22,1,1,40,1
2545,39016,79QvR9MowSFdJ7PRFtAx8omEmqdf2G66,A3fsA9Zfv1X2fVEQhTw51lKENdNrEqT3,8,5,1,0,1,0,6,0,13,1.8571428571428572,1,0.0,0,1,0,1,5,0,0,6,0,2,11,1
2546,39017,sUk3OLEiiNZtlo4krMYRLjkp5xwgbsPl,bWdj2GDclj5ofokWjzoa5jAwMkxCykd6,1,0,0,0,0,0,1,0,1,0.14285714285714285,1,0.0,0,0,0,0,0,0,0,1,0,0,1,1
2547,39020,sUk3OLEiiNZtlo4krMYRLjkp5xwgbsPl,A3fsA9Zfv1X2fVEQhTw51lKENdNrEqT3,1,0,0,0,0,0,2,0,2,0.2857142857142857,1,0.0,0,0,0,0,0,0,0,2,0,0,2,1
2548,39024,KbrQAfHN76lnV5ENpEesywqeBtzfyubO,SpATywNh6bZuzm8s1ceuBUnMUAeoAHHw,18,25,11,19,3,2,19,7,86,12.285714285714286,2,0.0,9,11,16,3,16,2,3,19,7,39,47,0
2549,39028,dNx7yBBYuWpRM4BeMNLD1yOnUwcueGfB,A3fsA9Zfv1X2fVEQhTw51lKENdNrEqT3,8,25,0,0,0,2,7,0,34,4.857142857142857,2,0.0,1,0,0,0,24,2,0,7,0,1,33,0
2550,39033,NfJMxVbS19N5X90YBDzzOQ6861Bhuidv,SpATywNh6bZuzm8s1ceuBUnMUAeoAHHw,11,6,4,0,3,0,4,1,18,2.5714285714285716,1,0.0,0,4,0,3,6,0,0,4,1,7,11,1
2551,39050,St7zx5CuqYmo3cCQEAdzvR5kNp3mDM9y,SpATywNh6bZuzm8s1ceuBUnMUAeoAHHw,26,35,18,26,7,19,21,1,127,18.142857142857142,5,0.0,11,18,22,7,24,19,4,21,1,58,69,0
2552,39051,PlXHYUUQO0ZfkxRdI3LzMqwSKR0cnJTo,bWdj2GDclj5ofokWjzoa5jAwMkxCykd6,1,0,0,0,0,0,1,0,1,0.14285714285714285,1,0.0,0,0,0,0,0,0,0,1,0,0,1,1
2553,39054,blGSSjmsnVQQQrRQxZJTHNQQUXxgUvBL,SpATywNh6bZuzm8s1ceuBUnMUAeoAHHw,8,17,7,0,2,0,4,0,30,4.285714285714286,2,0.0,3,7,0,2,14,0,0,4,0,12,18,0
2554,39057,l21tCwOolR7RD0CZyqRiNHHeEZC1D67K,SpATywNh6bZuzm8s1ceuBUnMUAeoAHHw,9,30,10,19,0,35,7,0,101,14.428571428571429,3,0.0,16,10,17,0,14,35,2,7,0,43,58,0
2555,39058,uGuE3FWo0NVfQumLjneHZr95vibdZhQe,SpATywNh6bZuzm8s1ceuBUnMUAeoAHHw,8,12,5,3,0,0,2,0,22,3.142857142857143,1,0.0,6,5,3,0,6,0,0,2,0,14,8,1
2556,39060,T4lMOZ9NGQ0RS4ue5IeZuDcW1ySIGZ9u,A3fsA9Zfv1X2fVEQhTw51lKENdNrEqT3,38,21,16,42,14,0,3,0,96,13.714285714285714,2,0.0,0,16,38,14,21,0,4,3,0,68,28,1
2557,39063,Zx1NMbt45yqUj8qZK11kDvFPzYX2jIZZ,SpATywNh6bZuzm8s1ceuBUnMUAeoAHHw,14,15,8,17,6,0,2,0,48,6.857142857142857,1,0.0,4,8,15,6,11,0,2,2,0,33,15,1
2558,39066,3SER276qaao5TSZqnt0y9TkdmkGTUUcO,SpATywNh6bZuzm8s1ceuBUnMUAeoAHHw,8,5,4,0,4,0,1,0,14,2.0,1,0.0,0,4,0,4,5,0,0,1,0,8,6,1
2559,39070,O3F8lLfHLYapLPkEvSdAfSwSBCUUJfWK,SpATywNh6bZuzm8s1ceuBUnMUAeoAHHw,4,0,0,0,0,1,4,1,6,0.8571428571428571,2,0.0,0,0,0,0,0,1,0,4,1,0,6,1
2560,39076,76j1Dib3EpIIxYpQXxI6VKhD3TOXoxhS,SpATywNh6bZuzm8s1ceuBUnMUAeoAHHw,16,31,3,12,1,4,15,0,66,9.428571428571429,2,0.0,9,3,12,1,22,4,0,15,0,25,41,1
2561,39090,fTfrYxb6cRWvjdEVjIZ7skF0s5uk6kd9,SpATywNh6bZuzm8s1ceuBUnMUAeoAHHw,33,44,22,47,8,1,19,1,142,20.285714285714285,7,0.0,7,22,43,8,37,1,4,19,1,80,62,0
2562,39094,tcrMObz5SSDCQNYpPsv4XWOxcLo3IPpN,SpATywNh6bZuzm8s1ceuBUnMUAeoAHHw,7,5,1,0,0,0,3,0,9,1.2857142857142858,2,0.0,0,1,0,0,5,0,0,3,0,1,8,1
2563,39102,7nUtazUwwSnnXJpIKdQBJGpXV6Po42DQ,SpATywNh6bZuzm8s1ceuBUnMUAeoAHHw,13,27,1,14,1,2,11,0,56,8.0,4,0.0,9,1,11,1,18,2,3,11,0,22,34,1
2564,39103,avH35RZc6PS7vBKogre4B3MKABAedNBF,bWdj2GDclj5ofokWjzoa5jAwMkxCykd6,7,22,12,0,2,0,13,0,49,7.0,5,0.0,1,12,0,2,21,0,0,13,0,15,34,1
2565,39107,Dzo4bt517HDNgh4yuxQj3WQVtnrvmG1A,SpATywNh6bZuzm8s1ceuBUnMUAeoAHHw,5,3,0,0,0,0,2,0,5,0.7142857142857143,1,0.0,0,0,0,0,3,0,0,2,0,0,5,1
2566,39109,zu1WAijSG0F2wy5x45xxD1w2SrPWGtuK,SpATywNh6bZuzm8s1ceuBUnMUAeoAHHw,6,1,1,0,1,0,3,0,6,0.8571428571428571,1,0.0,0,1,0,1,1,0,0,3,0,2,4,1
2567,39113,VvziK1FrzCcoikfRc0daxkE7fq3iFq0v,SpATywNh6bZuzm8s1ceuBUnMUAeoAHHw,30,45,21,30,9,2,17,0,124,17.714285714285715,3,0.0,16,21,26,9,29,2,4,17,0,72,52,0
2568,39125,BTjtyE8NjHRpreY21d7F2wNmadCPRKCQ,SpATywNh6bZuzm8s1ceuBUnMUAeoAHHw,7,8,5,0,2,0,4,0,19,2.7142857142857144,3,0.0,0,5,0,2,8,0,0,4,0,7,12,1
2569,39131,uJIh67cllxQLgAhipzdDZMEunDbuBxvF,RXDvfPUBYFlVdlueBFbLW0mhhAyGEqpt,49,56,39,124,22,17,40,20,318,45.42857142857143,5,0.0,14,39,116,22,42,17,8,40,20,191,127,0
2570,39136,srXgccav6ELo546oVIR7hwKdVqMPE3uB,SpATywNh6bZuzm8s1ceuBUnMUAeoAHHw,7,6,1,0,1,0,4,0,12,1.7142857142857142,2,0.0,0,1,0,1,6,0,0,4,0,2,10,1
2571,39139,sUk3OLEiiNZtlo4krMYRLjkp5xwgbsPl,G8EPVSXsOYB5YQWZGiz1aVq5Pgr2GrQu,1,0,0,0,0,0,1,0,1,0.14285714285714285,1,0.0,0,0,0,0,0,0,0,1,0,0,1,1
2572,39152,9LQKs2OgeSVzfrSEIBiyZg4jCEuAC01N,G8EPVSXsOYB5YQWZGiz1aVq5Pgr2GrQu,11,4,1,12,0,0,2,0,19,2.7142857142857144,1,0.0,1,1,11,0,3,0,1,2,0,13,6,1
2573,39158,V0auOwxD2tv59agygO0uPvKcU5ercMUa,SpATywNh6bZuzm8s1ceuBUnMUAeoAHHw,15,28,15,6,5,0,9,0,63,9.0,4,0.0,4,15,6,5,24,0,0,9,0,30,33,1
2574,39179,OGoPVjudSuGohkzHyvu7N6zC3RGML0mw,G8EPVSXsOYB5YQWZGiz1aVq5Pgr2GrQu,19,34,30,0,27,0,3,0,94,13.428571428571429,2,0.0,0,30,0,27,34,0,0,3,0,57,37,1
2575,39182,VIwJtaSOWWljnDL02ObzIxH4JeVU0QQ1,bWdj2GDclj5ofokWjzoa5jAwMkxCykd6,4,3,1,0,0,0,7,0,11,1.5714285714285714,3,0.0,0,1,0,0,3,0,0,7,0,1,10,1
2576,39201,45r4ENaVPqa3xBFTqWFkoJttz7HBM6Lb,SpATywNh6bZuzm8s1ceuBUnMUAeoAHHw,12,18,0,6,0,3,14,5,46,6.571428571428571,3,0.0,2,0,5,0,16,3,1,14,5,7,39,1
2577,39207,RmlyieNXfVrGM9LWnpgNxfz0WPjjsgcE,A3fsA9Zfv1X2fVEQhTw51lKENdNrEqT3,2,0,0,0,0,0,2,0,2,0.2857142857142857,1,0.0,0,0,0,0,0,0,0,2,0,0,2,1
2578,39216,qsBNE43NxZycap30DuQDyNDzs5hGI95w,SpATywNh6bZuzm8s1ceuBUnMUAeoAHHw,15,14,11,2,7,0,4,0,38,5.428571428571429,3,0.0,0,11,2,7,14,0,0,4,0,20,18,1
2579,39229,rue9XaVrhPMV8jlzLPRPLBsY7dTh1epz,SpATywNh6bZuzm8s1ceuBUnMUAeoAHHw,14,52,3,24,0,8,29,6,122,17.428571428571427,5,0.0,19,3,17,0,33,8,7,29,6,39,83,1
2580,39237,PNuCKnyPWCRVxphTjJ1pIquyKu0dURK7,SpATywNh6bZuzm8s1ceuBUnMUAeoAHHw,5,3,1,0,1,0,2,0,7,1.0,1,0.0,0,1,0,1,3,0,0,2,0,2,5,1
2581,39239,xmz4ffo3Xzh257Ul94Vh1nR04juD6y1C,SpATywNh6bZuzm8s1ceuBUnMUAeoAHHw,1,0,0,0,0,0,1,0,1,0.14285714285714285,1,0.0,0,0,0,0,0,0,0,1,0,0,1,1
2582,39241,krVsPdgfe85VvAQ2rdfbpjD89zMbnkR0,SpATywNh6bZuzm8s1ceuBUnMUAeoAHHw,11,11,4,6,3,1,2,0,27,3.857142857142857,1,0.0,6,4,5,3,5,1,1,2,0,18,9,1
2583,39243,gpyXT5iZHN1onXoVstOXZoiFizXraIkU,SpATywNh6bZuzm8s1ceuBUnMUAeoAHHw,11,16,8,0,3,2,6,1,36,5.142857142857143,2,0.0,5,8,0,3,11,2,0,6,1,16,20,1
2584,39246,fv07Mlz09PBHitYybJt9eVrK276xe9YI,SpATywNh6bZuzm8s1ceuBUnMUAeoAHHw,23,14,9,26,6,0,14,0,69,9.857142857142858,5,0.0,4,9,22,6,10,0,4,14,0,41,28,0
2585,39247,Qr5qzmAxo2eU7JvBgyKuPQuH3YgkGzii,SpATywNh6bZuzm8s1ceuBUnMUAeoAHHw,6,3,1,0,1,0,2,0,7,1.0,1,0.0,0,1,0,1,3,0,0,2,0,2,5,1
2586,39248,Lc5TZPB93C58CDuO8VjF5g6g9boxDaHr,RXDvfPUBYFlVdlueBFbLW0mhhAyGEqpt,1,0,0,0,0,0,1,0,1,0.14285714285714285,1,0.0,0,0,0,0,0,0,0,1,0,0,1,1
2587,39254,PATQ2JDuYcR1iRnRPNzs82w3vSQnScOh,RXDvfPUBYFlVdlueBFbLW0mhhAyGEqpt,1,0,0,0,0,0,1,0,1,0.14285714285714285,1,0.0,0,0,0,0,0,0,0,1,0,0,1,1
2588,39264,7ddOasUgoSwmcHs4lJMhvhalD4IA2urH,SpATywNh6bZuzm8s1ceuBUnMUAeoAHHw,10,18,0,0,0,3,9,2,32,4.571428571428571,2,0.0,5,0,0,0,13,3,0,9,2,5,27,0
2589,39274,2nLjdaVfmxwWCLw5sEI1KKYk7UXViPES,SpATywNh6bZuzm8s1ceuBUnMUAeoAHHw,4,3,0,0,0,0,1,0,4,0.5714285714285714,1,0.0,0,0,0,0,3,0,0,1,0,0,4,0
2590,39277,G6iele4ho79nU5jQ1J8umZLq8jEFa9yN,A3fsA9Zfv1X2fVEQhTw51lKENdNrEqT3,12,5,3,0,3,10,5,1,27,3.857142857142857,2,0.0,0,3,0,3,5,10,0,5,1,6,21,1
2591,39293,59KrgCJlOEHQHzBNjsHoSd6BkQVArDrc,SpATywNh6bZuzm8s1ceuBUnMUAeoAHHw,5,4,2,0,1,0,1,0,8,1.1428571428571428,1,0.0,0,2,0,1,4,0,0,1,0,3,5,1
2592,39294,t43o0GKgntYeNvU3jSnPK3vOmS44e5N2,G8EPVSXsOYB5YQWZGiz1aVq5Pgr2GrQu,9,5,1,0,1,2,3,0,12,1.7142857142857142,1,0.0,0,1,0,1,5,2,0,3,0,2,10,1
2593,39296,R2cga9JVVM2tXEVs2saYswslfxAU4nMk,bWdj2GDclj5ofokWjzoa5jAwMkxCykd6,7,6,4,4,0,0,8,0,22,3.142857142857143,3,0.0,2,4,4,0,4,0,0,8,0,10,12,1
2594,39301,ezp80xTAgodAGV4fsnNivfTneJn97tLE,RXDvfPUBYFlVdlueBFbLW0mhhAyGEqpt,69,65,37,134,17,6,16,0,275,39.285714285714285,5,0.0,11,37,125,17,54,6,9,16,0,190,85,0
2595,39312,5taolCXbi4GnZeqgvcKlHbiPurs2tpgr,SpATywNh6bZuzm8s1ceuBUnMUAeoAHHw,15,14,8,4,3,0,8,2,39,5.571428571428571,2,0.0,3,8,4,3,11,0,0,8,2,18,21,0
2596,39327,CnuwKGLCLbXYnPgy82VEWYA1NOiOhvr0,A3fsA9Zfv1X2fVEQhTw51lKENdNrEqT3,8,9,0,0,0,0,5,0,14,2.0,2,0.0,1,0,0,0,8,0,0,5,0,1,13,1
2597,39330,YY7yHizDn0UpGHVq4qoTfbulP3ev5TkC,SpATywNh6bZuzm8s1ceuBUnMUAeoAHHw,21,24,17,2,11,4,8,0,66,9.428571428571429,3,0.0,0,17,2,11,24,4,0,8,0,30,36,0
2598,39339,0QbAHgL1bHqgkC1CgcznJ6rPBigpeoia,SpATywNh6bZuzm8s1ceuBUnMUAeoAHHw,13,9,7,4,3,0,3,0,26,3.7142857142857144,2,0.0,0,7,4,3,9,0,0,3,0,14,12,1
2599,39349,8eqcmJf66b25Hdf1a71yMHA6gdhfVvDC,G8EPVSXsOYB5YQWZGiz1aVq5Pgr2GrQu,47,60,29,108,13,43,44,4,301,43.0,4,0.0,9,29,99,13,51,43,9,44,4,150,151,0
2600,39360,aiSJXiTI4iLjZWytdZmE5zydDNEQzaHj,A3fsA9Zfv1X2fVEQhTw51lKENdNrEqT3,2,0,0,0,0,0,2,0,2,0.2857142857142857,1,0.0,0,0,0,0,0,0,0,2,0,0,2,1
2601,39367,SgAa84aajahM2sd2hvCdYRfO014ocPV5,SpATywNh6bZuzm8s1ceuBUnMUAeoAHHw,17,35,9,10,5,27,12,1,99,14.142857142857142,3,0.0,10,9,10,5,25,27,0,12,1,34,65,0
2602,39368,OTHiy7CJ3gPgZvtv97Ds8YkrZ0bgVlAw,G8EPVSXsOYB5YQWZGiz1aVq5Pgr2GrQu,4,4,0,0,2,0,1,0,7,1.0,1,0.0,2,0,0,2,2,0,0,1,0,4,3,0
2603,39371,194jqOV6jnj4prH3N2CqRtpc9qi9vfln,A3fsA9Zfv1X2fVEQhTw51lKENdNrEqT3,4,1,0,0,0,0,3,0,4,0.5714285714285714,1,0.0,0,0,0,0,1,0,0,3,0,0,4,1
2604,39372,aA47iNtja2lxoPqFPeHjI7xjYuTmvZjx,SpATywNh6bZuzm8s1ceuBUnMUAeoAHHw,15,20,8,18,3,1,5,0,55,7.857142857142857,4,0.0,8,8,15,3,12,1,3,5,0,34,21,1
2605,39377,M0xQooArrVMTCCgk3YkWTaBSUVldkFxi,SpATywNh6bZuzm8s1ceuBUnMUAeoAHHw,27,27,16,26,6,16,14,0,105,15.0,4,0.0,4,16,26,6,23,16,0,14,0,52,53,0
2606,39395,i2suUv0IuyNKOwhtAFmOMY1okBxszKdN,A3fsA9Zfv1X2fVEQhTw51lKENdNrEqT3,1,0,0,0,0,0,1,0,1,0.14285714285714285,1,0.0,0,0,0,0,0,0,0,1,0,0,1,1
2607,39397,dlNspelxxHXjwBoo8dpRx9m2ctqEqalr,G8EPVSXsOYB5YQWZGiz1aVq5Pgr2GrQu,7,5,2,0,2,0,3,0,12,1.7142857142857142,1,0.0,0,2,0,2,5,0,0,3,0,4,8,1
2608,39407,W7Pzvj7hPa3qVKdWluutDHqjcp3iIpAb,SpATywNh6bZuzm8s1ceuBUnMUAeoAHHw,27,60,29,36,18,1,8,1,153,21.857142857142858,6,0.0,26,29,32,18,34,1,4,8,1,105,48,0
2609,39418,nBG9NwFfkLReYPd7l4XLlLWLMjwV7w8K,A3fsA9Zfv1X2fVEQhTw51lKENdNrEqT3,5,4,1,0,1,0,2,0,8,1.1428571428571428,1,0.0,0,1,0,1,4,0,0,2,0,2,6,1
2610,39422,f6uLbTCHrR4TIVQHhrh2EEZiIDyLA7ZC,SpATywNh6bZuzm8s1ceuBUnMUAeoAHHw,1,0,0,0,0,0,1,0,1,0.14285714285714285,1,0.0,0,0,0,0,0,0,0,1,0,0,1,1
2611,39430,IAvuP4GGmvnNj3Zisz3jDfo3mSmXiJSb,bWdj2GDclj5ofokWjzoa5jAwMkxCykd6,4,6,0,0,0,0,8,0,14,2.0,5,0.0,0,0,0,0,6,0,0,8,0,0,14,0
2612,39432,roGokqGBKtukTNGPdY1C2VEr66iWn5eT,G8EPVSXsOYB5YQWZGiz1aVq5Pgr2GrQu,5,2,1,0,1,0,3,0,7,1.0,2,0.0,0,1,0,1,2,0,0,3,0,2,5,1
2613,39441,VsLOJ7Xi4SI8kpOP7KF7SoJJkHTp6ASm,SpATywNh6bZuzm8s1ceuBUnMUAeoAHHw,31,34,19,29,12,8,11,1,114,16.285714285714285,3,0.0,11,19,27,12,23,8,2,11,1,69,45,0
2614,39443,WxaYTMCI7yD8mE0osZVkZT9Orbo545LC,G8EPVSXsOYB5YQWZGiz1aVq5Pgr2GrQu,25,20,17,36,12,0,5,1,91,13.0,2,0.0,2,17,30,12,18,0,6,5,1,61,30,1
2615,39464,e2VhgSHwCVj2IYcx6wF0yjNoIULwWBq8,A3fsA9Zfv1X2fVEQhTw51lKENdNrEqT3,17,15,11,0,7,0,3,0,36,5.142857142857143,2,0.0,1,11,0,7,14,0,0,3,0,19,17,1
2616,39485,O9c4mZKt6PM5RxUHcRjnRJOfvI41UF2p,SpATywNh6bZuzm8s1ceuBUnMUAeoAHHw,31,56,24,26,9,5,23,2,145,20.714285714285715,5,0.0,22,24,21,9,34,5,5,23,2,76,69,0
2617,39486,7UOiW6Ks9JGRUR75AHoSTuRNGYY2xnnm,A3fsA9Zfv1X2fVEQhTw51lKENdNrEqT3,10,10,5,0,2,0,3,0,20,2.857142857142857,1,0.0,0,5,0,2,10,0,0,3,0,7,13,0
2618,39488,fxwFHQhfnCCHU83SJwJLBtmbCrCDlv3i,G8EPVSXsOYB5YQWZGiz1aVq5Pgr2GrQu,17,24,17,0,10,1,4,0,56,8.0,4,0.0,0,17,0,10,24,1,0,4,0,27,29,1
2619,39494,L8U7mZiX5tfpfUV7mFpP0znonqPA6G6R,SpATywNh6bZuzm8s1ceuBUnMUAeoAHHw,12,16,2,14,0,0,5,0,37,5.285714285714286,2,0.0,11,2,13,0,5,0,1,5,0,26,11,1
2620,39496,D55KBHzjFX6XlkQnUeIgoK6OnycKiatp,SpATywNh6bZuzm8s1ceuBUnMUAeoAHHw,7,6,3,0,2,0,2,0,13,1.8571428571428572,2,0.0,0,3,0,2,6,0,0,2,0,5,8,1
2621,39499,nBZt0s4EJwoCi0gxserLJGtn0aLrx1yc,A3fsA9Zfv1X2fVEQhTw51lKENdNrEqT3,17,11,1,18,1,0,11,0,42,6.0,3,0.0,0,1,15,1,11,0,3,11,0,17,25,1
2622,39504,1BLAPxf3lDzwOBM6NeFyerOFp0vZobfY,SpATywNh6bZuzm8s1ceuBUnMUAeoAHHw,7,12,7,0,4,1,3,0,27,3.857142857142857,1,0.0,0,7,0,4,12,1,0,3,0,11,16,0
2623,39512,ivxBGUbA7UT7tzED0gKK31cJU8Lv97zd,SpATywNh6bZuzm8s1ceuBUnMUAeoAHHw,7,7,1,0,1,0,2,0,11,1.5714285714285714,1,0.0,0,1,0,1,7,0,0,2,0,2,9,1
2624,39526,3Aezv8lgcVyIW4Uwgi3KMiL4RZSkwke5,A3fsA9Zfv1X2fVEQhTw51lKENdNrEqT3,12,16,11,0,5,0,7,0,39,5.571428571428571,3,0.0,1,11,0,5,15,0,0,7,0,17,22,1
2625,39527,BZSYb0PJXmPcTlknqBAAi8E9uLmy4IRE,SpATywNh6bZuzm8s1ceuBUnMUAeoAHHw,19,49,23,12,5,1,12,2,104,14.857142857142858,4,0.0,4,23,11,5,45,1,1,12,2,43,61,1
2626,39530,ZuUY5FCqqOqbgit08Gvv6v9cPTZXO9su,SpATywNh6bZuzm8s1ceuBUnMUAeoAHHw,9,9,4,0,2,0,6,1,22,3.142857142857143,1,0.0,1,4,0,2,8,0,0,6,1,7,15,1
2627,39534,cULoH8ZJIqrdeB8ADfKnnQ8THzmbMgQV,A3fsA9Zfv1X2fVEQhTw51lKENdNrEqT3,2,0,0,0,0,0,2,0,2,0.2857142857142857,1,0.0,0,0,0,0,0,0,0,2,0,0,2,1
2628,39537,xg8lJQFNYZJBLJxL1TK1I5KNSxuhMUEI,bWdj2GDclj5ofokWjzoa5jAwMkxCykd6,5,7,2,0,0,0,4,0,13,1.8571428571428572,3,0.0,0,2,0,0,7,0,0,4,0,2,11,1
2629,39540,xnObPmivHmj7phvTSVLNuvvFk898J2aO,SpATywNh6bZuzm8s1ceuBUnMUAeoAHHw,16,24,4,9,2,2,8,0,49,7.0,3,0.0,4,4,9,2,20,2,0,8,0,19,30,1
2630,39541,fnvAURpBgndjkYxbDVVMCKsNQuRUMiGS,RXDvfPUBYFlVdlueBFbLW0mhhAyGEqpt,1,0,0,0,0,0,1,0,1,0.14285714285714285,1,0.0,0,0,0,0,0,0,0,1,0,0,1,1
2631,39546,94sscb1tthVT0LkFotULcfURBxnTdgyP,A3fsA9Zfv1X2fVEQhTw51lKENdNrEqT3,5,2,1,0,1,0,2,0,6,0.8571428571428571,1,0.0,0,1,0,1,2,0,0,2,0,2,4,1
2632,39560,tfLWXkHQA3FBV54C2lvq1caDx4Pi6QwO,SpATywNh6bZuzm8s1ceuBUnMUAeoAHHw,28,53,23,26,10,0,10,0,122,17.428571428571427,7,0.0,13,23,26,10,40,0,0,10,0,72,50,0
2633,39565,lY81J0j7TM6V2dDMqV7lafTfl1uBUPgf,A3fsA9Zfv1X2fVEQhTw51lKENdNrEqT3,36,16,9,92,6,0,14,1,138,19.714285714285715,2,0.0,4,9,81,6,12,0,11,14,1,100,38,1
2634,39567,YC5UG6m05nI4uxDXYqrNEKgzKHSk4oSu,SpATywNh6bZuzm8s1ceuBUnMUAeoAHHw,18,51,25,19,10,6,15,2,128,18.285714285714285,5,0.0,14,25,16,10,37,6,3,15,2,65,63,0
2635,39568,veYIONVCJwpad8Khvzq7a5rgGQHvYo6S,G8EPVSXsOYB5YQWZGiz1aVq5Pgr2GrQu,28,30,21,20,15,1,4,0,91,13.0,2,0.0,5,21,15,15,25,1,5,4,0,56,35,0
2636,39587,X14gKVD1ZKu0qL0NchpqxwhoYSEpz9QI,SpATywNh6bZuzm8s1ceuBUnMUAeoAHHw,14,28,4,10,1,19,15,0,77,11.0,7,0.0,5,4,9,1,23,19,1,15,0,19,58,0
2637,39595,YFvrapJWr0AHUdxkctZzup6RNdDbndzC,SpATywNh6bZuzm8s1ceuBUnMUAeoAHHw,7,9,2,0,2,0,3,1,17,2.4285714285714284,2,0.0,0,2,0,2,9,0,0,3,1,4,13,0
2638,39608,Z75g2Nz4DcysTkbj3XO50UPDPTuBSclE,A3fsA9Zfv1X2fVEQhTw51lKENdNrEqT3,36,18,2,88,1,5,7,2,123,17.571428571428573,2,0.0,1,2,70,1,17,5,18,7,2,74,49,1
2639,39613,Kp4YCt5gbTMeLX4vxDVqvPhrGDdHDcEC,SpATywNh6bZuzm8s1ceuBUnMUAeoAHHw,8,6,4,0,3,0,1,0,14,2.0,1,0.0,0,4,0,3,6,0,0,1,0,7,7,1
2640,39620,RERMHDA2gNT2NdhpczhxOdgAsVrkLgnS,SpATywNh6bZuzm8s1ceuBUnMUAeoAHHw,5,2,1,0,1,0,2,0,6,0.8571428571428571,1,0.0,0,1,0,1,2,0,0,2,0,2,4,0
2641,39622,GqdYzH9IQjNV4Qw4poxGmkYlIXbhf40S,SpATywNh6bZuzm8s1ceuBUnMUAeoAHHw,11,6,4,8,3,0,1,0,22,3.142857142857143,1,0.0,1,4,7,3,5,0,1,1,0,15,7,1
2642,39623,nlj7VjLiwr4POHSdgtLvTaDUWFoae60t,SpATywNh6bZuzm8s1ceuBUnMUAeoAHHw,15,18,10,2,6,0,9,1,46,6.571428571428571,3,0.0,1,10,2,6,17,0,0,9,1,19,27,1
2643,39627,W5u0uO7QxoiOFkTJ8a7Iluj7qY01eSEK,SpATywNh6bZuzm8s1ceuBUnMUAeoAHHw,8,3,1,0,1,0,4,1,10,1.4285714285714286,1,0.0,0,1,0,1,3,0,0,4,1,2,8,1
2644,39629,vh69W01dADhjl8K2ZA2b9sRlprr5NXs0,SpATywNh6bZuzm8s1ceuBUnMUAeoAHHw,11,11,5,4,2,0,1,0,23,3.2857142857142856,1,0.0,3,5,4,2,8,0,0,1,0,14,9,1
2645,39630,3Aezv8lgcVyIW4Uwgi3KMiL4RZSkwke5,bWdj2GDclj5ofokWjzoa5jAwMkxCykd6,24,49,25,40,11,58,29,5,217,31.0,7,0.0,9,25,34,11,40,58,6,29,5,79,138,0
2646,39632,YHL8SFwBUtFpO36pvl6xAPsnC0mLXaOp,G8EPVSXsOYB5YQWZGiz1aVq5Pgr2GrQu,9,16,3,0,3,0,4,0,26,3.7142857142857144,3,0.0,0,3,0,3,16,0,0,4,0,6,20,1
2647,39649,BfV7UiYzJLw6WeEm3hlQsMK4WHcSosq4,A3fsA9Zfv1X2fVEQhTw51lKENdNrEqT3,50,27,24,94,21,0,5,0,171,24.428571428571427,3,0.0,1,24,75,21,26,0,19,5,0,121,50,1
2648,39652,6FzXe5nPWUHRxntREHsQRnp7x1pxuhUz,bWdj2GDclj5ofokWjzoa5jAwMkxCykd6,14,35,13,44,5,8,7,1,113,16.142857142857142,2,0.0,11,13,43,5,24,8,1,7,1,72,41,1
2649,39662,3uY3PXIjE4xYhALzqv9EDJ3LJju3f4Jc,A3fsA9Zfv1X2fVEQhTw51lKENdNrEqT3,1,0,0,0,0,0,1,0,1,0.14285714285714285,1,0.0,0,0,0,0,0,0,0,1,0,0,1,1
2650,39673,fCmdFT6vVaKttJ0wsJVd3YILMXjqgUpl,A3fsA9Zfv1X2fVEQhTw51lKENdNrEqT3,1,0,0,0,0,0,1,0,1,0.14285714285714285,1,0.0,0,0,0,0,0,0,0,1,0,0,1,1
2651,39676,jsiVqpEsXq0sluinZw5ff1hSi6FTnuod,SpATywNh6bZuzm8s1ceuBUnMUAeoAHHw,5,2,1,0,1,0,4,0,8,1.1428571428571428,2,0.0,0,1,0,1,2,0,0,4,0,2,6,1
2652,39697,CJISoHtkGNnkB0CRrvBDw2uUj4sPNv5j,SpATywNh6bZuzm8s1ceuBUnMUAeoAHHw,12,28,0,13,0,1,4,0,46,6.571428571428571,2,0.0,11,0,10,0,17,1,3,4,0,21,25,1
2653,39709,Nfn60tuwOzVop5pbBaYFyFMaifJoAIP6,bWdj2GDclj5ofokWjzoa5jAwMkxCykd6,16,27,12,56,7,0,4,0,106,15.142857142857142,2,0.0,12,12,48,7,15,0,8,4,0,79,27,1
2654,39723,wg81hfugF770xMHAXCLP7YJmOhdUJnHl,SpATywNh6bZuzm8s1ceuBUnMUAeoAHHw,30,62,20,22,11,11,12,1,139,19.857142857142858,6,0.0,14,20,17,11,48,11,5,12,1,62,77,0
2655,39733,rMXcpM1YL9uvJc9vPGaTEpRlMvl4lfsn,bWdj2GDclj5ofokWjzoa5jAwMkxCykd6,4,3,1,0,0,0,1,0,5,0.7142857142857143,1,0.0,0,1,0,0,3,0,0,1,0,1,4,1
2656,39741,aw5sNjg3Ll84wJrvKaca9hOr6No0sjrv,SpATywNh6bZuzm8s1ceuBUnMUAeoAHHw,13,16,2,13,1,0,4,0,36,5.142857142857143,2,0.0,9,2,11,1,7,0,2,4,0,23,13,1
2657,39756,0aMTCmDPG4aC91o1krmKQxgTxAagyKJp,bWdj2GDclj5ofokWjzoa5jAwMkxCykd6,17,31,17,86,12,0,18,1,165,23.571428571428573,4,0.0,11,17,77,12,20,0,9,18,1,117,48,1
2658,39760,s8yyjhcg4BVOip4HSP4txOTTHFJ4aWPU,SpATywNh6bZuzm8s1ceuBUnMUAeoAHHw,3,2,1,0,0,0,2,0,5,0.7142857142857143,2,0.0,0,1,0,0,2,0,0,2,0,1,4,1
2659,39765,Ea76prVlgHXbifiTXOy9yoJBa7oRFv41,RXDvfPUBYFlVdlueBFbLW0mhhAyGEqpt,1,0,0,0,0,0,1,0,1,0.14285714285714285,1,0.0,0,0,0,0,0,0,0,1,0,0,1,1
2660,39773,6QYAwv5e3xo1Sn1iZiEuGx1qJzd44Lj7,RXDvfPUBYFlVdlueBFbLW0mhhAyGEqpt,19,29,7,0,5,0,10,0,51,7.285714285714286,2,0.0,3,7,0,5,26,0,0,10,0,15,36,1
2661,39774,1aQoKDna73jstuOrupWa9Kq8V3FdvbRU,RXDvfPUBYFlVdlueBFbLW0mhhAyGEqpt,7,4,2,0,2,0,1,0,9,1.2857142857142858,1,0.0,0,2,0,2,4,0,0,1,0,4,5,1
2662,39776,OdMr7dE5UlAme9Tp979vREBvY5CV50po,bWdj2GDclj5ofokWjzoa5jAwMkxCykd6,35,20,9,102,8,0,6,0,145,20.714285714285715,4,0.0,8,9,95,8,12,0,7,6,0,120,25,0
2663,39808,Y1HbgiosdaMEUFcfxOopNbywAYIWyuQr,SpATywNh6bZuzm8s1ceuBUnMUAeoAHHw,10,16,1,0,1,8,5,0,31,4.428571428571429,3,0.0,0,1,0,1,16,8,0,5,0,2,29,1
2664,39817,vkw8WV6aYKsdxKvxTMS0euMnMdoDV8qN,bWdj2GDclj5ofokWjzoa5jAwMkxCykd6,5,7,3,0,2,3,1,0,16,2.2857142857142856,1,0.0,2,3,0,2,5,3,0,1,0,7,9,1
2665,39823,rEKGYBPmMNG2ptSViOUukUYctuPLpJ3c,A3fsA9Zfv1X2fVEQhTw51lKENdNrEqT3,8,10,1,0,0,1,11,3,26,3.7142857142857144,2,0.0,2,1,0,0,8,1,0,11,3,3,23,1
2666,39824,ZKL2WgbeR5PdyCIYfqDQ4XNCHZlCFLIz,bWdj2GDclj5ofokWjzoa5jAwMkxCykd6,4,2,1,0,1,0,4,0,8,1.1428571428571428,1,0.0,0,1,0,1,2,0,0,4,0,2,6,1
2667,39827,A6hS9pkzvwTNmFdD6HzIqa5y6YmtMrCe,A3fsA9Zfv1X2fVEQhTw51lKENdNrEqT3,7,7,1,0,1,0,1,0,10,1.4285714285714286,1,0.0,0,1,0,1,7,0,0,1,0,2,8,1
2668,39828,ke8J6J68PMmqZ8rK8FCDUgXlLZQpLLZW,A3fsA9Zfv1X2fVEQhTw51lKENdNrEqT3,45,40,19,102,9,0,13,2,185,26.428571428571427,3,0.0,1,19,84,9,39,0,18,13,2,113,72,1
2669,39837,HboM24Wk39YTBPWC8WzrZxRqA9rZpUU4,SpATywNh6bZuzm8s1ceuBUnMUAeoAHHw,7,8,2,0,1,1,7,1,20,2.857142857142857,2,0.0,0,2,0,1,8,1,0,7,1,3,17,1
2670,39838,dNIlKItJkU7JaK0shSCPHRrbzZCvxDbc,A3fsA9Zfv1X2fVEQhTw51lKENdNrEqT3,6,0,0,0,0,4,8,0,12,1.7142857142857142,1,0.0,0,0,0,0,0,4,0,8,0,0,12,1
2671,39858,efn1iuG0ajlfaHaXrPxReUu8GzdIHbZe,SpATywNh6bZuzm8s1ceuBUnMUAeoAHHw,12,18,10,0,5,1,12,1,47,6.714285714285714,2,0.0,1,10,0,5,17,1,0,12,1,16,31,0
2672,39861,wVfyl6WgFur5urtfx8TypP7osjiRs72N,A3fsA9Zfv1X2fVEQhTw51lKENdNrEqT3,2,0,0,0,0,0,3,0,3,0.42857142857142855,1,0.0,0,0,0,0,0,0,0,3,0,0,3,1
2673,39885,g6UH67YbvJtewLNXQNVZTYui0XC1Hxpo,G8EPVSXsOYB5YQWZGiz1aVq5Pgr2GrQu,33,61,28,66,9,0,12,1,177,25.285714285714285,3,0.0,27,28,50,9,34,0,16,12,1,114,63,0
2674,39886,Dd40k4eqowbb0BAmqLv8aP0MP2R1XA5P,SpATywNh6bZuzm8s1ceuBUnMUAeoAHHw,18,15,6,6,3,21,11,3,65,9.285714285714286,1,0.0,7,6,6,3,8,21,0,11,3,22,43,1
2675,39891,Dk2p6h1MYjykCuVHQMak8GN098n0FvGH,A3fsA9Zfv1X2fVEQhTw51lKENdNrEqT3,7,5,0,0,0,0,3,0,8,1.1428571428571428,2,0.0,0,0,0,0,5,0,0,3,0,0,8,1
2676,39906,xOGjXyyeq87fCMSZ9z7Yuds9sMvR7Ohh,RXDvfPUBYFlVdlueBFbLW0mhhAyGEqpt,5,3,2,0,1,0,1,0,7,1.0,1,0.0,0,2,0,1,3,0,0,1,0,3,4,0
2677,39919,C6gazwyl7EiFD8XZj9L3YaSfbatiTDEE,bWdj2GDclj5ofokWjzoa5jAwMkxCykd6,9,28,15,58,10,0,8,0,119,17.0,6,0.0,5,15,55,10,23,0,3,8,0,85,34,0
2678,39924,1Lhe3e5bki1E1AUNwq5SspoMJiU5aMmH,RXDvfPUBYFlVdlueBFbLW0mhhAyGEqpt,44,45,30,59,24,0,7,2,167,23.857142857142858,2,0.0,10,30,53,24,35,0,6,7,2,117,50,0
2679,39925,muBWBBbWzkNF6Dzg57EIx35WmD2zp0yP,SpATywNh6bZuzm8s1ceuBUnMUAeoAHHw,16,30,4,16,3,1,11,0,65,9.285714285714286,5,0.0,7,4,14,3,23,1,2,11,0,28,37,0
2680,39928,ygXUYNlms6qOypCR1kXz9dAuLrVhdPds,SpATywNh6bZuzm8s1ceuBUnMUAeoAHHw,18,23,10,18,3,21,17,1,93,13.285714285714286,5,0.0,7,10,15,3,16,21,3,17,1,35,58,1
2681,39929,r3yTAtA27zn29k1K73ADGURrMlpR5nC7,RXDvfPUBYFlVdlueBFbLW0mhhAyGEqpt,12,19,15,0,12,0,5,0,51,7.285714285714286,1,0.0,0,15,0,12,19,0,0,5,0,27,24,0
2682,39932,ddMTOiTV5HSxEMNnjSDeiKLzuF1YmYcT,A3fsA9Zfv1X2fVEQhTw51lKENdNrEqT3,3,2,1,0,0,0,1,0,4,0.5714285714285714,1,0.0,0,1,0,0,2,0,0,1,0,1,3,1
2683,39938,RVwnUs0luG0pmL3ADXHeT8MpQNWgZj3Z,RXDvfPUBYFlVdlueBFbLW0mhhAyGEqpt,34,38,26,100,0,0,1,0,165,23.571428571428573,6,0.0,10,26,92,0,28,0,8,1,0,128,37,1
2684,39941,Z90b24vMiOddvA3R8cPrefim6f9EiVmz,SpATywNh6bZuzm8s1ceuBUnMUAeoAHHw,6,3,2,0,2,0,1,0,8,1.1428571428571428,2,0.0,0,2,0,2,3,0,0,1,0,4,4,0
2685,39943,P6hNwLATXTVCZjt7DoobnBSI1FyeLq01,A3fsA9Zfv1X2fVEQhTw51lKENdNrEqT3,8,15,2,0,2,0,6,0,25,3.5714285714285716,1,0.0,0,2,0,2,15,0,0,6,0,4,21,1
2686,39951,UXCeDIhL283LDr12VbAjFZUd7R6owJ9F,G8EPVSXsOYB5YQWZGiz1aVq5Pgr2GrQu,5,4,0,0,0,0,4,0,8,1.1428571428571428,1,0.0,1,0,0,0,3,0,0,4,0,1,7,0
2687,39956,CHAwTqWzS9gyj5Ro2Bvsw8FCNCA8dW6W,RXDvfPUBYFlVdlueBFbLW0mhhAyGEqpt,19,22,1,6,1,3,25,1,59,8.428571428571429,5,0.0,1,1,6,1,21,3,0,25,1,9,50,1
2688,39960,IyXR1neCOqlWiBnFK6SoolM6gOHf0cwa,A3fsA9Zfv1X2fVEQhTw51lKENdNrEqT3,12,4,3,0,3,1,7,0,18,2.5714285714285716,1,0.0,0,3,0,3,4,1,0,7,0,6,12,1
2689,39967,VFl026LXCSxME7l2ZLRhGKmh3R96duCq,SpATywNh6bZuzm8s1ceuBUnMUAeoAHHw,31,82,41,29,19,16,39,2,228,32.57142857142857,9,0.0,11,41,25,19,71,16,4,39,2,96,132,0
2690,39983,m4cy52txIJ3BHr73S3AvnUeiz4g3fpv8,A3fsA9Zfv1X2fVEQhTw51lKENdNrEqT3,8,4,3,0,3,0,1,0,11,1.5714285714285714,1,0.0,0,3,0,3,4,0,0,1,0,6,5,1
2691,39989,dhMm94sLRibUWA6YOpXlMLxyaR3sl4a9,A3fsA9Zfv1X2fVEQhTw51lKENdNrEqT3,18,39,2,0,2,5,14,0,62,8.857142857142858,6,0.0,0,2,0,2,39,5,0,14,0,4,58,0
2692,40010,XsIiMjBHDyB8SLEzKHAHcKIpWlAHXu34,RXDvfPUBYFlVdlueBFbLW0mhhAyGEqpt,29,77,22,45,13,4,9,0,170,24.285714285714285,2,0.0,9,22,43,13,68,4,2,9,0,87,83,0
2693,40013,p1fshV6UZeW7KZmzuxOc9ex10GYNTePc,RXDvfPUBYFlVdlueBFbLW0mhhAyGEqpt,48,41,23,85,12,42,8,2,213,30.428571428571427,3,0.0,15,23,77,12,26,42,8,8,2,127,86,1
2694,40019,wDbI53389OJRBH6MsGEj6dttayfVtGlQ,SpATywNh6bZuzm8s1ceuBUnMUAeoAHHw,1,0,0,0,0,0,1,0,1,0.14285714285714285,1,0.0,0,0,0,0,0,0,0,1,0,0,1,1
2695,40022,SP7CCOQc4gFs6CnOJ8vpnG2qG74ffSCZ,SpATywNh6bZuzm8s1ceuBUnMUAeoAHHw,12,15,0,14,0,0,9,0,38,5.428571428571429,3,0.0,5,0,13,0,10,0,1,9,0,18,20,0
2696,40027,vpdMGAwpHu1uhd9ckN957NDWXXLtiXYo,bWdj2GDclj5ofokWjzoa5jAwMkxCykd6,8,8,4,0,1,26,7,2,48,6.857142857142857,3,0.0,3,4,0,1,5,26,0,7,2,8,40,1
2697,40028,KaeCX7DoW5htn0YhXrWslGGGeoVPFyiJ,G8EPVSXsOYB5YQWZGiz1aVq5Pgr2GrQu,12,11,7,0,5,0,5,0,28,4.0,2,0.0,0,7,0,5,11,0,0,5,0,12,16,1
2698,40037,4wGoSTuzJXBCojeNmaxk9GbR1KaCV7ql,bWdj2GDclj5ofokWjzoa5jAwMkxCykd6,8,4,1,0,1,0,7,1,14,2.0,2,0.0,0,1,0,1,4,0,0,7,1,2,12,1
2699,40039,28PHU9suTM8EqUKsQwsvQ03DzFXi0yDl,A3fsA9Zfv1X2fVEQhTw51lKENdNrEqT3,46,20,15,54,10,1,13,1,114,16.285714285714285,4,0.0,2,15,46,10,18,1,8,13,1,73,41,0
2700,40054,dlphjzS7Cck7yL7KPK4kXgmYSbBOCuFC,bWdj2GDclj5ofokWjzoa5jAwMkxCykd6,20,63,25,118,12,52,30,4,304,43.42857142857143,6,0.0,16,25,114,12,47,52,4,30,4,167,137,0
2701,40060,qDqnrpVee3l5HrPD2lnOTUKZmsC9F3UK,A3fsA9Zfv1X2fVEQhTw51lKENdNrEqT3,5,2,1,0,1,0,2,0,6,0.8571428571428571,1,0.0,0,1,0,1,2,0,0,2,0,2,4,1
2702,40063,l5LfU8gApOG72AnBkdAbfOLQLwFH7Zo2,bWdj2GDclj5ofokWjzoa5jAwMkxCykd6,16,33,2,128,5,3,5,0,176,25.142857142857142,3,0.0,14,2,123,5,19,3,5,5,0,144,32,1
2703,40074,gT1aUgmAT0anYSW9us4nwhFYETF9WL3j,A3fsA9Zfv1X2fVEQhTw51lKENdNrEqT3,5,2,1,0,1,0,2,0,6,0.8571428571428571,1,0.0,0,1,0,1,2,0,0,2,0,2,4,1
2704,40079,2A7IXlmbeljDbPAl1ZsZqwpJw9LPGGGX,SpATywNh6bZuzm8s1ceuBUnMUAeoAHHw,16,11,6,12,3,15,5,1,53,7.571428571428571,1,0.0,4,6,10,3,7,15,2,5,1,23,30,1
2705,40080,tw29YEXMOD494kfaqMSHK6i8NRmqKdtq,G8EPVSXsOYB5YQWZGiz1aVq5Pgr2GrQu,9,4,3,0,3,0,2,0,12,1.7142857142857142,1,0.0,0,3,0,3,4,0,0,2,0,6,6,1
2706,40081,zyMs55MEXcYV6llnecBHL4KGyjGwZwbR,SpATywNh6bZuzm8s1ceuBUnMUAeoAHHw,2,0,0,0,0,0,2,0,2,0.2857142857142857,1,0.0,0,0,0,0,0,0,0,2,0,0,2,0
2707,40084,J8UiKHYyR4z2Md44vzlhH8x9Cnerjpzr,G8EPVSXsOYB5YQWZGiz1aVq5Pgr2GrQu,2,0,0,0,0,0,2,0,2,0.2857142857142857,1,0.0,0,0,0,0,0,0,0,2,0,0,2,1
2708,40087,yoDT9q7GsYYKpWeoYGubo3V2RcRn4gQU,A3fsA9Zfv1X2fVEQhTw51lKENdNrEqT3,24,4,2,56,1,0,3,0,66,9.428571428571429,1,0.0,1,2,47,1,3,0,9,3,0,51,15,1
2709,40101,D2f4XnvAFD8ZIkDvhpGbd6yCstJua9ut,SpATywNh6bZuzm8s1ceuBUnMUAeoAHHw,8,8,3,0,2,0,2,0,15,2.142857142857143,1,0.0,0,3,0,2,8,0,0,2,0,5,10,1
2710,40104,FUMcFXXfXADMgcSzTyKSabMQ45EVJp0n,A3fsA9Zfv1X2fVEQhTw51lKENdNrEqT3,30,13,11,12,9,1,10,0,56,8.0,3,0.0,1,11,12,9,12,1,0,10,0,33,23,1
2711,40137,7Blw5DXu09ENSrwHZywqqUdODuz4CZi6,SpATywNh6bZuzm8s1ceuBUnMUAeoAHHw,30,34,17,24,11,0,9,1,96,13.714285714285714,2,0.0,13,17,21,11,21,0,3,9,1,62,34,0
2712,40139,5veZ6xRUiuZvoK7jObyhZU0X1eoLbhpg,SpATywNh6bZuzm8s1ceuBUnMUAeoAHHw,6,3,2,0,2,0,1,0,8,1.1428571428571428,1,0.0,0,2,0,2,3,0,0,1,0,4,4,1
2713,40140,LEeLDvxwrRnZu2qnrsr2uQ3TKN0DCY1A,SpATywNh6bZuzm8s1ceuBUnMUAeoAHHw,4,2,1,0,1,1,1,0,6,0.8571428571428571,1,0.0,0,1,0,1,2,1,0,1,0,2,4,0
2714,40149,iUzEPtD1F6CCo8jGkTMMkDMICh5ACqJB,SpATywNh6bZuzm8s1ceuBUnMUAeoAHHw,7,4,2,0,1,0,6,0,13,1.8571428571428572,2,0.0,0,2,0,1,4,0,0,6,0,3,10,1
2715,40154,grc1pAXqdUQaBlZrZyROqjuEtg08nen2,bWdj2GDclj5ofokWjzoa5jAwMkxCykd6,6,2,0,0,0,0,10,0,12,1.7142857142857142,1,0.0,0,0,0,0,2,0,0,10,0,0,12,0
2716,40156,BM23agkLBTvZTkItMt2GtI7Rt9Nmmgof,SpATywNh6bZuzm8s1ceuBUnMUAeoAHHw,20,46,22,0,10,71,8,0,157,22.428571428571427,4,0.0,6,22,0,10,40,71,0,8,0,38,119,0
2717,40164,Ml8yd2wTtJsMaa32cmbKtb7cTpIqIKz4,SpATywNh6bZuzm8s1ceuBUnMUAeoAHHw,20,54,34,26,16,0,11,0,141,20.142857142857142,3,0.0,13,34,20,16,41,0,6,11,0,83,58,1
2718,40175,m2y02R5W4wE10TMNO80PJL5IOUbHqLJ2,SpATywNh6bZuzm8s1ceuBUnMUAeoAHHw,16,15,8,9,3,0,6,0,41,5.857142857142857,2,0.0,4,8,9,3,11,0,0,6,0,24,17,0
2719,40182,gMD3QXq0NP11IqNCLAQviPDQUlnfIgHG,A3fsA9Zfv1X2fVEQhTw51lKENdNrEqT3,14,25,1,0,0,13,7,3,49,7.0,2,0.0,0,1,0,0,25,13,0,7,3,1,48,1
2720,40184,p2NSaI2ihMq1kpyPoZO7VVEhFNMs1UZl,bWdj2GDclj5ofokWjzoa5jAwMkxCykd6,15,27,6,104,5,9,5,2,158,22.571428571428573,3,0.0,11,6,97,5,16,9,7,5,2,119,39,1
2721,40188,su19QKj6MYt8IN4q4jbVFtyo4Ew7wkeA,RXDvfPUBYFlVdlueBFbLW0mhhAyGEqpt,12,11,9,0,3,1,4,0,28,4.0,1,0.0,0,9,0,3,11,1,0,4,0,12,16,1
2722,40190,PPWmWzLrUp96FN46Q0IBJuH09vUmH4P8,RXDvfPUBYFlVdlueBFbLW0mhhAyGEqpt,5,2,2,0,0,1,2,0,7,1.0,1,0.0,0,2,0,0,2,1,0,2,0,2,5,1
2723,40198,w1whp42bLIFDRZ3YUW58J4w8I7T8mTT8,SpATywNh6bZuzm8s1ceuBUnMUAeoAHHw,16,58,9,10,3,14,29,1,124,17.714285714285715,4,0.0,24,9,10,3,34,14,0,29,1,46,78,1
2724,40204,tYXSIW41vEc1ilow8iQ6smCJvAodHkNV,bWdj2GDclj5ofokWjzoa5jAwMkxCykd6,3,0,0,0,0,4,6,0,10,1.4285714285714286,3,0.0,0,0,0,0,0,4,0,6,0,0,10,1
2725,40221,eLZwBv2irk6SjmpfpnKpxtWIlq5cEmna,SpATywNh6bZuzm8s1ceuBUnMUAeoAHHw,1,0,0,0,0,0,1,0,1,0.14285714285714285,1,0.0,0,0,0,0,0,0,0,1,0,0,1,1
2726,40222,eLodedTH8LaOO46CeXCjKZbHSbVrNTIU,SpATywNh6bZuzm8s1ceuBUnMUAeoAHHw,14,9,4,12,3,0,2,0,30,4.285714285714286,1,0.0,3,4,10,3,6,0,2,2,0,20,10,1
2727,40241,9y5g4IgoufVMmdRflE8Vnup7J4tZ9eiA,SpATywNh6bZuzm8s1ceuBUnMUAeoAHHw,9,13,5,0,2,0,3,0,23,3.2857142857142856,2,0.0,0,5,0,2,13,0,0,3,0,7,16,1
2728,40247,CnndUXNaSJ8w2bb9DGxHOhqjHw4SEo1K,SpATywNh6bZuzm8s1ceuBUnMUAeoAHHw,18,55,18,24,7,39,16,1,160,22.857142857142858,6,0.0,20,18,21,7,35,39,3,16,1,66,94,0
2729,40257,IRfJ2J3e4oTjcMA6yNpRgLvZtLwyduUa,SpATywNh6bZuzm8s1ceuBUnMUAeoAHHw,23,67,26,22,16,5,18,0,154,22.0,4,0.0,8,26,20,16,59,5,2,18,0,70,84,0
2730,40277,w1whp42bLIFDRZ3YUW58J4w8I7T8mTT8,G8EPVSXsOYB5YQWZGiz1aVq5Pgr2GrQu,1,0,0,0,0,0,3,0,3,0.42857142857142855,2,0.0,0,0,0,0,0,0,0,3,0,0,3,1
2731,40278,mMBONcOMl6gC3uzknh0XJLJbk13L2x3D,SpATywNh6bZuzm8s1ceuBUnMUAeoAHHw,1,0,0,0,0,0,1,0,1,0.14285714285714285,1,0.0,0,0,0,0,0,0,0,1,0,0,1,1
2732,40282,CSh5hGbaSFu2yCb31iVMOVwKocrH471Q,A3fsA9Zfv1X2fVEQhTw51lKENdNrEqT3,44,32,21,80,15,0,9,0,157,22.428571428571427,4,0.0,1,21,61,15,31,0,19,9,0,98,59,1
2733,40283,QrVCBnMblCvtcbL9oEOfx7eoMJ5VAhGg,A3fsA9Zfv1X2fVEQhTw51lKENdNrEqT3,5,3,0,0,0,1,4,0,8,1.1428571428571428,1,0.0,0,0,0,0,3,1,0,4,0,0,8,1
2734,40311,1Pk7jZ6bfmKYXcNnRyEd7kPSZWAEJN0N,RXDvfPUBYFlVdlueBFbLW0mhhAyGEqpt,4,0,0,0,0,1,3,4,8,1.1428571428571428,3,0.0,0,0,0,0,0,1,0,3,4,0,8,1
2735,40316,TDPVJF1yuusgDrAkAZKxkuuOK4BkswXA,RXDvfPUBYFlVdlueBFbLW0mhhAyGEqpt,1,0,0,0,0,0,1,0,1,0.14285714285714285,1,0.0,0,0,0,0,0,0,0,1,0,0,1,1
2736,40319,wg81hfugF770xMHAXCLP7YJmOhdUJnHl,A3fsA9Zfv1X2fVEQhTw51lKENdNrEqT3,10,13,4,0,3,12,7,0,39,5.571428571428571,3,0.0,0,4,0,3,13,12,0,7,0,7,32,0
2737,40327,5vUuq5ZeDCNce4LmvH0naoUjpb3qbNOp,A3fsA9Zfv1X2fVEQhTw51lKENdNrEqT3,4,3,1,0,0,0,3,0,7,1.0,2,0.0,0,1,0,0,3,0,0,3,0,1,6,1
2738,40332,JCQSo9f9Aey0YG4wslCCbhR6oOLB0oC6,SpATywNh6bZuzm8s1ceuBUnMUAeoAHHw,30,39,19,16,7,5,14,1,101,14.428571428571429,4,0.0,8,19,15,7,31,5,1,14,1,49,52,0
2739,40352,lkFGShqBa18inWINppsv8Kl48gyf85dR,A3fsA9Zfv1X2fVEQhTw51lKENdNrEqT3,27,18,13,0,11,4,8,1,55,7.857142857142857,1,0.0,1,13,0,11,17,4,0,8,1,25,30,0
2740,40354,GFHYWWeeAuj1pePvOmCpIpIQDTy4Q3Iv,RXDvfPUBYFlVdlueBFbLW0mhhAyGEqpt,5,4,3,0,0,0,3,0,10,1.4285714285714286,1,0.0,0,3,0,0,4,0,0,3,0,3,7,0
2741,40358,EEH4DLdmIdcQf1RzjjDafMrB5kVed71w,A3fsA9Zfv1X2fVEQhTw51lKENdNrEqT3,11,12,6,0,5,1,7,0,31,4.428571428571429,2,0.0,0,6,0,5,12,1,0,7,0,11,20,1
2742,40364,yzVmKfAEq3932HHrOfA6gQJmdnGWlxk3,bWdj2GDclj5ofokWjzoa5jAwMkxCykd6,1,0,0,0,0,0,1,0,1,0.14285714285714285,1,0.0,0,0,0,0,0,0,0,1,0,0,1,1
2743,40367,wg81hfugF770xMHAXCLP7YJmOhdUJnHl,bWdj2GDclj5ofokWjzoa5jAwMkxCykd6,7,10,3,4,1,0,3,0,21,3.0,2,0.0,1,3,3,1,9,0,1,3,0,8,13,0
2744,40368,12mZjkjOmjGXj1h45WoNLHZyHxNUfx7S,SpATywNh6bZuzm8s1ceuBUnMUAeoAHHw,8,10,1,0,0,0,4,0,15,2.142857142857143,2,0.0,0,1,0,0,10,0,0,4,0,1,14,1
2745,40379,ypimmfavTEjP3dtudBXAUUwNT9VgZavl,SpATywNh6bZuzm8s1ceuBUnMUAeoAHHw,6,3,2,0,1,0,3,0,9,1.2857142857142858,1,0.0,0,2,0,1,3,0,0,3,0,3,6,1
2746,40393,b3FNzt9bW0DYxGtrDwfKBHrmIKO1If8w,SpATywNh6bZuzm8s1ceuBUnMUAeoAHHw,8,10,3,0,3,0,2,0,18,2.5714285714285716,2,0.0,0,3,0,3,10,0,0,2,0,6,12,1
2747,40400,OEVp80aW59NsIt7NX2Io1skiDEX4Ksu0,RXDvfPUBYFlVdlueBFbLW0mhhAyGEqpt,9,5,5,0,1,2,6,2,21,3.0,2,0.0,0,5,0,1,5,2,0,6,2,6,15,1
2748,40402,O7GZYzgRa5tZbYrbtpqYuheFfdPZTjLl,bWdj2GDclj5ofokWjzoa5jAwMkxCykd6,13,25,12,30,7,52,13,2,141,20.142857142857142,4,0.0,5,12,28,7,20,52,2,13,2,52,89,1
2749,40407,oKgEB6oFYTWjl9uatjwv0rz1CsEob0nE,G8EPVSXsOYB5YQWZGiz1aVq5Pgr2GrQu,1,0,0,0,0,0,1,0,1,0.14285714285714285,1,0.0,0,0,0,0,0,0,0,1,0,0,1,1
2750,40413,0Cx8S0i9vAPm7jZ8jXLUkrYp9xGpIHIS,SpATywNh6bZuzm8s1ceuBUnMUAeoAHHw,4,2,1,0,0,4,3,2,12,1.7142857142857142,2,0.0,0,1,0,0,2,4,0,3,2,1,11,1
2751,40423,8jqDD2phXiMGQf0XQi1kVRzLj3TILO0y,RXDvfPUBYFlVdlueBFbLW0mhhAyGEqpt,21,25,15,44,6,0,7,0,97,13.857142857142858,3,0.0,7,15,36,6,18,0,8,7,0,64,33,1
2752,40426,gp5vtbG0la8PEmRrqmDatBiyjEv7PWrx,SpATywNh6bZuzm8s1ceuBUnMUAeoAHHw,9,12,5,20,0,0,3,0,40,5.714285714285714,3,0.0,3,5,16,0,9,0,4,3,0,24,16,1
2753,40427,7x51V9V9eIHFPqiYUnOLpACvWY55pqZF,G8EPVSXsOYB5YQWZGiz1aVq5Pgr2GrQu,6,4,2,0,2,0,2,0,10,1.4285714285714286,1,0.0,0,2,0,2,4,0,0,2,0,4,6,1
2754,40437,sV8Z2WoHSkq80AVgpDh4TBiipVVqEZ0U,A3fsA9Zfv1X2fVEQhTw51lKENdNrEqT3,6,2,1,0,1,0,4,0,8,1.1428571428571428,1,0.0,0,1,0,1,2,0,0,4,0,2,6,1
2755,40438,sV8Z2WoHSkq80AVgpDh4TBiipVVqEZ0U,bWdj2GDclj5ofokWjzoa5jAwMkxCykd6,4,2,1,0,1,0,1,0,5,0.7142857142857143,1,0.0,0,1,0,1,2,0,0,1,0,2,3,1
2756,40447,y6i20DJpIul6LihHwgZcWxbdAap5GcBP,bWdj2GDclj5ofokWjzoa5jAwMkxCykd6,6,4,0,0,0,1,5,0,10,1.4285714285714286,3,0.0,0,0,0,0,4,1,0,5,0,0,10,1
2757,40456,vGcLxIxx9hPQmjm92Kj3O9RHGwvxcHnD,RXDvfPUBYFlVdlueBFbLW0mhhAyGEqpt,18,13,8,6,4,7,8,1,47,6.714285714285714,2,0.0,1,8,6,4,12,7,0,8,1,19,28,1
2758,40467,bNBhDpviOcrLuVFG9Qda6S7fiYJ6jIvc,SpATywNh6bZuzm8s1ceuBUnMUAeoAHHw,18,32,14,14,6,0,4,0,70,10.0,4,0.0,9,14,13,6,23,0,1,4,0,42,28,1
2759,40469,zynLWMDwDGZGrMFdec4rl1UB2FSg8e8K,A3fsA9Zfv1X2fVEQhTw51lKENdNrEqT3,16,8,6,0,4,2,10,1,31,4.428571428571429,2,0.0,0,6,0,4,8,2,0,10,1,10,21,1
2760,40470,nc7wDS7f7s8kprAeqMfrtjmYyoRdpJ65,bWdj2GDclj5ofokWjzoa5jAwMkxCykd6,7,4,2,0,1,3,7,1,18,2.5714285714285716,2,0.0,0,2,0,1,4,3,0,7,1,3,15,1
2761,40476,EChSttZSil8pQFLm0qImYXOhSqXem2dj,SpATywNh6bZuzm8s1ceuBUnMUAeoAHHw,8,7,0,0,0,0,4,2,13,1.8571428571428572,1,0.0,1,0,0,0,6,0,0,4,2,1,12,1
2762,40478,i0LHbVo0MUWeo1slrPpQRlCoWzknlhLR,A3fsA9Zfv1X2fVEQhTw51lKENdNrEqT3,5,2,1,0,1,0,2,0,6,0.8571428571428571,1,0.0,0,1,0,1,2,0,0,2,0,2,4,1
2763,40483,qbRtu1q5PIx1qmhJ9lRn0S3Y5dNcEYWw,G8EPVSXsOYB5YQWZGiz1aVq5Pgr2GrQu,16,10,3,18,2,0,7,0,40,5.714285714285714,2,0.0,0,3,14,2,10,0,4,7,0,19,21,1
2764,40486,JyWRLOWjORt63r48lT9LFGZBSOdXCttf,SpATywNh6bZuzm8s1ceuBUnMUAeoAHHw,6,3,2,0,2,0,1,0,8,1.1428571428571428,1,0.0,0,2,0,2,3,0,0,1,0,4,4,1
2765,40507,ZuoiR8ZSgQ4EIp0UPK1kvYAuneCl6lTF,SpATywNh6bZuzm8s1ceuBUnMUAeoAHHw,8,9,6,0,3,0,1,0,19,2.7142857142857144,1,0.0,1,6,0,3,8,0,0,1,0,10,9,1
2766,40512,l01aGQuAgd5VHAVuk21pZMIeJcDQOX6i,RXDvfPUBYFlVdlueBFbLW0mhhAyGEqpt,21,19,10,39,4,0,6,0,78,11.142857142857142,3,0.0,3,10,35,4,16,0,4,6,0,52,26,0
2767,40514,weKRMLBzfxs8ekS11Y9oGFXbhmcomWRF,A3fsA9Zfv1X2fVEQhTw51lKENdNrEqT3,70,44,27,112,15,0,22,0,220,31.428571428571427,4,0.0,6,27,107,15,38,0,5,22,0,155,65,0
2768,40515,zynLWMDwDGZGrMFdec4rl1UB2FSg8e8K,bWdj2GDclj5ofokWjzoa5jAwMkxCykd6,5,2,1,0,1,0,4,0,8,1.1428571428571428,1,0.0,0,1,0,1,2,0,0,4,0,2,6,1
2769,40525,Su94NLhpMEwzyTwfu3GGXYbQEbtpeLin,G8EPVSXsOYB5YQWZGiz1aVq5Pgr2GrQu,23,23,3,28,3,0,3,0,60,8.571428571428571,3,0.0,1,3,24,3,22,0,4,3,0,31,29,1
2770,40531,KUjjznPFpWdBg0GS5p0fa4zyp2j0nULG,SpATywNh6bZuzm8s1ceuBUnMUAeoAHHw,2,0,0,0,0,0,2,0,2,0.2857142857142857,1,0.0,0,0,0,0,0,0,0,2,0,0,2,1
2771,40541,55BMoXCnWKUmNoRDU7bcdmqWNuK9JpZ6,RXDvfPUBYFlVdlueBFbLW0mhhAyGEqpt,5,6,1,0,0,0,3,0,10,1.4285714285714286,1,0.0,2,1,0,0,4,0,0,3,0,3,7,1
2772,40554,vG6SgKMKhZDlcYDUDKC1NlbpiW2uFCxn,A3fsA9Zfv1X2fVEQhTw51lKENdNrEqT3,8,5,0,0,0,4,10,0,19,2.7142857142857144,2,0.0,0,0,0,0,5,4,0,10,0,0,19,1
2773,40565,jPMKgTfqS9zWr9zlMBzf8ARp4D8cnFWF,SpATywNh6bZuzm8s1ceuBUnMUAeoAHHw,7,7,3,0,2,0,2,0,14,2.0,1,0.0,0,3,0,2,7,0,0,2,0,5,9,1
2774,40576,V2LBVc8iZdDnuXsiI9Sw06zIg4OqT9B6,SpATywNh6bZuzm8s1ceuBUnMUAeoAHHw,18,46,20,7,9,7,21,1,111,15.857142857142858,5,0.0,14,20,7,9,32,7,0,21,1,50,61,1
2775,40583,EVKTxmdXvqH9f0V4XuFLHjVRnnUWi9xh,A3fsA9Zfv1X2fVEQhTw51lKENdNrEqT3,26,47,33,2,14,0,22,0,118,16.857142857142858,8,0.0,2,33,2,14,45,0,0,22,0,51,67,1
2776,40591,izEpfh69zQRV21ZbipmxXr7f4EKcykoG,bWdj2GDclj5ofokWjzoa5jAwMkxCykd6,11,10,2,0,2,1,11,1,27,3.857142857142857,4,0.0,0,2,0,2,10,1,0,11,1,4,23,1
2777,40600,0ipS9A7VTQjzw25R8uCDpA963DAu7orq,SpATywNh6bZuzm8s1ceuBUnMUAeoAHHw,2,0,0,0,0,0,2,0,2,0.2857142857142857,1,0.0,0,0,0,0,0,0,0,2,0,0,2,1
2778,40608,nD2aR2lBTYEZ05tUWGjogkwgt2d7zeNx,A3fsA9Zfv1X2fVEQhTw51lKENdNrEqT3,43,46,2,92,2,0,4,0,146,20.857142857142858,3,0.0,0,2,81,2,46,0,11,4,0,85,61,1
2779,40611,hQ1i3lCFgZxFqzoAUMmIxeDISYlA8zCv,A3fsA9Zfv1X2fVEQhTw51lKENdNrEqT3,11,5,4,0,4,0,6,0,19,2.7142857142857144,1,0.0,0,4,0,4,5,0,0,6,0,8,11,1
2780,40622,FUMcFXXfXADMgcSzTyKSabMQ45EVJp0n,bWdj2GDclj5ofokWjzoa5jAwMkxCykd6,21,29,16,87,8,11,12,1,164,23.428571428571427,4,0.0,8,16,83,8,21,11,4,12,1,115,49,0
2781,40624,Tf1mjUo3ghY0Z5spwun4QIkEOaJmI2Lk,RXDvfPUBYFlVdlueBFbLW0mhhAyGEqpt,7,1,1,0,1,4,10,2,19,2.7142857142857144,1,0.0,0,1,0,1,1,4,0,10,2,2,17,1
2782,40635,BOna3ORacJGhjt4FcGMkKNwkDYsEjcvt,RXDvfPUBYFlVdlueBFbLW0mhhAyGEqpt,28,45,24,0,12,1,17,2,101,14.428571428571429,6,0.0,0,24,0,12,45,1,0,17,2,36,65,1
2783,40638,KLMwnbeiUPyAq67r6m0k1uM0yIHdmaWg,SpATywNh6bZuzm8s1ceuBUnMUAeoAHHw,6,2,0,0,0,0,5,0,7,1.0,1,0.0,0,0,0,0,2,0,0,5,0,0,7,1
2784,40646,uL0Po5J8HnBQPqSUKMNRTAvfe5A6cmqw,bWdj2GDclj5ofokWjzoa5jAwMkxCykd6,5,2,1,0,1,0,2,0,6,0.8571428571428571,1,0.0,0,1,0,1,2,0,0,2,0,2,4,1
2785,40670,AMHmOq5PY3K2Bq5bkWrg2Cz6hshdhVde,SpATywNh6bZuzm8s1ceuBUnMUAeoAHHw,7,5,1,0,1,4,5,0,16,2.2857142857142856,2,0.0,0,1,0,1,5,4,0,5,0,2,14,1
2786,40685,UIuYkrvUrLhMOE6NfUprrMfA4RCzuhOi,SpATywNh6bZuzm8s1ceuBUnMUAeoAHHw,8,3,2,0,2,0,5,1,13,1.8571428571428572,1,0.0,0,2,0,2,3,0,0,5,1,4,9,1
2787,40693,UGYGSfRkJhOkgkdlCI6YSCshpNvwBF31,SpATywNh6bZuzm8s1ceuBUnMUAeoAHHw,11,13,8,3,4,0,3,0,31,4.428571428571429,2,0.0,1,8,3,4,12,0,0,3,0,16,15,1
2788,40694,EY3QtJOWsoMIz6ZJR9ZEsrPPDsaYmN0t,SpATywNh6bZuzm8s1ceuBUnMUAeoAHHw,15,28,0,20,0,19,17,2,86,12.285714285714286,2,0.0,7,0,15,0,21,19,5,17,2,22,64,1
2789,40696,mWUHV4msWZXLdeYpWFdjuucQsrIdSFxH,SpATywNh6bZuzm8s1ceuBUnMUAeoAHHw,1,0,0,0,0,0,1,0,1,0.14285714285714285,1,0.0,0,0,0,0,0,0,0,1,0,0,1,1
2790,40697,B9Ey1tIo6ANxVa0IvzoinvUWj4cenbLl,SpATywNh6bZuzm8s1ceuBUnMUAeoAHHw,11,19,2,11,1,0,1,0,34,4.857142857142857,4,0.0,3,2,9,1,16,0,2,1,0,15,19,1
2791,40717,P11RKOPCDL5miqBQ5O3oznfREAcXF9hp,A3fsA9Zfv1X2fVEQhTw51lKENdNrEqT3,45,38,19,50,16,4,21,2,150,21.428571428571427,2,0.0,1,19,44,16,37,4,6,21,2,80,70,0
2792,40720,n0jV4ldO1halkYjljprJ6GkJFBgQehlW,bWdj2GDclj5ofokWjzoa5jAwMkxCykd6,5,5,0,0,0,0,3,0,8,1.1428571428571428,1,0.0,0,0,0,0,5,0,0,3,0,0,8,1
2793,40731,1UUWIp3PiN0CT0O96IXxrt6TRVFJmFUz,bWdj2GDclj5ofokWjzoa5jAwMkxCykd6,2,0,0,0,0,0,2,0,2,0.2857142857142857,1,0.0,0,0,0,0,0,0,0,2,0,0,2,1
2794,40755,1Pk7jZ6bfmKYXcNnRyEd7kPSZWAEJN0N,SpATywNh6bZuzm8s1ceuBUnMUAeoAHHw,2,0,0,0,0,0,2,0,2,0.2857142857142857,2,0.0,0,0,0,0,0,0,0,2,0,0,2,1
2795,40759,1Pk7jZ6bfmKYXcNnRyEd7kPSZWAEJN0N,bWdj2GDclj5ofokWjzoa5jAwMkxCykd6,10,12,0,2,1,3,13,2,33,4.714285714285714,4,0.0,1,0,2,1,11,3,0,13,2,4,29,1
2796,40760,n0jV4ldO1halkYjljprJ6GkJFBgQehlW,A3fsA9Zfv1X2fVEQhTw51lKENdNrEqT3,8,8,1,0,1,0,3,0,13,1.8571428571428572,2,0.0,0,1,0,1,8,0,0,3,0,2,11,1
2797,40762,FcIMQNoo2B9wNij30W0t3SsuF1pzZCFp,SpATywNh6bZuzm8s1ceuBUnMUAeoAHHw,14,42,0,21,0,19,33,8,123,17.571428571428573,6,0.0,19,0,18,0,23,19,3,33,8,37,86,0
2798,40771,bsalGAvHbAyi2zQkMdMuno7PqVBrE5qV,SpATywNh6bZuzm8s1ceuBUnMUAeoAHHw,11,14,7,2,4,1,1,0,29,4.142857142857143,1,0.0,6,7,2,4,8,1,0,1,0,19,10,1
2799,40784,H2Rgqo3kRDsNdbNVEDl0788s9SSdLM8P,A3fsA9Zfv1X2fVEQhTw51lKENdNrEqT3,10,8,1,0,0,0,4,0,13,1.8571428571428572,1,0.0,0,1,0,0,8,0,0,4,0,1,12,1
2800,40788,TXXodrsD3gpNuvLWnhSXeHO4v2Kp7PZ2,SpATywNh6bZuzm8s1ceuBUnMUAeoAHHw,16,18,8,13,3,0,6,0,48,6.857142857142857,3,0.0,3,8,11,3,15,0,2,6,0,25,23,1
2801,40790,c6KChK06Rh7fb4zwLQYLlfB5pAi9XDtG,A3fsA9Zfv1X2fVEQhTw51lKENdNrEqT3,15,14,2,2,2,0,6,0,26,3.7142857142857144,2,0.0,0,2,2,2,14,0,0,6,0,6,20,1
2802,40818,0wm7bVyJC7jfhIoeylaV85sHOH5JOhtj,RXDvfPUBYFlVdlueBFbLW0mhhAyGEqpt,1,0,0,0,0,0,3,0,3,0.42857142857142855,3,0.0,0,0,0,0,0,0,0,3,0,0,3,1
2803,40830,WVkWa16sSufUj4kk1L49kzGtRQMQkIJr,SpATywNh6bZuzm8s1ceuBUnMUAeoAHHw,14,30,2,17,1,0,6,0,56,8.0,3,0.0,6,2,14,1,24,0,3,6,0,23,33,1
2804,40833,LRHDYNgQAsG2UssS8TgaqkiYDbFlVrrj,bWdj2GDclj5ofokWjzoa5jAwMkxCykd6,5,2,1,0,1,0,2,0,6,0.8571428571428571,1,0.0,0,1,0,1,2,0,0,2,0,2,4,1
2805,40845,PiMa9t7XXgGIfYACepD9P8yHYFoha6X9,SpATywNh6bZuzm8s1ceuBUnMUAeoAHHw,7,3,2,0,2,0,2,0,9,1.2857142857142858,1,0.0,0,2,0,2,3,0,0,2,0,4,5,1
2806,40851,hkTx4XunczsnVq4H9eVYRZURkkofvB6I,bWdj2GDclj5ofokWjzoa5jAwMkxCykd6,15,19,7,20,3,29,6,0,84,12.0,2,0.0,4,7,16,3,15,29,4,6,0,30,54,1
2807,40858,dJJJLtI6F18pblO9KPkBPg9ZKTgQPaQc,SpATywNh6bZuzm8s1ceuBUnMUAeoAHHw,15,32,2,8,1,3,6,0,52,7.428571428571429,5,0.0,12,2,8,1,20,3,0,6,0,23,29,0
2808,40861,40L77km5z19sJEVeJ6u4qpa9SAG2ZSIF,SpATywNh6bZuzm8s1ceuBUnMUAeoAHHw,19,30,18,26,0,0,10,0,84,12.0,3,0.0,7,18,23,0,23,0,3,10,0,48,36,0
2809,40862,dNG5hDkS45m4C7FwHXebOEhyKKD4NWCM,SpATywNh6bZuzm8s1ceuBUnMUAeoAHHw,9,4,2,0,2,0,4,1,13,1.8571428571428572,1,0.0,1,2,0,2,3,0,0,4,1,5,8,1
2810,40870,8gfCGxZ6lFjZr89RwPF8oXZs1Qn6Pq6X,bWdj2GDclj5ofokWjzoa5jAwMkxCykd6,3,0,0,0,0,0,10,0,10,1.4285714285714286,3,0.0,0,0,0,0,0,0,0,10,0,0,10,1
2811,40873,EjYujgGigN4Oo3US4ixRA3bL0nJn2PDZ,SpATywNh6bZuzm8s1ceuBUnMUAeoAHHw,25,27,5,38,3,4,11,0,88,12.571428571428571,5,0.0,4,5,33,3,23,4,5,11,0,45,43,1
2812,40875,2ekh2uQneNAGmhQ3c3UciXnUFmuOUWou,SpATywNh6bZuzm8s1ceuBUnMUAeoAHHw,28,38,21,30,12,2,10,1,114,16.285714285714285,4,0.0,10,21,27,12,28,2,3,10,1,70,44,1
2813,40877,EjYujgGigN4Oo3US4ixRA3bL0nJn2PDZ,G8EPVSXsOYB5YQWZGiz1aVq5Pgr2GrQu,5,6,1,0,1,0,3,0,11,1.5714285714285714,2,0.0,1,1,0,1,5,0,0,3,0,3,8,1
2814,40891,CuHXUjtagLOKelRrRvelBtnV2Gm8l97I,RXDvfPUBYFlVdlueBFbLW0mhhAyGEqpt,5,2,1,0,1,0,4,0,8,1.1428571428571428,1,0.0,0,1,0,1,2,0,0,4,0,2,6,1
2815,40905,aldLXGpzmiip2CUSDhqN8A5UpGMVUHxY,bWdj2GDclj5ofokWjzoa5jAwMkxCykd6,21,50,30,14,14,8,12,0,128,18.285714285714285,6,0.0,8,30,14,14,42,8,0,12,0,66,62,0
2816,40908,OXDIjQPBiuWpB7PdzfniEtiITaq40Kxq,RXDvfPUBYFlVdlueBFbLW0mhhAyGEqpt,2,0,0,0,0,0,2,0,2,0.2857142857142857,1,0.0,0,0,0,0,0,0,0,2,0,0,2,1
2817,40910,M2AmcvqhvMtUlyRV6vMvvoM2IhrMmAwT,A3fsA9Zfv1X2fVEQhTw51lKENdNrEqT3,70,29,22,86,16,34,15,2,204,29.142857142857142,2,0.0,2,22,86,16,27,34,0,15,2,126,78,1
2818,40911,CdB6oTxVZuxQJ7m61lQzyuJSIxL6zQLH,A3fsA9Zfv1X2fVEQhTw51lKENdNrEqT3,16,17,8,0,7,0,4,0,36,5.142857142857143,1,0.0,0,8,0,7,17,0,0,4,0,15,21,1
2819,40918,6tIWZMByN6VbFXOKgaTSsptqRovNe938,bWdj2GDclj5ofokWjzoa5jAwMkxCykd6,1,0,0,0,0,0,1,0,1,0.14285714285714285,1,0.0,0,0,0,0,0,0,0,1,0,0,1,1
2820,40920,6tIWZMByN6VbFXOKgaTSsptqRovNe938,A3fsA9Zfv1X2fVEQhTw51lKENdNrEqT3,8,4,2,0,0,1,7,1,15,2.142857142857143,2,0.0,0,2,0,0,4,1,0,7,1,2,13,1
2821,40928,qoIGs6RP8XMC5yN9VowJtSVp77FsPrRk,A3fsA9Zfv1X2fVEQhTw51lKENdNrEqT3,23,36,24,0,14,0,7,0,81,11.571428571428571,2,0.0,1,24,0,14,35,0,0,7,0,39,42,1
2822,40936,DJeWlgB4cP1RQ3JZLa1wZwd4zgAbYOxv,RXDvfPUBYFlVdlueBFbLW0mhhAyGEqpt,1,0,0,0,0,0,1,0,1,0.14285714285714285,1,0.0,0,0,0,0,0,0,0,1,0,0,1,1
2823,40946,G14xjTwMWbfsqTNiU3Ie1utHyPegqSvR,G8EPVSXsOYB5YQWZGiz1aVq5Pgr2GrQu,4,2,1,0,1,0,2,0,6,0.8571428571428571,2,0.0,0,1,0,1,2,0,0,2,0,2,4,1
2824,40947,G14xjTwMWbfsqTNiU3Ie1utHyPegqSvR,SpATywNh6bZuzm8s1ceuBUnMUAeoAHHw,12,16,1,14,0,0,3,0,34,4.857142857142857,2,0.0,5,1,13,0,11,0,1,3,0,19,15,1
2825,40959,kKw20KeSl1t7Pslb9OutpFfK6qbHmAq8,bWdj2GDclj5ofokWjzoa5jAwMkxCykd6,8,10,2,0,0,0,10,1,23,3.2857142857142856,2,0.0,4,2,0,0,6,0,0,10,1,6,17,1
2826,40965,dSPH9g8Ag2uZLcQxLXukxNXBLRvLY5xp,A3fsA9Zfv1X2fVEQhTw51lKENdNrEqT3,10,8,0,0,1,0,1,0,10,1.4285714285714286,2,0.0,0,0,0,1,8,0,0,1,0,1,9,1
2827,40994,WmqMKoevd5yMpzwxk3BDNFkg4y1FZjx5,G8EPVSXsOYB5YQWZGiz1aVq5Pgr2GrQu,32,42,6,18,8,2,13,1,90,12.857142857142858,10,0.0,1,6,15,8,41,2,3,13,1,30,60,1
2828,40998,syzcMhy375dEj89fdUtXti8MXg1a8bSN,7GRhBDsirIGkRZBtSMEzNTyDr2JQm4xx,26,58,23,54,5,1,30,0,171,24.428571428571427,3,0.0,18,23,52,5,40,1,2,30,0,98,73,1
2829,41012,9GQBKn8LG5mdPSwy8AFUPaG4NSLWjEYt,7GRhBDsirIGkRZBtSMEzNTyDr2JQm4xx,9,15,5,0,0,0,12,2,34,4.857142857142857,2,0.0,3,5,0,0,12,0,0,12,2,8,26,1
2830,41018,Htb70W0lnqw4QeBjeePevzE0xRg4O6vF,7GRhBDsirIGkRZBtSMEzNTyDr2JQm4xx,1,0,0,0,0,0,1,0,1,0.14285714285714285,1,0.0,0,0,0,0,0,0,0,1,0,0,1,1
2831,41023,8Ht2Zmfn81Gwb093X2QMQmBGW6qi8rRd,7GRhBDsirIGkRZBtSMEzNTyDr2JQm4xx,28,33,15,53,13,0,6,0,120,17.142857142857142,4,0.0,13,15,45,13,20,0,8,6,0,86,34,1
2832,41066,wb00XyLFbUrmycITZ6LeGF1mEqSeoH2s,7GRhBDsirIGkRZBtSMEzNTyDr2JQm4xx,7,6,1,12,0,0,2,0,21,3.0,1,0.0,3,1,10,0,3,0,2,2,0,14,7,1
2833,41082,DVIil2NM7ZWOtqe6rhlMzwEUAb2wuaeh,7GRhBDsirIGkRZBtSMEzNTyDr2JQm4xx,31,91,28,32,16,15,9,0,191,27.285714285714285,4,0.0,52,28,32,16,39,15,0,9,0,128,63,0
2834,41111,LZT7nbUFDfOvhG31ggWghVXoB5daajKc,7GRhBDsirIGkRZBtSMEzNTyDr2JQm4xx,6,9,3,0,0,2,2,0,16,2.2857142857142856,1,0.0,3,3,0,0,6,2,0,2,0,6,10,1
2835,41157,k3YRNSEUtBfnCzCI2ffYAi1qqoCc9d8W,7GRhBDsirIGkRZBtSMEzNTyDr2JQm4xx,5,5,1,0,0,0,2,0,8,1.1428571428571428,1,0.0,0,1,0,0,5,0,0,2,0,1,7,1
2836,41289,I1VndljUSmkFLMl8yI2zESYAyPlBzjwo,7GRhBDsirIGkRZBtSMEzNTyDr2JQm4xx,10,13,7,0,2,0,1,0,23,3.2857142857142856,1,0.0,4,7,0,2,9,0,0,1,0,13,10,1
2837,41300,qJQBhMSxZNb9FZGkj9PyIWzMqhMNvrJp,7GRhBDsirIGkRZBtSMEzNTyDr2JQm4xx,27,41,5,28,6,0,12,1,93,13.285714285714286,5,0.0,16,5,26,6,25,0,2,12,1,53,40,0
2838,41366,Ns35aao5T8wUPwIDoTDfhRc8L852Neqp,7GRhBDsirIGkRZBtSMEzNTyDr2JQm4xx,20,30,10,0,10,2,7,1,60,8.571428571428571,1,0.0,18,10,0,10,12,2,0,7,1,38,22,0
2839,41377,PoxO0NKuyAvBdyfzZW09NxNtHwzofyd3,7GRhBDsirIGkRZBtSMEzNTyDr2JQm4xx,5,2,1,0,1,0,2,0,6,0.8571428571428571,1,0.0,0,1,0,1,2,0,0,2,0,2,4,1
2840,41405,wxXsB2E97PklyJnNr2rcYvINOWKCzd23,7GRhBDsirIGkRZBtSMEzNTyDr2JQm4xx,1,0,0,0,0,0,1,0,1,0.14285714285714285,1,0.0,0,0,0,0,0,0,0,1,0,0,1,0
2841,41483,KqlAQr8NRKwI0MhjiYskyr4iy4QPJQrZ,7GRhBDsirIGkRZBtSMEzNTyDr2JQm4xx,4,2,1,0,0,0,2,0,5,0.7142857142857143,1,0.0,0,1,0,0,2,0,0,2,0,1,4,1
2842,41485,xg6gozDtJtmbriZIHFk0YIJKhyzF16Dg,7GRhBDsirIGkRZBtSMEzNTyDr2JQm4xx,2,0,0,0,0,0,2,0,2,0.2857142857142857,1,0.0,0,0,0,0,0,0,0,2,0,0,2,1
2843,41495,w1eCZn6FuUz5n8CxQTkysG8zjugCkTfX,7GRhBDsirIGkRZBtSMEzNTyDr2JQm4xx,1,0,0,0,0,0,1,0,1,0.14285714285714285,1,0.0,0,0,0,0,0,0,0,1,0,0,1,1
2844,41514,TDsFMiW3NmfZzVauB4oMkOZiSJ5XLe6I,7GRhBDsirIGkRZBtSMEzNTyDr2JQm4xx,22,37,7,58,2,1,12,1,118,16.857142857142858,3,0.0,17,7,52,2,20,1,6,12,1,78,40,1
2845,41521,m7HNFlUhYzKWxgjrmFGLTIf1VbbNLm66,7GRhBDsirIGkRZBtSMEzNTyDr2JQm4xx,1,0,0,0,0,0,1,0,1,0.14285714285714285,1,0.0,0,0,0,0,0,0,0,1,0,0,1,1
2846,41533,8zcddBOPFYuIEkUZpmoApSiBFpQCKBLf,7GRhBDsirIGkRZBtSMEzNTyDr2JQm4xx,1,0,0,0,0,0,1,0,1,0.14285714285714285,1,0.0,0,0,0,0,0,0,0,1,0,0,1,1
2847,41551,SmViYwWTWrMXjcjjHVYvpvTHTeWvqg4X,7GRhBDsirIGkRZBtSMEzNTyDr2JQm4xx,7,3,1,0,1,0,3,0,8,1.1428571428571428,1,0.0,0,1,0,1,3,0,0,3,0,2,6,1
2848,41577,8niPfp9xqHHlhtnR3IY1QWUasjj0zQpl,7GRhBDsirIGkRZBtSMEzNTyDr2JQm4xx,5,2,1,0,1,0,2,0,6,0.8571428571428571,1,0.0,0,1,0,1,2,0,0,2,0,2,4,1
2849,41582,CfUHqy5TfjBtRxjNztsGxyFua9jISd0Q,7GRhBDsirIGkRZBtSMEzNTyDr2JQm4xx,43,70,31,53,22,1,10,0,187,26.714285714285715,5,0.0,34,31,46,22,36,1,7,10,0,133,54,1
2850,41618,ZqebYSMW1RUIRSXJmMzKs77Liu7pj2zF,7GRhBDsirIGkRZBtSMEzNTyDr2JQm4xx,33,34,32,0,24,4,8,1,103,14.714285714285714,3,0.0,0,32,0,24,34,4,0,8,1,56,47,1
2851,41697,CQ8MKRcyoRQu9uvYz8G86ILjGgWWbOQv,7GRhBDsirIGkRZBtSMEzNTyDr2JQm4xx,5,5,2,0,0,0,3,0,10,1.4285714285714286,1,0.0,0,2,0,0,5,0,0,3,0,2,8,1
2852,41753,5QHXCSGlBOGq7ih6SlrH28hNQCROqU2d,7GRhBDsirIGkRZBtSMEzNTyDr2JQm4xx,2,0,0,0,0,0,3,0,3,0.42857142857142855,2,0.0,0,0,0,0,0,0,0,3,0,0,3,1
2853,41762,FJJqBn1iTJmAbav7Ov5Y4ycyF65fvY1E,7GRhBDsirIGkRZBtSMEzNTyDr2JQm4xx,2,0,0,0,0,0,2,0,2,0.2857142857142857,2,0.0,0,0,0,0,0,0,0,2,0,0,2,0
2854,41792,UNnwy1ZgbFYM2Kztvg7tp4bM94xWe0nF,7GRhBDsirIGkRZBtSMEzNTyDr2JQm4xx,1,0,0,0,0,0,1,0,1,0.14285714285714285,1,0.0,0,0,0,0,0,0,0,1,0,0,1,1
2855,41795,F71ZfnryHCMhVExpC2gJVpDSfOwRuiHf,7GRhBDsirIGkRZBtSMEzNTyDr2JQm4xx,6,1,1,0,1,0,5,0,8,1.1428571428571428,1,0.0,0,1,0,1,1,0,0,5,0,2,6,1
2856,41801,3SP9iNDvUt8m67ZMqC5DpQRe6ekkTpsP,7GRhBDsirIGkRZBtSMEzNTyDr2JQm4xx,1,0,0,0,0,0,1,0,1,0.14285714285714285,1,0.0,0,0,0,0,0,0,0,1,0,0,1,1
2857,41807,txRaMeFRdTsCsziGBMMxzL5gSPIB7mbk,7GRhBDsirIGkRZBtSMEzNTyDr2JQm4xx,44,89,27,46,14,23,12,2,213,30.428571428571427,3,0.0,44,27,44,14,45,23,2,12,2,129,84,1
2858,41815,NYjtfRvfVgjdP93necZvZvYS7zFHrEkH,7GRhBDsirIGkRZBtSMEzNTyDr2JQm4xx,6,2,1,0,1,0,4,0,8,1.1428571428571428,1,0.0,0,1,0,1,2,0,0,4,0,2,6,1
2859,43665,NrHk4qmJXuD0TsjkQSnghKpk9ZjGAOyU,7GRhBDsirIGkRZBtSMEzNTyDr2JQm4xx,31,21,18,0,12,0,5,0,56,8.0,2,0.0,0,18,0,12,21,0,0,5,0,30,26,1
2860,43673,Y53vJNK6NsQxTqlgv0AKozWzT5IkWSVb,7GRhBDsirIGkRZBtSMEzNTyDr2JQm4xx,5,5,3,0,0,0,3,0,11,1.5714285714285714,2,0.0,0,3,0,0,5,0,0,3,0,3,8,0
2861,43993,p0RuxkRTmLRS6ii3YN8z6W4Bqa7AYRuD,fbPkOYLVPtPgIt0MxizjfFJov3JbHyAi,7,3,2,0,2,1,4,0,12,1.7142857142857142,1,0.0,0,2,0,2,3,1,0,4,0,4,8,1
2862,43994,hWE8YlXrkle820sTOY1UXpm2QbX0rLTx,fbPkOYLVPtPgIt0MxizjfFJov3JbHyAi,21,25,14,1,12,12,9,1,74,10.571428571428571,2,0.0,6,14,1,12,19,12,0,9,1,33,41,1
2863,43995,diyFwrzJDqdxnswzs6l8ZdAq590WR6Is,fbPkOYLVPtPgIt0MxizjfFJov3JbHyAi,5,4,0,0,0,1,14,3,22,3.142857142857143,1,0.0,0,0,0,0,4,1,0,14,3,0,22,1
2864,43996,aNKQixLt1xurBtrkCE5j4vCWMytj94zC,fbPkOYLVPtPgIt0MxizjfFJov3JbHyAi,7,14,6,0,3,7,11,0,41,5.857142857142857,3,0.0,0,6,0,3,14,7,0,11,0,9,32,1
2865,43997,mtCGwN4OvCoCnbzMbutLT6Nf2wxkcaDu,fbPkOYLVPtPgIt0MxizjfFJov3JbHyAi,3,1,0,0,0,0,2,0,3,0.42857142857142855,1,0.0,0,0,0,0,1,0,0,2,0,0,3,1
2866,43999,sCVKWDTf6SABzbHNn99T0WibbkC7xg03,fbPkOYLVPtPgIt0MxizjfFJov3JbHyAi,1,0,0,0,0,0,1,0,1,0.14285714285714285,1,0.0,0,0,0,0,0,0,0,1,0,0,1,1
2867,44000,7iDvRXsYqjRdgImengAvKZVd91CAi3lD,fbPkOYLVPtPgIt0MxizjfFJov3JbHyAi,10,13,8,0,4,4,6,2,37,5.285714285714286,2,0.0,2,8,0,4,11,4,0,6,2,14,23,1
2868,44001,mJn5S64R5TbyphUPASOXDVT6KwPqgFqV,fbPkOYLVPtPgIt0MxizjfFJov3JbHyAi,26,25,14,13,11,22,10,1,96,13.714285714285714,2,0.0,8,14,12,11,17,22,1,10,1,45,51,1
2869,44002,u11lG1A4K1gIhpOqkswgAj4EhDI0xOZ0,fbPkOYLVPtPgIt0MxizjfFJov3JbHyAi,7,3,2,0,2,0,6,0,13,1.8571428571428572,1,0.0,0,2,0,2,3,0,0,6,0,4,9,1
2870,44003,DDTIWqk6JJRrEvr9d9O7DmY1OYVdzDEA,fbPkOYLVPtPgIt0MxizjfFJov3JbHyAi,10,7,4,0,3,2,8,1,25,3.5714285714285716,1,0.0,1,4,0,3,6,2,0,8,1,8,17,1
2871,44004,d8EMxzMifzqQKHyC0riOTQo2zuIYKTb1,fbPkOYLVPtPgIt0MxizjfFJov3JbHyAi,11,9,6,0,4,5,7,0,31,4.428571428571429,1,0.0,0,6,0,4,9,5,0,7,0,10,21,1
2872,44005,J8NkUmSvsrLHkKNXPhFg7o0pG3K7Aywh,fbPkOYLVPtPgIt0MxizjfFJov3JbHyAi,20,26,13,18,9,51,6,0,123,17.571428571428573,3,0.0,7,13,16,9,19,51,2,6,0,45,78,0
2873,44006,hjUSUM6roI2mLGkMAqBjE0uxFRBSMYHJ,fbPkOYLVPtPgIt0MxizjfFJov3JbHyAi,7,3,2,0,2,4,4,0,15,2.142857142857143,2,0.0,0,2,0,2,3,4,0,4,0,4,11,1
2874,44011,DBl87nF6WTgoCD6kgTHVE2oB45pDEn6y,fbPkOYLVPtPgIt0MxizjfFJov3JbHyAi,7,7,5,0,3,0,2,0,17,2.4285714285714284,2,0.0,0,5,0,3,7,0,0,2,0,8,9,1
2875,44013,p2au3FOExtiqsg1tYoyGj3KNDXCc91mB,fbPkOYLVPtPgIt0MxizjfFJov3JbHyAi,10,6,4,0,3,1,7,1,22,3.142857142857143,1,0.0,0,4,0,3,6,1,0,7,1,7,15,1
2876,44014,x7XiHrvKEMpxKuTFiRO880d5p07e6S97,fbPkOYLVPtPgIt0MxizjfFJov3JbHyAi,8,2,2,0,2,1,3,1,11,1.5714285714285714,1,0.0,0,2,0,2,2,1,0,3,1,4,7,1
2877,44016,FssYjkUANdoULgFGTzw1AQpi3Hr9RmSx,fbPkOYLVPtPgIt0MxizjfFJov3JbHyAi,7,4,2,0,2,2,4,0,14,2.0,1,0.0,0,2,0,2,4,2,0,4,0,4,10,1
2878,44018,qKfZusm0R8jxltESvgi15dswdw73Gjlp,fbPkOYLVPtPgIt0MxizjfFJov3JbHyAi,11,14,3,0,3,0,3,0,23,3.2857142857142856,2,0.0,0,3,0,3,14,0,0,3,0,6,17,1
2879,44020,Z2WYkCILkqUB8wo1t1Cu8aCpPedEwo19,fbPkOYLVPtPgIt0MxizjfFJov3JbHyAi,5,3,1,0,1,0,1,0,6,0.8571428571428571,1,0.0,0,1,0,1,3,0,0,1,0,2,4,1
2880,44022,PDXGFyBPYCflMZuvp1Ir4M4S3e0nyboZ,fbPkOYLVPtPgIt0MxizjfFJov3JbHyAi,30,81,44,13,14,74,30,0,256,36.57142857142857,10,0.0,10,44,10,14,71,74,3,30,0,78,178,1
2881,44023,YB6Mdw3HVis2k9yXIV8Bn5gVXQ6GVqTU,fbPkOYLVPtPgIt0MxizjfFJov3JbHyAi,5,5,0,0,0,4,4,0,13,1.8571428571428572,2,0.0,0,0,0,0,5,4,0,4,0,0,13,1
2882,44025,26PDrRJYSMH6uI6XnAwbn1s6xjvZitk1,fbPkOYLVPtPgIt0MxizjfFJov3JbHyAi,5,2,1,0,1,0,3,0,7,1.0,1,0.0,0,1,0,1,2,0,0,3,0,2,5,1
2883,44026,A1Bqk2hgKzNE6O0Jd3HBtI2AJixgnU9D,fbPkOYLVPtPgIt0MxizjfFJov3JbHyAi,8,3,2,0,2,2,5,0,14,2.0,1,0.0,0,2,0,2,3,2,0,5,0,4,10,1
2884,44029,cDtNKVgke675efaANxs81gywhUCG6Xvn,fbPkOYLVPtPgIt0MxizjfFJov3JbHyAi,2,0,0,0,0,0,2,0,2,0.2857142857142857,1,0.0,0,0,0,0,0,0,0,2,0,0,2,1
2885,44030,AqCPWoJ3Xqrj0YuS9VE2yr3qK1da6ZEL,fbPkOYLVPtPgIt0MxizjfFJov3JbHyAi,6,2,1,0,1,8,4,0,16,2.2857142857142856,2,0.0,0,1,0,1,2,8,0,4,0,2,14,1
2886,44031,wg3Aluyuv2BxZCQwpp08tOXwIGHtBXla,fbPkOYLVPtPgIt0MxizjfFJov3JbHyAi,9,6,3,0,4,0,13,1,27,3.857142857142857,3,0.0,3,3,0,4,3,0,0,13,1,10,17,1
2887,44033,jCGl2la0U6McatWubPbo3ygrfz4SQroM,fbPkOYLVPtPgIt0MxizjfFJov3JbHyAi,2,0,0,0,0,0,2,0,2,0.2857142857142857,1,0.0,0,0,0,0,0,0,0,2,0,0,2,1
2888,44035,AOTrlTWQ3Oa2ClznlEkXg5ypb6eqlCbx,fbPkOYLVPtPgIt0MxizjfFJov3JbHyAi,8,5,3,0,2,1,6,1,18,2.5714285714285716,1,0.0,0,3,0,2,5,1,0,6,1,5,13,1
2889,44037,R2NtjVNHKdme1jYGEGYDv7qM6g83uuPF,fbPkOYLVPtPgIt0MxizjfFJov3JbHyAi,10,9,6,0,3,1,6,0,25,3.5714285714285716,1,0.0,0,6,0,3,9,1,0,6,0,9,16,1
2890,44038,3JmWuBfNEBLNWjaLSdiSh8Z86NQq0lk7,fbPkOYLVPtPgIt0MxizjfFJov3JbHyAi,15,23,1,5,1,9,7,1,47,6.714285714285714,1,0.0,3,1,4,1,20,9,1,7,1,9,38,1
2891,44039,4yBRvdZ1Q3XWGsAQkRh6UnzQ7WibjAOe,fbPkOYLVPtPgIt0MxizjfFJov3JbHyAi,7,8,6,0,4,0,7,0,25,3.5714285714285716,1,0.0,0,6,0,4,8,0,0,7,0,10,15,1
2892,44042,4QPOXaQgHIrhjYrZ52sVeohXb5o3Oznm,fbPkOYLVPtPgIt0MxizjfFJov3JbHyAi,2,0,0,0,0,0,2,0,2,0.2857142857142857,1,0.0,0,0,0,0,0,0,0,2,0,0,2,1
2893,44043,s8VWFWImIYSA2JA5l16L3WRLI25ddNXq,fbPkOYLVPtPgIt0MxizjfFJov3JbHyAi,11,21,5,1,8,7,10,0,52,7.428571428571429,2,0.0,13,5,1,8,8,7,0,10,0,27,25,1
2894,44045,HfDg6ZshQIIsqHP26E57zcevXCtObxuT,fbPkOYLVPtPgIt0MxizjfFJov3JbHyAi,1,0,0,0,0,0,2,0,2,0.2857142857142857,1,0.0,0,0,0,0,0,0,0,2,0,0,2,1
2895,44047,SJEqwoHZ7xXB9jGS9EmfQals4M4vlWb2,fbPkOYLVPtPgIt0MxizjfFJov3JbHyAi,5,3,1,0,1,0,5,0,10,1.4285714285714286,1,0.0,0,1,0,1,3,0,0,5,0,2,8,1
2896,44048,YmdgsFslyipuqAvTNMUf5cKIo7lT9UI2,fbPkOYLVPtPgIt0MxizjfFJov3JbHyAi,9,12,4,0,2,0,3,0,21,3.0,1,0.0,2,4,0,2,10,0,0,3,0,8,13,1
2897,44050,VeCExJm9PxMsppGBNIELDYWjqzgCI8lp,fbPkOYLVPtPgIt0MxizjfFJov3JbHyAi,6,3,2,0,2,0,1,0,8,1.1428571428571428,1,0.0,0,2,0,2,3,0,0,1,0,4,4,1
2898,44051,AmoWrYr0vE5hXRkVUs4W3twtpkRI6UWn,fbPkOYLVPtPgIt0MxizjfFJov3JbHyAi,10,19,9,0,6,14,9,1,58,8.285714285714286,3,0.0,4,9,0,6,15,14,0,9,1,19,39,1
2899,44053,eoxsaFPg8O2Z1ERwXNqkhtxGChEAvpFr,fbPkOYLVPtPgIt0MxizjfFJov3JbHyAi,6,8,2,2,2,0,1,0,15,2.142857142857143,1,0.0,5,2,2,2,3,0,0,1,0,11,4,1
2900,44055,aosFpeLMqBiLLcyUKYcbUuWGCjQbFGiD,fbPkOYLVPtPgIt0MxizjfFJov3JbHyAi,11,5,4,0,4,1,3,0,17,2.4285714285714284,1,0.0,0,4,0,4,5,1,0,3,0,8,9,1
2901,44056,pdAqVvKgeCIaihAcxhTXOYjPQxxjaa8K,fbPkOYLVPtPgIt0MxizjfFJov3JbHyAi,5,3,2,0,0,0,2,0,7,1.0,1,0.0,0,2,0,0,3,0,0,2,0,2,5,1
2902,44059,VCAUk6CdtYtSQUkeIHqrUkYmOmbAoytN,fbPkOYLVPtPgIt0MxizjfFJov3JbHyAi,12,15,12,0,9,9,7,0,52,7.428571428571429,3,0.0,0,12,0,9,15,9,0,7,0,21,31,1
2903,44061,YnLmtd3JRb0zimQpfWrFNcrwemvknDW5,fbPkOYLVPtPgIt0MxizjfFJov3JbHyAi,2,0,0,0,0,0,4,0,4,0.5714285714285714,1,0.0,0,0,0,0,0,0,0,4,0,0,4,1
2904,44064,sclpC2Q9gGuchXaYOn9jBhR0HTWTR3aT,fbPkOYLVPtPgIt0MxizjfFJov3JbHyAi,2,0,0,0,0,0,2,0,2,0.2857142857142857,1,0.0,0,0,0,0,0,0,0,2,0,0,2,1
2905,44065,MdDhGnwj5ASXKbZjKBE4rTINrZJxZKmf,fbPkOYLVPtPgIt0MxizjfFJov3JbHyAi,5,3,1,0,1,0,1,0,6,0.8571428571428571,1,0.0,0,1,0,1,3,0,0,1,0,2,4,1
2906,44066,YRnTGuoAQA7UM3uV59YNXUYN4n1CR9jv,fbPkOYLVPtPgIt0MxizjfFJov3JbHyAi,5,2,1,0,1,2,3,0,9,1.2857142857142858,1,0.0,0,1,0,1,2,2,0,3,0,2,7,1
2907,44067,j8RhTJjYDyhhJwKuX9dEaH9i8I1ldsXI,fbPkOYLVPtPgIt0MxizjfFJov3JbHyAi,6,1,1,0,1,0,5,0,8,1.1428571428571428,1,0.0,0,1,0,1,1,0,0,5,0,2,6,1
2908,44068,L5YuT98afVAOrSauv1O87vabcuU5P3FK,fbPkOYLVPtPgIt0MxizjfFJov3JbHyAi,9,6,4,0,4,15,4,0,33,4.714285714285714,2,0.0,1,4,0,4,5,15,0,4,0,9,24,1
2909,44073,IvyZt31HCtjMQMuaWC4jdk1sB0Xv7ntN,fbPkOYLVPtPgIt0MxizjfFJov3JbHyAi,2,0,0,0,0,0,2,0,2,0.2857142857142857,1,0.0,0,0,0,0,0,0,0,2,0,0,2,1
2910,44074,2ZTBzb1Y4dwuOwNiUUSWB6SyHlRXxNso,fbPkOYLVPtPgIt0MxizjfFJov3JbHyAi,7,8,6,0,5,3,2,0,24,3.4285714285714284,2,0.0,0,6,0,5,8,3,0,2,0,11,13,1
2911,44075,igbWLwpgdT3vH8N8WUDj5bw0PNuf5yJu,fbPkOYLVPtPgIt0MxizjfFJov3JbHyAi,5,0,0,0,0,1,10,1,12,1.7142857142857142,1,0.0,0,0,0,0,0,1,0,10,1,0,12,1
2912,44077,O8WpIn8YZlC9fwaPz6HgwkG3VYK9Pnk2,fbPkOYLVPtPgIt0MxizjfFJov3JbHyAi,42,48,32,37,21,13,12,1,164,23.428571428571427,2,0.0,10,32,31,21,38,13,6,12,1,94,70,1
2913,44078,QR9tTgqPj604qYCY9eaTIBAzrFpNWrLy,fbPkOYLVPtPgIt0MxizjfFJov3JbHyAi,11,22,7,8,11,0,7,0,55,7.857142857142857,1,0.0,10,7,6,11,12,0,2,7,0,34,21,1
2914,44080,bheLkhWEWGgBqIkahX9VmPOuI7dx9l0C,fbPkOYLVPtPgIt0MxizjfFJov3JbHyAi,8,3,2,0,2,0,4,0,11,1.5714285714285714,1,0.0,0,2,0,2,3,0,0,4,0,4,7,1
2915,44082,YzWgrkJXzobheYWSTdIFQuZL9QRQEEwo,fbPkOYLVPtPgIt0MxizjfFJov3JbHyAi,15,19,8,0,7,9,18,2,63,9.0,4,0.0,0,8,0,7,19,9,0,18,2,15,48,1
2916,44085,k3g7vGyejcBHPAYTerpXAPXP3aDlXECc,fbPkOYLVPtPgIt0MxizjfFJov3JbHyAi,12,13,5,4,5,0,4,0,31,4.428571428571429,2,0.0,3,5,3,5,10,0,1,4,0,16,15,1
2917,44086,RdUl2sUA9mfz6RQdwlY0IjEO1TB3V6He,fbPkOYLVPtPgIt0MxizjfFJov3JbHyAi,5,3,1,0,1,6,5,0,16,2.2857142857142856,1,0.0,0,1,0,1,3,6,0,5,0,2,14,1
2918,44087,lFoBW5pwyNxgkXXOh07oCGiEJfc9EI9m,fbPkOYLVPtPgIt0MxizjfFJov3JbHyAi,12,4,4,0,4,0,14,0,26,3.7142857142857144,1,0.0,0,4,0,4,4,0,0,14,0,8,18,1
2919,44088,lROQAiXdM7cGoWUW60LyDcyoBjMP9r3o,fbPkOYLVPtPgIt0MxizjfFJov3JbHyAi,3,2,0,0,0,0,1,0,3,0.42857142857142855,1,0.0,0,0,0,0,2,0,0,1,0,0,3,1
2920,44089,No6TsyszmhFBqFzsKXtnzkYT0Jt4BFGw,fbPkOYLVPtPgIt0MxizjfFJov3JbHyAi,25,60,30,18,22,45,16,9,200,28.571428571428573,4,0.0,18,30,14,22,42,45,4,16,9,84,116,0
2921,44090,8nAPL0mPQAW1c0oKz3Cmzoe0fblYTaaz,fbPkOYLVPtPgIt0MxizjfFJov3JbHyAi,8,6,4,0,3,0,4,0,17,2.4285714285714284,2,0.0,0,4,0,3,6,0,0,4,0,7,10,1
2922,44091,UzZPsoX0fPCsbykjSOoJQOmAIToD9VOQ,fbPkOYLVPtPgIt0MxizjfFJov3JbHyAi,4,2,1,0,1,0,1,0,5,0.7142857142857143,1,0.0,0,1,0,1,2,0,0,1,0,2,3,1
2923,44092,sLiNYOqDfBlMo7O3bGWUzk1xVOtexeDN,fbPkOYLVPtPgIt0MxizjfFJov3JbHyAi,6,3,2,0,2,0,1,0,8,1.1428571428571428,1,0.0,0,2,0,2,3,0,0,1,0,4,4,1
2924,44094,Y5EybULOrY5dAmMMQWE7bK5wg4bsR2Lr,fbPkOYLVPtPgIt0MxizjfFJov3JbHyAi,19,28,15,2,7,0,8,0,60,8.571428571428571,3,0.0,2,15,2,7,26,0,0,8,0,26,34,1
2925,44096,MvkVXPKImqjQobZ7zCJXq4GfQ4IthLq9,fbPkOYLVPtPgIt0MxizjfFJov3JbHyAi,7,2,1,0,1,0,6,1,11,1.5714285714285714,1,0.0,0,1,0,1,2,0,0,6,1,2,9,1
2926,44098,XMrYl2ASKmtprKkSXb8ccJGHLdsrFHJk,fbPkOYLVPtPgIt0MxizjfFJov3JbHyAi,5,0,0,0,0,4,10,1,15,2.142857142857143,1,0.0,0,0,0,0,0,4,0,10,1,0,15,1
2927,44099,ZD3ToNRRIcmCEA8K3LVmNsFQ0Leu0MkF,fbPkOYLVPtPgIt0MxizjfFJov3JbHyAi,7,3,2,0,2,0,4,0,11,1.5714285714285714,1,0.0,0,2,0,2,3,0,0,4,0,4,7,1
2928,44100,ANJ7A7TrnpRJsv1mG7Zq08b8gsBzPJqI,fbPkOYLVPtPgIt0MxizjfFJov3JbHyAi,9,18,11,2,6,22,9,0,68,9.714285714285714,2,0.0,2,11,2,6,16,22,0,9,0,21,47,1
2929,44101,VwVgSiouEmdKXwssd2MCisWFwFtWB9Im,fbPkOYLVPtPgIt0MxizjfFJov3JbHyAi,1,0,0,0,0,0,1,0,1,0.14285714285714285,1,0.0,0,0,0,0,0,0,0,1,0,0,1,1
2930,44103,A7lXg14ZXc0SEgbl8pEzN5LJNLnibxLn,fbPkOYLVPtPgIt0MxizjfFJov3JbHyAi,4,0,0,0,0,1,9,0,10,1.4285714285714286,1,0.0,0,0,0,0,0,1,0,9,0,0,10,1
2931,44104,v6ULfJ1wWpantgoVZXel0J0DDCWEkouX,fbPkOYLVPtPgIt0MxizjfFJov3JbHyAi,7,2,1,0,1,0,5,0,9,1.2857142857142858,1,0.0,0,1,0,1,2,0,0,5,0,2,7,1
2932,44105,LmCwIRpUqSmmlWIBPK14fUA8Auzaletz,fbPkOYLVPtPgIt0MxizjfFJov3JbHyAi,8,10,5,0,4,5,7,0,31,4.428571428571429,2,0.0,2,5,0,4,8,5,0,7,0,11,20,1
2933,44106,futHw5ylJYoore6oNuefdx05Xc1Es6E8,fbPkOYLVPtPgIt0MxizjfFJov3JbHyAi,17,51,19,4,13,1,8,0,96,13.714285714285714,6,0.0,7,19,4,13,44,1,0,8,0,43,53,1
2934,44107,671RbTfA5jsL1XLdOXGDRlUV35MrYEo2,fbPkOYLVPtPgIt0MxizjfFJov3JbHyAi,2,0,0,0,0,0,5,0,5,0.7142857142857143,1,0.0,0,0,0,0,0,0,0,5,0,0,5,1
2935,44108,05K9eYg3CyRfEGjA2jN84Kisnns0xWMm,fbPkOYLVPtPgIt0MxizjfFJov3JbHyAi,9,6,3,0,4,0,4,0,17,2.4285714285714284,1,0.0,2,3,0,4,4,0,0,4,0,9,8,1
2936,44109,2yhMB5G7BP9mjaTBhgm2Ob8NSOmIWTch,fbPkOYLVPtPgIt0MxizjfFJov3JbHyAi,5,2,1,0,1,6,4,0,14,2.0,1,0.0,0,1,0,1,2,6,0,4,0,2,12,1
2937,44110,e4cZqrYucFu6WeO5quZuqBqXvsVJ1X82,fbPkOYLVPtPgIt0MxizjfFJov3JbHyAi,4,2,1,0,1,2,1,0,7,1.0,1,0.0,0,1,0,1,2,2,0,1,0,2,5,1
2938,44113,2X7VWDc6h4sEfr5aWwtNfHXgmbohmuZY,fbPkOYLVPtPgIt0MxizjfFJov3JbHyAi,8,3,2,0,2,0,5,0,12,1.7142857142857142,1,0.0,0,2,0,2,3,0,0,5,0,4,8,1
2939,44114,Hnsg2RdEy94EzQKO2WfhQn1bhDkIZpuP,fbPkOYLVPtPgIt0MxizjfFJov3JbHyAi,16,63,34,0,10,26,20,3,156,22.285714285714285,7,0.0,8,34,0,10,55,26,0,20,3,52,104,1
2940,44116,6A60zadtj8FKi84VaMeYcSvKWRtVJvs6,fbPkOYLVPtPgIt0MxizjfFJov3JbHyAi,6,9,0,0,0,12,6,0,27,3.857142857142857,1,0.0,2,0,0,0,7,12,0,6,0,2,25,1
2941,44117,0MmMvk8S1ad0tMPIPxO3E9ZWoQTH5ohX,fbPkOYLVPtPgIt0MxizjfFJov3JbHyAi,7,5,2,0,2,0,7,0,16,2.2857142857142856,1,0.0,2,2,0,2,3,0,0,7,0,6,10,1
2942,44120,FTBGY79AZl1FhUSv46TguNvaQwPqRnW0,fbPkOYLVPtPgIt0MxizjfFJov3JbHyAi,6,8,4,0,1,7,3,0,23,3.2857142857142856,2,0.0,0,4,0,1,8,7,0,3,0,5,18,1
2943,44121,6adUsSvPO0BlKLyJ63pGCXpdZbbHOrC1,fbPkOYLVPtPgIt0MxizjfFJov3JbHyAi,7,3,2,0,2,0,3,0,10,1.4285714285714286,1,0.0,0,2,0,2,3,0,0,3,0,4,6,1
2944,44124,YDpcKYv6zEDbgKCrCZaLRWDXdGnmbBrJ,fbPkOYLVPtPgIt0MxizjfFJov3JbHyAi,7,3,2,0,2,1,2,0,10,1.4285714285714286,1,0.0,0,2,0,2,3,1,0,2,0,4,6,1
2945,44125,S0Ddt9YO0WoRWUIwBGA5TdHpdcYScp4i,fbPkOYLVPtPgIt0MxizjfFJov3JbHyAi,2,0,0,0,0,0,4,0,4,0.5714285714285714,1,0.0,0,0,0,0,0,0,0,4,0,0,4,1
2946,44126,tp8q2FaFgEZoEyMd2w4a4ElJA60aVpjU,fbPkOYLVPtPgIt0MxizjfFJov3JbHyAi,8,4,2,0,2,1,5,0,14,2.0,1,0.0,1,2,0,2,3,1,0,5,0,5,9,1
2947,44127,uE45A9X1ub2amdi5pgtNBuPUXW1OngP4,fbPkOYLVPtPgIt0MxizjfFJov3JbHyAi,8,7,4,0,2,25,8,1,47,6.714285714285714,3,0.0,0,4,0,2,7,25,0,8,1,6,41,1
2948,44128,V1LvU1c7E3PIUZFRN6WpF3BM13fnjgNE,fbPkOYLVPtPgIt0MxizjfFJov3JbHyAi,1,0,0,0,0,0,1,0,1,0.14285714285714285,1,0.0,0,0,0,0,0,0,0,1,0,0,1,1
2949,44129,p1XbGfxeaI6DleJXE743W1CITQmkaVh6,fbPkOYLVPtPgIt0MxizjfFJov3JbHyAi,20,29,15,0,11,41,8,1,105,15.0,2,0.0,6,15,0,11,23,41,0,8,1,32,73,1
2950,44130,aldLXGpzmiip2CUSDhqN8A5UpGMVUHxY,fbPkOYLVPtPgIt0MxizjfFJov3JbHyAi,7,6,3,0,2,0,2,0,13,1.8571428571428572,2,0.0,1,3,0,2,5,0,0,2,0,6,7,1
2951,44132,zFnB514y0Q6xzKQdlkyv2Oz7aEiEsfcU,fbPkOYLVPtPgIt0MxizjfFJov3JbHyAi,11,3,3,0,3,0,10,1,20,2.857142857142857,1,0.0,0,3,0,3,3,0,0,10,1,6,14,1
2952,44136,BF0qnZaKn6rKWwFuVZZ6evM5Lwl2Cgas,fbPkOYLVPtPgIt0MxizjfFJov3JbHyAi,9,5,3,0,3,31,8,1,51,7.285714285714286,1,0.0,1,3,0,3,4,31,0,8,1,7,44,1
2953,44137,2UpfysYIIWrRQes9MePdZN0xiR2zRHJz,fbPkOYLVPtPgIt0MxizjfFJov3JbHyAi,8,6,3,0,2,0,2,0,13,1.8571428571428572,1,0.0,0,3,0,2,6,0,0,2,0,5,8,1
2954,44138,3xpaESbMVIacFbBBinGWFh7uTUaRebCC,fbPkOYLVPtPgIt0MxizjfFJov3JbHyAi,7,5,3,0,1,0,3,0,12,1.7142857142857142,2,0.0,0,3,0,1,5,0,0,3,0,4,8,1
2955,44140,MmriHcroMe075aYWrI4hc7SygXVasdbB,fbPkOYLVPtPgIt0MxizjfFJov3JbHyAi,7,7,5,0,4,2,2,0,20,2.857142857142857,1,0.0,0,5,0,4,7,2,0,2,0,9,11,1
2956,44142,VT4lg4rYLuaybdJw72lJCTs81gBgRRBg,fbPkOYLVPtPgIt0MxizjfFJov3JbHyAi,26,121,61,23,38,68,33,3,347,49.57142857142857,9,0.0,36,61,18,38,85,68,5,33,3,153,194,1
2957,44143,J9FSUo4laXGBW66T35Zr5CFe56ZdTJTQ,fbPkOYLVPtPgIt0MxizjfFJov3JbHyAi,9,6,3,0,4,3,4,0,20,2.857142857142857,1,0.0,2,3,0,4,4,3,0,4,0,9,11,1
2958,44145,niLMw8MCObO7SSR2V1jNg9WQt5oSjDFJ,fbPkOYLVPtPgIt0MxizjfFJov3JbHyAi,6,7,3,0,2,2,2,0,16,2.2857142857142856,1,0.0,2,3,0,2,5,2,0,2,0,7,9,1
2959,44146,NiOuJ51IxTtojHMts8OdX2AfCH09G7vK,fbPkOYLVPtPgIt0MxizjfFJov3JbHyAi,8,5,2,0,2,11,5,1,26,3.7142857142857144,1,0.0,0,2,0,2,5,11,0,5,1,4,22,1
2960,44147,zeUi2UnQZPPF6bRQXw2s8LZ41ZOdqRAa,fbPkOYLVPtPgIt0MxizjfFJov3JbHyAi,5,2,1,0,1,5,4,0,13,1.8571428571428572,1,0.0,0,1,0,1,2,5,0,4,0,2,11,1
2961,44149,W7N7he2GGE1A2J3fJvsUdwOZI9P4besV,fbPkOYLVPtPgIt0MxizjfFJov3JbHyAi,16,50,13,3,11,0,6,0,83,11.857142857142858,2,0.0,18,13,3,11,32,0,0,6,0,45,38,1
2962,44150,1OCnfEluJ5C06UYF5oIawyvraf5cATWk,fbPkOYLVPtPgIt0MxizjfFJov3JbHyAi,12,9,3,4,5,0,3,0,24,3.4285714285714284,1,0.0,4,3,3,5,5,0,1,3,0,15,9,1
2963,44153,mZ7ilucqUFwey1NwU92PRXQQ0HeHtWmh,fbPkOYLVPtPgIt0MxizjfFJov3JbHyAi,7,4,3,0,3,0,3,0,13,1.8571428571428572,1,0.0,0,3,0,3,4,0,0,3,0,6,7,1
2964,44154,wJViEDKJG9cycqokQxxOomq0g3hb2X0n,fbPkOYLVPtPgIt0MxizjfFJov3JbHyAi,1,0,0,0,0,0,1,0,1,0.14285714285714285,1,0.0,0,0,0,0,0,0,0,1,0,0,1,1
2965,44156,2fI4wWrvurl3ODzFoF1kViu5y8Lc1NgZ,fbPkOYLVPtPgIt0MxizjfFJov3JbHyAi,5,3,1,0,1,10,2,0,17,2.4285714285714284,1,0.0,0,1,0,1,3,10,0,2,0,2,15,1
2966,44157,ScslB7DNmqv4WEnDOYxGnluFKACqdrbs,fbPkOYLVPtPgIt0MxizjfFJov3JbHyAi,13,18,7,1,8,0,9,2,45,6.428571428571429,2,0.0,7,7,1,8,11,0,0,9,2,23,22,1
2967,44158,KBAguIZfF7JFxQgNwhhTOV2JtOxu7CHH,fbPkOYLVPtPgIt0MxizjfFJov3JbHyAi,8,9,4,0,3,0,4,0,20,2.857142857142857,2,0.0,2,4,0,3,7,0,0,4,0,9,11,1
2968,44160,gHeXtpmuyccgWbGT5QiAuKlFydUbHDzc,fbPkOYLVPtPgIt0MxizjfFJov3JbHyAi,5,4,2,0,1,0,2,0,9,1.2857142857142858,2,0.0,0,2,0,1,4,0,0,2,0,3,6,1
2969,44162,Lyagkt8Tl6Y9546SuIOdZylzB0VpBr47,fbPkOYLVPtPgIt0MxizjfFJov3JbHyAi,2,0,0,0,0,0,8,0,8,1.1428571428571428,1,0.0,0,0,0,0,0,0,0,8,0,0,8,1
2970,44164,WLc3nzeMA1m785zH4gOIVyKG8qieUOwG,fbPkOYLVPtPgIt0MxizjfFJov3JbHyAi,4,2,1,0,1,0,2,0,6,0.8571428571428571,1,0.0,0,1,0,1,2,0,0,2,0,2,4,1
2971,44166,zLQK4qXkDKq3GVHuvnA5ZgyIevHVQUHp,fbPkOYLVPtPgIt0MxizjfFJov3JbHyAi,14,17,8,0,5,0,4,1,35,5.0,1,0.0,0,8,0,5,17,0,0,4,1,13,22,1
2972,44167,aXGAxVHU5aDLZJJ1gHpvXefHkIbw92yB,fbPkOYLVPtPgIt0MxizjfFJov3JbHyAi,18,11,8,0,7,18,8,1,53,7.571428571428571,1,0.0,1,8,0,7,10,18,0,8,1,16,37,1
2973,44171,JhiJnBpiVfW8JCO4BrjAwx4ywoZHB71f,fbPkOYLVPtPgIt0MxizjfFJov3JbHyAi,7,8,3,0,2,0,3,0,16,2.2857142857142856,1,0.0,0,3,0,2,8,0,0,3,0,5,11,1
2974,44172,SvI7NjkOF6DOPWLRc1U4XOWjW6ht1V3M,fbPkOYLVPtPgIt0MxizjfFJov3JbHyAi,2,0,0,0,0,0,5,0,5,0.7142857142857143,1,0.0,0,0,0,0,0,0,0,5,0,0,5,1
2975,44174,kr9MhAzeae0UKmOp6QSbcSIPAfRDBwyS,fbPkOYLVPtPgIt0MxizjfFJov3JbHyAi,17,30,12,3,10,32,10,0,97,13.857142857142858,3,0.0,12,12,3,10,18,32,0,10,0,37,60,1
2976,44175,58HxGhVJCkPf0xNzljCqWpiXdfJMiEDw,fbPkOYLVPtPgIt0MxizjfFJov3JbHyAi,8,2,2,0,2,0,6,0,12,1.7142857142857142,1,0.0,0,2,0,2,2,0,0,6,0,4,8,1
2977,44178,ZUj8ciewoY1krerme1rA06bZgMQzwUwF,fbPkOYLVPtPgIt0MxizjfFJov3JbHyAi,9,13,6,0,3,10,5,1,38,5.428571428571429,2,0.0,1,6,0,3,12,10,0,5,1,10,28,0
2978,44179,KybJTS3fr0HyrDCaccrgyo0RzMzG0qom,fbPkOYLVPtPgIt0MxizjfFJov3JbHyAi,2,0,0,0,0,0,4,0,4,0.5714285714285714,1,0.0,0,0,0,0,0,0,0,4,0,0,4,1
2979,44181,ZPamISIdPsbqsq6aVqRDFzUi3IlRadjg,fbPkOYLVPtPgIt0MxizjfFJov3JbHyAi,12,12,6,0,4,16,8,1,47,6.714285714285714,2,0.0,0,6,0,4,12,16,0,8,1,10,37,1
2980,44182,sn2EpOZocGCK2n6oyJ74BVfoIYZKGwBK,fbPkOYLVPtPgIt0MxizjfFJov3JbHyAi,9,15,0,10,3,11,10,0,49,7.0,1,0.0,10,0,7,3,5,11,3,10,0,20,29,1
2981,44184,UsLFN9dzLo3sTXf5tfNoi18KyZHWYRsB,fbPkOYLVPtPgIt0MxizjfFJov3JbHyAi,22,35,16,16,19,5,3,0,94,13.428571428571429,2,0.0,17,16,13,19,18,5,3,3,0,65,29,1
2982,44185,tcFBEkXakkuMK1VljJZtgKVBO9EsakN0,fbPkOYLVPtPgIt0MxizjfFJov3JbHyAi,1,0,0,0,0,0,1,0,1,0.14285714285714285,1,0.0,0,0,0,0,0,0,0,1,0,0,1,1
2983,44186,mJ5BZ6EJA3wLg8jbGMObtpjRK8yspzI5,fbPkOYLVPtPgIt0MxizjfFJov3JbHyAi,39,43,20,34,15,46,12,1,171,24.428571428571427,2,0.0,16,20,28,15,27,46,6,12,1,79,92,1
2984,44187,i7yYKzmNeDNpl7ZXyamysycDjJWbLntm,fbPkOYLVPtPgIt0MxizjfFJov3JbHyAi,11,19,4,7,9,4,5,0,48,6.857142857142857,1,0.0,14,4,6,9,5,4,1,5,0,33,15,1
2985,44188,yFk2LSMib4DE4CR8Gt7OigYN8UE5SERE,fbPkOYLVPtPgIt0MxizjfFJov3JbHyAi,6,5,3,0,1,0,4,0,13,1.8571428571428572,3,0.0,0,3,0,1,5,0,0,4,0,4,9,1
2986,44193,5olZBiEN7fREGvXjZsAPA34LD7TNv2Om,fbPkOYLVPtPgIt0MxizjfFJov3JbHyAi,9,12,3,0,3,11,7,0,36,5.142857142857143,1,0.0,0,3,0,3,12,11,0,7,0,6,30,1
2987,44194,nkWrffpo6kobU01lUWepcu6aQb60BdxH,fbPkOYLVPtPgIt0MxizjfFJov3JbHyAi,43,66,31,18,20,34,14,1,184,26.285714285714285,7,0.0,20,31,17,20,46,34,1,14,1,88,96,0
2988,44195,rQ7jrT4jqfVvIwV7TCyxKklrYfaXz5qx,fbPkOYLVPtPgIt0MxizjfFJov3JbHyAi,6,7,4,0,2,7,4,0,24,3.4285714285714284,1,0.0,0,4,0,2,7,7,0,4,0,6,18,1
2989,44196,cXbVpSHehoFAcD5jvifZg4hoGlmfKlx5,fbPkOYLVPtPgIt0MxizjfFJov3JbHyAi,3,3,1,0,0,0,1,0,5,0.7142857142857143,1,0.0,0,1,0,0,3,0,0,1,0,1,4,0
2990,44201,bGSf4Dv41LrPDFgbxGTmHZXMfhKccKJy,fbPkOYLVPtPgIt0MxizjfFJov3JbHyAi,8,4,3,0,3,0,2,0,12,1.7142857142857142,2,0.0,0,3,0,3,4,0,0,2,0,6,6,1
2991,44202,UvmsOyeKqNqdnoWuF67HYRoCd5vZCTT3,fbPkOYLVPtPgIt0MxizjfFJov3JbHyAi,4,2,0,0,0,0,10,0,12,1.7142857142857142,2,0.0,0,0,0,0,2,0,0,10,0,0,12,1
2992,44203,4cRZxyVNjv13lU3nu2aK2rwyndExVCGa,fbPkOYLVPtPgIt0MxizjfFJov3JbHyAi,24,36,22,23,11,10,7,0,109,15.571428571428571,5,0.0,6,22,17,11,30,10,6,7,0,56,53,1
2993,44208,9nBDwXR4PojGZeJgF10uxjH1va7sf1sb,fbPkOYLVPtPgIt0MxizjfFJov3JbHyAi,5,3,1,0,1,0,7,0,12,1.7142857142857142,1,0.0,0,1,0,1,3,0,0,7,0,2,10,1
2994,44209,XZNYPNX0OVSTYmnVJQK9QQliGDqh1neQ,fbPkOYLVPtPgIt0MxizjfFJov3JbHyAi,5,8,3,0,0,0,7,0,18,2.5714285714285716,1,0.0,3,3,0,0,5,0,0,7,0,6,12,1
2995,44212,lMefkcgNh5NMvOXiUOkNuemhw07vFq2i,fbPkOYLVPtPgIt0MxizjfFJov3JbHyAi,6,4,2,0,1,6,5,0,18,2.5714285714285716,1,0.0,0,2,0,1,4,6,0,5,0,3,15,1
2996,44213,lR39Ca78D0WrhfXRqUEM5XEFow5I5VmV,fbPkOYLVPtPgIt0MxizjfFJov3JbHyAi,10,11,4,0,4,0,3,0,22,3.142857142857143,1,0.0,5,4,0,4,6,0,0,3,0,13,9,1
2997,44215,zLhYaUkalf3cJa8yuQ4GA08EdlJo6KYR,fbPkOYLVPtPgIt0MxizjfFJov3JbHyAi,2,0,0,0,0,0,2,0,2,0.2857142857142857,1,0.0,0,0,0,0,0,0,0,2,0,0,2,1
2998,44216,398KUlAbQAJq86al7WBicOZ2ToPIvKyy,fbPkOYLVPtPgIt0MxizjfFJov3JbHyAi,5,2,1,0,1,0,3,0,7,1.0,1,0.0,0,1,0,1,2,0,0,3,0,2,5,1
2999,44217,DwhbrQEsdQ584Yt1VsJhxkmyn6wsMQlr,fbPkOYLVPtPgIt0MxizjfFJov3JbHyAi,9,5,3,4,3,0,1,0,16,2.2857142857142856,1,0.0,1,3,3,3,4,0,1,1,0,10,6,1
3000,44219,Ur8i7WXZlexxp5KjJw4MNXxBOiEFRmEq,fbPkOYLVPtPgIt0MxizjfFJov3JbHyAi,12,4,4,0,4,0,3,0,15,2.142857142857143,2,0.0,0,4,0,4,4,0,0,3,0,8,7,1
3001,44225,9asMsoidPaReetlZL7sWsBgxvGgFunIW,fbPkOYLVPtPgIt0MxizjfFJov3JbHyAi,7,7,2,0,3,0,5,0,17,2.4285714285714284,1,0.0,2,2,0,3,5,0,0,5,0,7,10,1
3002,44227,W3EB1elPrDjFWV4QIzuswTukmjxtHb6Z,fbPkOYLVPtPgIt0MxizjfFJov3JbHyAi,5,2,0,0,1,0,2,0,5,0.7142857142857143,1,0.0,0,0,0,1,2,0,0,2,0,1,4,1
3003,44228,R1FqqBKIoe5gb1Zm4cRd6C2dKym4oN3J,fbPkOYLVPtPgIt0MxizjfFJov3JbHyAi,4,3,1,0,1,0,1,0,6,0.8571428571428571,1,0.0,0,1,0,1,3,0,0,1,0,2,4,0
3004,44229,xDQR9jsrXbDdyr5ix2doPKar2TBbunBq,fbPkOYLVPtPgIt0MxizjfFJov3JbHyAi,8,8,4,0,3,19,4,1,39,5.571428571428571,1,0.0,0,4,0,3,8,19,0,4,1,7,32,1
3005,44230,Ijb9fKceIgYIt7UF8znubY4lpG9MvHfC,fbPkOYLVPtPgIt0MxizjfFJov3JbHyAi,4,2,1,0,1,0,1,0,5,0.7142857142857143,1,0.0,0,1,0,1,2,0,0,1,0,2,3,1
3006,44232,VvFmHqJuverkRg9SOJfO7EAhSTYwhk8R,fbPkOYLVPtPgIt0MxizjfFJov3JbHyAi,1,0,0,0,0,0,2,0,2,0.2857142857142857,1,0.0,0,0,0,0,0,0,0,2,0,0,2,1
3007,44233,wm9IrPuDWolACPuibTN3CpCrRGsa74ef,fbPkOYLVPtPgIt0MxizjfFJov3JbHyAi,19,8,7,0,7,0,19,1,42,6.0,1,0.0,0,7,0,7,8,0,0,19,1,14,28,1
3008,44236,jagu0OJDhWTGFhfCMk0ghqluLpW3kzdC,fbPkOYLVPtPgIt0MxizjfFJov3JbHyAi,34,46,24,26,20,44,23,5,188,26.857142857142858,4,0.0,14,24,20,20,32,44,6,23,5,78,110,0
3009,44237,5wfiCJMdbkN7MkoUGvo3cfz8jV3jCktA,fbPkOYLVPtPgIt0MxizjfFJov3JbHyAi,6,4,2,0,1,11,4,0,22,3.142857142857143,2,0.0,0,2,0,1,4,11,0,4,0,3,19,1
3010,44239,0rBpfipIkPUXXv4992tUqetb5IpoweSC,fbPkOYLVPtPgIt0MxizjfFJov3JbHyAi,7,3,2,0,2,0,2,0,9,1.2857142857142858,1,0.0,0,2,0,2,3,0,0,2,0,4,5,1
3011,44240,OrcJP9YaqKO2WfXtlTi3GWMyG2WCYDrA,fbPkOYLVPtPgIt0MxizjfFJov3JbHyAi,7,3,2,0,2,0,4,0,11,1.5714285714285714,1,0.0,0,2,0,2,3,0,0,4,0,4,7,1
3012,44242,QYVRHTpooyTkzSbIywJ7ri5o4t73Xwty,fbPkOYLVPtPgIt0MxizjfFJov3JbHyAi,7,11,5,0,2,6,6,3,33,4.714285714285714,2,0.0,0,5,0,2,11,6,0,6,3,7,26,1
3013,44243,RR8icbJjkYOdUrylwRxkzCL89mNBS1kQ,fbPkOYLVPtPgIt0MxizjfFJov3JbHyAi,7,5,2,0,2,0,6,0,15,2.142857142857143,1,0.0,2,2,0,2,3,0,0,6,0,6,9,1
3014,44244,g2zZYnTJ1Pk3cSjsVP5SH4UjJdsbDJv7,fbPkOYLVPtPgIt0MxizjfFJov3JbHyAi,28,36,20,22,15,13,9,1,116,16.571428571428573,3,0.0,11,20,17,15,25,13,5,9,1,63,53,0
3015,44248,K1umGIzxZInQChRQpf7KLIJB3rfPL8P3,fbPkOYLVPtPgIt0MxizjfFJov3JbHyAi,7,6,4,0,2,2,1,0,15,2.142857142857143,1,0.0,0,4,0,2,6,2,0,1,0,6,9,1
3016,44251,vFF7Q9hHOJ6qa16cDuF7JSSiOD7EEEuA,fbPkOYLVPtPgIt0MxizjfFJov3JbHyAi,2,0,0,0,0,0,2,0,2,0.2857142857142857,1,0.0,0,0,0,0,0,0,0,2,0,0,2,1
3017,44252,ly2UupZqGwkAeluSmrnRPVaNBG5zI6oB,fbPkOYLVPtPgIt0MxizjfFJov3JbHyAi,10,3,3,0,3,0,3,0,12,1.7142857142857142,1,0.0,0,3,0,3,3,0,0,3,0,6,6,1
3018,44253,ZV7o5798W7XrprHpNhvS0Cr1EgwiSgHZ,fbPkOYLVPtPgIt0MxizjfFJov3JbHyAi,10,11,5,0,4,17,8,0,45,6.428571428571429,2,0.0,3,5,0,4,8,17,0,8,0,12,33,1
3019,44256,bJOkL9U6IOy2ICy3FtWSfPLY5BHrDaNn,fbPkOYLVPtPgIt0MxizjfFJov3JbHyAi,19,19,11,2,8,1,8,0,49,7.0,3,0.0,1,11,2,8,18,1,0,8,0,22,27,1
3020,44257,QyPU5c4UNqLLtktJRpwU2AioPifGtMTU,fbPkOYLVPtPgIt0MxizjfFJov3JbHyAi,5,3,1,0,1,0,5,0,10,1.4285714285714286,1,0.0,0,1,0,1,3,0,0,5,0,2,8,1
3021,44258,mV7oUFoQV8UaUytbbGy8dq3Lp45sMej3,fbPkOYLVPtPgIt0MxizjfFJov3JbHyAi,5,2,1,0,1,0,3,0,7,1.0,1,0.0,0,1,0,1,2,0,0,3,0,2,5,1
3022,44260,fTY7PbFNeV0B3b5XiSuBQtOgneGDS4iZ,fbPkOYLVPtPgIt0MxizjfFJov3JbHyAi,12,7,5,0,4,0,4,0,20,2.857142857142857,2,0.0,0,5,0,4,7,0,0,4,0,9,11,1
3023,44263,w7sOZdeQBox0eO8DVqyUKzi8avIzaYn4,fbPkOYLVPtPgIt0MxizjfFJov3JbHyAi,11,9,4,0,3,2,8,1,27,3.857142857142857,1,0.0,3,4,0,3,6,2,0,8,1,10,17,1
3024,44264,cA8JP9WlrRgRowgBnuouyPdSEGVSdPoU,fbPkOYLVPtPgIt0MxizjfFJov3JbHyAi,7,3,2,0,2,0,2,0,9,1.2857142857142858,1,0.0,0,2,0,2,3,0,0,2,0,4,5,1
3025,44265,beJ7nfPQcUdFyj8P1C0Vl4K57I6wCKrL,fbPkOYLVPtPgIt0MxizjfFJov3JbHyAi,7,8,5,0,3,0,3,1,20,2.857142857142857,1,0.0,0,5,0,3,8,0,0,3,1,8,12,1
3026,44267,r9kprGnmV8vKXI1tErs4EvgHZZ8IRF8I,fbPkOYLVPtPgIt0MxizjfFJov3JbHyAi,4,2,0,0,0,4,4,0,10,1.4285714285714286,1,0.0,0,0,0,0,2,4,0,4,0,0,10,1
3027,44270,GMzSpgZQ6jzVsfHn8W8i83JsYNxnP00b,fbPkOYLVPtPgIt0MxizjfFJov3JbHyAi,14,15,8,6,7,0,4,0,40,5.714285714285714,2,0.0,5,8,5,7,10,0,1,4,0,25,15,1
3028,44272,J3rwPgcYHKst1mTrkHfz6lTuHZtWbhHS,fbPkOYLVPtPgIt0MxizjfFJov3JbHyAi,6,5,3,0,3,0,1,0,12,1.7142857142857142,1,0.0,0,3,0,3,5,0,0,1,0,6,6,1
3029,44274,2qxdbGcKrOShnqwnQiXgdDAFvYPhSM6o,fbPkOYLVPtPgIt0MxizjfFJov3JbHyAi,9,7,5,0,4,0,4,0,20,2.857142857142857,2,0.0,0,5,0,4,7,0,0,4,0,9,11,1
3030,44275,KTCLrjyRw15OM6ZLS9kBfeLSSnS0pLeh,fbPkOYLVPtPgIt0MxizjfFJov3JbHyAi,10,11,8,0,4,3,15,2,43,6.142857142857143,2,0.0,0,8,0,4,11,3,0,15,2,12,31,1
3031,44277,chYWQx9p6mrqtOqnuZLINe1RPkFDRJYi,fbPkOYLVPtPgIt0MxizjfFJov3JbHyAi,10,11,5,0,4,1,15,1,37,5.285714285714286,1,0.0,2,5,0,4,9,1,0,15,1,11,26,1
3032,44279,tx4grxmlQgEoy6eADYfJTj1STA6T1B91,fbPkOYLVPtPgIt0MxizjfFJov3JbHyAi,4,2,1,0,1,0,1,0,5,0.7142857142857143,1,0.0,0,1,0,1,2,0,0,1,0,2,3,1
3033,44280,gIksIEwmEEV0Pn8wMtaqnzuIMor23skp,fbPkOYLVPtPgIt0MxizjfFJov3JbHyAi,12,17,4,2,2,14,19,1,59,8.428571428571429,3,0.0,3,4,2,2,14,14,0,19,1,11,48,1
3034,44282,bxc4zM194IAB8OgoL6kSDGRq4OX5TDtY,fbPkOYLVPtPgIt0MxizjfFJov3JbHyAi,10,12,7,0,3,10,6,1,39,5.571428571428571,2,0.0,2,7,0,3,10,10,0,6,1,12,27,1
3035,44283,57qzgJAwfROYPxzSOrsA3G5DLHP95ajU,fbPkOYLVPtPgIt0MxizjfFJov3JbHyAi,6,5,3,0,2,0,4,0,14,2.0,2,0.0,0,3,0,2,5,0,0,4,0,5,9,1
3036,44284,lAPXQuLP1yRNYGiTpu7dIeoZTMEKBA0b,fbPkOYLVPtPgIt0MxizjfFJov3JbHyAi,10,16,4,6,4,0,3,0,33,4.714285714285714,1,0.0,4,4,6,4,12,0,0,3,0,18,15,1
3037,44285,KMmrb4nTAt1m2OAaFtq8lztLT3NFO2Pb,fbPkOYLVPtPgIt0MxizjfFJov3JbHyAi,1,0,0,0,0,0,1,0,1,0.14285714285714285,1,0.0,0,0,0,0,0,0,0,1,0,0,1,1
3038,44286,Sw0laYN5mow6XiHfrWCJl4qnRcU0Nesb,fbPkOYLVPtPgIt0MxizjfFJov3JbHyAi,10,10,8,0,6,0,2,0,26,3.7142857142857144,2,0.0,0,8,0,6,10,0,0,2,0,14,12,1
3039,44287,DULOyOFZsLRkoNHg3me4lby4O9mlfTfP,fbPkOYLVPtPgIt0MxizjfFJov3JbHyAi,8,14,8,0,0,0,6,0,28,4.0,2,0.0,0,8,0,0,14,0,0,6,0,8,20,1
3040,44288,mSToVMacc08MhsUyEFn562K69bpANB3P,fbPkOYLVPtPgIt0MxizjfFJov3JbHyAi,6,3,1,0,1,0,2,0,7,1.0,2,0.0,0,1,0,1,3,0,0,2,0,2,5,1
3041,44289,Z8E1fWEz0b5y6BD6dlIVX2UJWlqxRpHR,fbPkOYLVPtPgIt0MxizjfFJov3JbHyAi,11,12,6,5,5,4,2,0,34,4.857142857142857,2,0.0,4,6,4,5,8,4,1,2,0,19,15,1
3042,44290,RdArNf6qPycx7nnXJK9MCRyymBwv75n3,fbPkOYLVPtPgIt0MxizjfFJov3JbHyAi,5,2,1,0,0,0,5,0,8,1.1428571428571428,1,0.0,0,1,0,0,2,0,0,5,0,1,7,1
3043,44291,wGwI5daC8SwOUE0hcVwwOwixSwocHFPs,fbPkOYLVPtPgIt0MxizjfFJov3JbHyAi,6,3,2,0,2,0,1,0,8,1.1428571428571428,1,0.0,0,2,0,2,3,0,0,1,0,4,4,1
3044,44295,ydIfB5lDuQMdwnqw1Trec6MMfLMb9KME,fbPkOYLVPtPgIt0MxizjfFJov3JbHyAi,5,9,0,0,1,2,2,0,14,2.0,1,0.0,3,0,0,1,6,2,0,2,0,4,10,1
3045,44296,SlxIPeu1dmMaJlW3478OT2sG7yUhXJL1,fbPkOYLVPtPgIt0MxizjfFJov3JbHyAi,2,0,0,0,0,0,5,0,5,0.7142857142857143,1,0.0,0,0,0,0,0,0,0,5,0,0,5,1
3046,44297,4LlDUfJVZRN4VGhz1cOPbu42ptFr0ItJ,fbPkOYLVPtPgIt0MxizjfFJov3JbHyAi,10,22,16,0,10,4,5,0,57,8.142857142857142,2,0.0,2,16,0,10,20,4,0,5,0,28,29,1
3047,44299,5uyWPVLiSthHYhSAJufLobkztuAqGghO,fbPkOYLVPtPgIt0MxizjfFJov3JbHyAi,12,39,13,8,14,10,6,0,90,12.857142857142858,4,0.0,15,13,5,14,24,10,3,6,0,47,43,1
3048,44302,OzkaXzIRl9kqXzCHMBKEBEDNw27l64vJ,fbPkOYLVPtPgIt0MxizjfFJov3JbHyAi,5,2,1,0,1,0,6,0,10,1.4285714285714286,1,0.0,0,1,0,1,2,0,0,6,0,2,8,1
3049,44303,6SFV3JbKdSV7hRZqshJPkaxQAde0a5lX,fbPkOYLVPtPgIt0MxizjfFJov3JbHyAi,6,2,1,0,1,2,5,1,12,1.7142857142857142,1,0.0,0,1,0,1,2,2,0,5,1,2,10,1
3050,44304,NqxqEj1F6iv4kBP9fZF1q6JwtPVhl0hk,fbPkOYLVPtPgIt0MxizjfFJov3JbHyAi,4,1,0,0,0,0,3,0,4,0.5714285714285714,1,0.0,0,0,0,0,1,0,0,3,0,0,4,1
3051,44306,GCwNBqpZSN8gReMgO4ZxJ7plXwWznnJn,fbPkOYLVPtPgIt0MxizjfFJov3JbHyAi,1,0,0,0,0,0,1,0,1,0.14285714285714285,1,0.0,0,0,0,0,0,0,0,1,0,0,1,1
3052,44308,hIXeM0yyb6wIxVNnB5ijRV2LpcYBbrLW,fbPkOYLVPtPgIt0MxizjfFJov3JbHyAi,5,8,1,0,1,0,2,0,12,1.7142857142857142,1,0.0,0,1,0,1,8,0,0,2,0,2,10,1
3053,45309,cvmNQvB8C9tzfr5JL4ScqNRXsUkWS0qq,RXDvfPUBYFlVdlueBFbLW0mhhAyGEqpt,55,166,112,65,14,147,62,5,571,81.57142857142857,4,0.0,16,112,50,14,150,147,15,62,5,192,379,0
3054,45312,JrU3mQXDsHM3JCMrGML8Gsd1f6KKBRz5,RXDvfPUBYFlVdlueBFbLW0mhhAyGEqpt,1,0,0,0,0,0,1,0,1,0.14285714285714285,1,0.0,0,0,0,0,0,0,0,1,0,0,1,1
3055,45316,KUdvYZYC6ZViW3z5eiAU2e6Me0VXEfY4,RXDvfPUBYFlVdlueBFbLW0mhhAyGEqpt,1,0,0,0,0,0,2,0,2,0.2857142857142857,1,0.0,0,0,0,0,0,0,0,2,0,0,2,1
3056,45327,oE1QbspE1VaPia0G9CbmnflG7dN6cZJM,G8EPVSXsOYB5YQWZGiz1aVq5Pgr2GrQu,8,7,4,0,0,0,4,1,16,2.2857142857142856,2,0.0,1,4,0,0,6,0,0,4,1,5,11,1
3057,45339,CladEfFLLomb4XABUtmNVPFfnjm4LhE2,RXDvfPUBYFlVdlueBFbLW0mhhAyGEqpt,44,86,2,135,10,6,13,0,252,36.0,2,0.0,37,2,122,10,49,6,13,13,0,171,81,0
3058,45340,Q57EC9WScoWjECRp7MT77bmBt9oZMVVG,RXDvfPUBYFlVdlueBFbLW0mhhAyGEqpt,51,109,61,64,12,367,155,28,796,113.71428571428571,12,0.0,18,61,51,12,91,367,13,155,28,142,654,0
3059,45366,4v506xwnN2gFG9XeSNIeiBlmXImooi1O,RXDvfPUBYFlVdlueBFbLW0mhhAyGEqpt,1,0,0,0,0,0,2,0,2,0.2857142857142857,1,0.0,0,0,0,0,0,0,0,2,0,0,2,0
3060,45384,zkzUmPQTrqnNy4aMEOpIupZNYtjTcR9O,G8EPVSXsOYB5YQWZGiz1aVq5Pgr2GrQu,1,0,0,0,0,0,1,0,1,0.14285714285714285,1,0.0,0,0,0,0,0,0,0,1,0,0,1,1
3061,45391,sUA9xXq2cjEIung0hBSUfP1uBxFNZSs5,G8EPVSXsOYB5YQWZGiz1aVq5Pgr2GrQu,17,11,5,24,3,3,8,1,55,7.857142857142857,3,0.0,1,5,20,3,10,3,4,8,1,29,26,1
3062,45402,1lu7qFlpJ7c77SdGrohS207VNZCEPQ2W,G8EPVSXsOYB5YQWZGiz1aVq5Pgr2GrQu,14,7,6,0,4,0,19,2,38,5.428571428571429,2,0.0,0,6,0,4,7,0,0,19,2,10,28,1
3063,45436,yX4GtBReTtJl8CLrRCBEP3vcJDxXoOOn,RXDvfPUBYFlVdlueBFbLW0mhhAyGEqpt,1,0,0,0,0,0,1,0,1,0.14285714285714285,1,0.0,0,0,0,0,0,0,0,1,0,0,1,1
3064,45466,E2SSacGkmDwMmCOVOXL29GviqMFLwc68,G8EPVSXsOYB5YQWZGiz1aVq5Pgr2GrQu,1,0,0,0,0,0,1,0,1,0.14285714285714285,1,0.0,0,0,0,0,0,0,0,1,0,0,1,1
3065,45483,5U9E0pnoyq8gJfR6llsPDT5KP7DSR7H8,G8EPVSXsOYB5YQWZGiz1aVq5Pgr2GrQu,1,0,0,0,0,0,1,0,1,0.14285714285714285,1,0.0,0,0,0,0,0,0,0,1,0,0,1,1
3066,45532,ZrIXM5h8t7QDXRvT8qPfGTwh0kjMYeoV,RXDvfPUBYFlVdlueBFbLW0mhhAyGEqpt,9,13,8,0,1,15,4,0,41,5.857142857142857,3,0.0,2,8,0,1,11,15,0,4,0,11,30,1
3067,45546,VMgv7OqkaBwITbfAg6B6mOmAS6m3C11w,G8EPVSXsOYB5YQWZGiz1aVq5Pgr2GrQu,18,21,1,60,0,0,2,0,84,12.0,2,0.0,10,1,44,0,11,0,16,2,0,55,29,1
3068,45611,f2dlkEjQnfiTH1JmGq8MzaHN9HyOSQno,RXDvfPUBYFlVdlueBFbLW0mhhAyGEqpt,1,0,0,0,0,0,1,0,1,0.14285714285714285,1,0.0,0,0,0,0,0,0,0,1,0,0,1,1
3069,45722,zUCFNdkDJjSNIqUVigI0Q3t79JnpwRq3,RXDvfPUBYFlVdlueBFbLW0mhhAyGEqpt,1,0,0,0,0,0,1,0,1,0.14285714285714285,1,0.0,0,0,0,0,0,0,0,1,0,0,1,1
3070,45849,CpJFUzNBBad8gxGQfFWcVCTdakqtlRdi,RXDvfPUBYFlVdlueBFbLW0mhhAyGEqpt,1,0,0,0,0,0,2,0,2,0.2857142857142857,1,0.0,0,0,0,0,0,0,0,2,0,0,2,1
3071,45854,0DHsJAElXb9hqHUPTXAQocHtOXvWXP78,RXDvfPUBYFlVdlueBFbLW0mhhAyGEqpt,1,0,0,0,0,0,1,0,1,0.14285714285714285,1,0.0,0,0,0,0,0,0,0,1,0,0,1,1
3072,45931,BTsn79qot898Mo4TTFaO7NRlDTnmwcCn,G8EPVSXsOYB5YQWZGiz1aVq5Pgr2GrQu,1,0,0,0,0,0,1,0,1,0.14285714285714285,1,0.0,0,0,0,0,0,0,0,1,0,0,1,1
3073,45958,QVJT76zcnp3BslGL7JUS10ZkHM5HFGSg,RXDvfPUBYFlVdlueBFbLW0mhhAyGEqpt,1,0,0,0,0,0,1,0,1,0.14285714285714285,1,0.0,0,0,0,0,0,0,0,1,0,0,1,1
3074,45969,chQJNd08oe4UgyVlUUX52CvD3Wla8eb7,G8EPVSXsOYB5YQWZGiz1aVq5Pgr2GrQu,1,0,0,0,0,0,1,0,1,0.14285714285714285,1,0.0,0,0,0,0,0,0,0,1,0,0,1,1
3075,45977,sGg2QuTzc9ZdW4JVwqEMxUhxNa3l9bLB,G8EPVSXsOYB5YQWZGiz1aVq5Pgr2GrQu,1,0,0,0,0,0,1,0,1,0.14285714285714285,1,0.0,0,0,0,0,0,0,0,1,0,0,1,1
3076,46013,PNXl2SBlhwK5mHxVh3FrbKdX9rl1VIVp,G8EPVSXsOYB5YQWZGiz1aVq5Pgr2GrQu,1,0,0,0,0,0,1,0,1,0.14285714285714285,1,0.0,0,0,0,0,0,0,0,1,0,0,1,1
3077,46015,fGEAQY13PDoFhSvPw6ar51lhcxcXekJz,RXDvfPUBYFlVdlueBFbLW0mhhAyGEqpt,1,0,0,0,0,0,2,0,2,0.2857142857142857,1,0.0,0,0,0,0,0,0,0,2,0,0,2,1
3078,46059,ffnHtZ1QN4qjciwC3Yy8mONo5ZYvivQf,G8EPVSXsOYB5YQWZGiz1aVq5Pgr2GrQu,1,0,0,0,0,0,1,0,1,0.14285714285714285,1,0.0,0,0,0,0,0,0,0,1,0,0,1,1
3079,46114,3YdfU7bhuCtVSPeVcn33KfVYPID77mmY,RXDvfPUBYFlVdlueBFbLW0mhhAyGEqpt,1,0,0,0,0,0,1,0,1,0.14285714285714285,1,0.0,0,0,0,0,0,0,0,1,0,0,1,1
3080,46173,jj6BKJzz2LfNkxpbRScKRBOb519d4fcM,G8EPVSXsOYB5YQWZGiz1aVq5Pgr2GrQu,1,0,0,0,0,0,1,0,1,0.14285714285714285,1,0.0,0,0,0,0,0,0,0,1,0,0,1,1
3081,46237,N7kM3jWM4eH8xNeIeU71MKRwK6kQucbk,G8EPVSXsOYB5YQWZGiz1aVq5Pgr2GrQu,4,2,0,0,0,0,2,0,4,0.5714285714285714,1,0.0,0,0,0,0,2,0,0,2,0,0,4,1
3082,46280,2kMQkfKYMlhaU4UM5pB8xmNc8uChRuw1,RXDvfPUBYFlVdlueBFbLW0mhhAyGEqpt,1,0,0,0,0,0,1,0,1,0.14285714285714285,1,0.0,0,0,0,0,0,0,0,1,0,0,1,1
3083,46284,5lTTIs9nhtO0O7RTM99nDh8BPtI6ScTe,G8EPVSXsOYB5YQWZGiz1aVq5Pgr2GrQu,1,0,0,0,0,0,1,0,1,0.14285714285714285,1,0.0,0,0,0,0,0,0,0,1,0,0,1,1
3084,46304,khyDqhFAo6DpK4tMIyensDnI5TCI4bvw,G8EPVSXsOYB5YQWZGiz1aVq5Pgr2GrQu,1,0,0,0,0,0,1,0,1,0.14285714285714285,1,0.0,0,0,0,0,0,0,0,1,0,0,1,1
3085,46338,ZqLzWImxdtQBdKkWQiADsQDooYoZ3q37,RXDvfPUBYFlVdlueBFbLW0mhhAyGEqpt,1,0,0,0,0,0,1,0,1,0.14285714285714285,1,0.0,0,0,0,0,0,0,0,1,0,0,1,1
3086,46355,kjTdi307uJdPG2dA0MRZXL0j1FvRWtkq,G8EPVSXsOYB5YQWZGiz1aVq5Pgr2GrQu,1,0,0,0,0,0,1,0,1,0.14285714285714285,1,0.0,0,0,0,0,0,0,0,1,0,0,1,1
3087,46366,KuNFtG4l08F89uoxUeo0jGAYIKWrBRbs,RXDvfPUBYFlVdlueBFbLW0mhhAyGEqpt,15,19,6,0,3,0,10,0,38,5.428571428571429,2,0.0,0,6,0,3,19,0,0,10,0,9,29,1
3088,46383,cxxLaXhgAon6KrRcUx12hLoqbuiALekd,RXDvfPUBYFlVdlueBFbLW0mhhAyGEqpt,1,0,0,0,0,0,1,0,1,0.14285714285714285,1,0.0,0,0,0,0,0,0,0,1,0,0,1,1
3089,46389,gGFmJyNMerYTj0kT96HuKIvL9JdTq2vY,RXDvfPUBYFlVdlueBFbLW0mhhAyGEqpt,32,45,23,87,15,8,12,0,190,27.142857142857142,4,0.0,17,23,73,15,28,8,14,12,0,128,62,0
3090,46393,2AW6aH0SqKYjpe5J2qxXqfKxHscq7JWf,G8EPVSXsOYB5YQWZGiz1aVq5Pgr2GrQu,1,0,0,0,0,0,1,0,1,0.14285714285714285,1,0.0,0,0,0,0,0,0,0,1,0,0,1,1
3091,46413,3eLagVEammG0JrQUYdbSaNysDt0g3zAb,RXDvfPUBYFlVdlueBFbLW0mhhAyGEqpt,1,0,0,0,0,0,1,0,1,0.14285714285714285,1,0.0,0,0,0,0,0,0,0,1,0,0,1,1
3092,46414,pxpbjivAFvcOKL2janpM89oHptiaHIsF,G8EPVSXsOYB5YQWZGiz1aVq5Pgr2GrQu,1,0,0,0,0,0,1,0,1,0.14285714285714285,1,0.0,0,0,0,0,0,0,0,1,0,0,1,1
3093,46440,jspM6ZD48llYyfw95wwrh04hh61lp4NC,RXDvfPUBYFlVdlueBFbLW0mhhAyGEqpt,7,6,3,0,1,0,2,0,12,1.7142857142857142,2,0.0,0,3,0,1,6,0,0,2,0,4,8,1
3094,46446,C7E8IpvmWl51PErSqNPx8JIZDHe2uLQP,RXDvfPUBYFlVdlueBFbLW0mhhAyGEqpt,24,47,22,0,17,0,13,0,99,14.142857142857142,3,0.0,6,22,0,17,41,0,0,13,0,45,54,1
3095,46481,HBy8mPchGFgKjPi1BR1hdK1ryzkGe4Eu,fbPkOYLVPtPgIt0MxizjfFJov3JbHyAi,2,0,0,0,0,0,2,0,2,0.2857142857142857,1,0.0,0,0,0,0,0,0,0,2,0,0,2,1
3096,46482,QvWjJCxM4Z5YXutHnyToIP2emrXnT27F,fbPkOYLVPtPgIt0MxizjfFJov3JbHyAi,8,2,1,0,1,1,5,1,11,1.5714285714285714,1,0.0,0,1,0,1,2,1,0,5,1,2,9,1
3097,46483,TZ1qqjK0a5Zztn1Eld8NcfyMD8SKYxjC,fbPkOYLVPtPgIt0MxizjfFJov3JbHyAi,8,2,1,0,1,1,18,3,26,3.7142857142857144,1,0.0,0,1,0,1,2,1,0,18,3,2,24,1
3098,46484,acna1oLISW5GtLdHgEb3HFIk5PnI1WRA,fbPkOYLVPtPgIt0MxizjfFJov3JbHyAi,1,0,0,0,0,0,1,0,1,0.14285714285714285,1,0.0,0,0,0,0,0,0,0,1,0,0,1,1
3099,46485,n0aD0wlRo2epwn74jquTDUFpiwWF99mc,fbPkOYLVPtPgIt0MxizjfFJov3JbHyAi,11,16,5,2,6,4,4,0,37,5.285714285714286,2,0.0,7,5,2,6,9,4,0,4,0,20,17,0
3100,46487,0cQOAQZYor1XBUr8oohVdZF8cKrNp08W,fbPkOYLVPtPgIt0MxizjfFJov3JbHyAi,25,36,15,22,9,1,11,0,94,13.428571428571429,4,0.0,10,15,17,9,26,1,5,11,0,51,43,1
3101,46489,vjcoSDgY9JiBCtsViMhHCl6KGCk2TvE5,fbPkOYLVPtPgIt0MxizjfFJov3JbHyAi,7,3,2,0,2,0,2,0,9,1.2857142857142858,1,0.0,0,2,0,2,3,0,0,2,0,4,5,1
3102,46492,A5Ha5kMAE8LgDZc3iTs32MwLDsMXRqMa,fbPkOYLVPtPgIt0MxizjfFJov3JbHyAi,16,16,9,20,0,0,3,0,48,6.857142857142857,1,0.0,6,9,20,0,10,0,0,3,0,35,13,1
3103,46494,JedhrXCQn7XYerN8pX6fyNhWwODWvnUf,fbPkOYLVPtPgIt0MxizjfFJov3JbHyAi,10,16,3,8,7,0,4,0,38,5.428571428571429,1,0.0,12,3,5,7,4,0,3,4,0,27,11,0
3104,46496,TvKzeZn2ihjFdDt7bera0RviFXCeKKB6,fbPkOYLVPtPgIt0MxizjfFJov3JbHyAi,5,2,1,0,1,0,4,0,8,1.1428571428571428,1,0.0,0,1,0,1,2,0,0,4,0,2,6,1
3105,46498,jSp9qlCQEKpc4PsUPHVOngS2TFfQ6jwl,fbPkOYLVPtPgIt0MxizjfFJov3JbHyAi,3,1,0,0,0,0,2,0,3,0.42857142857142855,1,0.0,0,0,0,0,1,0,0,2,0,0,3,1
3106,46500,Kkk2oty8lHBEgyFYDiZgsO24fUpD8pZQ,fbPkOYLVPtPgIt0MxizjfFJov3JbHyAi,9,5,3,4,3,0,1,0,16,2.2857142857142856,1,0.0,1,3,3,3,4,0,1,1,0,10,6,1
3107,46501,rIwy3FDbkCxSl3lJMcDBmeUqV54svIRx,fbPkOYLVPtPgIt0MxizjfFJov3JbHyAi,8,9,5,0,4,0,5,0,23,3.2857142857142856,1,0.0,0,5,0,4,9,0,0,5,0,9,14,1
3108,46503,DPR39VXlEgPnSvHJlcrFWVjZyCJYvn9R,fbPkOYLVPtPgIt0MxizjfFJov3JbHyAi,2,0,0,0,0,0,5,0,5,0.7142857142857143,1,0.0,0,0,0,0,0,0,0,5,0,0,5,1
3109,46504,CpsMjwcxvfkSN0hyQGRgXRt6dQZxAjwb,fbPkOYLVPtPgIt0MxizjfFJov3JbHyAi,11,7,4,0,5,0,5,1,22,3.142857142857143,1,0.0,2,4,0,5,5,0,0,5,1,11,11,1
3110,46505,kBNWoa4A4jmNOoJaSAupB8wyNzpsoJAN,fbPkOYLVPtPgIt0MxizjfFJov3JbHyAi,45,82,28,27,25,1,17,3,183,26.142857142857142,4,0.0,32,28,24,25,50,1,3,17,3,109,74,0
3111,46511,xeCFX5y6IRjmYKFA9y4Rgt3SG4YPELud,fbPkOYLVPtPgIt0MxizjfFJov3JbHyAi,45,201,66,15,27,47,25,0,381,54.42857142857143,4,0.0,19,66,15,27,182,47,0,25,0,127,254,0
3112,46512,a8mEu8FF4lDfLSb2ZwttyDGOOQsEW3CZ,fbPkOYLVPtPgIt0MxizjfFJov3JbHyAi,9,7,3,0,3,0,6,0,19,2.7142857142857144,1,0.0,2,3,0,3,5,0,0,6,0,8,11,1
3113,46513,EiO5bky9R1Iqlpv4ItUpPBUgGb1eJItE,fbPkOYLVPtPgIt0MxizjfFJov3JbHyAi,5,2,1,0,1,0,2,0,6,0.8571428571428571,2,0.0,0,1,0,1,2,0,0,2,0,2,4,1
3114,46514,wQDLnIhQRiBlJ7OOKtAQT7egktqnXxWd,fbPkOYLVPtPgIt0MxizjfFJov3JbHyAi,13,9,6,0,5,18,11,1,50,7.142857142857143,1,0.0,0,6,0,5,9,18,0,11,1,11,39,1
3115,46515,ZalaHb2nOUsnNI2p4xQ00VNI9pJY08yk,fbPkOYLVPtPgIt0MxizjfFJov3JbHyAi,2,0,0,0,0,0,2,0,2,0.2857142857142857,1,0.0,0,0,0,0,0,0,0,2,0,0,2,1
3116,46516,WvBcJWjHUn0OSdcSOrveOYpPP7iy97HT,fbPkOYLVPtPgIt0MxizjfFJov3JbHyAi,3,0,0,0,0,0,7,0,7,1.0,1,0.0,0,0,0,0,0,0,0,7,0,0,7,1
3117,46517,MN4wOgynUY4QcRaraCB5Ym52vNjUttfc,fbPkOYLVPtPgIt0MxizjfFJov3JbHyAi,5,0,0,0,0,1,4,1,6,0.8571428571428571,1,0.0,0,0,0,0,0,1,0,4,1,0,6,1
3118,46518,zNp29QwJYW19LnSbsZ5BdQrNdzMHpz2F,fbPkOYLVPtPgIt0MxizjfFJov3JbHyAi,27,53,30,12,20,22,8,0,145,20.714285714285715,3,0.0,14,30,11,20,39,22,1,8,0,75,70,1
3119,46519,q0GqO7mYZSUjsbmDGsoT5N4ppqd8vOBB,fbPkOYLVPtPgIt0MxizjfFJov3JbHyAi,7,4,2,0,2,0,4,0,12,1.7142857142857142,1,0.0,0,2,0,2,4,0,0,4,0,4,8,1
3120,46520,SK3evWrWxCZl0iqN8sbmSNUdgxEYSLSK,fbPkOYLVPtPgIt0MxizjfFJov3JbHyAi,2,0,0,0,0,0,2,0,2,0.2857142857142857,1,0.0,0,0,0,0,0,0,0,2,0,0,2,1
3121,46522,EfURFHip4N6v2zuhSrNJ2KVVAM4Td3mY,fbPkOYLVPtPgIt0MxizjfFJov3JbHyAi,11,11,4,0,4,0,1,0,20,2.857142857142857,1,0.0,0,4,0,4,11,0,0,1,0,8,12,1
3122,46523,UD5FqfNicjboiN32GGPYtIcMIUIxLZOX,fbPkOYLVPtPgIt0MxizjfFJov3JbHyAi,6,4,3,0,3,0,1,0,11,1.5714285714285714,1,0.0,0,3,0,3,4,0,0,1,0,6,5,1
3123,46524,2QBIivovfBXOULGvBnn18Q4kSGQH3yTO,fbPkOYLVPtPgIt0MxizjfFJov3JbHyAi,7,2,1,0,1,0,4,0,8,1.1428571428571428,1,0.0,0,1,0,1,2,0,0,4,0,2,6,1
3124,46526,LTrIeWW4Gi4Y09oaKB1naUI4GII0UZAi,fbPkOYLVPtPgIt0MxizjfFJov3JbHyAi,4,3,0,0,0,0,5,0,8,1.1428571428571428,1,0.0,0,0,0,0,3,0,0,5,0,0,8,1
3125,46527,8JTz84ZDdJm6tvsd7hgyCl1RB6wU6r2e,fbPkOYLVPtPgIt0MxizjfFJov3JbHyAi,23,46,19,13,18,29,22,2,149,21.285714285714285,4,0.0,19,19,10,18,27,29,3,22,2,66,83,1
3126,46529,HQVRezU89umSvdjmOYF3nS0qPRPvMBxw,fbPkOYLVPtPgIt0MxizjfFJov3JbHyAi,8,5,2,0,3,0,3,0,13,1.8571428571428572,1,0.0,3,2,0,3,2,0,0,3,0,8,5,1
3127,46530,TBXYAxwexaNd47Tj9eT3p3QhXiwNSKj3,fbPkOYLVPtPgIt0MxizjfFJov3JbHyAi,1,0,0,0,0,0,1,0,1,0.14285714285714285,1,0.0,0,0,0,0,0,0,0,1,0,0,1,1
3128,46531,KbMG2R5hi7lV4ttClunSqF2UarKF8FNZ,fbPkOYLVPtPgIt0MxizjfFJov3JbHyAi,30,72,19,4,20,60,41,3,219,31.285714285714285,7,0.0,13,19,4,20,59,60,0,41,3,56,163,1
3129,46533,pRxI77wBFvTUHzDy8YsNcKJFbpdAZGNh,fbPkOYLVPtPgIt0MxizjfFJov3JbHyAi,15,9,5,0,4,3,7,1,29,4.142857142857143,2,0.0,0,5,0,4,9,3,0,7,1,9,20,1
3130,46534,KvCAdo1odeI84idtqyQZyVEKdaH6IDdM,fbPkOYLVPtPgIt0MxizjfFJov3JbHyAi,45,168,85,31,25,166,49,3,527,75.28571428571429,9,0.0,18,85,30,25,150,166,1,49,3,158,369,1
3131,46536,8HQsMOkKLewVMfte6VD2DYuU0urKWHXv,fbPkOYLVPtPgIt0MxizjfFJov3JbHyAi,12,26,9,4,9,6,15,1,70,10.0,3,0.0,11,9,4,9,15,6,0,15,1,33,37,0
3132,46540,25lc3om6HRn7SihjBlQbrBSLSUySLWnG,fbPkOYLVPtPgIt0MxizjfFJov3JbHyAi,7,3,2,0,2,0,2,0,9,1.2857142857142858,1,0.0,0,2,0,2,3,0,0,2,0,4,5,1
3133,46541,StTC3qGjYN4V41LymnTzXQRS0bQSlPrF,fbPkOYLVPtPgIt0MxizjfFJov3JbHyAi,7,4,2,0,2,0,2,0,10,1.4285714285714286,1,0.0,1,2,0,2,3,0,0,2,0,5,5,1
3134,46543,xBRGHAvkTfDDok4cH7N9aC7OMTMv6n3O,fbPkOYLVPtPgIt0MxizjfFJov3JbHyAi,7,5,4,0,3,0,4,0,16,2.2857142857142856,1,0.0,0,4,0,3,5,0,0,4,0,7,9,1
3135,46544,DAHT3MY5s8ge8Fy97bhkuUzIKyk1q8L2,fbPkOYLVPtPgIt0MxizjfFJov3JbHyAi,9,6,2,2,3,1,5,0,19,2.7142857142857144,1,0.0,3,2,2,3,3,1,0,5,0,10,9,1
3136,46547,GHqW2sFZULw6xLeFQhSQm5IW9wmBIZnH,fbPkOYLVPtPgIt0MxizjfFJov3JbHyAi,5,3,0,0,0,0,4,0,7,1.0,1,0.0,0,0,0,0,3,0,0,4,0,0,7,1
3137,46549,4ApVgPYGz6bz2SJLoGELpZ6RPnXwOa88,fbPkOYLVPtPgIt0MxizjfFJov3JbHyAi,44,138,60,38,36,40,29,0,341,48.714285714285715,10,0.0,48,60,32,36,90,40,6,29,0,176,165,0
3138,46550,F9UZi4Eyme7smBBGI6b8l0B0Zh1VRQUD,fbPkOYLVPtPgIt0MxizjfFJov3JbHyAi,10,6,3,0,2,1,13,1,26,3.7142857142857144,2,0.0,1,3,0,2,5,1,0,13,1,6,20,1
3139,46552,K3nS4VcLIzBgqPQsAsjEIOPChH8gvdgH,fbPkOYLVPtPgIt0MxizjfFJov3JbHyAi,8,2,1,0,1,2,8,1,15,2.142857142857143,1,0.0,0,1,0,1,2,2,0,8,1,2,13,1
3140,46555,QPiUGBr4vUjXTmo4VUV66g7hHPK0zcgj,fbPkOYLVPtPgIt0MxizjfFJov3JbHyAi,7,3,1,0,2,0,2,0,8,1.1428571428571428,1,0.0,0,1,0,2,3,0,0,2,0,3,5,1
3141,46556,VnuUyTHNwHr2LPEpDCNFEvbJ7YyA2Dtr,fbPkOYLVPtPgIt0MxizjfFJov3JbHyAi,7,2,1,0,1,0,6,1,11,1.5714285714285714,1,0.0,0,1,0,1,2,0,0,6,1,2,9,1
3142,46557,uoS96wNFUwtq7HfaPY02QxMEsIwJzjv6,fbPkOYLVPtPgIt0MxizjfFJov3JbHyAi,12,34,2,0,2,7,5,0,50,7.142857142857143,4,0.0,2,2,0,2,32,7,0,5,0,6,44,1
3143,46558,wgVuc0GdXqkgwRE7sGVxY1lchlcFK9wg,fbPkOYLVPtPgIt0MxizjfFJov3JbHyAi,3,0,0,0,0,0,5,0,5,0.7142857142857143,1,0.0,0,0,0,0,0,0,0,5,0,0,5,1
3144,46559,jl7dXdzz09XmO4Xe8w2lkGI7U7DzbG09,fbPkOYLVPtPgIt0MxizjfFJov3JbHyAi,8,6,4,0,3,0,3,0,16,2.2857142857142856,1,0.0,0,4,0,3,6,0,0,3,0,7,9,1
3145,46560,9giAVCaBxbNk2UdLbnYeVpzaUfG3nD03,fbPkOYLVPtPgIt0MxizjfFJov3JbHyAi,23,42,16,19,12,4,21,1,115,16.428571428571427,2,0.0,16,16,14,12,26,4,5,21,1,58,57,1
3146,46561,7ZyJguBzL4oDvx3QuauBv2Vv3pHBPVh3,fbPkOYLVPtPgIt0MxizjfFJov3JbHyAi,9,8,5,0,5,0,2,0,20,2.857142857142857,1,0.0,0,5,0,5,8,0,0,2,0,10,10,1
3147,46562,rCajReBu2KQJPlVlrrQZIZvrYAp8h9Yy,fbPkOYLVPtPgIt0MxizjfFJov3JbHyAi,2,0,0,0,0,0,3,0,3,0.42857142857142855,2,0.0,0,0,0,0,0,0,0,3,0,0,3,1
3148,46564,W7FXzdnq9Ktue5ZNM3TQmIP7HktmL3kC,fbPkOYLVPtPgIt0MxizjfFJov3JbHyAi,1,0,0,0,0,0,1,0,1,0.14285714285714285,1,0.0,0,0,0,0,0,0,0,1,0,0,1,1
3149,46565,wFCoKk3O7Yg710logPyDwMV7EivrZQCR,fbPkOYLVPtPgIt0MxizjfFJov3JbHyAi,1,0,0,0,0,0,1,0,1,0.14285714285714285,1,0.0,0,0,0,0,0,0,0,1,0,0,1,1
3150,46566,jFdhdjmfzOKKtloREabrCYP6a5dr6kJ3,fbPkOYLVPtPgIt0MxizjfFJov3JbHyAi,10,5,2,0,3,1,13,1,25,3.5714285714285716,1,0.0,2,2,0,3,3,1,0,13,1,7,18,1
3151,46567,UPecCjx5RBL6BceSov5rJLAaDoiPXUhg,fbPkOYLVPtPgIt0MxizjfFJov3JbHyAi,9,5,3,0,2,0,10,1,21,3.0,2,0.0,0,3,0,2,5,0,0,10,1,5,16,1
3152,46568,a9pvo8cVBjTHxQYvCPfHB4tPGRdFjAui,fbPkOYLVPtPgIt0MxizjfFJov3JbHyAi,13,8,5,0,4,2,13,1,33,4.714285714285714,1,0.0,0,5,0,4,8,2,0,13,1,9,24,1
3153,46569,EvnDUDuRuksYPdrCaUQQweT0GY5Najoh,fbPkOYLVPtPgIt0MxizjfFJov3JbHyAi,5,2,1,0,1,0,2,0,6,0.8571428571428571,1,0.0,0,1,0,1,2,0,0,2,0,2,4,1
3154,46570,1w8EW76qmBSgQ2s8Jb4yoPsNX01KUcoD,fbPkOYLVPtPgIt0MxizjfFJov3JbHyAi,10,3,2,0,2,1,7,1,16,2.2857142857142856,1,0.0,0,2,0,2,3,1,0,7,1,4,12,1
3155,46571,ZKAk08L8Iriz8Uv5UOeqSbrNnzg1rlMz,fbPkOYLVPtPgIt0MxizjfFJov3JbHyAi,9,9,6,0,4,0,12,0,31,4.428571428571429,2,0.0,1,6,0,4,8,0,0,12,0,11,20,1
3156,46573,IvhEQ40qNYap5nunxQhwiW2fnAok3TLS,fbPkOYLVPtPgIt0MxizjfFJov3JbHyAi,9,5,3,0,2,31,6,1,48,6.857142857142857,2,0.0,0,3,0,2,5,31,0,6,1,5,43,0
3157,46574,mZc1V3rQTRH4oqK1zqSjimuZcPwomnsE,fbPkOYLVPtPgIt0MxizjfFJov3JbHyAi,5,7,4,0,0,14,2,0,27,3.857142857142857,1,0.0,2,4,0,0,5,14,0,2,0,6,21,1
3158,46576,a8wX3Bl3kW6KFXwHZ6A5CPXKLBX1p4MZ,fbPkOYLVPtPgIt0MxizjfFJov3JbHyAi,2,0,0,0,0,0,3,0,3,0.42857142857142855,1,0.0,0,0,0,0,0,0,0,3,0,0,3,1
3159,46577,Edq6Echk8wEs8ShX5RBw5c8Yx8ANHVje,fbPkOYLVPtPgIt0MxizjfFJov3JbHyAi,1,0,0,0,0,0,1,0,1,0.14285714285714285,1,0.0,0,0,0,0,0,0,0,1,0,0,1,1
3160,46578,xpD8zL0kPAHItDUStTwEIkWWrm8dDFmA,fbPkOYLVPtPgIt0MxizjfFJov3JbHyAi,10,6,3,0,2,3,5,1,20,2.857142857142857,1,0.0,0,3,0,2,6,3,0,5,1,5,15,1
3161,46579,LWBASHvZlE9V0DOIMqscGs93ncFzXARw,fbPkOYLVPtPgIt0MxizjfFJov3JbHyAi,8,9,4,0,3,0,3,0,19,2.7142857142857144,1,0.0,2,4,0,3,7,0,0,3,0,9,10,1
3162,46580,sn1OZIzg3ZOiyRClBvvQLUKwx6tymOkC,fbPkOYLVPtPgIt0MxizjfFJov3JbHyAi,25,25,9,12,13,0,4,1,64,9.142857142857142,1,0.0,15,9,11,13,10,0,1,4,1,48,16,1
3163,46581,sw536JzryZ42F137fkltWvrIc3QLRo3o,fbPkOYLVPtPgIt0MxizjfFJov3JbHyAi,8,3,2,0,0,1,6,1,13,1.8571428571428572,1,0.0,0,2,0,0,3,1,0,6,1,2,11,1
3164,46582,Ikjjxpfg5ascMIjhTuGW8BkxPihDwWmv,fbPkOYLVPtPgIt0MxizjfFJov3JbHyAi,32,41,20,15,17,2,5,0,100,14.285714285714286,2,0.0,13,20,12,17,28,2,3,5,0,62,38,1
3165,46585,1fz7RS94t8nuoMroWFq8B06N4IWtq90I,fbPkOYLVPtPgIt0MxizjfFJov3JbHyAi,2,0,0,0,0,0,2,0,2,0.2857142857142857,1,0.0,0,0,0,0,0,0,0,2,0,0,2,1
3166,46587,lDJqver3AFFUyXISNdqvZpmq6OeWVl0r,fbPkOYLVPtPgIt0MxizjfFJov3JbHyAi,10,9,4,2,3,0,2,0,20,2.857142857142857,2,0.0,2,4,2,3,7,0,0,2,0,11,9,1
3167,46588,yfppFvC7mTSlPuhod9GGDRPkzP1HmCAu,fbPkOYLVPtPgIt0MxizjfFJov3JbHyAi,6,7,3,0,2,0,5,0,17,2.4285714285714284,4,0.0,0,3,0,2,7,0,0,5,0,5,12,1
3168,46589,Q8UiR0g4rvfffexhCwFYjhzrBs6RScJA,fbPkOYLVPtPgIt0MxizjfFJov3JbHyAi,8,4,3,0,2,8,6,0,23,3.2857142857142856,1,0.0,0,3,0,2,4,8,0,6,0,5,18,1
3169,46590,DeMkq0IaxnRQrXCQHQpz60sFvrsX1jLn,fbPkOYLVPtPgIt0MxizjfFJov3JbHyAi,15,10,6,0,6,13,11,1,47,6.714285714285714,1,0.0,2,6,0,6,8,13,0,11,1,14,33,1
3170,46593,xanxsjSeaVNFCeWQJAicKck5SsVFdK55,fbPkOYLVPtPgIt0MxizjfFJov3JbHyAi,13,6,5,0,5,0,3,0,19,2.7142857142857144,1,0.0,0,5,0,5,6,0,0,3,0,10,9,1
3171,47680,5j9EQkqR4CZfRV8sku9HLld3NnlBiUj6,7GRhBDsirIGkRZBtSMEzNTyDr2JQm4xx,14,15,3,22,2,0,3,0,45,6.428571428571429,1,0.0,11,3,19,2,4,0,3,3,0,35,10,1
3172,47709,gSg4PIaWl0hBhOgVlpN9o8YrQn4pTOeq,7GRhBDsirIGkRZBtSMEzNTyDr2JQm4xx,2,0,0,0,0,0,3,0,3,0.42857142857142855,1,0.0,0,0,0,0,0,0,0,3,0,0,3,1
3173,47743,iiuR3N6D1WRXLO09fb3Myc2MlNCCDfce,fbPkOYLVPtPgIt0MxizjfFJov3JbHyAi,4,3,0,0,0,0,2,0,5,0.7142857142857143,1,0.0,0,0,0,0,3,0,0,2,0,0,5,1
3174,47744,vCEQKCbjX310wPLqLwTGRr7i4Nhg0wTp,fbPkOYLVPtPgIt0MxizjfFJov3JbHyAi,10,8,4,0,3,2,5,0,22,3.142857142857143,1,0.0,0,4,0,3,8,2,0,5,0,7,15,1
3175,47745,gHBHYv37TuKpRs5kVViSUWhCV5Lhiblh,fbPkOYLVPtPgIt0MxizjfFJov3JbHyAi,7,3,2,0,2,0,2,0,9,1.2857142857142858,1,0.0,0,2,0,2,3,0,0,2,0,4,5,1
3176,47746,8ZsblV6culyKvM3swAGhgvHIR3alJq9n,fbPkOYLVPtPgIt0MxizjfFJov3JbHyAi,6,4,2,0,1,4,2,0,13,1.8571428571428572,2,0.0,0,2,0,1,4,4,0,2,0,3,10,1
3177,47747,FmNtF0dqiST5GypmKkWanKtXqnTegJEy,fbPkOYLVPtPgIt0MxizjfFJov3JbHyAi,1,0,0,0,0,0,1,0,1,0.14285714285714285,1,0.0,0,0,0,0,0,0,0,1,0,0,1,1
3178,47749,kkpDZ77gSlUQ6KcLobLV9NQm1XnSLEFr,fbPkOYLVPtPgIt0MxizjfFJov3JbHyAi,1,0,0,0,0,0,1,0,1,0.14285714285714285,1,0.0,0,0,0,0,0,0,0,1,0,0,1,1
3179,47751,cNndd5chSMU3sSAeRXd6PJHkgPmrCB8z,fbPkOYLVPtPgIt0MxizjfFJov3JbHyAi,7,2,1,0,1,1,4,2,11,1.5714285714285714,1,0.0,0,1,0,1,2,1,0,4,2,2,9,1
3180,47754,Pp9LbsXIl32Hj8Wq17Qd9kc6BTy8YAGl,fbPkOYLVPtPgIt0MxizjfFJov3JbHyAi,8,2,1,0,1,0,6,1,11,1.5714285714285714,1,0.0,0,1,0,1,2,0,0,6,1,2,9,1
3181,47755,lz6lDEfdau9dm3sqop0RmJjc1H5uyps1,fbPkOYLVPtPgIt0MxizjfFJov3JbHyAi,8,2,2,0,2,0,3,0,9,1.2857142857142858,1,0.0,0,2,0,2,2,0,0,3,0,4,5,1
3182,47756,L0FSy0eDJB0vLjpSsrNVX0T1aJD3NXFR,fbPkOYLVPtPgIt0MxizjfFJov3JbHyAi,15,29,11,12,10,4,19,0,85,12.142857142857142,2,0.0,12,11,9,10,17,4,3,19,0,42,43,1
3183,47757,AVyLSaof0VtZQR2ODvUxATLv8wovFv6r,fbPkOYLVPtPgIt0MxizjfFJov3JbHyAi,5,1,1,0,1,0,5,0,8,1.1428571428571428,1,0.0,0,1,0,1,1,0,0,5,0,2,6,1
3184,47759,ihajxoAz8rtCLZp3NhTz4Dj4wyy7Ve6j,fbPkOYLVPtPgIt0MxizjfFJov3JbHyAi,16,26,13,13,12,5,11,3,83,11.857142857142858,2,0.0,9,13,9,12,17,5,4,11,3,43,40,1
3185,47761,wzqDZnt5ey5srxRDV6DOODvuoPbW2hmC,fbPkOYLVPtPgIt0MxizjfFJov3JbHyAi,3,0,0,0,0,0,3,0,3,0.42857142857142855,1,0.0,0,0,0,0,0,0,0,3,0,0,3,1
3186,47762,zcIKJMENggqIW9hSdKBxNE0nRwFUSouz,fbPkOYLVPtPgIt0MxizjfFJov3JbHyAi,7,5,2,0,2,0,2,0,11,1.5714285714285714,1,0.0,2,2,0,2,3,0,0,2,0,6,5,1
3187,47763,JVoHWX6804dBiuuywxHjLhyoqtZIkCFx,fbPkOYLVPtPgIt0MxizjfFJov3JbHyAi,1,0,0,0,0,0,1,0,1,0.14285714285714285,1,0.0,0,0,0,0,0,0,0,1,0,0,1,1
3188,47765,ri6NVluQbSKckezFilIjxRHtq5swKp7U,fbPkOYLVPtPgIt0MxizjfFJov3JbHyAi,7,4,3,0,2,2,1,0,12,1.7142857142857142,1,0.0,0,3,0,2,4,2,0,1,0,5,7,1
3189,47766,ag9HLImVQiPyL9rK7r26gIINFvgysNlx,fbPkOYLVPtPgIt0MxizjfFJov3JbHyAi,10,7,5,0,4,0,5,0,21,3.0,1,0.0,0,5,0,4,7,0,0,5,0,9,12,0
3190,47767,Y54KD3ZA4LZs5ByE3QveGSSA4lLE8N3J,fbPkOYLVPtPgIt0MxizjfFJov3JbHyAi,6,3,2,0,2,0,1,0,8,1.1428571428571428,1,0.0,0,2,0,2,3,0,0,1,0,4,4,1
3191,47768,Yjq3LhAjOWvN82KjjED7khdom1HyBA50,fbPkOYLVPtPgIt0MxizjfFJov3JbHyAi,4,2,1,0,0,0,2,0,5,0.7142857142857143,1,0.0,0,1,0,0,2,0,0,2,0,1,4,1
3192,47769,37QXIA2mA5HwR196s7DdMurvu7yccsaS,fbPkOYLVPtPgIt0MxizjfFJov3JbHyAi,5,2,1,0,1,0,4,0,8,1.1428571428571428,1,0.0,0,1,0,1,2,0,0,4,0,2,6,1
3193,47771,WEqUhplW7x1SpLabVjNcI5M4HsCYjumg,fbPkOYLVPtPgIt0MxizjfFJov3JbHyAi,7,3,2,0,2,0,2,0,9,1.2857142857142858,1,0.0,0,2,0,2,3,0,0,2,0,4,5,1
3194,47773,rPoI3YNCiMsaBvpMVe9YNNLovGBjXQL1,fbPkOYLVPtPgIt0MxizjfFJov3JbHyAi,5,2,1,0,1,0,2,0,6,0.8571428571428571,1,0.0,0,1,0,1,2,0,0,2,0,2,4,1
3195,47774,38RAlLJIctL7kclCvMfQ1cdfefa6tncU,fbPkOYLVPtPgIt0MxizjfFJov3JbHyAi,7,4,2,0,2,0,4,0,12,1.7142857142857142,1,0.0,0,2,0,2,4,0,0,4,0,4,8,1
3196,47775,NbFjLBlaokvKCRfsLwofmB9VjZfUQeXG,fbPkOYLVPtPgIt0MxizjfFJov3JbHyAi,6,6,4,0,4,0,2,0,16,2.2857142857142856,1,0.0,0,4,0,4,6,0,0,2,0,8,8,1
3197,47778,tF7Aut7t0G2GWI4HCraCbVOE9W7RdLCy,fbPkOYLVPtPgIt0MxizjfFJov3JbHyAi,2,0,0,0,0,0,6,0,6,0.8571428571428571,1,0.0,0,0,0,0,0,0,0,6,0,0,6,1
3198,47781,JelJmDAgdvYMwysu2S8khlhEiSoRMDm3,fbPkOYLVPtPgIt0MxizjfFJov3JbHyAi,25,41,20,18,14,20,10,0,123,17.571428571428573,3,0.0,18,20,17,14,23,20,1,10,0,69,54,0
3199,47782,TGulLRA4GuGoMcQ4GcDFWeudMqmFclIY,fbPkOYLVPtPgIt0MxizjfFJov3JbHyAi,4,2,1,0,1,0,1,0,5,0.7142857142857143,1,0.0,0,1,0,1,2,0,0,1,0,2,3,1
3200,47784,o9yvVrDdqWbWhDTxptqPNzcJYAQzSgqs,fbPkOYLVPtPgIt0MxizjfFJov3JbHyAi,7,5,2,0,3,1,5,0,16,2.2857142857142856,1,0.0,2,2,0,3,3,1,0,5,0,7,9,1
3201,47785,hIwxGIao0auqtzgWn2kttNbjIiHkmA5D,fbPkOYLVPtPgIt0MxizjfFJov3JbHyAi,5,2,1,0,1,0,2,0,6,0.8571428571428571,1,0.0,0,1,0,1,2,0,0,2,0,2,4,1
3202,47786,9BOxWH9bnbnBFLyov7eyKil4OAMIu6r8,fbPkOYLVPtPgIt0MxizjfFJov3JbHyAi,1,0,0,0,0,0,4,0,4,0.5714285714285714,1,0.0,0,0,0,0,0,0,0,4,0,0,4,1
3203,47788,ZQSZgZ79Y2BI2kLu43mIPc6ox1OLMn3i,fbPkOYLVPtPgIt0MxizjfFJov3JbHyAi,9,4,3,0,2,0,7,0,16,2.2857142857142856,2,0.0,0,3,0,2,4,0,0,7,0,5,11,1
3204,47791,Hw8jmGp4VI4tAz6cfKhHDOeLB2t7MJ9z,fbPkOYLVPtPgIt0MxizjfFJov3JbHyAi,8,12,7,0,4,21,3,0,47,6.714285714285714,3,0.0,0,7,0,4,12,21,0,3,0,11,36,1
3205,47792,D6PbpNnbT91V2mO50Yo6lGeWMgk4tx0G,fbPkOYLVPtPgIt0MxizjfFJov3JbHyAi,8,9,6,0,2,5,2,0,24,3.4285714285714284,1,0.0,0,6,0,2,9,5,0,2,0,8,16,1
3206,47795,Ve7ldJJUZUHFSKTyCbiFRbXYpCfgkMe0,fbPkOYLVPtPgIt0MxizjfFJov3JbHyAi,5,3,2,0,1,0,2,0,8,1.1428571428571428,1,0.0,0,2,0,1,3,0,0,2,0,3,5,1
3207,47796,To4tY3l3Iwdy23bNNN8VbGmgVWF3Gp06,fbPkOYLVPtPgIt0MxizjfFJov3JbHyAi,11,7,3,7,4,0,3,0,24,3.4285714285714284,1,0.0,3,3,5,4,4,0,2,3,0,15,9,1
3208,47797,tHjeVI3fd22SmNtfBSk3NBb4XLGkojbV,fbPkOYLVPtPgIt0MxizjfFJov3JbHyAi,1,0,0,0,0,0,1,0,1,0.14285714285714285,1,0.0,0,0,0,0,0,0,0,1,0,0,1,1
3209,47798,ZobeGMKyIBgjnUNms43CrtMrVHf6iI1r,fbPkOYLVPtPgIt0MxizjfFJov3JbHyAi,8,7,4,0,2,0,5,0,18,2.5714285714285716,2,0.0,0,4,0,2,7,0,0,5,0,6,12,1
3210,47799,Iwfu4an5Skhugcqyo5SceYhoFf90uJBX,fbPkOYLVPtPgIt0MxizjfFJov3JbHyAi,9,5,2,0,2,3,5,1,18,2.5714285714285716,1,0.0,0,2,0,2,5,3,0,5,1,4,14,1
3211,47800,4TT2g7nLcTVtuILlZdgBu9rrz9KLLOMk,fbPkOYLVPtPgIt0MxizjfFJov3JbHyAi,6,8,2,0,3,0,6,0,19,2.7142857142857144,1,0.0,5,2,0,3,3,0,0,6,0,10,9,1
3212,47801,PmMFkd1Rzxa3QPI5maWIgc4heZgC88AX,fbPkOYLVPtPgIt0MxizjfFJov3JbHyAi,7,3,2,0,2,0,2,0,9,1.2857142857142858,1,0.0,0,2,0,2,3,0,0,2,0,4,5,1
3213,47803,93FWPuXY2azQQwZQWS80tdORRpOo60jj,fbPkOYLVPtPgIt0MxizjfFJov3JbHyAi,15,23,14,0,10,10,6,0,63,9.0,3,0.0,3,14,0,10,20,10,0,6,0,27,36,1
3214,47804,ZcgzdyII0xKmmApyb1MgVZBfYdWiemwd,fbPkOYLVPtPgIt0MxizjfFJov3JbHyAi,7,3,2,0,2,0,3,0,10,1.4285714285714286,2,0.0,0,2,0,2,3,0,0,3,0,4,6,1
3215,47807,JQWlZ9S0smBFDMGfgqcpt4ewgfL5yur6,fbPkOYLVPtPgIt0MxizjfFJov3JbHyAi,10,9,5,0,2,1,6,0,23,3.2857142857142856,2,0.0,1,5,0,2,8,1,0,6,0,8,15,1
3216,47808,FYmdcExkLD3hobz533EUh65L31LUqQ1Y,fbPkOYLVPtPgIt0MxizjfFJov3JbHyAi,2,0,0,0,0,0,3,0,3,0.42857142857142855,1,0.0,0,0,0,0,0,0,0,3,0,0,3,1
3217,47811,eIW9M0Trkt0EiuTzN2HuEtF6QnUOm4E9,fbPkOYLVPtPgIt0MxizjfFJov3JbHyAi,16,24,14,7,10,0,5,0,60,8.571428571428571,2,0.0,7,14,7,10,17,0,0,5,0,38,22,1
3218,47813,pzBdNMI6l60tGyYDZDsD8a3IbqJH27O8,fbPkOYLVPtPgIt0MxizjfFJov3JbHyAi,28,47,8,11,5,6,16,1,94,13.428571428571429,7,0.0,7,8,10,5,40,6,1,16,1,30,64,0
3219,47814,1gTDkM1DmoNiWAXMcO7Ry3TBKifByJrA,fbPkOYLVPtPgIt0MxizjfFJov3JbHyAi,5,3,2,0,0,0,2,0,7,1.0,1,0.0,0,2,0,0,3,0,0,2,0,2,5,1
3220,47815,R32OpsvoWT0fJOVOqVFkJPGA6xEYJoku,fbPkOYLVPtPgIt0MxizjfFJov3JbHyAi,5,0,0,0,0,2,5,1,8,1.1428571428571428,1,0.0,0,0,0,0,0,2,0,5,1,0,8,1
3221,47819,JSeJszCXASTiAymchwd8Mbxb0d9xvaME,fbPkOYLVPtPgIt0MxizjfFJov3JbHyAi,4,2,1,0,1,0,1,0,5,0.7142857142857143,1,0.0,0,1,0,1,2,0,0,1,0,2,3,1
3222,47821,GYAhe7QkBFzfyQOufZzJyKbMW1Ol7QR2,fbPkOYLVPtPgIt0MxizjfFJov3JbHyAi,1,0,0,0,0,0,1,0,1,0.14285714285714285,1,0.0,0,0,0,0,0,0,0,1,0,0,1,1
3223,47823,9uK9gXYJyTZNtNSUCINqfEFUfFE2z8C1,fbPkOYLVPtPgIt0MxizjfFJov3JbHyAi,2,0,0,0,0,0,2,0,2,0.2857142857142857,1,0.0,0,0,0,0,0,0,0,2,0,0,2,1
3224,47825,FosOn7Nym18de58uciRhhONZG69DSOHR,fbPkOYLVPtPgIt0MxizjfFJov3JbHyAi,1,0,0,0,0,0,1,0,1,0.14285714285714285,1,0.0,0,0,0,0,0,0,0,1,0,0,1,1
3225,47827,QXhJhqRI2RKlJx1bX2NHrvRhjNHoTmov,fbPkOYLVPtPgIt0MxizjfFJov3JbHyAi,7,5,3,0,2,0,2,0,12,1.7142857142857142,1,0.0,0,3,0,2,5,0,0,2,0,5,7,1
3226,47829,XHEZtfDZPcYKEJdadg7oTWoKvKH8Zuar,fbPkOYLVPtPgIt0MxizjfFJov3JbHyAi,2,0,0,0,0,0,2,0,2,0.2857142857142857,1,0.0,0,0,0,0,0,0,0,2,0,0,2,1
3227,47830,2yx2qSv17vABrVR2NSjoUhZ8khDHzM1p,fbPkOYLVPtPgIt0MxizjfFJov3JbHyAi,6,7,1,0,1,0,3,0,12,1.7142857142857142,2,0.0,0,1,0,1,7,0,0,3,0,2,10,1
3228,47831,YpdehTzQsSqz1ddMB0XGW2Y6lcmHTYFK,fbPkOYLVPtPgIt0MxizjfFJov3JbHyAi,6,4,2,0,0,0,4,0,10,1.4285714285714286,1,0.0,0,2,0,0,4,0,0,4,0,2,8,1
3229,47832,uzyKB6l5IMjDSYdYxLudAhgrFzD2VyDw,fbPkOYLVPtPgIt0MxizjfFJov3JbHyAi,8,6,4,0,3,1,4,0,18,2.5714285714285716,1,0.0,0,4,0,3,6,1,0,4,0,7,11,1
3230,47833,16veA4geT2xKUlqWBL48Fcqf8WTsVJtc,fbPkOYLVPtPgIt0MxizjfFJov3JbHyAi,1,0,0,0,0,0,1,0,1,0.14285714285714285,1,0.0,0,0,0,0,0,0,0,1,0,0,1,1
3231,47834,ONghHwhwAX2IyqpHHX698rW0VH9BRcsu,fbPkOYLVPtPgIt0MxizjfFJov3JbHyAi,7,4,2,0,3,0,3,0,12,1.7142857142857142,1,0.0,2,2,0,3,2,0,0,3,0,7,5,1
3232,47835,bPKFcVQkxVd0TAh9nUEtyZP7EFWzhnRn,fbPkOYLVPtPgIt0MxizjfFJov3JbHyAi,9,8,6,0,5,0,5,0,24,3.4285714285714284,1,0.0,0,6,0,5,8,0,0,5,0,11,13,1
3233,47836,SvayS3hRjiQUsZJZ3Z80XuRW7pnvNCGH,fbPkOYLVPtPgIt0MxizjfFJov3JbHyAi,28,72,32,10,19,9,15,1,158,22.571428571428573,3,0.0,22,32,9,19,50,9,1,15,1,82,76,1
3234,47837,pwbQ0rznhIurRxyuVQAFAxt3Zer8oDir,fbPkOYLVPtPgIt0MxizjfFJov3JbHyAi,4,3,2,0,2,0,3,0,10,1.4285714285714286,1,0.0,0,2,0,2,3,0,0,3,0,4,6,1
3235,47840,BNU2wGZhV5dmPLymeUzZGTZPF40H3QyF,fbPkOYLVPtPgIt0MxizjfFJov3JbHyAi,7,3,2,0,2,0,2,0,9,1.2857142857142858,1,0.0,0,2,0,2,3,0,0,2,0,4,5,1
3236,47841,HIbKGQJ8yDbPhmqDqsEHxHEydttgfsQA,fbPkOYLVPtPgIt0MxizjfFJov3JbHyAi,7,3,2,0,2,0,2,0,9,1.2857142857142858,1,0.0,0,2,0,2,3,0,0,2,0,4,5,1
3237,47842,oQIbxVPhPOzQp4tRk0swq8bc74m862Je,fbPkOYLVPtPgIt0MxizjfFJov3JbHyAi,6,13,1,0,1,0,3,0,18,2.5714285714285716,1,0.0,3,1,0,1,10,0,0,3,0,5,13,1
3238,47843,IZ5pWpBLzW50MjCCGxCjTz4w6DVz2MU3,fbPkOYLVPtPgIt0MxizjfFJov3JbHyAi,6,8,5,0,2,0,2,0,17,2.4285714285714284,2,0.0,0,5,0,2,8,0,0,2,0,7,10,1
3239,47844,P4gIdHzF607L8e8VPH3Qb09lxgNZRJFa,fbPkOYLVPtPgIt0MxizjfFJov3JbHyAi,12,20,14,0,12,3,9,0,58,8.285714285714286,4,0.0,2,14,0,12,18,3,0,9,0,28,30,1
3240,47845,QQOQ1mBFT0hbDG4vhxUnw8WQ7hq3XsN0,fbPkOYLVPtPgIt0MxizjfFJov3JbHyAi,6,3,2,0,2,0,1,0,8,1.1428571428571428,1,0.0,0,2,0,2,3,0,0,1,0,4,4,1
3241,47847,Bat1lO5dwlkuBIiIqyEjLCmla1w2SsRg,fbPkOYLVPtPgIt0MxizjfFJov3JbHyAi,1,0,0,0,0,0,1,0,1,0.14285714285714285,1,0.0,0,0,0,0,0,0,0,1,0,0,1,1
3242,47849,hjbzzLF0uZqUL22zLBiQhzq51chcw6mb,fbPkOYLVPtPgIt0MxizjfFJov3JbHyAi,18,19,11,5,8,6,5,0,54,7.714285714285714,1,0.0,6,11,4,8,13,6,1,5,0,29,25,1
3243,47851,kLsZKBC25zLVIospdIdcGhrxzfP125JG,fbPkOYLVPtPgIt0MxizjfFJov3JbHyAi,11,6,5,0,5,0,6,0,22,3.142857142857143,1,0.0,0,5,0,5,6,0,0,6,0,10,12,1
3244,47852,RfgbqJEazOp1Rb866WYVJPYz91jABFLG,fbPkOYLVPtPgIt0MxizjfFJov3JbHyAi,15,7,6,0,6,1,4,1,25,3.5714285714285716,1,0.0,0,6,0,6,7,1,0,4,1,12,13,1
3245,47854,gRdV8TKfYOuiXGGwKnVS8SiUiAxajq1L,fbPkOYLVPtPgIt0MxizjfFJov3JbHyAi,12,24,10,4,10,2,6,0,56,8.0,2,0.0,7,10,4,10,17,2,0,6,0,31,25,1
3246,47855,II1eOimMlUCajOv1GRuK8VabiA0lRWyy,fbPkOYLVPtPgIt0MxizjfFJov3JbHyAi,5,2,1,0,1,0,5,0,9,1.2857142857142858,1,0.0,0,1,0,1,2,0,0,5,0,2,7,1
3247,47856,82BkQjqJpTLnL5kDgBNneTIQ8dLAyaMt,fbPkOYLVPtPgIt0MxizjfFJov3JbHyAi,6,7,3,0,0,0,5,0,15,2.142857142857143,2,0.0,0,3,0,0,7,0,0,5,0,3,12,1
3248,47857,r7L6HOKA435eaor9jfOstdB35ZN19tsN,fbPkOYLVPtPgIt0MxizjfFJov3JbHyAi,5,4,3,0,3,0,2,0,12,1.7142857142857142,1,0.0,0,3,0,3,4,0,0,2,0,6,6,1
3249,47858,4uvFeDWIZ6bzoupIa1lCMrJxU4bo03vY,fbPkOYLVPtPgIt0MxizjfFJov3JbHyAi,21,25,10,13,12,1,5,1,67,9.571428571428571,2,0.0,13,10,10,12,12,1,3,5,1,45,22,1
3250,47859,HlsUiRcEZx95oGsZBkao06lPbfTneh9d,fbPkOYLVPtPgIt0MxizjfFJov3JbHyAi,1,0,0,0,0,0,1,0,1,0.14285714285714285,1,0.0,0,0,0,0,0,0,0,1,0,0,1,1
3251,47860,3Fj747AfeK8Iy9OuiJhJRPDmQRCh2lEF,fbPkOYLVPtPgIt0MxizjfFJov3JbHyAi,7,11,6,0,6,1,2,0,26,3.7142857142857144,2,0.0,2,6,0,6,9,1,0,2,0,14,12,1
3252,47899,7x6GR5vcpLicOQJjWWlyJk5P5JNLZFuv,RXDvfPUBYFlVdlueBFbLW0mhhAyGEqpt,3,0,0,0,0,0,2,3,5,0.7142857142857143,1,0.0,0,0,0,0,0,0,0,2,3,0,5,1
3253,47931,ExNrdfeKsdYl3xmpiJlCBa13JPKyssuX,A3fsA9Zfv1X2fVEQhTw51lKENdNrEqT3,23,56,3,0,3,29,22,1,114,16.285714285714285,7,0.0,0,3,0,3,56,29,0,22,1,6,108,0
3254,47955,WCBxImuXCQhe4JCGgmUbhM2fHJqNW9fo,bWdj2GDclj5ofokWjzoa5jAwMkxCykd6,15,17,8,0,43,0,3,0,71,10.142857142857142,2,0.0,1,8,0,43,16,0,0,3,0,52,19,1
3255,47959,grSdEhkb3V38lf9YQcXO8O3GBe0inhXx,SpATywNh6bZuzm8s1ceuBUnMUAeoAHHw,22,53,0,17,0,2,10,0,82,11.714285714285714,2,0.0,13,0,17,0,40,2,0,10,0,30,52,0
3256,47976,HhK8Fr5pAwm4jm0sdGfJEGDMiAvZjcpI,bWdj2GDclj5ofokWjzoa5jAwMkxCykd6,6,1,1,0,1,0,3,0,6,0.8571428571428571,1,0.0,0,1,0,1,1,0,0,3,0,2,4,1
3257,47984,nC6UOgoIicf8pr79f2rdG7NgUQiopW9Q,bWdj2GDclj5ofokWjzoa5jAwMkxCykd6,6,11,7,0,3,2,2,0,25,3.5714285714285716,2,0.0,0,7,0,3,11,2,0,2,0,10,15,0
3258,47995,UjOHFBm02iem7rlbuAJcfFkUj4JVBikN,RXDvfPUBYFlVdlueBFbLW0mhhAyGEqpt,39,50,3,71,4,8,17,2,155,22.142857142857142,3,0.0,14,3,68,4,36,8,3,17,2,89,66,0
3259,48035,DX4dLCDX6l0Z68Mym7vcnKV6tMlkufOW,RXDvfPUBYFlVdlueBFbLW0mhhAyGEqpt,23,25,14,18,7,1,5,0,70,10.0,1,0.0,7,14,17,7,18,1,1,5,0,45,25,1
3260,48037,tK5QWvLAN98DDvHjcCO96Vrig3bCPcrd,RXDvfPUBYFlVdlueBFbLW0mhhAyGEqpt,44,102,4,154,15,12,14,2,303,43.285714285714285,3,0.0,37,4,132,15,65,12,22,14,2,188,115,0
3261,48066,waLyzusenGGt78OBjbfLuixQktneXMVQ,SpATywNh6bZuzm8s1ceuBUnMUAeoAHHw,14,27,1,17,1,21,9,1,77,11.0,1,0.0,16,1,14,1,11,21,3,9,1,32,45,0
3262,48069,S0OJjF6aof0iTnIX6lUAxekoH3m4w7V0,A3fsA9Zfv1X2fVEQhTw51lKENdNrEqT3,62,27,15,132,8,34,13,2,231,33.0,3,0.0,2,15,115,8,25,34,17,13,2,140,91,0
3263,48082,s13Zj70iGaPJV2HiUyzOXf2g6dcMZpb3,RXDvfPUBYFlVdlueBFbLW0mhhAyGEqpt,49,62,25,46,17,37,9,0,196,28.0,3,0.0,13,25,46,17,49,37,0,9,0,101,95,0
3264,48100,MEAK3CtWNpeCicplOKHcDUkHm4e2Gnat,A3fsA9Zfv1X2fVEQhTw51lKENdNrEqT3,26,11,9,68,3,0,2,0,93,13.285714285714286,1,0.0,0,9,55,3,11,0,13,2,0,67,26,0
3265,48118,9pydrkItOvXReb7xWe6yqdMpXhFzfa5K,SpATywNh6bZuzm8s1ceuBUnMUAeoAHHw,31,71,27,36,8,45,18,0,205,29.285714285714285,6,0.0,21,27,30,8,50,45,6,18,0,86,119,0
3266,48135,gtGDHRUZ7LgMlMOjWieE5uKSYCgIoTZ0,G8EPVSXsOYB5YQWZGiz1aVq5Pgr2GrQu,47,64,6,138,5,17,10,1,241,34.42857142857143,6,0.0,14,6,110,5,50,17,28,10,1,135,106,0
3267,48138,f3FFKNKPDIkY4ZzespQ1tkojfbmyOtUb,SpATywNh6bZuzm8s1ceuBUnMUAeoAHHw,30,110,39,31,19,137,60,7,403,57.57142857142857,10,0.0,18,39,28,19,92,137,3,60,7,104,299,0
3268,48148,2zQQnqY1LiZ9lcEXTzcE3zimEdKe8CdV,SpATywNh6bZuzm8s1ceuBUnMUAeoAHHw,31,48,27,23,11,13,17,3,142,20.285714285714285,6,0.0,14,27,23,11,34,13,0,17,3,75,67,0
3269,48179,HCOgsqUBNFumf2cCspNzKWg9hTVzHRVA,SpATywNh6bZuzm8s1ceuBUnMUAeoAHHw,29,23,14,20,10,3,11,3,84,12.0,3,0.0,9,14,16,10,14,3,4,11,3,49,35,1
3270,48197,5KWnGsOw1ONkUhC7cQevc5FAKOxsvvUS,SpATywNh6bZuzm8s1ceuBUnMUAeoAHHw,13,16,2,14,1,0,4,0,37,5.285714285714286,1,0.0,7,2,13,1,9,0,1,4,0,23,14,1
3271,48218,VBP5PzVQEKJYFH0y5ffEek5WfP9EW7uc,A3fsA9Zfv1X2fVEQhTw51lKENdNrEqT3,16,19,12,0,4,2,20,2,59,8.428571428571429,7,0.0,0,12,0,4,19,2,0,20,2,16,43,1
3272,48223,GfRp1O86gI5zJJh8SIJ1bczUJPWlAqoK,SpATywNh6bZuzm8s1ceuBUnMUAeoAHHw,19,27,0,34,0,0,10,1,72,10.285714285714286,1,0.0,8,0,29,0,19,0,5,10,1,37,35,0
3273,48255,gLAW4GOuyz8JKg5RO5Sf2rzir65isCiq,G8EPVSXsOYB5YQWZGiz1aVq5Pgr2GrQu,26,33,25,0,19,6,14,2,99,14.142857142857142,2,0.0,0,25,0,19,33,6,0,14,2,44,55,0
3274,48268,EhHrinjt1AkEWC09AFZwBuP61S5NJgjn,A3fsA9Zfv1X2fVEQhTw51lKENdNrEqT3,19,14,11,0,7,2,6,0,40,5.714285714285714,2,0.0,0,11,0,7,14,2,0,6,0,18,22,1
3275,48277,KJnvgR26H5LLeKdyvjJHjjqg4mjHEhgN,A3fsA9Zfv1X2fVEQhTw51lKENdNrEqT3,29,9,8,60,4,0,2,0,83,11.857142857142858,1,0.0,1,8,52,4,8,0,8,2,0,65,18,1
3276,48285,CQ3xdz8pT9zQNTAl7b68jJZVAWVF2aTL,SpATywNh6bZuzm8s1ceuBUnMUAeoAHHw,15,12,0,13,1,6,7,1,40,5.714285714285714,3,0.0,3,0,11,1,9,6,2,7,1,15,25,1
3277,48303,ibgC3AgPCiKxZzQtLwOtyIa6DJRV6K2p,SpATywNh6bZuzm8s1ceuBUnMUAeoAHHw,23,80,32,44,4,142,46,7,355,50.714285714285715,8,0.0,29,32,35,4,51,142,9,46,7,100,255,0
3278,48304,H5UEKpeYUS8ZwAU1o3ZTuTx8QVBIM5mj,SpATywNh6bZuzm8s1ceuBUnMUAeoAHHw,22,21,0,12,0,6,9,1,49,7.0,3,0.0,4,0,12,0,17,6,0,9,1,16,33,1
3279,48308,UqMl8IgLVIouo6TVWfUzDQbBX8JDKQrY,SpATywNh6bZuzm8s1ceuBUnMUAeoAHHw,1,0,0,0,0,0,1,0,1,0.14285714285714285,1,0.0,0,0,0,0,0,0,0,1,0,0,1,1
3280,48343,KJnvgR26H5LLeKdyvjJHjjqg4mjHEhgN,bWdj2GDclj5ofokWjzoa5jAwMkxCykd6,15,19,7,46,9,13,14,0,108,15.428571428571429,2,0.0,9,7,43,9,10,13,3,14,0,68,40,0
3281,48354,YUkia24kFQkJdU9Tc0bEfJWS5kFL3fnZ,SpATywNh6bZuzm8s1ceuBUnMUAeoAHHw,28,64,21,26,10,25,40,1,187,26.714285714285715,10,0.0,25,21,20,10,39,25,6,40,1,76,111,0
3282,48364,TMaAbfbbsUXbGWJIhu1feBQgRZO29am6,G8EPVSXsOYB5YQWZGiz1aVq5Pgr2GrQu,65,63,26,134,14,59,28,1,325,46.42857142857143,6,0.0,22,26,110,14,41,59,24,28,1,172,153,0
3283,48366,eQnxTOv5tF733HrH1v8IIfXTQQ20WB86,SpATywNh6bZuzm8s1ceuBUnMUAeoAHHw,23,21,13,12,6,6,31,1,90,12.857142857142858,7,0.0,4,13,12,6,17,6,0,31,1,35,55,0
3284,48410,fKzNFTbPePkMpMq31aLHMmVifATbrx2C,A3fsA9Zfv1X2fVEQhTw51lKENdNrEqT3,7,3,2,0,1,1,4,1,12,1.7142857142857142,1,0.0,0,2,0,1,3,1,0,4,1,3,9,1
3285,48450,oWaJx5przpU6lf15eldDAW9VD7f9UZbS,SpATywNh6bZuzm8s1ceuBUnMUAeoAHHw,17,14,8,6,4,18,10,2,62,8.857142857142858,2,0.0,3,8,6,4,11,18,0,10,2,21,41,0
3286,48466,zOGgv8cnkqEW7Y2l6fqZ3IzLqplNhsIx,SpATywNh6bZuzm8s1ceuBUnMUAeoAHHw,11,12,0,0,0,1,8,2,23,3.2857142857142856,2,0.0,2,0,0,0,10,1,0,8,2,2,21,1
3287,48480,T2e7T1KVGbCZHkx82TLCiB6K2groJqnl,SpATywNh6bZuzm8s1ceuBUnMUAeoAHHw,13,33,1,21,0,18,10,1,84,12.0,1,0.0,14,1,18,0,19,18,3,10,1,33,51,1
3288,48498,VEdQQ1yOFNqPNBrecyFKsnw5QECT7x69,SpATywNh6bZuzm8s1ceuBUnMUAeoAHHw,3,3,0,0,0,0,2,0,5,0.7142857142857143,1,0.0,0,0,0,0,3,0,0,2,0,0,5,1
3289,48509,a41llItPMmO7jtwR6NH41lmydyfI26Gz,SpATywNh6bZuzm8s1ceuBUnMUAeoAHHw,17,46,2,18,2,4,9,3,84,12.0,1,0.0,20,2,15,2,26,4,3,9,3,39,45,0
3290,48515,NCU9xqLhC281ErH7IwNmupIJSyhaNMZW,SpATywNh6bZuzm8s1ceuBUnMUAeoAHHw,13,14,8,12,5,0,9,0,48,6.857142857142857,2,0.0,6,8,11,5,8,0,1,9,0,30,18,0
3291,48524,aYYkr3EBoQc6U0mONjplTV8V30x3QwMR,SpATywNh6bZuzm8s1ceuBUnMUAeoAHHw,11,47,14,0,5,1,23,1,91,13.0,2,0.0,0,14,0,5,47,1,0,23,1,19,72,0
3292,48572,RvDbqb1jf5bMQYeeBsAiuychmXlXMqZ3,SpATywNh6bZuzm8s1ceuBUnMUAeoAHHw,12,22,7,18,2,26,11,1,87,12.428571428571429,2,0.0,10,7,15,2,12,26,3,11,1,34,53,0
3293,48579,OmRwEqIcEcFH28h4LCCN9RZtwAWWiBmW,SpATywNh6bZuzm8s1ceuBUnMUAeoAHHw,9,44,1,8,0,0,4,0,57,8.142857142857142,2,0.0,0,1,7,0,44,0,1,4,0,8,49,1
3294,48590,Bm1ROY20Td8ahvL40ylWLEiakWpICc5q,SpATywNh6bZuzm8s1ceuBUnMUAeoAHHw,7,6,4,0,3,0,3,0,16,2.2857142857142856,2,0.0,0,4,0,3,6,0,0,3,0,7,9,0
3295,48629,1ERwpt9wMj2n5z0yrcDeOTKwiq17bpYL,SpATywNh6bZuzm8s1ceuBUnMUAeoAHHw,18,22,15,12,8,0,9,1,67,9.571428571428571,3,0.0,3,15,11,8,19,0,1,9,1,37,30,0
3296,48647,A5P9jrlzLqQKpA3sVBvwbPCf9CAYmtxw,SpATywNh6bZuzm8s1ceuBUnMUAeoAHHw,30,47,15,33,9,44,8,1,157,22.428571428571427,4,0.0,22,15,27,9,25,44,6,8,1,73,84,0
3297,48677,miskafWCgRGEerOwmFhGeXinZmiVq8Xq,SpATywNh6bZuzm8s1ceuBUnMUAeoAHHw,14,13,6,16,4,5,6,0,50,7.142857142857143,2,0.0,6,6,13,4,7,5,3,6,0,29,21,0
3298,48733,mitKAcO5Yq84LGwUL473CFioIDbwQfRi,SpATywNh6bZuzm8s1ceuBUnMUAeoAHHw,21,35,20,26,0,6,18,0,105,15.0,5,0.0,7,20,26,0,28,6,0,18,0,53,52,0
3299,48743,geHYnGH5sQ7aHnnwLKBvDRjabqJU8jWh,RXDvfPUBYFlVdlueBFbLW0mhhAyGEqpt,9,8,1,0,1,3,6,3,22,3.142857142857143,1,0.0,0,1,0,1,8,3,0,6,3,2,20,1
3300,48764,oWaJx5przpU6lf15eldDAW9VD7f9UZbS,RXDvfPUBYFlVdlueBFbLW0mhhAyGEqpt,50,48,29,61,14,34,13,5,204,29.142857142857142,3,0.0,8,29,61,14,40,34,0,13,5,112,92,0
3301,48766,xBzkSH4dgUCYZ5BDcyxU9YukAdw2snHB,RXDvfPUBYFlVdlueBFbLW0mhhAyGEqpt,5,2,1,0,1,0,2,0,6,0.8571428571428571,1,0.0,0,1,0,1,2,0,0,2,0,2,4,1
3302,48788,IN0xY05lGNY1Rxj5WWCYq1C0mF0lQ2fJ,SpATywNh6bZuzm8s1ceuBUnMUAeoAHHw,14,26,1,12,0,26,11,2,78,11.142857142857142,1,0.0,10,1,10,0,16,26,2,11,2,21,57,0
3303,48803,GkoB2VZz49YRew10AQsiKgGNbvbaRd2W,SpATywNh6bZuzm8s1ceuBUnMUAeoAHHw,21,51,20,0,7,2,24,3,107,15.285714285714286,5,0.0,0,20,0,7,51,2,0,24,3,27,80,0
3304,48816,Vn131dD12fh0kapodbBhio0q4dV4IYmG,SpATywNh6bZuzm8s1ceuBUnMUAeoAHHw,21,22,12,14,5,22,9,1,85,12.142857142857142,2,0.0,6,12,14,5,16,22,0,9,1,37,48,0
3305,48847,zrYm7VvWMlvZCf7Dgu9kA0S4dPcpd9DE,G8EPVSXsOYB5YQWZGiz1aVq5Pgr2GrQu,1,0,0,0,0,0,1,0,1,0.14285714285714285,1,0.0,0,0,0,0,0,0,0,1,0,0,1,1
3306,48881,n7yQ1FvfAXqDnBpszfIUjZkrvw3J2aJC,A3fsA9Zfv1X2fVEQhTw51lKENdNrEqT3,2,0,0,0,0,0,2,0,2,0.2857142857142857,1,0.0,0,0,0,0,0,0,0,2,0,0,2,1
3307,48903,TdcZVkuHoNELu59WVF9f7EUYKiYIHP14,A3fsA9Zfv1X2fVEQhTw51lKENdNrEqT3,1,0,0,0,0,0,1,0,1,0.14285714285714285,1,0.0,0,0,0,0,0,0,0,1,0,0,1,0
3308,48953,cPrlzYoTDFDvccHbBKlJUrITep6ieC7X,SpATywNh6bZuzm8s1ceuBUnMUAeoAHHw,24,25,15,33,6,0,3,0,82,11.714285714285714,1,0.0,7,15,30,6,18,0,3,3,0,58,24,0
3309,48954,7Lv6OVvu1nsvUexcKSRks3wnATE3pr1d,G8EPVSXsOYB5YQWZGiz1aVq5Pgr2GrQu,3,0,0,0,0,0,3,0,3,0.42857142857142855,1,0.0,0,0,0,0,0,0,0,3,0,0,3,1
3310,48972,4IxIKalU9kAsrSpHM9QUN57NRdKohmHA,SpATywNh6bZuzm8s1ceuBUnMUAeoAHHw,9,15,0,10,0,0,6,0,31,4.428571428571429,1,0.0,11,0,10,0,4,0,0,6,0,21,10,0
3311,48991,aOfddFrct0TUA0MYqpcFv1UssmM1IX2e,SpATywNh6bZuzm8s1ceuBUnMUAeoAHHw,28,49,17,37,12,0,8,0,123,17.571428571428573,2,0.0,31,17,32,12,18,0,5,8,0,92,31,1
3312,49001,xLRXz6THj9rNHROqVgV4eCcKXyO03jXb,RXDvfPUBYFlVdlueBFbLW0mhhAyGEqpt,17,29,8,0,6,0,2,0,45,6.428571428571429,1,0.0,0,8,0,6,29,0,0,2,0,14,31,1
3313,49011,1fjO19pGLwHG3depgSJxIFrDpr07UqZK,SpATywNh6bZuzm8s1ceuBUnMUAeoAHHw,19,65,22,16,5,8,27,1,144,20.571428571428573,6,0.0,14,22,14,5,51,8,2,27,1,55,89,0
3314,49017,1fjO19pGLwHG3depgSJxIFrDpr07UqZK,bWdj2GDclj5ofokWjzoa5jAwMkxCykd6,6,5,1,0,1,0,5,0,12,1.7142857142857142,2,0.0,0,1,0,1,5,0,0,5,0,2,10,1
3315,49076,WSyXGkhm7NDepRlMA3agJj8k8GLnavsP,SpATywNh6bZuzm8s1ceuBUnMUAeoAHHw,28,64,34,15,12,31,47,6,209,29.857142857142858,7,0.0,8,34,13,12,56,31,2,47,6,67,142,0
3316,49093,KcyotPC829BMj56l23keqhJ3VB5WV4xY,A3fsA9Zfv1X2fVEQhTw51lKENdNrEqT3,5,5,1,0,0,1,4,0,11,1.5714285714285714,1,0.0,0,1,0,0,5,1,0,4,0,1,10,1
3317,49096,etO9cGvtnbcyDOUow8PWemZvzpbkeWT2,SpATywNh6bZuzm8s1ceuBUnMUAeoAHHw,15,31,5,10,2,0,15,0,63,9.0,7,0.0,3,5,10,2,28,0,0,15,0,20,43,0
3318,49129,5VPsupm8AUE2ZBwqUxHjS8zxcSp1Mcls,SpATywNh6bZuzm8s1ceuBUnMUAeoAHHw,31,39,18,43,8,31,22,1,162,23.142857142857142,3,0.0,14,18,35,8,25,31,8,22,1,75,87,0
3319,49132,gSsRzqNvll8eqcaaEGmB933OlJpuGX1g,G8EPVSXsOYB5YQWZGiz1aVq5Pgr2GrQu,74,76,20,162,17,3,25,2,305,43.57142857142857,5,0.0,48,20,122,17,28,3,40,25,2,207,98,0
3320,49139,cszgTMCcWdEja3BpEwPP5MtLXTMUMJXE,G8EPVSXsOYB5YQWZGiz1aVq5Pgr2GrQu,28,42,18,54,6,3,6,1,130,18.571428571428573,1,0.0,17,18,39,6,25,3,15,6,1,80,50,1
3321,49143,Jt2ZVEP2fRpS6kT1yCei4p4So6yqdxLs,SpATywNh6bZuzm8s1ceuBUnMUAeoAHHw,32,42,19,32,10,5,16,4,128,18.285714285714285,4,0.0,14,19,30,10,28,5,2,16,4,73,55,0
3322,49204,KWhhYcngkyB7QbL1Y9080mTGvLlZLj2v,SpATywNh6bZuzm8s1ceuBUnMUAeoAHHw,18,56,18,20,4,4,19,1,122,17.428571428571427,3,0.0,27,18,16,4,29,4,4,19,1,65,57,1
3323,49212,l70wRZ2DS0s6LjbT7C4gRoGrF27x9p2H,SpATywNh6bZuzm8s1ceuBUnMUAeoAHHw,16,26,0,18,0,10,9,0,63,9.0,5,0.0,7,0,17,0,19,10,1,9,0,24,39,0
3324,49237,Et66VbQRwkFnF42twZ8Z4ErFWQLehmwC,G8EPVSXsOYB5YQWZGiz1aVq5Pgr2GrQu,8,5,2,0,2,0,5,0,14,2.0,2,0.0,0,2,0,2,5,0,0,5,0,4,10,1
3325,49353,W6MGFBQ1Tov9lOeRQ8QlzHUMCDNEGRDq,SpATywNh6bZuzm8s1ceuBUnMUAeoAHHw,14,8,5,6,4,0,1,0,24,3.4285714285714284,1,0.0,2,5,6,4,6,0,0,1,0,17,7,1
3326,49357,oJ9j9ejTgKixczg3tSE8Sg8DPI7YQpJq,G8EPVSXsOYB5YQWZGiz1aVq5Pgr2GrQu,39,46,16,53,7,6,7,0,135,19.285714285714285,3,0.0,25,16,35,7,21,6,18,7,0,83,52,0
3327,49397,uZVvmJaNXb0GsvOW7SvWgzrpxZ3muXeW,SpATywNh6bZuzm8s1ceuBUnMUAeoAHHw,24,28,8,33,5,15,14,2,105,15.0,6,0.0,14,8,32,5,14,15,1,14,2,59,46,0
3328,49410,tzUG2qRl7N6mPYRCQUU2RS3J3hIQZLrD,bWdj2GDclj5ofokWjzoa5jAwMkxCykd6,1,0,0,0,0,0,1,0,1,0.14285714285714285,1,0.0,0,0,0,0,0,0,0,1,0,0,1,1
3329,49481,2uoMQOxqyRzmIYFGnyAflqy5t44QW2xE,G8EPVSXsOYB5YQWZGiz1aVq5Pgr2GrQu,23,59,25,6,18,0,13,0,121,17.285714285714285,4,0.0,21,25,3,18,38,0,3,13,0,67,54,0
3330,49492,8zWgVyFjldbfjgOVhyVSCY9hVHofzB37,SpATywNh6bZuzm8s1ceuBUnMUAeoAHHw,26,48,9,16,6,1,10,1,91,13.0,8,0.0,9,9,16,6,39,1,0,10,1,40,51,0
3331,49507,IFqWOl32JJm0W3Ap2jxVCpJeXeLJlYDp,bWdj2GDclj5ofokWjzoa5jAwMkxCykd6,6,7,4,0,2,0,3,0,16,2.2857142857142856,2,0.0,1,4,0,2,6,0,0,3,0,7,9,1
3332,49593,tLAxgBhXx0zpE8fWNnwggaJx5LeHI2h1,A3fsA9Zfv1X2fVEQhTw51lKENdNrEqT3,54,47,24,118,14,0,5,0,208,29.714285714285715,4,0.0,1,24,103,14,46,0,15,5,0,142,66,1
3333,49675,vEvuCci9jxTTRH9CGXFnMQL31rdrARkm,RXDvfPUBYFlVdlueBFbLW0mhhAyGEqpt,8,12,7,0,2,0,7,0,28,4.0,3,0.0,0,7,0,2,12,0,0,7,0,9,19,1
3334,49713,3mhHS6HFiNSDTjK0MItggE081qDKfyqL,SpATywNh6bZuzm8s1ceuBUnMUAeoAHHw,15,23,9,14,3,14,9,0,72,10.285714285714286,4,0.0,9,9,11,3,14,14,3,9,0,32,40,0
3335,49733,YIbC1cuJA4PbBVwCZRQOVlAtofCW8hIn,A3fsA9Zfv1X2fVEQhTw51lKENdNrEqT3,42,14,11,56,9,0,4,0,94,13.428571428571429,3,0.0,1,11,48,9,13,0,8,4,0,69,25,1
3336,49779,W6MGFBQ1Tov9lOeRQ8QlzHUMCDNEGRDq,A3fsA9Zfv1X2fVEQhTw51lKENdNrEqT3,60,42,22,92,14,0,7,0,177,25.285714285714285,4,0.0,3,22,88,14,39,0,4,7,0,127,50,0
3337,49875,0Akk5gAtNLhWs93rvoK6BfZzftMu43VT,SpATywNh6bZuzm8s1ceuBUnMUAeoAHHw,1,0,0,0,0,0,1,0,1,0.14285714285714285,1,0.0,0,0,0,0,0,0,0,1,0,0,1,0
3338,49878,fvzGqz3wcA15cPFjEfZNgqzkQDubcDYj,SpATywNh6bZuzm8s1ceuBUnMUAeoAHHw,15,73,44,18,0,16,26,3,180,25.714285714285715,3,0.0,9,44,15,0,64,16,3,26,3,68,112,0
3339,49885,v8BycPX41vEGxhnmXhJJeiFe4eT4u7RK,SpATywNh6bZuzm8s1ceuBUnMUAeoAHHw,20,17,11,28,0,3,7,0,66,9.428571428571429,3,0.0,4,11,24,0,13,3,4,7,0,39,27,0
3340,49941,C4q4gNQYEpjKh7pq1qjN8i3L7uSpUX9d,RXDvfPUBYFlVdlueBFbLW0mhhAyGEqpt,8,5,2,0,2,0,1,0,10,1.4285714285714286,1,0.0,0,2,0,2,5,0,0,1,0,4,6,1
3341,49947,xXjBI1Nf4mgkfSUkf8YjQF9E0XahXwSr,SpATywNh6bZuzm8s1ceuBUnMUAeoAHHw,17,17,8,6,4,14,8,1,58,8.285714285714286,2,0.0,7,8,6,4,10,14,0,8,1,25,33,0
3342,49980,fFjj8aLqWVfTrDoDqL54VYBbLQmMY3Y1,G8EPVSXsOYB5YQWZGiz1aVq5Pgr2GrQu,25,58,1,40,4,0,17,2,122,17.428571428571427,4,0.0,40,1,32,4,18,0,8,17,2,77,45,1
3343,49981,Q0d1WItnRJvnzlnn5VcAU6GMGN4rfbYJ,A3fsA9Zfv1X2fVEQhTw51lKENdNrEqT3,5,4,2,0,0,0,11,0,17,2.4285714285714284,2,0.0,0,2,0,0,4,0,0,11,0,2,15,1
3344,49986,cT0XTodWylQtczhaeg1zuAXwbhCqeXWR,SpATywNh6bZuzm8s1ceuBUnMUAeoAHHw,13,22,2,5,2,0,7,0,38,5.428571428571429,3,0.0,0,2,4,2,22,0,1,7,0,8,30,0
3345,50006,IjWCyY0OMptnbDif5zdKxFY839cuvS21,SpATywNh6bZuzm8s1ceuBUnMUAeoAHHw,11,13,1,7,0,0,2,0,23,3.2857142857142856,1,0.0,0,1,7,0,13,0,0,2,0,8,15,0
3346,50023,Eu9HoDt3WhECHgcXaERosbI6lMj7Hipb,A3fsA9Zfv1X2fVEQhTw51lKENdNrEqT3,52,60,50,90,40,17,11,1,269,38.42857142857143,4,0.0,2,50,73,40,58,17,17,11,1,165,104,1
3347,50027,tWEnJYIhXMJ03Foo959mubaAJUHZPTw0,SpATywNh6bZuzm8s1ceuBUnMUAeoAHHw,24,73,1,48,0,50,15,3,190,27.142857142857142,3,0.0,15,1,41,0,58,50,7,15,3,57,133,0
3348,50028,9e5dcfJQbPUU8sTcmzE9DWoDPOA9Nhu3,A3fsA9Zfv1X2fVEQhTw51lKENdNrEqT3,7,10,1,0,1,0,1,0,13,1.8571428571428572,1,0.0,0,1,0,1,10,0,0,1,0,2,11,0
3349,50032,aKjAC5UWlmbeTD1k9n3NGSA3VSvaAKtm,SpATywNh6bZuzm8s1ceuBUnMUAeoAHHw,16,23,10,16,5,7,9,1,71,10.142857142857142,2,0.0,9,10,13,5,14,7,3,9,1,37,34,0
3350,50037,5ARkGJ4p1hrN1paVNwlZ2LmySeAZIjWv,SpATywNh6bZuzm8s1ceuBUnMUAeoAHHw,7,7,4,0,2,0,3,0,16,2.2857142857142856,1,0.0,0,4,0,2,7,0,0,3,0,6,10,1
3351,50084,1HlQxNM9nR1hj1jXFLyimiGxZiQUWT8w,RXDvfPUBYFlVdlueBFbLW0mhhAyGEqpt,17,22,7,14,12,8,7,2,72,10.285714285714286,3,0.0,10,7,12,12,12,8,2,7,2,41,31,1
3352,50161,vQxwNbtZgUat9SDZRmE7MEKdvAizpBwk,SpATywNh6bZuzm8s1ceuBUnMUAeoAHHw,19,31,0,17,0,2,3,0,53,7.571428571428571,1,0.0,6,0,17,0,25,2,0,3,0,23,30,0
3353,50170,jJ6KwmQPdHVF9SNnawJ7zfgWoExKlRbO,SpATywNh6bZuzm8s1ceuBUnMUAeoAHHw,3,3,1,0,0,0,2,0,6,0.8571428571428571,1,0.0,0,1,0,0,3,0,0,2,0,1,5,1
3354,50173,lVM3D8yPmd62Fdb29hI2YI0VPwlNvI4t,bWdj2GDclj5ofokWjzoa5jAwMkxCykd6,5,2,1,0,1,0,4,0,8,1.1428571428571428,2,0.0,0,1,0,1,2,0,0,4,0,2,6,1
3355,50203,8ZgsKNDzCbgk8zoZndfYiYFsfvE0SQgi,SpATywNh6bZuzm8s1ceuBUnMUAeoAHHw,25,45,6,30,3,1,16,1,102,14.571428571428571,5,0.0,19,6,26,3,26,1,4,16,1,54,48,0
3356,50223,l5LfU8gApOG72AnBkdAbfOLQLwFH7Zo2,SpATywNh6bZuzm8s1ceuBUnMUAeoAHHw,26,53,6,26,3,19,11,0,118,16.857142857142858,7,0.0,13,6,20,3,40,19,6,11,0,42,76,0
3357,50294,mexTVUuTBaMSHWugjgX7gCSwX1B8AubF,SpATywNh6bZuzm8s1ceuBUnMUAeoAHHw,5,8,0,0,0,0,2,0,10,1.4285714285714286,1,0.0,0,0,0,0,8,0,0,2,0,0,10,0
3358,50352,BS7u1moD4G6tIsp3i8TsGiKk2duVqSQ0,G8EPVSXsOYB5YQWZGiz1aVq5Pgr2GrQu,1,0,0,0,0,0,1,0,1,0.14285714285714285,1,0.0,0,0,0,0,0,0,0,1,0,0,1,1
3359,50361,Gur5FuhE9EyV9K1F0qLPk7AenhoY8PBS,SpATywNh6bZuzm8s1ceuBUnMUAeoAHHw,16,16,0,24,0,34,18,3,95,13.571428571428571,2,0.0,5,0,18,0,11,34,6,18,3,23,72,1
3360,50380,Xdag5jOmE7uWC3FmBvgPc5F7lO3QNcPW,bWdj2GDclj5ofokWjzoa5jAwMkxCykd6,18,57,24,48,7,45,27,5,213,30.428571428571427,4,0.0,7,24,42,7,50,45,6,27,5,80,133,0
3361,50383,wcXKTRp3782w7z3pcKy7I4KlcLaVU81W,SpATywNh6bZuzm8s1ceuBUnMUAeoAHHw,10,10,1,0,1,0,2,0,14,2.0,1,0.0,0,1,0,1,10,0,0,2,0,2,12,0
3362,50422,SnivjdMp3HL6G23yPscSnzZlAD2Rbyt6,bWdj2GDclj5ofokWjzoa5jAwMkxCykd6,14,31,16,28,11,13,4,0,103,14.714285714285714,4,0.0,10,16,24,11,21,13,4,4,0,61,42,1
3363,50455,9jNN69RJsAFkkuYDPHWQVpfsVwA6mFxd,SpATywNh6bZuzm8s1ceuBUnMUAeoAHHw,22,31,19,32,0,0,6,0,88,12.571428571428571,3,0.0,4,19,29,0,27,0,3,6,0,52,36,0
3364,50460,DRhlp1eJHQqsxjCL0bRD6kkHN20HbJ4w,RXDvfPUBYFlVdlueBFbLW0mhhAyGEqpt,14,9,6,12,5,0,2,0,34,4.857142857142857,3,0.0,1,6,12,5,8,0,0,2,0,24,10,1
3365,50485,bZVDIvmAMciYIQrrbhRx0jvH9Tiicfyn,SpATywNh6bZuzm8s1ceuBUnMUAeoAHHw,14,23,0,14,0,5,6,0,48,6.857142857142857,2,0.0,5,0,13,0,18,5,1,6,0,18,30,0
3366,50526,SKzEklIJtB0H7qSb29ZCLXx6x8polS8t,G8EPVSXsOYB5YQWZGiz1aVq5Pgr2GrQu,10,5,3,0,0,2,7,2,19,2.7142857142857144,1,0.0,0,3,0,0,5,2,0,7,2,3,16,1
3367,50572,XIlz5QvnlEzidDqYGld3VSh8CaOyBXAa,RXDvfPUBYFlVdlueBFbLW0mhhAyGEqpt,13,13,8,0,6,0,10,0,37,5.285714285714286,3,0.0,1,8,0,6,12,0,0,10,0,15,22,1
3368,50609,THlX4ibtjGYQg6ZUfc8ItvnKMtOly4Xi,SpATywNh6bZuzm8s1ceuBUnMUAeoAHHw,21,28,14,0,9,1,8,0,60,8.571428571428571,2,0.0,0,14,0,9,28,1,0,8,0,23,37,0
3369,50632,DeyP5lAVv1H3yXRPzbyis5xLngeggxpO,RXDvfPUBYFlVdlueBFbLW0mhhAyGEqpt,12,16,8,0,3,1,10,1,39,5.571428571428571,2,0.0,0,8,0,3,16,1,0,10,1,11,28,1
3370,50670,IDqUeKOsakXfpJsNR0qoC3jJJuHYmkPd,SpATywNh6bZuzm8s1ceuBUnMUAeoAHHw,5,13,1,0,0,0,3,1,18,2.5714285714285716,2,0.0,0,1,0,0,13,0,0,3,1,1,17,0
3371,50692,BfoybeaeQZxTt069jPLA4qjwQgNZD97I,G8EPVSXsOYB5YQWZGiz1aVq5Pgr2GrQu,17,22,0,10,0,18,13,2,65,9.285714285714286,1,0.0,6,0,5,0,16,18,5,13,2,11,54,1
3372,50703,AEOK3hwhmsMNDRL3o1uoaIUrWvSc7heg,SpATywNh6bZuzm8s1ceuBUnMUAeoAHHw,5,5,1,0,0,0,2,0,8,1.1428571428571428,1,0.0,2,1,0,0,3,0,0,2,0,3,5,1
3373,50738,9va47BxxunDTlRdlZXe6vZY5WX0faoXZ,G8EPVSXsOYB5YQWZGiz1aVq5Pgr2GrQu,30,12,0,110,0,0,8,1,131,18.714285714285715,1,0.0,3,0,93,0,9,0,17,8,1,96,35,1
3374,50777,se9ZVl8DNkiCW8i2nP0p3krrUcQqYC47,bWdj2GDclj5ofokWjzoa5jAwMkxCykd6,19,34,18,114,9,5,14,2,196,28.0,5,0.0,8,18,111,9,26,5,3,14,2,146,50,0
3375,50789,3URMlJ8WFfbFx3SvBMPqUCA5oJqCky66,RXDvfPUBYFlVdlueBFbLW0mhhAyGEqpt,1,0,0,0,0,0,1,0,1,0.14285714285714285,1,0.0,0,0,0,0,0,0,0,1,0,0,1,1
3376,50797,BWuaSpfjjWoQ6suviyDvOJ1XUJLgJBtc,SpATywNh6bZuzm8s1ceuBUnMUAeoAHHw,32,32,16,36,10,47,15,3,159,22.714285714285715,4,0.0,12,16,30,10,20,47,6,15,3,68,91,0
3377,50805,1HrXazG6mMhlQyrWzEYwtGHFWa0bXXko,SpATywNh6bZuzm8s1ceuBUnMUAeoAHHw,2,0,0,0,0,0,2,0,2,0.2857142857142857,2,0.0,0,0,0,0,0,0,0,2,0,0,2,0
3378,50808,xm9wUIf1J8EjTNxXT4ffEWzhuySk21YK,RXDvfPUBYFlVdlueBFbLW0mhhAyGEqpt,47,85,38,108,50,2,9,1,293,41.857142857142854,5,0.0,14,38,101,50,71,2,7,9,1,203,90,0
3379,50835,KH1qoBE3q99uPmQbxyBhuyXhrxNuFdJJ,A3fsA9Zfv1X2fVEQhTw51lKENdNrEqT3,1,0,0,0,0,0,1,0,1,0.14285714285714285,1,0.0,0,0,0,0,0,0,0,1,0,0,1,1
3380,50841,POGRFFRZzlPiBHiCHXnlCDCb459JTEzc,G8EPVSXsOYB5YQWZGiz1aVq5Pgr2GrQu,50,75,1,160,1,5,11,0,253,36.142857142857146,5,0.0,13,1,129,1,62,5,31,11,0,144,109,0
3381,52414,LwOwoJdIBH6qSphf2Y21IIrVgEcOPNno,7GRhBDsirIGkRZBtSMEzNTyDr2JQm4xx,8,4,1,0,0,3,11,0,19,2.7142857142857144,1,0.0,0,1,0,0,4,3,0,11,0,1,18,1
3382,52418,AWLXkSqW4e7SbhduVpZ7fOXghxuuP6q1,7GRhBDsirIGkRZBtSMEzNTyDr2JQm4xx,35,45,15,54,16,0,5,0,135,19.285714285714285,2,0.0,27,15,47,16,18,0,7,5,0,105,30,1
3383,52525,7tM0glf5iOjFrrOx11jEjeXPWGg1qnPf,7GRhBDsirIGkRZBtSMEzNTyDr2JQm4xx,27,57,20,125,9,7,13,0,231,33.0,4,0.0,24,20,124,9,33,7,1,13,0,177,54,1
3384,52527,3EXQpH44dmXe1KuNCn9IRB8zLxVzdC0Z,7GRhBDsirIGkRZBtSMEzNTyDr2JQm4xx,4,2,0,0,0,0,2,0,4,0.5714285714285714,2,0.0,0,0,0,0,2,0,0,2,0,0,4,1
3385,52564,KFkM2LdM6U7FLDyErp7vnT4e1T4YjeOt,7GRhBDsirIGkRZBtSMEzNTyDr2JQm4xx,1,0,0,0,0,0,1,0,1,0.14285714285714285,1,0.0,0,0,0,0,0,0,0,1,0,0,1,1
3386,52609,pf5bjcn02zW6F9NEdRWcVWa4U5P6G0ff,7GRhBDsirIGkRZBtSMEzNTyDr2JQm4xx,16,11,1,24,0,0,3,0,39,5.571428571428571,2,0.0,0,1,21,0,11,0,3,3,0,22,17,1
3387,52629,N1ze97FAwTuBZx89GGh4oyy7kZndQ2aO,7GRhBDsirIGkRZBtSMEzNTyDr2JQm4xx,1,0,0,0,0,0,1,0,1,0.14285714285714285,1,0.0,0,0,0,0,0,0,0,1,0,0,1,1
3388,52648,PCT9UecTLFgHQMLESQLM3zo2VKyldhOq,7GRhBDsirIGkRZBtSMEzNTyDr2JQm4xx,54,135,3,180,16,29,13,2,378,54.0,4,0.0,78,3,161,16,57,29,19,13,2,258,120,0
3389,52708,qZCURwy8JtTyuwzOv8VNGZdlPKRFUQ4x,7GRhBDsirIGkRZBtSMEzNTyDr2JQm4xx,6,4,1,0,1,2,8,0,16,2.2857142857142856,2,0.0,0,1,0,1,4,2,0,8,0,2,14,1
3390,52730,8XaoEwTyWeXdGPkk69feFC4MnARlyEPY,7GRhBDsirIGkRZBtSMEzNTyDr2JQm4xx,6,4,2,0,1,0,5,0,12,1.7142857142857142,2,0.0,0,2,0,1,4,0,0,5,0,3,9,0
3391,52753,SwHZgUxPjIeMthkMeeVpPfNadNOmRqaT,7GRhBDsirIGkRZBtSMEzNTyDr2JQm4xx,9,3,2,0,3,0,2,0,10,1.4285714285714286,1,0.0,0,2,0,3,3,0,0,2,0,5,5,1
3392,52762,yoBRTcR2cnNdwxBl8X3b5dAnEe5pLM8o,7GRhBDsirIGkRZBtSMEzNTyDr2JQm4xx,27,59,15,24,16,0,3,0,117,16.714285714285715,1,0.0,22,15,21,16,37,0,3,3,0,74,43,1
3393,52767,oegjA7ZBrBlZ5Cd9WyrHTpKnm4129pWq,7GRhBDsirIGkRZBtSMEzNTyDr2JQm4xx,3,3,1,0,0,0,1,0,5,0.7142857142857143,1,0.0,0,1,0,0,3,0,0,1,0,1,4,0
3394,52794,ZI5bmLXRjGY30yDOOtLk3SjipijnEDdH,7GRhBDsirIGkRZBtSMEzNTyDr2JQm4xx,40,114,35,60,19,2,11,0,241,34.42857142857143,4,0.0,44,35,50,19,70,2,10,11,0,148,93,1
3395,52796,5PAJAhGm6mrmRya9bVA0TVEjvyxWSpHH,7GRhBDsirIGkRZBtSMEzNTyDr2JQm4xx,1,0,0,0,0,0,1,0,1,0.14285714285714285,1,0.0,0,0,0,0,0,0,0,1,0,0,1,1
3396,52797,JIMEFE3LdWAEpCV2LFwTCYSPjTS7eSnb,7GRhBDsirIGkRZBtSMEzNTyDr2JQm4xx,1,0,0,0,0,0,2,0,2,0.2857142857142857,1,0.0,0,0,0,0,0,0,0,2,0,0,2,1
3397,52822,kXa3f0Vj2v6uxMPIg14PPBVn8OhOZ096,7GRhBDsirIGkRZBtSMEzNTyDr2JQm4xx,2,0,0,0,0,0,2,0,2,0.2857142857142857,1,0.0,0,0,0,0,0,0,0,2,0,0,2,1
3398,52863,3AQcLF4401vlSQmnRaDEtc72D2nXEfx6,7GRhBDsirIGkRZBtSMEzNTyDr2JQm4xx,3,0,0,0,0,0,4,0,4,0.5714285714285714,2,0.0,0,0,0,0,0,0,0,4,0,0,4,1
3399,52951,ZFZTZbiKHOXenp1TWxEkC4SRLbwYuUkm,7GRhBDsirIGkRZBtSMEzNTyDr2JQm4xx,2,0,0,0,0,0,2,0,2,0.2857142857142857,1,0.0,0,0,0,0,0,0,0,2,0,0,2,1
3400,52952,MfF2UM103u4NW6P3ppuUwg5ByBUcnBZA,7GRhBDsirIGkRZBtSMEzNTyDr2JQm4xx,1,0,0,0,0,0,1,0,1,0.14285714285714285,1,0.0,0,0,0,0,0,0,0,1,0,0,1,1
3401,52976,IiVkIz2ymD5LAyFMLUAoz4dlLCufsOLN,7GRhBDsirIGkRZBtSMEzNTyDr2JQm4xx,1,0,0,0,0,0,1,0,1,0.14285714285714285,1,0.0,0,0,0,0,0,0,0,1,0,0,1,0
3402,52994,KogrHROquIJLSXIZqzhYU9Hcb9zVebwT,7GRhBDsirIGkRZBtSMEzNTyDr2JQm4xx,18,25,4,24,7,0,1,0,61,8.714285714285714,1,0.0,10,4,22,7,15,0,2,1,0,43,18,1
3403,53007,0d9QTHxHI38QwsI8Nrfe3h4nIFkKB9wm,7GRhBDsirIGkRZBtSMEzNTyDr2JQm4xx,67,110,40,114,28,10,6,0,308,44.0,4,0.0,44,40,100,28,66,10,14,6,0,212,96,0
3404,53015,zKm7XBlAnX1kvqmnbBunuJ0zgW910NPD,7GRhBDsirIGkRZBtSMEzNTyDr2JQm4xx,2,0,0,0,0,0,2,0,2,0.2857142857142857,1,0.0,0,0,0,0,0,0,0,2,0,0,2,1
3405,53030,KR1JBNTPMvAMQwZ6jsgCry7qScNUELlI,7GRhBDsirIGkRZBtSMEzNTyDr2JQm4xx,1,0,0,0,0,0,1,0,1,0.14285714285714285,1,0.0,0,0,0,0,0,0,0,1,0,0,1,1
3406,53034,TCECwaNYQUDA9PVYFYURPe0mJR7V4JvI,SpATywNh6bZuzm8s1ceuBUnMUAeoAHHw,5,2,1,0,1,0,3,0,7,1.0,2,0.0,0,1,0,1,2,0,0,3,0,2,5,0
3407,53041,FW02PfU8vx3pzmS7oOXpJualmcvfngs4,SpATywNh6bZuzm8s1ceuBUnMUAeoAHHw,23,93,3,27,3,0,16,0,142,20.285714285714285,4,0.0,33,3,23,3,60,0,4,16,0,62,80,0
3408,53043,4LLdV2zTWS697dAsOgAPJZPFwfNnrjt6,SpATywNh6bZuzm8s1ceuBUnMUAeoAHHw,18,17,12,4,9,2,6,0,50,7.142857142857143,3,0.0,2,12,4,9,15,2,0,6,0,27,23,0
3409,53050,dy8SjTNGjfrg38FBIbengGqlbDgTOAri,bWdj2GDclj5ofokWjzoa5jAwMkxCykd6,7,3,2,0,2,0,2,0,9,1.2857142857142858,1,0.0,0,2,0,2,3,0,0,2,0,4,5,1
3410,53055,1EHzEIUJa67W0jqPggV7KDaLGgi5Qkxp,SpATywNh6bZuzm8s1ceuBUnMUAeoAHHw,22,25,12,11,8,1,4,0,61,8.714285714285714,3,0.0,8,12,11,8,17,1,0,4,0,39,22,1
3411,53074,vwFaMtviPYvvdeDxiexQOh059O9Yefj1,SpATywNh6bZuzm8s1ceuBUnMUAeoAHHw,18,74,10,0,11,1,13,2,111,15.857142857142858,5,0.0,6,10,0,11,68,1,0,13,2,27,84,1
3412,53087,Bos3zEEnAcYzPXQktMkJJ0ak5mhGWCAf,A3fsA9Zfv1X2fVEQhTw51lKENdNrEqT3,67,42,20,104,13,0,6,0,185,26.428571428571427,3,0.0,4,20,103,13,38,0,1,6,0,140,45,1
3413,53099,l5zm2dyq1Lp4ch4ILKl8mqNj892nMhsW,A3fsA9Zfv1X2fVEQhTw51lKENdNrEqT3,13,18,11,0,2,2,14,1,48,6.857142857142857,3,0.0,0,11,0,2,18,2,0,14,1,13,35,1
3414,53104,f3SUvLtMnVyEZPEDJVhRMSC5cEFasHSH,G8EPVSXsOYB5YQWZGiz1aVq5Pgr2GrQu,14,16,10,2,3,1,8,1,41,5.857142857142857,3,0.0,4,10,1,3,12,1,1,8,1,18,23,1
3415,53109,fFw6uRnMpWU4RqpwQO2WZ8GCAi6hyn9t,SpATywNh6bZuzm8s1ceuBUnMUAeoAHHw,31,39,19,31,12,5,18,1,125,17.857142857142858,4,0.0,7,19,27,12,32,5,4,18,1,65,60,0
3416,53110,ovvuiEhj0QBv4xi11GVjXr8JhlCgaPmd,bWdj2GDclj5ofokWjzoa5jAwMkxCykd6,35,47,18,288,7,17,29,0,406,58.0,3,0.0,16,18,264,7,31,17,24,29,0,305,101,0
3417,53122,OOC2fhf6AkZDpDsl3NCh3irgmTTqQt8y,G8EPVSXsOYB5YQWZGiz1aVq5Pgr2GrQu,3,0,0,0,0,1,2,0,3,0.42857142857142855,1,0.0,0,0,0,0,0,1,0,2,0,0,3,1
3418,53138,SSeq3zqfD5kMUB9gUKp0rdzGfihYMJi7,A3fsA9Zfv1X2fVEQhTw51lKENdNrEqT3,1,0,0,0,0,0,1,0,1,0.14285714285714285,1,0.0,0,0,0,0,0,0,0,1,0,0,1,1
3419,53142,AjsS25Vcjgm2GGcNjE7GPEmmTU7snmJA,SpATywNh6bZuzm8s1ceuBUnMUAeoAHHw,24,43,16,30,9,7,9,1,115,16.428571428571427,4,0.0,19,16,28,9,24,7,2,9,1,72,43,0
3420,53149,fkwxmynqKl1E9zGnE59tFxhsiBODuFhR,SpATywNh6bZuzm8s1ceuBUnMUAeoAHHw,6,3,1,0,1,0,2,0,7,1.0,1,0.0,0,1,0,1,3,0,0,2,0,2,5,1
3421,53157,H8hoxOy1VDjrCqtl8Y1RjEzCSImzfPb1,SpATywNh6bZuzm8s1ceuBUnMUAeoAHHw,31,34,15,34,9,15,8,5,120,17.142857142857142,3,0.0,15,15,29,9,19,15,5,8,5,68,52,1
3422,53160,PPZEwof9f8rZx0lcTpURHpbkLB2YY5hH,A3fsA9Zfv1X2fVEQhTw51lKENdNrEqT3,8,7,4,0,2,0,8,0,21,3.0,3,0.0,0,4,0,2,7,0,0,8,0,6,15,1
3423,53162,4nHfdAZtp0niyFyrjm2L6LhTVPrJBlZM,A3fsA9Zfv1X2fVEQhTw51lKENdNrEqT3,70,44,22,144,13,9,29,1,262,37.42857142857143,8,0.0,6,22,127,13,38,9,17,29,1,168,94,1
3424,53178,kgME9COu6f9ljQ8FhJeUQLVyeGDbkeLG,SpATywNh6bZuzm8s1ceuBUnMUAeoAHHw,15,15,1,24,0,0,4,0,44,6.285714285714286,2,0.0,6,1,21,0,9,0,3,4,0,28,16,1
3425,53190,cWykzNKAq5sFQBA059QN4Jx74YGPkfwB,SpATywNh6bZuzm8s1ceuBUnMUAeoAHHw,5,7,0,0,0,0,5,0,12,1.7142857142857142,2,0.0,0,0,0,0,7,0,0,5,0,0,12,0
3426,53199,RfxrjGWEyzBCwnQEmvcmVh3DEMcbhg4m,bWdj2GDclj5ofokWjzoa5jAwMkxCykd6,8,9,6,0,5,0,4,0,24,3.4285714285714284,2,0.0,0,6,0,5,9,0,0,4,0,11,13,1
3427,53220,5TX7mZmksEi56P8MasqobWPGE5NBw2IQ,A3fsA9Zfv1X2fVEQhTw51lKENdNrEqT3,10,8,7,0,6,0,2,0,23,3.2857142857142856,1,0.0,0,7,0,6,8,0,0,2,0,13,10,1
3428,53233,nOWqKetxGFQ9o73UNfcoh0XyCt3ITawR,SpATywNh6bZuzm8s1ceuBUnMUAeoAHHw,27,52,18,28,8,0,7,0,113,16.142857142857142,5,0.0,14,18,25,8,38,0,3,7,0,65,48,0
3429,53242,XHTKaBKRPxCmq5MPcwRRZlQAa68hU6KT,RXDvfPUBYFlVdlueBFbLW0mhhAyGEqpt,15,7,3,31,2,1,3,0,47,6.714285714285714,1,0.0,3,3,28,2,4,1,3,3,0,36,11,1
3430,53244,cW2Xkl8EMUT4ygDkm6LqHv4BqvkNTIWA,SpATywNh6bZuzm8s1ceuBUnMUAeoAHHw,9,3,2,0,2,1,5,0,13,1.8571428571428572,1,0.0,0,2,0,2,3,1,0,5,0,4,9,1
3431,53245,2Bc3e8bWl6DTvfTPBZCyShFFG8OApkva,G8EPVSXsOYB5YQWZGiz1aVq5Pgr2GrQu,23,45,16,20,12,16,5,0,114,16.285714285714285,4,0.0,13,16,15,12,32,16,5,5,0,56,58,1
3432,53253,nsNOT1cU6IuLaV7JjnTNsqpFb1YDxqEb,SpATywNh6bZuzm8s1ceuBUnMUAeoAHHw,21,56,22,16,2,57,25,4,182,26.0,8,0.0,16,22,13,2,40,57,3,25,4,53,129,0
3433,53264,cWykzNKAq5sFQBA059QN4Jx74YGPkfwB,bWdj2GDclj5ofokWjzoa5jAwMkxCykd6,7,6,1,0,1,0,3,0,11,1.5714285714285714,2,0.0,0,1,0,1,6,0,0,3,0,2,9,0
3434,53267,alOTnyZzhm1w471FhEQsPMZXRjsY4Vw8,SpATywNh6bZuzm8s1ceuBUnMUAeoAHHw,14,14,6,13,3,0,3,0,39,5.571428571428571,1,0.0,7,6,10,3,7,0,3,3,0,26,13,1
3435,53274,OfEWzuzCYpLy1DIkUzWxNoBbzCb9peT6,SpATywNh6bZuzm8s1ceuBUnMUAeoAHHw,6,4,1,0,0,0,6,0,11,1.5714285714285714,1,0.0,0,1,0,0,4,0,0,6,0,1,10,0
3436,53297,wEZByhPumKHDR8Jv649KZn2fKnoB4Z7a,RXDvfPUBYFlVdlueBFbLW0mhhAyGEqpt,59,83,2,168,4,6,5,1,269,38.42857142857143,2,0.0,23,2,161,4,60,6,7,5,1,190,79,0
3437,53298,TL33IPw9u5rF9KFoVrfFEZ81kglnbuR1,bWdj2GDclj5ofokWjzoa5jAwMkxCykd6,1,0,0,0,0,0,1,0,1,0.14285714285714285,1,0.0,0,0,0,0,0,0,0,1,0,0,1,1
3438,53302,yo1PAd1hBwimD9OOoxvyi6mwQC5bfK9g,A3fsA9Zfv1X2fVEQhTw51lKENdNrEqT3,5,2,1,0,1,0,3,0,7,1.0,3,0.0,0,1,0,1,2,0,0,3,0,2,5,1
3439,53311,aPkMT9tuTlJ66PtOLGr8kUMmFmOPUdkZ,SpATywNh6bZuzm8s1ceuBUnMUAeoAHHw,7,7,4,0,3,0,2,0,16,2.2857142857142856,2,0.0,0,4,0,3,7,0,0,2,0,7,9,1
3440,53317,yEniPsoZW8Rgn4eOpAbvQhjj6pD8iwKc,A3fsA9Zfv1X2fVEQhTw51lKENdNrEqT3,1,0,0,0,0,0,1,0,1,0.14285714285714285,1,0.0,0,0,0,0,0,0,0,1,0,0,1,1
3441,53331,hibDkoksqk55U27uWSImoVEarIMKhRU6,SpATywNh6bZuzm8s1ceuBUnMUAeoAHHw,1,0,0,0,0,0,1,0,1,0.14285714285714285,1,0.0,0,0,0,0,0,0,0,1,0,0,1,1
3442,53344,zDAtaSKsAJQmmJ6xHQBbAGN68vDebyev,bWdj2GDclj5ofokWjzoa5jAwMkxCykd6,4,4,0,0,0,0,1,0,5,0.7142857142857143,1,0.0,1,0,0,0,3,0,0,1,0,1,4,0
3443,53345,FtZzEliHSUjgpcn9CYNSke7IZriM02xT,SpATywNh6bZuzm8s1ceuBUnMUAeoAHHw,20,19,14,18,6,3,3,0,63,9.0,2,0.0,2,14,15,6,17,3,3,3,0,37,26,1
3444,53355,NiXPZUmEILmWUPwXexYxtHvaIL7QdjCQ,A3fsA9Zfv1X2fVEQhTw51lKENdNrEqT3,6,3,2,0,0,0,5,0,10,1.4285714285714286,1,0.0,0,2,0,0,3,0,0,5,0,2,8,1
3445,53363,kMMGkT5aXtXvkc2Ht1vStIyRGPA6Fe7z,G8EPVSXsOYB5YQWZGiz1aVq5Pgr2GrQu,17,14,10,0,7,0,8,1,40,5.714285714285714,2,0.0,2,10,0,7,12,0,0,8,1,19,21,1
3446,53367,qJEf5DGSDkSxZ1JIhipEbBFRbrhnAj1a,SpATywNh6bZuzm8s1ceuBUnMUAeoAHHw,27,62,23,32,13,0,7,0,137,19.571428571428573,2,0.0,30,23,31,13,32,0,1,7,0,97,40,0
3447,53375,Wz9l8snB7xy02KowUlwVZlKvIqcEcSjS,SpATywNh6bZuzm8s1ceuBUnMUAeoAHHw,20,25,1,16,0,0,2,0,44,6.285714285714286,1,0.0,10,1,16,0,15,0,0,2,0,27,17,1
3448,53378,5IoXxgwnl1RIJLxkp1FnmYezwVSXlFjr,SpATywNh6bZuzm8s1ceuBUnMUAeoAHHw,15,22,11,8,6,1,6,1,55,7.857142857142857,3,0.0,5,11,6,6,17,1,2,6,1,28,27,0
3449,53388,b8RIifGIgaKQKUnIb1k2djgWvbjJC3hc,A3fsA9Zfv1X2fVEQhTw51lKENdNrEqT3,1,0,0,0,0,0,1,0,1,0.14285714285714285,1,0.0,0,0,0,0,0,0,0,1,0,0,1,1
3450,53468,rLYXv7hKF9TmAtWbjwlsT53xTtV0g4r6,A3fsA9Zfv1X2fVEQhTw51lKENdNrEqT3,13,6,3,0,2,0,10,2,23,3.2857142857142856,1,0.0,0,3,0,2,6,0,0,10,2,5,18,0
3451,53487,N3Kcp8HxIitle1dnmjMusLDj62CzfGvL,SpATywNh6bZuzm8s1ceuBUnMUAeoAHHw,19,54,7,6,8,23,17,0,115,16.428571428571427,9,0.0,5,7,6,8,49,23,0,17,0,26,89,0
3452,53488,OnFhgQq4yBEqO4X7tLyRDBVhde68jGdf,RXDvfPUBYFlVdlueBFbLW0mhhAyGEqpt,52,49,31,97,12,39,27,4,259,37.0,3,0.0,13,31,87,12,36,39,10,27,4,143,116,0
3453,53489,griMTqEKR37PeprCrLd3ng7H5lhHXROa,G8EPVSXsOYB5YQWZGiz1aVq5Pgr2GrQu,6,0,0,0,0,1,6,1,8,1.1428571428571428,1,0.0,0,0,0,0,0,1,0,6,1,0,8,1
3454,53491,DJenb7iikHj085JzrOjjcdsjyfa241f7,RXDvfPUBYFlVdlueBFbLW0mhhAyGEqpt,2,0,0,0,0,0,2,0,2,0.2857142857142857,1,0.0,0,0,0,0,0,0,0,2,0,0,2,1
3455,53502,MrmZgmDV3fLNPBur1xb2HpNXhTz9Exkt,SpATywNh6bZuzm8s1ceuBUnMUAeoAHHw,18,25,2,32,2,0,13,0,74,10.571428571428571,4,0.0,11,2,28,2,14,0,4,13,0,43,31,0
3456,53508,PJ44wkPMp1IThxNmQ1GXtcqK19ORMpJF,A3fsA9Zfv1X2fVEQhTw51lKENdNrEqT3,2,0,0,0,0,0,2,0,2,0.2857142857142857,1,0.0,0,0,0,0,0,0,0,2,0,0,2,1
3457,53520,MhrFHIexWYn2dilUXh03cpnfpoe9tMBe,SpATywNh6bZuzm8s1ceuBUnMUAeoAHHw,30,44,14,32,6,8,15,1,120,17.142857142857142,7,0.0,25,14,29,6,19,8,3,15,1,74,46,1
3458,53539,i2lUV72IHqqXWYqLFMWv3y4XGmlq2lXa,SpATywNh6bZuzm8s1ceuBUnMUAeoAHHw,29,38,18,18,8,3,9,0,94,13.428571428571429,4,0.0,5,18,18,8,33,3,0,9,0,49,45,0
3459,53549,luffaRyMH17lmf9lXIITCUvmvLstdhJF,RXDvfPUBYFlVdlueBFbLW0mhhAyGEqpt,8,9,1,0,1,0,2,0,13,1.8571428571428572,1,0.0,0,1,0,1,9,0,0,2,0,2,11,1
3460,53555,gb9jOdGxS4Zwvh3LQboE7LmvRCw5TLz9,SpATywNh6bZuzm8s1ceuBUnMUAeoAHHw,18,32,2,15,1,0,16,1,67,9.571428571428571,2,0.0,8,2,14,1,24,0,1,16,1,25,42,1
3461,53562,KhZJrlhAYzlNSzHg9PDkxBUGTDjg8IXY,SpATywNh6bZuzm8s1ceuBUnMUAeoAHHw,10,10,1,7,0,0,1,0,19,2.7142857142857144,1,0.0,2,1,7,0,8,0,0,1,0,10,9,1
3462,53578,aEf8iYWPFredkFvIYIscqnDLIOz4fHRM,RXDvfPUBYFlVdlueBFbLW0mhhAyGEqpt,4,6,0,0,0,0,1,0,7,1.0,1,0.0,0,0,0,0,6,0,0,1,0,0,7,1
3463,53584,6ulfbgGgKweBR5jQh3XucxQAX08OMB72,SpATywNh6bZuzm8s1ceuBUnMUAeoAHHw,11,8,1,0,1,0,2,0,12,1.7142857142857142,1,0.0,0,1,0,1,8,0,0,2,0,2,10,0
3464,53597,dL8suqa4DXYE6Q2rD72jJySCosptOAyu,SpATywNh6bZuzm8s1ceuBUnMUAeoAHHw,15,37,11,3,8,0,14,0,73,10.428571428571429,4,0.0,6,11,3,8,31,0,0,14,0,28,45,0
3465,53603,4Eyygyv4Uek4GSzjnDMCkiuVf4JBrAxc,SpATywNh6bZuzm8s1ceuBUnMUAeoAHHw,17,32,1,30,0,23,12,0,98,14.0,4,0.0,17,1,27,0,15,23,3,12,0,45,53,1
3466,53622,N07QLGV4GMHH6HuHURctAIeJ4ePasSlF,SpATywNh6bZuzm8s1ceuBUnMUAeoAHHw,2,0,0,0,0,0,2,0,2,0.2857142857142857,1,0.0,0,0,0,0,0,0,0,2,0,0,2,1
3467,53625,WJVoKPfDDccrIbPzaP1iqdrTUwOdTQpf,A3fsA9Zfv1X2fVEQhTw51lKENdNrEqT3,5,4,2,0,1,0,1,0,8,1.1428571428571428,1,0.0,0,2,0,1,4,0,0,1,0,3,5,1
3468,53651,TXNnbjY690dLjW2nCR7nDyfRxXhXZM7x,A3fsA9Zfv1X2fVEQhTw51lKENdNrEqT3,7,11,0,0,0,0,3,0,14,2.0,2,0.0,0,0,0,0,11,0,0,3,0,0,14,1
3469,53678,uqIn0vdfJ1SDJCOeCVEAQPRFBBKQA2eB,bWdj2GDclj5ofokWjzoa5jAwMkxCykd6,40,27,11,145,7,9,14,1,214,30.571428571428573,4,0.0,5,11,140,7,22,9,5,14,1,163,51,1
3470,53706,xQeTj9CLDdVhlEixqachfO1hdSy3qexC,SpATywNh6bZuzm8s1ceuBUnMUAeoAHHw,17,32,5,32,0,4,11,4,88,12.571428571428571,6,0.0,14,5,31,0,18,4,1,11,4,50,38,1
3471,53713,RluI9XQtU4oZmhgM6DxuPP3K5fCr0lBq,SpATywNh6bZuzm8s1ceuBUnMUAeoAHHw,17,15,11,5,7,0,3,0,41,5.857142857142857,3,0.0,0,11,5,7,15,0,0,3,0,23,18,1
3472,53714,Ar22lkOE5FvesxoMKtYhm8Cbv4MUQUYF,RXDvfPUBYFlVdlueBFbLW0mhhAyGEqpt,51,91,4,126,7,28,55,26,337,48.142857142857146,5,0.0,30,4,118,7,61,28,8,55,26,159,178,1
3473,53720,eeYgUeHIQERDYwF1mxwVIZYsVaVSgwlV,A3fsA9Zfv1X2fVEQhTw51lKENdNrEqT3,51,62,34,104,11,21,21,0,253,36.142857142857146,5,0.0,3,34,89,11,59,21,15,21,0,137,116,1
3474,53727,krkfIMLel7iDn2mta14hX7PO3xGpidTe,bWdj2GDclj5ofokWjzoa5jAwMkxCykd6,4,6,0,0,0,0,3,0,9,1.2857142857142858,2,0.0,0,0,0,0,6,0,0,3,0,0,9,1
3475,53733,1OspHY7rOajB01D4WOGZGtONpUzR26jm,bWdj2GDclj5ofokWjzoa5jAwMkxCykd6,1,0,0,0,0,0,1,0,1,0.14285714285714285,1,0.0,0,0,0,0,0,0,0,1,0,0,1,1
3476,53750,DHyGbluRYDb9YK4sD54nYIDtRwaCVU4f,SpATywNh6bZuzm8s1ceuBUnMUAeoAHHw,20,39,13,6,2,10,9,1,80,11.428571428571429,5,0.0,5,13,6,2,34,10,0,9,1,26,54,1
3477,53758,Hu906OsUOpYkLeeay2GUzLMtBtAH0201,SpATywNh6bZuzm8s1ceuBUnMUAeoAHHw,15,24,2,0,2,0,8,0,36,5.142857142857143,4,0.0,0,2,0,2,24,0,0,8,0,4,32,1
3478,53765,tsMYMsnBDSMWs12MBfqVxxI4flEFKsqY,SpATywNh6bZuzm8s1ceuBUnMUAeoAHHw,6,2,1,0,1,0,3,0,7,1.0,1,0.0,0,1,0,1,2,0,0,3,0,2,5,1
3479,53767,7pxuwoHJlBJIgCUu1Em6p1jZ4AOgWd02,SpATywNh6bZuzm8s1ceuBUnMUAeoAHHw,1,0,0,0,0,0,1,0,1,0.14285714285714285,1,0.0,0,0,0,0,0,0,0,1,0,0,1,1
3480,53775,10a3aPUuiEikOQBzdtiLA8dXlMBNaCqq,SpATywNh6bZuzm8s1ceuBUnMUAeoAHHw,1,0,0,0,0,0,1,0,1,0.14285714285714285,1,0.0,0,0,0,0,0,0,0,1,0,0,1,1
3481,53790,F6SQlqazEZ0w5BjMwjWgS37WY6aKoLpg,SpATywNh6bZuzm8s1ceuBUnMUAeoAHHw,25,42,1,21,1,31,16,1,113,16.142857142857142,1,0.0,10,1,20,1,32,31,1,16,1,32,81,1
3482,53800,j69quqIKpcCSzqXo9ZsaY7H1y4DglvlA,SpATywNh6bZuzm8s1ceuBUnMUAeoAHHw,5,2,1,0,1,1,2,0,7,1.0,1,0.0,0,1,0,1,2,1,0,2,0,2,5,1
3483,53801,JVippbCdijsZvDTgzyPclP2OizOfI7bg,SpATywNh6bZuzm8s1ceuBUnMUAeoAHHw,26,32,15,26,7,5,5,0,90,12.857142857142858,2,0.0,5,15,21,7,27,5,5,5,0,48,42,1
3484,53811,VMIa4tT0g1D8FcJ7AhOiLBIndESbZgIA,A3fsA9Zfv1X2fVEQhTw51lKENdNrEqT3,1,0,0,0,0,0,1,0,1,0.14285714285714285,1,0.0,0,0,0,0,0,0,0,1,0,0,1,1
3485,53813,JfKuoH41ocsNDmphdAQOIFuKNZWqJJwf,SpATywNh6bZuzm8s1ceuBUnMUAeoAHHw,20,27,13,23,1,162,20,0,246,35.142857142857146,3,0.0,4,13,21,1,23,162,2,20,0,39,207,1
3486,53815,zSmc8rKmn3W7ClGZoLsZk5lSBVQHeitz,SpATywNh6bZuzm8s1ceuBUnMUAeoAHHw,17,23,1,10,1,0,20,0,55,7.857142857142857,4,0.0,2,1,8,1,21,0,2,20,0,12,43,0
3487,53828,anpgTlAzqtcn1vI43094PZ2LMGoPXQz9,SpATywNh6bZuzm8s1ceuBUnMUAeoAHHw,8,9,4,0,1,12,7,0,33,4.714285714285714,2,0.0,3,4,0,1,6,12,0,7,0,8,25,1
3488,53838,QApdmb1PXR97hGOt28aAXkYQiicNqOKw,SpATywNh6bZuzm8s1ceuBUnMUAeoAHHw,21,30,1,28,1,0,10,1,71,10.142857142857142,2,0.0,7,1,26,1,23,0,2,10,1,35,36,0
3489,53842,tN95ymRxU88OqvEeFVj1h9MemYWUdm2H,A3fsA9Zfv1X2fVEQhTw51lKENdNrEqT3,18,9,8,0,8,0,1,0,26,3.7142857142857144,1,0.0,0,8,0,8,9,0,0,1,0,16,10,1
3490,53849,gSVGAbR6ZoNLN4J93dYtc3hGFE6M7IrZ,SpATywNh6bZuzm8s1ceuBUnMUAeoAHHw,5,2,0,0,0,0,3,0,5,0.7142857142857143,1,0.0,0,0,0,0,2,0,0,3,0,0,5,1
3491,53858,6Upqh8KDtBiZuS1AWTucTCCkEJCPfX5m,SpATywNh6bZuzm8s1ceuBUnMUAeoAHHw,23,60,2,38,1,141,11,0,253,36.142857142857146,5,0.0,26,2,32,1,34,141,6,11,0,61,192,0
3492,53861,Su9COtUoYOdyYjAUoqvAULKdQODTHr7E,bWdj2GDclj5ofokWjzoa5jAwMkxCykd6,28,59,27,192,4,19,28,4,333,47.57142857142857,3,0.0,13,27,183,4,46,19,9,28,4,227,106,0
3493,53875,wgifE6A0kxnDEjw7myKTY39TRuCgYxaB,bWdj2GDclj5ofokWjzoa5jAwMkxCykd6,6,7,3,0,2,0,4,0,16,2.2857142857142856,3,0.0,0,3,0,2,7,0,0,4,0,5,11,1
3494,53877,cLYelk5eLuqZus5jIOPS82VsEcbwjlHd,SpATywNh6bZuzm8s1ceuBUnMUAeoAHHw,17,26,13,6,8,0,4,0,57,8.142857142857142,1,0.0,8,13,6,8,18,0,0,4,0,35,22,1
3495,53881,nEyHrNWAhCJiBBDbSB6IHu4lz50w5Dy6,A3fsA9Zfv1X2fVEQhTw51lKENdNrEqT3,17,14,10,0,7,0,6,0,37,5.285714285714286,4,0.0,0,10,0,7,14,0,0,6,0,17,20,1
3496,53895,Y0j1i2gPpBKnJTyvOTxYtV3JtU8UpMcv,SpATywNh6bZuzm8s1ceuBUnMUAeoAHHw,20,37,12,27,3,0,15,4,98,14.0,3,0.0,16,12,25,3,21,0,2,15,4,56,42,1
3497,53904,SjgqKMmF4tqpvhmgO66D1TdoOxgqcy2V,RXDvfPUBYFlVdlueBFbLW0mhhAyGEqpt,23,32,11,31,9,0,5,0,88,12.571428571428571,2,0.0,11,11,31,9,21,0,0,5,0,62,26,0
3498,53906,nCx7ByTflBYRKyE0yen5MKylk9XOx9rV,A3fsA9Zfv1X2fVEQhTw51lKENdNrEqT3,10,18,9,0,4,0,4,0,35,5.0,3,0.0,1,9,0,4,17,0,0,4,0,14,21,1
3499,53913,a2z9RsxlqGCqsHimTXs86MGbzWTI57AJ,SpATywNh6bZuzm8s1ceuBUnMUAeoAHHw,11,9,6,5,4,1,2,0,27,3.857142857142857,1,0.0,2,6,4,4,7,1,1,2,0,16,11,1
3500,53917,4S03noH7cjIbR4dHJ5qcypZRCrtfcYb6,bWdj2GDclj5ofokWjzoa5jAwMkxCykd6,16,28,3,10,2,11,8,2,64,9.142857142857142,5,0.0,3,3,10,2,25,11,0,8,2,18,46,1
3501,53923,hiq4p9Wpf1ENeqXLCQsPukhDTDL2bNA2,RXDvfPUBYFlVdlueBFbLW0mhhAyGEqpt,27,36,15,33,3,18,21,5,131,18.714285714285715,4,0.0,14,15,31,3,22,18,2,21,5,63,68,0
3502,53939,JUQwyjRts4o299yp6PZYUiNur6LnV5UN,SpATywNh6bZuzm8s1ceuBUnMUAeoAHHw,7,5,1,0,1,0,2,0,9,1.2857142857142858,1,0.0,0,1,0,1,5,0,0,2,0,2,7,1
3503,53947,cL4725Y58Cl01IjeOv5CCdtpjNF0EqJp,SpATywNh6bZuzm8s1ceuBUnMUAeoAHHw,13,23,13,0,4,7,9,1,57,8.142857142857142,5,0.0,3,13,0,4,20,7,0,9,1,20,37,1
3504,53958,wcSIko8HPcmbs4cOPlImi3EyazICOLlR,bWdj2GDclj5ofokWjzoa5jAwMkxCykd6,2,0,0,0,0,0,9,0,9,1.2857142857142858,4,0.0,0,0,0,0,0,0,0,9,0,0,9,1
3505,53962,HH3HV5HDJ35z2ldQAEIDXBOSBTxLd6O9,bWdj2GDclj5ofokWjzoa5jAwMkxCykd6,9,4,2,0,1,1,9,1,18,2.5714285714285716,2,0.0,0,2,0,1,4,1,0,9,1,3,15,1
3506,53968,561j5AofjwKlXet6wIEWLTESu761wNuJ,SpATywNh6bZuzm8s1ceuBUnMUAeoAHHw,10,12,6,0,3,9,6,1,37,5.285714285714286,1,0.0,0,6,0,3,12,9,0,6,1,9,28,1
3507,53980,f50myi7Wnjd1BWfZdyqaXMcdfMAdeGX9,G8EPVSXsOYB5YQWZGiz1aVq5Pgr2GrQu,74,109,0,149,2,40,26,1,327,46.714285714285715,11,0.0,51,0,110,2,58,40,39,26,1,163,164,0
3508,53983,R48KCTeb8uSJLAUTCApWBwkMVREjjMDW,A3fsA9Zfv1X2fVEQhTw51lKENdNrEqT3,24,5,3,87,0,2,8,1,106,15.142857142857142,1,0.0,1,3,71,0,4,2,16,8,1,75,31,1
3509,53992,srF76iHf3IXwkM0p0daLjk1LYx1sO9QO,A3fsA9Zfv1X2fVEQhTw51lKENdNrEqT3,43,69,4,68,5,1,16,1,164,23.428571428571427,2,0.0,7,4,59,5,62,1,9,16,1,75,89,1
3510,54001,Gglvz7f1jVuISouyvTJRaLDdezGOZ6EL,SpATywNh6bZuzm8s1ceuBUnMUAeoAHHw,29,59,13,34,7,11,21,1,146,20.857142857142858,5,0.0,12,13,29,7,47,11,5,21,1,61,85,0
3511,54002,FHrj4N2SCEsxza13qmFjgJkCjs8BkrF3,bWdj2GDclj5ofokWjzoa5jAwMkxCykd6,15,22,14,40,5,17,17,2,117,16.714285714285715,2,0.0,3,14,37,5,19,17,3,17,2,59,58,1
3512,54009,U2oiAxypJX3TTENRYPio3LHOtQ2XmXGS,SpATywNh6bZuzm8s1ceuBUnMUAeoAHHw,25,48,18,17,6,4,16,1,110,15.714285714285714,3,0.0,12,18,14,6,36,4,3,16,1,50,60,0
3513,54015,Uo49WNvktWkKOAhlqrqOXLXaeoQpAgrc,SpATywNh6bZuzm8s1ceuBUnMUAeoAHHw,15,17,2,15,2,0,3,0,39,5.571428571428571,3,0.0,8,2,14,2,9,0,1,3,0,26,13,1
3514,54018,dyoINQ9hlelfXhGgA7SokU45MaV6r2b8,SpATywNh6bZuzm8s1ceuBUnMUAeoAHHw,28,20,12,26,7,2,3,0,70,10.0,2,0.0,5,12,21,7,15,2,5,3,0,45,25,0
3515,54023,n7yQ1FvfAXqDnBpszfIUjZkrvw3J2aJC,bWdj2GDclj5ofokWjzoa5jAwMkxCykd6,2,0,0,0,0,0,2,0,2,0.2857142857142857,1,0.0,0,0,0,0,0,0,0,2,0,0,2,1
3516,54026,gw1ywpstRy3gY1kWojp1woauzVM2ZYVr,SpATywNh6bZuzm8s1ceuBUnMUAeoAHHw,23,41,28,12,11,0,13,0,105,15.0,4,0.0,2,28,9,11,39,0,3,13,0,50,55,0
3517,54027,0S1IMyqlmBJaUdNY6QqTX948M0Vx0tcJ,SpATywNh6bZuzm8s1ceuBUnMUAeoAHHw,13,18,6,0,3,0,3,0,30,4.285714285714286,2,0.0,0,6,0,3,18,0,0,3,0,9,21,1
3518,54029,So8gZ8cXseEZ7lXf4idNMqcN46bXtlIA,SpATywNh6bZuzm8s1ceuBUnMUAeoAHHw,16,26,11,17,7,4,6,0,71,10.142857142857142,4,0.0,11,11,14,7,15,4,3,6,0,43,28,0
3519,54048,pXLwXf6zUsqL9SOfZNShdqFixygLJrWR,SpATywNh6bZuzm8s1ceuBUnMUAeoAHHw,7,4,2,0,2,0,2,0,10,1.4285714285714286,1,0.0,1,2,0,2,3,0,0,2,0,5,5,1
3520,54056,HLuhLxGFPt6I9n1CokhbKviDPHHdGO60,G8EPVSXsOYB5YQWZGiz1aVq5Pgr2GrQu,4,2,0,0,0,0,2,0,4,0.5714285714285714,1,0.0,0,0,0,0,2,0,0,2,0,0,4,1
3521,54062,1zcBOliKKVXK419jHsqjZGpz654bIAn5,RXDvfPUBYFlVdlueBFbLW0mhhAyGEqpt,24,42,23,42,13,13,6,1,140,20.0,3,0.0,10,23,40,13,32,13,2,6,1,86,54,1
3522,54071,vYeGcWGAJP4B8Lvbjdr2jkY9NnpHN8xb,SpATywNh6bZuzm8s1ceuBUnMUAeoAHHw,29,44,23,27,11,5,18,0,128,18.285714285714285,4,0.0,12,23,24,11,32,5,3,18,0,70,58,1
3523,54076,33fwsM5EFqk5KwLRS1Hdk3QGBr5jYWOs,SpATywNh6bZuzm8s1ceuBUnMUAeoAHHw,30,41,22,19,9,20,25,2,138,19.714285714285715,7,0.0,11,22,18,9,30,20,1,25,2,60,78,0
3524,54078,mzJ0trk582dssKvdbvvSr3OyxZiFuQ3P,bWdj2GDclj5ofokWjzoa5jAwMkxCykd6,11,13,2,0,1,1,6,1,24,3.4285714285714284,3,0.0,0,2,0,1,13,1,0,6,1,3,21,1
3525,54079,pJOjDRWW7Xh5i12ZiWoQnz8dZuNP8rXl,SpATywNh6bZuzm8s1ceuBUnMUAeoAHHw,11,18,8,0,5,2,1,0,34,4.857142857142857,1,0.0,2,8,0,5,16,2,0,1,0,15,19,1
3526,54082,4LX6gYDKcYMBLDa9yuezfCQG1GKo9eu8,SpATywNh6bZuzm8s1ceuBUnMUAeoAHHw,5,8,0,0,0,0,7,0,15,2.142857142857143,1,0.0,0,0,0,0,8,0,0,7,0,0,15,1
3527,54083,QYVRHTpooyTkzSbIywJ7ri5o4t73Xwty,RXDvfPUBYFlVdlueBFbLW0mhhAyGEqpt,1,0,0,0,0,0,1,0,1,0.14285714285714285,1,0.0,0,0,0,0,0,0,0,1,0,0,1,1
3528,54085,BQCssLSYZBRoNs0A82WS0r6vRVhdQKvg,SpATywNh6bZuzm8s1ceuBUnMUAeoAHHw,9,6,4,0,2,0,3,0,15,2.142857142857143,1,0.0,0,4,0,2,6,0,0,3,0,6,9,1
3529,54088,7Xq01ZEcLJ8EiJEfAlByyafLSPE4vuef,SpATywNh6bZuzm8s1ceuBUnMUAeoAHHw,5,3,2,0,0,0,2,0,7,1.0,1,0.0,0,2,0,0,3,0,0,2,0,2,5,1
3530,54094,Fdt86Xu5OLPdaOgl6M1XDpiJ3zar7SU6,SpATywNh6bZuzm8s1ceuBUnMUAeoAHHw,27,43,11,65,3,1,13,4,140,20.0,3,0.0,19,11,57,3,24,1,8,13,4,90,50,0
3531,54103,uEA5Un9wAGiDxjEkoYiTUGhoxCFEEvwr,SpATywNh6bZuzm8s1ceuBUnMUAeoAHHw,1,0,0,0,0,0,1,0,1,0.14285714285714285,1,0.0,0,0,0,0,0,0,0,1,0,0,1,1
3532,54113,Dpj1ute7yeokptEET2ZfYuubDiXNwLXm,A3fsA9Zfv1X2fVEQhTw51lKENdNrEqT3,9,13,7,0,4,0,2,0,26,3.7142857142857144,2,0.0,0,7,0,4,13,0,0,2,0,11,15,1
3533,54121,nVNeaHavpiSEFe567sT2ScRxObLjhEGL,G8EPVSXsOYB5YQWZGiz1aVq5Pgr2GrQu,39,31,22,140,9,6,6,0,214,30.571428571428573,4,0.0,0,22,120,9,31,6,20,6,0,151,63,1
3534,54123,b5xbU8SGcZEvpqzyP6Qk6welzZOUxOvx,A3fsA9Zfv1X2fVEQhTw51lKENdNrEqT3,9,6,2,0,2,0,5,0,15,2.142857142857143,2,0.0,0,2,0,2,6,0,0,5,0,4,11,1
3535,54129,qKOvjGeHnXAGhScloNy1qhNnfc1xHZ3T,SpATywNh6bZuzm8s1ceuBUnMUAeoAHHw,24,128,1,36,1,122,52,5,345,49.285714285714285,8,0.0,38,1,28,1,90,122,8,52,5,68,277,0
3536,54132,PfTpx7WgTJY6IpNokJ2POml34GMs7LTI,bWdj2GDclj5ofokWjzoa5jAwMkxCykd6,35,20,10,82,5,8,7,0,132,18.857142857142858,2,0.0,6,10,79,5,14,8,3,7,0,100,32,0
3537,54133,jU9n6p1KRt3F2eM3pIcFgt7azc85bbxP,SpATywNh6bZuzm8s1ceuBUnMUAeoAHHw,18,46,28,0,18,6,25,1,124,17.714285714285715,4,0.0,3,28,0,18,43,6,0,25,1,49,75,1
3538,54134,BtB75B9l8XyH0uPaKeOkkRrm2NqBrtQe,A3fsA9Zfv1X2fVEQhTw51lKENdNrEqT3,20,14,10,0,9,0,6,0,39,5.571428571428571,5,0.0,0,10,0,9,14,0,0,6,0,19,20,1
3539,54137,kdSq236IYQMsCu2OjWxBROoAPTYOBg4Z,A3fsA9Zfv1X2fVEQhTw51lKENdNrEqT3,1,0,0,0,0,0,1,0,1,0.14285714285714285,1,0.0,0,0,0,0,0,0,0,1,0,0,1,1
3540,54138,cZ43eywkms9yBmvkdibtxlcZqrcdFmmE,SpATywNh6bZuzm8s1ceuBUnMUAeoAHHw,10,8,4,0,0,2,6,1,21,3.0,2,0.0,2,4,0,0,6,2,0,6,1,6,15,1
3541,54140,2Bc3e8bWl6DTvfTPBZCyShFFG8OApkva,A3fsA9Zfv1X2fVEQhTw51lKENdNrEqT3,9,11,5,0,3,0,2,0,21,3.0,2,0.0,0,5,0,3,11,0,0,2,0,8,13,1
3542,54144,oEOiBLMr97GK8O9ympHG9NMLQODJ0Xam,bWdj2GDclj5ofokWjzoa5jAwMkxCykd6,1,0,0,0,0,0,1,0,1,0.14285714285714285,1,0.0,0,0,0,0,0,0,0,1,0,0,1,1
3543,54145,uL6960SAwN5kJgcsaw9m5ztApNeZFO95,A3fsA9Zfv1X2fVEQhTw51lKENdNrEqT3,39,29,22,56,12,0,9,0,128,18.285714285714285,2,0.0,2,22,50,12,27,0,6,9,0,86,42,1
3544,54149,oEOiBLMr97GK8O9ympHG9NMLQODJ0Xam,SpATywNh6bZuzm8s1ceuBUnMUAeoAHHw,1,0,0,0,0,0,1,0,1,0.14285714285714285,1,0.0,0,0,0,0,0,0,0,1,0,0,1,1
3545,54153,1rAHmNrxrqnzHEQFMlydmQ968LsZW0oG,A3fsA9Zfv1X2fVEQhTw51lKENdNrEqT3,18,12,9,0,5,0,9,0,35,5.0,3,0.0,0,9,0,5,12,0,0,9,0,14,21,1
3546,54176,i2jPckJdA9hhx8KLohXM0CrojRerYpdv,SpATywNh6bZuzm8s1ceuBUnMUAeoAHHw,32,132,56,49,21,68,44,12,382,54.57142857142857,8,0.0,54,56,39,21,78,68,10,44,12,170,212,0
3547,54185,0fPKzumQAfSwGfxF7d6bvXWcsMGpFXOP,SpATywNh6bZuzm8s1ceuBUnMUAeoAHHw,30,42,17,28,9,5,7,2,110,15.714285714285714,4,0.0,7,17,26,9,35,5,2,7,2,59,51,0
3548,54199,yhj9ME5eIWuvrbwWqT7KNKtjeY6yuvxW,A3fsA9Zfv1X2fVEQhTw51lKENdNrEqT3,4,0,0,0,0,1,4,2,7,1.0,1,0.0,0,0,0,0,0,1,0,4,2,0,7,1
3549,54226,l3sfUHhSnAdS6GAthlSM3lKuUCRdk9CZ,A3fsA9Zfv1X2fVEQhTw51lKENdNrEqT3,21,14,8,62,2,0,5,0,91,13.0,3,0.0,2,8,48,2,12,0,14,5,0,60,31,1
3550,54231,o6TNCL8FasDR1iE3PXeICx9M4vKCc0T1,bWdj2GDclj5ofokWjzoa5jAwMkxCykd6,6,1,1,0,1,0,5,0,8,1.1428571428571428,2,0.0,0,1,0,1,1,0,0,5,0,2,6,1
3551,54233,o6TNCL8FasDR1iE3PXeICx9M4vKCc0T1,A3fsA9Zfv1X2fVEQhTw51lKENdNrEqT3,1,0,0,0,0,0,1,0,1,0.14285714285714285,1,0.0,0,0,0,0,0,0,0,1,0,0,1,1
3552,54238,V9HQPxlLSz0QiOl8p8UTUo6CstrlztcH,SpATywNh6bZuzm8s1ceuBUnMUAeoAHHw,4,2,0,0,0,0,2,0,4,0.5714285714285714,1,0.0,0,0,0,0,2,0,0,2,0,0,4,1
3553,54285,Io3VzTK6sP3a0ZVRKkRhFNz8A2ULjris,bWdj2GDclj5ofokWjzoa5jAwMkxCykd6,2,0,0,0,0,0,3,0,3,0.42857142857142855,1,0.0,0,0,0,0,0,0,0,3,0,0,3,1
3554,54287,kuiW3Le0WeMGiwxmKgXwp1GfHw3vKMeq,SpATywNh6bZuzm8s1ceuBUnMUAeoAHHw,11,7,4,4,3,0,2,0,20,2.857142857142857,2,0.0,1,4,4,3,6,0,0,2,0,12,8,1
3555,54306,pQnR1td8vlxsKseVpfzZVvCBdR2iP4U6,A3fsA9Zfv1X2fVEQhTw51lKENdNrEqT3,6,5,1,0,0,0,7,0,13,1.8571428571428572,2,0.0,0,1,0,0,5,0,0,7,0,1,12,0
3556,54312,np300nKbgkFp0EFcdJyIdPu3KUkiYdwY,G8EPVSXsOYB5YQWZGiz1aVq5Pgr2GrQu,6,4,1,0,1,0,2,0,8,1.1428571428571428,1,0.0,0,1,0,1,4,0,0,2,0,2,6,1
3557,54316,64OeQzK990rz5QNrMOQujVxWZWc38bZL,SpATywNh6bZuzm8s1ceuBUnMUAeoAHHw,17,11,7,11,4,0,3,0,36,5.142857142857143,2,0.0,2,7,11,4,9,0,0,3,0,24,12,1
3558,54321,qgHNkIIeFGRC3Bav4KufUnqlMzkDetSU,bWdj2GDclj5ofokWjzoa5jAwMkxCykd6,20,31,13,54,10,8,12,1,129,18.428571428571427,4,0.0,8,13,51,10,23,8,3,12,1,82,47,0
3559,54341,bJm6vpekKjS0vCZZW0loTWMZ3NWdcX0T,SpATywNh6bZuzm8s1ceuBUnMUAeoAHHw,1,0,0,0,0,0,1,0,1,0.14285714285714285,1,0.0,0,0,0,0,0,0,0,1,0,0,1,1
3560,54344,M7Vbw5q1oL32IfEMSI9AM5uHCUMDFHmm,bWdj2GDclj5ofokWjzoa5jAwMkxCykd6,1,0,0,0,0,0,1,0,1,0.14285714285714285,1,0.0,0,0,0,0,0,0,0,1,0,0,1,1
3561,54345,7P3XgLwfwlFBQozc5Gty8UBmzZ1wk3nf,bWdj2GDclj5ofokWjzoa5jAwMkxCykd6,3,5,1,0,1,0,1,0,8,1.1428571428571428,1,0.0,3,1,0,1,2,0,0,1,0,5,3,1
3562,54352,pQnR1td8vlxsKseVpfzZVvCBdR2iP4U6,RXDvfPUBYFlVdlueBFbLW0mhhAyGEqpt,5,2,1,0,1,0,2,0,6,0.8571428571428571,1,0.0,0,1,0,1,2,0,0,2,0,2,4,1
3563,54378,wykDdjB45pC3zZUNNLpkNXDJGEatsGFp,SpATywNh6bZuzm8s1ceuBUnMUAeoAHHw,1,0,0,0,0,0,1,0,1,0.14285714285714285,1,0.0,0,0,0,0,0,0,0,1,0,0,1,1
3564,54389,Dpj1ute7yeokptEET2ZfYuubDiXNwLXm,SpATywNh6bZuzm8s1ceuBUnMUAeoAHHw,9,14,9,0,6,0,4,0,33,4.714285714285714,4,0.0,0,9,0,6,14,0,0,4,0,15,18,1
3565,54391,6GW7T2KXNaFy6SJDNV3BLn1vYIvac4zq,bWdj2GDclj5ofokWjzoa5jAwMkxCykd6,1,0,0,0,0,0,1,0,1,0.14285714285714285,1,0.0,0,0,0,0,0,0,0,1,0,0,1,1
3566,54398,lg3JWapmXZgNYOt38qBO2QsZMUBFS5SJ,G8EPVSXsOYB5YQWZGiz1aVq5Pgr2GrQu,75,94,38,170,28,19,19,2,370,52.857142857142854,4,0.0,49,38,128,28,45,19,42,19,2,243,127,0
3567,54399,6GW7T2KXNaFy6SJDNV3BLn1vYIvac4zq,A3fsA9Zfv1X2fVEQhTw51lKENdNrEqT3,21,16,12,0,11,0,1,0,40,5.714285714285714,1,0.0,1,12,0,11,15,0,0,1,0,24,16,1
3568,54411,UZrNs5yPvW1ZVC8d6wdut2Js7XUvysRH,SpATywNh6bZuzm8s1ceuBUnMUAeoAHHw,28,33,22,27,6,29,11,3,131,18.714285714285715,7,0.0,4,22,26,6,29,29,1,11,3,58,73,1
3569,54419,H4rucA3Bl92feiIFqEyA7i9inMfODBCx,SpATywNh6bZuzm8s1ceuBUnMUAeoAHHw,4,2,0,0,0,0,3,0,5,0.7142857142857143,1,0.0,0,0,0,0,2,0,0,3,0,0,5,0
3570,54447,6A2JLpLWnCwUlo9pD1HHlgEwNLvzcllv,A3fsA9Zfv1X2fVEQhTw51lKENdNrEqT3,25,38,27,12,14,0,7,0,98,14.0,4,0.0,2,27,10,14,36,0,2,7,0,53,45,1
3571,54458,w8ymvO72UlYPBd2tG0A8iTEwt4UoIvlZ,A3fsA9Zfv1X2fVEQhTw51lKENdNrEqT3,40,26,18,50,12,0,4,0,110,15.714285714285714,2,0.0,3,18,50,12,23,0,0,4,0,83,27,1
3572,54467,Ha2E1KX6VBrxAJ0Y64ONsTCt1RbrAdiK,SpATywNh6bZuzm8s1ceuBUnMUAeoAHHw,21,20,11,13,5,0,7,0,56,8.0,4,0.0,6,11,11,5,14,0,2,7,0,33,23,0
3573,54485,bbBKqbJ74sqbqRiQHsLpyapFJxr2Z728,SpATywNh6bZuzm8s1ceuBUnMUAeoAHHw,17,55,16,14,3,5,13,2,108,15.428571428571429,3,0.0,26,16,12,3,29,5,2,13,2,57,51,1
3574,54509,HPaDTzk2xymxbpoa0VdcxdHl3uFfOfZk,bWdj2GDclj5ofokWjzoa5jAwMkxCykd6,11,16,9,0,1,5,31,3,65,9.285714285714286,4,0.0,2,9,0,1,14,5,0,31,3,12,53,1
3575,54512,x6BtQH70uuLHaxqzHA21U9wmfT0SxzD9,SpATywNh6bZuzm8s1ceuBUnMUAeoAHHw,26,38,7,22,4,38,36,3,148,21.142857142857142,9,0.0,11,7,18,4,27,38,4,36,3,40,108,0
3576,54514,Xq1kPqflDNgXwQ2pEniNYUjMpkVzPp1m,bWdj2GDclj5ofokWjzoa5jAwMkxCykd6,5,8,3,0,0,0,2,0,13,1.8571428571428572,2,0.0,0,3,0,0,8,0,0,2,0,3,10,1
3577,54516,bYSbXmkovrv6ucz58VC2SSCMvEjrNo7x,SpATywNh6bZuzm8s1ceuBUnMUAeoAHHw,1,0,0,0,0,0,1,0,1,0.14285714285714285,1,0.0,0,0,0,0,0,0,0,1,0,0,1,1
3578,54518,CE7hlTWnMpoldcHVRqlfbEgzp5iUVo4d,SpATywNh6bZuzm8s1ceuBUnMUAeoAHHw,15,17,8,0,4,1,7,1,38,5.428571428571429,2,0.0,7,8,0,4,10,1,0,7,1,19,19,0
3579,54524,CxUPOQRaQMGLmbOcfniIQOhh24PXLDR6,bWdj2GDclj5ofokWjzoa5jAwMkxCykd6,12,21,6,30,2,0,4,0,63,9.0,4,0.0,5,6,26,2,16,0,4,4,0,39,24,0
3580,54528,MXVve1Eg6sXSXHh1Skrb0tjPJ9Wtb0M7,SpATywNh6bZuzm8s1ceuBUnMUAeoAHHw,2,0,0,0,0,0,3,0,3,0.42857142857142855,1,0.0,0,0,0,0,0,0,0,3,0,0,3,1
3581,54544,CF0PQ9PBY5Y16Xk8e9CdQNNLQnwOLSsu,bWdj2GDclj5ofokWjzoa5jAwMkxCykd6,7,9,1,0,2,0,4,0,16,2.2857142857142856,1,0.0,3,1,0,2,6,0,0,4,0,6,10,1
3582,54554,7kbuqNU54d8d11QmdSpTGAMhLhmSDka1,SpATywNh6bZuzm8s1ceuBUnMUAeoAHHw,9,6,2,2,0,0,5,0,15,2.142857142857143,1,0.0,1,2,2,0,5,0,0,5,0,5,10,1
3583,54555,7kbuqNU54d8d11QmdSpTGAMhLhmSDka1,G8EPVSXsOYB5YQWZGiz1aVq5Pgr2GrQu,13,13,4,0,2,0,5,0,24,3.4285714285714284,1,0.0,6,4,0,2,7,0,0,5,0,12,12,1
3584,54558,jtxvuHBV8ZOgNnNCL1A1WerzR2TVfFNy,RXDvfPUBYFlVdlueBFbLW0mhhAyGEqpt,43,42,28,63,10,0,6,0,149,21.285714285714285,3,0.0,7,28,60,10,35,0,3,6,0,105,44,1
3585,54568,fUMqQuy71n3a3vBlGt3GhPdNsIerKaNG,SpATywNh6bZuzm8s1ceuBUnMUAeoAHHw,19,29,18,10,0,0,8,0,65,9.285714285714286,4,0.0,4,18,8,0,25,0,2,8,0,30,35,1
3586,54581,MF9uYxE1fYdj67HROuwgGArAcww4zZp4,bWdj2GDclj5ofokWjzoa5jAwMkxCykd6,1,0,0,0,0,0,1,0,1,0.14285714285714285,1,0.0,0,0,0,0,0,0,0,1,0,0,1,1
3587,54595,jMSxxfftYD0taGWVEUZkcvxpGucC0j8q,fbPkOYLVPtPgIt0MxizjfFJov3JbHyAi,4,5,3,0,0,0,1,0,9,1.2857142857142858,1,0.0,0,3,0,0,5,0,0,1,0,3,6,1
3588,54604,X3X3klM03RXeGUjty93sg2SlkZrg3xpQ,fbPkOYLVPtPgIt0MxizjfFJov3JbHyAi,6,3,2,0,2,0,1,0,8,1.1428571428571428,1,0.0,0,2,0,2,3,0,0,1,0,4,4,1
3589,54616,cgTRAnMuMn887xEhHTcg5rpmYHHPoyIP,fbPkOYLVPtPgIt0MxizjfFJov3JbHyAi,44,93,41,30,31,41,18,1,255,36.42857142857143,4,0.0,41,41,28,31,52,41,2,18,1,141,114,0
3590,54620,z4EDsyht0TzSAKAyhX4LHmg2BH9dRlQd,fbPkOYLVPtPgIt0MxizjfFJov3JbHyAi,11,5,4,0,3,5,5,1,23,3.2857142857142856,1,0.0,0,4,0,3,5,5,0,5,1,7,16,1
3591,54660,LG6VIza4JcQFFbXQ1PDBU7m3JeA6BbpC,fbPkOYLVPtPgIt0MxizjfFJov3JbHyAi,24,30,15,17,19,25,15,3,124,17.714285714285715,1,0.0,14,15,14,19,16,25,3,15,3,62,62,1
3592,54668,KEpGXvdRkmZf3PNthZY5jtIyu6Bw3Rlp,SpATywNh6bZuzm8s1ceuBUnMUAeoAHHw,18,29,13,10,3,7,24,1,87,12.428571428571429,3,0.0,8,13,9,3,21,7,1,24,1,33,54,1
3593,54721,5FY4ZrNjp3ms2uO9UJ9szCrbCrZUttRZ,7GRhBDsirIGkRZBtSMEzNTyDr2JQm4xx,5,3,1,0,1,0,1,0,6,0.8571428571428571,1,0.0,0,1,0,1,3,0,0,1,0,2,4,1
3594,54723,z5Ulo2w0cg5OjY2Cx9aYoywDQvm6hLIF,RXDvfPUBYFlVdlueBFbLW0mhhAyGEqpt,15,25,18,0,7,0,7,0,57,8.142857142857142,7,0.0,0,18,0,7,25,0,0,7,0,25,32,0
3595,54724,XfiCSk5eLAbq9rzQtnLkX2OQTd6M8xFG,bWdj2GDclj5ofokWjzoa5jAwMkxCykd6,24,30,20,20,11,0,18,0,99,14.142857142857142,4,0.0,4,20,20,11,26,0,0,18,0,55,44,0
3596,54761,MfwWTipzPsRtzbyiOZCobMuGSNow3sHg,SpATywNh6bZuzm8s1ceuBUnMUAeoAHHw,11,11,7,5,6,0,2,0,31,4.428571428571429,1,0.0,0,7,4,6,11,0,1,2,0,17,14,0
3597,54800,OseLd0Vj4CawbZPfZRznLZH5tivxQP68,SpATywNh6bZuzm8s1ceuBUnMUAeoAHHw,7,2,2,0,2,0,2,0,8,1.1428571428571428,1,0.0,0,2,0,2,2,0,0,2,0,4,4,1
3598,54819,PkEcTe3rugNe3WrTlhHnV7MduvQXThEB,RXDvfPUBYFlVdlueBFbLW0mhhAyGEqpt,6,5,4,0,0,0,1,0,10,1.4285714285714286,1,0.0,0,4,0,0,5,0,0,1,0,4,6,1
3599,54823,NNTbkWufZqd6OEZ4OfeDtmQCNI4vEzJo,A3fsA9Zfv1X2fVEQhTw51lKENdNrEqT3,2,0,0,0,0,0,2,0,2,0.2857142857142857,1,0.0,0,0,0,0,0,0,0,2,0,0,2,1
3600,54837,2AWz8OiYqJqT0VYmevCkAuxaVCSl88oB,7GRhBDsirIGkRZBtSMEzNTyDr2JQm4xx,1,0,0,0,0,0,1,0,1,0.14285714285714285,1,0.0,0,0,0,0,0,0,0,1,0,0,1,1
3601,54871,H2pnCC5fUi5Ho09aPqAE97vnlsM8FGBU,bWdj2GDclj5ofokWjzoa5jAwMkxCykd6,8,5,3,6,2,0,1,0,17,2.4285714285714284,1,0.0,0,3,6,2,5,0,0,1,0,11,6,1
3602,54876,tVqiyi20xeAPqMyQ1qSspr9PuF7fr80u,SpATywNh6bZuzm8s1ceuBUnMUAeoAHHw,9,6,4,0,3,1,4,0,18,2.5714285714285716,1,0.0,0,4,0,3,6,1,0,4,0,7,11,1
3603,54879,bT6yH99PTuyz3a6ueCehCDHIMjMdNYHB,SpATywNh6bZuzm8s1ceuBUnMUAeoAHHw,16,16,8,18,4,7,2,0,55,7.857142857142857,2,0.0,6,8,15,4,10,7,3,2,0,33,22,1
3604,54910,L8A0UDBue4RuYlwBFsU412yruT49eHlP,7GRhBDsirIGkRZBtSMEzNTyDr2JQm4xx,6,4,1,0,0,0,8,0,13,1.8571428571428572,1,0.0,0,1,0,0,4,0,0,8,0,1,12,1
3605,54937,o076ufFxYjFcAtg8dPv0W5vwk5oKbSiz,SpATywNh6bZuzm8s1ceuBUnMUAeoAHHw,12,13,9,0,5,0,5,1,33,4.714285714285714,3,0.0,0,9,0,5,13,0,0,5,1,14,19,1
3606,54942,ijpfz5cJPrusRBczJIwOiwlUzdR9aysy,SpATywNh6bZuzm8s1ceuBUnMUAeoAHHw,12,17,5,6,1,0,6,0,35,5.0,3,0.0,10,5,6,1,7,0,0,6,0,22,13,0
3607,54944,ak9H3u3GmnBMjkxaXtGHxcLDDF2zUXnS,7GRhBDsirIGkRZBtSMEzNTyDr2JQm4xx,2,0,0,0,0,0,3,0,3,0.42857142857142855,1,0.0,0,0,0,0,0,0,0,3,0,0,3,1
3608,54973,KIPXc8MOqmnlmMqnIzIeaBqliIw9pS44,A3fsA9Zfv1X2fVEQhTw51lKENdNrEqT3,13,13,9,0,5,0,4,0,31,4.428571428571429,2,0.0,0,9,0,5,13,0,0,4,0,14,17,1
3609,54989,DUw85TcNpxyZaZKIM1HlHxvgtSm7uwxY,A3fsA9Zfv1X2fVEQhTw51lKENdNrEqT3,7,3,1,0,1,0,8,1,14,2.0,2,0.0,0,1,0,1,3,0,0,8,1,2,12,1
3610,54999,4RUK0a6HkZbpdBgheC58rw27wDnlPa70,7GRhBDsirIGkRZBtSMEzNTyDr2JQm4xx,10,8,3,0,4,2,5,1,23,3.2857142857142856,1,0.0,4,3,0,4,4,2,0,5,1,11,12,1
3611,55026,7GuXtdTnAtax3FkfgWewqF5JrGz1oCyt,7GRhBDsirIGkRZBtSMEzNTyDr2JQm4xx,1,0,0,0,0,0,1,0,1,0.14285714285714285,1,0.0,0,0,0,0,0,0,0,1,0,0,1,1
3612,55039,0Au7FrQGJI1dB5PAH0C5RtkL9GE7xsrQ,SpATywNh6bZuzm8s1ceuBUnMUAeoAHHw,4,2,0,0,0,0,3,0,5,0.7142857142857143,2,0.0,0,0,0,0,2,0,0,3,0,0,5,1
3613,55082,UbxAJQUpM4nPUifCeu8NjmX0juFyLMFH,SpATywNh6bZuzm8s1ceuBUnMUAeoAHHw,11,11,0,12,0,0,3,0,26,3.7142857142857144,2,0.0,2,0,12,0,9,0,0,3,0,14,12,1
3614,55105,5ysSxswt94Gjj7n5OSEcRzDBWhgbKFUg,7GRhBDsirIGkRZBtSMEzNTyDr2JQm4xx,8,11,4,6,4,0,2,0,27,3.857142857142857,2,0.0,5,4,5,4,6,0,1,2,0,18,9,1
3615,55114,7U7MZiTthIrdSyitYp5jXYVRqrLWtNBu,7GRhBDsirIGkRZBtSMEzNTyDr2JQm4xx,11,10,0,0,0,0,4,0,14,2.0,1,0.0,0,0,0,0,10,0,0,4,0,0,14,1
3616,55135,GaaUSAn7OjFLzHXXBEBVyi3shjmvN0lH,A3fsA9Zfv1X2fVEQhTw51lKENdNrEqT3,4,4,3,0,2,0,2,0,11,1.5714285714285714,1,0.0,0,3,0,2,4,0,0,2,0,5,6,1
3617,55164,ELrr1JfnDsWjEvT48HXDtL9YqiQpfZmF,A3fsA9Zfv1X2fVEQhTw51lKENdNrEqT3,4,2,1,0,1,0,2,0,6,0.8571428571428571,1,0.0,0,1,0,1,2,0,0,2,0,2,4,1
3618,55182,VF14jDCwIzSb92Zq60K5zB8BaUbLT4fN,A3fsA9Zfv1X2fVEQhTw51lKENdNrEqT3,32,30,1,81,0,2,6,0,120,17.142857142857142,1,0.0,2,1,69,0,28,2,12,6,0,72,48,1
3619,55215,RHl3DsvAX7TisJ7qBptmgrrtDAQvH7mr,7GRhBDsirIGkRZBtSMEzNTyDr2JQm4xx,4,2,1,0,1,0,1,0,5,0.7142857142857143,1,0.0,0,1,0,1,2,0,0,1,0,2,3,1
3620,55220,nPRsjektHdbQkeAf1fIK4JbhrESPbPsA,RXDvfPUBYFlVdlueBFbLW0mhhAyGEqpt,8,6,1,0,0,2,5,1,15,2.142857142857143,1,0.0,0,1,0,0,6,2,0,5,1,1,14,1
3621,55295,XmfaTDISWF5comI3j0oigEszknbdPhWn,7GRhBDsirIGkRZBtSMEzNTyDr2JQm4xx,1,0,0,0,0,0,2,0,2,0.2857142857142857,1,0.0,0,0,0,0,0,0,0,2,0,0,2,1
3622,55343,YPEupTuOqSGieSSneZcv3AcUcSBCtbGY,7GRhBDsirIGkRZBtSMEzNTyDr2JQm4xx,6,6,1,6,1,1,2,0,17,2.4285714285714284,1,0.0,3,1,5,1,3,1,1,2,0,10,7,1
3623,55346,7bnGjPq4sg9VhmEEoEqqXHNgeEpEuUDV,SpATywNh6bZuzm8s1ceuBUnMUAeoAHHw,17,18,7,12,4,21,6,2,70,10.0,3,0.0,3,7,12,4,15,21,0,6,2,26,44,0
3624,55350,FbrKChJI6NE19RCUX3nZg6RKzVDriIZa,7GRhBDsirIGkRZBtSMEzNTyDr2JQm4xx,1,0,0,0,0,0,1,0,1,0.14285714285714285,1,0.0,0,0,0,0,0,0,0,1,0,0,1,1
3625,55358,eeotL07J3Y8VeL6DbnIqkm9FhuiNkg7O,SpATywNh6bZuzm8s1ceuBUnMUAeoAHHw,19,19,10,0,6,2,6,1,44,6.285714285714286,2,0.0,7,10,0,6,12,2,0,6,1,23,21,0
3626,55409,LuPgMCIdX2ugHzDAngaEsA394qOat0id,7GRhBDsirIGkRZBtSMEzNTyDr2JQm4xx,4,6,1,0,1,0,1,0,9,1.2857142857142858,1,0.0,3,1,0,1,3,0,0,1,0,5,4,1
3627,55425,iDV5to1cYevkdTWvpbQHbqC1rLSJxp3m,SpATywNh6bZuzm8s1ceuBUnMUAeoAHHw,6,4,1,0,1,0,4,0,10,1.4285714285714286,1,0.0,0,1,0,1,4,0,0,4,0,2,8,0
3628,55427,n5fmXY7W3OsRId8yMehdsktfc1GCY6un,7GRhBDsirIGkRZBtSMEzNTyDr2JQm4xx,16,20,10,34,3,12,4,0,83,11.857142857142858,1,0.0,6,10,28,3,14,12,6,4,0,47,36,0
3629,55475,mDHr8WvVVX9KSvXMqxtLvZ6vP4uuNF6E,SpATywNh6bZuzm8s1ceuBUnMUAeoAHHw,13,25,1,23,0,7,5,1,62,8.857142857142858,1,0.0,17,1,19,0,8,7,4,5,1,37,25,1
3630,55483,C4q4gNQYEpjKh7pq1qjN8i3L7uSpUX9d,A3fsA9Zfv1X2fVEQhTw51lKENdNrEqT3,13,12,8,0,6,0,4,0,30,4.285714285714286,2,0.0,0,8,0,6,12,0,0,4,0,14,16,0
3631,55489,vCm3LfZ9M6wOLWnqELTZFsk5hnCTaEbi,SpATywNh6bZuzm8s1ceuBUnMUAeoAHHw,9,18,3,0,1,0,7,1,30,4.285714285714286,2,0.0,6,3,0,1,12,0,0,7,1,10,20,0
3632,55511,g1maG24WsPdpEOMuZUsxQc7SlEYHJjT4,SpATywNh6bZuzm8s1ceuBUnMUAeoAHHw,12,21,10,0,4,0,4,0,39,5.571428571428571,1,0.0,6,10,0,4,15,0,0,4,0,20,19,1
3633,55516,lgS8T7X8MPl4rnyyVo63W82KpUI1LtmK,SpATywNh6bZuzm8s1ceuBUnMUAeoAHHw,4,2,1,0,0,0,2,0,5,0.7142857142857143,1,0.0,0,1,0,0,2,0,0,2,0,1,4,1
3634,55531,icc28ggRdRmZu2r1UuNBMEMav6yv5QTB,7GRhBDsirIGkRZBtSMEzNTyDr2JQm4xx,1,0,0,0,0,0,1,0,1,0.14285714285714285,1,0.0,0,0,0,0,0,0,0,1,0,0,1,1
3635,55532,vrKNA3eEZxLntZreFchejbQ8UgnPaTUE,RXDvfPUBYFlVdlueBFbLW0mhhAyGEqpt,16,12,7,6,4,0,3,0,32,4.571428571428571,1,0.0,4,7,6,4,8,0,0,3,0,21,11,1
3636,55536,lVM3D8yPmd62Fdb29hI2YI0VPwlNvI4t,7GRhBDsirIGkRZBtSMEzNTyDr2JQm4xx,5,2,1,0,1,0,3,0,7,1.0,2,0.0,0,1,0,1,2,0,0,3,0,2,5,1
3637,55556,Pg0gXikYsatKV6C2YLhl2LUFEvJuK423,SpATywNh6bZuzm8s1ceuBUnMUAeoAHHw,1,0,0,0,0,0,1,0,1,0.14285714285714285,1,0.0,0,0,0,0,0,0,0,1,0,0,1,1
3638,55557,FELnhQR0c7GZZX82ioYJEZsqujOrfyf7,SpATywNh6bZuzm8s1ceuBUnMUAeoAHHw,7,4,2,0,1,5,5,0,17,2.4285714285714284,2,0.0,0,2,0,1,4,5,0,5,0,3,14,1
3639,55560,NGCjg1L5IFyOkl1pLM5r5gRwzJYb60Ux,7GRhBDsirIGkRZBtSMEzNTyDr2JQm4xx,1,0,0,0,0,0,2,0,2,0.2857142857142857,1,0.0,0,0,0,0,0,0,0,2,0,0,2,1
3640,55591,9t2KBUQ5GiAw5lDqGOd0BuKNW0LVvTVG,A3fsA9Zfv1X2fVEQhTw51lKENdNrEqT3,42,26,18,64,13,0,5,0,126,18.0,2,0.0,2,18,55,13,24,0,9,5,0,88,38,0
3641,55593,9t2KBUQ5GiAw5lDqGOd0BuKNW0LVvTVG,bWdj2GDclj5ofokWjzoa5jAwMkxCykd6,31,62,32,74,10,12,15,1,206,29.428571428571427,4,0.0,15,32,67,10,47,12,7,15,1,124,82,0
3642,55624,QOwpzKqFZ32bfGgNkKoMFA0kfbklA5vW,7GRhBDsirIGkRZBtSMEzNTyDr2JQm4xx,6,6,4,0,1,0,3,0,14,2.0,2,0.0,0,4,0,1,6,0,0,3,0,5,9,1
3643,55637,ykaUPJW4Nc9r2mv4b25QxgdHgIcQ63RQ,7GRhBDsirIGkRZBtSMEzNTyDr2JQm4xx,2,0,0,0,0,0,2,0,2,0.2857142857142857,1,0.0,0,0,0,0,0,0,0,2,0,0,2,1
3644,55661,KKjjlHFWeLSseHD90tBUbNiE7bxXsPHK,A3fsA9Zfv1X2fVEQhTw51lKENdNrEqT3,1,0,0,0,0,0,1,0,1,0.14285714285714285,1,0.0,0,0,0,0,0,0,0,1,0,0,1,1
3645,55667,8ZhpSkXuKXWxDMEbryu3zVTkh7o5swmt,SpATywNh6bZuzm8s1ceuBUnMUAeoAHHw,10,14,1,6,0,5,11,0,37,5.285714285714286,2,0.0,7,1,6,0,7,5,0,11,0,14,23,1
3646,55692,y2EdvoA45jiUkTJcqU8mJ6KiT8yLZUjw,SpATywNh6bZuzm8s1ceuBUnMUAeoAHHw,5,3,1,0,0,3,3,0,10,1.4285714285714286,1,0.0,0,1,0,0,3,3,0,3,0,1,9,1
3647,55696,jaCcwHYnVHfV5mSQjy3wPbHHjpbiHJ5a,SpATywNh6bZuzm8s1ceuBUnMUAeoAHHw,15,29,3,16,2,0,20,0,70,10.0,2,0.0,6,3,15,2,23,0,1,20,0,26,44,0
3648,55699,HFO33lcsFKBDjSdg8KE5lGTCABOqytNM,RXDvfPUBYFlVdlueBFbLW0mhhAyGEqpt,44,53,16,108,20,2,5,1,205,29.285714285714285,2,0.0,34,16,92,20,19,2,16,5,1,162,43,0
3649,55734,JwzCuKRnJiCboJiRTMovpzJhdCfcNETm,bWdj2GDclj5ofokWjzoa5jAwMkxCykd6,4,2,0,0,0,0,2,0,4,0.5714285714285714,1,0.0,0,0,0,0,2,0,0,2,0,0,4,1
3650,55738,rCrf0hc0QRrKoK9w9R5Z8IvJlhGyjTyy,bWdj2GDclj5ofokWjzoa5jAwMkxCykd6,17,22,5,70,3,15,8,1,124,17.714285714285715,2,0.0,4,5,64,3,18,15,6,8,1,76,48,1
3651,55761,gEZOnwjA41tJvFOifXsWWDx9ePmBM5Kk,7GRhBDsirIGkRZBtSMEzNTyDr2JQm4xx,2,0,0,0,0,0,2,0,2,0.2857142857142857,1,0.0,0,0,0,0,0,0,0,2,0,0,2,1
3652,55773,mKWCTH01KzkLjFgXaCUEfs0dLu17r2jM,SpATywNh6bZuzm8s1ceuBUnMUAeoAHHw,3,2,1,0,0,0,1,0,4,0.5714285714285714,1,0.0,0,1,0,0,2,0,0,1,0,1,3,0
3653,55775,ZvdQafaVNGdhweIxI9FbVGKoGVxZDXFe,7GRhBDsirIGkRZBtSMEzNTyDr2JQm4xx,2,0,0,0,0,0,3,0,3,0.42857142857142855,2,0.0,0,0,0,0,0,0,0,3,0,0,3,1
3654,55777,aQ6WrdDe9pTNwVW3vmaMOs1pxy5r3Dxa,bWdj2GDclj5ofokWjzoa5jAwMkxCykd6,11,7,4,78,1,10,5,0,105,15.0,3,0.0,1,4,76,1,6,10,2,5,0,82,23,0
3655,55780,i5WDkhlf7rrVPmbQxsFTG1gowMYshvKj,bWdj2GDclj5ofokWjzoa5jAwMkxCykd6,9,15,6,8,5,2,3,0,39,5.571428571428571,2,0.0,7,6,8,5,8,2,0,3,0,26,13,1
3656,55820,LdhLlSD36AR268yKf0v6JE8vG5XYPHSF,SpATywNh6bZuzm8s1ceuBUnMUAeoAHHw,6,3,2,0,1,0,2,0,8,1.1428571428571428,1,0.0,0,2,0,1,3,0,0,2,0,3,5,1
3657,55846,q7ZtC6SevF8q9PKkXEaBMzUJ37xWhTDz,SpATywNh6bZuzm8s1ceuBUnMUAeoAHHw,17,22,8,19,3,16,12,0,80,11.428571428571429,4,0.0,6,8,16,3,16,16,3,12,0,33,47,1
3658,55865,ZEHkvN1JnR5aRFAd5UGefALeV7OHXWFP,7GRhBDsirIGkRZBtSMEzNTyDr2JQm4xx,37,106,32,42,13,24,22,3,242,34.57142857142857,4,0.0,49,32,40,13,57,24,2,22,3,134,108,1
3659,55877,GPe5tDvCMFa0yvoGbU7FbSxYbtu5eayz,SpATywNh6bZuzm8s1ceuBUnMUAeoAHHw,21,32,16,16,5,2,15,1,87,12.428571428571429,6,0.0,4,16,14,5,28,2,2,15,1,39,48,0
3660,55936,Uh4whLcptRuZuhdtjFruuYJY4YmOeYlV,SpATywNh6bZuzm8s1ceuBUnMUAeoAHHw,10,10,1,16,1,0,1,0,29,4.142857142857143,1,0.0,2,1,14,1,8,0,2,1,0,18,11,0
3661,55948,fOZTYKShrDEPywLsvnOq8r6y0esJP04d,G8EPVSXsOYB5YQWZGiz1aVq5Pgr2GrQu,38,109,45,66,26,35,20,2,303,43.285714285714285,4,0.0,49,45,53,26,60,35,13,20,2,173,130,0
3662,55969,Qs9VQJkriDZBH3FlG0bgTumvMa49MEaO,SpATywNh6bZuzm8s1ceuBUnMUAeoAHHw,2,0,0,0,0,2,1,0,3,0.42857142857142855,1,0.0,0,0,0,0,0,2,0,1,0,0,3,1
3663,56001,7EU7vMf2b4Xv6MdI3zbAqQNQTiRVSvYt,bWdj2GDclj5ofokWjzoa5jAwMkxCykd6,5,10,0,0,0,0,3,0,13,1.8571428571428572,2,0.0,0,0,0,0,10,0,0,3,0,0,13,0
3664,56002,aX8XTxJBQE99ErDnzZHdMXoXH5wjXDSz,SpATywNh6bZuzm8s1ceuBUnMUAeoAHHw,6,5,3,0,1,0,3,0,12,1.7142857142857142,1,0.0,0,3,0,1,5,0,0,3,0,4,8,1
3665,56010,hJo1MgKiPZFXuH2ko6hqPTd9dbjMQKDO,A3fsA9Zfv1X2fVEQhTw51lKENdNrEqT3,14,11,6,18,1,0,4,0,40,5.714285714285714,3,0.0,0,6,15,1,11,0,3,4,0,22,18,0
3666,56032,Y7LsqgQDUbWtXalaq4LkDEQKBlxOaCL3,A3fsA9Zfv1X2fVEQhTw51lKENdNrEqT3,7,8,3,0,2,0,1,0,14,2.0,1,0.0,1,3,0,2,7,0,0,1,0,6,8,1
3667,56040,420Gm2AWh0nImDTapBba1KojOp3noScY,SpATywNh6bZuzm8s1ceuBUnMUAeoAHHw,25,34,2,30,1,0,20,0,87,12.428571428571429,5,0.0,4,2,26,1,30,0,4,20,0,33,54,0
3668,56103,h7RW3AuXPtbIdr6MfEtTA3AoeBZHMuDe,SpATywNh6bZuzm8s1ceuBUnMUAeoAHHw,16,34,19,20,6,0,15,0,94,13.428571428571429,4,0.0,6,19,16,6,28,0,4,15,0,47,47,1
3669,56184,ndLSZuWw3bhlmRMZV7snp1VzVKaJfO1o,7GRhBDsirIGkRZBtSMEzNTyDr2JQm4xx,1,0,0,0,0,0,1,0,1,0.14285714285714285,1,0.0,0,0,0,0,0,0,0,1,0,0,1,1
3670,56202,xbYSqp0T7Uu69VoCNyfTCvQcS3HV3UeU,SpATywNh6bZuzm8s1ceuBUnMUAeoAHHw,15,55,23,20,1,54,35,6,194,27.714285714285715,7,0.0,12,23,16,1,43,54,4,35,6,52,142,1
3671,56215,J3FKLxbUlPTor4lyG8lMpHc8oUQEjfcp,SpATywNh6bZuzm8s1ceuBUnMUAeoAHHw,2,0,0,0,0,0,2,0,2,0.2857142857142857,1,0.0,0,0,0,0,0,0,0,2,0,0,2,0
3672,56223,7qDBI7pI0SQ1bfBBjf175GzJeqNA6CgO,7GRhBDsirIGkRZBtSMEzNTyDr2JQm4xx,5,2,1,0,1,0,2,0,6,0.8571428571428571,1,0.0,0,1,0,1,2,0,0,2,0,2,4,1
3673,56226,ok15ssTMon44FKUffK29mVEN6xTGU7F9,SpATywNh6bZuzm8s1ceuBUnMUAeoAHHw,10,6,4,6,3,0,1,0,20,2.857142857142857,1,0.0,1,4,5,3,5,0,1,1,0,13,7,1
3674,56244,XKteUTBXNdDfK3DTLCpAPdVFmdrv3Rx5,7GRhBDsirIGkRZBtSMEzNTyDr2JQm4xx,13,27,1,0,0,0,5,2,35,5.0,1,0.0,4,1,0,0,23,0,0,5,2,5,30,1
3675,56307,1GmUBgbH4qyfafNMJ2VdhisOaMrOQzrs,A3fsA9Zfv1X2fVEQhTw51lKENdNrEqT3,2,0,0,0,0,0,2,0,2,0.2857142857142857,1,0.0,0,0,0,0,0,0,0,2,0,0,2,1
3676,56321,YQloiHp4EDEAnQ7UnBm1Re3dyFVVFj8Z,SpATywNh6bZuzm8s1ceuBUnMUAeoAHHw,12,74,3,30,0,23,7,0,137,19.571428571428573,3,0.0,34,3,23,0,40,23,7,7,0,60,77,0
3677,56333,CwAitLaYuWheNSIoTgEZfJ56lAJf0HG8,7GRhBDsirIGkRZBtSMEzNTyDr2JQm4xx,29,34,13,43,11,0,7,0,108,15.428571428571429,3,0.0,20,13,38,11,14,0,5,7,0,82,26,1
3678,56354,EKjzbhHjXWCVYpc4LH9ESzstcF131j56,7GRhBDsirIGkRZBtSMEzNTyDr2JQm4xx,1,0,0,0,0,0,1,0,1,0.14285714285714285,1,0.0,0,0,0,0,0,0,0,1,0,0,1,1
3679,56366,CQ9z29HXcNaQxMUuAJ5s2uvH0fLzGYjv,SpATywNh6bZuzm8s1ceuBUnMUAeoAHHw,11,16,7,18,0,1,5,1,48,6.857142857142857,1,0.0,4,7,15,0,12,1,3,5,1,26,22,1
3680,56398,aGbKep26uuguTzwAUYDcwjqS1RQNroF5,SpATywNh6bZuzm8s1ceuBUnMUAeoAHHw,28,36,13,36,7,0,8,1,101,14.428571428571429,3,0.0,12,13,33,7,24,0,3,8,1,65,36,1
3681,56418,1yk3ITtkCTeBgpvC46EyEEfYcyKWD7Qc,SpATywNh6bZuzm8s1ceuBUnMUAeoAHHw,30,21,13,27,7,3,6,1,78,11.142857142857142,2,0.0,6,13,24,7,15,3,3,6,1,50,28,0
3682,56423,ouOARkjMonPxhUKVUmTMgEZ4vGcTZcAk,7GRhBDsirIGkRZBtSMEzNTyDr2JQm4xx,23,18,0,68,0,0,2,0,88,12.571428571428571,1,0.0,9,0,67,0,9,0,1,2,0,76,12,1
3683,56444,bUYPIrKUhpdtG1KH0Y9GXp4xZk1AgdLJ,SpATywNh6bZuzm8s1ceuBUnMUAeoAHHw,4,1,1,0,0,2,2,0,6,0.8571428571428571,1,0.0,0,1,0,0,1,2,0,2,0,1,5,0
3684,56445,UalIk08w9p6VGqWfZ6drUaQL5GhjEzcw,SpATywNh6bZuzm8s1ceuBUnMUAeoAHHw,6,1,0,0,0,1,4,1,7,1.0,1,0.0,0,0,0,0,1,1,0,4,1,0,7,1
3685,56446,TVQrQzdOFJxL0otAPBsN1HXNpNNlOLWm,7GRhBDsirIGkRZBtSMEzNTyDr2JQm4xx,24,41,0,84,3,0,3,0,131,18.714285714285715,2,0.0,27,0,74,3,14,0,10,3,0,104,27,1
3686,56477,g5ozjvUCdaFJGkcIZvHKw5OmNcDvdyli,G8EPVSXsOYB5YQWZGiz1aVq5Pgr2GrQu,9,11,3,12,1,0,2,0,29,4.142857142857143,1,0.0,6,3,7,1,5,0,5,2,0,17,12,1
3687,56490,kqS8BwWN9R1093oeblGkvtCsQJ68Gh0G,SpATywNh6bZuzm8s1ceuBUnMUAeoAHHw,30,116,55,45,27,20,22,0,285,40.714285714285715,10,0.0,18,55,36,27,98,20,9,22,0,136,149,0
3688,56494,mSe1A4ptQkbf64uqFepueFInmdXgPhYy,SpATywNh6bZuzm8s1ceuBUnMUAeoAHHw,7,4,2,0,1,0,6,0,13,1.8571428571428572,1,0.0,0,2,0,1,4,0,0,6,0,3,10,1
3689,56495,LMrnY95OXOcKLbPJNFk6CNnUTJJC01Mr,7GRhBDsirIGkRZBtSMEzNTyDr2JQm4xx,1,0,0,0,0,0,1,0,1,0.14285714285714285,1,0.0,0,0,0,0,0,0,0,1,0,0,1,1
3690,56501,AxlfZzXkXnhJLfyjxNARPh8wNlmuerJT,SpATywNh6bZuzm8s1ceuBUnMUAeoAHHw,6,6,2,0,1,0,4,0,13,1.8571428571428572,1,0.0,0,2,0,1,6,0,0,4,0,3,10,0
3691,56514,57DmCkxeT4CodU6tDrBCDXqGpXQ0D1sF,A3fsA9Zfv1X2fVEQhTw51lKENdNrEqT3,54,62,4,168,1,13,6,0,254,36.285714285714285,3,0.0,5,4,136,1,57,13,32,6,0,146,108,0
3692,56536,v3Nj91qeWhwVYxgQExYL9jO1Rd2uR5bo,SpATywNh6bZuzm8s1ceuBUnMUAeoAHHw,5,2,1,0,1,0,2,0,6,0.8571428571428571,1,0.0,0,1,0,1,2,0,0,2,0,2,4,1
3693,56615,ktKfaRtFOnFJdZMcfSCqSP14OG6TxlMY,SpATywNh6bZuzm8s1ceuBUnMUAeoAHHw,24,38,4,30,3,0,9,0,84,12.0,3,0.0,6,4,30,3,32,0,0,9,0,43,41,0
3694,56621,ma8nscMCD0ftKjbxujos5nzHFFtaZMo4,A3fsA9Zfv1X2fVEQhTw51lKENdNrEqT3,7,6,2,0,1,0,4,0,13,1.8571428571428572,2,0.0,0,2,0,1,6,0,0,4,0,3,10,0
3695,56633,NGQ6HXbhxwBlJxikVxca5noX2u8xI9AV,A3fsA9Zfv1X2fVEQhTw51lKENdNrEqT3,40,31,14,76,10,0,6,0,137,19.571428571428573,2,0.0,2,14,61,10,29,0,15,6,0,87,50,0
3696,56683,MbewcgzgToNhp9B6eaNSolme5R0M2nkY,A3fsA9Zfv1X2fVEQhTw51lKENdNrEqT3,1,0,0,0,0,0,1,0,1,0.14285714285714285,1,0.0,0,0,0,0,0,0,0,1,0,0,1,1
3697,56696,ReIy3etnMmZBVQ3CosU4FbzEF29F9nHU,SpATywNh6bZuzm8s1ceuBUnMUAeoAHHw,12,16,0,10,0,0,6,0,32,4.571428571428571,4,0.0,6,0,10,0,10,0,0,6,0,16,16,0
3698,56715,6iyCCTAEdDUFtgP0yXcCVROgqrKuAsJY,SpATywNh6bZuzm8s1ceuBUnMUAeoAHHw,14,14,10,18,4,2,6,0,54,7.714285714285714,2,0.0,2,10,15,4,12,2,3,6,0,31,23,0
3699,56725,Bxz1zTHFCCx9o1kJA9B0Pzm3PnmqKxr5,SpATywNh6bZuzm8s1ceuBUnMUAeoAHHw,9,18,14,0,8,0,2,0,42,6.0,4,0.0,1,14,0,8,17,0,0,2,0,23,19,1
3700,56736,csg0yBjjrshmLGGyq6UVgiiqMZP9T0vI,A3fsA9Zfv1X2fVEQhTw51lKENdNrEqT3,2,0,0,0,0,0,2,0,2,0.2857142857142857,1,0.0,0,0,0,0,0,0,0,2,0,0,2,1
3701,56791,1G2HPMj7bCJEDZxxbF8ae2kPQCHvH8vB,bWdj2GDclj5ofokWjzoa5jAwMkxCykd6,10,18,9,0,4,1,13,8,53,7.571428571428571,2,0.0,0,9,0,4,18,1,0,13,8,13,40,1
3702,56806,1ZeLZDjvvDkWWsoonk2q4KdJg9fzmSLS,SpATywNh6bZuzm8s1ceuBUnMUAeoAHHw,8,16,0,4,0,0,3,0,23,3.2857142857142856,2,0.0,1,0,3,0,15,0,1,3,0,4,19,1
3703,56817,qzripbhm6sAPdZP3rld8n0avyAjcFNv4,G8EPVSXsOYB5YQWZGiz1aVq5Pgr2GrQu,4,2,1,0,1,0,1,0,5,0.7142857142857143,1,0.0,0,1,0,1,2,0,0,1,0,2,3,0
3704,56834,i86rWeuy3cBtKeVeDiyieBp3ovKTOVnd,SpATywNh6bZuzm8s1ceuBUnMUAeoAHHw,13,16,8,0,5,0,8,1,38,5.428571428571429,2,0.0,1,8,0,5,15,0,0,8,1,14,24,1
3705,56864,y64BqR5f4fJBfwxF4aLt14ViHkvnjGLs,A3fsA9Zfv1X2fVEQhTw51lKENdNrEqT3,42,34,16,50,7,8,17,0,132,18.857142857142858,4,0.0,3,16,48,7,31,8,2,17,0,74,58,1
3706,56875,T8TKNQciNYxyZa02JNR1WAwQ2Y5qXjum,G8EPVSXsOYB5YQWZGiz1aVq5Pgr2GrQu,20,38,20,22,5,1,17,2,105,15.0,4,0.0,6,20,18,5,32,1,4,17,2,49,56,0
3707,56931,T6EWQ7jVP89JlHzj41KN1gEtGYevpSQM,bWdj2GDclj5ofokWjzoa5jAwMkxCykd6,15,18,10,10,4,9,16,2,69,9.857142857142858,4,0.0,3,10,9,4,15,9,1,16,2,26,43,1
3708,56956,6iOLSqRTRABETCaDgzA6NufDV3dLbSSl,bWdj2GDclj5ofokWjzoa5jAwMkxCykd6,33,23,15,102,7,9,16,0,172,24.571428571428573,3,0.0,5,15,89,7,18,9,13,16,0,116,56,1
3709,56963,GKzw24uGItaRbrNpOwWtTqnRbaZohHHZ,SpATywNh6bZuzm8s1ceuBUnMUAeoAHHw,17,50,23,20,8,38,26,3,168,24.0,3,0.0,18,23,17,8,32,38,3,26,3,66,102,0
3710,56974,ca0FiReQbSJ11H1fqXLWoWnOvLbBbR3V,SpATywNh6bZuzm8s1ceuBUnMUAeoAHHw,15,22,11,0,4,7,8,1,53,7.571428571428571,2,0.0,7,11,0,4,15,7,0,8,1,22,31,0
3711,57017,RVthfCRYYRCiFRx3Qkq6vL0caXa3Y6XL,SpATywNh6bZuzm8s1ceuBUnMUAeoAHHw,13,10,2,28,0,2,13,1,56,8.0,1,0.0,8,2,26,0,2,2,2,13,1,36,20,0
3712,57048,I7IIrHAh1LzzCf8lcvI92o8deFulzAh8,G8EPVSXsOYB5YQWZGiz1aVq5Pgr2GrQu,1,0,0,0,0,0,1,0,1,0.14285714285714285,1,0.0,0,0,0,0,0,0,0,1,0,0,1,1
3713,57049,I7IIrHAh1LzzCf8lcvI92o8deFulzAh8,RXDvfPUBYFlVdlueBFbLW0mhhAyGEqpt,1,0,0,0,0,0,1,0,1,0.14285714285714285,1,0.0,0,0,0,0,0,0,0,1,0,0,1,1
3714,57051,I7IIrHAh1LzzCf8lcvI92o8deFulzAh8,A3fsA9Zfv1X2fVEQhTw51lKENdNrEqT3,1,0,0,0,0,0,1,0,1,0.14285714285714285,1,0.0,0,0,0,0,0,0,0,1,0,0,1,1
3715,57116,FeZn6c6vb5R5SPZtACtqOXKJC1inbsZN,SpATywNh6bZuzm8s1ceuBUnMUAeoAHHw,21,21,2,20,3,1,6,0,53,7.571428571428571,2,0.0,4,2,16,3,17,1,4,6,0,25,28,0
3716,57131,3CLlQYPJzaDqTsMDCyIWfYEpsKmi9sXD,G8EPVSXsOYB5YQWZGiz1aVq5Pgr2GrQu,17,33,9,10,7,3,8,1,71,10.142857142857142,2,0.0,18,9,6,7,15,3,4,8,1,40,31,0
3717,57193,v6sJocXlJFeoDG1nXrmoTeUih19304GZ,SpATywNh6bZuzm8s1ceuBUnMUAeoAHHw,12,17,1,9,1,0,5,0,33,4.714285714285714,3,0.0,2,1,8,1,15,0,1,5,0,12,21,1
3718,57213,iSYj2oDe5RyCcvKGOIlJlpq8H0342az5,SpATywNh6bZuzm8s1ceuBUnMUAeoAHHw,15,12,10,5,9,1,10,1,48,6.857142857142857,1,0.0,1,10,4,9,11,1,1,10,1,24,24,1
3719,57225,Ct3eFzamQizfpV2I2rZSBKqavcN2kzGI,bWdj2GDclj5ofokWjzoa5jAwMkxCykd6,3,2,1,0,0,0,1,0,4,0.5714285714285714,1,0.0,0,1,0,0,2,0,0,1,0,1,3,1
3720,57274,a91ewPLjlp1X8KqwrnZISs7xgERRXuh7,SpATywNh6bZuzm8s1ceuBUnMUAeoAHHw,19,42,18,8,5,6,20,0,99,14.142857142857142,6,0.0,0,18,6,5,42,6,2,20,0,29,70,0
3721,57275,2Al3Sg2oc4NVlws5jTNzQZvd3PHAcnAl,SpATywNh6bZuzm8s1ceuBUnMUAeoAHHw,9,8,3,0,3,2,2,0,18,2.5714285714285716,1,0.0,1,3,0,3,7,2,0,2,0,7,11,1
3722,57289,JfftjOGdDbpgbrupi0Gwr899R0jzXikJ,SpATywNh6bZuzm8s1ceuBUnMUAeoAHHw,25,37,18,5,8,0,12,0,80,11.428571428571429,5,0.0,7,18,5,8,30,0,0,12,0,38,42,0
3723,57310,amNosdi6Uiilljdy8esSBA3F29NKPLUW,A3fsA9Zfv1X2fVEQhTw51lKENdNrEqT3,15,19,12,0,3,1,17,0,52,7.428571428571429,5,0.0,0,12,0,3,19,1,0,17,0,15,37,1
3724,57348,YPxQmDfYnmHgiT7CBa1xK3KUyMZAnQfd,SpATywNh6bZuzm8s1ceuBUnMUAeoAHHw,15,7,4,6,3,1,5,1,27,3.857142857142857,1,0.0,2,4,6,3,5,1,0,5,1,15,12,1
3725,57362,VrrBciftY2IctWxZzgYOD4l9QhmKgryv,SpATywNh6bZuzm8s1ceuBUnMUAeoAHHw,27,29,20,18,10,1,5,0,83,11.857142857142858,3,0.0,5,20,16,10,24,1,2,5,0,51,32,0
3726,57385,XJf8gYhDJm1hrkVJvLQ4HKEnvPd3mIMq,SpATywNh6bZuzm8s1ceuBUnMUAeoAHHw,20,22,0,18,0,1,5,0,46,6.571428571428571,3,0.0,4,0,18,0,18,1,0,5,0,22,24,0
3727,57421,xVSPiuldrfuaqB5x0wSqqh0RzPMsoNZK,SpATywNh6bZuzm8s1ceuBUnMUAeoAHHw,13,9,7,0,3,1,4,1,25,3.5714285714285716,3,0.0,0,7,0,3,9,1,0,4,1,10,15,0
3728,57477,5OgjW4RBhSCbfYx5XYwPp5mVp3N7l8JT,SpATywNh6bZuzm8s1ceuBUnMUAeoAHHw,15,28,19,7,0,11,42,3,110,15.714285714285714,6,0.0,2,19,7,0,26,11,0,42,3,28,82,1
3729,57497,h8ApK52PAIR0nuhXQv52hCsI8LxUHnXl,SpATywNh6bZuzm8s1ceuBUnMUAeoAHHw,13,18,0,15,0,0,4,1,38,5.428571428571429,1,0.0,6,0,12,0,12,0,3,4,1,18,20,1
3730,57540,q9BQrPVmTGVLXUZRKxvQUgkPlzz6bi8e,SpATywNh6bZuzm8s1ceuBUnMUAeoAHHw,7,8,4,0,4,0,2,0,18,2.5714285714285716,1,0.0,0,4,0,4,8,0,0,2,0,8,10,1
3731,57564,eAArxLyCThtu9N3Mv8rQculKbGSa66j9,bWdj2GDclj5ofokWjzoa5jAwMkxCykd6,7,7,2,22,1,0,5,0,37,5.285714285714286,2,0.0,3,2,20,1,4,0,2,5,0,26,11,1
3732,57568,73lhhrOcE2srJj5BkIzSweWSnQRZBT2o,SpATywNh6bZuzm8s1ceuBUnMUAeoAHHw,11,27,15,6,0,1,8,0,57,8.142857142857142,6,0.0,4,15,6,0,23,1,0,8,0,25,32,1
3733,57594,OOsRSTJd6U7cE43XHk99M9ofvrefufrh,A3fsA9Zfv1X2fVEQhTw51lKENdNrEqT3,3,3,1,0,0,0,1,0,5,0.7142857142857143,1,0.0,0,1,0,0,3,0,0,1,0,1,4,0
3734,57617,NVzsLV2hJQHxCBnLyaDpT9HrhRSWUOfa,RXDvfPUBYFlVdlueBFbLW0mhhAyGEqpt,43,78,29,66,11,2,20,4,210,30.0,3,0.0,18,29,63,11,60,2,3,20,4,121,89,1
3735,57636,D5gDQ8hFb4klemeBiodWmMPe9KIvqw9O,A3fsA9Zfv1X2fVEQhTw51lKENdNrEqT3,19,29,1,12,0,0,5,0,47,6.714285714285714,2,0.0,1,1,9,0,28,0,3,5,0,11,36,1
3736,57656,Y3ZpN8DOQK8YTfD0eUtklxiZfpWuBIeU,SpATywNh6bZuzm8s1ceuBUnMUAeoAHHw,21,18,9,12,5,2,5,0,51,7.285714285714286,1,0.0,7,9,12,5,11,2,0,5,0,33,18,0
3737,57712,p8eEbMqW5LefqN7qPq07exxdOPrIZY20,SpATywNh6bZuzm8s1ceuBUnMUAeoAHHw,14,17,7,14,5,0,4,0,47,6.714285714285714,2,0.0,4,7,14,5,13,0,0,4,0,30,17,1
3738,57731,VfWuQS8OTjJmyvWxq07hV2rzKtyu1LCX,SpATywNh6bZuzm8s1ceuBUnMUAeoAHHw,11,10,6,6,0,0,3,0,25,3.5714285714285716,1,0.0,2,6,6,0,8,0,0,3,0,14,11,0
3739,57735,uhbUne0Zqx7l0LKNWrxxR44WistJmxKI,SpATywNh6bZuzm8s1ceuBUnMUAeoAHHw,4,2,0,0,0,0,2,0,4,0.5714285714285714,1,0.0,0,0,0,0,2,0,0,2,0,0,4,1
3740,57770,TiyssQ1xBxRpSE8M84hoblpjLNawoMPM,A3fsA9Zfv1X2fVEQhTw51lKENdNrEqT3,12,7,5,0,4,0,5,0,21,3.0,1,0.0,0,5,0,4,7,0,0,5,0,9,12,1
3741,57797,bZSiNUbAIuydDBd77IMAJ15Hy6k2A1kT,A3fsA9Zfv1X2fVEQhTw51lKENdNrEqT3,2,0,0,0,0,0,2,0,2,0.2857142857142857,1,0.0,0,0,0,0,0,0,0,2,0,0,2,0
3742,57814,qdfZW2ffZy8gfDfLseVXmzjU3pjHztuR,SpATywNh6bZuzm8s1ceuBUnMUAeoAHHw,11,6,4,11,2,1,6,1,31,4.428571428571429,1,0.0,1,4,10,2,5,1,1,6,1,17,14,1
3743,57823,nTCOXKuQTHlcdJy5DLRFkg6Zh0x7ymZf,SpATywNh6bZuzm8s1ceuBUnMUAeoAHHw,12,20,0,18,0,3,4,0,45,6.428571428571429,1,0.0,9,0,15,0,11,3,3,4,0,24,21,0
3744,57865,6R0qSS2YfDD3HGMPKZeKRUJLbFOIEhNG,SpATywNh6bZuzm8s1ceuBUnMUAeoAHHw,6,13,1,0,0,0,2,0,16,2.2857142857142856,1,0.0,0,1,0,0,13,0,0,2,0,1,15,0
3745,57921,LJN1NW4KDrkfGUEkF9SJPSL4rdPIFcim,RXDvfPUBYFlVdlueBFbLW0mhhAyGEqpt,8,6,4,0,1,0,5,0,16,2.2857142857142856,2,0.0,0,4,0,1,6,0,0,5,0,5,11,1
3746,57923,g6dPr9Qj9PAMVLVyPAgx25XT3ANwjQos,A3fsA9Zfv1X2fVEQhTw51lKENdNrEqT3,33,11,9,48,8,0,2,0,78,11.142857142857142,1,0.0,1,9,46,8,10,0,2,2,0,64,14,1
3747,58064,rtg3Ki4vk14kI9MkEBE0pkOCAO2AnCnU,A3fsA9Zfv1X2fVEQhTw51lKENdNrEqT3,66,43,29,160,15,0,14,1,262,37.42857142857143,4,0.0,3,29,132,15,40,0,28,14,1,179,83,0
3748,58067,pAWmot8vJjNkDuzTDPJSBxqvPejAjgVS,RXDvfPUBYFlVdlueBFbLW0mhhAyGEqpt,6,3,2,0,2,0,1,0,8,1.1428571428571428,1,0.0,0,2,0,2,3,0,0,1,0,4,4,1
3749,58072,QWCcSRplc8XLohtOnjfleuw3Kl55Wt2l,G8EPVSXsOYB5YQWZGiz1aVq5Pgr2GrQu,11,10,6,0,4,0,1,0,21,3.0,1,0.0,0,6,0,4,10,0,0,1,0,10,11,1
3750,58081,VdrjT29t1tCYeqV5Pjs9K79bb5dKTQSe,SpATywNh6bZuzm8s1ceuBUnMUAeoAHHw,8,4,2,0,2,0,4,0,12,1.7142857142857142,1,0.0,0,2,0,2,4,0,0,4,0,4,8,1
3751,58088,ohNbQfFfbGDEMVmhwhRAFtQhn1peVJYy,SpATywNh6bZuzm8s1ceuBUnMUAeoAHHw,14,9,5,16,3,3,2,0,38,5.428571428571429,1,0.0,3,5,14,3,6,3,2,2,0,25,13,1
3752,58102,RPQvIQfjeayIRS4PyDyrIytbJ9ZHNktA,SpATywNh6bZuzm8s1ceuBUnMUAeoAHHw,31,43,21,12,7,7,11,1,102,14.571428571428571,4,0.0,16,21,12,7,27,7,0,11,1,56,46,1
3753,58112,Bf025FfgNrlcqN8gYGnmBAhjBy0v5Xmo,A3fsA9Zfv1X2fVEQhTw51lKENdNrEqT3,6,4,2,0,1,0,4,0,11,1.5714285714285714,1,0.0,0,2,0,1,4,0,0,4,0,3,8,1
3754,58128,th3jtP88bHr6FB2R2HdadrOKTixMDxTi,SpATywNh6bZuzm8s1ceuBUnMUAeoAHHw,4,0,0,0,0,0,5,1,6,0.8571428571428571,1,0.0,0,0,0,0,0,0,0,5,1,0,6,1
3755,58153,5IgfYzsKnLRjBd3YVdiUAOaMV18WR5D2,SpATywNh6bZuzm8s1ceuBUnMUAeoAHHw,1,0,0,0,0,0,2,0,2,0.2857142857142857,1,0.0,0,0,0,0,0,0,0,2,0,0,2,1
3756,58242,JaIi02fnjAZfoUxjYtpyJ7uZYWKdC5yF,RXDvfPUBYFlVdlueBFbLW0mhhAyGEqpt,19,43,2,17,3,10,16,0,91,13.0,2,0.0,4,2,17,3,39,10,0,16,0,26,65,1
3757,58255,zzLagpOecSivjjn7PNG5qmEhwa4PmnNX,SpATywNh6bZuzm8s1ceuBUnMUAeoAHHw,13,20,8,14,4,0,5,0,51,7.285714285714286,2,0.0,9,8,12,4,11,0,2,5,0,33,18,1
3758,58286,y6i20DJpIul6LihHwgZcWxbdAap5GcBP,A3fsA9Zfv1X2fVEQhTw51lKENdNrEqT3,16,18,8,0,3,14,14,1,58,8.285714285714286,4,0.0,2,8,0,3,16,14,0,14,1,13,45,1
3759,58291,PCPmtsqEtkHe7GooXQswbqyH8cnukgFn,G8EPVSXsOYB5YQWZGiz1aVq5Pgr2GrQu,27,24,0,42,0,28,8,1,103,14.714285714285714,1,0.0,11,0,32,0,13,28,10,8,1,43,60,0
3760,58300,uQw9hBSE2Dk9ZRkbmlhR0YJ8RRLoEt0U,SpATywNh6bZuzm8s1ceuBUnMUAeoAHHw,11,8,1,10,0,0,2,0,21,3.0,1,0.0,2,1,10,0,6,0,0,2,0,13,8,1
3761,58316,GfppdBt6zqP8G2m8ukjaahHhJ4ewTb0w,SpATywNh6bZuzm8s1ceuBUnMUAeoAHHw,12,31,2,14,1,1,4,0,53,7.571428571428571,3,0.0,6,2,14,1,25,1,0,4,0,23,30,0
3762,58357,OdMr7dE5UlAme9Tp979vREBvY5CV50po,A3fsA9Zfv1X2fVEQhTw51lKENdNrEqT3,41,18,11,50,9,0,2,0,90,12.857142857142858,1,0.0,3,11,46,9,15,0,4,2,0,69,21,0
3763,58359,czKChsqaxfwVoznY2WnWYH2vLIXb6X34,bWdj2GDclj5ofokWjzoa5jAwMkxCykd6,15,19,10,2,9,1,4,0,45,6.428571428571429,2,0.0,3,10,2,9,16,1,0,4,0,24,21,1
3764,58403,Xn2ydtleLSG85TyAEd0OMkY2BfH9jhfO,SpATywNh6bZuzm8s1ceuBUnMUAeoAHHw,27,40,2,36,4,52,13,1,148,21.142857142857142,2,0.0,12,2,30,4,28,52,6,13,1,48,100,0
3765,58453,fgzbUfrTxXYCuiFYTG1cTemcEJUl36an,A3fsA9Zfv1X2fVEQhTw51lKENdNrEqT3,10,7,4,0,3,0,4,0,18,2.5714285714285716,3,0.0,0,4,0,3,7,0,0,4,0,7,11,1
3766,58524,T761UltC8HrAVgHTpcJuQFf7vNJ3Ud9J,A3fsA9Zfv1X2fVEQhTw51lKENdNrEqT3,8,8,4,0,2,0,2,0,16,2.2857142857142856,1,0.0,0,4,0,2,8,0,0,2,0,6,10,0
3767,58526,OgKWYLWF7k4jNyuIPtj4HfbaQ79kKNws,A3fsA9Zfv1X2fVEQhTw51lKENdNrEqT3,12,7,6,0,6,0,10,0,29,4.142857142857143,2,0.0,0,6,0,6,7,0,0,10,0,12,17,1
3768,58544,bpxaFadaQixJuWRVtAAq5miKiBM3zC6u,A3fsA9Zfv1X2fVEQhTw51lKENdNrEqT3,40,59,3,88,3,21,17,0,191,27.285714285714285,6,0.0,2,3,83,3,57,21,5,17,0,91,100,0
3769,58560,3wojMge418Q4FflCb29r3hem59j6egRX,SpATywNh6bZuzm8s1ceuBUnMUAeoAHHw,15,18,0,0,0,1,5,0,24,3.4285714285714284,1,0.0,6,0,0,0,12,1,0,5,0,6,18,1
3770,58582,o0M6SOlciWGWtqkYLASaq6tS76D18V6N,SpATywNh6bZuzm8s1ceuBUnMUAeoAHHw,30,69,25,40,10,47,21,1,213,30.428571428571427,5,0.0,28,25,33,10,41,47,7,21,1,96,117,0
3771,58601,pIkx6nDAjTla5NYVEsjhMXOIu5zXDzmO,G8EPVSXsOYB5YQWZGiz1aVq5Pgr2GrQu,26,18,12,0,12,0,10,2,54,7.714285714285714,2,0.0,3,12,0,12,15,0,0,10,2,27,27,0
3772,58642,ALYZFAVviUOGzyN4znk46d3PmVgvtUAM,A3fsA9Zfv1X2fVEQhTw51lKENdNrEqT3,21,10,1,36,0,0,2,0,49,7.0,1,0.0,0,1,31,0,10,0,5,2,0,32,17,1
3773,58644,zWZdErlwOQ1yvd6vlyAltL2Balhdc8gj,G8EPVSXsOYB5YQWZGiz1aVq5Pgr2GrQu,53,76,45,172,19,47,20,1,380,54.285714285714285,5,0.0,13,45,145,19,63,47,27,20,1,222,158,0
3774,58675,jm31Z85lUKPglpGy76SHR0pRWJW0VhuU,SpATywNh6bZuzm8s1ceuBUnMUAeoAHHw,15,37,5,10,1,1,12,0,66,9.428571428571429,4,0.0,6,5,10,1,31,1,0,12,0,22,44,1
3775,58693,2AEx3J0dyYAsdnSPWbdrCmQApLqSYiKY,SpATywNh6bZuzm8s1ceuBUnMUAeoAHHw,18,32,17,10,3,12,13,2,89,12.714285714285714,2,0.0,10,17,8,3,22,12,2,13,2,38,51,0
3776,58794,1zErz13s8fNQRVaEvkOtvw6bLhr23yB4,SpATywNh6bZuzm8s1ceuBUnMUAeoAHHw,7,6,2,18,0,0,1,0,27,3.857142857142857,1,0.0,3,2,15,0,3,0,3,1,0,20,7,0
3777,58800,irZDaKqT4KdxcZGgiOHoDpvTtZyUugWP,G8EPVSXsOYB5YQWZGiz1aVq5Pgr2GrQu,25,32,14,30,6,8,11,0,101,14.428571428571429,3,0.0,1,14,25,6,31,8,5,11,0,46,55,0
3778,58804,OUbh6hvaOJDp9RK7kgTBzzPmjzmkYhZF,SpATywNh6bZuzm8s1ceuBUnMUAeoAHHw,25,31,0,24,1,16,12,2,86,12.285714285714286,2,0.0,5,0,21,1,26,16,3,12,2,27,59,0
3779,58812,x2TXADDQJTDLVMnKDb6BhJyWEoYQjlQy,SpATywNh6bZuzm8s1ceuBUnMUAeoAHHw,23,45,0,26,1,8,8,0,88,12.571428571428571,4,0.0,19,0,20,1,26,8,6,8,0,40,48,1
3780,58849,9UxAqNYuBtvS2ppV37y5D8wZyoNAl3Em,SpATywNh6bZuzm8s1ceuBUnMUAeoAHHw,13,40,3,15,0,23,13,4,98,14.0,2,0.0,13,3,12,0,27,23,3,13,4,28,70,1
3781,58855,6K3h9aDeHI9AUqOKTvZxzGkKh6WMc7A3,SpATywNh6bZuzm8s1ceuBUnMUAeoAHHw,15,8,7,0,6,0,2,0,23,3.2857142857142856,1,0.0,0,7,0,6,8,0,0,2,0,13,10,0
3782,58877,Hoitr98hXhrf7xDGgACEFamKhiarA3wg,SpATywNh6bZuzm8s1ceuBUnMUAeoAHHw,30,56,32,28,14,44,14,1,189,27.0,5,0.0,14,32,26,14,42,44,2,14,1,86,103,0
3783,58887,7wyfXvc1g99QNmXzEb4w8C1vE0Vi2bHm,RXDvfPUBYFlVdlueBFbLW0mhhAyGEqpt,15,27,12,0,6,1,6,0,52,7.428571428571429,3,0.0,0,12,0,6,27,1,0,6,0,18,34,0
3784,58937,BWQpUowEHGBDEzSf23lNUZVBPlEw3Sq1,SpATywNh6bZuzm8s1ceuBUnMUAeoAHHw,13,26,3,12,0,1,8,0,50,7.142857142857143,4,0.0,8,3,9,0,18,1,3,8,0,20,30,0
3785,59023,1zErz13s8fNQRVaEvkOtvw6bLhr23yB4,G8EPVSXsOYB5YQWZGiz1aVq5Pgr2GrQu,43,80,32,76,13,10,22,3,236,33.714285714285715,3,0.0,30,32,51,13,50,10,25,22,3,126,110,0
3786,59059,WyukafQHQxismOtYiPzoFkAc38hAOB09,SpATywNh6bZuzm8s1ceuBUnMUAeoAHHw,31,75,33,29,14,17,12,0,180,25.714285714285715,5,0.0,34,33,26,14,41,17,3,12,0,107,73,0
3787,59112,SSR2C7GBXM7XyR67GN0wwOxiCuLYjW4G,SpATywNh6bZuzm8s1ceuBUnMUAeoAHHw,18,35,3,3,4,3,7,1,56,8.0,2,0.0,14,3,3,4,21,3,0,7,1,24,32,0
3788,59133,kqS8BwWN9R1093oeblGkvtCsQJ68Gh0G,A3fsA9Zfv1X2fVEQhTw51lKENdNrEqT3,7,6,3,0,2,0,3,0,14,2.0,2,0.0,0,3,0,2,6,0,0,3,0,5,9,1
3789,59172,jImHfNEIObE674KdIbKVj7cCJ4ufqzHJ,SpATywNh6bZuzm8s1ceuBUnMUAeoAHHw,9,23,11,0,3,59,9,0,105,15.0,4,0.0,2,11,0,3,21,59,0,9,0,16,89,0
3790,60074,Vve0UwhmiGWZN8bT2t4sC82sMWi2ZyY8,7GRhBDsirIGkRZBtSMEzNTyDr2JQm4xx,7,0,0,0,0,1,9,1,11,1.5714285714285714,2,0.0,0,0,0,0,0,1,0,9,1,0,11,1
3791,60210,wGqhUJlJ3fGYOW2r7IbwNL0CdAR0avoU,7GRhBDsirIGkRZBtSMEzNTyDr2JQm4xx,63,217,77,172,52,73,14,0,605,86.42857142857143,8,0.0,121,77,135,52,96,73,37,14,0,385,220,1
3792,60214,Y3uwxWCm13Ol5xozrT2GPjOPhBlC2kOq,7GRhBDsirIGkRZBtSMEzNTyDr2JQm4xx,44,72,12,108,10,0,5,0,207,29.571428571428573,3,0.0,20,12,99,10,52,0,9,5,0,141,66,1
3793,60229,4IJ56QlJSL8avuRQEkrBcEyhUIO3LIP3,7GRhBDsirIGkRZBtSMEzNTyDr2JQm4xx,30,75,26,58,18,5,6,0,188,26.857142857142858,2,0.0,42,26,45,18,33,5,13,6,0,131,57,1
3794,60241,n2vbSLePtnxy4AVvThroeNvlXpcTMINy,7GRhBDsirIGkRZBtSMEzNTyDr2JQm4xx,21,27,13,2,7,0,1,0,50,7.142857142857143,1,0.0,7,13,1,7,20,0,1,1,0,28,22,0
3795,60264,iSrdvAXagFyTWuVpDzl1vXqwXkCyI8Nx,7GRhBDsirIGkRZBtSMEzNTyDr2JQm4xx,2,0,0,0,0,0,6,0,6,0.8571428571428571,2,0.0,0,0,0,0,0,0,0,6,0,0,6,1
3796,60283,uRNJHauAxW10nQZrIpEU1nj0mhvBnDcR,7GRhBDsirIGkRZBtSMEzNTyDr2JQm4xx,5,3,1,0,1,1,3,0,9,1.2857142857142858,1,0.0,0,1,0,1,3,1,0,3,0,2,7,1
3797,60427,r3TtJNrYEPB9JfkbBp23luDTSVLZGHt2,7GRhBDsirIGkRZBtSMEzNTyDr2JQm4xx,56,222,12,75,27,54,35,1,426,60.857142857142854,12,0.0,92,12,63,27,130,54,12,35,1,194,232,0
3798,60442,76btfIjeEvKDRqZ07unLyzOBWCQVXirv,7GRhBDsirIGkRZBtSMEzNTyDr2JQm4xx,4,2,1,0,1,0,1,0,5,0.7142857142857143,1,0.0,0,1,0,1,2,0,0,1,0,2,3,0
3799,60518,r639bFH7kDBWMyuyounNz9zTrG9jbNqa,7GRhBDsirIGkRZBtSMEzNTyDr2JQm4xx,16,19,9,8,6,28,17,2,89,12.714285714285714,1,0.0,3,9,6,6,16,28,2,17,2,24,65,0
3800,60531,Vdzl3X3O6ZP4Npa6oBdNxCc6U3L9nvWo,7GRhBDsirIGkRZBtSMEzNTyDr2JQm4xx,34,61,21,35,15,4,4,0,140,20.0,1,0.0,37,21,31,15,24,4,4,4,0,104,36,0
3801,61039,RzKvPu4qwYnkKioYxIJem5I7hV4q5Zey,7GRhBDsirIGkRZBtSMEzNTyDr2JQm4xx,2,0,0,0,0,0,2,0,2,0.2857142857142857,1,0.0,0,0,0,0,0,0,0,2,0,0,2,0
3802,61087,GDHvw72iSHIz6VwsSteleP4praXBxk8h,7GRhBDsirIGkRZBtSMEzNTyDr2JQm4xx,29,34,0,24,6,25,12,5,106,15.142857142857142,3,0.0,18,0,20,6,16,25,4,12,5,44,62,1
3803,61604,X8nI71wgjvVnziT2GohIRTnyUeumIuGT,SpATywNh6bZuzm8s1ceuBUnMUAeoAHHw,17,21,12,18,6,38,14,2,111,15.857142857142858,4,0.0,2,12,15,6,19,38,3,14,2,35,76,0
3804,61609,0RRA0LeDh4nSJ7FMl9qY1fE7T0M4oANR,SpATywNh6bZuzm8s1ceuBUnMUAeoAHHw,13,17,2,13,0,2,7,1,42,6.0,1,0.0,6,2,13,0,11,2,0,7,1,21,21,0
3805,61634,PyaXrfJadEJJdtWYxd1SSz75aPVyhQhH,SpATywNh6bZuzm8s1ceuBUnMUAeoAHHw,24,38,0,34,0,17,17,4,110,15.714285714285714,3,0.0,17,0,30,0,21,17,4,17,4,47,63,0
3806,61638,lLutp8H3vKf6Z8olMEwVlKswK040AY6M,7GRhBDsirIGkRZBtSMEzNTyDr2JQm4xx,39,111,43,85,28,3,15,1,286,40.857142857142854,5,0.0,54,43,75,28,57,3,10,15,1,200,86,1
3807,61654,LYqZV37zE6nJxDsCo1hT04A5qKWsawBT,SpATywNh6bZuzm8s1ceuBUnMUAeoAHHw,17,30,16,17,6,13,35,1,118,16.857142857142858,4,0.0,5,16,14,6,25,13,3,35,1,41,77,0
3808,61703,1Ccev0ap5uQQlfggUCTp94lkg9qZetYO,SpATywNh6bZuzm8s1ceuBUnMUAeoAHHw,7,2,0,0,0,1,4,1,8,1.1428571428571428,1,0.0,0,0,0,0,2,1,0,4,1,0,8,1
3809,61713,MYsCU1zkMrWxPhV1b7wSL5LZIo1zGyhU,bWdj2GDclj5ofokWjzoa5jAwMkxCykd6,14,21,11,0,6,0,5,0,43,6.142857142857143,4,0.0,4,11,0,6,17,0,0,5,0,21,22,0
3810,61732,NcracMTfiaTPMbO6SSDnt9CDc4SnvBs9,SpATywNh6bZuzm8s1ceuBUnMUAeoAHHw,31,25,15,18,7,44,9,0,118,16.857142857142858,2,0.0,5,15,17,7,20,44,1,9,0,44,74,0
3811,61740,I9yi1jZjIznCPzP5fpMJEhPDMiUaetUu,SpATywNh6bZuzm8s1ceuBUnMUAeoAHHw,17,43,21,20,6,30,10,3,133,19.0,3,0.0,12,21,17,6,31,30,3,10,3,56,77,0
3812,61744,l30g3WB045lPyRkHzrw7l9v0SYLqOMWO,SpATywNh6bZuzm8s1ceuBUnMUAeoAHHw,17,39,14,28,3,7,10,2,103,14.714285714285714,4,0.0,12,14,23,3,27,7,5,10,2,52,51,0
3813,61759,fx9PEMItfmJUgx5YPFOnYPw9ZcUduuYm,SpATywNh6bZuzm8s1ceuBUnMUAeoAHHw,15,38,4,12,1,1,16,1,73,10.428571428571429,2,0.0,6,4,11,1,32,1,1,16,1,22,51,1
3814,61801,2we3WxltFBT1dd0FjP3YZ8iHf2xpHEei,SpATywNh6bZuzm8s1ceuBUnMUAeoAHHw,15,17,8,6,4,0,5,0,40,5.714285714285714,3,0.0,2,8,6,4,15,0,0,5,0,20,20,1
3815,61837,2yFrrfFKwmpyH7xPcC8i0UYFZJHtjntf,SpATywNh6bZuzm8s1ceuBUnMUAeoAHHw,18,38,20,22,8,45,20,2,155,22.142857142857142,6,0.0,7,20,18,8,31,45,4,20,2,53,102,0
3816,61890,bY3M6NxBAZjGeFa96h2br6AbSx8krpDK,SpATywNh6bZuzm8s1ceuBUnMUAeoAHHw,14,16,9,19,7,7,4,0,62,8.857142857142858,2,0.0,3,9,15,7,13,7,4,4,0,34,28,0
3817,61910,TNArortVQm3F09odJ2W3xdM27lVc5PiX,SpATywNh6bZuzm8s1ceuBUnMUAeoAHHw,2,0,0,0,0,0,3,0,3,0.42857142857142855,1,0.0,0,0,0,0,0,0,0,3,0,0,3,0
3818,61916,XDPvGyFLLEYwbNEQik2MM4yiADs5rrYJ,A3fsA9Zfv1X2fVEQhTw51lKENdNrEqT3,1,0,0,0,0,0,1,0,1,0.14285714285714285,1,0.0,0,0,0,0,0,0,0,1,0,0,1,0
3819,61934,8dPQDWD7NMlHSztQh4Fh3dqPVx6xptft,SpATywNh6bZuzm8s1ceuBUnMUAeoAHHw,30,56,24,26,11,2,17,1,137,19.571428571428573,6,0.0,7,24,20,11,49,2,6,17,1,62,75,0
3820,61948,MHUd30s3WtRLChM8IirlGkLsv26fGFJh,bWdj2GDclj5ofokWjzoa5jAwMkxCykd6,14,26,15,36,6,20,12,2,117,16.714285714285715,3,0.0,3,15,34,6,23,20,2,12,2,58,59,1
3821,61951,01vp16vMBdfdzNflK84lEgGXfBDKyb7S,SpATywNh6bZuzm8s1ceuBUnMUAeoAHHw,8,6,3,0,3,0,5,0,17,2.4285714285714284,1,0.0,2,3,0,3,4,0,0,5,0,8,9,1
3822,61959,0qbWIMzrwjcZydLWs8mxTmhu7QXiYFSP,7GRhBDsirIGkRZBtSMEzNTyDr2JQm4xx,11,8,5,0,6,0,3,0,22,3.142857142857143,1,0.0,2,5,0,6,6,0,0,3,0,13,9,1
3823,61968,oNcOLZOgRKuqVCWgf9VQFQ2ph82THXaV,7GRhBDsirIGkRZBtSMEzNTyDr2JQm4xx,17,58,22,0,13,0,7,0,100,14.285714285714286,3,0.0,4,22,0,13,54,0,0,7,0,39,61,1
3824,61970,rw1CeO1TCa8fgCdp1zXNf3dRKMz7g6nk,SpATywNh6bZuzm8s1ceuBUnMUAeoAHHw,5,5,3,0,1,0,2,0,11,1.5714285714285714,1,0.0,0,3,0,1,5,0,0,2,0,4,7,1
3825,61977,XupxNoKQxp2aAQkFy5RiZK4Yl6Wd1tRi,SpATywNh6bZuzm8s1ceuBUnMUAeoAHHw,18,27,2,18,1,25,20,3,96,13.714285714285714,5,0.0,5,2,15,1,22,25,3,20,3,23,73,0
3826,61994,pvjfd8HSIoVZ71m9TCBbQlraohrUi2x6,SpATywNh6bZuzm8s1ceuBUnMUAeoAHHw,14,14,1,17,0,0,2,0,34,4.857142857142857,1,0.0,1,1,14,0,13,0,3,2,0,16,18,0
3827,62001,9RakuKxD8WS6oi5xvzWI4nJK3Tjlrymz,7GRhBDsirIGkRZBtSMEzNTyDr2JQm4xx,5,2,1,0,1,0,2,0,6,0.8571428571428571,1,0.0,0,1,0,1,2,0,0,2,0,2,4,1
3828,62005,63waYBGRyitKxyJxVKV8NWeJFWacnPQr,7GRhBDsirIGkRZBtSMEzNTyDr2JQm4xx,8,5,4,0,4,0,1,0,14,2.0,1,0.0,0,4,0,4,5,0,0,1,0,8,6,1
3829,62032,xMkkyPamBlQnoa7jeVZTYr4avomD93Rr,7GRhBDsirIGkRZBtSMEzNTyDr2JQm4xx,2,0,0,0,0,0,3,0,3,0.42857142857142855,1,0.0,0,0,0,0,0,0,0,3,0,0,3,1
3830,62051,xFkd6TNWJ8qmIM4trYH57onQcjo5lnU0,SpATywNh6bZuzm8s1ceuBUnMUAeoAHHw,18,44,13,18,5,0,12,0,92,13.142857142857142,6,0.0,7,13,17,5,37,0,1,12,0,42,50,0
3831,62072,VWEcCKiwp28lQZuBYYNslDL0523gk0Z6,SpATywNh6bZuzm8s1ceuBUnMUAeoAHHw,17,20,7,23,4,1,7,2,64,9.142857142857142,1,0.0,9,7,18,4,11,1,5,7,2,38,26,0
3832,62091,6AOZlfpjI3ayLpXvguaWVv2FqhQMzw4M,SpATywNh6bZuzm8s1ceuBUnMUAeoAHHw,16,23,9,20,0,0,8,0,60,8.571428571428571,6,0.0,6,9,19,0,17,0,1,8,0,34,26,0
3833,62133,CsUkH6E2FiorKRYwpRBQQof16ywBIfF7,SpATywNh6bZuzm8s1ceuBUnMUAeoAHHw,28,53,18,40,7,1,12,1,132,18.857142857142858,3,0.0,21,18,36,7,32,1,4,12,1,82,50,0
3834,62146,y8Q2VwfVlqk1j3XET9GUUSulEAonzlDI,7GRhBDsirIGkRZBtSMEzNTyDr2JQm4xx,4,0,0,0,0,0,5,1,6,0.8571428571428571,1,0.0,0,0,0,0,0,0,0,5,1,0,6,1
3835,62156,W2whDchxLBc7jpJ4UAVUryN7DSrj5pnr,SpATywNh6bZuzm8s1ceuBUnMUAeoAHHw,6,2,0,0,0,10,22,2,36,5.142857142857143,1,0.0,0,0,0,0,2,10,0,22,2,0,36,0
3836,62160,Mm7Iv2bcZu7V7eMb3kbuiZ6iWSUOq5iS,7GRhBDsirIGkRZBtSMEzNTyDr2JQm4xx,7,6,2,0,1,0,3,0,12,1.7142857142857142,2,0.0,0,2,0,1,6,0,0,3,0,3,9,1
3837,62161,We0slB08viHgFv6ByLfwdtuQZUg6JG7L,SpATywNh6bZuzm8s1ceuBUnMUAeoAHHw,2,0,0,0,0,0,2,0,2,0.2857142857142857,1,0.0,0,0,0,0,0,0,0,2,0,0,2,1
3838,62186,W0MWfR8rCQKyPPfo34tiE6MzA7EX1V3m,7GRhBDsirIGkRZBtSMEzNTyDr2JQm4xx,1,0,0,0,0,0,1,0,1,0.14285714285714285,1,0.0,0,0,0,0,0,0,0,1,0,0,1,1
3839,62208,mPSPvu82Gr17tV9GJ95bDC7exvsVnwDE,7GRhBDsirIGkRZBtSMEzNTyDr2JQm4xx,26,39,13,57,11,3,1,0,124,17.714285714285715,1,0.0,22,13,50,11,17,3,7,1,0,96,28,1
3840,62235,2cdJoONM7ugDmkPkQHwnxWZwEOIANTXn,SpATywNh6bZuzm8s1ceuBUnMUAeoAHHw,25,50,25,9,8,62,15,1,170,24.285714285714285,4,0.0,0,25,9,8,50,62,0,15,1,42,128,0
3841,62251,76Kz8DEQMUa3r549crPtcn99eC1czeI6,7GRhBDsirIGkRZBtSMEzNTyDr2JQm4xx,1,0,0,0,0,0,1,0,1,0.14285714285714285,1,0.0,0,0,0,0,0,0,0,1,0,0,1,1
3842,62290,FAyKTlOaLRLHiyLG5PXQhYddpdx56j0F,SpATywNh6bZuzm8s1ceuBUnMUAeoAHHw,18,35,14,19,9,6,10,1,94,13.428571428571429,2,0.0,13,14,16,9,22,6,3,10,1,52,42,0
3843,62305,jFuORSL1URM2oqg9zp9eOfHmKoYyUgBh,SpATywNh6bZuzm8s1ceuBUnMUAeoAHHw,13,27,1,16,0,1,9,1,55,7.857142857142857,2,0.0,13,1,14,0,14,1,2,9,1,28,27,1
3844,62321,4aUZNrEysB01BTDaMjEoJUWN7ca7RotB,SpATywNh6bZuzm8s1ceuBUnMUAeoAHHw,7,3,2,0,2,0,3,0,10,1.4285714285714286,1,0.0,0,2,0,2,3,0,0,3,0,4,6,1
3845,62331,FMwKUA8u0BzLarxpeAgKTtl6QSWIGKl8,SpATywNh6bZuzm8s1ceuBUnMUAeoAHHw,1,0,0,0,0,0,1,0,1,0.14285714285714285,1,0.0,0,0,0,0,0,0,0,1,0,0,1,0
3846,62371,sdgY41MIb6WYbIgC75Nfq2olF7e670eU,7GRhBDsirIGkRZBtSMEzNTyDr2JQm4xx,6,3,1,0,1,0,2,0,7,1.0,1,0.0,0,1,0,1,3,0,0,2,0,2,5,1
3847,62376,CqhdzHIILIe1pnO5H5MX1yWHcBaohaEB,7GRhBDsirIGkRZBtSMEzNTyDr2JQm4xx,8,2,2,0,2,0,3,0,9,1.2857142857142858,1,0.0,0,2,0,2,2,0,0,3,0,4,5,1
3848,62383,hIFgL0n5x61JjabCFOIHZgZxMVGzmHNh,SpATywNh6bZuzm8s1ceuBUnMUAeoAHHw,14,16,11,6,8,0,5,0,46,6.571428571428571,3,0.0,2,11,6,8,14,0,0,5,0,27,19,0
3849,62392,FLIojen7fff3GhtDNtEDgYWfLgv0g8w4,A3fsA9Zfv1X2fVEQhTw51lKENdNrEqT3,11,5,1,0,0,1,7,1,15,2.142857142857143,1,0.0,0,1,0,0,5,1,0,7,1,1,14,1
3850,62427,7FBwqoodmzhvrGGLuwBjRrxsykocUv8u,7GRhBDsirIGkRZBtSMEzNTyDr2JQm4xx,17,13,10,0,7,0,2,0,32,4.571428571428571,1,0.0,2,10,0,7,11,0,0,2,0,19,13,1
3851,62466,ggEr2STKTwtSSUdtGCmiPr3DBu3TJ34B,SpATywNh6bZuzm8s1ceuBUnMUAeoAHHw,14,13,5,12,0,0,2,0,32,4.571428571428571,2,0.0,4,5,12,0,9,0,0,2,0,21,11,1
3852,62481,ggEr2STKTwtSSUdtGCmiPr3DBu3TJ34B,7GRhBDsirIGkRZBtSMEzNTyDr2JQm4xx,1,0,0,0,0,0,1,0,1,0.14285714285714285,1,0.0,0,0,0,0,0,0,0,1,0,0,1,1
3853,62516,l7f4vHvlZkxCYoU9qM63V45bmndBSeZQ,A3fsA9Zfv1X2fVEQhTw51lKENdNrEqT3,11,5,1,30,0,0,2,0,38,5.428571428571429,1,0.0,0,1,28,0,5,0,2,2,0,29,9,1
3854,62533,UOssUZDJcaoIiaAH8nTbzjrXIWUHSQSA,7GRhBDsirIGkRZBtSMEzNTyDr2JQm4xx,3,2,1,0,0,0,1,0,4,0.5714285714285714,1,0.0,0,1,0,0,2,0,0,1,0,1,3,1
3855,62549,u82lBhpDxJIwlZISEntCxj1zgVFdW0vT,bWdj2GDclj5ofokWjzoa5jAwMkxCykd6,1,0,0,0,0,0,1,0,1,0.14285714285714285,1,0.0,0,0,0,0,0,0,0,1,0,0,1,1
3856,62554,bYD2u7vuN3G54awyDYPdRiZI3O4zw6kx,SpATywNh6bZuzm8s1ceuBUnMUAeoAHHw,15,14,7,12,3,4,4,0,44,6.285714285714286,2,0.0,4,7,12,3,10,4,0,4,0,26,18,0
3857,62571,E96VmAw6m1AOHRckdqiq2ASKbnHBlpAb,SpATywNh6bZuzm8s1ceuBUnMUAeoAHHw,5,4,2,0,1,0,2,0,9,1.2857142857142858,2,0.0,0,2,0,1,4,0,0,2,0,3,6,0
3858,62622,uU71zmfnwmq5Imjxap728hWGDmNRuuCF,SpATywNh6bZuzm8s1ceuBUnMUAeoAHHw,14,12,10,19,8,1,5,1,56,8.0,1,0.0,2,10,16,8,10,1,3,5,1,36,20,1
3859,62633,zlsPhArkUaQ0CCdgZTO1797WJjiciHBk,SpATywNh6bZuzm8s1ceuBUnMUAeoAHHw,6,2,1,0,1,0,4,1,9,1.2857142857142858,1,0.0,0,1,0,1,2,0,0,4,1,2,7,0
3860,62637,7PJjcgOQXwj0M6oz8Sxyd66Tvypm0TFY,SpATywNh6bZuzm8s1ceuBUnMUAeoAHHw,15,25,17,3,9,6,7,3,70,10.0,3,0.0,3,17,3,9,22,6,0,7,3,32,38,0
3861,62669,PMp3RxnsqELMI5BiCmteZ8iF2l5wlW7H,7GRhBDsirIGkRZBtSMEzNTyDr2JQm4xx,1,0,0,0,0,0,1,0,1,0.14285714285714285,1,0.0,0,0,0,0,0,0,0,1,0,0,1,1
3862,62685,xhufFs72rOwOGZDYtQtHTXdheNyqrUTX,SpATywNh6bZuzm8s1ceuBUnMUAeoAHHw,29,27,17,30,8,2,16,1,101,14.428571428571429,3,0.0,7,17,27,8,20,2,3,16,1,59,42,0
3863,62686,DpXkrIHIAIPNESKyvFah0WhpVT5PHFeL,bWdj2GDclj5ofokWjzoa5jAwMkxCykd6,10,28,16,16,0,3,7,0,70,10.0,2,0.0,3,16,16,0,25,3,0,7,0,35,35,1
3864,62739,CaM5OJ40UpPm5AoorpoNghXDZnct2Zfn,SpATywNh6bZuzm8s1ceuBUnMUAeoAHHw,13,19,1,18,0,15,7,1,61,8.714285714285714,2,0.0,5,1,15,0,14,15,3,7,1,21,40,1
3865,62752,GKJr5PPNFb6sbmwmK3Q19sOuk5TaY1oJ,SpATywNh6bZuzm8s1ceuBUnMUAeoAHHw,10,11,2,7,0,0,3,0,23,3.2857142857142856,3,0.0,1,2,6,0,10,0,1,3,0,9,14,1
3866,62764,XsK920toyXvpWwNS6lvZzDVJcrgCTFKd,SpATywNh6bZuzm8s1ceuBUnMUAeoAHHw,27,35,16,28,10,4,5,0,98,14.0,3,0.0,13,16,26,10,22,4,2,5,0,65,33,0
3867,62795,hf0GNWS6vfpKVHFBCaEpR8vnVjTeyl46,7GRhBDsirIGkRZBtSMEzNTyDr2JQm4xx,1,0,0,0,0,0,1,0,1,0.14285714285714285,1,0.0,0,0,0,0,0,0,0,1,0,0,1,1
3868,62809,EEgHvStGR7XKoMKoPOCBxkxFHcb7UdMh,SpATywNh6bZuzm8s1ceuBUnMUAeoAHHw,6,15,8,0,1,0,6,0,30,4.285714285714286,4,0.0,0,8,0,1,15,0,0,6,0,9,21,0
3869,62819,zn2X74vvqUQRINz90WjZLsSsFglpYr7o,SpATywNh6bZuzm8s1ceuBUnMUAeoAHHw,2,0,0,0,0,0,2,0,2,0.2857142857142857,1,0.0,0,0,0,0,0,0,0,2,0,0,2,1
3870,62837,k4ieA0VLPLUG1GV8FhtBGpWAykZRhHXI,7GRhBDsirIGkRZBtSMEzNTyDr2JQm4xx,32,53,17,57,11,1,8,1,148,21.142857142857142,5,0.0,30,17,53,11,23,1,4,8,1,111,37,1
3871,62856,SMph1YQCIZlmphiUl0TLsRAe6lO4LFpT,7GRhBDsirIGkRZBtSMEzNTyDr2JQm4xx,1,0,0,0,0,0,1,0,1,0.14285714285714285,1,0.0,0,0,0,0,0,0,0,1,0,0,1,1
3872,62864,3LVlNsK7BHroChDOSCZ8wTJul8hRnncw,7GRhBDsirIGkRZBtSMEzNTyDr2JQm4xx,8,18,5,6,2,0,3,0,34,4.857142857142857,1,0.0,11,5,4,2,7,0,2,3,0,22,12,1
3873,62891,lo9vHqgfDG1UEcho8eZgahljlKaQ2l9G,7GRhBDsirIGkRZBtSMEzNTyDr2JQm4xx,1,0,0,0,0,0,1,0,1,0.14285714285714285,1,0.0,0,0,0,0,0,0,0,1,0,0,1,1
3874,62903,6WyBLtTebYxWs237cTFazhrWvguV9PiM,7GRhBDsirIGkRZBtSMEzNTyDr2JQm4xx,12,33,0,16,6,0,3,0,58,8.285714285714286,2,0.0,18,0,14,6,15,0,2,3,0,38,20,1
3875,62911,KwjYZWNYzBofNYG8mRoeOhYNpisNnTvM,SpATywNh6bZuzm8s1ceuBUnMUAeoAHHw,6,3,2,0,2,0,1,0,8,1.1428571428571428,1,0.0,0,2,0,2,3,0,0,1,0,4,4,1
3876,62913,VnWhM3BeDRhDK8eiBuMGZHGyfJnGv0sM,SpATywNh6bZuzm8s1ceuBUnMUAeoAHHw,14,24,1,22,0,1,9,2,59,8.428571428571429,1,0.0,4,1,21,0,20,1,1,9,2,26,33,1
3877,62945,psUY0jMEvxZuoP9UKA82E9maLgW6I63x,SpATywNh6bZuzm8s1ceuBUnMUAeoAHHw,15,21,2,14,2,1,10,0,50,7.142857142857143,1,0.0,5,2,13,2,16,1,1,10,0,22,28,0
3878,62948,XjHYgZsrS0l8TkcDRDNv64IhD09kdX0g,7GRhBDsirIGkRZBtSMEzNTyDr2JQm4xx,4,2,1,0,1,0,1,0,5,0.7142857142857143,1,0.0,0,1,0,1,2,0,0,1,0,2,3,1
3879,62957,iugl3Rn3u1ci3BiC2tfekDHOQsD5QVGj,bWdj2GDclj5ofokWjzoa5jAwMkxCykd6,27,76,33,105,13,3,25,3,258,36.857142857142854,4,0.0,18,33,93,13,58,3,12,25,3,157,101,0
3880,62975,fV0W6675p3fpyY1tGNGM2NdIFpKgGWLW,SpATywNh6bZuzm8s1ceuBUnMUAeoAHHw,22,35,13,16,3,27,6,0,100,14.285714285714286,4,0.0,14,13,14,3,21,27,2,6,0,44,56,0
3881,62999,JFnonbrySwtMlSqTfY5pp3MQd3sPiIYz,bWdj2GDclj5ofokWjzoa5jAwMkxCykd6,6,6,3,0,1,0,7,0,17,2.4285714285714284,1,0.0,0,3,0,1,6,0,0,7,0,4,13,0
3882,63022,aGKf0W7DbO5pZNcjJ5sGrg9jyzAmLXkB,SpATywNh6bZuzm8s1ceuBUnMUAeoAHHw,7,12,7,0,5,0,4,0,28,4.0,1,0.0,0,7,0,5,12,0,0,4,0,12,16,0
3883,63048,OO2Ag6HEFKkZRtZuzzt1ya8SiL4BLCOC,bWdj2GDclj5ofokWjzoa5jAwMkxCykd6,11,24,9,0,6,1,13,1,54,7.714285714285714,2,0.0,6,9,0,6,18,1,0,13,1,21,33,0
3884,63053,2gXHY5qLgY96Nt3kImmboPawcy43EQXt,7GRhBDsirIGkRZBtSMEzNTyDr2JQm4xx,11,22,11,6,7,0,4,0,50,7.142857142857143,4,0.0,1,11,5,7,21,0,1,4,0,24,26,0
3885,63099,WYoMb9pjSPIkNMKnbh6vDtB0LRCn2aRR,bWdj2GDclj5ofokWjzoa5jAwMkxCykd6,9,4,3,0,3,0,3,0,13,1.8571428571428572,2,0.0,0,3,0,3,4,0,0,3,0,6,7,1
3886,63108,rtYqtRTnqUXb6diSp0MKjdA0eLt2BJ3X,7GRhBDsirIGkRZBtSMEzNTyDr2JQm4xx,25,23,12,18,6,0,5,0,64,9.142857142857142,2,0.0,8,12,17,6,15,0,1,5,0,43,21,1
3887,63116,BvCRPlMfMau2kDEBEjyV1l6RJMQy5B5l,SpATywNh6bZuzm8s1ceuBUnMUAeoAHHw,14,25,6,11,0,3,12,1,58,8.285714285714286,1,0.0,8,6,10,0,17,3,1,12,1,24,34,0
3888,63119,HVSG66Eu1vmbossvKhmdJDOdo5jOHC1z,7GRhBDsirIGkRZBtSMEzNTyDr2JQm4xx,1,0,0,0,0,0,1,0,1,0.14285714285714285,1,0.0,0,0,0,0,0,0,0,1,0,0,1,1
3889,63126,8nlNDsWSaxHCvsMKtqhBs81sknEiTCeb,bWdj2GDclj5ofokWjzoa5jAwMkxCykd6,20,28,16,12,7,5,11,0,79,11.285714285714286,7,0.0,3,16,9,7,25,5,3,11,0,35,44,0
3890,63128,5uO2cAopKsWa3VCKCGDarnhTzdurYycs,SpATywNh6bZuzm8s1ceuBUnMUAeoAHHw,24,22,13,25,8,0,3,0,71,10.142857142857142,2,0.0,5,13,22,8,17,0,3,3,0,48,23,0
3891,63131,6soSIDwrJrHtOwhrrHwhMkHLJvUycuiD,SpATywNh6bZuzm8s1ceuBUnMUAeoAHHw,11,9,2,7,1,0,6,0,25,3.5714285714285716,3,0.0,0,2,6,1,9,0,1,6,0,9,16,1
3892,63143,oE1QbspE1VaPia0G9CbmnflG7dN6cZJM,bWdj2GDclj5ofokWjzoa5jAwMkxCykd6,1,0,0,0,0,0,1,0,1,0.14285714285714285,1,0.0,0,0,0,0,0,0,0,1,0,0,1,1
3893,63144,Uf8FY0gZoVytp6K7SsDRXVZeOCL2hDEX,A3fsA9Zfv1X2fVEQhTw51lKENdNrEqT3,17,8,7,0,7,2,2,0,26,3.7142857142857144,1,0.0,0,7,0,7,8,2,0,2,0,14,12,1
3894,63198,JUAvN6CchqwicZ9lfSkTbwue3bPu0qhC,7GRhBDsirIGkRZBtSMEzNTyDr2JQm4xx,28,76,37,6,36,1,8,2,166,23.714285714285715,2,0.0,25,37,6,36,51,1,0,8,2,104,62,0
3895,63233,MvNnLQma2eBM9bCcMIR159XYSNp8VREs,A3fsA9Zfv1X2fVEQhTw51lKENdNrEqT3,1,0,0,0,0,0,3,0,3,0.42857142857142855,1,0.0,0,0,0,0,0,0,0,3,0,0,3,0
3896,63255,7u0QfTKQg4itZK9m8foLXkIGwUxxHMsT,7GRhBDsirIGkRZBtSMEzNTyDr2JQm4xx,40,49,18,32,18,1,7,0,125,17.857142857142858,4,0.0,27,18,32,18,22,1,0,7,0,95,30,0
3897,63257,A1X8BnmDZU7GoDnOEZBjlNXiBeexxBQy,7GRhBDsirIGkRZBtSMEzNTyDr2JQm4xx,1,0,0,0,0,0,1,0,1,0.14285714285714285,1,0.0,0,0,0,0,0,0,0,1,0,0,1,1
3898,63296,qMFAmPw34z5IViYTtA1Kkpcn2uEg1WBM,7GRhBDsirIGkRZBtSMEzNTyDr2JQm4xx,1,0,0,0,0,0,2,0,2,0.2857142857142857,2,0.0,0,0,0,0,0,0,0,2,0,0,2,1
3899,63344,pxvZPop6eUfNSRIk3XGIXLwhqmGee9n7,A3fsA9Zfv1X2fVEQhTw51lKENdNrEqT3,6,2,1,0,1,0,8,3,15,2.142857142857143,1,0.0,0,1,0,1,2,0,0,8,3,2,13,1
3900,63346,fOHPhMpeg8x93fPCuBnyT2XMX6wTKqV5,7GRhBDsirIGkRZBtSMEzNTyDr2JQm4xx,4,4,1,0,0,0,3,0,8,1.1428571428571428,1,0.0,0,1,0,0,4,0,0,3,0,1,7,1
3901,63384,oT95jnCrOomgCStV09kTjQxruOcKiBza,7GRhBDsirIGkRZBtSMEzNTyDr2JQm4xx,1,0,0,0,0,0,2,0,2,0.2857142857142857,2,0.0,0,0,0,0,0,0,0,2,0,0,2,1
3902,63415,BkWsoOcHNs2015z3Qrz6HVGKHPIIV4xg,7GRhBDsirIGkRZBtSMEzNTyDr2JQm4xx,1,0,0,0,0,0,1,0,1,0.14285714285714285,1,0.0,0,0,0,0,0,0,0,1,0,0,1,1
3903,63441,zga7Ud0Vk6NOYChIx78X5xKIKbxIADsx,7GRhBDsirIGkRZBtSMEzNTyDr2JQm4xx,2,0,0,0,0,0,2,0,2,0.2857142857142857,1,0.0,0,0,0,0,0,0,0,2,0,0,2,1
3904,63493,NRZzsjM7f5dJSFvndgYyTX54NocUI1PS,7GRhBDsirIGkRZBtSMEzNTyDr2JQm4xx,31,58,19,36,11,15,6,0,145,20.714285714285715,3,0.0,35,19,28,11,23,15,8,6,0,93,52,1
3905,63498,5P9Jg9PB0Bpdf0i8vhVF4X9FZYYuI2qy,7GRhBDsirIGkRZBtSMEzNTyDr2JQm4xx,8,4,4,0,3,0,5,0,16,2.2857142857142856,1,0.0,0,4,0,3,4,0,0,5,0,7,9,1
3906,63504,Bf025FfgNrlcqN8gYGnmBAhjBy0v5Xmo,7GRhBDsirIGkRZBtSMEzNTyDr2JQm4xx,7,8,4,0,2,0,1,0,15,2.142857142857143,1,0.0,0,4,0,2,8,0,0,1,0,6,9,1
3907,63534,XNb7KU6KeHuNJzclGX2ePynnmu8yxV3v,7GRhBDsirIGkRZBtSMEzNTyDr2JQm4xx,1,0,0,0,0,0,1,0,1,0.14285714285714285,1,0.0,0,0,0,0,0,0,0,1,0,0,1,1
3908,63571,EwaALzeaojV7pPZOsHFx7jzB7xjVDGvQ,A3fsA9Zfv1X2fVEQhTw51lKENdNrEqT3,35,22,1,54,1,0,4,0,82,11.714285714285714,2,0.0,1,1,48,1,21,0,6,4,0,51,31,1
3909,63577,WofGn4IWpKZgx8XqCdK2PR8vwgQ2CXSv,7GRhBDsirIGkRZBtSMEzNTyDr2JQm4xx,4,2,1,0,1,0,1,0,5,0.7142857142857143,1,0.0,0,1,0,1,2,0,0,1,0,2,3,0
3910,63583,CLsYy7g1hYWHJyj1aROfKK9oTeo5yxJx,7GRhBDsirIGkRZBtSMEzNTyDr2JQm4xx,36,38,19,44,15,34,8,0,158,22.571428571428573,2,0.0,14,19,36,15,24,34,8,8,0,84,74,1
3911,63593,KNf8lqR4KQcQVf1nb3UW38BlYtlHOqrY,A3fsA9Zfv1X2fVEQhTw51lKENdNrEqT3,8,6,3,0,2,0,2,1,14,2.0,2,0.0,1,3,0,2,5,0,0,2,1,6,8,0
3912,63644,abujBNmSyI9HYgtoO1EXyLGaW1rUTrMR,7GRhBDsirIGkRZBtSMEzNTyDr2JQm4xx,10,5,1,0,1,1,11,1,20,2.857142857142857,1,0.0,0,1,0,1,5,1,0,11,1,2,18,1
3913,63662,JFaXJp13wvkCeQQDDH7gpaTiCpXvjbvf,7GRhBDsirIGkRZBtSMEzNTyDr2JQm4xx,10,17,4,0,2,0,3,0,26,3.7142857142857144,1,0.0,3,4,0,2,14,0,0,3,0,9,17,1
3914,63710,Ga4lr67F0RIjyUetWH1EgQ3xzSHDnViF,7GRhBDsirIGkRZBtSMEzNTyDr2JQm4xx,13,10,5,13,4,0,3,0,35,5.0,2,0.0,2,5,12,4,8,0,1,3,0,23,12,1
3915,63713,DedOVhQ90meYxq6Misau3AEJ23SFBM8N,A3fsA9Zfv1X2fVEQhTw51lKENdNrEqT3,4,2,1,0,1,0,1,0,5,0.7142857142857143,1,0.0,0,1,0,1,2,0,0,1,0,2,3,1
3916,63719,RPsysYLHG9V8ibC4agPmUkz49odzJ61i,A3fsA9Zfv1X2fVEQhTw51lKENdNrEqT3,58,36,1,142,0,5,18,1,203,29.0,5,0.0,2,1,128,0,34,5,14,18,1,131,72,0
3917,63730,ZxSt3TZtQO3EpuEM7vETaMfS20LEVHky,7GRhBDsirIGkRZBtSMEzNTyDr2JQm4xx,1,0,0,0,0,0,1,0,1,0.14285714285714285,1,0.0,0,0,0,0,0,0,0,1,0,0,1,1
3918,63750,0wm7bVyJC7jfhIoeylaV85sHOH5JOhtj,7GRhBDsirIGkRZBtSMEzNTyDr2JQm4xx,1,0,0,0,0,0,2,0,2,0.2857142857142857,2,0.0,0,0,0,0,0,0,0,2,0,0,2,1
3919,63800,pwyQw70rdHu06KaDwuJu2ks1YZiiVKHU,7GRhBDsirIGkRZBtSMEzNTyDr2JQm4xx,5,2,1,0,1,0,2,0,6,0.8571428571428571,1,0.0,0,1,0,1,2,0,0,2,0,2,4,1
3920,63868,5Dk7QJtqh7ATnN1jDaFE4dN4E1GugvAr,A3fsA9Zfv1X2fVEQhTw51lKENdNrEqT3,12,8,6,0,4,0,2,0,20,2.857142857142857,1,0.0,0,6,0,4,8,0,0,2,0,10,10,1
3921,63914,Yt9n1K8qzV8RLiOcWgNVrYW5xiZerljd,7GRhBDsirIGkRZBtSMEzNTyDr2JQm4xx,41,58,3,62,10,2,12,2,149,21.285714285714285,2,0.0,35,3,55,10,23,2,7,12,2,103,46,1
3922,63933,K9G4dlm9tLRMMK1kov6MCkkTMks8NOCf,7GRhBDsirIGkRZBtSMEzNTyDr2JQm4xx,1,0,0,0,0,0,1,0,1,0.14285714285714285,1,0.0,0,0,0,0,0,0,0,1,0,0,1,1
3923,63934,QXR5sUbv4S12yRWxM4AzFUAlm7Vhd4VU,7GRhBDsirIGkRZBtSMEzNTyDr2JQm4xx,2,0,0,0,0,0,2,0,2,0.2857142857142857,1,0.0,0,0,0,0,0,0,0,2,0,0,2,1
3924,63977,OVG8I98WuYVhtwF4PGQiRQJNGKoIW18s,7GRhBDsirIGkRZBtSMEzNTyDr2JQm4xx,9,5,3,0,3,0,2,0,13,1.8571428571428572,1,0.0,0,3,0,3,5,0,0,2,0,6,7,0
3925,63996,kaNpWuIxNLxZkDfmjMzrYRVzuOgwIf0o,7GRhBDsirIGkRZBtSMEzNTyDr2JQm4xx,1,0,0,0,0,0,1,0,1,0.14285714285714285,1,0.0,0,0,0,0,0,0,0,1,0,0,1,1
3926,64025,VmlXkvuP00sXBlaPmnRadtsHqWz5E4fz,7GRhBDsirIGkRZBtSMEzNTyDr2JQm4xx,71,355,78,144,34,57,33,0,701,100.14285714285714,8,0.0,193,78,113,34,162,57,31,33,0,418,283,0
3927,64036,4dC723f2ZXGHBwWoh8xH8B5ftd5Zr0Rn,A3fsA9Zfv1X2fVEQhTw51lKENdNrEqT3,6,3,0,0,0,0,4,0,7,1.0,2,0.0,0,0,0,0,3,0,0,4,0,0,7,1
3928,64113,EVGpdajso7QxNR24Ui7ldtFyj6uWtpYs,7GRhBDsirIGkRZBtSMEzNTyDr2JQm4xx,31,53,12,65,11,0,4,0,145,20.714285714285715,2,0.0,26,12,58,11,27,0,7,4,0,107,38,1
3929,64116,sQpA2SuskRigo277vTUjZ4C84cF8DuDE,7GRhBDsirIGkRZBtSMEzNTyDr2JQm4xx,18,43,10,22,6,7,11,1,100,14.285714285714286,3,0.0,16,10,18,6,27,7,4,11,1,50,50,0
3930,64124,pseKOpRPBJlgz4ycJmBeuSlXa5DHSZxH,7GRhBDsirIGkRZBtSMEzNTyDr2JQm4xx,4,2,1,0,1,5,1,0,10,1.4285714285714286,1,0.0,0,1,0,1,2,5,0,1,0,2,8,1
3931,64139,oKHRSMo3yDALM11wXRuypZuoIWmshJLG,7GRhBDsirIGkRZBtSMEzNTyDr2JQm4xx,2,0,0,0,0,0,2,0,2,0.2857142857142857,1,0.0,0,0,0,0,0,0,0,2,0,0,2,1
3932,64142,as5VymGJtrKzsVSyPlhaHLjXcgFKhbSH,A3fsA9Zfv1X2fVEQhTw51lKENdNrEqT3,18,11,8,0,6,6,9,1,41,5.857142857142857,2,0.0,0,8,0,6,11,6,0,9,1,14,27,1
3933,64169,Z5Gd8RjsJSljoHUoBd3hvIVNy4VKuGq0,7GRhBDsirIGkRZBtSMEzNTyDr2JQm4xx,12,29,7,10,0,2,5,0,53,7.571428571428571,3,0.0,7,7,9,0,22,2,1,5,0,23,30,1
3934,64170,XPA1Jv5NXHfUcU7CMUA4EKvCqSxl1bO3,7GRhBDsirIGkRZBtSMEzNTyDr2JQm4xx,4,2,1,0,1,0,1,0,5,0.7142857142857143,1,0.0,0,1,0,1,2,0,0,1,0,2,3,1
3935,65788,aszS4GIQTgIfNXx5jr5Ct6AzWRVtVT5s,7GRhBDsirIGkRZBtSMEzNTyDr2JQm4xx,28,39,12,48,9,0,1,0,109,15.571428571428571,2,0.0,25,12,42,9,14,0,6,1,0,88,21,1
3936,66546,DTbJ7KB3uMFcpk8W3n4kvUeKqSYyolkW,SpATywNh6bZuzm8s1ceuBUnMUAeoAHHw,17,39,6,18,2,1,15,0,81,11.571428571428571,4,0.0,19,6,15,2,20,1,3,15,0,42,39,1
3937,66551,fkrSqTHnPEweVdPiAW6RgeMJZWZWaXQt,G8EPVSXsOYB5YQWZGiz1aVq5Pgr2GrQu,83,68,19,201,13,22,24,2,349,49.857142857142854,4,0.0,46,19,149,13,22,22,52,24,2,227,122,0
3938,66555,fdzq5tofwv4sAm3YqrsC6AMOnGl1oPA0,RXDvfPUBYFlVdlueBFbLW0mhhAyGEqpt,3,0,0,0,0,5,2,0,7,1.0,2,0.0,0,0,0,0,0,5,0,2,0,0,7,1
3939,66558,z6Xzy59qUrOr9kg6qBkR4Bly4uQ6Qoy2,SpATywNh6bZuzm8s1ceuBUnMUAeoAHHw,21,44,17,23,7,11,25,4,131,18.714285714285715,5,0.0,12,17,19,7,32,11,4,25,4,55,76,1
3940,66563,rMO5SCPyMgH89I8wk1aP5Tz4xRCn17BB,SpATywNh6bZuzm8s1ceuBUnMUAeoAHHw,6,5,2,0,2,0,1,0,10,1.4285714285714286,1,0.0,0,2,0,2,5,0,0,1,0,4,6,1
3941,66564,pzsUx69X9Xid85hyecE8y9Ou9VDtnPhb,SpATywNh6bZuzm8s1ceuBUnMUAeoAHHw,1,0,0,0,0,0,1,0,1,0.14285714285714285,1,0.0,0,0,0,0,0,0,0,1,0,0,1,1
3942,66569,2daUzJgefGOj5dfl9u5sPO7QTYuS1O1e,SpATywNh6bZuzm8s1ceuBUnMUAeoAHHw,4,2,1,0,0,0,2,0,5,0.7142857142857143,1,0.0,0,1,0,0,2,0,0,2,0,1,4,1
3943,66570,MpNfjrXai4aLf7BfVSQwZSS0DPolU3oZ,RXDvfPUBYFlVdlueBFbLW0mhhAyGEqpt,51,60,35,69,21,0,12,2,199,28.428571428571427,4,0.0,14,35,66,21,46,0,3,12,2,136,63,0
3944,66571,2jofclRKNdmEGIMZjR1X3xlqQjjV6yF4,SpATywNh6bZuzm8s1ceuBUnMUAeoAHHw,17,32,13,29,5,6,18,1,104,14.857142857142858,3,0.0,9,13,22,5,23,6,7,18,1,49,55,0
3945,66577,s9OHCOR537Yr2UKR6DSCnB7grKBa5GVW,SpATywNh6bZuzm8s1ceuBUnMUAeoAHHw,5,2,1,0,1,0,2,0,6,0.8571428571428571,1,0.0,0,1,0,1,2,0,0,2,0,2,4,1
3946,66579,bDdEUq0MJvGkx68ulN38uXa8x4Oc6Mqn,SpATywNh6bZuzm8s1ceuBUnMUAeoAHHw,17,18,6,20,4,0,9,1,58,8.285714285714286,1,0.0,5,6,16,4,13,0,4,9,1,31,27,1
3947,66581,thNNhxxCA11oJLPqP35etO0M0nOY00HM,G8EPVSXsOYB5YQWZGiz1aVq5Pgr2GrQu,32,59,28,60,18,0,4,0,169,24.142857142857142,2,0.0,27,28,50,18,32,0,10,4,0,123,46,1
3948,66586,F2b4wQkSXPvl6LtgZJlfZ4TcFXgwDGKe,SpATywNh6bZuzm8s1ceuBUnMUAeoAHHw,7,4,3,0,3,0,2,0,12,1.7142857142857142,1,0.0,0,3,0,3,4,0,0,2,0,6,6,1
3949,66592,7mVgrKQULKrxGxLEFeqEhI8vLoHAKVjH,SpATywNh6bZuzm8s1ceuBUnMUAeoAHHw,5,2,1,0,1,0,2,0,6,0.8571428571428571,1,0.0,0,1,0,1,2,0,0,2,0,2,4,1
3950,66594,Jkvg2vrMG0bsI6gC4CJJwz6mYReBwqyD,bWdj2GDclj5ofokWjzoa5jAwMkxCykd6,16,30,15,8,7,0,24,2,86,12.285714285714286,4,0.0,2,15,8,7,28,0,0,24,2,32,54,1
3951,66599,FrnZkjOLuaGZ96dbbyAebpl6VdyOmBDE,RXDvfPUBYFlVdlueBFbLW0mhhAyGEqpt,6,2,1,0,1,0,4,0,8,1.1428571428571428,2,0.0,0,1,0,1,2,0,0,4,0,2,6,1
3952,66603,2zQQnqY1LiZ9lcEXTzcE3zimEdKe8CdV,G8EPVSXsOYB5YQWZGiz1aVq5Pgr2GrQu,28,25,12,62,8,0,5,0,112,16.0,3,0.0,12,12,51,8,13,0,11,5,0,83,29,1
3953,66606,yceNLUK4FCR6SZUYW0W0TAVYCfKl5jP6,SpATywNh6bZuzm8s1ceuBUnMUAeoAHHw,11,11,0,5,0,10,9,1,36,5.142857142857143,1,0.0,0,0,4,0,11,10,1,9,1,4,32,1
3954,66607,nvX3zuXPoMSUhlRzwAoQtF8bA4zlkXZY,G8EPVSXsOYB5YQWZGiz1aVq5Pgr2GrQu,21,40,31,20,2,20,32,3,148,21.142857142857142,3,0.0,0,31,18,2,40,20,2,32,3,51,97,1
3955,66614,RxKdUoY8VjcWLXSrUuB2O5rajs7dKtPo,SpATywNh6bZuzm8s1ceuBUnMUAeoAHHw,9,10,4,0,3,1,4,0,22,3.142857142857143,1,0.0,3,4,0,3,7,1,0,4,0,10,12,1
3956,66620,YSRj2LyghpGgbkTJyCc5CeAD7nnieGEa,SpATywNh6bZuzm8s1ceuBUnMUAeoAHHw,7,9,1,0,1,0,2,0,13,1.8571428571428572,1,0.0,0,1,0,1,9,0,0,2,0,2,11,1
3957,66622,3BM8P16Xlf6mH29LptGI3X2aHEFZEk4O,SpATywNh6bZuzm8s1ceuBUnMUAeoAHHw,11,10,6,0,3,8,12,2,41,5.857142857142857,2,0.0,0,6,0,3,10,8,0,12,2,9,32,1
3958,66625,WSyXGkhm7NDepRlMA3agJj8k8GLnavsP,bWdj2GDclj5ofokWjzoa5jAwMkxCykd6,5,2,1,0,1,0,2,0,6,0.8571428571428571,1,0.0,0,1,0,1,2,0,0,2,0,2,4,1
3959,66633,tuzr7UEFeueCuu7trKtH12YoCRZa4u3J,SpATywNh6bZuzm8s1ceuBUnMUAeoAHHw,17,42,15,11,5,101,19,2,195,27.857142857142858,5,0.0,8,15,9,5,34,101,2,19,2,37,158,1
3960,66642,7i6uHx2i3AcAV22o4Aq16TZJzUL7SbJ8,SpATywNh6bZuzm8s1ceuBUnMUAeoAHHw,18,29,8,19,3,9,13,4,85,12.142857142857142,3,0.0,9,8,16,3,20,9,3,13,4,36,49,0
3961,66643,YpwPSpfFUdYNa3VjazLGMwZAAiqtZEgp,SpATywNh6bZuzm8s1ceuBUnMUAeoAHHw,1,0,0,0,0,0,1,0,1,0.14285714285714285,1,0.0,0,0,0,0,0,0,0,1,0,0,1,1
3962,66648,Z5eVqB1AyrDAwIaFYca0z5tjEfS46LEV,SpATywNh6bZuzm8s1ceuBUnMUAeoAHHw,6,2,1,0,0,0,4,0,7,1.0,1,0.0,0,1,0,0,2,0,0,4,0,1,6,1
3963,66649,Gmz5iMjiwcyTx4KusyWM0rOecmUutZaf,RXDvfPUBYFlVdlueBFbLW0mhhAyGEqpt,47,69,42,66,28,10,10,5,230,32.857142857142854,3,0.0,16,42,65,28,53,10,1,10,5,151,79,0
3964,66661,uPc8X6Bm31kSZXvsGiF4cJMs1CphJwNI,RXDvfPUBYFlVdlueBFbLW0mhhAyGEqpt,7,4,3,0,1,0,2,0,10,1.4285714285714286,1,0.0,0,3,0,1,4,0,0,2,0,4,6,1
3965,66666,4QSKoi2COLIjISXuWMSgkhYU8OcqVVuy,SpATywNh6bZuzm8s1ceuBUnMUAeoAHHw,10,12,4,0,3,0,2,0,21,3.0,1,0.0,4,4,0,3,8,0,0,2,0,11,10,1
3966,66667,emzkGgKaVLaDWCW4bOLMsgyMV9eX3Ume,G8EPVSXsOYB5YQWZGiz1aVq5Pgr2GrQu,29,33,13,62,3,6,11,1,129,18.428571428571427,2,0.0,13,13,44,3,20,6,18,11,1,73,56,0
3967,66668,VKxATUtWUHvLpvjNhrujhWYm5cDOeljR,SpATywNh6bZuzm8s1ceuBUnMUAeoAHHw,3,3,0,0,0,0,1,0,4,0.5714285714285714,2,0.0,0,0,0,0,3,0,0,1,0,0,4,1
3968,66673,jdTzrZz0SYzgENOxdTEUzOnYtapHefGQ,SpATywNh6bZuzm8s1ceuBUnMUAeoAHHw,3,2,0,0,0,0,1,0,3,0.42857142857142855,1,0.0,0,0,0,0,2,0,0,1,0,0,3,1
3969,66686,N1N2VoCQ3DCM7YknWLib5UEHyI2wyiAp,SpATywNh6bZuzm8s1ceuBUnMUAeoAHHw,12,10,3,25,2,0,6,0,46,6.571428571428571,2,0.0,4,3,20,2,6,0,5,6,0,29,17,1
3970,66687,Lb2uKLbwD8GvR2CPQEYJA4oaJUHHccBI,G8EPVSXsOYB5YQWZGiz1aVq5Pgr2GrQu,9,9,0,0,0,0,4,0,13,1.8571428571428572,1,0.0,0,0,0,0,9,0,0,4,0,0,13,1
3971,66692,X2YAK6wLAh05M8slR10ibCM34PqZNEYp,G8EPVSXsOYB5YQWZGiz1aVq5Pgr2GrQu,21,24,2,24,1,1,4,0,56,8.0,2,0.0,1,2,19,1,23,1,5,4,0,23,33,1
3972,66693,Q0GCy8RLg4XnQiHX0oDTDootKu46YmWa,SpATywNh6bZuzm8s1ceuBUnMUAeoAHHw,4,2,0,0,0,0,2,0,4,0.5714285714285714,1,0.0,0,0,0,0,2,0,0,2,0,0,4,1
3973,66694,ZnCJUx9hjBAhb4k6sSnSHXC3G4doeeAn,SpATywNh6bZuzm8s1ceuBUnMUAeoAHHw,12,17,8,0,4,10,6,1,46,6.571428571428571,1,0.0,6,8,0,4,11,10,0,6,1,18,28,1
3974,66699,vYjevNGSZuPL0Me7nQ7eB69nuvnbZiuq,SpATywNh6bZuzm8s1ceuBUnMUAeoAHHw,13,17,0,16,0,0,6,1,40,5.714285714285714,3,0.0,8,0,14,0,9,0,2,6,1,22,18,1
3975,66700,xLfQrz0Mm3ryvcwRcTyZdkwlshtwNJHB,RXDvfPUBYFlVdlueBFbLW0mhhAyGEqpt,5,2,1,0,1,0,2,0,6,0.8571428571428571,1,0.0,0,1,0,1,2,0,0,2,0,2,4,1
3976,66708,bPMM8JJVMbo3dHwzrkYwNanOXVlVjIZM,bWdj2GDclj5ofokWjzoa5jAwMkxCykd6,6,2,1,0,1,0,3,0,7,1.0,1,0.0,0,1,0,1,2,0,0,3,0,2,5,1
3977,66710,fUNdgzfWSE4HzsYQQ7FDu5pyDUIMQ40m,bWdj2GDclj5ofokWjzoa5jAwMkxCykd6,1,0,0,0,0,0,1,0,1,0.14285714285714285,1,0.0,0,0,0,0,0,0,0,1,0,0,1,1
3978,66712,Ksg32KcGSJwlEbdLbDafCAI8P52qq3MX,SpATywNh6bZuzm8s1ceuBUnMUAeoAHHw,5,2,1,0,0,0,3,0,6,0.8571428571428571,1,0.0,0,1,0,0,2,0,0,3,0,1,5,1
3979,66716,m8pWjgRGGqizCnvKfqrgJiRn5L3s4aMf,SpATywNh6bZuzm8s1ceuBUnMUAeoAHHw,10,6,4,0,3,0,4,1,18,2.5714285714285716,1,0.0,1,4,0,3,5,0,0,4,1,8,10,1
3980,66717,PI4R0HcIedaRtD4i4AnoySGCINPF9uFD,SpATywNh6bZuzm8s1ceuBUnMUAeoAHHw,15,16,7,15,3,0,6,0,47,6.714285714285714,2,0.0,4,7,12,3,12,0,3,6,0,26,21,1
3981,66722,dwydM4WZn1EE9lbFO8uBMhGMVscnDmyy,G8EPVSXsOYB5YQWZGiz1aVq5Pgr2GrQu,18,26,15,2,10,18,11,1,83,11.857142857142858,2,0.0,5,15,1,10,21,18,1,11,1,31,52,0
3982,66723,o4fNZaSYX3UHutrkuKOAdzPPx4q40e5R,SpATywNh6bZuzm8s1ceuBUnMUAeoAHHw,17,31,13,6,7,14,8,1,80,11.428571428571429,3,0.0,2,13,6,7,29,14,0,8,1,28,52,1
3983,66724,cWGbfR2Lw2D62YH4zDUtSEtnjy8NlUpm,SpATywNh6bZuzm8s1ceuBUnMUAeoAHHw,27,42,12,27,9,1,14,1,106,15.142857142857142,4,0.0,14,12,22,9,28,1,5,14,1,57,49,1
3984,66727,1F8QRhMnvAcX05zajUIEw9khHJe9qgvr,SpATywNh6bZuzm8s1ceuBUnMUAeoAHHw,2,2,0,0,0,0,2,0,4,0.5714285714285714,1,0.0,0,0,0,0,2,0,0,2,0,0,4,1
3985,66729,YG3IIEQOezPClODg4SNvtFayndWcEJ7a,bWdj2GDclj5ofokWjzoa5jAwMkxCykd6,10,18,7,0,7,1,4,0,37,5.285714285714286,2,0.0,7,7,0,7,11,1,0,4,0,21,16,1
3986,66731,Sz4iN9vM7plSJObu2Kgng7aJijtNNsts,bWdj2GDclj5ofokWjzoa5jAwMkxCykd6,10,11,0,14,3,8,3,0,39,5.571428571428571,1,0.0,5,0,13,3,6,8,1,3,0,21,18,1
3987,66734,NMCQVQ1Cg6MS9ushYbZMMzLoDclKVOyZ,SpATywNh6bZuzm8s1ceuBUnMUAeoAHHw,9,13,5,0,1,2,10,0,31,4.428571428571429,1,0.0,0,5,0,1,13,2,0,10,0,6,25,1
3988,66735,BF8BUQGTWJSC3An0NoOdiFsCvGqN90lp,SpATywNh6bZuzm8s1ceuBUnMUAeoAHHw,10,12,3,0,3,0,2,0,20,2.857142857142857,2,0.0,0,3,0,3,12,0,0,2,0,6,14,1
3989,66739,ggntZRuHqDckUtFC9TYtfF8K09iXYWES,G8EPVSXsOYB5YQWZGiz1aVq5Pgr2GrQu,12,11,2,26,2,2,3,0,46,6.571428571428571,2,0.0,6,2,20,2,5,2,6,3,0,30,16,1
3990,66743,ilB3zN3UyBwxCz4uXPqvzE0bs5QUbmk2,SpATywNh6bZuzm8s1ceuBUnMUAeoAHHw,6,12,0,0,0,0,4,0,16,2.2857142857142856,3,0.0,0,0,0,0,12,0,0,4,0,0,16,1
3991,66746,S5gDAq7XL2B348BbNrSZrsxK2ihjbqjX,bWdj2GDclj5ofokWjzoa5jAwMkxCykd6,4,2,0,0,0,2,10,0,14,2.0,2,0.0,0,0,0,0,2,2,0,10,0,0,14,1
3992,66748,IGtuwcXa7Vvuptxp2yP0y7DMlNgXBbkF,SpATywNh6bZuzm8s1ceuBUnMUAeoAHHw,12,11,5,6,0,12,5,0,39,5.571428571428571,2,0.0,4,5,6,0,7,12,0,5,0,15,24,1
3993,66752,qdU5OfBLhmAdLS2yu5kAr5MPjmjgxaEx,SpATywNh6bZuzm8s1ceuBUnMUAeoAHHw,9,9,4,0,4,0,2,0,19,2.7142857142857144,1,0.0,0,4,0,4,9,0,0,2,0,8,11,1
3994,66759,IFoWLGmc3yYo3jvZy7brYExecFieUsPa,SpATywNh6bZuzm8s1ceuBUnMUAeoAHHw,17,18,7,21,4,3,6,1,60,8.571428571428571,2,0.0,9,7,18,4,9,3,3,6,1,38,22,1
3995,66761,jZW7RSw8d3NHdCMzGR4TAiNXCrcYo90E,SpATywNh6bZuzm8s1ceuBUnMUAeoAHHw,16,13,5,23,3,12,12,1,69,9.857142857142858,1,0.0,7,5,19,3,6,12,4,12,1,34,35,0
3996,66763,3LiDRA4eEhNTPRwhkLOl4Xef83bJtvN6,SpATywNh6bZuzm8s1ceuBUnMUAeoAHHw,16,12,5,14,3,0,7,0,41,5.857142857142857,1,0.0,2,5,13,3,10,0,1,7,0,23,18,1
3997,66767,hphlDgjkqVbyJnFgMbu9WAMmL2wONlSy,SpATywNh6bZuzm8s1ceuBUnMUAeoAHHw,13,20,0,28,2,4,6,1,61,8.714285714285714,1,0.0,14,0,21,2,6,4,7,6,1,37,24,0
3998,66769,j8UeSZFNUzzfzk2DFBytx4Rkr6FApV94,SpATywNh6bZuzm8s1ceuBUnMUAeoAHHw,4,4,3,0,0,0,1,0,8,1.1428571428571428,1,0.0,0,3,0,0,4,0,0,1,0,3,5,1
3999,66771,DSoedfH3iEqkDSoEfnR9hPK9fGA03nvE,SpATywNh6bZuzm8s1ceuBUnMUAeoAHHw,6,3,2,0,2,0,1,0,8,1.1428571428571428,1,0.0,0,2,0,2,3,0,0,1,0,4,4,1
4000,66772,3IQ5vbIjcGZGFJfWLKmxNcLXTnJQLHyr,SpATywNh6bZuzm8s1ceuBUnMUAeoAHHw,17,25,13,16,4,35,17,2,112,16.0,4,0.0,2,13,13,4,23,35,3,17,2,32,80,1
4001,66773,5KXpHHWqAiriAz89DseoECa9CF8nNmNg,G8EPVSXsOYB5YQWZGiz1aVq5Pgr2GrQu,2,0,0,0,0,0,2,0,2,0.2857142857142857,1,0.0,0,0,0,0,0,0,0,2,0,0,2,1
4002,66774,3imocgNxcBfwQHadpMof51TjC5xJp8PT,SpATywNh6bZuzm8s1ceuBUnMUAeoAHHw,9,9,6,0,4,0,8,0,27,3.857142857142857,2,0.0,1,6,0,4,8,0,0,8,0,11,16,1
4003,66777,FQiENNRH2NfeZWMamUs40Z7QmdDjNODH,SpATywNh6bZuzm8s1ceuBUnMUAeoAHHw,5,2,1,0,1,0,2,0,6,0.8571428571428571,1,0.0,0,1,0,1,2,0,0,2,0,2,4,1
4004,66786,qGRPIv5dAFSTdBTLUyG7n07ghfZFrtTR,SpATywNh6bZuzm8s1ceuBUnMUAeoAHHw,17,51,4,16,3,4,22,4,104,14.857142857142858,3,0.0,18,4,14,3,33,4,2,22,4,39,65,1
4005,66787,hphlDgjkqVbyJnFgMbu9WAMmL2wONlSy,G8EPVSXsOYB5YQWZGiz1aVq5Pgr2GrQu,9,10,1,0,0,1,8,0,20,2.857142857142857,1,0.0,3,1,0,0,7,1,0,8,0,4,16,1
4006,66791,YKDsG4vA9NLXfljPnrmnZIZC1s2Q0ugD,SpATywNh6bZuzm8s1ceuBUnMUAeoAHHw,5,2,1,0,1,0,4,0,8,1.1428571428571428,1,0.0,0,1,0,1,2,0,0,4,0,2,6,1
4007,66795,ee4pYUOGDieGavHZlg2HTSjfqraD5k7B,SpATywNh6bZuzm8s1ceuBUnMUAeoAHHw,13,10,0,18,0,0,6,1,35,5.0,1,0.0,5,0,15,0,5,0,3,6,1,20,15,1
4008,66814,x0EQgyUAdVGVXHM8VfLLFzp2FQY3yEsn,SpATywNh6bZuzm8s1ceuBUnMUAeoAHHw,8,6,3,0,3,0,3,0,15,2.142857142857143,1,0.0,2,3,0,3,4,0,0,3,0,8,7,0
4009,66817,to6uzLarCrneiGy62nJuyfDuz8bCYwik,G8EPVSXsOYB5YQWZGiz1aVq5Pgr2GrQu,83,100,35,163,20,9,25,2,354,50.57142857142857,6,0.0,51,35,116,20,49,9,47,25,2,222,132,1
4010,66819,j21aImOKDywGp9C5VIymBW05Q7mvVltH,SpATywNh6bZuzm8s1ceuBUnMUAeoAHHw,4,5,0,0,0,0,1,0,6,0.8571428571428571,1,0.0,0,0,0,0,5,0,0,1,0,0,6,1
4011,66821,JcMvDAHro8DuV6i3JIeUIujj4IscZiT7,G8EPVSXsOYB5YQWZGiz1aVq5Pgr2GrQu,13,10,3,22,0,1,4,0,40,5.714285714285714,1,0.0,7,3,16,0,3,1,6,4,0,26,14,0
4012,66831,grwjhoAI1dEZsOpkE7fbBAVHWaIfQbiU,SpATywNh6bZuzm8s1ceuBUnMUAeoAHHw,4,2,1,0,1,0,2,0,6,0.8571428571428571,1,0.0,0,1,0,1,2,0,0,2,0,2,4,1
4013,66836,GjmAjZkQ0i4VbB9kzslDSKYjTMxi0DJm,SpATywNh6bZuzm8s1ceuBUnMUAeoAHHw,10,14,8,0,6,1,2,0,31,4.428571428571429,1,0.0,3,8,0,6,11,1,0,2,0,17,14,1
4014,66840,jW6xo8o8ggQigxJzuOWpksdLscP0nmMK,RXDvfPUBYFlVdlueBFbLW0mhhAyGEqpt,9,11,9,0,7,0,2,0,29,4.142857142857143,1,0.0,1,9,0,7,10,0,0,2,0,17,12,1
4015,66842,KP9bG9uWRMGfX1tzS44KTvN8Cg66ynpe,SpATywNh6bZuzm8s1ceuBUnMUAeoAHHw,13,12,3,13,2,0,4,0,34,4.857142857142857,3,0.0,3,3,10,2,9,0,3,4,0,18,16,1
4016,66845,spo2AoBcB8z4JnQ75NfCsXxxs58G8kjU,SpATywNh6bZuzm8s1ceuBUnMUAeoAHHw,4,2,1,0,1,0,1,0,5,0.7142857142857143,1,0.0,0,1,0,1,2,0,0,1,0,2,3,0
4017,66849,Q089sE9VtgxkkGKk7SyD8fz5PShaeQQT,SpATywNh6bZuzm8s1ceuBUnMUAeoAHHw,6,2,0,0,0,14,5,3,24,3.4285714285714284,1,0.0,0,0,0,0,2,14,0,5,3,0,24,1
4018,66850,WREte9djoqLkGoMvPHsglYJ5ApOOE4Xa,SpATywNh6bZuzm8s1ceuBUnMUAeoAHHw,5,2,0,0,0,1,4,0,7,1.0,1,0.0,0,0,0,0,2,1,0,4,0,0,7,0
4019,66856,9Bmxb2kRkvmXtKdf1iC2KsdGSl1k4oD2,G8EPVSXsOYB5YQWZGiz1aVq5Pgr2GrQu,3,0,0,0,0,0,7,0,7,1.0,5,0.0,0,0,0,0,0,0,0,7,0,0,7,1
4020,66863,xdClWt95AonMUbXmVncDz7pyQAF4u9BG,RXDvfPUBYFlVdlueBFbLW0mhhAyGEqpt,1,0,0,0,0,0,1,0,1,0.14285714285714285,1,0.0,0,0,0,0,0,0,0,1,0,0,1,1
4021,66867,t2MGYeUu0hRLKtqGYRo6b7Rz4YOZ5CAl,SpATywNh6bZuzm8s1ceuBUnMUAeoAHHw,8,3,1,0,1,1,8,0,14,2.0,2,0.0,0,1,0,1,3,1,0,8,0,2,12,1
4022,66876,lBWHzt16Kw5civcvlfzsyLbIMpskhKLb,SpATywNh6bZuzm8s1ceuBUnMUAeoAHHw,4,2,1,0,0,0,2,0,5,0.7142857142857143,1,0.0,0,1,0,0,2,0,0,2,0,1,4,1
4023,66882,RUyO8vGMdp7jhM6g17yji5ANjGox4I7a,G8EPVSXsOYB5YQWZGiz1aVq5Pgr2GrQu,15,45,18,6,13,1,3,7,93,13.285714285714286,2,0.0,16,18,4,13,29,1,2,3,7,51,42,1
4024,66901,jsqKkuSbErall5JnaWQXJQsGef5XwKOD,SpATywNh6bZuzm8s1ceuBUnMUAeoAHHw,9,13,6,0,1,4,9,1,34,4.857142857142857,2,0.0,0,6,0,1,13,4,0,9,1,7,27,1
4025,66902,SaCuUEx4yVWy7KEZ7c1LumXyYr79w4Rm,bWdj2GDclj5ofokWjzoa5jAwMkxCykd6,7,4,2,0,0,3,5,1,15,2.142857142857143,1,0.0,0,2,0,0,4,3,0,5,1,2,13,1
4026,66906,dEKCxHL9joqZNeQKkyzq4Y5b5GlTbyt0,SpATywNh6bZuzm8s1ceuBUnMUAeoAHHw,1,0,0,0,0,0,1,0,1,0.14285714285714285,1,0.0,0,0,0,0,0,0,0,1,0,0,1,1
4027,66912,i0LHbVo0MUWeo1slrPpQRlCoWzknlhLR,SpATywNh6bZuzm8s1ceuBUnMUAeoAHHw,6,6,1,0,0,0,3,0,10,1.4285714285714286,1,0.0,1,1,0,0,5,0,0,3,0,2,8,1
4028,66913,Pp6wRQkPti9Bk2fBcpI0VrxeT3AtZv4c,SpATywNh6bZuzm8s1ceuBUnMUAeoAHHw,13,42,7,16,3,4,10,0,82,11.714285714285714,3,0.0,7,7,14,3,35,4,2,10,0,31,51,1
4029,66919,4W9VDoom5TgPKJhY4YS0TxVzPBBhVmKe,SpATywNh6bZuzm8s1ceuBUnMUAeoAHHw,5,5,3,2,0,0,1,0,11,1.5714285714285714,1,0.0,1,3,2,0,4,0,0,1,0,6,5,1
4030,66921,HEyWCm29dAxf2gF6HX7SoCKEpp5xOaMH,SpATywNh6bZuzm8s1ceuBUnMUAeoAHHw,8,16,2,0,0,23,11,1,53,7.571428571428571,2,0.0,0,2,0,0,16,23,0,11,1,2,51,1
4031,66936,STtQLJYeEtdkd5hogRcAby24tBZrG3TQ,SpATywNh6bZuzm8s1ceuBUnMUAeoAHHw,1,0,0,0,0,0,1,0,1,0.14285714285714285,1,0.0,0,0,0,0,0,0,0,1,0,0,1,1
4032,66953,hgypFYGQkHCtSzjmFaIf3CToNAXniUea,bWdj2GDclj5ofokWjzoa5jAwMkxCykd6,4,4,0,0,2,0,3,0,9,1.2857142857142858,1,0.0,2,0,0,2,2,0,0,3,0,4,5,1
4033,66954,8Eqf4bSicFmRziRU1kFgF89C5yGB8WDX,bWdj2GDclj5ofokWjzoa5jAwMkxCykd6,7,26,7,0,6,16,20,0,75,10.714285714285714,3,0.0,0,7,0,6,26,16,0,20,0,13,62,1
4034,66957,19VrgqzLVY9ZBYQoB1uroAA02q94O1Zu,SpATywNh6bZuzm8s1ceuBUnMUAeoAHHw,11,8,0,21,0,1,4,1,35,5.0,1,0.0,2,0,17,0,6,1,4,4,1,19,16,1
4035,66958,VNn0ZSteI0TUWATSfv7oNQMdpP8UUblh,SpATywNh6bZuzm8s1ceuBUnMUAeoAHHw,31,61,23,18,10,9,20,1,142,20.285714285714285,3,0.0,17,23,18,10,44,9,0,20,1,68,74,1
4036,66963,HYIak5MajHEE4KscVQZXOCe1sQzZq7OB,G8EPVSXsOYB5YQWZGiz1aVq5Pgr2GrQu,7,7,1,0,0,0,3,0,11,1.5714285714285714,2,0.0,1,1,0,0,6,0,0,3,0,2,9,1
4037,66973,AtBEE9J055aDlITLvmg36iywfRw9ii2d,SpATywNh6bZuzm8s1ceuBUnMUAeoAHHw,16,13,6,15,3,0,11,0,48,6.857142857142857,2,0.0,2,6,12,3,11,0,3,11,0,23,25,1
4038,66977,vEpbzgzC6vVRH2ddUE3uoPla0NVwp3kL,SpATywNh6bZuzm8s1ceuBUnMUAeoAHHw,7,4,0,0,0,0,5,0,9,1.2857142857142858,1,0.0,0,0,0,0,4,0,0,5,0,0,9,1
4039,66996,vgJBdvzTqJ5MKR9sNPkrlU2Mvr3KdXZ3,SpATywNh6bZuzm8s1ceuBUnMUAeoAHHw,16,17,8,19,5,0,4,0,53,7.571428571428571,2,0.0,6,8,16,5,11,0,3,4,0,35,18,0
4040,66999,FfIijJSc7v6Gx20szDQGd4UKB6lngdbn,SpATywNh6bZuzm8s1ceuBUnMUAeoAHHw,4,2,1,0,1,0,1,0,5,0.7142857142857143,1,0.0,0,1,0,1,2,0,0,1,0,2,3,1
4041,67000,5TmlEBiIGuIt6aB6TwvG68U4RXEnGCj0,SpATywNh6bZuzm8s1ceuBUnMUAeoAHHw,4,2,1,0,1,0,1,0,5,0.7142857142857143,1,0.0,0,1,0,1,2,0,0,1,0,2,3,0
4042,67002,x0d0kPxQt2lqC4Ti0c8RfiJ0ufqJ2aAF,SpATywNh6bZuzm8s1ceuBUnMUAeoAHHw,4,2,1,0,0,1,2,0,6,0.8571428571428571,1,0.0,0,1,0,0,2,1,0,2,0,1,5,1
4043,67004,P2uvU61vWnBKPWmDU3fEsDqh9JFKsQoE,bWdj2GDclj5ofokWjzoa5jAwMkxCykd6,11,15,11,66,5,0,3,0,100,14.285714285714286,2,0.0,1,11,65,5,14,0,1,3,0,82,18,1
4044,67006,3KIB4La3IsOSQkcNKGmRWQWUPPUMWKbW,RXDvfPUBYFlVdlueBFbLW0mhhAyGEqpt,9,3,2,0,2,1,5,1,14,2.0,1,0.0,0,2,0,2,3,1,0,5,1,4,10,0
4045,67012,Id4UmIRRQiLXHoJYSjh5OCO1CRaFgQ2K,RXDvfPUBYFlVdlueBFbLW0mhhAyGEqpt,10,12,8,0,5,0,2,0,27,3.857142857142857,2,0.0,0,8,0,5,12,0,0,2,0,13,14,1
4046,67014,1yJ7vGttwVZkfwO9DkOg0seBq4i9314Q,bWdj2GDclj5ofokWjzoa5jAwMkxCykd6,1,0,0,0,0,0,1,0,1,0.14285714285714285,1,0.0,0,0,0,0,0,0,0,1,0,0,1,1
4047,67015,knXx0VSX34ZZdw5j0pCDnRFFDbxG6IJ6,SpATywNh6bZuzm8s1ceuBUnMUAeoAHHw,13,15,8,3,5,0,6,0,37,5.285714285714286,2,0.0,4,8,3,5,11,0,0,6,0,20,17,0
4048,67022,qgATVDXI6hyNw5k2TylFI0Voj1oJ8GzP,RXDvfPUBYFlVdlueBFbLW0mhhAyGEqpt,4,2,1,0,1,0,1,0,5,0.7142857142857143,1,0.0,0,1,0,1,2,0,0,1,0,2,3,1
4049,67023,qgATVDXI6hyNw5k2TylFI0Voj1oJ8GzP,SpATywNh6bZuzm8s1ceuBUnMUAeoAHHw,2,0,0,0,0,0,2,0,2,0.2857142857142857,1,0.0,0,0,0,0,0,0,0,2,0,0,2,1
4050,67033,tPYh43YRHAzuf09xESxSKtWvST0aCsjn,SpATywNh6bZuzm8s1ceuBUnMUAeoAHHw,15,19,8,16,1,0,7,0,51,7.285714285714286,5,0.0,7,8,14,1,12,0,2,7,0,30,21,0
4051,67034,yZ9FndAKqVsKwZtO1B2JJJblefdbhZ02,SpATywNh6bZuzm8s1ceuBUnMUAeoAHHw,14,15,1,30,0,0,13,0,59,8.428571428571429,5,0.0,8,1,27,0,7,0,3,13,0,36,23,0
4052,67037,6RtjQ87TFCeYnCEQooYczzLrx8zugyat,SpATywNh6bZuzm8s1ceuBUnMUAeoAHHw,1,0,0,0,0,0,1,0,1,0.14285714285714285,1,0.0,0,0,0,0,0,0,0,1,0,0,1,1
4053,67040,Rf7b7AtnB3yMHMysfPwxe6fh0kofBsCX,G8EPVSXsOYB5YQWZGiz1aVq5Pgr2GrQu,6,7,3,0,2,0,6,0,18,2.5714285714285716,2,0.0,3,3,0,2,4,0,0,6,0,8,10,1
4054,67041,G2vTTAEhPpy1uiGVOSc3WfzCmuUhZyw6,SpATywNh6bZuzm8s1ceuBUnMUAeoAHHw,12,19,1,19,1,0,12,0,52,7.428571428571429,1,0.0,8,1,15,1,11,0,4,12,0,25,27,1
4055,67049,caAQbOI1NkkZKVF3oGPK3OdsY0lbDlYb,SpATywNh6bZuzm8s1ceuBUnMUAeoAHHw,10,14,6,0,3,0,8,3,34,4.857142857142857,2,0.0,0,6,0,3,14,0,0,8,3,9,25,1
4056,67051,fJHji2otGUDYDMFxwiigoqhPCAcWp4zZ,SpATywNh6bZuzm8s1ceuBUnMUAeoAHHw,5,2,1,0,1,0,2,0,6,0.8571428571428571,1,0.0,0,1,0,1,2,0,0,2,0,2,4,1
4057,67058,b5Gj1OyeYKLhLlGsleyNSSJpbJ2lneFj,RXDvfPUBYFlVdlueBFbLW0mhhAyGEqpt,19,9,6,24,4,0,3,0,46,6.571428571428571,1,0.0,2,6,24,4,7,0,0,3,0,36,10,1
4058,67059,3w7hN41KgzlGkT6XiQZqVbo1geJzchKr,G8EPVSXsOYB5YQWZGiz1aVq5Pgr2GrQu,5,1,1,0,1,0,4,0,7,1.0,2,0.0,0,1,0,1,1,0,0,4,0,2,5,1
4059,67061,OisrcH2Uqqf03TtDLM3YLpNZbhlSzcT1,SpATywNh6bZuzm8s1ceuBUnMUAeoAHHw,8,7,4,0,2,0,11,1,25,3.5714285714285716,1,0.0,0,4,0,2,7,0,0,11,1,6,19,1
4060,67076,llPRK5GJ1Fu42jqOdNFWOcUEenGG1vdv,SpATywNh6bZuzm8s1ceuBUnMUAeoAHHw,13,26,6,17,3,0,4,0,56,8.0,1,0.0,15,6,16,3,11,0,1,4,0,40,16,1
4061,67077,wDMKq3Xvq95ERd20zjEMEb0BtCbHx7BM,SpATywNh6bZuzm8s1ceuBUnMUAeoAHHw,24,46,18,36,4,6,19,2,131,18.714285714285715,9,0.0,10,18,34,4,36,6,2,19,2,66,65,0
4062,67080,CgsguvEs0KUN3Abw9Qjh5ZZT0chwXUSw,SpATywNh6bZuzm8s1ceuBUnMUAeoAHHw,19,41,11,18,4,105,14,1,194,27.714285714285715,5,0.0,10,11,17,4,31,105,1,14,1,42,152,0
4063,67087,CN11ovtPF8fJmUO54gCiYLygyrR54itQ,SpATywNh6bZuzm8s1ceuBUnMUAeoAHHw,8,11,6,0,2,0,2,0,21,3.0,2,0.0,0,6,0,2,11,0,0,2,0,8,13,0
4064,67096,N7x6rez9AavUVus2y33zQwbgvW9e4FwN,SpATywNh6bZuzm8s1ceuBUnMUAeoAHHw,14,18,6,17,3,0,2,0,46,6.571428571428571,1,0.0,10,6,16,3,8,0,1,2,0,35,11,1
4065,67099,rwVFzRApiQw3vAU5Rpa6do3mD0uc5CXG,SpATywNh6bZuzm8s1ceuBUnMUAeoAHHw,22,53,1,33,1,5,14,1,108,15.428571428571429,5,0.0,17,1,29,1,36,5,4,14,1,48,60,1
4066,67104,8IdT3BpziJuUIg1uIZIVpj0NWmeXuSS8,G8EPVSXsOYB5YQWZGiz1aVq5Pgr2GrQu,32,57,4,94,4,6,14,1,180,25.714285714285715,3,0.0,37,4,79,4,20,6,15,14,1,124,56,1
4067,67111,KOlp6BtLHFtxPjNN0KYQVjD6WvIwSYtA,SpATywNh6bZuzm8s1ceuBUnMUAeoAHHw,22,54,1,25,0,9,12,0,101,14.428571428571429,3,0.0,16,1,24,0,38,9,1,12,0,41,60,0
4068,67114,G7XB7BvktED5k0pfiNMFlIFMFGCreTGp,G8EPVSXsOYB5YQWZGiz1aVq5Pgr2GrQu,6,12,1,0,3,0,3,0,19,2.7142857142857144,1,0.0,10,1,0,3,2,0,0,3,0,14,5,1
4069,67116,KhEJGS2oZuX97oPJJp9Z5yTu0JSgEwNN,SpATywNh6bZuzm8s1ceuBUnMUAeoAHHw,11,26,2,11,0,1,5,0,45,6.428571428571429,1,0.0,10,2,10,0,16,1,1,5,0,22,23,1
4070,67122,TuRtla6uL7YMLA6vfJsBKtiNWjCxP0OZ,RXDvfPUBYFlVdlueBFbLW0mhhAyGEqpt,10,26,13,0,3,0,3,0,45,6.428571428571429,2,0.0,9,13,0,3,17,0,0,3,0,25,20,1
4071,67128,dL3mb41Bm8AhTujPtToBfgUCEqTQ4yms,G8EPVSXsOYB5YQWZGiz1aVq5Pgr2GrQu,7,18,3,0,1,0,3,0,25,3.5714285714285716,2,0.0,3,3,0,1,15,0,0,3,0,7,18,1
4072,67133,iU8sg5PBq7mTADvs0COG4jXH4nM6hq2B,SpATywNh6bZuzm8s1ceuBUnMUAeoAHHw,31,50,20,13,12,11,23,1,130,18.571428571428573,5,0.0,20,20,13,12,30,11,0,23,1,65,65,1
4073,67137,iZa1NC6aT0Npl7jBiTIydtSYeYsdEobQ,bWdj2GDclj5ofokWjzoa5jAwMkxCykd6,3,0,0,0,0,0,2,1,3,0.42857142857142855,1,0.0,0,0,0,0,0,0,0,2,1,0,3,1
4074,67152,gaiJtHdepYI8ZLS7HsizBoGVbYaMsssC,bWdj2GDclj5ofokWjzoa5jAwMkxCykd6,2,0,0,0,0,0,2,0,2,0.2857142857142857,1,0.0,0,0,0,0,0,0,0,2,0,0,2,1
4075,67156,3vhG5LSOA1YcHy71CJJOxAgCZ2y6XT8e,SpATywNh6bZuzm8s1ceuBUnMUAeoAHHw,15,31,11,23,4,0,9,0,78,11.142857142857142,2,0.0,15,11,20,4,16,0,3,9,0,50,28,1
4076,67158,07nBIjV5wvxeipK7Zz3uxWH8hv0V5VvH,SpATywNh6bZuzm8s1ceuBUnMUAeoAHHw,30,47,22,20,11,5,9,1,115,16.428571428571427,4,0.0,19,22,19,11,28,5,1,9,1,71,44,0
4077,67159,CQ3lDAshmWjO1E4GBV1wnteO6NqYgq2s,G8EPVSXsOYB5YQWZGiz1aVq5Pgr2GrQu,30,63,1,68,5,8,7,1,153,21.857142857142858,2,0.0,23,1,53,5,40,8,15,7,1,82,71,1
4078,67164,ztcM8oJ9cYwAQxtlfaWWEY7el55tNp3L,SpATywNh6bZuzm8s1ceuBUnMUAeoAHHw,13,60,15,0,13,12,17,2,119,17.0,3,0.0,2,15,0,13,58,12,0,17,2,30,89,1
4079,67171,ILwuNMaKW9cfodB9O42BE2MDGjshUqyt,SpATywNh6bZuzm8s1ceuBUnMUAeoAHHw,10,12,0,0,0,0,7,0,19,2.7142857142857144,2,0.0,0,0,0,0,12,0,0,7,0,0,19,1
4080,67175,U9sp7fhhso4I4hUMdZYxdb4jjkzhb9EZ,SpATywNh6bZuzm8s1ceuBUnMUAeoAHHw,16,16,8,20,6,6,20,8,84,12.0,2,0.0,3,8,17,6,13,6,3,20,8,34,50,1
4081,67178,29637v4JeTV4lmXkjMER9DNWcGaMyJ4v,G8EPVSXsOYB5YQWZGiz1aVq5Pgr2GrQu,3,2,1,0,0,0,1,0,4,0.5714285714285714,1,0.0,0,1,0,0,2,0,0,1,0,1,3,1
4082,67184,tYMYXyJdOChlQSPrkrVNlrHj5tCYzHnQ,bWdj2GDclj5ofokWjzoa5jAwMkxCykd6,11,15,3,50,4,0,1,0,73,10.428571428571429,2,0.0,8,3,47,4,7,0,3,1,0,62,11,1
4083,67185,yCubUbsDW6wXrTu9ngQq5pTghAOVDrjs,SpATywNh6bZuzm8s1ceuBUnMUAeoAHHw,1,0,0,0,0,0,1,0,1,0.14285714285714285,1,0.0,0,0,0,0,0,0,0,1,0,0,1,1
4084,67195,MPLO46zeqSAmGFkKKuWvnx6pcJItRavU,SpATywNh6bZuzm8s1ceuBUnMUAeoAHHw,31,76,28,39,8,6,21,4,182,26.0,3,0.0,37,28,33,8,39,6,6,21,4,106,76,0
4085,67198,MozrQftkFsk2HJMPpZe4xQGho83nBBbJ,SpATywNh6bZuzm8s1ceuBUnMUAeoAHHw,9,8,3,0,1,1,6,1,20,2.857142857142857,1,0.0,1,3,0,1,7,1,0,6,1,5,15,1
4086,67207,jn6VKgJPC4fyRRCl6zZirG5zLpU8fnC6,SpATywNh6bZuzm8s1ceuBUnMUAeoAHHw,2,0,0,0,0,0,2,0,2,0.2857142857142857,1,0.0,0,0,0,0,0,0,0,2,0,0,2,1
4087,67209,lXVULXqG43l726A9V3NFlFs9kvovJQx4,SpATywNh6bZuzm8s1ceuBUnMUAeoAHHw,10,7,5,0,4,0,4,0,20,2.857142857142857,2,0.0,0,5,0,4,7,0,0,4,0,9,11,1
4088,67213,IHjTTbtSKJcagLP8HZiMzotl9tnHf7ev,SpATywNh6bZuzm8s1ceuBUnMUAeoAHHw,13,5,2,12,2,7,7,2,37,5.285714285714286,2,0.0,2,2,9,2,3,7,3,7,2,15,22,0
4089,67220,5UJZmEar1AX3gQXOzkh3MnQcYdErI17M,SpATywNh6bZuzm8s1ceuBUnMUAeoAHHw,21,25,9,12,5,3,10,1,65,9.285714285714286,3,0.0,12,9,10,5,13,3,2,10,1,36,29,1
4090,67224,AszzZcQ3DzjVCWiO17ucpHFrMmRC8MRV,SpATywNh6bZuzm8s1ceuBUnMUAeoAHHw,17,66,5,31,3,74,35,4,218,31.142857142857142,3,0.0,15,5,25,3,51,74,6,35,4,48,170,0
4091,67231,DBWpurAvW8awkr3pqCDDF8bsim2D57Vj,G8EPVSXsOYB5YQWZGiz1aVq5Pgr2GrQu,14,7,5,0,6,0,8,1,27,3.857142857142857,1,0.0,2,5,0,6,5,0,0,8,1,13,14,1
4092,67246,kA48LgfRPY6vHgTrWK5pJnx3RsuxrRTH,SpATywNh6bZuzm8s1ceuBUnMUAeoAHHw,10,6,3,1,2,0,3,0,15,2.142857142857143,1,0.0,1,3,1,2,5,0,0,3,0,7,8,1
4093,67247,q2AJDoW2EuJlq2uo87Sn9QLp36IwXzSv,SpATywNh6bZuzm8s1ceuBUnMUAeoAHHw,8,3,1,0,2,0,5,0,11,1.5714285714285714,2,0.0,0,1,0,2,3,0,0,5,0,3,8,1
4094,67248,8R7wkJYHxnNXLQq4dxMbBtsEclGat3j9,bWdj2GDclj5ofokWjzoa5jAwMkxCykd6,1,0,0,0,0,0,1,0,1,0.14285714285714285,1,0.0,0,0,0,0,0,0,0,1,0,0,1,1
4095,67260,ZULZi8TAkwGNSYKMYJ57kBAZvrMte2xF,SpATywNh6bZuzm8s1ceuBUnMUAeoAHHw,15,28,13,16,7,0,5,0,69,9.857142857142858,1,0.0,4,13,14,7,24,0,2,5,0,38,31,1
4096,67262,4hqkXkyq5mjsuNE9t6Q3zzOu4OQAJfqm,SpATywNh6bZuzm8s1ceuBUnMUAeoAHHw,12,19,9,10,4,0,5,0,47,6.714285714285714,4,0.0,5,9,10,4,14,0,0,5,0,28,19,1
4097,67264,uxiQAPJTLsI808GQpb2cYmEtdBDdQ3cx,SpATywNh6bZuzm8s1ceuBUnMUAeoAHHw,14,15,6,9,3,0,5,0,38,5.428571428571429,2,0.0,8,6,9,3,7,0,0,5,0,26,12,1
4098,67265,hfSXPDFaR2dzrQsij0JMBqqFRCNkzN0i,SpATywNh6bZuzm8s1ceuBUnMUAeoAHHw,6,3,1,0,1,0,2,0,7,1.0,1,0.0,0,1,0,1,3,0,0,2,0,2,5,1
4099,67266,X0qiYFDfIWOz74gDCjJtjtlJKUHThKgm,SpATywNh6bZuzm8s1ceuBUnMUAeoAHHw,24,45,23,18,9,19,12,1,127,18.142857142857142,5,0.0,15,23,15,9,30,19,3,12,1,62,65,0
4100,67267,d4AhROqi4DjVmWKfbbbhi19n7hcGPkSg,RXDvfPUBYFlVdlueBFbLW0mhhAyGEqpt,55,60,1,178,3,12,14,4,272,38.857142857142854,8,0.0,14,1,150,3,46,12,28,14,4,168,104,0
4101,67272,28W5CJrYp73LQgjHivjzAixkCQuqTCh6,bWdj2GDclj5ofokWjzoa5jAwMkxCykd6,4,2,1,0,1,0,2,0,6,0.8571428571428571,2,0.0,0,1,0,1,2,0,0,2,0,2,4,1
4102,67275,d7AooNZI1FOSZnZfgBmuAUMu5eysX9mb,SpATywNh6bZuzm8s1ceuBUnMUAeoAHHw,12,13,8,14,6,0,2,0,43,6.142857142857143,1,0.0,4,8,11,6,9,0,3,2,0,29,14,1
4103,67278,frK0oim7qtvURbYrZJ5gIFPqgQt63IEt,G8EPVSXsOYB5YQWZGiz1aVq5Pgr2GrQu,9,3,2,0,0,7,9,1,22,3.142857142857143,2,0.0,0,2,0,0,3,7,0,9,1,2,20,0
4104,67287,r9n2Z7iYkL5tKegLJwMIOxTHQqxopYp0,G8EPVSXsOYB5YQWZGiz1aVq5Pgr2GrQu,7,5,3,0,2,0,2,0,12,1.7142857142857142,2,0.0,0,3,0,2,5,0,0,2,0,5,7,0
4105,67288,PXVYYQlV1TwZ9b9f7GhoFUXTgABGZcBY,SpATywNh6bZuzm8s1ceuBUnMUAeoAHHw,17,27,11,19,5,3,16,2,83,11.857142857142858,2,0.0,12,11,16,5,15,3,3,16,2,44,39,0
4106,67297,mZ0efv4ffU6kCJ0Ro6mv6OGSULVT9odf,SpATywNh6bZuzm8s1ceuBUnMUAeoAHHw,1,0,0,0,0,0,1,0,1,0.14285714285714285,1,0.0,0,0,0,0,0,0,0,1,0,0,1,1
4107,67300,3QGIXvN5AKtl5SyCz6EZh0jA8JPL5Nkx,bWdj2GDclj5ofokWjzoa5jAwMkxCykd6,6,9,1,0,0,0,3,0,13,1.8571428571428572,2,0.0,0,1,0,0,9,0,0,3,0,1,12,1
4108,67302,CrdUJ25e700hCpU6YbocYb3uKRMcCPjz,SpATywNh6bZuzm8s1ceuBUnMUAeoAHHw,9,15,0,4,0,0,2,0,21,3.0,3,0.0,0,0,3,0,15,0,1,2,0,3,18,1
4109,67303,xrGYbDqan6dLH2p778nfhYmmVfnrrpam,SpATywNh6bZuzm8s1ceuBUnMUAeoAHHw,2,0,0,0,0,0,2,0,2,0.2857142857142857,1,0.0,0,0,0,0,0,0,0,2,0,0,2,1
4110,67308,T73fWQC3H2PhmOiodFuHvvahENx7TmZo,SpATywNh6bZuzm8s1ceuBUnMUAeoAHHw,7,6,4,0,3,0,1,0,14,2.0,1,0.0,1,4,0,3,5,0,0,1,0,8,6,1
4111,67314,CVINZY0qqZyjVQC8d4yq3w0fqkMGJBVL,G8EPVSXsOYB5YQWZGiz1aVq5Pgr2GrQu,21,16,2,14,2,0,7,1,42,6.0,1,0.0,0,2,12,2,16,0,2,7,1,16,26,1
4112,67328,HurK028hfari9vlQzhAchljjKEaGMu7l,SpATywNh6bZuzm8s1ceuBUnMUAeoAHHw,5,9,4,0,2,0,4,0,19,2.7142857142857144,3,0.0,0,4,0,2,9,0,0,4,0,6,13,1
4113,67332,0xyoG1WvCKM42y6l9xPNGRXw8gklJB9a,G8EPVSXsOYB5YQWZGiz1aVq5Pgr2GrQu,14,34,7,8,5,9,5,0,68,9.714285714285714,2,0.0,2,7,6,5,32,9,2,5,0,20,48,1
4114,67345,WACfmqzUT9wOhkm3QdtpYOSdY2CeIJWa,RXDvfPUBYFlVdlueBFbLW0mhhAyGEqpt,44,42,25,57,14,3,13,3,157,22.428571428571427,2,0.0,10,25,52,14,32,3,5,13,3,101,56,1
4115,67346,DDhKDNB6fEAHv06PdV80Zz5GVaFianlg,SpATywNh6bZuzm8s1ceuBUnMUAeoAHHw,11,13,5,0,1,4,9,1,33,4.714285714285714,1,0.0,3,5,0,1,10,4,0,9,1,9,24,1
4116,67348,GQMirxB5y3FtUmix76KGcpTxWntGgKiV,RXDvfPUBYFlVdlueBFbLW0mhhAyGEqpt,50,35,22,50,15,8,6,0,136,19.428571428571427,2,0.0,9,22,48,15,26,8,2,6,0,94,42,1
4117,67353,VWEcCKiwp28lQZuBYYNslDL0523gk0Z6,G8EPVSXsOYB5YQWZGiz1aVq5Pgr2GrQu,16,19,7,8,7,0,4,1,46,6.571428571428571,1,0.0,10,7,5,7,9,0,3,4,1,29,17,1
4118,67354,ZdDSfnnRjfjHFmnDyPudXjLUHiOgLvKy,SpATywNh6bZuzm8s1ceuBUnMUAeoAHHw,4,2,0,0,0,0,2,0,4,0.5714285714285714,1,0.0,0,0,0,0,2,0,0,2,0,0,4,1
4119,67359,SODa9wZLHSXHCkQdc5G9XFSaZePE5xpY,bWdj2GDclj5ofokWjzoa5jAwMkxCykd6,1,0,0,0,0,0,1,0,1,0.14285714285714285,1,0.0,0,0,0,0,0,0,0,1,0,0,1,1
4120,67360,V5bKpsSihRb2F9h32bBQPUZX9j9nvFi3,SpATywNh6bZuzm8s1ceuBUnMUAeoAHHw,5,5,0,0,0,0,2,0,7,1.0,1,0.0,0,0,0,0,5,0,0,2,0,0,7,1
4121,67362,a5BZ9otCoBYjX9WVbUSqK2dp356IUlVP,bWdj2GDclj5ofokWjzoa5jAwMkxCykd6,2,0,0,0,0,0,2,0,2,0.2857142857142857,1,0.0,0,0,0,0,0,0,0,2,0,0,2,1
4122,67371,Ofc6ixmmoavYN92PkloL7C1g0H36jbU2,SpATywNh6bZuzm8s1ceuBUnMUAeoAHHw,10,11,5,0,3,0,8,1,28,4.0,3,0.0,0,5,0,3,11,0,0,8,1,8,20,1
4123,67377,w2OXuLJJs4MYqj6mF4JPNXoMIMuUu4d7,SpATywNh6bZuzm8s1ceuBUnMUAeoAHHw,6,5,2,0,1,2,3,0,13,1.8571428571428572,1,0.0,0,2,0,1,5,2,0,3,0,3,10,1
4124,67381,lPTnc5ZrBauZXbwYcDNNjt3Gvgvmp9Cq,SpATywNh6bZuzm8s1ceuBUnMUAeoAHHw,5,5,3,0,1,0,3,0,12,1.7142857142857142,2,0.0,0,3,0,1,5,0,0,3,0,4,8,1
4125,67382,ib1Tw9jwnFk22Zeb4pY0FX5aHNkeyMBZ,SpATywNh6bZuzm8s1ceuBUnMUAeoAHHw,3,3,1,0,0,0,1,0,5,0.7142857142857143,1,0.0,0,1,0,0,3,0,0,1,0,1,4,1
4126,67388,ALYZFAVviUOGzyN4znk46d3PmVgvtUAM,bWdj2GDclj5ofokWjzoa5jAwMkxCykd6,4,2,0,0,0,0,2,2,6,0.8571428571428571,1,0.0,0,0,0,0,2,0,0,2,2,0,6,1
4127,67389,k5fKzDcQyLOb8CsK2DtBEPxysEHaDdpC,RXDvfPUBYFlVdlueBFbLW0mhhAyGEqpt,6,12,3,0,1,3,4,1,24,3.4285714285714284,2,0.0,0,3,0,1,12,3,0,4,1,4,20,1
4128,67394,5fHLQXAfhzEdTjeeb4rbhkUBfbZKOD1P,SpATywNh6bZuzm8s1ceuBUnMUAeoAHHw,6,9,1,0,0,2,4,0,16,2.2857142857142856,1,0.0,0,1,0,0,9,2,0,4,0,1,15,1
4129,67405,5MnZ5TXikbZdya4aF9I9IoQXVWF4ujt6,SpATywNh6bZuzm8s1ceuBUnMUAeoAHHw,2,0,0,0,0,0,3,0,3,0.42857142857142855,1,0.0,0,0,0,0,0,0,0,3,0,0,3,1
4130,67406,KglHKNjP3QUQRobKP7GTczISSfhOt7DT,SpATywNh6bZuzm8s1ceuBUnMUAeoAHHw,1,0,0,0,0,0,1,0,1,0.14285714285714285,1,0.0,0,0,0,0,0,0,0,1,0,0,1,1
4131,67418,lCMgevd3r8NsQWpObW4O6eaYbm6xHejf,bWdj2GDclj5ofokWjzoa5jAwMkxCykd6,8,6,4,0,3,0,3,0,16,2.2857142857142856,2,0.0,0,4,0,3,6,0,0,3,0,7,9,1
4132,67421,DjTSUM8no03TdLiv7ibkGW8BkXCgFLYB,bWdj2GDclj5ofokWjzoa5jAwMkxCykd6,11,22,11,16,9,0,6,0,64,9.142857142857142,2,0.0,4,11,14,9,18,0,2,6,0,38,26,1
4133,67424,kuV8TXv5cFVPIWK37fDR8nnl0vrHyjjA,RXDvfPUBYFlVdlueBFbLW0mhhAyGEqpt,61,104,49,115,9,6,13,2,298,42.57142857142857,4,0.0,15,49,107,9,89,6,8,13,2,180,118,0
4134,67427,vS0PO2z5tTpDl1S200qdqNDkFjNmdjxd,G8EPVSXsOYB5YQWZGiz1aVq5Pgr2GrQu,12,9,1,30,0,0,3,0,43,6.142857142857143,1,0.0,1,1,26,0,8,0,4,3,0,28,15,1
4135,67429,JY3pL2MJnhOGuIufYZaXnkXrdE9eR9kZ,SpATywNh6bZuzm8s1ceuBUnMUAeoAHHw,7,3,2,0,2,0,2,0,9,1.2857142857142858,1,0.0,0,2,0,2,3,0,0,2,0,4,5,1
4136,67431,ic21uM8q7hG6lYEnCwOGpdZRk8GzB2Q4,bWdj2GDclj5ofokWjzoa5jAwMkxCykd6,4,3,1,0,1,0,1,0,6,0.8571428571428571,1,0.0,0,1,0,1,3,0,0,1,0,2,4,1
4137,67435,gK0C2Qn10uFCDrXyxIuukzeUErx51I1a,SpATywNh6bZuzm8s1ceuBUnMUAeoAHHw,23,49,1,35,2,2,10,0,99,14.142857142857142,4,0.0,22,1,33,2,27,2,2,10,0,58,41,0
4138,67437,H1gNXDemnE2i9lW82GrGfdWk3AATsmHy,SpATywNh6bZuzm8s1ceuBUnMUAeoAHHw,13,15,6,6,5,4,2,0,38,5.428571428571429,1,0.0,8,6,6,5,7,4,0,2,0,25,13,0
4139,67444,Cow0Edw3V8JD4s2oOxNrhyd18ZVv78TG,SpATywNh6bZuzm8s1ceuBUnMUAeoAHHw,6,7,3,0,2,0,1,0,13,1.8571428571428572,1,0.0,0,3,0,2,7,0,0,1,0,5,8,1
4140,67445,Q9jQ2QVFcDk6rCEN1ap0bZmI7VqzGuqs,SpATywNh6bZuzm8s1ceuBUnMUAeoAHHw,13,18,0,21,0,7,6,1,53,7.571428571428571,2,0.0,2,0,17,0,16,7,4,6,1,19,34,0
4141,67454,7KhKGJPxu4uQKYHNs7O3NjmuTH6NjrVY,bWdj2GDclj5ofokWjzoa5jAwMkxCykd6,9,42,25,4,7,18,28,2,126,18.0,3,0.0,2,25,3,7,40,18,1,28,2,37,89,0
4142,67458,gjY6BujcNO3C8usrnDcYxkNzXuI0fCEe,SpATywNh6bZuzm8s1ceuBUnMUAeoAHHw,8,6,4,0,3,0,4,0,17,2.4285714285714284,1,0.0,0,4,0,3,6,0,0,4,0,7,10,1
4143,67464,uBWT9p90Ea0JVvR5wbRV9EQLPt0ehYR1,SpATywNh6bZuzm8s1ceuBUnMUAeoAHHw,24,41,1,27,1,10,18,0,98,14.0,4,0.0,12,1,24,1,29,10,3,18,0,38,60,1
4144,67466,6yy5YFhebeCVEWPcZqK4jg9qO8ru1OT4,SpATywNh6bZuzm8s1ceuBUnMUAeoAHHw,15,17,3,23,2,2,7,0,54,7.714285714285714,4,0.0,3,3,19,2,14,2,4,7,0,27,27,1
4145,67467,ZLbvkY9GfOSzox7JCIcmWczltkUqxVjR,SpATywNh6bZuzm8s1ceuBUnMUAeoAHHw,7,6,4,0,2,0,4,0,16,2.2857142857142856,1,0.0,0,4,0,2,6,0,0,4,0,6,10,1
4146,67468,lHCmVtLnmElXqFcol1pTzGnaqp21GEs7,RXDvfPUBYFlVdlueBFbLW0mhhAyGEqpt,3,0,0,0,0,0,2,2,4,0.5714285714285714,1,0.0,0,0,0,0,0,0,0,2,2,0,4,1
4147,67469,7tCVHfGANSkwc2DzOsbidXgZOw6Q8q5f,G8EPVSXsOYB5YQWZGiz1aVq5Pgr2GrQu,9,4,3,0,3,0,2,0,12,1.7142857142857142,1,0.0,0,3,0,3,4,0,0,2,0,6,6,1
4148,67474,XQsLTRxBgT09jhwR2kw4g3k34p5O8kHV,bWdj2GDclj5ofokWjzoa5jAwMkxCykd6,10,16,9,0,7,0,5,0,37,5.285714285714286,3,0.0,3,9,0,7,13,0,0,5,0,19,18,1
4149,67483,vEVxgcd4BTOgXUZ4VmhnVVivaAZ5TwNb,bWdj2GDclj5ofokWjzoa5jAwMkxCykd6,8,19,9,0,1,0,14,0,43,6.142857142857143,2,0.0,2,9,0,1,17,0,0,14,0,12,31,1
4150,67486,Ey4V2u8lgXOqStmlXh5LfVpeA2fR57Ho,SpATywNh6bZuzm8s1ceuBUnMUAeoAHHw,1,0,0,0,0,0,1,0,1,0.14285714285714285,1,0.0,0,0,0,0,0,0,0,1,0,0,1,1
4151,67492,pUaHa5R2nATh2lieQIvoIQ34ofl1qMpg,RXDvfPUBYFlVdlueBFbLW0mhhAyGEqpt,41,40,2,102,4,1,10,1,160,22.857142857142858,2,0.0,15,2,91,4,25,1,11,10,1,112,48,1
4152,67510,9by6FuLW9p6hAe2x8b5HjrOAjJeqk2av,SpATywNh6bZuzm8s1ceuBUnMUAeoAHHw,17,20,12,8,6,5,6,1,58,8.285714285714286,2,0.0,5,12,8,6,15,5,0,6,1,31,27,0
4153,67511,XiaZKMFLZltgVmLipzSXdXFKLHeDtV4U,SpATywNh6bZuzm8s1ceuBUnMUAeoAHHw,6,7,3,0,1,0,4,0,15,2.142857142857143,2,0.0,0,3,0,1,7,0,0,4,0,4,11,1
4154,67513,XKOZTIyRECata3wyZZEEtiKIhGnxgB74,SpATywNh6bZuzm8s1ceuBUnMUAeoAHHw,5,2,1,0,1,0,3,0,7,1.0,1,0.0,0,1,0,1,2,0,0,3,0,2,5,1
4155,67514,cCePdsnJSYHqdiZSbXBQK6xp3gMbJSPB,SpATywNh6bZuzm8s1ceuBUnMUAeoAHHw,8,2,1,0,1,0,4,1,9,1.2857142857142858,1,0.0,0,1,0,1,2,0,0,4,1,2,7,1
4156,67518,hd2F6jShBoDgDRbyWyB2cglMktEJbDcH,SpATywNh6bZuzm8s1ceuBUnMUAeoAHHw,5,2,1,0,1,0,3,0,7,1.0,1,0.0,0,1,0,1,2,0,0,3,0,2,5,1
4157,67532,GnIRbc6SlMVQELxTtsBRscVXZT2NaPnc,bWdj2GDclj5ofokWjzoa5jAwMkxCykd6,6,10,1,0,0,0,7,0,18,2.5714285714285716,2,0.0,0,1,0,0,10,0,0,7,0,1,17,1
4158,67535,HMMCRStJmM0GACTX8KnkMjogoI7SHUjo,SpATywNh6bZuzm8s1ceuBUnMUAeoAHHw,7,3,1,0,1,0,4,1,10,1.4285714285714286,1,0.0,0,1,0,1,3,0,0,4,1,2,8,1
4159,67539,ZhvYiagkjSANqD9iooXU2LPvYt7TDBNe,G8EPVSXsOYB5YQWZGiz1aVq5Pgr2GrQu,4,3,1,0,1,0,1,0,6,0.8571428571428571,1,0.0,1,1,0,1,2,0,0,1,0,3,3,1
4160,67542,87BKS3OvioYx6sBWp6JvkL3oGnn9HR6v,SpATywNh6bZuzm8s1ceuBUnMUAeoAHHw,6,2,0,0,1,0,6,0,9,1.2857142857142858,1,0.0,0,0,0,1,2,0,0,6,0,1,8,1
4161,67550,ScQd2YUPQVjLNV28id8viiUK1faGo8Du,SpATywNh6bZuzm8s1ceuBUnMUAeoAHHw,16,33,13,5,6,15,16,0,88,12.571428571428571,2,0.0,10,13,5,6,23,15,0,16,0,34,54,1
4162,67560,KpidFAO2tkY7K2KKYbeq2b9OWhsW5M4B,SpATywNh6bZuzm8s1ceuBUnMUAeoAHHw,1,0,0,0,0,0,1,0,1,0.14285714285714285,1,0.0,0,0,0,0,0,0,0,1,0,0,1,1
4163,67564,TyrR2674qqrmqDfJA1ba19pBHw30wbZn,bWdj2GDclj5ofokWjzoa5jAwMkxCykd6,9,11,3,2,2,0,7,1,26,3.7142857142857144,2,0.0,4,3,2,2,7,0,0,7,1,11,15,1
4164,67566,tYJFbmbzeY9dNgPSZvFhNskxnqvhh3AK,SpATywNh6bZuzm8s1ceuBUnMUAeoAHHw,18,24,6,8,3,5,9,2,57,8.142857142857142,3,0.0,4,6,6,3,20,5,2,9,2,19,38,0
4165,67572,HMOOD0QNsPiJ6FSYOiE4GQjvcEPtEXiW,SpATywNh6bZuzm8s1ceuBUnMUAeoAHHw,15,17,5,12,3,0,5,0,42,6.0,2,0.0,7,5,9,3,10,0,3,5,0,24,18,0
4166,67579,JsUpucQyiTLV5gDB7KrgqzRdiUsoUyeZ,bWdj2GDclj5ofokWjzoa5jAwMkxCykd6,1,0,0,0,0,0,2,0,2,0.2857142857142857,2,0.0,0,0,0,0,0,0,0,2,0,0,2,1
4167,67588,KgPlJUOxzo6K50clHm6VhLAZdTWxAeXA,SpATywNh6bZuzm8s1ceuBUnMUAeoAHHw,12,23,13,4,7,2,18,0,67,9.571428571428571,4,0.0,0,13,4,7,23,2,0,18,0,24,43,1
4168,67589,PiJ3gX6gddDaZL8DcE6EIcui1JUSTcfU,SpATywNh6bZuzm8s1ceuBUnMUAeoAHHw,16,13,7,6,4,16,5,1,52,7.428571428571429,1,0.0,3,7,6,4,10,16,0,5,1,20,32,1
4169,67590,iNC1K3GLRLEbKnkKM9DRjQmgl0TV31hj,SpATywNh6bZuzm8s1ceuBUnMUAeoAHHw,8,6,3,0,2,0,3,0,14,2.0,1,0.0,0,3,0,2,6,0,0,3,0,5,9,1
4170,67594,MwsjD881hF2KUCEG3rXUPSq3GKMfMo2d,SpATywNh6bZuzm8s1ceuBUnMUAeoAHHw,5,7,2,0,2,0,1,0,12,1.7142857142857142,1,0.0,0,2,0,2,7,0,0,1,0,4,8,0
4171,67595,FMyTD79DpzQKrXEJ9281Xlgi6vC7oMRz,SpATywNh6bZuzm8s1ceuBUnMUAeoAHHw,17,17,7,17,5,8,10,2,66,9.428571428571429,1,0.0,8,7,16,5,9,8,1,10,2,36,30,1
4172,67596,HMOOD0QNsPiJ6FSYOiE4GQjvcEPtEXiW,bWdj2GDclj5ofokWjzoa5jAwMkxCykd6,5,7,3,0,2,0,2,0,14,2.0,2,0.0,0,3,0,2,7,0,0,2,0,5,9,1
4173,67604,L7L1tCD13b9bwYB3itcIQLsWY4ZOzl4s,bWdj2GDclj5ofokWjzoa5jAwMkxCykd6,6,5,1,0,1,0,2,0,9,1.2857142857142858,1,0.0,0,1,0,1,5,0,0,2,0,2,7,1
4174,67606,zZJSO6J2IdlSRtL9i78S9ARTcFOb9HLo,SpATywNh6bZuzm8s1ceuBUnMUAeoAHHw,14,17,9,17,7,0,3,0,53,7.571428571428571,2,0.0,6,9,16,7,11,0,1,3,0,38,15,1
4175,67616,GkpBYL5A7XxQyiiOJwD69PHsUVDvMfPz,SpATywNh6bZuzm8s1ceuBUnMUAeoAHHw,15,14,10,0,5,0,8,1,38,5.428571428571429,4,0.0,0,10,0,5,14,0,0,8,1,15,23,0
4176,67621,n288BYpWLuFVQQ2eIcifxwEJn9u582IB,G8EPVSXsOYB5YQWZGiz1aVq5Pgr2GrQu,25,45,18,0,10,0,13,1,87,12.428571428571429,2,0.0,21,18,0,10,24,0,0,13,1,49,38,1
4177,67622,Sl7LGszo87N2dywG99gPMorFDWvvcTbU,SpATywNh6bZuzm8s1ceuBUnMUAeoAHHw,17,30,15,12,4,2,8,1,72,10.285714285714286,2,0.0,11,15,11,4,19,2,1,8,1,41,31,1
4178,67627,8AVylVqrvC0I5BhB8uK5ffluG4JxIZF6,SpATywNh6bZuzm8s1ceuBUnMUAeoAHHw,1,0,0,0,0,0,1,0,1,0.14285714285714285,1,0.0,0,0,0,0,0,0,0,1,0,0,1,1
4179,67633,IDjwQPQrnszw6soIGbbAmOia0h5OBccp,SpATywNh6bZuzm8s1ceuBUnMUAeoAHHw,2,0,0,0,0,0,2,0,2,0.2857142857142857,1,0.0,0,0,0,0,0,0,0,2,0,0,2,1
4180,67648,is1YRTEVdAbYSlOww6gWdslOyhkcfPV2,SpATywNh6bZuzm8s1ceuBUnMUAeoAHHw,15,30,14,17,7,2,6,0,76,10.857142857142858,3,0.0,11,14,14,7,19,2,3,6,0,46,30,0
4181,67652,HFAIeLw8Y6ycDg9QeC8e64dlQREKJUgu,SpATywNh6bZuzm8s1ceuBUnMUAeoAHHw,11,15,11,2,6,3,2,0,39,5.571428571428571,1,0.0,2,11,2,6,13,3,0,2,0,21,18,1
4182,67655,tkE1JI2oJkZLA1XOzEZ3Jn8IFDQS4QJ9,G8EPVSXsOYB5YQWZGiz1aVq5Pgr2GrQu,48,110,31,120,16,25,15,2,319,45.57142857142857,3,0.0,69,31,85,16,41,25,35,15,2,201,118,0
4183,67663,nBG9NwFfkLReYPd7l4XLlLWLMjwV7w8K,SpATywNh6bZuzm8s1ceuBUnMUAeoAHHw,5,11,6,0,3,0,5,0,25,3.5714285714285716,1,0.0,0,6,0,3,11,0,0,5,0,9,16,1
4184,67664,4GEmQt0JA7IFOeI2xvDzq0AMU7AHzUAO,G8EPVSXsOYB5YQWZGiz1aVq5Pgr2GrQu,1,0,0,0,0,0,1,0,1,0.14285714285714285,1,0.0,0,0,0,0,0,0,0,1,0,0,1,1
4185,67665,4GEmQt0JA7IFOeI2xvDzq0AMU7AHzUAO,RXDvfPUBYFlVdlueBFbLW0mhhAyGEqpt,8,8,1,0,1,0,2,0,12,1.7142857142857142,1,0.0,0,1,0,1,8,0,0,2,0,2,10,1
4186,67671,0ghe43x8DU4ZKEP2rwt8HDtWNCmUsBMb,SpATywNh6bZuzm8s1ceuBUnMUAeoAHHw,3,2,1,0,0,0,1,0,4,0.5714285714285714,1,0.0,0,1,0,0,2,0,0,1,0,1,3,1
4187,67676,HYd5rlFFgGK0QJw1jPObfen7RGCCaTWr,SpATywNh6bZuzm8s1ceuBUnMUAeoAHHw,12,19,2,14,0,0,11,0,46,6.571428571428571,2,0.0,6,2,13,0,13,0,1,11,0,21,25,1
4188,67678,5QFY4jhno4lDKDZjex2aoyci3DX1zToG,SpATywNh6bZuzm8s1ceuBUnMUAeoAHHw,6,3,1,0,1,0,2,0,7,1.0,1,0.0,0,1,0,1,3,0,0,2,0,2,5,1
4189,67679,MSP7eDamCCVYhdl4Hb4ah8yrT6phuW5z,SpATywNh6bZuzm8s1ceuBUnMUAeoAHHw,1,0,0,0,0,0,1,0,1,0.14285714285714285,1,0.0,0,0,0,0,0,0,0,1,0,0,1,1
4190,67682,UgNxeSUTyiiwvKUEwlvxMdHu83PhXRUn,G8EPVSXsOYB5YQWZGiz1aVq5Pgr2GrQu,5,6,1,0,0,0,2,0,9,1.2857142857142858,1,0.0,0,1,0,0,6,0,0,2,0,1,8,1
4191,67684,dQggCBdg5KVSltApPCgVZB7TTUQzzzoI,bWdj2GDclj5ofokWjzoa5jAwMkxCykd6,1,0,0,0,0,0,3,0,3,0.42857142857142855,2,0.0,0,0,0,0,0,0,0,3,0,0,3,1
4192,67685,fZeg9HEKP8oNI2LkglD6L1BrnS7HGXVv,SpATywNh6bZuzm8s1ceuBUnMUAeoAHHw,1,0,0,0,0,0,1,0,1,0.14285714285714285,1,0.0,0,0,0,0,0,0,0,1,0,0,1,1
4193,67686,eWYR1r7NLXWhx2IMzSgNL5MgIoGDCoNF,G8EPVSXsOYB5YQWZGiz1aVq5Pgr2GrQu,8,3,2,0,2,0,7,0,14,2.0,2,0.0,1,2,0,2,2,0,0,7,0,5,9,1
4194,67688,Bi4hHmeTLwTbUCScu9tC6ZZN7frLUhVP,RXDvfPUBYFlVdlueBFbLW0mhhAyGEqpt,8,7,3,0,1,0,4,0,15,2.142857142857143,2,0.0,0,3,0,1,7,0,0,4,0,4,11,1
4195,67690,nPRsjektHdbQkeAf1fIK4JbhrESPbPsA,G8EPVSXsOYB5YQWZGiz1aVq5Pgr2GrQu,3,2,0,0,0,0,1,0,3,0.42857142857142855,1,0.0,0,0,0,0,2,0,0,1,0,0,3,0
4196,67692,EVc4qUhPkP7UL5sL9o4Nn0zqfNCNBtZE,SpATywNh6bZuzm8s1ceuBUnMUAeoAHHw,5,5,1,0,0,0,1,0,7,1.0,1,0.0,0,1,0,0,5,0,0,1,0,1,6,1
4197,67701,4TWfM9na19lYGzUwRed2aAXURJ78KWCP,RXDvfPUBYFlVdlueBFbLW0mhhAyGEqpt,12,13,10,0,4,0,8,11,46,6.571428571428571,1,0.0,0,10,0,4,13,0,0,8,11,14,32,1
4198,67710,zDAtaSKsAJQmmJ6xHQBbAGN68vDebyev,SpATywNh6bZuzm8s1ceuBUnMUAeoAHHw,13,11,6,12,2,0,3,0,34,4.857142857142857,2,0.0,3,6,12,2,8,0,0,3,0,23,11,0
4199,67716,wuUYknrhhK9A1rfWPXYwIaIGT1vO8QhA,SpATywNh6bZuzm8s1ceuBUnMUAeoAHHw,9,12,1,12,0,1,2,0,28,4.0,2,0.0,7,1,12,0,5,1,0,2,0,20,8,1
4200,67717,qO8ml6g9ZeMxls7C74RxeVjl6mVWAz7I,RXDvfPUBYFlVdlueBFbLW0mhhAyGEqpt,13,9,0,21,1,0,5,0,36,5.142857142857143,2,0.0,5,0,21,1,4,0,0,5,0,27,9,1
4201,67722,vVABuHEl55FNtayFertBjV9CA1b1uUqW,SpATywNh6bZuzm8s1ceuBUnMUAeoAHHw,14,44,10,23,3,9,4,0,93,13.285714285714286,3,0.0,29,10,18,3,15,9,5,4,0,60,33,1
4202,67726,R2bf9dlDhtEUgfKzXR1GPBa12LhUfZ8W,bWdj2GDclj5ofokWjzoa5jAwMkxCykd6,8,7,2,28,2,1,3,0,43,6.142857142857143,1,0.0,3,2,28,2,4,1,0,3,0,35,8,1
4203,67736,SBdAO3sKpqSlgeWybSBaDHqROjoMpn5T,SpATywNh6bZuzm8s1ceuBUnMUAeoAHHw,8,6,4,0,3,0,2,0,15,2.142857142857143,1,0.0,1,4,0,3,5,0,0,2,0,8,7,1
4204,67737,NcqjzYwttpnmK16DHJYLwVOs33NDqK5j,bWdj2GDclj5ofokWjzoa5jAwMkxCykd6,5,5,3,0,3,0,3,0,14,2.0,2,0.0,0,3,0,3,5,0,0,3,0,6,8,1
4205,67738,7MNV6BxCJmXmzQulnH88qjtXkhlV5cJV,SpATywNh6bZuzm8s1ceuBUnMUAeoAHHw,1,0,0,0,0,0,2,0,2,0.2857142857142857,1,0.0,0,0,0,0,0,0,0,2,0,0,2,1
4206,67747,tV7GilNH4qERxqQG9yXRbyo0vWdEfCmA,bWdj2GDclj5ofokWjzoa5jAwMkxCykd6,2,0,0,0,0,0,2,0,2,0.2857142857142857,1,0.0,0,0,0,0,0,0,0,2,0,0,2,1
4207,67759,51ihx2Bl0VB10raEriHBNStktgNYyJiR,bWdj2GDclj5ofokWjzoa5jAwMkxCykd6,5,0,0,0,0,1,4,1,6,0.8571428571428571,1,0.0,0,0,0,0,0,1,0,4,1,0,6,1
4208,67761,vLffmcT3S49L5a1tJO8Q4Q4dkiJJ7J44,RXDvfPUBYFlVdlueBFbLW0mhhAyGEqpt,6,7,2,0,1,0,2,0,12,1.7142857142857142,1,0.0,3,2,0,1,4,0,0,2,0,6,6,1
4209,67779,bYYoAejjFfWzrfKZwav40GCs4SuO1jAC,SpATywNh6bZuzm8s1ceuBUnMUAeoAHHw,7,2,1,0,1,2,10,1,17,2.4285714285714284,1,0.0,0,1,0,1,2,2,0,10,1,2,15,1
4210,67781,bavq9pAJWJ3ks5oNWHTGf2k9koDwXsAH,RXDvfPUBYFlVdlueBFbLW0mhhAyGEqpt,14,17,12,0,4,2,6,0,41,5.857142857142857,4,0.0,0,12,0,4,17,2,0,6,0,16,25,1
4211,67793,Q97rHk1i5w2LHTlLAzCat2tEB4ZGa9hz,SpATywNh6bZuzm8s1ceuBUnMUAeoAHHw,11,8,5,0,3,1,6,0,23,3.2857142857142856,1,0.0,0,5,0,3,8,1,0,6,0,8,15,1
4212,67796,X2XXZYuDF6JxTO2GjiNfzkEyj4FQesn5,SpATywNh6bZuzm8s1ceuBUnMUAeoAHHw,17,39,9,30,4,28,17,2,129,18.428571428571427,3,0.0,22,9,25,4,17,28,5,17,2,60,69,0
4213,67797,BDbaeDrifYAc4onT7CTIZiQyVNIb3LDx,SpATywNh6bZuzm8s1ceuBUnMUAeoAHHw,1,0,0,0,0,0,1,0,1,0.14285714285714285,1,0.0,0,0,0,0,0,0,0,1,0,0,1,1
4214,67798,Zz1hYW3bIv4cloYkUjUfNR6Tk0kO8ZBM,SpATywNh6bZuzm8s1ceuBUnMUAeoAHHw,13,19,0,12,0,3,19,1,54,7.714285714285714,2,0.0,7,0,12,0,12,3,0,19,1,19,35,1
4215,67803,MVA6iVb95DkbKsEBY1TwCJRFhaq9Spfs,SpATywNh6bZuzm8s1ceuBUnMUAeoAHHw,8,4,3,0,3,0,4,0,14,2.0,1,0.0,0,3,0,3,4,0,0,4,0,6,8,1
4216,67804,A0FFdH0xpvPEedjm7o52yYaFKsMLgpjw,SpATywNh6bZuzm8s1ceuBUnMUAeoAHHw,12,15,1,10,1,8,6,0,41,5.857142857142857,2,0.0,5,1,10,1,10,8,0,6,0,17,24,1
4217,67809,FlsqjVVrWyPYAwe3clQKMsya1OMo4po8,SpATywNh6bZuzm8s1ceuBUnMUAeoAHHw,4,5,1,0,0,0,1,0,7,1.0,1,0.0,2,1,0,0,3,0,0,1,0,3,4,1
4218,67817,CBLeEN4LtKF8I3pqDKXGm8PyJoErUnYX,bWdj2GDclj5ofokWjzoa5jAwMkxCykd6,7,16,6,0,3,6,6,0,37,5.285714285714286,2,0.0,0,6,0,3,16,6,0,6,0,9,28,0
4219,67818,Ve30VVfu3WOSJCl56SL7TQHGBM98BQ3E,bWdj2GDclj5ofokWjzoa5jAwMkxCykd6,2,0,0,0,0,0,2,0,2,0.2857142857142857,1,0.0,0,0,0,0,0,0,0,2,0,0,2,1
4220,67820,opdILbT2IBFIYJvyIT5NXM7ymKeuMTcM,SpATywNh6bZuzm8s1ceuBUnMUAeoAHHw,31,78,48,34,17,47,30,3,257,36.714285714285715,5,0.0,15,48,29,17,63,47,5,30,3,109,148,0
4221,67822,AQTVoGGpVGka0Kb0gVc0xEeMCYW0e1Aj,SpATywNh6bZuzm8s1ceuBUnMUAeoAHHw,12,10,6,0,4,1,3,0,24,3.4285714285714284,1,0.0,2,6,0,4,8,1,0,3,0,12,12,1
4222,67832,Kp7bCEP3w8tCAj2Zcsfolokp8CiYHRrL,SpATywNh6bZuzm8s1ceuBUnMUAeoAHHw,11,10,0,21,0,0,3,0,34,4.857142857142857,1,0.0,4,0,17,0,6,0,4,3,0,21,13,1
4223,67837,FSLduWx3U7kR3IEOy9TPL7q6u3uDMATy,SpATywNh6bZuzm8s1ceuBUnMUAeoAHHw,17,29,15,20,8,7,10,3,92,13.142857142857142,3,0.0,8,15,18,8,21,7,2,10,3,49,43,1
4224,67845,ndNZsN4dzAawDolPqzrjn2BmwgSJmFEf,bWdj2GDclj5ofokWjzoa5jAwMkxCykd6,15,39,4,130,3,23,17,4,220,31.428571428571427,3,0.0,11,4,125,3,28,23,5,17,4,143,77,1
4225,67853,oseHKim5ugRciFh8lXIQ174blllPPfFO,SpATywNh6bZuzm8s1ceuBUnMUAeoAHHw,27,52,23,31,6,19,16,4,151,21.571428571428573,3,0.0,7,23,27,6,45,19,4,16,4,63,88,0
4226,67855,RGHao356rd6STLU5i2lDxhCwgle1rNFw,SpATywNh6bZuzm8s1ceuBUnMUAeoAHHw,13,11,7,0,4,1,7,1,31,4.428571428571429,3,0.0,0,7,0,4,11,1,0,7,1,11,20,1
4227,67867,YJjGstHCH0jRUJlDUc92oNrPq0d0Zijd,SpATywNh6bZuzm8s1ceuBUnMUAeoAHHw,14,17,9,17,6,0,3,0,52,7.428571428571429,2,0.0,4,9,13,6,13,0,4,3,0,32,20,1
4228,67869,Tn3HlTIsOQNqv7r0Cv64haAgTvsZ6b4U,SpATywNh6bZuzm8s1ceuBUnMUAeoAHHw,1,0,0,0,0,0,6,0,6,0.8571428571428571,1,0.0,0,0,0,0,0,0,0,6,0,0,6,1
4229,67875,LacgvIbC5Mx6NWAbh5ZFbP873whAiOPf,SpATywNh6bZuzm8s1ceuBUnMUAeoAHHw,7,5,2,0,2,0,2,0,11,1.5714285714285714,2,0.0,0,2,0,2,5,0,0,2,0,4,7,1
4230,67876,yTPe4A1Cw5qKDjYpFW5H73VItf0UPFbm,SpATywNh6bZuzm8s1ceuBUnMUAeoAHHw,15,28,15,0,4,7,12,1,67,9.571428571428571,5,0.0,3,15,0,4,25,7,0,12,1,22,45,1
4231,67897,yKgKNljfs8EwbfiKqNgGPLaIDdrvaFSp,SpATywNh6bZuzm8s1ceuBUnMUAeoAHHw,14,22,10,17,5,0,8,0,62,8.857142857142858,3,0.0,2,10,15,5,20,0,2,8,0,32,30,0
4232,67898,hs0BkyfSJv3crs4cIvcxkt53zip5FMPg,bWdj2GDclj5ofokWjzoa5jAwMkxCykd6,5,2,1,0,1,0,2,0,6,0.8571428571428571,1,0.0,0,1,0,1,2,0,0,2,0,2,4,1
4233,67899,p3H39E0dwbDTbdLaprpRXUCSVCX0arUc,SpATywNh6bZuzm8s1ceuBUnMUAeoAHHw,8,5,1,0,1,0,3,3,13,1.8571428571428572,1,0.0,0,1,0,1,5,0,0,3,3,2,11,1
4234,67901,8qABUnBBHxxZkfUhEQNUn5NNMSRrqvPC,RXDvfPUBYFlVdlueBFbLW0mhhAyGEqpt,55,46,27,101,0,15,11,1,201,28.714285714285715,3,0.0,11,27,97,0,35,15,4,11,1,135,66,1
4235,67910,uegc4WtztZ9oPCp3WmAu2ymDghX5YdD7,SpATywNh6bZuzm8s1ceuBUnMUAeoAHHw,8,7,4,0,1,0,10,0,22,3.142857142857143,3,0.0,0,4,0,1,7,0,0,10,0,5,17,0
4236,67917,g7pbT2353K6nDyXKA1Zfrr1XqVe2dRBP,SpATywNh6bZuzm8s1ceuBUnMUAeoAHHw,17,57,28,18,16,27,16,2,164,23.428571428571427,3,0.0,10,28,15,16,47,27,3,16,2,69,95,1
4237,67920,gqL1AoJbIkLDCmEi1SGH37fAu1Zdec1f,SpATywNh6bZuzm8s1ceuBUnMUAeoAHHw,8,13,8,0,2,0,9,0,32,4.571428571428571,3,0.0,0,8,0,2,13,0,0,9,0,10,22,0
4238,67926,ndNZsN4dzAawDolPqzrjn2BmwgSJmFEf,SpATywNh6bZuzm8s1ceuBUnMUAeoAHHw,5,2,0,0,0,0,3,0,5,0.7142857142857143,1,0.0,0,0,0,0,2,0,0,3,0,0,5,1
4239,67942,PXSCTSolyT6nzbTsv2Nsca26yVAoeW5q,SpATywNh6bZuzm8s1ceuBUnMUAeoAHHw,24,30,17,8,9,0,12,1,77,11.0,3,0.0,6,17,8,9,24,0,0,12,1,40,37,0
4240,67943,jR4AfVlqsecU2OD2EAAPnmIP3mzjfI1q,bWdj2GDclj5ofokWjzoa5jAwMkxCykd6,5,5,3,0,2,0,5,0,15,2.142857142857143,3,0.0,0,3,0,2,5,0,0,5,0,5,10,1
4241,67947,Ybrpv4FlyuZUoocuO2Icsv1UQ9DeHSQ3,RXDvfPUBYFlVdlueBFbLW0mhhAyGEqpt,17,27,4,6,1,0,6,0,44,6.285714285714286,4,0.0,0,4,5,1,27,0,1,6,0,10,34,1
4242,67952,S7PakAxNjFEw6AvrJnn5uzkFmL6Zaill,SpATywNh6bZuzm8s1ceuBUnMUAeoAHHw,5,2,1,0,1,0,3,0,7,1.0,1,0.0,0,1,0,1,2,0,0,3,0,2,5,1
4243,67955,8Kp5E2we1VVLiWHeVTgDcI33lkyZihaL,SpATywNh6bZuzm8s1ceuBUnMUAeoAHHw,3,2,0,0,0,0,1,0,3,0.42857142857142855,1,0.0,0,0,0,0,2,0,0,1,0,0,3,1
4244,67957,NFziKHIzOwiPmHVTsgIR3hdUWupUP7S5,SpATywNh6bZuzm8s1ceuBUnMUAeoAHHw,6,14,1,0,1,0,2,0,18,2.5714285714285716,3,0.0,0,1,0,1,14,0,0,2,0,2,16,1
4245,67960,up9RsivyokQDdIY9XjceWgPIaWSXiHeb,SpATywNh6bZuzm8s1ceuBUnMUAeoAHHw,17,45,2,12,1,8,10,1,79,11.285714285714286,2,0.0,2,2,10,1,43,8,2,10,1,15,64,1
4246,67961,TauShxFiSmmTBchoFAIoZD1cYw24SbpR,SpATywNh6bZuzm8s1ceuBUnMUAeoAHHw,14,71,3,27,0,11,51,2,165,23.571428571428573,3,0.0,14,3,21,0,57,11,6,51,2,38,127,1
4247,67971,tfoakS3EMOjWuYWNRSgWZTjBxe3Mf9Te,RXDvfPUBYFlVdlueBFbLW0mhhAyGEqpt,1,0,0,0,0,0,1,0,1,0.14285714285714285,1,0.0,0,0,0,0,0,0,0,1,0,0,1,1
4248,67972,6iHCxsm5tJiarmhUscvMMFN1oXgIYfGK,SpATywNh6bZuzm8s1ceuBUnMUAeoAHHw,12,18,1,14,1,14,11,0,59,8.428571428571429,2,0.0,4,1,11,1,14,14,3,11,0,17,42,1
4249,67977,tfoakS3EMOjWuYWNRSgWZTjBxe3Mf9Te,G8EPVSXsOYB5YQWZGiz1aVq5Pgr2GrQu,1,0,0,0,0,0,1,0,1,0.14285714285714285,1,0.0,0,0,0,0,0,0,0,1,0,0,1,1
4250,67978,nI7KHCeuUwYkf0rhfMBOC7e8vy7auq4l,SpATywNh6bZuzm8s1ceuBUnMUAeoAHHw,7,3,2,0,2,0,2,0,9,1.2857142857142858,1,0.0,0,2,0,2,3,0,0,2,0,4,5,1
4251,67982,ILI6Vf7i1QDo4pXG14Vgww7LNrHFRhLg,SpATywNh6bZuzm8s1ceuBUnMUAeoAHHw,7,5,0,4,0,0,6,0,15,2.142857142857143,2,0.0,1,0,3,0,4,0,1,6,0,4,11,1
4252,67988,Qy32fNQVMClwOlmUTHDbimblSTgM9GDa,SpATywNh6bZuzm8s1ceuBUnMUAeoAHHw,4,1,0,0,0,0,4,0,5,0.7142857142857143,1,0.0,0,0,0,0,1,0,0,4,0,0,5,1
4253,67993,HwikiMaD2SSDNPWrHLzCjZX0RDgnndHf,bWdj2GDclj5ofokWjzoa5jAwMkxCykd6,5,4,1,0,1,0,1,0,7,1.0,1,0.0,0,1,0,1,4,0,0,1,0,2,5,0
4254,68002,K0IGGULkNaDBoXYWwyrmeTaxQ3RLMvBE,SpATywNh6bZuzm8s1ceuBUnMUAeoAHHw,8,7,3,0,3,0,1,0,14,2.0,1,0.0,0,3,0,3,7,0,0,1,0,6,8,1
4255,68013,CDy3wblikhG2TGdNI3LhbAglknKqeMeq,RXDvfPUBYFlVdlueBFbLW0mhhAyGEqpt,1,0,0,0,0,0,1,0,1,0.14285714285714285,1,0.0,0,0,0,0,0,0,0,1,0,0,1,0
4256,68017,Ea76prVlgHXbifiTXOy9yoJBa7oRFv41,SpATywNh6bZuzm8s1ceuBUnMUAeoAHHw,17,38,2,17,1,8,8,1,75,10.714285714285714,4,0.0,12,2,14,1,26,8,3,8,1,29,46,1
4257,68019,c4Lb4MH2H2BBD2Eny5diwcURGPUNIr88,G8EPVSXsOYB5YQWZGiz1aVq5Pgr2GrQu,5,13,3,0,5,0,2,0,23,3.2857142857142856,2,0.0,9,3,0,5,4,0,0,2,0,17,6,1
4258,68021,YxdX3NPpzVJ59dpoBODWSD8Noi3lkajj,G8EPVSXsOYB5YQWZGiz1aVq5Pgr2GrQu,86,199,79,232,35,23,25,8,601,85.85714285714286,7,0.0,93,79,163,35,106,23,69,25,8,370,231,0
4259,68042,zHQwuuMF2E73UUayJX1hbmgxSuUBnwou,G8EPVSXsOYB5YQWZGiz1aVq5Pgr2GrQu,30,54,16,58,14,1,13,0,156,22.285714285714285,2,0.0,32,16,41,14,22,1,17,13,0,103,53,0
4260,68049,EBHdi8xR8rUEs7i0QRogmtFZNO8JeTy8,SpATywNh6bZuzm8s1ceuBUnMUAeoAHHw,16,16,7,5,3,2,6,1,40,5.714285714285714,2,0.0,3,7,5,3,13,2,0,6,1,18,22,1
4261,68051,CORJXNhWUR52sdjQNNf8qLspXXnCgswJ,SpATywNh6bZuzm8s1ceuBUnMUAeoAHHw,17,32,7,23,4,9,7,2,84,12.0,2,0.0,16,7,19,4,16,9,4,7,2,46,38,0
4262,68055,EBLsXyMzbHjWnC0OjjqcacEXrmUIJvTs,SpATywNh6bZuzm8s1ceuBUnMUAeoAHHw,5,2,1,0,1,0,2,0,6,0.8571428571428571,1,0.0,0,1,0,1,2,0,0,2,0,2,4,1
4263,68058,8qyr4gmatx7C6lBFbhpf1S75SesVpGhm,SpATywNh6bZuzm8s1ceuBUnMUAeoAHHw,16,28,9,17,5,11,9,1,80,11.428571428571429,2,0.0,13,9,15,5,15,11,2,9,1,42,38,0
4264,68061,Y0xpzPU1KVTtj1ZRV6oETnVQafrG6Rxw,G8EPVSXsOYB5YQWZGiz1aVq5Pgr2GrQu,15,17,10,18,4,0,5,0,54,7.714285714285714,2,0.0,3,10,15,4,14,0,3,5,0,32,22,1
4265,68074,C1sQeK9WfNApOsknFeDtbZSozuem8vKZ,SpATywNh6bZuzm8s1ceuBUnMUAeoAHHw,8,10,2,0,1,0,6,1,20,2.857142857142857,1,0.0,0,2,0,1,10,0,0,6,1,3,17,1
4266,68078,w9Zejjae59IiHj98CiIbluCo9JOahx2s,bWdj2GDclj5ofokWjzoa5jAwMkxCykd6,20,20,10,42,7,3,8,2,92,13.142857142857142,1,0.0,7,10,39,7,13,3,3,8,2,63,29,1
4267,68081,C1sQeK9WfNApOsknFeDtbZSozuem8vKZ,bWdj2GDclj5ofokWjzoa5jAwMkxCykd6,1,0,0,0,0,0,1,0,1,0.14285714285714285,1,0.0,0,0,0,0,0,0,0,1,0,0,1,1
4268,68082,C1sQeK9WfNApOsknFeDtbZSozuem8vKZ,G8EPVSXsOYB5YQWZGiz1aVq5Pgr2GrQu,1,0,0,0,0,0,1,0,1,0.14285714285714285,1,0.0,0,0,0,0,0,0,0,1,0,0,1,1
4269,68087,GlnhykNK42Hk2YDmiiI5XtZaM9QknLVN,SpATywNh6bZuzm8s1ceuBUnMUAeoAHHw,14,56,21,11,0,27,26,4,145,20.714285714285715,2,0.0,22,21,10,0,34,27,1,26,4,53,92,1
4270,68088,GIsRCDxWVYGm4So2chhYPzgj7oVxCsSB,RXDvfPUBYFlVdlueBFbLW0mhhAyGEqpt,12,14,2,0,3,0,4,0,23,3.2857142857142856,3,0.0,0,2,0,3,14,0,0,4,0,5,18,1
4271,68092,gmQzxzrGOrQhncsrBOMeYdsKsXhK53lF,bWdj2GDclj5ofokWjzoa5jAwMkxCykd6,11,10,4,34,3,0,9,0,60,8.571428571428571,1,0.0,1,4,34,3,9,0,0,9,0,42,18,1
4272,68093,GjzhHwDiXF2E87hVW0UoZGkmnIxus0Jb,G8EPVSXsOYB5YQWZGiz1aVq5Pgr2GrQu,2,0,0,0,0,0,2,0,2,0.2857142857142857,1,0.0,0,0,0,0,0,0,0,2,0,0,2,1
4273,68097,YtgrpGciY5emPU7tatGUnxp8LeEpuZ2R,G8EPVSXsOYB5YQWZGiz1aVq5Pgr2GrQu,1,0,0,0,0,0,1,0,1,0.14285714285714285,1,0.0,0,0,0,0,0,0,0,1,0,0,1,1
4274,68099,bf977a2Ekvsg0xEzQOrZjXRWnBKTxo2i,G8EPVSXsOYB5YQWZGiz1aVq5Pgr2GrQu,20,22,16,14,10,1,2,0,65,9.285714285714286,1,0.0,0,16,13,10,22,1,1,2,0,39,26,1
4275,68102,7rvGs1kznZu35xmEOruWRR3N50tl6czz,bWdj2GDclj5ofokWjzoa5jAwMkxCykd6,8,9,1,10,1,0,2,0,23,3.2857142857142856,1,0.0,1,1,9,1,8,0,1,2,0,12,11,1
4276,68104,6ybGGzfjXeEOFmc8PHowGPQhK4ir7keP,SpATywNh6bZuzm8s1ceuBUnMUAeoAHHw,9,5,1,0,1,4,7,1,19,2.7142857142857144,1,0.0,0,1,0,1,5,4,0,7,1,2,17,1
4277,68107,fJGnkdlpDXyGxGQQghKR3BhEMVARR2Lg,SpATywNh6bZuzm8s1ceuBUnMUAeoAHHw,1,0,0,0,0,0,1,0,1,0.14285714285714285,1,0.0,0,0,0,0,0,0,0,1,0,0,1,1
4278,68108,A0dHL3oOosmNf0Of1dLTB9JxNisZL1pv,SpATywNh6bZuzm8s1ceuBUnMUAeoAHHw,8,10,4,0,3,0,8,0,25,3.5714285714285716,2,0.0,1,4,0,3,9,0,0,8,0,8,17,1
4279,68110,aIu8QzWjQFPb4qaDfl0P1tztYuItpL4R,RXDvfPUBYFlVdlueBFbLW0mhhAyGEqpt,39,54,4,100,1,3,18,2,182,26.0,4,0.0,10,4,94,1,44,3,6,18,2,109,73,1
4280,68114,5PtI5arrhi7X94UIlnofTGsT9hPK6ewX,SpATywNh6bZuzm8s1ceuBUnMUAeoAHHw,5,4,3,0,0,0,1,0,8,1.1428571428571428,1,0.0,0,3,0,0,4,0,0,1,0,3,5,1
4281,68118,Z5b3QXG5aJtKMyvjqd5INn7f1wDhqIm4,SpATywNh6bZuzm8s1ceuBUnMUAeoAHHw,10,8,4,0,3,1,5,0,21,3.0,2,0.0,1,4,0,3,7,1,0,5,0,8,13,0
4282,68125,6akze6dlAjqRJRBQfIi4wuyuoFxmW6lS,SpATywNh6bZuzm8s1ceuBUnMUAeoAHHw,9,21,9,0,7,0,12,0,49,7.0,1,0.0,0,9,0,7,21,0,0,12,0,16,33,1
4283,68126,gLWYERddjD0e20XUR43WwbF7uNaF2Pgm,bWdj2GDclj5ofokWjzoa5jAwMkxCykd6,6,17,2,0,4,0,1,0,24,3.4285714285714284,1,0.0,0,2,0,4,17,0,0,1,0,6,18,1
4284,68130,gmQzxzrGOrQhncsrBOMeYdsKsXhK53lF,SpATywNh6bZuzm8s1ceuBUnMUAeoAHHw,1,0,0,0,0,0,1,0,1,0.14285714285714285,1,0.0,0,0,0,0,0,0,0,1,0,0,1,1
4285,68133,2NZH8U3WrlujDhhhOcDdw5QM9Su6Hvdq,SpATywNh6bZuzm8s1ceuBUnMUAeoAHHw,12,21,4,14,3,8,2,0,52,7.428571428571429,1,0.0,16,4,13,3,5,8,1,2,0,36,16,1
4286,68138,TnMuPtEYCG1UP1JnaDUM0auIBTc6VjvH,SpATywNh6bZuzm8s1ceuBUnMUAeoAHHw,4,2,0,0,0,0,5,0,7,1.0,1,0.0,0,0,0,0,2,0,0,5,0,0,7,0
4287,68142,78gf8prmiaXO1waYCeS1MI82L5gA5cph,SpATywNh6bZuzm8s1ceuBUnMUAeoAHHw,8,12,3,0,1,5,4,1,26,3.7142857142857144,1,0.0,0,3,0,1,12,5,0,4,1,4,22,1
4288,68155,GlnhykNK42Hk2YDmiiI5XtZaM9QknLVN,G8EPVSXsOYB5YQWZGiz1aVq5Pgr2GrQu,18,35,29,78,11,3,10,0,166,23.714285714285715,2,0.0,2,29,76,11,33,3,2,10,0,118,48,1
4289,68157,WHlJuYfhW4fQXvIRdAMxkZtYXebgfAZs,SpATywNh6bZuzm8s1ceuBUnMUAeoAHHw,7,4,3,0,3,0,2,0,12,1.7142857142857142,1,0.0,0,3,0,3,4,0,0,2,0,6,6,1
4290,68158,ZDEv7xdHlbONQGNdkwzMgbMsJFIzjdrJ,RXDvfPUBYFlVdlueBFbLW0mhhAyGEqpt,17,41,1,16,3,13,11,5,90,12.857142857142858,2,0.0,16,1,13,3,25,13,3,11,5,33,57,1
4291,68159,8PUTYY5GxR5hJrTB9VGuf6OwgmQYLlz6,SpATywNh6bZuzm8s1ceuBUnMUAeoAHHw,17,30,10,18,3,2,14,0,77,11.0,5,0.0,15,10,16,3,15,2,2,14,0,44,33,1
4292,68163,E7q8xgbm4JOITPhixAXraRklJYYNgqh3,SpATywNh6bZuzm8s1ceuBUnMUAeoAHHw,1,0,0,0,0,0,1,0,1,0.14285714285714285,1,0.0,0,0,0,0,0,0,0,1,0,0,1,1
4293,68165,c011xwxkscfGfFvLGjK44gLGvqvYHhED,SpATywNh6bZuzm8s1ceuBUnMUAeoAHHw,13,17,8,3,3,0,10,0,41,5.857142857142857,2,0.0,2,8,3,3,15,0,0,10,0,16,25,1
4294,68175,WAqLnSQyhRD0PYZmBqQYHPqSLjTTUH6O,SpATywNh6bZuzm8s1ceuBUnMUAeoAHHw,15,34,13,18,8,0,7,3,83,11.857142857142858,3,0.0,3,13,16,8,31,0,2,7,3,40,43,1
4295,68181,wCP7MM6FfvdZx8uOqp7AG8m1oFJcqLHB,SpATywNh6bZuzm8s1ceuBUnMUAeoAHHw,22,50,26,12,11,26,30,3,158,22.571428571428573,5,0.0,16,26,9,11,34,26,3,30,3,62,96,1
4296,68182,U8vo2wOZC3Q8EW1kIl6iwoIzgmQUZ4u1,SpATywNh6bZuzm8s1ceuBUnMUAeoAHHw,3,0,0,0,0,2,2,0,4,0.5714285714285714,1,0.0,0,0,0,0,0,2,0,2,0,0,4,1
4297,68191,hkTx4XunczsnVq4H9eVYRZURkkofvB6I,SpATywNh6bZuzm8s1ceuBUnMUAeoAHHw,8,6,3,2,2,0,1,0,14,2.0,1,0.0,0,3,2,2,6,0,0,1,0,7,7,1
4298,68194,3F9rh0xtO3MPjBfGcFPCm9PRbwYuY4I3,SpATywNh6bZuzm8s1ceuBUnMUAeoAHHw,19,39,3,21,1,2,14,1,81,11.571428571428571,7,0.0,7,3,17,1,32,2,4,14,1,28,53,1
4299,68195,PUFh3BsQaDVIJMDvwsFTqkrgAzvjO9ME,bWdj2GDclj5ofokWjzoa5jAwMkxCykd6,3,2,1,0,0,0,1,0,4,0.5714285714285714,1,0.0,0,1,0,0,2,0,0,1,0,1,3,1
4300,68203,6U8VFnPyZYhBRDbe5XdPXo17gTSrU7h6,bWdj2GDclj5ofokWjzoa5jAwMkxCykd6,10,11,7,0,2,10,8,1,39,5.571428571428571,3,0.0,0,7,0,2,11,10,0,8,1,9,30,1
4301,68205,XRUycqJgK6Teg1VieyLPSxgajklcF856,SpATywNh6bZuzm8s1ceuBUnMUAeoAHHw,8,7,1,0,0,5,4,1,18,2.5714285714285716,1,0.0,2,1,0,0,5,5,0,4,1,3,15,0
4302,68206,XZ83JcONkALUi8eW1z8sh8GNkNHnCecC,SpATywNh6bZuzm8s1ceuBUnMUAeoAHHw,17,26,11,25,3,11,11,3,90,12.857142857142858,2,0.0,12,11,19,3,14,11,6,11,3,45,45,1
4303,68208,j4u6F4qZpPKGLDItX0Q2HAWM10zHBR79,SpATywNh6bZuzm8s1ceuBUnMUAeoAHHw,13,19,8,11,3,0,2,0,43,6.142857142857143,1,0.0,7,8,11,3,12,0,0,2,0,29,14,1
4304,68210,6A7JcBAaCtlmyXJds1FDIeGlm0ezPnc3,SpATywNh6bZuzm8s1ceuBUnMUAeoAHHw,12,13,1,17,1,0,4,0,36,5.142857142857143,1,0.0,8,1,16,1,5,0,1,4,0,26,10,1
4305,68212,1fxFMFifV1rQ9EWjOwHxBWikLCyhcjXV,SpATywNh6bZuzm8s1ceuBUnMUAeoAHHw,7,15,1,8,0,0,1,0,25,3.5714285714285716,1,0.0,0,1,6,0,15,0,2,1,0,7,18,1
4306,68222,WnGoJ0X05nmmcr9OBuNGFmD5r4EVF1g6,bWdj2GDclj5ofokWjzoa5jAwMkxCykd6,12,24,13,0,5,34,20,4,100,14.285714285714286,4,0.0,0,13,0,5,24,34,0,20,4,18,82,1
4307,68230,82GMCFQFd0THTrsyKfVm7WvJIFvIx6zJ,bWdj2GDclj5ofokWjzoa5jAwMkxCykd6,1,0,0,0,0,0,1,0,1,0.14285714285714285,1,0.0,0,0,0,0,0,0,0,1,0,0,1,1
4308,68234,CR4gghlbM9RsvrMmN4aq9I8yiSZncbD8,SpATywNh6bZuzm8s1ceuBUnMUAeoAHHw,15,16,7,10,3,0,6,0,42,6.0,2,0.0,7,7,10,3,9,0,0,6,0,27,15,0
4309,68239,ZGeJlcog0o13nhqeKC2vRvkt6LFvOzyP,SpATywNh6bZuzm8s1ceuBUnMUAeoAHHw,1,0,0,0,0,0,1,0,1,0.14285714285714285,1,0.0,0,0,0,0,0,0,0,1,0,0,1,1
4310,68240,IZwgoYiQOwzeEoIsJbmj0ULJBVLQ8tDo,SpATywNh6bZuzm8s1ceuBUnMUAeoAHHw,6,3,2,0,2,0,1,0,8,1.1428571428571428,1,0.0,0,2,0,2,3,0,0,1,0,4,4,0
4311,68241,i2PPXz5Z5PB2ZfiVAI64TcWxYgJR1QQ1,RXDvfPUBYFlVdlueBFbLW0mhhAyGEqpt,16,16,10,0,5,1,6,0,38,5.428571428571429,3,0.0,0,10,0,5,16,1,0,6,0,15,23,1
4312,68242,zQ0WfWm1cz6xtKNF9R3KOD2OW4OSAkc1,SpATywNh6bZuzm8s1ceuBUnMUAeoAHHw,11,7,6,6,0,0,5,0,24,3.4285714285714284,2,0.0,0,6,5,0,7,0,1,5,0,11,13,1
4313,68248,difzQoAVFjIhhoeyJCnFHhQfdluM0dbZ,G8EPVSXsOYB5YQWZGiz1aVq5Pgr2GrQu,1,0,0,0,0,0,1,0,1,0.14285714285714285,1,0.0,0,0,0,0,0,0,0,1,0,0,1,1
4314,68250,bNThALRhT3LNXximO1paliuB0aPzkqk7,SpATywNh6bZuzm8s1ceuBUnMUAeoAHHw,17,15,7,25,4,47,15,3,116,16.571428571428573,2,0.0,6,7,21,4,9,47,4,15,3,38,78,1
4315,68251,Hy6j11K745hIL1HizKPEi5wjs7F2sOsG,SpATywNh6bZuzm8s1ceuBUnMUAeoAHHw,5,3,1,0,1,0,4,0,9,1.2857142857142858,1,0.0,0,1,0,1,3,0,0,4,0,2,7,1
4316,68252,5N9UtpTd0Iyfm1Amzky3t1R9JrMPidgw,SpATywNh6bZuzm8s1ceuBUnMUAeoAHHw,15,28,8,24,7,0,13,1,81,11.571428571428571,2,0.0,14,8,17,7,14,0,7,13,1,46,35,0
4317,68258,oL1G89Phk4nduULmJ17br7A4xddcHdc4,RXDvfPUBYFlVdlueBFbLW0mhhAyGEqpt,13,14,7,0,3,6,11,1,42,6.0,4,0.0,1,7,0,3,13,6,0,11,1,11,31,0
4318,68262,jwmMikqyMlJ3SzOUjqLjM22mCL5p25A7,SpATywNh6bZuzm8s1ceuBUnMUAeoAHHw,5,3,1,0,1,0,4,0,9,1.2857142857142858,1,0.0,1,1,0,1,2,0,0,4,0,3,6,1
4319,68263,pbaQcU38LWlEY15kC2Yb0jdLNtMAYhsA,SpATywNh6bZuzm8s1ceuBUnMUAeoAHHw,19,50,25,16,9,0,10,0,110,15.714285714285714,6,0.0,14,25,13,9,36,0,3,10,0,61,49,0
4320,68268,jwN9sgXwQLE8sD1F25K97DLtEDZ0gnxi,SpATywNh6bZuzm8s1ceuBUnMUAeoAHHw,1,0,0,0,0,0,1,0,1,0.14285714285714285,1,0.0,0,0,0,0,0,0,0,1,0,0,1,1
4321,68273,1qOWHE2SxHYAOzNCTuiHl1kSZUHL0gyU,SpATywNh6bZuzm8s1ceuBUnMUAeoAHHw,30,108,43,25,19,16,53,6,270,38.57142857142857,4,0.0,27,43,19,19,81,16,6,53,6,108,162,0
4322,68275,RWU4omSsfIhWMdUidy2dDc2hADqC6J7F,RXDvfPUBYFlVdlueBFbLW0mhhAyGEqpt,1,0,0,0,0,0,1,0,1,0.14285714285714285,1,0.0,0,0,0,0,0,0,0,1,0,0,1,1
4323,68279,S5r0CKOxIwwZ6o4r0E3DEfNq3HUydzP8,SpATywNh6bZuzm8s1ceuBUnMUAeoAHHw,10,11,9,0,7,0,2,0,29,4.142857142857143,1,0.0,0,9,0,7,11,0,0,2,0,16,13,1
4324,68280,0iBsrOe2KnLxk8TGZ7ugYIrItWDyZcX5,bWdj2GDclj5ofokWjzoa5jAwMkxCykd6,1,0,0,0,0,0,1,0,1,0.14285714285714285,1,0.0,0,0,0,0,0,0,0,1,0,0,1,1
4325,68296,b1g4AWG6A2zG5plnQY4paLSHRFnrgObC,G8EPVSXsOYB5YQWZGiz1aVq5Pgr2GrQu,6,16,6,0,2,0,23,0,47,6.714285714285714,4,0.0,0,6,0,2,16,0,0,23,0,8,39,1
4326,68299,MzTmeAugUJkvlIkD1VbUcP5NYDEco9Sz,bWdj2GDclj5ofokWjzoa5jAwMkxCykd6,12,9,3,54,3,0,1,0,70,10.0,1,0.0,5,3,51,3,4,0,3,1,0,62,8,1
4327,68305,1Z4DcQGB0iHwU6wAGYAE4UwCDJhJoWI1,SpATywNh6bZuzm8s1ceuBUnMUAeoAHHw,5,2,1,0,1,0,4,0,8,1.1428571428571428,1,0.0,0,1,0,1,2,0,0,4,0,2,6,0
4328,68312,FmmzXResih4xmTvS1USR90U6hsc9smA9,RXDvfPUBYFlVdlueBFbLW0mhhAyGEqpt,6,10,3,0,3,0,1,0,17,2.4285714285714284,2,0.0,0,3,0,3,10,0,0,1,0,6,11,1
4329,68316,FocgTK7ZKP5rXdprEvR0U5yJcvk72CbF,SpATywNh6bZuzm8s1ceuBUnMUAeoAHHw,11,14,6,10,0,9,7,0,46,6.571428571428571,2,0.0,7,6,8,0,7,9,2,7,0,21,25,1
4330,68318,g3PG76pcZjQr6VJ2OlBuhnEf9tLvgXf4,SpATywNh6bZuzm8s1ceuBUnMUAeoAHHw,4,2,1,0,1,0,1,0,5,0.7142857142857143,1,0.0,0,1,0,1,2,0,0,1,0,2,3,1
4331,68321,AOjgDe9pflTNYpkfyCGVCxzTomGLrXC9,G8EPVSXsOYB5YQWZGiz1aVq5Pgr2GrQu,9,7,3,0,2,3,15,1,31,4.428571428571429,1,0.0,2,3,0,2,5,3,0,15,1,7,24,1
4332,68324,VwIVGF64yzO60dfdnqn1D6KZSjw1xNvm,bWdj2GDclj5ofokWjzoa5jAwMkxCykd6,6,19,2,0,1,0,5,0,27,3.857142857142857,3,0.0,0,2,0,1,19,0,0,5,0,3,24,1
4333,68332,hJo1MgKiPZFXuH2ko6hqPTd9dbjMQKDO,SpATywNh6bZuzm8s1ceuBUnMUAeoAHHw,8,16,9,0,4,0,4,0,33,4.714285714285714,4,0.0,2,9,0,4,14,0,0,4,0,15,18,0
4334,68333,8DBF0kTYvtu7h0hsdxFO3EFrNNkmUkiM,SpATywNh6bZuzm8s1ceuBUnMUAeoAHHw,16,17,5,14,3,11,7,0,57,8.142857142857142,2,0.0,10,5,14,3,7,11,0,7,0,32,25,1
4335,68345,SnyeeNQTfkqzknIlQQLm06X1xA6g9a0l,SpATywNh6bZuzm8s1ceuBUnMUAeoAHHw,16,29,9,19,8,12,9,1,87,12.428571428571429,2,0.0,9,9,16,8,20,12,3,9,1,42,45,1
4336,68349,iADE6TgYebHG0th9GrbiEmbQ3Qc3Go8z,RXDvfPUBYFlVdlueBFbLW0mhhAyGEqpt,6,1,1,0,1,0,4,1,8,1.1428571428571428,2,0.0,0,1,0,1,1,0,0,4,1,2,6,1
4337,68351,QkN5nvBbZszJiSQ2f66kudMZ2eWWY8sa,RXDvfPUBYFlVdlueBFbLW0mhhAyGEqpt,6,4,3,0,1,0,1,0,9,1.2857142857142858,1,0.0,0,3,0,1,4,0,0,1,0,4,5,1
4338,68352,clbUGnOQsN7CuaV7idGJ2LVbYN3t8qC3,SpATywNh6bZuzm8s1ceuBUnMUAeoAHHw,15,30,13,10,5,17,8,1,84,12.0,4,0.0,3,13,9,5,27,17,1,8,1,30,54,0
4339,68357,uxWS9amhXxmjOvqXmZExJSg0LcMFBAvq,G8EPVSXsOYB5YQWZGiz1aVq5Pgr2GrQu,7,3,2,0,1,0,6,0,12,1.7142857142857142,2,0.0,0,2,0,1,3,0,0,6,0,3,9,1
4340,68360,4pJW5s4UUKXpxe6ChNDK23aeXIukgMH8,SpATywNh6bZuzm8s1ceuBUnMUAeoAHHw,16,17,6,17,4,17,10,1,72,10.285714285714286,1,0.0,3,6,14,4,14,17,3,10,1,27,45,1
4341,68362,tlaj4fnwxWl22MIDqzqpAu1L2vA1lQmh,bWdj2GDclj5ofokWjzoa5jAwMkxCykd6,12,23,14,16,7,10,8,1,79,11.285714285714286,4,0.0,3,14,15,7,20,10,1,8,1,39,40,1
4342,68363,0F1DhnfuH8hFtOjZ8dWmoNBQat6tI7Te,SpATywNh6bZuzm8s1ceuBUnMUAeoAHHw,5,2,1,0,1,0,2,1,7,1.0,1,0.0,0,1,0,1,2,0,0,2,1,2,5,1
4343,68364,2FyRSMemMx0WQNXDNdLObUL8ox2VWXod,SpATywNh6bZuzm8s1ceuBUnMUAeoAHHw,29,67,34,35,19,9,15,0,179,25.571428571428573,8,0.0,10,34,31,19,57,9,4,15,0,94,85,1
4344,68365,SG7hB83Yya2DA2E0NTjAVNa4uzxtdA6s,SpATywNh6bZuzm8s1ceuBUnMUAeoAHHw,9,9,2,0,0,2,6,1,20,2.857142857142857,1,0.0,0,2,0,0,9,2,0,6,1,2,18,1
4345,68371,xBU5Obte2st2JNuH81iN4TihJEa7jvrL,SpATywNh6bZuzm8s1ceuBUnMUAeoAHHw,1,0,0,0,0,0,2,0,2,0.2857142857142857,1,0.0,0,0,0,0,0,0,0,2,0,0,2,1
4346,68379,b4M5OphEGf9HhlcR04bazUL6wKV8uIkU,G8EPVSXsOYB5YQWZGiz1aVq5Pgr2GrQu,49,96,3,102,5,69,17,10,302,43.142857142857146,6,0.0,21,3,81,5,75,69,21,17,10,110,192,1
4347,68388,R2V0izPrSC9aiv4wxr7ZUbqHHqyQkLxw,bWdj2GDclj5ofokWjzoa5jAwMkxCykd6,4,2,1,0,1,0,1,0,5,0.7142857142857143,1,0.0,0,1,0,1,2,0,0,1,0,2,3,1
4348,68395,lTZusowYpBCkpVlkG3X20kNgU6aMOOBS,SpATywNh6bZuzm8s1ceuBUnMUAeoAHHw,17,18,7,18,3,3,15,1,65,9.285714285714286,3,0.0,8,7,15,3,10,3,3,15,1,33,32,1
4349,68397,td9JVyRGLfbXKWE7ys0aQ9IRUtJd97NP,bWdj2GDclj5ofokWjzoa5jAwMkxCykd6,5,2,1,0,1,0,3,0,7,1.0,1,0.0,0,1,0,1,2,0,0,3,0,2,5,1
4350,68398,LNdimqsJkOxQDP9dT4IGwewg9YvH7zfV,SpATywNh6bZuzm8s1ceuBUnMUAeoAHHw,15,30,16,6,5,8,4,0,69,9.857142857142858,3,0.0,9,16,6,5,21,8,0,4,0,36,33,1
4351,68399,TTmbjhCeX7YmnFUettVVam4HwYq17paa,SpATywNh6bZuzm8s1ceuBUnMUAeoAHHw,3,3,0,0,0,0,2,0,5,0.7142857142857143,1,0.0,0,0,0,0,3,0,0,2,0,0,5,0
4352,68406,fWzpIAl5AhTFdJeUPdzJHspdUzMjFUYM,bWdj2GDclj5ofokWjzoa5jAwMkxCykd6,5,3,2,0,1,0,5,0,11,1.5714285714285714,2,0.0,0,2,0,1,3,0,0,5,0,3,8,1
4353,68411,4vxCaGfGDr7qH4ipzhuoVimWrYG1kGYQ,bWdj2GDclj5ofokWjzoa5jAwMkxCykd6,17,47,22,58,6,52,43,4,232,33.142857142857146,4,0.0,3,22,49,6,44,52,9,43,4,80,152,1
4354,68412,0KxBv7TNEUj27dsp2zMGG4WpBswpgOyf,SpATywNh6bZuzm8s1ceuBUnMUAeoAHHw,9,16,10,5,2,0,7,0,40,5.714285714285714,4,0.0,0,10,5,2,16,0,0,7,0,17,23,0
4355,68423,bET2Moo4lPgmSBI2ZHgAloQD25b1Jinn,G8EPVSXsOYB5YQWZGiz1aVq5Pgr2GrQu,17,18,8,30,4,0,3,0,63,9.0,3,0.0,0,8,28,4,18,0,2,3,0,40,23,1
4356,68424,7XeEjaT7Rw76VaeBef1jnkEycygog40I,SpATywNh6bZuzm8s1ceuBUnMUAeoAHHw,9,16,8,0,7,0,2,0,33,4.714285714285714,1,0.0,2,8,0,7,14,0,0,2,0,17,16,1
4357,68426,4a1LmrNqPaRbQL0Q68aycdhtteXqXTMU,SpATywNh6bZuzm8s1ceuBUnMUAeoAHHw,5,2,1,0,1,0,2,0,6,0.8571428571428571,1,0.0,0,1,0,1,2,0,0,2,0,2,4,1
4358,68435,dYES117kkj3IhCPWFa9k6hhXgoc7YknJ,G8EPVSXsOYB5YQWZGiz1aVq5Pgr2GrQu,8,4,1,0,0,6,6,1,18,2.5714285714285716,1,0.0,0,1,0,0,4,6,0,6,1,1,17,1
4359,68438,nnZGKhMV6zkzSC8Qzeh7UPQIZVHpp5uX,bWdj2GDclj5ofokWjzoa5jAwMkxCykd6,1,0,0,0,0,0,1,0,1,0.14285714285714285,1,0.0,0,0,0,0,0,0,0,1,0,0,1,1
4360,68439,6H5tZYvQXUXA5x38gvAZ0WgqLjIkqn3b,SpATywNh6bZuzm8s1ceuBUnMUAeoAHHw,8,5,2,0,2,0,3,0,12,1.7142857142857142,2,0.0,0,2,0,2,5,0,0,3,0,4,8,1
4361,68442,v8CV9SymhVbpaH5nH9XVMeR4jjsMeKhG,G8EPVSXsOYB5YQWZGiz1aVq5Pgr2GrQu,15,5,4,20,3,0,2,0,34,4.857142857142857,1,0.0,0,4,17,3,5,0,3,2,0,24,10,1
4362,68455,HzaFh1I0rWfjYqs3kd2mhXywhDrDBNWZ,bWdj2GDclj5ofokWjzoa5jAwMkxCykd6,8,17,5,0,2,3,9,1,37,5.285714285714286,3,0.0,2,5,0,2,15,3,0,9,1,9,28,1
4363,68463,CJyFZrp4dFxNPWh98LYOwXSivShmskBg,SpATywNh6bZuzm8s1ceuBUnMUAeoAHHw,7,3,2,0,2,0,2,0,9,1.2857142857142858,1,0.0,0,2,0,2,3,0,0,2,0,4,5,1
4364,68467,4VUauTz2C9X4SCHk8ugs49B1paCitpmU,G8EPVSXsOYB5YQWZGiz1aVq5Pgr2GrQu,22,14,13,42,5,1,12,1,88,12.571428571428571,1,0.0,0,13,37,5,14,1,5,12,1,55,33,1
4365,68475,FCvIa0IivvqNa6modx0mbEXg1jcpQzBN,SpATywNh6bZuzm8s1ceuBUnMUAeoAHHw,1,0,0,0,0,0,1,0,1,0.14285714285714285,1,0.0,0,0,0,0,0,0,0,1,0,0,1,1
4366,68483,b3xaxczfVryBkeC1YPbXWEZUleYIZAnq,bWdj2GDclj5ofokWjzoa5jAwMkxCykd6,7,5,4,0,2,0,5,0,16,2.2857142857142856,2,0.0,1,4,0,2,4,0,0,5,0,7,9,1
4367,68485,v6euctfbzWthWyLBlYjaRzf7ryZssgjA,bWdj2GDclj5ofokWjzoa5jAwMkxCykd6,1,0,0,0,0,0,1,0,1,0.14285714285714285,1,0.0,0,0,0,0,0,0,0,1,0,0,1,1
4368,68494,yvCmfQ3z3fMLbjXX0h1AIIPVh4np9hhq,SpATywNh6bZuzm8s1ceuBUnMUAeoAHHw,27,46,24,40,10,6,17,1,144,20.571428571428573,5,0.0,13,24,35,10,33,6,5,17,1,82,62,0
4369,68496,SI82MK5h5zRoUuXAAtKY5ltobDSBBXh9,bWdj2GDclj5ofokWjzoa5jAwMkxCykd6,21,32,16,132,9,0,10,1,200,28.571428571428573,2,0.0,10,16,128,9,22,0,4,10,1,163,37,1
4370,68500,IhUEedXCjE6LoKReKNbXGS4Fqk4t4GUl,SpATywNh6bZuzm8s1ceuBUnMUAeoAHHw,7,5,1,0,1,0,3,0,10,1.4285714285714286,1,0.0,0,1,0,1,5,0,0,3,0,2,8,1
4371,68509,hkI32MAgHvJ4T3I3Up79daEJ8l4sKHaC,bWdj2GDclj5ofokWjzoa5jAwMkxCykd6,20,26,12,156,11,29,9,1,244,34.857142857142854,3,0.0,9,12,146,11,17,29,10,9,1,178,66,1
4372,68511,Q9VYSqOD2rxffT9mHJg8GtdPL5OsLSDn,G8EPVSXsOYB5YQWZGiz1aVq5Pgr2GrQu,5,2,1,0,1,0,3,0,7,1.0,1,0.0,0,1,0,1,2,0,0,3,0,2,5,1
4373,68513,PRgLfGkxJHP58QbJdXg5l5vWjuJI88nv,SpATywNh6bZuzm8s1ceuBUnMUAeoAHHw,16,15,7,12,4,15,7,0,60,8.571428571428571,3,0.0,5,7,9,4,10,15,3,7,0,25,35,1
4374,68516,6oCDtYWE1YbVTX7pVBS5Cflb4KyRNNI9,SpATywNh6bZuzm8s1ceuBUnMUAeoAHHw,1,0,0,0,0,0,1,0,1,0.14285714285714285,1,0.0,0,0,0,0,0,0,0,1,0,0,1,1
4375,68521,iSIDy53M1GeZpXt46JkUT1CVMnifiRBT,bWdj2GDclj5ofokWjzoa5jAwMkxCykd6,6,4,1,0,1,1,3,1,11,1.5714285714285714,2,0.0,0,1,0,1,4,1,0,3,1,2,9,1
4376,68543,kS5Tu2RHO9HzXMOZp3CUIdzW6Y8prRRh,SpATywNh6bZuzm8s1ceuBUnMUAeoAHHw,14,23,0,20,0,12,9,1,65,9.285714285714286,3,0.0,9,0,16,0,14,12,4,9,1,25,40,1
4377,68544,neZ18tPUzdX2s40f6yVBysxDUKCDyzmG,SpATywNh6bZuzm8s1ceuBUnMUAeoAHHw,10,14,1,13,1,0,2,0,31,4.428571428571429,1,0.0,10,1,12,1,4,0,1,2,0,24,7,0
4378,68551,NfUq1iJeG4DoVU66A3eQnbdSJYCM4IOC,SpATywNh6bZuzm8s1ceuBUnMUAeoAHHw,6,3,2,0,1,0,2,0,8,1.1428571428571428,1,0.0,0,2,0,1,3,0,0,2,0,3,5,1
4379,68555,vle68wJbpBxaKK8jTIIpU222057lhydD,bWdj2GDclj5ofokWjzoa5jAwMkxCykd6,4,3,1,0,1,0,2,0,7,1.0,1,0.0,0,1,0,1,3,0,0,2,0,2,5,1
4380,68561,Y3Qq9FqOVwUj6PrB3KNsrLngzeSzadt5,bWdj2GDclj5ofokWjzoa5jAwMkxCykd6,9,12,5,2,2,0,6,0,27,3.857142857142857,2,0.0,1,5,2,2,11,0,0,6,0,10,17,1
4381,68563,8fwUYmiU3p577nM1EutDr5QOZIKfzBRc,RXDvfPUBYFlVdlueBFbLW0mhhAyGEqpt,69,100,49,149,18,54,26,15,411,58.714285714285715,8,0.0,17,49,142,18,83,54,7,26,15,226,185,0
4382,68567,IFerpKRFijjTvFKVmnLPfRMMDF4cIZJF,SpATywNh6bZuzm8s1ceuBUnMUAeoAHHw,7,4,0,0,0,0,5,0,9,1.2857142857142858,1,0.0,0,0,0,0,4,0,0,5,0,0,9,1
4383,68585,Glxmm6OkKDEBHVvI7QqNEC5RvmqUE0HS,bWdj2GDclj5ofokWjzoa5jAwMkxCykd6,4,3,2,0,1,0,2,0,8,1.1428571428571428,1,0.0,0,2,0,1,3,0,0,2,0,3,5,1
4384,68590,E8oGkXDZccLFAlXi9bJFdyG7ZjuPGPVx,bWdj2GDclj5ofokWjzoa5jAwMkxCykd6,6,5,3,0,2,0,6,0,16,2.2857142857142856,1,0.0,0,3,0,2,5,0,0,6,0,5,11,1
4385,68593,ko8ha9Nr4wk6DeuPN4U2tszPncta4AJu,RXDvfPUBYFlVdlueBFbLW0mhhAyGEqpt,6,5,2,0,2,0,1,0,10,1.4285714285714286,1,0.0,0,2,0,2,5,0,0,1,0,4,6,1
4386,68594,rPL0mqKklpGJ7nKQwJfgLcDkUtLeeh8C,SpATywNh6bZuzm8s1ceuBUnMUAeoAHHw,1,0,0,0,0,0,1,0,1,0.14285714285714285,1,0.0,0,0,0,0,0,0,0,1,0,0,1,1
4387,68600,w4KVb9q7mwoVRgCyZI0dPAL72VxyapbO,SpATywNh6bZuzm8s1ceuBUnMUAeoAHHw,17,25,10,10,4,13,23,1,86,12.285714285714286,2,0.0,12,10,9,4,13,13,1,23,1,35,51,0
4388,68608,xKFuemwLTt1HbT05n0729C3MfJQfGzio,bWdj2GDclj5ofokWjzoa5jAwMkxCykd6,8,8,2,0,2,0,4,0,16,2.2857142857142856,2,0.0,0,2,0,2,8,0,0,4,0,4,12,1
4389,68614,oA0E9aMtllY5HCZuDmQFAhbdEUxnmzHK,SpATywNh6bZuzm8s1ceuBUnMUAeoAHHw,14,13,5,18,3,5,6,0,50,7.142857142857143,2,0.0,5,5,15,3,8,5,3,6,0,28,22,1
4390,68615,mPyp7jTeTZOoi8uKfW9n4yxp1m3yxLU6,SpATywNh6bZuzm8s1ceuBUnMUAeoAHHw,16,12,6,11,3,3,7,1,43,6.142857142857143,2,0.0,3,6,10,3,9,3,1,7,1,22,21,1
4391,68623,F5DvCuAufOHMNW6g3uuO7OUr15Bgdj9y,SpATywNh6bZuzm8s1ceuBUnMUAeoAHHw,23,51,15,29,5,20,14,0,134,19.142857142857142,4,0.0,11,15,25,5,40,20,4,14,0,56,78,0
4392,68633,EoHwSWSzaw8CNhaYKiwnwX4BUG0jVkiR,G8EPVSXsOYB5YQWZGiz1aVq5Pgr2GrQu,28,35,10,95,5,0,7,0,152,21.714285714285715,2,0.0,20,10,79,5,15,0,16,7,0,114,38,1
4393,68643,800D5qwHCt3Ko9pzEVC49paGCt6dYzm8,bWdj2GDclj5ofokWjzoa5jAwMkxCykd6,14,61,32,26,10,79,18,0,226,32.285714285714285,6,0.0,11,32,23,10,50,79,3,18,0,76,150,1
4394,68645,uSpti6Yw7qPzPT4S4dLtJ0lPSlE5C6Xf,RXDvfPUBYFlVdlueBFbLW0mhhAyGEqpt,1,0,0,0,0,0,1,0,1,0.14285714285714285,1,0.0,0,0,0,0,0,0,0,1,0,0,1,1
4395,68648,xHynkOdioqQyjpJfj8K7fiM1HqYlBJD7,SpATywNh6bZuzm8s1ceuBUnMUAeoAHHw,9,9,5,0,4,0,8,0,26,3.7142857142857144,2,0.0,0,5,0,4,9,0,0,8,0,9,17,1
4396,68652,HVM7cvH7tmJviHLVmU4moAWMBQcFDIXR,SpATywNh6bZuzm8s1ceuBUnMUAeoAHHw,1,0,0,0,0,0,1,0,1,0.14285714285714285,1,0.0,0,0,0,0,0,0,0,1,0,0,1,1
4397,68663,uWg9viAyRsUVYkVv3Yy7uJ56PNmRweOf,SpATywNh6bZuzm8s1ceuBUnMUAeoAHHw,7,3,1,0,1,1,3,0,9,1.2857142857142858,1,0.0,0,1,0,1,3,1,0,3,0,2,7,1
4398,68668,LJN1NW4KDrkfGUEkF9SJPSL4rdPIFcim,bWdj2GDclj5ofokWjzoa5jAwMkxCykd6,9,14,0,8,3,15,8,1,49,7.0,2,0.0,8,0,8,3,6,15,0,8,1,19,30,1
4399,68669,UpJrRBQ59x3Gn5L7s007cXh7Wi1pgqj5,G8EPVSXsOYB5YQWZGiz1aVq5Pgr2GrQu,1,0,0,0,0,0,1,0,1,0.14285714285714285,1,0.0,0,0,0,0,0,0,0,1,0,0,1,1
4400,68672,XlAtLUmCwQMJblZxz5Uj8YKvORzQq8sL,bWdj2GDclj5ofokWjzoa5jAwMkxCykd6,2,0,0,0,0,0,2,0,2,0.2857142857142857,1,0.0,0,0,0,0,0,0,0,2,0,0,2,1
4401,68673,LDvIjeK3BrrUiPE6HdHKfvDgiWdtz8gl,bWdj2GDclj5ofokWjzoa5jAwMkxCykd6,5,5,2,0,1,0,3,0,11,1.5714285714285714,2,0.0,0,2,0,1,5,0,0,3,0,3,8,1
4402,68675,ZBFATksKEZIW0yZpEc4DInpubrEeq3eS,SpATywNh6bZuzm8s1ceuBUnMUAeoAHHw,14,18,10,4,5,0,1,0,38,5.428571428571429,3,0.0,2,10,4,5,16,0,0,1,0,21,17,1
4403,68684,wL3zK87VyJEaxj3JDk5zLpiovNVlVgY0,SpATywNh6bZuzm8s1ceuBUnMUAeoAHHw,9,4,3,0,3,0,3,0,13,1.8571428571428572,1,0.0,0,3,0,3,4,0,0,3,0,6,7,1
4404,68685,0sGUIxoauZHFSZVR3Y4LtOM6Pq2DRxjU,SpATywNh6bZuzm8s1ceuBUnMUAeoAHHw,6,2,1,0,1,0,3,0,7,1.0,1,0.0,0,1,0,1,2,0,0,3,0,2,5,1
4405,68686,YRBA7GRiLrrlZjduaK8N9tfqRO36138H,SpATywNh6bZuzm8s1ceuBUnMUAeoAHHw,22,49,17,37,6,0,10,0,119,17.0,6,0.0,10,17,32,6,39,0,5,10,0,65,54,0
4406,68690,vsAcPV04LnM01WalbcA4jNxiuu2qNyeQ,SpATywNh6bZuzm8s1ceuBUnMUAeoAHHw,23,68,14,31,5,32,17,3,170,24.285714285714285,7,0.0,25,14,30,5,43,32,1,17,3,74,96,0
4407,68694,SPA2zjP6CEFeNMb3HCTy4jT9WpFTBDct,SpATywNh6bZuzm8s1ceuBUnMUAeoAHHw,28,37,13,29,7,1,9,1,97,13.857142857142858,3,0.0,5,13,27,7,32,1,2,9,1,52,45,1
4408,68698,L0kYOQ1jlQCXWFfUIC5KdixPfS0gzVfJ,SpATywNh6bZuzm8s1ceuBUnMUAeoAHHw,1,0,0,0,0,0,1,0,1,0.14285714285714285,1,0.0,0,0,0,0,0,0,0,1,0,0,1,1
4409,68702,vX3VPIJhPCYSA7dPeCf6CgdqKnk7djlz,SpATywNh6bZuzm8s1ceuBUnMUAeoAHHw,1,0,0,0,0,0,1,0,1,0.14285714285714285,1,0.0,0,0,0,0,0,0,0,1,0,0,1,1
4410,68706,i1TcNs7eTFFk7oCk5M8KreZU8FvcW9bN,SpATywNh6bZuzm8s1ceuBUnMUAeoAHHw,5,1,1,0,1,3,2,0,8,1.1428571428571428,1,0.0,0,1,0,1,1,3,0,2,0,2,6,1
4411,68714,AUQbcN6sP8jOc3r7pDcomR6R8baoxLvG,SpATywNh6bZuzm8s1ceuBUnMUAeoAHHw,9,9,4,0,3,0,5,0,21,3.0,1,0.0,1,4,0,3,8,0,0,5,0,8,13,1
4412,68715,naqtjO9tZgTvMaAs9wVFgT7OrPAljiOn,bWdj2GDclj5ofokWjzoa5jAwMkxCykd6,6,6,2,0,1,0,5,0,14,2.0,3,0.0,1,2,0,1,5,0,0,5,0,4,10,1
4413,68725,v9XA8V9r9cuRk407xmjctqU28ZOWPjKH,SpATywNh6bZuzm8s1ceuBUnMUAeoAHHw,11,14,2,14,1,9,4,0,44,6.285714285714286,2,0.0,4,2,13,1,10,9,1,4,0,20,24,1
4414,68726,9DFLyn8rbv9Edwun9eQjrB5tgbqXjOr5,RXDvfPUBYFlVdlueBFbLW0mhhAyGEqpt,13,24,11,0,8,3,10,1,57,8.142857142857142,3,0.0,2,11,0,8,22,3,0,10,1,21,36,1
4415,68728,OPI0XMiYXF2KbjFje02yg2IsfXd4KQW0,G8EPVSXsOYB5YQWZGiz1aVq5Pgr2GrQu,1,0,0,0,0,0,1,0,1,0.14285714285714285,1,0.0,0,0,0,0,0,0,0,1,0,0,1,1
4416,68729,fgHXEx1kTgwNtn0duzRnGZnTM9G4nrHz,SpATywNh6bZuzm8s1ceuBUnMUAeoAHHw,7,6,4,0,3,0,2,0,15,2.142857142857143,2,0.0,0,4,0,3,6,0,0,2,0,7,8,1
4417,68734,U7RYhML9VmouEXOzi3jihOcHs1Odr6nQ,SpATywNh6bZuzm8s1ceuBUnMUAeoAHHw,4,2,1,0,1,2,2,0,8,1.1428571428571428,1,0.0,0,1,0,1,2,2,0,2,0,2,6,1
4418,68735,3JdonxNhNI9NQjhEwg0qbYv0wUomYvrC,SpATywNh6bZuzm8s1ceuBUnMUAeoAHHw,4,2,1,0,0,0,2,0,5,0.7142857142857143,1,0.0,0,1,0,0,2,0,0,2,0,1,4,1
4419,68738,8mpNTb2f22eIFQe95nOOySrTvXoHGtkW,SpATywNh6bZuzm8s1ceuBUnMUAeoAHHw,5,1,1,0,0,0,4,0,6,0.8571428571428571,1,0.0,0,1,0,0,1,0,0,4,0,1,5,1
4420,68742,kv6R7WjolUetaoWMs79hGLWsktu3yDdz,bWdj2GDclj5ofokWjzoa5jAwMkxCykd6,7,10,2,0,1,0,5,0,18,2.5714285714285716,1,0.0,0,2,0,1,10,0,0,5,0,3,15,1
4421,68744,Gt9BtVmn4m8oLlyiIlUegGAp2m9g8UFD,SpATywNh6bZuzm8s1ceuBUnMUAeoAHHw,12,14,7,0,3,0,8,1,33,4.714285714285714,3,0.0,0,7,0,3,14,0,0,8,1,10,23,1
4422,68753,i3mc4Kbynj5lAgvXLfa16WvI77RFTi9E,SpATywNh6bZuzm8s1ceuBUnMUAeoAHHw,13,21,4,17,1,11,9,3,66,9.428571428571429,2,0.0,15,4,16,1,6,11,1,9,3,36,30,1
4423,68756,GbO46rd9u4nTIYKWQ4uqsc2u6MxCvlf3,bWdj2GDclj5ofokWjzoa5jAwMkxCykd6,8,17,10,0,0,0,10,0,37,5.285714285714286,4,0.0,2,10,0,0,15,0,0,10,0,12,25,1
4424,68766,o9OiuR1V9DDjBMFIfw7sS4DiqEBIQuP8,SpATywNh6bZuzm8s1ceuBUnMUAeoAHHw,1,0,0,0,0,0,1,0,1,0.14285714285714285,1,0.0,0,0,0,0,0,0,0,1,0,0,1,1
4425,68769,RtEFZWMpyIRlgcponU0BmtpKa8uVqiIS,bWdj2GDclj5ofokWjzoa5jAwMkxCykd6,8,8,2,0,1,19,9,1,40,5.714285714285714,3,0.0,2,2,0,1,6,19,0,9,1,5,35,1
4426,68770,yo49sG8PZONryMrR1vxvvUfG4Kw6dJSG,bWdj2GDclj5ofokWjzoa5jAwMkxCykd6,1,0,0,0,0,0,1,0,1,0.14285714285714285,1,0.0,0,0,0,0,0,0,0,1,0,0,1,1
4427,68773,G1AwzYA13F3hOahvKjBBoTuWWSrXyEmf,SpATywNh6bZuzm8s1ceuBUnMUAeoAHHw,8,20,1,0,1,1,18,0,41,5.857142857142857,4,0.0,1,1,0,1,19,1,0,18,0,3,38,1
4428,68774,b7XeenIAmbbWWMDukegOQ8zSwFKoA3Yg,SpATywNh6bZuzm8s1ceuBUnMUAeoAHHw,6,10,1,0,1,0,5,0,17,2.4285714285714284,2,0.0,0,1,0,1,10,0,0,5,0,2,15,1
4429,68779,r5IH8s4isWFYMIVZOSBCnIzOrNuqNLMt,RXDvfPUBYFlVdlueBFbLW0mhhAyGEqpt,2,0,0,0,0,0,3,0,3,0.42857142857142855,1,0.0,0,0,0,0,0,0,0,3,0,0,3,1
4430,68781,THXcc2NGn7OhkfHl1lLehmfkJwTtl0vs,SpATywNh6bZuzm8s1ceuBUnMUAeoAHHw,18,18,8,15,3,37,13,2,96,13.714285714285714,4,0.0,6,8,15,3,12,37,0,13,2,32,64,1
4431,68782,0txLoRwFKi6b3jBavBHeGS8Bc3NOwsVb,SpATywNh6bZuzm8s1ceuBUnMUAeoAHHw,6,2,1,0,1,1,4,0,9,1.2857142857142858,2,0.0,0,1,0,1,2,1,0,4,0,2,7,1
4432,68784,QhYcOEapN0nrffEwA6S7jQzZwToRePP8,SpATywNh6bZuzm8s1ceuBUnMUAeoAHHw,5,7,5,0,0,0,2,0,14,2.0,2,0.0,0,5,0,0,7,0,0,2,0,5,9,1
4433,68786,zikfbKKf6UwbalVzNX9BImZBlJFR20fk,bWdj2GDclj5ofokWjzoa5jAwMkxCykd6,5,0,0,0,0,2,7,0,9,1.2857142857142858,2,0.0,0,0,0,0,0,2,0,7,0,0,9,1
4434,68792,SmrYmgxL1AB7vaaR6Foc1c7Uyze9dDt7,RXDvfPUBYFlVdlueBFbLW0mhhAyGEqpt,1,0,0,0,0,0,1,0,1,0.14285714285714285,1,0.0,0,0,0,0,0,0,0,1,0,0,1,1
4435,68797,7BZDKYSiNttbGsEOSXAkMuiEhZ6QNT9G,bWdj2GDclj5ofokWjzoa5jAwMkxCykd6,16,27,15,46,2,38,5,1,134,19.142857142857142,2,0.0,10,15,42,2,17,38,4,5,1,69,65,1
4436,68805,xjDtTrSSXACX8VZBwSxlHbYQJ7eeUCIt,SpATywNh6bZuzm8s1ceuBUnMUAeoAHHw,5,2,1,0,1,0,2,0,6,0.8571428571428571,2,0.0,0,1,0,1,2,0,0,2,0,2,4,1
4437,68807,3vpFIgzmYroxEHJb2wiXr0H3xcuBXZTn,SpATywNh6bZuzm8s1ceuBUnMUAeoAHHw,1,0,0,0,0,0,1,0,1,0.14285714285714285,1,0.0,0,0,0,0,0,0,0,1,0,0,1,1
4438,68830,RqkVdaWIELGLgdM7036pqEWeMvYmKVEW,A3fsA9Zfv1X2fVEQhTw51lKENdNrEqT3,1,0,0,0,0,0,1,0,1,0.14285714285714285,1,0.0,0,0,0,0,0,0,0,1,0,0,1,1
4439,68831,SmLgezr6vw2mXwO7w10XynKKHaO5xE5n,SpATywNh6bZuzm8s1ceuBUnMUAeoAHHw,16,17,7,8,4,3,5,1,45,6.428571428571429,1,0.0,3,7,8,4,14,3,0,5,1,22,23,1
4440,68843,B2BG30LLtuU2kSL0uylbi1RWlBzZcLDB,SpATywNh6bZuzm8s1ceuBUnMUAeoAHHw,7,4,2,0,2,0,2,0,10,1.4285714285714286,1,0.0,0,2,0,2,4,0,0,2,0,4,6,1
4441,68844,EleMlloryvuXR0G9AOtui0gfdXfrUQfc,SpATywNh6bZuzm8s1ceuBUnMUAeoAHHw,11,20,0,0,0,1,20,2,43,6.142857142857143,3,0.0,2,0,0,0,18,1,0,20,2,2,41,1
4442,68868,FvJCcTNYroCUcSPHSotcunzGZyPy4Qi0,SpATywNh6bZuzm8s1ceuBUnMUAeoAHHw,1,0,0,0,0,0,1,0,1,0.14285714285714285,1,0.0,0,0,0,0,0,0,0,1,0,0,1,1
4443,68880,abcXzTNrOBL75IbG8Oh34uJmizkY4tz5,SpATywNh6bZuzm8s1ceuBUnMUAeoAHHw,5,2,0,0,0,0,5,3,10,1.4285714285714286,1,0.0,0,0,0,0,2,0,0,5,3,0,10,1
4444,68881,8cN2OVniTirjZQCsN0ZQrtldoXZmf2q1,SpATywNh6bZuzm8s1ceuBUnMUAeoAHHw,1,0,0,0,0,0,1,0,1,0.14285714285714285,1,0.0,0,0,0,0,0,0,0,1,0,0,1,1
4445,68888,de81RIzfVtIgQfKrUlwLBazhrka9zYFQ,RXDvfPUBYFlVdlueBFbLW0mhhAyGEqpt,44,29,19,80,13,6,6,0,153,21.857142857142858,2,0.0,9,19,78,13,20,6,2,6,0,119,34,1
4446,68902,ZNvFH7xCRnWt4senPXcU6KKoaNuuuPfc,SpATywNh6bZuzm8s1ceuBUnMUAeoAHHw,15,13,9,8,4,8,6,1,49,7.0,1,0.0,1,9,7,4,12,8,1,6,1,21,28,1
4447,68909,dgs5q517os0QP00EQ3rFo0TcrFNCs1kW,RXDvfPUBYFlVdlueBFbLW0mhhAyGEqpt,18,15,7,22,3,0,1,0,48,6.857142857142857,1,0.0,3,7,18,3,12,0,4,1,0,31,17,1
4448,68914,KwglP5SNsu1REAmS7zGy1xBBD4v1B0TU,A3fsA9Zfv1X2fVEQhTw51lKENdNrEqT3,2,0,0,0,0,0,3,0,3,0.42857142857142855,1,0.0,0,0,0,0,0,0,0,3,0,0,3,1
4449,68924,ekbuMTLYQMuR0OvEI2LJUhDBg5Hzduc2,SpATywNh6bZuzm8s1ceuBUnMUAeoAHHw,13,14,8,6,3,4,6,0,41,5.857142857142857,2,0.0,0,8,5,3,14,4,1,6,0,16,25,1
4450,68932,yDiB1gdGW97IDQmCuLOgxDpZ8bOAbVfO,SpATywNh6bZuzm8s1ceuBUnMUAeoAHHw,10,3,3,0,3,0,3,0,12,1.7142857142857142,1,0.0,0,3,0,3,3,0,0,3,0,6,6,1
4451,68936,FsS49SZqT6XuQy2tX0gejqco4jQwOMN4,SpATywNh6bZuzm8s1ceuBUnMUAeoAHHw,26,27,15,21,7,0,1,0,71,10.142857142857142,1,0.0,11,15,17,7,16,0,4,1,0,50,21,0
4452,68939,qUJHOEJOIUq6GHsEj06xYmT7rQa6YMuP,SpATywNh6bZuzm8s1ceuBUnMUAeoAHHw,8,6,4,0,3,0,3,0,16,2.2857142857142856,2,0.0,0,4,0,3,6,0,0,3,0,7,9,1
4453,68944,iLiEQfwv1SBVYie6f2UeSo0gjqwSPq60,SpATywNh6bZuzm8s1ceuBUnMUAeoAHHw,12,16,2,14,0,1,3,1,37,5.285714285714286,2,0.0,7,2,13,0,9,1,1,3,1,22,15,1
4454,68957,03OlEjthtH7bdIcwtrFwO8IymW2gZt4t,SpATywNh6bZuzm8s1ceuBUnMUAeoAHHw,16,51,2,20,1,47,25,8,154,22.0,3,0.0,15,2,16,1,36,47,4,25,8,34,120,0
4455,68961,Ivwf4DZ9PeaEe6riRbe3YhY3mU61V7Rv,SpATywNh6bZuzm8s1ceuBUnMUAeoAHHw,8,6,3,0,2,0,2,0,13,1.8571428571428572,1,0.0,1,3,0,2,5,0,0,2,0,6,7,1
4456,68965,wyjPcrAJWPhHnDHJIjk8dYEEg9jaoLeO,A3fsA9Zfv1X2fVEQhTw51lKENdNrEqT3,5,2,1,0,1,0,3,0,7,1.0,2,0.0,0,1,0,1,2,0,0,3,0,2,5,1
4457,68982,jvjNqoblvibp0tKoaV1BTGpJ4j9v7r5a,SpATywNh6bZuzm8s1ceuBUnMUAeoAHHw,5,7,2,0,1,0,2,0,12,1.7142857142857142,1,0.0,3,2,0,1,4,0,0,2,0,6,6,0
4458,68983,drUu3tyovHqnF7EAaPHayHDYbWMe2Od6,SpATywNh6bZuzm8s1ceuBUnMUAeoAHHw,1,0,0,0,0,0,2,0,2,0.2857142857142857,2,0.0,0,0,0,0,0,0,0,2,0,0,2,1
4459,68985,xHLXHkY22B9ev5t6W5YAgehgj6yjfueC,bWdj2GDclj5ofokWjzoa5jAwMkxCykd6,2,0,0,0,0,0,3,0,3,0.42857142857142855,1,0.0,0,0,0,0,0,0,0,3,0,0,3,1
4460,68990,Plvb7aRlGh6MOUAvNEeJPeQdOD4FTpby,SpATywNh6bZuzm8s1ceuBUnMUAeoAHHw,6,2,1,0,1,0,4,0,8,1.1428571428571428,1,0.0,0,1,0,1,2,0,0,4,0,2,6,1
4461,69002,f6sYAy41OQsdqlcuUmQWoHmf9GvB4eiI,SpATywNh6bZuzm8s1ceuBUnMUAeoAHHw,8,8,3,0,1,0,7,0,19,2.7142857142857144,2,0.0,0,3,0,1,8,0,0,7,0,4,15,1
4462,69017,fo11APiMDJF2DjuYtDFoBE2X6zRUvD0O,A3fsA9Zfv1X2fVEQhTw51lKENdNrEqT3,7,4,3,0,0,1,4,0,12,1.7142857142857142,1,0.0,0,3,0,0,4,1,0,4,0,3,9,1
4463,69030,fvADHkZjzAohNYEqPdzq6kjINkcTeJGs,SpATywNh6bZuzm8s1ceuBUnMUAeoAHHw,1,0,0,0,0,0,1,0,1,0.14285714285714285,1,0.0,0,0,0,0,0,0,0,1,0,0,1,1
4464,69035,Z71mo3axv3ChUzLxRVr9u5krFj7IoCv8,SpATywNh6bZuzm8s1ceuBUnMUAeoAHHw,1,0,0,0,0,0,1,0,1,0.14285714285714285,1,0.0,0,0,0,0,0,0,0,1,0,0,1,1
4465,69038,DanoP5XpHODQZmwuFGZgNKBiu5nY9yH1,A3fsA9Zfv1X2fVEQhTw51lKENdNrEqT3,38,20,12,68,11,0,2,0,113,16.142857142857142,1,0.0,5,12,59,11,15,0,9,2,0,87,26,1
4466,69046,iOxekl9VdW2ENNqFsiAkjUDt6XuQIiCO,G8EPVSXsOYB5YQWZGiz1aVq5Pgr2GrQu,9,4,0,0,0,1,8,1,14,2.0,1,0.0,0,0,0,0,4,1,0,8,1,0,14,1
4467,69051,NCEmznACf7J3BIMI6JIs4ZzQnHlfSjOZ,SpATywNh6bZuzm8s1ceuBUnMUAeoAHHw,2,0,0,0,0,0,2,0,2,0.2857142857142857,1,0.0,0,0,0,0,0,0,0,2,0,0,2,1
4468,69066,0a6HihupPBi4xpjolN637qOYG6WSN1Gx,SpATywNh6bZuzm8s1ceuBUnMUAeoAHHw,28,114,70,15,30,40,25,0,294,42.0,8,0.0,24,70,12,30,90,40,3,25,0,136,158,0
4469,69070,g5yKalRrHBvoyNkzpNTa67etQfVwykko,SpATywNh6bZuzm8s1ceuBUnMUAeoAHHw,30,39,13,39,8,5,8,1,113,16.142857142857142,2,0.0,15,13,32,8,24,5,7,8,1,68,45,0
4470,69076,cy1UxkAxcqJswFy9Syqm01bsE17PQcla,SpATywNh6bZuzm8s1ceuBUnMUAeoAHHw,22,40,21,30,9,11,18,2,131,18.714285714285715,5,0.0,9,21,21,9,31,11,9,18,2,60,71,0
4471,69081,BByvTH8isxSvKoMrLrxzWQ5eR0EYxeSe,SpATywNh6bZuzm8s1ceuBUnMUAeoAHHw,8,9,4,0,3,1,7,0,24,3.4285714285714284,3,0.0,0,4,0,3,9,1,0,7,0,7,17,1
4472,69087,sydTASQZF88RFtSW5G7BxBO6Hd5gV1Jf,A3fsA9Zfv1X2fVEQhTw51lKENdNrEqT3,13,17,8,0,6,0,2,0,33,4.714285714285714,1,0.0,0,8,0,6,17,0,0,2,0,14,19,1
4473,69088,tZsLQPiwQA1iRhDP7AIV5FXBJBCNasRN,SpATywNh6bZuzm8s1ceuBUnMUAeoAHHw,5,3,1,0,1,0,2,0,7,1.0,1,0.0,0,1,0,1,3,0,0,2,0,2,5,1
4474,69090,jtRxF2WWWP8ViskFgfl6yKIsTs5XUZVy,SpATywNh6bZuzm8s1ceuBUnMUAeoAHHw,5,2,1,0,1,0,2,0,6,0.8571428571428571,1,0.0,0,1,0,1,2,0,0,2,0,2,4,1
4475,69096,JsUpucQyiTLV5gDB7KrgqzRdiUsoUyeZ,SpATywNh6bZuzm8s1ceuBUnMUAeoAHHw,1,0,0,0,0,0,1,0,1,0.14285714285714285,1,0.0,0,0,0,0,0,0,0,1,0,0,1,1
4476,69098,EXVoxE3v0YCKVCUy0azISc65MiXBDpAw,SpATywNh6bZuzm8s1ceuBUnMUAeoAHHw,13,12,6,0,3,0,7,0,28,4.0,2,0.0,2,6,0,3,10,0,0,7,0,11,17,1
4477,69099,JQSlrp0DjB9to2Jj4hPDSm3T2LtQheyt,SpATywNh6bZuzm8s1ceuBUnMUAeoAHHw,1,0,0,0,0,0,1,0,1,0.14285714285714285,1,0.0,0,0,0,0,0,0,0,1,0,0,1,1
4478,69111,1pa7pgDaPKVXrmbNpHMbk5nmhTlNRGem,bWdj2GDclj5ofokWjzoa5jAwMkxCykd6,1,0,0,0,0,0,1,0,1,0.14285714285714285,1,0.0,0,0,0,0,0,0,0,1,0,0,1,1
4479,69118,27R6lnSTl4HmEumP2huFCqg7wjTw1o6f,SpATywNh6bZuzm8s1ceuBUnMUAeoAHHw,12,18,7,0,2,3,16,3,49,7.0,3,0.0,0,7,0,2,18,3,0,16,3,9,40,1
4480,69122,JsUpucQyiTLV5gDB7KrgqzRdiUsoUyeZ,A3fsA9Zfv1X2fVEQhTw51lKENdNrEqT3,1,0,0,0,0,0,1,0,1,0.14285714285714285,1,0.0,0,0,0,0,0,0,0,1,0,0,1,1
4481,69127,y7mamutAMELy79Bgdj0zOeVjiQ071oNX,bWdj2GDclj5ofokWjzoa5jAwMkxCykd6,6,4,2,0,1,0,5,0,12,1.7142857142857142,2,0.0,0,2,0,1,4,0,0,5,0,3,9,1
4482,69130,pGYLDmhkSj1iBp1YljlDSId0XSrjZNZR,SpATywNh6bZuzm8s1ceuBUnMUAeoAHHw,27,29,18,19,9,0,8,0,83,11.857142857142858,7,0.0,4,18,18,9,25,0,1,8,0,49,34,1
4483,69136,dcJzvjKrpatpLnXddQ3Vx9PLCNP0aaAz,SpATywNh6bZuzm8s1ceuBUnMUAeoAHHw,5,2,1,0,1,0,2,0,6,0.8571428571428571,1,0.0,0,1,0,1,2,0,0,2,0,2,4,1
4484,69138,C5Rja3fyOmRxfpM2pXQmwA2G5rEfb320,SpATywNh6bZuzm8s1ceuBUnMUAeoAHHw,23,48,2,23,1,2,23,2,101,14.428571428571429,3,0.0,8,2,19,1,40,2,4,23,2,30,71,1
4485,69140,EJxY61pifGLoX5582yQzVg4H77fLkSml,A3fsA9Zfv1X2fVEQhTw51lKENdNrEqT3,5,2,1,0,1,0,5,0,9,1.2857142857142858,1,0.0,0,1,0,1,2,0,0,5,0,2,7,1
4486,69142,YLA48gUHn1Dc2R5xXAOe8bpBqZ5RWVW4,bWdj2GDclj5ofokWjzoa5jAwMkxCykd6,1,0,0,0,0,0,1,0,1,0.14285714285714285,1,0.0,0,0,0,0,0,0,0,1,0,0,1,1
4487,69160,Vnhhp2QbBiDiUTTHmXkksXuO8NCNMbjj,A3fsA9Zfv1X2fVEQhTw51lKENdNrEqT3,3,0,0,0,0,0,3,0,3,0.42857142857142855,1,0.0,0,0,0,0,0,0,0,3,0,0,3,1
4488,69163,Oc5qPJBdwZoUrwnszLfpz6LxBxG1LBA2,SpATywNh6bZuzm8s1ceuBUnMUAeoAHHw,1,0,0,0,0,0,1,0,1,0.14285714285714285,1,0.0,0,0,0,0,0,0,0,1,0,0,1,1
4489,69170,RfZCGgQvqSwCxzUkNgQBjxizWHoR00JV,SpATywNh6bZuzm8s1ceuBUnMUAeoAHHw,1,0,0,0,0,0,1,0,1,0.14285714285714285,1,0.0,0,0,0,0,0,0,0,1,0,0,1,1
4490,69172,g2ieOC0GwkKqaZWeJNXowTArkXtXRKC6,SpATywNh6bZuzm8s1ceuBUnMUAeoAHHw,1,0,0,0,0,0,2,0,2,0.2857142857142857,2,0.0,0,0,0,0,0,0,0,2,0,0,2,0
4491,69179,WX5bge9EFbPypYuObEiSD1Gyvh8Z866G,A3fsA9Zfv1X2fVEQhTw51lKENdNrEqT3,9,6,2,0,2,0,4,0,14,2.0,2,0.0,0,2,0,2,6,0,0,4,0,4,10,1
4492,69184,2qz1ezmlR3R3fKwgJceAEHpik5SGv87j,SpATywNh6bZuzm8s1ceuBUnMUAeoAHHw,1,0,0,0,0,0,1,0,1,0.14285714285714285,1,0.0,0,0,0,0,0,0,0,1,0,0,1,1
4493,69193,R8klv9uflG5co96NLU45hbr8n54FLcZh,SpATywNh6bZuzm8s1ceuBUnMUAeoAHHw,1,0,0,0,0,0,1,0,1,0.14285714285714285,1,0.0,0,0,0,0,0,0,0,1,0,0,1,1
4494,69194,pngME6c5Y6LdP7X9v20FCeYjZ97OMCQR,SpATywNh6bZuzm8s1ceuBUnMUAeoAHHw,11,7,1,11,0,1,4,1,25,3.5714285714285716,1,0.0,2,1,10,0,5,1,1,4,1,13,12,1
4495,69199,CpruMjpYp2wLmRpTC4dJZ8iwMDhltzag,RXDvfPUBYFlVdlueBFbLW0mhhAyGEqpt,1,0,0,0,0,0,1,0,1,0.14285714285714285,1,0.0,0,0,0,0,0,0,0,1,0,0,1,1
4496,69213,WX5bge9EFbPypYuObEiSD1Gyvh8Z866G,bWdj2GDclj5ofokWjzoa5jAwMkxCykd6,9,4,2,12,2,0,2,0,22,3.142857142857143,1,0.0,1,2,11,2,3,0,1,2,0,16,6,0
4497,69218,YZJnbvfbnhVRirLqDRHGzQv4606Wu6TO,bWdj2GDclj5ofokWjzoa5jAwMkxCykd6,9,13,8,0,5,2,6,1,35,5.0,3,0.0,2,8,0,5,11,2,0,6,1,15,20,1
4498,69224,65ggrHSAXoVCOK75IinKW9i4EJF8EDcN,SpATywNh6bZuzm8s1ceuBUnMUAeoAHHw,6,3,1,0,1,0,2,0,7,1.0,1,0.0,0,1,0,1,3,0,0,2,0,2,5,1
4499,69233,W8K4VS8rPvnPTNUJrqgtS2FKH93KmR91,A3fsA9Zfv1X2fVEQhTw51lKENdNrEqT3,70,86,43,194,17,3,18,0,361,51.57142857142857,7,0.0,2,43,166,17,84,3,28,18,0,228,133,1
4500,69258,8O10QoLvReRhqOHRxozXCjfp01CP9Y6X,RXDvfPUBYFlVdlueBFbLW0mhhAyGEqpt,5,2,1,0,1,0,2,0,6,0.8571428571428571,1,0.0,0,1,0,1,2,0,0,2,0,2,4,1
4501,69261,Y0yiSfPX9V0A8oNPfdzCuT5yHRuHvSj6,SpATywNh6bZuzm8s1ceuBUnMUAeoAHHw,12,8,6,0,3,0,4,1,22,3.142857142857143,2,0.0,0,6,0,3,8,0,0,4,1,9,13,1
4502,69262,X9IKf8GgqS6dvoKX3VBo51mIr8yb4uFC,A3fsA9Zfv1X2fVEQhTw51lKENdNrEqT3,44,52,21,54,12,5,18,5,167,23.857142857142858,2,0.0,7,21,51,12,45,5,3,18,5,91,76,1
4503,69266,ZutC6FPMJvnUSI7oc7F8Om4NpwtKuyEH,SpATywNh6bZuzm8s1ceuBUnMUAeoAHHw,8,5,2,0,2,0,3,0,12,1.7142857142857142,1,0.0,0,2,0,2,5,0,0,3,0,4,8,1
4504,69270,2XqSSCGvWuNVBTm3MCFePDMOSuloLKPQ,SpATywNh6bZuzm8s1ceuBUnMUAeoAHHw,8,3,1,0,1,3,4,0,12,1.7142857142857142,3,0.0,0,1,0,1,3,3,0,4,0,2,10,1
4505,69273,61kObDGseAVKKKJnoykLCdN2clfrzPTZ,SpATywNh6bZuzm8s1ceuBUnMUAeoAHHw,20,26,10,16,8,0,5,0,65,9.285714285714286,2,0.0,6,10,13,8,20,0,3,5,0,37,28,1
4506,69279,HKRHFribtFXCazZMADj8ySc6wcBJmS1L,A3fsA9Zfv1X2fVEQhTw51lKENdNrEqT3,10,4,3,0,2,1,6,0,16,2.2857142857142856,1,0.0,0,3,0,2,4,1,0,6,0,5,11,1
4507,69295,NGQ6HXbhxwBlJxikVxca5noX2u8xI9AV,bWdj2GDclj5ofokWjzoa5jAwMkxCykd6,17,17,7,50,10,0,1,0,85,12.142857142857142,1,0.0,9,7,43,10,8,0,7,1,0,69,16,0
4508,69304,JR238GZjZ1ruNiJtwVaWypz6LFnrEv5m,A3fsA9Zfv1X2fVEQhTw51lKENdNrEqT3,10,10,5,0,0,1,19,1,36,5.142857142857143,3,0.0,0,5,0,0,10,1,0,19,1,5,31,1
4509,69305,1RaxWRR42BzbDLa8H5HkFu4x9YPe7T0C,A3fsA9Zfv1X2fVEQhTw51lKENdNrEqT3,9,4,2,0,2,0,6,0,14,2.0,1,0.0,1,2,0,2,3,0,0,6,0,5,9,1
4510,69313,JZ8D07WpMQUIA2O2a3f2Q2gV7h70rqbC,SpATywNh6bZuzm8s1ceuBUnMUAeoAHHw,15,22,11,8,6,30,6,0,83,11.857142857142858,3,0.0,7,11,7,6,15,30,1,6,0,31,52,1
4511,69343,hSBgpCIALinoasvGugUi15XiQqzIP0W5,SpATywNh6bZuzm8s1ceuBUnMUAeoAHHw,11,34,10,0,6,1,16,0,67,9.571428571428571,2,0.0,0,10,0,6,34,1,0,16,0,16,51,1
4512,69344,mAEhdvjtLD2ESiLI6ko7GgTTKTJ1f5Tn,SpATywNh6bZuzm8s1ceuBUnMUAeoAHHw,12,46,13,15,1,5,6,1,87,12.428571428571429,2,0.0,29,13,13,1,17,5,2,6,1,56,31,1
4513,69346,4G8hhK38eDoUtZ2viIFKnYiWqmC4nF56,SpATywNh6bZuzm8s1ceuBUnMUAeoAHHw,6,15,2,0,0,0,5,0,22,3.142857142857143,2,0.0,10,2,0,0,5,0,0,5,0,12,10,1
4514,69347,mhllqKKDFjXI3RWMG7mLE4M16FOLrFxr,SpATywNh6bZuzm8s1ceuBUnMUAeoAHHw,4,3,1,0,1,1,1,0,7,1.0,1,0.0,0,1,0,1,3,1,0,1,0,2,5,1
4515,69364,4cOOYrtQdvpiZuIPnsoBt4lhRdbqEcsp,SpATywNh6bZuzm8s1ceuBUnMUAeoAHHw,13,13,0,12,0,0,3,0,28,4.0,2,0.0,5,0,12,0,8,0,0,3,0,17,11,1
4516,69369,uMEUDlZ1tL8WoZ2EmL0CStSYwA0zOal8,bWdj2GDclj5ofokWjzoa5jAwMkxCykd6,10,6,3,8,2,0,5,0,24,3.4285714285714284,2,0.0,1,3,8,2,5,0,0,5,0,14,10,1
4517,69370,YsoUugdKj0wstrontIOHZ151jgNGqxCe,G8EPVSXsOYB5YQWZGiz1aVq5Pgr2GrQu,8,6,3,0,2,0,3,0,14,2.0,2,0.0,0,3,0,2,6,0,0,3,0,5,9,1
4518,69386,yeibveOoJwlHHcJycB6lhQvIP04mhNkZ,SpATywNh6bZuzm8s1ceuBUnMUAeoAHHw,7,11,0,0,0,0,1,0,12,1.7142857142857142,1,0.0,1,0,0,0,10,0,0,1,0,1,11,1
4519,69392,TmRAKP6Cldz70hzdom0pqdRRs9qbBLvD,SpATywNh6bZuzm8s1ceuBUnMUAeoAHHw,4,1,0,0,0,0,3,0,4,0.5714285714285714,1,0.0,0,0,0,0,1,0,0,3,0,0,4,1
4520,69404,EB2RCe088gjmT7cbJrt6urBwZOusH5vg,SpATywNh6bZuzm8s1ceuBUnMUAeoAHHw,24,46,23,27,11,0,9,0,116,16.571428571428573,3,0.0,15,23,24,11,31,0,3,9,0,73,43,1
4521,69407,cpYO1CIRym9qUpCwm4jnjZ21HfSKew1t,SpATywNh6bZuzm8s1ceuBUnMUAeoAHHw,20,26,1,15,1,4,14,1,62,8.857142857142858,2,0.0,9,1,15,1,17,4,0,14,1,26,36,1
4522,69418,Wb7djzeQ8T0CrP6nbbq8WdqHClynqFRu,SpATywNh6bZuzm8s1ceuBUnMUAeoAHHw,1,0,0,0,0,0,1,0,1,0.14285714285714285,1,0.0,0,0,0,0,0,0,0,1,0,0,1,1
4523,69422,1taO8BWZHffh7l7BaqgWcQJY3gQ1z1ac,A3fsA9Zfv1X2fVEQhTw51lKENdNrEqT3,5,0,0,0,0,0,5,1,6,0.8571428571428571,1,0.0,0,0,0,0,0,0,0,5,1,0,6,1
4524,69426,2iC0lVJQRHLawEI3r58K4Wl79T69zQyN,G8EPVSXsOYB5YQWZGiz1aVq5Pgr2GrQu,6,4,0,0,0,2,6,0,12,1.7142857142857142,1,0.0,0,0,0,0,4,2,0,6,0,0,12,1
4525,69435,vPqhvdjrX3GgCAjq6K96tYCv7DiMTBkh,SpATywNh6bZuzm8s1ceuBUnMUAeoAHHw,23,44,1,20,1,0,11,0,77,11.0,4,0.0,10,1,19,1,34,0,1,11,0,31,46,0
4526,69437,tHPSGx00vsFzhzr0zwBlWWarqJT4wPHF,bWdj2GDclj5ofokWjzoa5jAwMkxCykd6,18,17,11,36,7,0,3,0,74,10.571428571428571,3,0.0,3,11,35,7,14,0,1,3,0,56,18,1
4527,69438,QDpN8D19Mr8RZumTONWpZNlCWcHCCTbH,SpATywNh6bZuzm8s1ceuBUnMUAeoAHHw,5,5,1,0,0,0,2,0,8,1.1428571428571428,2,0.0,0,1,0,0,5,0,0,2,0,1,7,1
4528,69439,WELjmgdsP962Pc1teJ96xvofKraKe6qa,A3fsA9Zfv1X2fVEQhTw51lKENdNrEqT3,29,29,20,30,12,36,27,4,158,22.571428571428573,6,0.0,0,20,28,12,29,36,2,27,4,60,98,1
4529,69443,JnRbwXg3XGYAmOXQP1OiJxv44LsKYQS5,SpATywNh6bZuzm8s1ceuBUnMUAeoAHHw,21,22,1,26,1,5,8,1,64,9.142857142857142,2,0.0,7,1,23,1,15,5,3,8,1,32,32,0
4530,69444,sfdgnQL9ZJy8iQoJsTh6pz33V1sjsZlD,A3fsA9Zfv1X2fVEQhTw51lKENdNrEqT3,32,26,20,0,13,0,10,0,69,9.857142857142858,3,0.0,0,20,0,13,26,0,0,10,0,33,36,0
4531,69452,30KFUYZeibWx0Iky00wqYaxS7YWNwWx4,SpATywNh6bZuzm8s1ceuBUnMUAeoAHHw,5,5,2,0,1,0,1,0,9,1.2857142857142858,1,0.0,0,2,0,1,5,0,0,1,0,3,6,1
4532,69466,DcPL5Zur8S33yRX2fv1HxqidGklhFV5P,SpATywNh6bZuzm8s1ceuBUnMUAeoAHHw,22,31,17,18,7,2,9,1,85,12.142857142857142,2,0.0,9,17,15,7,22,2,3,9,1,48,37,1
4533,69471,x9up4wvnaS79M9udGA7fqhv1sigb86bK,SpATywNh6bZuzm8s1ceuBUnMUAeoAHHw,8,7,4,0,2,3,4,0,20,2.857142857142857,2,0.0,0,4,0,2,7,3,0,4,0,6,14,1
4534,69477,FlAkKX6ow9SvOzk0dTWPWgnX5766zY29,G8EPVSXsOYB5YQWZGiz1aVq5Pgr2GrQu,21,28,12,30,9,0,3,0,82,11.714285714285714,2,0.0,5,12,25,9,23,0,5,3,0,51,31,0
4535,69478,8tkFlxYnls5Mxd2ekCeWIpaKuJe1mR6W,G8EPVSXsOYB5YQWZGiz1aVq5Pgr2GrQu,19,25,8,12,8,4,6,1,64,9.142857142857142,1,0.0,15,8,7,8,10,4,5,6,1,38,26,1
4536,69499,oG7qUH6PFRXdknLnOhOWneHPtBW8Ta2o,A3fsA9Zfv1X2fVEQhTw51lKENdNrEqT3,3,0,0,0,0,0,3,0,3,0.42857142857142855,1,0.0,0,0,0,0,0,0,0,3,0,0,3,0
4537,69500,pNxcbeMWYcUZBxJCtPF9qmCQyBYd1bU7,SpATywNh6bZuzm8s1ceuBUnMUAeoAHHw,29,36,18,32,9,2,10,0,107,15.285714285714286,2,0.0,14,18,30,9,22,2,2,10,0,71,36,1
4538,69536,F6yoJDYdOCdZg3HrTm4YkvnDfcsvPtnN,SpATywNh6bZuzm8s1ceuBUnMUAeoAHHw,7,6,3,0,2,0,1,0,12,1.7142857142857142,1,0.0,0,3,0,2,6,0,0,1,0,5,7,1
4539,69538,RCYov8DEPqszWUDtrunbywhn5eFESjlB,SpATywNh6bZuzm8s1ceuBUnMUAeoAHHw,16,22,8,9,5,7,5,1,57,8.142857142857142,1,0.0,9,8,9,5,13,7,0,5,1,31,26,1
4540,69540,a160ewxyRJdtN45GnX3uGxkLMyeZKvV7,bWdj2GDclj5ofokWjzoa5jAwMkxCykd6,13,20,10,84,5,7,13,2,141,20.142857142857142,2,0.0,4,10,82,5,16,7,2,13,2,101,40,1
4541,69543,ZAi0jAKRdwQEtga2Yygb9adNtNc26TKH,SpATywNh6bZuzm8s1ceuBUnMUAeoAHHw,7,6,3,0,1,0,2,0,12,1.7142857142857142,1,0.0,2,3,0,1,4,0,0,2,0,6,6,1
4542,69548,cjgnRFcpPxhUwluGuMHbhKtpIo8g67oX,SpATywNh6bZuzm8s1ceuBUnMUAeoAHHw,5,2,1,0,1,0,5,0,9,1.2857142857142858,1,0.0,0,1,0,1,2,0,0,5,0,2,7,1
4543,69551,WfPfJn9lrx0nGBfxPbzYzJSQElx0Vya0,A3fsA9Zfv1X2fVEQhTw51lKENdNrEqT3,7,7,6,0,1,0,1,0,15,2.142857142857143,3,0.0,0,6,0,1,7,0,0,1,0,7,8,1
4544,69561,Z4SPpJfwg3kmbYmCX1430X6xnjXFgqan,SpATywNh6bZuzm8s1ceuBUnMUAeoAHHw,1,0,0,0,0,0,1,0,1,0.14285714285714285,1,0.0,0,0,0,0,0,0,0,1,0,0,1,1
4545,69567,q3DUInVVvDGT22ACyMKixODyUkgLOKmI,SpATywNh6bZuzm8s1ceuBUnMUAeoAHHw,18,25,16,13,8,0,5,0,67,9.571428571428571,3,0.0,4,16,13,8,21,0,0,5,0,41,26,1
4546,69577,zdQpZzeZtdBJrKxe0kkh4zz1KUaEeB2I,G8EPVSXsOYB5YQWZGiz1aVq5Pgr2GrQu,21,17,12,22,7,4,3,0,65,9.285714285714286,2,0.0,1,12,18,7,16,4,4,3,0,38,27,1
4547,69583,82WiuHoB3dVqYkf2UKsu9ogC0IsQQnqa,A3fsA9Zfv1X2fVEQhTw51lKENdNrEqT3,5,3,0,0,0,0,3,0,6,0.8571428571428571,1,0.0,0,0,0,0,3,0,0,3,0,0,6,1
4548,69590,aYhMdR5xaez3fr0lBrD6kCxYiCOyculR,SpATywNh6bZuzm8s1ceuBUnMUAeoAHHw,3,0,0,0,0,1,2,0,3,0.42857142857142855,1,0.0,0,0,0,0,0,1,0,2,0,0,3,0
4549,69594,0pQnhOp7TmXmyZJvGFVAPDeo6QapvPWM,SpATywNh6bZuzm8s1ceuBUnMUAeoAHHw,1,0,0,0,0,0,1,0,1,0.14285714285714285,1,0.0,0,0,0,0,0,0,0,1,0,0,1,1
4550,69602,ebvWYER6Bde0EUcNXXIX0vyTB9ur6Kqi,bWdj2GDclj5ofokWjzoa5jAwMkxCykd6,4,4,0,0,0,0,2,0,6,0.8571428571428571,2,0.0,0,0,0,0,4,0,0,2,0,0,6,1
4551,69604,ebvWYER6Bde0EUcNXXIX0vyTB9ur6Kqi,RXDvfPUBYFlVdlueBFbLW0mhhAyGEqpt,11,10,0,0,0,3,10,1,24,3.4285714285714284,2,0.0,1,0,0,0,9,3,0,10,1,1,23,1
4552,69608,luffaRyMH17lmf9lXIITCUvmvLstdhJF,SpATywNh6bZuzm8s1ceuBUnMUAeoAHHw,7,6,1,0,1,0,3,0,11,1.5714285714285714,2,0.0,2,1,0,1,4,0,0,3,0,4,7,1
4553,69609,m6d8SS4M8CUq3BoC3xOyTU0oHsPjDd2w,SpATywNh6bZuzm8s1ceuBUnMUAeoAHHw,4,2,0,0,0,0,2,0,4,0.5714285714285714,1,0.0,0,0,0,0,2,0,0,2,0,0,4,1
4554,69611,nJobBmBuwmDPhO4EIrWUJq110WMVvZw4,SpATywNh6bZuzm8s1ceuBUnMUAeoAHHw,8,4,3,0,2,0,2,0,11,1.5714285714285714,1,0.0,0,3,0,2,4,0,0,2,0,5,6,1
4555,69616,faupOzOQrYnrhUP3CZcXERH5hL8Q3xd2,SpATywNh6bZuzm8s1ceuBUnMUAeoAHHw,18,27,14,10,6,23,7,0,87,12.428571428571429,5,0.0,7,14,10,6,20,23,0,7,0,37,50,1
4556,69638,nkfthsiEhj5rlE8h2UVfSYWZi1i1pvPD,SpATywNh6bZuzm8s1ceuBUnMUAeoAHHw,25,46,15,22,8,2,7,0,100,14.285714285714286,2,0.0,11,15,19,8,35,2,3,7,0,53,47,1
4557,69643,W17GnVDduKqnwPQhc7qvZa9k2VQEwhjA,G8EPVSXsOYB5YQWZGiz1aVq5Pgr2GrQu,5,2,1,0,1,0,2,0,6,0.8571428571428571,1,0.0,0,1,0,1,2,0,0,2,0,2,4,1
4558,69647,tD4YaA9C1jzNLnr7tPBZ897xHEsnzm9F,SpATywNh6bZuzm8s1ceuBUnMUAeoAHHw,1,0,0,0,0,0,1,0,1,0.14285714285714285,1,0.0,0,0,0,0,0,0,0,1,0,0,1,1
4559,69650,tD4YaA9C1jzNLnr7tPBZ897xHEsnzm9F,A3fsA9Zfv1X2fVEQhTw51lKENdNrEqT3,1,0,0,0,0,0,1,0,1,0.14285714285714285,1,0.0,0,0,0,0,0,0,0,1,0,0,1,1
4560,69654,lD3KgUtWok6mjiblbvy163en24cSYNXc,RXDvfPUBYFlVdlueBFbLW0mhhAyGEqpt,1,0,0,0,0,0,1,0,1,0.14285714285714285,1,0.0,0,0,0,0,0,0,0,1,0,0,1,1
4561,69680,tes6smsqnnhtic7mel4he0HOVKxdsIk0,SpATywNh6bZuzm8s1ceuBUnMUAeoAHHw,5,6,3,0,1,0,5,0,15,2.142857142857143,3,0.0,0,3,0,1,6,0,0,5,0,4,11,1
4562,69682,DpqUZKEZpIFvZzvEXk8oaJMRAbEfypNN,A3fsA9Zfv1X2fVEQhTw51lKENdNrEqT3,25,20,15,0,14,0,6,0,55,7.857142857142857,1,0.0,2,15,0,14,18,0,0,6,0,31,24,1
4563,69684,jKWIhuXmlYFBIapfd4E50TBTHed3oveP,SpATywNh6bZuzm8s1ceuBUnMUAeoAHHw,16,25,10,12,4,1,4,0,56,8.0,3,0.0,6,10,11,4,19,1,1,4,0,31,25,1
4564,69690,RsnXePogfsPEsPaBIDmu1zOlkZ0nGsJG,SpATywNh6bZuzm8s1ceuBUnMUAeoAHHw,10,14,6,0,5,0,15,0,40,5.714285714285714,3,0.0,2,6,0,5,12,0,0,15,0,13,27,1
4565,69693,Z3XF9lddm62bhylNbOc8gNaNENZtsGVQ,SpATywNh6bZuzm8s1ceuBUnMUAeoAHHw,6,6,2,0,0,0,4,0,12,1.7142857142857142,2,0.0,0,2,0,0,6,0,0,4,0,2,10,1
4566,69697,KCsv9o14hbrQKvzaJVVOUtS9ZXoioMZi,SpATywNh6bZuzm8s1ceuBUnMUAeoAHHw,23,26,16,11,12,0,3,0,68,9.714285714285714,2,0.0,7,16,10,12,19,0,1,3,0,45,23,1
4567,69702,V5MB02xz5am2kHfey21j0yueDNM7JiHU,A3fsA9Zfv1X2fVEQhTw51lKENdNrEqT3,6,3,2,0,2,0,4,0,11,1.5714285714285714,1,0.0,0,2,0,2,3,0,0,4,0,4,7,1
4568,69708,xcD6YWhnGA2xukGmX4eaYrm6VS9ffz1H,RXDvfPUBYFlVdlueBFbLW0mhhAyGEqpt,49,67,28,84,19,3,16,0,217,31.0,3,0.0,28,28,76,19,39,3,8,16,0,151,66,0
4569,69709,HkR8egrosmo3p8vvw0Masj2JRYmaSMRW,bWdj2GDclj5ofokWjzoa5jAwMkxCykd6,3,0,0,0,0,1,6,0,7,1.0,2,0.0,0,0,0,0,0,1,0,6,0,0,7,0
4570,69713,8gwjs0B0kUE7stjGZjvEBczr2cXGTwYJ,SpATywNh6bZuzm8s1ceuBUnMUAeoAHHw,11,7,4,6,1,0,2,0,20,2.857142857142857,2,0.0,2,4,6,1,5,0,0,2,0,13,7,0
4571,69719,o7QNLHma5sLHPf1vf8edH1AxEjwzXjmH,RXDvfPUBYFlVdlueBFbLW0mhhAyGEqpt,4,2,1,0,1,0,1,0,5,0.7142857142857143,1,0.0,0,1,0,1,2,0,0,1,0,2,3,1
4572,69726,MJibuyVypmuBs7BncEuo5i3GOsk8IZAX,SpATywNh6bZuzm8s1ceuBUnMUAeoAHHw,9,5,3,0,1,1,5,0,15,2.142857142857143,1,0.0,0,3,0,1,5,1,0,5,0,4,11,1
4573,69728,RGp0TGYq2GqXU0ffAofLYX0dCiUdIWSh,SpATywNh6bZuzm8s1ceuBUnMUAeoAHHw,9,6,4,0,2,0,4,0,16,2.2857142857142856,2,0.0,0,4,0,2,6,0,0,4,0,6,10,0
4574,69749,1mwVsEWRdpRYvoqkUN67uGNzTUomXEbQ,G8EPVSXsOYB5YQWZGiz1aVq5Pgr2GrQu,22,55,4,0,4,3,8,0,74,10.571428571428571,2,0.0,2,4,0,4,53,3,0,8,0,10,64,1
4575,69750,LITEXQWwZ0HwbfUIw2ZTJ1Nz80g3xPKl,RXDvfPUBYFlVdlueBFbLW0mhhAyGEqpt,5,4,2,0,1,0,2,0,9,1.2857142857142858,2,0.0,0,2,0,1,4,0,0,2,0,3,6,1
4576,69752,WXX8Za7OuZw2MA7QaLNUhKigQ32JFLJo,SpATywNh6bZuzm8s1ceuBUnMUAeoAHHw,11,10,4,1,3,0,2,0,20,2.857142857142857,1,0.0,5,4,1,3,5,0,0,2,0,13,7,1
4577,69774,NiepHsDkcSMT8UZbqGGY6QXqNiJKeyrC,SpATywNh6bZuzm8s1ceuBUnMUAeoAHHw,6,4,1,0,1,0,3,0,9,1.2857142857142858,1,0.0,0,1,0,1,4,0,0,3,0,2,7,1
4578,69776,P1MYDLvlR6YqACMf13Tb8sFZFVWSr1nZ,bWdj2GDclj5ofokWjzoa5jAwMkxCykd6,7,11,0,0,0,0,11,0,22,3.142857142857143,1,0.0,0,0,0,0,11,0,0,11,0,0,22,1
4579,69777,vljlAhHGhHZt2ciFpy2bQxMoEL2SUwdk,G8EPVSXsOYB5YQWZGiz1aVq5Pgr2GrQu,10,5,1,0,0,2,8,1,17,2.4285714285714284,1,0.0,0,1,0,0,5,2,0,8,1,1,16,1
4580,69783,Nr4xgaqWlp3GY7Luca1HZwWSVTgxpORh,A3fsA9Zfv1X2fVEQhTw51lKENdNrEqT3,24,21,6,47,0,0,2,0,76,10.857142857142858,2,0.0,1,6,46,0,20,0,1,2,0,53,23,0
4581,69792,pmTpzYlO4DcSR3Hjn7J1Go0PaUoezH5E,SpATywNh6bZuzm8s1ceuBUnMUAeoAHHw,6,1,1,0,1,0,3,0,6,0.8571428571428571,1,0.0,0,1,0,1,1,0,0,3,0,2,4,1
4582,69800,kzyt7hO7yEeJxQfXO5XM7Bawq3xoVkTz,SpATywNh6bZuzm8s1ceuBUnMUAeoAHHw,9,6,3,7,1,0,5,0,22,3.142857142857143,2,0.0,2,3,6,1,4,0,1,5,0,12,10,0
4583,69802,2NIeHPnJrY66zbADeGJTptXbk5YYYnSv,G8EPVSXsOYB5YQWZGiz1aVq5Pgr2GrQu,6,3,1,9,0,0,1,0,14,2.0,1,0.0,0,1,7,0,3,0,2,1,0,8,6,1
4584,69807,iysh9174eOcFH0suenSCLNsv1cqN2Oie,A3fsA9Zfv1X2fVEQhTw51lKENdNrEqT3,15,13,5,0,4,0,8,0,30,4.285714285714286,2,0.0,0,5,0,4,13,0,0,8,0,9,21,1
4585,69808,rDR9DQbHi1eXHd28a6bdjn6YaDG8j833,SpATywNh6bZuzm8s1ceuBUnMUAeoAHHw,4,2,1,0,1,0,1,0,5,0.7142857142857143,1,0.0,0,1,0,1,2,0,0,1,0,2,3,1
4586,69809,j7794Az14TTh7tEEmhTpADHq4ipGllnd,SpATywNh6bZuzm8s1ceuBUnMUAeoAHHw,32,66,28,62,9,35,21,1,222,31.714285714285715,7,0.0,28,28,52,9,38,35,10,21,1,117,105,0
4587,69811,RN9YqqNsHa7lmCtbb4sE8JmcbttJklXE,SpATywNh6bZuzm8s1ceuBUnMUAeoAHHw,13,15,2,0,2,31,12,2,64,9.142857142857142,2,0.0,0,2,0,2,15,31,0,12,2,4,60,1
4588,69831,LFBaIhK5031yuWJYVNd4qT9zLr1L16XD,A3fsA9Zfv1X2fVEQhTw51lKENdNrEqT3,9,5,3,0,3,0,4,0,15,2.142857142857143,2,0.0,1,3,0,3,4,0,0,4,0,7,8,1
4589,69841,AlFdkAawiX4QZgKaI0ukIeHoMMs579rt,A3fsA9Zfv1X2fVEQhTw51lKENdNrEqT3,1,0,0,0,0,0,1,0,1,0.14285714285714285,1,0.0,0,0,0,0,0,0,0,1,0,0,1,1
4590,69843,yIgziBEY1QeE2VunyvjKVApcpAZz6INk,bWdj2GDclj5ofokWjzoa5jAwMkxCykd6,13,26,13,20,6,7,8,0,80,11.428571428571429,2,0.0,6,13,18,6,20,7,2,8,0,43,37,1
4591,69847,LyDM0yrwn8zKtQsuxEGqFMxdhffaZNVY,SpATywNh6bZuzm8s1ceuBUnMUAeoAHHw,4,3,0,0,0,0,1,0,4,0.5714285714285714,1,0.0,0,0,0,0,3,0,0,1,0,0,4,1
4592,69849,jSFXNgNICT3cTdtFY1qrRx06ncJbHNIL,SpATywNh6bZuzm8s1ceuBUnMUAeoAHHw,19,25,14,18,5,0,11,0,73,10.428571428571429,3,0.0,4,14,15,5,21,0,3,11,0,38,35,0
4593,69852,jGWjfQmpnKrCWFzIMxwjgnePo6w3vCLc,SpATywNh6bZuzm8s1ceuBUnMUAeoAHHw,18,41,19,2,10,4,13,3,92,13.142857142857142,5,0.0,16,19,2,10,25,4,0,13,3,47,45,1
4594,69854,vtTIluoXpRIe9zpqEiPikMWtGXSMpuiF,SpATywNh6bZuzm8s1ceuBUnMUAeoAHHw,18,37,12,18,4,1,9,0,81,11.571428571428571,5,0.0,8,12,15,4,29,1,3,9,0,39,42,1
4595,69856,SBz1G9CPNh7b1YKxwzjWQ2S8H7JkEfYW,SpATywNh6bZuzm8s1ceuBUnMUAeoAHHw,21,46,1,27,0,17,4,0,95,13.571428571428571,2,0.0,14,1,24,0,32,17,3,4,0,39,56,0
4596,69861,TgjP3M05p3RMkUJ6UX2DRRlsHiZcIeqm,SpATywNh6bZuzm8s1ceuBUnMUAeoAHHw,17,28,2,15,0,2,7,1,55,7.857142857142857,2,0.0,10,2,12,0,18,2,3,7,1,24,31,1
4597,69877,2eCbk1UbEiqe2btnyk0kQWHxge0iLKhu,SpATywNh6bZuzm8s1ceuBUnMUAeoAHHw,10,4,4,0,4,0,3,0,15,2.142857142857143,1,0.0,0,4,0,4,4,0,0,3,0,8,7,1
4598,69879,T7hyLHRci3AaSKtnxgzZP9PZimkugFag,SpATywNh6bZuzm8s1ceuBUnMUAeoAHHw,17,12,7,6,3,0,10,0,38,5.428571428571429,2,0.0,3,7,6,3,9,0,0,10,0,19,19,1
4599,69886,C89edYjc0egHm9DK0UhG6TICXc3cgfYt,SpATywNh6bZuzm8s1ceuBUnMUAeoAHHw,14,14,10,0,5,2,7,1,39,5.571428571428571,2,0.0,0,10,0,5,14,2,0,7,1,15,24,1
4600,69887,uxXbNZQzMKFVtvkoRDDVyoOZczad3AGk,SpATywNh6bZuzm8s1ceuBUnMUAeoAHHw,5,2,1,0,1,0,3,0,7,1.0,1,0.0,0,1,0,1,2,0,0,3,0,2,5,1
4601,69894,uxXbNZQzMKFVtvkoRDDVyoOZczad3AGk,bWdj2GDclj5ofokWjzoa5jAwMkxCykd6,1,0,0,0,0,0,1,0,1,0.14285714285714285,1,0.0,0,0,0,0,0,0,0,1,0,0,1,1
4602,69896,uxXbNZQzMKFVtvkoRDDVyoOZczad3AGk,A3fsA9Zfv1X2fVEQhTw51lKENdNrEqT3,1,0,0,0,0,0,1,0,1,0.14285714285714285,1,0.0,0,0,0,0,0,0,0,1,0,0,1,1
4603,69913,NMnvuPuFFRZJF8iN4i8wvMDrTjhZSOh9,SpATywNh6bZuzm8s1ceuBUnMUAeoAHHw,20,43,11,9,4,1,9,1,78,11.142857142857142,1,0.0,10,11,9,4,33,1,0,9,1,34,44,1
4604,69924,hF9wzZzzUNXUdemSIRccNUzFWcmYBmRA,SpATywNh6bZuzm8s1ceuBUnMUAeoAHHw,4,2,1,0,1,0,1,0,5,0.7142857142857143,1,0.0,0,1,0,1,2,0,0,1,0,2,3,1
4605,69926,iC67OjDFbVlCchthNt40xrjNGlZz61fX,SpATywNh6bZuzm8s1ceuBUnMUAeoAHHw,2,0,0,0,0,0,4,0,4,0.5714285714285714,2,0.0,0,0,0,0,0,0,0,4,0,0,4,0
4606,69928,VzpntkFDzyOIiXtUxc8LkeciWhAJhdSD,SpATywNh6bZuzm8s1ceuBUnMUAeoAHHw,9,4,3,2,2,0,3,0,14,2.0,2,0.0,0,3,2,2,4,0,0,3,0,7,7,1
4607,69933,GRXlFzfh4xOjZLiMJPGMcltQGlQAKqSw,A3fsA9Zfv1X2fVEQhTw51lKENdNrEqT3,3,2,0,0,0,0,1,0,3,0.42857142857142855,1,0.0,0,0,0,0,2,0,0,1,0,0,3,0
4608,69941,DpqUZKEZpIFvZzvEXk8oaJMRAbEfypNN,SpATywNh6bZuzm8s1ceuBUnMUAeoAHHw,15,11,7,0,7,0,6,0,31,4.428571428571429,1,0.0,2,7,0,7,9,0,0,6,0,16,15,0
4609,69948,lqeVvfv7UmHu5JiyWoTOATw0yL0HJQEo,G8EPVSXsOYB5YQWZGiz1aVq5Pgr2GrQu,1,0,0,0,0,0,1,0,1,0.14285714285714285,1,0.0,0,0,0,0,0,0,0,1,0,0,1,1
4610,69949,jcyADRcnQkvVHllsyVvCCi5Wcx40AoFW,SpATywNh6bZuzm8s1ceuBUnMUAeoAHHw,2,0,0,0,0,0,2,0,2,0.2857142857142857,1,0.0,0,0,0,0,0,0,0,2,0,0,2,1
4611,69961,jcyADRcnQkvVHllsyVvCCi5Wcx40AoFW,A3fsA9Zfv1X2fVEQhTw51lKENdNrEqT3,1,0,0,0,0,0,1,0,1,0.14285714285714285,1,0.0,0,0,0,0,0,0,0,1,0,0,1,1
4612,69973,CabsQjb2Sd2I3ynTdtsErAG67rLex08f,A3fsA9Zfv1X2fVEQhTw51lKENdNrEqT3,2,0,0,0,0,0,2,0,2,0.2857142857142857,1,0.0,0,0,0,0,0,0,0,2,0,0,2,1
4613,69975,xL2GGqHxlfngRtz8ATMPQBFRBvX6HArr,SpATywNh6bZuzm8s1ceuBUnMUAeoAHHw,22,24,13,16,3,16,12,3,87,12.428571428571429,2,0.0,8,13,16,3,16,16,0,12,3,40,47,0
4614,69997,viQoPUNtB7SIUiKvJ4gjpMz5oecDT31f,G8EPVSXsOYB5YQWZGiz1aVq5Pgr2GrQu,4,2,1,0,1,0,1,0,5,0.7142857142857143,1,0.0,0,1,0,1,2,0,0,1,0,2,3,1
4615,70006,wBxOvXavxcvDHQtsCbkdt1VRzmB8Qh9E,bWdj2GDclj5ofokWjzoa5jAwMkxCykd6,9,8,4,19,2,0,8,0,41,5.857142857142857,3,0.0,2,4,19,2,6,0,0,8,0,27,14,1
4616,70013,Kmxwvn5YFvJ5yFX0GZXEdEhcQGDP2CuP,SpATywNh6bZuzm8s1ceuBUnMUAeoAHHw,4,2,1,0,1,0,1,0,5,0.7142857142857143,1,0.0,0,1,0,1,2,0,0,1,0,2,3,1
4617,70034,J1us9rPcxSTckBHItgnAQKi26DjcRbl6,A3fsA9Zfv1X2fVEQhTw51lKENdNrEqT3,7,3,2,0,2,0,9,0,16,2.2857142857142856,1,0.0,0,2,0,2,3,0,0,9,0,4,12,1
4618,70037,jQGozXgCDEtih8n0QNDjwOxHGubLTjEt,SpATywNh6bZuzm8s1ceuBUnMUAeoAHHw,6,6,4,0,2,0,2,0,14,2.0,1,0.0,0,4,0,2,6,0,0,2,0,6,8,0
4619,70046,J1us9rPcxSTckBHItgnAQKi26DjcRbl6,bWdj2GDclj5ofokWjzoa5jAwMkxCykd6,5,2,1,0,1,0,2,0,6,0.8571428571428571,1,0.0,0,1,0,1,2,0,0,2,0,2,4,1
4620,70048,DbyuNNEIfQSCSjURAYhbFblaR63gfHlU,A3fsA9Zfv1X2fVEQhTw51lKENdNrEqT3,2,0,0,0,0,0,2,0,2,0.2857142857142857,1,0.0,0,0,0,0,0,0,0,2,0,0,2,1
4621,70049,DbyuNNEIfQSCSjURAYhbFblaR63gfHlU,bWdj2GDclj5ofokWjzoa5jAwMkxCykd6,7,5,1,24,2,0,4,0,36,5.142857142857143,2,0.0,3,1,23,2,2,0,1,4,0,29,7,1
4622,70050,hcNcs1eHZusVH4vyoLl8j9zdN7CZ6Lcy,SpATywNh6bZuzm8s1ceuBUnMUAeoAHHw,24,20,16,12,12,0,5,0,65,9.285714285714286,2,0.0,2,16,10,12,18,0,2,5,0,40,25,1
4623,70063,EJgYYp7MOTUbdsSUr6xoQChx0uLQ5Tys,SpATywNh6bZuzm8s1ceuBUnMUAeoAHHw,7,3,2,0,2,0,2,0,9,1.2857142857142858,1,0.0,0,2,0,2,3,0,0,2,0,4,5,1
4624,70070,nzxk9UvHRiwkN6SIsgPzgRjDaGaCgQRa,bWdj2GDclj5ofokWjzoa5jAwMkxCykd6,1,0,0,0,0,0,1,0,1,0.14285714285714285,1,0.0,0,0,0,0,0,0,0,1,0,0,1,1
4625,70101,vYeGcWGAJP4B8Lvbjdr2jkY9NnpHN8xb,bWdj2GDclj5ofokWjzoa5jAwMkxCykd6,1,0,0,0,0,0,1,0,1,0.14285714285714285,1,0.0,0,0,0,0,0,0,0,1,0,0,1,1
4626,70108,JaY583iEzhUh1H375yAqlbYi0f6zdDLM,SpATywNh6bZuzm8s1ceuBUnMUAeoAHHw,4,3,0,0,0,0,2,0,5,0.7142857142857143,1,0.0,1,0,0,0,2,0,0,2,0,1,4,1
4627,70109,w1PJeTTskG2DF1TtLUpuz9MkqxNdq5EB,SpATywNh6bZuzm8s1ceuBUnMUAeoAHHw,6,8,2,0,2,0,3,0,15,2.142857142857143,2,0.0,0,2,0,2,8,0,0,3,0,4,11,1
4628,70119,NXyco71N78GkVfHnZsK8R307XzQzXNS1,SpATywNh6bZuzm8s1ceuBUnMUAeoAHHw,17,23,9,8,3,0,1,0,44,6.285714285714286,3,0.0,7,9,7,3,16,0,1,1,0,26,18,0
4629,70122,68BjCXfBFqeZ01fFx1csrFmvef5xs0w2,G8EPVSXsOYB5YQWZGiz1aVq5Pgr2GrQu,33,47,28,8,14,31,10,0,138,19.714285714285715,6,0.0,8,28,5,14,39,31,3,10,0,55,83,1
4630,70132,rSEfJyHxNlxmmbC9ORIbqcFKKq08QDrh,A3fsA9Zfv1X2fVEQhTw51lKENdNrEqT3,7,5,2,0,2,14,3,0,26,3.7142857142857144,2,0.0,0,2,0,2,5,14,0,3,0,4,22,1
4631,70137,DyZ33FUAQ083lF7iqwpOMtJVUGHaWBxJ,SpATywNh6bZuzm8s1ceuBUnMUAeoAHHw,1,0,0,0,0,0,1,0,1,0.14285714285714285,1,0.0,0,0,0,0,0,0,0,1,0,0,1,1
4632,70139,j4hecXKY3USBQpRwMuzKA9d9SPzBKhRY,bWdj2GDclj5ofokWjzoa5jAwMkxCykd6,5,3,0,0,0,5,6,0,14,2.0,1,0.0,0,0,0,0,3,5,0,6,0,0,14,1
4633,70147,YlInwW32qLdS6CieoVgP5nZzRZh7iEhb,A3fsA9Zfv1X2fVEQhTw51lKENdNrEqT3,11,16,8,0,5,0,4,0,33,4.714285714285714,2,0.0,0,8,0,5,16,0,0,4,0,13,20,1
4634,70151,Zn9SLiwLflmw7DD6LFx0hGPxPjMJmhLJ,SpATywNh6bZuzm8s1ceuBUnMUAeoAHHw,1,0,0,0,0,0,1,0,1,0.14285714285714285,1,0.0,0,0,0,0,0,0,0,1,0,0,1,1
4635,70163,wykDdjB45pC3zZUNNLpkNXDJGEatsGFp,RXDvfPUBYFlVdlueBFbLW0mhhAyGEqpt,1,0,0,0,0,0,1,0,1,0.14285714285714285,1,0.0,0,0,0,0,0,0,0,1,0,0,1,1
4636,70368,4AzWdcwb3SG5chIViRUSkI6mbhUE2J75,fbPkOYLVPtPgIt0MxizjfFJov3JbHyAi,25,59,37,0,21,2,15,1,135,19.285714285714285,6,0.0,2,37,0,21,57,2,0,15,1,60,75,1
4637,70371,kC7JLQowN0BSKnzXXKRn5vuXi1nnM0dA,fbPkOYLVPtPgIt0MxizjfFJov3JbHyAi,4,2,1,0,1,0,1,0,5,0.7142857142857143,1,0.0,0,1,0,1,2,0,0,1,0,2,3,1
4638,70376,61PsrnqGMh19xjWowe2Lz8ELqYCTUUqE,fbPkOYLVPtPgIt0MxizjfFJov3JbHyAi,42,136,67,55,12,33,45,6,354,50.57142857142857,11,0.0,38,67,46,12,98,33,9,45,6,163,191,0
4639,70390,CZolsxTOSFE94rXDRXRTcZmeVsLJ3JH7,fbPkOYLVPtPgIt0MxizjfFJov3JbHyAi,1,0,0,0,0,0,1,0,1,0.14285714285714285,1,0.0,0,0,0,0,0,0,0,1,0,0,1,1
4640,70394,jVBLsQocjzyX8TfhIQuGcF0tRTsZU0fl,fbPkOYLVPtPgIt0MxizjfFJov3JbHyAi,5,3,1,0,1,0,3,0,8,1.1428571428571428,1,0.0,0,1,0,1,3,0,0,3,0,2,6,1
4641,70427,xlOz0HV4EOx3YcSKdziNkU6Tif0rYjnx,fbPkOYLVPtPgIt0MxizjfFJov3JbHyAi,5,2,1,0,1,0,2,0,6,0.8571428571428571,1,0.0,0,1,0,1,2,0,0,2,0,2,4,1
4642,70463,q5Mh1DiRxqFPerzFhySJn3OvdiZ2Qdjc,fbPkOYLVPtPgIt0MxizjfFJov3JbHyAi,6,3,2,0,2,0,1,0,8,1.1428571428571428,1,0.0,0,2,0,2,3,0,0,1,0,4,4,1
4643,70502,fd3M5GFuTNibIF234PDGuNuJ7TaPIle6,fbPkOYLVPtPgIt0MxizjfFJov3JbHyAi,11,8,3,0,2,0,11,0,24,3.4285714285714284,3,0.0,0,3,0,2,8,0,0,11,0,5,19,1
4644,70617,UNVbIrcEO0nclbN5f0xdIeSb61jrpRSX,fbPkOYLVPtPgIt0MxizjfFJov3JbHyAi,10,28,6,4,9,0,9,0,56,8.0,2,0.0,18,6,3,9,10,0,1,9,0,36,20,1
4645,70618,pE2pfmXY2JZ1ppA5N0APNqSGmVpRUVPY,fbPkOYLVPtPgIt0MxizjfFJov3JbHyAi,4,2,1,0,0,0,2,0,5,0.7142857142857143,1,0.0,0,1,0,0,2,0,0,2,0,1,4,1
4646,70620,szRdvMC9nJxtimPyvxBftIjBA99HXMVn,fbPkOYLVPtPgIt0MxizjfFJov3JbHyAi,5,2,1,0,1,0,2,0,6,0.8571428571428571,1,0.0,0,1,0,1,2,0,0,2,0,2,4,1
4647,70622,vL40lDIpwhva8z6IagRWvDtekT2W0mhZ,fbPkOYLVPtPgIt0MxizjfFJov3JbHyAi,10,8,6,0,5,7,4,0,30,4.285714285714286,2,0.0,0,6,0,5,8,7,0,4,0,11,19,1
4648,70623,MIB3h4eZc4hBNhmh6kNQRNuuqfplV8jE,fbPkOYLVPtPgIt0MxizjfFJov3JbHyAi,2,0,0,0,0,0,3,0,3,0.42857142857142855,1,0.0,0,0,0,0,0,0,0,3,0,0,3,1
4649,70624,ig7R2lu2J2odRrDTiKZUVfTrsahUIcRt,fbPkOYLVPtPgIt0MxizjfFJov3JbHyAi,5,2,1,0,1,0,3,0,7,1.0,2,0.0,0,1,0,1,2,0,0,3,0,2,5,0
4650,70625,07qmQr7YUC93IIwpmr9s2O0n03vLXYHf,fbPkOYLVPtPgIt0MxizjfFJov3JbHyAi,5,4,1,0,1,0,2,0,8,1.1428571428571428,1,0.0,1,1,0,1,3,0,0,2,0,3,5,1
4651,70626,QhtGT2PDmxENzsHDxP88jgz9lWXkKr4b,fbPkOYLVPtPgIt0MxizjfFJov3JbHyAi,9,20,9,6,9,4,1,0,49,7.0,1,0.0,3,9,5,9,17,4,1,1,0,26,23,1
4652,70627,VJsbRtMXxy8aqyccEZDzV7pPAGBosBu1,fbPkOYLVPtPgIt0MxizjfFJov3JbHyAi,30,50,32,12,13,6,15,2,130,18.571428571428573,6,0.0,7,32,11,13,43,6,1,15,2,63,67,0
4653,70629,jsdFWuQZ9wDLCnnTt28t2BLCDeZlTxUM,fbPkOYLVPtPgIt0MxizjfFJov3JbHyAi,6,5,1,0,1,0,2,0,9,1.2857142857142858,1,0.0,0,1,0,1,5,0,0,2,0,2,7,1
4654,70632,sMynuMhoZTpmWI7JIgM7Zcgv9Nw77yWq,fbPkOYLVPtPgIt0MxizjfFJov3JbHyAi,5,2,1,0,1,0,2,0,6,0.8571428571428571,1,0.0,0,1,0,1,2,0,0,2,0,2,4,1
4655,70635,DIYlLDsIX3rRB00v33V6F050gdzNiYGy,fbPkOYLVPtPgIt0MxizjfFJov3JbHyAi,10,13,9,5,5,0,3,0,35,5.0,2,0.0,1,9,4,5,12,0,1,3,0,19,16,1
4656,70636,cWnlO9T3wiOdZzNrm52Q8On5YEPOag8t,fbPkOYLVPtPgIt0MxizjfFJov3JbHyAi,14,21,2,0,2,0,11,0,36,5.142857142857143,3,0.0,1,2,0,2,20,0,0,11,0,5,31,1
4657,70637,1fleh7lPd7aghMITlPRITTq0TKiljgoj,fbPkOYLVPtPgIt0MxizjfFJov3JbHyAi,7,3,2,0,2,0,3,0,10,1.4285714285714286,2,0.0,0,2,0,2,3,0,0,3,0,4,6,1
4658,70638,xM8lVcqU5uqtxPXKRkobTl3b50GvL7Y6,fbPkOYLVPtPgIt0MxizjfFJov3JbHyAi,5,2,1,0,1,0,2,0,6,0.8571428571428571,1,0.0,0,1,0,1,2,0,0,2,0,2,4,1
4659,70641,2uadn8x6eG3s1sEJofJgCr35bh3OHGLh,fbPkOYLVPtPgIt0MxizjfFJov3JbHyAi,27,38,19,11,16,40,12,1,137,19.571428571428573,4,0.0,16,19,11,16,22,40,0,12,1,62,75,1
4660,70642,FaGf4ZENvncNMeGerxuOLnibVyMwnEb7,fbPkOYLVPtPgIt0MxizjfFJov3JbHyAi,4,2,1,0,1,0,1,0,5,0.7142857142857143,1,0.0,0,1,0,1,2,0,0,1,0,2,3,1
4661,70644,6kW13L6OI2CXAgkzbQCGiGCWDPgPVNqL,fbPkOYLVPtPgIt0MxizjfFJov3JbHyAi,8,3,2,0,2,0,5,1,13,1.8571428571428572,1,0.0,0,2,0,2,3,0,0,5,1,4,9,1
4662,70646,tuBfe6WhJei1RdPAXwFNRJbSnuTMeD4l,fbPkOYLVPtPgIt0MxizjfFJov3JbHyAi,1,0,0,0,0,0,1,0,1,0.14285714285714285,1,0.0,0,0,0,0,0,0,0,1,0,0,1,1
4663,70647,5Hvfr1gz4w1l7NMxdNIG23Iybswr6a4X,fbPkOYLVPtPgIt0MxizjfFJov3JbHyAi,5,2,1,0,1,0,2,0,6,0.8571428571428571,1,0.0,0,1,0,1,2,0,0,2,0,2,4,1
4664,70648,fdJXQSSucuzaRljy096jXgInnW2TakHQ,fbPkOYLVPtPgIt0MxizjfFJov3JbHyAi,1,0,0,0,0,0,1,0,1,0.14285714285714285,1,0.0,0,0,0,0,0,0,0,1,0,0,1,1
4665,70649,TqM5lkEeW6odNqcCIpnB8ZfnKymScjxh,fbPkOYLVPtPgIt0MxizjfFJov3JbHyAi,9,10,7,0,6,0,8,0,31,4.428571428571429,1,0.0,0,7,0,6,10,0,0,8,0,13,18,1
4666,70651,zPbUIdTRPjnN9GVjy7Vs8SVwjdhRAaUM,fbPkOYLVPtPgIt0MxizjfFJov3JbHyAi,11,30,18,0,6,54,12,1,121,17.285714285714285,6,0.0,0,18,0,6,30,54,0,12,1,24,97,1
4667,70652,RUk1UgFf8pHkjYocajMr35nYXvyKvRsO,fbPkOYLVPtPgIt0MxizjfFJov3JbHyAi,21,31,14,0,8,15,11,2,81,11.571428571428571,2,0.0,0,14,0,8,31,15,0,11,2,22,59,1
4668,70653,PNYL1Lh4wAAOtLwVLWtMerOLdRvGmWgc,fbPkOYLVPtPgIt0MxizjfFJov3JbHyAi,7,1,1,0,1,1,4,1,9,1.2857142857142858,1,0.0,0,1,0,1,1,1,0,4,1,2,7,1
4669,70655,NrraMyTwgTzYDPkTyoYsd0r0OJPy1sab,fbPkOYLVPtPgIt0MxizjfFJov3JbHyAi,7,3,2,0,2,0,6,0,13,1.8571428571428572,1,0.0,0,2,0,2,3,0,0,6,0,4,9,1
4670,70656,Nc9p0NDSJdMFoXyGCYKlMLXQtm4qOOTX,fbPkOYLVPtPgIt0MxizjfFJov3JbHyAi,7,3,2,0,2,6,6,0,19,2.7142857142857144,1,0.0,0,2,0,2,3,6,0,6,0,4,15,1
4671,70657,kF87tAiaM8moNftPhO4ia9AXwDDxrUtb,fbPkOYLVPtPgIt0MxizjfFJov3JbHyAi,11,9,5,0,2,14,13,4,47,6.714285714285714,1,0.0,0,5,0,2,9,14,0,13,4,7,40,1
4672,70658,7h3tDULs3BTNaDybaRAqNsIlSNoXgEZh,fbPkOYLVPtPgIt0MxizjfFJov3JbHyAi,11,14,6,0,4,0,7,0,31,4.428571428571429,2,0.0,1,6,0,4,13,0,0,7,0,11,20,1
4673,70659,3w3oVzXQmE457clbfwy8fl67WyFwWeZX,fbPkOYLVPtPgIt0MxizjfFJov3JbHyAi,4,3,1,0,1,0,1,0,6,0.8571428571428571,1,0.0,0,1,0,1,3,0,0,1,0,2,4,1
4674,70661,eLqag6twmL6nT6SLVrpY07QGG3bytKwe,fbPkOYLVPtPgIt0MxizjfFJov3JbHyAi,4,3,2,0,2,0,2,0,9,1.2857142857142858,1,0.0,0,2,0,2,3,0,0,2,0,4,5,1
4675,70664,8djQJACWabqqdfUYlZxiiBK5fRdO0gWZ,fbPkOYLVPtPgIt0MxizjfFJov3JbHyAi,24,30,16,13,8,9,6,0,82,11.714285714285714,3,0.0,6,16,11,8,24,9,2,6,0,41,41,1
4676,70666,ThmrVFQiXEXdtbVq9OcHgxf5egZE7CCF,fbPkOYLVPtPgIt0MxizjfFJov3JbHyAi,1,0,0,0,0,0,1,0,1,0.14285714285714285,1,0.0,0,0,0,0,0,0,0,1,0,0,1,1
4677,70669,NrAjCwSdkokFEs2cMTtwLegWozRaakkE,fbPkOYLVPtPgIt0MxizjfFJov3JbHyAi,7,3,2,0,2,0,2,0,9,1.2857142857142858,1,0.0,0,2,0,2,3,0,0,2,0,4,5,1
4678,70670,mgRmoo6F9KYYizHMOajedFcuJHtEV6by,fbPkOYLVPtPgIt0MxizjfFJov3JbHyAi,22,21,7,14,8,0,2,0,52,7.428571428571429,1,0.0,6,7,14,8,15,0,0,2,0,35,17,1
4679,70672,XRCyFAenNfq06SRijoW2bL3eLeq7TTnH,fbPkOYLVPtPgIt0MxizjfFJov3JbHyAi,1,0,0,0,0,0,1,0,1,0.14285714285714285,1,0.0,0,0,0,0,0,0,0,1,0,0,1,1
4680,70674,tsQNS0TFi4T2OwDWxOZsXYloXeaBeZAv,fbPkOYLVPtPgIt0MxizjfFJov3JbHyAi,16,19,10,10,8,0,2,0,49,7.0,2,0.0,5,10,10,8,14,0,0,2,0,33,16,1
4681,70675,qgTFbAMyZczl8sJiC9JGSI0pTfFVEsq0,fbPkOYLVPtPgIt0MxizjfFJov3JbHyAi,2,0,0,0,0,0,3,0,3,0.42857142857142855,1,0.0,0,0,0,0,0,0,0,3,0,0,3,1
4682,70676,Pv9LrfjnRw1WO1VwPNHCu7aKxUz6zC8i,fbPkOYLVPtPgIt0MxizjfFJov3JbHyAi,11,17,13,0,7,5,5,0,47,6.714285714285714,3,0.0,0,13,0,7,17,5,0,5,0,20,27,1
4683,70677,zmlL73g2U1Ek37ZDQ2H6P7dwK1MBsxuX,fbPkOYLVPtPgIt0MxizjfFJov3JbHyAi,11,22,12,2,8,11,7,0,62,8.857142857142858,3,0.0,5,12,2,8,17,11,0,7,0,27,35,1
4684,70678,o8iN3RNsKXCFYghfUgBvPvRXa514UVMy,fbPkOYLVPtPgIt0MxizjfFJov3JbHyAi,1,0,0,0,0,0,1,0,1,0.14285714285714285,1,0.0,0,0,0,0,0,0,0,1,0,0,1,1
4685,70682,KAxSek3GgKlkDfM652adYCX6zjbSz36L,fbPkOYLVPtPgIt0MxizjfFJov3JbHyAi,7,5,4,0,2,0,2,0,13,1.8571428571428572,1,0.0,0,4,0,2,5,0,0,2,0,6,7,1
4686,70706,2j7JDJ8MsffyV0kSC0vh7baFkUIS4GAx,fbPkOYLVPtPgIt0MxizjfFJov3JbHyAi,31,67,24,30,27,0,9,0,157,22.428571428571427,4,0.0,39,24,24,27,28,0,6,9,0,114,43,1
4687,70781,ctdO04zd7K8QUa5HFdH2dxaEs6nEQGcX,fbPkOYLVPtPgIt0MxizjfFJov3JbHyAi,7,5,3,0,2,0,1,0,11,1.5714285714285714,1,0.0,0,3,0,2,5,0,0,1,0,5,6,0
4688,70820,ELhlMyuHt1scQfOhkxfCzXRENMteryFF,fbPkOYLVPtPgIt0MxizjfFJov3JbHyAi,1,0,0,0,0,0,1,0,1,0.14285714285714285,1,0.0,0,0,0,0,0,0,0,1,0,0,1,1
4689,70870,NaTkGN0OVzlcYhXnPctl6N7eYxY7z7gT,fbPkOYLVPtPgIt0MxizjfFJov3JbHyAi,5,2,1,0,1,0,4,0,8,1.1428571428571428,1,0.0,0,1,0,1,2,0,0,4,0,2,6,1
4690,70897,83JPfkin3GX4GLKqML2uaHSZ5KvsuJhM,fbPkOYLVPtPgIt0MxizjfFJov3JbHyAi,6,7,4,0,3,0,2,0,16,2.2857142857142856,1,0.0,0,4,0,3,7,0,0,2,0,7,9,1
4691,70941,hplRuUXyLFhHcMqMJcb12YjqquTYp3Qw,bWdj2GDclj5ofokWjzoa5jAwMkxCykd6,9,5,2,0,1,1,8,1,18,2.5714285714285716,1,0.0,0,2,0,1,5,1,0,8,1,3,15,1
4692,70964,AtOHbVb7kxzZIoD2M5RWKjBCYCoDUPL6,SpATywNh6bZuzm8s1ceuBUnMUAeoAHHw,8,9,4,0,0,0,2,0,15,2.142857142857143,1,0.0,3,4,0,0,6,0,0,2,0,7,8,0
4693,70969,Ooaq1toVrKJC9KROMnT52Id1rqx2sDam,A3fsA9Zfv1X2fVEQhTw51lKENdNrEqT3,22,16,13,0,10,49,12,1,101,14.428571428571429,4,0.0,0,13,0,10,16,49,0,12,1,23,78,0
4694,71001,Qty87BeKrf3ZgzVA2PT9rBe28vADAPbJ,A3fsA9Zfv1X2fVEQhTw51lKENdNrEqT3,9,7,5,0,4,0,2,0,18,2.5714285714285716,2,0.0,0,5,0,4,7,0,0,2,0,9,9,0
4695,71078,dfEK3xvueeR9teWVma5VAaO4dthOOslM,bWdj2GDclj5ofokWjzoa5jAwMkxCykd6,39,30,17,95,16,0,22,2,182,26.0,3,0.0,11,17,85,16,19,0,10,22,2,129,53,1
4696,71164,GqY8cM6bEQ2o2zTrfF7msueNZ1f4HNE4,A3fsA9Zfv1X2fVEQhTw51lKENdNrEqT3,7,4,1,0,1,0,2,0,8,1.1428571428571428,1,0.0,0,1,0,1,4,0,0,2,0,2,6,1
4697,71174,axaScF3P7Dmq9RVjqcR7oOXvuGJjIWKx,SpATywNh6bZuzm8s1ceuBUnMUAeoAHHw,17,34,18,24,9,9,16,2,112,16.0,4,0.0,5,18,19,9,29,9,5,16,2,51,61,0
4698,71212,VaOhD86uWnK2TjloSi50DgiXbw9C3K0T,A3fsA9Zfv1X2fVEQhTw51lKENdNrEqT3,7,9,1,0,1,0,4,0,15,2.142857142857143,1,0.0,0,1,0,1,9,0,0,4,0,2,13,1
4699,71222,mRThjjGON0zU0Y2plEdpqVN16fEiXwSr,bWdj2GDclj5ofokWjzoa5jAwMkxCykd6,9,9,5,0,3,0,7,0,24,3.4285714285714284,1,0.0,0,5,0,3,9,0,0,7,0,8,16,1
4700,71272,CeGIsWlT0KBVS1hQGCUY2KCY4J9xzr3t,SpATywNh6bZuzm8s1ceuBUnMUAeoAHHw,17,14,1,20,1,54,13,0,103,14.714285714285714,4,0.0,2,1,16,1,12,54,4,13,0,20,83,1
4701,71362,f6IvpzZQ4NKKZIUTkgWEi3BVq577qLnM,SpATywNh6bZuzm8s1ceuBUnMUAeoAHHw,21,24,5,27,3,8,8,0,75,10.714285714285714,2,0.0,11,5,25,3,13,8,2,8,0,44,31,0
4702,71393,bzlTCtIUcO5BfACSIQwT3PRYSdK0QGTr,SpATywNh6bZuzm8s1ceuBUnMUAeoAHHw,14,10,4,10,3,0,4,0,31,4.428571428571429,1,0.0,5,4,8,3,5,0,2,4,0,20,11,1
4703,71478,au4q0hHoeIchXXu4o0X9kRH2tLR2LkOi,SpATywNh6bZuzm8s1ceuBUnMUAeoAHHw,6,2,1,0,1,0,3,0,7,1.0,1,0.0,0,1,0,1,2,0,0,3,0,2,5,1
4704,71534,6kmRTTlm2tGjO1GkeO8yvcp6lmCvKO0m,A3fsA9Zfv1X2fVEQhTw51lKENdNrEqT3,5,2,1,0,1,0,4,0,8,1.1428571428571428,3,0.0,0,1,0,1,2,0,0,4,0,2,6,1
4705,71700,qGPfY7GDQqrO1DPuPdsJnIrEGeJp1MpX,SpATywNh6bZuzm8s1ceuBUnMUAeoAHHw,14,39,4,18,2,14,11,0,88,12.571428571428571,3,0.0,8,4,15,2,31,14,3,11,0,29,59,1
4706,71712,TztthVt5KMop1hWx6wFArC8xg8H9VhnG,SpATywNh6bZuzm8s1ceuBUnMUAeoAHHw,13,11,7,4,3,5,8,0,38,5.428571428571429,4,0.0,1,7,3,3,10,5,1,8,0,14,24,1
4707,71802,YkfUrC2IjNSUcSjXepY6IHt6QpgdD85G,SpATywNh6bZuzm8s1ceuBUnMUAeoAHHw,25,32,17,7,10,10,10,0,86,12.285714285714286,3,0.0,9,17,7,10,23,10,0,10,0,43,43,1
4708,71842,ErXNe7efkRl64E8pJRc91VCcYddra1a4,SpATywNh6bZuzm8s1ceuBUnMUAeoAHHw,19,26,3,32,0,16,16,2,95,13.571428571428571,5,0.0,8,3,26,0,18,16,6,16,2,37,58,0
4709,71844,yjE4tqKQR2WC3DLToz6n1TUHIiH6cjX1,SpATywNh6bZuzm8s1ceuBUnMUAeoAHHw,9,13,6,0,4,0,7,0,30,4.285714285714286,4,0.0,0,6,0,4,13,0,0,7,0,10,20,0
4710,71873,nBOtam7XKIa3PxdTZIAJPzc36wtmbKH4,A3fsA9Zfv1X2fVEQhTw51lKENdNrEqT3,4,0,0,0,0,1,6,0,7,1.0,1,0.0,0,0,0,0,0,1,0,6,0,0,7,1
4711,71935,Cg7iNBAj8Tw36V9R4YA417eEEGy00kAz,SpATywNh6bZuzm8s1ceuBUnMUAeoAHHw,13,16,6,9,1,1,7,0,40,5.714285714285714,3,0.0,5,6,8,1,11,1,1,7,0,20,20,0
4712,71970,51xlIGXGRsE7YMneHTw1mXYuaEFgELF3,A3fsA9Zfv1X2fVEQhTw51lKENdNrEqT3,28,18,17,0,14,0,1,0,50,7.142857142857143,1,0.0,0,17,0,14,18,0,0,1,0,31,19,0
4713,71985,1LkX4t7QGG0LPbqqJvnwJmrweFNAYkvm,bWdj2GDclj5ofokWjzoa5jAwMkxCykd6,9,5,3,0,2,0,4,0,14,2.0,1,0.0,0,3,0,2,5,0,0,4,0,5,9,1
4714,72028,rGUcxYNOJhuu9K9SMgsP5W3xbSiphSwH,SpATywNh6bZuzm8s1ceuBUnMUAeoAHHw,16,22,8,14,3,12,8,1,68,9.714285714285714,3,0.0,9,8,14,3,13,12,0,8,1,34,34,1
4715,72034,4D3Mr9GTnnSeHqe4k4RduVTIffzivKXV,SpATywNh6bZuzm8s1ceuBUnMUAeoAHHw,24,20,10,26,4,2,7,1,70,10.0,2,0.0,8,10,25,4,12,2,1,7,1,47,23,1
4716,72066,FCXISzNoe8FGZLEA3b4ES0P455MShvJn,SpATywNh6bZuzm8s1ceuBUnMUAeoAHHw,4,2,1,0,1,0,1,0,5,0.7142857142857143,1,0.0,0,1,0,1,2,0,0,1,0,2,3,1
4717,72123,a8HvMkBRr1QnoDxivZVIhrkeiZFWplka,bWdj2GDclj5ofokWjzoa5jAwMkxCykd6,16,28,16,28,10,1,10,0,93,13.285714285714286,3,0.0,5,16,21,10,23,1,7,10,0,52,41,1
4718,72200,ZRC032b6bAMTdyW8JO1vU2llk0mQNPce,SpATywNh6bZuzm8s1ceuBUnMUAeoAHHw,14,27,8,20,2,21,13,4,95,13.571428571428571,2,0.0,11,8,17,2,16,21,3,13,4,38,57,1
4719,72206,2t2mFcXnjCSGOBpya1wSPFZtPiud9I2F,SpATywNh6bZuzm8s1ceuBUnMUAeoAHHw,15,32,0,17,0,0,9,1,59,8.428571428571429,3,0.0,14,0,15,0,18,0,2,9,1,29,30,0
4720,72215,6ngga8jBuXKmnKYc00TBjXbVEmc0f4XL,SpATywNh6bZuzm8s1ceuBUnMUAeoAHHw,9,6,4,0,3,0,2,0,15,2.142857142857143,2,0.0,0,4,0,3,6,0,0,2,0,7,8,1
4721,72250,SozblGZP0jqptTVCGb8oKsTCWZZGfIvg,SpATywNh6bZuzm8s1ceuBUnMUAeoAHHw,7,3,2,0,2,0,2,0,9,1.2857142857142858,1,0.0,0,2,0,2,3,0,0,2,0,4,5,0
4722,72268,hluzPB1y7zkKLSSzVkJvXfWNLyDAuRho,RXDvfPUBYFlVdlueBFbLW0mhhAyGEqpt,13,14,9,0,5,0,5,4,37,5.285714285714286,2,0.0,0,9,0,5,14,0,0,5,4,14,23,1
4723,72327,vpU9FFM3siBSv5Tq74CkiYBZ5nbD9oub,SpATywNh6bZuzm8s1ceuBUnMUAeoAHHw,23,26,1,28,0,2,5,1,63,9.0,2,0.0,10,1,26,0,16,2,2,5,1,37,26,1
4724,72370,WI9rk8aS11tBAJzjcX0JSIgomYYRQVjW,SpATywNh6bZuzm8s1ceuBUnMUAeoAHHw,17,31,2,16,2,5,14,0,70,10.0,4,0.0,2,2,15,2,29,5,1,14,0,21,49,0
4725,72371,iahhmqoMx53j5nO5miK92n3wdWI8ut4z,RXDvfPUBYFlVdlueBFbLW0mhhAyGEqpt,5,2,1,0,1,0,4,0,8,1.1428571428571428,2,0.0,0,1,0,1,2,0,0,4,0,2,6,1
4726,72375,jpXIq3stqWScWG27acYJbNKpdTmc6kli,bWdj2GDclj5ofokWjzoa5jAwMkxCykd6,37,73,44,190,11,13,39,0,370,52.857142857142854,8,0.0,6,44,183,11,67,13,7,39,0,244,126,0
4727,72412,NIlxh2g7VTAquieuVc9RGErPkOzbSh2Z,SpATywNh6bZuzm8s1ceuBUnMUAeoAHHw,17,32,13,19,3,0,11,0,78,11.142857142857142,2,0.0,4,13,17,3,28,0,2,11,0,37,41,1
4728,72416,iPefB9aOL6bAjIaS6Gks903vpOsT6Kof,SpATywNh6bZuzm8s1ceuBUnMUAeoAHHw,8,6,1,0,1,0,6,0,14,2.0,1,0.0,0,1,0,1,6,0,0,6,0,2,12,1
4729,72426,B9BCqbSn4dXX7PoOMPBly9mxS1ETXKHH,SpATywNh6bZuzm8s1ceuBUnMUAeoAHHw,7,14,6,0,2,0,2,0,24,3.4285714285714284,2,0.0,5,6,0,2,9,0,0,2,0,13,11,1
4730,72429,GwQix8XlCp4q9CmSxf5jg9NO42lfroib,SpATywNh6bZuzm8s1ceuBUnMUAeoAHHw,1,0,0,0,0,0,2,0,2,0.2857142857142857,2,0.0,0,0,0,0,0,0,0,2,0,0,2,1
4731,72442,LWfPQEZcfqcdY03cxPtuNt5LIUXK1J1h,bWdj2GDclj5ofokWjzoa5jAwMkxCykd6,18,21,1,80,5,25,22,1,155,22.142857142857142,3,0.0,9,1,75,5,12,25,5,22,1,90,65,1
4732,72448,Ln23tN1YAlBNEBT8tndbR9JhZVhVTsS7,SpATywNh6bZuzm8s1ceuBUnMUAeoAHHw,12,15,7,0,4,2,12,1,41,5.857142857142857,2,0.0,4,7,0,4,11,2,0,12,1,15,26,1
4733,72451,9FaPBbsYKn0C9myyRYf9vYNhns2eJDpD,bWdj2GDclj5ofokWjzoa5jAwMkxCykd6,12,14,5,0,4,0,14,1,38,5.428571428571429,4,0.0,2,5,0,4,12,0,0,14,1,11,27,0
4734,72452,MU4dVyJTD7iIRSTZIdJZ9VoLOxogfKQN,A3fsA9Zfv1X2fVEQhTw51lKENdNrEqT3,44,20,15,86,11,5,8,0,145,20.714285714285715,3,0.0,1,15,74,11,19,5,12,8,0,101,44,0
4735,72468,clbUGnOQsN7CuaV7idGJ2LVbYN3t8qC3,bWdj2GDclj5ofokWjzoa5jAwMkxCykd6,21,50,3,65,2,8,11,1,140,20.0,4,0.0,19,3,65,2,31,8,0,11,1,89,51,0
4736,72485,H1nbdkC904EOh8jWeVVcV5piaqMVBsli,RXDvfPUBYFlVdlueBFbLW0mhhAyGEqpt,41,38,3,84,3,0,9,2,139,19.857142857142858,3,0.0,9,3,83,3,29,0,1,9,2,98,41,0
4737,72532,QPoypIc1fBONo2zEXZGrqFPP68plPMOG,A3fsA9Zfv1X2fVEQhTw51lKENdNrEqT3,41,29,1,82,0,1,15,3,131,18.714285714285715,1,0.0,3,1,64,0,26,1,18,15,3,68,63,0
4738,72588,5fUv2a4WMEi2Bc60cQo0Uzo1I7SufPfI,SpATywNh6bZuzm8s1ceuBUnMUAeoAHHw,24,50,0,24,0,13,8,0,95,13.571428571428571,2,0.0,8,0,23,0,42,13,1,8,0,31,64,0
4739,72685,2IlOpdUgsPu5FVltj0flScFk4CeI7uHm,RXDvfPUBYFlVdlueBFbLW0mhhAyGEqpt,31,27,16,26,7,7,4,0,87,12.428571428571429,3,0.0,4,16,26,7,23,7,0,4,0,53,34,0
4740,72692,H2pnCC5fUi5Ho09aPqAE97vnlsM8FGBU,A3fsA9Zfv1X2fVEQhTw51lKENdNrEqT3,44,15,7,162,1,0,6,0,191,27.285714285714285,2,0.0,3,7,153,1,12,0,9,6,0,164,27,0
4741,72701,h2ynGKkFoAy58qRjHGCAYsp0Afa0leqG,SpATywNh6bZuzm8s1ceuBUnMUAeoAHHw,6,5,0,0,0,0,6,0,11,1.5714285714285714,1,0.0,0,0,0,0,5,0,0,6,0,0,11,1
4742,72716,0VjAWG5aLQgXyXeTqTPnha195szz41mH,RXDvfPUBYFlVdlueBFbLW0mhhAyGEqpt,50,53,20,111,20,36,11,2,253,36.142857142857146,2,0.0,28,20,104,20,25,36,7,11,2,172,81,1
4743,72721,1UwRwlLE0RwxPaY5NbrfjlESNYQllZZa,A3fsA9Zfv1X2fVEQhTw51lKENdNrEqT3,5,2,1,0,1,0,2,0,6,0.8571428571428571,1,0.0,0,1,0,1,2,0,0,2,0,2,4,0
4744,72844,pQdSl7i5ZuZeH9uPILgdHrvwskp4vc4V,A3fsA9Zfv1X2fVEQhTw51lKENdNrEqT3,2,0,0,0,0,0,2,0,2,0.2857142857142857,1,0.0,0,0,0,0,0,0,0,2,0,0,2,1
4745,72847,OUbh6hvaOJDp9RK7kgTBzzPmjzmkYhZF,bWdj2GDclj5ofokWjzoa5jAwMkxCykd6,9,7,1,70,0,0,6,0,84,12.0,1,0.0,1,1,68,0,6,0,2,6,0,70,14,1
4746,72850,QqE2Xjwy9gUzOvFdkDqAwAaNZLBZkxvd,G8EPVSXsOYB5YQWZGiz1aVq5Pgr2GrQu,20,24,3,0,1,18,23,1,70,10.0,7,0.0,0,3,0,1,24,18,0,23,1,4,66,1
4747,72922,ria1rZm5v1iNiSZkl2at79lKlYWZvHeF,SpATywNh6bZuzm8s1ceuBUnMUAeoAHHw,24,47,0,21,0,45,13,2,128,18.285714285714285,2,0.0,10,0,21,0,37,45,0,13,2,31,97,0
4748,72951,Ou3iHiBDr7O5XF3iHhMwgAvySH9eHz42,RXDvfPUBYFlVdlueBFbLW0mhhAyGEqpt,6,7,1,0,0,0,2,0,10,1.4285714285714286,1,0.0,0,1,0,0,7,0,0,2,0,1,9,1
4749,72967,NYagfMVvA1FDdZ7PZwzv8OVDbZ0jsy8R,SpATywNh6bZuzm8s1ceuBUnMUAeoAHHw,3,0,0,0,0,1,2,0,3,0.42857142857142855,1,0.0,0,0,0,0,0,1,0,2,0,0,3,1
4750,73009,l569pvTkqA1hwU8mlPA8zjV2SyK4a7w2,SpATywNh6bZuzm8s1ceuBUnMUAeoAHHw,20,39,0,34,0,1,2,0,76,10.857142857142858,2,0.0,12,0,29,0,27,1,5,2,0,41,35,0
4751,73036,zcVtFTrToAbXyBSFxcFkJCnMsb7Jt1Wc,SpATywNh6bZuzm8s1ceuBUnMUAeoAHHw,4,2,0,0,0,0,2,0,4,0.5714285714285714,1,0.0,0,0,0,0,2,0,0,2,0,0,4,1
4752,73180,uoufNidjh1zD724gB2zYdd5MROgtTWHO,A3fsA9Zfv1X2fVEQhTw51lKENdNrEqT3,27,19,16,0,14,0,2,0,51,7.285714285714286,1,0.0,0,16,0,14,19,0,0,2,0,30,21,1
4753,73500,m7jLYh84m9f53uDPmmpRCKYuGkwpenOB,fbPkOYLVPtPgIt0MxizjfFJov3JbHyAi,7,5,2,0,2,0,2,0,11,1.5714285714285714,1,0.0,2,2,0,2,3,0,0,2,0,6,5,1
4754,73514,eAreSTsX7Dih2J54vyrFl8ByPnikZNX4,fbPkOYLVPtPgIt0MxizjfFJov3JbHyAi,29,52,19,19,16,45,16,2,169,24.142857142857142,4,0.0,21,19,16,16,31,45,3,16,2,72,97,0
4755,73551,tpXvTahACNQY51r2DDxBjRZh56EvpTZe,fbPkOYLVPtPgIt0MxizjfFJov3JbHyAi,10,6,3,0,3,3,9,1,25,3.5714285714285716,1,0.0,2,3,0,3,4,3,0,9,1,8,17,1
4756,73885,zlC9nEdRrqLSPX386Mctiz9fIdlU29GI,7GRhBDsirIGkRZBtSMEzNTyDr2JQm4xx,32,55,22,28,21,0,3,0,129,18.428571428571427,3,0.0,29,22,25,21,26,0,3,3,0,97,32,1
4757,73899,4hEMELZWHLOm7hvjgIF8HpEdrI7mKYR9,7GRhBDsirIGkRZBtSMEzNTyDr2JQm4xx,1,0,0,0,0,0,4,0,4,0.5714285714285714,1,0.0,0,0,0,0,0,0,0,4,0,0,4,1
4758,73907,u40Wnz941IKPEKg6evh8MfJNEbnPlztD,7GRhBDsirIGkRZBtSMEzNTyDr2JQm4xx,1,0,0,0,0,0,1,0,1,0.14285714285714285,1,0.0,0,0,0,0,0,0,0,1,0,0,1,1
4759,73909,SQIuOWvxkt3YnLUzk8J5rhFP8qdbWUct,7GRhBDsirIGkRZBtSMEzNTyDr2JQm4xx,9,9,1,0,1,0,6,2,19,2.7142857142857144,1,0.0,4,1,0,1,5,0,0,6,2,6,13,1
4760,73914,nBvjxfottsOCrOycyCAN2ZrAK5pyyTJB,7GRhBDsirIGkRZBtSMEzNTyDr2JQm4xx,1,0,0,0,0,0,1,0,1,0.14285714285714285,1,0.0,0,0,0,0,0,0,0,1,0,0,1,1
4761,73925,QJJ8wBq7nom8t0h6F4ecboFqFhwa246L,7GRhBDsirIGkRZBtSMEzNTyDr2JQm4xx,1,0,0,0,0,0,2,0,2,0.2857142857142857,1,0.0,0,0,0,0,0,0,0,2,0,0,2,1
4762,73926,MrlzmdVJr5WOflJfAlRUbmdI8vfVUpTE,7GRhBDsirIGkRZBtSMEzNTyDr2JQm4xx,7,4,1,2,1,0,2,0,10,1.4285714285714286,1,0.0,1,1,2,1,3,0,0,2,0,5,5,1
4763,73937,28W5CJrYp73LQgjHivjzAixkCQuqTCh6,A3fsA9Zfv1X2fVEQhTw51lKENdNrEqT3,23,36,14,0,12,1,4,0,67,9.571428571428571,2,0.0,0,14,0,12,36,1,0,4,0,26,41,0
4764,73941,vaBnFuKrFzaRvpuQOGO2KMutesPcXn34,SpATywNh6bZuzm8s1ceuBUnMUAeoAHHw,21,27,11,17,5,2,5,1,68,9.714285714285714,2,0.0,11,11,14,5,16,2,3,5,1,41,27,0
4765,73951,7nQB7cjVdr2HijR82OoX1oMRPa42JjfY,7GRhBDsirIGkRZBtSMEzNTyDr2JQm4xx,11,4,2,4,2,0,5,0,17,2.4285714285714284,1,0.0,1,2,3,2,3,0,1,5,0,8,9,1
4766,73970,j32U9Y949ZW1nXMwG0aPWZXCmluBzel9,7GRhBDsirIGkRZBtSMEzNTyDr2JQm4xx,3,4,1,0,0,0,1,0,6,0.8571428571428571,1,0.0,0,1,0,0,4,0,0,1,0,1,5,1
4767,73972,fK0ybxlrUhmgrAr6gFQPIfSHLrJ4RdyL,7GRhBDsirIGkRZBtSMEzNTyDr2JQm4xx,27,49,16,32,12,0,10,0,119,17.0,1,0.0,27,16,29,12,22,0,3,10,0,84,35,1
4768,73976,7mxOgTUP9lSjAUBOPZ9fhNEhVSHMvF2J,A3fsA9Zfv1X2fVEQhTw51lKENdNrEqT3,1,0,0,0,0,0,3,0,3,0.42857142857142855,2,0.0,0,0,0,0,0,0,0,3,0,0,3,0
4769,74004,obFplu8p0J5bdsesTSoaj6Bc4UGbTB6M,7GRhBDsirIGkRZBtSMEzNTyDr2JQm4xx,1,0,0,0,0,0,2,0,2,0.2857142857142857,1,0.0,0,0,0,0,0,0,0,2,0,0,2,1
4770,74017,2kb07SQlxjCbOTE1DAO38U9f5IsTds9o,7GRhBDsirIGkRZBtSMEzNTyDr2JQm4xx,10,6,4,0,4,0,2,0,16,2.2857142857142856,1,0.0,0,4,0,4,6,0,0,2,0,8,8,1
4771,74024,EPmLjBxeWpwhjwoRgtmLV8RkhFOu2zzj,7GRhBDsirIGkRZBtSMEzNTyDr2JQm4xx,2,0,0,0,0,0,2,0,2,0.2857142857142857,1,0.0,0,0,0,0,0,0,0,2,0,0,2,1
4772,74026,zQ1YX4nsnROAkBYQ0FJFP0QSnhVmUslT,7GRhBDsirIGkRZBtSMEzNTyDr2JQm4xx,1,0,0,0,0,0,1,0,1,0.14285714285714285,1,0.0,0,0,0,0,0,0,0,1,0,0,1,1
4773,74040,CopXShP3zDILDEKJnKili2vT6Sl9AJnD,SpATywNh6bZuzm8s1ceuBUnMUAeoAHHw,2,0,0,0,0,0,2,0,2,0.2857142857142857,1,0.0,0,0,0,0,0,0,0,2,0,0,2,1
4774,74042,vQAS0obh0bWlfi2VaK7gKWVKUzPkWalY,7GRhBDsirIGkRZBtSMEzNTyDr2JQm4xx,7,2,1,0,1,0,4,0,8,1.1428571428571428,1,0.0,0,1,0,1,2,0,0,4,0,2,6,1
4775,74052,2TaYh8ycp9sh1x4LkBWnthNJDMCHE85T,7GRhBDsirIGkRZBtSMEzNTyDr2JQm4xx,29,59,20,46,16,1,8,0,150,21.428571428571427,2,0.0,31,20,37,16,28,1,9,8,0,104,46,1
4776,74059,TRGa3GfGhognO7jXiVPcSrWpnBuIeInO,7GRhBDsirIGkRZBtSMEzNTyDr2JQm4xx,7,7,5,0,0,0,3,0,15,2.142857142857143,1,0.0,0,5,0,0,7,0,0,3,0,5,10,1
4777,74075,DfnO2Gp0WpLIOOGCReKHPkH7dv25s88Q,7GRhBDsirIGkRZBtSMEzNTyDr2JQm4xx,1,0,0,0,0,0,1,0,1,0.14285714285714285,1,0.0,0,0,0,0,0,0,0,1,0,0,1,1
4778,74078,yqOOYx1jXUdpDzqGMMXJAQVE6fglCaFI,7GRhBDsirIGkRZBtSMEzNTyDr2JQm4xx,2,0,0,0,0,0,3,0,3,0.42857142857142855,1,0.0,0,0,0,0,0,0,0,3,0,0,3,1
4779,74086,a4naBAZCHNqdVKKeEiKQVvfTN6r4f6eG,bWdj2GDclj5ofokWjzoa5jAwMkxCykd6,9,12,6,42,4,4,6,1,75,10.714285714285714,1,0.0,3,6,41,4,9,4,1,6,1,54,21,1
4780,74095,f66qV2E6gvO4HMZXdbtN6yW4m9klwB2A,7GRhBDsirIGkRZBtSMEzNTyDr2JQm4xx,2,0,0,0,0,0,2,0,2,0.2857142857142857,1,0.0,0,0,0,0,0,0,0,2,0,0,2,1
4781,74114,OakZIwMalw5UgG2N0rTydClOEPiV8rki,SpATywNh6bZuzm8s1ceuBUnMUAeoAHHw,5,3,1,0,1,0,3,0,8,1.1428571428571428,1,0.0,0,1,0,1,3,0,0,3,0,2,6,0
4782,74115,NFrovzSNFaGOKX4ckxlOk5TIATwQWZDv,SpATywNh6bZuzm8s1ceuBUnMUAeoAHHw,17,20,13,24,5,11,10,1,84,12.0,1,0.0,3,13,18,5,17,11,6,10,1,39,45,0
4783,74117,ehQYO42YZfN9JqdFqKxgBFmu1fmVCsCo,7GRhBDsirIGkRZBtSMEzNTyDr2JQm4xx,8,1,1,0,1,3,9,0,15,2.142857142857143,1,0.0,0,1,0,1,1,3,0,9,0,2,13,1
4784,74121,Ym1ZTRs6QB0e3lMSh4qwLaB0p6ohf0Ak,RXDvfPUBYFlVdlueBFbLW0mhhAyGEqpt,48,63,30,73,26,7,5,0,204,29.142857142857142,2,0.0,26,30,64,26,37,7,9,5,0,146,58,0
4785,74122,MkhWkWrDBg7jFp3XklVC8uZQ46nAon3u,7GRhBDsirIGkRZBtSMEzNTyDr2JQm4xx,16,40,15,8,3,0,7,0,73,10.428571428571429,4,0.0,5,15,6,3,35,0,2,7,0,29,44,1
4786,74123,AisGNT34d6x1DicMgidteYUWukPQUQ7X,7GRhBDsirIGkRZBtSMEzNTyDr2JQm4xx,1,0,0,0,0,0,2,0,2,0.2857142857142857,2,0.0,0,0,0,0,0,0,0,2,0,0,2,1
4787,74136,ogJhjZ6JRse1i9Rm200W41y6knKdib4X,7GRhBDsirIGkRZBtSMEzNTyDr2JQm4xx,7,3,2,0,2,0,2,0,9,1.2857142857142858,1,0.0,0,2,0,2,3,0,0,2,0,4,5,1
4788,74160,fkpoiY9BcwTpPdjkd5ID0mAyCrJQOIvN,7GRhBDsirIGkRZBtSMEzNTyDr2JQm4xx,7,3,2,0,2,0,2,0,9,1.2857142857142858,1,0.0,0,2,0,2,3,0,0,2,0,4,5,1
4789,74224,s8rbNwiDb6Ued6nUvpbwuDl2s256fOiD,SpATywNh6bZuzm8s1ceuBUnMUAeoAHHw,10,7,0,12,0,0,3,0,22,3.142857142857143,1,0.0,2,0,9,0,5,0,3,3,0,11,11,1
4790,74245,2ZDZeGxlSkOYdQNOELblzmlZJh9Z3y1x,SpATywNh6bZuzm8s1ceuBUnMUAeoAHHw,13,17,14,6,8,0,3,0,48,6.857142857142857,2,0.0,0,14,5,8,17,0,1,3,0,27,21,0
4791,74262,USFNJQ0DS4O3ARJSYADvtg2Aw3GLb3J9,SpATywNh6bZuzm8s1ceuBUnMUAeoAHHw,10,11,4,7,2,0,3,0,27,3.857142857142857,3,0.0,0,4,6,2,11,0,1,3,0,12,15,1
4792,74268,NFrovzSNFaGOKX4ckxlOk5TIATwQWZDv,RXDvfPUBYFlVdlueBFbLW0mhhAyGEqpt,8,7,6,0,2,2,5,1,23,3.2857142857142856,1,0.0,0,6,0,2,7,2,0,5,1,8,15,1
4793,74275,Qr56xJpKpx3PDtASRPf6XQoHmcGp3CKT,7GRhBDsirIGkRZBtSMEzNTyDr2JQm4xx,1,0,0,0,0,0,3,0,3,0.42857142857142855,2,0.0,0,0,0,0,0,0,0,3,0,0,3,1
4794,74292,a4RYqILKcnu8c617gYSbD0KQIm9DqZnc,7GRhBDsirIGkRZBtSMEzNTyDr2JQm4xx,7,4,2,2,2,0,1,0,11,1.5714285714285714,1,0.0,1,2,2,2,3,0,0,1,0,7,4,1
4795,74293,1484VvY7Fi4yz6Sx6JQlO6okKw4a6Bw6,7GRhBDsirIGkRZBtSMEzNTyDr2JQm4xx,3,3,0,0,0,0,1,0,4,0.5714285714285714,1,0.0,0,0,0,0,3,0,0,1,0,0,4,1
4796,74302,Na52PtAqm4VlTMUv1OPLGNjij0a5votC,7GRhBDsirIGkRZBtSMEzNTyDr2JQm4xx,6,7,3,4,1,0,1,0,16,2.2857142857142856,1,0.0,1,3,3,1,6,0,1,1,0,8,8,1
4797,74323,fCmdFT6vVaKttJ0wsJVd3YILMXjqgUpl,7GRhBDsirIGkRZBtSMEzNTyDr2JQm4xx,8,8,4,0,3,0,4,0,19,2.7142857142857144,1,0.0,2,4,0,3,6,0,0,4,0,9,10,1
4798,74329,vCnaR7A3EMdV2eOQ4pBMh0byIjK5VwLE,SpATywNh6bZuzm8s1ceuBUnMUAeoAHHw,3,3,0,0,0,0,1,0,4,0.5714285714285714,1,0.0,0,0,0,0,3,0,0,1,0,0,4,1
4799,74333,Dc9OIUGhQBh3pdZe3Ppn36a1Oo81Nm8J,RXDvfPUBYFlVdlueBFbLW0mhhAyGEqpt,5,3,0,0,0,0,2,0,5,0.7142857142857143,1,0.0,0,0,0,0,3,0,0,2,0,0,5,1
4800,74342,GCXdwkqD60eGG5W317sN3ZNf27MOQY4U,7GRhBDsirIGkRZBtSMEzNTyDr2JQm4xx,1,0,0,0,0,0,1,0,1,0.14285714285714285,1,0.0,0,0,0,0,0,0,0,1,0,0,1,1
4801,74361,TvtViclCsd2PmV5PrW2DKEwPmoLOSaRh,7GRhBDsirIGkRZBtSMEzNTyDr2JQm4xx,16,23,1,11,2,0,3,0,40,5.714285714285714,2,0.0,6,1,10,2,17,0,1,3,0,19,21,1
4802,74375,pOkvcIFcOLnKHqzWe7X68PwdTZWgfXNn,7GRhBDsirIGkRZBtSMEzNTyDr2JQm4xx,26,46,15,20,8,1,3,0,93,13.285714285714286,1,0.0,15,15,20,8,31,1,0,3,0,58,35,1
4803,74376,uhOpSMle6LWQUtiKJ61AGF4uUuGwyCQB,7GRhBDsirIGkRZBtSMEzNTyDr2JQm4xx,7,6,1,0,1,0,3,0,11,1.5714285714285714,2,0.0,0,1,0,1,6,0,0,3,0,2,9,1
4804,74385,PiugBYfME8MQpTzoS0G5QvEJsAm89oP5,7GRhBDsirIGkRZBtSMEzNTyDr2JQm4xx,9,5,1,4,2,3,9,1,25,3.5714285714285716,1,0.0,3,1,3,2,2,3,1,9,1,9,16,1
4805,74412,vX9PpvehRTgTkIr6tSKODV93gbmBGfye,7GRhBDsirIGkRZBtSMEzNTyDr2JQm4xx,1,0,0,0,0,0,3,0,3,0.42857142857142855,2,0.0,0,0,0,0,0,0,0,3,0,0,3,1
4806,74417,pZeZwcDZvDaUYfNrM0JBq16CcPqoVjAy,7GRhBDsirIGkRZBtSMEzNTyDr2JQm4xx,2,0,0,0,0,0,2,0,2,0.2857142857142857,1,0.0,0,0,0,0,0,0,0,2,0,0,2,1
4807,74432,iB2CzgEKP1k7rQZEzYQoAPIRp7dEItA4,7GRhBDsirIGkRZBtSMEzNTyDr2JQm4xx,14,16,8,12,8,0,2,0,46,6.571428571428571,1,0.0,6,8,11,8,10,0,1,2,0,33,13,1
4808,74441,grxgFxuiaSTlMIk1kWcHwbLAYZVnIvkA,7GRhBDsirIGkRZBtSMEzNTyDr2JQm4xx,10,9,3,0,3,0,3,0,18,2.5714285714285716,1,0.0,0,3,0,3,9,0,0,3,0,6,12,1
4809,74455,PRNejdeVNKfxLUk8kGMRZmgBIyh1R45g,7GRhBDsirIGkRZBtSMEzNTyDr2JQm4xx,5,2,1,0,1,0,2,0,6,0.8571428571428571,1,0.0,0,1,0,1,2,0,0,2,0,2,4,1
4810,74456,2ZaLqb29uQ5ksFfqfhamJxjvg9jGJ9Ay,7GRhBDsirIGkRZBtSMEzNTyDr2JQm4xx,5,3,0,0,0,0,3,0,6,0.8571428571428571,1,0.0,0,0,0,0,3,0,0,3,0,0,6,1
4811,74461,z2UutrDxctGBl3XhV09hNxXdsZmqDZvY,A3fsA9Zfv1X2fVEQhTw51lKENdNrEqT3,8,4,2,0,2,23,9,0,40,5.714285714285714,2,0.0,1,2,0,2,3,23,0,9,0,5,35,1
4812,74462,dT92IjRcuruPiAlpqVUTtu3wNL9IIegT,7GRhBDsirIGkRZBtSMEzNTyDr2JQm4xx,4,0,0,0,0,0,3,1,4,0.5714285714285714,1,0.0,0,0,0,0,0,0,0,3,1,0,4,1
4813,74483,SP7hg1EWo2mZkHuxZFtI4Vbcyr5vcP4h,SpATywNh6bZuzm8s1ceuBUnMUAeoAHHw,10,10,3,14,1,0,3,0,31,4.428571428571429,2,0.0,4,3,13,1,6,0,1,3,0,21,10,0
4814,74500,spNi8Q5WiDgxakh0uckmQbexani6DCOh,7GRhBDsirIGkRZBtSMEzNTyDr2JQm4xx,20,23,7,12,6,0,2,0,50,7.142857142857143,2,0.0,8,7,12,6,15,0,0,2,0,33,17,1
4815,74506,M3qc1xm79CLjiw98zxp89bImiVSCJcDh,7GRhBDsirIGkRZBtSMEzNTyDr2JQm4xx,1,0,0,0,0,0,1,0,1,0.14285714285714285,1,0.0,0,0,0,0,0,0,0,1,0,0,1,1
4816,74516,KaBv8PoJ8OVsLIkZYrjM1X6uYKyRrniG,7GRhBDsirIGkRZBtSMEzNTyDr2JQm4xx,8,8,2,0,3,0,3,0,16,2.2857142857142856,1,0.0,5,2,0,3,3,0,0,3,0,10,6,1
4817,74522,ZYGzPhdrKsCQft8z3gUrz2GR31kmqGY8,SpATywNh6bZuzm8s1ceuBUnMUAeoAHHw,16,23,10,16,3,31,6,1,90,12.857142857142858,2,0.0,10,10,13,3,13,31,3,6,1,36,54,0
4818,74526,qwopEmmu52GEF4KxBC26RpTkcwtY07S9,SpATywNh6bZuzm8s1ceuBUnMUAeoAHHw,16,28,11,17,5,1,10,0,72,10.285714285714286,2,0.0,13,11,15,5,15,1,2,10,0,44,28,0
4819,74537,p64MOtUXpLiy07h6B0dKNFYMkAVaqQ98,7GRhBDsirIGkRZBtSMEzNTyDr2JQm4xx,2,0,0,0,0,0,4,0,4,0.5714285714285714,1,0.0,0,0,0,0,0,0,0,4,0,0,4,1
4820,74541,HbmZzALzRW0CJmaD07o1oMpvJwGgfjK4,bWdj2GDclj5ofokWjzoa5jAwMkxCykd6,3,2,0,0,0,0,1,0,3,0.42857142857142855,1,0.0,0,0,0,0,2,0,0,1,0,0,3,1
4821,74548,HF98YPKzT8oi2j9flZW9kstZcvL3ZimG,A3fsA9Zfv1X2fVEQhTw51lKENdNrEqT3,36,38,16,74,6,0,3,0,137,19.571428571428573,3,0.0,1,16,63,6,37,0,11,3,0,86,51,1
4822,74560,Q0d1WItnRJvnzlnn5VcAU6GMGN4rfbYJ,7GRhBDsirIGkRZBtSMEzNTyDr2JQm4xx,1,0,0,0,0,0,1,0,1,0.14285714285714285,1,0.0,0,0,0,0,0,0,0,1,0,0,1,1
4823,74603,A5la8pvW0tLLXP6HSr61aMxUll9fPTHI,7GRhBDsirIGkRZBtSMEzNTyDr2JQm4xx,11,5,2,4,3,0,10,0,24,3.4285714285714284,1,0.0,3,2,3,3,2,0,1,10,0,11,13,1
4824,74612,T8yZ978Owo7xSmEVFbiCM8j5K4ntSTo2,7GRhBDsirIGkRZBtSMEzNTyDr2JQm4xx,1,0,0,0,0,0,1,0,1,0.14285714285714285,1,0.0,0,0,0,0,0,0,0,1,0,0,1,1
4825,74650,usRZSdDsUQfZaciTJTskV4NLSeP1lHRl,7GRhBDsirIGkRZBtSMEzNTyDr2JQm4xx,14,22,4,14,6,13,8,1,68,9.714285714285714,1,0.0,10,4,11,6,12,13,3,8,1,31,37,1
4826,74712,ZudgpcrDV2RrJQUR1YBw9q8iUT5VbCHi,RXDvfPUBYFlVdlueBFbLW0mhhAyGEqpt,19,16,8,32,8,0,3,0,67,9.571428571428571,2,0.0,6,8,28,8,10,0,4,3,0,50,17,0
4827,74723,bLurC9srutCM4k4gLSsbzYrz2ihcIC86,7GRhBDsirIGkRZBtSMEzNTyDr2JQm4xx,6,3,1,0,1,0,4,0,9,1.2857142857142858,1,0.0,0,1,0,1,3,0,0,4,0,2,7,1
4828,74725,dg1KWi5LRRms7lQMyP0ii5Pv3KonWqiG,7GRhBDsirIGkRZBtSMEzNTyDr2JQm4xx,28,30,18,40,11,1,19,1,120,17.142857142857142,3,0.0,4,18,35,11,26,1,5,19,1,68,52,1
4829,74737,xMjaHywxqKHoEbgcAEYnpZkLLGRuzCTC,SpATywNh6bZuzm8s1ceuBUnMUAeoAHHw,25,62,14,24,9,7,12,0,128,18.285714285714285,4,0.0,12,14,18,9,50,7,6,12,0,53,75,0
4830,74739,WnGoJ0X05nmmcr9OBuNGFmD5r4EVF1g6,A3fsA9Zfv1X2fVEQhTw51lKENdNrEqT3,15,12,8,0,5,18,9,1,53,7.571428571428571,2,0.0,0,8,0,5,12,18,0,9,1,13,40,0
4831,74778,bYD2u7vuN3G54awyDYPdRiZI3O4zw6kx,G8EPVSXsOYB5YQWZGiz1aVq5Pgr2GrQu,5,3,2,0,1,0,2,0,8,1.1428571428571428,1,0.0,0,2,0,1,3,0,0,2,0,3,5,1
4832,74815,LFkf4WR1XfFwr3RF5erdei3F4d3PlupD,7GRhBDsirIGkRZBtSMEzNTyDr2JQm4xx,2,0,0,0,0,0,2,0,2,0.2857142857142857,1,0.0,0,0,0,0,0,0,0,2,0,0,2,1
4833,74840,FvY4K2RN2da3T8MEGlPk2LmHUIxOyg0h,SpATywNh6bZuzm8s1ceuBUnMUAeoAHHw,15,19,10,14,7,18,4,0,72,10.285714285714286,2,0.0,7,10,13,7,12,18,1,4,0,37,35,0
4834,74852,0wpgF8T87E4lIPjqoh0AkxyomANfbalw,7GRhBDsirIGkRZBtSMEzNTyDr2JQm4xx,1,0,0,0,0,0,1,0,1,0.14285714285714285,1,0.0,0,0,0,0,0,0,0,1,0,0,1,1
4835,74862,iNVrCH89sJttoddUpv5O2bH5LrAKlFHk,SpATywNh6bZuzm8s1ceuBUnMUAeoAHHw,7,4,3,0,3,0,2,0,12,1.7142857142857142,1,0.0,0,3,0,3,4,0,0,2,0,6,6,1
4836,74865,WlLtmSTcQZkOIIH38SOYOKYSBYpp2ymS,7GRhBDsirIGkRZBtSMEzNTyDr2JQm4xx,1,0,0,0,0,0,1,0,1,0.14285714285714285,1,0.0,0,0,0,0,0,0,0,1,0,0,1,1
4837,74867,IePFEx0pR5xLGQlWWjU59zR6qxTHOeo0,7GRhBDsirIGkRZBtSMEzNTyDr2JQm4xx,1,0,0,0,0,0,2,0,2,0.2857142857142857,2,0.0,0,0,0,0,0,0,0,2,0,0,2,1
4838,74874,CjjbRPpHR9Bj7mz7vlCMGl56lBOfuzeG,7GRhBDsirIGkRZBtSMEzNTyDr2JQm4xx,1,0,0,0,0,0,1,0,1,0.14285714285714285,1,0.0,0,0,0,0,0,0,0,1,0,0,1,1
4839,74887,YnXdaRteqU5oS01NC3H96Vynlp7riJjN,7GRhBDsirIGkRZBtSMEzNTyDr2JQm4xx,5,2,1,0,1,0,2,0,6,0.8571428571428571,1,0.0,0,1,0,1,2,0,0,2,0,2,4,1
4840,74888,hB4yTUnQMne1LtjUUKgpcnhj6jq7S5Co,7GRhBDsirIGkRZBtSMEzNTyDr2JQm4xx,58,82,34,78,32,2,11,0,239,34.142857142857146,5,0.0,35,34,71,32,47,2,7,11,0,172,67,0
4841,74890,ZqjoiK6u3Oz9EZH4lOkXjinyTZauCj8B,7GRhBDsirIGkRZBtSMEzNTyDr2JQm4xx,4,3,1,0,0,0,2,0,6,0.8571428571428571,1,0.0,0,1,0,0,3,0,0,2,0,1,5,1
4842,74903,Y0dbTriNAgSzbrnkzFHfTSZPt5kDzGfo,7GRhBDsirIGkRZBtSMEzNTyDr2JQm4xx,55,128,4,181,22,11,14,0,360,51.42857142857143,5,0.0,71,4,163,22,57,11,18,14,0,260,100,1
4843,74911,KXR3u54SykbWYMuF2sF6lcMFs68otiQO,SpATywNh6bZuzm8s1ceuBUnMUAeoAHHw,31,58,26,33,10,9,13,0,149,21.285714285714285,5,0.0,19,26,29,10,39,9,4,13,0,84,65,0
4844,74913,uFxbwM61ZWFC5xnxVOlmiGXCTyHmK3HX,bWdj2GDclj5ofokWjzoa5jAwMkxCykd6,8,5,3,0,2,9,6,1,26,3.7142857142857144,1,0.0,0,3,0,2,5,9,0,6,1,5,21,1
4845,74917,iFkbfunFypPiiZAClHyDLR02ievAgqRo,7GRhBDsirIGkRZBtSMEzNTyDr2JQm4xx,8,5,3,2,3,0,2,0,15,2.142857142857143,1,0.0,1,3,2,3,4,0,0,2,0,9,6,1
4846,74921,S6vBzHKpSh31SFGGZmwgKaOH2RvW3RpH,7GRhBDsirIGkRZBtSMEzNTyDr2JQm4xx,10,10,6,3,6,2,10,0,37,5.285714285714286,1,0.0,3,6,3,6,7,2,0,10,0,18,19,1
4847,74932,zaNavQl8vjpykftGiklyCQVgYYsAGELI,7GRhBDsirIGkRZBtSMEzNTyDr2JQm4xx,9,4,3,0,3,0,2,0,12,1.7142857142857142,1,0.0,0,3,0,3,4,0,0,2,0,6,6,1
4848,74934,knxAJpSFDgjN8jBmnCV7BB7s4fbgoTt1,SpATywNh6bZuzm8s1ceuBUnMUAeoAHHw,9,6,2,0,1,13,7,1,30,4.285714285714286,1,0.0,0,2,0,1,6,13,0,7,1,3,27,0
4849,74963,jt6cAnJpqYCiS3Lj5wNBvifs8WZJznlF,7GRhBDsirIGkRZBtSMEzNTyDr2JQm4xx,5,2,1,0,1,0,2,0,6,0.8571428571428571,1,0.0,0,1,0,1,2,0,0,2,0,2,4,1
4850,74990,RbewLSSgBXbMSLEvzESHw0b6pdUZ0dT1,7GRhBDsirIGkRZBtSMEzNTyDr2JQm4xx,4,2,1,0,1,0,1,0,5,0.7142857142857143,1,0.0,0,1,0,1,2,0,0,1,0,2,3,1
4851,75008,s2svupUO1VMo8YfeGdH5qCtTY141gV4e,7GRhBDsirIGkRZBtSMEzNTyDr2JQm4xx,16,41,1,4,5,1,13,0,65,9.285714285714286,2,0.0,18,1,3,5,23,1,1,13,0,27,38,1
4852,75076,Oa5Z9qxxvzPY6Y4pD2DPDPqyzdKPou5A,7GRhBDsirIGkRZBtSMEzNTyDr2JQm4xx,5,7,2,0,1,0,1,0,11,1.5714285714285714,1,0.0,3,2,0,1,4,0,0,1,0,6,5,1
4853,75083,WFdKiZBTbeCiiw3YIeAU1XWn0P3M4cOn,7GRhBDsirIGkRZBtSMEzNTyDr2JQm4xx,1,0,0,0,0,0,1,0,1,0.14285714285714285,1,0.0,0,0,0,0,0,0,0,1,0,0,1,1
4854,75093,Wcbtj2ddFRjLWK9tTZ7uzCDmpegrAZ78,A3fsA9Zfv1X2fVEQhTw51lKENdNrEqT3,54,28,18,104,10,2,13,1,176,25.142857142857142,3,0.0,3,18,92,10,25,2,12,13,1,123,53,0
4855,75102,7PsSHlEYnB89Jan9VqppndjNHL90G8j5,7GRhBDsirIGkRZBtSMEzNTyDr2JQm4xx,1,0,0,0,0,0,2,0,2,0.2857142857142857,2,0.0,0,0,0,0,0,0,0,2,0,0,2,1
4856,75108,35ygmhgWZR3Rp3zgk5PM9pjJe8hJeFw2,G8EPVSXsOYB5YQWZGiz1aVq5Pgr2GrQu,22,22,14,20,9,6,7,1,79,11.285714285714286,2,0.0,4,14,19,9,18,6,1,7,1,46,33,0
4857,75120,H2nT05aeA6Q1zZKHa66kquyct5PT5SXn,SpATywNh6bZuzm8s1ceuBUnMUAeoAHHw,11,16,0,6,0,19,3,0,44,6.285714285714286,2,0.0,6,0,6,0,10,19,0,3,0,12,32,0
4858,75208,EsXr4Om7Vwi1sKSVuaosexmk6LU6FCZi,SpATywNh6bZuzm8s1ceuBUnMUAeoAHHw,12,13,8,0,6,2,8,0,37,5.285714285714286,1,0.0,0,8,0,6,13,2,0,8,0,14,23,0
4859,75218,loLM1q927UBCE6cjZ1Vielkh2VBpufUl,7GRhBDsirIGkRZBtSMEzNTyDr2JQm4xx,2,0,0,0,0,0,2,0,2,0.2857142857142857,1,0.0,0,0,0,0,0,0,0,2,0,0,2,1
4860,75237,RFr9TyIVEW42bBHoptkHxr0bo57RDi2m,7GRhBDsirIGkRZBtSMEzNTyDr2JQm4xx,60,109,32,116,27,42,23,2,351,50.142857142857146,2,0.0,76,32,99,27,33,42,17,23,2,234,117,1
4861,75239,azgXgRxypRV3MCHuv22g9fm7GCtWHZdX,SpATywNh6bZuzm8s1ceuBUnMUAeoAHHw,11,21,15,8,0,1,2,0,47,6.714285714285714,1,0.0,6,15,7,0,15,1,1,2,0,28,19,1
4862,75244,pkcnSnJ3oMXJ1Rn021rYtsOpPmKbDGk6,7GRhBDsirIGkRZBtSMEzNTyDr2JQm4xx,17,34,13,3,7,0,7,0,64,9.142857142857142,1,0.0,12,13,3,7,22,0,0,7,0,35,29,1
4863,75288,ZuPH4O6ElHiBwlm11NvwWK4IBueWaJol,7GRhBDsirIGkRZBtSMEzNTyDr2JQm4xx,1,0,0,0,0,0,1,0,1,0.14285714285714285,1,0.0,0,0,0,0,0,0,0,1,0,0,1,1
4864,75314,2IlOpdUgsPu5FVltj0flScFk4CeI7uHm,A3fsA9Zfv1X2fVEQhTw51lKENdNrEqT3,44,16,12,38,9,6,7,1,89,12.714285714285714,2,0.0,1,12,38,9,15,6,0,7,1,60,29,1
4865,75323,1aZU0pZlvemw2X4WLr3aSR93nNOLRr5M,7GRhBDsirIGkRZBtSMEzNTyDr2JQm4xx,13,12,4,16,5,1,2,0,40,5.714285714285714,1,0.0,6,4,13,5,6,1,3,2,0,28,12,1
4866,75329,gmhCT21egJ120TaG89Xay0aaFTdFxysB,7GRhBDsirIGkRZBtSMEzNTyDr2JQm4xx,2,0,0,0,0,0,2,0,2,0.2857142857142857,1,0.0,0,0,0,0,0,0,0,2,0,0,2,1
4867,75347,iJftBP3zncmjUCwGWSZ77IUrDb3Dt8rz,7GRhBDsirIGkRZBtSMEzNTyDr2JQm4xx,9,10,5,4,3,0,3,0,25,3.5714285714285716,1,0.0,2,5,3,3,8,0,1,3,0,13,12,1
4868,75379,MYsCU1zkMrWxPhV1b7wSL5LZIo1zGyhU,A3fsA9Zfv1X2fVEQhTw51lKENdNrEqT3,29,26,21,2,14,0,5,0,68,9.714285714285714,3,0.0,0,21,2,14,26,0,0,5,0,37,31,0
4869,75425,Th6GGIKucyCokdQsUn3aOeloTzqx0Qbo,G8EPVSXsOYB5YQWZGiz1aVq5Pgr2GrQu,48,47,2,140,1,22,9,0,221,31.571428571428573,2,0.0,12,2,114,1,35,22,26,9,0,129,92,1
4870,75476,RJ8UDBA8MoIbU3vEiMeGJTOTXtH9PTgu,7GRhBDsirIGkRZBtSMEzNTyDr2JQm4xx,21,44,17,32,20,2,3,0,118,16.857142857142858,1,0.0,25,17,31,20,19,2,1,3,0,93,25,1
4871,75480,RsZjSLVxYbmsMcCyiGpXZKIPYOa4dUlN,7GRhBDsirIGkRZBtSMEzNTyDr2JQm4xx,1,0,0,0,0,0,2,0,2,0.2857142857142857,1,0.0,0,0,0,0,0,0,0,2,0,0,2,1
4872,75493,Y7Pi7uKjChwCBFftO7ZsD2oE8A4VzjzU,7GRhBDsirIGkRZBtSMEzNTyDr2JQm4xx,5,2,1,0,1,0,2,0,6,0.8571428571428571,1,0.0,0,1,0,1,2,0,0,2,0,2,4,1
4873,75511,MYsCU1zkMrWxPhV1b7wSL5LZIo1zGyhU,RXDvfPUBYFlVdlueBFbLW0mhhAyGEqpt,35,29,26,0,16,0,3,0,74,10.571428571428571,3,0.0,0,26,0,16,29,0,0,3,0,42,32,0
4874,75520,9Ymehs8Guv0M3ykIpbJLNOnh3ut9xb1R,SpATywNh6bZuzm8s1ceuBUnMUAeoAHHw,2,0,0,0,0,0,2,0,2,0.2857142857142857,1,0.0,0,0,0,0,0,0,0,2,0,0,2,1
4875,75537,MYsCU1zkMrWxPhV1b7wSL5LZIo1zGyhU,7GRhBDsirIGkRZBtSMEzNTyDr2JQm4xx,11,6,5,0,3,0,2,0,16,2.2857142857142856,1,0.0,0,5,0,3,6,0,0,2,0,8,8,1
4876,75593,9aM24JWMSszlno8F5rXsYdVrvPAYQQTl,7GRhBDsirIGkRZBtSMEzNTyDr2JQm4xx,2,0,0,0,0,0,2,0,2,0.2857142857142857,1,0.0,0,0,0,0,0,0,0,2,0,0,2,1
4877,75601,Xt4h1KWJBlSDSafJvdbE69LJiRLDiihq,7GRhBDsirIGkRZBtSMEzNTyDr2JQm4xx,6,3,1,0,1,0,2,0,7,1.0,1,0.0,0,1,0,1,3,0,0,2,0,2,5,0
4878,75685,7glymc4Wt1TTt6LrLi78VQNF5GV1r6UY,7GRhBDsirIGkRZBtSMEzNTyDr2JQm4xx,6,1,0,0,0,1,6,1,9,1.2857142857142858,1,0.0,0,0,0,0,1,1,0,6,1,0,9,1
4879,75687,LFB2kImAJUILQTj3BlBgq5zjMlrHesod,7GRhBDsirIGkRZBtSMEzNTyDr2JQm4xx,1,0,0,0,0,0,2,0,2,0.2857142857142857,1,0.0,0,0,0,0,0,0,0,2,0,0,2,1
4880,75711,ONaGFOFSpTcGmGss3L3s1gXRn5LKjFn3,SpATywNh6bZuzm8s1ceuBUnMUAeoAHHw,5,1,1,0,1,0,2,0,5,0.7142857142857143,1,0.0,0,1,0,1,1,0,0,2,0,2,3,1
4881,75721,hkOcH5tOuxyPKzObCfNaFgGI6cTMtgMP,SpATywNh6bZuzm8s1ceuBUnMUAeoAHHw,11,10,7,0,2,0,8,0,27,3.857142857142857,1,0.0,0,7,0,2,10,0,0,8,0,9,18,0
4882,75751,AQki29spcihutk4byKfhdfiwIESO5QjE,7GRhBDsirIGkRZBtSMEzNTyDr2JQm4xx,4,3,1,0,0,0,3,0,7,1.0,1,0.0,0,1,0,0,3,0,0,3,0,1,6,1
4883,75752,0CuRIhBavvQKL5rTT1QWf2kztAfRXZug,A3fsA9Zfv1X2fVEQhTw51lKENdNrEqT3,16,22,11,0,5,14,9,0,61,8.714285714285714,3,0.0,0,11,0,5,22,14,0,9,0,16,45,0
4884,75790,rT1OrFQC18rdvYkTGYqwRgC7eDvihHsc,A3fsA9Zfv1X2fVEQhTw51lKENdNrEqT3,25,14,11,0,9,2,10,1,47,6.714285714285714,3,0.0,1,11,0,9,13,2,0,10,1,21,26,1
4885,75879,Slk5JcZSYHmDLQZXaNVmcMDmjJ16kBhI,SpATywNh6bZuzm8s1ceuBUnMUAeoAHHw,21,43,0,18,0,8,16,1,86,12.285714285714286,6,0.0,11,0,16,0,32,8,2,16,1,27,59,0
4886,75888,PQscC5e4adjOlDXssQTF1miDsYNrTX1i,7GRhBDsirIGkRZBtSMEzNTyDr2JQm4xx,5,2,1,0,1,1,3,0,8,1.1428571428571428,1,0.0,0,1,0,1,2,1,0,3,0,2,6,1
4887,75965,v3CIUjxPH9xWB79tSDrtVHc9ShR8m6Ki,7GRhBDsirIGkRZBtSMEzNTyDr2JQm4xx,9,15,0,2,1,36,3,0,57,8.142857142857142,1,0.0,2,0,2,1,13,36,0,3,0,5,52,1
4888,75985,XJ0fPDPj1weE8n0B17PQ5bWqC1TTj821,7GRhBDsirIGkRZBtSMEzNTyDr2JQm4xx,4,2,0,0,0,0,2,0,4,0.5714285714285714,1,0.0,0,0,0,0,2,0,0,2,0,0,4,1
4889,76027,BlBPU32FQaOv4FFjXSkiNL1PvarqZtmh,7GRhBDsirIGkRZBtSMEzNTyDr2JQm4xx,1,0,0,0,0,0,1,0,1,0.14285714285714285,1,0.0,0,0,0,0,0,0,0,1,0,0,1,1
4890,76044,Qfr71fBWHfCr6Grcd1acKeeOb47jgXr2,RXDvfPUBYFlVdlueBFbLW0mhhAyGEqpt,17,14,10,0,7,3,6,0,40,5.714285714285714,1,0.0,0,10,0,7,14,3,0,6,0,17,23,1
4891,76073,sxlaG4Fls4yl9crPN8VEZQ5WoWsunptZ,7GRhBDsirIGkRZBtSMEzNTyDr2JQm4xx,3,0,0,0,0,3,2,0,5,0.7142857142857143,1,0.0,0,0,0,0,0,3,0,2,0,0,5,1
4892,76091,UcMBbV5apyBn6US03aF0lorBUPxtfuSB,bWdj2GDclj5ofokWjzoa5jAwMkxCykd6,12,9,4,14,3,13,5,1,49,7.0,1,0.0,2,4,13,3,7,13,1,5,1,22,27,0
4893,76108,zKXJGJg9DMEB2RAxuThjb4UbLJ2XM2gW,RXDvfPUBYFlVdlueBFbLW0mhhAyGEqpt,14,16,11,9,4,0,3,0,43,6.142857142857143,1,0.0,3,11,9,4,13,0,0,3,0,27,16,1
4894,76121,UcMBbV5apyBn6US03aF0lorBUPxtfuSB,SpATywNh6bZuzm8s1ceuBUnMUAeoAHHw,18,14,7,12,4,47,8,1,93,13.285714285714286,2,0.0,5,7,11,4,9,47,1,8,1,27,66,0
4895,76169,6RuWsSvS3Ngnjl37PzNAaaGn8Jd9a1lW,A3fsA9Zfv1X2fVEQhTw51lKENdNrEqT3,7,10,2,0,2,0,5,0,19,2.7142857142857144,3,0.0,0,2,0,2,10,0,0,5,0,4,15,0
4896,76235,jByBG50ghoSer5UP92qpkAfDGFpraaH7,SpATywNh6bZuzm8s1ceuBUnMUAeoAHHw,24,53,13,25,3,8,32,1,135,19.285714285714285,4,0.0,12,13,24,3,41,8,1,32,1,52,83,0
4897,76295,Slk5JcZSYHmDLQZXaNVmcMDmjJ16kBhI,bWdj2GDclj5ofokWjzoa5jAwMkxCykd6,38,73,8,108,4,6,24,2,225,32.142857142857146,7,0.0,12,8,99,4,61,6,9,24,2,123,102,0
4898,76325,R5PVQLHQfRcyGqt0KVpTkwcmfBgB3rs1,7GRhBDsirIGkRZBtSMEzNTyDr2JQm4xx,8,16,7,2,1,2,6,0,34,4.857142857142857,3,0.0,1,7,2,1,15,2,0,6,0,11,23,0
4899,76368,Kcl98h3mNpyExmJuf2coZt58rSEztGxk,7GRhBDsirIGkRZBtSMEzNTyDr2JQm4xx,30,55,24,44,20,32,8,0,183,26.142857142857142,4,0.0,25,24,43,20,30,32,1,8,0,112,71,0
4900,77034,s6iksgptFmyh2vfiarKdJkiKnp6RLi3f,7GRhBDsirIGkRZBtSMEzNTyDr2JQm4xx,15,25,13,0,3,10,29,3,83,11.857142857142858,2,0.0,4,13,0,3,21,10,0,29,3,20,63,0
4901,77169,Cp72CI2Sf9jM7OL4FtK9fjTjNz5WkQpA,fbPkOYLVPtPgIt0MxizjfFJov3JbHyAi,21,20,16,0,7,0,6,1,50,7.142857142857143,2,0.0,0,16,0,7,20,0,0,6,1,23,27,1
4902,77171,HBsmUsRxNy9YIFuJFQ7jYNsbYwo3J2fi,fbPkOYLVPtPgIt0MxizjfFJov3JbHyAi,2,0,0,0,0,0,4,0,4,0.5714285714285714,1,0.0,0,0,0,0,0,0,0,4,0,0,4,1
4903,77174,SAaosoVr2vtr4dixGOnJyFfsZpQgNJkr,fbPkOYLVPtPgIt0MxizjfFJov3JbHyAi,7,3,2,0,2,0,2,0,9,1.2857142857142858,1,0.0,0,2,0,2,3,0,0,2,0,4,5,1
4904,77175,uHjc02bb5yahJPEhzfl5FY8Jbd1eMOQQ,fbPkOYLVPtPgIt0MxizjfFJov3JbHyAi,6,2,1,0,1,0,4,0,8,1.1428571428571428,1,0.0,0,1,0,1,2,0,0,4,0,2,6,1
4905,77178,sgnybIqhppcE8t2VPYKo1tSMEtj9RDxf,fbPkOYLVPtPgIt0MxizjfFJov3JbHyAi,11,13,2,4,5,0,2,0,26,3.7142857142857144,1,0.0,7,2,4,5,6,0,0,2,0,18,8,1
4906,77179,eoSLO9oJFq2ypi74bXNS4eHCMDLAFDL3,fbPkOYLVPtPgIt0MxizjfFJov3JbHyAi,25,77,23,21,26,0,28,1,176,25.142857142857142,7,0.0,38,23,15,26,39,0,6,28,1,102,74,0
4907,77180,4G8giDRiV5HhGR2bRPmscEq6mPK32SgK,fbPkOYLVPtPgIt0MxizjfFJov3JbHyAi,1,0,0,0,0,0,1,0,1,0.14285714285714285,1,0.0,0,0,0,0,0,0,0,1,0,0,1,1
4908,77183,bDjOfMP0w62FEHIuWcxaWhNnsKOONfSS,fbPkOYLVPtPgIt0MxizjfFJov3JbHyAi,8,3,2,0,2,0,3,1,11,1.5714285714285714,1,0.0,0,2,0,2,3,0,0,3,1,4,7,1
4909,77186,ezX0IzuZ3J41r6pzTzeXqv8c59Uxb12M,fbPkOYLVPtPgIt0MxizjfFJov3JbHyAi,25,56,25,44,9,6,15,2,157,22.428571428571427,2,0.0,20,25,37,9,36,6,7,15,2,91,66,1
4910,77192,meLyG0wJkMmV21DuYQM3wSrWMuffsNoT,fbPkOYLVPtPgIt0MxizjfFJov3JbHyAi,6,7,1,0,2,0,2,0,12,1.7142857142857142,1,0.0,4,1,0,2,3,0,0,2,0,7,5,1
4911,77193,alkuv5SdY4gggdYWMPXddOsJJh5KuvhQ,fbPkOYLVPtPgIt0MxizjfFJov3JbHyAi,8,5,2,0,2,1,4,1,15,2.142857142857143,1,0.0,0,2,0,2,5,1,0,4,1,4,11,1
4912,77195,gir9E9ZUbwj6bCUNLD2kQmOx1nsVwG4J,fbPkOYLVPtPgIt0MxizjfFJov3JbHyAi,1,0,0,0,0,0,1,0,1,0.14285714285714285,1,0.0,0,0,0,0,0,0,0,1,0,0,1,1
4913,77196,MzVpgt6eIu33aOAUbbblQyleNNMrWM7t,fbPkOYLVPtPgIt0MxizjfFJov3JbHyAi,5,2,1,0,1,0,2,0,6,0.8571428571428571,1,0.0,0,1,0,1,2,0,0,2,0,2,4,1
4914,77199,KG6oNmBFEPQJXhvAD0RPIYEBC1kCcYzu,fbPkOYLVPtPgIt0MxizjfFJov3JbHyAi,12,12,8,2,4,0,6,0,32,4.571428571428571,1,0.0,1,8,2,4,11,0,0,6,0,15,17,1
4915,77201,syI09vfTHJXWHQvllYPBF5DBbMlFFVEK,fbPkOYLVPtPgIt0MxizjfFJov3JbHyAi,8,8,3,0,1,0,9,0,21,3.0,3,0.0,0,3,0,1,8,0,0,9,0,4,17,1
4916,77202,U7npE6DxNpBR5QQ69mhzcy60y59pDPJp,fbPkOYLVPtPgIt0MxizjfFJov3JbHyAi,7,4,3,0,3,0,2,0,12,1.7142857142857142,1,0.0,0,3,0,3,4,0,0,2,0,6,6,1
4917,77203,riM9GkB0ajSqpIPlVq4tRzOjk7wJ6NHE,fbPkOYLVPtPgIt0MxizjfFJov3JbHyAi,4,2,0,0,0,0,2,0,4,0.5714285714285714,1,0.0,0,0,0,0,2,0,0,2,0,0,4,1
4918,77204,cNbaOf1E9E66ogkJPuo6YM141nAFPTNg,fbPkOYLVPtPgIt0MxizjfFJov3JbHyAi,14,22,15,0,11,3,5,0,56,8.0,2,0.0,2,15,0,11,20,3,0,5,0,28,28,1
4919,77205,tAelht5FQdpcbtZQoKgvZA90XQy6zeRb,fbPkOYLVPtPgIt0MxizjfFJov3JbHyAi,7,5,4,0,3,0,1,0,13,1.8571428571428572,1,0.0,0,4,0,3,5,0,0,1,0,7,6,1
4920,77207,AXWWqNDiRDejTjo5V7yUaMbjtzXKhlP0,fbPkOYLVPtPgIt0MxizjfFJov3JbHyAi,10,6,3,0,2,5,5,1,22,3.142857142857143,1,0.0,1,3,0,2,5,5,0,5,1,6,16,1
4921,77304,nknXXbQsC6Q6nMDyRKc0MDJZg6KtAXBE,fbPkOYLVPtPgIt0MxizjfFJov3JbHyAi,8,9,5,0,2,3,7,0,26,3.7142857142857144,2,0.0,0,5,0,2,9,3,0,7,0,7,19,1
4922,77848,4s6cwLPbdRkDxHfFtEkiNoQ9RLKrwhVv,A3fsA9Zfv1X2fVEQhTw51lKENdNrEqT3,14,7,5,0,4,4,7,1,28,4.0,2,0.0,0,5,0,4,7,4,0,7,1,9,19,1
4923,77859,FbNQPrTC7bI79XxVFKHE9WIoUItnOpDj,SpATywNh6bZuzm8s1ceuBUnMUAeoAHHw,13,16,8,16,5,17,1,0,63,9.0,1,0.0,6,8,14,5,10,17,2,1,0,33,30,1
4924,77865,mqEWhrPz1lKF0rYKRYPaEdxo5F8aEixX,bWdj2GDclj5ofokWjzoa5jAwMkxCykd6,7,14,0,60,0,0,5,0,79,11.285714285714286,2,0.0,9,0,59,0,5,0,1,5,0,68,11,0
4925,77895,ywdL3xkp7d2PSjbvnflAvIe7Wp6Q4SRe,bWdj2GDclj5ofokWjzoa5jAwMkxCykd6,35,48,26,154,9,0,17,0,254,36.285714285714285,4,0.0,7,26,142,9,41,0,12,17,0,184,70,0
4926,77959,oL1G89Phk4nduULmJ17br7A4xddcHdc4,bWdj2GDclj5ofokWjzoa5jAwMkxCykd6,1,0,0,0,0,0,1,0,1,0.14285714285714285,1,0.0,0,0,0,0,0,0,0,1,0,0,1,1
4927,77993,c8WJAdYLV71mOx4ZXSglpCNd0dBUR3Om,A3fsA9Zfv1X2fVEQhTw51lKENdNrEqT3,70,27,18,120,12,1,19,1,198,28.285714285714285,5,0.0,2,18,119,12,25,1,1,19,1,151,47,0
4928,78000,fFuKiCeoQQwOgD8VAud2ta198Mbq05KK,bWdj2GDclj5ofokWjzoa5jAwMkxCykd6,29,73,34,40,9,249,32,0,437,62.42857142857143,5,0.0,8,34,37,9,65,249,3,32,0,88,349,0
4929,78061,CTzsOL49UPUArAP2sAfnnQhe79FdliFF,bWdj2GDclj5ofokWjzoa5jAwMkxCykd6,4,4,1,0,2,0,1,0,8,1.1428571428571428,1,0.0,2,1,0,2,2,0,0,1,0,5,3,1
4930,78074,69m94gHdGGbBNOXpX0bnvC61pSot80tW,SpATywNh6bZuzm8s1ceuBUnMUAeoAHHw,17,28,7,23,3,40,21,3,125,17.857142857142858,4,0.0,16,7,19,3,12,40,4,21,3,45,80,1
4931,78089,hL8JceSXib9VR5R33sNp2RkuLry7d4Yu,SpATywNh6bZuzm8s1ceuBUnMUAeoAHHw,8,10,0,24,0,0,4,0,38,5.428571428571429,1,0.0,2,0,21,0,8,0,3,4,0,23,15,1
4932,78095,pd8vtyQRUNRd6UqLQhDDx4sQEKhI3nO6,SpATywNh6bZuzm8s1ceuBUnMUAeoAHHw,14,25,2,30,0,3,12,1,73,10.428571428571429,6,0.0,9,2,26,0,16,3,4,12,1,37,36,1
4933,78101,ew5XZC7WSosl0QdXH45kYD3syMSGbOj6,SpATywNh6bZuzm8s1ceuBUnMUAeoAHHw,15,17,8,12,3,12,9,1,62,8.857142857142858,3,0.0,4,8,9,3,13,12,3,9,1,24,38,1
4934,78113,95wznOdbj11g3FRFEWLtWETJ4xtU9Lr5,G8EPVSXsOYB5YQWZGiz1aVq5Pgr2GrQu,2,0,0,0,0,0,3,0,3,0.42857142857142855,1,0.0,0,0,0,0,0,0,0,3,0,0,3,1
4935,78198,WnXohtCVTjGmg2VYZ7QMusUaSQiMqg1z,SpATywNh6bZuzm8s1ceuBUnMUAeoAHHw,15,21,9,6,3,0,7,0,46,6.571428571428571,3,0.0,8,9,6,3,13,0,0,7,0,26,20,1
4936,78207,KxuHPQOdlWxQw9hyxXdRrGHh12yzsPD2,SpATywNh6bZuzm8s1ceuBUnMUAeoAHHw,22,45,1,48,0,6,16,4,120,17.142857142857142,4,0.0,13,1,38,0,32,6,10,16,4,52,68,0
4937,78230,Q9vRNhatkLDJJU3tGkLQZvY6VPiyvyvp,SpATywNh6bZuzm8s1ceuBUnMUAeoAHHw,6,10,1,0,1,0,2,0,14,2.0,1,0.0,0,1,0,1,10,0,0,2,0,2,12,1
4938,78272,wnNKMl9xF7Ymo4g0NZCDRhkVYih1owQr,SpATywNh6bZuzm8s1ceuBUnMUAeoAHHw,15,25,18,21,11,0,6,0,81,11.571428571428571,2,0.0,4,18,17,11,21,0,4,6,0,50,31,1
4939,78273,XE05vZThEHf17O6FM08AySNf2qZFgNWa,SpATywNh6bZuzm8s1ceuBUnMUAeoAHHw,9,9,3,6,1,0,2,0,21,3.0,1,0.0,5,3,6,1,4,0,0,2,0,15,6,0
4940,78404,r83Hvy5kcw0EMVIlIEQofYLVkxqypRN2,A3fsA9Zfv1X2fVEQhTw51lKENdNrEqT3,10,10,7,0,0,0,9,0,26,3.7142857142857144,2,0.0,0,7,0,0,10,0,0,9,0,7,19,1
4941,78414,VzHARyOCXw9czoqgTkAm6CGUmYU7yDEA,A3fsA9Zfv1X2fVEQhTw51lKENdNrEqT3,5,0,0,0,0,0,10,1,11,1.5714285714285714,1,0.0,0,0,0,0,0,0,0,10,1,0,11,1
4942,78450,FKaIUzhQjfUDPqxWuQzJXyqHP4qLLgRX,SpATywNh6bZuzm8s1ceuBUnMUAeoAHHw,16,31,1,24,1,6,21,3,87,12.428571428571429,3,0.0,15,1,19,1,16,6,5,21,3,36,51,0
4943,78456,eBckG9AVr6bIBOpezfRr2S1KzQMM7OtD,SpATywNh6bZuzm8s1ceuBUnMUAeoAHHw,4,2,1,0,1,0,1,0,5,0.7142857142857143,1,0.0,0,1,0,1,2,0,0,1,0,2,3,1
4944,78467,J2luenZYZZPbaRbefvLso2Jyw46qiM9q,G8EPVSXsOYB5YQWZGiz1aVq5Pgr2GrQu,1,0,0,0,0,0,1,0,1,0.14285714285714285,1,0.0,0,0,0,0,0,0,0,1,0,0,1,1
4945,78511,98Rmjqd0huhIhiHJIK65vNiEBdUVwDLb,A3fsA9Zfv1X2fVEQhTw51lKENdNrEqT3,16,14,11,0,6,0,4,0,35,5.0,3,0.0,0,11,0,6,14,0,0,4,0,17,18,1
4946,78545,Ckb71Ev9RlsIUvVDfkFS0AumQJilppvB,SpATywNh6bZuzm8s1ceuBUnMUAeoAHHw,5,3,1,0,1,0,1,0,6,0.8571428571428571,1,0.0,0,1,0,1,3,0,0,1,0,2,4,1
4947,78564,X8qfNjsHrwR5R67KkU9t7FXc6jQSGsyo,A3fsA9Zfv1X2fVEQhTw51lKENdNrEqT3,43,53,6,65,3,11,26,1,165,23.571428571428573,3,0.0,0,6,56,3,53,11,9,26,1,65,100,1
4948,78584,5bg7aQCg1xT3BNwuorGcguCUDl8W5Lwl,bWdj2GDclj5ofokWjzoa5jAwMkxCykd6,5,7,2,0,0,12,4,0,25,3.5714285714285716,2,0.0,1,2,0,0,6,12,0,4,0,3,22,1
4949,78627,mJ6Ucc9SqO7RDdkh3xF9KLI6sTyfYc24,SpATywNh6bZuzm8s1ceuBUnMUAeoAHHw,10,13,3,21,1,5,6,0,49,7.0,1,0.0,10,3,18,1,3,5,3,6,0,32,17,1
4950,78660,uhbUne0Zqx7l0LKNWrxxR44WistJmxKI,RXDvfPUBYFlVdlueBFbLW0mhhAyGEqpt,4,4,0,0,0,0,2,0,6,0.8571428571428571,1,0.0,0,0,0,0,4,0,0,2,0,0,6,1
4951,78686,38U4yWxOl4oZXP5u7g0lCPmmavOa19Ln,A3fsA9Zfv1X2fVEQhTw51lKENdNrEqT3,11,14,2,0,2,0,7,0,25,3.5714285714285716,2,0.0,0,2,0,2,14,0,0,7,0,4,21,1
4952,78691,tmJw00mRQLbE68iN3hs2GcRMynHK5cxp,A3fsA9Zfv1X2fVEQhTw51lKENdNrEqT3,35,22,17,54,11,2,6,2,114,16.285714285714285,1,0.0,2,17,46,11,20,2,8,6,2,76,38,1
4953,78733,hiYWxbK79jotdVc0LNw6xFpPROtaee83,SpATywNh6bZuzm8s1ceuBUnMUAeoAHHw,15,18,1,18,0,10,10,1,58,8.285714285714286,3,0.0,8,1,15,0,10,10,3,10,1,24,34,0
4954,78776,eAArxLyCThtu9N3Mv8rQculKbGSa66j9,A3fsA9Zfv1X2fVEQhTw51lKENdNrEqT3,8,6,4,0,1,0,4,0,15,2.142857142857143,2,0.0,0,4,0,1,6,0,0,4,0,5,10,1
4955,78822,WmqMKoevd5yMpzwxk3BDNFkg4y1FZjx5,A3fsA9Zfv1X2fVEQhTw51lKENdNrEqT3,5,7,0,0,0,0,2,0,9,1.2857142857142858,1,0.0,0,0,0,0,7,0,0,2,0,0,9,1
4956,78834,Ffohn9JNnGJQD2IavzMTS00ubnVtcb2T,bWdj2GDclj5ofokWjzoa5jAwMkxCykd6,39,62,28,103,12,1,23,1,230,32.857142857142854,8,0.0,13,28,85,12,49,1,18,23,1,138,92,0
4957,78843,FSe393m4kqHOdsL9YDo8QralMIqcUHdZ,A3fsA9Zfv1X2fVEQhTw51lKENdNrEqT3,9,2,1,0,1,4,7,1,16,2.2857142857142856,1,0.0,0,1,0,1,2,4,0,7,1,2,14,1
4958,78880,b5FAs3DRd36MUCxhLKFjsHu3HN0mJvs6,SpATywNh6bZuzm8s1ceuBUnMUAeoAHHw,10,24,19,0,0,5,7,6,61,8.714285714285714,1,0.0,1,19,0,0,23,5,0,7,6,20,41,1
4959,78881,toLFcom7KFecBZf6qB124Knuopx8NQmy,SpATywNh6bZuzm8s1ceuBUnMUAeoAHHw,15,9,5,15,4,0,5,2,40,5.714285714285714,1,0.0,2,5,15,4,7,0,0,5,2,26,14,0
4960,78897,E96VmAw6m1AOHRckdqiq2ASKbnHBlpAb,A3fsA9Zfv1X2fVEQhTw51lKENdNrEqT3,10,16,2,2,0,0,2,0,22,3.142857142857143,1,0.0,0,2,2,0,16,0,0,2,0,4,18,0
4961,78914,azVElWk7I3VwRJA3S907C5a9P0Jn3yCG,SpATywNh6bZuzm8s1ceuBUnMUAeoAHHw,5,9,7,0,2,0,2,0,20,2.857142857142857,2,0.0,0,7,0,2,9,0,0,2,0,9,11,1
4962,78948,0OC0czg5KrchA85VzU71XhGpYSu49K6t,SpATywNh6bZuzm8s1ceuBUnMUAeoAHHw,14,20,2,0,1,0,8,0,31,4.428571428571429,1,0.0,4,2,0,1,16,0,0,8,0,7,24,0
4963,78972,ef55znmweQJrijlI0fO1Ekc271nZnV0m,SpATywNh6bZuzm8s1ceuBUnMUAeoAHHw,27,26,14,13,10,1,10,0,74,10.571428571428571,3,0.0,10,14,13,10,16,1,0,10,0,47,27,0
4964,78981,NohnA6aI0IdpBmazHAgdTY50K8lYcWSq,A3fsA9Zfv1X2fVEQhTw51lKENdNrEqT3,8,4,3,0,3,0,1,0,11,1.5714285714285714,1,0.0,0,3,0,3,4,0,0,1,0,6,5,1
4965,78984,v6Va3YleqjOFxWX0C18ItZbiVgGPA6xX,RXDvfPUBYFlVdlueBFbLW0mhhAyGEqpt,28,45,8,20,3,24,21,2,123,17.571428571428573,5,0.0,6,8,20,3,39,24,0,21,2,37,86,1
4966,79004,xsisvuj6gK52B2ADQNofz9kAaPqANNhO,SpATywNh6bZuzm8s1ceuBUnMUAeoAHHw,10,8,2,0,1,1,5,1,18,2.5714285714285716,1,0.0,0,2,0,1,8,1,0,5,1,3,15,1
4967,79006,mP6z9RZ14UwkQFXdxH2YSItn6R2tzg1x,SpATywNh6bZuzm8s1ceuBUnMUAeoAHHw,19,34,19,16,6,83,14,3,175,25.0,8,0.0,7,19,15,6,27,83,1,14,3,47,128,1
4968,79007,THie45OT0ypeHdwObqe2tZANN0miCnWz,SpATywNh6bZuzm8s1ceuBUnMUAeoAHHw,9,25,1,18,0,2,1,0,47,6.714285714285714,1,0.0,17,1,15,0,8,2,3,1,0,33,14,1
4969,79020,lYvVL2L87vZrMtNfBHPIK2tByK515zCD,SpATywNh6bZuzm8s1ceuBUnMUAeoAHHw,31,51,23,38,12,0,10,0,134,19.142857142857142,1,0.0,9,23,32,12,42,0,6,10,0,76,58,1
4970,79022,twCpzhGO216Hze2mrl4NXCjfHuwTo4Bh,SpATywNh6bZuzm8s1ceuBUnMUAeoAHHw,28,42,26,15,9,0,9,0,101,14.428571428571429,4,0.0,5,26,15,9,37,0,0,9,0,55,46,0
4971,79055,zTHTtX2nKd2KBXQuLnlYdTrAwR5h128q,SpATywNh6bZuzm8s1ceuBUnMUAeoAHHw,10,19,1,14,0,0,2,0,36,5.142857142857143,1,0.0,12,1,13,0,7,0,1,2,0,26,10,1
4972,79061,MoBz0U3Ui9CRWte6snkIzBaarIFflstn,SpATywNh6bZuzm8s1ceuBUnMUAeoAHHw,15,18,8,18,3,2,11,3,63,9.0,2,0.0,4,8,18,3,14,2,0,11,3,33,30,1
4973,79110,TpoKGwVbR1z5uy5X3SWIdHRQv5iAfdP8,G8EPVSXsOYB5YQWZGiz1aVq5Pgr2GrQu,79,78,42,212,17,13,10,1,373,53.285714285714285,2,0.0,14,42,193,17,64,13,19,10,1,266,107,0
4974,79163,LwwIfMdYfjJJxHB8Z4Fggv4xXuygh6dE,A3fsA9Zfv1X2fVEQhTw51lKENdNrEqT3,7,12,3,0,0,0,3,0,18,2.5714285714285716,3,0.0,0,3,0,0,12,0,0,3,0,3,15,1
4975,79167,Zz3pwLjAzfZui2iOxDBByv28nniL3g2U,SpATywNh6bZuzm8s1ceuBUnMUAeoAHHw,14,20,7,13,4,0,2,0,46,6.571428571428571,1,0.0,10,7,13,4,10,0,0,2,0,34,12,1
4976,79169,LwwIfMdYfjJJxHB8Z4Fggv4xXuygh6dE,bWdj2GDclj5ofokWjzoa5jAwMkxCykd6,9,20,3,0,4,1,11,0,39,5.571428571428571,4,0.0,2,3,0,4,18,1,0,11,0,9,30,0
4977,79170,h774wdF6vIIcl50Js74gckwUtlv9SBGH,SpATywNh6bZuzm8s1ceuBUnMUAeoAHHw,14,35,21,6,5,2,8,0,77,11.0,3,0.0,7,21,6,5,28,2,0,8,0,39,38,0
4978,79172,layckrYedWZgFw7etRwkXZmJxZfLSCWL,RXDvfPUBYFlVdlueBFbLW0mhhAyGEqpt,1,0,0,0,0,0,1,0,1,0.14285714285714285,1,0.0,0,0,0,0,0,0,0,1,0,0,1,1
4979,79180,PT6UXcwKy3wc3VzHkqI3gbGZ6DxtjZzB,SpATywNh6bZuzm8s1ceuBUnMUAeoAHHw,5,4,1,0,0,0,2,0,7,1.0,1,0.0,0,1,0,0,4,0,0,2,0,1,6,0
4980,79273,DpXkrIHIAIPNESKyvFah0WhpVT5PHFeL,A3fsA9Zfv1X2fVEQhTw51lKENdNrEqT3,6,6,5,0,0,4,4,0,19,2.7142857142857144,2,0.0,0,5,0,0,6,4,0,4,0,5,14,1
4981,79287,wd4pAwN3deBeynXwR5OfOX4prNtBduEk,bWdj2GDclj5ofokWjzoa5jAwMkxCykd6,6,11,3,0,2,0,2,0,18,2.5714285714285716,1,0.0,5,3,0,2,6,0,0,2,0,10,8,1
4982,79290,vtrHNbtnxRGyZem1sSOdKIp109fZtSKY,SpATywNh6bZuzm8s1ceuBUnMUAeoAHHw,13,21,14,7,7,7,9,0,65,9.285714285714286,2,0.0,0,14,6,7,21,7,1,9,0,27,38,0
4983,79299,gpn05NwMGqKm6lLZGRrnOmPlhHxlC7Wb,A3fsA9Zfv1X2fVEQhTw51lKENdNrEqT3,28,7,3,44,1,0,7,0,62,8.857142857142858,1,0.0,1,3,43,1,6,0,1,7,0,48,14,1
4984,79307,3MN9gqffGxZJqVwbda6Nr5mGlWwnaW7z,G8EPVSXsOYB5YQWZGiz1aVq5Pgr2GrQu,9,10,7,0,5,0,2,0,24,3.4285714285714284,1,0.0,1,7,0,5,9,0,0,2,0,13,11,0
4985,79315,b9hN1tjIpM67gB8PuwPQ3u561lqo1V2f,A3fsA9Zfv1X2fVEQhTw51lKENdNrEqT3,30,26,21,12,18,2,10,1,90,12.857142857142858,2,0.0,1,21,12,18,25,2,0,10,1,52,38,1
4986,79352,giXuT5U1RtMqgo8IXt5j9x4mrlpr0AWq,SpATywNh6bZuzm8s1ceuBUnMUAeoAHHw,14,25,2,12,0,1,11,0,51,7.285714285714286,3,0.0,10,2,10,0,15,1,2,11,0,22,29,0
4987,79374,2Z36vzEoy2AuTF2qkFNHld62ohkbaoik,G8EPVSXsOYB5YQWZGiz1aVq5Pgr2GrQu,5,4,2,0,1,0,6,0,13,1.8571428571428572,1,0.0,0,2,0,1,4,0,0,6,0,3,10,1
4988,79378,LgPlpopSU02baX8XsEJO6rWixplusEKm,SpATywNh6bZuzm8s1ceuBUnMUAeoAHHw,21,32,18,9,4,2,11,0,76,10.857142857142858,4,0.0,10,18,8,4,22,2,1,11,0,40,36,0
4989,79430,3MN9gqffGxZJqVwbda6Nr5mGlWwnaW7z,SpATywNh6bZuzm8s1ceuBUnMUAeoAHHw,10,13,10,0,6,0,5,0,34,4.857142857142857,1,0.0,0,10,0,6,13,0,0,5,0,16,18,0
4990,79498,GPbq86k98Rz9tUbijEEopIymy9u0Fcyf,RXDvfPUBYFlVdlueBFbLW0mhhAyGEqpt,24,22,18,38,5,1,4,4,92,13.142857142857142,1,0.0,3,18,30,5,19,1,8,4,4,56,36,1
4991,79511,NMqhcmmxkLiM0RcDlPlkNnMgmo9q8VT7,A3fsA9Zfv1X2fVEQhTw51lKENdNrEqT3,3,4,0,0,0,0,1,0,5,0.7142857142857143,1,0.0,0,0,0,0,4,0,0,1,0,0,5,1
4992,79516,PSAOLNrXnjwLk6spKn3AQn9MyKNbkNFR,A3fsA9Zfv1X2fVEQhTw51lKENdNrEqT3,10,7,5,0,4,0,3,0,19,2.7142857142857144,1,0.0,0,5,0,4,7,0,0,3,0,9,10,1
4993,79530,iF24oNq097ygA95BwYxAfvpVnpWVn9EH,A3fsA9Zfv1X2fVEQhTw51lKENdNrEqT3,1,0,0,0,0,0,1,0,1,0.14285714285714285,1,0.0,0,0,0,0,0,0,0,1,0,0,1,1
4994,79568,rZUdPpi92l1qQIS8kuhajEO9kujkZRBg,SpATywNh6bZuzm8s1ceuBUnMUAeoAHHw,1,0,0,0,0,0,1,0,1,0.14285714285714285,1,0.0,0,0,0,0,0,0,0,1,0,0,1,1
4995,79582,yMKOk0dVftHnVR1CEiO9scq4ARXi4xK4,A3fsA9Zfv1X2fVEQhTw51lKENdNrEqT3,15,6,6,0,6,0,3,0,21,3.0,1,0.0,0,6,0,6,6,0,0,3,0,12,9,0
4996,79584,ZbdgVvxsxyG1aqBQ8n6eLVu27gWAZvhX,A3fsA9Zfv1X2fVEQhTw51lKENdNrEqT3,1,0,0,0,0,0,1,0,1,0.14285714285714285,1,0.0,0,0,0,0,0,0,0,1,0,0,1,1
4997,79606,ZOTpNZ0MPCzhXQVB7FrlPGVckR2bh01V,SpATywNh6bZuzm8s1ceuBUnMUAeoAHHw,8,6,5,0,0,4,9,0,24,3.4285714285714284,2,0.0,0,5,0,0,6,4,0,9,0,5,19,0
4998,79614,fIRimGrxWNqdzbEvkhoxiWFjGRhUXcWW,A3fsA9Zfv1X2fVEQhTw51lKENdNrEqT3,25,38,13,0,10,0,5,0,66,9.428571428571429,3,0.0,0,13,0,10,38,0,0,5,0,23,43,0
4999,79639,HHjw6PARN0UbkiffbOwvG4RULtVIyY0R,RXDvfPUBYFlVdlueBFbLW0mhhAyGEqpt,6,11,0,0,0,0,2,0,13,1.8571428571428572,1,0.0,1,0,0,0,10,0,0,2,0,1,12,0
5000,79658,MIuMzVdl8gwQZWh4ux7IRLhRo5aprHQC,A3fsA9Zfv1X2fVEQhTw51lKENdNrEqT3,24,13,10,0,10,0,2,0,35,5.0,1,0.0,0,10,0,10,13,0,0,2,0,20,15,1
5001,79672,kzKMRE4CEMjRtmtzEE50k044KTV0exYI,A3fsA9Zfv1X2fVEQhTw51lKENdNrEqT3,4,2,0,0,0,0,2,0,4,0.5714285714285714,1,0.0,0,0,0,0,2,0,0,2,0,0,4,1
5002,79708,rScZ8wYdCfayAwidHm4E5aYRTim0GnWj,A3fsA9Zfv1X2fVEQhTw51lKENdNrEqT3,7,3,2,0,2,0,4,0,11,1.5714285714285714,1,0.0,0,2,0,2,3,0,0,4,0,4,7,1
5003,79750,iRchfzTUfvY9CtdBwkeS8vPP8TSfaMHm,A3fsA9Zfv1X2fVEQhTw51lKENdNrEqT3,9,12,6,0,5,0,6,0,29,4.142857142857143,1,0.0,1,6,0,5,11,0,0,6,0,12,17,1
5004,79767,ffg9VbmMkFKj2DfO61ClA5PDHr5Xa6gN,A3fsA9Zfv1X2fVEQhTw51lKENdNrEqT3,16,37,7,0,6,0,5,0,55,7.857142857142857,5,0.0,0,7,0,6,37,0,0,5,0,13,42,1
5005,79789,WIkPVA3ZQexYqPa7aSal3hPiR2XYOXKW,A3fsA9Zfv1X2fVEQhTw51lKENdNrEqT3,42,18,16,60,13,0,2,0,109,15.571428571428571,1,0.0,1,16,52,13,17,0,8,2,0,82,27,1
5006,79797,ziI4sKMlAzhuWPMy9t2U96G01O68Dxyj,A3fsA9Zfv1X2fVEQhTw51lKENdNrEqT3,7,2,1,0,1,0,6,0,10,1.4285714285714286,1,0.0,0,1,0,1,2,0,0,6,0,2,8,0
5007,79813,qMFAmPw34z5IViYTtA1Kkpcn2uEg1WBM,RXDvfPUBYFlVdlueBFbLW0mhhAyGEqpt,19,26,11,16,9,0,2,0,64,9.142857142857142,2,0.0,4,11,14,9,22,0,2,2,0,38,26,1
5008,79859,gEzMd6gbgpZIm67NWd6vqHpEEo3Eo4i8,SpATywNh6bZuzm8s1ceuBUnMUAeoAHHw,1,0,0,0,0,0,1,0,1,0.14285714285714285,1,0.0,0,0,0,0,0,0,0,1,0,0,1,1
5009,79887,yonwfYKGqRaxFqA59D8fadwOwcb5hmqL,SpATywNh6bZuzm8s1ceuBUnMUAeoAHHw,20,35,13,28,5,14,18,1,114,16.285714285714285,5,0.0,16,13,26,5,19,14,2,18,1,60,54,1
5010,79908,Q2dKqJgalCRkN8Z90Lq1SNPa32DtEIlR,A3fsA9Zfv1X2fVEQhTw51lKENdNrEqT3,4,2,0,0,0,0,3,0,5,0.7142857142857143,2,0.0,0,0,0,0,2,0,0,3,0,0,5,1
5011,79912,6aZq0tRjnqwqsZYSpN4QHIWtCCCKxYqK,A3fsA9Zfv1X2fVEQhTw51lKENdNrEqT3,7,3,2,0,2,0,2,0,9,1.2857142857142858,1,0.0,0,2,0,2,3,0,0,2,0,4,5,1
5012,79954,U0h9ZcOzwmSa5zXabz3gRq51gj9CVPUf,SpATywNh6bZuzm8s1ceuBUnMUAeoAHHw,1,0,0,0,0,0,1,0,1,0.14285714285714285,1,0.0,0,0,0,0,0,0,0,1,0,0,1,0
5013,79959,ViTvmoQakNqraCyfp2YEkEE863w1n9bk,A3fsA9Zfv1X2fVEQhTw51lKENdNrEqT3,11,14,9,0,7,0,4,0,34,4.857142857142857,1,0.0,0,9,0,7,14,0,0,4,0,16,18,1
5014,79973,lxjW2IwfKKnK2DrRSZaIR9GsDl9lxdt8,A3fsA9Zfv1X2fVEQhTw51lKENdNrEqT3,28,25,13,0,9,1,12,1,61,8.714285714285714,3,0.0,0,13,0,9,25,1,0,12,1,22,39,0
5015,79990,M0c3f3OA8Aim8kZWQMZkBlO1O030yIDl,A3fsA9Zfv1X2fVEQhTw51lKENdNrEqT3,7,4,1,0,1,0,7,0,13,1.8571428571428572,1,0.0,0,1,0,1,4,0,0,7,0,2,11,1
5016,80011,va3cVfF38XAjn4LEh6VxTTEdlP5IupZ2,A3fsA9Zfv1X2fVEQhTw51lKENdNrEqT3,37,25,0,52,0,0,6,0,83,11.857142857142858,1,0.0,3,0,47,0,22,0,5,6,0,50,33,1
5017,80047,QjwQzuiA6TAJjCb0ag4sYfZRjiTOPACp,SpATywNh6bZuzm8s1ceuBUnMUAeoAHHw,18,49,27,5,14,1,18,0,114,16.285714285714285,4,0.0,4,27,5,14,45,1,0,18,0,50,64,0
5018,80069,srJeJbIuD6nlvLtYdUFiQcvh7X1ghk8m,A3fsA9Zfv1X2fVEQhTw51lKENdNrEqT3,1,0,0,0,0,0,1,0,1,0.14285714285714285,1,0.0,0,0,0,0,0,0,0,1,0,0,1,1
5019,80096,IAOTVxG7e06ArppQIZcVBCeppiZS52Zi,A3fsA9Zfv1X2fVEQhTw51lKENdNrEqT3,1,0,0,0,0,0,1,0,1,0.14285714285714285,1,0.0,0,0,0,0,0,0,0,1,0,0,1,1
5020,80097,RPansaKc9yPYyKahcqLAJO6a0GoBHglr,bWdj2GDclj5ofokWjzoa5jAwMkxCykd6,10,13,4,32,6,7,5,0,67,9.571428571428571,3,0.0,7,4,30,6,6,7,2,5,0,47,20,1
5021,80136,XQFWhrsULMJrGiXoFieAPwx4Rm1ETQ8D,SpATywNh6bZuzm8s1ceuBUnMUAeoAHHw,27,45,24,27,10,2,10,0,118,16.857142857142858,4,0.0,13,24,26,10,32,2,1,10,0,73,45,0
5022,80196,y6xjaNTFuIUic3qLUBgR8svfOIFXDQ53,A3fsA9Zfv1X2fVEQhTw51lKENdNrEqT3,2,0,0,0,0,0,4,0,4,0.5714285714285714,1,0.0,0,0,0,0,0,0,0,4,0,0,4,1
5023,80207,53qrF6M0dMx7kKnOiKvVv5yJevXuY3XD,RXDvfPUBYFlVdlueBFbLW0mhhAyGEqpt,50,27,16,87,9,5,9,7,160,22.857142857142858,1,0.0,8,16,79,9,19,5,8,9,7,112,48,1
5024,80226,IVH8kKmCoTvdDqBRydeePjJ8DeEc5nxo,G8EPVSXsOYB5YQWZGiz1aVq5Pgr2GrQu,11,6,0,8,1,2,9,1,27,3.857142857142857,1,0.0,4,0,5,1,2,2,3,9,1,10,17,1
5025,80231,v20UMppd3ocHkd49REEhfohYTaesL83r,SpATywNh6bZuzm8s1ceuBUnMUAeoAHHw,5,7,3,0,2,0,4,0,16,2.2857142857142856,4,0.0,3,3,0,2,4,0,0,4,0,8,8,1
5026,80256,qbxr7nsJKbupU2nnOZ4AXSvMY5DklIDV,SpATywNh6bZuzm8s1ceuBUnMUAeoAHHw,12,16,6,1,3,0,4,0,30,4.285714285714286,1,0.0,6,6,1,3,10,0,0,4,0,16,14,0
5027,80258,AlLFcyRB5UwpN8dJK67Vqu0OFPpIDrGm,A3fsA9Zfv1X2fVEQhTw51lKENdNrEqT3,68,56,46,168,31,18,9,0,328,46.857142857142854,4,0.0,4,46,137,31,52,18,31,9,0,218,110,0
5028,80288,TY4t65XwSRMNK0q3MPTxoH0jDDniCwnz,A3fsA9Zfv1X2fVEQhTw51lKENdNrEqT3,1,0,0,0,0,0,1,0,1,0.14285714285714285,1,0.0,0,0,0,0,0,0,0,1,0,0,1,1
5029,80289,ZNeDcv9lqRN7ZQjZM2CkfhEwlbeNJpas,SpATywNh6bZuzm8s1ceuBUnMUAeoAHHw,29,20,13,22,7,3,11,2,78,11.142857142857142,2,0.0,4,13,21,7,16,3,1,11,2,45,33,0
5030,80324,I90xPqkS9HpEgNxHw8dM4fDCcTPeHknd,A3fsA9Zfv1X2fVEQhTw51lKENdNrEqT3,1,0,0,0,0,0,1,0,1,0.14285714285714285,1,0.0,0,0,0,0,0,0,0,1,0,0,1,1
5031,80344,EFMEoi5W4mceo8rjft5LKrYvvT3E2eat,A3fsA9Zfv1X2fVEQhTw51lKENdNrEqT3,5,4,1,0,1,0,1,0,7,1.0,1,0.0,0,1,0,1,4,0,0,1,0,2,5,1
5032,80348,9D8Fr85Y0xJSTSvXENunTRQkQQzpKKhe,bWdj2GDclj5ofokWjzoa5jAwMkxCykd6,19,24,14,72,4,4,10,1,129,18.428571428571427,4,0.0,5,14,68,4,19,4,4,10,1,91,38,1
5033,80360,eShFyPGgCT65uThL7XGiKvmljTNciFAA,G8EPVSXsOYB5YQWZGiz1aVq5Pgr2GrQu,34,54,8,50,8,6,15,1,142,20.285714285714285,3,0.0,15,8,36,8,39,6,14,15,1,67,75,1
5034,80373,YrgwsEFjLyT5SXSOyIIpFlTBfXK1acSP,bWdj2GDclj5ofokWjzoa5jAwMkxCykd6,7,8,1,10,3,1,2,1,26,3.7142857142857144,1,0.0,6,1,8,3,2,1,2,2,1,18,8,0
5035,80400,xH5f8nfW6oTIgHjXoQgEUKIx6qvDN8rk,A3fsA9Zfv1X2fVEQhTw51lKENdNrEqT3,5,4,0,0,0,0,6,0,10,1.4285714285714286,3,0.0,0,0,0,0,4,0,0,6,0,0,10,1
5036,80406,9d6HoNqzGbbCd66bGVck7uPSgkXTez3M,G8EPVSXsOYB5YQWZGiz1aVq5Pgr2GrQu,14,22,4,4,5,0,7,0,42,6.0,3,0.0,11,4,3,5,11,0,1,7,0,23,19,1
5037,80454,SicKtTdinGjYgkh3dK0y8UiEfELy0LiN,bWdj2GDclj5ofokWjzoa5jAwMkxCykd6,4,2,0,0,0,0,5,0,7,1.0,2,0.0,0,0,0,0,2,0,0,5,0,0,7,1
5038,80505,I7kUxTrFR4kUt4IUmZUgm3AQtDQNh7Pu,G8EPVSXsOYB5YQWZGiz1aVq5Pgr2GrQu,21,25,22,36,8,4,27,0,122,17.428571428571427,4,0.0,0,22,28,8,25,4,8,27,0,58,64,0
5039,80550,CXCaJpUSDS18xEbIkOvQDpHLpsuhXdw4,A3fsA9Zfv1X2fVEQhTw51lKENdNrEqT3,6,3,1,0,1,0,2,0,7,1.0,1,0.0,0,1,0,1,3,0,0,2,0,2,5,1
5040,80561,0TYsGSagjtpdvts8BjnEYwbdzO0Cq9cu,bWdj2GDclj5ofokWjzoa5jAwMkxCykd6,5,2,1,0,1,0,4,0,8,1.1428571428571428,1,0.0,0,1,0,1,2,0,0,4,0,2,6,1
5041,80563,ZjWuXv8EONEQWoGCaTlXceVXFgdHRHNG,A3fsA9Zfv1X2fVEQhTw51lKENdNrEqT3,24,12,1,58,0,0,2,0,73,10.428571428571429,1,0.0,1,1,47,0,11,0,11,2,0,49,24,1
5042,80564,qWUac1M6H0GGCt2oRkcCo2PK0QcGvZVS,A3fsA9Zfv1X2fVEQhTw51lKENdNrEqT3,9,9,1,8,0,0,2,0,20,2.857142857142857,2,0.0,1,1,8,0,8,0,0,2,0,10,10,1
5043,80632,4CBJi9FPwBtDwABbM6tdSqW9vKh1q7Z5,SpATywNh6bZuzm8s1ceuBUnMUAeoAHHw,17,27,10,16,3,27,14,2,99,14.142857142857142,2,0.0,13,10,13,3,14,27,3,14,2,39,60,1
5044,80660,TMS9M7AUlYgaEtdQAX29SchyEATrODFG,G8EPVSXsOYB5YQWZGiz1aVq5Pgr2GrQu,63,86,36,88,20,3,11,2,246,35.142857142857146,4,0.0,45,36,54,20,41,3,34,11,2,155,91,1
5045,80698,CqJyXqN2l3WOJQLqxchvfRFp3seiLXw6,A3fsA9Zfv1X2fVEQhTw51lKENdNrEqT3,15,15,7,0,6,0,4,0,32,4.571428571428571,2,0.0,0,7,0,6,15,0,0,4,0,13,19,1
5046,80717,eVZffGeL4uoEevrNNMdcmW6f0YwT8plW,SpATywNh6bZuzm8s1ceuBUnMUAeoAHHw,16,20,9,13,4,2,10,2,60,8.571428571428571,3,0.0,6,9,13,4,14,2,0,10,2,32,28,1
5047,80728,EZ8RICWKm2CZHfClKFJxNtx1ItORs9so,SpATywNh6bZuzm8s1ceuBUnMUAeoAHHw,16,41,4,19,1,4,17,2,88,12.571428571428571,3,0.0,9,4,16,1,32,4,3,17,2,30,58,1
5048,80758,T4bTYOzPYArqtWPF4tmIGoxoB2vrFxrw,SpATywNh6bZuzm8s1ceuBUnMUAeoAHHw,19,19,12,6,7,0,7,1,52,7.428571428571429,3,0.0,3,12,6,7,16,0,0,7,1,28,24,1
5049,80779,6qgQAmX6y5wh5nEPRINOiKrZNoTl5yfT,bWdj2GDclj5ofokWjzoa5jAwMkxCykd6,19,38,20,62,9,31,19,2,181,25.857142857142858,5,0.0,11,20,58,9,27,31,4,19,2,98,83,1
5050,80780,Nn60hlJlXHP7n7M6lOuhaSQUkd1WY1lX,A3fsA9Zfv1X2fVEQhTw51lKENdNrEqT3,2,0,0,0,0,0,2,0,2,0.2857142857142857,1,0.0,0,0,0,0,0,0,0,2,0,0,2,1
5051,80798,B0jVKFlvXfKwVR9pXnhJZcf2VbxqeEJP,SpATywNh6bZuzm8s1ceuBUnMUAeoAHHw,9,9,5,0,3,0,4,0,21,3.0,2,0.0,0,5,0,3,9,0,0,4,0,8,13,1
5052,80799,cJ9a9VybEQZXRFqEMI78WQ8ukmEaaVlE,SpATywNh6bZuzm8s1ceuBUnMUAeoAHHw,15,20,7,19,3,4,5,0,58,8.285714285714286,2,0.0,10,7,16,3,10,4,3,5,0,36,22,0
5053,80825,IH2c5uYafZAMnz8GRu5q3bfkjqRBG0d4,bWdj2GDclj5ofokWjzoa5jAwMkxCykd6,4,3,1,0,1,0,3,0,8,1.1428571428571428,1,0.0,0,1,0,1,3,0,0,3,0,2,6,1
5054,80849,2mD1u3b1vLrSJM0DZTrsvLcZVBVwwd27,A3fsA9Zfv1X2fVEQhTw51lKENdNrEqT3,3,0,0,0,0,0,3,0,3,0.42857142857142855,1,0.0,0,0,0,0,0,0,0,3,0,0,3,1
5055,80867,pXgjy4DXaOKMQD4LAgLui9VHE5CpkZu9,fbPkOYLVPtPgIt0MxizjfFJov3JbHyAi,31,45,27,0,20,26,8,1,127,18.142857142857142,2,0.0,9,27,0,20,36,26,0,8,1,56,71,1
5056,80868,swFi5fb79eZLyE5zYDE8WBJhH3Y94beD,fbPkOYLVPtPgIt0MxizjfFJov3JbHyAi,2,0,0,0,0,0,2,0,2,0.2857142857142857,1,0.0,0,0,0,0,0,0,0,2,0,0,2,1
5057,80869,Ov1eEIsyiq4NpsQyBb4m5rDEEYvFdikk,fbPkOYLVPtPgIt0MxizjfFJov3JbHyAi,10,7,5,0,3,1,2,0,18,2.5714285714285716,1,0.0,0,5,0,3,7,1,0,2,0,8,10,1
5058,80870,YM9Z89N137bY5qphnaUaFSAicUvT78c0,fbPkOYLVPtPgIt0MxizjfFJov3JbHyAi,8,11,7,0,3,0,5,0,26,3.7142857142857144,1,0.0,0,7,0,3,11,0,0,5,0,10,16,1
5059,80871,Rs4pfmJlaHiSs2fYG1vucMoIlgnMNq35,fbPkOYLVPtPgIt0MxizjfFJov3JbHyAi,1,0,0,0,0,0,1,0,1,0.14285714285714285,1,0.0,0,0,0,0,0,0,0,1,0,0,1,1
5060,80873,J6Gdt3OhkKwtA1tiJMtQErFzdO5CDNjE,fbPkOYLVPtPgIt0MxizjfFJov3JbHyAi,4,3,0,0,0,0,1,0,4,0.5714285714285714,1,0.0,0,0,0,0,3,0,0,1,0,0,4,1
5061,80877,9aS1NSJb2Hj0xHbbuoyhLmktYrjypxsy,fbPkOYLVPtPgIt0MxizjfFJov3JbHyAi,31,69,24,45,18,26,20,0,202,28.857142857142858,5,0.0,34,24,44,18,35,26,1,20,0,120,82,1
5062,80878,mz4jh38pq3jPwJJzfaN8eT823I3JqGp6,fbPkOYLVPtPgIt0MxizjfFJov3JbHyAi,6,4,0,0,0,2,5,1,12,1.7142857142857142,1,0.0,0,0,0,0,4,2,0,5,1,0,12,1
5063,80881,whV1nFYZoFkMMEitqUr4NmhBR8HyCOwO,fbPkOYLVPtPgIt0MxizjfFJov3JbHyAi,10,18,12,0,6,24,8,0,68,9.714285714285714,4,0.0,0,12,0,6,18,24,0,8,0,18,50,1
5064,80882,a98Mt6r9LLCkAEPo2R3JVMN20OhIPoaG,fbPkOYLVPtPgIt0MxizjfFJov3JbHyAi,9,10,5,0,4,0,6,1,26,3.7142857142857144,4,0.0,0,5,0,4,10,0,0,6,1,9,17,1
5065,80884,jUXtuG5Q1xcdJqmPNWwEYGXvh7x6ZP49,fbPkOYLVPtPgIt0MxizjfFJov3JbHyAi,1,0,0,0,0,0,2,0,2,0.2857142857142857,2,0.0,0,0,0,0,0,0,0,2,0,0,2,1
5066,80886,0DzldTHKdoH90kklIAjpWyAEe6XDDjyM,fbPkOYLVPtPgIt0MxizjfFJov3JbHyAi,8,13,8,0,5,13,7,0,46,6.571428571428571,4,0.0,1,8,0,5,12,13,0,7,0,14,32,1
5067,80887,oFIudRLykO0Fs6hEVqUgdjhHssApq1CY,fbPkOYLVPtPgIt0MxizjfFJov3JbHyAi,10,6,3,8,4,0,2,0,23,3.2857142857142856,1,0.0,2,3,6,4,4,0,2,2,0,15,8,1
5068,80888,koWvCadm1og0LpcFvcQlTqhBDNIm2AFz,fbPkOYLVPtPgIt0MxizjfFJov3JbHyAi,8,6,4,0,3,0,3,0,16,2.2857142857142856,2,0.0,0,4,0,3,6,0,0,3,0,7,9,1
5069,80889,K8SEVoLEOyaxiId31CfQ3tViDlX904mj,fbPkOYLVPtPgIt0MxizjfFJov3JbHyAi,7,3,2,0,2,0,2,0,9,1.2857142857142858,1,0.0,0,2,0,2,3,0,0,2,0,4,5,1
5070,80893,u5RnzaYe9alTOldsdopsRhwom5jR9n5h,fbPkOYLVPtPgIt0MxizjfFJov3JbHyAi,12,16,6,4,7,0,3,0,36,5.142857142857143,1,0.0,8,6,4,7,8,0,0,3,0,25,11,1
5071,80895,b17BXpd9CJ1FbG7Eiys3N3TmOMsQOqc5,fbPkOYLVPtPgIt0MxizjfFJov3JbHyAi,6,2,1,0,1,0,3,0,7,1.0,1,0.0,0,1,0,1,2,0,0,3,0,2,5,1
5072,80897,IVsQLNPDPXZtEeF9QnUix2gm2WS214ki,fbPkOYLVPtPgIt0MxizjfFJov3JbHyAi,1,0,0,0,0,0,1,0,1,0.14285714285714285,1,0.0,0,0,0,0,0,0,0,1,0,0,1,1
5073,80898,87MEmQxd2seObxQu44Z8XlD7ySMr8nwp,fbPkOYLVPtPgIt0MxizjfFJov3JbHyAi,9,3,2,0,2,0,9,1,17,2.4285714285714284,1,0.0,0,2,0,2,3,0,0,9,1,4,13,1
5074,80899,LB9Y3hHJxXFKUivI2IDZO69UMgf1mHWd,fbPkOYLVPtPgIt0MxizjfFJov3JbHyAi,12,31,11,0,1,9,4,0,56,8.0,2,0.0,1,11,0,1,30,9,0,4,0,13,43,1
5075,80900,zbVrmGy9kpOt2q8xeIclHo9H8afE2cMh,fbPkOYLVPtPgIt0MxizjfFJov3JbHyAi,4,6,2,0,0,0,1,0,9,1.2857142857142858,1,0.0,0,2,0,0,6,0,0,1,0,2,7,1
5076,82295,2vTiDJaUXObkB4MCSVV6b36fCzIFNmlO,fbPkOYLVPtPgIt0MxizjfFJov3JbHyAi,7,1,1,0,1,14,16,1,34,4.857142857142857,1,0.0,0,1,0,1,1,14,0,16,1,2,32,1
5077,82303,7cOxNQ9QY0kpQ3XCTHRP00ygFCzb9CpO,fbPkOYLVPtPgIt0MxizjfFJov3JbHyAi,6,3,1,0,0,2,4,1,11,1.5714285714285714,1,0.0,0,1,0,0,3,2,0,4,1,1,10,1
5078,82347,HMYpimZGFgj5IczDutkfjUfnxl45PoHW,7GRhBDsirIGkRZBtSMEzNTyDr2JQm4xx,1,0,0,0,0,0,1,0,1,0.14285714285714285,1,0.0,0,0,0,0,0,0,0,1,0,0,1,1
5079,82357,1v1hnAW2fjxDgMlfMAcBqTKOh6UMFrVl,7GRhBDsirIGkRZBtSMEzNTyDr2JQm4xx,9,9,2,2,2,1,4,0,20,2.857142857142857,2,0.0,4,2,2,2,5,1,0,4,0,10,10,1
5080,82391,r6vCAWlYIzTyZ2tN64AHwtfHr1599fdG,7GRhBDsirIGkRZBtSMEzNTyDr2JQm4xx,41,190,4,41,9,1,40,1,286,40.857142857142854,7,0.0,125,4,35,9,65,1,6,40,1,173,113,0
5081,82633,xLA7fhjHBFsq0q4kxpkXfUkRljEs0TAd,SpATywNh6bZuzm8s1ceuBUnMUAeoAHHw,12,22,16,4,8,1,4,0,55,7.857142857142857,2,0.0,3,16,4,8,19,1,0,4,0,31,24,0
5082,82635,xLA7fhjHBFsq0q4kxpkXfUkRljEs0TAd,bWdj2GDclj5ofokWjzoa5jAwMkxCykd6,17,28,13,54,8,8,12,0,123,17.571428571428573,3,0.0,9,13,53,8,19,8,1,12,0,83,40,0
5083,82642,7IO6p4687fQRowFKh8aP2BRrTBz96sXF,G8EPVSXsOYB5YQWZGiz1aVq5Pgr2GrQu,27,19,8,24,8,0,9,1,69,9.857142857142858,3,0.0,7,8,16,8,12,0,8,9,1,39,30,0
5084,82722,i0k5iK0fS6RmfXLKfz70zhtGt8sKmdev,G8EPVSXsOYB5YQWZGiz1aVq5Pgr2GrQu,14,22,2,40,2,0,3,0,69,9.857142857142858,2,0.0,0,2,35,2,22,0,5,3,0,39,30,1
5085,82751,8kDMxN2jxnl0uIdlggQjT6QmHT7F6WvQ,A3fsA9Zfv1X2fVEQhTw51lKENdNrEqT3,9,10,1,0,0,0,5,0,16,2.2857142857142856,1,0.0,0,1,0,0,10,0,0,5,0,1,15,0
5086,82832,bNG7kJA3jy4DW8PDzMNAT9OoyHwhutqS,bWdj2GDclj5ofokWjzoa5jAwMkxCykd6,3,2,0,0,0,0,5,0,7,1.0,1,0.0,0,0,0,0,2,0,0,5,0,0,7,1
5087,82840,Jee7EGsn5XYP5oawysLFsO8VcnPFjYWM,SpATywNh6bZuzm8s1ceuBUnMUAeoAHHw,20,26,14,21,7,0,4,0,72,10.285714285714286,2,0.0,9,14,18,7,17,0,3,4,0,48,24,1
5088,82875,LSxdutAKHjruUktaLYDzR4TTFH4npHSj,SpATywNh6bZuzm8s1ceuBUnMUAeoAHHw,9,6,5,0,4,0,6,0,21,3.0,2,0.0,0,5,0,4,6,0,0,6,0,9,12,1
5089,82911,g1LVeBlQiVCOcKiTDDTy4PafQkGd4pbr,A3fsA9Zfv1X2fVEQhTw51lKENdNrEqT3,2,0,0,0,0,0,3,0,3,0.42857142857142855,2,0.0,0,0,0,0,0,0,0,3,0,0,3,0
5090,82912,dSKLyWRwDNYp6bnGVfES0oxRsg4F2fbZ,SpATywNh6bZuzm8s1ceuBUnMUAeoAHHw,6,5,0,0,0,0,3,0,8,1.1428571428571428,1,0.0,0,0,0,0,5,0,0,3,0,0,8,1
5091,82968,k3mZz4gOE5kxngWJdlg5ZkSuFCPjQxmM,A3fsA9Zfv1X2fVEQhTw51lKENdNrEqT3,9,5,3,0,3,0,3,0,14,2.0,1,0.0,0,3,0,3,5,0,0,3,0,6,8,1
5092,82997,HKDSRzc7MQzCfJsk49D6xFQK4oFHHvy7,RXDvfPUBYFlVdlueBFbLW0mhhAyGEqpt,25,50,2,0,2,0,9,0,63,9.0,2,0.0,13,2,0,2,37,0,0,9,0,17,46,1
5093,83123,ZNcLOAJ2r3H5DqhbGk1CiPtwI7ixaCeK,bWdj2GDclj5ofokWjzoa5jAwMkxCykd6,5,7,3,0,2,0,3,0,15,2.142857142857143,2,0.0,0,3,0,2,7,0,0,3,0,5,10,0
5094,83126,Lcn36O95deZy87mO20P7rqE00Sa7JkLZ,SpATywNh6bZuzm8s1ceuBUnMUAeoAHHw,16,28,12,18,2,16,12,1,89,12.714285714285714,4,0.0,11,12,15,2,17,16,3,12,1,40,49,1
5095,83161,pAklb1PvY7ruK0UegPVyIZm4Osf6iC9m,bWdj2GDclj5ofokWjzoa5jAwMkxCykd6,5,1,1,0,1,0,2,0,5,0.7142857142857143,1,0.0,0,1,0,1,1,0,0,2,0,2,3,1
5096,83237,EzJ8kmSst3q4WJG0Np16XBDvh9hFUAyd,SpATywNh6bZuzm8s1ceuBUnMUAeoAHHw,8,11,0,0,0,2,1,0,14,2.0,1,0.0,0,0,0,0,11,2,0,1,0,0,14,0
5097,83305,4NR9J7NrWx9P8bFiOFbZEGtYIezzdGum,SpATywNh6bZuzm8s1ceuBUnMUAeoAHHw,5,3,1,0,1,0,3,0,8,1.1428571428571428,2,0.0,0,1,0,1,3,0,0,3,0,2,6,1
5098,83314,n49l3ufDNhve5wMzUe1UGnoLeZWomGLA,SpATywNh6bZuzm8s1ceuBUnMUAeoAHHw,7,4,3,0,2,0,1,0,10,1.4285714285714286,1,0.0,0,3,0,2,4,0,0,1,0,5,5,1
5099,83403,e7qNFJlKhMPlLeAG8swrUc3pRnnUCD82,SpATywNh6bZuzm8s1ceuBUnMUAeoAHHw,29,39,24,33,12,2,9,0,119,17.0,4,0.0,9,24,30,12,30,2,3,9,0,75,44,0
5100,83425,Lr6km982apCQSCgmC6f9GQFgHOEktsCy,G8EPVSXsOYB5YQWZGiz1aVq5Pgr2GrQu,12,7,2,14,1,1,5,0,30,4.285714285714286,2,0.0,0,2,12,1,7,1,2,5,0,15,15,1
5101,83578,t8qBiDTvOvYmrxcVIErRuEOf38tywm6t,A3fsA9Zfv1X2fVEQhTw51lKENdNrEqT3,42,24,19,92,8,9,8,0,160,22.857142857142858,3,0.0,1,19,73,8,23,9,19,8,0,101,59,1
5102,83597,kzdGmpsGUR2isiUTRf34FiwBn190CZX2,SpATywNh6bZuzm8s1ceuBUnMUAeoAHHw,1,0,0,0,0,0,1,0,1,0.14285714285714285,1,0.0,0,0,0,0,0,0,0,1,0,0,1,1
5103,83610,LsCKaHxDojvW6mqkt4YixGtP1AxIvEcR,SpATywNh6bZuzm8s1ceuBUnMUAeoAHHw,17,24,0,14,0,2,11,1,52,7.428571428571429,3,0.0,0,0,12,0,24,2,2,11,1,12,40,0
5104,83614,f0G6xN4ok96NnHxUb12ID1EOiKvmCYmR,SpATywNh6bZuzm8s1ceuBUnMUAeoAHHw,5,13,9,0,0,0,4,0,26,3.7142857142857144,3,0.0,0,9,0,0,13,0,0,4,0,9,17,1
5105,83795,P0VuZGgCaFPCBxKorH7bJdlMsmBgjIrL,bWdj2GDclj5ofokWjzoa5jAwMkxCykd6,6,2,1,0,1,2,4,5,15,2.142857142857143,1,0.0,0,1,0,1,2,2,0,4,5,2,13,1
5106,83851,hkZJZMuEk3eRSgWhjH7jPcJrlgv2RTNl,A3fsA9Zfv1X2fVEQhTw51lKENdNrEqT3,14,7,5,18,4,0,2,0,36,5.142857142857143,1,0.0,0,5,15,4,7,0,3,2,0,24,12,1
5107,83858,mSQuPHmd8TP05MnBFR4zut82tnd837yj,G8EPVSXsOYB5YQWZGiz1aVq5Pgr2GrQu,10,20,2,0,3,0,5,0,30,4.285714285714286,2,0.0,6,2,0,3,14,0,0,5,0,11,19,0
5108,83861,yfR3kQ7JpR4tbAAtg2uJogcbjyExFgIX,A3fsA9Zfv1X2fVEQhTw51lKENdNrEqT3,25,16,0,60,0,0,7,0,83,11.857142857142858,3,0.0,3,0,58,0,13,0,2,7,0,61,22,1
5109,83916,9gwK2SMO9RzFmbR3NVs20xNig2HGOi8l,A3fsA9Zfv1X2fVEQhTw51lKENdNrEqT3,2,0,0,0,0,0,2,0,2,0.2857142857142857,2,0.0,0,0,0,0,0,0,0,2,0,0,2,1
5110,83933,bA4tnPZD0UU4XAL3OkL7nUjtkAzbgj9d,bWdj2GDclj5ofokWjzoa5jAwMkxCykd6,10,27,10,6,5,6,4,0,58,8.285714285714286,1,0.0,4,10,5,5,23,6,1,4,0,24,34,0
5111,83937,riM9GkB0ajSqpIPlVq4tRzOjk7wJ6NHE,SpATywNh6bZuzm8s1ceuBUnMUAeoAHHw,2,0,0,0,0,0,2,0,2,0.2857142857142857,1,0.0,0,0,0,0,0,0,0,2,0,0,2,1
5112,83949,Z89wynkx1rcXHYvlCNExAupGqq9VVjQV,G8EPVSXsOYB5YQWZGiz1aVq5Pgr2GrQu,23,5,4,56,1,0,9,1,76,10.857142857142858,2,0.0,0,4,48,1,5,0,8,9,1,53,23,1
5113,83978,19iVDfShKixZpg8xTJAbBZz9CTfyTS2H,A3fsA9Zfv1X2fVEQhTw51lKENdNrEqT3,5,3,1,0,1,0,2,0,7,1.0,1,0.0,0,1,0,1,3,0,0,2,0,2,5,1
5114,84001,rdlMbs5MAmZwKWZ5MP6d4JJy7danp2Mg,A3fsA9Zfv1X2fVEQhTw51lKENdNrEqT3,40,23,17,94,15,0,3,0,152,21.714285714285715,1,0.0,2,17,77,15,21,0,17,3,0,111,41,1
5115,84165,n1ESpvyobZkFsfrWJhKOuY4URaa1sUc5,SpATywNh6bZuzm8s1ceuBUnMUAeoAHHw,8,18,10,0,0,0,7,0,35,5.0,1,0.0,0,10,0,0,18,0,0,7,0,10,25,0
5116,84260,rYr2KHitWY2dJDjTm0iH4NPcJrqWE49C,fbPkOYLVPtPgIt0MxizjfFJov3JbHyAi,6,3,2,0,2,0,1,0,8,1.1428571428571428,1,0.0,0,2,0,2,3,0,0,1,0,4,4,1
5117,84262,FPAm2uFeanUhwrUMeNexrdAIqWOfXUXu,fbPkOYLVPtPgIt0MxizjfFJov3JbHyAi,9,3,2,0,1,0,9,2,17,2.4285714285714284,1,0.0,0,2,0,1,3,0,0,9,2,3,14,1
5118,84263,wYQFQjixTa6JPR4LS7RDubQDsjze2pIh,fbPkOYLVPtPgIt0MxizjfFJov3JbHyAi,4,0,0,0,0,1,6,0,7,1.0,1,0.0,0,0,0,0,0,1,0,6,0,0,7,1
5119,84265,RfVW0lNKrf9tzkgd827lLFW37SMuSXSa,fbPkOYLVPtPgIt0MxizjfFJov3JbHyAi,1,0,0,0,0,0,1,0,1,0.14285714285714285,1,0.0,0,0,0,0,0,0,0,1,0,0,1,1
5120,84266,Y9sABG91qMGS63qErzaDtI7NXtIr1yry,fbPkOYLVPtPgIt0MxizjfFJov3JbHyAi,1,0,0,0,0,0,2,0,2,0.2857142857142857,1,0.0,0,0,0,0,0,0,0,2,0,0,2,1
5121,84267,fSXZR9jouiiFWLCY3FdQ789t2sGYhvFo,fbPkOYLVPtPgIt0MxizjfFJov3JbHyAi,8,3,2,0,2,0,5,0,12,1.7142857142857142,1,0.0,0,2,0,2,3,0,0,5,0,4,8,1
5122,84269,m3CYAa4IcxX9Ylz9hZ2wRjnl2ftCrROV,fbPkOYLVPtPgIt0MxizjfFJov3JbHyAi,2,0,0,0,0,0,2,0,2,0.2857142857142857,1,0.0,0,0,0,0,0,0,0,2,0,0,2,1
5123,84271,hqClGLaQsSBO8I9GqLKpIixM0sA0K0b8,fbPkOYLVPtPgIt0MxizjfFJov3JbHyAi,7,5,2,0,1,0,6,0,14,2.0,1,0.0,0,2,0,1,5,0,0,6,0,3,11,0
5124,84272,evnakjU40Z6lomGsTCUgDGsdugdMX48K,fbPkOYLVPtPgIt0MxizjfFJov3JbHyAi,1,0,0,0,0,0,1,0,1,0.14285714285714285,1,0.0,0,0,0,0,0,0,0,1,0,0,1,1
5125,84275,pzjUl0u19ajI9ZVL0U8kEZyjNgq0vPjp,fbPkOYLVPtPgIt0MxizjfFJov3JbHyAi,6,1,1,0,1,0,3,0,6,0.8571428571428571,1,0.0,0,1,0,1,1,0,0,3,0,2,4,1
5126,84280,BCFi8OFpWeV6fuTRoD5vV8AJMWuQ1jB1,fbPkOYLVPtPgIt0MxizjfFJov3JbHyAi,1,0,0,0,0,0,1,0,1,0.14285714285714285,1,0.0,0,0,0,0,0,0,0,1,0,0,1,1
5127,84283,e0psMwhUBdLDxrOxBkoveKoEdFTTZrF1,fbPkOYLVPtPgIt0MxizjfFJov3JbHyAi,1,0,0,0,0,0,1,0,1,0.14285714285714285,1,0.0,0,0,0,0,0,0,0,1,0,0,1,1
5128,84286,jzGZfbr4RQdn7HQn4oyJMDfKBcS7VFEE,fbPkOYLVPtPgIt0MxizjfFJov3JbHyAi,5,5,0,0,0,0,5,0,10,1.4285714285714286,1,0.0,0,0,0,0,5,0,0,5,0,0,10,1
5129,84287,7Wr0weM79zMxBVlRbYesNzjHgoZsdOEJ,fbPkOYLVPtPgIt0MxizjfFJov3JbHyAi,5,2,1,0,1,0,2,0,6,0.8571428571428571,1,0.0,0,1,0,1,2,0,0,2,0,2,4,1
5130,84288,7o7xgD7LMzcqbchAXccb0936AlSMEPrX,fbPkOYLVPtPgIt0MxizjfFJov3JbHyAi,11,16,5,0,2,1,8,1,33,4.714285714285714,1,0.0,0,5,0,2,16,1,0,8,1,7,26,1
5131,84290,ZjhTJ45cHD4xtUxPoyNMJGOQiBl5fTQp,fbPkOYLVPtPgIt0MxizjfFJov3JbHyAi,5,1,1,0,1,0,3,0,6,0.8571428571428571,1,0.0,0,1,0,1,1,0,0,3,0,2,4,1
5132,84292,vvCucU5XJyhTM3r43nJfSwk9oTpOoOzq,fbPkOYLVPtPgIt0MxizjfFJov3JbHyAi,2,0,0,0,0,0,2,0,2,0.2857142857142857,1,0.0,0,0,0,0,0,0,0,2,0,0,2,1
5133,84428,X7EWmuNzsz8xJY0A1pRUOJGHwrCZ0B64,bWdj2GDclj5ofokWjzoa5jAwMkxCykd6,5,4,1,0,2,0,6,0,13,1.8571428571428572,1,0.0,2,1,0,2,2,0,0,6,0,5,8,1
5134,84435,OOJh2Yrr6RQf9QAHFBo7EBzeZ2OAmLfw,SpATywNh6bZuzm8s1ceuBUnMUAeoAHHw,10,48,15,0,1,3,15,2,84,12.0,5,0.0,0,15,0,1,48,3,0,15,2,16,68,1
5135,84436,Vu8rN942EwDIOj6iE8IDqvSFXpvGHO9R,bWdj2GDclj5ofokWjzoa5jAwMkxCykd6,1,0,0,0,0,0,1,0,1,0.14285714285714285,1,0.0,0,0,0,0,0,0,0,1,0,0,1,1
5136,84456,RGf4k3THi4AV4qsAjc1UEOWiIeDYcchf,RXDvfPUBYFlVdlueBFbLW0mhhAyGEqpt,1,0,0,0,0,0,4,0,4,0.5714285714285714,1,0.0,0,0,0,0,0,0,0,4,0,0,4,1
5137,84462,bfYktB6xMRG2G8ooGt6o3rE63qV6JxlI,A3fsA9Zfv1X2fVEQhTw51lKENdNrEqT3,1,0,0,0,0,0,1,0,1,0.14285714285714285,1,0.0,0,0,0,0,0,0,0,1,0,0,1,1
5138,84519,RijiZcjqs3Sau2onXuynGNDorKgFFeFF,bWdj2GDclj5ofokWjzoa5jAwMkxCykd6,2,0,0,0,0,0,2,0,2,0.2857142857142857,1,0.0,0,0,0,0,0,0,0,2,0,0,2,1
5139,84525,Q8lgDaE6CB6Qe5bNGFRY9Gtyuy1mU1jD,bWdj2GDclj5ofokWjzoa5jAwMkxCykd6,5,6,1,0,0,0,2,0,9,1.2857142857142858,1,0.0,1,1,0,0,5,0,0,2,0,2,7,1
5140,84556,OatCEetKd31vq2MFNsgH6MMikZrZEqiC,bWdj2GDclj5ofokWjzoa5jAwMkxCykd6,6,5,0,0,1,0,3,0,9,1.2857142857142858,1,0.0,0,0,0,1,5,0,0,3,0,1,8,1
5141,84580,7dBPQqnhg3HraIZoj8IGy6tqqgLAonOI,SpATywNh6bZuzm8s1ceuBUnMUAeoAHHw,22,39,1,22,0,0,5,0,67,9.571428571428571,2,0.0,18,1,21,0,21,0,1,5,0,40,27,1
5142,84601,xH5f8nfW6oTIgHjXoQgEUKIx6qvDN8rk,SpATywNh6bZuzm8s1ceuBUnMUAeoAHHw,10,10,5,4,2,0,3,0,24,3.4285714285714284,1,0.0,3,5,3,2,7,0,1,3,0,13,11,1
5143,84623,bVCYDQX7pJxff6OyJX4M9s17AtFlpk5i,bWdj2GDclj5ofokWjzoa5jAwMkxCykd6,7,4,2,0,2,0,2,0,10,1.4285714285714286,1,0.0,0,2,0,2,4,0,0,2,0,4,6,1
5144,84653,M8sw9Q866fjD6jCvGFf8R8DxTYZlPOJu,A3fsA9Zfv1X2fVEQhTw51lKENdNrEqT3,6,3,2,0,1,0,2,0,8,1.1428571428571428,1,0.0,0,2,0,1,3,0,0,2,0,3,5,1
5145,84661,WEqUhplW7x1SpLabVjNcI5M4HsCYjumg,bWdj2GDclj5ofokWjzoa5jAwMkxCykd6,1,0,0,0,0,0,1,0,1,0.14285714285714285,1,0.0,0,0,0,0,0,0,0,1,0,0,1,1
5146,84662,WEqUhplW7x1SpLabVjNcI5M4HsCYjumg,A3fsA9Zfv1X2fVEQhTw51lKENdNrEqT3,1,0,0,0,0,0,1,0,1,0.14285714285714285,1,0.0,0,0,0,0,0,0,0,1,0,0,1,0
5147,84666,hBNiP82EasOgIR36wjHyg8vPIDQi3YO9,bWdj2GDclj5ofokWjzoa5jAwMkxCykd6,18,26,14,63,3,24,46,1,177,25.285714285714285,5,0.0,3,14,57,3,23,24,6,46,1,77,100,1
5148,84675,BEEx400Zym1Adj0LXV9O094DcgDYxMgU,SpATywNh6bZuzm8s1ceuBUnMUAeoAHHw,4,2,1,0,1,2,1,0,7,1.0,1,0.0,0,1,0,1,2,2,0,1,0,2,5,1
5149,84683,4VbB29c0q05cB50SX5b3ExZB3pSJc6RG,bWdj2GDclj5ofokWjzoa5jAwMkxCykd6,1,0,0,0,0,0,1,0,1,0.14285714285714285,1,0.0,0,0,0,0,0,0,0,1,0,0,1,1
5150,84699,BePz5wimB2cOHtaUExV25HDlvULcE611,bWdj2GDclj5ofokWjzoa5jAwMkxCykd6,1,0,0,0,0,0,1,0,1,0.14285714285714285,1,0.0,0,0,0,0,0,0,0,1,0,0,1,1
5151,84700,y6ntZnNLGo4HBLvhhvkQknL88GLC1lnO,A3fsA9Zfv1X2fVEQhTw51lKENdNrEqT3,14,18,11,0,7,1,6,1,44,6.285714285714286,2,0.0,0,11,0,7,18,1,0,6,1,18,26,1
5152,84701,T7Fjesc6ALJYDwDrKyS5CHisl2gr4aWJ,SpATywNh6bZuzm8s1ceuBUnMUAeoAHHw,18,25,8,16,4,2,7,1,63,9.0,1,0.0,11,8,15,4,14,2,1,7,1,38,25,1
5153,84702,BePz5wimB2cOHtaUExV25HDlvULcE611,A3fsA9Zfv1X2fVEQhTw51lKENdNrEqT3,7,4,2,0,2,0,2,0,10,1.4285714285714286,1,0.0,0,2,0,2,4,0,0,2,0,4,6,1
5154,84709,1Ld3jQU8M0eiaLBshs8gjcgQEfdlgHyZ,A3fsA9Zfv1X2fVEQhTw51lKENdNrEqT3,4,1,0,0,0,0,4,0,5,0.7142857142857143,2,0.0,0,0,0,0,1,0,0,4,0,0,5,1
5155,84728,GEuM5Jv5mgEiHQoZ7WZazbnkG2fcrd9Y,SpATywNh6bZuzm8s1ceuBUnMUAeoAHHw,27,36,23,21,15,2,4,0,101,14.428571428571429,2,0.0,10,23,19,15,26,2,2,4,0,67,34,0
5156,84745,BecDXRtXjm4nVBtBp7AS3BiGeJeKZmYu,SpATywNh6bZuzm8s1ceuBUnMUAeoAHHw,8,19,14,0,4,2,8,0,47,6.714285714285714,2,0.0,0,14,0,4,19,2,0,8,0,18,29,1
5157,84762,NC1pdSztpfJLgz1bqVoe5aonviJWe881,A3fsA9Zfv1X2fVEQhTw51lKENdNrEqT3,9,7,1,0,1,1,5,0,15,2.142857142857143,1,0.0,0,1,0,1,7,1,0,5,0,2,13,1
5158,84772,zZhdHu8U17iajwoRnuWugvDVR1mdDKy8,bWdj2GDclj5ofokWjzoa5jAwMkxCykd6,5,2,1,0,1,0,2,0,6,0.8571428571428571,1,0.0,0,1,0,1,2,0,0,2,0,2,4,1
5159,84777,pQdSl7i5ZuZeH9uPILgdHrvwskp4vc4V,SpATywNh6bZuzm8s1ceuBUnMUAeoAHHw,2,0,0,0,0,0,2,0,2,0.2857142857142857,1,0.0,0,0,0,0,0,0,0,2,0,0,2,1
5160,84779,Yg1xD2SamgKDKmDpRN2e3H3NAX0vGE2e,SpATywNh6bZuzm8s1ceuBUnMUAeoAHHw,23,36,2,31,1,7,16,0,93,13.285714285714286,3,0.0,18,2,28,1,18,7,3,16,0,49,44,1
5161,84789,rK4055OdlTymOWiwkxW7eIve09mowPhX,SpATywNh6bZuzm8s1ceuBUnMUAeoAHHw,7,7,3,0,1,0,2,0,13,1.8571428571428572,1,0.0,3,3,0,1,4,0,0,2,0,7,6,1
5162,84792,uGYj0yruFsWhwZGIUR02DogFquupaSDC,A3fsA9Zfv1X2fVEQhTw51lKENdNrEqT3,2,0,0,0,0,0,2,0,2,0.2857142857142857,1,0.0,0,0,0,0,0,0,0,2,0,0,2,1
5163,84795,uGYj0yruFsWhwZGIUR02DogFquupaSDC,SpATywNh6bZuzm8s1ceuBUnMUAeoAHHw,3,0,0,0,0,0,3,0,3,0.42857142857142855,1,0.0,0,0,0,0,0,0,0,3,0,0,3,1
5164,84798,TMW9SZvtLJ7yT5p9QtW5dUGKwlkcqKyn,SpATywNh6bZuzm8s1ceuBUnMUAeoAHHw,4,5,0,0,0,0,1,0,6,0.8571428571428571,1,0.0,0,0,0,0,5,0,0,1,0,0,6,1
5165,84805,eo86tl8OT9De2TqE4YR9qShJM6EFKpQ8,bWdj2GDclj5ofokWjzoa5jAwMkxCykd6,1,0,0,0,0,0,1,0,1,0.14285714285714285,1,0.0,0,0,0,0,0,0,0,1,0,0,1,1
5166,84812,hfXydPAjmOPsUaxL2NqJ9TVTB2YLFfnT,A3fsA9Zfv1X2fVEQhTw51lKENdNrEqT3,6,6,4,0,1,0,1,0,12,1.7142857142857142,1,0.0,1,4,0,1,5,0,0,1,0,6,6,1
5167,84817,Wefj86tFjwJZnMq6IAWMjbzJgYWyoGE5,SpATywNh6bZuzm8s1ceuBUnMUAeoAHHw,5,2,1,0,1,0,2,0,6,0.8571428571428571,1,0.0,0,1,0,1,2,0,0,2,0,2,4,1
5168,84826,Q9zNW7tUNygCfX90HmMYh3sp90BWwKOU,SpATywNh6bZuzm8s1ceuBUnMUAeoAHHw,5,5,2,0,1,0,3,0,11,1.5714285714285714,2,0.0,0,2,0,1,5,0,0,3,0,3,8,1
5169,84828,Q9zNW7tUNygCfX90HmMYh3sp90BWwKOU,A3fsA9Zfv1X2fVEQhTw51lKENdNrEqT3,7,5,2,0,2,0,4,0,13,1.8571428571428572,2,0.0,0,2,0,2,5,0,0,4,0,4,9,1
5170,84830,Q9zNW7tUNygCfX90HmMYh3sp90BWwKOU,bWdj2GDclj5ofokWjzoa5jAwMkxCykd6,6,2,1,0,1,1,7,1,13,1.8571428571428572,2,0.0,0,1,0,1,2,1,0,7,1,2,11,1
5171,84833,lYZxf8lh7ftdpqB6JLOchZTdcrWSTRKb,SpATywNh6bZuzm8s1ceuBUnMUAeoAHHw,1,0,0,0,0,0,1,0,1,0.14285714285714285,1,0.0,0,0,0,0,0,0,0,1,0,0,1,1
5172,84839,VIwJtaSOWWljnDL02ObzIxH4JeVU0QQ1,A3fsA9Zfv1X2fVEQhTw51lKENdNrEqT3,31,33,23,0,13,1,20,0,90,12.857142857142858,5,0.0,0,23,0,13,33,1,0,20,0,36,54,1
5173,84843,SgKrscfCtmytbxsrqs57oYYzOpyIlSfF,A3fsA9Zfv1X2fVEQhTw51lKENdNrEqT3,52,32,20,74,10,13,18,1,168,24.0,4,0.0,4,20,64,10,28,13,10,18,1,98,70,0
5174,84847,FeSQQc9CIFMTYLlHcSRbUJqf0NNwxJ2K,A3fsA9Zfv1X2fVEQhTw51lKENdNrEqT3,42,51,19,44,11,0,9,0,134,19.142857142857142,3,0.0,3,19,43,11,48,0,1,9,0,76,58,0
5175,84848,ykaUPJW4Nc9r2mv4b25QxgdHgIcQ63RQ,A3fsA9Zfv1X2fVEQhTw51lKENdNrEqT3,3,5,1,0,0,0,1,0,7,1.0,2,0.0,0,1,0,0,5,0,0,1,0,1,6,0
5176,84851,1GaXo8IuKFR6VdEVIYRJbTRl2qOzgbEk,SpATywNh6bZuzm8s1ceuBUnMUAeoAHHw,20,15,12,2,9,0,2,0,40,5.714285714285714,2,0.0,1,12,2,9,14,0,0,2,0,24,16,1
5177,84859,tW4kGyQmGPxJ7lQyOwGHaOFglTma7gIC,A3fsA9Zfv1X2fVEQhTw51lKENdNrEqT3,1,0,0,0,0,0,1,0,1,0.14285714285714285,1,0.0,0,0,0,0,0,0,0,1,0,0,1,1
5178,84861,HWTC2OrGiLVAGzdqeYnCu2ZFUrUbe6I6,A3fsA9Zfv1X2fVEQhTw51lKENdNrEqT3,24,13,11,0,9,0,10,0,43,6.142857142857143,2,0.0,0,11,0,9,13,0,0,10,0,20,23,1
5179,84878,94L6G6uqjoIozyLQIsc4GEWmNn1tQth5,SpATywNh6bZuzm8s1ceuBUnMUAeoAHHw,5,5,2,0,1,0,1,0,9,1.2857142857142858,1,0.0,2,2,0,1,3,0,0,1,0,5,4,1
5180,84900,kFEFWVRKxySg48KS2BQ5EGBj2Fy43YYR,SpATywNh6bZuzm8s1ceuBUnMUAeoAHHw,20,50,0,41,0,0,3,0,94,13.428571428571429,2,0.0,29,0,34,0,21,0,7,3,0,63,31,0
5181,84901,vDE54330fhfIeduEF4A9zDFR0caHiOdH,SpATywNh6bZuzm8s1ceuBUnMUAeoAHHw,5,4,2,0,2,0,1,0,9,1.2857142857142858,1,0.0,0,2,0,2,4,0,0,1,0,4,5,0
5182,84917,0vwRPKOOXqPVOG208KGIKC6ZMS7Sq8oQ,SpATywNh6bZuzm8s1ceuBUnMUAeoAHHw,1,0,0,0,0,0,1,0,1,0.14285714285714285,1,0.0,0,0,0,0,0,0,0,1,0,0,1,1
5183,84921,P8HECw7bHyNqGqPTlWbv24tTg1SG6bAf,bWdj2GDclj5ofokWjzoa5jAwMkxCykd6,5,2,1,0,1,0,2,0,6,0.8571428571428571,1,0.0,0,1,0,1,2,0,0,2,0,2,4,1
5184,84961,Z7OL2jReCGgQtTEQuUTXjMfA5lyDuHVX,bWdj2GDclj5ofokWjzoa5jAwMkxCykd6,1,0,0,0,0,0,1,0,1,0.14285714285714285,1,0.0,0,0,0,0,0,0,0,1,0,0,1,1
5185,84966,pCc4oMnSwjyLKgjKHMWP0AClAZXrGa7k,SpATywNh6bZuzm8s1ceuBUnMUAeoAHHw,4,3,2,0,2,0,1,0,8,1.1428571428571428,1,0.0,0,2,0,2,3,0,0,1,0,4,4,1
5186,84984,DzeVjg4mxykX9i07xMVI01d13jNEeveb,SpATywNh6bZuzm8s1ceuBUnMUAeoAHHw,7,2,1,0,1,1,5,0,10,1.4285714285714286,1,0.0,0,1,0,1,2,1,0,5,0,2,8,1
5187,84985,CrUGk3m8dLEwGtioGoHIpBu2eedFaqft,A3fsA9Zfv1X2fVEQhTw51lKENdNrEqT3,1,0,0,0,0,0,1,0,1,0.14285714285714285,1,0.0,0,0,0,0,0,0,0,1,0,0,1,1
5188,84991,NA0DQ3D2dj2Qrm5FSVbmrxMOfzF4fwPf,A3fsA9Zfv1X2fVEQhTw51lKENdNrEqT3,4,4,0,0,0,2,2,0,8,1.1428571428571428,1,0.0,0,0,0,0,4,2,0,2,0,0,8,1
5189,85012,DyupaV8BmUavHjvovvxyDg1D0z37S8dm,bWdj2GDclj5ofokWjzoa5jAwMkxCykd6,8,9,6,0,4,0,5,0,24,3.4285714285714284,3,0.0,0,6,0,4,9,0,0,5,0,10,14,1
5190,85019,aIIHBjdeRcv9jhajcTkxD39vpVMqF1ri,RXDvfPUBYFlVdlueBFbLW0mhhAyGEqpt,6,4,2,0,1,0,1,0,8,1.1428571428571428,1,0.0,0,2,0,1,4,0,0,1,0,3,5,1
5191,85021,QAaGqoCRVYYJLVC9SEo8gPzESLmuOfNy,SpATywNh6bZuzm8s1ceuBUnMUAeoAHHw,6,3,1,0,2,0,1,0,7,1.0,1,0.0,0,1,0,2,3,0,0,1,0,3,4,1
5192,85025,BvCRPlMfMau2kDEBEjyV1l6RJMQy5B5l,A3fsA9Zfv1X2fVEQhTw51lKENdNrEqT3,5,3,2,0,0,0,4,0,9,1.2857142857142858,1,0.0,0,2,0,0,3,0,0,4,0,2,7,1
5193,85046,kNdT4Mob6J1VkdvqbhmS4aPzbDLqNeYP,bWdj2GDclj5ofokWjzoa5jAwMkxCykd6,5,5,1,0,1,0,1,0,8,1.1428571428571428,2,0.0,0,1,0,1,5,0,0,1,0,2,6,1
5194,85050,nyeqFiX3kXuwJTyYhNUJyRvPBqtJ6Two,bWdj2GDclj5ofokWjzoa5jAwMkxCykd6,5,2,1,0,1,0,4,0,8,1.1428571428571428,1,0.0,0,1,0,1,2,0,0,4,0,2,6,1
5195,85076,oW1xvgPq04VONgGO2ScFMsBR7tam1x2P,SpATywNh6bZuzm8s1ceuBUnMUAeoAHHw,6,6,1,0,1,0,2,0,10,1.4285714285714286,1,0.0,0,1,0,1,6,0,0,2,0,2,8,1
5196,85111,4sNqSI7Ntno9WsJhOo6RhAKwZwVuo3TV,bWdj2GDclj5ofokWjzoa5jAwMkxCykd6,1,0,0,0,0,0,1,0,1,0.14285714285714285,1,0.0,0,0,0,0,0,0,0,1,0,0,1,1
5197,85125,HpVSIYjYyErYvGk0jIIh7vGC0VGqoFpj,bWdj2GDclj5ofokWjzoa5jAwMkxCykd6,8,4,2,0,1,0,7,1,15,2.142857142857143,1,0.0,0,2,0,1,4,0,0,7,1,3,12,0
5198,85126,PWCmirnemxe8gmyr1O505eqeMATy6y8u,SpATywNh6bZuzm8s1ceuBUnMUAeoAHHw,7,3,2,0,2,0,2,0,9,1.2857142857142858,1,0.0,0,2,0,2,3,0,0,2,0,4,5,0
5199,85127,dZqFLbQhzRGv0XrnoR6Btyn7eZPLWNcs,SpATywNh6bZuzm8s1ceuBUnMUAeoAHHw,12,18,0,20,0,0,2,0,40,5.714285714285714,1,0.0,6,0,17,0,12,0,3,2,0,23,17,1
5200,85129,BvCRPlMfMau2kDEBEjyV1l6RJMQy5B5l,bWdj2GDclj5ofokWjzoa5jAwMkxCykd6,4,7,3,0,0,2,5,0,17,2.4285714285714284,1,0.0,2,3,0,0,5,2,0,5,0,5,12,1
5201,85135,n2FEbIJOdMpzLhQAaysQpPRu04nDuH4a,bWdj2GDclj5ofokWjzoa5jAwMkxCykd6,7,9,4,0,3,0,2,0,18,2.5714285714285716,1,0.0,0,4,0,3,9,0,0,2,0,7,11,1
5202,85144,CVCf4od7ffnWY5VcGG9qXOV7fsgr6eo9,G8EPVSXsOYB5YQWZGiz1aVq5Pgr2GrQu,8,2,0,0,0,0,13,0,15,2.142857142857143,1,0.0,0,0,0,0,2,0,0,13,0,0,15,1
5203,85174,TNWu8lQOCqXwhlhWhjlBSPXoG0TmfsH5,SpATywNh6bZuzm8s1ceuBUnMUAeoAHHw,1,0,0,0,0,0,2,0,2,0.2857142857142857,1,0.0,0,0,0,0,0,0,0,2,0,0,2,1
5204,85178,TNWu8lQOCqXwhlhWhjlBSPXoG0TmfsH5,bWdj2GDclj5ofokWjzoa5jAwMkxCykd6,1,0,0,0,0,0,2,0,2,0.2857142857142857,1,0.0,0,0,0,0,0,0,0,2,0,0,2,1
5205,85182,TNWu8lQOCqXwhlhWhjlBSPXoG0TmfsH5,A3fsA9Zfv1X2fVEQhTw51lKENdNrEqT3,1,0,0,0,0,0,2,0,2,0.2857142857142857,1,0.0,0,0,0,0,0,0,0,2,0,0,2,1
5206,85191,YgaRsb5CJPElWQw5mvJ8Vl3IfLfYzm4F,SpATywNh6bZuzm8s1ceuBUnMUAeoAHHw,21,19,10,10,7,0,8,1,55,7.857142857142857,3,0.0,3,10,10,7,16,0,0,8,1,30,25,1
5207,85204,rSg9Ux5o4Clwkrl8yQB8aMYBxGhrELBb,bWdj2GDclj5ofokWjzoa5jAwMkxCykd6,5,3,1,0,1,0,2,0,7,1.0,1,0.0,0,1,0,1,3,0,0,2,0,2,5,1
5208,85215,hu8eak1Xmf8voE8pnxPzkSD2dZP9Sipf,RXDvfPUBYFlVdlueBFbLW0mhhAyGEqpt,3,1,0,0,0,0,2,0,3,0.42857142857142855,1,0.0,0,0,0,0,1,0,0,2,0,0,3,1
5209,85221,QtVFRX2q8o00yrhDoRxTCIn6JhufsUXY,A3fsA9Zfv1X2fVEQhTw51lKENdNrEqT3,1,0,0,0,0,0,1,0,1,0.14285714285714285,1,0.0,0,0,0,0,0,0,0,1,0,0,1,1
5210,85234,x8deFWL3OuMwdtM1Ar06UAP0kS8JTUGt,SpATywNh6bZuzm8s1ceuBUnMUAeoAHHw,14,32,0,21,0,0,2,0,55,7.857142857142857,1,0.0,19,0,18,0,13,0,3,2,0,37,18,1
5211,85236,rSg9Ux5o4Clwkrl8yQB8aMYBxGhrELBb,A3fsA9Zfv1X2fVEQhTw51lKENdNrEqT3,6,3,1,0,1,0,2,0,7,1.0,1,0.0,0,1,0,1,3,0,0,2,0,2,5,1
5212,85254,5AnTWuSZRA41O05i9OVXdtPUlL8FmaJL,SpATywNh6bZuzm8s1ceuBUnMUAeoAHHw,13,22,4,2,1,7,19,3,58,8.285714285714286,2,0.0,1,4,2,1,21,7,0,19,3,8,50,1
5213,85307,HDadS1kWhA9nJbFHsRG6aT6o1pPlcFrf,SpATywNh6bZuzm8s1ceuBUnMUAeoAHHw,1,0,0,0,0,0,2,0,2,0.2857142857142857,2,0.0,0,0,0,0,0,0,0,2,0,0,2,1
5214,85315,6wxNqFTG10UU1QlHAjCeeHAXofHA0Wd6,A3fsA9Zfv1X2fVEQhTw51lKENdNrEqT3,2,0,0,0,0,0,2,0,2,0.2857142857142857,1,0.0,0,0,0,0,0,0,0,2,0,0,2,1
5215,85320,6W33zL2q4028wAczl90YoEq5VRoJonHk,bWdj2GDclj5ofokWjzoa5jAwMkxCykd6,2,0,0,0,0,0,2,0,2,0.2857142857142857,1,0.0,0,0,0,0,0,0,0,2,0,0,2,0
5216,85329,dkZKTQ89aNq1jLWsQ8GHGCzeOaVmaX8E,SpATywNh6bZuzm8s1ceuBUnMUAeoAHHw,1,0,0,0,0,0,1,0,1,0.14285714285714285,1,0.0,0,0,0,0,0,0,0,1,0,0,1,1
5217,85336,176ILS8J1NMmZsoc0RxEg8JQJcz6ksLo,A3fsA9Zfv1X2fVEQhTw51lKENdNrEqT3,1,0,0,0,0,0,1,0,1,0.14285714285714285,1,0.0,0,0,0,0,0,0,0,1,0,0,1,1
5218,85340,7iqCukuZ9oGbANuGlupslMrsiHUFtGa5,bWdj2GDclj5ofokWjzoa5jAwMkxCykd6,3,3,1,0,0,0,1,0,5,0.7142857142857143,1,0.0,0,1,0,0,3,0,0,1,0,1,4,1
5219,85347,qr1Y8xuPrcpdzScNHYsirGXqasfUdOVa,A3fsA9Zfv1X2fVEQhTw51lKENdNrEqT3,14,15,11,0,6,0,13,0,45,6.428571428571429,3,0.0,0,11,0,6,15,0,0,13,0,17,28,1
5220,85360,sT9hGAnww95aeGvqwQpJlS3ORhWDT49F,SpATywNh6bZuzm8s1ceuBUnMUAeoAHHw,19,30,15,14,2,0,8,0,69,9.857142857142858,2,0.0,8,15,13,2,22,0,1,8,0,38,31,0
5221,85362,h7k1wsPKqQnsb0xgegTBlN0S8ZpolGHh,SpATywNh6bZuzm8s1ceuBUnMUAeoAHHw,6,5,1,0,1,0,2,0,9,1.2857142857142858,1,0.0,0,1,0,1,5,0,0,2,0,2,7,1
5222,85381,MaYaRLQWCfitDjLO89g6UksqHgmMxPRV,SpATywNh6bZuzm8s1ceuBUnMUAeoAHHw,24,33,3,38,1,5,13,2,95,13.571428571428571,3,0.0,12,3,32,1,21,5,6,13,2,48,47,0
5223,86912,GfqCozSB56b335uZLl5d2syEloMgMtnE,SpATywNh6bZuzm8s1ceuBUnMUAeoAHHw,8,22,10,0,5,5,25,3,70,10.0,1,0.0,1,10,0,5,21,5,0,25,3,16,54,0
5224,86916,m9APg30xFaPG98uje3arCJfO5W7zr48c,SpATywNh6bZuzm8s1ceuBUnMUAeoAHHw,1,0,0,0,0,0,1,0,1,0.14285714285714285,1,0.0,0,0,0,0,0,0,0,1,0,0,1,1
5225,86938,rJCRtFYOHadlaWolNt4hiGuOfo8UHBBK,SpATywNh6bZuzm8s1ceuBUnMUAeoAHHw,13,30,9,12,3,7,4,0,65,9.285714285714286,3,0.0,16,9,12,3,14,7,0,4,0,40,25,0
5226,86974,HB5xN5WvO63fyle8L9OU8KEV5tvW4m0R,SpATywNh6bZuzm8s1ceuBUnMUAeoAHHw,10,3,2,0,2,1,6,3,17,2.4285714285714284,1,0.0,0,2,0,2,3,1,0,6,3,4,13,0
5227,87087,ycZcyaRZkRmTmfTyJcaxWvg5l6N3L4CN,SpATywNh6bZuzm8s1ceuBUnMUAeoAHHw,12,13,7,0,4,3,4,1,32,4.571428571428571,1,0.0,3,7,0,4,10,3,0,4,1,14,18,1
5228,87094,TPPsOieQBcwqH8dqABTR3mddQ5gDzlZO,A3fsA9Zfv1X2fVEQhTw51lKENdNrEqT3,22,26,20,0,18,0,3,0,67,9.571428571428571,1,0.0,3,20,0,18,23,0,0,3,0,41,26,1
5229,87109,xSRvBNCdhLUrfFyYzicxsnRRkZUYQ9tk,SpATywNh6bZuzm8s1ceuBUnMUAeoAHHw,11,10,1,0,0,0,9,1,21,3.0,2,0.0,2,1,0,0,8,0,0,9,1,3,18,1
5230,87120,Kpr6ISdqohTmchfzbxziZ98TNPreGKVa,SpATywNh6bZuzm8s1ceuBUnMUAeoAHHw,6,5,1,0,1,0,2,0,9,1.2857142857142858,1,0.0,2,1,0,1,3,0,0,2,0,4,5,1
5231,87147,PHBho9Sc0XQZt8wGEuns5tbDU5eoHa8g,A3fsA9Zfv1X2fVEQhTw51lKENdNrEqT3,24,45,25,0,16,0,16,0,102,14.571428571428571,3,0.0,4,25,0,16,41,0,0,16,0,45,57,0
5232,87169,BYoagvhtaQZvEdBOdm0fSGLXeMikTNAf,SpATywNh6bZuzm8s1ceuBUnMUAeoAHHw,8,5,0,0,0,0,3,0,8,1.1428571428571428,1,0.0,0,0,0,0,5,0,0,3,0,0,8,1
5233,87190,rs3WOUQ4PSHbNxyhVeLlE6lgdYqGPTef,SpATywNh6bZuzm8s1ceuBUnMUAeoAHHw,16,26,5,15,3,0,4,0,53,7.571428571428571,1,0.0,20,5,14,3,6,0,1,4,0,42,11,1
5234,87199,hO4ixki4cn72f2HXil7H5yfXyIpxdfFl,SpATywNh6bZuzm8s1ceuBUnMUAeoAHHw,14,20,1,18,1,0,7,0,47,6.714285714285714,2,0.0,9,1,15,1,11,0,3,7,0,26,21,0
5235,87447,QflUMQYqgKuyQPnCteHvz3LqhJ9AwCga,RXDvfPUBYFlVdlueBFbLW0mhhAyGEqpt,37,63,47,0,39,6,8,0,163,23.285714285714285,2,0.0,8,47,0,39,55,6,0,8,0,94,69,1
5236,87514,UUyRymVa7K1uXcxu9NV7wrw7koSoKJkA,A3fsA9Zfv1X2fVEQhTw51lKENdNrEqT3,8,1,0,0,1,0,8,1,11,1.5714285714285714,1,0.0,0,0,0,1,1,0,0,8,1,1,10,1
5237,87520,pqsPOTJhOrzp1CuSM0L3m4JXPVXPbkqe,SpATywNh6bZuzm8s1ceuBUnMUAeoAHHw,16,29,14,6,2,5,11,1,68,9.714285714285714,2,0.0,4,14,6,2,25,5,0,11,1,26,42,1
5238,87544,HF98YPKzT8oi2j9flZW9kstZcvL3ZimG,SpATywNh6bZuzm8s1ceuBUnMUAeoAHHw,20,26,10,12,5,0,7,0,60,8.571428571428571,3,0.0,5,10,9,5,21,0,3,7,0,29,31,0
5239,87563,mLnrkBxCMzHzCOgxlcePLHngsSsyrmY0,SpATywNh6bZuzm8s1ceuBUnMUAeoAHHw,22,44,0,24,0,2,14,1,85,12.142857142857142,3,0.0,15,0,21,0,29,2,3,14,1,36,49,0
5240,87607,Y1N757YBcw2pa0f5R2cGYXkdHdVAg7lL,RXDvfPUBYFlVdlueBFbLW0mhhAyGEqpt,22,29,16,0,9,0,1,0,55,7.857142857142857,1,0.0,0,16,0,9,29,0,0,1,0,25,30,1
5241,87645,or5tGmwIQtkxzns3Abayo6pKJnoHWcAG,A3fsA9Zfv1X2fVEQhTw51lKENdNrEqT3,8,2,2,0,2,0,3,0,9,1.2857142857142858,1,0.0,0,2,0,2,2,0,0,3,0,4,5,1
5242,87732,L1FTG9TM6RI5TBCTexQgshQhXhu2oZpJ,RXDvfPUBYFlVdlueBFbLW0mhhAyGEqpt,45,32,19,59,13,2,8,0,133,19.0,4,0.0,9,19,57,13,23,2,2,8,0,98,35,1
5243,87733,bwOsVB833e5tHrwHSqmXCzs0EZClNPpv,bWdj2GDclj5ofokWjzoa5jAwMkxCykd6,6,3,1,0,1,3,5,1,14,2.0,2,0.0,1,1,0,1,2,3,0,5,1,3,11,1
5244,87759,kbnbUyJ6SeYN8u39lgEBCBnZvcNekMlk,bWdj2GDclj5ofokWjzoa5jAwMkxCykd6,4,2,1,0,1,0,1,0,5,0.7142857142857143,1,0.0,0,1,0,1,2,0,0,1,0,2,3,1
5245,87864,nWedGV2Cyz7b86zoWjyUJZtraXV6YlYz,SpATywNh6bZuzm8s1ceuBUnMUAeoAHHw,12,12,0,7,0,1,5,0,25,3.5714285714285716,1,0.0,4,0,7,0,8,1,0,5,0,11,14,0
5246,87919,NtuSsCWxiM5cZ0UalS4e7aFbcsYH60Br,bWdj2GDclj5ofokWjzoa5jAwMkxCykd6,2,0,0,0,0,0,2,0,2,0.2857142857142857,1,0.0,0,0,0,0,0,0,0,2,0,0,2,0
5247,87920,1uj3lODORrX2PgjuF1fpWy9nhOirDGas,G8EPVSXsOYB5YQWZGiz1aVq5Pgr2GrQu,29,43,18,24,5,1,8,1,100,14.285714285714286,4,0.0,4,18,18,5,39,1,6,8,1,45,55,0
5248,87987,Ffohn9JNnGJQD2IavzMTS00ubnVtcb2T,SpATywNh6bZuzm8s1ceuBUnMUAeoAHHw,31,34,20,14,8,1,11,1,89,12.714285714285714,5,0.0,7,20,14,8,27,1,0,11,1,49,40,0
5249,88029,bSaZ1hYnI1zX06sBhHjW0JtYDEAqEuPp,SpATywNh6bZuzm8s1ceuBUnMUAeoAHHw,23,32,0,23,0,13,30,5,103,14.714285714285714,5,0.0,7,0,19,0,25,13,4,30,5,26,77,0
5250,88039,pAIEYSSXdgXA2O8eKo5gs0U3YOaGGkK5,SpATywNh6bZuzm8s1ceuBUnMUAeoAHHw,11,6,4,4,3,0,3,0,20,2.857142857142857,1,0.0,1,4,4,3,5,0,0,3,0,12,8,1
5251,88082,yiWok4eQ5hgdJ8eYi2O0qHhy67Y9EA3E,RXDvfPUBYFlVdlueBFbLW0mhhAyGEqpt,4,2,0,0,0,0,2,0,4,0.5714285714285714,1,0.0,0,0,0,0,2,0,0,2,0,0,4,1
5252,88086,ffLXxfgMU4yir9uI5fIkKo2iZzEw2Lpz,A3fsA9Zfv1X2fVEQhTw51lKENdNrEqT3,4,0,0,0,0,1,3,0,4,0.5714285714285714,1,0.0,0,0,0,0,0,1,0,3,0,0,4,1
5253,88095,dCAqk9uHiS99GMTcJQtThG8XWnwwbp5Q,bWdj2GDclj5ofokWjzoa5jAwMkxCykd6,1,0,0,0,0,0,1,0,1,0.14285714285714285,1,0.0,0,0,0,0,0,0,0,1,0,0,1,1
5254,88139,dclBqf1EWh3Ih224SoyQN0nAKWGjQR6I,SpATywNh6bZuzm8s1ceuBUnMUAeoAHHw,11,5,4,0,4,2,11,1,27,3.857142857142857,1,0.0,0,4,0,4,5,2,0,11,1,8,19,1
5255,88140,ci0TVQYsVR5jGo6uk57VSejmvHQzKbHq,SpATywNh6bZuzm8s1ceuBUnMUAeoAHHw,15,23,6,16,3,1,6,0,55,7.857142857142857,1,0.0,16,6,13,3,7,1,3,6,0,38,17,1
5256,88290,zagfJzNHtSvWCFgkMj9NSIbmff9j4Jzi,7GRhBDsirIGkRZBtSMEzNTyDr2JQm4xx,5,2,1,0,1,1,4,0,9,1.2857142857142858,1,0.0,0,1,0,1,2,1,0,4,0,2,7,1
5257,88395,qInCpaeuecWrGMAIOnQb1wZeYTgOfrqB,7GRhBDsirIGkRZBtSMEzNTyDr2JQm4xx,1,0,0,0,0,0,1,0,1,0.14285714285714285,1,0.0,0,0,0,0,0,0,0,1,0,0,1,1
5258,88419,Nnydl7u2ge7nezXYbZ5DWwoPbVU96qN7,7GRhBDsirIGkRZBtSMEzNTyDr2JQm4xx,25,25,12,25,7,2,4,0,75,10.714285714285714,1,0.0,8,12,19,7,17,2,6,4,0,46,29,1
5259,88520,klfSXDgeuLd0URCaUqSBWiGxyD6lj0zh,7GRhBDsirIGkRZBtSMEzNTyDr2JQm4xx,31,53,12,38,14,18,7,0,142,20.285714285714285,1,0.0,34,12,33,14,19,18,5,7,0,93,49,1
5260,88535,RMHhN3yqeqMVtL0le3LPxRjp5aMu0uOX,7GRhBDsirIGkRZBtSMEzNTyDr2JQm4xx,7,3,2,0,2,0,2,0,9,1.2857142857142858,1,0.0,0,2,0,2,3,0,0,2,0,4,5,1
5261,88543,dorUpp1ODfe9BqxoBX8EUNGD90FW70kn,7GRhBDsirIGkRZBtSMEzNTyDr2JQm4xx,37,61,20,58,15,0,2,0,156,22.285714285714285,1,0.0,30,20,52,15,31,0,6,2,0,117,39,0
5262,88559,dpAgQLtjPDPymVmdyZFVsWQut5sougN0,7GRhBDsirIGkRZBtSMEzNTyDr2JQm4xx,11,3,2,0,2,4,6,1,18,2.5714285714285716,1,0.0,0,2,0,2,3,4,0,6,1,4,14,1
5263,88609,NRGKxfD21idsk82Fv2MwrybcNTOKr52A,7GRhBDsirIGkRZBtSMEzNTyDr2JQm4xx,1,0,0,0,0,0,1,0,1,0.14285714285714285,1,0.0,0,0,0,0,0,0,0,1,0,0,1,1
5264,88671,uUGE7QSg22XWq63RpYifnvGl7ha2AJY9,7GRhBDsirIGkRZBtSMEzNTyDr2JQm4xx,1,0,0,0,0,0,1,0,1,0.14285714285714285,1,0.0,0,0,0,0,0,0,0,1,0,0,1,1
5265,88682,IPGiOAgTo8oAVcrOKeYCONet5W5qWWCW,7GRhBDsirIGkRZBtSMEzNTyDr2JQm4xx,2,0,0,0,0,0,2,0,2,0.2857142857142857,1,0.0,0,0,0,0,0,0,0,2,0,0,2,1
5266,88683,YPNKBmbK0WLMDD2GyDPdurqVlRMJYUzc,7GRhBDsirIGkRZBtSMEzNTyDr2JQm4xx,3,0,0,0,0,0,3,0,3,0.42857142857142855,1,0.0,0,0,0,0,0,0,0,3,0,0,3,1
5267,88691,OanZ4liHLS9Z9zOLSdbk7KQJbN4gOKSZ,7GRhBDsirIGkRZBtSMEzNTyDr2JQm4xx,1,0,0,0,0,0,1,0,1,0.14285714285714285,1,0.0,0,0,0,0,0,0,0,1,0,0,1,1
5268,88775,zNnqmF2sQm5pVrk4EjykARlvIbp0hTq0,fbPkOYLVPtPgIt0MxizjfFJov3JbHyAi,1,0,0,0,0,0,1,0,1,0.14285714285714285,1,0.0,0,0,0,0,0,0,0,1,0,0,1,1
5269,88777,Uf1qigQqXVxNALjpI0OUPGkslBlud9Ut,fbPkOYLVPtPgIt0MxizjfFJov3JbHyAi,6,3,2,0,2,0,1,0,8,1.1428571428571428,1,0.0,0,2,0,2,3,0,0,1,0,4,4,1
5270,88778,gfCaKEduRhBAyI1gNYKiZ3eGKbbM2Zzn,fbPkOYLVPtPgIt0MxizjfFJov3JbHyAi,2,0,0,0,0,0,2,0,2,0.2857142857142857,1,0.0,0,0,0,0,0,0,0,2,0,0,2,1
5271,88780,nxtpPsNzngYTsI1SZcZNPzXTwqY5qTmx,fbPkOYLVPtPgIt0MxizjfFJov3JbHyAi,5,2,1,0,1,0,2,0,6,0.8571428571428571,1,0.0,0,1,0,1,2,0,0,2,0,2,4,1
5272,88782,0Fj1MjrLeWw10VEjEhUtTscYzoHMiAaR,fbPkOYLVPtPgIt0MxizjfFJov3JbHyAi,2,0,0,0,0,0,6,0,6,0.8571428571428571,1,0.0,0,0,0,0,0,0,0,6,0,0,6,1
5273,88783,0osfGmMGm8jt9kb8kP5HcmQdyiR2KFbt,fbPkOYLVPtPgIt0MxizjfFJov3JbHyAi,9,5,3,0,2,6,4,1,21,3.0,1,0.0,0,3,0,2,5,6,0,4,1,5,16,1
5274,88784,la0M1c91h799fPQIw73JrRQfyaSu3lyA,fbPkOYLVPtPgIt0MxizjfFJov3JbHyAi,1,0,0,0,0,0,1,0,1,0.14285714285714285,1,0.0,0,0,0,0,0,0,0,1,0,0,1,1
5275,88785,76WTB850XyfRMUDEt6Hi4EqgOfT9IEtK,fbPkOYLVPtPgIt0MxizjfFJov3JbHyAi,9,12,1,0,1,1,5,1,21,3.0,1,0.0,1,1,0,1,11,1,0,5,1,3,18,1
5276,88787,9k2E0gibBkBETtLxegOSAXJ2stT7JIe8,fbPkOYLVPtPgIt0MxizjfFJov3JbHyAi,8,5,1,0,2,0,11,2,21,3.0,1,0.0,2,1,0,2,3,0,0,11,2,5,16,1
5277,88788,qT122hnKUhEIpv6ZsCDLoOTP7nHJSaNq,fbPkOYLVPtPgIt0MxizjfFJov3JbHyAi,7,4,2,0,2,0,7,0,15,2.142857142857143,1,0.0,1,2,0,2,3,0,0,7,0,5,10,1
5278,88789,fQyY3sWQeXkKYt8B4zLpW9naNVJ351r5,fbPkOYLVPtPgIt0MxizjfFJov3JbHyAi,11,7,3,0,4,0,8,2,24,3.4285714285714284,1,0.0,3,3,0,4,4,0,0,8,2,10,14,1
5279,88790,nZBEO25QEEdKJsNDjWc27BQlFlOJqVIP,fbPkOYLVPtPgIt0MxizjfFJov3JbHyAi,7,5,3,0,2,1,2,0,13,1.8571428571428572,1,0.0,0,3,0,2,5,1,0,2,0,5,8,1
5280,88791,iZvZwMImGAt7q4aUPPRIOXEQbHAYw3j9,fbPkOYLVPtPgIt0MxizjfFJov3JbHyAi,24,28,14,20,15,2,9,1,89,12.714285714285714,1,0.0,9,14,15,15,19,2,5,9,1,53,36,1
5281,88793,iUbyHXj7nnwsn3idID6iMxIxqlgprHQJ,fbPkOYLVPtPgIt0MxizjfFJov3JbHyAi,2,0,0,0,0,0,4,0,4,0.5714285714285714,1,0.0,0,0,0,0,0,0,0,4,0,0,4,1
5282,88797,SJbFjfL77hmrpjM2fDE61GEOGezGEGS2,fbPkOYLVPtPgIt0MxizjfFJov3JbHyAi,1,0,0,0,0,0,1,0,1,0.14285714285714285,1,0.0,0,0,0,0,0,0,0,1,0,0,1,1
5283,88799,sCKziRJTsOYc4lQfYxPq4wO4jIyYAbxE,fbPkOYLVPtPgIt0MxizjfFJov3JbHyAi,2,0,0,0,0,0,2,0,2,0.2857142857142857,1,0.0,0,0,0,0,0,0,0,2,0,0,2,1
5284,88800,NBVERkC2Sbv324jT0djpWcPmYUJcR4Oa,fbPkOYLVPtPgIt0MxizjfFJov3JbHyAi,3,2,0,0,0,0,1,0,3,0.42857142857142855,1,0.0,0,0,0,0,2,0,0,1,0,0,3,1
5285,88802,1qt3gH5lpss0VnR5LgXp1AGPTrEn5n0R,fbPkOYLVPtPgIt0MxizjfFJov3JbHyAi,2,0,0,0,0,0,2,0,2,0.2857142857142857,1,0.0,0,0,0,0,0,0,0,2,0,0,2,1
5286,88803,2zFsyHLRIVr61iaQkzpRvzQtauWJlCfW,fbPkOYLVPtPgIt0MxizjfFJov3JbHyAi,1,0,0,0,0,0,2,0,2,0.2857142857142857,1,0.0,0,0,0,0,0,0,0,2,0,0,2,1
5287,88804,u4s0SPiIkynucY7ReF58TL89R2q4zw1x,fbPkOYLVPtPgIt0MxizjfFJov3JbHyAi,4,2,1,0,1,0,1,0,5,0.7142857142857143,1,0.0,0,1,0,1,2,0,0,1,0,2,3,0
5288,88805,8YR0tcT3D8d0JlIytw4LxKfYYQekJyvj,fbPkOYLVPtPgIt0MxizjfFJov3JbHyAi,5,3,1,0,1,0,1,0,6,0.8571428571428571,1,0.0,0,1,0,1,3,0,0,1,0,2,4,1
5289,88806,emj3hNG2XZHsTTaF5Lr1CYx27lHx0rEZ,fbPkOYLVPtPgIt0MxizjfFJov3JbHyAi,8,9,4,0,4,0,1,0,18,2.5714285714285716,1,0.0,0,4,0,4,9,0,0,1,0,8,10,1
5290,88808,qvojdac7xUuog4FKjywIiWLo2CLniAnu,fbPkOYLVPtPgIt0MxizjfFJov3JbHyAi,9,5,3,0,3,0,2,0,13,1.8571428571428572,1,0.0,0,3,0,3,5,0,0,2,0,6,7,1
5291,88809,r7HcMNOT5LLOYH8hCtxY2qjQMqPnDz4Z,fbPkOYLVPtPgIt0MxizjfFJov3JbHyAi,11,13,7,2,5,4,4,0,35,5.0,1,0.0,1,7,2,5,12,4,0,4,0,15,20,1
5292,88810,Im5unyUxIwWC6gQuuhs0nm7hNG0B0uwk,fbPkOYLVPtPgIt0MxizjfFJov3JbHyAi,7,3,2,0,2,1,7,0,15,2.142857142857143,1,0.0,0,2,0,2,3,1,0,7,0,4,11,1
5293,88811,75sdjcSshG9zd9yqWMZjrix1dGre1kOU,fbPkOYLVPtPgIt0MxizjfFJov3JbHyAi,5,2,1,0,1,0,2,0,6,0.8571428571428571,1,0.0,0,1,0,1,2,0,0,2,0,2,4,1
5294,88813,KC3eAbHLPns12iVsS4LuLv4X7AErDIWY,fbPkOYLVPtPgIt0MxizjfFJov3JbHyAi,1,0,0,0,0,0,2,0,2,0.2857142857142857,1,0.0,0,0,0,0,0,0,0,2,0,0,2,1
5295,88814,qmemIVC5Iuvmt3EwAEmeheRArNgSE4sO,fbPkOYLVPtPgIt0MxizjfFJov3JbHyAi,1,0,0,0,0,0,1,0,1,0.14285714285714285,1,0.0,0,0,0,0,0,0,0,1,0,0,1,1
5296,88815,Ryj9SYlTY2129nyufOPixA9oPGYhqvjh,fbPkOYLVPtPgIt0MxizjfFJov3JbHyAi,4,3,1,0,1,0,3,0,8,1.1428571428571428,2,0.0,0,1,0,1,3,0,0,3,0,2,6,1
5297,88818,89WrqZK2Q73BIEUqNtaalkZbdJCLDFwZ,fbPkOYLVPtPgIt0MxizjfFJov3JbHyAi,8,4,2,0,1,3,6,1,17,2.4285714285714284,2,0.0,0,2,0,1,4,3,0,6,1,3,14,1
5298,88820,FwTErVkZ5KG64sGBwGPbKk9gM0cwQPh1,fbPkOYLVPtPgIt0MxizjfFJov3JbHyAi,10,7,5,0,4,8,6,1,31,4.428571428571429,1,0.0,0,5,0,4,7,8,0,6,1,9,22,1
5299,88821,p4bpHXDCH4ga8oV8ZqbH95nJI7VYCp8t,fbPkOYLVPtPgIt0MxizjfFJov3JbHyAi,1,0,0,0,0,0,1,0,1,0.14285714285714285,1,0.0,0,0,0,0,0,0,0,1,0,0,1,1
5300,88822,4hbcS1XH6kSybbsyz7K3CYFhB00MIUIr,fbPkOYLVPtPgIt0MxizjfFJov3JbHyAi,6,6,2,0,3,0,1,0,12,1.7142857142857142,1,0.0,3,2,0,3,3,0,0,1,0,8,4,1
5301,88823,AyhJARh0xhxObM9zhvUdDxlTCtu309eW,fbPkOYLVPtPgIt0MxizjfFJov3JbHyAi,8,7,4,0,3,27,5,0,46,6.571428571428571,3,0.0,0,4,0,3,7,27,0,5,0,7,39,1
5302,88824,mc7ReRohr0aHl54443zTpOlq1o12BqN6,fbPkOYLVPtPgIt0MxizjfFJov3JbHyAi,1,0,0,0,0,0,1,0,1,0.14285714285714285,1,0.0,0,0,0,0,0,0,0,1,0,0,1,1
5303,88825,SO7BGTzNf50pHLqWJC7Isbkuvs1iCvSw,fbPkOYLVPtPgIt0MxizjfFJov3JbHyAi,11,8,5,0,3,7,3,1,27,3.857142857142857,1,0.0,1,5,0,3,7,7,0,3,1,9,18,1
5304,88826,FHVGisAeAJdUWbqdfGOX1SqwMTNsn4Sl,fbPkOYLVPtPgIt0MxizjfFJov3JbHyAi,6,1,1,0,1,0,3,0,6,0.8571428571428571,1,0.0,0,1,0,1,1,0,0,3,0,2,4,1
5305,88828,D4QcA7podzZXBTfof4ESNtLtgPKFTty3,fbPkOYLVPtPgIt0MxizjfFJov3JbHyAi,7,2,1,0,1,8,6,1,19,2.7142857142857144,1,0.0,0,1,0,1,2,8,0,6,1,2,17,1
5306,88832,xLVZrHAd2rcd4gjL2AH8LHStjVOxoTXH,fbPkOYLVPtPgIt0MxizjfFJov3JbHyAi,6,3,2,0,2,0,1,0,8,1.1428571428571428,1,0.0,0,2,0,2,3,0,0,1,0,4,4,1
5307,88833,eOxm8XEI11Xs6eiBi1Nu5QzIagZXwEm9,fbPkOYLVPtPgIt0MxizjfFJov3JbHyAi,7,4,2,0,2,8,3,0,19,2.7142857142857144,2,0.0,1,2,0,2,3,8,0,3,0,5,14,1
5308,88834,UPCBTwptJrhgu4vesm7VG1r09OOWFZ8M,fbPkOYLVPtPgIt0MxizjfFJov3JbHyAi,2,0,0,0,0,0,3,0,3,0.42857142857142855,1,0.0,0,0,0,0,0,0,0,3,0,0,3,1
5309,88835,sR0gVqP9THtsGU0nXYxvlPsXuHuYggxR,fbPkOYLVPtPgIt0MxizjfFJov3JbHyAi,8,6,2,2,2,0,4,0,16,2.2857142857142856,1,0.0,2,2,2,2,4,0,0,4,0,8,8,1
5310,88837,QkdU1z3YFvdeUK9lKehYyofsDutrm196,fbPkOYLVPtPgIt0MxizjfFJov3JbHyAi,6,4,2,0,2,0,1,0,9,1.2857142857142858,1,0.0,0,2,0,2,4,0,0,1,0,4,5,1
5311,88838,gVqypDd1b5rP0VnVbrsZj4FDK81Xew1Y,fbPkOYLVPtPgIt0MxizjfFJov3JbHyAi,4,2,1,0,1,0,1,0,5,0.7142857142857143,1,0.0,0,1,0,1,2,0,0,1,0,2,3,1
5312,88839,iKVtXLZY6XC1Ozhvwt3XfCzLYHoRf4Le,fbPkOYLVPtPgIt0MxizjfFJov3JbHyAi,5,1,1,0,1,0,2,0,5,0.7142857142857143,1,0.0,0,1,0,1,1,0,0,2,0,2,3,1
5313,88840,Sbvsuo19O2SfThVQR8m11L1fIHdeUt20,fbPkOYLVPtPgIt0MxizjfFJov3JbHyAi,9,8,4,0,2,2,8,1,25,3.5714285714285716,2,0.0,0,4,0,2,8,2,0,8,1,6,19,1
5314,88841,sXHmxCYzWKnOBp4g0oDOkoNrOpYDpt1m,fbPkOYLVPtPgIt0MxizjfFJov3JbHyAi,1,0,0,0,0,0,1,0,1,0.14285714285714285,1,0.0,0,0,0,0,0,0,0,1,0,0,1,1
5315,88843,YkG4vF4KhqibrD50khtgskxo6iKIJC5w,fbPkOYLVPtPgIt0MxizjfFJov3JbHyAi,6,3,2,0,2,0,1,0,8,1.1428571428571428,1,0.0,0,2,0,2,3,0,0,1,0,4,4,1
5316,88846,AqzJls3OFl2nFap48g5Tia0Yo0Y7Cer3,fbPkOYLVPtPgIt0MxizjfFJov3JbHyAi,9,11,4,0,3,1,5,1,25,3.5714285714285716,1,0.0,0,4,0,3,11,1,0,5,1,7,18,1
5317,88847,6mNKW4qOUXPShTxM8cvfepjQFTLv3oOh,fbPkOYLVPtPgIt0MxizjfFJov3JbHyAi,20,20,16,0,16,18,15,1,86,12.285714285714286,1,0.0,2,16,0,16,18,18,0,15,1,34,52,1
5318,88850,d9MkkuCn04Toz7g1JpLdUJWD9xM5braA,fbPkOYLVPtPgIt0MxizjfFJov3JbHyAi,4,3,1,0,1,0,2,0,7,1.0,1,0.0,0,1,0,1,3,0,0,2,0,2,5,1
5319,88851,Gl03eSeNtb7juYcfyy4T6xQkEEhQalIx,fbPkOYLVPtPgIt0MxizjfFJov3JbHyAi,5,5,3,0,2,0,1,0,11,1.5714285714285714,1,0.0,0,3,0,2,5,0,0,1,0,5,6,0
5320,88852,SW8hZER4lRVJxocMEgvR4kXl1NsQnFzy,fbPkOYLVPtPgIt0MxizjfFJov3JbHyAi,6,3,2,0,2,0,1,0,8,1.1428571428571428,1,0.0,0,2,0,2,3,0,0,1,0,4,4,1
5321,88853,zvDqimtTzQDntzI9wqOWSebcIJKnGJ4a,fbPkOYLVPtPgIt0MxizjfFJov3JbHyAi,12,26,3,11,1,16,15,1,73,10.428571428571429,5,0.0,7,3,7,1,19,16,4,15,1,18,55,1
5322,88855,XQ3dYwdsUwJ24fnMOalUTaMPlpgBFmZW,fbPkOYLVPtPgIt0MxizjfFJov3JbHyAi,3,0,0,0,0,1,2,0,3,0.42857142857142855,1,0.0,0,0,0,0,0,1,0,2,0,0,3,1
5323,88856,hluzPB1y7zkKLSSzVkJvXfWNLyDAuRho,fbPkOYLVPtPgIt0MxizjfFJov3JbHyAi,9,11,8,0,6,0,3,0,28,4.0,2,0.0,0,8,0,6,11,0,0,3,0,14,14,1
5324,88858,sfQpIAyh1Bl1FfOPcdLy9YBFhdo6RQbA,fbPkOYLVPtPgIt0MxizjfFJov3JbHyAi,2,0,0,0,0,0,4,0,4,0.5714285714285714,1,0.0,0,0,0,0,0,0,0,4,0,0,4,1
5325,88859,JF7rR3pF5cT0hx4XGqF6ShAdIIlqNFHc,fbPkOYLVPtPgIt0MxizjfFJov3JbHyAi,7,3,2,0,2,0,2,0,9,1.2857142857142858,1,0.0,0,2,0,2,3,0,0,2,0,4,5,1
5326,88860,V8o57SeARenbMywXqROBGV5CkdHJLIRM,fbPkOYLVPtPgIt0MxizjfFJov3JbHyAi,3,0,0,0,0,8,4,0,12,1.7142857142857142,1,0.0,0,0,0,0,0,8,0,4,0,0,12,1
5327,89156,vbW1KaPU4HdAU3ExlW7t2Z2lZknONBDo,SpATywNh6bZuzm8s1ceuBUnMUAeoAHHw,1,0,0,0,0,0,1,0,1,0.14285714285714285,1,0.0,0,0,0,0,0,0,0,1,0,0,1,1
5328,89158,4izQXcJwvwmvhdH2eayMFjLqLTND3JLq,SpATywNh6bZuzm8s1ceuBUnMUAeoAHHw,1,0,0,0,0,0,1,0,1,0.14285714285714285,1,0.0,0,0,0,0,0,0,0,1,0,0,1,1
5329,89160,ujTZ8itG5tOi9RBi81LVjGylcfmfscnv,SpATywNh6bZuzm8s1ceuBUnMUAeoAHHw,1,0,0,0,0,0,4,0,4,0.5714285714285714,1,0.0,0,0,0,0,0,0,0,4,0,0,4,1
5330,89176,xe8A48TmWAWrsrOrkKLLF9EL4o5xag4y,SpATywNh6bZuzm8s1ceuBUnMUAeoAHHw,1,0,0,0,0,0,1,0,1,0.14285714285714285,1,0.0,0,0,0,0,0,0,0,1,0,0,1,1
5331,89177,JfoqUtmque7wAjeDp4JXdK1NxfjlSlfN,SpATywNh6bZuzm8s1ceuBUnMUAeoAHHw,1,0,0,0,0,0,1,0,1,0.14285714285714285,1,0.0,0,0,0,0,0,0,0,1,0,0,1,1
5332,89178,mmrzdjNmPvFK53WAh9BwB5yGYUT5HqSe,G8EPVSXsOYB5YQWZGiz1aVq5Pgr2GrQu,1,0,0,0,0,0,1,0,1,0.14285714285714285,1,0.0,0,0,0,0,0,0,0,1,0,0,1,1
5333,89179,byKEl7rjAYN1zOFtYklTCb9GFeYuN4nO,SpATywNh6bZuzm8s1ceuBUnMUAeoAHHw,1,0,0,0,0,0,1,0,1,0.14285714285714285,1,0.0,0,0,0,0,0,0,0,1,0,0,1,1
5334,89180,GWkPEXh9DjC0IZThysIgNjSmYaI9dcS2,G8EPVSXsOYB5YQWZGiz1aVq5Pgr2GrQu,9,2,1,0,1,1,7,1,13,1.8571428571428572,2,0.0,0,1,0,1,2,1,0,7,1,2,11,1
5335,89187,rfOApTbQ4xF2665bHZIBhoJqQcTU6i9L,bWdj2GDclj5ofokWjzoa5jAwMkxCykd6,7,3,2,0,2,0,4,0,11,1.5714285714285714,1,0.0,0,2,0,2,3,0,0,4,0,4,7,1
5336,89189,bJL1sGEdg6Wyh9EeL6PIHUn7Crptl1QG,SpATywNh6bZuzm8s1ceuBUnMUAeoAHHw,2,0,0,0,0,0,2,0,2,0.2857142857142857,1,0.0,0,0,0,0,0,0,0,2,0,0,2,1
5337,89195,htC7O6KmzjLEAd92jccVhN4tDLN92YII,SpATywNh6bZuzm8s1ceuBUnMUAeoAHHw,5,5,0,0,0,0,3,0,8,1.1428571428571428,2,0.0,0,0,0,0,5,0,0,3,0,0,8,1
5338,89205,iHJGDLnoobtpsuLsojTJ7EMK5S6IfRa5,bWdj2GDclj5ofokWjzoa5jAwMkxCykd6,10,7,1,12,2,1,4,0,27,3.857142857142857,1,0.0,1,1,12,2,6,1,0,4,0,16,11,1
5339,89207,Wfpsd6cFXMtD0KyRvLKtWb4mn0MDgPtD,SpATywNh6bZuzm8s1ceuBUnMUAeoAHHw,6,2,0,0,0,2,21,6,31,4.428571428571429,1,0.0,0,0,0,0,2,2,0,21,6,0,31,1
5340,89211,W4anGZ3gUxihb7qbTalaixckN7io0pRJ,RXDvfPUBYFlVdlueBFbLW0mhhAyGEqpt,1,0,0,0,0,0,1,0,1,0.14285714285714285,1,0.0,0,0,0,0,0,0,0,1,0,0,1,1
5341,89213,7ORBOKUOYBR6pt3N4fl6iHTd7mMd3dtL,G8EPVSXsOYB5YQWZGiz1aVq5Pgr2GrQu,5,9,2,0,2,0,2,0,15,2.142857142857143,2,0.0,6,2,0,2,3,0,0,2,0,10,5,1
5342,89216,moK1GdnqoYxhSRCf5a95lgXdVNdzYrjs,bWdj2GDclj5ofokWjzoa5jAwMkxCykd6,6,5,0,0,0,0,9,0,14,2.0,1,0.0,0,0,0,0,5,0,0,9,0,0,14,1
5343,89217,PA2zIjexrl5X42bUhfLaCsans4YmH5zQ,SpATywNh6bZuzm8s1ceuBUnMUAeoAHHw,12,15,5,0,3,2,11,2,38,5.428571428571429,2,0.0,0,5,0,3,15,2,0,11,2,8,30,1
5344,89219,Mqke4gGiYdtmQuFOtXx8ilrWhvfHEVOG,SpATywNh6bZuzm8s1ceuBUnMUAeoAHHw,3,0,0,0,0,1,3,0,4,0.5714285714285714,1,0.0,0,0,0,0,0,1,0,3,0,0,4,1
5345,89222,JmoVlWZppOh9wSlYvcOL4ciU00D3apDg,SpATywNh6bZuzm8s1ceuBUnMUAeoAHHw,3,2,0,0,0,0,4,0,6,0.8571428571428571,1,0.0,0,0,0,0,2,0,0,4,0,0,6,1
5346,89235,d4cb9OZbLbDBqzuhcJemwCaulhBw3XcA,bWdj2GDclj5ofokWjzoa5jAwMkxCykd6,18,19,7,44,7,4,7,0,88,12.571428571428571,1,0.0,10,7,37,7,9,4,7,7,0,61,27,1
5347,89242,hjUSUM6roI2mLGkMAqBjE0uxFRBSMYHJ,bWdj2GDclj5ofokWjzoa5jAwMkxCykd6,6,3,2,0,2,0,1,0,8,1.1428571428571428,1,0.0,0,2,0,2,3,0,0,1,0,4,4,1
5348,89249,YjL44X3XqXhDvKRGkgBLHiV9slzcQZGJ,SpATywNh6bZuzm8s1ceuBUnMUAeoAHHw,3,1,0,0,0,0,2,0,3,0.42857142857142855,1,0.0,0,0,0,0,1,0,0,2,0,0,3,1
5349,89252,gleoXCfE3tA6f5uM3pUTeqQbfFckrfVd,bWdj2GDclj5ofokWjzoa5jAwMkxCykd6,1,0,0,0,0,0,1,0,1,0.14285714285714285,1,0.0,0,0,0,0,0,0,0,1,0,0,1,1
5350,89262,qxQtZuyIzQWGcD008dVh3c4jYjIPrn2L,SpATywNh6bZuzm8s1ceuBUnMUAeoAHHw,3,1,0,0,0,0,2,0,3,0.42857142857142855,1,0.0,0,0,0,0,1,0,0,2,0,0,3,1
5351,89265,Hh6CQ9eQF89j5a5Oi2NUf2uAs2DZd4QT,SpATywNh6bZuzm8s1ceuBUnMUAeoAHHw,11,7,4,0,3,0,6,1,21,3.0,1,0.0,0,4,0,3,7,0,0,6,1,7,14,1
5352,89274,gAYHJa3M8crEnYGtoK5ulJH4EjKveQ23,SpATywNh6bZuzm8s1ceuBUnMUAeoAHHw,6,2,0,0,0,0,5,1,8,1.1428571428571428,1,0.0,0,0,0,0,2,0,0,5,1,0,8,1
5353,89275,PEDczBqLWdyMeFUgqqnQ5UtJeB7qq12O,SpATywNh6bZuzm8s1ceuBUnMUAeoAHHw,5,7,4,0,3,0,3,0,17,2.4285714285714284,1,0.0,0,4,0,3,7,0,0,3,0,7,10,1
5354,89286,pMaElq6QfFkzEK9UpuWlI5Z36ojw0yzC,bWdj2GDclj5ofokWjzoa5jAwMkxCykd6,1,0,0,0,0,0,1,0,1,0.14285714285714285,1,0.0,0,0,0,0,0,0,0,1,0,0,1,1
5355,89289,2Rw9LEKgxnu10TYMueqqEJs507ou3OOr,SpATywNh6bZuzm8s1ceuBUnMUAeoAHHw,5,2,0,0,0,2,5,1,10,1.4285714285714286,1,0.0,0,0,0,0,2,2,0,5,1,0,10,1
5356,89297,JYyHN8axXgpHcSLeMA1wyxGi6GgnqXzc,bWdj2GDclj5ofokWjzoa5jAwMkxCykd6,7,2,1,0,0,3,7,2,15,2.142857142857143,1,0.0,0,1,0,0,2,3,0,7,2,1,14,1
5357,89300,ZKwoFbqxmjGUhMeAwrPlEcEnBfnKdvyQ,SpATywNh6bZuzm8s1ceuBUnMUAeoAHHw,3,2,0,0,0,2,2,0,6,0.8571428571428571,1,0.0,0,0,0,0,2,2,0,2,0,0,6,1
5358,89301,Uk2Y8qj9Cf6T7k2O1cxM5Fue4zKTF1K8,SpATywNh6bZuzm8s1ceuBUnMUAeoAHHw,10,16,6,0,3,3,5,1,34,4.857142857142857,2,0.0,1,6,0,3,15,3,0,5,1,10,24,1
5359,89310,bwyEPRDnWmgwxNZP823jR0R0w9PchQI0,bWdj2GDclj5ofokWjzoa5jAwMkxCykd6,11,12,1,16,3,2,5,1,40,5.714285714285714,1,0.0,7,1,16,3,5,2,0,5,1,27,13,1
5360,89315,z8zMi50azvRwAPUNW2f5Gt0F6WOr8PI9,bWdj2GDclj5ofokWjzoa5jAwMkxCykd6,15,9,3,52,2,1,3,1,71,10.142857142857142,1,0.0,5,3,49,2,4,1,3,3,1,59,12,1
5361,89316,VF14jDCwIzSb92Zq60K5zB8BaUbLT4fN,bWdj2GDclj5ofokWjzoa5jAwMkxCykd6,16,31,3,40,4,9,8,1,96,13.714285714285714,3,0.0,7,3,39,4,24,9,1,8,1,53,43,1
5362,89320,EUrAZ23hcKSgGkr8BcxsusY5VGcq8UzJ,G8EPVSXsOYB5YQWZGiz1aVq5Pgr2GrQu,26,35,0,24,3,11,9,0,82,11.714285714285714,1,0.0,17,0,13,3,18,11,11,9,0,33,49,1
5363,89321,hwob5cfANjyVXpPbIwjR9A4IpD8atc3c,SpATywNh6bZuzm8s1ceuBUnMUAeoAHHw,10,8,7,0,5,0,2,0,22,3.142857142857143,1,0.0,0,7,0,5,8,0,0,2,0,12,10,1
5364,89323,JNtIRj6hnKiaMOhcBlcWRjLc0QwYKSxo,SpATywNh6bZuzm8s1ceuBUnMUAeoAHHw,12,9,2,14,1,0,4,0,30,4.285714285714286,1,0.0,2,2,11,1,7,0,3,4,0,16,14,1
5365,89325,8nDAopmFCIj7DcwdoC4rkmpeCk1s8Zgz,SpATywNh6bZuzm8s1ceuBUnMUAeoAHHw,9,8,4,0,3,1,5,1,22,3.142857142857143,2,0.0,1,4,0,3,7,1,0,5,1,8,14,1
5366,89330,HhEzipYCSzqDHvfYzAIj6GLpNqmUDFFt,SpATywNh6bZuzm8s1ceuBUnMUAeoAHHw,1,0,0,0,0,0,11,0,11,1.5714285714285714,1,0.0,0,0,0,0,0,0,0,11,0,0,11,1
5367,89345,g6IxzfRtoY3ZngcwPaZoK8tEiW61b5Gm,SpATywNh6bZuzm8s1ceuBUnMUAeoAHHw,7,2,1,0,1,0,4,2,10,1.4285714285714286,1,0.0,0,1,0,1,2,0,0,4,2,2,8,1
5368,89347,nRVtG0QK38ehOZE61TsAumXFUUbgiwAK,SpATywNh6bZuzm8s1ceuBUnMUAeoAHHw,5,3,0,0,0,0,3,0,6,0.8571428571428571,1,0.0,0,0,0,0,3,0,0,3,0,0,6,1
5369,89353,RMJqhWaieV03GDbDCUCDtD33fHLxVV5K,SpATywNh6bZuzm8s1ceuBUnMUAeoAHHw,14,12,6,10,3,1,3,1,36,5.142857142857143,1,0.0,5,6,9,3,7,1,1,3,1,23,13,1
5370,89354,PmjzDmD1PFYqpmVaelKXEbwbYfZH0pBp,SpATywNh6bZuzm8s1ceuBUnMUAeoAHHw,5,7,4,0,3,0,1,0,15,2.142857142857143,1,0.0,2,4,0,3,5,0,0,1,0,9,6,1
5371,89356,NpZps0g6tawFjKVlcYqueUROYKEoKNaJ,SpATywNh6bZuzm8s1ceuBUnMUAeoAHHw,4,3,1,0,1,0,1,0,6,0.8571428571428571,1,0.0,0,1,0,1,3,0,0,1,0,2,4,1
5372,89360,ZufvgvpRY93M4np3YlRkSzwkfWq82En4,SpATywNh6bZuzm8s1ceuBUnMUAeoAHHw,6,6,2,0,2,1,4,0,15,2.142857142857143,1,0.0,0,2,0,2,6,1,0,4,0,4,11,1
5373,89363,7oeUnzeChzbfg8iPaEKhVywsWn9pqTw6,SpATywNh6bZuzm8s1ceuBUnMUAeoAHHw,5,2,1,0,1,1,2,0,7,1.0,1,0.0,0,1,0,1,2,1,0,2,0,2,5,1
5374,89364,lXYwudRP8Zl9Z938FMhDttVYfWWJ9atj,RXDvfPUBYFlVdlueBFbLW0mhhAyGEqpt,12,13,6,0,3,3,7,0,32,4.571428571428571,2,0.0,3,6,0,3,10,3,0,7,0,12,20,1
5375,89365,LslskpvRu2kdJKdLBrkhLUwON3Gy18Vo,SpATywNh6bZuzm8s1ceuBUnMUAeoAHHw,7,4,3,0,3,0,4,0,14,2.0,2,0.0,0,3,0,3,4,0,0,4,0,6,8,1
5376,89368,Hut1tgueSKPspzugaIR7MA7bHeQEJ3sN,SpATywNh6bZuzm8s1ceuBUnMUAeoAHHw,11,7,5,0,3,2,5,1,23,3.2857142857142856,1,0.0,0,5,0,3,7,2,0,5,1,8,15,1
5377,89374,WJOBtEN6MBmL5RAy18uZScmCw5QHqH7o,bWdj2GDclj5ofokWjzoa5jAwMkxCykd6,7,9,5,32,1,0,2,0,49,7.0,1,0.0,1,5,31,1,8,0,1,2,0,38,11,1
5378,89376,x7a8xZCwJM4RqKXg6G5neepAYFOs6m5d,SpATywNh6bZuzm8s1ceuBUnMUAeoAHHw,7,3,1,0,1,1,4,1,11,1.5714285714285714,1,0.0,0,1,0,1,3,1,0,4,1,2,9,1
5379,89378,z8zMi50azvRwAPUNW2f5Gt0F6WOr8PI9,SpATywNh6bZuzm8s1ceuBUnMUAeoAHHw,7,6,2,0,1,0,2,0,11,1.5714285714285714,2,0.0,0,2,0,1,6,0,0,2,0,3,8,1
5380,89382,tEjzvvLPWnUBzeg9eUEbSbUDxKXRjQIx,SpATywNh6bZuzm8s1ceuBUnMUAeoAHHw,8,6,1,0,1,3,4,1,16,2.2857142857142856,1,0.0,0,1,0,1,6,3,0,4,1,2,14,1
5381,89384,IE6kqz4SgQ2K5IXq1ddIKWqjAvkWjxXn,SpATywNh6bZuzm8s1ceuBUnMUAeoAHHw,3,0,0,0,0,1,3,0,4,0.5714285714285714,1,0.0,0,0,0,0,0,1,0,3,0,0,4,1
5382,89389,YcgF3ndOhv1gz5wV43GDFwEO3v9Db2WY,SpATywNh6bZuzm8s1ceuBUnMUAeoAHHw,1,0,0,0,0,0,1,0,1,0.14285714285714285,1,0.0,0,0,0,0,0,0,0,1,0,0,1,1
5383,89392,zHLtAdps4GmYQ36wgo6nLPWMewImtEPP,SpATywNh6bZuzm8s1ceuBUnMUAeoAHHw,5,3,1,0,1,0,2,0,7,1.0,1,0.0,0,1,0,1,3,0,0,2,0,2,5,1
5384,89396,6xizGBxRpzCQSAXaR3hwOv1SoAXsZCKh,SpATywNh6bZuzm8s1ceuBUnMUAeoAHHw,7,1,1,0,1,0,7,1,11,1.5714285714285714,1,0.0,0,1,0,1,1,0,0,7,1,2,9,1
5385,89400,21PiP1YhF59KyQpWQkFYKWspSiSWfrA7,SpATywNh6bZuzm8s1ceuBUnMUAeoAHHw,4,2,0,0,0,0,2,0,4,0.5714285714285714,1,0.0,0,0,0,0,2,0,0,2,0,0,4,1
5386,89402,HG2LtxlWFsBhMuK56mWZ91TjbhMLoylz,SpATywNh6bZuzm8s1ceuBUnMUAeoAHHw,12,18,4,15,3,0,2,0,42,6.0,1,0.0,13,4,12,3,5,0,3,2,0,32,10,0
5387,89409,4OTqFMCZxx7r7u5a2qYtSI5NaNF7PvO8,SpATywNh6bZuzm8s1ceuBUnMUAeoAHHw,16,17,5,14,3,3,6,1,49,7.0,2,0.0,8,5,14,3,9,3,0,6,1,30,19,1
5388,89416,X8YK3vveOwnCTAS3rpB58DG3aostwJaj,SpATywNh6bZuzm8s1ceuBUnMUAeoAHHw,5,2,1,0,1,0,2,0,6,0.8571428571428571,1,0.0,0,1,0,1,2,0,0,2,0,2,4,1
5389,89419,s6NTLcoRryN4aDfvO1qsCQXhze6kEfOl,RXDvfPUBYFlVdlueBFbLW0mhhAyGEqpt,5,0,0,0,0,1,4,2,7,1.0,1,0.0,0,0,0,0,0,1,0,4,2,0,7,1
5390,89422,YjEaFn5LTfYqjxB6JXUvw4Xb9oLhK631,SpATywNh6bZuzm8s1ceuBUnMUAeoAHHw,1,0,0,0,0,0,1,0,1,0.14285714285714285,1,0.0,0,0,0,0,0,0,0,1,0,0,1,1
5391,89427,tMCbE9iM7KBcWjBabYSS51NRc5mnYleA,SpATywNh6bZuzm8s1ceuBUnMUAeoAHHw,4,3,1,0,1,0,1,0,6,0.8571428571428571,1,0.0,0,1,0,1,3,0,0,1,0,2,4,1
5392,89428,7rCsWwNSyvtkrQ3mC6RRhvkE6QVhgAZs,bWdj2GDclj5ofokWjzoa5jAwMkxCykd6,2,0,0,0,0,0,2,0,2,0.2857142857142857,1,0.0,0,0,0,0,0,0,0,2,0,0,2,1
5393,89429,2lYbk0XOrmGdaeqlfLI5dUfAHuZ6yPBA,SpATywNh6bZuzm8s1ceuBUnMUAeoAHHw,2,0,0,0,0,0,2,0,2,0.2857142857142857,1,0.0,0,0,0,0,0,0,0,2,0,0,2,1
5394,89431,nYSFDE8RCbcZhD46fRSvPHUvA1ahfupi,RXDvfPUBYFlVdlueBFbLW0mhhAyGEqpt,16,17,6,0,4,2,4,0,33,4.714285714285714,2,0.0,0,6,0,4,17,2,0,4,0,10,23,1
5395,89434,w60ThqGBllezQkIxCXQKmVVjrEAbCB3o,SpATywNh6bZuzm8s1ceuBUnMUAeoAHHw,13,12,8,0,4,1,11,1,37,5.285714285714286,1,0.0,1,8,0,4,11,1,0,11,1,13,24,1
5396,89435,mXql2iQ0u9MrfhDk3EyQfVgmOA6PfBP6,SpATywNh6bZuzm8s1ceuBUnMUAeoAHHw,9,5,4,0,3,0,3,1,16,2.2857142857142856,1,0.0,0,4,0,3,5,0,0,3,1,7,9,1
5397,89437,JaihKxZ9pTOfses6LZRLDOjCYawYvRFT,SpATywNh6bZuzm8s1ceuBUnMUAeoAHHw,15,14,2,6,1,1,6,1,31,4.428571428571429,1,0.0,6,2,6,1,8,1,0,6,1,15,16,1
5398,89438,KogrHROquIJLSXIZqzhYU9Hcb9zVebwT,bWdj2GDclj5ofokWjzoa5jAwMkxCykd6,12,15,8,38,2,7,8,1,79,11.285714285714286,1,0.0,1,8,37,2,14,7,1,8,1,48,31,1
5399,89439,GmpxJ8O1By2XxJiRtr729hGN3Vo5Le6z,SpATywNh6bZuzm8s1ceuBUnMUAeoAHHw,7,3,0,0,0,0,5,1,9,1.2857142857142858,1,0.0,1,0,0,0,2,0,0,5,1,1,8,1
5400,89445,QB10zfXuA41QjD5k4oKWFSxMld8hOlzr,SpATywNh6bZuzm8s1ceuBUnMUAeoAHHw,5,10,1,0,1,0,1,0,13,1.8571428571428572,1,0.0,0,1,0,1,10,0,0,1,0,2,11,1
5401,89447,reyLh94O0G9Sps1AWVf0MNOYDY3UabsF,bWdj2GDclj5ofokWjzoa5jAwMkxCykd6,1,0,0,0,0,0,1,0,1,0.14285714285714285,1,0.0,0,0,0,0,0,0,0,1,0,0,1,1
5402,89464,k7IDe0FSSJNcEAsxSZDCYYdSJ9TEDema,SpATywNh6bZuzm8s1ceuBUnMUAeoAHHw,5,2,1,0,1,0,2,0,6,0.8571428571428571,1,0.0,0,1,0,1,2,0,0,2,0,2,4,1
5403,89470,vEKYOhRdGZ59kfXY6wTO63YZY4EqPYqX,RXDvfPUBYFlVdlueBFbLW0mhhAyGEqpt,8,4,3,0,2,0,2,0,11,1.5714285714285714,1,0.0,0,3,0,2,4,0,0,2,0,5,6,1
5404,89472,hA0qeCFHNAYT25Zfkgax8xO422WWYXAI,SpATywNh6bZuzm8s1ceuBUnMUAeoAHHw,9,7,0,0,0,6,5,0,18,2.5714285714285716,1,0.0,1,0,0,0,6,6,0,5,0,1,17,1
5405,89481,KUppVPuFnFs0vLCUrPJOIfquMy1mUooq,SpATywNh6bZuzm8s1ceuBUnMUAeoAHHw,3,2,1,0,0,0,1,0,4,0.5714285714285714,1,0.0,0,1,0,0,2,0,0,1,0,1,3,1
5406,89484,tWsedvadboRaUvtnR4XHAbkrBvCaHSP7,SpATywNh6bZuzm8s1ceuBUnMUAeoAHHw,5,2,1,0,1,0,2,0,6,0.8571428571428571,1,0.0,0,1,0,1,2,0,0,2,0,2,4,1
5407,89486,ALqQPup1pnpnyRPY8Wn9arGTMiZcUqbO,SpATywNh6bZuzm8s1ceuBUnMUAeoAHHw,12,7,0,3,0,2,6,0,18,2.5714285714285716,1,0.0,2,0,3,0,5,2,0,6,0,5,13,1
5408,89487,C4jo9SMfYZ7U2XGeGdDn52kX4eeoqM99,bWdj2GDclj5ofokWjzoa5jAwMkxCykd6,13,17,0,36,0,1,7,0,61,8.714285714285714,3,0.0,4,0,30,0,13,1,6,7,0,34,27,1
5409,89493,KMupQNOY5AUo1OSHinupraqdnIAkZaUk,SpATywNh6bZuzm8s1ceuBUnMUAeoAHHw,11,8,5,0,3,2,3,0,21,3.0,1,0.0,2,5,0,3,6,2,0,3,0,10,11,0
5410,89496,9HuS6eeLBJKMWQs5fuvJufNrciBPiV4Z,SpATywNh6bZuzm8s1ceuBUnMUAeoAHHw,14,16,9,4,5,0,6,3,43,6.142857142857143,2,0.0,1,9,4,5,15,0,0,6,3,19,24,1
5411,89497,DoqTCfzI1BFXttxyeA3RWI5TOmYLp0hg,SpATywNh6bZuzm8s1ceuBUnMUAeoAHHw,6,5,0,0,0,1,6,1,13,1.8571428571428572,2,0.0,0,0,0,0,5,1,0,6,1,0,13,1
5412,89501,iIVb1PSNqRo7ycAAOFHU9Md1pZ0vCsoL,RXDvfPUBYFlVdlueBFbLW0mhhAyGEqpt,10,7,4,0,2,8,6,1,28,4.0,2,0.0,0,4,0,2,7,8,0,6,1,6,22,1
5413,89502,mR9Awu9GGhq6cpZDsN1vhsOMBBjHJTwu,SpATywNh6bZuzm8s1ceuBUnMUAeoAHHw,2,0,0,0,0,0,2,0,2,0.2857142857142857,1,0.0,0,0,0,0,0,0,0,2,0,0,2,1
5414,89504,g8m22R7W0Wo8v9RXY0TMbj5qf5RFgvht,SpATywNh6bZuzm8s1ceuBUnMUAeoAHHw,7,12,9,0,5,0,5,0,31,4.428571428571429,3,0.0,0,9,0,5,12,0,0,5,0,14,17,1
5415,89508,IK3hKesiTuTek37MSwSLzKRB4SC1WHUB,RXDvfPUBYFlVdlueBFbLW0mhhAyGEqpt,8,2,2,0,2,12,6,0,24,3.4285714285714284,1,0.0,0,2,0,2,2,12,0,6,0,4,20,1
5416,89510,HlbAiahvOwKnLbpNJlRLXObPS8VUYp1d,SpATywNh6bZuzm8s1ceuBUnMUAeoAHHw,4,4,2,0,2,0,2,0,10,1.4285714285714286,1,0.0,0,2,0,2,4,0,0,2,0,4,6,1
5417,89523,uufMRz1rjLB5PHuvCFtrRWUteDYIyLB4,SpATywNh6bZuzm8s1ceuBUnMUAeoAHHw,7,10,4,0,4,0,8,0,26,3.7142857142857144,5,0.0,1,4,0,4,9,0,0,8,0,9,17,1
5418,89528,UUMX1CmSolRdRWNSlMStbZ6MtOKuPj1e,bWdj2GDclj5ofokWjzoa5jAwMkxCykd6,6,4,1,0,1,0,4,0,10,1.4285714285714286,2,0.0,0,1,0,1,4,0,0,4,0,2,8,0
5419,89530,wIoFAWs9LgckZlTBThLS4htxmELqPsaS,SpATywNh6bZuzm8s1ceuBUnMUAeoAHHw,2,0,0,0,0,0,2,0,2,0.2857142857142857,1,0.0,0,0,0,0,0,0,0,2,0,0,2,1
5420,89537,KMupQNOY5AUo1OSHinupraqdnIAkZaUk,bWdj2GDclj5ofokWjzoa5jAwMkxCykd6,5,2,1,0,1,2,2,0,8,1.1428571428571428,1,0.0,0,1,0,1,2,2,0,2,0,2,6,1
5421,89545,gbYUHxxKDGWDbytDUcXlcbADJemufrHf,bWdj2GDclj5ofokWjzoa5jAwMkxCykd6,1,0,0,0,0,0,1,0,1,0.14285714285714285,1,0.0,0,0,0,0,0,0,0,1,0,0,1,1
5422,89547,yiyWtvIUUgzCTrQ1w4vh6W1sUUxvDdmd,G8EPVSXsOYB5YQWZGiz1aVq5Pgr2GrQu,19,33,11,6,7,0,8,1,66,9.428571428571429,3,0.0,9,11,3,7,24,0,3,8,1,30,36,1
5423,89554,ywVRX55s8qrIIZjyxsYaBHsGW40qS7zt,SpATywNh6bZuzm8s1ceuBUnMUAeoAHHw,8,5,2,5,1,0,2,0,15,2.142857142857143,1,0.0,1,2,4,1,4,0,1,2,0,8,7,1
5424,89558,s4xNNQ4RZ35amMfmvZawsu7u8CabnIey,bWdj2GDclj5ofokWjzoa5jAwMkxCykd6,13,14,8,0,7,1,8,1,39,5.571428571428571,1,0.0,2,8,0,7,12,1,0,8,1,17,22,1
5425,89559,0wpgF8T87E4lIPjqoh0AkxyomANfbalw,bWdj2GDclj5ofokWjzoa5jAwMkxCykd6,6,4,2,0,2,0,1,0,9,1.2857142857142858,1,0.0,1,2,0,2,3,0,0,1,0,5,4,1
5426,89564,CywE8FKIbY3F3QxzorcpvAYCApeOH4J5,SpATywNh6bZuzm8s1ceuBUnMUAeoAHHw,16,29,14,26,7,6,9,1,92,13.142857142857142,2,0.0,8,14,20,7,21,6,6,9,1,49,43,1
5427,89573,EJIkk1z1GAyTxouBU8smmsjhIBwzBhn1,bWdj2GDclj5ofokWjzoa5jAwMkxCykd6,5,2,0,0,0,1,6,0,9,1.2857142857142858,1,0.0,0,0,0,0,2,1,0,6,0,0,9,1
5428,89582,IVRKzAf1gWN5ButpaPiczzsxf6iD5MK8,SpATywNh6bZuzm8s1ceuBUnMUAeoAHHw,28,42,22,15,12,3,17,0,111,15.857142857142858,4,0.0,12,22,15,12,30,3,0,17,0,61,50,0
5429,89585,YyGQMZcaxlC6XILTwFAL9ZoWRvDQm7bN,SpATywNh6bZuzm8s1ceuBUnMUAeoAHHw,15,8,4,17,3,111,7,1,151,21.571428571428573,1,0.0,3,4,14,3,5,111,3,7,1,24,127,1
5430,89586,Ici19IlriqXgCDQhlI7Y7CIAQZwpQKlL,SpATywNh6bZuzm8s1ceuBUnMUAeoAHHw,6,2,1,0,1,0,3,0,7,1.0,1,0.0,0,1,0,1,2,0,0,3,0,2,5,1
5431,89594,8lejIyIXg2PoIErIyQIUo4voWGcEGVK1,SpATywNh6bZuzm8s1ceuBUnMUAeoAHHw,14,25,9,19,3,1,3,0,60,8.571428571428571,1,0.0,6,9,16,3,19,1,3,3,0,34,26,1
5432,89596,xfVSAJmUsFwMX0mM4lQFC1xlBJimN3Sw,SpATywNh6bZuzm8s1ceuBUnMUAeoAHHw,1,0,0,0,0,0,1,0,1,0.14285714285714285,1,0.0,0,0,0,0,0,0,0,1,0,0,1,1
5433,89600,JV9PrSM2vjuxfGaaWBES6jKK96YmYbtj,SpATywNh6bZuzm8s1ceuBUnMUAeoAHHw,13,11,4,16,3,1,2,0,37,5.285714285714286,1,0.0,6,4,16,3,5,1,0,2,0,29,8,1
5434,89605,f3LgSSewSBsudoWmIigH2aapqGCxH8CK,SpATywNh6bZuzm8s1ceuBUnMUAeoAHHw,8,6,2,8,0,0,3,0,19,2.7142857142857144,2,0.0,1,2,7,0,5,0,1,3,0,10,9,0
5435,89606,QUiyBd2SaZz1OhTujJnVJUzpOWStKB8O,SpATywNh6bZuzm8s1ceuBUnMUAeoAHHw,11,14,7,0,2,2,10,0,35,5.0,2,0.0,3,7,0,2,11,2,0,10,0,12,23,1
5436,89611,oD0FQQV2wqYt3501tltDa6pobGqWwl0U,SpATywNh6bZuzm8s1ceuBUnMUAeoAHHw,2,0,0,0,0,0,2,0,2,0.2857142857142857,1,0.0,0,0,0,0,0,0,0,2,0,0,2,1
5437,89613,TrrLeSGbjOK3szupk5Bxq1KXuDNAsaBR,RXDvfPUBYFlVdlueBFbLW0mhhAyGEqpt,4,0,0,0,0,4,5,0,9,1.2857142857142858,1,0.0,0,0,0,0,0,4,0,5,0,0,9,1
5438,89614,v2d7e1ThXhvKY81XABSzKd6OtFeJV4cC,bWdj2GDclj5ofokWjzoa5jAwMkxCykd6,16,23,8,44,6,0,5,0,86,12.285714285714286,2,0.0,10,8,38,6,13,0,6,5,0,62,24,1
5439,89615,0Dihh52qSGvY4VErU5EvQUZatVGQEN7V,G8EPVSXsOYB5YQWZGiz1aVq5Pgr2GrQu,2,0,0,0,0,0,2,0,2,0.2857142857142857,1,0.0,0,0,0,0,0,0,0,2,0,0,2,1
5440,89629,yd5TT5oOy4dFZZMQ0jlppRbBYPk2zugf,RXDvfPUBYFlVdlueBFbLW0mhhAyGEqpt,34,40,26,34,12,29,15,4,160,22.857142857142858,3,0.0,6,26,31,12,34,29,3,15,4,75,85,1
5441,89632,fGUxtqzvs60cjlG1FT6OPrGFHTQ3arMq,SpATywNh6bZuzm8s1ceuBUnMUAeoAHHw,9,9,4,0,2,0,3,0,18,2.5714285714285716,2,0.0,0,4,0,2,9,0,0,3,0,6,12,1
5442,89633,NecHXZoXWlSlvFR2HUgkuO9YtJstZDyP,SpATywNh6bZuzm8s1ceuBUnMUAeoAHHw,2,0,0,0,0,0,3,0,3,0.42857142857142855,1,0.0,0,0,0,0,0,0,0,3,0,0,3,1
5443,89635,q0VUQjNPG110NUbSYiiAeb8QmfsAGRIl,bWdj2GDclj5ofokWjzoa5jAwMkxCykd6,2,0,0,0,0,0,2,0,2,0.2857142857142857,1,0.0,0,0,0,0,0,0,0,2,0,0,2,1
5444,89637,9FULiZu6qUnuIs2MyDSoVO8NHl3dw8Ao,SpATywNh6bZuzm8s1ceuBUnMUAeoAHHw,17,32,5,12,1,16,13,3,82,11.714285714285714,3,0.0,6,5,12,1,26,16,0,13,3,24,58,1
5445,89639,NecHXZoXWlSlvFR2HUgkuO9YtJstZDyP,G8EPVSXsOYB5YQWZGiz1aVq5Pgr2GrQu,1,0,0,0,0,0,1,0,1,0.14285714285714285,1,0.0,0,0,0,0,0,0,0,1,0,0,1,1
5446,89640,4rTxfdVJbNfbAtIV373iaao2aWX8Xwpx,bWdj2GDclj5ofokWjzoa5jAwMkxCykd6,11,16,4,0,3,1,10,1,35,5.0,1,0.0,2,4,0,3,14,1,0,10,1,9,26,1
5447,89642,tZzxdl7066iNcnLGeU4cT9rDUqFLgEBx,SpATywNh6bZuzm8s1ceuBUnMUAeoAHHw,5,2,1,0,1,0,2,0,6,0.8571428571428571,1,0.0,0,1,0,1,2,0,0,2,0,2,4,0
5448,89646,JEelEWgHt6PkTjt88tREqKMfbXr9CA9f,SpATywNh6bZuzm8s1ceuBUnMUAeoAHHw,5,3,1,0,1,0,2,0,7,1.0,1,0.0,0,1,0,1,3,0,0,2,0,2,5,1
5449,89648,et0FwkFflO62QJKGJwzwDqACodcSRV2v,SpATywNh6bZuzm8s1ceuBUnMUAeoAHHw,15,42,18,7,10,0,6,0,83,11.857142857142858,3,0.0,11,18,7,10,31,0,0,6,0,46,37,1
5450,89651,4qM7n65VbCTp8lq3dbzhDmImmEZcwgn8,bWdj2GDclj5ofokWjzoa5jAwMkxCykd6,5,5,1,0,1,0,2,0,9,1.2857142857142858,2,0.0,0,1,0,1,5,0,0,2,0,2,7,1
5451,89652,g8m22R7W0Wo8v9RXY0TMbj5qf5RFgvht,G8EPVSXsOYB5YQWZGiz1aVq5Pgr2GrQu,8,5,3,0,2,0,5,0,15,2.142857142857143,2,0.0,0,3,0,2,5,0,0,5,0,5,10,1
5452,89654,q0VUQjNPG110NUbSYiiAeb8QmfsAGRIl,SpATywNh6bZuzm8s1ceuBUnMUAeoAHHw,5,2,1,0,1,0,2,0,6,0.8571428571428571,1,0.0,0,1,0,1,2,0,0,2,0,2,4,1
5453,89657,d1q0By7DZyiPLgwuG8hyGXtu0NW1hfAc,SpATywNh6bZuzm8s1ceuBUnMUAeoAHHw,8,12,6,0,3,0,4,0,25,3.5714285714285716,2,0.0,0,6,0,3,12,0,0,4,0,9,16,1
5454,89660,gGywHgGU1Kdw7XJcqMzinsJnpz7uSgex,SpATywNh6bZuzm8s1ceuBUnMUAeoAHHw,3,2,0,0,0,0,2,0,4,0.5714285714285714,1,0.0,0,0,0,0,2,0,0,2,0,0,4,1
5455,89663,7plKTmv3RnLOGLbgKBn60EIAr1uLnnPW,SpATywNh6bZuzm8s1ceuBUnMUAeoAHHw,2,0,0,0,0,0,3,0,3,0.42857142857142855,1,0.0,0,0,0,0,0,0,0,3,0,0,3,1
5456,89665,7plKTmv3RnLOGLbgKBn60EIAr1uLnnPW,G8EPVSXsOYB5YQWZGiz1aVq5Pgr2GrQu,2,0,0,0,0,0,7,0,7,1.0,1,0.0,0,0,0,0,0,0,0,7,0,0,7,1
5457,89667,4ZJIc9fpxQVSj3UgQJHtkAvW8OVkOdgO,SpATywNh6bZuzm8s1ceuBUnMUAeoAHHw,1,0,0,0,0,0,1,0,1,0.14285714285714285,1,0.0,0,0,0,0,0,0,0,1,0,0,1,1
5458,89669,tmmvczbZLiPw6t5Ru9DTWRYnvMI3hKxN,G8EPVSXsOYB5YQWZGiz1aVq5Pgr2GrQu,8,8,5,0,3,0,4,0,20,2.857142857142857,2,0.0,0,5,0,3,8,0,0,4,0,8,12,1
5459,89672,Sqgk0iqdEQnGHvbbLSikGrUMP9U33RaR,SpATywNh6bZuzm8s1ceuBUnMUAeoAHHw,1,0,0,0,0,0,1,0,1,0.14285714285714285,1,0.0,0,0,0,0,0,0,0,1,0,0,1,1
5460,89682,VCrlTy1l4SI8aDl63osChvBColRWsjDv,bWdj2GDclj5ofokWjzoa5jAwMkxCykd6,4,2,1,0,1,6,2,0,12,1.7142857142857142,1,0.0,0,1,0,1,2,6,0,2,0,2,10,1
5461,89685,hAdLjCwSiW0mQdl44dFfRTVxdDqDmjKC,SpATywNh6bZuzm8s1ceuBUnMUAeoAHHw,7,4,3,0,1,0,2,0,10,1.4285714285714286,1,0.0,0,3,0,1,4,0,0,2,0,4,6,1
5462,89691,iADIVtxyoQg4RtIKmWkz3YbJ1msvN2b8,G8EPVSXsOYB5YQWZGiz1aVq5Pgr2GrQu,28,26,14,38,9,0,3,0,90,12.857142857142858,1,0.0,8,14,38,9,18,0,0,3,0,69,21,1
5463,89697,i4fgy4BVHlpEBMVrUkI9gWLihOonqgFN,SpATywNh6bZuzm8s1ceuBUnMUAeoAHHw,8,9,5,0,2,0,6,0,22,3.142857142857143,2,0.0,0,5,0,2,9,0,0,6,0,7,15,1
5464,89700,5c8lpFjwt7A1RG96ZJudxhytTaQ1Rdi3,SpATywNh6bZuzm8s1ceuBUnMUAeoAHHw,9,4,3,0,2,0,3,0,12,1.7142857142857142,1,0.0,0,3,0,2,4,0,0,3,0,5,7,1
5465,89704,EFvdBUP19hneCSDaGOnsFiBemnNxo1wC,SpATywNh6bZuzm8s1ceuBUnMUAeoAHHw,5,2,0,0,0,3,4,0,9,1.2857142857142858,1,0.0,0,0,0,0,2,3,0,4,0,0,9,1
5466,89716,34wvjhwjZXp59iVLK73uLxzWNB5SDXqZ,SpATywNh6bZuzm8s1ceuBUnMUAeoAHHw,1,0,0,0,0,0,1,0,1,0.14285714285714285,1,0.0,0,0,0,0,0,0,0,1,0,0,1,1
5467,89718,gJUEUQ7J006sORAArhI6J8FkT7xUEHkB,SpATywNh6bZuzm8s1ceuBUnMUAeoAHHw,27,42,13,34,4,7,8,1,109,15.571428571428571,3,0.0,10,13,30,4,32,7,4,8,1,57,52,1
5468,89721,Y1k7olzlKnbC2gLcfIeH2MYAVraORisd,SpATywNh6bZuzm8s1ceuBUnMUAeoAHHw,7,3,2,0,2,0,2,0,9,1.2857142857142858,1,0.0,0,2,0,2,3,0,0,2,0,4,5,1
5469,89727,8yrIKDtnkYcLfERwrXrvcRGxHxbt2Jd3,bWdj2GDclj5ofokWjzoa5jAwMkxCykd6,5,5,2,0,1,0,4,0,12,1.7142857142857142,1,0.0,0,2,0,1,5,0,0,4,0,3,9,1
5470,89728,XzytXRsbdOwF87AfAw5uPYzo1dbeIXdh,SpATywNh6bZuzm8s1ceuBUnMUAeoAHHw,11,10,8,0,2,1,6,1,28,4.0,1,0.0,0,8,0,2,10,1,0,6,1,10,18,1
5471,89730,lVnMpRF2pBRLkh9CfasNC1eZi18lrTad,G8EPVSXsOYB5YQWZGiz1aVq5Pgr2GrQu,7,4,3,0,3,0,2,0,12,1.7142857142857142,1,0.0,0,3,0,3,4,0,0,2,0,6,6,1
5472,89735,DBl87nF6WTgoCD6kgTHVE2oB45pDEn6y,RXDvfPUBYFlVdlueBFbLW0mhhAyGEqpt,10,8,4,0,2,0,2,0,16,2.2857142857142856,1,0.0,0,4,0,2,8,0,0,2,0,6,10,1
5473,89736,bRDMid9iRGcartTY4OAKAdQRbX2j8Y86,SpATywNh6bZuzm8s1ceuBUnMUAeoAHHw,5,2,1,0,1,0,2,0,6,0.8571428571428571,1,0.0,0,1,0,1,2,0,0,2,0,2,4,1
5474,89737,Fa7tOqP1WKllvNDMgvUWmTzPr8J8vhy8,bWdj2GDclj5ofokWjzoa5jAwMkxCykd6,4,2,1,0,0,0,3,0,6,0.8571428571428571,1,0.0,0,1,0,0,2,0,0,3,0,1,5,1
5475,89741,4TxI4qNPs1w5xlNJ8vKBNEb6bFI5MoVU,SpATywNh6bZuzm8s1ceuBUnMUAeoAHHw,3,2,0,0,0,0,1,0,3,0.42857142857142855,1,0.0,0,0,0,0,2,0,0,1,0,0,3,1
5476,89750,wpQN3hnHZvt8MtT7VRAs9ZQvlWkphaGS,SpATywNh6bZuzm8s1ceuBUnMUAeoAHHw,7,3,2,0,2,0,2,0,9,1.2857142857142858,1,0.0,0,2,0,2,3,0,0,2,0,4,5,1
5477,89752,bRDMid9iRGcartTY4OAKAdQRbX2j8Y86,G8EPVSXsOYB5YQWZGiz1aVq5Pgr2GrQu,2,0,0,0,0,0,2,0,2,0.2857142857142857,1,0.0,0,0,0,0,0,0,0,2,0,0,2,1
5478,89753,k3RqfBgQWTtiyEyw3fqGDGa48Oo6Lcuo,SpATywNh6bZuzm8s1ceuBUnMUAeoAHHw,2,0,0,0,0,0,3,0,3,0.42857142857142855,1,0.0,0,0,0,0,0,0,0,3,0,0,3,1
5479,89764,Ur5YqRaNsaD6KYfRfGA2p4Zmd8kpRITc,SpATywNh6bZuzm8s1ceuBUnMUAeoAHHw,26,37,18,16,7,7,11,0,96,13.714285714285714,4,0.0,12,18,16,7,25,7,0,11,0,53,43,0
5480,89766,36BAYEapI76Mtxquz6BRxAoc9Y27dWFZ,G8EPVSXsOYB5YQWZGiz1aVq5Pgr2GrQu,10,20,4,0,5,0,2,0,31,4.428571428571429,1,0.0,11,4,0,5,9,0,0,2,0,20,11,1
5481,89767,4geFTA2SGlVqwe93iNEDI1Zg55VMGaYi,SpATywNh6bZuzm8s1ceuBUnMUAeoAHHw,9,15,7,0,2,1,6,0,31,4.428571428571429,1,0.0,1,7,0,2,14,1,0,6,0,10,21,1
5482,89788,jH123vWnpYTVLfmuSyled9Oau0AYvcx6,SpATywNh6bZuzm8s1ceuBUnMUAeoAHHw,14,12,1,18,0,4,6,1,42,6.0,1,0.0,4,1,14,0,8,4,4,6,1,19,23,1
5483,89792,TvO9et6FKUYNWGTC0Lu8cSO0dysynadE,SpATywNh6bZuzm8s1ceuBUnMUAeoAHHw,13,21,1,18,0,2,10,0,52,7.428571428571429,1,0.0,6,1,15,0,15,2,3,10,0,22,30,1
5484,89796,TNaXEhaNWX9mct0CT7Pun5pZ6GW6ngCc,SpATywNh6bZuzm8s1ceuBUnMUAeoAHHw,1,0,0,0,0,0,1,0,1,0.14285714285714285,1,0.0,0,0,0,0,0,0,0,1,0,0,1,1
5485,89799,eaeORohb7wCQL9JM2uz3yah8DgLbswAx,SpATywNh6bZuzm8s1ceuBUnMUAeoAHHw,7,3,2,0,2,25,3,0,35,5.0,1,0.0,0,2,0,2,3,25,0,3,0,4,31,1
5486,89806,55eRUKhAgZ6jAG2QNlk8p8bxI8Mo1ci4,bWdj2GDclj5ofokWjzoa5jAwMkxCykd6,4,2,1,0,1,0,1,0,5,0.7142857142857143,1,0.0,0,1,0,1,2,0,0,1,0,2,3,1
5487,89810,ZGj94V0W2CVzOroBBKkby4OcuobYFXw5,SpATywNh6bZuzm8s1ceuBUnMUAeoAHHw,1,0,0,0,0,0,1,0,1,0.14285714285714285,1,0.0,0,0,0,0,0,0,0,1,0,0,1,1
5488,89814,HOOY7gv2DgQRhkoQeNGOHVNWen0BTC1i,SpATywNh6bZuzm8s1ceuBUnMUAeoAHHw,1,0,0,0,0,0,1,0,1,0.14285714285714285,1,0.0,0,0,0,0,0,0,0,1,0,0,1,1
5489,89816,KDx4Tzovot56yH25Hp8Dvz0vvUPU9kNc,RXDvfPUBYFlVdlueBFbLW0mhhAyGEqpt,13,8,0,0,0,3,7,1,19,2.7142857142857144,1,0.0,0,0,0,0,8,3,0,7,1,0,19,1
5490,89818,UD9YcWI16E6My1ERXiW1sP1n2okAaM6v,bWdj2GDclj5ofokWjzoa5jAwMkxCykd6,1,0,0,0,0,0,1,0,1,0.14285714285714285,1,0.0,0,0,0,0,0,0,0,1,0,0,1,1
5491,89822,9aAr0eFSVkxwTSV4wzEfwp33zeuW9SSs,bWdj2GDclj5ofokWjzoa5jAwMkxCykd6,17,20,5,44,4,0,5,0,78,11.142857142857142,2,0.0,4,5,42,4,16,0,2,5,0,55,23,1
5492,89824,JXDuo0HNKJSjtiXj27sPUY7beWRK43na,SpATywNh6bZuzm8s1ceuBUnMUAeoAHHw,9,3,1,0,2,1,11,2,20,2.857142857142857,1,0.0,0,1,0,2,3,1,0,11,2,3,17,1
5493,89829,sfmDw8Mu24TwJAISRGKb3tkGixPCex4a,SpATywNh6bZuzm8s1ceuBUnMUAeoAHHw,16,26,14,12,7,18,7,1,85,12.142857142857142,1,0.0,6,14,9,7,20,18,3,7,1,36,49,1
5494,89838,ZV56LNPqAGNtVEuE1uQTYk5rPuhQg5k4,bWdj2GDclj5ofokWjzoa5jAwMkxCykd6,2,0,0,0,0,0,3,0,3,0.42857142857142855,1,0.0,0,0,0,0,0,0,0,3,0,0,3,1
5495,89844,ijg95u2jQVjnyTNM7ClS8Oj92hwAA9nz,SpATywNh6bZuzm8s1ceuBUnMUAeoAHHw,8,2,1,0,1,0,5,1,10,1.4285714285714286,1,0.0,0,1,0,1,2,0,0,5,1,2,8,1
5496,89845,yirkVFAFnnxTIzPISxnqlF6vNcZ5Qb6v,SpATywNh6bZuzm8s1ceuBUnMUAeoAHHw,4,2,1,0,0,0,2,0,5,0.7142857142857143,1,0.0,0,1,0,0,2,0,0,2,0,1,4,1
5497,89865,3z5ETakafkt4JzUHVZc8EGa6ySJrNrZy,SpATywNh6bZuzm8s1ceuBUnMUAeoAHHw,5,2,1,0,1,0,2,0,6,0.8571428571428571,1,0.0,0,1,0,1,2,0,0,2,0,2,4,1
5498,89889,esqI93l6FZECayExObEEu4vBjC7wOeKE,SpATywNh6bZuzm8s1ceuBUnMUAeoAHHw,7,2,2,0,2,0,2,0,8,1.1428571428571428,1,0.0,0,2,0,2,2,0,0,2,0,4,4,1
5499,89890,IXH7oZyCKGgxdh9kwUS5VD9TLaoLggU5,SpATywNh6bZuzm8s1ceuBUnMUAeoAHHw,7,3,2,0,2,0,2,0,9,1.2857142857142858,1,0.0,0,2,0,2,3,0,0,2,0,4,5,1
5500,89893,HAAyQYNYY3ULmqhNC56bxv5FSwyMVoqP,SpATywNh6bZuzm8s1ceuBUnMUAeoAHHw,11,26,4,10,0,1,10,0,51,7.285714285714286,3,0.0,9,4,9,0,17,1,1,10,0,22,29,1
5501,89897,HAAyQYNYY3ULmqhNC56bxv5FSwyMVoqP,bWdj2GDclj5ofokWjzoa5jAwMkxCykd6,4,10,4,0,0,0,6,0,20,2.857142857142857,3,0.0,0,4,0,0,10,0,0,6,0,4,16,1
5502,89899,uI2C8kZvxXShkoacauA0S9izMW2oRB2R,RXDvfPUBYFlVdlueBFbLW0mhhAyGEqpt,71,49,28,154,15,10,13,1,270,38.57142857142857,4,0.0,14,28,144,15,35,10,10,13,1,201,69,1
5503,89901,YiHBZRMHXXOxz07e5dCrboCIm1oQ0OKy,RXDvfPUBYFlVdlueBFbLW0mhhAyGEqpt,16,17,12,0,6,7,10,0,52,7.428571428571429,1,0.0,0,12,0,6,17,7,0,10,0,18,34,1
5504,89906,mMv5ULasJWNphOEtfj5B5HTtZYfxsB3G,SpATywNh6bZuzm8s1ceuBUnMUAeoAHHw,2,0,0,0,0,0,2,0,2,0.2857142857142857,1,0.0,0,0,0,0,0,0,0,2,0,0,2,1
5505,89910,qngZFTemZ9VNe5bU9mST85frjoIJ7IAD,RXDvfPUBYFlVdlueBFbLW0mhhAyGEqpt,5,2,1,0,1,0,2,0,6,0.8571428571428571,1,0.0,0,1,0,1,2,0,0,2,0,2,4,1
5506,89913,zlNlEcmlViJgBUG0ywxJEPhI6SYvToC0,SpATywNh6bZuzm8s1ceuBUnMUAeoAHHw,1,0,0,0,0,0,1,0,1,0.14285714285714285,1,0.0,0,0,0,0,0,0,0,1,0,0,1,1
5507,89917,Jr0Xqt1ZmxzSzD15wla9BChmcIeBBK4Z,G8EPVSXsOYB5YQWZGiz1aVq5Pgr2GrQu,9,4,0,0,0,3,7,1,15,2.142857142857143,1,0.0,0,0,0,0,4,3,0,7,1,0,15,1
5508,89923,ysO1bg2EIYdeVFkxhwuOr9gves820gWk,RXDvfPUBYFlVdlueBFbLW0mhhAyGEqpt,6,4,1,0,0,0,3,1,9,1.2857142857142858,1,0.0,0,1,0,0,4,0,0,3,1,1,8,1
5509,89935,Cvsz0UZNQwRp1mBIzDah4d0DHCa0q2WK,SpATywNh6bZuzm8s1ceuBUnMUAeoAHHw,1,0,0,0,0,0,1,0,1,0.14285714285714285,1,0.0,0,0,0,0,0,0,0,1,0,0,1,1
5510,89937,Lb6PKJrTzwsQYsITlNu0wfDvL4DmKZCj,RXDvfPUBYFlVdlueBFbLW0mhhAyGEqpt,4,2,1,0,1,0,1,0,5,0.7142857142857143,1,0.0,0,1,0,1,2,0,0,1,0,2,3,1
5511,89948,TtmytGkYhNaL4UmbxQBMSixlcCRjb9lD,SpATywNh6bZuzm8s1ceuBUnMUAeoAHHw,7,8,1,0,0,6,5,0,20,2.857142857142857,1,0.0,0,1,0,0,8,6,0,5,0,1,19,1
5512,89956,myYQGnE7AuDkDAMs5wvSchGGtMiBR3qG,RXDvfPUBYFlVdlueBFbLW0mhhAyGEqpt,6,4,0,0,0,2,5,0,11,1.5714285714285714,1,0.0,0,0,0,0,4,2,0,5,0,0,11,0
5513,89957,0q9MKOQI6izUm7JGi2QEuKfgyApDxosK,SpATywNh6bZuzm8s1ceuBUnMUAeoAHHw,2,0,0,0,0,0,2,0,2,0.2857142857142857,1,0.0,0,0,0,0,0,0,0,2,0,0,2,1
5514,89967,db8Cy33Nc9oRQhsghT9mZ7YJUbZnnH0B,SpATywNh6bZuzm8s1ceuBUnMUAeoAHHw,5,2,1,0,1,0,2,0,6,0.8571428571428571,1,0.0,0,1,0,1,2,0,0,2,0,2,4,1
5515,89968,KjHvjBsSgp7lqvkYLAjrQHS8ZrdrlLzv,SpATywNh6bZuzm8s1ceuBUnMUAeoAHHw,11,9,7,7,5,1,2,0,31,4.428571428571429,1,0.0,1,7,6,5,8,1,1,2,0,19,12,1
5516,89969,frAGxLKbgrgCbr9YXoqzdmgtbJjUbBNJ,G8EPVSXsOYB5YQWZGiz1aVq5Pgr2GrQu,5,8,1,0,2,1,2,0,14,2.0,1,0.0,6,1,0,2,2,1,0,2,0,9,5,1
5517,89971,DpB3NoJLarAGiHUaBV6zvSP8bR0qw4yk,RXDvfPUBYFlVdlueBFbLW0mhhAyGEqpt,23,17,15,0,11,0,3,0,46,6.571428571428571,3,0.0,0,15,0,11,17,0,0,3,0,26,20,1
5518,89984,HCLrpFC2S5L0Y8JmZewW8gsgYgpEkXeP,SpATywNh6bZuzm8s1ceuBUnMUAeoAHHw,14,12,5,24,3,0,6,0,50,7.142857142857143,2,0.0,4,5,19,3,8,0,5,6,0,31,19,1
5519,89987,8QIwRllpGKgpURtcmS5hWJ0AInSKESf0,RXDvfPUBYFlVdlueBFbLW0mhhAyGEqpt,6,2,1,0,1,0,3,0,7,1.0,1,0.0,0,1,0,1,2,0,0,3,0,2,5,1
5520,89994,zvOHbaUWjxRZ9zCYxYPMcUH4Ef5dE8Ae,G8EPVSXsOYB5YQWZGiz1aVq5Pgr2GrQu,9,6,2,0,2,0,9,0,19,2.7142857142857144,3,0.0,0,2,0,2,6,0,0,9,0,4,15,1
5521,90000,xFi8956jLKPkTqTiwrHbFAm2iOTFidYP,SpATywNh6bZuzm8s1ceuBUnMUAeoAHHw,1,0,0,0,0,0,2,0,2,0.2857142857142857,1,0.0,0,0,0,0,0,0,0,2,0,0,2,1
5522,90008,aM04j8B80UycNpLiy2mFNdgBiaLCgDBx,SpATywNh6bZuzm8s1ceuBUnMUAeoAHHw,5,2,1,0,1,0,4,0,8,1.1428571428571428,1,0.0,0,1,0,1,2,0,0,4,0,2,6,1
5523,90011,KbVIZwe7S3MOh9dlFVWDZwSpf3zNL2tv,SpATywNh6bZuzm8s1ceuBUnMUAeoAHHw,5,4,2,0,1,0,1,0,8,1.1428571428571428,1,0.0,0,2,0,1,4,0,0,1,0,3,5,1
5524,90014,ZDrt6zlGm4y4ur5AWVSG62RV3VJJ5cJS,SpATywNh6bZuzm8s1ceuBUnMUAeoAHHw,6,3,2,0,1,7,3,0,16,2.2857142857142856,1,0.0,0,2,0,1,3,7,0,3,0,3,13,1
5525,90021,bjoQsxzy5xWbIlWJOK88FLxI1KzCehRN,SpATywNh6bZuzm8s1ceuBUnMUAeoAHHw,3,2,0,0,0,0,1,0,3,0.42857142857142855,1,0.0,0,0,0,0,2,0,0,1,0,0,3,1
5526,90023,OMrBHOtDkdk4Zxba42NamuOWH8Ss9fWW,bWdj2GDclj5ofokWjzoa5jAwMkxCykd6,2,0,0,0,0,0,2,0,2,0.2857142857142857,1,0.0,0,0,0,0,0,0,0,2,0,0,2,1
5527,90030,rQT5JCDNn9UQwRKU1wpR7NGmcTvEHfxS,bWdj2GDclj5ofokWjzoa5jAwMkxCykd6,5,2,1,0,1,0,5,0,9,1.2857142857142858,1,0.0,0,1,0,1,2,0,0,5,0,2,7,1
5528,90034,YCpaFH59BZea33ilZmurVIrcGKs7kkSW,SpATywNh6bZuzm8s1ceuBUnMUAeoAHHw,1,0,0,0,0,0,1,0,1,0.14285714285714285,1,0.0,0,0,0,0,0,0,0,1,0,0,1,1
5529,90041,JaLvdj0QPGLA6QlwJ3N2oF66NiYZ7XSV,bWdj2GDclj5ofokWjzoa5jAwMkxCykd6,39,68,38,86,17,114,23,5,351,50.142857142857146,5,0.0,7,38,71,17,61,114,15,23,5,133,218,0
5530,90047,b31D3oEzHUylsy39VKOzq1naz39PNLwH,G8EPVSXsOYB5YQWZGiz1aVq5Pgr2GrQu,41,58,25,54,8,3,23,1,172,24.571428571428573,3,0.0,21,25,34,8,37,3,20,23,1,88,84,1
5531,90052,ggntZRuHqDckUtFC9TYtfF8K09iXYWES,SpATywNh6bZuzm8s1ceuBUnMUAeoAHHw,5,3,0,0,0,0,6,0,9,1.2857142857142858,2,0.0,0,0,0,0,3,0,0,6,0,0,9,1
5532,90055,kGkU7DU5zOC0IQHNRlo6r0rouCnUfi6R,RXDvfPUBYFlVdlueBFbLW0mhhAyGEqpt,22,25,13,17,8,3,14,1,81,11.571428571428571,2,0.0,5,13,16,8,20,3,1,14,1,42,39,1
5533,90063,Vn131dD12fh0kapodbBhio0q4dV4IYmG,bWdj2GDclj5ofokWjzoa5jAwMkxCykd6,4,2,1,0,1,0,1,0,5,0.7142857142857143,1,0.0,0,1,0,1,2,0,0,1,0,2,3,1
5534,90067,6e1wovvtDhnhxwqREzmRRei4eIEEGraW,bWdj2GDclj5ofokWjzoa5jAwMkxCykd6,8,6,4,0,3,0,7,1,21,3.0,1,0.0,0,4,0,3,6,0,0,7,1,7,14,1
5535,90076,QhIEGvYTYkDhEyimLONTXmJHONpcq43g,SpATywNh6bZuzm8s1ceuBUnMUAeoAHHw,1,0,0,0,0,0,1,0,1,0.14285714285714285,1,0.0,0,0,0,0,0,0,0,1,0,0,1,1
5536,90085,JYzVKgw0yfgKYwKodhquOfGRUiHh1739,SpATywNh6bZuzm8s1ceuBUnMUAeoAHHw,4,2,0,0,0,0,2,0,4,0.5714285714285714,1,0.0,0,0,0,0,2,0,0,2,0,0,4,1
5537,90087,6Xt9XL14E8rzUiRHbQmDyc0T0uWOhD5k,SpATywNh6bZuzm8s1ceuBUnMUAeoAHHw,5,4,1,0,1,0,2,0,8,1.1428571428571428,1,0.0,0,1,0,1,4,0,0,2,0,2,6,1
5538,90088,lzm9dP9Q32i0nrdz5KGk9vngMJk6H38J,SpATywNh6bZuzm8s1ceuBUnMUAeoAHHw,7,9,3,0,2,0,5,0,19,2.7142857142857144,2,0.0,1,3,0,2,8,0,0,5,0,6,13,1
5539,90090,srF76iHf3IXwkM0p0daLjk1LYx1sO9QO,bWdj2GDclj5ofokWjzoa5jAwMkxCykd6,1,0,0,0,0,0,1,0,1,0.14285714285714285,1,0.0,0,0,0,0,0,0,0,1,0,0,1,1
5540,90094,TYu8VgV6TkJO1pWVABdfXnpa6VWQUK0O,RXDvfPUBYFlVdlueBFbLW0mhhAyGEqpt,20,13,9,27,5,0,3,0,57,8.142857142857142,2,0.0,2,9,27,5,11,0,0,3,0,43,14,1
5541,90097,ilWzYGLWBh9DSc1MV8g2C4Go5wDNgUHX,bWdj2GDclj5ofokWjzoa5jAwMkxCykd6,8,4,2,6,1,7,2,0,22,3.142857142857143,1,0.0,1,2,6,1,3,7,0,2,0,10,12,1
5542,90103,faywX8b5OPf8lgTBqNfgsgut6a2kmqN4,SpATywNh6bZuzm8s1ceuBUnMUAeoAHHw,6,3,2,0,2,0,1,0,8,1.1428571428571428,1,0.0,0,2,0,2,3,0,0,1,0,4,4,1
5543,90117,MjWnBfKyq3bKCwHG0ZVIL5hXZR3ku4f4,SpATywNh6bZuzm8s1ceuBUnMUAeoAHHw,12,8,5,0,3,0,8,1,25,3.5714285714285716,1,0.0,0,5,0,3,8,0,0,8,1,8,17,1
5544,90120,jDBqOswp4ojFI0uystVaz1714DhGWBFe,SpATywNh6bZuzm8s1ceuBUnMUAeoAHHw,6,4,3,0,2,0,2,2,13,1.8571428571428572,1,0.0,0,3,0,2,4,0,0,2,2,5,8,1
5545,90131,bTJkfLPF7pQ1o12jyPBjkkHpxb8ACgm5,bWdj2GDclj5ofokWjzoa5jAwMkxCykd6,1,0,0,0,0,0,1,0,1,0.14285714285714285,1,0.0,0,0,0,0,0,0,0,1,0,0,1,1
5546,90135,bTJkfLPF7pQ1o12jyPBjkkHpxb8ACgm5,SpATywNh6bZuzm8s1ceuBUnMUAeoAHHw,4,2,1,0,1,0,1,0,5,0.7142857142857143,1,0.0,0,1,0,1,2,0,0,1,0,2,3,1
5547,90136,bMIS6W7sngWZiZpkuSg6XOmdfsq88CgB,bWdj2GDclj5ofokWjzoa5jAwMkxCykd6,9,13,6,126,7,0,2,0,154,22.0,1,0.0,6,6,125,7,7,0,1,2,0,144,10,1
5548,90138,Eg9TEdaEeaxICrLXGeMPzp6XOtJtw2iA,SpATywNh6bZuzm8s1ceuBUnMUAeoAHHw,6,1,1,0,1,0,5,0,8,1.1428571428571428,1,0.0,0,1,0,1,1,0,0,5,0,2,6,1
5549,90139,6ev6a6dpwen0GstMqDij5DO55YCNj8wV,SpATywNh6bZuzm8s1ceuBUnMUAeoAHHw,10,10,5,0,3,7,8,1,34,4.857142857142857,1,0.0,0,5,0,3,10,7,0,8,1,8,26,1
5550,90155,U7btMcQ825kheRskgLUndnBUWWFj60BC,G8EPVSXsOYB5YQWZGiz1aVq5Pgr2GrQu,2,0,0,0,0,0,3,0,3,0.42857142857142855,1,0.0,0,0,0,0,0,0,0,3,0,0,3,1
5551,90160,Q7rqeL75J4PJeAuNXiXhCR5dry9rPsv1,G8EPVSXsOYB5YQWZGiz1aVq5Pgr2GrQu,14,24,9,4,8,1,7,1,54,7.714285714285714,1,0.0,13,9,3,8,11,1,1,7,1,33,21,1
5552,90172,ktsGX0WguDDY6I5ilK51sxzTMtoxdwY2,G8EPVSXsOYB5YQWZGiz1aVq5Pgr2GrQu,5,2,1,0,1,0,4,0,8,1.1428571428571428,2,0.0,0,1,0,1,2,0,0,4,0,2,6,1
5553,90176,TM0zAsul1XLjJRFtspexc3sccxHTiW3v,SpATywNh6bZuzm8s1ceuBUnMUAeoAHHw,2,0,0,0,0,0,2,0,2,0.2857142857142857,1,0.0,0,0,0,0,0,0,0,2,0,0,2,0
5554,90177,ihuUuFaDeVBULP8Ogmzz18gVO9cBzlOD,RXDvfPUBYFlVdlueBFbLW0mhhAyGEqpt,3,0,0,0,0,2,2,0,4,0.5714285714285714,1,0.0,0,0,0,0,0,2,0,2,0,0,4,1
5555,90180,7ibtd0r1yxMhjpaNZCtEirkOcSqUBCGN,RXDvfPUBYFlVdlueBFbLW0mhhAyGEqpt,13,11,5,14,5,0,1,0,36,5.142857142857143,1,0.0,5,5,12,5,6,0,2,1,0,27,9,0
5556,90183,SYRx2sSX9LDLLUNNibf5r7JJQePy5BRh,G8EPVSXsOYB5YQWZGiz1aVq5Pgr2GrQu,27,47,2,48,0,1,12,1,111,15.857142857142858,2,0.0,19,2,35,0,28,1,13,12,1,56,55,1
5557,90184,7zAZJQJmdmR0Q9agHk9B0faabzdMeTDx,G8EPVSXsOYB5YQWZGiz1aVq5Pgr2GrQu,4,5,2,0,2,0,1,0,10,1.4285714285714286,1,0.0,2,2,0,2,3,0,0,1,0,6,4,1
5558,90189,64SFa5QYw3OYdZffw8ZxPKmPdz675qex,G8EPVSXsOYB5YQWZGiz1aVq5Pgr2GrQu,6,3,2,0,2,0,1,0,8,1.1428571428571428,1,0.0,0,2,0,2,3,0,0,1,0,4,4,1
5559,90192,uybm0Sdpts5PrhQW2nyBVnFfiT9zAmh4,G8EPVSXsOYB5YQWZGiz1aVq5Pgr2GrQu,8,9,1,8,1,0,3,0,22,3.142857142857143,1,0.0,2,1,6,1,7,0,2,3,0,10,12,0
5560,90199,loDNGhsCc1OXWM5CF3rme5wzdyMcOTJj,RXDvfPUBYFlVdlueBFbLW0mhhAyGEqpt,26,19,9,0,7,1,9,4,49,7.0,2,0.0,1,9,0,7,18,1,0,9,4,17,32,1
5561,90214,LfZmAYW4GITnFlauWgCvKzPoi1bCqPgK,bWdj2GDclj5ofokWjzoa5jAwMkxCykd6,12,13,4,4,5,0,6,0,32,4.571428571428571,2,0.0,4,4,4,5,9,0,0,6,0,17,15,1
5562,90215,GxfzvZIYYQ6Ai51iUnspJ06bhY10jacX,SpATywNh6bZuzm8s1ceuBUnMUAeoAHHw,17,20,9,18,5,0,8,1,61,8.714285714285714,2,0.0,3,9,15,5,17,0,3,8,1,32,29,1
5563,90219,feANl8pQvsJtkNIIOWO1qX8ND4VT9Cj4,G8EPVSXsOYB5YQWZGiz1aVq5Pgr2GrQu,4,2,1,0,1,0,1,0,5,0.7142857142857143,1,0.0,0,1,0,1,2,0,0,1,0,2,3,1
5564,90223,LRnQOt7NsdMcAvm0GOPse3zkFSQ0mVYI,SpATywNh6bZuzm8s1ceuBUnMUAeoAHHw,5,2,1,0,1,0,2,0,6,0.8571428571428571,1,0.0,0,1,0,1,2,0,0,2,0,2,4,1
5565,90224,S0OJjF6aof0iTnIX6lUAxekoH3m4w7V0,RXDvfPUBYFlVdlueBFbLW0mhhAyGEqpt,18,13,10,29,7,0,1,0,60,8.571428571428571,1,0.0,2,10,23,7,11,0,6,1,0,42,18,1
5566,90233,mXvtIKY9ZnAQyKjdLyySIxbvTtoP8Weq,G8EPVSXsOYB5YQWZGiz1aVq5Pgr2GrQu,5,2,1,0,1,0,3,0,7,1.0,1,0.0,0,1,0,1,2,0,0,3,0,2,5,1
5567,90235,pONYaLTf3U8GoaNpbS0j1PZ1GhOmkS7N,SpATywNh6bZuzm8s1ceuBUnMUAeoAHHw,14,17,6,14,4,1,3,0,45,6.428571428571429,1,0.0,10,6,14,4,7,1,0,3,0,34,11,1
5568,90244,DU0dRtEpZksA4ySXAez5UVn9g5rHoTAA,SpATywNh6bZuzm8s1ceuBUnMUAeoAHHw,8,22,11,0,3,0,3,0,39,5.571428571428571,2,0.0,8,11,0,3,14,0,0,3,0,22,17,1
5569,90248,b0xM3piMaIC7gCFYyxqHoITel9oKF6YW,bWdj2GDclj5ofokWjzoa5jAwMkxCykd6,9,5,1,26,1,2,4,1,40,5.714285714285714,1,0.0,2,1,25,1,3,2,1,4,1,29,11,1
5570,90249,RDTdhSHGbxVSFCWLWYH4XRafyz4IOkLm,SpATywNh6bZuzm8s1ceuBUnMUAeoAHHw,7,6,2,0,1,1,4,0,14,2.0,2,0.0,0,2,0,1,6,1,0,4,0,3,11,1
5571,90250,Cb5KBNxKLciN7IuFLNM0hPSrkcjzkoDX,SpATywNh6bZuzm8s1ceuBUnMUAeoAHHw,7,2,1,0,1,0,3,0,7,1.0,1,0.0,0,1,0,1,2,0,0,3,0,2,5,1
5572,90251,GMTEjCyWbqfKfP4EXN5ReJJtqfdXmmTA,RXDvfPUBYFlVdlueBFbLW0mhhAyGEqpt,2,0,0,0,0,0,2,0,2,0.2857142857142857,1,0.0,0,0,0,0,0,0,0,2,0,0,2,1
5573,90253,5a7fehAo0Ol3kwHzhNqAYRGEzPLIE5FD,bWdj2GDclj5ofokWjzoa5jAwMkxCykd6,6,9,5,0,1,0,7,0,22,3.142857142857143,3,0.0,0,5,0,1,9,0,0,7,0,6,16,1
5574,90256,JHLmQKNX4G6HmeBY0Psd6kgnv0WEcPsm,SpATywNh6bZuzm8s1ceuBUnMUAeoAHHw,7,4,1,0,1,0,6,0,12,1.7142857142857142,1,0.0,0,1,0,1,4,0,0,6,0,2,10,1
5575,90258,tQrXZ3EDIEf1hKQdGJOaurgPvqncjvEA,bWdj2GDclj5ofokWjzoa5jAwMkxCykd6,3,2,0,0,0,0,2,0,4,0.5714285714285714,1,0.0,0,0,0,0,2,0,0,2,0,0,4,1
5576,90260,zykAfhTnSrdYpElmeo66SyCzw5nw6JVn,bWdj2GDclj5ofokWjzoa5jAwMkxCykd6,7,12,7,0,3,0,6,0,28,4.0,1,0.0,0,7,0,3,12,0,0,6,0,10,18,1
5577,90263,QmJXKs57BF6o936ZGaQIMEt20JYrSdAW,G8EPVSXsOYB5YQWZGiz1aVq5Pgr2GrQu,4,27,1,4,2,0,1,0,35,5.0,1,0.0,23,1,3,2,4,0,1,1,0,29,6,1
5578,90266,n0HFF3TwqKuBMzzkdLCbvb8Mji5ZUnVX,SpATywNh6bZuzm8s1ceuBUnMUAeoAHHw,7,9,6,0,4,0,3,0,22,3.142857142857143,3,0.0,0,6,0,4,9,0,0,3,0,10,12,1
5579,90270,521YJDVy6G9ul5QyLTUZAuztPLpe7gqW,G8EPVSXsOYB5YQWZGiz1aVq5Pgr2GrQu,11,14,4,0,2,1,10,1,32,4.571428571428571,1,0.0,2,4,0,2,12,1,0,10,1,8,24,1
5580,90272,s41hWh3vMIIfQQVEuM6UwEzfhfcM1JZA,SpATywNh6bZuzm8s1ceuBUnMUAeoAHHw,5,2,1,0,1,0,2,0,6,0.8571428571428571,1,0.0,0,1,0,1,2,0,0,2,0,2,4,1
5581,90278,bweLZE6WiefKMb8vrgzlIS50q4xPrbd3,G8EPVSXsOYB5YQWZGiz1aVq5Pgr2GrQu,8,8,2,2,2,0,2,0,16,2.2857142857142856,2,0.0,3,2,2,2,5,0,0,2,0,9,7,1
5582,90279,Ewm3oAfqxDgJQMFbDpAkGPAjCut5zQSX,SpATywNh6bZuzm8s1ceuBUnMUAeoAHHw,1,0,0,0,0,0,1,0,1,0.14285714285714285,1,0.0,0,0,0,0,0,0,0,1,0,0,1,1
5583,90280,jwRuJMKgg5MQLF9v6u6v92ntnY2avB7X,SpATywNh6bZuzm8s1ceuBUnMUAeoAHHw,7,3,2,0,2,0,4,0,11,1.5714285714285714,1,0.0,0,2,0,2,3,0,0,4,0,4,7,1
5584,90285,v4laioBlEPXkN50wQCoVv0p0aRfPHa4S,G8EPVSXsOYB5YQWZGiz1aVq5Pgr2GrQu,1,0,0,0,0,0,1,0,1,0.14285714285714285,1,0.0,0,0,0,0,0,0,0,1,0,0,1,1
5585,90286,0nJUVE3hT3v1fqbd9NpHDszm9KS6NNTn,G8EPVSXsOYB5YQWZGiz1aVq5Pgr2GrQu,6,1,1,0,1,0,3,0,6,0.8571428571428571,1,0.0,0,1,0,1,1,0,0,3,0,2,4,1
5586,90289,n5gAmeJZl36AzaSKV2dfNY3RvYF0IYqr,SpATywNh6bZuzm8s1ceuBUnMUAeoAHHw,5,3,1,0,1,0,2,0,7,1.0,1,0.0,1,1,0,1,2,0,0,2,0,3,4,1
5587,90290,264OEiaYNcFYG5J7N6NDOp3G0CBJqdMF,SpATywNh6bZuzm8s1ceuBUnMUAeoAHHw,2,0,0,0,0,0,3,0,3,0.42857142857142855,1,0.0,0,0,0,0,0,0,0,3,0,0,3,1
5588,90294,juZ453F4cmwgObiaW1ClMKkoi0EGrafR,G8EPVSXsOYB5YQWZGiz1aVq5Pgr2GrQu,4,2,0,0,0,1,2,0,5,0.7142857142857143,1,0.0,0,0,0,0,2,1,0,2,0,0,5,1
5589,90305,Sy1NUS22p5IcvKggpod61sUWNUSyXtbs,G8EPVSXsOYB5YQWZGiz1aVq5Pgr2GrQu,19,29,11,0,8,0,7,0,55,7.857142857142857,4,0.0,8,11,0,8,21,0,0,7,0,27,28,0
5590,90306,cwnwk7sVo9oHpSkUPDdu8wUE4KBTJLBj,bWdj2GDclj5ofokWjzoa5jAwMkxCykd6,1,0,0,0,0,0,1,0,1,0.14285714285714285,1,0.0,0,0,0,0,0,0,0,1,0,0,1,1
5591,90321,NlgFEWO87VQbCzq3S6FQjH7bzvdUhuql,RXDvfPUBYFlVdlueBFbLW0mhhAyGEqpt,1,0,0,0,0,0,1,0,1,0.14285714285714285,1,0.0,0,0,0,0,0,0,0,1,0,0,1,1
5592,90326,J1iCM60eAwVKTPRoP9hdyFlEQf6db3YF,SpATywNh6bZuzm8s1ceuBUnMUAeoAHHw,13,10,6,6,4,4,3,0,33,4.714285714285714,1,0.0,2,6,6,4,8,4,0,3,0,18,15,1
5593,90337,AImQCDhN4bmgLgB3jm3FHzAq0G1rwIiv,SpATywNh6bZuzm8s1ceuBUnMUAeoAHHw,5,2,1,0,1,0,2,0,6,0.8571428571428571,1,0.0,0,1,0,1,2,0,0,2,0,2,4,1
5594,90343,jl79Z6TfXd4YLzsAQwSCeo1eMaF6Ha8d,bWdj2GDclj5ofokWjzoa5jAwMkxCykd6,13,14,1,0,2,11,19,4,51,7.285714285714286,2,0.0,2,1,0,2,12,11,0,19,4,5,46,1
5595,90348,VDscv2ylkQ5hVjxSl7FzkFmJDmBcIaMr,bWdj2GDclj5ofokWjzoa5jAwMkxCykd6,11,8,3,18,1,0,14,1,45,6.428571428571429,4,0.0,1,3,18,1,7,0,0,14,1,23,22,1
5596,90349,F6I7OSqjE137AeaYIX9MEazl6a7Noplf,SpATywNh6bZuzm8s1ceuBUnMUAeoAHHw,7,4,0,0,0,0,4,0,8,1.1428571428571428,1,0.0,0,0,0,0,4,0,0,4,0,0,8,1
5597,90351,vSAp2k0hR5TAgTxUO6r2EVSaLCqePHP4,SpATywNh6bZuzm8s1ceuBUnMUAeoAHHw,4,2,1,0,1,0,1,0,5,0.7142857142857143,1,0.0,0,1,0,1,2,0,0,1,0,2,3,1
5598,90354,x3sZblYMoUvQJbk7l9GY688n7RQqaQct,bWdj2GDclj5ofokWjzoa5jAwMkxCykd6,5,5,1,0,1,0,2,0,9,1.2857142857142858,1,0.0,0,1,0,1,5,0,0,2,0,2,7,1
5599,90355,D7Evkt9LkM9awqCB4mL7Tk75xiGKRcNK,RXDvfPUBYFlVdlueBFbLW0mhhAyGEqpt,1,0,0,0,0,0,1,0,1,0.14285714285714285,1,0.0,0,0,0,0,0,0,0,1,0,0,1,1
5600,90356,ublyxWXAJoR0ltzxB8gmTQ7Y4SFlWnZM,G8EPVSXsOYB5YQWZGiz1aVq5Pgr2GrQu,10,23,0,6,1,0,5,1,36,5.142857142857143,2,0.0,14,0,5,1,9,0,1,5,1,20,16,1
5601,90358,JnnoDII6jIRoAG8myf8F5d0DS0vEB9se,bWdj2GDclj5ofokWjzoa5jAwMkxCykd6,3,0,0,0,0,4,2,0,6,0.8571428571428571,1,0.0,0,0,0,0,0,4,0,2,0,0,6,1
5602,90359,6ryFJ2ZF3YGC7hqGJv2IswdyAnxH8nhB,G8EPVSXsOYB5YQWZGiz1aVq5Pgr2GrQu,5,2,1,0,1,0,7,0,11,1.5714285714285714,1,0.0,0,1,0,1,2,0,0,7,0,2,9,1
5603,90369,BBJ3vKTyvStRa10Tpfc6k0oOhgY721Pq,bWdj2GDclj5ofokWjzoa5jAwMkxCykd6,7,5,3,0,2,0,5,1,16,2.2857142857142856,1,0.0,0,3,0,2,5,0,0,5,1,5,11,1
5604,90372,4GMbKnTV7f2uA3paM09GNAdyVnypDTbs,RXDvfPUBYFlVdlueBFbLW0mhhAyGEqpt,8,2,2,0,2,0,8,0,14,2.0,1,0.0,0,2,0,2,2,0,0,8,0,4,10,1
5605,90374,FGJeYJZQGTs7gi3lnr6EovN6yJTo7ibM,G8EPVSXsOYB5YQWZGiz1aVq5Pgr2GrQu,20,8,6,22,3,1,7,1,48,6.857142857142857,1,0.0,0,6,17,3,8,1,5,7,1,26,22,1
5606,90376,BBJ3vKTyvStRa10Tpfc6k0oOhgY721Pq,RXDvfPUBYFlVdlueBFbLW0mhhAyGEqpt,1,0,0,0,0,0,1,0,1,0.14285714285714285,1,0.0,0,0,0,0,0,0,0,1,0,0,1,1
5607,90377,2sT7ojsC1w02fAwhcaRLBrXcss5IOsOK,bWdj2GDclj5ofokWjzoa5jAwMkxCykd6,5,2,1,0,1,0,2,0,6,0.8571428571428571,1,0.0,0,1,0,1,2,0,0,2,0,2,4,1
5608,90381,JnnoDII6jIRoAG8myf8F5d0DS0vEB9se,RXDvfPUBYFlVdlueBFbLW0mhhAyGEqpt,1,0,0,0,0,0,1,0,1,0.14285714285714285,1,0.0,0,0,0,0,0,0,0,1,0,0,1,1
5609,90382,JnnoDII6jIRoAG8myf8F5d0DS0vEB9se,G8EPVSXsOYB5YQWZGiz1aVq5Pgr2GrQu,1,0,0,0,0,0,1,0,1,0.14285714285714285,1,0.0,0,0,0,0,0,0,0,1,0,0,1,1
5610,90389,UdVAw5urwjLmc9uIJ3uWZ6MzY9bq82FD,bWdj2GDclj5ofokWjzoa5jAwMkxCykd6,5,11,1,18,0,5,1,0,36,5.142857142857143,1,0.0,6,1,16,0,5,5,2,1,0,23,13,1
5611,90391,wyK0UoS83lDT8utSJzcLSlSEzOTr7cFo,SpATywNh6bZuzm8s1ceuBUnMUAeoAHHw,4,0,0,0,0,0,4,0,4,0.5714285714285714,1,0.0,0,0,0,0,0,0,0,4,0,0,4,1
5612,90399,Gq0WW1vBA55n1msrepMKrg3TKn8N6yfT,bWdj2GDclj5ofokWjzoa5jAwMkxCykd6,16,21,1,48,2,0,6,0,78,11.142857142857142,2,0.0,10,1,47,2,11,0,1,6,0,60,18,1
5613,90404,5o9h0u1MdREnKa1ru9UVL61wcNO9zJkv,bWdj2GDclj5ofokWjzoa5jAwMkxCykd6,6,15,3,0,1,0,9,0,28,4.0,1,0.0,0,3,0,1,15,0,0,9,0,4,24,1
5614,90408,C6mvlVLzmlNXh4kv8CeERDr2P2W5lqpV,SpATywNh6bZuzm8s1ceuBUnMUAeoAHHw,7,2,0,0,0,2,7,1,12,1.7142857142857142,1,0.0,0,0,0,0,2,2,0,7,1,0,12,1
5615,90416,4tsGZRMByIyec9WCveltaBAT6TVvi6KF,RXDvfPUBYFlVdlueBFbLW0mhhAyGEqpt,9,6,2,26,3,0,1,0,38,5.428571428571429,1,0.0,2,2,20,3,4,0,6,1,0,27,11,1
5616,90418,fBvSAwv6uc40UeqRCaejhOfI13E4tjda,SpATywNh6bZuzm8s1ceuBUnMUAeoAHHw,6,8,3,0,1,0,2,0,14,2.0,1,0.0,3,3,0,1,5,0,0,2,0,7,7,1
5617,90422,rwjIOQWge6ogv55EFnUadvoZ473wCxPF,SpATywNh6bZuzm8s1ceuBUnMUAeoAHHw,2,0,0,0,0,0,3,0,3,0.42857142857142855,1,0.0,0,0,0,0,0,0,0,3,0,0,3,1
5618,90425,lcgsmC4BQDYDnzCO5vs1TCdTPnBbRaGt,SpATywNh6bZuzm8s1ceuBUnMUAeoAHHw,13,31,0,22,0,9,10,2,74,10.571428571428571,1,0.0,10,0,18,0,21,9,4,10,2,28,46,1
5619,90429,NnJUzVJQXS15uc1WVncpFgpFT3Jtm38y,bWdj2GDclj5ofokWjzoa5jAwMkxCykd6,4,2,1,0,1,0,1,0,5,0.7142857142857143,1,0.0,0,1,0,1,2,0,0,1,0,2,3,1
5620,90432,PCdtFg5aq768xRAGHCfQQy2MLmWOvvld,bWdj2GDclj5ofokWjzoa5jAwMkxCykd6,5,5,3,0,0,0,3,0,11,1.5714285714285714,2,0.0,0,3,0,0,5,0,0,3,0,3,8,1
5621,90435,ohlMhSWqKWmqC7u03UQO1YoFekI6xVAy,RXDvfPUBYFlVdlueBFbLW0mhhAyGEqpt,9,4,1,0,1,2,11,1,20,2.857142857142857,1,0.0,0,1,0,1,4,2,0,11,1,2,18,1
5622,90445,NvpLHMRFxJk2eR30iYl189WOkyZeEnSd,RXDvfPUBYFlVdlueBFbLW0mhhAyGEqpt,4,3,0,0,0,0,1,0,4,0.5714285714285714,1,0.0,0,0,0,0,3,0,0,1,0,0,4,1
5623,90446,FcIMQNoo2B9wNij30W0t3SsuF1pzZCFp,G8EPVSXsOYB5YQWZGiz1aVq5Pgr2GrQu,6,2,1,0,0,0,6,0,9,1.2857142857142858,1,0.0,0,1,0,0,2,0,0,6,0,1,8,1
5624,90448,8spZJm18FAAt0jkb5fLlQ7lVR80rIhqU,SpATywNh6bZuzm8s1ceuBUnMUAeoAHHw,9,8,2,0,1,4,13,3,31,4.428571428571429,2,0.0,0,2,0,1,8,4,0,13,3,3,28,1
5625,90449,MoVymwbcHW0CbhTCwXgAq4UFuaXFCEM8,SpATywNh6bZuzm8s1ceuBUnMUAeoAHHw,5,3,0,0,0,0,2,0,5,0.7142857142857143,1,0.0,0,0,0,0,3,0,0,2,0,0,5,1
5626,90450,K0GvqkFX0mEPCK9WbHThj3iwTwuWgCZz,G8EPVSXsOYB5YQWZGiz1aVq5Pgr2GrQu,83,118,49,230,6,19,18,2,442,63.142857142857146,1,0.0,55,49,171,6,63,19,59,18,2,281,161,1
5627,90451,gbhKUd7BJXTZpVcoQvBpKT3bqB9VoWlp,SpATywNh6bZuzm8s1ceuBUnMUAeoAHHw,4,2,1,0,1,0,1,0,5,0.7142857142857143,1,0.0,0,1,0,1,2,0,0,1,0,2,3,1
5628,90455,loPn0Qajy87SoektWTbVxEkxp7hmTtzk,SpATywNh6bZuzm8s1ceuBUnMUAeoAHHw,1,0,0,0,0,0,1,0,1,0.14285714285714285,1,0.0,0,0,0,0,0,0,0,1,0,0,1,1
5629,90456,ejWSFSNW1jOTCFDROUQkAUS6uY6mX6CR,bWdj2GDclj5ofokWjzoa5jAwMkxCykd6,4,2,1,0,1,0,1,0,5,0.7142857142857143,1,0.0,0,1,0,1,2,0,0,1,0,2,3,1
5630,90468,D0SRTJhzsGGnKbIKtAcGeOVG46CDAXxq,bWdj2GDclj5ofokWjzoa5jAwMkxCykd6,6,11,6,0,3,0,5,0,25,3.5714285714285716,2,0.0,0,6,0,3,11,0,0,5,0,9,16,1
5631,90469,3v3FB5XsF44WUQOyhVB1K7TjhxipIjnJ,bWdj2GDclj5ofokWjzoa5jAwMkxCykd6,1,0,0,0,0,0,1,0,1,0.14285714285714285,1,0.0,0,0,0,0,0,0,0,1,0,0,1,1
5632,90471,AcoYRXM9MxEJpHYoq7SsbSwZ8unsRtq3,SpATywNh6bZuzm8s1ceuBUnMUAeoAHHw,6,3,1,0,1,0,2,0,7,1.0,1,0.0,0,1,0,1,3,0,0,2,0,2,5,0
5633,90474,AMP1VomhrLvq0oxaLMgCzayTJQ1U3Z03,SpATywNh6bZuzm8s1ceuBUnMUAeoAHHw,8,8,2,0,0,0,10,1,21,3.0,1,0.0,0,2,0,0,8,0,0,10,1,2,19,1
5634,90479,09hA70zHHsdFY99KewQn0t7W1Th1KuA4,RXDvfPUBYFlVdlueBFbLW0mhhAyGEqpt,21,15,10,22,9,2,8,14,80,11.428571428571429,1,0.0,5,10,18,9,10,2,4,8,14,42,38,1
5635,90480,jJhM7dfbmyu6QnNvOuNIHUQvXzylS9kq,bWdj2GDclj5ofokWjzoa5jAwMkxCykd6,1,0,0,0,0,0,1,0,1,0.14285714285714285,1,0.0,0,0,0,0,0,0,0,1,0,0,1,1
5636,90482,LfSoKi26BKEYZHPv7eOdEODBvG4bpVnt,SpATywNh6bZuzm8s1ceuBUnMUAeoAHHw,11,8,5,0,3,0,7,0,23,3.2857142857142856,2,0.0,0,5,0,3,8,0,0,7,0,8,15,1
5637,90486,4eRAU6q1j8xj2oZfSvPOcocekaK18w9w,RXDvfPUBYFlVdlueBFbLW0mhhAyGEqpt,16,21,3,0,0,2,11,1,38,5.428571428571429,1,0.0,2,3,0,0,19,2,0,11,1,5,33,1
5638,90487,swTV8FwIOGPvq6kDLTbN7KErbstwahnB,RXDvfPUBYFlVdlueBFbLW0mhhAyGEqpt,5,3,2,0,1,0,2,0,8,1.1428571428571428,1,0.0,0,2,0,1,3,0,0,2,0,3,5,1
5639,90491,0Gw9qsZWrsuN96zAJXr0m2eOAANOJE07,SpATywNh6bZuzm8s1ceuBUnMUAeoAHHw,1,0,0,0,0,0,1,0,1,0.14285714285714285,1,0.0,0,0,0,0,0,0,0,1,0,0,1,1
5640,90493,3yfQbyJ9pf1yrEL1gur3tzr8XAtUzfm8,bWdj2GDclj5ofokWjzoa5jAwMkxCykd6,4,2,0,0,0,0,2,0,4,0.5714285714285714,1,0.0,0,0,0,0,2,0,0,2,0,0,4,1
5641,90494,r3ymEDBeAtjd52LKkH7rXxWW6cBfLEDa,bWdj2GDclj5ofokWjzoa5jAwMkxCykd6,10,9,4,0,4,0,6,0,23,3.2857142857142856,1,0.0,2,4,0,4,7,0,0,6,0,10,13,1
5642,90495,IV2jyEJwnx9XuvLUnJBPSDEiQEmkULrq,SpATywNh6bZuzm8s1ceuBUnMUAeoAHHw,13,25,3,17,1,0,8,0,54,7.714285714285714,1,0.0,11,3,15,1,14,0,2,8,0,30,24,1
5643,90504,3uY3PXIjE4xYhALzqv9EDJ3LJju3f4Jc,SpATywNh6bZuzm8s1ceuBUnMUAeoAHHw,7,4,2,0,2,0,2,0,10,1.4285714285714286,1,0.0,0,2,0,2,4,0,0,2,0,4,6,1
5644,90513,rW9Fl0YODiCSMxzLAOKlzYxXd8TfgDcd,RXDvfPUBYFlVdlueBFbLW0mhhAyGEqpt,4,5,2,0,0,0,1,0,8,1.1428571428571428,1,0.0,0,2,0,0,5,0,0,1,0,2,6,1
5645,90518,9D8Fr85Y0xJSTSvXENunTRQkQQzpKKhe,RXDvfPUBYFlVdlueBFbLW0mhhAyGEqpt,41,32,22,48,10,24,7,0,143,20.428571428571427,1,0.0,7,22,46,10,25,24,2,7,0,85,58,1
5646,90519,Xs5JYGOD3p8qnunCvDbRtmUT4YrLSZAt,SpATywNh6bZuzm8s1ceuBUnMUAeoAHHw,5,1,1,0,1,0,2,0,5,0.7142857142857143,1,0.0,0,1,0,1,1,0,0,2,0,2,3,1
5647,90520,JoruyAOmEeM1qjcSEWRUjLvQUHpNPZGp,bWdj2GDclj5ofokWjzoa5jAwMkxCykd6,1,0,0,0,0,0,1,0,1,0.14285714285714285,1,0.0,0,0,0,0,0,0,0,1,0,0,1,1
5648,90523,3CsUz8mRFoFNKmkeENo8HuDQSH05lxmZ,SpATywNh6bZuzm8s1ceuBUnMUAeoAHHw,11,23,0,16,0,3,9,0,51,7.285714285714286,1,0.0,9,0,13,0,14,3,3,9,0,22,29,1
5649,90524,LowLlbmaDUppvngMtOhXYfyftobUC8Pz,SpATywNh6bZuzm8s1ceuBUnMUAeoAHHw,10,6,3,0,2,1,7,1,20,2.857142857142857,1,0.0,1,3,0,2,5,1,0,7,1,6,14,1
5650,90526,w2OxtzQI9blY6H8U919hOBWDDo1sEi62,SpATywNh6bZuzm8s1ceuBUnMUAeoAHHw,14,22,0,28,0,55,20,2,127,18.142857142857142,1,0.0,12,0,22,0,10,55,6,20,2,34,93,1
5651,90527,HtbY3zzP3Q7syMRtSIgdj2lkZgZynozO,bWdj2GDclj5ofokWjzoa5jAwMkxCykd6,8,13,0,24,1,27,7,0,72,10.285714285714286,1,0.0,5,0,22,1,8,27,2,7,0,28,44,1
5652,90528,3DMxdIMHShIiQg7VSSohBgQL1oCtuKe4,SpATywNh6bZuzm8s1ceuBUnMUAeoAHHw,4,3,1,0,1,0,0,0,5,0.7142857142857143,1,0.0,0,1,0,1,3,0,0,0,0,2,3,1
5653,90531,iEQKBpzbjZD62mKeYEyJG967oZGFzYX2,SpATywNh6bZuzm8s1ceuBUnMUAeoAHHw,1,0,0,0,0,0,1,0,1,0.14285714285714285,1,0.0,0,0,0,0,0,0,0,1,0,0,1,0
5654,90532,MBimBV1KD5WZIVxadl6ACFa9rEZi9InE,SpATywNh6bZuzm8s1ceuBUnMUAeoAHHw,6,2,1,0,1,0,4,0,8,1.1428571428571428,1,0.0,0,1,0,1,2,0,0,4,0,2,6,1
5655,90540,M8ZBCZwMuabH0ACZboTe8kVgLwQBa43E,bWdj2GDclj5ofokWjzoa5jAwMkxCykd6,7,5,2,0,2,1,5,1,16,2.2857142857142856,1,0.0,0,2,0,2,5,1,0,5,1,4,12,1
5656,90546,68BjCXfBFqeZ01fFx1csrFmvef5xs0w2,bWdj2GDclj5ofokWjzoa5jAwMkxCykd6,9,8,5,0,4,7,3,0,27,3.857142857142857,2,0.0,1,5,0,4,7,7,0,3,0,10,17,1
5657,90549,Z3cBuyK57dLpleXUvGj6emfcnGidOatN,SpATywNh6bZuzm8s1ceuBUnMUAeoAHHw,10,7,6,0,5,0,2,0,20,2.857142857142857,1,0.0,0,6,0,5,7,0,0,2,0,11,9,1
5658,90550,RNHJpl4xeeRwTYeul6H1SE3f8Bgn5J0c,SpATywNh6bZuzm8s1ceuBUnMUAeoAHHw,11,13,5,0,1,2,7,0,28,4.0,1,0.0,0,5,0,1,13,2,0,7,0,6,22,1
5659,90553,Urctwx56OvAe8Aa2Ler31rqDl5pjO2bG,G8EPVSXsOYB5YQWZGiz1aVq5Pgr2GrQu,20,10,2,24,1,9,16,1,63,9.0,2,0.0,3,2,18,1,7,9,6,16,1,24,39,1
5660,90560,QqAAFsY8kslizUQKd5uhHbFKpFbb6EW2,SpATywNh6bZuzm8s1ceuBUnMUAeoAHHw,28,43,17,32,6,15,8,1,122,17.428571428571427,2,0.0,12,17,29,6,31,15,3,8,1,64,58,0
5661,90564,gpn05NwMGqKm6lLZGRrnOmPlhHxlC7Wb,RXDvfPUBYFlVdlueBFbLW0mhhAyGEqpt,7,5,3,0,1,0,2,0,11,1.5714285714285714,1,0.0,0,3,0,1,5,0,0,2,0,4,7,1
5662,90569,vKmnCHrfJDutyArHoAT9SYM4ChEEDtjx,SpATywNh6bZuzm8s1ceuBUnMUAeoAHHw,3,5,0,0,0,0,1,0,6,0.8571428571428571,1,0.0,0,0,0,0,5,0,0,1,0,0,6,1
5663,90571,i6jKFDXXIDyjle2n9K5Y7L1CTASMdeNx,RXDvfPUBYFlVdlueBFbLW0mhhAyGEqpt,7,2,1,0,1,0,7,13,24,3.4285714285714284,1,0.0,0,1,0,1,2,0,0,7,13,2,22,0
5664,90572,T8mcyrbyEy4XKuvvM213HanZBW8dGO2d,G8EPVSXsOYB5YQWZGiz1aVq5Pgr2GrQu,7,5,1,0,1,0,1,0,8,1.1428571428571428,1,0.0,0,1,0,1,5,0,0,1,0,2,6,1
5665,90581,zH9I9L0RNBBTkWMoTXe4TRjHS1m1XHhV,G8EPVSXsOYB5YQWZGiz1aVq5Pgr2GrQu,10,22,3,12,5,0,3,0,45,6.428571428571429,2,0.0,17,3,9,5,5,0,3,3,0,34,11,1
5666,90583,bXejoPivba2ie50IiUpExTQGL9Tgmtcn,bWdj2GDclj5ofokWjzoa5jAwMkxCykd6,5,2,1,0,1,0,2,0,6,0.8571428571428571,1,0.0,0,1,0,1,2,0,0,2,0,2,4,1
5667,90589,eRKD4Ti4W635KvBhrrkbgHKvnvdw2Idz,SpATywNh6bZuzm8s1ceuBUnMUAeoAHHw,5,2,1,0,1,0,2,0,6,0.8571428571428571,1,0.0,0,1,0,1,2,0,0,2,0,2,4,1
5668,90590,jAHcjIKPY9dlDu300CKSWdNxocPzZC4f,G8EPVSXsOYB5YQWZGiz1aVq5Pgr2GrQu,10,10,4,4,2,0,2,0,22,3.142857142857143,2,0.0,3,4,3,2,7,0,1,2,0,12,10,1
5669,90592,kYIFQ3xM3QnRCvimArGnWBFWWaGJijmw,RXDvfPUBYFlVdlueBFbLW0mhhAyGEqpt,5,2,1,0,1,0,2,0,6,0.8571428571428571,1,0.0,0,1,0,1,2,0,0,2,0,2,4,1
5670,90597,DFFDn6kzjxm3QeQyKXF89GDFKDcalqmY,bWdj2GDclj5ofokWjzoa5jAwMkxCykd6,4,2,1,0,1,1,1,0,6,0.8571428571428571,1,0.0,0,1,0,1,2,1,0,1,0,2,4,1
5671,90611,1e3hDoCmipyCoPSCkvgArsY66kXMIOjQ,SpATywNh6bZuzm8s1ceuBUnMUAeoAHHw,8,11,3,0,2,1,6,1,24,3.4285714285714284,1,0.0,0,3,0,2,11,1,0,6,1,5,19,1
5672,90612,JqFx1dnEaecJfkuX3GZ1Q8Br4IpDeS68,SpATywNh6bZuzm8s1ceuBUnMUAeoAHHw,5,5,4,0,0,0,1,0,10,1.4285714285714286,1,0.0,0,4,0,0,5,0,0,1,0,4,6,1
5673,90620,7QseuWlQx7k5rV1TFF4oSS2exFRRLKz7,SpATywNh6bZuzm8s1ceuBUnMUAeoAHHw,11,4,2,0,2,1,8,1,18,2.5714285714285716,1,0.0,0,2,0,2,4,1,0,8,1,4,14,1
5674,90627,vDq8yiqHZiGZE0VPuzr41C23TWmY1JqS,SpATywNh6bZuzm8s1ceuBUnMUAeoAHHw,5,4,3,0,1,0,1,0,9,1.2857142857142858,1,0.0,0,3,0,1,4,0,0,1,0,4,5,1
5675,90632,5Dk7QJtqh7ATnN1jDaFE4dN4E1GugvAr,bWdj2GDclj5ofokWjzoa5jAwMkxCykd6,16,31,17,140,6,19,5,0,218,31.142857142857142,2,0.0,6,17,137,6,25,19,3,5,0,166,52,1
5676,90640,3YR1C1jI56LrsXJAUkFoM0M9MuhHAioI,SpATywNh6bZuzm8s1ceuBUnMUAeoAHHw,8,4,1,0,1,0,4,0,10,1.4285714285714286,1,0.0,2,1,0,1,2,0,0,4,0,4,6,1
5677,90643,LvpKAlZO7ziKr9qX3nIahz2mFKsUbwWI,SpATywNh6bZuzm8s1ceuBUnMUAeoAHHw,6,2,1,0,1,0,6,0,10,1.4285714285714286,3,0.0,0,1,0,1,2,0,0,6,0,2,8,1
5678,90647,ATFpemxOxaCS0pUz9OSp5dq4w85WuWvd,SpATywNh6bZuzm8s1ceuBUnMUAeoAHHw,13,22,0,18,0,0,8,2,50,7.142857142857143,1,0.0,6,0,17,0,16,0,1,8,2,23,27,1
5679,90649,CfeENerIdAGepleePWSt0SV88ctt0Tmw,RXDvfPUBYFlVdlueBFbLW0mhhAyGEqpt,1,0,0,0,0,0,1,0,1,0.14285714285714285,1,0.0,0,0,0,0,0,0,0,1,0,0,1,1
5680,90650,cvuy8HaLnRoF5suMAoOqjooUG2AEFLC2,bWdj2GDclj5ofokWjzoa5jAwMkxCykd6,4,2,1,0,1,0,2,0,6,0.8571428571428571,1,0.0,0,1,0,1,2,0,0,2,0,2,4,1
5681,90655,w0NwX9gVv58q1LwNFajcpOhqIprh7BvB,G8EPVSXsOYB5YQWZGiz1aVq5Pgr2GrQu,10,17,2,6,3,0,5,0,33,4.714285714285714,2,0.0,8,2,5,3,9,0,1,5,0,18,15,1
5682,90671,PwGj8ON4yrWpMaoZE0ES8sG2eAqFQNfN,SpATywNh6bZuzm8s1ceuBUnMUAeoAHHw,16,17,10,16,6,11,7,1,68,9.714285714285714,2,0.0,4,10,14,6,13,11,2,7,1,34,34,1
5683,90673,yDc9ZpbUycr11xuvu88deR54WnL37yET,SpATywNh6bZuzm8s1ceuBUnMUAeoAHHw,15,15,7,17,4,2,5,1,51,7.285714285714286,1,0.0,5,7,15,4,10,2,2,5,1,31,20,0
5684,90674,bLDIg7orV5sh30oIBmQ342IswZTJ8Q5l,RXDvfPUBYFlVdlueBFbLW0mhhAyGEqpt,9,11,6,0,4,0,3,0,24,3.4285714285714284,2,0.0,0,6,0,4,11,0,0,3,0,10,14,1
5685,90676,JrmmYCeYhJwPKrtI75WdL68kxmQcjGg8,SpATywNh6bZuzm8s1ceuBUnMUAeoAHHw,11,12,8,0,5,1,6,1,33,4.714285714285714,3,0.0,0,8,0,5,12,1,0,6,1,13,20,1
5686,90678,wQn1gyWkMsHmRn6FRBCpTkRxPyoDtHcK,G8EPVSXsOYB5YQWZGiz1aVq5Pgr2GrQu,5,13,0,0,1,0,4,0,18,2.5714285714285716,2,0.0,6,0,0,1,7,0,0,4,0,7,11,1
5687,90685,p1glD11J2O4xqRjpc7tPhfftojomVp8l,G8EPVSXsOYB5YQWZGiz1aVq5Pgr2GrQu,2,0,0,0,0,0,2,0,2,0.2857142857142857,1,0.0,0,0,0,0,0,0,0,2,0,0,2,1
5688,90696,H5UEKpeYUS8ZwAU1o3ZTuTx8QVBIM5mj,bWdj2GDclj5ofokWjzoa5jAwMkxCykd6,1,0,0,0,0,0,1,0,1,0.14285714285714285,1,0.0,0,0,0,0,0,0,0,1,0,0,1,1
5689,90700,63wWcpmf1i2NKSiQREiAJYYp7SpsRdNk,SpATywNh6bZuzm8s1ceuBUnMUAeoAHHw,6,4,3,0,2,0,2,0,11,1.5714285714285714,1,0.0,0,3,0,2,4,0,0,2,0,5,6,1
5690,90701,deIsi5BI37iNeLK3sFoXHW9756YDHzUX,SpATywNh6bZuzm8s1ceuBUnMUAeoAHHw,8,5,1,0,0,11,9,1,27,3.857142857142857,1,0.0,0,1,0,0,5,11,0,9,1,1,26,1
5691,90702,ORT6fH4QpWfdVApgOFbiZIUgnndzWNam,bWdj2GDclj5ofokWjzoa5jAwMkxCykd6,6,2,1,0,1,0,4,0,8,1.1428571428571428,1,0.0,0,1,0,1,2,0,0,4,0,2,6,1
5692,90707,oJ9j9ejTgKixczg3tSE8Sg8DPI7YQpJq,bWdj2GDclj5ofokWjzoa5jAwMkxCykd6,8,11,5,0,2,1,4,1,24,3.4285714285714284,1,0.0,3,5,0,2,8,1,0,4,1,10,14,1
5693,90708,rd6AxicG284gxewkDLzJ9mHqaB9eMpej,SpATywNh6bZuzm8s1ceuBUnMUAeoAHHw,5,2,1,0,1,0,2,0,6,0.8571428571428571,1,0.0,0,1,0,1,2,0,0,2,0,2,4,1
5694,90711,YwhJiJdY6sdupy0lRkNRU9p6H4rUPLhl,SpATywNh6bZuzm8s1ceuBUnMUAeoAHHw,2,0,0,0,0,0,3,0,3,0.42857142857142855,1,0.0,0,0,0,0,0,0,0,3,0,0,3,1
5695,90712,sKygNm7l33RvePXhMRKhT8eWlgq4D2Uu,G8EPVSXsOYB5YQWZGiz1aVq5Pgr2GrQu,7,2,1,0,1,0,8,1,13,1.8571428571428572,1,0.0,0,1,0,1,2,0,0,8,1,2,11,1
5696,90714,F56VIhO1QqwJ2EV8tGyI5l1mo3yf3Tk3,bWdj2GDclj5ofokWjzoa5jAwMkxCykd6,3,2,0,0,0,0,2,0,4,0.5714285714285714,1,0.0,0,0,0,0,2,0,0,2,0,0,4,1
5697,90716,D03u0gED7VbQRZXbOTEY3B3RSnOHMTwX,G8EPVSXsOYB5YQWZGiz1aVq5Pgr2GrQu,4,4,1,0,1,0,1,0,7,1.0,1,0.0,0,1,0,1,4,0,0,1,0,2,5,1
5698,90718,tOwol93HcvuFb5zloOErYW1pE3AivbGE,bWdj2GDclj5ofokWjzoa5jAwMkxCykd6,1,0,0,0,0,0,1,0,1,0.14285714285714285,1,0.0,0,0,0,0,0,0,0,1,0,0,1,1
5699,90720,tOwol93HcvuFb5zloOErYW1pE3AivbGE,RXDvfPUBYFlVdlueBFbLW0mhhAyGEqpt,6,2,1,0,1,0,3,0,7,1.0,1,0.0,0,1,0,1,2,0,0,3,0,2,5,1
5700,90722,1UXy9epSRpZ4kgvfm7ijkVKWuglHemTQ,SpATywNh6bZuzm8s1ceuBUnMUAeoAHHw,5,2,1,0,1,0,6,0,10,1.4285714285714286,1,0.0,0,1,0,1,2,0,0,6,0,2,8,0
5701,90729,4TzA065DYK6LuKsj03IdWmVVHtLP4pD7,SpATywNh6bZuzm8s1ceuBUnMUAeoAHHw,6,2,1,0,1,0,3,0,7,1.0,1,0.0,0,1,0,1,2,0,0,3,0,2,5,1
5702,90741,w5OdJoQZNGUVPiCQDXg0Vd0yo9ewUzmW,RXDvfPUBYFlVdlueBFbLW0mhhAyGEqpt,14,10,7,12,4,0,2,0,35,5.0,2,0.0,1,7,12,4,9,0,0,2,0,24,11,1
5703,90743,Y5C6JW9FcrJIhkFtmu7KcSC7Zibilzs4,RXDvfPUBYFlVdlueBFbLW0mhhAyGEqpt,14,15,10,0,4,2,11,2,44,6.285714285714286,2,0.0,0,10,0,4,15,2,0,11,2,14,30,1
5704,90746,ldckbcGV67YBoSN68pz7hDadzOTSpXE4,G8EPVSXsOYB5YQWZGiz1aVq5Pgr2GrQu,8,26,8,12,6,0,3,0,55,7.857142857142857,3,0.0,6,8,11,6,20,0,1,3,0,31,24,1
5705,90747,4f6gBunWwjsaAgYwinaGIAK95dQig1Sv,bWdj2GDclj5ofokWjzoa5jAwMkxCykd6,1,0,0,0,0,0,1,0,1,0.14285714285714285,1,0.0,0,0,0,0,0,0,0,1,0,0,1,1
5706,90749,Y5EybULOrY5dAmMMQWE7bK5wg4bsR2Lr,bWdj2GDclj5ofokWjzoa5jAwMkxCykd6,12,26,14,60,3,61,20,2,186,26.571428571428573,4,0.0,3,14,58,3,23,61,2,20,2,78,108,1
5707,90755,KQaABjEuQepl9FAcsVuUoYwnLleiOaUh,bWdj2GDclj5ofokWjzoa5jAwMkxCykd6,4,4,1,0,2,0,1,0,8,1.1428571428571428,1,0.0,2,1,0,2,2,0,0,1,0,5,3,1
5708,90757,wwEAB1ez2GqscQ96613pzqpcm4gmgk2z,bWdj2GDclj5ofokWjzoa5jAwMkxCykd6,9,13,3,0,5,0,2,0,23,3.2857142857142856,1,0.0,5,3,0,5,8,0,0,2,0,13,10,1
5709,90760,LknZf5R0kFesJr0Rm2KEqD235TVmngp0,SpATywNh6bZuzm8s1ceuBUnMUAeoAHHw,13,11,0,14,0,57,8,1,91,13.0,1,0.0,2,0,11,0,9,57,3,8,1,13,78,1
5710,90761,l4s4x0272kzhcEfgCvz1VNYYSzsAqk0d,G8EPVSXsOYB5YQWZGiz1aVq5Pgr2GrQu,11,8,4,0,3,3,6,0,24,3.4285714285714284,2,0.0,0,4,0,3,8,3,0,6,0,7,17,1
5711,90765,pGY1w8eP7I4lbateXReA0flFyTJRZgPr,G8EPVSXsOYB5YQWZGiz1aVq5Pgr2GrQu,6,1,1,0,1,0,3,0,6,0.8571428571428571,1,0.0,0,1,0,1,1,0,0,3,0,2,4,1
5712,90770,3CsUz8mRFoFNKmkeENo8HuDQSH05lxmZ,G8EPVSXsOYB5YQWZGiz1aVq5Pgr2GrQu,3,0,0,0,0,0,6,0,6,0.8571428571428571,2,0.0,0,0,0,0,0,0,0,6,0,0,6,1
5713,90773,D0SRTJhzsGGnKbIKtAcGeOVG46CDAXxq,SpATywNh6bZuzm8s1ceuBUnMUAeoAHHw,7,8,5,0,3,0,3,0,19,2.7142857142857144,2,0.0,0,5,0,3,8,0,0,3,0,8,11,1
5714,90782,LeyecjAY6mg5LvZFKVpB5z5Vy8PSThxU,SpATywNh6bZuzm8s1ceuBUnMUAeoAHHw,7,6,2,0,2,0,2,0,12,1.7142857142857142,1,0.0,0,2,0,2,6,0,0,2,0,4,8,1
5715,90788,AhMXiVok13ZjNF4gspHPwIDZecQgiWpM,RXDvfPUBYFlVdlueBFbLW0mhhAyGEqpt,1,0,0,0,0,0,1,0,1,0.14285714285714285,1,0.0,0,0,0,0,0,0,0,1,0,0,1,1
5716,90789,bEGwB6bxwamH303rlcp1dTooqcWaF93C,SpATywNh6bZuzm8s1ceuBUnMUAeoAHHw,20,31,3,20,3,19,14,1,91,13.0,5,0.0,15,3,17,3,16,19,3,14,1,38,53,0
5717,90790,CdOlESGB1DzB9C16eeGe1UhXPsjHWQGW,SpATywNh6bZuzm8s1ceuBUnMUAeoAHHw,13,9,5,13,3,10,3,0,43,6.142857142857143,1,0.0,3,5,12,3,6,10,1,3,0,23,20,1
5718,90794,J38SfNJhh0josFdljlBSrhXRogu9GoqX,G8EPVSXsOYB5YQWZGiz1aVq5Pgr2GrQu,23,56,25,30,7,0,8,0,126,18.0,1,0.0,17,25,23,7,39,0,7,8,0,72,54,1
5719,90799,4LhW0gpz7wD6EZALKqoopL1swej6F6kT,RXDvfPUBYFlVdlueBFbLW0mhhAyGEqpt,8,10,3,0,1,0,4,1,19,2.7142857142857144,2,0.0,0,3,0,1,10,0,0,4,1,4,15,1
5720,90800,HDDfG2CBGcAcxX3ycvOXstF4TGeBz4ZN,G8EPVSXsOYB5YQWZGiz1aVq5Pgr2GrQu,8,4,3,0,3,0,1,0,11,1.5714285714285714,1,0.0,0,3,0,3,4,0,0,1,0,6,5,1
5721,90801,D819UH6GjR554Q5KsACZVpoO8UDhricE,SpATywNh6bZuzm8s1ceuBUnMUAeoAHHw,7,3,2,0,2,0,2,0,9,1.2857142857142858,1,0.0,0,2,0,2,3,0,0,2,0,4,5,1
5722,90811,I2obse1Zq7Nau4sY1YPG5mgE6G3RFVMC,G8EPVSXsOYB5YQWZGiz1aVq5Pgr2GrQu,6,5,4,0,4,0,1,0,14,2.0,1,0.0,0,4,0,4,5,0,0,1,0,8,6,1
5723,90815,iXNm5ZN5LzdJniA2N9BJpNV8u0KUat63,SpATywNh6bZuzm8s1ceuBUnMUAeoAHHw,10,20,7,0,3,0,5,0,35,5.0,2,0.0,0,7,0,3,20,0,0,5,0,10,25,1
5724,90821,pNgGoRZfmUo4wkTYP23egMC3LUn4nA2d,SpATywNh6bZuzm8s1ceuBUnMUAeoAHHw,12,14,6,0,2,1,10,0,33,4.714285714285714,1,0.0,0,6,0,2,14,1,0,10,0,8,25,1
5725,90822,X6bWAuG7i4cSWjzWor8wb8Jqxiw7Y3fM,G8EPVSXsOYB5YQWZGiz1aVq5Pgr2GrQu,20,12,1,36,1,3,2,0,55,7.857142857142857,1,0.0,1,1,29,1,11,3,7,2,0,32,23,1
5726,90824,5vkNIYp2bYY1LtZU7tLxethQegJYgNo1,G8EPVSXsOYB5YQWZGiz1aVq5Pgr2GrQu,4,8,1,0,3,0,1,0,13,1.8571428571428572,1,0.0,6,1,0,3,2,0,0,1,0,10,3,1
5727,90825,06UqVup6ex1qeNp4vJ1m9FBAIaawxt3L,bWdj2GDclj5ofokWjzoa5jAwMkxCykd6,8,5,3,0,2,0,3,0,13,1.8571428571428572,1,0.0,0,3,0,2,5,0,0,3,0,5,8,1
5728,90828,l8KXVCEZbv28Mkels2ilOG7I8qSBHRqR,RXDvfPUBYFlVdlueBFbLW0mhhAyGEqpt,7,8,1,0,1,0,1,0,11,1.5714285714285714,1,0.0,2,1,0,1,6,0,0,1,0,4,7,1
5729,90832,Qsw20Q5PeTwiq1PxYe0LRVTTkwenKksO,SpATywNh6bZuzm8s1ceuBUnMUAeoAHHw,8,13,2,7,0,6,3,0,31,4.428571428571429,2,0.0,0,2,6,0,13,6,1,3,0,8,23,1
5730,90839,5ZwXPjJ7Hpe1sEszjUirFtHlC571EgXW,bWdj2GDclj5ofokWjzoa5jAwMkxCykd6,5,8,1,0,1,0,2,0,12,1.7142857142857142,1,0.0,1,1,0,1,7,0,0,2,0,3,9,1
5731,90848,KrsnHficdQyIsUU0OmJhlaIOPfA02mNz,bWdj2GDclj5ofokWjzoa5jAwMkxCykd6,1,0,0,0,0,0,2,0,2,0.2857142857142857,1,0.0,0,0,0,0,0,0,0,2,0,0,2,1
5732,90850,GWNKqanO7Bwv22F8soWqeHa4Wn2DiLGZ,RXDvfPUBYFlVdlueBFbLW0mhhAyGEqpt,36,32,10,61,8,0,1,0,112,16.0,1,0.0,6,10,59,8,26,0,2,1,0,83,29,1
5733,90855,KogrHROquIJLSXIZqzhYU9Hcb9zVebwT,SpATywNh6bZuzm8s1ceuBUnMUAeoAHHw,15,13,6,10,1,28,6,1,65,9.285714285714286,2,0.0,3,6,9,1,10,28,1,6,1,19,46,1
5734,90856,t4mBW06R5u34zTzy1YY0BqHR3HtrMlxW,bWdj2GDclj5ofokWjzoa5jAwMkxCykd6,17,18,9,20,3,11,15,2,78,11.142857142857142,3,0.0,3,9,19,3,15,11,1,15,2,34,44,1
5735,90861,sD4VJ3Pl6fUXDlwP0L4osteHu9UdT1hV,SpATywNh6bZuzm8s1ceuBUnMUAeoAHHw,6,3,1,0,1,0,4,0,9,1.2857142857142858,1,0.0,0,1,0,1,3,0,0,4,0,2,7,1
5736,90863,OuHC5cgkNZAxQ8FoVKCX7NbOcZdwtnqB,SpATywNh6bZuzm8s1ceuBUnMUAeoAHHw,8,11,7,0,4,0,5,0,27,3.857142857142857,1,0.0,0,7,0,4,11,0,0,5,0,11,16,1
5737,90872,nL9fwNKEZP1vFZxFJDQtGgReRFz5AlyD,SpATywNh6bZuzm8s1ceuBUnMUAeoAHHw,8,8,3,0,1,2,6,2,22,3.142857142857143,1,0.0,4,3,0,1,4,2,0,6,2,8,14,1
5738,90875,Qyq18jm4urtOwW9jbqpJJDMX3auyGXK1,SpATywNh6bZuzm8s1ceuBUnMUAeoAHHw,4,2,0,0,0,0,2,0,4,0.5714285714285714,1,0.0,0,0,0,0,2,0,0,2,0,0,4,1
5739,90877,C9Wh4VK0YDPz8OcZLvDPXEYgZvrO7fON,SpATywNh6bZuzm8s1ceuBUnMUAeoAHHw,4,2,1,0,1,0,1,0,5,0.7142857142857143,1,0.0,0,1,0,1,2,0,0,1,0,2,3,1
5740,90878,vIBcYbs1BLdmaaP30fcE2FS7kB7v7QRn,bWdj2GDclj5ofokWjzoa5jAwMkxCykd6,9,20,11,0,1,3,13,0,48,6.857142857142857,2,0.0,2,11,0,1,18,3,0,13,0,14,34,1
5741,90880,YAHRUvgTShfsjnOmO618HsecfyEFFriC,SpATywNh6bZuzm8s1ceuBUnMUAeoAHHw,5,15,3,0,2,0,2,0,22,3.142857142857143,1,0.0,0,3,0,2,15,0,0,2,0,5,17,1
5742,90885,kFMdrBn76woeFkLVMgIjnzYIkBkN2rjs,SpATywNh6bZuzm8s1ceuBUnMUAeoAHHw,5,5,3,0,2,0,1,0,11,1.5714285714285714,1,0.0,0,3,0,2,5,0,0,1,0,5,6,1
5743,90887,GVUw4u2UhYktwQlrJTo9fWmDS2qzWpQC,SpATywNh6bZuzm8s1ceuBUnMUAeoAHHw,26,38,2,30,2,70,17,1,160,22.857142857142858,3,0.0,13,2,26,2,25,70,4,17,1,43,117,0
5744,90905,R3vdKqOlKdhOGFVIJPoEGMoTbxTcB9bc,SpATywNh6bZuzm8s1ceuBUnMUAeoAHHw,16,10,7,5,6,1,17,1,47,6.714285714285714,3,0.0,0,7,4,6,10,1,1,17,1,17,30,1
5745,90910,8mVKxRgJ8A1rq04XffdKXYfatdM3yRYE,RXDvfPUBYFlVdlueBFbLW0mhhAyGEqpt,8,4,3,0,2,0,2,0,11,1.5714285714285714,1,0.0,0,3,0,2,4,0,0,2,0,5,6,1
5746,90915,HPaDTzk2xymxbpoa0VdcxdHl3uFfOfZk,G8EPVSXsOYB5YQWZGiz1aVq5Pgr2GrQu,1,0,0,0,0,0,1,0,1,0.14285714285714285,1,0.0,0,0,0,0,0,0,0,1,0,0,1,1
5747,90916,nMBGX3nqIipxPIzBJdOaTEwO6lPkrYAP,SpATywNh6bZuzm8s1ceuBUnMUAeoAHHw,9,12,8,0,2,2,8,0,32,4.571428571428571,1,0.0,0,8,0,2,12,2,0,8,0,10,22,1
5748,90918,P8T670PRvYsTF14RAy04Ypel9tVdSt4W,SpATywNh6bZuzm8s1ceuBUnMUAeoAHHw,14,16,3,14,2,1,7,1,44,6.285714285714286,1,0.0,11,3,13,2,5,1,1,7,1,29,15,1
5749,90926,mfSlhGs8TOW9c66xAJCzRN5uCUec3OQS,G8EPVSXsOYB5YQWZGiz1aVq5Pgr2GrQu,4,3,0,0,0,0,1,0,4,0.5714285714285714,1,0.0,0,0,0,0,3,0,0,1,0,0,4,1
5750,90938,qA7txaCsDINVj5jwLkjFxBdOEKcLbkUC,bWdj2GDclj5ofokWjzoa5jAwMkxCykd6,4,8,2,0,2,0,1,0,13,1.8571428571428572,1,0.0,4,2,0,2,4,0,0,1,0,8,5,1
5751,90939,hRiaJRtvIOFlbihdEsv906GxXONnrFfr,SpATywNh6bZuzm8s1ceuBUnMUAeoAHHw,6,11,2,0,1,0,7,0,21,3.0,1,0.0,1,2,0,1,10,0,0,7,0,4,17,1
5752,90951,bmpOpVuzweuue9KaoQwJh1soVS4PCMAj,RXDvfPUBYFlVdlueBFbLW0mhhAyGEqpt,16,7,4,15,5,1,4,0,36,5.142857142857143,1,0.0,2,4,14,5,5,1,1,4,0,25,11,1
5753,90953,hIjUruVScjiqfQ0ERHHhB6StdCOggvbB,RXDvfPUBYFlVdlueBFbLW0mhhAyGEqpt,18,14,5,29,3,0,5,1,57,8.142857142857142,1,0.0,2,5,29,3,12,0,0,5,1,39,18,1
5754,90959,bAPyDIJfdAxQ8AHvo3QeBgdKri2hlVLQ,G8EPVSXsOYB5YQWZGiz1aVq5Pgr2GrQu,1,0,0,0,0,0,1,0,1,0.14285714285714285,1,0.0,0,0,0,0,0,0,0,1,0,0,1,1
5755,90961,h3p30ndtRdIyBMRidOGn8LuOdbmfUl5i,bWdj2GDclj5ofokWjzoa5jAwMkxCykd6,4,2,1,0,0,0,2,0,5,0.7142857142857143,1,0.0,0,1,0,0,2,0,0,2,0,1,4,1
5756,90962,1x68B6ELAKzkC8Z87epaTU9JLE90xrom,SpATywNh6bZuzm8s1ceuBUnMUAeoAHHw,6,10,0,5,0,0,2,0,17,2.4285714285714284,1,0.0,7,0,5,0,3,0,0,2,0,12,5,1
5757,90964,UEGgGFOddxp081siu8g5s2awm2LAgg2C,G8EPVSXsOYB5YQWZGiz1aVq5Pgr2GrQu,5,3,0,0,0,0,2,0,5,0.7142857142857143,1,0.0,0,0,0,0,3,0,0,2,0,0,5,1
5758,90967,8nT76hrzyl8ZAUdI7W6kfrIzHxI3puKM,SpATywNh6bZuzm8s1ceuBUnMUAeoAHHw,1,0,0,0,0,0,1,0,1,0.14285714285714285,1,0.0,0,0,0,0,0,0,0,1,0,0,1,1
5759,90968,1YzhwwWLdVM4bzJMYH49O7nplNitMAxK,SpATywNh6bZuzm8s1ceuBUnMUAeoAHHw,1,0,0,0,0,0,1,0,1,0.14285714285714285,1,0.0,0,0,0,0,0,0,0,1,0,0,1,1
5760,90975,ABlVlNkPi30ZMlFLrcsAhP5jZW6rJhdZ,bWdj2GDclj5ofokWjzoa5jAwMkxCykd6,6,3,2,0,1,0,2,0,8,1.1428571428571428,2,0.0,0,2,0,1,3,0,0,2,0,3,5,1
5761,90976,JgACfbSPbgZxvcoTB7IZVAGzYc3ZbdQl,G8EPVSXsOYB5YQWZGiz1aVq5Pgr2GrQu,18,19,0,0,1,2,8,1,31,4.428571428571429,2,0.0,2,0,0,1,17,2,0,8,1,3,28,1
5762,90980,iKjkh1YrFzq5OB5DSHkFwl9ZdnaqKanG,SpATywNh6bZuzm8s1ceuBUnMUAeoAHHw,5,4,1,0,1,1,2,0,9,1.2857142857142858,1,0.0,1,1,0,1,3,1,0,2,0,3,6,1
5763,90982,P9uew3S2WCP2kqlooRwkV6WK6JXjnFW1,SpATywNh6bZuzm8s1ceuBUnMUAeoAHHw,7,4,1,0,0,1,4,1,11,1.5714285714285714,1,0.0,0,1,0,0,4,1,0,4,1,1,10,1
5764,90990,h3p30ndtRdIyBMRidOGn8LuOdbmfUl5i,SpATywNh6bZuzm8s1ceuBUnMUAeoAHHw,13,8,3,12,2,3,4,1,33,4.714285714285714,1,0.0,3,3,12,2,5,3,0,4,1,20,13,1
5765,90991,MSVIULFa47b8oOycWVWVcPhuMCdDd5NZ,SpATywNh6bZuzm8s1ceuBUnMUAeoAHHw,25,32,12,20,4,6,17,1,92,13.142857142857142,3,0.0,6,12,18,4,26,6,2,17,1,40,52,1
5766,90996,XjO6wB2Z4egz4mV0GhT9a1BmKnwX0iZQ,SpATywNh6bZuzm8s1ceuBUnMUAeoAHHw,7,7,1,0,1,0,2,0,11,1.5714285714285714,1,0.0,3,1,0,1,4,0,0,2,0,5,6,1
5767,91000,69mjZoNGtUdd47OHaI2iQubsVwSBE5CT,SpATywNh6bZuzm8s1ceuBUnMUAeoAHHw,5,3,0,0,0,0,5,0,8,1.1428571428571428,1,0.0,0,0,0,0,3,0,0,5,0,0,8,1
5768,91003,iJftBP3zncmjUCwGWSZ77IUrDb3Dt8rz,bWdj2GDclj5ofokWjzoa5jAwMkxCykd6,4,2,1,0,1,0,1,0,5,0.7142857142857143,1,0.0,0,1,0,1,2,0,0,1,0,2,3,1
5769,91005,h83s4W6wEAiVAQw1YsiHYJozxIiZHoSp,G8EPVSXsOYB5YQWZGiz1aVq5Pgr2GrQu,5,2,1,0,1,1,2,0,7,1.0,1,0.0,0,1,0,1,2,1,0,2,0,2,5,1
5770,91007,fnbOlL6zM0TdpgW3GvlsPHFVJnQSFTyA,SpATywNh6bZuzm8s1ceuBUnMUAeoAHHw,10,13,7,0,6,0,4,0,30,4.285714285714286,2,0.0,0,7,0,6,13,0,0,4,0,13,17,1
5771,91008,UB0nPfUwWgaRThrVeKik4SwdfP63TRHx,SpATywNh6bZuzm8s1ceuBUnMUAeoAHHw,14,29,2,18,1,4,6,0,60,8.571428571428571,2,0.0,5,2,15,1,24,4,3,6,0,23,37,1
5772,91011,UyjpsvsOggyMosfJEuRSeI96eHcBNf41,SpATywNh6bZuzm8s1ceuBUnMUAeoAHHw,6,4,2,3,1,0,1,0,11,1.5714285714285714,1,0.0,1,2,3,1,3,0,0,1,0,7,4,1
5773,91013,bqWpav7ocOhCfb3xc4QgAvBDK5g8BmiZ,bWdj2GDclj5ofokWjzoa5jAwMkxCykd6,11,10,8,0,2,0,4,0,24,3.4285714285714284,2,0.0,0,8,0,2,10,0,0,4,0,10,14,1
5774,91014,dLJ4i4UwjNqr5YPEuySq1h5THPMNjgjJ,SpATywNh6bZuzm8s1ceuBUnMUAeoAHHw,10,8,6,0,5,0,3,0,22,3.142857142857143,2,0.0,0,6,0,5,8,0,0,3,0,11,11,0
5775,91016,KyDM2Ub30UlLqAgwV3Kdja9FjS49F2cL,G8EPVSXsOYB5YQWZGiz1aVq5Pgr2GrQu,4,2,1,0,1,0,1,0,5,0.7142857142857143,1,0.0,0,1,0,1,2,0,0,1,0,2,3,1
5776,91017,zrZWN5ij2KPpDRaiyWWPqj2Z1YuwvTvt,SpATywNh6bZuzm8s1ceuBUnMUAeoAHHw,10,19,7,0,4,5,14,3,52,7.428571428571429,3,0.0,0,7,0,4,19,5,0,14,3,11,41,1
5777,91022,BvTUeUSX8ehdvYqgk6h69dy9HSlBWzXM,G8EPVSXsOYB5YQWZGiz1aVq5Pgr2GrQu,7,31,7,0,3,0,9,0,50,7.142857142857143,1,0.0,3,7,0,3,28,0,0,9,0,13,37,1
5778,91023,ZZzQCzIgfdjMh5GZMagmPbKqCFsmjzqD,SpATywNh6bZuzm8s1ceuBUnMUAeoAHHw,5,2,1,0,1,0,2,0,6,0.8571428571428571,1,0.0,0,1,0,1,2,0,0,2,0,2,4,1
5779,91025,nTeEg9IpivRmreYWiIjMvVlevTAaGMey,SpATywNh6bZuzm8s1ceuBUnMUAeoAHHw,7,5,3,0,2,0,2,0,12,1.7142857142857142,2,0.0,0,3,0,2,5,0,0,2,0,5,7,1
5780,91029,tvqXd520K684wy1KQ0GBsByYs78H3st9,RXDvfPUBYFlVdlueBFbLW0mhhAyGEqpt,1,0,0,0,0,0,1,0,1,0.14285714285714285,1,0.0,0,0,0,0,0,0,0,1,0,0,1,1
5781,91037,mJHwEQabAWgiuu06ZP8aR46SMutI8kEA,SpATywNh6bZuzm8s1ceuBUnMUAeoAHHw,5,2,1,0,1,0,3,0,7,1.0,1,0.0,0,1,0,1,2,0,0,3,0,2,5,1
5782,91045,dB4WDfiw60nGNNAG9g9zNz1Z102rMluZ,SpATywNh6bZuzm8s1ceuBUnMUAeoAHHw,19,12,7,12,4,2,7,1,45,6.428571428571429,2,0.0,2,7,11,4,10,2,1,7,1,24,21,1
5783,91050,Y5EybULOrY5dAmMMQWE7bK5wg4bsR2Lr,RXDvfPUBYFlVdlueBFbLW0mhhAyGEqpt,13,8,7,0,4,0,1,0,20,2.857142857142857,1,0.0,0,7,0,4,8,0,0,1,0,11,9,1
5784,91054,EjR7iUwsiJVzqJrC7t3D1JWVRCEYToml,bWdj2GDclj5ofokWjzoa5jAwMkxCykd6,8,7,1,0,2,24,5,1,40,5.714285714285714,1,0.0,2,1,0,2,5,24,0,5,1,5,35,1
5785,91058,JckOmRdQvE0R24dfuPeUe2DTKfe4tF0h,G8EPVSXsOYB5YQWZGiz1aVq5Pgr2GrQu,2,0,0,0,0,0,4,0,4,0.5714285714285714,1,0.0,0,0,0,0,0,0,0,4,0,0,4,0
5786,91059,YJQCaDByfjoOhBSQklKuzWe4YXgqBr84,SpATywNh6bZuzm8s1ceuBUnMUAeoAHHw,5,3,2,0,2,0,3,0,10,1.4285714285714286,2,0.0,0,2,0,2,3,0,0,3,0,4,6,1
5787,91061,4BM2X3vjiB0KMTdSgJPbb92aYDlCdKqm,SpATywNh6bZuzm8s1ceuBUnMUAeoAHHw,1,0,0,0,0,0,5,0,5,0.7142857142857143,1,0.0,0,0,0,0,0,0,0,5,0,0,5,1
5788,91063,gzBj4rBVIL1BI1dJCkBf6DnSNlOqQIwg,SpATywNh6bZuzm8s1ceuBUnMUAeoAHHw,7,8,0,0,0,4,4,0,16,2.2857142857142856,1,0.0,0,0,0,0,8,4,0,4,0,0,16,1
5789,91066,HvCZ1bV9L7D0erySzp1UH1mW8tuWfYPw,SpATywNh6bZuzm8s1ceuBUnMUAeoAHHw,7,11,5,0,3,3,2,0,24,3.4285714285714284,2,0.0,0,5,0,3,11,3,0,2,0,8,16,1
5790,91070,G1AtiTSNDONQwl0Hl81VRJCbBPxu3bhI,bWdj2GDclj5ofokWjzoa5jAwMkxCykd6,7,4,2,0,1,5,6,0,18,2.5714285714285716,1,0.0,0,2,0,1,4,5,0,6,0,3,15,0
5791,91078,KYLGj0LJWlbOKu0N6ntmca4SUIisJJd9,SpATywNh6bZuzm8s1ceuBUnMUAeoAHHw,1,0,0,0,0,0,4,0,4,0.5714285714285714,1,0.0,0,0,0,0,0,0,0,4,0,0,4,1
5792,91081,U04y5vFf0AfyJVGIOJHlryTyRQEOm5pT,RXDvfPUBYFlVdlueBFbLW0mhhAyGEqpt,6,2,1,0,1,0,4,0,8,1.1428571428571428,2,0.0,0,1,0,1,2,0,0,4,0,2,6,1
5793,91105,ZxvROepgS8uZpWYEjrhlsfyND4f2cw2o,SpATywNh6bZuzm8s1ceuBUnMUAeoAHHw,26,31,16,31,6,3,24,2,113,16.142857142857142,2,0.0,11,16,25,6,20,3,6,24,2,58,55,0
5794,91108,nJUQO0awidSkRki1FSo1rhLXdIxrzKfS,G8EPVSXsOYB5YQWZGiz1aVq5Pgr2GrQu,22,30,5,34,4,8,12,1,94,13.428571428571429,5,0.0,5,5,28,4,25,8,6,12,1,42,52,0
5795,91110,9jYO2Na9DSPgmUyIaCnH33KjtnbI2MPN,SpATywNh6bZuzm8s1ceuBUnMUAeoAHHw,8,4,3,0,3,0,1,0,11,1.5714285714285714,1,0.0,0,3,0,3,4,0,0,1,0,6,5,1
5796,91111,Bx6FqxWgsWymyOwxFcEQZn8BP7GPaoEm,G8EPVSXsOYB5YQWZGiz1aVq5Pgr2GrQu,8,5,3,0,1,0,12,0,21,3.0,1,0.0,0,3,0,1,5,0,0,12,0,4,17,1
5797,91115,fAwXW6DQAyNHjMN17jlyBSVcZRO4da21,SpATywNh6bZuzm8s1ceuBUnMUAeoAHHw,14,32,12,14,7,3,5,0,73,10.428571428571429,2,0.0,4,12,12,7,28,3,2,5,0,35,38,1
5798,91116,K1IqR71Sh84XFi6onZppsnD3thTHQIxV,SpATywNh6bZuzm8s1ceuBUnMUAeoAHHw,13,16,11,0,8,1,11,1,48,6.857142857142857,3,0.0,0,11,0,8,16,1,0,11,1,19,29,1
5799,91117,BbiSpjLUYXccDuntMMtC8mx0riONNKqb,bWdj2GDclj5ofokWjzoa5jAwMkxCykd6,5,2,1,0,1,0,2,0,6,0.8571428571428571,1,0.0,0,1,0,1,2,0,0,2,0,2,4,1
5800,91121,7LnOg1xHmRDTcvzCdFBumEhAPUujuxnu,SpATywNh6bZuzm8s1ceuBUnMUAeoAHHw,7,12,1,0,1,0,4,0,18,2.5714285714285716,1,0.0,0,1,0,1,12,0,0,4,0,2,16,1
5801,91124,EiO5bky9R1Iqlpv4ItUpPBUgGb1eJItE,RXDvfPUBYFlVdlueBFbLW0mhhAyGEqpt,1,0,0,0,0,0,1,0,1,0.14285714285714285,1,0.0,0,0,0,0,0,0,0,1,0,0,1,1
5802,91127,Dtyef0XPp5AB6qcxARHBVaIqOwKhnCJD,RXDvfPUBYFlVdlueBFbLW0mhhAyGEqpt,17,17,12,14,6,13,6,0,68,9.714285714285714,1,0.0,1,12,13,6,16,13,1,6,0,32,36,1
5803,91131,q5brbl1IUGTW0QCDlsOmPM8P083V7zR9,SpATywNh6bZuzm8s1ceuBUnMUAeoAHHw,1,0,0,0,0,0,1,0,1,0.14285714285714285,1,0.0,0,0,0,0,0,0,0,1,0,0,1,1
5804,91132,92Eer7xGYFDCorN4RAF4CYzwZt5RGCcT,SpATywNh6bZuzm8s1ceuBUnMUAeoAHHw,1,0,0,0,0,0,1,0,1,0.14285714285714285,1,0.0,0,0,0,0,0,0,0,1,0,0,1,1
5805,91143,hx5sJ7jwWSrYbv8AAwrwIYlkyA5lh0xw,SpATywNh6bZuzm8s1ceuBUnMUAeoAHHw,2,0,0,0,0,0,2,0,2,0.2857142857142857,1,0.0,0,0,0,0,0,0,0,2,0,0,2,1
5806,91145,im3SIH2rxe8iUb1VWEDrDsuvwOO0Qeuq,SpATywNh6bZuzm8s1ceuBUnMUAeoAHHw,1,0,0,0,0,0,1,0,1,0.14285714285714285,1,0.0,0,0,0,0,0,0,0,1,0,0,1,1
5807,91146,5kux74rVeqoEvbABYMpdIOO6ta3zLim7,SpATywNh6bZuzm8s1ceuBUnMUAeoAHHw,6,10,1,0,0,0,3,0,14,2.0,1,0.0,0,1,0,0,10,0,0,3,0,1,13,1
5808,91148,mirL98pOfRc0QA1dI8m4EOtFFog8KIsB,SpATywNh6bZuzm8s1ceuBUnMUAeoAHHw,6,11,2,0,0,0,3,0,16,2.2857142857142856,3,0.0,0,2,0,0,11,0,0,3,0,2,14,1
5809,91151,EpEDPL39pwbGw6HcHWJhf2GDqySvaN1h,SpATywNh6bZuzm8s1ceuBUnMUAeoAHHw,6,2,1,0,1,0,2,0,6,0.8571428571428571,1,0.0,0,1,0,1,2,0,0,2,0,2,4,1
5810,91158,B4jOMU8eQLApET1YBx1fXCzcdODxsgi8,bWdj2GDclj5ofokWjzoa5jAwMkxCykd6,7,9,1,0,2,0,2,0,14,2.0,1,0.0,2,1,0,2,7,0,0,2,0,5,9,1
5811,91159,O7hnrNbVuVSYYY4GiDlB8jr4kCwVIU3W,SpATywNh6bZuzm8s1ceuBUnMUAeoAHHw,1,0,0,0,0,0,7,0,7,1.0,1,0.0,0,0,0,0,0,0,0,7,0,0,7,1
5812,91160,urxyBMLwqPoccprp1W7NCQtPStGZDqxd,SpATywNh6bZuzm8s1ceuBUnMUAeoAHHw,5,2,1,0,1,0,2,0,6,0.8571428571428571,1,0.0,0,1,0,1,2,0,0,2,0,2,4,1
5813,91162,ORT6fH4QpWfdVApgOFbiZIUgnndzWNam,SpATywNh6bZuzm8s1ceuBUnMUAeoAHHw,21,30,20,14,12,3,6,0,85,12.142857142857142,3,0.0,6,20,11,12,24,3,3,6,0,49,36,0
5814,91167,XMtcnsDNasKCOMBWrsjCVH5NONQyEryR,bWdj2GDclj5ofokWjzoa5jAwMkxCykd6,18,26,12,122,6,0,10,0,176,25.142857142857142,2,0.0,9,12,118,6,17,0,4,10,0,145,31,0
5815,91171,XMIsZqrfw7qqk0EIVzNsPndKXVTScrCr,SpATywNh6bZuzm8s1ceuBUnMUAeoAHHw,16,22,10,17,4,5,7,1,66,9.428571428571429,1,0.0,6,10,15,4,16,5,2,7,1,35,31,1
5816,91172,EJfQNb5Mu8lcO1ocmk4PtmUhkW8FMGb9,RXDvfPUBYFlVdlueBFbLW0mhhAyGEqpt,5,7,2,0,1,0,2,0,12,1.7142857142857142,2,0.0,0,2,0,1,7,0,0,2,0,3,9,0
5817,91173,wdzOHZGShaydEKxmovJEzQ6EMiqynMte,SpATywNh6bZuzm8s1ceuBUnMUAeoAHHw,14,50,14,26,0,18,11,2,121,17.285714285714285,3,0.0,29,14,20,0,21,18,6,11,2,63,58,1
5818,91178,ogkoDosyBhbZAvybtPbmcuc4tjatNf2P,G8EPVSXsOYB5YQWZGiz1aVq5Pgr2GrQu,17,36,30,22,16,0,4,0,108,15.428571428571429,2,0.0,0,30,18,16,36,0,4,4,0,64,44,1
5819,91182,H1VDSbfLdFN8dYSqCsn4o54mYdltgayR,SpATywNh6bZuzm8s1ceuBUnMUAeoAHHw,1,0,0,0,0,0,1,0,1,0.14285714285714285,1,0.0,0,0,0,0,0,0,0,1,0,0,1,1
5820,91184,v5DL1tRN6AvAeQThFmEHNCo6sn5M6uIG,SpATywNh6bZuzm8s1ceuBUnMUAeoAHHw,12,14,6,19,4,0,1,0,44,6.285714285714286,1,0.0,5,6,17,4,9,0,2,1,0,32,12,1
5821,91190,HHjw6PARN0UbkiffbOwvG4RULtVIyY0R,bWdj2GDclj5ofokWjzoa5jAwMkxCykd6,1,0,0,0,0,0,1,0,1,0.14285714285714285,1,0.0,0,0,0,0,0,0,0,1,0,0,1,1
5822,91204,JwpnWAbXqqokshNbyxBH2QHaOUPb8wrj,G8EPVSXsOYB5YQWZGiz1aVq5Pgr2GrQu,11,24,1,0,1,1,11,2,40,5.714285714285714,2,0.0,1,1,0,1,23,1,0,11,2,3,37,0
5823,91207,37tZi453KKWhJoY7icXXq6XTM7CZX5cD,SpATywNh6bZuzm8s1ceuBUnMUAeoAHHw,14,16,0,21,0,3,10,2,52,7.428571428571429,1,0.0,4,0,17,0,12,3,4,10,2,21,31,1
5824,91208,tPYh43YRHAzuf09xESxSKtWvST0aCsjn,RXDvfPUBYFlVdlueBFbLW0mhhAyGEqpt,1,0,0,0,0,0,1,0,1,0.14285714285714285,1,0.0,0,0,0,0,0,0,0,1,0,0,1,1
5825,91214,Rd7eeroPlO4BVZv0bnl0CqHm3u7jCGNe,SpATywNh6bZuzm8s1ceuBUnMUAeoAHHw,12,17,8,0,6,6,4,0,41,5.857142857142857,1,0.0,0,8,0,6,17,6,0,4,0,14,27,1
5826,91215,AXWWqNDiRDejTjo5V7yUaMbjtzXKhlP0,bWdj2GDclj5ofokWjzoa5jAwMkxCykd6,6,5,2,0,1,3,3,0,14,2.0,1,0.0,2,2,0,1,3,3,0,3,0,5,9,1
5827,91217,Zw1bdKbgaMzUzlqlieQSaucEQ8wggZlx,G8EPVSXsOYB5YQWZGiz1aVq5Pgr2GrQu,9,14,5,0,3,0,3,0,25,3.5714285714285716,1,0.0,0,5,0,3,14,0,0,3,0,8,17,1
5828,91220,TXdA343riqqgy7iMdaooNvyNV5wjOdTg,SpATywNh6bZuzm8s1ceuBUnMUAeoAHHw,1,0,0,0,0,0,3,0,3,0.42857142857142855,1,0.0,0,0,0,0,0,0,0,3,0,0,3,1
5829,91221,2FMy3BDMeRecSDtTTnOKB2d19YsmeIUm,SpATywNh6bZuzm8s1ceuBUnMUAeoAHHw,17,15,9,6,5,12,11,2,60,8.571428571428571,1,0.0,4,9,6,5,11,12,0,11,2,24,36,1
5830,91228,14pD3OA8ZEvWCgDfU1fYkv0M9pXxNW5u,SpATywNh6bZuzm8s1ceuBUnMUAeoAHHw,14,34,0,19,0,11,14,5,83,11.857142857142858,2,0.0,15,0,17,0,19,11,2,14,5,32,51,0
5831,91243,eds8bJvJ9xWp5J9qVgS3pSKJpcp9ssMO,RXDvfPUBYFlVdlueBFbLW0mhhAyGEqpt,18,22,11,20,5,0,5,0,63,9.0,1,0.0,4,11,20,5,18,0,0,5,0,40,23,1
5832,91250,XdYuk6m8JAApvXFcBONfmeC52I0301IJ,SpATywNh6bZuzm8s1ceuBUnMUAeoAHHw,3,2,0,0,0,0,1,0,3,0.42857142857142855,1,0.0,0,0,0,0,2,0,0,1,0,0,3,1
5833,91251,69mjZoNGtUdd47OHaI2iQubsVwSBE5CT,RXDvfPUBYFlVdlueBFbLW0mhhAyGEqpt,7,3,2,0,1,1,6,1,14,2.0,2,0.0,0,2,0,1,3,1,0,6,1,3,11,1
5834,91253,XdYuk6m8JAApvXFcBONfmeC52I0301IJ,G8EPVSXsOYB5YQWZGiz1aVq5Pgr2GrQu,3,2,0,0,0,0,1,0,3,0.42857142857142855,1,0.0,0,0,0,0,2,0,0,1,0,0,3,1
5835,91254,3BYgVMhPAaxlk6STVmLlShJjZEZk9Ygh,G8EPVSXsOYB5YQWZGiz1aVq5Pgr2GrQu,7,5,4,8,2,0,1,0,20,2.857142857142857,1,0.0,0,4,6,2,5,0,2,1,0,12,8,1
5836,91257,WCmDosmdgfMjDVmsfhMjruGatZmceBZ1,G8EPVSXsOYB5YQWZGiz1aVq5Pgr2GrQu,10,10,1,0,2,2,8,2,25,3.5714285714285716,1,0.0,4,1,0,2,6,2,0,8,2,7,18,1
5837,91263,mpFcyQQmc8dk989EyC0qjuZYiRIdPGUA,G8EPVSXsOYB5YQWZGiz1aVq5Pgr2GrQu,15,14,11,18,5,0,2,0,50,7.142857142857143,2,0.0,0,11,14,5,14,0,4,2,0,30,20,1
5838,91264,Ydgz8POU25ETYijca209j0OeGw9lAoWU,RXDvfPUBYFlVdlueBFbLW0mhhAyGEqpt,6,3,2,0,1,1,4,1,12,1.7142857142857142,1,0.0,0,2,0,1,3,1,0,4,1,3,9,1
5839,91270,1g8yBUc3cHuCmwlbkVdrck4LA6Kk4jp8,SpATywNh6bZuzm8s1ceuBUnMUAeoAHHw,1,0,0,0,0,0,1,0,1,0.14285714285714285,1,0.0,0,0,0,0,0,0,0,1,0,0,1,1
5840,91271,xsGCEWhbZlUdlgrI9YmAsQkfbCuoHlqr,SpATywNh6bZuzm8s1ceuBUnMUAeoAHHw,3,2,0,0,0,0,1,0,3,0.42857142857142855,1,0.0,0,0,0,0,2,0,0,1,0,0,3,1
5841,91272,Xl4Lzddy8Aw3656QCmyajshZUF8lGm25,G8EPVSXsOYB5YQWZGiz1aVq5Pgr2GrQu,8,5,3,0,1,4,3,1,17,2.4285714285714284,1,0.0,0,3,0,1,5,4,0,3,1,4,13,1
5842,91274,Ub05s2SQ9ZHQTwcGaeWGVwMVL3ugFxRh,SpATywNh6bZuzm8s1ceuBUnMUAeoAHHw,18,19,8,11,3,2,9,1,53,7.571428571428571,2,0.0,8,8,11,3,11,2,0,9,1,30,23,1
5843,91278,g5Cdwy5RdXfNsnVJb5dTAjZFbf2MEVG0,bWdj2GDclj5ofokWjzoa5jAwMkxCykd6,5,13,7,0,5,0,3,0,28,4.0,2,0.0,0,7,0,5,13,0,0,3,0,12,16,1
5844,91284,3a9jnl6D615xvyDPr3X72Qm6tyAqQDq6,SpATywNh6bZuzm8s1ceuBUnMUAeoAHHw,5,0,0,0,0,2,6,1,9,1.2857142857142858,1,0.0,0,0,0,0,0,2,0,6,1,0,9,1
5845,91287,Xl4Lzddy8Aw3656QCmyajshZUF8lGm25,SpATywNh6bZuzm8s1ceuBUnMUAeoAHHw,14,19,6,22,3,8,4,0,62,8.857142857142858,1,0.0,10,6,19,3,9,8,3,4,0,38,24,1
5846,91299,3lDn61j7LQx2ct2mXSyFAxE4I2joOjdi,SpATywNh6bZuzm8s1ceuBUnMUAeoAHHw,16,16,5,19,3,4,7,1,55,7.857142857142857,1,0.0,10,5,16,3,6,4,3,7,1,34,21,1
5847,91300,UZj9qZ6lkWkIz7HEEFyBh5LFRNaz4SI2,SpATywNh6bZuzm8s1ceuBUnMUAeoAHHw,11,15,1,6,1,0,4,0,27,3.857142857142857,3,0.0,0,1,5,1,15,0,1,4,0,7,20,1
5848,91302,CuRQgxEa02jfJLJUhEm7AKFBwc2Dt3PE,SpATywNh6bZuzm8s1ceuBUnMUAeoAHHw,10,15,7,7,0,0,4,0,33,4.714285714285714,1,0.0,0,7,6,0,15,0,1,4,0,13,20,1
5849,91304,VYmODogcHFHSX4vALahPhItYfFc245Hp,RXDvfPUBYFlVdlueBFbLW0mhhAyGEqpt,21,28,17,31,5,1,9,0,91,13.0,2,0.0,5,17,26,5,23,1,5,9,0,53,38,1
5850,91307,MHM1aXC71Dw383yBooXdYF1qDKYHoccv,bWdj2GDclj5ofokWjzoa5jAwMkxCykd6,1,0,0,0,0,0,1,0,1,0.14285714285714285,1,0.0,0,0,0,0,0,0,0,1,0,0,1,1
5851,91310,MHM1aXC71Dw383yBooXdYF1qDKYHoccv,SpATywNh6bZuzm8s1ceuBUnMUAeoAHHw,4,2,1,0,1,0,2,0,6,0.8571428571428571,1,0.0,0,1,0,1,2,0,0,2,0,2,4,1
5852,91312,LmrXz112hM3lsrkiQcTLgB1CQdX7OPmf,RXDvfPUBYFlVdlueBFbLW0mhhAyGEqpt,23,22,16,30,10,1,5,1,85,12.142857142857142,1,0.0,4,16,27,10,18,1,3,5,1,57,28,1
5853,91325,q5vo1hp0Q9QDxbtjHEkZyC7Vz9AYHKaw,G8EPVSXsOYB5YQWZGiz1aVq5Pgr2GrQu,1,0,0,0,0,0,1,0,1,0.14285714285714285,1,0.0,0,0,0,0,0,0,0,1,0,0,1,1
5854,91328,OZaq72DmJH6bReA6lKvO4XbWYjmwsu42,bWdj2GDclj5ofokWjzoa5jAwMkxCykd6,18,22,8,98,4,0,7,0,139,19.857142857142858,4,0.0,6,8,92,4,16,0,6,7,0,110,29,1
5855,91333,xRrdKDq0SR8avtZTCYAseO6HdCVb8m0M,bWdj2GDclj5ofokWjzoa5jAwMkxCykd6,9,13,5,43,2,13,8,6,90,12.857142857142858,1,0.0,5,5,42,2,8,13,1,8,6,54,36,1
5856,91337,OtHqAfAnlt18GaEWyak2S1YVbRKxCTZV,bWdj2GDclj5ofokWjzoa5jAwMkxCykd6,1,0,0,0,0,0,1,0,1,0.14285714285714285,1,0.0,0,0,0,0,0,0,0,1,0,0,1,1
5857,91346,b4VAhvG3MG7lVRCMYGT7EV06rJVZjoZJ,SpATywNh6bZuzm8s1ceuBUnMUAeoAHHw,6,5,1,0,1,0,2,0,9,1.2857142857142858,2,0.0,0,1,0,1,5,0,0,2,0,2,7,1
5858,91357,CqJyXqN2l3WOJQLqxchvfRFp3seiLXw6,bWdj2GDclj5ofokWjzoa5jAwMkxCykd6,6,8,3,0,2,0,2,1,16,2.2857142857142856,1,0.0,3,3,0,2,5,0,0,2,1,8,8,1
5859,91358,za2dBkPPLD9IPRBjooK7GJit2ulI5UgN,RXDvfPUBYFlVdlueBFbLW0mhhAyGEqpt,1,0,0,0,0,0,1,0,1,0.14285714285714285,1,0.0,0,0,0,0,0,0,0,1,0,0,1,1
5860,91359,qlATuCCqDpQGO38aosxnvWXoyFwzEQc6,SpATywNh6bZuzm8s1ceuBUnMUAeoAHHw,1,0,0,0,0,0,1,0,1,0.14285714285714285,1,0.0,0,0,0,0,0,0,0,1,0,0,1,1
5861,91360,Y7IgoRAqVJfNlsulCSI4HObujHPSzoLA,bWdj2GDclj5ofokWjzoa5jAwMkxCykd6,16,31,16,18,9,1,9,0,84,12.0,3,0.0,9,16,15,9,22,1,3,9,0,49,35,1
5862,91363,LrkrvySxDPWP0dPv0sy62S8XY8vaxevX,SpATywNh6bZuzm8s1ceuBUnMUAeoAHHw,1,0,0,0,0,0,1,0,1,0.14285714285714285,1,0.0,0,0,0,0,0,0,0,1,0,0,1,1
5863,91364,PERCKVrZOUZ9ZmdU3J0Mwd1TZrMvK8yc,bWdj2GDclj5ofokWjzoa5jAwMkxCykd6,1,0,0,0,0,0,1,0,1,0.14285714285714285,1,0.0,0,0,0,0,0,0,0,1,0,0,1,1
5864,91370,A8jyl8S1kU5U2ikqJ1w16Eh9QcSPe3kU,bWdj2GDclj5ofokWjzoa5jAwMkxCykd6,10,6,2,36,1,14,9,0,68,9.714285714285714,3,0.0,1,2,35,1,5,14,1,9,0,39,29,1
5865,91372,KdRLGDNkLtrOcdNI9HZrV8CuGZ4u276z,SpATywNh6bZuzm8s1ceuBUnMUAeoAHHw,6,3,2,0,2,0,1,0,8,1.1428571428571428,1,0.0,0,2,0,2,3,0,0,1,0,4,4,1
5866,91378,2GLZl96ZIgoKdw26t6xniq9LngPm9HvA,RXDvfPUBYFlVdlueBFbLW0mhhAyGEqpt,1,0,0,0,0,0,1,0,1,0.14285714285714285,1,0.0,0,0,0,0,0,0,0,1,0,0,1,1
5867,91382,UmS6fyVqoZGfOpZXm4pjngyByXpv5BZq,SpATywNh6bZuzm8s1ceuBUnMUAeoAHHw,2,0,0,0,0,0,2,0,2,0.2857142857142857,1,0.0,0,0,0,0,0,0,0,2,0,0,2,1
5868,91400,mP7T5RBRG5ILBmmKKL1ktjST3p6gGZyD,G8EPVSXsOYB5YQWZGiz1aVq5Pgr2GrQu,27,33,16,54,10,8,17,3,141,20.142857142857142,2,0.0,7,16,46,10,26,8,8,17,3,79,62,0
5869,91402,95hqHTSw1gz1emf3tVFfyk36gKJr0SpD,SpATywNh6bZuzm8s1ceuBUnMUAeoAHHw,5,2,1,0,1,0,3,0,7,1.0,1,0.0,0,1,0,1,2,0,0,3,0,2,5,1
5870,91403,poUZo66KaOJLyZ89MU32hotzwVV9BV0u,SpATywNh6bZuzm8s1ceuBUnMUAeoAHHw,11,9,0,10,0,4,6,2,31,4.428571428571429,1,0.0,2,0,8,0,7,4,2,6,2,10,21,1
5871,91412,WS43utSG33bYCMf9KzrbX5AdwBBQGbjp,G8EPVSXsOYB5YQWZGiz1aVq5Pgr2GrQu,7,2,1,0,1,0,4,1,9,1.2857142857142858,1,0.0,0,1,0,1,2,0,0,4,1,2,7,1
5872,91418,guY4SSn1fy4TWThod7s2lBFrUtiOX15g,SpATywNh6bZuzm8s1ceuBUnMUAeoAHHw,1,0,0,0,0,0,1,0,1,0.14285714285714285,1,0.0,0,0,0,0,0,0,0,1,0,0,1,1
5873,91425,Kp4YCt5gbTMeLX4vxDVqvPhrGDdHDcEC,bWdj2GDclj5ofokWjzoa5jAwMkxCykd6,1,0,0,0,0,0,1,0,1,0.14285714285714285,1,0.0,0,0,0,0,0,0,0,1,0,0,1,1
5874,91440,FiJs6t54TQx94XiEoXWiArjFjkJV5FwV,SpATywNh6bZuzm8s1ceuBUnMUAeoAHHw,5,2,1,0,1,0,2,0,6,0.8571428571428571,1,0.0,0,1,0,1,2,0,0,2,0,2,4,1
5875,91443,KUB7X44VbEjxMDVZF3W29K5D0UgPC6KH,SpATywNh6bZuzm8s1ceuBUnMUAeoAHHw,1,0,0,0,0,0,1,0,1,0.14285714285714285,1,0.0,0,0,0,0,0,0,0,1,0,0,1,1
5876,91447,tf4ZGAY33jZAuxFy4GuZb8bCcW9cJu8C,SpATywNh6bZuzm8s1ceuBUnMUAeoAHHw,1,0,0,0,0,0,3,0,3,0.42857142857142855,1,0.0,0,0,0,0,0,0,0,3,0,0,3,1
5877,91448,IRULN38M25Cl78bawBWQTQjcpwpaaNDt,SpATywNh6bZuzm8s1ceuBUnMUAeoAHHw,20,37,0,34,0,2,11,4,88,12.571428571428571,3,0.0,15,0,28,0,22,2,6,11,4,43,45,1
5878,91455,iXxs6D3heezRYy4j7tliC14ux3klsjwX,SpATywNh6bZuzm8s1ceuBUnMUAeoAHHw,9,7,0,10,0,0,4,0,21,3.0,2,0.0,2,0,8,0,5,0,2,4,0,10,11,1
5879,91470,QGuKTIBC2KLaYpPdOnB4nXCWgxMM1Dog,SpATywNh6bZuzm8s1ceuBUnMUAeoAHHw,7,4,3,0,2,0,1,0,10,1.4285714285714286,1,0.0,0,3,0,2,4,0,0,1,0,5,5,0
5880,91476,TRCrdidmG6eXWyA1xpJbOiCViWff58Ia,RXDvfPUBYFlVdlueBFbLW0mhhAyGEqpt,35,26,16,42,11,1,6,0,102,14.571428571428571,2,0.0,5,16,39,11,21,1,3,6,0,71,31,1
5881,91479,7wwnUxCzQI2wyfpl5OyzTa3WTS3Ri45e,bWdj2GDclj5ofokWjzoa5jAwMkxCykd6,8,9,5,0,2,1,14,1,32,4.571428571428571,5,0.0,0,5,0,2,9,1,0,14,1,7,25,1
5882,91482,LOVxi1n45DRmVnmmx6W7w15Zc3W4DL9Q,SpATywNh6bZuzm8s1ceuBUnMUAeoAHHw,5,2,1,0,1,0,2,0,6,0.8571428571428571,1,0.0,0,1,0,1,2,0,0,2,0,2,4,1
5883,91485,iEQmrsDBbeOrnopk2RwtHZMbNkoYEU8q,SpATywNh6bZuzm8s1ceuBUnMUAeoAHHw,13,12,5,0,3,1,7,1,29,4.142857142857143,1,0.0,2,5,0,3,10,1,0,7,1,10,19,0
5884,91491,CwyOL3RMOVLomxrxyN9D4jPa9R0iWrS5,SpATywNh6bZuzm8s1ceuBUnMUAeoAHHw,15,11,5,7,3,1,10,1,38,5.428571428571429,2,0.0,4,5,7,3,7,1,0,10,1,19,19,1
5885,91494,Zdseq1rQmkAi5wZl57d3RwjzOxlL3B5I,bWdj2GDclj5ofokWjzoa5jAwMkxCykd6,1,0,0,0,0,0,1,0,1,0.14285714285714285,1,0.0,0,0,0,0,0,0,0,1,0,0,1,1
5886,91496,iX8db0h4bK73Weo8AP1BXtlfn6xSOf6w,bWdj2GDclj5ofokWjzoa5jAwMkxCykd6,6,7,4,0,2,0,7,0,20,2.857142857142857,2,0.0,1,4,0,2,6,0,0,7,0,7,13,1
5887,91500,cGHoibSqVUbVlKoJgTJL9GQ2AhPLVzAA,SpATywNh6bZuzm8s1ceuBUnMUAeoAHHw,5,2,1,0,1,0,2,0,6,0.8571428571428571,1,0.0,0,1,0,1,2,0,0,2,0,2,4,1
5888,91505,NjgQeSBBMWIwQySsR5ymtqiugkMaOyYh,SpATywNh6bZuzm8s1ceuBUnMUAeoAHHw,6,10,4,0,0,0,3,0,17,2.4285714285714284,1,0.0,1,4,0,0,9,0,0,3,0,5,12,1
5889,91508,CoIppafSfTN9XDj22SO0MlvO24IGW3qc,SpATywNh6bZuzm8s1ceuBUnMUAeoAHHw,5,3,1,0,1,0,2,0,7,1.0,1,0.0,0,1,0,1,3,0,0,2,0,2,5,1
5890,91509,sytW49I21SJ70ElOkXGU5SHeeHl1E3fL,bWdj2GDclj5ofokWjzoa5jAwMkxCykd6,9,7,3,4,1,0,9,2,26,3.7142857142857144,2,0.0,1,3,3,1,6,0,1,9,2,8,18,1
5891,91515,HMYpimZGFgj5IczDutkfjUfnxl45PoHW,bWdj2GDclj5ofokWjzoa5jAwMkxCykd6,12,20,12,0,6,1,8,1,48,6.857142857142857,3,0.0,3,12,0,6,17,1,0,8,1,21,27,1
5892,91519,INi9R682jCcjSCeRDCpuPIJvFgA3WCPK,SpATywNh6bZuzm8s1ceuBUnMUAeoAHHw,4,4,0,0,0,0,3,0,7,1.0,1,0.0,0,0,0,0,4,0,0,3,0,0,7,1
5893,91523,zTDlJM8GToOfxmvivD5zWrgVHrXjTey0,SpATywNh6bZuzm8s1ceuBUnMUAeoAHHw,5,3,1,0,1,0,1,0,6,0.8571428571428571,1,0.0,0,1,0,1,3,0,0,1,0,2,4,1
5894,91527,8Juk29xSxX3yy5MeVUlmmq4TGH5jCyZl,bWdj2GDclj5ofokWjzoa5jAwMkxCykd6,1,0,0,0,0,0,1,0,1,0.14285714285714285,1,0.0,0,0,0,0,0,0,0,1,0,0,1,1
5895,91546,4ZKN4qjeNhliROr2sm8vB8zmpPTrlPXO,bWdj2GDclj5ofokWjzoa5jAwMkxCykd6,1,0,0,0,0,0,1,0,1,0.14285714285714285,1,0.0,0,0,0,0,0,0,0,1,0,0,1,1
5896,91551,HRDkxtbUq1mjWiCFLcR4tjQW2mCEHxu4,RXDvfPUBYFlVdlueBFbLW0mhhAyGEqpt,18,25,14,0,9,8,20,13,89,12.714285714285714,2,0.0,3,14,0,9,22,8,0,20,13,26,63,1
5897,91553,95ZATSYX39rVcaPDxHBCcw9smfWWWOJE,G8EPVSXsOYB5YQWZGiz1aVq5Pgr2GrQu,4,2,0,0,0,0,2,0,4,0.5714285714285714,1,0.0,0,0,0,0,2,0,0,2,0,0,4,1
5898,91561,JaxQCd7UV5o1rvWxAibMy6iOMU3fCV5H,G8EPVSXsOYB5YQWZGiz1aVq5Pgr2GrQu,2,0,0,0,0,0,2,0,2,0.2857142857142857,1,0.0,0,0,0,0,0,0,0,2,0,0,2,1
5899,91563,CV9JyLcIlYcf3I8rF9dkDEhChf1GM9os,G8EPVSXsOYB5YQWZGiz1aVq5Pgr2GrQu,5,5,1,0,1,0,2,0,9,1.2857142857142858,1,0.0,0,1,0,1,5,0,0,2,0,2,7,1
5900,91565,Yc7DWSMOX4qXPZYRvYXJRnfQO7mqesrH,SpATywNh6bZuzm8s1ceuBUnMUAeoAHHw,9,8,2,8,1,0,2,0,21,3.0,1,0.0,4,2,6,1,4,0,2,2,0,13,8,1
5901,91571,M3CWdGPorPClU70a2twe6L8itu10pmZS,SpATywNh6bZuzm8s1ceuBUnMUAeoAHHw,1,0,0,0,0,0,1,0,1,0.14285714285714285,1,0.0,0,0,0,0,0,0,0,1,0,0,1,1
5902,91572,tl6eW0ZllZHnwqWfi7Wfg5VpXnj5pUEg,SpATywNh6bZuzm8s1ceuBUnMUAeoAHHw,15,11,5,12,3,0,4,0,35,5.0,1,0.0,4,5,10,3,7,0,2,4,0,22,13,1
5903,91575,nzicLrGs2CkHsGEmCwyxF4pye3Bqo62U,G8EPVSXsOYB5YQWZGiz1aVq5Pgr2GrQu,10,6,4,0,3,0,2,0,15,2.142857142857143,1,0.0,1,4,0,3,5,0,0,2,0,8,7,1
5904,91578,Zh7CYVhvtUUFf70foMQSgpBF0IOlRY9B,SpATywNh6bZuzm8s1ceuBUnMUAeoAHHw,5,2,1,0,1,0,2,0,6,0.8571428571428571,1,0.0,0,1,0,1,2,0,0,2,0,2,4,1
5905,91584,JBjA243ZRIqgCsAm61lG2qOhZbNcozpv,G8EPVSXsOYB5YQWZGiz1aVq5Pgr2GrQu,12,16,3,0,2,1,7,1,30,4.285714285714286,3,0.0,1,3,0,2,15,1,0,7,1,6,24,1
5906,91586,vOpj8ur6jA13uE8NuDJFu1oyU88RJP1w,bWdj2GDclj5ofokWjzoa5jAwMkxCykd6,4,4,0,0,0,0,1,0,5,0.7142857142857143,1,0.0,0,0,0,0,4,0,0,1,0,0,5,1
5907,91589,JBjA243ZRIqgCsAm61lG2qOhZbNcozpv,SpATywNh6bZuzm8s1ceuBUnMUAeoAHHw,5,5,1,0,0,0,4,0,10,1.4285714285714286,1,0.0,0,1,0,0,5,0,0,4,0,1,9,1
5908,91591,Jp26ywpmjw8PCn9zJ6Emr3JwxCXz1vqU,SpATywNh6bZuzm8s1ceuBUnMUAeoAHHw,14,21,1,18,1,9,10,0,60,8.571428571428571,4,0.0,2,1,15,1,19,9,3,10,0,19,41,1
5909,91592,rzAa0SbIuqxRiUHWVTPJbitOwzhhOEdv,G8EPVSXsOYB5YQWZGiz1aVq5Pgr2GrQu,8,16,7,6,0,0,4,0,33,4.714285714285714,1,0.0,6,7,5,0,10,0,1,4,0,18,15,1
5910,91593,PizUKf6mRUas66X3VMYXf9aygnN1CUCf,bWdj2GDclj5ofokWjzoa5jAwMkxCykd6,8,12,5,0,6,0,3,0,26,3.7142857142857144,1,0.0,5,5,0,6,7,0,0,3,0,16,10,1
5911,91595,gDaSFJD4b80GGtFaPG7wjh3sxtnlKrIT,SpATywNh6bZuzm8s1ceuBUnMUAeoAHHw,15,28,8,11,3,4,8,2,64,9.142857142857142,5,0.0,11,8,10,3,17,4,1,8,2,32,32,0
5912,91597,GsuSgvyvG4oCfnW3UaGKEeHZUImW7ybU,RXDvfPUBYFlVdlueBFbLW0mhhAyGEqpt,6,3,1,0,1,0,2,0,7,1.0,1,0.0,0,1,0,1,3,0,0,2,0,2,5,1
5913,92825,DuFXvlMxtAdxfnPOoOZpxEKgHTS36vNK,A3fsA9Zfv1X2fVEQhTw51lKENdNrEqT3,32,15,13,56,9,0,6,0,99,14.142857142857142,2,0.0,0,13,46,9,15,0,10,6,0,68,31,1
5914,92827,ZEbdtmjZoFNJAd6x9CZyfsFMmBEwQpXv,SpATywNh6bZuzm8s1ceuBUnMUAeoAHHw,13,11,8,0,5,1,7,1,33,4.714285714285714,2,0.0,0,8,0,5,11,1,0,7,1,13,20,1
5915,92860,msWTEJiXPD0IrE0kyLI7rGT23zUS4bM8,A3fsA9Zfv1X2fVEQhTw51lKENdNrEqT3,1,0,0,0,0,0,1,0,1,0.14285714285714285,1,0.0,0,0,0,0,0,0,0,1,0,0,1,1
5916,92870,nCB7ViHcbXHrq91Tw7AsIMYmLiKIa5Jv,A3fsA9Zfv1X2fVEQhTw51lKENdNrEqT3,4,1,0,0,0,0,5,0,6,0.8571428571428571,1,0.0,0,0,0,0,1,0,0,5,0,0,6,1
5917,92890,HJ2gv3yF0WCJxGH8T6tjLTFYdM4sCizz,SpATywNh6bZuzm8s1ceuBUnMUAeoAHHw,16,16,10,12,6,6,7,0,57,8.142857142857142,2,0.0,4,10,9,6,12,6,3,7,0,29,28,1
5918,92931,09jqR7IfvazajqsgYnjd0mGOuTyUXJmR,A3fsA9Zfv1X2fVEQhTw51lKENdNrEqT3,2,0,0,0,0,0,2,0,2,0.2857142857142857,1,0.0,0,0,0,0,0,0,0,2,0,0,2,1
5919,92933,Mf0xp5vhxE4EpnovGXm23q0TRlnpal5a,SpATywNh6bZuzm8s1ceuBUnMUAeoAHHw,1,0,0,0,0,0,1,0,1,0.14285714285714285,1,0.0,0,0,0,0,0,0,0,1,0,0,1,1
5920,92944,9HqwJ8d4m6K7QOSGhF3dVzXYAYpOl0vj,A3fsA9Zfv1X2fVEQhTw51lKENdNrEqT3,2,0,0,0,0,0,2,0,2,0.2857142857142857,1,0.0,0,0,0,0,0,0,0,2,0,0,2,1
5921,92947,xVCW9o5KqxAPnPVb1aenUpUZ6QWvEQCo,A3fsA9Zfv1X2fVEQhTw51lKENdNrEqT3,6,7,6,0,0,0,1,0,14,2.0,1,0.0,0,6,0,0,7,0,0,1,0,6,8,1
5922,92954,erkNYBqLpKRElyeL8GeAgO43CMazg6Rt,bWdj2GDclj5ofokWjzoa5jAwMkxCykd6,2,0,0,0,0,0,4,0,4,0.5714285714285714,1,0.0,0,0,0,0,0,0,0,4,0,0,4,1
5923,92957,DsdpjqDmkf4bB9F4w67WvhR5rXeY4BvC,bWdj2GDclj5ofokWjzoa5jAwMkxCykd6,11,18,7,0,6,27,11,1,70,10.0,1,0.0,7,7,0,6,11,27,0,11,1,20,50,1
5924,92960,3aETBFRObq3YeSOCDzQSdXdbqZJSuHf3,A3fsA9Zfv1X2fVEQhTw51lKENdNrEqT3,5,4,0,0,0,0,1,0,5,0.7142857142857143,1,0.0,0,0,0,0,4,0,0,1,0,0,5,1
5925,92962,4JgrlxTTs75mHh4mrh8qrfNDEELryL3p,bWdj2GDclj5ofokWjzoa5jAwMkxCykd6,12,15,6,18,42,0,4,0,85,12.142857142857142,1,0.0,2,6,16,42,13,0,2,4,0,66,19,1
5926,92968,eD22YcO1SJ996J45uu5dqIqwhKfXceL1,SpATywNh6bZuzm8s1ceuBUnMUAeoAHHw,3,2,1,0,1,0,0,0,4,0.5714285714285714,1,0.0,0,1,0,1,2,0,0,0,0,2,2,1
5927,92972,NXRVwFyxLXtyRtxM7ojyAnaiZQnhtjWO,SpATywNh6bZuzm8s1ceuBUnMUAeoAHHw,3,3,1,0,0,0,1,0,5,0.7142857142857143,1,0.0,0,1,0,0,3,0,0,1,0,1,4,1
5928,92975,mblW3W0a9cnUCcAYuJVrRwCReLzIZfZq,A3fsA9Zfv1X2fVEQhTw51lKENdNrEqT3,27,11,1,60,0,6,12,1,91,13.0,2,0.0,4,1,54,0,7,6,6,12,1,59,32,0
5929,92986,QKIVpxTYRwxpGiT6VdCFipdI87gZtHRH,SpATywNh6bZuzm8s1ceuBUnMUAeoAHHw,6,1,1,0,1,0,5,0,8,1.1428571428571428,1,0.0,0,1,0,1,1,0,0,5,0,2,6,1
5930,92988,niqjW4BciMttbwWr8wY84QzUCSHN5RSJ,G8EPVSXsOYB5YQWZGiz1aVq5Pgr2GrQu,1,0,0,0,0,0,1,0,1,0.14285714285714285,1,0.0,0,0,0,0,0,0,0,1,0,0,1,1
5931,92997,83JPfkin3GX4GLKqML2uaHSZ5KvsuJhM,SpATywNh6bZuzm8s1ceuBUnMUAeoAHHw,14,18,8,8,5,0,2,0,41,5.857142857142857,2,0.0,7,8,7,5,11,0,1,2,0,27,14,1
5932,93010,TMOi85sLkuYVgzErcEPoJc0AevPqR04B,RXDvfPUBYFlVdlueBFbLW0mhhAyGEqpt,17,21,11,14,4,11,10,1,72,10.285714285714286,5,0.0,3,11,11,4,18,11,3,10,1,29,43,1
5933,93012,PLJp2RYA7RZnQtREb0F5oRb3E0g7Z0Hr,G8EPVSXsOYB5YQWZGiz1aVq5Pgr2GrQu,2,0,0,0,0,0,2,0,2,0.2857142857142857,1,0.0,0,0,0,0,0,0,0,2,0,0,2,1
5934,93015,m9qgZNgP3Zn0sGVjbTdK1WyVxg0SzTDj,bWdj2GDclj5ofokWjzoa5jAwMkxCykd6,4,0,0,0,0,1,4,2,7,1.0,1,0.0,0,0,0,0,0,1,0,4,2,0,7,1
5935,93020,1RtjVFUMnRaIGZgXyyq9YVsVqwZO71yi,A3fsA9Zfv1X2fVEQhTw51lKENdNrEqT3,27,11,3,58,1,0,5,0,78,11.142857142857142,1,0.0,5,3,54,1,6,0,4,5,0,63,15,1
5936,93026,faeF4I5p3gAJMB1p4LfYVeCLQZKervYV,RXDvfPUBYFlVdlueBFbLW0mhhAyGEqpt,18,32,3,12,3,0,4,0,54,7.714285714285714,2,0.0,5,3,12,3,27,0,0,4,0,23,31,1
5937,93034,BIzXD84TaTFgXPtPL9bMALD9s3bgn0u7,SpATywNh6bZuzm8s1ceuBUnMUAeoAHHw,7,2,1,0,1,0,3,0,7,1.0,1,0.0,0,1,0,1,2,0,0,3,0,2,5,1
5938,93040,FlkgbrtKorC1nj2J8Ggbje7DCDtg1huD,A3fsA9Zfv1X2fVEQhTw51lKENdNrEqT3,5,4,2,0,1,0,4,0,11,1.5714285714285714,2,0.0,0,2,0,1,4,0,0,4,0,3,8,1
5939,93043,E5602d0htkVZGQTnJE6WlrGSkrgiKfR6,SpATywNh6bZuzm8s1ceuBUnMUAeoAHHw,2,0,0,0,0,0,2,0,2,0.2857142857142857,1,0.0,0,0,0,0,0,0,0,2,0,0,2,1
5940,93059,y5aIEV04Hqe57KpGOGn83CrEmVkQlotT,SpATywNh6bZuzm8s1ceuBUnMUAeoAHHw,4,2,0,0,0,1,2,0,5,0.7142857142857143,1,0.0,0,0,0,0,2,1,0,2,0,0,5,1
5941,93069,wxDnmvTLHWGwCYYCjH3qEOtgLqGKeB8y,bWdj2GDclj5ofokWjzoa5jAwMkxCykd6,2,0,0,0,0,0,3,0,3,0.42857142857142855,1,0.0,0,0,0,0,0,0,0,3,0,0,3,1
5942,93071,va3cVfF38XAjn4LEh6VxTTEdlP5IupZ2,bWdj2GDclj5ofokWjzoa5jAwMkxCykd6,1,0,0,0,0,0,1,0,1,0.14285714285714285,1,0.0,0,0,0,0,0,0,0,1,0,0,1,1
5943,93073,15L69MXCYIH8txiwXfgte6Bdad1p8M7U,SpATywNh6bZuzm8s1ceuBUnMUAeoAHHw,11,20,7,0,4,0,2,0,33,4.714285714285714,1,0.0,0,7,0,4,20,0,0,2,0,11,22,1
5944,93077,cnJW6igbDk7mivnYsxVZcWD5COwXKpJj,A3fsA9Zfv1X2fVEQhTw51lKENdNrEqT3,23,13,5,68,0,0,9,0,95,13.571428571428571,1,0.0,7,5,60,0,6,0,8,9,0,72,23,1
5945,93082,dPAuRkHCuQhCcbVNP1uiDIdfcWFQHP2t,SpATywNh6bZuzm8s1ceuBUnMUAeoAHHw,2,0,0,0,0,0,2,0,2,0.2857142857142857,1,0.0,0,0,0,0,0,0,0,2,0,0,2,1
5946,93106,28Xs6RIGljkwGIhsVvWB0d4RartQZhIp,SpATywNh6bZuzm8s1ceuBUnMUAeoAHHw,14,13,8,3,4,0,5,0,33,4.714285714285714,2,0.0,2,8,3,4,11,0,0,5,0,17,16,0
5947,93108,dBPTjHGtowbPnTOm514Emm9Jz5rIzrSj,SpATywNh6bZuzm8s1ceuBUnMUAeoAHHw,15,17,2,0,1,3,8,1,32,4.571428571428571,3,0.0,0,2,0,1,17,3,0,8,1,3,29,1
5948,93113,QOWLFnVTxLvLint3QUq9XwfNiIwpTPjR,G8EPVSXsOYB5YQWZGiz1aVq5Pgr2GrQu,6,2,1,0,1,0,3,0,7,1.0,1,0.0,0,1,0,1,2,0,0,3,0,2,5,1
5949,93128,OTVmyM3oMOEh3RPUJ9JvZ1cqJuClk9Op,A3fsA9Zfv1X2fVEQhTw51lKENdNrEqT3,13,24,11,0,5,1,6,1,48,6.857142857142857,2,0.0,2,11,0,5,22,1,0,6,1,18,30,1
5950,93151,Co9dycRC3nnJN4rm3WsLzyk3Mwz3zosU,SpATywNh6bZuzm8s1ceuBUnMUAeoAHHw,10,26,0,15,0,9,6,0,56,8.0,3,0.0,5,0,14,0,21,9,1,6,0,19,37,1
5951,93166,wjcBLe1692KFPJUkCwcKQrXvoLbsDg0j,A3fsA9Zfv1X2fVEQhTw51lKENdNrEqT3,6,5,2,0,2,0,1,0,10,1.4285714285714286,1,0.0,0,2,0,2,5,0,0,1,0,4,6,1
5952,93206,JtMmp5BCDQnYE7CMI3NvnX4aRCZsQW9K,RXDvfPUBYFlVdlueBFbLW0mhhAyGEqpt,1,0,0,0,0,0,2,0,2,0.2857142857142857,2,0.0,0,0,0,0,0,0,0,2,0,0,2,1
5953,93207,E7aYibTjzxGSk6NL3yeJVWuk7dqVnncv,bWdj2GDclj5ofokWjzoa5jAwMkxCykd6,4,5,2,0,2,0,1,0,10,1.4285714285714286,1,0.0,0,2,0,2,5,0,0,1,0,4,6,1
5954,93210,O9DTMIbbKOPsa4B7k1STk0nNuSR3cdx2,SpATywNh6bZuzm8s1ceuBUnMUAeoAHHw,3,2,0,0,0,0,2,0,4,0.5714285714285714,2,0.0,0,0,0,0,2,0,0,2,0,0,4,1
5955,93215,iCEb35gaygczCVXBPDGlI3sXrSsDaVej,A3fsA9Zfv1X2fVEQhTw51lKENdNrEqT3,1,0,0,0,0,0,1,0,1,0.14285714285714285,1,0.0,0,0,0,0,0,0,0,1,0,0,1,1
5956,93221,BhaFO7Lx4Q4YbNxvEeo9nBTXjsmsEz6c,SpATywNh6bZuzm8s1ceuBUnMUAeoAHHw,10,9,6,0,4,0,4,0,23,3.2857142857142856,2,0.0,0,6,0,4,9,0,0,4,0,10,13,1
5957,93225,mWv2aD1lbqJSR5LQ8znxXgNEw4RCzno5,bWdj2GDclj5ofokWjzoa5jAwMkxCykd6,1,0,0,0,0,0,1,0,1,0.14285714285714285,1,0.0,0,0,0,0,0,0,0,1,0,0,1,1
5958,93235,epvD2Wcl45J2GdVoBHzahVMdghFLent2,A3fsA9Zfv1X2fVEQhTw51lKENdNrEqT3,8,6,5,0,5,0,2,0,18,2.5714285714285716,1,0.0,0,5,0,5,6,0,0,2,0,10,8,1
5959,93249,yqsIVJwLxHRAX79gd7ST37Kksa5nD2Lx,SpATywNh6bZuzm8s1ceuBUnMUAeoAHHw,4,8,0,0,0,0,2,0,10,1.4285714285714286,1,0.0,0,0,0,0,8,0,0,2,0,0,10,1
5960,93294,zGuA1mMLvM3gfcKciKtoyFo6318fINqG,SpATywNh6bZuzm8s1ceuBUnMUAeoAHHw,1,0,0,0,0,0,1,0,1,0.14285714285714285,1,0.0,0,0,0,0,0,0,0,1,0,0,1,1
5961,93313,MU7wboUY4X1pw35YtYq9QO37Sakj8O8C,SpATywNh6bZuzm8s1ceuBUnMUAeoAHHw,6,5,3,0,3,0,1,0,12,1.7142857142857142,1,0.0,0,3,0,3,5,0,0,1,0,6,6,1
5962,93326,x6oT9QqDd4S0kTW1QntTwdbJd7rGTsDd,G8EPVSXsOYB5YQWZGiz1aVq5Pgr2GrQu,40,38,26,44,14,8,9,1,140,20.0,1,0.0,7,26,40,14,31,8,4,9,1,87,53,1
5963,93335,6WDAV2K5JXtsN5Y7oVoYno0rdPlDVwAS,SpATywNh6bZuzm8s1ceuBUnMUAeoAHHw,12,33,10,1,8,0,22,0,74,10.571428571428571,3,0.0,1,10,1,8,32,0,0,22,0,20,54,1
5964,93336,J9IFZ6lJS0kAA8VxmLEtsSsATCVlFyib,A3fsA9Zfv1X2fVEQhTw51lKENdNrEqT3,9,5,0,0,0,0,8,1,14,2.0,1,0.0,0,0,0,0,5,0,0,8,1,0,14,1
5965,93338,J9IFZ6lJS0kAA8VxmLEtsSsATCVlFyib,G8EPVSXsOYB5YQWZGiz1aVq5Pgr2GrQu,3,0,0,0,0,0,6,0,6,0.8571428571428571,2,0.0,0,0,0,0,0,0,0,6,0,0,6,1
5966,93346,b3ww03gxsETlWqnhgdTKJu0odbTVWElw,SpATywNh6bZuzm8s1ceuBUnMUAeoAHHw,1,0,0,0,0,0,1,0,1,0.14285714285714285,1,0.0,0,0,0,0,0,0,0,1,0,0,1,1
5967,93347,xfIcqx8ftYruTYGt1LiJYX4e8qkp171D,A3fsA9Zfv1X2fVEQhTw51lKENdNrEqT3,6,5,0,0,0,0,2,0,7,1.0,1,0.0,0,0,0,0,5,0,0,2,0,0,7,1
5968,93351,cwBiyXmdgaiw26TEVXDuCjvVYFCLKOa1,SpATywNh6bZuzm8s1ceuBUnMUAeoAHHw,6,14,3,0,1,0,1,0,19,2.7142857142857144,1,0.0,10,3,0,1,4,0,0,1,0,14,5,1
5969,93356,QKPOTPLCFSSptakTWL9scYXAQmH9VPoV,A3fsA9Zfv1X2fVEQhTw51lKENdNrEqT3,4,2,1,0,1,0,1,0,5,0.7142857142857143,1,0.0,0,1,0,1,2,0,0,1,0,2,3,1
5970,93373,rdlkz4QUHd85FYWQkxx9tuSVm08spAcj,A3fsA9Zfv1X2fVEQhTw51lKENdNrEqT3,11,5,3,0,3,0,3,0,14,2.0,1,0.0,0,3,0,3,5,0,0,3,0,6,8,1
5971,93374,AN1pw84sOSfQ3KFcxuCbDy0hYOBni6dp,G8EPVSXsOYB5YQWZGiz1aVq5Pgr2GrQu,23,30,11,34,3,0,10,0,88,12.571428571428571,1,0.0,12,11,24,3,18,0,10,10,0,50,38,1
5972,93383,YyNcczfjJii4HexOcQkp0MHeatr8c5sB,bWdj2GDclj5ofokWjzoa5jAwMkxCykd6,4,3,0,0,0,0,2,0,5,0.7142857142857143,1,0.0,0,0,0,0,3,0,0,2,0,0,5,1
5973,93384,1M4xACtMIoM8zWBXmaYDVcE8Iy4RYZ8e,G8EPVSXsOYB5YQWZGiz1aVq5Pgr2GrQu,13,13,2,10,1,3,14,1,44,6.285714285714286,2,0.0,5,2,7,1,8,3,3,14,1,15,29,1
5974,93387,HWAJhvF3LR86qA3qhHJiqZmQp4teUKAm,G8EPVSXsOYB5YQWZGiz1aVq5Pgr2GrQu,31,53,0,94,5,2,2,0,156,22.285714285714285,1,0.0,40,0,66,5,13,2,28,2,0,111,45,1
5975,93399,8LtTXy2ZLwBwWwH4BENA0Wiv8pjMa9RP,SpATywNh6bZuzm8s1ceuBUnMUAeoAHHw,11,18,0,10,0,6,3,0,37,5.285714285714286,1,0.0,9,0,8,0,9,6,2,3,0,17,20,1
5976,93402,wRuDkiFKsIS1XayC3m2MgIyWR2x1W3i6,A3fsA9Zfv1X2fVEQhTw51lKENdNrEqT3,6,3,1,0,1,0,3,0,8,1.1428571428571428,1,0.0,0,1,0,1,3,0,0,3,0,2,6,1
5977,93404,eT5JmMMKMcNoJjMWrJaUqOJQSpR601jL,A3fsA9Zfv1X2fVEQhTw51lKENdNrEqT3,4,2,1,0,1,0,5,0,9,1.2857142857142858,2,0.0,0,1,0,1,2,0,0,5,0,2,7,1
5978,93414,LiD14ALXLddUqpdQnujGFxQiBSoJOZGF,bWdj2GDclj5ofokWjzoa5jAwMkxCykd6,21,55,7,122,3,3,29,0,219,31.285714285714285,8,0.0,10,7,114,3,45,3,8,29,0,134,85,0
5979,93415,CiJGHZYjg5XVOtN8y1aUHiZjaXvVvsf8,bWdj2GDclj5ofokWjzoa5jAwMkxCykd6,5,3,1,0,1,0,5,0,10,1.4285714285714286,3,0.0,0,1,0,1,3,0,0,5,0,2,8,1
5980,93416,NFwkvwlecWBzcgNCOvBMTCkkUA7P9cK8,bWdj2GDclj5ofokWjzoa5jAwMkxCykd6,6,7,3,0,1,0,4,0,15,2.142857142857143,2,0.0,0,3,0,1,7,0,0,4,0,4,11,1
5981,93417,C6OkpqYGxZDK55uJrTXLk64MO2W2kN6e,SpATywNh6bZuzm8s1ceuBUnMUAeoAHHw,1,0,0,0,0,0,1,0,1,0.14285714285714285,1,0.0,0,0,0,0,0,0,0,1,0,0,1,1
5982,93422,HcOpBFh3ZPBJu7PjBFffM3Zedw54RSXN,A3fsA9Zfv1X2fVEQhTw51lKENdNrEqT3,4,8,2,0,0,0,2,0,12,1.7142857142857142,3,0.0,0,2,0,0,8,0,0,2,0,2,10,1
5983,93426,Hc0D2UkydjyUi3vnnsfmiB8lOnMbIWKo,SpATywNh6bZuzm8s1ceuBUnMUAeoAHHw,4,2,1,0,1,0,1,0,5,0.7142857142857143,1,0.0,0,1,0,1,2,0,0,1,0,2,3,0
5984,93434,BCPOhUa2LrfH93ebCE15VbF0VEWEyi7T,SpATywNh6bZuzm8s1ceuBUnMUAeoAHHw,6,3,2,0,2,0,1,0,8,1.1428571428571428,1,0.0,0,2,0,2,3,0,0,1,0,4,4,0
5985,93437,lmx2t8WuCRr4yPlE96c0Hld3ah69yimY,SpATywNh6bZuzm8s1ceuBUnMUAeoAHHw,8,16,2,17,0,26,2,0,63,9.0,1,0.0,14,2,15,0,2,26,2,2,0,31,32,1
5986,93444,wfUVHBmDLe0V8vTm9YNAi5Eoe98kipNK,RXDvfPUBYFlVdlueBFbLW0mhhAyGEqpt,15,22,1,0,1,0,6,4,34,4.857142857142857,2,0.0,4,1,0,1,18,0,0,6,4,6,28,1
5987,93454,IdPM07Tobfo8uXfAGdfrnlSPQUjcS5lw,SpATywNh6bZuzm8s1ceuBUnMUAeoAHHw,15,15,7,15,4,3,7,2,53,7.571428571428571,2,0.0,5,7,13,4,10,3,2,7,2,29,24,1
5988,93461,iNqMxLUew1d2DW8l74urvD3s2ojQNcOj,G8EPVSXsOYB5YQWZGiz1aVq5Pgr2GrQu,9,6,1,0,1,0,3,0,11,1.5714285714285714,2,0.0,0,1,0,1,6,0,0,3,0,2,9,1
5989,93463,KnjIylBxQGK5ybTZHRQCIOf6LVaiEDiE,SpATywNh6bZuzm8s1ceuBUnMUAeoAHHw,17,21,9,14,6,56,8,0,114,16.285714285714285,3,0.0,10,9,11,6,11,56,3,8,0,36,78,1
5990,93476,XiRokcstRgTAoxw5fli1EiomcYln51fR,bWdj2GDclj5ofokWjzoa5jAwMkxCykd6,4,3,0,0,0,0,5,0,8,1.1428571428571428,1,0.0,1,0,0,0,2,0,0,5,0,1,7,1
5991,93478,ouHHL7JxNnPJ7sZc8oGHgugCfHuyBFzn,bWdj2GDclj5ofokWjzoa5jAwMkxCykd6,8,10,6,0,4,0,2,0,22,3.142857142857143,3,0.0,0,6,0,4,10,0,0,2,0,10,12,1
5992,93497,QcZtDJ3gyfgBjK6fnA4Umq8WcjzDqlhe,A3fsA9Zfv1X2fVEQhTw51lKENdNrEqT3,1,0,0,0,0,0,1,0,1,0.14285714285714285,1,0.0,0,0,0,0,0,0,0,1,0,0,1,1
5993,93504,vaOIevkYLsk4A7wWmrPXcGrOKX6OgVbB,G8EPVSXsOYB5YQWZGiz1aVq5Pgr2GrQu,12,4,3,0,3,1,5,1,17,2.4285714285714284,1,0.0,0,3,0,3,4,1,0,5,1,6,11,1
5994,93513,yuqYkP52C7pQOIQ48GEgTRDqcNtFSeb3,bWdj2GDclj5ofokWjzoa5jAwMkxCykd6,22,29,13,38,7,37,21,1,146,20.857142857142858,4,0.0,8,13,35,7,21,37,3,21,1,63,83,1
5995,93517,1yALM9xjClF6jgXaABxhrYNC8eb8bQ9n,bWdj2GDclj5ofokWjzoa5jAwMkxCykd6,18,31,16,34,8,14,6,0,109,15.571428571428571,2,0.0,6,16,30,8,25,14,4,6,0,60,49,1
5996,93518,I3RIPLupgcaFBN4TZgx1kwE7cqUmhNGE,SpATywNh6bZuzm8s1ceuBUnMUAeoAHHw,5,2,1,0,1,0,2,0,6,0.8571428571428571,1,0.0,0,1,0,1,2,0,0,2,0,2,4,1
5997,93519,lUW6V1mqrGSz0okgfju4Oi2AssrcTWTN,bWdj2GDclj5ofokWjzoa5jAwMkxCykd6,12,6,4,0,3,1,8,0,22,3.142857142857143,2,0.0,0,4,0,3,6,1,0,8,0,7,15,1
5998,93520,caAQbOI1NkkZKVF3oGPK3OdsY0lbDlYb,bWdj2GDclj5ofokWjzoa5jAwMkxCykd6,6,2,1,0,1,1,5,2,12,1.7142857142857142,1,0.0,0,1,0,1,2,1,0,5,2,2,10,1
5999,93523,7KhKGJPxu4uQKYHNs7O3NjmuTH6NjrVY,A3fsA9Zfv1X2fVEQhTw51lKENdNrEqT3,10,6,4,0,3,0,6,0,19,2.7142857142857144,1,0.0,0,4,0,3,6,0,0,6,0,7,12,0
6000,93525,SI82rbAOql23YmOWiXWAc0dEkHYrXScg,SpATywNh6bZuzm8s1ceuBUnMUAeoAHHw,8,4,1,0,1,3,5,0,14,2.0,1,0.0,0,1,0,1,4,3,0,5,0,2,12,1
6001,93529,K5WcXRk24XKmzfaggLfniRGhO7RrNYwU,SpATywNh6bZuzm8s1ceuBUnMUAeoAHHw,13,15,8,12,6,0,1,0,42,6.0,1,0.0,6,8,12,6,9,0,0,1,0,32,10,0
6002,93531,RHEMdhoy3TVz84IqO3CiO0ZVmx7sjl4N,A3fsA9Zfv1X2fVEQhTw51lKENdNrEqT3,41,20,13,65,10,0,9,0,117,16.714285714285715,2,0.0,1,13,52,10,19,0,13,9,0,76,41,0
6003,93538,oUwdPVwTRYLcPpw0ARjn83xyQKxe2P4j,A3fsA9Zfv1X2fVEQhTw51lKENdNrEqT3,8,15,0,0,0,0,4,0,19,2.7142857142857144,1,0.0,0,0,0,0,15,0,0,4,0,0,19,1
6004,93558,wjcBLe1692KFPJUkCwcKQrXvoLbsDg0j,bWdj2GDclj5ofokWjzoa5jAwMkxCykd6,3,3,1,0,0,0,1,0,5,0.7142857142857143,1,0.0,0,1,0,0,3,0,0,1,0,1,4,1
6005,93559,kQHHmjfVeHdUMEjst4rHDTfMZ6Hq7zy6,G8EPVSXsOYB5YQWZGiz1aVq5Pgr2GrQu,21,36,13,56,5,0,11,1,122,17.428571428571427,3,0.0,15,13,49,5,21,0,7,11,1,82,40,1
6006,93567,GWCKXkmUMNA4NMWmbV0iY9p0NnvUAuFf,SpATywNh6bZuzm8s1ceuBUnMUAeoAHHw,2,0,0,0,0,0,2,0,2,0.2857142857142857,1,0.0,0,0,0,0,0,0,0,2,0,0,2,1
6007,93576,kWRi0bjTsOLXCT3B1x0edeUqfKik54ld,SpATywNh6bZuzm8s1ceuBUnMUAeoAHHw,7,3,2,0,2,0,2,0,9,1.2857142857142858,1,0.0,0,2,0,2,3,0,0,2,0,4,5,1
6008,93583,3RcsrMTbPrb8ZHYXLlgwoRK7zrqTGSuq,A3fsA9Zfv1X2fVEQhTw51lKENdNrEqT3,22,17,13,2,11,0,4,0,47,6.714285714285714,1,0.0,3,13,2,11,14,0,0,4,0,29,18,1
6009,93594,SI82rbAOql23YmOWiXWAc0dEkHYrXScg,G8EPVSXsOYB5YQWZGiz1aVq5Pgr2GrQu,6,1,1,0,1,0,3,0,6,0.8571428571428571,1,0.0,0,1,0,1,1,0,0,3,0,2,4,1
6010,93601,auyTDueRbJJVbSgkNfSzePWA0sXDjoDA,A3fsA9Zfv1X2fVEQhTw51lKENdNrEqT3,5,4,0,0,0,0,4,0,8,1.1428571428571428,1,0.0,0,0,0,0,4,0,0,4,0,0,8,1
6011,93608,XIhNBV2ngE6VH3B3rFCGmtxUmfBaQQAu,bWdj2GDclj5ofokWjzoa5jAwMkxCykd6,2,0,0,0,0,0,4,0,4,0.5714285714285714,1,0.0,0,0,0,0,0,0,0,4,0,0,4,1
6012,93612,iKQWUg85b7iQVNDnFW3yVIr4MRSX1OiM,SpATywNh6bZuzm8s1ceuBUnMUAeoAHHw,9,4,4,0,4,0,4,0,16,2.2857142857142856,2,0.0,0,4,0,4,4,0,0,4,0,8,8,1
6013,93613,5zmdkrLCsYposTlmADCtPSCtqJszOFSq,A3fsA9Zfv1X2fVEQhTw51lKENdNrEqT3,17,11,8,0,5,1,6,0,31,4.428571428571429,2,0.0,0,8,0,5,11,1,0,6,0,13,18,1
6014,93623,SetmDwaBCsbTdPHVqtt90lo6lvXmXkbh,RXDvfPUBYFlVdlueBFbLW0mhhAyGEqpt,2,0,0,0,0,0,2,0,2,0.2857142857142857,1,0.0,0,0,0,0,0,0,0,2,0,0,2,1
6015,93634,hjHWaXhruoFaGhRZCz2Vsvz3ABLehqZ4,bWdj2GDclj5ofokWjzoa5jAwMkxCykd6,5,2,1,0,1,0,3,0,7,1.0,1,0.0,0,1,0,1,2,0,0,3,0,2,5,1
6016,93641,3NITGQuylcrTi63aoWqnzXuF5Rtf7QVq,A3fsA9Zfv1X2fVEQhTw51lKENdNrEqT3,37,13,11,80,10,0,1,0,115,16.428571428571427,1,0.0,1,11,69,10,12,0,11,1,0,91,24,1
6017,93642,87SYGQjFYUtEWda0pG12bcNker0JGBy3,A3fsA9Zfv1X2fVEQhTw51lKENdNrEqT3,5,7,0,0,0,0,1,0,8,1.1428571428571428,1,0.0,0,0,0,0,7,0,0,1,0,0,8,1
6018,93647,GyNkIVOso2X6ndPFrPZ0dYdTkjhdba2Q,G8EPVSXsOYB5YQWZGiz1aVq5Pgr2GrQu,10,11,3,0,3,0,7,0,24,3.4285714285714284,2,0.0,2,3,0,3,9,0,0,7,0,8,16,1
6019,93654,FFnoMDhUnJZ86LrCRa50JPybQorDvh89,RXDvfPUBYFlVdlueBFbLW0mhhAyGEqpt,10,10,7,0,3,0,4,0,24,3.4285714285714284,3,0.0,1,7,0,3,9,0,0,4,0,11,13,1
6020,93664,wmwDf7eIRrKPL0l8cNmMygnEPd5vzoqs,A3fsA9Zfv1X2fVEQhTw51lKENdNrEqT3,10,7,0,0,0,2,9,2,20,2.857142857142857,2,0.0,1,0,0,0,6,2,0,9,2,1,19,1
6021,93665,OCOZunZP01no4Zh4NYF1FDXoOWZrc1Yv,SpATywNh6bZuzm8s1ceuBUnMUAeoAHHw,10,16,2,26,2,0,1,0,47,6.714285714285714,1,0.0,11,2,21,2,5,0,5,1,0,36,11,1
6022,93668,wmwDf7eIRrKPL0l8cNmMygnEPd5vzoqs,bWdj2GDclj5ofokWjzoa5jAwMkxCykd6,8,7,1,0,0,1,6,1,16,2.2857142857142856,2,0.0,0,1,0,0,7,1,0,6,1,1,15,1
6023,93698,F3pS3HhR6zAyElkIe1WFx5cvIXH3Mmjf,SpATywNh6bZuzm8s1ceuBUnMUAeoAHHw,1,0,0,0,0,0,1,0,1,0.14285714285714285,1,0.0,0,0,0,0,0,0,0,1,0,0,1,1
6024,93711,VvbZjK8y9aernnsSHvAW377h2uAEkOuF,RXDvfPUBYFlVdlueBFbLW0mhhAyGEqpt,2,0,0,0,0,0,2,0,2,0.2857142857142857,1,0.0,0,0,0,0,0,0,0,2,0,0,2,1
6025,93728,GZzbpBGluNcEXFZ9BEQgqFPzH6qJC8rT,SpATywNh6bZuzm8s1ceuBUnMUAeoAHHw,13,21,3,8,1,0,8,1,42,6.0,3,0.0,0,3,7,1,21,0,1,8,1,11,31,1
6026,93733,vSy2YWE0W8axNgPS8DBIlQoMQuLcT6wu,G8EPVSXsOYB5YQWZGiz1aVq5Pgr2GrQu,2,0,0,0,0,0,2,0,2,0.2857142857142857,1,0.0,0,0,0,0,0,0,0,2,0,0,2,1
6027,93734,J2Ryyq6g6TjnFue1VPNlM9zNmZVB3792,SpATywNh6bZuzm8s1ceuBUnMUAeoAHHw,6,3,1,0,1,0,2,0,7,1.0,1,0.0,0,1,0,1,3,0,0,2,0,2,5,1
6028,93744,ROmxIDt1Nv5jCVXIVh1nfk5f1b4KKNIR,bWdj2GDclj5ofokWjzoa5jAwMkxCykd6,8,6,3,0,2,0,6,0,17,2.4285714285714284,2,0.0,0,3,0,2,6,0,0,6,0,5,12,1
6029,93756,KO9zYaiac2CNagQLdx3aJ9c2fXXMgIJX,SpATywNh6bZuzm8s1ceuBUnMUAeoAHHw,14,20,9,11,5,0,5,0,50,7.142857142857143,4,0.0,4,9,11,5,16,0,0,5,0,29,21,1
6030,93774,2AXxkCmyE7acjKrdHA94DKX4eMigeF9j,A3fsA9Zfv1X2fVEQhTw51lKENdNrEqT3,14,8,6,0,6,0,3,0,23,3.2857142857142856,2,0.0,0,6,0,6,8,0,0,3,0,12,11,1
6031,93781,seYLwHio53k0mOFj19dZ5TEGXq5ADUux,SpATywNh6bZuzm8s1ceuBUnMUAeoAHHw,5,2,1,0,0,0,6,0,9,1.2857142857142858,1,0.0,0,1,0,0,2,0,0,6,0,1,8,1
6032,93787,QOHFX3G0atWVkV8bdUDLZP6MvVAU1bxE,A3fsA9Zfv1X2fVEQhTw51lKENdNrEqT3,7,5,0,0,0,0,7,0,12,1.7142857142857142,2,0.0,0,0,0,0,5,0,0,7,0,0,12,1
6033,93789,bFxkSwC4B7FuMDmZm2HkHgiHz8QC2hPC,A3fsA9Zfv1X2fVEQhTw51lKENdNrEqT3,9,11,5,0,3,0,2,0,21,3.0,1,0.0,0,5,0,3,11,0,0,2,0,8,13,1
6034,93799,SvayS3hRjiQUsZJZ3Z80XuRW7pnvNCGH,SpATywNh6bZuzm8s1ceuBUnMUAeoAHHw,25,46,4,18,3,20,21,4,116,16.571428571428573,3,0.0,8,4,17,3,38,20,1,21,4,32,84,1
6035,93814,uHLnVmnvVGRf9UQIVsgUkoIvLInqWS41,RXDvfPUBYFlVdlueBFbLW0mhhAyGEqpt,35,83,43,32,26,5,26,3,218,31.142857142857142,3,0.0,9,43,30,26,74,5,2,26,3,108,110,1
6036,93818,CYf5wdcurcSyhJdbx09KiN2Kzj9VLvNU,SpATywNh6bZuzm8s1ceuBUnMUAeoAHHw,1,0,0,0,0,0,1,0,1,0.14285714285714285,1,0.0,0,0,0,0,0,0,0,1,0,0,1,1
6037,93821,O2RP4lI2hqQTYW7uUxK7lTmJyXECBert,SpATywNh6bZuzm8s1ceuBUnMUAeoAHHw,4,2,1,0,1,0,1,0,5,0.7142857142857143,1,0.0,0,1,0,1,2,0,0,1,0,2,3,1
6038,93835,D98GkCb5yOnLtlLtWNWnUK2keXt1DRWI,A3fsA9Zfv1X2fVEQhTw51lKENdNrEqT3,2,0,0,0,0,0,2,0,2,0.2857142857142857,1,0.0,0,0,0,0,0,0,0,2,0,0,2,1
6039,93843,OMmdzdRtTLASG3chso9cdfg94JQDfZqt,SpATywNh6bZuzm8s1ceuBUnMUAeoAHHw,11,15,5,2,3,0,3,0,28,4.0,3,0.0,2,5,2,3,13,0,0,3,0,12,16,1
6040,93860,iDEg223wPLRjblw05XWiNlNB0XKXbAH3,SpATywNh6bZuzm8s1ceuBUnMUAeoAHHw,8,4,2,0,1,0,6,1,14,2.0,1,0.0,0,2,0,1,4,0,0,6,1,3,11,1
6041,93862,MdwJcKhWKSfBlz1JQsWSYPZY8VplWXai,SpATywNh6bZuzm8s1ceuBUnMUAeoAHHw,2,0,0,0,0,0,2,0,2,0.2857142857142857,1,0.0,0,0,0,0,0,0,0,2,0,0,2,1
6042,93863,Ac4OXBvc7WZ07azvF8LolPbeFPCXH5U0,SpATywNh6bZuzm8s1ceuBUnMUAeoAHHw,1,0,0,0,0,0,1,0,1,0.14285714285714285,1,0.0,0,0,0,0,0,0,0,1,0,0,1,1
6043,93879,qT6iwsUe27SkWCpThee9QunElnsrIqyP,SpATywNh6bZuzm8s1ceuBUnMUAeoAHHw,16,18,6,14,3,0,8,0,49,7.0,3,0.0,7,6,13,3,11,0,1,8,0,29,20,1
6044,93881,wKKdkZJ3MevUShYy00jn3yNZpY2kcdrV,A3fsA9Zfv1X2fVEQhTw51lKENdNrEqT3,4,1,0,0,0,0,3,0,4,0.5714285714285714,1,0.0,0,0,0,0,1,0,0,3,0,0,4,0
6045,93900,L1FTG9TM6RI5TBCTexQgshQhXhu2oZpJ,A3fsA9Zfv1X2fVEQhTw51lKENdNrEqT3,41,21,15,46,10,0,11,0,103,14.714285714285714,5,0.0,1,15,45,10,20,0,1,11,0,71,32,0
6046,93903,L1FTG9TM6RI5TBCTexQgshQhXhu2oZpJ,G8EPVSXsOYB5YQWZGiz1aVq5Pgr2GrQu,44,39,18,74,14,0,4,0,149,21.285714285714285,2,0.0,15,18,68,14,24,0,6,4,0,115,34,1
6047,93906,df9qJcc4auTr14t9gsIjmvQwAgkzyFuV,SpATywNh6bZuzm8s1ceuBUnMUAeoAHHw,6,2,1,0,1,0,3,0,7,1.0,1,0.0,0,1,0,1,2,0,0,3,0,2,5,1
6048,93917,MyQ8e9mBKn27AhY70WumCof36bw293Y4,SpATywNh6bZuzm8s1ceuBUnMUAeoAHHw,16,24,7,17,3,4,7,0,62,8.857142857142858,3,0.0,12,7,13,3,12,4,4,7,0,35,27,1
6049,93918,oW89eJD99A7pCOqqvTkgIt7CVSu0bGbe,SpATywNh6bZuzm8s1ceuBUnMUAeoAHHw,8,5,2,0,1,0,6,0,14,2.0,1,0.0,0,2,0,1,5,0,0,6,0,3,11,1
6050,93920,EJ6j1DQBzD1orM5Ltf8vXiAVi2YaVKj4,A3fsA9Zfv1X2fVEQhTw51lKENdNrEqT3,12,16,7,0,6,0,1,0,30,4.285714285714286,1,0.0,0,7,0,6,16,0,0,1,0,13,17,1
6051,93924,QrJQFROnKZICXeQTI0yD9R5uKCsOiaxB,bWdj2GDclj5ofokWjzoa5jAwMkxCykd6,5,3,1,0,1,0,2,0,7,1.0,1,0.0,0,1,0,1,3,0,0,2,0,2,5,1
6052,93928,grEUheAl7r2qUdLFFy9nEMsG9X5GQrvY,SpATywNh6bZuzm8s1ceuBUnMUAeoAHHw,17,16,7,7,5,1,6,1,43,6.142857142857143,1,0.0,7,7,7,5,9,1,0,6,1,26,17,1
6053,93937,2j0Susczy7BF2QnNLUm3dJdUMP10ntAU,SpATywNh6bZuzm8s1ceuBUnMUAeoAHHw,16,19,12,9,3,0,9,2,54,7.714285714285714,2,0.0,2,12,8,3,17,0,1,9,2,25,29,1
6054,93949,pQdqlOtxi2sBVu8vnQy738Mf4LOYprkG,SpATywNh6bZuzm8s1ceuBUnMUAeoAHHw,5,2,1,0,1,0,3,0,7,1.0,1,0.0,0,1,0,1,2,0,0,3,0,2,5,1
6055,93951,Ei65KRTqH4vAZu2hVbuPfr6ybTjVLWsx,SpATywNh6bZuzm8s1ceuBUnMUAeoAHHw,12,19,7,0,6,0,4,0,36,5.142857142857143,2,0.0,7,7,0,6,12,0,0,4,0,20,16,1
6056,93967,XyD01HhzMuHzP5ArHNJFexoSZMamD6Wh,SpATywNh6bZuzm8s1ceuBUnMUAeoAHHw,14,17,8,16,5,1,3,0,50,7.142857142857143,2,0.0,7,8,14,5,10,1,2,3,0,34,16,1
6057,93981,aoxjDsJ8sZvuPjSCqksrdXkImRMV7vgy,A3fsA9Zfv1X2fVEQhTw51lKENdNrEqT3,5,5,1,0,0,0,2,0,8,1.1428571428571428,1,0.0,0,1,0,0,5,0,0,2,0,1,7,1
6058,93999,M4LPRpz3NIxIAwFWtYdMyaFovwI23Hwi,SpATywNh6bZuzm8s1ceuBUnMUAeoAHHw,1,0,0,0,0,0,1,0,1,0.14285714285714285,1,0.0,0,0,0,0,0,0,0,1,0,0,1,1
6059,94009,E1EZDOz8phdW938KkZKGZCkkHanJOco1,bWdj2GDclj5ofokWjzoa5jAwMkxCykd6,5,2,1,0,1,0,2,0,6,0.8571428571428571,1,0.0,0,1,0,1,2,0,0,2,0,2,4,1
6060,94020,aj6uF4XWV3XUUfOpWCk3NuntI2wXym6n,bWdj2GDclj5ofokWjzoa5jAwMkxCykd6,3,0,0,0,0,0,9,0,9,1.2857142857142858,1,0.0,0,0,0,0,0,0,0,9,0,0,9,1
6061,94021,ZtP7ZrczBJoU0XUS4dUWlvI4t1uLf935,A3fsA9Zfv1X2fVEQhTw51lKENdNrEqT3,8,6,4,0,3,0,2,0,15,2.142857142857143,1,0.0,1,4,0,3,5,0,0,2,0,8,7,1
6062,94033,1j3EQYZpvzbHITrSXjRLOl0JrSGShjCW,SpATywNh6bZuzm8s1ceuBUnMUAeoAHHw,12,8,5,5,3,0,2,0,23,3.2857142857142856,1,0.0,2,5,4,3,6,0,1,2,0,14,9,1
6063,94041,gMeZHtHbmrRB8drlaFHRYNGQ6Z4lgho8,A3fsA9Zfv1X2fVEQhTw51lKENdNrEqT3,8,2,1,0,1,0,5,1,10,1.4285714285714286,1,0.0,0,1,0,1,2,0,0,5,1,2,8,1
6064,94050,5WAIxgqU8QRTpOrU8O3vmj4h4ZKof8jn,bWdj2GDclj5ofokWjzoa5jAwMkxCykd6,7,3,2,0,2,0,2,0,9,1.2857142857142858,1,0.0,0,2,0,2,3,0,0,2,0,4,5,1
6065,94059,WO12a2dRrxFwdlmt1PknzZCD2wf5mAFA,SpATywNh6bZuzm8s1ceuBUnMUAeoAHHw,4,3,0,0,0,0,2,0,5,0.7142857142857143,1,0.0,0,0,0,0,3,0,0,2,0,0,5,1
6066,94061,eEQqKnaUGHJzSnB7MrBGgZfDTYsV36xI,A3fsA9Zfv1X2fVEQhTw51lKENdNrEqT3,2,0,0,0,0,0,2,0,2,0.2857142857142857,1,0.0,0,0,0,0,0,0,0,2,0,0,2,1
6067,94083,sTlxlEkJ3MbMUAeSajnaHOGfpyW9hgq1,SpATywNh6bZuzm8s1ceuBUnMUAeoAHHw,7,5,2,0,2,0,2,0,11,1.5714285714285714,1,0.0,0,2,0,2,5,0,0,2,0,4,7,0
6068,94086,uKZ87zwhOlE6XjyVFr8vmJl9wOD1B9qQ,A3fsA9Zfv1X2fVEQhTw51lKENdNrEqT3,8,4,1,0,1,8,11,0,25,3.5714285714285716,2,0.0,0,1,0,1,4,8,0,11,0,2,23,1
6069,94097,uKZ87zwhOlE6XjyVFr8vmJl9wOD1B9qQ,bWdj2GDclj5ofokWjzoa5jAwMkxCykd6,1,0,0,0,0,0,1,0,1,0.14285714285714285,1,0.0,0,0,0,0,0,0,0,1,0,0,1,1
6070,94106,MRzfDn8Dt6xZQHTAuGEWQiuznoHxxpTX,SpATywNh6bZuzm8s1ceuBUnMUAeoAHHw,16,20,13,13,3,3,7,0,59,8.428571428571429,3,0.0,5,13,11,3,15,3,2,7,0,32,27,1
6071,94113,nVXGW3QRysmVp7bseFXpH5xogt6vyuOe,A3fsA9Zfv1X2fVEQhTw51lKENdNrEqT3,1,0,0,0,0,0,3,0,3,0.42857142857142855,2,0.0,0,0,0,0,0,0,0,3,0,0,3,1
6072,94124,XyD01HhzMuHzP5ArHNJFexoSZMamD6Wh,G8EPVSXsOYB5YQWZGiz1aVq5Pgr2GrQu,9,6,2,0,2,0,4,3,17,2.4285714285714284,2,0.0,2,2,0,2,4,0,0,4,3,6,11,1
6073,94128,sKWLe14EbvHw5vqAsPu64KkYjNDdUiTB,SpATywNh6bZuzm8s1ceuBUnMUAeoAHHw,8,9,0,8,0,0,6,0,23,3.2857142857142856,2,0.0,2,0,6,0,7,0,2,6,0,8,15,0
6074,94132,agX7ad5amneAPRCUHAMkIow0n3bNeaeT,SpATywNh6bZuzm8s1ceuBUnMUAeoAHHw,10,5,4,0,3,0,3,0,15,2.142857142857143,1,0.0,0,4,0,3,5,0,0,3,0,7,8,1
6075,94154,sEtktPcVAhFQ7PqkOK3agQy8gf3suIv1,SpATywNh6bZuzm8s1ceuBUnMUAeoAHHw,16,22,9,18,5,0,7,0,61,8.714285714285714,3,0.0,4,9,15,5,18,0,3,7,0,33,28,0
6076,94159,tT3q39TssUZPXoxVdRzgRUu1SUheNubE,A3fsA9Zfv1X2fVEQhTw51lKENdNrEqT3,9,5,3,0,3,1,2,0,14,2.0,1,0.0,0,3,0,3,5,1,0,2,0,6,8,1
6077,94168,ImT05r98NIKWlAcW1CpDyV3beLAyiPwI,A3fsA9Zfv1X2fVEQhTw51lKENdNrEqT3,39,20,10,72,7,0,4,0,113,16.142857142857142,2,0.0,1,10,62,7,19,0,10,4,0,80,33,1
6078,94173,ekbYWgnVFLMYoljaE2I4pYzmSROCPA7U,SpATywNh6bZuzm8s1ceuBUnMUAeoAHHw,17,21,7,11,3,15,11,1,69,9.857142857142858,3,0.0,11,7,10,3,10,15,1,11,1,31,38,1
6079,94185,uHQHB7VXsqIiN9QWww9HiRF0pTlZ4g4T,SpATywNh6bZuzm8s1ceuBUnMUAeoAHHw,12,14,1,23,0,0,2,0,40,5.714285714285714,1,0.0,4,1,20,0,10,0,3,2,0,25,15,1
6080,94191,aMoLa2myIR3XZbIIUknP0HHf77SQMaDf,A3fsA9Zfv1X2fVEQhTw51lKENdNrEqT3,1,0,0,0,0,0,1,0,1,0.14285714285714285,1,0.0,0,0,0,0,0,0,0,1,0,0,1,1
6081,94197,OOnLMU5i5dIEK7NKdoclKsBTE1KLFIfI,SpATywNh6bZuzm8s1ceuBUnMUAeoAHHw,6,7,2,0,1,0,2,0,12,1.7142857142857142,1,0.0,0,2,0,1,7,0,0,2,0,3,9,1
6082,94199,kbnRP5v2Cp1hRovzbBsM6Gb1jKCIVIhL,A3fsA9Zfv1X2fVEQhTw51lKENdNrEqT3,3,2,0,0,0,0,2,0,4,0.5714285714285714,1,0.0,0,0,0,0,2,0,0,2,0,0,4,1
6083,94203,6pBQz4v6AEbi1mr9tNTCug5y9Nmhc90r,A3fsA9Zfv1X2fVEQhTw51lKENdNrEqT3,9,8,5,0,3,0,3,0,19,2.7142857142857144,1,0.0,0,5,0,3,8,0,0,3,0,8,11,1
6084,94205,3KCb4A6amo38Fw6QE756HJn80s8Q1p3u,RXDvfPUBYFlVdlueBFbLW0mhhAyGEqpt,1,0,0,0,0,0,1,0,1,0.14285714285714285,1,0.0,0,0,0,0,0,0,0,1,0,0,1,1
6085,94208,NO1MJkdcGNcIxZKkf5qtzbhQeFobR0HR,SpATywNh6bZuzm8s1ceuBUnMUAeoAHHw,15,11,4,16,3,10,4,0,48,6.857142857142857,1,0.0,6,4,16,3,5,10,0,4,0,29,19,1
6086,94210,4cB4y17zVi4jfdrlreMIHGN1aQJHMMST,bWdj2GDclj5ofokWjzoa5jAwMkxCykd6,5,1,1,0,0,0,3,0,5,0.7142857142857143,1,0.0,0,1,0,0,1,0,0,3,0,1,4,1
6087,94213,6nUn5FL9ZAMjSGoB8M6FuLGMybzSihLy,SpATywNh6bZuzm8s1ceuBUnMUAeoAHHw,4,0,0,0,0,0,3,1,4,0.5714285714285714,1,0.0,0,0,0,0,0,0,0,3,1,0,4,1
6088,94229,dzvyuk189tsgDZIOFuacAzCgRiphRz5M,SpATywNh6bZuzm8s1ceuBUnMUAeoAHHw,2,0,0,0,0,0,2,0,2,0.2857142857142857,1,0.0,0,0,0,0,0,0,0,2,0,0,2,0
6089,94245,rFglXXD43LPWYWjk5nJFVhPJBw4btSRI,SpATywNh6bZuzm8s1ceuBUnMUAeoAHHw,11,9,2,0,1,3,8,1,24,3.4285714285714284,2,0.0,0,2,0,1,9,3,0,8,1,3,21,1
6090,94269,CyJflfaXZKlRhnAKYz3Gu6YETYpaZMel,SpATywNh6bZuzm8s1ceuBUnMUAeoAHHw,2,0,0,0,0,0,2,0,2,0.2857142857142857,1,0.0,0,0,0,0,0,0,0,2,0,0,2,1
6091,94274,0NICeN7b6gzNzu2kflLtEXCwdFBGs0NN,bWdj2GDclj5ofokWjzoa5jAwMkxCykd6,7,5,0,0,0,0,4,0,9,1.2857142857142858,1,0.0,0,0,0,0,5,0,0,4,0,0,9,1
6092,94286,M8C9BDFICk4ida59GU0jjp556zazDEi1,A3fsA9Zfv1X2fVEQhTw51lKENdNrEqT3,12,11,8,0,6,0,5,0,30,4.285714285714286,4,0.0,0,8,0,6,11,0,0,5,0,14,16,1
6093,94287,Ft2AG2HMzLmh2EcmDrFVFbinKvFMlb1G,A3fsA9Zfv1X2fVEQhTw51lKENdNrEqT3,2,0,0,0,0,0,2,0,2,0.2857142857142857,1,0.0,0,0,0,0,0,0,0,2,0,0,2,1
6094,94291,r2j4kmS3sSw2bBC6XtGVEzDG8uZSaMde,bWdj2GDclj5ofokWjzoa5jAwMkxCykd6,1,0,0,0,0,0,1,0,1,0.14285714285714285,1,0.0,0,0,0,0,0,0,0,1,0,0,1,1
6095,94294,M8C9BDFICk4ida59GU0jjp556zazDEi1,bWdj2GDclj5ofokWjzoa5jAwMkxCykd6,9,17,10,0,5,2,9,0,43,6.142857142857143,4,0.0,0,10,0,5,17,2,0,9,0,15,28,1
6096,94297,PSQvTxj1y3we6BHzfg47qDUvmFQLocrD,RXDvfPUBYFlVdlueBFbLW0mhhAyGEqpt,4,3,1,0,0,0,2,0,6,0.8571428571428571,1,0.0,0,1,0,0,3,0,0,2,0,1,5,1
6097,94303,OFXXpJjmXQdJCa3neipnRUGCkhEYKOcL,RXDvfPUBYFlVdlueBFbLW0mhhAyGEqpt,1,0,0,0,0,0,1,0,1,0.14285714285714285,1,0.0,0,0,0,0,0,0,0,1,0,0,1,1
6098,94318,VykAceZUulaqkCpokuW5Za4FHqwbjR1t,bWdj2GDclj5ofokWjzoa5jAwMkxCykd6,2,0,0,0,0,0,2,0,2,0.2857142857142857,1,0.0,0,0,0,0,0,0,0,2,0,0,2,1
6099,94327,nm4sJLNdobmK6nfqGoX1goxharKsSyKv,RXDvfPUBYFlVdlueBFbLW0mhhAyGEqpt,6,3,2,0,2,0,1,0,8,1.1428571428571428,2,0.0,0,2,0,2,3,0,0,1,0,4,4,1
6100,94336,vtU6JORjVkLaXrwFmZEhiuwgIFIb8D5d,bWdj2GDclj5ofokWjzoa5jAwMkxCykd6,4,2,0,0,0,0,2,0,4,0.5714285714285714,1,0.0,0,0,0,0,2,0,0,2,0,0,4,1
6101,94338,yk8HuNxXIum8r8XDIOHqnAVeWfg9tYo1,bWdj2GDclj5ofokWjzoa5jAwMkxCykd6,24,37,17,88,8,2,4,0,156,22.285714285714285,2,0.0,17,17,88,8,20,2,0,4,0,130,26,1
6102,94345,57fIWdKz3C3DE8VWT2c85KC8LovB1GJc,SpATywNh6bZuzm8s1ceuBUnMUAeoAHHw,8,3,0,0,0,0,6,1,10,1.4285714285714286,1,0.0,0,0,0,0,3,0,0,6,1,0,10,1
6103,94349,tkz0XqYzbemGJfGKDWj9gxriQAFTaODF,SpATywNh6bZuzm8s1ceuBUnMUAeoAHHw,5,9,4,0,0,0,3,0,16,2.2857142857142856,1,0.0,0,4,0,0,9,0,0,3,0,4,12,1
6104,94360,Wx74KNuo9MEhjxtzU2HbTG4AbGSUPoBd,SpATywNh6bZuzm8s1ceuBUnMUAeoAHHw,9,4,3,0,3,1,2,0,13,1.8571428571428572,1,0.0,0,3,0,3,4,1,0,2,0,6,7,1
6105,94369,f83h4yuqimgMGxVhGXHOS7nPCMRes6Qy,A3fsA9Zfv1X2fVEQhTw51lKENdNrEqT3,20,10,9,0,8,0,2,0,29,4.142857142857143,1,0.0,0,9,0,8,10,0,0,2,0,17,12,1
6106,94370,LfQeKYjXm6fIUOYzQcp1BnDj9xoPObW8,SpATywNh6bZuzm8s1ceuBUnMUAeoAHHw,8,7,3,0,1,0,6,0,17,2.4285714285714284,1,0.0,0,3,0,1,7,0,0,6,0,4,13,1
6107,94371,na1nn5UiTLqwc4QuFzUQCajZnMiZo4DY,SpATywNh6bZuzm8s1ceuBUnMUAeoAHHw,9,7,5,6,1,0,3,0,22,3.142857142857143,1,0.0,0,5,5,1,7,0,1,3,0,11,11,1
6108,94380,FX47GMrA7B8YjGPkDGCkONJuduXkgeGC,A3fsA9Zfv1X2fVEQhTw51lKENdNrEqT3,1,0,0,0,0,0,1,0,1,0.14285714285714285,1,0.0,0,0,0,0,0,0,0,1,0,0,1,1
6109,94381,NpKmXMDiovurtYgXEkcoE0sVWAxI8pB3,SpATywNh6bZuzm8s1ceuBUnMUAeoAHHw,2,0,0,0,0,0,3,0,3,0.42857142857142855,1,0.0,0,0,0,0,0,0,0,3,0,0,3,1
6110,94390,2ZmAuHOKUwpsOZtu09BcUrjIotbqiy3i,RXDvfPUBYFlVdlueBFbLW0mhhAyGEqpt,7,2,1,0,0,1,6,1,11,1.5714285714285714,1,0.0,0,1,0,0,2,1,0,6,1,1,10,1
6111,94412,mXYBTPDkJluI9G6T4seVU7hhFpBmZYUl,G8EPVSXsOYB5YQWZGiz1aVq5Pgr2GrQu,5,2,1,0,1,0,2,0,6,0.8571428571428571,1,0.0,0,1,0,1,2,0,0,2,0,2,4,1
6112,94434,D7ijm86N7h5o3w1fsSkZ0iVyhHtcIbis,SpATywNh6bZuzm8s1ceuBUnMUAeoAHHw,20,37,9,40,2,11,6,1,106,15.142857142857142,2,0.0,26,9,34,2,11,11,6,6,1,71,35,0
6113,94436,dgp1qm7PjXoVV4MjyzuvWetQrJ3T9kos,A3fsA9Zfv1X2fVEQhTw51lKENdNrEqT3,10,6,4,0,2,2,18,2,34,4.857142857142857,2,0.0,0,4,0,2,6,2,0,18,2,6,28,1
6114,94440,Zp3KwB88qNkgRL7fOtXbXw8ohFvxUyg2,bWdj2GDclj5ofokWjzoa5jAwMkxCykd6,13,11,5,50,4,1,13,2,86,12.285714285714286,1,0.0,4,5,48,4,7,1,2,13,2,61,25,1
6115,94470,gTN0rkPeefB1hZOI5VW6CFWJwvhdBtBh,SpATywNh6bZuzm8s1ceuBUnMUAeoAHHw,5,2,1,0,1,0,4,0,8,1.1428571428571428,1,0.0,0,1,0,1,2,0,0,4,0,2,6,1
6116,94473,KkeLwwXyUiCfeVvKPcarXSSK8DrECkDe,A3fsA9Zfv1X2fVEQhTw51lKENdNrEqT3,4,4,1,0,0,0,2,0,7,1.0,2,0.0,0,1,0,0,4,0,0,2,0,1,6,1
6117,94480,LkgxCzljZyoH3VIdoXwdLt0OprbSc3sT,SpATywNh6bZuzm8s1ceuBUnMUAeoAHHw,13,17,10,0,3,0,9,0,39,5.571428571428571,2,0.0,0,10,0,3,17,0,0,9,0,13,26,1
6118,94491,a9Qi5jUo324IBdWO7mih7fiFScdu3QAb,SpATywNh6bZuzm8s1ceuBUnMUAeoAHHw,5,4,3,0,0,0,1,0,8,1.1428571428571428,1,0.0,0,3,0,0,4,0,0,1,0,3,5,1
6119,94493,OseLd0Vj4CawbZPfZRznLZH5tivxQP68,G8EPVSXsOYB5YQWZGiz1aVq5Pgr2GrQu,15,10,4,14,2,0,2,0,32,4.571428571428571,1,0.0,6,4,8,2,4,0,6,2,0,20,12,1
6120,94892,nPRsjektHdbQkeAf1fIK4JbhrESPbPsA,fbPkOYLVPtPgIt0MxizjfFJov3JbHyAi,1,0,0,0,0,0,1,0,1,0.14285714285714285,1,0.0,0,0,0,0,0,0,0,1,0,0,1,1
6121,94908,Y0dtU5bUn0PrrnfgvOUCPfb1rktwn4CX,fbPkOYLVPtPgIt0MxizjfFJov3JbHyAi,11,13,6,0,4,2,12,1,38,5.428571428571429,2,0.0,0,6,0,4,13,2,0,12,1,10,28,1
6122,94913,YPe9PkGt8zBUqd5BCkLiDVIWrxR3Ane8,fbPkOYLVPtPgIt0MxizjfFJov3JbHyAi,1,0,0,0,0,0,1,0,1,0.14285714285714285,1,0.0,0,0,0,0,0,0,0,1,0,0,1,1
6123,94915,CD136AEP3K4fUPxB0PiyL0uWFPHfdCLY,fbPkOYLVPtPgIt0MxizjfFJov3JbHyAi,5,2,1,0,1,0,2,0,6,0.8571428571428571,1,0.0,0,1,0,1,2,0,0,2,0,2,4,1
6124,94916,tN25USY6Yw7TL4DfXwjrjqK862rGOedD,fbPkOYLVPtPgIt0MxizjfFJov3JbHyAi,7,3,2,0,2,0,5,0,12,1.7142857142857142,1,0.0,0,2,0,2,3,0,0,5,0,4,8,1
6125,94925,PF30Vqy17JIy50CbxBzrrEB7UvSbzYk3,fbPkOYLVPtPgIt0MxizjfFJov3JbHyAi,7,3,2,0,2,0,2,0,9,1.2857142857142858,1,0.0,0,2,0,2,3,0,0,2,0,4,5,1
6126,94926,5MiwmAeXmS1fmC9lSNRxf7aBKSjN4L17,fbPkOYLVPtPgIt0MxizjfFJov3JbHyAi,1,0,0,0,0,0,1,0,1,0.14285714285714285,1,0.0,0,0,0,0,0,0,0,1,0,0,1,1
6127,94927,BMt1sMJKW8lUV5XsrUOWqq2qoU33TZEw,fbPkOYLVPtPgIt0MxizjfFJov3JbHyAi,12,9,4,0,3,12,7,3,38,5.428571428571429,2,0.0,1,4,0,3,8,12,0,7,3,8,30,0
6128,94932,Oyh3flf2wYtqmXZJ703xfAIo394jSx4Q,fbPkOYLVPtPgIt0MxizjfFJov3JbHyAi,7,2,2,0,2,1,18,3,28,4.0,1,0.0,0,2,0,2,2,1,0,18,3,4,24,1
6129,94933,oASR1hbK6DD6OJfTJCDKLW9l2vPgw7kR,fbPkOYLVPtPgIt0MxizjfFJov3JbHyAi,6,3,2,0,2,0,1,0,8,1.1428571428571428,1,0.0,0,2,0,2,3,0,0,1,0,4,4,1
6130,94935,KbVIZwe7S3MOh9dlFVWDZwSpf3zNL2tv,fbPkOYLVPtPgIt0MxizjfFJov3JbHyAi,1,0,0,0,0,0,1,0,1,0.14285714285714285,1,0.0,0,0,0,0,0,0,0,1,0,0,1,1
6131,94936,uarVJhEs6XLW7Dw1D7iBgEK6zPe65WwX,fbPkOYLVPtPgIt0MxizjfFJov3JbHyAi,6,3,2,0,1,0,3,0,9,1.2857142857142858,1,0.0,0,2,0,1,3,0,0,3,0,3,6,1
6132,94937,P6rUUMuGXrvMpG8WR8uzYUJPpfieJxTd,fbPkOYLVPtPgIt0MxizjfFJov3JbHyAi,1,0,0,0,0,0,1,0,1,0.14285714285714285,1,0.0,0,0,0,0,0,0,0,1,0,0,1,1
6133,94939,gpRi42UI7sWUeBhI8VeTEp7H6XwIGlNG,fbPkOYLVPtPgIt0MxizjfFJov3JbHyAi,2,0,0,0,0,0,9,0,9,1.2857142857142858,1,0.0,0,0,0,0,0,0,0,9,0,0,9,1
6134,94940,2gXHY5qLgY96Nt3kImmboPawcy43EQXt,fbPkOYLVPtPgIt0MxizjfFJov3JbHyAi,7,3,2,0,2,0,2,0,9,1.2857142857142858,1,0.0,0,2,0,2,3,0,0,2,0,4,5,1
6135,94942,6u1ZWprTe7uoVhqimJI2aVqsjH23ao5o,fbPkOYLVPtPgIt0MxizjfFJov3JbHyAi,7,3,2,0,2,0,4,0,11,1.5714285714285714,1,0.0,0,2,0,2,3,0,0,4,0,4,7,1
6136,94944,Z13gCiJciUykTdLRTsjNu2GwwR7Nbxp1,fbPkOYLVPtPgIt0MxizjfFJov3JbHyAi,6,3,2,0,2,0,1,0,8,1.1428571428571428,1,0.0,0,2,0,2,3,0,0,1,0,4,4,1
6137,94945,VtEfFHwCwR0CG3OZFyRUkRQlzB85HLcu,fbPkOYLVPtPgIt0MxizjfFJov3JbHyAi,4,2,1,0,1,0,1,0,5,0.7142857142857143,1,0.0,0,1,0,1,2,0,0,1,0,2,3,1
6138,94947,MDIYLIYQBWx9HiPTzYboxCieX8UYramh,fbPkOYLVPtPgIt0MxizjfFJov3JbHyAi,2,0,0,0,0,0,3,0,3,0.42857142857142855,2,0.0,0,0,0,0,0,0,0,3,0,0,3,1
6139,94948,wtEiMTsSGyqVYmzAUWtaJeXU5b3t5li0,fbPkOYLVPtPgIt0MxizjfFJov3JbHyAi,9,7,5,0,3,8,2,0,25,3.5714285714285716,1,0.0,1,5,0,3,6,8,0,2,0,9,16,1
6140,94949,6VGKONVpl1KgJ6EuaAzeKa8BNrxzEeZU,fbPkOYLVPtPgIt0MxizjfFJov3JbHyAi,7,9,1,0,1,0,2,0,13,1.8571428571428572,2,0.0,0,1,0,1,9,0,0,2,0,2,11,1
6141,94951,Th6GGIKucyCokdQsUn3aOeloTzqx0Qbo,fbPkOYLVPtPgIt0MxizjfFJov3JbHyAi,1,0,0,0,0,0,1,0,1,0.14285714285714285,1,0.0,0,0,0,0,0,0,0,1,0,0,1,1
6142,95304,sXXu4twesSnXXidsHxSOeMg5Xzk8xAsm,A3fsA9Zfv1X2fVEQhTw51lKENdNrEqT3,2,0,0,0,0,0,2,0,2,0.2857142857142857,1,0.0,0,0,0,0,0,0,0,2,0,0,2,0
6143,95315,U0aWEpE7Ns3m6FjrcttSNCCy6f34uaV4,SpATywNh6bZuzm8s1ceuBUnMUAeoAHHw,1,0,0,0,0,0,1,0,1,0.14285714285714285,1,0.0,0,0,0,0,0,0,0,1,0,0,1,1
6144,95323,Ge5fW9CsKdA0D6503NL20NzJpcoMVtar,SpATywNh6bZuzm8s1ceuBUnMUAeoAHHw,6,2,1,0,1,0,3,0,7,1.0,1,0.0,0,1,0,1,2,0,0,3,0,2,5,1
6145,95333,YybGVTqjY7vuqDLgHStfT8JBgnvTLDFS,bWdj2GDclj5ofokWjzoa5jAwMkxCykd6,6,2,1,0,1,0,3,0,7,1.0,1,0.0,0,1,0,1,2,0,0,3,0,2,5,1
6146,95336,QzVwezWUOBpl33EMiprsTWQNwkGzpYUZ,RXDvfPUBYFlVdlueBFbLW0mhhAyGEqpt,1,0,0,0,0,0,1,0,1,0.14285714285714285,1,0.0,0,0,0,0,0,0,0,1,0,0,1,0
6147,95343,WjGAvDgXPzKEfssMPXtQ1xVWZPI1hH6R,SpATywNh6bZuzm8s1ceuBUnMUAeoAHHw,3,2,0,0,0,0,1,0,3,0.42857142857142855,1,0.0,0,0,0,0,2,0,0,1,0,0,3,0
6148,95365,Ieqd5itEcYJJN0R1exEtlEqnGZPAbCE6,A3fsA9Zfv1X2fVEQhTw51lKENdNrEqT3,4,3,1,0,1,0,2,0,7,1.0,1,0.0,0,1,0,1,3,0,0,2,0,2,5,1
6149,95379,jl79Z6TfXd4YLzsAQwSCeo1eMaF6Ha8d,A3fsA9Zfv1X2fVEQhTw51lKENdNrEqT3,10,7,0,0,0,4,9,1,21,3.0,1,0.0,0,0,0,0,7,4,0,9,1,0,21,1
6150,95421,Bha7QMGmONKAqxvqVmMzYDzgn03rupB9,A3fsA9Zfv1X2fVEQhTw51lKENdNrEqT3,2,0,0,0,0,0,2,0,2,0.2857142857142857,1,0.0,0,0,0,0,0,0,0,2,0,0,2,1
6151,95443,Bha7QMGmONKAqxvqVmMzYDzgn03rupB9,bWdj2GDclj5ofokWjzoa5jAwMkxCykd6,4,2,1,0,0,0,3,0,6,0.8571428571428571,1,0.0,0,1,0,0,2,0,0,3,0,1,5,1
6152,95457,5yUqlUp9Xefz1r5QbYyqOcfkyddpZEv3,SpATywNh6bZuzm8s1ceuBUnMUAeoAHHw,19,22,6,12,5,0,5,0,50,7.142857142857143,1,0.0,9,6,10,5,13,0,2,5,0,30,20,1
6153,95460,yell4xFioKaQh1Eh8e1BHgTr9kNc23uL,G8EPVSXsOYB5YQWZGiz1aVq5Pgr2GrQu,2,0,0,0,0,0,2,0,2,0.2857142857142857,1,0.0,0,0,0,0,0,0,0,2,0,0,2,1
6154,95491,pO2KznyI9EIaBuWTbRmHrZfzq1y78Swj,A3fsA9Zfv1X2fVEQhTw51lKENdNrEqT3,10,6,4,0,4,0,3,0,17,2.4285714285714284,1,0.0,1,4,0,4,5,0,0,3,0,9,8,1
6155,95501,XgCNwD2cEVKtD4WAVaPORGAj8LHTJr5e,A3fsA9Zfv1X2fVEQhTw51lKENdNrEqT3,1,0,0,0,0,0,2,0,2,0.2857142857142857,2,0.0,0,0,0,0,0,0,0,2,0,0,2,1
6156,95518,GjBrMYHaMHg9XRlK0GO1kzoiYlxNFcC2,A3fsA9Zfv1X2fVEQhTw51lKENdNrEqT3,60,29,19,126,9,0,13,0,196,28.0,3,0.0,2,19,118,9,27,0,8,13,0,148,48,1
6157,95519,3TwYkv5KYm0nsRHdmcaiJpajLH9JQ0UG,A3fsA9Zfv1X2fVEQhTw51lKENdNrEqT3,3,0,0,0,0,0,5,0,5,0.7142857142857143,1,0.0,0,0,0,0,0,0,0,5,0,0,5,1
6158,95547,t3XemfoUPPfcRENYQvP2H3PO2tJX9CiG,SpATywNh6bZuzm8s1ceuBUnMUAeoAHHw,4,2,1,0,1,0,1,0,5,0.7142857142857143,1,0.0,0,1,0,1,2,0,0,1,0,2,3,1
6159,95560,oSEQ14Ll1d8ZBrsI9L5wTDmDWqMOqneK,A3fsA9Zfv1X2fVEQhTw51lKENdNrEqT3,14,7,6,0,6,1,7,1,28,4.0,1,0.0,0,6,0,6,7,1,0,7,1,12,16,1
6160,95566,WdzyWsqPss1ohcmLXQZkxthaNy8YyGzL,A3fsA9Zfv1X2fVEQhTw51lKENdNrEqT3,3,0,0,0,0,0,5,0,5,0.7142857142857143,1,0.0,0,0,0,0,0,0,0,5,0,0,5,1
6161,95567,BlS8PCoC6oTDUZj2Hj1GOesx0cnG3IDt,A3fsA9Zfv1X2fVEQhTw51lKENdNrEqT3,8,6,4,0,2,0,5,0,17,2.4285714285714284,1,0.0,0,4,0,2,6,0,0,5,0,6,11,1
6162,95570,nYSFDE8RCbcZhD46fRSvPHUvA1ahfupi,SpATywNh6bZuzm8s1ceuBUnMUAeoAHHw,8,9,1,0,1,4,5,0,20,2.857142857142857,1,0.0,0,1,0,1,9,4,0,5,0,2,18,1
6163,95579,8DrwDXKGEBLVwNt7dUNV7BIWxiG8AH1C,A3fsA9Zfv1X2fVEQhTw51lKENdNrEqT3,8,7,2,0,2,0,7,0,18,2.5714285714285716,1,0.0,0,2,0,2,7,0,0,7,0,4,14,1
6164,95584,vnJ8iXwVjPF96rPn5RIZQWSaOopjKseH,SpATywNh6bZuzm8s1ceuBUnMUAeoAHHw,28,33,14,40,8,0,11,0,106,15.142857142857142,1,0.0,8,14,34,8,25,0,6,11,0,64,42,1
6165,95604,nYSFDE8RCbcZhD46fRSvPHUvA1ahfupi,G8EPVSXsOYB5YQWZGiz1aVq5Pgr2GrQu,7,4,1,0,1,1,2,0,9,1.2857142857142858,1,0.0,0,1,0,1,4,1,0,2,0,2,7,1
6166,95610,nYSFDE8RCbcZhD46fRSvPHUvA1ahfupi,A3fsA9Zfv1X2fVEQhTw51lKENdNrEqT3,9,7,1,0,1,3,2,0,14,2.0,1,0.0,0,1,0,1,7,3,0,2,0,2,12,1
6167,95621,nH3NRDQLecB3hMbOpaitsdqKrlyEIXGh,SpATywNh6bZuzm8s1ceuBUnMUAeoAHHw,21,22,13,34,6,0,3,0,78,11.142857142857142,2,0.0,6,13,29,6,16,0,5,3,0,54,24,0
6168,95640,Y7qsqdZIsv6Hy0vu4LtgtbOKv08z7vaS,A3fsA9Zfv1X2fVEQhTw51lKENdNrEqT3,2,0,0,0,0,0,2,0,2,0.2857142857142857,1,0.0,0,0,0,0,0,0,0,2,0,0,2,1
6169,95647,kHWuc10C4T4imgPGXw1iL9DdxxMDyloj,A3fsA9Zfv1X2fVEQhTw51lKENdNrEqT3,2,0,0,0,0,0,3,0,3,0.42857142857142855,1,0.0,0,0,0,0,0,0,0,3,0,0,3,1
6170,95655,aFVIDdMfPLCaqut6kVxorTellYImwEAn,RXDvfPUBYFlVdlueBFbLW0mhhAyGEqpt,1,0,0,0,0,0,1,0,1,0.14285714285714285,1,0.0,0,0,0,0,0,0,0,1,0,0,1,1
6171,95692,PoMIsULf4fdpKNpab6c33l88EClRsCjy,A3fsA9Zfv1X2fVEQhTw51lKENdNrEqT3,14,7,6,0,5,0,2,0,20,2.857142857142857,1,0.0,0,6,0,5,7,0,0,2,0,11,9,0
6172,95693,lLO2IvxcSlYUuWvFwkacGc9eGibtMx0u,A3fsA9Zfv1X2fVEQhTw51lKENdNrEqT3,1,0,0,0,0,0,1,0,1,0.14285714285714285,1,0.0,0,0,0,0,0,0,0,1,0,0,1,1
6173,95713,XUeZabU3qZWCaiD6wFnhBaCufbfFTb2H,A3fsA9Zfv1X2fVEQhTw51lKENdNrEqT3,16,7,6,0,6,0,3,0,22,3.142857142857143,1,0.0,0,6,0,6,7,0,0,3,0,12,10,1
6174,95742,Y9G0Vd7vUaj0pt9EeQDbDOvFl3eVdYaR,RXDvfPUBYFlVdlueBFbLW0mhhAyGEqpt,1,0,0,0,0,0,1,0,1,0.14285714285714285,1,0.0,0,0,0,0,0,0,0,1,0,0,1,1
6175,95754,fXpjk0OrbkXxQzpvttVDelNPD6lPfJXA,SpATywNh6bZuzm8s1ceuBUnMUAeoAHHw,20,14,8,19,6,0,6,0,53,7.571428571428571,1,0.0,6,8,16,6,8,0,3,6,0,36,17,1
6176,95775,WuM67GwQW9M3d1mnuGHuvAdo907S9qb5,SpATywNh6bZuzm8s1ceuBUnMUAeoAHHw,1,0,0,0,0,0,1,0,1,0.14285714285714285,1,0.0,0,0,0,0,0,0,0,1,0,0,1,0
6177,95777,Yc8rNkAsH37cAbAebyiE6I2RsfVaxpIZ,A3fsA9Zfv1X2fVEQhTw51lKENdNrEqT3,7,3,2,0,2,0,2,0,9,1.2857142857142858,1,0.0,0,2,0,2,3,0,0,2,0,4,5,1
6178,95783,Xcq5CVanT8J8ISNJVeThaVoqYhMkjumr,SpATywNh6bZuzm8s1ceuBUnMUAeoAHHw,5,2,1,0,1,0,2,0,6,0.8571428571428571,1,0.0,0,1,0,1,2,0,0,2,0,2,4,1
6179,95790,aSlIMkfly6xTMJCGTWDQcnFZjajcWM6y,A3fsA9Zfv1X2fVEQhTw51lKENdNrEqT3,7,4,1,0,1,0,2,0,8,1.1428571428571428,1,0.0,0,1,0,1,4,0,0,2,0,2,6,1
6180,95796,AfmdKPTL0IbcupndNMlY5c7PImPraChY,SpATywNh6bZuzm8s1ceuBUnMUAeoAHHw,25,20,11,16,5,0,6,1,59,8.428571428571429,2,0.0,6,11,15,5,14,0,1,6,1,37,22,1
6181,95800,XhN7QGypor4DcMvMWEJ3oRIi5DeJwYDV,SpATywNh6bZuzm8s1ceuBUnMUAeoAHHw,14,20,1,15,1,2,3,0,42,6.0,2,0.0,10,1,14,1,10,2,1,3,0,26,16,1
6182,95805,jN3AJMUVBTsXIfTNwaMmorNzhVw7coVS,A3fsA9Zfv1X2fVEQhTw51lKENdNrEqT3,2,0,0,0,0,0,2,0,2,0.2857142857142857,1,0.0,0,0,0,0,0,0,0,2,0,0,2,1
6183,95817,1uEo4BzsZxlgHBFClnUu9nbvDrRmzn4T,SpATywNh6bZuzm8s1ceuBUnMUAeoAHHw,7,4,3,5,1,0,1,0,14,2.0,1,0.0,0,3,5,1,4,0,0,1,0,9,5,1
6184,95824,qHYMkh2G06Tgj4MMABvKGj1g29BRMeXu,SpATywNh6bZuzm8s1ceuBUnMUAeoAHHw,6,4,3,0,3,0,1,0,11,1.5714285714285714,1,0.0,0,3,0,3,4,0,0,1,0,6,5,1
6185,95827,1u5RJ3ohzI9I8TYHEG8zy2n2QjuVVCRw,SpATywNh6bZuzm8s1ceuBUnMUAeoAHHw,1,0,0,0,0,0,1,0,1,0.14285714285714285,1,0.0,0,0,0,0,0,0,0,1,0,0,1,1
6186,95834,86utfBtmFqtE8TLsj2h1BusfBdMTH1O8,SpATywNh6bZuzm8s1ceuBUnMUAeoAHHw,10,11,3,1,2,0,2,0,19,2.7142857142857144,2,0.0,2,3,1,2,9,0,0,2,0,8,11,1
6187,95841,AEeLy9n4nUl6UlG8WfSP7Q5sqAzFdtaD,A3fsA9Zfv1X2fVEQhTw51lKENdNrEqT3,15,25,19,0,14,13,9,1,81,11.571428571428571,7,0.0,0,19,0,14,25,13,0,9,1,33,48,0
6188,95849,j3HNnX1GWjrCGNX5n4Ax13Vu5X6WNds7,SpATywNh6bZuzm8s1ceuBUnMUAeoAHHw,5,2,1,0,1,0,2,0,6,0.8571428571428571,1,0.0,0,1,0,1,2,0,0,2,0,2,4,1
6189,95866,wdK5DIKl9qd73hM1uOx3ufcKj0J9AcRr,A3fsA9Zfv1X2fVEQhTw51lKENdNrEqT3,9,8,6,0,5,0,2,0,21,3.0,2,0.0,0,6,0,5,8,0,0,2,0,11,10,1
6190,95877,ofStwmRRBPN4Od7HYTx4tgAh724FKaML,RXDvfPUBYFlVdlueBFbLW0mhhAyGEqpt,8,4,0,0,0,4,4,1,13,1.8571428571428572,1,0.0,0,0,0,0,4,4,0,4,1,0,13,1
6191,95886,xsD2uaFheAaDTDHzSeAKROA0IH2KQICZ,SpATywNh6bZuzm8s1ceuBUnMUAeoAHHw,12,11,1,6,1,0,2,0,21,3.0,1,0.0,2,1,6,1,9,0,0,2,0,10,11,1
6192,95903,8Bi5fR0qSZjzFptY6NNbPZ6GLpteABmy,SpATywNh6bZuzm8s1ceuBUnMUAeoAHHw,4,2,0,0,0,0,3,0,5,0.7142857142857143,2,0.0,0,0,0,0,2,0,0,3,0,0,5,1
6193,95914,rTLMEQB78zn1g6bt6KRypanGZ8QWPbQv,A3fsA9Zfv1X2fVEQhTw51lKENdNrEqT3,49,72,13,88,11,42,31,1,258,36.857142857142854,7,0.0,6,13,69,11,66,42,19,31,1,99,159,0
6194,95924,yF9l9yvoXyIeGTDuNPcQeoWm8bOFk82H,A3fsA9Zfv1X2fVEQhTw51lKENdNrEqT3,1,0,0,0,0,0,1,0,1,0.14285714285714285,1,0.0,0,0,0,0,0,0,0,1,0,0,1,1
6195,95938,H8hXX8mRAbdpVvW9JxPUH4Vz1O6DjIDQ,SpATywNh6bZuzm8s1ceuBUnMUAeoAHHw,12,15,4,11,3,0,1,0,34,4.857142857142857,1,0.0,10,4,10,3,5,0,1,1,0,27,7,1
6196,95943,Gnvd8M3zeIOpApc28ArYy1li1qM7ZTwg,SpATywNh6bZuzm8s1ceuBUnMUAeoAHHw,15,26,0,18,0,1,10,2,57,8.142857142857142,2,0.0,6,0,15,0,20,1,3,10,2,21,36,1
6197,95946,VSxmvcFHrZIVtNnTaFw0qdfh1Zdl1LMy,SpATywNh6bZuzm8s1ceuBUnMUAeoAHHw,27,43,20,12,9,0,4,0,88,12.571428571428571,3,0.0,19,20,12,9,24,0,0,4,0,60,28,0
6198,95965,L22oksNNnEaRYr1idj7T9wNLQN39zTXs,SpATywNh6bZuzm8s1ceuBUnMUAeoAHHw,8,2,1,0,1,1,5,1,11,1.5714285714285714,1,0.0,0,1,0,1,2,1,0,5,1,2,9,1
6199,95979,kYCiC9sjJhVea0nSa72pTn7A2eOhjLmI,SpATywNh6bZuzm8s1ceuBUnMUAeoAHHw,10,6,4,0,3,1,8,1,23,3.2857142857142856,2,0.0,0,4,0,3,6,1,0,8,1,7,16,1
6200,95984,D9YS628mhjQ1I60HvdkUWN4SFDF5a33E,SpATywNh6bZuzm8s1ceuBUnMUAeoAHHw,7,2,0,0,0,1,5,1,9,1.2857142857142858,1,0.0,0,0,0,0,2,1,0,5,1,0,9,1
6201,95991,S144mYN036ngEoT5NOZhFV5f1CGtYvQl,SpATywNh6bZuzm8s1ceuBUnMUAeoAHHw,7,2,0,0,0,1,7,1,11,1.5714285714285714,1,0.0,0,0,0,0,2,1,0,7,1,0,11,1
6202,96002,Hxd16O3nQG6ddXQCBbAu8BGBmmZmiixl,bWdj2GDclj5ofokWjzoa5jAwMkxCykd6,1,0,0,0,0,0,1,0,1,0.14285714285714285,1,0.0,0,0,0,0,0,0,0,1,0,0,1,1
6203,96009,GpLd8OePUlzkVkOH6kyAjUXsolCeEYNN,RXDvfPUBYFlVdlueBFbLW0mhhAyGEqpt,7,3,1,0,1,0,3,0,8,1.1428571428571428,1,0.0,0,1,0,1,3,0,0,3,0,2,6,1
6204,96015,5AnpX5rZgeZiqdXpEpBXchayqHICSQR2,SpATywNh6bZuzm8s1ceuBUnMUAeoAHHw,9,6,4,0,2,0,2,0,14,2.0,1,0.0,1,4,0,2,5,0,0,2,0,7,7,1
6205,96018,HPasLgueYgbdk1es5obBHn6eCO700ZnM,G8EPVSXsOYB5YQWZGiz1aVq5Pgr2GrQu,5,2,1,0,1,0,3,0,7,1.0,1,0.0,0,1,0,1,2,0,0,3,0,2,5,1
6206,96021,ix15aF6FOEF1waZCSZt01VrPOuPGJ3yM,SpATywNh6bZuzm8s1ceuBUnMUAeoAHHw,19,21,0,12,0,4,9,1,47,6.714285714285714,4,0.0,10,0,12,0,11,4,0,9,1,22,25,0
6207,96028,3tDepbYkazgiOrBsQmbtJa1H3rNZc54O,SpATywNh6bZuzm8s1ceuBUnMUAeoAHHw,9,5,1,0,1,0,7,2,16,2.2857142857142856,2,0.0,0,1,0,1,5,0,0,7,2,2,14,0
6208,96037,zwqhxdboQszkcKvPN5pyN1nGDFR4ub3y,bWdj2GDclj5ofokWjzoa5jAwMkxCykd6,7,8,1,6,4,0,3,0,22,3.142857142857143,2,0.0,6,1,6,4,2,0,0,3,0,17,5,1
6209,96038,NGxVJQppNBMfgJiFwD3Ox6xl5bHm79ig,A3fsA9Zfv1X2fVEQhTw51lKENdNrEqT3,7,5,4,0,1,0,2,0,12,1.7142857142857142,1,0.0,0,4,0,1,5,0,0,2,0,5,7,1
6210,96051,nl7CfVETct3efRgniW8qXKplgQDLZElB,bWdj2GDclj5ofokWjzoa5jAwMkxCykd6,2,0,0,0,0,0,3,0,3,0.42857142857142855,1,0.0,0,0,0,0,0,0,0,3,0,0,3,1
6211,96060,1FiRW6JL0h34vWqoZjG8ei2zujPF23NL,A3fsA9Zfv1X2fVEQhTw51lKENdNrEqT3,68,61,28,90,13,2,20,1,215,30.714285714285715,4,0.0,7,28,87,13,54,2,3,20,1,135,80,1
6212,96063,McYATdhZDDMDpni6a4GbjI06ustMpvdV,bWdj2GDclj5ofokWjzoa5jAwMkxCykd6,1,0,0,0,0,0,2,0,2,0.2857142857142857,2,0.0,0,0,0,0,0,0,0,2,0,0,2,1
6213,96074,MiDD69NvLCtsK6jzM5U32WgBFDv8XbVJ,A3fsA9Zfv1X2fVEQhTw51lKENdNrEqT3,11,7,2,0,2,0,11,1,23,3.2857142857142856,1,0.0,0,2,0,2,7,0,0,11,1,4,19,0
6214,96080,nBih09u5WtqrKAXZJuGGTQZ4MinMYlfW,SpATywNh6bZuzm8s1ceuBUnMUAeoAHHw,5,2,0,0,0,0,7,0,9,1.2857142857142858,1,0.0,0,0,0,0,2,0,0,7,0,0,9,1
6215,96094,ps5VcFUapZM31sy4VNJWOTFBzN98932v,SpATywNh6bZuzm8s1ceuBUnMUAeoAHHw,1,0,0,0,0,0,1,0,1,0.14285714285714285,1,0.0,0,0,0,0,0,0,0,1,0,0,1,1
6216,96102,VLNGwZ1eoTZ1MrW64VolhWSmnDD0C1Ov,A3fsA9Zfv1X2fVEQhTw51lKENdNrEqT3,8,3,2,0,1,4,8,1,19,2.7142857142857144,2,0.0,0,2,0,1,3,4,0,8,1,3,16,1
6217,96105,IhdK4MEktWiSl0ozGtXiJFeE1awPcboi,SpATywNh6bZuzm8s1ceuBUnMUAeoAHHw,29,37,19,37,8,3,8,0,112,16.0,2,0.0,6,19,32,8,31,3,5,8,0,65,47,1
6218,96109,gnTcbZ4BOuQk0BfuzZDpGiEEYJSGOrYu,SpATywNh6bZuzm8s1ceuBUnMUAeoAHHw,26,25,16,30,12,5,3,0,91,13.0,2,0.0,5,16,27,12,20,5,3,3,0,60,31,1
6219,96112,o3REKVT5jtm2Ed8QHiz1c3PlSbYTElLg,SpATywNh6bZuzm8s1ceuBUnMUAeoAHHw,3,0,0,0,0,0,3,0,3,0.42857142857142855,1,0.0,0,0,0,0,0,0,0,3,0,0,3,1
6220,96113,o3REKVT5jtm2Ed8QHiz1c3PlSbYTElLg,G8EPVSXsOYB5YQWZGiz1aVq5Pgr2GrQu,2,0,0,0,0,0,2,0,2,0.2857142857142857,1,0.0,0,0,0,0,0,0,0,2,0,0,2,1
6221,96114,XYKEbaRABcMuBHmMB2I3YkBepzCp0swB,A3fsA9Zfv1X2fVEQhTw51lKENdNrEqT3,26,14,1,72,0,0,4,0,91,13.0,3,0.0,3,1,58,0,11,0,14,4,0,62,29,1
6222,96121,gnTcbZ4BOuQk0BfuzZDpGiEEYJSGOrYu,A3fsA9Zfv1X2fVEQhTw51lKENdNrEqT3,7,3,2,0,2,0,4,0,11,1.5714285714285714,2,0.0,0,2,0,2,3,0,0,4,0,4,7,1
6223,96126,8n73BBd3mvRJq2a0KZ4WJWTYj65s8f61,bWdj2GDclj5ofokWjzoa5jAwMkxCykd6,1,0,0,0,0,0,1,0,1,0.14285714285714285,1,0.0,0,0,0,0,0,0,0,1,0,0,1,1
6224,96133,gMMqUNqa2ZYLkCBhPE0t3hx9nA1CQadH,SpATywNh6bZuzm8s1ceuBUnMUAeoAHHw,31,67,37,32,22,11,16,1,186,26.571428571428573,6,0.0,20,37,29,22,47,11,3,16,1,108,78,0
6225,96140,QTgmoEmFx7yveY8D3dDCUQU4BnndurNn,RXDvfPUBYFlVdlueBFbLW0mhhAyGEqpt,63,87,36,80,18,11,12,1,245,35.0,5,0.0,15,36,78,18,72,11,2,12,1,147,98,0
6226,96698,kfq7KT5bB5EYh8pOfijeZyMqCV9XlzvB,RXDvfPUBYFlVdlueBFbLW0mhhAyGEqpt,13,9,7,0,2,7,4,1,30,4.285714285714286,1,0.0,0,7,0,2,9,7,0,4,1,9,21,0
6227,96720,nyH7Jx4kN1AdDJdwkZQoUDqYoovHgbk5,SpATywNh6bZuzm8s1ceuBUnMUAeoAHHw,7,21,11,0,10,0,2,0,44,6.285714285714286,2,0.0,0,11,0,10,21,0,0,2,0,21,23,1
6228,96733,tMJpDv6ZjEPz2ELzUVp4mZTT6G7u49T6,SpATywNh6bZuzm8s1ceuBUnMUAeoAHHw,2,0,0,0,0,0,2,0,2,0.2857142857142857,1,0.0,0,0,0,0,0,0,0,2,0,0,2,1
6229,96734,fAZJvvaqILemW9qqdyo0ZQidn1S9S3J8,RXDvfPUBYFlVdlueBFbLW0mhhAyGEqpt,42,119,2,106,4,16,22,5,274,39.142857142857146,5,0.0,14,2,91,4,105,16,15,22,5,111,163,1
6230,96776,Q2sM7xUZ5pftXbE3pDquUzMiyNyEc1IS,SpATywNh6bZuzm8s1ceuBUnMUAeoAHHw,5,6,0,0,0,1,5,0,12,1.7142857142857142,1,0.0,0,0,0,0,6,1,0,5,0,0,12,1
6231,96805,l5LcQXaXypTaa8UtbYyDr1XartlmUM1X,A3fsA9Zfv1X2fVEQhTw51lKENdNrEqT3,3,0,0,0,0,0,5,0,5,0.7142857142857143,1,0.0,0,0,0,0,0,0,0,5,0,0,5,1
6232,96818,ULdF32fTmMpV957Ngz6P80D0kuxYFb2A,SpATywNh6bZuzm8s1ceuBUnMUAeoAHHw,29,23,12,18,6,0,18,3,80,11.428571428571429,4,0.0,11,12,17,6,12,0,1,18,3,46,34,0
6233,96873,cD5CJQRtTCG0McZYvErqx6oV3tTvutc8,RXDvfPUBYFlVdlueBFbLW0mhhAyGEqpt,46,50,22,73,9,19,7,3,183,26.142857142857142,1,0.0,11,22,70,9,39,19,3,7,3,112,71,1
6234,96901,umy7brIUz48bN1VUJsZEuHA9by5FINCa,7GRhBDsirIGkRZBtSMEzNTyDr2JQm4xx,4,2,1,0,1,0,1,0,5,0.7142857142857143,1,0.0,0,1,0,1,2,0,0,1,0,2,3,1
6235,96903,1pK61ylyaaC4hALoXRUV5dMzHILaBLST,7GRhBDsirIGkRZBtSMEzNTyDr2JQm4xx,10,6,4,0,3,3,5,0,21,3.0,1,0.0,0,4,0,3,6,3,0,5,0,7,14,1
6236,96909,cydJyLaLNn5DY7FvXVsvxCdKUpzLzSYa,7GRhBDsirIGkRZBtSMEzNTyDr2JQm4xx,1,0,0,0,0,0,1,0,1,0.14285714285714285,1,0.0,0,0,0,0,0,0,0,1,0,0,1,1
6237,96942,ddBSvwjxr0YTDDcnYkevrytFfJuV96PQ,7GRhBDsirIGkRZBtSMEzNTyDr2JQm4xx,6,2,2,0,1,4,3,0,12,1.7142857142857142,1,0.0,0,2,0,1,2,4,0,3,0,3,9,0
6238,96973,sDkPRIBG4BxIPEbrLzSh2qpuZHtht3Is,7GRhBDsirIGkRZBtSMEzNTyDr2JQm4xx,5,5,0,0,0,4,2,1,12,1.7142857142857142,1,0.0,0,0,0,0,5,4,0,2,1,0,12,1
6239,96985,JXYISIoy0xfDgxPuIXBBnerkjGt68Wii,7GRhBDsirIGkRZBtSMEzNTyDr2JQm4xx,2,0,0,0,0,0,2,0,2,0.2857142857142857,1,0.0,0,0,0,0,0,0,0,2,0,0,2,1
6240,96988,UpJhrUDqF2VjXGqQuraSx51MIPsKK7IC,7GRhBDsirIGkRZBtSMEzNTyDr2JQm4xx,1,0,0,0,0,0,1,0,1,0.14285714285714285,1,0.0,0,0,0,0,0,0,0,1,0,0,1,1
6241,96994,Pn5FZNl6VLJk6Snk5stzxPkp0wDMfahE,7GRhBDsirIGkRZBtSMEzNTyDr2JQm4xx,17,18,7,6,7,6,3,0,47,6.714285714285714,1,0.0,10,7,5,7,8,6,1,3,0,29,18,1
6242,97000,NTUe1XMr3a8PtjVuNaWc1ebEh7ejstpo,7GRhBDsirIGkRZBtSMEzNTyDr2JQm4xx,5,3,1,0,1,1,2,0,8,1.1428571428571428,1,0.0,0,1,0,1,3,1,0,2,0,2,6,1
6243,97002,uRoFRO1euFkfOgsqx7mXaWeoTuIR1DXQ,7GRhBDsirIGkRZBtSMEzNTyDr2JQm4xx,1,0,0,0,0,0,1,0,1,0.14285714285714285,1,0.0,0,0,0,0,0,0,0,1,0,0,1,1
6244,97009,nRHQUNRUIsIinoYx4tQlxNnAC0I3YYVk,7GRhBDsirIGkRZBtSMEzNTyDr2JQm4xx,4,2,1,0,1,0,1,0,5,0.7142857142857143,1,0.0,0,1,0,1,2,0,0,1,0,2,3,1
6245,97022,B5xWWXtq7QtEIXusjmb70Va0vI762ykg,7GRhBDsirIGkRZBtSMEzNTyDr2JQm4xx,1,0,0,0,0,0,1,0,1,0.14285714285714285,1,0.0,0,0,0,0,0,0,0,1,0,0,1,1
6246,97065,M2tv4JvKfiiNHzXtHrilXY5dpWpYAsaI,7GRhBDsirIGkRZBtSMEzNTyDr2JQm4xx,8,5,3,0,2,1,6,1,18,2.5714285714285716,1,0.0,0,3,0,2,5,1,0,6,1,5,13,1
6247,97117,c8WJAdYLV71mOx4ZXSglpCNd0dBUR3Om,7GRhBDsirIGkRZBtSMEzNTyDr2JQm4xx,53,40,16,53,9,0,7,0,125,17.857142857142858,3,0.0,19,16,53,9,21,0,0,7,0,97,28,0
6248,97118,4qkLaALORr1a036cib5fpJjiu97UEMIR,A3fsA9Zfv1X2fVEQhTw51lKENdNrEqT3,1,0,0,0,0,0,1,0,1,0.14285714285714285,1,0.0,0,0,0,0,0,0,0,1,0,0,1,0
6249,97187,QRq9SneqdOEdNrPCbzGfNOJsUrpMzzSX,7GRhBDsirIGkRZBtSMEzNTyDr2JQm4xx,6,2,1,0,0,0,4,1,8,1.1428571428571428,1,0.0,0,1,0,0,2,0,0,4,1,1,7,1
6250,97214,9HiOT9GgvrP1q1oAqpQLpBir7zKJrsoX,A3fsA9Zfv1X2fVEQhTw51lKENdNrEqT3,25,26,13,0,9,0,5,0,53,7.571428571428571,1,0.0,0,13,0,9,26,0,0,5,0,22,31,0
6251,97267,lDlatmKJdo0qBYapZcbWQLsUydBhY3xU,7GRhBDsirIGkRZBtSMEzNTyDr2JQm4xx,2,0,0,0,0,0,2,0,2,0.2857142857142857,1,0.0,0,0,0,0,0,0,0,2,0,0,2,1
6252,97280,K3hHnTNefmiCtc4XrTaWBBqlsZLO9w2Y,7GRhBDsirIGkRZBtSMEzNTyDr2JQm4xx,7,2,1,0,1,0,6,0,10,1.4285714285714286,1,0.0,0,1,0,1,2,0,0,6,0,2,8,1
6253,97284,pMJooPSuvdyxYlrVEgbsDyM57xOtG2AB,7GRhBDsirIGkRZBtSMEzNTyDr2JQm4xx,10,20,8,0,3,5,12,1,49,7.0,1,0.0,0,8,0,3,20,5,0,12,1,11,38,1
6254,97298,tp9GLoYyljDV6mILQxrtrv1Iw4qcPl5Z,7GRhBDsirIGkRZBtSMEzNTyDr2JQm4xx,6,4,2,0,1,0,2,0,9,1.2857142857142858,1,0.0,1,2,0,1,3,0,0,2,0,4,5,1
6255,97310,OQh4D4FzaoRB0CBhRcAfr9BP6p8j9VSR,7GRhBDsirIGkRZBtSMEzNTyDr2JQm4xx,46,108,41,63,28,22,14,1,277,39.57142857142857,2,0.0,59,41,55,28,49,22,8,14,1,183,94,1
6256,97320,l70wRZ2DS0s6LjbT7C4gRoGrF27x9p2H,7GRhBDsirIGkRZBtSMEzNTyDr2JQm4xx,5,4,1,0,1,0,2,0,8,1.1428571428571428,2,0.0,0,1,0,1,4,0,0,2,0,2,6,1
6257,97324,f90qLjbKhR4QYxfjw2iRpmn1h5TurGYb,7GRhBDsirIGkRZBtSMEzNTyDr2JQm4xx,1,0,0,0,0,0,1,0,1,0.14285714285714285,1,0.0,0,0,0,0,0,0,0,1,0,0,1,1
6258,97328,drUu3tyovHqnF7EAaPHayHDYbWMe2Od6,7GRhBDsirIGkRZBtSMEzNTyDr2JQm4xx,1,0,0,0,0,0,1,0,1,0.14285714285714285,1,0.0,0,0,0,0,0,0,0,1,0,0,1,1
6259,97345,PUW0i4IuafllkJEtV0GCqmTDeLHkDmH3,7GRhBDsirIGkRZBtSMEzNTyDr2JQm4xx,26,28,8,34,0,2,4,0,76,10.857142857142858,2,0.0,10,8,29,0,18,2,5,4,0,47,29,0
6260,97357,VnkZQ14wQqfipOllRb5zJLKqrvJ7kfcr,7GRhBDsirIGkRZBtSMEzNTyDr2JQm4xx,25,70,24,24,11,2,8,0,139,19.857142857142858,2,0.0,37,24,22,11,33,2,2,8,0,94,45,1
6261,97373,PkSfLYbj8bmlsWpi3b15gaXmhBJLMldT,7GRhBDsirIGkRZBtSMEzNTyDr2JQm4xx,4,0,0,0,0,0,5,0,5,0.7142857142857143,1,0.0,0,0,0,0,0,0,0,5,0,0,5,1
6262,97388,X4FMUX7NyjmKPKTTYvtQYUeaVHGTuyBO,7GRhBDsirIGkRZBtSMEzNTyDr2JQm4xx,1,0,0,0,0,0,1,0,1,0.14285714285714285,1,0.0,0,0,0,0,0,0,0,1,0,0,1,1
6263,97462,nCZrnJjbpsSoXVwiEhCJqTYAOI3F94p9,7GRhBDsirIGkRZBtSMEzNTyDr2JQm4xx,1,0,0,0,0,0,1,0,1,0.14285714285714285,1,0.0,0,0,0,0,0,0,0,1,0,0,1,1
6264,97464,rX6twqRSTJA5YELRg8HEcckmy1BY4CL4,7GRhBDsirIGkRZBtSMEzNTyDr2JQm4xx,2,0,0,0,0,0,4,0,4,0.5714285714285714,1,0.0,0,0,0,0,0,0,0,4,0,0,4,1
6265,97489,gSg4PIaWl0hBhOgVlpN9o8YrQn4pTOeq,A3fsA9Zfv1X2fVEQhTw51lKENdNrEqT3,36,27,23,42,16,4,8,0,120,17.142857142857142,1,0.0,2,23,36,16,25,4,6,8,0,77,43,1
6266,97503,kuZwBvEdgeUtKZ495C2FptBbxEtLtmVH,A3fsA9Zfv1X2fVEQhTw51lKENdNrEqT3,52,59,29,66,20,0,11,0,185,26.428571428571427,6,0.0,3,29,59,20,56,0,7,11,0,111,74,0
6267,97505,irC65kbKvoZeQoBjNpGJgeuitn3hVGmi,7GRhBDsirIGkRZBtSMEzNTyDr2JQm4xx,16,13,8,0,6,0,1,0,28,4.0,1,0.0,4,8,0,6,9,0,0,1,0,18,10,1
6268,97552,EO6xtvTLkHLCut4ifOiDl6xUZBrLObA6,7GRhBDsirIGkRZBtSMEzNTyDr2JQm4xx,1,0,0,0,0,0,1,0,1,0.14285714285714285,1,0.0,0,0,0,0,0,0,0,1,0,0,1,1
6269,97591,2B1Sa19tBbYgocD2xlB5fX7K09dmclmZ,7GRhBDsirIGkRZBtSMEzNTyDr2JQm4xx,5,5,1,0,1,0,1,0,8,1.1428571428571428,1,0.0,0,1,0,1,5,0,0,1,0,2,6,1
6270,97613,kz8Qaij4c30iDpbw4iAszcAM45hxcKwU,7GRhBDsirIGkRZBtSMEzNTyDr2JQm4xx,6,2,1,0,1,0,4,0,8,1.1428571428571428,2,0.0,0,1,0,1,2,0,0,4,0,2,6,1
6271,97636,xjgxPvzfyFRaUpAnYKBxqwH6viCz5kQQ,7GRhBDsirIGkRZBtSMEzNTyDr2JQm4xx,11,8,0,0,0,2,3,0,13,1.8571428571428572,1,0.0,0,0,0,0,8,2,0,3,0,0,13,1
6272,97740,pC1UDzWN2ohmqWVct0AFjGKW6gzUzWEQ,7GRhBDsirIGkRZBtSMEzNTyDr2JQm4xx,1,0,0,0,0,0,1,0,1,0.14285714285714285,1,0.0,0,0,0,0,0,0,0,1,0,0,1,1
6273,97741,WIkPVA3ZQexYqPa7aSal3hPiR2XYOXKW,7GRhBDsirIGkRZBtSMEzNTyDr2JQm4xx,7,5,3,4,1,4,2,0,19,2.7142857142857144,1,0.0,1,3,3,1,4,4,1,2,0,8,11,1
6274,97788,rUoEyfIkacNKFckMvyv3DLlxAp35p4TH,7GRhBDsirIGkRZBtSMEzNTyDr2JQm4xx,1,0,0,0,0,0,1,0,1,0.14285714285714285,1,0.0,0,0,0,0,0,0,0,1,0,0,1,1
6275,97823,ATQZndVeRd2FYpO1RdHKpCdTF73Knsgq,7GRhBDsirIGkRZBtSMEzNTyDr2JQm4xx,25,28,8,22,9,0,1,0,68,9.714285714285714,1,0.0,19,8,20,9,9,0,2,1,0,56,12,1
6276,97850,xRxxfDF9JUhs0UX7r4WnpuABa2UDKRlw,7GRhBDsirIGkRZBtSMEzNTyDr2JQm4xx,5,3,1,0,1,0,2,0,7,1.0,1,0.0,0,1,0,1,3,0,0,2,0,2,5,1
6277,97852,ZzaZO5citAcoeYBQ4xnco2bMgq0deP0c,7GRhBDsirIGkRZBtSMEzNTyDr2JQm4xx,5,2,1,0,1,0,2,0,6,0.8571428571428571,1,0.0,0,1,0,1,2,0,0,2,0,2,4,1
6278,97886,OCAzb1VfLGBRFoguhxZLxVaO4EgntnGi,7GRhBDsirIGkRZBtSMEzNTyDr2JQm4xx,11,5,4,0,3,2,9,1,24,3.4285714285714284,1,0.0,0,4,0,3,5,2,0,9,1,7,17,1
6279,97920,vWPEyRranfmzkX1ptXTrcH52A4pj7s7J,7GRhBDsirIGkRZBtSMEzNTyDr2JQm4xx,8,6,3,0,1,0,7,0,17,2.4285714285714284,1,0.0,0,3,0,1,6,0,0,7,0,4,13,1
6280,98950,ltaPWMahEaqTdpjQAeiBFxa5xewAQJDv,SpATywNh6bZuzm8s1ceuBUnMUAeoAHHw,1,0,0,0,0,0,1,0,1,0.14285714285714285,1,0.0,0,0,0,0,0,0,0,1,0,0,1,1
6281,98954,wBGtqMIqfQE0VLJPhcCJAUkBOhFNa6qW,G8EPVSXsOYB5YQWZGiz1aVq5Pgr2GrQu,7,4,0,0,0,0,10,1,15,2.142857142857143,3,0.0,0,0,0,0,4,0,0,10,1,0,15,1
6282,98963,y2GG0eXD492QyyIoYTZNCQnQCo2nl9OI,SpATywNh6bZuzm8s1ceuBUnMUAeoAHHw,4,6,0,0,0,1,2,0,9,1.2857142857142858,1,0.0,0,0,0,0,6,1,0,2,0,0,9,1
6283,98973,uxdJIidy36Grvd6xNfpUFUhDe4OC7W0I,SpATywNh6bZuzm8s1ceuBUnMUAeoAHHw,2,0,0,0,0,0,2,0,2,0.2857142857142857,1,0.0,0,0,0,0,0,0,0,2,0,0,2,1
6284,98979,fIRimGrxWNqdzbEvkhoxiWFjGRhUXcWW,bWdj2GDclj5ofokWjzoa5jAwMkxCykd6,9,12,9,0,7,0,3,0,31,4.428571428571429,3,0.0,0,9,0,7,12,0,0,3,0,16,15,1
6285,98990,m30r8XAusN1tKwuw4RNeOZUufFJ19O18,G8EPVSXsOYB5YQWZGiz1aVq5Pgr2GrQu,1,0,0,0,0,0,1,0,1,0.14285714285714285,1,0.0,0,0,0,0,0,0,0,1,0,0,1,1
6286,99018,ifcc4uHfz9c03WKs2R4honhWtRoNdK5d,SpATywNh6bZuzm8s1ceuBUnMUAeoAHHw,4,0,0,0,0,0,4,0,4,0.5714285714285714,1,0.0,0,0,0,0,0,0,0,4,0,0,4,1
6287,99029,qg6GOCuPcDwehPMMAEed7GZuAdyiaV9B,bWdj2GDclj5ofokWjzoa5jAwMkxCykd6,14,23,0,72,5,0,9,3,112,16.0,2,0.0,14,0,71,5,9,0,1,9,3,90,22,0
6288,99046,O7BkYKGPbSCKVITR1KG0UTtUy6cDdabs,SpATywNh6bZuzm8s1ceuBUnMUAeoAHHw,13,8,5,9,3,0,4,0,29,4.142857142857143,1,0.0,3,5,9,3,5,0,0,4,0,20,9,1
6289,99054,zzAZgy76SGFU6cR6cdB2SgVDsOtIFGEc,SpATywNh6bZuzm8s1ceuBUnMUAeoAHHw,14,28,15,16,3,10,2,0,74,10.571428571428571,1,0.0,7,15,14,3,21,10,2,2,0,39,35,1
6290,99058,84jM92o4oluSWHz68fjJdNU1O5aejzX8,G8EPVSXsOYB5YQWZGiz1aVq5Pgr2GrQu,17,33,3,0,3,2,11,1,53,7.571428571428571,3,0.0,6,3,0,3,27,2,0,11,1,12,41,0
6291,99066,T3sGbyIt0UjiteEMsVXGzcCDHseJZwlW,bWdj2GDclj5ofokWjzoa5jAwMkxCykd6,3,0,0,0,0,0,5,0,5,0.7142857142857143,1,0.0,0,0,0,0,0,0,0,5,0,0,5,1
6292,99069,88XDkNH6bI4ALBv7wIako8gqEashqdgA,bWdj2GDclj5ofokWjzoa5jAwMkxCykd6,4,2,0,0,0,0,2,0,4,0.5714285714285714,1,0.0,0,0,0,0,2,0,0,2,0,0,4,1
6293,99070,9e5dcfJQbPUU8sTcmzE9DWoDPOA9Nhu3,RXDvfPUBYFlVdlueBFbLW0mhhAyGEqpt,10,15,1,0,1,0,2,0,19,2.7142857142857144,1,0.0,0,1,0,1,15,0,0,2,0,2,17,0
6294,99081,ZC2nAMORm6ACPbodv0ZDapZ3ammrIH2s,G8EPVSXsOYB5YQWZGiz1aVq5Pgr2GrQu,6,1,1,0,1,0,3,0,6,0.8571428571428571,1,0.0,0,1,0,1,1,0,0,3,0,2,4,1
6295,99082,4DxKDIVHzjxY43c2DifDetzvvaumQ2x6,RXDvfPUBYFlVdlueBFbLW0mhhAyGEqpt,8,7,1,0,1,0,1,0,10,1.4285714285714286,1,0.0,0,1,0,1,7,0,0,1,0,2,8,0
6296,99098,obIiPpvlsnw7kahKveiA1IdOjIdBUlWR,bWdj2GDclj5ofokWjzoa5jAwMkxCykd6,4,3,1,0,0,0,3,0,7,1.0,1,0.0,0,1,0,0,3,0,0,3,0,1,6,1
6297,99100,ZMTgNYkbfDsBe4X8ZM8wJYJMTUYSz0bl,SpATywNh6bZuzm8s1ceuBUnMUAeoAHHw,13,13,0,11,0,37,8,4,73,10.428571428571429,2,0.0,3,0,10,0,10,37,1,8,4,13,60,1
6298,99107,r3OdfccxoUjSXp0sWnFk9IAbamqaQLkg,SpATywNh6bZuzm8s1ceuBUnMUAeoAHHw,6,14,0,0,0,0,4,0,18,2.5714285714285716,3,0.0,0,0,0,0,14,0,0,4,0,0,18,1
6299,99118,8P2tXYi4EZDZkbdP0MJKzxjbxyxdg79S,bWdj2GDclj5ofokWjzoa5jAwMkxCykd6,4,2,0,0,0,0,4,0,6,0.8571428571428571,2,0.0,0,0,0,0,2,0,0,4,0,0,6,1
6300,99132,euFeRK4WVq3xP7j8z58Hdv4WK0cZyZNI,RXDvfPUBYFlVdlueBFbLW0mhhAyGEqpt,46,39,25,64,16,7,6,1,158,22.571428571428573,1,0.0,9,25,60,16,30,7,4,6,1,110,48,1
6301,99139,Q8CD0UEUMHAcRhd0KntpUKYo8YWk4fXe,SpATywNh6bZuzm8s1ceuBUnMUAeoAHHw,6,5,0,0,0,0,1,0,6,0.8571428571428571,1,0.0,0,0,0,0,5,0,0,1,0,0,6,1
6302,99174,u8ZjG1mGoKDfAR0qANs0LauHsnuYvByf,SpATywNh6bZuzm8s1ceuBUnMUAeoAHHw,2,0,0,0,0,0,2,0,2,0.2857142857142857,1,0.0,0,0,0,0,0,0,0,2,0,0,2,1
6303,99181,3gKLDpGjwKizSsdfJ1bxm4OzkmE9SSv0,G8EPVSXsOYB5YQWZGiz1aVq5Pgr2GrQu,10,5,3,0,3,0,5,2,18,2.5714285714285716,1,0.0,1,3,0,3,4,0,0,5,2,7,11,1
6304,99209,cKCzrCCCXe9nkBgWepq9AEXje7SITRTz,RXDvfPUBYFlVdlueBFbLW0mhhAyGEqpt,1,0,0,0,0,0,1,0,1,0.14285714285714285,1,0.0,0,0,0,0,0,0,0,1,0,0,1,1
6305,99238,Sd9iWVuleZqBvt54uADj49zmx7nnkEGd,SpATywNh6bZuzm8s1ceuBUnMUAeoAHHw,7,4,2,0,1,1,7,0,15,2.142857142857143,2,0.0,0,2,0,1,4,1,0,7,0,3,12,1
6306,99239,T0WYTVwYJgFl0x8drZ3acqWyc5rt9vgS,bWdj2GDclj5ofokWjzoa5jAwMkxCykd6,8,6,4,0,3,0,8,0,21,3.0,1,0.0,0,4,0,3,6,0,0,8,0,7,14,1
6307,99253,8i7cvJkHkgdZTPaFAtgMAW0lWMM44P2s,bWdj2GDclj5ofokWjzoa5jAwMkxCykd6,11,11,5,26,0,2,3,0,47,6.714285714285714,1,0.0,5,5,24,0,6,2,2,3,0,34,13,0
6308,99270,CV7h2ez66N3XbcrhHK1a0MSuvaKeLrbg,SpATywNh6bZuzm8s1ceuBUnMUAeoAHHw,4,2,1,0,1,0,1,0,5,0.7142857142857143,1,0.0,0,1,0,1,2,0,0,1,0,2,3,1
6309,99271,Pe5w2Jkb1gsjqOIYHp7FZfmU0KM6bSQ8,SpATywNh6bZuzm8s1ceuBUnMUAeoAHHw,9,15,1,24,0,39,3,0,82,11.714285714285714,2,0.0,9,1,19,0,6,39,5,3,0,29,53,1
6310,99274,F6DWPZmYOtVM9PypQunsAj9fDIO5oqCA,SpATywNh6bZuzm8s1ceuBUnMUAeoAHHw,7,3,1,0,2,0,2,0,8,1.1428571428571428,1,0.0,0,1,0,2,3,0,0,2,0,3,5,1
6311,99278,Zq7w9tMtshfWhXKxO6HgVWaJZugCDD4X,SpATywNh6bZuzm8s1ceuBUnMUAeoAHHw,7,2,0,0,0,0,6,1,9,1.2857142857142858,1,0.0,0,0,0,0,2,0,0,6,1,0,9,1
6312,99281,kLCnsSmz7iq09RICj2W5oj0rePK2t86T,A3fsA9Zfv1X2fVEQhTw51lKENdNrEqT3,7,4,2,0,1,0,5,0,12,1.7142857142857142,2,0.0,0,2,0,1,4,0,0,5,0,3,9,1
6313,99291,kkiueCBXYoPTmt9I3HbEovrMKKFeGu6b,SpATywNh6bZuzm8s1ceuBUnMUAeoAHHw,7,4,3,0,2,0,1,0,10,1.4285714285714286,1,0.0,0,3,0,2,4,0,0,1,0,5,5,1
6314,99301,U77qPrnpSziwcYTMiYVhQDvF7hOqssuP,A3fsA9Zfv1X2fVEQhTw51lKENdNrEqT3,1,0,0,0,0,0,1,0,1,0.14285714285714285,1,0.0,0,0,0,0,0,0,0,1,0,0,1,1
6315,99307,uA8rfZuH0eMveW06zMXRELfenuAEs8xA,RXDvfPUBYFlVdlueBFbLW0mhhAyGEqpt,12,10,8,0,6,0,1,0,25,3.5714285714285716,1,0.0,1,8,0,6,9,0,0,1,0,15,10,1
6316,99308,LtEcnNjG2bVTqyOQr5fGITsmCk6KdvTV,SpATywNh6bZuzm8s1ceuBUnMUAeoAHHw,7,3,2,0,2,0,2,0,9,1.2857142857142858,1,0.0,0,2,0,2,3,0,0,2,0,4,5,1
6317,99311,70RjGajH7pmMAPjzGV9cfLTOEtPaOO7x,bWdj2GDclj5ofokWjzoa5jAwMkxCykd6,4,0,0,0,0,0,5,1,6,0.8571428571428571,1,0.0,0,0,0,0,0,0,0,5,1,0,6,1
6318,99324,zZiKahy0aUh5eIyH06AprK07k6t9S0px,SpATywNh6bZuzm8s1ceuBUnMUAeoAHHw,1,0,0,0,0,0,1,0,1,0.14285714285714285,1,0.0,0,0,0,0,0,0,0,1,0,0,1,1
6319,99328,4lIBX7jVNURqeuVw7y54KWNhg5lYseZ6,bWdj2GDclj5ofokWjzoa5jAwMkxCykd6,10,8,3,0,2,5,7,0,25,3.5714285714285716,3,0.0,0,3,0,2,8,5,0,7,0,5,20,1
6320,99344,JbEjxQ5AsXJ2R3WBH2hwFnQgUiz9YCm1,RXDvfPUBYFlVdlueBFbLW0mhhAyGEqpt,33,71,42,41,21,19,32,5,231,33.0,3,0.0,14,42,33,21,57,19,8,32,5,110,121,0
6321,99347,d03TqUFy5aM2PIFe72rgYScPoI0zjriD,SpATywNh6bZuzm8s1ceuBUnMUAeoAHHw,1,0,0,0,0,0,1,0,1,0.14285714285714285,1,0.0,0,0,0,0,0,0,0,1,0,0,1,1
6322,99352,KQNAn65G00s1hNhpNIZbIlQjdMIvn0te,SpATywNh6bZuzm8s1ceuBUnMUAeoAHHw,3,2,0,0,0,1,2,0,5,0.7142857142857143,1,0.0,0,0,0,0,2,1,0,2,0,0,5,1
6323,99357,dA2znH7Ys1BZ6Ag1jC6siF2XLsfXuatY,G8EPVSXsOYB5YQWZGiz1aVq5Pgr2GrQu,10,12,4,0,4,0,5,0,25,3.5714285714285716,2,0.0,0,4,0,4,12,0,0,5,0,8,17,1
6324,99361,RUkwQN28KywAbYCPf8B2kmvVB4j6glMk,SpATywNh6bZuzm8s1ceuBUnMUAeoAHHw,4,3,0,0,0,0,2,0,5,0.7142857142857143,1,0.0,0,0,0,0,3,0,0,2,0,0,5,1
6325,99362,pUTxXh2GY765KSOGlKRsr8whr66yS2si,SpATywNh6bZuzm8s1ceuBUnMUAeoAHHw,6,3,1,0,1,0,2,0,7,1.0,1,0.0,0,1,0,1,3,0,0,2,0,2,5,1
6326,99367,7j1Qy60pQmlvQ7Dqk2iUN3aMOz565Svk,SpATywNh6bZuzm8s1ceuBUnMUAeoAHHw,10,7,4,0,3,0,5,0,19,2.7142857142857144,3,0.0,1,4,0,3,6,0,0,5,0,8,11,1
6327,99368,7M1gTpajHgYWFRBJBTE3YPlAjNYb9gfx,SpATywNh6bZuzm8s1ceuBUnMUAeoAHHw,1,0,0,0,0,0,1,0,1,0.14285714285714285,1,0.0,0,0,0,0,0,0,0,1,0,0,1,1
6328,99369,qW9QfVksexOjxQBoakOZ3N1wOwk2Uoq3,SpATywNh6bZuzm8s1ceuBUnMUAeoAHHw,4,2,0,0,0,0,4,0,6,0.8571428571428571,1,0.0,0,0,0,0,2,0,0,4,0,0,6,1
6329,99379,0DbC5JilnobJmMMZ806aDGvS966g1ymK,SpATywNh6bZuzm8s1ceuBUnMUAeoAHHw,5,3,1,0,1,1,2,0,8,1.1428571428571428,1,0.0,0,1,0,1,3,1,0,2,0,2,6,1
6330,99380,0DbC5JilnobJmMMZ806aDGvS966g1ymK,G8EPVSXsOYB5YQWZGiz1aVq5Pgr2GrQu,1,0,0,0,0,0,1,0,1,0.14285714285714285,1,0.0,0,0,0,0,0,0,0,1,0,0,1,1
6331,99395,kKVwpcRVIoBHXwQJxUscCmJVsObHmuic,SpATywNh6bZuzm8s1ceuBUnMUAeoAHHw,11,6,4,0,3,0,5,1,19,2.7142857142857144,1,0.0,0,4,0,3,6,0,0,5,1,7,12,1
6332,99410,RrZI3LBwWWMML70TBgENRap2pJnz1WcI,G8EPVSXsOYB5YQWZGiz1aVq5Pgr2GrQu,7,8,2,0,3,0,3,0,16,2.2857142857142856,1,0.0,4,2,0,3,4,0,0,3,0,9,7,1
6333,99419,CIojvdkZCguBWuN7246vWmUJ6qBNp7JQ,RXDvfPUBYFlVdlueBFbLW0mhhAyGEqpt,44,36,14,68,6,5,7,1,137,19.571428571428573,2,0.0,12,14,66,6,24,5,2,7,1,98,39,1
6334,99429,Og1p6VqqK505SKTAg7oggM1PpCX9htgK,bWdj2GDclj5ofokWjzoa5jAwMkxCykd6,2,0,0,0,0,0,2,0,2,0.2857142857142857,1,0.0,0,0,0,0,0,0,0,2,0,0,2,1
6335,99436,rPmua3xrnLtgdU4TZGq8z4hoSz54twnz,RXDvfPUBYFlVdlueBFbLW0mhhAyGEqpt,2,0,0,0,0,0,2,0,2,0.2857142857142857,1,0.0,0,0,0,0,0,0,0,2,0,0,2,1
6336,99458,XKiESHLmmxxFLSNhNTicMKXZo07ga8rR,SpATywNh6bZuzm8s1ceuBUnMUAeoAHHw,17,21,6,27,3,5,9,1,72,10.285714285714286,1,0.0,12,6,22,3,9,5,5,9,1,43,29,1
6337,99460,x0kuyWECJARUGYUkf8OBmp3NS07aeieW,SpATywNh6bZuzm8s1ceuBUnMUAeoAHHw,22,32,7,30,5,19,8,1,102,14.571428571428571,2,0.0,13,7,25,5,19,19,5,8,1,50,52,1
6338,99465,dDLv4oouOmVB45Y4hnRyV7IUqT7tMKiq,RXDvfPUBYFlVdlueBFbLW0mhhAyGEqpt,5,4,2,0,1,2,2,0,11,1.5714285714285714,1,0.0,0,2,0,1,4,2,0,2,0,3,8,1
6339,99476,H1SXscwZbeBIGdJtjznbLlFWKEefKgS4,bWdj2GDclj5ofokWjzoa5jAwMkxCykd6,1,0,0,0,0,0,1,0,1,0.14285714285714285,1,0.0,0,0,0,0,0,0,0,1,0,0,1,1
6340,99482,YLgIjYna0b19CObH0aixdNFVjkWguI8z,SpATywNh6bZuzm8s1ceuBUnMUAeoAHHw,6,3,1,0,1,0,2,0,7,1.0,1,0.0,0,1,0,1,3,0,0,2,0,2,5,1
6341,99499,nazeZS8BdRMOGGuVriyb5M21Pn5Qng36,RXDvfPUBYFlVdlueBFbLW0mhhAyGEqpt,2,0,0,0,0,0,5,0,5,0.7142857142857143,3,0.0,0,0,0,0,0,0,0,5,0,0,5,1
6342,99504,F6k3M4cXPmDcGMYwz4MYjROjPe1tP3Ym,SpATywNh6bZuzm8s1ceuBUnMUAeoAHHw,2,0,0,0,0,0,2,0,2,0.2857142857142857,1,0.0,0,0,0,0,0,0,0,2,0,0,2,1
6343,99519,qsSi1uSJyI5PyAmcKOuOd3i9fMbo7Kcq,SpATywNh6bZuzm8s1ceuBUnMUAeoAHHw,18,35,4,4,3,10,15,6,77,11.0,2,0.0,0,4,3,3,35,10,1,15,6,10,67,1
6344,99523,tItJmM8DSrsR2C4SUW6G90kGTH9CET7i,A3fsA9Zfv1X2fVEQhTw51lKENdNrEqT3,1,0,0,0,0,0,1,0,1,0.14285714285714285,1,0.0,0,0,0,0,0,0,0,1,0,0,1,1
6345,99528,9HLdaHmr6CL0Qkr0yUtrnxT1uvy3iohQ,G8EPVSXsOYB5YQWZGiz1aVq5Pgr2GrQu,4,4,2,0,0,2,3,0,11,1.5714285714285714,1,0.0,0,2,0,0,4,2,0,3,0,2,9,1
6346,99538,aApTNsNL5V8p77KfIZfCDf8PLQlY5mEZ,RXDvfPUBYFlVdlueBFbLW0mhhAyGEqpt,10,5,4,0,3,0,2,0,14,2.0,1,0.0,0,4,0,3,5,0,0,2,0,7,7,1
6347,99544,VMv3kIqXbjzzweiSaOh7btZJMGqiha14,SpATywNh6bZuzm8s1ceuBUnMUAeoAHHw,8,5,3,0,2,0,4,0,14,2.0,2,0.0,0,3,0,2,5,0,0,4,0,5,9,1
6348,99548,hbUthRcRktel8CTk5FJE2GFw0tsGaPJX,SpATywNh6bZuzm8s1ceuBUnMUAeoAHHw,8,7,1,0,0,0,6,1,15,2.142857142857143,2,0.0,2,1,0,0,5,0,0,6,1,3,12,1
6349,99553,B48liWLvGTFhxmScNtRccVTYMrDSRz6T,SpATywNh6bZuzm8s1ceuBUnMUAeoAHHw,11,30,0,17,0,9,6,0,62,8.857142857142858,1,0.0,15,0,16,0,15,9,1,6,0,31,31,1
6350,99559,UvQp4bR98Xn1uwzsk2XfrzaGsOC8PbwE,SpATywNh6bZuzm8s1ceuBUnMUAeoAHHw,13,10,4,16,3,0,2,0,35,5.0,1,0.0,4,4,14,3,6,0,2,2,0,25,10,1
6351,99570,K9rvD8Iu0wq956P4CDD0WYKLX5TfMvJ0,G8EPVSXsOYB5YQWZGiz1aVq5Pgr2GrQu,1,0,0,0,0,0,1,0,1,0.14285714285714285,1,0.0,0,0,0,0,0,0,0,1,0,0,1,1
6352,99582,pJZjfxkmSUcLjysKXGMvcQJcdn3Lfmps,G8EPVSXsOYB5YQWZGiz1aVq5Pgr2GrQu,9,21,1,4,4,0,4,1,35,5.0,1,0.0,15,1,2,4,6,0,2,4,1,22,13,1
6353,99585,MsXQVdqX93JlyFfWTzQyZnJZn8bWw73p,G8EPVSXsOYB5YQWZGiz1aVq5Pgr2GrQu,1,0,0,0,0,0,1,0,1,0.14285714285714285,1,0.0,0,0,0,0,0,0,0,1,0,0,1,1
6354,99589,X2tBPTLsKr1PUmH63wCYNuKDkAG71YDY,SpATywNh6bZuzm8s1ceuBUnMUAeoAHHw,2,0,0,0,0,0,2,0,2,0.2857142857142857,1,0.0,0,0,0,0,0,0,0,2,0,0,2,1
6355,99591,X2tBPTLsKr1PUmH63wCYNuKDkAG71YDY,bWdj2GDclj5ofokWjzoa5jAwMkxCykd6,2,0,0,0,0,0,2,0,2,0.2857142857142857,1,0.0,0,0,0,0,0,0,0,2,0,0,2,1
6356,99624,eeYgUeHIQERDYwF1mxwVIZYsVaVSgwlV,RXDvfPUBYFlVdlueBFbLW0mhhAyGEqpt,1,0,0,0,0,0,1,0,1,0.14285714285714285,1,0.0,0,0,0,0,0,0,0,1,0,0,1,1
6357,99632,XcU2XTxeLZ8F89uBFmVFyW4cnWhjcEiA,SpATywNh6bZuzm8s1ceuBUnMUAeoAHHw,13,17,7,9,5,5,4,0,47,6.714285714285714,2,0.0,5,7,9,5,12,5,0,4,0,26,21,1
6358,99634,iKW0Nip3dgY8YRgutfX9HfgsuYc5FITi,SpATywNh6bZuzm8s1ceuBUnMUAeoAHHw,16,16,9,15,6,3,6,0,55,7.857142857142857,1,0.0,4,9,14,6,12,3,1,6,0,33,22,1
6359,99638,KfP7DqXlruQE3Tc1dgUq6GzZBbeDyO72,SpATywNh6bZuzm8s1ceuBUnMUAeoAHHw,6,7,2,0,1,1,2,0,13,1.8571428571428572,1,0.0,0,2,0,1,7,1,0,2,0,3,10,1
6360,99639,HdhmGphCRXsQFbeFhgLmEJAXmcjxk1qH,G8EPVSXsOYB5YQWZGiz1aVq5Pgr2GrQu,1,0,0,0,0,0,2,0,2,0.2857142857142857,2,0.0,0,0,0,0,0,0,0,2,0,0,2,1
6361,99653,2ENDZhPlfPQ7xqwHjrfLuuWg5Duw7ZBj,SpATywNh6bZuzm8s1ceuBUnMUAeoAHHw,17,37,17,12,4,1,15,1,87,12.428571428571429,5,0.0,5,17,12,4,32,1,0,15,1,38,49,0
6362,99654,uA8rfZuH0eMveW06zMXRELfenuAEs8xA,A3fsA9Zfv1X2fVEQhTw51lKENdNrEqT3,1,0,0,0,0,0,1,0,1,0.14285714285714285,1,0.0,0,0,0,0,0,0,0,1,0,0,1,1
6363,99667,yUFGaXV6e729cAx9t4iOfoMO0XzOm9Tn,SpATywNh6bZuzm8s1ceuBUnMUAeoAHHw,5,3,2,0,1,0,1,0,7,1.0,1,0.0,0,2,0,1,3,0,0,1,0,3,4,1
6364,99671,KbnH0sTIlztrZBuSXZduD8Hjf6pJFDbi,G8EPVSXsOYB5YQWZGiz1aVq5Pgr2GrQu,6,2,1,0,1,0,3,0,7,1.0,1,0.0,0,1,0,1,2,0,0,3,0,2,5,1
6365,99693,1poMA1x0qhCnYBPVsxm5CInRDHfF8Q0k,SpATywNh6bZuzm8s1ceuBUnMUAeoAHHw,10,12,8,0,4,2,15,3,44,6.285714285714286,1,0.0,0,8,0,4,12,2,0,15,3,12,32,1
6366,99715,xg8dkQPzve0MzcpgxvEsbKyY4VwKrxAC,G8EPVSXsOYB5YQWZGiz1aVq5Pgr2GrQu,1,0,0,0,0,0,1,0,1,0.14285714285714285,1,0.0,0,0,0,0,0,0,0,1,0,0,1,1
6367,99717,0b1xMc7vBqRRfJj4HArRLbAJZWV8VISr,RXDvfPUBYFlVdlueBFbLW0mhhAyGEqpt,1,0,0,0,0,0,1,0,1,0.14285714285714285,1,0.0,0,0,0,0,0,0,0,1,0,0,1,1
6368,99728,507IdnNFIDoiPRr88JDQa6OplkPcxI18,G8EPVSXsOYB5YQWZGiz1aVq5Pgr2GrQu,1,0,0,0,0,0,1,0,1,0.14285714285714285,1,0.0,0,0,0,0,0,0,0,1,0,0,1,1
6369,99747,SH3THvT9ATqMny80GD63EuK5GGnf8XMU,bWdj2GDclj5ofokWjzoa5jAwMkxCykd6,4,3,0,0,0,3,6,0,12,1.7142857142857142,3,0.0,0,0,0,0,3,3,0,6,0,0,12,1
6370,99752,v8s2hAX8tQgFD6i9MrUt2cuWPYPq3DuN,G8EPVSXsOYB5YQWZGiz1aVq5Pgr2GrQu,5,4,2,0,1,0,2,0,9,1.2857142857142858,2,0.0,0,2,0,1,4,0,0,2,0,3,6,0
6371,99758,q5R81Yw8uRP3FrwNvV49L9qc5ag0j7J9,A3fsA9Zfv1X2fVEQhTw51lKENdNrEqT3,1,0,0,0,0,0,1,0,1,0.14285714285714285,1,0.0,0,0,0,0,0,0,0,1,0,0,1,1
6372,99759,LgCMqz3FdP5FVzPuiAaae1dvV0Dou3Op,SpATywNh6bZuzm8s1ceuBUnMUAeoAHHw,7,3,2,0,2,0,2,0,9,1.2857142857142858,1,0.0,0,2,0,2,3,0,0,2,0,4,5,1
6373,99785,oNDKvCCMv3YHycTSYSxE4vCb7yy2VCwV,SpATywNh6bZuzm8s1ceuBUnMUAeoAHHw,10,3,2,0,2,7,5,1,20,2.857142857142857,1,0.0,0,2,0,2,3,7,0,5,1,4,16,1
6374,99798,t84V1IZRpqwPOLkIILsxQF8RqF1exsFD,SpATywNh6bZuzm8s1ceuBUnMUAeoAHHw,4,2,1,0,0,0,2,0,5,0.7142857142857143,1,0.0,0,1,0,0,2,0,0,2,0,1,4,1
6375,99810,E5f5bNHHVwXdE8xNDAy656AeEbGGB2sd,SpATywNh6bZuzm8s1ceuBUnMUAeoAHHw,11,43,3,27,2,0,3,0,78,11.142857142857142,2,0.0,30,3,23,2,13,0,4,3,0,58,20,1
6376,99812,ZDVmuYiPoGm0gu1bR2BaE1soF6dU5v1W,bWdj2GDclj5ofokWjzoa5jAwMkxCykd6,6,12,6,14,0,2,6,0,40,5.714285714285714,1,0.0,4,6,14,0,8,2,0,6,0,24,16,1
6377,99813,7aA6BrVZipLHOrozlrYBMEmfMq4MXahq,A3fsA9Zfv1X2fVEQhTw51lKENdNrEqT3,1,0,0,0,0,0,1,0,1,0.14285714285714285,1,0.0,0,0,0,0,0,0,0,1,0,0,1,1
6378,99817,TJwArXyryXs3RiLiYIGaN8bFGgjvPLws,SpATywNh6bZuzm8s1ceuBUnMUAeoAHHw,4,2,1,0,1,0,2,0,6,0.8571428571428571,1,0.0,0,1,0,1,2,0,0,2,0,2,4,1
6379,99819,GjfzOWel7UtLS6b5EULEaoKkW3os5vHa,SpATywNh6bZuzm8s1ceuBUnMUAeoAHHw,5,2,1,0,1,0,3,0,7,1.0,1,0.0,0,1,0,1,2,0,0,3,0,2,5,1
6380,99822,mb36VuCvp1Z6gW8mqkNElCgDYgcBIF3z,SpATywNh6bZuzm8s1ceuBUnMUAeoAHHw,7,11,8,0,6,0,3,0,28,4.0,1,0.0,0,8,0,6,11,0,0,3,0,14,14,1
6381,99831,Jzdxwa4kNVDonbh32Q542LfZRfsA4OPw,SpATywNh6bZuzm8s1ceuBUnMUAeoAHHw,8,3,2,0,2,1,4,0,12,1.7142857142857142,1,0.0,0,2,0,2,3,1,0,4,0,4,8,1
6382,99839,TdfXOtlNb7Av3MtzwkldFOrTHIZeitdz,SpATywNh6bZuzm8s1ceuBUnMUAeoAHHw,10,24,16,0,9,3,10,0,62,8.857142857142858,3,0.0,0,16,0,9,24,3,0,10,0,25,37,0
6383,99840,eVv8K2gdE5SVTmPw9MARDIRZSaYqMHSQ,SpATywNh6bZuzm8s1ceuBUnMUAeoAHHw,11,9,0,10,0,0,3,2,24,3.4285714285714284,1,0.0,2,0,9,0,7,0,1,3,2,11,13,1
6384,99843,oNDKvCCMv3YHycTSYSxE4vCb7yy2VCwV,RXDvfPUBYFlVdlueBFbLW0mhhAyGEqpt,9,5,4,0,4,0,4,0,17,2.4285714285714284,1,0.0,0,4,0,4,5,0,0,4,0,8,9,1
6385,99866,7aA6BrVZipLHOrozlrYBMEmfMq4MXahq,bWdj2GDclj5ofokWjzoa5jAwMkxCykd6,1,0,0,0,0,0,1,0,1,0.14285714285714285,1,0.0,0,0,0,0,0,0,0,1,0,0,1,1
6386,99879,6ACUaz471Pn1fnrZDeY9K0EfEHUBtjpk,SpATywNh6bZuzm8s1ceuBUnMUAeoAHHw,17,11,6,17,3,24,13,3,77,11.0,1,0.0,2,6,15,3,9,24,2,13,3,26,51,1
6387,99883,CFvk4wjTMYl1iJidR1XmhJBW4azBqofZ,SpATywNh6bZuzm8s1ceuBUnMUAeoAHHw,6,3,1,0,1,0,4,0,9,1.2857142857142858,1,0.0,0,1,0,1,3,0,0,4,0,2,7,1
6388,99891,cNOMlpfCFQuhn4NfuqDzr2Vocotv36oU,A3fsA9Zfv1X2fVEQhTw51lKENdNrEqT3,1,0,0,0,0,0,1,0,1,0.14285714285714285,1,0.0,0,0,0,0,0,0,0,1,0,0,1,1
6389,99892,DDOsm4qYmwEA6E1tTBXPjk0uhAES8TZ9,SpATywNh6bZuzm8s1ceuBUnMUAeoAHHw,9,7,3,3,2,0,2,0,17,2.4285714285714284,1,0.0,3,3,3,2,4,0,0,2,0,11,6,1
6390,99895,sRTon1VBBuP0uvdQE1lWLIce29YVBv8J,SpATywNh6bZuzm8s1ceuBUnMUAeoAHHw,13,19,0,11,0,4,8,0,42,6.0,2,0.0,6,0,10,0,13,4,1,8,0,16,26,1
6391,99900,90Ea96jYOrWvumropceyEFhiPsTvKfzf,bWdj2GDclj5ofokWjzoa5jAwMkxCykd6,8,4,0,0,0,1,4,1,10,1.4285714285714286,1,0.0,0,0,0,0,4,1,0,4,1,0,10,1
6392,99902,Fio0BW8a5yrv46EIdUqSrGYnBJXNuvAc,G8EPVSXsOYB5YQWZGiz1aVq5Pgr2GrQu,1,0,0,0,0,0,1,0,1,0.14285714285714285,1,0.0,0,0,0,0,0,0,0,1,0,0,1,1
6393,99905,GR0IZ8RAROGoO8dlKHQecnjtd4J4CV8E,SpATywNh6bZuzm8s1ceuBUnMUAeoAHHw,7,4,3,0,3,0,2,0,12,1.7142857142857142,1,0.0,0,3,0,3,4,0,0,2,0,6,6,1
6394,99908,Wlz3wRUCGZdxuPjJRKNKqt34F0pjoQUU,SpATywNh6bZuzm8s1ceuBUnMUAeoAHHw,5,3,0,0,0,0,2,0,5,0.7142857142857143,1,0.0,0,0,0,0,3,0,0,2,0,0,5,1
6395,99910,T0V1MC6bsX3mZxJfTJfqpva6BwB6iZOI,SpATywNh6bZuzm8s1ceuBUnMUAeoAHHw,5,3,2,0,2,0,2,0,9,1.2857142857142858,1,0.0,0,2,0,2,3,0,0,2,0,4,5,1
6396,99919,bzlTCtIUcO5BfACSIQwT3PRYSdK0QGTr,bWdj2GDclj5ofokWjzoa5jAwMkxCykd6,5,2,1,0,1,0,3,0,7,1.0,2,0.0,0,1,0,1,2,0,0,3,0,2,5,1
6397,99924,s22y3yJL9OZAJbywe5kehjyeI57l8QWk,SpATywNh6bZuzm8s1ceuBUnMUAeoAHHw,1,0,0,0,0,0,2,0,2,0.2857142857142857,1,0.0,0,0,0,0,0,0,0,2,0,0,2,1
6398,99933,grGzcyT8HhVfjhYhmvwa7hRZvpxVILf7,SpATywNh6bZuzm8s1ceuBUnMUAeoAHHw,12,19,5,15,4,0,1,0,44,6.285714285714286,1,0.0,13,5,14,4,6,0,1,1,0,36,8,1
6399,99936,Oi7Qhc5WNxKsxx530z6SWxDXUzxiC0Iw,G8EPVSXsOYB5YQWZGiz1aVq5Pgr2GrQu,10,15,1,0,2,0,9,0,27,3.857142857142857,2,0.0,8,1,0,2,7,0,0,9,0,11,16,0
6400,99937,cnsyUcQdXkjXAZu2LRhrO31c8mThrNUr,SpATywNh6bZuzm8s1ceuBUnMUAeoAHHw,13,11,5,20,2,0,4,0,42,6.0,2,0.0,2,5,16,2,9,0,4,4,0,25,17,1
6401,99947,IZ16dnDzM5qLtyHLu3aaKf2eiaAGYSGA,SpATywNh6bZuzm8s1ceuBUnMUAeoAHHw,1,0,0,0,0,0,1,0,1,0.14285714285714285,1,0.0,0,0,0,0,0,0,0,1,0,0,1,1
6402,99956,JncF0A6NLmySeUG55ffbMgtwYs8JPP1N,bWdj2GDclj5ofokWjzoa5jAwMkxCykd6,2,0,0,0,0,0,2,0,2,0.2857142857142857,1,0.0,0,0,0,0,0,0,0,2,0,0,2,1
6403,99986,4dUaGH7iXRv1eQLzCgjayv9tRaG807lp,SpATywNh6bZuzm8s1ceuBUnMUAeoAHHw,12,9,6,16,3,0,1,0,35,5.0,1,0.0,2,6,13,3,7,0,3,1,0,24,11,1
6404,99990,BY7rZbvKNAuIQddu3IMUH8CKbKBlCl4t,SpATywNh6bZuzm8s1ceuBUnMUAeoAHHw,16,47,25,17,8,6,15,1,119,17.0,4,0.0,6,25,14,8,41,6,3,15,1,53,66,0
6405,99994,25I3ZHC2CKPuZdwEsDJVb3ivMmenYIrh,SpATywNh6bZuzm8s1ceuBUnMUAeoAHHw,1,0,0,0,0,0,1,0,1,0.14285714285714285,1,0.0,0,0,0,0,0,0,0,1,0,0,1,1
6406,99997,DtHgKVPDhIQdcn9LoDGSbijzl93Gk2jn,SpATywNh6bZuzm8s1ceuBUnMUAeoAHHw,6,3,1,0,1,0,2,0,7,1.0,1,0.0,0,1,0,1,3,0,0,2,0,2,5,1
6407,99999,6sN2V3D1BSB8BILaihUzYoUSAATbUImJ,G8EPVSXsOYB5YQWZGiz1aVq5Pgr2GrQu,2,0,0,0,0,0,2,0,2,0.2857142857142857,1,0.0,0,0,0,0,0,0,0,2,0,0,2,1
6408,100015,kVQgvZQEECWcBpDBfOHSkyukPIRvJ5sY,RXDvfPUBYFlVdlueBFbLW0mhhAyGEqpt,1,0,0,0,0,0,1,0,1,0.14285714285714285,1,0.0,0,0,0,0,0,0,0,1,0,0,1,1
6409,100024,yIWuZECPMnNHsT4nnuxaCnrNgzyFmEU4,SpATywNh6bZuzm8s1ceuBUnMUAeoAHHw,12,9,1,13,0,0,6,0,29,4.142857142857143,2,0.0,2,1,11,0,7,0,2,6,0,14,15,1
6410,100027,lVpMvFJQUkBRc5QzVKlkj16QaA3takHv,G8EPVSXsOYB5YQWZGiz1aVq5Pgr2GrQu,20,10,6,42,3,5,4,0,70,10.0,1,0.0,3,6,34,3,7,5,8,4,0,46,24,0
6411,100028,AMKNyvONM5p8NpA87JkQdxEGdnEv8UBc,SpATywNh6bZuzm8s1ceuBUnMUAeoAHHw,14,14,2,20,1,11,11,4,63,9.0,2,0.0,2,2,17,1,12,11,3,11,4,22,41,1
6412,100034,UO4K287BxB8BWqN4Vsyelgc9IxlYK4Tg,SpATywNh6bZuzm8s1ceuBUnMUAeoAHHw,13,8,5,12,4,0,2,0,31,4.428571428571429,1,0.0,2,5,12,4,6,0,0,2,0,23,8,1
6413,100036,drecLIVL8lECR1fdFh4q87LPP9hTNU3f,SpATywNh6bZuzm8s1ceuBUnMUAeoAHHw,5,2,1,0,1,0,2,0,6,0.8571428571428571,1,0.0,0,1,0,1,2,0,0,2,0,2,4,1
6414,100061,wSHJOUrC5HDoRV04dRmaj6jhdM6NYaj6,RXDvfPUBYFlVdlueBFbLW0mhhAyGEqpt,17,26,16,0,9,1,12,0,64,9.142857142857142,1,0.0,0,16,0,9,26,1,0,12,0,25,39,1
6415,100063,ZmILkESSKwaUf7dlv2MYezsPM9kEgn0g,bWdj2GDclj5ofokWjzoa5jAwMkxCykd6,1,0,0,0,0,0,1,0,1,0.14285714285714285,1,0.0,0,0,0,0,0,0,0,1,0,0,1,1
6416,100072,GCBiFXC2EhwXYwz6gh8rDQT1ItPzfReO,SpATywNh6bZuzm8s1ceuBUnMUAeoAHHw,1,0,0,0,0,0,1,0,1,0.14285714285714285,1,0.0,0,0,0,0,0,0,0,1,0,0,1,1
6417,100101,7BLSB26pFgDMSTV4x8nY66FLFZIw20Ig,bWdj2GDclj5ofokWjzoa5jAwMkxCykd6,3,0,0,0,0,0,3,0,3,0.42857142857142855,1,0.0,0,0,0,0,0,0,0,3,0,0,3,1
6418,100118,e0PSviaCUv7g6edvYkj3Wxxy57eyFNfw,G8EPVSXsOYB5YQWZGiz1aVq5Pgr2GrQu,8,6,4,0,3,0,3,0,16,2.2857142857142856,1,0.0,0,4,0,3,6,0,0,3,0,7,9,1
6419,100121,zDkFthLb8QiYlJN46xEgukiHh2xvNh17,SpATywNh6bZuzm8s1ceuBUnMUAeoAHHw,12,8,4,4,6,24,5,0,51,7.285714285714286,1,0.0,0,4,4,6,8,24,0,5,0,14,37,1
6420,100126,92FUTIKpJKurgJxPcqboELrIlwQuRnws,SpATywNh6bZuzm8s1ceuBUnMUAeoAHHw,4,2,1,0,1,0,3,0,7,1.0,1,0.0,0,1,0,1,2,0,0,3,0,2,5,1
6421,100128,sQN6Ivaey7nQA0xFHZwWETnwBmEDP3C4,bWdj2GDclj5ofokWjzoa5jAwMkxCykd6,1,0,0,0,0,0,1,0,1,0.14285714285714285,1,0.0,0,0,0,0,0,0,0,1,0,0,1,1
6422,100129,UKq5lhvAp06ZhcbYGirhBoJurTHlyP25,SpATywNh6bZuzm8s1ceuBUnMUAeoAHHw,4,2,1,0,0,0,3,0,6,0.8571428571428571,1,0.0,0,1,0,0,2,0,0,3,0,1,5,0
6423,100132,zhtf7EZUjW6s3Guz5lXD8KDXJ4lw9cuB,SpATywNh6bZuzm8s1ceuBUnMUAeoAHHw,27,30,20,18,11,0,7,0,86,12.285714285714286,3,0.0,7,20,17,11,23,0,1,7,0,55,31,0
6424,100141,OMeQBd65CGlFdF9LPjtleDAWNG4SlWp3,SpATywNh6bZuzm8s1ceuBUnMUAeoAHHw,15,45,4,27,3,24,7,1,111,15.857142857142858,2,0.0,27,4,21,3,18,24,6,7,1,55,56,1
6425,100153,3ZBkeExde7b5snRqlcNlkhznPWJKIR4u,SpATywNh6bZuzm8s1ceuBUnMUAeoAHHw,3,2,0,0,0,0,1,0,3,0.42857142857142855,1,0.0,0,0,0,0,2,0,0,1,0,0,3,1
6426,100197,7VYsu22xA0behvNW5V0HO7suqw3RpS8G,A3fsA9Zfv1X2fVEQhTw51lKENdNrEqT3,1,0,0,0,0,0,1,0,1,0.14285714285714285,1,0.0,0,0,0,0,0,0,0,1,0,0,1,1
6427,100212,2bZFunHMPmr3ZtiaHMdXxkvbsb400BRF,bWdj2GDclj5ofokWjzoa5jAwMkxCykd6,7,2,1,0,1,0,5,1,10,1.4285714285714286,2,0.0,0,1,0,1,2,0,0,5,1,2,8,1
6428,100234,mV6vIHBrgth3lTaajvzuqQeEfK5qY5yY,SpATywNh6bZuzm8s1ceuBUnMUAeoAHHw,14,26,3,19,2,0,4,0,54,7.714285714285714,2,0.0,6,3,16,2,20,0,3,4,0,27,27,1
6429,100242,pOVkDtM2cW4XWonAB3isY5WCbnNkYAIp,G8EPVSXsOYB5YQWZGiz1aVq5Pgr2GrQu,12,38,2,30,5,1,6,1,83,11.857142857142858,1,0.0,21,2,21,5,17,1,9,6,1,49,34,0
6430,100248,YNyEESXbqSWkVhYDWRBMKhf7B8RI9hCb,SpATywNh6bZuzm8s1ceuBUnMUAeoAHHw,9,9,1,0,1,0,9,0,20,2.857142857142857,2,0.0,0,1,0,1,9,0,0,9,0,2,18,1
6431,100250,TciQEzJA4hKxeo0Ve5JLByGDZHpNx3uy,RXDvfPUBYFlVdlueBFbLW0mhhAyGEqpt,1,0,0,0,0,0,1,0,1,0.14285714285714285,1,0.0,0,0,0,0,0,0,0,1,0,0,1,1
6432,100254,qNh1HmZZ5IODkL9bGcGUg3xnGvE9VrLH,A3fsA9Zfv1X2fVEQhTw51lKENdNrEqT3,1,0,0,0,0,0,1,0,1,0.14285714285714285,1,0.0,0,0,0,0,0,0,0,1,0,0,1,1
6433,100255,CyLrnwOuvkEKQhwjogaYhZvzxTeqKBge,bWdj2GDclj5ofokWjzoa5jAwMkxCykd6,1,0,0,0,0,0,1,0,1,0.14285714285714285,1,0.0,0,0,0,0,0,0,0,1,0,0,1,1
6434,100259,c2Q5B1aYF1KkI9v6dRXIUSAa5DOcN20a,SpATywNh6bZuzm8s1ceuBUnMUAeoAHHw,1,0,0,0,0,0,1,0,1,0.14285714285714285,1,0.0,0,0,0,0,0,0,0,1,0,0,1,1
6435,100274,psBmoUfd8F19brtdh1bZTLzNbdOCOBdc,G8EPVSXsOYB5YQWZGiz1aVq5Pgr2GrQu,12,5,4,0,4,1,5,1,20,2.857142857142857,1,0.0,0,4,0,4,5,1,0,5,1,8,12,1
6436,100279,KyiebHDxme4fhoxffRK8u4aC4pCnnodx,RXDvfPUBYFlVdlueBFbLW0mhhAyGEqpt,7,9,1,0,1,0,3,0,14,2.0,2,0.0,0,1,0,1,9,0,0,3,0,2,12,1
6437,100283,RqdDZ59hZyptwdavZ7BebY7MyinitbUb,RXDvfPUBYFlVdlueBFbLW0mhhAyGEqpt,18,17,2,28,2,6,5,1,61,8.714285714285714,2,0.0,2,2,26,2,15,6,2,5,1,32,29,1
6438,100306,mSmEv1ySOfyHPKXATZwYWxeWIR1bOlzf,A3fsA9Zfv1X2fVEQhTw51lKENdNrEqT3,1,0,0,0,0,0,1,0,1,0.14285714285714285,1,0.0,0,0,0,0,0,0,0,1,0,0,1,1
6439,100316,zOam8QEm9OnWecRZGQt83gQL3mhsAeeZ,bWdj2GDclj5ofokWjzoa5jAwMkxCykd6,3,0,0,0,0,0,3,0,3,0.42857142857142855,1,0.0,0,0,0,0,0,0,0,3,0,0,3,1
6440,100317,jHFndzgHWJwhCt25LmxPZ3zqNFqlRdEb,A3fsA9Zfv1X2fVEQhTw51lKENdNrEqT3,7,3,2,0,2,0,2,0,9,1.2857142857142858,2,0.0,0,2,0,2,3,0,0,2,0,4,5,1
6441,100327,wrKMasi8LNygKef8piFZGi3m3QxjccZE,bWdj2GDclj5ofokWjzoa5jAwMkxCykd6,4,2,1,0,1,0,1,0,5,0.7142857142857143,1,0.0,0,1,0,1,2,0,0,1,0,2,3,1
6442,100328,KgI1c7voNVzVIvjs4ZhktR8A7fWkMDoW,SpATywNh6bZuzm8s1ceuBUnMUAeoAHHw,1,0,0,0,0,0,1,0,1,0.14285714285714285,1,0.0,0,0,0,0,0,0,0,1,0,0,1,1
6443,100330,XIlz5QvnlEzidDqYGld3VSh8CaOyBXAa,bWdj2GDclj5ofokWjzoa5jAwMkxCykd6,1,0,0,0,0,0,1,0,1,0.14285714285714285,1,0.0,0,0,0,0,0,0,0,1,0,0,1,1
6444,100338,ZtkS0KlWCGCzlEANBJ5GgCPzAAljBHVt,bWdj2GDclj5ofokWjzoa5jAwMkxCykd6,10,8,4,10,4,0,4,0,30,4.285714285714286,2,0.0,2,4,10,4,6,0,0,4,0,20,10,1
6445,100373,7rPiBqfbPQeCxCiqXyPinFDIqFEPCizE,SpATywNh6bZuzm8s1ceuBUnMUAeoAHHw,4,2,1,0,0,0,2,0,5,0.7142857142857143,1,0.0,0,1,0,0,2,0,0,2,0,1,4,1
6446,100377,MlHPKmdi90dDdvX24jYoFlYEp8xS4RGn,SpATywNh6bZuzm8s1ceuBUnMUAeoAHHw,8,23,8,0,3,3,6,0,43,6.142857142857143,3,0.0,1,8,0,3,22,3,0,6,0,12,31,0
6447,100383,CgW6eb6Uo35foWi9RCL2029DF7zH5e88,SpATywNh6bZuzm8s1ceuBUnMUAeoAHHw,7,2,1,0,1,1,7,1,13,1.8571428571428572,2,0.0,0,1,0,1,2,1,0,7,1,2,11,1
6448,100384,FMxvsapRPXXXNxGG3GDsHR7zl4E2ofKu,bWdj2GDclj5ofokWjzoa5jAwMkxCykd6,2,0,0,0,0,0,2,0,2,0.2857142857142857,1,0.0,0,0,0,0,0,0,0,2,0,0,2,1
6449,100388,2JB50R0jD3NibtfXa92f6mpF735lk1Oo,SpATywNh6bZuzm8s1ceuBUnMUAeoAHHw,13,10,6,16,3,0,1,0,36,5.142857142857143,1,0.0,2,6,14,3,8,0,2,1,0,25,11,1
6450,100391,kyGh4gel5GTGb41pTkpUlnRTMKLiWXKA,G8EPVSXsOYB5YQWZGiz1aVq5Pgr2GrQu,5,2,1,0,1,0,2,0,6,0.8571428571428571,1,0.0,0,1,0,1,2,0,0,2,0,2,4,1
6451,100395,lDJQud5AwL6Ba2zEaWPbxkrhuulYEvyw,bWdj2GDclj5ofokWjzoa5jAwMkxCykd6,1,0,0,0,0,0,3,0,3,0.42857142857142855,1,0.0,0,0,0,0,0,0,0,3,0,0,3,1
6452,100405,lsAfokF5POsODUr1G2X0v5zWkAd5sfbB,SpATywNh6bZuzm8s1ceuBUnMUAeoAHHw,2,0,0,0,0,0,3,0,3,0.42857142857142855,1,0.0,0,0,0,0,0,0,0,3,0,0,3,1
6453,100408,MlHPKmdi90dDdvX24jYoFlYEp8xS4RGn,RXDvfPUBYFlVdlueBFbLW0mhhAyGEqpt,14,22,1,0,1,3,2,0,29,4.142857142857143,2,0.0,4,1,0,1,18,3,0,2,0,6,23,0
6454,100412,OvbupWSPA81Tk7Ur62Bs2bcQ5LB2mCRC,bWdj2GDclj5ofokWjzoa5jAwMkxCykd6,1,0,0,0,0,0,1,0,1,0.14285714285714285,1,0.0,0,0,0,0,0,0,0,1,0,0,1,1
6455,100426,sWiS7fnOghX7y7YX6Vs9Fow1ZPp98c2P,bWdj2GDclj5ofokWjzoa5jAwMkxCykd6,10,26,0,0,3,3,15,1,48,6.857142857142857,1,0.0,9,0,0,3,17,3,0,15,1,12,36,1
6456,100439,FhVGWSUXUeZGSguiLBd186fsM4sRhpPL,G8EPVSXsOYB5YQWZGiz1aVq5Pgr2GrQu,9,11,1,22,1,0,1,0,36,5.142857142857143,1,0.0,3,1,17,1,8,0,5,1,0,22,14,1
6457,100450,lU8LXbJuGJewdk0jE0yxpPj20hcwCqO8,A3fsA9Zfv1X2fVEQhTw51lKENdNrEqT3,59,16,12,100,7,0,13,0,148,21.142857142857142,3,0.0,2,12,94,7,14,0,6,13,0,115,33,0
6458,100489,siw3z9CF4q7PdqdWdVvFDzTmHm8ZHf2L,SpATywNh6bZuzm8s1ceuBUnMUAeoAHHw,1,0,0,0,0,0,1,0,1,0.14285714285714285,1,0.0,0,0,0,0,0,0,0,1,0,0,1,1
6459,100499,ZIt5iRfEuLMxmr9xMDT0sX9zx5GgOmQf,A3fsA9Zfv1X2fVEQhTw51lKENdNrEqT3,1,0,0,0,0,0,2,0,2,0.2857142857142857,1,0.0,0,0,0,0,0,0,0,2,0,0,2,1
6460,100512,sv1H0k2AOskJuUJSlRoi2iUdzle6ZY5e,G8EPVSXsOYB5YQWZGiz1aVq5Pgr2GrQu,3,0,0,0,0,0,3,0,3,0.42857142857142855,1,0.0,0,0,0,0,0,0,0,3,0,0,3,1
6461,100523,FifZKzWgnHbxPg1j0vi1JZCTI4cVJ25l,G8EPVSXsOYB5YQWZGiz1aVq5Pgr2GrQu,9,8,0,6,0,0,2,0,16,2.2857142857142856,1,0.0,3,0,3,0,5,0,3,2,0,6,10,1
6462,100547,0Czxo1UyRYR5I2rUJ5duK2VwsqwaqR13,SpATywNh6bZuzm8s1ceuBUnMUAeoAHHw,10,6,0,0,0,4,6,1,17,2.4285714285714284,1,0.0,0,0,0,0,6,4,0,6,1,0,17,1
6463,100554,8msriFvaCCtQyOBjAsLjk1IXyxsB0lzq,RXDvfPUBYFlVdlueBFbLW0mhhAyGEqpt,5,3,2,0,0,0,2,0,7,1.0,2,0.0,0,2,0,0,3,0,0,2,0,2,5,1
6464,100560,x8DjxiuO7OZapd2gSqXnLZdmO4eYlUve,bWdj2GDclj5ofokWjzoa5jAwMkxCykd6,1,0,0,0,0,0,1,0,1,0.14285714285714285,1,0.0,0,0,0,0,0,0,0,1,0,0,1,1
6465,100568,9fKCM48WCwLwvCl1vZ5Sx66ep0GEs87k,RXDvfPUBYFlVdlueBFbLW0mhhAyGEqpt,10,8,3,6,1,0,1,0,19,2.7142857142857144,1,0.0,1,3,6,1,7,0,0,1,0,11,8,1
6466,100573,krUqGfXTBwqDLoVqEC6x5HRNcKeuU2b1,SpATywNh6bZuzm8s1ceuBUnMUAeoAHHw,1,0,0,0,0,0,1,0,1,0.14285714285714285,1,0.0,0,0,0,0,0,0,0,1,0,0,1,1
6467,100594,0m1xQAlS5S5aY7jod2X9WwncTIVqHxA2,SpATywNh6bZuzm8s1ceuBUnMUAeoAHHw,4,2,1,0,0,0,2,0,5,0.7142857142857143,1,0.0,0,1,0,0,2,0,0,2,0,1,4,0
6468,100599,2sNFZBlVAcN0C3ozIX9ouOQIe9XjJNO6,RXDvfPUBYFlVdlueBFbLW0mhhAyGEqpt,8,5,2,0,2,0,6,0,15,2.142857142857143,2,0.0,0,2,0,2,5,0,0,6,0,4,11,1
6469,100604,FYehGDNRsrl5wDaAnO5HST0ivs3hH7sH,SpATywNh6bZuzm8s1ceuBUnMUAeoAHHw,12,12,1,12,1,12,3,0,41,5.857142857142857,1,0.0,3,1,12,1,9,12,0,3,0,17,24,1
6470,100606,EW14eVSThxGfz3peXBNT9jQSWqEa62yw,SpATywNh6bZuzm8s1ceuBUnMUAeoAHHw,5,2,1,0,1,0,4,0,8,1.1428571428571428,1,0.0,0,1,0,1,2,0,0,4,0,2,6,1
6471,100608,qrBxOx4xvfJbTRNtYXFo4mMHRch3LE9R,bWdj2GDclj5ofokWjzoa5jAwMkxCykd6,2,0,0,0,0,0,3,0,3,0.42857142857142855,1,0.0,0,0,0,0,0,0,0,3,0,0,3,1
6472,100610,vPuo8DmIldZLRb6b5UgHPfgjxOLUxczJ,SpATywNh6bZuzm8s1ceuBUnMUAeoAHHw,8,6,3,0,2,4,4,0,19,2.7142857142857144,2,0.0,0,3,0,2,6,4,0,4,0,5,14,1
6473,100614,qeHXe8DRkB9urr63HS1yAMwTxQkwIbff,RXDvfPUBYFlVdlueBFbLW0mhhAyGEqpt,43,87,2,85,9,10,26,6,225,32.142857142857146,5,0.0,32,2,78,9,55,10,7,26,6,121,104,1
6474,100628,5POGITm84aGrgNJ0nsPFC65wjX6UfDmC,SpATywNh6bZuzm8s1ceuBUnMUAeoAHHw,4,2,0,0,0,0,5,0,7,1.0,1,0.0,0,0,0,0,2,0,0,5,0,0,7,1
6475,100642,5kFbFpqTAfcE9zjpZiw5sGDR5BhJdfrE,SpATywNh6bZuzm8s1ceuBUnMUAeoAHHw,5,3,0,0,0,0,2,0,5,0.7142857142857143,1,0.0,0,0,0,0,3,0,0,2,0,0,5,1
6476,100644,W3mRXTG4xhvVAzedNOQzsJsrgQcHfu8g,A3fsA9Zfv1X2fVEQhTw51lKENdNrEqT3,1,0,0,0,0,0,1,0,1,0.14285714285714285,1,0.0,0,0,0,0,0,0,0,1,0,0,1,1
6477,100647,rOlo2GoZP9TqbgRI0oVgxX8oSUKh8U3d,RXDvfPUBYFlVdlueBFbLW0mhhAyGEqpt,7,5,0,0,0,0,4,0,9,1.2857142857142858,1,0.0,0,0,0,0,5,0,0,4,0,0,9,1
6478,100648,lWNGGFUB9gkHAgPFHpuxssg4Y5G8A4T2,bWdj2GDclj5ofokWjzoa5jAwMkxCykd6,4,2,1,0,0,0,2,0,5,0.7142857142857143,1,0.0,0,1,0,0,2,0,0,2,0,1,4,1
6479,100659,rDec3XLpppIQx4sScddB7i9e44PtAV8K,A3fsA9Zfv1X2fVEQhTw51lKENdNrEqT3,1,0,0,0,0,0,1,0,1,0.14285714285714285,1,0.0,0,0,0,0,0,0,0,1,0,0,1,1
6480,100661,3C8bDgUvFDILMw4UNlmk2n4yo5NHVGtC,SpATywNh6bZuzm8s1ceuBUnMUAeoAHHw,11,18,0,15,0,1,5,0,39,5.571428571428571,2,0.0,8,0,15,0,10,1,0,5,0,23,16,1
6481,100677,ga70xb8tiQejcbGQlS6US7AEzd2ynNMR,bWdj2GDclj5ofokWjzoa5jAwMkxCykd6,5,5,2,0,1,0,2,0,10,1.4285714285714286,1,0.0,0,2,0,1,5,0,0,2,0,3,7,0
6482,100690,TqIZW6TBerJNN7EZw5XWZ32AUByseuDz,bWdj2GDclj5ofokWjzoa5jAwMkxCykd6,1,0,0,0,0,0,1,0,1,0.14285714285714285,1,0.0,0,0,0,0,0,0,0,1,0,0,1,1
6483,100693,5hXITOhzRYMjx2VRfYxzWyiyJwxTbApF,RXDvfPUBYFlVdlueBFbLW0mhhAyGEqpt,3,0,0,0,0,0,3,0,3,0.42857142857142855,1,0.0,0,0,0,0,0,0,0,3,0,0,3,1
6484,100715,vt827MYpYgT0JKXBC62SZ24Gxa8OJ87k,bWdj2GDclj5ofokWjzoa5jAwMkxCykd6,4,5,1,0,0,0,1,0,7,1.0,1,0.0,0,1,0,0,5,0,0,1,0,1,6,1
6485,100716,dGI6yveNenjFfT8c0PjNzk1ugu0VsvkU,G8EPVSXsOYB5YQWZGiz1aVq5Pgr2GrQu,2,0,0,0,0,0,2,0,2,0.2857142857142857,1,0.0,0,0,0,0,0,0,0,2,0,0,2,1
6486,100739,MqqmdkYysHqA6UDBkyqkZJffv3577kEU,SpATywNh6bZuzm8s1ceuBUnMUAeoAHHw,7,2,1,0,1,1,5,1,11,1.5714285714285714,1,0.0,0,1,0,1,2,1,0,5,1,2,9,1
6487,100745,oBC6VJY82mEcAXDVlIE68Xc4JnrHjU4b,SpATywNh6bZuzm8s1ceuBUnMUAeoAHHw,6,8,2,0,1,0,4,0,15,2.142857142857143,1,0.0,0,2,0,1,8,0,0,4,0,3,12,1
6488,100774,6cRse7eR1s1pCddP2ji9L7RuB7UYuqjL,SpATywNh6bZuzm8s1ceuBUnMUAeoAHHw,5,3,2,0,0,0,2,0,7,1.0,1,0.0,0,2,0,0,3,0,0,2,0,2,5,1
6489,100778,Wigd4PnyDnjfDcFOxsTBcEnXo7kl9GSg,SpATywNh6bZuzm8s1ceuBUnMUAeoAHHw,16,26,9,22,3,5,15,1,81,11.571428571428571,2,0.0,6,9,18,3,20,5,4,15,1,36,45,1
6490,100779,Qi3PLuC7w2Yo9hFgq37MObjY8icnRdc6,bWdj2GDclj5ofokWjzoa5jAwMkxCykd6,39,61,25,97,22,52,25,1,283,40.42857142857143,7,0.0,7,25,82,22,54,52,15,25,1,136,147,1
6491,100781,C82stxYBdobab5s8FnzuMHxgMBwKu2tD,A3fsA9Zfv1X2fVEQhTw51lKENdNrEqT3,1,0,0,0,0,0,1,0,1,0.14285714285714285,1,0.0,0,0,0,0,0,0,0,1,0,0,1,1
6492,100796,oDUwm6L4MXQ6JEb98dYg8X4b6ULu2zCm,SpATywNh6bZuzm8s1ceuBUnMUAeoAHHw,7,14,4,0,0,0,2,0,20,2.857142857142857,1,0.0,3,4,0,0,11,0,0,2,0,7,13,1
6493,100807,zfQZFTiqHKQUgpAItjpYn7ZjkbIcP825,SpATywNh6bZuzm8s1ceuBUnMUAeoAHHw,5,3,1,0,0,0,2,0,6,0.8571428571428571,2,0.0,0,1,0,0,3,0,0,2,0,1,5,1
6494,100817,jSNLRK8jxSbbcqhbWW7DXZqoGlvGgXDY,G8EPVSXsOYB5YQWZGiz1aVq5Pgr2GrQu,10,15,4,0,0,2,7,1,29,4.142857142857143,5,0.0,0,4,0,0,15,2,0,7,1,4,25,1
6495,100823,3SCBHiEI4HvwPrOQDNTIAqp1rZOAx5IK,bWdj2GDclj5ofokWjzoa5jAwMkxCykd6,17,52,29,112,18,0,10,0,221,31.571428571428573,5,0.0,15,29,105,18,37,0,7,10,0,167,54,1
6496,100834,EhKlFSggqkpH0G4s3hbhvR0dQLyh6jQ2,bWdj2GDclj5ofokWjzoa5jAwMkxCykd6,9,5,1,10,1,0,14,0,31,4.428571428571429,1,0.0,2,1,9,1,3,0,1,14,0,13,18,1
6497,100846,78iUKf97Yd7gLvilaD752YymIdL84Vdn,SpATywNh6bZuzm8s1ceuBUnMUAeoAHHw,5,4,1,0,0,0,2,0,7,1.0,1,0.0,0,1,0,0,4,0,0,2,0,1,6,1
6498,100862,G6iele4ho79nU5jQ1J8umZLq8jEFa9yN,bWdj2GDclj5ofokWjzoa5jAwMkxCykd6,6,6,3,0,1,14,4,1,29,4.142857142857143,2,0.0,0,3,0,1,6,14,0,4,1,4,25,1
6499,100869,jfd2LG9hNbbf5Lp41xKYtXydDr9rSQaq,G8EPVSXsOYB5YQWZGiz1aVq5Pgr2GrQu,4,3,1,0,1,0,1,0,6,0.8571428571428571,1,0.0,0,1,0,1,3,0,0,1,0,2,4,1
6500,100879,xlgVVLxBZCGRSXArMda1ZJ2EETOVQEd7,SpATywNh6bZuzm8s1ceuBUnMUAeoAHHw,5,2,1,0,1,1,2,0,7,1.0,1,0.0,0,1,0,1,2,1,0,2,0,2,5,1
6501,100888,JfI1PlGVl9kA0mdAoeqyEmchpJwdwBfa,SpATywNh6bZuzm8s1ceuBUnMUAeoAHHw,14,21,8,6,5,6,5,1,52,7.428571428571429,2,0.0,0,8,5,5,21,6,1,5,1,18,34,1
6502,100921,9Dj7cZ9RPLWRgYWhoZq69xKKKshP0n7X,A3fsA9Zfv1X2fVEQhTw51lKENdNrEqT3,1,0,0,0,0,0,1,0,1,0.14285714285714285,1,0.0,0,0,0,0,0,0,0,1,0,0,1,1
6503,100928,erUNLgaqPpXW5SB6BA1vjCrKhwxECQ5B,bWdj2GDclj5ofokWjzoa5jAwMkxCykd6,5,7,0,0,0,0,3,0,10,1.4285714285714286,2,0.0,0,0,0,0,7,0,0,3,0,0,10,1
6504,100931,QAQOQC9orxaSCK47wTUjk6OT4uXNA4IV,SpATywNh6bZuzm8s1ceuBUnMUAeoAHHw,1,0,0,0,0,0,1,0,1,0.14285714285714285,1,0.0,0,0,0,0,0,0,0,1,0,0,1,1
6505,100944,ZqMeeZA1fdjNAJGfaX50qgTzDRJ8YFP5,SpATywNh6bZuzm8s1ceuBUnMUAeoAHHw,7,9,5,0,2,1,4,0,21,3.0,2,0.0,0,5,0,2,9,1,0,4,0,7,14,1
6506,100956,Qi3PLuC7w2Yo9hFgq37MObjY8icnRdc6,RXDvfPUBYFlVdlueBFbLW0mhhAyGEqpt,4,2,1,0,1,0,2,0,6,0.8571428571428571,1,0.0,0,1,0,1,2,0,0,2,0,2,4,1
6507,100957,U04y5vFf0AfyJVGIOJHlryTyRQEOm5pT,bWdj2GDclj5ofokWjzoa5jAwMkxCykd6,4,2,1,0,1,0,1,0,5,0.7142857142857143,1,0.0,0,1,0,1,2,0,0,1,0,2,3,1
6508,100958,JHP5MvKDX3euU7PqF5LcZxc3GqSOARsL,SpATywNh6bZuzm8s1ceuBUnMUAeoAHHw,2,0,0,0,0,0,2,0,2,0.2857142857142857,1,0.0,0,0,0,0,0,0,0,2,0,0,2,1
6509,100960,U04y5vFf0AfyJVGIOJHlryTyRQEOm5pT,G8EPVSXsOYB5YQWZGiz1aVq5Pgr2GrQu,2,0,0,0,0,0,2,0,2,0.2857142857142857,1,0.0,0,0,0,0,0,0,0,2,0,0,2,1
6510,100961,pdDWSL0qqW5lqoVLDvyIeqmUWuTqLvQ6,SpATywNh6bZuzm8s1ceuBUnMUAeoAHHw,1,0,0,0,0,0,1,0,1,0.14285714285714285,1,0.0,0,0,0,0,0,0,0,1,0,0,1,1
6511,100978,4X713FvFJyCLvswyefbqyJ5rn4U0EDrr,G8EPVSXsOYB5YQWZGiz1aVq5Pgr2GrQu,7,2,1,0,1,0,5,1,10,1.4285714285714286,1,0.0,0,1,0,1,2,0,0,5,1,2,8,1
6512,100990,CnuwKGLCLbXYnPgy82VEWYA1NOiOhvr0,SpATywNh6bZuzm8s1ceuBUnMUAeoAHHw,24,48,0,22,1,1,13,2,87,12.428571428571429,5,0.0,12,0,17,1,36,1,5,13,2,30,57,0
6513,100997,coZTr10eytnE55me2AxqRWq6qrVXEB7M,SpATywNh6bZuzm8s1ceuBUnMUAeoAHHw,17,37,15,14,11,22,16,3,118,16.857142857142858,3,0.0,6,15,12,11,31,22,2,16,3,44,74,1
6514,101010,fd2e5NJVnyVwHFHuiTOOM639ZY1uThtn,SpATywNh6bZuzm8s1ceuBUnMUAeoAHHw,1,0,0,0,0,0,1,0,1,0.14285714285714285,1,0.0,0,0,0,0,0,0,0,1,0,0,1,1
6515,101011,6RuWsSvS3Ngnjl37PzNAaaGn8Jd9a1lW,SpATywNh6bZuzm8s1ceuBUnMUAeoAHHw,1,0,0,0,0,0,1,0,1,0.14285714285714285,1,0.0,0,0,0,0,0,0,0,1,0,0,1,1
6516,101020,0ZCSFawDDnRtGIJPo0HlmFehfeS6kHt8,SpATywNh6bZuzm8s1ceuBUnMUAeoAHHw,6,7,3,0,2,0,2,0,14,2.0,1,0.0,0,3,0,2,7,0,0,2,0,5,9,1
6517,101024,WSII4CAtuXXVd816MewodzGLKdBCCfc2,SpATywNh6bZuzm8s1ceuBUnMUAeoAHHw,15,32,11,18,7,1,8,0,77,11.0,2,0.0,14,11,17,7,18,1,1,8,0,49,28,0
6518,101026,mbu5XDK8Rjc919DDY9nTqWKI0jGsFurC,A3fsA9Zfv1X2fVEQhTw51lKENdNrEqT3,1,0,0,0,0,0,1,0,1,0.14285714285714285,1,0.0,0,0,0,0,0,0,0,1,0,0,1,1
6519,101029,qnchlLjb2Sg0NdcHhbSBOQwh2G3s1NPH,G8EPVSXsOYB5YQWZGiz1aVq5Pgr2GrQu,9,6,1,0,1,0,3,0,11,1.5714285714285714,2,0.0,0,1,0,1,6,0,0,3,0,2,9,1
6520,101037,eWW5LWmp2L4jfpnZTKTrpHZw2NPytGoT,A3fsA9Zfv1X2fVEQhTw51lKENdNrEqT3,1,0,0,0,0,0,1,0,1,0.14285714285714285,1,0.0,0,0,0,0,0,0,0,1,0,0,1,1
6521,101039,3Cx4dFPpXfBhy67BB6opyx75Z6TxCQV0,SpATywNh6bZuzm8s1ceuBUnMUAeoAHHw,1,0,0,0,0,0,1,0,1,0.14285714285714285,1,0.0,0,0,0,0,0,0,0,1,0,0,1,1
6522,101040,0MInlyhRLhTct7ctvAmGIMuZ2WCCEQOJ,A3fsA9Zfv1X2fVEQhTw51lKENdNrEqT3,1,0,0,0,0,0,1,0,1,0.14285714285714285,1,0.0,0,0,0,0,0,0,0,1,0,0,1,1
6523,101049,4s35oxsHucC7ffS0wFNPwafPYeG49GAU,SpATywNh6bZuzm8s1ceuBUnMUAeoAHHw,4,0,0,0,0,0,4,1,5,0.7142857142857143,1,0.0,0,0,0,0,0,0,0,4,1,0,5,1
6524,101051,0WQxgoUN7TBDtRGEW7KgYzWz2pgrrK5v,A3fsA9Zfv1X2fVEQhTw51lKENdNrEqT3,1,0,0,0,0,0,1,0,1,0.14285714285714285,1,0.0,0,0,0,0,0,0,0,1,0,0,1,1
6525,101056,OHdLWfOkVYVSxh9avWbeG6oGLyuN9vvx,SpATywNh6bZuzm8s1ceuBUnMUAeoAHHw,6,3,2,0,1,0,3,0,9,1.2857142857142858,1,0.0,0,2,0,1,3,0,0,3,0,3,6,1
6526,101075,2edy9dIAe4yrL8yAxHgqsIKKU0nldbta,SpATywNh6bZuzm8s1ceuBUnMUAeoAHHw,18,32,10,15,4,17,19,1,98,14.0,4,0.0,16,10,12,4,16,17,3,19,1,42,56,0
6527,101076,9QftuNjRCr9ybWcdk9XGcjwoamuBGtxp,RXDvfPUBYFlVdlueBFbLW0mhhAyGEqpt,13,8,3,8,2,0,4,1,26,3.7142857142857144,1,0.0,4,3,8,2,4,0,0,4,1,17,9,1
6528,101088,skwGEmBgIkpxOdkOcle3E7qOBQA7vS2R,SpATywNh6bZuzm8s1ceuBUnMUAeoAHHw,5,3,1,0,1,0,2,0,7,1.0,1,0.0,0,1,0,1,3,0,0,2,0,2,5,1
6529,101089,6mMeVC2B7hFVd1nCtPVGU6PaoCXq1G2c,SpATywNh6bZuzm8s1ceuBUnMUAeoAHHw,3,2,0,0,0,0,1,0,3,0.42857142857142855,1,0.0,0,0,0,0,2,0,0,1,0,0,3,1
6530,101100,mRaBEX7ZDfkFg6XYznVptg421BJGPS3w,SpATywNh6bZuzm8s1ceuBUnMUAeoAHHw,6,3,1,0,1,0,2,1,8,1.1428571428571428,1,0.0,0,1,0,1,3,0,0,2,1,2,6,1
6531,101101,FTGBOUC5qFiXzNQNK1iKg2fvAMPM8ThA,SpATywNh6bZuzm8s1ceuBUnMUAeoAHHw,9,8,4,0,4,0,2,0,18,2.5714285714285716,1,0.0,0,4,0,4,8,0,0,2,0,8,10,1
6532,101111,jWJRJs7mP2iWLScGpcEFZK8ziDAIaDM6,SpATywNh6bZuzm8s1ceuBUnMUAeoAHHw,12,20,1,18,0,0,5,0,44,6.285714285714286,2,0.0,12,1,15,0,8,0,3,5,0,28,16,1
6533,101115,FixP7IuJ80KsWtzMzcQsJZKOjLxDKZgC,SpATywNh6bZuzm8s1ceuBUnMUAeoAHHw,1,0,0,0,0,0,1,0,1,0.14285714285714285,1,0.0,0,0,0,0,0,0,0,1,0,0,1,1
6534,101129,dZFFkuSkEdW4wzDVTZtpVIC64kvJ857o,G8EPVSXsOYB5YQWZGiz1aVq5Pgr2GrQu,5,2,1,0,1,0,2,0,6,0.8571428571428571,1,0.0,0,1,0,1,2,0,0,2,0,2,4,1
6535,101152,7B5rcRMuJ6A1xAdnnIVDusvPjMkwnC77,bWdj2GDclj5ofokWjzoa5jAwMkxCykd6,26,51,6,96,1,3,16,1,174,24.857142857142858,4,0.0,11,6,90,1,40,3,6,16,1,108,66,1
6536,101155,PSxHADin4S7TFVr4zP5HBd1nZjW3cx4M,G8EPVSXsOYB5YQWZGiz1aVq5Pgr2GrQu,11,10,5,6,0,19,2,0,42,6.0,1,0.0,3,5,3,0,7,19,3,2,0,11,31,1
6537,101166,DFKzgJXlXxnZVHESIM4fYC543XX9ZfDV,A3fsA9Zfv1X2fVEQhTw51lKENdNrEqT3,1,0,0,0,0,0,1,0,1,0.14285714285714285,1,0.0,0,0,0,0,0,0,0,1,0,0,1,1
6538,101168,Fa6BLRRKtDwlKrwyXtqO3LGNnTfVpmlS,SpATywNh6bZuzm8s1ceuBUnMUAeoAHHw,1,0,0,0,0,0,1,0,1,0.14285714285714285,1,0.0,0,0,0,0,0,0,0,1,0,0,1,1
6539,101172,hfMGuVwBeucr422AFfEYrtJHa9rVnsoA,SpATywNh6bZuzm8s1ceuBUnMUAeoAHHw,1,0,0,0,0,0,1,0,1,0.14285714285714285,1,0.0,0,0,0,0,0,0,0,1,0,0,1,1
6540,101178,uAXW7zeSaEEtMIdMcVsYpUquscAKUnr7,bWdj2GDclj5ofokWjzoa5jAwMkxCykd6,2,0,0,0,0,0,2,0,2,0.2857142857142857,1,0.0,0,0,0,0,0,0,0,2,0,0,2,1
6541,101183,4moZsX66K72QjGT5GqDqJCMPu4Ct97bi,G8EPVSXsOYB5YQWZGiz1aVq5Pgr2GrQu,6,5,1,0,2,1,2,0,11,1.5714285714285714,1,0.0,2,1,0,2,3,1,0,2,0,5,6,1
6542,101188,gtKTzkXHwS41ljYVmjlLLf4WyQSkK02q,RXDvfPUBYFlVdlueBFbLW0mhhAyGEqpt,2,0,0,0,0,0,2,0,2,0.2857142857142857,1,0.0,0,0,0,0,0,0,0,2,0,0,2,1
6543,101208,6bpPMNX4VLAo5FNzh6WrMNoyVaRnL68O,RXDvfPUBYFlVdlueBFbLW0mhhAyGEqpt,8,9,1,0,0,0,1,0,11,1.5714285714285714,1,0.0,0,1,0,0,9,0,0,1,0,1,10,1
6544,101210,h9fj5ctPIK6vllChG3R7Ob244BG9PpLx,SpATywNh6bZuzm8s1ceuBUnMUAeoAHHw,3,0,0,0,0,0,3,1,4,0.5714285714285714,1,0.0,0,0,0,0,0,0,0,3,1,0,4,1
6545,101217,eoY58NwX7OVcm2sOG1AAgydEA1V5TiLJ,SpATywNh6bZuzm8s1ceuBUnMUAeoAHHw,1,0,0,0,0,0,1,0,1,0.14285714285714285,1,0.0,0,0,0,0,0,0,0,1,0,0,1,1
6546,101222,7SY0SzNTkW1xUX8FK1P49jbfTWqfgLfG,SpATywNh6bZuzm8s1ceuBUnMUAeoAHHw,7,16,2,0,1,0,7,0,26,3.7142857142857144,2,0.0,0,2,0,1,16,0,0,7,0,3,23,1
6547,101225,MwRVXLIjs7ObnboXYRMgXHQa3UWpN5i5,bWdj2GDclj5ofokWjzoa5jAwMkxCykd6,5,2,1,0,1,0,3,0,7,1.0,1,0.0,0,1,0,1,2,0,0,3,0,2,5,1
6548,101227,1zysq5lTXLzGIAe1yQorA74YMvQPYkm5,SpATywNh6bZuzm8s1ceuBUnMUAeoAHHw,1,0,0,0,0,0,2,0,2,0.2857142857142857,1,0.0,0,0,0,0,0,0,0,2,0,0,2,1
6549,101234,7kbuqNU54d8d11QmdSpTGAMhLhmSDka1,RXDvfPUBYFlVdlueBFbLW0mhhAyGEqpt,44,25,15,72,8,0,4,0,124,17.714285714285715,2,0.0,7,15,68,8,18,0,4,4,0,98,26,1
6550,101236,cCvHnoX6St5OTmXQ2AOInGyMnqlmS6DL,SpATywNh6bZuzm8s1ceuBUnMUAeoAHHw,14,14,6,16,4,1,2,0,43,6.142857142857143,1,0.0,4,6,14,4,10,1,2,2,0,28,15,1
6551,101246,I5LLOe5opvt5J43scHH7lI6K5JrrHIsM,SpATywNh6bZuzm8s1ceuBUnMUAeoAHHw,7,2,1,0,1,0,4,0,8,1.1428571428571428,2,0.0,0,1,0,1,2,0,0,4,0,2,6,1
6552,101250,iI85tnA7qrRiHSPoxfEPOdB8KhBODfhh,bWdj2GDclj5ofokWjzoa5jAwMkxCykd6,3,0,0,0,0,0,3,0,3,0.42857142857142855,1,0.0,0,0,0,0,0,0,0,3,0,0,3,1
6553,101260,ti7nrCLZuFBhUOASmDPlWdVcwOuGnHAJ,SpATywNh6bZuzm8s1ceuBUnMUAeoAHHw,7,7,5,0,3,0,3,0,18,2.5714285714285716,2,0.0,0,5,0,3,7,0,0,3,0,8,10,1
6554,102975,DvNxKU9g5rp8dv94zJRF8Ah76URW61cr,SpATywNh6bZuzm8s1ceuBUnMUAeoAHHw,9,4,3,0,3,0,2,0,12,1.7142857142857142,1,0.0,0,3,0,3,4,0,0,2,0,6,6,1
6555,103038,TGrjsRoxwzZ35wp3zciCPp8r5aOpBmZm,SpATywNh6bZuzm8s1ceuBUnMUAeoAHHw,1,0,0,0,0,0,2,0,2,0.2857142857142857,1,0.0,0,0,0,0,0,0,0,2,0,0,2,1
6556,103157,8IuzZOXaXVUql9pLZtNuJIyLoDJ8ZL4V,A3fsA9Zfv1X2fVEQhTw51lKENdNrEqT3,20,17,7,50,2,0,2,0,78,11.142857142857142,1,0.0,2,7,43,2,15,0,7,2,0,54,24,1
6557,103347,hNJz0qbOhrUgajUkzqSdDbybHkuRglfs,SpATywNh6bZuzm8s1ceuBUnMUAeoAHHw,30,39,25,25,10,1,12,3,115,16.428571428571427,5,0.0,6,25,23,10,33,1,2,12,3,64,51,0
6558,103445,YR1IgV2TtttHJ35h5NJxgcWKWfmLYszA,SpATywNh6bZuzm8s1ceuBUnMUAeoAHHw,14,30,16,4,7,1,11,0,69,9.857142857142858,4,0.0,3,16,4,7,27,1,0,11,0,30,39,0
6559,103457,XvNNzv39b8VqKid0q4fV9ms2wVNAdWks,bWdj2GDclj5ofokWjzoa5jAwMkxCykd6,19,54,20,84,8,0,25,0,191,27.285714285714285,4,0.0,14,20,81,8,40,0,3,25,0,123,68,0
6560,103661,Z5Gd8RjsJSljoHUoBd3hvIVNy4VKuGq0,SpATywNh6bZuzm8s1ceuBUnMUAeoAHHw,24,50,21,18,12,40,6,0,147,21.0,3,0.0,10,21,16,12,40,40,2,6,0,59,88,0
6561,103668,p9NcQP74LARrulF6JzGeab5yk6ciJM9V,SpATywNh6bZuzm8s1ceuBUnMUAeoAHHw,12,25,1,10,1,1,2,0,40,5.714285714285714,1,0.0,6,1,10,1,19,1,0,2,0,18,22,0
6562,103849,9poFqdhDn1jEwJp6tGIQlD3gMA14zAqO,SpATywNh6bZuzm8s1ceuBUnMUAeoAHHw,8,6,0,0,0,2,7,1,16,2.2857142857142856,2,0.0,0,0,0,0,6,2,0,7,1,0,16,1
6563,103930,Txv4UTCXPzwxfIDD6g3LwRLt3kYLBXuk,SpATywNh6bZuzm8s1ceuBUnMUAeoAHHw,23,47,10,26,2,48,14,0,147,21.0,8,0.0,13,10,22,2,34,48,4,14,0,47,100,0
6564,104119,1aQoKDna73jstuOrupWa9Kq8V3FdvbRU,SpATywNh6bZuzm8s1ceuBUnMUAeoAHHw,6,3,2,0,2,0,1,0,8,1.1428571428571428,1,0.0,0,2,0,2,3,0,0,1,0,4,4,1
6565,104284,eTpWGRVGcm2Ik3M0L1jEIkegdNZVCw6R,SpATywNh6bZuzm8s1ceuBUnMUAeoAHHw,14,47,1,21,1,47,6,1,124,17.714285714285715,2,0.0,34,1,18,1,13,47,3,6,1,54,70,0
6566,104292,BhFlcQJWIjFJlF5Tqxm0xkVlpnp9sVr5,A3fsA9Zfv1X2fVEQhTw51lKENdNrEqT3,10,6,4,0,3,0,2,0,15,2.142857142857143,1,0.0,0,4,0,3,6,0,0,2,0,7,8,1
6567,104294,HTFrI1D4p0HbfBDMwhsdYfCOWsNzjXaR,SpATywNh6bZuzm8s1ceuBUnMUAeoAHHw,7,3,2,0,2,0,2,0,9,1.2857142857142858,1,0.0,0,2,0,2,3,0,0,2,0,4,5,1
6568,104296,qIvK9ObB3zgAcjyEoNQW2L93AtBba9D4,G8EPVSXsOYB5YQWZGiz1aVq5Pgr2GrQu,7,5,0,0,0,0,4,0,9,1.2857142857142858,1,0.0,0,0,0,0,5,0,0,4,0,0,9,0
6569,104301,Vy093XdUJPwNTmCPocZUTd1XYGzzyp34,G8EPVSXsOYB5YQWZGiz1aVq5Pgr2GrQu,2,0,0,0,0,0,2,0,2,0.2857142857142857,1,0.0,0,0,0,0,0,0,0,2,0,0,2,1
6570,104335,PcrKUgtxZcGXBYkLOmECh99m3fhAOabf,G8EPVSXsOYB5YQWZGiz1aVq5Pgr2GrQu,3,2,0,0,0,0,1,0,3,0.42857142857142855,1,0.0,0,0,0,0,2,0,0,1,0,0,3,1
6571,104337,dMZ9S55l3tq5M3A71U0KoWxXWAhXsFH4,SpATywNh6bZuzm8s1ceuBUnMUAeoAHHw,7,10,4,0,2,0,2,0,18,2.5714285714285716,1,0.0,0,4,0,2,10,0,0,2,0,6,12,1
6572,104341,2rPgSvtsbYrCOUBollArAnVMcQox4Rzz,SpATywNh6bZuzm8s1ceuBUnMUAeoAHHw,10,5,4,0,3,0,6,0,18,2.5714285714285716,1,0.0,0,4,0,3,5,0,0,6,0,7,11,1
6573,104352,Jc6Rj6cwfhWlrTpjaB2LnqARTW8Bbf0L,SpATywNh6bZuzm8s1ceuBUnMUAeoAHHw,5,3,1,0,1,0,2,0,7,1.0,1,0.0,0,1,0,1,3,0,0,2,0,2,5,1
6574,104356,Nvx1FqKYM0wMKIIRgD0fWbHs2ulluJLe,bWdj2GDclj5ofokWjzoa5jAwMkxCykd6,1,0,0,0,0,0,1,0,1,0.14285714285714285,1,0.0,0,0,0,0,0,0,0,1,0,0,1,1
6575,104358,Nvx1FqKYM0wMKIIRgD0fWbHs2ulluJLe,A3fsA9Zfv1X2fVEQhTw51lKENdNrEqT3,4,2,0,0,0,0,2,0,4,0.5714285714285714,1,0.0,0,0,0,0,2,0,0,2,0,0,4,1
6576,104361,xnObPmivHmj7phvTSVLNuvvFk898J2aO,RXDvfPUBYFlVdlueBFbLW0mhhAyGEqpt,1,0,0,0,0,0,1,0,1,0.14285714285714285,1,0.0,0,0,0,0,0,0,0,1,0,0,1,1
6577,104366,uLsUz9dpaUlUOxHeWF3yHSSVzvVLEW6w,SpATywNh6bZuzm8s1ceuBUnMUAeoAHHw,1,0,0,0,0,0,1,0,1,0.14285714285714285,1,0.0,0,0,0,0,0,0,0,1,0,0,1,1
6578,104391,jTauqnokjVi6ospRFXXduew42x2G5Up9,G8EPVSXsOYB5YQWZGiz1aVq5Pgr2GrQu,7,3,2,0,2,0,2,0,9,1.2857142857142858,1,0.0,0,2,0,2,3,0,0,2,0,4,5,1
6579,104410,ObbXaQT6J9VxlQqNb4O6euoNIJzHR7rT,SpATywNh6bZuzm8s1ceuBUnMUAeoAHHw,9,4,3,0,3,0,2,0,12,1.7142857142857142,1,0.0,0,3,0,3,4,0,0,2,0,6,6,1
6580,104411,pcsiSS3QOPo0n8yKp6skJyBWeonG4c8P,A3fsA9Zfv1X2fVEQhTw51lKENdNrEqT3,7,4,3,0,3,0,2,0,12,1.7142857142857142,1,0.0,0,3,0,3,4,0,0,2,0,6,6,1
6581,104432,nbu72Hfybp6pv1ykyATXAv2RfzFEFoR8,SpATywNh6bZuzm8s1ceuBUnMUAeoAHHw,12,12,0,20,0,4,5,0,41,5.857142857142857,1,0.0,5,0,17,0,7,4,3,5,0,22,19,1
6582,104441,xMs8rC8PWX4mnQhPoCok61SbExcNBkVe,SpATywNh6bZuzm8s1ceuBUnMUAeoAHHw,6,3,1,0,1,0,2,0,7,1.0,1,0.0,0,1,0,1,3,0,0,2,0,2,5,1
6583,104452,ziSW6xDH8gzyWXn2P08NFoRMJoG4EqEB,SpATywNh6bZuzm8s1ceuBUnMUAeoAHHw,12,25,12,0,7,0,2,0,46,6.571428571428571,1,0.0,4,12,0,7,21,0,0,2,0,23,23,1
6584,104453,8uGMX8Xu6j8RLuhsBjmFgfMaI4mZnvz1,SpATywNh6bZuzm8s1ceuBUnMUAeoAHHw,12,10,4,0,3,0,4,0,21,3.0,1,0.0,0,4,0,3,10,0,0,4,0,7,14,1
6585,104458,I3Y9SshT4Px6bPwzvv7ixI5CQirBePZQ,SpATywNh6bZuzm8s1ceuBUnMUAeoAHHw,6,12,6,0,0,0,4,0,22,3.142857142857143,3,0.0,0,6,0,0,12,0,0,4,0,6,16,1
6586,104463,DyQHVTNiwX6W4PiKOVh8BCoKQr8u7ImW,A3fsA9Zfv1X2fVEQhTw51lKENdNrEqT3,12,12,1,0,0,3,10,0,26,3.7142857142857144,1,0.0,1,1,0,0,11,3,0,10,0,2,24,1
6587,104464,4OFy9ZLb1svxpVgXkgI60wOGeiU4V4oA,G8EPVSXsOYB5YQWZGiz1aVq5Pgr2GrQu,1,0,0,0,0,0,1,0,1,0.14285714285714285,1,0.0,0,0,0,0,0,0,0,1,0,0,1,1
6588,104466,KXi2lu4GlKmrO1lJTLg3t4l701rvNXNZ,bWdj2GDclj5ofokWjzoa5jAwMkxCykd6,1,0,0,0,0,0,1,0,1,0.14285714285714285,1,0.0,0,0,0,0,0,0,0,1,0,0,1,1
6589,104468,qUJjM2rHGQKXLfW6M7Cfr4tvklEU6daf,SpATywNh6bZuzm8s1ceuBUnMUAeoAHHw,13,12,6,3,2,6,11,3,43,6.142857142857143,2,0.0,1,6,3,2,11,6,0,11,3,12,31,1
6590,104489,wT2PCRFj23I7HDSSujNYjrYVx91GnsP3,A3fsA9Zfv1X2fVEQhTw51lKENdNrEqT3,5,2,1,0,1,0,4,0,8,1.1428571428571428,3,0.0,0,1,0,1,2,0,0,4,0,2,6,0
6591,104492,tPRxZgUxDUTQm2PmIuX0fewSz7eitT8g,SpATywNh6bZuzm8s1ceuBUnMUAeoAHHw,1,0,0,0,0,0,1,0,1,0.14285714285714285,1,0.0,0,0,0,0,0,0,0,1,0,0,1,1
6592,104495,LYehQDSOM5PcdlXuo0xGoCftzdlyd2gI,A3fsA9Zfv1X2fVEQhTw51lKENdNrEqT3,4,0,0,0,0,0,4,0,4,0.5714285714285714,1,0.0,0,0,0,0,0,0,0,4,0,0,4,1
6593,104496,tWy6K2sNXVB2esbGJMyXdZRQGH2Klw9e,SpATywNh6bZuzm8s1ceuBUnMUAeoAHHw,1,0,0,0,0,0,1,0,1,0.14285714285714285,1,0.0,0,0,0,0,0,0,0,1,0,0,1,1
6594,104503,2jTGBIAeHp8pnl61IF8YWrKorMuy9KJe,SpATywNh6bZuzm8s1ceuBUnMUAeoAHHw,2,0,0,0,0,0,2,0,2,0.2857142857142857,1,0.0,0,0,0,0,0,0,0,2,0,0,2,1
6595,104509,oE1QbspE1VaPia0G9CbmnflG7dN6cZJM,SpATywNh6bZuzm8s1ceuBUnMUAeoAHHw,2,0,0,0,0,0,2,0,2,0.2857142857142857,1,0.0,0,0,0,0,0,0,0,2,0,0,2,1
6596,104515,KQvub9kHQ3XpwpO5JgmmZp67zs4af3TX,A3fsA9Zfv1X2fVEQhTw51lKENdNrEqT3,5,2,1,0,1,0,2,0,6,0.8571428571428571,1,0.0,0,1,0,1,2,0,0,2,0,2,4,1
6597,104521,i5EjwCywnHAh7QM2CMkeJsIdXa8rMV6i,bWdj2GDclj5ofokWjzoa5jAwMkxCykd6,2,0,0,0,0,0,2,0,2,0.2857142857142857,1,0.0,0,0,0,0,0,0,0,2,0,0,2,1
6598,104526,ydd1OhJLlZRjAmcrBX6w4fAjd763MlEr,SpATywNh6bZuzm8s1ceuBUnMUAeoAHHw,2,0,0,0,0,0,2,0,2,0.2857142857142857,1,0.0,0,0,0,0,0,0,0,2,0,0,2,1
6599,104531,VqPSgF7LIkhd0l6BSJd84AdcMj5MaqIS,SpATywNh6bZuzm8s1ceuBUnMUAeoAHHw,1,0,0,0,0,0,1,0,1,0.14285714285714285,1,0.0,0,0,0,0,0,0,0,1,0,0,1,1
6600,104540,WELjmgdsP962Pc1teJ96xvofKraKe6qa,bWdj2GDclj5ofokWjzoa5jAwMkxCykd6,8,5,3,0,1,13,11,0,33,4.714285714285714,5,0.0,0,3,0,1,5,13,0,11,0,4,29,0
6601,104546,h2uPViUap57On5JUqQ9igq5GDP75Rgzf,SpATywNh6bZuzm8s1ceuBUnMUAeoAHHw,14,13,6,9,2,1,3,0,34,4.857142857142857,1,0.0,3,6,9,2,10,1,0,3,0,20,14,1
6602,104548,V0AsQgHGQGwNZqmKaETWBrxe3WpC4m5k,SpATywNh6bZuzm8s1ceuBUnMUAeoAHHw,8,6,3,0,2,0,6,0,17,2.4285714285714284,1,0.0,0,3,0,2,6,0,0,6,0,5,12,1
6603,104555,PSygGEnajNdSwAgw8ZB2LUfijgMjfKqV,bWdj2GDclj5ofokWjzoa5jAwMkxCykd6,1,0,0,0,0,0,1,0,1,0.14285714285714285,1,0.0,0,0,0,0,0,0,0,1,0,0,1,1
6604,104582,xM1yUWSpt3htcKGdTrpZVO5ZeftoW9re,G8EPVSXsOYB5YQWZGiz1aVq5Pgr2GrQu,10,6,2,8,1,0,5,0,22,3.142857142857143,1,0.0,3,2,6,1,3,0,2,5,0,12,10,1
6605,104589,LOsVkswWxHe5YwcAM1YjHggicuRbJ5sf,SpATywNh6bZuzm8s1ceuBUnMUAeoAHHw,1,0,0,0,0,0,1,0,1,0.14285714285714285,1,0.0,0,0,0,0,0,0,0,1,0,0,1,1
6606,104590,hlub8IQ6xr3M5qQPn6YnEFWROpuhMcwL,A3fsA9Zfv1X2fVEQhTw51lKENdNrEqT3,9,2,1,0,1,2,10,1,17,2.4285714285714284,3,0.0,0,1,0,1,2,2,0,10,1,2,15,1
6607,104591,nZpaESUo0GJPIuUQLM7WpTAyDvRCYws3,SpATywNh6bZuzm8s1ceuBUnMUAeoAHHw,11,6,2,8,1,0,6,0,23,3.2857142857142856,1,0.0,2,2,6,1,4,0,2,6,0,11,12,1
6608,104593,Q37fGjJ8eugSdDYZTpXfPJGR1Hy2EJgr,A3fsA9Zfv1X2fVEQhTw51lKENdNrEqT3,8,2,1,0,1,1,6,1,12,1.7142857142857142,1,0.0,0,1,0,1,2,1,0,6,1,2,10,1
6609,104606,n0z9CmHQ1aT2Na1Alnc3POrgJ8DExUjg,G8EPVSXsOYB5YQWZGiz1aVq5Pgr2GrQu,8,12,3,0,3,1,4,0,23,3.2857142857142856,1,0.0,5,3,0,3,7,1,0,4,0,11,12,1
6610,104608,n0z9CmHQ1aT2Na1Alnc3POrgJ8DExUjg,A3fsA9Zfv1X2fVEQhTw51lKENdNrEqT3,1,0,0,0,0,0,1,0,1,0.14285714285714285,1,0.0,0,0,0,0,0,0,0,1,0,0,1,1
6611,104610,3C1lYSFixKkKNR8DGEXYYhDOAMAek2Zr,G8EPVSXsOYB5YQWZGiz1aVq5Pgr2GrQu,12,10,4,6,4,0,2,0,26,3.7142857142857144,1,0.0,5,4,3,4,5,0,3,2,0,16,10,1
6612,104613,Ek3NRIw6r3qK8qXdjTcUWOMSezARAlja,bWdj2GDclj5ofokWjzoa5jAwMkxCykd6,9,24,9,0,6,3,14,2,58,8.285714285714286,3,0.0,5,9,0,6,19,3,0,14,2,20,38,1
6613,104615,yfPEDU3OzZWMdKaypuOZrACuYp6GNcyd,A3fsA9Zfv1X2fVEQhTw51lKENdNrEqT3,1,0,0,0,0,0,2,0,2,0.2857142857142857,1,0.0,0,0,0,0,0,0,0,2,0,0,2,1
6614,104630,CtmqfatIKebJswM6ar9T0zVFJv52NCRl,G8EPVSXsOYB5YQWZGiz1aVq5Pgr2GrQu,7,11,0,0,0,0,5,0,16,2.2857142857142856,1,0.0,6,0,0,0,5,0,0,5,0,6,10,1
6615,104632,z2UutrDxctGBl3XhV09hNxXdsZmqDZvY,RXDvfPUBYFlVdlueBFbLW0mhhAyGEqpt,1,0,0,0,0,0,1,0,1,0.14285714285714285,1,0.0,0,0,0,0,0,0,0,1,0,0,1,1
6616,104633,CtmqfatIKebJswM6ar9T0zVFJv52NCRl,SpATywNh6bZuzm8s1ceuBUnMUAeoAHHw,7,5,0,0,0,0,3,0,8,1.1428571428571428,1,0.0,0,0,0,0,5,0,0,3,0,0,8,1
6617,104636,JgNllefl6lxMJFs121u0iwNrhgAg4Z2l,A3fsA9Zfv1X2fVEQhTw51lKENdNrEqT3,4,2,1,0,1,0,1,0,5,0.7142857142857143,1,0.0,0,1,0,1,2,0,0,1,0,2,3,1
6618,104642,OyCwM8soHH8QE4hfLYRsx6iyHPIOqWTw,SpATywNh6bZuzm8s1ceuBUnMUAeoAHHw,13,12,0,11,0,0,9,1,33,4.714285714285714,2,0.0,7,0,9,0,5,0,2,9,1,16,17,1
6619,104688,1vi3aoGF64IJNwusboKMOjObFPU3HDht,SpATywNh6bZuzm8s1ceuBUnMUAeoAHHw,14,15,6,15,4,0,2,0,42,6.0,1,0.0,8,6,12,4,7,0,3,2,0,30,12,0
6620,104693,vGcc0AnjpQHzU6MhASLVTSg5K7Oxs693,bWdj2GDclj5ofokWjzoa5jAwMkxCykd6,1,0,0,0,0,0,1,0,1,0.14285714285714285,1,0.0,0,0,0,0,0,0,0,1,0,0,1,0
6621,104697,HlYiU2TA92it9HWOPDlsBmlpdZ7J7QTJ,A3fsA9Zfv1X2fVEQhTw51lKENdNrEqT3,30,59,30,52,19,11,19,1,191,27.285714285714285,4,0.0,2,30,43,19,57,11,9,19,1,94,97,1
6622,104724,AO2DWs3lh9A1GvC8BAMupQKT1Hlk19lZ,A3fsA9Zfv1X2fVEQhTw51lKENdNrEqT3,5,7,0,0,0,0,6,0,13,1.8571428571428572,1,0.0,0,0,0,0,7,0,0,6,0,0,13,1
6623,104727,T8KPSkXPudd9vKVat9asv5ysr6zWaQCY,SpATywNh6bZuzm8s1ceuBUnMUAeoAHHw,15,25,2,19,0,1,9,2,58,8.285714285714286,1,0.0,9,2,16,0,16,1,3,9,2,27,31,1
6624,104735,XEAzAzWsIHOpS801lITcIzqWP1a4yYMV,SpATywNh6bZuzm8s1ceuBUnMUAeoAHHw,15,12,7,13,4,2,3,1,42,6.0,1,0.0,4,7,12,4,8,2,1,3,1,27,15,1
6625,104737,o6c539lwIkVrO8m1FxoLjW3D1hV2LZeV,SpATywNh6bZuzm8s1ceuBUnMUAeoAHHw,10,7,0,8,0,6,3,0,24,3.4285714285714284,2,0.0,2,0,7,0,5,6,1,3,0,9,15,1
6626,104746,Lzsz8G97Oqbb3ZBCI5dR9gHrqQ1EH7Ym,bWdj2GDclj5ofokWjzoa5jAwMkxCykd6,5,3,1,0,0,0,3,0,7,1.0,2,0.0,0,1,0,0,3,0,0,3,0,1,6,1
6627,104755,cwVdqEP9opAeKfgoOEHlcQUqgyjLtu9l,G8EPVSXsOYB5YQWZGiz1aVq5Pgr2GrQu,5,2,1,0,1,0,2,0,6,0.8571428571428571,1,0.0,0,1,0,1,2,0,0,2,0,2,4,1
6628,104757,couyquW2Z4n38XcaXOGqoUN34GlfxMVE,A3fsA9Zfv1X2fVEQhTw51lKENdNrEqT3,6,4,1,0,1,0,2,0,8,1.1428571428571428,1,0.0,0,1,0,1,4,0,0,2,0,2,6,0
6629,104762,Lo2vU6mH3fqBjPz8YtN99A9tnKdHVK6o,SpATywNh6bZuzm8s1ceuBUnMUAeoAHHw,8,11,7,0,4,0,8,0,30,4.285714285714286,2,0.0,0,7,0,4,11,0,0,8,0,11,19,1
6630,104767,futyrc5ZKHBBJxaxN8pRQj4FOD0yyEl8,RXDvfPUBYFlVdlueBFbLW0mhhAyGEqpt,7,9,5,0,1,0,2,0,17,2.4285714285714284,1,0.0,0,5,0,1,9,0,0,2,0,6,11,1
6631,104770,1O5EjoRsscLnc9nXfpqkKtbnynlBSzrx,SpATywNh6bZuzm8s1ceuBUnMUAeoAHHw,6,3,2,0,0,0,3,0,8,1.1428571428571428,1,0.0,0,2,0,0,3,0,0,3,0,2,6,1
6632,104774,tBbhVMYYQ6OTtHw8ihRfnNPpAK2u2FCV,SpATywNh6bZuzm8s1ceuBUnMUAeoAHHw,10,16,7,0,4,0,1,0,28,4.0,1,0.0,0,7,0,4,16,0,0,1,0,11,17,1
6633,104777,7AcpuVe6H4EQE4t982IHxKSRBEP280dQ,SpATywNh6bZuzm8s1ceuBUnMUAeoAHHw,11,13,1,16,0,6,5,1,42,6.0,1,0.0,6,1,15,0,7,6,1,5,1,22,20,1
6634,104784,A7BPMFQzaFIvFoWRCDmdq1av9dzZSKUQ,SpATywNh6bZuzm8s1ceuBUnMUAeoAHHw,1,0,0,0,0,0,1,0,1,0.14285714285714285,1,0.0,0,0,0,0,0,0,0,1,0,0,1,1
6635,104792,uMEUDlZ1tL8WoZ2EmL0CStSYwA0zOal8,SpATywNh6bZuzm8s1ceuBUnMUAeoAHHw,6,3,2,0,2,0,1,0,8,1.1428571428571428,1,0.0,0,2,0,2,3,0,0,1,0,4,4,1
6636,104793,qDtFi7e90cUeHzM7V0dyqooeuFxEYpNm,SpATywNh6bZuzm8s1ceuBUnMUAeoAHHw,7,3,2,0,2,0,2,0,9,1.2857142857142858,1,0.0,0,2,0,2,3,0,0,2,0,4,5,1
6637,104795,cjnjr7Duofdr7KxOEuxuSM38OHUgNo60,G8EPVSXsOYB5YQWZGiz1aVq5Pgr2GrQu,18,27,6,0,6,0,15,1,55,7.857142857142857,2,0.0,0,6,0,6,27,0,0,15,1,12,43,0
6638,104800,mz4uLo9BLm8C45jnilK7oxFwMZeC54GR,A3fsA9Zfv1X2fVEQhTw51lKENdNrEqT3,8,6,1,0,0,3,5,0,15,2.142857142857143,1,0.0,0,1,0,0,6,3,0,5,0,1,14,1
6639,104801,dDRiefJH6VL2xh5SH3Jn4nOIwtp9UE53,SpATywNh6bZuzm8s1ceuBUnMUAeoAHHw,4,0,0,0,0,0,5,0,5,0.7142857142857143,1,0.0,0,0,0,0,0,0,0,5,0,0,5,1
6640,104811,xhZvMzC7C3FI6QGx1nJhPvhS30jV3HlC,SpATywNh6bZuzm8s1ceuBUnMUAeoAHHw,1,0,0,0,0,0,1,0,1,0.14285714285714285,1,0.0,0,0,0,0,0,0,0,1,0,0,1,1
6641,104815,I3l3i5FdvqNSQ2HVtWbrElKwC57iq42m,SpATywNh6bZuzm8s1ceuBUnMUAeoAHHw,6,4,1,0,1,0,2,0,8,1.1428571428571428,1,0.0,1,1,0,1,3,0,0,2,0,3,5,1
6642,104817,kCDwRCPqHBdxL6Zm4oP4P8LFVB7ooBk2,A3fsA9Zfv1X2fVEQhTw51lKENdNrEqT3,1,0,0,0,0,0,1,0,1,0.14285714285714285,1,0.0,0,0,0,0,0,0,0,1,0,0,1,1
6643,104821,HZ09CsQBbpW2jBqTRwR09w2caEvBXEBF,SpATywNh6bZuzm8s1ceuBUnMUAeoAHHw,11,9,0,18,0,0,2,0,29,4.142857142857143,1,0.0,2,0,15,0,7,0,3,2,0,17,12,0
6644,104824,zoXigsWBjyJG6OSyWQP4Y5frh0Mc9ncS,A3fsA9Zfv1X2fVEQhTw51lKENdNrEqT3,5,3,1,0,1,0,3,0,8,1.1428571428571428,1,0.0,1,1,0,1,2,0,0,3,0,3,5,1
6645,104825,fPBHPutjsyATgfjDez6QiXqE3EQ549Sn,bWdj2GDclj5ofokWjzoa5jAwMkxCykd6,10,9,2,56,3,3,5,1,79,11.285714285714286,1,0.0,5,2,53,3,4,3,3,5,1,63,16,1
6646,104828,TvgIXPYmwQ8PEavqO4tLfxpm2FF8nOoT,RXDvfPUBYFlVdlueBFbLW0mhhAyGEqpt,5,2,1,0,1,0,3,0,7,1.0,1,0.0,0,1,0,1,2,0,0,3,0,2,5,1
6647,104835,Ri95AXIo8zsMGIr8iLd7Nlf3hXPlEtcm,SpATywNh6bZuzm8s1ceuBUnMUAeoAHHw,5,3,1,0,0,0,2,0,6,0.8571428571428571,1,0.0,0,1,0,0,3,0,0,2,0,1,5,1
6648,104851,zjreW3h1Ea5BeCNB7vdMhwpbveHkJfhN,SpATywNh6bZuzm8s1ceuBUnMUAeoAHHw,7,2,1,0,1,1,4,1,10,1.4285714285714286,1,0.0,0,1,0,1,2,1,0,4,1,2,8,1
6649,104852,YjmLtoh2FsHRMNwgNAtlpUzEWjN5nhAS,SpATywNh6bZuzm8s1ceuBUnMUAeoAHHw,7,3,2,0,2,0,2,0,9,1.2857142857142858,1,0.0,0,2,0,2,3,0,0,2,0,4,5,1
6650,104857,EfAzIK92h28Gz4WXYVhp9fzk6YRB1DXC,A3fsA9Zfv1X2fVEQhTw51lKENdNrEqT3,1,0,0,0,0,0,1,0,1,0.14285714285714285,1,0.0,0,0,0,0,0,0,0,1,0,0,1,0
6651,104865,w1QHQFv3RratMvfK2BnfmiIqIYey1EzI,bWdj2GDclj5ofokWjzoa5jAwMkxCykd6,12,10,1,72,4,0,1,0,88,12.571428571428571,1,0.0,6,1,70,4,4,0,2,1,0,81,7,1
6652,104867,vO07VFd2DYWPdrvNiSqsqXFTXPKE00c4,RXDvfPUBYFlVdlueBFbLW0mhhAyGEqpt,1,0,0,0,0,0,1,0,1,0.14285714285714285,1,0.0,0,0,0,0,0,0,0,1,0,0,1,1
6653,104879,KLWMzt2lbmi8onKYKX9eWLl5lpM0wx0M,A3fsA9Zfv1X2fVEQhTw51lKENdNrEqT3,1,0,0,0,0,0,1,0,1,0.14285714285714285,1,0.0,0,0,0,0,0,0,0,1,0,0,1,1
6654,104881,RGtc1IdNIb5F1GGBZyglC3Cmje3Zbvbo,SpATywNh6bZuzm8s1ceuBUnMUAeoAHHw,1,0,0,0,0,0,1,0,1,0.14285714285714285,1,0.0,0,0,0,0,0,0,0,1,0,0,1,1
6655,104892,knqmj88BDpPhBept6EC2R3YJ3D5KQUZz,SpATywNh6bZuzm8s1ceuBUnMUAeoAHHw,6,4,1,0,1,0,2,0,8,1.1428571428571428,1,0.0,0,1,0,1,4,0,0,2,0,2,6,1
6656,104895,pOlc1xunOD2pPlaz6EGQWZcGB6A8fwQn,SpATywNh6bZuzm8s1ceuBUnMUAeoAHHw,6,5,0,0,0,0,2,0,7,1.0,1,0.0,0,0,0,0,5,0,0,2,0,0,7,1
6657,104916,Pe6a7Y0LdkKZQUrgr38AH2nCOR1VUYXS,SpATywNh6bZuzm8s1ceuBUnMUAeoAHHw,20,26,13,16,9,0,3,0,67,9.571428571428571,2,0.0,7,13,15,9,19,0,1,3,0,44,23,0
6658,104920,CGn56kdY0PhcUPAztOY3cUKmF6tF5atc,RXDvfPUBYFlVdlueBFbLW0mhhAyGEqpt,5,2,1,0,1,0,2,0,6,0.8571428571428571,1,0.0,0,1,0,1,2,0,0,2,0,2,4,1
6659,104924,e1PghwtNUGs6vA3J705NBEUcrBHwivKH,G8EPVSXsOYB5YQWZGiz1aVq5Pgr2GrQu,19,19,1,32,0,1,13,1,67,9.571428571428571,2,0.0,2,1,28,0,17,1,4,13,1,31,36,0
6660,104925,EmcvJhyzyIpQugXCF4WUuZQjl0kHTxx5,SpATywNh6bZuzm8s1ceuBUnMUAeoAHHw,5,2,1,0,1,0,2,0,6,0.8571428571428571,1,0.0,0,1,0,1,2,0,0,2,0,2,4,1
6661,104926,ONFhYKrJFqmwx9zBxMrT7qWQQw1Hgoxe,SpATywNh6bZuzm8s1ceuBUnMUAeoAHHw,8,7,3,0,2,0,2,0,14,2.0,1,0.0,3,3,0,2,4,0,0,2,0,8,6,1
6662,104928,hp7Gqo5252E9slRfXH0KFbulYobVoVWo,SpATywNh6bZuzm8s1ceuBUnMUAeoAHHw,7,5,3,0,1,0,4,0,13,1.8571428571428572,1,0.0,1,3,0,1,4,0,0,4,0,5,8,1
6663,104936,9xV1wwHzLoXwKNrE0sl58GGQQc4oj1NS,bWdj2GDclj5ofokWjzoa5jAwMkxCykd6,4,2,1,0,0,0,6,0,9,1.2857142857142858,3,0.0,0,1,0,0,2,0,0,6,0,1,8,1
6664,104943,8yrIKDtnkYcLfERwrXrvcRGxHxbt2Jd3,RXDvfPUBYFlVdlueBFbLW0mhhAyGEqpt,5,4,0,0,0,1,3,0,8,1.1428571428571428,1,0.0,0,0,0,0,4,1,0,3,0,0,8,1
6665,104947,MRBkmzjOlIfmLj12ExsDOcm0igHkBWY5,SpATywNh6bZuzm8s1ceuBUnMUAeoAHHw,4,2,0,0,0,0,2,0,4,0.5714285714285714,1,0.0,0,0,0,0,2,0,0,2,0,0,4,1
6666,104948,GEo21EE9t59WNpPzwlumpgmynliuHSiq,SpATywNh6bZuzm8s1ceuBUnMUAeoAHHw,3,0,0,0,0,0,3,0,3,0.42857142857142855,1,0.0,0,0,0,0,0,0,0,3,0,0,3,1
6667,104968,7cuOR7XN3OKWyCY4rmOlBcFyB6vgzoQs,A3fsA9Zfv1X2fVEQhTw51lKENdNrEqT3,3,0,0,0,0,0,4,0,4,0.5714285714285714,1,0.0,0,0,0,0,0,0,0,4,0,0,4,1
6668,104978,4p8c3FKQ0TxdvnCwTtbL9bKeePWMVkGP,SpATywNh6bZuzm8s1ceuBUnMUAeoAHHw,1,0,0,0,0,0,3,0,3,0.42857142857142855,1,0.0,0,0,0,0,0,0,0,3,0,0,3,1
6669,104984,0BvOWU3Vj9nIRblTj7EEskLoO3PxCxAy,bWdj2GDclj5ofokWjzoa5jAwMkxCykd6,5,2,1,0,1,0,5,0,9,1.2857142857142858,1,0.0,0,1,0,1,2,0,0,5,0,2,7,1
6670,104997,ve3dSb9Szfp4MnOfHAgrGxXGtdEF42Tp,A3fsA9Zfv1X2fVEQhTw51lKENdNrEqT3,10,4,3,0,3,0,3,0,13,1.8571428571428572,1,0.0,0,3,0,3,4,0,0,3,0,6,7,1
6671,105008,yV65Fr78Zm5MeDBgymBFgzc66d5t5Zmy,SpATywNh6bZuzm8s1ceuBUnMUAeoAHHw,12,24,14,0,0,2,13,2,55,7.857142857142857,1,0.0,7,14,0,0,17,2,0,13,2,21,34,0
6672,105014,qUdYzd5flRA3GCXiGt7tidXnS0F0FsHM,SpATywNh6bZuzm8s1ceuBUnMUAeoAHHw,5,3,0,0,0,0,4,2,9,1.2857142857142858,1,0.0,0,0,0,0,3,0,0,4,2,0,9,1
6673,105023,JKdKVDiZ9BQn8tsX4CdH77AcEG85EmQH,SpATywNh6bZuzm8s1ceuBUnMUAeoAHHw,5,3,1,0,0,0,3,0,7,1.0,1,0.0,0,1,0,0,3,0,0,3,0,1,6,1
6674,105024,7NRmTpdp1LUibho8qoHBLQ3GcaVtwUud,SpATywNh6bZuzm8s1ceuBUnMUAeoAHHw,1,0,0,0,0,0,1,0,1,0.14285714285714285,1,0.0,0,0,0,0,0,0,0,1,0,0,1,1
6675,105029,AdZFV9sO1gJgqtrxJrKT3ZcjH3XA6zTA,RXDvfPUBYFlVdlueBFbLW0mhhAyGEqpt,1,0,0,0,0,0,1,0,1,0.14285714285714285,1,0.0,0,0,0,0,0,0,0,1,0,0,1,1
6676,105030,QtcaqP1Oq08hvIX3wqGcQDC13eo6FjVm,SpATywNh6bZuzm8s1ceuBUnMUAeoAHHw,11,11,7,0,5,1,5,1,30,4.285714285714286,1,0.0,0,7,0,5,11,1,0,5,1,12,18,1
6677,105036,ynZ1Df4G2ARwLF4O85BSlMjjeKhXCtXL,SpATywNh6bZuzm8s1ceuBUnMUAeoAHHw,4,4,0,0,0,0,3,0,7,1.0,1,0.0,0,0,0,0,4,0,0,3,0,0,7,1
6678,105049,5GS5OD1cmKWecEPymf3UVauvWYXb9WHE,A3fsA9Zfv1X2fVEQhTw51lKENdNrEqT3,1,0,0,0,0,0,1,0,1,0.14285714285714285,1,0.0,0,0,0,0,0,0,0,1,0,0,1,1
6679,105053,pNgLScEwGgq81vg0a0cEXKNs5eG2UXph,bWdj2GDclj5ofokWjzoa5jAwMkxCykd6,1,0,0,0,0,0,1,0,1,0.14285714285714285,1,0.0,0,0,0,0,0,0,0,1,0,0,1,1
6680,105055,J7rstoE2U9Xgk66AuMKUxWUISAvdCQAz,G8EPVSXsOYB5YQWZGiz1aVq5Pgr2GrQu,12,11,1,6,2,1,5,1,27,3.857142857142857,1,0.0,5,1,3,2,6,1,3,5,1,11,16,1
6681,105057,QhYcOEapN0nrffEwA6S7jQzZwToRePP8,A3fsA9Zfv1X2fVEQhTw51lKENdNrEqT3,1,0,0,0,0,0,1,0,1,0.14285714285714285,1,0.0,0,0,0,0,0,0,0,1,0,0,1,1
6682,105059,KbGfmKt9ZBLOdWhdHwa3KVnLDM8esaSY,bWdj2GDclj5ofokWjzoa5jAwMkxCykd6,6,6,4,0,0,0,3,0,13,1.8571428571428572,1,0.0,0,4,0,0,6,0,0,3,0,4,9,1
6683,105061,jbwkj7UcLcGeNeVIuodsT34xBiopSnSK,A3fsA9Zfv1X2fVEQhTw51lKENdNrEqT3,2,0,0,0,0,0,3,0,3,0.42857142857142855,1,0.0,0,0,0,0,0,0,0,3,0,0,3,0
6684,105065,qhE0nq1HVP5Z55HX3UNFMVHvllKc96Rl,SpATywNh6bZuzm8s1ceuBUnMUAeoAHHw,5,3,1,0,1,0,3,0,8,1.1428571428571428,2,0.0,0,1,0,1,3,0,0,3,0,2,6,1
6685,105070,C6BeEBrAxqOuF3t7YwEepluTHqEHWFpN,G8EPVSXsOYB5YQWZGiz1aVq5Pgr2GrQu,5,4,1,0,1,0,1,0,7,1.0,1,0.0,0,1,0,1,4,0,0,1,0,2,5,1
6686,105071,NSXDiRfuzySceLFWn0ct3CJviCtJc0Gq,SpATywNh6bZuzm8s1ceuBUnMUAeoAHHw,1,0,0,0,0,0,1,0,1,0.14285714285714285,1,0.0,0,0,0,0,0,0,0,1,0,0,1,1
6687,105074,O4P6YgbHRYZHkVgbR7e9lebrpm34oAOF,G8EPVSXsOYB5YQWZGiz1aVq5Pgr2GrQu,2,0,0,0,0,0,2,0,2,0.2857142857142857,1,0.0,0,0,0,0,0,0,0,2,0,0,2,1
6688,105076,drf1IY3xrpWQ9619UjKLyUfcUQsAdZju,bWdj2GDclj5ofokWjzoa5jAwMkxCykd6,5,3,1,0,1,0,2,0,7,1.0,1,0.0,0,1,0,1,3,0,0,2,0,2,5,1
6689,105082,0V54aOwQrSAMewtMntBBMI7Ks56rZdIS,A3fsA9Zfv1X2fVEQhTw51lKENdNrEqT3,12,6,4,0,2,1,7,0,20,2.857142857142857,1,0.0,0,4,0,2,6,1,0,7,0,6,14,1
6690,105085,aBoQ4OrEI4L04m6kqgzVP3CKZVnd2VFV,A3fsA9Zfv1X2fVEQhTw51lKENdNrEqT3,9,9,1,0,1,0,6,1,18,2.5714285714285716,1,0.0,0,1,0,1,9,0,0,6,1,2,16,1
6691,105105,aBoQ4OrEI4L04m6kqgzVP3CKZVnd2VFV,bWdj2GDclj5ofokWjzoa5jAwMkxCykd6,5,4,0,0,1,0,3,0,8,1.1428571428571428,1,0.0,2,0,0,1,2,0,0,3,0,3,5,1
6692,105107,kJpZNsO69ywT5OXmlvOgbLwUz2WmPek1,SpATywNh6bZuzm8s1ceuBUnMUAeoAHHw,13,11,5,14,3,0,2,0,35,5.0,1,0.0,5,5,11,3,6,0,3,2,0,24,11,1
6693,105146,hzBzR1u0wuRoc2H2cG5d9FzvO4PwKrLQ,SpATywNh6bZuzm8s1ceuBUnMUAeoAHHw,7,27,8,0,4,6,8,0,53,7.571428571428571,3,0.0,6,8,0,4,21,6,0,8,0,18,35,1
6694,105153,qTzYx0lbBuxcg0Yki7msaMyOo4bFeb91,SpATywNh6bZuzm8s1ceuBUnMUAeoAHHw,29,32,19,27,7,0,14,0,99,14.142857142857142,4,0.0,6,19,26,7,26,0,1,14,0,58,41,0
6695,105158,CCtqoOTfmYZ29m0AHaWWxr5jrw4v0sd6,A3fsA9Zfv1X2fVEQhTw51lKENdNrEqT3,2,0,0,0,0,0,2,0,2,0.2857142857142857,1,0.0,0,0,0,0,0,0,0,2,0,0,2,1
6696,105161,e8r3psiscML69Zoh8ndZVq9bRmvgsAna,RXDvfPUBYFlVdlueBFbLW0mhhAyGEqpt,3,0,0,0,0,0,4,0,4,0.5714285714285714,1,0.0,0,0,0,0,0,0,0,4,0,0,4,1
6697,105162,k5TsyI58X8P4Z61qSJPkdF5Bt76uuEiR,A3fsA9Zfv1X2fVEQhTw51lKENdNrEqT3,6,5,0,0,0,0,5,0,10,1.4285714285714286,1,0.0,0,0,0,0,5,0,0,5,0,0,10,1
6698,105165,WmDH79DnUcU85ObQwdrX32y257qi5DRa,SpATywNh6bZuzm8s1ceuBUnMUAeoAHHw,5,6,4,0,0,0,2,0,12,1.7142857142857142,1,0.0,1,4,0,0,5,0,0,2,0,5,7,1
6699,105182,w5agfaMGeGtqcOtE7XkU1SDkqYl8T1h1,A3fsA9Zfv1X2fVEQhTw51lKENdNrEqT3,8,5,3,0,2,0,6,1,17,2.4285714285714284,1,0.0,0,3,0,2,5,0,0,6,1,5,12,1
6700,105191,BFrfDseDfXCBvtTfCsJAy36Ogk6b0Rfx,G8EPVSXsOYB5YQWZGiz1aVq5Pgr2GrQu,6,5,2,0,2,0,1,0,10,1.4285714285714286,1,0.0,0,2,0,2,5,0,0,1,0,4,6,1
6701,105194,5KBUyFUobvfAu8D7u7bO9wAPV4vuXQZU,A3fsA9Zfv1X2fVEQhTw51lKENdNrEqT3,43,73,20,76,13,0,12,0,194,27.714285714285715,2,0.0,4,20,67,13,69,0,9,12,0,104,90,0
6702,105199,OX6Bv3g06ycMeO3pZBZoU81BWj7ixSi4,A3fsA9Zfv1X2fVEQhTw51lKENdNrEqT3,5,6,0,0,0,0,5,0,11,1.5714285714285714,1,0.0,0,0,0,0,6,0,0,5,0,0,11,1
6703,105209,H9GkE0FMgvPMf43bNx1b9TXX6TZkGY34,SpATywNh6bZuzm8s1ceuBUnMUAeoAHHw,8,10,4,0,0,0,8,0,22,3.142857142857143,2,0.0,0,4,0,0,10,0,0,8,0,4,18,1
6704,105210,4gTXYNChXbNDMcXayBSE04FxQ2nn4APt,SpATywNh6bZuzm8s1ceuBUnMUAeoAHHw,9,11,6,0,4,7,4,0,32,4.571428571428571,1,0.0,0,6,0,4,11,7,0,4,0,10,22,1
6705,105217,OTdrNhcnMXK6bAJrTqNFs6h1YG7CDhcG,SpATywNh6bZuzm8s1ceuBUnMUAeoAHHw,10,10,3,0,2,3,6,3,27,3.857142857142857,1,0.0,0,3,0,2,10,3,0,6,3,5,22,1
6706,105234,taq5KphdnNYof9EF9ofKeGcG174vbrqW,SpATywNh6bZuzm8s1ceuBUnMUAeoAHHw,7,3,2,0,2,0,3,0,10,1.4285714285714286,1,0.0,0,2,0,2,3,0,0,3,0,4,6,1
6707,105243,cOQL66KmsXcVQs1SDl21ZVtRVEM2A2Mr,SpATywNh6bZuzm8s1ceuBUnMUAeoAHHw,15,16,4,17,3,0,6,0,46,6.571428571428571,1,0.0,8,4,14,3,8,0,3,6,0,29,17,1
6708,105249,TS1ZCG3Pe57Kb9bO3M4HccqPzgampcZm,RXDvfPUBYFlVdlueBFbLW0mhhAyGEqpt,1,0,0,0,0,0,1,0,1,0.14285714285714285,1,0.0,0,0,0,0,0,0,0,1,0,0,1,1
6709,105252,0XkWdOrszvLHfOAiz41vzdHNx25DrTO5,SpATywNh6bZuzm8s1ceuBUnMUAeoAHHw,18,24,9,14,4,2,7,1,61,8.714285714285714,1,0.0,12,9,13,4,12,2,1,7,1,38,23,1
6710,105253,HVCfWzPuIjheqdsfcEfqumsi8ZGav6vR,SpATywNh6bZuzm8s1ceuBUnMUAeoAHHw,10,14,8,0,3,0,5,0,30,4.285714285714286,1,0.0,0,8,0,3,14,0,0,5,0,11,19,1
6711,105260,IK3mtf86eqab6u3Svud8svoyG25XbueY,SpATywNh6bZuzm8s1ceuBUnMUAeoAHHw,11,11,2,17,0,0,4,0,34,4.857142857142857,1,0.0,2,2,15,0,9,0,2,4,0,19,15,1
6712,105262,47V3QOKZAFRfMjY5qh3dGgU05qgUrwzk,SpATywNh6bZuzm8s1ceuBUnMUAeoAHHw,22,28,13,19,6,11,7,0,84,12.0,3,0.0,5,13,18,6,23,11,1,7,0,42,42,0
6713,105263,4HfbFsCyYszJO7w4OHW3KiOw346tCEQ3,RXDvfPUBYFlVdlueBFbLW0mhhAyGEqpt,9,11,8,0,2,0,3,0,24,3.4285714285714284,2,0.0,0,8,0,2,11,0,0,3,0,10,14,0
6714,105269,Kbp64JoaypwT9V2b1Sun21o5uQW5G9la,SpATywNh6bZuzm8s1ceuBUnMUAeoAHHw,6,3,2,0,2,0,1,0,8,1.1428571428571428,1,0.0,0,2,0,2,3,0,0,1,0,4,4,1
6715,105271,b1VyhJSDHv0QJ3rH7siQ8iNr5JEetUc9,RXDvfPUBYFlVdlueBFbLW0mhhAyGEqpt,17,42,13,0,8,1,10,1,75,10.714285714285714,2,0.0,13,13,0,8,29,1,0,10,1,34,41,1
6716,105273,eGtLsIjZlkWgWdMhhuLPGoqFtXLYqSzQ,G8EPVSXsOYB5YQWZGiz1aVq5Pgr2GrQu,11,14,8,0,5,0,5,0,32,4.571428571428571,1,0.0,0,8,0,5,14,0,0,5,0,13,19,0
6717,105274,6nb23dYhCIP1cVQ6kR327mxTR7zAmW6A,SpATywNh6bZuzm8s1ceuBUnMUAeoAHHw,15,13,9,3,5,0,3,0,33,4.714285714285714,2,0.0,2,9,3,5,11,0,0,3,0,19,14,1
6718,105289,BRC3IBMyw5vaRtTzcXuOEQUfoXyf29w0,G8EPVSXsOYB5YQWZGiz1aVq5Pgr2GrQu,8,2,1,0,2,0,3,0,8,1.1428571428571428,1,0.0,0,1,0,2,2,0,0,3,0,3,5,1
6719,105306,drUu3tyovHqnF7EAaPHayHDYbWMe2Od6,bWdj2GDclj5ofokWjzoa5jAwMkxCykd6,1,0,0,0,0,0,1,0,1,0.14285714285714285,1,0.0,0,0,0,0,0,0,0,1,0,0,1,1
6720,105322,CSp8QkNZa6B12LzJipxPFgC5w6lKLtbn,SpATywNh6bZuzm8s1ceuBUnMUAeoAHHw,1,0,0,0,0,0,1,0,1,0.14285714285714285,1,0.0,0,0,0,0,0,0,0,1,0,0,1,1
6721,105331,Sk4DUKJRImF6lijTnkABuH01jDj9zcnP,bWdj2GDclj5ofokWjzoa5jAwMkxCykd6,3,2,1,0,0,3,2,0,8,1.1428571428571428,1,0.0,0,1,0,0,2,3,0,2,0,1,7,1
6722,105347,CvSKLBTIxxGXbtAVP0WUmmB2Wsdsb6DU,SpATywNh6bZuzm8s1ceuBUnMUAeoAHHw,10,15,0,16,0,5,3,0,39,5.571428571428571,1,0.0,3,0,14,0,12,5,2,3,0,17,22,0
6723,105360,OWE34kkoT9KAMAmKtdn3UxQ37r5Vj3AT,SpATywNh6bZuzm8s1ceuBUnMUAeoAHHw,7,5,0,0,0,0,2,0,7,1.0,1,0.0,0,0,0,0,5,0,0,2,0,0,7,1
6724,105365,4ReTrx0DPSKofx7nLibnDMfTITGlbh8n,SpATywNh6bZuzm8s1ceuBUnMUAeoAHHw,7,6,3,0,2,0,3,0,14,2.0,2,0.0,0,3,0,2,6,0,0,3,0,5,9,1
6725,105366,dcPEtQ1aJsWPQvIFxgPvwR3ekqBX6ZB0,SpATywNh6bZuzm8s1ceuBUnMUAeoAHHw,1,0,0,0,0,0,1,0,1,0.14285714285714285,1,0.0,0,0,0,0,0,0,0,1,0,0,1,1
6726,105375,4Z0DzzRnG5ol9npBuWMZsHzI0G7yrdgb,SpATywNh6bZuzm8s1ceuBUnMUAeoAHHw,1,0,0,0,0,0,1,0,1,0.14285714285714285,1,0.0,0,0,0,0,0,0,0,1,0,0,1,1
6727,105377,ugyzx2kY0haeVd2DKPlWf2u8TPvIWwdG,SpATywNh6bZuzm8s1ceuBUnMUAeoAHHw,10,8,6,0,3,1,6,1,25,3.5714285714285716,1,0.0,0,6,0,3,8,1,0,6,1,9,16,1
6728,105382,OBVOXM1wUEgaM1Ic1TPHZnmgDHa3Iw3E,SpATywNh6bZuzm8s1ceuBUnMUAeoAHHw,5,2,1,0,1,0,2,0,6,0.8571428571428571,1,0.0,0,1,0,1,2,0,0,2,0,2,4,1
6729,105403,BAyiuAHT9YavjRYUTL3SqAF5fajY78B8,G8EPVSXsOYB5YQWZGiz1aVq5Pgr2GrQu,9,5,4,0,4,0,2,0,15,2.142857142857143,1,0.0,0,4,0,4,5,0,0,2,0,8,7,1
6730,105405,itFrYwUUr3TPc7mZS2RWfo2HaYAcNOxB,SpATywNh6bZuzm8s1ceuBUnMUAeoAHHw,15,13,6,13,4,1,9,0,46,6.571428571428571,1,0.0,4,6,12,4,9,1,1,9,0,26,20,1
6731,105409,vqSgORDp5PsEpveQVJoPh4dnJvR6AQkK,bWdj2GDclj5ofokWjzoa5jAwMkxCykd6,1,0,0,0,0,0,1,0,1,0.14285714285714285,1,0.0,0,0,0,0,0,0,0,1,0,0,1,1
6732,105412,6d0wTeGZDr0ncgCyWQX4AMn46gB2ZbPz,bWdj2GDclj5ofokWjzoa5jAwMkxCykd6,6,2,1,0,1,0,3,0,7,1.0,1,0.0,0,1,0,1,2,0,0,3,0,2,5,1
6733,105413,uTHtFLFEH5oi1Mhz7WcXFhd8fnlKyBlD,SpATywNh6bZuzm8s1ceuBUnMUAeoAHHw,11,10,6,0,4,0,2,0,22,3.142857142857143,1,0.0,1,6,0,4,9,0,0,2,0,11,11,1
6734,105431,7bBbNS8igBUmtAlhgWeyPaLpz7A08m0l,A3fsA9Zfv1X2fVEQhTw51lKENdNrEqT3,6,6,4,0,1,0,4,0,15,2.142857142857143,2,0.0,0,4,0,1,6,0,0,4,0,5,10,1
6735,105432,1cSsz0UCfa4Sky1FhbU6sbIRYsZ41OPL,A3fsA9Zfv1X2fVEQhTw51lKENdNrEqT3,20,28,1,38,0,2,24,4,97,13.857142857142858,1,0.0,0,1,32,0,28,2,6,24,4,33,64,1
6736,105439,jmHt2ZlvXO3qz2cHf72G06suxgziLa3C,A3fsA9Zfv1X2fVEQhTw51lKENdNrEqT3,2,0,0,0,0,0,2,0,2,0.2857142857142857,1,0.0,0,0,0,0,0,0,0,2,0,0,2,1
6737,105445,LdIFMEp4Gma3xMuOQ2mpp1BJ3jFvB9c2,bWdj2GDclj5ofokWjzoa5jAwMkxCykd6,30,57,20,88,9,4,19,0,197,28.142857142857142,6,0.0,15,20,75,9,42,4,13,19,0,119,78,0
6738,105451,1YSmilr2ajm5pFk4iAawwfB3mRapy4GR,bWdj2GDclj5ofokWjzoa5jAwMkxCykd6,4,2,1,0,1,0,1,0,5,0.7142857142857143,1,0.0,0,1,0,1,2,0,0,1,0,2,3,1
6739,105453,FNaEworzG9JIrUWWqoqtljEERNazKuKb,SpATywNh6bZuzm8s1ceuBUnMUAeoAHHw,6,3,1,0,1,0,2,0,7,1.0,1,0.0,0,1,0,1,3,0,0,2,0,2,5,1
6740,105454,EK81RbZoXEDM3g1RV68PHuRhq28X4Rfk,A3fsA9Zfv1X2fVEQhTw51lKENdNrEqT3,5,2,1,0,1,0,2,0,6,0.8571428571428571,1,0.0,0,1,0,1,2,0,0,2,0,2,4,1
6741,105456,P9cYtrIJUSQx41yE7x59h9MgXtuGnnbs,G8EPVSXsOYB5YQWZGiz1aVq5Pgr2GrQu,1,0,0,0,0,0,1,0,1,0.14285714285714285,1,0.0,0,0,0,0,0,0,0,1,0,0,1,1
6742,105464,rc8mOopKEVh5BHf3pFrEDGrzFcNfbS3h,SpATywNh6bZuzm8s1ceuBUnMUAeoAHHw,5,2,1,0,1,0,3,0,7,1.0,2,0.0,0,1,0,1,2,0,0,3,0,2,5,1
6743,105471,DIfj5Ba2axfDE4LFDWqKjVBCgesW8XXW,SpATywNh6bZuzm8s1ceuBUnMUAeoAHHw,12,36,8,0,2,3,8,0,57,8.142857142857142,1,0.0,0,8,0,2,36,3,0,8,0,10,47,1
6744,105479,DRqM6Ff42uz4k14OFxcFjetTXyC12WI7,SpATywNh6bZuzm8s1ceuBUnMUAeoAHHw,9,11,1,7,1,0,4,0,24,3.4285714285714284,2,0.0,0,1,6,1,11,0,1,4,0,8,16,1
6745,105480,RSwFpC1qMeXR2lSJtCkUxC2GY1HkPGdb,SpATywNh6bZuzm8s1ceuBUnMUAeoAHHw,9,10,6,0,3,0,3,0,22,3.142857142857143,2,0.0,1,6,0,3,9,0,0,3,0,10,12,1
6746,105491,QKXQzGYic4FsMmW8FpleZuFU3phntMAt,SpATywNh6bZuzm8s1ceuBUnMUAeoAHHw,8,4,3,0,3,0,1,0,11,1.5714285714285714,1,0.0,0,3,0,3,4,0,0,1,0,6,5,0
6747,105497,ouzFxiP7ljIzym1OgbkkNZsSGwRWOJRH,SpATywNh6bZuzm8s1ceuBUnMUAeoAHHw,5,2,1,0,1,0,2,0,6,0.8571428571428571,1,0.0,0,1,0,1,2,0,0,2,0,2,4,1
6748,105507,3xA82OlUzQ8FfAlTJcvVktSt0q894DXz,A3fsA9Zfv1X2fVEQhTw51lKENdNrEqT3,9,4,3,0,2,0,3,0,12,1.7142857142857142,1,0.0,0,3,0,2,4,0,0,3,0,5,7,1
6749,105513,huQkoBKNhxQg56EbGDFifh0dLnvHtGe7,SpATywNh6bZuzm8s1ceuBUnMUAeoAHHw,30,25,13,16,7,7,10,2,80,11.428571428571429,3,0.0,9,13,15,7,16,7,1,10,2,44,36,1
6750,105514,pb0NolqZsXAL2OR3XPD1zckdYQxFlvNU,SpATywNh6bZuzm8s1ceuBUnMUAeoAHHw,5,2,1,0,1,0,4,0,8,1.1428571428571428,1,0.0,0,1,0,1,2,0,0,4,0,2,6,1
6751,105517,bR55dFOoIQqPJPBvXoxJUIXx5dva0hOC,G8EPVSXsOYB5YQWZGiz1aVq5Pgr2GrQu,9,3,2,0,2,0,4,0,11,1.5714285714285714,1,0.0,0,2,0,2,3,0,0,4,0,4,7,1
6752,105526,dBYXiPq5rGdb4oW5xYaPd7zkgh6w8ny5,SpATywNh6bZuzm8s1ceuBUnMUAeoAHHw,3,3,0,0,0,0,1,0,4,0.5714285714285714,1,0.0,0,0,0,0,3,0,0,1,0,0,4,1
6753,105528,Gs4A8cx631DBKRtaVJfbdm1OgfYfhvQ8,A3fsA9Zfv1X2fVEQhTw51lKENdNrEqT3,2,0,0,0,0,0,2,0,2,0.2857142857142857,1,0.0,0,0,0,0,0,0,0,2,0,0,2,1
6754,105530,yjJ1iNhFO6aUkQdyDFXsvnts4X4TBbt1,G8EPVSXsOYB5YQWZGiz1aVq5Pgr2GrQu,14,8,7,0,6,0,6,1,28,4.0,1,0.0,0,7,0,6,8,0,0,6,1,13,15,1
6755,105532,YBSh2Ce8VFxfjfLxt9dOr0DLrvgLDo3G,SpATywNh6bZuzm8s1ceuBUnMUAeoAHHw,4,3,1,0,1,0,1,0,6,0.8571428571428571,1,0.0,0,1,0,1,3,0,0,1,0,2,4,1
6756,105538,JFR1iuUdFS1mD5BLqLO5DI7ZsHM5MIC6,SpATywNh6bZuzm8s1ceuBUnMUAeoAHHw,2,0,0,0,0,0,2,0,2,0.2857142857142857,1,0.0,0,0,0,0,0,0,0,2,0,0,2,1
6757,105543,JFR1iuUdFS1mD5BLqLO5DI7ZsHM5MIC6,bWdj2GDclj5ofokWjzoa5jAwMkxCykd6,2,0,0,0,0,0,2,0,2,0.2857142857142857,1,0.0,0,0,0,0,0,0,0,2,0,0,2,0
6758,105549,2OnJKTPobGmyM9bjszCwLbDBhhcw3Ptr,SpATywNh6bZuzm8s1ceuBUnMUAeoAHHw,6,4,2,0,1,0,4,0,11,1.5714285714285714,1,0.0,0,2,0,1,4,0,0,4,0,3,8,1
6759,105554,lD9Di3R0D8jVkARIDTv9uHKlPOJul1IJ,RXDvfPUBYFlVdlueBFbLW0mhhAyGEqpt,21,12,10,0,7,1,10,3,43,6.142857142857143,1,0.0,0,10,0,7,12,1,0,10,3,17,26,1
6760,105560,TBhSGbYkj43z5s2FElhR2mY8V29OFGOl,SpATywNh6bZuzm8s1ceuBUnMUAeoAHHw,9,12,4,14,1,8,1,0,40,5.714285714285714,1,0.0,7,4,12,1,5,8,2,1,0,24,16,1
6761,105564,a160ewxyRJdtN45GnX3uGxkLMyeZKvV7,A3fsA9Zfv1X2fVEQhTw51lKENdNrEqT3,5,3,2,0,1,0,1,0,7,1.0,1,0.0,0,2,0,1,3,0,0,1,0,3,4,1
6762,105572,i1rf4Uc8Jyx4GInthodWWBcAxWOUsNY3,SpATywNh6bZuzm8s1ceuBUnMUAeoAHHw,1,0,0,0,0,0,1,0,1,0.14285714285714285,1,0.0,0,0,0,0,0,0,0,1,0,0,1,1
6763,105578,UZSpGopByMz4vpZWWp6YjynYHDg7IDCz,SpATywNh6bZuzm8s1ceuBUnMUAeoAHHw,7,3,0,0,0,1,7,2,13,1.8571428571428572,1,0.0,0,0,0,0,3,1,0,7,2,0,13,1
6764,105596,9U8TB2VVR3SpNOaUoetOaSnkDznyBFBg,G8EPVSXsOYB5YQWZGiz1aVq5Pgr2GrQu,5,3,0,0,0,0,2,0,5,0.7142857142857143,1,0.0,0,0,0,0,3,0,0,2,0,0,5,1
6765,105603,U5SVBnEdwM8cChRjcz152ZJPSF8LRTgS,SpATywNh6bZuzm8s1ceuBUnMUAeoAHHw,17,23,12,15,6,10,4,0,70,10.0,1,0.0,10,12,12,6,13,10,3,4,0,40,30,1
6766,105605,vqN40E2i0C3fLg1fxObrFNN6aBFCAnYS,SpATywNh6bZuzm8s1ceuBUnMUAeoAHHw,4,2,1,0,1,0,1,0,5,0.7142857142857143,1,0.0,0,1,0,1,2,0,0,1,0,2,3,1
6767,105611,Z91ylcCa0QBPuZRAZnN7Bi8KMhEMk84I,G8EPVSXsOYB5YQWZGiz1aVq5Pgr2GrQu,1,0,0,0,0,0,1,0,1,0.14285714285714285,1,0.0,0,0,0,0,0,0,0,1,0,0,1,1
6768,105614,jkI0zARZWQkZpKjEUfCP0wADmuTyrZSB,G8EPVSXsOYB5YQWZGiz1aVq5Pgr2GrQu,5,2,1,0,1,0,2,0,6,0.8571428571428571,1,0.0,0,1,0,1,2,0,0,2,0,2,4,1
6769,105615,yt2gjsEupK8sBRyKpoF6RM4kG7zfvxKC,SpATywNh6bZuzm8s1ceuBUnMUAeoAHHw,17,42,11,22,2,9,11,2,99,14.142857142857142,3,0.0,23,11,21,2,19,9,1,11,2,57,42,0
6770,105618,UR2QSgawy0CjHWh1ilXf2hWdYdvRIm7a,A3fsA9Zfv1X2fVEQhTw51lKENdNrEqT3,1,0,0,0,0,0,1,0,1,0.14285714285714285,1,0.0,0,0,0,0,0,0,0,1,0,0,1,1
6771,105622,jkI0zARZWQkZpKjEUfCP0wADmuTyrZSB,A3fsA9Zfv1X2fVEQhTw51lKENdNrEqT3,12,11,2,0,2,0,4,0,19,2.7142857142857144,1,0.0,0,2,0,2,11,0,0,4,0,4,15,1
6772,105627,5uQhTmVLlxOLiyKyZlkmRhPs99pj5h4D,SpATywNh6bZuzm8s1ceuBUnMUAeoAHHw,7,3,2,0,2,0,2,0,9,1.2857142857142858,1,0.0,0,2,0,2,3,0,0,2,0,4,5,1
6773,105633,No3uaZVX8QfUWi2WuoYFYrVrLQNiuZit,SpATywNh6bZuzm8s1ceuBUnMUAeoAHHw,4,2,1,0,1,0,1,0,5,0.7142857142857143,1,0.0,0,1,0,1,2,0,0,1,0,2,3,1
6774,105634,6YparlTvGntzzoJlcpXRHjZMmqjae5pt,SpATywNh6bZuzm8s1ceuBUnMUAeoAHHw,14,7,5,2,3,7,7,1,32,4.571428571428571,1,0.0,0,5,2,3,7,7,0,7,1,10,22,1
6775,105640,gw3yc6n6VFyWcEZvOt8ZtzcLtuPxALTw,SpATywNh6bZuzm8s1ceuBUnMUAeoAHHw,14,25,11,19,0,21,16,1,93,13.285714285714286,4,0.0,8,11,16,0,17,21,3,16,1,35,58,1
6776,105645,jcprw7R15XocpeKMqxQA9O1OxKgjloTM,SpATywNh6bZuzm8s1ceuBUnMUAeoAHHw,1,0,0,0,0,0,1,0,1,0.14285714285714285,1,0.0,0,0,0,0,0,0,0,1,0,0,1,1
6777,105654,YpnxbgvlHOSkecYk2lPrRwAg5SZiWPmr,A3fsA9Zfv1X2fVEQhTw51lKENdNrEqT3,5,2,1,0,1,0,2,0,6,0.8571428571428571,1,0.0,0,1,0,1,2,0,0,2,0,2,4,1
6778,105668,7KQcIrOp3KoypOTvziMED7rHtDH1CXtE,A3fsA9Zfv1X2fVEQhTw51lKENdNrEqT3,1,0,0,0,0,0,1,0,1,0.14285714285714285,1,0.0,0,0,0,0,0,0,0,1,0,0,1,1
6779,105671,wpA3YODDDsWaFQtfPR7v2M6HEJbcAeIY,SpATywNh6bZuzm8s1ceuBUnMUAeoAHHw,5,5,1,0,0,0,3,0,9,1.2857142857142858,2,0.0,0,1,0,0,5,0,0,3,0,1,8,1
6780,105672,V02ryEmMmqjGIIiLHIkYu0vvVMLeyKKP,A3fsA9Zfv1X2fVEQhTw51lKENdNrEqT3,8,4,2,0,2,0,2,0,10,1.4285714285714286,1,0.0,0,2,0,2,4,0,0,2,0,4,6,1
6781,105677,tbzj7Go70gnZDKKkB7OUY9ROk4h4NATx,bWdj2GDclj5ofokWjzoa5jAwMkxCykd6,6,4,2,0,1,0,4,0,11,1.5714285714285714,1,0.0,0,2,0,1,4,0,0,4,0,3,8,1
6782,105690,dCV7p4dH2mfgkfJtane8atsSzuvj1JQf,bWdj2GDclj5ofokWjzoa5jAwMkxCykd6,1,0,0,0,0,0,1,0,1,0.14285714285714285,1,0.0,0,0,0,0,0,0,0,1,0,0,1,1
6783,105699,hBWZaknNj3MZUvkhj5xTqflV3rTd1l4t,bWdj2GDclj5ofokWjzoa5jAwMkxCykd6,2,0,0,0,0,0,2,0,2,0.2857142857142857,1,0.0,0,0,0,0,0,0,0,2,0,0,2,1
6784,105703,xePykhVJ0RKvBcesQ9TJJOkbxCOkEY1s,SpATywNh6bZuzm8s1ceuBUnMUAeoAHHw,4,0,0,0,0,3,3,0,6,0.8571428571428571,2,0.0,0,0,0,0,0,3,0,3,0,0,6,1
6785,105706,Higp7tL2evAdDfwxJ7Fv3MD5xI1FILhG,G8EPVSXsOYB5YQWZGiz1aVq5Pgr2GrQu,1,0,0,0,0,0,1,0,1,0.14285714285714285,1,0.0,0,0,0,0,0,0,0,1,0,0,1,1
6786,105707,YXw4AHOHrgMAyUR11Z0AMDwuHnZeqZI7,G8EPVSXsOYB5YQWZGiz1aVq5Pgr2GrQu,5,2,1,0,1,0,2,0,6,0.8571428571428571,1,0.0,0,1,0,1,2,0,0,2,0,2,4,1
6787,105713,RHNP6ku8FrLIdJ9UJ6RZ5wmeyQgTyWsO,A3fsA9Zfv1X2fVEQhTw51lKENdNrEqT3,1,0,0,0,0,0,2,0,2,0.2857142857142857,1,0.0,0,0,0,0,0,0,0,2,0,0,2,1
6788,105746,szmVnhPypUPoSdN8Z8D02a6M8Gjrnwmf,7GRhBDsirIGkRZBtSMEzNTyDr2JQm4xx,4,2,1,0,1,0,1,0,5,0.7142857142857143,1,0.0,0,1,0,1,2,0,0,1,0,2,3,1
6789,105767,mjObtvp4vmduPSr2e6gxrQuYRjgGF8wF,7GRhBDsirIGkRZBtSMEzNTyDr2JQm4xx,11,11,6,0,5,2,1,0,25,3.5714285714285716,1,0.0,4,6,0,5,7,2,0,1,0,15,10,0
6790,106004,ZPzO2Jq9MyhQSTfjOYO9iqzdnziVzHhF,7GRhBDsirIGkRZBtSMEzNTyDr2JQm4xx,18,27,11,8,6,0,7,0,59,8.428571428571429,1,0.0,12,11,7,6,15,0,1,7,0,36,23,1
6791,106408,3C0RNflDAI8FmTdsE1mhjUkpDZ4xUri7,SpATywNh6bZuzm8s1ceuBUnMUAeoAHHw,1,0,0,0,0,0,1,0,1,0.14285714285714285,1,0.0,0,0,0,0,0,0,0,1,0,0,1,1
6792,106443,t3vj4r7JOWedUjNWDPc1a4izv1Cmnqwm,RXDvfPUBYFlVdlueBFbLW0mhhAyGEqpt,13,10,2,28,2,0,3,0,45,6.428571428571429,2,0.0,6,2,26,2,4,0,2,3,0,36,9,1
6793,106591,rxfzVJVj4XNymQN7SX1pdLUM549NCrW7,SpATywNh6bZuzm8s1ceuBUnMUAeoAHHw,6,7,4,0,1,0,5,0,17,2.4285714285714284,3,0.0,0,4,0,1,7,0,0,5,0,5,12,0
6794,106650,GebdA7Vo87ReyKP2A7BXi3CttXQIgfXb,SpATywNh6bZuzm8s1ceuBUnMUAeoAHHw,5,3,1,0,0,0,4,0,8,1.1428571428571428,1,0.0,0,1,0,0,3,0,0,4,0,1,7,1
6795,106698,AuIQbwKCl1rpgmIzQXLySneETBtGUcy9,SpATywNh6bZuzm8s1ceuBUnMUAeoAHHw,9,15,2,0,3,0,2,0,22,3.142857142857143,2,0.0,2,2,0,3,13,0,0,2,0,7,15,1
6796,106710,2sYGHfb0Gpw1ITIdkhTs2jjyBEZU4HAF,SpATywNh6bZuzm8s1ceuBUnMUAeoAHHw,4,2,0,0,0,0,4,0,6,0.8571428571428571,1,0.0,0,0,0,0,2,0,0,4,0,0,6,1
6797,106724,LBz8eebDA0q3o7gWfqXlzvsHwwqTUJzd,SpATywNh6bZuzm8s1ceuBUnMUAeoAHHw,7,14,0,0,0,0,3,1,18,2.5714285714285716,1,0.0,0,0,0,0,14,0,0,3,1,0,18,0
6798,106858,wwFNSVNavy53ZZLg1TQ0hM4pFCmqfiLF,A3fsA9Zfv1X2fVEQhTw51lKENdNrEqT3,5,2,1,0,1,0,3,0,7,1.0,1,0.0,0,1,0,1,2,0,0,3,0,2,5,0
6799,106906,myNTp931AmSPRA2kl8memATVLQzx4fxs,SpATywNh6bZuzm8s1ceuBUnMUAeoAHHw,11,11,3,8,0,0,3,0,25,3.5714285714285716,1,0.0,5,3,8,0,6,0,0,3,0,16,9,1
6800,106940,NKTsGtocSBmn1p0LL8TfbQ17Oh6XvCt3,SpATywNh6bZuzm8s1ceuBUnMUAeoAHHw,14,46,3,27,0,71,20,4,171,24.428571428571427,5,0.0,19,3,21,0,27,71,6,20,4,43,128,0
6801,107974,dtVsNki5zywoboI6DGdzIRSljGsEQsRE,SpATywNh6bZuzm8s1ceuBUnMUAeoAHHw,7,6,1,0,1,0,3,0,11,1.5714285714285714,1,0.0,0,1,0,1,6,0,0,3,0,2,9,1
6802,107980,lOPfkJTjHU0xkFfC9CIvobXcPYmnNHom,SpATywNh6bZuzm8s1ceuBUnMUAeoAHHw,15,22,14,10,4,0,9,0,59,8.428571428571429,2,0.0,4,14,9,4,18,0,1,9,0,31,28,0
6803,107985,3zcQqBSlndQvb088xX2bWzjwjrK9gGXb,SpATywNh6bZuzm8s1ceuBUnMUAeoAHHw,13,23,0,21,0,2,4,0,50,7.142857142857143,1,0.0,6,0,20,0,17,2,1,4,0,26,24,1
6804,107989,ilWzYGLWBh9DSc1MV8g2C4Go5wDNgUHX,RXDvfPUBYFlVdlueBFbLW0mhhAyGEqpt,1,0,0,0,0,0,1,0,1,0.14285714285714285,1,0.0,0,0,0,0,0,0,0,1,0,0,1,1
6805,108004,6oCIsm9feSmMCAtwRcz7U3xMlVdQPmgW,SpATywNh6bZuzm8s1ceuBUnMUAeoAHHw,6,3,1,0,1,0,2,0,7,1.0,1,0.0,0,1,0,1,3,0,0,2,0,2,5,1
6806,108008,7JBtUpIhUnYCA4q3ae7hJoTZvMtE4cUd,SpATywNh6bZuzm8s1ceuBUnMUAeoAHHw,21,44,10,3,5,1,11,1,75,10.714285714285714,5,0.0,2,10,3,5,42,1,0,11,1,20,55,1
6807,108022,PouZmZXexxytkMLV0zJhqCjIk5MXfiuJ,SpATywNh6bZuzm8s1ceuBUnMUAeoAHHw,17,18,7,21,4,17,6,2,75,10.714285714285714,1,0.0,8,7,17,4,10,17,4,6,2,36,39,1
6808,108028,bDxjtNxv0fWJdWWEfRKEUv4YBma9IgaW,SpATywNh6bZuzm8s1ceuBUnMUAeoAHHw,15,18,8,18,4,5,12,1,66,9.428571428571429,2,0.0,4,8,16,4,14,5,2,12,1,32,34,1
6809,108043,e2g6ypvlbdTJJDNt2jr7tkCU179qUmrV,SpATywNh6bZuzm8s1ceuBUnMUAeoAHHw,1,0,0,0,0,0,1,0,1,0.14285714285714285,1,0.0,0,0,0,0,0,0,0,1,0,0,1,1
6810,108056,P6v79AbA8JNvvK6UNaNGagvsf7jk48sR,SpATywNh6bZuzm8s1ceuBUnMUAeoAHHw,5,2,1,0,1,0,2,0,6,0.8571428571428571,1,0.0,0,1,0,1,2,0,0,2,0,2,4,1
6811,108059,YHlbNc2DvzqJVtSUhFFwHv9LTYvtn9Mw,RXDvfPUBYFlVdlueBFbLW0mhhAyGEqpt,1,0,0,0,0,0,2,0,2,0.2857142857142857,1,0.0,0,0,0,0,0,0,0,2,0,0,2,1
6812,108063,FLuCisP22zuNYM50DiHloNWfjCL7Trqn,SpATywNh6bZuzm8s1ceuBUnMUAeoAHHw,7,7,2,0,1,0,3,0,13,1.8571428571428572,2,0.0,0,2,0,1,7,0,0,3,0,3,10,1
6813,108066,biPbQQgRZQFKOAVcr8zCs5vcz2Zp7TtR,SpATywNh6bZuzm8s1ceuBUnMUAeoAHHw,6,5,3,0,2,0,3,0,13,1.8571428571428572,1,0.0,0,3,0,2,5,0,0,3,0,5,8,1
6814,108067,7LgsB1Dbs9AWbCH4Qtqx9aZFnEle1djD,A3fsA9Zfv1X2fVEQhTw51lKENdNrEqT3,6,3,0,0,0,0,5,0,8,1.1428571428571428,1,0.0,0,0,0,0,3,0,0,5,0,0,8,1
6815,108068,521YJDVy6G9ul5QyLTUZAuztPLpe7gqW,A3fsA9Zfv1X2fVEQhTw51lKENdNrEqT3,8,4,2,0,0,4,10,0,20,2.857142857142857,1,0.0,1,2,0,0,3,4,0,10,0,3,17,1
6816,108075,EboqTOLce3Kcnbr13rePsINEM3noHrcD,A3fsA9Zfv1X2fVEQhTw51lKENdNrEqT3,8,4,3,0,3,0,1,0,11,1.5714285714285714,1,0.0,0,3,0,3,4,0,0,1,0,6,5,1
6817,108077,aiXR63FJxLzLjxOw200I9QHjcVwt5TEN,RXDvfPUBYFlVdlueBFbLW0mhhAyGEqpt,1,0,0,0,0,0,1,0,1,0.14285714285714285,1,0.0,0,0,0,0,0,0,0,1,0,0,1,1
6818,108080,KMcnmZ5Os9sw6KyJ7BWURh6K8QGi1wsV,bWdj2GDclj5ofokWjzoa5jAwMkxCykd6,8,6,1,0,2,0,3,0,12,1.7142857142857142,1,0.0,2,1,0,2,4,0,0,3,0,5,7,1
6819,108086,3pgK06P2oLAcnmiNZRznn0B0EGmUgMOP,SpATywNh6bZuzm8s1ceuBUnMUAeoAHHw,6,9,3,0,1,0,4,0,17,2.4285714285714284,1,0.0,0,3,0,1,9,0,0,4,0,4,13,1
6820,108100,KYKzKpnBUYOr84PudAmq8tNzhwmTGrJ8,A3fsA9Zfv1X2fVEQhTw51lKENdNrEqT3,10,5,3,0,2,1,6,1,18,2.5714285714285716,1,0.0,0,3,0,2,5,1,0,6,1,5,13,1
6821,108102,7aA6BrVZipLHOrozlrYBMEmfMq4MXahq,SpATywNh6bZuzm8s1ceuBUnMUAeoAHHw,4,6,0,0,0,0,2,0,8,1.1428571428571428,1,0.0,0,0,0,0,6,0,0,2,0,0,8,1
6822,108103,2jvZGTQOv5HI5u69PvJ98o1zG3YXhtLw,SpATywNh6bZuzm8s1ceuBUnMUAeoAHHw,12,12,4,11,2,1,2,0,32,4.571428571428571,1,0.0,6,4,10,2,6,1,1,2,0,22,10,1
6823,108114,sgggYhWjUONtSvJl6cytWZyV2XJXwrfv,RXDvfPUBYFlVdlueBFbLW0mhhAyGEqpt,1,0,0,0,0,0,1,0,1,0.14285714285714285,1,0.0,0,0,0,0,0,0,0,1,0,0,1,1
6824,108117,dpzYaESA6MCFHXGYe2bLHvSr1kNOP50p,bWdj2GDclj5ofokWjzoa5jAwMkxCykd6,1,0,0,0,0,0,1,0,1,0.14285714285714285,1,0.0,0,0,0,0,0,0,0,1,0,0,1,1
6825,108124,dpzYaESA6MCFHXGYe2bLHvSr1kNOP50p,RXDvfPUBYFlVdlueBFbLW0mhhAyGEqpt,1,0,0,0,0,0,1,0,1,0.14285714285714285,1,0.0,0,0,0,0,0,0,0,1,0,0,1,1
6826,108126,5vV5bz7iJVuZlu434ocQi0K0Vkr9Mwnk,bWdj2GDclj5ofokWjzoa5jAwMkxCykd6,4,2,0,0,0,0,4,0,6,0.8571428571428571,1,0.0,0,0,0,0,2,0,0,4,0,0,6,1
6827,108129,5vV5bz7iJVuZlu434ocQi0K0Vkr9Mwnk,A3fsA9Zfv1X2fVEQhTw51lKENdNrEqT3,2,0,0,0,0,0,3,0,3,0.42857142857142855,1,0.0,0,0,0,0,0,0,0,3,0,0,3,1
6828,108132,2w4cE1JaIeIFAZaP4jTngJpTehNnFzsI,G8EPVSXsOYB5YQWZGiz1aVq5Pgr2GrQu,4,2,0,0,0,0,2,0,4,0.5714285714285714,1,0.0,0,0,0,0,2,0,0,2,0,0,4,0
6829,108137,wKzEabDf6tGdNdSmhgTmVPwzaHM3HdDm,bWdj2GDclj5ofokWjzoa5jAwMkxCykd6,1,0,0,0,0,0,1,0,1,0.14285714285714285,1,0.0,0,0,0,0,0,0,0,1,0,0,1,1
6830,108140,wKzEabDf6tGdNdSmhgTmVPwzaHM3HdDm,A3fsA9Zfv1X2fVEQhTw51lKENdNrEqT3,1,0,0,0,0,0,1,0,1,0.14285714285714285,1,0.0,0,0,0,0,0,0,0,1,0,0,1,1
6831,108154,hbTx2HlAPaSfk5EORjF7ocOSpDhWinaD,G8EPVSXsOYB5YQWZGiz1aVq5Pgr2GrQu,8,16,8,0,5,0,14,0,43,6.142857142857143,3,0.0,2,8,0,5,14,0,0,14,0,15,28,0
6832,108178,vz93ZdWSu0NWsoHKFr8vIf7NHeIpZbfP,bWdj2GDclj5ofokWjzoa5jAwMkxCykd6,7,3,2,0,2,0,2,0,9,1.2857142857142858,1,0.0,0,2,0,2,3,0,0,2,0,4,5,1
6833,108187,TSPlBwReynnjQ2q72CnYFjLp85rX76cJ,A3fsA9Zfv1X2fVEQhTw51lKENdNrEqT3,2,0,0,0,0,0,2,0,2,0.2857142857142857,1,0.0,0,0,0,0,0,0,0,2,0,0,2,1
6834,108190,bGjzMxOC88rUacNGu6kshAaxdH2zKDK7,A3fsA9Zfv1X2fVEQhTw51lKENdNrEqT3,6,9,0,0,0,0,1,0,10,1.4285714285714286,1,0.0,0,0,0,0,9,0,0,1,0,0,10,1
6835,108213,zrXVmAXKkFc8iiWu8fCjaRvDc9MMQT2x,SpATywNh6bZuzm8s1ceuBUnMUAeoAHHw,4,2,1,0,1,0,1,0,5,0.7142857142857143,1,0.0,0,1,0,1,2,0,0,1,0,2,3,1
6836,108217,6In9aidJiz35UAmMIZUhwjQpPpqW4IPc,A3fsA9Zfv1X2fVEQhTw51lKENdNrEqT3,4,3,1,0,0,0,4,0,8,1.1428571428571428,1,0.0,0,1,0,0,3,0,0,4,0,1,7,1
6837,108228,6In9aidJiz35UAmMIZUhwjQpPpqW4IPc,bWdj2GDclj5ofokWjzoa5jAwMkxCykd6,2,0,0,0,0,0,2,0,2,0.2857142857142857,1,0.0,0,0,0,0,0,0,0,2,0,0,2,1
6838,108235,uGnwUJpu1DKiWsVPpyszxZyMbYFsrVu7,SpATywNh6bZuzm8s1ceuBUnMUAeoAHHw,10,9,3,11,2,4,2,0,31,4.428571428571429,1,0.0,5,3,11,2,4,4,0,2,0,21,10,0
6839,108247,JVwYgpbMnhyXKC0xUgsIj4AIloKjDOV1,A3fsA9Zfv1X2fVEQhTw51lKENdNrEqT3,4,2,0,0,0,2,3,0,7,1.0,2,0.0,0,0,0,0,2,2,0,3,0,0,7,1
6840,108251,Exf9rFmbTdsimBjbWioKYnQ8NgdvC5jd,RXDvfPUBYFlVdlueBFbLW0mhhAyGEqpt,8,9,1,0,0,0,1,0,11,1.5714285714285714,1,0.0,0,1,0,0,9,0,0,1,0,1,10,1
6841,108256,D6COhDGqanxSpN5gApKicTTjeA66WqVe,SpATywNh6bZuzm8s1ceuBUnMUAeoAHHw,1,0,0,0,0,0,1,0,1,0.14285714285714285,1,0.0,0,0,0,0,0,0,0,1,0,0,1,1
6842,108262,BKTGezJoHjleu4tXARXtOL0EOZtL4wb9,bWdj2GDclj5ofokWjzoa5jAwMkxCykd6,9,11,5,0,3,0,2,0,21,3.0,3,0.0,0,5,0,3,11,0,0,2,0,8,13,1
6843,108283,hmtOqZVjWQ6rLJb3YkFWytQIy20ogszh,A3fsA9Zfv1X2fVEQhTw51lKENdNrEqT3,5,2,1,0,1,0,3,0,7,1.0,1,0.0,0,1,0,1,2,0,0,3,0,2,5,1
6844,108289,uidhjEbrao8Ccg3eBjaALRRkH9i692Ay,RXDvfPUBYFlVdlueBFbLW0mhhAyGEqpt,1,0,0,0,0,0,1,0,1,0.14285714285714285,1,0.0,0,0,0,0,0,0,0,1,0,0,1,1
6845,108291,KEDl5eQRZ3KXdMwf0omOM9Nnx9xLsQXi,SpATywNh6bZuzm8s1ceuBUnMUAeoAHHw,4,2,0,0,0,0,3,0,5,0.7142857142857143,1,0.0,0,0,0,0,2,0,0,3,0,0,5,1
6846,108292,uux8SuQRwPqDOuP8QlaB5wBQy6rHdvqS,SpATywNh6bZuzm8s1ceuBUnMUAeoAHHw,5,3,1,0,1,4,2,0,11,1.5714285714285714,1,0.0,0,1,0,1,3,4,0,2,0,2,9,1
6847,108301,cLfffYpPluVkrQWrGySOJC5E8Pia7HHf,A3fsA9Zfv1X2fVEQhTw51lKENdNrEqT3,2,0,0,0,0,0,2,0,2,0.2857142857142857,1,0.0,0,0,0,0,0,0,0,2,0,0,2,1
6848,108307,dbPMzxs1MK4eXxSu7capyuymr7qmuT7h,G8EPVSXsOYB5YQWZGiz1aVq5Pgr2GrQu,8,14,5,0,4,0,4,0,27,3.857142857142857,1,0.0,0,5,0,4,14,0,0,4,0,9,18,1
6849,108319,yVtzjNm7Xgz14yjopuLvCh7VRZR9RBra,A3fsA9Zfv1X2fVEQhTw51lKENdNrEqT3,5,0,0,0,0,6,8,0,14,2.0,1,0.0,0,0,0,0,0,6,0,8,0,0,14,1
6850,108328,xzsuu7TKRpeInAyJlxSvMP3hCrOSGC3q,G8EPVSXsOYB5YQWZGiz1aVq5Pgr2GrQu,7,6,2,0,2,0,4,0,14,2.0,1,0.0,3,2,0,2,3,0,0,4,0,7,7,1
6851,108342,LWnw8PqIiH64F1iHRbOem9hLLYoUuhVp,SpATywNh6bZuzm8s1ceuBUnMUAeoAHHw,1,0,0,0,0,0,1,0,1,0.14285714285714285,1,0.0,0,0,0,0,0,0,0,1,0,0,1,1
6852,108349,YbIRWz7aGoZEJGOL5qUEZpXGM6vHAAAA,SpATywNh6bZuzm8s1ceuBUnMUAeoAHHw,7,3,2,0,2,0,2,0,9,1.2857142857142858,1,0.0,0,2,0,2,3,0,0,2,0,4,5,1
6853,108363,LSAqQ9qRJ6IA5mDIPLRj3aw5O17rNapz,SpATywNh6bZuzm8s1ceuBUnMUAeoAHHw,4,3,0,0,0,0,1,0,4,0.5714285714285714,1,0.0,0,0,0,0,3,0,0,1,0,0,4,1
6854,108369,ZelBFCiIf4nT2uZgj3xzub7opPstKtrk,SpATywNh6bZuzm8s1ceuBUnMUAeoAHHw,1,0,0,0,0,0,1,0,1,0.14285714285714285,1,0.0,0,0,0,0,0,0,0,1,0,0,1,1
6855,108382,GibLcUgLW0dAKrvBvyjm1UI7aEhY2EYI,SpATywNh6bZuzm8s1ceuBUnMUAeoAHHw,7,7,5,0,3,0,5,0,20,2.857142857142857,1,0.0,0,5,0,3,7,0,0,5,0,8,12,1
6856,108383,dgp1qm7PjXoVV4MjyzuvWetQrJ3T9kos,SpATywNh6bZuzm8s1ceuBUnMUAeoAHHw,1,0,0,0,0,0,1,0,1,0.14285714285714285,1,0.0,0,0,0,0,0,0,0,1,0,0,1,1
6857,108384,HErgZ4jawN9YK19iQGOcyzXBTFaOouqG,bWdj2GDclj5ofokWjzoa5jAwMkxCykd6,7,4,3,0,3,0,2,0,12,1.7142857142857142,1,0.0,0,3,0,3,4,0,0,2,0,6,6,1
6858,108386,eBckG9AVr6bIBOpezfRr2S1KzQMM7OtD,G8EPVSXsOYB5YQWZGiz1aVq5Pgr2GrQu,14,14,10,0,7,2,6,1,40,5.714285714285714,1,0.0,0,10,0,7,14,2,0,6,1,17,23,0
6859,108388,M5VVteWQySX3L3J4dk5RJz0FGibCUyC6,SpATywNh6bZuzm8s1ceuBUnMUAeoAHHw,1,0,0,0,0,0,2,0,2,0.2857142857142857,1,0.0,0,0,0,0,0,0,0,2,0,0,2,1
6860,108444,slbuLFnaQZJ34dE8jfJqWtRl7JJLBe8u,SpATywNh6bZuzm8s1ceuBUnMUAeoAHHw,8,7,4,0,2,0,3,0,16,2.2857142857142856,1,0.0,0,4,0,2,7,0,0,3,0,6,10,1
6861,108472,AVjxFBCViTyDwpTqU42MWgJe18swM9dv,A3fsA9Zfv1X2fVEQhTw51lKENdNrEqT3,1,0,0,0,0,0,1,0,1,0.14285714285714285,1,0.0,0,0,0,0,0,0,0,1,0,0,1,1
6862,108477,0utD2vP6cBRtrip5Htxbgl8CGlMSWQLX,bWdj2GDclj5ofokWjzoa5jAwMkxCykd6,7,4,1,0,2,31,5,0,43,6.142857142857143,1,0.0,3,1,0,2,1,31,0,5,0,6,37,1
6863,108489,HBfe50okXo4yGURKfz5xhaX3ToIkoF7Q,A3fsA9Zfv1X2fVEQhTw51lKENdNrEqT3,46,48,23,61,12,20,11,1,176,25.142857142857142,2,0.0,1,23,51,12,47,20,10,11,1,87,89,1
6864,108497,FtVfxMAHOJCihrndIwrct9vQdb6Q44Wo,A3fsA9Zfv1X2fVEQhTw51lKENdNrEqT3,6,0,0,0,0,1,12,2,15,2.142857142857143,1,0.0,0,0,0,0,0,1,0,12,2,0,15,1
6865,108502,DfCpxv5XAI5uu8kT5xePLzsIgRboevuL,bWdj2GDclj5ofokWjzoa5jAwMkxCykd6,4,2,0,0,0,1,4,0,7,1.0,1,0.0,0,0,0,0,2,1,0,4,0,0,7,1
6866,108527,zbpyeHVfqJFGdhXASTaYNBrzQldiaNac,RXDvfPUBYFlVdlueBFbLW0mhhAyGEqpt,1,0,0,0,0,0,1,0,1,0.14285714285714285,1,0.0,0,0,0,0,0,0,0,1,0,0,1,1
6867,108530,vZzTgGwK0cR24BSm1xzdfANP52hj4iMk,SpATywNh6bZuzm8s1ceuBUnMUAeoAHHw,2,0,0,0,0,0,2,0,2,0.2857142857142857,1,0.0,0,0,0,0,0,0,0,2,0,0,2,1
6868,108537,CZVgFr3TEx4eVQgnanHCgaKUvWrCxqq0,bWdj2GDclj5ofokWjzoa5jAwMkxCykd6,1,0,0,0,0,0,1,0,1,0.14285714285714285,1,0.0,0,0,0,0,0,0,0,1,0,0,1,1
6869,108561,cJebZdZYNfcRFrDILULKtUjsVZucvQNZ,bWdj2GDclj5ofokWjzoa5jAwMkxCykd6,1,0,0,0,0,0,1,0,1,0.14285714285714285,1,0.0,0,0,0,0,0,0,0,1,0,0,1,1
6870,108566,ojqlaWuS8RKsQp5vm29IP0i1rlepDfW4,SpATywNh6bZuzm8s1ceuBUnMUAeoAHHw,9,7,3,0,1,0,5,0,16,2.2857142857142856,2,0.0,0,3,0,1,7,0,0,5,0,4,12,1
6871,108579,CppQWIoYRvNJi8vbZRpDyWKb0nwHtu8o,SpATywNh6bZuzm8s1ceuBUnMUAeoAHHw,8,9,3,0,1,0,3,0,16,2.2857142857142856,1,0.0,0,3,0,1,9,0,0,3,0,4,12,1
6872,108586,zGoXWftPbgMoerOVXBTD4diPBqy753pp,SpATywNh6bZuzm8s1ceuBUnMUAeoAHHw,14,16,8,11,0,2,10,1,48,6.857142857142857,2,0.0,4,8,10,0,12,2,1,10,1,22,26,1
6873,108588,anqtRE1JbVfWjk9aVYgpNXBcTCoFe9WO,RXDvfPUBYFlVdlueBFbLW0mhhAyGEqpt,1,0,0,0,0,0,2,0,2,0.2857142857142857,2,0.0,0,0,0,0,0,0,0,2,0,0,2,1
6874,108598,imxSDm2buzZ62mNMbQHQ2TU94JYpOhZs,A3fsA9Zfv1X2fVEQhTw51lKENdNrEqT3,2,0,0,0,0,0,2,0,2,0.2857142857142857,1,0.0,0,0,0,0,0,0,0,2,0,0,2,1
6875,108606,l1knNMDAAaNYCbUzngkK8zi8ibAxSEhp,SpATywNh6bZuzm8s1ceuBUnMUAeoAHHw,1,0,0,0,0,0,1,0,1,0.14285714285714285,1,0.0,0,0,0,0,0,0,0,1,0,0,1,1
6876,108614,QNTRCRLtlkIMOKaNSTyyYSuzmrMmUnRO,SpATywNh6bZuzm8s1ceuBUnMUAeoAHHw,11,12,1,17,0,0,2,0,32,4.571428571428571,1,0.0,2,1,14,0,10,0,3,2,0,17,15,1
6877,108616,9Em7ZIIQKauUvueNLPgAUpkXgxbNUW1r,A3fsA9Zfv1X2fVEQhTw51lKENdNrEqT3,16,17,7,0,6,0,6,0,36,5.142857142857143,1,0.0,0,7,0,6,17,0,0,6,0,13,23,1
6878,108620,5USBnLyMGXd4vW6kBwxN1Sg97co2qZq2,A3fsA9Zfv1X2fVEQhTw51lKENdNrEqT3,3,2,0,0,0,0,2,0,4,0.5714285714285714,1,0.0,0,0,0,0,2,0,0,2,0,0,4,1
6879,108622,QBPT1uwial7Y5XFWw81ordtuhoTMulQT,A3fsA9Zfv1X2fVEQhTw51lKENdNrEqT3,10,4,3,0,3,0,6,0,16,2.2857142857142856,1,0.0,0,3,0,3,4,0,0,6,0,6,10,1
6880,108623,vvgFtJK0OvK0nLiIcreYLk1PpU7Og3xn,A3fsA9Zfv1X2fVEQhTw51lKENdNrEqT3,6,1,1,0,1,0,5,0,8,1.1428571428571428,1,0.0,0,1,0,1,1,0,0,5,0,2,6,1
6881,108625,hi6YD0ZFgzDW7d6YNZOEVbYcZq8RBo6y,G8EPVSXsOYB5YQWZGiz1aVq5Pgr2GrQu,10,7,4,0,5,0,5,1,22,3.142857142857143,1,0.0,2,4,0,5,5,0,0,5,1,11,11,1
6882,108626,Pku6n7JNFwWSrlmN4ke1wEsgtvibhHUB,SpATywNh6bZuzm8s1ceuBUnMUAeoAHHw,7,4,1,0,1,0,3,0,9,1.2857142857142858,1,0.0,0,1,0,1,4,0,0,3,0,2,7,1
6883,108632,KCAa0nKBsiapAJL8hF3jy3WnrDUcaBRF,A3fsA9Zfv1X2fVEQhTw51lKENdNrEqT3,1,0,0,0,0,0,6,0,6,0.8571428571428571,1,0.0,0,0,0,0,0,0,0,6,0,0,6,1
6884,108646,WEWYd7NOLi6QToOgocTwXHUAGlncS3ka,A3fsA9Zfv1X2fVEQhTw51lKENdNrEqT3,6,7,1,0,1,0,3,0,12,1.7142857142857142,1,0.0,0,1,0,1,7,0,0,3,0,2,10,1
6885,108649,3R8N615p99BGAZXNRR4tu9I4dMAzyaYx,SpATywNh6bZuzm8s1ceuBUnMUAeoAHHw,10,6,6,0,6,0,3,0,21,3.0,1,0.0,0,6,0,6,6,0,0,3,0,12,9,1
6886,108651,LWFByRJk3azFmQgQM4UimOOGLsmXN342,A3fsA9Zfv1X2fVEQhTw51lKENdNrEqT3,1,0,0,0,0,0,3,0,3,0.42857142857142855,1,0.0,0,0,0,0,0,0,0,3,0,0,3,1
6887,108657,TxKyOi1lNIjE6GBf0G1VUEkgRaSNv5aU,bWdj2GDclj5ofokWjzoa5jAwMkxCykd6,5,2,1,0,1,0,2,0,6,0.8571428571428571,1,0.0,0,1,0,1,2,0,0,2,0,2,4,0
6888,108663,IVLYBILu5bsz4kc422I8sXYkTLjww3zh,SpATywNh6bZuzm8s1ceuBUnMUAeoAHHw,5,4,2,0,1,0,3,0,10,1.4285714285714286,1,0.0,0,2,0,1,4,0,0,3,0,3,7,1
6889,108666,wTFt4jd8Vf2XnbTwygw9m5uOggZGQW45,A3fsA9Zfv1X2fVEQhTw51lKENdNrEqT3,4,3,0,0,0,0,2,0,5,0.7142857142857143,1,0.0,0,0,0,0,3,0,0,2,0,0,5,1
6890,108671,uxgNKX0ZdDu87Z4mjH6KkxEGynnwur5T,A3fsA9Zfv1X2fVEQhTw51lKENdNrEqT3,3,4,0,0,0,0,2,0,6,0.8571428571428571,1,0.0,0,0,0,0,4,0,0,2,0,0,6,1
6891,108680,fihaFvHVK0WmjfjHHr8uDKIAQygBbKLV,A3fsA9Zfv1X2fVEQhTw51lKENdNrEqT3,1,0,0,0,0,0,1,0,1,0.14285714285714285,1,0.0,0,0,0,0,0,0,0,1,0,0,1,1
6892,108687,ABbPtVE9vR3q9TnGdVr0jhQS05eL9aJw,A3fsA9Zfv1X2fVEQhTw51lKENdNrEqT3,15,11,6,0,4,9,11,1,42,6.0,1,0.0,0,6,0,4,11,9,0,11,1,10,32,0
6893,108696,5Rbvag4nzKt7RfTqiThTliUWaR0ZVWak,bWdj2GDclj5ofokWjzoa5jAwMkxCykd6,14,23,13,22,8,4,11,1,82,11.714285714285714,1,0.0,7,13,21,8,16,4,1,11,1,49,33,1
6894,108697,6HIBebNSnNEoSeekVShzxF3x0IcbgohT,A3fsA9Zfv1X2fVEQhTw51lKENdNrEqT3,9,8,0,0,0,2,2,0,12,1.7142857142857142,1,0.0,1,0,0,0,7,2,0,2,0,1,11,1
6895,108708,5Rbvag4nzKt7RfTqiThTliUWaR0ZVWak,A3fsA9Zfv1X2fVEQhTw51lKENdNrEqT3,8,8,5,0,1,0,5,0,19,2.7142857142857144,1,0.0,2,5,0,1,6,0,0,5,0,8,11,1
6896,108719,WF6wuTvQFfQjN4sNbpLPNNaCItibHnsk,SpATywNh6bZuzm8s1ceuBUnMUAeoAHHw,5,2,1,0,1,0,2,0,6,0.8571428571428571,1,0.0,0,1,0,1,2,0,0,2,0,2,4,1
6897,108722,MSyG0cZLfbMN5GFb3dR5puqqT5uvCbhT,SpATywNh6bZuzm8s1ceuBUnMUAeoAHHw,6,1,1,0,1,0,3,0,6,0.8571428571428571,1,0.0,0,1,0,1,1,0,0,3,0,2,4,1
6898,108725,2qs5o4ShoJi8U8TmD1cNHDzshN8FK6oF,A3fsA9Zfv1X2fVEQhTw51lKENdNrEqT3,2,0,0,0,0,0,4,0,4,0.5714285714285714,1,0.0,0,0,0,0,0,0,0,4,0,0,4,1
6899,108728,I5y7gNrP5Yz8ZedoBMi3comUdlpFv5gJ,SpATywNh6bZuzm8s1ceuBUnMUAeoAHHw,3,2,0,0,0,0,1,0,3,0.42857142857142855,1,0.0,0,0,0,0,2,0,0,1,0,0,3,1
6900,108732,2Zhak41HpdUHgCzOLAuYT50kXg4d3Zji,G8EPVSXsOYB5YQWZGiz1aVq5Pgr2GrQu,5,2,1,0,1,0,2,0,6,0.8571428571428571,1,0.0,0,1,0,1,2,0,0,2,0,2,4,1
6901,108736,mFyBIO6GmLHqTEssxzuSwYKXW2BbEyYv,A3fsA9Zfv1X2fVEQhTw51lKENdNrEqT3,7,6,4,0,3,0,2,0,15,2.142857142857143,1,0.0,0,4,0,3,6,0,0,2,0,7,8,1
6902,108740,z8PlFZ3kRCGZCtReInG4syWyRUKvCeDo,RXDvfPUBYFlVdlueBFbLW0mhhAyGEqpt,58,72,3,147,16,1,8,1,248,35.42857142857143,2,0.0,40,3,140,16,32,1,7,8,1,199,49,0
6903,108741,8bMxud2pJnttNvsNwa7l9gc36Q1hRhIk,A3fsA9Zfv1X2fVEQhTw51lKENdNrEqT3,8,4,3,0,3,0,1,0,11,1.5714285714285714,1,0.0,0,3,0,3,4,0,0,1,0,6,5,1
6904,108748,ABbPtVE9vR3q9TnGdVr0jhQS05eL9aJw,bWdj2GDclj5ofokWjzoa5jAwMkxCykd6,6,2,1,0,1,0,3,0,7,1.0,1,0.0,0,1,0,1,2,0,0,3,0,2,5,1
6905,108756,h2bHu87wTYXhBBhcXbsLbNIYZ54rAZgt,A3fsA9Zfv1X2fVEQhTw51lKENdNrEqT3,45,38,27,84,19,7,14,1,190,27.142857142857142,1,0.0,4,27,74,19,34,7,10,14,1,124,66,1
6906,108765,wJC86gc3viBGM4vTuYg8647vhYAtlLLc,A3fsA9Zfv1X2fVEQhTw51lKENdNrEqT3,1,0,0,0,0,0,1,0,1,0.14285714285714285,1,0.0,0,0,0,0,0,0,0,1,0,0,1,1
6907,108766,sOb1oiy6NjSaiCXhGkHSqKHtlguCQRa0,A3fsA9Zfv1X2fVEQhTw51lKENdNrEqT3,1,0,0,0,0,0,1,0,1,0.14285714285714285,1,0.0,0,0,0,0,0,0,0,1,0,0,1,1
6908,108769,K1Izk0V4ksCL81zmOeuNNasAXwE95TLa,SpATywNh6bZuzm8s1ceuBUnMUAeoAHHw,1,0,0,0,0,0,2,0,2,0.2857142857142857,1,0.0,0,0,0,0,0,0,0,2,0,0,2,1
6909,108771,AvefCXcG5Ufaee9dlfNQnJvhOv3ejoZa,bWdj2GDclj5ofokWjzoa5jAwMkxCykd6,16,19,3,94,5,2,13,2,138,19.714285714285715,2,0.0,11,3,91,5,8,2,3,13,2,110,28,1
6910,108782,KdDp90RfX0ap0e8qJs31e2eGxlYje3er,A3fsA9Zfv1X2fVEQhTw51lKENdNrEqT3,41,31,14,96,10,0,8,0,159,22.714285714285715,2,0.0,3,14,83,10,28,0,13,8,0,110,49,1
6911,108786,ue5DigOvMG1l9Z3tvu2VwrvC8NR96FUy,SpATywNh6bZuzm8s1ceuBUnMUAeoAHHw,3,2,0,0,0,0,2,0,4,0.5714285714285714,1,0.0,0,0,0,0,2,0,0,2,0,0,4,1
6912,108787,x7jRdqJhx5ja6FBqxJnzxkapRPVQ2fNm,A3fsA9Zfv1X2fVEQhTw51lKENdNrEqT3,1,0,0,0,0,0,1,0,1,0.14285714285714285,1,0.0,0,0,0,0,0,0,0,1,0,0,1,1
6913,108789,AmjIDQe44ue5n1ufYmtWXDVGVMWDOkiz,A3fsA9Zfv1X2fVEQhTw51lKENdNrEqT3,3,3,0,0,0,0,1,0,4,0.5714285714285714,1,0.0,0,0,0,0,3,0,0,1,0,0,4,1
6914,108793,tn5nSlJLNdxx4Uni5Dn3S8nwDR8GJibq,A3fsA9Zfv1X2fVEQhTw51lKENdNrEqT3,14,7,5,0,3,1,7,1,24,3.4285714285714284,1,0.0,0,5,0,3,7,1,0,7,1,8,16,1
6915,108798,O12TpofOcB7jKUNGaL0IFXdieGzZ8DbW,SpATywNh6bZuzm8s1ceuBUnMUAeoAHHw,4,2,0,0,0,0,2,0,4,0.5714285714285714,1,0.0,0,0,0,0,2,0,0,2,0,0,4,1
6916,108799,J8izYPuHoJnyIb9qLV3GxLKVHOmNnyCQ,bWdj2GDclj5ofokWjzoa5jAwMkxCykd6,7,3,1,22,0,0,5,0,31,4.428571428571429,1,0.0,1,1,21,0,2,0,1,5,0,23,8,1
6917,108810,zcKuGtc5O9cMvHSHaVwufdFteCrEpUtA,A3fsA9Zfv1X2fVEQhTw51lKENdNrEqT3,69,43,25,164,16,37,11,0,296,42.285714285714285,4,0.0,3,25,138,16,40,37,26,11,0,182,114,1
6918,108835,NJrnUAVHenUfV0p23UPZO1ifAbb8gJ0p,SpATywNh6bZuzm8s1ceuBUnMUAeoAHHw,6,4,1,0,1,0,1,0,7,1.0,1,0.0,0,1,0,1,4,0,0,1,0,2,5,1
6919,108845,VBP5PzVQEKJYFH0y5ffEek5WfP9EW7uc,bWdj2GDclj5ofokWjzoa5jAwMkxCykd6,9,16,9,32,4,14,6,0,81,11.571428571428571,6,0.0,1,9,30,4,15,14,2,6,0,44,37,1
6920,108855,KQaABjEuQepl9FAcsVuUoYwnLleiOaUh,A3fsA9Zfv1X2fVEQhTw51lKENdNrEqT3,12,10,7,0,5,0,3,0,25,3.5714285714285716,1,0.0,0,7,0,5,10,0,0,3,0,12,13,1
6921,108856,AmiJtmcKc0Yc4REOzpITViIEZy1tcMgF,A3fsA9Zfv1X2fVEQhTw51lKENdNrEqT3,2,0,0,0,0,0,4,0,4,0.5714285714285714,1,0.0,0,0,0,0,0,0,0,4,0,0,4,1
6922,108857,XaYV3yff9o91oPBR4K32BeMm7Wg8wnLi,A3fsA9Zfv1X2fVEQhTw51lKENdNrEqT3,1,0,0,0,0,0,1,0,1,0.14285714285714285,1,0.0,0,0,0,0,0,0,0,1,0,0,1,1
6923,108869,4mtoRYC9jVVxEoNU8knjZ5oLeF7Lb02c,SpATywNh6bZuzm8s1ceuBUnMUAeoAHHw,5,8,0,0,0,0,2,0,10,1.4285714285714286,2,0.0,0,0,0,0,8,0,0,2,0,0,10,1
6924,108895,RGr3DE14hb7Ufb3qkxo2JnrYRs9POJfu,A3fsA9Zfv1X2fVEQhTw51lKENdNrEqT3,8,2,1,0,1,1,5,1,11,1.5714285714285714,1,0.0,0,1,0,1,2,1,0,5,1,2,9,1
6925,108904,5upQSO7J9z4uj80lVoIg3U6hUe3UwAJY,SpATywNh6bZuzm8s1ceuBUnMUAeoAHHw,2,0,0,0,0,0,2,0,2,0.2857142857142857,1,0.0,0,0,0,0,0,0,0,2,0,0,2,1
6926,108909,PIWGwmpuvT6lwwfSr4RWZP56tih9auMI,SpATywNh6bZuzm8s1ceuBUnMUAeoAHHw,8,5,1,0,1,0,3,0,10,1.4285714285714286,1,0.0,0,1,0,1,5,0,0,3,0,2,8,1
6927,108930,9vnJJcOjSmdwXe3BZQ5uEyhKgS7hqzyX,bWdj2GDclj5ofokWjzoa5jAwMkxCykd6,5,5,1,0,0,0,4,0,10,1.4285714285714286,1,0.0,0,1,0,0,5,0,0,4,0,1,9,1
6928,108946,xCHQAq5m2mtyQES4gfg6MjCHDUVD1J71,SpATywNh6bZuzm8s1ceuBUnMUAeoAHHw,6,7,1,0,0,0,2,0,10,1.4285714285714286,2,0.0,0,1,0,0,7,0,0,2,0,1,9,0
6929,108955,kLrl7hvNIzvhv6K321CFhgLYEgDfA62M,bWdj2GDclj5ofokWjzoa5jAwMkxCykd6,1,0,0,0,0,0,2,0,2,0.2857142857142857,1,0.0,0,0,0,0,0,0,0,2,0,0,2,1
6930,108960,g6loW2VoON94gkUidTjl3Rc73OlFLAiK,A3fsA9Zfv1X2fVEQhTw51lKENdNrEqT3,2,0,0,0,0,0,2,0,2,0.2857142857142857,1,0.0,0,0,0,0,0,0,0,2,0,0,2,0
6931,108961,xOpIfUll35xPHM6WEP4Czjw6kk2qoOGO,SpATywNh6bZuzm8s1ceuBUnMUAeoAHHw,5,7,4,0,3,0,4,0,18,2.5714285714285716,2,0.0,0,4,0,3,7,0,0,4,0,7,11,1
6932,108968,iRrv3nyo6BGr7ILpR2ahzmHKuzrYBh4I,SpATywNh6bZuzm8s1ceuBUnMUAeoAHHw,5,3,2,0,0,0,2,0,7,1.0,1,0.0,0,2,0,0,3,0,0,2,0,2,5,1
6933,108975,O5osNpvARQ134oncM7N5QGhst9sMjRtB,A3fsA9Zfv1X2fVEQhTw51lKENdNrEqT3,4,2,0,0,0,0,2,0,4,0.5714285714285714,1,0.0,0,0,0,0,2,0,0,2,0,0,4,1
6934,108989,i67qzouvUD7nINgK6d1xrH4pvufZqbFd,A3fsA9Zfv1X2fVEQhTw51lKENdNrEqT3,4,4,0,0,0,0,2,0,6,0.8571428571428571,1,0.0,0,0,0,0,4,0,0,2,0,0,6,0
6935,108990,OBplED2L50SmrdwVpOVn4VpcRjjudLK7,A3fsA9Zfv1X2fVEQhTw51lKENdNrEqT3,5,2,1,0,1,0,2,0,6,0.8571428571428571,1,0.0,0,1,0,1,2,0,0,2,0,2,4,1
6936,108993,SvKqfRpvSIeLIO42O4cF9tQtaigEgElY,A3fsA9Zfv1X2fVEQhTw51lKENdNrEqT3,7,6,2,0,2,0,2,0,12,1.7142857142857142,1,0.0,0,2,0,2,6,0,0,2,0,4,8,1
6937,108996,PhB6dZZRUCfcaCQkgFVOf4MMEPnUePaG,RXDvfPUBYFlVdlueBFbLW0mhhAyGEqpt,5,2,1,0,1,0,2,0,6,0.8571428571428571,1,0.0,0,1,0,1,2,0,0,2,0,2,4,1
6938,108999,3eJvDKkDryOUbJ3SYPy86iIynJcgnuci,SpATywNh6bZuzm8s1ceuBUnMUAeoAHHw,1,0,0,0,0,0,1,0,1,0.14285714285714285,1,0.0,0,0,0,0,0,0,0,1,0,0,1,1
6939,109002,qZCURwy8JtTyuwzOv8VNGZdlPKRFUQ4x,A3fsA9Zfv1X2fVEQhTw51lKENdNrEqT3,17,17,1,0,1,4,7,2,32,4.571428571428571,2,0.0,0,1,0,1,17,4,0,7,2,2,30,1
6940,109011,15KYq5P8DtSomIVrM0yWgXsvBsTL3cVz,A3fsA9Zfv1X2fVEQhTw51lKENdNrEqT3,9,5,4,0,4,0,3,0,16,2.2857142857142856,2,0.0,0,4,0,4,5,0,0,3,0,8,8,1
6941,109016,tJDZI9sjRcU2ZrvrdL12AwFT0OmQXIcr,A3fsA9Zfv1X2fVEQhTw51lKENdNrEqT3,5,2,1,0,1,0,4,0,8,1.1428571428571428,1,0.0,0,1,0,1,2,0,0,4,0,2,6,1
6942,109022,uJIh67cllxQLgAhipzdDZMEunDbuBxvF,bWdj2GDclj5ofokWjzoa5jAwMkxCykd6,1,0,0,0,0,0,1,0,1,0.14285714285714285,1,0.0,0,0,0,0,0,0,0,1,0,0,1,1
6943,109028,A1lWOqwgNzPh9AvybgvSnK3H60XpyG9J,SpATywNh6bZuzm8s1ceuBUnMUAeoAHHw,7,6,3,0,0,0,4,0,13,1.8571428571428572,1,0.0,2,3,0,0,4,0,0,4,0,5,8,1
6944,109035,qM8kx4xeCdgN7CQ3kDBj5MRznS4QMkrQ,G8EPVSXsOYB5YQWZGiz1aVq5Pgr2GrQu,1,0,0,0,0,0,1,0,1,0.14285714285714285,1,0.0,0,0,0,0,0,0,0,1,0,0,1,1
6945,109037,uCruZPKaQ2OyzLHOvqZfPPePv6wmtjTT,A3fsA9Zfv1X2fVEQhTw51lKENdNrEqT3,10,7,4,0,3,0,1,0,15,2.142857142857143,1,0.0,0,4,0,3,7,0,0,1,0,7,8,1
6946,109039,9RkNm8sDHM1l6EQFg0Uccrj0rG6zyU2p,A3fsA9Zfv1X2fVEQhTw51lKENdNrEqT3,18,13,0,32,0,0,2,0,47,6.714285714285714,1,0.0,2,0,29,0,11,0,3,2,0,31,16,1
6947,109047,JzBkQb66RlGvGZ9KheszqpvjIwSLUPa9,A3fsA9Zfv1X2fVEQhTw51lKENdNrEqT3,34,36,0,88,0,0,14,0,138,19.714285714285715,1,0.0,19,0,78,0,17,0,10,14,0,97,41,1
6948,109054,ay6BDjRoukNNZyMRT5YgyV5vrEPJDpPO,SpATywNh6bZuzm8s1ceuBUnMUAeoAHHw,8,9,6,0,4,1,5,0,25,3.5714285714285716,2,0.0,0,6,0,4,9,1,0,5,0,10,15,1
6949,109057,6UqKKdBhJ7OhJUUsVD1NV7GupMYMaBeb,RXDvfPUBYFlVdlueBFbLW0mhhAyGEqpt,15,12,8,0,6,0,3,0,29,4.142857142857143,1,0.0,0,8,0,6,12,0,0,3,0,14,15,1
6950,109059,i7lWxTot2xX5tUsFMkvVZL9ZWUCuO03L,A3fsA9Zfv1X2fVEQhTw51lKENdNrEqT3,11,9,4,0,1,1,7,2,24,3.4285714285714284,1,0.0,0,4,0,1,9,1,0,7,2,5,19,1
6951,109069,7JTB4CyOxMIYiscUQS5N24z40QJDU2NG,SpATywNh6bZuzm8s1ceuBUnMUAeoAHHw,13,13,8,7,5,0,5,0,38,5.428571428571429,2,0.0,0,8,6,5,13,0,1,5,0,19,19,1
6952,109074,3Q4BnqdcagQPfwKNQquFMuffhZmA481O,A3fsA9Zfv1X2fVEQhTw51lKENdNrEqT3,43,29,21,100,10,28,17,1,206,29.428571428571427,4,0.0,1,21,91,10,28,28,9,17,1,123,83,0
6953,109084,CJj1ly3IvknwPjPwTtDbF1Ndj6DLlK2p,A3fsA9Zfv1X2fVEQhTw51lKENdNrEqT3,1,0,0,0,0,0,1,0,1,0.14285714285714285,1,0.0,0,0,0,0,0,0,0,1,0,0,1,1
6954,109093,SSeq3zqfD5kMUB9gUKp0rdzGfihYMJi7,bWdj2GDclj5ofokWjzoa5jAwMkxCykd6,8,16,4,32,1,0,3,0,56,8.0,1,0.0,5,4,31,1,11,0,1,3,0,41,15,1
6955,109110,GqdYzH9IQjNV4Qw4poxGmkYlIXbhf40S,A3fsA9Zfv1X2fVEQhTw51lKENdNrEqT3,42,41,14,56,9,6,10,1,137,19.571428571428573,2,0.0,4,14,49,9,37,6,7,10,1,76,61,1
6956,109111,AQdHyQtscAI4B6OA1EdXFLllqKFEoazm,SpATywNh6bZuzm8s1ceuBUnMUAeoAHHw,5,2,1,0,1,0,2,0,6,0.8571428571428571,1,0.0,0,1,0,1,2,0,0,2,0,2,4,1
6957,109119,5bxm8iejKGaSX6YQr0TZiikGC5f5Uall,A3fsA9Zfv1X2fVEQhTw51lKENdNrEqT3,2,0,0,0,0,0,2,0,2,0.2857142857142857,1,0.0,0,0,0,0,0,0,0,2,0,0,2,1
6958,109122,Z9o0wypJqquui2I9MOTdTYh5ZR4U4MfH,A3fsA9Zfv1X2fVEQhTw51lKENdNrEqT3,7,3,0,0,0,0,5,0,8,1.1428571428571428,1,0.0,0,0,0,0,3,0,0,5,0,0,8,1
6959,109127,hIXeM0yyb6wIxVNnB5ijRV2LpcYBbrLW,bWdj2GDclj5ofokWjzoa5jAwMkxCykd6,1,0,0,0,0,0,1,0,1,0.14285714285714285,1,0.0,0,0,0,0,0,0,0,1,0,0,1,1
6960,109128,lvcfwg5xu40SCJNanQ0x3P780n9BnCrh,SpATywNh6bZuzm8s1ceuBUnMUAeoAHHw,5,2,1,0,1,0,2,0,6,0.8571428571428571,1,0.0,0,1,0,1,2,0,0,2,0,2,4,1
6961,109131,WixZusYrasZzR9owXlaQpXrbIZeJOheR,G8EPVSXsOYB5YQWZGiz1aVq5Pgr2GrQu,1,0,0,0,0,0,1,0,1,0.14285714285714285,1,0.0,0,0,0,0,0,0,0,1,0,0,1,1
6962,109132,ZVmjT1rppq7ilCPRRtmAl1wo0gOugsCt,A3fsA9Zfv1X2fVEQhTw51lKENdNrEqT3,43,26,21,66,16,2,7,4,142,20.285714285714285,3,0.0,2,21,58,16,24,2,8,7,4,97,45,1
6963,109136,oqLAJu8zdqUr5XPQYn4bKVmvqSIRanjc,A3fsA9Zfv1X2fVEQhTw51lKENdNrEqT3,1,0,0,0,0,0,1,0,1,0.14285714285714285,1,0.0,0,0,0,0,0,0,0,1,0,0,1,1
6964,109147,yM4AD5P6cznT9ej6JMMHXYh7GR0LcYuh,RXDvfPUBYFlVdlueBFbLW0mhhAyGEqpt,5,2,1,0,1,0,2,0,6,0.8571428571428571,1,0.0,0,1,0,1,2,0,0,2,0,2,4,0
6965,109169,7OAz0qWJXAI5T9rA3xczkfKNiBaKS5xD,A3fsA9Zfv1X2fVEQhTw51lKENdNrEqT3,5,2,1,0,1,0,3,0,7,1.0,1,0.0,0,1,0,1,2,0,0,3,0,2,5,1
6966,109181,YGxQDme0yci5ICjRYEy6Me4N0nnZ0g9H,SpATywNh6bZuzm8s1ceuBUnMUAeoAHHw,4,4,0,0,0,0,1,0,5,0.7142857142857143,1,0.0,0,0,0,0,4,0,0,1,0,0,5,1
6967,109182,QF5cQIRzKp7h2VSkoGej2U04awk99fmw,bWdj2GDclj5ofokWjzoa5jAwMkxCykd6,12,10,6,38,4,1,2,0,61,8.714285714285714,1,0.0,3,6,33,4,7,1,5,2,0,46,15,1
6968,109186,5kEshmgSAUGvBEOsnsKU8IViB0lkOwoD,A3fsA9Zfv1X2fVEQhTw51lKENdNrEqT3,23,4,0,94,0,0,2,0,100,14.285714285714286,1,0.0,1,0,78,0,3,0,16,2,0,79,21,1
6969,109189,eb3mqqeSvUWzy1wBijQrenro4Nhum9Na,SpATywNh6bZuzm8s1ceuBUnMUAeoAHHw,5,2,1,0,1,0,2,0,6,0.8571428571428571,1,0.0,0,1,0,1,2,0,0,2,0,2,4,1
6970,109191,Wigd4PnyDnjfDcFOxsTBcEnXo7kl9GSg,A3fsA9Zfv1X2fVEQhTw51lKENdNrEqT3,16,35,12,0,5,0,5,0,57,8.142857142857142,2,0.0,0,12,0,5,35,0,0,5,0,17,40,1
6971,109193,SclrH2608f72JlTtkBQ5xWQXCuDyyco3,A3fsA9Zfv1X2fVEQhTw51lKENdNrEqT3,62,24,17,176,10,3,15,0,245,35.0,5,0.0,2,17,155,10,22,3,21,15,0,184,61,0
6972,109195,1Gv11nS0XCuxdjw8VOmeY5aEETIaIhPq,A3fsA9Zfv1X2fVEQhTw51lKENdNrEqT3,9,7,4,0,3,0,2,0,16,2.2857142857142856,1,0.0,0,4,0,3,7,0,0,2,0,7,9,1
6973,109196,dUvs72HAR74VSIdDk98Za5hbojuIxWU6,A3fsA9Zfv1X2fVEQhTw51lKENdNrEqT3,7,5,1,6,0,0,1,0,13,1.8571428571428572,1,0.0,0,1,5,0,5,0,1,1,0,6,7,1
6974,109211,qGqiGKt8aL9OJtRSM5jpSwytmMiScrIj,SpATywNh6bZuzm8s1ceuBUnMUAeoAHHw,4,3,1,0,1,0,1,0,6,0.8571428571428571,1,0.0,0,1,0,1,3,0,0,1,0,2,4,1
6975,109231,eBgUh4wTe9cxKEwDUzWCU7PVyq9kVzKO,RXDvfPUBYFlVdlueBFbLW0mhhAyGEqpt,1,0,0,0,0,0,1,0,1,0.14285714285714285,1,0.0,0,0,0,0,0,0,0,1,0,0,1,1
6976,109241,XuNt1i5t4SR1AjDP4UHvsoux0R9qVf5C,SpATywNh6bZuzm8s1ceuBUnMUAeoAHHw,13,8,4,9,3,0,2,0,26,3.7142857142857144,1,0.0,3,4,9,3,5,0,0,2,0,19,7,1
6977,109250,eS5XywA64oauZkENyWLpeVNsSbZFhj1k,A3fsA9Zfv1X2fVEQhTw51lKENdNrEqT3,4,2,1,0,1,0,1,0,5,0.7142857142857143,1,0.0,0,1,0,1,2,0,0,1,0,2,3,1
6978,109252,urSFKVbpyaFPrDJOmPVaNjyfC2aA3KOx,SpATywNh6bZuzm8s1ceuBUnMUAeoAHHw,9,10,3,0,2,0,10,0,25,3.5714285714285716,2,0.0,0,3,0,2,10,0,0,10,0,5,20,1
6979,109256,FHrj4N2SCEsxza13qmFjgJkCjs8BkrF3,A3fsA9Zfv1X2fVEQhTw51lKENdNrEqT3,1,0,0,0,0,0,1,0,1,0.14285714285714285,1,0.0,0,0,0,0,0,0,0,1,0,0,1,1
6980,109272,BLoa1RvSOgexbSH4hGzCihmBc8pXd0Db,SpATywNh6bZuzm8s1ceuBUnMUAeoAHHw,14,26,3,0,2,11,13,1,56,8.0,4,0.0,4,3,0,2,22,11,0,13,1,9,47,1
6981,109278,fsmpK8LD6WXenVxwQRsdTaVF7iZvaL2a,A3fsA9Zfv1X2fVEQhTw51lKENdNrEqT3,24,31,17,21,9,10,12,1,101,14.428571428571429,2,0.0,0,17,17,9,31,10,4,12,1,43,58,0
6982,109279,Y5EybULOrY5dAmMMQWE7bK5wg4bsR2Lr,A3fsA9Zfv1X2fVEQhTw51lKENdNrEqT3,26,32,21,0,9,46,13,2,123,17.571428571428573,1,0.0,0,21,0,9,32,46,0,13,2,30,93,1
6983,109281,MFZvBtjHJjKdCSK87D1kJEMGtcPTGn4S,A3fsA9Zfv1X2fVEQhTw51lKENdNrEqT3,13,14,1,0,0,9,17,2,43,6.142857142857143,4,0.0,1,1,0,0,13,9,0,17,2,2,41,1
6984,109284,wbX1noywm1bmZy8t47H8TCRwxZP7RsKK,A3fsA9Zfv1X2fVEQhTw51lKENdNrEqT3,1,0,0,0,0,0,1,0,1,0.14285714285714285,1,0.0,0,0,0,0,0,0,0,1,0,0,1,1
6985,109290,A7LjkAd6Hsm6pjjO6SeIGFgQk6AkrU13,A3fsA9Zfv1X2fVEQhTw51lKENdNrEqT3,2,0,0,0,0,0,2,0,2,0.2857142857142857,1,0.0,0,0,0,0,0,0,0,2,0,0,2,1
6986,109297,VHpS9hAicdnMqh79M7ktVNQGD7RUDs6Y,SpATywNh6bZuzm8s1ceuBUnMUAeoAHHw,1,0,0,0,0,0,1,0,1,0.14285714285714285,1,0.0,0,0,0,0,0,0,0,1,0,0,1,1
6987,109304,xIuSJsusLSQAfSXoNCyoYjZ56tZodncr,bWdj2GDclj5ofokWjzoa5jAwMkxCykd6,1,0,0,0,0,0,1,0,1,0.14285714285714285,1,0.0,0,0,0,0,0,0,0,1,0,0,1,1
6988,109312,XyoP35cBUiKk44G72mbtEXCBjk8FmHfo,RXDvfPUBYFlVdlueBFbLW0mhhAyGEqpt,25,17,11,40,5,0,6,0,79,11.285714285714286,2,0.0,4,11,37,5,13,0,3,6,0,57,22,1
6989,109317,3MhfBeZhIT9AL4Tb9CZUr8w3WzrKSn3o,A3fsA9Zfv1X2fVEQhTw51lKENdNrEqT3,3,1,0,0,0,0,4,0,5,0.7142857142857143,1,0.0,0,0,0,0,1,0,0,4,0,0,5,1
6990,109318,2kGHpLQ025yq85EhWUzksnj6YbPuOHOR,bWdj2GDclj5ofokWjzoa5jAwMkxCykd6,1,0,0,0,0,0,1,0,1,0.14285714285714285,1,0.0,0,0,0,0,0,0,0,1,0,0,1,1
6991,109319,Xv6VsjsdEll9lNbT4VRN24UmJx0y2b5E,SpATywNh6bZuzm8s1ceuBUnMUAeoAHHw,1,0,0,0,0,0,1,0,1,0.14285714285714285,1,0.0,0,0,0,0,0,0,0,1,0,0,1,1
6992,109328,1hnXgqUJOPkoCUYTmndUozE0mj3w5YNX,A3fsA9Zfv1X2fVEQhTw51lKENdNrEqT3,4,2,1,0,1,0,2,0,6,0.8571428571428571,1,0.0,0,1,0,1,2,0,0,2,0,2,4,1
6993,109344,zhiAnt6m0h6AhsgVFkvjzbntxyU6BMtY,A3fsA9Zfv1X2fVEQhTw51lKENdNrEqT3,7,3,2,0,2,0,3,1,11,1.5714285714285714,1,0.0,0,2,0,2,3,0,0,3,1,4,7,1
6994,109345,yjSLpu9rXQ5LHtGm8PnDgnJW6R5BYmgU,A3fsA9Zfv1X2fVEQhTw51lKENdNrEqT3,9,7,0,0,0,0,3,0,10,1.4285714285714286,1,0.0,1,0,0,0,6,0,0,3,0,1,9,1
6995,109346,m5W0Hr8czUb20VBRzQ0jvBI30TuPU4RJ,G8EPVSXsOYB5YQWZGiz1aVq5Pgr2GrQu,6,0,0,0,0,2,6,1,9,1.2857142857142858,1,0.0,0,0,0,0,0,2,0,6,1,0,9,1
6996,109359,G5JFEd58i47FiqQxatEMibk5NL9uoQb2,A3fsA9Zfv1X2fVEQhTw51lKENdNrEqT3,3,3,1,0,0,0,1,0,5,0.7142857142857143,1,0.0,0,1,0,0,3,0,0,1,0,1,4,1
6997,109374,Tpf1XLLzVEPyFa0H95Pm3DK4tc3XDhko,G8EPVSXsOYB5YQWZGiz1aVq5Pgr2GrQu,1,0,0,0,0,0,1,0,1,0.14285714285714285,1,0.0,0,0,0,0,0,0,0,1,0,0,1,1
6998,109376,Sqh5jl1ru6WQiSCN47rLyyyFSF0wkiCq,SpATywNh6bZuzm8s1ceuBUnMUAeoAHHw,6,9,0,0,0,0,2,0,11,1.5714285714285714,1,0.0,0,0,0,0,9,0,0,2,0,0,11,1
6999,109383,gbm2CIpey5BIwuF4GxSVVzkrIqxOpVxg,A3fsA9Zfv1X2fVEQhTw51lKENdNrEqT3,41,36,25,52,19,6,12,1,151,21.571428571428573,3,0.0,3,25,44,19,33,6,8,12,1,91,60,1
7000,109394,Gbu6u21HudOCm7T5rLfdumNquubs5EJ1,SpATywNh6bZuzm8s1ceuBUnMUAeoAHHw,1,0,0,0,0,0,1,0,1,0.14285714285714285,1,0.0,0,0,0,0,0,0,0,1,0,0,1,1
7001,109402,r9Iw8qv5Gd0slmKCVr3aUz7TALROG0cf,A3fsA9Zfv1X2fVEQhTw51lKENdNrEqT3,11,4,3,0,3,1,7,1,19,2.7142857142857144,1,0.0,0,3,0,3,4,1,0,7,1,6,13,1
7002,109403,RJ2AN96oZxuBCR52LgUmQpj4g9Y4mcD4,bWdj2GDclj5ofokWjzoa5jAwMkxCykd6,16,20,12,16,3,1,6,0,58,8.285714285714286,2,0.0,2,12,16,3,18,1,0,6,0,33,25,0
7003,109417,7T8zBGfQI7GmUNFouD9u4M8LhrQmKX66,RXDvfPUBYFlVdlueBFbLW0mhhAyGEqpt,1,0,0,0,0,0,1,0,1,0.14285714285714285,1,0.0,0,0,0,0,0,0,0,1,0,0,1,1
7004,109420,SPTliKTsT7X2iG2wvNL5AHdQ10rMJVZH,SpATywNh6bZuzm8s1ceuBUnMUAeoAHHw,6,4,1,0,1,0,5,0,11,1.5714285714285714,2,0.0,0,1,0,1,4,0,0,5,0,2,9,1
7005,109439,On26vSCnXPxlOaC4mCdb6AzdACXRPBhk,G8EPVSXsOYB5YQWZGiz1aVq5Pgr2GrQu,5,2,1,0,1,0,2,0,6,0.8571428571428571,1,0.0,0,1,0,1,2,0,0,2,0,2,4,1
7006,109443,7M6n6JJz8OT4WvASBJlRAyi4sCwcAzru,A3fsA9Zfv1X2fVEQhTw51lKENdNrEqT3,8,5,4,0,4,0,1,0,14,2.0,1,0.0,0,4,0,4,5,0,0,1,0,8,6,1
7007,109445,bwOsVB833e5tHrwHSqmXCzs0EZClNPpv,A3fsA9Zfv1X2fVEQhTw51lKENdNrEqT3,1,0,0,0,0,0,1,0,1,0.14285714285714285,1,0.0,0,0,0,0,0,0,0,1,0,0,1,1
7008,109451,JbJKnENXbd4D9YGrXPdV81P48WObl8vL,SpATywNh6bZuzm8s1ceuBUnMUAeoAHHw,6,7,0,0,0,0,7,0,14,2.0,1,0.0,0,0,0,0,7,0,0,7,0,0,14,1
7009,109454,xvNZbY8RiapNT0qosUHeJFlEtqfPfVcr,SpATywNh6bZuzm8s1ceuBUnMUAeoAHHw,14,11,6,12,4,0,4,0,37,5.285714285714286,2,0.0,3,6,11,4,8,0,1,4,0,24,13,1
7010,109455,MCvvcTb9wFwriBgKb49jcCFeKRdTXM9j,A3fsA9Zfv1X2fVEQhTw51lKENdNrEqT3,5,2,1,0,1,0,4,0,8,1.1428571428571428,2,0.0,0,1,0,1,2,0,0,4,0,2,6,1
7011,109475,RNh4yH9mZXB6eTgcXXcHwrIgY95Sp0W7,A3fsA9Zfv1X2fVEQhTw51lKENdNrEqT3,7,6,1,0,1,0,1,0,9,1.2857142857142858,1,0.0,0,1,0,1,6,0,0,1,0,2,7,1
7012,109477,7Cs0Abzd0FS9IIdr1A12WVGDozLYcxYb,SpATywNh6bZuzm8s1ceuBUnMUAeoAHHw,1,0,0,0,0,0,1,0,1,0.14285714285714285,1,0.0,0,0,0,0,0,0,0,1,0,0,1,1
7013,109482,ZwZ9L46oJNtj9fhgH7VsyHRiEXY9tnmd,G8EPVSXsOYB5YQWZGiz1aVq5Pgr2GrQu,5,3,1,0,1,0,3,0,8,1.1428571428571428,1,0.0,0,1,0,1,3,0,0,3,0,2,6,1
7014,109484,pdp70UYWh5otKyx4vGTfJaBVRuSZsd0M,SpATywNh6bZuzm8s1ceuBUnMUAeoAHHw,6,2,1,0,1,2,5,0,11,1.5714285714285714,1,0.0,0,1,0,1,2,2,0,5,0,2,9,1
7015,109493,kajklFKczHkuBeWWHTIA518Xzi7jmX3b,A3fsA9Zfv1X2fVEQhTw51lKENdNrEqT3,11,9,1,0,1,6,7,2,26,3.7142857142857144,1,0.0,0,1,0,1,9,6,0,7,2,2,24,1
7016,109503,IoDMPccLVuoP1kfQwv1qzxHOaDwHWJ1B,RXDvfPUBYFlVdlueBFbLW0mhhAyGEqpt,17,15,11,0,6,0,13,0,45,6.428571428571429,2,0.0,0,11,0,6,15,0,0,13,0,17,28,1
7017,109510,xHqnmrHdKLDxnJRARDHa2hpY45Zdt2kb,A3fsA9Zfv1X2fVEQhTw51lKENdNrEqT3,3,2,0,0,0,0,1,0,3,0.42857142857142855,1,0.0,0,0,0,0,2,0,0,1,0,0,3,1
7018,109514,KpYtE2oiCacGgvHDiOR9EPHvEG8K5VAH,bWdj2GDclj5ofokWjzoa5jAwMkxCykd6,6,4,2,0,0,0,4,0,10,1.4285714285714286,2,0.0,0,2,0,0,4,0,0,4,0,2,8,1
7019,109517,EEukb1HtBZxlb0jW8bNwwOHInCYodyW7,bWdj2GDclj5ofokWjzoa5jAwMkxCykd6,1,0,0,0,0,0,1,0,1,0.14285714285714285,1,0.0,0,0,0,0,0,0,0,1,0,0,1,1
7020,109523,qYbhiF3nJ95ttwkxqyX4iKZXAQTXvtdJ,G8EPVSXsOYB5YQWZGiz1aVq5Pgr2GrQu,1,0,0,0,0,0,1,0,1,0.14285714285714285,1,0.0,0,0,0,0,0,0,0,1,0,0,1,1
7021,109527,e0jCfTT6aDMNOYEB4iNXcTbrqQiVpXOZ,bWdj2GDclj5ofokWjzoa5jAwMkxCykd6,1,0,0,0,0,0,1,0,1,0.14285714285714285,1,0.0,0,0,0,0,0,0,0,1,0,0,1,1
7022,109533,7Cs0Abzd0FS9IIdr1A12WVGDozLYcxYb,bWdj2GDclj5ofokWjzoa5jAwMkxCykd6,2,0,0,0,0,0,2,0,2,0.2857142857142857,1,0.0,0,0,0,0,0,0,0,2,0,0,2,1
7023,109537,F5SjzrcjsAWqSZbt6NDh8MAkDqWpXhkX,SpATywNh6bZuzm8s1ceuBUnMUAeoAHHw,25,38,16,24,9,1,5,0,93,13.285714285714286,2,0.0,19,16,22,9,19,1,2,5,0,66,27,1
7024,109547,R2rZMVSlSMqKi5RYuPtRmvScbhOABzyG,SpATywNh6bZuzm8s1ceuBUnMUAeoAHHw,8,5,0,0,1,0,3,0,9,1.2857142857142858,1,0.0,0,0,0,1,5,0,0,3,0,1,8,1
7025,109548,sXsJQIq7yfhUcvdfsv1TB75YziTHrdKC,SpATywNh6bZuzm8s1ceuBUnMUAeoAHHw,1,0,0,0,0,0,1,0,1,0.14285714285714285,1,0.0,0,0,0,0,0,0,0,1,0,0,1,1
7026,109549,rHrqDHLlL0apyY3RByvtRvQofhL6Brvn,A3fsA9Zfv1X2fVEQhTw51lKENdNrEqT3,8,8,0,0,0,4,5,0,17,2.4285714285714284,1,0.0,0,0,0,0,8,4,0,5,0,0,17,1
7027,109555,Cv1aavObJnuABKfipF6OGePzg0BnGPFs,G8EPVSXsOYB5YQWZGiz1aVq5Pgr2GrQu,26,4,3,106,0,0,8,0,121,17.285714285714285,2,0.0,1,3,91,0,3,0,15,8,0,95,26,1
7028,109569,XTOZBwO5vG1hcHef4AbuiTP7iSg27hS9,A3fsA9Zfv1X2fVEQhTw51lKENdNrEqT3,37,24,2,68,1,0,10,0,105,15.0,2,0.0,2,2,59,1,22,0,9,10,0,64,41,1
7029,109570,ZGw6EJB3cHSkZVviqnd0VnyCd0Hz7wva,SpATywNh6bZuzm8s1ceuBUnMUAeoAHHw,15,12,6,12,2,2,4,1,39,5.571428571428571,1,0.0,4,6,12,2,8,2,0,4,1,24,15,1
7030,109578,QYVRHTpooyTkzSbIywJ7ri5o4t73Xwty,G8EPVSXsOYB5YQWZGiz1aVq5Pgr2GrQu,1,0,0,0,0,0,1,0,1,0.14285714285714285,1,0.0,0,0,0,0,0,0,0,1,0,0,1,1
7031,109585,MF5edVvM6lCZDxnMdHelos9TUh3KERjn,bWdj2GDclj5ofokWjzoa5jAwMkxCykd6,4,2,1,0,1,0,1,0,5,0.7142857142857143,1,0.0,0,1,0,1,2,0,0,1,0,2,3,0
7032,109590,fsmpK8LD6WXenVxwQRsdTaVF7iZvaL2a,RXDvfPUBYFlVdlueBFbLW0mhhAyGEqpt,5,2,1,0,1,0,2,0,6,0.8571428571428571,1,0.0,0,1,0,1,2,0,0,2,0,2,4,0
7033,109591,Lo69R5WSRDc62Oqnj9VlNFkaC1RUwhyo,G8EPVSXsOYB5YQWZGiz1aVq5Pgr2GrQu,8,6,2,0,2,0,3,1,14,2.0,1,0.0,3,2,0,2,3,0,0,3,1,7,7,1
7034,109601,800D5qwHCt3Ko9pzEVC49paGCt6dYzm8,A3fsA9Zfv1X2fVEQhTw51lKENdNrEqT3,5,4,2,0,1,0,3,0,10,1.4285714285714286,1,0.0,0,2,0,1,4,0,0,3,0,3,7,1
7035,109607,6YbtihuLKjD5ARAIowoJ3OQ962AhWkN5,A3fsA9Zfv1X2fVEQhTw51lKENdNrEqT3,5,3,1,0,1,0,2,0,7,1.0,1,0.0,0,1,0,1,3,0,0,2,0,2,5,1
7036,109614,cu1UzrL4copIEW9h08HrvzOBVJhdKzoe,SpATywNh6bZuzm8s1ceuBUnMUAeoAHHw,7,2,1,0,1,0,7,2,13,1.8571428571428572,1,0.0,0,1,0,1,2,0,0,7,2,2,11,1
7037,109621,dpYSVisiS2cUJnMBorcbHAtUmvFhsmWA,bWdj2GDclj5ofokWjzoa5jAwMkxCykd6,7,1,1,0,1,0,7,0,10,1.4285714285714286,1,0.0,0,1,0,1,1,0,0,7,0,2,8,1
7038,109631,ol7Qu6IbbqCzG4dmk5UYJtqKBH41uMvQ,SpATywNh6bZuzm8s1ceuBUnMUAeoAHHw,10,7,5,5,4,0,2,0,23,3.2857142857142856,1,0.0,1,5,4,4,6,0,1,2,0,14,9,1
7039,109642,JsgxGxJYDhwgnBgYbCILUrGTg0zFV4WJ,SpATywNh6bZuzm8s1ceuBUnMUAeoAHHw,12,9,8,6,4,0,2,0,29,4.142857142857143,1,0.0,0,8,5,4,9,0,1,2,0,17,12,1
7040,109647,jHKRHkwov2ldu5B5B6LxfeJx9Okiy1xa,G8EPVSXsOYB5YQWZGiz1aVq5Pgr2GrQu,10,14,5,0,5,0,6,1,31,4.428571428571429,1,0.0,7,5,0,5,7,0,0,6,1,17,14,1
7041,109651,9JqGpnHdkbKBOmcT3LmREcuqxduizBra,SpATywNh6bZuzm8s1ceuBUnMUAeoAHHw,17,36,18,21,5,43,18,2,143,20.428571428571427,4,0.0,8,18,18,5,28,43,3,18,2,49,94,1
7042,109655,rfK1l9cGasJW2YfHTqaTiWeJHGoMfxaD,G8EPVSXsOYB5YQWZGiz1aVq5Pgr2GrQu,9,8,1,0,1,0,3,0,13,1.8571428571428572,1,0.0,2,1,0,1,6,0,0,3,0,4,9,1
7043,109664,SzAtQzNOap38B7fNAidQGz1HfRyu6YSS,A3fsA9Zfv1X2fVEQhTw51lKENdNrEqT3,41,24,15,68,10,0,17,0,134,19.142857142857142,2,0.0,6,15,56,10,18,0,12,17,0,87,47,1
7044,109678,PxrASHNEh6iqdpy6HawW3zGbUAupdzGr,G8EPVSXsOYB5YQWZGiz1aVq5Pgr2GrQu,6,1,1,0,1,0,5,0,8,1.1428571428571428,1,0.0,0,1,0,1,1,0,0,5,0,2,6,1
7045,109679,Dpj1ute7yeokptEET2ZfYuubDiXNwLXm,bWdj2GDclj5ofokWjzoa5jAwMkxCykd6,7,11,7,0,3,0,3,0,24,3.4285714285714284,2,0.0,0,7,0,3,11,0,0,3,0,10,14,1
7046,109680,yesikXRZpFYEGoXWRi2rEHboJsFyCCGG,A3fsA9Zfv1X2fVEQhTw51lKENdNrEqT3,4,2,1,0,1,0,1,0,5,0.7142857142857143,1,0.0,0,1,0,1,2,0,0,1,0,2,3,1
7047,109682,HYMxLb0qNi7DvNLdn0aBxzsZewAG7tgU,SpATywNh6bZuzm8s1ceuBUnMUAeoAHHw,1,0,0,0,0,0,1,0,1,0.14285714285714285,1,0.0,0,0,0,0,0,0,0,1,0,0,1,1
7048,109695,3o4QanEzrLxU7IR8E0SkDLt6uwLmz5BV,SpATywNh6bZuzm8s1ceuBUnMUAeoAHHw,1,0,0,0,0,0,1,0,1,0.14285714285714285,1,0.0,0,0,0,0,0,0,0,1,0,0,1,1
7049,109702,eO5PxtKBgjWgF4Rm51wpAuHgGsQTJyoc,G8EPVSXsOYB5YQWZGiz1aVq5Pgr2GrQu,9,4,3,0,3,0,2,0,12,1.7142857142857142,1,0.0,0,3,0,3,4,0,0,2,0,6,6,1
7050,109705,HMYpimZGFgj5IczDutkfjUfnxl45PoHW,A3fsA9Zfv1X2fVEQhTw51lKENdNrEqT3,45,33,21,50,11,32,15,0,162,23.142857142857142,4,0.0,4,21,47,11,29,32,3,15,0,83,79,1
7051,109708,nPYAQvL2RWwzE56jCZxlu4AvBduWOQxo,SpATywNh6bZuzm8s1ceuBUnMUAeoAHHw,4,2,1,0,1,0,2,0,6,0.8571428571428571,1,0.0,0,1,0,1,2,0,0,2,0,2,4,1
7052,109716,9257hE3j2ibuyvUsd5ug9QNBvZR626xP,SpATywNh6bZuzm8s1ceuBUnMUAeoAHHw,19,38,15,18,9,0,6,0,86,12.285714285714286,4,0.0,11,15,15,9,27,0,3,6,0,50,36,1
7053,109718,LauvBEW2SjRiQSbmKACjhjUjr7ycSUes,SpATywNh6bZuzm8s1ceuBUnMUAeoAHHw,13,14,4,12,3,0,2,1,36,5.142857142857143,1,0.0,9,4,12,3,5,0,0,2,1,28,8,1
7054,109731,sXWQCMJ5uWT53YScVl07HilRx1j9KLZ2,SpATywNh6bZuzm8s1ceuBUnMUAeoAHHw,1,0,0,0,0,0,1,0,1,0.14285714285714285,1,0.0,0,0,0,0,0,0,0,1,0,0,1,1
7055,109746,GLXgEITEGSlq2OnY03wIuxcorHQRX3zY,A3fsA9Zfv1X2fVEQhTw51lKENdNrEqT3,10,7,5,0,3,1,5,0,21,3.0,1,0.0,0,5,0,3,7,1,0,5,0,8,13,0
7056,109757,NCq7uMk20xis3HUzEQcWP2K284TvGGUT,G8EPVSXsOYB5YQWZGiz1aVq5Pgr2GrQu,10,5,4,0,3,3,3,0,18,2.5714285714285716,1,0.0,0,4,0,3,5,3,0,3,0,7,11,0
7057,109782,OZaq72DmJH6bReA6lKvO4XbWYjmwsu42,A3fsA9Zfv1X2fVEQhTw51lKENdNrEqT3,1,0,0,0,0,0,1,0,1,0.14285714285714285,1,0.0,0,0,0,0,0,0,0,1,0,0,1,1
7058,109783,TGbtpXBmCBBlZeS2P72XRQZjesW8qA9X,SpATywNh6bZuzm8s1ceuBUnMUAeoAHHw,2,0,0,0,0,0,2,0,2,0.2857142857142857,1,0.0,0,0,0,0,0,0,0,2,0,0,2,1
7059,109784,qp7BLvS8nhXNAuvU9LsQhZWo9nk3BTFw,bWdj2GDclj5ofokWjzoa5jAwMkxCykd6,1,0,0,0,0,0,1,0,1,0.14285714285714285,1,0.0,0,0,0,0,0,0,0,1,0,0,1,1
7060,109785,qp7BLvS8nhXNAuvU9LsQhZWo9nk3BTFw,RXDvfPUBYFlVdlueBFbLW0mhhAyGEqpt,1,0,0,0,0,0,1,0,1,0.14285714285714285,1,0.0,0,0,0,0,0,0,0,1,0,0,1,1
7061,109786,jRi5kMZL8gw9VtNxiN9NAzyTyPmFUqYw,A3fsA9Zfv1X2fVEQhTw51lKENdNrEqT3,9,8,1,0,1,0,11,2,23,3.2857142857142856,1,0.0,0,1,0,1,8,0,0,11,2,2,21,1
7062,109800,PenDUeO0eoR8hyLVdfPN6H7q2FnTGMus,bWdj2GDclj5ofokWjzoa5jAwMkxCykd6,1,0,0,0,0,0,1,0,1,0.14285714285714285,1,0.0,0,0,0,0,0,0,0,1,0,0,1,1
7063,109811,4FKdcJP7BDwtMG7CY9eliEHXAfUQYGv7,RXDvfPUBYFlVdlueBFbLW0mhhAyGEqpt,9,12,6,0,3,0,1,0,22,3.142857142857143,1,0.0,0,6,0,3,12,0,0,1,0,9,13,1
7064,109816,NxKBgCf6L0n0EeCKRoJkVqGpdQ3sLVu2,SpATywNh6bZuzm8s1ceuBUnMUAeoAHHw,6,3,2,0,2,0,1,0,8,1.1428571428571428,1,0.0,0,2,0,2,3,0,0,1,0,4,4,1
7065,109821,OEuLxcw6vw5UY038iWtYfZUlieO9mgsq,RXDvfPUBYFlVdlueBFbLW0mhhAyGEqpt,9,24,15,0,5,0,5,0,49,7.0,2,0.0,0,15,0,5,24,0,0,5,0,20,29,1
7066,109835,QQrQFuArLkquFtXrvX0HKAU3caPT1bEW,SpATywNh6bZuzm8s1ceuBUnMUAeoAHHw,1,0,0,0,0,0,1,0,1,0.14285714285714285,1,0.0,0,0,0,0,0,0,0,1,0,0,1,1
7067,109840,fW2uAkcB4Zo13Su23SC3AqxKoKQQCv9V,bWdj2GDclj5ofokWjzoa5jAwMkxCykd6,14,11,4,28,5,0,2,0,50,7.142857142857143,2,0.0,4,4,27,5,7,0,1,2,0,40,10,1
7068,109841,008XUUt5rc6hUrg7SHj9oW0rG0FE0dkF,A3fsA9Zfv1X2fVEQhTw51lKENdNrEqT3,36,20,12,68,0,1,7,2,110,15.714285714285714,1,0.0,6,12,58,0,14,1,10,7,2,76,34,0
7069,109856,PVIjAE0m0OeJAYOHc5gIjzktRijtXdS4,SpATywNh6bZuzm8s1ceuBUnMUAeoAHHw,6,3,2,0,2,0,1,0,8,1.1428571428571428,2,0.0,0,2,0,2,3,0,0,1,0,4,4,0
7070,109858,45qf8dslh2FbT82HZJkVQ8o4xBP1tetJ,SpATywNh6bZuzm8s1ceuBUnMUAeoAHHw,1,0,0,0,0,0,1,0,1,0.14285714285714285,1,0.0,0,0,0,0,0,0,0,1,0,0,1,1
7071,109865,WRiHtWJX61VUGyAGQFSHJ3czdrgqxeQW,A3fsA9Zfv1X2fVEQhTw51lKENdNrEqT3,3,0,0,0,0,2,2,0,4,0.5714285714285714,1,0.0,0,0,0,0,0,2,0,2,0,0,4,1
7072,109876,J9b5OTfKjKw0x7GgqhJQnViZ6aYw88y1,bWdj2GDclj5ofokWjzoa5jAwMkxCykd6,4,2,0,0,0,0,3,0,5,0.7142857142857143,1,0.0,0,0,0,0,2,0,0,3,0,0,5,1
7073,109884,TiyssQ1xBxRpSE8M84hoblpjLNawoMPM,bWdj2GDclj5ofokWjzoa5jAwMkxCykd6,1,0,0,0,0,0,1,0,1,0.14285714285714285,1,0.0,0,0,0,0,0,0,0,1,0,0,1,1
7074,109888,onkD63zW36qWueM4FnIhDEFep4J6xaTB,SpATywNh6bZuzm8s1ceuBUnMUAeoAHHw,10,9,6,0,6,1,8,1,31,4.428571428571429,3,0.0,0,6,0,6,9,1,0,8,1,12,19,1
7075,109898,26GEnf61bFs7ZWD0apKuRzsFCe2K0kZz,SpATywNh6bZuzm8s1ceuBUnMUAeoAHHw,7,2,0,0,0,14,6,1,23,3.2857142857142856,1,0.0,0,0,0,0,2,14,0,6,1,0,23,1
7076,109903,m4zdr76CpU472F6wsJffFbslI27LpI4g,A3fsA9Zfv1X2fVEQhTw51lKENdNrEqT3,4,2,1,0,1,0,1,0,5,0.7142857142857143,1,0.0,0,1,0,1,2,0,0,1,0,2,3,1
7077,109911,AVOR5ugt0lZQkprV146IIDmyiCL0xSOy,SpATywNh6bZuzm8s1ceuBUnMUAeoAHHw,6,3,1,0,1,0,2,0,7,1.0,1,0.0,0,1,0,1,3,0,0,2,0,2,5,1
7078,109935,CViRSkXaB71kW0MpqfES8A240EKnhiKp,SpATywNh6bZuzm8s1ceuBUnMUAeoAHHw,9,13,10,0,6,0,5,0,34,4.857142857142857,3,0.0,0,10,0,6,13,0,0,5,0,16,18,1
7079,109938,jhSBNR9EEysD5KhTnnFndvZuefk9V3rI,SpATywNh6bZuzm8s1ceuBUnMUAeoAHHw,26,25,17,23,5,2,12,1,85,12.142857142857142,3,0.0,6,17,20,5,19,2,3,12,1,48,37,0
7080,109950,m46ZDnHY4MCOwsZObE6icbOdSDL76NDY,A3fsA9Zfv1X2fVEQhTw51lKENdNrEqT3,1,0,0,0,0,0,1,0,1,0.14285714285714285,1,0.0,0,0,0,0,0,0,0,1,0,0,1,1
7081,109952,7vgfRfYiZZ2eDFnPmEicllnUmROBENw7,SpATywNh6bZuzm8s1ceuBUnMUAeoAHHw,1,0,0,0,0,0,1,0,1,0.14285714285714285,1,0.0,0,0,0,0,0,0,0,1,0,0,1,1
7082,109957,69mjZoNGtUdd47OHaI2iQubsVwSBE5CT,bWdj2GDclj5ofokWjzoa5jAwMkxCykd6,4,3,1,0,1,0,2,0,7,1.0,1,0.0,0,1,0,1,3,0,0,2,0,2,5,1
7083,109960,dq3iqibSI5OSwCbWRZv7tfgbiuLwOgjh,A3fsA9Zfv1X2fVEQhTw51lKENdNrEqT3,10,7,5,0,4,0,1,0,17,2.4285714285714284,1,0.0,0,5,0,4,7,0,0,1,0,9,8,1
7084,109967,gcway7yukVhkU23YjxQt8J89R78muKel,A3fsA9Zfv1X2fVEQhTw51lKENdNrEqT3,1,0,0,0,0,0,2,0,2,0.2857142857142857,1,0.0,0,0,0,0,0,0,0,2,0,0,2,1
7085,109984,9vKJ7o9c510Kb9hLaAaKExOfBIo69t2w,bWdj2GDclj5ofokWjzoa5jAwMkxCykd6,4,3,1,0,1,0,1,0,6,0.8571428571428571,1,0.0,0,1,0,1,3,0,0,1,0,2,4,1
7086,109993,ma5SB0XT5eSIELPtdH2s2g8qesUddnBJ,SpATywNh6bZuzm8s1ceuBUnMUAeoAHHw,4,2,0,0,0,0,3,0,5,0.7142857142857143,1,0.0,0,0,0,0,2,0,0,3,0,0,5,1
7087,109994,V9A9B2T9pRTU3AqvpqzuKs4MfRcAEte2,bWdj2GDclj5ofokWjzoa5jAwMkxCykd6,7,3,2,0,2,0,3,0,10,1.4285714285714286,2,0.0,0,2,0,2,3,0,0,3,0,4,6,1
7088,109995,9vKJ7o9c510Kb9hLaAaKExOfBIo69t2w,SpATywNh6bZuzm8s1ceuBUnMUAeoAHHw,6,7,3,0,2,0,1,0,13,1.8571428571428572,1,0.0,0,3,0,2,7,0,0,1,0,5,8,1
7089,109996,OZ02Yntpt8Hg8thsFgejT4NSsPYtVPPm,A3fsA9Zfv1X2fVEQhTw51lKENdNrEqT3,4,3,2,0,2,0,1,0,8,1.1428571428571428,1,0.0,0,2,0,2,3,0,0,1,0,4,4,0
7090,109999,rYSxun4NgQnH8EYwHicH82Z91cblITe8,A3fsA9Zfv1X2fVEQhTw51lKENdNrEqT3,8,2,1,0,1,1,10,1,16,2.2857142857142856,1,0.0,0,1,0,1,2,1,0,10,1,2,14,1
7091,110000,A49hnVx3rwiVqM2hX3Oana4wZTCICiZX,SpATywNh6bZuzm8s1ceuBUnMUAeoAHHw,4,2,1,0,1,0,1,0,5,0.7142857142857143,1,0.0,0,1,0,1,2,0,0,1,0,2,3,0
7092,110005,CD2QgLWd9xNuEgr45XWnWQUVbnjf79M7,A3fsA9Zfv1X2fVEQhTw51lKENdNrEqT3,14,7,6,0,5,0,3,0,21,3.0,2,0.0,0,6,0,5,7,0,0,3,0,11,10,1
7093,110009,9803qM4isShkjkoVAPID7DQVAjFPwCDe,bWdj2GDclj5ofokWjzoa5jAwMkxCykd6,2,0,0,0,0,0,3,0,3,0.42857142857142855,1,0.0,0,0,0,0,0,0,0,3,0,0,3,1
7094,110013,OvIrFDXnTf7lPGXHN37tKh2m9dXSHGJK,A3fsA9Zfv1X2fVEQhTw51lKENdNrEqT3,1,0,0,0,0,0,2,0,2,0.2857142857142857,2,0.0,0,0,0,0,0,0,0,2,0,0,2,1
7095,110021,hkMQnmp0vvHTyvieOAhjYCGC9vi3Sftr,SpATywNh6bZuzm8s1ceuBUnMUAeoAHHw,10,5,3,0,2,5,5,0,20,2.857142857142857,1,0.0,0,3,0,2,5,5,0,5,0,5,15,1
7096,110025,VLJj9ywKL5TKEmvLWZO7iNyx7gDmV9Dg,SpATywNh6bZuzm8s1ceuBUnMUAeoAHHw,1,0,0,0,0,0,1,0,1,0.14285714285714285,1,0.0,0,0,0,0,0,0,0,1,0,0,1,1
7097,110030,2gXHY5qLgY96Nt3kImmboPawcy43EQXt,A3fsA9Zfv1X2fVEQhTw51lKENdNrEqT3,5,6,2,0,2,0,3,0,13,1.8571428571428572,1,0.0,0,2,0,2,6,0,0,3,0,4,9,1
7098,110033,sVIvm416vjfeqMOGnXZuyI7BvpOH8r6a,A3fsA9Zfv1X2fVEQhTw51lKENdNrEqT3,8,2,1,0,1,4,6,1,15,2.142857142857143,1,0.0,0,1,0,1,2,4,0,6,1,2,13,1
7099,110036,pKc7l3x3OfAQ9k2wvNUoHVHE65xXVFbV,G8EPVSXsOYB5YQWZGiz1aVq5Pgr2GrQu,9,5,3,0,2,1,4,0,15,2.142857142857143,1,0.0,0,3,0,2,5,1,0,4,0,5,10,1
7100,110047,mutkCKvqzTd4FkjKQRYUWL51H59AdIct,SpATywNh6bZuzm8s1ceuBUnMUAeoAHHw,10,10,7,0,6,0,4,0,27,3.857142857142857,1,0.0,0,7,0,6,10,0,0,4,0,13,14,0
7101,110051,UCDPR1k7RkPBDIde3KiukiosB55WbRVo,bWdj2GDclj5ofokWjzoa5jAwMkxCykd6,1,0,0,0,0,0,1,0,1,0.14285714285714285,1,0.0,0,0,0,0,0,0,0,1,0,0,1,1
7102,110053,gaD5Av49rKMTRISUDiGUl6H5FYk7vPMw,G8EPVSXsOYB5YQWZGiz1aVq5Pgr2GrQu,29,35,4,66,6,2,3,1,117,16.714285714285715,1,0.0,21,4,51,6,14,2,15,3,1,82,35,0
7103,110060,HAmydfc2dHhpF7W3j97KPwhZZY0mGz44,bWdj2GDclj5ofokWjzoa5jAwMkxCykd6,6,1,0,0,0,0,8,1,10,1.4285714285714286,2,0.0,0,0,0,0,1,0,0,8,1,0,10,1
7104,113825,xUhDcXiX03QQg1jNR3Lksh9CrGcRUkPg,7GRhBDsirIGkRZBtSMEzNTyDr2JQm4xx,13,21,1,0,3,4,8,0,37,5.285714285714286,2,0.0,5,1,0,3,16,4,0,8,0,9,28,0
7105,113845,EwpbggvNdZkeSTjdG48aEltlJYavm02s,7GRhBDsirIGkRZBtSMEzNTyDr2JQm4xx,4,2,1,0,1,0,1,0,5,0.7142857142857143,1,0.0,0,1,0,1,2,0,0,1,0,2,3,1
7106,113846,7hhGe4WcGEHypOzIVz3DLRx9GS52ozkE,7GRhBDsirIGkRZBtSMEzNTyDr2JQm4xx,40,59,25,58,16,0,7,0,165,23.571428571428573,5,0.0,26,25,51,16,33,0,7,7,0,118,47,1
7107,113935,nDRvdnRCphlivJCuFTuhDKgd5jyHoHuK,7GRhBDsirIGkRZBtSMEzNTyDr2JQm4xx,62,162,85,133,36,4,28,0,448,64.0,8,0.0,53,85,112,36,109,4,21,28,0,286,162,0
7108,113957,JoqAGqbao71wc04PyVzx7SVvlZZ0knbI,7GRhBDsirIGkRZBtSMEzNTyDr2JQm4xx,35,103,31,58,7,14,17,0,230,32.857142857142854,4,0.0,49,31,54,7,54,14,4,17,0,141,89,1
7109,114029,B7LHt2Cj2bBAHJSILTk3b5ZvfNYywzep,7GRhBDsirIGkRZBtSMEzNTyDr2JQm4xx,9,6,3,0,1,0,5,0,15,2.142857142857143,1,0.0,1,3,0,1,5,0,0,5,0,5,10,1
7110,114045,40f11BuizcEv7ZFFxcPqa0v1O1iUUbkI,7GRhBDsirIGkRZBtSMEzNTyDr2JQm4xx,7,6,3,0,2,0,2,0,13,1.8571428571428572,2,0.0,1,3,0,2,5,0,0,2,0,6,7,1
7111,114118,hNtOw8NhFSEVmWVm0uZ7niVIy1y64lqK,7GRhBDsirIGkRZBtSMEzNTyDr2JQm4xx,4,0,0,0,0,0,10,0,10,1.4285714285714286,2,0.0,0,0,0,0,0,0,0,10,0,0,10,1
7112,114136,tkUa5CpArdCreqMyzIcAuTFrrxiEVJbS,7GRhBDsirIGkRZBtSMEzNTyDr2JQm4xx,30,30,13,34,11,15,12,0,115,16.428571428571427,1,0.0,16,13,29,11,14,15,5,12,0,69,46,1
7113,114140,nUWkRuhBy34ASlaPMCQ75Oelnn64cfdy,7GRhBDsirIGkRZBtSMEzNTyDr2JQm4xx,52,151,53,36,45,10,21,1,317,45.285714285714285,4,0.0,87,53,33,45,64,10,3,21,1,218,99,0
7114,114147,okqN4nBVKRYYrkYonKicKGOmPqVGYjZh,7GRhBDsirIGkRZBtSMEzNTyDr2JQm4xx,4,3,1,0,0,0,4,0,8,1.1428571428571428,2,0.0,0,1,0,0,3,0,0,4,0,1,7,0
7115,114179,QZbPGbTnAqz8GS6cm25XcpeiETovvLN6,7GRhBDsirIGkRZBtSMEzNTyDr2JQm4xx,2,0,0,0,0,0,3,0,3,0.42857142857142855,1,0.0,0,0,0,0,0,0,0,3,0,0,3,0
7116,114255,dtcl5eI6yhwMyoweqshgFuTzKqFJQm0u,7GRhBDsirIGkRZBtSMEzNTyDr2JQm4xx,2,0,0,0,0,0,3,0,3,0.42857142857142855,1,0.0,0,0,0,0,0,0,0,3,0,0,3,1
7117,114289,yt0pMjWs1WUyd9gdp8SqXOjWyU58K3uA,7GRhBDsirIGkRZBtSMEzNTyDr2JQm4xx,2,0,0,0,0,0,2,0,2,0.2857142857142857,2,0.0,0,0,0,0,0,0,0,2,0,0,2,1
7118,114349,HHtkMPGPD7M5HjKp2cITsAXThUPUGeqi,7GRhBDsirIGkRZBtSMEzNTyDr2JQm4xx,49,141,49,101,34,10,14,0,349,49.857142857142854,5,0.0,68,49,88,34,73,10,13,14,0,239,110,1
7119,114404,RrDvHNy910b7XxqIkvHWSamS4IG3fgCH,7GRhBDsirIGkRZBtSMEzNTyDr2JQm4xx,1,0,0,0,0,0,1,0,1,0.14285714285714285,1,0.0,0,0,0,0,0,0,0,1,0,0,1,1
7120,114429,NEVPUSDkU7HaE7xRESmGkn6KaWhWlNDH,7GRhBDsirIGkRZBtSMEzNTyDr2JQm4xx,11,19,4,51,0,0,1,0,75,10.714285714285714,1,0.0,14,4,44,0,5,0,7,1,0,62,13,1
7121,114458,hu8eak1Xmf8voE8pnxPzkSD2dZP9Sipf,7GRhBDsirIGkRZBtSMEzNTyDr2JQm4xx,2,0,0,0,0,0,4,0,4,0.5714285714285714,2,0.0,0,0,0,0,0,0,0,4,0,0,4,0
7122,114460,gBUQvhjVwGtG2bUGFkuQNt86DA2hmTm5,7GRhBDsirIGkRZBtSMEzNTyDr2JQm4xx,43,133,62,64,34,0,30,3,326,46.57142857142857,3,0.0,63,62,54,34,70,0,10,30,3,213,113,1
7123,114491,MU4dVyJTD7iIRSTZIdJZ9VoLOxogfKQN,7GRhBDsirIGkRZBtSMEzNTyDr2JQm4xx,4,2,1,0,1,0,1,0,5,0.7142857142857143,1,0.0,0,1,0,1,2,0,0,1,0,2,3,1
7124,114492,oxOzo82Nq65tcwE6AZvxglw3lN8SeywJ,7GRhBDsirIGkRZBtSMEzNTyDr2JQm4xx,5,2,1,0,1,0,2,0,6,0.8571428571428571,1,0.0,0,1,0,1,2,0,0,2,0,2,4,1
7125,114508,DahdU3m64q9GHbzMvs6TdHVFTDo4asbt,7GRhBDsirIGkRZBtSMEzNTyDr2JQm4xx,13,5,3,0,2,10,15,6,41,5.857142857142857,2,0.0,0,3,0,2,5,10,0,15,6,5,36,0
7126,114536,BIrtFqgMfUNvzbgStoEGnPt5I5Uav700,7GRhBDsirIGkRZBtSMEzNTyDr2JQm4xx,1,0,0,0,0,0,1,0,1,0.14285714285714285,1,0.0,0,0,0,0,0,0,0,1,0,0,1,1
7127,114546,CKlPS4aJNSCYcpmTEnTkXSXKz4jn8q0W,7GRhBDsirIGkRZBtSMEzNTyDr2JQm4xx,2,0,0,0,0,0,2,0,2,0.2857142857142857,1,0.0,0,0,0,0,0,0,0,2,0,0,2,1
7128,114562,BQSRjVmgixA5nv8k53vKwJ20bVp0NOMd,7GRhBDsirIGkRZBtSMEzNTyDr2JQm4xx,69,96,34,107,27,120,25,2,411,58.714285714285715,5,0.0,51,34,90,27,45,120,17,25,2,202,209,0
7129,114597,rwCHpAN1sY0GvFYG7zQQk2qpgkOBz9O3,7GRhBDsirIGkRZBtSMEzNTyDr2JQm4xx,1,0,0,0,0,0,1,0,1,0.14285714285714285,1,0.0,0,0,0,0,0,0,0,1,0,0,1,1
7130,114622,whDoakw9KuyWQ8M0W7cddKOMydB0d6nf,fbPkOYLVPtPgIt0MxizjfFJov3JbHyAi,15,29,9,8,16,12,7,0,81,11.571428571428571,2,0.0,18,9,6,16,11,12,2,7,0,49,32,1
7131,114627,uKuE1pqPLKBLlaDHpMsHUJvLz6lxiokY,fbPkOYLVPtPgIt0MxizjfFJov3JbHyAi,11,25,13,0,10,0,5,0,53,7.571428571428571,2,0.0,0,13,0,10,25,0,0,5,0,23,30,1
7132,114634,5MFqn51ngpNJRILTITSLFdc469nefTuS,fbPkOYLVPtPgIt0MxizjfFJov3JbHyAi,9,5,2,0,2,3,4,1,17,2.4285714285714284,1,0.0,2,2,0,2,3,3,0,4,1,6,11,1
7133,114639,IXyECojptU5NkfL9RFdtwIRy87m56pw9,fbPkOYLVPtPgIt0MxizjfFJov3JbHyAi,35,123,55,38,27,49,70,19,381,54.42857142857143,11,0.0,34,55,24,27,89,49,14,70,19,140,241,1
7134,114652,wuaIkUodYTr49NZ7BbMPsEdpO0t0C8Nt,fbPkOYLVPtPgIt0MxizjfFJov3JbHyAi,16,33,1,8,3,0,9,0,54,7.714285714285714,2,0.0,8,1,7,3,25,0,1,9,0,19,35,1
7135,117347,Lmy48LaZfIr9H2JGohLJKVaIoB8r8qji,fbPkOYLVPtPgIt0MxizjfFJov3JbHyAi,7,3,2,0,2,0,4,0,11,1.5714285714285714,1,0.0,0,2,0,2,3,0,0,4,0,4,7,1
7136,117348,5qhlEY7iczknBOw4qaTj0oiHyjQVe9rT,fbPkOYLVPtPgIt0MxizjfFJov3JbHyAi,4,2,1,0,1,0,1,0,5,0.7142857142857143,1,0.0,0,1,0,1,2,0,0,1,0,2,3,1
7137,117349,CcuDWPt1eyW7M86jUsYuAZO2EZvkv343,fbPkOYLVPtPgIt0MxizjfFJov3JbHyAi,2,0,0,0,0,0,2,0,2,0.2857142857142857,1,0.0,0,0,0,0,0,0,0,2,0,0,2,1
7138,117350,THBV67QwrR4fvYsMOGo7siHXFao0S7M8,fbPkOYLVPtPgIt0MxizjfFJov3JbHyAi,4,2,1,0,1,0,1,0,5,0.7142857142857143,1,0.0,0,1,0,1,2,0,0,1,0,2,3,1
7139,117351,S6eQGQp3K76RS5VMtIsaLuIm5UHtwYF7,fbPkOYLVPtPgIt0MxizjfFJov3JbHyAi,5,2,1,0,1,0,4,0,8,1.1428571428571428,1,0.0,0,1,0,1,2,0,0,4,0,2,6,1
7140,117352,W8LiHDfUOd6JJS4l21H06gvkeAd3UQzA,fbPkOYLVPtPgIt0MxizjfFJov3JbHyAi,8,6,2,0,3,0,6,0,17,2.4285714285714284,2,0.0,3,2,0,3,3,0,0,6,0,8,9,1
7141,117353,qsIC4v5Dx0AC8V7VvfXbXh1Orc1wEb3w,fbPkOYLVPtPgIt0MxizjfFJov3JbHyAi,2,0,0,0,0,0,4,0,4,0.5714285714285714,2,0.0,0,0,0,0,0,0,0,4,0,0,4,1
7142,117354,wJflvpFe05Aoyiv7JkqhQs7iDcvnIpoZ,fbPkOYLVPtPgIt0MxizjfFJov3JbHyAi,23,95,36,22,66,45,14,0,278,39.714285714285715,4,0.0,16,36,19,66,79,45,3,14,0,137,141,0
7143,117355,HymjYRZjO8zO0eFKC26krqimHj67lbM0,fbPkOYLVPtPgIt0MxizjfFJov3JbHyAi,9,3,2,0,2,12,13,1,33,4.714285714285714,1,0.0,0,2,0,2,3,12,0,13,1,4,29,1
7144,117356,BEpwi711y09XyC4DFTNZ8NMJ5PwUJeE1,fbPkOYLVPtPgIt0MxizjfFJov3JbHyAi,37,120,53,28,18,78,33,6,336,48.0,8,0.0,16,53,26,18,104,78,2,33,6,113,223,0
7145,117357,jdo8ZaITXdNg3iaXD5IuBNuDQn99Df8w,fbPkOYLVPtPgIt0MxizjfFJov3JbHyAi,6,6,3,0,1,0,2,0,12,1.7142857142857142,2,0.0,0,3,0,1,6,0,0,2,0,4,8,1
7146,117358,VIIC2sfSYNNzIhFTDhqx6glGRp1LLtBP,fbPkOYLVPtPgIt0MxizjfFJov3JbHyAi,1,0,0,0,0,0,1,0,1,0.14285714285714285,1,0.0,0,0,0,0,0,0,0,1,0,0,1,1
7147,117359,1fv3phUYFf4MQkWpDcJllU01xcW0vo3W,fbPkOYLVPtPgIt0MxizjfFJov3JbHyAi,4,2,1,0,1,0,1,0,5,0.7142857142857143,1,0.0,0,1,0,1,2,0,0,1,0,2,3,1
7148,117360,u8qSA6tNYpciCcX3NsOlG8kpTSmTzvQW,fbPkOYLVPtPgIt0MxizjfFJov3JbHyAi,1,0,0,0,0,0,1,0,1,0.14285714285714285,1,0.0,0,0,0,0,0,0,0,1,0,0,1,1
7149,117361,YmW9sTTkl6fJ0hETvvamJqK86iqzkJtX,fbPkOYLVPtPgIt0MxizjfFJov3JbHyAi,9,12,7,0,4,3,3,0,29,4.142857142857143,2,0.0,0,7,0,4,12,3,0,3,0,11,18,1
7150,117362,GhH23XxJCtHV5BHmHgLHMs1bT51czMlK,fbPkOYLVPtPgIt0MxizjfFJov3JbHyAi,2,0,0,0,0,0,8,0,8,1.1428571428571428,1,0.0,0,0,0,0,0,0,0,8,0,0,8,1
7151,117363,jpOV5NTWg54y4Oc7tw4bVLxYduaerIGO,fbPkOYLVPtPgIt0MxizjfFJov3JbHyAi,5,2,1,0,1,0,4,0,8,1.1428571428571428,1,0.0,0,1,0,1,2,0,0,4,0,2,6,1
7152,117364,gVDka1k86106F8RxhzEk3T4GWmptct3j,fbPkOYLVPtPgIt0MxizjfFJov3JbHyAi,5,2,1,0,1,0,5,0,9,1.2857142857142858,1,0.0,0,1,0,1,2,0,0,5,0,2,7,1
7153,117365,Jab5g3oUGQ9SaeNRnULqHnW16VXqaDjO,fbPkOYLVPtPgIt0MxizjfFJov3JbHyAi,5,3,1,0,1,0,4,0,9,1.2857142857142858,1,0.0,0,1,0,1,3,0,0,4,0,2,7,0
7154,117366,dzyBEAqhGTXZ2XFaP0jn5Y8xrnIodQ3R,fbPkOYLVPtPgIt0MxizjfFJov3JbHyAi,1,0,0,0,0,0,1,0,1,0.14285714285714285,1,0.0,0,0,0,0,0,0,0,1,0,0,1,1
7155,117369,84MmPDpZ0YkQ5nQqNX1rbALt0YU3wNuB,fbPkOYLVPtPgIt0MxizjfFJov3JbHyAi,6,1,0,0,0,0,8,1,10,1.4285714285714286,1,0.0,0,0,0,0,1,0,0,8,1,0,10,1
7156,117371,yr7gisoB3gNrf1PYumUdBsd83AKA13gw,fbPkOYLVPtPgIt0MxizjfFJov3JbHyAi,2,0,0,0,0,0,4,0,4,0.5714285714285714,1,0.0,0,0,0,0,0,0,0,4,0,0,4,1
7157,117372,frevGWOFyf2Wo6uQjpFNvZnyWeFbKP0E,fbPkOYLVPtPgIt0MxizjfFJov3JbHyAi,25,17,8,16,8,5,6,0,60,8.571428571428571,2,0.0,7,8,14,8,10,5,2,6,0,37,23,1
7158,117373,FAatoUEhCvhRpOYbmvA32pbUt7RdzYRu,fbPkOYLVPtPgIt0MxizjfFJov3JbHyAi,5,2,1,0,1,0,5,0,9,1.2857142857142858,1,0.0,0,1,0,1,2,0,0,5,0,2,7,1
7159,117374,ZMs9DXI7ESTFKW1YBMWs95iQQk6J7X2z,fbPkOYLVPtPgIt0MxizjfFJov3JbHyAi,5,3,1,0,1,2,4,0,11,1.5714285714285714,1,0.0,0,1,0,1,3,2,0,4,0,2,9,1
7160,117375,70RbSAVcGIyny9mWjCd20wt9FfgzeOIU,fbPkOYLVPtPgIt0MxizjfFJov3JbHyAi,8,8,4,0,1,10,10,1,34,4.857142857142857,2,0.0,0,4,0,1,8,10,0,10,1,5,29,1
7161,117376,7RSTSE7CX0EZRW2RDRnKS7CJkHtK7gJx,fbPkOYLVPtPgIt0MxizjfFJov3JbHyAi,4,3,1,0,1,3,1,0,9,1.2857142857142858,1,0.0,0,1,0,1,3,3,0,1,0,2,7,0
7162,117378,9jhH7wrMd3Eqw0VV440Dc9UHr2dQD82o,fbPkOYLVPtPgIt0MxizjfFJov3JbHyAi,6,1,1,0,1,0,5,0,8,1.1428571428571428,1,0.0,0,1,0,1,1,0,0,5,0,2,6,1
7163,117381,WeKk3LPA70V1znb6M7iSuaLFtRvTgv4L,fbPkOYLVPtPgIt0MxizjfFJov3JbHyAi,4,2,1,0,1,0,1,0,5,0.7142857142857143,1,0.0,0,1,0,1,2,0,0,1,0,2,3,1
7164,117383,cgR6Sk6i1HisakMjtLETZQtfL4e89Msk,fbPkOYLVPtPgIt0MxizjfFJov3JbHyAi,2,0,0,0,0,0,2,0,2,0.2857142857142857,1,0.0,0,0,0,0,0,0,0,2,0,0,2,1
7165,117384,QE7VYemIj4pMHXuEl2xp801KoSOaKbg6,fbPkOYLVPtPgIt0MxizjfFJov3JbHyAi,10,10,5,0,4,0,7,0,26,3.7142857142857144,2,0.0,2,5,0,4,8,0,0,7,0,11,15,1
7166,117387,Q6xW7zlgn9B8VyFUYRYPAiN0jH5lh0YZ,fbPkOYLVPtPgIt0MxizjfFJov3JbHyAi,5,3,1,0,1,0,5,0,10,1.4285714285714286,1,0.0,0,1,0,1,3,0,0,5,0,2,8,1
7167,117388,cdL4DEn7NceHWkENWhz16RxoYhvN1B4t,fbPkOYLVPtPgIt0MxizjfFJov3JbHyAi,9,9,4,0,3,3,7,1,27,3.857142857142857,1,0.0,3,4,0,3,6,3,0,7,1,10,17,1
7168,117390,CadKUf2Mul3ALexXlY5uWvTQFtSrVs8p,fbPkOYLVPtPgIt0MxizjfFJov3JbHyAi,5,2,1,0,1,0,2,0,6,0.8571428571428571,1,0.0,0,1,0,1,2,0,0,2,0,2,4,1
7169,117391,dGox9f4ZDlHQwjKRHa3wEmIJzGDWDxPX,fbPkOYLVPtPgIt0MxizjfFJov3JbHyAi,15,21,7,17,10,10,9,0,74,10.571428571428571,2,0.0,12,7,12,10,9,10,5,9,0,41,33,1
7170,117392,A3rmkE1bnOg1XwxjYHudD7UFmCyTX4Vy,fbPkOYLVPtPgIt0MxizjfFJov3JbHyAi,5,2,1,0,1,0,2,0,6,0.8571428571428571,1,0.0,0,1,0,1,2,0,0,2,0,2,4,1
7171,117393,1NRhqP9avvdGMFKMKghbEOxv5wnexLIt,fbPkOYLVPtPgIt0MxizjfFJov3JbHyAi,2,0,0,0,0,0,4,0,4,0.5714285714285714,1,0.0,0,0,0,0,0,0,0,4,0,0,4,1
7172,117394,x61GVEFoUQZEIHnVsxBCw0kitfDOhP0p,fbPkOYLVPtPgIt0MxizjfFJov3JbHyAi,28,56,30,10,22,96,27,1,242,34.57142857142857,4,0.0,13,30,9,22,43,96,1,27,1,74,168,1
7173,117395,Mh66DLCMXZ6dBObZWAREClnDkNcjPB4t,fbPkOYLVPtPgIt0MxizjfFJov3JbHyAi,5,2,1,0,1,0,4,0,8,1.1428571428571428,1,0.0,0,1,0,1,2,0,0,4,0,2,6,1
7174,117398,RToZJlmZ1SKeCpqwz31BArcaj4qy0SaF,fbPkOYLVPtPgIt0MxizjfFJov3JbHyAi,2,0,0,0,0,0,2,0,2,0.2857142857142857,1,0.0,0,0,0,0,0,0,0,2,0,0,2,1
7175,117400,DYhAozmaoJyITokVWonroVftsEgv5K6H,fbPkOYLVPtPgIt0MxizjfFJov3JbHyAi,7,3,2,0,2,0,4,0,11,1.5714285714285714,1,0.0,0,2,0,2,3,0,0,4,0,4,7,1
7176,117401,8loJZqV93UIB0LVEOgs0qIcfMBhyuVR4,fbPkOYLVPtPgIt0MxizjfFJov3JbHyAi,5,2,1,0,1,0,2,0,6,0.8571428571428571,1,0.0,0,1,0,1,2,0,0,2,0,2,4,1
7177,117402,BdMHqR5WAKDssANXDMso5QusZ7X7eexo,fbPkOYLVPtPgIt0MxizjfFJov3JbHyAi,25,89,34,11,20,37,10,1,202,28.857142857142858,3,0.0,31,34,10,20,58,37,1,10,1,95,107,1
7178,117403,AyVFKMWjzC4gPpDsd8ofzYs7TtpYPztD,fbPkOYLVPtPgIt0MxizjfFJov3JbHyAi,7,4,2,0,1,0,5,0,12,1.7142857142857142,1,0.0,0,2,0,1,4,0,0,5,0,3,9,1
7179,117404,C89edYjc0egHm9DK0UhG6TICXc3cgfYt,fbPkOYLVPtPgIt0MxizjfFJov3JbHyAi,4,2,1,0,0,0,2,0,5,0.7142857142857143,1,0.0,0,1,0,0,2,0,0,2,0,1,4,1
7180,117406,skfYGEKD2YfFTJGYxEqRg06NVhsZf6hd,fbPkOYLVPtPgIt0MxizjfFJov3JbHyAi,2,0,0,0,0,0,2,0,2,0.2857142857142857,1,0.0,0,0,0,0,0,0,0,2,0,0,2,1
7181,117411,K22VFryh5Od9V1LL0eOyTaqPsCNGJ8v3,fbPkOYLVPtPgIt0MxizjfFJov3JbHyAi,5,1,1,0,1,0,2,0,5,0.7142857142857143,1,0.0,0,1,0,1,1,0,0,2,0,2,3,1
7182,117412,27mdD0tYMMLTpcK2D7h6xnCOldDDzHch,fbPkOYLVPtPgIt0MxizjfFJov3JbHyAi,8,17,6,0,3,0,2,0,28,4.0,2,0.0,2,6,0,3,15,0,0,2,0,11,17,1
7183,117413,ZcypYnlQeadTdUIaT74Rv3xxhxFofUjh,fbPkOYLVPtPgIt0MxizjfFJov3JbHyAi,5,2,1,0,1,0,6,0,10,1.4285714285714286,1,0.0,0,1,0,1,2,0,0,6,0,2,8,1
7184,117414,u601bf5LgTloUnzWrvF8VsEbNdAIplE1,fbPkOYLVPtPgIt0MxizjfFJov3JbHyAi,7,3,2,0,2,0,4,0,11,1.5714285714285714,1,0.0,0,2,0,2,3,0,0,4,0,4,7,1
7185,117415,4Qo7Z1J3GHBpS2AY75HBdWU9Il8Ha5mP,fbPkOYLVPtPgIt0MxizjfFJov3JbHyAi,13,17,6,1,8,9,10,1,52,7.428571428571429,1,0.0,9,6,1,8,8,9,0,10,1,24,28,1
7186,117416,no2ug7TKVsupL4LU2a5jY2GhYHkskTdw,fbPkOYLVPtPgIt0MxizjfFJov3JbHyAi,44,79,42,30,19,9,19,0,198,28.285714285714285,8,0.0,22,42,24,19,57,9,6,19,0,107,91,1
7187,117417,MWcyYl4VKJ6gXYTCZ6GsdLjzmXlJRZpp,fbPkOYLVPtPgIt0MxizjfFJov3JbHyAi,10,9,2,0,3,21,12,4,51,7.285714285714286,2,0.0,2,2,0,3,7,21,0,12,4,7,44,1
7188,117418,xO9ez1QwXcTHUWvk9yY6tpiPg2NpvI40,fbPkOYLVPtPgIt0MxizjfFJov3JbHyAi,7,3,2,0,2,0,2,0,9,1.2857142857142858,1,0.0,0,2,0,2,3,0,0,2,0,4,5,1
7189,117419,EDx8dOeIuSiG4dzn3b6IyJq074mUoFqU,fbPkOYLVPtPgIt0MxizjfFJov3JbHyAi,2,0,0,0,0,0,4,0,4,0.5714285714285714,1,0.0,0,0,0,0,0,0,0,4,0,0,4,1
7190,117422,3ufcPQa9fE8hNqWpP8Ewk6MLJ169ewYG,fbPkOYLVPtPgIt0MxizjfFJov3JbHyAi,9,15,3,0,2,0,4,0,24,3.4285714285714284,2,0.0,0,3,0,2,15,0,0,4,0,5,19,1
7191,117423,NXEwBXbU6vvce77sujWgRB6LivhFJvRb,fbPkOYLVPtPgIt0MxizjfFJov3JbHyAi,6,7,4,0,2,0,4,0,17,2.4285714285714284,2,0.0,0,4,0,2,7,0,0,4,0,6,11,1
7192,117424,ksf7O5VoxfMEE12hvGca3f6KoMnOQ3Bh,fbPkOYLVPtPgIt0MxizjfFJov3JbHyAi,5,5,0,0,0,0,7,0,12,1.7142857142857142,1,0.0,0,0,0,0,5,0,0,7,0,0,12,1
7193,117427,bGLdkKassDYyZB9t4bgBBFjAHmjUsNSR,fbPkOYLVPtPgIt0MxizjfFJov3JbHyAi,7,3,1,0,1,1,7,1,14,2.0,1,0.0,0,1,0,1,3,1,0,7,1,2,12,1
7194,117428,es5zwE1DJ3gcng5ye9rbNjDc6YGVZjjA,fbPkOYLVPtPgIt0MxizjfFJov3JbHyAi,7,4,3,0,2,0,4,0,13,1.8571428571428572,1,0.0,0,3,0,2,4,0,0,4,0,5,8,1
7195,117431,da6MhMlDFSRLmIrClGzjJtU8eL0pm2dy,fbPkOYLVPtPgIt0MxizjfFJov3JbHyAi,5,2,1,0,1,0,2,0,6,0.8571428571428571,1,0.0,0,1,0,1,2,0,0,2,0,2,4,1
7196,117433,M75L90OOMTV1kEiI3n7vM0ty47YBFna9,fbPkOYLVPtPgIt0MxizjfFJov3JbHyAi,6,3,2,0,2,0,1,0,8,1.1428571428571428,1,0.0,0,2,0,2,3,0,0,1,0,4,4,1
7197,117435,Mal0OrUqylh9gVaeGBMc9fi4hOm7CY1j,fbPkOYLVPtPgIt0MxizjfFJov3JbHyAi,5,3,1,0,1,0,4,0,9,1.2857142857142858,1,0.0,0,1,0,1,3,0,0,4,0,2,7,1
7198,117436,CarlVCnkEuEWdxEFIyhyUfB0cb91lk3u,fbPkOYLVPtPgIt0MxizjfFJov3JbHyAi,5,2,1,0,1,1,4,0,9,1.2857142857142858,1,0.0,0,1,0,1,2,1,0,4,0,2,7,1
7199,117438,tD6MzN5QxvGBHQOVcmWLTvbMypNYMcey,fbPkOYLVPtPgIt0MxizjfFJov3JbHyAi,6,3,2,0,2,0,1,0,8,1.1428571428571428,1,0.0,0,2,0,2,3,0,0,1,0,4,4,1
7200,117439,vEs30RoWqgpB6hECbcLmFiwxEohGiKSd,fbPkOYLVPtPgIt0MxizjfFJov3JbHyAi,5,2,0,0,0,8,3,0,13,1.8571428571428572,1,0.0,0,0,0,0,2,8,0,3,0,0,13,1
7201,117440,IvHnLbw6NP6LhhQqreTJbhNQU5Zs6JCF,fbPkOYLVPtPgIt0MxizjfFJov3JbHyAi,4,2,1,0,1,0,2,0,6,0.8571428571428571,1,0.0,0,1,0,1,2,0,0,2,0,2,4,1
7202,117441,HptEZjRmdOpiqQNtiQtuC0XhWeQWrU1F,fbPkOYLVPtPgIt0MxizjfFJov3JbHyAi,2,0,0,0,0,0,2,0,2,0.2857142857142857,1,0.0,0,0,0,0,0,0,0,2,0,0,2,1
7203,117448,EVLibPakJPGsb5a9opPnLRzSILBMV36m,fbPkOYLVPtPgIt0MxizjfFJov3JbHyAi,7,2,1,0,1,1,7,1,13,1.8571428571428572,1,0.0,0,1,0,1,2,1,0,7,1,2,11,1
7204,117449,jfWbgHyvVBGKbleke3IOJ4RuvBB6sx7J,fbPkOYLVPtPgIt0MxizjfFJov3JbHyAi,9,5,3,0,3,0,3,0,14,2.0,2,0.0,0,3,0,3,5,0,0,3,0,6,8,1
7205,117450,NTi3RF6xGnkzsfYTj8D33u4sH3LbVAHE,fbPkOYLVPtPgIt0MxizjfFJov3JbHyAi,23,56,26,46,0,0,12,0,140,20.0,3,0.0,20,26,40,0,36,0,6,12,0,86,54,1
7206,117451,8TpvgxjbFSiTX0WEWOAldouvOlu5hbct,fbPkOYLVPtPgIt0MxizjfFJov3JbHyAi,5,2,0,0,0,22,4,0,28,4.0,1,0.0,0,0,0,0,2,22,0,4,0,0,28,1
7207,117453,GOoApgMbqW9QFX07cCt2mUBIZ8txh6qT,fbPkOYLVPtPgIt0MxizjfFJov3JbHyAi,9,17,9,0,9,15,1,0,51,7.285714285714286,1,0.0,6,9,0,9,11,15,0,1,0,24,27,1
7208,117455,HTst2SMNdS0XNA43FeobA5o05v7CUlNA,fbPkOYLVPtPgIt0MxizjfFJov3JbHyAi,25,42,17,22,18,2,6,1,108,15.428571428571429,1,0.0,22,17,21,18,20,2,1,6,1,78,30,0
7209,117456,PgMYw44fTh4Xx5U2R8ETG8pzBeXCE15Z,fbPkOYLVPtPgIt0MxizjfFJov3JbHyAi,1,0,0,0,0,0,1,0,1,0.14285714285714285,1,0.0,0,0,0,0,0,0,0,1,0,0,1,1
7210,117457,AFgD1DLeorByrsoA4AU51GpZfc6uZUVB,fbPkOYLVPtPgIt0MxizjfFJov3JbHyAi,6,7,3,0,2,0,1,0,13,1.8571428571428572,1,0.0,0,3,0,2,7,0,0,1,0,5,8,1
7211,117458,Uc3HK5Q0vMTy3ljdUcEzfnFcMiWvgtMK,fbPkOYLVPtPgIt0MxizjfFJov3JbHyAi,5,1,1,0,1,0,2,0,5,0.7142857142857143,1,0.0,0,1,0,1,1,0,0,2,0,2,3,1
7212,117459,8BPmxHv8u8jXk5HWBs0qXnY9uZ2rLMGq,fbPkOYLVPtPgIt0MxizjfFJov3JbHyAi,5,6,3,0,2,0,2,0,13,1.8571428571428572,2,0.0,0,3,0,2,6,0,0,2,0,5,8,0
7213,117461,OakZIwMalw5UgG2N0rTydClOEPiV8rki,fbPkOYLVPtPgIt0MxizjfFJov3JbHyAi,16,37,15,10,9,6,4,0,81,11.571428571428571,3,0.0,5,15,10,9,32,6,0,4,0,39,42,1
7214,117462,t9DYQDh2NoshF6BVBhwjK6lRvYfkvSI9,fbPkOYLVPtPgIt0MxizjfFJov3JbHyAi,5,2,1,0,1,0,4,0,8,1.1428571428571428,1,0.0,0,1,0,1,2,0,0,4,0,2,6,1
7215,117463,KMNMpAumo6Yq2T1usaL4CulVhqgN4Ggl,fbPkOYLVPtPgIt0MxizjfFJov3JbHyAi,10,4,3,0,3,0,5,0,15,2.142857142857143,1,0.0,0,3,0,3,4,0,0,5,0,6,9,1
7216,117464,SiySM3c36hCdKDVaWJXLlC2PBQXet4s6,fbPkOYLVPtPgIt0MxizjfFJov3JbHyAi,5,3,2,0,1,0,1,0,7,1.0,1,0.0,0,2,0,1,3,0,0,1,0,3,4,1
7217,117465,c0uK7fknnbIb1l1yn1QtakefMn1Gi8lI,fbPkOYLVPtPgIt0MxizjfFJov3JbHyAi,5,11,4,4,0,5,1,0,25,3.5714285714285716,1,0.0,6,4,4,0,5,5,0,1,0,14,11,1
7218,117466,f46TsvwYgA023En7b0jRPEBnKcXc3eeY,fbPkOYLVPtPgIt0MxizjfFJov3JbHyAi,1,0,0,0,0,0,1,0,1,0.14285714285714285,1,0.0,0,0,0,0,0,0,0,1,0,0,1,1
7219,117468,AyISABpEkA6iYSuwBUoEgieVOrxLsxsQ,fbPkOYLVPtPgIt0MxizjfFJov3JbHyAi,4,2,1,0,0,0,3,0,6,0.8571428571428571,1,0.0,0,1,0,0,2,0,0,3,0,1,5,1
7220,117469,L3IzrZCeDOJTtm8wqYhXyjKAgit0WIBa,fbPkOYLVPtPgIt0MxizjfFJov3JbHyAi,1,0,0,0,0,0,1,0,1,0.14285714285714285,1,0.0,0,0,0,0,0,0,0,1,0,0,1,1
7221,117471,yDbqTKS1iAgd89Ji6xK8IoXm0GxGr49P,fbPkOYLVPtPgIt0MxizjfFJov3JbHyAi,2,0,0,0,0,0,4,0,4,0.5714285714285714,1,0.0,0,0,0,0,0,0,0,4,0,0,4,1
7222,117473,5eQJepE2igmBlMYZK0syg6BGCi1adOu4,fbPkOYLVPtPgIt0MxizjfFJov3JbHyAi,5,2,1,0,1,0,2,0,6,0.8571428571428571,1,0.0,0,1,0,1,2,0,0,2,0,2,4,1
7223,117474,1HKWuDclbOiSiuIlQVduMPq7fJCJ9Rls,fbPkOYLVPtPgIt0MxizjfFJov3JbHyAi,8,27,10,0,2,0,6,0,45,6.428571428571429,3,0.0,3,10,0,2,24,0,0,6,0,15,30,1
7224,117475,SBljO82TZdHeWzc47l4IthlHIwfXwoH3,fbPkOYLVPtPgIt0MxizjfFJov3JbHyAi,7,5,3,0,3,0,6,0,17,2.4285714285714284,1,0.0,0,3,0,3,5,0,0,6,0,6,11,1
7225,117479,Hc79IVDWbH7OTe9ljIsaEhHZLqPrPrds,fbPkOYLVPtPgIt0MxizjfFJov3JbHyAi,7,4,3,0,3,0,2,0,12,1.7142857142857142,1,0.0,0,3,0,3,4,0,0,2,0,6,6,1
7226,117480,O85WftB5NCrDTb9pXVSgYQyFNgKq9cya,fbPkOYLVPtPgIt0MxizjfFJov3JbHyAi,7,3,2,0,2,0,4,0,11,1.5714285714285714,1,0.0,0,2,0,2,3,0,0,4,0,4,7,1
7227,117481,58Jq6K3XLZtch5ZG85QFaonKOWfQNCcP,fbPkOYLVPtPgIt0MxizjfFJov3JbHyAi,7,3,2,0,2,0,2,0,9,1.2857142857142858,1,0.0,0,2,0,2,3,0,0,2,0,4,5,1
7228,117482,ueh8Q0J414FE7Xmjqeh6AbzlK27RwSRw,fbPkOYLVPtPgIt0MxizjfFJov3JbHyAi,1,0,0,0,0,0,1,0,1,0.14285714285714285,1,0.0,0,0,0,0,0,0,0,1,0,0,1,1
7229,117486,XDj6kE9olAchZwfUS0dXzHZTiPPM5bec,fbPkOYLVPtPgIt0MxizjfFJov3JbHyAi,4,4,2,0,2,0,1,0,9,1.2857142857142858,1,0.0,0,2,0,2,4,0,0,1,0,4,5,1
7230,117487,UvYdE00Z5Ts8a6wK0WxKxxpGT2cAkrRh,fbPkOYLVPtPgIt0MxizjfFJov3JbHyAi,20,82,27,8,18,0,10,0,145,20.714285714285715,5,0.0,24,27,7,18,58,0,1,10,0,76,69,0
7231,117488,1CyCTZgUsAiY8PwSyUmbGce1pgpqezgo,fbPkOYLVPtPgIt0MxizjfFJov3JbHyAi,11,9,6,0,4,1,6,3,29,4.142857142857143,1,0.0,0,6,0,4,9,1,0,6,3,10,19,1
7232,117489,36E8EgprLSCZHQtlY5yjvPm97JUh2cfX,fbPkOYLVPtPgIt0MxizjfFJov3JbHyAi,1,0,0,0,0,0,1,0,1,0.14285714285714285,1,0.0,0,0,0,0,0,0,0,1,0,0,1,1
7233,117490,yCzdfwMA9QCcmr5ztirsmSQYamCmcIS7,fbPkOYLVPtPgIt0MxizjfFJov3JbHyAi,1,0,0,0,0,0,1,0,1,0.14285714285714285,1,0.0,0,0,0,0,0,0,0,1,0,0,1,1
7234,117491,WDD9a1qNUJX21r5OnYzYbe9snqA1PiYA,fbPkOYLVPtPgIt0MxizjfFJov3JbHyAi,9,4,3,0,3,0,2,0,12,1.7142857142857142,1,0.0,0,3,0,3,4,0,0,2,0,6,6,1
7235,117492,nsluEqDvvOEPdz5RzSmy7fU8guuqWKfm,fbPkOYLVPtPgIt0MxizjfFJov3JbHyAi,11,11,7,6,5,0,4,0,33,4.714285714285714,2,0.0,1,7,4,5,10,0,2,4,0,17,16,1
7236,117493,Cn5FQ7TJ9erBCpMOguGrs26OG5h6UtTt,fbPkOYLVPtPgIt0MxizjfFJov3JbHyAi,11,12,5,0,4,0,8,0,29,4.142857142857143,3,0.0,2,5,0,4,10,0,0,8,0,11,18,1
7237,117494,bXLdnFxUVQAW3oOCSdQxNLLTqr9NOtgu,fbPkOYLVPtPgIt0MxizjfFJov3JbHyAi,2,0,0,0,0,0,3,0,3,0.42857142857142855,2,0.0,0,0,0,0,0,0,0,3,0,0,3,1
7238,117495,ETdIqr5m0JR2Poccag4YWGY81ays6ejO,fbPkOYLVPtPgIt0MxizjfFJov3JbHyAi,4,2,0,0,0,0,6,0,8,1.1428571428571428,1,0.0,0,0,0,0,2,0,0,6,0,0,8,1
7239,117496,Hoitr98hXhrf7xDGgACEFamKhiarA3wg,fbPkOYLVPtPgIt0MxizjfFJov3JbHyAi,7,4,2,0,2,0,2,0,10,1.4285714285714286,1,0.0,1,2,0,2,3,0,0,2,0,5,5,0
7240,117501,Djtv0PgEw9uZSQc7WiXmZsJgnFOxrvrt,A3fsA9Zfv1X2fVEQhTw51lKENdNrEqT3,1,0,0,0,0,0,1,0,1,0.14285714285714285,1,0.0,0,0,0,0,0,0,0,1,0,0,1,1
7241,117509,ydSu1htsBf3RzcwY9UTcwNk58kfOh1CK,SpATywNh6bZuzm8s1ceuBUnMUAeoAHHw,15,21,1,12,1,0,7,0,42,6.0,5,0.0,0,1,11,1,21,0,1,7,0,13,29,0
7242,117517,s6b6Agzyi3Or4EEcsJYYkdvPZgCCL57f,A3fsA9Zfv1X2fVEQhTw51lKENdNrEqT3,20,14,9,0,7,0,7,0,37,5.285714285714286,2,0.0,0,9,0,7,14,0,0,7,0,16,21,1
7243,117534,qX3w4IgztgXyu9swieirFObama3kJyza,bWdj2GDclj5ofokWjzoa5jAwMkxCykd6,24,34,3,70,6,0,11,0,124,17.714285714285715,3,0.0,13,3,64,6,21,0,6,11,0,86,38,1
7244,117536,f07Kut7kBpGHis5iRAbMzHKfd6CS5vLr,A3fsA9Zfv1X2fVEQhTw51lKENdNrEqT3,21,85,55,0,4,240,49,3,436,62.285714285714285,7,0.0,5,55,0,4,80,240,0,49,3,64,372,0
7245,117546,EX3gOxFqlG8z0KCJnBCBLiCIiQRkFF4q,A3fsA9Zfv1X2fVEQhTw51lKENdNrEqT3,9,3,2,0,2,0,4,0,11,1.5714285714285714,1,0.0,0,2,0,2,3,0,0,4,0,4,7,1
7246,117552,wKSiPD3ccCI47tDYWhx56Wd2BJP8ki2L,SpATywNh6bZuzm8s1ceuBUnMUAeoAHHw,14,40,12,7,6,10,6,0,81,11.571428571428571,3,0.0,11,12,7,6,29,10,0,6,0,36,45,0
7247,117561,ADL0cXowUMs4wyiAOHKMOrtTHu5tmUqi,A3fsA9Zfv1X2fVEQhTw51lKENdNrEqT3,39,32,17,100,1,0,23,0,173,24.714285714285715,8,0.0,2,17,93,1,30,0,7,23,0,113,60,0
7248,117563,W5xQOH5MemwXn7klqn6rjd1MM4WzuzQi,SpATywNh6bZuzm8s1ceuBUnMUAeoAHHw,16,11,5,20,3,0,4,0,43,6.142857142857143,2,0.0,5,5,17,3,6,0,3,4,0,30,13,0
7249,117586,23MV7Tf2OIT2UG3xeA8mvmRw6rIFBd81,A3fsA9Zfv1X2fVEQhTw51lKENdNrEqT3,30,27,20,6,13,8,22,2,98,14.0,4,0.0,0,20,6,13,27,8,0,22,2,39,59,1
7250,117602,BcsAFxTYYWhC1bNDfK977UfoS17oCWvP,SpATywNh6bZuzm8s1ceuBUnMUAeoAHHw,24,45,3,27,0,4,11,2,92,13.142857142857142,3,0.0,16,3,23,0,29,4,4,11,2,42,50,0
7251,117611,BbvGM92sGSMMIrRMXDFdD1GEnySzXRYT,SpATywNh6bZuzm8s1ceuBUnMUAeoAHHw,20,44,3,32,1,0,7,0,87,12.428571428571429,6,0.0,13,3,30,1,31,0,2,7,0,47,40,0
7252,117616,GLClE8eg40BpWvmEfcSMwSvtSTOkzETn,SpATywNh6bZuzm8s1ceuBUnMUAeoAHHw,12,21,2,19,1,5,8,0,56,8.0,4,0.0,3,2,16,1,18,5,3,8,0,22,34,0
7253,117653,xdxiKeJYKflgdr88D3HSJXuR1e81YpjG,A3fsA9Zfv1X2fVEQhTw51lKENdNrEqT3,25,21,16,0,11,0,7,0,55,7.857142857142857,4,0.0,0,16,0,11,21,0,0,7,0,27,28,1
7254,117664,wbMM6yL6hpsJkBDUrCRoi5Fuo2kgSUdK,SpATywNh6bZuzm8s1ceuBUnMUAeoAHHw,5,3,1,0,1,0,2,0,7,1.0,1,0.0,0,1,0,1,3,0,0,2,0,2,5,1
7255,117668,ZvlB6WVwV84B3g1S1DABzlXirXgL69kV,SpATywNh6bZuzm8s1ceuBUnMUAeoAHHw,14,16,5,19,4,0,12,0,56,8.0,5,0.0,11,5,16,4,5,0,3,12,0,36,20,1
7256,117669,3xN41ERTxK2f1CGWRDLSjBdLqp0aeXRu,SpATywNh6bZuzm8s1ceuBUnMUAeoAHHw,12,30,24,0,0,5,23,3,85,12.142857142857142,2,0.0,0,24,0,0,30,5,0,23,3,24,61,1
7257,117698,JjO25OOm89Iye7MTZHSNIwd1wvv7Llpy,bWdj2GDclj5ofokWjzoa5jAwMkxCykd6,2,0,0,0,0,0,2,0,2,0.2857142857142857,1,0.0,0,0,0,0,0,0,0,2,0,0,2,1
7258,117703,70SrKRY1oWl5d62cNgc8OZe8Ra3cen1a,SpATywNh6bZuzm8s1ceuBUnMUAeoAHHw,26,75,3,37,1,19,19,1,155,22.142857142857142,7,0.0,33,3,32,1,42,19,5,19,1,69,86,0
7259,117730,ZRcEnEYSSBQbkjzMu7sidjbxasfrmw8l,A3fsA9Zfv1X2fVEQhTw51lKENdNrEqT3,38,48,23,78,2,0,11,0,162,23.142857142857142,3,0.0,1,23,62,2,47,0,16,11,0,88,74,0
7260,117732,cQJEH4N9NA86ElT2x4zkE6ToN6rVT4MQ,A3fsA9Zfv1X2fVEQhTw51lKENdNrEqT3,30,24,22,18,16,0,3,0,83,11.857142857142858,3,0.0,0,22,16,16,24,0,2,3,0,54,29,1
7261,117749,yNygMjDRQbsmQrkdzv6Ni3gEhrA9rC9T,G8EPVSXsOYB5YQWZGiz1aVq5Pgr2GrQu,11,26,14,6,2,0,5,0,53,7.571428571428571,3,0.0,7,14,3,2,19,0,3,5,0,26,27,1
7262,117776,8EDi9ELIY5NaafGr5ul94OArAKYSlPLk,SpATywNh6bZuzm8s1ceuBUnMUAeoAHHw,4,2,1,0,1,0,2,0,6,0.8571428571428571,1,0.0,0,1,0,1,2,0,0,2,0,2,4,0
7263,117782,usFuTvFQpKrRjDwn3CiAVcIq4WWtoKl0,RXDvfPUBYFlVdlueBFbLW0mhhAyGEqpt,59,119,77,122,52,136,81,86,673,96.14285714285714,10,0.0,20,77,114,52,99,136,8,81,86,263,410,0
7264,117796,2HxuGhGQGzCNLHdg582isvj2k1uv2pCi,SpATywNh6bZuzm8s1ceuBUnMUAeoAHHw,14,45,1,15,1,14,11,2,89,12.714285714285714,1,0.0,27,1,13,1,18,14,2,11,2,42,47,0
7265,117813,wKbSE55kexrWAbxmePgEr4VHk4YSiEaC,A3fsA9Zfv1X2fVEQhTw51lKENdNrEqT3,1,0,0,0,0,0,1,0,1,0.14285714285714285,1,0.0,0,0,0,0,0,0,0,1,0,0,1,1
7266,117838,E6GtLgX3I7VGOpV74LvaV5V5J9ND1jUQ,SpATywNh6bZuzm8s1ceuBUnMUAeoAHHw,1,0,0,0,0,0,1,0,1,0.14285714285714285,1,0.0,0,0,0,0,0,0,0,1,0,0,1,1
7267,117865,57P5UbCfzn8GLpyzVkqMDPp8kp3hFIaz,bWdj2GDclj5ofokWjzoa5jAwMkxCykd6,9,35,8,0,4,0,9,0,56,8.0,6,0.0,0,8,0,4,35,0,0,9,0,12,44,1
7268,117866,o7ztEzN1VLXMPiKeM3Eu4FDhVLhHjR47,A3fsA9Zfv1X2fVEQhTw51lKENdNrEqT3,17,11,9,0,6,4,3,0,33,4.714285714285714,1,0.0,0,9,0,6,11,4,0,3,0,15,18,1
7269,117906,NoA9xueUUthCTfidqnFplOKsMZsY3DHa,A3fsA9Zfv1X2fVEQhTw51lKENdNrEqT3,39,22,16,68,9,0,9,0,124,17.714285714285715,4,0.0,1,16,62,9,21,0,6,9,0,88,36,1
7270,117907,Z3bFvTwttDZ4bCfkqeyPSBE9NPAPKPqN,SpATywNh6bZuzm8s1ceuBUnMUAeoAHHw,12,34,4,23,0,1,10,0,72,10.285714285714286,5,0.0,10,4,19,0,24,1,4,10,0,33,39,0
7271,117910,QtoTN2OyyTcqe6Us4ENFLFoSg3hJkA40,SpATywNh6bZuzm8s1ceuBUnMUAeoAHHw,18,67,4,17,2,4,20,1,115,16.428571428571427,6,0.0,22,4,14,2,45,4,3,20,1,42,73,0
7272,117927,M45J6fNUaggda3LzoFU6r4v9Do7R8HkV,bWdj2GDclj5ofokWjzoa5jAwMkxCykd6,17,51,40,0,10,8,5,0,114,16.285714285714285,1,0.0,5,40,0,10,46,8,0,5,0,55,59,0
7273,117940,JYCXGTBUXKAgLYAuYSVkBAkWpoJ7TYUE,G8EPVSXsOYB5YQWZGiz1aVq5Pgr2GrQu,46,61,22,72,8,40,40,4,247,35.285714285714285,7,0.0,27,22,44,8,34,40,28,40,4,101,146,0
7274,117944,Lx03w1Z7uki61iSuRTBJrJMgf0kqOIrF,SpATywNh6bZuzm8s1ceuBUnMUAeoAHHw,17,14,6,15,3,7,12,2,59,8.428571428571429,2,0.0,5,6,12,3,9,7,3,12,2,26,33,0
7275,117948,1AlOrbJ2y8dS4ycbJ2sP2OTCfMGEqZ01,SpATywNh6bZuzm8s1ceuBUnMUAeoAHHw,32,60,28,54,10,25,15,2,194,27.714285714285715,2,0.0,24,28,41,10,36,25,13,15,2,103,91,0
7276,117954,jFYWygr5nLqLhHkXltZRkT0S1zQoLEVR,SpATywNh6bZuzm8s1ceuBUnMUAeoAHHw,6,3,2,0,2,0,1,0,8,1.1428571428571428,1,0.0,0,2,0,2,3,0,0,1,0,4,4,0
7277,118025,DBl0Whn7bz7gT7myQMnidYa3zRNL4McA,SpATywNh6bZuzm8s1ceuBUnMUAeoAHHw,12,34,6,21,0,20,14,3,98,14.0,6,0.0,19,6,18,0,15,20,3,14,3,43,55,1
7278,118032,VE9HD5yzeCmqc2pNGfTQWsVbRdaqJBIV,A3fsA9Zfv1X2fVEQhTw51lKENdNrEqT3,4,2,1,0,1,0,1,0,5,0.7142857142857143,1,0.0,0,1,0,1,2,0,0,1,0,2,3,1
7279,118033,86F6XnjIRLQFbYrnQo4SUAq6YeqsWqJH,SpATywNh6bZuzm8s1ceuBUnMUAeoAHHw,17,18,10,15,4,26,17,16,106,15.142857142857142,2,0.0,5,10,12,4,13,26,3,17,16,31,75,1
7280,118051,PHrtg3UspIdS1qc6Vp5GAq4YFnlF3cc7,G8EPVSXsOYB5YQWZGiz1aVq5Pgr2GrQu,8,22,4,4,0,0,6,0,36,5.142857142857143,1,0.0,6,4,2,0,16,0,2,6,0,12,24,1
7281,118083,hJwtwnOzJaTrAeP4eXJAEwz2xbKsgc4M,SpATywNh6bZuzm8s1ceuBUnMUAeoAHHw,4,2,0,0,0,0,12,0,14,2.0,8,0.0,0,0,0,0,2,0,0,12,0,0,14,0
7282,118124,11qZqrXXcQbdqet0TC5DW03t5yp66Tzn,SpATywNh6bZuzm8s1ceuBUnMUAeoAHHw,16,9,6,8,4,0,4,0,31,4.428571428571429,2,0.0,2,6,8,4,7,0,0,4,0,20,11,0
7283,118145,CUEyHbsjLlbX6I7tsbnNjxFI1v5Lj4iD,SpATywNh6bZuzm8s1ceuBUnMUAeoAHHw,20,53,16,6,10,0,11,0,96,13.714285714285714,4,0.0,3,16,6,10,50,0,0,11,0,35,61,0
7284,118153,UwereIH21fVhvJGOSErkxB1cQ9i013xS,SpATywNh6bZuzm8s1ceuBUnMUAeoAHHw,8,5,3,0,2,1,5,3,19,2.7142857142857144,2,0.0,0,3,0,2,5,1,0,5,3,5,14,0
7285,118171,U3R4m4eLMm2lirgI7HLueBKsNpxhFpn9,A3fsA9Zfv1X2fVEQhTw51lKENdNrEqT3,13,9,6,0,3,0,4,0,22,3.142857142857143,3,0.0,0,6,0,3,9,0,0,4,0,9,13,0
7286,118178,qAVFbR5cx9X92KNDPDJmLoSTth8nEsRM,RXDvfPUBYFlVdlueBFbLW0mhhAyGEqpt,68,82,23,184,11,49,25,2,376,53.714285714285715,6,0.0,19,23,165,11,63,49,19,25,2,218,158,0
7287,118222,IONYwfWuSLUzRHMHVpaPTPvGauCNosjD,SpATywNh6bZuzm8s1ceuBUnMUAeoAHHw,8,46,33,0,21,0,14,0,114,16.285714285714285,4,0.0,0,33,0,21,46,0,0,14,0,54,60,1
7288,118237,rT3zpA0g6rjJ1jZXfn6mCIcHmMcmU756,SpATywNh6bZuzm8s1ceuBUnMUAeoAHHw,5,6,5,0,3,7,2,0,23,3.2857142857142856,1,0.0,0,5,0,3,6,7,0,2,0,8,15,1
7289,118260,5rpYxIaCTDb4PhszkJWpACOx5VMpNGcQ,A3fsA9Zfv1X2fVEQhTw51lKENdNrEqT3,50,22,17,64,13,31,19,4,170,24.285714285714285,5,0.0,1,17,53,13,21,31,11,19,4,84,86,1
7290,118267,GyWTABuPpZEqO585EnNTIpM2B2faPYN3,SpATywNh6bZuzm8s1ceuBUnMUAeoAHHw,26,30,18,14,14,2,2,0,80,11.428571428571429,1,0.0,11,18,14,14,19,2,0,2,0,57,23,1
7291,118277,LULTOx14kVdHaym020tyvEUUMDRXiDOf,SpATywNh6bZuzm8s1ceuBUnMUAeoAHHw,5,6,3,0,0,0,7,0,16,2.2857142857142856,1,0.0,0,3,0,0,6,0,0,7,0,3,13,1
7292,118284,iRkGn6DaWx0LZKTkLTjixCrksMnftQiz,SpATywNh6bZuzm8s1ceuBUnMUAeoAHHw,6,5,1,0,1,0,1,0,8,1.1428571428571428,1,0.0,0,1,0,1,5,0,0,1,0,2,6,1
7293,118297,jSCfroddrqNUSCH6KjU0nXMDCSxYb3do,A3fsA9Zfv1X2fVEQhTw51lKENdNrEqT3,1,0,0,0,0,0,1,0,1,0.14285714285714285,1,0.0,0,0,0,0,0,0,0,1,0,0,1,1
7294,118321,vCel5g8zGhrngsDNZ5YOyxEmQk5qV7ac,bWdj2GDclj5ofokWjzoa5jAwMkxCykd6,9,14,0,0,1,5,6,1,27,3.857142857142857,2,0.0,5,0,0,1,9,5,0,6,1,6,21,1
7295,118324,QRV1oI1S8Ffuh8TqoOSVsQ6W4xedCLat,SpATywNh6bZuzm8s1ceuBUnMUAeoAHHw,4,4,0,0,0,0,1,0,5,0.7142857142857143,1,0.0,0,0,0,0,4,0,0,1,0,0,5,0
7296,118328,oyFfPK6y9oPPwQR5mbsXW98FJaEnU88b,RXDvfPUBYFlVdlueBFbLW0mhhAyGEqpt,7,4,3,0,2,0,1,0,10,1.4285714285714286,1,0.0,0,3,0,2,4,0,0,1,0,5,5,1
7297,118336,50cUUtrBaOZeeifZra0Sj4seKRuBEyFS,SpATywNh6bZuzm8s1ceuBUnMUAeoAHHw,16,65,7,20,4,0,4,0,100,14.285714285714286,5,0.0,33,7,16,4,32,0,4,4,0,60,40,0
7298,118363,FOCCuGaJ7zYTl7CCCo7T3PqrLtxGVeiU,SpATywNh6bZuzm8s1ceuBUnMUAeoAHHw,5,2,1,0,1,0,2,0,6,0.8571428571428571,1,0.0,0,1,0,1,2,0,0,2,0,2,4,0
7299,118375,iCakYP1w40pz3A1o7VgcbnomKTMQfUiT,SpATywNh6bZuzm8s1ceuBUnMUAeoAHHw,1,0,0,0,0,0,1,0,1,0.14285714285714285,1,0.0,0,0,0,0,0,0,0,1,0,0,1,1
7300,118395,LVTU4qA4F3wWkxH81iGfu4ZuIt77nyhh,A3fsA9Zfv1X2fVEQhTw51lKENdNrEqT3,6,8,2,0,0,1,8,0,19,2.7142857142857144,2,0.0,0,2,0,0,8,1,0,8,0,2,17,0
7301,118423,9iGaqBGS5kkoXjLd87hUL2eIJMVUVKfU,bWdj2GDclj5ofokWjzoa5jAwMkxCykd6,6,6,3,0,2,0,3,0,14,2.0,2,0.0,0,3,0,2,6,0,0,3,0,5,9,1
7302,118427,ycOAtB1gwFcaAwvsqsJPeGAqm0EVwIDN,G8EPVSXsOYB5YQWZGiz1aVq5Pgr2GrQu,22,23,9,16,6,0,15,0,69,9.857142857142858,2,0.0,11,9,14,6,12,0,2,15,0,40,29,1
7303,118432,LFsOk9gu14yLVtdY9pNmboBkRA6YhVq4,SpATywNh6bZuzm8s1ceuBUnMUAeoAHHw,1,0,0,0,0,0,1,0,1,0.14285714285714285,1,0.0,0,0,0,0,0,0,0,1,0,0,1,1
7304,118433,U4egSBuIz4Tp2aExbhUIhaem6H1lHi4I,A3fsA9Zfv1X2fVEQhTw51lKENdNrEqT3,1,0,0,0,0,0,1,0,1,0.14285714285714285,1,0.0,0,0,0,0,0,0,0,1,0,0,1,0
7305,118453,X285XxvFlCKmuDlV3vzMxZpCu1V9X67P,G8EPVSXsOYB5YQWZGiz1aVq5Pgr2GrQu,26,36,22,10,12,0,5,0,85,12.142857142857142,2,0.0,10,22,9,12,26,0,1,5,0,53,32,1
7306,118469,HlHSVt6QwV3D8zM3oQa4RZqHTHgBTeDb,G8EPVSXsOYB5YQWZGiz1aVq5Pgr2GrQu,3,1,0,0,0,0,2,0,3,0.42857142857142855,1,0.0,0,0,0,0,1,0,0,2,0,0,3,1
7307,118484,grhneBVDCBhvBD53OXACTDGfdH3pEWQ2,SpATywNh6bZuzm8s1ceuBUnMUAeoAHHw,23,36,2,28,0,1,7,1,75,10.714285714285714,4,0.0,11,2,22,0,25,1,6,7,1,35,40,0
7308,118497,D42av4RgpD46CqlOrc3UqYUQGU69fX7w,SpATywNh6bZuzm8s1ceuBUnMUAeoAHHw,10,16,8,7,5,0,1,0,37,5.285714285714286,2,0.0,0,8,6,5,16,0,1,1,0,19,18,1
7309,118517,AADHk2CnqIXqU54SVoJYYzHXkzsT7VVX,SpATywNh6bZuzm8s1ceuBUnMUAeoAHHw,29,120,50,56,4,55,37,17,339,48.42857142857143,7,0.0,46,50,45,4,74,55,11,37,17,145,194,0
7310,118552,bQgvxTEfpKkG7faV4J3DTFNYdIGmaRJn,A3fsA9Zfv1X2fVEQhTw51lKENdNrEqT3,2,0,0,0,0,0,2,0,2,0.2857142857142857,1,0.0,0,0,0,0,0,0,0,2,0,0,2,1
7311,118561,Go1ERHGiNnYVc6rXpAjttQ9IaXemOnqN,A3fsA9Zfv1X2fVEQhTw51lKENdNrEqT3,4,3,2,0,0,0,1,0,6,0.8571428571428571,1,0.0,0,2,0,0,3,0,0,1,0,2,4,1
7312,118567,TQy9wSoPujib2kvNE4TTZJIA8yQmRsFr,bWdj2GDclj5ofokWjzoa5jAwMkxCykd6,3,3,0,0,0,0,1,0,4,0.5714285714285714,1,0.0,0,0,0,0,3,0,0,1,0,0,4,1
7313,118592,RiCs84yGV6JCwVfBOhcXa8oCpUMbIJNf,SpATywNh6bZuzm8s1ceuBUnMUAeoAHHw,27,88,4,37,2,28,30,5,194,27.714285714285715,6,0.0,32,4,34,2,56,28,3,30,5,72,122,0
7314,118594,r0yZNwEG828V0TMkCl61Reya5Y5HO5aR,A3fsA9Zfv1X2fVEQhTw51lKENdNrEqT3,3,3,1,0,0,0,2,0,6,0.8571428571428571,1,0.0,0,1,0,0,3,0,0,2,0,1,5,1
7315,118599,tp9GLoYyljDV6mILQxrtrv1Iw4qcPl5Z,A3fsA9Zfv1X2fVEQhTw51lKENdNrEqT3,7,4,2,0,2,0,3,0,11,1.5714285714285714,1,0.0,1,2,0,2,3,0,0,3,0,5,6,1
7316,118626,sjQQWItXAp5E8ocdOnRRzFCiZKv0PVqn,SpATywNh6bZuzm8s1ceuBUnMUAeoAHHw,17,18,5,11,0,0,4,0,38,5.428571428571429,1,0.0,2,5,10,0,16,0,1,4,0,17,21,0
7317,118629,f4eElh7NTKGsWnUHRO9BuyTOQtrsnWlM,SpATywNh6bZuzm8s1ceuBUnMUAeoAHHw,17,16,9,19,4,0,6,0,54,7.714285714285714,1,0.0,6,9,17,4,10,0,2,6,0,36,18,1
7318,118633,NuFKQkAxfn2PT3wbGN0i3erkBYbjqkix,A3fsA9Zfv1X2fVEQhTw51lKENdNrEqT3,53,15,0,170,0,2,8,1,196,28.0,2,0.0,2,0,148,0,13,2,22,8,1,150,46,0
7319,118651,ANtHTaCISHkEW6ENLanE6G1HEnRFLZdw,SpATywNh6bZuzm8s1ceuBUnMUAeoAHHw,1,0,0,0,0,0,1,0,1,0.14285714285714285,1,0.0,0,0,0,0,0,0,0,1,0,0,1,1
7320,118653,YmAogTXGoaSGS2jBtwsCLUVebiwWGuMB,A3fsA9Zfv1X2fVEQhTw51lKENdNrEqT3,17,18,15,0,13,4,4,0,54,7.714285714285714,3,0.0,0,15,0,13,18,4,0,4,0,28,26,1
7321,118662,ANtHTaCISHkEW6ENLanE6G1HEnRFLZdw,RXDvfPUBYFlVdlueBFbLW0mhhAyGEqpt,3,2,1,0,0,0,1,0,4,0.5714285714285714,1,0.0,0,1,0,0,2,0,0,1,0,1,3,1
7322,118665,eNgDL8k9xOLyBlZ3UNlseJHly8SfPZZu,A3fsA9Zfv1X2fVEQhTw51lKENdNrEqT3,54,86,62,76,30,45,28,1,328,46.857142857142854,9,0.0,6,62,58,30,80,45,18,28,1,156,172,0
7323,118667,oamKaVYtYcTWlWXxR9gjWFZVaqJSv9QD,RXDvfPUBYFlVdlueBFbLW0mhhAyGEqpt,56,120,2,102,31,5,7,0,267,38.142857142857146,3,0.0,76,2,97,31,44,5,5,7,0,206,61,0
7324,118668,vbghp1PVpZxFaWqasEyQzIEfPKBk8vPh,A3fsA9Zfv1X2fVEQhTw51lKENdNrEqT3,12,7,4,0,4,0,3,0,18,2.5714285714285716,2,0.0,1,4,0,4,6,0,0,3,0,9,9,1
7325,118691,DvqqmzfQOqhniG6rRYaSYRCVzVLc6KPG,A3fsA9Zfv1X2fVEQhTw51lKENdNrEqT3,5,3,2,0,1,0,1,0,7,1.0,1,0.0,0,2,0,1,3,0,0,1,0,3,4,1
7326,118692,34Xbf7uBGJ4LnJBXPtvvptwjUQQdkYUg,A3fsA9Zfv1X2fVEQhTw51lKENdNrEqT3,44,70,32,44,8,3,47,2,206,29.428571428571427,6,0.0,6,32,42,8,64,3,2,47,2,88,118,0
7327,118695,DvqqmzfQOqhniG6rRYaSYRCVzVLc6KPG,bWdj2GDclj5ofokWjzoa5jAwMkxCykd6,4,3,1,0,1,0,1,0,6,0.8571428571428571,1,0.0,1,1,0,1,2,0,0,1,0,3,3,1
7328,118713,GzZqgl4giqqW7TCBTX5a2jDyy6Q646Os,SpATywNh6bZuzm8s1ceuBUnMUAeoAHHw,16,39,2,19,2,3,19,3,87,12.428571428571429,3,0.0,13,2,16,2,26,3,3,19,3,33,54,1
7329,118722,DHhoczdtvn37Fynebgh7tMkKtF0dh4jQ,A3fsA9Zfv1X2fVEQhTw51lKENdNrEqT3,1,0,0,0,0,0,1,0,1,0.14285714285714285,1,0.0,0,0,0,0,0,0,0,1,0,0,1,1
7330,118738,I3IAdtd399keUxdhVZ1J3PIkz3kC7zL8,RXDvfPUBYFlVdlueBFbLW0mhhAyGEqpt,2,0,0,0,0,0,2,0,2,0.2857142857142857,1,0.0,0,0,0,0,0,0,0,2,0,0,2,1
7331,118752,v5ZzaFsvASHZHFHDQx30X4bWu2OAn0TJ,bWdj2GDclj5ofokWjzoa5jAwMkxCykd6,11,18,1,30,5,1,7,1,63,9.0,1,0.0,10,1,30,5,8,1,0,7,1,46,17,1
7332,118771,lrp5AGJUh69hKuCI5IYUEU19E2beipwd,A3fsA9Zfv1X2fVEQhTw51lKENdNrEqT3,28,32,3,30,3,2,8,0,78,11.142857142857142,6,0.0,0,3,25,3,32,2,5,8,0,31,47,1
7333,118774,DqNAxwTcrk055KEf1va6hv0cFfrqGSiY,A3fsA9Zfv1X2fVEQhTw51lKENdNrEqT3,7,13,5,0,1,0,2,0,21,3.0,2,0.0,0,5,0,1,13,0,0,2,0,6,15,1
7334,118783,bKVslXuzEQ1pv4c6iV5mVjs6X6avUbmL,G8EPVSXsOYB5YQWZGiz1aVq5Pgr2GrQu,1,0,0,0,0,0,3,0,3,0.42857142857142855,3,0.0,0,0,0,0,0,0,0,3,0,0,3,0
7335,118829,oYXc35V0j0DGRrciqWRUFfGtnQPnDhaQ,A3fsA9Zfv1X2fVEQhTw51lKENdNrEqT3,7,12,1,0,0,0,5,0,18,2.5714285714285716,1,0.0,0,1,0,0,12,0,0,5,0,1,17,1
7336,118876,eLhnZqVqldawLLuaLdbS0XPiIKiZAief,RXDvfPUBYFlVdlueBFbLW0mhhAyGEqpt,27,43,1,0,0,26,18,1,89,12.714285714285714,2,0.0,0,1,0,0,43,26,0,18,1,1,88,0
7337,118879,wuMhhjy7NxtqcBPxbigACLOqg9Xy71R7,SpATywNh6bZuzm8s1ceuBUnMUAeoAHHw,2,0,0,0,0,0,2,0,2,0.2857142857142857,1,0.0,0,0,0,0,0,0,0,2,0,0,2,0
7338,118913,xUhDcXiX03QQg1jNR3Lksh9CrGcRUkPg,A3fsA9Zfv1X2fVEQhTw51lKENdNrEqT3,48,110,59,116,19,116,26,0,446,63.714285714285715,9,0.0,12,59,87,19,98,116,29,26,0,177,269,0
7339,118919,TOHE2cn8sx2ym4g7cRhp3c9gQIpGV4UB,A3fsA9Zfv1X2fVEQhTw51lKENdNrEqT3,1,0,0,0,0,0,1,0,1,0.14285714285714285,1,0.0,0,0,0,0,0,0,0,1,0,0,1,1
7340,118923,FcPFK6OTsUF1j3uNGabdzGTvbY8kcO3D,A3fsA9Zfv1X2fVEQhTw51lKENdNrEqT3,15,14,12,0,8,0,2,0,36,5.142857142857143,2,0.0,0,12,0,8,14,0,0,2,0,20,16,1
7341,118926,efygWYkxxUMOGInRZT4qEeuzMRlIpQq6,SpATywNh6bZuzm8s1ceuBUnMUAeoAHHw,25,46,27,8,14,1,12,0,108,15.428571428571429,4,0.0,11,27,8,14,35,1,0,12,0,60,48,0
7342,118930,fiLsrcAU0ZFm61T8xhRUwb5p8PN605CT,SpATywNh6bZuzm8s1ceuBUnMUAeoAHHw,7,3,2,0,2,0,2,0,9,1.2857142857142858,1,0.0,0,2,0,2,3,0,0,2,0,4,5,1
7343,118931,ZRfFWalEoINhUGe05gZETSGzjQUd6T5n,SpATywNh6bZuzm8s1ceuBUnMUAeoAHHw,14,22,8,13,4,9,3,0,59,8.428571428571429,2,0.0,12,8,10,4,10,9,3,3,0,34,25,1
7344,118943,6hOFMnbpcErHmlwc3MeiSQOkkbkZvsdF,SpATywNh6bZuzm8s1ceuBUnMUAeoAHHw,11,11,4,0,3,1,7,1,27,3.857142857142857,3,0.0,6,4,0,3,5,1,0,7,1,13,14,0
7345,118944,pqKCkJOspd9xXtA4k6IDJS4Js61XmolB,SpATywNh6bZuzm8s1ceuBUnMUAeoAHHw,4,2,1,0,1,0,1,0,5,0.7142857142857143,2,0.0,0,1,0,1,2,0,0,1,0,2,3,1
7346,118950,5eO5trczHn4tezH3o1mHOvzooHGmVWMl,A3fsA9Zfv1X2fVEQhTw51lKENdNrEqT3,11,11,7,0,4,0,4,0,26,3.7142857142857144,3,0.0,0,7,0,4,11,0,0,4,0,11,15,1
7347,118957,28PHU9suTM8EqUKsQwsvQ03DzFXi0yDl,RXDvfPUBYFlVdlueBFbLW0mhhAyGEqpt,1,0,0,0,0,0,3,0,3,0.42857142857142855,2,0.0,0,0,0,0,0,0,0,3,0,0,3,1
7348,118962,UHbjjkoY8eePNp6r324vyfQdD3BvD0KM,G8EPVSXsOYB5YQWZGiz1aVq5Pgr2GrQu,8,5,4,0,1,0,2,0,12,1.7142857142857142,1,0.0,0,4,0,1,5,0,0,2,0,5,7,1
7349,118964,YvVuka2rxSzzYYNnDLtzVMee0hjbsr3Q,SpATywNh6bZuzm8s1ceuBUnMUAeoAHHw,6,4,1,0,1,0,1,0,7,1.0,2,0.0,0,1,0,1,4,0,0,1,0,2,5,1
7350,118966,zQeYO5pZ1xh2UAEMjLOadhLt0hmfHHxb,bWdj2GDclj5ofokWjzoa5jAwMkxCykd6,9,15,7,8,3,1,7,0,41,5.857142857142857,3,0.0,1,7,7,3,14,1,1,7,0,18,23,1
7351,118977,rwmKpdbePJfKvi814EI3msCq1quO9ftl,SpATywNh6bZuzm8s1ceuBUnMUAeoAHHw,6,2,0,0,0,0,5,1,8,1.1428571428571428,1,0.0,0,0,0,0,2,0,0,5,1,0,8,1
7352,118987,u79qFvGauNOAmgDpP2DklDOwG6ISKFXs,SpATywNh6bZuzm8s1ceuBUnMUAeoAHHw,13,32,7,0,3,32,8,2,84,12.0,2,0.0,23,7,0,3,9,32,0,8,2,33,51,1
7353,118993,5R2yvtH9LNaB7I0DFs0y5Dgzft4SPkTz,SpATywNh6bZuzm8s1ceuBUnMUAeoAHHw,27,33,19,32,11,0,12,0,107,15.285714285714286,3,0.0,10,19,29,11,23,0,3,12,0,69,38,1
7354,118995,UoQ0PEeqIO4n6Ln8avpcjf2ZoIAx1YCQ,A3fsA9Zfv1X2fVEQhTw51lKENdNrEqT3,42,30,23,54,17,0,9,0,133,19.0,6,0.0,1,23,49,17,29,0,5,9,0,90,43,0
7355,119001,DXaGQeTbJkNEulVow7g1qYtfMHcxt0Bb,SpATywNh6bZuzm8s1ceuBUnMUAeoAHHw,24,40,2,20,2,18,5,1,88,12.571428571428571,3,0.0,12,2,17,2,28,18,3,5,1,33,55,0
7356,119008,i41wq4JFa1zWjnzk4s4F0u6D3S1UMuDT,bWdj2GDclj5ofokWjzoa5jAwMkxCykd6,1,0,0,0,0,0,1,0,1,0.14285714285714285,1,0.0,0,0,0,0,0,0,0,1,0,0,1,1
7357,119009,c8TFm45r0bfBe26eBlEeUAKDBoTJT9yV,SpATywNh6bZuzm8s1ceuBUnMUAeoAHHw,8,9,0,19,0,0,1,0,29,4.142857142857143,1,0.0,4,0,16,0,5,0,3,1,0,20,9,0
7358,119012,gVK9JFuVehH4w6Ht2Q17t4NUtbNWFPNf,SpATywNh6bZuzm8s1ceuBUnMUAeoAHHw,7,2,0,0,0,0,9,1,12,1.7142857142857142,1,0.0,0,0,0,0,2,0,0,9,1,0,12,1
7359,119026,Pqb8mgUOFwNjSYHZCNAFlv28S1hEJuyW,RXDvfPUBYFlVdlueBFbLW0mhhAyGEqpt,7,3,2,0,1,0,4,0,10,1.4285714285714286,1,0.0,1,2,0,1,2,0,0,4,0,4,6,1
7360,119027,5tL0goZ0bMjNeuGHJZ9VZymSM6PzqaXn,SpATywNh6bZuzm8s1ceuBUnMUAeoAHHw,24,40,22,14,14,12,5,0,107,15.285714285714286,3,0.0,14,22,11,14,26,12,3,5,0,61,46,0
7361,119042,lVwgv61cg8fkhW9rg5b1PIPnuUWxb0Vk,bWdj2GDclj5ofokWjzoa5jAwMkxCykd6,22,33,18,24,8,63,18,3,167,23.857142857142858,6,0.0,5,18,22,8,28,63,2,18,3,53,114,1
7362,119043,D5jAgVwgvpw2Kr66NxyapnkPl0dnzBLu,A3fsA9Zfv1X2fVEQhTw51lKENdNrEqT3,4,2,0,0,0,0,15,0,17,2.4285714285714284,4,0.0,0,0,0,0,2,0,0,15,0,0,17,1
7363,119057,pKoUS2SEKCFMATrFfyk1PMmORYo186Kb,G8EPVSXsOYB5YQWZGiz1aVq5Pgr2GrQu,54,157,3,102,12,1,15,1,291,41.57142857142857,3,0.0,89,3,73,12,68,1,29,15,1,177,114,0
7364,119060,vnVRudtEjYlZLumIJaQJj0f2z3slueSl,SpATywNh6bZuzm8s1ceuBUnMUAeoAHHw,12,15,9,10,5,0,5,0,44,6.285714285714286,1,0.0,2,9,9,5,13,0,1,5,0,25,19,1
7365,119071,pcGXxspzr6LCJz7Udn3jdISDvA5WWes9,G8EPVSXsOYB5YQWZGiz1aVq5Pgr2GrQu,4,3,1,0,0,0,1,0,5,0.7142857142857143,1,0.0,0,1,0,0,3,0,0,1,0,1,4,1
7366,119080,iPvQyQrtKaIWy8V9F09NldCS64KhU7EA,G8EPVSXsOYB5YQWZGiz1aVq5Pgr2GrQu,1,0,0,0,0,0,1,0,1,0.14285714285714285,1,0.0,0,0,0,0,0,0,0,1,0,0,1,1
7367,119090,RwiQ9qTlDDbK4m60mKR4JxmbkQn57Rff,RXDvfPUBYFlVdlueBFbLW0mhhAyGEqpt,19,21,14,0,6,46,11,7,105,15.0,4,0.0,2,14,0,6,19,46,0,11,7,22,83,1
7368,119104,jq4JfpgApzrMRuCNvYDPIsQTWPeEZuhJ,G8EPVSXsOYB5YQWZGiz1aVq5Pgr2GrQu,28,33,5,81,3,29,14,3,168,24.0,2,0.0,11,5,71,3,22,29,10,14,3,90,78,1
7369,119109,PZtj1GnJa5qYIICIjESUcqp401L5vmnR,G8EPVSXsOYB5YQWZGiz1aVq5Pgr2GrQu,21,36,0,58,2,24,17,2,139,19.857142857142858,1,0.0,17,0,48,2,19,24,10,17,2,67,72,1
7370,119117,t1xspb1k3lEGBshWKCwAoW44MsPqXHk5,A3fsA9Zfv1X2fVEQhTw51lKENdNrEqT3,1,0,0,0,0,0,1,0,1,0.14285714285714285,1,0.0,0,0,0,0,0,0,0,1,0,0,1,1
7371,119130,7iwTSJc32zh43nzmRibHZmGv70Vk4Lgo,SpATywNh6bZuzm8s1ceuBUnMUAeoAHHw,5,2,1,0,1,0,4,0,8,1.1428571428571428,1,0.0,0,1,0,1,2,0,0,4,0,2,6,1
7372,119131,NOm4CR7y4Aje7RwR2ZLNwhU4SfabY7lA,SpATywNh6bZuzm8s1ceuBUnMUAeoAHHw,10,63,35,0,3,0,10,0,111,15.857142857142858,2,0.0,20,35,0,3,43,0,0,10,0,58,53,1
7373,119143,YMxXtA5A6XX1bdm998q3OXZqnuIpo8I0,SpATywNh6bZuzm8s1ceuBUnMUAeoAHHw,16,55,22,0,0,27,13,0,117,16.714285714285715,5,0.0,15,22,0,0,40,27,0,13,0,37,80,0
7374,119151,RlfxLmk0H7RVTMayoeG4aa7x6bQD0aZn,SpATywNh6bZuzm8s1ceuBUnMUAeoAHHw,4,2,1,0,1,0,1,0,5,0.7142857142857143,1,0.0,0,1,0,1,2,0,0,1,0,2,3,1
7375,119152,xJut5jnrMH6sobZn5JCJO1JseLVZmDHM,SpATywNh6bZuzm8s1ceuBUnMUAeoAHHw,11,15,6,0,4,0,3,0,28,4.0,1,0.0,0,6,0,4,15,0,0,3,0,10,18,1
7376,119159,rbbo6gYUB5I1wwOafpQCdj4m6UPXHmsz,SpATywNh6bZuzm8s1ceuBUnMUAeoAHHw,8,25,8,0,2,6,10,3,54,7.714285714285714,4,0.0,8,8,0,2,17,6,0,10,3,18,36,0
7377,119170,kd67Lm5QGeYWxcKJYnacCNFbyj5NIxDh,SpATywNh6bZuzm8s1ceuBUnMUAeoAHHw,14,21,3,39,1,0,3,0,67,9.571428571428571,2,0.0,14,3,31,1,7,0,8,3,0,49,18,0
7378,119185,mu7Zdr1ChN6xNMWE8Otd7Si7TQhm7pEQ,SpATywNh6bZuzm8s1ceuBUnMUAeoAHHw,10,32,9,0,6,0,18,1,66,9.428571428571429,5,0.0,2,9,0,6,30,0,0,18,1,17,49,0
7379,119190,oUj6dSGxHzsnU6uTXKwTomk9vwlHt6j0,G8EPVSXsOYB5YQWZGiz1aVq5Pgr2GrQu,15,15,11,0,7,0,6,0,39,5.571428571428571,3,0.0,0,11,0,7,15,0,0,6,0,18,21,1
7380,119192,NoA9xueUUthCTfidqnFplOKsMZsY3DHa,SpATywNh6bZuzm8s1ceuBUnMUAeoAHHw,26,43,18,26,8,0,8,0,103,14.714285714285714,3,0.0,10,18,25,8,33,0,1,8,0,61,42,1
7381,119203,PZqGQ10gijeZZaXj244FlA0iYVn9rzPC,SpATywNh6bZuzm8s1ceuBUnMUAeoAHHw,5,2,1,0,1,0,2,0,6,0.8571428571428571,1,0.0,0,1,0,1,2,0,0,2,0,2,4,1
7382,119204,okqN4nBVKRYYrkYonKicKGOmPqVGYjZh,G8EPVSXsOYB5YQWZGiz1aVq5Pgr2GrQu,8,11,4,0,1,0,10,0,26,3.7142857142857144,3,0.0,0,4,0,1,11,0,0,10,0,5,21,0
7383,119208,BnCTRJ1O4fVqlnxTGriZkJ9JZEc8p58K,A3fsA9Zfv1X2fVEQhTw51lKENdNrEqT3,1,0,0,0,0,0,2,0,2,0.2857142857142857,1,0.0,0,0,0,0,0,0,0,2,0,0,2,1
7384,119212,ttJwJCfGlOpWVOx9vRULE7UdoGyFI9Ut,SpATywNh6bZuzm8s1ceuBUnMUAeoAHHw,5,6,3,0,2,0,1,0,12,1.7142857142857142,1,0.0,2,3,0,2,4,0,0,1,0,7,5,1
7385,119217,UbE5C1Pto1KvqgPPDmGO0svv7BwAZk15,G8EPVSXsOYB5YQWZGiz1aVq5Pgr2GrQu,9,7,4,0,4,0,2,0,17,2.4285714285714284,1,0.0,0,4,0,4,7,0,0,2,0,8,9,1
7386,119224,ieJctBgJj74PFo2P7ymmdVzAX2v62LKu,G8EPVSXsOYB5YQWZGiz1aVq5Pgr2GrQu,12,11,5,0,4,0,6,0,26,3.7142857142857144,1,0.0,0,5,0,4,11,0,0,6,0,9,17,1
7387,119237,63TreuteShRAITxpj6URpYIQ3kURzPmt,bWdj2GDclj5ofokWjzoa5jAwMkxCykd6,8,9,1,0,1,10,7,1,29,4.142857142857143,1,0.0,2,1,0,1,7,10,0,7,1,4,25,1
7388,119239,okqN4nBVKRYYrkYonKicKGOmPqVGYjZh,bWdj2GDclj5ofokWjzoa5jAwMkxCykd6,8,30,14,0,0,13,21,0,78,11.142857142857142,5,0.0,1,14,0,0,29,13,0,21,0,15,63,0
7389,119243,q3pPbgY0JhPpTgQfSrEbBAWd7rbmYjI4,SpATywNh6bZuzm8s1ceuBUnMUAeoAHHw,23,68,2,34,2,6,17,0,129,18.428571428571427,3,0.0,17,2,32,2,51,6,2,17,0,53,76,0
7390,119245,7RIgMHzHpMzY7qBXHPj6WiDKK3U9H2Wz,SpATywNh6bZuzm8s1ceuBUnMUAeoAHHw,22,44,32,0,20,0,27,1,124,17.714285714285715,7,0.0,0,32,0,20,44,0,0,27,1,52,72,0
7391,119251,qujx8xRYXJGJrQ3ruvaaTF7TTwy8KaeC,G8EPVSXsOYB5YQWZGiz1aVq5Pgr2GrQu,9,5,3,0,1,0,4,0,13,1.8571428571428572,1,0.0,0,3,0,1,5,0,0,4,0,4,9,1
7392,119265,8oiFYmMp7IOF1mfFRmhZ7Lug8ImrhTTO,SpATywNh6bZuzm8s1ceuBUnMUAeoAHHw,18,31,13,21,5,9,8,0,87,12.428571428571429,4,0.0,11,13,18,5,20,9,3,8,0,47,40,1
7393,119266,iacqYcgHTn7FZ8NE4roe5kgAUjDF0efr,SpATywNh6bZuzm8s1ceuBUnMUAeoAHHw,26,41,25,19,16,6,24,1,132,18.857142857142858,4,0.0,10,25,16,16,31,6,3,24,1,67,65,0
7394,119267,4eT20gUbOYkq3qXZQOFYEeSPNFVVnLrB,A3fsA9Zfv1X2fVEQhTw51lKENdNrEqT3,2,0,0,0,0,0,2,0,2,0.2857142857142857,1,0.0,0,0,0,0,0,0,0,2,0,0,2,1
7395,119288,NDGU2YEumOCOuP8YkbdyT4JHlfK2eImX,SpATywNh6bZuzm8s1ceuBUnMUAeoAHHw,9,6,4,0,2,0,2,0,14,2.0,1,0.0,0,4,0,2,6,0,0,2,0,6,8,1
7396,119289,ch9jXib8D5Z69PRYwp1WHAUa7SmEdgIr,SpATywNh6bZuzm8s1ceuBUnMUAeoAHHw,18,19,7,11,3,1,10,2,53,7.571428571428571,1,0.0,10,7,11,3,9,1,0,10,2,31,22,1
7397,119290,AJAawUTIK5tTWvBfm3QRQhh9S7SsRdRA,SpATywNh6bZuzm8s1ceuBUnMUAeoAHHw,10,8,2,0,2,1,5,1,19,2.7142857142857144,2,0.0,0,2,0,2,8,1,0,5,1,4,15,1
7398,119293,845wZKTJiCD0zuzvTs70K7NaBfTnltXS,SpATywNh6bZuzm8s1ceuBUnMUAeoAHHw,7,2,1,0,1,10,4,1,19,2.7142857142857144,1,0.0,0,1,0,1,2,10,0,4,1,2,17,1
7399,119294,tdyEqQ928g4zwLz7u1XUELM0nW67gqKU,G8EPVSXsOYB5YQWZGiz1aVq5Pgr2GrQu,28,97,44,42,11,5,27,1,227,32.42857142857143,4,0.0,22,44,40,11,75,5,2,27,1,117,110,1
7400,119295,yuOMBhnDAvRSNCNkI5M8rpsRFdq6dg7T,RXDvfPUBYFlVdlueBFbLW0mhhAyGEqpt,4,2,1,0,1,0,1,0,5,0.7142857142857143,1,0.0,0,1,0,1,2,0,0,1,0,2,3,1
7401,119300,1P5MvFqtZDoED6FWgTnhCj192U5gDdPF,G8EPVSXsOYB5YQWZGiz1aVq5Pgr2GrQu,12,12,0,6,0,19,7,1,45,6.428571428571429,1,0.0,8,0,5,0,4,19,1,7,1,13,32,0
7402,119305,kLbYKjAePyQg6GOXHiVGeoyhhDvXEfjN,SpATywNh6bZuzm8s1ceuBUnMUAeoAHHw,25,53,3,32,1,36,19,7,151,21.571428571428573,5,0.0,25,3,28,1,28,36,4,19,7,57,94,0
7403,119309,kWr0BhoQMxiu9wSeKhtyX0T1P5JfsERH,SpATywNh6bZuzm8s1ceuBUnMUAeoAHHw,31,42,21,39,7,67,39,2,217,31.0,9,0.0,5,21,35,7,37,67,4,39,2,68,149,0
7404,119325,grNuFIQJF1sOOkw8RJjaExhlwTJt52uU,SpATywNh6bZuzm8s1ceuBUnMUAeoAHHw,31,88,38,24,8,149,46,2,355,50.714285714285715,8,0.0,20,38,23,8,68,149,1,46,2,89,266,0
7405,119330,Xx6t23p3XIha0hNmBziFcHG3GcEwTmQl,SpATywNh6bZuzm8s1ceuBUnMUAeoAHHw,29,28,17,25,9,29,36,2,146,20.857142857142858,1,0.0,7,17,22,9,21,29,3,36,2,55,91,0
7406,119332,FEK5BtdsP2RwxkLYp7U5A0VI3SgJyNlk,SpATywNh6bZuzm8s1ceuBUnMUAeoAHHw,5,7,1,0,1,0,1,0,10,1.4285714285714286,2,0.0,0,1,0,1,7,0,0,1,0,2,8,1
7407,119349,loZxBAFxFplmuCNvi9UHlWI1qnWbS4Xp,A3fsA9Zfv1X2fVEQhTw51lKENdNrEqT3,7,2,1,0,1,0,9,1,14,2.0,2,0.0,0,1,0,1,2,0,0,9,1,2,12,1
7408,119359,DhNEa94k5xGKWUPgWcx5F0CO6u6J4iIb,G8EPVSXsOYB5YQWZGiz1aVq5Pgr2GrQu,33,57,28,96,17,17,11,2,228,32.57142857142857,2,0.0,26,28,75,17,31,17,21,11,2,146,82,1
7409,119361,d0czHY9SleKhWFZVHkBc11jXgenCfeaE,SpATywNh6bZuzm8s1ceuBUnMUAeoAHHw,18,26,20,0,12,7,16,7,88,12.571428571428571,2,0.0,0,20,0,12,26,7,0,16,7,32,56,1
7410,119368,WfocL88obqufkiW8V6EsVJAto3ptM4se,RXDvfPUBYFlVdlueBFbLW0mhhAyGEqpt,13,9,0,0,0,2,11,2,24,3.4285714285714284,2,0.0,0,0,0,0,9,2,0,11,2,0,24,1
7411,119369,w0JXf5IU53zIrRHN4nASHPBtvGw0J3e8,SpATywNh6bZuzm8s1ceuBUnMUAeoAHHw,1,0,0,0,0,0,1,0,1,0.14285714285714285,1,0.0,0,0,0,0,0,0,0,1,0,0,1,1
7412,119372,RwvuGEh3euIR11rktJrGBhzDqcQMkhOC,SpATywNh6bZuzm8s1ceuBUnMUAeoAHHw,30,64,32,16,14,0,19,1,146,20.857142857142858,7,0.0,21,32,15,14,43,0,1,19,1,82,64,0
7413,119382,tiXCEdgwB1xd20Vy4mgIvE207fd2jlXf,SpATywNh6bZuzm8s1ceuBUnMUAeoAHHw,28,35,15,30,8,0,4,0,92,13.142857142857142,2,0.0,17,15,28,8,18,0,2,4,0,68,24,1
7414,119383,v2tR5cCXv44SOe8Z266q9U5FU2iAwtD3,SpATywNh6bZuzm8s1ceuBUnMUAeoAHHw,20,16,11,4,7,0,6,0,44,6.285714285714286,1,0.0,6,11,4,7,10,0,0,6,0,28,16,1
7415,119395,W4swLEiF6xa4CU1Ee5z4jQMNXyEDiyxR,A3fsA9Zfv1X2fVEQhTw51lKENdNrEqT3,8,2,0,0,0,7,7,1,17,2.4285714285714284,1,0.0,0,0,0,0,2,7,0,7,1,0,17,1
7416,119401,rSKz43hYiPnNMTLyx15fL1ocrthBLweg,SpATywNh6bZuzm8s1ceuBUnMUAeoAHHw,6,10,4,0,2,5,4,0,25,3.5714285714285716,2,0.0,3,4,0,2,7,5,0,4,0,9,16,1
7417,119406,qL29jh1ARNpuNbjWhIJAl20fDBQmsVJq,A3fsA9Zfv1X2fVEQhTw51lKENdNrEqT3,1,0,0,0,0,0,1,0,1,0.14285714285714285,1,0.0,0,0,0,0,0,0,0,1,0,0,1,1
7418,119408,TDRTbyk0dkUIgXlX1DR0wEGLNYKbj2kE,SpATywNh6bZuzm8s1ceuBUnMUAeoAHHw,5,7,2,0,1,0,1,0,11,1.5714285714285714,1,0.0,2,2,0,1,5,0,0,1,0,5,6,0
7419,119413,HNjmezOX8bu6iW67SYkfKBzixQs4v7AY,SpATywNh6bZuzm8s1ceuBUnMUAeoAHHw,17,25,11,10,3,13,10,1,73,10.428571428571429,2,0.0,10,11,10,3,15,13,0,10,1,34,39,0
7420,119422,8bsgdKFaSfwROHIZCKXm97BMUW4OFzed,SpATywNh6bZuzm8s1ceuBUnMUAeoAHHw,27,24,12,22,7,1,6,0,72,10.285714285714286,3,0.0,9,12,18,7,15,1,4,6,0,46,26,0
7421,119437,WnuLHUQ0J3BeGgl165qL2l7BKuVDR3LS,RXDvfPUBYFlVdlueBFbLW0mhhAyGEqpt,48,62,4,129,4,2,10,2,213,30.428571428571427,3,0.0,12,4,121,4,50,2,8,10,2,141,72,0
7422,119446,XvNNzv39b8VqKid0q4fV9ms2wVNAdWks,A3fsA9Zfv1X2fVEQhTw51lKENdNrEqT3,1,0,0,0,0,0,1,0,1,0.14285714285714285,1,0.0,0,0,0,0,0,0,0,1,0,0,1,1
7423,119456,72z519PMt8GGBXLvF1FG0oMJuciCSWYJ,RXDvfPUBYFlVdlueBFbLW0mhhAyGEqpt,51,76,8,148,7,6,19,0,264,37.714285714285715,9,0.0,11,8,130,7,65,6,18,19,0,156,108,1
7424,119461,6ZwHbtvdiS8islxnPJXOOnLtMpvU3IpT,SpATywNh6bZuzm8s1ceuBUnMUAeoAHHw,18,26,14,0,11,0,10,2,63,9.0,5,0.0,3,14,0,11,23,0,0,10,2,28,35,0
7425,119482,S2q1gEPtloNcMfcAwTCrDjaeEJ3ox2aC,A3fsA9Zfv1X2fVEQhTw51lKENdNrEqT3,44,57,40,94,25,3,12,0,231,33.0,5,0.0,4,40,72,25,53,3,22,12,0,141,90,1
7426,119493,50aSuabL02e7lLNBHTRXsMQnBChV2lSX,G8EPVSXsOYB5YQWZGiz1aVq5Pgr2GrQu,4,2,0,0,0,0,2,0,4,0.5714285714285714,1,0.0,0,0,0,0,2,0,0,2,0,0,4,1
7427,119496,HJsFc87NFCDg5yRkkakXIT7nSH8XGxhF,A3fsA9Zfv1X2fVEQhTw51lKENdNrEqT3,9,4,3,0,3,0,2,0,12,1.7142857142857142,1,0.0,0,3,0,3,4,0,0,2,0,6,6,1
7428,119501,iWlNj0RlfLQkFgeY87o4tMiHnUMI1yTI,G8EPVSXsOYB5YQWZGiz1aVq5Pgr2GrQu,10,15,5,14,5,0,3,0,42,6.0,3,0.0,8,5,9,5,7,0,5,3,0,27,15,1
7429,119515,0mqsqXT4HPDOQPxpDnEoZEe1KeuUzpQx,SpATywNh6bZuzm8s1ceuBUnMUAeoAHHw,25,70,10,31,7,1,18,0,137,19.571428571428573,8,0.0,13,10,27,7,57,1,4,18,0,57,80,0
7430,119520,ZQcWT47pZxjNboL0V0inwxjvImMCbKfc,SpATywNh6bZuzm8s1ceuBUnMUAeoAHHw,28,114,33,28,13,0,20,0,208,29.714285714285715,7,0.0,6,33,23,13,108,0,5,20,0,75,133,0
7431,119528,BnWzYOrzXkQQKpdPflOsG06i68fZaDTp,SpATywNh6bZuzm8s1ceuBUnMUAeoAHHw,8,5,0,0,0,0,6,0,11,1.5714285714285714,1,0.0,0,0,0,0,5,0,0,6,0,0,11,1
7432,119537,OHgepWjzcLmDHpgOxR6c8DhDBUqi1HDm,G8EPVSXsOYB5YQWZGiz1aVq5Pgr2GrQu,2,0,0,0,0,0,2,0,2,0.2857142857142857,1,0.0,0,0,0,0,0,0,0,2,0,0,2,1
7433,119540,OHgepWjzcLmDHpgOxR6c8DhDBUqi1HDm,bWdj2GDclj5ofokWjzoa5jAwMkxCykd6,7,2,1,0,1,0,4,0,8,1.1428571428571428,1,0.0,0,1,0,1,2,0,0,4,0,2,6,1
7434,119544,NHjxa47feJ9sWQnmg6HoO6L78eHIRwnl,A3fsA9Zfv1X2fVEQhTw51lKENdNrEqT3,3,2,0,0,0,0,1,0,3,0.42857142857142855,1,0.0,0,0,0,0,2,0,0,1,0,0,3,1
7435,119547,NHjxa47feJ9sWQnmg6HoO6L78eHIRwnl,RXDvfPUBYFlVdlueBFbLW0mhhAyGEqpt,16,24,1,0,0,0,7,0,32,4.571428571428571,2,0.0,1,1,0,0,23,0,0,7,0,2,30,1
7436,119555,72z519PMt8GGBXLvF1FG0oMJuciCSWYJ,A3fsA9Zfv1X2fVEQhTw51lKENdNrEqT3,7,8,1,0,1,0,1,0,11,1.5714285714285714,1,0.0,0,1,0,1,8,0,0,1,0,2,9,0
7437,119556,ZQcWT47pZxjNboL0V0inwxjvImMCbKfc,A3fsA9Zfv1X2fVEQhTw51lKENdNrEqT3,54,93,29,68,14,0,24,1,229,32.714285714285715,6,0.0,2,29,58,14,91,0,10,24,1,103,126,1
7438,119563,HbDZBLuVJ2GX78KybFnufJtg8yn0zj71,SpATywNh6bZuzm8s1ceuBUnMUAeoAHHw,24,22,17,17,11,0,3,0,70,10.0,2,0.0,3,17,13,11,19,0,4,3,0,44,26,1
7439,119570,vuz6r1wL6cSmPMYDw5wsdIxwDVSbQPGA,SpATywNh6bZuzm8s1ceuBUnMUAeoAHHw,15,21,13,16,5,1,4,0,60,8.571428571428571,2,0.0,5,13,14,5,16,1,2,4,0,37,23,1
7440,119577,ZtIdVQN3EYruDP82MkDXBV4HsWJ99nHc,SpATywNh6bZuzm8s1ceuBUnMUAeoAHHw,17,12,1,12,0,7,17,1,50,7.142857142857143,3,0.0,0,1,10,0,12,7,2,17,1,11,39,1
7441,119580,TnET23MWjnuobi5dYEzVGlV9qd1ZWPbL,A3fsA9Zfv1X2fVEQhTw51lKENdNrEqT3,11,39,3,0,1,0,2,0,45,6.428571428571429,1,0.0,0,3,0,1,39,0,0,2,0,4,41,0
7442,119590,hWuNPhEBxnKOOJFguUTUYW5SrQ5ZI8jY,SpATywNh6bZuzm8s1ceuBUnMUAeoAHHw,5,2,1,0,1,0,2,0,6,0.8571428571428571,1,0.0,0,1,0,1,2,0,0,2,0,2,4,1
7443,119595,GPzUdrAeOhUs39B3OZTNuOkoEWda0QRy,G8EPVSXsOYB5YQWZGiz1aVq5Pgr2GrQu,9,6,0,0,0,3,10,0,19,2.7142857142857144,1,0.0,0,0,0,0,6,3,0,10,0,0,19,1
7444,119601,VW1NSXHsRBHsQFDrAdwMVKxbl0FK1kSa,SpATywNh6bZuzm8s1ceuBUnMUAeoAHHw,4,5,1,0,0,0,2,0,8,1.1428571428571428,1,0.0,0,1,0,0,5,0,0,2,0,1,7,0
7445,119603,RwVsCYe1en11KhE66sG3vEW9DQBctFlb,SpATywNh6bZuzm8s1ceuBUnMUAeoAHHw,14,25,9,15,4,0,4,0,57,8.142857142857142,3,0.0,13,9,14,4,12,0,1,4,0,40,17,1
7446,119629,nIvIddlMAmTQagaACOulbZ6PInxlyOy2,G8EPVSXsOYB5YQWZGiz1aVq5Pgr2GrQu,1,0,0,0,0,0,1,0,1,0.14285714285714285,1,0.0,0,0,0,0,0,0,0,1,0,0,1,1
7447,119630,nIvIddlMAmTQagaACOulbZ6PInxlyOy2,RXDvfPUBYFlVdlueBFbLW0mhhAyGEqpt,1,0,0,0,0,0,1,0,1,0.14285714285714285,1,0.0,0,0,0,0,0,0,0,1,0,0,1,1
7448,119633,owff2SMFy8taj2Sp3iBe2dPorkqov8kW,SpATywNh6bZuzm8s1ceuBUnMUAeoAHHw,29,54,32,22,19,16,22,5,170,24.285714285714285,8,0.0,9,32,18,19,45,16,4,22,5,78,92,0
7449,119636,ocTIjxG8zBs0mQRpUtpuAKc7MDpzU7Sd,RXDvfPUBYFlVdlueBFbLW0mhhAyGEqpt,5,2,1,0,1,0,3,0,7,1.0,1,0.0,0,1,0,1,2,0,0,3,0,2,5,1
7450,119662,sImBATl7O8yGkyet4MbeHdX4JDcSvSmd,SpATywNh6bZuzm8s1ceuBUnMUAeoAHHw,6,4,1,0,1,0,2,0,8,1.1428571428571428,1,0.0,0,1,0,1,4,0,0,2,0,2,6,1
7451,119668,Iydx83GAroCbGGGXrOpRJJuSwZtmEEM2,G8EPVSXsOYB5YQWZGiz1aVq5Pgr2GrQu,4,2,1,0,1,2,1,0,7,1.0,1,0.0,0,1,0,1,2,2,0,1,0,2,5,0
7452,119670,zVRAzbnjBCQDkq8v9znUSK3YAm6GKwXz,SpATywNh6bZuzm8s1ceuBUnMUAeoAHHw,13,18,1,6,0,1,6,1,33,4.714285714285714,1,0.0,2,1,5,0,16,1,1,6,1,8,25,0
7453,119681,528WImnBRwlpaJrHx5YESmcymECT8QVd,SpATywNh6bZuzm8s1ceuBUnMUAeoAHHw,7,6,4,0,3,0,2,0,15,2.142857142857143,1,0.0,0,4,0,3,6,0,0,2,0,7,8,1
7454,119685,OOIu03NBEHePUSUIFa86FGFP5M136EAn,SpATywNh6bZuzm8s1ceuBUnMUAeoAHHw,25,43,15,12,7,0,7,0,84,12.0,4,0.0,15,15,12,7,28,0,0,7,0,49,35,0
7455,119699,poqFOGQT2LdvIPHVhQsrQlPpawp1crlg,RXDvfPUBYFlVdlueBFbLW0mhhAyGEqpt,24,90,39,11,35,5,2,0,182,26.0,4,0.0,0,39,10,35,90,5,1,2,0,84,98,0
7456,119700,6PXcyDdGgas03jfN9GNBg7eDbTNLi58b,A3fsA9Zfv1X2fVEQhTw51lKENdNrEqT3,42,27,13,66,9,0,8,0,123,17.571428571428573,1,0.0,2,13,56,9,25,0,10,8,0,80,43,1
7457,119705,jyrCU8C7BRBPvFcEuIthOI2idRHtzC9e,RXDvfPUBYFlVdlueBFbLW0mhhAyGEqpt,3,0,0,0,0,0,3,0,3,0.42857142857142855,1,0.0,0,0,0,0,0,0,0,3,0,0,3,1
7458,119706,4aBimyYkJ2UKqGpkp7oZ1zAX2svcfueq,SpATywNh6bZuzm8s1ceuBUnMUAeoAHHw,16,16,6,19,4,0,2,0,47,6.714285714285714,2,0.0,10,6,17,4,6,0,2,2,0,37,10,1
7459,119713,6PXcyDdGgas03jfN9GNBg7eDbTNLi58b,bWdj2GDclj5ofokWjzoa5jAwMkxCykd6,2,0,0,0,0,0,2,0,2,0.2857142857142857,1,0.0,0,0,0,0,0,0,0,2,0,0,2,1
7460,119718,GB4yB9EIEjt1Ja66w5VOBhvDfHhUpkZn,G8EPVSXsOYB5YQWZGiz1aVq5Pgr2GrQu,14,13,9,0,8,0,4,0,34,4.857142857142857,3,0.0,0,9,0,8,13,0,0,4,0,17,17,1
7461,119720,k6RJ44LpfDefc4BqSfb5Ks3bqRLzpbPs,A3fsA9Zfv1X2fVEQhTw51lKENdNrEqT3,14,12,0,10,0,0,4,0,26,3.7142857142857144,2,0.0,0,0,9,0,12,0,1,4,0,9,17,1
7462,119726,crYeYmekM522NBCXMSSwnlz38sA9PXwb,SpATywNh6bZuzm8s1ceuBUnMUAeoAHHw,1,0,0,0,0,0,1,0,1,0.14285714285714285,1,0.0,0,0,0,0,0,0,0,1,0,0,1,1
7463,119730,6ap3DhKROc7tFODwClFOjVJl3s3EA3mu,G8EPVSXsOYB5YQWZGiz1aVq5Pgr2GrQu,18,32,21,10,22,0,24,0,109,15.571428571428571,5,0.0,7,21,7,22,25,0,3,24,0,57,52,1
7464,119735,7spTo5lIRwZxDBcGilRyFIwiDfkCxjQE,SpATywNh6bZuzm8s1ceuBUnMUAeoAHHw,20,38,1,24,0,22,13,0,98,14.0,4,0.0,16,1,20,0,22,22,4,13,0,37,61,1
7465,119738,mu5O3Y2ITikjmKkPmDursRzlvrhHDXTz,SpATywNh6bZuzm8s1ceuBUnMUAeoAHHw,2,0,0,0,0,0,2,0,2,0.2857142857142857,1,0.0,0,0,0,0,0,0,0,2,0,0,2,1
7466,119742,PHTS4r6mOEHpVZfm3SzAd9KLg785EPpx,SpATywNh6bZuzm8s1ceuBUnMUAeoAHHw,25,70,32,12,12,52,22,2,202,28.857142857142858,9,0.0,4,32,12,12,66,52,0,22,2,60,142,0
7467,119748,wIXH3gEY2v8CIGUg8D6sapoHRbIUXs86,SpATywNh6bZuzm8s1ceuBUnMUAeoAHHw,20,19,1,17,0,1,2,0,40,5.714285714285714,1,0.0,5,1,17,0,14,1,0,2,0,23,17,1
7468,119749,r81fu0o4ondjTT64GPXMD4igVXZTnWR1,G8EPVSXsOYB5YQWZGiz1aVq5Pgr2GrQu,15,18,1,22,0,0,4,0,45,6.428571428571429,2,0.0,3,1,17,0,15,0,5,4,0,21,24,1
7469,119758,VbCHzxhJd8ennilHHm3zMG389MZjcR4g,SpATywNh6bZuzm8s1ceuBUnMUAeoAHHw,28,30,14,30,8,10,7,0,99,14.142857142857142,7,0.0,10,14,28,8,20,10,2,7,0,60,39,0
7470,119759,eXv6ACzt62C4hMSoDSIQMvmz4LEnGBtm,SpATywNh6bZuzm8s1ceuBUnMUAeoAHHw,16,44,17,42,0,23,29,4,159,22.714285714285715,7,0.0,16,17,33,0,28,23,9,29,4,66,93,0
7471,119765,pTILTxXRSQA3FxWLi5P70kOpV3SZ6Qdg,SpATywNh6bZuzm8s1ceuBUnMUAeoAHHw,1,0,0,0,0,0,1,0,1,0.14285714285714285,1,0.0,0,0,0,0,0,0,0,1,0,0,1,1
7472,119767,OXe0TiHLRyjl3AO2ffihLeA3ZfDF07jU,SpATywNh6bZuzm8s1ceuBUnMUAeoAHHw,12,12,3,0,2,0,2,0,19,2.7142857142857144,2,0.0,0,3,0,2,12,0,0,2,0,5,14,1
7473,119775,Hvo87huFBpCunolEWjcvbDUcmX9h25rT,SpATywNh6bZuzm8s1ceuBUnMUAeoAHHw,30,37,23,9,13,1,10,1,94,13.428571428571429,2,0.0,6,23,9,13,31,1,0,10,1,51,43,1
7474,119777,6r9w9XrCXpAInFHxfDIxOD9m18cX5jcd,SpATywNh6bZuzm8s1ceuBUnMUAeoAHHw,9,9,1,0,1,0,3,0,14,2.0,1,0.0,0,1,0,1,9,0,0,3,0,2,12,1
7475,119783,XRCyFAenNfq06SRijoW2bL3eLeq7TTnH,SpATywNh6bZuzm8s1ceuBUnMUAeoAHHw,2,0,0,0,0,0,2,0,2,0.2857142857142857,1,0.0,0,0,0,0,0,0,0,2,0,0,2,1
7476,119789,s5PM22AMhoKbdj4BvXCXSb2DG7kHVY83,bWdj2GDclj5ofokWjzoa5jAwMkxCykd6,7,9,2,0,1,0,1,0,13,1.8571428571428572,1,0.0,0,2,0,1,9,0,0,1,0,3,10,1
7477,119791,WdCL06lQKY0BoTH9YYJuYqUtT5XtLkKl,A3fsA9Zfv1X2fVEQhTw51lKENdNrEqT3,1,0,0,0,0,0,1,0,1,0.14285714285714285,1,0.0,0,0,0,0,0,0,0,1,0,0,1,1
7478,119801,jORRvCSUTQr1FHykD1dmWMVMdAoKMUmG,RXDvfPUBYFlVdlueBFbLW0mhhAyGEqpt,8,3,2,0,2,0,4,1,12,1.7142857142857142,1,0.0,0,2,0,2,3,0,0,4,1,4,8,1
7479,119802,pgn1580cn8cQemEJzrm47II2SqctZZrK,G8EPVSXsOYB5YQWZGiz1aVq5Pgr2GrQu,34,22,17,0,16,0,2,0,57,8.142857142857142,2,0.0,0,17,0,16,22,0,0,2,0,33,24,0
7480,119807,ABAPRQWSFErhHUFQsJmCoj4Rpg4DtQ8w,bWdj2GDclj5ofokWjzoa5jAwMkxCykd6,2,0,0,0,0,0,6,0,6,0.8571428571428571,2,0.0,0,0,0,0,0,0,0,6,0,0,6,1
7481,119825,xwG9GgMrPHgbqqrlvclpGJMpSPdOCjxQ,A3fsA9Zfv1X2fVEQhTw51lKENdNrEqT3,6,6,0,0,0,0,2,0,8,1.1428571428571428,2,0.0,1,0,0,0,5,0,0,2,0,1,7,1
7482,119833,DhGcyoTp73fKDVPL51XtXQlMqfdtfXVc,SpATywNh6bZuzm8s1ceuBUnMUAeoAHHw,6,3,2,0,2,0,1,0,8,1.1428571428571428,1,0.0,0,2,0,2,3,0,0,1,0,4,4,1
7483,119836,GyWTABuPpZEqO585EnNTIpM2B2faPYN3,A3fsA9Zfv1X2fVEQhTw51lKENdNrEqT3,8,7,5,0,3,0,3,0,18,2.5714285714285716,1,0.0,0,5,0,3,7,0,0,3,0,8,10,1
7484,119867,bCILkQHxUJub9H7cxxmSR5zqZAu3BvHB,SpATywNh6bZuzm8s1ceuBUnMUAeoAHHw,24,19,15,0,8,0,5,0,47,6.714285714285714,2,0.0,0,15,0,8,19,0,0,5,0,23,24,1
7485,119878,T7izEMyckZ14Dpb0HXCCbCEgRCtemG2v,A3fsA9Zfv1X2fVEQhTw51lKENdNrEqT3,6,7,1,0,0,0,7,0,15,2.142857142857143,3,0.0,0,1,0,0,7,0,0,7,0,1,14,1
7486,119879,ClHMnOLy9vZKRtNjcA9yPWajeNvRCNdE,RXDvfPUBYFlVdlueBFbLW0mhhAyGEqpt,1,0,0,0,0,0,1,0,1,0.14285714285714285,1,0.0,0,0,0,0,0,0,0,1,0,0,1,1
7487,119888,pgB6pQ9DmcVMwAXk0gVwFSTwyA4alFe0,SpATywNh6bZuzm8s1ceuBUnMUAeoAHHw,7,4,3,0,0,1,5,0,13,1.8571428571428572,2,0.0,0,3,0,0,4,1,0,5,0,3,10,1
7488,119892,6PXcyDdGgas03jfN9GNBg7eDbTNLi58b,SpATywNh6bZuzm8s1ceuBUnMUAeoAHHw,5,3,1,0,1,1,3,0,9,1.2857142857142858,1,0.0,0,1,0,1,3,1,0,3,0,2,7,1
7489,119895,JAh5RXKrssqx6aZ2Y0OKL2tpBD86qsyv,SpATywNh6bZuzm8s1ceuBUnMUAeoAHHw,10,8,1,0,1,0,9,0,19,2.7142857142857144,1,0.0,0,1,0,1,8,0,0,9,0,2,17,1
7490,119896,c4MI9OfbyJ0RGX9j0ZiKqfaHb3fSOPCp,SpATywNh6bZuzm8s1ceuBUnMUAeoAHHw,9,26,1,11,0,0,8,0,46,6.571428571428571,3,0.0,10,1,11,0,16,0,0,8,0,22,24,1
7491,119898,7nQB7cjVdr2HijR82OoX1oMRPa42JjfY,A3fsA9Zfv1X2fVEQhTw51lKENdNrEqT3,13,7,5,0,2,2,8,1,25,3.5714285714285716,2,0.0,0,5,0,2,7,2,0,8,1,7,18,1
7492,119905,alePu0FhXWTyAf3z1TbtScq1Obpgwyvj,SpATywNh6bZuzm8s1ceuBUnMUAeoAHHw,10,5,2,0,2,1,9,1,20,2.857142857142857,1,0.0,0,2,0,2,5,1,0,9,1,4,16,0
7493,119907,Tlrkgpa05toeVrZOHafHN5HVS3Ley7hG,A3fsA9Zfv1X2fVEQhTw51lKENdNrEqT3,51,37,25,46,13,1,14,1,137,19.571428571428573,5,0.0,6,25,46,13,31,1,0,14,1,90,47,1
7494,119923,nrDkIZH2wqEVh6i4pBxcbRBJIMc9s20b,SpATywNh6bZuzm8s1ceuBUnMUAeoAHHw,20,69,3,34,2,0,18,0,126,18.0,7,0.0,22,3,29,2,47,0,5,18,0,56,70,0
7495,119933,nHnSkTZVeRCsQFFRAJ2tasC3JodYcJAU,SpATywNh6bZuzm8s1ceuBUnMUAeoAHHw,14,25,11,0,8,0,3,0,47,6.714285714285714,1,0.0,0,11,0,8,25,0,0,3,0,19,28,1
7496,119935,4uCHoIviHPzCtwadirbZDGuLNqx4H5qx,SpATywNh6bZuzm8s1ceuBUnMUAeoAHHw,27,46,22,44,6,0,9,0,127,18.142857142857142,3,0.0,17,22,37,6,29,0,7,9,0,82,45,0
7497,119937,l70wRZ2DS0s6LjbT7C4gRoGrF27x9p2H,bWdj2GDclj5ofokWjzoa5jAwMkxCykd6,1,0,0,0,0,0,1,0,1,0.14285714285714285,1,0.0,0,0,0,0,0,0,0,1,0,0,1,1
7498,119938,hdh7f9dbamC5OLbnjQIw5ciTwmy2oqSe,A3fsA9Zfv1X2fVEQhTw51lKENdNrEqT3,29,29,23,0,19,0,8,0,79,11.285714285714286,4,0.0,0,23,0,19,29,0,0,8,0,42,37,1
7499,119942,D9eQoamtTDpiMV0b0OdGca728kthGUV3,SpATywNh6bZuzm8s1ceuBUnMUAeoAHHw,6,4,0,4,0,0,2,0,10,1.4285714285714286,1,0.0,1,0,4,0,3,0,0,2,0,5,5,0
7500,119947,jnIQMhy9SQ2YnxY9vLXkaYJhqSTRkdV3,SpATywNh6bZuzm8s1ceuBUnMUAeoAHHw,24,40,17,7,9,0,8,0,81,11.571428571428571,3,0.0,18,17,7,9,22,0,0,8,0,51,30,1
7501,119949,3dRJytFtMTBsljPJJKUMWZqWEGtFd6rm,SpATywNh6bZuzm8s1ceuBUnMUAeoAHHw,14,16,4,17,3,0,2,0,42,6.0,1,0.0,10,4,14,3,6,0,3,2,0,31,11,1
7502,119953,ixEbiSQCdFYvedCjd9ZSVhkHMvgSKaLG,SpATywNh6bZuzm8s1ceuBUnMUAeoAHHw,8,6,4,0,3,0,3,0,16,2.2857142857142856,2,0.0,0,4,0,3,6,0,0,3,0,7,9,1
7503,119958,lm0zg2eARlzCRkKcI4nbhfozsZEvEhl3,SpATywNh6bZuzm8s1ceuBUnMUAeoAHHw,11,8,1,12,0,0,2,0,23,3.2857142857142856,1,0.0,2,1,11,0,6,0,1,2,0,14,9,1
7504,119960,4TtGjmtd4ISORDD5okRgx7kXAcGUW8IN,RXDvfPUBYFlVdlueBFbLW0mhhAyGEqpt,9,4,3,0,1,4,5,1,18,2.5714285714285716,2,0.0,0,3,0,1,4,4,0,5,1,4,14,1
7505,119969,RpC8ahxzmHtiHrtEolXbAvhs5yymX13F,SpATywNh6bZuzm8s1ceuBUnMUAeoAHHw,5,4,3,0,2,0,2,0,11,1.5714285714285714,1,0.0,0,3,0,2,4,0,0,2,0,5,6,1
7506,119970,4kQU73UJCeVbdLolFE0fE9baW58Y34lz,SpATywNh6bZuzm8s1ceuBUnMUAeoAHHw,11,8,5,0,3,0,8,1,25,3.5714285714285716,1,0.0,0,5,0,3,8,0,0,8,1,8,17,1
7507,119973,0NGZq9HZW5KOrSfzSGGipuN20pCRDMWu,RXDvfPUBYFlVdlueBFbLW0mhhAyGEqpt,13,9,6,0,4,3,4,0,26,3.7142857142857144,1,0.0,0,6,0,4,9,3,0,4,0,10,16,0
7508,119974,VLq5RjmauxaFZfPnx2f9r9Dehjw868o9,SpATywNh6bZuzm8s1ceuBUnMUAeoAHHw,19,29,16,11,8,6,13,2,85,12.142857142857142,5,0.0,2,16,11,8,27,6,0,13,2,37,48,0
7509,119981,hNJz0qbOhrUgajUkzqSdDbybHkuRglfs,A3fsA9Zfv1X2fVEQhTw51lKENdNrEqT3,39,21,15,56,9,1,8,1,111,15.857142857142858,2,0.0,3,15,48,9,18,1,8,8,1,75,36,0
7510,119983,8ZvgmVWPuU4xKWq9tw3YZdhhMDnHsFgT,SpATywNh6bZuzm8s1ceuBUnMUAeoAHHw,29,72,27,24,11,37,42,3,216,30.857142857142858,10,0.0,14,27,21,11,58,37,3,42,3,73,143,0
7511,119991,EjqS3A2Iv9J8JTjinbKy3gdtrrXaSQyJ,bWdj2GDclj5ofokWjzoa5jAwMkxCykd6,4,4,2,0,0,0,2,0,8,1.1428571428571428,2,0.0,0,2,0,0,4,0,0,2,0,2,6,1
7512,119993,GMzSpgZQ6jzVsfHn8W8i83JsYNxnP00b,A3fsA9Zfv1X2fVEQhTw51lKENdNrEqT3,5,3,2,0,1,0,1,0,7,1.0,1,0.0,0,2,0,1,3,0,0,1,0,3,4,1
7513,119994,O4934ANB2qMTFJBwUqvZeG7DbnQJCsce,SpATywNh6bZuzm8s1ceuBUnMUAeoAHHw,27,28,11,29,7,0,3,0,78,11.142857142857142,2,0.0,8,11,27,7,20,0,2,3,0,53,25,1
7514,120004,4mdszhiojUd6ka3AsjiiGyQ3X7W5E7uc,A3fsA9Zfv1X2fVEQhTw51lKENdNrEqT3,1,0,0,0,0,0,2,0,2,0.2857142857142857,2,0.0,0,0,0,0,0,0,0,2,0,0,2,1
7515,120015,4YCZfbR5vSUmQm9JKU53CaLT4o7zzhD5,A3fsA9Zfv1X2fVEQhTw51lKENdNrEqT3,1,0,0,0,0,0,1,0,1,0.14285714285714285,1,0.0,0,0,0,0,0,0,0,1,0,0,1,1
7516,120019,eC4QFVNRkDMJURDQ2ZX8Orvtuy3F8ILJ,SpATywNh6bZuzm8s1ceuBUnMUAeoAHHw,15,18,3,24,1,0,8,0,54,7.714285714285714,2,0.0,8,3,19,1,10,0,5,8,0,31,23,1
7517,120021,xr2T8ak6swOOfU9oanYvPbQ4STab9s9f,bWdj2GDclj5ofokWjzoa5jAwMkxCykd6,11,30,2,0,2,0,16,0,50,7.142857142857143,5,0.0,7,2,0,2,23,0,0,16,0,11,39,1
7518,120022,npXfYqxF0TCNN5vliwdRJdFcBk0rmfXv,bWdj2GDclj5ofokWjzoa5jAwMkxCykd6,13,18,6,16,7,5,6,1,59,8.428571428571429,4,0.0,5,6,14,7,13,5,2,6,1,32,27,0
7519,120026,ZH0VWJ7XJWogjYH6Qq2Nr4TMh6fe5JGW,SpATywNh6bZuzm8s1ceuBUnMUAeoAHHw,16,44,4,6,0,0,6,0,60,8.571428571428571,4,0.0,0,4,6,0,44,0,0,6,0,10,50,0
7520,120032,n58OZShh1DSriRlOeR7KzkMLpM8Ixh01,A3fsA9Zfv1X2fVEQhTw51lKENdNrEqT3,2,0,0,0,0,0,3,0,3,0.42857142857142855,1,0.0,0,0,0,0,0,0,0,3,0,0,3,1
7521,120052,2VfZF4h8v7eR70PfxTwoJImij1XH3cw0,SpATywNh6bZuzm8s1ceuBUnMUAeoAHHw,9,5,4,0,3,1,13,0,26,3.7142857142857144,1,0.0,0,4,0,3,5,1,0,13,0,7,19,1
7522,120053,WELjmgdsP962Pc1teJ96xvofKraKe6qa,RXDvfPUBYFlVdlueBFbLW0mhhAyGEqpt,6,5,3,0,1,9,2,0,20,2.857142857142857,1,0.0,0,3,0,1,5,9,0,2,0,4,16,1
7523,120056,fzsHY2LgfBXg8YsHOoWkwNUOqIdUaJDy,bWdj2GDclj5ofokWjzoa5jAwMkxCykd6,2,0,0,0,0,0,3,0,3,0.42857142857142855,1,0.0,0,0,0,0,0,0,0,3,0,0,3,1
7524,120069,md1Mf60Z4ySa4NKHKWMKq8Bxh8C0w3Ro,SpATywNh6bZuzm8s1ceuBUnMUAeoAHHw,10,12,6,0,2,4,7,0,31,4.428571428571429,2,0.0,2,6,0,2,10,4,0,7,0,10,21,1
7525,120070,JkGUdKB9J1ONvSF3GWx5guW4dzLf3fLB,RXDvfPUBYFlVdlueBFbLW0mhhAyGEqpt,6,4,3,0,1,0,2,0,10,1.4285714285714286,1,0.0,0,3,0,1,4,0,0,2,0,4,6,1
7526,120071,3n6ajKAkQu8rgtUnNpdWOfMF8VSNsMVs,G8EPVSXsOYB5YQWZGiz1aVq5Pgr2GrQu,6,5,3,0,0,0,3,0,11,1.5714285714285714,2,0.0,0,3,0,0,5,0,0,3,0,3,8,1
7527,120073,2VfZF4h8v7eR70PfxTwoJImij1XH3cw0,RXDvfPUBYFlVdlueBFbLW0mhhAyGEqpt,5,2,1,0,1,0,2,0,6,0.8571428571428571,1,0.0,0,1,0,1,2,0,0,2,0,2,4,1
7528,120075,OwDVM5C0ZIkYKCNBKi1eBMmRNb7I7ptI,bWdj2GDclj5ofokWjzoa5jAwMkxCykd6,2,0,0,0,0,0,5,0,5,0.7142857142857143,1,0.0,0,0,0,0,0,0,0,5,0,0,5,1
7529,120076,4YCZfbR5vSUmQm9JKU53CaLT4o7zzhD5,G8EPVSXsOYB5YQWZGiz1aVq5Pgr2GrQu,1,0,0,0,0,0,1,0,1,0.14285714285714285,1,0.0,0,0,0,0,0,0,0,1,0,0,1,1
7530,120078,saXRSf4MnhO78zgLoljZlslavqJjBtLm,bWdj2GDclj5ofokWjzoa5jAwMkxCykd6,19,80,7,60,7,44,26,0,224,32.0,4,0.0,20,7,54,7,60,44,6,26,0,88,136,1
7531,120085,SozLQk8695JG7fvj1Enp26s5ACJQjjq5,RXDvfPUBYFlVdlueBFbLW0mhhAyGEqpt,1,0,0,0,0,0,1,0,1,0.14285714285714285,1,0.0,0,0,0,0,0,0,0,1,0,0,1,1
7532,120088,ZOVfvlm206voHlGJ4V6McNGjtxTxB7JQ,A3fsA9Zfv1X2fVEQhTw51lKENdNrEqT3,7,4,3,0,2,0,3,0,12,1.7142857142857142,2,0.0,0,3,0,2,4,0,0,3,0,5,7,1
7533,120097,5pfeeYLWSB4wCSWnPZbrmiSBS3yXgMsk,bWdj2GDclj5ofokWjzoa5jAwMkxCykd6,7,5,1,0,1,0,4,0,11,1.5714285714285714,2,0.0,0,1,0,1,5,0,0,4,0,2,9,1
7534,120100,JdKnU2sktk6AZyjwyIqgEXYK8OtgPCn2,bWdj2GDclj5ofokWjzoa5jAwMkxCykd6,16,27,10,0,15,0,8,0,60,8.571428571428571,2,0.0,4,10,0,15,23,0,0,8,0,29,31,0
7535,120111,aGyzysUQgcpficWqTygk8rcuo677dPZU,SpATywNh6bZuzm8s1ceuBUnMUAeoAHHw,23,61,6,26,6,30,21,3,153,21.857142857142858,5,0.0,16,6,23,6,45,30,3,21,3,51,102,0
7536,120118,cPZ5ch8V46zptI5nnRGh9SfMnAQrVDUi,bWdj2GDclj5ofokWjzoa5jAwMkxCykd6,12,31,19,0,12,7,11,0,80,11.428571428571429,4,0.0,4,19,0,12,27,7,0,11,0,35,45,0
7537,120124,Ga7iU5IP3f6oL4nXlygCBVszreMPGCt3,G8EPVSXsOYB5YQWZGiz1aVq5Pgr2GrQu,1,0,0,0,0,0,1,0,1,0.14285714285714285,1,0.0,0,0,0,0,0,0,0,1,0,0,1,1
7538,120126,c6XaDpje2iQSWpoXkTtf00BW6tACh6Q9,SpATywNh6bZuzm8s1ceuBUnMUAeoAHHw,31,67,31,31,14,25,28,3,199,28.428571428571427,4,0.0,10,31,28,14,57,25,3,28,3,83,116,0
7539,120129,nDUXGSBgQyo69KyzDsvsphUp6qKxv1Ib,SpATywNh6bZuzm8s1ceuBUnMUAeoAHHw,5,2,1,0,1,0,2,0,6,0.8571428571428571,1,0.0,0,1,0,1,2,0,0,2,0,2,4,1
7540,120134,nKMPTOF6v1sp7aVmO78zmSRg9f9QXrTf,A3fsA9Zfv1X2fVEQhTw51lKENdNrEqT3,45,28,21,45,16,1,5,0,116,16.571428571428573,4,0.0,1,21,42,16,27,1,3,5,0,80,36,1
7541,120142,Uxom3QvnZvmlcNVTXDTJG0YgMkZr2hhX,SpATywNh6bZuzm8s1ceuBUnMUAeoAHHw,7,3,2,0,2,0,2,0,9,1.2857142857142858,1,0.0,0,2,0,2,3,0,0,2,0,4,5,1
7542,120149,LY15AitabC9VNRy9N91XwsKL39G9Yhym,SpATywNh6bZuzm8s1ceuBUnMUAeoAHHw,24,31,18,14,8,14,9,4,98,14.0,3,0.0,6,18,11,8,25,14,3,9,4,43,55,1
7543,120153,la15uCtK5VeDQX41dystrGx2B895Oqjw,RXDvfPUBYFlVdlueBFbLW0mhhAyGEqpt,45,68,38,82,25,9,7,3,232,33.142857142857146,3,0.0,19,38,79,25,49,9,3,7,3,161,71,1
7544,120158,durZRNVeZgKGbNDftJUmwBeNsWC0AnPo,SpATywNh6bZuzm8s1ceuBUnMUAeoAHHw,1,0,0,0,0,0,1,0,1,0.14285714285714285,1,0.0,0,0,0,0,0,0,0,1,0,0,1,1
7545,120170,80Av2RXrFoxNOdv7EQUM2TDOM0gyNH0J,bWdj2GDclj5ofokWjzoa5jAwMkxCykd6,4,2,1,0,1,0,2,0,6,0.8571428571428571,1,0.0,0,1,0,1,2,0,0,2,0,2,4,1
7546,120171,ThGblU6q4nWmu3ORXgM7eQc8q9vcBP4r,A3fsA9Zfv1X2fVEQhTw51lKENdNrEqT3,37,39,5,56,1,0,28,0,129,18.428571428571427,5,0.0,4,5,49,1,35,0,7,28,0,59,70,1
7547,120177,83cBV2IXkwoW1nUaa1kxaJ98L3bxFsPn,A3fsA9Zfv1X2fVEQhTw51lKENdNrEqT3,48,56,41,72,5,7,16,0,197,28.142857142857142,9,0.0,2,41,72,5,54,7,0,16,0,120,77,0
7548,120181,yBsDX1Dsw9hy8f2NuaeMfD0tvX413Igw,bWdj2GDclj5ofokWjzoa5jAwMkxCykd6,5,2,1,0,1,0,3,0,7,1.0,2,0.0,0,1,0,1,2,0,0,3,0,2,5,0
7549,120194,Uylyq7LmmNSvSWdWZxt9uRF9NmGdfp0A,RXDvfPUBYFlVdlueBFbLW0mhhAyGEqpt,1,0,0,0,0,0,1,0,1,0.14285714285714285,1,0.0,0,0,0,0,0,0,0,1,0,0,1,1
7550,120196,qLscbApWydA7z1h7Ht7RN2UnF0mvGZpF,SpATywNh6bZuzm8s1ceuBUnMUAeoAHHw,17,33,1,20,1,0,7,0,62,8.857142857142858,2,0.0,7,1,16,1,26,0,4,7,0,25,37,1
7551,120204,cQbl9j85owwXzcR0zsrhIz1wkEuaLsqG,A3fsA9Zfv1X2fVEQhTw51lKENdNrEqT3,1,0,0,0,0,0,1,0,1,0.14285714285714285,1,0.0,0,0,0,0,0,0,0,1,0,0,1,1
7552,120211,WfK8spzPGQgUUjtYsrbByJpvEEqSCjRx,A3fsA9Zfv1X2fVEQhTw51lKENdNrEqT3,1,0,0,0,0,0,1,0,1,0.14285714285714285,1,0.0,0,0,0,0,0,0,0,1,0,0,1,1
7553,120219,Yp8yvTzeMvocSqLvL15ovVwipej5zHiT,SpATywNh6bZuzm8s1ceuBUnMUAeoAHHw,1,0,0,0,0,0,1,0,1,0.14285714285714285,1,0.0,0,0,0,0,0,0,0,1,0,0,1,1
7554,120228,zVgOUCulbNx05te9mrJWZeO6VJGrw5WO,G8EPVSXsOYB5YQWZGiz1aVq5Pgr2GrQu,14,19,10,8,1,0,9,0,47,6.714285714285714,2,0.0,3,10,5,1,16,0,3,9,0,19,28,1
7555,120230,LY15AitabC9VNRy9N91XwsKL39G9Yhym,G8EPVSXsOYB5YQWZGiz1aVq5Pgr2GrQu,14,24,7,0,7,0,7,0,45,6.428571428571429,4,0.0,2,7,0,7,22,0,0,7,0,16,29,1
7556,120234,1Rj37m2TWBRQIZjAlVjTge1bBoqghnB2,bWdj2GDclj5ofokWjzoa5jAwMkxCykd6,6,0,0,0,0,1,6,1,8,1.1428571428571428,1,0.0,0,0,0,0,0,1,0,6,1,0,8,1
7557,120240,YYie2sncdtzNtDvv2HrWAX3WcnBaHhtH,A3fsA9Zfv1X2fVEQhTw51lKENdNrEqT3,10,3,2,0,2,0,5,1,13,1.8571428571428572,1,0.0,0,2,0,2,3,0,0,5,1,4,9,1
7558,120251,qY3mO9VSgbSXrTZIckLWUEq4U741QpCT,SpATywNh6bZuzm8s1ceuBUnMUAeoAHHw,21,41,17,18,3,4,17,1,101,14.428571428571429,2,0.0,20,17,17,3,21,4,1,17,1,57,44,0
7559,120255,3nXqsLutTeQFNz1Ya8GTFnWUmV4VnYmX,SpATywNh6bZuzm8s1ceuBUnMUAeoAHHw,15,19,2,17,1,1,6,1,47,6.714285714285714,3,0.0,6,2,15,1,13,1,2,6,1,24,23,1
7560,120257,FsHh7NEicgBmDLs5h5Swts1JnEA5erYu,A3fsA9Zfv1X2fVEQhTw51lKENdNrEqT3,1,0,0,0,0,0,2,0,2,0.2857142857142857,1,0.0,0,0,0,0,0,0,0,2,0,0,2,1
7561,120262,x2vyDUpFuVAQOVEKoczKBtYvi1pP4Hfq,SpATywNh6bZuzm8s1ceuBUnMUAeoAHHw,1,0,0,0,0,0,1,0,1,0.14285714285714285,1,0.0,0,0,0,0,0,0,0,1,0,0,1,1
7562,120263,farPAnvPmsSrd5ovHg0tlsOgoAj5LoAg,SpATywNh6bZuzm8s1ceuBUnMUAeoAHHw,4,2,1,0,1,0,1,0,5,0.7142857142857143,1,0.0,0,1,0,1,2,0,0,1,0,2,3,1
7563,120270,oh70wjHZNiJm6YMEO2zTeIrDQMUiqmDd,A3fsA9Zfv1X2fVEQhTw51lKENdNrEqT3,11,15,1,0,1,0,2,0,19,2.7142857142857144,2,0.0,1,1,0,1,14,0,0,2,0,3,16,1
7564,120279,1cxiENcEp3mVuj0hieZU2n66DvVX0lKj,bWdj2GDclj5ofokWjzoa5jAwMkxCykd6,1,0,0,0,0,0,1,0,1,0.14285714285714285,1,0.0,0,0,0,0,0,0,0,1,0,0,1,1
7565,120284,1cxiENcEp3mVuj0hieZU2n66DvVX0lKj,A3fsA9Zfv1X2fVEQhTw51lKENdNrEqT3,8,2,0,0,0,2,10,1,15,2.142857142857143,1,0.0,0,0,0,0,2,2,0,10,1,0,15,1
7566,120285,G6cW0d2bzLHgB0vreFbhNx3GSiMBKbtv,A3fsA9Zfv1X2fVEQhTw51lKENdNrEqT3,40,23,10,48,9,0,3,0,93,13.285714285714286,2,0.0,2,10,46,9,21,0,2,3,0,67,26,1
7567,120287,JdKnU2sktk6AZyjwyIqgEXYK8OtgPCn2,A3fsA9Zfv1X2fVEQhTw51lKENdNrEqT3,11,11,5,0,3,0,3,1,23,3.2857142857142856,1,0.0,0,5,0,3,11,0,0,3,1,8,15,1
7568,120296,WnLVBva4oiF8muizYYbe8GP2LesbDaQA,SpATywNh6bZuzm8s1ceuBUnMUAeoAHHw,9,4,3,0,3,0,2,0,12,1.7142857142857142,1,0.0,0,3,0,3,4,0,0,2,0,6,6,1
7569,120318,Z01b5ZH1XnM8VywoaG2LGeoRdMPqFc6F,SpATywNh6bZuzm8s1ceuBUnMUAeoAHHw,9,9,4,0,3,0,7,1,24,3.4285714285714284,1,0.0,5,4,0,3,4,0,0,7,1,12,12,1
7570,120323,HZLnsnoiGm4WW2vjutmDoR0ipnBBZA4G,A3fsA9Zfv1X2fVEQhTw51lKENdNrEqT3,23,25,19,0,15,0,9,0,68,9.714285714285714,2,0.0,0,19,0,15,25,0,0,9,0,34,34,1
7571,120325,iG6MpbqzKA4jDaDFNYLj8a74oKQT8YWZ,A3fsA9Zfv1X2fVEQhTw51lKENdNrEqT3,2,0,0,0,0,0,4,0,4,0.5714285714285714,1,0.0,0,0,0,0,0,0,0,4,0,0,4,1
7572,120337,KDeaSgZ6wTHm30JcQgLQFVdVYbxH0KHc,SpATywNh6bZuzm8s1ceuBUnMUAeoAHHw,8,18,7,0,3,0,4,0,32,4.571428571428571,3,0.0,2,7,0,3,16,0,0,4,0,12,20,1
7573,120345,DsvMkutBFtLefRL1hsHU5bFQpdJBtlsH,SpATywNh6bZuzm8s1ceuBUnMUAeoAHHw,14,11,1,11,1,0,2,0,26,3.7142857142857144,1,0.0,2,1,9,1,9,0,2,2,0,13,13,1
7574,120365,aXiJW8ayzWdjAFuCXJZEkZEM0lQLoZYD,bWdj2GDclj5ofokWjzoa5jAwMkxCykd6,9,16,4,0,2,5,12,1,40,5.714285714285714,2,0.0,4,4,0,2,12,5,0,12,1,10,30,1
7575,120369,Z0j9vlmYA8vddl2WEYwRJJAGu9WTMzZU,SpATywNh6bZuzm8s1ceuBUnMUAeoAHHw,6,3,2,0,2,0,1,0,8,1.1428571428571428,1,0.0,0,2,0,2,3,0,0,1,0,4,4,1
7576,120371,XQgYe2uvAKPXdUiz5f6AHKp9LdPbPxAU,A3fsA9Zfv1X2fVEQhTw51lKENdNrEqT3,4,2,1,0,1,0,1,0,5,0.7142857142857143,1,0.0,0,1,0,1,2,0,0,1,0,2,3,1
7577,120374,ePOpOKycvORTPdc6DfieYb44dd8ej3gR,SpATywNh6bZuzm8s1ceuBUnMUAeoAHHw,8,7,6,0,6,0,1,0,20,2.857142857142857,1,0.0,0,6,0,6,7,0,0,1,0,12,8,1
7578,120390,snoVfOu7m3uQyb0rtN2hVEbVR2VoIt0E,SpATywNh6bZuzm8s1ceuBUnMUAeoAHHw,1,0,0,0,0,0,1,0,1,0.14285714285714285,1,0.0,0,0,0,0,0,0,0,1,0,0,1,1
7579,120399,tQgPfoIxEUrRTpkUJ12lc7yYMouZEU13,SpATywNh6bZuzm8s1ceuBUnMUAeoAHHw,8,11,3,0,3,0,8,0,25,3.5714285714285716,2,0.0,0,3,0,3,11,0,0,8,0,6,19,1
7580,120400,STgJR8QT5S3NDhZTGanzgxzj1oLmNnCR,SpATywNh6bZuzm8s1ceuBUnMUAeoAHHw,19,10,8,0,7,3,6,0,34,4.857142857142857,1,0.0,0,8,0,7,10,3,0,6,0,15,19,1
7581,120402,Y2MWDCkue2rmZywdTMYpTi8OGrxwTILf,A3fsA9Zfv1X2fVEQhTw51lKENdNrEqT3,1,0,0,0,0,0,1,0,1,0.14285714285714285,1,0.0,0,0,0,0,0,0,0,1,0,0,1,1
7582,120404,NYt3HW4iIDKFfkoDHUmE2GfhEi6C8Rqu,A3fsA9Zfv1X2fVEQhTw51lKENdNrEqT3,8,9,3,0,2,0,6,0,20,2.857142857142857,2,0.0,1,3,0,2,8,0,0,6,0,6,14,1
7583,120406,7Tzl2OTGekrrZ1AXSNaODNbj4vnVdNB2,G8EPVSXsOYB5YQWZGiz1aVq5Pgr2GrQu,22,32,3,20,4,25,19,2,105,15.0,3,0.0,13,3,11,4,19,25,9,19,2,31,74,0
7584,120412,JPQfQe2O1MgBbogZcbI6qUWraQxSj98z,A3fsA9Zfv1X2fVEQhTw51lKENdNrEqT3,1,0,0,0,0,0,1,0,1,0.14285714285714285,1,0.0,0,0,0,0,0,0,0,1,0,0,1,1
7585,120415,lk6sSo2mEoREiTaQjIlY6dKahZkFRKmP,bWdj2GDclj5ofokWjzoa5jAwMkxCykd6,19,22,10,66,6,0,10,0,114,16.285714285714285,3,0.0,6,10,60,6,16,0,6,10,0,82,32,1
7586,120416,vQlqRATWFUYVohKNm8Qpw3XkVdJ2DmuJ,SpATywNh6bZuzm8s1ceuBUnMUAeoAHHw,14,18,0,17,0,0,1,0,36,5.142857142857143,1,0.0,7,0,14,0,11,0,3,1,0,21,15,1
7587,120417,DHUv7XpIZcPp2QYGNmTXjhgg7Zq4BpJ7,G8EPVSXsOYB5YQWZGiz1aVq5Pgr2GrQu,4,2,1,0,1,0,1,0,5,0.7142857142857143,1,0.0,0,1,0,1,2,0,0,1,0,2,3,1
7588,120419,ozv3HO6eArxO9HBSOsAR70hZyYDwrV65,A3fsA9Zfv1X2fVEQhTw51lKENdNrEqT3,6,2,1,0,1,0,5,0,9,1.2857142857142858,1,0.0,0,1,0,1,2,0,0,5,0,2,7,1
7589,120421,ouTwCUFDa5PRzaHQSaChM41Y1q02nIPV,SpATywNh6bZuzm8s1ceuBUnMUAeoAHHw,17,16,1,4,1,2,9,1,34,4.857142857142857,3,0.0,2,1,3,1,14,2,1,9,1,7,27,1
7590,120425,uEDnklEhnnZbnvzJYYw9brmjh3D3gkF9,SpATywNh6bZuzm8s1ceuBUnMUAeoAHHw,1,0,0,0,0,0,1,0,1,0.14285714285714285,1,0.0,0,0,0,0,0,0,0,1,0,0,1,1
7591,120435,OifsLGRBGBgFFNsSrNDnK5W8Vbn9qLGX,SpATywNh6bZuzm8s1ceuBUnMUAeoAHHw,11,27,1,0,0,0,0,0,28,4.0,5,0.0,0,1,0,0,27,0,0,0,0,1,27,1
7592,120437,do3bUhF7O0txAhPkHUppSnV3jZUZ9sqF,SpATywNh6bZuzm8s1ceuBUnMUAeoAHHw,5,2,1,0,1,0,2,0,6,0.8571428571428571,1,0.0,0,1,0,1,2,0,0,2,0,2,4,1
7593,120457,1La5rp9ZSz9cfpqCRJiC01Rwvuq5VVrf,SpATywNh6bZuzm8s1ceuBUnMUAeoAHHw,18,18,8,24,4,0,8,0,62,8.857142857142858,5,0.0,8,8,24,4,10,0,0,8,0,44,18,0
7594,120460,5MOHfgPntZIsRWkQebauzpUgUSaHvhFJ,bWdj2GDclj5ofokWjzoa5jAwMkxCykd6,6,9,5,0,1,0,6,0,21,3.0,4,0.0,0,5,0,1,9,0,0,6,0,6,15,1
7595,120465,oldypK1fqRkEbCk0bKZUJxOdwxxRRKXf,A3fsA9Zfv1X2fVEQhTw51lKENdNrEqT3,9,6,1,0,1,0,4,0,12,1.7142857142857142,1,0.0,0,1,0,1,6,0,0,4,0,2,10,1
7596,120471,I6qoCcohBrCkqxmkans73ezft5aIvcN6,SpATywNh6bZuzm8s1ceuBUnMUAeoAHHw,6,7,2,0,1,0,3,0,13,1.8571428571428572,2,0.0,2,2,0,1,5,0,0,3,0,5,8,1
7597,120480,GJdrQdNnhszyte4F0GpLkVjDN5SstsoH,SpATywNh6bZuzm8s1ceuBUnMUAeoAHHw,26,56,9,35,8,2,13,2,125,17.857142857142858,6,0.0,6,9,33,8,50,2,2,13,2,56,69,0
7598,120489,MgS6WK9esRya9QyP2ZOjbNdLSIL7NuM9,bWdj2GDclj5ofokWjzoa5jAwMkxCykd6,19,25,15,22,5,2,10,0,79,11.285714285714286,3,0.0,5,15,22,5,20,2,0,10,0,47,32,0
7599,120505,QZQvnzqgk3ZJQavig3cFuZehXC8CHrPm,bWdj2GDclj5ofokWjzoa5jAwMkxCykd6,16,43,11,64,17,0,9,0,144,20.571428571428573,3,0.0,28,11,60,17,15,0,4,9,0,116,28,1
7600,120524,MgS6WK9esRya9QyP2ZOjbNdLSIL7NuM9,RXDvfPUBYFlVdlueBFbLW0mhhAyGEqpt,7,7,4,0,1,0,2,0,14,2.0,2,0.0,0,4,0,1,7,0,0,2,0,5,9,1
7601,120531,Fkd43qYCuPn5hi79UziIpsXZru3xZf0R,SpATywNh6bZuzm8s1ceuBUnMUAeoAHHw,4,2,1,0,1,0,1,0,5,0.7142857142857143,1,0.0,0,1,0,1,2,0,0,1,0,2,3,1
7602,120533,vEaXPhyTYPOxUDFFnNSxdj1qZ39pJLBH,A3fsA9Zfv1X2fVEQhTw51lKENdNrEqT3,6,3,2,0,2,0,5,0,12,1.7142857142857142,1,0.0,0,2,0,2,3,0,0,5,0,4,8,1
7603,120538,kJkXo4nSNqbMETrXDpi6P9tfSt1mYjrM,SpATywNh6bZuzm8s1ceuBUnMUAeoAHHw,24,50,21,17,10,0,21,0,119,17.0,6,0.0,12,21,15,10,38,0,2,21,0,58,61,1
7604,120540,U0zx3N1uSd1t4oNG6aeia4oGy5qrTYII,SpATywNh6bZuzm8s1ceuBUnMUAeoAHHw,15,14,8,9,4,0,4,0,39,5.571428571428571,2,0.0,4,8,9,4,10,0,0,4,0,25,14,1
7605,120547,6T4qq3cdISFF5pyvVKMrcmEINY6BysCY,A3fsA9Zfv1X2fVEQhTw51lKENdNrEqT3,51,21,10,134,2,31,11,2,211,30.142857142857142,4,0.0,7,10,117,2,14,31,17,11,2,136,75,0
7606,120550,SiUZQJJjUWzItu4TetvbGbgpJYIYKjWr,SpATywNh6bZuzm8s1ceuBUnMUAeoAHHw,4,2,1,0,1,0,1,0,5,0.7142857142857143,1,0.0,0,1,0,1,2,0,0,1,0,2,3,1
7607,120554,33YJhO56Hz6X3YkBaXAE8jLXj3hGQz0E,RXDvfPUBYFlVdlueBFbLW0mhhAyGEqpt,4,2,1,0,1,0,1,0,5,0.7142857142857143,1,0.0,0,1,0,1,2,0,0,1,0,2,3,1
7608,120559,4YCZfbR5vSUmQm9JKU53CaLT4o7zzhD5,SpATywNh6bZuzm8s1ceuBUnMUAeoAHHw,1,0,0,0,0,0,2,0,2,0.2857142857142857,1,0.0,0,0,0,0,0,0,0,2,0,0,2,1
7609,120567,VL7NPBJuyzF1uV3nhlsl7JEimjvq8BIB,SpATywNh6bZuzm8s1ceuBUnMUAeoAHHw,30,84,52,12,26,6,19,0,199,28.428571428571427,5,0.0,9,52,12,26,75,6,0,19,0,99,100,0
7610,120570,EIpkB0c46fQRf924Hrf1SRiPLyg6N4rm,RXDvfPUBYFlVdlueBFbLW0mhhAyGEqpt,11,7,2,0,2,2,4,0,17,2.4285714285714284,2,0.0,0,2,0,2,7,2,0,4,0,4,13,1
7611,120571,ZcwgBhx2C5CsYaUWf4YQ2u1SWzTYaxss,A3fsA9Zfv1X2fVEQhTw51lKENdNrEqT3,16,15,7,0,5,1,15,1,44,6.285714285714286,3,0.0,6,7,0,5,9,1,0,15,1,18,26,0
7612,120576,WIgM6nvV9YFBo82xFhtQp6923xmcbs69,SpATywNh6bZuzm8s1ceuBUnMUAeoAHHw,22,35,20,15,0,0,10,0,80,11.428571428571429,5,0.0,10,20,15,0,25,0,0,10,0,45,35,0
7613,120580,tepLda5wSKMdrl1YSxQ7o9ErmWSmjLIs,SpATywNh6bZuzm8s1ceuBUnMUAeoAHHw,26,54,34,19,6,29,27,0,169,24.142857142857142,5,0.0,9,34,18,6,45,29,1,27,0,67,102,0
7614,120581,lggvGpvA9S46sPyt7OTjASGRNtpXIFQL,SpATywNh6bZuzm8s1ceuBUnMUAeoAHHw,1,0,0,0,0,0,1,0,1,0.14285714285714285,1,0.0,0,0,0,0,0,0,0,1,0,0,1,1
7615,120586,cOTtp4pVPpt9GEFdMZaLCIG1IBXouqo8,A3fsA9Zfv1X2fVEQhTw51lKENdNrEqT3,1,0,0,0,0,0,1,0,1,0.14285714285714285,1,0.0,0,0,0,0,0,0,0,1,0,0,1,1
7616,120592,eS2KrqTdusBuI6pcIMw5VPgc4bcyJ1eG,bWdj2GDclj5ofokWjzoa5jAwMkxCykd6,2,0,0,0,0,0,2,0,2,0.2857142857142857,1,0.0,0,0,0,0,0,0,0,2,0,0,2,1
7617,120599,yhSGXw7EnYX7J3WWxRb9piBAfJaOtRLJ,SpATywNh6bZuzm8s1ceuBUnMUAeoAHHw,1,0,0,0,0,0,1,0,1,0.14285714285714285,1,0.0,0,0,0,0,0,0,0,1,0,0,1,1
7618,120621,7rzvmKtANOU8M4posmrNW445K28DcImr,SpATywNh6bZuzm8s1ceuBUnMUAeoAHHw,2,0,0,0,0,0,2,0,2,0.2857142857142857,1,0.0,0,0,0,0,0,0,0,2,0,0,2,0
7619,120628,T84tM0SY1NeTwy8ZOUv1K7SYM12l3y0u,SpATywNh6bZuzm8s1ceuBUnMUAeoAHHw,15,15,8,0,5,14,10,2,54,7.714285714285714,4,0.0,3,8,0,5,12,14,0,10,2,16,38,1
7620,120633,IU1lGseLxckCGwI4nmuh7Ca5kBungyEP,SpATywNh6bZuzm8s1ceuBUnMUAeoAHHw,14,35,2,25,2,0,2,0,66,9.428571428571429,1,0.0,17,2,21,2,18,0,4,2,0,42,24,1
7621,120634,EDLvNoRIb3gHoThJ1NoAuBrT3yJGczm3,A3fsA9Zfv1X2fVEQhTw51lKENdNrEqT3,2,0,0,0,0,0,4,0,4,0.5714285714285714,1,0.0,0,0,0,0,0,0,0,4,0,0,4,1
7622,120647,RrUICdqzzS6uEuuuo42x7DWjiBSOVyuw,RXDvfPUBYFlVdlueBFbLW0mhhAyGEqpt,11,7,6,0,2,2,4,0,21,3.0,1,0.0,0,6,0,2,7,2,0,4,0,8,13,1
7623,120650,AqOYZE1KwO9ElxY4ESIL8wZt1KCX4QiQ,SpATywNh6bZuzm8s1ceuBUnMUAeoAHHw,28,47,20,26,10,16,11,1,131,18.714285714285715,5,0.0,9,20,23,10,38,16,3,11,1,62,69,0
7624,120654,8eYQfp27L4KqSIcQS2lfdmoY7VEE1qFC,RXDvfPUBYFlVdlueBFbLW0mhhAyGEqpt,6,5,0,0,0,0,5,0,10,1.4285714285714286,1,0.0,0,0,0,0,5,0,0,5,0,0,10,1
7625,120680,Mv7oSGs75OaCjYLhHCNmqqrqaAjjO5gs,A3fsA9Zfv1X2fVEQhTw51lKENdNrEqT3,1,0,0,0,0,0,1,0,1,0.14285714285714285,1,0.0,0,0,0,0,0,0,0,1,0,0,1,1
7626,120683,1U4BCdHxNjp4LH6S6L2sowJaRSmQKYKF,A3fsA9Zfv1X2fVEQhTw51lKENdNrEqT3,5,8,1,0,1,0,5,0,15,2.142857142857143,2,0.0,0,1,0,1,8,0,0,5,0,2,13,1
7627,120685,dWpBguIfALUazWbTuRqWRbI4Z6RC5ZA1,SpATywNh6bZuzm8s1ceuBUnMUAeoAHHw,12,5,2,0,2,3,16,2,30,4.285714285714286,1,0.0,0,2,0,2,5,3,0,16,2,4,26,1
7628,120692,yPANNiQQMnN6yMtp5OhnGyYLdZrKDZ9V,RXDvfPUBYFlVdlueBFbLW0mhhAyGEqpt,9,4,3,0,2,0,3,0,12,1.7142857142857142,1,0.0,0,3,0,2,4,0,0,3,0,5,7,1
7629,120706,RrLCYgvxi3oib8ZNMGweT91KCXFbFqgQ,A3fsA9Zfv1X2fVEQhTw51lKENdNrEqT3,8,8,3,0,1,0,3,0,15,2.142857142857143,1,0.0,0,3,0,1,8,0,0,3,0,4,11,1
7630,120707,YBlpuOz29CjjHYq0RuGLiSzLtjKLdYy2,RXDvfPUBYFlVdlueBFbLW0mhhAyGEqpt,22,32,2,16,2,0,14,0,66,9.428571428571429,5,0.0,6,2,15,2,26,0,1,14,0,25,41,0
7631,120715,ucFGb4sKO6LhsbUaWhFjc3yaUOdGfmQa,RXDvfPUBYFlVdlueBFbLW0mhhAyGEqpt,7,2,2,0,2,0,2,0,8,1.1428571428571428,1,0.0,0,2,0,2,2,0,0,2,0,4,4,1
7632,120724,s4dtgJUQtJkEKTGiW6rNu8EDXRkyQStr,bWdj2GDclj5ofokWjzoa5jAwMkxCykd6,1,0,0,0,0,0,1,0,1,0.14285714285714285,1,0.0,0,0,0,0,0,0,0,1,0,0,1,1
7633,120736,niznzPsNcmf0qkvKVIABVzsBAFOWmMfr,SpATywNh6bZuzm8s1ceuBUnMUAeoAHHw,20,21,1,8,1,1,7,1,40,5.714285714285714,1,0.0,2,1,8,1,19,1,0,7,1,12,28,1
7634,120743,es5GTyNQHE6XqsHqRasxkSTkn6q7y8k2,SpATywNh6bZuzm8s1ceuBUnMUAeoAHHw,23,38,19,23,5,7,8,1,101,14.428571428571429,5,0.0,11,19,20,5,27,7,3,8,1,55,46,0
7635,120744,dvGlk7sqlRtsNklrx9jTekm5CnQWuhDQ,SpATywNh6bZuzm8s1ceuBUnMUAeoAHHw,21,23,13,17,6,0,8,0,67,9.571428571428571,4,0.0,6,13,17,6,17,0,0,8,0,42,25,1
7636,120755,PQyLGsdBWhEy27jacipkmntLAvcsGeQa,SpATywNh6bZuzm8s1ceuBUnMUAeoAHHw,28,22,12,30,8,4,7,0,83,11.857142857142858,2,0.0,9,12,25,8,13,4,5,7,0,54,29,0
7637,120768,lu6LWsHgfburMRdWsFabIR2bIQ3MFD6f,RXDvfPUBYFlVdlueBFbLW0mhhAyGEqpt,49,39,20,70,15,4,11,0,159,22.714285714285715,5,0.0,11,20,63,15,28,4,7,11,0,109,50,0
7638,120769,9ejhHF65VDeA89TY7yPYCEx8qdV4K69n,A3fsA9Zfv1X2fVEQhTw51lKENdNrEqT3,29,22,14,28,10,0,9,0,83,11.857142857142858,2,0.0,1,14,24,10,21,0,4,9,0,49,34,1
7639,120773,uiXIZg9P7E1egIRj5Sno619DS7IwlQY9,SpATywNh6bZuzm8s1ceuBUnMUAeoAHHw,1,0,0,0,0,0,1,0,1,0.14285714285714285,1,0.0,0,0,0,0,0,0,0,1,0,0,1,1
7640,120776,9ejhHF65VDeA89TY7yPYCEx8qdV4K69n,bWdj2GDclj5ofokWjzoa5jAwMkxCykd6,1,0,0,0,0,0,2,0,2,0.2857142857142857,1,0.0,0,0,0,0,0,0,0,2,0,0,2,1
7641,120785,Axaz2TU9iWJqggZ8S9ZVW7y3xhVfFBfg,SpATywNh6bZuzm8s1ceuBUnMUAeoAHHw,9,4,3,0,1,7,6,1,22,3.142857142857143,1,0.0,0,3,0,1,4,7,0,6,1,4,18,1
7642,120787,JBH4PfoUtr8SFyt6u3u3ciODwm9LbhKT,SpATywNh6bZuzm8s1ceuBUnMUAeoAHHw,8,2,1,0,1,0,5,1,10,1.4285714285714286,1,0.0,0,1,0,1,2,0,0,5,1,2,8,1
7643,120792,vSEsL1qLMsR8cNJOX6mMDcN6nVaHqWNR,bWdj2GDclj5ofokWjzoa5jAwMkxCykd6,1,0,0,0,0,0,1,0,1,0.14285714285714285,1,0.0,0,0,0,0,0,0,0,1,0,0,1,1
7644,120800,7bnGjPq4sg9VhmEEoEqqXHNgeEpEuUDV,bWdj2GDclj5ofokWjzoa5jAwMkxCykd6,11,12,6,0,2,23,8,4,55,7.857142857142857,2,0.0,0,6,0,2,12,23,0,8,4,8,47,0
7645,120807,KHl8vTLwoQOTsjJg2pVXTnG0Is0a8K1K,SpATywNh6bZuzm8s1ceuBUnMUAeoAHHw,5,2,1,0,1,0,2,1,7,1.0,1,0.0,0,1,0,1,2,0,0,2,1,2,5,1
7646,120809,bWtnIrdbQPafPqPLZtocbxJYk8IfZ76X,SpATywNh6bZuzm8s1ceuBUnMUAeoAHHw,7,3,2,0,2,0,2,0,9,1.2857142857142858,1,0.0,0,2,0,2,3,0,0,2,0,4,5,1
7647,120825,tQAgy689j7VgAO7nbWHE1fj0JJjMUDvF,SpATywNh6bZuzm8s1ceuBUnMUAeoAHHw,4,2,0,0,0,0,2,0,4,0.5714285714285714,1,0.0,0,0,0,0,2,0,0,2,0,0,4,1
7648,120827,tCQ9JALurTpI0v0jgUfmOoOzw21YvN4S,RXDvfPUBYFlVdlueBFbLW0mhhAyGEqpt,10,4,3,0,1,2,6,1,17,2.4285714285714284,1,0.0,0,3,0,1,4,2,0,6,1,4,13,1
7649,120831,JLn36xalC1eIUd4jm6gux9oEgx3gpDxA,SpATywNh6bZuzm8s1ceuBUnMUAeoAHHw,15,24,0,17,0,0,5,0,46,6.571428571428571,2,0.0,6,0,15,0,18,0,2,5,0,21,25,1
7650,120833,72z519PMt8GGBXLvF1FG0oMJuciCSWYJ,SpATywNh6bZuzm8s1ceuBUnMUAeoAHHw,5,4,1,0,0,0,4,0,9,1.2857142857142858,3,0.0,0,1,0,0,4,0,0,4,0,1,8,1
7651,120844,JjOxJWvSLO4lglPA5ATD8doF5KAfdZlo,G8EPVSXsOYB5YQWZGiz1aVq5Pgr2GrQu,1,0,0,0,0,0,1,0,1,0.14285714285714285,1,0.0,0,0,0,0,0,0,0,1,0,0,1,1
7652,120846,UkERsue63b46ZbS092pGmdIWYcMFC2bg,SpATywNh6bZuzm8s1ceuBUnMUAeoAHHw,7,7,1,0,0,0,4,0,12,1.7142857142857142,2,0.0,0,1,0,0,7,0,0,4,0,1,11,1
7653,120851,dJq8sIYKCGcPSHpIrI20rFWCk7jAqAdY,A3fsA9Zfv1X2fVEQhTw51lKENdNrEqT3,8,4,3,0,3,0,1,0,11,1.5714285714285714,1,0.0,0,3,0,3,4,0,0,1,0,6,5,1
7654,120852,EPmLjBxeWpwhjwoRgtmLV8RkhFOu2zzj,G8EPVSXsOYB5YQWZGiz1aVq5Pgr2GrQu,1,0,0,0,0,0,1,0,1,0.14285714285714285,1,0.0,0,0,0,0,0,0,0,1,0,0,1,1
7655,120874,c7JueNv3hDicP8Z6SVI5VQqnBM3V6CD4,SpATywNh6bZuzm8s1ceuBUnMUAeoAHHw,8,7,3,0,2,2,15,3,32,4.571428571428571,1,0.0,0,3,0,2,7,2,0,15,3,5,27,1
7656,120878,edVuZXQuYE4LHUfAzzB1uGhpYsPr0vJx,SpATywNh6bZuzm8s1ceuBUnMUAeoAHHw,31,34,14,37,8,7,13,3,116,16.571428571428573,3,0.0,8,14,31,8,26,7,6,13,3,61,55,0
7657,120881,Ow20UOjVruC0CURQijQixRuf9scGhyUK,G8EPVSXsOYB5YQWZGiz1aVq5Pgr2GrQu,5,2,2,0,2,0,3,0,9,1.2857142857142858,2,0.0,0,2,0,2,2,0,0,3,0,4,5,1
7658,120893,xb9WJcv3uIYBfZD9WqegvIpYdxaUF3h5,bWdj2GDclj5ofokWjzoa5jAwMkxCykd6,8,8,4,0,3,0,3,0,18,2.5714285714285716,2,0.0,0,4,0,3,8,0,0,3,0,7,11,1
7659,120896,u5ObOMoHUcvVsOQTGkiv0BRKKcn8v2w8,A3fsA9Zfv1X2fVEQhTw51lKENdNrEqT3,13,14,8,0,5,0,6,0,33,4.714285714285714,1,0.0,2,8,0,5,12,0,0,6,0,15,18,0
7660,120904,kFp6IoufrvIevAVHehiSDqUBNzpbkI6L,bWdj2GDclj5ofokWjzoa5jAwMkxCykd6,23,49,26,34,11,25,29,2,176,25.142857142857142,8,0.0,6,26,32,11,43,25,2,29,2,75,101,0
7661,120919,DahdU3m64q9GHbzMvs6TdHVFTDo4asbt,SpATywNh6bZuzm8s1ceuBUnMUAeoAHHw,3,0,0,0,0,0,5,0,5,0.7142857142857143,3,0.0,0,0,0,0,0,0,0,5,0,0,5,1
7662,120924,ocmyq6MXRULfgpYdGM8QGfWnP2Queprt,SpATywNh6bZuzm8s1ceuBUnMUAeoAHHw,28,48,28,15,15,0,19,4,129,18.428571428571427,4,0.0,5,28,15,15,43,0,0,19,4,63,66,1
7663,120927,4bcOXBC1lhgwF9Pg3IMx9vJFVwNtFyik,SpATywNh6bZuzm8s1ceuBUnMUAeoAHHw,17,45,11,2,4,1,22,0,85,12.142857142857142,5,0.0,0,11,2,4,45,1,0,22,0,17,68,1
7664,120936,i0ksX07HnsV5rQlWqOr1uKEuc7yNU24c,A3fsA9Zfv1X2fVEQhTw51lKENdNrEqT3,53,39,26,68,12,29,28,3,205,29.285714285714285,6,0.0,3,26,56,12,36,29,12,28,3,97,108,0
7665,120940,KkBPwixR7onoXlZ2HnK8cYokgUE3P396,bWdj2GDclj5ofokWjzoa5jAwMkxCykd6,6,4,0,0,0,0,7,0,11,1.5714285714285714,3,0.0,0,0,0,0,4,0,0,7,0,0,11,1
7666,120948,TevGcL3mCy823FJCU3MpLHqDSnMlx8KC,SpATywNh6bZuzm8s1ceuBUnMUAeoAHHw,28,19,13,29,8,0,3,0,72,10.285714285714286,2,0.0,4,13,22,8,15,0,7,3,0,47,25,0
7667,120953,HGkuwdB1J817cl9wl529SZa2OTu14HFB,SpATywNh6bZuzm8s1ceuBUnMUAeoAHHw,31,27,13,35,7,8,15,1,106,15.142857142857142,2,0.0,10,13,30,7,17,8,5,15,1,60,46,0
7668,120964,JCDOEMgsanA2Wd8RJtg9ctpT52Gae7ak,SpATywNh6bZuzm8s1ceuBUnMUAeoAHHw,1,0,0,0,0,0,1,0,1,0.14285714285714285,1,0.0,0,0,0,0,0,0,0,1,0,0,1,1
7669,120967,nToY9YbKok17BpaPlTxZF9mLZdFu0iiS,G8EPVSXsOYB5YQWZGiz1aVq5Pgr2GrQu,17,19,12,0,9,0,6,0,46,6.571428571428571,3,0.0,3,12,0,9,16,0,0,6,0,24,22,1
7670,120969,hNYqJEuS1AXT481SIEkT37fZObOmjXuX,G8EPVSXsOYB5YQWZGiz1aVq5Pgr2GrQu,6,4,2,0,1,0,4,0,11,1.5714285714285714,1,0.0,0,2,0,1,4,0,0,4,0,3,8,1
7671,120983,Tg9kFmEr6KGEyzeoopWvQ3WCSPhx01lk,SpATywNh6bZuzm8s1ceuBUnMUAeoAHHw,30,37,23,25,9,6,31,5,136,19.428571428571427,5,0.0,5,23,24,9,32,6,1,31,5,61,75,1
7672,120986,OcU9jyzQQ3iLPmO8KqVEvCwQSxQdBoZu,SpATywNh6bZuzm8s1ceuBUnMUAeoAHHw,11,15,7,0,5,1,10,1,39,5.571428571428571,2,0.0,4,7,0,5,11,1,0,10,1,16,23,1
7673,120998,y7Z8jSjEija2cXP8zDhgGRVfac5fnMAR,SpATywNh6bZuzm8s1ceuBUnMUAeoAHHw,9,16,0,2,0,0,3,0,21,3.0,4,0.0,1,0,2,0,15,0,0,3,0,3,18,1
7674,121001,k2w7Fl2HRg9SZoDIHFnK8RXCKuBBE2y7,A3fsA9Zfv1X2fVEQhTw51lKENdNrEqT3,61,35,21,90,13,27,11,0,197,28.142857142857142,4,0.0,2,21,79,13,33,27,11,11,0,115,82,1
7675,121014,5sovUdBY4AsVUtXY7BWDVXxvHAPsWkZb,A3fsA9Zfv1X2fVEQhTw51lKENdNrEqT3,9,5,4,0,3,0,1,0,13,1.8571428571428572,1,0.0,0,4,0,3,5,0,0,1,0,7,6,1
7676,121017,iW5zRjJuIjvxlxhDULlodfhsU8gFYbbs,SpATywNh6bZuzm8s1ceuBUnMUAeoAHHw,8,7,6,0,0,0,2,0,15,2.142857142857143,1,0.0,0,6,0,0,7,0,0,2,0,6,9,1
7677,121039,QaKdVtbgjSMpkDFYeFcsaL5O2NEtGRQz,SpATywNh6bZuzm8s1ceuBUnMUAeoAHHw,1,0,0,0,0,0,1,0,1,0.14285714285714285,1,0.0,0,0,0,0,0,0,0,1,0,0,1,1
7678,121053,npZiJYBXIvuULdTyVSfZOjhsnEdX6i82,SpATywNh6bZuzm8s1ceuBUnMUAeoAHHw,30,37,18,37,8,0,5,0,105,15.0,2,0.0,15,18,31,8,22,0,6,5,0,72,33,0
7679,121085,hWWjbjEJOX0Ph07p1EJp8Ya48hU8wP5v,SpATywNh6bZuzm8s1ceuBUnMUAeoAHHw,30,70,33,39,19,0,14,0,175,25.0,3,0.0,11,33,35,19,59,0,4,14,0,98,77,0
7680,121096,ZtA9pLb0sfgqk6iLVTJtOHVhh3oHeQLC,SpATywNh6bZuzm8s1ceuBUnMUAeoAHHw,5,2,0,0,0,0,3,0,5,0.7142857142857143,1,0.0,0,0,0,0,2,0,0,3,0,0,5,1
7681,121099,cHpOktJabOMVpsE04dze5ePRZnN7bWdJ,A3fsA9Zfv1X2fVEQhTw51lKENdNrEqT3,14,8,6,0,5,0,3,0,22,3.142857142857143,2,0.0,0,6,0,5,8,0,0,3,0,11,11,1
7682,121101,34fQh4AyuAWML6hByTmQJCsftdAFH2Hu,SpATywNh6bZuzm8s1ceuBUnMUAeoAHHw,19,36,15,18,4,0,10,1,84,12.0,3,0.0,16,15,15,4,20,0,3,10,1,50,34,1
7683,121118,vTTrcE2RlYlajsEul9ylLY6DUQNcdNgN,SpATywNh6bZuzm8s1ceuBUnMUAeoAHHw,7,6,4,0,2,0,2,0,14,2.0,2,0.0,0,4,0,2,6,0,0,2,0,6,8,1
7684,121122,GlVmjWGZ8XsOuLGdZvtzRw0xzELGNzxx,bWdj2GDclj5ofokWjzoa5jAwMkxCykd6,4,9,5,0,0,0,2,0,16,2.2857142857142856,5,0.0,0,5,0,0,9,0,0,2,0,5,11,1
7685,121137,5uUrNOrq1vz8XtHDv1LWcBc27EEqbO5u,SpATywNh6bZuzm8s1ceuBUnMUAeoAHHw,19,43,4,22,1,0,7,0,77,11.0,4,0.0,3,4,20,1,40,0,2,7,0,28,49,1
7686,121140,QAb8PmUj3McyQuaW6daHNk0NhlxSWKuO,SpATywNh6bZuzm8s1ceuBUnMUAeoAHHw,1,0,0,0,0,0,2,0,2,0.2857142857142857,2,0.0,0,0,0,0,0,0,0,2,0,0,2,1
7687,121141,YhSlQp6TZH2sVWIgjyn2YxpekmOBzjQt,SpATywNh6bZuzm8s1ceuBUnMUAeoAHHw,27,30,16,25,8,0,10,0,89,12.714285714285714,3,0.0,11,16,23,8,19,0,2,10,0,58,31,0
7688,121142,xlx6h4vTU14b0zR9O9NKqKPZoDtNmECc,A3fsA9Zfv1X2fVEQhTw51lKENdNrEqT3,10,8,4,0,2,0,3,0,17,2.4285714285714284,1,0.0,2,4,0,2,6,0,0,3,0,8,9,1
7689,121143,rik0F1mWVOeGz53BJ3pfmg90EeuTpONo,bWdj2GDclj5ofokWjzoa5jAwMkxCykd6,5,5,1,0,1,0,2,0,9,1.2857142857142858,1,0.0,0,1,0,1,5,0,0,2,0,2,7,1
7690,121145,atoEVjauO8UqqxbDs90qm3bNJMwCLIt0,SpATywNh6bZuzm8s1ceuBUnMUAeoAHHw,5,2,1,0,1,0,2,0,6,0.8571428571428571,1,0.0,0,1,0,1,2,0,0,2,0,2,4,0
7691,121156,ZPtKMZp2cxlBd5CcEcoCaraY1yoC22cg,SpATywNh6bZuzm8s1ceuBUnMUAeoAHHw,30,21,14,44,8,1,7,0,95,13.571428571428571,2,0.0,4,14,38,8,17,1,6,7,0,64,31,0
7692,121161,Yl3fWDphM6Ifhmu0NrJgclA0dIl02Kms,A3fsA9Zfv1X2fVEQhTw51lKENdNrEqT3,10,5,3,0,2,0,4,0,14,2.0,1,0.0,1,3,0,2,4,0,0,4,0,6,8,1
7693,121165,Sp3nYt5ii7nPRoxqEiVcKwwIa973Pnnr,A3fsA9Zfv1X2fVEQhTw51lKENdNrEqT3,29,11,6,64,2,0,4,0,87,12.428571428571429,2,0.0,4,6,54,2,7,0,10,4,0,66,21,1
7694,121169,WJs2oS3DHmzLGumW31DTiDLH77aXdb4Z,G8EPVSXsOYB5YQWZGiz1aVq5Pgr2GrQu,1,0,0,0,0,0,1,0,1,0.14285714285714285,1,0.0,0,0,0,0,0,0,0,1,0,0,1,1
7695,121171,w81M8LsxqroaoVvhuOiOu12ogu2TTrVp,SpATywNh6bZuzm8s1ceuBUnMUAeoAHHw,8,8,2,0,3,0,3,0,16,2.2857142857142856,2,0.0,0,2,0,3,8,0,0,3,0,5,11,1
7696,121172,J7iejq5NtsfdHjPTK3MrPhGPRoJN9WrB,bWdj2GDclj5ofokWjzoa5jAwMkxCykd6,1,0,0,0,0,0,1,0,1,0.14285714285714285,1,0.0,0,0,0,0,0,0,0,1,0,0,1,1
7697,121195,rrD2k9raPTugWiiZJjKTcEpxfKzXPOoh,A3fsA9Zfv1X2fVEQhTw51lKENdNrEqT3,5,2,1,0,1,0,2,0,6,0.8571428571428571,1,0.0,0,1,0,1,2,0,0,2,0,2,4,1
7698,121200,xyoj4G3pVqlUCzQtS2iNDV55nyPLJkyp,A3fsA9Zfv1X2fVEQhTw51lKENdNrEqT3,8,5,4,0,4,0,1,0,14,2.0,1,0.0,0,4,0,4,5,0,0,1,0,8,6,1
7699,121201,osRqgZRzeeCEid1eYNHbUWEZePoVbqKO,SpATywNh6bZuzm8s1ceuBUnMUAeoAHHw,6,3,1,0,1,0,2,0,7,1.0,1,0.0,0,1,0,1,3,0,0,2,0,2,5,1
7700,121205,irUhnQtLaQWO9Ilnw5LLg2nfVwuwwh1f,SpATywNh6bZuzm8s1ceuBUnMUAeoAHHw,5,4,0,0,0,0,6,1,11,1.5714285714285714,2,0.0,0,0,0,0,4,0,0,6,1,0,11,1
7701,121225,6lL0tobxamv6kkGYMIOtqqnjmWQC4apa,A3fsA9Zfv1X2fVEQhTw51lKENdNrEqT3,71,30,23,138,16,3,8,1,219,31.285714285714285,2,0.0,2,23,123,16,28,3,15,8,1,164,55,1
7702,121226,RdjpcuNJHcq9iKd6LdCp1m7jbwau68ud,SpATywNh6bZuzm8s1ceuBUnMUAeoAHHw,2,0,0,0,0,1,2,0,3,0.42857142857142855,1,0.0,0,0,0,0,0,1,0,2,0,0,3,1
7703,121232,lojhMqQRO46DZsZEpJYUmk4ki07ZAOFG,SpATywNh6bZuzm8s1ceuBUnMUAeoAHHw,1,0,0,0,0,0,1,0,1,0.14285714285714285,1,0.0,0,0,0,0,0,0,0,1,0,0,1,1
7704,121261,YPxQmDfYnmHgiT7CBa1xK3KUyMZAnQfd,A3fsA9Zfv1X2fVEQhTw51lKENdNrEqT3,8,4,3,0,2,0,2,0,11,1.5714285714285714,1,0.0,0,3,0,2,4,0,0,2,0,5,6,1
7705,121269,OifsLGRBGBgFFNsSrNDnK5W8Vbn9qLGX,A3fsA9Zfv1X2fVEQhTw51lKENdNrEqT3,2,2,0,0,0,0,0,0,2,0.2857142857142857,1,0.0,0,0,0,0,2,0,0,0,0,0,2,1
7706,121279,iSSrSd8vVxBC2JC6ajviRFDfdtqLCuym,A3fsA9Zfv1X2fVEQhTw51lKENdNrEqT3,1,0,0,0,0,0,1,0,1,0.14285714285714285,1,0.0,0,0,0,0,0,0,0,1,0,0,1,1
7707,121286,go4j7bRhXINgA1WuC2lRA0Hee8dTMRV5,SpATywNh6bZuzm8s1ceuBUnMUAeoAHHw,8,6,4,0,2,0,6,0,18,2.5714285714285716,2,0.0,0,4,0,2,6,0,0,6,0,6,12,1
7708,121292,b4JhdDZuiMoCYMffFqg7ALO9K4ZBVn12,A3fsA9Zfv1X2fVEQhTw51lKENdNrEqT3,32,29,23,0,15,1,15,0,83,11.857142857142858,3,0.0,0,23,0,15,29,1,0,15,0,38,45,1
7709,121298,ONVx5VkCTs6D7RWJGi0oaLbXvf1yyHqy,bWdj2GDclj5ofokWjzoa5jAwMkxCykd6,1,0,0,0,0,0,1,0,1,0.14285714285714285,1,0.0,0,0,0,0,0,0,0,1,0,0,1,1
7710,121308,vFTyJ5TiVtOMNTDle7WFtHDAgvur1Shs,SpATywNh6bZuzm8s1ceuBUnMUAeoAHHw,7,4,3,0,3,0,2,0,12,1.7142857142857142,1,0.0,0,3,0,3,4,0,0,2,0,6,6,1
7711,121315,20miIbW6puYcFBNRUpHWBfGdgoL7IsKl,A3fsA9Zfv1X2fVEQhTw51lKENdNrEqT3,2,0,0,0,0,0,3,0,3,0.42857142857142855,1,0.0,0,0,0,0,0,0,0,3,0,0,3,1
7712,121316,AOiSjL4Nis9M3s1AhiMS89hfMIvo6CLU,SpATywNh6bZuzm8s1ceuBUnMUAeoAHHw,1,0,0,0,0,0,1,0,1,0.14285714285714285,1,0.0,0,0,0,0,0,0,0,1,0,0,1,1
7713,121325,togvLGeHHJalLzAy7gb7bMJngLXYGAjs,bWdj2GDclj5ofokWjzoa5jAwMkxCykd6,6,2,1,0,1,0,3,0,7,1.0,1,0.0,0,1,0,1,2,0,0,3,0,2,5,1
7714,121327,togvLGeHHJalLzAy7gb7bMJngLXYGAjs,A3fsA9Zfv1X2fVEQhTw51lKENdNrEqT3,2,0,0,0,0,0,2,0,2,0.2857142857142857,1,0.0,0,0,0,0,0,0,0,2,0,0,2,1
7715,121329,zJaHqs5kxeHEJuK4mQU1DIdrSDzLOTmW,bWdj2GDclj5ofokWjzoa5jAwMkxCykd6,1,0,0,0,0,0,1,0,1,0.14285714285714285,1,0.0,0,0,0,0,0,0,0,1,0,0,1,1
7716,121334,X9tesPfVRQu9R7pVopuvpFNecLnZt8Km,SpATywNh6bZuzm8s1ceuBUnMUAeoAHHw,26,32,11,13,5,3,16,1,81,11.571428571428571,4,0.0,8,11,11,5,24,3,2,16,1,35,46,1
7717,121335,rcQSbcF05AQYvzQJmDOGu4MfsQVuu05l,SpATywNh6bZuzm8s1ceuBUnMUAeoAHHw,29,27,16,33,7,2,7,1,93,13.285714285714286,3,0.0,8,16,29,7,19,2,4,7,1,60,33,0
7718,121350,OaR2omePx63fXdBiAV1sA954f6IcbIvq,A3fsA9Zfv1X2fVEQhTw51lKENdNrEqT3,22,24,17,18,10,0,14,0,83,11.857142857142858,4,0.0,2,17,18,10,22,0,0,14,0,47,36,0
7719,121354,EIHhmYlRU23gD32AsZHHvSXzjtFCo0yL,SpATywNh6bZuzm8s1ceuBUnMUAeoAHHw,12,18,2,14,0,2,4,0,40,5.714285714285714,3,0.0,3,2,12,0,15,2,2,4,0,17,23,1
7720,121375,JwzCuKRnJiCboJiRTMovpzJhdCfcNETm,A3fsA9Zfv1X2fVEQhTw51lKENdNrEqT3,12,14,1,0,2,0,1,0,18,2.5714285714285716,1,0.0,0,1,0,2,14,0,0,1,0,3,15,1
7721,121382,Kgm7zLW8p8Jc9BDI12KiHyoMRqlC0TXl,SpATywNh6bZuzm8s1ceuBUnMUAeoAHHw,1,0,0,0,0,0,1,0,1,0.14285714285714285,1,0.0,0,0,0,0,0,0,0,1,0,0,1,1
7722,121383,7af3IyECXIPSWoeM4guaEGHMHNE9EYdr,SpATywNh6bZuzm8s1ceuBUnMUAeoAHHw,1,0,0,0,0,0,1,0,1,0.14285714285714285,1,0.0,0,0,0,0,0,0,0,1,0,0,1,1
7723,121385,3pMXqJaEYEy2mxtFTggtjQ8mcRHGvdLr,SpATywNh6bZuzm8s1ceuBUnMUAeoAHHw,5,4,3,0,0,0,2,0,9,1.2857142857142858,2,0.0,0,3,0,0,4,0,0,2,0,3,6,1
7724,121390,3jWLQZ2XpNpB2H4UFvKRCVfzgbIsEanY,A3fsA9Zfv1X2fVEQhTw51lKENdNrEqT3,1,0,0,0,0,0,1,0,1,0.14285714285714285,1,0.0,0,0,0,0,0,0,0,1,0,0,1,1
7725,121395,Xn0msswMya4DdeH7Dc0xTOd0ODvYwWM7,SpATywNh6bZuzm8s1ceuBUnMUAeoAHHw,1,0,0,0,0,0,1,0,1,0.14285714285714285,1,0.0,0,0,0,0,0,0,0,1,0,0,1,1
7726,121400,BMjIPGqtYoLatxXDEHrhiIMt72Ckp0Wf,SpATywNh6bZuzm8s1ceuBUnMUAeoAHHw,13,38,3,18,0,5,10,2,76,10.857142857142858,2,0.0,6,3,16,0,32,5,2,10,2,25,51,1
7727,121403,Uf8FY0gZoVytp6K7SsDRXVZeOCL2hDEX,bWdj2GDclj5ofokWjzoa5jAwMkxCykd6,13,11,7,0,3,6,13,1,41,5.857142857142857,2,0.0,0,7,0,3,11,6,0,13,1,10,31,1
7728,121409,vi8rW5hK5fGcrIxB8UA7uUUfvDXFcBEr,SpATywNh6bZuzm8s1ceuBUnMUAeoAHHw,6,3,2,0,2,0,1,0,8,1.1428571428571428,1,0.0,0,2,0,2,3,0,0,1,0,4,4,1
7729,121411,VytsQ5XFduK8xsP7edRPe1GY948fNELc,SpATywNh6bZuzm8s1ceuBUnMUAeoAHHw,6,3,2,0,2,0,6,1,14,2.0,3,0.0,0,2,0,2,3,0,0,6,1,4,10,1
7730,121418,HSjT6fK4xHlufEG141acXPeMw5gqxgnK,RXDvfPUBYFlVdlueBFbLW0mhhAyGEqpt,1,0,0,0,0,0,1,0,1,0.14285714285714285,1,0.0,0,0,0,0,0,0,0,1,0,0,1,1
7731,121419,I6qGclNEImKeNJdvIwY5PrrMknw1zeQu,SpATywNh6bZuzm8s1ceuBUnMUAeoAHHw,29,52,27,31,8,4,16,0,138,19.714285714285715,4,0.0,10,27,27,8,42,4,4,16,0,72,66,0
7732,121430,wmNYHs69T6CHydhCxfzhydbjA79LMuTD,A3fsA9Zfv1X2fVEQhTw51lKENdNrEqT3,11,7,5,0,4,0,3,0,19,2.7142857142857144,2,0.0,0,5,0,4,7,0,0,3,0,9,10,1
7733,121432,SZ5q3TqDiWq8s23sHXWpsG5po2IH5JPk,A3fsA9Zfv1X2fVEQhTw51lKENdNrEqT3,42,18,12,64,10,0,5,0,109,15.571428571428571,1,0.0,4,12,58,10,14,0,6,5,0,84,25,1
7734,121448,TdEOLyaFODrUztdbfcJuA9ZwFd0i4XD2,SpATywNh6bZuzm8s1ceuBUnMUAeoAHHw,4,3,2,0,0,0,1,0,6,0.8571428571428571,1,0.0,0,2,0,0,3,0,0,1,0,2,4,1
7735,121457,ZBXcY1yn7nPU5Nfb3hlu4PDRbw4uvT17,bWdj2GDclj5ofokWjzoa5jAwMkxCykd6,5,2,1,0,1,0,2,0,6,0.8571428571428571,1,0.0,0,1,0,1,2,0,0,2,0,2,4,1
7736,121491,YydaZKjlAxGfDjMV5cfCRvsT4mycBKZj,SpATywNh6bZuzm8s1ceuBUnMUAeoAHHw,2,0,0,0,0,0,2,0,2,0.2857142857142857,1,0.0,0,0,0,0,0,0,0,2,0,0,2,1
7737,121499,4pJSh8LpNyCkIEyBWC74bNGXhEuDFen1,A3fsA9Zfv1X2fVEQhTw51lKENdNrEqT3,7,3,2,0,2,0,2,0,9,1.2857142857142858,1,0.0,0,2,0,2,3,0,0,2,0,4,5,1
7738,121506,8MuDfPMTQjGdTGCwKyaBRuguRPTmkIOy,SpATywNh6bZuzm8s1ceuBUnMUAeoAHHw,1,0,0,0,0,0,1,0,1,0.14285714285714285,1,0.0,0,0,0,0,0,0,0,1,0,0,1,1
7739,121507,gt5tqcVggdqz1dxVZeHDF843i5ITQdCe,SpATywNh6bZuzm8s1ceuBUnMUAeoAHHw,4,0,0,0,0,0,8,0,8,1.1428571428571428,1,0.0,0,0,0,0,0,0,0,8,0,0,8,1
7740,121533,H4AuaeZGDkkLMPXUAyZX0i8XXk2BDNyk,G8EPVSXsOYB5YQWZGiz1aVq5Pgr2GrQu,6,6,4,0,2,0,1,0,13,1.8571428571428572,1,0.0,0,4,0,2,6,0,0,1,0,6,7,1
7741,121556,D2GfCnbuT86TYful9fFSzT7T5yZ1f04f,A3fsA9Zfv1X2fVEQhTw51lKENdNrEqT3,34,22,15,30,13,0,6,0,86,12.285714285714286,2,0.0,5,15,26,13,17,0,4,6,0,59,27,1
7742,121558,YPFriT4OfareXOz7G4xpBUwlcCA03JlS,SpATywNh6bZuzm8s1ceuBUnMUAeoAHHw,21,22,17,0,13,0,8,0,60,8.571428571428571,2,0.0,0,17,0,13,22,0,0,8,0,30,30,1
7743,121569,4fggBiTulBMhqyvK9Klo3I0joX8sXLqR,RXDvfPUBYFlVdlueBFbLW0mhhAyGEqpt,7,6,3,0,1,0,3,1,14,2.0,2,0.0,0,3,0,1,6,0,0,3,1,4,10,1
7744,121571,LhjMbgeFB1ZSL6HIgJEVDb0SZxar7EsN,A3fsA9Zfv1X2fVEQhTw51lKENdNrEqT3,1,0,0,0,0,0,1,0,1,0.14285714285714285,1,0.0,0,0,0,0,0,0,0,1,0,0,1,1
7745,121573,kj5o7wMZl1s4q0cggcmipnm7O7L6g4Ps,G8EPVSXsOYB5YQWZGiz1aVq5Pgr2GrQu,1,0,0,0,0,0,1,0,1,0.14285714285714285,1,0.0,0,0,0,0,0,0,0,1,0,0,1,1
7746,121590,9iGaqBGS5kkoXjLd87hUL2eIJMVUVKfU,RXDvfPUBYFlVdlueBFbLW0mhhAyGEqpt,9,15,8,0,0,0,4,0,27,3.857142857142857,3,0.0,0,8,0,0,15,0,0,4,0,8,19,1
7747,121598,CtUi7t368xVR51EojyElWFRq57eG1Gx1,bWdj2GDclj5ofokWjzoa5jAwMkxCykd6,6,2,1,0,1,0,3,1,8,1.1428571428571428,1,0.0,0,1,0,1,2,0,0,3,1,2,6,1
7748,121606,qbhlqWnlMqLEJtHv0AQDrobM0lY6ZQwu,SpATywNh6bZuzm8s1ceuBUnMUAeoAHHw,1,0,0,0,0,0,1,0,1,0.14285714285714285,1,0.0,0,0,0,0,0,0,0,1,0,0,1,1
7749,121611,bDlowck7PoswtmYozGMoa41g1GVEejKh,RXDvfPUBYFlVdlueBFbLW0mhhAyGEqpt,69,73,46,88,31,0,11,0,249,35.57142857142857,4,0.0,20,46,85,31,53,0,3,11,0,182,67,0
7750,121619,JfftjOGdDbpgbrupi0Gwr899R0jzXikJ,A3fsA9Zfv1X2fVEQhTw51lKENdNrEqT3,17,22,13,0,6,1,14,1,57,8.142857142857142,4,0.0,0,13,0,6,22,1,0,14,1,19,38,1
7751,121641,ThGblU6q4nWmu3ORXgM7eQc8q9vcBP4r,G8EPVSXsOYB5YQWZGiz1aVq5Pgr2GrQu,2,0,0,0,0,0,5,0,5,0.7142857142857143,1,0.0,0,0,0,0,0,0,0,5,0,0,5,1
7752,121643,ZULomXsITwM6vNxcJN8imzU1pyfKn8Cw,bWdj2GDclj5ofokWjzoa5jAwMkxCykd6,4,2,1,0,1,0,1,0,5,0.7142857142857143,1,0.0,0,1,0,1,2,0,0,1,0,2,3,1
7753,121648,jXl4Q6TFlYw71Bn9dguW333wEk83ysVq,SpATywNh6bZuzm8s1ceuBUnMUAeoAHHw,15,74,0,18,0,17,26,2,137,19.571428571428573,3,0.0,27,0,13,0,47,17,5,26,2,40,97,1
7754,121655,h0mYz4sCKBTfszMtgSo44TDhg1SbrdKo,SpATywNh6bZuzm8s1ceuBUnMUAeoAHHw,1,0,0,0,0,0,1,0,1,0.14285714285714285,1,0.0,0,0,0,0,0,0,0,1,0,0,1,1
7755,121662,5HXdL6OatNrhiY174KvxQUp0tpTJ3ory,SpATywNh6bZuzm8s1ceuBUnMUAeoAHHw,13,16,0,8,0,0,7,0,31,4.428571428571429,4,0.0,5,0,7,0,11,0,1,7,0,12,19,0
7756,121671,aCa6UD5e0XT0F0IHI4OQnRXRULZbtISA,SpATywNh6bZuzm8s1ceuBUnMUAeoAHHw,6,2,1,0,1,0,3,0,7,1.0,1,0.0,0,1,0,1,2,0,0,3,0,2,5,1
7757,121698,4QwjE5TQhZzqrIrmgTxr1bYCO2SVUQg8,SpATywNh6bZuzm8s1ceuBUnMUAeoAHHw,5,2,1,0,1,0,2,0,6,0.8571428571428571,1,0.0,0,1,0,1,2,0,0,2,0,2,4,1
7758,121707,4Mn2tC0xP3jJpRjJYgW6V342Z3uScDbd,A3fsA9Zfv1X2fVEQhTw51lKENdNrEqT3,6,3,1,0,1,0,3,0,8,1.1428571428571428,1,0.0,0,1,0,1,3,0,0,3,0,2,6,1
7759,121708,UBz29jsG8rR9fxGJ07ON7jTRlCVHOAv0,A3fsA9Zfv1X2fVEQhTw51lKENdNrEqT3,11,6,4,0,4,0,1,0,15,2.142857142857143,1,0.0,0,4,0,4,6,0,0,1,0,8,7,0
7760,121722,u92r3WC1YEXgmCIXMjFGJYvXTQBxOYhd,SpATywNh6bZuzm8s1ceuBUnMUAeoAHHw,13,11,4,17,3,0,2,0,37,5.285714285714286,1,0.0,6,4,16,3,5,0,1,2,0,29,8,1
7761,121729,ZrDgEyfoUHLa5uf0N0ml9T9xO22FqwKE,SpATywNh6bZuzm8s1ceuBUnMUAeoAHHw,17,24,3,6,2,1,13,1,50,7.142857142857143,3,0.0,9,3,6,2,15,1,0,13,1,20,30,0
7762,121734,x6OLIz4hMM0ByyN6TmY57kyFyEddmJ4M,A3fsA9Zfv1X2fVEQhTw51lKENdNrEqT3,6,9,4,0,0,0,4,0,17,2.4285714285714284,2,0.0,0,4,0,0,9,0,0,4,0,4,13,1
7763,121761,x6OLIz4hMM0ByyN6TmY57kyFyEddmJ4M,bWdj2GDclj5ofokWjzoa5jAwMkxCykd6,21,30,11,64,11,1,8,1,126,18.0,2,0.0,11,11,58,11,19,1,6,8,1,91,35,1
7764,121765,v4KRIvW2fm59UFurmYoSZsK2mZZrmnsA,bWdj2GDclj5ofokWjzoa5jAwMkxCykd6,9,6,3,0,1,10,11,2,33,4.714285714285714,3,0.0,0,3,0,1,6,10,0,11,2,4,29,1
7765,121767,v4KRIvW2fm59UFurmYoSZsK2mZZrmnsA,A3fsA9Zfv1X2fVEQhTw51lKENdNrEqT3,6,3,2,0,2,0,1,0,8,1.1428571428571428,1,0.0,0,2,0,2,3,0,0,1,0,4,4,1
7766,121775,jqFdSJ7Rp5LdpTT9xaXcYyPDgZuP8K28,SpATywNh6bZuzm8s1ceuBUnMUAeoAHHw,8,6,1,0,1,0,3,0,11,1.5714285714285714,1,0.0,0,1,0,1,6,0,0,3,0,2,9,1
7767,121787,x4Txzgd0OUi5yqi55NtM21eJpZWiZeEW,A3fsA9Zfv1X2fVEQhTw51lKENdNrEqT3,12,20,2,0,2,0,6,0,30,4.285714285714286,2,0.0,0,2,0,2,20,0,0,6,0,4,26,1
7768,121807,FAflDmZ5UbfFzu5Y3WrugBr3CXMWVehE,bWdj2GDclj5ofokWjzoa5jAwMkxCykd6,1,0,0,0,0,0,1,0,1,0.14285714285714285,1,0.0,0,0,0,0,0,0,0,1,0,0,1,1
7769,121808,QhQuu2NMHYcgj0YP3onmnea8Jv814Mc8,SpATywNh6bZuzm8s1ceuBUnMUAeoAHHw,4,3,1,0,1,0,1,0,6,0.8571428571428571,1,0.0,0,1,0,1,3,0,0,1,0,2,4,1
7770,121817,qZUSZi93i2Ee9CUC34HmFgFywQL2ImeW,SpATywNh6bZuzm8s1ceuBUnMUAeoAHHw,22,50,6,0,5,0,19,1,81,11.571428571428571,2,0.0,3,6,0,5,47,0,0,19,1,14,67,1
7771,121819,PmBLjK8JCE0PzpkrJAjhhCm5nVqtWEV1,A3fsA9Zfv1X2fVEQhTw51lKENdNrEqT3,1,0,0,0,0,0,1,0,1,0.14285714285714285,1,0.0,0,0,0,0,0,0,0,1,0,0,1,1
7772,121821,qsqfA7OOnk8HnDIdBoWsK3JLpkRs9fc7,A3fsA9Zfv1X2fVEQhTw51lKENdNrEqT3,1,0,0,0,0,0,1,0,1,0.14285714285714285,1,0.0,0,0,0,0,0,0,0,1,0,0,1,1
7773,121831,SiH274DFlaeNzsDPV8qquK4qRpZHyEyM,SpATywNh6bZuzm8s1ceuBUnMUAeoAHHw,30,28,18,22,8,8,9,0,93,13.285714285714286,3,0.0,6,18,19,8,22,8,3,9,0,51,42,1
7774,121832,smSHdwJ1UOXCOwbwU1gE5ygVGM1XcWJI,SpATywNh6bZuzm8s1ceuBUnMUAeoAHHw,10,6,3,0,2,0,4,2,17,2.4285714285714284,1,0.0,0,3,0,2,6,0,0,4,2,5,12,1
7775,121833,QhQuu2NMHYcgj0YP3onmnea8Jv814Mc8,G8EPVSXsOYB5YQWZGiz1aVq5Pgr2GrQu,5,3,1,0,1,0,3,0,8,1.1428571428571428,1,0.0,0,1,0,1,3,0,0,3,0,2,6,1
7776,121840,A3FGIvcpmP9UeVzECTe66iC9lFbKmHRb,RXDvfPUBYFlVdlueBFbLW0mhhAyGEqpt,44,67,34,122,21,42,17,31,334,47.714285714285715,7,0.0,21,34,100,21,46,42,22,17,31,176,158,0
7777,121845,k6ujPs3A9T0AUvcnn4NYjtPRZDclle8p,SpATywNh6bZuzm8s1ceuBUnMUAeoAHHw,1,0,0,0,0,0,1,0,1,0.14285714285714285,1,0.0,0,0,0,0,0,0,0,1,0,0,1,1
7778,121846,986WgoFI0AZSDPIvWwBI8MUZveW4E4Xu,SpATywNh6bZuzm8s1ceuBUnMUAeoAHHw,1,0,0,0,0,0,1,0,1,0.14285714285714285,1,0.0,0,0,0,0,0,0,0,1,0,0,1,1
7779,121853,6kheVQ9HoYcmvRy4m74n5u7AB6nlCIYR,SpATywNh6bZuzm8s1ceuBUnMUAeoAHHw,7,3,2,0,2,0,2,0,9,1.2857142857142858,1,0.0,0,2,0,2,3,0,0,2,0,4,5,1
7780,121859,IcRuYze0CzOpE4oHF70ukHAkSTPB9bCH,SpATywNh6bZuzm8s1ceuBUnMUAeoAHHw,24,59,5,29,0,10,13,1,117,16.714285714285715,7,0.0,23,5,27,0,36,10,2,13,1,55,62,1
7781,121873,nHMoTKw6ss0dSnBzmsq0keGpHH2NjvR7,SpATywNh6bZuzm8s1ceuBUnMUAeoAHHw,28,35,16,32,8,1,21,3,116,16.571428571428573,8,0.0,9,16,28,8,26,1,4,21,3,61,55,1
7782,121889,PhJ8qm8JsHCEW9dAikvHznDiB4SDMYD6,A3fsA9Zfv1X2fVEQhTw51lKENdNrEqT3,6,3,2,0,2,0,1,0,8,1.1428571428571428,1,0.0,0,2,0,2,3,0,0,1,0,4,4,1
7783,121891,lyKWlQXSsOSx9dJ1ME8N6mLGOkZhDx56,SpATywNh6bZuzm8s1ceuBUnMUAeoAHHw,17,33,13,6,7,1,7,0,67,9.571428571428571,4,0.0,15,13,6,7,18,1,0,7,0,41,26,1
7784,121893,Q8D1GMU9DUO6Nj6ySx5rrvLwl2bu2DGZ,SpATywNh6bZuzm8s1ceuBUnMUAeoAHHw,21,47,23,14,9,25,13,1,132,18.857142857142858,4,0.0,11,23,13,9,36,25,1,13,1,56,76,0
7785,121896,IDVV2jtBUYHXvZRwUeupKpLFwBDZmMvi,bWdj2GDclj5ofokWjzoa5jAwMkxCykd6,8,2,2,0,2,0,5,0,11,1.5714285714285714,1,0.0,0,2,0,2,2,0,0,5,0,4,7,1
7786,121903,x2eztv69vavhwR6qv43AthcyQwI14YNr,SpATywNh6bZuzm8s1ceuBUnMUAeoAHHw,16,17,9,12,4,2,5,0,49,7.0,4,0.0,4,9,9,4,13,2,3,5,0,26,23,0
7787,121906,DPTAQ5lGsvjESrb4v1mwHpMaZuqLNytl,SpATywNh6bZuzm8s1ceuBUnMUAeoAHHw,26,31,3,22,1,4,9,1,71,10.142857142857142,3,0.0,9,3,17,1,22,4,5,9,1,30,41,0
7788,121937,Ks3akoPw8lV1qZsYDHC2B3y9yzMeHmnf,SpATywNh6bZuzm8s1ceuBUnMUAeoAHHw,1,0,0,0,0,0,2,0,2,0.2857142857142857,1,0.0,0,0,0,0,0,0,0,2,0,0,2,1
7789,121952,x98jQugu3yASfETi9tV0JU7AQJM0sBk6,A3fsA9Zfv1X2fVEQhTw51lKENdNrEqT3,1,0,0,0,0,0,1,0,1,0.14285714285714285,1,0.0,0,0,0,0,0,0,0,1,0,0,1,1
7790,121961,oW9L7CxP0sDxYCxol70CUfkBpdozjWLb,SpATywNh6bZuzm8s1ceuBUnMUAeoAHHw,1,0,0,0,0,0,1,0,1,0.14285714285714285,1,0.0,0,0,0,0,0,0,0,1,0,0,1,0
7791,121984,XGd8OaVZcFiceiXpuPYWv2tDLfwrfQG1,SpATywNh6bZuzm8s1ceuBUnMUAeoAHHw,4,4,2,0,2,0,1,0,9,1.2857142857142858,1,0.0,0,2,0,2,4,0,0,1,0,4,5,1
7792,122008,C7BxnTntfGXjkSosgH12xJ8S1pNqiUlY,SpATywNh6bZuzm8s1ceuBUnMUAeoAHHw,8,4,4,0,3,0,7,0,18,2.5714285714285716,3,0.0,0,4,0,3,4,0,0,7,0,7,11,1
7793,122009,DPTAQ5lGsvjESrb4v1mwHpMaZuqLNytl,G8EPVSXsOYB5YQWZGiz1aVq5Pgr2GrQu,1,0,0,0,0,0,1,0,1,0.14285714285714285,1,0.0,0,0,0,0,0,0,0,1,0,0,1,1
7794,122011,rwCHpAN1sY0GvFYG7zQQk2qpgkOBz9O3,SpATywNh6bZuzm8s1ceuBUnMUAeoAHHw,7,6,3,0,0,2,6,0,17,2.4285714285714284,2,0.0,0,3,0,0,6,2,0,6,0,3,14,1
7795,122031,CfiZ4fswch8CYfHMLc9SAlgLprJRdAVO,SpATywNh6bZuzm8s1ceuBUnMUAeoAHHw,15,16,8,0,16,0,5,0,45,6.428571428571429,2,0.0,0,8,0,16,16,0,0,5,0,24,21,1
7796,122035,PFXaSbylT2XRWmnFTzI7TT06KKEcrU02,G8EPVSXsOYB5YQWZGiz1aVq5Pgr2GrQu,1,0,0,0,0,0,1,0,1,0.14285714285714285,1,0.0,0,0,0,0,0,0,0,1,0,0,1,1
7797,122049,IDVV2jtBUYHXvZRwUeupKpLFwBDZmMvi,A3fsA9Zfv1X2fVEQhTw51lKENdNrEqT3,10,5,5,0,5,0,5,0,20,2.857142857142857,1,0.0,0,5,0,5,5,0,0,5,0,10,10,1
7798,122055,cgc8DGkd3Jwqn7jWLS8pFiVfUMBb7Shb,bWdj2GDclj5ofokWjzoa5jAwMkxCykd6,9,18,0,0,2,3,6,0,29,4.142857142857143,2,0.0,8,0,0,2,10,3,0,6,0,10,19,1
7799,122060,Cyazs2KNzeLH7rwO0YD9wLQWGHR2SXrB,SpATywNh6bZuzm8s1ceuBUnMUAeoAHHw,5,6,3,0,1,0,3,0,13,1.8571428571428572,3,0.0,0,3,0,1,6,0,0,3,0,4,9,1
7800,122062,Cyazs2KNzeLH7rwO0YD9wLQWGHR2SXrB,A3fsA9Zfv1X2fVEQhTw51lKENdNrEqT3,5,4,2,0,1,0,2,0,9,1.2857142857142858,2,0.0,0,2,0,1,4,0,0,2,0,3,6,1
7801,122063,Cyazs2KNzeLH7rwO0YD9wLQWGHR2SXrB,bWdj2GDclj5ofokWjzoa5jAwMkxCykd6,5,6,3,0,1,0,3,0,13,1.8571428571428572,3,0.0,0,3,0,1,6,0,0,3,0,4,9,1
7802,122072,UdIMXWwMbB1F8xXEtwt8g56Lh72G96hQ,SpATywNh6bZuzm8s1ceuBUnMUAeoAHHw,9,10,9,0,9,0,2,0,30,4.285714285714286,1,0.0,0,9,0,9,10,0,0,2,0,18,12,1
7803,122074,JbB7hpnQ5hVzqELznLtzJLRyOZ2rdnyH,SpATywNh6bZuzm8s1ceuBUnMUAeoAHHw,20,40,13,32,7,0,8,0,100,14.285714285714286,3,0.0,25,13,29,7,15,0,3,8,0,74,26,1
7804,122079,cderIDaWBR3ykedbqXoG7yh75mThXkpL,A3fsA9Zfv1X2fVEQhTw51lKENdNrEqT3,9,18,8,0,0,10,10,0,46,6.571428571428571,3,0.0,2,8,0,0,16,10,0,10,0,10,36,1
7805,122080,2dTQ27kTyKMSAN4dn7cbjnuDmdSbybLJ,SpATywNh6bZuzm8s1ceuBUnMUAeoAHHw,26,35,16,31,7,8,16,1,114,16.285714285714285,3,0.0,13,16,31,7,22,8,0,16,1,67,47,0
7806,124650,efygWYkxxUMOGInRZT4qEeuzMRlIpQq6,7GRhBDsirIGkRZBtSMEzNTyDr2JQm4xx,37,93,58,0,61,0,16,2,230,32.857142857142854,5,0.0,26,58,0,61,67,0,0,16,2,145,85,0
7807,124655,znF1cjtWo1KGLXEIK5C3NJfQlk7HZ3U1,7GRhBDsirIGkRZBtSMEzNTyDr2JQm4xx,32,71,19,68,6,35,9,1,209,29.857142857142858,4,0.0,44,19,57,6,27,35,11,9,1,126,83,1
7808,124664,sL5jw3pLWZoRI7avI17oM60mfF67Acgz,7GRhBDsirIGkRZBtSMEzNTyDr2JQm4xx,1,0,0,0,0,0,2,0,2,0.2857142857142857,2,0.0,0,0,0,0,0,0,0,2,0,0,2,1
7809,124672,SglSA2qg6fizXrvdkABD6ypMwWhttZ4P,7GRhBDsirIGkRZBtSMEzNTyDr2JQm4xx,1,0,0,0,0,0,1,0,1,0.14285714285714285,1,0.0,0,0,0,0,0,0,0,1,0,0,1,1
7810,124702,Xv0DoRVy2WPaq7NGSTl3PflvzGmHzjVJ,7GRhBDsirIGkRZBtSMEzNTyDr2JQm4xx,52,196,22,105,18,25,57,0,423,60.42857142857143,7,0.0,117,22,91,18,79,25,14,57,0,248,175,0
7811,124731,kAnFbfXpbNeJLwDkVeY9dBv06ssaFoQQ,7GRhBDsirIGkRZBtSMEzNTyDr2JQm4xx,7,5,4,0,4,0,10,0,23,3.2857142857142856,3,0.0,0,4,0,4,5,0,0,10,0,8,15,1
7812,124761,ioaeb7d1U29jI9wsI7DHJ7aiuWWVX3KB,7GRhBDsirIGkRZBtSMEzNTyDr2JQm4xx,1,0,0,0,0,0,1,0,1,0.14285714285714285,1,0.0,0,0,0,0,0,0,0,1,0,0,1,1
7813,124784,Eh1GmQ1l1uLUtTdjFKV3N8aG3h7KeTZw,7GRhBDsirIGkRZBtSMEzNTyDr2JQm4xx,11,10,6,0,4,10,7,0,37,5.285714285714286,3,0.0,0,6,0,4,10,10,0,7,0,10,27,1
7814,124806,Th577tzrUuQ2mCFol11GPYRTSP1uxDgy,7GRhBDsirIGkRZBtSMEzNTyDr2JQm4xx,1,0,0,0,0,0,8,0,8,1.1428571428571428,6,0.0,0,0,0,0,0,0,0,8,0,0,8,1
7815,124883,YglOmvsVjCCnNnyOM9hw1BozNvavt4Yw,7GRhBDsirIGkRZBtSMEzNTyDr2JQm4xx,10,10,5,4,5,0,4,0,28,4.0,2,0.0,3,5,3,5,7,0,1,4,0,16,12,1
7816,124914,Jjmm0y7q4AQOSfmS8g0ehDtEqybh04ZX,7GRhBDsirIGkRZBtSMEzNTyDr2JQm4xx,1,0,0,0,0,0,1,0,1,0.14285714285714285,1,0.0,0,0,0,0,0,0,0,1,0,0,1,1
7817,124920,gZWf27ETcHz4bBmwZPjiPumw55JZ4IOR,7GRhBDsirIGkRZBtSMEzNTyDr2JQm4xx,3,2,0,0,0,0,1,0,3,0.42857142857142855,1,0.0,0,0,0,0,2,0,0,1,0,0,3,1
7818,124935,VRS5uIqYlw2SwZ8kUgzPCb9ckuRb5DEy,7GRhBDsirIGkRZBtSMEzNTyDr2JQm4xx,2,0,0,0,0,0,3,0,3,0.42857142857142855,2,0.0,0,0,0,0,0,0,0,3,0,0,3,1
7819,124949,sQym1SSnuvlV9rWhfoiNBuvnxQoSSsrc,7GRhBDsirIGkRZBtSMEzNTyDr2JQm4xx,8,17,5,0,1,1,3,0,27,3.857142857142857,2,0.0,6,5,0,1,11,1,0,3,0,12,15,0
7820,124950,Xn0FkHI67ejumzKXwubbQ6h7XBOcvKHb,7GRhBDsirIGkRZBtSMEzNTyDr2JQm4xx,1,0,0,0,0,0,2,0,2,0.2857142857142857,2,0.0,0,0,0,0,0,0,0,2,0,0,2,1
7821,124961,MQKEfJfHQjDI3xyJjnjmz4WwmQkpOvq2,7GRhBDsirIGkRZBtSMEzNTyDr2JQm4xx,4,2,1,0,1,0,2,0,6,0.8571428571428571,2,0.0,0,1,0,1,2,0,0,2,0,2,4,1
7822,125015,wuCb3DAs0UTa3nnL6gSfoBgjTkpbfyNt,7GRhBDsirIGkRZBtSMEzNTyDr2JQm4xx,2,0,0,0,0,0,5,0,5,0.7142857142857143,2,0.0,0,0,0,0,0,0,0,5,0,0,5,0
7823,125055,GjKIGij44vr1LmHxaYp53Ww7DNMH4X51,7GRhBDsirIGkRZBtSMEzNTyDr2JQm4xx,1,0,0,0,0,0,1,0,1,0.14285714285714285,1,0.0,0,0,0,0,0,0,0,1,0,0,1,1
7824,125141,Bh56YjgPG1aYs0o5T2OK5m2v5NWxpiqv,7GRhBDsirIGkRZBtSMEzNTyDr2JQm4xx,1,0,0,0,0,0,1,0,1,0.14285714285714285,1,0.0,0,0,0,0,0,0,0,1,0,0,1,1
7825,125168,lJUTJBRxdmUZMtpc6Z00drkXv7sphS3I,7GRhBDsirIGkRZBtSMEzNTyDr2JQm4xx,1,0,0,0,0,0,1,0,1,0.14285714285714285,1,0.0,0,0,0,0,0,0,0,1,0,0,1,1
7826,125192,GCOHYGlzOItFnghKeaWS09bGB70fHDaY,7GRhBDsirIGkRZBtSMEzNTyDr2JQm4xx,3,1,0,0,0,0,2,0,3,0.42857142857142855,1,0.0,0,0,0,0,1,0,0,2,0,0,3,1
7827,125231,LKQx76DscP8cMaadDZLCOsushv3ygeRX,7GRhBDsirIGkRZBtSMEzNTyDr2JQm4xx,1,0,0,0,0,0,2,0,2,0.2857142857142857,2,0.0,0,0,0,0,0,0,0,2,0,0,2,1
7828,125245,eOxm8XEI11Xs6eiBi1Nu5QzIagZXwEm9,7GRhBDsirIGkRZBtSMEzNTyDr2JQm4xx,7,0,0,0,0,2,7,0,9,1.2857142857142858,2,0.0,0,0,0,0,0,2,0,7,0,0,9,1
7829,125259,BGrU91p3SJR2EobOQ7G1wG17DcXaN4qI,7GRhBDsirIGkRZBtSMEzNTyDr2JQm4xx,6,5,3,0,2,0,3,0,13,1.8571428571428572,2,0.0,0,3,0,2,5,0,0,3,0,5,8,1
7830,125303,b7PuwalmdIR7gI2f0kgWK9mhLJEyGy0c,7GRhBDsirIGkRZBtSMEzNTyDr2JQm4xx,5,2,1,0,1,0,4,0,8,1.1428571428571428,2,0.0,0,1,0,1,2,0,0,4,0,2,6,1
7831,125376,Im85u8aENweba95uFnFOR6zdQWFnfDOq,7GRhBDsirIGkRZBtSMEzNTyDr2JQm4xx,6,10,6,0,3,0,6,0,25,3.5714285714285716,2,0.0,0,6,0,3,10,0,0,6,0,9,16,1
7832,125417,EApv9HeMdrTOqAiEQ2b8Pe6dV7nBgttc,7GRhBDsirIGkRZBtSMEzNTyDr2JQm4xx,25,30,10,14,12,0,4,0,70,10.0,1,0.0,19,10,11,12,11,0,3,4,0,52,18,1
7833,125427,eRoc2wJbq7MhBPMEmeCelGVn6NCoE6rW,7GRhBDsirIGkRZBtSMEzNTyDr2JQm4xx,5,2,1,0,1,0,2,0,6,0.8571428571428571,1,0.0,0,1,0,1,2,0,0,2,0,2,4,1
7834,125428,7tmNprOSiahGzByaY8XiUnCFEIQfWwuf,7GRhBDsirIGkRZBtSMEzNTyDr2JQm4xx,40,170,35,56,18,10,12,0,301,43.0,5,0.0,89,35,50,18,81,10,6,12,0,192,109,0
7835,125495,idU4PBrRhkhRSQxacAs4twJhArJhSxu3,7GRhBDsirIGkRZBtSMEzNTyDr2JQm4xx,1,0,0,0,0,0,1,0,1,0.14285714285714285,1,0.0,0,0,0,0,0,0,0,1,0,0,1,1
7836,125497,PBb82RihjctDhPv3TdRmoDOf1nw7NrF1,7GRhBDsirIGkRZBtSMEzNTyDr2JQm4xx,7,7,4,0,2,0,4,0,17,2.4285714285714284,2,0.0,0,4,0,2,7,0,0,4,0,6,11,1
7837,125503,EihYm2z8SiHLHxWvKz7i6RRNVdYLw99f,7GRhBDsirIGkRZBtSMEzNTyDr2JQm4xx,2,0,0,0,0,0,4,0,4,0.5714285714285714,1,0.0,0,0,0,0,0,0,0,4,0,0,4,1
7838,125626,xAPFTLGOI6MhRuvYnyw4iYAuIk60vENo,7GRhBDsirIGkRZBtSMEzNTyDr2JQm4xx,5,9,5,0,0,0,6,0,20,2.857142857142857,1,0.0,0,5,0,0,9,0,0,6,0,5,15,1
7839,125633,FDR62LyL2NPX1eDLrbTp7iEOk4qB3llp,7GRhBDsirIGkRZBtSMEzNTyDr2JQm4xx,26,37,17,10,26,1,15,0,106,15.142857142857142,3,0.0,18,17,10,26,19,1,0,15,0,71,35,1
7840,125658,cUvcpWppohUVKz8Tban8cv5QfXMTXadW,7GRhBDsirIGkRZBtSMEzNTyDr2JQm4xx,1,0,0,0,0,0,2,0,2,0.2857142857142857,2,0.0,0,0,0,0,0,0,0,2,0,0,2,1
7841,125680,tRu7kc3B7i0xOP4FswhcDsdZx5KznD0T,7GRhBDsirIGkRZBtSMEzNTyDr2JQm4xx,2,0,0,0,0,0,3,0,3,0.42857142857142855,1,0.0,0,0,0,0,0,0,0,3,0,0,3,1
7842,125693,Z1sZhLd0yuKMu6iVzogIpx0JDek3jyqT,7GRhBDsirIGkRZBtSMEzNTyDr2JQm4xx,1,0,0,0,0,0,1,0,1,0.14285714285714285,1,0.0,0,0,0,0,0,0,0,1,0,0,1,1
7843,125756,ScNAsndZpkOb6xTMDq2TkU95eVmTkUfl,7GRhBDsirIGkRZBtSMEzNTyDr2JQm4xx,4,2,0,0,0,0,2,0,4,0.5714285714285714,1,0.0,0,0,0,0,2,0,0,2,0,0,4,1
7844,125793,xpwei0fjDTwQJLJhl5FjMPXksqpuR5GG,7GRhBDsirIGkRZBtSMEzNTyDr2JQm4xx,62,60,21,60,19,0,18,0,178,25.428571428571427,2,0.0,32,21,60,19,28,0,0,18,0,132,46,0
7845,125803,UgRvVqO3twMvJzAlD49rqrTbxTS8yLpX,7GRhBDsirIGkRZBtSMEzNTyDr2JQm4xx,5,4,1,0,1,0,2,0,8,1.1428571428571428,2,0.0,0,1,0,1,4,0,0,2,0,2,6,1
7846,125837,k0z6RGGewAn8TOLu7gTAfbvZpKAlaO9s,7GRhBDsirIGkRZBtSMEzNTyDr2JQm4xx,1,0,0,0,0,0,1,0,1,0.14285714285714285,1,0.0,0,0,0,0,0,0,0,1,0,0,1,1
7847,125844,PmtrviA6hBub1PH85YXqVyZgghNsuc4g,7GRhBDsirIGkRZBtSMEzNTyDr2JQm4xx,1,0,0,0,0,0,1,0,1,0.14285714285714285,1,0.0,0,0,0,0,0,0,0,1,0,0,1,1
7848,125847,z1ruPoQWI2YQpUKGJMJN29iqd6Mz8fk8,7GRhBDsirIGkRZBtSMEzNTyDr2JQm4xx,8,8,0,4,2,1,2,0,17,2.4285714285714284,1,0.0,4,0,3,2,4,1,1,2,0,9,8,1
7849,125865,PKH12j56WyhhHbwNNO7EjzMEo1oeOneA,7GRhBDsirIGkRZBtSMEzNTyDr2JQm4xx,1,0,0,0,0,0,1,0,1,0.14285714285714285,1,0.0,0,0,0,0,0,0,0,1,0,0,1,1
7850,125959,d8nG3CRjdRKOgHNCQ97Y2ebOYVCkXw4D,7GRhBDsirIGkRZBtSMEzNTyDr2JQm4xx,2,0,0,0,0,0,2,0,2,0.2857142857142857,2,0.0,0,0,0,0,0,0,0,2,0,0,2,1
7851,125993,YNJKXpmmDE2uZ1c64Ovdnu4MZUQJ0A5j,7GRhBDsirIGkRZBtSMEzNTyDr2JQm4xx,1,0,0,0,0,0,1,0,1,0.14285714285714285,1,0.0,0,0,0,0,0,0,0,1,0,0,1,1
7852,126003,Vao6JycAVhIhWbjbxKbLXiDUK1ZHKwjo,7GRhBDsirIGkRZBtSMEzNTyDr2JQm4xx,25,34,15,36,2,7,3,0,97,13.857142857142858,2,0.0,9,15,33,2,25,7,3,3,0,59,38,1
7853,126612,OvRHQPlJQt08MjvBAsm9o6SalVx0kpxp,fbPkOYLVPtPgIt0MxizjfFJov3JbHyAi,6,15,1,0,1,0,5,0,22,3.142857142857143,1,0.0,2,1,0,1,13,0,0,5,0,4,18,1
7854,126613,Zl05tzo85snAXIri6adShvvUNKe0OymE,fbPkOYLVPtPgIt0MxizjfFJov3JbHyAi,6,9,3,0,2,0,7,0,21,3.0,1,0.0,4,3,0,2,5,0,0,7,0,9,12,1
7855,126614,heqH52ArHeSze97HDhxIHtMU3K7IMrRM,fbPkOYLVPtPgIt0MxizjfFJov3JbHyAi,9,7,3,0,3,0,6,0,19,2.7142857142857144,1,0.0,2,3,0,3,5,0,0,6,0,8,11,1
7856,126615,YxqQc0FBDNSpG3MFOKGx9ekKufVhxrPh,fbPkOYLVPtPgIt0MxizjfFJov3JbHyAi,16,9,7,0,7,0,3,0,26,3.7142857142857144,1,0.0,0,7,0,7,9,0,0,3,0,14,12,1
7857,126616,uieKgiKz9M2OwhKZvR7kKiTuoDNfJUlP,fbPkOYLVPtPgIt0MxizjfFJov3JbHyAi,2,0,0,0,0,0,5,0,5,0.7142857142857143,1,0.0,0,0,0,0,0,0,0,5,0,0,5,1
7858,126617,ysDhewvMwqkWHpjR0j6mtjJo9sLvpRAM,fbPkOYLVPtPgIt0MxizjfFJov3JbHyAi,16,23,9,2,11,15,18,1,79,11.285714285714286,2,0.0,11,9,2,11,12,15,0,18,1,33,46,1
7859,126618,fbJQhb9qJhxn4GPcwi4AErVjPsHJbyL7,fbPkOYLVPtPgIt0MxizjfFJov3JbHyAi,7,12,4,0,5,0,5,0,26,3.7142857142857144,2,0.0,2,4,0,5,10,0,0,5,0,11,15,1
7860,126620,LSVa2jpU1dF8RnC5rzovm0tv2cSNIe8I,fbPkOYLVPtPgIt0MxizjfFJov3JbHyAi,10,9,6,4,4,0,3,0,26,3.7142857142857144,2,0.0,1,6,3,4,8,0,1,3,0,14,12,1
7861,126621,L1D39t7woJJ3WRGAxRtS5wF9BZQP2EYr,fbPkOYLVPtPgIt0MxizjfFJov3JbHyAi,6,5,3,0,3,0,3,0,14,2.0,1,0.0,0,3,0,3,5,0,0,3,0,6,8,1
7862,126625,arRLaw4hZnmx5zrjvIy48oXkTK5DrU7i,fbPkOYLVPtPgIt0MxizjfFJov3JbHyAi,6,4,2,0,1,2,7,0,16,2.2857142857142856,2,0.0,0,2,0,1,4,2,0,7,0,3,13,1
7863,126626,0PTt7yojLQH47Ob79awcf5jvqfHw2L3I,fbPkOYLVPtPgIt0MxizjfFJov3JbHyAi,27,34,18,23,16,17,7,1,116,16.571428571428573,4,0.0,8,18,18,16,26,17,5,7,1,60,56,1
7864,126627,810MRx7l0r4ApLZ3yM1jRSAg5LUkiCFn,fbPkOYLVPtPgIt0MxizjfFJov3JbHyAi,4,2,1,0,1,0,1,0,5,0.7142857142857143,1,0.0,0,1,0,1,2,0,0,1,0,2,3,1
7865,126628,gdWTcSZVoKN1pGf7JyovC0vqfcnT9h18,fbPkOYLVPtPgIt0MxizjfFJov3JbHyAi,8,10,5,0,6,0,15,0,36,5.142857142857143,4,0.0,2,5,0,6,8,0,0,15,0,13,23,1
7866,126629,0hd5ExdLnNdKHQRTwwTLHmDaSlTLMdvd,fbPkOYLVPtPgIt0MxizjfFJov3JbHyAi,5,2,1,0,1,0,4,0,8,1.1428571428571428,1,0.0,0,1,0,1,2,0,0,4,0,2,6,1
7867,126631,I2ghGumCKIaVsnJOGZA0xyJzTnEm5KtW,fbPkOYLVPtPgIt0MxizjfFJov3JbHyAi,14,13,8,4,4,10,7,1,47,6.714285714285714,3,0.0,1,8,3,4,12,10,1,7,1,16,31,1
7868,126634,euBhTje23sMDM8PPQbKVpH6OVKTfG91O,fbPkOYLVPtPgIt0MxizjfFJov3JbHyAi,1,0,0,0,0,0,1,0,1,0.14285714285714285,1,0.0,0,0,0,0,0,0,0,1,0,0,1,1
7869,126635,bA4tnPZD0UU4XAL3OkL7nUjtkAzbgj9d,fbPkOYLVPtPgIt0MxizjfFJov3JbHyAi,7,4,2,0,2,6,2,0,16,2.2857142857142856,1,0.0,0,2,0,2,4,6,0,2,0,4,12,1
7870,126636,P2xHl8oxJOV4TMoYrxym6L2dPSAdMMJs,fbPkOYLVPtPgIt0MxizjfFJov3JbHyAi,4,2,1,0,1,0,1,0,5,0.7142857142857143,1,0.0,0,1,0,1,2,0,0,1,0,2,3,1
7871,126637,c8TFm45r0bfBe26eBlEeUAKDBoTJT9yV,fbPkOYLVPtPgIt0MxizjfFJov3JbHyAi,8,4,3,0,3,0,1,0,11,1.5714285714285714,1,0.0,0,3,0,3,4,0,0,1,0,6,5,0
7872,126638,IBEBjXb2AhSAQmCEtwVxNy77qVPKcclm,fbPkOYLVPtPgIt0MxizjfFJov3JbHyAi,6,4,2,0,1,2,3,0,12,1.7142857142857142,1,0.0,0,2,0,1,4,2,0,3,0,3,9,1
7873,126639,x6BtQH70uuLHaxqzHA21U9wmfT0SxzD9,fbPkOYLVPtPgIt0MxizjfFJov3JbHyAi,6,2,0,0,0,0,5,1,8,1.1428571428571428,2,0.0,0,0,0,0,2,0,0,5,1,0,8,1
7874,126640,99YWSjgqR4hZD4KPEunWhlG5MDGBBYbJ,fbPkOYLVPtPgIt0MxizjfFJov3JbHyAi,6,3,1,0,1,0,2,0,7,1.0,1,0.0,0,1,0,1,3,0,0,2,0,2,5,1
7875,126642,OseLd0Vj4CawbZPfZRznLZH5tivxQP68,fbPkOYLVPtPgIt0MxizjfFJov3JbHyAi,7,4,2,0,2,0,4,0,12,1.7142857142857142,2,0.0,1,2,0,2,3,0,0,4,0,5,7,1
7876,126643,lRTCAuzQcWWtA62pbQwh7xYqG6ghwvm9,fbPkOYLVPtPgIt0MxizjfFJov3JbHyAi,12,17,5,9,10,3,8,0,52,7.428571428571429,1,0.0,11,5,7,10,6,3,2,8,0,33,19,1
7877,126644,N1bQ5aFhcb1yr21loPYJqu2BbdxHrcfB,fbPkOYLVPtPgIt0MxizjfFJov3JbHyAi,11,8,6,0,2,1,6,1,24,3.4285714285714284,1,0.0,0,6,0,2,8,1,0,6,1,8,16,1
7878,126646,mb7Zd70aH6w6tsEQr8q9cAr4RlsgpSEG,fbPkOYLVPtPgIt0MxizjfFJov3JbHyAi,2,0,0,0,0,0,7,0,7,1.0,1,0.0,0,0,0,0,0,0,0,7,0,0,7,1
7879,126647,1tMY1MpuZPW690JnedcAZZYFmf6foWjL,fbPkOYLVPtPgIt0MxizjfFJov3JbHyAi,7,5,3,0,2,7,2,0,19,2.7142857142857144,1,0.0,0,3,0,2,5,7,0,2,0,5,14,1
7880,126649,wdjY1oC33XqL52RaIYWlfwM88qICxfHB,fbPkOYLVPtPgIt0MxizjfFJov3JbHyAi,8,9,5,0,5,4,3,0,26,3.7142857142857144,1,0.0,2,5,0,5,7,4,0,3,0,12,14,0
7881,126650,LD7pbuVHju3VTu9U8udNh6I7JCsw9ECG,fbPkOYLVPtPgIt0MxizjfFJov3JbHyAi,28,37,20,31,13,0,10,0,111,15.857142857142858,3,0.0,12,20,22,13,25,0,9,10,0,67,44,0
7882,126651,ctraTKVJ2JhUCIHyavrJWUiIknGdQbqc,fbPkOYLVPtPgIt0MxizjfFJov3JbHyAi,2,0,0,0,0,0,5,0,5,0.7142857142857143,1,0.0,0,0,0,0,0,0,0,5,0,0,5,1
7883,126654,YLJf06fjaksgc6NESkSC4nTSBafk5Yoh,fbPkOYLVPtPgIt0MxizjfFJov3JbHyAi,7,9,2,0,2,0,2,0,15,2.142857142857143,1,0.0,0,2,0,2,9,0,0,2,0,4,11,1
7884,126656,vXwf4MSRd0xkinwiIqWQdnJoLNdmsOvm,fbPkOYLVPtPgIt0MxizjfFJov3JbHyAi,7,3,2,0,2,0,5,0,12,1.7142857142857142,1,0.0,0,2,0,2,3,0,0,5,0,4,8,1
7885,126657,A6zX6I2GfUhXHkfxx6hY7fkYNihUgWzR,fbPkOYLVPtPgIt0MxizjfFJov3JbHyAi,6,6,2,0,2,0,1,0,11,1.5714285714285714,1,0.0,1,2,0,2,5,0,0,1,0,5,6,1
7886,126658,bwZYXSIDocrsg9B80u5hz1s4TUzxdjem,fbPkOYLVPtPgIt0MxizjfFJov3JbHyAi,8,6,2,0,3,0,5,0,16,2.2857142857142856,1,0.0,2,2,0,3,4,0,0,5,0,7,9,1
7887,126659,lUOW63ZIGkmagy3rVXMv25n4vumPKUfs,fbPkOYLVPtPgIt0MxizjfFJov3JbHyAi,5,2,1,0,1,0,3,0,7,1.0,1,0.0,0,1,0,1,2,0,0,3,0,2,5,1
7888,126660,e2CxwSKYgRRxAYL99ajalycn9caM2cox,fbPkOYLVPtPgIt0MxizjfFJov3JbHyAi,5,2,1,0,1,2,6,0,12,1.7142857142857142,1,0.0,0,1,0,1,2,2,0,6,0,2,10,1
7889,126661,7dkSnitaOk46bh4JzUzQh70jkQ2SBZcu,fbPkOYLVPtPgIt0MxizjfFJov3JbHyAi,3,2,1,0,0,0,1,0,4,0.5714285714285714,1,0.0,0,1,0,0,2,0,0,1,0,1,3,1
7890,126662,wUoZ0jO9cvYMtyUP7nefHwtNjYQG7VUS,fbPkOYLVPtPgIt0MxizjfFJov3JbHyAi,2,0,0,0,0,0,7,0,7,1.0,1,0.0,0,0,0,0,0,0,0,7,0,0,7,1
7891,126663,AAbYMvj6N4kPLfJSTWdxJHOFF7gGokhv,fbPkOYLVPtPgIt0MxizjfFJov3JbHyAi,7,3,2,0,2,0,5,0,12,1.7142857142857142,1,0.0,0,2,0,2,3,0,0,5,0,4,8,1
7892,126665,paTNeCrMrWcChojlLsspaorcmQjiSxoH,fbPkOYLVPtPgIt0MxizjfFJov3JbHyAi,2,0,0,0,0,0,3,0,3,0.42857142857142855,1,0.0,0,0,0,0,0,0,0,3,0,0,3,1
7893,126668,GbCaM9AUbbkCquP0Qap7xohw6uCLXYPC,fbPkOYLVPtPgIt0MxizjfFJov3JbHyAi,6,9,0,0,0,3,7,2,21,3.0,2,0.0,0,0,0,0,9,3,0,7,2,0,21,1
7894,126669,pEzMNyrul10BaiwI0ZVRc6CziruRKt37,fbPkOYLVPtPgIt0MxizjfFJov3JbHyAi,1,0,0,0,0,0,1,0,1,0.14285714285714285,1,0.0,0,0,0,0,0,0,0,1,0,0,1,1
7895,126670,G4gv3psLUg6DraQbf90HcUcwjZl74koo,fbPkOYLVPtPgIt0MxizjfFJov3JbHyAi,7,2,2,0,2,0,2,0,8,1.1428571428571428,1,0.0,0,2,0,2,2,0,0,2,0,4,4,1
7896,126672,cAt3kAq8A4nBNACWncm3aidYAQ1d8bbM,fbPkOYLVPtPgIt0MxizjfFJov3JbHyAi,7,6,4,0,2,0,2,0,14,2.0,2,0.0,0,4,0,2,6,0,0,2,0,6,8,1
7897,126673,9iDcxmHxr3SmvjvcATJP2YvHEz7UDHIB,fbPkOYLVPtPgIt0MxizjfFJov3JbHyAi,1,0,0,0,0,0,1,0,1,0.14285714285714285,1,0.0,0,0,0,0,0,0,0,1,0,0,1,1
7898,126674,LqQpVFQv4lJ36VdzJ4TLAuyE3Ov82MrP,fbPkOYLVPtPgIt0MxizjfFJov3JbHyAi,14,13,8,0,6,9,6,1,43,6.142857142857143,2,0.0,1,8,0,6,12,9,0,6,1,15,28,1
7899,126675,IDaqGyhjD6ErPQOFlyvvPqvNK1bXBxI0,fbPkOYLVPtPgIt0MxizjfFJov3JbHyAi,5,3,2,0,2,5,0,0,12,1.7142857142857142,1,0.0,0,2,0,2,3,5,0,0,0,4,8,1
7900,126676,wmND65rZOV8Cdq3Mq9MmFLy7XUHHSgIW,fbPkOYLVPtPgIt0MxizjfFJov3JbHyAi,1,0,0,0,0,0,1,0,1,0.14285714285714285,1,0.0,0,0,0,0,0,0,0,1,0,0,1,1
7901,126682,gCWKTntdRCeMdOtUiFg2mfCjgrvO2vpV,fbPkOYLVPtPgIt0MxizjfFJov3JbHyAi,10,7,5,0,3,0,2,0,17,2.4285714285714284,1,0.0,0,5,0,3,7,0,0,2,0,8,9,1
7902,126684,4nv50J1wZS6kPdidLB1Y9lmEShhD8gDr,fbPkOYLVPtPgIt0MxizjfFJov3JbHyAi,4,2,1,0,1,0,1,0,5,0.7142857142857143,1,0.0,0,1,0,1,2,0,0,1,0,2,3,1
7903,126686,twUid3xG1muFotfbhs814Ag7sscFy0p2,fbPkOYLVPtPgIt0MxizjfFJov3JbHyAi,8,7,3,0,3,0,2,0,15,2.142857142857143,1,0.0,2,3,0,3,5,0,0,2,0,8,7,1
7904,126687,h5bSBTzGWadYMvrkMiapQR2U8CQzOFmW,fbPkOYLVPtPgIt0MxizjfFJov3JbHyAi,6,3,1,0,1,0,2,0,7,1.0,1,0.0,0,1,0,1,3,0,0,2,0,2,5,1
7905,126690,RhUtXI34T3ZAxfPNMapta5ryhpUSWnVk,fbPkOYLVPtPgIt0MxizjfFJov3JbHyAi,4,2,0,0,0,0,3,0,5,0.7142857142857143,2,0.0,0,0,0,0,2,0,0,3,0,0,5,1
7906,126693,v6oH0XZ7BYoM6ZOy0T23nm7pBiES9NPB,fbPkOYLVPtPgIt0MxizjfFJov3JbHyAi,8,10,4,0,4,8,9,0,35,5.0,2,0.0,2,4,0,4,8,8,0,9,0,10,25,1
7907,126694,zn2X74vvqUQRINz90WjZLsSsFglpYr7o,fbPkOYLVPtPgIt0MxizjfFJov3JbHyAi,10,9,6,0,3,6,8,1,33,4.714285714285714,3,0.0,0,6,0,3,9,6,0,8,1,9,24,1
7908,126695,HSi3yW2yFW0jz9rvJLhKsLbntRdoY32a,fbPkOYLVPtPgIt0MxizjfFJov3JbHyAi,8,4,3,0,3,0,1,0,11,1.5714285714285714,1,0.0,0,3,0,3,4,0,0,1,0,6,5,1
7909,126696,XMNENeqGvf1rZdMY0iLZGJZMfiQXuZuC,fbPkOYLVPtPgIt0MxizjfFJov3JbHyAi,9,12,5,0,4,0,3,0,24,3.4285714285714284,2,0.0,2,5,0,4,10,0,0,3,0,11,13,1
7910,126698,9LD2dY2JJUiq4N2gerCXLTVCO162xgQP,fbPkOYLVPtPgIt0MxizjfFJov3JbHyAi,1,0,0,0,0,0,1,0,1,0.14285714285714285,1,0.0,0,0,0,0,0,0,0,1,0,0,1,1
7911,126700,ltYfR4c85t4WE2sNzApQ2jUPBpU7b957,fbPkOYLVPtPgIt0MxizjfFJov3JbHyAi,7,3,1,0,1,0,4,0,9,1.2857142857142858,1,0.0,0,1,0,1,3,0,0,4,0,2,7,1
7912,126702,dUZiaQQxyKZymoXkd4PU7n1DsSWSaoIy,fbPkOYLVPtPgIt0MxizjfFJov3JbHyAi,8,4,1,0,1,3,15,0,24,3.4285714285714284,2,0.0,0,1,0,1,4,3,0,15,0,2,22,1
7913,126704,T8cbb1vJp70svkAiDdRu3fMjKB52qGra,fbPkOYLVPtPgIt0MxizjfFJov3JbHyAi,18,20,14,0,11,2,4,0,51,7.285714285714286,2,0.0,0,14,0,11,20,2,0,4,0,25,26,1
7914,126706,wRfmNw7A5BDFV6ZZ1hHimgxOa1BKzUIG,fbPkOYLVPtPgIt0MxizjfFJov3JbHyAi,5,2,1,0,1,0,4,0,8,1.1428571428571428,1,0.0,0,1,0,1,2,0,0,4,0,2,6,1
7915,126707,J1iCM60eAwVKTPRoP9hdyFlEQf6db3YF,fbPkOYLVPtPgIt0MxizjfFJov3JbHyAi,5,2,1,0,1,0,2,0,6,0.8571428571428571,1,0.0,0,1,0,1,2,0,0,2,0,2,4,1
7916,126709,xJHRW2pP02hpKUueg876ng5RKQuuRj6e,fbPkOYLVPtPgIt0MxizjfFJov3JbHyAi,7,2,1,0,1,5,5,2,16,2.2857142857142856,1,0.0,0,1,0,1,2,5,0,5,2,2,14,1
7917,126710,74SN75RPs9smmLOI0EXp2s3BwIneUL6f,fbPkOYLVPtPgIt0MxizjfFJov3JbHyAi,4,2,1,0,1,0,1,0,5,0.7142857142857143,1,0.0,0,1,0,1,2,0,0,1,0,2,3,1
7918,126716,nKDNYUTGPAPqMmlfE7Ub4Qe4fIY0CgoN,fbPkOYLVPtPgIt0MxizjfFJov3JbHyAi,7,3,2,0,2,0,2,0,9,1.2857142857142858,1,0.0,0,2,0,2,3,0,0,2,0,4,5,1
7919,126719,ubotMSWIUOxiTHzx65PiC1ieC4BwcBY3,fbPkOYLVPtPgIt0MxizjfFJov3JbHyAi,7,6,4,0,3,0,8,0,21,3.0,1,0.0,0,4,0,3,6,0,0,8,0,7,14,1
7920,126720,ILgj2bRC3L9liHZTpRi1J62GsWMdjm7i,fbPkOYLVPtPgIt0MxizjfFJov3JbHyAi,33,35,22,16,17,24,8,0,122,17.428571428571427,2,0.0,7,22,13,17,28,24,3,8,0,59,63,0
7921,126721,svRBzwXocvDcjjQhiBGtiJ9xaG6TSovy,fbPkOYLVPtPgIt0MxizjfFJov3JbHyAi,7,13,3,0,3,0,2,0,21,3.0,1,0.0,6,3,0,3,7,0,0,2,0,12,9,1
7922,126723,CEB1n53vwmUc8FHZoBrt4V9IQdrhTfqS,fbPkOYLVPtPgIt0MxizjfFJov3JbHyAi,1,0,0,0,0,0,1,0,1,0.14285714285714285,1,0.0,0,0,0,0,0,0,0,1,0,0,1,1
7923,126725,qad1013ZPW8FX2puHq0BQB5FRF6ADJuZ,fbPkOYLVPtPgIt0MxizjfFJov3JbHyAi,1,0,0,0,0,0,1,0,1,0.14285714285714285,1,0.0,0,0,0,0,0,0,0,1,0,0,1,1
7924,126726,jwPZuNOmAMKPf75y5B5RjmpRb6aVkyKO,fbPkOYLVPtPgIt0MxizjfFJov3JbHyAi,8,5,2,0,2,0,4,0,13,1.8571428571428572,1,0.0,0,2,0,2,5,0,0,4,0,4,9,1
7925,126727,okqN4nBVKRYYrkYonKicKGOmPqVGYjZh,fbPkOYLVPtPgIt0MxizjfFJov3JbHyAi,12,19,9,0,10,0,18,0,56,8.0,4,0.0,0,9,0,10,19,0,0,18,0,19,37,0
7926,126732,c3bBGCRAwL0HZQ0vFzkQ6CAecfLWPbLO,fbPkOYLVPtPgIt0MxizjfFJov3JbHyAi,7,3,2,0,2,0,6,0,13,1.8571428571428572,1,0.0,0,2,0,2,3,0,0,6,0,4,9,1
7927,126733,eGYk5KFWT4Pvjbd5cX2RH5CTBhiHI9SQ,fbPkOYLVPtPgIt0MxizjfFJov3JbHyAi,17,32,6,25,15,0,6,0,84,12.0,1,0.0,25,6,21,15,7,0,4,6,0,67,17,1
7928,126734,AbrmwZ5WdO7ReOka4PEAhehW5B0axP5g,fbPkOYLVPtPgIt0MxizjfFJov3JbHyAi,10,4,2,0,2,4,10,1,23,3.2857142857142856,1,0.0,1,2,0,2,3,4,0,10,1,5,18,1
7929,126735,FXETNH4OzV3fwI4YkwpBpnk1E19ob1X2,fbPkOYLVPtPgIt0MxizjfFJov3JbHyAi,2,0,0,0,0,0,2,0,2,0.2857142857142857,1,0.0,0,0,0,0,0,0,0,2,0,0,2,1
7930,126736,rrBwc9DqMP8jnv9AB7ljubWYdmiLkI0q,fbPkOYLVPtPgIt0MxizjfFJov3JbHyAi,1,0,0,0,0,0,1,0,1,0.14285714285714285,1,0.0,0,0,0,0,0,0,0,1,0,0,1,1
7931,126738,7M93OdpUvlNXQzkFgbb1jjdCwfDx9GtM,fbPkOYLVPtPgIt0MxizjfFJov3JbHyAi,13,7,5,0,5,0,7,0,24,3.4285714285714284,1,0.0,0,5,0,5,7,0,0,7,0,10,14,1
7932,126740,5lk9vcvlk4ZCLjblktkMYKVUtSVMBE5E,fbPkOYLVPtPgIt0MxizjfFJov3JbHyAi,6,8,1,0,2,3,6,0,20,2.857142857142857,1,0.0,2,1,0,2,6,3,0,6,0,5,15,1
7933,126741,lkSkVgerjbY9elu2HritmYHEIObp7PjN,fbPkOYLVPtPgIt0MxizjfFJov3JbHyAi,20,30,13,12,12,0,12,0,79,11.285714285714286,5,0.0,14,13,10,12,16,0,2,12,0,49,30,1
7934,126743,lkPumIFIPcAu2WGl2L8VJbRmISnkyI8O,fbPkOYLVPtPgIt0MxizjfFJov3JbHyAi,1,0,0,0,0,0,1,0,1,0.14285714285714285,1,0.0,0,0,0,0,0,0,0,1,0,0,1,1
7935,126744,oGufUk3TlimKTfZlaD6U33grjPc0CIXa,fbPkOYLVPtPgIt0MxizjfFJov3JbHyAi,1,0,0,0,0,0,1,0,1,0.14285714285714285,1,0.0,0,0,0,0,0,0,0,1,0,0,1,1
7936,126745,LNdimqsJkOxQDP9dT4IGwewg9YvH7zfV,fbPkOYLVPtPgIt0MxizjfFJov3JbHyAi,1,0,0,0,0,0,1,0,1,0.14285714285714285,1,0.0,0,0,0,0,0,0,0,1,0,0,1,1
7937,126747,N8IThlIYSn8Fy4uyyTQSpl5K0TGz5NzT,fbPkOYLVPtPgIt0MxizjfFJov3JbHyAi,1,0,0,0,0,0,1,0,1,0.14285714285714285,1,0.0,0,0,0,0,0,0,0,1,0,0,1,1
7938,126749,dhYRwzeTF8ZdKZPmARZOAee0piLEqFbu,fbPkOYLVPtPgIt0MxizjfFJov3JbHyAi,10,12,5,0,3,3,11,0,34,4.857142857142857,1,0.0,1,5,0,3,11,3,0,11,0,9,25,1
7939,126752,WIgM6nvV9YFBo82xFhtQp6923xmcbs69,fbPkOYLVPtPgIt0MxizjfFJov3JbHyAi,1,0,0,0,0,0,1,0,1,0.14285714285714285,1,0.0,0,0,0,0,0,0,0,1,0,0,1,1
7940,126754,xGbsJo4oJvVhF60tIqZnizNX71bTSMlF,fbPkOYLVPtPgIt0MxizjfFJov3JbHyAi,5,3,1,0,1,0,2,0,7,1.0,1,0.0,0,1,0,1,3,0,0,2,0,2,5,1
7941,126755,sfmDw8Mu24TwJAISRGKb3tkGixPCex4a,fbPkOYLVPtPgIt0MxizjfFJov3JbHyAi,1,0,0,0,0,0,1,0,1,0.14285714285714285,1,0.0,0,0,0,0,0,0,0,1,0,0,1,1
7942,126757,6Rep3wtvxTeRNedCLfqY7iMeUZ3V82V5,fbPkOYLVPtPgIt0MxizjfFJov3JbHyAi,1,0,0,0,0,0,1,0,1,0.14285714285714285,1,0.0,0,0,0,0,0,0,0,1,0,0,1,1
7943,126758,bATDoM6JXGnyb4V3IABuJhs4a0vjJZc3,fbPkOYLVPtPgIt0MxizjfFJov3JbHyAi,7,3,2,0,2,0,2,0,9,1.2857142857142858,1,0.0,0,2,0,2,3,0,0,2,0,4,5,1
7944,126762,tedGThhHMqVARfBh6zyzyocTKbTJYJpB,fbPkOYLVPtPgIt0MxizjfFJov3JbHyAi,10,10,7,0,4,9,7,0,37,5.285714285714286,2,0.0,0,7,0,4,10,9,0,7,0,11,26,0
7945,126774,4FlFuHK6TBPGfbsvWig6oHoWLKBiaFvx,fbPkOYLVPtPgIt0MxizjfFJov3JbHyAi,8,3,1,0,1,0,6,1,12,1.7142857142857142,1,0.0,0,1,0,1,3,0,0,6,1,2,10,1
7946,126820,qDTU2XGTiB220mLDzlsck7xSj3wUhIhe,fbPkOYLVPtPgIt0MxizjfFJov3JbHyAi,2,0,0,0,0,0,2,0,2,0.2857142857142857,1,0.0,0,0,0,0,0,0,0,2,0,0,2,1
7947,130035,GWG8afsUfRei9CIZYg1Y2sBsF64D5J9k,7GRhBDsirIGkRZBtSMEzNTyDr2JQm4xx,5,4,1,0,0,0,4,0,9,1.2857142857142858,3,0.0,0,1,0,0,4,0,0,4,0,1,8,1
7948,130051,V6I2tWMT4J6OaEfYWYGJXMvy6YbJ0vQk,7GRhBDsirIGkRZBtSMEzNTyDr2JQm4xx,36,46,13,55,0,0,2,0,116,16.571428571428573,2,0.0,22,13,53,0,24,0,2,2,0,88,28,0
7949,130052,zJ1cXp5NsbaO1h7ITMq3mqJ8kisUpMMv,7GRhBDsirIGkRZBtSMEzNTyDr2JQm4xx,47,36,12,108,10,0,3,0,169,24.142857142857142,1,0.0,22,12,100,10,14,0,8,3,0,144,25,1
7950,130059,1xcKG4Eeqo6PRlQtqz4lRNBDzvKhe7qL,7GRhBDsirIGkRZBtSMEzNTyDr2JQm4xx,30,67,9,56,7,21,25,3,188,26.857142857142858,4,0.0,35,9,46,7,32,21,10,25,3,97,91,0
7951,130126,Kt9qeiacR1tBDeKKHUR6O60ehH5pm7C9,7GRhBDsirIGkRZBtSMEzNTyDr2JQm4xx,8,11,0,2,0,0,2,0,15,2.142857142857143,1,0.0,4,0,2,0,7,0,0,2,0,6,9,1
7952,130170,bVkBiR8Ol1DpipPI05IgYIPbLOO6oZNi,7GRhBDsirIGkRZBtSMEzNTyDr2JQm4xx,34,71,22,49,9,12,15,4,182,26.0,1,0.0,33,22,44,9,38,12,5,15,4,108,74,0
7953,130205,D5GqwXfacfySSvxPJ9v7ORjiX9Oa23f1,7GRhBDsirIGkRZBtSMEzNTyDr2JQm4xx,34,50,21,72,14,1,21,1,180,25.714285714285715,3,0.0,26,21,63,14,24,1,9,21,1,124,56,1
7954,130318,Mms6sMIkW4Omst3uLD38oJJ4C0ZCQcDW,7GRhBDsirIGkRZBtSMEzNTyDr2JQm4xx,6,5,0,0,0,0,4,0,9,1.2857142857142858,1,0.0,1,0,0,0,4,0,0,4,0,1,8,1
7955,134909,GfFjXeeiX86hNL5LrfmBqRsIDiX1X26k,SpATywNh6bZuzm8s1ceuBUnMUAeoAHHw,27,37,20,30,9,1,4,0,101,14.428571428571429,2,0.0,10,20,27,9,27,1,3,4,0,66,35,1
7956,134917,yNC8T7gdWO96Y2q3tzTQeJUMY0F51xnO,RXDvfPUBYFlVdlueBFbLW0mhhAyGEqpt,42,23,14,52,8,0,3,0,100,14.285714285714286,2,0.0,7,14,52,8,16,0,0,3,0,81,19,1
7957,134918,IFqWOl32JJm0W3Ap2jxVCpJeXeLJlYDp,A3fsA9Zfv1X2fVEQhTw51lKENdNrEqT3,8,11,6,0,0,0,6,0,23,3.2857142857142856,4,0.0,0,6,0,0,11,0,0,6,0,6,17,1
7958,134919,DLOMX6N4LOgxba8fGitXr3UEhtTSXCQd,bWdj2GDclj5ofokWjzoa5jAwMkxCykd6,7,9,1,0,2,0,3,0,15,2.142857142857143,2,0.0,2,1,0,2,7,0,0,3,0,5,10,1
7959,134934,mWx2Nz03jP9JKc9PS0gQU6sG6k2C9F0d,SpATywNh6bZuzm8s1ceuBUnMUAeoAHHw,15,31,1,22,1,24,2,0,81,11.571428571428571,2,0.0,9,1,20,1,22,24,2,2,0,31,50,0
7960,134936,NOmOOlAJE5nKLDW211ZOVqBtRY1AgNoT,bWdj2GDclj5ofokWjzoa5jAwMkxCykd6,12,21,2,0,0,1,7,0,31,4.428571428571429,1,0.0,1,2,0,0,20,1,0,7,0,3,28,1
7961,134958,vZY5RTyvAOyjF1AYeCntOYrEo9bIz6lQ,G8EPVSXsOYB5YQWZGiz1aVq5Pgr2GrQu,1,0,0,0,0,0,1,0,1,0.14285714285714285,1,0.0,0,0,0,0,0,0,0,1,0,0,1,1
7962,134959,pvIpspZXePJsFKRHWlM49ptwJQDbUcRt,SpATywNh6bZuzm8s1ceuBUnMUAeoAHHw,3,2,0,0,0,0,1,0,3,0.42857142857142855,1,0.0,0,0,0,0,2,0,0,1,0,0,3,1
7963,134961,oqS6zzIbAzdLBJLSTonEDuhKDtanqUaf,SpATywNh6bZuzm8s1ceuBUnMUAeoAHHw,22,25,0,31,0,17,7,0,80,11.428571428571429,2,0.0,7,0,26,0,18,17,5,7,0,33,47,1
7964,134982,CW7Zlsz0NoDYd7q0tu1Krgi9b7wpQUwQ,A3fsA9Zfv1X2fVEQhTw51lKENdNrEqT3,11,11,6,4,1,0,11,0,33,4.714285714285714,3,0.0,0,6,3,1,11,0,1,11,0,10,23,0
7965,134994,eSBIcO9jl3TmHpUt3HWb9pXo82kpOmfn,bWdj2GDclj5ofokWjzoa5jAwMkxCykd6,7,4,2,0,2,0,1,0,9,1.2857142857142858,1,0.0,0,2,0,2,4,0,0,1,0,4,5,1
7966,135002,Vr0kaKAkI4p2upUYNB1MMKsTShBZob66,A3fsA9Zfv1X2fVEQhTw51lKENdNrEqT3,10,10,5,0,2,13,6,0,36,5.142857142857143,3,0.0,0,5,0,2,10,13,0,6,0,7,29,1
7967,135005,8roapIDCTFIdbLoaqBbYR8jsy1UP5sGP,RXDvfPUBYFlVdlueBFbLW0mhhAyGEqpt,11,9,6,0,3,1,4,0,23,3.2857142857142856,1,0.0,0,6,0,3,9,1,0,4,0,9,14,1
7968,135010,ABF7qktVQ6rBIirYNSz5GNtRM330ID0h,A3fsA9Zfv1X2fVEQhTw51lKENdNrEqT3,1,0,0,0,0,0,2,0,2,0.2857142857142857,1,0.0,0,0,0,0,0,0,0,2,0,0,2,1
7969,135021,TCrdvmbavAJVW5bPiEeyt89TcS6pYL1D,A3fsA9Zfv1X2fVEQhTw51lKENdNrEqT3,2,0,0,0,0,0,3,0,3,0.42857142857142855,1,0.0,0,0,0,0,0,0,0,3,0,0,3,1
7970,135022,f0rWHmI4rV7ssYizy9jzg3UxqKTtG19Y,SpATywNh6bZuzm8s1ceuBUnMUAeoAHHw,21,44,0,20,0,1,17,0,82,11.714285714285714,4,0.0,18,0,17,0,26,1,3,17,0,35,47,0
7971,135025,tedGThhHMqVARfBh6zyzyocTKbTJYJpB,SpATywNh6bZuzm8s1ceuBUnMUAeoAHHw,21,29,15,15,5,11,7,1,83,11.857142857142858,3,0.0,10,15,12,5,19,11,3,7,1,42,41,1
7972,135026,Cue1j1CEK4ByBYziFbTJAskjanGgrJp6,SpATywNh6bZuzm8s1ceuBUnMUAeoAHHw,17,16,0,10,0,9,2,0,37,5.285714285714286,2,0.0,0,0,10,0,16,9,0,2,0,10,27,0
7973,135035,wQjDRlC3tPpszGzQ3Dfiq7I6azQztJ02,A3fsA9Zfv1X2fVEQhTw51lKENdNrEqT3,13,9,6,4,4,0,2,0,25,3.5714285714285716,1,0.0,2,6,4,4,7,0,0,2,0,16,9,1
7974,135040,QflUMQYqgKuyQPnCteHvz3LqhJ9AwCga,A3fsA9Zfv1X2fVEQhTw51lKENdNrEqT3,2,0,0,0,0,0,9,0,9,1.2857142857142858,1,0.0,0,0,0,0,0,0,0,9,0,0,9,1
7975,135060,UJeg7gRsnH7RZFT5Iv8Y0tTilR96sXcV,A3fsA9Zfv1X2fVEQhTw51lKENdNrEqT3,3,2,0,0,0,0,2,0,4,0.5714285714285714,1,0.0,0,0,0,0,2,0,0,2,0,0,4,1
7976,135065,g9QyBrQkEVh9IC3JA81b7KgVa01DwgUa,SpATywNh6bZuzm8s1ceuBUnMUAeoAHHw,30,29,18,26,10,5,7,2,97,13.857142857142858,1,0.0,8,18,25,10,21,5,1,7,2,61,36,1
7977,135079,GFArLd1huQSmyLkNR2x5AlhFrFWDXs0N,SpATywNh6bZuzm8s1ceuBUnMUAeoAHHw,14,35,6,26,3,0,2,0,72,10.285714285714286,1,0.0,24,6,21,3,11,0,5,2,0,54,18,0
7978,135095,e09uq36QgLuBVK5DERoejsHeMH2uPMRM,bWdj2GDclj5ofokWjzoa5jAwMkxCykd6,1,0,0,0,0,0,1,0,1,0.14285714285714285,1,0.0,0,0,0,0,0,0,0,1,0,0,1,1
7979,135097,EbZIIypapfDMAa5QP57XCFF2cfAshgSo,RXDvfPUBYFlVdlueBFbLW0mhhAyGEqpt,1,0,0,0,0,0,2,0,2,0.2857142857142857,1,0.0,0,0,0,0,0,0,0,2,0,0,2,1
7980,135104,gZWf27ETcHz4bBmwZPjiPumw55JZ4IOR,A3fsA9Zfv1X2fVEQhTw51lKENdNrEqT3,1,0,0,0,0,0,1,0,1,0.14285714285714285,1,0.0,0,0,0,0,0,0,0,1,0,0,1,1
7981,135115,qknWf2eBme9z3XgVNwZwbwdoI0FKipkj,A3fsA9Zfv1X2fVEQhTw51lKENdNrEqT3,40,25,16,70,12,4,13,0,140,20.0,3,0.0,6,16,55,12,19,4,15,13,0,89,51,1
7982,135119,czraR8jl3tjb5vvHKbMcAmZkpcCxXmtq,bWdj2GDclj5ofokWjzoa5jAwMkxCykd6,7,3,2,0,2,1,3,0,11,1.5714285714285714,1,0.0,0,2,0,2,3,1,0,3,0,4,7,1
7983,135128,jbfQf8j93qEc8QCxEb0dikXBABlkLrcO,G8EPVSXsOYB5YQWZGiz1aVq5Pgr2GrQu,1,0,0,0,0,0,1,0,1,0.14285714285714285,1,0.0,0,0,0,0,0,0,0,1,0,0,1,1
7984,135137,A3FGIvcpmP9UeVzECTe66iC9lFbKmHRb,A3fsA9Zfv1X2fVEQhTw51lKENdNrEqT3,13,10,8,0,5,0,4,0,27,3.857142857142857,3,0.0,0,8,0,5,10,0,0,4,0,13,14,1
7985,135143,LbQhhYRYGsyaTkO1QusAxgXnsVSB1OSE,SpATywNh6bZuzm8s1ceuBUnMUAeoAHHw,7,1,1,0,1,1,6,1,11,1.5714285714285714,1,0.0,0,1,0,1,1,1,0,6,1,2,9,1
7986,135168,wMQxNrryGKgbGXsy17gJPlh2fJdDvt8s,bWdj2GDclj5ofokWjzoa5jAwMkxCykd6,13,19,6,72,5,9,3,0,114,16.285714285714285,2,0.0,8,6,65,5,11,9,7,3,0,84,30,1
7987,135172,qLscbApWydA7z1h7Ht7RN2UnF0mvGZpF,RXDvfPUBYFlVdlueBFbLW0mhhAyGEqpt,13,14,1,0,0,1,7,1,24,3.4285714285714284,2,0.0,0,1,0,0,14,1,0,7,1,1,23,1
7988,135188,qhmgArW8a15UOGQrFTosGi03wE1TjPeN,G8EPVSXsOYB5YQWZGiz1aVq5Pgr2GrQu,32,54,2,38,6,0,3,0,103,14.714285714285714,2,0.0,34,2,24,6,20,0,14,3,0,66,37,1
7989,135190,wLSijvQvjlVUQosga79Y2P2NJWJt5aXA,SpATywNh6bZuzm8s1ceuBUnMUAeoAHHw,15,24,11,20,4,3,3,0,65,9.285714285714286,1,0.0,4,11,16,4,20,3,4,3,0,35,30,0
7990,135205,ps2zbzmz8NQnCm6f0pvJpkBQkQh2tR1v,bWdj2GDclj5ofokWjzoa5jAwMkxCykd6,17,53,38,0,14,0,12,0,117,16.714285714285715,2,0.0,2,38,0,14,51,0,0,12,0,54,63,1
7991,135209,XPNYQB8BXxVJKoqXsnIXNkzgmqWM9Jf1,bWdj2GDclj5ofokWjzoa5jAwMkxCykd6,1,0,0,0,0,0,1,0,1,0.14285714285714285,1,0.0,0,0,0,0,0,0,0,1,0,0,1,0
7992,135219,njjQXvcpocYF8aiLDJ8yZfLnv69cMgqm,SpATywNh6bZuzm8s1ceuBUnMUAeoAHHw,18,10,9,0,8,0,2,0,29,4.142857142857143,1,0.0,0,9,0,8,10,0,0,2,0,17,12,1
7993,135222,MpTAgw3ozhmeD7C8xc95FgAYRb7j4nGM,SpATywNh6bZuzm8s1ceuBUnMUAeoAHHw,6,2,1,0,1,0,3,0,7,1.0,1,0.0,0,1,0,1,2,0,0,3,0,2,5,1
7994,135232,ZfIQYurnR6gJbWxLJ81cU3ZqzX4mpHm0,A3fsA9Zfv1X2fVEQhTw51lKENdNrEqT3,34,73,36,4,21,2,34,2,172,24.571428571428573,4,0.0,3,36,4,21,70,2,0,34,2,64,108,1
7995,135234,8JTz84ZDdJm6tvsd7hgyCl1RB6wU6r2e,A3fsA9Zfv1X2fVEQhTw51lKENdNrEqT3,6,3,2,0,1,0,2,0,8,1.1428571428571428,1,0.0,0,2,0,1,3,0,0,2,0,3,5,1
7996,135242,JJ57bFsns5I0rz7X8YoOwiZazG9JNmlR,SpATywNh6bZuzm8s1ceuBUnMUAeoAHHw,1,0,0,0,0,0,1,0,1,0.14285714285714285,1,0.0,0,0,0,0,0,0,0,1,0,0,1,1
7997,135247,n67Q6gA8OyrfjvaOwbClftMWf4trlmyC,A3fsA9Zfv1X2fVEQhTw51lKENdNrEqT3,16,12,8,0,7,0,5,0,32,4.571428571428571,2,0.0,0,8,0,7,12,0,0,5,0,15,17,1
7998,135252,1umo7etGwkx7NcpFxVialzDD37NdyqRT,G8EPVSXsOYB5YQWZGiz1aVq5Pgr2GrQu,43,77,35,58,8,0,4,0,182,26.0,2,0.0,38,35,37,8,39,0,21,4,0,118,64,0
7999,135271,orkLWN7Jw88UrSJVImY9WyAA9wO3axVi,A3fsA9Zfv1X2fVEQhTw51lKENdNrEqT3,1,0,0,0,0,0,1,0,1,0.14285714285714285,1,0.0,0,0,0,0,0,0,0,1,0,0,1,1
8000,135272,MZomFQTbHAKaDGd0B9fv7KQ9MRsZJ7m6,bWdj2GDclj5ofokWjzoa5jAwMkxCykd6,4,4,1,0,0,0,2,0,7,1.0,1,0.0,0,1,0,0,4,0,0,2,0,1,6,1
8001,135304,43KrXQWA5nPYKCMGBRnIKMf2ytZWgrcW,bWdj2GDclj5ofokWjzoa5jAwMkxCykd6,1,0,0,0,0,0,1,0,1,0.14285714285714285,1,0.0,0,0,0,0,0,0,0,1,0,0,1,1
8002,135305,43KrXQWA5nPYKCMGBRnIKMf2ytZWgrcW,A3fsA9Zfv1X2fVEQhTw51lKENdNrEqT3,1,0,0,0,0,0,2,0,2,0.2857142857142857,1,0.0,0,0,0,0,0,0,0,2,0,0,2,1
8003,135319,XRgwz0GPwgb7aVdSZ4HGlz0QU2iMHxW2,A3fsA9Zfv1X2fVEQhTw51lKENdNrEqT3,8,3,2,0,2,1,3,2,13,1.8571428571428572,1,0.0,0,2,0,2,3,1,0,3,2,4,9,1
8004,135335,NXrRVU4FxMGO3zABXLL6x3AW8OEzmOAP,SpATywNh6bZuzm8s1ceuBUnMUAeoAHHw,3,0,0,0,0,0,3,0,3,0.42857142857142855,1,0.0,0,0,0,0,0,0,0,3,0,0,3,1
8005,135337,1Qo7KMYcvZsuiBzdvEuPj5kKA7qUbqJV,RXDvfPUBYFlVdlueBFbLW0mhhAyGEqpt,1,0,0,0,0,0,1,0,1,0.14285714285714285,1,0.0,0,0,0,0,0,0,0,1,0,0,1,1
8006,135358,ENiSmEGDuCang79gWrzmkKVXvQ2o3noj,SpATywNh6bZuzm8s1ceuBUnMUAeoAHHw,13,21,3,0,3,0,4,0,31,4.428571428571429,4,0.0,0,3,0,3,21,0,0,4,0,6,25,1
8007,135377,ZfIQYurnR6gJbWxLJ81cU3ZqzX4mpHm0,SpATywNh6bZuzm8s1ceuBUnMUAeoAHHw,30,65,26,21,8,3,13,0,136,19.428571428571427,4,0.0,18,26,16,8,47,3,5,13,0,68,68,0
8008,135390,IGFSjvLtGQCYdnhMcrAQcaIreY53ybWv,bWdj2GDclj5ofokWjzoa5jAwMkxCykd6,37,74,23,115,16,40,15,1,284,40.57142857142857,7,0.0,13,23,99,16,61,40,16,15,1,151,133,0
8009,135396,g5cfvDvYqz1BC4LMGanzPaVPPBmwbapa,SpATywNh6bZuzm8s1ceuBUnMUAeoAHHw,15,12,9,0,6,0,4,0,31,4.428571428571429,3,0.0,0,9,0,6,12,0,0,4,0,15,16,0
8010,135399,46rTxBSjCmRWQay8Ou4hIiZJB66kf2no,RXDvfPUBYFlVdlueBFbLW0mhhAyGEqpt,6,1,1,0,1,0,6,0,9,1.2857142857142858,1,0.0,0,1,0,1,1,0,0,6,0,2,7,1
8011,135412,kdSYbpVWFVGC6Yy5JRVMZRVsatOK3Lvr,SpATywNh6bZuzm8s1ceuBUnMUAeoAHHw,14,8,5,11,3,0,2,0,29,4.142857142857143,1,0.0,2,5,11,3,6,0,0,2,0,21,8,1
8012,135415,HshUJf4SCu4uNEnMGOCihwqMFgpruX2A,bWdj2GDclj5ofokWjzoa5jAwMkxCykd6,13,13,7,20,7,11,4,1,63,9.0,1,0.0,3,7,17,7,10,11,3,4,1,34,29,0
8013,135418,OdctoiqHnsBGK57e7GpH3g9wz0WU5g5f,SpATywNh6bZuzm8s1ceuBUnMUAeoAHHw,1,0,0,0,0,0,1,0,1,0.14285714285714285,1,0.0,0,0,0,0,0,0,0,1,0,0,1,1
8014,135420,58eQNUjs318sjON50Y8nkDIw70NM1q5r,SpATywNh6bZuzm8s1ceuBUnMUAeoAHHw,15,24,0,17,0,1,6,0,48,6.857142857142857,3,0.0,12,0,14,0,12,1,3,6,0,26,22,1
8015,135425,LoyL1dLg21zF03lUMGts7AHY1XLphBvU,SpATywNh6bZuzm8s1ceuBUnMUAeoAHHw,30,54,17,29,10,1,11,1,123,17.571428571428573,4,0.0,16,17,27,10,38,1,2,11,1,70,53,1
8016,135428,yNBmodc8EXXXXDprMuN3jSh3qPXFcpn8,bWdj2GDclj5ofokWjzoa5jAwMkxCykd6,3,5,1,0,0,0,1,0,7,1.0,1,0.0,0,1,0,0,5,0,0,1,0,1,6,1
8017,135442,x6BtQH70uuLHaxqzHA21U9wmfT0SxzD9,RXDvfPUBYFlVdlueBFbLW0mhhAyGEqpt,10,17,1,0,1,2,10,1,32,4.571428571428571,2,0.0,0,1,0,1,17,2,0,10,1,2,30,1
8018,135447,ivxBGUbA7UT7tzED0gKK31cJU8Lv97zd,A3fsA9Zfv1X2fVEQhTw51lKENdNrEqT3,6,5,1,0,1,0,3,1,11,1.5714285714285714,1,0.0,0,1,0,1,5,0,0,3,1,2,9,1
8019,135458,l3gXcoEEAi47BjXtnIC98tO9tYDIMoBh,SpATywNh6bZuzm8s1ceuBUnMUAeoAHHw,1,0,0,0,0,0,1,0,1,0.14285714285714285,1,0.0,0,0,0,0,0,0,0,1,0,0,1,1
8020,135459,EXZ81qqSldwR1xdBEwBZ7wmgbTHF86sl,bWdj2GDclj5ofokWjzoa5jAwMkxCykd6,39,88,52,149,34,24,11,3,361,51.57142857142857,3,0.0,15,52,125,34,73,24,24,11,3,226,135,0
8021,135464,LpEtIb2L9alLwOQca0Li1HTQlgRpqszP,SpATywNh6bZuzm8s1ceuBUnMUAeoAHHw,5,2,1,0,1,0,2,0,6,0.8571428571428571,1,0.0,0,1,0,1,2,0,0,2,0,2,4,0
8022,135482,AbI9GGAE5Qd4SVmAdr7BeGuvfhPX7Wtw,SpATywNh6bZuzm8s1ceuBUnMUAeoAHHw,9,9,0,6,1,0,2,0,18,2.5714285714285716,1,0.0,0,0,5,1,9,0,1,2,0,6,12,1
8023,135484,gPVsxFydsCsfu82yACdpzeHHS3WY2N6x,SpATywNh6bZuzm8s1ceuBUnMUAeoAHHw,5,2,1,0,1,0,2,0,6,0.8571428571428571,1,0.0,0,1,0,1,2,0,0,2,0,2,4,1
8024,135499,MgBJbfRXH0QNEJmIiGY28SpmFvbhxSoF,A3fsA9Zfv1X2fVEQhTw51lKENdNrEqT3,4,2,1,0,0,5,2,0,10,1.4285714285714286,1,0.0,0,1,0,0,2,5,0,2,0,1,9,1
8025,135507,irZDaKqT4KdxcZGgiOHoDpvTtZyUugWP,A3fsA9Zfv1X2fVEQhTw51lKENdNrEqT3,21,11,5,60,2,0,4,0,82,11.714285714285714,2,0.0,0,5,49,2,11,0,11,4,0,56,26,1
8026,135529,ibuUKEEpKQv3Ka1yViFkKH0Ap8k9qs3g,SpATywNh6bZuzm8s1ceuBUnMUAeoAHHw,3,4,0,0,0,0,1,0,5,0.7142857142857143,1,0.0,0,0,0,0,4,0,0,1,0,0,5,1
8027,135533,oM7zTsGBhypmiyvXB06I1GE7QqwfEoSV,SpATywNh6bZuzm8s1ceuBUnMUAeoAHHw,1,0,0,0,0,0,1,0,1,0.14285714285714285,1,0.0,0,0,0,0,0,0,0,1,0,0,1,1
8028,135535,oM7zTsGBhypmiyvXB06I1GE7QqwfEoSV,bWdj2GDclj5ofokWjzoa5jAwMkxCykd6,1,0,0,0,0,0,1,0,1,0.14285714285714285,1,0.0,0,0,0,0,0,0,0,1,0,0,1,1
8029,135536,oM7zTsGBhypmiyvXB06I1GE7QqwfEoSV,A3fsA9Zfv1X2fVEQhTw51lKENdNrEqT3,2,0,0,0,0,0,3,0,3,0.42857142857142855,1,0.0,0,0,0,0,0,0,0,3,0,0,3,1
8030,135547,XuaSoIyzQwXQTlS6fvGcmzTRqL1S8Nnj,A3fsA9Zfv1X2fVEQhTw51lKENdNrEqT3,6,4,0,0,0,0,7,0,11,1.5714285714285714,1,0.0,0,0,0,0,4,0,0,7,0,0,11,1
8031,135552,oaQkoDjpR1FzyXXhOzFvMONGKXrM2zS0,SpATywNh6bZuzm8s1ceuBUnMUAeoAHHw,6,3,1,0,1,0,2,0,7,1.0,1,0.0,0,1,0,1,3,0,0,2,0,2,5,1
8032,135553,HQ9RppyfbU41Pv363qQe8zqkh0OzGsvv,SpATywNh6bZuzm8s1ceuBUnMUAeoAHHw,17,12,8,14,4,0,3,0,41,5.857142857142857,2,0.0,2,8,13,4,10,0,1,3,0,27,14,1
8033,135554,nrNRU1bochGfgxXZNdc89zA9KtJYIKVZ,SpATywNh6bZuzm8s1ceuBUnMUAeoAHHw,24,37,23,8,14,0,8,0,90,12.857142857142858,4,0.0,7,23,8,14,30,0,0,8,0,52,38,0
8034,135560,p7o6CUVxTvhF5zDZdbTejHoySKfqycmC,A3fsA9Zfv1X2fVEQhTw51lKENdNrEqT3,6,3,2,0,1,0,2,0,8,1.1428571428571428,1,0.0,0,2,0,1,3,0,0,2,0,3,5,1
8035,135566,vycvLwIlVlbz3tEwZzvFj0YINSM3Ga0S,A3fsA9Zfv1X2fVEQhTw51lKENdNrEqT3,2,0,0,0,0,0,5,0,5,0.7142857142857143,1,0.0,0,0,0,0,0,0,0,5,0,0,5,1
8036,135570,JoLD64z5yUuFbScCfKMnv8dODXOTXhRU,RXDvfPUBYFlVdlueBFbLW0mhhAyGEqpt,37,35,2,59,5,1,8,3,113,16.142857142857142,3,0.0,9,2,55,5,26,1,4,8,3,71,42,1
8037,135590,VYMfm0tgVS6x4Eosz9NPpRPYpCrgFsMy,RXDvfPUBYFlVdlueBFbLW0mhhAyGEqpt,62,45,27,173,13,4,7,0,269,38.42857142857143,2,0.0,14,27,157,13,31,4,16,7,0,211,58,0
8038,135613,8lCrBaMkcXk8KsL7M8AYgjnsyFuSP4yK,SpATywNh6bZuzm8s1ceuBUnMUAeoAHHw,17,17,8,13,4,6,7,1,56,8.0,4,0.0,4,8,11,4,13,6,2,7,1,27,29,0
8039,135614,jWsLxS98Uf5iPgurn9PRvQM3beT2rSkF,RXDvfPUBYFlVdlueBFbLW0mhhAyGEqpt,8,5,4,0,2,0,1,0,12,1.7142857142857142,1,0.0,0,4,0,2,5,0,0,1,0,6,6,1
8040,135619,dmVv4oc5Gy8IXIoX1c6y61vCY7ZjC5c1,SpATywNh6bZuzm8s1ceuBUnMUAeoAHHw,29,45,21,12,6,7,17,0,108,15.428571428571429,5,0.0,7,21,12,6,38,7,0,17,0,46,62,1
8041,135624,MwZAtUJAIGUF9YvAxz812Aiz5L37mA7l,A3fsA9Zfv1X2fVEQhTw51lKENdNrEqT3,8,3,0,0,0,0,9,1,13,1.8571428571428572,1,0.0,0,0,0,0,3,0,0,9,1,0,13,1
8042,135627,p8PDk7PIRcdv8OilLQ1EB9K2d3Uc8Sea,SpATywNh6bZuzm8s1ceuBUnMUAeoAHHw,14,30,13,0,4,0,6,0,53,7.571428571428571,4,0.0,9,13,0,4,21,0,0,6,0,26,27,1
8043,135651,8E88mVxxHiSEV3ReMbiLkIuYAxJ6YXeO,A3fsA9Zfv1X2fVEQhTw51lKENdNrEqT3,12,18,12,0,3,0,7,0,40,5.714285714285714,4,0.0,0,12,0,3,18,0,0,7,0,15,25,0
8044,135653,ZtI7VkDL2OGaTLjYGXUs2OJh9j1CJRBG,A3fsA9Zfv1X2fVEQhTw51lKENdNrEqT3,1,0,0,0,0,0,1,0,1,0.14285714285714285,1,0.0,0,0,0,0,0,0,0,1,0,0,1,1
8045,135660,700mBNy8Tl4Vnb1y2ttxNbwsqHUl4IAM,RXDvfPUBYFlVdlueBFbLW0mhhAyGEqpt,2,0,0,0,0,0,3,0,3,0.42857142857142855,2,0.0,0,0,0,0,0,0,0,3,0,0,3,0
8046,135683,tK1ujwYOutLxYQ1M2MwQkyt3NUvkvmdS,SpATywNh6bZuzm8s1ceuBUnMUAeoAHHw,7,3,2,0,2,0,2,0,9,1.2857142857142858,1,0.0,0,2,0,2,3,0,0,2,0,4,5,1
8047,135687,txe41Ukj2eG7YicOJ2zPZM0lmaXGVXJ2,bWdj2GDclj5ofokWjzoa5jAwMkxCykd6,2,0,0,0,0,0,3,0,3,0.42857142857142855,1,0.0,0,0,0,0,0,0,0,3,0,0,3,1
8048,135692,txe41Ukj2eG7YicOJ2zPZM0lmaXGVXJ2,A3fsA9Zfv1X2fVEQhTw51lKENdNrEqT3,1,0,0,0,0,0,2,0,2,0.2857142857142857,1,0.0,0,0,0,0,0,0,0,2,0,0,2,1
8049,135701,0JlJQUp9pPJEAtzsQAEQWYAKuWMKB5Wj,SpATywNh6bZuzm8s1ceuBUnMUAeoAHHw,1,0,0,0,0,0,1,0,1,0.14285714285714285,1,0.0,0,0,0,0,0,0,0,1,0,0,1,1
8050,135703,1i94xoT1OVM1lTP3R294JlD5odSrEcP5,SpATywNh6bZuzm8s1ceuBUnMUAeoAHHw,16,34,0,0,0,3,10,1,48,6.857142857142857,5,0.0,7,0,0,0,27,3,0,10,1,7,41,1
8051,135709,EvNxwwShcQXgwZllGhuS7z5fGOL08A9A,SpATywNh6bZuzm8s1ceuBUnMUAeoAHHw,29,114,50,16,17,24,41,7,269,38.42857142857143,9,0.0,18,50,15,17,96,24,1,41,7,100,169,0
8052,135710,W1eC8dDo2Br41T5aJYgOhKyFK29UHKkl,bWdj2GDclj5ofokWjzoa5jAwMkxCykd6,1,0,0,0,0,0,1,0,1,0.14285714285714285,1,0.0,0,0,0,0,0,0,0,1,0,0,1,1
8053,135713,uw4petWia8mRNE3kHXaUdR4MrfrMeMii,SpATywNh6bZuzm8s1ceuBUnMUAeoAHHw,15,23,12,0,6,0,4,0,45,6.428571428571429,4,0.0,3,12,0,6,20,0,0,4,0,21,24,0
8054,135718,P3c6lZK14dvErTUVPURdGKdrWTycrHyk,SpATywNh6bZuzm8s1ceuBUnMUAeoAHHw,8,5,2,0,2,0,3,0,12,1.7142857142857142,1,0.0,0,2,0,2,5,0,0,3,0,4,8,1
8055,135730,H8XaU1gbefHT7MZ45ya2B80ofczKeIUJ,bWdj2GDclj5ofokWjzoa5jAwMkxCykd6,28,42,22,102,11,17,30,1,225,32.142857142857146,4,0.0,9,22,93,11,33,17,9,30,1,135,90,0
8056,135731,NBdBSIIhFodg28Tlkf7g5CN58dT0AVfw,A3fsA9Zfv1X2fVEQhTw51lKENdNrEqT3,5,1,1,0,0,0,10,0,12,1.7142857142857142,2,0.0,0,1,0,0,1,0,0,10,0,1,11,1
8057,135750,S9HR7eC8Gw4zo138FI1zxgIn4ZjLPEI1,RXDvfPUBYFlVdlueBFbLW0mhhAyGEqpt,2,0,0,0,0,0,5,0,5,0.7142857142857143,1,0.0,0,0,0,0,0,0,0,5,0,0,5,1
8058,135760,S9HR7eC8Gw4zo138FI1zxgIn4ZjLPEI1,SpATywNh6bZuzm8s1ceuBUnMUAeoAHHw,1,0,0,0,0,0,1,0,1,0.14285714285714285,1,0.0,0,0,0,0,0,0,0,1,0,0,1,1
8059,135772,B5AczbKF5ZPxp6QPkgM4LlavowE2gAlY,bWdj2GDclj5ofokWjzoa5jAwMkxCykd6,1,0,0,0,0,0,1,0,1,0.14285714285714285,1,0.0,0,0,0,0,0,0,0,1,0,0,1,1
8060,135789,PCI2iKpgTMjPS1xfOSmpWNe7sqLAlttf,G8EPVSXsOYB5YQWZGiz1aVq5Pgr2GrQu,1,0,0,0,0,0,1,0,1,0.14285714285714285,1,0.0,0,0,0,0,0,0,0,1,0,0,1,1
8061,135794,FpBG6AfbqT8rtlNKLvRAodERdOKPGQfD,A3fsA9Zfv1X2fVEQhTw51lKENdNrEqT3,7,3,2,0,2,0,2,0,9,1.2857142857142858,1,0.0,0,2,0,2,3,0,0,2,0,4,5,1
8062,135795,CAnNKDdlHhDJqz95kWpWwBuKgmoUwH3k,RXDvfPUBYFlVdlueBFbLW0mhhAyGEqpt,5,2,1,0,1,0,2,0,6,0.8571428571428571,1,0.0,0,1,0,1,2,0,0,2,0,2,4,1
8063,135813,E4hjF5LL5g3DmDyETJzEmj6OhjarBopN,A3fsA9Zfv1X2fVEQhTw51lKENdNrEqT3,7,3,1,0,0,1,11,1,17,2.4285714285714284,2,0.0,0,1,0,0,3,1,0,11,1,1,16,1
8064,135826,ETvKJXrBLwN7msxC91B5PIQrzaf0kAW1,A3fsA9Zfv1X2fVEQhTw51lKENdNrEqT3,1,0,0,0,0,0,1,0,1,0.14285714285714285,1,0.0,0,0,0,0,0,0,0,1,0,0,1,1
8065,135829,iyNW22GLVn7ltcBOUiQmam3mjjq9r9cL,A3fsA9Zfv1X2fVEQhTw51lKENdNrEqT3,7,7,1,0,1,0,3,0,12,1.7142857142857142,3,0.0,0,1,0,1,7,0,0,3,0,2,10,1
8066,135840,Pk1zvEWPdVckXHLEawuIZZjckq66QamN,A3fsA9Zfv1X2fVEQhTw51lKENdNrEqT3,12,12,3,0,1,0,16,1,33,4.714285714285714,2,0.0,0,3,0,1,12,0,0,16,1,4,29,1
8067,135843,QGuKTIBC2KLaYpPdOnB4nXCWgxMM1Dog,bWdj2GDclj5ofokWjzoa5jAwMkxCykd6,10,20,9,4,3,0,8,0,44,6.285714285714286,4,0.0,3,9,3,3,17,0,1,8,0,18,26,0
8068,135882,tTG3Ne3P3A1gAXhNVMiXz0Ee3ILsYPsk,7GRhBDsirIGkRZBtSMEzNTyDr2JQm4xx,1,0,0,0,0,0,1,0,1,0.14285714285714285,1,0.0,0,0,0,0,0,0,0,1,0,0,1,1
8069,135909,s1vgWbMezqTHWPlvrms0WJFKvZbaN3cw,7GRhBDsirIGkRZBtSMEzNTyDr2JQm4xx,22,24,13,16,7,3,6,0,69,9.857142857142858,3,0.0,5,13,13,7,19,3,3,6,0,38,31,1
8070,135969,QiJcxNGmLOdmB6eeGiBPeeCTz8AUKVVD,A3fsA9Zfv1X2fVEQhTw51lKENdNrEqT3,5,3,1,0,1,1,1,0,7,1.0,1,0.0,0,1,0,1,3,1,0,1,0,2,5,1
8071,136004,XpLwBNjV7lkbo9HRLwBFqy6jHSpPfym2,SpATywNh6bZuzm8s1ceuBUnMUAeoAHHw,8,5,3,0,2,0,3,0,13,1.8571428571428572,2,0.0,0,3,0,2,5,0,0,3,0,5,8,0
8072,136010,7bBbNS8igBUmtAlhgWeyPaLpz7A08m0l,7GRhBDsirIGkRZBtSMEzNTyDr2JQm4xx,23,43,18,35,16,2,3,0,117,16.714285714285715,2,0.0,21,18,31,16,22,2,4,3,0,86,31,1
8073,136060,K6gZA7sjhdZCSz3L5n4Avap9MqiCE3Mp,7GRhBDsirIGkRZBtSMEzNTyDr2JQm4xx,1,0,0,0,0,0,1,0,1,0.14285714285714285,1,0.0,0,0,0,0,0,0,0,1,0,0,1,1
8074,136090,1ml1ZIUtZXpkL0JmFSahYiWnT7jKIk9A,7GRhBDsirIGkRZBtSMEzNTyDr2JQm4xx,35,100,41,64,23,28,14,4,274,39.142857142857146,4,0.0,49,41,58,23,51,28,6,14,4,171,103,1
8075,136150,7aQ6rvmUrAZhXOumaP4VW6FvjX4qSmMG,SpATywNh6bZuzm8s1ceuBUnMUAeoAHHw,26,21,14,14,7,4,2,0,62,8.857142857142858,1,0.0,6,14,14,7,15,4,0,2,0,41,21,1
8076,136155,GgCLl5NjwqMgkh5JCvkbSguhpqbBPXLG,7GRhBDsirIGkRZBtSMEzNTyDr2JQm4xx,8,4,0,0,0,1,5,0,10,1.4285714285714286,2,0.0,0,0,0,0,4,1,0,5,0,0,10,1
8077,136220,kJR7SORW78mX9yl9TvMAdIrYcwnnZz4r,7GRhBDsirIGkRZBtSMEzNTyDr2JQm4xx,27,62,30,28,11,0,6,0,137,19.571428571428573,4,0.0,28,30,28,11,34,0,0,6,0,97,40,1
8078,136257,8uSQsFhnhoJeSVZylwMfyqKR37MO9Qyr,SpATywNh6bZuzm8s1ceuBUnMUAeoAHHw,4,2,1,0,1,0,1,0,5,0.7142857142857143,2,0.0,0,1,0,1,2,0,0,1,0,2,3,0
8079,136275,khelYX1bk51SSadsVaUzKR0zRRNCX0tK,7GRhBDsirIGkRZBtSMEzNTyDr2JQm4xx,37,99,36,121,1,0,21,1,279,39.857142857142854,5,0.0,49,36,109,1,50,0,12,21,1,195,84,1
8080,136282,no2ug7TKVsupL4LU2a5jY2GhYHkskTdw,SpATywNh6bZuzm8s1ceuBUnMUAeoAHHw,13,19,13,10,8,0,5,0,55,7.857142857142857,3,0.0,2,13,9,8,17,0,1,5,0,32,23,0
8081,136299,4R8cjmGXnx8F1dFD5UPDPTI5U03hvnfJ,G8EPVSXsOYB5YQWZGiz1aVq5Pgr2GrQu,9,4,3,0,3,0,4,1,15,2.142857142857143,1,0.0,0,3,0,3,4,0,0,4,1,6,9,1
8082,136386,FM7LvWy0SQdmiC09CRsUT44n0BqWWa2S,SpATywNh6bZuzm8s1ceuBUnMUAeoAHHw,14,72,18,0,14,0,11,0,115,16.428571428571427,6,0.0,0,18,0,14,72,0,0,11,0,32,83,0
8083,136411,AUmfgp7YjPBzDSEEKYtmp5NT1ZaUbwCu,A3fsA9Zfv1X2fVEQhTw51lKENdNrEqT3,72,40,29,148,18,18,13,2,268,38.285714285714285,1,0.0,4,29,128,18,36,18,20,13,2,179,89,0
8084,136442,TOTNiRasgzo7kH1hlyiehLV3DbzVA61v,7GRhBDsirIGkRZBtSMEzNTyDr2JQm4xx,56,81,20,104,25,56,25,0,311,44.42857142857143,5,0.0,56,20,87,25,25,56,17,25,0,188,123,1
8085,136447,ecut1h0rhjLzcs1jrL1hILYqwNtlJCKC,7GRhBDsirIGkRZBtSMEzNTyDr2JQm4xx,41,117,39,62,17,16,13,1,265,37.857142857142854,4,0.0,43,39,58,17,74,16,4,13,1,157,108,1
8086,136460,66UIy9DsqvecX9deVURN28A6eUmaxM2O,7GRhBDsirIGkRZBtSMEzNTyDr2JQm4xx,7,3,1,0,1,2,8,0,15,2.142857142857143,2,0.0,0,1,0,1,3,2,0,8,0,2,13,1
8087,136491,NcracMTfiaTPMbO6SSDnt9CDc4SnvBs9,7GRhBDsirIGkRZBtSMEzNTyDr2JQm4xx,12,29,7,0,7,0,2,0,45,6.428571428571429,1,0.0,21,7,0,7,8,0,0,2,0,35,10,1
8088,136495,EbKjJZq8GOECUxJBvCCbIZN8O8RweU4z,A3fsA9Zfv1X2fVEQhTw51lKENdNrEqT3,5,2,1,0,1,0,2,0,6,0.8571428571428571,1,0.0,0,1,0,1,2,0,0,2,0,2,4,1
8089,136513,hZR4MwcYec4g0GoOyJFngJGEyWOySpv2,bWdj2GDclj5ofokWjzoa5jAwMkxCykd6,9,10,7,0,2,5,9,0,33,4.714285714285714,2,0.0,1,7,0,2,9,5,0,9,0,10,23,0
8090,136514,ODBJIDcvWCzkG2XoiGFYE0mdoqG7tfRb,7GRhBDsirIGkRZBtSMEzNTyDr2JQm4xx,2,0,0,0,0,0,2,0,2,0.2857142857142857,1,0.0,0,0,0,0,0,0,0,2,0,0,2,1
8091,136521,i15PHia6n9agkYRoEhdWcUwrhqvX8pmC,7GRhBDsirIGkRZBtSMEzNTyDr2JQm4xx,1,0,0,0,0,0,1,0,1,0.14285714285714285,1,0.0,0,0,0,0,0,0,0,1,0,0,1,1
8092,136529,jia7n6yiGa4HNwul2FwX7WuWnOCMgFMl,7GRhBDsirIGkRZBtSMEzNTyDr2JQm4xx,21,39,10,21,6,5,1,0,82,11.714285714285714,1,0.0,27,10,21,6,12,5,0,1,0,64,18,1
8093,136530,hZR4MwcYec4g0GoOyJFngJGEyWOySpv2,G8EPVSXsOYB5YQWZGiz1aVq5Pgr2GrQu,20,30,14,0,9,6,14,0,73,10.428571428571429,2,0.0,9,14,0,9,21,6,0,14,0,32,41,0
8094,136533,ZC5rnhfF0O0RN6wj4xnmSbFJHTipD7b4,7GRhBDsirIGkRZBtSMEzNTyDr2JQm4xx,2,0,0,0,0,0,2,0,2,0.2857142857142857,1,0.0,0,0,0,0,0,0,0,2,0,0,2,1
8095,136558,Cv1aavObJnuABKfipF6OGePzg0BnGPFs,7GRhBDsirIGkRZBtSMEzNTyDr2JQm4xx,8,6,3,4,0,0,4,0,17,2.4285714285714284,1,0.0,3,3,4,0,3,0,0,4,0,10,7,1
8096,136562,UUf7W9nrVz0icOeIhIvztvvypaJKgHhN,SpATywNh6bZuzm8s1ceuBUnMUAeoAHHw,17,19,11,8,3,0,11,0,52,7.428571428571429,5,0.0,2,11,8,3,17,0,0,11,0,24,28,1
8097,136566,wamlK8Nx9pa9kXzI19EF5HF3fhJv3sWN,7GRhBDsirIGkRZBtSMEzNTyDr2JQm4xx,4,2,0,0,0,0,2,0,4,0.5714285714285714,1,0.0,0,0,0,0,2,0,0,2,0,0,4,1
8098,136576,wmN4PPC7Vh1X3pevAvwrqSI7HI55oZD6,A3fsA9Zfv1X2fVEQhTw51lKENdNrEqT3,11,8,6,0,6,0,5,1,26,3.7142857142857144,1,0.0,0,6,0,6,8,0,0,5,1,12,14,1
8099,136586,XvNNzv39b8VqKid0q4fV9ms2wVNAdWks,7GRhBDsirIGkRZBtSMEzNTyDr2JQm4xx,3,3,1,0,0,0,2,0,6,0.8571428571428571,2,0.0,0,1,0,0,3,0,0,2,0,1,5,1
8100,136588,KdKmzuUNmhXxN946vW23lms2nowQCTiW,7GRhBDsirIGkRZBtSMEzNTyDr2JQm4xx,6,0,0,0,0,0,17,2,19,2.7142857142857144,1,0.0,0,0,0,0,0,0,0,17,2,0,19,1
8101,136611,X7TCdJnOYqrDdC7umXZiC7RNUdfK8e7D,7GRhBDsirIGkRZBtSMEzNTyDr2JQm4xx,5,3,1,0,1,0,1,0,6,0.8571428571428571,1,0.0,0,1,0,1,3,0,0,1,0,2,4,1
8102,136615,Cv1aavObJnuABKfipF6OGePzg0BnGPFs,RXDvfPUBYFlVdlueBFbLW0mhhAyGEqpt,34,19,10,55,0,0,10,0,94,13.428571428571429,1,0.0,7,10,55,0,12,0,0,10,0,72,22,1
8103,136641,ndSSvoqRP9UOBqRicNUijfD0pPNDqiTJ,7GRhBDsirIGkRZBtSMEzNTyDr2JQm4xx,48,109,62,48,62,3,32,2,318,45.42857142857143,6,0.0,43,62,47,62,66,3,1,32,2,214,104,0
8104,136658,i6Z64SjIvtG8bIYKBDvv4gEAv5H6yeWe,7GRhBDsirIGkRZBtSMEzNTyDr2JQm4xx,1,0,0,0,0,0,2,0,2,0.2857142857142857,1,0.0,0,0,0,0,0,0,0,2,0,0,2,1
8105,136683,J3FKLxbUlPTor4lyG8lMpHc8oUQEjfcp,RXDvfPUBYFlVdlueBFbLW0mhhAyGEqpt,40,44,29,14,27,8,16,2,140,20.0,3,0.0,4,29,13,27,40,8,1,16,2,73,67,0
8106,136697,ZbpLZuhcPXDt8MCBlzIEU31Qmn57Ldle,G8EPVSXsOYB5YQWZGiz1aVq5Pgr2GrQu,5,7,3,0,1,0,5,0,16,2.2857142857142856,3,0.0,0,3,0,1,7,0,0,5,0,4,12,0
8107,136701,0Vr5nGGnd8VQ31kkuDTufqDyRIq6gvkS,RXDvfPUBYFlVdlueBFbLW0mhhAyGEqpt,45,28,11,68,7,1,5,0,120,17.142857142857142,1,0.0,7,11,68,7,21,1,0,5,0,93,27,1
8108,136765,Jpxsd7AQ90urdftfAf3y5kTy6w3x8OIk,7GRhBDsirIGkRZBtSMEzNTyDr2JQm4xx,1,0,0,0,0,0,1,0,1,0.14285714285714285,1,0.0,0,0,0,0,0,0,0,1,0,0,1,1
8109,136798,i8t7Go6rdZ7c7uD9bC7IIvAKxqbWTCzk,7GRhBDsirIGkRZBtSMEzNTyDr2JQm4xx,9,10,3,0,3,0,4,0,20,2.857142857142857,1,0.0,0,3,0,3,10,0,0,4,0,6,14,1
8110,136811,MgBJbfRXH0QNEJmIiGY28SpmFvbhxSoF,7GRhBDsirIGkRZBtSMEzNTyDr2JQm4xx,4,2,0,0,0,1,3,0,6,0.8571428571428571,2,0.0,0,0,0,0,2,1,0,3,0,0,6,1
8111,136845,OmBhuxpgNHza1UgJ4sJoDmhlFXyn8dEO,SpATywNh6bZuzm8s1ceuBUnMUAeoAHHw,16,32,17,21,7,0,12,2,91,13.0,3,0.0,10,17,17,7,22,0,4,12,2,51,40,0
8112,136896,0CZrf1rdgKFCFIVyDqGwyjQ94p1TBewg,SpATywNh6bZuzm8s1ceuBUnMUAeoAHHw,10,9,1,0,1,1,7,1,20,2.857142857142857,1,0.0,1,1,0,1,8,1,0,7,1,3,17,1
8113,136961,Cx9UgN9CA3ZQNCspfULD8FGJJpSFtxJF,bWdj2GDclj5ofokWjzoa5jAwMkxCykd6,20,22,12,18,6,1,8,2,69,9.857142857142858,1,0.0,5,12,18,6,17,1,0,8,2,41,28,0
8114,136994,UaiNqahLufAkWkzNVXpp9zyadIeXFDQ2,7GRhBDsirIGkRZBtSMEzNTyDr2JQm4xx,2,0,0,0,0,0,4,0,4,0.5714285714285714,1,0.0,0,0,0,0,0,0,0,4,0,0,4,1
8115,136997,azSMvYaBlxi8sVQgX0j44wgyxslA1ZOv,bWdj2GDclj5ofokWjzoa5jAwMkxCykd6,4,2,0,0,0,17,6,0,25,3.5714285714285716,1,0.0,0,0,0,0,2,17,0,6,0,0,25,0
8116,137007,1vvo0r6a7F7cnmAi2geIjNYeLW8STOBo,bWdj2GDclj5ofokWjzoa5jAwMkxCykd6,9,14,5,20,0,4,14,2,59,8.428571428571429,1,0.0,4,5,18,0,10,4,2,14,2,27,32,0
8117,137015,C7bvV9WgtivYIxdtA0RvlWoiA6KPa8KB,A3fsA9Zfv1X2fVEQhTw51lKENdNrEqT3,6,6,1,0,1,0,4,0,12,1.7142857142857142,2,0.0,0,1,0,1,6,0,0,4,0,2,10,1
8118,137018,xwVxmiN6s5Ty9myiVUNDBrV8mOb9D8yx,7GRhBDsirIGkRZBtSMEzNTyDr2JQm4xx,6,13,3,0,1,0,1,0,18,2.5714285714285716,1,0.0,9,3,0,1,4,0,0,1,0,13,5,1
8119,137066,ysgn6TuMNCSCCc3YWRE4ykee40CF0ytw,SpATywNh6bZuzm8s1ceuBUnMUAeoAHHw,9,9,4,0,2,0,8,1,24,3.4285714285714284,1,0.0,4,4,0,2,5,0,0,8,1,10,14,0
8120,137067,3AKxcSEV1jrslQIrEuinY7HEzBYlVr1w,7GRhBDsirIGkRZBtSMEzNTyDr2JQm4xx,1,0,0,0,0,0,1,0,1,0.14285714285714285,1,0.0,0,0,0,0,0,0,0,1,0,0,1,1
8121,137075,D5GqwXfacfySSvxPJ9v7ORjiX9Oa23f1,A3fsA9Zfv1X2fVEQhTw51lKENdNrEqT3,1,0,0,0,0,0,2,0,2,0.2857142857142857,1,0.0,0,0,0,0,0,0,0,2,0,0,2,1
8122,137106,ysgn6TuMNCSCCc3YWRE4ykee40CF0ytw,G8EPVSXsOYB5YQWZGiz1aVq5Pgr2GrQu,4,0,0,0,0,0,4,1,5,0.7142857142857143,1,0.0,0,0,0,0,0,0,0,4,1,0,5,1
8123,137107,XWnCbgeYVoaeV4iWRMUFAsMH4LdV0YRz,7GRhBDsirIGkRZBtSMEzNTyDr2JQm4xx,12,12,5,0,1,0,5,0,23,3.2857142857142856,1,0.0,0,5,0,1,12,0,0,5,0,6,17,1
8124,137117,TXBaUi0GpvXZWCDXsKlkFWTtfaT87UMz,A3fsA9Zfv1X2fVEQhTw51lKENdNrEqT3,7,4,2,0,0,3,5,1,15,2.142857142857143,1,0.0,1,2,0,0,3,3,0,5,1,3,12,1
8125,137120,TXBaUi0GpvXZWCDXsKlkFWTtfaT87UMz,7GRhBDsirIGkRZBtSMEzNTyDr2JQm4xx,1,0,0,0,0,0,1,0,1,0.14285714285714285,1,0.0,0,0,0,0,0,0,0,1,0,0,1,1
8126,137193,PmtrviA6hBub1PH85YXqVyZgghNsuc4g,RXDvfPUBYFlVdlueBFbLW0mhhAyGEqpt,8,8,2,0,1,0,2,0,13,1.8571428571428572,1,0.0,0,2,0,1,8,0,0,2,0,3,10,0
8127,137231,ZSEIlb9ma209LSHLrk2K3oKNlkQui4gF,7GRhBDsirIGkRZBtSMEzNTyDr2JQm4xx,38,55,22,43,16,4,7,0,147,21.0,3,0.0,28,22,38,16,27,4,5,7,0,104,43,1
8128,137244,v8s2hAX8tQgFD6i9MrUt2cuWPYPq3DuN,7GRhBDsirIGkRZBtSMEzNTyDr2JQm4xx,29,48,18,31,19,12,4,0,132,18.857142857142858,4,0.0,26,18,28,19,22,12,3,4,0,91,41,0
8129,137259,jx3H6f2miwKbLN02Gt82PEqx2tCxuPiz,SpATywNh6bZuzm8s1ceuBUnMUAeoAHHw,17,15,9,7,6,5,20,1,63,9.0,3,0.0,2,9,7,6,13,5,0,20,1,24,39,0
8130,137268,qDignCY8ZSbFAHDmfGr6um90qnmxvInL,7GRhBDsirIGkRZBtSMEzNTyDr2JQm4xx,7,5,2,4,2,0,1,0,14,2.0,1,0.0,2,2,3,2,3,0,1,1,0,9,5,1
8131,137291,zhx9FAttDf9KfTt4QYbmf4kGhKS1JatC,fbPkOYLVPtPgIt0MxizjfFJov3JbHyAi,6,2,0,0,0,8,8,1,19,2.7142857142857144,1,0.0,0,0,0,0,2,8,0,8,1,0,19,1
8132,137293,aJRPciowZ4Uphw6R6OHAqScxIuuZ6bxP,fbPkOYLVPtPgIt0MxizjfFJov3JbHyAi,1,0,0,0,0,0,1,0,1,0.14285714285714285,1,0.0,0,0,0,0,0,0,0,1,0,0,1,0
8133,137294,2AVqf09WA2itMEZz0u7FX3Fi3x3FZzPg,fbPkOYLVPtPgIt0MxizjfFJov3JbHyAi,6,8,4,0,2,1,5,0,20,2.857142857142857,2,0.0,0,4,0,2,8,1,0,5,0,6,14,1
8134,137295,VaoxktacOI8C5q8hn2iIjPvNhrMgUBA1,fbPkOYLVPtPgIt0MxizjfFJov3JbHyAi,1,0,0,0,0,0,1,0,1,0.14285714285714285,1,0.0,0,0,0,0,0,0,0,1,0,0,1,1
8135,137297,YkKsB5X9vnptYYEdKXeE2TLVCO4MMdOc,fbPkOYLVPtPgIt0MxizjfFJov3JbHyAi,6,6,3,0,2,0,3,0,14,2.0,1,0.0,0,3,0,2,6,0,0,3,0,5,9,1
8136,137298,c8WJAdYLV71mOx4ZXSglpCNd0dBUR3Om,fbPkOYLVPtPgIt0MxizjfFJov3JbHyAi,10,8,3,3,2,3,5,0,24,3.4285714285714284,1,0.0,1,3,2,2,7,3,1,5,0,8,16,1
8137,137302,qfe1MUR6a62dAgiCJR4API4cCHsYlsVO,fbPkOYLVPtPgIt0MxizjfFJov3JbHyAi,6,4,3,0,3,0,1,0,11,1.5714285714285714,1,0.0,0,3,0,3,4,0,0,1,0,6,5,1
8138,137303,RUYKIgG46teji8tqIoyMK9d2o6MFKma5,fbPkOYLVPtPgIt0MxizjfFJov3JbHyAi,10,5,3,0,3,0,6,0,17,2.4285714285714284,1,0.0,0,3,0,3,5,0,0,6,0,6,11,1
8139,137305,Z1uIScALT37BtyCtbFy33E9DuvHO2hks,fbPkOYLVPtPgIt0MxizjfFJov3JbHyAi,12,47,8,3,5,2,15,1,81,11.571428571428571,1,0.0,10,8,3,5,37,2,0,15,1,26,55,1
8140,137307,CgQYjUs70RSn4QebA63eL3Qm5MtCUzhj,fbPkOYLVPtPgIt0MxizjfFJov3JbHyAi,6,4,2,0,2,0,1,0,9,1.2857142857142858,1,0.0,1,2,0,2,3,0,0,1,0,5,4,0
8141,137310,3dtK0EXsDFiqPIgXhR4S028y6RGCztxN,fbPkOYLVPtPgIt0MxizjfFJov3JbHyAi,9,6,2,0,3,0,7,0,18,2.5714285714285716,1,0.0,3,2,0,3,3,0,0,7,0,8,10,1
8142,137311,bAltXvR0FBKFy91atPslJEMIb77R3lRC,fbPkOYLVPtPgIt0MxizjfFJov3JbHyAi,5,3,2,0,2,3,6,0,16,2.2857142857142856,2,0.0,0,2,0,2,3,3,0,6,0,4,12,1
8143,137312,yG9o9nU1hVydCMiwULHDO2ptGPwb3jNJ,fbPkOYLVPtPgIt0MxizjfFJov3JbHyAi,10,7,4,0,5,0,6,0,22,3.142857142857143,1,0.0,2,4,0,5,5,0,0,6,0,11,11,1
8144,137314,yQcq1gJWEi9sb58vjqz4cWvz65K4he0Q,fbPkOYLVPtPgIt0MxizjfFJov3JbHyAi,5,2,1,0,1,0,7,0,11,1.5714285714285714,1,0.0,0,1,0,1,2,0,0,7,0,2,9,1
8145,137316,xmbjcbay9FhXPDAWN6ffVRxetrr8jeM4,fbPkOYLVPtPgIt0MxizjfFJov3JbHyAi,16,9,7,0,6,11,14,1,48,6.857142857142857,1,0.0,0,7,0,6,9,11,0,14,1,13,35,1
8146,137317,55wDwHImP2KSV7dhBC7nPdVPLu4YizxX,fbPkOYLVPtPgIt0MxizjfFJov3JbHyAi,5,3,1,0,1,0,6,0,11,1.5714285714285714,1,0.0,0,1,0,1,3,0,0,6,0,2,9,1
8147,137318,5R4vzdx33VN10wY0ny2PCajdeF7dJThU,fbPkOYLVPtPgIt0MxizjfFJov3JbHyAi,5,2,1,0,1,0,3,0,7,1.0,1,0.0,0,1,0,1,2,0,0,3,0,2,5,1
8148,137320,8XstJLDa8agdHppUFVVZbvtgkIjc1hSo,fbPkOYLVPtPgIt0MxizjfFJov3JbHyAi,8,6,3,0,2,3,5,0,19,2.7142857142857144,2,0.0,0,3,0,2,6,3,0,5,0,5,14,1
8149,137322,7YUms5oSq8SOTxahUEH4CgK97RwpzrJL,fbPkOYLVPtPgIt0MxizjfFJov3JbHyAi,1,0,0,0,0,0,1,0,1,0.14285714285714285,1,0.0,0,0,0,0,0,0,0,1,0,0,1,1
8150,137327,4QLYsScyK6MU5AtBG0Whf2A1TPnb1x0x,fbPkOYLVPtPgIt0MxizjfFJov3JbHyAi,4,2,1,0,1,0,1,0,5,0.7142857142857143,1,0.0,0,1,0,1,2,0,0,1,0,2,3,1
8151,137328,DRsh16n3YrIgDiEC23najFM1m1jqkwJO,fbPkOYLVPtPgIt0MxizjfFJov3JbHyAi,5,3,1,0,1,0,1,0,6,0.8571428571428571,1,0.0,0,1,0,1,3,0,0,1,0,2,4,1
8152,137330,VThmvfwuMXDnKChVAYvsJFXoC4zUM0D9,fbPkOYLVPtPgIt0MxizjfFJov3JbHyAi,4,2,1,0,1,0,1,0,5,0.7142857142857143,1,0.0,0,1,0,1,2,0,0,1,0,2,3,1
8153,137333,gctoOufeRjSEdr00xmWUSLYVm7c6Ovl4,fbPkOYLVPtPgIt0MxizjfFJov3JbHyAi,2,0,0,0,0,0,4,0,4,0.5714285714285714,1,0.0,0,0,0,0,0,0,0,4,0,0,4,1
8154,137334,bzOuF27O1YGS02SMyouUKFo24T7mHVXd,fbPkOYLVPtPgIt0MxizjfFJov3JbHyAi,8,6,3,0,4,0,4,0,17,2.4285714285714284,1,0.0,1,3,0,4,5,0,0,4,0,8,9,1
8155,137337,SO9qUKDjuES2bMkck2Ro41uio1RDDMn4,fbPkOYLVPtPgIt0MxizjfFJov3JbHyAi,4,2,0,0,0,0,2,0,4,0.5714285714285714,1,0.0,0,0,0,0,2,0,0,2,0,0,4,1
8156,137338,i1dAtk6qr0Yjyjyw021VWnqB4cTdL0zR,fbPkOYLVPtPgIt0MxizjfFJov3JbHyAi,20,16,11,0,9,12,10,3,61,8.714285714285714,1,0.0,0,11,0,9,16,12,0,10,3,20,41,1
8157,137344,UUY3BPLR7A3Xa6FGsztMCn6xCbxtdCYu,fbPkOYLVPtPgIt0MxizjfFJov3JbHyAi,4,2,1,0,1,0,1,0,5,0.7142857142857143,1,0.0,0,1,0,1,2,0,0,1,0,2,3,1
8158,137346,LhTbpdQPj8McUYLExnN4ONQebEAJlctK,fbPkOYLVPtPgIt0MxizjfFJov3JbHyAi,5,2,1,0,1,0,2,0,6,0.8571428571428571,1,0.0,0,1,0,1,2,0,0,2,0,2,4,1
8159,137347,OilNA0H2OqGoAWakPxAdVr8srp2M8Kk5,fbPkOYLVPtPgIt0MxizjfFJov3JbHyAi,5,2,1,0,1,0,9,0,13,1.8571428571428572,2,0.0,0,1,0,1,2,0,0,9,0,2,11,1
8160,137349,hTAo9KiAJdTi42ZGMp48lMwTSPkKJERF,fbPkOYLVPtPgIt0MxizjfFJov3JbHyAi,2,0,0,0,0,0,4,0,4,0.5714285714285714,1,0.0,0,0,0,0,0,0,0,4,0,0,4,1
8161,137350,LUzWKYsqqChsro86iNB09MI9Og8MojLk,fbPkOYLVPtPgIt0MxizjfFJov3JbHyAi,6,6,2,0,2,0,4,0,14,2.0,1,0.0,3,2,0,2,3,0,0,4,0,7,7,1
8162,137351,wOJGPiHQhntwjEFJywVCc6H0XBUUrn4W,fbPkOYLVPtPgIt0MxizjfFJov3JbHyAi,5,2,1,0,1,0,4,0,8,1.1428571428571428,1,0.0,0,1,0,1,2,0,0,4,0,2,6,1
8163,137352,cuefNHr7cmtAeAOTeZH62xK2M7JgCzzm,fbPkOYLVPtPgIt0MxizjfFJov3JbHyAi,6,3,1,0,1,0,4,0,9,1.2857142857142858,1,0.0,0,1,0,1,3,0,0,4,0,2,7,1
8164,137354,WtDMxixQmy03wB9jEWr2xYQPm36rgbzM,fbPkOYLVPtPgIt0MxizjfFJov3JbHyAi,12,23,4,6,5,0,11,0,49,7.0,2,0.0,9,4,6,5,14,0,0,11,0,24,25,1
8165,137356,ADL0cXowUMs4wyiAOHKMOrtTHu5tmUqi,fbPkOYLVPtPgIt0MxizjfFJov3JbHyAi,5,3,2,0,1,0,3,0,9,1.2857142857142858,1,0.0,0,2,0,1,3,0,0,3,0,3,6,1
8166,137359,tg3C5tAthjtIE6hVso6iXfcLGroduOx8,fbPkOYLVPtPgIt0MxizjfFJov3JbHyAi,6,4,1,0,1,0,3,0,9,1.2857142857142858,1,0.0,0,1,0,1,4,0,0,3,0,2,7,1
8167,137360,NEKO6BLQdSSPIkqL9Q7yxqF7YpsLWJ2i,fbPkOYLVPtPgIt0MxizjfFJov3JbHyAi,7,4,2,0,1,1,8,0,16,2.2857142857142856,1,0.0,0,2,0,1,4,1,0,8,0,3,13,1
8168,137362,6OO2RXg4fKLY0L2CDQWPbDzS9qYFNLhY,fbPkOYLVPtPgIt0MxizjfFJov3JbHyAi,7,2,1,0,1,2,11,1,18,2.5714285714285716,1,0.0,0,1,0,1,2,2,0,11,1,2,16,1
8169,137363,PG5DcX6LvCCrfUIpAzQI5ebaNfLqaT2x,fbPkOYLVPtPgIt0MxizjfFJov3JbHyAi,9,8,4,0,3,19,6,1,41,5.857142857142857,1,0.0,3,4,0,3,5,19,0,6,1,10,31,1
8170,137364,PNltRKReLHuKml6LKXYu0Xf2LLMAke1h,fbPkOYLVPtPgIt0MxizjfFJov3JbHyAi,5,5,0,0,0,0,4,0,9,1.2857142857142858,1,0.0,0,0,0,0,5,0,0,4,0,0,9,1
8171,137365,X285XxvFlCKmuDlV3vzMxZpCu1V9X67P,fbPkOYLVPtPgIt0MxizjfFJov3JbHyAi,7,8,4,0,3,7,1,0,23,3.2857142857142856,1,0.0,2,4,0,3,6,7,0,1,0,9,14,1
8172,137366,0TSJej9rL1Sb8axummfeQPMEkUPlnJtY,fbPkOYLVPtPgIt0MxizjfFJov3JbHyAi,4,2,1,0,1,0,1,0,5,0.7142857142857143,1,0.0,0,1,0,1,2,0,0,1,0,2,3,1
8173,137367,yUbOTxLRPrMBKeEJQgeZAYWE44xjkzqj,fbPkOYLVPtPgIt0MxizjfFJov3JbHyAi,3,0,0,0,0,7,5,0,12,1.7142857142857142,1,0.0,0,0,0,0,0,7,0,5,0,0,12,1
8174,137368,fWcDM7NTKsDIL7vPWRWhQ3HiIwO7ubW6,fbPkOYLVPtPgIt0MxizjfFJov3JbHyAi,5,3,2,0,1,0,4,0,10,1.4285714285714286,1,0.0,0,2,0,1,3,0,0,4,0,3,7,1
8175,137369,llbduCly6ZFemSI4OiW2PWc2ZsNUujfV,fbPkOYLVPtPgIt0MxizjfFJov3JbHyAi,5,2,1,0,1,2,2,0,8,1.1428571428571428,1,0.0,0,1,0,1,2,2,0,2,0,2,6,1
8176,137371,IDAegjDGT88IxffhIlPXozfrAIyenr6d,fbPkOYLVPtPgIt0MxizjfFJov3JbHyAi,9,11,5,0,3,8,16,0,43,6.142857142857143,1,0.0,3,5,0,3,8,8,0,16,0,11,32,0
8177,137374,XnBCBUkc42wLmZebmQm45ZhzN8434GYt,fbPkOYLVPtPgIt0MxizjfFJov3JbHyAi,9,3,2,0,2,1,8,1,17,2.4285714285714284,1,0.0,0,2,0,2,3,1,0,8,1,4,13,1
8178,137376,xudT2FGfOf7lnAynFZztXlYI3LpEGyZP,fbPkOYLVPtPgIt0MxizjfFJov3JbHyAi,6,5,3,0,2,2,7,0,19,2.7142857142857144,1,0.0,0,3,0,2,5,2,0,7,0,5,14,1
8179,137378,1wIqcRX58Bpw6RXvGnbxsc6WbPwWGwXd,fbPkOYLVPtPgIt0MxizjfFJov3JbHyAi,5,5,3,0,2,2,2,0,14,2.0,2,0.0,0,3,0,2,5,2,0,2,0,5,9,1
8180,137380,yNFkVq3WBH36gbFucxZddTEItgWhR2NG,fbPkOYLVPtPgIt0MxizjfFJov3JbHyAi,7,5,2,0,3,0,2,0,12,1.7142857142857142,1,0.0,2,2,0,3,3,0,0,2,0,7,5,1
8181,137381,XE05vZThEHf17O6FM08AySNf2qZFgNWa,fbPkOYLVPtPgIt0MxizjfFJov3JbHyAi,7,6,3,1,4,0,1,0,15,2.142857142857143,1,0.0,2,3,1,4,4,0,0,1,0,10,5,1
8182,137382,nkm4i9oKKVu0C5FrCnxvTBLSuiaAGdZs,fbPkOYLVPtPgIt0MxizjfFJov3JbHyAi,6,3,2,0,2,0,1,0,8,1.1428571428571428,1,0.0,0,2,0,2,3,0,0,1,0,4,4,1
8183,137385,Cil3ne7R9WaXD5p2VZEmRDvLwX0ITQx4,fbPkOYLVPtPgIt0MxizjfFJov3JbHyAi,5,2,1,0,1,1,3,0,8,1.1428571428571428,1,0.0,0,1,0,1,2,1,0,3,0,2,6,1
8184,137387,KpMidRbqlnB1jsFzzXeXD9SSZ9cT4DEn,fbPkOYLVPtPgIt0MxizjfFJov3JbHyAi,2,0,0,0,0,0,2,0,2,0.2857142857142857,1,0.0,0,0,0,0,0,0,0,2,0,0,2,1
8185,137389,tsTDNHtkzUQqr6Le5CiKzEb1J3ub8XpE,fbPkOYLVPtPgIt0MxizjfFJov3JbHyAi,1,0,0,0,0,0,1,0,1,0.14285714285714285,1,0.0,0,0,0,0,0,0,0,1,0,0,1,1
8186,137390,WGBXR80uiaxU0rQGqPRIQBTLpC89XbJW,fbPkOYLVPtPgIt0MxizjfFJov3JbHyAi,2,0,0,0,0,0,2,0,2,0.2857142857142857,1,0.0,0,0,0,0,0,0,0,2,0,0,2,1
8187,137392,5iWOSqpJMywqKPlLQJ5aQLOawtvw8Iyp,fbPkOYLVPtPgIt0MxizjfFJov3JbHyAi,5,2,1,0,1,0,8,0,12,1.7142857142857142,1,0.0,0,1,0,1,2,0,0,8,0,2,10,1
8188,137393,iRCtUk9qJG1ZNpyYOkrIzRzmwV1jkfTG,fbPkOYLVPtPgIt0MxizjfFJov3JbHyAi,2,0,0,0,0,0,6,0,6,0.8571428571428571,1,0.0,0,0,0,0,0,0,0,6,0,0,6,1
8189,137394,C8zDhaG0vPsQegBtS55u3JZHiYuueFnE,fbPkOYLVPtPgIt0MxizjfFJov3JbHyAi,5,2,1,0,1,0,4,0,8,1.1428571428571428,1,0.0,0,1,0,1,2,0,0,4,0,2,6,1
8190,137395,174L1V9TprbRTHroQ9FWwbu1TqCVlQjk,fbPkOYLVPtPgIt0MxizjfFJov3JbHyAi,5,2,1,0,1,0,2,0,6,0.8571428571428571,1,0.0,0,1,0,1,2,0,0,2,0,2,4,1
8191,137396,mSgxVbbf83kCrpd2JLuv7BfCExmUt2C4,fbPkOYLVPtPgIt0MxizjfFJov3JbHyAi,8,4,2,0,2,2,4,1,15,2.142857142857143,1,0.0,1,2,0,2,3,2,0,4,1,5,10,0
8192,137398,Kc3YlgMAuK3aPMXYbr7Lb1W7MBNaKMiR,fbPkOYLVPtPgIt0MxizjfFJov3JbHyAi,6,3,2,0,2,0,1,0,8,1.1428571428571428,1,0.0,0,2,0,2,3,0,0,1,0,4,4,1
8193,137400,a5h0uXVhrD32xi14HjckmWeHNJHW3EMf,fbPkOYLVPtPgIt0MxizjfFJov3JbHyAi,4,15,2,0,0,0,1,0,18,2.5714285714285716,1,0.0,0,2,0,0,15,0,0,1,0,2,16,1
8194,137401,kQsVPicmVfwF40LR0Bwbh20EXwnKbn92,fbPkOYLVPtPgIt0MxizjfFJov3JbHyAi,18,42,13,9,16,20,17,2,119,17.0,3,0.0,28,13,8,16,14,20,1,17,2,65,54,1
8195,137402,C8KvwWwhKVcH5gZKcH7dQig9dEhWoVOu,fbPkOYLVPtPgIt0MxizjfFJov3JbHyAi,2,0,0,0,0,0,3,0,3,0.42857142857142855,1,0.0,0,0,0,0,0,0,0,3,0,0,3,1
8196,137403,3rZRyyAqQR0LHT7iXSTyhR4wZI7IzOpN,fbPkOYLVPtPgIt0MxizjfFJov3JbHyAi,6,6,2,0,3,0,1,0,12,1.7142857142857142,1,0.0,3,2,0,3,3,0,0,1,0,8,4,1
8197,137404,nOvIog5xbz5ZKA2OUeEwDTOaSy9QOHTT,fbPkOYLVPtPgIt0MxizjfFJov3JbHyAi,8,8,4,0,3,0,12,0,27,3.857142857142857,1,0.0,0,4,0,3,8,0,0,12,0,7,20,1
8198,137409,OD1pqN8En0iNd52vQpaf4DwGLH3W4dof,fbPkOYLVPtPgIt0MxizjfFJov3JbHyAi,9,7,5,0,3,0,3,0,18,2.5714285714285716,2,0.0,0,5,0,3,7,0,0,3,0,8,10,1
8199,137413,uCu7X2FM1qO7UaWcT7yafBpyCKsVxRuo,fbPkOYLVPtPgIt0MxizjfFJov3JbHyAi,7,2,1,0,1,3,6,1,14,2.0,1,0.0,0,1,0,1,2,3,0,6,1,2,12,1
8200,137416,A41hdT15T7mumzDW53QCDXRUsOilvTI0,fbPkOYLVPtPgIt0MxizjfFJov3JbHyAi,9,16,8,0,3,9,5,0,41,5.857142857142857,2,0.0,0,8,0,3,16,9,0,5,0,11,30,0
8201,137419,wCdkG2gdJ13TsTuESZCgsx6c9HoUuD9s,fbPkOYLVPtPgIt0MxizjfFJov3JbHyAi,8,10,4,7,4,0,1,0,26,3.7142857142857144,1,0.0,4,4,6,4,6,0,1,1,0,18,8,1
8202,137422,cH7MXJwZ1B11Byd6oixA8vDtJ38H8Xie,fbPkOYLVPtPgIt0MxizjfFJov3JbHyAi,5,1,1,0,1,0,3,0,6,0.8571428571428571,1,0.0,0,1,0,1,1,0,0,3,0,2,4,1
8203,137423,BEEx400Zym1Adj0LXV9O094DcgDYxMgU,fbPkOYLVPtPgIt0MxizjfFJov3JbHyAi,4,2,1,0,1,0,1,0,5,0.7142857142857143,1,0.0,0,1,0,1,2,0,0,1,0,2,3,1
8204,137424,bqKMJ5OUNpA2Wgq0oxWCoJ7xNwTYKmHM,fbPkOYLVPtPgIt0MxizjfFJov3JbHyAi,12,9,7,0,6,0,1,0,23,3.2857142857142856,1,0.0,0,7,0,6,9,0,0,1,0,13,10,1
8205,137425,X6JW84BYI57qMmiEsexKiPAn78X5H1sY,fbPkOYLVPtPgIt0MxizjfFJov3JbHyAi,3,2,0,0,0,0,1,0,3,0.42857142857142855,1,0.0,0,0,0,0,2,0,0,1,0,0,3,1
8206,137426,45lJHu4OdGTQsQvp0urXXWXHjLHgbztG,fbPkOYLVPtPgIt0MxizjfFJov3JbHyAi,2,0,0,0,0,0,2,0,2,0.2857142857142857,1,0.0,0,0,0,0,0,0,0,2,0,0,2,1
8207,137428,Q7kz14DBsTywLRi7Bx0P7HkElJgTxbaA,fbPkOYLVPtPgIt0MxizjfFJov3JbHyAi,4,3,2,0,0,0,3,0,8,1.1428571428571428,1,0.0,0,2,0,0,3,0,0,3,0,2,6,1
8208,137430,zEaDEiE5fac9Y3NT8JaitlDl9a7ILbFn,fbPkOYLVPtPgIt0MxizjfFJov3JbHyAi,6,1,1,0,1,0,9,0,12,1.7142857142857142,1,0.0,0,1,0,1,1,0,0,9,0,2,10,1
8209,137432,4foS4JAYOnNJdWly53kH9VyAeI8ZpoB9,fbPkOYLVPtPgIt0MxizjfFJov3JbHyAi,8,5,3,0,2,0,4,0,14,2.0,1,0.0,0,3,0,2,5,0,0,4,0,5,9,1
8210,137433,MXpZg6Y3WvwOURUS1VvgXTxhk1pXKVY7,fbPkOYLVPtPgIt0MxizjfFJov3JbHyAi,7,6,2,0,3,3,2,0,16,2.2857142857142856,1,0.0,3,2,0,3,3,3,0,2,0,8,8,1
8211,137435,2kGVAArEEN0LJBurgHk38pEMZThzj1T0,fbPkOYLVPtPgIt0MxizjfFJov3JbHyAi,6,3,2,0,2,0,1,0,8,1.1428571428571428,1,0.0,0,2,0,2,3,0,0,1,0,4,4,1
8212,137436,NOuxSmdis5r1BA64zbAkvC5MyhRcV1wd,fbPkOYLVPtPgIt0MxizjfFJov3JbHyAi,2,0,0,0,0,0,11,0,11,1.5714285714285714,1,0.0,0,0,0,0,0,0,0,11,0,0,11,1
8213,137437,tQSlSaSXXQMbulfRrarng77t6SPsEo7N,fbPkOYLVPtPgIt0MxizjfFJov3JbHyAi,6,7,4,0,5,0,1,0,17,2.4285714285714284,1,0.0,2,4,0,5,5,0,0,1,0,11,6,1
8214,137439,0PoVNnWMSVMNUD7YbDeAnDdYFFtJNZml,fbPkOYLVPtPgIt0MxizjfFJov3JbHyAi,5,2,1,0,1,0,2,0,6,0.8571428571428571,1,0.0,0,1,0,1,2,0,0,2,0,2,4,1
8215,137441,4hHmnOenTXav8CdwQUU4bXbhMHCuz22G,fbPkOYLVPtPgIt0MxizjfFJov3JbHyAi,12,29,5,8,7,3,12,2,66,9.428571428571429,2,0.0,12,5,8,7,17,3,0,12,2,32,34,1
8216,137442,1LtLQwRGDjWRPORAmpPeWuHr93qsG62M,fbPkOYLVPtPgIt0MxizjfFJov3JbHyAi,3,3,0,0,0,4,1,0,8,1.1428571428571428,1,0.0,0,0,0,0,3,4,0,1,0,0,8,1
8217,137444,7J7CDZ99WfuIWgF8UjFLGxW2Gw1ELsrr,fbPkOYLVPtPgIt0MxizjfFJov3JbHyAi,5,3,1,0,1,0,2,0,7,1.0,1,0.0,1,1,0,1,2,0,0,2,0,3,4,1
8218,137445,CuHzzfkniWARJNGhM9Z8TfGkX4QBNw5S,fbPkOYLVPtPgIt0MxizjfFJov3JbHyAi,2,0,0,0,0,0,5,0,5,0.7142857142857143,1,0.0,0,0,0,0,0,0,0,5,0,0,5,1
8219,137447,ucnh7Je2Ujv5K3Q3wjC5gWq40jwh8dv6,fbPkOYLVPtPgIt0MxizjfFJov3JbHyAi,5,8,3,0,1,0,2,0,14,2.0,1,0.0,0,3,0,1,8,0,0,2,0,4,10,1
8220,137448,ELrr1JfnDsWjEvT48HXDtL9YqiQpfZmF,fbPkOYLVPtPgIt0MxizjfFJov3JbHyAi,6,2,1,0,1,0,9,0,13,1.8571428571428572,1,0.0,0,1,0,1,2,0,0,9,0,2,11,1
8221,137450,nGWRzCfLEHu3fioeTp2MrUVqCTeaWKKh,fbPkOYLVPtPgIt0MxizjfFJov3JbHyAi,8,3,2,0,2,1,5,0,13,1.8571428571428572,1,0.0,0,2,0,2,3,1,0,5,0,4,9,1
8222,137452,OyUzOGgEg3D1ADlF5EJGg06nY3QmnkdW,fbPkOYLVPtPgIt0MxizjfFJov3JbHyAi,2,0,0,0,0,0,4,0,4,0.5714285714285714,1,0.0,0,0,0,0,0,0,0,4,0,0,4,1
8223,137454,U324n6nKpAIcARSxYaybih33hdfe43Hg,fbPkOYLVPtPgIt0MxizjfFJov3JbHyAi,1,0,0,0,0,0,1,0,1,0.14285714285714285,1,0.0,0,0,0,0,0,0,0,1,0,0,1,1
8224,137455,LLnSYhSyIZOYJyyJOzJg3NGJiWH34163,fbPkOYLVPtPgIt0MxizjfFJov3JbHyAi,1,0,0,0,0,0,1,0,1,0.14285714285714285,1,0.0,0,0,0,0,0,0,0,1,0,0,1,1
8225,137456,lYv59CqFZ5WNS1LpSdwbwYgAB1AnSa2W,fbPkOYLVPtPgIt0MxizjfFJov3JbHyAi,10,5,3,0,2,4,7,2,23,3.2857142857142856,1,0.0,0,3,0,2,5,4,0,7,2,5,18,1
8226,137457,5hA99qfStHjQqEYR2bkieX1UEObLPtIn,fbPkOYLVPtPgIt0MxizjfFJov3JbHyAi,5,3,0,0,0,0,2,0,5,0.7142857142857143,1,0.0,0,0,0,0,3,0,0,2,0,0,5,1
8227,137458,ccrvrr39fWp2aVbnA3k1bH1sjmwx7FQs,fbPkOYLVPtPgIt0MxizjfFJov3JbHyAi,8,25,2,0,0,0,9,0,36,5.142857142857143,2,0.0,0,2,0,0,25,0,0,9,0,2,34,1
8228,137459,Rr92BzwqUyCtPYHU3DwB1aivajxBRTFz,fbPkOYLVPtPgIt0MxizjfFJov3JbHyAi,4,2,1,0,1,0,1,0,5,0.7142857142857143,1,0.0,0,1,0,1,2,0,0,1,0,2,3,1
8229,138172,jb9pTa916Vn2VeH0D7ExYaf2JyoI9zrO,7GRhBDsirIGkRZBtSMEzNTyDr2JQm4xx,31,79,2,42,5,43,31,1,203,29.0,3,0.0,35,2,35,5,44,43,7,31,1,77,126,0
8230,138175,mLD9g4ezOv6SvPMWLaj047DaKrptKosJ,7GRhBDsirIGkRZBtSMEzNTyDr2JQm4xx,4,4,3,0,3,1,1,0,12,1.7142857142857142,1,0.0,0,3,0,3,4,1,0,1,0,6,6,1
8231,138199,x29OOChdmJGXK62DnUpwKbwJurqULmnD,7GRhBDsirIGkRZBtSMEzNTyDr2JQm4xx,7,6,2,0,3,0,2,0,13,1.8571428571428572,1,0.0,3,2,0,3,3,0,0,2,0,8,5,0
8232,138215,RgBHZtppWNmiRr4zn4KqEhMkv6vEscGZ,7GRhBDsirIGkRZBtSMEzNTyDr2JQm4xx,29,41,15,67,14,3,1,0,141,20.142857142857142,1,0.0,24,15,58,14,17,3,9,1,0,111,30,0
8233,138232,MfzRriitP2kzeiTWJO2r85qGclUEFMNK,7GRhBDsirIGkRZBtSMEzNTyDr2JQm4xx,6,3,1,0,1,0,5,0,10,1.4285714285714286,1,0.0,0,1,0,1,3,0,0,5,0,2,8,1
8234,138264,45E6hpwDMHp9Q3Pt1xT8q04bbowKk87g,7GRhBDsirIGkRZBtSMEzNTyDr2JQm4xx,33,92,25,30,22,1,10,0,180,25.714285714285715,2,0.0,63,25,28,22,29,1,2,10,0,138,42,0
8235,138266,pAkhnLI0s5vboktZycO7Tobv6jbspULh,G8EPVSXsOYB5YQWZGiz1aVq5Pgr2GrQu,17,15,8,6,8,0,2,0,39,5.571428571428571,2,0.0,5,8,5,8,10,0,1,2,0,26,13,0
8236,138267,pAkhnLI0s5vboktZycO7Tobv6jbspULh,7GRhBDsirIGkRZBtSMEzNTyDr2JQm4xx,3,2,1,0,0,0,1,0,4,0.5714285714285714,1,0.0,0,1,0,0,2,0,0,1,0,1,3,1
8237,138314,W6AT73CXG4URTyD2I7QWXXVZx4oeh86N,7GRhBDsirIGkRZBtSMEzNTyDr2JQm4xx,16,18,10,0,7,0,9,0,44,6.285714285714286,2,0.0,4,10,0,7,14,0,0,9,0,21,23,1
8238,138324,lVwgv61cg8fkhW9rg5b1PIPnuUWxb0Vk,7GRhBDsirIGkRZBtSMEzNTyDr2JQm4xx,1,0,0,0,0,0,1,0,1,0.14285714285714285,1,0.0,0,0,0,0,0,0,0,1,0,0,1,1
8239,138326,t4tnBhQAPqBnCFRCjzr4Y2gSOW7MaWb7,SpATywNh6bZuzm8s1ceuBUnMUAeoAHHw,4,2,1,0,1,0,1,0,5,0.7142857142857143,1,0.0,0,1,0,1,2,0,0,1,0,2,3,0
8240,138327,yq5rHqpCTagxs6XCaAXxmCSySzn2U3u8,A3fsA9Zfv1X2fVEQhTw51lKENdNrEqT3,43,6,3,146,1,0,6,0,162,23.142857142857142,1,0.0,2,3,119,1,4,0,27,6,0,125,37,1
8241,138358,8RGLvfdludl70fdPksu2JYtYCxSVr9FR,SpATywNh6bZuzm8s1ceuBUnMUAeoAHHw,13,17,0,20,0,0,2,0,39,5.571428571428571,1,0.0,2,0,16,0,15,0,4,2,0,18,21,1
8242,138367,KAW52VBDXCvurEAry0tITiLWjcxVkV8S,SpATywNh6bZuzm8s1ceuBUnMUAeoAHHw,18,41,16,24,4,63,18,1,167,23.857142857142858,4,0.0,16,16,20,4,25,63,4,18,1,56,111,0
8243,138373,0I055s9vaRQ6PXqeLKyD6l9kPxlReBT2,7GRhBDsirIGkRZBtSMEzNTyDr2JQm4xx,1,0,0,0,0,0,1,0,1,0.14285714285714285,1,0.0,0,0,0,0,0,0,0,1,0,0,1,1
8244,138406,73Lo5aiYTeasg8R5eGVwIsechNk0OHx6,SpATywNh6bZuzm8s1ceuBUnMUAeoAHHw,12,6,4,0,3,0,6,0,19,2.7142857142857144,2,0.0,0,4,0,3,6,0,0,6,0,7,12,1
8245,138420,GGf1UPTxgLShqKb7PDIL9hAwpCBcU4fs,SpATywNh6bZuzm8s1ceuBUnMUAeoAHHw,6,3,2,0,2,0,1,0,8,1.1428571428571428,1,0.0,0,2,0,2,3,0,0,1,0,4,4,1
8246,138456,jSWk10JJ0OWajXDG9k2ujEK46fA1leIF,7GRhBDsirIGkRZBtSMEzNTyDr2JQm4xx,2,0,0,0,0,0,2,0,2,0.2857142857142857,1,0.0,0,0,0,0,0,0,0,2,0,0,2,1
8247,138467,LN6esXV3qnIoLg44h6fXbTBvNC9pi5Ym,7GRhBDsirIGkRZBtSMEzNTyDr2JQm4xx,1,0,0,0,0,0,1,0,1,0.14285714285714285,1,0.0,0,0,0,0,0,0,0,1,0,0,1,1
8248,138510,eh4s2O0xG3K7bB3gC9QI2pZbmOHi0FkP,7GRhBDsirIGkRZBtSMEzNTyDr2JQm4xx,6,2,1,0,1,0,3,0,7,1.0,1,0.0,0,1,0,1,2,0,0,3,0,2,5,1
8249,138515,2Vr8sMi8Nmtw7GvPlYj3ww9EzMgjDWh8,SpATywNh6bZuzm8s1ceuBUnMUAeoAHHw,17,108,41,12,5,19,21,3,209,29.857142857142858,3,0.0,35,41,12,5,73,19,0,21,3,93,116,0
8250,138523,BhCvmy8WtOEti83wDjK9xOLWP4oCctij,RXDvfPUBYFlVdlueBFbLW0mhhAyGEqpt,6,4,1,0,2,2,3,0,12,1.7142857142857142,2,0.0,3,1,0,2,1,2,0,3,0,6,6,1
8251,138534,ilUzpPaeFISeGNY7Nt0DehBLL3wxQX0O,7GRhBDsirIGkRZBtSMEzNTyDr2JQm4xx,9,1,1,0,1,0,8,0,11,1.5714285714285714,1,0.0,0,1,0,1,1,0,0,8,0,2,9,1
8252,138537,e3wyIozlRLlcs7B7d4wJ9CCyj0Cy9HNB,7GRhBDsirIGkRZBtSMEzNTyDr2JQm4xx,7,2,1,0,1,0,4,1,9,1.2857142857142858,1,0.0,0,1,0,1,2,0,0,4,1,2,7,1
8253,138553,okqN4nBVKRYYrkYonKicKGOmPqVGYjZh,SpATywNh6bZuzm8s1ceuBUnMUAeoAHHw,15,34,17,15,6,0,17,0,89,12.714285714285714,5,0.0,3,17,14,6,31,0,1,17,0,40,49,0
8254,138559,WNxlasM9yolV5j0jIrxkqf7jn6zMrkGu,SpATywNh6bZuzm8s1ceuBUnMUAeoAHHw,1,0,0,0,0,0,1,0,1,0.14285714285714285,1,0.0,0,0,0,0,0,0,0,1,0,0,1,0
8255,138621,dgFOOUSNfQK8xIrT47Av0Q04bBFeE21W,RXDvfPUBYFlVdlueBFbLW0mhhAyGEqpt,1,0,0,0,0,0,1,0,1,0.14285714285714285,1,0.0,0,0,0,0,0,0,0,1,0,0,1,1
8256,138627,QZoi4xpkEVVH2rbYL53oYFfYungIuUup,7GRhBDsirIGkRZBtSMEzNTyDr2JQm4xx,35,42,13,63,11,5,13,3,150,21.428571428571427,2,0.0,24,13,56,11,18,5,7,13,3,104,46,1
8257,138638,fUQHFT4QEMRSPqJAQlXlvlyNwca9Q0dU,7GRhBDsirIGkRZBtSMEzNTyDr2JQm4xx,2,0,0,0,0,0,2,0,2,0.2857142857142857,1,0.0,0,0,0,0,0,0,0,2,0,0,2,1
8258,138716,bWXDTeHwMBrcFvsHEHi16Kcz6vnkKBkc,SpATywNh6bZuzm8s1ceuBUnMUAeoAHHw,2,0,0,0,0,0,3,0,3,0.42857142857142855,1,0.0,0,0,0,0,0,0,0,3,0,0,3,1
8259,138728,kcajSl3XvPJzA8r8jTipqgj4EAGyDqJf,7GRhBDsirIGkRZBtSMEzNTyDr2JQm4xx,15,47,1,16,5,1,3,0,73,10.428571428571429,1,0.0,23,1,14,5,24,1,2,3,0,43,30,1
8260,138731,Za7TsRG0IgcPg4zI5JWLKyABDBTbji9K,7GRhBDsirIGkRZBtSMEzNTyDr2JQm4xx,25,64,2,64,5,0,5,0,140,20.0,3,0.0,33,2,56,5,31,0,8,5,0,96,44,1
8261,138736,Sz9JtbyfGasFOcDw3qsqx6peODd97ECd,7GRhBDsirIGkRZBtSMEzNTyDr2JQm4xx,5,2,1,0,1,0,2,0,6,0.8571428571428571,2,0.0,0,1,0,1,2,0,0,2,0,2,4,1
8262,138808,wZxGcsfZmDyO3eZaMEp8V4Qxwmu1n6lt,A3fsA9Zfv1X2fVEQhTw51lKENdNrEqT3,41,14,12,56,11,0,6,0,99,14.142857142857142,1,0.0,1,12,47,11,13,0,9,6,0,71,28,0
8263,138810,KarP5JDxaA55wR1ThEFPoGYFsHmbBCZf,SpATywNh6bZuzm8s1ceuBUnMUAeoAHHw,12,11,4,6,2,0,3,0,26,3.7142857142857144,2,0.0,3,4,6,2,8,0,0,3,0,15,11,1
8264,138873,lLp4bdT6ycggmaUdjHCcgWeQnh0T1b1d,SpATywNh6bZuzm8s1ceuBUnMUAeoAHHw,11,26,10,0,5,0,3,0,44,6.285714285714286,2,0.0,8,10,0,5,18,0,0,3,0,23,21,1
8265,138898,mSs5bB1Rxg3xYWjWjJY9pVTt7WAiMgyu,RXDvfPUBYFlVdlueBFbLW0mhhAyGEqpt,8,9,6,0,1,0,11,0,27,3.857142857142857,1,0.0,0,6,0,1,9,0,0,11,0,7,20,0
8266,138921,SdmxANaN4VeJNVCXABSOs77O0krJ65nl,SpATywNh6bZuzm8s1ceuBUnMUAeoAHHw,31,42,23,35,10,10,18,5,143,20.428571428571427,3,0.0,4,23,30,10,38,10,5,18,5,67,76,1
8267,138933,YbQfcgwKrjskWW3wyOzQUUJYzdeHmY82,7GRhBDsirIGkRZBtSMEzNTyDr2JQm4xx,18,37,8,6,9,0,2,0,62,8.857142857142858,1,0.0,18,8,6,9,19,0,0,2,0,41,21,1
8268,138979,9Mbi6CksSOlTvzJd1jV7pzorOP4mmF9E,SpATywNh6bZuzm8s1ceuBUnMUAeoAHHw,18,23,11,2,6,0,9,0,51,7.285714285714286,4,0.0,2,11,2,6,21,0,0,9,0,21,30,0
8269,139001,PLKaanKvHCtHMqtCskLE9sVgrYP9vmXy,SpATywNh6bZuzm8s1ceuBUnMUAeoAHHw,12,22,9,20,1,0,6,1,59,8.428571428571429,3,0.0,10,9,17,1,12,0,3,6,1,37,22,0
8270,139009,ucdoEtZyBMBpMuHw7eldMzgNsB5u9NZD,7GRhBDsirIGkRZBtSMEzNTyDr2JQm4xx,2,0,0,0,0,0,2,0,2,0.2857142857142857,1,0.0,0,0,0,0,0,0,0,2,0,0,2,1
8271,139030,nZH2h9tRgS1XihszFT0Gsl3zQK5yTzdn,7GRhBDsirIGkRZBtSMEzNTyDr2JQm4xx,1,0,0,0,0,0,2,0,2,0.2857142857142857,1,0.0,0,0,0,0,0,0,0,2,0,0,2,1
8272,139077,sTlxlEkJ3MbMUAeSajnaHOGfpyW9hgq1,7GRhBDsirIGkRZBtSMEzNTyDr2JQm4xx,4,3,1,0,1,0,1,0,6,0.8571428571428571,1,0.0,0,1,0,1,3,0,0,1,0,2,4,1
8273,139091,FqxZInDGuTXmPgpy2HmrKGvUbRHydqL9,A3fsA9Zfv1X2fVEQhTw51lKENdNrEqT3,43,38,29,72,14,12,10,3,178,25.428571428571427,2,0.0,3,29,59,14,35,12,13,10,3,105,73,1
8274,139097,rJa06nlcyBimvgL7PoPXhuOUbmR9mddR,7GRhBDsirIGkRZBtSMEzNTyDr2JQm4xx,1,0,0,0,0,0,1,0,1,0.14285714285714285,1,0.0,0,0,0,0,0,0,0,1,0,0,1,1
8275,139138,pLMdR2T5UiKa0jLlBQ6JAVdYxLS2oAZC,7GRhBDsirIGkRZBtSMEzNTyDr2JQm4xx,9,8,6,0,5,0,3,0,22,3.142857142857143,2,0.0,0,6,0,5,8,0,0,3,0,11,11,1
8276,139172,vQiAys6oOekX5OV9gzy071CxobZT5OY1,7GRhBDsirIGkRZBtSMEzNTyDr2JQm4xx,1,0,0,0,0,0,1,0,1,0.14285714285714285,1,0.0,0,0,0,0,0,0,0,1,0,0,1,1
8277,139207,RIjNzTzWwuMpVu0vcsF9N8cORAAtLFQn,bWdj2GDclj5ofokWjzoa5jAwMkxCykd6,6,5,1,0,2,0,3,0,11,1.5714285714285714,1,0.0,2,1,0,2,3,0,0,3,0,5,6,1
8278,139217,OOIu03NBEHePUSUIFa86FGFP5M136EAn,RXDvfPUBYFlVdlueBFbLW0mhhAyGEqpt,61,101,38,137,22,12,30,4,344,49.142857142857146,6,0.0,15,38,127,22,86,12,10,30,4,202,142,0
8279,139222,St6usTSSgX5U9v7wchuMWqmBKoCcDwN2,bWdj2GDclj5ofokWjzoa5jAwMkxCykd6,5,4,0,0,0,0,2,0,6,0.8571428571428571,2,0.0,0,0,0,0,4,0,0,2,0,0,6,1
8280,139230,Az3rIdfQyspbBZOuftkV0XmT1mpRRVMU,G8EPVSXsOYB5YQWZGiz1aVq5Pgr2GrQu,10,5,4,0,4,0,2,0,15,2.142857142857143,1,0.0,0,4,0,4,5,0,0,2,0,8,7,1
8281,139246,3nkAYJy31glMu7RttArFOqU7gmkfxNPM,SpATywNh6bZuzm8s1ceuBUnMUAeoAHHw,1,0,0,0,0,0,2,0,2,0.2857142857142857,2,0.0,0,0,0,0,0,0,0,2,0,0,2,0
8282,139252,AKVd0gnvEJlgz6OnGwqybMUQOVjHL58y,SpATywNh6bZuzm8s1ceuBUnMUAeoAHHw,18,32,22,18,15,0,7,0,94,13.428571428571429,3,0.0,2,22,16,15,30,0,2,7,0,55,39,0
8283,139262,CQI3ipMoYWvyV7ZuewrTlOYAM3gikvMq,7GRhBDsirIGkRZBtSMEzNTyDr2JQm4xx,14,16,8,4,5,0,5,0,38,5.428571428571429,2,0.0,4,8,4,5,12,0,0,5,0,21,17,1
8284,139270,9W6HDa8nbr3i4rkBKbOa5qCJz73HRO2D,7GRhBDsirIGkRZBtSMEzNTyDr2JQm4xx,18,20,9,25,8,0,4,0,66,9.428571428571429,2,0.0,9,9,21,8,11,0,4,4,0,47,19,1
8285,139324,hT3A3NhtOhvHOWKsgHNINVDyTB0qBxh1,SpATywNh6bZuzm8s1ceuBUnMUAeoAHHw,16,38,10,31,5,3,9,1,97,13.857142857142858,2,0.0,12,10,27,5,26,3,4,9,1,54,43,0
8286,139331,jIQxdn4syEISmeL05XWgww3FZktzs7MC,SpATywNh6bZuzm8s1ceuBUnMUAeoAHHw,19,21,9,17,4,0,6,0,57,8.142857142857142,1,0.0,9,9,15,4,12,0,2,6,0,37,20,0
8287,139332,IAgEmatHzKUXARhFStPcCuJqOEJArzMq,SpATywNh6bZuzm8s1ceuBUnMUAeoAHHw,1,0,0,0,0,0,1,0,1,0.14285714285714285,1,0.0,0,0,0,0,0,0,0,1,0,0,1,0
8288,139342,iO8wfk9CJpGr60f1tg17Yoor3BIrLyLv,bWdj2GDclj5ofokWjzoa5jAwMkxCykd6,2,0,0,0,0,0,3,0,3,0.42857142857142855,1,0.0,0,0,0,0,0,0,0,3,0,0,3,1
8289,139344,h4B8ffuSXL9NZaxc0msh2EYaxC0hStsr,7GRhBDsirIGkRZBtSMEzNTyDr2JQm4xx,5,2,0,0,0,0,3,1,6,0.8571428571428571,1,0.0,0,0,0,0,2,0,0,3,1,0,6,1
8290,139369,aXYyJMDvVYwwKBbiO4CB25XlnDBfWYNg,A3fsA9Zfv1X2fVEQhTw51lKENdNrEqT3,7,4,2,0,1,10,3,0,20,2.857142857142857,1,0.0,1,2,0,1,3,10,0,3,0,4,16,1
8291,139376,wx3mAGKFM6cge9w8piWfsYKppmWVhkYO,7GRhBDsirIGkRZBtSMEzNTyDr2JQm4xx,5,10,2,0,2,0,1,0,15,2.142857142857143,1,0.0,0,2,0,2,10,0,0,1,0,4,11,1
8292,139404,fgEJIqkp4SMlTSJ7SAm1OLRW7sHHzj7J,RXDvfPUBYFlVdlueBFbLW0mhhAyGEqpt,7,6,5,0,2,0,4,1,18,2.5714285714285716,1,0.0,0,5,0,2,6,0,0,4,1,7,11,0
8293,139428,abzlLtUVw5Pp8kU9DAXNl6SvnA5wbEox,7GRhBDsirIGkRZBtSMEzNTyDr2JQm4xx,1,0,0,0,0,0,2,0,2,0.2857142857142857,1,0.0,0,0,0,0,0,0,0,2,0,0,2,1
8294,139436,YOvd9uht0tZm889aIFQH8jd68xtH7inE,bWdj2GDclj5ofokWjzoa5jAwMkxCykd6,18,42,18,44,3,2,14,0,123,17.571428571428573,5,0.0,9,18,37,3,33,2,7,14,0,67,56,0
8295,139465,zbo9FGjTmUUlBLDkbpFTLQYtMVFawINZ,7GRhBDsirIGkRZBtSMEzNTyDr2JQm4xx,1,0,0,0,0,0,2,0,2,0.2857142857142857,1,0.0,0,0,0,0,0,0,0,2,0,0,2,1
8296,139544,G8fLPL9uAaHZvdz6ZdYfgDC2jOIdMG4b,7GRhBDsirIGkRZBtSMEzNTyDr2JQm4xx,1,0,0,0,0,0,1,0,1,0.14285714285714285,1,0.0,0,0,0,0,0,0,0,1,0,0,1,1
8297,139596,7u3azzypzNqPYEFxf0DcbGOgDVhkOXos,7GRhBDsirIGkRZBtSMEzNTyDr2JQm4xx,32,37,8,42,8,4,9,0,108,15.428571428571429,2,0.0,21,8,37,8,16,4,5,9,0,74,34,1
8298,139598,bHMSPD6TpG4I9IyQFzHZ8oywImP9IiZd,7GRhBDsirIGkRZBtSMEzNTyDr2JQm4xx,1,0,0,0,0,0,1,0,1,0.14285714285714285,1,0.0,0,0,0,0,0,0,0,1,0,0,1,1
8299,139703,MDn3CtIIZuEXDPhMfThc5BfvVlOiIwwt,7GRhBDsirIGkRZBtSMEzNTyDr2JQm4xx,9,7,1,0,0,1,9,1,19,2.7142857142857144,1,0.0,0,1,0,0,7,1,0,9,1,1,18,1
8300,139706,BGq4CkiKFU4S6hRTjQFWEyJE9fTf2RIS,7GRhBDsirIGkRZBtSMEzNTyDr2JQm4xx,2,0,0,0,0,0,2,0,2,0.2857142857142857,1,0.0,0,0,0,0,0,0,0,2,0,0,2,1
8301,139713,n51reZ5FTJkHLnQwBqURrmxGDzwEsEjy,7GRhBDsirIGkRZBtSMEzNTyDr2JQm4xx,4,2,1,0,1,0,1,0,5,0.7142857142857143,1,0.0,0,1,0,1,2,0,0,1,0,2,3,1
8302,140068,dRD1DS5DuggVygcG59W7832HdVYwtgOn,7GRhBDsirIGkRZBtSMEzNTyDr2JQm4xx,7,6,1,0,1,0,4,0,12,1.7142857142857142,3,0.0,0,1,0,1,6,0,0,4,0,2,10,1
8303,140282,xcD6YWhnGA2xukGmX4eaYrm6VS9ffz1H,7GRhBDsirIGkRZBtSMEzNTyDr2JQm4xx,4,2,0,0,0,0,5,0,7,1.0,1,0.0,0,0,0,0,2,0,0,5,0,0,7,0
8304,140636,2lTrV3r5iXOtPSrHMTWqISMwiAr82ziw,7GRhBDsirIGkRZBtSMEzNTyDr2JQm4xx,5,2,1,0,1,0,2,0,6,0.8571428571428571,1,0.0,0,1,0,1,2,0,0,2,0,2,4,1
8305,143597,0cz0w0x5qzuunbgfeQV0i5L0OMvyWFxQ,SpATywNh6bZuzm8s1ceuBUnMUAeoAHHw,13,10,7,0,5,3,17,4,46,6.571428571428571,2,0.0,0,7,0,5,10,3,0,17,4,12,34,1
8306,143602,Jm4nQ05ndX10jbofbWx6S0r9VXrqia6S,A3fsA9Zfv1X2fVEQhTw51lKENdNrEqT3,10,9,6,0,2,0,2,0,19,2.7142857142857144,1,0.0,0,6,0,2,9,0,0,2,0,8,11,0
8307,143603,nWxN8tjySUVOGOns5lP09DIo5v1ke7EL,A3fsA9Zfv1X2fVEQhTw51lKENdNrEqT3,8,9,4,0,3,0,2,0,18,2.5714285714285716,1,0.0,0,4,0,3,9,0,0,2,0,7,11,1
8308,143605,nWxN8tjySUVOGOns5lP09DIo5v1ke7EL,bWdj2GDclj5ofokWjzoa5jAwMkxCykd6,8,4,2,0,1,2,11,2,22,3.142857142857143,1,0.0,0,2,0,1,4,2,0,11,2,3,19,1
8309,143607,3iJrlZJEv2h7DgWBpz6wZtSXPXEy6IAY,bWdj2GDclj5ofokWjzoa5jAwMkxCykd6,6,5,3,0,2,0,2,0,12,1.7142857142857142,2,0.0,0,3,0,2,5,0,0,2,0,5,7,1
8310,143614,n2GF9Yeq4eisQG7nka32xYSXt9etqVaZ,G8EPVSXsOYB5YQWZGiz1aVq5Pgr2GrQu,6,5,3,0,0,1,2,0,11,1.5714285714285714,1,0.0,0,3,0,0,5,1,0,2,0,3,8,1
8311,143623,HtMha1d9fNJoHGbwIKcB3HWdDU94w7Lj,SpATywNh6bZuzm8s1ceuBUnMUAeoAHHw,16,21,11,17,5,0,5,1,60,8.571428571428571,2,0.0,6,11,16,5,15,0,1,5,1,38,22,1
8312,143629,tkMGC5CG4kemHaNbBo6MMddbuqCxk8Qb,SpATywNh6bZuzm8s1ceuBUnMUAeoAHHw,5,5,3,0,1,0,2,0,11,1.5714285714285714,3,0.0,0,3,0,1,5,0,0,2,0,4,7,1
8313,143631,GNXZVEHsVeYck60C0KBPWHG0mMcY0UQQ,SpATywNh6bZuzm8s1ceuBUnMUAeoAHHw,15,20,2,7,3,9,4,0,45,6.428571428571429,5,0.0,2,2,7,3,18,9,0,4,0,14,31,0
8314,143641,Uux0jHna4HKcvE72hnPMG7xrHByftJPh,bWdj2GDclj5ofokWjzoa5jAwMkxCykd6,5,2,1,0,1,0,2,0,6,0.8571428571428571,1,0.0,0,1,0,1,2,0,0,2,0,2,4,1
8315,143650,iyNW22GLVn7ltcBOUiQmam3mjjq9r9cL,bWdj2GDclj5ofokWjzoa5jAwMkxCykd6,1,0,0,0,0,0,1,0,1,0.14285714285714285,1,0.0,0,0,0,0,0,0,0,1,0,0,1,1
8316,143652,NNxm4wTuqK3vBr5exeeaxNmVWigp9kZd,RXDvfPUBYFlVdlueBFbLW0mhhAyGEqpt,9,9,1,0,0,0,4,0,14,2.0,2,0.0,0,1,0,0,9,0,0,4,0,1,13,1
8317,143653,E7W9iVWrVUAUJsVKnfZDdWhC9kKNiFWd,A3fsA9Zfv1X2fVEQhTw51lKENdNrEqT3,4,2,1,0,1,0,1,0,5,0.7142857142857143,1,0.0,0,1,0,1,2,0,0,1,0,2,3,0
8318,143683,oArXTDKLwWKfXkZ74yUJJtvr4UhDGsgG,SpATywNh6bZuzm8s1ceuBUnMUAeoAHHw,7,4,0,0,1,0,2,0,7,1.0,1,0.0,0,0,0,1,4,0,0,2,0,1,6,1
8319,143687,zXaIFCKxfdY9z9fVBcdJ9CKQhYz4fcsP,A3fsA9Zfv1X2fVEQhTw51lKENdNrEqT3,8,4,1,8,1,0,2,0,16,2.2857142857142856,1,0.0,1,1,8,1,3,0,0,2,0,11,5,1
8320,143689,ZaW4RrWrF9gJ30CuAjw5a2IkcpF7An5C,G8EPVSXsOYB5YQWZGiz1aVq5Pgr2GrQu,10,8,3,0,2,5,12,2,32,4.571428571428571,2,0.0,2,3,0,2,6,5,0,12,2,7,25,1
8321,143690,9l6PGZqklFaIeCC4cIui4TvC3Cf7mMtA,G8EPVSXsOYB5YQWZGiz1aVq5Pgr2GrQu,8,3,2,0,2,1,8,1,17,2.4285714285714284,1,0.0,0,2,0,2,3,1,0,8,1,4,13,1
8322,143695,MiA88xKunqu6yy0duOdvLI06Oy5UMt4X,RXDvfPUBYFlVdlueBFbLW0mhhAyGEqpt,4,2,1,0,1,0,1,0,5,0.7142857142857143,1,0.0,0,1,0,1,2,0,0,1,0,2,3,1
8323,143715,vFHaopWeOsxXSRudDrGgOuVKmzwec37W,SpATywNh6bZuzm8s1ceuBUnMUAeoAHHw,13,19,0,9,1,0,4,0,33,4.714285714285714,1,0.0,4,0,9,1,15,0,0,4,0,14,19,1
8324,143722,VzxoAK96NBZMonMzFBNCEGPOgDpcMczp,A3fsA9Zfv1X2fVEQhTw51lKENdNrEqT3,8,2,1,0,1,10,6,1,21,3.0,1,0.0,0,1,0,1,2,10,0,6,1,2,19,1
8325,143731,X2xaI3ENq0OZDZ0s1ETxwXOMaEJnZn8K,A3fsA9Zfv1X2fVEQhTw51lKENdNrEqT3,8,4,3,0,3,0,1,0,11,1.5714285714285714,2,0.0,0,3,0,3,4,0,0,1,0,6,5,1
8326,143736,a2kYXY4DZduwKkGJa8fQrbG6TxHBB94I,A3fsA9Zfv1X2fVEQhTw51lKENdNrEqT3,6,2,1,0,1,0,9,0,13,1.8571428571428572,1,0.0,0,1,0,1,2,0,0,9,0,2,11,1
8327,143739,j1ZwHmxsEQ0TgQEQqgxbWG7UscEDky1c,SpATywNh6bZuzm8s1ceuBUnMUAeoAHHw,13,22,0,11,0,0,8,0,41,5.857142857142857,2,0.0,10,0,10,0,12,0,1,8,0,20,21,1
8328,143745,ravD1f2MIgZP9srRrYJQsdPSYhRi83XU,SpATywNh6bZuzm8s1ceuBUnMUAeoAHHw,16,27,4,21,1,2,13,1,69,9.857142857142858,3,0.0,9,4,18,1,18,2,3,13,1,32,37,0
8329,143749,cZbR6FMlSKlEaK0BZQEtqLknk5lBVQRh,SpATywNh6bZuzm8s1ceuBUnMUAeoAHHw,14,16,1,12,1,12,8,1,51,7.285714285714286,1,0.0,5,1,10,1,11,12,2,8,1,17,34,1
8330,143750,ldpyoNVLH614iuNg2P99R7SYjvFOfdM2,G8EPVSXsOYB5YQWZGiz1aVq5Pgr2GrQu,11,14,6,0,4,1,4,0,29,4.142857142857143,3,0.0,3,6,0,4,11,1,0,4,0,13,16,1
8331,143762,m7fPOqd4GotPyK3pn7xq2eK9izwTqrAR,A3fsA9Zfv1X2fVEQhTw51lKENdNrEqT3,5,1,1,0,1,1,2,0,6,0.8571428571428571,1,0.0,0,1,0,1,1,1,0,2,0,2,4,1
8332,143766,CDMI3gQZrAOAZ9Cf4jB5NzA4daPYwjjn,A3fsA9Zfv1X2fVEQhTw51lKENdNrEqT3,20,16,13,0,7,5,11,4,56,8.0,2,0.0,0,13,0,7,16,5,0,11,4,20,36,1
8333,143772,D0Q5uZnA6QMJZo17g9opktHEQj6b5d5E,SpATywNh6bZuzm8s1ceuBUnMUAeoAHHw,3,0,0,0,0,0,3,0,3,0.42857142857142855,1,0.0,0,0,0,0,0,0,0,3,0,0,3,0
8334,143796,JGBLBGhiZQ8K0PQBUKKu5a6jYm04SHA0,A3fsA9Zfv1X2fVEQhTw51lKENdNrEqT3,2,0,0,0,0,0,2,0,2,0.2857142857142857,1,0.0,0,0,0,0,0,0,0,2,0,0,2,1
8335,143804,qmiNvBvBVayyfYSGvn9Ww6fyfbmmg8Ju,SpATywNh6bZuzm8s1ceuBUnMUAeoAHHw,1,0,0,0,0,0,1,0,1,0.14285714285714285,1,0.0,0,0,0,0,0,0,0,1,0,0,1,1
8336,143810,bACQsAWyyrjdiMPqSUjAzVKv7ajw33ro,SpATywNh6bZuzm8s1ceuBUnMUAeoAHHw,8,7,5,0,4,2,5,1,24,3.4285714285714284,1,0.0,0,5,0,4,7,2,0,5,1,9,15,1
8337,143814,65NT4Vy4CWsCo0yJt0Ser3pgvYWBcuzx,G8EPVSXsOYB5YQWZGiz1aVq5Pgr2GrQu,10,4,2,0,2,1,4,1,14,2.0,1,0.0,0,2,0,2,4,1,0,4,1,4,10,1
8338,143816,dmgKCClueSUfvNvbgn76P7yZNOrcqS51,SpATywNh6bZuzm8s1ceuBUnMUAeoAHHw,5,5,2,0,0,0,5,0,12,1.7142857142857142,1,0.0,0,2,0,0,5,0,0,5,0,2,10,1
8339,143826,vWKarVz9MLdkaeCnowC5zORVIjWhxnGT,A3fsA9Zfv1X2fVEQhTw51lKENdNrEqT3,41,17,11,56,8,1,10,1,104,14.857142857142858,1,0.0,4,11,49,8,13,1,7,10,1,72,32,1
8340,143827,icWbBG6yTFIZ32qTSFWaJeU4GOLom0j8,SpATywNh6bZuzm8s1ceuBUnMUAeoAHHw,12,12,8,0,3,6,12,2,43,6.142857142857143,2,0.0,0,8,0,3,12,6,0,12,2,11,32,1
8341,143828,e0M6WM1PijCu34LKse7mmvSD1YWuaWbQ,SpATywNh6bZuzm8s1ceuBUnMUAeoAHHw,13,10,1,5,1,1,6,1,25,3.5714285714285716,1,0.0,4,1,5,1,6,1,0,6,1,11,14,1
8342,143833,O8HOTucc0KEJXoqiM5XCMFFloSFDXkri,SpATywNh6bZuzm8s1ceuBUnMUAeoAHHw,10,8,3,0,2,0,6,0,19,2.7142857142857144,3,0.0,0,3,0,2,8,0,0,6,0,5,14,0
8343,143840,kuZwBvEdgeUtKZ495C2FptBbxEtLtmVH,bWdj2GDclj5ofokWjzoa5jAwMkxCykd6,6,14,5,0,1,0,6,0,26,3.7142857142857144,3,0.0,2,5,0,1,12,0,0,6,0,8,18,1
8344,143841,U9j28kbZjF4W0VB5A2yieyyacPtOxvwt,bWdj2GDclj5ofokWjzoa5jAwMkxCykd6,11,69,23,10,11,2,18,1,134,19.142857142857142,4,0.0,28,23,10,11,41,2,0,18,1,72,62,1
8345,143856,k5QrgarfuSQsGSVQQrcJTwJdAAKzf9gw,A3fsA9Zfv1X2fVEQhTw51lKENdNrEqT3,2,0,0,0,0,0,2,0,2,0.2857142857142857,1,0.0,0,0,0,0,0,0,0,2,0,0,2,1
8346,143858,uVezMKauDUYUFjTOlrwzQHcegaGFiPmr,A3fsA9Zfv1X2fVEQhTw51lKENdNrEqT3,7,5,1,0,1,0,4,0,11,1.5714285714285714,1,0.0,0,1,0,1,5,0,0,4,0,2,9,1
8347,143860,kMzMJEHy7fAHiNUZU0um3I2BsPC7gMll,SpATywNh6bZuzm8s1ceuBUnMUAeoAHHw,1,0,0,0,0,0,2,0,2,0.2857142857142857,2,0.0,0,0,0,0,0,0,0,2,0,0,2,1
8348,143863,cQR8w7MfHX2zVKP2ObrWt7YmSX4BnmzU,SpATywNh6bZuzm8s1ceuBUnMUAeoAHHw,5,3,2,0,0,0,2,0,7,1.0,1,0.0,0,2,0,0,3,0,0,2,0,2,5,1
8349,143864,RCdcltNaQLfcoxT7YKTjQxAYUbCmzzKd,bWdj2GDclj5ofokWjzoa5jAwMkxCykd6,9,13,9,0,8,2,5,0,37,5.285714285714286,2,0.0,3,9,0,8,10,2,0,5,0,20,17,1
8350,143865,wovmcysU3CVvWe03Rf3D2PLI3no54RS2,SpATywNh6bZuzm8s1ceuBUnMUAeoAHHw,5,2,1,0,1,0,3,0,7,1.0,1,0.0,0,1,0,1,2,0,0,3,0,2,5,1
8351,143866,cQR8w7MfHX2zVKP2ObrWt7YmSX4BnmzU,bWdj2GDclj5ofokWjzoa5jAwMkxCykd6,1,0,0,0,0,0,1,0,1,0.14285714285714285,1,0.0,0,0,0,0,0,0,0,1,0,0,1,1
8352,143867,Pnezq6slEV4CIBxIFIPqhlGLNILa8T8M,SpATywNh6bZuzm8s1ceuBUnMUAeoAHHw,24,33,7,20,3,4,6,0,73,10.428571428571429,4,0.0,8,7,18,3,25,4,2,6,0,36,37,0
8353,143880,zAobqpIInEgToh5g3mHxVZCEkz5XFqde,SpATywNh6bZuzm8s1ceuBUnMUAeoAHHw,10,23,1,18,0,0,3,0,45,6.428571428571429,2,0.0,13,1,17,0,10,0,1,3,0,31,14,1
8354,143881,g5rASgrCPlNIsJec3wFullHkMrOBGptd,SpATywNh6bZuzm8s1ceuBUnMUAeoAHHw,10,7,5,4,4,0,2,0,22,3.142857142857143,1,0.0,0,5,3,4,7,0,1,2,0,12,10,1
8355,143887,SKJH5bhXUHUXBV3YRjTcw0Oe5kVFAmnw,SpATywNh6bZuzm8s1ceuBUnMUAeoAHHw,5,5,2,0,2,0,3,0,12,1.7142857142857142,1,0.0,0,2,0,2,5,0,0,3,0,4,8,1
8356,143888,CdBS5mGJVzgaGDeY8NzEjALJKus99MGR,SpATywNh6bZuzm8s1ceuBUnMUAeoAHHw,17,40,10,16,4,8,15,0,93,13.285714285714286,3,0.0,6,10,14,4,34,8,2,15,0,34,59,1
8357,143891,UpT5KvhktZoGfL90nOmM9gx3GU38kT3j,bWdj2GDclj5ofokWjzoa5jAwMkxCykd6,17,14,1,38,3,11,11,1,79,11.285714285714286,3,0.0,5,1,33,3,9,11,5,11,1,42,37,0
8358,143897,BhOp2rSiJ2q2zT4ZZzNtPz6Fovfll5Yb,SpATywNh6bZuzm8s1ceuBUnMUAeoAHHw,12,8,5,1,3,0,7,2,26,3.7142857142857144,3,0.0,1,5,1,3,7,0,0,7,2,10,16,1
8359,143900,NWUbBzN3rFqJYQQKuHujeEDgr8fxabPr,SpATywNh6bZuzm8s1ceuBUnMUAeoAHHw,16,23,7,20,3,19,8,0,80,11.428571428571429,4,0.0,7,7,16,3,16,19,4,8,0,33,47,0
8360,143901,mvgC6breSmhPTVyyPyUMeu7XoIQqVA6J,bWdj2GDclj5ofokWjzoa5jAwMkxCykd6,1,0,0,0,0,0,1,0,1,0.14285714285714285,1,0.0,0,0,0,0,0,0,0,1,0,0,1,1
8361,143902,qDW8D89X9oTRJFDDcQZTLb3PUIxnDi04,bWdj2GDclj5ofokWjzoa5jAwMkxCykd6,5,2,1,0,1,0,2,0,6,0.8571428571428571,1,0.0,0,1,0,1,2,0,0,2,0,2,4,1
8362,143908,nwFT4lnmg30fCvHRB6tbALo9FpcanuLx,SpATywNh6bZuzm8s1ceuBUnMUAeoAHHw,10,11,1,0,1,0,10,0,23,3.2857142857142856,5,0.0,2,1,0,1,9,0,0,10,0,4,19,0
8363,143909,nwFT4lnmg30fCvHRB6tbALo9FpcanuLx,A3fsA9Zfv1X2fVEQhTw51lKENdNrEqT3,4,3,0,0,0,0,4,0,7,1.0,3,0.0,0,0,0,0,3,0,0,4,0,0,7,1
8364,143927,2WRiAgv5S6kcFPY2blVGjs9g0YNkJyLP,A3fsA9Zfv1X2fVEQhTw51lKENdNrEqT3,12,6,5,0,5,0,1,0,17,2.4285714285714284,1,0.0,0,5,0,5,6,0,0,1,0,10,7,1
8365,143933,Mi4V9PN04XHkOYjYbsNOyLc2HUiygd5R,SpATywNh6bZuzm8s1ceuBUnMUAeoAHHw,19,24,1,18,1,0,6,0,50,7.142857142857143,3,0.0,0,1,16,1,24,0,2,6,0,18,32,1
8366,143940,rMQIZQBxSTMFTRmvcfmpoYqCAUhMol3Y,A3fsA9Zfv1X2fVEQhTw51lKENdNrEqT3,11,11,2,0,2,0,3,0,18,2.5714285714285716,3,0.0,0,2,0,2,11,0,0,3,0,4,14,1
8367,143941,QZzKa5b6BbNwk1LIn6xlSQQLnIzRsZka,SpATywNh6bZuzm8s1ceuBUnMUAeoAHHw,13,15,0,16,0,2,14,3,50,7.142857142857143,3,0.0,2,0,14,0,13,2,2,14,3,16,34,1
8368,143945,U0EvfjsY5qqb8sRRReWuk6YqXYpCTRVc,SpATywNh6bZuzm8s1ceuBUnMUAeoAHHw,20,50,17,17,6,0,8,0,98,14.0,4,0.0,26,17,15,6,24,0,2,8,0,64,34,0
8369,143948,PM49kyPCpZaIfMyV0vVvEZLNApBiy9hl,G8EPVSXsOYB5YQWZGiz1aVq5Pgr2GrQu,18,16,11,22,3,4,29,7,92,13.142857142857142,2,0.0,0,11,17,3,16,4,5,29,7,31,61,0
8370,143956,BjRnjY2o7a3tMcpDhDIkBnAHWrC67ajb,bWdj2GDclj5ofokWjzoa5jAwMkxCykd6,11,13,1,30,4,0,1,0,49,7.0,1,0.0,8,1,28,4,5,0,2,1,0,41,8,1
8371,143959,qE4hwNlGPGhoA6O5q5uX2JQSuwb75VXN,SpATywNh6bZuzm8s1ceuBUnMUAeoAHHw,12,5,4,0,2,5,8,1,25,3.5714285714285716,2,0.0,0,4,0,2,5,5,0,8,1,6,19,1
8372,143964,J4CQZgZBlOmytRfPs9vqhW9gDDIzfvcP,SpATywNh6bZuzm8s1ceuBUnMUAeoAHHw,14,14,8,9,5,0,2,0,38,5.428571428571429,2,0.0,4,8,9,5,10,0,0,2,0,26,12,1
8373,143970,yepbpI2oB7GcEIjPPhcQSpqMxzy4YG1o,A3fsA9Zfv1X2fVEQhTw51lKENdNrEqT3,17,16,11,0,9,0,3,0,39,5.571428571428571,2,0.0,0,11,0,9,16,0,0,3,0,20,19,1
8374,143971,nVB1o73xluQXZjoI2dUYHGxbCDG8qiCL,SpATywNh6bZuzm8s1ceuBUnMUAeoAHHw,9,13,9,0,5,18,8,0,53,7.571428571428571,2,0.0,0,9,0,5,13,18,0,8,0,14,39,0
8375,143981,sNbuAEBvvCL9s1FspvGXLJVjQkFzxwpw,A3fsA9Zfv1X2fVEQhTw51lKENdNrEqT3,2,0,0,0,0,0,3,0,3,0.42857142857142855,2,0.0,0,0,0,0,0,0,0,3,0,0,3,1
8376,143982,4GJSwwikGuUWXSajcKoSlvfsoiC8eEZq,SpATywNh6bZuzm8s1ceuBUnMUAeoAHHw,8,11,2,0,1,0,3,0,17,2.4285714285714284,2,0.0,3,2,0,1,8,0,0,3,0,6,11,1
8377,144006,BNzSA1bHraXMmngTyyc8aHsRdjDVh5h7,bWdj2GDclj5ofokWjzoa5jAwMkxCykd6,6,0,0,0,0,1,7,1,9,1.2857142857142858,1,0.0,0,0,0,0,0,1,0,7,1,0,9,1
8378,144007,jSNLRK8jxSbbcqhbWW7DXZqoGlvGgXDY,SpATywNh6bZuzm8s1ceuBUnMUAeoAHHw,11,34,4,7,0,8,9,0,62,8.857142857142858,4,0.0,8,4,6,0,26,8,1,9,0,18,44,0
8379,144009,xbYSqp0T7Uu69VoCNyfTCvQcS3HV3UeU,A3fsA9Zfv1X2fVEQhTw51lKENdNrEqT3,6,13,7,0,0,10,6,0,36,5.142857142857143,3,0.0,1,7,0,0,12,10,0,6,0,8,28,1
8380,144012,tShEWwQUmNvdJJLgb6IWQwSvspfEXM5K,A3fsA9Zfv1X2fVEQhTw51lKENdNrEqT3,4,2,1,0,1,0,1,0,5,0.7142857142857143,1,0.0,0,1,0,1,2,0,0,1,0,2,3,1
8381,144016,pV3LNiRBcnB0okGlxsutPlVeupVbHeL3,SpATywNh6bZuzm8s1ceuBUnMUAeoAHHw,6,3,2,0,1,0,2,0,8,1.1428571428571428,1,0.0,0,2,0,1,3,0,0,2,0,3,5,1
8382,144037,nCjvWGBuFy5INkXPz8A7SRdydYBldjvQ,SpATywNh6bZuzm8s1ceuBUnMUAeoAHHw,4,2,0,0,0,0,2,0,4,0.5714285714285714,1,0.0,0,0,0,0,2,0,0,2,0,0,4,1
8383,144041,oqyavd6F0mKguMPCfvp0hDFA1MAPWGfD,SpATywNh6bZuzm8s1ceuBUnMUAeoAHHw,13,18,8,17,6,0,1,0,50,7.142857142857143,2,0.0,8,8,14,6,10,0,3,1,0,36,14,0
8384,144045,X6wKs7o7iaOCvuOiKVJE8ObJhZymqim9,A3fsA9Zfv1X2fVEQhTw51lKENdNrEqT3,2,0,0,0,0,0,2,0,2,0.2857142857142857,1,0.0,0,0,0,0,0,0,0,2,0,0,2,1
8385,144054,3gXxAS6JQyT6kaPyX2q9IFEYv8Hv4qpf,SpATywNh6bZuzm8s1ceuBUnMUAeoAHHw,1,0,0,0,0,0,2,0,2,0.2857142857142857,1,0.0,0,0,0,0,0,0,0,2,0,0,2,1
8386,144058,JaYbgvhgx43SysY9J8DaCR3IcdUzCcUf,A3fsA9Zfv1X2fVEQhTw51lKENdNrEqT3,14,26,2,0,2,0,4,0,34,4.857142857142857,3,0.0,0,2,0,2,26,0,0,4,0,4,30,1
8387,144068,lWBDQVwIQrjtFGVOoBxPlW4CU3O2tpal,bWdj2GDclj5ofokWjzoa5jAwMkxCykd6,6,10,3,0,5,0,2,0,20,2.857142857142857,1,0.0,6,3,0,5,4,0,0,2,0,14,6,0
8388,144071,N3PF6286hfkTToYfzWd10OYG6jiYeyxL,A3fsA9Zfv1X2fVEQhTw51lKENdNrEqT3,28,15,6,76,3,2,7,0,109,15.571428571428571,2,0.0,4,6,65,3,11,2,11,7,0,78,31,1
8389,144073,J308vOrLkdYqLmDeq0FXdJXMsr1GuQ4w,SpATywNh6bZuzm8s1ceuBUnMUAeoAHHw,6,4,2,0,1,0,2,0,9,1.2857142857142858,1,0.0,0,2,0,1,4,0,0,2,0,3,6,1
8390,144076,M8cV3FHZsXmaSmJz43zOWXbhj6ecftQ6,A3fsA9Zfv1X2fVEQhTw51lKENdNrEqT3,1,0,0,0,0,0,1,0,1,0.14285714285714285,1,0.0,0,0,0,0,0,0,0,1,0,0,1,1
8391,144079,0MJO2AqnpIZ1IQnC9vPe2n4pS7b47XJt,bWdj2GDclj5ofokWjzoa5jAwMkxCykd6,5,10,8,0,6,0,2,0,26,3.7142857142857144,3,0.0,0,8,0,6,10,0,0,2,0,14,12,1
8392,144084,oM7kzBqhrhvKM9TULmlTbBtomZs2uMAz,bWdj2GDclj5ofokWjzoa5jAwMkxCykd6,7,7,1,0,1,0,3,0,12,1.7142857142857142,1,0.0,1,1,0,1,6,0,0,3,0,3,9,1
8393,144093,xOQ7AnZhBVXWatzUYsH22obdE4ihFc1J,bWdj2GDclj5ofokWjzoa5jAwMkxCykd6,6,11,4,0,2,0,5,0,22,3.142857142857143,2,0.0,4,4,0,2,7,0,0,5,0,10,12,1
8394,144104,8wj2Kr145taRtViYKZRdPMwAZeP9BDRs,A3fsA9Zfv1X2fVEQhTw51lKENdNrEqT3,10,9,1,0,1,0,4,0,15,2.142857142857143,2,0.0,0,1,0,1,9,0,0,4,0,2,13,1
8395,144107,QR8UITZg856bsXeO3qqb9HBw7LvT4WYt,G8EPVSXsOYB5YQWZGiz1aVq5Pgr2GrQu,14,15,2,6,2,1,7,1,34,4.857142857142857,1,0.0,6,2,5,2,9,1,1,7,1,15,19,1
8396,144112,A41hdT15T7mumzDW53QCDXRUsOilvTI0,A3fsA9Zfv1X2fVEQhTw51lKENdNrEqT3,9,8,5,0,3,0,5,0,21,3.0,2,0.0,0,5,0,3,8,0,0,5,0,8,13,0
8397,144120,rqoGLMWp7ee8Ppu4OdHSBl6vmRxDZvKU,A3fsA9Zfv1X2fVEQhTw51lKENdNrEqT3,7,8,2,0,2,0,1,0,13,1.8571428571428572,2,0.0,0,2,0,2,8,0,0,1,0,4,9,1
8398,144140,5F9PaqbFd1lCE07rWZ8QBm5IEOOVBjgP,G8EPVSXsOYB5YQWZGiz1aVq5Pgr2GrQu,48,16,13,96,10,0,5,0,140,20.0,1,0.0,1,13,75,10,15,0,21,5,0,99,41,1
8399,144144,IXIS4Shtcigf6RcvylwWobSKfmofV0Nt,SpATywNh6bZuzm8s1ceuBUnMUAeoAHHw,6,6,3,0,1,0,3,0,13,1.8571428571428572,2,0.0,0,3,0,1,6,0,0,3,0,4,9,1
8400,144158,LfOTQoQ2fSLvFDTNyvPm8DKwqfdrfE91,SpATywNh6bZuzm8s1ceuBUnMUAeoAHHw,17,20,10,6,5,0,4,1,46,6.571428571428571,1,0.0,8,10,6,5,12,0,0,4,1,29,17,1
8401,144159,vSPx0Rg8IfOWpaATb7kkPj0mZPaLkdwk,A3fsA9Zfv1X2fVEQhTw51lKENdNrEqT3,7,7,0,0,0,0,5,0,12,1.7142857142857142,1,0.0,0,0,0,0,7,0,0,5,0,0,12,1
8402,144162,vSPx0Rg8IfOWpaATb7kkPj0mZPaLkdwk,bWdj2GDclj5ofokWjzoa5jAwMkxCykd6,6,6,2,0,3,0,2,0,13,1.8571428571428572,1,0.0,2,2,0,3,4,0,0,2,0,7,6,1
8403,144163,Mi04UWZgqcHrMSZckQSYxOftI8OPYCzT,G8EPVSXsOYB5YQWZGiz1aVq5Pgr2GrQu,10,6,1,0,1,6,6,0,20,2.857142857142857,1,0.0,0,1,0,1,6,6,0,6,0,2,18,0
8404,144168,TTLR6K3ZlbSrGOfX2kjd2U4ChldGiopU,A3fsA9Zfv1X2fVEQhTw51lKENdNrEqT3,9,25,0,0,0,0,4,0,29,4.142857142857143,2,0.0,1,0,0,0,24,0,0,4,0,1,28,1
8405,144172,mSs5bB1Rxg3xYWjWjJY9pVTt7WAiMgyu,G8EPVSXsOYB5YQWZGiz1aVq5Pgr2GrQu,1,0,0,0,0,0,3,0,3,0.42857142857142855,2,0.0,0,0,0,0,0,0,0,3,0,0,3,0
8406,144173,mSs5bB1Rxg3xYWjWjJY9pVTt7WAiMgyu,A3fsA9Zfv1X2fVEQhTw51lKENdNrEqT3,5,3,2,0,2,2,7,0,16,2.2857142857142856,1,0.0,0,2,0,2,3,2,0,7,0,4,12,0
8407,144177,vang2CBp79w46FuP8PHdcPzohOKhBOq7,SpATywNh6bZuzm8s1ceuBUnMUAeoAHHw,8,3,2,0,2,0,3,0,10,1.4285714285714286,2,0.0,0,2,0,2,3,0,0,3,0,4,6,1
8408,144182,vaHtIA00RCulwKK7VIyzWyzyLmevfcyF,RXDvfPUBYFlVdlueBFbLW0mhhAyGEqpt,1,0,0,0,0,0,1,0,1,0.14285714285714285,1,0.0,0,0,0,0,0,0,0,1,0,0,1,1
8409,144190,lxaN8cMu58kiTAIgLqzjn8LLROF5HL13,SpATywNh6bZuzm8s1ceuBUnMUAeoAHHw,1,0,0,0,0,0,2,0,2,0.2857142857142857,2,0.0,0,0,0,0,0,0,0,2,0,0,2,1
8410,144195,TLRNemgJ2qb9k6dqDLHmoeJOx0QEylHX,A3fsA9Zfv1X2fVEQhTw51lKENdNrEqT3,7,3,2,0,2,0,4,0,11,1.5714285714285714,1,0.0,0,2,0,2,3,0,0,4,0,4,7,1
8411,144201,qz846pl1l6yGERGHSFYtB9X4bZxpZ3Ym,SpATywNh6bZuzm8s1ceuBUnMUAeoAHHw,4,2,1,0,1,0,1,0,5,0.7142857142857143,1,0.0,0,1,0,1,2,0,0,1,0,2,3,1
8412,144203,Dd8BaN0Npmwg2omUrerhRcBJi9Zv0QF5,G8EPVSXsOYB5YQWZGiz1aVq5Pgr2GrQu,22,27,16,34,8,1,16,1,103,14.714285714285714,3,0.0,0,16,30,8,27,1,4,16,1,54,49,0
8413,144208,7fciuEa5Xf2g36Xi6ZmKVyrNCJiVORwj,G8EPVSXsOYB5YQWZGiz1aVq5Pgr2GrQu,1,0,0,0,0,0,1,0,1,0.14285714285714285,1,0.0,0,0,0,0,0,0,0,1,0,0,1,1
8414,144209,7fciuEa5Xf2g36Xi6ZmKVyrNCJiVORwj,RXDvfPUBYFlVdlueBFbLW0mhhAyGEqpt,1,0,0,0,0,0,1,0,1,0.14285714285714285,1,0.0,0,0,0,0,0,0,0,1,0,0,1,1
8415,144212,vIAdh2clW8FkvdVniXHQiMyPfgIo07gQ,SpATywNh6bZuzm8s1ceuBUnMUAeoAHHw,4,0,0,0,0,0,3,1,4,0.5714285714285714,1,0.0,0,0,0,0,0,0,0,3,1,0,4,1
8416,144213,P89UxuMs18mdXj4DGhJJSZRF8BUJV2uZ,A3fsA9Zfv1X2fVEQhTw51lKENdNrEqT3,34,13,11,40,10,0,4,0,78,11.142857142857142,2,0.0,1,11,36,10,12,0,4,4,0,58,20,1
8417,144222,s2jX5TZHNhVfY48YU4SNM5eF0Y5PZev6,SpATywNh6bZuzm8s1ceuBUnMUAeoAHHw,5,2,1,0,1,0,2,0,6,0.8571428571428571,1,0.0,0,1,0,1,2,0,0,2,0,2,4,1
8418,144223,lnkkWGyIr1b44KiKgAFL6qVeebRfNJt3,SpATywNh6bZuzm8s1ceuBUnMUAeoAHHw,5,2,1,0,1,0,2,0,6,0.8571428571428571,1,0.0,0,1,0,1,2,0,0,2,0,2,4,1
8419,144237,YCrhaujUJb2ysdJEAlnTFggfP634EwtZ,bWdj2GDclj5ofokWjzoa5jAwMkxCykd6,1,0,0,0,0,0,1,0,1,0.14285714285714285,1,0.0,0,0,0,0,0,0,0,1,0,0,1,1
8420,144240,BPLF5bOPHidVrP3JGHCr9npCCCPEhz1g,SpATywNh6bZuzm8s1ceuBUnMUAeoAHHw,17,50,16,20,6,6,19,2,119,17.0,3,0.0,27,16,18,6,23,6,2,19,2,67,52,1
8421,144244,y3GJh8xEC6iboTvFOS91chZLMqYyEapH,G8EPVSXsOYB5YQWZGiz1aVq5Pgr2GrQu,16,20,3,0,3,1,8,2,37,5.285714285714286,3,0.0,6,3,0,3,14,1,0,8,2,12,25,1
8422,144259,PGj1B7s4Yw1PBLMA6crSiWk0Zk66XU5n,SpATywNh6bZuzm8s1ceuBUnMUAeoAHHw,1,0,0,0,0,0,1,0,1,0.14285714285714285,1,0.0,0,0,0,0,0,0,0,1,0,0,1,1
8423,144260,NxRna5VYeAvwKdtdFMhqdPkmD703DSHi,SpATywNh6bZuzm8s1ceuBUnMUAeoAHHw,17,37,17,18,6,13,14,0,105,15.0,4,0.0,10,17,16,6,27,13,2,14,0,49,56,1
8424,144290,QX3ApvDJvO9Hor69Bz89tLVK3rkHTGIJ,SpATywNh6bZuzm8s1ceuBUnMUAeoAHHw,2,0,0,0,0,0,2,0,2,0.2857142857142857,1,0.0,0,0,0,0,0,0,0,2,0,0,2,1
8425,144292,ObRNFdACerskEaO6OwPXBsUqKEYRJtIa,SpATywNh6bZuzm8s1ceuBUnMUAeoAHHw,7,3,2,0,2,0,2,0,9,1.2857142857142858,1,0.0,0,2,0,2,3,0,0,2,0,4,5,1
8426,144302,pWZNevyPOl4ouTcnYPIT4PYWT7cW7Aq7,SpATywNh6bZuzm8s1ceuBUnMUAeoAHHw,1,0,0,0,0,0,1,0,1,0.14285714285714285,1,0.0,0,0,0,0,0,0,0,1,0,0,1,1
8427,144315,8lCrBaMkcXk8KsL7M8AYgjnsyFuSP4yK,A3fsA9Zfv1X2fVEQhTw51lKENdNrEqT3,18,18,16,0,16,0,1,0,51,7.285714285714286,1,0.0,0,16,0,16,18,0,0,1,0,32,19,1
8428,144325,IKQYwh1PoPanPyuEqIIRzDtzc0tOUD2x,SpATywNh6bZuzm8s1ceuBUnMUAeoAHHw,15,25,4,15,0,1,21,1,67,9.571428571428571,6,0.0,5,4,12,0,20,1,3,21,1,21,46,0
8429,144327,SKemaavr5OG5spO92jXls0zhTMuWKDja,A3fsA9Zfv1X2fVEQhTw51lKENdNrEqT3,38,44,23,36,10,0,8,2,123,17.571428571428573,4,0.0,3,23,36,10,41,0,0,8,2,72,51,1
8430,144331,G4MfAXnz0EbVaCbavnksnUIxHSPSMOp9,SpATywNh6bZuzm8s1ceuBUnMUAeoAHHw,7,7,1,0,1,0,2,0,11,1.5714285714285714,2,0.0,0,1,0,1,7,0,0,2,0,2,9,0
8431,144349,0Xxh6UWDrWwPPLaMpUv0ZEdnE00mPUSR,A3fsA9Zfv1X2fVEQhTw51lKENdNrEqT3,4,4,0,0,0,0,4,0,8,1.1428571428571428,2,0.0,0,0,0,0,4,0,0,4,0,0,8,0
8432,144357,Ie7mkAUCVVaLYxvosre748ADQJqirOJg,SpATywNh6bZuzm8s1ceuBUnMUAeoAHHw,6,3,1,0,1,0,2,0,7,1.0,1,0.0,0,1,0,1,3,0,0,2,0,2,5,1
8433,144363,svmQRfMWV47ki33Dy8s4c1zTDx5xyqqy,SpATywNh6bZuzm8s1ceuBUnMUAeoAHHw,22,27,0,29,0,1,5,0,62,8.857142857142858,2,0.0,9,0,26,0,18,1,3,5,0,35,27,1
8434,144370,BdodnRCsey53xS6PtugKwlzojwI7pwLX,bWdj2GDclj5ofokWjzoa5jAwMkxCykd6,5,2,1,0,1,0,2,0,6,0.8571428571428571,1,0.0,0,1,0,1,2,0,0,2,0,2,4,0
8435,144381,fcKXv9ZhNMmLocipK5ZZiRQ1LDYoPfgB,G8EPVSXsOYB5YQWZGiz1aVq5Pgr2GrQu,10,5,4,0,4,0,3,1,17,2.4285714285714284,2,0.0,0,4,0,4,5,0,0,3,1,8,9,1
8436,144387,sxauqKQQUFpXy4JZb43frlkE4bOqyCWY,G8EPVSXsOYB5YQWZGiz1aVq5Pgr2GrQu,9,5,3,0,2,0,8,0,18,2.5714285714285716,1,0.0,0,3,0,2,5,0,0,8,0,5,13,1
8437,144395,o8axHOLhofevJLu5TvKmRFieQionk0uo,bWdj2GDclj5ofokWjzoa5jAwMkxCykd6,6,10,1,0,2,0,3,0,16,2.2857142857142856,2,0.0,0,1,0,2,10,0,0,3,0,3,13,1
8438,144401,4xrSOv0Zb9s9Mfulum5aoHlVB6c6SKgp,RXDvfPUBYFlVdlueBFbLW0mhhAyGEqpt,24,21,6,37,9,5,13,5,96,13.714285714285714,3,0.0,9,6,32,9,12,5,5,13,5,56,40,1
8439,144405,m0LuTHIjrSW3BF8YSCNgkHg0UqSBwWqE,bWdj2GDclj5ofokWjzoa5jAwMkxCykd6,7,23,6,0,5,0,7,0,41,5.857142857142857,3,0.0,6,6,0,5,17,0,0,7,0,17,24,1
8440,144413,SG7N8DhpCuhIu06IIzLX0CSolbyIDsIx,bWdj2GDclj5ofokWjzoa5jAwMkxCykd6,11,11,5,0,2,1,10,1,30,4.285714285714286,4,0.0,1,5,0,2,10,1,0,10,1,8,22,1
8441,144415,6ElmeAobgOVWMQKbfyTe96fhVbG33C2X,SpATywNh6bZuzm8s1ceuBUnMUAeoAHHw,1,0,0,0,0,0,2,0,2,0.2857142857142857,2,0.0,0,0,0,0,0,0,0,2,0,0,2,1
8442,144420,yntRyPnV06sPev3xKXJHMzKiUHpX97Sd,bWdj2GDclj5ofokWjzoa5jAwMkxCykd6,4,3,1,0,0,0,4,0,8,1.1428571428571428,1,0.0,0,1,0,0,3,0,0,4,0,1,7,1
8443,144425,cDfX3cMJgUCBkullLQDAvI97VlFeM2Mm,SpATywNh6bZuzm8s1ceuBUnMUAeoAHHw,1,0,0,0,0,0,1,0,1,0.14285714285714285,1,0.0,0,0,0,0,0,0,0,1,0,0,1,1
8444,144427,tVItbLut2hv4GIKzxM0DVZ7s3PzDPaT6,A3fsA9Zfv1X2fVEQhTw51lKENdNrEqT3,1,0,0,0,0,0,1,0,1,0.14285714285714285,1,0.0,0,0,0,0,0,0,0,1,0,0,1,1
8445,144430,04LxEQ3nhSzj7dXc7lrpbpcFvVUWGlZI,SpATywNh6bZuzm8s1ceuBUnMUAeoAHHw,16,17,9,18,4,4,10,1,63,9.0,2,0.0,4,9,15,4,13,4,3,10,1,32,31,0
8446,144435,v8vHTBb2c8b6hXbbCm3oZZxhG00wE2vP,SpATywNh6bZuzm8s1ceuBUnMUAeoAHHw,14,14,0,15,0,0,8,0,37,5.285714285714286,2,0.0,5,0,14,0,9,0,1,8,0,19,18,1
8447,144441,SSjG9q1bzvgdf9EkFqx8YjsCqQBg1XFt,A3fsA9Zfv1X2fVEQhTw51lKENdNrEqT3,21,12,9,0,7,0,8,1,37,5.285714285714286,2,0.0,0,9,0,7,12,0,0,8,1,16,21,0
8448,144464,lZNtuG4kxIFp0PJuciNw1EckZr8BFEk1,G8EPVSXsOYB5YQWZGiz1aVq5Pgr2GrQu,9,8,3,0,3,0,2,0,16,2.2857142857142856,1,0.0,4,3,0,3,4,0,0,2,0,10,6,1
8449,144468,mU6A1Eh1Sbu4ybvtOk62E6H19PAtCNgh,SpATywNh6bZuzm8s1ceuBUnMUAeoAHHw,29,40,22,31,8,4,23,2,130,18.571428571428573,6,0.0,8,22,25,8,32,4,6,23,2,63,67,1
8450,144470,3DA03ejzzYcn7ZLRW08jG2ITijpoufwN,G8EPVSXsOYB5YQWZGiz1aVq5Pgr2GrQu,12,17,1,6,1,0,4,1,30,4.285714285714286,1,0.0,7,1,3,1,10,0,3,4,1,12,18,1
8451,144475,JyrEAC8QBM1FImevyuACZ1OHrDsTde69,G8EPVSXsOYB5YQWZGiz1aVq5Pgr2GrQu,5,3,1,0,1,0,1,0,6,0.8571428571428571,1,0.0,0,1,0,1,3,0,0,1,0,2,4,1
8452,144476,uCAoWg5FaKwY0ioNKZmmoCVVstQhRxsa,SpATywNh6bZuzm8s1ceuBUnMUAeoAHHw,6,2,1,0,1,2,6,2,14,2.0,1,0.0,0,1,0,1,2,2,0,6,2,2,12,1
8453,144477,Lrv4yyy1oRPtpNW8S56NcLTs3dActQgc,SpATywNh6bZuzm8s1ceuBUnMUAeoAHHw,10,3,2,0,2,14,5,4,30,4.285714285714286,1,0.0,0,2,0,2,3,14,0,5,4,4,26,1
8454,144479,85biSqbQ9pgTGTSoZq3mDHUWbBBUYgJi,SpATywNh6bZuzm8s1ceuBUnMUAeoAHHw,16,21,11,12,7,5,7,0,63,9.0,2,0.0,8,11,11,7,13,5,1,7,0,37,26,0
8455,144491,liAQef8wjw79hEo9eOQyUXxysuTaQycU,A3fsA9Zfv1X2fVEQhTw51lKENdNrEqT3,2,0,0,0,0,0,2,0,2,0.2857142857142857,1,0.0,0,0,0,0,0,0,0,2,0,0,2,1
8456,144501,rFLQgLWbBhSut44kCW6TkgnVsL5AzEC5,SpATywNh6bZuzm8s1ceuBUnMUAeoAHHw,11,9,3,0,3,0,2,0,17,2.4285714285714284,2,0.0,0,3,0,3,9,0,0,2,0,6,11,1
8457,144506,bEN4cDdCBNI6z1gBK5oUDg5Tkh0maAFl,SpATywNh6bZuzm8s1ceuBUnMUAeoAHHw,9,6,5,0,3,0,2,0,16,2.2857142857142856,1,0.0,0,5,0,3,6,0,0,2,0,8,8,1
8458,144513,CDMI3gQZrAOAZ9Cf4jB5NzA4daPYwjjn,SpATywNh6bZuzm8s1ceuBUnMUAeoAHHw,1,0,0,0,0,0,1,0,1,0.14285714285714285,1,0.0,0,0,0,0,0,0,0,1,0,0,1,1
8459,144521,uCAoWg5FaKwY0ioNKZmmoCVVstQhRxsa,G8EPVSXsOYB5YQWZGiz1aVq5Pgr2GrQu,2,0,0,0,0,0,2,0,2,0.2857142857142857,1,0.0,0,0,0,0,0,0,0,2,0,0,2,1
8460,144526,9lksmcPg7FQE2FGQIA9VvWum1Z9DYrHM,G8EPVSXsOYB5YQWZGiz1aVq5Pgr2GrQu,1,0,0,0,0,0,1,0,1,0.14285714285714285,1,0.0,0,0,0,0,0,0,0,1,0,0,1,1
8461,144527,V76hQrNxMwZx40IX3yjuclMj7tgBsXTX,G8EPVSXsOYB5YQWZGiz1aVq5Pgr2GrQu,2,0,0,0,0,0,2,0,2,0.2857142857142857,1,0.0,0,0,0,0,0,0,0,2,0,0,2,1
8462,144536,393Iwr9LCShShn3ZP9MDE1iyGNI2KLnH,A3fsA9Zfv1X2fVEQhTw51lKENdNrEqT3,13,7,4,0,3,0,6,1,21,3.0,1,0.0,0,4,0,3,7,0,0,6,1,7,14,1
8463,144568,oBzLCci1yorqxivOBJW1dKnQofqyR5pw,A3fsA9Zfv1X2fVEQhTw51lKENdNrEqT3,2,0,0,0,0,0,2,0,2,0.2857142857142857,1,0.0,0,0,0,0,0,0,0,2,0,0,2,1
8464,144578,OUsTbnD6QZatQvggR5YjMxWOH6TYQEkw,SpATywNh6bZuzm8s1ceuBUnMUAeoAHHw,10,8,4,0,4,1,5,2,24,3.4285714285714284,3,0.0,0,4,0,4,8,1,0,5,2,8,16,1
8465,144590,aiKrSmMzCgtO0agHJchvzxr28vyUxQZz,G8EPVSXsOYB5YQWZGiz1aVq5Pgr2GrQu,8,3,2,0,2,0,3,1,11,1.5714285714285714,1,0.0,0,2,0,2,3,0,0,3,1,4,7,1
8466,144593,K938KGiMd2B4Ec49syEZjpINF1qucFfC,A3fsA9Zfv1X2fVEQhTw51lKENdNrEqT3,6,3,2,0,2,0,2,0,9,1.2857142857142858,1,0.0,0,2,0,2,3,0,0,2,0,4,5,1
8467,144599,KkSinTdG2PbGrJIRATMZos8HES46UawO,SpATywNh6bZuzm8s1ceuBUnMUAeoAHHw,5,3,1,0,1,0,2,0,7,1.0,2,0.0,0,1,0,1,3,0,0,2,0,2,5,1
8468,144600,9loONblFsvKeToe2mgBZCeASeNdXOJTu,A3fsA9Zfv1X2fVEQhTw51lKENdNrEqT3,1,0,0,0,0,0,1,0,1,0.14285714285714285,1,0.0,0,0,0,0,0,0,0,1,0,0,1,1
8469,144604,5ehf4EFN8WhDbvmb2WvfZwpaBD0cj1oj,A3fsA9Zfv1X2fVEQhTw51lKENdNrEqT3,31,22,3,48,1,0,6,0,80,11.428571428571429,1,0.0,6,3,47,1,16,0,1,6,0,57,23,1
8470,144606,AeCrxYByugIwu4XUBpI0LhoTguBozLAa,SpATywNh6bZuzm8s1ceuBUnMUAeoAHHw,18,36,17,15,9,1,19,1,98,14.0,3,0.0,3,17,14,9,33,1,1,19,1,43,55,1
8471,144610,6oCDtYWE1YbVTX7pVBS5Cflb4KyRNNI9,bWdj2GDclj5ofokWjzoa5jAwMkxCykd6,7,2,0,0,0,1,7,1,11,1.5714285714285714,1,0.0,0,0,0,0,2,1,0,7,1,0,11,1
8472,144633,qpV3C2IZjB1ICwVxeuRFosLbHBid3MJt,A3fsA9Zfv1X2fVEQhTw51lKENdNrEqT3,22,14,10,0,8,1,6,1,40,5.714285714285714,1,0.0,2,10,0,8,12,1,0,6,1,20,20,1
8473,144638,PUdcV8hfT4fAKFK5ZdHY1Ahxf6WKmDC8,A3fsA9Zfv1X2fVEQhTw51lKENdNrEqT3,6,5,2,0,2,0,1,0,10,1.4285714285714286,1,0.0,0,2,0,2,5,0,0,1,0,4,6,1
8474,144639,VY7imgBCSjRZotznUQIcU9HEMteCD7Vu,SpATywNh6bZuzm8s1ceuBUnMUAeoAHHw,8,3,1,0,1,1,5,0,11,1.5714285714285714,2,0.0,0,1,0,1,3,1,0,5,0,2,9,1
8475,144642,9qlyY7aaGl7nuKeZpypgQ9ZpHmFszatV,A3fsA9Zfv1X2fVEQhTw51lKENdNrEqT3,44,24,17,62,14,1,10,1,129,18.428571428571427,2,0.0,3,17,53,14,21,1,9,10,1,87,42,1
8476,144648,2LaA70mUgBYc8D3OKr2EYK4J2QrpGRxB,A3fsA9Zfv1X2fVEQhTw51lKENdNrEqT3,30,9,6,54,4,0,4,0,77,11.0,2,0.0,2,6,48,4,7,0,6,4,0,60,17,1
8477,144650,nv8B6ZD44hAnu4T6PFDyOO5rZhYIZjTq,SpATywNh6bZuzm8s1ceuBUnMUAeoAHHw,8,10,2,0,2,0,6,0,20,2.857142857142857,3,0.0,0,2,0,2,10,0,0,6,0,4,16,1
8478,144659,ObnmYfTIiUEvUBHUZwAwe98p78F42lKP,SpATywNh6bZuzm8s1ceuBUnMUAeoAHHw,11,23,1,17,0,0,1,0,42,6.0,1,0.0,13,1,15,0,10,0,2,1,0,29,13,0
8479,144661,K1P5HkkD06S9UwpMzKhPLUcedpL6qD5q,G8EPVSXsOYB5YQWZGiz1aVq5Pgr2GrQu,1,0,0,0,0,0,1,0,1,0.14285714285714285,1,0.0,0,0,0,0,0,0,0,1,0,0,1,1
8480,144664,ZZTvad4Qf03uG7FsvH1m57TKBNy8UI9m,SpATywNh6bZuzm8s1ceuBUnMUAeoAHHw,6,5,2,0,1,0,5,0,13,1.8571428571428572,2,0.0,2,2,0,1,3,0,0,5,0,5,8,1
8481,144667,uk1SKekwkpaHXYRLjN8ZintRuJ2tncOb,SpATywNh6bZuzm8s1ceuBUnMUAeoAHHw,8,8,0,0,0,0,3,0,11,1.5714285714285714,1,0.0,2,0,0,0,6,0,0,3,0,2,9,0
8482,144669,IX7RiRPOSUbuV2fcXoS0ynYb5Bmt0H4j,G8EPVSXsOYB5YQWZGiz1aVq5Pgr2GrQu,13,8,2,16,2,2,6,1,37,5.285714285714286,1,0.0,5,2,13,2,3,2,3,6,1,22,15,0
8483,144671,2LaA70mUgBYc8D3OKr2EYK4J2QrpGRxB,bWdj2GDclj5ofokWjzoa5jAwMkxCykd6,8,5,3,0,2,0,8,0,18,2.5714285714285716,2,0.0,0,3,0,2,5,0,0,8,0,5,13,1
8484,144683,qpL2vcjziNlnSRSNpZZmRQfFObDSNaQD,A3fsA9Zfv1X2fVEQhTw51lKENdNrEqT3,2,0,0,0,0,0,2,0,2,0.2857142857142857,1,0.0,0,0,0,0,0,0,0,2,0,0,2,1
8485,144686,mp93D5T5EosRPeX8VQcgmycIpnu3UAVQ,SpATywNh6bZuzm8s1ceuBUnMUAeoAHHw,10,6,4,0,3,0,3,0,16,2.2857142857142856,1,0.0,0,4,0,3,6,0,0,3,0,7,9,1
8486,144695,BWZzwZgEWlPhZ8O1NZ0qWUnIi8M3MM7E,RXDvfPUBYFlVdlueBFbLW0mhhAyGEqpt,2,0,0,0,0,0,2,0,2,0.2857142857142857,1,0.0,0,0,0,0,0,0,0,2,0,0,2,1
8487,144700,SgWqRh3XmeJpz6RfUb8yXu2ZkH0AleuJ,A3fsA9Zfv1X2fVEQhTw51lKENdNrEqT3,1,0,0,0,0,0,1,0,1,0.14285714285714285,1,0.0,0,0,0,0,0,0,0,1,0,0,1,1
8488,144702,Edq6Echk8wEs8ShX5RBw5c8Yx8ANHVje,SpATywNh6bZuzm8s1ceuBUnMUAeoAHHw,4,2,0,0,0,0,3,0,5,0.7142857142857143,2,0.0,0,0,0,0,2,0,0,3,0,0,5,1
8489,144703,Edq6Echk8wEs8ShX5RBw5c8Yx8ANHVje,A3fsA9Zfv1X2fVEQhTw51lKENdNrEqT3,5,3,0,0,0,0,2,0,5,0.7142857142857143,1,0.0,0,0,0,0,3,0,0,2,0,0,5,1
8490,144708,Edq6Echk8wEs8ShX5RBw5c8Yx8ANHVje,G8EPVSXsOYB5YQWZGiz1aVq5Pgr2GrQu,5,2,1,0,1,0,3,0,7,1.0,2,0.0,0,1,0,1,2,0,0,3,0,2,5,1
8491,144709,Edq6Echk8wEs8ShX5RBw5c8Yx8ANHVje,RXDvfPUBYFlVdlueBFbLW0mhhAyGEqpt,5,3,0,0,0,0,3,0,6,0.8571428571428571,2,0.0,0,0,0,0,3,0,0,3,0,0,6,1
8492,144711,5W6zUlMsjNEU65Ree05lYmcDiOLewtR2,A3fsA9Zfv1X2fVEQhTw51lKENdNrEqT3,13,14,0,0,0,0,4,0,18,2.5714285714285716,2,0.0,0,0,0,0,14,0,0,4,0,0,18,1
8493,144722,0PHNMn5JYsQigYaNxUJgIv4qow2cWlQK,A3fsA9Zfv1X2fVEQhTw51lKENdNrEqT3,2,0,0,0,0,0,2,0,2,0.2857142857142857,1,0.0,0,0,0,0,0,0,0,2,0,0,2,1
8494,144723,TkLeStjoXAMG5nRKUJ5tMauLM6wlBb8U,SpATywNh6bZuzm8s1ceuBUnMUAeoAHHw,16,13,5,16,3,0,4,0,41,5.857142857142857,1,0.0,6,5,14,3,7,0,2,4,0,28,13,1
8495,144729,Myt16IMVzxwRTOZLb6UMMq0vewiso7Vm,SpATywNh6bZuzm8s1ceuBUnMUAeoAHHw,15,27,1,12,1,8,9,2,60,8.571428571428571,3,0.0,15,1,9,1,12,8,3,9,2,26,34,1
8496,144733,X7TtqcEziDolV47iXb7vXuzoIflttREX,A3fsA9Zfv1X2fVEQhTw51lKENdNrEqT3,2,0,0,0,0,0,2,0,2,0.2857142857142857,1,0.0,0,0,0,0,0,0,0,2,0,0,2,1
8497,144739,i3sBPnecqsJtCmiHMtv0ri41qFT4LGFd,SpATywNh6bZuzm8s1ceuBUnMUAeoAHHw,1,0,0,0,0,0,1,0,1,0.14285714285714285,1,0.0,0,0,0,0,0,0,0,1,0,0,1,1
8498,144750,CWRrmCimMLwDXZTgPsiO3B49woTmmP7J,SpATywNh6bZuzm8s1ceuBUnMUAeoAHHw,4,3,0,0,0,0,2,0,5,0.7142857142857143,1,0.0,0,0,0,0,3,0,0,2,0,0,5,1
8499,144755,0eMlSFoZScU7zUCIgAM0BWfQh50FQz3i,RXDvfPUBYFlVdlueBFbLW0mhhAyGEqpt,22,18,15,10,9,1,2,0,55,7.857142857142857,3,0.0,1,15,8,9,17,1,2,2,0,33,22,1
8500,144758,iEsrSdCjyin4iFARTXOj17FWObSkkW7Y,A3fsA9Zfv1X2fVEQhTw51lKENdNrEqT3,4,2,0,0,0,0,5,0,7,1.0,1,0.0,0,0,0,0,2,0,0,5,0,0,7,1
8501,144761,0xrj8jMy7DRmz2206OV6CH0SXBZh0mT4,SpATywNh6bZuzm8s1ceuBUnMUAeoAHHw,7,3,2,0,2,0,2,0,9,1.2857142857142858,1,0.0,0,2,0,2,3,0,0,2,0,4,5,1
8502,144772,yB2j2tPO2DVKCBBdsLv8a1lbHtfWINMh,A3fsA9Zfv1X2fVEQhTw51lKENdNrEqT3,22,17,14,0,12,0,4,0,47,6.714285714285714,3,0.0,0,14,0,12,17,0,0,4,0,26,21,0
8503,144775,WQI2O3Oijx2QlB8hE2TltFPDzjM5E22B,A3fsA9Zfv1X2fVEQhTw51lKENdNrEqT3,1,0,0,0,0,0,1,0,1,0.14285714285714285,1,0.0,0,0,0,0,0,0,0,1,0,0,1,1
8504,144776,jOKGDo32k5y1tQ1HBtDhmlq3GlvnMuW4,RXDvfPUBYFlVdlueBFbLW0mhhAyGEqpt,5,2,1,0,1,0,2,0,6,0.8571428571428571,1,0.0,0,1,0,1,2,0,0,2,0,2,4,1
8505,144791,qhMicTW8kXbgpTyOx2V27yOmKQOouISe,SpATywNh6bZuzm8s1ceuBUnMUAeoAHHw,17,19,8,19,3,5,7,1,62,8.857142857142858,2,0.0,8,8,16,3,11,5,3,7,1,35,27,1
8506,144792,PbpiZjozcQl91esiggJPwCEQesHzXMge,SpATywNh6bZuzm8s1ceuBUnMUAeoAHHw,4,2,0,0,0,0,3,0,5,0.7142857142857143,1,0.0,0,0,0,0,2,0,0,3,0,0,5,1
8507,144793,Q4yECXO7W1LpqtiMAu4zBn3zpNL7asTt,RXDvfPUBYFlVdlueBFbLW0mhhAyGEqpt,30,29,3,49,2,5,11,3,102,14.571428571428571,6,0.0,5,3,45,2,24,5,4,11,3,55,47,1
8508,144807,jOmJWWKjeEAibobmUGCNZpRQTVi2zu3q,SpATywNh6bZuzm8s1ceuBUnMUAeoAHHw,5,2,1,0,1,0,3,0,7,1.0,1,0.0,0,1,0,1,2,0,0,3,0,2,5,1
8509,144812,2plfHoT1TmtCwY9OYRzSThXWtZ22ORll,SpATywNh6bZuzm8s1ceuBUnMUAeoAHHw,4,3,1,0,1,0,1,0,6,0.8571428571428571,1,0.0,0,1,0,1,3,0,0,1,0,2,4,1
8510,144816,kQbCL3ZvWis8hkLoQgkRd3flhuUVeNwO,SpATywNh6bZuzm8s1ceuBUnMUAeoAHHw,5,2,0,0,1,0,2,0,5,0.7142857142857143,1,0.0,0,0,0,1,2,0,0,2,0,1,4,1
8511,144821,CQWretzMoQOL7mDTUjZusG4cd4L6wPQK,SpATywNh6bZuzm8s1ceuBUnMUAeoAHHw,11,8,6,0,4,0,3,0,21,3.0,2,0.0,0,6,0,4,8,0,0,3,0,10,11,1
8512,144822,0xrj8jMy7DRmz2206OV6CH0SXBZh0mT4,A3fsA9Zfv1X2fVEQhTw51lKENdNrEqT3,7,3,2,0,2,0,2,0,9,1.2857142857142858,1,0.0,0,2,0,2,3,0,0,2,0,4,5,0
8513,144828,KiabjnGWKx4XDSpmz6cnPElBww0X3aaK,SpATywNh6bZuzm8s1ceuBUnMUAeoAHHw,16,21,7,22,3,0,5,0,58,8.285714285714286,1,0.0,9,7,19,3,12,0,3,5,0,38,20,1
8514,144838,afGDIbGbSLFIkIVgYTcsM0nZrlLAYXP9,SpATywNh6bZuzm8s1ceuBUnMUAeoAHHw,10,9,6,0,5,1,20,1,42,6.0,2,0.0,0,6,0,5,9,1,0,20,1,11,31,1
8515,144839,59I5in7ieFGusS8qxVtrv60LZ3ifOtyr,A3fsA9Zfv1X2fVEQhTw51lKENdNrEqT3,3,3,0,0,0,0,2,0,5,0.7142857142857143,2,0.0,0,0,0,0,3,0,0,2,0,0,5,1
8516,144841,5o27t78wmU6kJM7l11bepi10qooi6vTp,A3fsA9Zfv1X2fVEQhTw51lKENdNrEqT3,3,0,0,0,0,2,2,0,4,0.5714285714285714,1,0.0,0,0,0,0,0,2,0,2,0,0,4,1
8517,144845,FfUXMT7mZqZTunyhx99wOtQUuUI4jlLj,A3fsA9Zfv1X2fVEQhTw51lKENdNrEqT3,11,7,4,0,4,0,2,0,17,2.4285714285714284,2,0.0,0,4,0,4,7,0,0,2,0,8,9,1
8518,144851,Msnkbi5gSjnXMGVMwapulzDXPJT7PsEO,RXDvfPUBYFlVdlueBFbLW0mhhAyGEqpt,2,0,0,0,0,0,2,0,2,0.2857142857142857,1,0.0,0,0,0,0,0,0,0,2,0,0,2,1
8519,144856,raoWM7iEQ4dq4BWNCSh69Fo9jIIvs47M,RXDvfPUBYFlVdlueBFbLW0mhhAyGEqpt,1,0,0,0,0,0,1,0,1,0.14285714285714285,1,0.0,0,0,0,0,0,0,0,1,0,0,1,1
8520,144861,ytxaMMjv4jRoSu72s5GHMltMaCAqKKcw,A3fsA9Zfv1X2fVEQhTw51lKENdNrEqT3,6,4,1,0,0,0,4,0,9,1.2857142857142858,1,0.0,0,1,0,0,4,0,0,4,0,1,8,1
8521,144862,7ZV5hVKM33Il4ZphKUROohrBCk5SoM3Q,RXDvfPUBYFlVdlueBFbLW0mhhAyGEqpt,8,25,14,0,0,0,1,0,40,5.714285714285714,1,0.0,8,14,0,0,17,0,0,1,0,22,18,1
8522,144865,T9c92JfvB6Kfucc01WIFC70LXWVeMAod,SpATywNh6bZuzm8s1ceuBUnMUAeoAHHw,15,23,0,18,0,13,9,1,64,9.142857142857142,1,0.0,8,0,15,0,15,13,3,9,1,23,41,1
8523,144877,ooFElJ4ZPOLTBMQwigtvKfnHk0DNrR2R,bWdj2GDclj5ofokWjzoa5jAwMkxCykd6,2,0,0,0,0,0,2,0,2,0.2857142857142857,1,0.0,0,0,0,0,0,0,0,2,0,0,2,1
8524,144882,ng2LeRo6bYVrW9ExHXJ3akhqh2xVsMqB,G8EPVSXsOYB5YQWZGiz1aVq5Pgr2GrQu,6,4,0,0,1,4,2,0,11,1.5714285714285714,1,0.0,0,0,0,1,4,4,0,2,0,1,10,1
8525,144904,oIHEiOwjcaMd5CeWZdkq4rXU3yelDWwT,bWdj2GDclj5ofokWjzoa5jAwMkxCykd6,1,0,0,0,0,0,1,0,1,0.14285714285714285,1,0.0,0,0,0,0,0,0,0,1,0,0,1,1
8526,144918,PZdxFgKpeQmexjsFXHDQYKHzq3CXEabo,SpATywNh6bZuzm8s1ceuBUnMUAeoAHHw,7,2,2,0,2,0,2,0,8,1.1428571428571428,1,0.0,0,2,0,2,2,0,0,2,0,4,4,1
8527,144921,1ygmKyxuE9zTchPBrLxYZHBa3CxHnvGx,SpATywNh6bZuzm8s1ceuBUnMUAeoAHHw,1,0,0,0,0,0,1,0,1,0.14285714285714285,1,0.0,0,0,0,0,0,0,0,1,0,0,1,1
8528,144922,1whtO6jrHXBMnMCSb8vftfOcDZoI6lpk,SpATywNh6bZuzm8s1ceuBUnMUAeoAHHw,2,0,0,0,0,0,2,0,2,0.2857142857142857,1,0.0,0,0,0,0,0,0,0,2,0,0,2,1
8529,144930,0ItSpPGfnBPXWyzwV4fknfpLDkx7tWJ8,SpATywNh6bZuzm8s1ceuBUnMUAeoAHHw,1,0,0,0,0,0,1,0,1,0.14285714285714285,1,0.0,0,0,0,0,0,0,0,1,0,0,1,1
8530,144934,WiWr9LeARPPUMTXasnYbOZNxI6vKEOag,SpATywNh6bZuzm8s1ceuBUnMUAeoAHHw,9,12,8,0,6,0,3,0,29,4.142857142857143,1,0.0,0,8,0,6,12,0,0,3,0,14,15,0
8531,144942,sJvbEmQSLPUSlzQVliesQ54qeaDrLfvx,A3fsA9Zfv1X2fVEQhTw51lKENdNrEqT3,1,0,0,0,0,0,1,0,1,0.14285714285714285,1,0.0,0,0,0,0,0,0,0,1,0,0,1,0
8532,144962,Tknw6wFyBHibLmhWsLFULGANgYkknQHe,bWdj2GDclj5ofokWjzoa5jAwMkxCykd6,8,6,0,0,0,0,6,0,12,1.7142857142857142,2,0.0,0,0,0,0,6,0,0,6,0,0,12,1
8533,144964,5x6p4rljKsrejQoWBLOKiqqWs4gJF7v5,bWdj2GDclj5ofokWjzoa5jAwMkxCykd6,4,2,0,0,0,0,2,0,4,0.5714285714285714,1,0.0,0,0,0,0,2,0,0,2,0,0,4,1
8534,144979,AO5lBD55aLiSGI6wc1OCl02CqUcrTOsS,G8EPVSXsOYB5YQWZGiz1aVq5Pgr2GrQu,7,6,2,2,3,0,2,0,15,2.142857142857143,1,0.0,3,2,1,3,3,0,1,2,0,9,6,0
8535,144984,mco1H2E00EJyxVOQ1f2JUOahUZWPVYSV,G8EPVSXsOYB5YQWZGiz1aVq5Pgr2GrQu,12,16,11,0,5,1,9,0,42,6.0,3,0.0,0,11,0,5,16,1,0,9,0,16,26,1
8536,144988,r2BlY5kx3gPU1opGlfjFI0ngbnfS5jKE,bWdj2GDclj5ofokWjzoa5jAwMkxCykd6,1,0,0,0,0,0,2,0,2,0.2857142857142857,1,0.0,0,0,0,0,0,0,0,2,0,0,2,1
8537,144998,QbBXesiuS3b5lRVZqzzdKh71YLAIKh1k,A3fsA9Zfv1X2fVEQhTw51lKENdNrEqT3,20,14,8,0,6,1,7,1,37,5.285714285714286,2,0.0,0,8,0,6,14,1,0,7,1,14,23,0
8538,144999,KQvub9kHQ3XpwpO5JgmmZp67zs4af3TX,SpATywNh6bZuzm8s1ceuBUnMUAeoAHHw,9,7,4,0,1,2,8,1,23,3.2857142857142856,1,0.0,0,4,0,1,7,2,0,8,1,5,18,1
8539,145000,FsN3EYiAfRxm9msVQNiGujMlmaZjdiLV,A3fsA9Zfv1X2fVEQhTw51lKENdNrEqT3,10,5,3,0,2,0,6,0,16,2.2857142857142856,2,0.0,0,3,0,2,5,0,0,6,0,5,11,1
8540,145001,cZxcDNlAnm0tcnrjnkTKyh2S3nRuNP2Z,G8EPVSXsOYB5YQWZGiz1aVq5Pgr2GrQu,7,5,1,0,1,0,3,0,10,1.4285714285714286,1,0.0,2,1,0,1,3,0,0,3,0,4,6,1
8541,145005,GkMFrAPlA6A09ccGhHn8t14lF9MeMrXS,SpATywNh6bZuzm8s1ceuBUnMUAeoAHHw,4,5,2,0,0,0,1,0,8,1.1428571428571428,1,0.0,0,2,0,0,5,0,0,1,0,2,6,1
8542,145008,1ORn2IwJawkKgC86QfIvIvcPRotoBurY,RXDvfPUBYFlVdlueBFbLW0mhhAyGEqpt,1,0,0,0,0,0,1,0,1,0.14285714285714285,1,0.0,0,0,0,0,0,0,0,1,0,0,1,1
8543,145013,yIWNRaHiP3wQHGf1Y6WI0xVXEdSpULNT,SpATywNh6bZuzm8s1ceuBUnMUAeoAHHw,6,3,2,0,2,0,1,0,8,1.1428571428571428,1,0.0,0,2,0,2,3,0,0,1,0,4,4,1
8544,145018,sPPWsacmUhKicl9IkMyPoW9C9Hv6wkAR,SpATywNh6bZuzm8s1ceuBUnMUAeoAHHw,11,13,2,0,1,0,4,0,20,2.857142857142857,2,0.0,0,2,0,1,13,0,0,4,0,3,17,1
8545,145030,ZvJHkcI26nhwqsVV9yaOoOyrIpy66iPT,A3fsA9Zfv1X2fVEQhTw51lKENdNrEqT3,6,6,1,0,1,0,1,0,9,1.2857142857142858,1,0.0,0,1,0,1,6,0,0,1,0,2,7,1
8546,145041,yIWNRaHiP3wQHGf1Y6WI0xVXEdSpULNT,bWdj2GDclj5ofokWjzoa5jAwMkxCykd6,5,2,1,0,1,0,2,0,6,0.8571428571428571,1,0.0,0,1,0,1,2,0,0,2,0,2,4,1
8547,145052,xvgAWMkP6HI1IM5orrHyjEEETuOd15kx,A3fsA9Zfv1X2fVEQhTw51lKENdNrEqT3,1,0,0,0,0,0,1,0,1,0.14285714285714285,1,0.0,0,0,0,0,0,0,0,1,0,0,1,1
8548,145055,rL34nWMQELY22w9bM5KXtMtPPdNRd6Vz,bWdj2GDclj5ofokWjzoa5jAwMkxCykd6,8,4,3,0,3,0,2,0,12,1.7142857142857142,1,0.0,0,3,0,3,4,0,0,2,0,6,6,1
8549,145059,0ZuqaZpF1uAdriF9eidLtJ5iuMfVy2xj,SpATywNh6bZuzm8s1ceuBUnMUAeoAHHw,11,16,4,0,2,10,5,0,37,5.285714285714286,2,0.0,0,4,0,2,16,10,0,5,0,6,31,1
8550,145106,DyTFy9Maa2ONHa1kuv16yd2JfoXtDQiQ,A3fsA9Zfv1X2fVEQhTw51lKENdNrEqT3,2,0,0,0,0,0,2,0,2,0.2857142857142857,1,0.0,0,0,0,0,0,0,0,2,0,0,2,1
8551,145109,PnK7IG5mVnL9F5P0hCKqF8uvfGfnI7Zr,SpATywNh6bZuzm8s1ceuBUnMUAeoAHHw,18,15,8,14,3,1,23,4,68,9.714285714285714,2,0.0,5,8,11,3,10,1,3,23,4,27,41,1
8552,145115,s4uxePGHFu7vUUg0QFSUrIPUr6ntECxH,SpATywNh6bZuzm8s1ceuBUnMUAeoAHHw,11,4,3,0,2,1,8,1,19,2.7142857142857144,2,0.0,0,3,0,2,4,1,0,8,1,5,14,1
8553,145116,TQ3ME8oXFjG9uPuJF9DlrWFS3Mh17Asw,SpATywNh6bZuzm8s1ceuBUnMUAeoAHHw,12,14,1,12,0,7,7,1,42,6.0,1,0.0,6,1,9,0,8,7,3,7,1,16,26,1
8554,145118,QoxAfK1F7spDZI2801beWPeXZSdQfP03,SpATywNh6bZuzm8s1ceuBUnMUAeoAHHw,9,14,1,9,0,16,5,0,45,6.428571428571429,2,0.0,10,1,9,0,4,16,0,5,0,20,25,1
8555,145120,iMAPtNJrTh9vdZVbGuGpFbwdggkaxy45,SpATywNh6bZuzm8s1ceuBUnMUAeoAHHw,13,14,9,0,5,4,6,0,38,5.428571428571429,2,0.0,2,9,0,5,12,4,0,6,0,16,22,1
8556,145134,nA58ZDkDJW4coPbkDAFQTIrhFRBe6rSy,G8EPVSXsOYB5YQWZGiz1aVq5Pgr2GrQu,8,14,2,0,0,0,4,0,20,2.857142857142857,2,0.0,4,2,0,0,10,0,0,4,0,6,14,1
8557,145135,ryorMC5bEintyqBNOh5gLfjxAx4QoH5u,A3fsA9Zfv1X2fVEQhTw51lKENdNrEqT3,17,22,13,0,4,12,19,3,73,10.428571428571429,2,0.0,1,13,0,4,21,12,0,19,3,18,55,1
8558,145137,yCZXjIGq001xO7v4MWCrl9HykbxmZHu1,SpATywNh6bZuzm8s1ceuBUnMUAeoAHHw,13,32,11,38,0,0,3,0,84,12.0,2,0.0,18,11,30,0,14,0,8,3,0,59,25,0
8559,145143,sytW49I21SJ70ElOkXGU5SHeeHl1E3fL,RXDvfPUBYFlVdlueBFbLW0mhhAyGEqpt,1,0,0,0,0,0,1,0,1,0.14285714285714285,1,0.0,0,0,0,0,0,0,0,1,0,0,1,1
8560,145155,BohRHH2vBIgnEZGZjM3WnHwJbVFmITRG,bWdj2GDclj5ofokWjzoa5jAwMkxCykd6,1,0,0,0,0,0,2,0,2,0.2857142857142857,1,0.0,0,0,0,0,0,0,0,2,0,0,2,1
8561,145161,K9rvD8Iu0wq956P4CDD0WYKLX5TfMvJ0,SpATywNh6bZuzm8s1ceuBUnMUAeoAHHw,7,3,2,0,2,0,3,0,10,1.4285714285714286,2,0.0,0,2,0,2,3,0,0,3,0,4,6,1
8562,145165,6h1KbHhbSaGcIKRFEHiX0UdDPCB3E5BQ,A3fsA9Zfv1X2fVEQhTw51lKENdNrEqT3,7,3,2,0,2,0,3,0,10,1.4285714285714286,1,0.0,0,2,0,2,3,0,0,3,0,4,6,1
8563,145167,q1fsTZpD3tHg9RFkIri5aJQcs8ZtVzZU,A3fsA9Zfv1X2fVEQhTw51lKENdNrEqT3,1,0,0,0,0,0,1,0,1,0.14285714285714285,1,0.0,0,0,0,0,0,0,0,1,0,0,1,1
8564,145182,JkokNSOVQ0CmVMNuEphopYOXBxfXEJtF,SpATywNh6bZuzm8s1ceuBUnMUAeoAHHw,5,2,1,0,1,0,7,0,11,1.5714285714285714,2,0.0,0,1,0,1,2,0,0,7,0,2,9,1
8565,145183,l5XRpi9H4fQ2XUHeEPRXRHL6Y4BckIOB,bWdj2GDclj5ofokWjzoa5jAwMkxCykd6,5,10,3,0,5,0,1,0,19,2.7142857142857144,2,0.0,4,3,0,5,6,0,0,1,0,12,7,1
8566,145195,XOKsEN36DokXwcr1smPc9nspsVQlK0Oq,bWdj2GDclj5ofokWjzoa5jAwMkxCykd6,5,2,1,0,0,0,3,0,6,0.8571428571428571,1,0.0,0,1,0,0,2,0,0,3,0,1,5,1
8567,145204,HnmJeuwsJxtO6k1CT8974Qo3Mu0GibPm,SpATywNh6bZuzm8s1ceuBUnMUAeoAHHw,6,3,1,0,1,0,3,0,8,1.1428571428571428,1,0.0,0,1,0,1,3,0,0,3,0,2,6,1
8568,145206,GQtHf5FrRCd4lKlDjEvxcTzFdncOzUUt,SpATywNh6bZuzm8s1ceuBUnMUAeoAHHw,4,2,0,0,0,0,3,0,5,0.7142857142857143,2,0.0,0,0,0,0,2,0,0,3,0,0,5,1
8569,145208,oGbJmKuU02t3nWH0tibgF9TroQlaGQUL,SpATywNh6bZuzm8s1ceuBUnMUAeoAHHw,13,14,8,0,3,0,10,0,35,5.0,1,0.0,2,8,0,3,12,0,0,10,0,13,22,1
8570,145217,TvUMV7rQqIP7XtKwTDDoLxmalP29Ttuw,SpATywNh6bZuzm8s1ceuBUnMUAeoAHHw,15,15,5,20,3,0,3,0,46,6.571428571428571,1,0.0,9,5,17,3,6,0,3,3,0,34,12,1
8571,145226,OpGwtUbMGweipJr0vMybah9tM3IHgiea,G8EPVSXsOYB5YQWZGiz1aVq5Pgr2GrQu,7,8,0,0,0,0,3,0,11,1.5714285714285714,1,0.0,0,0,0,0,8,0,0,3,0,0,11,1
8572,145236,DaYS7gf8DVgCD84ya5YqgMFFiGYw1ps2,bWdj2GDclj5ofokWjzoa5jAwMkxCykd6,10,14,1,0,3,0,7,1,26,3.7142857142857144,2,0.0,5,1,0,3,9,0,0,7,1,9,17,1
8573,145239,OtjE6pGePvcycREQhVmfTMoFJDvUV70D,SpATywNh6bZuzm8s1ceuBUnMUAeoAHHw,11,6,5,2,2,0,3,0,18,2.5714285714285716,1,0.0,0,5,2,2,6,0,0,3,0,9,9,1
8574,145253,5CjxInsWcHYdL9qJZYHVK4nh5ZsDhwos,A3fsA9Zfv1X2fVEQhTw51lKENdNrEqT3,6,3,1,0,1,0,2,0,7,1.0,1,0.0,0,1,0,1,3,0,0,2,0,2,5,1
8575,145259,5CjxInsWcHYdL9qJZYHVK4nh5ZsDhwos,bWdj2GDclj5ofokWjzoa5jAwMkxCykd6,10,16,3,0,3,2,7,1,32,4.571428571428571,2,0.0,0,3,0,3,16,2,0,7,1,6,26,1
8576,145264,EvNxwwShcQXgwZllGhuS7z5fGOL08A9A,G8EPVSXsOYB5YQWZGiz1aVq5Pgr2GrQu,1,0,0,0,0,0,1,0,1,0.14285714285714285,1,0.0,0,0,0,0,0,0,0,1,0,0,1,1
8577,145306,gB1oK8asvoVWRzgcHWrM4vY7Z3TLvmEu,G8EPVSXsOYB5YQWZGiz1aVq5Pgr2GrQu,14,29,2,0,2,1,14,1,49,7.0,2,0.0,0,2,0,2,29,1,0,14,1,4,45,1
8578,145308,UdRvlfQEjfzv2meiEECQoQ6VdSnYEWcK,bWdj2GDclj5ofokWjzoa5jAwMkxCykd6,1,0,0,0,0,0,1,0,1,0.14285714285714285,1,0.0,0,0,0,0,0,0,0,1,0,0,1,1
8579,145314,0G4cec511TtDyNtXCTS7DRIqOcOGSzxj,bWdj2GDclj5ofokWjzoa5jAwMkxCykd6,2,0,0,0,0,0,4,0,4,0.5714285714285714,2,0.0,0,0,0,0,0,0,0,4,0,0,4,1
8580,145324,eb3SHueTE6ugnDkhYnh0RBSPDS20VwLZ,SpATywNh6bZuzm8s1ceuBUnMUAeoAHHw,10,13,6,0,3,0,4,0,26,3.7142857142857144,2,0.0,2,6,0,3,11,0,0,4,0,11,15,1
8581,145327,fB0i7xObEYSWbMZwNEun6y9gdH9iF6Ca,bWdj2GDclj5ofokWjzoa5jAwMkxCykd6,6,4,1,0,0,0,3,0,8,1.1428571428571428,1,0.0,0,1,0,0,4,0,0,3,0,1,7,1
8582,145344,rrHRbXLg6i4u3JAIzGOFXJzGViekqHta,A3fsA9Zfv1X2fVEQhTw51lKENdNrEqT3,5,4,2,0,1,1,3,0,11,1.5714285714285714,2,0.0,0,2,0,1,4,1,0,3,0,3,8,1
8583,145354,KF5OPToc2HXGCGomze0nhcEx5XKSQ0eb,A3fsA9Zfv1X2fVEQhTw51lKENdNrEqT3,1,0,0,0,0,0,1,0,1,0.14285714285714285,1,0.0,0,0,0,0,0,0,0,1,0,0,1,1
8584,145359,KF5OPToc2HXGCGomze0nhcEx5XKSQ0eb,bWdj2GDclj5ofokWjzoa5jAwMkxCykd6,7,6,1,0,0,0,5,1,13,1.8571428571428572,2,0.0,0,1,0,0,6,0,0,5,1,1,12,1
8585,145362,UTEysxng8QdAA1HDzCSMUfK51MYoUK0I,SpATywNh6bZuzm8s1ceuBUnMUAeoAHHw,18,23,8,17,3,1,9,1,62,8.857142857142858,2,0.0,10,8,15,3,13,1,2,9,1,36,26,1
8586,145365,pG2ElR6wLgS0VIoYkLxmyVPOZz4q1huq,SpATywNh6bZuzm8s1ceuBUnMUAeoAHHw,5,3,1,0,1,0,4,0,9,1.2857142857142858,1,0.0,0,1,0,1,3,0,0,4,0,2,7,1
8587,145367,D9K6eWkEOoVrLczNZaGo49KoERtz2c6V,SpATywNh6bZuzm8s1ceuBUnMUAeoAHHw,16,23,13,11,4,0,6,0,57,8.142857142857142,4,0.0,4,13,10,4,19,0,1,6,0,31,26,1
8588,145368,705a1tvxnZT7omctMx7Fjakho000VDxN,A3fsA9Zfv1X2fVEQhTw51lKENdNrEqT3,1,0,0,0,0,0,2,0,2,0.2857142857142857,1,0.0,0,0,0,0,0,0,0,2,0,0,2,1
8589,145378,cMwTVyssxspl1RAprFyXqPmiVK2Z3yGe,SpATywNh6bZuzm8s1ceuBUnMUAeoAHHw,6,3,1,0,1,0,2,0,7,1.0,1,0.0,0,1,0,1,3,0,0,2,0,2,5,1
8590,145380,hZsYKh9WLvB4Wt2hCg4xVcKygpRAuxj7,A3fsA9Zfv1X2fVEQhTw51lKENdNrEqT3,25,10,9,16,8,0,4,0,47,6.714285714285714,2,0.0,0,9,14,8,10,0,2,4,0,31,16,1
8591,145389,TRYKApgWJsELbbCq5WSkTNwaxvbHHyCj,A3fsA9Zfv1X2fVEQhTw51lKENdNrEqT3,2,0,0,0,0,0,3,0,3,0.42857142857142855,1,0.0,0,0,0,0,0,0,0,3,0,0,3,1
8592,145391,H1aKLEBJtpAOAOCXptqn2WzikG0W6HkP,SpATywNh6bZuzm8s1ceuBUnMUAeoAHHw,3,0,0,0,0,0,2,1,3,0.42857142857142855,1,0.0,0,0,0,0,0,0,0,2,1,0,3,1
8593,145403,NO22WSq5lVGwq6WPEcqalEaMjYIZxX3u,SpATywNh6bZuzm8s1ceuBUnMUAeoAHHw,4,2,0,0,0,0,2,0,4,0.5714285714285714,2,0.0,0,0,0,0,2,0,0,2,0,0,4,1
8594,145411,sETZmDR5b3CheYe2K5IvWb1lrRsZmOT8,bWdj2GDclj5ofokWjzoa5jAwMkxCykd6,7,4,0,0,0,0,6,1,11,1.5714285714285714,2,0.0,0,0,0,0,4,0,0,6,1,0,11,1
8595,145461,XGghmqZSDFp0iwrgmPDUKXBdusY5a7fx,bWdj2GDclj5ofokWjzoa5jAwMkxCykd6,4,3,1,0,1,0,1,0,6,0.8571428571428571,1,0.0,0,1,0,1,3,0,0,1,0,2,4,1
8596,145471,cRlXLJdkIX4KH74JKLBjP86zQb3lppxR,A3fsA9Zfv1X2fVEQhTw51lKENdNrEqT3,9,4,3,0,3,0,2,0,12,1.7142857142857142,1,0.0,0,3,0,3,4,0,0,2,0,6,6,1
8597,145473,UNqMz63UOiLuXMnJzd7YWyfD3qIuNdaK,A3fsA9Zfv1X2fVEQhTw51lKENdNrEqT3,8,3,2,0,2,0,5,0,12,1.7142857142857142,2,0.0,0,2,0,2,3,0,0,5,0,4,8,1
8598,145474,cRlXLJdkIX4KH74JKLBjP86zQb3lppxR,SpATywNh6bZuzm8s1ceuBUnMUAeoAHHw,5,2,1,0,1,0,2,0,6,0.8571428571428571,1,0.0,0,1,0,1,2,0,0,2,0,2,4,1
8599,145483,wAirqcgeWs2CREKJhWAsWOo902skDwiw,SpATywNh6bZuzm8s1ceuBUnMUAeoAHHw,1,0,0,0,0,0,1,0,1,0.14285714285714285,1,0.0,0,0,0,0,0,0,0,1,0,0,1,1
8600,145487,3nvYm1DKrH5EOHAw44wBVldk53PpV7TA,A3fsA9Zfv1X2fVEQhTw51lKENdNrEqT3,14,10,7,0,5,2,2,0,26,3.7142857142857144,1,0.0,0,7,0,5,10,2,0,2,0,12,14,1
8601,145490,cKkpvGwYNdrpPwFgGI1Q3ssqlyxAIVaB,SpATywNh6bZuzm8s1ceuBUnMUAeoAHHw,7,7,4,0,3,0,1,0,15,2.142857142857143,1,0.0,2,4,0,3,5,0,0,1,0,9,6,1
8602,145493,BQyaQ0QwoGWbtLuf0oWIdmIpVjKe7O2x,A3fsA9Zfv1X2fVEQhTw51lKENdNrEqT3,7,4,3,0,2,0,2,0,11,1.5714285714285714,1,0.0,0,3,0,2,4,0,0,2,0,5,6,1
8603,145494,ySy2zYThCkVZr5MjEXuKxq60wfOynxkJ,bWdj2GDclj5ofokWjzoa5jAwMkxCykd6,1,0,0,0,0,0,1,0,1,0.14285714285714285,1,0.0,0,0,0,0,0,0,0,1,0,0,1,1
8604,145496,zhoGGW9mWTf0e7saIpd0Zh4kN5TE5GWq,SpATywNh6bZuzm8s1ceuBUnMUAeoAHHw,10,8,2,0,1,0,7,0,18,2.5714285714285716,1,0.0,0,2,0,1,8,0,0,7,0,3,15,1
8605,145522,vbUXBKy2vKu4AOOOd2rJki0btGiFQNDk,G8EPVSXsOYB5YQWZGiz1aVq5Pgr2GrQu,1,0,0,0,0,0,1,0,1,0.14285714285714285,1,0.0,0,0,0,0,0,0,0,1,0,0,1,1
8606,145525,x9kyeNXnVmIKLkyrDIOwE7AbD5ZpbAEs,RXDvfPUBYFlVdlueBFbLW0mhhAyGEqpt,1,0,0,0,0,0,1,0,1,0.14285714285714285,1,0.0,0,0,0,0,0,0,0,1,0,0,1,1
8607,145545,2CCQpD8tgu5ha7nXCDy4k1uINvkP56Wv,7GRhBDsirIGkRZBtSMEzNTyDr2JQm4xx,2,0,0,0,0,0,5,0,5,0.7142857142857143,1,0.0,0,0,0,0,0,0,0,5,0,0,5,1
8608,145547,rT3zpA0g6rjJ1jZXfn6mCIcHmMcmU756,7GRhBDsirIGkRZBtSMEzNTyDr2JQm4xx,44,62,22,54,23,1,14,0,176,25.142857142857142,3,0.0,30,22,44,23,32,1,10,14,0,119,57,0
8609,145550,RuTxY8DaJW8mZYxEAeQrQJD3l4wbq41Q,7GRhBDsirIGkRZBtSMEzNTyDr2JQm4xx,6,3,0,0,0,0,3,0,6,0.8571428571428571,1,0.0,0,0,0,0,3,0,0,3,0,0,6,0
8610,145552,J9NhhdMcyji8QpxegDrg5mXOQMf3xBRf,7GRhBDsirIGkRZBtSMEzNTyDr2JQm4xx,1,0,0,0,0,0,1,0,1,0.14285714285714285,1,0.0,0,0,0,0,0,0,0,1,0,0,1,1
8611,145560,vGQAID39BKk1FvQYReBWX247x3QlYrgz,7GRhBDsirIGkRZBtSMEzNTyDr2JQm4xx,6,15,4,0,1,0,2,0,22,3.142857142857143,1,0.0,6,4,0,1,9,0,0,2,0,11,11,1
8612,145583,iiP1QVGLP2M3sIU07s5hEwnMnf9UaC7w,7GRhBDsirIGkRZBtSMEzNTyDr2JQm4xx,5,3,1,0,1,0,1,0,6,0.8571428571428571,1,0.0,0,1,0,1,3,0,0,1,0,2,4,1
8613,145608,3kzqQ9nu0puySXndbv8HvzuMPwBlBjfc,7GRhBDsirIGkRZBtSMEzNTyDr2JQm4xx,23,22,11,21,6,6,22,1,89,12.714285714285714,3,0.0,2,11,16,6,20,6,5,22,1,35,54,1
8614,145620,S9UJJr8IVX3RcksPSP43kxazIyd4D4o5,7GRhBDsirIGkRZBtSMEzNTyDr2JQm4xx,1,0,0,0,0,0,1,0,1,0.14285714285714285,1,0.0,0,0,0,0,0,0,0,1,0,0,1,1
8615,145622,520kTOJ5a6HoTMe30flreSub2cyQqOhY,7GRhBDsirIGkRZBtSMEzNTyDr2JQm4xx,13,18,7,6,7,0,3,0,41,5.857142857142857,2,0.0,6,7,5,7,12,0,1,3,0,25,16,1
8616,145653,NCnx21IrphITLHEQy42s0jDfFa8Z92Kq,7GRhBDsirIGkRZBtSMEzNTyDr2JQm4xx,27,32,0,48,6,3,2,0,91,13.0,1,0.0,21,0,43,6,11,3,5,2,0,70,21,1
8617,145667,dNsNKeQao2yeFH4xZSLIDRMA5I5s2F7t,7GRhBDsirIGkRZBtSMEzNTyDr2JQm4xx,10,4,1,4,0,1,8,1,19,2.7142857142857144,1,0.0,2,1,3,0,2,1,1,8,1,6,13,1
8618,145672,J2mZhHnfnDU9Z2NM0dfjKg8jCciGVkrO,7GRhBDsirIGkRZBtSMEzNTyDr2JQm4xx,1,0,0,0,0,0,1,0,1,0.14285714285714285,1,0.0,0,0,0,0,0,0,0,1,0,0,1,1
8619,145700,4w6yJxocEKgAV94E61slsyKYrolKgTdS,7GRhBDsirIGkRZBtSMEzNTyDr2JQm4xx,2,0,0,0,0,0,2,0,2,0.2857142857142857,1,0.0,0,0,0,0,0,0,0,2,0,0,2,1
8620,145706,VQbP5QE49Z71QPyvJxZhD4TLO56u1QUG,7GRhBDsirIGkRZBtSMEzNTyDr2JQm4xx,10,11,3,9,2,0,2,0,27,3.857142857142857,1,0.0,7,3,8,2,4,0,1,2,0,20,7,1
8621,145733,j2PX858BWhrQRgl6BBT72xW4SDvQKpBb,7GRhBDsirIGkRZBtSMEzNTyDr2JQm4xx,1,0,0,0,0,0,1,0,1,0.14285714285714285,1,0.0,0,0,0,0,0,0,0,1,0,0,1,1
8622,145753,6UQSgDDlbey2YMMKaSOEpDJ0KQllZPpX,7GRhBDsirIGkRZBtSMEzNTyDr2JQm4xx,4,0,0,0,0,0,4,0,4,0.5714285714285714,1,0.0,0,0,0,0,0,0,0,4,0,0,4,1
8623,145763,lnkkWGyIr1b44KiKgAFL6qVeebRfNJt3,7GRhBDsirIGkRZBtSMEzNTyDr2JQm4xx,17,28,0,37,0,0,4,0,69,9.857142857142858,2,0.0,16,0,32,0,12,0,5,4,0,48,21,1
8624,145766,IL2QJO9D8DzgZ0CQ8CMzPpcGTIPKd3bR,7GRhBDsirIGkRZBtSMEzNTyDr2JQm4xx,1,0,0,0,0,0,1,0,1,0.14285714285714285,1,0.0,0,0,0,0,0,0,0,1,0,0,1,1
8625,145774,UtbznsHbbIxKlUqw2M2px85X4bXZRgMG,7GRhBDsirIGkRZBtSMEzNTyDr2JQm4xx,1,0,0,0,0,0,1,0,1,0.14285714285714285,1,0.0,0,0,0,0,0,0,0,1,0,0,1,1
8626,145785,r1hSpHaWwriGvone6pflJV8zZcv0Gdcl,7GRhBDsirIGkRZBtSMEzNTyDr2JQm4xx,2,0,0,0,0,0,2,0,2,0.2857142857142857,1,0.0,0,0,0,0,0,0,0,2,0,0,2,1
8627,145795,yEBTzrvNFAmfa9M4QYcbmiIM6sJKI3UY,7GRhBDsirIGkRZBtSMEzNTyDr2JQm4xx,2,0,0,0,0,0,4,0,4,0.5714285714285714,1,0.0,0,0,0,0,0,0,0,4,0,0,4,1
8628,145817,sqxWpMhcYtYMOXwrr0icUXKE79UdB0Zx,7GRhBDsirIGkRZBtSMEzNTyDr2JQm4xx,14,17,1,2,1,0,6,1,28,4.0,1,0.0,1,1,2,1,16,0,0,6,1,5,23,1
8629,145827,dgFOOUSNfQK8xIrT47Av0Q04bBFeE21W,7GRhBDsirIGkRZBtSMEzNTyDr2JQm4xx,1,0,0,0,0,0,1,0,1,0.14285714285714285,1,0.0,0,0,0,0,0,0,0,1,0,0,1,0
8630,145897,amg8X8B8QF6NtkilqTdjsvKuhYv7sNrc,7GRhBDsirIGkRZBtSMEzNTyDr2JQm4xx,5,7,2,0,0,0,2,0,11,1.5714285714285714,1,0.0,0,2,0,0,7,0,0,2,0,2,9,1
8631,145980,HAj954mCjfBGJQsjyOUvywwmDcTn3cfv,7GRhBDsirIGkRZBtSMEzNTyDr2JQm4xx,3,2,1,0,0,0,1,0,4,0.5714285714285714,1,0.0,0,1,0,0,2,0,0,1,0,1,3,1
8632,145993,FTJVq9TWMdAK3okD5xbyDXGZ8r3m7Y4p,7GRhBDsirIGkRZBtSMEzNTyDr2JQm4xx,3,2,0,0,0,0,1,0,3,0.42857142857142855,1,0.0,0,0,0,0,2,0,0,1,0,0,3,1
8633,145997,xZ2FRlEfvjMgYQGaQTIBwdHmWyFrjfGH,7GRhBDsirIGkRZBtSMEzNTyDr2JQm4xx,2,1,0,0,0,0,2,0,3,0.42857142857142855,1,0.0,0,0,0,0,1,0,0,2,0,0,3,0
8634,146003,0Jy5agBaIEKZmcjIoKNgJ60hHPcSDAap,7GRhBDsirIGkRZBtSMEzNTyDr2JQm4xx,1,0,0,0,0,0,1,0,1,0.14285714285714285,1,0.0,0,0,0,0,0,0,0,1,0,0,1,1
8635,146593,dnF4V3J1QcZ16kz7ecUJEPAkM9rOV7wb,7GRhBDsirIGkRZBtSMEzNTyDr2JQm4xx,1,0,0,0,0,0,1,0,1,0.14285714285714285,1,0.0,0,0,0,0,0,0,0,1,0,0,1,1
8636,146916,nC3nlEcInfZBkfWiBAFT0QImutSJIRDp,RXDvfPUBYFlVdlueBFbLW0mhhAyGEqpt,1,0,0,0,0,0,1,0,1,0.14285714285714285,1,0.0,0,0,0,0,0,0,0,1,0,0,1,1
8637,146924,gNoniBDFX51Yjk2gJg2vMlrLeNPSUasm,G8EPVSXsOYB5YQWZGiz1aVq5Pgr2GrQu,1,0,0,0,0,0,2,0,2,0.2857142857142857,1,0.0,0,0,0,0,0,0,0,2,0,0,2,1
8638,146944,w8NrkUwgMqb3O2jCUrmWBqs2yypNb8dq,RXDvfPUBYFlVdlueBFbLW0mhhAyGEqpt,18,28,3,28,1,0,11,0,71,10.142857142857142,3,0.0,3,3,26,1,25,0,2,11,0,33,38,1
8639,147012,T9AvdYMob6A7XymtAVQOWMZ2VKIDwWSx,RXDvfPUBYFlVdlueBFbLW0mhhAyGEqpt,8,4,0,0,0,1,9,2,16,2.2857142857142856,3,0.0,0,0,0,0,4,1,0,9,2,0,16,1
8640,147075,wVwBkRoAPUoV5PewFP4svSYnl1ZXoHnc,G8EPVSXsOYB5YQWZGiz1aVq5Pgr2GrQu,1,0,0,0,0,0,1,0,1,0.14285714285714285,1,0.0,0,0,0,0,0,0,0,1,0,0,1,1
8641,147096,MZsWffL53WPYhfyCR8aX3Mp9egHMC4ie,RXDvfPUBYFlVdlueBFbLW0mhhAyGEqpt,1,0,0,0,0,0,1,0,1,0.14285714285714285,1,0.0,0,0,0,0,0,0,0,1,0,0,1,1
8642,147103,114X1vLT3OTzchhxfRGg24FTsgrs6Boi,RXDvfPUBYFlVdlueBFbLW0mhhAyGEqpt,1,0,0,0,0,0,2,0,2,0.2857142857142857,1,0.0,0,0,0,0,0,0,0,2,0,0,2,1
8643,147112,sL5jw3pLWZoRI7avI17oM60mfF67Acgz,G8EPVSXsOYB5YQWZGiz1aVq5Pgr2GrQu,1,0,0,0,0,0,2,0,2,0.2857142857142857,2,0.0,0,0,0,0,0,0,0,2,0,0,2,0
8644,147144,a91ewPLjlp1X8KqwrnZISs7xgERRXuh7,RXDvfPUBYFlVdlueBFbLW0mhhAyGEqpt,1,0,0,0,0,0,1,0,1,0.14285714285714285,1,0.0,0,0,0,0,0,0,0,1,0,0,1,1
8645,147223,uUyznY5p2fw7hVKlngBtP5z29uUZt16H,RXDvfPUBYFlVdlueBFbLW0mhhAyGEqpt,1,0,0,0,0,0,1,0,1,0.14285714285714285,1,0.0,0,0,0,0,0,0,0,1,0,0,1,1
8646,147232,bkdCLvSthS1MubyKzxMCvPKPGG70pOZC,G8EPVSXsOYB5YQWZGiz1aVq5Pgr2GrQu,1,0,0,0,0,0,1,0,1,0.14285714285714285,1,0.0,0,0,0,0,0,0,0,1,0,0,1,0
8647,147287,yB2j2tPO2DVKCBBdsLv8a1lbHtfWINMh,RXDvfPUBYFlVdlueBFbLW0mhhAyGEqpt,1,0,0,0,0,0,1,0,1,0.14285714285714285,1,0.0,0,0,0,0,0,0,0,1,0,0,1,1
8648,147309,UfUYHtn7EFCFULfAAiVnfhKrcOfMt4Ug,G8EPVSXsOYB5YQWZGiz1aVq5Pgr2GrQu,1,0,0,0,0,0,1,0,1,0.14285714285714285,1,0.0,0,0,0,0,0,0,0,1,0,0,1,1
8649,147318,GONTKb318b2pNzO4RSf2Oav2TmqJo6yi,G8EPVSXsOYB5YQWZGiz1aVq5Pgr2GrQu,1,0,0,0,0,0,1,0,1,0.14285714285714285,1,0.0,0,0,0,0,0,0,0,1,0,0,1,1
8650,147344,fE8AsLCA0TCwN2lFIpEAgt949Oz2zi2M,G8EPVSXsOYB5YQWZGiz1aVq5Pgr2GrQu,1,0,0,0,0,0,1,0,1,0.14285714285714285,1,0.0,0,0,0,0,0,0,0,1,0,0,1,1
8651,147349,hRH67nWa9zgJtoi4yrmT3KmNMJoVcNRr,G8EPVSXsOYB5YQWZGiz1aVq5Pgr2GrQu,1,0,0,0,0,0,1,0,1,0.14285714285714285,1,0.0,0,0,0,0,0,0,0,1,0,0,1,1
8652,147376,aBcd5xuaSGFcCFUKcCSjEaSoJEfIPYAN,G8EPVSXsOYB5YQWZGiz1aVq5Pgr2GrQu,1,0,0,0,0,0,1,0,1,0.14285714285714285,1,0.0,0,0,0,0,0,0,0,1,0,0,1,1
8653,147407,SVxtFny9oPYbtoixSK2PAs9XNkM3e8hn,RXDvfPUBYFlVdlueBFbLW0mhhAyGEqpt,12,11,1,2,3,0,6,1,24,3.4285714285714284,2,0.0,4,1,2,3,7,0,0,6,1,10,14,1
8654,147416,Wi6NsYPSasqtq71046KwRwCUoJ7gSxqZ,G8EPVSXsOYB5YQWZGiz1aVq5Pgr2GrQu,29,42,24,44,0,38,28,3,179,25.571428571428573,3,0.0,12,24,30,0,30,38,14,28,3,66,113,1
8655,147480,SLkozwcHBufe0UPB64m4o1Ao551WfuNu,G8EPVSXsOYB5YQWZGiz1aVq5Pgr2GrQu,1,0,0,0,0,0,1,0,1,0.14285714285714285,1,0.0,0,0,0,0,0,0,0,1,0,0,1,1
8656,147501,Rw0pJvwCeS9P2HJebYz4vjMvliFwRI8o,G8EPVSXsOYB5YQWZGiz1aVq5Pgr2GrQu,9,2,1,0,1,0,7,2,13,1.8571428571428572,2,0.0,0,1,0,1,2,0,0,7,2,2,11,1
8657,147517,t3323TFWjEAQScP83AS7oMF9sZ2WNapI,G8EPVSXsOYB5YQWZGiz1aVq5Pgr2GrQu,1,0,0,0,0,0,1,0,1,0.14285714285714285,1,0.0,0,0,0,0,0,0,0,1,0,0,1,1
8658,147588,USLTnsAwagwK2c83KXd1SNEeENnzkTTo,RXDvfPUBYFlVdlueBFbLW0mhhAyGEqpt,1,0,0,0,0,0,1,0,1,0.14285714285714285,1,0.0,0,0,0,0,0,0,0,1,0,0,1,1
8659,147597,jN2uzyXO5CSzMfW3pp82AVUf4pDPwJuY,RXDvfPUBYFlVdlueBFbLW0mhhAyGEqpt,1,0,0,0,0,0,1,0,1,0.14285714285714285,1,0.0,0,0,0,0,0,0,0,1,0,0,1,1
8660,147600,cvwnd07iniLpbhx37I857HZu05eA9OFE,RXDvfPUBYFlVdlueBFbLW0mhhAyGEqpt,16,24,15,2,5,15,13,2,76,10.857142857142858,2,0.0,1,15,2,5,23,15,0,13,2,23,53,1
8661,147610,xLkdbbKQJbd2pVZCFImtrA3GPATvYGgD,G8EPVSXsOYB5YQWZGiz1aVq5Pgr2GrQu,1,0,0,0,0,0,1,0,1,0.14285714285714285,1,0.0,0,0,0,0,0,0,0,1,0,0,1,1
8662,147639,MU6JKjzSFjezaWPFdc0IJW3L2fftgaQZ,RXDvfPUBYFlVdlueBFbLW0mhhAyGEqpt,1,0,0,0,0,0,1,0,1,0.14285714285714285,1,0.0,0,0,0,0,0,0,0,1,0,0,1,1
8663,147658,htYzFBi86rzWlzEtyu7aNqTtL2SW6jzn,G8EPVSXsOYB5YQWZGiz1aVq5Pgr2GrQu,1,0,0,0,0,0,1,0,1,0.14285714285714285,1,0.0,0,0,0,0,0,0,0,1,0,0,1,1
8664,147673,5kCR1wjWWz9eEHdizA4crFyxKTH4mIdl,RXDvfPUBYFlVdlueBFbLW0mhhAyGEqpt,1,0,0,0,0,0,1,0,1,0.14285714285714285,1,0.0,0,0,0,0,0,0,0,1,0,0,1,1
8665,147711,Z96ghDF2SEO6eJyjMUuyfBwUaW4sni8D,G8EPVSXsOYB5YQWZGiz1aVq5Pgr2GrQu,11,21,3,4,3,0,4,1,36,5.142857142857143,2,0.0,11,3,2,3,10,0,2,4,1,19,17,1
8666,147717,i4fgy4BVHlpEBMVrUkI9gWLihOonqgFN,G8EPVSXsOYB5YQWZGiz1aVq5Pgr2GrQu,15,13,4,16,2,2,9,1,47,6.714285714285714,3,0.0,5,4,14,2,8,2,2,9,1,25,22,1
8667,147725,DJXPEOqclxMbkJva0g6MJfihz48JHIVn,G8EPVSXsOYB5YQWZGiz1aVq5Pgr2GrQu,1,0,0,0,0,0,1,0,1,0.14285714285714285,1,0.0,0,0,0,0,0,0,0,1,0,0,1,1
8668,147730,J5FkxM9o8L4y51xbaKwQjZuay8KpJMzH,G8EPVSXsOYB5YQWZGiz1aVq5Pgr2GrQu,1,0,0,0,0,0,1,0,1,0.14285714285714285,1,0.0,0,0,0,0,0,0,0,1,0,0,1,1
8669,147737,eXv6ACzt62C4hMSoDSIQMvmz4LEnGBtm,G8EPVSXsOYB5YQWZGiz1aVq5Pgr2GrQu,1,0,0,0,0,0,1,0,1,0.14285714285714285,1,0.0,0,0,0,0,0,0,0,1,0,0,1,1
8670,147758,jEGqrC42iEC0MkvaQaekkhZsW8YPZGtW,fbPkOYLVPtPgIt0MxizjfFJov3JbHyAi,1,0,0,0,0,0,1,0,1,0.14285714285714285,1,0.0,0,0,0,0,0,0,0,1,0,0,1,1
8671,147759,pFE82fh5DH8NUVtvV1y83suNQP2lNeAe,fbPkOYLVPtPgIt0MxizjfFJov3JbHyAi,7,11,5,0,2,0,4,0,22,3.142857142857143,3,0.0,1,5,0,2,10,0,0,4,0,8,14,1
8672,147761,6lr9avMLLLHkFmJUiXzIeIFidbBgUCxs,fbPkOYLVPtPgIt0MxizjfFJov3JbHyAi,4,2,1,0,1,0,2,0,6,0.8571428571428571,1,0.0,0,1,0,1,2,0,0,2,0,2,4,1
8673,147762,h6gp6OLQCLhKTyjanK3TbnUuf19NH0Ob,fbPkOYLVPtPgIt0MxizjfFJov3JbHyAi,1,0,0,0,0,0,1,0,1,0.14285714285714285,1,0.0,0,0,0,0,0,0,0,1,0,0,1,1
8674,147763,Eth5NiW62QeegjonEwzsKZ7huvzhHIVn,fbPkOYLVPtPgIt0MxizjfFJov3JbHyAi,1,0,0,0,0,0,1,0,1,0.14285714285714285,1,0.0,0,0,0,0,0,0,0,1,0,0,1,1
8675,147764,J2kOdVfbOVzDYlg6JttZzYj1ijMbmOfa,fbPkOYLVPtPgIt0MxizjfFJov3JbHyAi,9,5,3,0,3,0,2,0,13,1.8571428571428572,1,0.0,1,3,0,3,4,0,0,2,0,7,6,1
8676,147768,1YQhKlVbSWSyRB9mcpedGa7M41YWFSmU,fbPkOYLVPtPgIt0MxizjfFJov3JbHyAi,8,2,1,0,1,3,7,1,15,2.142857142857143,1,0.0,0,1,0,1,2,3,0,7,1,2,13,1
8677,147769,KDxyrbt1mVWE3rzc84dyTK3d2hDl8n9y,fbPkOYLVPtPgIt0MxizjfFJov3JbHyAi,5,0,0,0,0,0,5,1,6,0.8571428571428571,1,0.0,0,0,0,0,0,0,0,5,1,0,6,1
8678,147770,tKs772tHpR5tE8Ceee9VXQcqKPNhx6zt,fbPkOYLVPtPgIt0MxizjfFJov3JbHyAi,1,0,0,0,0,0,1,0,1,0.14285714285714285,1,0.0,0,0,0,0,0,0,0,1,0,0,1,1
8679,147771,o1Z0mcnOVXV8qXjqUo78WebzsF68mpLE,fbPkOYLVPtPgIt0MxizjfFJov3JbHyAi,6,5,3,0,3,0,3,0,14,2.0,1,0.0,1,3,0,3,4,0,0,3,0,7,7,1
8680,147772,mFN7ZQWOcVa7LiP8Oo1W0WPTVxvqcwqO,fbPkOYLVPtPgIt0MxizjfFJov3JbHyAi,13,11,8,0,5,3,1,0,28,4.0,1,0.0,2,8,0,5,9,3,0,1,0,15,13,1
8681,147773,PvYWxw3yEbAoadQAkzpd3k3f7OpG6DoE,fbPkOYLVPtPgIt0MxizjfFJov3JbHyAi,5,2,1,0,1,0,2,0,6,0.8571428571428571,1,0.0,0,1,0,1,2,0,0,2,0,2,4,1
8682,147774,GwBsELCYAYNo2pcJ3Hwab6UtiG3ye1Qj,fbPkOYLVPtPgIt0MxizjfFJov3JbHyAi,21,23,15,0,9,5,10,0,62,8.857142857142858,5,0.0,0,15,0,9,23,5,0,10,0,24,38,1
8683,147775,wm3H7yjZZekKOdpMLsAK0Ro798c59IP1,fbPkOYLVPtPgIt0MxizjfFJov3JbHyAi,5,2,1,0,1,0,2,0,6,0.8571428571428571,1,0.0,0,1,0,1,2,0,0,2,0,2,4,1
8684,147776,aeUD1Q8xXZqlrQjVnPDT03gNdmvseEAG,fbPkOYLVPtPgIt0MxizjfFJov3JbHyAi,1,0,0,0,0,0,1,0,1,0.14285714285714285,1,0.0,0,0,0,0,0,0,0,1,0,0,1,1
8685,147778,UqdW6exgqWwrDooHrQBPDZ2CP0Vab4m7,fbPkOYLVPtPgIt0MxizjfFJov3JbHyAi,5,2,1,0,1,0,2,0,6,0.8571428571428571,1,0.0,0,1,0,1,2,0,0,2,0,2,4,1
8686,147780,Ov4mGbTBr19epZTdyb8WcJdW9YbNKnAm,fbPkOYLVPtPgIt0MxizjfFJov3JbHyAi,6,4,1,0,1,0,4,0,10,1.4285714285714286,1,0.0,0,1,0,1,4,0,0,4,0,2,8,1
8687,147781,5xOYe3GtSFIz24skQDwp2bS5mtMryo1i,fbPkOYLVPtPgIt0MxizjfFJov3JbHyAi,5,2,1,0,1,0,3,0,7,1.0,1,0.0,0,1,0,1,2,0,0,3,0,2,5,1
8688,147782,D1P1Hsf44r0eDI7GpWUjS6UCddknnKAg,fbPkOYLVPtPgIt0MxizjfFJov3JbHyAi,1,0,0,0,0,0,1,0,1,0.14285714285714285,1,0.0,0,0,0,0,0,0,0,1,0,0,1,1
8689,147783,T24KPVGcghdv6P7ytQKE6lhStbj1tDHE,fbPkOYLVPtPgIt0MxizjfFJov3JbHyAi,7,3,2,0,2,0,2,0,9,1.2857142857142858,1,0.0,0,2,0,2,3,0,0,2,0,4,5,1
8690,147784,K1OObDgsc7SijBamTjkwfIoFyHtZ3ZU6,fbPkOYLVPtPgIt0MxizjfFJov3JbHyAi,11,14,8,0,6,1,7,1,37,5.285714285714286,1,0.0,2,8,0,6,12,1,0,7,1,16,21,1
8691,147785,hOKkjeN6nHMO6D4VBHXzVFHaUdaVhrEZ,fbPkOYLVPtPgIt0MxizjfFJov3JbHyAi,6,3,1,0,1,6,6,0,17,2.4285714285714284,1,0.0,0,1,0,1,3,6,0,6,0,2,15,1
8692,147786,TuaZjf9Q9UcuuonmpyeQa8sFOZhELQm1,fbPkOYLVPtPgIt0MxizjfFJov3JbHyAi,8,3,2,0,2,0,9,0,16,2.2857142857142856,1,0.0,0,2,0,2,3,0,0,9,0,4,12,1
8693,147787,H69WO9aanRW4gzX23LgvL4SatIAdfXLh,fbPkOYLVPtPgIt0MxizjfFJov3JbHyAi,1,0,0,0,0,0,1,0,1,0.14285714285714285,1,0.0,0,0,0,0,0,0,0,1,0,0,1,1
8694,147789,xJLiT7aQ8wJaqtjbqZPuNyUe7xsRIYUx,fbPkOYLVPtPgIt0MxizjfFJov3JbHyAi,10,5,2,0,3,0,8,2,20,2.857142857142857,1,0.0,2,2,0,3,3,0,0,8,2,7,13,1
8695,147790,EQQGIzDw0KP7FL3ru9SVFlekfV91SRlx,fbPkOYLVPtPgIt0MxizjfFJov3JbHyAi,7,3,2,0,2,0,2,0,9,1.2857142857142858,1,0.0,0,2,0,2,3,0,0,2,0,4,5,1
8696,147791,UGbvFlSQXPNfRziPAOx4kHkl79A7jmGG,fbPkOYLVPtPgIt0MxizjfFJov3JbHyAi,18,29,9,12,12,1,3,0,66,9.428571428571429,2,0.0,8,9,12,12,21,1,0,3,0,41,25,1
8697,147793,UHhf3OS5KTsSmirrMDTBosghF0Ip6ptz,fbPkOYLVPtPgIt0MxizjfFJov3JbHyAi,1,0,0,0,0,0,1,0,1,0.14285714285714285,1,0.0,0,0,0,0,0,0,0,1,0,0,1,1
8698,147794,KsHIB2XNLK7Fs02PF75Xmf4i3fa72rIT,fbPkOYLVPtPgIt0MxizjfFJov3JbHyAi,2,0,0,0,0,0,2,0,2,0.2857142857142857,1,0.0,0,0,0,0,0,0,0,2,0,0,2,1
8699,148334,7gxdF7npc77h7z0KnU9ezGYqtBJqY4fQ,7GRhBDsirIGkRZBtSMEzNTyDr2JQm4xx,35,51,17,52,15,3,9,2,149,21.285714285714285,3,0.0,30,17,48,15,21,3,4,9,2,110,39,0
8700,148351,UuZ3VzxMOcv1pgBQfP1NUeudFRRQ1mRU,fbPkOYLVPtPgIt0MxizjfFJov3JbHyAi,8,3,2,0,2,0,4,0,11,1.5714285714285714,1,0.0,0,2,0,2,3,0,0,4,0,4,7,1
8701,148352,jHtmhjYvIQCrHvgDxRflQ5IxXJSVFYuQ,fbPkOYLVPtPgIt0MxizjfFJov3JbHyAi,3,2,0,0,0,0,1,0,3,0.42857142857142855,1,0.0,0,0,0,0,2,0,0,1,0,0,3,1
8702,148354,l20aBHleNKjK0XwZQWFPyPJB0cuojdw9,fbPkOYLVPtPgIt0MxizjfFJov3JbHyAi,5,2,1,0,1,0,4,0,8,1.1428571428571428,1,0.0,0,1,0,1,2,0,0,4,0,2,6,1
8703,148355,8PiAS0TmnQl9QEf7dgpgPmWaNztmfJVP,fbPkOYLVPtPgIt0MxizjfFJov3JbHyAi,9,7,4,0,4,0,3,0,18,2.5714285714285716,1,0.0,2,4,0,4,5,0,0,3,0,10,8,1
8704,148356,1FMoEHMl48zOO2kttHN9vLOQurH54seC,fbPkOYLVPtPgIt0MxizjfFJov3JbHyAi,6,7,3,0,2,0,4,0,16,2.2857142857142856,1,0.0,0,3,0,2,7,0,0,4,0,5,11,1
8705,148357,fyc4dkjFagB2LcZciRyqSJPoegzypBzy,fbPkOYLVPtPgIt0MxizjfFJov3JbHyAi,6,5,3,0,2,0,3,0,13,1.8571428571428572,1,0.0,0,3,0,2,5,0,0,3,0,5,8,1
8706,148359,uZ1O39GxSmePAndNprQEBYYChQSQNkhB,fbPkOYLVPtPgIt0MxizjfFJov3JbHyAi,23,24,16,13,11,0,9,1,74,10.571428571428571,2,0.0,4,16,11,11,20,0,2,9,1,42,32,1
8707,148360,wJP9G4aa97RALoz7jgfom2Is1dozR5XV,fbPkOYLVPtPgIt0MxizjfFJov3JbHyAi,8,10,7,0,4,0,3,0,24,3.4285714285714284,2,0.0,0,7,0,4,10,0,0,3,0,11,13,1
8708,148361,X0S4TDZgj5AsEY7rj0bHgFBmM1wEHl8g,fbPkOYLVPtPgIt0MxizjfFJov3JbHyAi,5,2,1,0,1,0,3,0,7,1.0,1,0.0,0,1,0,1,2,0,0,3,0,2,5,1
8709,148362,zo3To03Q5Rdok3x4Zu1wNdsKqNDBlzyd,fbPkOYLVPtPgIt0MxizjfFJov3JbHyAi,7,3,2,0,2,0,4,0,11,1.5714285714285714,1,0.0,0,2,0,2,3,0,0,4,0,4,7,1
8710,148363,mvWG8WfFoikkAB9Wg1mtbCZJVje4NMeg,fbPkOYLVPtPgIt0MxizjfFJov3JbHyAi,2,0,0,0,0,2,1,0,3,0.42857142857142855,1,0.0,0,0,0,0,0,2,0,1,0,0,3,1
8711,148364,8TsC1FJM6vJWYXxMn4XOpAyFu9uyBcwT,fbPkOYLVPtPgIt0MxizjfFJov3JbHyAi,3,0,0,0,0,0,3,0,3,0.42857142857142855,1,0.0,0,0,0,0,0,0,0,3,0,0,3,1
8712,148365,lQTp6SekPVZwhVL0coTG7jI0NerwwRXX,fbPkOYLVPtPgIt0MxizjfFJov3JbHyAi,1,0,0,0,0,0,1,0,1,0.14285714285714285,1,0.0,0,0,0,0,0,0,0,1,0,0,1,1
8713,148369,BZslXVbbVc1YaW2k5ccBUS6eiDl1WM07,fbPkOYLVPtPgIt0MxizjfFJov3JbHyAi,5,4,1,0,1,0,5,0,11,1.5714285714285714,1,0.0,2,1,0,1,2,0,0,5,0,4,7,1
8714,148370,O3TF3GdRfaqFBn0EbABVcwycS92XFqQI,fbPkOYLVPtPgIt0MxizjfFJov3JbHyAi,8,2,1,0,1,0,4,1,9,1.2857142857142858,1,0.0,0,1,0,1,2,0,0,4,1,2,7,1
8715,148372,RVf6e28k6GsRGb8DN1lRFhzAihWj6uwr,fbPkOYLVPtPgIt0MxizjfFJov3JbHyAi,6,6,1,0,2,0,2,0,11,1.5714285714285714,1,0.0,3,1,0,2,3,0,0,2,0,6,5,1
8716,148373,ajZe5IV50P9q1MwLuSJJxiEXkVsZl5Va,fbPkOYLVPtPgIt0MxizjfFJov3JbHyAi,9,4,2,0,3,0,2,0,11,1.5714285714285714,1,0.0,0,2,0,3,4,0,0,2,0,5,6,1
8717,148374,SkGT6P4CYkjpyqSl3XDsa9OtVYpbNLKc,fbPkOYLVPtPgIt0MxizjfFJov3JbHyAi,5,2,1,0,1,0,2,0,6,0.8571428571428571,1,0.0,0,1,0,1,2,0,0,2,0,2,4,1
8718,148376,OektSQ9TNN3cEy3ZKuUs35c7BdSOqtaQ,fbPkOYLVPtPgIt0MxizjfFJov3JbHyAi,6,5,3,0,2,0,5,0,15,2.142857142857143,1,0.0,0,3,0,2,5,0,0,5,0,5,10,1
8719,148377,9DQIIj4A47ahx19xY3qY5HPiF8T9NzKd,fbPkOYLVPtPgIt0MxizjfFJov3JbHyAi,5,3,1,0,1,0,2,0,7,1.0,1,0.0,0,1,0,1,3,0,0,2,0,2,5,1
8720,148380,mmXnUf3Xp68sXzzvqqAwsEL8YCYNkHx6,fbPkOYLVPtPgIt0MxizjfFJov3JbHyAi,9,4,3,0,3,0,5,0,15,2.142857142857143,1,0.0,0,3,0,3,4,0,0,5,0,6,9,1
8721,148386,3J1rNe3uRvedZitqeCdyMGosrBYsQChl,fbPkOYLVPtPgIt0MxizjfFJov3JbHyAi,5,2,1,0,1,0,2,0,6,0.8571428571428571,1,0.0,0,1,0,1,2,0,0,2,0,2,4,0
8722,148387,LZ4FjsgtwzNif1KtUcVyAos1pH68eZ72,fbPkOYLVPtPgIt0MxizjfFJov3JbHyAi,1,0,0,0,0,0,1,0,1,0.14285714285714285,1,0.0,0,0,0,0,0,0,0,1,0,0,1,1
8723,148389,CSh5hGbaSFu2yCb31iVMOVwKocrH471Q,fbPkOYLVPtPgIt0MxizjfFJov3JbHyAi,5,2,1,0,1,0,2,0,6,0.8571428571428571,1,0.0,0,1,0,1,2,0,0,2,0,2,4,1
8724,148653,fO1rPCd8LF1QZM5kj2eXZwLqI6uO4Zpz,A3fsA9Zfv1X2fVEQhTw51lKENdNrEqT3,26,19,15,10,10,0,2,0,56,8.0,1,0.0,1,15,9,10,18,0,1,2,0,35,21,1
8725,148694,XydvMA0BgL1Al10q3L0D2wz1Y6wVb2rC,bWdj2GDclj5ofokWjzoa5jAwMkxCykd6,11,13,8,0,6,0,4,1,32,4.571428571428571,1,0.0,2,8,0,6,11,0,0,4,1,16,16,0
8726,148830,9Se0fuNtnF0aDoUMyiU1YG9IfxiIm4MD,SpATywNh6bZuzm8s1ceuBUnMUAeoAHHw,3,0,0,0,0,0,3,0,3,0.42857142857142855,1,0.0,0,0,0,0,0,0,0,3,0,0,3,1
8727,148843,El7h5k9dEnkCTNiRD6ocpDGK1aq9r5Q4,SpATywNh6bZuzm8s1ceuBUnMUAeoAHHw,23,39,0,33,0,14,13,4,103,14.714285714285714,2,0.0,12,0,30,0,27,14,3,13,4,42,61,1
8728,148853,GMzSpgZQ6jzVsfHn8W8i83JsYNxnP00b,SpATywNh6bZuzm8s1ceuBUnMUAeoAHHw,15,21,9,18,7,0,3,0,58,8.285714285714286,2,0.0,8,9,15,7,13,0,3,3,0,39,19,0
8729,148855,i7oHLg2mT287Keuj3rMh6YGhkeP2LXJu,SpATywNh6bZuzm8s1ceuBUnMUAeoAHHw,9,16,5,12,0,0,3,0,36,5.142857142857143,1,0.0,6,5,10,0,10,0,2,3,0,21,15,0
8730,148949,KVBhg9xLiQ9g29dG7acnqU2JhAhcB1WP,SpATywNh6bZuzm8s1ceuBUnMUAeoAHHw,2,0,0,0,0,7,1,0,8,1.1428571428571428,1,0.0,0,0,0,0,0,7,0,1,0,0,8,1
8731,148972,nCi2pdM7sw91EDGAoZtmNoRGljKaB4FL,SpATywNh6bZuzm8s1ceuBUnMUAeoAHHw,12,23,9,23,5,0,1,0,61,8.714285714285714,1,0.0,13,9,19,5,10,0,4,1,0,46,15,0
8732,149077,tvs2CHlzCZXNqvPsCXS6KuyuottEQsCw,A3fsA9Zfv1X2fVEQhTw51lKENdNrEqT3,7,3,1,0,1,3,4,1,13,1.8571428571428572,1,0.0,0,1,0,1,3,3,0,4,1,2,11,1
8733,149087,SneRH8JK6KCMhHOEHp7Zi9NRJB5DLBI8,SpATywNh6bZuzm8s1ceuBUnMUAeoAHHw,10,14,1,5,1,6,2,0,29,4.142857142857143,1,0.0,6,1,4,1,8,6,1,2,0,12,17,1
8734,149109,5is3QPvmCTb2wCYPovTArJero2U5eHRU,SpATywNh6bZuzm8s1ceuBUnMUAeoAHHw,14,27,9,24,0,10,10,1,81,11.571428571428571,3,0.0,14,9,19,0,13,10,5,10,1,42,39,0
8735,149169,SG7N8DhpCuhIu06IIzLX0CSolbyIDsIx,A3fsA9Zfv1X2fVEQhTw51lKENdNrEqT3,1,0,0,0,0,0,1,0,1,0.14285714285714285,1,0.0,0,0,0,0,0,0,0,1,0,0,1,1
8736,149251,nK3rDT3I0HOsKd8MAJyaw5mnBzHCmQCb,SpATywNh6bZuzm8s1ceuBUnMUAeoAHHw,5,2,1,0,1,0,2,0,6,0.8571428571428571,1,0.0,0,1,0,1,2,0,0,2,0,2,4,1
8737,149303,qVL008tAQyHTveNNTUZJN2fiJMviNw9f,A3fsA9Zfv1X2fVEQhTw51lKENdNrEqT3,11,10,0,0,1,12,6,1,30,4.285714285714286,1,0.0,0,0,0,1,10,12,0,6,1,1,29,1
8738,149416,PFJhF2sNLYftHHb21pjL43RM5viviTlT,SpATywNh6bZuzm8s1ceuBUnMUAeoAHHw,13,17,8,8,4,0,1,0,38,5.428571428571429,1,0.0,5,8,8,4,12,0,0,1,0,25,13,0
8739,149431,I45Q3yivyiRN2kHVhbV8bUCfrXvtpUvU,SpATywNh6bZuzm8s1ceuBUnMUAeoAHHw,28,25,15,17,9,0,6,0,72,10.285714285714286,4,0.0,5,15,17,9,20,0,0,6,0,46,26,0
8740,149492,Ev6KS9MaK9gTGqPDnT9PUK5kybHZnCjh,RXDvfPUBYFlVdlueBFbLW0mhhAyGEqpt,36,61,29,21,19,15,19,3,167,23.857142857142858,4,0.0,0,29,15,19,61,15,6,19,3,63,104,1
8741,149526,CW7Zlsz0NoDYd7q0tu1Krgi9b7wpQUwQ,bWdj2GDclj5ofokWjzoa5jAwMkxCykd6,16,15,7,26,4,9,14,1,76,10.857142857142858,2,0.0,4,7,25,4,11,9,1,14,1,40,36,0
8742,149534,M6hmghWj9c26PhfYNN6D8AlzAKngSx0i,SpATywNh6bZuzm8s1ceuBUnMUAeoAHHw,1,0,1,0,0,0,0,0,1,0.14285714285714285,1,0.0,0,1,0,0,0,0,0,0,0,1,0,0
8743,149612,dhNL51CrFkHxhMt1kiIq7Iu6BdYInJEB,RXDvfPUBYFlVdlueBFbLW0mhhAyGEqpt,20,34,2,8,1,21,7,15,88,12.571428571428571,3,0.0,0,2,7,1,34,21,1,7,15,10,78,1
8744,149665,0k9erSYQLRK4wIQFPxo1tbDP6EMqZIo0,A3fsA9Zfv1X2fVEQhTw51lKENdNrEqT3,39,12,10,56,9,3,16,1,107,15.285714285714286,1,0.0,2,10,51,9,10,3,5,16,1,72,35,1
8745,149743,E7Frt6tr6owhsgLSRkD2PqDaTSKmNLId,RXDvfPUBYFlVdlueBFbLW0mhhAyGEqpt,1,0,0,0,0,0,1,0,1,0.14285714285714285,1,0.0,0,0,0,0,0,0,0,1,0,0,1,1
8746,149764,nKMPTOF6v1sp7aVmO78zmSRg9f9QXrTf,bWdj2GDclj5ofokWjzoa5jAwMkxCykd6,17,38,20,20,9,6,14,3,110,15.714285714285714,3,0.0,6,20,18,9,32,6,2,14,3,53,57,0
8747,149820,iSiPEDuhdTDGTEOpkEJzXCeneTDhblqT,A3fsA9Zfv1X2fVEQhTw51lKENdNrEqT3,9,6,4,0,3,0,1,0,14,2.0,1,0.0,0,4,0,3,6,0,0,1,0,7,7,1
8748,149821,j7cR8MulZ7sIljFq9IIvuWVX0W2fGIFM,SpATywNh6bZuzm8s1ceuBUnMUAeoAHHw,16,18,7,14,3,7,8,0,57,8.142857142857142,3,0.0,3,7,11,3,15,7,3,8,0,24,33,0
8749,149848,C8zDhaG0vPsQegBtS55u3JZHiYuueFnE,RXDvfPUBYFlVdlueBFbLW0mhhAyGEqpt,9,12,2,0,2,0,4,0,20,2.857142857142857,2,0.0,0,2,0,2,12,0,0,4,0,4,16,1
8750,149938,zEQiQScIpc1hSOgBtA0a2snrDFq0NA2H,SpATywNh6bZuzm8s1ceuBUnMUAeoAHHw,10,14,4,20,1,0,3,0,42,6.0,1,0.0,9,4,17,1,5,0,3,3,0,31,11,1
8751,150005,D5IkCYseUCO88GE1B1rMaRAAZyqCPk5T,SpATywNh6bZuzm8s1ceuBUnMUAeoAHHw,10,49,2,0,1,8,15,2,77,11.0,2,0.0,14,2,0,1,35,8,0,15,2,17,60,0
8752,150034,dU7DqQeRV0VJw1owh3rH0rASxy6mSG05,RXDvfPUBYFlVdlueBFbLW0mhhAyGEqpt,7,3,2,0,2,2,2,0,11,1.5714285714285714,1,0.0,0,2,0,2,3,2,0,2,0,4,7,1
8753,150105,G2qtWwR1edRN2N5qfu1AgRch8m00Htg9,SpATywNh6bZuzm8s1ceuBUnMUAeoAHHw,28,26,11,18,7,9,3,0,74,10.571428571428571,2,0.0,5,11,18,7,21,9,0,3,0,41,33,1
8754,152855,GPbq86k98Rz9tUbijEEopIymy9u0Fcyf,7GRhBDsirIGkRZBtSMEzNTyDr2JQm4xx,7,6,1,2,1,0,2,0,12,1.7142857142857142,2,0.0,3,1,2,1,3,0,0,2,0,7,5,1
8755,152864,hCBb0btCYW2ppCBVarI67JyCO4pJ7eb9,7GRhBDsirIGkRZBtSMEzNTyDr2JQm4xx,1,0,0,0,0,0,1,0,1,0.14285714285714285,1,0.0,0,0,0,0,0,0,0,1,0,0,1,1
8756,152879,dqSfWCCLLdDoawrlG8LB6YtjPp851gTf,7GRhBDsirIGkRZBtSMEzNTyDr2JQm4xx,1,0,0,0,0,0,1,0,1,0.14285714285714285,1,0.0,0,0,0,0,0,0,0,1,0,0,1,1
8757,152931,bKVslXuzEQ1pv4c6iV5mVjs6X6avUbmL,7GRhBDsirIGkRZBtSMEzNTyDr2JQm4xx,39,82,21,60,16,3,5,0,187,26.714285714285715,4,0.0,26,21,51,16,56,3,9,5,0,114,73,1
8758,152938,Lf93y7eBw6lMLWUxl2k8Aa6sTuqt3rkX,7GRhBDsirIGkRZBtSMEzNTyDr2JQm4xx,38,65,19,57,20,2,15,2,180,25.714285714285715,1,0.0,31,19,51,20,34,2,6,15,2,121,59,1
8759,152954,sITNvJWxCzf6WaNIdOh2TIdks7kOsSJ9,7GRhBDsirIGkRZBtSMEzNTyDr2JQm4xx,1,0,0,0,0,0,1,0,1,0.14285714285714285,1,0.0,0,0,0,0,0,0,0,1,0,0,1,1
8760,152987,AzVjKFfX4LhEl6lfJyI7leulN5tgJJFC,7GRhBDsirIGkRZBtSMEzNTyDr2JQm4xx,2,0,0,0,0,0,2,0,2,0.2857142857142857,1,0.0,0,0,0,0,0,0,0,2,0,0,2,1
8761,152991,8x5LnIwANrYRfzVuO8KI6hCDTjG995Zm,7GRhBDsirIGkRZBtSMEzNTyDr2JQm4xx,36,34,9,214,0,0,2,0,259,37.0,1,0.0,16,9,191,0,18,0,23,2,0,216,43,1
8762,152997,Bos3zEEnAcYzPXQktMkJJ0ak5mhGWCAf,7GRhBDsirIGkRZBtSMEzNTyDr2JQm4xx,40,44,15,170,0,0,3,0,232,33.142857142857146,1,0.0,17,15,159,0,27,0,11,3,0,191,41,1
8763,153006,S2jcDn3vCeFbqJDKmfQ5CtCJMDMc0dCL,7GRhBDsirIGkRZBtSMEzNTyDr2JQm4xx,1,0,0,0,0,0,1,0,1,0.14285714285714285,1,0.0,0,0,0,0,0,0,0,1,0,0,1,1
8764,153011,MU2dpqeoXpRCc5hjW6jEYEhmjukPgsDA,7GRhBDsirIGkRZBtSMEzNTyDr2JQm4xx,1,0,0,0,0,0,1,0,1,0.14285714285714285,1,0.0,0,0,0,0,0,0,0,1,0,0,1,1
8765,153055,DQfW4bOWdBOe4SfBmetTmbxwKFxrUYju,7GRhBDsirIGkRZBtSMEzNTyDr2JQm4xx,29,51,2,68,4,17,9,1,152,21.714285714285715,1,0.0,24,2,58,4,27,17,10,9,1,88,64,1
8766,153110,G1Fi5Ihmt1UntL9sxYjXIiKyHUtRhwud,7GRhBDsirIGkRZBtSMEzNTyDr2JQm4xx,1,0,0,0,0,0,1,0,1,0.14285714285714285,1,0.0,0,0,0,0,0,0,0,1,0,0,1,1
8767,153161,wFvodFqghxL7iISMFbYXkYNq6P6eK5gH,7GRhBDsirIGkRZBtSMEzNTyDr2JQm4xx,1,0,0,0,0,0,1,0,1,0.14285714285714285,1,0.0,0,0,0,0,0,0,0,1,0,0,1,1
8768,153184,VhcJDUnonrNMNnFkqYhfbm6haKp8kch0,7GRhBDsirIGkRZBtSMEzNTyDr2JQm4xx,10,16,4,0,5,4,4,0,33,4.714285714285714,1,0.0,5,4,0,5,11,4,0,4,0,14,19,1
8769,153191,eYNvtk5CsI9HdFompLA9hNZLZOidbC7w,7GRhBDsirIGkRZBtSMEzNTyDr2JQm4xx,2,0,0,0,0,0,2,0,2,0.2857142857142857,1,0.0,0,0,0,0,0,0,0,2,0,0,2,1
8770,153231,cYX89S5aEiRwSUpLGmwi2u7t2zEOcoD7,SpATywNh6bZuzm8s1ceuBUnMUAeoAHHw,6,5,3,0,2,0,3,0,13,1.8571428571428572,2,0.0,0,3,0,2,5,0,0,3,0,5,8,1
8771,153253,DKdrh8xgsWflkjgGhFow61asDvGQGw1P,bWdj2GDclj5ofokWjzoa5jAwMkxCykd6,13,33,11,98,4,3,10,2,161,23.0,2,0.0,6,11,96,4,27,3,2,10,2,117,44,1
8772,153256,KLnx64Dkkv51tfpLPbQ8sIJ698FwQUkp,bWdj2GDclj5ofokWjzoa5jAwMkxCykd6,4,2,0,0,0,0,4,0,6,0.8571428571428571,1,0.0,0,0,0,0,2,0,0,4,0,0,6,1
8773,153264,yN30P4SLRbmDewtu5A5YdbrNC6oNgNQn,SpATywNh6bZuzm8s1ceuBUnMUAeoAHHw,22,33,1,26,1,3,7,0,71,10.142857142857142,2,0.0,8,1,25,1,25,3,1,7,0,35,36,1
8774,153286,qzyzNBM5k9TrDdDhv4o4ZBzLquisQf0j,bWdj2GDclj5ofokWjzoa5jAwMkxCykd6,5,11,1,0,0,0,2,0,14,2.0,2,0.0,2,1,0,0,9,0,0,2,0,3,11,1
8775,153297,vljlAhHGhHZt2ciFpy2bQxMoEL2SUwdk,A3fsA9Zfv1X2fVEQhTw51lKENdNrEqT3,7,6,0,0,0,0,2,0,8,1.1428571428571428,1,0.0,0,0,0,0,6,0,0,2,0,0,8,1
8776,153306,I45Q3yivyiRN2kHVhbV8bUCfrXvtpUvU,A3fsA9Zfv1X2fVEQhTw51lKENdNrEqT3,9,4,3,0,3,0,2,0,12,1.7142857142857142,1,0.0,0,3,0,3,4,0,0,2,0,6,6,1
8777,153308,erktNoGO81kr4QkrHCOsCmKD0qcxd37Z,bWdj2GDclj5ofokWjzoa5jAwMkxCykd6,5,2,1,0,1,0,2,0,6,0.8571428571428571,1,0.0,0,1,0,1,2,0,0,2,0,2,4,1
8778,153326,AZlc6zt0IWDCnhebkR8dcDm8Jn7On2BO,G8EPVSXsOYB5YQWZGiz1aVq5Pgr2GrQu,3,0,0,0,0,31,9,0,40,5.714285714285714,2,0.0,0,0,0,0,0,31,0,9,0,0,40,1
8779,153339,kgtwfSxV6DlyR7XWJO7BpLSg33UPKjB8,SpATywNh6bZuzm8s1ceuBUnMUAeoAHHw,1,0,0,0,0,0,1,0,1,0.14285714285714285,1,0.0,0,0,0,0,0,0,0,1,0,0,1,1
8780,153348,rew0c3O7roxnm8EfAzYQGMCDX1NNxnod,bWdj2GDclj5ofokWjzoa5jAwMkxCykd6,5,2,1,0,1,0,2,0,6,0.8571428571428571,1,0.0,0,1,0,1,2,0,0,2,0,2,4,1
8781,153362,NAuTAy6LFtpkSTeaDzpzRRxCaq6qJCQ5,bWdj2GDclj5ofokWjzoa5jAwMkxCykd6,1,0,0,0,0,0,1,0,1,0.14285714285714285,1,0.0,0,0,0,0,0,0,0,1,0,0,1,1
8782,153375,EnaSTRqxkWjMR8pSWQe4ipdWniwPtGKE,A3fsA9Zfv1X2fVEQhTw51lKENdNrEqT3,1,0,0,0,0,0,1,0,1,0.14285714285714285,1,0.0,0,0,0,0,0,0,0,1,0,0,1,1
8783,153391,afQkAxUvdLu532EqkP2BO2E822Re7HYk,SpATywNh6bZuzm8s1ceuBUnMUAeoAHHw,1,0,0,0,0,0,1,0,1,0.14285714285714285,1,0.0,0,0,0,0,0,0,0,1,0,0,1,1
8784,153397,HQm7nMTOyi7HCPaL4vs2tkbd4DWxfE67,A3fsA9Zfv1X2fVEQhTw51lKENdNrEqT3,8,4,2,0,2,0,5,0,13,1.8571428571428572,1,0.0,1,2,0,2,3,0,0,5,0,5,8,1
8785,153405,SQBW44VzMb5zXQWTfzFzAP2RU7qxP2su,A3fsA9Zfv1X2fVEQhTw51lKENdNrEqT3,4,3,2,0,1,0,1,0,7,1.0,2,0.0,0,2,0,1,3,0,0,1,0,3,4,1
8786,153410,0akUPLtvQvvS6uDU84fTYZNIPYPvoH52,A3fsA9Zfv1X2fVEQhTw51lKENdNrEqT3,8,4,1,0,1,1,5,1,13,1.8571428571428572,1,0.0,0,1,0,1,4,1,0,5,1,2,11,1
8787,153427,BtyJK9nVdN1kc0SoyvBwk9Why1olo9fX,SpATywNh6bZuzm8s1ceuBUnMUAeoAHHw,4,2,1,0,0,0,2,0,5,0.7142857142857143,1,0.0,0,1,0,0,2,0,0,2,0,1,4,1
8788,153440,piC2LAhWCCsSJOB3RH6MaHzy9gHIudvG,RXDvfPUBYFlVdlueBFbLW0mhhAyGEqpt,1,0,0,0,0,0,1,0,1,0.14285714285714285,1,0.0,0,0,0,0,0,0,0,1,0,0,1,1
8789,153480,pwnvfCtqibSBzw9gewKZFVOUFkyHecrp,RXDvfPUBYFlVdlueBFbLW0mhhAyGEqpt,1,0,0,0,0,0,1,0,1,0.14285714285714285,1,0.0,0,0,0,0,0,0,0,1,0,0,1,1
8790,153509,EzJJd1vaXRdhAvKq2Q0XoWVWiA4HWk5i,bWdj2GDclj5ofokWjzoa5jAwMkxCykd6,7,4,1,6,1,0,7,0,19,2.7142857142857144,2,0.0,1,1,4,1,3,0,2,7,0,7,12,1
8791,153514,63urTnMQ6906ju0tncFpKl8xLgyyTd5d,SpATywNh6bZuzm8s1ceuBUnMUAeoAHHw,12,9,2,0,2,2,9,1,25,3.5714285714285716,2,0.0,0,2,0,2,9,2,0,9,1,4,21,1
8792,153534,am1ujnojA2ZUYWhKXji6KHqg6kwAFj5z,SpATywNh6bZuzm8s1ceuBUnMUAeoAHHw,7,3,2,0,2,0,2,0,9,1.2857142857142858,1,0.0,0,2,0,2,3,0,0,2,0,4,5,1
8793,153550,CfbsMYGg57bCv0HnMFe2zrw0mAeXuZTI,SpATywNh6bZuzm8s1ceuBUnMUAeoAHHw,2,0,0,0,0,0,2,0,2,0.2857142857142857,1,0.0,0,0,0,0,0,0,0,2,0,0,2,1
8794,153555,YqtqVDKc4pZH2IHRYh05LZbT8NkeJ2tA,bWdj2GDclj5ofokWjzoa5jAwMkxCykd6,10,8,3,0,2,1,8,1,23,3.2857142857142856,1,0.0,3,3,0,2,5,1,0,8,1,8,15,1
8795,153561,AxjnggPTKyT2aYQCBpgnjenDZZbNsOpc,G8EPVSXsOYB5YQWZGiz1aVq5Pgr2GrQu,6,6,2,0,2,0,5,0,15,2.142857142857143,1,0.0,0,2,0,2,6,0,0,5,0,4,11,1
8796,153566,UBlBWZ3qSNiPpjfNB2f0HBLc8JT09fQp,A3fsA9Zfv1X2fVEQhTw51lKENdNrEqT3,13,9,6,0,4,0,11,3,33,4.714285714285714,1,0.0,0,6,0,4,9,0,0,11,3,10,23,1
8797,153568,jR4AfVlqsecU2OD2EAAPnmIP3mzjfI1q,RXDvfPUBYFlVdlueBFbLW0mhhAyGEqpt,3,0,0,0,0,0,3,0,3,0.42857142857142855,1,0.0,0,0,0,0,0,0,0,3,0,0,3,1
8798,153581,6VwrXuZWbgcjNNDx17wfxtM1n4lp5Lty,SpATywNh6bZuzm8s1ceuBUnMUAeoAHHw,5,3,1,0,1,0,2,0,7,1.0,1,0.0,0,1,0,1,3,0,0,2,0,2,5,1
8799,153583,ManuYhUk0ydtDbFYHqGK5HcrqUDdhmXT,A3fsA9Zfv1X2fVEQhTw51lKENdNrEqT3,17,9,1,12,1,2,7,1,33,4.714285714285714,1,0.0,0,1,10,1,9,2,2,7,1,12,21,1
8800,153586,JtIk3EAEhmwR0FR2ilwFzJTkMTjDzXA6,bWdj2GDclj5ofokWjzoa5jAwMkxCykd6,5,4,2,0,2,0,2,0,10,1.4285714285714286,1,0.0,1,2,0,2,3,0,0,2,0,5,5,1
8801,153597,6eigRKdKORgy46hn8ZqOQWxZJBzNbSVK,SpATywNh6bZuzm8s1ceuBUnMUAeoAHHw,12,13,0,45,0,10,1,0,69,9.857142857142858,1,0.0,8,0,38,0,5,10,7,1,0,46,23,0
8802,153624,TQ1Tb2cgiG68xs6aUf696l3C3zHYq6fS,A3fsA9Zfv1X2fVEQhTw51lKENdNrEqT3,4,3,2,0,0,0,1,0,6,0.8571428571428571,1,0.0,0,2,0,0,3,0,0,1,0,2,4,1
8803,153627,Cx9UgN9CA3ZQNCspfULD8FGJJpSFtxJF,A3fsA9Zfv1X2fVEQhTw51lKENdNrEqT3,30,20,17,0,13,0,6,0,56,8.0,2,0.0,0,17,0,13,20,0,0,6,0,30,26,1
8804,153633,IRpbgsWkgoZJzwjoe9EnoRzUlAbnuMfL,SpATywNh6bZuzm8s1ceuBUnMUAeoAHHw,7,10,3,0,2,0,1,0,16,2.2857142857142856,1,0.0,0,3,0,2,10,0,0,1,0,5,11,1
8805,153667,htua1xywlnpsMMY7EJSOsurL86GI912X,SpATywNh6bZuzm8s1ceuBUnMUAeoAHHw,31,41,22,24,9,2,10,1,109,15.571428571428571,3,0.0,10,22,18,9,31,2,6,10,1,59,50,1
8806,153670,9CQfIvDiQz4gDArSnTXOgxNKUwJW75pD,G8EPVSXsOYB5YQWZGiz1aVq5Pgr2GrQu,7,5,3,0,1,0,2,0,11,1.5714285714285714,1,0.0,0,3,0,1,5,0,0,2,0,4,7,1
8807,153672,GLPmzj5hXdU3lPOHJ5T9KsJUoi44XCjZ,bWdj2GDclj5ofokWjzoa5jAwMkxCykd6,8,3,2,0,2,0,3,1,11,1.5714285714285714,1,0.0,0,2,0,2,3,0,0,3,1,4,7,1
8808,153675,ncZpzPYvUtQjJgcrnY99CiTzo4JQVsl8,A3fsA9Zfv1X2fVEQhTw51lKENdNrEqT3,1,0,0,0,0,0,1,0,1,0.14285714285714285,1,0.0,0,0,0,0,0,0,0,1,0,0,1,1
8809,153676,rMQIZQBxSTMFTRmvcfmpoYqCAUhMol3Y,bWdj2GDclj5ofokWjzoa5jAwMkxCykd6,14,38,1,58,4,2,18,8,129,18.428571428571427,3,0.0,13,1,54,4,25,2,4,18,8,72,57,0
8810,153677,ncZpzPYvUtQjJgcrnY99CiTzo4JQVsl8,RXDvfPUBYFlVdlueBFbLW0mhhAyGEqpt,1,0,0,0,0,0,1,0,1,0.14285714285714285,1,0.0,0,0,0,0,0,0,0,1,0,0,1,1
8811,153683,X9vm4W9jxNs3PEUtGGsO0Yn0aFWIbkg5,SpATywNh6bZuzm8s1ceuBUnMUAeoAHHw,11,21,8,0,0,0,2,0,31,4.428571428571429,1,0.0,6,8,0,0,15,0,0,2,0,14,17,1
8812,153696,kQrbauxiC7YRwJ9kMbwlTSfqUjp3UrEF,SpATywNh6bZuzm8s1ceuBUnMUAeoAHHw,15,12,5,19,3,0,3,0,42,6.0,3,0.0,4,5,17,3,8,0,2,3,0,29,13,1
8813,153712,GQQgnryyOjGmrLa2rKAbo7L18aO95YIN,SpATywNh6bZuzm8s1ceuBUnMUAeoAHHw,8,6,4,0,4,0,1,0,15,2.142857142857143,1,0.0,0,4,0,4,6,0,0,1,0,8,7,1
8814,153714,hMspMrStrcDDx9Uzg5qhswDwr2Wyqchl,bWdj2GDclj5ofokWjzoa5jAwMkxCykd6,5,5,4,0,1,0,1,0,11,1.5714285714285714,1,0.0,0,4,0,1,5,0,0,1,0,5,6,1
8815,153717,ikhBAd1BuMTyBJimuuSlAf6s44URi8zu,A3fsA9Zfv1X2fVEQhTw51lKENdNrEqT3,14,6,4,0,3,6,10,5,34,4.857142857142857,1,0.0,1,4,0,3,5,6,0,10,5,8,26,1
8816,153719,9AI5pszWPE25mtEwaHMtbhaDZrYN4oZ9,SpATywNh6bZuzm8s1ceuBUnMUAeoAHHw,5,2,1,0,1,0,2,0,6,0.8571428571428571,1,0.0,0,1,0,1,2,0,0,2,0,2,4,1
8817,153723,TqRaDvXJpdWXGkJNi0RDsTtg47jRUl81,bWdj2GDclj5ofokWjzoa5jAwMkxCykd6,1,0,0,0,0,0,1,0,1,0.14285714285714285,1,0.0,0,0,0,0,0,0,0,1,0,0,1,0
8818,153728,58eQNUjs318sjON50Y8nkDIw70NM1q5r,A3fsA9Zfv1X2fVEQhTw51lKENdNrEqT3,3,1,0,0,0,0,2,0,3,0.42857142857142855,1,0.0,0,0,0,0,1,0,0,2,0,0,3,1
8819,153736,PjOclk6Yw0TIvLC3mHiumPaKYTUJC7i8,G8EPVSXsOYB5YQWZGiz1aVq5Pgr2GrQu,1,0,0,0,0,0,2,0,2,0.2857142857142857,1,0.0,0,0,0,0,0,0,0,2,0,0,2,1
8820,153740,EVmZGFFbud1idCrJ2HZ0M1Xnc7jp4QF2,SpATywNh6bZuzm8s1ceuBUnMUAeoAHHw,1,0,0,0,0,0,1,0,1,0.14285714285714285,1,0.0,0,0,0,0,0,0,0,1,0,0,1,1
8821,153751,sUtQh78DXyhh3vE9rxqMUoIBjqNSKrC0,A3fsA9Zfv1X2fVEQhTw51lKENdNrEqT3,9,4,3,0,3,0,2,1,13,1.8571428571428572,1,0.0,0,3,0,3,4,0,0,2,1,6,7,1
8822,153752,sUtQh78DXyhh3vE9rxqMUoIBjqNSKrC0,bWdj2GDclj5ofokWjzoa5jAwMkxCykd6,2,0,0,0,0,0,2,0,2,0.2857142857142857,1,0.0,0,0,0,0,0,0,0,2,0,0,2,1
8823,153760,sUtQh78DXyhh3vE9rxqMUoIBjqNSKrC0,RXDvfPUBYFlVdlueBFbLW0mhhAyGEqpt,1,0,0,0,0,0,1,0,1,0.14285714285714285,1,0.0,0,0,0,0,0,0,0,1,0,0,1,1
8824,153765,JTN1G4IwNqBxpxjKApCtLeoFv6NT4I58,SpATywNh6bZuzm8s1ceuBUnMUAeoAHHw,18,28,11,18,5,10,9,1,82,11.714285714285714,3,0.0,10,11,15,5,18,10,3,9,1,41,41,1
8825,153767,mUDgTVmygSuewvWeFS0TPPpUtE7wznA7,SpATywNh6bZuzm8s1ceuBUnMUAeoAHHw,5,2,1,0,1,0,2,0,6,0.8571428571428571,1,0.0,0,1,0,1,2,0,0,2,0,2,4,0
8826,153791,qScEGLnewgguP1Ewzar5maJbQBA27NyN,SpATywNh6bZuzm8s1ceuBUnMUAeoAHHw,13,21,0,17,0,6,5,0,49,7.0,1,0.0,9,0,14,0,12,6,3,5,0,23,26,1
8827,153809,57xBvLPGpSkzxqkLuJgHQNjPmsEoPQJW,A3fsA9Zfv1X2fVEQhTw51lKENdNrEqT3,4,4,0,0,0,0,1,0,5,0.7142857142857143,1,0.0,0,0,0,0,4,0,0,1,0,0,5,1
8828,153818,LM1rmZxY7OzUOcYjeqeOXcU9AGsbnd9q,SpATywNh6bZuzm8s1ceuBUnMUAeoAHHw,5,2,1,0,1,0,2,0,6,0.8571428571428571,1,0.0,0,1,0,1,2,0,0,2,0,2,4,1
8829,153819,HkcPmWCSdk3INCYsquWGQGZKijdTCD0w,SpATywNh6bZuzm8s1ceuBUnMUAeoAHHw,15,14,2,8,1,3,9,1,38,5.428571428571429,3,0.0,2,2,7,1,12,3,1,9,1,12,26,1
8830,153821,57xBvLPGpSkzxqkLuJgHQNjPmsEoPQJW,bWdj2GDclj5ofokWjzoa5jAwMkxCykd6,3,6,0,0,0,2,1,0,9,1.2857142857142858,1,0.0,1,0,0,0,5,2,0,1,0,1,8,1
8831,153822,GmUgGkHH917kYWGPPkvD4RSeUx3CJaej,SpATywNh6bZuzm8s1ceuBUnMUAeoAHHw,15,17,0,14,0,5,7,1,44,6.285714285714286,1,0.0,10,0,11,0,7,5,3,7,1,21,23,1
8832,153823,wsHwZ3NkY1tqHKUuOn0buAOnr2acx1MP,bWdj2GDclj5ofokWjzoa5jAwMkxCykd6,3,0,0,0,0,0,3,0,3,0.42857142857142855,1,0.0,0,0,0,0,0,0,0,3,0,0,3,1
8833,153831,uhU9XFMHqXe19d0SBpTzsSNqTtdSMXBT,bWdj2GDclj5ofokWjzoa5jAwMkxCykd6,1,0,0,0,0,0,1,0,1,0.14285714285714285,1,0.0,0,0,0,0,0,0,0,1,0,0,1,1
8834,153842,bdZOWERl4VN1w1rz4KfnRlahupg4gIpq,bWdj2GDclj5ofokWjzoa5jAwMkxCykd6,10,17,10,64,0,16,7,2,116,16.571428571428573,1,0.0,3,10,62,0,14,16,2,7,2,75,41,1
8835,153862,WCBxImuXCQhe4JCGgmUbhM2fHJqNW9fo,A3fsA9Zfv1X2fVEQhTw51lKENdNrEqT3,8,11,5,0,3,0,2,0,21,3.0,1,0.0,0,5,0,3,11,0,0,2,0,8,13,1
8836,153869,Ya9PqShf5x9jueZxN5yIDpfhkNWrfHAh,RXDvfPUBYFlVdlueBFbLW0mhhAyGEqpt,9,4,4,0,3,1,3,0,15,2.142857142857143,1,0.0,0,4,0,3,4,1,0,3,0,7,8,1
8837,153871,kyU7VEeDwoGKq58Y5h10sPBzrIAFqfVi,bWdj2GDclj5ofokWjzoa5jAwMkxCykd6,5,2,1,0,1,0,2,0,6,0.8571428571428571,1,0.0,0,1,0,1,2,0,0,2,0,2,4,1
8838,153873,lHqG7UT3evpRhAVEeXMKWozC3OBfRB6b,A3fsA9Zfv1X2fVEQhTw51lKENdNrEqT3,1,0,0,0,0,0,1,0,1,0.14285714285714285,1,0.0,0,0,0,0,0,0,0,1,0,0,1,1
8839,153874,KSxx5GQKyHs39JznmMANF7eJRsaveHfw,A3fsA9Zfv1X2fVEQhTw51lKENdNrEqT3,7,6,1,0,0,2,5,1,15,2.142857142857143,1,0.0,0,1,0,0,6,2,0,5,1,1,14,1
8840,153892,d2NzzaJnxOD8hORDU0JQIrwAo12srVeO,SpATywNh6bZuzm8s1ceuBUnMUAeoAHHw,14,17,10,0,6,12,17,7,69,9.857142857142858,4,0.0,0,10,0,6,17,12,0,17,7,16,53,1
8841,153895,f3YcaJisiu4LNXF8c0nltyQqDOirQ4G3,bWdj2GDclj5ofokWjzoa5jAwMkxCykd6,8,7,4,0,2,5,5,1,24,3.4285714285714284,1,0.0,0,4,0,2,7,5,0,5,1,6,18,1
8842,153899,RuTxY8DaJW8mZYxEAeQrQJD3l4wbq41Q,bWdj2GDclj5ofokWjzoa5jAwMkxCykd6,5,3,1,0,1,0,2,0,7,1.0,1,0.0,0,1,0,1,3,0,0,2,0,2,5,1
8843,153900,idxxWwMKAxBMibSoM88bXM2M515R6wYi,SpATywNh6bZuzm8s1ceuBUnMUAeoAHHw,5,2,1,0,1,0,2,0,6,0.8571428571428571,1,0.0,0,1,0,1,2,0,0,2,0,2,4,1
8844,153903,XmbkXRvCaUzUbqcHrpRU9UVMv582qDRu,G8EPVSXsOYB5YQWZGiz1aVq5Pgr2GrQu,17,7,4,20,2,2,9,1,45,6.428571428571429,1,0.0,0,4,18,2,7,2,2,9,1,24,21,1
8845,153928,rWCtYQJxLY6x4HYR2cUOUU68SSwJtOXD,SpATywNh6bZuzm8s1ceuBUnMUAeoAHHw,1,0,0,0,0,0,1,0,1,0.14285714285714285,1,0.0,0,0,0,0,0,0,0,1,0,0,1,1
8846,153935,xCtx9oK39TlKlw1wuTfbxFcC7lD8Tvmu,SpATywNh6bZuzm8s1ceuBUnMUAeoAHHw,6,11,3,0,1,0,3,0,18,2.5714285714285716,1,0.0,0,3,0,1,11,0,0,3,0,4,14,1
8847,153936,UU4MEikmCGklRVK3djHNSk7yxxkesa3p,SpATywNh6bZuzm8s1ceuBUnMUAeoAHHw,6,5,0,0,1,0,2,0,8,1.1428571428571428,1,0.0,0,0,0,1,5,0,0,2,0,1,7,1
8848,153941,ECkqmAuIkv3ncN9wNJby8oOn15qTd9kR,A3fsA9Zfv1X2fVEQhTw51lKENdNrEqT3,1,0,0,0,0,0,1,0,1,0.14285714285714285,1,0.0,0,0,0,0,0,0,0,1,0,0,1,1
8849,153950,4IJ56QlJSL8avuRQEkrBcEyhUIO3LIP3,A3fsA9Zfv1X2fVEQhTw51lKENdNrEqT3,33,21,11,36,4,0,14,0,86,12.285714285714286,3,0.0,3,11,36,4,18,0,0,14,0,54,32,0
8850,153951,QcAEBwtOda13Q2hwEpOzUuFeV6Y52Ggz,SpATywNh6bZuzm8s1ceuBUnMUAeoAHHw,15,27,2,20,0,0,4,0,53,7.571428571428571,3,0.0,9,2,17,0,18,0,3,4,0,28,25,1
8851,153958,LhMGo1H458StfoGsiIJMkiDJEIOqqbKe,SpATywNh6bZuzm8s1ceuBUnMUAeoAHHw,18,16,11,0,8,0,2,0,37,5.285714285714286,1,0.0,3,11,0,8,13,0,0,2,0,22,15,0
8852,153988,vN0Rkga5RDQhnR6Qd8HVKAqnd5DqO9Q9,G8EPVSXsOYB5YQWZGiz1aVq5Pgr2GrQu,3,0,0,0,0,0,3,0,3,0.42857142857142855,1,0.0,0,0,0,0,0,0,0,3,0,0,3,1
8853,153989,lqbdGj6Vu3etzwWvEelu4TAXnkcY6ywX,SpATywNh6bZuzm8s1ceuBUnMUAeoAHHw,5,2,1,0,1,0,2,0,6,0.8571428571428571,1,0.0,0,1,0,1,2,0,0,2,0,2,4,1
8854,153990,wUS4QMZENKgcJOovrFGfoZniw3fDJWWg,SpATywNh6bZuzm8s1ceuBUnMUAeoAHHw,17,15,8,22,2,0,5,0,52,7.428571428571429,3,0.0,4,8,20,2,11,0,2,5,0,34,18,0
8855,153995,Bj2SxvASGVcIXgTPxMzZPlX3DzMVAgje,bWdj2GDclj5ofokWjzoa5jAwMkxCykd6,6,4,1,2,2,0,3,0,12,1.7142857142857142,1,0.0,2,1,2,2,2,0,0,3,0,7,5,1
8856,153996,7IjzbYGXgciR2DhqsqrtMeDkNMFINoYx,SpATywNh6bZuzm8s1ceuBUnMUAeoAHHw,20,37,15,5,5,1,23,1,87,12.428571428571429,2,0.0,13,15,5,5,24,1,0,23,1,38,49,1
8857,153997,zdA78Dg0BGWLvIRxkEt1PHhxNyG6hsIH,SpATywNh6bZuzm8s1ceuBUnMUAeoAHHw,1,0,0,0,0,0,1,0,1,0.14285714285714285,1,0.0,0,0,0,0,0,0,0,1,0,0,1,1
8858,154002,oO8PkmS40wsHMDT2LhD46mYGdAQ8FooI,bWdj2GDclj5ofokWjzoa5jAwMkxCykd6,15,28,11,48,8,14,5,0,114,16.285714285714285,2,0.0,10,11,45,8,18,14,3,5,0,74,40,1
8859,154011,u1aZFlVWlqtE11RPrh292EwKCdah7ek7,SpATywNh6bZuzm8s1ceuBUnMUAeoAHHw,4,2,0,0,0,0,2,0,4,0.5714285714285714,1,0.0,0,0,0,0,2,0,0,2,0,0,4,1
8860,154040,zWXhTxTG418YOfBpnhuFBg2UPPJXEdZa,SpATywNh6bZuzm8s1ceuBUnMUAeoAHHw,5,3,1,0,1,0,1,0,6,0.8571428571428571,1,0.0,0,1,0,1,3,0,0,1,0,2,4,1
8861,154056,3v4pf4Z2sq302espsMpIgHq4VUPDIN8A,SpATywNh6bZuzm8s1ceuBUnMUAeoAHHw,5,2,1,0,1,1,2,0,7,1.0,1,0.0,0,1,0,1,2,1,0,2,0,2,5,1
8862,154062,TSAIY3YjXsZdZc9oVcWWYSbgnOAvAP3E,G8EPVSXsOYB5YQWZGiz1aVq5Pgr2GrQu,5,3,1,0,1,0,2,0,7,1.0,1,0.0,0,1,0,1,3,0,0,2,0,2,5,1
8863,154066,BJOmIWRDihyZz3o40vbdAfCNe0WIbLc5,SpATywNh6bZuzm8s1ceuBUnMUAeoAHHw,6,2,1,0,1,0,3,0,7,1.0,1,0.0,0,1,0,1,2,0,0,3,0,2,5,1
8864,154076,22YNnFMji9XXRm4684KBVp3G0eZTCIft,A3fsA9Zfv1X2fVEQhTw51lKENdNrEqT3,13,8,5,0,4,0,8,0,25,3.5714285714285716,1,0.0,0,5,0,4,8,0,0,8,0,9,16,1
8865,154091,3FZ7859u0AJ285S0tHRE6ylhfDMJda8K,SpATywNh6bZuzm8s1ceuBUnMUAeoAHHw,1,0,0,0,0,0,1,0,1,0.14285714285714285,1,0.0,0,0,0,0,0,0,0,1,0,0,1,1
8866,154093,p6TgFJdLQMaMzbR16kycIPcRPnBj3paK,SpATywNh6bZuzm8s1ceuBUnMUAeoAHHw,4,2,1,0,1,0,1,0,5,0.7142857142857143,1,0.0,0,1,0,1,2,0,0,1,0,2,3,1
8867,154101,SS2LhAp5I5Z43oIfHH4Ih7CTNU5vDf5h,SpATywNh6bZuzm8s1ceuBUnMUAeoAHHw,1,0,0,0,0,0,1,0,1,0.14285714285714285,1,0.0,0,0,0,0,0,0,0,1,0,0,1,1
8868,154104,9Jy1wR1kNKfVIlzkWjf6DnrfYfDGnPzT,SpATywNh6bZuzm8s1ceuBUnMUAeoAHHw,20,26,16,12,10,16,10,1,91,13.0,3,0.0,7,16,12,10,19,16,0,10,1,45,46,0
8869,154109,Cx9AvhpaoGF7JJ71AI7APeANc2Vipt9I,SpATywNh6bZuzm8s1ceuBUnMUAeoAHHw,1,0,0,0,0,0,1,0,1,0.14285714285714285,1,0.0,0,0,0,0,0,0,0,1,0,0,1,1
8870,154111,fKBgr7W6Vaq7CaM5NPYdwouK9aGfjKnk,SpATywNh6bZuzm8s1ceuBUnMUAeoAHHw,4,3,0,0,0,0,5,0,8,1.1428571428571428,1,0.0,0,0,0,0,3,0,0,5,0,0,8,1
8871,154128,bw9Orpcerztec7DXXrZLdtk0pUJ9Agjc,RXDvfPUBYFlVdlueBFbLW0mhhAyGEqpt,12,6,1,3,1,1,3,0,15,2.142857142857143,1,0.0,1,1,3,1,5,1,0,3,0,6,9,1
8872,154145,MUAq8cgExXjyCvVsMiE64RjE0HwCMEx8,A3fsA9Zfv1X2fVEQhTw51lKENdNrEqT3,7,2,1,0,1,0,6,1,11,1.5714285714285714,1,0.0,0,1,0,1,2,0,0,6,1,2,9,1
8873,154161,YtJbqHCfQeko1zihs9n6E1Ly00ndbcI5,bWdj2GDclj5ofokWjzoa5jAwMkxCykd6,4,1,0,0,0,0,4,0,5,0.7142857142857143,1,0.0,0,0,0,0,1,0,0,4,0,0,5,1
8874,154171,2m1f0GkzC3lXY6f5kS8aatrSNoeQ2Cc4,SpATywNh6bZuzm8s1ceuBUnMUAeoAHHw,11,17,10,0,6,3,12,0,48,6.857142857142857,2,0.0,3,10,0,6,14,3,0,12,0,19,29,1
8875,154190,fZpfLVVUEp7GXISLcNFyxWveiOP0dldp,SpATywNh6bZuzm8s1ceuBUnMUAeoAHHw,8,15,0,0,0,0,1,0,16,2.2857142857142856,1,0.0,1,0,0,0,14,0,0,1,0,1,15,0
8876,154193,6HPRmmMDN5OSycgmfnsrqG7YAJbfsWTK,SpATywNh6bZuzm8s1ceuBUnMUAeoAHHw,19,25,8,29,3,0,3,0,68,9.714285714285714,2,0.0,8,8,27,3,17,0,2,3,0,46,22,1
8877,154199,bZtNzDzO2qmGZ75gSzCr8t2M40vhOtlI,A3fsA9Zfv1X2fVEQhTw51lKENdNrEqT3,9,4,2,0,1,2,10,1,20,2.857142857142857,2,0.0,0,2,0,1,4,2,0,10,1,3,17,0
8878,154200,ADL0cXowUMs4wyiAOHKMOrtTHu5tmUqi,bWdj2GDclj5ofokWjzoa5jAwMkxCykd6,15,20,12,0,6,3,15,1,57,8.142857142857142,6,0.0,0,12,0,6,20,3,0,15,1,18,39,1
8879,154221,1L7XwCOwn8nIJFjaEmGoI47SzrXbe8CM,SpATywNh6bZuzm8s1ceuBUnMUAeoAHHw,16,19,1,20,1,13,12,2,68,9.714285714285714,2,0.0,6,1,16,1,13,13,4,12,2,24,44,0
8880,154253,QweH7yTZRdri03OUSokKH99D0caZDv7H,7GRhBDsirIGkRZBtSMEzNTyDr2JQm4xx,7,4,1,0,2,1,3,0,11,1.5714285714285714,1,0.0,2,1,0,2,2,1,0,3,0,5,6,1
8881,154284,QCIxkwrtd7EyHnigeiQpqn6l0kVuCgK4,7GRhBDsirIGkRZBtSMEzNTyDr2JQm4xx,9,6,2,0,1,2,6,1,18,2.5714285714285716,1,0.0,0,2,0,1,6,2,0,6,1,3,15,1
8882,154301,Q95csmmf8N84WQQSbOMc5rN6dm3wzDuG,SpATywNh6bZuzm8s1ceuBUnMUAeoAHHw,10,20,1,11,1,2,4,0,39,5.571428571428571,1,0.0,0,1,9,1,20,2,2,4,0,11,28,0
8883,154314,ulqdtzoaFKnUas51E4T9qwtZYnxyLzzg,7GRhBDsirIGkRZBtSMEzNTyDr2JQm4xx,3,0,0,0,0,0,9,0,9,1.2857142857142858,1,0.0,0,0,0,0,0,0,0,9,0,0,9,1
8884,154361,Zz1hYW3bIv4cloYkUjUfNR6Tk0kO8ZBM,7GRhBDsirIGkRZBtSMEzNTyDr2JQm4xx,1,0,0,0,0,0,1,0,1,0.14285714285714285,1,0.0,0,0,0,0,0,0,0,1,0,0,1,1
8885,154367,EqDMtLRDV3YTsfyNsZW3gWT7QJ22Zgxb,7GRhBDsirIGkRZBtSMEzNTyDr2JQm4xx,1,0,0,0,0,0,1,0,1,0.14285714285714285,1,0.0,0,0,0,0,0,0,0,1,0,0,1,1
8886,154398,5dFDKTPyqIzDoJ1o2UMmJJhGPtehK3JJ,7GRhBDsirIGkRZBtSMEzNTyDr2JQm4xx,3,0,0,0,0,0,3,0,3,0.42857142857142855,1,0.0,0,0,0,0,0,0,0,3,0,0,3,1
8887,154407,sL5jw3pLWZoRI7avI17oM60mfF67Acgz,SpATywNh6bZuzm8s1ceuBUnMUAeoAHHw,1,0,0,0,0,0,1,0,1,0.14285714285714285,1,0.0,0,0,0,0,0,0,0,1,0,0,1,0
8888,154416,sL5jw3pLWZoRI7avI17oM60mfF67Acgz,A3fsA9Zfv1X2fVEQhTw51lKENdNrEqT3,1,0,0,0,0,0,1,0,1,0.14285714285714285,1,0.0,0,0,0,0,0,0,0,1,0,0,1,0
8889,154427,OykLnAMH2CQ2oGjpNacvJNT6LnoApkhT,7GRhBDsirIGkRZBtSMEzNTyDr2JQm4xx,2,0,0,0,0,0,2,0,2,0.2857142857142857,1,0.0,0,0,0,0,0,0,0,2,0,0,2,1
8890,154448,lhlon92qtIm50z28ydik0v6JhWIxsC1U,7GRhBDsirIGkRZBtSMEzNTyDr2JQm4xx,1,0,0,0,0,0,1,0,1,0.14285714285714285,1,0.0,0,0,0,0,0,0,0,1,0,0,1,1
8891,154474,iZp3ALNWwOETx9Rhz5RySkBkkPAlDqst,7GRhBDsirIGkRZBtSMEzNTyDr2JQm4xx,28,54,16,38,10,9,3,0,130,18.571428571428573,1,0.0,36,16,32,10,18,9,6,3,0,94,36,1
8892,154475,wMQxNrryGKgbGXsy17gJPlh2fJdDvt8s,7GRhBDsirIGkRZBtSMEzNTyDr2JQm4xx,6,3,2,0,2,0,1,0,8,1.1428571428571428,1,0.0,0,2,0,2,3,0,0,1,0,4,4,1
8893,154484,iacqYcgHTn7FZ8NE4roe5kgAUjDF0efr,7GRhBDsirIGkRZBtSMEzNTyDr2JQm4xx,13,13,7,6,5,1,13,1,46,6.571428571428571,4,0.0,2,7,5,5,11,1,1,13,1,19,27,1
8894,154517,oT3mLzHF4Tpr8bcFPMHSPaLobLxRQRsd,7GRhBDsirIGkRZBtSMEzNTyDr2JQm4xx,1,0,0,0,0,0,1,0,1,0.14285714285714285,1,0.0,0,0,0,0,0,0,0,1,0,0,1,1
8895,154521,BFTedJpOGn9f3lzS2daZGbUvWzaKCeH4,RXDvfPUBYFlVdlueBFbLW0mhhAyGEqpt,7,2,2,0,2,0,2,0,8,1.1428571428571428,1,0.0,0,2,0,2,2,0,0,2,0,4,4,1
8896,154583,asAtaJoAJHlf2G0ikRIi1BJt6dsbnxvW,7GRhBDsirIGkRZBtSMEzNTyDr2JQm4xx,19,44,2,26,4,0,15,0,91,13.0,6,0.0,16,2,22,4,28,0,4,15,0,44,47,1
8897,154596,LKQRwZ0wiIjNtxj2rwmRK6v48vwGtrYE,7GRhBDsirIGkRZBtSMEzNTyDr2JQm4xx,1,0,0,0,0,0,1,0,1,0.14285714285714285,1,0.0,0,0,0,0,0,0,0,1,0,0,1,1
8898,154635,futyrc5ZKHBBJxaxN8pRQj4FOD0yyEl8,7GRhBDsirIGkRZBtSMEzNTyDr2JQm4xx,38,107,26,64,36,2,4,0,239,34.142857142857146,3,0.0,42,26,58,36,65,2,6,4,0,162,77,1
8899,154664,wmND65rZOV8Cdq3Mq9MmFLy7XUHHSgIW,7GRhBDsirIGkRZBtSMEzNTyDr2JQm4xx,4,2,1,0,1,0,2,0,6,0.8571428571428571,1,0.0,0,1,0,1,2,0,0,2,0,2,4,1
8900,154665,wmND65rZOV8Cdq3Mq9MmFLy7XUHHSgIW,RXDvfPUBYFlVdlueBFbLW0mhhAyGEqpt,23,22,10,28,5,8,6,0,79,11.285714285714286,1,0.0,4,10,24,5,18,8,4,6,0,43,36,1
8901,154673,Bb6y6KL5R1oXKLejmEf2ogmY60nmHSEg,7GRhBDsirIGkRZBtSMEzNTyDr2JQm4xx,15,19,0,4,0,1,6,0,30,4.285714285714286,1,0.0,4,0,4,0,15,1,0,6,0,8,22,1
8902,154719,bQS9TypVeSJHdaY7Zz5SfbkFkeJ7Xy7P,G8EPVSXsOYB5YQWZGiz1aVq5Pgr2GrQu,11,9,1,0,0,3,9,1,23,3.2857142857142856,1,0.0,0,1,0,0,9,3,0,9,1,1,22,1
8903,154721,JkBKsyFO0Yc8vpbIVFPRsgPENSXQYzwJ,7GRhBDsirIGkRZBtSMEzNTyDr2JQm4xx,7,4,3,0,3,0,3,0,13,1.8571428571428572,1,0.0,0,3,0,3,4,0,0,3,0,6,7,1
8904,154750,9022MHPvnYCQFW4Qbw5KRQ2IXKBbqJc6,7GRhBDsirIGkRZBtSMEzNTyDr2JQm4xx,9,4,3,0,0,6,7,1,21,3.0,1,0.0,0,3,0,0,4,6,0,7,1,3,18,1
8905,154759,9g6cYAmFbDY0CjADcdMWUoQ4H4YvgLXQ,7GRhBDsirIGkRZBtSMEzNTyDr2JQm4xx,1,0,0,0,0,0,1,0,1,0.14285714285714285,1,0.0,0,0,0,0,0,0,0,1,0,0,1,1
8906,154764,BPDxtvSmkKR4nTdKjes8gGxzoOprTkK2,SpATywNh6bZuzm8s1ceuBUnMUAeoAHHw,16,22,12,19,8,8,8,1,78,11.142857142857142,2,0.0,6,12,16,8,16,8,3,8,1,42,36,1
8907,154820,Xf0Og50NXKhKGIY0WPfCy8ERJ7r6XgJl,7GRhBDsirIGkRZBtSMEzNTyDr2JQm4xx,1,0,0,0,0,0,1,0,1,0.14285714285714285,1,0.0,0,0,0,0,0,0,0,1,0,0,1,1
8908,154862,I1340YsGXK2BIG96XRWppOvFniqpKDu7,7GRhBDsirIGkRZBtSMEzNTyDr2JQm4xx,1,0,0,0,0,0,1,0,1,0.14285714285714285,1,0.0,0,0,0,0,0,0,0,1,0,0,1,1
8909,154911,yGvIE15GH4VA1DDC2IJtfMXXasgYhTMz,7GRhBDsirIGkRZBtSMEzNTyDr2JQm4xx,1,0,0,0,0,0,1,0,1,0.14285714285714285,1,0.0,0,0,0,0,0,0,0,1,0,0,1,1
8910,154913,j9DMqIZkavMsFdWoxVo3EuIrdKBeRzf9,RXDvfPUBYFlVdlueBFbLW0mhhAyGEqpt,46,44,24,47,15,5,9,0,144,20.571428571428573,1,0.0,12,24,47,15,32,5,0,9,0,98,46,1
8911,154940,MxhxHMlOpo3bTyeulVXY5tLPOxuKgX9g,RXDvfPUBYFlVdlueBFbLW0mhhAyGEqpt,10,5,4,0,2,2,4,3,20,2.857142857142857,1,0.0,0,4,0,2,5,2,0,4,3,6,14,1
8912,155027,PexOV0LWT1fDCzyfhjsaD6ViAyGfZwtP,SpATywNh6bZuzm8s1ceuBUnMUAeoAHHw,2,0,0,0,0,0,2,0,2,0.2857142857142857,1,0.0,0,0,0,0,0,0,0,2,0,0,2,1
8913,155048,OqBkXI62rrUk2ckZzlCRqJd1hz7KQTiD,7GRhBDsirIGkRZBtSMEzNTyDr2JQm4xx,15,27,1,12,3,0,3,1,47,6.714285714285714,1,0.0,15,1,10,3,12,0,2,3,1,29,18,1
8914,155050,791uZs1oletLjsDrEfx07tDuNe91zVsB,7GRhBDsirIGkRZBtSMEzNTyDr2JQm4xx,7,3,2,0,2,0,2,0,9,1.2857142857142858,1,0.0,0,2,0,2,3,0,0,2,0,4,5,1
8915,155101,JbB7hpnQ5hVzqELznLtzJLRyOZ2rdnyH,A3fsA9Zfv1X2fVEQhTw51lKENdNrEqT3,27,19,10,58,0,19,14,1,121,17.285714285714285,2,0.0,3,10,50,0,16,19,8,14,1,63,58,1
8916,155102,JbB7hpnQ5hVzqELznLtzJLRyOZ2rdnyH,7GRhBDsirIGkRZBtSMEzNTyDr2JQm4xx,4,2,1,0,1,0,1,0,5,0.7142857142857143,1,0.0,0,1,0,1,2,0,0,1,0,2,3,1
8917,155129,t8qBiDTvOvYmrxcVIErRuEOf38tywm6t,7GRhBDsirIGkRZBtSMEzNTyDr2JQm4xx,26,46,22,30,13,36,4,1,152,21.714285714285715,1,0.0,19,22,25,13,27,36,5,4,1,79,73,1
8918,155141,PUySp8Qi7ahosRvBWR6xsbTAmeC3pRdT,SpATywNh6bZuzm8s1ceuBUnMUAeoAHHw,24,45,21,14,7,3,15,0,105,15.0,5,0.0,6,21,12,7,39,3,2,15,0,46,59,0
8919,155157,YBxdZNwXHdHfvV2eXmAcEoLMgpOYOPHS,7GRhBDsirIGkRZBtSMEzNTyDr2JQm4xx,9,8,5,8,5,0,2,0,28,4.0,1,0.0,3,5,7,5,5,0,1,2,0,20,8,1
8920,155173,JHfmlel9KNxicHtEPCs7j50mTEJgnt8P,7GRhBDsirIGkRZBtSMEzNTyDr2JQm4xx,1,0,0,0,0,0,1,0,1,0.14285714285714285,1,0.0,0,0,0,0,0,0,0,1,0,0,1,1
8921,155247,NfNQzrIJhmgRP7158cjFmvfhx6PtMoIG,7GRhBDsirIGkRZBtSMEzNTyDr2JQm4xx,7,0,0,0,0,2,6,1,9,1.2857142857142858,1,0.0,0,0,0,0,0,2,0,6,1,0,9,1
8922,155268,5WJ9TRmJQHZjCB6N96s5yxRqedfFf2EC,7GRhBDsirIGkRZBtSMEzNTyDr2JQm4xx,5,2,1,0,1,0,2,0,6,0.8571428571428571,1,0.0,0,1,0,1,2,0,0,2,0,2,4,1
8923,155315,2DvkJl9UVozMaO0xGaO2ndEJOUw63HiE,7GRhBDsirIGkRZBtSMEzNTyDr2JQm4xx,4,2,1,0,1,0,1,0,5,0.7142857142857143,1,0.0,0,1,0,1,2,0,0,1,0,2,3,1
8924,155324,Bw1W3aypNX1U28lPbdggaNPof0tcfoYy,7GRhBDsirIGkRZBtSMEzNTyDr2JQm4xx,12,27,7,10,6,0,3,0,53,7.571428571428571,2,0.0,6,7,8,6,21,0,2,3,0,27,26,1
8925,155398,V6OdAS3CbYkwbVZibmDB3Td15gp0rTCi,7GRhBDsirIGkRZBtSMEzNTyDr2JQm4xx,4,2,1,0,1,0,1,0,5,0.7142857142857143,1,0.0,0,1,0,1,2,0,0,1,0,2,3,1
8926,155458,anKy5XeCNcJg717tYlt4WP7NvJptZoH3,RXDvfPUBYFlVdlueBFbLW0mhhAyGEqpt,26,17,16,0,12,0,23,1,69,9.857142857142858,4,0.0,0,16,0,12,17,0,0,23,1,28,41,1
8927,155562,f7tZxTkA0B7yOxMWeydGO2hW0y86mAhD,RXDvfPUBYFlVdlueBFbLW0mhhAyGEqpt,13,7,5,0,5,0,4,0,21,3.0,1,0.0,1,5,0,5,6,0,0,4,0,11,10,1
8928,155581,2ZRBFnStzt5cjrck9eS6oYGoTRuicZMh,G8EPVSXsOYB5YQWZGiz1aVq5Pgr2GrQu,9,8,1,0,1,0,2,0,12,1.7142857142857142,1,0.0,0,1,0,1,8,0,0,2,0,2,10,1
8929,155618,s6FY1tnJFeJCup1Eko54ROGWiTGeTtYm,SpATywNh6bZuzm8s1ceuBUnMUAeoAHHw,1,0,0,0,0,0,1,0,1,0.14285714285714285,1,0.0,0,0,0,0,0,0,0,1,0,0,1,0
8930,156083,65WrAm7LwtsX3nVDTLh1bnXt0L79cL04,bWdj2GDclj5ofokWjzoa5jAwMkxCykd6,1,0,0,0,0,0,1,0,1,0.14285714285714285,1,0.0,0,0,0,0,0,0,0,1,0,0,1,0
8931,156211,KDWP2k3afTGhSxEaH7oA3UMXbJchV5C0,SpATywNh6bZuzm8s1ceuBUnMUAeoAHHw,6,4,1,0,1,0,2,0,8,1.1428571428571428,1,0.0,0,1,0,1,4,0,0,2,0,2,6,0
8932,156248,2rcvhx1rR5YxLdJduMzgm4BAqYgFhtji,G8EPVSXsOYB5YQWZGiz1aVq5Pgr2GrQu,2,0,0,0,0,0,2,0,2,0.2857142857142857,1,0.0,0,0,0,0,0,0,0,2,0,0,2,1
8933,156260,TVPORDuXFZycPf0Vi3wZKRTY1n2f7P3G,A3fsA9Zfv1X2fVEQhTw51lKENdNrEqT3,17,18,7,14,2,14,20,3,78,11.142857142857142,1,0.0,1,7,13,2,17,14,1,20,3,23,55,1
8934,156384,eQeAZJfAlQDBFNhBayGkUGtYxXtMJqJ1,A3fsA9Zfv1X2fVEQhTw51lKENdNrEqT3,7,8,6,0,1,0,2,0,17,2.4285714285714284,1,0.0,0,6,0,1,8,0,0,2,0,7,10,1
8935,156452,kiukAy7oxipXUU8Ys4wcsL36Pp7URsoj,RXDvfPUBYFlVdlueBFbLW0mhhAyGEqpt,9,8,0,0,0,0,3,0,11,1.5714285714285714,1,0.0,0,0,0,0,8,0,0,3,0,0,11,0
8936,156559,Un3EzEE4Sz8i5Z84q9e50URbIAEkkVSB,bWdj2GDclj5ofokWjzoa5jAwMkxCykd6,8,5,1,0,1,1,7,1,16,2.2857142857142856,1,0.0,0,1,0,1,5,1,0,7,1,2,14,1
8937,156571,OLSxCkluLildKVrVnzRIsj47tt9tVHj9,RXDvfPUBYFlVdlueBFbLW0mhhAyGEqpt,1,0,0,0,0,0,1,0,1,0.14285714285714285,1,0.0,0,0,0,0,0,0,0,1,0,0,1,1
8938,156708,qzgqMBszLUnJd9ZV8Zyg9x0an59yJyuH,A3fsA9Zfv1X2fVEQhTw51lKENdNrEqT3,49,46,31,64,16,8,21,1,187,26.714285714285715,3,0.0,2,31,57,16,44,8,7,21,1,106,81,1
8939,156757,MOcMwRKo0dtFqZ5xWBgRzquuZGKtQyf4,bWdj2GDclj5ofokWjzoa5jAwMkxCykd6,4,2,1,0,1,0,1,0,5,0.7142857142857143,1,0.0,0,1,0,1,2,0,0,1,0,2,3,1
8940,157312,9FHojamNYxBNrQ6PYQ6fNVNJw4Al6wFf,7GRhBDsirIGkRZBtSMEzNTyDr2JQm4xx,28,69,4,8,8,3,17,2,111,15.857142857142858,1,0.0,28,4,6,8,41,3,2,17,2,46,65,1
8941,157338,cOx2ivO0cjd2S3OxGikx2UdSMlRcgy0Q,7GRhBDsirIGkRZBtSMEzNTyDr2JQm4xx,1,0,0,0,0,0,1,0,1,0.14285714285714285,1,0.0,0,0,0,0,0,0,0,1,0,0,1,1
8942,157493,oBNu1yheXNm4QzvTpRG6uVhpeMCjpi7n,7GRhBDsirIGkRZBtSMEzNTyDr2JQm4xx,20,15,12,10,10,0,2,0,49,7.0,1,0.0,2,12,10,10,13,0,0,2,0,34,15,1
8943,160678,08OTJovI4mN1P4AUjCgqGCGzY3HAu3jj,A3fsA9Zfv1X2fVEQhTw51lKENdNrEqT3,1,0,0,0,0,0,1,0,1,0.14285714285714285,1,0.0,0,0,0,0,0,0,0,1,0,0,1,1
8944,160775,ZgNdO7hyoQRmg00lVh0JR0YxTL2sBLXr,SpATywNh6bZuzm8s1ceuBUnMUAeoAHHw,6,1,1,0,0,0,15,1,18,2.5714285714285716,1,0.0,0,1,0,0,1,0,0,15,1,1,17,0
8945,160837,3f8TEYsxw8fTx61szmPewZsIJHdQMPuP,SpATywNh6bZuzm8s1ceuBUnMUAeoAHHw,15,11,6,12,3,13,11,0,56,8.0,1,0.0,3,6,12,3,8,13,0,11,0,24,32,0
8946,160842,ffjWC7PpsqUyQ4g8h9cR2OgJ4csHrEGY,7GRhBDsirIGkRZBtSMEzNTyDr2JQm4xx,1,0,0,0,0,0,1,0,1,0.14285714285714285,1,0.0,0,0,0,0,0,0,0,1,0,0,1,1
8947,160956,3G8UKlMnri0uMjx4kTUdEFUnuVu9MqyS,7GRhBDsirIGkRZBtSMEzNTyDr2JQm4xx,4,4,1,0,2,0,2,0,9,1.2857142857142858,1,0.0,2,1,0,2,2,0,0,2,0,5,4,1
8948,160963,W4swLEiF6xa4CU1Ee5z4jQMNXyEDiyxR,SpATywNh6bZuzm8s1ceuBUnMUAeoAHHw,4,2,0,0,0,2,2,0,6,0.8571428571428571,1,0.0,0,0,0,0,2,2,0,2,0,0,6,1
8949,160991,fDaxh7N7NdJHdXsnAIuELHd50CNN3hz9,7GRhBDsirIGkRZBtSMEzNTyDr2JQm4xx,2,0,0,0,0,0,2,0,2,0.2857142857142857,1,0.0,0,0,0,0,0,0,0,2,0,0,2,1
8950,161071,kD7KrEgPns8NN7pPH4RunWGvMBAYF6OW,7GRhBDsirIGkRZBtSMEzNTyDr2JQm4xx,4,2,0,0,0,0,3,0,5,0.7142857142857143,1,0.0,0,0,0,0,2,0,0,3,0,0,5,1
8951,161076,BbvGM92sGSMMIrRMXDFdD1GEnySzXRYT,A3fsA9Zfv1X2fVEQhTw51lKENdNrEqT3,1,0,0,0,0,0,1,0,1,0.14285714285714285,1,0.0,0,0,0,0,0,0,0,1,0,0,1,0
8952,161079,JDFQZtkjaBhYZM0MLFNIDJC3MmDM3j4N,SpATywNh6bZuzm8s1ceuBUnMUAeoAHHw,17,16,9,10,4,12,13,1,65,9.285714285714286,3,0.0,5,9,8,4,11,12,2,13,1,26,39,0
8953,161120,bAABlYXwSxLGjyoM2mZWwlEcMoay9TKF,7GRhBDsirIGkRZBtSMEzNTyDr2JQm4xx,34,49,20,36,13,13,25,8,164,23.428571428571427,1,0.0,23,20,33,13,26,13,3,25,8,89,75,1
8954,161146,wKtjicmtXDLrlymiwnuOgL0XJQtQSxfX,7GRhBDsirIGkRZBtSMEzNTyDr2JQm4xx,2,0,0,0,0,0,2,0,2,0.2857142857142857,1,0.0,0,0,0,0,0,0,0,2,0,0,2,1
8955,161208,FgKGJkcyrlk2UGTZTaDtYvcpTKr0lNLA,7GRhBDsirIGkRZBtSMEzNTyDr2JQm4xx,11,12,6,10,4,0,7,0,39,5.571428571428571,2,0.0,4,6,8,4,8,0,2,7,0,22,17,1
8956,161246,B5jlZpEDxUNGCe4UQsaYbJ99Z8y5d2lN,A3fsA9Zfv1X2fVEQhTw51lKENdNrEqT3,1,0,0,0,0,0,1,0,1,0.14285714285714285,1,0.0,0,0,0,0,0,0,0,1,0,0,1,0
8957,161273,vuVnTFCBfdzSvUffWnstx1XETLzOHwWp,SpATywNh6bZuzm8s1ceuBUnMUAeoAHHw,9,10,6,0,5,0,1,0,22,3.142857142857143,1,0.0,0,6,0,5,10,0,0,1,0,11,11,0
8958,161290,jMYQxsCNKY5cLAg44E5z2BIKSAvgdfQc,7GRhBDsirIGkRZBtSMEzNTyDr2JQm4xx,5,2,1,0,1,0,2,0,6,0.8571428571428571,1,0.0,0,1,0,1,2,0,0,2,0,2,4,1
8959,161386,adfbW7xBPY784GRXAIq3fInFogIbD6ro,SpATywNh6bZuzm8s1ceuBUnMUAeoAHHw,15,13,6,8,0,2,9,2,40,5.714285714285714,1,0.0,5,6,7,0,8,2,1,9,2,18,22,0
8960,161412,uqHSgHtPqI0pLXHTpUBns1eF4e9jsvt1,7GRhBDsirIGkRZBtSMEzNTyDr2JQm4xx,1,0,0,0,0,0,1,0,1,0.14285714285714285,1,0.0,0,0,0,0,0,0,0,1,0,0,1,1
8961,161465,QwzgqwSHCQGBlqpFzwe8sYcM8CZG7iZ9,SpATywNh6bZuzm8s1ceuBUnMUAeoAHHw,6,5,1,0,1,0,3,0,10,1.4285714285714286,1,0.0,0,1,0,1,5,0,0,3,0,2,8,1
8962,161577,Khe9KlmSoSTsax6cgkl9d8UgiAE6YdMj,7GRhBDsirIGkRZBtSMEzNTyDr2JQm4xx,8,6,3,0,1,0,3,0,13,1.8571428571428572,1,0.0,0,3,0,1,6,0,0,3,0,4,9,1
8963,161606,JyZKV6Cx4T3sb5lEewrPu89ztBDJpjHB,7GRhBDsirIGkRZBtSMEzNTyDr2JQm4xx,1,0,0,0,0,0,1,0,1,0.14285714285714285,1,0.0,0,0,0,0,0,0,0,1,0,0,1,1
8964,161622,0PgvslXgC0pgpIZFL5uHzeqmbNWkjEcF,7GRhBDsirIGkRZBtSMEzNTyDr2JQm4xx,15,17,1,0,1,6,7,1,33,4.714285714285714,1,0.0,2,1,0,1,15,6,0,7,1,4,29,1
8965,161667,q1QqcOJEpZrZKGZXfigMjZ8ytnCI74VX,7GRhBDsirIGkRZBtSMEzNTyDr2JQm4xx,2,0,0,0,0,0,2,0,2,0.2857142857142857,1,0.0,0,0,0,0,0,0,0,2,0,0,2,1
8966,161706,2XDpaAo3slMsrFQXFgtVX89IlqkzpX74,7GRhBDsirIGkRZBtSMEzNTyDr2JQm4xx,25,46,4,45,0,9,4,0,108,15.428571428571429,2,0.0,23,4,37,0,23,9,8,4,0,64,44,1
8967,161713,ySy2zYThCkVZr5MjEXuKxq60wfOynxkJ,7GRhBDsirIGkRZBtSMEzNTyDr2JQm4xx,1,0,0,0,0,0,1,0,1,0.14285714285714285,1,0.0,0,0,0,0,0,0,0,1,0,0,1,1
8968,161720,xdxiKeJYKflgdr88D3HSJXuR1e81YpjG,7GRhBDsirIGkRZBtSMEzNTyDr2JQm4xx,11,10,3,6,3,0,4,1,27,3.857142857142857,2,0.0,5,3,6,3,5,0,0,4,1,17,10,1
8969,161747,i7uheDJIh5lOS1HvZimsF1kp1fKEvbnh,7GRhBDsirIGkRZBtSMEzNTyDr2JQm4xx,1,0,0,0,0,0,1,0,1,0.14285714285714285,1,0.0,0,0,0,0,0,0,0,1,0,0,1,1
8970,161754,Xipj7T5lLiw1KZ1W0l4R2RMWExB1p24F,7GRhBDsirIGkRZBtSMEzNTyDr2JQm4xx,1,0,0,0,0,0,2,0,2,0.2857142857142857,2,0.0,0,0,0,0,0,0,0,2,0,0,2,1
8971,161876,rwuM6JXyr9NW5skD2mjToJGXTpHNXOXm,7GRhBDsirIGkRZBtSMEzNTyDr2JQm4xx,14,11,5,4,4,4,11,0,39,5.571428571428571,2,0.0,3,5,3,4,8,4,1,11,0,15,24,1
8972,161903,UtNvwiEIu7iQRo2Po9FxglHJbAYaDW68,7GRhBDsirIGkRZBtSMEzNTyDr2JQm4xx,34,69,4,81,1,23,10,0,188,26.857142857142858,4,0.0,39,4,65,1,30,23,16,10,0,109,79,0
8973,161916,UwYS4S13mN9PKtlnG61IUx3MqUPXsSwd,7GRhBDsirIGkRZBtSMEzNTyDr2JQm4xx,1,0,0,0,0,0,1,0,1,0.14285714285714285,1,0.0,0,0,0,0,0,0,0,1,0,0,1,1
8974,161917,ClHMnOLy9vZKRtNjcA9yPWajeNvRCNdE,7GRhBDsirIGkRZBtSMEzNTyDr2JQm4xx,56,109,23,119,17,1,4,0,273,39.0,2,0.0,48,23,106,17,61,1,13,4,0,194,79,1
8975,161935,uKGXhzbiDEpxCHjVlf9dmkGcQbxLosVe,7GRhBDsirIGkRZBtSMEzNTyDr2JQm4xx,18,16,11,0,8,1,9,1,46,6.571428571428571,2,0.0,0,11,0,8,16,1,0,9,1,19,27,1
8976,161939,5kEshmgSAUGvBEOsnsKU8IViB0lkOwoD,7GRhBDsirIGkRZBtSMEzNTyDr2JQm4xx,10,5,0,48,0,0,2,0,55,7.857142857142857,1,0.0,2,0,43,0,3,0,5,2,0,45,10,1
8977,161972,MXpZg6Y3WvwOURUS1VvgXTxhk1pXKVY7,7GRhBDsirIGkRZBtSMEzNTyDr2JQm4xx,13,11,5,12,6,0,1,0,35,5.0,1,0.0,5,5,10,6,6,0,2,1,0,26,9,1
8978,161994,ePOpOKycvORTPdc6DfieYb44dd8ej3gR,7GRhBDsirIGkRZBtSMEzNTyDr2JQm4xx,1,0,0,0,0,0,1,0,1,0.14285714285714285,1,0.0,0,0,0,0,0,0,0,1,0,0,1,1
8979,162062,J8ozccvPLhHs7wXw9VrsAZ8xFj3qhhGw,7GRhBDsirIGkRZBtSMEzNTyDr2JQm4xx,9,14,6,4,1,1,3,0,29,4.142857142857143,2,0.0,2,6,3,1,12,1,1,3,0,12,17,1
8980,162105,iJS4NO25TGJOkDkxwNThNbes0mRasAmQ,7GRhBDsirIGkRZBtSMEzNTyDr2JQm4xx,19,19,11,16,12,0,4,0,62,8.857142857142858,2,0.0,4,11,14,12,15,0,2,4,0,41,21,1
8981,162121,jjgQ4rbsYW6nenx45QcLulM61xyCV5lA,7GRhBDsirIGkRZBtSMEzNTyDr2JQm4xx,1,0,0,0,0,0,1,0,1,0.14285714285714285,1,0.0,0,0,0,0,0,0,0,1,0,0,1,1
8982,162160,oBhK6ZD6VFllj6i4Noya3bCJzaI8iNet,7GRhBDsirIGkRZBtSMEzNTyDr2JQm4xx,1,0,0,0,0,0,1,0,1,0.14285714285714285,1,0.0,0,0,0,0,0,0,0,1,0,0,1,1
8983,162259,ZttplEH5TKj1WzPyzoO9Df2vFzi15P8B,7GRhBDsirIGkRZBtSMEzNTyDr2JQm4xx,5,2,1,0,1,0,2,0,6,0.8571428571428571,1,0.0,0,1,0,1,2,0,0,2,0,2,4,0
8984,162270,CXpq1UcG0elhHuiCZeD2FXcwR7rCcPqM,7GRhBDsirIGkRZBtSMEzNTyDr2JQm4xx,1,0,0,0,0,0,1,0,1,0.14285714285714285,1,0.0,0,0,0,0,0,0,0,1,0,0,1,1
8985,162310,IY2XGmMLdQpnN2CAArJJlJXjbbQc8pm5,7GRhBDsirIGkRZBtSMEzNTyDr2JQm4xx,9,3,3,0,3,0,4,1,14,2.0,1,0.0,0,3,0,3,3,0,0,4,1,6,8,1
8986,162313,Ql4EosuzRo0tVj3lvTLhkLOyEsWZly6m,7GRhBDsirIGkRZBtSMEzNTyDr2JQm4xx,18,17,6,27,7,3,4,0,64,9.142857142857142,1,0.0,8,6,24,7,9,3,3,4,0,45,19,1
8987,162315,eLddk0FueVUEJUwpfOsyoO4vLUtPFHIZ,7GRhBDsirIGkRZBtSMEzNTyDr2JQm4xx,2,0,0,0,0,0,2,0,2,0.2857142857142857,1,0.0,0,0,0,0,0,0,0,2,0,0,2,1
8988,162321,FRqEtBjptiNhO97ht9j9vzryGlyCBOWn,7GRhBDsirIGkRZBtSMEzNTyDr2JQm4xx,1,0,0,0,0,0,1,0,1,0.14285714285714285,1,0.0,0,0,0,0,0,0,0,1,0,0,1,1
8989,162361,SRWyybFCyRnJ5WkAnmW9p9zBXOYVWjli,7GRhBDsirIGkRZBtSMEzNTyDr2JQm4xx,8,4,3,0,3,0,3,1,14,2.0,1,0.0,0,3,0,3,4,0,0,3,1,6,8,1
8990,162368,1YVvREjW4GG7vGtDdZTgfavzuWoJyEQ1,7GRhBDsirIGkRZBtSMEzNTyDr2JQm4xx,3,2,1,0,0,0,1,0,4,0.5714285714285714,1,0.0,0,1,0,0,2,0,0,1,0,1,3,1
8991,162648,Nc3ZZeizgzMQ7ljgRcfUdDiH0EOAXMpI,fbPkOYLVPtPgIt0MxizjfFJov3JbHyAi,4,2,1,0,1,0,1,0,5,0.7142857142857143,1,0.0,0,1,0,1,2,0,0,1,0,2,3,1
8992,162649,0KUBjckzhPh04pcpref906kWaVGOckIo,fbPkOYLVPtPgIt0MxizjfFJov3JbHyAi,1,0,0,0,0,0,1,0,1,0.14285714285714285,1,0.0,0,0,0,0,0,0,0,1,0,0,1,1
8993,162650,V6E1tx9saR5jAji0JFYWv5QlYX2evnTz,fbPkOYLVPtPgIt0MxizjfFJov3JbHyAi,5,4,1,0,1,0,1,0,7,1.0,1,0.0,0,1,0,1,4,0,0,1,0,2,5,1
8994,162651,YowQZlyvBksxQT6KgTXhQMJmbU93kRLD,fbPkOYLVPtPgIt0MxizjfFJov3JbHyAi,9,4,3,0,2,0,6,0,15,2.142857142857143,2,0.0,0,3,0,2,4,0,0,6,0,5,10,1
8995,162652,ez8FDX1i0b7pyEME5JxBBRyGHo5i1NxT,fbPkOYLVPtPgIt0MxizjfFJov3JbHyAi,5,2,1,0,1,0,11,0,15,2.142857142857143,1,0.0,0,1,0,1,2,0,0,11,0,2,13,1
8996,162656,KSRVmTGtqcEHSDvxEeA6R7dUXFztkOiS,fbPkOYLVPtPgIt0MxizjfFJov3JbHyAi,9,3,2,0,2,1,10,0,18,2.5714285714285716,1,0.0,0,2,0,2,3,1,0,10,0,4,14,1
8997,162657,2D1HXSTD406ltsrZw4ApG5jDeXzE2KN2,fbPkOYLVPtPgIt0MxizjfFJov3JbHyAi,9,4,3,0,3,0,6,1,17,2.4285714285714284,1,0.0,0,3,0,3,4,0,0,6,1,6,11,1
8998,162658,xC5auIx5EjJCsJXVxhOLOCVWQh5LEXXH,fbPkOYLVPtPgIt0MxizjfFJov3JbHyAi,6,7,4,0,0,0,1,0,12,1.7142857142857142,1,0.0,0,4,0,0,7,0,0,1,0,4,8,1
8999,162659,WSgIm6djd7gHeBntYx8K78vnaXdzEUiL,fbPkOYLVPtPgIt0MxizjfFJov3JbHyAi,1,0,0,0,0,0,1,0,1,0.14285714285714285,1,0.0,0,0,0,0,0,0,0,1,0,0,1,1
9000,162660,llYG1mfEDeV8Y5AFdIVbdEPymP3mr3rj,fbPkOYLVPtPgIt0MxizjfFJov3JbHyAi,6,2,1,0,1,0,3,0,7,1.0,1,0.0,0,1,0,1,2,0,0,3,0,2,5,1
9001,162661,KZBxo2oXfcrXYFa3c9hEkQ12gjuvG6yO,fbPkOYLVPtPgIt0MxizjfFJov3JbHyAi,13,18,8,0,4,0,6,0,36,5.142857142857143,1,0.0,1,8,0,4,17,0,0,6,0,13,23,1
9002,162666,naFnVVivN8IeDypOt2hjD9CIwDCj76XP,fbPkOYLVPtPgIt0MxizjfFJov3JbHyAi,9,4,3,0,3,0,4,0,14,2.0,1,0.0,0,3,0,3,4,0,0,4,0,6,8,1
9003,162671,MH888ZUNYQEtzY7davmN9IOBnnNRrZa7,fbPkOYLVPtPgIt0MxizjfFJov3JbHyAi,2,0,0,0,0,0,6,0,6,0.8571428571428571,1,0.0,0,0,0,0,0,0,0,6,0,0,6,1
9004,162673,7l3GpI16MslYkR5zIHoJyawqfDaUFhUp,fbPkOYLVPtPgIt0MxizjfFJov3JbHyAi,15,33,10,16,13,7,8,0,87,12.428571428571429,3,0.0,15,10,13,13,18,7,3,8,0,51,36,1
9005,162676,yYnx2Djc2xdWmysqfYS5LaytJ644aZht,fbPkOYLVPtPgIt0MxizjfFJov3JbHyAi,10,14,7,0,6,3,6,1,37,5.285714285714286,1,0.0,4,7,0,6,10,3,0,6,1,17,20,1
9006,162678,QLkjPbhzjYBuoRyN6jpM1zgzPhFcXPgV,fbPkOYLVPtPgIt0MxizjfFJov3JbHyAi,7,2,1,0,1,0,6,1,11,1.5714285714285714,1,0.0,0,1,0,1,2,0,0,6,1,2,9,1
9007,162679,4wGoSTuzJXBCojeNmaxk9GbR1KaCV7ql,fbPkOYLVPtPgIt0MxizjfFJov3JbHyAi,1,0,0,0,0,0,1,0,1,0.14285714285714285,1,0.0,0,0,0,0,0,0,0,1,0,0,1,1
9008,162680,Zt0s8z7D4BOSO5NcolkhNghzd1kCk6hq,fbPkOYLVPtPgIt0MxizjfFJov3JbHyAi,1,0,0,0,0,0,1,0,1,0.14285714285714285,1,0.0,0,0,0,0,0,0,0,1,0,0,1,1
9009,162681,uoKTE5T5YjIuFpYd6T7OJca437ewpV5r,fbPkOYLVPtPgIt0MxizjfFJov3JbHyAi,7,4,3,0,2,1,5,0,15,2.142857142857143,1,0.0,0,3,0,2,4,1,0,5,0,5,10,1
9010,162682,pvA5hAXeC4hqGygcnZUaZJq577cEj1jy,fbPkOYLVPtPgIt0MxizjfFJov3JbHyAi,4,2,0,0,0,0,4,0,6,0.8571428571428571,1,0.0,0,0,0,0,2,0,0,4,0,0,6,1
9011,162685,VW6QI6YQieHfuGH7gHn8hEJuMvSxxHAp,fbPkOYLVPtPgIt0MxizjfFJov3JbHyAi,7,6,4,0,3,0,2,0,15,2.142857142857143,1,0.0,0,4,0,3,6,0,0,2,0,7,8,1
9012,162687,y8AdDSbHENRUD5ii0AuyONW5YY98sBlv,fbPkOYLVPtPgIt0MxizjfFJov3JbHyAi,2,0,0,0,0,0,2,0,2,0.2857142857142857,1,0.0,0,0,0,0,0,0,0,2,0,0,2,1
9013,162689,OY5aMjVZYmvVnPhf0Ien1tS1qoTzYCve,fbPkOYLVPtPgIt0MxizjfFJov3JbHyAi,1,0,0,0,0,0,1,0,1,0.14285714285714285,1,0.0,0,0,0,0,0,0,0,1,0,0,1,1
9014,162690,4fAtuZyf3pqLNg4NAgnHL2LTveUsNAHR,fbPkOYLVPtPgIt0MxizjfFJov3JbHyAi,7,2,0,0,0,0,8,2,12,1.7142857142857142,1,0.0,0,0,0,0,2,0,0,8,2,0,12,1
9015,162691,RXL48ch4QpTtcFwRepyduTfKEKrGyTKN,fbPkOYLVPtPgIt0MxizjfFJov3JbHyAi,9,16,8,0,4,2,10,0,40,5.714285714285714,2,0.0,1,8,0,4,15,2,0,10,0,13,27,1
9016,162692,gwOQCfMjy3mPEOM9frEBJIEoEp54k479,fbPkOYLVPtPgIt0MxizjfFJov3JbHyAi,7,5,2,0,2,0,4,0,13,1.8571428571428572,1,0.0,2,2,0,2,3,0,0,4,0,6,7,1
9017,162693,cAiYY43X2fHcaVTtJkfbXwU4uE2YSYcT,fbPkOYLVPtPgIt0MxizjfFJov3JbHyAi,1,0,0,0,0,0,1,0,1,0.14285714285714285,1,0.0,0,0,0,0,0,0,0,1,0,0,1,1
9018,162694,Ht6ACDtkBUDQYG2zJ9PW4yD5omwx8FOt,fbPkOYLVPtPgIt0MxizjfFJov3JbHyAi,14,13,10,0,7,1,10,0,41,5.857142857142857,2,0.0,0,10,0,7,13,1,0,10,0,17,24,1
9019,162695,HjTLxjkRtxfAyk5V8KdvHAETDClCPqM8,fbPkOYLVPtPgIt0MxizjfFJov3JbHyAi,2,0,0,0,0,0,2,0,2,0.2857142857142857,1,0.0,0,0,0,0,0,0,0,2,0,0,2,1
9020,162696,d0rOxeHVhXN56S1SdxDqutEizIO79l17,fbPkOYLVPtPgIt0MxizjfFJov3JbHyAi,7,2,1,0,1,0,5,0,9,1.2857142857142858,1,0.0,0,1,0,1,2,0,0,5,0,2,7,1
9021,162697,itGGfLzW4kinBqXhqpdYcm0uN1rV3AUu,fbPkOYLVPtPgIt0MxizjfFJov3JbHyAi,8,2,1,0,1,35,10,1,50,7.142857142857143,1,0.0,0,1,0,1,2,35,0,10,1,2,48,1
9022,162698,Qkc0CJeX5rSUk4cMC7WmTWxFf636HopV,fbPkOYLVPtPgIt0MxizjfFJov3JbHyAi,6,3,1,0,1,0,2,0,7,1.0,1,0.0,0,1,0,1,3,0,0,2,0,2,5,1
9023,162699,zOMqB2xbzDTe4odeoQFhdTt3CHQxy4f2,fbPkOYLVPtPgIt0MxizjfFJov3JbHyAi,5,2,1,0,1,0,3,0,7,1.0,1,0.0,0,1,0,1,2,0,0,3,0,2,5,1
9024,162701,CqDZkF3Y4Ub1OGba7JosAdKhIi9VL2wR,fbPkOYLVPtPgIt0MxizjfFJov3JbHyAi,8,3,2,0,2,0,3,0,10,1.4285714285714286,1,0.0,0,2,0,2,3,0,0,3,0,4,6,1
9025,162703,Vvmg4GFkxtES0j2sr2rm1vhisTqz0hYp,fbPkOYLVPtPgIt0MxizjfFJov3JbHyAi,1,0,0,0,0,0,1,0,1,0.14285714285714285,1,0.0,0,0,0,0,0,0,0,1,0,0,1,1
9026,162705,EXeNK59x0ypZcTmicRInOt3hG7yAskPL,fbPkOYLVPtPgIt0MxizjfFJov3JbHyAi,1,0,0,0,0,0,1,0,1,0.14285714285714285,1,0.0,0,0,0,0,0,0,0,1,0,0,1,1
9027,162707,cqdnmjbJq0lDv2xgeKuzXqVr5xQytWr0,fbPkOYLVPtPgIt0MxizjfFJov3JbHyAi,1,0,0,0,0,0,1,0,1,0.14285714285714285,1,0.0,0,0,0,0,0,0,0,1,0,0,1,1
9028,162709,gD7dR7qYBA1tFY5jHEs9UR01plTA8iId,fbPkOYLVPtPgIt0MxizjfFJov3JbHyAi,8,8,5,0,2,0,4,0,19,2.7142857142857144,1,0.0,0,5,0,2,8,0,0,4,0,7,12,1
9029,162712,cXYqUXWJSTT7g3JkZOD6VVFxaOdV583i,fbPkOYLVPtPgIt0MxizjfFJov3JbHyAi,12,10,7,0,7,0,1,0,25,3.5714285714285716,1,0.0,1,7,0,7,9,0,0,1,0,15,10,1
9030,162714,HwZxiuOTyvjMb92UmTQViLX9URtxzqcc,fbPkOYLVPtPgIt0MxizjfFJov3JbHyAi,5,3,1,0,1,0,2,0,7,1.0,1,0.0,0,1,0,1,3,0,0,2,0,2,5,1
9031,163169,tZMtcgGsCq7JvLpFL4lhYMv0agvGaZe2,7GRhBDsirIGkRZBtSMEzNTyDr2JQm4xx,7,2,1,0,1,1,5,0,10,1.4285714285714286,1,0.0,0,1,0,1,2,1,0,5,0,2,8,1
9032,163445,xXU9KJwMH5fbM7NnMKoHs3jEsDiPaALW,bWdj2GDclj5ofokWjzoa5jAwMkxCykd6,8,9,0,4,1,0,11,0,25,3.5714285714285716,2,0.0,5,0,3,1,4,0,1,11,0,9,16,1
9033,163449,vrjYYhgraDUMACavD1Jq29AQHFh2bMGk,SpATywNh6bZuzm8s1ceuBUnMUAeoAHHw,10,17,0,14,0,0,2,0,33,4.714285714285714,2,0.0,11,0,13,0,6,0,1,2,0,24,9,1
9034,163466,ASnkRnrOf1WwhiZJlBu5Rdb7kpMknjcy,SpATywNh6bZuzm8s1ceuBUnMUAeoAHHw,1,0,0,0,0,0,1,0,1,0.14285714285714285,1,0.0,0,0,0,0,0,0,0,1,0,0,1,1
9035,163470,vbOiF6cnlAMZD8LbHyglMTSugmHV6DHA,RXDvfPUBYFlVdlueBFbLW0mhhAyGEqpt,17,31,13,0,7,0,24,5,80,11.428571428571429,5,0.0,2,13,0,7,29,0,0,24,5,22,58,1
9036,163475,H8YHtkra0xamWmCl1rG6GNG1DeiG8zbG,bWdj2GDclj5ofokWjzoa5jAwMkxCykd6,15,32,0,104,0,14,9,0,159,22.714285714285715,1,0.0,6,0,97,0,26,14,7,9,0,103,56,1
9037,163480,6hX10Wu1E2KDRE7mYGP1VPoNRkdF7lrL,RXDvfPUBYFlVdlueBFbLW0mhhAyGEqpt,6,6,3,0,2,0,2,0,13,1.8571428571428572,1,0.0,0,3,0,2,6,0,0,2,0,5,8,1
9038,163483,pDYlcAIvVnBJ5nJ6t9DMrTdONniDYlEW,RXDvfPUBYFlVdlueBFbLW0mhhAyGEqpt,4,4,0,0,0,3,2,0,9,1.2857142857142858,1,0.0,0,0,0,0,4,3,0,2,0,0,9,1
9039,163490,QP9mUTxIKar5wOD0pjJi5ToJRWI6Qe58,G8EPVSXsOYB5YQWZGiz1aVq5Pgr2GrQu,9,11,0,0,0,0,6,0,17,2.4285714285714284,1,0.0,2,0,0,0,9,0,0,6,0,2,15,0
9040,163507,kGtpt8jv2taW68U9XPA4K4mRWM6eie4a,SpATywNh6bZuzm8s1ceuBUnMUAeoAHHw,9,7,5,0,4,0,4,1,21,3.0,1,0.0,0,5,0,4,7,0,0,4,1,9,12,1
9041,163509,z98RxEOJ89VINRwVTX4KbTlJYz09XMrh,SpATywNh6bZuzm8s1ceuBUnMUAeoAHHw,1,0,0,0,0,0,1,0,1,0.14285714285714285,1,0.0,0,0,0,0,0,0,0,1,0,0,1,1
9042,163510,5oLMWOENowYuBiosAAPZhmNDox994GEM,SpATywNh6bZuzm8s1ceuBUnMUAeoAHHw,14,25,13,16,0,6,26,8,94,13.428571428571429,2,0.0,5,13,13,0,20,6,3,26,8,31,63,1
9043,163514,VulnA8EYzLxbOoYdrjgIqZbvSkkMTK23,RXDvfPUBYFlVdlueBFbLW0mhhAyGEqpt,9,11,1,0,1,0,1,0,14,2.0,1,0.0,0,1,0,1,11,0,0,1,0,2,12,1
9044,163516,cnF5YfjX3CQt7JMSCL8P4leqdmCPbBni,bWdj2GDclj5ofokWjzoa5jAwMkxCykd6,5,2,1,0,1,0,2,0,6,0.8571428571428571,1,0.0,0,1,0,1,2,0,0,2,0,2,4,1
9045,163518,ljvQidttDf2jbMq0Dhco00ANs1OMPP2n,SpATywNh6bZuzm8s1ceuBUnMUAeoAHHw,7,2,1,0,1,1,6,0,11,1.5714285714285714,1,0.0,0,1,0,1,2,1,0,6,0,2,9,1
9046,163533,fkHyrrcfJ6oe60xqsar56Gz0YRl5rHzC,SpATywNh6bZuzm8s1ceuBUnMUAeoAHHw,1,0,0,0,0,0,2,0,2,0.2857142857142857,1,0.0,0,0,0,0,0,0,0,2,0,0,2,1
9047,163542,CSh5hGbaSFu2yCb31iVMOVwKocrH471Q,G8EPVSXsOYB5YQWZGiz1aVq5Pgr2GrQu,4,2,1,0,1,0,1,0,5,0.7142857142857143,2,0.0,0,1,0,1,2,0,0,1,0,2,3,1
9048,163549,kD7KrEgPns8NN7pPH4RunWGvMBAYF6OW,RXDvfPUBYFlVdlueBFbLW0mhhAyGEqpt,10,8,4,0,2,0,6,0,20,2.857142857142857,3,0.0,0,4,0,2,8,0,0,6,0,6,14,0
9049,163562,H7BcZUb2MJ3mV3eWcUeltHh62X1WzBrw,SpATywNh6bZuzm8s1ceuBUnMUAeoAHHw,1,0,0,0,0,0,1,0,1,0.14285714285714285,1,0.0,0,0,0,0,0,0,0,1,0,0,1,1
9050,163569,C5uVsSF0OJOzgwE9vgQEq40axD3ffZTd,RXDvfPUBYFlVdlueBFbLW0mhhAyGEqpt,7,6,2,0,1,0,8,0,17,2.4285714285714284,2,0.0,0,2,0,1,6,0,0,8,0,3,14,1
9051,163571,F3TqBHACHIYM9Yg9wui66QV7ygJkp22V,bWdj2GDclj5ofokWjzoa5jAwMkxCykd6,7,1,1,0,1,2,6,1,12,1.7142857142857142,1,0.0,0,1,0,1,1,2,0,6,1,2,10,1
9052,163577,Uy2krOPQuopj6gsLDrvSnNpCmzlDZ3lx,G8EPVSXsOYB5YQWZGiz1aVq5Pgr2GrQu,26,30,2,52,0,0,4,0,88,12.571428571428571,1,0.0,15,2,37,0,15,0,15,4,0,54,34,1
9053,163582,eYxD3pCXsuNAtHKPOm6JQVNldqcoc61X,RXDvfPUBYFlVdlueBFbLW0mhhAyGEqpt,9,6,2,0,2,4,5,1,20,2.857142857142857,2,0.0,0,2,0,2,6,4,0,5,1,4,16,1
9054,163588,pvAe37z1FjLTGYdwlJFjXex25zlpyHtu,RXDvfPUBYFlVdlueBFbLW0mhhAyGEqpt,1,0,0,0,0,0,1,0,1,0.14285714285714285,1,0.0,0,0,0,0,0,0,0,1,0,0,1,1
9055,163589,lQAYhw1UzsQa6D4iHlC81XAZ1ajKb7gC,SpATywNh6bZuzm8s1ceuBUnMUAeoAHHw,5,2,1,0,1,1,2,0,7,1.0,1,0.0,0,1,0,1,2,1,0,2,0,2,5,1
9056,163590,vagG6fUZaIryVQfvx8v2uowaOCAY1cdW,G8EPVSXsOYB5YQWZGiz1aVq5Pgr2GrQu,7,5,1,0,1,0,4,0,11,1.5714285714285714,1,0.0,0,1,0,1,5,0,0,4,0,2,9,1
9057,163600,S1y1GaZipa7CZ4Lvwv6Z3UIIwux9mVs2,SpATywNh6bZuzm8s1ceuBUnMUAeoAHHw,6,3,2,0,2,0,1,0,8,1.1428571428571428,1,0.0,0,2,0,2,3,0,0,1,0,4,4,1
9058,163601,XqqzFQNJmn3Nj5uaNCNXStUfXUCSgi1X,SpATywNh6bZuzm8s1ceuBUnMUAeoAHHw,6,3,2,0,2,0,1,0,8,1.1428571428571428,1,0.0,0,2,0,2,3,0,0,1,0,4,4,1
9059,163614,cfOhX0waxJYI0ZiTf440b9KQ8z56ZELH,SpATywNh6bZuzm8s1ceuBUnMUAeoAHHw,13,10,5,0,3,0,7,5,30,4.285714285714286,2,0.0,4,5,0,3,6,0,0,7,5,12,18,1
9060,163618,w1CA5COiIiNblmqtUGzNLlwoBIorG5nj,SpATywNh6bZuzm8s1ceuBUnMUAeoAHHw,13,14,0,7,0,1,6,1,29,4.142857142857143,2,0.0,5,0,7,0,9,1,0,6,1,12,17,1
9061,163619,Fa1mAVxGk4kVn9jd6eDkxLNhUbCZP7qX,G8EPVSXsOYB5YQWZGiz1aVq5Pgr2GrQu,16,8,6,0,5,0,6,0,25,3.5714285714285716,2,0.0,0,6,0,5,8,0,0,6,0,11,14,1
9062,163622,L1AaE8JRIRIV3lw2DVe2AIMIzykmc89e,G8EPVSXsOYB5YQWZGiz1aVq5Pgr2GrQu,26,68,22,26,15,1,11,3,146,20.857142857142858,1,0.0,29,22,23,15,39,1,3,11,3,89,57,1
9063,163625,YMDTxwTCTCMBG5LWHOVv3uaqDpUsACxE,SpATywNh6bZuzm8s1ceuBUnMUAeoAHHw,1,0,0,0,0,0,1,0,1,0.14285714285714285,1,0.0,0,0,0,0,0,0,0,1,0,0,1,1
9064,163631,F3LkPjPg6vCRHLtL3FvDerZrs5n7emOU,SpATywNh6bZuzm8s1ceuBUnMUAeoAHHw,7,5,4,0,4,0,2,0,15,2.142857142857143,1,0.0,0,4,0,4,5,0,0,2,0,8,7,1
9065,163632,PCPmtsqEtkHe7GooXQswbqyH8cnukgFn,SpATywNh6bZuzm8s1ceuBUnMUAeoAHHw,5,2,0,0,0,0,3,0,5,0.7142857142857143,1,0.0,0,0,0,0,2,0,0,3,0,0,5,1
9066,163638,DyoNdvHG07mU6Bz7r3h8R4ubHxjNBfTA,SpATywNh6bZuzm8s1ceuBUnMUAeoAHHw,6,5,2,0,1,1,2,0,11,1.5714285714285714,1,0.0,0,2,0,1,5,1,0,2,0,3,8,1
9067,163643,C4OZeIeoVWL85YLgAEXLqPH3ncq3XA6k,SpATywNh6bZuzm8s1ceuBUnMUAeoAHHw,8,2,1,0,1,1,6,1,12,1.7142857142857142,1,0.0,0,1,0,1,2,1,0,6,1,2,10,1
9068,163650,wi94HT3Va3Hif8CpMS1WVbL5a71j9CMb,RXDvfPUBYFlVdlueBFbLW0mhhAyGEqpt,15,10,7,8,2,15,6,8,56,8.0,1,0.0,1,7,7,2,9,15,1,6,8,17,39,1
9069,163654,mlnhYrciKajvXbMdJptDLVlFyYAjST94,G8EPVSXsOYB5YQWZGiz1aVq5Pgr2GrQu,7,3,0,0,0,8,5,13,29,4.142857142857143,1,0.0,0,0,0,0,3,8,0,5,13,0,29,1
9070,163656,hsKZoLrdrvPaRbEyzj2NgfRJmBw1qqW5,SpATywNh6bZuzm8s1ceuBUnMUAeoAHHw,11,34,17,0,0,11,23,4,89,12.714285714285714,2,0.0,11,17,0,0,23,11,0,23,4,28,61,1
9071,163660,WIulMAW8PLfyLvnliYk0w4Xs9IJHKZPS,bWdj2GDclj5ofokWjzoa5jAwMkxCykd6,6,2,1,0,0,1,5,1,10,1.4285714285714286,2,0.0,0,1,0,0,2,1,0,5,1,1,9,1
9072,163675,0kNhy59h1x4o0Ij6YScRdNhibpvh4SDd,SpATywNh6bZuzm8s1ceuBUnMUAeoAHHw,1,0,0,0,0,0,1,0,1,0.14285714285714285,1,0.0,0,0,0,0,0,0,0,1,0,0,1,0
9073,163678,u40Wnz941IKPEKg6evh8MfJNEbnPlztD,bWdj2GDclj5ofokWjzoa5jAwMkxCykd6,5,2,1,0,1,6,2,0,12,1.7142857142857142,1,0.0,0,1,0,1,2,6,0,2,0,2,10,1
9074,163681,lyMxC1IigTgGwaO3VxYbmlReQwCiDGpV,RXDvfPUBYFlVdlueBFbLW0mhhAyGEqpt,11,14,0,0,0,4,5,2,25,3.5714285714285716,1,0.0,0,0,0,0,14,4,0,5,2,0,25,1
9075,163684,ewJfXKCM3UIjcsxxypCAlFJ00OIwALVK,SpATywNh6bZuzm8s1ceuBUnMUAeoAHHw,16,17,8,23,4,18,7,2,79,11.285714285714286,1,0.0,6,8,19,4,11,18,4,7,2,37,42,1
9076,163689,Ex7M4i0hxnSRXjh3Gag0IYca3K61Kn2n,SpATywNh6bZuzm8s1ceuBUnMUAeoAHHw,13,10,6,10,5,0,3,0,34,4.857142857142857,1,0.0,3,6,8,5,7,0,2,3,0,22,12,1
9077,163699,QZzKa5b6BbNwk1LIn6xlSQQLnIzRsZka,RXDvfPUBYFlVdlueBFbLW0mhhAyGEqpt,9,6,2,0,2,0,4,0,14,2.0,1,0.0,0,2,0,2,6,0,0,4,0,4,10,1
9078,163702,wf4tYLDC26NonKlhHYQJXmb4zsRVp9vv,RXDvfPUBYFlVdlueBFbLW0mhhAyGEqpt,2,1,0,0,0,0,2,0,3,0.42857142857142855,1,0.0,0,0,0,0,1,0,0,2,0,0,3,1
9079,163705,Np4pKivCInwrNv4VDIJNvSdKsE4Ykhes,SpATywNh6bZuzm8s1ceuBUnMUAeoAHHw,7,2,1,0,1,1,4,1,10,1.4285714285714286,1,0.0,0,1,0,1,2,1,0,4,1,2,8,1
9080,163709,pdSGmGjIheArtjBU79xTfiS3vhBu2KPT,SpATywNh6bZuzm8s1ceuBUnMUAeoAHHw,6,2,1,0,1,0,3,0,7,1.0,1,0.0,0,1,0,1,2,0,0,3,0,2,5,1
9081,163717,s7VOudb8mAmGtu7aUQI1pKU0VJWMkjoX,G8EPVSXsOYB5YQWZGiz1aVq5Pgr2GrQu,5,2,1,0,1,0,2,0,6,0.8571428571428571,1,0.0,0,1,0,1,2,0,0,2,0,2,4,1
9082,163721,qefyjSYUZQgFnIvwhQLXYc5FeLuyNtLR,SpATywNh6bZuzm8s1ceuBUnMUAeoAHHw,4,2,0,0,0,0,2,0,4,0.5714285714285714,1,0.0,0,0,0,0,2,0,0,2,0,0,4,1
9083,163725,2jbBgSBiRnod35BsxMp6TsDQi1nWOPvD,SpATywNh6bZuzm8s1ceuBUnMUAeoAHHw,7,3,2,0,2,0,2,0,9,1.2857142857142858,1,0.0,0,2,0,2,3,0,0,2,0,4,5,1
9084,163726,GEJT2aBPUnilxjCoBwgHhTPS1ahoPkLE,RXDvfPUBYFlVdlueBFbLW0mhhAyGEqpt,4,3,2,0,2,0,1,0,8,1.1428571428571428,2,0.0,0,2,0,2,3,0,0,1,0,4,4,1
9085,163732,CEHfXzpDz8lIH5e7jnl07zaS2wVnOurM,bWdj2GDclj5ofokWjzoa5jAwMkxCykd6,1,0,0,0,0,0,2,0,2,0.2857142857142857,1,0.0,0,0,0,0,0,0,0,2,0,0,2,1
9086,163733,XlmyWP3uzEka8XsoWFimEg5Beb9mAoVO,SpATywNh6bZuzm8s1ceuBUnMUAeoAHHw,13,9,2,21,2,1,3,0,38,5.428571428571429,1,0.0,4,2,19,2,5,1,2,3,0,27,11,0
9087,163737,ltg49XAFIsj12MvcvVinx0U6nQzosGwX,SpATywNh6bZuzm8s1ceuBUnMUAeoAHHw,1,0,0,0,0,0,1,0,1,0.14285714285714285,1,0.0,0,0,0,0,0,0,0,1,0,0,1,1
9088,163742,p0fw4v0FzqDHoIprXWv2PhAw9MEKisrS,SpATywNh6bZuzm8s1ceuBUnMUAeoAHHw,11,35,29,0,16,9,8,0,97,13.857142857142858,2,0.0,2,29,0,16,33,9,0,8,0,47,50,1
9089,163746,T40Q6IsSToScgVshLJURvbaPdMvC0SSz,SpATywNh6bZuzm8s1ceuBUnMUAeoAHHw,3,2,0,0,0,0,2,0,4,0.5714285714285714,1,0.0,0,0,0,0,2,0,0,2,0,0,4,1
9090,163749,fyTJxX25s6bGEKgBLCJRWjXtah1KWf2a,SpATywNh6bZuzm8s1ceuBUnMUAeoAHHw,7,3,2,0,0,1,5,1,12,1.7142857142857142,1,0.0,0,2,0,0,3,1,0,5,1,2,10,1
9091,163751,WIulMAW8PLfyLvnliYk0w4Xs9IJHKZPS,RXDvfPUBYFlVdlueBFbLW0mhhAyGEqpt,2,0,0,0,0,0,3,0,3,0.42857142857142855,2,0.0,0,0,0,0,0,0,0,3,0,0,3,1
9092,163755,ePj7Vg45LclsHx65E6l7TrkRBcgJnatl,SpATywNh6bZuzm8s1ceuBUnMUAeoAHHw,16,22,9,23,3,1,5,1,64,9.142857142857142,1,0.0,10,9,19,3,12,1,4,5,1,41,23,1
9093,163762,8frCsvLNU0A4TOJYDtM515jTF7T871uZ,SpATywNh6bZuzm8s1ceuBUnMUAeoAHHw,1,0,0,0,0,0,1,0,1,0.14285714285714285,1,0.0,0,0,0,0,0,0,0,1,0,0,1,1
9094,163764,J1eFEaKfAoVdTBUtGJyjHKFZqTtKoDt7,SpATywNh6bZuzm8s1ceuBUnMUAeoAHHw,2,0,0,0,0,0,2,0,2,0.2857142857142857,2,0.0,0,0,0,0,0,0,0,2,0,0,2,1
9095,163772,4IvlesNs2H0RowHre7RAgbEkJVMxR7AN,SpATywNh6bZuzm8s1ceuBUnMUAeoAHHw,10,8,5,0,4,5,5,0,27,3.857142857142857,1,0.0,0,5,0,4,8,5,0,5,0,9,18,1
9096,163774,MByqWSIhrOuR5hLDV5SDwmnefy1Zfii8,SpATywNh6bZuzm8s1ceuBUnMUAeoAHHw,14,15,2,19,0,2,12,1,51,7.285714285714286,3,0.0,2,2,15,0,13,2,4,12,1,19,32,1
9097,163782,mxBhue6G5uamvaszDl3iuMbiHnjieccs,SpATywNh6bZuzm8s1ceuBUnMUAeoAHHw,6,4,1,0,1,0,2,0,8,1.1428571428571428,2,0.0,1,1,0,1,3,0,0,2,0,3,5,1
9098,163783,uPwSB0CSQ1ut2moqiJ7QCNXIo4WCZY1E,bWdj2GDclj5ofokWjzoa5jAwMkxCykd6,1,0,0,0,0,0,1,0,1,0.14285714285714285,1,0.0,0,0,0,0,0,0,0,1,0,0,1,1
9099,163785,9d3JQQBsPcAu5WcxhfhApcP84UgGH4MP,SpATywNh6bZuzm8s1ceuBUnMUAeoAHHw,6,3,2,0,2,0,1,0,8,1.1428571428571428,1,0.0,0,2,0,2,3,0,0,1,0,4,4,1
9100,163787,8VYVEiIEY85awvLQk1iQtn3EDF8rq6g1,RXDvfPUBYFlVdlueBFbLW0mhhAyGEqpt,1,0,0,0,0,0,1,0,1,0.14285714285714285,1,0.0,0,0,0,0,0,0,0,1,0,0,1,1
9101,163791,D42av4RgpD46CqlOrc3UqYUQGU69fX7w,G8EPVSXsOYB5YQWZGiz1aVq5Pgr2GrQu,10,14,5,8,3,0,2,0,32,4.571428571428571,2,0.0,3,5,5,3,11,0,3,2,0,16,16,1
9102,163803,OTTt0WwDCNei2O0TEm6JKkoSswKCnrig,bWdj2GDclj5ofokWjzoa5jAwMkxCykd6,7,4,2,0,1,2,3,1,13,1.8571428571428572,1,0.0,0,2,0,1,4,2,0,3,1,3,10,1
9103,163805,RGr3DE14hb7Ufb3qkxo2JnrYRs9POJfu,bWdj2GDclj5ofokWjzoa5jAwMkxCykd6,2,0,0,0,0,0,2,0,2,0.2857142857142857,1,0.0,0,0,0,0,0,0,0,2,0,0,2,1
9104,163806,VROspqrlv0dK4X4QLAJe4l0nslgLETjg,SpATywNh6bZuzm8s1ceuBUnMUAeoAHHw,11,21,13,0,0,0,7,1,42,6.0,1,0.0,5,13,0,0,16,0,0,7,1,18,24,1
9105,163808,Zt87siQCmnS8kLlyv5Y5utZhnc1bMPCO,SpATywNh6bZuzm8s1ceuBUnMUAeoAHHw,4,2,0,0,0,0,2,0,4,0.5714285714285714,1,0.0,0,0,0,0,2,0,0,2,0,0,4,1
9106,163814,RmNdouduvikY6rwKOzMijwxrRPvXpOqe,SpATywNh6bZuzm8s1ceuBUnMUAeoAHHw,1,0,0,0,0,0,1,0,1,0.14285714285714285,1,0.0,0,0,0,0,0,0,0,1,0,0,1,1
9107,163822,RGr3DE14hb7Ufb3qkxo2JnrYRs9POJfu,RXDvfPUBYFlVdlueBFbLW0mhhAyGEqpt,2,0,0,0,0,0,2,0,2,0.2857142857142857,1,0.0,0,0,0,0,0,0,0,2,0,0,2,1
9108,163824,8VGorZlY7mV29XrBVXKId31ils1jK6e4,SpATywNh6bZuzm8s1ceuBUnMUAeoAHHw,11,10,1,16,0,0,3,0,30,4.285714285714286,1,0.0,5,1,14,0,5,0,2,3,0,20,10,1
9109,163831,TRkoMMGdlwDWhj0QSrRowmh4NkQmbVQQ,RXDvfPUBYFlVdlueBFbLW0mhhAyGEqpt,7,5,0,0,0,0,2,0,7,1.0,1,0.0,0,0,0,0,5,0,0,2,0,0,7,1
9110,163832,PiD5rrce1Y4GmQw7bDUPO9xN5t3xVeMb,bWdj2GDclj5ofokWjzoa5jAwMkxCykd6,1,0,0,0,0,0,1,0,1,0.14285714285714285,1,0.0,0,0,0,0,0,0,0,1,0,0,1,1
9111,163833,KVtMqoPC0QDsoF45TzGd0BaG4fzRLrFd,SpATywNh6bZuzm8s1ceuBUnMUAeoAHHw,14,18,4,0,1,5,5,0,33,4.714285714285714,2,0.0,0,4,0,1,18,5,0,5,0,5,28,1
9112,163836,SQBW44VzMb5zXQWTfzFzAP2RU7qxP2su,SpATywNh6bZuzm8s1ceuBUnMUAeoAHHw,7,13,5,0,2,0,3,0,23,3.2857142857142856,3,0.0,4,5,0,2,9,0,0,3,0,11,12,1
9113,163841,VOYGsHw00bDlJPevH6j2b9TjHm4MTXPJ,bWdj2GDclj5ofokWjzoa5jAwMkxCykd6,7,5,4,0,4,0,4,0,17,2.4285714285714284,1,0.0,0,4,0,4,5,0,0,4,0,8,9,0
9114,163865,5OhxkZY6VrmzMIEqEJk4w0eM2XdsVdBQ,bWdj2GDclj5ofokWjzoa5jAwMkxCykd6,1,0,0,0,0,0,1,0,1,0.14285714285714285,1,0.0,0,0,0,0,0,0,0,1,0,0,1,1
9115,163879,nu1pV8lIFpyulfHtXPUt3mWowV7EAjTM,SpATywNh6bZuzm8s1ceuBUnMUAeoAHHw,1,0,0,0,0,0,2,0,2,0.2857142857142857,1,0.0,0,0,0,0,0,0,0,2,0,0,2,1
9116,163886,Bos3zEEnAcYzPXQktMkJJ0ak5mhGWCAf,bWdj2GDclj5ofokWjzoa5jAwMkxCykd6,14,29,9,32,3,2,6,1,82,11.714285714285714,2,0.0,9,9,31,3,20,2,1,6,1,52,30,0
9117,163895,IdPX4c7Aq1sETI8RH1NYOE4mt2Ch4lHK,G8EPVSXsOYB5YQWZGiz1aVq5Pgr2GrQu,12,6,5,16,2,0,3,0,32,4.571428571428571,1,0.0,0,5,14,2,6,0,2,3,0,21,11,1
9118,163900,3RcsrMTbPrb8ZHYXLlgwoRK7zrqTGSuq,SpATywNh6bZuzm8s1ceuBUnMUAeoAHHw,1,0,0,0,0,0,1,0,1,0.14285714285714285,1,0.0,0,0,0,0,0,0,0,1,0,0,1,1
9119,163902,35YnYP4Tkn7xvOTt0M51AeVR3m7l2sIt,G8EPVSXsOYB5YQWZGiz1aVq5Pgr2GrQu,7,5,1,0,1,0,2,0,9,1.2857142857142858,2,0.0,0,1,0,1,5,0,0,2,0,2,7,1
9120,163908,NrHk4qmJXuD0TsjkQSnghKpk9ZjGAOyU,RXDvfPUBYFlVdlueBFbLW0mhhAyGEqpt,5,3,2,0,2,0,2,0,9,1.2857142857142858,1,0.0,0,2,0,2,3,0,0,2,0,4,5,1
9121,163909,omRh5Z9AcNowwMlq7wsAXczLrDoDOAwv,bWdj2GDclj5ofokWjzoa5jAwMkxCykd6,8,14,7,2,2,0,2,0,27,3.857142857142857,2,0.0,2,7,2,2,12,0,0,2,0,13,14,1
9122,163911,O1GQCvqX78WHj4bvuBKl7CpHmRzidVy9,SpATywNh6bZuzm8s1ceuBUnMUAeoAHHw,4,6,3,0,0,0,1,0,10,1.4285714285714286,1,0.0,2,3,0,0,4,0,0,1,0,5,5,1
9123,163914,ncIBIt1kRS23NRG3HklaOrwS2ep1UY7z,G8EPVSXsOYB5YQWZGiz1aVq5Pgr2GrQu,14,15,6,12,3,0,1,0,37,5.285714285714286,1,0.0,6,6,7,3,9,0,5,1,0,22,15,1
9124,163916,lntlNyrTcmBgMyWfooLFXfRIXX7mctQs,bWdj2GDclj5ofokWjzoa5jAwMkxCykd6,3,1,0,0,0,0,2,0,3,0.42857142857142855,1,0.0,0,0,0,0,1,0,0,2,0,0,3,1
9125,163922,ncIBIt1kRS23NRG3HklaOrwS2ep1UY7z,bWdj2GDclj5ofokWjzoa5jAwMkxCykd6,5,4,1,0,0,0,3,0,8,1.1428571428571428,1,0.0,0,1,0,0,4,0,0,3,0,1,7,1
9126,163925,TbdeJU00oP9V3i4nJearCAXrCR8nfsK3,SpATywNh6bZuzm8s1ceuBUnMUAeoAHHw,7,9,4,0,2,1,2,0,18,2.5714285714285716,2,0.0,0,4,0,2,9,1,0,2,0,6,12,1
9127,163928,VjsjgdvHeFwreLXV4d0cm1ICJk30LzPH,bWdj2GDclj5ofokWjzoa5jAwMkxCykd6,1,0,0,0,0,0,2,0,2,0.2857142857142857,1,0.0,0,0,0,0,0,0,0,2,0,0,2,1
9128,163934,5NIrDL6VpBxdJ6CyWDkvlKDqSlFChzvA,SpATywNh6bZuzm8s1ceuBUnMUAeoAHHw,21,16,12,8,7,0,5,0,48,6.857142857142857,3,0.0,0,12,8,7,16,0,0,5,0,27,21,0
9129,163936,58CuB3m4LabodooAfWkSdyPNtGlVJfdv,SpATywNh6bZuzm8s1ceuBUnMUAeoAHHw,2,0,0,0,0,0,2,0,2,0.2857142857142857,1,0.0,0,0,0,0,0,0,0,2,0,0,2,1
9130,163940,Kt9qeiacR1tBDeKKHUR6O60ehH5pm7C9,RXDvfPUBYFlVdlueBFbLW0mhhAyGEqpt,1,0,0,0,0,0,1,0,1,0.14285714285714285,1,0.0,0,0,0,0,0,0,0,1,0,0,1,1
9131,163944,k8NseCRyuonMJqIA9r5ZttySeYFCZkvS,bWdj2GDclj5ofokWjzoa5jAwMkxCykd6,2,0,0,0,0,0,2,0,2,0.2857142857142857,1,0.0,0,0,0,0,0,0,0,2,0,0,2,1
9132,163961,NNIDIi1G7HKDU1709vBEwzpydUygCNLC,SpATywNh6bZuzm8s1ceuBUnMUAeoAHHw,15,25,9,21,4,0,7,0,66,9.428571428571429,3,0.0,12,9,18,4,13,0,3,7,0,43,23,1
9133,163972,83J9IXuPcwdDBJoFENdSQFWzvgELVzeu,SpATywNh6bZuzm8s1ceuBUnMUAeoAHHw,1,0,0,0,0,0,1,0,1,0.14285714285714285,1,0.0,0,0,0,0,0,0,0,1,0,0,1,1
9134,163975,dbtlJh8uWixqUAz5pHAMwXOZNVVUTuzi,bWdj2GDclj5ofokWjzoa5jAwMkxCykd6,7,9,4,0,3,0,5,0,21,3.0,1,0.0,2,4,0,3,7,0,0,5,0,9,12,1
9135,163982,cikSh880jtc26b154AaVhDiV1L6H6F3g,SpATywNh6bZuzm8s1ceuBUnMUAeoAHHw,19,17,11,18,6,1,10,0,63,9.0,3,0.0,2,11,16,6,15,1,2,10,0,35,28,0
9136,163983,Is7lqncTs1EDN9QmzrTbcU6KnB0BCGNX,bWdj2GDclj5ofokWjzoa5jAwMkxCykd6,5,2,1,0,1,0,2,0,6,0.8571428571428571,1,0.0,0,1,0,1,2,0,0,2,0,2,4,1
9137,163986,YgxPec9PZk03SxcMpde0DWwnbgHU13wT,RXDvfPUBYFlVdlueBFbLW0mhhAyGEqpt,1,0,0,0,0,0,1,0,1,0.14285714285714285,1,0.0,0,0,0,0,0,0,0,1,0,0,1,1
9138,163993,EQtZU9INEuWvmS0EVA02NQr3rav8vOCw,SpATywNh6bZuzm8s1ceuBUnMUAeoAHHw,1,0,0,0,0,0,1,0,1,0.14285714285714285,1,0.0,0,0,0,0,0,0,0,1,0,0,1,1
9139,163995,EQtZU9INEuWvmS0EVA02NQr3rav8vOCw,bWdj2GDclj5ofokWjzoa5jAwMkxCykd6,1,0,0,0,0,0,1,0,1,0.14285714285714285,1,0.0,0,0,0,0,0,0,0,1,0,0,1,1
9140,163996,HE0yFYNeyW3jGh5EhXv7uoc6O18ATk5R,bWdj2GDclj5ofokWjzoa5jAwMkxCykd6,9,8,4,0,2,0,4,0,18,2.5714285714285716,3,0.0,0,4,0,2,8,0,0,4,0,6,12,1
9141,163997,KZBxo2oXfcrXYFa3c9hEkQ12gjuvG6yO,SpATywNh6bZuzm8s1ceuBUnMUAeoAHHw,5,3,1,0,1,0,1,0,6,0.8571428571428571,1,0.0,0,1,0,1,3,0,0,1,0,2,4,1
9142,164001,XFqiUKRJW4dHHhbAyhg0HRvuoT5jA7Ib,SpATywNh6bZuzm8s1ceuBUnMUAeoAHHw,8,9,7,0,5,0,3,0,24,3.4285714285714284,2,0.0,0,7,0,5,9,0,0,3,0,12,12,1
9143,164004,RcOO7zh8NeavIcr1ab7xjfpMRrA97BXt,G8EPVSXsOYB5YQWZGiz1aVq5Pgr2GrQu,6,2,1,0,1,0,3,0,7,1.0,1,0.0,0,1,0,1,2,0,0,3,0,2,5,1
9144,164005,DhiB4cJ1TCjmSH3ZWP9m0OqNyBdGeS5P,SpATywNh6bZuzm8s1ceuBUnMUAeoAHHw,10,14,1,16,1,0,1,0,33,4.714285714285714,3,0.0,4,1,14,1,10,0,2,1,0,20,13,1
9145,164006,BMjIPGqtYoLatxXDEHrhiIMt72Ckp0Wf,RXDvfPUBYFlVdlueBFbLW0mhhAyGEqpt,19,16,1,26,0,0,5,1,49,7.0,1,0.0,5,1,25,0,11,0,1,5,1,31,18,1
9146,164008,0sPJG21Jmy137j2MeTN2RYjy8hYUDlLs,G8EPVSXsOYB5YQWZGiz1aVq5Pgr2GrQu,10,11,2,16,1,0,3,0,33,4.714285714285714,1,0.0,4,2,13,1,7,0,3,3,0,20,13,1
9147,164009,g3902agYIRHzac78MKVZlvljLMXXNpQ7,bWdj2GDclj5ofokWjzoa5jAwMkxCykd6,6,3,2,0,2,0,5,0,12,1.7142857142857142,1,0.0,0,2,0,2,3,0,0,5,0,4,8,1
9148,164013,1l8gTBWE0zew7p1xhFmmlqlIh8QPXivD,RXDvfPUBYFlVdlueBFbLW0mhhAyGEqpt,1,0,0,0,0,0,1,0,1,0.14285714285714285,1,0.0,0,0,0,0,0,0,0,1,0,0,1,1
9149,164024,s5CJLvNaNPk4PiGqc6NTFvObROYB0OQQ,SpATywNh6bZuzm8s1ceuBUnMUAeoAHHw,22,46,0,27,0,20,13,0,106,15.142857142857142,5,0.0,12,0,25,0,34,20,2,13,0,37,69,0
9150,164030,1KSlK2xXHUc3PjC1CsQEQaomGBagqDXf,bWdj2GDclj5ofokWjzoa5jAwMkxCykd6,5,2,1,0,1,0,2,0,6,0.8571428571428571,1,0.0,0,1,0,1,2,0,0,2,0,2,4,1
9151,164032,zQ5BnttGrAYjfbNnxAVeHGUEjC3wWZZU,SpATywNh6bZuzm8s1ceuBUnMUAeoAHHw,17,32,19,21,9,8,21,0,110,15.714285714285714,5,0.0,3,19,18,9,29,8,3,21,0,49,61,0
9152,164035,HnIhmL6C5c5V3yK8mmGh4fDvVHyYVu6T,SpATywNh6bZuzm8s1ceuBUnMUAeoAHHw,17,27,4,18,4,0,13,1,67,9.571428571428571,2,0.0,9,4,15,4,18,0,3,13,1,32,35,1
9153,164038,muYojhkvYaqc1I2tE62ZyLEtlEpDYqtR,SpATywNh6bZuzm8s1ceuBUnMUAeoAHHw,10,8,2,0,2,1,6,1,20,2.857142857142857,1,0.0,0,2,0,2,8,1,0,6,1,4,16,1
9154,164048,ZhPOxBDoDGtWvBUdn6MZkcPVAapzwktO,SpATywNh6bZuzm8s1ceuBUnMUAeoAHHw,15,32,1,22,0,2,11,1,69,9.857142857142858,3,0.0,13,1,19,0,19,2,3,11,1,33,36,1
9155,164050,frevGWOFyf2Wo6uQjpFNvZnyWeFbKP0E,bWdj2GDclj5ofokWjzoa5jAwMkxCykd6,3,3,0,0,0,0,1,0,4,0.5714285714285714,1,0.0,1,0,0,0,2,0,0,1,0,1,3,1
9156,164051,frevGWOFyf2Wo6uQjpFNvZnyWeFbKP0E,RXDvfPUBYFlVdlueBFbLW0mhhAyGEqpt,9,13,1,0,0,0,1,0,15,2.142857142857143,1,0.0,4,1,0,0,9,0,0,1,0,5,10,1
9157,164053,C0k0i5iW9Kp3SljhwW4D102xschKnWU2,RXDvfPUBYFlVdlueBFbLW0mhhAyGEqpt,1,0,0,0,0,0,1,0,1,0.14285714285714285,1,0.0,0,0,0,0,0,0,0,1,0,0,1,1
9158,164059,KNSr5UQyphUzZdobhnLn0kvEqH22GN8U,G8EPVSXsOYB5YQWZGiz1aVq5Pgr2GrQu,2,0,0,0,0,0,2,0,2,0.2857142857142857,1,0.0,0,0,0,0,0,0,0,2,0,0,2,1
9159,164064,uuxrUSHn3GpYFneZnY8GpLgr5XiyDABs,bWdj2GDclj5ofokWjzoa5jAwMkxCykd6,9,19,7,0,6,13,10,3,58,8.285714285714286,1,0.0,8,7,0,6,11,13,0,10,3,21,37,1
9160,164068,83H2FVc0DUlyPpMlZsbpGsFQRMFc6fan,bWdj2GDclj5ofokWjzoa5jAwMkxCykd6,3,4,0,0,0,0,2,0,6,0.8571428571428571,1,0.0,0,0,0,0,4,0,0,2,0,0,6,1
9161,164072,KRDbzApPGunbpzFiIxAlDnKcVqmXz93Z,SpATywNh6bZuzm8s1ceuBUnMUAeoAHHw,9,9,0,0,0,1,5,1,16,2.2857142857142856,1,0.0,0,0,0,0,9,1,0,5,1,0,16,1
9162,164075,Qfoj47ZFH9kFoOklCPtfSf7qImKKODGj,bWdj2GDclj5ofokWjzoa5jAwMkxCykd6,1,0,0,0,0,0,1,0,1,0.14285714285714285,1,0.0,0,0,0,0,0,0,0,1,0,0,1,1
9163,164078,WsP1VDhZbOPlkd3sbnAsknbzVniUGVR6,SpATywNh6bZuzm8s1ceuBUnMUAeoAHHw,11,18,6,12,3,0,2,0,41,5.857142857142857,1,0.0,6,6,11,3,12,0,1,2,0,26,15,1
9164,164089,O3lqSpngMxAwSEkWjBn3tk145jZG19Vi,SpATywNh6bZuzm8s1ceuBUnMUAeoAHHw,8,8,5,0,4,1,5,1,24,3.4285714285714284,1,0.0,0,5,0,4,8,1,0,5,1,9,15,1
9165,164094,ndz80WiJUz0adE8axEB4JuY9X6KNPO7X,SpATywNh6bZuzm8s1ceuBUnMUAeoAHHw,1,0,0,0,0,0,1,0,1,0.14285714285714285,1,0.0,0,0,0,0,0,0,0,1,0,0,1,1
9166,164095,yPIqHEe4AecQ4GX5I2LJPYqjiV9xQfx2,SpATywNh6bZuzm8s1ceuBUnMUAeoAHHw,7,3,2,0,2,0,2,0,9,1.2857142857142858,1,0.0,0,2,0,2,3,0,0,2,0,4,5,1
9167,164097,yKlpCOv4oX3vHTFVM0BhF8OwgGT3xUhB,G8EPVSXsOYB5YQWZGiz1aVq5Pgr2GrQu,11,22,0,2,0,0,1,0,25,3.5714285714285716,1,0.0,6,0,2,0,16,0,0,1,0,8,17,0
9168,164105,UjuYob8V8C70Onzp78W1rkt8ybxbAbwx,RXDvfPUBYFlVdlueBFbLW0mhhAyGEqpt,9,4,3,0,1,2,5,1,16,2.2857142857142856,1,0.0,1,3,0,1,3,2,0,5,1,5,11,0
9169,164114,7ynsHGhJ1N4494Hez57ckblgtBNGbed9,bWdj2GDclj5ofokWjzoa5jAwMkxCykd6,7,2,1,0,0,24,12,2,41,5.857142857142857,1,0.0,0,1,0,0,2,24,0,12,2,1,40,1
9170,164128,3iB62eqNt3nRiXslxHuT1UtvhrRX1eLs,SpATywNh6bZuzm8s1ceuBUnMUAeoAHHw,14,19,14,0,8,10,10,3,64,9.142857142857142,1,0.0,0,14,0,8,19,10,0,10,3,22,42,0
9171,164135,blaKT90TeOTAa2RsAkTxWQqeLxEi93Qu,G8EPVSXsOYB5YQWZGiz1aVq5Pgr2GrQu,16,28,1,0,1,0,3,0,33,4.714285714285714,1,0.0,6,1,0,1,22,0,0,3,0,8,25,0
9172,164143,Rfx55so0bnrgOG7iRmEYhpikxS2TaZXD,SpATywNh6bZuzm8s1ceuBUnMUAeoAHHw,6,6,4,0,2,0,4,0,16,2.2857142857142856,1,0.0,0,4,0,2,6,0,0,4,0,6,10,1
9173,164152,DFbejjY7iFDbzUdxXNh2pDwgdrX3wa4i,SpATywNh6bZuzm8s1ceuBUnMUAeoAHHw,14,28,8,24,3,10,5,1,79,11.285714285714286,2,0.0,12,8,18,3,16,10,6,5,1,41,38,1
9174,164156,RJbtfdnDfiKYbXA54RnQnnmr6xKZwlkg,bWdj2GDclj5ofokWjzoa5jAwMkxCykd6,8,9,1,20,1,3,6,0,40,5.714285714285714,1,0.0,4,1,18,1,5,3,2,6,0,24,16,1
9175,164158,uZwtgzrFploohPWTfTTW4oFbLgraM3NM,RXDvfPUBYFlVdlueBFbLW0mhhAyGEqpt,5,6,4,0,1,0,1,0,12,1.7142857142857142,2,0.0,0,4,0,1,6,0,0,1,0,5,7,1
9176,164162,8rrasDTB21WkgxqQeAJWm6ZLoQBQi4Tp,SpATywNh6bZuzm8s1ceuBUnMUAeoAHHw,9,3,2,0,1,1,7,1,15,2.142857142857143,1,0.0,0,2,0,1,3,1,0,7,1,3,12,1
9177,164163,GY3gjlGW984FFVVjyCHJw8AVsx1rzHGL,SpATywNh6bZuzm8s1ceuBUnMUAeoAHHw,1,0,0,0,0,0,2,0,2,0.2857142857142857,1,0.0,0,0,0,0,0,0,0,2,0,0,2,1
9178,164167,g8GaCwXJUf6SPnVxk3h41vOpn1g2rMNj,SpATywNh6bZuzm8s1ceuBUnMUAeoAHHw,14,17,7,17,3,0,4,0,48,6.857142857142857,1,0.0,8,7,15,3,9,0,2,4,0,33,15,1
9179,164173,o3O6sFZEm4uYUPzBaiRjRHoiv6fwyQLX,bWdj2GDclj5ofokWjzoa5jAwMkxCykd6,11,7,5,0,3,0,6,0,21,3.0,2,0.0,1,5,0,3,6,0,0,6,0,9,12,1
9180,164180,Lwf7mfGJ3FePZ7LRuU8J3HhoGD7wCy3e,bWdj2GDclj5ofokWjzoa5jAwMkxCykd6,6,0,0,0,0,3,11,1,15,2.142857142857143,1,0.0,0,0,0,0,0,3,0,11,1,0,15,1
9181,164181,9Gcg3d2ByGJfHaOgn8q1nODMxGfTga0V,SpATywNh6bZuzm8s1ceuBUnMUAeoAHHw,4,2,1,0,1,0,1,0,5,0.7142857142857143,1,0.0,0,1,0,1,2,0,0,1,0,2,3,1
9182,164182,ztJdAnCpBgEgLx5fhRggF88Y3Pxlvyek,SpATywNh6bZuzm8s1ceuBUnMUAeoAHHw,5,5,1,0,1,0,1,0,8,1.1428571428571428,1,0.0,0,1,0,1,5,0,0,1,0,2,6,1
9183,164189,vFfdM0ONqhREkb5cy2nDN88l9Gb7gZxp,SpATywNh6bZuzm8s1ceuBUnMUAeoAHHw,12,14,7,9,4,2,17,0,53,7.571428571428571,1,0.0,3,7,7,4,11,2,2,17,0,21,32,1
9184,164190,9ygKD7mdzmGQqRwlKeL15CcGPS61a1pB,SpATywNh6bZuzm8s1ceuBUnMUAeoAHHw,1,0,0,0,0,0,1,0,1,0.14285714285714285,1,0.0,0,0,0,0,0,0,0,1,0,0,1,1
9185,164196,CXOtKVmMQojq2XNTO0iupqinfdnG9ZHO,SpATywNh6bZuzm8s1ceuBUnMUAeoAHHw,12,23,5,13,0,19,4,0,64,9.142857142857142,1,0.0,13,5,11,0,10,19,2,4,0,29,35,1
9186,164198,w0MOevkqL7TIdK3soXlSk0InhRt5D2OI,SpATywNh6bZuzm8s1ceuBUnMUAeoAHHw,7,15,0,0,0,10,5,0,30,4.285714285714286,3,0.0,1,0,0,0,14,10,0,5,0,1,29,1
9187,164199,Fk4hjEUqgyLHxBlk1cbfR9hWyVsJsJLo,bWdj2GDclj5ofokWjzoa5jAwMkxCykd6,6,5,2,0,2,0,1,0,10,1.4285714285714286,1,0.0,0,2,0,2,5,0,0,1,0,4,6,1
9188,164202,BlqNhk6hbhpwG32KfW3xxRFbNDrCRljo,bWdj2GDclj5ofokWjzoa5jAwMkxCykd6,9,18,11,0,0,16,19,3,67,9.571428571428571,2,0.0,0,11,0,0,18,16,0,19,3,11,56,1
9189,164204,Yp9LyEPv40Da5bhTi9YoLgYAzGahNHA7,RXDvfPUBYFlVdlueBFbLW0mhhAyGEqpt,13,19,14,0,6,2,5,0,46,6.571428571428571,2,0.0,1,14,0,6,18,2,0,5,0,21,25,1
9190,164211,o4jfOgo2dfLmNdqfH47BtVPD4gDTd4tS,RXDvfPUBYFlVdlueBFbLW0mhhAyGEqpt,3,0,0,0,0,4,5,0,9,1.2857142857142858,2,0.0,0,0,0,0,0,4,0,5,0,0,9,1
9191,164212,BqQvzvKumSuXZDEF5Fpfkr95tleas1E0,bWdj2GDclj5ofokWjzoa5jAwMkxCykd6,1,0,0,0,0,0,1,0,1,0.14285714285714285,1,0.0,0,0,0,0,0,0,0,1,0,0,1,1
9192,164213,wFvodFqghxL7iISMFbYXkYNq6P6eK5gH,RXDvfPUBYFlVdlueBFbLW0mhhAyGEqpt,6,5,0,0,0,0,6,0,11,1.5714285714285714,1,0.0,0,0,0,0,5,0,0,6,0,0,11,1
9193,164214,HDmenaP9dq5AQ9fnpOe9TUOGtyNR5hfW,bWdj2GDclj5ofokWjzoa5jAwMkxCykd6,5,2,1,0,1,0,4,0,8,1.1428571428571428,1,0.0,0,1,0,1,2,0,0,4,0,2,6,1
9194,164218,a8UKs1NxAK1Rc6mTIgzTKX0mHyAKUP88,G8EPVSXsOYB5YQWZGiz1aVq5Pgr2GrQu,12,14,5,8,4,0,1,0,32,4.571428571428571,1,0.0,8,5,5,4,6,0,3,1,0,22,10,1
9195,164219,cderIDaWBR3ykedbqXoG7yh75mThXkpL,SpATywNh6bZuzm8s1ceuBUnMUAeoAHHw,7,2,1,0,1,0,5,1,10,1.4285714285714286,1,0.0,0,1,0,1,2,0,0,5,1,2,8,1
9196,164223,dXCvdD4j2gSkM89QjHdpheWOht9HZ4w4,SpATywNh6bZuzm8s1ceuBUnMUAeoAHHw,13,12,4,20,3,0,2,0,41,5.857142857142857,1,0.0,7,4,16,3,5,0,4,2,0,30,11,1
9197,164226,ylaFiKTL5M7uyaxbJV4j95mbCqvhbcFS,G8EPVSXsOYB5YQWZGiz1aVq5Pgr2GrQu,26,98,3,26,8,26,8,1,170,24.285714285714285,2,0.0,27,3,23,8,71,26,3,8,1,61,109,1
9198,164229,m7lUxDgRiiqzb1cDzFb6FRFrHWjmnS0E,bWdj2GDclj5ofokWjzoa5jAwMkxCykd6,15,21,10,28,6,2,11,1,79,11.285714285714286,2,0.0,5,10,25,6,16,2,3,11,1,46,33,1
9199,164237,ZfIQYurnR6gJbWxLJ81cU3ZqzX4mpHm0,RXDvfPUBYFlVdlueBFbLW0mhhAyGEqpt,6,4,2,0,1,0,3,0,10,1.4285714285714286,1,0.0,0,2,0,1,4,0,0,3,0,3,7,1
9200,164238,mQPNS4mAXxHsb5X4ulTZ0rUofu82I30M,SpATywNh6bZuzm8s1ceuBUnMUAeoAHHw,4,0,0,0,0,1,4,0,5,0.7142857142857143,1,0.0,0,0,0,0,0,1,0,4,0,0,5,1
9201,164243,wFvodFqghxL7iISMFbYXkYNq6P6eK5gH,G8EPVSXsOYB5YQWZGiz1aVq5Pgr2GrQu,1,0,0,0,0,0,1,0,1,0.14285714285714285,1,0.0,0,0,0,0,0,0,0,1,0,0,1,1
9202,164253,s53Goue7PBVQuWwuk4njE0FTuXBFYzWT,bWdj2GDclj5ofokWjzoa5jAwMkxCykd6,5,2,1,0,1,0,2,0,6,0.8571428571428571,1,0.0,0,1,0,1,2,0,0,2,0,2,4,1
9203,164257,yLdwUTmew1kIx5gdbRjo7r2vOLkom0w2,RXDvfPUBYFlVdlueBFbLW0mhhAyGEqpt,1,0,0,0,0,0,1,0,1,0.14285714285714285,1,0.0,0,0,0,0,0,0,0,1,0,0,1,1
9204,164266,JHhY30IKFzw4LWcyrHuTEglWNqRkqdDU,G8EPVSXsOYB5YQWZGiz1aVq5Pgr2GrQu,16,13,7,22,3,0,7,0,52,7.428571428571429,1,0.0,6,7,19,3,7,0,3,7,0,35,17,1
9205,164273,wg7LkabhS9jTmBy5bEF3lQSLJkluKGUF,SpATywNh6bZuzm8s1ceuBUnMUAeoAHHw,5,2,1,0,1,0,2,0,6,0.8571428571428571,1,0.0,0,1,0,1,2,0,0,2,0,2,4,1
9206,164276,mdAxXzEXQEyyjCtALtGRFZS9oxIIimgr,G8EPVSXsOYB5YQWZGiz1aVq5Pgr2GrQu,1,0,0,0,0,0,5,0,5,0.7142857142857143,1,0.0,0,0,0,0,0,0,0,5,0,0,5,1
9207,164277,VCOGW9OE6DqAZaAneJJM4ZOSOc2aI6o3,SpATywNh6bZuzm8s1ceuBUnMUAeoAHHw,1,0,0,0,0,0,1,0,1,0.14285714285714285,1,0.0,0,0,0,0,0,0,0,1,0,0,1,1
9208,164283,44FzEVxwFpCY2dQQ0BkdyMwLoRQRjARq,bWdj2GDclj5ofokWjzoa5jAwMkxCykd6,5,2,1,0,1,0,2,0,6,0.8571428571428571,1,0.0,0,1,0,1,2,0,0,2,0,2,4,1
9209,164288,VD6TkymcxBFMdB1MoYEexj8K6lT6eEyR,SpATywNh6bZuzm8s1ceuBUnMUAeoAHHw,13,9,6,14,5,5,3,0,42,6.0,2,0.0,2,6,11,5,7,5,3,3,0,24,18,1
9210,164293,5iSY38QlsciL98g4h2hbNSbA8fYeSyCj,SpATywNh6bZuzm8s1ceuBUnMUAeoAHHw,5,6,2,0,1,0,2,0,11,1.5714285714285714,2,0.0,1,2,0,1,5,0,0,2,0,4,7,1
9211,164295,R6At1oAc7WZXNfKoQsgcMko62fJQGIiO,SpATywNh6bZuzm8s1ceuBUnMUAeoAHHw,2,0,0,0,0,0,2,0,2,0.2857142857142857,1,0.0,0,0,0,0,0,0,0,2,0,0,2,1
9212,164297,XpHgf5hU50AoSdtBhnyxR1OezCcdtpcw,SpATywNh6bZuzm8s1ceuBUnMUAeoAHHw,2,0,0,0,0,0,2,0,2,0.2857142857142857,1,0.0,0,0,0,0,0,0,0,2,0,0,2,1
9213,164299,4PiVkHMvtEasaFMOjyfke8CDtZnJS1Ch,G8EPVSXsOYB5YQWZGiz1aVq5Pgr2GrQu,5,1,1,0,1,0,2,0,5,0.7142857142857143,1,0.0,0,1,0,1,1,0,0,2,0,2,3,1
9214,164300,4pta5bIC2z8xvBYipNvHjqZfFKDEeM7X,SpATywNh6bZuzm8s1ceuBUnMUAeoAHHw,3,2,0,0,0,0,1,0,3,0.42857142857142855,1,0.0,0,0,0,0,2,0,0,1,0,0,3,0
9215,164304,P61EBU96iANevNQaamAZ1nmVdv1hlahG,RXDvfPUBYFlVdlueBFbLW0mhhAyGEqpt,5,2,1,0,1,0,2,0,6,0.8571428571428571,1,0.0,0,1,0,1,2,0,0,2,0,2,4,1
9216,164310,3kLiq8d9Yk709I1l6E6cFZpYQ45LBOgu,bWdj2GDclj5ofokWjzoa5jAwMkxCykd6,13,13,5,24,5,8,4,1,60,8.571428571428571,1,0.0,6,5,22,5,7,8,2,4,1,38,22,1
9217,164321,u889jcGO7u4YLeZfY23r5rctOxqBf6PA,SpATywNh6bZuzm8s1ceuBUnMUAeoAHHw,4,2,1,0,1,0,1,0,5,0.7142857142857143,1,0.0,0,1,0,1,2,0,0,1,0,2,3,1
9218,164323,KhocfHwmF39ufDx3XWH1QBLAW0hrIea9,SpATywNh6bZuzm8s1ceuBUnMUAeoAHHw,5,2,1,0,1,0,2,0,6,0.8571428571428571,1,0.0,0,1,0,1,2,0,0,2,0,2,4,1
9219,164326,Elyv0DBesmIDtda22RvPoYHZeyVOycgU,SpATywNh6bZuzm8s1ceuBUnMUAeoAHHw,13,16,5,13,3,0,5,0,42,6.0,2,0.0,6,5,13,3,10,0,0,5,0,27,15,0
9220,164333,pDmI6y2Fn3FHC3y8A6z8rbPnUAwXuAZ7,bWdj2GDclj5ofokWjzoa5jAwMkxCykd6,5,12,1,0,2,0,1,0,16,2.2857142857142856,2,0.0,2,1,0,2,10,0,0,1,0,5,11,1
9221,164338,vcmcxuoPWSwobaWPUxsfdhKEplWa2ces,SpATywNh6bZuzm8s1ceuBUnMUAeoAHHw,1,0,0,0,0,0,1,0,1,0.14285714285714285,1,0.0,0,0,0,0,0,0,0,1,0,0,1,1
9222,164341,vxGkTn6WfGBki29hwuSV6Xuc1hbgzs4I,bWdj2GDclj5ofokWjzoa5jAwMkxCykd6,1,0,0,0,0,0,1,0,1,0.14285714285714285,1,0.0,0,0,0,0,0,0,0,1,0,0,1,1
9223,164346,yB2j2tPO2DVKCBBdsLv8a1lbHtfWINMh,SpATywNh6bZuzm8s1ceuBUnMUAeoAHHw,7,14,7,0,5,0,3,0,29,4.142857142857143,3,0.0,1,7,0,5,13,0,0,3,0,13,16,1
9224,164356,MVnPWBm2d0gRS2GY8sfJnIUDF0K4iyE8,SpATywNh6bZuzm8s1ceuBUnMUAeoAHHw,1,0,0,0,0,0,1,0,1,0.14285714285714285,1,0.0,0,0,0,0,0,0,0,1,0,0,1,1
9225,164357,JsqrqubnjjSuqmmuivzKTDyASkdX1tsp,bWdj2GDclj5ofokWjzoa5jAwMkxCykd6,4,2,1,0,1,0,1,0,5,0.7142857142857143,1,0.0,0,1,0,1,2,0,0,1,0,2,3,1
9226,164378,Gt7xzQhw88EwESh7Xb4lU1zFZmxNJNIK,SpATywNh6bZuzm8s1ceuBUnMUAeoAHHw,9,7,4,0,1,2,7,1,22,3.142857142857143,2,0.0,0,4,0,1,7,2,0,7,1,5,17,1
9227,164387,ocTIjxG8zBs0mQRpUtpuAKc7MDpzU7Sd,SpATywNh6bZuzm8s1ceuBUnMUAeoAHHw,18,37,15,16,4,54,21,4,151,21.571428571428573,5,0.0,12,15,14,4,25,54,2,21,4,45,106,0
9228,164395,TAkEj78WoaHvO22LXzTn955rJBXiVudz,SpATywNh6bZuzm8s1ceuBUnMUAeoAHHw,1,0,0,0,0,0,1,0,1,0.14285714285714285,1,0.0,0,0,0,0,0,0,0,1,0,0,1,1
9229,164400,PUS8mu8K3BWjJGC8YlXjmQjHGQC9v5P9,SpATywNh6bZuzm8s1ceuBUnMUAeoAHHw,6,6,1,0,0,0,2,0,9,1.2857142857142858,1,0.0,0,1,0,0,6,0,0,2,0,1,8,1
9230,164403,ORIXOLqWtzi0s28E5aG42qOb01NSXSRE,SpATywNh6bZuzm8s1ceuBUnMUAeoAHHw,1,0,0,0,0,0,1,0,1,0.14285714285714285,1,0.0,0,0,0,0,0,0,0,1,0,0,1,1
9231,164404,mR38LOzPkDgy4Z7CZO92yHt4TSlNwfzC,bWdj2GDclj5ofokWjzoa5jAwMkxCykd6,14,31,1,50,1,12,23,6,124,17.714285714285715,3,0.0,10,1,45,1,21,12,5,23,6,57,67,1
9232,164407,KFG6G55toGAeaWBt5UmyioW5n1NVxSjT,SpATywNh6bZuzm8s1ceuBUnMUAeoAHHw,6,6,4,0,3,0,3,0,16,2.2857142857142856,1,0.0,0,4,0,3,6,0,0,3,0,7,9,1
9233,164411,y0PkAopIdLmRFrkWC9eBHvWT77KfVWMh,G8EPVSXsOYB5YQWZGiz1aVq5Pgr2GrQu,7,15,8,0,6,4,11,0,44,6.285714285714286,2,0.0,1,8,0,6,14,4,0,11,0,15,29,1
9234,164412,Z8r3kWGF2ZuWSy5TZGg00SEG4qfRh2Ag,bWdj2GDclj5ofokWjzoa5jAwMkxCykd6,5,6,3,0,1,0,5,0,15,2.142857142857143,3,0.0,0,3,0,1,6,0,0,5,0,4,11,1
9235,164415,GJ6G7nOOlt6NQXt3GWs6ppYe9Y1fZaES,bWdj2GDclj5ofokWjzoa5jAwMkxCykd6,1,0,0,0,0,0,1,0,1,0.14285714285714285,1,0.0,0,0,0,0,0,0,0,1,0,0,1,1
9236,164425,GJ6G7nOOlt6NQXt3GWs6ppYe9Y1fZaES,SpATywNh6bZuzm8s1ceuBUnMUAeoAHHw,1,0,0,0,0,0,1,0,1,0.14285714285714285,1,0.0,0,0,0,0,0,0,0,1,0,0,1,1
9237,164433,kaAc9OSRmTYmUacyuwJF8uvWHTHZhU6I,RXDvfPUBYFlVdlueBFbLW0mhhAyGEqpt,27,17,11,35,8,0,1,0,72,10.285714285714286,1,0.0,5,11,31,8,12,0,4,1,0,55,17,1
9238,164435,notZnFUBIqcbpWIYWbyK9wwcfdCEbsj2,RXDvfPUBYFlVdlueBFbLW0mhhAyGEqpt,6,2,1,0,1,0,3,0,7,1.0,1,0.0,0,1,0,1,2,0,0,3,0,2,5,1
9239,164436,Dqr6qIWfTOfWtI2PbseZL8Rm5WmdZOyL,SpATywNh6bZuzm8s1ceuBUnMUAeoAHHw,8,12,0,15,0,23,1,0,51,7.285714285714286,1,0.0,6,0,14,0,6,23,1,1,0,20,31,1
9240,164444,R7nlNg2K1A6D7NxbdpuHIgXqttVlWJcu,RXDvfPUBYFlVdlueBFbLW0mhhAyGEqpt,1,0,0,0,0,0,1,0,1,0.14285714285714285,1,0.0,0,0,0,0,0,0,0,1,0,0,1,1
9241,164447,JfftjOGdDbpgbrupi0Gwr899R0jzXikJ,bWdj2GDclj5ofokWjzoa5jAwMkxCykd6,11,16,8,0,4,5,9,2,44,6.285714285714286,4,0.0,0,8,0,4,16,5,0,9,2,12,32,1
9242,164452,LLZV0fRwNBkHHCO0iJlbUS4AGPQGvo8C,SpATywNh6bZuzm8s1ceuBUnMUAeoAHHw,10,15,0,14,1,0,2,0,32,4.571428571428571,1,0.0,8,0,13,1,7,0,1,2,0,22,10,1
9243,164456,QYjw7Y4e4Czbt9G691x4dA9fq3fXHjUR,bWdj2GDclj5ofokWjzoa5jAwMkxCykd6,6,2,1,0,1,7,6,0,17,2.4285714285714284,2,0.0,0,1,0,1,2,7,0,6,0,2,15,1
9244,164457,RNMplhTvSIPFgFZTfBAvIrYzbjwGfRpO,RXDvfPUBYFlVdlueBFbLW0mhhAyGEqpt,16,17,9,6,6,0,8,8,54,7.714285714285714,2,0.0,2,9,6,6,15,0,0,8,8,23,31,1
9245,164474,WLXtV9xU02TWrBcV5JQ79YomKzdOBWBA,bWdj2GDclj5ofokWjzoa5jAwMkxCykd6,3,3,1,0,0,0,1,0,5,0.7142857142857143,1,0.0,0,1,0,0,3,0,0,1,0,1,4,1
9246,164475,PrXGfRfcXAOp5eyOk9i7xyvPZyDLOEXf,SpATywNh6bZuzm8s1ceuBUnMUAeoAHHw,1,0,0,0,0,0,1,0,1,0.14285714285714285,1,0.0,0,0,0,0,0,0,0,1,0,0,1,1
9247,164476,1QkcpD1DfxC2p3XNS9AeGnCICPIyGC1C,SpATywNh6bZuzm8s1ceuBUnMUAeoAHHw,6,3,2,0,2,0,1,0,8,1.1428571428571428,1,0.0,0,2,0,2,3,0,0,1,0,4,4,1
9248,164478,lcxEu4F2dIRGolbGM8J7dkDro6hPXvBJ,SpATywNh6bZuzm8s1ceuBUnMUAeoAHHw,12,21,9,8,1,4,11,0,54,7.714285714285714,2,0.0,8,9,8,1,13,4,0,11,0,26,28,0
9249,164487,NA8Wgtfbm0wtXt1SByxQO0XvsqhkLzxE,SpATywNh6bZuzm8s1ceuBUnMUAeoAHHw,5,3,1,0,1,0,1,0,6,0.8571428571428571,1,0.0,0,1,0,1,3,0,0,1,0,2,4,1
9250,164489,rZSqEDajDij6VIcQBEDrdSlRO8swoKNK,SpATywNh6bZuzm8s1ceuBUnMUAeoAHHw,7,1,1,0,1,1,4,1,9,1.2857142857142858,1,0.0,0,1,0,1,1,1,0,4,1,2,7,1
9251,164491,Gcm2rqLAF1kWEJPfH2gzQRI0pndoww3G,bWdj2GDclj5ofokWjzoa5jAwMkxCykd6,8,8,5,0,3,0,6,0,22,3.142857142857143,2,0.0,0,5,0,3,8,0,0,6,0,8,14,1
9252,164492,p3tXqS62uMFoMZgoBWInrsBqScyEVB75,RXDvfPUBYFlVdlueBFbLW0mhhAyGEqpt,9,13,6,0,4,1,13,3,40,5.714285714285714,1,0.0,0,6,0,4,13,1,0,13,3,10,30,1
9253,164497,r0yZNwEG828V0TMkCl61Reya5Y5HO5aR,SpATywNh6bZuzm8s1ceuBUnMUAeoAHHw,13,24,12,0,7,2,9,2,56,8.0,3,0.0,0,12,0,7,24,2,0,9,2,19,37,1
9254,164505,yL460nvgMDqeAUMg6jxieurwSdj92YoI,SpATywNh6bZuzm8s1ceuBUnMUAeoAHHw,12,17,0,20,1,35,5,1,79,11.285714285714286,3,0.0,5,0,16,1,12,35,4,5,1,22,57,1
9255,164513,AaS8GsfaaiK26oA6b0QdGhs8opVCkjvV,RXDvfPUBYFlVdlueBFbLW0mhhAyGEqpt,1,0,0,0,0,0,1,0,1,0.14285714285714285,1,0.0,0,0,0,0,0,0,0,1,0,0,1,1
9256,164515,7wCkCmm5cR5EEXcCUnyxM6sXtrHGDdV9,SpATywNh6bZuzm8s1ceuBUnMUAeoAHHw,6,3,0,0,1,0,2,0,6,0.8571428571428571,1,0.0,0,0,0,1,3,0,0,2,0,1,5,1
9257,164516,kdAMRS8ek5nIImAJzh3SQaTESbJTFYQj,SpATywNh6bZuzm8s1ceuBUnMUAeoAHHw,14,10,5,9,3,0,5,2,34,4.857142857142857,1,0.0,3,5,8,3,7,0,1,5,2,19,15,1
9258,164522,KsAGy1yiN8nYXJpS6DHcH3mgCmV9iuno,RXDvfPUBYFlVdlueBFbLW0mhhAyGEqpt,19,14,12,0,8,0,2,0,36,5.142857142857143,2,0.0,0,12,0,8,14,0,0,2,0,20,16,1
9259,164523,plzzrHT4KCGyPPQGvIdYTvuIq5SPXcu1,RXDvfPUBYFlVdlueBFbLW0mhhAyGEqpt,7,1,1,0,1,2,9,2,16,2.2857142857142856,1,0.0,0,1,0,1,1,2,0,9,2,2,14,1
9260,164524,T9Cyxm8vF5hMWVEQAwASNLuJdzjdg5o1,SpATywNh6bZuzm8s1ceuBUnMUAeoAHHw,1,0,0,0,0,0,1,0,1,0.14285714285714285,1,0.0,0,0,0,0,0,0,0,1,0,0,1,1
9261,164529,Ldp7KDHbr0atRXYQ3DSiKhwRPw9nfvPl,SpATywNh6bZuzm8s1ceuBUnMUAeoAHHw,1,0,0,0,0,0,1,0,1,0.14285714285714285,1,0.0,0,0,0,0,0,0,0,1,0,0,1,1
9262,164534,8yNyyy8aPKd19nuqwaynaLkU67KuROpn,SpATywNh6bZuzm8s1ceuBUnMUAeoAHHw,4,3,1,0,1,0,1,0,6,0.8571428571428571,1,0.0,0,1,0,1,3,0,0,1,0,2,4,1
9263,164537,9poFqdhDn1jEwJp6tGIQlD3gMA14zAqO,RXDvfPUBYFlVdlueBFbLW0mhhAyGEqpt,15,29,0,13,1,0,5,0,48,6.857142857142857,3,0.0,1,0,13,1,28,0,0,5,0,15,33,1
9264,164539,TMVDThY2bkgDg7sHqM0GQP2XTTPMcYfY,SpATywNh6bZuzm8s1ceuBUnMUAeoAHHw,8,6,3,0,2,7,4,0,22,3.142857142857143,1,0.0,0,3,0,2,6,7,0,4,0,5,17,1
9265,164542,8p1yDT05QCsKrFjaE90DCIRByQyt5uxS,bWdj2GDclj5ofokWjzoa5jAwMkxCykd6,5,2,0,0,0,0,3,0,5,0.7142857142857143,1,0.0,0,0,0,0,2,0,0,3,0,0,5,1
9266,164552,SOZQ09msP4gFSDHArJmMSKrG8q4wIkm6,bWdj2GDclj5ofokWjzoa5jAwMkxCykd6,5,3,1,0,1,0,2,0,7,1.0,1,0.0,0,1,0,1,3,0,0,2,0,2,5,1
9267,164557,xN8qQh9NkfWvTtFHmPyQN8TpX680eL1v,SpATywNh6bZuzm8s1ceuBUnMUAeoAHHw,8,4,3,0,3,0,1,0,11,1.5714285714285714,1,0.0,0,3,0,3,4,0,0,1,0,6,5,1
9268,164565,s6KPq1RjdqeVgQrh8kntPjnSOHQAM1j3,SpATywNh6bZuzm8s1ceuBUnMUAeoAHHw,4,4,1,0,0,2,2,0,9,1.2857142857142858,2,0.0,0,1,0,0,4,2,0,2,0,1,8,1
9269,164568,y79Bz5Pe0nNA2zswV3Szg0JL3sj7FjTw,SpATywNh6bZuzm8s1ceuBUnMUAeoAHHw,7,8,0,10,0,1,1,0,20,2.857142857142857,1,0.0,4,0,9,0,4,1,1,1,0,13,7,1
9270,164575,bNBhDpviOcrLuVFG9Qda6S7fiYJ6jIvc,RXDvfPUBYFlVdlueBFbLW0mhhAyGEqpt,16,16,12,11,7,0,5,0,51,7.285714285714286,1,0.0,1,12,9,7,15,0,2,5,0,29,22,1
9271,164576,mFgVeo284zyRw0AHsEf7Tlutzf0jRu5y,G8EPVSXsOYB5YQWZGiz1aVq5Pgr2GrQu,38,42,24,38,15,0,12,2,133,19.0,3,0.0,12,24,26,15,30,0,12,12,2,77,56,1
9272,164583,4M7imMvvjejITdlkdL2tmwikUUTIrCPh,SpATywNh6bZuzm8s1ceuBUnMUAeoAHHw,5,2,1,0,1,3,2,0,9,1.2857142857142858,1,0.0,0,1,0,1,2,3,0,2,0,2,7,1
9273,164586,z1G7LpYxsjwTZY4hppMJzutv7SFcW56t,bWdj2GDclj5ofokWjzoa5jAwMkxCykd6,5,8,5,0,3,1,3,0,20,2.857142857142857,2,0.0,0,5,0,3,8,1,0,3,0,8,12,1
9274,164588,LqURTBP4yk5vSqNo0hCLASnfQyzdI5Pp,SpATywNh6bZuzm8s1ceuBUnMUAeoAHHw,5,7,0,0,0,1,2,0,10,1.4285714285714286,1,0.0,0,0,0,0,7,1,0,2,0,0,10,1
9275,164596,huVRXsZzo8sJwzNaUCXkQqT8IVauIRmI,G8EPVSXsOYB5YQWZGiz1aVq5Pgr2GrQu,5,3,1,0,1,0,1,0,6,0.8571428571428571,1,0.0,0,1,0,1,3,0,0,1,0,2,4,1
9276,164599,3eIemZUCKErDOaY2n5eaZc2Nb7KmqL3h,SpATywNh6bZuzm8s1ceuBUnMUAeoAHHw,7,3,1,0,1,0,4,0,9,1.2857142857142858,1,0.0,0,1,0,1,3,0,0,4,0,2,7,1
9277,164604,D5T00vfAoymuLZctUEYUqWRUSFLxc6S2,SpATywNh6bZuzm8s1ceuBUnMUAeoAHHw,17,13,8,6,5,0,16,9,57,8.142857142857142,1,0.0,2,8,6,5,11,0,0,16,9,21,36,1
9278,164609,KGwvzr0w0g2Ui1Ce7HWqcTPb5LubNTcC,bWdj2GDclj5ofokWjzoa5jAwMkxCykd6,16,26,11,132,7,0,7,0,183,26.142857142857142,1,0.0,14,11,128,7,12,0,4,7,0,160,23,1
9279,164612,vMgdrowUhfs65egdim3M3Ibio1bafxKv,SpATywNh6bZuzm8s1ceuBUnMUAeoAHHw,3,2,0,0,0,0,1,0,3,0.42857142857142855,1,0.0,0,0,0,0,2,0,0,1,0,0,3,1
9280,164614,Ia1CTpUugiWywdlf9kz3F5HfoicyRI2a,SpATywNh6bZuzm8s1ceuBUnMUAeoAHHw,10,12,0,22,0,0,8,0,42,6.0,1,0.0,6,0,17,0,6,0,5,8,0,23,19,1
9281,164618,GMzSpgZQ6jzVsfHn8W8i83JsYNxnP00b,bWdj2GDclj5ofokWjzoa5jAwMkxCykd6,3,2,0,0,0,0,1,0,3,0.42857142857142855,1,0.0,0,0,0,0,2,0,0,1,0,0,3,1
9282,164621,OK36i7c8u9GmSfG9DXL0YN94pRFkcmzE,bWdj2GDclj5ofokWjzoa5jAwMkxCykd6,10,14,4,62,3,0,3,1,87,12.428571428571429,1,0.0,9,4,62,3,5,0,0,3,1,78,9,1
9283,164623,rk9NUxSXr4iC638u7CUrQUKNTm3BCpYr,bWdj2GDclj5ofokWjzoa5jAwMkxCykd6,5,5,0,0,0,0,2,0,7,1.0,1,0.0,0,0,0,0,5,0,0,2,0,0,7,1
9284,164624,h3Oxw2qM6MZeJxbxgclKfxWrkznzqR3o,SpATywNh6bZuzm8s1ceuBUnMUAeoAHHw,1,0,0,0,0,0,1,0,1,0.14285714285714285,1,0.0,0,0,0,0,0,0,0,1,0,0,1,1
9285,164625,9BDe6DEjC6kCZdUf85MYhGs6ssX3Yd66,SpATywNh6bZuzm8s1ceuBUnMUAeoAHHw,2,0,0,0,0,0,2,0,2,0.2857142857142857,1,0.0,0,0,0,0,0,0,0,2,0,0,2,1
9286,164629,SVcpJb6gXZcQDuOEWDQYFqv2P86R1Xaj,bWdj2GDclj5ofokWjzoa5jAwMkxCykd6,1,0,0,0,0,0,2,0,2,0.2857142857142857,1,0.0,0,0,0,0,0,0,0,2,0,0,2,1
9287,164630,MWkXS8wTteiq3wnUOJQXQCzRJDoS4fUl,SpATywNh6bZuzm8s1ceuBUnMUAeoAHHw,8,11,1,0,1,2,8,2,25,3.5714285714285716,2,0.0,0,1,0,1,11,2,0,8,2,2,23,1
9288,164633,jQaCxlcrIW3B0ti76HtzjtRZOLJHPbzy,SpATywNh6bZuzm8s1ceuBUnMUAeoAHHw,6,8,4,0,0,0,1,0,13,1.8571428571428572,1,0.0,0,4,0,0,8,0,0,1,0,4,9,1
9289,164639,ZRcEnEYSSBQbkjzMu7sidjbxasfrmw8l,bWdj2GDclj5ofokWjzoa5jAwMkxCykd6,3,6,1,0,1,0,1,0,9,1.2857142857142858,1,0.0,2,1,0,1,4,0,0,1,0,4,5,1
9290,164650,WQKKwzu8xDLLktMRV89tUbRag4kJ87WF,SpATywNh6bZuzm8s1ceuBUnMUAeoAHHw,11,6,3,0,2,1,5,1,18,2.5714285714285716,1,0.0,0,3,0,2,6,1,0,5,1,5,13,1
9291,164652,pOBmP02v5rRyUAaKAfr6us8i87HHPyHg,G8EPVSXsOYB5YQWZGiz1aVq5Pgr2GrQu,7,4,2,0,2,0,5,0,13,1.8571428571428572,2,0.0,0,2,0,2,4,0,0,5,0,4,9,1
9292,164654,kW1xniKv3zwqO5oh82gt2iROU6EwbCnD,bWdj2GDclj5ofokWjzoa5jAwMkxCykd6,9,5,1,18,1,0,3,0,28,4.0,1,0.0,2,1,17,1,3,0,1,3,0,21,7,1
9293,164662,4lIBX7jVNURqeuVw7y54KWNhg5lYseZ6,SpATywNh6bZuzm8s1ceuBUnMUAeoAHHw,8,7,5,0,1,0,3,0,16,2.2857142857142856,2,0.0,0,5,0,1,7,0,0,3,0,6,10,1
9294,164669,Ib8KHMHKfyTwrkbnwsSOuVq4nV1vOamx,bWdj2GDclj5ofokWjzoa5jAwMkxCykd6,6,6,1,0,2,0,2,0,11,1.5714285714285714,1,0.0,3,1,0,2,3,0,0,2,0,6,5,1
9295,164672,JnItsaXrVUFk1SorJ52og61s5dE3TwDr,SpATywNh6bZuzm8s1ceuBUnMUAeoAHHw,13,18,2,15,0,0,7,1,43,6.142857142857143,2,0.0,8,2,14,0,10,0,1,7,1,24,19,1
9296,164694,uUMf8oHT3hYC8oh9guwKDiIUlL3eooGH,RXDvfPUBYFlVdlueBFbLW0mhhAyGEqpt,6,5,0,0,0,0,1,0,6,0.8571428571428571,1,0.0,0,0,0,0,5,0,0,1,0,0,6,1
9297,164698,xKvX1ldWoix080dPRcCCrhtY6KsUvocI,SpATywNh6bZuzm8s1ceuBUnMUAeoAHHw,6,3,2,0,1,0,3,0,9,1.2857142857142858,2,0.0,0,2,0,1,3,0,0,3,0,3,6,1
9298,164708,QRKDYncXtzqUo7eYzl5ZNiNJ63G2lU5V,bWdj2GDclj5ofokWjzoa5jAwMkxCykd6,3,3,1,0,0,0,2,0,6,0.8571428571428571,1,0.0,0,1,0,0,3,0,0,2,0,1,5,1
9299,164710,T4zdcGe48q1WGzA0YIvniMTWo2k6dk59,SpATywNh6bZuzm8s1ceuBUnMUAeoAHHw,3,2,0,0,0,0,1,0,3,0.42857142857142855,1,0.0,0,0,0,0,2,0,0,1,0,0,3,1
9300,164715,D5IkCYseUCO88GE1B1rMaRAAZyqCPk5T,G8EPVSXsOYB5YQWZGiz1aVq5Pgr2GrQu,1,0,0,0,0,0,1,0,1,0.14285714285714285,1,0.0,0,0,0,0,0,0,0,1,0,0,1,1
9301,164718,YHt0dZJFvCE3vP08l7NFcQ3cbtNDgaRS,SpATywNh6bZuzm8s1ceuBUnMUAeoAHHw,7,6,3,0,2,0,3,0,14,2.0,1,0.0,0,3,0,2,6,0,0,3,0,5,9,1
9302,164720,6CAW15U7onmNe5U8VRNHyhImgcvFA6AP,G8EPVSXsOYB5YQWZGiz1aVq5Pgr2GrQu,7,3,2,0,2,0,2,0,9,1.2857142857142858,1,0.0,0,2,0,2,3,0,0,2,0,4,5,1
9303,164721,WhbpJZxh93gnEo0Bkb56Vi4OStNv0BeR,G8EPVSXsOYB5YQWZGiz1aVq5Pgr2GrQu,6,4,2,0,1,0,2,0,9,1.2857142857142858,1,0.0,0,2,0,1,4,0,0,2,0,3,6,1
9304,164725,dpMiuMIGfVjkJNBGAa2GW5Vztul0ul4C,SpATywNh6bZuzm8s1ceuBUnMUAeoAHHw,14,26,6,23,2,19,6,0,82,11.714285714285714,2,0.0,15,6,20,2,11,19,3,6,0,43,39,1
9305,164731,haO9EV3Nk4mk3OeBYKT0QOiPfUTqVhFn,SpATywNh6bZuzm8s1ceuBUnMUAeoAHHw,10,16,0,6,0,0,2,0,24,3.4285714285714284,1,0.0,4,0,6,0,12,0,0,2,0,10,14,1
9306,164737,IaoTQrvjcHkJTQC9F8CfKXXVgVZXu8JB,SpATywNh6bZuzm8s1ceuBUnMUAeoAHHw,5,2,1,0,1,0,5,0,9,1.2857142857142858,1,0.0,0,1,0,1,2,0,0,5,0,2,7,1
9307,164746,ikRlhkwZCU39UKjMqWVQGSSX3n2hrElG,SpATywNh6bZuzm8s1ceuBUnMUAeoAHHw,1,0,0,0,0,0,2,0,2,0.2857142857142857,1,0.0,0,0,0,0,0,0,0,2,0,0,2,1
9308,164749,DVyimdGTTnbLGYwEpoGlJAG1kt7yY9fR,SpATywNh6bZuzm8s1ceuBUnMUAeoAHHw,4,2,1,0,1,0,1,0,5,0.7142857142857143,1,0.0,0,1,0,1,2,0,0,1,0,2,3,1
9309,164755,hgQRm8OL4JkmLyk7gplu1M4NKLxrHiyO,SpATywNh6bZuzm8s1ceuBUnMUAeoAHHw,4,2,1,0,1,0,1,0,5,0.7142857142857143,1,0.0,0,1,0,1,2,0,0,1,0,2,3,1
9310,164769,w14rTBVaKAEl5wo1WnNS26mWscctUzrO,SpATywNh6bZuzm8s1ceuBUnMUAeoAHHw,13,11,5,14,4,1,2,0,37,5.285714285714286,1,0.0,5,5,12,4,6,1,2,2,0,26,11,1
9311,164771,qOfaZTBIbb7J17xXt4ZWUinnClou9TNY,SpATywNh6bZuzm8s1ceuBUnMUAeoAHHw,13,19,0,17,0,11,11,2,60,8.571428571428571,1,0.0,13,0,15,0,6,11,2,11,2,28,32,1
9312,164775,s8rbNwiDb6Ued6nUvpbwuDl2s256fOiD,bWdj2GDclj5ofokWjzoa5jAwMkxCykd6,8,4,1,0,1,1,5,1,13,1.8571428571428572,1,0.0,0,1,0,1,4,1,0,5,1,2,11,1
9313,164791,6aBFBdVzdNrq3IlbLV8DRjoHXWBDTkRv,bWdj2GDclj5ofokWjzoa5jAwMkxCykd6,1,0,0,0,0,0,1,0,1,0.14285714285714285,1,0.0,0,0,0,0,0,0,0,1,0,0,1,1
9314,164793,VD6TkymcxBFMdB1MoYEexj8K6lT6eEyR,bWdj2GDclj5ofokWjzoa5jAwMkxCykd6,9,6,2,18,2,13,5,1,47,6.714285714285714,1,0.0,3,2,18,2,3,13,0,5,1,25,22,1
9315,164798,jmSgKLjYRvCwLEN3cPhxDpejaRW1URFZ,SpATywNh6bZuzm8s1ceuBUnMUAeoAHHw,4,2,1,0,1,0,1,0,5,0.7142857142857143,1,0.0,0,1,0,1,2,0,0,1,0,2,3,1
9316,164799,pPZkiQmDPKqQ9IZ0jTf8ExIfHdZSz9Tp,SpATywNh6bZuzm8s1ceuBUnMUAeoAHHw,14,18,7,18,4,11,5,1,64,9.142857142857142,2,0.0,9,7,15,4,9,11,3,5,1,35,29,1
9317,164800,Exq64VXC5vAwuYwY4YHzQg0BjMOxcioB,G8EPVSXsOYB5YQWZGiz1aVq5Pgr2GrQu,1,0,0,0,0,0,1,0,1,0.14285714285714285,1,0.0,0,0,0,0,0,0,0,1,0,0,1,1
9318,164805,BBfiARXlf8DQ4mmAXStqrzMqGcJUzid6,bWdj2GDclj5ofokWjzoa5jAwMkxCykd6,4,4,0,0,0,1,1,0,6,0.8571428571428571,1,0.0,0,0,0,0,4,1,0,1,0,0,6,1
9319,164807,aKmGG28IIMsmRYbcnkO5kp7ipo4I9wj0,bWdj2GDclj5ofokWjzoa5jAwMkxCykd6,1,0,0,0,0,0,1,0,1,0.14285714285714285,1,0.0,0,0,0,0,0,0,0,1,0,0,1,1
9320,164813,cZWFemuqv22LyBzJ62hqYFI8OPrcmsVO,RXDvfPUBYFlVdlueBFbLW0mhhAyGEqpt,1,0,0,0,0,0,1,0,1,0.14285714285714285,1,0.0,0,0,0,0,0,0,0,1,0,0,1,1
9321,164816,2uLwwxMo6zi7FYS0noJqK7cA1dw8HmPb,SpATywNh6bZuzm8s1ceuBUnMUAeoAHHw,1,0,0,0,0,0,1,0,1,0.14285714285714285,1,0.0,0,0,0,0,0,0,0,1,0,0,1,1
9322,164817,WTwb8dUqzcP0BlBT1I9MZd2r9gTEXFM0,bWdj2GDclj5ofokWjzoa5jAwMkxCykd6,5,2,1,0,1,0,2,0,6,0.8571428571428571,1,0.0,0,1,0,1,2,0,0,2,0,2,4,1
9323,164818,7xT79xUxciGCPT2px4CYK4DLm3lIDEn8,bWdj2GDclj5ofokWjzoa5jAwMkxCykd6,3,2,1,0,0,0,1,0,4,0.5714285714285714,1,0.0,0,1,0,0,2,0,0,1,0,1,3,1
9324,164819,td1qPqbY65yQMbPFzvqLZhtQGNGi89Aa,SpATywNh6bZuzm8s1ceuBUnMUAeoAHHw,16,16,9,19,3,0,12,1,60,8.571428571428571,2,0.0,6,9,16,3,10,0,3,12,1,34,26,1
9325,164820,opdILbT2IBFIYJvyIT5NXM7ymKeuMTcM,bWdj2GDclj5ofokWjzoa5jAwMkxCykd6,4,3,2,0,2,0,3,0,10,1.4285714285714286,1,0.0,0,2,0,2,3,0,0,3,0,4,6,1
9326,164823,xdClWt95AonMUbXmVncDz7pyQAF4u9BG,SpATywNh6bZuzm8s1ceuBUnMUAeoAHHw,4,2,0,0,0,0,3,0,5,0.7142857142857143,1,0.0,0,0,0,0,2,0,0,3,0,0,5,1
9327,164825,IfM7NFN1EcMfjBhCGt0UvdSV1gN33bRZ,bWdj2GDclj5ofokWjzoa5jAwMkxCykd6,2,0,0,0,0,0,4,0,4,0.5714285714285714,1,0.0,0,0,0,0,0,0,0,4,0,0,4,1
9328,164828,v7OTUgukPaXTchqClaPcgxRHfeAHlZs8,SpATywNh6bZuzm8s1ceuBUnMUAeoAHHw,9,4,3,0,2,0,3,1,13,1.8571428571428572,1,0.0,0,3,0,2,4,0,0,3,1,5,8,1
9329,164831,yNygMjDRQbsmQrkdzv6Ni3gEhrA9rC9T,RXDvfPUBYFlVdlueBFbLW0mhhAyGEqpt,2,0,0,0,0,0,2,0,2,0.2857142857142857,1,0.0,0,0,0,0,0,0,0,2,0,0,2,1
9330,164832,DmjOQ53VXOobMBTmNf8WzrNOpoPBXteN,G8EPVSXsOYB5YQWZGiz1aVq5Pgr2GrQu,10,9,3,0,3,0,3,0,18,2.5714285714285716,2,0.0,0,3,0,3,9,0,0,3,0,6,12,1
9331,164833,Vdk84P68xIHXBGrWqw3oEozZYT063dLv,bWdj2GDclj5ofokWjzoa5jAwMkxCykd6,6,2,1,0,1,0,3,0,7,1.0,1,0.0,0,1,0,1,2,0,0,3,0,2,5,1
9332,164839,k0fNZidBUd2gbryk31YveUTLLwvsjsHF,bWdj2GDclj5ofokWjzoa5jAwMkxCykd6,6,5,2,56,1,0,1,0,65,9.285714285714286,1,0.0,2,2,55,1,3,0,1,1,0,60,5,1
9333,164840,MSOPexvB5Mxvh6qEAn5PDvoAxMalQijS,SpATywNh6bZuzm8s1ceuBUnMUAeoAHHw,8,3,2,0,2,0,3,0,10,1.4285714285714286,1,0.0,0,2,0,2,3,0,0,3,0,4,6,1
9334,164843,oVaXXkgNP2VtEgRht0YdjYINkh8LeLTs,bWdj2GDclj5ofokWjzoa5jAwMkxCykd6,7,4,1,0,0,0,4,0,9,1.2857142857142858,1,0.0,0,1,0,0,4,0,0,4,0,1,8,1
9335,164854,iCakYP1w40pz3A1o7VgcbnomKTMQfUiT,RXDvfPUBYFlVdlueBFbLW0mhhAyGEqpt,1,0,0,0,0,0,1,0,1,0.14285714285714285,1,0.0,0,0,0,0,0,0,0,1,0,0,1,1
9336,164859,dgFOOUSNfQK8xIrT47Av0Q04bBFeE21W,SpATywNh6bZuzm8s1ceuBUnMUAeoAHHw,6,3,1,0,1,0,4,0,9,1.2857142857142858,2,0.0,0,1,0,1,3,0,0,4,0,2,7,1
9337,164870,6lI1WuhNHXlfVKzmWVMcaMqLcjUDqRef,SpATywNh6bZuzm8s1ceuBUnMUAeoAHHw,13,17,10,0,6,4,12,1,50,7.142857142857143,2,0.0,5,10,0,6,12,4,0,12,1,21,29,1
9338,164877,jqdafBVztOaU7B8oBuajiXxvz1FDItGv,RXDvfPUBYFlVdlueBFbLW0mhhAyGEqpt,1,0,0,0,0,0,1,0,1,0.14285714285714285,1,0.0,0,0,0,0,0,0,0,1,0,0,1,1
9339,164884,1vSzQDGr3DRQD3m17X46GyHlBw9UnL8Y,SpATywNh6bZuzm8s1ceuBUnMUAeoAHHw,5,2,1,0,1,0,2,0,6,0.8571428571428571,1,0.0,0,1,0,1,2,0,0,2,0,2,4,1
9340,164885,qOfaZTBIbb7J17xXt4ZWUinnClou9TNY,G8EPVSXsOYB5YQWZGiz1aVq5Pgr2GrQu,1,0,0,0,0,0,1,0,1,0.14285714285714285,1,0.0,0,0,0,0,0,0,0,1,0,0,1,1
9341,164894,d1YpWm8ZrJHw6yZFmSUUfwiG1uncdFaC,SpATywNh6bZuzm8s1ceuBUnMUAeoAHHw,7,8,6,0,5,0,2,0,21,3.0,2,0.0,0,6,0,5,8,0,0,2,0,11,10,1
9342,164897,OfowGKzB14DtDFMAzalSIqF59FGJmwsI,SpATywNh6bZuzm8s1ceuBUnMUAeoAHHw,7,4,3,0,2,0,1,0,10,1.4285714285714286,1,0.0,0,3,0,2,4,0,0,1,0,5,5,1
9343,164899,hJaHVe8Xh44z9hukeLNeR2pNBHqQdjsc,SpATywNh6bZuzm8s1ceuBUnMUAeoAHHw,8,5,2,0,2,0,2,0,11,1.5714285714285714,1,0.0,0,2,0,2,5,0,0,2,0,4,7,1
9344,164901,i7nraLaHwBYgXZfTke5TbxgaFvaS9vbl,SpATywNh6bZuzm8s1ceuBUnMUAeoAHHw,9,9,2,0,0,3,8,1,23,3.2857142857142856,2,0.0,2,2,0,0,7,3,0,8,1,4,19,1
9345,164902,kBQcF47B5gP441lpSW9ys93OU4QAjKEG,RXDvfPUBYFlVdlueBFbLW0mhhAyGEqpt,1,0,0,0,0,0,1,0,1,0.14285714285714285,1,0.0,0,0,0,0,0,0,0,1,0,0,1,1
9346,164903,kBQcF47B5gP441lpSW9ys93OU4QAjKEG,G8EPVSXsOYB5YQWZGiz1aVq5Pgr2GrQu,2,0,0,0,0,0,2,0,2,0.2857142857142857,1,0.0,0,0,0,0,0,0,0,2,0,0,2,1
9347,164905,plHbrJsV4vYGjRBOcUzcsYwkbv9wQX5B,SpATywNh6bZuzm8s1ceuBUnMUAeoAHHw,7,3,2,0,1,0,6,1,13,1.8571428571428572,1,0.0,0,2,0,1,3,0,0,6,1,3,10,1
9348,164913,0Gs9Qa1O3WvMBUAbfZOfCgWR0kizA6yM,bWdj2GDclj5ofokWjzoa5jAwMkxCykd6,6,2,0,0,0,0,8,0,10,1.4285714285714286,1,0.0,0,0,0,0,2,0,0,8,0,0,10,1
9349,164921,ID4lEXkhsumNcBZAAsLvwOjDHErWPU9z,RXDvfPUBYFlVdlueBFbLW0mhhAyGEqpt,7,7,2,0,2,0,2,0,13,1.8571428571428572,1,0.0,0,2,0,2,7,0,0,2,0,4,9,1
9350,164925,AI4uNtWiMMh2sMzoXDYV3Lbf88yJL8Br,SpATywNh6bZuzm8s1ceuBUnMUAeoAHHw,14,24,10,17,7,2,11,0,71,10.142857142857142,2,0.0,4,10,15,7,20,2,2,11,0,36,35,1
9351,164933,oz2lIvXgN1G19jRJoPetgndSl9b9808T,bWdj2GDclj5ofokWjzoa5jAwMkxCykd6,8,6,3,0,4,0,1,0,14,2.0,2,0.0,2,3,0,4,4,0,0,1,0,9,5,1
9352,164941,j0ueLtQ2R4YY5IElzCXogrNJYFltC4bt,G8EPVSXsOYB5YQWZGiz1aVq5Pgr2GrQu,8,10,3,0,2,0,4,0,19,2.7142857142857144,2,0.0,1,3,0,2,9,0,0,4,0,6,13,1
9353,164948,aGKf0W7DbO5pZNcjJ5sGrg9jyzAmLXkB,bWdj2GDclj5ofokWjzoa5jAwMkxCykd6,8,11,4,0,2,0,8,0,25,3.5714285714285716,1,0.0,0,4,0,2,11,0,0,8,0,6,19,1
9354,164949,QJffKxs9lkFscQquMcfEw8hYo0ArYTkN,SpATywNh6bZuzm8s1ceuBUnMUAeoAHHw,4,3,1,0,1,0,2,0,7,1.0,3,0.0,0,1,0,1,3,0,0,2,0,2,5,1
9355,164952,oZPmpjOeoiaunM2zVcQx8binL7fSfr4d,SpATywNh6bZuzm8s1ceuBUnMUAeoAHHw,1,0,0,0,0,0,1,0,1,0.14285714285714285,1,0.0,0,0,0,0,0,0,0,1,0,0,1,1
9356,164955,5BBW4T6qopgkCdcRVxFBI93aopzlZ3Vz,bWdj2GDclj5ofokWjzoa5jAwMkxCykd6,5,5,3,0,1,0,2,0,11,1.5714285714285714,2,0.0,0,3,0,1,5,0,0,2,0,4,7,1
9357,164957,1d49ijo1gfMUzl6uYLthfVZwQuAtGF5H,SpATywNh6bZuzm8s1ceuBUnMUAeoAHHw,1,0,0,0,0,0,1,0,1,0.14285714285714285,1,0.0,0,0,0,0,0,0,0,1,0,0,1,1
9358,164958,d9MkkuCn04Toz7g1JpLdUJWD9xM5braA,SpATywNh6bZuzm8s1ceuBUnMUAeoAHHw,1,0,0,0,0,0,1,0,1,0.14285714285714285,1,0.0,0,0,0,0,0,0,0,1,0,0,1,1
9359,164962,IwDrIHJtpM1SKA7Se5PnSGFRi77bmt0i,G8EPVSXsOYB5YQWZGiz1aVq5Pgr2GrQu,1,0,0,0,0,0,1,0,1,0.14285714285714285,1,0.0,0,0,0,0,0,0,0,1,0,0,1,1
9360,164963,IwDrIHJtpM1SKA7Se5PnSGFRi77bmt0i,bWdj2GDclj5ofokWjzoa5jAwMkxCykd6,2,0,0,0,0,0,2,0,2,0.2857142857142857,1,0.0,0,0,0,0,0,0,0,2,0,0,2,1
9361,164967,Jk09qA6alwSJzVuIqHppbDvZyk5u7ZHA,SpATywNh6bZuzm8s1ceuBUnMUAeoAHHw,23,26,0,33,0,10,12,3,84,12.0,2,0.0,10,0,29,0,16,10,4,12,3,39,45,1
9362,164978,NimtbKU9auo6KOsWhgU5KdNhvgw88gOw,bWdj2GDclj5ofokWjzoa5jAwMkxCykd6,5,2,1,0,1,0,2,0,6,0.8571428571428571,1,0.0,0,1,0,1,2,0,0,2,0,2,4,1
9363,164983,idGQZu8btUqvVr9UadRnlmVq4UYW0mU2,SpATywNh6bZuzm8s1ceuBUnMUAeoAHHw,1,0,0,0,0,0,1,0,1,0.14285714285714285,1,0.0,0,0,0,0,0,0,0,1,0,0,1,1
9364,164999,muJ6MIRhOdDL6SrbHsZ7Ks5a50Iz9AeC,G8EPVSXsOYB5YQWZGiz1aVq5Pgr2GrQu,40,54,19,24,14,1,5,0,117,16.714285714285715,1,0.0,12,19,13,14,42,1,11,5,0,58,59,0
9365,165000,nazeZS8BdRMOGGuVriyb5M21Pn5Qng36,G8EPVSXsOYB5YQWZGiz1aVq5Pgr2GrQu,1,0,0,0,0,0,1,0,1,0.14285714285714285,1,0.0,0,0,0,0,0,0,0,1,0,0,1,1
9366,165009,z79FxI6IxKXksSKIwsXSYM1kOlaP8f6r,A3fsA9Zfv1X2fVEQhTw51lKENdNrEqT3,3,3,0,0,0,0,1,0,4,0.5714285714285714,1,0.0,0,0,0,0,3,0,0,1,0,0,4,1
9367,165020,D1bGDJ4bL5x58ejhrACWlbqkfYdH5dQ6,G8EPVSXsOYB5YQWZGiz1aVq5Pgr2GrQu,2,0,0,0,0,0,5,0,5,0.7142857142857143,1,0.0,0,0,0,0,0,0,0,5,0,0,5,1
9368,165028,l1eQ9gI2TTb4dmIRNT0TZDzdHfiIL8H7,SpATywNh6bZuzm8s1ceuBUnMUAeoAHHw,4,2,1,0,1,0,1,0,5,0.7142857142857143,1,0.0,0,1,0,1,2,0,0,1,0,2,3,1
9369,165035,qKfZusm0R8jxltESvgi15dswdw73Gjlp,SpATywNh6bZuzm8s1ceuBUnMUAeoAHHw,4,6,3,0,0,0,2,0,11,1.5714285714285714,1,0.0,2,3,0,0,4,0,0,2,0,5,6,1
9370,165038,Im85u8aENweba95uFnFOR6zdQWFnfDOq,A3fsA9Zfv1X2fVEQhTw51lKENdNrEqT3,2,0,0,0,0,0,2,0,2,0.2857142857142857,1,0.0,0,0,0,0,0,0,0,2,0,0,2,1
9371,165043,WLEMGeSXBUEafvCWOKhfcrxNQOC05nqM,bWdj2GDclj5ofokWjzoa5jAwMkxCykd6,6,2,1,0,1,0,5,1,10,1.4285714285714286,1,0.0,0,1,0,1,2,0,0,5,1,2,8,1
9372,165045,WzO2F8mFL9S6WyVuaBKRnAo7AfpK6MFq,SpATywNh6bZuzm8s1ceuBUnMUAeoAHHw,7,8,3,0,4,0,2,0,17,2.4285714285714284,2,0.0,0,3,0,4,8,0,0,2,0,7,10,1
9373,165056,AOCx0foyQMeiMTgZQ1N4fT75yVQcQ0J9,A3fsA9Zfv1X2fVEQhTw51lKENdNrEqT3,2,0,0,0,0,0,2,0,2,0.2857142857142857,1,0.0,0,0,0,0,0,0,0,2,0,0,2,0
9374,165064,PXNipZTrm6ag7nUFRb8wDcb09bEqCKm5,bWdj2GDclj5ofokWjzoa5jAwMkxCykd6,16,7,4,72,1,0,3,0,87,12.428571428571429,1,0.0,0,4,62,1,7,0,10,3,0,67,20,1
9375,165066,jaOmqqWd0RurZsiyeEDBNOhHZZXgisPQ,G8EPVSXsOYB5YQWZGiz1aVq5Pgr2GrQu,16,26,14,6,6,4,18,1,75,10.714285714285714,4,0.0,5,14,3,6,21,4,3,18,1,28,47,1
9376,165067,Wm4d7ifDaTgcR0GfUqwJt5OZKbYglRCq,bWdj2GDclj5ofokWjzoa5jAwMkxCykd6,1,0,0,0,0,0,1,0,1,0.14285714285714285,1,0.0,0,0,0,0,0,0,0,1,0,0,1,1
9377,165074,ij6lhOw7nYbJY8ZynpI4C6NhJmjCSNsH,bWdj2GDclj5ofokWjzoa5jAwMkxCykd6,7,6,2,0,3,1,4,1,17,2.4285714285714284,1,0.0,3,2,0,3,3,1,0,4,1,8,9,1
9378,165075,ij6lhOw7nYbJY8ZynpI4C6NhJmjCSNsH,A3fsA9Zfv1X2fVEQhTw51lKENdNrEqT3,2,0,0,0,0,0,2,0,2,0.2857142857142857,1,0.0,0,0,0,0,0,0,0,2,0,0,2,1
9379,165079,5B9CBBwEycq9mrKyjhnz4JxWbxAUtqXx,bWdj2GDclj5ofokWjzoa5jAwMkxCykd6,2,0,0,0,0,0,3,0,3,0.42857142857142855,1,0.0,0,0,0,0,0,0,0,3,0,0,3,1
9380,165087,M4k2b8losoqUFktWiKn58aOnUoYhQVU3,A3fsA9Zfv1X2fVEQhTw51lKENdNrEqT3,9,5,4,0,4,0,10,0,23,3.2857142857142856,3,0.0,0,4,0,4,5,0,0,10,0,8,15,0
9381,165098,zX1TLWT3E7MpbG4kzvZO6rEOvxyi9iAE,SpATywNh6bZuzm8s1ceuBUnMUAeoAHHw,4,2,1,0,1,0,1,0,5,0.7142857142857143,1,0.0,0,1,0,1,2,0,0,1,0,2,3,1
9382,165102,8IsnQQnfLzKrobCqyqui1F07ZqYQDg46,G8EPVSXsOYB5YQWZGiz1aVq5Pgr2GrQu,20,60,4,40,9,1,4,0,118,16.857142857142858,1,0.0,37,4,25,9,23,1,15,4,0,75,43,1
9383,165103,Tc9HVYhVH0mbvYBIDHqjba6NetUmurJg,SpATywNh6bZuzm8s1ceuBUnMUAeoAHHw,1,0,0,0,0,0,1,0,1,0.14285714285714285,1,0.0,0,0,0,0,0,0,0,1,0,0,1,1
9384,165110,o0yBW91wJfDjK5Q4nsWKulavXcIg9y1s,SpATywNh6bZuzm8s1ceuBUnMUAeoAHHw,1,0,0,0,0,0,1,0,1,0.14285714285714285,1,0.0,0,0,0,0,0,0,0,1,0,0,1,1
9385,165112,Ml3VPfyUCPhgR4WxRurT5TFwkYDGbSwH,SpATywNh6bZuzm8s1ceuBUnMUAeoAHHw,13,8,6,0,3,2,6,1,26,3.7142857142857144,1,0.0,0,6,0,3,8,2,0,6,1,9,17,1
9386,165114,o0yBW91wJfDjK5Q4nsWKulavXcIg9y1s,bWdj2GDclj5ofokWjzoa5jAwMkxCykd6,1,0,0,0,0,0,1,0,1,0.14285714285714285,1,0.0,0,0,0,0,0,0,0,1,0,0,1,1
9387,165115,o0yBW91wJfDjK5Q4nsWKulavXcIg9y1s,A3fsA9Zfv1X2fVEQhTw51lKENdNrEqT3,1,0,0,0,0,0,1,0,1,0.14285714285714285,1,0.0,0,0,0,0,0,0,0,1,0,0,1,1
9388,165124,h3uJUtBmEvmKgQr2Q8BC6FJ5GRugm894,bWdj2GDclj5ofokWjzoa5jAwMkxCykd6,3,0,0,0,0,0,3,0,3,0.42857142857142855,1,0.0,0,0,0,0,0,0,0,3,0,0,3,1
9389,165134,kaAc9OSRmTYmUacyuwJF8uvWHTHZhU6I,SpATywNh6bZuzm8s1ceuBUnMUAeoAHHw,3,2,0,0,0,0,1,0,3,0.42857142857142855,1,0.0,0,0,0,0,2,0,0,1,0,0,3,1
9390,165142,6PDeQOxrHkZQRUh0DA1ORZrJ9fgsXVig,SpATywNh6bZuzm8s1ceuBUnMUAeoAHHw,6,1,1,0,1,0,3,0,6,0.8571428571428571,1,0.0,0,1,0,1,1,0,0,3,0,2,4,1
9391,165148,pdZm7VuSx559JxocpNxvzJ1tzNwrAivH,SpATywNh6bZuzm8s1ceuBUnMUAeoAHHw,11,6,3,2,2,0,5,0,18,2.5714285714285716,1,0.0,2,3,2,2,4,0,0,5,0,9,9,1
9392,165152,KOUX6K1HiyGmH7Bu8fXQloWlM5ql067i,SpATywNh6bZuzm8s1ceuBUnMUAeoAHHw,1,0,0,0,0,0,1,0,1,0.14285714285714285,1,0.0,0,0,0,0,0,0,0,1,0,0,1,1
9393,165164,OhaXK8lO0kUyQn9GvgyzAKVV6q7Nf881,G8EPVSXsOYB5YQWZGiz1aVq5Pgr2GrQu,17,17,9,6,7,2,6,0,47,6.714285714285714,1,0.0,5,9,3,7,12,2,3,6,0,24,23,1
9394,165183,oBIU2QyRoi1Laa10XMgxHQ2fgzYMbfW0,RXDvfPUBYFlVdlueBFbLW0mhhAyGEqpt,7,4,3,0,1,0,2,0,10,1.4285714285714286,1,0.0,0,3,0,1,4,0,0,2,0,4,6,1
9395,165187,Wm4d7ifDaTgcR0GfUqwJt5OZKbYglRCq,SpATywNh6bZuzm8s1ceuBUnMUAeoAHHw,12,12,6,0,4,0,3,0,25,3.5714285714285716,2,0.0,0,6,0,4,12,0,0,3,0,10,15,1
9396,165190,gR8vpBOtEmg1p0U3mlFoyPZ2gKmD8M8k,bWdj2GDclj5ofokWjzoa5jAwMkxCykd6,1,0,0,0,0,0,1,0,1,0.14285714285714285,1,0.0,0,0,0,0,0,0,0,1,0,0,1,1
9397,165194,Qn3OccgDXQpcut9yLA9jXfau6FPbS72n,bWdj2GDclj5ofokWjzoa5jAwMkxCykd6,1,0,0,0,0,0,1,0,1,0.14285714285714285,1,0.0,0,0,0,0,0,0,0,1,0,0,1,1
9398,165204,gfT397rHr4ZgHPLGZxZdcWxic55z4KQu,A3fsA9Zfv1X2fVEQhTw51lKENdNrEqT3,5,4,1,0,0,0,3,0,8,1.1428571428571428,2,0.0,0,1,0,0,4,0,0,3,0,1,7,1
9399,165205,EP7JoIZBfkdGbLwYL5xgvZ6bevF26Inu,SpATywNh6bZuzm8s1ceuBUnMUAeoAHHw,10,7,5,0,4,1,6,1,24,3.4285714285714284,1,0.0,0,5,0,4,7,1,0,6,1,9,15,1
9400,165208,kERhRnhdT9O0KrRIFldGxnMdaroWZIzP,bWdj2GDclj5ofokWjzoa5jAwMkxCykd6,8,4,0,0,0,2,6,1,13,1.8571428571428572,1,0.0,0,0,0,0,4,2,0,6,1,0,13,1
9401,165211,xNRLLiS6E0KC8Qrwk7McgtlhyqJ4FeFj,SpATywNh6bZuzm8s1ceuBUnMUAeoAHHw,1,0,0,0,0,0,1,0,1,0.14285714285714285,1,0.0,0,0,0,0,0,0,0,1,0,0,1,1
9402,165214,PaIBEPuJYWYGsLlp86uNBuTjQqpfezDI,G8EPVSXsOYB5YQWZGiz1aVq5Pgr2GrQu,6,3,1,0,1,0,2,0,7,1.0,1,0.0,0,1,0,1,3,0,0,2,0,2,5,1
9403,165215,1ak0eRZu8M5MlKljzewZoOjF7rom18Lp,SpATywNh6bZuzm8s1ceuBUnMUAeoAHHw,14,13,5,19,3,0,2,0,42,6.0,1,0.0,6,5,16,3,7,0,3,2,0,30,12,1
9404,165216,wricgx1QoMh70qtCt5pQGc1O8zgAKC8W,SpATywNh6bZuzm8s1ceuBUnMUAeoAHHw,6,2,2,0,0,1,3,0,8,1.1428571428571428,1,0.0,0,2,0,0,2,1,0,3,0,2,6,1
9405,165225,ofD9EgkVhROhMeSiR6CvxPzrkKAVlk9e,SpATywNh6bZuzm8s1ceuBUnMUAeoAHHw,4,2,0,0,0,0,2,0,4,0.5714285714285714,1,0.0,0,0,0,0,2,0,0,2,0,0,4,1
9406,165230,frKiIgyfjqTyVCSr7oHYXE3h3ahmBYPu,SpATywNh6bZuzm8s1ceuBUnMUAeoAHHw,9,4,3,0,3,0,2,0,12,1.7142857142857142,1,0.0,0,3,0,3,4,0,0,2,0,6,6,1
9407,165231,kERhRnhdT9O0KrRIFldGxnMdaroWZIzP,A3fsA9Zfv1X2fVEQhTw51lKENdNrEqT3,6,3,1,0,1,0,2,0,7,1.0,1,0.0,0,1,0,1,3,0,0,2,0,2,5,1
9408,165232,0tHH7qf3NqLHNPGNzZQ6gb0TO9yXFipC,SpATywNh6bZuzm8s1ceuBUnMUAeoAHHw,6,2,1,0,1,0,3,0,7,1.0,1,0.0,0,1,0,1,2,0,0,3,0,2,5,1
9409,165233,dVeRIohjfohGjzEkLsaU11h0LM0FLGYK,A3fsA9Zfv1X2fVEQhTw51lKENdNrEqT3,1,0,0,0,0,0,1,0,1,0.14285714285714285,1,0.0,0,0,0,0,0,0,0,1,0,0,1,1
9410,165249,luS4LypZudLH1I2R9ITqSmx2yCBqIuBV,A3fsA9Zfv1X2fVEQhTw51lKENdNrEqT3,5,0,0,0,0,0,10,2,12,1.7142857142857142,1,0.0,0,0,0,0,0,0,0,10,2,0,12,1
9411,165251,pQwQ7lq50KHnzLX18552MmFyRyK2NBh3,SpATywNh6bZuzm8s1ceuBUnMUAeoAHHw,16,34,16,19,6,0,3,0,78,11.142857142857142,3,0.0,13,16,18,6,21,0,1,3,0,53,25,1
9412,165254,SHOQyzWMzeXzTVojp4arGhfbJLLjl3Lx,A3fsA9Zfv1X2fVEQhTw51lKENdNrEqT3,25,8,5,68,0,0,3,0,84,12.0,1,0.0,1,5,68,0,7,0,0,3,0,74,10,1
9413,165256,z9oiQyplHlMmhFVKenfY0OjMOlRO24Ty,SpATywNh6bZuzm8s1ceuBUnMUAeoAHHw,10,20,9,0,6,0,3,0,38,5.428571428571429,2,0.0,0,9,0,6,20,0,0,3,0,15,23,0
9414,165259,5pl9QZtfcLF7zmReytidQLwrDKpwL5AY,G8EPVSXsOYB5YQWZGiz1aVq5Pgr2GrQu,18,14,10,0,9,0,5,1,39,5.571428571428571,1,0.0,2,10,0,9,12,0,0,5,1,21,18,1
9415,165269,NrHk4qmJXuD0TsjkQSnghKpk9ZjGAOyU,bWdj2GDclj5ofokWjzoa5jAwMkxCykd6,17,16,12,0,9,3,7,1,48,6.857142857142857,2,0.0,0,12,0,9,16,3,0,7,1,21,27,1
9416,165274,2EVUeEjVIM9F9OWjZ4WZKUdJeVQtpas5,SpATywNh6bZuzm8s1ceuBUnMUAeoAHHw,1,0,0,0,0,0,1,0,1,0.14285714285714285,1,0.0,0,0,0,0,0,0,0,1,0,0,1,0
9417,165275,nIaUSG86MljehwfWdoHPVChPOF3VCDSs,SpATywNh6bZuzm8s1ceuBUnMUAeoAHHw,1,0,0,0,0,0,1,0,1,0.14285714285714285,1,0.0,0,0,0,0,0,0,0,1,0,0,1,1
9418,165277,2HOmNQE0nDdyZUXCoC3g1k9N8rwQhnPY,RXDvfPUBYFlVdlueBFbLW0mhhAyGEqpt,3,1,0,0,0,0,2,0,3,0.42857142857142855,1,0.0,0,0,0,0,1,0,0,2,0,0,3,1
9419,165314,k1lsxE5YiR3LJaUe06e2F2PB8Llyh0eb,SpATywNh6bZuzm8s1ceuBUnMUAeoAHHw,7,3,2,0,2,0,2,0,9,1.2857142857142858,1,0.0,0,2,0,2,3,0,0,2,0,4,5,1
9420,165315,SZwbwmX9qJUPYLRS3g1l8moP7xnTFUCL,G8EPVSXsOYB5YQWZGiz1aVq5Pgr2GrQu,7,2,0,0,0,0,7,3,12,1.7142857142857142,1,0.0,0,0,0,0,2,0,0,7,3,0,12,1
9421,165316,QjeOsFvzphzL2UBVpgKTVxr9nbyzd09u,SpATywNh6bZuzm8s1ceuBUnMUAeoAHHw,5,4,3,0,3,0,2,0,12,1.7142857142857142,1,0.0,0,3,0,3,4,0,0,2,0,6,6,1
9422,165318,H5hq1RXMZvjdgAVV42G1HlcBUWfqaAQD,SpATywNh6bZuzm8s1ceuBUnMUAeoAHHw,10,16,3,0,1,2,13,0,35,5.0,2,0.0,0,3,0,1,16,2,0,13,0,4,31,1
9423,165319,ELnpGakFfMjgNeN5VeZv7LPxT1yvRGG2,SpATywNh6bZuzm8s1ceuBUnMUAeoAHHw,16,8,4,10,3,1,8,1,35,5.0,2,0.0,3,4,10,3,5,1,0,8,1,20,15,1
9424,165320,mvS4OjvaKNqVV60dVhvpTVSSCBc97FlN,A3fsA9Zfv1X2fVEQhTw51lKENdNrEqT3,1,0,0,0,0,0,2,0,2,0.2857142857142857,1,0.0,0,0,0,0,0,0,0,2,0,0,2,1
9425,165333,Vi6OE1s5C9epsDKkpv5rYzlTigz225uK,SpATywNh6bZuzm8s1ceuBUnMUAeoAHHw,7,3,2,0,2,1,2,0,10,1.4285714285714286,1,0.0,0,2,0,2,3,1,0,2,0,4,6,1
9426,165334,FsXs9JXJ9sX8GX6pr0IRKZCa3w12SCYq,G8EPVSXsOYB5YQWZGiz1aVq5Pgr2GrQu,5,2,1,0,1,0,3,0,7,1.0,1,0.0,0,1,0,1,2,0,0,3,0,2,5,1
9427,165337,SiDEVAV0vWeEC76b25xnijgEBNeEhRJy,SpATywNh6bZuzm8s1ceuBUnMUAeoAHHw,1,0,0,0,0,0,1,0,1,0.14285714285714285,1,0.0,0,0,0,0,0,0,0,1,0,0,1,1
9428,165340,oaoj9be4jW2Hot8wYgYrzLRvB0RU4KYy,SpATywNh6bZuzm8s1ceuBUnMUAeoAHHw,5,6,3,0,1,0,3,0,13,1.8571428571428572,3,0.0,0,3,0,1,6,0,0,3,0,4,9,1
9429,165342,oaoj9be4jW2Hot8wYgYrzLRvB0RU4KYy,A3fsA9Zfv1X2fVEQhTw51lKENdNrEqT3,5,6,3,0,1,0,3,0,13,1.8571428571428572,3,0.0,0,3,0,1,6,0,0,3,0,4,9,0
9430,165353,SiDEVAV0vWeEC76b25xnijgEBNeEhRJy,bWdj2GDclj5ofokWjzoa5jAwMkxCykd6,1,0,0,0,0,0,1,0,1,0.14285714285714285,1,0.0,0,0,0,0,0,0,0,1,0,0,1,1
9431,165359,SiDEVAV0vWeEC76b25xnijgEBNeEhRJy,A3fsA9Zfv1X2fVEQhTw51lKENdNrEqT3,1,0,0,0,0,0,1,0,1,0.14285714285714285,1,0.0,0,0,0,0,0,0,0,1,0,0,1,1
9432,165373,PhwD1ZKLhvgbOMQEx5zAfzeK2oPW1QkC,SpATywNh6bZuzm8s1ceuBUnMUAeoAHHw,1,0,0,0,0,0,1,0,1,0.14285714285714285,1,0.0,0,0,0,0,0,0,0,1,0,0,1,1
9433,165376,yR0NraAWygNs5cts7Fvc0zvbt2sGOVtI,SpATywNh6bZuzm8s1ceuBUnMUAeoAHHw,9,5,4,0,4,0,3,0,16,2.2857142857142856,2,0.0,0,4,0,4,5,0,0,3,0,8,8,1
9434,165378,H3h5uLXB3vbpRqjJs3VxBW591kIrIfb3,SpATywNh6bZuzm8s1ceuBUnMUAeoAHHw,4,3,1,0,1,0,2,0,7,1.0,1,0.0,0,1,0,1,3,0,0,2,0,2,5,0
9435,165390,QNGWdAKV7t5cBffSfxkRIBFN3DRIwrkT,SpATywNh6bZuzm8s1ceuBUnMUAeoAHHw,5,2,1,0,1,0,2,0,6,0.8571428571428571,1,0.0,0,1,0,1,2,0,0,2,0,2,4,1
9436,165393,yfeIcWRmFLjQgBIM196kRoHXCKG0ateC,A3fsA9Zfv1X2fVEQhTw51lKENdNrEqT3,24,21,14,0,9,3,11,0,58,8.285714285714286,3,0.0,3,14,0,9,18,3,0,11,0,26,32,1
9437,165398,4BWY4WoZwowebQpACrizuzaSUpqFUPYV,A3fsA9Zfv1X2fVEQhTw51lKENdNrEqT3,1,0,0,0,0,0,2,0,2,0.2857142857142857,1,0.0,0,0,0,0,0,0,0,2,0,0,2,1
9438,165402,RDChRApYRv6Sfe9dw6iFymmd1hK0JhGY,A3fsA9Zfv1X2fVEQhTw51lKENdNrEqT3,1,0,0,0,0,0,1,0,1,0.14285714285714285,1,0.0,0,0,0,0,0,0,0,1,0,0,1,1
9439,165419,G6cW0d2bzLHgB0vreFbhNx3GSiMBKbtv,bWdj2GDclj5ofokWjzoa5jAwMkxCykd6,4,3,1,0,1,0,1,0,6,0.8571428571428571,1,0.0,0,1,0,1,3,0,0,1,0,2,4,1
9440,165422,rROYd0uArbh5iBXaNezR5YmAESEuia7u,bWdj2GDclj5ofokWjzoa5jAwMkxCykd6,2,0,0,0,0,0,2,0,2,0.2857142857142857,1,0.0,0,0,0,0,0,0,0,2,0,0,2,1
9441,165427,QDpN8D19Mr8RZumTONWpZNlCWcHCCTbH,RXDvfPUBYFlVdlueBFbLW0mhhAyGEqpt,1,0,0,0,0,0,1,0,1,0.14285714285714285,1,0.0,0,0,0,0,0,0,0,1,0,0,1,1
9442,165428,MCX6PserzHPOVcVElkM3aC5c5GhSLDKg,SpATywNh6bZuzm8s1ceuBUnMUAeoAHHw,7,6,4,0,1,0,4,0,15,2.142857142857143,1,0.0,0,4,0,1,6,0,0,4,0,5,10,1
9443,165431,DrolXxynktOsAUhkf2q3qgLe9PvqdRq3,A3fsA9Zfv1X2fVEQhTw51lKENdNrEqT3,1,0,0,0,0,0,1,0,1,0.14285714285714285,1,0.0,0,0,0,0,0,0,0,1,0,0,1,1
9444,165432,171vdjJg3ZQqEKQGGQqQb3EXy77TiE88,SpATywNh6bZuzm8s1ceuBUnMUAeoAHHw,2,0,0,0,0,0,2,0,2,0.2857142857142857,1,0.0,0,0,0,0,0,0,0,2,0,0,2,1
9445,165446,bWVYIzoXIGQmlYVnRkh7UPWZa7BftJJn,SpATywNh6bZuzm8s1ceuBUnMUAeoAHHw,2,0,0,0,0,0,2,0,2,0.2857142857142857,1,0.0,0,0,0,0,0,0,0,2,0,0,2,1
9446,165458,MQKEfJfHQjDI3xyJjnjmz4WwmQkpOvq2,bWdj2GDclj5ofokWjzoa5jAwMkxCykd6,6,4,2,0,1,0,4,0,11,1.5714285714285714,2,0.0,0,2,0,1,4,0,0,4,0,3,8,1
9447,165462,0RrAM7mPLzd3skZgaRP9NKB2Gqbiiam3,SpATywNh6bZuzm8s1ceuBUnMUAeoAHHw,3,2,0,0,0,0,2,0,4,0.5714285714285714,1,0.0,0,0,0,0,2,0,0,2,0,0,4,1
9448,165485,WXsAy1py6xNoAtmIQsPWN4rhdvzggrq1,SpATywNh6bZuzm8s1ceuBUnMUAeoAHHw,1,0,0,0,0,0,1,0,1,0.14285714285714285,1,0.0,0,0,0,0,0,0,0,1,0,0,1,1
9449,165489,WXsAy1py6xNoAtmIQsPWN4rhdvzggrq1,RXDvfPUBYFlVdlueBFbLW0mhhAyGEqpt,15,19,2,0,2,0,5,0,28,4.0,2,0.0,0,2,0,2,19,0,0,5,0,4,24,1
9450,165491,wg9kzusa79hS4fFC5hU9Laht66GWJcDA,RXDvfPUBYFlVdlueBFbLW0mhhAyGEqpt,1,0,0,0,0,0,1,0,1,0.14285714285714285,1,0.0,0,0,0,0,0,0,0,1,0,0,1,1
9451,165509,E7ohNiXaqWq4qLMuCCQXRkjiO7PGgPyS,A3fsA9Zfv1X2fVEQhTw51lKENdNrEqT3,1,0,0,0,0,0,1,0,1,0.14285714285714285,1,0.0,0,0,0,0,0,0,0,1,0,0,1,1
9452,165524,8wyKs5vTbaPjVAzqiPgYkv71kXMupepX,SpATywNh6bZuzm8s1ceuBUnMUAeoAHHw,6,3,1,0,1,2,2,0,9,1.2857142857142858,1,0.0,0,1,0,1,3,2,0,2,0,2,7,1
9453,165525,pLYG36p2jiNeVIQQxkAjPMCy7LTje21i,bWdj2GDclj5ofokWjzoa5jAwMkxCykd6,1,0,0,0,0,0,1,0,1,0.14285714285714285,1,0.0,0,0,0,0,0,0,0,1,0,0,1,1
9454,165530,2g49Uxh0o7UNSAoA6NR0GAmfGLF8JjXt,SpATywNh6bZuzm8s1ceuBUnMUAeoAHHw,11,14,0,23,1,7,3,0,48,6.857142857142857,1,0.0,8,0,20,1,6,7,3,3,0,29,19,1
9455,165531,srCZOXVyb44qlEge30QR25H9jokNeHzQ,SpATywNh6bZuzm8s1ceuBUnMUAeoAHHw,3,2,0,0,0,0,1,0,3,0.42857142857142855,1,0.0,0,0,0,0,2,0,0,1,0,0,3,0
9456,165536,1ImGMKyV7Di3tjZEdKRuDKDVzc7buyQG,SpATywNh6bZuzm8s1ceuBUnMUAeoAHHw,6,7,1,0,1,0,2,0,11,1.5714285714285714,1,0.0,0,1,0,1,7,0,0,2,0,2,9,1
9457,165539,GKKPaN5cNHTg4FgODePiiUlUMrULEfiu,SpATywNh6bZuzm8s1ceuBUnMUAeoAHHw,8,6,4,0,3,0,2,0,15,2.142857142857143,1,0.0,0,4,0,3,6,0,0,2,0,7,8,1
9458,165563,OIJqLsLQ0l4P9wwH2Os3C8W1InCTTS4l,SpATywNh6bZuzm8s1ceuBUnMUAeoAHHw,1,0,0,0,0,0,1,0,1,0.14285714285714285,1,0.0,0,0,0,0,0,0,0,1,0,0,1,1
9459,165566,Ml5BpcJCzlIYi0qFUUXB9FVaOk4IObDm,SpATywNh6bZuzm8s1ceuBUnMUAeoAHHw,5,4,0,0,0,0,2,0,6,0.8571428571428571,1,0.0,0,0,0,0,4,0,0,2,0,0,6,1
9460,165576,5fYqTmVKkWf8WeRMHDLJyPdR1zqgEtLM,SpATywNh6bZuzm8s1ceuBUnMUAeoAHHw,6,2,1,0,1,0,3,0,7,1.0,1,0.0,0,1,0,1,2,0,0,3,0,2,5,1
9461,165581,cp1vQuxrP7S8Bxj7ORUE5wjTIrRPfe4O,SpATywNh6bZuzm8s1ceuBUnMUAeoAHHw,7,8,0,0,0,0,5,1,14,2.0,1,0.0,2,0,0,0,6,0,0,5,1,2,12,1
9462,165592,JWwJ8KbdNh7FB84c1h8AD4pHgPCC9uj6,SpATywNh6bZuzm8s1ceuBUnMUAeoAHHw,8,4,3,0,3,0,1,0,11,1.5714285714285714,1,0.0,0,3,0,3,4,0,0,1,0,6,5,1
9463,165596,QqNuARzccJUP5HNszzjljOhC9t53eZLk,A3fsA9Zfv1X2fVEQhTw51lKENdNrEqT3,42,25,11,66,7,5,11,8,133,19.0,2,0.0,4,11,57,7,21,5,9,11,8,79,54,1
9464,165606,XmbLwxmQRLXz9T2ULgWW6uwVskMK6ds2,SpATywNh6bZuzm8s1ceuBUnMUAeoAHHw,17,23,0,12,0,0,1,0,36,5.142857142857143,1,0.0,4,0,12,0,19,0,0,1,0,16,20,1
9465,165612,KL4xQqmMI37CKNQsNsMM9emaoJIOAgLu,SpATywNh6bZuzm8s1ceuBUnMUAeoAHHw,8,9,2,0,1,0,3,0,15,2.142857142857143,1,0.0,0,2,0,1,9,0,0,3,0,3,12,1
9466,165617,fB4iAxEUCZ6aGoIPtPsbdJRsMMg2k42A,SpATywNh6bZuzm8s1ceuBUnMUAeoAHHw,10,8,5,2,1,0,3,0,19,2.7142857142857144,1,0.0,1,5,2,1,7,0,0,3,0,9,10,1
9467,165620,llrEAs9SMv6dYcefFrAK178vmmmglVzw,SpATywNh6bZuzm8s1ceuBUnMUAeoAHHw,9,5,3,0,2,1,6,1,18,2.5714285714285716,1,0.0,0,3,0,2,5,1,0,6,1,5,13,1
9468,165626,85DVIn1pw5TUgdo2ZtmymnwN8xrWNYCJ,G8EPVSXsOYB5YQWZGiz1aVq5Pgr2GrQu,1,0,0,0,0,0,1,0,1,0.14285714285714285,1,0.0,0,0,0,0,0,0,0,1,0,0,1,1
9469,165635,OLNUzQUHvlNsi2WFlH5eEyaieqKXrEz7,RXDvfPUBYFlVdlueBFbLW0mhhAyGEqpt,1,0,0,0,0,0,1,0,1,0.14285714285714285,1,0.0,0,0,0,0,0,0,0,1,0,0,1,1
9470,165636,OLNUzQUHvlNsi2WFlH5eEyaieqKXrEz7,A3fsA9Zfv1X2fVEQhTw51lKENdNrEqT3,1,0,0,0,0,0,1,0,1,0.14285714285714285,1,0.0,0,0,0,0,0,0,0,1,0,0,1,1
9471,165640,GOWvSpqnQlbRYn3L1ovF5Dk4awbNrqjv,bWdj2GDclj5ofokWjzoa5jAwMkxCykd6,8,6,3,0,3,0,1,0,13,1.8571428571428572,1,0.0,0,3,0,3,6,0,0,1,0,6,7,1
9472,165648,45RDvtjbfAzQUYoMqYnUCNheNvdQTBQf,SpATywNh6bZuzm8s1ceuBUnMUAeoAHHw,1,0,0,0,0,0,1,0,1,0.14285714285714285,1,0.0,0,0,0,0,0,0,0,1,0,0,1,1
9473,165678,u5R8HPCpot8dC2SKEeIgSJg3TYEfNk6j,SpATywNh6bZuzm8s1ceuBUnMUAeoAHHw,5,2,1,0,1,0,2,0,6,0.8571428571428571,1,0.0,0,1,0,1,2,0,0,2,0,2,4,1
9474,165681,zZk0zQJxr08CnTp44rAPtrScPbsUq7U7,SpATywNh6bZuzm8s1ceuBUnMUAeoAHHw,6,3,2,0,1,0,3,0,9,1.2857142857142858,1,0.0,0,2,0,1,3,0,0,3,0,3,6,0
9475,165689,WVNZbdoXW7KA02SSLbuMYRv36MSZshQF,SpATywNh6bZuzm8s1ceuBUnMUAeoAHHw,5,3,2,0,2,0,2,0,9,1.2857142857142858,1,0.0,0,2,0,2,3,0,0,2,0,4,5,1
9476,165692,VKQwP2UGxFr8cW02yW69JgEmp944MwNR,SpATywNh6bZuzm8s1ceuBUnMUAeoAHHw,12,13,8,0,5,0,2,0,28,4.0,2,0.0,2,8,0,5,11,0,0,2,0,15,13,0
9477,165693,h7XFnfSxsjydwMPLvMejh0cg5xL1ZDd5,SpATywNh6bZuzm8s1ceuBUnMUAeoAHHw,5,2,1,0,1,0,2,0,6,0.8571428571428571,1,0.0,0,1,0,1,2,0,0,2,0,2,4,1
9478,165694,oNStIislotbuK2XCCskaFe8CInb3EbrY,SpATywNh6bZuzm8s1ceuBUnMUAeoAHHw,4,2,0,0,0,0,2,0,4,0.5714285714285714,1,0.0,0,0,0,0,2,0,0,2,0,0,4,1
9479,165697,0gS5Q732yxgOQo1BReYmVwLNG0PEmJtw,RXDvfPUBYFlVdlueBFbLW0mhhAyGEqpt,1,0,0,0,0,0,2,0,2,0.2857142857142857,1,0.0,0,0,0,0,0,0,0,2,0,0,2,1
9480,165703,9gwK2SMO9RzFmbR3NVs20xNig2HGOi8l,SpATywNh6bZuzm8s1ceuBUnMUAeoAHHw,7,4,2,0,2,0,2,0,10,1.4285714285714286,1,0.0,1,2,0,2,3,0,0,2,0,5,5,1
9481,165705,jFvQpyb1OqXqTZx0rW1xHWEtpgyxk2Lr,A3fsA9Zfv1X2fVEQhTw51lKENdNrEqT3,1,0,0,0,0,0,1,0,1,0.14285714285714285,1,0.0,0,0,0,0,0,0,0,1,0,0,1,1
9482,165707,XOhs3C3hEbYCXLCkazKW0gKNbUWn1jg2,G8EPVSXsOYB5YQWZGiz1aVq5Pgr2GrQu,1,0,0,0,0,0,1,0,1,0.14285714285714285,1,0.0,0,0,0,0,0,0,0,1,0,0,1,1
9483,165710,ZSl6vjDvuQwmk9tpCIu9AiiDVVFMdktp,bWdj2GDclj5ofokWjzoa5jAwMkxCykd6,3,2,1,0,0,0,2,0,5,0.7142857142857143,2,0.0,0,1,0,0,2,0,0,2,0,1,4,1
9484,165713,0beqYHGnxE1kTUwjVs54066oNfD5qFpw,A3fsA9Zfv1X2fVEQhTw51lKENdNrEqT3,4,3,1,0,1,0,1,0,6,0.8571428571428571,1,0.0,0,1,0,1,3,0,0,1,0,2,4,1
9485,165723,M2gu56p2gwP0LePGc68gh6Y3xSriA9x3,A3fsA9Zfv1X2fVEQhTw51lKENdNrEqT3,2,2,0,0,0,0,0,0,2,0.2857142857142857,1,0.0,0,0,0,0,2,0,0,0,0,0,2,1
9486,165738,rHhFTy1MHghalNQn9kKgxeI72dfIAI1Z,SpATywNh6bZuzm8s1ceuBUnMUAeoAHHw,2,0,0,0,0,0,2,0,2,0.2857142857142857,1,0.0,0,0,0,0,0,0,0,2,0,0,2,0
9487,165748,GrUpT0uWeNhnYmy4WRpw1EFafAAAhhi9,SpATywNh6bZuzm8s1ceuBUnMUAeoAHHw,22,39,0,31,1,10,9,0,90,12.857142857142858,2,0.0,10,0,31,1,29,10,0,9,0,42,48,0
9488,165758,BqlRpJCqwZj92xSZouRWh3sD1AZZKBEX,G8EPVSXsOYB5YQWZGiz1aVq5Pgr2GrQu,1,0,0,0,0,0,1,0,1,0.14285714285714285,1,0.0,0,0,0,0,0,0,0,1,0,0,1,1
9489,165760,zfQZFTiqHKQUgpAItjpYn7ZjkbIcP825,G8EPVSXsOYB5YQWZGiz1aVq5Pgr2GrQu,6,2,1,0,1,0,4,0,8,1.1428571428571428,1,0.0,0,1,0,1,2,0,0,4,0,2,6,1
9490,165762,6WkOKMKB5P2APoB7vbWWLXwAR3emifoG,A3fsA9Zfv1X2fVEQhTw51lKENdNrEqT3,7,12,8,0,2,0,3,0,25,3.5714285714285716,2,0.0,1,8,0,2,11,0,0,3,0,11,14,1
9491,165763,ON4mKUtTdsRS7Qi2xUjPqd2ovm0Dg75e,SpATywNh6bZuzm8s1ceuBUnMUAeoAHHw,9,11,5,6,0,1,4,0,27,3.857142857142857,2,0.0,1,5,5,0,10,1,1,4,0,11,16,1
9492,165768,hbzbE3YW3TFJZGn3KQWHVTTu9qGbrE8v,A3fsA9Zfv1X2fVEQhTw51lKENdNrEqT3,2,0,0,0,0,0,2,0,2,0.2857142857142857,1,0.0,0,0,0,0,0,0,0,2,0,0,2,1
9493,165781,hyGNNqxhAyFxbHW9ng6YRyMeUCWAgj0x,A3fsA9Zfv1X2fVEQhTw51lKENdNrEqT3,3,2,0,0,0,0,1,0,3,0.42857142857142855,1,0.0,0,0,0,0,2,0,0,1,0,0,3,0
9494,165785,rh0SgumcqbNnCp7Kv0VptrPMVPtrWDm8,A3fsA9Zfv1X2fVEQhTw51lKENdNrEqT3,7,8,2,0,1,0,4,0,15,2.142857142857143,1,0.0,2,2,0,1,6,0,0,4,0,5,10,1
9495,165793,NKdzAvohqx5ZB0phtZyAtuBxXKa68OBU,SpATywNh6bZuzm8s1ceuBUnMUAeoAHHw,8,8,0,0,0,0,4,0,12,1.7142857142857142,2,0.0,0,0,0,0,8,0,0,4,0,0,12,1
9496,165799,tWEnJYIhXMJ03Foo959mubaAJUHZPTw0,RXDvfPUBYFlVdlueBFbLW0mhhAyGEqpt,1,0,0,0,0,0,1,0,1,0.14285714285714285,1,0.0,0,0,0,0,0,0,0,1,0,0,1,1
9497,165814,0vxIliccHyPsFqS3FXAcl5CXDHX5ju89,SpATywNh6bZuzm8s1ceuBUnMUAeoAHHw,1,0,0,0,0,0,1,0,1,0.14285714285714285,1,0.0,0,0,0,0,0,0,0,1,0,0,1,1
9498,165819,RgSsBQ3nqtDrfLpSobr2YuUHRErLTR4s,RXDvfPUBYFlVdlueBFbLW0mhhAyGEqpt,11,7,6,0,5,0,1,0,19,2.7142857142857144,1,0.0,0,6,0,5,7,0,0,1,0,11,8,1
9499,165820,wcSIko8HPcmbs4cOPlImi3EyazICOLlR,A3fsA9Zfv1X2fVEQhTw51lKENdNrEqT3,1,0,0,0,0,0,2,0,2,0.2857142857142857,1,0.0,0,0,0,0,0,0,0,2,0,0,2,1
9500,166036,wCZGolOXIHC0m5ValHsltDi5uu5i6G63,fbPkOYLVPtPgIt0MxizjfFJov3JbHyAi,4,3,1,0,1,0,1,0,6,0.8571428571428571,1,0.0,0,1,0,1,3,0,0,1,0,2,4,1
9501,166037,wc8ABOXSHDqwIaE5k0JYlZP66W8tdlRo,fbPkOYLVPtPgIt0MxizjfFJov3JbHyAi,12,12,6,0,2,8,13,1,42,6.0,2,0.0,0,6,0,2,12,8,0,13,1,8,34,1
9502,166038,FFaLaJRa89FKW6pVYuJ3dXumxZUbwjZC,fbPkOYLVPtPgIt0MxizjfFJov3JbHyAi,1,0,0,0,0,0,1,0,1,0.14285714285714285,1,0.0,0,0,0,0,0,0,0,1,0,0,1,1
9503,166039,ESUjI9FMN0bUSmI9r3u304t5lebCsXMM,fbPkOYLVPtPgIt0MxizjfFJov3JbHyAi,6,2,1,0,0,1,5,1,10,1.4285714285714286,1,0.0,0,1,0,0,2,1,0,5,1,1,9,1
9504,166040,fcgIoTowNoXtysmcakqXD5rIrFDMOLMS,fbPkOYLVPtPgIt0MxizjfFJov3JbHyAi,4,2,1,0,1,0,1,0,5,0.7142857142857143,1,0.0,0,1,0,1,2,0,0,1,0,2,3,1
9505,166042,fTFCMd76UjKBUrosPwesoa2JcVylSbm0,fbPkOYLVPtPgIt0MxizjfFJov3JbHyAi,15,57,2,14,7,1,10,2,93,13.285714285714286,1,0.0,14,2,11,7,43,1,3,10,2,34,59,1
9506,166044,yImV3f0xQc91646kWaaTCoHPHfLcFyiE,fbPkOYLVPtPgIt0MxizjfFJov3JbHyAi,4,2,1,0,1,0,1,0,5,0.7142857142857143,1,0.0,0,1,0,1,2,0,0,1,0,2,3,1
9507,166045,fOR5X73Jlz0p1e9noRgVbo5kXcgdZJVO,fbPkOYLVPtPgIt0MxizjfFJov3JbHyAi,7,3,2,0,2,0,2,0,9,1.2857142857142858,1,0.0,0,2,0,2,3,0,0,2,0,4,5,1
9508,166047,vqP7fSXyXiWaT2K7Qf3eA0zXPxAvIBz4,fbPkOYLVPtPgIt0MxizjfFJov3JbHyAi,6,3,2,0,2,0,1,0,8,1.1428571428571428,1,0.0,0,2,0,2,3,0,0,1,0,4,4,1
9509,166048,aih3bUgUWJe7LHDxPrKqUKv7M1PtyZMy,fbPkOYLVPtPgIt0MxizjfFJov3JbHyAi,7,3,2,0,2,0,2,0,9,1.2857142857142858,1,0.0,0,2,0,2,3,0,0,2,0,4,5,1
9510,166049,wDXghK2BIM2TBsqSOrjDvr9Ut4FXTmRS,fbPkOYLVPtPgIt0MxizjfFJov3JbHyAi,7,3,2,0,2,0,3,0,10,1.4285714285714286,1,0.0,0,2,0,2,3,0,0,3,0,4,6,1
9511,166053,DhiB4cJ1TCjmSH3ZWP9m0OqNyBdGeS5P,fbPkOYLVPtPgIt0MxizjfFJov3JbHyAi,3,0,0,0,0,1,2,0,3,0.42857142857142855,1,0.0,0,0,0,0,0,1,0,2,0,0,3,1
9512,166057,y23uUtZASm6un1sOo8Z3FtFtr7wmEBUC,fbPkOYLVPtPgIt0MxizjfFJov3JbHyAi,8,3,1,0,1,2,5,1,13,1.8571428571428572,1,0.0,0,1,0,1,3,2,0,5,1,2,11,1
9513,166058,u3Es5hUyjf5nk8KFgVLYAoNUWyPWxnEj,fbPkOYLVPtPgIt0MxizjfFJov3JbHyAi,6,7,4,0,2,0,6,0,19,2.7142857142857144,1,0.0,0,4,0,2,7,0,0,6,0,6,13,1
9514,166059,tDLUr7SnRwxXyYOlr1OOOB7neeYu2GfR,fbPkOYLVPtPgIt0MxizjfFJov3JbHyAi,2,0,0,0,0,0,3,0,3,0.42857142857142855,1,0.0,0,0,0,0,0,0,0,3,0,0,3,1
9515,166060,NcjYJr1XLJ9a71yX9v2oEtoXLbIWWmNa,fbPkOYLVPtPgIt0MxizjfFJov3JbHyAi,7,10,1,1,2,0,4,0,18,2.5714285714285716,1,0.0,4,1,1,2,6,0,0,4,0,8,10,1
9516,166062,RQ6jHOF0XaVCtNO9cGrCBZ0SdqPrnq0p,fbPkOYLVPtPgIt0MxizjfFJov3JbHyAi,5,2,1,0,1,0,2,0,6,0.8571428571428571,1,0.0,0,1,0,1,2,0,0,2,0,2,4,1
9517,166066,0nSJm9RR2EHSZbxafc9dMAvqeh04T45l,fbPkOYLVPtPgIt0MxizjfFJov3JbHyAi,18,10,9,0,8,0,2,0,29,4.142857142857143,1,0.0,0,9,0,8,10,0,0,2,0,17,12,1
9518,166071,wdYj6Nt0ckfUFBd2Af4u2WMsP126y1D7,fbPkOYLVPtPgIt0MxizjfFJov3JbHyAi,7,2,2,0,1,0,3,0,8,1.1428571428571428,1,0.0,0,2,0,1,2,0,0,3,0,3,5,1
9519,166072,xzTUXMkATDrzXhPVq5lWKfyqNyH6U4X9,fbPkOYLVPtPgIt0MxizjfFJov3JbHyAi,1,0,0,0,0,0,1,0,1,0.14285714285714285,1,0.0,0,0,0,0,0,0,0,1,0,0,1,1
9520,166074,Xy9hY2jzdaXdVDhVwpfMWrmwNRASq6RF,fbPkOYLVPtPgIt0MxizjfFJov3JbHyAi,7,3,2,0,2,0,3,0,10,1.4285714285714286,1,0.0,0,2,0,2,3,0,0,3,0,4,6,1
9521,166075,AeNkuMZiCOxqxMy4dCnuYLHaK5F326HO,fbPkOYLVPtPgIt0MxizjfFJov3JbHyAi,1,0,0,0,0,0,1,0,1,0.14285714285714285,1,0.0,0,0,0,0,0,0,0,1,0,0,1,1
9522,166190,m0ftathRLrGnJCnhmZSV8vDms8QzsQ7P,fbPkOYLVPtPgIt0MxizjfFJov3JbHyAi,23,16,7,21,7,0,2,0,53,7.571428571428571,1,0.0,7,7,17,7,9,0,4,2,0,38,15,1
9523,166211,535rqCxCBVvAkDc6bSBePBKNVyS23A04,fbPkOYLVPtPgIt0MxizjfFJov3JbHyAi,7,3,1,0,2,0,2,0,8,1.1428571428571428,1,0.0,0,1,0,2,3,0,0,2,0,3,5,1
9524,166304,cr6Tgf9hnYbWIgXq8hI7G8mwIYtkpuPn,SpATywNh6bZuzm8s1ceuBUnMUAeoAHHw,8,12,8,0,0,0,12,0,32,4.571428571428571,3,0.0,0,8,0,0,12,0,0,12,0,8,24,1
9525,166334,O9GgLjRVV0VZ4XM2UvjBFBWJXBSS6aK0,SpATywNh6bZuzm8s1ceuBUnMUAeoAHHw,13,19,10,15,6,5,4,0,59,8.428571428571429,1,0.0,4,10,13,6,15,5,2,4,0,33,26,1
9526,166338,VGpsDdnTGsfrp3adgxkdRhxpkaNF7Bg2,SpATywNh6bZuzm8s1ceuBUnMUAeoAHHw,10,8,6,0,5,0,4,0,23,3.2857142857142856,1,0.0,0,6,0,5,8,0,0,4,0,11,12,1
9527,166409,iIkBXne7Ob9Fgz6Oa5wXMKZwMdTiJR2o,SpATywNh6bZuzm8s1ceuBUnMUAeoAHHw,7,2,1,0,1,2,5,1,12,1.7142857142857142,1,0.0,0,1,0,1,2,2,0,5,1,2,10,1
9528,166778,AtDlkFSnWTgMt7xJ3PkbVdpoMvsEJuZd,SpATywNh6bZuzm8s1ceuBUnMUAeoAHHw,5,2,0,0,1,0,2,0,5,0.7142857142857143,1,0.0,0,0,0,1,2,0,0,2,0,1,4,1
9529,166787,35YnYP4Tkn7xvOTt0M51AeVR3m7l2sIt,SpATywNh6bZuzm8s1ceuBUnMUAeoAHHw,13,11,0,10,0,1,5,1,28,4.0,1,0.0,4,0,9,0,7,1,1,5,1,13,15,1
9530,167084,OtGMx6eKyVYjbz3L87VVmC99kyg1WjEl,SpATywNh6bZuzm8s1ceuBUnMUAeoAHHw,30,57,22,46,8,28,16,4,181,25.857142857142858,4,0.0,20,22,36,8,37,28,10,16,4,86,95,0
9531,167109,riXqOkhR5seretWfUGQsZViiD6naR0Fb,G8EPVSXsOYB5YQWZGiz1aVq5Pgr2GrQu,8,6,3,0,2,0,3,0,14,2.0,1,0.0,0,3,0,2,6,0,0,3,0,5,9,1
9532,167207,l6rkobnqEUKXFQnaBVgonlwU5l25TkcG,A3fsA9Zfv1X2fVEQhTw51lKENdNrEqT3,30,9,6,54,4,1,4,1,79,11.285714285714286,1,0.0,1,6,53,4,8,1,1,4,1,64,15,0
9533,167283,ilday4HM3BCIYcolQVgtTOYVZxbISCZm,G8EPVSXsOYB5YQWZGiz1aVq5Pgr2GrQu,13,13,5,6,4,3,10,0,41,5.857142857142857,2,0.0,4,5,3,4,9,3,3,10,0,16,25,1
9534,167492,kMJdIf6lyKBj8d5FH5wYfeAvXu9zJZ2k,A3fsA9Zfv1X2fVEQhTw51lKENdNrEqT3,6,1,1,0,0,0,7,0,9,1.2857142857142858,1,0.0,0,1,0,0,1,0,0,7,0,1,8,1
9535,167712,JhqtKTVVZhx2wzcUoD48zfOf7XJtvv55,SpATywNh6bZuzm8s1ceuBUnMUAeoAHHw,9,7,4,0,2,0,6,0,19,2.7142857142857144,1,0.0,0,4,0,2,7,0,0,6,0,6,13,1
9536,167714,nyH7Jx4kN1AdDJdwkZQoUDqYoovHgbk5,G8EPVSXsOYB5YQWZGiz1aVq5Pgr2GrQu,13,31,12,10,9,0,3,0,65,9.285714285714286,3,0.0,13,12,6,9,18,0,4,3,0,40,25,1
9537,167738,8MuGb55gUM18pukCITXgZoTSobqXs9G4,A3fsA9Zfv1X2fVEQhTw51lKENdNrEqT3,2,0,0,0,0,0,2,0,2,0.2857142857142857,1,0.0,0,0,0,0,0,0,0,2,0,0,2,1
9538,167777,BWZyBrJDBbkcDEXyE3CSVFoVlT2CRRku,bWdj2GDclj5ofokWjzoa5jAwMkxCykd6,1,0,0,0,0,0,1,0,1,0.14285714285714285,1,0.0,0,0,0,0,0,0,0,1,0,0,1,1
9539,168016,Xdurokd2SSgNf25hifq07OxoiHEDcyiq,fbPkOYLVPtPgIt0MxizjfFJov3JbHyAi,5,6,4,0,0,2,4,0,16,2.2857142857142856,1,0.0,0,4,0,0,6,2,0,4,0,4,12,1
9540,169735,5IM8g7YMOYo5qH7Yu3x31T3JkVOH9iqe,7GRhBDsirIGkRZBtSMEzNTyDr2JQm4xx,5,2,1,0,1,0,2,0,6,0.8571428571428571,2,0.0,0,1,0,1,2,0,0,2,0,2,4,1
9541,169800,g3902agYIRHzac78MKVZlvljLMXXNpQ7,7GRhBDsirIGkRZBtSMEzNTyDr2JQm4xx,10,7,4,4,2,0,6,0,23,3.2857142857142856,1,0.0,1,4,4,2,6,0,0,6,0,11,12,1
9542,169865,FUKsUHV3URSaK57Jrek7EonPjAGWSjXW,7GRhBDsirIGkRZBtSMEzNTyDr2JQm4xx,3,2,1,0,0,0,2,0,5,0.7142857142857143,1,0.0,0,1,0,0,2,0,0,2,0,1,4,1
9543,169885,BSj3AAnB5ipEkdnoMrRkK2tTYOV9mAFC,7GRhBDsirIGkRZBtSMEzNTyDr2JQm4xx,9,9,3,4,1,2,5,0,24,3.4285714285714284,2,0.0,2,3,3,1,7,2,1,5,0,9,15,1
9544,169911,2j6SiYhVaWD27toQPxUbfR6IzUCgWGsO,7GRhBDsirIGkRZBtSMEzNTyDr2JQm4xx,1,0,0,0,0,0,1,0,1,0.14285714285714285,1,0.0,0,0,0,0,0,0,0,1,0,0,1,1
9545,169914,EX4mN8VqjmDrg8vjZaJJar6Z7qHJihO0,SpATywNh6bZuzm8s1ceuBUnMUAeoAHHw,16,18,6,14,3,1,6,1,49,7.0,1,0.0,9,6,14,3,9,1,0,6,1,32,17,0
9546,169943,BLyKMpisIDss4MmDNKRytNOAQZEOycAU,7GRhBDsirIGkRZBtSMEzNTyDr2JQm4xx,1,0,0,0,0,0,1,0,1,0.14285714285714285,1,0.0,0,0,0,0,0,0,0,1,0,0,1,1
9547,169955,ZQcqpVyhrZVshH7yyuAn3ze3B9JEoNBU,SpATywNh6bZuzm8s1ceuBUnMUAeoAHHw,1,0,0,0,0,0,1,0,1,0.14285714285714285,1,0.0,0,0,0,0,0,0,0,1,0,0,1,1
9548,169971,bNG7kJA3jy4DW8PDzMNAT9OoyHwhutqS,7GRhBDsirIGkRZBtSMEzNTyDr2JQm4xx,3,2,1,0,0,0,1,0,4,0.5714285714285714,1,0.0,0,1,0,0,2,0,0,1,0,1,3,1
9549,170020,nVB1o73xluQXZjoI2dUYHGxbCDG8qiCL,7GRhBDsirIGkRZBtSMEzNTyDr2JQm4xx,5,2,1,0,1,0,10,0,14,2.0,3,0.0,0,1,0,1,2,0,0,10,0,2,12,1
9550,170040,qqtHlVJpcH8uxc5327KA4fBoZNP0U5Xd,7GRhBDsirIGkRZBtSMEzNTyDr2JQm4xx,6,4,3,0,0,0,2,0,9,1.2857142857142858,1,0.0,0,3,0,0,4,0,0,2,0,3,6,1
9551,170061,tfoakS3EMOjWuYWNRSgWZTjBxe3Mf9Te,7GRhBDsirIGkRZBtSMEzNTyDr2JQm4xx,1,0,0,0,0,0,1,0,1,0.14285714285714285,1,0.0,0,0,0,0,0,0,0,1,0,0,1,1
9552,170075,nmifCUUA8im6jjkFk86bK5knz02SLRlN,7GRhBDsirIGkRZBtSMEzNTyDr2JQm4xx,7,4,2,0,2,0,2,0,10,1.4285714285714286,1,0.0,0,2,0,2,4,0,0,2,0,4,6,1
9553,170100,R0iGmWkfHC0JwSUufNxBJOtu3BmW7cey,7GRhBDsirIGkRZBtSMEzNTyDr2JQm4xx,10,21,6,0,4,2,3,0,36,5.142857142857143,1,0.0,13,6,0,4,8,2,0,3,0,23,13,1
9554,170206,mKHQM9iW9olu6z2WamdxK7ySH3UwX3JX,bWdj2GDclj5ofokWjzoa5jAwMkxCykd6,1,0,0,0,0,0,1,0,1,0.14285714285714285,1,0.0,0,0,0,0,0,0,0,1,0,0,1,1
9555,170213,dRpHvWsltBuE4KgJgZUdCQKV5v7VQuHh,7GRhBDsirIGkRZBtSMEzNTyDr2JQm4xx,10,2,1,0,1,3,8,4,19,2.7142857142857144,1,0.0,0,1,0,1,2,3,0,8,4,2,17,1
9556,170244,GdGI6ZUeHNfDd16CDy7Y3YMvqdJfsIRh,7GRhBDsirIGkRZBtSMEzNTyDr2JQm4xx,1,0,0,0,0,0,2,0,2,0.2857142857142857,1,0.0,0,0,0,0,0,0,0,2,0,0,2,1
9557,170247,vaWLVKWyrsUzDV0qs20ZUq8M3VNW01Uk,7GRhBDsirIGkRZBtSMEzNTyDr2JQm4xx,9,4,2,6,2,5,3,0,22,3.142857142857143,2,0.0,1,2,5,2,3,5,1,3,0,10,12,1
9558,170250,7jkKKf5Pb7FrtJ3WnuF11G7ePioUPJm3,bWdj2GDclj5ofokWjzoa5jAwMkxCykd6,3,2,1,0,0,1,1,0,5,0.7142857142857143,1,0.0,0,1,0,0,2,1,0,1,0,1,4,1
9559,170262,RHsk3gHUm8VEfb9FwEFf8vBDNKZZ0LWe,bWdj2GDclj5ofokWjzoa5jAwMkxCykd6,40,52,32,118,20,19,18,1,260,37.142857142857146,2,0.0,13,32,92,20,39,19,26,18,1,157,103,0
9560,170274,eb3SHueTE6ugnDkhYnh0RBSPDS20VwLZ,7GRhBDsirIGkRZBtSMEzNTyDr2JQm4xx,16,26,12,0,7,0,2,0,47,6.714285714285714,2,0.0,0,12,0,7,26,0,0,2,0,19,28,1
9561,170284,3RtHMyLQOrBsDYp6yo5VYdmS72cr3PBJ,bWdj2GDclj5ofokWjzoa5jAwMkxCykd6,5,1,1,0,1,0,3,0,6,0.8571428571428571,1,0.0,0,1,0,1,1,0,0,3,0,2,4,1
9562,170320,pqBs8sN0PT2UoBL7VKu89PIVTchItwDs,7GRhBDsirIGkRZBtSMEzNTyDr2JQm4xx,4,2,0,0,0,0,5,0,7,1.0,1,0.0,0,0,0,0,2,0,0,5,0,0,7,1
9563,170347,ung1DnQyYgd0tfz7mAKTwJrrm5UPHWt1,7GRhBDsirIGkRZBtSMEzNTyDr2JQm4xx,1,0,0,0,0,0,1,0,1,0.14285714285714285,1,0.0,0,0,0,0,0,0,0,1,0,0,1,1
9564,170400,qlV7NVEcCnAsxKC17kpoGCtCEpV1bUS5,A3fsA9Zfv1X2fVEQhTw51lKENdNrEqT3,11,4,3,0,3,3,4,0,17,2.4285714285714284,1,0.0,0,3,0,3,4,3,0,4,0,6,11,1
9565,170403,TY1XSpzUxZYHUqU0tQYtstvuwKCsGYpR,SpATywNh6bZuzm8s1ceuBUnMUAeoAHHw,3,2,0,0,0,0,2,0,4,0.5714285714285714,1,0.0,0,0,0,0,2,0,0,2,0,0,4,1
9566,170412,Z6SakRvyvh7ZuaV4DHEE1b3QLOpPcfOm,SpATywNh6bZuzm8s1ceuBUnMUAeoAHHw,16,14,1,26,0,0,8,1,50,7.142857142857143,3,0.0,4,1,25,0,10,0,1,8,1,30,20,0
9567,170432,CDy3wblikhG2TGdNI3LhbAglknKqeMeq,7GRhBDsirIGkRZBtSMEzNTyDr2JQm4xx,1,0,0,0,0,0,1,0,1,0.14285714285714285,1,0.0,0,0,0,0,0,0,0,1,0,0,1,1
9568,170458,DIfj5Ba2axfDE4LFDWqKjVBCgesW8XXW,A3fsA9Zfv1X2fVEQhTw51lKENdNrEqT3,1,0,0,0,0,0,1,0,1,0.14285714285714285,1,0.0,0,0,0,0,0,0,0,1,0,0,1,1
9569,170460,m8tZWvMesr1zQS0esJJogsiMlXHxe2Cd,7GRhBDsirIGkRZBtSMEzNTyDr2JQm4xx,1,0,0,0,0,0,1,0,1,0.14285714285714285,1,0.0,0,0,0,0,0,0,0,1,0,0,1,1
9570,170490,2H6KbsPWrpdsyjI0g4q0nnMN85W6it1n,7GRhBDsirIGkRZBtSMEzNTyDr2JQm4xx,1,0,0,0,0,0,1,0,1,0.14285714285714285,1,0.0,0,0,0,0,0,0,0,1,0,0,1,1
9571,170572,lyUyYIfExuGOGDXTlbgjuS96P5Iv4Fw9,SpATywNh6bZuzm8s1ceuBUnMUAeoAHHw,18,27,10,21,4,21,17,5,105,15.0,2,0.0,12,10,18,4,15,21,3,17,5,44,61,1
9572,170619,SSjJLhqPp3KtEjhygN5aGwtbWcKsJk4h,7GRhBDsirIGkRZBtSMEzNTyDr2JQm4xx,1,0,0,0,0,0,2,0,2,0.2857142857142857,1,0.0,0,0,0,0,0,0,0,2,0,0,2,1
9573,170650,WJvUM8vrAZx3jP5SMFm1lAFz7l2iXld4,7GRhBDsirIGkRZBtSMEzNTyDr2JQm4xx,5,2,1,0,1,0,2,0,6,0.8571428571428571,1,0.0,0,1,0,1,2,0,0,2,0,2,4,1
9574,170674,GfrMOiCcFGorw9y2zYLBWSI6Ij42MMT7,7GRhBDsirIGkRZBtSMEzNTyDr2JQm4xx,1,0,0,0,0,0,1,0,1,0.14285714285714285,1,0.0,0,0,0,0,0,0,0,1,0,0,1,1
9575,170681,cJJis1Eo88AzCRowxVa7rzvY4ZLonXwZ,A3fsA9Zfv1X2fVEQhTw51lKENdNrEqT3,6,2,1,0,1,0,4,0,8,1.1428571428571428,1,0.0,0,1,0,1,2,0,0,4,0,2,6,1
9576,170692,Hm7TJQq1vAhYsYwItY96s4Me02Vfs6zP,7GRhBDsirIGkRZBtSMEzNTyDr2JQm4xx,1,0,0,0,0,0,1,0,1,0.14285714285714285,1,0.0,0,0,0,0,0,0,0,1,0,0,1,1
9577,172761,sL5jw3pLWZoRI7avI17oM60mfF67Acgz,fbPkOYLVPtPgIt0MxizjfFJov3JbHyAi,4,0,0,0,0,1,5,0,6,0.8571428571428571,2,0.0,0,0,0,0,0,1,0,5,0,0,6,0
9578,173137,jV4bQZTO8NhEnxumKD5qHxnk6auhtohn,SpATywNh6bZuzm8s1ceuBUnMUAeoAHHw,12,7,3,10,2,0,2,0,24,3.4285714285714284,1,0.0,2,3,10,2,5,0,0,2,0,17,7,0
9579,173167,R2PVhKsPZcwfUBkw7hJ62cbr2j1XWSh4,SpATywNh6bZuzm8s1ceuBUnMUAeoAHHw,11,13,7,0,6,1,3,1,31,4.428571428571429,1,0.0,4,7,0,6,9,1,0,3,1,17,14,1
9580,173247,WLAmx1xu6Oqj4DvlomeHAJXvMyktUiPG,SpATywNh6bZuzm8s1ceuBUnMUAeoAHHw,1,0,0,0,0,0,1,0,1,0.14285714285714285,1,0.0,0,0,0,0,0,0,0,1,0,0,1,0
9581,173397,PUvUSLbNhJCmhl8hY6hN43xWGmaNTEJm,SpATywNh6bZuzm8s1ceuBUnMUAeoAHHw,3,2,0,0,0,0,1,0,3,0.42857142857142855,1,0.0,0,0,0,0,2,0,0,1,0,0,3,1
9582,173485,Gj6yrFuP2L0UySRxwG1ZhYaHhmyFPckw,SpATywNh6bZuzm8s1ceuBUnMUAeoAHHw,6,5,3,0,3,0,1,0,12,1.7142857142857142,1,0.0,1,3,0,3,4,0,0,1,0,7,5,1
9583,173594,fPM57KFy9Z8MO9ygSzYz3vMhCvMUYCpW,SpATywNh6bZuzm8s1ceuBUnMUAeoAHHw,4,3,0,0,0,0,1,0,4,0.5714285714285714,1,0.0,0,0,0,0,3,0,0,1,0,0,4,1
9584,173626,aEIz8d9s1BC7n4fBeFuKK0VhLVqwpGhk,SpATywNh6bZuzm8s1ceuBUnMUAeoAHHw,17,12,5,19,3,33,19,3,94,13.428571428571429,1,0.0,4,5,16,3,8,33,3,19,3,28,66,0
9585,173683,zKbFB2XJ8gemmfPKgB0q2D34TEqFCaPJ,SpATywNh6bZuzm8s1ceuBUnMUAeoAHHw,11,10,6,2,4,1,1,0,24,3.4285714285714284,1,0.0,2,6,2,4,8,1,0,1,0,14,10,1
9586,173759,OO1JwGoh4BUjbVi8UpZSb7D59mBcs3nt,bWdj2GDclj5ofokWjzoa5jAwMkxCykd6,4,3,1,0,1,0,1,0,6,0.8571428571428571,1,0.0,0,1,0,1,3,0,0,1,0,2,4,1
9587,173927,2jcDulxQhwaZp6ERelJB4WRzpPoEb0N3,G8EPVSXsOYB5YQWZGiz1aVq5Pgr2GrQu,24,19,9,46,8,5,10,0,97,13.857142857142858,1,0.0,9,9,38,8,10,5,8,10,0,64,33,1
9588,174023,qCRa9Z4oZ6HdXxtc9b3V1X8DNEfTKusC,SpATywNh6bZuzm8s1ceuBUnMUAeoAHHw,3,2,1,0,0,0,1,0,4,0.5714285714285714,1,0.0,0,1,0,0,2,0,0,1,0,1,3,1
9589,174123,vAGOe6e2RHZZ1EaDZrX2SIPJIAyfl840,SpATywNh6bZuzm8s1ceuBUnMUAeoAHHw,7,5,4,0,3,0,4,0,16,2.2857142857142856,2,0.0,0,4,0,3,5,0,0,4,0,7,9,1
9590,174379,BeoWdDFNsVFqWVq3B4qjYh8vNjNTgwSB,A3fsA9Zfv1X2fVEQhTw51lKENdNrEqT3,9,8,4,0,1,0,16,0,29,4.142857142857143,2,0.0,1,4,0,1,7,0,0,16,0,6,23,1
9591,174420,LKippngJk3cGSHQFQuBifcn7F1qfi1gi,A3fsA9Zfv1X2fVEQhTw51lKENdNrEqT3,7,3,2,0,2,0,2,0,9,1.2857142857142858,1,0.0,0,2,0,2,3,0,0,2,0,4,5,1
9592,174444,2dsmXUwyJ6i3C5akCdjurWqi0Hs9JJIw,A3fsA9Zfv1X2fVEQhTw51lKENdNrEqT3,4,2,1,0,1,0,1,0,5,0.7142857142857143,1,0.0,0,1,0,1,2,0,0,1,0,2,3,1
9593,174534,uxH2QBwZxSFN9LkkI09Zd3NZx6wgvi3y,A3fsA9Zfv1X2fVEQhTw51lKENdNrEqT3,7,4,1,0,1,0,2,0,8,1.1428571428571428,1,0.0,0,1,0,1,4,0,0,2,0,2,6,1
9594,174592,Q80okLXehG3FaUclazDQaglICbThrfeN,A3fsA9Zfv1X2fVEQhTw51lKENdNrEqT3,12,4,2,0,2,0,9,1,18,2.5714285714285716,1,0.0,0,2,0,2,4,0,0,9,1,4,14,1
9595,174614,TEtpertndC0kxUAzNDZsnaaHXZ1UiUgn,A3fsA9Zfv1X2fVEQhTw51lKENdNrEqT3,6,2,1,0,1,0,4,3,11,1.5714285714285714,1,0.0,0,1,0,1,2,0,0,4,3,2,9,1
9596,174624,oGK3c8nk6Ftl3V2u1zOvslszD4LDLr3w,SpATywNh6bZuzm8s1ceuBUnMUAeoAHHw,6,13,7,0,3,0,5,0,28,4.0,2,0.0,2,7,0,3,11,0,0,5,0,12,16,1
9597,174645,lJdTg9WUYwumFfeQmhmLXhBEAFP0NsAi,A3fsA9Zfv1X2fVEQhTw51lKENdNrEqT3,1,0,0,0,0,0,1,0,1,0.14285714285714285,1,0.0,0,0,0,0,0,0,0,1,0,0,1,1
9598,174672,N5iDERl36Pe29yDG8gDe9a99dYgqwB7y,A3fsA9Zfv1X2fVEQhTw51lKENdNrEqT3,1,0,0,0,0,0,1,0,1,0.14285714285714285,1,0.0,0,0,0,0,0,0,0,1,0,0,1,1
9599,174695,mu7Zdr1ChN6xNMWE8Otd7Si7TQhm7pEQ,bWdj2GDclj5ofokWjzoa5jAwMkxCykd6,6,5,3,0,2,0,4,0,14,2.0,1,0.0,0,3,0,2,5,0,0,4,0,5,9,1
9600,174811,JdEJSTgj9mzyZgP3wbpkgBRlhmZAWyOb,A3fsA9Zfv1X2fVEQhTw51lKENdNrEqT3,8,6,1,0,1,0,3,0,11,1.5714285714285714,1,0.0,0,1,0,1,6,0,0,3,0,2,9,1
9601,174850,JsUvqozri9AItThk54BBjEwYIqDey9JK,SpATywNh6bZuzm8s1ceuBUnMUAeoAHHw,14,22,10,20,6,0,5,0,63,9.0,4,0.0,6,10,16,6,16,0,4,5,0,38,25,1
9602,174890,JsUvqozri9AItThk54BBjEwYIqDey9JK,A3fsA9Zfv1X2fVEQhTw51lKENdNrEqT3,1,0,0,0,0,0,1,0,1,0.14285714285714285,1,0.0,0,0,0,0,0,0,0,1,0,0,1,1
9603,174896,W38DcguBOORgyx8AQARyx9O00yMNPg6e,A3fsA9Zfv1X2fVEQhTw51lKENdNrEqT3,24,25,13,0,8,0,4,0,50,7.142857142857143,2,0.0,0,13,0,8,25,0,0,4,0,21,29,1
9604,174947,YXkiTHpE2a6E2kDFUh3HT5sKHSlA7gXq,A3fsA9Zfv1X2fVEQhTw51lKENdNrEqT3,21,16,10,0,8,0,3,0,37,5.285714285714286,1,0.0,5,10,0,8,11,0,0,3,0,23,14,1
9605,175031,fiQPKilJkIFWShuteKFoAKrsoRjAoTQq,G8EPVSXsOYB5YQWZGiz1aVq5Pgr2GrQu,12,9,5,22,1,2,6,0,45,6.428571428571429,2,0.0,1,5,20,1,8,2,2,6,0,27,18,1
9606,175042,fN9yVRde7R2H7fN2gH8pJh2bfcNVmJQE,SpATywNh6bZuzm8s1ceuBUnMUAeoAHHw,4,3,1,0,1,0,1,0,6,0.8571428571428571,1,0.0,0,1,0,1,3,0,0,1,0,2,4,1
9607,175061,WoXtpP4H4ghgkRBv3UuiyrHP7GFAl55y,A3fsA9Zfv1X2fVEQhTw51lKENdNrEqT3,1,0,0,0,0,0,1,0,1,0.14285714285714285,1,0.0,0,0,0,0,0,0,0,1,0,0,1,1
9608,175139,Vdk84P68xIHXBGrWqw3oEozZYT063dLv,A3fsA9Zfv1X2fVEQhTw51lKENdNrEqT3,12,11,8,0,7,0,6,0,32,4.571428571428571,2,0.0,0,8,0,7,11,0,0,6,0,15,17,1
9609,175145,U6qE2fx7rlT2WEmACzAkhjUhd8LCbR1p,A3fsA9Zfv1X2fVEQhTw51lKENdNrEqT3,8,4,3,0,3,0,1,0,11,1.5714285714285714,1,0.0,0,3,0,3,4,0,0,1,0,6,5,1
9610,175170,o9SCOAY5nuSxaVorNF1mq3E0AGKQbCox,A3fsA9Zfv1X2fVEQhTw51lKENdNrEqT3,1,0,0,0,0,0,1,0,1,0.14285714285714285,1,0.0,0,0,0,0,0,0,0,1,0,0,1,1
9611,175256,jdfd8H9lnYttHWf9Izxs2MscynFXyhGW,A3fsA9Zfv1X2fVEQhTw51lKENdNrEqT3,4,5,1,0,0,0,1,0,7,1.0,1,0.0,0,1,0,0,5,0,0,1,0,1,6,0
9612,175322,YaeMtpEn02jmas25d0067kgG6T0CswLK,A3fsA9Zfv1X2fVEQhTw51lKENdNrEqT3,1,0,0,0,0,0,1,0,1,0.14285714285714285,1,0.0,0,0,0,0,0,0,0,1,0,0,1,1
9613,175337,4jGp0wM4bWQL7YeW1fZnRYCrYjnWjDPp,A3fsA9Zfv1X2fVEQhTw51lKENdNrEqT3,2,0,0,0,0,0,2,0,2,0.2857142857142857,1,0.0,0,0,0,0,0,0,0,2,0,0,2,1
9614,175380,xyhTJkgGghEribeWkvfmDO529PeI6BOD,A3fsA9Zfv1X2fVEQhTw51lKENdNrEqT3,23,16,11,0,11,0,4,0,42,6.0,1,0.0,0,11,0,11,16,0,0,4,0,22,20,1
9615,175382,YcbMhXf6WOxBHwzY0X9hWTypvQthAicg,SpATywNh6bZuzm8s1ceuBUnMUAeoAHHw,5,3,2,0,1,0,1,0,7,1.0,1,0.0,0,2,0,1,3,0,0,1,0,3,4,1
9616,175396,EvySN154YDM9eHA8rncD5Y4XnKitTOWj,A3fsA9Zfv1X2fVEQhTw51lKENdNrEqT3,1,0,0,0,0,0,1,0,1,0.14285714285714285,1,0.0,0,0,0,0,0,0,0,1,0,0,1,1
9617,175398,MoQLSLdgc8N78DNeGEQHypzHbyf063p0,A3fsA9Zfv1X2fVEQhTw51lKENdNrEqT3,1,0,0,0,0,0,1,0,1,0.14285714285714285,1,0.0,0,0,0,0,0,0,0,1,0,0,1,1
9618,175422,JLpYHpRsamf04qcVxCPYwLYYhT8v6H5r,A3fsA9Zfv1X2fVEQhTw51lKENdNrEqT3,9,4,3,0,3,0,2,0,12,1.7142857142857142,1,0.0,0,3,0,3,4,0,0,2,0,6,6,1
9619,175437,Ht8gQquuDWuHnE8TA1lycaHJ8C9MVf20,fbPkOYLVPtPgIt0MxizjfFJov3JbHyAi,1,0,0,0,0,0,1,0,1,0.14285714285714285,1,0.0,0,0,0,0,0,0,0,1,0,0,1,1
9620,175438,dcYgKBzujpMIqe60unjrhnmHIEGafOxK,fbPkOYLVPtPgIt0MxizjfFJov3JbHyAi,1,0,0,0,0,0,1,0,1,0.14285714285714285,1,0.0,0,0,0,0,0,0,0,1,0,0,1,1
9621,175441,bcbHJfb8lY4U1KCijmTk7gJHSF0OiBaV,fbPkOYLVPtPgIt0MxizjfFJov3JbHyAi,8,4,4,0,4,0,4,0,16,2.2857142857142856,1,0.0,0,4,0,4,4,0,0,4,0,8,8,1
9622,175442,VMKrpzh7jQOpngYePozoQTNizGUgxuvX,fbPkOYLVPtPgIt0MxizjfFJov3JbHyAi,5,0,0,0,0,3,6,1,10,1.4285714285714286,1,0.0,0,0,0,0,0,3,0,6,1,0,10,0
9623,175443,uOJVnPYi8EJLtbdq5vki7NQKzKS5WxlN,fbPkOYLVPtPgIt0MxizjfFJov3JbHyAi,9,23,2,0,2,0,8,1,36,5.142857142857143,1,0.0,7,2,0,2,16,0,0,8,1,11,25,1
9624,175448,8Ify4dSBeSQhnw6uYnkYU0v4wr7gJcMS,fbPkOYLVPtPgIt0MxizjfFJov3JbHyAi,9,8,2,0,4,0,8,1,23,3.2857142857142856,1,0.0,5,2,0,4,3,0,0,8,1,11,12,1
9625,175449,wR7MeRMuDjqJzIdX6xUDIhHYl6LZetsZ,fbPkOYLVPtPgIt0MxizjfFJov3JbHyAi,1,0,0,0,0,0,1,0,1,0.14285714285714285,1,0.0,0,0,0,0,0,0,0,1,0,0,1,1
9626,175452,UGrzFFoMUY8lyETY7WUVQiSf705Madpt,fbPkOYLVPtPgIt0MxizjfFJov3JbHyAi,1,0,0,0,0,0,1,0,1,0.14285714285714285,1,0.0,0,0,0,0,0,0,0,1,0,0,1,1
9627,175454,xMTEKIKt8iJP63Gwx7tRgqa1pIDmZgMk,fbPkOYLVPtPgIt0MxizjfFJov3JbHyAi,1,0,0,0,0,0,1,0,1,0.14285714285714285,1,0.0,0,0,0,0,0,0,0,1,0,0,1,1
9628,175455,QLDHYthOyr0cclZ1Sc6usIODjIEumKpI,fbPkOYLVPtPgIt0MxizjfFJov3JbHyAi,7,3,2,0,2,0,2,0,9,1.2857142857142858,1,0.0,0,2,0,2,3,0,0,2,0,4,5,1
9629,175456,OTIaOWnuQGJS24y1xroPuPud7cEKSrq6,fbPkOYLVPtPgIt0MxizjfFJov3JbHyAi,7,8,2,0,4,0,2,0,16,2.2857142857142856,1,0.0,5,2,0,4,3,0,0,2,0,11,5,1
9630,175457,5p4xnVU1oXqeHfhqOsPC09VPLJWVQgy1,fbPkOYLVPtPgIt0MxizjfFJov3JbHyAi,7,4,3,0,3,0,2,0,12,1.7142857142857142,1,0.0,0,3,0,3,4,0,0,2,0,6,6,1
9631,175461,XB0CsTWEqiEaZYtZLlV2XbWJ8POYjAA4,fbPkOYLVPtPgIt0MxizjfFJov3JbHyAi,7,4,2,0,2,0,4,0,12,1.7142857142857142,1,0.0,1,2,0,2,3,0,0,4,0,5,7,1
9632,175465,YhKyManCtFjOHDUhvEEwYRA6Sue32NUJ,fbPkOYLVPtPgIt0MxizjfFJov3JbHyAi,10,6,4,0,2,6,9,3,30,4.285714285714286,1,0.0,0,4,0,2,6,6,0,9,3,6,24,1
9633,175467,Ato56ooa6y54tphZfyEFBMuiinGkCdDC,fbPkOYLVPtPgIt0MxizjfFJov3JbHyAi,5,3,1,0,1,0,2,0,7,1.0,1,0.0,0,1,0,1,3,0,0,2,0,2,5,1
9634,175468,nV17iCvBE2XN1lp2NOww0UgnrnPkpny4,fbPkOYLVPtPgIt0MxizjfFJov3JbHyAi,13,16,5,11,7,1,13,3,56,8.0,1,0.0,8,5,8,7,8,1,3,13,3,28,28,1
9635,175469,3Un500IqBW3emCZEkVYOgMvAW5xeb1AP,fbPkOYLVPtPgIt0MxizjfFJov3JbHyAi,1,0,0,0,0,0,1,0,1,0.14285714285714285,1,0.0,0,0,0,0,0,0,0,1,0,0,1,1
9636,175471,Ar7wri6od2sIMOfx95hPmMwDttR4wtOC,fbPkOYLVPtPgIt0MxizjfFJov3JbHyAi,1,0,0,0,0,0,1,0,1,0.14285714285714285,1,0.0,0,0,0,0,0,0,0,1,0,0,1,1
9637,175474,Y1jXhPhCX2kJOjFXBIjhhtIcj4SJDjMI,fbPkOYLVPtPgIt0MxizjfFJov3JbHyAi,7,3,2,0,2,0,2,0,9,1.2857142857142858,1,0.0,0,2,0,2,3,0,0,2,0,4,5,1
9638,175475,1w0szCmbk0c8fTIiC10xTGm5aiOfXQpV,fbPkOYLVPtPgIt0MxizjfFJov3JbHyAi,5,2,1,0,1,0,3,0,7,1.0,1,0.0,0,1,0,1,2,0,0,3,0,2,5,1
9639,175476,CobcodAmjDEWWm8RdgM2qfuZmhHbHRNU,fbPkOYLVPtPgIt0MxizjfFJov3JbHyAi,6,3,1,0,1,0,6,0,11,1.5714285714285714,1,0.0,1,1,0,1,2,0,0,6,0,3,8,1
9640,175477,YK7kIznrzD8DIJpIXSwoLltRvaesCrfj,fbPkOYLVPtPgIt0MxizjfFJov3JbHyAi,6,3,2,0,2,0,2,0,9,1.2857142857142858,1,0.0,0,2,0,2,3,0,0,2,0,4,5,1
9641,175478,FIQFfdFooB5Qr3t4W3Ez4CHK8yaDPL6r,fbPkOYLVPtPgIt0MxizjfFJov3JbHyAi,8,7,3,0,2,5,2,1,20,2.857142857142857,1,0.0,0,3,0,2,7,5,0,2,1,5,15,1
9642,175479,5257BfDOFjjC1F8tPsdm817yJFHm3nJq,fbPkOYLVPtPgIt0MxizjfFJov3JbHyAi,5,2,1,0,1,0,2,0,6,0.8571428571428571,1,0.0,0,1,0,1,2,0,0,2,0,2,4,1
9643,175480,GCbj5MX1kqm8CtGBmbuXpnp1WMiRGaCo,fbPkOYLVPtPgIt0MxizjfFJov3JbHyAi,4,2,0,0,0,0,2,0,4,0.5714285714285714,1,0.0,0,0,0,0,2,0,0,2,0,0,4,1
9644,175481,ofogRZ8rNViMcr7xZw7tGZINwIkOUuzb,fbPkOYLVPtPgIt0MxizjfFJov3JbHyAi,7,3,2,0,2,0,3,0,10,1.4285714285714286,1,0.0,0,2,0,2,3,0,0,3,0,4,6,1
9645,175484,6EaK0gHFiSwbLJpDVBHv9ZNNoyIiEert,fbPkOYLVPtPgIt0MxizjfFJov3JbHyAi,1,0,0,0,0,0,1,0,1,0.14285714285714285,1,0.0,0,0,0,0,0,0,0,1,0,0,1,1
9646,175485,9karhKHktKTUl1g2B756WZohKwl0YF1K,fbPkOYLVPtPgIt0MxizjfFJov3JbHyAi,2,0,0,0,0,0,3,0,3,0.42857142857142855,1,0.0,0,0,0,0,0,0,0,3,0,0,3,1
9647,175486,om0KjvovtBK0gZUSboAPRv5A6Jkm00Ei,fbPkOYLVPtPgIt0MxizjfFJov3JbHyAi,7,5,2,0,2,0,4,0,13,1.8571428571428572,1,0.0,0,2,0,2,5,0,0,4,0,4,9,0
9648,175487,wNSaTBieURYU9eqRBVXTHwg7UnVH1LNG,fbPkOYLVPtPgIt0MxizjfFJov3JbHyAi,7,8,2,0,3,0,4,0,17,2.4285714285714284,1,0.0,2,2,0,3,6,0,0,4,0,7,10,1
9649,175489,gqg82ZlqVKWjlS0c4NNxNoHosWhYfCyK,fbPkOYLVPtPgIt0MxizjfFJov3JbHyAi,7,3,2,0,2,0,2,0,9,1.2857142857142858,1,0.0,0,2,0,2,3,0,0,2,0,4,5,1
9650,175490,PnA6r0X1SYV0NubfDqVTrMnAW0y3wbco,fbPkOYLVPtPgIt0MxizjfFJov3JbHyAi,8,5,2,0,3,0,5,1,16,2.2857142857142856,1,0.0,2,2,0,3,3,0,0,5,1,7,9,1
9651,175492,BsdltKARtL2vwhO9E4jy6NsRDyZPduO2,fbPkOYLVPtPgIt0MxizjfFJov3JbHyAi,6,3,1,0,1,0,2,0,7,1.0,1,0.0,0,1,0,1,3,0,0,2,0,2,5,1
9652,175493,LAOj1accETKmU8VQwigRsaQa5A7qsGPe,fbPkOYLVPtPgIt0MxizjfFJov3JbHyAi,7,5,2,0,2,0,4,0,13,1.8571428571428572,1,0.0,0,2,0,2,5,0,0,4,0,4,9,1
9653,175494,drW0fI24E8OPT5rwVcYcGjFLcooZDvPF,fbPkOYLVPtPgIt0MxizjfFJov3JbHyAi,7,5,3,0,2,0,2,0,12,1.7142857142857142,2,0.0,0,3,0,2,5,0,0,2,0,5,7,1
9654,175496,e5SHaCJ1YwrfRF0jQyBahObK2P8hYPve,fbPkOYLVPtPgIt0MxizjfFJov3JbHyAi,5,2,1,0,1,0,2,0,6,0.8571428571428571,1,0.0,0,1,0,1,2,0,0,2,0,2,4,1
9655,175497,IbpttTpyCGfZ6D6p8wXVxA8GNM8MhK7W,fbPkOYLVPtPgIt0MxizjfFJov3JbHyAi,1,0,0,0,0,0,1,0,1,0.14285714285714285,1,0.0,0,0,0,0,0,0,0,1,0,0,1,1
9656,175499,qbL2YHzrsuMmEiJasxtJywxONtOZbPqY,fbPkOYLVPtPgIt0MxizjfFJov3JbHyAi,5,3,1,0,1,0,4,0,9,1.2857142857142858,1,0.0,0,1,0,1,3,0,0,4,0,2,7,1
9657,175500,052V26a8dvnnaUmI4wUAzyjC2b7PSOrg,fbPkOYLVPtPgIt0MxizjfFJov3JbHyAi,5,5,2,0,2,0,2,0,11,1.5714285714285714,2,0.0,0,2,0,2,5,0,0,2,0,4,7,1
9658,175501,m9TcnazDdqlnNxcGRCE8U6df3FfqDKf1,fbPkOYLVPtPgIt0MxizjfFJov3JbHyAi,4,3,1,0,0,0,2,0,6,0.8571428571428571,1,0.0,0,1,0,0,3,0,0,2,0,1,5,1
9659,175502,CGrFKacz6p4gJHwJ4xqUr7POA26XzDqd,fbPkOYLVPtPgIt0MxizjfFJov3JbHyAi,4,2,1,0,1,0,1,0,5,0.7142857142857143,2,0.0,0,1,0,1,2,0,0,1,0,2,3,1
9660,175503,LTwrn8iO2pRbLrTnW6wOA9gDNQYv9ip1,fbPkOYLVPtPgIt0MxizjfFJov3JbHyAi,6,3,2,0,2,0,1,0,8,1.1428571428571428,1,0.0,0,2,0,2,3,0,0,1,0,4,4,1
9661,175504,3N5sXtJHk0S0MyzqJoRxaXFTELV1xCPn,fbPkOYLVPtPgIt0MxizjfFJov3JbHyAi,7,8,4,0,4,0,1,0,17,2.4285714285714284,1,0.0,2,4,0,4,6,0,0,1,0,10,7,1
9662,175505,WHZrYzY9tohLccoqyQSfSqyUPDUl9WdE,fbPkOYLVPtPgIt0MxizjfFJov3JbHyAi,7,3,2,0,2,0,2,0,9,1.2857142857142858,1,0.0,0,2,0,2,3,0,0,2,0,4,5,1
9663,175506,qTno0LLDbZSn2CC4rZpUMVqkfAX6tLBw,fbPkOYLVPtPgIt0MxizjfFJov3JbHyAi,1,0,0,0,0,0,1,0,1,0.14285714285714285,1,0.0,0,0,0,0,0,0,0,1,0,0,1,1
9664,175507,CFYmGwr95iYII1Xahjw54NZCjdk2d4Wp,fbPkOYLVPtPgIt0MxizjfFJov3JbHyAi,6,6,1,0,1,0,2,0,10,1.4285714285714286,1,0.0,1,1,0,1,5,0,0,2,0,3,7,1
9665,175508,XyCxlADmHDxfuETiOd9Qt3MOPKhTmOlb,fbPkOYLVPtPgIt0MxizjfFJov3JbHyAi,6,4,1,0,1,0,2,0,8,1.1428571428571428,1,0.0,0,1,0,1,4,0,0,2,0,2,6,1
9666,175510,kY9yPgTd7RyYG1qUhQ8Q0xOuR3Fox0Ti,fbPkOYLVPtPgIt0MxizjfFJov3JbHyAi,2,0,0,0,0,0,4,0,4,0.5714285714285714,1,0.0,0,0,0,0,0,0,0,4,0,0,4,1
9667,175515,R3pJN0fTux9sFYOjyzF0EbS2c0Xrmde3,fbPkOYLVPtPgIt0MxizjfFJov3JbHyAi,6,6,3,0,2,0,10,0,21,3.0,1,0.0,2,3,0,2,4,0,0,10,0,7,14,1
9668,175516,ldm7FcdWlJdLvNLq5omS5m0FzdvPxViY,fbPkOYLVPtPgIt0MxizjfFJov3JbHyAi,7,8,3,0,4,0,2,0,17,2.4285714285714284,1,0.0,2,3,0,4,6,0,0,2,0,9,8,1
9669,175518,tLauqU6m7jR9M9FVV91XHWWjOVljDHTA,fbPkOYLVPtPgIt0MxizjfFJov3JbHyAi,18,31,14,16,12,2,6,0,81,11.571428571428571,1,0.0,13,14,12,12,18,2,4,6,0,51,30,1
9670,175520,tkWTBuD8nrYklSlgsF9aKVPineGUm2wd,fbPkOYLVPtPgIt0MxizjfFJov3JbHyAi,7,10,2,0,1,0,3,0,16,2.2857142857142856,1,0.0,0,2,0,1,10,0,0,3,0,3,13,1
9671,175523,cv7s2nnOAGwzgfER5oZNesmUBbRGxCps,fbPkOYLVPtPgIt0MxizjfFJov3JbHyAi,7,3,2,0,2,0,2,0,9,1.2857142857142858,1,0.0,0,2,0,2,3,0,0,2,0,4,5,1
9672,175524,VeDeV6aD6kowERv1ygPjE9YEMgMJMOAv,fbPkOYLVPtPgIt0MxizjfFJov3JbHyAi,1,0,0,0,0,0,1,0,1,0.14285714285714285,1,0.0,0,0,0,0,0,0,0,1,0,0,1,1
9673,175526,ucQjAvDjYoqpSh3nQps3rSAEs5u7Mvtk,fbPkOYLVPtPgIt0MxizjfFJov3JbHyAi,2,0,0,0,0,0,2,0,2,0.2857142857142857,1,0.0,0,0,0,0,0,0,0,2,0,0,2,1
9674,175528,mz46tnsW5yzzVlL3u3XwzrxNaj8Gctbo,fbPkOYLVPtPgIt0MxizjfFJov3JbHyAi,1,0,0,0,0,0,1,0,1,0.14285714285714285,1,0.0,0,0,0,0,0,0,0,1,0,0,1,1
9675,175531,eXM1gBg4CSAoJIkchTxClftGT7trcN3I,fbPkOYLVPtPgIt0MxizjfFJov3JbHyAi,5,2,1,0,1,0,2,0,6,0.8571428571428571,1,0.0,0,1,0,1,2,0,0,2,0,2,4,1
9676,175533,TL1aA8ITe7VP42GX52yE5M5UsjXNCOS3,fbPkOYLVPtPgIt0MxizjfFJov3JbHyAi,7,5,3,0,2,5,2,0,17,2.4285714285714284,2,0.0,0,3,0,2,5,5,0,2,0,5,12,1
9677,175534,UtAqhqB3FX1II4t3OmHm0AmqSdhnUJww,fbPkOYLVPtPgIt0MxizjfFJov3JbHyAi,1,0,0,0,0,0,1,0,1,0.14285714285714285,1,0.0,0,0,0,0,0,0,0,1,0,0,1,1
9678,175535,Bf0qullIcB7YMd6p0ga3kapcfp1HAy4D,fbPkOYLVPtPgIt0MxizjfFJov3JbHyAi,4,2,1,0,1,0,1,0,5,0.7142857142857143,1,0.0,0,1,0,1,2,0,0,1,0,2,3,1
9679,175536,UGeVqsUEeFxkRpYFM0kXm2U5Cm8I1M7Q,fbPkOYLVPtPgIt0MxizjfFJov3JbHyAi,9,5,3,0,3,0,2,0,13,1.8571428571428572,1,0.0,1,3,0,3,4,0,0,2,0,7,6,1
9680,175537,nTUP3gEuwVy2Io3TzQXGmuh9VvJxgHk3,fbPkOYLVPtPgIt0MxizjfFJov3JbHyAi,1,0,0,0,0,0,1,0,1,0.14285714285714285,1,0.0,0,0,0,0,0,0,0,1,0,0,1,1
9681,175539,1CCZmdq6Gb6gZ6uKsuQ6KwhvPKPrUh2U,fbPkOYLVPtPgIt0MxizjfFJov3JbHyAi,5,2,1,0,1,0,4,0,8,1.1428571428571428,1,0.0,0,1,0,1,2,0,0,4,0,2,6,1
9682,175540,xB6Yoh3Jxp1w9CTAondnOiYqF7QVxKDy,fbPkOYLVPtPgIt0MxizjfFJov3JbHyAi,10,10,6,0,3,12,4,0,35,5.0,2,0.0,0,6,0,3,10,12,0,4,0,9,26,1
9683,175542,B02fY98iRJpi5vADl4eH2XHtzf1uLIV2,fbPkOYLVPtPgIt0MxizjfFJov3JbHyAi,5,3,1,0,1,0,2,0,7,1.0,1,0.0,0,1,0,1,3,0,0,2,0,2,5,1
9684,175543,O9Ru4jbLuBmSjAvyVz5x9pDKgWs38Hwv,fbPkOYLVPtPgIt0MxizjfFJov3JbHyAi,5,2,1,0,1,0,2,0,6,0.8571428571428571,1,0.0,0,1,0,1,2,0,0,2,0,2,4,1
9685,175544,U4zrVJHh3FaieGmYntHxuYMlUehDirPp,fbPkOYLVPtPgIt0MxizjfFJov3JbHyAi,4,2,1,0,1,0,1,0,5,0.7142857142857143,1,0.0,0,1,0,1,2,0,0,1,0,2,3,1
9686,175545,1R1CKWtxnh6YgR55bjp2SqlcSVpP0TFg,fbPkOYLVPtPgIt0MxizjfFJov3JbHyAi,5,4,0,0,0,4,4,0,12,1.7142857142857142,1,0.0,0,0,0,0,4,4,0,4,0,0,12,1
9687,175547,KjHPeZFepHZBGvn3dcFcrV9gz6Gs9Ua1,fbPkOYLVPtPgIt0MxizjfFJov3JbHyAi,1,0,0,0,0,0,1,0,1,0.14285714285714285,1,0.0,0,0,0,0,0,0,0,1,0,0,1,1
9688,176352,0Tg2flbTUdD7fODqYIfpiJiK0IDdFiOP,fbPkOYLVPtPgIt0MxizjfFJov3JbHyAi,10,11,8,0,3,9,4,1,36,5.142857142857143,1,0.0,0,8,0,3,11,9,0,4,1,11,25,1
9689,177084,KGMUqHbYYqeF4kil6zUa1qpianJR3FpM,SpATywNh6bZuzm8s1ceuBUnMUAeoAHHw,9,8,1,0,0,0,6,1,16,2.2857142857142856,2,0.0,1,1,0,0,7,0,0,6,1,2,14,1
9690,177087,9G22TFSpifXf2dRYsg4E8vgkMWfro3Ct,bWdj2GDclj5ofokWjzoa5jAwMkxCykd6,6,4,0,0,0,0,8,0,12,1.7142857142857142,1,0.0,0,0,0,0,4,0,0,8,0,0,12,1
9691,177114,wingMAl29ucopfiyx66jxxaUInzOOQW5,SpATywNh6bZuzm8s1ceuBUnMUAeoAHHw,1,0,0,0,0,0,1,0,1,0.14285714285714285,1,0.0,0,0,0,0,0,0,0,1,0,0,1,1
9692,177342,ukV83h2gop6RgQ4r0p0CZA73Nn6q15H2,SpATywNh6bZuzm8s1ceuBUnMUAeoAHHw,8,6,4,0,3,0,3,0,16,2.2857142857142856,1,0.0,0,4,0,3,6,0,0,3,0,7,9,1
9693,177493,K3eaSd5rYP9Gkimldqt40pigYQrGeLsH,A3fsA9Zfv1X2fVEQhTw51lKENdNrEqT3,16,8,7,0,6,0,2,0,23,3.2857142857142856,1,0.0,0,7,0,6,8,0,0,2,0,13,10,1
9694,177506,TL1aA8ITe7VP42GX52yE5M5UsjXNCOS3,SpATywNh6bZuzm8s1ceuBUnMUAeoAHHw,12,8,5,14,4,23,2,0,56,8.0,1,0.0,2,5,11,4,6,23,3,2,0,22,34,1
9695,177648,XTgYONXtkRAl3sCFaGFF8e1mU9AMcEwg,A3fsA9Zfv1X2fVEQhTw51lKENdNrEqT3,1,0,0,0,0,0,1,0,1,0.14285714285714285,1,0.0,0,0,0,0,0,0,0,1,0,0,1,1
9696,177656,3EOSgrGzaBOPj9C9GS5Q7Pv420ga9IOi,SpATywNh6bZuzm8s1ceuBUnMUAeoAHHw,16,16,8,0,6,0,2,0,32,4.571428571428571,2,0.0,0,8,0,6,16,0,0,2,0,14,18,1
9697,177692,EovGqmWXTyV2r8yAXv2wZ0VYOf33vn0t,SpATywNh6bZuzm8s1ceuBUnMUAeoAHHw,8,9,2,0,2,0,4,0,17,2.4285714285714284,1,0.0,1,2,0,2,8,0,0,4,0,5,12,1
9698,177701,vvZAdi1giBsqNJd2MIMUF2BeNIuSYzIL,A3fsA9Zfv1X2fVEQhTw51lKENdNrEqT3,1,0,0,0,0,0,1,0,1,0.14285714285714285,1,0.0,0,0,0,0,0,0,0,1,0,0,1,1
9699,177705,wlzAgdvhO4A4jv5wZbftQLCtHeMZtcKt,A3fsA9Zfv1X2fVEQhTw51lKENdNrEqT3,8,1,1,0,1,1,11,1,16,2.2857142857142856,1,0.0,0,1,0,1,1,1,0,11,1,2,14,1
9700,177706,Hw8jmGp4VI4tAz6cfKhHDOeLB2t7MJ9z,A3fsA9Zfv1X2fVEQhTw51lKENdNrEqT3,1,0,0,0,0,0,1,0,1,0.14285714285714285,1,0.0,0,0,0,0,0,0,0,1,0,0,1,1
9701,177712,bkuP1EtN8mdTFJXvfsUwoFetipNOKV1x,bWdj2GDclj5ofokWjzoa5jAwMkxCykd6,4,2,0,0,0,0,2,0,4,0.5714285714285714,1,0.0,0,0,0,0,2,0,0,2,0,0,4,0
9702,177716,YeSu5vnyd7NLR6mjoon0rNurw7LtWHKM,SpATywNh6bZuzm8s1ceuBUnMUAeoAHHw,5,2,1,0,1,0,2,0,6,0.8571428571428571,1,0.0,0,1,0,1,2,0,0,2,0,2,4,1
9703,177731,nWfmkEV4YCKZ7mcPyrthk5xsFNQD6yNN,SpATywNh6bZuzm8s1ceuBUnMUAeoAHHw,15,13,2,11,0,0,2,0,28,4.0,1,0.0,0,2,10,0,13,0,1,2,0,12,16,1
9704,177737,F7IgmS7BQy7wghj5xQppsiqo1bYAbUaS,A3fsA9Zfv1X2fVEQhTw51lKENdNrEqT3,2,0,0,0,0,0,3,0,3,0.42857142857142855,1,0.0,0,0,0,0,0,0,0,3,0,0,3,1
9705,177744,7MJ8Lhv2PsjCppkY7orFcs7zn9hmP4MG,A3fsA9Zfv1X2fVEQhTw51lKENdNrEqT3,5,2,1,0,1,0,3,0,7,1.0,2,0.0,0,1,0,1,2,0,0,3,0,2,5,1
9706,177746,FTdbZ3S8aZZ61DWcRvHq8VI8NuRVTtYB,SpATywNh6bZuzm8s1ceuBUnMUAeoAHHw,5,3,1,0,1,0,1,0,6,0.8571428571428571,1,0.0,0,1,0,1,3,0,0,1,0,2,4,1
9707,177781,Fjsr4YVijnhHCyav53zNG4j0ri6wctia,SpATywNh6bZuzm8s1ceuBUnMUAeoAHHw,5,2,1,0,1,1,2,0,7,1.0,1,0.0,0,1,0,1,2,1,0,2,0,2,5,1
9708,177802,IfuP3wsHPcoufqx0FyqFKUytwStvSPv8,SpATywNh6bZuzm8s1ceuBUnMUAeoAHHw,8,7,1,0,1,0,2,0,11,1.5714285714285714,1,0.0,0,1,0,1,7,0,0,2,0,2,9,1
9709,177808,h1QswJ31uhxfyhfP3OhNVJBUvcTub6pW,A3fsA9Zfv1X2fVEQhTw51lKENdNrEqT3,6,2,1,0,1,0,3,0,7,1.0,1,0.0,0,1,0,1,2,0,0,3,0,2,5,1
9710,177815,bntZ4rfkG0kbpKVyaZN5dpSYAjphN7lA,SpATywNh6bZuzm8s1ceuBUnMUAeoAHHw,2,0,0,0,0,0,4,0,4,0.5714285714285714,1,0.0,0,0,0,0,0,0,0,4,0,0,4,1
9711,177826,6Orjf1CvaLA2u5CajSzbONgKa1cSGpsp,SpATywNh6bZuzm8s1ceuBUnMUAeoAHHw,5,2,1,0,1,0,2,0,6,0.8571428571428571,1,0.0,0,1,0,1,2,0,0,2,0,2,4,1
9712,177833,WfZHYsGW1JdLRZrh0HxeGf3PWw6Zaiy6,SpATywNh6bZuzm8s1ceuBUnMUAeoAHHw,5,2,1,0,1,0,2,0,6,0.8571428571428571,1,0.0,0,1,0,1,2,0,0,2,0,2,4,1
9713,177838,sJcjGGS4IqxtZ0yUL13beAzln7dowOpj,SpATywNh6bZuzm8s1ceuBUnMUAeoAHHw,1,0,0,0,0,0,1,0,1,0.14285714285714285,1,0.0,0,0,0,0,0,0,0,1,0,0,1,1
9714,177874,vCeaWq9tqFyvtajgk87uB8epKyzp49he,SpATywNh6bZuzm8s1ceuBUnMUAeoAHHw,13,12,5,11,2,1,4,0,35,5.0,1,0.0,5,5,9,2,7,1,2,4,0,21,14,1
9715,177879,M8C9BDFICk4ida59GU0jjp556zazDEi1,G8EPVSXsOYB5YQWZGiz1aVq5Pgr2GrQu,4,2,1,0,0,0,2,0,5,0.7142857142857143,1,0.0,0,1,0,0,2,0,0,2,0,1,4,1
9716,177882,EwT4gfO7FSX1b89EA44scYJQueULJfeO,SpATywNh6bZuzm8s1ceuBUnMUAeoAHHw,5,2,1,0,1,0,2,0,6,0.8571428571428571,1,0.0,0,1,0,1,2,0,0,2,0,2,4,1
9717,177889,Ccj8NEsaoMQRZnTXAxQZ3mlzMKhmRScC,SpATywNh6bZuzm8s1ceuBUnMUAeoAHHw,16,23,10,6,4,0,3,0,46,6.571428571428571,1,0.0,6,10,6,4,17,0,0,3,0,26,20,0
9718,177896,A6tOI6UQdaIkkVbh2LcanNew6i5iO2fH,bWdj2GDclj5ofokWjzoa5jAwMkxCykd6,1,0,0,0,0,0,2,0,2,0.2857142857142857,1,0.0,0,0,0,0,0,0,0,2,0,0,2,1
9719,177916,x5efWjoRyi52rQ7JepSo4abkhsClgbZ4,bWdj2GDclj5ofokWjzoa5jAwMkxCykd6,2,0,0,0,0,0,2,0,2,0.2857142857142857,1,0.0,0,0,0,0,0,0,0,2,0,0,2,1
9720,177918,Ck862YJ4TKsW5xBb6Obw9gcSWBzSDmoA,SpATywNh6bZuzm8s1ceuBUnMUAeoAHHw,10,12,0,19,0,0,2,0,33,4.714285714285714,1,0.0,4,0,15,0,8,0,4,2,0,19,14,1
9721,177946,fsYAWTSjas5dj2ZT4ziu6J8GfCN2A543,SpATywNh6bZuzm8s1ceuBUnMUAeoAHHw,8,2,1,0,1,1,5,1,11,1.5714285714285714,1,0.0,0,1,0,1,2,1,0,5,1,2,9,1
9722,178015,IZxwz54TsYvU9RDBY0Jd0dZSoQSefAFM,SpATywNh6bZuzm8s1ceuBUnMUAeoAHHw,3,0,0,0,0,0,7,0,7,1.0,1,0.0,0,0,0,0,0,0,0,7,0,0,7,1
9723,178018,EQaS3CpcvDJhQrwHEK3TrEH3gvn0Dpxt,A3fsA9Zfv1X2fVEQhTw51lKENdNrEqT3,1,0,0,0,0,0,1,0,1,0.14285714285714285,1,0.0,0,0,0,0,0,0,0,1,0,0,1,1
9724,178031,dH1fJFd4EUa9cDGkzaH97LNe2YTOAGRI,bWdj2GDclj5ofokWjzoa5jAwMkxCykd6,1,0,0,0,0,0,2,0,2,0.2857142857142857,1,0.0,0,0,0,0,0,0,0,2,0,0,2,1
9725,178048,ZnF4cH0Rkfun3Ujybr1tuGGeHps3w9hO,A3fsA9Zfv1X2fVEQhTw51lKENdNrEqT3,20,10,9,0,8,0,3,0,30,4.285714285714286,2,0.0,0,9,0,8,10,0,0,3,0,17,13,1
9726,178057,vOyNIvbmr9YMEBhwQMSd5QWgWHEvzCE0,SpATywNh6bZuzm8s1ceuBUnMUAeoAHHw,9,8,1,10,1,0,3,0,23,3.2857142857142856,1,0.0,2,1,9,1,6,0,1,3,0,13,10,1
9727,178058,xk56WEVJEAYlfTe18KDPHjwyCpm6eESo,G8EPVSXsOYB5YQWZGiz1aVq5Pgr2GrQu,18,35,19,30,10,0,4,0,98,14.0,1,0.0,7,19,29,10,28,0,1,4,0,65,33,1
9728,178065,Cwlc0kvvLoKXxEuXNQkjFRo818TDMpZS,A3fsA9Zfv1X2fVEQhTw51lKENdNrEqT3,12,6,5,0,5,0,1,0,17,2.4285714285714284,1,0.0,0,5,0,5,6,0,0,1,0,10,7,1
9729,178071,8uKfJT3Ferex7gSStlreZzcbQrGyXHDu,A3fsA9Zfv1X2fVEQhTw51lKENdNrEqT3,13,5,4,22,3,0,1,0,35,5.0,1,0.0,0,4,19,3,5,0,3,1,0,26,9,1
9730,178091,YRvoydpc37Vpysmtw8O9rzowfgsZu7lO,SpATywNh6bZuzm8s1ceuBUnMUAeoAHHw,5,5,2,0,1,3,1,0,12,1.7142857142857142,1,0.0,2,2,0,1,3,3,0,1,0,5,7,1
9731,178094,esEoFNEKF5IP6OxWYdt6tpHD0Qc2cHks,SpATywNh6bZuzm8s1ceuBUnMUAeoAHHw,4,4,1,0,1,0,1,0,7,1.0,1,0.0,0,1,0,1,4,0,0,1,0,2,5,1
9732,178095,44onQpYi5VTnyFsvK7UkRriRlwhqqD0U,SpATywNh6bZuzm8s1ceuBUnMUAeoAHHw,1,0,0,0,0,0,1,0,1,0.14285714285714285,1,0.0,0,0,0,0,0,0,0,1,0,0,1,1
9733,178108,gSVv2aL3mlSaSez3uclTs7guBwBPusEU,A3fsA9Zfv1X2fVEQhTw51lKENdNrEqT3,1,0,0,0,0,0,1,0,1,0.14285714285714285,1,0.0,0,0,0,0,0,0,0,1,0,0,1,1
9734,178129,NMPg56MDKMVC7ti0J9mAofQpqCKjpKCl,bWdj2GDclj5ofokWjzoa5jAwMkxCykd6,8,5,1,0,2,1,6,1,16,2.2857142857142856,1,0.0,3,1,0,2,2,1,0,6,1,6,10,1
9735,178130,NMPg56MDKMVC7ti0J9mAofQpqCKjpKCl,A3fsA9Zfv1X2fVEQhTw51lKENdNrEqT3,1,0,0,0,0,0,1,0,1,0.14285714285714285,1,0.0,0,0,0,0,0,0,0,1,0,0,1,1
9736,178173,yuqt6qA4ywnzzkfFkXqBct0eJDj9XUsS,SpATywNh6bZuzm8s1ceuBUnMUAeoAHHw,6,1,1,0,1,0,3,0,6,0.8571428571428571,1,0.0,0,1,0,1,1,0,0,3,0,2,4,1
9737,178187,3THLA2KuYKQhJc7rfDiBcIyyI3oWoZEW,bWdj2GDclj5ofokWjzoa5jAwMkxCykd6,1,0,0,0,0,0,1,0,1,0.14285714285714285,1,0.0,0,0,0,0,0,0,0,1,0,0,1,1
9738,178206,vYYhKPJ8OWf68zu55Ez1PMsu8DH2KE0M,A3fsA9Zfv1X2fVEQhTw51lKENdNrEqT3,7,5,4,0,4,1,3,0,17,2.4285714285714284,1,0.0,0,4,0,4,5,1,0,3,0,8,9,1
9739,178214,ZgFCLkDPzcdiy0sIzPjvfQAgjdD1TUt9,A3fsA9Zfv1X2fVEQhTw51lKENdNrEqT3,8,6,3,0,1,2,9,2,23,3.2857142857142856,1,0.0,0,3,0,1,6,2,0,9,2,4,19,1
9740,179272,XydvMA0BgL1Al10q3L0D2wz1Y6wVb2rC,RXDvfPUBYFlVdlueBFbLW0mhhAyGEqpt,23,15,14,0,10,0,2,0,41,5.857142857142857,1,0.0,0,14,0,10,15,0,0,2,0,24,17,1
9741,179318,0islXLiLHhX22socdAlKCtW1OjyrNJz9,SpATywNh6bZuzm8s1ceuBUnMUAeoAHHw,7,3,2,0,2,0,2,0,9,1.2857142857142858,1,0.0,0,2,0,2,3,0,0,2,0,4,5,1
9742,179424,RyFLXBVd2U304JMB6ECFi9FilOybDHpw,SpATywNh6bZuzm8s1ceuBUnMUAeoAHHw,12,7,1,17,0,0,4,2,31,4.428571428571429,1,0.0,3,1,16,0,4,0,1,4,2,20,11,1
9743,179447,sRKFcCOCmJuLZB6RUcOH6aSVKmD3A5OQ,SpATywNh6bZuzm8s1ceuBUnMUAeoAHHw,1,0,0,0,0,0,1,0,1,0.14285714285714285,1,0.0,0,0,0,0,0,0,0,1,0,0,1,1
9744,179732,GnMMDgMkehWbrroCw3WzwugiIkCP2y33,G8EPVSXsOYB5YQWZGiz1aVq5Pgr2GrQu,18,14,9,34,6,7,4,0,74,10.571428571428571,1,0.0,2,9,29,6,12,7,5,4,0,46,28,1
9745,179739,yYsW32kCOP4EgbR8poMa9E3lg8DNZAYh,SpATywNh6bZuzm8s1ceuBUnMUAeoAHHw,1,0,0,0,0,0,1,0,1,0.14285714285714285,1,0.0,0,0,0,0,0,0,0,1,0,0,1,1
9746,179772,StY7mIcclc0vcUIJFTvL9RrXxdUXnEhh,SpATywNh6bZuzm8s1ceuBUnMUAeoAHHw,14,13,7,6,5,3,2,0,36,5.142857142857143,1,0.0,5,7,6,5,8,3,0,2,0,23,13,1
9747,179802,fIbdXFPoTOYlPmaY1ETJ8qg0oyUmhp0g,bWdj2GDclj5ofokWjzoa5jAwMkxCykd6,1,0,0,0,0,0,1,0,1,0.14285714285714285,1,0.0,0,0,0,0,0,0,0,1,0,0,1,1
9748,179834,ymWpwD3GRW9ut1JiVBQeAWpoDiatjwOa,A3fsA9Zfv1X2fVEQhTw51lKENdNrEqT3,1,0,0,0,0,0,1,0,1,0.14285714285714285,1,0.0,0,0,0,0,0,0,0,1,0,0,1,1
9749,180006,5I4Sxxub5eHlZ4uVi2doKTMQ77gD08Kz,SpATywNh6bZuzm8s1ceuBUnMUAeoAHHw,3,2,0,0,0,0,2,0,4,0.5714285714285714,1,0.0,0,0,0,0,2,0,0,2,0,0,4,1
9750,180043,IB6QwGjfRbp7aWxgSMpIkngT9FviLi1Z,bWdj2GDclj5ofokWjzoa5jAwMkxCykd6,1,0,0,0,0,0,1,0,1,0.14285714285714285,1,0.0,0,0,0,0,0,0,0,1,0,0,1,1
9751,180050,yAFOzDqu62VOeEElP9JgOlIiP2xoZYrS,7GRhBDsirIGkRZBtSMEzNTyDr2JQm4xx,1,0,0,0,0,0,1,0,1,0.14285714285714285,1,0.0,0,0,0,0,0,0,0,1,0,0,1,1
9752,180099,jrgM1oW0TWS88MYVs7LRUQjqPhGPE54P,7GRhBDsirIGkRZBtSMEzNTyDr2JQm4xx,46,72,36,50,20,32,23,0,233,33.285714285714285,1,0.0,31,36,44,20,41,32,6,23,0,131,102,1
9753,180179,SFfKdrEty3lLCn3Lw45FtRZTydUXwmxu,7GRhBDsirIGkRZBtSMEzNTyDr2JQm4xx,5,2,1,0,1,0,2,0,6,0.8571428571428571,1,0.0,0,1,0,1,2,0,0,2,0,2,4,1
9754,180216,QSaImtnwSyIvS5AffCcxoWPOjD7SK8AN,7GRhBDsirIGkRZBtSMEzNTyDr2JQm4xx,1,0,0,0,0,0,1,0,1,0.14285714285714285,1,0.0,0,0,0,0,0,0,0,1,0,0,1,1
9755,180269,oPqCsuIFtZAPoNsyhKvigrqOFJmD29Ve,7GRhBDsirIGkRZBtSMEzNTyDr2JQm4xx,13,16,7,4,2,10,13,1,53,7.571428571428571,2,0.0,2,7,3,2,14,10,1,13,1,14,39,1
9756,180318,Hf0URgVFicQOS2VXZZFuo5o8pUWE4p7E,7GRhBDsirIGkRZBtSMEzNTyDr2JQm4xx,1,0,0,0,0,0,1,0,1,0.14285714285714285,1,0.0,0,0,0,0,0,0,0,1,0,0,1,1
9757,180326,vIJUyeZxiAlOeYPEqKJHsdkNk5HQVTjW,7GRhBDsirIGkRZBtSMEzNTyDr2JQm4xx,1,0,0,0,0,0,1,0,1,0.14285714285714285,1,0.0,0,0,0,0,0,0,0,1,0,0,1,1
9758,182109,Gwa0DmAnwS7uFof0niE4PXKO0jXe3Slf,fbPkOYLVPtPgIt0MxizjfFJov3JbHyAi,1,0,0,0,0,0,1,0,1,0.14285714285714285,1,0.0,0,0,0,0,0,0,0,1,0,0,1,1
9759,182112,zlwQbpNIekZraqM3friulFpxhiOo1ayo,fbPkOYLVPtPgIt0MxizjfFJov3JbHyAi,10,15,5,12,5,0,1,0,38,5.428571428571429,1,0.0,8,5,10,5,7,0,2,1,0,28,10,1
9760,182113,GYgjnVWPCrydBlTq2p9TNsOMewn9I740,fbPkOYLVPtPgIt0MxizjfFJov3JbHyAi,7,3,2,0,2,1,2,0,10,1.4285714285714286,1,0.0,0,2,0,2,3,1,0,2,0,4,6,1
9761,182116,hHZ1kUumh00Z1O4WNdKmul7qhC5wFHpp,fbPkOYLVPtPgIt0MxizjfFJov3JbHyAi,2,0,0,0,0,0,2,0,2,0.2857142857142857,1,0.0,0,0,0,0,0,0,0,2,0,0,2,1
9762,182119,3cxRLD4ivD6Xixr11d6ir7hAedI4FyWB,fbPkOYLVPtPgIt0MxizjfFJov3JbHyAi,4,4,0,0,0,0,2,0,6,0.8571428571428571,1,0.0,0,0,0,0,4,0,0,2,0,0,6,1
9763,182120,6VA6nLOi6ahJ2WGPKX7ioAOUNgqPHvUs,fbPkOYLVPtPgIt0MxizjfFJov3JbHyAi,2,0,0,0,0,0,6,0,6,0.8571428571428571,1,0.0,0,0,0,0,0,0,0,6,0,0,6,1
9764,182121,E6bBR9HWJxY6CHMf6HUGhFy5mb5tOylJ,fbPkOYLVPtPgIt0MxizjfFJov3JbHyAi,11,8,5,0,5,0,7,0,25,3.5714285714285716,1,0.0,0,5,0,5,8,0,0,7,0,10,15,1
9765,182122,5YQOb4e4NWGumJICWtGzlXhZqNgwWRbu,fbPkOYLVPtPgIt0MxizjfFJov3JbHyAi,4,2,1,0,1,0,2,0,6,0.8571428571428571,1,0.0,0,1,0,1,2,0,0,2,0,2,4,1
9766,182123,ymJ3Ly9A46GdjQR1wi3rfZi54oWQxUId,fbPkOYLVPtPgIt0MxizjfFJov3JbHyAi,18,18,10,0,5,3,10,1,47,6.714285714285714,1,0.0,0,10,0,5,18,3,0,10,1,15,32,1
9767,182126,olMbWc9RSQc0Tu4bEWQzOnwezTDWcrs8,fbPkOYLVPtPgIt0MxizjfFJov3JbHyAi,6,5,1,0,1,0,2,0,9,1.2857142857142858,1,0.0,0,1,0,1,5,0,0,2,0,2,7,1
9768,182127,vRSgOJQhE6Dmiwqh3C4hk74qCb0K1GB9,fbPkOYLVPtPgIt0MxizjfFJov3JbHyAi,10,11,3,0,5,6,8,1,34,4.857142857142857,1,0.0,5,3,0,5,6,6,0,8,1,13,21,1
9769,182129,KZwRHcnI3AfT8vnaT6jXgPBnofHOQ7LC,fbPkOYLVPtPgIt0MxizjfFJov3JbHyAi,7,3,2,0,2,0,2,0,9,1.2857142857142858,1,0.0,0,2,0,2,3,0,0,2,0,4,5,1
9770,182130,NYIqoSfm9poo24TZ0kcwGlXtybBgVCOL,fbPkOYLVPtPgIt0MxizjfFJov3JbHyAi,11,13,6,4,6,13,6,1,49,7.0,1,0.0,5,6,4,6,8,13,0,6,1,21,28,1
9771,182131,fNApL5o3nJBE8hTLknxUE86rJy4pC3GT,fbPkOYLVPtPgIt0MxizjfFJov3JbHyAi,4,3,0,0,0,0,8,0,11,1.5714285714285714,1,0.0,0,0,0,0,3,0,0,8,0,0,11,1
9772,182132,hl9NS7ZQVsxPwew9lFoMcbw555xXfA7K,fbPkOYLVPtPgIt0MxizjfFJov3JbHyAi,7,5,2,0,1,4,3,0,15,2.142857142857143,1,0.0,0,2,0,1,5,4,0,3,0,3,12,1
9773,182133,UyFXTBkXJQGbTK6ia4vV9zDaXqtiIBQm,fbPkOYLVPtPgIt0MxizjfFJov3JbHyAi,7,8,2,0,3,0,2,0,15,2.142857142857143,1,0.0,5,2,0,3,3,0,0,2,0,10,5,1
9774,182136,X4KSPkBIdPEeXdEy4Fa5NvixCQZdfNj3,fbPkOYLVPtPgIt0MxizjfFJov3JbHyAi,4,2,1,0,1,2,1,0,7,1.0,1,0.0,0,1,0,1,2,2,0,1,0,2,5,0
9775,182137,y20f09CxhvS55Wblm8XZJQuRockZgjId,fbPkOYLVPtPgIt0MxizjfFJov3JbHyAi,7,6,2,0,3,0,4,0,15,2.142857142857143,1,0.0,3,2,0,3,3,0,0,4,0,8,7,1
9776,182140,CspzBeiHo2fn2vKCGW8HrTuVGO5NjODD,fbPkOYLVPtPgIt0MxizjfFJov3JbHyAi,7,7,4,0,3,1,1,0,16,2.2857142857142856,1,0.0,1,4,0,3,6,1,0,1,0,8,8,1
9777,182141,AauRkOnfsQwSVeed7CUEfyrgZR6O3N4f,fbPkOYLVPtPgIt0MxizjfFJov3JbHyAi,9,3,2,0,2,1,5,1,14,2.0,1,0.0,0,2,0,2,3,1,0,5,1,4,10,1
9778,182142,ZpH2lTvJnGFaqS5AMOBCpvMR4Yj9r7Pd,fbPkOYLVPtPgIt0MxizjfFJov3JbHyAi,9,3,2,0,2,0,6,1,14,2.0,1,0.0,0,2,0,2,3,0,0,6,1,4,10,1
9779,182148,QXkIuj2oxPauvAqRj9R3CrSpnC0ZZZoj,fbPkOYLVPtPgIt0MxizjfFJov3JbHyAi,1,0,0,0,0,0,1,0,1,0.14285714285714285,1,0.0,0,0,0,0,0,0,0,1,0,0,1,1
9780,182149,Gk8pzlz0IYhW1OkJmVAg6JK1p1uZlJAZ,fbPkOYLVPtPgIt0MxizjfFJov3JbHyAi,1,0,0,0,0,0,1,0,1,0.14285714285714285,1,0.0,0,0,0,0,0,0,0,1,0,0,1,1
9781,182150,7DufOZH7uJb86RSw7kwej322YsuvsAOn,fbPkOYLVPtPgIt0MxizjfFJov3JbHyAi,8,7,3,0,2,0,2,0,14,2.0,1,0.0,0,3,0,2,7,0,0,2,0,5,9,1
9782,182151,9IwP7y3bv6FVCnKXUMMCB32M5XkaXZUv,fbPkOYLVPtPgIt0MxizjfFJov3JbHyAi,4,2,1,0,1,3,1,0,8,1.1428571428571428,1,0.0,0,1,0,1,2,3,0,1,0,2,6,1
9783,182153,LYRECt7UvWAQo3p4ZaUgaxhi8hvbxrUh,fbPkOYLVPtPgIt0MxizjfFJov3JbHyAi,8,3,2,0,2,4,4,1,16,2.2857142857142856,1,0.0,0,2,0,2,3,4,0,4,1,4,12,1
9784,182157,qjvNhzawDTohg4QJduwMXhiyYQLWnwRL,fbPkOYLVPtPgIt0MxizjfFJov3JbHyAi,5,2,1,0,1,0,5,0,9,1.2857142857142858,1,0.0,0,1,0,1,2,0,0,5,0,2,7,1
9785,182158,EbhEKkK0InsrxKv61aHGTKOc8r6D96CH,fbPkOYLVPtPgIt0MxizjfFJov3JbHyAi,5,2,1,0,1,4,5,0,13,1.8571428571428572,1,0.0,0,1,0,1,2,4,0,5,0,2,11,1
9786,182161,fnqTxztLKveM5YvxSzdyiaXhOlLMcpQz,fbPkOYLVPtPgIt0MxizjfFJov3JbHyAi,6,3,2,0,2,0,1,0,8,1.1428571428571428,1,0.0,0,2,0,2,3,0,0,1,0,4,4,1
9787,182290,5toCKkjnRq0eSPOLqtFoS578XbzD4wBw,G8EPVSXsOYB5YQWZGiz1aVq5Pgr2GrQu,1,0,0,0,0,0,1,0,1,0.14285714285714285,1,0.0,0,0,0,0,0,0,0,1,0,0,1,1
9788,182291,cQRD9R1lgeOAK9gupu9KhB7dk2fRklcD,SpATywNh6bZuzm8s1ceuBUnMUAeoAHHw,1,0,0,0,0,0,1,0,1,0.14285714285714285,1,0.0,0,0,0,0,0,0,0,1,0,0,1,1
9789,182293,rjvGhIVc59Kfmh4NTR3DXDqHucpB5jFj,SpATywNh6bZuzm8s1ceuBUnMUAeoAHHw,1,0,0,0,0,0,1,0,1,0.14285714285714285,1,0.0,0,0,0,0,0,0,0,1,0,0,1,1
9790,182294,yzxOtAUXbE94zTY0JAZtWSh2NXgDCsgD,RXDvfPUBYFlVdlueBFbLW0mhhAyGEqpt,1,0,0,0,0,0,2,0,2,0.2857142857142857,1,0.0,0,0,0,0,0,0,0,2,0,0,2,1
9791,182295,zDSSBRMWP1Y5CJVqlFdftdl4OIpV063x,G8EPVSXsOYB5YQWZGiz1aVq5Pgr2GrQu,5,5,2,0,2,0,9,0,18,2.5714285714285716,1,0.0,2,2,0,2,3,0,0,9,0,6,12,1
9792,182301,kSqoYJOiSgMSgk1xmaagqD7swBESTNnk,SpATywNh6bZuzm8s1ceuBUnMUAeoAHHw,1,0,0,0,0,0,1,0,1,0.14285714285714285,1,0.0,0,0,0,0,0,0,0,1,0,0,1,1
9793,182303,6V0aEecugZSGEGjp9sOtqKaVX0hdaxfx,SpATywNh6bZuzm8s1ceuBUnMUAeoAHHw,1,0,0,0,0,0,1,0,1,0.14285714285714285,1,0.0,0,0,0,0,0,0,0,1,0,0,1,1
9794,182311,v2pq4xsqndqpApLtzn0qeg9IWIRhaLtH,RXDvfPUBYFlVdlueBFbLW0mhhAyGEqpt,1,0,0,0,0,0,1,0,1,0.14285714285714285,1,0.0,0,0,0,0,0,0,0,1,0,0,1,1
9795,182316,PlkufWXrNLS9iN2k0xnVvGFQQ3lcdAbM,G8EPVSXsOYB5YQWZGiz1aVq5Pgr2GrQu,1,0,0,0,0,0,1,0,1,0.14285714285714285,1,0.0,0,0,0,0,0,0,0,1,0,0,1,1
9796,182317,pCLzLzljqYC5o1UQJ6Cha7geyVzPY5Vr,SpATywNh6bZuzm8s1ceuBUnMUAeoAHHw,6,3,0,0,0,12,12,2,29,4.142857142857143,1,0.0,0,0,0,0,3,12,0,12,2,0,29,1
9797,182319,dVj05AozpSMnDp2rhv4XKLX2a6Zq0Qtw,G8EPVSXsOYB5YQWZGiz1aVq5Pgr2GrQu,1,0,0,0,0,0,1,0,1,0.14285714285714285,1,0.0,0,0,0,0,0,0,0,1,0,0,1,1
9798,182326,Sw8bR12uIoqYzcTEWiNrFu21bYIsPZ21,SpATywNh6bZuzm8s1ceuBUnMUAeoAHHw,8,3,1,0,1,4,11,1,21,3.0,2,0.0,0,1,0,1,3,4,0,11,1,2,19,1
9799,182335,o4d7pEXcgiRK88QgwrazSAkO64S1An1t,SpATywNh6bZuzm8s1ceuBUnMUAeoAHHw,5,0,0,0,0,1,6,1,8,1.1428571428571428,1,0.0,0,0,0,0,0,1,0,6,1,0,8,1
9800,182339,Xx5J61LsGAAIQtOy53VIgrfa1jCLAM7p,SpATywNh6bZuzm8s1ceuBUnMUAeoAHHw,6,4,0,0,0,0,9,3,16,2.2857142857142856,1,0.0,0,0,0,0,4,0,0,9,3,0,16,1
9801,182340,0hNxT6GuoMZdI4yowbLV9KqXkZO6tOr5,bWdj2GDclj5ofokWjzoa5jAwMkxCykd6,2,0,0,0,0,0,2,0,2,0.2857142857142857,1,0.0,0,0,0,0,0,0,0,2,0,0,2,1
9802,182347,HtQh4lek05i0a5loRX7CCHUQbHgEiPqt,G8EPVSXsOYB5YQWZGiz1aVq5Pgr2GrQu,1,0,0,0,0,0,1,0,1,0.14285714285714285,1,0.0,0,0,0,0,0,0,0,1,0,0,1,1
9803,182353,WO9GKA0lZwTMWZPNOUikUeUkOH5TeVRT,bWdj2GDclj5ofokWjzoa5jAwMkxCykd6,5,1,0,0,0,1,3,0,5,0.7142857142857143,1,0.0,0,0,0,0,1,1,0,3,0,0,5,1
9804,182356,Bk9dV86JsBuitZPucHUYfkNksrS8wdwY,G8EPVSXsOYB5YQWZGiz1aVq5Pgr2GrQu,1,0,0,0,0,0,1,0,1,0.14285714285714285,1,0.0,0,0,0,0,0,0,0,1,0,0,1,1
9805,182364,sHXZP4MEjEMzkkOQfvmTepwt8uTqOiyM,bWdj2GDclj5ofokWjzoa5jAwMkxCykd6,1,0,0,0,0,0,2,0,2,0.2857142857142857,1,0.0,0,0,0,0,0,0,0,2,0,0,2,1
9806,182373,JQ5HcehgeZikB3gBiE8cU639NjwVjWKa,SpATywNh6bZuzm8s1ceuBUnMUAeoAHHw,6,2,0,0,0,4,12,1,19,2.7142857142857144,1,0.0,0,0,0,0,2,4,0,12,1,0,19,1
9807,182381,qaaVUOEYbrLxp7YRueHtvaFuKfMUdZFu,SpATywNh6bZuzm8s1ceuBUnMUAeoAHHw,4,1,0,0,0,0,5,0,6,0.8571428571428571,1,0.0,0,0,0,0,1,0,0,5,0,0,6,1
9808,182382,GaGH1fy9jH1iKzXu03szgy9cHdGLnq5i,SpATywNh6bZuzm8s1ceuBUnMUAeoAHHw,5,3,0,0,0,1,8,1,13,1.8571428571428572,1,0.0,0,0,0,0,3,1,0,8,1,0,13,0
9809,182386,qPi2PGJwgnVJqcFYKHdGLm3vb4xL3Vqe,SpATywNh6bZuzm8s1ceuBUnMUAeoAHHw,3,1,0,0,0,0,2,1,4,0.5714285714285714,1,0.0,0,0,0,0,1,0,0,2,1,0,4,1
9810,182390,1b8W57uM2By4uHrSNMMSnzGhkYIXdyHL,SpATywNh6bZuzm8s1ceuBUnMUAeoAHHw,8,12,6,0,0,17,9,1,45,6.428571428571429,1,0.0,0,6,0,0,12,17,0,9,1,6,39,1
9811,182396,zp4PyZk9acvJn0zAHSStMGVB47KHiGqV,SpATywNh6bZuzm8s1ceuBUnMUAeoAHHw,4,2,0,0,0,1,6,0,9,1.2857142857142858,1,0.0,0,0,0,0,2,1,0,6,0,0,9,1
9812,182408,guVBQQJjeYDSTq5MuNRM97IJcEbUqgcR,bWdj2GDclj5ofokWjzoa5jAwMkxCykd6,1,0,0,0,0,0,1,0,1,0.14285714285714285,1,0.0,0,0,0,0,0,0,0,1,0,0,1,1
9813,182409,Ts2aYicZBB6YO6VPNN4UcEdjhKngsoNN,SpATywNh6bZuzm8s1ceuBUnMUAeoAHHw,5,7,2,0,1,0,4,0,14,2.0,1,0.0,0,2,0,1,7,0,0,4,0,3,11,1
9814,182410,LF2KQyoh29W4ySeHppAbd59MSPNMzEhL,SpATywNh6bZuzm8s1ceuBUnMUAeoAHHw,7,4,3,0,3,0,3,0,13,1.8571428571428572,1,0.0,0,3,0,3,4,0,0,3,0,6,7,1
9815,182412,nWBGuFtxvcnIdby83CLlwrZAI2gdEnIT,SpATywNh6bZuzm8s1ceuBUnMUAeoAHHw,12,23,0,32,0,0,5,0,60,8.571428571428571,1,0.0,15,0,31,0,8,0,1,5,0,46,14,1
9816,182413,GXDOLXInBDPENmCe7wGStFtoPK2oUX4s,SpATywNh6bZuzm8s1ceuBUnMUAeoAHHw,1,0,0,0,0,0,7,0,7,1.0,1,0.0,0,0,0,0,0,0,0,7,0,0,7,1
9817,182431,FvzTIFO6hWFbSbURKzXHQcilBAcLEPtg,SpATywNh6bZuzm8s1ceuBUnMUAeoAHHw,7,6,4,0,2,1,1,0,14,2.0,1,0.0,0,4,0,2,6,1,0,1,0,6,8,1
9818,182432,42bX0uPWOXgBHMwF4wqdnl1Ve6wIHNQe,RXDvfPUBYFlVdlueBFbLW0mhhAyGEqpt,1,0,0,0,0,0,1,0,1,0.14285714285714285,1,0.0,0,0,0,0,0,0,0,1,0,0,1,1
9819,182435,HxeyM7hnjqqrHkT4PVJnwDZtWwoxUMiy,SpATywNh6bZuzm8s1ceuBUnMUAeoAHHw,11,10,1,0,1,1,6,1,20,2.857142857142857,1,0.0,2,1,0,1,8,1,0,6,1,4,16,1
9820,182437,6tKFS11agpQ0olDkx5j9iNHGPGSGzhhI,SpATywNh6bZuzm8s1ceuBUnMUAeoAHHw,5,2,1,0,1,0,3,0,7,1.0,1,0.0,0,1,0,1,2,0,0,3,0,2,5,1
9821,182438,Lj5uTbeKi1sufoHMuLZiALNDuJSM9yU6,SpATywNh6bZuzm8s1ceuBUnMUAeoAHHw,8,12,6,0,4,22,6,0,50,7.142857142857143,1,0.0,0,6,0,4,12,22,0,6,0,10,40,1
9822,182440,kEYZryUXXrs1JDEn4cAws8bSjO65yGwg,SpATywNh6bZuzm8s1ceuBUnMUAeoAHHw,10,4,3,0,2,0,5,0,14,2.0,1,0.0,0,3,0,2,4,0,0,5,0,5,9,1
9823,182443,xS1af9TI3CHZS0INarz6NC45nSv9EYbw,SpATywNh6bZuzm8s1ceuBUnMUAeoAHHw,4,3,1,0,0,0,2,0,6,0.8571428571428571,1,0.0,0,1,0,0,3,0,0,2,0,1,5,0
9824,182456,N48ctBBocxdq0KkO9X20oV13gY0Gjyl2,SpATywNh6bZuzm8s1ceuBUnMUAeoAHHw,5,3,2,0,2,0,2,0,9,1.2857142857142858,1,0.0,0,2,0,2,3,0,0,2,0,4,5,1
9825,182460,GjfYG8nVkFnRE6YCq1jd11CdDUHtJYRI,RXDvfPUBYFlVdlueBFbLW0mhhAyGEqpt,2,0,0,0,0,0,2,0,2,0.2857142857142857,1,0.0,0,0,0,0,0,0,0,2,0,0,2,1
9826,182462,SKgefBsbooOLi1DQ2ANZv6uhR5LclYyt,SpATywNh6bZuzm8s1ceuBUnMUAeoAHHw,2,0,0,0,0,0,2,0,2,0.2857142857142857,1,0.0,0,0,0,0,0,0,0,2,0,0,2,1
9827,182469,3kzqQ9nu0puySXndbv8HvzuMPwBlBjfc,SpATywNh6bZuzm8s1ceuBUnMUAeoAHHw,5,2,1,0,1,0,3,0,7,1.0,1,0.0,0,1,0,1,2,0,0,3,0,2,5,1
9828,182474,jhtAULfQ5yICMx2IFQr24sJJ4xrsxsJG,SpATywNh6bZuzm8s1ceuBUnMUAeoAHHw,5,2,1,0,1,0,2,0,6,0.8571428571428571,1,0.0,0,1,0,1,2,0,0,2,0,2,4,1
9829,182475,mN4qYBgpy4Qxh2rSlBkY5ZDyLEZtAHu9,SpATywNh6bZuzm8s1ceuBUnMUAeoAHHw,6,5,3,0,1,4,3,1,17,2.4285714285714284,2,0.0,0,3,0,1,5,4,0,3,1,4,13,1
9830,182481,vyEmNT9CTTZs1s1eotM7mTmxUqBkMZB7,RXDvfPUBYFlVdlueBFbLW0mhhAyGEqpt,1,0,0,0,0,0,1,0,1,0.14285714285714285,1,0.0,0,0,0,0,0,0,0,1,0,0,1,1
9831,182485,z17j9VE8hh3UoPkOgrySRSueL3ju2tA5,SpATywNh6bZuzm8s1ceuBUnMUAeoAHHw,5,2,1,0,1,0,2,0,6,0.8571428571428571,1,0.0,0,1,0,1,2,0,0,2,0,2,4,1
9832,182486,m5upFVNgYoX0YbIT8oOeY2wNVmvYCqj2,SpATywNh6bZuzm8s1ceuBUnMUAeoAHHw,14,16,0,8,0,0,11,1,36,5.142857142857143,2,0.0,2,0,8,0,14,0,0,11,1,10,26,1
9833,182487,nVOg10sq8HgH3D4DlsGdX3NFr8soVHEc,RXDvfPUBYFlVdlueBFbLW0mhhAyGEqpt,3,0,0,0,0,1,2,1,4,0.5714285714285714,1,0.0,0,0,0,0,0,1,0,2,1,0,4,1
9834,182489,NrHk4qmJXuD0TsjkQSnghKpk9ZjGAOyU,SpATywNh6bZuzm8s1ceuBUnMUAeoAHHw,6,4,3,0,3,0,1,0,11,1.5714285714285714,1,0.0,0,3,0,3,4,0,0,1,0,6,5,1
9835,182494,zsHSwvXoubMUxhT2AYVzfcvRGMppEBUX,SpATywNh6bZuzm8s1ceuBUnMUAeoAHHw,1,0,0,0,0,0,1,0,1,0.14285714285714285,1,0.0,0,0,0,0,0,0,0,1,0,0,1,1
9836,182500,VBP5PzVQEKJYFH0y5ffEek5WfP9EW7uc,RXDvfPUBYFlVdlueBFbLW0mhhAyGEqpt,1,0,0,0,0,0,1,0,1,0.14285714285714285,1,0.0,0,0,0,0,0,0,0,1,0,0,1,1
9837,182502,kAraFi42vk7T3fSVrfxFu4iOqntHqrmm,SpATywNh6bZuzm8s1ceuBUnMUAeoAHHw,5,2,1,0,1,0,2,0,6,0.8571428571428571,1,0.0,0,1,0,1,2,0,0,2,0,2,4,1
9838,182505,m0a4B9CqoOZviuEOZZDt94aINv2ug5oe,SpATywNh6bZuzm8s1ceuBUnMUAeoAHHw,12,12,0,18,0,1,5,1,37,5.285714285714286,1,0.0,7,0,16,0,5,1,2,5,1,23,14,1
9839,182512,6hJQXXKt3z1MdoT6ARo6T723NTe1XSxK,SpATywNh6bZuzm8s1ceuBUnMUAeoAHHw,5,3,2,0,0,0,2,0,7,1.0,1,0.0,0,2,0,0,3,0,0,2,0,2,5,1
9840,182517,ks5e3RcWAMPB7dYikwZWJXfUkWO8gZ3N,SpATywNh6bZuzm8s1ceuBUnMUAeoAHHw,4,3,0,0,1,0,1,0,5,0.7142857142857143,1,0.0,0,0,0,1,3,0,0,1,0,1,4,1
9841,182521,T5B0wanX0DF5aMvlnBdjCYkcuibanyPc,SpATywNh6bZuzm8s1ceuBUnMUAeoAHHw,7,3,2,0,2,1,2,0,10,1.4285714285714286,1,0.0,0,2,0,2,3,1,0,2,0,4,6,1
9842,182523,84Vq27rxsidbGJFxLO0cd5e2CSiXRChu,bWdj2GDclj5ofokWjzoa5jAwMkxCykd6,9,5,3,0,2,0,5,0,15,2.142857142857143,2,0.0,0,3,0,2,5,0,0,5,0,5,10,1
9843,182525,cPdYTPvgiw01Ix09y30D3fRJUN12tLct,SpATywNh6bZuzm8s1ceuBUnMUAeoAHHw,4,2,1,0,1,0,1,0,5,0.7142857142857143,1,0.0,0,1,0,1,2,0,0,1,0,2,3,1
9844,182528,9BiLYY350hgtHO5tL7nbMfcZU0JcfZbs,bWdj2GDclj5ofokWjzoa5jAwMkxCykd6,13,32,11,26,8,6,15,3,101,14.428571428571429,2,0.0,7,11,25,8,25,6,1,15,3,51,50,1
9845,182532,hnqQN2i26CUAGHIpVFZ6rAak8SqbOivU,SpATywNh6bZuzm8s1ceuBUnMUAeoAHHw,14,12,7,0,4,12,6,2,43,6.142857142857143,1,0.0,3,7,0,4,9,12,0,6,2,14,29,1
9846,182535,Y6X26XefNz3sdpw3wkwyK5sCZwXPgnq9,G8EPVSXsOYB5YQWZGiz1aVq5Pgr2GrQu,1,0,0,0,0,0,1,0,1,0.14285714285714285,1,0.0,0,0,0,0,0,0,0,1,0,0,1,1
9847,182537,1MlRC5B28v0ZYaZMhNewOGPdpzQmr9tm,G8EPVSXsOYB5YQWZGiz1aVq5Pgr2GrQu,1,0,0,0,0,0,2,0,2,0.2857142857142857,1,0.0,0,0,0,0,0,0,0,2,0,0,2,1
9848,182549,95du6AurTX5krUoy6t3WLkl60ccYr4Yy,SpATywNh6bZuzm8s1ceuBUnMUAeoAHHw,7,6,3,0,2,0,1,0,12,1.7142857142857142,1,0.0,0,3,0,2,6,0,0,1,0,5,7,1
9849,182550,s7vJJA7T1Y0Q1LgIP8wcUZxSj1YxtrKh,SpATywNh6bZuzm8s1ceuBUnMUAeoAHHw,5,2,1,0,1,0,2,0,6,0.8571428571428571,1,0.0,0,1,0,1,2,0,0,2,0,2,4,1
9850,182551,TzUoSJ3pyMjwCKLIHuVSKLad9h9hLr5U,bWdj2GDclj5ofokWjzoa5jAwMkxCykd6,4,4,0,0,0,0,2,0,6,0.8571428571428571,2,0.0,0,0,0,0,4,0,0,2,0,0,6,1
9851,182562,abjQNDbGZHBvhV75LOq4Zq7eUXUW7X3t,SpATywNh6bZuzm8s1ceuBUnMUAeoAHHw,5,2,1,0,1,16,4,0,24,3.4285714285714284,1,0.0,0,1,0,1,2,16,0,4,0,2,22,1
9852,182564,9TiNdK7h4B0s8IwXYYwGBHmjweOZzBSB,SpATywNh6bZuzm8s1ceuBUnMUAeoAHHw,6,3,2,0,2,0,1,0,8,1.1428571428571428,1,0.0,0,2,0,2,3,0,0,1,0,4,4,1
9853,182566,d5l2AueqCUuxelNqQjpUQXmepKxeL9RK,SpATywNh6bZuzm8s1ceuBUnMUAeoAHHw,2,0,0,0,0,0,3,0,3,0.42857142857142855,1,0.0,0,0,0,0,0,0,0,3,0,0,3,1
9854,182578,2lL4O2JkoYHXEIhykvPcKhzBe5EQva7N,SpATywNh6bZuzm8s1ceuBUnMUAeoAHHw,10,6,4,0,3,1,4,0,18,2.5714285714285716,1,0.0,0,4,0,3,6,1,0,4,0,7,11,1
9855,182580,Sg8cI88TycyqBJF3IvR4MAi6ZTHZwK4Y,SpATywNh6bZuzm8s1ceuBUnMUAeoAHHw,8,4,2,0,2,0,2,0,10,1.4285714285714286,1,0.0,0,2,0,2,4,0,0,2,0,4,6,1
9856,182581,jU374KwiA6GV2KDGbAoaF4QnL7rMxEi0,G8EPVSXsOYB5YQWZGiz1aVq5Pgr2GrQu,2,0,0,0,0,0,2,0,2,0.2857142857142857,1,0.0,0,0,0,0,0,0,0,2,0,0,2,1
9857,182585,2a0JX3oGEViqf41bSYpVwPl2biPpAdoF,SpATywNh6bZuzm8s1ceuBUnMUAeoAHHw,1,0,0,0,0,0,2,0,2,0.2857142857142857,1,0.0,0,0,0,0,0,0,0,2,0,0,2,1
9858,182588,0PHNMn5JYsQigYaNxUJgIv4qow2cWlQK,RXDvfPUBYFlVdlueBFbLW0mhhAyGEqpt,1,0,0,0,0,0,1,0,1,0.14285714285714285,1,0.0,0,0,0,0,0,0,0,1,0,0,1,1
9859,182594,i1weaEaafaiWi31Ms4bwoF6JM4IRf714,RXDvfPUBYFlVdlueBFbLW0mhhAyGEqpt,4,2,1,0,1,0,1,0,5,0.7142857142857143,1,0.0,0,1,0,1,2,0,0,1,0,2,3,1
9860,182597,yP6YIcdT0zgy1EQJGlMcTsst8ErbjUGy,SpATywNh6bZuzm8s1ceuBUnMUAeoAHHw,15,12,7,8,4,0,4,0,35,5.0,1,0.0,2,7,8,4,10,0,0,4,0,21,14,1
9861,182601,ryvCYWNER8Ti86HxjplPmDOVtkpCfcHF,SpATywNh6bZuzm8s1ceuBUnMUAeoAHHw,5,2,0,3,0,0,3,0,8,1.1428571428571428,1,0.0,1,0,3,0,1,0,0,3,0,4,4,1
9862,182603,pC6FwYDHxh9swUa6nvJYcLLtE0AYC1Cg,G8EPVSXsOYB5YQWZGiz1aVq5Pgr2GrQu,1,0,0,0,0,0,1,0,1,0.14285714285714285,1,0.0,0,0,0,0,0,0,0,1,0,0,1,1
9863,182606,DgUbD2nFaZ1xgkcPsb7gJ6lYqMu1fGiD,SpATywNh6bZuzm8s1ceuBUnMUAeoAHHw,10,3,3,0,3,1,8,1,19,2.7142857142857144,1,0.0,0,3,0,3,3,1,0,8,1,6,13,1
9864,182607,wMgpdygsXgp7CzOQBDeaQc0sjt2NDO9y,SpATywNh6bZuzm8s1ceuBUnMUAeoAHHw,9,13,6,0,3,0,3,0,25,3.5714285714285716,1,0.0,0,6,0,3,13,0,0,3,0,9,16,1
9865,182612,0hrKpjkp9zkhrQR2RoP7TZCXn5cdSG8v,SpATywNh6bZuzm8s1ceuBUnMUAeoAHHw,9,12,3,1,2,0,5,0,23,3.2857142857142856,1,0.0,3,3,1,2,9,0,0,5,0,9,14,1
9866,182615,gnekWLWeAJ1MVfJL4ZXLvhc4aznPtP4v,RXDvfPUBYFlVdlueBFbLW0mhhAyGEqpt,18,24,18,0,8,0,6,0,56,8.0,1,0.0,2,18,0,8,22,0,0,6,0,28,28,1
9867,182616,8JTz84ZDdJm6tvsd7hgyCl1RB6wU6r2e,SpATywNh6bZuzm8s1ceuBUnMUAeoAHHw,5,3,2,0,1,0,1,0,7,1.0,1,0.0,0,2,0,1,3,0,0,1,0,3,4,1
9868,182620,pmyN5Lpd7zPzDMrdwaddb9OujjdVFpIA,SpATywNh6bZuzm8s1ceuBUnMUAeoAHHw,1,0,0,0,0,0,1,0,1,0.14285714285714285,1,0.0,0,0,0,0,0,0,0,1,0,0,1,1
9869,182621,uLzTTG1K0rlYPSkAfYE7pAYKyeT5Eqlp,bWdj2GDclj5ofokWjzoa5jAwMkxCykd6,14,24,9,78,4,0,4,0,119,17.0,2,0.0,10,9,71,4,14,0,7,4,0,94,25,1
9870,182622,99qhCmy07rsquumjTFRELTtrLHpQpj07,SpATywNh6bZuzm8s1ceuBUnMUAeoAHHw,9,9,4,0,3,0,1,0,17,2.4285714285714284,1,0.0,0,4,0,3,9,0,0,1,0,7,10,1
9871,182625,pmyN5Lpd7zPzDMrdwaddb9OujjdVFpIA,G8EPVSXsOYB5YQWZGiz1aVq5Pgr2GrQu,1,0,0,0,0,0,1,0,1,0.14285714285714285,1,0.0,0,0,0,0,0,0,0,1,0,0,1,1
9872,182631,jvMxvmnfDR2nX2SDb9U9vK3bZQo5n6aS,SpATywNh6bZuzm8s1ceuBUnMUAeoAHHw,8,4,2,0,2,0,2,0,10,1.4285714285714286,1,0.0,0,2,0,2,4,0,0,2,0,4,6,1
9873,182632,JDFQZtkjaBhYZM0MLFNIDJC3MmDM3j4N,G8EPVSXsOYB5YQWZGiz1aVq5Pgr2GrQu,1,0,0,0,0,0,1,0,1,0.14285714285714285,1,0.0,0,0,0,0,0,0,0,1,0,0,1,1
9874,182635,xQkXRLMidDA6kOSlXJCwzS4szskglPiE,SpATywNh6bZuzm8s1ceuBUnMUAeoAHHw,8,2,2,0,2,0,6,0,12,1.7142857142857142,1,0.0,0,2,0,2,2,0,0,6,0,4,8,1
9875,182642,1KbKxaDkaJs93myqaKszRgBW1gxYyrTr,SpATywNh6bZuzm8s1ceuBUnMUAeoAHHw,7,3,2,0,2,0,2,0,9,1.2857142857142858,1,0.0,0,2,0,2,3,0,0,2,0,4,5,1
9876,182652,OvE6fswKcyt8W4X23yrGAT3owgNKqghE,SpATywNh6bZuzm8s1ceuBUnMUAeoAHHw,5,2,1,0,1,1,2,0,7,1.0,1,0.0,0,1,0,1,2,1,0,2,0,2,5,1
9877,182653,kNUYVfCCGHx63xQDhqVhj2cbZ7iw47SV,SpATywNh6bZuzm8s1ceuBUnMUAeoAHHw,15,18,11,12,5,10,8,0,64,9.142857142857142,1,0.0,2,11,12,5,16,10,0,8,0,30,34,1
9878,182656,3jm0outqyG6Dt6oUYnLDUhzCWjwa7f0d,SpATywNh6bZuzm8s1ceuBUnMUAeoAHHw,5,3,1,0,1,0,2,0,7,1.0,1,0.0,0,1,0,1,3,0,0,2,0,2,5,1
9879,182657,NgSAymzGStRSHltSswQtmpS99cSj4EzE,SpATywNh6bZuzm8s1ceuBUnMUAeoAHHw,14,23,8,20,5,2,4,0,62,8.857142857142858,1,0.0,12,8,17,5,11,2,3,4,0,42,20,1
9880,182659,42WJ8lF0jtc8jUDcyiUTsDeA2HGhhgcv,SpATywNh6bZuzm8s1ceuBUnMUAeoAHHw,5,2,1,0,1,0,3,0,7,1.0,1,0.0,0,1,0,1,2,0,0,3,0,2,5,1
9881,182676,Tqsu4RE8c8PTxIWjwbo0acp1R4rHJLQK,G8EPVSXsOYB5YQWZGiz1aVq5Pgr2GrQu,1,0,0,0,0,0,1,0,1,0.14285714285714285,1,0.0,0,0,0,0,0,0,0,1,0,0,1,1
9882,182681,wIYlooJ3PkONzNoU7I0nxWGWuqjalYcP,SpATywNh6bZuzm8s1ceuBUnMUAeoAHHw,7,5,0,0,0,0,2,0,7,1.0,1,0.0,0,0,0,0,5,0,0,2,0,0,7,1
9883,182683,PmtrviA6hBub1PH85YXqVyZgghNsuc4g,bWdj2GDclj5ofokWjzoa5jAwMkxCykd6,5,6,2,0,1,0,3,0,12,1.7142857142857142,1,0.0,0,2,0,1,6,0,0,3,0,3,9,0
9884,182684,u1buUEFv61yp0wROjZxTLttJ3M1La8iE,bWdj2GDclj5ofokWjzoa5jAwMkxCykd6,5,2,1,0,1,0,2,0,6,0.8571428571428571,1,0.0,0,1,0,1,2,0,0,2,0,2,4,1
9885,182691,PhL2ZyLw1V28vd4DfOVSi8FZIcPFQkVx,RXDvfPUBYFlVdlueBFbLW0mhhAyGEqpt,9,9,0,15,0,0,1,0,25,3.5714285714285716,1,0.0,1,0,14,0,8,0,1,1,0,15,10,1
9886,182692,Dtr7OzFhzoVvzJKeK0urGyJsIrB0TIJH,bWdj2GDclj5ofokWjzoa5jAwMkxCykd6,4,2,0,0,0,0,3,0,5,0.7142857142857143,1,0.0,0,0,0,0,2,0,0,3,0,0,5,1
9887,182700,bpGrzhHHu1EmIR8DPqrwGOVi55Jq7xh3,SpATywNh6bZuzm8s1ceuBUnMUAeoAHHw,1,0,0,0,0,0,1,0,1,0.14285714285714285,1,0.0,0,0,0,0,0,0,0,1,0,0,1,1
9888,182707,vCFSDawXLqrnXpNrVBnTFno2SpXSvGWp,SpATywNh6bZuzm8s1ceuBUnMUAeoAHHw,9,4,3,0,3,0,2,0,12,1.7142857142857142,1,0.0,0,3,0,3,4,0,0,2,0,6,6,1
9889,182709,RGPmxfpZ3Hotrw69jr331xicKNruhw9Y,SpATywNh6bZuzm8s1ceuBUnMUAeoAHHw,9,11,0,1,0,0,3,0,15,2.142857142857143,1,0.0,1,0,1,0,10,0,0,3,0,2,13,1
9890,182713,CZTcq7wzEt9ONvni7ZzjQbcLcDeC1DZ4,SpATywNh6bZuzm8s1ceuBUnMUAeoAHHw,1,0,0,0,0,0,1,0,1,0.14285714285714285,1,0.0,0,0,0,0,0,0,0,1,0,0,1,1
9891,182715,l70wRZ2DS0s6LjbT7C4gRoGrF27x9p2H,RXDvfPUBYFlVdlueBFbLW0mhhAyGEqpt,3,2,0,0,0,0,1,0,3,0.42857142857142855,1,0.0,0,0,0,0,2,0,0,1,0,0,3,1
9892,182719,E2SmOalca4Mn2HYnea1ltBRrUmhkEunr,RXDvfPUBYFlVdlueBFbLW0mhhAyGEqpt,2,0,0,0,0,0,2,0,2,0.2857142857142857,1,0.0,0,0,0,0,0,0,0,2,0,0,2,1
9893,182728,YyGH9YI1z47bsz19P5wTavf6fegO5GlF,SpATywNh6bZuzm8s1ceuBUnMUAeoAHHw,7,8,4,0,3,0,1,0,16,2.2857142857142856,1,0.0,3,4,0,3,5,0,0,1,0,10,6,1
9894,182729,AdlQluSNsa5qamKMPw9WD0mzbeMDsH2H,SpATywNh6bZuzm8s1ceuBUnMUAeoAHHw,4,4,0,0,0,0,4,0,8,1.1428571428571428,1,0.0,2,0,0,0,2,0,0,4,0,2,6,1
9895,182732,58s2cb7fdRQwJqQoDBtdpi70NOxjg3qZ,SpATywNh6bZuzm8s1ceuBUnMUAeoAHHw,4,2,1,0,1,0,1,0,5,0.7142857142857143,1,0.0,0,1,0,1,2,0,0,1,0,2,3,1
9896,182733,sTHTvkTsGG8vLnHKJRukF2jRzSiTp03D,SpATywNh6bZuzm8s1ceuBUnMUAeoAHHw,5,0,0,0,0,1,5,1,7,1.0,1,0.0,0,0,0,0,0,1,0,5,1,0,7,1
9897,182734,4CoRulGyQ4icBbm2v9jyxX1ENJFCtIe4,SpATywNh6bZuzm8s1ceuBUnMUAeoAHHw,15,20,11,27,7,15,5,0,85,12.142857142857142,1,0.0,8,11,21,7,12,15,6,5,0,47,38,1
9898,182737,m2BGUVswXHBZPtMgyVgsV42eoIMpIlIe,SpATywNh6bZuzm8s1ceuBUnMUAeoAHHw,4,0,0,0,0,0,4,0,4,0.5714285714285714,1,0.0,0,0,0,0,0,0,0,4,0,0,4,1
9899,182740,mSs5bB1Rxg3xYWjWjJY9pVTt7WAiMgyu,bWdj2GDclj5ofokWjzoa5jAwMkxCykd6,1,0,0,0,0,0,2,0,2,0.2857142857142857,1,0.0,0,0,0,0,0,0,0,2,0,0,2,1
9900,182741,TDJgAusC4tcAuKVU8oHZGKrqhY6Lp4X4,SpATywNh6bZuzm8s1ceuBUnMUAeoAHHw,9,10,1,25,0,0,1,0,37,5.285714285714286,1,0.0,4,1,20,0,6,0,5,1,0,25,12,1
9901,182747,y8tduZmgWrgzcw2L4zthOZlXWzNlHnmJ,SpATywNh6bZuzm8s1ceuBUnMUAeoAHHw,5,2,1,0,1,0,2,0,6,0.8571428571428571,1,0.0,0,1,0,1,2,0,0,2,0,2,4,1
9902,182748,qBpMFzKW2718794c3zfgwmEpIQp9kP8K,SpATywNh6bZuzm8s1ceuBUnMUAeoAHHw,1,0,0,0,0,0,1,0,1,0.14285714285714285,1,0.0,0,0,0,0,0,0,0,1,0,0,1,1
9903,182758,2HbabEHSEnqM0bBaiJs30PG9549v5yOk,bWdj2GDclj5ofokWjzoa5jAwMkxCykd6,6,7,4,0,2,10,5,0,28,4.0,1,0.0,0,4,0,2,7,10,0,5,0,6,22,1
9904,182767,sNbJ7pzaVnDxlASTW0niTKovpFXjQSy0,SpATywNh6bZuzm8s1ceuBUnMUAeoAHHw,5,5,3,0,1,3,2,0,14,2.0,1,0.0,0,3,0,1,5,3,0,2,0,4,10,1
9905,182770,VyinneBSnu52o8UNYSCuv49XXxRYrO53,bWdj2GDclj5ofokWjzoa5jAwMkxCykd6,1,0,0,0,0,0,2,0,2,0.2857142857142857,1,0.0,0,0,0,0,0,0,0,2,0,0,2,1
9906,182774,TzCu0qgQvcoK9kO9NBGEPpkuqzoJ6woq,RXDvfPUBYFlVdlueBFbLW0mhhAyGEqpt,20,15,11,28,4,8,4,0,70,10.0,2,0.0,2,11,26,4,13,8,2,4,0,43,27,1
9907,182780,yMIQHZsn323wNw1rKC7KVgV21MZHgiuz,bWdj2GDclj5ofokWjzoa5jAwMkxCykd6,2,0,0,0,0,0,2,0,2,0.2857142857142857,1,0.0,0,0,0,0,0,0,0,2,0,0,2,1
9908,182782,9tOn7goHN9N7J9eojiuTfPcShVM7kNFp,SpATywNh6bZuzm8s1ceuBUnMUAeoAHHw,5,9,1,0,1,0,1,0,12,1.7142857142857142,1,0.0,0,1,0,1,9,0,0,1,0,2,10,1
9909,182784,VWOXBW9EkYxZ0T2dOO4SxzMKxSN8bgNI,G8EPVSXsOYB5YQWZGiz1aVq5Pgr2GrQu,12,11,3,0,3,6,23,1,47,6.714285714285714,1,0.0,2,3,0,3,9,6,0,23,1,8,39,0
9910,182798,IkIRLi9Hmy3B5WcPYXBnOiu1cJErCZKt,RXDvfPUBYFlVdlueBFbLW0mhhAyGEqpt,8,7,0,13,2,0,5,0,27,3.857142857142857,1,0.0,6,0,10,2,1,0,3,5,0,18,9,1
9911,182808,kCXzR6ce1eaurKGud1Yjcq6ND5eQQb6c,G8EPVSXsOYB5YQWZGiz1aVq5Pgr2GrQu,19,25,13,60,5,3,10,2,118,16.857142857142858,1,0.0,8,13,53,5,17,3,7,10,2,79,39,1
9912,182810,kqM4LD5JOLaYmtsmvPLTUDaTCfv2YPdG,SpATywNh6bZuzm8s1ceuBUnMUAeoAHHw,1,0,0,0,0,0,1,0,1,0.14285714285714285,1,0.0,0,0,0,0,0,0,0,1,0,0,1,1
9913,182813,mSXZKJ9e3RCTXopgrFUphpxYgeKp7tlG,G8EPVSXsOYB5YQWZGiz1aVq5Pgr2GrQu,11,16,7,0,4,7,2,0,36,5.142857142857143,1,0.0,7,7,0,4,9,7,0,2,0,18,18,1
9914,182814,jhJWgDURvdBA1kmFGY4Ezste38F8s208,SpATywNh6bZuzm8s1ceuBUnMUAeoAHHw,6,2,0,0,0,4,6,1,13,1.8571428571428572,1,0.0,0,0,0,0,2,4,0,6,1,0,13,1
9915,182819,p7Mr6Ok0a4vcUFYBslKXHXBRGQMy3QGf,G8EPVSXsOYB5YQWZGiz1aVq5Pgr2GrQu,5,2,0,0,0,0,3,0,5,0.7142857142857143,1,0.0,0,0,0,0,2,0,0,3,0,0,5,1
9916,182820,o3hN6q5KODtoiHqaRQtCHeenQfWWwJmZ,bWdj2GDclj5ofokWjzoa5jAwMkxCykd6,8,3,1,0,1,3,6,1,15,2.142857142857143,1,0.0,1,1,0,1,2,3,0,6,1,3,12,1
9917,182823,YkXExE2iZQg9FZbuDDBEUmC7J16BAywt,SpATywNh6bZuzm8s1ceuBUnMUAeoAHHw,7,3,2,0,2,0,2,0,9,1.2857142857142858,1,0.0,0,2,0,2,3,0,0,2,0,4,5,1
9918,182824,HguVwcZaqEwGXJzY3HP39fA7Ctl2ESJX,SpATywNh6bZuzm8s1ceuBUnMUAeoAHHw,3,0,0,0,0,0,3,0,3,0.42857142857142855,1,0.0,0,0,0,0,0,0,0,3,0,0,3,1
9919,182825,akObaqJGuxjG1OPwZ5IUA6gd9nOx4oJA,SpATywNh6bZuzm8s1ceuBUnMUAeoAHHw,6,3,2,0,2,0,1,0,8,1.1428571428571428,1,0.0,0,2,0,2,3,0,0,1,0,4,4,1
9920,182834,9MvSiFhTOIXzdJdkvHVmHtDUCykt8hMb,RXDvfPUBYFlVdlueBFbLW0mhhAyGEqpt,1,0,0,0,0,0,1,0,1,0.14285714285714285,1,0.0,0,0,0,0,0,0,0,1,0,0,1,1
9921,182835,RkK6wAnzc2qyntdfmCfNZV178HOs8z1G,SpATywNh6bZuzm8s1ceuBUnMUAeoAHHw,7,3,2,0,2,0,2,0,9,1.2857142857142858,1,0.0,0,2,0,2,3,0,0,2,0,4,5,1
9922,182836,vIwO29pFDuU0ivIbuEkS0ajYobih9mJy,SpATywNh6bZuzm8s1ceuBUnMUAeoAHHw,1,0,0,0,0,0,1,0,1,0.14285714285714285,1,0.0,0,0,0,0,0,0,0,1,0,0,1,1
9923,182839,1i94xoT1OVM1lTP3R294JlD5odSrEcP5,G8EPVSXsOYB5YQWZGiz1aVq5Pgr2GrQu,4,8,0,0,1,0,1,0,10,1.4285714285714286,1,0.0,3,0,0,1,5,0,0,1,0,4,6,1
9924,182850,Klt9qoufCaIWdba44x7MkMWwmjaj9rrO,SpATywNh6bZuzm8s1ceuBUnMUAeoAHHw,7,3,2,0,2,0,2,0,9,1.2857142857142858,1,0.0,0,2,0,2,3,0,0,2,0,4,5,1
9925,182854,JO39AO6t7PlfqwBybyNaLNHxe7KK1KKl,SpATywNh6bZuzm8s1ceuBUnMUAeoAHHw,5,2,1,0,1,0,2,0,6,0.8571428571428571,1,0.0,0,1,0,1,2,0,0,2,0,2,4,1
9926,182855,NaGWxZf58IyW9QoVHeBvFF43QTruA6pk,G8EPVSXsOYB5YQWZGiz1aVq5Pgr2GrQu,5,3,1,0,1,0,1,0,6,0.8571428571428571,1,0.0,0,1,0,1,3,0,0,1,0,2,4,1
9927,182863,HXHzL7PqrUL6ax4VV0BL6WUNfIFy8UXd,bWdj2GDclj5ofokWjzoa5jAwMkxCykd6,5,2,1,0,1,0,2,0,6,0.8571428571428571,1,0.0,0,1,0,1,2,0,0,2,0,2,4,1
9928,182874,wfWgaSJojVTsOWnu0Zw38TJ4gTxVsstc,SpATywNh6bZuzm8s1ceuBUnMUAeoAHHw,10,8,5,0,3,0,2,0,18,2.5714285714285716,1,0.0,0,5,0,3,8,0,0,2,0,8,10,1
9929,182875,PdvjXH7022Nj56iHc15p9NRzsFaRES9J,SpATywNh6bZuzm8s1ceuBUnMUAeoAHHw,6,7,2,0,0,0,3,0,12,1.7142857142857142,1,0.0,0,2,0,0,7,0,0,3,0,2,10,1
9930,182886,zcNroqWUiRIsPxABKRrWkwPAId27OxZy,SpATywNh6bZuzm8s1ceuBUnMUAeoAHHw,1,0,0,0,0,0,1,0,1,0.14285714285714285,1,0.0,0,0,0,0,0,0,0,1,0,0,1,1
9931,182891,fdJXQSSucuzaRljy096jXgInnW2TakHQ,G8EPVSXsOYB5YQWZGiz1aVq5Pgr2GrQu,1,0,0,0,0,0,1,0,1,0.14285714285714285,1,0.0,0,0,0,0,0,0,0,1,0,0,1,1
9932,182894,Wm4d7ifDaTgcR0GfUqwJt5OZKbYglRCq,RXDvfPUBYFlVdlueBFbLW0mhhAyGEqpt,1,0,0,0,0,0,1,0,1,0.14285714285714285,1,0.0,0,0,0,0,0,0,0,1,0,0,1,1
9933,182899,LgLijvJ6nDDZDXZheZk4D1S1H0ok87z5,SpATywNh6bZuzm8s1ceuBUnMUAeoAHHw,10,7,5,0,4,0,3,0,19,2.7142857142857144,1,0.0,0,5,0,4,7,0,0,3,0,9,10,1
9934,182900,CqHYUR2wxaYgHzOmefYHdYFAqnjgWzGT,G8EPVSXsOYB5YQWZGiz1aVq5Pgr2GrQu,9,4,1,0,2,1,9,1,18,2.5714285714285716,1,0.0,2,1,0,2,2,1,0,9,1,5,13,1
9935,182906,DYhVLGAPWOAx4wB3gzSHS1w7MxX73feL,RXDvfPUBYFlVdlueBFbLW0mhhAyGEqpt,5,4,1,0,1,0,2,0,8,1.1428571428571428,1,0.0,0,1,0,1,4,0,0,2,0,2,6,1
9936,182912,effsEtqrwknjHEr0npnCFm7KOzCTSt0r,SpATywNh6bZuzm8s1ceuBUnMUAeoAHHw,7,2,1,0,1,0,4,1,9,1.2857142857142858,1,0.0,0,1,0,1,2,0,0,4,1,2,7,0
9937,182916,QBj5ZW5uQiE9SstQccaFKwhAjo1qH9Dk,RXDvfPUBYFlVdlueBFbLW0mhhAyGEqpt,1,0,0,0,0,0,1,0,1,0.14285714285714285,1,0.0,0,0,0,0,0,0,0,1,0,0,1,1
9938,182917,HidChEYUkwCd57tLyDRaYOVeEhFDQ3Gw,bWdj2GDclj5ofokWjzoa5jAwMkxCykd6,5,8,0,53,2,0,1,0,64,9.142857142857142,1,0.0,5,0,52,2,3,0,1,1,0,59,5,1
9939,182918,7kTFcvgxY9P1Hkw99pjiwbkFh98nJXIE,RXDvfPUBYFlVdlueBFbLW0mhhAyGEqpt,6,5,4,0,2,0,1,0,12,1.7142857142857142,1,0.0,0,4,0,2,5,0,0,1,0,6,6,1
9940,182920,Dtrw7jIOc6N9cJtQZ4pVW9s2qBJPFTTc,SpATywNh6bZuzm8s1ceuBUnMUAeoAHHw,7,2,1,0,1,1,4,1,10,1.4285714285714286,1,0.0,0,1,0,1,2,1,0,4,1,2,8,1
9941,182922,TulvnxhxqY9XFV1SbRR2w0EFWo4ahEEO,SpATywNh6bZuzm8s1ceuBUnMUAeoAHHw,10,27,8,0,0,1,21,3,60,8.571428571428571,2,0.0,19,8,0,0,8,1,0,21,3,27,33,1
9942,182924,eCJN0zxGlTEvXWXpm18IFLjiZf0BGvPo,SpATywNh6bZuzm8s1ceuBUnMUAeoAHHw,9,7,4,0,3,0,5,0,19,2.7142857142857144,2,0.0,1,4,0,3,6,0,0,5,0,8,11,1
9943,182925,VU8zmf7Owaz6sNWcWKLdrCl3ZTLYDEQY,SpATywNh6bZuzm8s1ceuBUnMUAeoAHHw,1,0,0,0,0,0,1,0,1,0.14285714285714285,1,0.0,0,0,0,0,0,0,0,1,0,0,1,1
9944,182931,jtsbnKKZ9XPpwCclPqSDCMPCyLbC3Ksj,SpATywNh6bZuzm8s1ceuBUnMUAeoAHHw,12,36,0,13,0,72,11,4,136,19.428571428571427,1,0.0,24,0,11,0,12,72,2,11,4,35,101,0
9945,182940,FIgFPRNDKi4WgyVVOEDupBUIDsQ9EQjV,bWdj2GDclj5ofokWjzoa5jAwMkxCykd6,6,3,2,0,2,0,1,0,8,1.1428571428571428,1,0.0,0,2,0,2,3,0,0,1,0,4,4,1
9946,182941,rwSODbQgRDu2S1bK7vXZWKLJHo1nYnGp,RXDvfPUBYFlVdlueBFbLW0mhhAyGEqpt,5,2,1,0,1,0,3,0,7,1.0,1,0.0,0,1,0,1,2,0,0,3,0,2,5,1
9947,182946,vxHy8fVeIc8PK6sLXnCDyEMZZSM3Rj0M,RXDvfPUBYFlVdlueBFbLW0mhhAyGEqpt,10,9,1,0,1,0,3,0,14,2.0,2,0.0,0,1,0,1,9,0,0,3,0,2,12,1
9948,182948,vag4ySgp6Xv9LLImwgHsnSu0uSrwUg8z,SpATywNh6bZuzm8s1ceuBUnMUAeoAHHw,7,5,1,0,1,0,4,0,11,1.5714285714285714,1,0.0,0,1,0,1,5,0,0,4,0,2,9,1
9949,182949,ffGclPAQxsNqhgZk4UCZvcIXCepIlinY,SpATywNh6bZuzm8s1ceuBUnMUAeoAHHw,4,2,0,0,0,0,4,0,6,0.8571428571428571,1,0.0,0,0,0,0,2,0,0,4,0,0,6,1
9950,182952,IBE9FtQ9x1E7k3ZNC16nikEg5d3E4b8O,bWdj2GDclj5ofokWjzoa5jAwMkxCykd6,14,25,0,51,2,10,11,4,103,14.714285714285714,1,0.0,17,0,48,2,8,10,3,11,4,67,36,1
9951,182954,c6Fui1ajX2dPIYhG2OvpvJJxojMFsXjs,SpATywNh6bZuzm8s1ceuBUnMUAeoAHHw,3,2,0,0,0,0,2,0,4,0.5714285714285714,1,0.0,0,0,0,0,2,0,0,2,0,0,4,1
9952,182968,XARPe6DPXR8KDgKnXuqN5NP0VHFMzwUO,SpATywNh6bZuzm8s1ceuBUnMUAeoAHHw,6,1,1,0,1,0,3,0,6,0.8571428571428571,1,0.0,0,1,0,1,1,0,0,3,0,2,4,1
9953,182984,2hadEUwp57oaCSemFWbiVdojDARXylA4,SpATywNh6bZuzm8s1ceuBUnMUAeoAHHw,16,25,6,6,4,6,5,2,54,7.714285714285714,1,0.0,18,6,6,4,7,6,0,5,2,34,20,1
9954,182985,EHr9i7DrAmLY9IIcFmxYuvipqCAk2sM7,SpATywNh6bZuzm8s1ceuBUnMUAeoAHHw,1,0,0,0,0,0,1,0,1,0.14285714285714285,1,0.0,0,0,0,0,0,0,0,1,0,0,1,1
9955,182987,CflmnNLx1El6KrTaSWqI7nU1TsN8LeKr,G8EPVSXsOYB5YQWZGiz1aVq5Pgr2GrQu,5,2,1,0,1,0,2,0,6,0.8571428571428571,1,0.0,0,1,0,1,2,0,0,2,0,2,4,1
9956,182993,ZxyDDY406MYSLk3FLUMvDHc7n6my0jWC,bWdj2GDclj5ofokWjzoa5jAwMkxCykd6,10,4,2,0,1,21,14,4,46,6.571428571428571,1,0.0,0,2,0,1,4,21,0,14,4,3,43,1
9957,183001,bG2jmidl1bDsU5kwFldO2hSfMzLKGTZ3,SpATywNh6bZuzm8s1ceuBUnMUAeoAHHw,1,0,0,0,0,0,1,0,1,0.14285714285714285,1,0.0,0,0,0,0,0,0,0,1,0,0,1,1
9958,183002,qeZsVtb8AWeyVhfs2hYQ0ujp2PobwrVT,RXDvfPUBYFlVdlueBFbLW0mhhAyGEqpt,6,3,0,0,0,0,4,0,7,1.0,1,0.0,0,0,0,0,3,0,0,4,0,0,7,1
9959,183004,hzI7F4aEa5EKvJiM87cs2lRhWvluO07x,SpATywNh6bZuzm8s1ceuBUnMUAeoAHHw,18,28,13,9,4,2,18,4,78,11.142857142857142,2,0.0,8,13,8,4,20,2,1,18,4,33,45,0
9960,183007,bXjfWJe04qOx78zkMNdSaPRQzOnTNGYL,SpATywNh6bZuzm8s1ceuBUnMUAeoAHHw,4,3,1,0,1,0,1,0,6,0.8571428571428571,1,0.0,0,1,0,1,3,0,0,1,0,2,4,1
9961,183009,hPhWVQjBXU898finCJGmzk0KCmEwCOvP,SpATywNh6bZuzm8s1ceuBUnMUAeoAHHw,1,0,0,0,0,0,1,0,1,0.14285714285714285,1,0.0,0,0,0,0,0,0,0,1,0,0,1,1
9962,183010,5PoE3YvA0iZFEwystRRucVmekQOUvlOx,RXDvfPUBYFlVdlueBFbLW0mhhAyGEqpt,1,0,0,0,0,0,2,0,2,0.2857142857142857,1,0.0,0,0,0,0,0,0,0,2,0,0,2,1
9963,183016,GQxqlKBuTHN1s8soumNB9QXxdu6crGoG,bWdj2GDclj5ofokWjzoa5jAwMkxCykd6,3,1,0,0,0,0,3,0,4,0.5714285714285714,1,0.0,0,0,0,0,1,0,0,3,0,0,4,1
9964,183024,Yb5pEK7VjcxeVZ9fUeqOSZHX1vLfJthY,SpATywNh6bZuzm8s1ceuBUnMUAeoAHHw,9,4,2,0,1,1,9,1,18,2.5714285714285716,1,0.0,0,2,0,1,4,1,0,9,1,3,15,1
9965,183026,rVKS9MvAzj9bHO6qj6FhT80Vyfah5rgx,RXDvfPUBYFlVdlueBFbLW0mhhAyGEqpt,2,0,0,0,0,0,3,0,3,0.42857142857142855,1,0.0,0,0,0,0,0,0,0,3,0,0,3,1
9966,183033,5RiaRbVAffy243QN8cvvydK7FTo8Ge7y,SpATywNh6bZuzm8s1ceuBUnMUAeoAHHw,6,3,2,0,2,0,1,0,8,1.1428571428571428,1,0.0,0,2,0,2,3,0,0,1,0,4,4,1
9967,183038,AvefIGzCaOx0Wgqe3dv7u8LN0NNvyUzu,RXDvfPUBYFlVdlueBFbLW0mhhAyGEqpt,11,3,2,12,2,0,5,0,24,3.4285714285714284,2,0.0,1,2,11,2,2,0,1,5,0,16,8,1
9968,183040,PybrMIHJW5iPpVWCSYrCV4jYePWbXmcH,SpATywNh6bZuzm8s1ceuBUnMUAeoAHHw,4,2,0,0,0,1,4,1,8,1.1428571428571428,1,0.0,0,0,0,0,2,1,0,4,1,0,8,1
9969,183041,b07lyeDRIGTDb23WDQrqmxKnx7uJ6kqa,RXDvfPUBYFlVdlueBFbLW0mhhAyGEqpt,6,2,0,0,0,0,5,2,9,1.2857142857142858,1,0.0,0,0,0,0,2,0,0,5,2,0,9,1
9970,183042,43XnUoAZbDkvxCOgOY8IuFHvhpNa62ol,SpATywNh6bZuzm8s1ceuBUnMUAeoAHHw,1,0,0,0,0,0,1,0,1,0.14285714285714285,1,0.0,0,0,0,0,0,0,0,1,0,0,1,1
9971,183048,oeQ1nHqbsofIU4Gddro5UkGg44HCxqO8,SpATywNh6bZuzm8s1ceuBUnMUAeoAHHw,8,9,3,0,2,0,2,0,16,2.2857142857142856,1,0.0,1,3,0,2,8,0,0,2,0,6,10,1
9972,183050,aBjPpLZjZVQXphzIZ2ZdW0Gy5cspTPuz,SpATywNh6bZuzm8s1ceuBUnMUAeoAHHw,8,3,1,0,1,0,4,2,11,1.5714285714285714,1,0.0,0,1,0,1,3,0,0,4,2,2,9,1
9973,183056,h6N9SyV6dQj6If7QxGp31IQ94XXyWUIO,bWdj2GDclj5ofokWjzoa5jAwMkxCykd6,4,2,1,0,1,0,2,0,6,0.8571428571428571,1,0.0,0,1,0,1,2,0,0,2,0,2,4,0
9974,183059,6xyaVeSZsCu6Nqe5h1ruYj89xweZsGkX,SpATywNh6bZuzm8s1ceuBUnMUAeoAHHw,8,2,1,0,1,0,10,1,15,2.142857142857143,1,0.0,0,1,0,1,2,0,0,10,1,2,13,1
9975,183066,Oq9Z1hsv3NeEDP3Q4F964BpI3HU1uf4u,RXDvfPUBYFlVdlueBFbLW0mhhAyGEqpt,41,87,26,104,14,19,3,0,253,36.142857142857146,1,0.0,28,26,97,14,59,19,7,3,0,165,88,1
9976,183075,8SwolTrUbLeQIryGNwnSraj6AIJcPhi1,RXDvfPUBYFlVdlueBFbLW0mhhAyGEqpt,8,3,2,0,0,1,6,2,14,2.0,1,0.0,0,2,0,0,3,1,0,6,2,2,12,1
9977,183076,kE46GjSqE5uiUhF9LbgXs97FJQSvErKB,SpATywNh6bZuzm8s1ceuBUnMUAeoAHHw,18,14,9,8,5,2,9,1,48,6.857142857142857,3,0.0,2,9,8,5,12,2,0,9,1,24,24,0
9978,183079,UZQMHBD59LcFUBlLzTajpfngFoDhvuqd,bWdj2GDclj5ofokWjzoa5jAwMkxCykd6,2,0,0,0,0,0,2,0,2,0.2857142857142857,1,0.0,0,0,0,0,0,0,0,2,0,0,2,0
9979,183082,IKXwL3bDtlAxjRP4WWhZczJlcbIhG3ib,bWdj2GDclj5ofokWjzoa5jAwMkxCykd6,5,2,1,0,1,0,3,0,7,1.0,1,0.0,0,1,0,1,2,0,0,3,0,2,5,1
9980,183083,EbfkLutG3Wlnfk5dlvXr0Vcdn1M25FU9,bWdj2GDclj5ofokWjzoa5jAwMkxCykd6,13,21,11,0,7,15,10,1,65,9.285714285714286,2,0.0,4,11,0,7,17,15,0,10,1,22,43,1
9981,183092,xrcBYo5W41za7iW83F0KEtd3oYoFiOrz,SpATywNh6bZuzm8s1ceuBUnMUAeoAHHw,6,3,2,0,2,0,2,0,9,1.2857142857142858,1,0.0,0,2,0,2,3,0,0,2,0,4,5,1
9982,183094,LielUY2CViAshyTPFVeBFjcM9c8YHKw6,SpATywNh6bZuzm8s1ceuBUnMUAeoAHHw,4,2,0,0,0,0,2,0,4,0.5714285714285714,1,0.0,0,0,0,0,2,0,0,2,0,0,4,1
9983,183098,iYmkUVGHT7OvfSsIIRGv9c31sCISp6uV,bWdj2GDclj5ofokWjzoa5jAwMkxCykd6,3,2,0,0,0,0,2,0,4,0.5714285714285714,2,0.0,0,0,0,0,2,0,0,2,0,0,4,1
9984,183100,zgTz7w4MQKVAfOVf6tj5uMnkGGy77PYu,SpATywNh6bZuzm8s1ceuBUnMUAeoAHHw,8,3,1,0,1,1,4,1,11,1.5714285714285714,1,0.0,0,1,0,1,3,1,0,4,1,2,9,1
9985,183105,HTGHrKrt9bt2no7NEjeTqA36pNapNLke,bWdj2GDclj5ofokWjzoa5jAwMkxCykd6,1,0,0,0,0,0,1,0,1,0.14285714285714285,1,0.0,0,0,0,0,0,0,0,1,0,0,1,1
9986,183106,5UgB7WrC5inA92uoZPywCX6RsZIYfbPF,SpATywNh6bZuzm8s1ceuBUnMUAeoAHHw,7,5,2,0,2,6,4,0,19,2.7142857142857144,1,0.0,0,2,0,2,5,6,0,4,0,4,15,1
9987,183110,53fG4qjpoEeWdWNP9xPO2S2BFstrPjGH,RXDvfPUBYFlVdlueBFbLW0mhhAyGEqpt,9,5,0,0,0,1,10,11,27,3.857142857142857,2,0.0,0,0,0,0,5,1,0,10,11,0,27,1
9988,183113,PHVZqegG7Zevy6zLiqsCasCOZvoRRNNg,SpATywNh6bZuzm8s1ceuBUnMUAeoAHHw,7,5,4,0,3,0,2,0,14,2.0,1,0.0,0,4,0,3,5,0,0,2,0,7,7,1
9989,183114,g1dFQ3mnVnBiIhnsU4zqK21biH9l5lF9,bWdj2GDclj5ofokWjzoa5jAwMkxCykd6,8,5,1,0,1,0,4,1,12,1.7142857142857142,1,0.0,0,1,0,1,5,0,0,4,1,2,10,1
9990,183117,WDD9a1qNUJX21r5OnYzYbe9snqA1PiYA,G8EPVSXsOYB5YQWZGiz1aVq5Pgr2GrQu,10,7,4,0,3,0,3,0,17,2.4285714285714284,1,0.0,1,4,0,3,6,0,0,3,0,8,9,1
9991,183118,Xebl2a1reCTgb3CZmsapTzbcj94w3H8B,SpATywNh6bZuzm8s1ceuBUnMUAeoAHHw,1,0,0,0,0,0,2,0,2,0.2857142857142857,1,0.0,0,0,0,0,0,0,0,2,0,0,2,1
9992,183125,juPgseiv6fz8BUaq09A165VVR6UHjpbU,SpATywNh6bZuzm8s1ceuBUnMUAeoAHHw,5,2,1,0,1,1,2,1,8,1.1428571428571428,1,0.0,0,1,0,1,2,1,0,2,1,2,6,1
9993,183127,Hm8PhmgumYGSpnWdU16xXCEPyBtXct0m,G8EPVSXsOYB5YQWZGiz1aVq5Pgr2GrQu,6,3,0,0,0,0,3,0,6,0.8571428571428571,1,0.0,0,0,0,0,3,0,0,3,0,0,6,1
9994,183128,JChnJwlkYSD6G5rkj5DhsEWsQiOBTkEx,G8EPVSXsOYB5YQWZGiz1aVq5Pgr2GrQu,8,2,1,0,1,1,6,1,12,1.7142857142857142,1,0.0,0,1,0,1,2,1,0,6,1,2,10,1
9995,183135,TVBdP57RgHmXdzDOQxhhxrruZniECnNa,G8EPVSXsOYB5YQWZGiz1aVq5Pgr2GrQu,10,5,3,0,2,3,11,1,25,3.5714285714285716,2,0.0,0,3,0,2,5,3,0,11,1,5,20,0
9996,183136,Wh6uG1HOxpwP3HtqSjbX0A0Sk2Rn3Ci7,SpATywNh6bZuzm8s1ceuBUnMUAeoAHHw,3,0,0,0,0,0,3,0,3,0.42857142857142855,1,0.0,0,0,0,0,0,0,0,3,0,0,3,1
9997,183137,HIa1PFcWZWr32eqQoCfZvVHM2iyl701E,G8EPVSXsOYB5YQWZGiz1aVq5Pgr2GrQu,8,13,4,0,2,1,3,0,23,3.2857142857142856,1,0.0,3,4,0,2,10,1,0,3,0,9,14,1
9998,183142,DZfIhfsDxjKeEsV2YKbtNB2Ii6s7pc9Z,G8EPVSXsOYB5YQWZGiz1aVq5Pgr2GrQu,5,2,1,0,1,0,2,0,6,0.8571428571428571,1,0.0,0,1,0,1,2,0,0,2,0,2,4,1
9999,183145,Jur8wTdD1tDMuHkI3CFyF52Um8NeR9PV,G8EPVSXsOYB5YQWZGiz1aVq5Pgr2GrQu,37,31,8,71,7,0,1,0,118,16.857142857142858,1,0.0,20,8,48,7,11,0,23,1,0,83,35,1
10000,183155,ZjtLHxVaFYGXpjpGEU4pMEKPyHOa2BQR,SpATywNh6bZuzm8s1ceuBUnMUAeoAHHw,4,3,1,0,1,0,1,0,6,0.8571428571428571,1,0.0,0,1,0,1,3,0,0,1,0,2,4,1
10001,183157,uxG0FJsqPkZSNzWDeidAA0UNFfE5AajW,SpATywNh6bZuzm8s1ceuBUnMUAeoAHHw,17,26,11,22,7,17,9,2,94,13.428571428571429,1,0.0,11,11,19,7,15,17,3,9,2,48,46,1
10002,183159,hiXDc0k3aCbg2PlfMmAMtnsGGLI4iZVQ,SpATywNh6bZuzm8s1ceuBUnMUAeoAHHw,1,0,0,0,0,0,1,0,1,0.14285714285714285,1,0.0,0,0,0,0,0,0,0,1,0,0,1,1
10003,183161,giWgdBNdbd331HsBTghzm2Zz7pyTR32i,bWdj2GDclj5ofokWjzoa5jAwMkxCykd6,7,4,1,0,1,10,8,2,26,3.7142857142857144,1,0.0,2,1,0,1,2,10,0,8,2,4,22,1
10004,183162,OKPZyRTenUKO4uf828hjTvwVhuS9Ozxv,SpATywNh6bZuzm8s1ceuBUnMUAeoAHHw,4,2,1,0,1,0,1,0,5,0.7142857142857143,1,0.0,0,1,0,1,2,0,0,1,0,2,3,1
10005,183164,7RSTSE7CX0EZRW2RDRnKS7CJkHtK7gJx,RXDvfPUBYFlVdlueBFbLW0mhhAyGEqpt,6,5,3,0,0,4,2,0,14,2.0,1,0.0,0,3,0,0,5,4,0,2,0,3,11,1
10006,183165,ZsigjPuCWauQ6fedPh3KulNWQfy4Omyd,bWdj2GDclj5ofokWjzoa5jAwMkxCykd6,16,22,9,34,2,5,10,1,83,11.857142857142858,1,0.0,7,9,30,2,15,5,4,10,1,48,35,1
10007,183168,HwQlDqQYrfHrBUx2SSkCNQ3Dej1xgfkf,bWdj2GDclj5ofokWjzoa5jAwMkxCykd6,6,6,0,0,0,4,3,0,13,1.8571428571428572,1,0.0,0,0,0,0,6,4,0,3,0,0,13,1
10008,183172,8UbjMY8dXKhktWVxiVJfz8pElgxOXJnG,G8EPVSXsOYB5YQWZGiz1aVq5Pgr2GrQu,12,20,10,18,6,0,1,0,55,7.857142857142857,1,0.0,8,10,16,6,12,0,2,1,0,40,15,1
10009,183180,hc7DHMNIyA27xd52J4BHXtmpErxPTaQY,SpATywNh6bZuzm8s1ceuBUnMUAeoAHHw,4,2,1,0,1,0,2,0,6,0.8571428571428571,1,0.0,0,1,0,1,2,0,0,2,0,2,4,1
10010,183184,QBUSyyOSif4bY2k2ASnON62QDLzUWAXK,SpATywNh6bZuzm8s1ceuBUnMUAeoAHHw,6,2,1,0,1,1,3,1,9,1.2857142857142858,1,0.0,0,1,0,1,2,1,0,3,1,2,7,1
10011,183188,CUbueK74RGsaWBcRtztdoMN84Z7TxEjm,SpATywNh6bZuzm8s1ceuBUnMUAeoAHHw,1,0,0,0,0,0,1,0,1,0.14285714285714285,1,0.0,0,0,0,0,0,0,0,1,0,0,1,1
10012,183194,Ck862YJ4TKsW5xBb6Obw9gcSWBzSDmoA,bWdj2GDclj5ofokWjzoa5jAwMkxCykd6,2,0,0,0,0,0,2,0,2,0.2857142857142857,1,0.0,0,0,0,0,0,0,0,2,0,0,2,1
10013,183196,MHxssLIOse4kgwRMC6Bd41Ph9QZkPYqP,SpATywNh6bZuzm8s1ceuBUnMUAeoAHHw,12,7,5,0,3,1,3,1,20,2.857142857142857,1,0.0,0,5,0,3,7,1,0,3,1,8,12,1
10014,183198,Bb87wS5DPfEgqeumUQCP2v4mASdjKigL,RXDvfPUBYFlVdlueBFbLW0mhhAyGEqpt,7,2,1,0,1,7,5,2,18,2.5714285714285716,1,0.0,0,1,0,1,2,7,0,5,2,2,16,1
10015,183200,JxLtKAnMek98G5fWpyeTaKlh0zheuNnU,SpATywNh6bZuzm8s1ceuBUnMUAeoAHHw,8,4,2,0,2,0,4,0,12,1.7142857142857142,1,0.0,0,2,0,2,4,0,0,4,0,4,8,0
10016,183209,OO1JwGoh4BUjbVi8UpZSb7D59mBcs3nt,RXDvfPUBYFlVdlueBFbLW0mhhAyGEqpt,7,5,3,0,1,0,2,0,11,1.5714285714285714,1,0.0,0,3,0,1,5,0,0,2,0,4,7,1
10017,183211,oqLAJu8zdqUr5XPQYn4bKVmvqSIRanjc,bWdj2GDclj5ofokWjzoa5jAwMkxCykd6,9,9,1,0,2,8,6,1,27,3.857142857142857,1,0.0,2,1,0,2,7,8,0,6,1,5,22,1
10018,183214,4zGb8KPKuLvneJBtnBUfe0LzhdWsYBWD,G8EPVSXsOYB5YQWZGiz1aVq5Pgr2GrQu,12,4,3,0,3,3,6,1,20,2.857142857142857,1,0.0,0,3,0,3,4,3,0,6,1,6,14,1
10019,183215,AIHzQdi1VPMOsdN6EyZk6CRIyb9n7SRR,SpATywNh6bZuzm8s1ceuBUnMUAeoAHHw,3,1,0,0,0,0,2,0,3,0.42857142857142855,1,0.0,0,0,0,0,1,0,0,2,0,0,3,1
10020,183220,e3UIGG7UQFKXGRFOxu4N5schAIY0VK0V,SpATywNh6bZuzm8s1ceuBUnMUAeoAHHw,9,9,6,0,3,0,1,0,19,2.7142857142857144,1,0.0,2,6,0,3,7,0,0,1,0,11,8,1
10021,183224,tgGXquDTTGvx5MwsNQ6vkm5pQoRrWFlX,SpATywNh6bZuzm8s1ceuBUnMUAeoAHHw,4,2,0,0,0,0,2,0,4,0.5714285714285714,1,0.0,0,0,0,0,2,0,0,2,0,0,4,1
10022,183231,FBOPqv9eeto5z974B2QRTSbPP2n29lzH,SpATywNh6bZuzm8s1ceuBUnMUAeoAHHw,14,10,1,9,1,5,10,1,37,5.285714285714286,1,0.0,1,1,8,1,9,5,1,10,1,11,26,0
10023,183234,u2dRmVeIaLoDMHF5VEceAEEDchUnRMzS,SpATywNh6bZuzm8s1ceuBUnMUAeoAHHw,2,0,0,0,0,0,2,0,2,0.2857142857142857,1,0.0,0,0,0,0,0,0,0,2,0,0,2,1
10024,183240,5tBgJZtV2IcrOsT8dEGT5vR2wgUVL0Ki,RXDvfPUBYFlVdlueBFbLW0mhhAyGEqpt,7,9,0,0,1,0,1,0,11,1.5714285714285714,1,0.0,0,0,0,1,9,0,0,1,0,1,10,1
10025,183242,bOMNnv3BcmeLvNMeUxuJFunXB0SEjjhL,G8EPVSXsOYB5YQWZGiz1aVq5Pgr2GrQu,6,5,0,0,0,0,1,0,6,0.8571428571428571,1,0.0,0,0,0,0,5,0,0,1,0,0,6,1
10026,183243,FGCLu23qz5rUrelYuCtqPnMTqZtXAAMw,SpATywNh6bZuzm8s1ceuBUnMUAeoAHHw,3,2,0,0,0,0,1,0,3,0.42857142857142855,1,0.0,0,0,0,0,2,0,0,1,0,0,3,1
10027,183246,0XGLQ2e4IRT7VYRVdCJkoQRc2HBjT9PI,SpATywNh6bZuzm8s1ceuBUnMUAeoAHHw,6,3,2,0,2,1,5,4,17,2.4285714285714284,1,0.0,0,2,0,2,3,1,0,5,4,4,13,1
10028,183255,o0L0ZsTU5fXkPgqce1TgnefJury1RfBP,SpATywNh6bZuzm8s1ceuBUnMUAeoAHHw,1,0,0,0,0,0,1,0,1,0.14285714285714285,1,0.0,0,0,0,0,0,0,0,1,0,0,1,1
10029,183256,Hqq2J56mzskAJKg1DKQGyeniCWvGpIGe,G8EPVSXsOYB5YQWZGiz1aVq5Pgr2GrQu,8,5,0,0,0,0,14,1,20,2.857142857142857,1,0.0,0,0,0,0,5,0,0,14,1,0,20,1
10030,183259,oAeA1FcKJgCgppNdDO8cyAq9ijjrn0WR,SpATywNh6bZuzm8s1ceuBUnMUAeoAHHw,1,0,0,0,0,0,1,0,1,0.14285714285714285,1,0.0,0,0,0,0,0,0,0,1,0,0,1,1
10031,183263,sRTon1VBBuP0uvdQE1lWLIce29YVBv8J,G8EPVSXsOYB5YQWZGiz1aVq5Pgr2GrQu,7,8,4,0,0,1,6,0,19,2.7142857142857144,1,0.0,0,4,0,0,8,1,0,6,0,4,15,1
10032,183270,7nQB7cjVdr2HijR82OoX1oMRPa42JjfY,SpATywNh6bZuzm8s1ceuBUnMUAeoAHHw,15,20,7,16,5,4,8,2,62,8.857142857142858,1,0.0,12,7,14,5,8,4,2,8,2,38,24,1
10033,183275,xQCtMoNknB0tylWKH0fJbJooatlzGcif,bWdj2GDclj5ofokWjzoa5jAwMkxCykd6,2,0,0,0,0,0,2,0,2,0.2857142857142857,1,0.0,0,0,0,0,0,0,0,2,0,0,2,1
10034,183278,GPLdxh0c6YlbU65pqQa5Y6COOTFoYUCD,bWdj2GDclj5ofokWjzoa5jAwMkxCykd6,1,0,0,0,0,0,1,0,1,0.14285714285714285,1,0.0,0,0,0,0,0,0,0,1,0,0,1,1
10035,183281,QCcqcVaEKUPWiTK3zDmg4MUzFmU49Qen,G8EPVSXsOYB5YQWZGiz1aVq5Pgr2GrQu,8,8,0,4,0,2,4,0,18,2.5714285714285716,1,0.0,5,0,2,0,3,2,2,4,0,7,11,1
10036,183282,eOxm8XEI11Xs6eiBi1Nu5QzIagZXwEm9,bWdj2GDclj5ofokWjzoa5jAwMkxCykd6,8,9,3,0,3,3,4,0,22,3.142857142857143,1,0.0,4,3,0,3,5,3,0,4,0,10,12,1
10037,183283,3uajdhCj0s2q50MqyB5gJCI3ZNoF8Pn6,SpATywNh6bZuzm8s1ceuBUnMUAeoAHHw,11,18,1,16,0,6,4,0,45,6.428571428571429,2,0.0,7,1,13,0,11,6,3,4,0,21,24,0
10038,183287,myIIBocNFelldmuN47bMrRiORGKDSj7S,bWdj2GDclj5ofokWjzoa5jAwMkxCykd6,5,2,1,0,1,0,2,0,6,0.8571428571428571,1,0.0,0,1,0,1,2,0,0,2,0,2,4,1
10039,183295,pjhJt7Jli5gOZV2lL76izW3SObuDigHu,SpATywNh6bZuzm8s1ceuBUnMUAeoAHHw,6,6,1,0,1,0,1,0,9,1.2857142857142858,1,0.0,0,1,0,1,6,0,0,1,0,2,7,1
10040,183298,JazzJWzkixijQw0lzFOQdWkrQaVq1jug,SpATywNh6bZuzm8s1ceuBUnMUAeoAHHw,1,0,0,0,0,0,1,0,1,0.14285714285714285,1,0.0,0,0,0,0,0,0,0,1,0,0,1,1
10041,183302,UVJV0Z8LgePBFvFPqKCGcnBV2sDOhrhM,SpATywNh6bZuzm8s1ceuBUnMUAeoAHHw,9,9,5,0,2,3,15,2,36,5.142857142857143,1,0.0,0,5,0,2,9,3,0,15,2,7,29,1
10042,183304,xyEiirOhDK1UDi4PZ4UKu6B69xftDWtO,G8EPVSXsOYB5YQWZGiz1aVq5Pgr2GrQu,3,1,0,0,0,0,2,0,3,0.42857142857142855,1,0.0,0,0,0,0,1,0,0,2,0,0,3,1
10043,183314,8lLmfOvYbkWA0I629B3U62LfaD1fwQEn,RXDvfPUBYFlVdlueBFbLW0mhhAyGEqpt,4,3,0,0,0,0,1,0,4,0.5714285714285714,1,0.0,0,0,0,0,3,0,0,1,0,0,4,1
10044,183318,5ZZ7ac02MMtLItQmBAzvselJyRLR3oem,RXDvfPUBYFlVdlueBFbLW0mhhAyGEqpt,13,8,6,14,4,0,1,0,33,4.714285714285714,1,0.0,1,6,13,4,7,0,1,1,0,24,9,1
10045,183322,aoDqbYwTSNONO0ewp0wUEkLRTmINlnHL,bWdj2GDclj5ofokWjzoa5jAwMkxCykd6,4,2,1,0,1,0,2,0,6,0.8571428571428571,1,0.0,0,1,0,1,2,0,0,2,0,2,4,0
10046,183335,DfGFChbBes1JC5MAOGd9A1oO26eP1NW8,SpATywNh6bZuzm8s1ceuBUnMUAeoAHHw,5,2,1,0,1,0,2,0,6,0.8571428571428571,1,0.0,0,1,0,1,2,0,0,2,0,2,4,1
10047,183336,tMAhwsb1zwYUL3evTh1bPfibKP5Qon6G,SpATywNh6bZuzm8s1ceuBUnMUAeoAHHw,14,26,12,23,0,16,12,3,92,13.142857142857142,1,0.0,11,12,19,0,15,16,4,12,3,42,50,1
10048,183338,AwyuEC08S0bk8UcEbhYUOEEzGzNqDKU8,SpATywNh6bZuzm8s1ceuBUnMUAeoAHHw,15,13,7,10,4,0,5,0,39,5.571428571428571,1,0.0,2,7,10,4,11,0,0,5,0,23,16,1
10049,183339,6mOQPHYetbEhBA0tIxsajGc8MOtDRaKo,SpATywNh6bZuzm8s1ceuBUnMUAeoAHHw,14,9,4,12,3,2,4,0,34,4.857142857142857,1,0.0,4,4,9,3,5,2,3,4,0,20,14,1
10050,183341,idNHVa5qTuX7uet3LgzHDgeF9ZtnSDQ3,bWdj2GDclj5ofokWjzoa5jAwMkxCykd6,5,4,2,0,2,0,4,0,12,1.7142857142857142,2,0.0,1,2,0,2,3,0,0,4,0,5,7,1
10051,183349,jM6CIVoPwE4qSBrp1fYyKBxxPBT1cEI7,SpATywNh6bZuzm8s1ceuBUnMUAeoAHHw,13,18,0,13,0,22,5,1,59,8.428571428571429,1,0.0,9,0,11,0,9,22,2,5,1,20,39,1
10052,183352,F60PWu4BLsLJcl06zQNatmmupVqE7UvO,SpATywNh6bZuzm8s1ceuBUnMUAeoAHHw,8,2,1,0,1,41,6,1,52,7.428571428571429,1,0.0,0,1,0,1,2,41,0,6,1,2,50,1
10053,183355,E2ARe3Bjs7AnrUVutsjVawfNV9IbxIpY,SpATywNh6bZuzm8s1ceuBUnMUAeoAHHw,10,2,2,0,2,1,6,1,14,2.0,1,0.0,0,2,0,2,2,1,0,6,1,4,10,1
10054,183356,dgFOOUSNfQK8xIrT47Av0Q04bBFeE21W,bWdj2GDclj5ofokWjzoa5jAwMkxCykd6,5,2,1,0,1,0,3,0,7,1.0,1,0.0,0,1,0,1,2,0,0,3,0,2,5,0
10055,183359,ks16hCmKEY3uCrrfZAVFFF4H8o1iqNYf,SpATywNh6bZuzm8s1ceuBUnMUAeoAHHw,2,0,0,0,0,0,2,0,2,0.2857142857142857,1,0.0,0,0,0,0,0,0,0,2,0,0,2,1
10056,183360,9s0JhEhDR0DB5lchGcAvAZmTtIRHEPQm,G8EPVSXsOYB5YQWZGiz1aVq5Pgr2GrQu,4,3,0,0,0,0,2,0,5,0.7142857142857143,1,0.0,0,0,0,0,3,0,0,2,0,0,5,1
10057,183364,wVXoala8XOb2iYKmDwv4j0mTTabnjV0o,SpATywNh6bZuzm8s1ceuBUnMUAeoAHHw,3,3,0,0,0,1,2,0,6,0.8571428571428571,1,0.0,0,0,0,0,3,1,0,2,0,0,6,1
10058,183366,lRau52E8JZjvrp0KLukaOoqpUzIxzIMQ,bWdj2GDclj5ofokWjzoa5jAwMkxCykd6,1,0,0,0,0,0,1,0,1,0.14285714285714285,1,0.0,0,0,0,0,0,0,0,1,0,0,1,1
10059,183371,kqNwxNjHDwzzgcfuymv6Zjh6rnLpzjX1,G8EPVSXsOYB5YQWZGiz1aVq5Pgr2GrQu,4,2,1,0,1,0,1,0,5,0.7142857142857143,1,0.0,0,1,0,1,2,0,0,1,0,2,3,0
10060,183373,BhK0qN7yCyRENwc0cuo4sVnEheX7uuVm,RXDvfPUBYFlVdlueBFbLW0mhhAyGEqpt,4,2,1,0,1,0,1,0,5,0.7142857142857143,1,0.0,0,1,0,1,2,0,0,1,0,2,3,1
10061,183375,t5Hw0caPG6L3nFHgMe2ewZ65zHyUbUJs,G8EPVSXsOYB5YQWZGiz1aVq5Pgr2GrQu,2,0,0,0,0,0,2,0,2,0.2857142857142857,1,0.0,0,0,0,0,0,0,0,2,0,0,2,1
10062,183376,bBc0KX5JgaSX0V8JzMsfaXljJJH0L4ZY,bWdj2GDclj5ofokWjzoa5jAwMkxCykd6,1,0,0,0,0,0,1,0,1,0.14285714285714285,1,0.0,0,0,0,0,0,0,0,1,0,0,1,0
10063,183377,IEfUasRNK7F4OXmh9ZRgY5RLlk7j6VcY,SpATywNh6bZuzm8s1ceuBUnMUAeoAHHw,5,6,2,0,1,0,1,0,10,1.4285714285714286,1,0.0,3,2,0,1,3,0,0,1,0,6,4,1
10064,183379,qHIKvxolHHwVyfUrUuTQ7lCeMbWX7sYP,RXDvfPUBYFlVdlueBFbLW0mhhAyGEqpt,14,16,2,6,3,1,1,0,29,4.142857142857143,1,0.0,5,2,6,3,11,1,0,1,0,16,13,1
10065,183381,I2UwAjBakgo7ulEE8gv6S9DLeFdNO1pr,bWdj2GDclj5ofokWjzoa5jAwMkxCykd6,3,0,0,0,0,0,2,1,3,0.42857142857142855,1,0.0,0,0,0,0,0,0,0,2,1,0,3,1
10066,183386,O7fzJfuKfqlfMIjfhNwbu2i8Ce4wMF9H,SpATywNh6bZuzm8s1ceuBUnMUAeoAHHw,2,0,0,0,0,0,2,0,2,0.2857142857142857,1,0.0,0,0,0,0,0,0,0,2,0,0,2,1
10067,183387,AT7MUJLyTRujCGftxJSRLnutVHzi2W6K,bWdj2GDclj5ofokWjzoa5jAwMkxCykd6,1,0,0,0,0,0,1,0,1,0.14285714285714285,1,0.0,0,0,0,0,0,0,0,1,0,0,1,1
10068,183394,rEeBeKGH612kEsTNiutHYC8nvtLgJLl3,bWdj2GDclj5ofokWjzoa5jAwMkxCykd6,6,4,1,0,2,8,5,0,20,2.857142857142857,1,0.0,2,1,0,2,2,8,0,5,0,5,15,1
10069,183395,3ypTaFxEmzRhgWt1V6ubGImksm3gaDqi,G8EPVSXsOYB5YQWZGiz1aVq5Pgr2GrQu,6,6,0,0,0,0,3,0,9,1.2857142857142858,1,0.0,1,0,0,0,5,0,0,3,0,1,8,1
10070,183402,uZccjrlfbKn6BDCm3jPoxZprWusdhQYC,RXDvfPUBYFlVdlueBFbLW0mhhAyGEqpt,8,3,2,0,0,2,6,1,14,2.0,1,0.0,0,2,0,0,3,2,0,6,1,2,12,1
10071,183404,StBmEv3I1e5i7om3Qal9RCxtr12zGldK,SpATywNh6bZuzm8s1ceuBUnMUAeoAHHw,3,2,1,0,0,0,1,0,4,0.5714285714285714,1,0.0,0,1,0,0,2,0,0,1,0,1,3,1
10072,183406,6x4B9nu8vwEEwbbJ91dM7syOmh6Wd3T4,RXDvfPUBYFlVdlueBFbLW0mhhAyGEqpt,15,12,8,0,9,0,7,0,36,5.142857142857143,2,0.0,3,8,0,9,9,0,0,7,0,20,16,1
10073,183409,p2WxyRGvLvUMOSoEWtLVx9Ca2AiCwjk0,SpATywNh6bZuzm8s1ceuBUnMUAeoAHHw,10,7,4,10,0,0,2,0,23,3.2857142857142856,1,0.0,2,4,8,0,5,0,2,2,0,14,9,1
10074,183414,e2iZvNKfdNseGOCno9jVScN4rf0x278a,G8EPVSXsOYB5YQWZGiz1aVq5Pgr2GrQu,10,6,2,10,1,0,3,0,22,3.142857142857143,1,0.0,3,2,7,1,3,0,3,3,0,13,9,1
10075,183423,CViRSkXaB71kW0MpqfES8A240EKnhiKp,bWdj2GDclj5ofokWjzoa5jAwMkxCykd6,6,6,3,0,2,0,2,0,13,1.8571428571428572,1,0.0,2,3,0,2,4,0,0,2,0,7,6,1
10076,183427,BYDzZvbHlPLB5l5C8F0sCY7jgUh5E5kF,SpATywNh6bZuzm8s1ceuBUnMUAeoAHHw,4,3,2,0,0,0,1,0,6,0.8571428571428571,1,0.0,0,2,0,0,3,0,0,1,0,2,4,1
10077,183430,MofLU1eAzpaUKN6d2uNrYpUKgP1lpdHE,RXDvfPUBYFlVdlueBFbLW0mhhAyGEqpt,15,16,11,12,3,3,7,1,53,7.571428571428571,1,0.0,0,11,10,3,16,3,2,7,1,24,29,1
10078,183431,8BTLZqMynI47lpeExrpUyf3Ycam7Kqwv,SpATywNh6bZuzm8s1ceuBUnMUAeoAHHw,9,28,10,0,0,0,4,0,42,6.0,1,0.0,3,10,0,0,25,0,0,4,0,13,29,1
10079,183435,t4uSkzpGvWF0mtXEP739NS9nOIoxwvm0,RXDvfPUBYFlVdlueBFbLW0mhhAyGEqpt,6,4,0,0,0,0,2,0,6,0.8571428571428571,1,0.0,0,0,0,0,4,0,0,2,0,0,6,1
10080,183440,EtfxOXHEuVBMaj0eMSXrIIrSQlTvW9sK,bWdj2GDclj5ofokWjzoa5jAwMkxCykd6,1,0,0,0,0,0,1,0,1,0.14285714285714285,1,0.0,0,0,0,0,0,0,0,1,0,0,1,1
10081,183442,v9EzyBMgqrHmKu64Jm356JCxNk5lnRyw,G8EPVSXsOYB5YQWZGiz1aVq5Pgr2GrQu,2,0,0,0,0,0,2,0,2,0.2857142857142857,1,0.0,0,0,0,0,0,0,0,2,0,0,2,1
10082,183452,RnIxYOCcvRkH5SmLcSLbuQiMmbZTCV4X,bWdj2GDclj5ofokWjzoa5jAwMkxCykd6,7,4,2,0,1,2,3,1,13,1.8571428571428572,1,0.0,0,2,0,1,4,2,0,3,1,3,10,1
10083,183456,InAOZGiL3znHtTGfF0VCl2ivku6eLEMF,RXDvfPUBYFlVdlueBFbLW0mhhAyGEqpt,20,30,16,35,14,1,7,11,114,16.285714285714285,1,0.0,12,16,30,14,18,1,5,7,11,72,42,1
10084,183465,Mie6PMLFZ6GTGAAMZLvUdpU4rgeHjvP2,bWdj2GDclj5ofokWjzoa5jAwMkxCykd6,5,2,1,0,1,0,2,0,6,0.8571428571428571,1,0.0,0,1,0,1,2,0,0,2,0,2,4,1
10085,183466,nwVilrO2xxpsCBw1FRKGSujEDxCOupgS,SpATywNh6bZuzm8s1ceuBUnMUAeoAHHw,6,6,2,0,1,1,4,0,14,2.0,1,0.0,0,2,0,1,6,1,0,4,0,3,11,1
10086,183467,PFkCedTA1DArZVlA7QIlGHqePzUVifGy,SpATywNh6bZuzm8s1ceuBUnMUAeoAHHw,1,0,0,0,0,0,1,0,1,0.14285714285714285,1,0.0,0,0,0,0,0,0,0,1,0,0,1,1
10087,183468,SSM7wEvdZo8FZW0zxJcXGwdA1S6Vbn5Q,SpATywNh6bZuzm8s1ceuBUnMUAeoAHHw,10,9,5,13,0,1,2,0,30,4.285714285714286,1,0.0,3,5,11,0,6,1,2,2,0,19,11,0
10088,183471,ZWE0n8BTbJ9FUQALYDITtcmVETezeafV,bWdj2GDclj5ofokWjzoa5jAwMkxCykd6,10,8,2,40,2,1,4,1,58,8.285714285714286,1,0.0,5,2,39,2,3,1,1,4,1,48,10,1
10089,183472,UJgg3Z7RMqrOzehAajABZyrolXDOj0JJ,G8EPVSXsOYB5YQWZGiz1aVq5Pgr2GrQu,3,2,0,0,0,0,2,0,4,0.5714285714285714,1,0.0,0,0,0,0,2,0,0,2,0,0,4,1
10090,183474,pk69em2bhNfGTrrqysMHCMfzjd22WDJE,SpATywNh6bZuzm8s1ceuBUnMUAeoAHHw,13,8,4,2,3,0,4,1,22,3.142857142857143,1,0.0,0,4,2,3,8,0,0,4,1,9,13,1
10091,183475,bz5GKxlsbJHiQ5yHN3mGDylrAg3DXi5E,SpATywNh6bZuzm8s1ceuBUnMUAeoAHHw,9,9,8,0,5,0,2,0,24,3.4285714285714284,1,0.0,0,8,0,5,9,0,0,2,0,13,11,1
10092,183480,pumsIIBvkIDHPLuElv7OSuQxwiyrjr12,SpATywNh6bZuzm8s1ceuBUnMUAeoAHHw,14,27,8,20,4,1,5,0,65,9.285714285714286,1,0.0,9,8,18,4,18,1,2,5,0,39,26,1
10093,183491,hMsNCldAkGadwgGX6yjkMuu7X3GLTjYs,bWdj2GDclj5ofokWjzoa5jAwMkxCykd6,12,14,10,8,7,10,11,0,60,8.571428571428571,2,0.0,1,10,6,7,13,10,2,11,0,24,36,1
10094,183493,wTO6PriqUjklZvIhTLmF52Ryme8SIc0k,SpATywNh6bZuzm8s1ceuBUnMUAeoAHHw,1,0,0,0,0,0,1,0,1,0.14285714285714285,1,0.0,0,0,0,0,0,0,0,1,0,0,1,1
10095,183495,O6uNlqe4D6fw6uKpeBg3BRdXTyp6hhXG,RXDvfPUBYFlVdlueBFbLW0mhhAyGEqpt,1,0,0,0,0,0,1,0,1,0.14285714285714285,1,0.0,0,0,0,0,0,0,0,1,0,0,1,1
10096,183498,cQingcIr6b1ihV5kJhN5qPmtxp0KcxRT,G8EPVSXsOYB5YQWZGiz1aVq5Pgr2GrQu,7,6,3,0,2,3,3,0,17,2.4285714285714284,1,0.0,0,3,0,2,6,3,0,3,0,5,12,1
10097,183506,VtCUQBk0TlN0AJOAq0bEC4tTAH6HVrBA,RXDvfPUBYFlVdlueBFbLW0mhhAyGEqpt,5,3,1,0,1,0,1,0,6,0.8571428571428571,1,0.0,0,1,0,1,3,0,0,1,0,2,4,1
10098,183507,dRkGRhgEz0P6Cj2gSWKZ3jwm6LAB5sTl,RXDvfPUBYFlVdlueBFbLW0mhhAyGEqpt,6,14,10,0,0,0,5,0,29,4.142857142857143,1,0.0,0,10,0,0,14,0,0,5,0,10,19,1
10099,183510,UjlYIZQOEINWayGhC3yn2Cik0ILUnmNg,RXDvfPUBYFlVdlueBFbLW0mhhAyGEqpt,10,11,7,0,4,0,10,0,32,4.571428571428571,1,0.0,0,7,0,4,11,0,0,10,0,11,21,1
10100,183512,DhiB4cJ1TCjmSH3ZWP9m0OqNyBdGeS5P,bWdj2GDclj5ofokWjzoa5jAwMkxCykd6,5,6,0,0,0,0,2,0,8,1.1428571428571428,1,0.0,0,0,0,0,6,0,0,2,0,0,8,1
10101,183515,dRbINtWX4PACMb6CoPwzFcGIwIksepgL,SpATywNh6bZuzm8s1ceuBUnMUAeoAHHw,1,0,0,0,0,0,1,0,1,0.14285714285714285,1,0.0,0,0,0,0,0,0,0,1,0,0,1,1
10102,183516,AwMbVkwoHOO4RwVeu0kWHW1pZCX6cyCm,bWdj2GDclj5ofokWjzoa5jAwMkxCykd6,2,0,0,0,0,0,2,0,2,0.2857142857142857,1,0.0,0,0,0,0,0,0,0,2,0,0,2,1
10103,183519,B4PjpXbBdKDLR1d4bTEW8nYb1XQ8zgOw,RXDvfPUBYFlVdlueBFbLW0mhhAyGEqpt,3,2,1,0,0,0,1,0,4,0.5714285714285714,1,0.0,0,1,0,0,2,0,0,1,0,1,3,1
10104,183520,1D6eUyCJP5alahovvE13UJeLeWGqXCSN,SpATywNh6bZuzm8s1ceuBUnMUAeoAHHw,1,0,0,0,0,0,1,0,1,0.14285714285714285,1,0.0,0,0,0,0,0,0,0,1,0,0,1,0
10105,183522,jdDAkKv7CXlTSONMrkYEJDMOqMZv4NO7,G8EPVSXsOYB5YQWZGiz1aVq5Pgr2GrQu,7,5,1,0,1,0,3,0,10,1.4285714285714286,1,0.0,0,1,0,1,5,0,0,3,0,2,8,1
10106,183523,uvHFiZDnxbLoaMgYUEvYxJ8fEqaBGtVR,SpATywNh6bZuzm8s1ceuBUnMUAeoAHHw,6,3,2,0,1,0,2,0,8,1.1428571428571428,1,0.0,0,2,0,1,3,0,0,2,0,3,5,1
10107,183525,l4fUBbt2UkEBI1IQ0gPXz6asVAEuAAgG,SpATywNh6bZuzm8s1ceuBUnMUAeoAHHw,8,6,6,0,4,0,5,0,21,3.0,3,0.0,0,6,0,4,6,0,0,5,0,10,11,1
10108,183529,Nqn3ANjR8SmFf4pF0O8Kve4CiSpmex7G,SpATywNh6bZuzm8s1ceuBUnMUAeoAHHw,1,0,0,0,0,0,1,0,1,0.14285714285714285,1,0.0,0,0,0,0,0,0,0,1,0,0,1,1
10109,183532,vrlk2ULHn3q7og5F7d4moUFSIP81jWhe,SpATywNh6bZuzm8s1ceuBUnMUAeoAHHw,5,2,1,0,1,0,2,0,6,0.8571428571428571,1,0.0,0,1,0,1,2,0,0,2,0,2,4,1
10110,183533,M75L90OOMTV1kEiI3n7vM0ty47YBFna9,SpATywNh6bZuzm8s1ceuBUnMUAeoAHHw,3,3,0,0,0,0,1,0,4,0.5714285714285714,1,0.0,0,0,0,0,3,0,0,1,0,0,4,1
10111,183544,pIUA4CxUOhlZMOg4cOlVb2la0FCnmRD3,RXDvfPUBYFlVdlueBFbLW0mhhAyGEqpt,11,6,5,0,3,0,2,0,16,2.2857142857142856,1,0.0,0,5,0,3,6,0,0,2,0,8,8,1
10112,183554,4gFDIkwCKsDbUhjdoZqM1BZ32HnFPqUv,bWdj2GDclj5ofokWjzoa5jAwMkxCykd6,2,0,0,0,0,0,2,0,2,0.2857142857142857,1,0.0,0,0,0,0,0,0,0,2,0,0,2,1
10113,183562,AWvgwCQmPH4OGAIYypj87Tg2RKpUEZjK,RXDvfPUBYFlVdlueBFbLW0mhhAyGEqpt,23,42,2,36,4,3,4,2,93,13.285714285714286,1,0.0,29,2,31,4,13,3,5,4,2,66,27,1
10114,183563,Edq6Echk8wEs8ShX5RBw5c8Yx8ANHVje,bWdj2GDclj5ofokWjzoa5jAwMkxCykd6,5,2,1,0,1,0,5,0,9,1.2857142857142858,1,0.0,0,1,0,1,2,0,0,5,0,2,7,1
10115,183564,K7VioOgkoW2bG7ynS7EVbYmEm9sNay8P,bWdj2GDclj5ofokWjzoa5jAwMkxCykd6,8,3,2,0,2,0,3,0,10,1.4285714285714286,1,0.0,0,2,0,2,3,0,0,3,0,4,6,1
10116,183568,lRbeD3dHMTos4W2d1Naqv6Hm53gM6ove,RXDvfPUBYFlVdlueBFbLW0mhhAyGEqpt,5,5,3,0,0,0,3,0,11,1.5714285714285714,1,0.0,0,3,0,0,5,0,0,3,0,3,8,1
10117,183574,kGkU7DU5zOC0IQHNRlo6r0rouCnUfi6R,bWdj2GDclj5ofokWjzoa5jAwMkxCykd6,1,0,0,0,0,0,1,0,1,0.14285714285714285,1,0.0,0,0,0,0,0,0,0,1,0,0,1,1
10118,183575,dTjL08in9jKZ00BA9Kf6biDJuIA4OzlF,bWdj2GDclj5ofokWjzoa5jAwMkxCykd6,1,0,0,0,0,0,1,0,1,0.14285714285714285,1,0.0,0,0,0,0,0,0,0,1,0,0,1,1
10119,183578,b1g4AWG6A2zG5plnQY4paLSHRFnrgObC,bWdj2GDclj5ofokWjzoa5jAwMkxCykd6,3,2,0,0,0,0,2,0,4,0.5714285714285714,1,0.0,0,0,0,0,2,0,0,2,0,0,4,1
10120,183580,3t9ZicXafEarB5kevklUjZj2RJMyb5VH,bWdj2GDclj5ofokWjzoa5jAwMkxCykd6,1,0,0,0,0,0,1,0,1,0.14285714285714285,1,0.0,0,0,0,0,0,0,0,1,0,0,1,1
10121,183583,eDzTwNhYw5qEG2zvbZVjOixJZpRNeUjf,SpATywNh6bZuzm8s1ceuBUnMUAeoAHHw,16,12,6,14,4,3,8,2,49,7.0,1,0.0,4,6,12,4,8,3,2,8,2,26,23,1
10122,183584,9KpScbHudyYdTVutfkp65lLJaFeSgBWp,SpATywNh6bZuzm8s1ceuBUnMUAeoAHHw,4,3,1,0,0,0,2,0,6,0.8571428571428571,1,0.0,0,1,0,0,3,0,0,2,0,1,5,1
10123,183597,Eh6H4i1zHStqzSkD6GI2c0vx2yJEOPJN,RXDvfPUBYFlVdlueBFbLW0mhhAyGEqpt,1,0,0,0,0,0,1,0,1,0.14285714285714285,1,0.0,0,0,0,0,0,0,0,1,0,0,1,1
10124,183600,0ZbsYtS35s7opWGwTDlJClFUqsKIqJ5M,SpATywNh6bZuzm8s1ceuBUnMUAeoAHHw,9,3,2,0,2,1,4,1,13,1.8571428571428572,1,0.0,0,2,0,2,3,1,0,4,1,4,9,1
10125,183602,VRgPAzuxIaYkNO2Qx5nEdyuDaVR0Pn8E,SpATywNh6bZuzm8s1ceuBUnMUAeoAHHw,7,5,4,0,3,0,4,0,16,2.2857142857142856,1,0.0,0,4,0,3,5,0,0,4,0,7,9,1
10126,183604,SKEZ0daa2ls5AsPymaWXx3HMK7ugoFOQ,SpATywNh6bZuzm8s1ceuBUnMUAeoAHHw,3,2,0,0,0,0,2,0,4,0.5714285714285714,1,0.0,0,0,0,0,2,0,0,2,0,0,4,1
10127,183605,u4EZDHauXLY7CQOXsbgjEXdCMOX1ZIIi,bWdj2GDclj5ofokWjzoa5jAwMkxCykd6,8,6,1,0,2,0,9,1,19,2.7142857142857144,1,0.0,3,1,0,2,3,0,0,9,1,6,13,1
10128,183608,5Qb7U49ZGB6vPwkkfqIlX0DILe5PUAX7,SpATywNh6bZuzm8s1ceuBUnMUAeoAHHw,4,3,1,0,0,0,2,0,6,0.8571428571428571,1,0.0,0,1,0,0,3,0,0,2,0,1,5,1
10129,183615,jcXoYFaI9QPcliotiwIgOLeObkrSUvNn,bWdj2GDclj5ofokWjzoa5jAwMkxCykd6,1,0,0,0,0,0,1,0,1,0.14285714285714285,1,0.0,0,0,0,0,0,0,0,1,0,0,1,1
10130,183617,Pv9LrfjnRw1WO1VwPNHCu7aKxUz6zC8i,SpATywNh6bZuzm8s1ceuBUnMUAeoAHHw,9,11,6,8,0,0,4,0,29,4.142857142857143,2,0.0,4,6,6,0,7,0,2,4,0,16,13,1
10131,183618,Fy49pMsTJR4qc7kCFAlWxZsMejdzrbbw,SpATywNh6bZuzm8s1ceuBUnMUAeoAHHw,6,2,1,0,1,0,3,1,8,1.1428571428571428,1,0.0,0,1,0,1,2,0,0,3,1,2,6,1
10132,183620,8f6cUr3CdC0FEH3V0o2H0iLNd9nVyUsV,SpATywNh6bZuzm8s1ceuBUnMUAeoAHHw,6,0,0,0,0,1,7,1,9,1.2857142857142858,1,0.0,0,0,0,0,0,1,0,7,1,0,9,1
10133,183623,7wyfXvc1g99QNmXzEb4w8C1vE0Vi2bHm,bWdj2GDclj5ofokWjzoa5jAwMkxCykd6,4,2,0,0,0,0,4,0,6,0.8571428571428571,1,0.0,0,0,0,0,2,0,0,4,0,0,6,1
10134,183626,Qntf4pjwhrrlpkPkdw7xTOHA3tqEKwZo,SpATywNh6bZuzm8s1ceuBUnMUAeoAHHw,1,0,0,0,0,0,1,0,1,0.14285714285714285,1,0.0,0,0,0,0,0,0,0,1,0,0,1,1
10135,183627,vpIRkrpJz2fnOEDQ7QyDeADagL23RUmm,SpATywNh6bZuzm8s1ceuBUnMUAeoAHHw,5,2,1,0,1,0,3,0,7,1.0,1,0.0,0,1,0,1,2,0,0,3,0,2,5,1
10136,183628,r3xrbycrTBTOJ8lVkbmPIEtnYkwuySp0,G8EPVSXsOYB5YQWZGiz1aVq5Pgr2GrQu,7,7,1,0,1,0,1,0,10,1.4285714285714286,1,0.0,1,1,0,1,6,0,0,1,0,3,7,1
10137,183642,mbEX76fVD9CfdxvS9S0YmboTh2OQRRH9,SpATywNh6bZuzm8s1ceuBUnMUAeoAHHw,9,10,0,10,0,23,1,0,44,6.285714285714286,1,0.0,4,0,9,0,6,23,1,1,0,13,31,1
10138,183647,a4RYqILKcnu8c617gYSbD0KQIm9DqZnc,RXDvfPUBYFlVdlueBFbLW0mhhAyGEqpt,6,5,4,0,2,0,1,0,12,1.7142857142857142,1,0.0,0,4,0,2,5,0,0,1,0,6,6,1
10139,183667,H01qgmsAzE6UZ02rpT0g0cPQbKgigwE6,SpATywNh6bZuzm8s1ceuBUnMUAeoAHHw,1,0,0,0,0,0,1,0,1,0.14285714285714285,1,0.0,0,0,0,0,0,0,0,1,0,0,1,1
10140,183668,NMciPbdIeB9uIZwCMcw6mXU2i3BtnB5v,RXDvfPUBYFlVdlueBFbLW0mhhAyGEqpt,13,8,5,15,3,0,1,0,32,4.571428571428571,1,0.0,1,5,12,3,7,0,3,1,0,21,11,0
10141,183677,3kAfPhBAdLqCd25fZapuQy7eXOe7UiZ6,SpATywNh6bZuzm8s1ceuBUnMUAeoAHHw,2,0,0,0,0,0,3,0,3,0.42857142857142855,1,0.0,0,0,0,0,0,0,0,3,0,0,3,1
10142,183678,00w736SmRTShB1yHSNNQKxZ90wTM71uT,SpATywNh6bZuzm8s1ceuBUnMUAeoAHHw,1,0,0,0,0,0,1,0,1,0.14285714285714285,1,0.0,0,0,0,0,0,0,0,1,0,0,1,1
10143,183681,tUa09YYOUnb3wVzvjQGH0FvIpZ5hsZpt,SpATywNh6bZuzm8s1ceuBUnMUAeoAHHw,6,1,0,0,0,1,4,1,7,1.0,1,0.0,0,0,0,0,1,1,0,4,1,0,7,1
10144,183683,Hqlgf2n4GScNbLk3LnpSlhqbXS4k1V5Y,bWdj2GDclj5ofokWjzoa5jAwMkxCykd6,2,0,0,0,0,0,2,0,2,0.2857142857142857,1,0.0,0,0,0,0,0,0,0,2,0,0,2,1
10145,183684,PJVOwbqsSqxmbQfiqysBeUsqu2d0RHYt,SpATywNh6bZuzm8s1ceuBUnMUAeoAHHw,1,0,0,0,0,0,1,0,1,0.14285714285714285,1,0.0,0,0,0,0,0,0,0,1,0,0,1,1
10146,183685,srrwedRjbv42svoIh3SiJfl8lc5wqthR,SpATywNh6bZuzm8s1ceuBUnMUAeoAHHw,8,6,1,0,1,0,3,1,12,1.7142857142857142,1,0.0,0,1,0,1,6,0,0,3,1,2,10,1
10147,183690,LrnqEdfBj0D0yEwqlIwYFq7gG4yeMv2F,RXDvfPUBYFlVdlueBFbLW0mhhAyGEqpt,5,3,2,0,2,0,2,0,9,1.2857142857142858,1,0.0,0,2,0,2,3,0,0,2,0,4,5,1
10148,183692,pGwYJRrX7MfzhhSwNLSQAMurehSIgkJ9,bWdj2GDclj5ofokWjzoa5jAwMkxCykd6,9,5,3,16,2,8,7,1,42,6.0,2,0.0,1,3,16,2,4,8,0,7,1,22,20,1
10149,183696,5507vCg0B1i7QYbqjYirkMGFioj9q8do,bWdj2GDclj5ofokWjzoa5jAwMkxCykd6,7,3,3,0,3,0,2,0,11,1.5714285714285714,1,0.0,0,3,0,3,3,0,0,2,0,6,5,1
10150,183697,XTAgcCcMxVaOaQnxZJfZgo5L5IIUp6vo,SpATywNh6bZuzm8s1ceuBUnMUAeoAHHw,7,4,1,0,1,0,4,0,10,1.4285714285714286,1,0.0,0,1,0,1,4,0,0,4,0,2,8,1
10151,183703,0tUsWRwcM5Diph5ritKgQygdUhSNn96x,SpATywNh6bZuzm8s1ceuBUnMUAeoAHHw,6,2,1,0,1,0,2,0,6,0.8571428571428571,1,0.0,0,1,0,1,2,0,0,2,0,2,4,1
10152,183705,fsTTrbfLLX3LLKI2ivzhVe8zchwg73pj,SpATywNh6bZuzm8s1ceuBUnMUAeoAHHw,15,12,6,14,3,1,5,0,41,5.857142857142857,1,0.0,4,6,13,3,8,1,1,5,0,26,15,1
10153,183706,0eu2uHXXHlrxtRapovPIpFp8IooLmBew,SpATywNh6bZuzm8s1ceuBUnMUAeoAHHw,5,2,1,0,1,0,2,0,6,0.8571428571428571,1,0.0,0,1,0,1,2,0,0,2,0,2,4,1
10154,183707,NaRJmQnyQzKeB0w8DDGDf6ZmsPHjlThO,SpATywNh6bZuzm8s1ceuBUnMUAeoAHHw,10,6,0,6,0,0,4,1,17,2.4285714285714284,1,0.0,1,0,5,0,5,0,1,4,1,6,11,1
10155,183721,j77DK4hco4PDLnfPsujP1vD7LFaP7p4V,SpATywNh6bZuzm8s1ceuBUnMUAeoAHHw,10,10,0,0,1,3,5,3,22,3.142857142857143,1,0.0,1,0,0,1,9,3,0,5,3,2,20,1
10156,183725,GfV76YxFEig6L2nHg6sIaPDE5VPf3uRt,SpATywNh6bZuzm8s1ceuBUnMUAeoAHHw,8,4,3,0,3,0,3,0,13,1.8571428571428572,1,0.0,0,3,0,3,4,0,0,3,0,6,7,1
10157,183728,wjS8ie6ACTxewSCQo7zpBy0tu4z4RYPD,RXDvfPUBYFlVdlueBFbLW0mhhAyGEqpt,1,0,0,0,0,0,1,0,1,0.14285714285714285,1,0.0,0,0,0,0,0,0,0,1,0,0,1,1
10158,183730,eDzTwNhYw5qEG2zvbZVjOixJZpRNeUjf,bWdj2GDclj5ofokWjzoa5jAwMkxCykd6,11,14,8,10,4,0,7,0,43,6.142857142857143,1,0.0,1,8,8,4,13,0,2,7,0,21,22,1
10159,183732,Cu4fMSI1LUWMJcNR5zM13WUwE6Hxc1yL,SpATywNh6bZuzm8s1ceuBUnMUAeoAHHw,10,7,4,11,0,0,2,0,24,3.4285714285714284,1,0.0,2,4,10,0,5,0,1,2,0,16,8,1
10160,183733,MlcE1JFENTunAHw0ocZkMchxf8NdWNFO,bWdj2GDclj5ofokWjzoa5jAwMkxCykd6,3,4,1,0,1,0,1,0,7,1.0,1,0.0,2,1,0,1,2,0,0,1,0,4,3,1
10161,183735,68jxA2PUjT1NQfZbUcdmPfGR0u6r2zeM,RXDvfPUBYFlVdlueBFbLW0mhhAyGEqpt,1,0,0,0,0,0,1,0,1,0.14285714285714285,1,0.0,0,0,0,0,0,0,0,1,0,0,1,1
10162,183745,FR3djrgj8pkYcAIqYiRiT862Pvu77Ath,SpATywNh6bZuzm8s1ceuBUnMUAeoAHHw,1,0,0,0,0,0,1,0,1,0.14285714285714285,1,0.0,0,0,0,0,0,0,0,1,0,0,1,1
10163,183748,hD4qEuZFDZPZ2RLgArJFuhYLdzuJCt01,bWdj2GDclj5ofokWjzoa5jAwMkxCykd6,7,5,1,0,0,0,5,0,11,1.5714285714285714,1,0.0,0,1,0,0,5,0,0,5,0,1,10,1
10164,183750,G7MC8DJ4FubRjcyO7f3yIgxskIjZSZjx,SpATywNh6bZuzm8s1ceuBUnMUAeoAHHw,1,0,0,0,0,0,1,0,1,0.14285714285714285,1,0.0,0,0,0,0,0,0,0,1,0,0,1,1
10165,183751,hJq2MbZS4JBSMT1a0Z3Gv6HKBJY6P875,bWdj2GDclj5ofokWjzoa5jAwMkxCykd6,1,0,0,0,0,0,1,0,1,0.14285714285714285,1,0.0,0,0,0,0,0,0,0,1,0,0,1,1
10166,183752,bxybXAkYqJdxWDLSPlh74sjGoIJub8gI,SpATywNh6bZuzm8s1ceuBUnMUAeoAHHw,4,3,1,0,1,0,1,0,6,0.8571428571428571,1,0.0,0,1,0,1,3,0,0,1,0,2,4,1
10167,183756,hJq2MbZS4JBSMT1a0Z3Gv6HKBJY6P875,G8EPVSXsOYB5YQWZGiz1aVq5Pgr2GrQu,1,0,0,0,0,0,1,0,1,0.14285714285714285,1,0.0,0,0,0,0,0,0,0,1,0,0,1,1
10168,183762,o1et1l3gB2UO6Zee7jdvT3mFoSzRmTnv,SpATywNh6bZuzm8s1ceuBUnMUAeoAHHw,11,67,43,0,0,2,18,1,131,18.714285714285715,1,0.0,11,43,0,0,56,2,0,18,1,54,77,1
10169,183763,VeIUrvtz2WpmBOVKmRi9CiIdJh5W97e2,RXDvfPUBYFlVdlueBFbLW0mhhAyGEqpt,6,1,1,0,1,0,4,0,7,1.0,1,0.0,0,1,0,1,1,0,0,4,0,2,5,1
10170,183764,Nlh27vHI7XhT6kQrXYnVdjcOvglbank1,G8EPVSXsOYB5YQWZGiz1aVq5Pgr2GrQu,5,4,1,0,0,0,1,0,6,0.8571428571428571,1,0.0,0,1,0,0,4,0,0,1,0,1,5,1
10171,183765,rQAguOaTDu3xVeM76HB96fgatKOO1sTk,SpATywNh6bZuzm8s1ceuBUnMUAeoAHHw,1,0,0,0,0,0,1,0,1,0.14285714285714285,1,0.0,0,0,0,0,0,0,0,1,0,0,1,1
10172,183769,YV5fQTL2YvQLATfqnj9sLfcWGppiWs4n,bWdj2GDclj5ofokWjzoa5jAwMkxCykd6,9,12,5,0,2,0,6,1,26,3.7142857142857144,1,0.0,0,5,0,2,12,0,0,6,1,7,19,1
10173,183771,rQAguOaTDu3xVeM76HB96fgatKOO1sTk,bWdj2GDclj5ofokWjzoa5jAwMkxCykd6,1,0,0,0,0,0,1,0,1,0.14285714285714285,1,0.0,0,0,0,0,0,0,0,1,0,0,1,1
10174,183772,cYRBWOkDMP7C555Y2eZz5GOKMhCVJBvZ,SpATywNh6bZuzm8s1ceuBUnMUAeoAHHw,8,5,3,0,2,0,4,0,14,2.0,1,0.0,0,3,0,2,5,0,0,4,0,5,9,1
10175,183773,aXiJW8ayzWdjAFuCXJZEkZEM0lQLoZYD,SpATywNh6bZuzm8s1ceuBUnMUAeoAHHw,1,0,0,0,0,0,1,0,1,0.14285714285714285,1,0.0,0,0,0,0,0,0,0,1,0,0,1,1
10176,183776,K8gGtH4J6AjA9U9FV7bczDiv6su7TqD9,SpATywNh6bZuzm8s1ceuBUnMUAeoAHHw,2,0,0,0,0,0,2,0,2,0.2857142857142857,1,0.0,0,0,0,0,0,0,0,2,0,0,2,1
10177,183778,jVE9J6XTbZz7EeUuDkD5BDSnxkl65G8L,bWdj2GDclj5ofokWjzoa5jAwMkxCykd6,6,7,4,0,1,6,4,0,22,3.142857142857143,1,0.0,0,4,0,1,7,6,0,4,0,5,17,1
10178,183782,wzcKXGYxAENlw35KZ5i9A0UYj84yOcRo,SpATywNh6bZuzm8s1ceuBUnMUAeoAHHw,1,0,0,0,0,0,1,0,1,0.14285714285714285,1,0.0,0,0,0,0,0,0,0,1,0,0,1,1
10179,183794,oqyLKKVVYW9EATjohuVL1hNLHTIkDxiu,RXDvfPUBYFlVdlueBFbLW0mhhAyGEqpt,9,6,3,0,1,1,7,1,19,2.7142857142857144,1,0.0,0,3,0,1,6,1,0,7,1,4,15,1
10180,183795,8u2jHFBQdYbssbxd155XumepML5OnCFA,SpATywNh6bZuzm8s1ceuBUnMUAeoAHHw,9,3,2,0,1,1,5,1,13,1.8571428571428572,1,0.0,0,2,0,1,3,1,0,5,1,3,10,1
10181,183797,vlHmtLHxbw7S6zxC5oHlY3I9JCi1BY6K,bWdj2GDclj5ofokWjzoa5jAwMkxCykd6,1,0,0,0,0,0,1,0,1,0.14285714285714285,1,0.0,0,0,0,0,0,0,0,1,0,0,1,1
10182,183799,bxybXAkYqJdxWDLSPlh74sjGoIJub8gI,bWdj2GDclj5ofokWjzoa5jAwMkxCykd6,7,5,2,0,1,0,4,0,12,1.7142857142857142,2,0.0,0,2,0,1,5,0,0,4,0,3,9,1
10183,183807,nB4B19Wi7VjyTtJDPkIXAAww5TaYMuNU,G8EPVSXsOYB5YQWZGiz1aVq5Pgr2GrQu,6,5,3,0,1,0,2,0,11,1.5714285714285714,1,0.0,0,3,0,1,5,0,0,2,0,4,7,0
10184,183809,hr7uGA6N7pm5Wb3vahUIH4sx0GWC6IQD,G8EPVSXsOYB5YQWZGiz1aVq5Pgr2GrQu,5,2,1,0,1,0,3,0,7,1.0,1,0.0,0,1,0,1,2,0,0,3,0,2,5,1
10185,183811,YXm8bq7zaK4Xr5i1u3w8eLm5WwHCxSwx,bWdj2GDclj5ofokWjzoa5jAwMkxCykd6,2,0,0,0,0,4,1,0,5,0.7142857142857143,1,0.0,0,0,0,0,0,4,0,1,0,0,5,1
10186,183814,aOe6ryD5RYplhCYczJ8onj52Uh9OP4Rs,SpATywNh6bZuzm8s1ceuBUnMUAeoAHHw,7,7,1,0,1,1,3,0,13,1.8571428571428572,1,0.0,0,1,0,1,7,1,0,3,0,2,11,1
10187,183815,cfg2dvjgHRrRXnLKehwyxBIarxQiiXUS,bWdj2GDclj5ofokWjzoa5jAwMkxCykd6,4,2,0,0,1,0,1,0,4,0.5714285714285714,1,0.0,0,0,0,1,2,0,0,1,0,1,3,1
10188,183816,1y8Z7kbql2eWHeUppugE1NMIawh69MAq,SpATywNh6bZuzm8s1ceuBUnMUAeoAHHw,1,0,0,0,0,0,2,0,2,0.2857142857142857,1,0.0,0,0,0,0,0,0,0,2,0,0,2,1
10189,183820,RtJIi7yt7eqxxsJXnxUwVJPkYwTwddBt,SpATywNh6bZuzm8s1ceuBUnMUAeoAHHw,1,0,0,0,0,0,1,0,1,0.14285714285714285,1,0.0,0,0,0,0,0,0,0,1,0,0,1,1
10190,183824,ijNpE1ugmA4mkAddk2e3bQh6TJ0jb7HD,RXDvfPUBYFlVdlueBFbLW0mhhAyGEqpt,5,2,1,0,1,10,2,1,17,2.4285714285714284,1,0.0,0,1,0,1,2,10,0,2,1,2,15,1
10191,183826,GZEmn2jDYiPNelTXdP84Wl4gxgVXz7UQ,SpATywNh6bZuzm8s1ceuBUnMUAeoAHHw,7,4,3,0,2,1,2,0,12,1.7142857142857142,1,0.0,0,3,0,2,4,1,0,2,0,5,7,1
10192,183828,KyIbCsqzwxfjreA4vfXflB0Ayn4dl9kJ,SpATywNh6bZuzm8s1ceuBUnMUAeoAHHw,16,15,7,18,3,22,8,2,75,10.714285714285714,1,0.0,6,7,15,3,9,22,3,8,2,31,44,1
10193,183831,G4FZ5Oaaa2T6hGa1xufDgayvfMZLCg3D,bWdj2GDclj5ofokWjzoa5jAwMkxCykd6,2,0,0,0,0,0,2,0,2,0.2857142857142857,1,0.0,0,0,0,0,0,0,0,2,0,0,2,1
10194,183832,114X1vLT3OTzchhxfRGg24FTsgrs6Boi,SpATywNh6bZuzm8s1ceuBUnMUAeoAHHw,6,3,1,0,1,1,2,0,8,1.1428571428571428,1,0.0,0,1,0,1,3,1,0,2,0,2,6,1
10195,183833,vjbajDbPbQrGXYYcs1rbmRr6ezhDtDUy,bWdj2GDclj5ofokWjzoa5jAwMkxCykd6,1,0,0,0,0,0,1,0,1,0.14285714285714285,1,0.0,0,0,0,0,0,0,0,1,0,0,1,1
10196,183837,9veooDPdHGt0QPXOfcP4HtwqJxaobeIU,SpATywNh6bZuzm8s1ceuBUnMUAeoAHHw,11,17,3,14,0,8,5,1,48,6.857142857142857,1,0.0,10,3,13,0,7,8,1,5,1,26,22,1
10197,183838,aHceKEl94riboDVp8PRLPCY1XwhHlQv5,SpATywNh6bZuzm8s1ceuBUnMUAeoAHHw,1,0,0,0,0,0,1,0,1,0.14285714285714285,1,0.0,0,0,0,0,0,0,0,1,0,0,1,1
10198,183840,nxF8oaRxp1kRmW1R62DpnweCKcBsKTqd,SpATywNh6bZuzm8s1ceuBUnMUAeoAHHw,10,17,8,0,3,17,4,0,49,7.0,1,0.0,2,8,0,3,15,17,0,4,0,13,36,1
10199,183841,EytS791DMHkWPyEwKtiaQ332ujzLnBwF,bWdj2GDclj5ofokWjzoa5jAwMkxCykd6,5,10,1,0,1,0,2,0,14,2.0,1,0.0,0,1,0,1,10,0,0,2,0,2,12,1
10200,183846,umctuhbIVZDh6EHjPhWargzhNqVIeFMx,RXDvfPUBYFlVdlueBFbLW0mhhAyGEqpt,2,0,0,0,0,0,2,0,2,0.2857142857142857,1,0.0,0,0,0,0,0,0,0,2,0,0,2,1
10201,183861,DIfWHwFZNZPga0SgQhZ5mLJfHSTndMBk,G8EPVSXsOYB5YQWZGiz1aVq5Pgr2GrQu,4,0,0,0,0,1,3,1,5,0.7142857142857143,1,0.0,0,0,0,0,0,1,0,3,1,0,5,1
10202,183863,OyUzOGgEg3D1ADlF5EJGg06nY3QmnkdW,RXDvfPUBYFlVdlueBFbLW0mhhAyGEqpt,15,10,10,0,8,0,7,0,35,5.0,3,0.0,0,10,0,8,10,0,0,7,0,18,17,1
10203,183866,lLsAMLGXDOsZeatceMnZJfI2N4EJjHne,G8EPVSXsOYB5YQWZGiz1aVq5Pgr2GrQu,1,0,0,0,0,0,4,0,4,0.5714285714285714,1,0.0,0,0,0,0,0,0,0,4,0,0,4,1
10204,183878,EnOE2zcU3adIQka8zXE5uaDcwrIceQaF,bWdj2GDclj5ofokWjzoa5jAwMkxCykd6,3,2,0,0,0,0,2,0,4,0.5714285714285714,1,0.0,0,0,0,0,2,0,0,2,0,0,4,1
10205,183879,5wfiCJMdbkN7MkoUGvo3cfz8jV3jCktA,SpATywNh6bZuzm8s1ceuBUnMUAeoAHHw,4,2,1,0,1,0,1,0,5,0.7142857142857143,1,0.0,0,1,0,1,2,0,0,1,0,2,3,1
10206,183881,8qABUnBBHxxZkfUhEQNUn5NNMSRrqvPC,bWdj2GDclj5ofokWjzoa5jAwMkxCykd6,7,4,1,36,0,0,3,1,45,6.428571428571429,1,0.0,2,1,35,0,2,0,1,3,1,38,7,1
10207,183888,TL1aA8ITe7VP42GX52yE5M5UsjXNCOS3,RXDvfPUBYFlVdlueBFbLW0mhhAyGEqpt,14,6,4,10,2,5,4,3,34,4.857142857142857,1,0.0,1,4,9,2,5,5,1,4,3,16,18,1
10208,183892,4wMgOAufqnPs3VhoygBeCYo4HP5tpnQt,SpATywNh6bZuzm8s1ceuBUnMUAeoAHHw,13,22,0,17,0,27,14,2,82,11.714285714285714,2,0.0,6,0,16,0,16,27,1,14,2,22,60,1
10209,183896,0a6HihupPBi4xpjolN637qOYG6WSN1Gx,bWdj2GDclj5ofokWjzoa5jAwMkxCykd6,1,0,0,0,0,0,1,0,1,0.14285714285714285,1,0.0,0,0,0,0,0,0,0,1,0,0,1,1
10210,183897,0a6HihupPBi4xpjolN637qOYG6WSN1Gx,G8EPVSXsOYB5YQWZGiz1aVq5Pgr2GrQu,1,0,0,0,0,0,1,0,1,0.14285714285714285,1,0.0,0,0,0,0,0,0,0,1,0,0,1,1
10211,183902,Z0eVgz6SGtmMg7DreMuN7iJOutansTOw,SpATywNh6bZuzm8s1ceuBUnMUAeoAHHw,5,2,1,0,1,0,2,0,6,0.8571428571428571,1,0.0,0,1,0,1,2,0,0,2,0,2,4,1
10212,183903,Pe0BOQruXYclUh2pOuaZXsDRh9S1JXgK,G8EPVSXsOYB5YQWZGiz1aVq5Pgr2GrQu,15,19,2,14,2,0,2,0,39,5.571428571428571,2,0.0,0,2,13,2,19,0,1,2,0,17,22,1
10213,183927,1dSFrGV3jJZZA6qD4kOvZZNlB08eN9yU,SpATywNh6bZuzm8s1ceuBUnMUAeoAHHw,5,2,1,0,1,0,2,0,6,0.8571428571428571,1,0.0,0,1,0,1,2,0,0,2,0,2,4,1
10214,183929,BDdKHYPp1edgylVPYUBHaWJ6W3VobGdR,bWdj2GDclj5ofokWjzoa5jAwMkxCykd6,1,0,0,0,0,0,1,0,1,0.14285714285714285,1,0.0,0,0,0,0,0,0,0,1,0,0,1,1
10215,183936,MQT2DULvI9Dh4Sv1Ybk3xSqbqkDpET5t,RXDvfPUBYFlVdlueBFbLW0mhhAyGEqpt,5,1,1,0,1,0,3,0,6,0.8571428571428571,1,0.0,0,1,0,1,1,0,0,3,0,2,4,1
10216,183944,OB9oqmKPpcpFDkINdhqqXHF5hvJxfFBy,RXDvfPUBYFlVdlueBFbLW0mhhAyGEqpt,10,6,3,0,4,4,3,1,21,3.0,1,0.0,2,3,0,4,4,4,0,3,1,9,12,1
10217,183945,eswhmtF9u6PPevIa1f1kWFAOOSBwFxOH,SpATywNh6bZuzm8s1ceuBUnMUAeoAHHw,11,12,0,17,0,6,11,0,46,6.571428571428571,1,0.0,5,0,15,0,7,6,2,11,0,20,26,1
10218,183948,FFv9BpeuCytTk0cAY5ewtWqnPg8thMxr,SpATywNh6bZuzm8s1ceuBUnMUAeoAHHw,6,4,1,0,1,0,2,0,8,1.1428571428571428,1,0.0,0,1,0,1,4,0,0,2,0,2,6,1
10219,183956,qWnVRlOPWMpKhlz6DOCzqOXTcukhQiSA,bWdj2GDclj5ofokWjzoa5jAwMkxCykd6,3,2,0,0,0,0,1,0,3,0.42857142857142855,1,0.0,0,0,0,0,2,0,0,1,0,0,3,1
10220,183960,Q1yHZhB4hdcEznkeMey1ms0QifJ1CmdJ,G8EPVSXsOYB5YQWZGiz1aVq5Pgr2GrQu,1,0,0,0,0,0,1,0,1,0.14285714285714285,1,0.0,0,0,0,0,0,0,0,1,0,0,1,1
10221,183961,EWfsPxhCOXyE5eAI95GRpmzvT2SBrtgo,bWdj2GDclj5ofokWjzoa5jAwMkxCykd6,5,2,1,0,1,0,2,0,6,0.8571428571428571,1,0.0,0,1,0,1,2,0,0,2,0,2,4,1
10222,183975,f87pZCpThW6wNSnbexp1IWcK6VsMLCVr,RXDvfPUBYFlVdlueBFbLW0mhhAyGEqpt,19,11,7,14,4,0,2,0,38,5.428571428571429,1,0.0,3,7,14,4,8,0,0,2,0,28,10,1
10223,183982,Y87S79gsUH7x23XztCpMBa6RocL8Wlfk,bWdj2GDclj5ofokWjzoa5jAwMkxCykd6,5,4,0,0,1,0,5,0,10,1.4285714285714286,1,0.0,2,0,0,1,2,0,0,5,0,3,7,0
10224,183983,SEGJwH5xjhu0GixnmBSSBGNuHPRYimOx,SpATywNh6bZuzm8s1ceuBUnMUAeoAHHw,6,4,3,0,3,0,2,0,12,1.7142857142857142,1,0.0,0,3,0,3,4,0,0,2,0,6,6,1
10225,183985,GkZnrGaNbm07rAcHFJINai1bqc5xBBHT,SpATywNh6bZuzm8s1ceuBUnMUAeoAHHw,13,9,5,14,3,0,2,0,33,4.714285714285714,1,0.0,3,5,12,3,6,0,2,2,0,23,10,1
10226,183986,fNmDgjJniXOszcIHzS3zC4fz25NLjlFC,SpATywNh6bZuzm8s1ceuBUnMUAeoAHHw,1,0,0,0,0,0,1,0,1,0.14285714285714285,1,0.0,0,0,0,0,0,0,0,1,0,0,1,1
10227,183989,m4zdr76CpU472F6wsJffFbslI27LpI4g,SpATywNh6bZuzm8s1ceuBUnMUAeoAHHw,4,2,1,0,1,0,1,0,5,0.7142857142857143,1,0.0,0,1,0,1,2,0,0,1,0,2,3,1
10228,183993,dHF0lmwAWj90dNkEJgjhA3G1B2pjJava,bWdj2GDclj5ofokWjzoa5jAwMkxCykd6,1,0,0,0,0,0,1,0,1,0.14285714285714285,1,0.0,0,0,0,0,0,0,0,1,0,0,1,1
10229,183996,37daqGAbA6x2VvXkiqdWX1nBv2Tqqgte,SpATywNh6bZuzm8s1ceuBUnMUAeoAHHw,5,6,2,0,0,0,4,0,12,1.7142857142857142,1,0.0,0,2,0,0,6,0,0,4,0,2,10,1
10230,184009,wB8pBt76NTGPtrvjIdU3pN9EwIWhKGQo,SpATywNh6bZuzm8s1ceuBUnMUAeoAHHw,1,0,0,0,0,0,1,0,1,0.14285714285714285,1,0.0,0,0,0,0,0,0,0,1,0,0,1,1
10231,184012,mEFKCYz8MVHPZugokUhGo6T9qmLFE897,SpATywNh6bZuzm8s1ceuBUnMUAeoAHHw,16,28,10,13,5,2,8,2,68,9.714285714285714,2,0.0,8,10,13,5,20,2,0,8,2,36,32,1
10232,184033,BMzXa4F1HK4MbDTdR0pGzLHAAodUPJ6y,bWdj2GDclj5ofokWjzoa5jAwMkxCykd6,1,0,0,0,0,0,1,0,1,0.14285714285714285,1,0.0,0,0,0,0,0,0,0,1,0,0,1,1
10233,184038,Q12SmIgxAUIk1yKqjdfp0LXtJMgJdL9G,G8EPVSXsOYB5YQWZGiz1aVq5Pgr2GrQu,4,2,1,0,1,0,1,0,5,0.7142857142857143,1,0.0,0,1,0,1,2,0,0,1,0,2,3,1
10234,184039,GuBhksrnBhutuN529M1YtfTMCYIFJ6lY,G8EPVSXsOYB5YQWZGiz1aVq5Pgr2GrQu,12,10,5,0,4,0,2,0,21,3.0,1,0.0,0,5,0,4,10,0,0,2,0,9,12,1
10235,184047,XGJyrNdICrlEhPA3ZH7TFUF5DLeflEqn,SpATywNh6bZuzm8s1ceuBUnMUAeoAHHw,5,2,1,0,1,0,2,0,6,0.8571428571428571,1,0.0,0,1,0,1,2,0,0,2,0,2,4,1
10236,184048,k03NkUiM55XNDdygu6sbcCzBSQB1ke1d,RXDvfPUBYFlVdlueBFbLW0mhhAyGEqpt,11,17,1,0,1,0,4,0,23,3.2857142857142856,2,0.0,4,1,0,1,13,0,0,4,0,6,17,1
10237,184049,e41xflW3FJ2sfkSYCVTAw1yP2aJoqexe,SpATywNh6bZuzm8s1ceuBUnMUAeoAHHw,8,3,2,0,2,0,3,0,10,1.4285714285714286,1,0.0,0,2,0,2,3,0,0,3,0,4,6,1
10238,184060,BggPiWvKnxZgtt6PObC5h6pkP2Vpotku,SpATywNh6bZuzm8s1ceuBUnMUAeoAHHw,6,6,0,0,0,0,1,0,7,1.0,1,0.0,1,0,0,0,5,0,0,1,0,1,6,1
10239,184061,f5Mcw4567TFpDJkhEoRSw0Jz1pQ2BFAk,bWdj2GDclj5ofokWjzoa5jAwMkxCykd6,8,3,2,0,1,9,6,1,22,3.142857142857143,1,0.0,0,2,0,1,3,9,0,6,1,3,19,1
10240,184062,0CZR6JiyNyPl8nfnIp1u7wOec3poXsdF,SpATywNh6bZuzm8s1ceuBUnMUAeoAHHw,2,0,0,0,0,0,3,0,3,0.42857142857142855,1,0.0,0,0,0,0,0,0,0,3,0,0,3,1
10241,184063,Dpc0zozzlSgsLSateIgSdps1xubS3wT6,SpATywNh6bZuzm8s1ceuBUnMUAeoAHHw,7,3,2,0,2,0,2,0,9,1.2857142857142858,1,0.0,0,2,0,2,3,0,0,2,0,4,5,1
10242,184064,4RuLKPumIDuBK6n356cKgw9GML4wpFFR,SpATywNh6bZuzm8s1ceuBUnMUAeoAHHw,3,2,0,0,0,0,1,0,3,0.42857142857142855,1,0.0,0,0,0,0,2,0,0,1,0,0,3,1
10243,184066,qgG4OU0HRuoi21bBKmy9fO5g8h7KcP6E,SpATywNh6bZuzm8s1ceuBUnMUAeoAHHw,1,0,0,0,0,0,2,0,2,0.2857142857142857,1,0.0,0,0,0,0,0,0,0,2,0,0,2,1
10244,184067,OQfqRWOxxNsIi3nGxNChuaOEpiwW2MKx,RXDvfPUBYFlVdlueBFbLW0mhhAyGEqpt,5,2,1,0,1,0,2,0,6,0.8571428571428571,1,0.0,0,1,0,1,2,0,0,2,0,2,4,1
10245,184068,4RuLKPumIDuBK6n356cKgw9GML4wpFFR,bWdj2GDclj5ofokWjzoa5jAwMkxCykd6,1,0,0,0,0,0,1,0,1,0.14285714285714285,1,0.0,0,0,0,0,0,0,0,1,0,0,1,1
10246,184069,8KiAWlLGlDWFZP4JQG4AIAZhrqwvN88h,SpATywNh6bZuzm8s1ceuBUnMUAeoAHHw,3,2,1,0,0,1,2,0,6,0.8571428571428571,1,0.0,0,1,0,0,2,1,0,2,0,1,5,1
10247,184071,BpUC3MNCHd8FaxSe6moajPD8WZk6dYxr,SpATywNh6bZuzm8s1ceuBUnMUAeoAHHw,8,7,3,0,1,0,5,0,16,2.2857142857142856,2,0.0,1,3,0,1,6,0,0,5,0,5,11,1
10248,184075,ZGG633YrnGbNzVczhlK5S0rasrudTzhc,bWdj2GDclj5ofokWjzoa5jAwMkxCykd6,5,2,1,0,1,0,2,0,6,0.8571428571428571,1,0.0,0,1,0,1,2,0,0,2,0,2,4,1
10249,184076,1WYr5BJIApYgFHMSnNu25YjtJhDOUsgy,SpATywNh6bZuzm8s1ceuBUnMUAeoAHHw,6,3,2,0,2,0,1,0,8,1.1428571428571428,1,0.0,0,2,0,2,3,0,0,1,0,4,4,1
10250,184079,CbIcKD0jazBhPd3ibnu0zTtemqpWb0KP,bWdj2GDclj5ofokWjzoa5jAwMkxCykd6,2,0,0,0,0,0,4,0,4,0.5714285714285714,1,0.0,0,0,0,0,0,0,0,4,0,0,4,1
10251,184083,1KWQQsGdbVWUkaTLPILtfeXnjhFZjqBM,G8EPVSXsOYB5YQWZGiz1aVq5Pgr2GrQu,9,17,5,10,0,0,1,0,33,4.714285714285714,1,0.0,11,5,7,0,6,0,3,1,0,23,10,1
10252,184088,NslicJCNMxB9cZhzoMFtRxmqPnqyw5Ii,bWdj2GDclj5ofokWjzoa5jAwMkxCykd6,2,0,0,0,0,0,2,0,2,0.2857142857142857,1,0.0,0,0,0,0,0,0,0,2,0,0,2,1
10253,184089,OcFLLEI56U80V98vNeJ7LrlE5FWxkkpp,G8EPVSXsOYB5YQWZGiz1aVq5Pgr2GrQu,3,0,0,0,0,0,3,0,3,0.42857142857142855,1,0.0,0,0,0,0,0,0,0,3,0,0,3,1
10254,184094,CJe4pjtrcC0FOMy3krEkccqFJZO0Cqq4,bWdj2GDclj5ofokWjzoa5jAwMkxCykd6,1,0,0,0,0,0,1,0,1,0.14285714285714285,1,0.0,0,0,0,0,0,0,0,1,0,0,1,1
10255,184095,P3USQ4ceul2wiH8GV6NzM8M3iSKwMNo4,SpATywNh6bZuzm8s1ceuBUnMUAeoAHHw,5,4,0,0,0,0,3,0,7,1.0,1,0.0,0,0,0,0,4,0,0,3,0,0,7,1
10256,184098,z6xFpyaGUcaO2LWirVvA3M3GqpWgJhqS,SpATywNh6bZuzm8s1ceuBUnMUAeoAHHw,1,0,0,0,0,0,1,0,1,0.14285714285714285,1,0.0,0,0,0,0,0,0,0,1,0,0,1,1
10257,184101,PgqyyO7ndxsbTeXX946lNioQkjXip4tO,SpATywNh6bZuzm8s1ceuBUnMUAeoAHHw,16,16,5,3,4,2,5,1,36,5.142857142857143,1,0.0,4,5,3,4,12,2,0,5,1,16,20,1
10258,184107,qZ6pNkd000rAjy9LHfRpNpwESWSmgGUc,bWdj2GDclj5ofokWjzoa5jAwMkxCykd6,5,1,1,0,1,0,2,0,5,0.7142857142857143,1,0.0,0,1,0,1,1,0,0,2,0,2,3,1
10259,184110,CDBOTUK7uywn5HAqBz0EsxjWXDFENYqJ,SpATywNh6bZuzm8s1ceuBUnMUAeoAHHw,7,5,3,0,2,2,4,1,17,2.4285714285714284,1,0.0,0,3,0,2,5,2,0,4,1,5,12,1
10260,184113,87SYGQjFYUtEWda0pG12bcNker0JGBy3,G8EPVSXsOYB5YQWZGiz1aVq5Pgr2GrQu,4,5,0,0,0,0,1,0,6,0.8571428571428571,1,0.0,0,0,0,0,5,0,0,1,0,0,6,1
10261,184118,s26PJmkfPL2SwqWbKoi56ybE6GBIg4Tm,SpATywNh6bZuzm8s1ceuBUnMUAeoAHHw,7,2,0,0,0,1,7,1,11,1.5714285714285714,1,0.0,0,0,0,0,2,1,0,7,1,0,11,1
10262,184122,uUI9pQoArlf6QZxuJL0Anm2VUW5XAEuG,SpATywNh6bZuzm8s1ceuBUnMUAeoAHHw,6,2,1,0,1,0,3,0,7,1.0,1,0.0,0,1,0,1,2,0,0,3,0,2,5,1
10263,184126,6MUx7O8xcYuB5a5sYqWaf93meZNmeUNV,SpATywNh6bZuzm8s1ceuBUnMUAeoAHHw,1,0,0,0,0,0,1,0,1,0.14285714285714285,1,0.0,0,0,0,0,0,0,0,1,0,0,1,1
10264,184133,4YlVfpMODnahyqQ3n65BCTHXZpXYZLKw,G8EPVSXsOYB5YQWZGiz1aVq5Pgr2GrQu,6,5,1,0,0,0,4,0,10,1.4285714285714286,1,0.0,0,1,0,0,5,0,0,4,0,1,9,1
10265,184142,drGvqw10fBGceNSK8gYikgxOQZE0vxto,SpATywNh6bZuzm8s1ceuBUnMUAeoAHHw,7,6,4,0,3,0,1,0,14,2.0,1,0.0,0,4,0,3,6,0,0,1,0,7,7,1
10266,184150,Ywa3CoCRvYFskTMBH1zQHBLyzuQWtUYW,RXDvfPUBYFlVdlueBFbLW0mhhAyGEqpt,1,0,0,0,0,0,1,0,1,0.14285714285714285,1,0.0,0,0,0,0,0,0,0,1,0,0,1,1
10267,184153,Pb9hmoXos06ovaJ97f9maK0LR5EwPgFN,SpATywNh6bZuzm8s1ceuBUnMUAeoAHHw,1,0,0,0,0,0,1,0,1,0.14285714285714285,1,0.0,0,0,0,0,0,0,0,1,0,0,1,1
10268,184154,4DUZBFD9Fwl71r8i0SB6pVZCzmNoxKnn,RXDvfPUBYFlVdlueBFbLW0mhhAyGEqpt,4,2,1,0,1,0,1,0,5,0.7142857142857143,1,0.0,0,1,0,1,2,0,0,1,0,2,3,1
10269,184156,4DUZBFD9Fwl71r8i0SB6pVZCzmNoxKnn,bWdj2GDclj5ofokWjzoa5jAwMkxCykd6,6,3,2,0,2,0,1,0,8,1.1428571428571428,1,0.0,0,2,0,2,3,0,0,1,0,4,4,1
10270,184160,h58kvDL22TD1HjsSMB6VxjCw9rBsMnsj,SpATywNh6bZuzm8s1ceuBUnMUAeoAHHw,15,18,9,6,5,4,4,0,46,6.571428571428571,2,0.0,7,9,6,5,11,4,0,4,0,27,19,1
10271,184165,oQLN4c1EqhMjc5I7s4sQvYxTs3qNNEKF,SpATywNh6bZuzm8s1ceuBUnMUAeoAHHw,1,0,0,0,0,0,1,0,1,0.14285714285714285,1,0.0,0,0,0,0,0,0,0,1,0,0,1,1
10272,184169,CalIeuRUuDsI51PX7a2T0B5AXb9dl64K,SpATywNh6bZuzm8s1ceuBUnMUAeoAHHw,1,0,0,0,0,0,1,0,1,0.14285714285714285,1,0.0,0,0,0,0,0,0,0,1,0,0,1,1
10273,184170,zx92A3etlZOmjWi19IMDYlwaWCkvF08z,bWdj2GDclj5ofokWjzoa5jAwMkxCykd6,3,2,0,0,0,0,2,0,4,0.5714285714285714,1,0.0,0,0,0,0,2,0,0,2,0,0,4,0
10274,184180,w0NgQbkpBdIfJsaBSOoX4c1UgwA7dN8N,RXDvfPUBYFlVdlueBFbLW0mhhAyGEqpt,11,5,5,0,4,1,4,2,21,3.0,1,0.0,0,5,0,4,5,1,0,4,2,9,12,1
10275,184182,7EvTIqysZmn3AonROhXlIbdOubKSMiWg,G8EPVSXsOYB5YQWZGiz1aVq5Pgr2GrQu,5,2,1,0,1,0,2,0,6,0.8571428571428571,1,0.0,0,1,0,1,2,0,0,2,0,2,4,1
10276,184183,i39wrwOFUT4cBFVx9tMMQ3lQ2qJwZK9W,bWdj2GDclj5ofokWjzoa5jAwMkxCykd6,11,9,4,38,2,2,4,1,60,8.571428571428571,1,0.0,1,4,35,2,8,2,3,4,1,42,18,1
10277,184189,wTZQy1XFMokTUfJmtWSLn3pA2hHc02jP,G8EPVSXsOYB5YQWZGiz1aVq5Pgr2GrQu,13,13,7,0,1,0,15,1,37,5.285714285714286,1,0.0,0,7,0,1,13,0,0,15,1,8,29,1
10278,184192,t5YYcIeNMVb3RFW5w6rNVr5dnA806rKL,SpATywNh6bZuzm8s1ceuBUnMUAeoAHHw,7,4,3,0,3,8,3,0,21,3.0,1,0.0,0,3,0,3,4,8,0,3,0,6,15,1
10279,184195,pumsIIBvkIDHPLuElv7OSuQxwiyrjr12,bWdj2GDclj5ofokWjzoa5jAwMkxCykd6,4,4,1,0,1,0,1,0,7,1.0,1,0.0,1,1,0,1,3,0,0,1,0,3,4,1
10280,184201,AFZF0g5bqQh2xcoSPcZTvnmo1YmyGZbs,bWdj2GDclj5ofokWjzoa5jAwMkxCykd6,6,5,2,0,2,0,3,0,12,1.7142857142857142,2,0.0,0,2,0,2,5,0,0,3,0,4,8,1
10281,184202,XAN5G2SZeU8Zht7MvC5iqTKg1rYC9VmO,G8EPVSXsOYB5YQWZGiz1aVq5Pgr2GrQu,5,7,0,2,1,0,2,0,12,1.7142857142857142,1,0.0,5,0,1,1,2,0,1,2,0,7,5,1
10282,184203,cCvHnoX6St5OTmXQ2AOInGyMnqlmS6DL,bWdj2GDclj5ofokWjzoa5jAwMkxCykd6,5,2,1,0,1,0,4,0,8,1.1428571428571428,1,0.0,0,1,0,1,2,0,0,4,0,2,6,1
10283,184207,CR6hbwvXPZHEYYcI4AAX4civM4Pp6Aex,SpATywNh6bZuzm8s1ceuBUnMUAeoAHHw,5,2,1,0,1,0,2,0,6,0.8571428571428571,1,0.0,0,1,0,1,2,0,0,2,0,2,4,1
10284,184209,H3w465L7hDzZfQglT7xQ9IAtKqV2E37U,bWdj2GDclj5ofokWjzoa5jAwMkxCykd6,1,0,0,0,0,0,1,0,1,0.14285714285714285,1,0.0,0,0,0,0,0,0,0,1,0,0,1,1
10285,185697,sZk8u46TtWwCnXAO1CfZDLpjuO4MvayN,SpATywNh6bZuzm8s1ceuBUnMUAeoAHHw,1,0,0,0,0,0,1,0,1,0.14285714285714285,1,0.0,0,0,0,0,0,0,0,1,0,0,1,1
10286,185699,iHtSvehLiNBG0wCDW2WxQ7UVFKpHQkCr,G8EPVSXsOYB5YQWZGiz1aVq5Pgr2GrQu,7,2,0,0,1,0,5,1,9,1.2857142857142858,2,0.0,0,0,0,1,2,0,0,5,1,1,8,1
10287,185701,V02ryEmMmqjGIIiLHIkYu0vvVMLeyKKP,SpATywNh6bZuzm8s1ceuBUnMUAeoAHHw,4,2,0,0,0,0,2,0,4,0.5714285714285714,1,0.0,0,0,0,0,2,0,0,2,0,0,4,1
10288,185711,uhhlffPGiUyqHwKWs4eYUM0KXbbqijwF,bWdj2GDclj5ofokWjzoa5jAwMkxCykd6,5,2,1,0,1,0,3,0,7,1.0,1,0.0,0,1,0,1,2,0,0,3,0,2,5,1
10289,185712,cqvPqhuUpY41CAAgpjP0jUqubyRnUma9,A3fsA9Zfv1X2fVEQhTw51lKENdNrEqT3,12,10,0,10,0,0,4,0,24,3.4285714285714284,1,0.0,0,0,9,0,10,0,1,4,0,9,15,1
10290,185717,xMPYVkKLJasLVs71q8GhDTIiypmAhLbm,bWdj2GDclj5ofokWjzoa5jAwMkxCykd6,4,2,0,0,0,0,2,0,4,0.5714285714285714,1,0.0,0,0,0,0,2,0,0,2,0,0,4,1
10291,185719,DedOVhQ90meYxq6Misau3AEJ23SFBM8N,SpATywNh6bZuzm8s1ceuBUnMUAeoAHHw,3,0,0,0,0,0,3,1,4,0.5714285714285714,1,0.0,0,0,0,0,0,0,0,3,1,0,4,1
10292,185720,pnqwjatzPNd5f8exo5KMAGnQXVJnxQke,bWdj2GDclj5ofokWjzoa5jAwMkxCykd6,1,0,0,0,0,0,1,0,1,0.14285714285714285,1,0.0,0,0,0,0,0,0,0,1,0,0,1,1
10293,185721,9SQvvdARLUcjeNs1HN0rEVcQQDFBRIFU,SpATywNh6bZuzm8s1ceuBUnMUAeoAHHw,13,20,8,22,5,0,6,0,61,8.714285714285714,4,0.0,4,8,18,5,16,0,4,6,0,35,26,0
10294,185735,IO3o6QwloFvMHM9ifw0qIeLDZXWrcK99,G8EPVSXsOYB5YQWZGiz1aVq5Pgr2GrQu,11,25,7,2,4,0,6,0,44,6.285714285714286,1,0.0,7,7,2,4,18,0,0,6,0,20,24,1
10295,185740,alnogGpZqhBWQHh6ZLeZUIXk896ksLOu,A3fsA9Zfv1X2fVEQhTw51lKENdNrEqT3,8,13,1,0,0,0,8,2,24,3.4285714285714284,1,0.0,0,1,0,0,13,0,0,8,2,1,23,1
10296,185749,4iA1ycKJBUtgZZkZgkIUFUIpxxqEAlGx,bWdj2GDclj5ofokWjzoa5jAwMkxCykd6,2,0,0,0,0,0,2,0,2,0.2857142857142857,1,0.0,0,0,0,0,0,0,0,2,0,0,2,1
10297,185751,MbewcgzgToNhp9B6eaNSolme5R0M2nkY,SpATywNh6bZuzm8s1ceuBUnMUAeoAHHw,13,17,1,10,0,0,4,0,32,4.571428571428571,1,0.0,5,1,9,0,12,0,1,4,0,15,17,1
10298,185762,wi94HT3Va3Hif8CpMS1WVbL5a71j9CMb,A3fsA9Zfv1X2fVEQhTw51lKENdNrEqT3,23,3,2,84,0,0,4,0,93,13.285714285714286,1,0.0,1,2,65,0,2,0,19,4,0,68,25,1
10299,185773,VDLlgOqW7FFpT6uHqFXXlnnZR1JOz0x8,SpATywNh6bZuzm8s1ceuBUnMUAeoAHHw,2,0,0,0,0,0,2,0,2,0.2857142857142857,1,0.0,0,0,0,0,0,0,0,2,0,0,2,1
10300,185778,oIHEiOwjcaMd5CeWZdkq4rXU3yelDWwT,A3fsA9Zfv1X2fVEQhTw51lKENdNrEqT3,40,25,13,50,11,0,10,0,109,15.571428571428571,1,0.0,1,13,50,11,24,0,0,10,0,75,34,1
10301,185781,b247UYxQmorWoByqHaWMP4yZ1NRODrQz,SpATywNh6bZuzm8s1ceuBUnMUAeoAHHw,8,4,0,0,0,0,6,1,11,1.5714285714285714,1,0.0,0,0,0,0,4,0,0,6,1,0,11,1
10302,185783,XLVBkGRL2w5Wpk8oB8gzWVUvCGz9Rhlw,SpATywNh6bZuzm8s1ceuBUnMUAeoAHHw,1,0,0,0,0,0,1,0,1,0.14285714285714285,1,0.0,0,0,0,0,0,0,0,1,0,0,1,1
10303,185788,ggqCYexsMA3gqHfUfLE6gTs4JZ2aYAma,G8EPVSXsOYB5YQWZGiz1aVq5Pgr2GrQu,5,2,1,0,1,2,2,0,8,1.1428571428571428,1,0.0,0,1,0,1,2,2,0,2,0,2,6,1
10304,185789,KsZJWOsbWvg6N1GJmMWPndE2481JZ5k3,A3fsA9Zfv1X2fVEQhTw51lKENdNrEqT3,12,9,3,0,2,1,8,0,23,3.2857142857142856,1,0.0,0,3,0,2,9,1,0,8,0,5,18,1
10305,185799,5vZRuON34JUuUxkGF08Mu94iTiQzZas4,A3fsA9Zfv1X2fVEQhTw51lKENdNrEqT3,14,11,7,0,4,0,5,0,27,3.857142857142857,2,0.0,0,7,0,4,11,0,0,5,0,11,16,1
10306,185800,UiNc6Olm5OJvjLtbHiGutXVBHbKcOCGc,G8EPVSXsOYB5YQWZGiz1aVq5Pgr2GrQu,9,5,2,0,2,0,4,1,14,2.0,1,0.0,0,2,0,2,5,0,0,4,1,4,10,1
10307,185802,OuF01YeNHtVi6Jk1MFlWzs0i66xxscb1,bWdj2GDclj5ofokWjzoa5jAwMkxCykd6,4,2,0,0,0,0,3,0,5,0.7142857142857143,1,0.0,0,0,0,0,2,0,0,3,0,0,5,1
10308,185803,p54dVByd9epbS397rAmrAwTW19iwa3UI,A3fsA9Zfv1X2fVEQhTw51lKENdNrEqT3,2,0,0,0,0,0,2,0,2,0.2857142857142857,2,0.0,0,0,0,0,0,0,0,2,0,0,2,1
10309,185805,ggqCYexsMA3gqHfUfLE6gTs4JZ2aYAma,A3fsA9Zfv1X2fVEQhTw51lKENdNrEqT3,1,0,0,0,0,0,1,0,1,0.14285714285714285,1,0.0,0,0,0,0,0,0,0,1,0,0,1,1
10310,185808,ggqCYexsMA3gqHfUfLE6gTs4JZ2aYAma,RXDvfPUBYFlVdlueBFbLW0mhhAyGEqpt,1,0,0,0,0,0,1,0,1,0.14285714285714285,1,0.0,0,0,0,0,0,0,0,1,0,0,1,1
10311,185810,ggqCYexsMA3gqHfUfLE6gTs4JZ2aYAma,bWdj2GDclj5ofokWjzoa5jAwMkxCykd6,1,0,0,0,0,0,1,0,1,0.14285714285714285,1,0.0,0,0,0,0,0,0,0,1,0,0,1,1
10312,185816,lMDmp2qNyRczEhhMTcMnsuhXMIgG5u4z,SpATywNh6bZuzm8s1ceuBUnMUAeoAHHw,8,5,2,0,2,0,4,0,13,1.8571428571428572,1,0.0,0,2,0,2,5,0,0,4,0,4,9,1
10313,185822,xr2T8ak6swOOfU9oanYvPbQ4STab9s9f,A3fsA9Zfv1X2fVEQhTw51lKENdNrEqT3,16,16,1,0,1,0,7,0,25,3.5714285714285716,2,0.0,0,1,0,1,16,0,0,7,0,2,23,1
10314,185827,BiROhpVKZVE8DbOW78DzcMxwLwnrk2vP,SpATywNh6bZuzm8s1ceuBUnMUAeoAHHw,4,2,0,0,0,0,2,0,4,0.5714285714285714,1,0.0,0,0,0,0,2,0,0,2,0,0,4,1
10315,185865,KqT70GlMbxQHBXiXc69IrkuqKmM7JyJa,A3fsA9Zfv1X2fVEQhTw51lKENdNrEqT3,1,0,0,0,0,0,1,0,1,0.14285714285714285,1,0.0,0,0,0,0,0,0,0,1,0,0,1,1
10316,185873,fjIKsKO6rizBomnPFn2db56S1nui3RlN,RXDvfPUBYFlVdlueBFbLW0mhhAyGEqpt,10,7,5,0,3,4,5,0,24,3.4285714285714284,1,0.0,1,5,0,3,6,4,0,5,0,9,15,1
10317,185875,a7oEKWybXixFIxItLioFkgXev62XcPSx,SpATywNh6bZuzm8s1ceuBUnMUAeoAHHw,7,3,2,0,2,0,2,0,9,1.2857142857142858,1,0.0,0,2,0,2,3,0,0,2,0,4,5,1
10318,185876,BCr2GOpOyeEKOuzlRV7PJCL1CEnRyr6Q,bWdj2GDclj5ofokWjzoa5jAwMkxCykd6,1,0,0,0,0,0,1,0,1,0.14285714285714285,1,0.0,0,0,0,0,0,0,0,1,0,0,1,1
10319,185888,GHTsld2FtHJjs2ejBig6RPBMNqBTieZV,G8EPVSXsOYB5YQWZGiz1aVq5Pgr2GrQu,1,0,0,0,0,0,1,0,1,0.14285714285714285,1,0.0,0,0,0,0,0,0,0,1,0,0,1,1
10320,185899,HXRY1mkagv1TklYNb6z2U5DQSLEv5d2U,bWdj2GDclj5ofokWjzoa5jAwMkxCykd6,3,2,0,0,0,0,2,0,4,0.5714285714285714,1,0.0,0,0,0,0,2,0,0,2,0,0,4,1
10321,185912,l6rkobnqEUKXFQnaBVgonlwU5l25TkcG,SpATywNh6bZuzm8s1ceuBUnMUAeoAHHw,7,4,3,0,3,0,3,0,13,1.8571428571428572,1,0.0,0,3,0,3,4,0,0,3,0,6,7,1
10322,185917,qU5mfkjhD9M0R49RmBMaCeXLeTqIOyhm,bWdj2GDclj5ofokWjzoa5jAwMkxCykd6,7,8,1,0,0,1,7,2,19,2.7142857142857144,1,0.0,0,1,0,0,8,1,0,7,2,1,18,1
10323,185926,BFrfDseDfXCBvtTfCsJAy36Ogk6b0Rfx,bWdj2GDclj5ofokWjzoa5jAwMkxCykd6,6,5,2,0,2,0,1,0,10,1.4285714285714286,1,0.0,0,2,0,2,5,0,0,1,0,4,6,1
10324,185934,YisM8PtG7Ux1VoDWsMxvoOKtYDxnQIkB,SpATywNh6bZuzm8s1ceuBUnMUAeoAHHw,6,4,1,0,0,0,2,0,7,1.0,1,0.0,0,1,0,0,4,0,0,2,0,1,6,0
10325,185935,g3k1QLHPwEzAuA17RgcYJkFPtaOb0o3B,SpATywNh6bZuzm8s1ceuBUnMUAeoAHHw,6,3,1,0,1,0,2,0,7,1.0,1,0.0,0,1,0,1,3,0,0,2,0,2,5,1
10326,185940,JpOYg97nyPxwnn3z2vFN1FK1LYz5DhTY,A3fsA9Zfv1X2fVEQhTw51lKENdNrEqT3,6,2,1,0,1,0,3,0,7,1.0,1,0.0,0,1,0,1,2,0,0,3,0,2,5,1
10327,185947,ztsQNM9uMd9SZEOM5x5YQ0KVKbbr5L7g,SpATywNh6bZuzm8s1ceuBUnMUAeoAHHw,5,2,1,0,1,0,2,0,6,0.8571428571428571,1,0.0,0,1,0,1,2,0,0,2,0,2,4,1
10328,185967,pyMEb6x72KY9mgbYMOoJOte9pQweaRy0,A3fsA9Zfv1X2fVEQhTw51lKENdNrEqT3,4,2,0,0,0,0,2,0,4,0.5714285714285714,1,0.0,0,0,0,0,2,0,0,2,0,0,4,1
10329,185977,q3IBH9ErSFzy7COPLzEQoKQuyHgNCnZt,SpATywNh6bZuzm8s1ceuBUnMUAeoAHHw,4,2,1,0,1,0,2,0,6,0.8571428571428571,1,0.0,0,1,0,1,2,0,0,2,0,2,4,1
10330,185981,9GkiQywusvhD7mWAdJSKQKuF3YnhYHyY,SpATywNh6bZuzm8s1ceuBUnMUAeoAHHw,4,4,0,0,0,0,3,0,7,1.0,1,0.0,0,0,0,0,4,0,0,3,0,0,7,1
10331,185989,HHr7pweQNhEg4xRoOlqDUkqUpKwnfVTC,bWdj2GDclj5ofokWjzoa5jAwMkxCykd6,4,2,1,0,1,0,1,0,5,0.7142857142857143,1,0.0,0,1,0,1,2,0,0,1,0,2,3,1
10332,185993,4lIBX7jVNURqeuVw7y54KWNhg5lYseZ6,A3fsA9Zfv1X2fVEQhTw51lKENdNrEqT3,16,15,10,0,0,6,9,0,40,5.714285714285714,1,0.0,0,10,0,0,15,6,0,9,0,10,30,1
10333,185996,rqLYGFT8OdZ1rVwTL6aA81jhg4BwFBcq,SpATywNh6bZuzm8s1ceuBUnMUAeoAHHw,11,26,15,4,8,7,5,0,65,9.285714285714286,3,0.0,4,15,4,8,22,7,0,5,0,31,34,1
10334,186008,OQ7W8hYEVefBsrV36TMIjyhMvo7kqJ6U,bWdj2GDclj5ofokWjzoa5jAwMkxCykd6,1,0,0,0,0,0,1,0,1,0.14285714285714285,1,0.0,0,0,0,0,0,0,0,1,0,0,1,1
10335,186010,pwdsR2guw7jGBDVAdaksGODr7uJoy6bJ,A3fsA9Zfv1X2fVEQhTw51lKENdNrEqT3,13,5,4,0,4,21,8,1,43,6.142857142857143,1,0.0,0,4,0,4,5,21,0,8,1,8,35,1
10336,186017,3kmVKNRbGOm4fMFsW3dgnHkHEGKHE1G0,SpATywNh6bZuzm8s1ceuBUnMUAeoAHHw,1,0,0,0,0,0,1,0,1,0.14285714285714285,1,0.0,0,0,0,0,0,0,0,1,0,0,1,1
10337,186024,mshtCxMsmXSptJoESXKNMH3UVCFV33v0,bWdj2GDclj5ofokWjzoa5jAwMkxCykd6,7,6,2,0,1,0,5,0,14,2.0,1,0.0,0,2,0,1,6,0,0,5,0,3,11,1
10338,186027,eGRaiLXqwboqQlaTTQYr1FB1cM61jV4I,bWdj2GDclj5ofokWjzoa5jAwMkxCykd6,16,38,8,80,5,0,10,0,141,20.142857142857142,3,0.0,9,8,73,5,29,0,7,10,0,95,46,0
10339,186030,WgIzAwP7DckFZQVcLeYgUBCqWImeGyjc,bWdj2GDclj5ofokWjzoa5jAwMkxCykd6,1,0,0,0,0,0,1,0,1,0.14285714285714285,1,0.0,0,0,0,0,0,0,0,1,0,0,1,1
10340,186033,oBeAGLSBA1xupWifcihdC6keBG4wuecB,SpATywNh6bZuzm8s1ceuBUnMUAeoAHHw,12,14,6,0,4,0,5,5,34,4.857142857142857,1,0.0,6,6,0,4,8,0,0,5,5,16,18,1
10341,186034,VKd5p4d9iO6xk39JhIOj5DwKdihmd0lg,SpATywNh6bZuzm8s1ceuBUnMUAeoAHHw,1,0,0,0,0,0,2,0,2,0.2857142857142857,1,0.0,0,0,0,0,0,0,0,2,0,0,2,1
10342,186053,pwdsR2guw7jGBDVAdaksGODr7uJoy6bJ,G8EPVSXsOYB5YQWZGiz1aVq5Pgr2GrQu,1,0,0,0,0,0,1,0,1,0.14285714285714285,1,0.0,0,0,0,0,0,0,0,1,0,0,1,1
10343,186054,pwdsR2guw7jGBDVAdaksGODr7uJoy6bJ,RXDvfPUBYFlVdlueBFbLW0mhhAyGEqpt,1,0,0,0,0,0,1,0,1,0.14285714285714285,1,0.0,0,0,0,0,0,0,0,1,0,0,1,1
10344,186069,1Qo7KMYcvZsuiBzdvEuPj5kKA7qUbqJV,bWdj2GDclj5ofokWjzoa5jAwMkxCykd6,1,0,0,0,0,0,1,0,1,0.14285714285714285,1,0.0,0,0,0,0,0,0,0,1,0,0,1,1
10345,186070,TCINPpi4BOwqMGx315JhuBgHLWH5YLIC,SpATywNh6bZuzm8s1ceuBUnMUAeoAHHw,11,11,5,0,4,0,3,0,23,3.2857142857142856,1,0.0,0,5,0,4,11,0,0,3,0,9,14,1
10346,186080,k1v3XdotdB8LdO3icpee6tW4PUfHmiil,SpATywNh6bZuzm8s1ceuBUnMUAeoAHHw,1,0,0,0,0,0,1,0,1,0.14285714285714285,1,0.0,0,0,0,0,0,0,0,1,0,0,1,1
10347,186090,RKevUFoWjA4gBXEFiCKb5AP4PJvgxsMD,SpATywNh6bZuzm8s1ceuBUnMUAeoAHHw,7,21,4,0,0,1,2,2,30,4.285714285714286,1,0.0,15,4,0,0,6,1,0,2,2,19,11,1
10348,186093,4RiemE5r88jWq9gaL0lVYzjeUhWq3sNP,bWdj2GDclj5ofokWjzoa5jAwMkxCykd6,5,2,1,0,1,0,2,0,6,0.8571428571428571,1,0.0,0,1,0,1,2,0,0,2,0,2,4,1
10349,186105,H7QRgEunakiQpSkvgA6e0kPLJYMsizvQ,RXDvfPUBYFlVdlueBFbLW0mhhAyGEqpt,20,12,6,20,5,1,4,2,50,7.142857142857143,1,0.0,4,6,17,5,8,1,3,4,2,32,18,1
10350,186108,movFtkKyZ7KF2alge61BByZFH1juXwvn,G8EPVSXsOYB5YQWZGiz1aVq5Pgr2GrQu,6,20,5,0,5,0,3,0,33,4.714285714285714,1,0.0,6,5,0,5,14,0,0,3,0,16,17,0
10351,186126,v7J9oMmutdLnNr3JZvwlkpjW9LXfiVjj,bWdj2GDclj5ofokWjzoa5jAwMkxCykd6,1,0,0,0,0,0,3,0,3,0.42857142857142855,1,0.0,0,0,0,0,0,0,0,3,0,0,3,1
10352,186149,3RleWWZim0t3JTvkySadKrLWZcHXfb0j,SpATywNh6bZuzm8s1ceuBUnMUAeoAHHw,5,2,1,0,1,1,2,0,7,1.0,1,0.0,0,1,0,1,2,1,0,2,0,2,5,1
10353,186152,U7gTTHbgIV4F5dvLWAHaZprd34m8Q6vZ,A3fsA9Zfv1X2fVEQhTw51lKENdNrEqT3,2,0,0,0,0,0,3,0,3,0.42857142857142855,1,0.0,0,0,0,0,0,0,0,3,0,0,3,1
10354,186160,76AvlH3YIWFXw8S2TlpvkGfhwLRoEd9v,G8EPVSXsOYB5YQWZGiz1aVq5Pgr2GrQu,1,0,0,0,0,0,1,0,1,0.14285714285714285,1,0.0,0,0,0,0,0,0,0,1,0,0,1,1
10355,186167,vmgNze76nhe4Mg9lRleNqfB4tioADZEi,SpATywNh6bZuzm8s1ceuBUnMUAeoAHHw,5,2,1,0,1,0,2,0,6,0.8571428571428571,1,0.0,0,1,0,1,2,0,0,2,0,2,4,1
10356,186172,eC7mMb2gTYoACNwQi5SJ70EXu79ikkpz,G8EPVSXsOYB5YQWZGiz1aVq5Pgr2GrQu,15,26,2,16,2,1,11,1,59,8.428571428571429,2,0.0,4,2,12,2,22,1,4,11,1,20,39,0
10357,186188,7I0I1azNl6RTMt3ii9CU0GnkhQk3GlzK,bWdj2GDclj5ofokWjzoa5jAwMkxCykd6,4,2,1,0,1,0,1,0,5,0.7142857142857143,1,0.0,0,1,0,1,2,0,0,1,0,2,3,1
10358,186217,joApt9vAdh8Ppf8VaTUE5PED1Gnaa6Cg,SpATywNh6bZuzm8s1ceuBUnMUAeoAHHw,9,6,3,0,1,0,6,0,16,2.2857142857142856,2,0.0,2,3,0,1,4,0,0,6,0,6,10,1
10359,186219,9hgjLw4OD5u1XjZx0s9EMRnEguVXBlYy,bWdj2GDclj5ofokWjzoa5jAwMkxCykd6,5,3,2,0,1,0,1,0,7,1.0,1,0.0,0,2,0,1,3,0,0,1,0,3,4,1
10360,186226,NJMgv4F05c0UQYudEdfqMGLsHyyDDfGS,bWdj2GDclj5ofokWjzoa5jAwMkxCykd6,1,0,0,0,0,0,1,0,1,0.14285714285714285,1,0.0,0,0,0,0,0,0,0,1,0,0,1,1
10361,186239,6LXzBe3NOudMerEzgOt0MkAbIrREFpjB,SpATywNh6bZuzm8s1ceuBUnMUAeoAHHw,6,2,1,0,1,0,8,0,12,1.7142857142857142,1,0.0,0,1,0,1,2,0,0,8,0,2,10,1
10362,186260,CYN3tl2d8PV3r7FRKTn3DmaQTLhkh777,bWdj2GDclj5ofokWjzoa5jAwMkxCykd6,4,4,0,0,0,0,4,0,8,1.1428571428571428,1,0.0,0,0,0,0,4,0,0,4,0,0,8,1
10363,186262,qtck8S6SMYpkxbIZosuQoFSB26vuEbBy,SpATywNh6bZuzm8s1ceuBUnMUAeoAHHw,12,13,6,0,2,2,6,1,30,4.285714285714286,1,0.0,5,6,0,2,8,2,0,6,1,13,17,1
10364,186265,O54CNBN3NKMMQYcBy9CQbkmesf27d5tK,bWdj2GDclj5ofokWjzoa5jAwMkxCykd6,8,7,3,0,4,0,1,0,15,2.142857142857143,1,0.0,3,3,0,4,4,0,0,1,0,10,5,1
10365,186274,UjdXV2LbbZ78dbdYSbQt8OX1VfVSyWoG,RXDvfPUBYFlVdlueBFbLW0mhhAyGEqpt,1,0,0,0,0,0,1,0,1,0.14285714285714285,1,0.0,0,0,0,0,0,0,0,1,0,0,1,1
10366,186278,tRniyBbP3M0j7k24AHpOwHltcVZ3Mvlp,G8EPVSXsOYB5YQWZGiz1aVq5Pgr2GrQu,19,7,6,10,4,4,12,1,44,6.285714285714286,1,0.0,0,6,9,4,7,4,1,12,1,19,25,1
10367,186282,NbCrL52EtsGx8vVNfWSZpmpE4q33iGMd,bWdj2GDclj5ofokWjzoa5jAwMkxCykd6,1,0,0,0,0,0,1,0,1,0.14285714285714285,1,0.0,0,0,0,0,0,0,0,1,0,0,1,1
10368,186293,dN9FTYZkbDCdtR1BnEY22uyGdtBZPVhu,bWdj2GDclj5ofokWjzoa5jAwMkxCykd6,13,12,7,20,4,0,2,0,45,6.428571428571429,2,0.0,2,7,17,4,10,0,3,2,0,30,15,1
10369,186296,B72h1YINVnIBuQnVvUdewAz5RbHuw445,SpATywNh6bZuzm8s1ceuBUnMUAeoAHHw,7,10,1,0,0,0,5,0,16,2.2857142857142856,1,0.0,0,1,0,0,10,0,0,5,0,1,15,1
10370,186306,4i4PHyTAjN8h3LruWdRgGB0UcB2mKwQS,G8EPVSXsOYB5YQWZGiz1aVq5Pgr2GrQu,7,5,4,0,4,0,2,0,15,2.142857142857143,1,0.0,0,4,0,4,5,0,0,2,0,8,7,1
10371,186307,LDAJhM2EkTXhEhkZMewkMv22tm6tjZRZ,G8EPVSXsOYB5YQWZGiz1aVq5Pgr2GrQu,11,17,7,0,0,1,9,1,35,5.0,1,0.0,6,7,0,0,11,1,0,9,1,13,22,1
10372,186310,oiCPMPa63rog2k5BPZRkJCoJXfrcSy1e,SpATywNh6bZuzm8s1ceuBUnMUAeoAHHw,11,8,5,0,3,0,5,2,23,3.2857142857142856,1,0.0,1,5,0,3,7,0,0,5,2,9,14,1
10373,186315,8UDPY0GORYpQM3S1dtt5YkG0CDkJUfAi,G8EPVSXsOYB5YQWZGiz1aVq5Pgr2GrQu,1,0,0,0,0,0,1,0,1,0.14285714285714285,1,0.0,0,0,0,0,0,0,0,1,0,0,1,1
10374,186316,JKjbqPpgyVuFohWzcaEzU3vXeEuQMCY2,SpATywNh6bZuzm8s1ceuBUnMUAeoAHHw,6,6,2,0,1,0,3,0,12,1.7142857142857142,1,0.0,4,2,0,1,2,0,0,3,0,7,5,1
10375,186326,oXcCXnNaPGvzw5MpNzQ49lDnTqlhdcyO,RXDvfPUBYFlVdlueBFbLW0mhhAyGEqpt,6,4,3,0,2,0,2,0,11,1.5714285714285714,1,0.0,0,3,0,2,4,0,0,2,0,5,6,1
10376,186327,5YRs7upinP21LnBzrkpoBo8Kvhb3lSkQ,SpATywNh6bZuzm8s1ceuBUnMUAeoAHHw,9,14,9,0,7,0,9,0,39,5.571428571428571,1,0.0,2,9,0,7,12,0,0,9,0,18,21,1
10377,186343,hNSGUbGCRW7qjA1g49kHgu4SIBbwJo9q,SpATywNh6bZuzm8s1ceuBUnMUAeoAHHw,9,5,4,0,4,0,2,0,15,2.142857142857143,1,0.0,0,4,0,4,5,0,0,2,0,8,7,1
10378,186346,0tNPU3kkt3CooZ4NeVBPjpcYXq8dTU8q,SpATywNh6bZuzm8s1ceuBUnMUAeoAHHw,5,2,1,0,1,0,3,0,7,1.0,1,0.0,0,1,0,1,2,0,0,3,0,2,5,1
10379,186361,ia27UAQHt7F9XiRQIIX7AOZPA1Z4gISX,G8EPVSXsOYB5YQWZGiz1aVq5Pgr2GrQu,24,16,12,0,13,0,14,4,59,8.428571428571429,1,0.0,3,12,0,13,13,0,0,14,4,28,31,1
10380,186368,ihKJAzCpK1sJmaODICQLggyYKl8s1XF0,A3fsA9Zfv1X2fVEQhTw51lKENdNrEqT3,2,0,0,0,0,0,4,0,4,0.5714285714285714,1,0.0,0,0,0,0,0,0,0,4,0,0,4,1
10381,186369,trBO4BEJIC9uXexHjtiN83f66AEsM41a,RXDvfPUBYFlVdlueBFbLW0mhhAyGEqpt,7,3,2,0,2,0,2,0,9,1.2857142857142858,1,0.0,0,2,0,2,3,0,0,2,0,4,5,1
10382,186372,4lhCwJo7yYXKFlssNpVO8DZHuYKFBvLp,bWdj2GDclj5ofokWjzoa5jAwMkxCykd6,5,2,1,0,1,0,2,0,6,0.8571428571428571,1,0.0,0,1,0,1,2,0,0,2,0,2,4,1
10383,186376,61PsrnqGMh19xjWowe2Lz8ELqYCTUUqE,A3fsA9Zfv1X2fVEQhTw51lKENdNrEqT3,6,5,2,0,1,0,3,0,11,1.5714285714285714,1,0.0,0,2,0,1,5,0,0,3,0,3,8,1
10384,186385,TREm1kp17GnbcApEfZDyA7Kp4fSLmJio,SpATywNh6bZuzm8s1ceuBUnMUAeoAHHw,2,0,0,0,0,0,3,0,3,0.42857142857142855,1,0.0,0,0,0,0,0,0,0,3,0,0,3,1
10385,186390,AeCrxYByugIwu4XUBpI0LhoTguBozLAa,G8EPVSXsOYB5YQWZGiz1aVq5Pgr2GrQu,26,28,6,66,4,0,3,0,107,15.285714285714286,1,0.0,16,6,48,4,12,0,18,3,0,74,33,1
10386,186417,gLeI9VliEYF371soyxZF0epS12DLfvFA,SpATywNh6bZuzm8s1ceuBUnMUAeoAHHw,10,14,1,12,0,0,1,0,28,4.0,1,0.0,6,1,11,0,8,0,1,1,0,18,10,0
10387,186425,Vgv9Vbo4BqJtU7GBUbwfi1DvG0Q1nDxJ,A3fsA9Zfv1X2fVEQhTw51lKENdNrEqT3,6,3,2,0,1,0,2,0,8,1.1428571428571428,1,0.0,0,2,0,1,3,0,0,2,0,3,5,1
10388,186430,s5UknTeAXWW62hajP9UwOYzwqzInPkkx,SpATywNh6bZuzm8s1ceuBUnMUAeoAHHw,7,2,1,0,1,0,4,0,8,1.1428571428571428,1,0.0,0,1,0,1,2,0,0,4,0,2,6,1
10389,186455,ocTIjxG8zBs0mQRpUtpuAKc7MDpzU7Sd,A3fsA9Zfv1X2fVEQhTw51lKENdNrEqT3,7,4,2,0,1,32,10,0,49,7.0,3,0.0,0,2,0,1,4,32,0,10,0,3,46,0
10390,186465,qJgl58YR6SFE9WBZ5w9d3OO6sin62mbS,G8EPVSXsOYB5YQWZGiz1aVq5Pgr2GrQu,5,2,1,0,1,0,2,0,6,0.8571428571428571,1,0.0,0,1,0,1,2,0,0,2,0,2,4,1
10391,186482,xTif7TWTzpmMlOz25LEjdVnoxKR0Djir,bWdj2GDclj5ofokWjzoa5jAwMkxCykd6,1,0,0,0,0,0,1,0,1,0.14285714285714285,1,0.0,0,0,0,0,0,0,0,1,0,0,1,1
10392,186507,Ws3AQXJqw3VTjixWLsavB7mzhprdidTH,G8EPVSXsOYB5YQWZGiz1aVq5Pgr2GrQu,4,2,1,0,1,0,1,0,5,0.7142857142857143,1,0.0,0,1,0,1,2,0,0,1,0,2,3,1
10393,186513,bieYN909hTRWSvc3EaZDiQYQdygsSUNW,SpATywNh6bZuzm8s1ceuBUnMUAeoAHHw,7,6,3,0,3,0,3,0,15,2.142857142857143,1,0.0,0,3,0,3,6,0,0,3,0,6,9,1
10394,186514,bYD2u7vuN3G54awyDYPdRiZI3O4zw6kx,A3fsA9Zfv1X2fVEQhTw51lKENdNrEqT3,9,7,4,0,2,4,5,0,22,3.142857142857143,2,0.0,1,4,0,2,6,4,0,5,0,7,15,1
10395,186522,xe3aQO2zOncGcTg3GZj4Ju1vwkPuneGt,A3fsA9Zfv1X2fVEQhTw51lKENdNrEqT3,26,21,16,6,11,2,7,1,64,9.142857142857142,2,0.0,0,16,5,11,21,2,1,7,1,32,32,1
10396,186541,k9uZHzVbTw2SpPQ5TgMY9urRyaKHQ7D1,SpATywNh6bZuzm8s1ceuBUnMUAeoAHHw,11,10,0,3,0,0,5,0,18,2.5714285714285716,1,0.0,5,0,3,0,5,0,0,5,0,8,10,1
10397,186552,fiJeUe4rD7XOpUxN73ysB6UZAqbfZlmt,SpATywNh6bZuzm8s1ceuBUnMUAeoAHHw,8,2,2,0,2,0,3,0,9,1.2857142857142858,1,0.0,0,2,0,2,2,0,0,3,0,4,5,1
10398,186565,7ho1Tg0rPKs5S3R4MH5byApVMAoQWEXh,RXDvfPUBYFlVdlueBFbLW0mhhAyGEqpt,10,4,3,0,2,12,10,5,36,5.142857142857143,1,0.0,0,3,0,2,4,12,0,10,5,5,31,1
10399,186574,2hFnq94PJL4XDwPjj8ZoE3JMQah41FEA,SpATywNh6bZuzm8s1ceuBUnMUAeoAHHw,5,3,2,0,1,0,2,0,8,1.1428571428571428,2,0.0,0,2,0,1,3,0,0,2,0,3,5,1
10400,186576,dCkOxG7NzEIrFHNAIlnaKMlesPlFB6No,bWdj2GDclj5ofokWjzoa5jAwMkxCykd6,3,0,0,0,0,1,3,0,4,0.5714285714285714,1,0.0,0,0,0,0,0,1,0,3,0,0,4,1
10401,186587,rBTUDXHsyVAHRzecZ0JrUNZO0FdtzEgU,SpATywNh6bZuzm8s1ceuBUnMUAeoAHHw,12,13,0,11,1,0,3,0,28,4.0,1,0.0,4,0,10,1,9,0,1,3,0,15,13,1
10402,186595,QZIRHdwFgibI2SBehTrmLAZxED1F4JL7,bWdj2GDclj5ofokWjzoa5jAwMkxCykd6,3,3,0,0,0,0,2,0,5,0.7142857142857143,1,0.0,0,0,0,0,3,0,0,2,0,0,5,1
10403,186611,aZ82NGvfiihxQfhlR4uS7n77c1b4mi5Z,G8EPVSXsOYB5YQWZGiz1aVq5Pgr2GrQu,6,4,1,0,1,0,3,0,9,1.2857142857142858,1,0.0,0,1,0,1,4,0,0,3,0,2,7,1
10404,186626,0zEvDhRJYIh90RBOGZBHRBqiMwb7D8PK,SpATywNh6bZuzm8s1ceuBUnMUAeoAHHw,1,0,0,0,0,0,1,0,1,0.14285714285714285,1,0.0,0,0,0,0,0,0,0,1,0,0,1,1
10405,186632,65P7KaQODeqWFWqHnCldB0bW07lJUhzD,A3fsA9Zfv1X2fVEQhTw51lKENdNrEqT3,7,5,3,0,1,0,2,0,11,1.5714285714285714,1,0.0,0,3,0,1,5,0,0,2,0,4,7,1
10406,186643,GOc4kNORXKPP2dp4IaPI0qi7cdZjVMoK,bWdj2GDclj5ofokWjzoa5jAwMkxCykd6,1,0,0,0,0,0,1,0,1,0.14285714285714285,1,0.0,0,0,0,0,0,0,0,1,0,0,1,1
10407,186660,G6IoTlb3c3ZQL96Z5jLVHovz7cxEUWx5,SpATywNh6bZuzm8s1ceuBUnMUAeoAHHw,5,2,1,0,1,0,2,0,6,0.8571428571428571,1,0.0,0,1,0,1,2,0,0,2,0,2,4,1
10408,186668,Q3SCEqfg6AiZK4k6l6uETosmZAruIeRz,bWdj2GDclj5ofokWjzoa5jAwMkxCykd6,5,2,1,0,1,0,2,0,6,0.8571428571428571,1,0.0,0,1,0,1,2,0,0,2,0,2,4,1
10409,186671,fWFaAKdCQbV0w3S48FeXgmzcwLTDxziF,RXDvfPUBYFlVdlueBFbLW0mhhAyGEqpt,2,0,0,0,0,0,2,0,2,0.2857142857142857,1,0.0,0,0,0,0,0,0,0,2,0,0,2,1
10410,186690,C7zqVICfiC5LB2CDdZC77m5k2umUb3cp,SpATywNh6bZuzm8s1ceuBUnMUAeoAHHw,18,27,10,9,4,0,13,1,64,9.142857142857142,2,0.0,11,10,9,4,16,0,0,13,1,34,30,1
10411,186696,XWqfdH6YA4Zk74Kdlw1zAAjKNGLWzY2X,A3fsA9Zfv1X2fVEQhTw51lKENdNrEqT3,5,0,0,0,0,1,4,1,6,0.8571428571428571,1,0.0,0,0,0,0,0,1,0,4,1,0,6,1
10412,186698,cdSk14IbXqFAl31nStZhqBGbvhRNZQDG,A3fsA9Zfv1X2fVEQhTw51lKENdNrEqT3,2,0,0,0,0,0,2,0,2,0.2857142857142857,1,0.0,0,0,0,0,0,0,0,2,0,0,2,1
10413,186710,i8nr5dg8z4enS0u6hepa5rlWzI5t4l3G,SpATywNh6bZuzm8s1ceuBUnMUAeoAHHw,6,6,0,0,0,0,7,0,13,1.8571428571428572,2,0.0,0,0,0,0,6,0,0,7,0,0,13,1
10414,186711,VrzXB04D4NAWNSSnAJBQgbBcugtgsrsf,SpATywNh6bZuzm8s1ceuBUnMUAeoAHHw,5,2,1,0,1,0,3,0,7,1.0,1,0.0,0,1,0,1,2,0,0,3,0,2,5,1
10415,186716,yTPe4A1Cw5qKDjYpFW5H73VItf0UPFbm,A3fsA9Zfv1X2fVEQhTw51lKENdNrEqT3,4,2,1,0,1,0,1,0,5,0.7142857142857143,1,0.0,0,1,0,1,2,0,0,1,0,2,3,1
10416,186723,XO4yOVP7eCwBTi6pYIgtRmMh0ft7YdHb,A3fsA9Zfv1X2fVEQhTw51lKENdNrEqT3,9,12,1,0,1,0,4,0,18,2.5714285714285716,1,0.0,0,1,0,1,12,0,0,4,0,2,16,1
10417,186727,rwCHpAN1sY0GvFYG7zQQk2qpgkOBz9O3,A3fsA9Zfv1X2fVEQhTw51lKENdNrEqT3,1,0,0,0,0,0,1,0,1,0.14285714285714285,1,0.0,0,0,0,0,0,0,0,1,0,0,1,1
10418,186740,ctYjDizjossnFRGdONqI7hfhQiNCx3Il,SpATywNh6bZuzm8s1ceuBUnMUAeoAHHw,5,2,1,0,1,0,2,0,6,0.8571428571428571,1,0.0,0,1,0,1,2,0,0,2,0,2,4,1
10419,186744,5QmsfWrr8re1QceHmRAqqM6UDRZ5H0Jh,A3fsA9Zfv1X2fVEQhTw51lKENdNrEqT3,1,0,0,0,0,0,1,0,1,0.14285714285714285,1,0.0,0,0,0,0,0,0,0,1,0,0,1,1
10420,186749,sHd9Ol41vgPIb8hQT0QvUGTmi4Ucq4PU,A3fsA9Zfv1X2fVEQhTw51lKENdNrEqT3,7,5,1,0,1,0,2,1,10,1.4285714285714286,1,0.0,0,1,0,1,5,0,0,2,1,2,8,0
10421,186757,hDObtbeavxijehIK2xeebS18vJ3HSLBF,G8EPVSXsOYB5YQWZGiz1aVq5Pgr2GrQu,20,13,2,28,2,8,9,2,64,9.142857142857142,1,0.0,7,2,22,2,6,8,6,9,2,33,31,1
10422,186771,EEukb1HtBZxlb0jW8bNwwOHInCYodyW7,SpATywNh6bZuzm8s1ceuBUnMUAeoAHHw,10,8,5,0,3,1,2,0,19,2.7142857142857144,1,0.0,2,5,0,3,6,1,0,2,0,10,9,1
10423,186772,FfI4UUUkiQJXZUOcZvQpEfxlQuZiIFGh,SpATywNh6bZuzm8s1ceuBUnMUAeoAHHw,16,21,6,19,3,1,7,1,58,8.285714285714286,1,0.0,15,6,16,3,6,1,3,7,1,40,18,1
10424,186778,RPs2tKrisA27ObcW2SBs1xNMfhflcdme,A3fsA9Zfv1X2fVEQhTw51lKENdNrEqT3,26,16,13,0,10,2,7,1,49,7.0,1,0.0,1,13,0,10,15,2,0,7,1,24,25,1
10425,186781,7AJKHqkajNqeFVOiguDrQip0qHhqaIRR,SpATywNh6bZuzm8s1ceuBUnMUAeoAHHw,4,3,0,0,0,0,4,0,7,1.0,1,0.0,0,0,0,0,3,0,0,4,0,0,7,1
10426,186783,gGYcWzk2NzIvua4pLrzA2aQChS7C946h,bWdj2GDclj5ofokWjzoa5jAwMkxCykd6,1,0,0,0,0,0,1,0,1,0.14285714285714285,1,0.0,0,0,0,0,0,0,0,1,0,0,1,1
10427,186784,gGYcWzk2NzIvua4pLrzA2aQChS7C946h,A3fsA9Zfv1X2fVEQhTw51lKENdNrEqT3,1,0,0,0,0,0,1,0,1,0.14285714285714285,1,0.0,0,0,0,0,0,0,0,1,0,0,1,1
10428,186800,5dOCb3tuN0oLC3HIthm7sT5KORDlaOZw,bWdj2GDclj5ofokWjzoa5jAwMkxCykd6,1,0,0,0,0,0,1,0,1,0.14285714285714285,1,0.0,0,0,0,0,0,0,0,1,0,0,1,1
10429,186810,fOtwdZktYnpxoylqFRzXhWQ4IRQZkjMB,bWdj2GDclj5ofokWjzoa5jAwMkxCykd6,2,0,0,0,0,0,2,0,2,0.2857142857142857,1,0.0,0,0,0,0,0,0,0,2,0,0,2,1
10430,186813,YxZ9FmNlyuWdg66eoHTORDjjSmjY5VNG,G8EPVSXsOYB5YQWZGiz1aVq5Pgr2GrQu,1,0,0,0,0,0,1,0,1,0.14285714285714285,1,0.0,0,0,0,0,0,0,0,1,0,0,1,1
10431,186814,CBTOHCGcjccQ2o1Vrrh64wBXcjBq7Z16,SpATywNh6bZuzm8s1ceuBUnMUAeoAHHw,1,0,0,0,0,0,1,0,1,0.14285714285714285,1,0.0,0,0,0,0,0,0,0,1,0,0,1,1
10432,186847,hz69aGX7TSXJFEooFn03184YEuUmyXMU,A3fsA9Zfv1X2fVEQhTw51lKENdNrEqT3,1,0,0,0,0,0,1,0,1,0.14285714285714285,1,0.0,0,0,0,0,0,0,0,1,0,0,1,1
10433,186850,UgDeDsY1WA9fQwWE8jwZFiYA6EyOF0ZW,SpATywNh6bZuzm8s1ceuBUnMUAeoAHHw,8,10,6,0,4,0,5,0,25,3.5714285714285716,2,0.0,0,6,0,4,10,0,0,5,0,10,15,1
10434,186853,LsOIP6tIKtIJyz4AzkO8CiGUDMpbTeCo,A3fsA9Zfv1X2fVEQhTw51lKENdNrEqT3,6,13,2,0,0,0,2,0,17,2.4285714285714284,1,0.0,5,2,0,0,8,0,0,2,0,7,10,1
10435,186855,nxuexUreiYSzpSapqT3MF6tzgH9I1i5D,SpATywNh6bZuzm8s1ceuBUnMUAeoAHHw,2,0,0,0,0,0,2,0,2,0.2857142857142857,1,0.0,0,0,0,0,0,0,0,2,0,0,2,1
10436,186856,LsOIP6tIKtIJyz4AzkO8CiGUDMpbTeCo,bWdj2GDclj5ofokWjzoa5jAwMkxCykd6,3,0,0,0,0,0,5,0,5,0.7142857142857143,1,0.0,0,0,0,0,0,0,0,5,0,0,5,1
10437,186860,6wrpSaMSo2sFDvbkUAkMpT5um9Gim187,RXDvfPUBYFlVdlueBFbLW0mhhAyGEqpt,7,4,2,0,1,0,2,0,9,1.2857142857142858,2,0.0,0,2,0,1,4,0,0,2,0,3,6,1
10438,186863,8Sv91LR7V2lE7Zyit6yFhnYKBfbSa4xP,bWdj2GDclj5ofokWjzoa5jAwMkxCykd6,1,0,0,0,0,0,1,0,1,0.14285714285714285,1,0.0,0,0,0,0,0,0,0,1,0,0,1,1
10439,186871,gCagcmlQCSqfTruAye7CNDK3pgpCGf84,G8EPVSXsOYB5YQWZGiz1aVq5Pgr2GrQu,5,2,1,0,1,0,2,0,6,0.8571428571428571,2,0.0,0,1,0,1,2,0,0,2,0,2,4,1
10440,186872,qyt4OAUG4MKvi1Q9hL19EWAbFxfkdehH,SpATywNh6bZuzm8s1ceuBUnMUAeoAHHw,1,0,0,0,0,0,1,0,1,0.14285714285714285,1,0.0,0,0,0,0,0,0,0,1,0,0,1,1
10441,186890,3eKiIXhRJU4AcaSK2OGxb5hm0pCKaHgd,A3fsA9Zfv1X2fVEQhTw51lKENdNrEqT3,39,13,11,46,10,6,2,0,88,12.571428571428571,2,0.0,1,11,45,10,12,6,1,2,0,67,21,1
10442,188085,zRnOVNOS86llNSo73YXoV5gxm1bqsSCm,SpATywNh6bZuzm8s1ceuBUnMUAeoAHHw,5,2,1,0,1,0,2,0,6,0.8571428571428571,1,0.0,0,1,0,1,2,0,0,2,0,2,4,1
10443,188090,ybIzxkMDLWLrDVExEcMDqo8WM6vEGkZZ,SpATywNh6bZuzm8s1ceuBUnMUAeoAHHw,1,0,0,0,0,0,1,0,1,0.14285714285714285,1,0.0,0,0,0,0,0,0,0,1,0,0,1,1
10444,188094,ThbgWOtxqhoj3CitI04NYmRPUH8AcwTc,bWdj2GDclj5ofokWjzoa5jAwMkxCykd6,5,2,1,0,1,0,2,0,6,0.8571428571428571,1,0.0,0,1,0,1,2,0,0,2,0,2,4,1
10445,188109,OH3E8d7hl8qczf2rbzD7q87CuSXHDkzd,SpATywNh6bZuzm8s1ceuBUnMUAeoAHHw,7,3,2,0,2,0,2,0,9,1.2857142857142858,1,0.0,0,2,0,2,3,0,0,2,0,4,5,1
10446,188110,C3IAtr3DP6X43hGuQp5cpcBsS3W9ZHlR,A3fsA9Zfv1X2fVEQhTw51lKENdNrEqT3,9,6,4,0,2,0,4,0,16,2.2857142857142856,3,0.0,0,4,0,2,6,0,0,4,0,6,10,1
10447,188116,MK8k0hhUdWdpYmj0isuX8T1dViy4UCt1,SpATywNh6bZuzm8s1ceuBUnMUAeoAHHw,18,19,6,18,4,0,5,0,52,7.428571428571429,2,0.0,8,6,15,4,11,0,3,5,0,33,19,1
10448,188130,yf5lbvaFDQkrMlGgcstn1q64tRnOCok9,SpATywNh6bZuzm8s1ceuBUnMUAeoAHHw,1,0,0,0,0,0,1,0,1,0.14285714285714285,1,0.0,0,0,0,0,0,0,0,1,0,0,1,1
10449,188131,M16e8QYaHQdZuQp8Y763VwuDYhM2nJCJ,bWdj2GDclj5ofokWjzoa5jAwMkxCykd6,1,0,0,0,0,0,1,0,1,0.14285714285714285,1,0.0,0,0,0,0,0,0,0,1,0,0,1,1
10450,188142,rUr3hxt1niPeDbjT1dWASqAoHDERYMHJ,A3fsA9Zfv1X2fVEQhTw51lKENdNrEqT3,16,3,1,58,0,0,2,0,64,9.142857142857142,1,0.0,0,1,50,0,3,0,8,2,0,51,13,1
10451,188154,iiOxy6ZHzLGvKGuYRdh7FVWh0KnEKqfO,bWdj2GDclj5ofokWjzoa5jAwMkxCykd6,2,0,0,0,0,0,2,0,2,0.2857142857142857,1,0.0,0,0,0,0,0,0,0,2,0,0,2,1
10452,188159,7Yp7JtPvuAevQOAXXsHTKvHnWR7urZQ4,G8EPVSXsOYB5YQWZGiz1aVq5Pgr2GrQu,13,10,6,0,5,1,9,1,32,4.571428571428571,1,0.0,0,6,0,5,10,1,0,9,1,11,21,1
10453,188164,CHnoo745rkdwAbtfBdiAFrd16E9EwOo7,SpATywNh6bZuzm8s1ceuBUnMUAeoAHHw,7,3,2,0,2,0,2,0,9,1.2857142857142858,1,0.0,0,2,0,2,3,0,0,2,0,4,5,1
10454,188166,CHnoo745rkdwAbtfBdiAFrd16E9EwOo7,A3fsA9Zfv1X2fVEQhTw51lKENdNrEqT3,2,0,0,0,0,0,2,0,2,0.2857142857142857,1,0.0,0,0,0,0,0,0,0,2,0,0,2,1
10455,188187,L4jaFu0vxNsfaC1OhafSk08ztmq6goZk,bWdj2GDclj5ofokWjzoa5jAwMkxCykd6,1,0,0,0,0,0,1,0,1,0.14285714285714285,1,0.0,0,0,0,0,0,0,0,1,0,0,1,1
10456,188194,ZbaPpC6DlaDgy5Ic6oj7YX9qkm2j3Pmr,bWdj2GDclj5ofokWjzoa5jAwMkxCykd6,1,0,0,0,0,0,1,0,1,0.14285714285714285,1,0.0,0,0,0,0,0,0,0,1,0,0,1,1
10457,188195,GSVK27iuI3PAZqwurTaJZ7s4wwjamYAo,bWdj2GDclj5ofokWjzoa5jAwMkxCykd6,1,0,0,0,0,0,1,0,1,0.14285714285714285,1,0.0,0,0,0,0,0,0,0,1,0,0,1,1
10458,188217,aXH2LOKFA6E3yNtljCtC3Nc8jVn6ci1H,A3fsA9Zfv1X2fVEQhTw51lKENdNrEqT3,1,0,0,0,0,0,1,0,1,0.14285714285714285,1,0.0,0,0,0,0,0,0,0,1,0,0,1,1
10459,188219,ycZck16llBAZloBk10bwfMcnaMnaXQWK,G8EPVSXsOYB5YQWZGiz1aVq5Pgr2GrQu,8,8,1,4,1,0,3,0,17,2.4285714285714284,1,0.0,0,1,3,1,8,0,1,3,0,5,12,1
10460,188239,zItJ3nxDMUzUt8KfP7wnRxeJL6qP12Ql,SpATywNh6bZuzm8s1ceuBUnMUAeoAHHw,21,16,10,19,7,1,3,1,57,8.142857142857142,1,0.0,5,10,16,7,11,1,3,3,1,38,19,0
10461,188247,BKY6uxinHYYQ0SbTdivOCWOjfYsvPMBo,G8EPVSXsOYB5YQWZGiz1aVq5Pgr2GrQu,21,37,30,36,19,0,7,1,130,18.571428571428573,1,0.0,2,30,35,19,35,0,1,7,1,86,44,1
10462,188261,JxIBkz7Ac4cigQzgeXEdcv5rttnqlmPu,SpATywNh6bZuzm8s1ceuBUnMUAeoAHHw,7,13,6,0,5,0,1,0,25,3.5714285714285716,1,0.0,0,6,0,5,13,0,0,1,0,11,14,1
10463,188265,4M7QUx9Fzm9ZPaWRvEUxQx27jAilEGAL,SpATywNh6bZuzm8s1ceuBUnMUAeoAHHw,1,0,0,0,0,0,1,0,1,0.14285714285714285,1,0.0,0,0,0,0,0,0,0,1,0,0,1,1
10464,188285,VDLlgOqW7FFpT6uHqFXXlnnZR1JOz0x8,bWdj2GDclj5ofokWjzoa5jAwMkxCykd6,5,2,1,0,1,0,2,0,6,0.8571428571428571,1,0.0,0,1,0,1,2,0,0,2,0,2,4,1
10465,188303,jIZxfoiSxH2AO4xoJAniqOuewjPFpPI5,bWdj2GDclj5ofokWjzoa5jAwMkxCykd6,2,0,0,0,0,0,2,0,2,0.2857142857142857,1,0.0,0,0,0,0,0,0,0,2,0,0,2,1
10466,188309,YBtKAFQt6fk6EIukc4Ut5J2kdzYxomaP,G8EPVSXsOYB5YQWZGiz1aVq5Pgr2GrQu,4,2,0,0,0,0,2,1,5,0.7142857142857143,1,0.0,0,0,0,0,2,0,0,2,1,0,5,1
10467,188313,Z34rmr1DW5f5nfzpsFgtbvoODrTWS0gR,A3fsA9Zfv1X2fVEQhTw51lKENdNrEqT3,10,6,5,0,3,0,2,0,16,2.2857142857142856,1,0.0,0,5,0,3,6,0,0,2,0,8,8,1
10468,188317,SgxzSZm3WqSNUUUyFr3EYdvWEPQiCYXc,SpATywNh6bZuzm8s1ceuBUnMUAeoAHHw,5,4,1,0,0,1,3,0,9,1.2857142857142858,1,0.0,0,1,0,0,4,1,0,3,0,1,8,1
10469,188340,lXbqqhFQBJZOyvWBPJdHT24KBsdCctUo,A3fsA9Zfv1X2fVEQhTw51lKENdNrEqT3,2,0,0,0,0,0,2,0,2,0.2857142857142857,1,0.0,0,0,0,0,0,0,0,2,0,0,2,1
10470,188349,OiGglfoFWXujNzXY3OeV6ty8l3z95RBT,G8EPVSXsOYB5YQWZGiz1aVq5Pgr2GrQu,5,2,1,0,1,0,4,0,8,1.1428571428571428,1,0.0,0,1,0,1,2,0,0,4,0,2,6,1
10471,188350,jafkqz7Ls6SMq5HQIDonLkyeZrg5LRjK,bWdj2GDclj5ofokWjzoa5jAwMkxCykd6,2,0,0,0,0,0,3,0,3,0.42857142857142855,1,0.0,0,0,0,0,0,0,0,3,0,0,3,1
10472,188365,4ly9tFjgsKJLiMP1XUHFz2i27nHiXdvU,bWdj2GDclj5ofokWjzoa5jAwMkxCykd6,2,0,0,0,0,0,2,0,2,0.2857142857142857,1,0.0,0,0,0,0,0,0,0,2,0,0,2,1
10473,188366,Qb1CgQ8SxoQQTE8swhxPBVi0nI23eAzb,A3fsA9Zfv1X2fVEQhTw51lKENdNrEqT3,30,15,6,52,2,0,6,0,81,11.571428571428571,2,0.0,2,6,51,2,13,0,1,6,0,61,20,1
10474,188380,YvqXtgBNC43WLi1Y1OHrc4YV5wJZj5BZ,SpATywNh6bZuzm8s1ceuBUnMUAeoAHHw,1,0,0,0,0,0,1,0,1,0.14285714285714285,1,0.0,0,0,0,0,0,0,0,1,0,0,1,1
10475,188395,3RtHMyLQOrBsDYp6yo5VYdmS72cr3PBJ,A3fsA9Zfv1X2fVEQhTw51lKENdNrEqT3,4,4,1,0,0,0,2,0,7,1.0,1,0.0,0,1,0,0,4,0,0,2,0,1,6,1
10476,188404,vN6O2x0QSqyADqu8ib3CnGtyQMSLegp0,SpATywNh6bZuzm8s1ceuBUnMUAeoAHHw,6,5,2,0,1,0,3,0,11,1.5714285714285714,1,0.0,0,2,0,1,5,0,0,3,0,3,8,1
10477,188429,O1acx8tASPAKCowx3gb1g3tmN6Tc39LY,SpATywNh6bZuzm8s1ceuBUnMUAeoAHHw,5,3,1,0,1,0,2,0,7,1.0,1,0.0,0,1,0,1,3,0,0,2,0,2,5,1
10478,188437,xGSY8Cd0Vf3OB8ao8DFjx5u3ZfaDhjub,SpATywNh6bZuzm8s1ceuBUnMUAeoAHHw,4,2,0,0,0,0,3,0,5,0.7142857142857143,1,0.0,0,0,0,0,2,0,0,3,0,0,5,1
10479,188443,2I5ebzNsijWnJvqjKSef4ff3wTM7uHNA,SpATywNh6bZuzm8s1ceuBUnMUAeoAHHw,19,21,13,18,6,1,6,1,66,9.428571428571429,1,0.0,5,13,15,6,16,1,3,6,1,39,27,1
10480,188449,Pp88hiBrGOv2jXNIxXAtL4Okpq7q1gT0,SpATywNh6bZuzm8s1ceuBUnMUAeoAHHw,9,10,4,4,0,0,2,0,20,2.857142857142857,1,0.0,4,4,3,0,6,0,1,2,0,11,9,1
10481,188453,hVaGaJRn8sLkma0vlTnpuIvccDoCcRmU,SpATywNh6bZuzm8s1ceuBUnMUAeoAHHw,11,9,1,10,0,0,3,0,23,3.2857142857142856,1,0.0,1,1,9,0,8,0,1,3,0,11,12,1
10482,188457,gKGgdSFWPcygAewBStBoLPqo60qbmH1E,SpATywNh6bZuzm8s1ceuBUnMUAeoAHHw,6,3,1,0,1,0,2,0,7,1.0,1,0.0,0,1,0,1,3,0,0,2,0,2,5,1
10483,188473,A5GOsdnH2EcjC6B3eZFXiZImo9yFgAgf,SpATywNh6bZuzm8s1ceuBUnMUAeoAHHw,7,5,1,0,1,0,2,0,9,1.2857142857142858,1,0.0,0,1,0,1,5,0,0,2,0,2,7,1
10484,188474,T2bqEEIIeGnaI1g4yvbhFPGfktTUZc7r,A3fsA9Zfv1X2fVEQhTw51lKENdNrEqT3,2,0,0,0,0,0,3,0,3,0.42857142857142855,1,0.0,0,0,0,0,0,0,0,3,0,0,3,1
10485,188485,DnH0S2FmhfjVrDlDj5ZYyy4G86Cb3LMh,A3fsA9Zfv1X2fVEQhTw51lKENdNrEqT3,20,8,7,0,7,1,8,1,32,4.571428571428571,1,0.0,0,7,0,7,8,1,0,8,1,14,18,1
10486,188490,V6YPbhCrTroTd2oOIiUcM7kFRRLU5vrj,A3fsA9Zfv1X2fVEQhTw51lKENdNrEqT3,10,5,4,0,4,0,1,0,14,2.0,1,0.0,0,4,0,4,5,0,0,1,0,8,6,1
10487,188492,Bm156uclJazpLCklS4EEwaPxoPGPtFcp,SpATywNh6bZuzm8s1ceuBUnMUAeoAHHw,5,2,1,0,1,0,2,0,6,0.8571428571428571,1,0.0,0,1,0,1,2,0,0,2,0,2,4,1
10488,188500,j6ThnD1jS0Zu8CWEKNbNRNMNGJz47quI,SpATywNh6bZuzm8s1ceuBUnMUAeoAHHw,19,18,13,14,11,3,1,0,60,8.571428571428571,1,0.0,3,13,14,11,15,3,0,1,0,41,19,1
10489,188505,YnmpFl6RHXV2PnbToNbHTDGl7f0k3wEj,SpATywNh6bZuzm8s1ceuBUnMUAeoAHHw,7,3,2,0,2,0,2,0,9,1.2857142857142858,1,0.0,0,2,0,2,3,0,0,2,0,4,5,1
10490,188513,Vr0kaKAkI4p2upUYNB1MMKsTShBZob66,bWdj2GDclj5ofokWjzoa5jAwMkxCykd6,1,0,0,0,0,0,1,0,1,0.14285714285714285,1,0.0,0,0,0,0,0,0,0,1,0,0,1,1
10491,188517,udLbdwzexRvhhTaiAuWi3yugEk6gj6AD,SpATywNh6bZuzm8s1ceuBUnMUAeoAHHw,6,5,4,0,4,0,1,0,14,2.0,1,0.0,0,4,0,4,5,0,0,1,0,8,6,1
10492,188521,bK37SC4aHpDxnD3Rvkijz9Wy2oAlQRmW,bWdj2GDclj5ofokWjzoa5jAwMkxCykd6,6,2,0,0,0,0,7,1,10,1.4285714285714286,1,0.0,0,0,0,0,2,0,0,7,1,0,10,1
10493,188530,1NKuiSaTPUbZFDACCyv5YoUfO7qDer9w,SpATywNh6bZuzm8s1ceuBUnMUAeoAHHw,3,3,1,0,0,0,1,0,5,0.7142857142857143,1,0.0,0,1,0,0,3,0,0,1,0,1,4,1
10494,188532,3sMwGCOGCL2RAMMG6tfFT0UobGq5flFz,SpATywNh6bZuzm8s1ceuBUnMUAeoAHHw,6,3,2,0,2,0,1,0,8,1.1428571428571428,1,0.0,0,2,0,2,3,0,0,1,0,4,4,1
10495,188535,DVNRZ0Vb68sNhFssev2X8FTZcbZTVgAF,RXDvfPUBYFlVdlueBFbLW0mhhAyGEqpt,1,0,0,0,0,0,1,0,1,0.14285714285714285,1,0.0,0,0,0,0,0,0,0,1,0,0,1,1
10496,188543,JV1BgG1khCT6s4RU5oY7ZOSmwW31Qjbp,A3fsA9Zfv1X2fVEQhTw51lKENdNrEqT3,3,0,0,0,0,1,2,0,3,0.42857142857142855,1,0.0,0,0,0,0,0,1,0,2,0,0,3,1
10497,188551,SSoRd5SzkY86SEd4leqERj2oURCXSCvn,SpATywNh6bZuzm8s1ceuBUnMUAeoAHHw,5,2,1,0,1,0,2,0,6,0.8571428571428571,1,0.0,0,1,0,1,2,0,0,2,0,2,4,1
10498,188559,pGYLDmhkSj1iBp1YljlDSId0XSrjZNZR,A3fsA9Zfv1X2fVEQhTw51lKENdNrEqT3,9,7,5,0,4,0,3,0,19,2.7142857142857144,2,0.0,0,5,0,4,7,0,0,3,0,9,10,1
10499,188560,5gty34EJtQfrhgxngYuTOUGIUr24foZa,SpATywNh6bZuzm8s1ceuBUnMUAeoAHHw,2,0,0,0,0,0,2,0,2,0.2857142857142857,1,0.0,0,0,0,0,0,0,0,2,0,0,2,1
10500,188567,j6ThnD1jS0Zu8CWEKNbNRNMNGJz47quI,A3fsA9Zfv1X2fVEQhTw51lKENdNrEqT3,10,7,5,0,5,0,1,0,18,2.5714285714285716,1,0.0,1,5,0,5,6,0,0,1,0,11,7,1
10501,188572,y9xw5DVwyk92GMkn6gBPMifXrAjYvHji,A3fsA9Zfv1X2fVEQhTw51lKENdNrEqT3,13,10,6,0,3,0,6,2,27,3.857142857142857,1,0.0,2,6,0,3,8,0,0,6,2,11,16,1
10502,188593,urj2Kr7Ws5qXQZp6biE11Qihh39xd0AE,SpATywNh6bZuzm8s1ceuBUnMUAeoAHHw,1,0,0,0,0,0,1,0,1,0.14285714285714285,1,0.0,0,0,0,0,0,0,0,1,0,0,1,1
10503,188618,xteF5FHjR9QQQGxa0LyAUB4pHnIcVbG6,SpATywNh6bZuzm8s1ceuBUnMUAeoAHHw,1,0,0,0,0,0,1,0,1,0.14285714285714285,1,0.0,0,0,0,0,0,0,0,1,0,0,1,1
10504,188635,0sfQp4STEjfvmoiPU7wK8kVHvDAbzKnN,SpATywNh6bZuzm8s1ceuBUnMUAeoAHHw,7,3,1,0,2,0,2,0,8,1.1428571428571428,1,0.0,0,1,0,2,3,0,0,2,0,3,5,1
10505,188643,16lFu8CHy4ustz36vrR0Ab5cogeu487w,A3fsA9Zfv1X2fVEQhTw51lKENdNrEqT3,2,0,0,0,0,0,2,0,2,0.2857142857142857,1,0.0,0,0,0,0,0,0,0,2,0,0,2,1
10506,188933,Xtlrv3IpXCAfEIMntfnxIykrduMXBwb6,7GRhBDsirIGkRZBtSMEzNTyDr2JQm4xx,1,0,0,0,0,0,1,0,1,0.14285714285714285,1,0.0,0,0,0,0,0,0,0,1,0,0,1,1
10507,188937,7gxdF7npc77h7z0KnU9ezGYqtBJqY4fQ,A3fsA9Zfv1X2fVEQhTw51lKENdNrEqT3,1,0,0,0,0,0,2,0,2,0.2857142857142857,1,0.0,0,0,0,0,0,0,0,2,0,0,2,1
10508,188963,bGjzMxOC88rUacNGu6kshAaxdH2zKDK7,7GRhBDsirIGkRZBtSMEzNTyDr2JQm4xx,2,0,0,0,0,0,2,0,2,0.2857142857142857,1,0.0,0,0,0,0,0,0,0,2,0,0,2,1
10509,188974,KcVR47mhsCByukl6kUhifp06p0t9ddmf,7GRhBDsirIGkRZBtSMEzNTyDr2JQm4xx,1,0,0,0,0,0,1,0,1,0.14285714285714285,1,0.0,0,0,0,0,0,0,0,1,0,0,1,1
10510,188976,hlny1PkYo5JEvtbsehOwAyHgv8hye7Vl,7GRhBDsirIGkRZBtSMEzNTyDr2JQm4xx,1,0,0,0,0,0,1,0,1,0.14285714285714285,1,0.0,0,0,0,0,0,0,0,1,0,0,1,1
10511,188979,XoKIP4RGpnZk163890vUyWhLOIUSaapU,7GRhBDsirIGkRZBtSMEzNTyDr2JQm4xx,28,58,22,50,13,2,1,0,146,20.857142857142858,1,0.0,35,22,40,13,23,2,10,1,0,110,36,1
10512,188986,pDtmXyCxgvpAGK1UHOqTKB1Mk4ad0Obx,7GRhBDsirIGkRZBtSMEzNTyDr2JQm4xx,2,0,0,0,0,0,3,0,3,0.42857142857142855,1,0.0,0,0,0,0,0,0,0,3,0,0,3,1
10513,188997,vDLgajPV6eBsq6waPGg2sGMVCdUz10kh,7GRhBDsirIGkRZBtSMEzNTyDr2JQm4xx,6,0,0,0,0,0,9,1,10,1.4285714285714286,1,0.0,0,0,0,0,0,0,0,9,1,0,10,1
10514,189038,CaO6lbKucftN7Eu0LZWcCZKQchWcKCTo,7GRhBDsirIGkRZBtSMEzNTyDr2JQm4xx,6,0,0,0,0,0,6,0,6,0.8571428571428571,1,0.0,0,0,0,0,0,0,0,6,0,0,6,1
10515,189121,v4Sdqo21VERdMlPPJ5lxFzea2Futc16m,7GRhBDsirIGkRZBtSMEzNTyDr2JQm4xx,10,5,3,7,3,1,2,1,22,3.142857142857143,1,0.0,1,3,6,3,4,1,1,2,1,13,9,1
10516,189123,f3G4rcF7hvAe5fW36C69obxNMOERmdUr,7GRhBDsirIGkRZBtSMEzNTyDr2JQm4xx,2,0,0,0,0,0,2,0,2,0.2857142857142857,1,0.0,0,0,0,0,0,0,0,2,0,0,2,1
10517,189125,BlhCYC8woOBcOY9B6dneqhiXvmHLTuKE,7GRhBDsirIGkRZBtSMEzNTyDr2JQm4xx,2,0,0,0,0,0,2,0,2,0.2857142857142857,1,0.0,0,0,0,0,0,0,0,2,0,0,2,1
10518,189138,jiFzFGisDkK72ZBTna8wrY4pq5bLzUOt,SpATywNh6bZuzm8s1ceuBUnMUAeoAHHw,4,2,1,0,1,0,1,0,5,0.7142857142857143,1,0.0,0,1,0,1,2,0,0,1,0,2,3,1
10519,189142,skSnSfH7XcyX8lYXpZBS74pGLHKMwWNm,7GRhBDsirIGkRZBtSMEzNTyDr2JQm4xx,1,0,0,0,0,0,1,0,1,0.14285714285714285,1,0.0,0,0,0,0,0,0,0,1,0,0,1,1
10520,189149,RD8IEsnXxFXH4Z6OD9WSAuQqmJ27nHhK,7GRhBDsirIGkRZBtSMEzNTyDr2JQm4xx,2,0,0,0,0,0,2,0,2,0.2857142857142857,1,0.0,0,0,0,0,0,0,0,2,0,0,2,1
10521,189157,KADzrQcaGi7TzZIKCqh7I8E0i863BBoH,7GRhBDsirIGkRZBtSMEzNTyDr2JQm4xx,2,0,0,0,0,0,2,0,2,0.2857142857142857,1,0.0,0,0,0,0,0,0,0,2,0,0,2,1
10522,189163,YdCaKimqYb8kuFiHEtjPDsCbtIch1tfO,7GRhBDsirIGkRZBtSMEzNTyDr2JQm4xx,8,9,2,0,0,1,5,2,19,2.7142857142857144,1,0.0,5,2,0,0,4,1,0,5,2,7,12,1
10523,189178,UpLwu6T0ULbCdikK3k55n17m75BbWAqs,7GRhBDsirIGkRZBtSMEzNTyDr2JQm4xx,7,4,1,0,2,0,4,0,11,1.5714285714285714,1,0.0,2,1,0,2,2,0,0,4,0,5,6,1
10524,189180,De3af8LDoF4IXXnUzXAiZVCskiGXJoAd,7GRhBDsirIGkRZBtSMEzNTyDr2JQm4xx,11,11,4,4,2,15,9,3,48,6.857142857142857,1,0.0,2,4,3,2,9,15,1,9,3,11,37,1
10525,189185,waDceRgc2N0BjPJorKWJj1WtKs87R7xP,7GRhBDsirIGkRZBtSMEzNTyDr2JQm4xx,4,2,0,0,0,0,2,0,4,0.5714285714285714,1,0.0,0,0,0,0,2,0,0,2,0,0,4,1
10526,189190,hz69aGX7TSXJFEooFn03184YEuUmyXMU,7GRhBDsirIGkRZBtSMEzNTyDr2JQm4xx,2,0,0,0,0,0,2,0,2,0.2857142857142857,1,0.0,0,0,0,0,0,0,0,2,0,0,2,1
10527,189200,jxw4QkqvvdLlUDAf97E2SumJv5ThdQ3m,7GRhBDsirIGkRZBtSMEzNTyDr2JQm4xx,2,0,0,0,0,0,5,0,5,0.7142857142857143,1,0.0,0,0,0,0,0,0,0,5,0,0,5,1
10528,189217,S685sFeuH7ep81myXbWJBadTSgXcwR6Q,7GRhBDsirIGkRZBtSMEzNTyDr2JQm4xx,5,2,1,0,1,0,3,0,7,1.0,1,0.0,0,1,0,1,2,0,0,3,0,2,5,1
10529,189225,V1EykxyqrSjJS8SrSU1L9A5qCk92mw9z,7GRhBDsirIGkRZBtSMEzNTyDr2JQm4xx,23,34,18,24,17,1,2,0,96,13.714285714285714,1,0.0,8,18,21,17,26,1,3,2,0,64,32,1
10530,189237,XqzZzhc9uB2wCLtNHGWt7epj98UW1aCq,7GRhBDsirIGkRZBtSMEzNTyDr2JQm4xx,2,0,0,0,0,0,2,0,2,0.2857142857142857,1,0.0,0,0,0,0,0,0,0,2,0,0,2,1
10531,189251,gKEmxl73O6lgpzCm5W5THfmE7UMUjyMT,7GRhBDsirIGkRZBtSMEzNTyDr2JQm4xx,6,1,1,0,0,5,4,3,14,2.0,1,0.0,0,1,0,0,1,5,0,4,3,1,13,1
10532,189258,vKg7m5YebaxRd5kf6WsIAhVoxmBX8DKD,7GRhBDsirIGkRZBtSMEzNTyDr2JQm4xx,2,0,0,0,0,0,2,0,2,0.2857142857142857,1,0.0,0,0,0,0,0,0,0,2,0,0,2,1
10533,189329,IDVV2jtBUYHXvZRwUeupKpLFwBDZmMvi,7GRhBDsirIGkRZBtSMEzNTyDr2JQm4xx,3,2,0,0,0,0,1,0,3,0.42857142857142855,1,0.0,0,0,0,0,2,0,0,1,0,0,3,1
10534,189332,xhCV750Vmz3Zc8n6WSG04S1Of863qTkW,7GRhBDsirIGkRZBtSMEzNTyDr2JQm4xx,1,0,0,0,0,0,1,0,1,0.14285714285714285,1,0.0,0,0,0,0,0,0,0,1,0,0,1,1
10535,189336,y71lRBqIdu5iPiLn9Yi5PQm6GFIvgLwB,7GRhBDsirIGkRZBtSMEzNTyDr2JQm4xx,1,0,0,0,0,0,1,0,1,0.14285714285714285,1,0.0,0,0,0,0,0,0,0,1,0,0,1,1
10536,189381,d9mMxxcMI65zEdojLuYluBZegkL9kaO9,7GRhBDsirIGkRZBtSMEzNTyDr2JQm4xx,2,0,0,0,0,0,2,0,2,0.2857142857142857,1,0.0,0,0,0,0,0,0,0,2,0,0,2,1
10537,189401,PB7h0UvHpsEAKo6BKDI2Oe83oHx4FlRv,7GRhBDsirIGkRZBtSMEzNTyDr2JQm4xx,5,4,1,0,2,0,2,0,9,1.2857142857142858,1,0.0,2,1,0,2,2,0,0,2,0,5,4,1
10538,189408,XsZuRX3JjxC6rjjGF8ce2xx3yowgSNne,7GRhBDsirIGkRZBtSMEzNTyDr2JQm4xx,8,3,2,0,2,0,4,0,11,1.5714285714285714,1,0.0,0,2,0,2,3,0,0,4,0,4,7,1
10539,189442,ifnHK7elzUrx6FoT7eceCrEZMhAwQ98l,7GRhBDsirIGkRZBtSMEzNTyDr2JQm4xx,5,3,1,4,1,0,2,0,11,1.5714285714285714,1,0.0,1,1,3,1,2,0,1,2,0,6,5,1
10540,189444,HO1jCcwERynGUi1jR0hjkSfXZ85j5jaW,7GRhBDsirIGkRZBtSMEzNTyDr2JQm4xx,1,0,0,0,0,0,1,0,1,0.14285714285714285,1,0.0,0,0,0,0,0,0,0,1,0,0,1,1
10541,189448,opKUJLQunILYTzpA0JfEP9KQkwUgY37v,7GRhBDsirIGkRZBtSMEzNTyDr2JQm4xx,16,8,5,0,3,3,10,1,30,4.285714285714286,1,0.0,0,5,0,3,8,3,0,10,1,8,22,1
10542,189453,CwPtG0pQpatgEgPUJC1fzC45UnY2lgMF,7GRhBDsirIGkRZBtSMEzNTyDr2JQm4xx,10,11,7,10,5,0,4,0,37,5.285714285714286,2,0.0,3,7,8,5,8,0,2,4,0,23,14,1
10543,189519,W44EUSPSAj1fZWLor5hD25joUoQF1Axq,7GRhBDsirIGkRZBtSMEzNTyDr2JQm4xx,9,6,0,2,1,0,2,0,11,1.5714285714285714,1,0.0,1,0,2,1,5,0,0,2,0,4,7,1
10544,189520,xPkJLyddSzkSguLc8iFCPUKp6SiHPVYA,7GRhBDsirIGkRZBtSMEzNTyDr2JQm4xx,1,0,0,0,0,0,1,0,1,0.14285714285714285,1,0.0,0,0,0,0,0,0,0,1,0,0,1,1
10545,189576,QGuKTIBC2KLaYpPdOnB4nXCWgxMM1Dog,7GRhBDsirIGkRZBtSMEzNTyDr2JQm4xx,1,0,0,0,0,0,1,0,1,0.14285714285714285,1,0.0,0,0,0,0,0,0,0,1,0,0,1,1
10546,189593,MgVP6LodMhznTbusy8mYmerhW0RKcSCB,7GRhBDsirIGkRZBtSMEzNTyDr2JQm4xx,1,0,0,0,0,0,1,0,1,0.14285714285714285,1,0.0,0,0,0,0,0,0,0,1,0,0,1,1
10547,189605,yrczal0ybDrTDoOYd1WvgcBQApn5E29e,7GRhBDsirIGkRZBtSMEzNTyDr2JQm4xx,1,0,0,0,0,0,1,0,1,0.14285714285714285,1,0.0,0,0,0,0,0,0,0,1,0,0,1,1
10548,189608,1HkkpfSVTiT6CtY9J3aLZcX4FRE5LVLz,7GRhBDsirIGkRZBtSMEzNTyDr2JQm4xx,3,0,0,0,0,3,2,0,5,0.7142857142857143,1,0.0,0,0,0,0,0,3,0,2,0,0,5,1
10549,189614,5PZBmKEXGmnHhrok7M9vaGB06CAzFVOO,7GRhBDsirIGkRZBtSMEzNTyDr2JQm4xx,6,4,1,2,1,0,1,0,9,1.2857142857142858,1,0.0,1,1,2,1,3,0,0,1,0,5,4,0
10550,189666,lbgTV2YMskSv2TX4EXpaazpMVWfsftEV,7GRhBDsirIGkRZBtSMEzNTyDr2JQm4xx,1,0,0,0,0,0,1,0,1,0.14285714285714285,1,0.0,0,0,0,0,0,0,0,1,0,0,1,1
10551,189696,PMZJ7vxYEpwybeGWTMZuFimiDLzBBGfH,7GRhBDsirIGkRZBtSMEzNTyDr2JQm4xx,9,7,1,0,1,0,2,0,11,1.5714285714285714,1,0.0,0,1,0,1,7,0,0,2,0,2,9,1
10552,189792,tr8E6i6LhPPOpsyObFM4xo1Myl86ILao,A3fsA9Zfv1X2fVEQhTw51lKENdNrEqT3,4,3,0,0,0,0,1,0,4,0.5714285714285714,1,0.0,0,0,0,0,3,0,0,1,0,0,4,1
10553,189835,vXT2w57VYk2IRPGUPSaMsXQX7TQrsaxB,7GRhBDsirIGkRZBtSMEzNTyDr2JQm4xx,1,0,0,0,0,0,1,0,1,0.14285714285714285,1,0.0,0,0,0,0,0,0,0,1,0,0,1,1
10554,189836,xgQYbfvDEw17v13YEvx2pY52YvDa4jfG,7GRhBDsirIGkRZBtSMEzNTyDr2JQm4xx,12,6,5,0,5,0,1,0,17,2.4285714285714284,1,0.0,0,5,0,5,6,0,0,1,0,10,7,0
10555,189841,c6EQxl5Y5srE1l7qShfQ6CExe7ZkgJ6z,7GRhBDsirIGkRZBtSMEzNTyDr2JQm4xx,4,2,0,0,0,1,2,0,5,0.7142857142857143,1,0.0,0,0,0,0,2,1,0,2,0,0,5,0
10556,189872,tvbjaq3OPKemCIT5KViqtpbuzjmnk9iv,7GRhBDsirIGkRZBtSMEzNTyDr2JQm4xx,1,0,0,0,0,0,1,0,1,0.14285714285714285,1,0.0,0,0,0,0,0,0,0,1,0,0,1,1
10557,189878,EuByZSROH9lLZ2dnd4GXxahw8RdkgjTd,7GRhBDsirIGkRZBtSMEzNTyDr2JQm4xx,5,2,1,0,1,0,4,0,8,1.1428571428571428,1,0.0,0,1,0,1,2,0,0,4,0,2,6,1
10558,189962,vqeyrkQOvY6ito5wie8yXLKkDfcoR2Qk,7GRhBDsirIGkRZBtSMEzNTyDr2JQm4xx,1,0,0,0,0,0,1,0,1,0.14285714285714285,1,0.0,0,0,0,0,0,0,0,1,0,0,1,1
10559,189987,VAnGmjZDe4mKyUygxHcsKkNd3a9DThub,7GRhBDsirIGkRZBtSMEzNTyDr2JQm4xx,9,8,2,4,3,0,3,0,20,2.857142857142857,1,0.0,3,2,3,3,5,0,1,3,0,11,9,1
10560,190043,9NL6pIdeoq3qoMYjmrqicRwQF6as6xWO,7GRhBDsirIGkRZBtSMEzNTyDr2JQm4xx,6,7,1,0,1,0,3,0,12,1.7142857142857142,1,0.0,0,1,0,1,7,0,0,3,0,2,10,1
10561,190059,zX9pboSJ4vJa1gdfSLlOQHMTjhsQEp32,7GRhBDsirIGkRZBtSMEzNTyDr2JQm4xx,1,0,0,0,0,0,1,0,1,0.14285714285714285,1,0.0,0,0,0,0,0,0,0,1,0,0,1,1
10562,190148,WQMZ2fhdRzqYNsK6k2GeqeA3Ess2PfYw,7GRhBDsirIGkRZBtSMEzNTyDr2JQm4xx,1,0,0,0,0,0,1,0,1,0.14285714285714285,1,0.0,0,0,0,0,0,0,0,1,0,0,1,1
10563,190207,LuEM6Ji2sbchJvZp3E6DXQ6Q9idvBGe0,7GRhBDsirIGkRZBtSMEzNTyDr2JQm4xx,5,1,1,0,1,2,2,0,7,1.0,1,0.0,0,1,0,1,1,2,0,2,0,2,5,1
10564,190718,DpxuYKp6sa0JAnGuKmqElQRmCDtXLEpJ,SpATywNh6bZuzm8s1ceuBUnMUAeoAHHw,1,0,0,0,0,0,1,0,1,0.14285714285714285,1,0.0,0,0,0,0,0,0,0,1,0,0,1,1
10565,190722,Ms1kL8mhYcPEiDk8tgcaN8I4C5LMNZxp,G8EPVSXsOYB5YQWZGiz1aVq5Pgr2GrQu,11,9,1,19,0,0,1,0,30,4.285714285714286,1,0.0,4,1,15,0,5,0,4,1,0,20,10,1
10566,190727,37BDHc0OYB1UI75qIorGre2ofEZmPc4J,A3fsA9Zfv1X2fVEQhTw51lKENdNrEqT3,1,0,0,0,0,0,1,0,1,0.14285714285714285,1,0.0,0,0,0,0,0,0,0,1,0,0,1,1
10567,190733,qwFC3xpje0fSY3HguoMOOzyv51OIHJQc,SpATywNh6bZuzm8s1ceuBUnMUAeoAHHw,5,2,1,0,1,0,2,0,6,0.8571428571428571,1,0.0,0,1,0,1,2,0,0,2,0,2,4,1
10568,190740,MK8n1r3R3tfWcasYdKrOSnVNYSZNSOlt,SpATywNh6bZuzm8s1ceuBUnMUAeoAHHw,13,33,4,23,0,1,7,2,70,10.0,1,0.0,10,4,20,0,23,1,3,7,2,34,36,1
10569,190746,TCMrwUanMGda0OSNc9BMWUDLbksnXQ2Q,SpATywNh6bZuzm8s1ceuBUnMUAeoAHHw,11,13,7,0,4,5,6,1,36,5.142857142857143,1,0.0,0,7,0,4,13,5,0,6,1,11,25,0
10570,190751,wIcAqiIkhVke6PQk1FQ10LQjFUOa268K,A3fsA9Zfv1X2fVEQhTw51lKENdNrEqT3,1,0,0,0,0,0,2,0,2,0.2857142857142857,1,0.0,0,0,0,0,0,0,0,2,0,0,2,1
10571,190753,d91YjGHVAp34DYQkswrOrvZeIJcGcFNO,SpATywNh6bZuzm8s1ceuBUnMUAeoAHHw,13,13,5,12,4,0,2,0,36,5.142857142857143,1,0.0,6,5,11,4,7,0,1,2,0,26,10,1
10572,190765,3RcsrMTbPrb8ZHYXLlgwoRK7zrqTGSuq,RXDvfPUBYFlVdlueBFbLW0mhhAyGEqpt,4,2,1,0,1,0,1,0,5,0.7142857142857143,1,0.0,0,1,0,1,2,0,0,1,0,2,3,1
10573,190772,HBKLIFAfKd9tCUbnjwmqE9j7uloBEJrv,bWdj2GDclj5ofokWjzoa5jAwMkxCykd6,6,8,1,0,1,5,6,0,21,3.0,2,0.0,0,1,0,1,8,5,0,6,0,2,19,1
10574,190777,Ah2AGzYhaU2T8uPD2EY56TT31dJPAut5,SpATywNh6bZuzm8s1ceuBUnMUAeoAHHw,6,3,1,0,1,0,2,0,7,1.0,1,0.0,0,1,0,1,3,0,0,2,0,2,5,1
10575,190783,jImHfNEIObE674KdIbKVj7cCJ4ufqzHJ,bWdj2GDclj5ofokWjzoa5jAwMkxCykd6,6,6,2,0,0,10,4,0,22,3.142857142857143,1,0.0,1,2,0,0,5,10,0,4,0,3,19,1
10576,190788,ub8WyOqIuzODPtpQPBgjCOsRi8689oKs,bWdj2GDclj5ofokWjzoa5jAwMkxCykd6,9,16,6,34,6,0,3,0,65,9.285714285714286,1,0.0,7,6,33,6,9,0,1,3,0,52,13,1
10577,190789,OVHTSfVPYj0AbzU459n1EpNOKwcVwoC1,SpATywNh6bZuzm8s1ceuBUnMUAeoAHHw,6,1,1,0,1,0,5,0,8,1.1428571428571428,1,0.0,0,1,0,1,1,0,0,5,0,2,6,1
10578,190799,4e4wTy2Vsuz8jVFYgJOgi1kIGDWREiPH,A3fsA9Zfv1X2fVEQhTw51lKENdNrEqT3,1,0,0,0,0,0,1,0,1,0.14285714285714285,1,0.0,0,0,0,0,0,0,0,1,0,0,1,1
10579,190810,kKpnSjKhiG2j5iddaCKIyt4CCm1rwmVr,bWdj2GDclj5ofokWjzoa5jAwMkxCykd6,2,0,0,0,0,0,2,0,2,0.2857142857142857,1,0.0,0,0,0,0,0,0,0,2,0,0,2,0
10580,190812,3GA2inbDa4Qb67FoyO0TodCHsf82hLjI,bWdj2GDclj5ofokWjzoa5jAwMkxCykd6,7,9,0,0,0,0,6,0,15,2.142857142857143,2,0.0,0,0,0,0,9,0,0,6,0,0,15,1
10581,190843,hfNogWjrbSkOb5OMhhVjR3oNpdgCCLmb,SpATywNh6bZuzm8s1ceuBUnMUAeoAHHw,3,0,0,0,0,0,3,0,3,0.42857142857142855,1,0.0,0,0,0,0,0,0,0,3,0,0,3,1
10582,190859,ckUpblr5wnpb1JdYLODP4lr2g04VPwJ3,SpATywNh6bZuzm8s1ceuBUnMUAeoAHHw,6,8,4,0,4,0,1,0,17,2.4285714285714284,1,0.0,3,4,0,4,5,0,0,1,0,11,6,1
10583,190862,6ZrLKRxT6wri7cDqZ6Wete0KvsW58pUp,SpATywNh6bZuzm8s1ceuBUnMUAeoAHHw,3,2,0,0,0,0,1,0,3,0.42857142857142855,1,0.0,0,0,0,0,2,0,0,1,0,0,3,1
10584,190865,tE94PJyjcpdWxXLDLcWw5U2hOs3lOnfb,SpATywNh6bZuzm8s1ceuBUnMUAeoAHHw,12,4,3,0,3,1,5,1,17,2.4285714285714284,1,0.0,0,3,0,3,4,1,0,5,1,6,11,1
10585,190871,DanoP5XpHODQZmwuFGZgNKBiu5nY9yH1,bWdj2GDclj5ofokWjzoa5jAwMkxCykd6,5,3,1,0,1,1,2,1,9,1.2857142857142858,1,0.0,1,1,0,1,2,1,0,2,1,3,6,1
10586,190878,XZVdP9VG9V0aFXSF7pNpI4xf6QSEG5Qi,SpATywNh6bZuzm8s1ceuBUnMUAeoAHHw,1,0,0,0,0,0,1,0,1,0.14285714285714285,1,0.0,0,0,0,0,0,0,0,1,0,0,1,1
10587,190881,qKdcEew3Ozu2wI3f7P370tw3NiiGDkW3,bWdj2GDclj5ofokWjzoa5jAwMkxCykd6,1,0,0,0,0,0,1,0,1,0.14285714285714285,1,0.0,0,0,0,0,0,0,0,1,0,0,1,1
10588,190890,9Yh9BGNzlB70iEC7VABYNXfepXjXz9Ik,A3fsA9Zfv1X2fVEQhTw51lKENdNrEqT3,1,0,0,0,0,0,3,0,3,0.42857142857142855,1,0.0,0,0,0,0,0,0,0,3,0,0,3,1
10589,190896,jGtiVf5HYLqgOasCrKGgOBMBFuA9x4ae,SpATywNh6bZuzm8s1ceuBUnMUAeoAHHw,7,6,2,0,2,0,2,0,12,1.7142857142857142,1,0.0,0,2,0,2,6,0,0,2,0,4,8,1
10590,190918,withnGSnYLu5h0Gra5Fz5vQjZTgJGD3V,SpATywNh6bZuzm8s1ceuBUnMUAeoAHHw,7,3,2,0,2,0,4,0,11,1.5714285714285714,1,0.0,0,2,0,2,3,0,0,4,0,4,7,1
10591,190922,tbFJlVh7YWaPwir5TDxmcNNiJWy4IdR6,SpATywNh6bZuzm8s1ceuBUnMUAeoAHHw,7,8,5,0,3,0,3,0,19,2.7142857142857144,1,0.0,0,5,0,3,8,0,0,3,0,8,11,1
10592,190929,KK8c9Dmj5I63bhg4LxlQHTWu5jCGLVNt,SpATywNh6bZuzm8s1ceuBUnMUAeoAHHw,1,0,0,0,0,0,1,0,1,0.14285714285714285,1,0.0,0,0,0,0,0,0,0,1,0,0,1,1
10593,190932,gWQVeEY6kY0Jw04P2MZyClMk9GLvVaq0,RXDvfPUBYFlVdlueBFbLW0mhhAyGEqpt,14,11,8,19,2,0,11,0,51,7.285714285714286,1,0.0,1,8,16,2,10,0,3,11,0,27,24,1
10594,190938,QxwH5Fww2hdJXhksXEKBkHoArOFw3LA7,bWdj2GDclj5ofokWjzoa5jAwMkxCykd6,1,0,0,0,0,0,1,0,1,0.14285714285714285,1,0.0,0,0,0,0,0,0,0,1,0,0,1,1
10595,190943,2AimReANoYwzi4n9y5GufQBbWWeoLfr2,bWdj2GDclj5ofokWjzoa5jAwMkxCykd6,1,0,0,0,0,0,1,0,1,0.14285714285714285,1,0.0,0,0,0,0,0,0,0,1,0,0,1,1
10596,190946,NzGQ6qHi5I7oDznlM4iA1Evelv3MLoFE,SpATywNh6bZuzm8s1ceuBUnMUAeoAHHw,10,16,5,4,0,2,6,0,33,4.714285714285714,1,0.0,1,5,3,0,15,2,1,6,0,9,24,1
10597,190948,BwqiPFy1sDFuBLb3rSXiF0IO3CLelW7L,SpATywNh6bZuzm8s1ceuBUnMUAeoAHHw,14,14,5,16,2,13,8,4,62,8.857142857142858,2,0.0,8,5,14,2,6,13,2,8,4,29,33,1
10598,190950,9Yh9BGNzlB70iEC7VABYNXfepXjXz9Ik,bWdj2GDclj5ofokWjzoa5jAwMkxCykd6,4,2,0,0,0,3,4,0,9,1.2857142857142858,1,0.0,0,0,0,0,2,3,0,4,0,0,9,1
10599,190952,C4ydYZ7sRMBYk7EGihDGPeJUEQIdQEOw,SpATywNh6bZuzm8s1ceuBUnMUAeoAHHw,8,18,10,0,6,0,4,0,38,5.428571428571429,3,0.0,0,10,0,6,18,0,0,4,0,16,22,0
10600,190956,MBe2FxezhNNSk0O4l1Td85ufwdvtDvm8,SpATywNh6bZuzm8s1ceuBUnMUAeoAHHw,14,7,4,12,3,7,4,0,37,5.285714285714286,1,0.0,2,4,10,3,5,7,2,4,0,19,18,1
10601,190963,AilYGUB2b7U7u3L7JzReiarkucWyF0Uz,SpATywNh6bZuzm8s1ceuBUnMUAeoAHHw,2,0,0,0,0,0,4,0,4,0.5714285714285714,1,0.0,0,0,0,0,0,0,0,4,0,0,4,1
10602,190970,LLbWHvDvBPRMaeOD85m6rAaUvdLFucgj,bWdj2GDclj5ofokWjzoa5jAwMkxCykd6,3,0,0,0,0,0,3,0,3,0.42857142857142855,1,0.0,0,0,0,0,0,0,0,3,0,0,3,1
10603,190979,pMptAyZDeGXiIThstiLzNxB1KwRjAXpm,SpATywNh6bZuzm8s1ceuBUnMUAeoAHHw,1,0,0,0,0,0,1,0,1,0.14285714285714285,1,0.0,0,0,0,0,0,0,0,1,0,0,1,1
10604,190983,FiovvlFjZXQo41RA25FaJ17VJEgdj2le,SpATywNh6bZuzm8s1ceuBUnMUAeoAHHw,9,17,1,20,0,0,1,0,39,5.571428571428571,1,0.0,8,1,17,0,9,0,3,1,0,26,13,0
10605,191003,hupbjCOx448dHGDJQGqmUPOcvI9LWbzv,SpATywNh6bZuzm8s1ceuBUnMUAeoAHHw,4,2,1,0,0,7,3,0,13,1.8571428571428572,2,0.0,0,1,0,0,2,7,0,3,0,1,12,1
10606,191006,Q8nnFnGSO36eBGAiyp2wP0aveYg77DlE,G8EPVSXsOYB5YQWZGiz1aVq5Pgr2GrQu,5,6,1,0,2,1,2,0,12,1.7142857142857142,1,0.0,2,1,0,2,4,1,0,2,0,5,7,1
10607,191018,co3nb33nJ0Krxm21xnzLNxLQgo7GndnG,SpATywNh6bZuzm8s1ceuBUnMUAeoAHHw,1,0,0,0,0,0,1,0,1,0.14285714285714285,1,0.0,0,0,0,0,0,0,0,1,0,0,1,1
10608,191019,NCCp8fTS5s1iyttaNh3WkMeHCOcN3tb4,bWdj2GDclj5ofokWjzoa5jAwMkxCykd6,2,0,0,0,0,0,2,0,2,0.2857142857142857,1,0.0,0,0,0,0,0,0,0,2,0,0,2,1
10609,191021,nNXCDU7pCvXdQPycxWESwEGIIRWvHKWv,SpATywNh6bZuzm8s1ceuBUnMUAeoAHHw,3,2,1,0,0,0,1,0,4,0.5714285714285714,1,0.0,0,1,0,0,2,0,0,1,0,1,3,1
10610,191027,uFHm9PGn5yQICMVzgF44FzRtCVKrar2K,SpATywNh6bZuzm8s1ceuBUnMUAeoAHHw,7,2,1,0,1,1,4,0,9,1.2857142857142858,1,0.0,0,1,0,1,2,1,0,4,0,2,7,0
10611,191029,qSgfNAK24EhdWunFvzpQNvLLVkPV61Hr,A3fsA9Zfv1X2fVEQhTw51lKENdNrEqT3,1,0,0,0,0,0,1,0,1,0.14285714285714285,1,0.0,0,0,0,0,0,0,0,1,0,0,1,1
10612,191038,Sc510MM1IFPp0fhdgDOEyRVvZYZOxuoR,A3fsA9Zfv1X2fVEQhTw51lKENdNrEqT3,1,0,0,0,0,0,1,0,1,0.14285714285714285,1,0.0,0,0,0,0,0,0,0,1,0,0,1,1
10613,191041,trENMyltvkElnFRacDKrV1O2HLSxf35j,A3fsA9Zfv1X2fVEQhTw51lKENdNrEqT3,5,2,1,0,1,0,2,0,6,0.8571428571428571,2,0.0,0,1,0,1,2,0,0,2,0,2,4,1
10614,191050,Y3qAEqzdKJewEkb06n8n2BrJMQzX9urI,SpATywNh6bZuzm8s1ceuBUnMUAeoAHHw,15,13,5,19,3,7,6,1,54,7.714285714285714,1,0.0,8,5,16,3,5,7,3,6,1,32,22,1
10615,191063,nRHQUNRUIsIinoYx4tQlxNnAC0I3YYVk,G8EPVSXsOYB5YQWZGiz1aVq5Pgr2GrQu,41,59,33,88,16,0,11,5,212,30.285714285714285,1,0.0,20,33,75,16,39,0,13,11,5,144,68,1
10616,191064,yB2j2tPO2DVKCBBdsLv8a1lbHtfWINMh,bWdj2GDclj5ofokWjzoa5jAwMkxCykd6,1,0,0,0,0,0,1,0,1,0.14285714285714285,1,0.0,0,0,0,0,0,0,0,1,0,0,1,1
10617,191078,hjK9g2c0CglrLajBSxgIKqI54vivYEKM,SpATywNh6bZuzm8s1ceuBUnMUAeoAHHw,1,0,0,0,0,0,1,0,1,0.14285714285714285,1,0.0,0,0,0,0,0,0,0,1,0,0,1,1
10618,191102,etudbAO9CMrW6LcXYzcIWXUJFoLMbVh9,SpATywNh6bZuzm8s1ceuBUnMUAeoAHHw,10,5,3,0,2,9,5,1,25,3.5714285714285716,1,0.0,0,3,0,2,5,9,0,5,1,5,20,1
10619,191103,917C36aL5o1yjdcDTH5lZyAgXpc01Gk5,SpATywNh6bZuzm8s1ceuBUnMUAeoAHHw,4,2,0,0,0,1,2,1,6,0.8571428571428571,1,0.0,0,0,0,0,2,1,0,2,1,0,6,1
10620,191106,geEAXwfPbJ0MhEZG0COad1UptHNAilTd,bWdj2GDclj5ofokWjzoa5jAwMkxCykd6,2,0,0,0,0,0,2,0,2,0.2857142857142857,1,0.0,0,0,0,0,0,0,0,2,0,0,2,1
10621,191129,SHOQyzWMzeXzTVojp4arGhfbJLLjl3Lx,bWdj2GDclj5ofokWjzoa5jAwMkxCykd6,4,2,1,0,1,0,1,0,5,0.7142857142857143,1,0.0,0,1,0,1,2,0,0,1,0,2,3,1
10622,191131,HcFsEHTYadygQKRPBb3uDSEv8jpRHr6D,A3fsA9Zfv1X2fVEQhTw51lKENdNrEqT3,1,0,0,0,0,0,2,0,2,0.2857142857142857,1,0.0,0,0,0,0,0,0,0,2,0,0,2,1
10623,191132,deraFog8y0MjwcE23P6Rs0pGeytN3xmN,SpATywNh6bZuzm8s1ceuBUnMUAeoAHHw,9,11,0,0,0,2,14,4,31,4.428571428571429,1,0.0,0,0,0,0,11,2,0,14,4,0,31,1
10624,191135,OPQKWFr5Ag3gYEWW9i0rWdZ5Gc0wk3FB,SpATywNh6bZuzm8s1ceuBUnMUAeoAHHw,5,2,1,0,1,0,4,0,8,1.1428571428571428,1,0.0,0,1,0,1,2,0,0,4,0,2,6,1
10625,191143,KarP5JDxaA55wR1ThEFPoGYFsHmbBCZf,bWdj2GDclj5ofokWjzoa5jAwMkxCykd6,5,2,1,0,1,0,2,0,6,0.8571428571428571,1,0.0,0,1,0,1,2,0,0,2,0,2,4,1
10626,191147,21VuQSD13OpzBWnKCJ94z3vzUwy0J7cg,SpATywNh6bZuzm8s1ceuBUnMUAeoAHHw,9,7,3,0,0,0,5,1,16,2.2857142857142856,1,0.0,1,3,0,0,6,0,0,5,1,4,12,1
10627,191149,2KkJ2RPeYYnwpoBmLIbDX3SHVzQ9KAtd,SpATywNh6bZuzm8s1ceuBUnMUAeoAHHw,1,0,0,0,0,0,1,0,1,0.14285714285714285,1,0.0,0,0,0,0,0,0,0,1,0,0,1,1
10628,191155,S1LmT8vUaszGt2C5KVBW9KkkZ6u3e67K,SpATywNh6bZuzm8s1ceuBUnMUAeoAHHw,1,0,0,0,0,0,1,0,1,0.14285714285714285,1,0.0,0,0,0,0,0,0,0,1,0,0,1,1
10629,191165,XKiESHLmmxxFLSNhNTicMKXZo07ga8rR,bWdj2GDclj5ofokWjzoa5jAwMkxCykd6,2,0,0,0,0,0,2,0,2,0.2857142857142857,1,0.0,0,0,0,0,0,0,0,2,0,0,2,1
10630,191170,SfAUcZmUPYD4dsdFfOX7wSpg4mGcve5n,RXDvfPUBYFlVdlueBFbLW0mhhAyGEqpt,1,0,0,0,0,0,1,0,1,0.14285714285714285,1,0.0,0,0,0,0,0,0,0,1,0,0,1,1
10631,191179,wFv26V6AwzjCWPgCKpY50WBZiVw3xNw6,SpATywNh6bZuzm8s1ceuBUnMUAeoAHHw,7,4,3,0,3,0,2,0,12,1.7142857142857142,1,0.0,0,3,0,3,4,0,0,2,0,6,6,1
10632,191183,fXZkHvfRnLNWddfTwlt8RK2cRTiOmg3N,A3fsA9Zfv1X2fVEQhTw51lKENdNrEqT3,1,0,0,0,0,0,1,0,1,0.14285714285714285,1,0.0,0,0,0,0,0,0,0,1,0,0,1,1
10633,191190,aapkW8QMW8TztGeQlTnDfKEKcZX1vbn1,G8EPVSXsOYB5YQWZGiz1aVq5Pgr2GrQu,13,9,5,0,3,4,15,3,39,5.571428571428571,2,0.0,0,5,0,3,9,4,0,15,3,8,31,1
10634,191209,p8HUn53OHQxlBbPvpqicSSSkhMnoLuUk,A3fsA9Zfv1X2fVEQhTw51lKENdNrEqT3,1,0,0,0,0,0,1,0,1,0.14285714285714285,1,0.0,0,0,0,0,0,0,0,1,0,0,1,1
10635,191216,Rrclmw0iWTQ4R8VbZgEecyKPKpTh2o7K,SpATywNh6bZuzm8s1ceuBUnMUAeoAHHw,6,2,0,0,0,12,9,4,27,3.857142857142857,1,0.0,0,0,0,0,2,12,0,9,4,0,27,1
10636,191217,ecMZFfPrfYojsNqJQgwYc4hJSMzDZMZK,A3fsA9Zfv1X2fVEQhTw51lKENdNrEqT3,3,0,0,0,0,0,5,0,5,0.7142857142857143,2,0.0,0,0,0,0,0,0,0,5,0,0,5,1
10637,191224,3g91EUZkauWqcKpU9xr8zVzrn0H8G1A9,bWdj2GDclj5ofokWjzoa5jAwMkxCykd6,1,0,0,0,0,0,1,0,1,0.14285714285714285,1,0.0,0,0,0,0,0,0,0,1,0,0,1,1
10638,191240,z79FxI6IxKXksSKIwsXSYM1kOlaP8f6r,SpATywNh6bZuzm8s1ceuBUnMUAeoAHHw,4,5,0,0,0,0,1,0,6,0.8571428571428571,1,0.0,0,0,0,0,5,0,0,1,0,0,6,1
10639,191243,6lzjvaZGtQnKLrqzhDE3hBesO66bNsQN,SpATywNh6bZuzm8s1ceuBUnMUAeoAHHw,1,0,0,0,0,0,1,0,1,0.14285714285714285,1,0.0,0,0,0,0,0,0,0,1,0,0,1,1
10640,191248,Vl2QqZFE2XGfXDYVL2VXW5So0Zc5MScE,A3fsA9Zfv1X2fVEQhTw51lKENdNrEqT3,1,0,0,0,0,0,1,0,1,0.14285714285714285,1,0.0,0,0,0,0,0,0,0,1,0,0,1,1
10641,191266,eSnXFXUMyU3QpBQqVY71joco7MnEt79W,SpATywNh6bZuzm8s1ceuBUnMUAeoAHHw,8,5,1,0,1,0,2,0,9,1.2857142857142858,1,0.0,0,1,0,1,5,0,0,2,0,2,7,1
10642,191276,VFwcKDLRscQsLZ6sHhxlnjIEC63BsTj9,SpATywNh6bZuzm8s1ceuBUnMUAeoAHHw,5,5,0,0,0,0,1,0,6,0.8571428571428571,1,0.0,0,0,0,0,5,0,0,1,0,0,6,1
10643,191277,rqoGLMWp7ee8Ppu4OdHSBl6vmRxDZvKU,bWdj2GDclj5ofokWjzoa5jAwMkxCykd6,5,2,1,0,1,2,3,0,9,1.2857142857142858,1,0.0,0,1,0,1,2,2,0,3,0,2,7,1
10644,191282,ThbUQJBeO3JBYqtYMPK5UU7NNpR9FBno,SpATywNh6bZuzm8s1ceuBUnMUAeoAHHw,7,2,1,0,0,1,6,1,11,1.5714285714285714,1,0.0,0,1,0,0,2,1,0,6,1,1,10,1
10645,191294,bQTEZZd4jSi2B0W0A1TlEJEWBwzOd8zQ,SpATywNh6bZuzm8s1ceuBUnMUAeoAHHw,1,0,0,0,0,0,2,0,2,0.2857142857142857,1,0.0,0,0,0,0,0,0,0,2,0,0,2,1
10646,191295,kpqLFmJCsamYXFuknK3QXbLEc5jdZhta,RXDvfPUBYFlVdlueBFbLW0mhhAyGEqpt,1,0,0,0,0,0,1,0,1,0.14285714285714285,1,0.0,0,0,0,0,0,0,0,1,0,0,1,1
10647,191296,UfBZxbp3dHdvs4dmjpPF1a599SiVHfq9,SpATywNh6bZuzm8s1ceuBUnMUAeoAHHw,1,0,0,0,0,0,1,0,1,0.14285714285714285,1,0.0,0,0,0,0,0,0,0,1,0,0,1,1
10648,191301,UfBZxbp3dHdvs4dmjpPF1a599SiVHfq9,A3fsA9Zfv1X2fVEQhTw51lKENdNrEqT3,1,0,0,0,0,0,1,0,1,0.14285714285714285,1,0.0,0,0,0,0,0,0,0,1,0,0,1,0
10649,191326,bqKGVuyOqvCYIWLNoZkiDVBShCS1Solh,bWdj2GDclj5ofokWjzoa5jAwMkxCykd6,7,3,2,0,2,0,2,0,9,1.2857142857142858,1,0.0,0,2,0,2,3,0,0,2,0,4,5,1
10650,191328,d5HAnSQkztXQmCBt7mWJteYbuGp9eXK9,SpATywNh6bZuzm8s1ceuBUnMUAeoAHHw,17,11,5,16,3,1,6,1,43,6.142857142857143,1,0.0,4,5,13,3,7,1,3,6,1,25,18,0
10651,191333,u2lFPFqaHTPOsPVzurefGhIungrLsH3I,G8EPVSXsOYB5YQWZGiz1aVq5Pgr2GrQu,4,2,1,0,1,0,1,0,5,0.7142857142857143,1,0.0,0,1,0,1,2,0,0,1,0,2,3,1
10652,191336,2XCqRCsUPBJ1NAgHMrTgcxY6YdxrycrK,G8EPVSXsOYB5YQWZGiz1aVq5Pgr2GrQu,4,2,0,0,0,0,2,0,4,0.5714285714285714,1,0.0,0,0,0,0,2,0,0,2,0,0,4,1
10653,191348,SI69wwcTWVHmHvMK3iTZ6yjmoQxbU7l5,SpATywNh6bZuzm8s1ceuBUnMUAeoAHHw,10,12,0,22,0,8,5,1,48,6.857142857142857,1,0.0,6,0,20,0,6,8,2,5,1,26,22,1
10654,191352,9I8c8L7WQpD9ZtJRhVVfTlPNfkSlIEEb,SpATywNh6bZuzm8s1ceuBUnMUAeoAHHw,14,17,1,22,0,4,9,1,54,7.714285714285714,2,0.0,8,1,20,0,9,4,2,9,1,29,25,0
10655,191361,uvyVPWEsqLIlBRKFxrhWDmK1U2rKG8GE,SpATywNh6bZuzm8s1ceuBUnMUAeoAHHw,18,44,20,20,10,11,17,3,125,17.857142857142858,2,0.0,17,20,16,10,27,11,4,17,3,63,62,1
10656,191363,fayEZWE6L5NpkIRwMpEH7DP3Ho4nLIru,RXDvfPUBYFlVdlueBFbLW0mhhAyGEqpt,7,4,0,0,0,0,3,0,7,1.0,1,0.0,0,0,0,0,4,0,0,3,0,0,7,1
10657,191366,CRRYXyAc4ijr26PN9CuVczNnv8kJ91AK,SpATywNh6bZuzm8s1ceuBUnMUAeoAHHw,9,8,4,0,2,0,5,0,19,2.7142857142857144,1,0.0,2,4,0,2,6,0,0,5,0,8,11,1
10658,191379,Ieqd5itEcYJJN0R1exEtlEqnGZPAbCE6,bWdj2GDclj5ofokWjzoa5jAwMkxCykd6,4,3,1,0,1,0,1,0,6,0.8571428571428571,1,0.0,0,1,0,1,3,0,0,1,0,2,4,1
10659,191384,dmUrk0xMCS6SDyaouVCuyhAM6JJFFbys,SpATywNh6bZuzm8s1ceuBUnMUAeoAHHw,5,3,0,0,0,2,4,0,9,1.2857142857142858,1,0.0,0,0,0,0,3,2,0,4,0,0,9,1
10660,191389,smdC4Gk5L0XnGuMq4y1IOb0E2yVqYROb,SpATywNh6bZuzm8s1ceuBUnMUAeoAHHw,3,0,0,0,0,1,2,0,3,0.42857142857142855,1,0.0,0,0,0,0,0,1,0,2,0,0,3,1
10661,191398,ArHJamcmypPdkqgLXvwA7Xp8QRSvXxlF,SpATywNh6bZuzm8s1ceuBUnMUAeoAHHw,7,3,2,0,2,0,2,0,9,1.2857142857142858,1,0.0,0,2,0,2,3,0,0,2,0,4,5,1
10662,191409,uIv1Q8Ye5xXUaFW9tumYDZDxTsrCfpst,SpATywNh6bZuzm8s1ceuBUnMUAeoAHHw,1,0,0,0,0,0,1,0,1,0.14285714285714285,1,0.0,0,0,0,0,0,0,0,1,0,0,1,1
10663,191419,S4sULDuFAQWAEdmQxVT34py82agUl29W,bWdj2GDclj5ofokWjzoa5jAwMkxCykd6,6,1,1,0,1,0,3,0,6,0.8571428571428571,1,0.0,0,1,0,1,1,0,0,3,0,2,4,1
10664,191424,dnQdmZcm7uKA0vljQm6kJeP4CqW8fiMU,SpATywNh6bZuzm8s1ceuBUnMUAeoAHHw,5,2,1,0,1,0,2,0,6,0.8571428571428571,1,0.0,0,1,0,1,2,0,0,2,0,2,4,1
10665,191440,y1w3D4hQ1692TSq31BiNSwe5l2ooxLrJ,SpATywNh6bZuzm8s1ceuBUnMUAeoAHHw,7,2,1,0,1,0,4,0,8,1.1428571428571428,1,0.0,0,1,0,1,2,0,0,4,0,2,6,1
10666,191458,N9XRkzLdEnO1yDrNCc5jLvv7TriIRXAT,SpATywNh6bZuzm8s1ceuBUnMUAeoAHHw,9,4,2,0,1,0,8,1,16,2.2857142857142856,1,0.0,0,2,0,1,4,0,0,8,1,3,13,1
10667,191479,lcq8rKaAKyasaLAhf4XgwtdTDaLQpKXs,G8EPVSXsOYB5YQWZGiz1aVq5Pgr2GrQu,1,0,0,0,0,0,1,0,1,0.14285714285714285,1,0.0,0,0,0,0,0,0,0,1,0,0,1,1
10668,191482,qV9YvOiEawMvqxu18S9WhO9WLokOJG0e,SpATywNh6bZuzm8s1ceuBUnMUAeoAHHw,16,26,13,16,5,10,11,1,82,11.714285714285714,1,0.0,7,13,14,5,19,10,2,11,1,39,43,1
10669,191505,MRzfDn8Dt6xZQHTAuGEWQiuznoHxxpTX,G8EPVSXsOYB5YQWZGiz1aVq5Pgr2GrQu,1,0,0,0,0,0,1,0,1,0.14285714285714285,1,0.0,0,0,0,0,0,0,0,1,0,0,1,1
10670,191507,JIbJQhNgua4oE3gk86Jkguj8qmM444Gu,A3fsA9Zfv1X2fVEQhTw51lKENdNrEqT3,1,0,0,0,0,0,1,0,1,0.14285714285714285,1,0.0,0,0,0,0,0,0,0,1,0,0,1,1
10671,191531,zFJwABbnu7ecHOUlCE6eTmrBM1zbvMVg,SpATywNh6bZuzm8s1ceuBUnMUAeoAHHw,7,3,2,0,2,0,2,0,9,1.2857142857142858,1,0.0,0,2,0,2,3,0,0,2,0,4,5,1
10672,191534,wme4hkVddg0xzeatj2MinEZLWEQ5E7bR,SpATywNh6bZuzm8s1ceuBUnMUAeoAHHw,1,0,0,0,0,0,1,0,1,0.14285714285714285,1,0.0,0,0,0,0,0,0,0,1,0,0,1,1
10673,191545,xe9PdHtL47ijNdtrDmdC73RUGIc061NJ,SpATywNh6bZuzm8s1ceuBUnMUAeoAHHw,7,5,2,0,2,0,2,0,11,1.5714285714285714,1,0.0,0,2,0,2,5,0,0,2,0,4,7,1
10674,191560,lQY8mxQRqkTrX8U3ZBCC39fTp3ibXjgY,A3fsA9Zfv1X2fVEQhTw51lKENdNrEqT3,1,0,0,0,0,0,1,0,1,0.14285714285714285,1,0.0,0,0,0,0,0,0,0,1,0,0,1,1
10675,191562,LzUunErgfx3QBtzhgVcWGMItAqeQB5qb,bWdj2GDclj5ofokWjzoa5jAwMkxCykd6,10,20,7,44,8,0,16,0,95,13.571428571428571,2,0.0,3,7,42,8,17,0,2,16,0,60,35,1
10676,191570,8O8F8lqVhamnWAYoriozJh1JpqbQqAoe,SpATywNh6bZuzm8s1ceuBUnMUAeoAHHw,15,34,14,18,7,1,7,1,82,11.714285714285714,1,0.0,12,14,17,7,22,1,1,7,1,50,32,1
10677,191577,O9WtdqogfiBdd3zkscxK6K63kFz00EHp,SpATywNh6bZuzm8s1ceuBUnMUAeoAHHw,4,3,1,0,1,0,1,0,6,0.8571428571428571,1,0.0,0,1,0,1,3,0,0,1,0,2,4,1
10678,191578,BPpNiGtPp3VJWjhMdlZulJsFMsfFBZVO,SpATywNh6bZuzm8s1ceuBUnMUAeoAHHw,1,0,0,0,0,0,1,0,1,0.14285714285714285,1,0.0,0,0,0,0,0,0,0,1,0,0,1,1
10679,191579,ZP3SwNjKPikYYkMi8mCd8YXWyZ9QqocI,SpATywNh6bZuzm8s1ceuBUnMUAeoAHHw,15,13,6,16,5,0,6,0,46,6.571428571428571,1,0.0,6,6,13,5,7,0,3,6,0,30,16,1
10680,191585,7GKeqKRq8nTlHW07udIOaXEQQyokdI9X,G8EPVSXsOYB5YQWZGiz1aVq5Pgr2GrQu,12,9,5,6,5,0,2,0,27,3.857142857142857,1,0.0,3,5,3,5,6,0,3,2,0,16,11,1
10681,191591,PowQ1NVYMTVwKWPXrRw8LaXCisXsIuwA,SpATywNh6bZuzm8s1ceuBUnMUAeoAHHw,8,7,2,0,1,0,4,0,14,2.0,1,0.0,0,2,0,1,7,0,0,4,0,3,11,1
10682,191594,HaJu4RsCsmkTJbtFh34ypsakOUnNCikb,SpATywNh6bZuzm8s1ceuBUnMUAeoAHHw,1,0,0,0,0,0,1,0,1,0.14285714285714285,1,0.0,0,0,0,0,0,0,0,1,0,0,1,1
10683,191598,9Gr4ivUbGE9SyepAFZz19vI7kz7neHyv,SpATywNh6bZuzm8s1ceuBUnMUAeoAHHw,4,1,0,0,0,0,4,0,5,0.7142857142857143,1,0.0,0,0,0,0,1,0,0,4,0,0,5,1
10684,191608,K3reDywuca5r3zDnGu7WqoG47Og2VsxH,SpATywNh6bZuzm8s1ceuBUnMUAeoAHHw,8,10,5,0,2,1,12,0,30,4.285714285714286,1,0.0,0,5,0,2,10,1,0,12,0,7,23,0
10685,191621,01qQ2I7uJit5AcT5N3y2JZTjrStNpmSM,A3fsA9Zfv1X2fVEQhTw51lKENdNrEqT3,1,0,0,0,0,0,1,0,1,0.14285714285714285,1,0.0,0,0,0,0,0,0,0,1,0,0,1,1
10686,191628,WlHV3frRLxQmTIY14HccRXj4N1zg8F2y,bWdj2GDclj5ofokWjzoa5jAwMkxCykd6,1,0,0,0,0,0,1,0,1,0.14285714285714285,1,0.0,0,0,0,0,0,0,0,1,0,0,1,1
10687,191645,2m7SzUThbQ51vSBFUnCl1CYaMYSooUEI,bWdj2GDclj5ofokWjzoa5jAwMkxCykd6,4,2,1,0,1,0,1,0,5,0.7142857142857143,1,0.0,0,1,0,1,2,0,0,1,0,2,3,1
10688,191648,Xl3alXCSFw7Pm6L09eZSxygjyh6OTCwK,SpATywNh6bZuzm8s1ceuBUnMUAeoAHHw,7,4,2,0,2,1,2,0,11,1.5714285714285714,1,0.0,0,2,0,2,4,1,0,2,0,4,7,1
10689,191653,5MNPQvl4M43vX9Ck1VibapAl5kRKA0Ky,SpATywNh6bZuzm8s1ceuBUnMUAeoAHHw,5,3,1,0,1,0,1,0,6,0.8571428571428571,1,0.0,0,1,0,1,3,0,0,1,0,2,4,1
10690,191654,pOCc4XSnI7H8LGdDjvbS3fdE3PxuanE9,SpATywNh6bZuzm8s1ceuBUnMUAeoAHHw,4,2,1,0,1,2,2,0,8,1.1428571428571428,1,0.0,0,1,0,1,2,2,0,2,0,2,6,1
10691,191658,rrHRbXLg6i4u3JAIzGOFXJzGViekqHta,bWdj2GDclj5ofokWjzoa5jAwMkxCykd6,1,0,0,0,0,0,1,0,1,0.14285714285714285,1,0.0,0,0,0,0,0,0,0,1,0,0,1,1
10692,191667,jLTXtk76CIwYt4vY9Qrj5n40JdJeuHTk,SpATywNh6bZuzm8s1ceuBUnMUAeoAHHw,10,8,1,20,0,9,7,1,46,6.571428571428571,2,0.0,2,1,16,0,6,9,4,7,1,19,27,1
10693,191673,eEQqKnaUGHJzSnB7MrBGgZfDTYsV36xI,SpATywNh6bZuzm8s1ceuBUnMUAeoAHHw,5,2,1,0,1,0,2,0,6,0.8571428571428571,1,0.0,0,1,0,1,2,0,0,2,0,2,4,1
10694,191681,poTjed6dzFzOdJfGIhM72y1g95A9uYj5,SpATywNh6bZuzm8s1ceuBUnMUAeoAHHw,4,2,1,0,1,0,1,0,5,0.7142857142857143,1,0.0,0,1,0,1,2,0,0,1,0,2,3,1
10695,191683,hzmNiaPcq2EodwDNxyNnOX6tvxR9MJ1N,SpATywNh6bZuzm8s1ceuBUnMUAeoAHHw,5,2,1,0,1,0,2,0,6,0.8571428571428571,1,0.0,0,1,0,1,2,0,0,2,0,2,4,1
10696,191684,voXAnjlRro0uKeE7Bhzlc3B8ctN5va8G,A3fsA9Zfv1X2fVEQhTw51lKENdNrEqT3,1,0,0,0,0,0,1,0,1,0.14285714285714285,1,0.0,0,0,0,0,0,0,0,1,0,0,1,1
10697,191689,KNNMSW3oLxGqEqv2czanNkhQgdUkOWgY,SpATywNh6bZuzm8s1ceuBUnMUAeoAHHw,1,0,0,0,0,0,1,0,1,0.14285714285714285,1,0.0,0,0,0,0,0,0,0,1,0,0,1,1
10698,191694,WpYtemwKZQxcuLGpndx0lQojfh6o5GOv,A3fsA9Zfv1X2fVEQhTw51lKENdNrEqT3,1,0,0,0,0,0,1,0,1,0.14285714285714285,1,0.0,0,0,0,0,0,0,0,1,0,0,1,1
10699,191705,GfTG7Jl5LqR9ys6qGsGxQl3P09Y2SKWt,SpATywNh6bZuzm8s1ceuBUnMUAeoAHHw,6,4,1,0,1,0,2,0,8,1.1428571428571428,1,0.0,0,1,0,1,4,0,0,2,0,2,6,1
10700,191718,eIW9M0Trkt0EiuTzN2HuEtF6QnUOm4E9,G8EPVSXsOYB5YQWZGiz1aVq5Pgr2GrQu,1,0,0,0,0,0,1,0,1,0.14285714285714285,1,0.0,0,0,0,0,0,0,0,1,0,0,1,1
10701,191719,KFU9DDalEkLY57CnYLljzPh20kfkJgg1,SpATywNh6bZuzm8s1ceuBUnMUAeoAHHw,1,0,0,0,0,0,3,0,3,0.42857142857142855,1,0.0,0,0,0,0,0,0,0,3,0,0,3,1
10702,191736,7891kkT0UkgzTiNar1WxxiRFlwbJEBnB,SpATywNh6bZuzm8s1ceuBUnMUAeoAHHw,10,24,10,3,5,0,2,0,44,6.285714285714286,1,0.0,5,10,3,5,19,0,0,2,0,23,21,1
10703,191746,Yy2T8AQun3h4tOt3dyFcuzCw5XOF0cCp,SpATywNh6bZuzm8s1ceuBUnMUAeoAHHw,1,0,0,0,0,0,2,0,2,0.2857142857142857,1,0.0,0,0,0,0,0,0,0,2,0,0,2,1
10704,191756,Nw8BNhwzOdO3iOxqT3HR1nBiyOtFleo0,SpATywNh6bZuzm8s1ceuBUnMUAeoAHHw,1,0,0,0,0,0,1,0,1,0.14285714285714285,1,0.0,0,0,0,0,0,0,0,1,0,0,1,1
10705,191760,xdfT7UfbG0ewFi6FNN3zlNGBGpobyBrO,RXDvfPUBYFlVdlueBFbLW0mhhAyGEqpt,6,6,0,0,0,0,5,2,13,1.8571428571428572,1,0.0,0,0,0,0,6,0,0,5,2,0,13,1
10706,191773,LuPgMCIdX2ugHzDAngaEsA394qOat0id,A3fsA9Zfv1X2fVEQhTw51lKENdNrEqT3,11,10,5,0,1,0,6,0,22,3.142857142857143,2,0.0,0,5,0,1,10,0,0,6,0,6,16,1
10707,191798,HsUrz2Tvq8sRzoPDsx1zZZFVKu21a9Fj,A3fsA9Zfv1X2fVEQhTw51lKENdNrEqT3,1,0,0,0,0,0,1,0,1,0.14285714285714285,1,0.0,0,0,0,0,0,0,0,1,0,0,1,1
10708,191799,sxhiQuS3HfySJYy4LOfQjplyCzgTKScO,SpATywNh6bZuzm8s1ceuBUnMUAeoAHHw,7,8,4,0,0,0,6,3,21,3.0,1,0.0,0,4,0,0,8,0,0,6,3,4,17,1
10709,191802,kadlP2QWuFIFKLOUJo5sW8v7B7XAv9LQ,SpATywNh6bZuzm8s1ceuBUnMUAeoAHHw,5,3,1,0,1,0,2,0,7,1.0,1,0.0,0,1,0,1,3,0,0,2,0,2,5,1
10710,191804,MU4dVyJTD7iIRSTZIdJZ9VoLOxogfKQN,bWdj2GDclj5ofokWjzoa5jAwMkxCykd6,2,0,0,0,0,0,2,0,2,0.2857142857142857,1,0.0,0,0,0,0,0,0,0,2,0,0,2,1
10711,191808,QhgZ8WnXOcD5WE8AKIXP6yesa48bioAv,G8EPVSXsOYB5YQWZGiz1aVq5Pgr2GrQu,1,0,0,0,0,0,1,0,1,0.14285714285714285,1,0.0,0,0,0,0,0,0,0,1,0,0,1,1
10712,191812,glVCC77LfitTkPbkpypiclvPPbAnhs5Z,SpATywNh6bZuzm8s1ceuBUnMUAeoAHHw,1,0,0,0,0,0,1,0,1,0.14285714285714285,1,0.0,0,0,0,0,0,0,0,1,0,0,1,1
10713,191821,IERsxa1qtpNEp0IX6fqnPIs58eKAo4jM,RXDvfPUBYFlVdlueBFbLW0mhhAyGEqpt,3,2,1,0,0,0,1,0,4,0.5714285714285714,1,0.0,0,1,0,0,2,0,0,1,0,1,3,1
10714,191834,xFQWFF18peOPGJbc58SGDlEI5nMMZqZ4,SpATywNh6bZuzm8s1ceuBUnMUAeoAHHw,16,11,4,19,3,1,6,1,45,6.428571428571429,1,0.0,6,4,17,3,5,1,2,6,1,30,15,1
10715,191845,HL02PKMnOIDdiDp79NgTxbZJpjcKEWWT,SpATywNh6bZuzm8s1ceuBUnMUAeoAHHw,5,5,1,0,1,0,1,0,8,1.1428571428571428,1,0.0,0,1,0,1,5,0,0,1,0,2,6,1
10716,191893,F90BMBHCwVLSbJKgbHhGlOavE20yEHNs,SpATywNh6bZuzm8s1ceuBUnMUAeoAHHw,7,1,1,0,1,1,4,1,9,1.2857142857142858,1,0.0,0,1,0,1,1,1,0,4,1,2,7,1
10717,191919,eh0y0gctBGer07yOzwET1ULsjXcAMiHK,A3fsA9Zfv1X2fVEQhTw51lKENdNrEqT3,1,0,0,0,0,0,1,0,1,0.14285714285714285,1,0.0,0,0,0,0,0,0,0,1,0,0,1,1
10718,191927,e7i4vctFK9ije7n1OkadHlIYbLm8AOao,A3fsA9Zfv1X2fVEQhTw51lKENdNrEqT3,1,0,0,0,0,0,1,0,1,0.14285714285714285,1,0.0,0,0,0,0,0,0,0,1,0,0,1,1
10719,191930,Y0uNzgYoq3o4UIUWA7DyI9uIWevNL2UZ,SpATywNh6bZuzm8s1ceuBUnMUAeoAHHw,1,0,0,0,0,0,1,0,1,0.14285714285714285,1,0.0,0,0,0,0,0,0,0,1,0,0,1,1
10720,191936,pVHJZ63Y7JdfMuJUTvroL7qbSGOfkgFO,SpATywNh6bZuzm8s1ceuBUnMUAeoAHHw,1,0,0,0,0,0,1,0,1,0.14285714285714285,1,0.0,0,0,0,0,0,0,0,1,0,0,1,1
10721,191946,X14gKVD1ZKu0qL0NchpqxwhoYSEpz9QI,A3fsA9Zfv1X2fVEQhTw51lKENdNrEqT3,1,0,0,0,0,0,1,0,1,0.14285714285714285,1,0.0,0,0,0,0,0,0,0,1,0,0,1,1
10722,191949,5nY7bkwDkC2HlVFlWmyBFJRNx9a0SeRf,SpATywNh6bZuzm8s1ceuBUnMUAeoAHHw,6,6,2,0,1,0,2,0,11,1.5714285714285714,1,0.0,2,2,0,1,4,0,0,2,0,5,6,1
10723,191957,q8qv4J0WokPksYuUIg2pKKJs5I4YE8LL,bWdj2GDclj5ofokWjzoa5jAwMkxCykd6,7,5,3,0,1,0,4,0,13,1.8571428571428572,1,0.0,0,3,0,1,5,0,0,4,0,4,9,1
10724,191961,XirdNKPxR3QK6AqsS5xwiQuah55CHklz,SpATywNh6bZuzm8s1ceuBUnMUAeoAHHw,6,4,1,0,1,0,2,0,8,1.1428571428571428,1,0.0,0,1,0,1,4,0,0,2,0,2,6,1
10725,191970,guhTAC2wGHeGVbnCgc8qjrM4m2j0yBgB,bWdj2GDclj5ofokWjzoa5jAwMkxCykd6,7,5,2,0,3,0,3,0,13,1.8571428571428572,1,0.0,2,2,0,3,3,0,0,3,0,7,6,1
10726,191977,ECkqmAuIkv3ncN9wNJby8oOn15qTd9kR,SpATywNh6bZuzm8s1ceuBUnMUAeoAHHw,3,2,0,0,0,0,4,0,6,0.8571428571428571,2,0.0,0,0,0,0,2,0,0,4,0,0,6,1
10727,191981,1kpLB0DAS1b0ejanJYSedd5z8Kef2r9d,SpATywNh6bZuzm8s1ceuBUnMUAeoAHHw,6,5,3,0,2,0,3,0,13,1.8571428571428572,2,0.0,0,3,0,2,5,0,0,3,0,5,8,1
10728,191987,guhTAC2wGHeGVbnCgc8qjrM4m2j0yBgB,A3fsA9Zfv1X2fVEQhTw51lKENdNrEqT3,20,11,8,0,5,2,8,1,35,5.0,2,0.0,0,8,0,5,11,2,0,8,1,13,22,0
10729,191992,LW6zzfd6Z7RUZZtZGyYDx5y4SX3cBpdo,SpATywNh6bZuzm8s1ceuBUnMUAeoAHHw,4,6,0,0,0,0,3,0,9,1.2857142857142858,1,0.0,0,0,0,0,6,0,0,3,0,0,9,1
10730,192004,E3N8Ml469xlgFPJmAY5Sxe1V7qT3zvY6,SpATywNh6bZuzm8s1ceuBUnMUAeoAHHw,5,2,1,0,1,0,2,0,6,0.8571428571428571,1,0.0,0,1,0,1,2,0,0,2,0,2,4,1
10731,192005,co2tEDTUQOPBlFecfyW4CBakQdUodp0x,A3fsA9Zfv1X2fVEQhTw51lKENdNrEqT3,1,0,0,0,0,0,1,0,1,0.14285714285714285,1,0.0,0,0,0,0,0,0,0,1,0,0,1,1
10732,192010,tAelht5FQdpcbtZQoKgvZA90XQy6zeRb,SpATywNh6bZuzm8s1ceuBUnMUAeoAHHw,1,0,0,0,0,0,1,0,1,0.14285714285714285,1,0.0,0,0,0,0,0,0,0,1,0,0,1,1
10733,192012,br6ITMcvmAAwree2VNmUR9deXubPoM9q,G8EPVSXsOYB5YQWZGiz1aVq5Pgr2GrQu,3,0,0,0,0,0,3,0,3,0.42857142857142855,1,0.0,0,0,0,0,0,0,0,3,0,0,3,1
10734,192018,eotRm6Y2SbyKhVlLkGLDzSxdsKqSBO9y,SpATywNh6bZuzm8s1ceuBUnMUAeoAHHw,6,3,2,0,2,0,1,0,8,1.1428571428571428,1,0.0,0,2,0,2,3,0,0,1,0,4,4,1
10735,192024,Q12SmIgxAUIk1yKqjdfp0LXtJMgJdL9G,SpATywNh6bZuzm8s1ceuBUnMUAeoAHHw,6,3,2,0,2,0,1,0,8,1.1428571428571428,1,0.0,0,2,0,2,3,0,0,1,0,4,4,1
10736,192034,6BEGVp3lU36uMYUemMIuUfA5VThOFY5Z,SpATywNh6bZuzm8s1ceuBUnMUAeoAHHw,3,2,0,0,0,0,1,0,3,0.42857142857142855,1,0.0,0,0,0,0,2,0,0,1,0,0,3,0
10737,192039,JuuQdyakOE1dmJoAhQzVgyBgj45A1hjb,G8EPVSXsOYB5YQWZGiz1aVq5Pgr2GrQu,6,2,1,0,1,0,3,0,7,1.0,1,0.0,0,1,0,1,2,0,0,3,0,2,5,1
10738,192050,dQYdXrn6Y9f5Ts4mUHKMqkz2QoUbyo9u,SpATywNh6bZuzm8s1ceuBUnMUAeoAHHw,10,16,7,0,0,1,6,1,31,4.428571428571429,1,0.0,6,7,0,0,10,1,0,6,1,13,18,1
10739,192058,rv4ArbR8ug8w4z8sISrvrxALsLkp46Ty,bWdj2GDclj5ofokWjzoa5jAwMkxCykd6,6,23,0,0,0,0,5,0,28,4.0,1,0.0,4,0,0,0,19,0,0,5,0,4,24,1
10740,192065,FaNPo4Qqcy5TdmFUv8WUTRgDMV0ZgbCp,RXDvfPUBYFlVdlueBFbLW0mhhAyGEqpt,19,10,7,22,5,0,2,0,46,6.571428571428571,1,0.0,2,7,20,5,8,0,2,2,0,34,12,1
10741,192091,dmhkL35doRyRiXlb3XuDnJlpO05GLvg1,SpATywNh6bZuzm8s1ceuBUnMUAeoAHHw,4,3,1,0,1,0,2,0,7,1.0,1,0.0,0,1,0,1,3,0,0,2,0,2,5,1
10742,192098,LTXDIL613XcTInp5rf7qYUY6DFOgTe7d,G8EPVSXsOYB5YQWZGiz1aVq5Pgr2GrQu,6,4,1,0,2,0,7,0,14,2.0,1,0.0,2,1,0,2,2,0,0,7,0,5,9,0
10743,192109,BlzehVS9w06tJmaZKz9FlNz9VFUjaNUH,G8EPVSXsOYB5YQWZGiz1aVq5Pgr2GrQu,5,2,0,0,0,0,3,0,5,0.7142857142857143,1,0.0,0,0,0,0,2,0,0,3,0,0,5,1
10744,192117,TiNNJ9dGwnc8LtrTW4Oq8UzJGxXCWpRS,A3fsA9Zfv1X2fVEQhTw51lKENdNrEqT3,1,0,0,0,0,0,1,0,1,0.14285714285714285,1,0.0,0,0,0,0,0,0,0,1,0,0,1,1
10745,192125,PhoKgDlJTLmZpXJ7XlrprWN3ANMNNAAs,SpATywNh6bZuzm8s1ceuBUnMUAeoAHHw,7,3,1,0,1,0,5,0,10,1.4285714285714286,1,0.0,0,1,0,1,3,0,0,5,0,2,8,1
10746,192134,vsDIa2pTzMsANsuFnkRlfs0CNdNFRShO,bWdj2GDclj5ofokWjzoa5jAwMkxCykd6,1,0,0,0,0,0,1,0,1,0.14285714285714285,1,0.0,0,0,0,0,0,0,0,1,0,0,1,1
10747,192141,vsDIa2pTzMsANsuFnkRlfs0CNdNFRShO,RXDvfPUBYFlVdlueBFbLW0mhhAyGEqpt,1,0,0,0,0,0,1,0,1,0.14285714285714285,1,0.0,0,0,0,0,0,0,0,1,0,0,1,1
10748,192147,luNGlNTmJ26UVXohAPNf4yZNgIUDcpxK,RXDvfPUBYFlVdlueBFbLW0mhhAyGEqpt,1,0,0,0,0,0,1,0,1,0.14285714285714285,1,0.0,0,0,0,0,0,0,0,1,0,0,1,1
10749,192149,kz806LJqSjCWsOsMbb4QF8SkTWd8OARr,bWdj2GDclj5ofokWjzoa5jAwMkxCykd6,5,2,0,0,0,0,9,0,11,1.5714285714285714,1,0.0,0,0,0,0,2,0,0,9,0,0,11,1
10750,192150,luNGlNTmJ26UVXohAPNf4yZNgIUDcpxK,A3fsA9Zfv1X2fVEQhTw51lKENdNrEqT3,1,0,0,0,0,0,1,0,1,0.14285714285714285,1,0.0,0,0,0,0,0,0,0,1,0,0,1,1
10751,192176,UAWEvfipqNVrtAY7A1ItWPIZCE9n4bC0,A3fsA9Zfv1X2fVEQhTw51lKENdNrEqT3,1,0,0,0,0,0,1,0,1,0.14285714285714285,1,0.0,0,0,0,0,0,0,0,1,0,0,1,1
10752,192185,REBUdT3PdwenVsbHSd8vx9j28veewpFY,G8EPVSXsOYB5YQWZGiz1aVq5Pgr2GrQu,1,0,0,0,0,0,3,0,3,0.42857142857142855,1,0.0,0,0,0,0,0,0,0,3,0,0,3,1
10753,192186,JQ24AQoZsOQkDbcWerb6XGxtCwcxcjqd,SpATywNh6bZuzm8s1ceuBUnMUAeoAHHw,4,2,0,0,0,0,2,0,4,0.5714285714285714,1,0.0,0,0,0,0,2,0,0,2,0,0,4,1
10754,192194,lHTZAvBbd0zcUoZ0ZCqy0WxYTp3sveXN,SpATywNh6bZuzm8s1ceuBUnMUAeoAHHw,3,2,0,0,0,0,1,0,3,0.42857142857142855,1,0.0,0,0,0,0,2,0,0,1,0,0,3,1
10755,192209,Qws7jSORIWaamW2WkksSfXYG3Zz7g3Xb,SpATywNh6bZuzm8s1ceuBUnMUAeoAHHw,5,2,1,0,1,0,3,0,7,1.0,1,0.0,0,1,0,1,2,0,0,3,0,2,5,1
10756,192216,WqVnvIDeqK0FV6SVy7LE13jQheJAXDUI,SpATywNh6bZuzm8s1ceuBUnMUAeoAHHw,6,3,0,0,1,0,2,0,6,0.8571428571428571,1,0.0,0,0,0,1,3,0,0,2,0,1,5,1
10757,192217,AcQwcLzGnWU6HJG1JegBGJmpymCdTsiJ,SpATywNh6bZuzm8s1ceuBUnMUAeoAHHw,1,0,0,0,0,0,1,0,1,0.14285714285714285,1,0.0,0,0,0,0,0,0,0,1,0,0,1,1
10758,192223,DtCbpRVw6ZPHzvqt3yEtockBy9bOvWMU,SpATywNh6bZuzm8s1ceuBUnMUAeoAHHw,15,31,9,18,5,0,3,0,66,9.428571428571429,1,0.0,13,9,16,5,18,0,2,3,0,43,23,1
10759,192225,RFIYCucE5KCs9Bz4puoVDGPVmKoCQR4H,SpATywNh6bZuzm8s1ceuBUnMUAeoAHHw,1,0,0,0,0,0,1,0,1,0.14285714285714285,1,0.0,0,0,0,0,0,0,0,1,0,0,1,1
10760,192230,SMcFR1tzrGAErGanrAOTaiQacFJ5UscL,SpATywNh6bZuzm8s1ceuBUnMUAeoAHHw,6,2,1,0,1,0,3,1,8,1.1428571428571428,1,0.0,0,1,0,1,2,0,0,3,1,2,6,1
10761,192233,Av0so8JeZkL37S3USay6JyAc2H9w3WcS,SpATywNh6bZuzm8s1ceuBUnMUAeoAHHw,8,8,1,0,1,0,2,0,12,1.7142857142857142,1,0.0,1,1,0,1,7,0,0,2,0,3,9,1
10762,192236,4WRiJt7yDLRdAnLXyL07imUb9PD066er,SpATywNh6bZuzm8s1ceuBUnMUAeoAHHw,7,1,1,0,1,1,9,3,16,2.2857142857142856,2,0.0,0,1,0,1,1,1,0,9,3,2,14,1
10763,192247,HR02YAHzGFr2hdShoIiTumT2tyoMXoiF,SpATywNh6bZuzm8s1ceuBUnMUAeoAHHw,7,5,0,0,0,0,5,1,11,1.5714285714285714,2,0.0,0,0,0,0,5,0,0,5,1,0,11,1
10764,192248,Qb1CgQ8SxoQQTE8swhxPBVi0nI23eAzb,bWdj2GDclj5ofokWjzoa5jAwMkxCykd6,11,21,9,16,6,1,6,1,60,8.571428571428571,2,0.0,3,9,16,6,18,1,0,6,1,34,26,1
10765,192253,HTVs7V0e4g4fF28WOVqp2vXklALtMpIX,RXDvfPUBYFlVdlueBFbLW0mhhAyGEqpt,1,0,0,0,0,0,1,0,1,0.14285714285714285,1,0.0,0,0,0,0,0,0,0,1,0,0,1,1
10766,192265,NE6VVAXhm16C7ZaHLYFeGaAbJXqSbS5P,SpATywNh6bZuzm8s1ceuBUnMUAeoAHHw,1,0,0,0,0,0,1,0,1,0.14285714285714285,1,0.0,0,0,0,0,0,0,0,1,0,0,1,1
10767,192272,AE77uBYkDOA4olq3PELAlnphtU2v0TDL,A3fsA9Zfv1X2fVEQhTw51lKENdNrEqT3,1,0,0,0,0,0,1,0,1,0.14285714285714285,1,0.0,0,0,0,0,0,0,0,1,0,0,1,1
10768,192281,oOq0KGCcuj3zSTyAkLmOA3bz1mpT4Cy2,SpATywNh6bZuzm8s1ceuBUnMUAeoAHHw,1,0,0,0,0,0,1,0,1,0.14285714285714285,1,0.0,0,0,0,0,0,0,0,1,0,0,1,1
10769,192285,DanoP5XpHODQZmwuFGZgNKBiu5nY9yH1,RXDvfPUBYFlVdlueBFbLW0mhhAyGEqpt,6,5,4,0,2,0,1,0,12,1.7142857142857142,1,0.0,0,4,0,2,5,0,0,1,0,6,6,1
10770,192293,k0fNZidBUd2gbryk31YveUTLLwvsjsHF,A3fsA9Zfv1X2fVEQhTw51lKENdNrEqT3,1,0,0,0,0,0,1,0,1,0.14285714285714285,1,0.0,0,0,0,0,0,0,0,1,0,0,1,1
10771,192300,4YD7ENfnhFTRFL7ILKgGgEPnhlw4hbFM,SpATywNh6bZuzm8s1ceuBUnMUAeoAHHw,6,3,1,0,1,0,2,0,7,1.0,1,0.0,0,1,0,1,3,0,0,2,0,2,5,1
10772,192306,ypGCuSMoTu4jFEklb1OmiXvUyZSt3GFy,A3fsA9Zfv1X2fVEQhTw51lKENdNrEqT3,1,0,0,0,0,0,1,0,1,0.14285714285714285,1,0.0,0,0,0,0,0,0,0,1,0,0,1,1
10773,192308,5Vw6FQuIrDyG4P6UKq7rbidOHP4recgB,SpATywNh6bZuzm8s1ceuBUnMUAeoAHHw,1,0,0,0,0,0,1,0,1,0.14285714285714285,1,0.0,0,0,0,0,0,0,0,1,0,0,1,1
10774,192310,pr4S9UwIGe9A49oNuW5UlWpQYB2ZSYV0,SpATywNh6bZuzm8s1ceuBUnMUAeoAHHw,2,0,0,0,0,0,2,0,2,0.2857142857142857,1,0.0,0,0,0,0,0,0,0,2,0,0,2,1
10775,192329,SgmklvgEB9LRwbyM7mjtFwPn2s1gjHGn,A3fsA9Zfv1X2fVEQhTw51lKENdNrEqT3,1,0,0,0,0,0,1,0,1,0.14285714285714285,1,0.0,0,0,0,0,0,0,0,1,0,0,1,1
10776,192356,3T8jD055VA7hJ3tuRSbjf4ntse0zAX7A,bWdj2GDclj5ofokWjzoa5jAwMkxCykd6,8,15,4,0,2,1,8,1,31,4.428571428571429,1,0.0,6,4,0,2,9,1,0,8,1,12,19,1
10777,192365,ooAUGXFOFAguQ9s1QlStBjM610gDeFBk,bWdj2GDclj5ofokWjzoa5jAwMkxCykd6,8,7,4,0,3,0,3,0,17,2.4285714285714284,1,0.0,0,4,0,3,7,0,0,3,0,7,10,1
10778,192376,JuG3mNYUQgxAVzPcc7Ar48FfL6xAPMUZ,SpATywNh6bZuzm8s1ceuBUnMUAeoAHHw,6,6,1,0,1,0,2,0,10,1.4285714285714286,1,0.0,3,1,0,1,3,0,0,2,0,5,5,1
10779,192381,cfgt4lcsD0BLDwVvHK3CK5jqeK8KZQhZ,SpATywNh6bZuzm8s1ceuBUnMUAeoAHHw,8,2,1,0,1,2,5,2,13,1.8571428571428572,1,0.0,0,1,0,1,2,2,0,5,2,2,11,1
10780,192384,eGRaiLXqwboqQlaTTQYr1FB1cM61jV4I,RXDvfPUBYFlVdlueBFbLW0mhhAyGEqpt,2,0,0,0,0,0,2,0,2,0.2857142857142857,1,0.0,0,0,0,0,0,0,0,2,0,0,2,1
10781,192402,waC8kf8PXJ6GslXvkly6fK7T4isyWaN7,bWdj2GDclj5ofokWjzoa5jAwMkxCykd6,11,6,4,0,3,3,8,1,25,3.5714285714285716,2,0.0,0,4,0,3,6,3,0,8,1,7,18,1
10782,192404,FmxPauZCcN5TsI90By7Uh5tN8Q2Qo10j,A3fsA9Zfv1X2fVEQhTw51lKENdNrEqT3,1,0,0,0,0,0,2,0,2,0.2857142857142857,1,0.0,0,0,0,0,0,0,0,2,0,0,2,1
10783,192407,RVzC5vQBqN30AW6Su7sjAfdP0iWczm3N,G8EPVSXsOYB5YQWZGiz1aVq5Pgr2GrQu,13,8,5,0,3,0,9,0,25,3.5714285714285716,1,0.0,0,5,0,3,8,0,0,9,0,8,17,1
10784,192413,1StpqFExawTnYrEXKci6A5cFxEzx53P4,RXDvfPUBYFlVdlueBFbLW0mhhAyGEqpt,3,3,1,0,0,0,1,0,5,0.7142857142857143,1,0.0,0,1,0,0,3,0,0,1,0,1,4,1
10785,192425,GyLB5V57I2KbnfFgZclSqyQAUY6eRpjt,bWdj2GDclj5ofokWjzoa5jAwMkxCykd6,1,0,0,0,0,0,1,0,1,0.14285714285714285,1,0.0,0,0,0,0,0,0,0,1,0,0,1,1
10786,192426,o4zmJwxCaOlZRS6sjq7iHLRJ7DThOMe1,G8EPVSXsOYB5YQWZGiz1aVq5Pgr2GrQu,7,5,1,0,1,0,2,0,9,1.2857142857142858,1,0.0,0,1,0,1,5,0,0,2,0,2,7,1
10787,192431,OZzcwN4ObB1Nk33MS2zCa76PywvXNHRC,SpATywNh6bZuzm8s1ceuBUnMUAeoAHHw,5,5,1,0,1,0,1,0,8,1.1428571428571428,1,0.0,0,1,0,1,5,0,0,1,0,2,6,1
10788,192434,c1BXmJNemroOPh6WUefTBD28s2WzSNwi,G8EPVSXsOYB5YQWZGiz1aVq5Pgr2GrQu,1,0,0,0,0,0,1,0,1,0.14285714285714285,1,0.0,0,0,0,0,0,0,0,1,0,0,1,1
10789,192441,s1qTQc7ciJLP829kxDx1Q2usdHCCY2Ax,SpATywNh6bZuzm8s1ceuBUnMUAeoAHHw,2,0,0,0,0,0,2,0,2,0.2857142857142857,1,0.0,0,0,0,0,0,0,0,2,0,0,2,1
10790,192449,IihMsyE33bR2W1CinvLERaFEike0N1tI,SpATywNh6bZuzm8s1ceuBUnMUAeoAHHw,1,0,0,0,0,0,1,0,1,0.14285714285714285,1,0.0,0,0,0,0,0,0,0,1,0,0,1,1
10791,192450,fm4PPCUPLg6L0eK2GymW6alb9TJFqvnn,SpATywNh6bZuzm8s1ceuBUnMUAeoAHHw,1,0,0,0,0,0,1,0,1,0.14285714285714285,1,0.0,0,0,0,0,0,0,0,1,0,0,1,1
10792,192464,FnLRbhWfyqv6yBzd4jhbaUJyw3LJoL3p,SpATywNh6bZuzm8s1ceuBUnMUAeoAHHw,1,0,0,0,0,0,1,0,1,0.14285714285714285,1,0.0,0,0,0,0,0,0,0,1,0,0,1,0
10793,192468,XKJKqrTlrk5aKXeVOrE6ycEvLm3u912L,SpATywNh6bZuzm8s1ceuBUnMUAeoAHHw,1,0,0,0,0,0,1,0,1,0.14285714285714285,1,0.0,0,0,0,0,0,0,0,1,0,0,1,1
10794,192471,D2lFXeOodglgSTRNVccRvVrNvHlYgfLJ,SpATywNh6bZuzm8s1ceuBUnMUAeoAHHw,1,0,0,0,0,0,1,0,1,0.14285714285714285,1,0.0,0,0,0,0,0,0,0,1,0,0,1,1
10795,192474,cRUmHDnCm3xvppfYUcJkwRqBBl5OBCgi,SpATywNh6bZuzm8s1ceuBUnMUAeoAHHw,1,0,0,0,0,0,1,0,1,0.14285714285714285,1,0.0,0,0,0,0,0,0,0,1,0,0,1,1
10796,194476,48cQDxCvkp2Kfh2llKaDd9ViunV47JS8,SpATywNh6bZuzm8s1ceuBUnMUAeoAHHw,4,3,0,0,0,0,2,0,5,0.7142857142857143,1,0.0,0,0,0,0,3,0,0,2,0,0,5,1
10797,194479,onTUKKbDoguwNYZBVtONhnnEUSuWUV8S,G8EPVSXsOYB5YQWZGiz1aVq5Pgr2GrQu,9,3,1,0,1,0,5,1,11,1.5714285714285714,1,0.0,0,1,0,1,3,0,0,5,1,2,9,1
10798,194483,uWA9XLuGA6XEQSt93Q0BaDvrrOLPsSDK,SpATywNh6bZuzm8s1ceuBUnMUAeoAHHw,7,3,2,0,2,0,2,0,9,1.2857142857142858,1,0.0,0,2,0,2,3,0,0,2,0,4,5,1
10799,194504,Idacmra5qZXQ5ItNCju8xTvAUotHMPrs,SpATywNh6bZuzm8s1ceuBUnMUAeoAHHw,6,8,5,0,0,1,5,0,19,2.7142857142857144,1,0.0,1,5,0,0,7,1,0,5,0,6,13,1
10800,194507,FlQozMQpruyYmAqeyZEzRE9TkM48Rlw4,RXDvfPUBYFlVdlueBFbLW0mhhAyGEqpt,4,2,1,0,1,0,1,0,5,0.7142857142857143,1,0.0,0,1,0,1,2,0,0,1,0,2,3,1
10801,194511,34PiVxaMQlPDCBhflVVNOJYBNiFJq4sd,G8EPVSXsOYB5YQWZGiz1aVq5Pgr2GrQu,4,2,0,0,0,0,2,0,4,0.5714285714285714,1,0.0,0,0,0,0,2,0,0,2,0,0,4,1
10802,194515,YwHqDHYDccXkxjPE1B044eDwvxiVBTeO,SpATywNh6bZuzm8s1ceuBUnMUAeoAHHw,3,2,1,0,0,0,1,0,4,0.5714285714285714,1,0.0,0,1,0,0,2,0,0,1,0,1,3,1
10803,194534,H3KvIatiAwzsCPQBVABALz431TkTR6tW,bWdj2GDclj5ofokWjzoa5jAwMkxCykd6,1,0,0,0,0,0,1,0,1,0.14285714285714285,1,0.0,0,0,0,0,0,0,0,1,0,0,1,1
10804,194544,p8BRO2js5DMFomuFhLGv1L7bXBEJtOjM,SpATywNh6bZuzm8s1ceuBUnMUAeoAHHw,2,0,0,0,0,0,3,0,3,0.42857142857142855,1,0.0,0,0,0,0,0,0,0,3,0,0,3,1
10805,194549,om0KjvovtBK0gZUSboAPRv5A6Jkm00Ei,G8EPVSXsOYB5YQWZGiz1aVq5Pgr2GrQu,1,0,0,0,0,0,2,0,2,0.2857142857142857,1,0.0,0,0,0,0,0,0,0,2,0,0,2,1
10806,194556,AsOrTv5l2WGfE3oCrdncC2RTwz7dm912,bWdj2GDclj5ofokWjzoa5jAwMkxCykd6,2,0,0,0,0,0,3,0,3,0.42857142857142855,1,0.0,0,0,0,0,0,0,0,3,0,0,3,1
10807,194581,XFUUwZmtEN3cKElSp0idT6cWlW88ytvr,SpATywNh6bZuzm8s1ceuBUnMUAeoAHHw,1,0,0,0,0,0,2,0,2,0.2857142857142857,1,0.0,0,0,0,0,0,0,0,2,0,0,2,1
10808,194597,MYuwori4SZLwwApulVomE37Zmv9CBJsc,SpATywNh6bZuzm8s1ceuBUnMUAeoAHHw,1,0,0,0,0,0,1,0,1,0.14285714285714285,1,0.0,0,0,0,0,0,0,0,1,0,0,1,1
10809,194619,8IMVGvB09WRKHeXEjWGkZOVu6CXmlVXA,G8EPVSXsOYB5YQWZGiz1aVq5Pgr2GrQu,1,0,0,0,0,0,1,0,1,0.14285714285714285,1,0.0,0,0,0,0,0,0,0,1,0,0,1,1
10810,194625,cDJMTZrtYqA5Zzp6GydZkLUzHLBofVka,G8EPVSXsOYB5YQWZGiz1aVq5Pgr2GrQu,6,2,1,0,1,5,4,0,13,1.8571428571428572,1,0.0,0,1,0,1,2,5,0,4,0,2,11,0
10811,194626,xxqm3MFvp9JeD1lH1hC9xIrY8O1L8Xjf,SpATywNh6bZuzm8s1ceuBUnMUAeoAHHw,3,2,0,0,0,1,1,0,4,0.5714285714285714,1,0.0,0,0,0,0,2,1,0,1,0,0,4,1
10812,194629,mRThjjGON0zU0Y2plEdpqVN16fEiXwSr,A3fsA9Zfv1X2fVEQhTw51lKENdNrEqT3,1,0,0,0,0,0,2,0,2,0.2857142857142857,1,0.0,0,0,0,0,0,0,0,2,0,0,2,1
10813,194632,mhoMg2u4vZZCHMZwVbOPSr9rKeZ90EyX,SpATywNh6bZuzm8s1ceuBUnMUAeoAHHw,1,0,0,0,0,0,1,0,1,0.14285714285714285,1,0.0,0,0,0,0,0,0,0,1,0,0,1,1
10814,194633,NLv4FgxnCzxez4sx4x5czDhMA2RThzip,G8EPVSXsOYB5YQWZGiz1aVq5Pgr2GrQu,11,8,1,0,1,0,3,0,13,1.8571428571428572,1,0.0,0,1,0,1,8,0,0,3,0,2,11,0
10815,194655,Ntq8V5vAbhpRqfZVmDonWfflMXALrE62,A3fsA9Zfv1X2fVEQhTw51lKENdNrEqT3,7,5,3,0,1,0,4,0,13,1.8571428571428572,1,0.0,0,3,0,1,5,0,0,4,0,4,9,1
10816,194658,YTC5509AOhIkCtNjrBmjv9Yv2oK29NsL,SpATywNh6bZuzm8s1ceuBUnMUAeoAHHw,6,1,1,0,1,0,3,0,6,0.8571428571428571,1,0.0,0,1,0,1,1,0,0,3,0,2,4,1
10817,194667,sbaCeCpavj6HRFMhWrWMN8T04nCg0Bj4,SpATywNh6bZuzm8s1ceuBUnMUAeoAHHw,4,3,1,0,1,0,2,0,7,1.0,1,0.0,0,1,0,1,3,0,0,2,0,2,5,1
10818,194668,1sJ6YPYoSHma92rhmUGAalTdAYX4i2lG,SpATywNh6bZuzm8s1ceuBUnMUAeoAHHw,7,5,3,0,3,0,2,0,13,1.8571428571428572,1,0.0,0,3,0,3,5,0,0,2,0,6,7,1
10819,194674,VK6VYsFJEy8hhWdKq52KmrJkO3b6jNbn,bWdj2GDclj5ofokWjzoa5jAwMkxCykd6,4,2,1,0,1,0,1,0,5,0.7142857142857143,1,0.0,0,1,0,1,2,0,0,1,0,2,3,1
10820,194677,D0i6ZcBzVub6eIaIAw4ckCiIW5ThBWQ4,A3fsA9Zfv1X2fVEQhTw51lKENdNrEqT3,1,0,0,0,0,0,1,0,1,0.14285714285714285,1,0.0,0,0,0,0,0,0,0,1,0,0,1,1
10821,194678,96DWLTPjQt7WYS8cwfEQ2OGqQgPivHHX,SpATywNh6bZuzm8s1ceuBUnMUAeoAHHw,6,5,4,0,2,2,3,0,16,2.2857142857142856,1,0.0,0,4,0,2,5,2,0,3,0,6,10,1
10822,194684,d5TfbEyt4nCHCAaoxySwtX2WVur5Z8A1,A3fsA9Zfv1X2fVEQhTw51lKENdNrEqT3,1,0,0,0,0,0,1,0,1,0.14285714285714285,1,0.0,0,0,0,0,0,0,0,1,0,0,1,1
10823,194685,1YrPSVRax2MbGnGgOZ0qdLQfDXuMb3FP,SpATywNh6bZuzm8s1ceuBUnMUAeoAHHw,4,2,1,0,1,0,1,0,5,0.7142857142857143,1,0.0,0,1,0,1,2,0,0,1,0,2,3,1
10824,194693,8TF2Yz03M0ctxPaKqQO9uTaRyGlE3FTS,bWdj2GDclj5ofokWjzoa5jAwMkxCykd6,1,0,0,0,0,0,1,0,1,0.14285714285714285,1,0.0,0,0,0,0,0,0,0,1,0,0,1,1
10825,194694,6Ypoz1HptUjxpuR7fZtuIow2vA2n53uM,A3fsA9Zfv1X2fVEQhTw51lKENdNrEqT3,1,0,0,0,0,0,1,0,1,0.14285714285714285,1,0.0,0,0,0,0,0,0,0,1,0,0,1,1
10826,194713,aMZE4hDrTfaO5VrIlGdTGgvjbzOnIun0,A3fsA9Zfv1X2fVEQhTw51lKENdNrEqT3,1,0,0,0,0,0,1,0,1,0.14285714285714285,1,0.0,0,0,0,0,0,0,0,1,0,0,1,1
10827,194719,wj7PR2dOTCSENZUxdS1JrjKR8466zZVl,bWdj2GDclj5ofokWjzoa5jAwMkxCykd6,8,2,1,0,1,1,6,1,12,1.7142857142857142,1,0.0,0,1,0,1,2,1,0,6,1,2,10,1
10828,194722,4rwe5BmciR8qkFj7YwyJ3a5aK2xp9xod,A3fsA9Zfv1X2fVEQhTw51lKENdNrEqT3,6,5,3,0,2,0,3,0,13,1.8571428571428572,1,0.0,0,3,0,2,5,0,0,3,0,5,8,1
10829,194729,yWWr0HnJqf4TxBLaD1ZmBW6mPdbU2NXV,SpATywNh6bZuzm8s1ceuBUnMUAeoAHHw,5,4,1,0,1,0,4,0,10,1.4285714285714286,1,0.0,0,1,0,1,4,0,0,4,0,2,8,1
10830,194733,MBzpq6BeyrKVsFmJlf8cgHZW8NmCppoM,bWdj2GDclj5ofokWjzoa5jAwMkxCykd6,5,2,1,0,1,0,2,0,6,0.8571428571428571,1,0.0,0,1,0,1,2,0,0,2,0,2,4,1
10831,194734,55FtCsTJdMN32PE70MZj9DHqTCxXeYP2,SpATywNh6bZuzm8s1ceuBUnMUAeoAHHw,6,3,2,0,2,0,1,0,8,1.1428571428571428,1,0.0,0,2,0,2,3,0,0,1,0,4,4,1
10832,194739,ivSdmGnxv1Uz6NLl4IGvBJeRY1HBPrVZ,SpATywNh6bZuzm8s1ceuBUnMUAeoAHHw,9,4,1,0,1,8,5,1,20,2.857142857142857,1,0.0,0,1,0,1,4,8,0,5,1,2,18,1
10833,194753,Bxz1zTHFCCx9o1kJA9B0Pzm3PnmqKxr5,A3fsA9Zfv1X2fVEQhTw51lKENdNrEqT3,7,3,2,0,2,0,2,0,9,1.2857142857142858,1,0.0,0,2,0,2,3,0,0,2,0,4,5,1
10834,194767,i4NsQYAbaUfmQ6n2VMTiVWggNWktkrDX,bWdj2GDclj5ofokWjzoa5jAwMkxCykd6,5,10,3,0,0,0,5,0,18,2.5714285714285716,1,0.0,0,3,0,0,10,0,0,5,0,3,15,0
10835,194779,KheifBHmTnDsYBIH7TBBDpXQ1Bd1UA3a,SpATywNh6bZuzm8s1ceuBUnMUAeoAHHw,1,0,0,0,0,0,1,0,1,0.14285714285714285,1,0.0,0,0,0,0,0,0,0,1,0,0,1,1
10836,194784,LDPCm5FHAiMLt4xJYeSbtfjm8D9WglxJ,SpATywNh6bZuzm8s1ceuBUnMUAeoAHHw,16,15,7,14,3,0,5,0,44,6.285714285714286,1,0.0,4,7,14,3,11,0,0,5,0,28,16,1
10837,194788,BH0g3wVCilU6qeEv507COxWXunEVyQCt,A3fsA9Zfv1X2fVEQhTw51lKENdNrEqT3,4,6,3,0,0,0,2,0,11,1.5714285714285714,1,0.0,0,3,0,0,6,0,0,2,0,3,8,1
10838,194803,YqqcH0qThFMdLP4k9i9U0gJ4gpbELjkv,SpATywNh6bZuzm8s1ceuBUnMUAeoAHHw,8,8,6,0,0,0,5,2,21,3.0,1,0.0,0,6,0,0,8,0,0,5,2,6,15,1
10839,194806,FF4dRvqzL3V5nW7v3NbN8PsUIVH4lz6F,SpATywNh6bZuzm8s1ceuBUnMUAeoAHHw,1,0,0,0,0,0,1,0,1,0.14285714285714285,1,0.0,0,0,0,0,0,0,0,1,0,0,1,1
10840,194807,tyVcDsPvN4UjeaGnK8HkYLM1DiaISxPh,A3fsA9Zfv1X2fVEQhTw51lKENdNrEqT3,10,10,5,0,1,12,13,0,41,5.857142857142857,2,0.0,2,5,0,1,8,12,0,13,0,8,33,1
10841,194810,mNLR1O6gqXF6Zqi4uIf130gITni9gN1A,SpATywNh6bZuzm8s1ceuBUnMUAeoAHHw,7,3,2,0,2,0,2,0,9,1.2857142857142858,1,0.0,0,2,0,2,3,0,0,2,0,4,5,0
10842,194813,pFd3DZfpKrECGIK8sknjrUy2fJFwKULW,G8EPVSXsOYB5YQWZGiz1aVq5Pgr2GrQu,2,0,0,0,0,0,3,0,3,0.42857142857142855,1,0.0,0,0,0,0,0,0,0,3,0,0,3,1
10843,194817,7HNfi5OY69fAwtBXY2Bx1G7GFcGZh7Ly,SpATywNh6bZuzm8s1ceuBUnMUAeoAHHw,1,0,0,0,0,0,1,0,1,0.14285714285714285,1,0.0,0,0,0,0,0,0,0,1,0,0,1,1
10844,194820,W3q5xabVGlYtHwCF6azkr4rDuBoAdzu5,SpATywNh6bZuzm8s1ceuBUnMUAeoAHHw,4,2,1,0,1,0,1,0,5,0.7142857142857143,1,0.0,0,1,0,1,2,0,0,1,0,2,3,1
10845,194822,oLy9nBdTYL8NCOYS922zyTRG6EziMvh0,SpATywNh6bZuzm8s1ceuBUnMUAeoAHHw,5,2,1,0,1,0,2,0,6,0.8571428571428571,1,0.0,0,1,0,1,2,0,0,2,0,2,4,1
10846,194837,h1POuqYbxnxgGkE4pWe2S8wS54aC8n19,SpATywNh6bZuzm8s1ceuBUnMUAeoAHHw,7,2,1,0,1,1,4,1,10,1.4285714285714286,1,0.0,0,1,0,1,2,1,0,4,1,2,8,1
10847,194844,V6I2tWMT4J6OaEfYWYGJXMvy6YbJ0vQk,RXDvfPUBYFlVdlueBFbLW0mhhAyGEqpt,1,0,0,0,0,0,1,0,1,0.14285714285714285,1,0.0,0,0,0,0,0,0,0,1,0,0,1,1
10848,194852,nq0fTUXEyf4zNsnzbVQxJGqu2ei3Zzxd,SpATywNh6bZuzm8s1ceuBUnMUAeoAHHw,1,0,0,0,0,0,1,0,1,0.14285714285714285,1,0.0,0,0,0,0,0,0,0,1,0,0,1,1
10849,194853,SSxnRLkRY8Nz6yCXbxisiyKLbaiWbjIK,bWdj2GDclj5ofokWjzoa5jAwMkxCykd6,1,0,0,0,0,0,1,0,1,0.14285714285714285,1,0.0,0,0,0,0,0,0,0,1,0,0,1,1
10850,194862,cW4Q7k8uorP2ZaATVwEYmHiYgqZDhGz3,SpATywNh6bZuzm8s1ceuBUnMUAeoAHHw,5,2,1,0,1,2,2,0,8,1.1428571428571428,1,0.0,0,1,0,1,2,2,0,2,0,2,6,1
10851,194870,4sHw1UrsiyaJNXlPeVCwFs89kPI7rFXb,RXDvfPUBYFlVdlueBFbLW0mhhAyGEqpt,1,0,0,0,0,0,1,0,1,0.14285714285714285,1,0.0,0,0,0,0,0,0,0,1,0,0,1,1
10852,194886,AYPzYs86vNA5oOhv1GafopaYTci4zq2u,SpATywNh6bZuzm8s1ceuBUnMUAeoAHHw,3,3,0,0,0,0,2,0,5,0.7142857142857143,1,0.0,0,0,0,0,3,0,0,2,0,0,5,1
10853,194887,QUGraFxtzCQNNKP2kQzaB6kauOeKIjbk,SpATywNh6bZuzm8s1ceuBUnMUAeoAHHw,5,2,1,0,1,0,2,0,6,0.8571428571428571,1,0.0,0,1,0,1,2,0,0,2,0,2,4,1
10854,194888,nfvdVPsl73HsB5v26CK2d3kpAhmyAPaZ,SpATywNh6bZuzm8s1ceuBUnMUAeoAHHw,2,0,0,0,0,0,2,0,2,0.2857142857142857,1,0.0,0,0,0,0,0,0,0,2,0,0,2,1
10855,194896,50aSuabL02e7lLNBHTRXsMQnBChV2lSX,SpATywNh6bZuzm8s1ceuBUnMUAeoAHHw,9,4,3,0,3,0,2,0,12,1.7142857142857142,1,0.0,0,3,0,3,4,0,0,2,0,6,6,0
10856,194907,r8kATVhVTFWwFIt4UfjEkmBJAJ9dIcZn,SpATywNh6bZuzm8s1ceuBUnMUAeoAHHw,11,10,3,0,1,6,8,2,30,4.285714285714286,1,0.0,4,3,0,1,6,6,0,8,2,8,22,1
10857,194908,FtHUJIDgcRIKvAk6G0aJG28BljfTCpR1,SpATywNh6bZuzm8s1ceuBUnMUAeoAHHw,3,0,0,0,0,2,2,0,4,0.5714285714285714,1,0.0,0,0,0,0,0,2,0,2,0,0,4,1
10858,194921,coZTr10eytnE55me2AxqRWq6qrVXEB7M,bWdj2GDclj5ofokWjzoa5jAwMkxCykd6,1,0,0,0,0,0,1,0,1,0.14285714285714285,1,0.0,0,0,0,0,0,0,0,1,0,0,1,1
10859,194930,4pOcM6UwGexWSApv8Q2hzDn3Wxf1tNaX,G8EPVSXsOYB5YQWZGiz1aVq5Pgr2GrQu,2,0,0,0,0,0,4,0,4,0.5714285714285714,1,0.0,0,0,0,0,0,0,0,4,0,0,4,1
10860,194932,XzsCpdFAPGr3HoHuPSOeqUJ9vrQ1cDvx,SpATywNh6bZuzm8s1ceuBUnMUAeoAHHw,1,0,0,0,0,0,1,0,1,0.14285714285714285,1,0.0,0,0,0,0,0,0,0,1,0,0,1,1
10861,194941,WOgCErvth3RYtZvlZwUgSVLnOS4A1Eul,SpATywNh6bZuzm8s1ceuBUnMUAeoAHHw,1,0,0,0,0,0,1,0,1,0.14285714285714285,1,0.0,0,0,0,0,0,0,0,1,0,0,1,1
10862,194948,gDo9M8HDbXmLQPxqqLTsn9N4ZUEPKvcn,SpATywNh6bZuzm8s1ceuBUnMUAeoAHHw,7,10,1,0,0,0,2,0,13,1.8571428571428572,1,0.0,3,1,0,0,7,0,0,2,0,4,9,1
10863,194949,88fLpsc97HhNfdaSPlKqNnhAVgW27BAo,SpATywNh6bZuzm8s1ceuBUnMUAeoAHHw,5,3,0,0,0,0,3,1,7,1.0,1,0.0,0,0,0,0,3,0,0,3,1,0,7,1
10864,194965,FuiskmcpMN6lu4pckLk8iCQBFUYbh2yw,G8EPVSXsOYB5YQWZGiz1aVq5Pgr2GrQu,6,3,1,0,1,0,2,0,7,1.0,1,0.0,0,1,0,1,3,0,0,2,0,2,5,1
10865,194968,Jx42Ejc8m7xjALEiD0Ys2DAnttPYIxMG,A3fsA9Zfv1X2fVEQhTw51lKENdNrEqT3,17,14,0,0,0,12,7,1,34,4.857142857142857,1,0.0,1,0,0,0,13,12,0,7,1,1,33,1
10866,194972,sESOR36K7nBM311FFRUj2nLw7gbYwiJz,SpATywNh6bZuzm8s1ceuBUnMUAeoAHHw,7,7,3,0,2,0,3,0,15,2.142857142857143,1,0.0,1,3,0,2,6,0,0,3,0,6,9,1
10867,194974,Io5gLr8QOxaBw8nFReloAXOpt3IlZ5WE,bWdj2GDclj5ofokWjzoa5jAwMkxCykd6,1,0,0,0,0,0,1,0,1,0.14285714285714285,1,0.0,0,0,0,0,0,0,0,1,0,0,1,1
10868,194975,Io5gLr8QOxaBw8nFReloAXOpt3IlZ5WE,A3fsA9Zfv1X2fVEQhTw51lKENdNrEqT3,1,0,0,0,0,0,1,0,1,0.14285714285714285,1,0.0,0,0,0,0,0,0,0,1,0,0,1,1
10869,194980,z2EPdF3qYcFLBwhpfABa73PTR23asQuU,A3fsA9Zfv1X2fVEQhTw51lKENdNrEqT3,9,3,1,0,1,2,7,1,15,2.142857142857143,1,0.0,0,1,0,1,3,2,0,7,1,2,13,1
10870,194982,1GEou0jUAwSZvf4K9js5E10dDnbmQpAC,A3fsA9Zfv1X2fVEQhTw51lKENdNrEqT3,8,2,1,0,1,0,5,1,10,1.4285714285714286,1,0.0,0,1,0,1,2,0,0,5,1,2,8,1
10871,194988,uiws4KxaJyhkKSkkHMDme11rXJg9xyaL,SpATywNh6bZuzm8s1ceuBUnMUAeoAHHw,11,13,7,0,4,2,13,1,40,5.714285714285714,1,0.0,3,7,0,4,10,2,0,13,1,14,26,1
10872,195002,LfNMIOZFn9FNdYWiUKFIdgjlnXx6yIVQ,SpATywNh6bZuzm8s1ceuBUnMUAeoAHHw,12,14,1,2,1,0,6,0,24,3.4285714285714284,1,0.0,0,1,2,1,14,0,0,6,0,4,20,1
10873,195013,Y8EaHrodQDFZUcVDuYNEubkGRhsaWq8Y,RXDvfPUBYFlVdlueBFbLW0mhhAyGEqpt,6,0,0,0,0,0,10,3,13,1.8571428571428572,1,0.0,0,0,0,0,0,0,0,10,3,0,13,1
10874,195022,0FxfzBL8lExhKYYcGcci82l6xBLomyet,SpATywNh6bZuzm8s1ceuBUnMUAeoAHHw,9,5,4,0,4,0,3,0,16,2.2857142857142856,1,0.0,0,4,0,4,5,0,0,3,0,8,8,1
10875,195029,3bqYNHEttQnrSXCOjNHPi8cuvQEsNCSU,bWdj2GDclj5ofokWjzoa5jAwMkxCykd6,1,0,0,0,0,0,1,0,1,0.14285714285714285,1,0.0,0,0,0,0,0,0,0,1,0,0,1,1
10876,195031,2wS8JVpw1CsKg56Cx9G9VOnhu3l1G4I0,SpATywNh6bZuzm8s1ceuBUnMUAeoAHHw,17,21,11,15,4,9,8,2,70,10.0,1,0.0,4,11,14,4,17,9,1,8,2,33,37,1
10877,195033,IPw8SBo730f13L9fdyPJQsRb6dxi5glI,G8EPVSXsOYB5YQWZGiz1aVq5Pgr2GrQu,7,6,0,0,0,0,2,0,8,1.1428571428571428,1,0.0,0,0,0,0,6,0,0,2,0,0,8,1
10878,195036,A8zAoi2Uw9AkuLfLEgj43RiYhGLMNj18,SpATywNh6bZuzm8s1ceuBUnMUAeoAHHw,5,5,1,0,1,0,1,0,8,1.1428571428571428,1,0.0,0,1,0,1,5,0,0,1,0,2,6,1
10879,195039,I9J4QWiXHWCNKaic0XgJQZKgGASYH4yX,SpATywNh6bZuzm8s1ceuBUnMUAeoAHHw,7,6,4,0,3,0,1,0,14,2.0,1,0.0,0,4,0,3,6,0,0,1,0,7,7,1
10880,195040,B8Q6zzQbCDmmGJ2Jkpuj3FBNKJuawYVo,G8EPVSXsOYB5YQWZGiz1aVq5Pgr2GrQu,4,4,0,0,0,0,2,0,6,0.8571428571428571,1,0.0,0,0,0,0,4,0,0,2,0,0,6,1
10881,195057,NikqZ1qZg3zBUaGWiNf6mGXz34uqYANW,bWdj2GDclj5ofokWjzoa5jAwMkxCykd6,7,3,1,0,1,0,5,6,16,2.2857142857142856,1,0.0,1,1,0,1,2,0,0,5,6,3,13,1
10882,195059,4LHx8JspDAj57obmMYSAAyDYEzuHjEJP,A3fsA9Zfv1X2fVEQhTw51lKENdNrEqT3,2,0,0,0,0,0,2,0,2,0.2857142857142857,1,0.0,0,0,0,0,0,0,0,2,0,0,2,1
10883,195062,9YkZ5i0tAbds4GKPFoxObCx79Yv0yxVA,G8EPVSXsOYB5YQWZGiz1aVq5Pgr2GrQu,22,21,13,26,7,1,4,0,72,10.285714285714286,1,0.0,6,13,19,7,15,1,7,4,0,45,27,0
10884,195066,xsq0NNhfMlJSps1up5uJcRMXvgRrV0sJ,SpATywNh6bZuzm8s1ceuBUnMUAeoAHHw,1,0,0,0,0,0,1,0,1,0.14285714285714285,1,0.0,0,0,0,0,0,0,0,1,0,0,1,1
10885,195089,qX3w4IgztgXyu9swieirFObama3kJyza,SpATywNh6bZuzm8s1ceuBUnMUAeoAHHw,2,0,0,0,0,0,3,0,3,0.42857142857142855,1,0.0,0,0,0,0,0,0,0,3,0,0,3,1
10886,195091,L8lHLh6Mth1S7I3sErP5oDZD885a1BOh,SpATywNh6bZuzm8s1ceuBUnMUAeoAHHw,5,3,2,0,2,0,2,0,9,1.2857142857142858,1,0.0,0,2,0,2,3,0,0,2,0,4,5,1
10887,195092,aBOCGRJtSTLes0jxdeecmLlgi9rWLU2d,SpATywNh6bZuzm8s1ceuBUnMUAeoAHHw,4,1,0,0,0,0,3,0,4,0.5714285714285714,1,0.0,0,0,0,0,1,0,0,3,0,0,4,1
10888,195103,vxGkTn6WfGBki29hwuSV6Xuc1hbgzs4I,SpATywNh6bZuzm8s1ceuBUnMUAeoAHHw,1,0,0,0,0,0,1,0,1,0.14285714285714285,1,0.0,0,0,0,0,0,0,0,1,0,0,1,1
10889,195104,90Hur8PGj0IjqXgPOcR65ST1YxNz0ds7,A3fsA9Zfv1X2fVEQhTw51lKENdNrEqT3,12,9,3,0,2,0,7,1,22,3.142857142857143,2,0.0,0,3,0,2,9,0,0,7,1,5,17,1
10890,195119,aWAFF1Fze4LYlsUU8ERMTgVYzoyOI6Lv,SpATywNh6bZuzm8s1ceuBUnMUAeoAHHw,5,3,0,0,1,0,1,0,5,0.7142857142857143,1,0.0,0,0,0,1,3,0,0,1,0,1,4,1
10891,195127,jg3jOKfanNJPAzYxAIsKTejRcuHuYakD,SpATywNh6bZuzm8s1ceuBUnMUAeoAHHw,2,1,0,0,0,0,1,0,2,0.2857142857142857,1,0.0,0,0,0,0,1,0,0,1,0,0,2,1
10892,195132,TAT1t0HA0deInUIqMQU3qN2hNwJUolWn,SpATywNh6bZuzm8s1ceuBUnMUAeoAHHw,10,8,6,3,4,0,2,0,23,3.2857142857142856,1,0.0,1,6,3,4,7,0,0,2,0,14,9,1
10893,195149,lxP21JAeoGw4N8j8NgjQVcD64XYgvMHQ,SpATywNh6bZuzm8s1ceuBUnMUAeoAHHw,3,2,0,0,0,0,1,0,3,0.42857142857142855,1,0.0,0,0,0,0,2,0,0,1,0,0,3,1
10894,195158,YwfI8H5GXP8M3NnSeLcRy7i15qMPqaXk,SpATywNh6bZuzm8s1ceuBUnMUAeoAHHw,7,4,1,0,1,0,3,1,10,1.4285714285714286,1,0.0,0,1,0,1,4,0,0,3,1,2,8,1
10895,195169,S3f0JK9oaNTPyiRDrmkpSKmLckAAblqI,SpATywNh6bZuzm8s1ceuBUnMUAeoAHHw,6,5,3,0,1,0,1,0,10,1.4285714285714286,1,0.0,0,3,0,1,5,0,0,1,0,4,6,1
10896,195174,iXadVTWz0gSvLWs1uknu7xrsEL401uhz,SpATywNh6bZuzm8s1ceuBUnMUAeoAHHw,3,0,0,0,0,0,3,0,3,0.42857142857142855,1,0.0,0,0,0,0,0,0,0,3,0,0,3,1
10897,195175,02LTWEFxRPP3VB0zkhjBsebsLQ1XAvEO,G8EPVSXsOYB5YQWZGiz1aVq5Pgr2GrQu,1,0,0,0,0,0,1,0,1,0.14285714285714285,1,0.0,0,0,0,0,0,0,0,1,0,0,1,1
10898,195179,xEHo4X1rukdspRGBdfJyX5P4IZVyDEcz,SpATywNh6bZuzm8s1ceuBUnMUAeoAHHw,7,3,2,0,2,0,2,0,9,1.2857142857142858,1,0.0,0,2,0,2,3,0,0,2,0,4,5,1
10899,195184,NtEul7SVttJozgojuYe5lpg4GBGEyM2O,G8EPVSXsOYB5YQWZGiz1aVq5Pgr2GrQu,6,0,0,0,0,1,5,1,7,1.0,1,0.0,0,0,0,0,0,1,0,5,1,0,7,1
10900,195208,L2VtKU10xoYfk9AeXI4ucBlRANoxyJAj,SpATywNh6bZuzm8s1ceuBUnMUAeoAHHw,7,30,3,0,0,0,7,0,40,5.714285714285714,1,0.0,0,3,0,0,30,0,0,7,0,3,37,1
10901,195219,Nvud1QIhR4FBjW055r9HSxywupZk5GAR,RXDvfPUBYFlVdlueBFbLW0mhhAyGEqpt,10,6,1,0,1,0,6,3,17,2.4285714285714284,1,0.0,0,1,0,1,6,0,0,6,3,2,15,0
10902,195223,jtdJ8s2kyNzwf06KTNChcN9oAOS9ZmYk,A3fsA9Zfv1X2fVEQhTw51lKENdNrEqT3,8,5,2,0,2,0,3,0,12,1.7142857142857142,1,0.0,0,2,0,2,5,0,0,3,0,4,8,1
10903,195227,bONRCO0uATZ9orvOXASjWia0swY9AaMZ,A3fsA9Zfv1X2fVEQhTw51lKENdNrEqT3,6,2,1,0,1,0,8,0,12,1.7142857142857142,1,0.0,0,1,0,1,2,0,0,8,0,2,10,1
10904,195231,8qABUnBBHxxZkfUhEQNUn5NNMSRrqvPC,A3fsA9Zfv1X2fVEQhTw51lKENdNrEqT3,7,8,5,0,0,0,2,0,15,2.142857142857143,2,0.0,0,5,0,0,8,0,0,2,0,5,10,1
10905,195235,fIET0xNMcDIlnjd0AnC9TZEnn5s3AA6i,G8EPVSXsOYB5YQWZGiz1aVq5Pgr2GrQu,21,23,5,18,4,1,5,0,56,8.0,1,0.0,15,5,9,4,8,1,9,5,0,33,23,1
10906,195240,nhwZ1i3tBLPpKZ1jf7waw2ZZrzqPTraF,A3fsA9Zfv1X2fVEQhTw51lKENdNrEqT3,1,0,0,0,0,0,2,0,2,0.2857142857142857,1,0.0,0,0,0,0,0,0,0,2,0,0,2,1
10907,195246,hNV2TDc5kXTQn8foo4aRN6FCIXLNr4nn,SpATywNh6bZuzm8s1ceuBUnMUAeoAHHw,6,0,0,0,0,1,6,1,8,1.1428571428571428,1,0.0,0,0,0,0,0,1,0,6,1,0,8,1
10908,195253,K6R10YCm4EKgUGnQY53FYbuIV8YOCHd6,A3fsA9Zfv1X2fVEQhTw51lKENdNrEqT3,14,11,9,0,6,0,3,0,29,4.142857142857143,1,0.0,0,9,0,6,11,0,0,3,0,15,14,1
10909,195255,nFy3S5ktNxWHxSxQEsVxABtdYtTHm2QG,SpATywNh6bZuzm8s1ceuBUnMUAeoAHHw,10,6,1,6,0,0,5,0,18,2.5714285714285716,1,0.0,1,1,5,0,5,0,1,5,0,7,11,1
10910,195259,7dlRqTed9Vz3lG7sCkGqwL4Rf479l4Lf,SpATywNh6bZuzm8s1ceuBUnMUAeoAHHw,3,2,0,0,0,0,1,0,3,0.42857142857142855,1,0.0,0,0,0,0,2,0,0,1,0,0,3,1
10911,195260,sbaJoVFlMLyfg1PbRG67GWzU7ygSqHEa,G8EPVSXsOYB5YQWZGiz1aVq5Pgr2GrQu,4,6,0,0,0,0,4,0,10,1.4285714285714286,1,0.0,0,0,0,0,6,0,0,4,0,0,10,0
10912,195275,JIBg2bFQYc7ncSPQhvBWrAlcobShyiXA,SpATywNh6bZuzm8s1ceuBUnMUAeoAHHw,11,8,1,11,0,0,3,1,24,3.4285714285714284,1,0.0,2,1,10,0,6,0,1,3,1,13,11,1
10913,195278,8cxCnT3STAEth9x4HzjOcerWufkhGlX3,A3fsA9Zfv1X2fVEQhTw51lKENdNrEqT3,1,0,0,0,0,0,1,0,1,0.14285714285714285,1,0.0,0,0,0,0,0,0,0,1,0,0,1,1
10914,195303,ouhJVRUNWH7xFlD4xC7qUWcBbb5kOVSM,SpATywNh6bZuzm8s1ceuBUnMUAeoAHHw,7,3,0,0,0,0,8,0,11,1.5714285714285714,1,0.0,0,0,0,0,3,0,0,8,0,0,11,1
10915,195307,3PN3AyL6tfmtfTSkHxR5sSs7QxGCrkua,SpATywNh6bZuzm8s1ceuBUnMUAeoAHHw,1,0,0,0,0,0,1,0,1,0.14285714285714285,1,0.0,0,0,0,0,0,0,0,1,0,0,1,1
10916,195309,qqPuA4adS4zWJNjZeIJQCgaT64XJRtor,A3fsA9Zfv1X2fVEQhTw51lKENdNrEqT3,32,31,16,14,11,8,8,0,88,12.571428571428571,1,0.0,0,16,13,11,31,8,1,8,0,40,48,1
10917,195318,ee58foeX64HQVEJT3urOlMI7BjSHbs8j,G8EPVSXsOYB5YQWZGiz1aVq5Pgr2GrQu,5,5,0,0,0,0,4,0,9,1.2857142857142858,1,0.0,0,0,0,0,5,0,0,4,0,0,9,1
10918,195323,PQAJu1VB3GuaUzJI11vB182M1L2se1PX,SpATywNh6bZuzm8s1ceuBUnMUAeoAHHw,10,3,2,0,2,1,6,2,16,2.2857142857142856,1,0.0,0,2,0,2,3,1,0,6,2,4,12,1
10919,195326,0Si73COGxildPoctZYuOxLe1rgf9eDaM,RXDvfPUBYFlVdlueBFbLW0mhhAyGEqpt,8,3,1,0,1,0,3,0,8,1.1428571428571428,1,0.0,0,1,0,1,3,0,0,3,0,2,6,1
10920,195328,kKCWVPsmOCuRmD5n3b0FhPNIyXfeeMNV,SpATywNh6bZuzm8s1ceuBUnMUAeoAHHw,3,2,0,0,0,0,1,0,3,0.42857142857142855,1,0.0,0,0,0,0,2,0,0,1,0,0,3,1
10921,195336,cA8asOLHRHcK3Kr0VMyGtrDdcfovAiM5,A3fsA9Zfv1X2fVEQhTw51lKENdNrEqT3,21,11,10,0,8,0,3,0,32,4.571428571428571,1,0.0,1,10,0,8,10,0,0,3,0,19,13,1
10922,195357,rYmd6vnR5Pxkj69jVuGfihv9dJd27d4j,SpATywNh6bZuzm8s1ceuBUnMUAeoAHHw,7,3,2,0,2,0,2,0,9,1.2857142857142858,1,0.0,0,2,0,2,3,0,0,2,0,4,5,1
10923,195359,v4pwVH1VWldeBobir3iEqSHO6IoG1mdb,SpATywNh6bZuzm8s1ceuBUnMUAeoAHHw,14,17,6,12,4,0,2,0,41,5.857142857142857,1,0.0,4,6,11,4,13,0,1,2,0,25,16,1
10924,195361,v4pwVH1VWldeBobir3iEqSHO6IoG1mdb,A3fsA9Zfv1X2fVEQhTw51lKENdNrEqT3,10,9,3,0,3,0,2,0,17,2.4285714285714284,1,0.0,0,3,0,3,9,0,0,2,0,6,11,1
10925,195368,YPWJVK9ueaONJH89FoDwiyUXkyNj3an5,SpATywNh6bZuzm8s1ceuBUnMUAeoAHHw,7,3,2,0,2,0,2,0,9,1.2857142857142858,1,0.0,0,2,0,2,3,0,0,2,0,4,5,1
10926,195397,Px3zRsOzY6lifmzZgnqcwuqsaYej1KKL,A3fsA9Zfv1X2fVEQhTw51lKENdNrEqT3,1,0,0,0,0,0,1,0,1,0.14285714285714285,1,0.0,0,0,0,0,0,0,0,1,0,0,1,0
10927,195413,bvN6XOPoER6NVEf5NoGSs2X6xsEr92h3,SpATywNh6bZuzm8s1ceuBUnMUAeoAHHw,8,3,1,0,1,0,4,1,10,1.4285714285714286,1,0.0,0,1,0,1,3,0,0,4,1,2,8,1
10928,195423,5qPjBVti4pvxDDFGs1UFTjnAG1OLcLcB,RXDvfPUBYFlVdlueBFbLW0mhhAyGEqpt,3,2,0,0,0,0,1,0,3,0.42857142857142855,1,0.0,0,0,0,0,2,0,0,1,0,0,3,1
10929,195425,izM8opj3xJHFbPsERjrPScHIIGoVU3sL,SpATywNh6bZuzm8s1ceuBUnMUAeoAHHw,6,0,0,0,0,1,12,1,14,2.0,1,0.0,0,0,0,0,0,1,0,12,1,0,14,1
10930,195430,fHIOg4CLMDgqxwisMJ0FCaIJdtYNnnlj,SpATywNh6bZuzm8s1ceuBUnMUAeoAHHw,4,2,1,0,1,0,1,0,5,0.7142857142857143,1,0.0,0,1,0,1,2,0,0,1,0,2,3,1
10931,195432,LICyXxeZEgLwXHk4xrNu6rCpPIKDNqKx,bWdj2GDclj5ofokWjzoa5jAwMkxCykd6,4,0,0,0,0,2,3,1,6,0.8571428571428571,1,0.0,0,0,0,0,0,2,0,3,1,0,6,0
10932,195452,k57D5r1HBQsYTFYwjCvC4VLOFbsyC3KY,bWdj2GDclj5ofokWjzoa5jAwMkxCykd6,5,2,1,0,1,0,2,0,6,0.8571428571428571,1,0.0,0,1,0,1,2,0,0,2,0,2,4,1
10933,195453,k57D5r1HBQsYTFYwjCvC4VLOFbsyC3KY,A3fsA9Zfv1X2fVEQhTw51lKENdNrEqT3,9,4,3,0,3,0,2,0,12,1.7142857142857142,1,0.0,0,3,0,3,4,0,0,2,0,6,6,1
10934,195458,fp4riRNidjgqRkLYeMfperPsuliabiil,A3fsA9Zfv1X2fVEQhTw51lKENdNrEqT3,2,0,0,0,0,0,2,0,2,0.2857142857142857,1,0.0,0,0,0,0,0,0,0,2,0,0,2,1
10935,195463,Vc1baHxuYCOF9wXqOziB65UR0NyB8LSm,A3fsA9Zfv1X2fVEQhTw51lKENdNrEqT3,4,2,1,0,1,0,1,0,5,0.7142857142857143,1,0.0,0,1,0,1,2,0,0,1,0,2,3,1
10936,195471,VCHjbUg5mmZIrDffSGKLebg8S6dLXnyn,SpATywNh6bZuzm8s1ceuBUnMUAeoAHHw,2,0,0,0,0,0,2,0,2,0.2857142857142857,1,0.0,0,0,0,0,0,0,0,2,0,0,2,1
10937,195475,VCHjbUg5mmZIrDffSGKLebg8S6dLXnyn,RXDvfPUBYFlVdlueBFbLW0mhhAyGEqpt,2,0,0,0,0,0,2,0,2,0.2857142857142857,1,0.0,0,0,0,0,0,0,0,2,0,0,2,0
10938,195495,s6FY1tnJFeJCup1Eko54ROGWiTGeTtYm,bWdj2GDclj5ofokWjzoa5jAwMkxCykd6,1,0,0,0,0,0,1,0,1,0.14285714285714285,1,0.0,0,0,0,0,0,0,0,1,0,0,1,1
10939,195497,s6FY1tnJFeJCup1Eko54ROGWiTGeTtYm,A3fsA9Zfv1X2fVEQhTw51lKENdNrEqT3,2,0,0,0,0,0,2,0,2,0.2857142857142857,1,0.0,0,0,0,0,0,0,0,2,0,0,2,1
10940,195501,Sy7PnSgnanE6MmRmOk45JZv7731jQKG6,SpATywNh6bZuzm8s1ceuBUnMUAeoAHHw,4,3,0,0,0,0,3,0,6,0.8571428571428571,1,0.0,0,0,0,0,3,0,0,3,0,0,6,1
10941,195511,KzP79COW0J6jugsTdx8JCjyWx6PlJCcn,bWdj2GDclj5ofokWjzoa5jAwMkxCykd6,4,0,0,0,0,1,3,0,4,0.5714285714285714,1,0.0,0,0,0,0,0,1,0,3,0,0,4,1
10942,195530,OuoRlyFtQHB6CBdOhxOFsh6hGiNcDFNC,SpATywNh6bZuzm8s1ceuBUnMUAeoAHHw,1,0,0,0,0,0,1,0,1,0.14285714285714285,1,0.0,0,0,0,0,0,0,0,1,0,0,1,1
10943,195542,BXV7sGq2IrRSqCFuLKgoxpKYDPSPpUSj,SpATywNh6bZuzm8s1ceuBUnMUAeoAHHw,9,3,2,0,1,0,6,1,13,1.8571428571428572,1,0.0,0,2,0,1,3,0,0,6,1,3,10,1
10944,195544,BXV7sGq2IrRSqCFuLKgoxpKYDPSPpUSj,G8EPVSXsOYB5YQWZGiz1aVq5Pgr2GrQu,1,0,0,0,0,0,1,0,1,0.14285714285714285,1,0.0,0,0,0,0,0,0,0,1,0,0,1,1
10945,195552,xNnZt1wpctMu8RWBLbfzbKE1cqLvtEr3,G8EPVSXsOYB5YQWZGiz1aVq5Pgr2GrQu,1,0,0,0,0,0,1,0,1,0.14285714285714285,1,0.0,0,0,0,0,0,0,0,1,0,0,1,1
10946,195557,23A4h0mJIxgdd7Lfc0ogX2OGnwyxoL13,SpATywNh6bZuzm8s1ceuBUnMUAeoAHHw,5,9,1,0,1,0,1,0,12,1.7142857142857142,1,0.0,0,1,0,1,9,0,0,1,0,2,10,1
10947,195558,xUhDcXiX03QQg1jNR3Lksh9CrGcRUkPg,SpATywNh6bZuzm8s1ceuBUnMUAeoAHHw,1,0,0,0,0,0,1,0,1,0.14285714285714285,1,0.0,0,0,0,0,0,0,0,1,0,0,1,0
10948,195562,mfr902ctNImyZnb2hOpmu3P3IkYTM2W3,G8EPVSXsOYB5YQWZGiz1aVq5Pgr2GrQu,37,55,14,64,7,0,1,0,141,20.142857142857142,1,0.0,32,14,43,7,23,0,21,1,0,96,45,1
10949,195570,UcPGwduguQweVEpy1bHMRcDAVjaxDzZ7,G8EPVSXsOYB5YQWZGiz1aVq5Pgr2GrQu,7,3,2,0,2,0,2,0,9,1.2857142857142858,1,0.0,0,2,0,2,3,0,0,2,0,4,5,1
10950,195572,SSpeewBDHUNKkvUJM5ASinNHvMXIOEwr,A3fsA9Zfv1X2fVEQhTw51lKENdNrEqT3,2,0,0,0,0,2,2,0,4,0.5714285714285714,1,0.0,0,0,0,0,0,2,0,2,0,0,4,1
10951,197544,FySmfd2hS941zbI2PjxLl96G2jk3gIlQ,bWdj2GDclj5ofokWjzoa5jAwMkxCykd6,1,0,0,0,0,0,1,0,1,0.14285714285714285,1,0.0,0,0,0,0,0,0,0,1,0,0,1,1
10952,197561,1sxU5u2tB4cfcS6yRjPgL8Lbs961wxI1,A3fsA9Zfv1X2fVEQhTw51lKENdNrEqT3,1,0,0,0,0,0,1,0,1,0.14285714285714285,1,0.0,0,0,0,0,0,0,0,1,0,0,1,1
10953,197565,cSPs7Fdln4Ch49nnOhLrL6tMXQVWaRtw,SpATywNh6bZuzm8s1ceuBUnMUAeoAHHw,1,0,0,0,0,0,1,0,1,0.14285714285714285,1,0.0,0,0,0,0,0,0,0,1,0,0,1,1
10954,197581,3UIhyDBe2cVwfnPbxOe5VWApIlUgpsbX,bWdj2GDclj5ofokWjzoa5jAwMkxCykd6,1,0,0,0,0,0,1,0,1,0.14285714285714285,1,0.0,0,0,0,0,0,0,0,1,0,0,1,1
10955,197585,wrEd0NIQV39m2xEAHNuU1Ww6eryiacbC,SpATywNh6bZuzm8s1ceuBUnMUAeoAHHw,11,15,0,21,0,4,3,0,43,6.142857142857143,1,0.0,7,0,18,0,8,4,3,3,0,25,18,1
10956,197592,ECkqmAuIkv3ncN9wNJby8oOn15qTd9kR,RXDvfPUBYFlVdlueBFbLW0mhhAyGEqpt,1,0,0,0,0,0,2,0,2,0.2857142857142857,1,0.0,0,0,0,0,0,0,0,2,0,0,2,1
10957,197598,RCC0chPMKpWYHBcYuZNQFLP3RQicCreS,SpATywNh6bZuzm8s1ceuBUnMUAeoAHHw,2,0,0,0,0,0,3,0,3,0.42857142857142855,1,0.0,0,0,0,0,0,0,0,3,0,0,3,1
10958,197603,xOGjXyyeq87fCMSZ9z7Yuds9sMvR7Ohh,A3fsA9Zfv1X2fVEQhTw51lKENdNrEqT3,20,12,10,0,10,0,1,0,33,4.714285714285714,1,0.0,0,10,0,10,12,0,0,1,0,20,13,1
10959,197604,xWQhq9RZKw08hANIa0LgFXN2DnwycQf4,bWdj2GDclj5ofokWjzoa5jAwMkxCykd6,5,2,1,0,1,0,2,0,6,0.8571428571428571,1,0.0,0,1,0,1,2,0,0,2,0,2,4,1
10960,197622,d8GXnhJ8BgnDSKpTLyLaGdg2jK5wWL8e,G8EPVSXsOYB5YQWZGiz1aVq5Pgr2GrQu,27,31,11,10,12,0,9,0,73,10.428571428571429,1,0.0,17,11,6,12,14,0,4,9,0,46,27,1
10961,197629,pyv0DnRM0PUGZlRUjUkquPGtUI5wlNKd,bWdj2GDclj5ofokWjzoa5jAwMkxCykd6,3,0,0,0,0,0,3,0,3,0.42857142857142855,1,0.0,0,0,0,0,0,0,0,3,0,0,3,1
10962,197633,klchONEdPI3u3wOB4C8jNpM0hCX3C5RZ,RXDvfPUBYFlVdlueBFbLW0mhhAyGEqpt,24,23,17,7,12,0,4,0,63,9.0,1,0.0,3,17,7,12,20,0,0,4,0,39,24,1
10963,197640,ybqXs1BYgb66Ubmo4CtWBedAmyNUZkNR,SpATywNh6bZuzm8s1ceuBUnMUAeoAHHw,5,2,1,0,1,0,3,0,7,1.0,1,0.0,0,1,0,1,2,0,0,3,0,2,5,1
10964,197645,hbSZ24mH4oabI0uhhWxmu9uILNkjYUT4,SpATywNh6bZuzm8s1ceuBUnMUAeoAHHw,6,1,1,0,1,0,3,0,6,0.8571428571428571,1,0.0,0,1,0,1,1,0,0,3,0,2,4,1
10965,197658,VhMVe0e0vgyahnrJinzgUUFfkUYIGngP,bWdj2GDclj5ofokWjzoa5jAwMkxCykd6,1,0,0,0,0,0,1,0,1,0.14285714285714285,1,0.0,0,0,0,0,0,0,0,1,0,0,1,1
10966,197660,4fYqS5i8zH5iFL9FCzQ9Jw4wAZdnrAvU,RXDvfPUBYFlVdlueBFbLW0mhhAyGEqpt,8,5,4,0,2,0,1,0,12,1.7142857142857142,1,0.0,0,4,0,2,5,0,0,1,0,6,6,1
10967,197671,bRDOwsDzRQZuxjrOsoP53hDwwMbqZqej,SpATywNh6bZuzm8s1ceuBUnMUAeoAHHw,1,0,0,0,0,0,1,0,1,0.14285714285714285,1,0.0,0,0,0,0,0,0,0,1,0,0,1,1
10968,197673,f0YMm9i9boHqaqH06EMyOVgZ4eqVoTpv,SpATywNh6bZuzm8s1ceuBUnMUAeoAHHw,9,10,7,0,0,1,9,1,28,4.0,1,0.0,0,7,0,0,10,1,0,9,1,7,21,0
10969,197674,PpAhko9wN0CoGGKMK5cOihgQKnJKH7vJ,SpATywNh6bZuzm8s1ceuBUnMUAeoAHHw,1,0,0,0,0,0,1,0,1,0.14285714285714285,1,0.0,0,0,0,0,0,0,0,1,0,0,1,1
10970,197684,1oYUpAzbanZgtAfH9FWjQtyhbjb42Xx4,bWdj2GDclj5ofokWjzoa5jAwMkxCykd6,1,0,0,0,0,0,1,0,1,0.14285714285714285,1,0.0,0,0,0,0,0,0,0,1,0,0,1,1
10971,197685,1oYUpAzbanZgtAfH9FWjQtyhbjb42Xx4,RXDvfPUBYFlVdlueBFbLW0mhhAyGEqpt,1,0,0,0,0,0,1,0,1,0.14285714285714285,1,0.0,0,0,0,0,0,0,0,1,0,0,1,1
10972,197695,4fYqS5i8zH5iFL9FCzQ9Jw4wAZdnrAvU,bWdj2GDclj5ofokWjzoa5jAwMkxCykd6,4,2,1,0,1,0,1,0,5,0.7142857142857143,1,0.0,0,1,0,1,2,0,0,1,0,2,3,1
10973,197700,iKVVP8eq0ppb7OxMxmGwiOY8iziYmfHr,A3fsA9Zfv1X2fVEQhTw51lKENdNrEqT3,1,0,0,0,0,0,2,0,2,0.2857142857142857,1,0.0,0,0,0,0,0,0,0,2,0,0,2,1
10974,197708,HE0yFYNeyW3jGh5EhXv7uoc6O18ATk5R,A3fsA9Zfv1X2fVEQhTw51lKENdNrEqT3,19,10,8,0,8,0,1,0,27,3.857142857142857,1,0.0,0,8,0,8,10,0,0,1,0,16,11,1
10975,197723,A2szMVZ2xHQSx9WPUKhhkvBSuScZqBJF,A3fsA9Zfv1X2fVEQhTw51lKENdNrEqT3,13,7,5,0,5,0,1,0,18,2.5714285714285716,1,0.0,0,5,0,5,7,0,0,1,0,10,8,1
10976,197732,jqN3FAeYERU2lkKz9K4K9sLSZnaWl5Zg,SpATywNh6bZuzm8s1ceuBUnMUAeoAHHw,4,3,1,0,1,0,3,0,8,1.1428571428571428,1,0.0,0,1,0,1,3,0,0,3,0,2,6,1
10977,197737,HhuDqntCSTLCVngcOF2eAHqFrhEVuPmX,SpATywNh6bZuzm8s1ceuBUnMUAeoAHHw,4,2,0,0,0,0,2,0,4,0.5714285714285714,1,0.0,0,0,0,0,2,0,0,2,0,0,4,1
10978,197803,vtBnoyzeCC8wZr284IGH2R9KjVsQkSSy,SpATywNh6bZuzm8s1ceuBUnMUAeoAHHw,1,0,0,0,0,0,1,0,1,0.14285714285714285,1,0.0,0,0,0,0,0,0,0,1,0,0,1,1
10979,197827,mVLfrQRFV4YD7pibAFgNSJRdbeuiy0Sw,G8EPVSXsOYB5YQWZGiz1aVq5Pgr2GrQu,1,0,0,0,0,0,1,0,1,0.14285714285714285,1,0.0,0,0,0,0,0,0,0,1,0,0,1,1
10980,197843,1AZmjj77W8BIGEE1Hrm2nLFWlidLNL1Q,G8EPVSXsOYB5YQWZGiz1aVq5Pgr2GrQu,3,1,0,0,0,0,2,0,3,0.42857142857142855,1,0.0,0,0,0,0,1,0,0,2,0,0,3,1
10981,197860,kukBD4x4uH6xHKp8zwbeAlZ5XIJZfUlp,SpATywNh6bZuzm8s1ceuBUnMUAeoAHHw,5,2,1,0,1,0,2,0,6,0.8571428571428571,1,0.0,0,1,0,1,2,0,0,2,0,2,4,1
10982,197865,UmYxiFu6na7ioq4pFJaZYbHcM2Oxxqgd,SpATywNh6bZuzm8s1ceuBUnMUAeoAHHw,11,8,5,8,3,0,5,0,29,4.142857142857143,1,0.0,2,5,8,3,6,0,0,5,0,18,11,1
10983,197867,NvxM2w7KuHaUb4w9IwWeNWL1FPcoZWlg,SpATywNh6bZuzm8s1ceuBUnMUAeoAHHw,4,3,2,0,0,0,1,0,6,0.8571428571428571,1,0.0,0,2,0,0,3,0,0,1,0,2,4,1
10984,197891,ew6rgTKhfFlJk0TBM29erpe2hVQwpNiX,bWdj2GDclj5ofokWjzoa5jAwMkxCykd6,3,0,0,0,0,0,3,0,3,0.42857142857142855,1,0.0,0,0,0,0,0,0,0,3,0,0,3,1
10985,197901,3E2J8oODQN7NkqxkMAgArJcF2FBjPre3,G8EPVSXsOYB5YQWZGiz1aVq5Pgr2GrQu,10,5,3,0,3,0,4,0,15,2.142857142857143,1,0.0,0,3,0,3,5,0,0,4,0,6,9,1
10986,197903,quZIfUvhbgq4XxK5fzctoX77uKRPby0l,SpATywNh6bZuzm8s1ceuBUnMUAeoAHHw,5,4,1,0,1,0,1,0,7,1.0,1,0.0,0,1,0,1,4,0,0,1,0,2,5,1
10987,197906,kSxsrTO5exODRPeD7VJyPIeGcMKlqOQM,A3fsA9Zfv1X2fVEQhTw51lKENdNrEqT3,1,0,0,0,0,0,1,0,1,0.14285714285714285,1,0.0,0,0,0,0,0,0,0,1,0,0,1,1
10988,197912,OM3FARUmSrkVmJXDiM3P0y6LhqqplIHH,SpATywNh6bZuzm8s1ceuBUnMUAeoAHHw,6,2,1,0,1,0,4,0,8,1.1428571428571428,1,0.0,0,1,0,1,2,0,0,4,0,2,6,1
10989,197920,Jmn2E7XgQKFifDbJIxuDxMHLi4YpW3jx,G8EPVSXsOYB5YQWZGiz1aVq5Pgr2GrQu,3,0,0,0,0,4,2,0,6,0.8571428571428571,1,0.0,0,0,0,0,0,4,0,2,0,0,6,1
10990,197928,oqI20pdqFt40phk7jIrltWVMqWvZcban,A3fsA9Zfv1X2fVEQhTw51lKENdNrEqT3,1,0,0,0,0,0,1,0,1,0.14285714285714285,1,0.0,0,0,0,0,0,0,0,1,0,0,1,1
10991,197963,xp0PGlV4qhp60qYyxRe8xCxRmmPbM3Jj,bWdj2GDclj5ofokWjzoa5jAwMkxCykd6,1,0,0,0,0,0,4,0,4,0.5714285714285714,1,0.0,0,0,0,0,0,0,0,4,0,0,4,1
10992,197968,Kc8b3JW1MQKQC6TGWRiZEShHUO8QsHV5,SpATywNh6bZuzm8s1ceuBUnMUAeoAHHw,1,0,0,0,0,0,1,0,1,0.14285714285714285,1,0.0,0,0,0,0,0,0,0,1,0,0,1,1
10993,197975,xlZo0JM0E05KNiKs7UHaCnGkhTzmaKtg,SpATywNh6bZuzm8s1ceuBUnMUAeoAHHw,2,0,0,0,0,0,2,0,2,0.2857142857142857,1,0.0,0,0,0,0,0,0,0,2,0,0,2,1
10994,197977,WbJsJWqKM3lS43E1ayfblK0uOswvkrBy,bWdj2GDclj5ofokWjzoa5jAwMkxCykd6,2,0,0,0,0,0,3,0,3,0.42857142857142855,1,0.0,0,0,0,0,0,0,0,3,0,0,3,1
10995,197984,h4sY8Ph1vbc191O1JmHGbdnyocsoSDQO,G8EPVSXsOYB5YQWZGiz1aVq5Pgr2GrQu,5,10,1,0,0,0,3,0,14,2.0,1,0.0,0,1,0,0,10,0,0,3,0,1,13,1
10996,197985,qMtHlzOZxaTrhiGkJGWyjk6FQrkiMtpo,SpATywNh6bZuzm8s1ceuBUnMUAeoAHHw,4,3,0,0,0,0,3,0,6,0.8571428571428571,1,0.0,0,0,0,0,3,0,0,3,0,0,6,1
10997,197986,UZPajHzpSX5mbiv3Scxfu2s5ueCVoTcN,RXDvfPUBYFlVdlueBFbLW0mhhAyGEqpt,5,0,0,0,0,0,5,1,6,0.8571428571428571,1,0.0,0,0,0,0,0,0,0,5,1,0,6,1
10998,197990,EH79kaJEIeXcrssngPKoTUSLUCjHUazt,A3fsA9Zfv1X2fVEQhTw51lKENdNrEqT3,2,0,0,0,0,0,4,0,4,0.5714285714285714,1,0.0,0,0,0,0,0,0,0,4,0,0,4,1
10999,197996,6hX10Wu1E2KDRE7mYGP1VPoNRkdF7lrL,A3fsA9Zfv1X2fVEQhTw51lKENdNrEqT3,3,0,0,0,0,0,3,0,3,0.42857142857142855,1,0.0,0,0,0,0,0,0,0,3,0,0,3,0
11000,197999,NVzsLV2hJQHxCBnLyaDpT9HrhRSWUOfa,A3fsA9Zfv1X2fVEQhTw51lKENdNrEqT3,2,0,0,0,0,0,2,0,2,0.2857142857142857,1,0.0,0,0,0,0,0,0,0,2,0,0,2,1
11001,198002,Juod2UGp1EISVAlVAqDeLcVK1OmKMlrq,A3fsA9Zfv1X2fVEQhTw51lKENdNrEqT3,5,2,1,0,1,1,4,0,9,1.2857142857142858,1,0.0,0,1,0,1,2,1,0,4,0,2,7,1
11002,198015,G40CqBl9Wk8vBpLpRLZfdLIUELNw0IuK,bWdj2GDclj5ofokWjzoa5jAwMkxCykd6,11,20,7,32,6,1,8,0,74,10.571428571428571,1,0.0,8,7,30,6,12,1,2,8,0,51,23,1
11003,198020,mBkByOktWGTfbLjZh4oUEAyrYqB4PqkG,A3fsA9Zfv1X2fVEQhTw51lKENdNrEqT3,5,3,1,0,1,0,2,0,7,1.0,1,0.0,0,1,0,1,3,0,0,2,0,2,5,1
11004,198037,ptvJrZNOUMqIwb7dgd5momqDwhHuKgqy,A3fsA9Zfv1X2fVEQhTw51lKENdNrEqT3,1,0,0,0,0,0,1,0,1,0.14285714285714285,1,0.0,0,0,0,0,0,0,0,1,0,0,1,1
11005,198039,mBkByOktWGTfbLjZh4oUEAyrYqB4PqkG,bWdj2GDclj5ofokWjzoa5jAwMkxCykd6,7,7,2,10,1,0,2,0,22,3.142857142857143,1,0.0,2,2,9,1,5,0,1,2,0,14,8,1
11006,198040,hwsOMQoQpEm6hpx9rFynsAz9z0b8kZIy,SpATywNh6bZuzm8s1ceuBUnMUAeoAHHw,6,3,1,0,0,0,3,1,8,1.1428571428571428,1,0.0,0,1,0,0,3,0,0,3,1,1,7,1
11007,198057,ZPbUovw1YoDeaWUVrbGEj5A5WdIXTYjf,A3fsA9Zfv1X2fVEQhTw51lKENdNrEqT3,41,20,16,58,10,4,3,0,111,15.857142857142858,1,0.0,1,16,52,10,19,4,6,3,0,79,32,1
11008,198059,THP1XMjHSxStaFTc2EbpYMi7w0ocTWsv,A3fsA9Zfv1X2fVEQhTw51lKENdNrEqT3,2,0,0,0,0,0,2,0,2,0.2857142857142857,1,0.0,0,0,0,0,0,0,0,2,0,0,2,1
11009,198064,FmREEBmKaoWQV1gJ6HLZOzgC3kziEupI,SpATywNh6bZuzm8s1ceuBUnMUAeoAHHw,9,6,3,5,2,0,2,0,18,2.5714285714285716,1,0.0,2,3,4,2,4,0,1,2,0,11,7,1
11010,198072,ydSu1htsBf3RzcwY9UTcwNk58kfOh1CK,A3fsA9Zfv1X2fVEQhTw51lKENdNrEqT3,1,0,0,0,0,0,1,0,1,0.14285714285714285,1,0.0,0,0,0,0,0,0,0,1,0,0,1,1
11011,198075,Zh41FGMVAot9ISpRqN7C51AlQVbP6TRp,G8EPVSXsOYB5YQWZGiz1aVq5Pgr2GrQu,1,0,0,0,0,0,1,0,1,0.14285714285714285,1,0.0,0,0,0,0,0,0,0,1,0,0,1,1
11012,198089,1Y8zyxJNFqsbAxngaSR4MBCJMYy7aumA,A3fsA9Zfv1X2fVEQhTw51lKENdNrEqT3,1,0,0,0,0,0,1,0,1,0.14285714285714285,1,0.0,0,0,0,0,0,0,0,1,0,0,1,1
11013,198092,7qSkKlCfwbOANWGSAwfdpq7Q0evXlyXJ,A3fsA9Zfv1X2fVEQhTw51lKENdNrEqT3,2,0,0,0,0,0,2,0,2,0.2857142857142857,1,0.0,0,0,0,0,0,0,0,2,0,0,2,1
11014,198094,NVHlXFJKdfwucYR5YquGJkYfegUD35pC,bWdj2GDclj5ofokWjzoa5jAwMkxCykd6,1,0,0,0,0,0,1,0,1,0.14285714285714285,1,0.0,0,0,0,0,0,0,0,1,0,0,1,1
11015,198096,gQqEJZs7B37MmzRexP5otRszUHd2KLYy,A3fsA9Zfv1X2fVEQhTw51lKENdNrEqT3,18,11,9,0,7,0,4,0,31,4.428571428571429,1,0.0,0,9,0,7,11,0,0,4,0,16,15,1
11016,198102,UmMUmfW7iDbccQsjMsWCLdabczIvW3k8,G8EPVSXsOYB5YQWZGiz1aVq5Pgr2GrQu,10,20,7,10,4,0,4,0,45,6.428571428571429,1,0.0,10,7,6,4,10,0,4,4,0,27,18,1
11017,198108,tpRB0Y2odcJ8wbxdjaREs5gktwFdDR2h,A3fsA9Zfv1X2fVEQhTw51lKENdNrEqT3,46,72,30,82,21,41,15,3,264,37.714285714285715,1,0.0,1,30,64,21,71,41,18,15,3,116,148,1
11018,198110,Psbjgi8UNl2rcrsYIe1cv0JHA13unwqh,A3fsA9Zfv1X2fVEQhTw51lKENdNrEqT3,9,6,4,0,3,0,1,0,14,2.0,1,0.0,0,4,0,3,6,0,0,1,0,7,7,1
11019,198119,ivQxpA3T4qXcNV0IuvLDkzJLb00vpKY1,A3fsA9Zfv1X2fVEQhTw51lKENdNrEqT3,9,5,4,0,4,0,3,0,16,2.2857142857142856,1,0.0,0,4,0,4,5,0,0,3,0,8,8,1
11020,198123,Bobzv8PFDIeID7NJyzm72ZPzBi51TYoj,G8EPVSXsOYB5YQWZGiz1aVq5Pgr2GrQu,4,1,0,0,0,0,6,0,7,1.0,1,0.0,0,0,0,0,1,0,0,6,0,0,7,1
11021,198126,EuJrP6kozTqtmrZ2kvjKbbdLy1MAtd6Q,G8EPVSXsOYB5YQWZGiz1aVq5Pgr2GrQu,5,2,0,0,0,0,3,0,5,0.7142857142857143,1,0.0,0,0,0,0,2,0,0,3,0,0,5,1
11022,198127,NRHQ3tSUEv4DHf8jZg8RV7YWaKkLB0Yk,A3fsA9Zfv1X2fVEQhTw51lKENdNrEqT3,4,3,0,0,0,0,2,0,5,0.7142857142857143,1,0.0,1,0,0,0,2,0,0,2,0,1,4,1
11023,198148,PumYHOn9wm04kyhWSxqPbI3SWXpAfHRE,bWdj2GDclj5ofokWjzoa5jAwMkxCykd6,5,11,3,0,3,0,2,0,19,2.7142857142857144,1,0.0,4,3,0,3,7,0,0,2,0,10,9,1
11024,198151,1DCeTt0CkcmxoPvN3IFKoXhg62qIczOd,G8EPVSXsOYB5YQWZGiz1aVq5Pgr2GrQu,7,4,1,0,1,0,3,0,9,1.2857142857142858,1,0.0,0,1,0,1,4,0,0,3,0,2,7,1
11025,198157,BnOHUZJJ8tQ0RqiSOgsTvzjr9EqA1Ahw,A3fsA9Zfv1X2fVEQhTw51lKENdNrEqT3,2,0,0,0,0,0,4,0,4,0.5714285714285714,1,0.0,0,0,0,0,0,0,0,4,0,0,4,1
11026,198160,BAyN80jjR5TuHhGoBQcino62lPw8bhBn,A3fsA9Zfv1X2fVEQhTw51lKENdNrEqT3,8,7,5,0,3,0,5,0,20,2.857142857142857,1,0.0,0,5,0,3,7,0,0,5,0,8,12,1
11027,198164,Wm4d7ifDaTgcR0GfUqwJt5OZKbYglRCq,A3fsA9Zfv1X2fVEQhTw51lKENdNrEqT3,1,0,0,0,0,0,1,0,1,0.14285714285714285,1,0.0,0,0,0,0,0,0,0,1,0,0,1,1
11028,198174,sN8O8pu3Q2qKEwnDCRLYVlmO1uAJE4Tm,bWdj2GDclj5ofokWjzoa5jAwMkxCykd6,2,0,0,0,0,0,2,0,2,0.2857142857142857,1,0.0,0,0,0,0,0,0,0,2,0,0,2,1
11029,198185,sAxHVWDxoGkBRa6727BiAQz0xOxKCIGR,A3fsA9Zfv1X2fVEQhTw51lKENdNrEqT3,13,12,6,12,5,0,4,0,39,5.571428571428571,1,0.0,0,6,10,5,12,0,2,4,0,21,18,1
11030,198188,l5G8UW1TXnTSjtyKClgVOnqQm4ApNaj0,SpATywNh6bZuzm8s1ceuBUnMUAeoAHHw,1,0,0,0,0,0,1,0,1,0.14285714285714285,1,0.0,0,0,0,0,0,0,0,1,0,0,1,1
11031,198191,5bHmfN0X9wT3swMDlkpW5ii5MZXZrCFW,SpATywNh6bZuzm8s1ceuBUnMUAeoAHHw,15,22,6,19,4,2,4,0,57,8.142857142857142,1,0.0,15,6,16,4,7,2,3,4,0,41,16,1
11032,198193,LFKsM29SPdpn03mCOLrrK3FdXPUDZBKB,A3fsA9Zfv1X2fVEQhTw51lKENdNrEqT3,5,2,1,0,1,0,5,0,9,1.2857142857142858,1,0.0,0,1,0,1,2,0,0,5,0,2,7,1
11033,198197,SC8FL9WL3BPOx8OCkTnqw5xmr73Pqs8z,A3fsA9Zfv1X2fVEQhTw51lKENdNrEqT3,7,4,3,0,3,0,2,0,12,1.7142857142857142,1,0.0,0,3,0,3,4,0,0,2,0,6,6,1
11034,198198,93Os1dPmyvzf4unZeLzWAm1E98vamZ7f,SpATywNh6bZuzm8s1ceuBUnMUAeoAHHw,5,2,1,0,1,0,2,0,6,0.8571428571428571,1,0.0,0,1,0,1,2,0,0,2,0,2,4,1
11035,198209,xudoA9elSC5Ik0l8XT7ohHiAxUwBFTwg,SpATywNh6bZuzm8s1ceuBUnMUAeoAHHw,14,9,6,11,4,0,2,0,32,4.571428571428571,1,0.0,2,6,9,4,7,0,2,2,0,21,11,1
11036,198227,NXiIb9Dcpvf6m1gIchCaIvmdnXDXN6rC,A3fsA9Zfv1X2fVEQhTw51lKENdNrEqT3,21,10,9,0,9,1,12,1,42,6.0,1,0.0,0,9,0,9,10,1,0,12,1,18,24,1
11037,198228,So8gZ8cXseEZ7lXf4idNMqcN46bXtlIA,bWdj2GDclj5ofokWjzoa5jAwMkxCykd6,4,2,1,0,1,0,1,0,5,0.7142857142857143,1,0.0,0,1,0,1,2,0,0,1,0,2,3,1
11038,198231,tblYMREbAeB7j9qmk5L4ctIeWrhD9ybH,A3fsA9Zfv1X2fVEQhTw51lKENdNrEqT3,1,0,0,0,0,0,1,0,1,0.14285714285714285,1,0.0,0,0,0,0,0,0,0,1,0,0,1,1
11039,198245,qq2f8Akny1ajULPtgXYv9fMRWduKMr9q,A3fsA9Zfv1X2fVEQhTw51lKENdNrEqT3,7,2,1,0,1,0,4,1,9,1.2857142857142858,1,0.0,0,1,0,1,2,0,0,4,1,2,7,1
11040,198253,eZIzehl9YTnThSDhfRvumYM9JAWW8X94,A3fsA9Zfv1X2fVEQhTw51lKENdNrEqT3,9,6,1,0,1,1,5,3,17,2.4285714285714284,1,0.0,0,1,0,1,6,1,0,5,3,2,15,1
11041,198257,FM9F7roZRXjjLVpKJMa3bf9FDgpJfg8g,A3fsA9Zfv1X2fVEQhTw51lKENdNrEqT3,1,0,0,0,0,0,1,0,1,0.14285714285714285,1,0.0,0,0,0,0,0,0,0,1,0,0,1,1
11042,198260,84GcjGYfYBEDW8RMth7eOtG4XRkKowY7,SpATywNh6bZuzm8s1ceuBUnMUAeoAHHw,5,5,2,0,1,0,2,0,10,1.4285714285714286,1,0.0,0,2,0,1,5,0,0,2,0,3,7,1
11043,198261,2dPSdalUbHtu7nWWfNnHcWGVd8UXHjrQ,SpATywNh6bZuzm8s1ceuBUnMUAeoAHHw,16,16,5,11,3,1,4,2,42,6.0,1,0.0,7,5,10,3,9,1,1,4,2,25,17,1
11044,198266,itycNCCvd4Cws5pdd4hKIkDKI4KaE5Jt,A3fsA9Zfv1X2fVEQhTw51lKENdNrEqT3,27,11,10,16,9,0,1,0,47,6.714285714285714,1,0.0,0,10,16,9,11,0,0,1,0,35,12,1
11045,198268,aIL1NEjCe1OHtEKm6JpGdIdTZNDD6Wwu,SpATywNh6bZuzm8s1ceuBUnMUAeoAHHw,1,0,0,0,0,0,1,0,1,0.14285714285714285,1,0.0,0,0,0,0,0,0,0,1,0,0,1,1
11046,198273,3UZJYrArdmpKznqwnck7MTEpjxG34pMK,SpATywNh6bZuzm8s1ceuBUnMUAeoAHHw,5,2,1,0,1,0,2,0,6,0.8571428571428571,1,0.0,0,1,0,1,2,0,0,2,0,2,4,1
11047,198284,TPwZPOPBUdCaLSbv54gObUYtfBQKaJVW,A3fsA9Zfv1X2fVEQhTw51lKENdNrEqT3,1,0,0,0,0,0,1,0,1,0.14285714285714285,1,0.0,0,0,0,0,0,0,0,1,0,0,1,1
11048,198297,bpXV0HZ9yixzCGyJdeSxqm4EvQYi9XKg,SpATywNh6bZuzm8s1ceuBUnMUAeoAHHw,2,0,0,0,0,0,3,0,3,0.42857142857142855,1,0.0,0,0,0,0,0,0,0,3,0,0,3,1
11049,198303,qzSOzKpDnUaSHLwAqVpSpGcUMfaOhDjD,G8EPVSXsOYB5YQWZGiz1aVq5Pgr2GrQu,5,2,1,0,1,0,2,0,6,0.8571428571428571,1,0.0,0,1,0,1,2,0,0,2,0,2,4,1
11050,198310,Cgmx3Ujcxc92HHP4N1UU0TjRl5xBcyRy,A3fsA9Zfv1X2fVEQhTw51lKENdNrEqT3,8,5,3,0,3,0,1,0,12,1.7142857142857142,1,0.0,1,3,0,3,4,0,0,1,0,7,5,1
11051,198312,nrvDpyOlV5T6ZU5wiBAqPXpBwJOtawqO,bWdj2GDclj5ofokWjzoa5jAwMkxCykd6,9,9,3,0,2,6,7,4,31,4.428571428571429,1,0.0,1,3,0,2,8,6,0,7,4,6,25,1
11052,198314,d6GKFo7VpAwS4H9iF45HPuBB7oVkM6uC,SpATywNh6bZuzm8s1ceuBUnMUAeoAHHw,10,8,3,16,2,0,2,0,31,4.428571428571429,1,0.0,4,3,13,2,4,0,3,2,0,22,9,1
11053,198319,hM78zuTWvc2c2WdiFwwJZnLKCiMEzZwE,RXDvfPUBYFlVdlueBFbLW0mhhAyGEqpt,5,4,3,0,2,0,1,0,10,1.4285714285714286,1,0.0,0,3,0,2,4,0,0,1,0,5,5,1
11054,198322,ZdxnlwASEXds7VOuv4UniogqFzAjU71x,G8EPVSXsOYB5YQWZGiz1aVq5Pgr2GrQu,4,0,0,0,0,1,3,0,4,0.5714285714285714,1,0.0,0,0,0,0,0,1,0,3,0,0,4,1
11055,198342,X3X3klM03RXeGUjty93sg2SlkZrg3xpQ,SpATywNh6bZuzm8s1ceuBUnMUAeoAHHw,1,0,0,0,0,0,1,0,1,0.14285714285714285,1,0.0,0,0,0,0,0,0,0,1,0,0,1,1
11056,198343,7XiYdmZTSPhaWzjUuGCUAw2ynyRrmxfl,SpATywNh6bZuzm8s1ceuBUnMUAeoAHHw,8,12,4,0,2,3,2,0,23,3.2857142857142856,1,0.0,6,4,0,2,6,3,0,2,0,12,11,1
11057,198344,walE7JsvJqHl8yLz0PR8Oim32Lz4OIQ0,A3fsA9Zfv1X2fVEQhTw51lKENdNrEqT3,1,0,0,0,0,0,1,0,1,0.14285714285714285,1,0.0,0,0,0,0,0,0,0,1,0,0,1,1
11058,198353,ByX3sCZWzA6bGb4zKqYogAA175eLOyAG,SpATywNh6bZuzm8s1ceuBUnMUAeoAHHw,11,8,6,2,3,0,1,0,20,2.857142857142857,1,0.0,1,6,2,3,7,0,0,1,0,12,8,1
11059,198372,hl3CIQ0lpvTB8gq9L7ARkQJG7PfzlcBL,RXDvfPUBYFlVdlueBFbLW0mhhAyGEqpt,1,0,0,0,0,0,1,0,1,0.14285714285714285,1,0.0,0,0,0,0,0,0,0,1,0,0,1,1
11060,198374,5fiIK7VmqPKr4nf6AwCLv5FpXOs8AmIF,A3fsA9Zfv1X2fVEQhTw51lKENdNrEqT3,4,2,1,0,1,0,2,0,6,0.8571428571428571,1,0.0,0,1,0,1,2,0,0,2,0,2,4,1
11061,198378,xsoPQiWD0DInR2Sgur0NcgW3AIl7NeY0,SpATywNh6bZuzm8s1ceuBUnMUAeoAHHw,5,3,1,0,1,0,2,0,7,1.0,1,0.0,0,1,0,1,3,0,0,2,0,2,5,1
11062,198379,dgFOOUSNfQK8xIrT47Av0Q04bBFeE21W,A3fsA9Zfv1X2fVEQhTw51lKENdNrEqT3,7,3,2,0,2,0,3,0,10,1.4285714285714286,1,0.0,0,2,0,2,3,0,0,3,0,4,6,0
11063,198388,zum8lmwUciqBOjRcsKypiYs2OlSb1h15,A3fsA9Zfv1X2fVEQhTw51lKENdNrEqT3,9,6,1,0,1,0,4,0,12,1.7142857142857142,1,0.0,0,1,0,1,6,0,0,4,0,2,10,0
11064,198398,83TQNbmBQ9BH29WB1QIy1fMhXfCV72jv,A3fsA9Zfv1X2fVEQhTw51lKENdNrEqT3,1,0,0,0,0,0,1,0,1,0.14285714285714285,1,0.0,0,0,0,0,0,0,0,1,0,0,1,1
11065,198400,C23sTQ3IqWj72FdxhbjBadlgfhNvNhLt,bWdj2GDclj5ofokWjzoa5jAwMkxCykd6,4,2,1,0,0,0,2,0,5,0.7142857142857143,1,0.0,0,1,0,0,2,0,0,2,0,1,4,1
11066,198403,Dq2cCGdJlkpRnI9Tq5kE4JyzjGIGvpDz,A3fsA9Zfv1X2fVEQhTw51lKENdNrEqT3,9,5,3,0,3,0,4,0,15,2.142857142857143,1,0.0,0,3,0,3,5,0,0,4,0,6,9,1
11067,198404,hrPjKcL9rUfM1fnC8qta4lu2HmlsBLv6,A3fsA9Zfv1X2fVEQhTw51lKENdNrEqT3,12,6,5,0,5,0,1,0,17,2.4285714285714284,1,0.0,0,5,0,5,6,0,0,1,0,10,7,1
11068,198410,Kkww4jmevg0ZHJyNJmjfSGoxXiVH3qc9,SpATywNh6bZuzm8s1ceuBUnMUAeoAHHw,5,2,1,0,1,3,3,0,10,1.4285714285714286,1,0.0,0,1,0,1,2,3,0,3,0,2,8,1
11069,198411,6dJBpGT7qNr0NTuZjVXnITeb9R9DQeyE,SpATywNh6bZuzm8s1ceuBUnMUAeoAHHw,2,0,0,0,0,0,2,0,2,0.2857142857142857,1,0.0,0,0,0,0,0,0,0,2,0,0,2,1
11070,198416,KhKCxhPBpm8wuQfuIb6HFYBHnnvZJlex,RXDvfPUBYFlVdlueBFbLW0mhhAyGEqpt,1,0,0,0,0,0,1,0,1,0.14285714285714285,1,0.0,0,0,0,0,0,0,0,1,0,0,1,1
11071,198417,2uLHED4iY9VmLy5RW7Mfy2sLsR8ze3u7,RXDvfPUBYFlVdlueBFbLW0mhhAyGEqpt,1,0,0,0,0,0,1,0,1,0.14285714285714285,1,0.0,0,0,0,0,0,0,0,1,0,0,1,1
11072,198429,Fm0KmurJVBFEZiRcw3nlgAYLTArGnQaR,SpATywNh6bZuzm8s1ceuBUnMUAeoAHHw,16,30,1,14,1,20,14,4,84,12.0,1,0.0,7,1,12,1,23,20,2,14,4,21,63,1
11073,198446,P4gIdHzF607L8e8VPH3Qb09lxgNZRJFa,SpATywNh6bZuzm8s1ceuBUnMUAeoAHHw,4,3,0,0,0,0,1,0,4,0.5714285714285714,1,0.0,0,0,0,0,3,0,0,1,0,0,4,0
11074,198448,brW82YOCdOnTyLjpAh6QOg0ROSIhJ2Rz,A3fsA9Zfv1X2fVEQhTw51lKENdNrEqT3,2,0,0,0,0,0,3,0,3,0.42857142857142855,1,0.0,0,0,0,0,0,0,0,3,0,0,3,1
11075,198449,ncZpzPYvUtQjJgcrnY99CiTzo4JQVsl8,SpATywNh6bZuzm8s1ceuBUnMUAeoAHHw,4,2,0,0,0,0,2,0,4,0.5714285714285714,1,0.0,0,0,0,0,2,0,0,2,0,0,4,1
11076,198454,MqwnKklVqrb7jfevVzyfhGQMDPOkys7S,A3fsA9Zfv1X2fVEQhTw51lKENdNrEqT3,6,2,0,0,0,1,7,1,11,1.5714285714285714,1,0.0,0,0,0,0,2,1,0,7,1,0,11,1
11077,198475,Wq2ch7EEtsSKF9Vm0sUqWsaIHScTXudA,SpATywNh6bZuzm8s1ceuBUnMUAeoAHHw,4,2,1,0,1,0,1,0,5,0.7142857142857143,1,0.0,0,1,0,1,2,0,0,1,0,2,3,1
11078,198479,zHNYns4eYsvaD0PCrPbR7JoIqflHxrEv,A3fsA9Zfv1X2fVEQhTw51lKENdNrEqT3,1,0,0,0,0,0,1,0,1,0.14285714285714285,1,0.0,0,0,0,0,0,0,0,1,0,0,1,1
11079,198486,jHa0rWGu66mtR6qdZK3honEGURZjLRQo,SpATywNh6bZuzm8s1ceuBUnMUAeoAHHw,4,4,3,0,3,0,1,0,11,1.5714285714285714,1,0.0,0,3,0,3,4,0,0,1,0,6,5,0
11080,198492,SZnZ9mw8U8WzrYPDnWgxJCTIBCqTF6rB,SpATywNh6bZuzm8s1ceuBUnMUAeoAHHw,2,0,0,0,0,0,2,0,2,0.2857142857142857,1,0.0,0,0,0,0,0,0,0,2,0,0,2,1
11081,198495,OO2Ag6HEFKkZRtZuzzt1ya8SiL4BLCOC,RXDvfPUBYFlVdlueBFbLW0mhhAyGEqpt,1,0,0,0,0,0,1,0,1,0.14285714285714285,1,0.0,0,0,0,0,0,0,0,1,0,0,1,1
11082,198496,byyujsciSYId0rQQrEakxEnXcWLiLPay,SpATywNh6bZuzm8s1ceuBUnMUAeoAHHw,10,9,1,0,1,1,9,1,22,3.142857142857143,1,0.0,0,1,0,1,9,1,0,9,1,2,20,1
11083,198497,AfmdKPTL0IbcupndNMlY5c7PImPraChY,A3fsA9Zfv1X2fVEQhTw51lKENdNrEqT3,13,7,5,0,5,0,1,0,18,2.5714285714285716,1,0.0,0,5,0,5,7,0,0,1,0,10,8,1
11084,198500,dN2hlyHLZZp4dyg60YxnWe6xCUBAX5se,bWdj2GDclj5ofokWjzoa5jAwMkxCykd6,4,3,1,0,1,0,2,0,7,1.0,1,0.0,0,1,0,1,3,0,0,2,0,2,5,1
11085,198501,EwaALzeaojV7pPZOsHFx7jzB7xjVDGvQ,bWdj2GDclj5ofokWjzoa5jAwMkxCykd6,8,4,0,14,0,1,3,1,23,3.2857142857142856,1,0.0,1,0,14,0,3,1,0,3,1,15,8,1
11086,198503,F16OuTgaH1ZbsvG4bVnrHtSG2xmdMXNR,A3fsA9Zfv1X2fVEQhTw51lKENdNrEqT3,7,5,2,0,2,0,2,1,12,1.7142857142857142,1,0.0,0,2,0,2,5,0,0,2,1,4,8,1
11087,198506,sVvZPZ3GVHWR4Hg1FcQf4FWks0TLCNOR,A3fsA9Zfv1X2fVEQhTw51lKENdNrEqT3,14,7,5,0,3,1,8,1,25,3.5714285714285716,1,0.0,0,5,0,3,7,1,0,8,1,8,17,1
11088,198517,xIuD143aD9LhLXzAc6byVmIGYF4SpJsZ,A3fsA9Zfv1X2fVEQhTw51lKENdNrEqT3,1,0,0,0,0,0,1,0,1,0.14285714285714285,1,0.0,0,0,0,0,0,0,0,1,0,0,1,1
11089,198518,eEUIScknc9SimnLuPMm5Vf07ulWcWd92,A3fsA9Zfv1X2fVEQhTw51lKENdNrEqT3,1,0,0,0,0,0,1,0,1,0.14285714285714285,1,0.0,0,0,0,0,0,0,0,1,0,0,1,1
11090,198529,eBQTzPv3v3TV7mZrXSw0RrOHTLWkqz5k,bWdj2GDclj5ofokWjzoa5jAwMkxCykd6,7,4,2,0,2,0,2,0,10,1.4285714285714286,1,0.0,1,2,0,2,3,0,0,2,0,5,5,1
11091,198539,w7s7CbDlE2P2RGY2w8kEYH9keSavEsec,bWdj2GDclj5ofokWjzoa5jAwMkxCykd6,2,0,0,0,0,0,2,0,2,0.2857142857142857,1,0.0,0,0,0,0,0,0,0,2,0,0,2,1
11092,198547,2kSwVlbsGRMwb7boxmMBKvNiRXYYeI1Y,SpATywNh6bZuzm8s1ceuBUnMUAeoAHHw,2,0,0,0,0,0,2,0,2,0.2857142857142857,1,0.0,0,0,0,0,0,0,0,2,0,0,2,1
11093,198550,dYWKoJoBpKPEwdcqoTPZCoTIyvG7V1Tu,A3fsA9Zfv1X2fVEQhTw51lKENdNrEqT3,6,3,1,0,1,6,5,0,16,2.2857142857142856,1,0.0,0,1,0,1,3,6,0,5,0,2,14,1
11094,198555,s37SmpVU3dTE3yD2mQmjjcBs0sjjoAwz,SpATywNh6bZuzm8s1ceuBUnMUAeoAHHw,15,28,0,18,0,4,8,3,61,8.714285714285714,1,0.0,18,0,17,0,10,4,1,8,3,35,26,1
11095,198560,b0mgWZqNzMdtJFxZULQczG8Tc3XpTILP,bWdj2GDclj5ofokWjzoa5jAwMkxCykd6,9,6,3,2,3,0,1,0,15,2.142857142857143,1,0.0,2,3,2,3,4,0,0,1,0,10,5,0
11096,198562,dYWKoJoBpKPEwdcqoTPZCoTIyvG7V1Tu,bWdj2GDclj5ofokWjzoa5jAwMkxCykd6,7,5,2,0,2,0,1,0,10,1.4285714285714286,1,0.0,0,2,0,2,5,0,0,1,0,4,6,1
11097,198566,zhF9aamFaaPbw8uvKpkg1m1HOa3rg91T,A3fsA9Zfv1X2fVEQhTw51lKENdNrEqT3,18,9,8,0,8,0,1,0,26,3.7142857142857144,1,0.0,0,8,0,8,9,0,0,1,0,16,10,1
11098,198567,4GJSwwikGuUWXSajcKoSlvfsoiC8eEZq,A3fsA9Zfv1X2fVEQhTw51lKENdNrEqT3,12,16,14,0,0,0,4,0,34,4.857142857142857,1,0.0,0,14,0,0,16,0,0,4,0,14,20,1
11099,198575,IR9p9WuPGPaaA4f6RkgkUYRRmOTg8aPE,SpATywNh6bZuzm8s1ceuBUnMUAeoAHHw,1,0,0,0,0,0,1,0,1,0.14285714285714285,1,0.0,0,0,0,0,0,0,0,1,0,0,1,1
11100,198576,M75L90OOMTV1kEiI3n7vM0ty47YBFna9,A3fsA9Zfv1X2fVEQhTw51lKENdNrEqT3,5,7,1,0,1,0,2,0,11,1.5714285714285714,1,0.0,0,1,0,1,7,0,0,2,0,2,9,1
11101,198577,QXph4cOoRqm5422pzQXvVGuiJ0zPyE5f,SpATywNh6bZuzm8s1ceuBUnMUAeoAHHw,7,4,3,0,3,0,2,0,12,1.7142857142857142,1,0.0,0,3,0,3,4,0,0,2,0,6,6,1
11102,198580,iJRgFwBj3cEAZI5JrvtGnB3yvPVZ5Cdq,bWdj2GDclj5ofokWjzoa5jAwMkxCykd6,8,2,2,0,2,0,3,0,9,1.2857142857142858,1,0.0,0,2,0,2,2,0,0,3,0,4,5,1
11103,198581,W5wwRspxUk4ZCYBlSnCmonKbHdsPqzQn,SpATywNh6bZuzm8s1ceuBUnMUAeoAHHw,2,0,0,0,0,0,2,0,2,0.2857142857142857,1,0.0,0,0,0,0,0,0,0,2,0,0,2,1
11104,198584,0q3P6YGkZ2dxtBIeVbo5DKpZyIRZVZAM,A3fsA9Zfv1X2fVEQhTw51lKENdNrEqT3,1,0,0,0,0,0,1,0,1,0.14285714285714285,1,0.0,0,0,0,0,0,0,0,1,0,0,1,1
11105,198596,ZfjfwFl0JPdJif1Zgl3u0FEb4C4l2Zxn,A3fsA9Zfv1X2fVEQhTw51lKENdNrEqT3,8,4,2,0,3,0,1,0,10,1.4285714285714286,1,0.0,0,2,0,3,4,0,0,1,0,5,5,1
11106,198603,fsydotVTfs3IO9vO0Vkp2xRbb1WB0CCz,SpATywNh6bZuzm8s1ceuBUnMUAeoAHHw,8,3,1,0,1,0,7,1,13,1.8571428571428572,1,0.0,0,1,0,1,3,0,0,7,1,2,11,1
11107,198605,pnnKMIXc9aatMHlNextjL8MoSsu3IuzR,SpATywNh6bZuzm8s1ceuBUnMUAeoAHHw,5,2,1,0,1,0,2,0,6,0.8571428571428571,1,0.0,0,1,0,1,2,0,0,2,0,2,4,1
11108,198637,CUEyHbsjLlbX6I7tsbnNjxFI1v5Lj4iD,bWdj2GDclj5ofokWjzoa5jAwMkxCykd6,5,2,1,0,1,0,2,0,6,0.8571428571428571,1,0.0,0,1,0,1,2,0,0,2,0,2,4,1
11109,198643,6lxqO6gucEPo0iFbRZ4Psmditgm2GZdr,SpATywNh6bZuzm8s1ceuBUnMUAeoAHHw,10,7,4,6,0,0,3,0,20,2.857142857142857,1,0.0,2,4,6,0,5,0,0,3,0,12,8,1
11110,198646,iCEb35gaygczCVXBPDGlI3sXrSsDaVej,bWdj2GDclj5ofokWjzoa5jAwMkxCykd6,1,0,0,0,0,0,2,0,2,0.2857142857142857,1,0.0,0,0,0,0,0,0,0,2,0,0,2,1
11111,198656,mXfwwTIVjHMqoVKAh2iEQbinKUCJHwTp,A3fsA9Zfv1X2fVEQhTw51lKENdNrEqT3,8,6,3,0,2,0,8,0,19,2.7142857142857144,1,0.0,0,3,0,2,6,0,0,8,0,5,14,1
11112,198671,34cVbMGyVO1SqQjOK9RNk00q4uKA3nIE,SpATywNh6bZuzm8s1ceuBUnMUAeoAHHw,5,2,1,0,1,0,2,0,6,0.8571428571428571,1,0.0,0,1,0,1,2,0,0,2,0,2,4,1
11113,198676,8OMQVFIkmUspkJuyYp0KATDRhux0sdCZ,A3fsA9Zfv1X2fVEQhTw51lKENdNrEqT3,5,0,0,0,0,1,5,1,7,1.0,1,0.0,0,0,0,0,0,1,0,5,1,0,7,1
11114,198682,O1JCj9IRlzuPnXGSMFH3o6nPheXmI0dk,A3fsA9Zfv1X2fVEQhTw51lKENdNrEqT3,5,2,0,0,0,0,3,1,6,0.8571428571428571,1,0.0,0,0,0,0,2,0,0,3,1,0,6,1
11115,198700,iJRgFwBj3cEAZI5JrvtGnB3yvPVZ5Cdq,A3fsA9Zfv1X2fVEQhTw51lKENdNrEqT3,6,1,1,0,1,0,3,0,6,0.8571428571428571,1,0.0,0,1,0,1,1,0,0,3,0,2,4,1
11116,198709,JlndvP2EuIlwJAySHuL6QfQBf6i8elGn,G8EPVSXsOYB5YQWZGiz1aVq5Pgr2GrQu,2,0,0,0,0,0,2,0,2,0.2857142857142857,1,0.0,0,0,0,0,0,0,0,2,0,0,2,1
11117,198711,5Lnagj9S1Vv0G8cjSfxcxK2ro2WrQMdB,G8EPVSXsOYB5YQWZGiz1aVq5Pgr2GrQu,4,2,0,0,0,0,5,0,7,1.0,1,0.0,0,0,0,0,2,0,0,5,0,0,7,1
11118,198722,ITvb0EWV8ZZ88RI4SBwUoVbHLyVcwZRP,A3fsA9Zfv1X2fVEQhTw51lKENdNrEqT3,13,12,1,0,0,0,2,0,15,2.142857142857143,1,0.0,0,1,0,0,12,0,0,2,0,1,14,1
11119,198734,QCY6rb7yvcagouaf25uIFV9RWdPPOb7l,SpATywNh6bZuzm8s1ceuBUnMUAeoAHHw,5,4,0,0,0,0,1,0,5,0.7142857142857143,1,0.0,0,0,0,0,4,0,0,1,0,0,5,1
11120,198739,QvUtN7NvmMmWACtjGZbRh5vUGOqoadOI,SpATywNh6bZuzm8s1ceuBUnMUAeoAHHw,1,0,0,0,0,0,1,0,1,0.14285714285714285,1,0.0,0,0,0,0,0,0,0,1,0,0,1,1
11121,198740,ilMjmMVbiUSUOOjXRXyXhngOcMKQcGhx,G8EPVSXsOYB5YQWZGiz1aVq5Pgr2GrQu,2,0,0,0,0,0,2,0,2,0.2857142857142857,1,0.0,0,0,0,0,0,0,0,2,0,0,2,1
11122,198747,ScmiDI5AINzZbjcs2bWNBHbp8udIsqgh,SpATywNh6bZuzm8s1ceuBUnMUAeoAHHw,7,7,2,0,1,0,3,0,13,1.8571428571428572,1,0.0,0,2,0,1,7,0,0,3,0,3,10,1
11123,198755,l99Zcol89MEEF7ym4ZK8FY1ESaelZnlP,A3fsA9Zfv1X2fVEQhTw51lKENdNrEqT3,8,5,4,0,4,0,1,0,14,2.0,1,0.0,0,4,0,4,5,0,0,1,0,8,6,0
11124,198761,ONe4iInwtHkZ5gtlbWN831JopVHbaD8L,SpATywNh6bZuzm8s1ceuBUnMUAeoAHHw,3,0,0,0,0,2,5,0,7,1.0,1,0.0,0,0,0,0,0,2,0,5,0,0,7,1
11125,198769,XduGpggqMznFnxTLbAhFUOyKgFLNMc8n,SpATywNh6bZuzm8s1ceuBUnMUAeoAHHw,4,2,1,0,1,0,1,0,5,0.7142857142857143,1,0.0,0,1,0,1,2,0,0,1,0,2,3,1
11126,198792,g1dFQ3mnVnBiIhnsU4zqK21biH9l5lF9,A3fsA9Zfv1X2fVEQhTw51lKENdNrEqT3,1,0,0,0,0,0,1,0,1,0.14285714285714285,1,0.0,0,0,0,0,0,0,0,1,0,0,1,1
11127,198793,QrIpd1N2l4iqQkNACgUM7iTDn2RZjb2Z,A3fsA9Zfv1X2fVEQhTw51lKENdNrEqT3,1,0,0,0,0,0,1,0,1,0.14285714285714285,1,0.0,0,0,0,0,0,0,0,1,0,0,1,1
11128,198807,FrcNdFNfLYMOg5fdBzjs15qKbgtHEYZH,A3fsA9Zfv1X2fVEQhTw51lKENdNrEqT3,5,2,1,0,1,0,2,0,6,0.8571428571428571,1,0.0,0,1,0,1,2,0,0,2,0,2,4,0
11129,198812,DxsFVZh699mkeWBLgWLRdSxOs5e2KIgS,SpATywNh6bZuzm8s1ceuBUnMUAeoAHHw,11,8,4,0,2,3,7,1,25,3.5714285714285716,1,0.0,2,4,0,2,6,3,0,7,1,8,17,1
11130,198820,chD7Ekz0CCeTW4cvhA1an0KXokkNIvTf,SpATywNh6bZuzm8s1ceuBUnMUAeoAHHw,1,0,0,0,0,0,1,0,1,0.14285714285714285,1,0.0,0,0,0,0,0,0,0,1,0,0,1,1
11131,198822,uZbzvdzFyR1ceRxI8f80IsSKw8Wzuev1,SpATywNh6bZuzm8s1ceuBUnMUAeoAHHw,7,7,1,0,1,0,2,0,11,1.5714285714285714,1,0.0,0,1,0,1,7,0,0,2,0,2,9,0
11132,198823,2ENDZhPlfPQ7xqwHjrfLuuWg5Duw7ZBj,G8EPVSXsOYB5YQWZGiz1aVq5Pgr2GrQu,4,4,1,0,1,0,1,0,7,1.0,1,0.0,1,1,0,1,3,0,0,1,0,3,4,1
11133,198832,PKdKWqW1VQJFocRWfF0D5fFjfdW8ENqW,SpATywNh6bZuzm8s1ceuBUnMUAeoAHHw,2,0,0,0,0,0,2,0,2,0.2857142857142857,1,0.0,0,0,0,0,0,0,0,2,0,0,2,1
11134,198844,9xn3imvdiJkc9HcKhWV1Hhylco4OVjiR,SpATywNh6bZuzm8s1ceuBUnMUAeoAHHw,2,0,0,0,0,0,2,0,2,0.2857142857142857,1,0.0,0,0,0,0,0,0,0,2,0,0,2,1
11135,198849,9xn3imvdiJkc9HcKhWV1Hhylco4OVjiR,G8EPVSXsOYB5YQWZGiz1aVq5Pgr2GrQu,7,13,0,0,0,0,4,0,17,2.4285714285714284,1,0.0,1,0,0,0,12,0,0,4,0,1,16,1
11136,198863,ZWKBU7cFyL8Xqx9wqUlqIH5ujAlqP1xm,A3fsA9Zfv1X2fVEQhTw51lKENdNrEqT3,8,7,3,0,2,0,3,0,15,2.142857142857143,1,0.0,0,3,0,2,7,0,0,3,0,5,10,1
11137,198865,AUCcjgWVaeHbyOo7n1ZoCM3NX1aTzthI,G8EPVSXsOYB5YQWZGiz1aVq5Pgr2GrQu,7,4,0,0,0,0,5,0,9,1.2857142857142858,1,0.0,0,0,0,0,4,0,0,5,0,0,9,1
11138,198866,cGujrM5GGnHFlTqKFoeVE54jkUOVyngH,A3fsA9Zfv1X2fVEQhTw51lKENdNrEqT3,1,0,0,0,0,0,1,0,1,0.14285714285714285,1,0.0,0,0,0,0,0,0,0,1,0,0,1,1
11139,198868,rlQIqtgsDfEVihltHvVH3EnaOkFIJWY2,A3fsA9Zfv1X2fVEQhTw51lKENdNrEqT3,1,0,0,0,0,0,1,0,1,0.14285714285714285,1,0.0,0,0,0,0,0,0,0,1,0,0,1,1
11140,198869,TSm2R7cUPaXhbTrj1LddmwVL7dduRSSa,A3fsA9Zfv1X2fVEQhTw51lKENdNrEqT3,8,3,2,0,2,8,6,1,22,3.142857142857143,1,0.0,0,2,0,2,3,8,0,6,1,4,18,1
11141,198870,3Ayux0uPJ6ML3SyziM62LSRrG0V1OgIm,SpATywNh6bZuzm8s1ceuBUnMUAeoAHHw,17,18,11,10,6,1,6,1,53,7.571428571428571,1,0.0,5,11,9,6,13,1,1,6,1,31,22,1
11142,198874,JdraUX9nFc2Y8K2LiincPu5HyHjoquI8,A3fsA9Zfv1X2fVEQhTw51lKENdNrEqT3,8,6,0,0,0,1,10,1,18,2.5714285714285716,1,0.0,3,0,0,0,3,1,0,10,1,3,15,1
11143,198894,nKVAY2GHYnzf4BfG261ddlVdtqvsIA9B,A3fsA9Zfv1X2fVEQhTw51lKENdNrEqT3,6,4,2,0,2,0,1,0,9,1.2857142857142858,1,0.0,0,2,0,2,4,0,0,1,0,4,5,1
11144,198899,ctoSfpAfvm3av2aqkT0D3Yq8icDxZKCx,A3fsA9Zfv1X2fVEQhTw51lKENdNrEqT3,1,0,0,0,0,0,1,0,1,0.14285714285714285,1,0.0,0,0,0,0,0,0,0,1,0,0,1,1
11145,198902,pSRqXJrhW3cpcIMqshrNJY13lAR5UPwX,G8EPVSXsOYB5YQWZGiz1aVq5Pgr2GrQu,2,0,0,0,0,0,2,0,2,0.2857142857142857,1,0.0,0,0,0,0,0,0,0,2,0,0,2,1
11146,198903,iUqEEHE7KFlYvrJ9lttneq6sdDOxoE0o,SpATywNh6bZuzm8s1ceuBUnMUAeoAHHw,1,0,0,0,0,0,1,0,1,0.14285714285714285,1,0.0,0,0,0,0,0,0,0,1,0,0,1,0
11147,198910,pSRqXJrhW3cpcIMqshrNJY13lAR5UPwX,A3fsA9Zfv1X2fVEQhTw51lKENdNrEqT3,2,0,0,0,0,0,2,0,2,0.2857142857142857,1,0.0,0,0,0,0,0,0,0,2,0,0,2,1
11148,198915,5RFNEnBqW8mdktbwEzjZ2lPhm72vzWhr,SpATywNh6bZuzm8s1ceuBUnMUAeoAHHw,8,4,3,0,2,0,2,0,11,1.5714285714285714,1,0.0,0,3,0,2,4,0,0,2,0,5,6,1
11149,198936,QO42SHgXwWqLSSYHUVMAX8sjMgYnpZEl,G8EPVSXsOYB5YQWZGiz1aVq5Pgr2GrQu,7,3,2,0,2,0,2,0,9,1.2857142857142858,1,0.0,0,2,0,2,3,0,0,2,0,4,5,1
11150,198955,25eiJkNBguZOcrPXS1ZGiSW1nfaRn05c,SpATywNh6bZuzm8s1ceuBUnMUAeoAHHw,7,3,2,0,2,0,2,0,9,1.2857142857142858,1,0.0,0,2,0,2,3,0,0,2,0,4,5,1
11151,198956,GyLB5V57I2KbnfFgZclSqyQAUY6eRpjt,A3fsA9Zfv1X2fVEQhTw51lKENdNrEqT3,2,0,0,0,0,0,2,0,2,0.2857142857142857,1,0.0,0,0,0,0,0,0,0,2,0,0,2,1
11152,198963,WAnB7c5F1PHHqCCd4HzBf0vmVEoM8DG4,SpATywNh6bZuzm8s1ceuBUnMUAeoAHHw,6,3,0,0,0,2,6,0,11,1.5714285714285714,1,0.0,0,0,0,0,3,2,0,6,0,0,11,1
11153,198965,9og5l3kBrvNmeUS7WEJnLIW5U5JOFnlr,SpATywNh6bZuzm8s1ceuBUnMUAeoAHHw,5,1,1,0,1,0,2,0,5,0.7142857142857143,1,0.0,0,1,0,1,1,0,0,2,0,2,3,1
11154,198975,2oTvbzieHn2y5oozeOgSnruqE6N0BtR5,bWdj2GDclj5ofokWjzoa5jAwMkxCykd6,11,11,6,0,5,7,4,0,33,4.714285714285714,1,0.0,2,6,0,5,9,7,0,4,0,13,20,1
11155,198976,qJSVGIIBKQpzllCeTCwG3pgdEZIo3QRz,bWdj2GDclj5ofokWjzoa5jAwMkxCykd6,1,0,0,0,0,0,1,0,1,0.14285714285714285,1,0.0,0,0,0,0,0,0,0,1,0,0,1,1
11156,198979,U5aocuOsbgg0bKahFwFd1In2DcDc3oBc,G8EPVSXsOYB5YQWZGiz1aVq5Pgr2GrQu,7,5,2,0,2,0,2,0,11,1.5714285714285714,1,0.0,0,2,0,2,5,0,0,2,0,4,7,1
11157,198991,mSWRBlOsrbB7GjQNoTuNmuW3YOy77l6X,bWdj2GDclj5ofokWjzoa5jAwMkxCykd6,1,0,0,0,0,0,1,0,1,0.14285714285714285,1,0.0,0,0,0,0,0,0,0,1,0,0,1,1
11158,198993,mSWRBlOsrbB7GjQNoTuNmuW3YOy77l6X,A3fsA9Zfv1X2fVEQhTw51lKENdNrEqT3,1,0,0,0,0,0,1,0,1,0.14285714285714285,1,0.0,0,0,0,0,0,0,0,1,0,0,1,1
11159,199000,4UScXtt088oGe9dJ2KJws6faWfnlaEO8,G8EPVSXsOYB5YQWZGiz1aVq5Pgr2GrQu,8,12,0,0,0,0,4,0,16,2.2857142857142856,1,0.0,0,0,0,0,12,0,0,4,0,0,16,1
11160,199004,wB1zTvSxiuMnQ6mG62KhRDH75H6JzCKK,G8EPVSXsOYB5YQWZGiz1aVq5Pgr2GrQu,1,0,0,0,0,0,1,0,1,0.14285714285714285,1,0.0,0,0,0,0,0,0,0,1,0,0,1,1
11161,199009,UoLm4A2shVKJTBQjYq1cnhy9CVAb6BPB,SpATywNh6bZuzm8s1ceuBUnMUAeoAHHw,1,0,0,0,0,0,2,0,2,0.2857142857142857,1,0.0,0,0,0,0,0,0,0,2,0,0,2,1
11162,199016,C4ciI1Hxrse5ND4h1rvhsDGjFinNO7RJ,bWdj2GDclj5ofokWjzoa5jAwMkxCykd6,8,9,1,0,1,1,10,5,27,3.857142857142857,1,0.0,5,1,0,1,4,1,0,10,5,7,20,1
11163,199018,YQQ0U1ySGhxQGw2MpzkqAJru8VuefP0L,bWdj2GDclj5ofokWjzoa5jAwMkxCykd6,4,5,2,0,0,0,2,0,9,1.2857142857142858,1,0.0,2,2,0,0,3,0,0,2,0,4,5,1
11164,199029,cderIDaWBR3ykedbqXoG7yh75mThXkpL,bWdj2GDclj5ofokWjzoa5jAwMkxCykd6,1,0,0,0,0,0,1,0,1,0.14285714285714285,1,0.0,0,0,0,0,0,0,0,1,0,0,1,1
11165,199032,aTQ4Ypzwh1rImg9ZYH1ng3j22ZvxNJg3,SpATywNh6bZuzm8s1ceuBUnMUAeoAHHw,1,0,0,0,0,0,1,0,1,0.14285714285714285,1,0.0,0,0,0,0,0,0,0,1,0,0,1,1
11166,199036,Cj6qzoa736NxMqt5KsDr9YuISfsEJCrb,SpATywNh6bZuzm8s1ceuBUnMUAeoAHHw,6,3,1,0,1,0,2,0,7,1.0,1,0.0,0,1,0,1,3,0,0,2,0,2,5,1
11167,199044,nmlYjXdaqWSjPWm2kQhmjZqjjBKhkQAm,bWdj2GDclj5ofokWjzoa5jAwMkxCykd6,6,3,2,0,2,1,4,1,13,1.8571428571428572,1,0.0,0,2,0,2,3,1,0,4,1,4,9,1
11168,199046,xcyypTvwSo3LXkXsaePEIK0Y1mo0nQoS,SpATywNh6bZuzm8s1ceuBUnMUAeoAHHw,13,15,8,4,3,0,2,0,32,4.571428571428571,1,0.0,6,8,4,3,9,0,0,2,0,21,11,1
11169,199049,Yer7ST1oiQQLYYgjANCmG1MBkWuTCohH,bWdj2GDclj5ofokWjzoa5jAwMkxCykd6,1,0,0,0,0,0,1,0,1,0.14285714285714285,1,0.0,0,0,0,0,0,0,0,1,0,0,1,1
11170,199051,uufXnXOfmStAymRAiMYAROVtj5hPlDvd,A3fsA9Zfv1X2fVEQhTw51lKENdNrEqT3,1,0,0,0,0,0,1,0,1,0.14285714285714285,1,0.0,0,0,0,0,0,0,0,1,0,0,1,1
11171,199056,OGCl7FuINJMmIPxVehaSeriK0obhKOqa,SpATywNh6bZuzm8s1ceuBUnMUAeoAHHw,8,6,4,0,3,0,1,0,14,2.0,1,0.0,0,4,0,3,6,0,0,1,0,7,7,1
11172,199057,AW3qB37tEUxBhbQEUxhofJkaUbKF4F7i,bWdj2GDclj5ofokWjzoa5jAwMkxCykd6,2,0,0,0,0,4,1,0,5,0.7142857142857143,1,0.0,0,0,0,0,0,4,0,1,0,0,5,1
11173,199058,VeLCqoeC0RO3eUOAMmBgbUdlxxqFnwbN,SpATywNh6bZuzm8s1ceuBUnMUAeoAHHw,4,4,0,0,0,0,2,0,6,0.8571428571428571,1,0.0,0,0,0,0,4,0,0,2,0,0,6,0
11174,199069,M45QNJ6951iGJajsprAeFVhHViiX50AV,A3fsA9Zfv1X2fVEQhTw51lKENdNrEqT3,22,12,10,0,9,5,5,1,42,6.0,1,0.0,0,10,0,9,12,5,0,5,1,19,23,1
11175,199078,pXGBcTffNYWAUeYw1RFCIuTgQsIvI4OJ,G8EPVSXsOYB5YQWZGiz1aVq5Pgr2GrQu,5,2,1,0,1,0,2,0,6,0.8571428571428571,1,0.0,0,1,0,1,2,0,0,2,0,2,4,0
