,enrollment_id,username,course_id,no_of_objects12,bno_access12,bno_pageclose12,bno_problem12,bno_video12,bno_discussion12,bno_navigate12,bno_wiki12,bno_total12,bno_avg12,no_of_active_days12,time_consumption12,browser_access12,browser_pageclose12,browser_problem12,browser_video12,server_access12,server_discussion12,server_problem12,server_navigate12,server_wiki12,bno_browser12,bno_server12,label
0,34,OeLBIzS0gNQ56euxy5b66gAZMzQCGE7n,7GRhBDsirIGkRZBtSMEzNTyDr2JQm4xx,42,48,16,42,14,5,19,2,146,20.857142857142858,8,-2046176.0,22,16,37,14,26,5,5,19,2,89,57,0
1,66,cGrHiRjztN9fSltHujpfWaaWfYWiidiG,7GRhBDsirIGkRZBtSMEzNTyDr2JQm4xx,62,256,40,127,22,119,32,0,596,85.14285714285714,12,0.0,100,40,98,22,156,119,29,32,0,260,336,0
2,85,OdsEBh425XZxll0hTUv04OAotDf6aGtE,7GRhBDsirIGkRZBtSMEzNTyDr2JQm4xx,10,14,4,2,3,0,5,0,28,4.0,3,0.0,1,4,2,3,13,0,0,5,0,10,18,1
3,89,Po17baTutQqG3KBkMaahpxQ7IpjhFfZa,7GRhBDsirIGkRZBtSMEzNTyDr2JQm4xx,28,57,3,51,17,8,5,0,141,20.142857142857142,5,0.0,34,3,42,17,23,8,9,5,0,96,45,1
4,145,TZOWoG0yzTTzAfx5K054mpl5rZTlZIcZ,7GRhBDsirIGkRZBtSMEzNTyDr2JQm4xx,42,98,31,68,15,25,9,3,249,35.57142857142857,6,0.0,28,31,63,15,70,25,5,9,3,137,112,1
5,163,jJZ8z8M2beLy33Z7JJbNFq1bQd8o43FV,7GRhBDsirIGkRZBtSMEzNTyDr2JQm4xx,6,11,3,0,0,1,5,0,20,2.857142857142857,3,0.0,4,3,0,0,7,1,0,5,0,7,13,1
6,312,BCPhbcVTukJPsOtUJJbyOWvpso8GiEV1,7GRhBDsirIGkRZBtSMEzNTyDr2JQm4xx,41,125,46,85,17,314,46,3,636,90.85714285714286,12,0.0,51,46,72,17,74,314,13,46,3,186,450,0
7,384,zcVNiJm0X4Vm9oBHkuQez1iW6Hb7iAYl,7GRhBDsirIGkRZBtSMEzNTyDr2JQm4xx,31,67,26,54,15,2,3,0,167,23.857142857142858,1,0.0,39,26,50,15,28,2,4,3,0,130,37,1
8,397,9JGDpM8F0Ioe7WqwIugLWqE5Qa4gQNAo,7GRhBDsirIGkRZBtSMEzNTyDr2JQm4xx,5,0,0,0,0,0,6,0,6,0.8571428571428571,1,0.0,0,0,0,0,0,0,0,6,0,0,6,1
9,405,jWgeQ7calOYQcs5lv7T9mWy3KUSp4lwk,7GRhBDsirIGkRZBtSMEzNTyDr2JQm4xx,7,4,1,0,1,0,2,0,8,1.1428571428571428,1,0.0,0,1,0,1,4,0,0,2,0,2,6,1
10,457,LP0dfF7fyuhmmsZ61rjoy3gAmrNgZfWE,7GRhBDsirIGkRZBtSMEzNTyDr2JQm4xx,5,3,0,0,0,0,2,0,5,0.7142857142857143,1,0.0,0,0,0,0,3,0,0,2,0,0,5,1
11,488,j2rHuSroJ2LNNnea5uXtGt5k8dfNg0dE,7GRhBDsirIGkRZBtSMEzNTyDr2JQm4xx,1,0,0,0,0,0,1,0,1,0.14285714285714285,1,0.0,0,0,0,0,0,0,0,1,0,0,1,1
12,508,hbwWiZJx2DqUaUjG4c2EvTFTwMA32fWP,7GRhBDsirIGkRZBtSMEzNTyDr2JQm4xx,54,95,43,103,19,1,9,1,271,38.714285714285715,4,0.0,38,43,93,19,57,1,10,9,1,193,78,1
13,529,VjgzAw2H8q9OHgJwlSzUGU3MhKciCosm,7GRhBDsirIGkRZBtSMEzNTyDr2JQm4xx,1,0,0,0,0,0,1,0,1,0.14285714285714285,1,0.0,0,0,0,0,0,0,0,1,0,0,1,1
14,559,gZhclo8obnDdq4Hpc6ohnKIqNEyfFli3,7GRhBDsirIGkRZBtSMEzNTyDr2JQm4xx,39,49,24,47,19,0,6,0,145,20.714285714285715,2,0.0,21,24,39,19,28,0,8,6,0,103,42,1
15,571,cuuYGTWWAmhidQoRHdGzANriCatcPrlK,7GRhBDsirIGkRZBtSMEzNTyDr2JQm4xx,61,122,55,105,49,16,9,0,356,50.857142857142854,9,0.0,59,55,91,49,63,16,14,9,0,254,102,0
16,578,eER8RoiVQhlBLlO4WV7kKfWOx4XE0E9c,7GRhBDsirIGkRZBtSMEzNTyDr2JQm4xx,33,89,34,54,19,58,14,0,268,38.285714285714285,7,0.0,41,34,45,19,48,58,9,14,0,139,129,1
17,618,M5ID2aNMWGm5ShsGkFPYgTgN2UReXK8g,7GRhBDsirIGkRZBtSMEzNTyDr2JQm4xx,48,96,40,81,38,1,7,0,263,37.57142857142857,4,0.0,43,40,69,38,53,1,12,7,0,190,73,1
18,694,DVxZxPUgYsodJVtjUg4HG3ZucfJoWgwo,7GRhBDsirIGkRZBtSMEzNTyDr2JQm4xx,57,75,20,183,18,0,40,0,336,48.0,7,0.0,31,20,173,18,44,0,10,40,0,242,94,1
19,755,qVDHsjIzoOtZnTwpJtbJGpvapy4sRYpW,7GRhBDsirIGkRZBtSMEzNTyDr2JQm4xx,64,157,48,110,36,12,25,1,389,55.57142857142857,10,0.0,82,48,99,36,75,12,11,25,1,265,124,1
20,849,se5zs87qj8m5HDpiAuY9fHW8e8hfOFuJ,7GRhBDsirIGkRZBtSMEzNTyDr2JQm4xx,38,141,63,60,20,62,21,1,368,52.57142857142857,3,0.0,55,63,53,20,86,62,7,21,1,191,177,0
21,874,QpsLmP3WeC01C1T5jY6uw1yDvPjAiorO,7GRhBDsirIGkRZBtSMEzNTyDr2JQm4xx,1,0,0,0,0,0,1,0,1,0.14285714285714285,1,0.0,0,0,0,0,0,0,0,1,0,0,1,1
22,948,iYWLR7w0j5yEEe1bCu5IYYyXjnXbv448,7GRhBDsirIGkRZBtSMEzNTyDr2JQm4xx,41,90,35,51,19,27,11,4,237,33.857142857142854,7,0.0,40,35,45,19,50,27,6,11,4,139,98,0
23,998,RJ1FVW8gXQIpK321uzh2Sh69ojlsqnvg,7GRhBDsirIGkRZBtSMEzNTyDr2JQm4xx,1,0,0,0,0,0,1,0,1,0.14285714285714285,1,0.0,0,0,0,0,0,0,0,1,0,0,1,1
24,1042,ypoGZw2r9uT31DVWRK8Ak5IwBPQDf2ZW,7GRhBDsirIGkRZBtSMEzNTyDr2JQm4xx,29,104,33,45,12,3,8,0,205,29.285714285714285,4,0.0,58,33,40,12,46,3,5,8,0,143,62,1
25,1067,9XUvtVr9N38jFL9d3KSBLe5NN0NI5Xv8,7GRhBDsirIGkRZBtSMEzNTyDr2JQm4xx,1,0,0,0,0,0,2,0,2,0.2857142857142857,2,0.0,0,0,0,0,0,0,0,2,0,0,2,1
26,1130,aaJeZnIT5e0GpVZyGMksW5aGfCnXK0Ln,7GRhBDsirIGkRZBtSMEzNTyDr2JQm4xx,49,171,1,124,0,63,22,3,384,54.857142857142854,3,0.0,102,1,93,0,69,63,31,22,3,196,188,1
27,1194,WFh9KL1sDhp4NpPSjJuGtUwdjU2As3jU,7GRhBDsirIGkRZBtSMEzNTyDr2JQm4xx,17,26,5,31,2,0,7,0,71,10.142857142857142,3,0.0,14,5,31,2,12,0,0,7,0,52,19,1
28,1197,x9GXQQjoWNWecF7wnG4Lnubsxy4Sbicl,7GRhBDsirIGkRZBtSMEzNTyDr2JQm4xx,71,172,55,155,44,20,32,0,478,68.28571428571429,5,0.0,99,55,132,44,73,20,23,32,0,330,148,1
29,1293,2CIqPxwfpdleLKAwuxTPlDujU1ToKMCe,7GRhBDsirIGkRZBtSMEzNTyDr2JQm4xx,43,94,40,64,14,80,46,3,341,48.714285714285715,9,0.0,37,40,53,14,57,80,11,46,3,144,197,0
30,1298,xdVF44pcmC57LxybIN6S03WC3lkijhye,7GRhBDsirIGkRZBtSMEzNTyDr2JQm4xx,5,3,2,0,2,0,2,0,9,1.2857142857142858,1,0.0,0,2,0,2,3,0,0,2,0,4,5,0
31,1304,CSh5hGbaSFu2yCb31iVMOVwKocrH471Q,7GRhBDsirIGkRZBtSMEzNTyDr2JQm4xx,7,20,12,0,6,0,7,0,45,6.428571428571429,6,0.0,2,12,0,6,18,0,0,7,0,20,25,1
32,1327,2cWT2r9kI6XDpveso7mwMhmCGJDMpJ6X,7GRhBDsirIGkRZBtSMEzNTyDr2JQm4xx,27,52,1,68,5,6,15,1,148,21.142857142857142,2,0.0,23,1,59,5,29,6,9,15,1,88,60,1
33,1334,BdwcZr5MO8X0sPJO0Tqucc1g1g6IA4vq,7GRhBDsirIGkRZBtSMEzNTyDr2JQm4xx,10,16,3,10,1,0,4,0,34,4.857142857142857,2,0.0,3,3,9,1,13,0,1,4,0,16,18,0
34,1395,YAuAlaDad79jVXW80O0RGtQjJBBOLDit,7GRhBDsirIGkRZBtSMEzNTyDr2JQm4xx,5,4,1,0,0,0,3,1,9,1.2857142857142858,1,0.0,1,1,0,0,3,0,0,3,1,2,7,1
35,1396,4pgEahxP0BMucPOaES4iKt1glSEl2goc,7GRhBDsirIGkRZBtSMEzNTyDr2JQm4xx,70,335,90,141,32,66,55,5,724,103.42857142857143,9,0.0,160,90,113,32,175,66,28,55,5,395,329,0
36,1434,M3xTB6LenTJvMpybZKparVtRZKzrRM1R,7GRhBDsirIGkRZBtSMEzNTyDr2JQm4xx,1,0,0,0,0,0,2,0,2,0.2857142857142857,2,0.0,0,0,0,0,0,0,0,2,0,0,2,1
37,1436,hmtOqZVjWQ6rLJb3YkFWytQIy20ogszh,7GRhBDsirIGkRZBtSMEzNTyDr2JQm4xx,42,39,15,75,16,6,15,0,166,23.714285714285715,3,0.0,18,15,64,16,21,6,11,15,0,113,53,1
38,1644,P18honwQPPbELUE86qFIATuZK3YDtjvG,7GRhBDsirIGkRZBtSMEzNTyDr2JQm4xx,29,53,5,48,6,7,6,0,125,17.857142857142858,5,0.0,29,5,38,6,24,7,10,6,0,78,47,1
39,1682,rGP2g0AMaZmMVMjLaxKJkSmzZgbB3U4e,7GRhBDsirIGkRZBtSMEzNTyDr2JQm4xx,4,0,0,0,0,0,4,0,4,0.5714285714285714,1,0.0,0,0,0,0,0,0,0,4,0,0,4,0
40,1739,MSwjf2I17FAgMFqknSNlHHVpwcQKsxyQ,7GRhBDsirIGkRZBtSMEzNTyDr2JQm4xx,18,48,10,21,17,0,4,0,100,14.285714285714286,2,0.0,20,10,17,17,28,0,4,4,0,64,36,1
41,1765,8nlNDsWSaxHCvsMKtqhBs81sknEiTCeb,7GRhBDsirIGkRZBtSMEzNTyDr2JQm4xx,24,36,20,14,17,0,7,0,94,13.428571428571429,7,0.0,7,20,11,17,29,0,3,7,0,55,39,0
42,1771,jImHfNEIObE674KdIbKVj7cCJ4ufqzHJ,7GRhBDsirIGkRZBtSMEzNTyDr2JQm4xx,36,76,31,42,3,353,42,3,550,78.57142857142857,11,0.0,32,31,36,3,44,353,6,42,3,102,448,0
43,1775,mIe8dQN3qDFpsTsivIoOXC4yOCPP2RyG,7GRhBDsirIGkRZBtSMEzNTyDr2JQm4xx,37,60,14,0,14,10,18,1,117,16.714285714285715,4,0.0,22,14,0,14,38,10,0,18,1,50,67,0
44,1808,Slk5JcZSYHmDLQZXaNVmcMDmjJ16kBhI,fbPkOYLVPtPgIt0MxizjfFJov3JbHyAi,32,156,4,56,7,45,23,3,294,42.0,9,0.0,55,4,46,7,101,45,10,23,3,112,182,1
45,1809,oo6yDppb7lwtVg5iRhFytpMjmAuhJrAW,fbPkOYLVPtPgIt0MxizjfFJov3JbHyAi,16,41,22,3,9,134,30,5,244,34.857142857142854,4,0.0,10,22,3,9,31,134,0,30,5,44,200,0
46,1814,KVMcZ0CphnUUs4jbRYRdgMvMogJko09j,fbPkOYLVPtPgIt0MxizjfFJov3JbHyAi,45,80,50,40,27,28,25,0,250,35.714285714285715,5,0.0,20,50,34,27,60,28,6,25,0,131,119,0
47,1836,XlDfnhryafmarvecZhKZMWL7AupGjwi4,fbPkOYLVPtPgIt0MxizjfFJov3JbHyAi,5,11,4,0,1,0,1,0,17,2.4285714285714284,1,0.0,0,4,0,1,11,0,0,1,0,5,12,1
48,1837,QvqMF8oqvOJDLWUvXbTcLl7n0z5cypNQ,fbPkOYLVPtPgIt0MxizjfFJov3JbHyAi,10,12,8,0,6,1,12,2,41,5.857142857142857,1,0.0,1,8,0,6,11,1,0,12,2,15,26,1
49,1846,82UlWF6Fm1gkNum7nNbVw0yOV1BUdNoS,fbPkOYLVPtPgIt0MxizjfFJov3JbHyAi,4,2,1,0,1,18,2,0,24,3.4285714285714284,1,0.0,0,1,0,1,2,18,0,2,0,2,22,1
50,1848,JfQVgXDVu1NGs9lcRBOD4w6V7BSaZCc2,fbPkOYLVPtPgIt0MxizjfFJov3JbHyAi,45,57,29,32,17,38,23,0,196,28.0,7,0.0,15,29,28,17,42,38,4,23,0,89,107,0
51,1850,62aEkx5hiqjq7miMyrFwVbP7Jkesq4eo,fbPkOYLVPtPgIt0MxizjfFJov3JbHyAi,9,4,3,0,3,0,2,0,12,1.7142857142857142,1,0.0,0,3,0,3,4,0,0,2,0,6,6,0
52,1854,sjBn8oayOINN3T3JZLXHY4beCfaHLSkq,fbPkOYLVPtPgIt0MxizjfFJov3JbHyAi,28,51,17,21,17,19,8,1,134,19.142857142857142,3,0.0,26,17,19,17,25,19,2,8,1,79,55,0
53,1855,cy2CnLMLxJkryBCEHSwR3ZMTpAjnoO1C,fbPkOYLVPtPgIt0MxizjfFJov3JbHyAi,50,206,38,17,18,711,104,1,1095,156.42857142857142,11,0.0,20,38,16,18,186,711,1,104,1,92,1003,0
54,1857,3LBSAbcxxmlIGNLvUbxOBHP17eWw2EWo,fbPkOYLVPtPgIt0MxizjfFJov3JbHyAi,10,8,5,0,4,0,2,0,19,2.7142857142857144,2,0.0,0,5,0,4,8,0,0,2,0,9,10,0
55,1866,mrzCfkgyM6KyC9H5Ok54xCLYWyp2COiw,fbPkOYLVPtPgIt0MxizjfFJov3JbHyAi,9,7,3,0,3,17,3,1,34,4.857142857142857,1,0.0,2,3,0,3,5,17,0,3,1,8,26,1
56,1868,euJ8gpxfARpnWjt9X8Fyxm47A6A32cKl,fbPkOYLVPtPgIt0MxizjfFJov3JbHyAi,44,138,70,25,28,112,42,2,417,59.57142857142857,11,0.0,21,70,21,28,117,112,4,42,2,140,277,0
57,1877,BPWa0SjleiqllaywZCKubwGSdtmQ6n1j,fbPkOYLVPtPgIt0MxizjfFJov3JbHyAi,6,3,1,0,1,0,2,0,7,1.0,1,0.0,0,1,0,1,3,0,0,2,0,2,5,1
58,1885,9sckfYHCSe28pCKnT8xoBCq2thEZcsel,fbPkOYLVPtPgIt0MxizjfFJov3JbHyAi,11,34,3,5,3,0,4,0,49,7.0,2,0.0,5,3,4,3,29,0,1,4,0,15,34,1
59,1889,9lZ5nNFJAuEwr4dRJLRoTk52o5oWJaUg,fbPkOYLVPtPgIt0MxizjfFJov3JbHyAi,45,75,35,22,22,111,29,2,296,42.285714285714285,8,0.0,24,35,21,22,51,111,1,29,2,102,194,0
60,1892,h8BwrBZ61dHhi5fhxZzTUeeYh9J3sER4,fbPkOYLVPtPgIt0MxizjfFJov3JbHyAi,31,32,24,0,18,5,10,0,89,12.714285714285714,4,0.0,1,24,0,18,31,5,0,10,0,43,46,0
61,1900,FELnhQR0c7GZZX82ioYJEZsqujOrfyf7,fbPkOYLVPtPgIt0MxizjfFJov3JbHyAi,11,8,5,0,3,23,6,2,47,6.714285714285714,2,0.0,1,5,0,3,7,23,0,6,2,9,38,1
62,1905,rH9yibot6cCOaAZphZeWIT7V2pydvksO,fbPkOYLVPtPgIt0MxizjfFJov3JbHyAi,7,5,3,0,2,0,2,0,12,1.7142857142857142,2,0.0,0,3,0,2,5,0,0,2,0,5,7,1
63,1907,O4E7as3W8jLvygS4k9RX6VKdAkX7GkpR,fbPkOYLVPtPgIt0MxizjfFJov3JbHyAi,12,10,4,4,6,1,7,0,32,4.571428571428571,1,0.0,5,4,4,6,5,1,0,7,0,19,13,0
64,1908,uJfbc9I7P24gwBxCb4NuFSYLPcQJXbJC,fbPkOYLVPtPgIt0MxizjfFJov3JbHyAi,46,174,102,46,68,134,67,10,601,85.85714285714286,10,0.0,51,102,37,68,123,134,9,67,10,258,343,0
65,1914,Ms0MC4W5moiGJLWP7iE3FImeH9CHN4KT,fbPkOYLVPtPgIt0MxizjfFJov3JbHyAi,15,22,10,0,5,3,8,2,50,7.142857142857143,4,0.0,4,10,0,5,18,3,0,8,2,19,31,0
66,1919,ZVE1PX7xOz79BV4QTr7JFzHx09U83o43,fbPkOYLVPtPgIt0MxizjfFJov3JbHyAi,30,83,47,12,28,16,9,1,196,28.0,4,0.0,20,47,11,28,63,16,1,9,1,106,90,0
67,1920,3Nb5o5OohsDNIgLceYbTurAWBMiIQRDh,fbPkOYLVPtPgIt0MxizjfFJov3JbHyAi,44,58,32,31,26,16,8,0,171,24.428571428571427,3,0.0,19,32,26,26,39,16,5,8,0,103,68,0
68,1924,bRmU4ghbgx16XrcSMiRmwAVngSF9Tm10,fbPkOYLVPtPgIt0MxizjfFJov3JbHyAi,7,8,4,0,3,0,3,0,18,2.5714285714285716,3,0.0,0,4,0,3,8,0,0,3,0,7,11,0
69,1925,UHEdqIfQMlcBmdDDlAACqjd4uHB22PZR,fbPkOYLVPtPgIt0MxizjfFJov3JbHyAi,7,10,5,0,0,5,4,1,25,3.5714285714285716,4,0.0,0,5,0,0,10,5,0,4,1,5,20,0
70,1927,KGKXtIu1hkHju7SCZs8gtmA9OwHIqK9w,fbPkOYLVPtPgIt0MxizjfFJov3JbHyAi,40,214,149,1,58,360,81,2,865,123.57142857142857,13,0.0,22,149,1,58,192,360,0,81,2,230,635,0
71,1930,7Qi8MZVdpAWF6Jx24ApQvOp3KudDuUEC,fbPkOYLVPtPgIt0MxizjfFJov3JbHyAi,11,13,8,0,5,0,3,0,29,4.142857142857143,2,0.0,0,8,0,5,13,0,0,3,0,13,16,1
72,1937,vtrHNbtnxRGyZem1sSOdKIp109fZtSKY,fbPkOYLVPtPgIt0MxizjfFJov3JbHyAi,31,41,19,22,10,46,23,1,162,23.142857142857142,3,0.0,9,19,18,10,32,46,4,23,1,56,106,0
73,1944,FPtAc2MhfpwZkpPIx5xZqPDLAMDq2xlZ,fbPkOYLVPtPgIt0MxizjfFJov3JbHyAi,24,44,13,17,7,30,17,2,130,18.571428571428573,4,0.0,11,13,13,7,33,30,4,17,2,44,86,0
74,1946,oNX40hvUpCseO8BHKhGJvG2jyQpYKQyk,fbPkOYLVPtPgIt0MxizjfFJov3JbHyAi,13,19,11,4,7,7,5,0,53,7.571428571428571,3,0.0,4,11,4,7,15,7,0,5,0,26,27,0
75,3978,h8n9HekAuyT08sLL5qmdMZ3BdSJVR4QF,fbPkOYLVPtPgIt0MxizjfFJov3JbHyAi,19,48,27,0,8,110,32,2,227,32.42857142857143,9,0.0,3,27,0,8,45,110,0,32,2,38,189,0
76,3979,2GATpIfDBYFyTgYmFkr0bda9mVfNXuAl,fbPkOYLVPtPgIt0MxizjfFJov3JbHyAi,45,111,44,40,32,6,19,1,253,36.142857142857146,7,0.0,37,44,37,32,74,6,3,19,1,150,103,0
77,3980,7CTS8g5RByDUjwfG52XdQusTnAWGmBhD,fbPkOYLVPtPgIt0MxizjfFJov3JbHyAi,7,5,3,0,3,0,5,0,16,2.2857142857142856,2,0.0,0,3,0,3,5,0,0,5,0,6,10,1
78,3981,fbTCtGbhuEEqIHlqmw0iRyoH7wNTYXlV,fbPkOYLVPtPgIt0MxizjfFJov3JbHyAi,7,3,2,0,2,0,3,0,10,1.4285714285714286,1,0.0,0,2,0,2,3,0,0,3,0,4,6,1
79,3983,eQnxTOv5tF733HrH1v8IIfXTQQ20WB86,fbPkOYLVPtPgIt0MxizjfFJov3JbHyAi,5,2,1,0,1,7,9,0,20,2.857142857142857,2,0.0,0,1,0,1,2,7,0,9,0,2,18,1
80,3984,oY9JHCaqebrwbBFVvySUXQvzoRiFSB12,fbPkOYLVPtPgIt0MxizjfFJov3JbHyAi,8,5,2,0,2,3,6,1,19,2.7142857142857144,1,0.0,2,2,0,2,3,3,0,6,1,6,13,1
81,3985,d4cb9OZbLbDBqzuhcJemwCaulhBw3XcA,fbPkOYLVPtPgIt0MxizjfFJov3JbHyAi,18,55,10,21,9,15,2,0,112,16.0,2,0.0,19,10,18,9,36,15,3,2,0,56,56,1
82,3996,w2cvWGtYDFIPnh2ovYoWa5sxrg1Qp0H1,fbPkOYLVPtPgIt0MxizjfFJov3JbHyAi,4,2,1,0,1,0,3,0,7,1.0,1,0.0,0,1,0,1,2,0,0,3,0,2,5,1
83,3997,ZoqTlt1YSWNa9KffVPpNehpQugTpP3Na,fbPkOYLVPtPgIt0MxizjfFJov3JbHyAi,18,14,9,0,8,0,12,0,43,6.142857142857143,2,0.0,0,9,0,8,14,0,0,12,0,17,26,1
84,3998,q4Yehmjs3jQT9rXdV6cXhcGjESMqINf5,fbPkOYLVPtPgIt0MxizjfFJov3JbHyAi,47,106,67,30,35,27,22,2,289,41.285714285714285,11,0.0,20,67,27,35,86,27,3,22,2,149,140,0
85,4004,guY4SSn1fy4TWThod7s2lBFrUtiOX15g,fbPkOYLVPtPgIt0MxizjfFJov3JbHyAi,23,24,13,1,11,3,9,1,62,8.857142857142858,4,0.0,5,13,1,11,19,3,0,9,1,30,32,1
86,4007,tfoakS3EMOjWuYWNRSgWZTjBxe3Mf9Te,fbPkOYLVPtPgIt0MxizjfFJov3JbHyAi,10,9,4,0,2,3,10,1,29,4.142857142857143,4,0.0,0,4,0,2,9,3,0,10,1,6,23,0
87,4008,54s32diFNl04mUbmkn3h7tEt4XEhQ65w,fbPkOYLVPtPgIt0MxizjfFJov3JbHyAi,7,6,3,0,2,0,3,0,14,2.0,2,0.0,1,3,0,2,5,0,0,3,0,6,8,0
88,4009,yQdl23AC4WuqLN6qLaK80XdAyoAoH1QK,fbPkOYLVPtPgIt0MxizjfFJov3JbHyAi,9,3,2,0,2,1,10,1,19,2.7142857142857144,1,0.0,0,2,0,2,3,1,0,10,1,4,15,1
89,4011,cHr4Ma0WfX0OLiO7JvZC8s1q3EauwDjN,fbPkOYLVPtPgIt0MxizjfFJov3JbHyAi,25,66,27,5,24,9,24,5,160,22.857142857142858,5,0.0,15,27,4,24,51,9,1,24,5,70,90,1
90,4012,bZSiNUbAIuydDBd77IMAJ15Hy6k2A1kT,fbPkOYLVPtPgIt0MxizjfFJov3JbHyAi,1,0,0,0,0,0,1,0,1,0.14285714285714285,1,0.0,0,0,0,0,0,0,0,1,0,0,1,1
91,4020,s7dtbhPs1iKqu788xCkGZggRAum1oJgW,fbPkOYLVPtPgIt0MxizjfFJov3JbHyAi,7,2,1,0,1,1,5,2,12,1.7142857142857142,1,0.0,0,1,0,1,2,1,0,5,2,2,10,1
92,4023,A98oANyiAwfle2kQ1TjJxeaYVrk9o9i7,fbPkOYLVPtPgIt0MxizjfFJov3JbHyAi,25,81,41,25,17,126,25,3,318,45.42857142857143,4,0.0,22,41,19,17,59,126,6,25,3,99,219,1
93,4027,WYF6gnZ4xRpre5Df26WMDKWFofwrAPRG,fbPkOYLVPtPgIt0MxizjfFJov3JbHyAi,14,97,0,8,0,19,26,1,151,21.571428571428573,9,0.0,13,0,8,0,84,19,0,26,1,21,130,1
94,4032,rLDet26H0uxPJ5dsCZ5fa0WL1GxwPxuK,fbPkOYLVPtPgIt0MxizjfFJov3JbHyAi,8,5,3,0,2,9,3,0,22,3.142857142857143,2,0.0,0,3,0,2,5,9,0,3,0,5,17,1
95,4033,OkJ0lKmMXuQ2MGftQ8Isfw1JciMpapRC,fbPkOYLVPtPgIt0MxizjfFJov3JbHyAi,5,3,2,0,2,2,2,0,11,1.5714285714285714,1,0.0,0,2,0,2,3,2,0,2,0,4,7,0
96,4034,rGQNVCuxfrzbvnkFPCMdRGiz6QMgyFzA,fbPkOYLVPtPgIt0MxizjfFJov3JbHyAi,6,5,2,0,3,0,1,0,11,1.5714285714285714,1,0.0,2,2,0,3,3,0,0,1,0,7,4,1
97,4037,87Lm8BclRnYN39dmpTmFhTgJtRlJLHVz,fbPkOYLVPtPgIt0MxizjfFJov3JbHyAi,5,2,1,0,1,0,2,0,6,0.8571428571428571,1,0.0,0,1,0,1,2,0,0,2,0,2,4,1
98,4038,RZRLmBfJaLV1U3x2iNOo982VF2lx4M5E,fbPkOYLVPtPgIt0MxizjfFJov3JbHyAi,35,45,20,26,12,59,9,1,172,24.571428571428573,8,0.0,10,20,23,12,35,59,3,9,1,65,107,0
99,4041,mmBEzZ1YFdSzzY513HhhaTI5HINoZNej,fbPkOYLVPtPgIt0MxizjfFJov3JbHyAi,6,3,0,0,0,0,5,0,8,1.1428571428571428,1,0.0,0,0,0,0,3,0,0,5,0,0,8,1
100,4043,AzVXW4kCWHtvQbdNXdZjm5qxnXDAkj3A,fbPkOYLVPtPgIt0MxizjfFJov3JbHyAi,7,5,2,0,2,0,2,0,11,1.5714285714285714,1,0.0,2,2,0,2,3,0,0,2,0,6,5,1
101,4045,hC8ztRi3EjwyWcSJecvgX15KmWpaGcdW,fbPkOYLVPtPgIt0MxizjfFJov3JbHyAi,2,0,0,0,0,0,13,0,13,1.8571428571428572,3,0.0,0,0,0,0,0,0,0,13,0,0,13,1
102,4047,lHHgniZkyeFRjJGU3HLkOi9ieHbZHJUQ,fbPkOYLVPtPgIt0MxizjfFJov3JbHyAi,4,2,0,0,0,0,2,0,4,0.5714285714285714,1,0.0,0,0,0,0,2,0,0,2,0,0,4,1
103,4049,L9qMLlGWAeAI6zWAZIyJtn0wISNa3dxg,fbPkOYLVPtPgIt0MxizjfFJov3JbHyAi,4,2,1,0,1,0,2,0,6,0.8571428571428571,2,0.0,0,1,0,1,2,0,0,2,0,2,4,1
104,4050,0MTpVXdT8ASYCb3Z08epLhiKNkl8GgEQ,fbPkOYLVPtPgIt0MxizjfFJov3JbHyAi,18,16,9,11,8,0,6,0,50,7.142857142857143,2,0.0,5,9,9,8,11,0,2,6,0,31,19,1
105,4051,cT78xvKkV1UFGcRKty0V03Jr4RRPh50F,fbPkOYLVPtPgIt0MxizjfFJov3JbHyAi,11,14,5,4,3,0,12,3,41,5.857142857142857,1,0.0,3,5,3,3,11,0,1,12,3,14,27,1
106,4053,AOW4X6UkiHewUAs5OuRwOBQZ55uoQosX,fbPkOYLVPtPgIt0MxizjfFJov3JbHyAi,8,4,2,0,1,2,8,1,18,2.5714285714285716,3,0.0,0,2,0,1,4,2,0,8,1,3,15,1
107,4055,rAB3GdBf2kyPvfhSALJZpfL3o8n2yfaM,fbPkOYLVPtPgIt0MxizjfFJov3JbHyAi,5,2,1,0,1,0,2,0,6,0.8571428571428571,1,0.0,0,1,0,1,2,0,0,2,0,2,4,1
108,4057,FsCZ2JlPdTOKccvkXXkGRkEo9MNtfR49,fbPkOYLVPtPgIt0MxizjfFJov3JbHyAi,4,2,1,0,1,0,1,0,5,0.7142857142857143,1,0.0,0,1,0,1,2,0,0,1,0,2,3,1
109,4058,CZqROpwtMfkuBimM2AQHyYwmYC0nRQMX,fbPkOYLVPtPgIt0MxizjfFJov3JbHyAi,2,0,0,0,0,0,6,0,6,0.8571428571428571,1,0.0,0,0,0,0,0,0,0,6,0,0,6,1
110,4059,k7E3UdMFCxZGbJkrqWFVZo27sTFlZitl,fbPkOYLVPtPgIt0MxizjfFJov3JbHyAi,2,0,0,0,0,0,4,0,4,0.5714285714285714,1,0.0,0,0,0,0,0,0,0,4,0,0,4,1
111,4063,DYy3OcZHNqaAwRPZTK5mmyz2pajxcVFG,fbPkOYLVPtPgIt0MxizjfFJov3JbHyAi,10,21,14,8,10,3,3,0,59,8.428571428571429,4,0.0,3,14,5,10,18,3,3,3,0,32,27,1
112,4067,etwrJvnLVRKl99lXJcTlVgF9a5u8b4IB,fbPkOYLVPtPgIt0MxizjfFJov3JbHyAi,4,2,1,0,1,0,1,0,5,0.7142857142857143,1,0.0,0,1,0,1,2,0,0,1,0,2,3,1
113,4068,Xtya7Ut5RfqXdKIJyeRno0pknCSJ0KQ9,fbPkOYLVPtPgIt0MxizjfFJov3JbHyAi,5,2,1,0,1,0,4,0,8,1.1428571428571428,1,0.0,0,1,0,1,2,0,0,4,0,2,6,1
114,4069,cvrniaRluzl5M2YhJj6gzVR22hfoNS7o,fbPkOYLVPtPgIt0MxizjfFJov3JbHyAi,5,2,1,0,1,0,3,0,7,1.0,1,0.0,0,1,0,1,2,0,0,3,0,2,5,1
115,4073,muLa1Vo0bC9fvm6n6sXrTQPXWjmeflat,fbPkOYLVPtPgIt0MxizjfFJov3JbHyAi,2,0,0,0,0,0,2,0,2,0.2857142857142857,1,0.0,0,0,0,0,0,0,0,2,0,0,2,0
116,4074,pPhnCYGqjbUED63FvqrsKWCb9oPSb13A,fbPkOYLVPtPgIt0MxizjfFJov3JbHyAi,8,6,4,0,3,4,5,0,22,3.142857142857143,1,0.0,0,4,0,3,6,4,0,5,0,7,15,1
117,4075,p9RSc47fxU5KZrLFjwRWdfPjsbrYYsbL,fbPkOYLVPtPgIt0MxizjfFJov3JbHyAi,17,36,11,20,10,26,16,1,120,17.142857142857142,4,0.0,12,11,16,10,24,26,4,16,1,49,71,1
118,4076,xyBRzNYMnXahEQBoehtwEHCPr5ttcqSy,fbPkOYLVPtPgIt0MxizjfFJov3JbHyAi,9,7,3,0,4,0,4,0,18,2.5714285714285716,1,0.0,3,3,0,4,4,0,0,4,0,10,8,1
119,4078,yZ6537rd8avkULuEwmDtoeWv0g2tI9No,fbPkOYLVPtPgIt0MxizjfFJov3JbHyAi,6,5,4,0,4,5,2,0,20,2.857142857142857,1,0.0,0,4,0,4,5,5,0,2,0,8,12,1
120,4079,k6RJ44LpfDefc4BqSfb5Ks3bqRLzpbPs,fbPkOYLVPtPgIt0MxizjfFJov3JbHyAi,5,4,2,0,1,0,3,0,10,1.4285714285714286,2,0.0,0,2,0,1,4,0,0,3,0,3,7,1
121,4080,wGCry3EmryoBv7Csae49tbGzHF0lQra2,fbPkOYLVPtPgIt0MxizjfFJov3JbHyAi,7,4,2,0,1,5,10,0,22,3.142857142857143,2,0.0,0,2,0,1,4,5,0,10,0,3,19,1
122,4082,Intzo0A8tpMyd3IA01YG1BctRIdPWdNV,fbPkOYLVPtPgIt0MxizjfFJov3JbHyAi,10,22,1,4,0,33,7,0,67,9.571428571428571,3,0.0,4,1,3,0,18,33,1,7,0,8,59,0
123,4085,kjoYyxOsZaiCA9S8PMK5B69QLaH15SYn,fbPkOYLVPtPgIt0MxizjfFJov3JbHyAi,10,19,12,0,6,21,9,0,67,9.571428571428571,4,0.0,0,12,0,6,19,21,0,9,0,18,49,1
124,4086,99KAycUWIde0VU3hu66xpS6f8Dw5XMUf,fbPkOYLVPtPgIt0MxizjfFJov3JbHyAi,6,3,0,0,0,9,5,1,18,2.5714285714285716,1,0.0,0,0,0,0,3,9,0,5,1,0,18,1
125,4087,kyUPY0MEVeZNvkmrQxOn0CHNXLZiD03b,fbPkOYLVPtPgIt0MxizjfFJov3JbHyAi,11,15,7,0,2,9,8,0,41,5.857142857142857,3,0.0,2,7,0,2,13,9,0,8,0,11,30,0
126,4089,xHHwDRtwZQVvSchbI5GuritLImybQBlY,fbPkOYLVPtPgIt0MxizjfFJov3JbHyAi,22,60,47,0,39,13,11,0,170,24.285714285714285,5,0.0,0,47,0,39,60,13,0,11,0,86,84,1
127,4092,FWBo1Ve6aUEc5FnBNwSlwL8Ejasy32Ah,fbPkOYLVPtPgIt0MxizjfFJov3JbHyAi,24,207,5,21,8,62,18,3,324,46.285714285714285,11,0.0,59,5,17,8,148,62,4,18,3,89,235,1
128,4094,aHy0SOLp5TIYEPrUDsA19thlT8zgE9kw,fbPkOYLVPtPgIt0MxizjfFJov3JbHyAi,7,3,2,0,2,0,2,0,9,1.2857142857142858,1,0.0,0,2,0,2,3,0,0,2,0,4,5,1
129,4096,7f5BucMg0feISwFBvqaHF0DKL8QG4WFt,fbPkOYLVPtPgIt0MxizjfFJov3JbHyAi,6,8,3,0,2,2,6,0,21,3.0,3,0.0,0,3,0,2,8,2,0,6,0,5,16,1
130,4098,7t6XdKZrxDN4lQnu2mS0b8xNunzNVAPj,fbPkOYLVPtPgIt0MxizjfFJov3JbHyAi,6,3,2,0,2,0,1,0,8,1.1428571428571428,1,0.0,0,2,0,2,3,0,0,1,0,4,4,1
131,4099,Rp1QUon6WyfjWJdUcBo02v2P6oL5StoN,fbPkOYLVPtPgIt0MxizjfFJov3JbHyAi,34,74,41,10,29,132,37,9,332,47.42857142857143,7,0.0,19,41,8,29,55,132,2,37,9,97,235,0
132,4100,biOEnvJNbNmJmtnLohBToN5g3ppQrMj4,fbPkOYLVPtPgIt0MxizjfFJov3JbHyAi,30,108,30,36,29,23,14,3,243,34.714285714285715,3,0.0,29,30,30,29,79,23,6,14,3,118,125,0
133,4102,DQcZziMBGJTQn4VwY66mMsTqydvYxO88,fbPkOYLVPtPgIt0MxizjfFJov3JbHyAi,15,31,17,4,8,4,9,0,73,10.428571428571429,5,0.0,5,17,3,8,26,4,1,9,0,33,40,1
134,4104,cT38CQfUVEuJ2lsb0Hk89Z8ENzEcFYoN,fbPkOYLVPtPgIt0MxizjfFJov3JbHyAi,11,12,3,4,4,17,15,5,60,8.571428571428571,1,0.0,6,3,3,4,6,17,1,15,5,16,44,1
135,4107,hXZgc5Oc8L3KNvO8ElQE29RF6Exzr76M,fbPkOYLVPtPgIt0MxizjfFJov3JbHyAi,35,222,7,30,9,38,33,1,340,48.57142857142857,12,0.0,56,7,28,9,166,38,2,33,1,100,240,1
136,4109,UTHVC9ResLri50kLlwVRolzN0EU0QbSV,fbPkOYLVPtPgIt0MxizjfFJov3JbHyAi,7,9,3,0,4,0,3,0,19,2.7142857142857144,1,0.0,4,3,0,4,5,0,0,3,0,11,8,1
137,4110,IhZdPOtOeXyg0OwsQIkD0XHc4IVBLzMp,fbPkOYLVPtPgIt0MxizjfFJov3JbHyAi,7,8,3,0,3,15,1,0,30,4.285714285714286,1,0.0,3,3,0,3,5,15,0,1,0,9,21,1
138,4115,JxLtKAnMek98G5fWpyeTaKlh0zheuNnU,fbPkOYLVPtPgIt0MxizjfFJov3JbHyAi,9,14,8,0,5,2,6,0,35,5.0,3,0.0,0,8,0,5,14,2,0,6,0,13,22,1
139,4118,lJBDlJfqpfLWNzA9gJNRBPGPdfnA8FjE,fbPkOYLVPtPgIt0MxizjfFJov3JbHyAi,11,14,4,5,5,0,10,0,38,5.428571428571429,2,0.0,6,4,4,5,8,0,1,10,0,19,19,1
140,4119,NDGD5kd43PPvwOqGnZbnmRA4IWxJUUWC,fbPkOYLVPtPgIt0MxizjfFJov3JbHyAi,11,10,6,0,5,13,5,1,40,5.714285714285714,1,0.0,0,6,0,5,10,13,0,5,1,11,29,1
141,4120,PLiz4R37f42hgWuNrDCM4We21NotfdFu,fbPkOYLVPtPgIt0MxizjfFJov3JbHyAi,10,8,3,0,3,0,4,0,18,2.5714285714285716,1,0.0,0,3,0,3,8,0,0,4,0,6,12,1
142,4123,v5fgLzwSp4csuplvg9kjWtplfkZ2GwCX,fbPkOYLVPtPgIt0MxizjfFJov3JbHyAi,47,78,42,48,24,87,28,1,308,44.0,9,0.0,17,42,45,24,61,87,3,28,1,128,180,1
143,4128,QFQlbn421RXpUzVVaKhkxpBlvQfTJy18,fbPkOYLVPtPgIt0MxizjfFJov3JbHyAi,1,0,0,0,0,0,2,0,2,0.2857142857142857,2,0.0,0,0,0,0,0,0,0,2,0,0,2,1
144,4131,IeoenmsgL9uI9DnVMbUVvL3IGBjOCvft,fbPkOYLVPtPgIt0MxizjfFJov3JbHyAi,7,22,10,0,6,6,4,0,48,6.857142857142857,2,0.0,1,10,0,6,21,6,0,4,0,17,31,1
145,4132,0EnifHYs46yDInpwwIuVTnoLaWAcGzwI,fbPkOYLVPtPgIt0MxizjfFJov3JbHyAi,2,0,0,0,0,0,7,0,7,1.0,1,0.0,0,0,0,0,0,0,0,7,0,0,7,1
146,4139,KGmMkFplDRCxys7XWInR8BCBSZINLZGV,fbPkOYLVPtPgIt0MxizjfFJov3JbHyAi,7,3,2,0,2,0,6,0,13,1.8571428571428572,1,0.0,0,2,0,2,3,0,0,6,0,4,9,1
147,4142,lnvoZ2tnJVetz4XYfY83aKXEsZTCt6TJ,fbPkOYLVPtPgIt0MxizjfFJov3JbHyAi,5,2,1,0,1,0,2,0,6,0.8571428571428571,1,0.0,0,1,0,1,2,0,0,2,0,2,4,1
148,4144,8FXCmdqVnzf3TYAPHoGg8tXyARiNLHCI,fbPkOYLVPtPgIt0MxizjfFJov3JbHyAi,14,34,24,0,13,5,19,1,96,13.714285714285714,3,0.0,2,24,0,13,32,5,0,19,1,39,57,1
149,4151,Ke8VwfqDMnQ67aDANakOnH0vYOFJh9kP,fbPkOYLVPtPgIt0MxizjfFJov3JbHyAi,5,2,0,0,0,0,4,0,6,0.8571428571428571,1,0.0,0,0,0,0,2,0,0,4,0,0,6,1
150,4153,9bv4TssyKs6woXSaEFvigyhEyIkdO1mQ,fbPkOYLVPtPgIt0MxizjfFJov3JbHyAi,24,65,26,9,18,6,22,1,147,21.0,7,0.0,17,26,9,18,48,6,0,22,1,70,77,1
151,4154,P7HoHyQzVXLghYr6m3MYTEIsDQbHfDfp,fbPkOYLVPtPgIt0MxizjfFJov3JbHyAi,8,7,4,0,3,2,5,0,21,3.0,2,0.0,1,4,0,3,6,2,0,5,0,8,13,1
152,4156,7wnX5auEB03UpnNYej7D6uFMFlr0UMF4,fbPkOYLVPtPgIt0MxizjfFJov3JbHyAi,45,92,26,38,30,57,28,1,272,38.857142857142854,6,0.0,40,26,31,30,52,57,7,28,1,127,145,1
153,4158,i2lUV72IHqqXWYqLFMWv3y4XGmlq2lXa,fbPkOYLVPtPgIt0MxizjfFJov3JbHyAi,15,36,18,18,0,0,13,0,85,12.142857142857142,7,0.0,7,18,17,0,29,0,1,13,0,42,43,0
154,4159,K7x1FBngM9kl9ILUtVAk9JDodBBRiKnk,fbPkOYLVPtPgIt0MxizjfFJov3JbHyAi,5,2,0,0,1,0,2,0,5,0.7142857142857143,1,0.0,0,0,0,1,2,0,0,2,0,1,4,1
155,4165,PQXXfcguNvwGC13fUA8grymIl8Xku68T,fbPkOYLVPtPgIt0MxizjfFJov3JbHyAi,8,5,4,0,1,4,9,1,24,3.4285714285714284,1,0.0,0,4,0,1,5,4,0,9,1,5,19,1
156,4166,bUnyK1hKhmXoEcHzbj5c3xR9U7XUAY5Y,fbPkOYLVPtPgIt0MxizjfFJov3JbHyAi,14,19,5,5,4,4,0,0,37,5.285714285714286,4,0.0,3,5,4,4,16,4,1,0,0,16,21,1
157,4167,1LwHP3062AHKmQwDl3FPlP3B3adaBvx7,fbPkOYLVPtPgIt0MxizjfFJov3JbHyAi,13,7,4,0,4,0,9,1,25,3.5714285714285716,3,0.0,0,4,0,4,7,0,0,9,1,8,17,1
158,4188,Em0hjKXRkhdtpThrexhSS4wvCtqaUFMH,SpATywNh6bZuzm8s1ceuBUnMUAeoAHHw,6,3,2,0,2,0,2,0,9,1.2857142857142858,1,0.0,0,2,0,2,3,0,0,2,0,4,5,0
159,4189,DMRT6aSto1hsV85RHmev1d5IWcNMIFEq,SpATywNh6bZuzm8s1ceuBUnMUAeoAHHw,22,39,14,6,4,19,9,0,91,13.0,5,0.0,7,14,6,4,32,19,0,9,0,31,60,0
160,4191,s0DIFg7W3dnddXITKcNP8LHUkKIQHugk,A3fsA9Zfv1X2fVEQhTw51lKENdNrEqT3,42,28,16,36,13,0,8,2,103,14.714285714285714,6,0.0,1,16,35,13,27,0,1,8,2,65,38,0
161,4240,bN6JhUz4s97Xsh7eq2ZH1ilTMaKJDuUF,A3fsA9Zfv1X2fVEQhTw51lKENdNrEqT3,69,124,47,138,26,44,28,2,409,58.42857142857143,9,0.0,6,47,109,26,118,44,29,28,2,188,221,1
162,4257,7FYMj2bFfaTXHKfoaKa59KqAPXY4BWgD,SpATywNh6bZuzm8s1ceuBUnMUAeoAHHw,28,35,21,29,7,0,14,0,106,15.142857142857142,6,0.0,4,21,27,7,31,0,2,14,0,59,47,0
163,4264,I91CCtQfetYUPwkEXIvTFBP6tbrp1spN,SpATywNh6bZuzm8s1ceuBUnMUAeoAHHw,31,40,20,14,13,3,8,2,100,14.285714285714286,3,0.0,16,20,13,13,24,3,1,8,2,62,38,0
164,4267,RGl45e2VVMMdpatWhMc5IOKclnuxXpA1,SpATywNh6bZuzm8s1ceuBUnMUAeoAHHw,13,7,6,8,3,0,9,0,33,4.714285714285714,1,0.0,1,6,6,3,6,0,2,9,0,16,17,0
165,4289,zEiNHlokNuJTLVoV4Hy4kJd9kzaIjztD,G8EPVSXsOYB5YQWZGiz1aVq5Pgr2GrQu,66,131,37,116,25,40,7,0,356,50.857142857142854,5,0.0,59,37,77,25,72,40,39,7,0,198,158,1
166,4315,BQkLFspAkEwZRgeuoSbQxFTr6POAaRzP,SpATywNh6bZuzm8s1ceuBUnMUAeoAHHw,15,22,4,38,0,5,8,3,80,11.428571428571429,3,0.0,15,4,35,0,7,5,3,8,3,54,26,0
167,4363,TQnfaXCRCgVZx9kYYn4s6Q3eXGXW2mAu,SpATywNh6bZuzm8s1ceuBUnMUAeoAHHw,27,42,11,34,5,77,13,2,184,26.285714285714285,4,0.0,11,11,28,5,31,77,6,13,2,55,129,0
168,4367,5I2aLwWP8vG6g175Y3fJi9X9n53v6aCn,SpATywNh6bZuzm8s1ceuBUnMUAeoAHHw,31,92,54,44,19,317,68,3,597,85.28571428571429,11,0.0,16,54,34,19,76,317,10,68,3,123,474,1
169,4380,5GeMwmyzCXMcMYfcWdKaXbpNNdL8bmPq,bWdj2GDclj5ofokWjzoa5jAwMkxCykd6,40,57,31,138,8,200,50,2,486,69.42857142857143,7,0.0,10,31,109,8,47,200,29,50,2,158,328,0
170,4385,wzrtLsMLUwSE1eXDXVMESg2JjrWZl4JD,SpATywNh6bZuzm8s1ceuBUnMUAeoAHHw,6,13,6,0,0,0,2,0,21,3.0,4,0.0,3,6,0,0,10,0,0,2,0,9,12,0
171,4417,0wJhtCWK60WPCeRF62m8T80DtNpWhRrg,A3fsA9Zfv1X2fVEQhTw51lKENdNrEqT3,44,30,15,72,12,0,5,0,134,19.142857142857142,3,0.0,1,15,69,12,29,0,3,5,0,97,37,1
172,4427,8DDe6pT3DTsk8IoUaxeHbA3kSbfeV3pT,SpATywNh6bZuzm8s1ceuBUnMUAeoAHHw,6,1,1,0,1,0,6,0,9,1.2857142857142858,1,0.0,0,1,0,1,1,0,0,6,0,2,7,1
173,4429,BKMLDrZrwnjIMy3sAyFHQhrFM6liXbvY,SpATywNh6bZuzm8s1ceuBUnMUAeoAHHw,11,14,0,12,0,0,2,0,28,4.0,1,0.0,7,0,12,0,7,0,0,2,0,19,9,1
174,4438,3IgwuZBiVdgdYRQ9ySaEvpMizbjCJFS0,SpATywNh6bZuzm8s1ceuBUnMUAeoAHHw,17,31,11,8,4,38,18,1,111,15.857142857142858,4,0.0,11,11,8,4,20,38,0,18,1,34,77,0
175,4460,oxOzo82Nq65tcwE6AZvxglw3lN8SeywJ,bWdj2GDclj5ofokWjzoa5jAwMkxCykd6,17,30,15,104,9,0,8,0,166,23.714285714285715,2,0.0,7,15,98,9,23,0,6,8,0,129,37,1
176,4471,lEIFkqeT396JMSPUyiaHNMN8g7bQ1x9p,RXDvfPUBYFlVdlueBFbLW0mhhAyGEqpt,6,3,0,0,0,0,10,1,14,2.0,3,0.0,0,0,0,0,3,0,0,10,1,0,14,0
177,4492,800Nw5pvfdV7zCXCGav7KOLaYLAdOKht,SpATywNh6bZuzm8s1ceuBUnMUAeoAHHw,24,76,2,26,1,48,66,1,220,31.428571428571427,7,0.0,18,2,26,1,58,48,0,66,1,47,173,0
178,4494,wONMmUHIYwPBmEB9lgpOY3KCldKiuZFl,G8EPVSXsOYB5YQWZGiz1aVq5Pgr2GrQu,29,33,21,2,13,7,27,2,105,15.0,6,0.0,6,21,2,13,27,7,0,27,2,42,63,0
179,4503,JJDRXXLRU75H8Dx2cuK7Td1V7D7QoKg9,SpATywNh6bZuzm8s1ceuBUnMUAeoAHHw,13,12,1,0,1,2,8,1,25,3.5714285714285716,2,0.0,3,1,0,1,9,2,0,8,1,5,20,0
180,4529,DB1URyLII1znnmxnZlmmkOEalzIpmvtZ,A3fsA9Zfv1X2fVEQhTw51lKENdNrEqT3,18,18,9,0,5,0,6,0,38,5.428571428571429,1,0.0,0,9,0,5,18,0,0,6,0,14,24,1
181,4557,s4xNNQ4RZ35amMfmvZawsu7u8CabnIey,A3fsA9Zfv1X2fVEQhTw51lKENdNrEqT3,46,38,24,78,12,87,37,2,278,39.714285714285715,5,0.0,4,24,61,12,34,87,17,37,2,101,177,0
182,4558,oxOzo82Nq65tcwE6AZvxglw3lN8SeywJ,A3fsA9Zfv1X2fVEQhTw51lKENdNrEqT3,21,18,13,0,9,0,5,0,45,6.428571428571429,2,0.0,0,13,0,9,18,0,0,5,0,22,23,1
183,4562,sOkc0wEXSSLpxtxlqjZObJqg94IyLpuY,bWdj2GDclj5ofokWjzoa5jAwMkxCykd6,35,65,1,98,0,17,29,1,211,30.142857142857142,8,0.0,8,1,87,0,57,17,11,29,1,96,115,1
184,4576,alnogGpZqhBWQHh6ZLeZUIXk896ksLOu,RXDvfPUBYFlVdlueBFbLW0mhhAyGEqpt,14,29,1,2,1,4,15,3,55,7.857142857142857,3,0.0,2,1,2,1,27,4,0,15,3,6,49,1
185,4580,PUW0i4IuafllkJEtV0GCqmTDeLHkDmH3,A3fsA9Zfv1X2fVEQhTw51lKENdNrEqT3,65,108,24,169,8,251,57,2,619,88.42857142857143,10,0.0,3,24,133,8,105,251,36,57,2,168,451,0
186,4609,UqksMVZ1lLvn2u7s6dT9SU5OFeNJnaAy,A3fsA9Zfv1X2fVEQhTw51lKENdNrEqT3,45,73,34,42,21,3,9,2,184,26.285714285714285,4,0.0,4,34,38,21,69,3,4,9,2,97,87,1
187,4639,3OcDTnCwcizCpcOtz2UR6tflsBOvlv2R,SpATywNh6bZuzm8s1ceuBUnMUAeoAHHw,26,63,4,37,1,1,35,2,143,20.428571428571427,8,0.0,15,4,34,1,48,1,3,35,2,54,89,0
188,4653,IeSddciCla7lkuGxlh3rPQuCAXyzOV2D,SpATywNh6bZuzm8s1ceuBUnMUAeoAHHw,18,34,12,19,8,7,4,0,84,12.0,2,0.0,20,12,18,8,14,7,1,4,0,58,26,1
189,4654,DsHgWZRTJ1y1l15smwhB78ZQq3d8dyKP,SpATywNh6bZuzm8s1ceuBUnMUAeoAHHw,25,86,4,42,3,26,26,3,190,27.142857142857142,8,0.0,21,4,37,3,65,26,5,26,3,65,125,0
190,4668,r5RSR6lot2jmkfKvV1hMDjuwwaPyA58W,SpATywNh6bZuzm8s1ceuBUnMUAeoAHHw,23,47,7,21,6,0,11,0,92,13.142857142857142,4,0.0,21,7,17,6,26,0,4,11,0,51,41,0
191,4678,SXmv5BCLsa8KcmJ2wx7Xg5CRI8Gu1aDd,bWdj2GDclj5ofokWjzoa5jAwMkxCykd6,14,40,19,0,8,19,12,0,98,14.0,4,0.0,0,19,0,8,40,19,0,12,0,27,71,0
192,4682,a59vIKGy87nbLYAxp6cxkmNDzOYhSXnX,SpATywNh6bZuzm8s1ceuBUnMUAeoAHHw,16,24,17,18,9,0,10,0,78,11.142857142857142,3,0.0,2,17,15,9,22,0,3,10,0,43,35,1
193,4699,7xdvqdjwrTcnpU47VRFtnMnSYVyjOAaR,SpATywNh6bZuzm8s1ceuBUnMUAeoAHHw,20,30,4,26,0,0,5,0,65,9.285714285714286,3,0.0,4,4,25,0,26,0,1,5,0,33,32,0
194,4701,eg4vjaGd0e6Yp3fu5azU2ZqedIZ6GBxl,SpATywNh6bZuzm8s1ceuBUnMUAeoAHHw,23,45,2,28,0,8,21,2,106,15.142857142857142,5,0.0,19,2,21,0,26,8,7,21,2,42,64,0
195,4703,C8ZlatATbcer8D4Z8pCX4rv1Rcx870po,RXDvfPUBYFlVdlueBFbLW0mhhAyGEqpt,27,31,14,18,5,5,19,7,99,14.142857142857142,4,0.0,3,14,18,5,28,5,0,19,7,40,59,0
196,4778,xcD6YWhnGA2xukGmX4eaYrm6VS9ffz1H,G8EPVSXsOYB5YQWZGiz1aVq5Pgr2GrQu,26,44,24,36,5,3,10,0,122,17.428571428571427,1,0.0,13,24,26,5,31,3,10,10,0,68,54,0
197,4810,2LtuchYgE8Pco2t6mZeF2PkyT5iYJ1L1,SpATywNh6bZuzm8s1ceuBUnMUAeoAHHw,17,17,4,6,2,31,6,0,66,9.428571428571429,3,0.0,2,4,6,2,15,31,0,6,0,14,52,0
198,4814,SmONSyS4YgG4Afnv6ZxU81t7p4CQPV5P,A3fsA9Zfv1X2fVEQhTw51lKENdNrEqT3,29,48,11,16,8,0,6,0,89,12.714285714285714,4,0.0,0,11,13,8,48,0,3,6,0,32,57,1
199,4828,f2h2VLvmMjqsSE1GgoTjiV7kOBQ7ba5D,SpATywNh6bZuzm8s1ceuBUnMUAeoAHHw,16,29,8,19,5,11,6,0,78,11.142857142857142,2,0.0,18,8,17,5,11,11,2,6,0,48,30,0
200,4862,9k6Repn2h6zXTygwvpy8LAM7GzTSYQBm,G8EPVSXsOYB5YQWZGiz1aVq5Pgr2GrQu,72,103,57,105,37,8,17,3,330,47.142857142857146,5,0.0,37,57,81,37,66,8,24,17,3,212,118,0
201,4866,GmHJt2279LUj6P2OGQD6V5Y1W95kmZpl,SpATywNh6bZuzm8s1ceuBUnMUAeoAHHw,22,53,9,14,4,0,15,0,95,13.571428571428571,6,0.0,0,9,13,4,53,0,1,15,0,26,69,1
202,4870,T2tyjiaDe9s4tWUugE6FZTShWofnfMqo,bWdj2GDclj5ofokWjzoa5jAwMkxCykd6,20,63,6,108,9,36,9,1,232,33.142857142857146,6,0.0,25,6,103,9,38,36,5,9,1,143,89,0
203,4885,sOkc0wEXSSLpxtxlqjZObJqg94IyLpuY,A3fsA9Zfv1X2fVEQhTw51lKENdNrEqT3,45,68,3,66,2,23,35,0,197,28.142857142857142,9,0.0,3,3,59,2,65,23,7,35,0,67,130,0
204,4912,gVGEUb9jfMmddRlcGqXsnz4ZV26w6q4e,SpATywNh6bZuzm8s1ceuBUnMUAeoAHHw,12,11,7,9,4,0,1,0,32,4.571428571428571,1,0.0,3,7,7,4,8,0,2,1,0,21,11,0
205,4918,QDpN8D19Mr8RZumTONWpZNlCWcHCCTbH,A3fsA9Zfv1X2fVEQhTw51lKENdNrEqT3,19,42,5,0,1,0,6,0,54,7.714285714285714,5,0.0,0,5,0,1,42,0,0,6,0,6,48,0
206,4945,ySy2zYThCkVZr5MjEXuKxq60wfOynxkJ,SpATywNh6bZuzm8s1ceuBUnMUAeoAHHw,25,55,1,33,1,42,27,2,161,23.0,6,0.0,6,1,29,1,49,42,4,27,2,37,124,0
207,4946,SVwfCRY50hd9Fz0klab9XqT7QROcyhqY,SpATywNh6bZuzm8s1ceuBUnMUAeoAHHw,16,26,13,18,6,6,6,0,75,10.714285714285714,2,0.0,10,13,15,6,16,6,3,6,0,44,31,0
208,4950,QIQydLQKNp8IAhwJcWzcTMkwBUNbfwOF,SpATywNh6bZuzm8s1ceuBUnMUAeoAHHw,14,32,2,14,0,12,9,1,70,10.0,4,0.0,15,2,14,0,17,12,0,9,1,31,39,0
209,4953,VZdYnvKDyQlSbZcXkY9T9OB3rX2Vy7uz,SpATywNh6bZuzm8s1ceuBUnMUAeoAHHw,2,0,0,0,0,0,2,0,2,0.2857142857142857,1,0.0,0,0,0,0,0,0,0,2,0,0,2,1
210,4981,syrttArug8Mpzs9L0IHsvBtATawYF9J2,bWdj2GDclj5ofokWjzoa5jAwMkxCykd6,39,34,12,93,15,14,6,1,175,25.0,1,0.0,20,12,76,15,14,14,17,6,1,123,52,0
211,4991,meJV5qRzmJA836PpWZKeoFo4ZX1xiQOS,RXDvfPUBYFlVdlueBFbLW0mhhAyGEqpt,15,24,11,8,6,5,4,0,58,8.285714285714286,4,0.0,2,11,8,6,22,5,0,4,0,27,31,1
212,5020,7kNYuUNvdIVdadzDsnKIKM0Ln3KLHYo2,SpATywNh6bZuzm8s1ceuBUnMUAeoAHHw,32,95,39,28,12,25,59,5,263,37.57142857142857,10,0.0,23,39,23,12,72,25,5,59,5,97,166,1
213,5022,QCXbyb2FyuLlETPxf3u27tgIYTs9gTM4,SpATywNh6bZuzm8s1ceuBUnMUAeoAHHw,18,45,18,20,5,35,15,1,139,19.857142857142858,4,0.0,18,18,16,5,27,35,4,15,1,57,82,0
214,5031,6Qw49dxLKsjbapN7r9Da43ajoDW7rCxT,G8EPVSXsOYB5YQWZGiz1aVq5Pgr2GrQu,21,56,35,10,7,497,42,12,659,94.14285714285714,12,0.0,4,35,5,7,52,497,5,42,12,51,608,0
215,5069,pOySDxOmbrI0pDd4UMGfMc77U1VB32Te,A3fsA9Zfv1X2fVEQhTw51lKENdNrEqT3,2,0,0,0,0,0,2,0,2,0.2857142857142857,1,0.0,0,0,0,0,0,0,0,2,0,0,2,1
216,5082,rVF6sxySmleXKBlMsWpXjKDnmQNSzrnS,G8EPVSXsOYB5YQWZGiz1aVq5Pgr2GrQu,40,51,24,64,10,1,26,1,177,25.285714285714285,3,0.0,20,24,47,10,31,1,17,26,1,101,76,0
217,5096,rsMqzQV4BJo2NdhTX79HDXS5zRZgLPX5,SpATywNh6bZuzm8s1ceuBUnMUAeoAHHw,18,14,10,19,7,1,8,0,59,8.428571428571429,2,0.0,4,10,18,7,10,1,1,8,0,39,20,0
218,5142,B6vCUtkVL8SVuEEWctSPinCUr9rxihnh,G8EPVSXsOYB5YQWZGiz1aVq5Pgr2GrQu,42,81,35,82,19,20,12,1,250,35.714285714285715,3,0.0,36,35,62,19,45,20,20,12,1,152,98,0
219,5152,RZI7KROUR7i2T6MB71TuoKGbXE5WXiwO,bWdj2GDclj5ofokWjzoa5jAwMkxCykd6,6,8,0,0,0,0,3,0,11,1.5714285714285714,1,0.0,0,0,0,0,8,0,0,3,0,0,11,1
220,5153,JiVwV8l6zLIAeTDli3uYE3CMxT1oG8Me,SpATywNh6bZuzm8s1ceuBUnMUAeoAHHw,19,39,6,18,2,0,22,0,87,12.428571428571429,6,0.0,7,6,15,2,32,0,3,22,0,30,57,0
221,5173,d6aHeIWZcsirh8eDlHrmG2KrUzDWnJuj,A3fsA9Zfv1X2fVEQhTw51lKENdNrEqT3,14,17,12,0,10,0,8,0,47,6.714285714285714,2,0.0,0,12,0,10,17,0,0,8,0,22,25,1
222,5217,EP1XQRGS4HZOG1hdGzNZdD1HFhJcHpos,RXDvfPUBYFlVdlueBFbLW0mhhAyGEqpt,55,49,4,102,0,28,13,0,196,28.0,4,0.0,14,4,96,0,35,28,6,13,0,114,82,0
223,5224,vEkraIjbJw9RkPvqczZeJYSVVtpO2PkE,G8EPVSXsOYB5YQWZGiz1aVq5Pgr2GrQu,17,14,8,0,10,0,12,0,44,6.285714285714286,3,0.0,5,8,0,10,9,0,0,12,0,23,21,1
224,5259,hdKqkkWKrDzbKE9btGChBqiCfsTwp68E,bWdj2GDclj5ofokWjzoa5jAwMkxCykd6,27,55,29,96,10,150,48,2,390,55.714285714285715,10,0.0,5,29,87,10,50,150,9,48,2,131,259,0
225,5279,cs5iJZEgrhw6pymo9S5BmSlmIVmjOxuC,A3fsA9Zfv1X2fVEQhTw51lKENdNrEqT3,4,2,1,0,1,0,1,0,5,0.7142857142857143,1,0.0,0,1,0,1,2,0,0,1,0,2,3,1
226,5303,o9EVHnUUU8I3f9dlC8NAcnHlKvZOnRmy,bWdj2GDclj5ofokWjzoa5jAwMkxCykd6,16,16,2,24,2,0,3,0,47,6.714285714285714,3,0.0,3,2,21,2,13,0,3,3,0,28,19,0
227,5305,o9EVHnUUU8I3f9dlC8NAcnHlKvZOnRmy,A3fsA9Zfv1X2fVEQhTw51lKENdNrEqT3,58,49,1,92,0,23,19,1,185,26.428571428571427,7,0.0,2,1,86,0,47,23,6,19,1,89,96,0
228,5310,OMEL4ay2FeLAUvBpF5PNfopRFoBTNYW8,SpATywNh6bZuzm8s1ceuBUnMUAeoAHHw,12,27,0,11,0,0,4,0,42,6.0,3,0.0,11,0,10,0,16,0,1,4,0,21,21,0
229,5319,hDWTDNoM8bIQS3Q25EYxxHniqW2wmxDn,bWdj2GDclj5ofokWjzoa5jAwMkxCykd6,9,6,3,0,2,1,4,1,17,2.4285714285714284,1,0.0,0,3,0,2,6,1,0,4,1,5,12,0
230,5332,DJ09O49b2a0ZKXkFKbGfN66X8003c5sz,SpATywNh6bZuzm8s1ceuBUnMUAeoAHHw,10,28,21,0,10,0,6,0,65,9.285714285714286,5,0.0,0,21,0,10,28,0,0,6,0,31,34,1
231,5340,oDnQYjxji4p3XVFJMOGI9NvIvASqoqC1,SpATywNh6bZuzm8s1ceuBUnMUAeoAHHw,2,0,0,0,0,0,3,0,3,0.42857142857142855,2,0.0,0,0,0,0,0,0,0,3,0,0,3,1
232,5345,Kssd3yKtVgKi0ua0svvR8GgbZwRwIJMZ,SpATywNh6bZuzm8s1ceuBUnMUAeoAHHw,24,59,7,12,2,13,12,2,107,15.285714285714286,8,0.0,13,7,12,2,46,13,0,12,2,34,73,0
233,5363,WXWUGznWk133hcEltnw7lYbm2oVZoXLf,SpATywNh6bZuzm8s1ceuBUnMUAeoAHHw,30,98,24,21,7,20,43,24,237,33.857142857142854,6,0.0,6,24,20,7,92,20,1,43,24,57,180,1
234,5389,cd7VGHrZb4Blwr9YuFp9MqF71m5wWUVd,G8EPVSXsOYB5YQWZGiz1aVq5Pgr2GrQu,2,0,0,0,0,0,2,0,2,0.2857142857142857,1,0.0,0,0,0,0,0,0,0,2,0,0,2,0
235,5390,NL3IFunZJHMkqSLqiaHHbVIge1Bdgn26,G8EPVSXsOYB5YQWZGiz1aVq5Pgr2GrQu,29,68,25,40,13,26,18,2,192,27.428571428571427,3,0.0,32,25,29,13,36,26,11,18,2,99,93,0
236,5392,Tj9gyzxktEEAGnL07HQ3qbd2V0oCt16o,SpATywNh6bZuzm8s1ceuBUnMUAeoAHHw,31,120,48,35,14,92,58,8,375,53.57142857142857,7,0.0,28,48,28,14,92,92,7,58,8,118,257,0
237,5397,I6gFU4rZZ1rIaEMk0n0tBNQZ2tGcnjLw,SpATywNh6bZuzm8s1ceuBUnMUAeoAHHw,26,45,19,40,13,0,13,0,130,18.571428571428573,4,0.0,25,19,33,13,20,0,7,13,0,90,40,0
238,5414,4qM7n65VbCTp8lq3dbzhDmImmEZcwgn8,A3fsA9Zfv1X2fVEQhTw51lKENdNrEqT3,42,82,5,118,1,148,51,3,408,58.285714285714285,8,0.0,5,5,99,1,77,148,19,51,3,110,298,0
239,5454,3ZzNkdWgGb47Go07PRKPf0XZ6jjhVCB4,bWdj2GDclj5ofokWjzoa5jAwMkxCykd6,17,42,20,40,13,43,14,0,172,24.571428571428573,6,0.0,11,20,34,13,31,43,6,14,0,78,94,0
240,5458,YOkiW0yIzjAwppKQnKaeEhWktVPNCIFb,A3fsA9Zfv1X2fVEQhTw51lKENdNrEqT3,43,26,18,80,9,2,20,1,156,22.285714285714285,6,0.0,2,18,64,9,24,2,16,20,1,93,63,1
241,5469,fn3RgMp4JCABnOK3IDXz6cUAXpmeuiYQ,SpATywNh6bZuzm8s1ceuBUnMUAeoAHHw,20,18,14,0,10,1,5,0,48,6.857142857142857,2,0.0,0,14,0,10,18,1,0,5,0,24,24,1
242,5472,OLX98cHycOH1FdInwYYk8PZBVFPyIkIG,SpATywNh6bZuzm8s1ceuBUnMUAeoAHHw,18,29,11,10,4,0,7,0,61,8.714285714285714,4,0.0,15,11,10,4,14,0,0,7,0,40,21,0
243,5486,TMdqZjFm6eGvpWCVvOj8xDCqkoxEsWlO,RXDvfPUBYFlVdlueBFbLW0mhhAyGEqpt,10,11,7,0,3,0,2,0,23,3.2857142857142856,2,0.0,0,7,0,3,11,0,0,2,0,10,13,1
244,5487,gqe5NXbZbf5uXY0rPviLeIFOMpQyekdp,SpATywNh6bZuzm8s1ceuBUnMUAeoAHHw,8,5,1,0,0,0,5,0,11,1.5714285714285714,1,0.0,0,1,0,0,5,0,0,5,0,1,10,1
245,5498,F2owRK2SDPW5FCDK4TxmBVHsTtJ44Nxq,bWdj2GDclj5ofokWjzoa5jAwMkxCykd6,7,11,0,0,1,0,5,0,17,2.4285714285714284,3,0.0,0,0,0,1,11,0,0,5,0,1,16,1
246,5499,F2owRK2SDPW5FCDK4TxmBVHsTtJ44Nxq,SpATywNh6bZuzm8s1ceuBUnMUAeoAHHw,14,20,1,9,1,0,3,1,35,5.0,2,0.0,11,1,8,1,9,0,1,3,1,21,14,1
247,5511,YTuPtoiiUgMUEO0EcQhHENEgNCcauWbW,SpATywNh6bZuzm8s1ceuBUnMUAeoAHHw,1,0,0,0,0,0,2,0,2,0.2857142857142857,2,0.0,0,0,0,0,0,0,0,2,0,0,2,1
248,5535,0N8Aw17N0N8m1sn7piRGEu1YkeZIgvRo,SpATywNh6bZuzm8s1ceuBUnMUAeoAHHw,8,5,4,0,4,0,1,0,14,2.0,1,0.0,0,4,0,4,5,0,0,1,0,8,6,0
249,5554,C6xrhZPOmVH2gCVNP26gSSPka2CcwgB5,A3fsA9Zfv1X2fVEQhTw51lKENdNrEqT3,67,37,27,106,19,0,17,0,206,29.428571428571427,6,0.0,10,27,104,19,27,0,2,17,0,160,46,1
250,5568,w1PJeTTskG2DF1TtLUpuz9MkqxNdq5EB,bWdj2GDclj5ofokWjzoa5jAwMkxCykd6,16,31,7,74,3,0,15,3,133,19.0,1,0.0,15,7,72,3,16,0,2,15,3,97,36,1
251,5573,GdXLROZTUYTypGrrX0BjPE53M0Un36D7,SpATywNh6bZuzm8s1ceuBUnMUAeoAHHw,28,87,13,24,5,44,26,5,204,29.142857142857142,4,0.0,44,13,24,5,43,44,0,26,5,86,118,1
252,5582,kKBIfyZmN22zBj263eKBa0SA1U5xYMsR,SpATywNh6bZuzm8s1ceuBUnMUAeoAHHw,27,99,10,18,5,212,24,5,373,53.285714285714285,6,0.0,10,10,17,5,89,212,1,24,5,42,331,0
253,5605,k2w7Fl2HRg9SZoDIHFnK8RXCKuBBE2y7,bWdj2GDclj5ofokWjzoa5jAwMkxCykd6,38,84,39,71,8,229,64,4,499,71.28571428571429,13,0.0,9,39,64,8,75,229,7,64,4,120,379,0
254,5620,ZOxTwY2wRpdYn3qbKBoyT1PgdUitZ7Hl,RXDvfPUBYFlVdlueBFbLW0mhhAyGEqpt,42,57,36,10,15,16,18,0,152,21.714285714285715,3,0.0,0,36,10,15,57,16,0,18,0,61,91,1
255,5645,UCDPR1k7RkPBDIde3KiukiosB55WbRVo,A3fsA9Zfv1X2fVEQhTw51lKENdNrEqT3,10,8,4,0,3,0,4,0,19,2.7142857142857144,3,0.0,0,4,0,3,8,0,0,4,0,7,12,1
256,5669,HbDaABEakQmE8DQEoFoIphu2SH13rFRy,SpATywNh6bZuzm8s1ceuBUnMUAeoAHHw,28,48,30,16,13,4,5,0,116,16.571428571428573,3,0.0,12,30,15,13,36,4,1,5,0,70,46,0
257,5692,KtQYnyrETXqJCvCxj7ZUnFcjZBBdiT7G,SpATywNh6bZuzm8s1ceuBUnMUAeoAHHw,32,35,19,30,9,10,13,1,117,16.714285714285715,2,0.0,7,19,27,9,28,10,3,13,1,62,55,0
258,5726,tzyyAYK7Q2hNPhv988H6lH5D7hdM24rK,SpATywNh6bZuzm8s1ceuBUnMUAeoAHHw,28,24,11,24,6,4,7,0,76,10.857142857142858,3,0.0,9,11,24,6,15,4,0,7,0,50,26,0
259,5745,PpMDt0ql3KtH4YMuxusWOnbL4LfspwvV,A3fsA9Zfv1X2fVEQhTw51lKENdNrEqT3,40,40,27,68,11,28,12,0,186,26.571428571428573,7,0.0,2,27,57,11,38,28,11,12,0,97,89,1
260,5775,TO8Y79YghtROlTlvlXU7LRtpWyGNF6ec,SpATywNh6bZuzm8s1ceuBUnMUAeoAHHw,14,20,7,25,4,0,2,0,58,8.285714285714286,2,0.0,8,7,21,4,12,0,4,2,0,40,18,1
261,5778,A3AW3c7i1MF6oyHBEYvrXWvBxZwqeuYh,SpATywNh6bZuzm8s1ceuBUnMUAeoAHHw,13,10,2,15,1,21,13,2,64,9.142857142857142,3,0.0,2,2,12,1,8,21,3,13,2,17,47,0
262,5782,hjUSUM6roI2mLGkMAqBjE0uxFRBSMYHJ,A3fsA9Zfv1X2fVEQhTw51lKENdNrEqT3,71,55,42,134,20,2,14,0,267,38.142857142857146,5,0.0,2,42,112,20,53,2,22,14,0,176,91,1
263,5796,8tzllCaQFf5FO2XcYgqoYiMGBjUwujYx,SpATywNh6bZuzm8s1ceuBUnMUAeoAHHw,9,14,1,0,1,0,5,3,24,3.4285714285714284,1,0.0,2,1,0,1,12,0,0,5,3,4,20,1
264,5859,pGMnNtuqcZlCojrlW4Qh2PIHblJQmotx,SpATywNh6bZuzm8s1ceuBUnMUAeoAHHw,31,31,14,28,8,1,8,1,91,13.0,2,0.0,15,14,27,8,16,1,1,8,1,64,27,1
265,5889,Oe7zyPdqUKEu4xpqbiVxJiAwdUxxeOQv,A3fsA9Zfv1X2fVEQhTw51lKENdNrEqT3,8,12,7,0,3,0,12,0,34,4.857142857142857,2,0.0,0,7,0,3,12,0,0,12,0,10,24,1
266,5904,L4jaFu0vxNsfaC1OhafSk08ztmq6goZk,SpATywNh6bZuzm8s1ceuBUnMUAeoAHHw,19,39,15,0,8,0,15,0,77,11.0,4,0.0,0,15,0,8,39,0,0,15,0,23,54,0
267,5925,sc5S8mzwcw7LbcetViv5Dahuhyet4uF1,A3fsA9Zfv1X2fVEQhTw51lKENdNrEqT3,36,33,19,94,2,20,24,3,195,27.857142857142858,3,0.0,7,19,81,2,26,20,13,24,3,109,86,1
268,5928,QJQFN1rOmy0JEkg26kEuCjYYvoywuFFu,A3fsA9Zfv1X2fVEQhTw51lKENdNrEqT3,5,2,1,0,1,0,2,0,6,0.8571428571428571,2,0.0,0,1,0,1,2,0,0,2,0,2,4,1
269,6000,2mD1u3b1vLrSJM0DZTrsvLcZVBVwwd27,RXDvfPUBYFlVdlueBFbLW0mhhAyGEqpt,18,17,16,0,12,2,4,0,51,7.285714285714286,6,0.0,0,16,0,12,17,2,0,4,0,28,23,0
270,6010,gEPTO2jN7POX6QtJlMdktFPT74irRyFu,SpATywNh6bZuzm8s1ceuBUnMUAeoAHHw,23,36,14,28,9,18,7,0,112,16.0,8,0.0,10,14,26,9,26,18,2,7,0,59,53,0
271,6060,1gK3jCeXNxEbn9wGz2jRwqB6S5hBMDkt,bWdj2GDclj5ofokWjzoa5jAwMkxCykd6,19,42,17,82,12,27,10,1,191,27.285714285714285,1,0.0,8,17,78,12,34,27,4,10,1,115,76,1
272,6074,xQWsagZWr4hwuLscur4NAIFNIWIrJTay,RXDvfPUBYFlVdlueBFbLW0mhhAyGEqpt,12,9,9,0,4,0,8,0,30,4.285714285714286,1,0.0,0,9,0,4,9,0,0,8,0,13,17,0
273,6075,4pJCNd3c3ApEtuK2GDe7eGNzOhsu04W5,G8EPVSXsOYB5YQWZGiz1aVq5Pgr2GrQu,38,94,49,72,2,307,69,5,598,85.42857142857143,12,0.0,10,49,53,2,84,307,19,69,5,114,484,0
274,6102,DJPrQ8k1R0aSF2q32X8eWoHfRxJjw6WA,SpATywNh6bZuzm8s1ceuBUnMUAeoAHHw,30,45,22,41,9,16,19,8,160,22.857142857142858,2,0.0,14,22,35,9,31,16,6,19,8,80,80,1
275,6105,lVM3D8yPmd62Fdb29hI2YI0VPwlNvI4t,A3fsA9Zfv1X2fVEQhTw51lKENdNrEqT3,17,10,7,0,7,0,13,0,37,5.285714285714286,5,0.0,2,7,0,7,8,0,0,13,0,16,21,1
276,6108,WWWH5rGgnKzcRMEBKWqCKBbIYZVZp9Wi,SpATywNh6bZuzm8s1ceuBUnMUAeoAHHw,21,33,2,18,1,7,6,0,67,9.571428571428571,3,0.0,11,2,16,1,22,7,2,6,0,30,37,0
277,6114,PIxnueIZLpBbMAAHbhlsEVGPkWRYGpMI,RXDvfPUBYFlVdlueBFbLW0mhhAyGEqpt,14,17,1,0,0,1,11,0,30,4.285714285714286,2,0.0,0,1,0,0,17,1,0,11,0,1,29,0
278,6123,onsmNYIoPFEi185f5ZLsQXD70I3K25Cb,A3fsA9Zfv1X2fVEQhTw51lKENdNrEqT3,25,45,27,0,15,8,10,1,106,15.142857142857142,2,0.0,2,27,0,15,43,8,0,10,1,44,62,1
279,6134,UhLO5kko2VQ90AI2af3XOU7N46nRv9TM,SpATywNh6bZuzm8s1ceuBUnMUAeoAHHw,11,12,4,18,5,1,17,1,58,8.285714285714286,2,0.0,6,4,17,5,6,1,1,17,1,32,26,0
280,6140,IBg4xmPqhTfP3qhSQ0m2yOJeGxXoGyqu,RXDvfPUBYFlVdlueBFbLW0mhhAyGEqpt,48,50,29,123,16,240,82,12,552,78.85714285714286,8,0.0,17,29,116,16,33,240,7,82,12,178,374,0
281,6168,H2ZjrPimYfiWwdYkdNOPsZZk83kbIBCz,bWdj2GDclj5ofokWjzoa5jAwMkxCykd6,4,2,0,0,0,0,3,0,5,0.7142857142857143,1,0.0,0,0,0,0,2,0,0,3,0,0,5,1
282,6185,rowlJHASOW6yJNtP0z67l2i9CtJCMokD,SpATywNh6bZuzm8s1ceuBUnMUAeoAHHw,13,14,1,18,0,0,11,3,47,6.714285714285714,3,0.0,4,1,15,0,10,0,3,11,3,20,27,0
283,6192,uFKxt8ud4wgPXsnEMlnj4koWPrsJIWsU,SpATywNh6bZuzm8s1ceuBUnMUAeoAHHw,28,60,22,22,8,17,32,1,162,23.142857142857142,6,0.0,13,22,21,8,47,17,1,32,1,64,98,0
284,6220,hyKcsvbAZrS0MucDsyUSihT6aOgvgztm,A3fsA9Zfv1X2fVEQhTw51lKENdNrEqT3,8,9,4,0,4,0,1,0,18,2.5714285714285716,1,0.0,0,4,0,4,9,0,0,1,0,8,10,1
285,6240,IkJ5dxCbqNRxBRuENFqjes2Z4rIDUrXn,SpATywNh6bZuzm8s1ceuBUnMUAeoAHHw,31,45,16,43,9,13,7,0,133,19.0,2,0.0,22,16,35,9,23,13,8,7,0,82,51,0
286,6271,q2xQCstASp96wpspi8iqsuaqJ7gzfsux,A3fsA9Zfv1X2fVEQhTw51lKENdNrEqT3,47,37,12,86,0,0,3,0,138,19.714285714285715,3,0.0,7,12,77,0,30,0,9,3,0,96,42,0
287,6273,pP1hwdPGxzBA8F4ZSgJiv9MEvr2pc047,SpATywNh6bZuzm8s1ceuBUnMUAeoAHHw,14,52,3,9,0,51,43,2,160,22.857142857142858,4,0.0,15,3,9,0,37,51,0,43,2,27,133,1
288,6292,TmCsqieGLPEH7gIm9lIZtj95nwJ99JkM,A3fsA9Zfv1X2fVEQhTw51lKENdNrEqT3,7,3,2,0,2,0,3,0,10,1.4285714285714286,1,0.0,0,2,0,2,3,0,0,3,0,4,6,1
289,6303,jqoeUpESPoqODjA4STQaMBhAr7OND2EP,bWdj2GDclj5ofokWjzoa5jAwMkxCykd6,5,4,1,0,0,0,4,0,9,1.2857142857142858,1,0.0,0,1,0,0,4,0,0,4,0,1,8,1
290,6306,Q8L1mPYwfiwtGo48PB0N9B5ppVi0px10,SpATywNh6bZuzm8s1ceuBUnMUAeoAHHw,31,64,30,30,11,4,28,0,167,23.857142857142858,4,0.0,24,30,27,11,40,4,3,28,0,92,75,0
291,6317,3Bw18YJt9vJt2emNNJ6GnWW50YrVLdEa,bWdj2GDclj5ofokWjzoa5jAwMkxCykd6,7,3,1,0,0,0,7,0,11,1.5714285714285714,2,0.0,0,1,0,0,3,0,0,7,0,1,10,0
292,6331,SYptj19Xjkw9HEWtBs53CLIV7bhIU7QA,SpATywNh6bZuzm8s1ceuBUnMUAeoAHHw,30,63,33,19,10,31,18,0,174,24.857142857142858,3,0.0,6,33,18,10,57,31,1,18,0,67,107,1
293,6347,TAjGGV7oJgeUhPcj5Eum0tnVYrY7qjOE,RXDvfPUBYFlVdlueBFbLW0mhhAyGEqpt,22,30,15,52,5,2,13,0,117,16.714285714285715,5,0.0,7,15,43,5,23,2,9,13,0,70,47,0
294,6357,Aay6TeSPyFLmKNsg9Z4tXGnlIddPmJBP,SpATywNh6bZuzm8s1ceuBUnMUAeoAHHw,4,6,0,0,0,0,1,0,7,1.0,1,0.0,0,0,0,0,6,0,0,1,0,0,7,1
295,6368,Fa7tOqP1WKllvNDMgvUWmTzPr8J8vhy8,A3fsA9Zfv1X2fVEQhTw51lKENdNrEqT3,47,24,18,64,12,0,8,0,126,18.0,5,0.0,1,18,58,12,23,0,6,8,0,89,37,1
296,6382,9a1CkPBtfy1cinURU7wYCdYhBZbPuPSf,A3fsA9Zfv1X2fVEQhTw51lKENdNrEqT3,6,0,0,0,0,2,5,1,8,1.1428571428571428,1,0.0,0,0,0,0,0,2,0,5,1,0,8,1
297,6424,SmSrrYBj6KLZ39TqXb57CVWv6gX6sF7Q,SpATywNh6bZuzm8s1ceuBUnMUAeoAHHw,32,57,23,37,10,13,24,9,173,24.714285714285715,5,0.0,21,23,31,10,36,13,6,24,9,85,88,0
298,6435,nFeXukK9uLZggTwgBm3mDIxskaBXISqn,SpATywNh6bZuzm8s1ceuBUnMUAeoAHHw,20,42,10,34,0,0,3,0,89,12.714285714285714,10,0.0,7,10,29,0,35,0,5,3,0,46,43,1
299,6448,yau38b5UXLNmzsSxrtZsXYfKt6l52ZSP,A3fsA9Zfv1X2fVEQhTw51lKENdNrEqT3,11,24,2,0,1,0,3,0,30,4.285714285714286,3,0.0,1,2,0,1,23,0,0,3,0,4,26,0
300,6466,GUIjXzC11NU91af1UN0XPnms1Mnty0es,G8EPVSXsOYB5YQWZGiz1aVq5Pgr2GrQu,9,5,4,0,3,0,3,0,15,2.142857142857143,1,0.0,0,4,0,3,5,0,0,3,0,7,8,1
301,6472,wxlTuL6FVeoyKGq1xWxdRI4GRTsaG1Ha,A3fsA9Zfv1X2fVEQhTw51lKENdNrEqT3,5,4,3,0,0,0,1,0,8,1.1428571428571428,1,0.0,0,3,0,0,4,0,0,1,0,3,5,1
302,6488,aYhMdR5xaez3fr0lBrD6kCxYiCOyculR,RXDvfPUBYFlVdlueBFbLW0mhhAyGEqpt,35,109,68,10,8,2239,71,114,2619,374.14285714285717,13,0.0,12,68,5,8,97,2239,5,71,114,93,2526,0
303,6506,DCJPPLzeeZhBbsYhL4xGedJzVmW41Gnk,SpATywNh6bZuzm8s1ceuBUnMUAeoAHHw,29,40,25,31,11,13,7,0,127,18.142857142857142,3,0.0,11,25,28,11,29,13,3,7,0,75,52,0
304,6516,1CrVBOpFvr6rOy553Xrye0bjPdL11eu8,RXDvfPUBYFlVdlueBFbLW0mhhAyGEqpt,48,85,45,61,15,36,21,2,265,37.857142857142854,8,0.0,10,45,57,15,75,36,4,21,2,127,138,0
305,6517,7u3azzypzNqPYEFxf0DcbGOgDVhkOXos,A3fsA9Zfv1X2fVEQhTw51lKENdNrEqT3,58,17,12,130,8,1,22,1,191,27.285714285714285,4,0.0,2,12,120,8,15,1,10,22,1,142,49,0
306,6523,dna1EUjVeT7Ka4gaXCCa53DsP3COwQS1,SpATywNh6bZuzm8s1ceuBUnMUAeoAHHw,19,19,2,31,0,0,1,0,53,7.571428571428571,1,0.0,4,2,25,0,15,0,6,1,0,31,22,0
307,6528,97yjJniO9qlZAjgn3gm4HXnkbwnHzt9O,SpATywNh6bZuzm8s1ceuBUnMUAeoAHHw,16,44,3,21,3,10,8,0,89,12.714285714285714,2,0.0,13,3,15,3,31,10,6,8,0,34,55,1
308,6535,tuBxNlu8Vf06uK8sXGF2P17UeyGdHKNN,SpATywNh6bZuzm8s1ceuBUnMUAeoAHHw,25,33,26,6,11,0,6,0,82,11.714285714285714,3,0.0,0,26,5,11,33,0,1,6,0,42,40,1
309,6574,09vierxoREaD4msGgreYQSyOiGeSiZdQ,SpATywNh6bZuzm8s1ceuBUnMUAeoAHHw,9,20,12,0,7,0,3,0,42,6.0,2,0.0,0,12,0,7,20,0,0,3,0,19,23,0
310,6587,Y89GJdSZUpoYFMgx00SCe6qFoYoXIpUj,A3fsA9Zfv1X2fVEQhTw51lKENdNrEqT3,45,73,3,102,1,0,7,0,186,26.571428571428573,5,0.0,0,3,87,1,73,0,15,7,0,91,95,0
311,6620,ImttANzrjJymFPMjHDf4wrhhCWWSpYTI,A3fsA9Zfv1X2fVEQhTw51lKENdNrEqT3,7,11,0,0,0,0,4,0,15,2.142857142857143,1,0.0,0,0,0,0,11,0,0,4,0,0,15,1
312,6637,qcaVl4qf6hxavlIQkbkKC1Gm28s0psJd,SpATywNh6bZuzm8s1ceuBUnMUAeoAHHw,19,26,1,40,0,0,2,0,69,9.857142857142858,1,0.0,9,1,34,0,17,0,6,2,0,44,25,1
313,6643,lDflzmK9F6H42Kj6EtaBezWOcB4UUWiV,SpATywNh6bZuzm8s1ceuBUnMUAeoAHHw,21,31,17,6,9,4,16,1,84,12.0,6,0.0,6,17,6,9,25,4,0,16,1,38,46,0
314,6685,mfQ48K9Gnf187sLZBiTNegL6UkMDsKbJ,SpATywNh6bZuzm8s1ceuBUnMUAeoAHHw,11,12,1,0,0,0,7,1,21,3.0,1,0.0,3,1,0,0,9,0,0,7,1,4,17,0
315,6760,yh14zaFitCUTgvBPqRXiaZ6cUijtktL4,A3fsA9Zfv1X2fVEQhTw51lKENdNrEqT3,70,39,24,112,14,3,13,3,208,29.714285714285715,3,0.0,6,24,98,14,33,3,14,13,3,142,66,1
316,6813,UvqKXPrebnykj7gkohis9MIhsKJQCjxw,G8EPVSXsOYB5YQWZGiz1aVq5Pgr2GrQu,6,4,2,0,1,0,3,0,10,1.4285714285714286,2,0.0,0,2,0,1,4,0,0,3,0,3,7,0
317,6816,dSloiolTuQA1YnIVrIEZb5m23cL24cRw,A3fsA9Zfv1X2fVEQhTw51lKENdNrEqT3,28,48,5,34,3,5,16,1,112,16.0,4,0.0,5,5,29,3,43,5,5,16,1,42,70,1
318,6824,e12uQn96OlYfknMdqSXCXdImglIj4IRR,bWdj2GDclj5ofokWjzoa5jAwMkxCykd6,19,40,24,0,11,70,34,5,184,26.285714285714285,4,0.0,3,24,0,11,37,70,0,34,5,38,146,0
319,6835,05hxkbgK0IX5639oITtQjU5YEEUBb8L1,SpATywNh6bZuzm8s1ceuBUnMUAeoAHHw,17,54,2,17,2,0,8,1,84,12.0,2,0.0,16,2,14,2,38,0,3,8,1,34,50,0
320,6838,AyhJARh0xhxObM9zhvUdDxlTCtu309eW,SpATywNh6bZuzm8s1ceuBUnMUAeoAHHw,27,40,24,20,13,88,8,0,193,27.571428571428573,5,0.0,7,24,20,13,33,88,0,8,0,64,129,1
321,6873,NAuTAy6LFtpkSTeaDzpzRRxCaq6qJCQ5,A3fsA9Zfv1X2fVEQhTw51lKENdNrEqT3,52,65,48,73,28,0,36,0,250,35.714285714285715,6,0.0,5,48,65,28,60,0,8,36,0,146,104,0
322,6881,jzWvwaTexkgbyBrPkQbXDb98Viqx6cSS,G8EPVSXsOYB5YQWZGiz1aVq5Pgr2GrQu,19,18,5,30,4,11,10,1,79,11.285714285714286,4,0.0,11,5,23,4,7,11,7,10,1,43,36,1
323,6898,UxSaaQ6GZyl7nlDC1x0TA1qshXRkMyH8,RXDvfPUBYFlVdlueBFbLW0mhhAyGEqpt,47,75,23,89,18,16,11,0,232,33.142857142857146,1,0.0,27,23,85,18,48,16,4,11,0,153,79,0
324,6914,5XorWInOikFQGiy06qBvCZ6iOgBDDoJu,SpATywNh6bZuzm8s1ceuBUnMUAeoAHHw,27,72,32,17,16,43,18,3,201,28.714285714285715,3,0.0,30,32,16,16,42,43,1,18,3,94,107,0
325,6916,x6r7USCSuVFGzUeOMsU9rcLC4WDuI3GF,A3fsA9Zfv1X2fVEQhTw51lKENdNrEqT3,13,18,11,0,0,1,13,1,44,6.285714285714286,2,0.0,0,11,0,0,18,1,0,13,1,11,33,0
326,6931,s6iPd6MFpHWkQ354d5Z6XCZ6dbx7CutD,SpATywNh6bZuzm8s1ceuBUnMUAeoAHHw,12,6,5,4,3,0,3,0,21,3.0,2,0.0,0,5,3,3,6,0,1,3,0,11,10,0
327,6938,a6f3gPi6axX0cfBnUGVliBDQrPx92l1r,A3fsA9Zfv1X2fVEQhTw51lKENdNrEqT3,66,111,71,246,52,1,13,0,494,70.57142857142857,7,0.0,14,71,206,52,97,1,40,13,0,343,151,1
328,6948,4r712Cp6HawShlWfCnD4BeT5bNCQMkQ4,SpATywNh6bZuzm8s1ceuBUnMUAeoAHHw,22,26,2,24,0,7,6,1,66,9.428571428571429,3,0.0,7,2,19,0,19,7,5,6,1,28,38,0
329,6956,ykaUPJW4Nc9r2mv4b25QxgdHgIcQ63RQ,SpATywNh6bZuzm8s1ceuBUnMUAeoAHHw,25,32,10,27,4,23,6,1,103,14.714285714285714,5,0.0,15,10,26,4,17,23,1,6,1,55,48,0
330,6969,YfVqOdQV9ZXJgq8aC5ARPHksMFUwqOvU,SpATywNh6bZuzm8s1ceuBUnMUAeoAHHw,13,11,7,0,4,4,14,0,40,5.714285714285714,1,0.0,0,7,0,4,11,4,0,14,0,11,29,1
331,6981,Pp5JJMKWhHjqXDQq6vl852N5LskPEcDA,bWdj2GDclj5ofokWjzoa5jAwMkxCykd6,16,27,7,54,8,0,3,0,99,14.142857142857142,2,0.0,18,7,49,8,9,0,5,3,0,82,17,1
332,6983,7fC3V6ivG07wUIMOmiYFzSlyjWvbYnYf,A3fsA9Zfv1X2fVEQhTw51lKENdNrEqT3,58,47,2,206,2,2,17,0,276,39.42857142857143,7,0.0,5,2,170,2,42,2,36,17,0,179,97,0
333,6985,Pp5JJMKWhHjqXDQq6vl852N5LskPEcDA,A3fsA9Zfv1X2fVEQhTw51lKENdNrEqT3,5,4,1,0,1,0,4,0,10,1.4285714285714286,2,0.0,0,1,0,1,4,0,0,4,0,2,8,1
334,6989,QXMWMAYLhXvptULktpThtcXNRQ6JansN,SpATywNh6bZuzm8s1ceuBUnMUAeoAHHw,30,79,34,14,10,15,54,0,206,29.428571428571427,12,0.0,18,34,14,10,61,15,0,54,0,76,130,0
335,7004,4L8FEL9uQ33lr2hJ5CSJNyGu6GEq5daD,A3fsA9Zfv1X2fVEQhTw51lKENdNrEqT3,2,0,0,0,0,0,2,0,2,0.2857142857142857,1,0.0,0,0,0,0,0,0,0,2,0,0,2,1
336,7020,43QhXZfKBBZHpTmjLSVuTzbc6djzr40d,SpATywNh6bZuzm8s1ceuBUnMUAeoAHHw,25,58,1,26,3,11,17,0,116,16.571428571428573,3,0.0,16,1,24,3,42,11,2,17,0,44,72,0
337,7032,ogcVEHXlejDZ3EsIUfi0CHUmNlnDccd3,A3fsA9Zfv1X2fVEQhTw51lKENdNrEqT3,4,0,0,0,0,0,4,0,4,0.5714285714285714,1,0.0,0,0,0,0,0,0,0,4,0,0,4,1
338,7085,UrENN1zIfJIc4hCxDDWe8c7coKokiTdF,A3fsA9Zfv1X2fVEQhTw51lKENdNrEqT3,56,37,26,76,18,3,7,1,168,24.0,4,0.0,4,26,62,18,33,3,14,7,1,110,58,1
339,7107,oBmksukoqTKiKpWhco7hv7dHpVNhiTm0,SpATywNh6bZuzm8s1ceuBUnMUAeoAHHw,11,10,0,7,0,0,4,0,21,3.0,1,0.0,3,0,7,0,7,0,0,4,0,10,11,1
340,7119,03YAuQnjuYjTWwgHqE1110CZpZwknRbj,RXDvfPUBYFlVdlueBFbLW0mhhAyGEqpt,65,48,27,141,16,1,14,1,248,35.42857142857143,3,0.0,13,27,136,16,35,1,5,14,1,192,56,0
341,7138,tJ7FzaUMbzSP2K4BtZobNqzCoEbllcH1,RXDvfPUBYFlVdlueBFbLW0mhhAyGEqpt,41,138,74,86,3,752,207,919,2179,311.2857142857143,14,0.0,11,74,78,3,127,752,8,207,919,166,2013,0
342,7143,ahFkMpqRNclNalhsRFgKmc75UZfOTdgQ,SpATywNh6bZuzm8s1ceuBUnMUAeoAHHw,18,40,19,20,3,5,14,2,103,14.714285714285714,7,0.0,17,19,16,3,23,5,4,14,2,55,48,1
343,7151,2QwHrFxGcIFGuR6TyUnlExhchaRL2Ipx,SpATywNh6bZuzm8s1ceuBUnMUAeoAHHw,23,76,14,19,4,14,21,1,149,21.285714285714285,9,0.0,24,14,17,4,52,14,2,21,1,59,90,0
344,7182,HlYiU2TA92it9HWOPDlsBmlpdZ7J7QTJ,SpATywNh6bZuzm8s1ceuBUnMUAeoAHHw,23,36,13,16,4,0,11,0,80,11.428571428571429,4,0.0,8,13,16,4,28,0,0,11,0,41,39,1
345,7225,WixZusYrasZzR9owXlaQpXrbIZeJOheR,SpATywNh6bZuzm8s1ceuBUnMUAeoAHHw,12,10,5,0,3,3,6,1,28,4.0,2,0.0,3,5,0,3,7,3,0,6,1,11,17,0
346,7246,WixZusYrasZzR9owXlaQpXrbIZeJOheR,RXDvfPUBYFlVdlueBFbLW0mhhAyGEqpt,1,0,0,0,0,0,1,0,1,0.14285714285714285,1,0.0,0,0,0,0,0,0,0,1,0,0,1,1
347,7258,sT9hGAnww95aeGvqwQpJlS3ORhWDT49F,A3fsA9Zfv1X2fVEQhTw51lKENdNrEqT3,9,10,6,0,3,0,3,0,22,3.142857142857143,2,0.0,1,6,0,3,9,0,0,3,0,10,12,1
348,7282,gMP76SzwbIEJUCyidRWCdRJzafVqamrK,bWdj2GDclj5ofokWjzoa5jAwMkxCykd6,9,9,2,0,0,0,6,1,18,2.5714285714285716,1,0.0,0,2,0,0,9,0,0,6,1,2,16,1
349,7283,K5Sy6doI03r5uctdEcvObhW1bpzNGROt,G8EPVSXsOYB5YQWZGiz1aVq5Pgr2GrQu,26,55,30,22,9,7,30,1,154,22.0,4,0.0,1,30,16,9,54,7,6,30,1,56,98,0
350,7304,VSEOcWZYpZiKC2PUmidzj4VqbBnc3GAo,A3fsA9Zfv1X2fVEQhTw51lKENdNrEqT3,44,20,9,121,0,13,59,0,222,31.714285714285715,10,0.0,8,9,104,0,12,13,17,59,0,121,101,0
351,7332,5kqorcxIJejDFcc1de7q3uie94xFSgMJ,SpATywNh6bZuzm8s1ceuBUnMUAeoAHHw,29,92,47,19,7,3,19,0,187,26.714285714285715,7,0.0,21,47,18,7,71,3,1,19,0,93,94,0
352,7336,XaZ9suMr2OUkXLhyKSMfk6SMeajIT5ha,A3fsA9Zfv1X2fVEQhTw51lKENdNrEqT3,7,6,1,0,1,0,5,0,13,1.8571428571428572,1,0.0,0,1,0,1,6,0,0,5,0,2,11,1
353,7337,J5FkxM9o8L4y51xbaKwQjZuay8KpJMzH,SpATywNh6bZuzm8s1ceuBUnMUAeoAHHw,27,57,6,33,2,22,15,1,136,19.428571428571427,5,0.0,23,6,27,2,34,22,6,15,1,58,78,1
354,7338,XpquNqg2EIDRwNL88GzK6drchpRZMQN1,A3fsA9Zfv1X2fVEQhTw51lKENdNrEqT3,21,15,13,0,11,1,6,0,46,6.571428571428571,3,0.0,0,13,0,11,15,1,0,6,0,24,22,0
355,7345,B9KqNNxXBxHFUsJnQKQysblL3f8zF7sg,bWdj2GDclj5ofokWjzoa5jAwMkxCykd6,13,24,3,0,2,0,11,0,40,5.714285714285714,6,0.0,3,3,0,2,21,0,0,11,0,8,32,0
356,7348,5a7fehAo0Ol3kwHzhNqAYRGEzPLIE5FD,SpATywNh6bZuzm8s1ceuBUnMUAeoAHHw,20,31,21,11,12,2,13,0,90,12.857142857142858,5,0.0,2,21,10,12,29,2,1,13,0,45,45,1
357,7364,84Vq27rxsidbGJFxLO0cd5e2CSiXRChu,A3fsA9Zfv1X2fVEQhTw51lKENdNrEqT3,49,48,32,54,13,5,20,2,174,24.857142857142858,8,0.0,4,32,49,13,44,5,5,20,2,98,76,1
358,7380,y4ROZxtUW2SffaQ3DMgCK81r0GDNLnMO,SpATywNh6bZuzm8s1ceuBUnMUAeoAHHw,29,30,12,23,7,2,8,1,83,11.857142857142858,6,0.0,10,12,20,7,20,2,3,8,1,49,34,0
359,7387,u82lBhpDxJIwlZISEntCxj1zgVFdW0vT,SpATywNh6bZuzm8s1ceuBUnMUAeoAHHw,32,208,104,43,41,162,69,7,634,90.57142857142857,13,0.0,74,104,31,41,134,162,12,69,7,250,384,0
360,7402,XESEnxXOxYn0sEg8u7X5S27rymbaMzNA,SpATywNh6bZuzm8s1ceuBUnMUAeoAHHw,31,69,36,42,16,11,27,0,201,28.714285714285715,5,0.0,21,36,34,16,48,11,8,27,0,107,94,0
361,7405,thbVK5OkB13GLXnOCtBegvQeqDmjraYm,SpATywNh6bZuzm8s1ceuBUnMUAeoAHHw,27,43,18,27,7,14,11,0,120,17.142857142857142,3,0.0,20,18,26,7,23,14,1,11,0,71,49,0
362,7410,MRybyq1cnqatDusvwSwOpxgKfQSDJUE3,bWdj2GDclj5ofokWjzoa5jAwMkxCykd6,12,7,4,14,1,0,6,1,33,4.714285714285714,1,0.0,1,4,14,1,6,0,0,6,1,20,13,1
363,7425,AV3xIWfwsQ5uGH8Qf1BwlVsUBUI5kjl1,SpATywNh6bZuzm8s1ceuBUnMUAeoAHHw,10,26,7,0,3,0,10,0,46,6.571428571428571,4,0.0,0,7,0,3,26,0,0,10,0,10,36,1
364,7445,mawBMWVaMDuwBgxqJlSNvSnxuZmWfWRW,SpATywNh6bZuzm8s1ceuBUnMUAeoAHHw,25,67,23,18,6,4,26,0,144,20.571428571428573,8,0.0,8,23,17,6,59,4,1,26,0,54,90,0
365,7456,1CrVBOpFvr6rOy553Xrye0bjPdL11eu8,A3fsA9Zfv1X2fVEQhTw51lKENdNrEqT3,50,54,31,36,15,34,18,0,188,26.857142857142858,5,0.0,7,31,36,15,47,34,0,18,0,89,99,0
366,7459,RvbHqbSC41GB9aoXWEA7k8GnWBXN8w9e,SpATywNh6bZuzm8s1ceuBUnMUAeoAHHw,5,3,0,0,0,0,2,0,5,0.7142857142857143,1,0.0,0,0,0,0,3,0,0,2,0,0,5,1
367,7460,oTbhbArArMYa19mRFQxnzp4vm2INrkSU,SpATywNh6bZuzm8s1ceuBUnMUAeoAHHw,13,15,2,0,1,2,7,1,28,4.0,1,0.0,3,2,0,1,12,2,0,7,1,6,22,1
368,7470,zwtc7XYkGr4Bhsl8UEIZlPO0o9lpzfSZ,A3fsA9Zfv1X2fVEQhTw51lKENdNrEqT3,40,45,20,58,11,0,10,0,144,20.571428571428573,4,0.0,1,20,54,11,44,0,4,10,0,86,58,0
369,7477,5DIcniD9kRbDupVPBNugV5by0SZHtD2e,SpATywNh6bZuzm8s1ceuBUnMUAeoAHHw,26,54,6,34,3,2,16,2,117,16.714285714285715,5,0.0,14,6,29,3,40,2,5,16,2,52,65,0
370,7484,ZghgmsFKGlL396BKFJoJeIy2X7crdnN0,SpATywNh6bZuzm8s1ceuBUnMUAeoAHHw,27,62,21,44,6,42,27,4,206,29.428571428571427,4,0.0,31,21,37,6,31,42,7,27,4,95,111,0
371,7489,uUSTKM8g1hIskJbYHh1UiIQ6epHTSTNR,bWdj2GDclj5ofokWjzoa5jAwMkxCykd6,20,41,22,30,6,3,16,0,118,16.857142857142858,7,0.0,3,22,28,6,38,3,2,16,0,59,59,1
372,7490,uUSTKM8g1hIskJbYHh1UiIQ6epHTSTNR,G8EPVSXsOYB5YQWZGiz1aVq5Pgr2GrQu,83,94,34,182,17,3,14,1,345,49.285714285714285,3,0.0,53,34,127,17,41,3,55,14,1,231,114,0
373,7494,CSp8QkNZa6B12LzJipxPFgC5w6lKLtbn,RXDvfPUBYFlVdlueBFbLW0mhhAyGEqpt,29,67,7,45,9,10,17,1,156,22.285714285714285,3,0.0,14,7,43,9,53,10,2,17,1,73,83,0
374,7497,guprsx2yFQ5jOFQRa2OmDTvoe1Qtus0L,SpATywNh6bZuzm8s1ceuBUnMUAeoAHHw,10,18,9,0,5,0,4,0,36,5.142857142857143,2,0.0,0,9,0,5,18,0,0,4,0,14,22,1
375,7500,BQwuBUR4WYRdCAVoQUNUZK3Ln34YX0iv,SpATywNh6bZuzm8s1ceuBUnMUAeoAHHw,18,40,22,13,12,15,30,6,138,19.714285714285715,5,0.0,10,22,11,12,30,15,2,30,6,55,83,1
376,7505,1sFJ1Szdx1WU21TgC1PRv3tkQ09H4qed,SpATywNh6bZuzm8s1ceuBUnMUAeoAHHw,17,17,9,10,4,8,12,1,61,8.714285714285714,2,0.0,4,9,9,4,13,8,1,12,1,26,35,1
377,7524,UNtI3N6D9AZsFIjfiItWfMe73uBfp0VS,SpATywNh6bZuzm8s1ceuBUnMUAeoAHHw,14,18,8,17,5,0,9,0,57,8.142857142857142,4,0.0,9,8,16,5,9,0,1,9,0,38,19,0
378,7541,CGIwACA114zcxKI2ZiGPCkXleQcVHz2y,SpATywNh6bZuzm8s1ceuBUnMUAeoAHHw,25,50,8,28,3,21,22,2,134,19.142857142857142,7,0.0,19,8,25,3,31,21,3,22,2,55,79,0
379,7543,fGIeAB7IRJCHxzCo8u4GLaPKxQfHeCdi,SpATywNh6bZuzm8s1ceuBUnMUAeoAHHw,30,97,47,30,22,0,31,0,227,32.42857142857143,4,0.0,16,47,27,22,81,0,3,31,0,112,115,0
380,7551,dnay2jAX3cgskuo0IcUq4nB4ZOtSKU5x,SpATywNh6bZuzm8s1ceuBUnMUAeoAHHw,26,53,20,28,8,1,14,0,124,17.714285714285715,6,0.0,9,20,26,8,44,1,2,14,0,63,61,0
381,7554,eO5CgKdvPHZfZ8krv7wlSTYp2EdmZAmV,RXDvfPUBYFlVdlueBFbLW0mhhAyGEqpt,33,112,4,50,7,17,20,6,216,30.857142857142858,3,0.0,29,4,44,7,83,17,6,20,6,84,132,1
382,7586,40eiF3ZEuOYP1RP6XBUcW4OUQFmNxf9i,SpATywNh6bZuzm8s1ceuBUnMUAeoAHHw,31,38,19,27,7,9,18,3,121,17.285714285714285,3,0.0,8,19,24,7,30,9,3,18,3,58,63,0
383,7587,wEaTyOJwwvOCk7eUttQISK5WPXL7ANNV,SpATywNh6bZuzm8s1ceuBUnMUAeoAHHw,23,34,13,21,5,15,17,3,108,15.428571428571429,3,0.0,6,13,18,5,28,15,3,17,3,42,66,0
384,7616,PcrKUgtxZcGXBYkLOmECh99m3fhAOabf,SpATywNh6bZuzm8s1ceuBUnMUAeoAHHw,15,58,26,21,5,3,9,0,122,17.428571428571427,2,0.0,12,26,17,5,46,3,4,9,0,60,62,0
385,7623,uRIMG7KJWhHO81Kf9MvAfUFzZC6juL3s,bWdj2GDclj5ofokWjzoa5jAwMkxCykd6,14,22,12,50,6,9,6,0,105,15.0,6,0.0,4,12,48,6,18,9,2,6,0,70,35,0
386,7649,cauH4YekuRKFsHZgdw9jChinljVOhzCP,SpATywNh6bZuzm8s1ceuBUnMUAeoAHHw,21,18,10,19,8,0,3,0,58,8.285714285714286,3,0.0,4,10,16,8,14,0,3,3,0,38,20,1
387,7651,HL6JESJ9UfnK7mtp7EsklcgEKja4gTaC,RXDvfPUBYFlVdlueBFbLW0mhhAyGEqpt,56,79,3,82,11,12,8,0,195,27.857142857142858,3,0.0,34,3,80,11,45,12,2,8,0,128,67,1
388,7656,v9Jp2iBPSFTVxP8FrUe1odwfz8Hd1wS3,SpATywNh6bZuzm8s1ceuBUnMUAeoAHHw,28,33,17,12,8,35,14,0,119,17.0,4,0.0,10,17,12,8,23,35,0,14,0,47,72,0
389,7659,1KSlK2xXHUc3PjC1CsQEQaomGBagqDXf,A3fsA9Zfv1X2fVEQhTw51lKENdNrEqT3,16,10,7,0,6,0,2,0,25,3.5714285714285716,3,0.0,0,7,0,6,10,0,0,2,0,13,12,1
390,7660,ae4nSawB3M11Wmq3zKGmekxyJPcADmL9,bWdj2GDclj5ofokWjzoa5jAwMkxCykd6,1,0,0,0,0,0,1,0,1,0.14285714285714285,1,0.0,0,0,0,0,0,0,0,1,0,0,1,1
391,7667,ImCVHOP1jti1S73II8BRabWE6aqK4I6u,SpATywNh6bZuzm8s1ceuBUnMUAeoAHHw,1,0,0,0,0,0,1,0,1,0.14285714285714285,1,0.0,0,0,0,0,0,0,0,1,0,0,1,1
392,7670,NKzNFHK6LaJqjMec69ZX5HfBigF4yyJV,SpATywNh6bZuzm8s1ceuBUnMUAeoAHHw,28,27,15,14,9,12,16,1,94,13.428571428571429,2,0.0,10,15,14,9,17,12,0,16,1,48,46,0
393,7677,HPp2Yy992FcBIXDjeQl0bEftbV1QFRDS,SpATywNh6bZuzm8s1ceuBUnMUAeoAHHw,18,40,14,23,3,19,15,3,117,16.714285714285715,3,0.0,16,14,19,3,24,19,4,15,3,52,65,0
394,7681,3RcsrMTbPrb8ZHYXLlgwoRK7zrqTGSuq,bWdj2GDclj5ofokWjzoa5jAwMkxCykd6,6,3,2,0,2,0,1,0,8,1.1428571428571428,1,0.0,0,2,0,2,3,0,0,1,0,4,4,1
395,7683,uydIb4MWCn95KWcEhKwj3VRfjvxXo8Nj,A3fsA9Zfv1X2fVEQhTw51lKENdNrEqT3,61,164,91,136,2,793,156,4,1346,192.28571428571428,14,0.0,18,91,104,2,146,793,32,156,4,215,1131,0
396,7694,a6f3gPi6axX0cfBnUGVliBDQrPx92l1r,SpATywNh6bZuzm8s1ceuBUnMUAeoAHHw,25,45,32,36,17,0,8,0,138,19.714285714285715,5,0.0,5,32,28,17,40,0,8,8,0,82,56,0
397,7701,f81JJCqMlkJdA9lV7uQBviuGlLm2CDkR,SpATywNh6bZuzm8s1ceuBUnMUAeoAHHw,26,90,7,39,6,13,34,0,189,27.0,7,0.0,27,7,31,6,63,13,8,34,0,71,118,0
398,7720,LyBG9vpZvAGsIKFzeD4gB6XRCVzk12fF,A3fsA9Zfv1X2fVEQhTw51lKENdNrEqT3,13,7,6,10,4,0,5,0,32,4.571428571428571,1,0.0,0,6,9,4,7,0,1,5,0,19,13,1
399,7729,xkt3K6JWpnfeixDBdwkLXaHgXuuGt35v,A3fsA9Zfv1X2fVEQhTw51lKENdNrEqT3,42,27,19,78,9,2,13,0,148,21.142857142857142,4,0.0,1,19,70,9,26,2,8,13,0,99,49,1
400,7731,ZD844NRFhgHqwskHd8pIBuIwDiTAY4NC,SpATywNh6bZuzm8s1ceuBUnMUAeoAHHw,22,29,21,21,13,4,6,0,94,13.428571428571429,3,0.0,3,21,17,13,26,4,4,6,0,54,40,0
401,7766,3kfsZtV93tVXeg8YtF9PTasYswVdOeLx,SpATywNh6bZuzm8s1ceuBUnMUAeoAHHw,25,58,20,32,7,2,21,0,140,20.0,7,0.0,10,20,28,7,48,2,4,21,0,65,75,0
402,7767,GcInGCXKYnNWAnYbqUyxJe7hi4ZjhElg,RXDvfPUBYFlVdlueBFbLW0mhhAyGEqpt,27,27,15,8,14,0,5,0,69,9.857142857142858,3,0.0,5,15,8,14,22,0,0,5,0,42,27,1
403,7771,Rdvgrardg53H2oeCgmOt8vFxIUu5nogb,SpATywNh6bZuzm8s1ceuBUnMUAeoAHHw,28,44,26,28,13,1,10,0,122,17.428571428571427,5,0.0,7,26,22,13,37,1,6,10,0,68,54,0
404,7774,EQU3KQKmF0NpNwQmPmUw90ptahwADmIz,SpATywNh6bZuzm8s1ceuBUnMUAeoAHHw,19,48,4,0,1,13,25,2,93,13.285714285714286,4,0.0,15,4,0,1,33,13,0,25,2,20,73,1
405,7778,moK1GdnqoYxhSRCf5a95lgXdVNdzYrjs,A3fsA9Zfv1X2fVEQhTw51lKENdNrEqT3,64,71,14,90,8,16,56,0,255,36.42857142857143,8,0.0,2,14,84,8,69,16,6,56,0,108,147,0
406,7781,h1PVCD4diCwozuU4ZjcMLdFycUmYpSIc,G8EPVSXsOYB5YQWZGiz1aVq5Pgr2GrQu,33,30,13,58,5,1,15,1,123,17.571428571428573,4,0.0,10,13,42,5,20,1,16,15,1,70,53,0
407,7786,7aA6BrVZipLHOrozlrYBMEmfMq4MXahq,RXDvfPUBYFlVdlueBFbLW0mhhAyGEqpt,58,187,58,113,39,25,51,3,476,68.0,10,0.0,26,58,97,39,161,25,16,51,3,220,256,0
408,7789,pdotXwlXOl4cuEJn7TjzheQq2EZaH9qB,SpATywNh6bZuzm8s1ceuBUnMUAeoAHHw,6,5,0,0,0,0,2,0,7,1.0,2,0.0,0,0,0,0,5,0,0,2,0,0,7,1
409,7793,z2zhro5MCTuNkAWXNKBS5L7zEtJc0Vs9,SpATywNh6bZuzm8s1ceuBUnMUAeoAHHw,29,107,43,24,19,184,66,14,457,65.28571428571429,6,0.0,30,43,21,19,77,184,3,66,14,113,344,0
410,7820,tcrOs8a5NYKg0fcf0qJ4buK5RKIEFS5o,RXDvfPUBYFlVdlueBFbLW0mhhAyGEqpt,43,31,14,107,8,0,6,0,166,23.714285714285715,3,0.0,7,14,102,8,24,0,5,6,0,131,35,0
411,7831,SozLQk8695JG7fvj1Enp26s5ACJQjjq5,SpATywNh6bZuzm8s1ceuBUnMUAeoAHHw,30,33,22,20,10,25,17,2,129,18.428571428571427,3,0.0,4,22,19,10,29,25,1,17,2,55,74,0
412,7844,cSB2xmj1Zot5hgCLSHhxDNISJzHyYsXf,SpATywNh6bZuzm8s1ceuBUnMUAeoAHHw,13,21,3,0,1,0,12,0,37,5.285714285714286,3,0.0,0,3,0,1,21,0,0,12,0,4,33,1
413,7869,34oDxV5jJfVaGWSsgPNGJP2ott7rJu7I,SpATywNh6bZuzm8s1ceuBUnMUAeoAHHw,14,53,30,14,24,0,3,0,124,17.714285714285715,3,0.0,13,30,14,24,40,0,0,3,0,81,43,0
414,7872,ZosutOeXAHBSIvZIuIxhmKGfV7JZESP5,SpATywNh6bZuzm8s1ceuBUnMUAeoAHHw,23,29,17,1,15,1,66,1,130,18.571428571428573,4,0.0,5,17,1,15,24,1,0,66,1,38,92,0
415,7885,S58o7T8J2JcEBTi3bdMATXeMdhJbXqYq,SpATywNh6bZuzm8s1ceuBUnMUAeoAHHw,31,30,17,27,9,11,11,2,107,15.285714285714286,2,0.0,7,17,24,9,23,11,3,11,2,57,50,0
416,7900,pVR5qyfYJN582jaXWwJ4YRpKGyADx6Eu,RXDvfPUBYFlVdlueBFbLW0mhhAyGEqpt,29,18,15,0,11,0,4,0,48,6.857142857142857,1,0.0,2,15,0,11,16,0,0,4,0,28,20,1
417,7916,TIvBCmMDquWj2iwTixxUP6A3HzcrQyq3,SpATywNh6bZuzm8s1ceuBUnMUAeoAHHw,31,73,31,30,13,54,78,5,284,40.57142857142857,9,0.0,11,31,22,13,62,54,8,78,5,77,207,0
418,7932,Dm0fTQ5hQ4vZLMdCz8HpFheMP2yCMt3n,SpATywNh6bZuzm8s1ceuBUnMUAeoAHHw,6,6,4,0,3,0,4,1,18,2.5714285714285716,2,0.0,0,4,0,3,6,0,0,4,1,7,11,0
419,7953,KIPXc8MOqmnlmMqnIzIeaBqliIw9pS44,RXDvfPUBYFlVdlueBFbLW0mhhAyGEqpt,16,26,13,14,7,2,10,0,72,10.285714285714286,1,0.0,2,13,13,7,24,2,1,10,0,35,37,1
420,7971,Y7KMNxUWz3B2grUtFCf2FgfpqFMvSy0l,G8EPVSXsOYB5YQWZGiz1aVq5Pgr2GrQu,22,26,16,42,7,13,22,4,130,18.571428571428573,3,0.0,3,16,37,7,23,13,5,22,4,63,67,0
421,7982,9MK6uRaOnLFmxpxcsZHlBDf4ITU7Vvr6,SpATywNh6bZuzm8s1ceuBUnMUAeoAHHw,7,3,0,0,0,0,4,0,7,1.0,1,0.0,0,0,0,0,3,0,0,4,0,0,7,1
422,8012,jagu0OJDhWTGFhfCMk0ghqluLpW3kzdC,SpATywNh6bZuzm8s1ceuBUnMUAeoAHHw,30,26,16,26,8,2,14,4,96,13.714285714285714,3,0.0,6,16,21,8,20,2,5,14,4,51,45,0
423,8033,e2lOOqKSlF9Fw65H87m0cJslmAtz6Yej,SpATywNh6bZuzm8s1ceuBUnMUAeoAHHw,5,2,1,0,1,0,2,0,6,0.8571428571428571,1,0.0,0,1,0,1,2,0,0,2,0,2,4,1
424,8035,Q7WmsII1N0h11nYfhimDkafAIQtH8FBe,A3fsA9Zfv1X2fVEQhTw51lKENdNrEqT3,27,16,11,0,9,3,12,2,53,7.571428571428571,1,0.0,3,11,0,9,13,3,0,12,2,23,30,1
425,8040,IjI8O6qhXWrzvoHGjD0jKSLTrkjwywnZ,SpATywNh6bZuzm8s1ceuBUnMUAeoAHHw,12,22,0,21,0,31,9,0,83,11.857142857142858,3,0.0,16,0,18,0,6,31,3,9,0,34,49,0
426,8042,XDPvGyFLLEYwbNEQik2MM4yiADs5rrYJ,SpATywNh6bZuzm8s1ceuBUnMUAeoAHHw,14,16,8,0,3,15,4,0,46,6.571428571428571,3,0.0,4,8,0,3,12,15,0,4,0,15,31,1
427,8048,lPfsYctvOlk2KshSTR0YzF9fsG0sDcXm,SpATywNh6bZuzm8s1ceuBUnMUAeoAHHw,18,38,16,27,4,7,12,3,107,15.285714285714286,4,0.0,16,16,21,4,22,7,6,12,3,57,50,0
428,8054,3nOS3JEH08BgwunQqioyEFfja4qIND4p,SpATywNh6bZuzm8s1ceuBUnMUAeoAHHw,8,6,4,0,1,0,3,0,14,2.0,2,0.0,0,4,0,1,6,0,0,3,0,5,9,1
429,8060,aJPDWxjvWh7cfVWUTg8ZVK8q5wjeFEdQ,SpATywNh6bZuzm8s1ceuBUnMUAeoAHHw,11,12,2,8,1,1,7,1,32,4.571428571428571,2,0.0,1,2,7,1,11,1,1,7,1,11,21,1
430,8084,Rl9j2cgwioq6OBXKad44x4Um0fdVh2gk,SpATywNh6bZuzm8s1ceuBUnMUAeoAHHw,6,2,1,0,1,0,3,0,7,1.0,1,0.0,0,1,0,1,2,0,0,3,0,2,5,1
431,8090,cXITZ8Hjmr6myIyBLbDLY8s8nux0OPPJ,SpATywNh6bZuzm8s1ceuBUnMUAeoAHHw,6,9,2,0,0,0,7,0,18,2.5714285714285716,2,0.0,0,2,0,0,9,0,0,7,0,2,16,1
432,8091,Nt122dpzJdE1gwkHUV6Ncnzj3MDda3Gr,G8EPVSXsOYB5YQWZGiz1aVq5Pgr2GrQu,5,9,1,2,1,0,3,0,16,2.2857142857142856,1,0.0,3,1,1,1,6,0,1,3,0,6,10,1
433,8094,cZCWNPGtcdIiIlOnNkFDWI8KTo9TOlAC,SpATywNh6bZuzm8s1ceuBUnMUAeoAHHw,6,1,1,0,1,0,4,0,7,1.0,1,0.0,0,1,0,1,1,0,0,4,0,2,5,1
434,8108,D8ad6YCP4S8e1UHCQjU17HMPa0udSxjF,A3fsA9Zfv1X2fVEQhTw51lKENdNrEqT3,37,10,8,64,5,12,17,2,118,16.857142857142858,2,0.0,1,8,60,5,9,12,4,17,2,74,44,1
435,8112,X4PGvTm4F0x49zE1LPpj4etdmQj6eS9S,SpATywNh6bZuzm8s1ceuBUnMUAeoAHHw,9,14,8,0,5,0,3,0,30,4.285714285714286,1,0.0,0,8,0,5,14,0,0,3,0,13,17,0
436,8123,q6JeU48PcDOdiZ368tb3IoCh3BVgnxVp,bWdj2GDclj5ofokWjzoa5jAwMkxCykd6,17,43,17,16,16,14,7,0,113,16.142857142857142,3,0.0,10,17,14,16,33,14,2,7,0,57,56,1
437,8145,ZDVmuYiPoGm0gu1bR2BaE1soF6dU5v1W,A3fsA9Zfv1X2fVEQhTw51lKENdNrEqT3,6,13,9,0,0,0,2,0,24,3.4285714285714284,1,0.0,0,9,0,0,13,0,0,2,0,9,15,1
438,8148,nx1z63DgmeEAxW8gQgEbpcNs34kbRne4,A3fsA9Zfv1X2fVEQhTw51lKENdNrEqT3,4,1,1,0,0,0,3,0,5,0.7142857142857143,1,0.0,0,1,0,0,1,0,0,3,0,1,4,1
439,8166,eOxm8XEI11Xs6eiBi1Nu5QzIagZXwEm9,SpATywNh6bZuzm8s1ceuBUnMUAeoAHHw,22,34,22,19,5,106,16,0,202,28.857142857142858,8,0.0,3,22,17,5,31,106,2,16,0,47,155,0
440,8168,jtxvuHBV8ZOgNnNCL1A1WerzR2TVfFNy,A3fsA9Zfv1X2fVEQhTw51lKENdNrEqT3,42,24,17,62,12,0,4,0,119,17.0,3,0.0,3,17,52,12,21,0,10,4,0,84,35,1
441,8185,WgYQBUzSJJLcj6PwA0d8MdNri6k7nN4s,RXDvfPUBYFlVdlueBFbLW0mhhAyGEqpt,5,2,1,0,1,0,4,0,8,1.1428571428571428,2,0.0,0,1,0,1,2,0,0,4,0,2,6,1
442,8188,XpMzbdWNf7VknZxctjGvDzxNpyCLWCaP,SpATywNh6bZuzm8s1ceuBUnMUAeoAHHw,22,35,14,16,8,1,14,2,90,12.857142857142858,4,0.0,13,14,15,8,22,1,1,14,2,50,40,1
443,8210,YxqHC7YRxEYSyD66BTdrU6f4qZw3IxAu,SpATywNh6bZuzm8s1ceuBUnMUAeoAHHw,7,1,1,0,1,0,4,0,7,1.0,1,0.0,0,1,0,1,1,0,0,4,0,2,5,1
444,8243,VAe2acDlYib7o05H0M3tg4gQoc5gLI96,SpATywNh6bZuzm8s1ceuBUnMUAeoAHHw,28,28,15,17,6,0,7,1,74,10.571428571428571,4,0.0,9,15,17,6,19,0,0,7,1,47,27,1
445,8254,rD3x5Ovuza1MLiqkvaHksaL42hepSLSa,bWdj2GDclj5ofokWjzoa5jAwMkxCykd6,12,29,13,8,4,1,15,0,70,10.0,6,0.0,1,13,8,4,28,1,0,15,0,26,44,1
446,8257,ANOp8mWNHTZUswLhYddMTdBChUriYZaX,RXDvfPUBYFlVdlueBFbLW0mhhAyGEqpt,58,338,7,190,12,151,59,3,760,108.57142857142857,9,0.0,84,7,174,12,254,151,16,59,3,277,483,0
447,8284,X9u2Hncxz9A6DpGBhCZ5wulJhsMdyVac,RXDvfPUBYFlVdlueBFbLW0mhhAyGEqpt,13,11,9,0,4,0,6,0,30,4.285714285714286,3,0.0,0,9,0,4,11,0,0,6,0,13,17,1
448,8291,ljmWZCzWPqv1RXsn1q2wpsQtrnA1zct2,bWdj2GDclj5ofokWjzoa5jAwMkxCykd6,16,31,1,194,2,46,21,1,296,42.285714285714285,4,0.0,9,1,186,2,22,46,8,21,1,198,98,1
449,8301,KdYI01F9Xc7qTt82weazWGHtHsUvxDB7,SpATywNh6bZuzm8s1ceuBUnMUAeoAHHw,24,42,6,15,5,19,12,1,100,14.285714285714286,6,0.0,13,6,12,5,29,19,3,12,1,36,64,1
450,8305,kpS5tMAHQr9yJyfVB9Mkc4TlfmouYjNE,SpATywNh6bZuzm8s1ceuBUnMUAeoAHHw,21,89,32,0,14,3,30,4,172,24.571428571428573,8,0.0,0,32,0,14,89,3,0,30,4,46,126,0
451,8312,cYibpCaMUGq0WjgUWfTv0iIvJ7QbFj5E,SpATywNh6bZuzm8s1ceuBUnMUAeoAHHw,29,31,14,32,8,37,39,0,161,23.0,8,0.0,12,14,28,8,19,37,4,39,0,62,99,0
452,8345,qDcPjYl3DZy0WT2lmJT9GmZYgAdLwjE1,SpATywNh6bZuzm8s1ceuBUnMUAeoAHHw,5,6,1,0,0,0,2,0,9,1.2857142857142858,1,0.0,3,1,0,0,3,0,0,2,0,4,5,1
453,8348,f6fUoSUJslaShApLLQ3C3hAE39t0Ewco,SpATywNh6bZuzm8s1ceuBUnMUAeoAHHw,28,52,15,18,7,31,11,2,136,19.428571428571427,2,0.0,23,15,17,7,29,31,1,11,2,62,74,1
454,8375,U7C8tpNUwsrK1uIrWw0ieIQJYwOo61Uc,SpATywNh6bZuzm8s1ceuBUnMUAeoAHHw,19,23,15,8,7,0,2,0,55,7.857142857142857,2,0.0,2,15,6,7,21,0,2,2,0,30,25,1
455,8378,ZipuPEeCqze6LFrYfkIZBU7ronXF3JAb,SpATywNh6bZuzm8s1ceuBUnMUAeoAHHw,30,38,21,23,10,0,9,1,102,14.571428571428571,3,0.0,12,21,22,10,26,0,1,9,1,65,37,0
456,8381,XDUz0oVcNwke0CqAlFlmwOWSA32SgeFl,SpATywNh6bZuzm8s1ceuBUnMUAeoAHHw,18,41,2,4,1,0,14,0,62,8.857142857142858,9,0.0,3,2,4,1,38,0,0,14,0,10,52,0
457,8397,a9P7gN6Av72Gjg1AVS7Rv4BiyiW2xpDS,bWdj2GDclj5ofokWjzoa5jAwMkxCykd6,3,0,0,0,0,1,3,0,4,0.5714285714285714,1,0.0,0,0,0,0,0,1,0,3,0,0,4,1
458,8408,NYt3HW4iIDKFfkoDHUmE2GfhEi6C8Rqu,bWdj2GDclj5ofokWjzoa5jAwMkxCykd6,8,11,6,0,0,6,18,1,42,6.0,5,0.0,0,6,0,0,11,6,0,18,1,6,36,1
459,8410,kWUbu8oK1dFJKpHhiF15MwcSzNzv8GaS,A3fsA9Zfv1X2fVEQhTw51lKENdNrEqT3,4,2,1,0,1,0,1,0,5,0.7142857142857143,1,0.0,0,1,0,1,2,0,0,1,0,2,3,1
460,8424,ukCIrv5h45nbdIEPPmMlvipT87B8fFE7,RXDvfPUBYFlVdlueBFbLW0mhhAyGEqpt,41,70,54,2,34,19,18,5,202,28.857142857142858,5,0.0,0,54,2,34,70,19,0,18,5,90,112,0
461,8427,sOkc0wEXSSLpxtxlqjZObJqg94IyLpuY,SpATywNh6bZuzm8s1ceuBUnMUAeoAHHw,24,81,2,21,0,34,37,0,175,25.0,11,0.0,26,2,17,0,55,34,4,37,0,45,130,0
462,8443,ITkxDxE80MnM3R1P6Tny4qeXU1QIqBHa,A3fsA9Zfv1X2fVEQhTw51lKENdNrEqT3,35,25,15,74,3,34,18,1,170,24.285714285714285,4,0.0,2,15,59,3,23,34,15,18,1,79,91,1
463,8449,TTJoWZMu9qE69gK338lM1DPPuzOJjTS2,SpATywNh6bZuzm8s1ceuBUnMUAeoAHHw,18,31,2,20,2,5,8,1,69,9.857142857142858,3,0.0,5,2,17,2,26,5,3,8,1,26,43,1
464,8457,jcXoYFaI9QPcliotiwIgOLeObkrSUvNn,SpATywNh6bZuzm8s1ceuBUnMUAeoAHHw,16,24,1,14,0,3,3,0,45,6.428571428571429,3,0.0,5,1,13,0,19,3,1,3,0,19,26,0
465,8471,qLCBP0aNIaDp6cyqIvUit2p06Y7zVnQy,G8EPVSXsOYB5YQWZGiz1aVq5Pgr2GrQu,7,6,1,0,1,0,2,0,10,1.4285714285714286,1,0.0,1,1,0,1,5,0,0,2,0,3,7,1
466,8478,UY6XF5Ob1mgKcqmlUI5FgYfIUUIUAwxR,SpATywNh6bZuzm8s1ceuBUnMUAeoAHHw,30,91,29,34,13,5,31,3,206,29.428571428571427,7,0.0,28,29,28,13,63,5,6,31,3,98,108,0
467,8504,2cKDRLsZWRQVPO7xdF2dpJ6vw1EsD7pk,bWdj2GDclj5ofokWjzoa5jAwMkxCykd6,14,35,8,102,3,0,4,0,152,21.714285714285715,5,0.0,3,8,96,3,32,0,6,4,0,110,42,1
468,8505,DpXkrIHIAIPNESKyvFah0WhpVT5PHFeL,SpATywNh6bZuzm8s1ceuBUnMUAeoAHHw,14,21,10,11,0,20,9,2,73,10.428571428571429,4,0.0,6,10,10,0,15,20,1,9,2,26,47,0
469,8510,2cKDRLsZWRQVPO7xdF2dpJ6vw1EsD7pk,A3fsA9Zfv1X2fVEQhTw51lKENdNrEqT3,66,76,28,218,13,0,4,0,339,48.42857142857143,4,0.0,10,28,182,13,66,0,36,4,0,233,106,1
470,8516,WFBeS5f6wWn1eFBxyujnTFuvM6fqEpDk,A3fsA9Zfv1X2fVEQhTw51lKENdNrEqT3,7,3,2,0,2,0,2,0,9,1.2857142857142858,1,0.0,0,2,0,2,3,0,0,2,0,4,5,1
471,8517,4tj4DQ4XnBvn4uM9Mw2kTJbN1KPDkno4,SpATywNh6bZuzm8s1ceuBUnMUAeoAHHw,28,71,29,34,8,24,27,8,201,28.714285714285715,6,0.0,22,29,33,8,49,24,1,27,8,92,109,0
472,8522,aLRP3ahB5SIcOn5vpM1VPEh9ib2QIioX,bWdj2GDclj5ofokWjzoa5jAwMkxCykd6,5,10,0,0,0,19,5,0,34,4.857142857142857,3,0.0,0,0,0,0,10,19,0,5,0,0,34,1
473,8523,0Vj24SN7QK68fxZGEj9b6pGHh8nTXfGG,A3fsA9Zfv1X2fVEQhTw51lKENdNrEqT3,29,16,10,56,1,0,8,0,91,13.0,6,0.0,1,10,52,1,15,0,4,8,0,64,27,0
474,8526,HBfe50okXo4yGURKfz5xhaX3ToIkoF7Q,bWdj2GDclj5ofokWjzoa5jAwMkxCykd6,38,95,44,88,13,58,23,1,322,46.0,8,0.0,9,44,81,13,86,58,7,23,1,147,175,1
475,8529,lnzFfoDYtlWPJMTPbihufULiQk1Jv9SB,SpATywNh6bZuzm8s1ceuBUnMUAeoAHHw,6,2,1,0,1,0,3,0,7,1.0,1,0.0,0,1,0,1,2,0,0,3,0,2,5,1
476,8540,83bogZlv4TVHMx4MUYOU3yEQWNYHnGAe,G8EPVSXsOYB5YQWZGiz1aVq5Pgr2GrQu,3,17,4,0,0,0,1,0,22,3.142857142857143,5,0.0,1,4,0,0,16,0,0,1,0,5,17,1
477,8553,aGkT5uzDJUsKsLNIW3C8wBL1bUhJSBfn,SpATywNh6bZuzm8s1ceuBUnMUAeoAHHw,22,39,3,36,2,0,3,0,83,11.857142857142858,7,0.0,10,3,30,2,29,0,6,3,0,45,38,0
478,8570,ApFdQQBcLqTLoA4wIvtlnnwFs4FrlVS1,RXDvfPUBYFlVdlueBFbLW0mhhAyGEqpt,27,28,17,22,0,1,17,1,86,12.285714285714286,6,0.0,7,17,22,0,21,1,0,17,1,46,40,0
479,8574,7jkKKf5Pb7FrtJ3WnuF11G7ePioUPJm3,A3fsA9Zfv1X2fVEQhTw51lKENdNrEqT3,46,26,20,68,13,6,7,0,140,20.0,2,0.0,1,20,58,13,25,6,10,7,0,92,48,1
480,8582,x0VzAeYdlywtGLqE1HF68qQMYZTLfsw9,SpATywNh6bZuzm8s1ceuBUnMUAeoAHHw,19,44,22,6,9,1,14,1,97,13.857142857142858,5,0.0,11,22,6,9,33,1,0,14,1,48,49,0
481,8585,28jQkMYgDOh7TIBKdGn62G1sm2slN0BP,A3fsA9Zfv1X2fVEQhTw51lKENdNrEqT3,48,33,22,109,13,0,7,0,184,26.285714285714285,4,0.0,0,22,95,13,33,0,14,7,0,130,54,0
482,8586,Xci1viGBABzXjikcwwlwGEGBfmePUlzw,SpATywNh6bZuzm8s1ceuBUnMUAeoAHHw,24,128,52,13,5,35,34,4,271,38.714285714285715,6,0.0,56,52,13,5,72,35,0,34,4,126,145,1
483,8616,GexMn1szbSD50sX3ghgNlwAzziO50D2R,SpATywNh6bZuzm8s1ceuBUnMUAeoAHHw,29,66,19,23,9,34,20,2,173,24.714285714285715,3,0.0,17,19,22,9,49,34,1,20,2,67,106,0
484,8619,7yfm92CNSrFqBw5yp2Efl7B2jNSXGlux,SpATywNh6bZuzm8s1ceuBUnMUAeoAHHw,1,0,0,0,0,0,1,0,1,0.14285714285714285,1,0.0,0,0,0,0,0,0,0,1,0,0,1,1
485,8620,x0VzAeYdlywtGLqE1HF68qQMYZTLfsw9,bWdj2GDclj5ofokWjzoa5jAwMkxCykd6,8,7,5,0,3,0,2,0,17,2.4285714285714284,1,0.0,0,5,0,3,7,0,0,2,0,8,9,1
486,8628,nQgK4glIoTighvWZSrb5cpZqSgT49IUz,SpATywNh6bZuzm8s1ceuBUnMUAeoAHHw,25,33,16,12,9,2,10,0,82,11.714285714285714,5,0.0,11,16,12,9,22,2,0,10,0,48,34,0
487,8636,2tNnsKlcvz4IV4xQh5sF75J9zNq5DtzC,SpATywNh6bZuzm8s1ceuBUnMUAeoAHHw,22,44,8,32,3,21,4,0,112,16.0,2,0.0,26,8,28,3,18,21,4,4,0,65,47,1
488,8640,g2XbJogybHS3UQDYBcO0HoCO8HfG7ABm,A3fsA9Zfv1X2fVEQhTw51lKENdNrEqT3,41,56,1,38,0,5,19,3,122,17.428571428571427,4,0.0,3,1,38,0,53,5,0,19,3,42,80,1
489,8641,3dlrFJzmVyUebS1oyKqPiquAJj3CweSU,SpATywNh6bZuzm8s1ceuBUnMUAeoAHHw,29,60,15,29,5,2,20,2,133,19.0,4,0.0,16,15,23,5,44,2,6,20,2,59,74,1
490,8649,uQjl8NGtIQkRfoe9edBiMgtYYmdkzVXR,bWdj2GDclj5ofokWjzoa5jAwMkxCykd6,19,46,27,34,5,8,32,3,155,22.142857142857142,9,0.0,3,27,30,5,43,8,4,32,3,65,90,0
491,8652,15n53eqSRMLQKZaiigI2Vgclm7aKceka,A3fsA9Zfv1X2fVEQhTw51lKENdNrEqT3,19,21,3,0,2,1,13,2,42,6.0,3,0.0,0,3,0,2,21,1,0,13,2,5,37,0
492,8660,CxUPOQRaQMGLmbOcfniIQOhh24PXLDR6,A3fsA9Zfv1X2fVEQhTw51lKENdNrEqT3,53,81,40,79,14,8,29,3,254,36.285714285714285,9,0.0,6,40,63,14,75,8,16,29,3,123,131,0
493,8677,k6Ev3pOofJatsjXYv6yHRgeWPlAQcaXL,SpATywNh6bZuzm8s1ceuBUnMUAeoAHHw,28,24,15,20,6,1,9,1,76,10.857142857142858,2,0.0,4,15,19,6,20,1,1,9,1,44,32,1
494,8683,xlLP2MUG9CBaax1U0Ai47Er5upBZhMpV,SpATywNh6bZuzm8s1ceuBUnMUAeoAHHw,17,45,21,11,8,1,9,0,95,13.571428571428571,5,0.0,15,21,10,8,30,1,1,9,0,54,41,1
495,8690,NuBf7vtWvcfQjgrelnmNuJu6a5WC9FFT,SpATywNh6bZuzm8s1ceuBUnMUAeoAHHw,29,85,25,66,9,26,47,3,261,37.285714285714285,6,0.0,20,25,59,9,65,26,7,47,3,113,148,0
496,8734,fxq584v5hQmVOHgm4uohGT9XrYo1FGMS,SpATywNh6bZuzm8s1ceuBUnMUAeoAHHw,30,111,36,47,11,5,26,1,237,33.857142857142854,6,0.0,17,36,38,11,94,5,9,26,1,102,135,0
497,8741,XWElpBT4PKnC5pi96PLjtYP5u9l1rrKm,SpATywNh6bZuzm8s1ceuBUnMUAeoAHHw,27,93,27,18,7,6,41,2,194,27.714285714285715,7,0.0,17,27,17,7,76,6,1,41,2,68,126,0
498,8748,IZ5pWpBLzW50MjCCGxCjTz4w6DVz2MU3,A3fsA9Zfv1X2fVEQhTw51lKENdNrEqT3,4,2,1,0,1,0,2,0,6,0.8571428571428571,1,0.0,0,1,0,1,2,0,0,2,0,2,4,0
499,8752,tsTDNHtkzUQqr6Le5CiKzEb1J3ub8XpE,G8EPVSXsOYB5YQWZGiz1aVq5Pgr2GrQu,33,41,6,46,6,0,4,0,103,14.714285714285714,6,0.0,12,6,34,6,29,0,12,4,0,58,45,0
500,8756,cPzUMr5q8dc3UpQvyyBObvWhUfY89oua,SpATywNh6bZuzm8s1ceuBUnMUAeoAHHw,28,23,15,30,9,0,4,0,81,11.571428571428571,1,0.0,5,15,25,9,18,0,5,4,0,54,27,1
501,8766,V8icfAYA9I8myBnRTjbheMwStuoZOBk5,SpATywNh6bZuzm8s1ceuBUnMUAeoAHHw,27,98,35,35,10,20,41,6,245,35.0,7,0.0,29,35,30,10,69,20,5,41,6,104,141,1
502,8768,Za0SfT4qDZpXUZtWaYX1DLLmm9w6G9yO,RXDvfPUBYFlVdlueBFbLW0mhhAyGEqpt,7,7,5,0,2,0,1,0,15,2.142857142857143,1,0.0,0,5,0,2,7,0,0,1,0,7,8,1
503,8772,NLUFE7ndaVQ8A2tkIa8xBpPqWZbahAYT,SpATywNh6bZuzm8s1ceuBUnMUAeoAHHw,30,43,20,53,10,12,23,1,162,23.142857142857142,4,0.0,13,20,42,10,30,12,11,23,1,85,77,0
504,8778,hkmT0j8GDy3ymXnKaIcUDPdFkebvKRou,SpATywNh6bZuzm8s1ceuBUnMUAeoAHHw,30,68,32,45,15,14,26,2,202,28.857142857142858,6,0.0,20,32,37,15,48,14,8,26,2,104,98,0
505,8783,V9A9B2T9pRTU3AqvpqzuKs4MfRcAEte2,RXDvfPUBYFlVdlueBFbLW0mhhAyGEqpt,32,40,25,12,10,0,22,1,110,15.714285714285714,5,0.0,4,25,10,10,36,0,2,22,1,49,61,1
506,8790,hShFZH2IARrzxZjv2Hbws9rmf9bt3f58,SpATywNh6bZuzm8s1ceuBUnMUAeoAHHw,21,34,11,18,7,0,6,0,76,10.857142857142858,3,0.0,16,11,16,7,18,0,2,6,0,50,26,0
507,8820,sqKEuRhvHf94SnQ2C0IdhOfhaSrrM6tg,SpATywNh6bZuzm8s1ceuBUnMUAeoAHHw,19,96,4,25,4,19,31,2,181,25.857142857142858,8,0.0,29,4,21,4,67,19,4,31,2,58,123,0
508,8830,LfzKT52vEtoxbNqX2vKaJI7cIpPCsgUd,SpATywNh6bZuzm8s1ceuBUnMUAeoAHHw,7,3,2,0,2,0,4,0,11,1.5714285714285714,1,0.0,0,2,0,2,3,0,0,4,0,4,7,1
509,8831,SoFzOO60yRk0ggHCvfEgIFgyAhcbDPEU,SpATywNh6bZuzm8s1ceuBUnMUAeoAHHw,5,2,1,0,1,0,2,0,6,0.8571428571428571,1,0.0,0,1,0,1,2,0,0,2,0,2,4,1
510,8833,BX9KMh9DUbDRkGw8SYAs3wHv0hHJ990Z,SpATywNh6bZuzm8s1ceuBUnMUAeoAHHw,26,42,26,30,14,0,9,0,121,17.285714285714285,6,0.0,6,26,25,14,36,0,5,9,0,71,50,0
511,8862,5QXD7nGlfa5LD2DcNq8Av61TrcRi85rU,G8EPVSXsOYB5YQWZGiz1aVq5Pgr2GrQu,15,15,1,39,3,0,2,0,60,8.571428571428571,1,0.0,8,1,32,3,7,0,7,2,0,44,16,0
512,8863,4vEHDSGKXu9Cie3on99cieDjI4lud9xW,SpATywNh6bZuzm8s1ceuBUnMUAeoAHHw,12,26,1,14,0,0,2,0,43,6.142857142857143,1,0.0,13,1,13,0,13,0,1,2,0,27,16,1
513,8874,XrkmN79zYVHhoXA87bb44oUhAS8HKFji,SpATywNh6bZuzm8s1ceuBUnMUAeoAHHw,16,35,20,0,3,6,12,1,77,11.0,1,0.0,2,20,0,3,33,6,0,12,1,25,52,1
514,8880,mVMuUEeLKa3SdL5JnStqlN0fzPnKsCAA,SpATywNh6bZuzm8s1ceuBUnMUAeoAHHw,1,0,0,0,0,0,1,0,1,0.14285714285714285,1,0.0,0,0,0,0,0,0,0,1,0,0,1,1
515,8882,NAmyRYUXoAoJaF1WmEUzfZdW5j2jsFh1,SpATywNh6bZuzm8s1ceuBUnMUAeoAHHw,13,11,7,14,3,0,9,0,44,6.285714285714286,2,0.0,2,7,12,3,9,0,2,9,0,24,20,0
516,8894,8IuzZOXaXVUql9pLZtNuJIyLoDJ8ZL4V,bWdj2GDclj5ofokWjzoa5jAwMkxCykd6,7,8,2,0,0,0,10,0,20,2.857142857142857,3,0.0,0,2,0,0,8,0,0,10,0,2,18,1
517,8903,cvlNPzqQj2LOz3Z7WcczCYX7AEEZY5z2,RXDvfPUBYFlVdlueBFbLW0mhhAyGEqpt,7,5,2,0,1,2,6,0,16,2.2857142857142856,1,0.0,0,2,0,1,5,2,0,6,0,3,13,1
518,8908,9lksmcPg7FQE2FGQIA9VvWum1Z9DYrHM,SpATywNh6bZuzm8s1ceuBUnMUAeoAHHw,13,21,12,0,4,3,10,0,50,7.142857142857143,2,0.0,5,12,0,4,16,3,0,10,0,21,29,1
519,8915,RlIzEuK7g6sugNWIIhijiyryQft8qZof,SpATywNh6bZuzm8s1ceuBUnMUAeoAHHw,20,21,13,10,6,4,7,0,61,8.714285714285714,3,0.0,4,13,9,6,17,4,1,7,0,32,29,1
520,8939,awz7o49PrUBSNrYng5ZPMFSJBn6RXWK1,G8EPVSXsOYB5YQWZGiz1aVq5Pgr2GrQu,77,140,80,108,47,2,24,0,401,57.285714285714285,10,0.0,13,80,89,47,127,2,19,24,0,229,172,0
521,8943,dQggCBdg5KVSltApPCgVZB7TTUQzzzoI,RXDvfPUBYFlVdlueBFbLW0mhhAyGEqpt,51,49,28,101,11,22,8,0,219,31.285714285714285,5,0.0,10,28,86,11,39,22,15,8,0,135,84,1
522,8954,N7x6rez9AavUVus2y33zQwbgvW9e4FwN,bWdj2GDclj5ofokWjzoa5jAwMkxCykd6,4,2,1,0,1,0,1,0,5,0.7142857142857143,1,0.0,0,1,0,1,2,0,0,1,0,2,3,1
523,8972,3NITGQuylcrTi63aoWqnzXuF5Rtf7QVq,SpATywNh6bZuzm8s1ceuBUnMUAeoAHHw,25,45,19,15,17,19,23,0,138,19.714285714285715,4,0.0,7,19,14,17,38,19,1,23,0,57,81,1
524,8976,7uaenfsWfnarv8At387iUkznBBW20T7a,SpATywNh6bZuzm8s1ceuBUnMUAeoAHHw,17,31,8,13,3,7,10,1,73,10.428571428571429,2,0.0,16,8,10,3,15,7,3,10,1,37,36,0
525,8978,WCRryRCEKP6zK3AUHtR5dzBwncEtNUH8,G8EPVSXsOYB5YQWZGiz1aVq5Pgr2GrQu,97,224,38,228,19,4,55,2,570,81.42857142857143,11,0.0,83,38,156,19,141,4,72,55,2,296,274,0
526,8986,Ucr48Rnt4CA9YgbeIcM1jITCIMHtgMC0,A3fsA9Zfv1X2fVEQhTw51lKENdNrEqT3,3,0,0,0,0,0,6,0,6,0.8571428571428571,2,0.0,0,0,0,0,0,0,0,6,0,0,6,1
527,9001,lvwGRCEVK5ut59266fZHM9ppN9a4Qw6i,SpATywNh6bZuzm8s1ceuBUnMUAeoAHHw,6,5,3,0,2,0,3,0,13,1.8571428571428572,2,0.0,0,3,0,2,5,0,0,3,0,5,8,1
528,9007,WDMP5c2Ubx8vVSFegA0mXeU23cYb0qCY,RXDvfPUBYFlVdlueBFbLW0mhhAyGEqpt,58,94,8,75,4,38,22,2,243,34.714285714285715,8,0.0,14,8,72,4,80,38,3,22,2,98,145,0
529,9035,ANOp8mWNHTZUswLhYddMTdBChUriYZaX,SpATywNh6bZuzm8s1ceuBUnMUAeoAHHw,24,67,0,49,0,13,20,2,151,21.571428571428573,5,0.0,16,0,42,0,51,13,7,20,2,58,93,0
530,9039,AoGNGJBevj5UJJAo0rhBglhkcP4W6WBy,G8EPVSXsOYB5YQWZGiz1aVq5Pgr2GrQu,1,0,0,0,0,0,1,0,1,0.14285714285714285,1,0.0,0,0,0,0,0,0,0,1,0,0,1,1
531,9043,aiXR63FJxLzLjxOw200I9QHjcVwt5TEN,SpATywNh6bZuzm8s1ceuBUnMUAeoAHHw,18,33,1,25,1,34,15,1,110,15.714285714285714,2,0.0,14,1,21,1,19,34,4,15,1,37,73,1
532,9136,UqGW2x76mENodjXkUPPKnojGcrLxXcJN,SpATywNh6bZuzm8s1ceuBUnMUAeoAHHw,28,57,29,42,16,2,11,0,157,22.428571428571427,6,0.0,17,29,36,16,40,2,6,11,0,98,59,0
533,9146,ZZYUdx90J4oaTxXr1v9ckDyAAO4fdRrW,bWdj2GDclj5ofokWjzoa5jAwMkxCykd6,4,2,0,0,0,0,2,0,4,0.5714285714285714,1,0.0,0,0,0,0,2,0,0,2,0,0,4,1
534,9149,8SekjqaLbfUPHiuX7ZCPwYfF03sn6XJi,RXDvfPUBYFlVdlueBFbLW0mhhAyGEqpt,46,73,30,101,15,3,10,0,232,33.142857142857146,7,0.0,16,30,99,15,57,3,2,10,0,160,72,1
535,9159,9DysAmMC3i4TW1eruWnww7wyDSDGRjXp,A3fsA9Zfv1X2fVEQhTw51lKENdNrEqT3,2,0,0,0,0,0,2,0,2,0.2857142857142857,1,0.0,0,0,0,0,0,0,0,2,0,0,2,1
536,9190,aP7onqFgeKEyIpEWyf9FmzL3YmPhzgtY,SpATywNh6bZuzm8s1ceuBUnMUAeoAHHw,5,4,2,0,0,0,2,0,8,1.1428571428571428,1,0.0,0,2,0,0,4,0,0,2,0,2,6,1
537,9197,1F8H7rmfvGmKxlm2143vBRoEH3vbZnuH,SpATywNh6bZuzm8s1ceuBUnMUAeoAHHw,7,5,2,0,2,0,4,0,13,1.8571428571428572,1,0.0,0,2,0,2,5,0,0,4,0,4,9,1
538,9206,Gdklwa0GJ75FwxPq1eHDC2rS99nIOtyi,bWdj2GDclj5ofokWjzoa5jAwMkxCykd6,38,53,31,116,12,12,14,2,240,34.285714285714285,4,0.0,12,31,102,12,41,12,14,14,2,157,83,1
539,9211,wSA7fJey1UFj4xGAji5nvUhhmZ43Jtbi,SpATywNh6bZuzm8s1ceuBUnMUAeoAHHw,7,7,2,0,1,0,8,0,18,2.5714285714285716,1,0.0,0,2,0,1,7,0,0,8,0,3,15,1
540,9220,lnpRXkDrSwjGYP4CoWLvjg5xZj4SSBHh,SpATywNh6bZuzm8s1ceuBUnMUAeoAHHw,32,91,36,21,10,83,25,2,268,38.285714285714285,6,0.0,18,36,20,10,73,83,1,25,2,84,184,0
541,9229,pSPqM0wxHLvU8pOPPVGkhJ6iIpXOwE0D,SpATywNh6bZuzm8s1ceuBUnMUAeoAHHw,5,2,1,0,1,3,3,0,10,1.4285714285714286,1,0.0,0,1,0,1,2,3,0,3,0,2,8,1
542,9232,b3doS3mx4rZAsWrCVosVej8UMBCaG0ZM,SpATywNh6bZuzm8s1ceuBUnMUAeoAHHw,23,35,15,18,7,0,5,0,80,11.428571428571429,2,0.0,16,15,17,7,19,0,1,5,0,55,25,1
543,9246,oolYEp2BotSva2yfmUYiIDYQiMjym92z,SpATywNh6bZuzm8s1ceuBUnMUAeoAHHw,9,11,6,0,4,0,4,0,25,3.5714285714285716,3,0.0,0,6,0,4,11,0,0,4,0,10,15,0
544,9257,XQsLTRxBgT09jhwR2kw4g3k34p5O8kHV,A3fsA9Zfv1X2fVEQhTw51lKENdNrEqT3,25,45,26,0,12,12,17,3,115,16.428571428571427,7,0.0,5,26,0,12,40,12,0,17,3,43,72,1
545,9260,OXDIjQPBiuWpB7PdzfniEtiITaq40Kxq,SpATywNh6bZuzm8s1ceuBUnMUAeoAHHw,31,42,19,35,8,2,15,1,122,17.428571428571427,7,0.0,11,19,31,8,31,2,4,15,1,69,53,1
546,9272,8lhedVUrxjbKOOXrDoKpLvh9BgBDrVND,SpATywNh6bZuzm8s1ceuBUnMUAeoAHHw,29,59,17,30,8,7,22,5,148,21.142857142857142,3,0.0,13,17,25,8,46,7,5,22,5,63,85,0
547,9273,Mu4L96Qo7KWrVAKYK2IsPfV4EjP9aNL4,G8EPVSXsOYB5YQWZGiz1aVq5Pgr2GrQu,14,9,5,2,4,13,15,1,49,7.0,4,0.0,4,5,1,4,5,13,1,15,1,14,35,1
548,9275,Mu4L96Qo7KWrVAKYK2IsPfV4EjP9aNL4,SpATywNh6bZuzm8s1ceuBUnMUAeoAHHw,30,36,21,47,9,10,18,0,141,20.142857142857142,4,0.0,7,21,39,9,29,10,8,18,0,76,65,1
549,9291,0rBpfipIkPUXXv4992tUqetb5IpoweSC,SpATywNh6bZuzm8s1ceuBUnMUAeoAHHw,12,13,1,12,0,0,6,1,33,4.714285714285714,2,0.0,4,1,12,0,9,0,0,6,1,17,16,1
550,9295,Xj0ZJ92JN6F4CNXTzd0Bvhi4bYi9S3VP,SpATywNh6bZuzm8s1ceuBUnMUAeoAHHw,18,19,8,11,5,6,20,2,71,10.142857142857142,5,0.0,4,8,11,5,15,6,0,20,2,28,43,0
551,9315,MjPA7JgM9XbkzRn3BICo8xJPG5qfeCcD,bWdj2GDclj5ofokWjzoa5jAwMkxCykd6,8,23,18,0,17,0,7,0,65,9.285714285714286,7,0.0,0,18,0,17,23,0,0,7,0,35,30,1
552,9327,tJN8ZYcrD7OwnBb01xCqUSDOnzwFRPdf,SpATywNh6bZuzm8s1ceuBUnMUAeoAHHw,21,55,6,24,0,11,21,0,117,16.714285714285715,6,0.0,15,6,21,0,40,11,3,21,0,42,75,0
553,9328,3SP9iNDvUt8m67ZMqC5DpQRe6ekkTpsP,SpATywNh6bZuzm8s1ceuBUnMUAeoAHHw,1,0,0,0,0,0,17,0,17,2.4285714285714284,6,0.0,0,0,0,0,0,0,0,17,0,0,17,1
554,9329,sh6bGbGsbHzTVrRuQUATUDypFgGrJyhP,bWdj2GDclj5ofokWjzoa5jAwMkxCykd6,1,0,0,0,0,0,1,0,1,0.14285714285714285,1,0.0,0,0,0,0,0,0,0,1,0,0,1,1
555,9335,hsFDq5MhfyyJ0opvBTTLO0xNuy1mKh4f,SpATywNh6bZuzm8s1ceuBUnMUAeoAHHw,25,28,14,8,7,0,8,0,65,9.285714285714286,4,0.0,6,14,8,7,22,0,0,8,0,35,30,1
556,9339,4GxaPPzHsA8XSeyZ6ySVKPYJkeTDhbmO,A3fsA9Zfv1X2fVEQhTw51lKENdNrEqT3,11,2,2,0,2,5,15,3,29,4.142857142857143,1,0.0,0,2,0,2,2,5,0,15,3,4,25,1
557,9347,dQweEcdBCmNmUPOeO7X4TTmH8zuMq2aJ,bWdj2GDclj5ofokWjzoa5jAwMkxCykd6,35,88,39,174,1,30,26,0,358,51.142857142857146,4,0.0,19,39,124,1,69,30,50,26,0,183,175,1
558,9357,aSYSmBNLMzBrel3rF1bQSMOfc7OKhL4q,SpATywNh6bZuzm8s1ceuBUnMUAeoAHHw,18,25,10,20,7,0,9,0,71,10.142857142857142,4,0.0,3,10,16,7,22,0,4,9,0,36,35,1
559,9358,I2ghGumCKIaVsnJOGZA0xyJzTnEm5KtW,RXDvfPUBYFlVdlueBFbLW0mhhAyGEqpt,28,30,18,0,8,16,4,0,76,10.857142857142858,3,0.0,6,18,0,8,24,16,0,4,0,32,44,1
560,9362,EoYFOaJU19EU8QGJeHpIRqrgzpIVI4Qd,bWdj2GDclj5ofokWjzoa5jAwMkxCykd6,9,13,5,28,3,0,9,0,58,8.285714285714286,4,0.0,4,5,27,3,9,0,1,9,0,39,19,1
561,9389,UGnGGFIGvpoYWCshdaVb9HHg3HECfvUa,A3fsA9Zfv1X2fVEQhTw51lKENdNrEqT3,9,4,3,0,3,0,4,0,14,2.0,1,0.0,0,3,0,3,4,0,0,4,0,6,8,1
562,9391,ZVsvi9Hs3gwMngikgiUNz4ONY4BYnfbY,SpATywNh6bZuzm8s1ceuBUnMUAeoAHHw,1,0,0,0,0,0,1,0,1,0.14285714285714285,1,0.0,0,0,0,0,0,0,0,1,0,0,1,1
563,9419,JZCy2v8CZ2nSCAUiBMrG3NWUkCCn6jiz,G8EPVSXsOYB5YQWZGiz1aVq5Pgr2GrQu,32,73,8,6,3,1,11,1,103,14.714285714285714,5,0.0,14,8,5,3,59,1,1,11,1,30,73,1
564,9422,KqXKhfoS0ErJVO04c2y8uGBxUt61ck8m,SpATywNh6bZuzm8s1ceuBUnMUAeoAHHw,15,18,1,20,1,0,5,0,45,6.428571428571429,1,0.0,9,1,19,1,9,0,1,5,0,30,15,1
565,9460,zOr0niRplBKfkwpPHNykN96u1FhzegfK,G8EPVSXsOYB5YQWZGiz1aVq5Pgr2GrQu,54,96,56,0,30,58,29,1,270,38.57142857142857,8,0.0,2,56,0,30,94,58,0,29,1,88,182,0
566,9466,XDPvGyFLLEYwbNEQik2MM4yiADs5rrYJ,G8EPVSXsOYB5YQWZGiz1aVq5Pgr2GrQu,2,0,0,0,0,0,2,0,2,0.2857142857142857,1,0.0,0,0,0,0,0,0,0,2,0,0,2,1
567,9468,JnhPqAOFLEpgEufKhwt0tmkUNhkNteVd,SpATywNh6bZuzm8s1ceuBUnMUAeoAHHw,21,38,7,36,1,0,13,0,95,13.571428571428571,5,0.0,11,7,34,1,27,0,2,13,0,53,42,1
568,9469,V4PEne3FGwC3uaaGa4t7iLZtyEIE0fzF,SpATywNh6bZuzm8s1ceuBUnMUAeoAHHw,25,43,10,16,4,15,25,3,116,16.571428571428573,5,0.0,10,10,13,4,33,15,3,25,3,37,79,1
569,9470,XDPvGyFLLEYwbNEQik2MM4yiADs5rrYJ,RXDvfPUBYFlVdlueBFbLW0mhhAyGEqpt,2,0,0,0,0,0,2,0,2,0.2857142857142857,1,0.0,0,0,0,0,0,0,0,2,0,0,2,1
570,9480,xNIFyatWugs5Maa0edr0HyKzFRsz7FQp,G8EPVSXsOYB5YQWZGiz1aVq5Pgr2GrQu,2,0,0,0,0,0,2,0,2,0.2857142857142857,1,0.0,0,0,0,0,0,0,0,2,0,0,2,1
571,9482,2YohZ5UKGzy1qUgVAShosLdhgm3pfvsR,SpATywNh6bZuzm8s1ceuBUnMUAeoAHHw,6,3,1,0,1,0,2,0,7,1.0,1,0.0,0,1,0,1,3,0,0,2,0,2,5,1
572,9510,20lTdK7j1fcbNyoe9mD2q7qXvA5Z8HOD,SpATywNh6bZuzm8s1ceuBUnMUAeoAHHw,27,72,38,11,26,3,10,1,161,23.0,3,0.0,12,38,10,26,60,3,1,10,1,86,75,0
573,9517,fN4I0M2Yv3uPvseFkDyQdSg5ZokzJaMj,RXDvfPUBYFlVdlueBFbLW0mhhAyGEqpt,71,76,46,186,19,119,10,10,466,66.57142857142857,6,0.0,17,46,169,19,59,119,17,10,10,251,215,1
574,9533,xdUSsALCLmQFNaGX8BEyTR2RhmvhWdsB,SpATywNh6bZuzm8s1ceuBUnMUAeoAHHw,27,31,8,32,5,4,28,0,108,15.428571428571429,5,0.0,8,8,28,5,23,4,4,28,0,49,59,0
575,9549,RV3mgnFEm5em6PXoEJeQNSKFCpjzfVyy,bWdj2GDclj5ofokWjzoa5jAwMkxCykd6,11,10,4,4,1,189,38,0,246,35.142857142857146,10,0.0,1,4,3,1,9,189,1,38,0,9,237,0
576,9550,7J9JIWVCQG1g6yXh3uTVbrSu3pa18Ezn,SpATywNh6bZuzm8s1ceuBUnMUAeoAHHw,28,37,23,18,7,7,9,2,103,14.714285714285714,2,0.0,9,23,17,7,28,7,1,9,2,56,47,0
577,9581,c9jAWas5mvRKYRBHiOkTzLeYoPWRHLa3,G8EPVSXsOYB5YQWZGiz1aVq5Pgr2GrQu,1,0,0,0,0,0,2,0,2,0.2857142857142857,1,0.0,0,0,0,0,0,0,0,2,0,0,2,1
578,9624,GD8FRA1y66qb4KlW9w61HoAU1TWGpDoa,G8EPVSXsOYB5YQWZGiz1aVq5Pgr2GrQu,48,85,37,76,8,1200,140,123,1669,238.42857142857142,14,0.0,13,37,59,8,72,1200,17,140,123,117,1552,0
579,9636,zcw6JFT1cBTyKAWUWt6eG4jvVYxHMSLq,SpATywNh6bZuzm8s1ceuBUnMUAeoAHHw,24,26,15,23,6,8,7,0,85,12.142857142857142,3,0.0,6,15,20,6,20,8,3,7,0,47,38,0
580,9643,UzwJVyLJF6Ih9iHYPyYWMullgIr89o5m,SpATywNh6bZuzm8s1ceuBUnMUAeoAHHw,20,38,20,14,2,2,11,0,87,12.428571428571429,6,0.0,9,20,14,2,29,2,0,11,0,45,42,0
581,9655,66U3TkcZA1aSl7HKRun9CzahgGH85zQD,SpATywNh6bZuzm8s1ceuBUnMUAeoAHHw,28,55,21,14,8,19,13,0,130,18.571428571428573,5,0.0,23,21,14,8,32,19,0,13,0,66,64,0
582,9663,C4q4gNQYEpjKh7pq1qjN8i3L7uSpUX9d,bWdj2GDclj5ofokWjzoa5jAwMkxCykd6,39,56,35,172,19,4,17,2,305,43.57142857142857,4,0.0,6,35,156,19,50,4,16,17,2,216,89,0
583,9672,Bi4hHmeTLwTbUCScu9tC6ZZN7frLUhVP,A3fsA9Zfv1X2fVEQhTw51lKENdNrEqT3,43,18,14,40,10,15,13,0,110,15.714285714285714,2,0.0,1,14,40,10,17,15,0,13,0,65,45,0
584,9720,0dBn4alo7QBTd62VD5XO0yNMbQ5QN2OQ,bWdj2GDclj5ofokWjzoa5jAwMkxCykd6,10,29,10,0,4,0,4,0,47,6.714285714285714,3,0.0,0,10,0,4,29,0,0,4,0,14,33,1
585,9724,YwojqO58bCgaotjJoOTtpKH2oiEFOZyB,bWdj2GDclj5ofokWjzoa5jAwMkxCykd6,15,25,16,10,16,1,7,0,75,10.714285714285714,6,0.0,6,16,8,16,19,1,2,7,0,46,29,1
586,9746,ZPXEPNmHJO62FgTOVc5NtKcudTAnHNKW,SpATywNh6bZuzm8s1ceuBUnMUAeoAHHw,5,2,1,0,1,0,2,0,6,0.8571428571428571,2,0.0,0,1,0,1,2,0,0,2,0,2,4,1
587,9760,HNHEsc9fD0OwHisMoqyCkexAkrQ9Muqq,bWdj2GDclj5ofokWjzoa5jAwMkxCykd6,6,4,2,0,1,0,5,0,12,1.7142857142857142,1,0.0,0,2,0,1,4,0,0,5,0,3,9,0
588,9767,Bv9FSXvHlE6wLC4E4yrAKqe3BQhrrtfx,A3fsA9Zfv1X2fVEQhTw51lKENdNrEqT3,9,18,2,0,0,0,5,0,25,3.5714285714285716,3,0.0,0,2,0,0,18,0,0,5,0,2,23,1
589,9783,CZfXDHVnNPClikyXrFzPhkQoFiILzXmF,SpATywNh6bZuzm8s1ceuBUnMUAeoAHHw,21,37,2,24,0,0,4,0,67,9.571428571428571,3,0.0,13,2,22,0,24,0,2,4,0,37,30,0
590,9784,WnYAypmYi03odcBC7NgJFsh1FzqrpNw6,SpATywNh6bZuzm8s1ceuBUnMUAeoAHHw,5,5,2,0,1,0,2,0,10,1.4285714285714286,2,0.0,0,2,0,1,5,0,0,2,0,3,7,0
591,9790,yUvG5Vqh097epwWCIkZetr2ZlwvQRcLL,SpATywNh6bZuzm8s1ceuBUnMUAeoAHHw,18,29,7,16,1,0,11,0,64,9.142857142857142,6,0.0,11,7,15,1,18,0,1,11,0,34,30,0
592,9793,B2ahwtOo16YsNrAQ9LRd2yjP18Ni9l2c,SpATywNh6bZuzm8s1ceuBUnMUAeoAHHw,23,98,14,17,9,0,17,0,155,22.142857142857142,8,0.0,5,14,15,9,93,0,2,17,0,43,112,0
593,9797,Dnyzk8ev480byt0tTEIN8mPtG79PwCH1,RXDvfPUBYFlVdlueBFbLW0mhhAyGEqpt,15,25,21,0,11,11,3,0,71,10.142857142857142,7,0.0,0,21,0,11,25,11,0,3,0,32,39,1
594,9812,fARr9B8lZ63xDV7GkxAczvRhzY3xBLi6,RXDvfPUBYFlVdlueBFbLW0mhhAyGEqpt,18,24,0,1,0,24,4,0,53,7.571428571428571,4,0.0,1,0,1,0,23,24,0,4,0,2,51,1
595,9823,hEw8FL1KT7bCC88Jn3Nko4dT9ob6cai1,A3fsA9Zfv1X2fVEQhTw51lKENdNrEqT3,10,9,1,0,1,0,1,0,12,1.7142857142857142,1,0.0,0,1,0,1,9,0,0,1,0,2,10,0
596,9839,bunHowa0BgtekXN64zdm8G1L1XdN8gBZ,bWdj2GDclj5ofokWjzoa5jAwMkxCykd6,7,7,1,4,1,0,6,0,19,2.7142857142857144,2,0.0,4,1,4,1,3,0,0,6,0,10,9,1
597,9852,1wIqcRX58Bpw6RXvGnbxsc6WbPwWGwXd,SpATywNh6bZuzm8s1ceuBUnMUAeoAHHw,15,41,5,17,0,0,11,0,74,10.571428571428571,4,0.0,15,5,16,0,26,0,1,11,0,36,38,0
598,9869,0RNr6P08D2zaPSoifoE3KvUeNCFcBSvA,SpATywNh6bZuzm8s1ceuBUnMUAeoAHHw,26,48,9,19,3,17,9,1,106,15.142857142857142,5,0.0,15,9,16,3,33,17,3,9,1,43,63,0
599,9873,u4s0SPiIkynucY7ReF58TL89R2q4zw1x,SpATywNh6bZuzm8s1ceuBUnMUAeoAHHw,15,39,21,6,10,0,5,0,81,11.571428571428571,5,0.0,2,21,6,10,37,0,0,5,0,39,42,1
600,9876,vn6QiPL2hNfbQVlbP4Lnj04J2ZQusfUk,A3fsA9Zfv1X2fVEQhTw51lKENdNrEqT3,7,10,7,0,0,0,4,0,21,3.0,2,0.0,1,7,0,0,9,0,0,4,0,8,13,1
601,9904,OfMabADNCpK7MfQ7IaqBsUw8RvPeHL0S,RXDvfPUBYFlVdlueBFbLW0mhhAyGEqpt,71,99,57,147,26,11,27,0,367,52.42857142857143,7,0.0,23,57,142,26,76,11,5,27,0,248,119,0
602,9923,CRrOxkmi8hXpA4NrCBnJ87Z2odaZzKo5,SpATywNh6bZuzm8s1ceuBUnMUAeoAHHw,31,49,22,37,11,19,16,2,156,22.285714285714285,3,0.0,23,22,33,11,26,19,4,16,2,89,67,1
603,9928,ylxIxsQV8oDzYk1f9bdd1UWiUi1ODLbL,SpATywNh6bZuzm8s1ceuBUnMUAeoAHHw,25,107,2,33,1,32,41,3,219,31.285714285714285,10,0.0,32,2,28,1,75,32,5,41,3,63,156,0
604,9929,oaL3pbpAfEH9L4o42G6X4xjme1kXt2tm,SpATywNh6bZuzm8s1ceuBUnMUAeoAHHw,26,45,23,22,15,0,10,0,115,16.428571428571427,6,0.0,4,23,21,15,41,0,1,10,0,63,52,0
605,9943,KXKbDyPytrUZAnNaQjyZgMFkA2w3Wpvj,SpATywNh6bZuzm8s1ceuBUnMUAeoAHHw,27,77,49,38,21,52,29,3,269,38.42857142857143,5,0.0,16,49,30,21,61,52,8,29,3,116,153,1
606,9946,Jd5OP6GIsguRdsq9k3eSYNENmzhPbdGe,G8EPVSXsOYB5YQWZGiz1aVq5Pgr2GrQu,4,2,1,0,1,0,2,0,6,0.8571428571428571,2,0.0,0,1,0,1,2,0,0,2,0,2,4,0
607,9949,IUn6MADAjAYkGlJisA1WiDvCeNlJd5Xd,SpATywNh6bZuzm8s1ceuBUnMUAeoAHHw,28,33,21,18,15,8,9,0,104,14.857142857142858,5,0.0,8,21,16,15,25,8,2,9,0,60,44,0
608,9953,KeGByI8uvXcUVBvZaFAzVTfOuPfjSv5Y,SpATywNh6bZuzm8s1ceuBUnMUAeoAHHw,10,19,5,0,0,36,26,6,92,13.142857142857142,4,0.0,4,5,0,0,15,36,0,26,6,9,83,1
609,9963,YleydB3G0OM4jGw8hrXeA6aAbHfKvakN,SpATywNh6bZuzm8s1ceuBUnMUAeoAHHw,21,31,16,12,5,0,9,0,73,10.428571428571429,7,0.0,8,16,12,5,23,0,0,9,0,41,32,1
610,9970,Eok9XbYPb68kijAV2YozwwDkJT3HyKxy,RXDvfPUBYFlVdlueBFbLW0mhhAyGEqpt,6,4,3,0,1,0,1,0,9,1.2857142857142858,1,0.0,0,3,0,1,4,0,0,1,0,4,5,1
611,9976,lGkFqL5UAvY3j67ej7JQek066TD04jDH,bWdj2GDclj5ofokWjzoa5jAwMkxCykd6,1,0,0,0,0,0,1,0,1,0.14285714285714285,1,0.0,0,0,0,0,0,0,0,1,0,0,1,1
612,9988,GVRJN4wkoooaXJUVmwnX983A87KsrZPK,SpATywNh6bZuzm8s1ceuBUnMUAeoAHHw,27,41,25,16,10,182,14,1,289,41.285714285714285,9,0.0,7,25,15,10,34,182,1,14,1,57,232,0
613,10015,gFtSwrFBdsFWgLyqjSCzwaUhlQmEHgOq,SpATywNh6bZuzm8s1ceuBUnMUAeoAHHw,16,27,19,6,11,0,7,0,70,10.0,6,0.0,0,19,5,11,27,0,1,7,0,35,35,0
614,10016,5z0TnHJcRYhCDHjnNu4kmaWirO8lucwr,SpATywNh6bZuzm8s1ceuBUnMUAeoAHHw,20,152,6,9,5,3,15,0,190,27.142857142857142,6,0.0,27,6,8,5,125,3,1,15,0,46,144,1
615,10018,yzEVvmdwGMRoO2gS2DXIrqQbxP7DOJod,SpATywNh6bZuzm8s1ceuBUnMUAeoAHHw,7,3,2,0,2,0,2,0,9,1.2857142857142858,1,0.0,0,2,0,2,3,0,0,2,0,4,5,1
616,10024,FELnhQR0c7GZZX82ioYJEZsqujOrfyf7,bWdj2GDclj5ofokWjzoa5jAwMkxCykd6,10,8,5,0,2,9,8,0,32,4.571428571428571,2,0.0,0,5,0,2,8,9,0,8,0,7,25,1
617,10025,SozAkRr5kfRi3urQaoczmRXQoW70onBa,A3fsA9Zfv1X2fVEQhTw51lKENdNrEqT3,10,5,1,0,1,0,6,1,14,2.0,1,0.0,0,1,0,1,5,0,0,6,1,2,12,1
618,10035,FELnhQR0c7GZZX82ioYJEZsqujOrfyf7,A3fsA9Zfv1X2fVEQhTw51lKENdNrEqT3,9,2,1,0,1,21,10,1,36,5.142857142857143,3,0.0,0,1,0,1,2,21,0,10,1,2,34,1
619,10050,syrttArug8Mpzs9L0IHsvBtATawYF9J2,RXDvfPUBYFlVdlueBFbLW0mhhAyGEqpt,7,5,3,0,2,0,4,0,14,2.0,2,0.0,0,3,0,2,5,0,0,4,0,5,9,1
620,10059,UOOsauq1lFlLECbNF7MRjSfLxlpKxsoG,SpATywNh6bZuzm8s1ceuBUnMUAeoAHHw,29,26,15,20,10,2,20,2,95,13.571428571428571,6,0.0,7,15,19,10,19,2,1,20,2,51,44,0
621,10062,e0buQlxlHVWdQd03EOAehldJOI8AeFTm,SpATywNh6bZuzm8s1ceuBUnMUAeoAHHw,29,58,23,20,14,3,17,0,135,19.285714285714285,6,0.0,20,23,19,14,38,3,1,17,0,76,59,1
622,10077,Hm4CsH22c8YOwrQia0hrSt9jO8gMpoFd,SpATywNh6bZuzm8s1ceuBUnMUAeoAHHw,9,7,2,0,2,0,4,0,15,2.142857142857143,1,0.0,0,2,0,2,7,0,0,4,0,4,11,1
623,10101,30Velr3UVYghs85WZNOKXFcrgzOgBsfI,SpATywNh6bZuzm8s1ceuBUnMUAeoAHHw,29,23,13,26,7,72,11,0,152,21.714285714285715,4,0.0,6,13,25,7,17,72,1,11,0,51,101,0
624,10103,yS4oyG8z71VcMw1yy9w2LWRiDWgGhtKA,SpATywNh6bZuzm8s1ceuBUnMUAeoAHHw,16,31,16,18,7,1,7,0,80,11.428571428571429,4,0.0,5,16,15,7,26,1,3,7,0,43,37,0
625,10113,D1iAkJgGLDV90w339eOp4Bqd5z6wvBY6,G8EPVSXsOYB5YQWZGiz1aVq5Pgr2GrQu,26,25,13,41,7,0,6,1,93,13.285714285714286,1,0.0,8,13,34,7,17,0,7,6,1,62,31,1
626,10123,pAxOMca5gwJLembsUpWhZwow68Ox9dFB,SpATywNh6bZuzm8s1ceuBUnMUAeoAHHw,31,63,22,44,11,21,13,0,174,24.857142857142858,3,0.0,26,22,34,11,37,21,10,13,0,93,81,0
627,10132,ILMhPMpEir8VP8Uy0NQI7guQFniKAiGh,SpATywNh6bZuzm8s1ceuBUnMUAeoAHHw,31,60,23,12,10,5,19,2,131,18.714285714285715,7,0.0,20,23,12,10,40,5,0,19,2,65,66,0
628,10149,KG1VMsurgFKqkMv9nVqkO9ppjva59kYw,SpATywNh6bZuzm8s1ceuBUnMUAeoAHHw,10,18,9,0,2,4,11,1,45,6.428571428571429,2,0.0,2,9,0,2,16,4,0,11,1,13,32,0
629,10157,CUHsvexAAfaCEMKsM3644JTxXL5DgSss,SpATywNh6bZuzm8s1ceuBUnMUAeoAHHw,11,13,8,0,5,0,3,0,29,4.142857142857143,3,0.0,1,8,0,5,12,0,0,3,0,14,15,1
630,10173,ewZzdypyl0fDIzKshXnlZXjyO7oizoCq,SpATywNh6bZuzm8s1ceuBUnMUAeoAHHw,21,22,5,18,3,1,5,0,54,7.714285714285714,3,0.0,5,5,15,3,17,1,3,5,0,28,26,1
631,10183,rf43ZHojMqXQ775bmX3nnHgQ62d9XvGK,SpATywNh6bZuzm8s1ceuBUnMUAeoAHHw,28,53,25,25,7,3,10,0,123,17.571428571428573,7,0.0,12,25,23,7,41,3,2,10,0,67,56,1
632,10188,2rS9ufrltSIJVkQHjlKCjTvqcoR7anzz,A3fsA9Zfv1X2fVEQhTw51lKENdNrEqT3,35,49,2,68,1,0,8,0,128,18.285714285714285,3,0.0,7,2,56,1,42,0,12,8,0,66,62,1
633,10189,sY8CcZG79KJSl2UAc47IiYJD1k5ghqCN,SpATywNh6bZuzm8s1ceuBUnMUAeoAHHw,21,51,23,16,10,11,18,2,131,18.714285714285715,7,0.0,13,23,14,10,38,11,2,18,2,60,71,1
634,10197,tqvOTiQbipkIXQL7CIR5dckxV83rng9S,SpATywNh6bZuzm8s1ceuBUnMUAeoAHHw,19,32,15,15,5,17,16,1,101,14.428571428571429,3,0.0,8,15,13,5,24,17,2,16,1,41,60,0
635,10201,MB156dsmOWVhw7SmCPNYcmBUK9V54bIt,SpATywNh6bZuzm8s1ceuBUnMUAeoAHHw,19,74,7,9,6,1,22,4,123,17.571428571428573,4,0.0,4,7,9,6,70,1,0,22,4,26,97,1
636,10217,VWRhwnsbyy7kINpd5Pldlp01a86tVlAt,SpATywNh6bZuzm8s1ceuBUnMUAeoAHHw,28,144,48,28,16,9,33,3,281,40.142857142857146,6,0.0,44,48,21,16,100,9,7,33,3,129,152,0
637,10220,L4Uo99RvQ1cxFdSSaMag731dHicuHxV2,SpATywNh6bZuzm8s1ceuBUnMUAeoAHHw,23,51,2,55,0,11,27,7,153,21.857142857142858,4,0.0,15,2,41,0,36,11,14,27,7,58,95,0
638,10226,DHenWrxVzReZszxo1qw3Im0Zj99tiAII,bWdj2GDclj5ofokWjzoa5jAwMkxCykd6,17,31,19,0,14,22,22,5,113,16.142857142857142,6,0.0,2,19,0,14,29,22,0,22,5,35,78,1
639,10229,NF3XhJyO8NABn8EYOnk4mda6QMNEzq1R,SpATywNh6bZuzm8s1ceuBUnMUAeoAHHw,5,4,1,0,1,0,1,0,7,1.0,1,0.0,0,1,0,1,4,0,0,1,0,2,5,1
640,10239,tFhufiT6u4TsvucRy3FgIz40XsxZ2qh7,SpATywNh6bZuzm8s1ceuBUnMUAeoAHHw,7,4,3,0,3,0,4,0,14,2.0,1,0.0,0,3,0,3,4,0,0,4,0,6,8,1
641,10241,7kTdvih7UMOiFKC9aXRp88JppGP4qSKH,G8EPVSXsOYB5YQWZGiz1aVq5Pgr2GrQu,15,11,5,8,4,0,2,0,30,4.285714285714286,2,0.0,4,5,4,4,7,0,4,2,0,17,13,1
642,10243,YdCaKimqYb8kuFiHEtjPDsCbtIch1tfO,SpATywNh6bZuzm8s1ceuBUnMUAeoAHHw,19,27,10,27,3,0,3,0,70,10.0,2,0.0,14,10,21,3,13,0,6,3,0,48,22,0
643,10266,8Q42Hi4bJP7SqbH4XystURHk2B8tBI5i,G8EPVSXsOYB5YQWZGiz1aVq5Pgr2GrQu,45,34,23,98,17,0,6,0,178,25.428571428571427,5,0.0,0,23,83,17,34,0,15,6,0,123,55,0
644,10285,GIsRCDxWVYGm4So2chhYPzgj7oVxCsSB,SpATywNh6bZuzm8s1ceuBUnMUAeoAHHw,13,10,2,0,2,0,7,0,21,3.0,3,0.0,0,2,0,2,10,0,0,7,0,4,17,1
645,10321,njb10SfHXKB30cApzPJzWBcqA8VQx0HA,A3fsA9Zfv1X2fVEQhTw51lKENdNrEqT3,3,0,0,0,0,0,3,0,3,0.42857142857142855,1,0.0,0,0,0,0,0,0,0,3,0,0,3,1
646,10332,86utfBtmFqtE8TLsj2h1BusfBdMTH1O8,G8EPVSXsOYB5YQWZGiz1aVq5Pgr2GrQu,1,0,0,0,0,0,1,0,1,0.14285714285714285,1,0.0,0,0,0,0,0,0,0,1,0,0,1,1
647,10338,j2MboDReb1SoSFb2jmGT6OHiYADxn3PT,A3fsA9Zfv1X2fVEQhTw51lKENdNrEqT3,4,3,0,0,0,0,2,0,5,0.7142857142857143,1,0.0,0,0,0,0,3,0,0,2,0,0,5,1
648,10345,cRvonGDWMKfxHYP6TdkGqL61F16M4yAA,SpATywNh6bZuzm8s1ceuBUnMUAeoAHHw,21,32,11,23,6,5,8,1,86,12.285714285714286,3,0.0,14,11,18,6,18,5,5,8,1,49,37,1
649,10350,VPNixAQG356EF5jDEqbiZrQi2WBUwBq3,bWdj2GDclj5ofokWjzoa5jAwMkxCykd6,1,0,0,0,0,0,1,0,1,0.14285714285714285,1,0.0,0,0,0,0,0,0,0,1,0,0,1,1
650,10366,c4eku5xKmsJEaRwRx0NUj58EVKBhTUlh,bWdj2GDclj5ofokWjzoa5jAwMkxCykd6,1,0,0,0,0,0,1,0,1,0.14285714285714285,1,0.0,0,0,0,0,0,0,0,1,0,0,1,1
651,10385,4SjsVB9NX97jh5FCSnOdHgEUANJ1svZm,SpATywNh6bZuzm8s1ceuBUnMUAeoAHHw,18,18,10,13,6,0,5,0,52,7.428571428571429,2,0.0,6,10,11,6,12,0,2,5,0,33,19,0
652,10387,MicTROP14z0YujgzSBBjIifCsW8T6Yg4,RXDvfPUBYFlVdlueBFbLW0mhhAyGEqpt,6,0,0,0,0,1,6,1,8,1.1428571428571428,1,0.0,0,0,0,0,0,1,0,6,1,0,8,1
653,10394,EF3EfvSrA0c1KnpZ3bhY87a1rscondwY,SpATywNh6bZuzm8s1ceuBUnMUAeoAHHw,29,54,27,43,11,0,15,0,150,21.428571428571427,4,0.0,17,27,36,11,37,0,7,15,0,91,59,0
654,10399,D2M0lUAbb3NbvYyEfkDkoqJ8mQHTb4db,G8EPVSXsOYB5YQWZGiz1aVq5Pgr2GrQu,58,67,27,102,16,14,9,1,236,33.714285714285715,3,0.0,34,27,77,16,33,14,25,9,1,154,82,0
655,10402,CQOn4KWCA0duDCOSP1DQzvXZ3yAfq1zW,RXDvfPUBYFlVdlueBFbLW0mhhAyGEqpt,74,106,69,223,32,143,37,17,627,89.57142857142857,9,0.0,17,69,201,32,89,143,22,37,17,319,308,0
656,10420,Eu9HoDt3WhECHgcXaERosbI6lMj7Hipb,bWdj2GDclj5ofokWjzoa5jAwMkxCykd6,23,79,39,44,25,20,22,1,230,32.857142857142854,5,0.0,22,39,36,25,57,20,8,22,1,122,108,0
657,10437,N0P6Yrg1zRuUPyVufFpM0ZExnJnGTKKG,SpATywNh6bZuzm8s1ceuBUnMUAeoAHHw,23,34,2,31,0,1,15,1,84,12.0,5,0.0,8,2,26,0,26,1,5,15,1,36,48,0
658,10445,wXYPFlL861BbeAt6BcFbVApC7BUFADjk,A3fsA9Zfv1X2fVEQhTw51lKENdNrEqT3,8,16,1,0,1,0,3,0,21,3.0,2,0.0,0,1,0,1,16,0,0,3,0,2,19,1
659,10451,JLVzu9EMywyHTSJk37J5rGpw1UsulAZc,SpATywNh6bZuzm8s1ceuBUnMUAeoAHHw,15,68,24,0,10,1,22,3,128,18.285714285714285,2,0.0,10,24,0,10,58,1,0,22,3,44,84,1
660,10454,6tpE26inQQeNPyhZ0HoRMm7l4NlMiWJC,SpATywNh6bZuzm8s1ceuBUnMUAeoAHHw,17,40,2,23,1,13,32,5,116,16.571428571428573,5,0.0,14,2,21,1,26,13,2,32,5,38,78,0
661,10463,uhU9XFMHqXe19d0SBpTzsSNqTtdSMXBT,SpATywNh6bZuzm8s1ceuBUnMUAeoAHHw,24,54,27,16,8,33,20,1,159,22.714285714285715,6,0.0,21,27,15,8,33,33,1,20,1,71,88,1
662,10471,l7T8dOWG1cEtOxAxVcD5zNV6vn1g4oYM,G8EPVSXsOYB5YQWZGiz1aVq5Pgr2GrQu,14,20,1,32,0,7,12,0,72,10.285714285714286,8,0.0,6,1,27,0,14,7,5,12,0,34,38,1
663,10475,haRKCROopZUqu2HvR7rfja2IzweZ0l2Z,G8EPVSXsOYB5YQWZGiz1aVq5Pgr2GrQu,1,0,0,0,0,0,1,0,1,0.14285714285714285,1,0.0,0,0,0,0,0,0,0,1,0,0,1,1
664,10483,TroWrp5S8FhNJSgSuQ7Yk9WR8zsmBapA,SpATywNh6bZuzm8s1ceuBUnMUAeoAHHw,6,3,2,0,1,0,2,0,8,1.1428571428571428,1,0.0,0,2,0,1,3,0,0,2,0,3,5,1
665,10491,egnijdxL4Cz1CfzoCQSNIgWry6KIzA7P,SpATywNh6bZuzm8s1ceuBUnMUAeoAHHw,15,25,7,16,3,0,6,0,57,8.142857142857142,6,0.0,2,7,13,3,23,0,3,6,0,25,32,0
666,10505,L5cqiD5dkEVfnPDeQYK5cFR9ssDpnyPm,SpATywNh6bZuzm8s1ceuBUnMUAeoAHHw,2,0,0,0,0,0,2,0,2,0.2857142857142857,1,0.0,0,0,0,0,0,0,0,2,0,0,2,1
667,10507,rf43ZHojMqXQ775bmX3nnHgQ62d9XvGK,bWdj2GDclj5ofokWjzoa5jAwMkxCykd6,14,31,15,4,2,2,12,0,66,9.428571428571429,6,0.0,2,15,4,2,29,2,0,12,0,23,43,0
668,10519,lnzFfoDYtlWPJMTPbihufULiQk1Jv9SB,bWdj2GDclj5ofokWjzoa5jAwMkxCykd6,7,7,1,0,1,0,3,0,12,1.7142857142857142,1,0.0,0,1,0,1,7,0,0,3,0,2,10,1
669,10525,w8NGfLpAxSvlcPdxr1N6ClRtnCD7UkJu,A3fsA9Zfv1X2fVEQhTw51lKENdNrEqT3,2,0,0,0,0,0,3,0,3,0.42857142857142855,2,0.0,0,0,0,0,0,0,0,3,0,0,3,0
670,10537,4zppanuK6US9rtvd04IL60AQkgDx5lm5,RXDvfPUBYFlVdlueBFbLW0mhhAyGEqpt,22,47,1,0,0,3,7,0,58,8.285714285714286,2,0.0,0,1,0,0,47,3,0,7,0,1,57,1
671,10538,xhM6sGbifURQLX65jKTsRiTJp9ePqM2R,RXDvfPUBYFlVdlueBFbLW0mhhAyGEqpt,1,0,0,0,0,0,1,0,1,0.14285714285714285,1,0.0,0,0,0,0,0,0,0,1,0,0,1,1
672,10560,m4jrmeR3FtkOUCbFelK4w5ennRkxlxWD,A3fsA9Zfv1X2fVEQhTw51lKENdNrEqT3,26,37,23,24,16,0,7,0,107,15.285714285714286,4,0.0,1,23,19,16,36,0,5,7,0,59,48,0
673,10563,IQCtPVNPylpjpNjZtQrr88vV5qPansN0,SpATywNh6bZuzm8s1ceuBUnMUAeoAHHw,27,20,13,16,7,3,2,0,61,8.714285714285714,2,0.0,5,13,16,7,15,3,0,2,0,41,20,0
674,10569,54BZa2PEVowNqI6EO6NzeCnkR49ry3oS,SpATywNh6bZuzm8s1ceuBUnMUAeoAHHw,22,40,1,30,1,37,16,1,126,18.0,6,0.0,6,1,23,1,34,37,7,16,1,31,95,0
675,10574,NFgPnsok64XIrx8pioLRAIHoliaoDIvn,SpATywNh6bZuzm8s1ceuBUnMUAeoAHHw,16,42,7,28,0,8,16,0,101,14.428571428571429,4,0.0,13,7,25,0,29,8,3,16,0,45,56,0
676,10579,QoRl6lUIBIR1pRLScf6eg36kOBc6a9q5,SpATywNh6bZuzm8s1ceuBUnMUAeoAHHw,2,0,0,0,0,0,4,0,4,0.5714285714285714,1,0.0,0,0,0,0,0,0,0,4,0,0,4,1
677,10607,ySOA4rbQpe1GOPfJP5VkUnJIGjlF7GXO,SpATywNh6bZuzm8s1ceuBUnMUAeoAHHw,23,41,0,30,0,4,15,4,94,13.428571428571429,4,0.0,18,0,26,0,23,4,4,15,4,44,50,1
678,10612,BTSZE2PXdA7MkOyBKPCnqqHRa0lxJtHO,SpATywNh6bZuzm8s1ceuBUnMUAeoAHHw,23,63,1,49,1,0,10,0,124,17.714285714285715,7,0.0,22,1,42,1,41,0,7,10,0,66,58,0
679,10627,80aCDppJ7kPmOrquzLdsI5OBB47H5IdW,G8EPVSXsOYB5YQWZGiz1aVq5Pgr2GrQu,2,0,0,0,0,0,2,0,2,0.2857142857142857,1,0.0,0,0,0,0,0,0,0,2,0,0,2,1
680,10629,okYlHVritwXcHhkiNLd9pfhBZv2uubiO,SpATywNh6bZuzm8s1ceuBUnMUAeoAHHw,27,22,12,33,9,1,4,0,81,11.571428571428571,2,0.0,7,12,29,9,15,1,4,4,0,57,24,1
681,10641,Q5TmTVdy8nnH2vTL73s67ZseaCMO3k91,SpATywNh6bZuzm8s1ceuBUnMUAeoAHHw,22,16,13,12,7,0,12,0,60,8.571428571428571,5,0.0,2,13,12,7,14,0,0,12,0,34,26,0
682,10652,teqJGecOr4a6oVYU1O9bgvPkX5ZSKA8N,SpATywNh6bZuzm8s1ceuBUnMUAeoAHHw,16,14,9,0,6,0,4,0,33,4.714285714285714,2,0.0,0,9,0,6,14,0,0,4,0,15,18,0
683,10653,7xJbwgQFzeH69YJLbZncWAGT3dRrKubC,bWdj2GDclj5ofokWjzoa5jAwMkxCykd6,17,15,6,86,5,1,8,1,122,17.428571428571427,1,0.0,6,6,85,5,9,1,1,8,1,102,20,0
684,10659,DLCsXj6afYeXedkEor8cSwWpPMWMukEN,A3fsA9Zfv1X2fVEQhTw51lKENdNrEqT3,2,0,0,0,0,0,2,0,2,0.2857142857142857,1,0.0,0,0,0,0,0,0,0,2,0,0,2,1
685,10687,CXT3urKvwCIfBmuQmODRcZXAAAJs07Dk,RXDvfPUBYFlVdlueBFbLW0mhhAyGEqpt,1,0,0,0,0,0,1,0,1,0.14285714285714285,1,0.0,0,0,0,0,0,0,0,1,0,0,1,1
686,10705,CeupRRMHE9iQJGvyrBKaDsPPM9lhEl5t,SpATywNh6bZuzm8s1ceuBUnMUAeoAHHw,28,36,14,24,5,13,15,0,107,15.285714285714286,6,0.0,6,14,19,5,30,13,5,15,0,44,63,0
687,10721,trG5MFuNMIgyTGz1X8WvOUa7Zgqkp3Oe,SpATywNh6bZuzm8s1ceuBUnMUAeoAHHw,17,18,7,18,3,3,7,2,58,8.285714285714286,1,0.0,9,7,15,3,9,3,3,7,2,34,24,1
688,10738,uyomj5PLSD8MuBnIm3UXNOM2zJB1f3kv,bWdj2GDclj5ofokWjzoa5jAwMkxCykd6,21,61,12,52,6,23,16,0,170,24.285714285714285,4,0.0,17,12,43,6,44,23,9,16,0,78,92,1
689,10766,puC0Dx9PufKMVxVv15STTWR0hwd8EG3K,A3fsA9Zfv1X2fVEQhTw51lKENdNrEqT3,6,3,2,0,1,0,2,0,8,1.1428571428571428,1,0.0,0,2,0,1,3,0,0,2,0,3,5,1
690,10804,kGzsRVbG5WMbWj0lYrhayqrDZ1knQphM,SpATywNh6bZuzm8s1ceuBUnMUAeoAHHw,1,0,0,0,0,0,1,0,1,0.14285714285714285,1,0.0,0,0,0,0,0,0,0,1,0,0,1,1
691,10808,8dXlYKMlojZ10oWsfo0feSv9eUr2FQcM,G8EPVSXsOYB5YQWZGiz1aVq5Pgr2GrQu,5,2,1,0,1,0,2,0,6,0.8571428571428571,1,0.0,0,1,0,1,2,0,0,2,0,2,4,1
692,10809,gzv7fk7jLAAb6tXwbmA5ceisqqnvcETz,SpATywNh6bZuzm8s1ceuBUnMUAeoAHHw,12,7,5,0,3,3,7,1,26,3.7142857142857144,2,0.0,0,5,0,3,7,3,0,7,1,8,18,0
693,10819,v21GnAmoo56SIXGBSOh9jDiYo8T7Od29,SpATywNh6bZuzm8s1ceuBUnMUAeoAHHw,22,46,7,10,3,0,7,0,73,10.428571428571429,5,0.0,18,7,10,3,28,0,0,7,0,38,35,0
694,10822,xYLJB56SVkFUOdT5vN3Qq6OYNlnP0Fjc,RXDvfPUBYFlVdlueBFbLW0mhhAyGEqpt,33,87,38,26,17,8,30,7,213,30.428571428571427,5,0.0,0,38,22,17,87,8,4,30,7,77,136,0
695,10823,aGY42WVQQtCQKQRks3knIxGWrLxCy60h,G8EPVSXsOYB5YQWZGiz1aVq5Pgr2GrQu,10,4,0,0,0,3,7,1,15,2.142857142857143,1,0.0,0,0,0,0,4,3,0,7,1,0,15,1
696,10835,kGzsRVbG5WMbWj0lYrhayqrDZ1knQphM,bWdj2GDclj5ofokWjzoa5jAwMkxCykd6,1,0,0,0,0,0,1,0,1,0.14285714285714285,1,0.0,0,0,0,0,0,0,0,1,0,0,1,1
697,10853,2uZ2ZHQBnnVrb5vAtTu1AloVYtZL1MXg,G8EPVSXsOYB5YQWZGiz1aVq5Pgr2GrQu,103,333,103,185,42,36,65,11,775,110.71428571428571,10,0.0,76,103,134,42,257,36,51,65,11,355,420,0
698,10869,fuprfcX49r5QcUYvMQnvvzEf76cx4sRp,bWdj2GDclj5ofokWjzoa5jAwMkxCykd6,9,12,1,6,1,1,6,4,31,4.428571428571429,2,0.0,5,1,5,1,7,1,1,6,4,12,19,1
699,10876,4vKI2gaXrHATS50fqVyDxXcmRy0MrgJS,A3fsA9Zfv1X2fVEQhTw51lKENdNrEqT3,34,62,42,2,29,8,20,3,166,23.714285714285715,4,0.0,12,42,2,29,50,8,0,20,3,85,81,1
700,10891,L5fA3BAe6FOUhd5mq4cXOYYHxtSuGgKM,SpATywNh6bZuzm8s1ceuBUnMUAeoAHHw,28,72,33,17,15,17,21,2,177,25.285714285714285,5,0.0,29,33,15,15,43,17,2,21,2,92,85,0
701,10917,Bf9it9d08iLIslwAMDaZjQzh1Kdl2qhf,SpATywNh6bZuzm8s1ceuBUnMUAeoAHHw,4,2,0,0,0,0,3,0,5,0.7142857142857143,2,0.0,0,0,0,0,2,0,0,3,0,0,5,0
702,10922,Bf9it9d08iLIslwAMDaZjQzh1Kdl2qhf,A3fsA9Zfv1X2fVEQhTw51lKENdNrEqT3,5,3,0,0,0,0,2,0,5,0.7142857142857143,1,0.0,0,0,0,0,3,0,0,2,0,0,5,0
703,10952,nKH0niV76APk64AIPNglQ4nJBpaxE108,SpATywNh6bZuzm8s1ceuBUnMUAeoAHHw,19,40,2,19,1,12,15,1,90,12.857142857142858,2,0.0,9,2,16,1,31,12,3,15,1,28,62,0
704,10955,rieeUlMbLxJ13UbEQlJjvhM4prlyBS6B,SpATywNh6bZuzm8s1ceuBUnMUAeoAHHw,30,30,13,35,7,46,17,5,153,21.857142857142858,5,0.0,7,13,31,7,23,46,4,17,5,58,95,0
705,10990,xxd1UUpRh1yQGgGLMyjshPknKZCNEYlg,A3fsA9Zfv1X2fVEQhTw51lKENdNrEqT3,70,58,29,124,14,0,18,0,243,34.714285714285715,8,0.0,5,29,104,14,53,0,20,18,0,152,91,0
706,10998,h5xiKkT5i4jRXd69Uq7dCU9wazCqxrHf,bWdj2GDclj5ofokWjzoa5jAwMkxCykd6,2,0,0,0,0,0,2,0,2,0.2857142857142857,1,0.0,0,0,0,0,0,0,0,2,0,0,2,1
707,11001,4vKI2gaXrHATS50fqVyDxXcmRy0MrgJS,bWdj2GDclj5ofokWjzoa5jAwMkxCykd6,21,66,39,26,16,45,26,1,219,31.285714285714285,7,0.0,6,39,24,16,60,45,2,26,1,85,134,0
708,11008,nKH0niV76APk64AIPNglQ4nJBpaxE108,A3fsA9Zfv1X2fVEQhTw51lKENdNrEqT3,1,0,0,0,0,0,1,0,1,0.14285714285714285,1,0.0,0,0,0,0,0,0,0,1,0,0,1,1
709,11023,T1BAt2dEt9EzWcybuzXyLq6mHbiEQWZt,G8EPVSXsOYB5YQWZGiz1aVq5Pgr2GrQu,6,3,2,0,2,0,1,0,8,1.1428571428571428,1,0.0,0,2,0,2,3,0,0,1,0,4,4,1
710,11029,1PM9jc7cZ3C091LId9Ek5VaVwRreQ0TH,A3fsA9Zfv1X2fVEQhTw51lKENdNrEqT3,5,3,1,0,1,0,2,0,7,1.0,1,0.0,0,1,0,1,3,0,0,2,0,2,5,1
711,11036,0kTYCEXFiuNuYfSpCOb8HIL3aF9nkrGc,SpATywNh6bZuzm8s1ceuBUnMUAeoAHHw,29,33,13,21,7,12,12,1,99,14.142857142857142,3,0.0,17,13,19,7,16,12,2,12,1,56,43,0
712,11052,T1BAt2dEt9EzWcybuzXyLq6mHbiEQWZt,SpATywNh6bZuzm8s1ceuBUnMUAeoAHHw,4,2,1,0,1,0,2,0,6,0.8571428571428571,1,0.0,0,1,0,1,2,0,0,2,0,2,4,1
713,11068,E6SywimuBT6ZGpGjcedDyV1LTcQRc9ds,A3fsA9Zfv1X2fVEQhTw51lKENdNrEqT3,47,31,24,90,15,24,20,2,206,29.428571428571427,3,0.0,2,24,75,15,29,24,15,20,2,116,90,1
714,11087,vrHzQ6JF32OpLCmbxoOSorIkJkRXwSrS,SpATywNh6bZuzm8s1ceuBUnMUAeoAHHw,3,2,1,0,0,0,1,0,4,0.5714285714285714,1,0.0,0,1,0,0,2,0,0,1,0,1,3,1
715,11092,WFURYJe5F7dgP6i0YwgNFeyKSFpNu7xS,A3fsA9Zfv1X2fVEQhTw51lKENdNrEqT3,17,17,9,0,7,0,4,0,37,5.285714285714286,2,0.0,0,9,0,7,17,0,0,4,0,16,21,1
716,11103,hGRsAtrDXcgCObVXPjFeCVGCoNSaOPeW,SpATywNh6bZuzm8s1ceuBUnMUAeoAHHw,5,3,2,0,1,0,2,0,8,1.1428571428571428,1,0.0,0,2,0,1,3,0,0,2,0,3,5,1
717,11104,hGRsAtrDXcgCObVXPjFeCVGCoNSaOPeW,G8EPVSXsOYB5YQWZGiz1aVq5Pgr2GrQu,4,2,1,0,1,0,1,0,5,0.7142857142857143,1,0.0,0,1,0,1,2,0,0,1,0,2,3,1
718,11113,tDwPtwMZBHQrqhm9RKWd7GW4j1pmFbeZ,A3fsA9Zfv1X2fVEQhTw51lKENdNrEqT3,2,0,0,0,0,0,5,0,5,0.7142857142857143,1,0.0,0,0,0,0,0,0,0,5,0,0,5,1
719,11136,iVrbldNmEASAlMSnUTWFx7qcEdScVNde,SpATywNh6bZuzm8s1ceuBUnMUAeoAHHw,14,31,19,0,13,0,7,0,70,10.0,4,0.0,0,19,0,13,31,0,0,7,0,32,38,1
720,11143,P9MGcZfmosEjD4PEwCVp6vB9MzPbeKLI,G8EPVSXsOYB5YQWZGiz1aVq5Pgr2GrQu,1,0,0,0,0,0,1,0,1,0.14285714285714285,1,0.0,0,0,0,0,0,0,0,1,0,0,1,1
721,11146,e2vebmlDc23PpKpfRYyd1By1iCXcv3UO,RXDvfPUBYFlVdlueBFbLW0mhhAyGEqpt,42,32,0,58,0,0,3,0,93,13.285714285714286,3,0.0,9,0,56,0,23,0,2,3,0,65,28,1
722,11163,arCKlRkqmCQRumxhAEQROrAdYVJBCNWo,SpATywNh6bZuzm8s1ceuBUnMUAeoAHHw,11,13,8,0,3,0,4,0,28,4.0,2,0.0,0,8,0,3,13,0,0,4,0,11,17,0
723,11165,xebgVIBazn8SEoqG6RUzBHRE4EbzaN4t,A3fsA9Zfv1X2fVEQhTw51lKENdNrEqT3,8,2,1,0,1,1,8,1,14,2.0,1,0.0,0,1,0,1,2,1,0,8,1,2,12,1
724,11179,gryVUwWLvrsNv4F8O3kiEBAQILnJg7OT,SpATywNh6bZuzm8s1ceuBUnMUAeoAHHw,20,38,0,24,0,38,21,4,125,17.857142857142858,6,0.0,16,0,23,0,22,38,1,21,4,39,86,0
725,11198,HbdIEiZ1jslj2pBp8czn7lhBbxLYjtpj,SpATywNh6bZuzm8s1ceuBUnMUAeoAHHw,7,14,6,0,2,0,3,0,25,3.5714285714285716,3,0.0,2,6,0,2,12,0,0,3,0,10,15,1
726,11225,Vmvdv9k8S1ONPkUHSdXPEenyx7UNVISW,SpATywNh6bZuzm8s1ceuBUnMUAeoAHHw,15,31,1,12,0,20,12,3,79,11.285714285714286,3,0.0,10,1,9,0,21,20,3,12,3,20,59,1
727,11290,JZZnn79hJZh6uernNE50Bi5HDewJf78E,RXDvfPUBYFlVdlueBFbLW0mhhAyGEqpt,15,14,5,0,2,8,3,0,32,4.571428571428571,1,0.0,0,5,0,2,14,8,0,3,0,7,25,1
728,11303,gnjZOoI8BeitDTrO8bhWhoFLWjid4LeA,bWdj2GDclj5ofokWjzoa5jAwMkxCykd6,7,9,4,0,0,0,5,0,18,2.5714285714285716,1,0.0,2,4,0,0,7,0,0,5,0,6,12,1
729,11306,5ZQSBzYZG0AalCCLt1PNSHaXvEDYOMak,SpATywNh6bZuzm8s1ceuBUnMUAeoAHHw,1,0,0,0,0,0,2,0,2,0.2857142857142857,1,0.0,0,0,0,0,0,0,0,2,0,0,2,1
730,11314,o7HGnjuXHyEfteJtxVQ5dpBJz7Yzz0T1,SpATywNh6bZuzm8s1ceuBUnMUAeoAHHw,7,3,0,0,0,2,4,0,9,1.2857142857142858,1,0.0,0,0,0,0,3,2,0,4,0,0,9,1
731,11326,IFQQStJmvfA3NyTN88jNEn631VKsGQET,SpATywNh6bZuzm8s1ceuBUnMUAeoAHHw,7,2,1,0,1,1,4,0,9,1.2857142857142858,1,0.0,0,1,0,1,2,1,0,4,0,2,7,1
732,11331,eqaDSMjkkLr4V8zwKAYzNF193Wm3l9Pg,A3fsA9Zfv1X2fVEQhTw51lKENdNrEqT3,1,0,0,0,0,0,1,0,1,0.14285714285714285,1,0.0,0,0,0,0,0,0,0,1,0,0,1,1
733,11344,SHXTFVyrdbzmF1pJEIvr2zpR8jK358bb,SpATywNh6bZuzm8s1ceuBUnMUAeoAHHw,22,46,3,28,1,25,9,1,113,16.142857142857142,5,0.0,11,3,24,1,35,25,4,9,1,39,74,1
734,11355,Z5t6AGEyADeSVHWZTgBW4lR5XMnM5VWU,SpATywNh6bZuzm8s1ceuBUnMUAeoAHHw,29,41,14,12,10,0,5,0,82,11.714285714285714,3,0.0,13,14,12,10,28,0,0,5,0,49,33,0
735,11356,KXkOWXgIJuvmtvaUVHrKWAaqrFaY5cx8,SpATywNh6bZuzm8s1ceuBUnMUAeoAHHw,11,18,0,22,0,3,7,3,53,7.571428571428571,3,0.0,13,0,18,0,5,3,4,7,3,31,22,1
736,11357,WJKEaeH3ob9wscd3i5dXEY7kRPHMEwVj,bWdj2GDclj5ofokWjzoa5jAwMkxCykd6,5,3,1,0,1,0,2,0,7,1.0,2,0.0,0,1,0,1,3,0,0,2,0,2,5,1
737,11362,13fzVwLJSsgGzTLwjEHCuvf0Ks8dgxYZ,SpATywNh6bZuzm8s1ceuBUnMUAeoAHHw,28,49,13,24,5,12,42,7,152,21.714285714285715,8,0.0,12,13,20,5,37,12,4,42,7,50,102,1
738,11389,PqLnOjm8gCkS4EhgcnGtGCfdwzyBuNjz,A3fsA9Zfv1X2fVEQhTw51lKENdNrEqT3,10,3,2,0,2,0,8,2,17,2.4285714285714284,1,0.0,0,2,0,2,3,0,0,8,2,4,13,1
739,11403,HYCkyEJhW9QtzilmanJKsxRLSBi9UGoV,A3fsA9Zfv1X2fVEQhTw51lKENdNrEqT3,1,0,0,0,0,0,1,0,1,0.14285714285714285,1,0.0,0,0,0,0,0,0,0,1,0,0,1,1
740,11410,YEYkPWHcftKd8bKe1Q9b21lzhv1SChRM,SpATywNh6bZuzm8s1ceuBUnMUAeoAHHw,31,33,19,21,8,6,15,2,104,14.857142857142858,4,0.0,7,19,21,8,26,6,0,15,2,55,49,1
741,11414,HYCkyEJhW9QtzilmanJKsxRLSBi9UGoV,bWdj2GDclj5ofokWjzoa5jAwMkxCykd6,2,0,0,0,0,0,2,0,2,0.2857142857142857,1,0.0,0,0,0,0,0,0,0,2,0,0,2,1
742,11425,82UlWF6Fm1gkNum7nNbVw0yOV1BUdNoS,bWdj2GDclj5ofokWjzoa5jAwMkxCykd6,9,15,8,0,1,16,13,1,54,7.714285714285714,5,0.0,1,8,0,1,14,16,0,13,1,10,44,0
743,11428,82UlWF6Fm1gkNum7nNbVw0yOV1BUdNoS,A3fsA9Zfv1X2fVEQhTw51lKENdNrEqT3,17,31,20,0,9,36,20,3,119,17.0,7,0.0,1,20,0,9,30,36,0,20,3,30,89,0
744,11463,uFcd6yCTniScAvbMiWJYRQ8Du52ubELm,RXDvfPUBYFlVdlueBFbLW0mhhAyGEqpt,31,45,8,18,5,6,7,0,89,12.714285714285714,5,0.0,0,8,17,5,45,6,1,7,0,30,59,0
745,11475,UJiJ4PvH4qodyDnURbFXyi5LWwaSKUwb,RXDvfPUBYFlVdlueBFbLW0mhhAyGEqpt,74,81,42,172,20,48,33,6,402,57.42857142857143,6,0.0,16,42,163,20,65,48,9,33,6,241,161,0
746,11478,RGf4k3THi4AV4qsAjc1UEOWiIeDYcchf,A3fsA9Zfv1X2fVEQhTw51lKENdNrEqT3,34,48,31,50,17,20,10,0,176,25.142857142857142,5,0.0,6,31,39,17,42,20,11,10,0,93,83,0
747,11492,zKdMAgWBKjA8jF1t74QW0q0ZxGMcvW9t,RXDvfPUBYFlVdlueBFbLW0mhhAyGEqpt,19,9,7,16,5,0,2,0,39,5.571428571428571,1,0.0,2,7,15,5,7,0,1,2,0,29,10,1
748,11509,sQVxVjeT9NfPAT9IdDUsY0RSB3XrvO2y,SpATywNh6bZuzm8s1ceuBUnMUAeoAHHw,25,64,32,45,0,29,20,1,191,27.285714285714285,4,0.0,25,32,36,0,39,29,9,20,1,93,98,0
749,11515,iIwpETh60BkJfJQJqvWucH2tzh64j0U3,SpATywNh6bZuzm8s1ceuBUnMUAeoAHHw,27,86,34,34,7,4,28,3,196,28.0,8,0.0,16,34,31,7,70,4,3,28,3,88,108,0
750,11522,MOJ1BiwMK7lBUiFS9DTwwPvbUWIkdFFP,A3fsA9Zfv1X2fVEQhTw51lKENdNrEqT3,35,82,49,22,29,0,14,0,196,28.0,13,0.0,2,49,21,29,80,0,1,14,0,101,95,1
751,11547,NKnL5oTIIxOmPf0Ep5iKaKIecNheR2t7,SpATywNh6bZuzm8s1ceuBUnMUAeoAHHw,16,33,17,12,9,0,7,0,78,11.142857142857142,3,0.0,10,17,12,9,23,0,0,7,0,48,30,0
752,11555,7OkCZWJW1Ow4wpTBUq53amL13pV2vy2v,G8EPVSXsOYB5YQWZGiz1aVq5Pgr2GrQu,24,70,15,48,11,13,34,0,191,27.285714285714285,8,0.0,8,15,40,11,62,13,8,34,0,74,117,0
753,11618,FftGEmgyFF5pWtfM0EZJwp0rzcGMH1JL,SpATywNh6bZuzm8s1ceuBUnMUAeoAHHw,31,74,44,28,17,4,40,10,217,31.0,4,0.0,9,44,25,17,65,4,3,40,10,95,122,1
754,11636,Y3uwxWCm13Ol5xozrT2GPjOPhBlC2kOq,RXDvfPUBYFlVdlueBFbLW0mhhAyGEqpt,9,18,0,0,0,0,2,0,20,2.857142857142857,2,0.0,0,0,0,0,18,0,0,2,0,0,20,1
755,11646,MR4k3wv95Ttq1fQaT9W4WgxrPezl0N4j,G8EPVSXsOYB5YQWZGiz1aVq5Pgr2GrQu,11,15,5,16,2,0,3,0,41,5.857142857142857,1,0.0,2,5,12,2,13,0,4,3,0,21,20,1
756,11647,KAHcIFqF1cp4MJN69oD7XlQBuGCiexCt,bWdj2GDclj5ofokWjzoa5jAwMkxCykd6,2,0,0,0,0,0,2,0,2,0.2857142857142857,1,0.0,0,0,0,0,0,0,0,2,0,0,2,1
757,11677,FduexGuoL0tC7LqIuSFtIm03lXvHHbSw,SpATywNh6bZuzm8s1ceuBUnMUAeoAHHw,11,37,2,0,1,4,32,4,80,11.428571428571429,5,0.0,0,2,0,1,37,4,0,32,4,3,77,1
758,11690,37daqGAbA6x2VvXkiqdWX1nBv2Tqqgte,G8EPVSXsOYB5YQWZGiz1aVq5Pgr2GrQu,68,280,129,168,34,75,70,2,758,108.28571428571429,10,0.0,51,129,139,34,229,75,29,70,2,353,405,0
759,11741,n3cFXGx3rjoPJPOmeF5tlnmkFmFFJI7p,A3fsA9Zfv1X2fVEQhTw51lKENdNrEqT3,50,47,28,72,10,24,30,2,213,30.428571428571427,6,0.0,4,28,54,10,43,24,18,30,2,96,117,1
760,11758,7UZLQknm2A0Xcs9lZDmhCq5ocQIOEmmj,SpATywNh6bZuzm8s1ceuBUnMUAeoAHHw,26,25,11,16,6,0,11,1,70,10.0,2,0.0,10,11,14,6,15,0,2,11,1,41,29,1
761,11811,YRnTGuoAQA7UM3uV59YNXUYN4n1CR9jv,SpATywNh6bZuzm8s1ceuBUnMUAeoAHHw,27,24,13,16,7,1,6,0,67,9.571428571428571,5,0.0,7,13,14,7,17,1,2,6,0,41,26,0
762,11827,McYATdhZDDMDpni6a4GbjI06ustMpvdV,G8EPVSXsOYB5YQWZGiz1aVq5Pgr2GrQu,7,3,2,0,2,4,3,0,14,2.0,2,0.0,0,2,0,2,3,4,0,3,0,4,10,1
763,11836,zm7kTPWc2Ij7nyP9Co8cVtDEuAGTQRmn,A3fsA9Zfv1X2fVEQhTw51lKENdNrEqT3,5,3,1,0,1,0,2,0,7,1.0,1,0.0,0,1,0,1,3,0,0,2,0,2,5,1
764,11839,McYATdhZDDMDpni6a4GbjI06ustMpvdV,A3fsA9Zfv1X2fVEQhTw51lKENdNrEqT3,10,8,6,0,5,6,2,0,27,3.857142857142857,2,0.0,0,6,0,5,8,6,0,2,0,11,16,1
765,11841,4GMbKnTV7f2uA3paM09GNAdyVnypDTbs,A3fsA9Zfv1X2fVEQhTw51lKENdNrEqT3,38,24,4,44,2,0,11,0,85,12.142857142857142,4,0.0,3,4,42,2,21,0,2,11,0,51,34,0
766,11842,MFEX8ieEZqjvGSzLHf4hJjdY1BCifo1Q,G8EPVSXsOYB5YQWZGiz1aVq5Pgr2GrQu,9,5,2,4,2,0,3,0,16,2.2857142857142856,1,0.0,1,2,3,2,4,0,1,3,0,8,8,1
767,11862,n42jeLyeDpoJPwT1pkhXRyhzHjUnC2KC,SpATywNh6bZuzm8s1ceuBUnMUAeoAHHw,26,47,14,12,4,2,17,5,101,14.428571428571429,6,0.0,12,14,9,4,35,2,3,17,5,39,62,1
768,11867,2axjl9Byq908rUlMrYGzo2sfhA3p18fU,SpATywNh6bZuzm8s1ceuBUnMUAeoAHHw,11,6,4,1,3,0,2,0,16,2.2857142857142856,1,0.0,1,4,1,3,5,0,0,2,0,9,7,1
769,11892,QkpDyGn4qqqwpxvXRrFsAsKSrEtfkQJQ,SpATywNh6bZuzm8s1ceuBUnMUAeoAHHw,28,27,15,24,8,4,5,0,83,11.857142857142858,3,0.0,8,15,23,8,19,4,1,5,0,54,29,0
770,11895,Er0phLmicWoU9yr3sUBC2BCne0YIK1vQ,A3fsA9Zfv1X2fVEQhTw51lKENdNrEqT3,39,37,22,34,15,0,25,0,133,19.0,7,0.0,0,22,29,15,37,0,5,25,0,66,67,1
771,11896,UzuB1gScsXJ6b46FForXq5x2wnZw4QoH,SpATywNh6bZuzm8s1ceuBUnMUAeoAHHw,31,61,30,26,17,6,21,2,163,23.285714285714285,4,0.0,14,30,24,17,47,6,2,21,2,85,78,0
772,11900,8xT75XL9dKm7CwLmOxtys3bmWBh3OJmY,RXDvfPUBYFlVdlueBFbLW0mhhAyGEqpt,58,79,4,35,2,0,7,0,127,18.142857142857142,4,0.0,25,4,35,2,54,0,0,7,0,66,61,0
773,11914,5YO2NGkR6BZ1s4HfeOrLezgFkpBKmNPV,SpATywNh6bZuzm8s1ceuBUnMUAeoAHHw,1,0,0,0,0,0,1,0,1,0.14285714285714285,1,0.0,0,0,0,0,0,0,0,1,0,0,1,0
774,11917,uuxrUSHn3GpYFneZnY8GpLgr5XiyDABs,A3fsA9Zfv1X2fVEQhTw51lKENdNrEqT3,12,8,6,0,5,0,5,1,25,3.5714285714285716,1,0.0,0,6,0,5,8,0,0,5,1,11,14,0
775,11920,uarVJhEs6XLW7Dw1D7iBgEK6zPe65WwX,A3fsA9Zfv1X2fVEQhTw51lKENdNrEqT3,15,16,13,0,2,0,6,0,37,5.285714285714286,3,0.0,1,13,0,2,15,0,0,6,0,16,21,1
776,11921,JERgMmFADxaPxEUdcYHhaMN4ZwNAyErv,A3fsA9Zfv1X2fVEQhTw51lKENdNrEqT3,71,34,20,164,13,24,14,1,270,38.57142857142857,2,0.0,6,20,137,13,28,24,27,14,1,176,94,0
777,11922,gKme5KJOgqJrjNwDUsRPKwK3QFyN7vPD,RXDvfPUBYFlVdlueBFbLW0mhhAyGEqpt,50,82,47,122,22,4,9,1,287,41.0,6,0.0,18,47,115,22,64,4,7,9,1,202,85,0
778,11951,Nsiwn7635mGlMs5nxmspwUbmVQaPZWQ6,G8EPVSXsOYB5YQWZGiz1aVq5Pgr2GrQu,21,18,10,26,7,1,11,1,74,10.571428571428571,3,0.0,2,10,21,7,16,1,5,11,1,40,34,1
779,11956,oyFfPK6y9oPPwQR5mbsXW98FJaEnU88b,bWdj2GDclj5ofokWjzoa5jAwMkxCykd6,4,2,1,0,1,0,2,0,6,0.8571428571428571,1,0.0,0,1,0,1,2,0,0,2,0,2,4,1
780,11977,JtbtRyqX4dZ0edFKFJwGNY9JG3aidrlj,SpATywNh6bZuzm8s1ceuBUnMUAeoAHHw,29,40,18,26,12,4,18,1,119,17.0,3,0.0,16,18,20,12,24,4,6,18,1,66,53,0
781,11983,058hmyJK1lejTwX8sX29U5yFETfrvQ95,G8EPVSXsOYB5YQWZGiz1aVq5Pgr2GrQu,1,0,0,0,0,0,1,0,1,0.14285714285714285,1,0.0,0,0,0,0,0,0,0,1,0,0,1,1
782,11986,058hmyJK1lejTwX8sX29U5yFETfrvQ95,A3fsA9Zfv1X2fVEQhTw51lKENdNrEqT3,1,0,0,0,0,0,1,0,1,0.14285714285714285,1,0.0,0,0,0,0,0,0,0,1,0,0,1,1
783,12007,Uwggq8NcihxhBLnReA5tboVbRLkIS371,SpATywNh6bZuzm8s1ceuBUnMUAeoAHHw,1,0,0,0,0,0,1,0,1,0.14285714285714285,1,0.0,0,0,0,0,0,0,0,1,0,0,1,1
784,12011,q36eiA77bwwsXGg05ifhgnTFDpR9Ar4V,bWdj2GDclj5ofokWjzoa5jAwMkxCykd6,38,63,33,200,10,25,11,0,342,48.857142857142854,5,0.0,19,33,181,10,44,25,19,11,0,243,99,0
785,12020,LHFojLmJ5Ll3LGp6GnqLClTkRFP5a32j,bWdj2GDclj5ofokWjzoa5jAwMkxCykd6,1,0,0,0,0,0,1,0,1,0.14285714285714285,1,0.0,0,0,0,0,0,0,0,1,0,0,1,1
786,12030,gSxiLtAU3HWIGwL9IJcAr6lB3iS2AC6Z,A3fsA9Zfv1X2fVEQhTw51lKENdNrEqT3,2,0,0,0,0,0,2,0,2,0.2857142857142857,1,0.0,0,0,0,0,0,0,0,2,0,0,2,1
787,12053,7m381KBoEq7nybFxitllQlgHOa7YYR1i,SpATywNh6bZuzm8s1ceuBUnMUAeoAHHw,25,64,10,27,4,7,16,0,128,18.285714285714285,7,0.0,4,10,26,4,60,7,1,16,0,44,84,0
788,12090,M7Vbw5q1oL32IfEMSI9AM5uHCUMDFHmm,A3fsA9Zfv1X2fVEQhTw51lKENdNrEqT3,19,17,11,2,5,1,17,3,56,8.0,2,0.0,0,11,2,5,17,1,0,17,3,18,38,1
789,12099,tCXa4pMsMXRuliZWNM9so3Odte6UmpYj,bWdj2GDclj5ofokWjzoa5jAwMkxCykd6,1,0,0,0,0,0,1,0,1,0.14285714285714285,1,0.0,0,0,0,0,0,0,0,1,0,0,1,1
790,12113,l6nLhBWETqCazxhjGSPbpZQRNqpsMPRD,bWdj2GDclj5ofokWjzoa5jAwMkxCykd6,2,0,0,0,0,0,4,0,4,0.5714285714285714,1,0.0,0,0,0,0,0,0,0,4,0,0,4,1
791,12141,4n0eavxCNp4F6LlqtEg5gsmyBVEbRBeE,G8EPVSXsOYB5YQWZGiz1aVq5Pgr2GrQu,70,147,57,112,46,0,14,0,376,53.714285714285715,6,0.0,76,57,81,46,71,0,31,14,0,260,116,1
792,12147,VJw4zFdkpwcu4sXr2e3LyD2CU2ajLhIu,SpATywNh6bZuzm8s1ceuBUnMUAeoAHHw,30,40,19,18,9,22,11,0,119,17.0,1,0.0,7,19,17,9,33,22,1,11,0,52,67,0
793,12178,V2ut0n3Er1p82GdKRcLWOrmZXj3No2ts,bWdj2GDclj5ofokWjzoa5jAwMkxCykd6,1,0,0,0,0,0,1,0,1,0.14285714285714285,1,0.0,0,0,0,0,0,0,0,1,0,0,1,1
794,12203,TSpDTvH7tx13LMObu1OWRVwKh8isSitO,SpATywNh6bZuzm8s1ceuBUnMUAeoAHHw,14,16,4,3,3,0,6,1,33,4.714285714285714,1,0.0,4,4,3,3,12,0,0,6,1,14,19,1
795,12208,dOjwcbpJoBEbemc7xmUKlO5o5THYYuWb,RXDvfPUBYFlVdlueBFbLW0mhhAyGEqpt,67,76,26,85,14,25,15,2,243,34.714285714285715,3,0.0,23,26,83,14,53,25,2,15,2,146,97,0
796,12223,ysTOTg8n91NBng8BrzlEom4lR6CnDwPC,SpATywNh6bZuzm8s1ceuBUnMUAeoAHHw,26,57,22,17,7,12,29,10,154,22.0,4,0.0,13,22,16,7,44,12,1,29,10,58,96,1
797,12241,YqzonIu9nUz3X2nkdJiReRrylaOckiCC,SpATywNh6bZuzm8s1ceuBUnMUAeoAHHw,21,31,2,24,1,4,14,1,77,11.0,2,0.0,17,2,21,1,14,4,3,14,1,41,36,0
798,12246,I0uHaMvDeJM1w1AenEVj8xWzg3OizAzv,G8EPVSXsOYB5YQWZGiz1aVq5Pgr2GrQu,35,45,1,60,0,2,19,2,129,18.428571428571427,3,0.0,10,1,48,0,35,2,12,19,2,59,70,1
799,12253,Kxifrwa9ntGWJyRtJS6owg0ZQfSyRPcW,A3fsA9Zfv1X2fVEQhTw51lKENdNrEqT3,2,0,0,0,0,0,2,0,2,0.2857142857142857,1,0.0,0,0,0,0,0,0,0,2,0,0,2,0
800,12262,GAfZCFoItZF6u2g6TmFIAYqk177Q5kZH,SpATywNh6bZuzm8s1ceuBUnMUAeoAHHw,30,25,13,25,7,1,8,0,79,11.285714285714286,1,0.0,8,13,21,7,17,1,4,8,0,49,30,1
801,12287,zZK4lWrYYn5bTLcjHRRO0XA8xNwpu7OT,RXDvfPUBYFlVdlueBFbLW0mhhAyGEqpt,63,47,23,115,18,1,17,7,228,32.57142857142857,5,0.0,17,23,106,18,30,1,9,17,7,164,64,0
802,12293,UxPdjVFzcqqJoB99RNTW4pwswAcQ32eZ,RXDvfPUBYFlVdlueBFbLW0mhhAyGEqpt,32,20,18,0,15,0,23,0,76,10.857142857142858,3,0.0,2,18,0,15,18,0,0,23,0,35,41,0
803,12302,OeLBIzS0gNQ56euxy5b66gAZMzQCGE7n,A3fsA9Zfv1X2fVEQhTw51lKENdNrEqT3,71,31,21,140,14,2,30,2,240,34.285714285714285,3,0.0,2,21,116,14,29,2,24,30,2,153,87,1
804,12316,8SG0IoRU1kfooCNm4CWXEAnDe54VjVcy,A3fsA9Zfv1X2fVEQhTw51lKENdNrEqT3,22,16,11,0,8,2,10,2,49,7.0,2,0.0,2,11,0,8,14,2,0,10,2,21,28,1
805,12330,9iGaqBGS5kkoXjLd87hUL2eIJMVUVKfU,A3fsA9Zfv1X2fVEQhTw51lKENdNrEqT3,53,57,28,150,4,0,18,1,258,36.857142857142854,4,0.0,9,28,135,4,48,0,15,18,1,176,82,0
806,12350,7m381KBoEq7nybFxitllQlgHOa7YYR1i,G8EPVSXsOYB5YQWZGiz1aVq5Pgr2GrQu,57,129,28,122,18,15,18,0,330,47.142857142857146,6,0.0,3,28,113,18,126,15,9,18,0,162,168,1
807,12356,GW78UVODV1oPxxynjXG1U7em3gdA8wQF,SpATywNh6bZuzm8s1ceuBUnMUAeoAHHw,25,22,16,8,9,0,7,1,63,9.0,3,0.0,0,16,8,9,22,0,0,7,1,33,30,0
808,12358,nlf7AlI08jbhXKXagULClsgDoakDOx2G,SpATywNh6bZuzm8s1ceuBUnMUAeoAHHw,12,8,6,0,5,2,6,1,28,4.0,1,0.0,0,6,0,5,8,2,0,6,1,11,17,1
809,12363,5wKAjfQ5T37M2WWxYAwMeUeLhDScm1Z0,bWdj2GDclj5ofokWjzoa5jAwMkxCykd6,4,2,0,0,0,50,26,0,78,11.142857142857142,6,0.0,0,0,0,0,2,50,0,26,0,0,78,0
810,12372,Dx1ZzKpwFtwNhE9gdaLaohssqGyqrqjD,A3fsA9Zfv1X2fVEQhTw51lKENdNrEqT3,45,42,23,60,10,17,11,0,163,23.285714285714285,3,0.0,6,23,50,10,36,17,10,11,0,89,74,1
811,12374,dkmoSmrpP5gK9Xi6ySwrroCNfUlumbtO,G8EPVSXsOYB5YQWZGiz1aVq5Pgr2GrQu,12,7,0,10,0,0,2,0,19,2.7142857142857144,1,0.0,0,0,8,0,7,0,2,2,0,8,11,1
812,12381,zZsHSLX7Hk1sqhZYCfBgGlYJnqetGIKf,SpATywNh6bZuzm8s1ceuBUnMUAeoAHHw,9,12,2,0,0,4,7,1,26,3.7142857142857144,3,0.0,0,2,0,0,12,4,0,7,1,2,24,1
813,12383,7OkCZWJW1Ow4wpTBUq53amL13pV2vy2v,SpATywNh6bZuzm8s1ceuBUnMUAeoAHHw,15,42,1,14,2,87,35,7,188,26.857142857142858,5,0.0,13,1,13,2,29,87,1,35,7,29,159,0
814,12394,HXDAyPRsApqduwAe8pSs8BlStcKWeCOs,bWdj2GDclj5ofokWjzoa5jAwMkxCykd6,5,6,3,0,1,0,3,0,13,1.8571428571428572,2,0.0,0,3,0,1,6,0,0,3,0,4,9,1
815,12410,wXFfHtwd9smrvhh9NQW7SmEEo1001LDW,A3fsA9Zfv1X2fVEQhTw51lKENdNrEqT3,24,36,22,10,8,2,26,1,105,15.0,7,0.0,2,22,8,8,34,2,2,26,1,40,65,1
816,12412,s24Qk0ZpAXR97ldBDtgP8DE6rT8or69U,SpATywNh6bZuzm8s1ceuBUnMUAeoAHHw,16,40,1,34,0,0,7,0,82,11.714285714285714,4,0.0,13,1,31,0,27,0,3,7,0,45,37,0
817,12442,HbmZzALzRW0CJmaD07o1oMpvJwGgfjK4,SpATywNh6bZuzm8s1ceuBUnMUAeoAHHw,8,12,2,0,2,2,4,1,23,3.2857142857142856,3,0.0,1,2,0,2,11,2,0,4,1,5,18,1
818,12445,CqxK3XGagGgLgWXJIkp8qfeo0SWv94XW,RXDvfPUBYFlVdlueBFbLW0mhhAyGEqpt,65,174,101,115,25,131,47,25,618,88.28571428571429,11,0.0,45,101,98,25,129,131,17,47,25,269,349,0
819,12464,NSrMJ69WS92LaJ6a09xOpViELCrjji8S,SpATywNh6bZuzm8s1ceuBUnMUAeoAHHw,22,45,9,30,1,43,20,0,148,21.142857142857142,10,0.0,8,9,26,1,37,43,4,20,0,44,104,0
820,12480,q54oCvxsY1LE19jtoD23qGpHSrkdhUlF,A3fsA9Zfv1X2fVEQhTw51lKENdNrEqT3,36,26,1,66,1,1,16,0,111,15.857142857142858,2,0.0,2,1,62,1,24,1,4,16,0,66,45,1
821,12482,35upFtDrqCqWhj8RVNLHqe6Xg75dIX7z,G8EPVSXsOYB5YQWZGiz1aVq5Pgr2GrQu,4,3,1,2,0,0,2,0,8,1.1428571428571428,2,0.0,1,1,2,0,2,0,0,2,0,4,4,1
822,12515,UKrQdzHwNJRJK7ZoTzKsoWlrkEbsQk7X,RXDvfPUBYFlVdlueBFbLW0mhhAyGEqpt,1,0,0,0,0,0,1,0,1,0.14285714285714285,1,0.0,0,0,0,0,0,0,0,1,0,0,1,1
823,12522,MRCD9XxqQVpIexf9EdSwdaoHW691k7OH,SpATywNh6bZuzm8s1ceuBUnMUAeoAHHw,21,33,17,16,0,0,5,0,71,10.142857142857142,2,0.0,9,17,14,0,24,0,2,5,0,40,31,1
824,12569,4Z7n4wdauhlOTY95FN6j39vUUWT0ZgYl,SpATywNh6bZuzm8s1ceuBUnMUAeoAHHw,19,66,29,24,10,0,15,0,144,20.571428571428573,8,0.0,16,29,18,10,50,0,6,15,0,73,71,1
825,12580,kB76SiSV4uYN77hHUOgf3IbLpFWkgJbj,SpATywNh6bZuzm8s1ceuBUnMUAeoAHHw,32,31,18,35,10,1,15,1,111,15.857142857142858,4,0.0,6,18,30,10,25,1,5,15,1,64,47,0
826,12583,JRuzCriX6hvuTQ943ttXKlmrFVyfxMHr,SpATywNh6bZuzm8s1ceuBUnMUAeoAHHw,24,37,23,8,7,0,7,0,82,11.714285714285714,6,0.0,0,23,7,7,37,0,1,7,0,37,45,0
827,12586,jfC6fPTH59GZUrxarremx8AmMC8XNgfG,SpATywNh6bZuzm8s1ceuBUnMUAeoAHHw,26,36,22,13,9,2,3,0,85,12.142857142857142,4,0.0,7,22,13,9,29,2,0,3,0,51,34,1
828,12588,XQTN1LOe7iul8RvZ4acTOpEntRORT1SG,SpATywNh6bZuzm8s1ceuBUnMUAeoAHHw,6,6,0,0,0,0,3,0,9,1.2857142857142858,2,0.0,2,0,0,0,4,0,0,3,0,2,7,1
829,12597,R8tAdEYq32rVkLXscE5SipLgbsEEPIk8,bWdj2GDclj5ofokWjzoa5jAwMkxCykd6,1,0,0,0,0,0,2,0,2,0.2857142857142857,1,0.0,0,0,0,0,0,0,0,2,0,0,2,1
830,12600,NO22WSq5lVGwq6WPEcqalEaMjYIZxX3u,bWdj2GDclj5ofokWjzoa5jAwMkxCykd6,10,27,0,9,1,0,10,0,47,6.714285714285714,3,0.0,13,0,8,1,14,0,1,10,0,22,25,1
831,12616,gLKRPeA7yYfxDrcYMLyblT6wVEjgwKPH,SpATywNh6bZuzm8s1ceuBUnMUAeoAHHw,32,48,23,16,14,5,8,1,115,16.428571428571427,3,0.0,9,23,14,14,39,5,2,8,1,60,55,0
832,12620,LxV8BE7SALs1WsK81jAFnmtwnc7yS8ck,G8EPVSXsOYB5YQWZGiz1aVq5Pgr2GrQu,8,7,3,0,3,0,3,0,16,2.2857142857142856,1,0.0,2,3,0,3,5,0,0,3,0,8,8,1
833,12626,NSkQyRZ5kDInEI8yx5AGmbuyJ28eG48A,SpATywNh6bZuzm8s1ceuBUnMUAeoAHHw,31,38,21,24,10,5,10,0,108,15.428571428571429,3,0.0,5,21,19,10,33,5,5,10,0,55,53,0
834,12633,8DlfU1bgriTJuUO8vI8x268Lnn7yRdfp,A3fsA9Zfv1X2fVEQhTw51lKENdNrEqT3,5,2,1,0,1,4,6,0,14,2.0,2,0.0,0,1,0,1,2,4,0,6,0,2,12,1
835,12649,TexDHGk8F5I6X0NlqVQwzJ9MMWpLdMbB,SpATywNh6bZuzm8s1ceuBUnMUAeoAHHw,30,41,19,35,8,6,8,1,118,16.857142857142858,4,0.0,13,19,27,8,28,6,8,8,1,67,51,0
836,12667,h1g6Jk0YES6cZKnPtmszwjPCneFTGd3j,bWdj2GDclj5ofokWjzoa5jAwMkxCykd6,13,12,8,0,6,18,11,1,56,8.0,2,0.0,0,8,0,6,12,18,0,11,1,14,42,1
837,12682,I19aG6zmdTntoy0T8VxEogbN4WVEZZNa,SpATywNh6bZuzm8s1ceuBUnMUAeoAHHw,5,5,1,0,0,0,2,0,8,1.1428571428571428,1,0.0,2,1,0,0,3,0,0,2,0,3,5,1
838,12689,1Ld3jQU8M0eiaLBshs8gjcgQEfdlgHyZ,RXDvfPUBYFlVdlueBFbLW0mhhAyGEqpt,30,21,15,0,12,0,4,0,52,7.428571428571429,3,0.0,2,15,0,12,19,0,0,4,0,29,23,1
839,12707,Hr9mm3bIoeLv4wyDeAcwJNdd3K6mgRy4,SpATywNh6bZuzm8s1ceuBUnMUAeoAHHw,30,39,22,26,8,3,8,0,106,15.142857142857142,2,0.0,9,22,25,8,30,3,1,8,0,64,42,0
840,12711,rDEv38jBkahw1DC082iTP7UbA4sE1KaP,SpATywNh6bZuzm8s1ceuBUnMUAeoAHHw,13,9,1,17,1,0,3,0,31,4.428571428571429,1,0.0,2,1,15,1,7,0,2,3,0,19,12,0
841,12726,bQve3ajdEL4IqADUWqNBP99IoqvejzJV,A3fsA9Zfv1X2fVEQhTw51lKENdNrEqT3,6,3,0,0,0,4,8,1,16,2.2857142857142856,2,0.0,0,0,0,0,3,4,0,8,1,0,16,1
842,12735,KBt3gvTJLTIjt4EkmG3y3LICooEML1xW,G8EPVSXsOYB5YQWZGiz1aVq5Pgr2GrQu,6,5,2,0,2,0,6,0,15,2.142857142857143,3,0.0,0,2,0,2,5,0,0,6,0,4,11,1
843,12742,arTGhRrKZksM4iY72XDJ8i8oBmMABS0m,SpATywNh6bZuzm8s1ceuBUnMUAeoAHHw,26,63,7,7,2,75,19,1,174,24.857142857142858,7,0.0,15,7,7,2,48,75,0,19,1,31,143,0
844,12745,rRt0QHymEdl6Kph5VPgdVUvepB7ZBNXt,SpATywNh6bZuzm8s1ceuBUnMUAeoAHHw,20,52,20,14,8,2,17,0,113,16.142857142857142,5,0.0,6,20,13,8,46,2,1,17,0,47,66,0
845,12750,i67qzouvUD7nINgK6d1xrH4pvufZqbFd,SpATywNh6bZuzm8s1ceuBUnMUAeoAHHw,21,38,1,27,0,4,7,0,77,11.0,4,0.0,7,1,25,0,31,4,2,7,0,33,44,0
846,12753,79Po0Awyh8Z7ruF9y6agajWClv9uUoPL,SpATywNh6bZuzm8s1ceuBUnMUAeoAHHw,11,59,0,0,1,6,14,1,81,11.571428571428571,3,0.0,2,0,0,1,57,6,0,14,1,3,78,1
847,12761,rtYqtRTnqUXb6diSp0MKjdA0eLt2BJ3X,SpATywNh6bZuzm8s1ceuBUnMUAeoAHHw,19,30,14,17,4,20,11,0,96,13.714285714285714,3,0.0,8,14,15,4,22,20,2,11,0,41,55,0
848,12768,ghgdA2SJuIXQM23Hgf4BrlUd29ois5mW,SpATywNh6bZuzm8s1ceuBUnMUAeoAHHw,14,19,1,12,1,6,5,0,44,6.285714285714286,2,0.0,6,1,11,1,13,6,1,5,0,19,25,1
849,12784,rZSLmwiYX8trzeLsBLeg8r0IN1GBbqOC,bWdj2GDclj5ofokWjzoa5jAwMkxCykd6,1,0,0,0,0,0,1,0,1,0.14285714285714285,1,0.0,0,0,0,0,0,0,0,1,0,0,1,1
850,12796,P5jfghvfecmYY6IMTqwwXqe4o108QRc4,SpATywNh6bZuzm8s1ceuBUnMUAeoAHHw,18,11,9,0,8,0,4,0,32,4.571428571428571,3,0.0,0,9,0,8,11,0,0,4,0,17,15,1
851,12805,P0uW8e7uWJsgVO5MWg1krlEvXljM181Y,G8EPVSXsOYB5YQWZGiz1aVq5Pgr2GrQu,1,0,0,0,0,0,4,0,4,0.5714285714285714,3,0.0,0,0,0,0,0,0,0,4,0,0,4,1
852,12808,idxWUfEs3kYL0r7IC35umYY3ZJQ22Zab,SpATywNh6bZuzm8s1ceuBUnMUAeoAHHw,6,9,4,0,2,0,3,0,18,2.5714285714285716,2,0.0,0,4,0,2,9,0,0,3,0,6,12,1
853,12813,L3khlyhxkzKPVeEgnV2Dt5jl6Pe5Thm4,RXDvfPUBYFlVdlueBFbLW0mhhAyGEqpt,20,27,17,25,9,1,8,0,87,12.428571428571429,4,0.0,8,17,22,9,19,1,3,8,0,56,31,1
854,12834,ZYxocA1Ix9ILa1C9VKK1bM1W4sEOXUVw,SpATywNh6bZuzm8s1ceuBUnMUAeoAHHw,19,25,0,29,0,0,7,0,61,8.714285714285714,3,0.0,12,0,28,0,13,0,1,7,0,40,21,0
855,12845,syrttArug8Mpzs9L0IHsvBtATawYF9J2,SpATywNh6bZuzm8s1ceuBUnMUAeoAHHw,8,8,5,0,2,0,4,0,19,2.7142857142857144,4,0.0,0,5,0,2,8,0,0,4,0,7,12,1
856,12853,55dttExESw0iXI74tkLBOaeITFkRCx90,A3fsA9Zfv1X2fVEQhTw51lKENdNrEqT3,42,39,21,58,8,2,15,1,144,20.571428571428573,3,0.0,1,21,48,8,38,2,10,15,1,78,66,1
857,12854,cVHCYdG6eoXKQe55dLZbvLgwBGbWam7p,A3fsA9Zfv1X2fVEQhTw51lKENdNrEqT3,11,11,2,0,1,0,6,0,20,2.857142857142857,3,0.0,0,2,0,1,11,0,0,6,0,3,17,1
858,12856,0wSRq6mRtt7ajwm8CWZxYMig1mbMrg7d,bWdj2GDclj5ofokWjzoa5jAwMkxCykd6,1,0,0,0,0,0,1,0,1,0.14285714285714285,1,0.0,0,0,0,0,0,0,0,1,0,0,1,1
859,12883,KKz5C2CIERGp4d0g7P8ZO1hnR4NT39t2,SpATywNh6bZuzm8s1ceuBUnMUAeoAHHw,30,34,21,20,12,9,6,0,102,14.571428571428571,3,0.0,7,21,16,12,27,9,4,6,0,56,46,0
860,12888,lMy0A59BRo4770ALzvOjsBS5HJkCRV78,A3fsA9Zfv1X2fVEQhTw51lKENdNrEqT3,43,66,11,50,3,27,48,2,207,29.571428571428573,9,0.0,4,11,48,3,62,27,2,48,2,66,141,1
861,12892,P0uW8e7uWJsgVO5MWg1krlEvXljM181Y,bWdj2GDclj5ofokWjzoa5jAwMkxCykd6,11,10,3,8,2,0,7,0,30,4.285714285714286,2,0.0,1,3,7,2,9,0,1,7,0,13,17,1
862,12948,f7pgA2Hp0s8DkqzKuvE0Kw8QRuoBh3Zv,A3fsA9Zfv1X2fVEQhTw51lKENdNrEqT3,41,16,9,93,1,17,8,0,144,20.571428571428573,3,0.0,1,9,82,1,15,17,11,8,0,93,51,0
863,12956,lEIFkqeT396JMSPUyiaHNMN8g7bQ1x9p,SpATywNh6bZuzm8s1ceuBUnMUAeoAHHw,30,70,31,18,19,5,21,1,165,23.571428571428573,5,0.0,38,31,17,19,32,5,1,21,1,105,60,0
864,12976,KpbHdGVlZIWVraCiFee7Cav2rNnqqrsJ,SpATywNh6bZuzm8s1ceuBUnMUAeoAHHw,27,29,20,20,13,7,5,0,94,13.428571428571429,2,0.0,4,20,20,13,25,7,0,5,0,57,37,1
865,12993,8r4M2l7ATXMXEQUCAknekZVeyUGIpRyK,SpATywNh6bZuzm8s1ceuBUnMUAeoAHHw,18,76,8,15,5,2,37,0,143,20.428571428571427,8,0.0,8,8,12,5,68,2,3,37,0,33,110,1
866,13011,3Eee8QbVtHhcwedqstQME1x67jOdVLkK,SpATywNh6bZuzm8s1ceuBUnMUAeoAHHw,5,3,0,0,0,1,4,3,11,1.5714285714285714,1,0.0,0,0,0,0,3,1,0,4,3,0,11,1
867,13023,MAktGJIumyskhJp25e79u9tVhauVJ2c6,SpATywNh6bZuzm8s1ceuBUnMUAeoAHHw,31,37,18,36,11,43,19,1,165,23.571428571428573,4,0.0,10,18,30,11,27,43,6,19,1,69,96,0
868,13088,AbunVo6pGQTlDxnSJmOS7flQ0Vb2S3xP,bWdj2GDclj5ofokWjzoa5jAwMkxCykd6,13,13,5,18,3,6,12,1,58,8.285714285714286,2,0.0,4,5,18,3,9,6,0,12,1,30,28,1
869,13109,YW2vWUP3xrebFWQq20TaENvqpb9ZdJV6,SpATywNh6bZuzm8s1ceuBUnMUAeoAHHw,28,27,13,26,7,5,17,1,96,13.714285714285714,4,0.0,4,13,22,7,23,5,4,17,1,46,50,0
870,13129,AbunVo6pGQTlDxnSJmOS7flQ0Vb2S3xP,A3fsA9Zfv1X2fVEQhTw51lKENdNrEqT3,1,0,0,0,0,0,3,0,3,0.42857142857142855,2,0.0,0,0,0,0,0,0,0,3,0,0,3,1
871,13135,nF3fyodzvP9Kt8uvHxBDafFDSHuZ38jd,SpATywNh6bZuzm8s1ceuBUnMUAeoAHHw,30,75,13,38,10,50,23,4,213,30.428571428571427,5,0.0,8,13,31,10,67,50,7,23,4,62,151,1
872,13143,igeK6rUQT7Ehyj7yY5oAEj8DvOITiuBO,SpATywNh6bZuzm8s1ceuBUnMUAeoAHHw,29,61,28,35,11,5,15,0,155,22.142857142857142,7,0.0,18,28,30,11,43,5,5,15,0,87,68,0
873,13147,p9Pgf9XUtcr2kL39MqLlMakadbFqlUtX,RXDvfPUBYFlVdlueBFbLW0mhhAyGEqpt,14,45,31,0,13,9,16,2,116,16.571428571428573,5,0.0,2,31,0,13,43,9,0,16,2,46,70,1
874,13159,gMZKWOenFyVb6m3mcpDQmzDRcu1zvYbF,G8EPVSXsOYB5YQWZGiz1aVq5Pgr2GrQu,12,21,8,50,5,0,9,0,93,13.285714285714286,3,0.0,6,8,47,5,15,0,3,9,0,66,27,1
875,13179,pOKZyBql9SdI7DoREUHq99ghEycAS0cI,bWdj2GDclj5ofokWjzoa5jAwMkxCykd6,4,2,0,0,1,0,1,0,4,0.5714285714285714,1,0.0,0,0,0,1,2,0,0,1,0,1,3,1
876,13187,i67qzouvUD7nINgK6d1xrH4pvufZqbFd,bWdj2GDclj5ofokWjzoa5jAwMkxCykd6,3,2,0,0,0,0,3,0,5,0.7142857142857143,1,0.0,0,0,0,0,2,0,0,3,0,0,5,1
877,13206,GSkYUOcl4XzYMWSWhE6gXRGQ9kqPeXsi,RXDvfPUBYFlVdlueBFbLW0mhhAyGEqpt,50,35,20,84,11,0,7,0,157,22.428571428571427,5,0.0,8,20,82,11,27,0,2,7,0,121,36,1
878,13207,PMDa1SUjeddLyhfDscbnAxL67GyZb6sD,SpATywNh6bZuzm8s1ceuBUnMUAeoAHHw,20,45,20,16,1,13,11,0,106,15.142857142857142,6,0.0,3,20,16,1,42,13,0,11,0,40,66,0
879,13212,pR0rEzd43YPn1ujQN1oHxqL0z3U4G8ju,SpATywNh6bZuzm8s1ceuBUnMUAeoAHHw,7,6,1,0,1,0,3,0,11,1.5714285714285714,2,0.0,2,1,0,1,4,0,0,3,0,4,7,1
880,13214,XFmrH2WQYMYLXRE1Jm7VValFt236PUJr,SpATywNh6bZuzm8s1ceuBUnMUAeoAHHw,22,24,1,24,1,0,3,0,53,7.571428571428571,2,0.0,8,1,20,1,16,0,4,3,0,30,23,1
881,13227,0wJhtCWK60WPCeRF62m8T80DtNpWhRrg,RXDvfPUBYFlVdlueBFbLW0mhhAyGEqpt,46,44,20,98,11,0,5,0,178,25.428571428571427,4,0.0,9,20,94,11,35,0,4,5,0,134,44,0
882,13233,UM3F51S6vWhAORUn5XfgddMSa2NpuDR3,bWdj2GDclj5ofokWjzoa5jAwMkxCykd6,5,4,1,0,1,0,3,0,9,1.2857142857142858,2,0.0,0,1,0,1,4,0,0,3,0,2,7,1
883,13240,m52orXncJIuZMWO7LnwS1hFqDU5X5m24,SpATywNh6bZuzm8s1ceuBUnMUAeoAHHw,29,37,9,49,5,38,20,2,160,22.857142857142858,5,0.0,16,9,40,5,21,38,9,20,2,70,90,0
884,13259,KovPBJesZmgqVCWR3DXdtvcd4XyHL9BT,SpATywNh6bZuzm8s1ceuBUnMUAeoAHHw,21,35,4,25,3,36,18,7,128,18.285714285714285,4,0.0,11,4,20,3,24,36,5,18,7,38,90,0
885,13263,CZ6gFOo6OnSPq5AGDZTDmf17XM8Rum8M,SpATywNh6bZuzm8s1ceuBUnMUAeoAHHw,10,8,0,11,0,0,3,0,22,3.142857142857143,1,0.0,3,0,10,0,5,0,1,3,0,13,9,1
886,13273,bKbwS8bsj3eNxoCQcsrg5SKpHAoJ8uGu,A3fsA9Zfv1X2fVEQhTw51lKENdNrEqT3,49,42,2,148,0,8,12,0,212,30.285714285714285,5,0.0,11,2,120,0,31,8,28,12,0,133,79,1
887,13290,bDOMCQV7nFdKo0pDqOPr3ECLpgkdBCSt,A3fsA9Zfv1X2fVEQhTw51lKENdNrEqT3,34,67,4,38,2,1,10,0,122,17.428571428571427,3,0.0,2,4,35,2,65,1,3,10,0,43,79,1
888,13316,7P8eMWaZZgnw2duzHVId8BVYAnTZapE1,SpATywNh6bZuzm8s1ceuBUnMUAeoAHHw,8,4,2,0,2,0,8,0,16,2.2857142857142856,1,0.0,0,2,0,2,4,0,0,8,0,4,12,1
889,13319,sqZsZQq9LcjzbfCPmehLyMMrK3ClcYAT,SpATywNh6bZuzm8s1ceuBUnMUAeoAHHw,3,2,0,0,0,0,1,0,3,0.42857142857142855,1,0.0,0,0,0,0,2,0,0,1,0,0,3,1
890,13338,UidTeyEs50r1zTQVJtstLvLcMUKrNN3b,SpATywNh6bZuzm8s1ceuBUnMUAeoAHHw,13,20,1,6,0,2,9,1,39,5.571428571428571,3,0.0,9,1,6,0,11,2,0,9,1,16,23,0
891,13358,Aw7PeIkLW9CDHbPpPSjrFUdtBaUuHUXm,bWdj2GDclj5ofokWjzoa5jAwMkxCykd6,37,90,33,124,8,95,82,5,437,62.42857142857143,9,0.0,36,33,107,8,54,95,17,82,5,184,253,0
892,13379,TGngiWN6RHpSD048KJCksxngjFh0emXm,A3fsA9Zfv1X2fVEQhTw51lKENdNrEqT3,7,6,1,0,1,0,3,0,11,1.5714285714285714,1,0.0,0,1,0,1,6,0,0,3,0,2,9,1
893,13386,5KSMnQXKnbRqNWod4v539vcEvMedku3c,bWdj2GDclj5ofokWjzoa5jAwMkxCykd6,2,0,0,0,0,0,2,0,2,0.2857142857142857,1,0.0,0,0,0,0,0,0,0,2,0,0,2,1
894,13398,bqWpav7ocOhCfb3xc4QgAvBDK5g8BmiZ,SpATywNh6bZuzm8s1ceuBUnMUAeoAHHw,18,42,23,12,4,55,18,1,155,22.142857142857142,6,0.0,10,23,9,4,32,55,3,18,1,46,109,0
895,13402,mGb99e4ZiyyEapZp3B98Pssar5eWGHEz,G8EPVSXsOYB5YQWZGiz1aVq5Pgr2GrQu,17,19,2,30,2,0,5,0,58,8.285714285714286,3,0.0,3,2,24,2,16,0,6,5,0,31,27,1
896,13424,PfZH4Yubwsve9DvShzAvHjayDN16nhpN,G8EPVSXsOYB5YQWZGiz1aVq5Pgr2GrQu,1,0,0,0,0,0,1,0,1,0.14285714285714285,1,0.0,0,0,0,0,0,0,0,1,0,0,1,1
897,13430,j0gxXks7DZitzyeEGG2agLKFp30HqXVu,bWdj2GDclj5ofokWjzoa5jAwMkxCykd6,14,61,22,0,5,16,22,2,128,18.285714285714285,4,0.0,14,22,0,5,47,16,0,22,2,41,87,0
898,13460,mG2HKIW4KvK5MNtCekVvEvxXHT51PCPq,A3fsA9Zfv1X2fVEQhTw51lKENdNrEqT3,1,0,0,0,0,0,1,0,1,0.14285714285714285,1,0.0,0,0,0,0,0,0,0,1,0,0,1,1
899,13469,OLmaTq1VRWq8uhF6WwamKt59rXmIqMgh,SpATywNh6bZuzm8s1ceuBUnMUAeoAHHw,11,14,7,0,4,4,11,0,40,5.714285714285714,3,0.0,0,7,0,4,14,4,0,11,0,11,29,1
900,13477,9pzI899XVNJmMa8xv35JoCa2P4C0Faa4,bWdj2GDclj5ofokWjzoa5jAwMkxCykd6,14,31,3,0,2,39,13,1,89,12.714285714285714,2,0.0,0,3,0,2,31,39,0,13,1,5,84,1
901,13479,sfuANiSFq72qS7aoKnyvPaRtXw7bLFiY,SpATywNh6bZuzm8s1ceuBUnMUAeoAHHw,17,25,11,10,5,0,6,0,57,8.142857142857142,5,0.0,4,11,10,5,21,0,0,6,0,30,27,1
902,13490,RtDHl5nE4LpZJE4fPWaXYE5l5ziJJw3q,SpATywNh6bZuzm8s1ceuBUnMUAeoAHHw,6,7,3,0,3,0,1,0,14,2.0,1,0.0,0,3,0,3,7,0,0,1,0,6,8,1
903,13491,KKBYOCb35hszQy5vSfsxbAFYFgilEECF,SpATywNh6bZuzm8s1ceuBUnMUAeoAHHw,22,17,11,18,5,0,14,0,65,9.285714285714286,6,0.0,6,11,18,5,11,0,0,14,0,40,25,1
904,13518,OcFLLEI56U80V98vNeJ7LrlE5FWxkkpp,SpATywNh6bZuzm8s1ceuBUnMUAeoAHHw,30,53,24,23,12,35,22,2,171,24.428571428571427,5,0.0,13,24,22,12,40,35,1,22,2,71,100,0
905,13525,J1f9rNzR7t1WQhWY7vU0QrkaWuS9xCeR,bWdj2GDclj5ofokWjzoa5jAwMkxCykd6,23,17,10,48,8,27,31,1,142,20.285714285714285,4,0.0,5,10,44,8,12,27,4,31,1,67,75,1
906,13530,7dPYuxC1NExRQjXFHnhWbTviIyBFUDmL,SpATywNh6bZuzm8s1ceuBUnMUAeoAHHw,5,19,13,0,1,0,2,0,35,5.0,14,0.0,0,13,0,1,19,0,0,2,0,14,21,1
907,13537,LDoffeIzXBaEA3EoYd9Gp4Kl36LUuUJD,SpATywNh6bZuzm8s1ceuBUnMUAeoAHHw,10,12,6,0,1,17,10,4,50,7.142857142857143,3,0.0,0,6,0,1,12,17,0,10,4,7,43,1
908,13552,IGnubmoC2Z3kyMhnm5cfb5h7HnKkMEVq,G8EPVSXsOYB5YQWZGiz1aVq5Pgr2GrQu,6,6,2,0,1,3,7,0,19,2.7142857142857144,2,0.0,0,2,0,1,6,3,0,7,0,3,16,1
909,13578,7XgWWxsOrwxcFjioh5NncRGrx77dSS5r,SpATywNh6bZuzm8s1ceuBUnMUAeoAHHw,23,43,1,21,1,1,11,0,78,11.142857142857142,4,0.0,9,1,19,1,34,1,2,11,0,30,48,0
910,13583,UmlMF2TsgsipXk92JRV0A7TQAmCZuKWV,SpATywNh6bZuzm8s1ceuBUnMUAeoAHHw,6,4,1,0,0,0,2,0,7,1.0,1,0.0,0,1,0,0,4,0,0,2,0,1,6,1
911,13587,zFEKyzORyNtVsN87mi1ReZjFEUKvm21T,SpATywNh6bZuzm8s1ceuBUnMUAeoAHHw,25,32,19,12,9,9,6,2,89,12.714285714285714,3,0.0,3,19,10,9,29,9,2,6,2,41,48,1
912,13594,sZYvW7O1yC1PAj5iYABgZ056jCM2PsNq,SpATywNh6bZuzm8s1ceuBUnMUAeoAHHw,13,30,16,4,6,0,6,0,62,8.857142857142858,4,0.0,9,16,4,6,21,0,0,6,0,35,27,0
913,13605,g2crr0D1YRZspeg3aG0QVrkBBPBltTjz,SpATywNh6bZuzm8s1ceuBUnMUAeoAHHw,12,19,3,19,1,0,2,0,44,6.285714285714286,3,0.0,9,3,16,1,10,0,3,2,0,29,15,0
914,13610,r10mjNLAOjkXo9ipKqWrD4Hts48L6lcD,G8EPVSXsOYB5YQWZGiz1aVq5Pgr2GrQu,45,19,15,134,12,0,3,0,183,26.142857142857142,1,0.0,0,15,113,12,19,0,21,3,0,140,43,0
915,13672,kP6GmMO1OBG46GzGpGgNEkhdNz0eN2Yt,SpATywNh6bZuzm8s1ceuBUnMUAeoAHHw,1,0,0,0,0,0,1,0,1,0.14285714285714285,1,0.0,0,0,0,0,0,0,0,1,0,0,1,1
916,13684,XkKS323fFxBVezQ5JyIgzxHDxEKEwwEf,A3fsA9Zfv1X2fVEQhTw51lKENdNrEqT3,18,14,9,10,5,3,5,0,46,6.571428571428571,2,0.0,1,9,10,5,13,3,0,5,0,25,21,0
917,13696,r0yAsNzYkqEPYi6zNhQfzuueDjmcyFRr,bWdj2GDclj5ofokWjzoa5jAwMkxCykd6,2,0,0,0,0,0,3,0,3,0.42857142857142855,1,0.0,0,0,0,0,0,0,0,3,0,0,3,1
918,13703,FaZLW3HiYLflnTCxi4BN21oHHvNYhtue,SpATywNh6bZuzm8s1ceuBUnMUAeoAHHw,20,46,22,18,6,1,13,0,106,15.142857142857142,10,0.0,9,22,15,6,37,1,3,13,0,52,54,1
919,13711,H2Rgqo3kRDsNdbNVEDl0788s9SSdLM8P,bWdj2GDclj5ofokWjzoa5jAwMkxCykd6,6,5,2,0,2,0,4,0,13,1.8571428571428572,3,0.0,0,2,0,2,5,0,0,4,0,4,9,1
920,13714,e4xoItGqdt7VvYzxou1Pv23rnKAXXXsC,SpATywNh6bZuzm8s1ceuBUnMUAeoAHHw,18,31,4,9,3,6,13,2,68,9.714285714285714,3,0.0,7,4,8,3,24,6,1,13,2,22,46,1
921,13720,9JsNhrsWtCheE46kbgKiC6TCsPPGBSze,SpATywNh6bZuzm8s1ceuBUnMUAeoAHHw,19,34,19,9,6,4,7,0,79,11.285714285714286,3,0.0,7,19,9,6,27,4,0,7,0,41,38,1
922,13750,6UfeuZvS7L15CgcbiecsOUDWQezuLDJz,SpATywNh6bZuzm8s1ceuBUnMUAeoAHHw,1,0,0,0,0,0,1,0,1,0.14285714285714285,1,0.0,0,0,0,0,0,0,0,1,0,0,1,1
923,13751,wfHTtk8oy0CiP4p3waBMhlIvxeVIbZqk,SpATywNh6bZuzm8s1ceuBUnMUAeoAHHw,29,50,16,15,7,8,26,0,122,17.428571428571427,7,0.0,8,16,15,7,42,8,0,26,0,46,76,0
924,13758,Pt4CHQaH2Lj9ri6xbjrkQ0IBNpZPKhdM,SpATywNh6bZuzm8s1ceuBUnMUAeoAHHw,2,0,0,0,0,0,2,0,2,0.2857142857142857,1,0.0,0,0,0,0,0,0,0,2,0,0,2,1
925,13764,fdJXQSSucuzaRljy096jXgInnW2TakHQ,SpATywNh6bZuzm8s1ceuBUnMUAeoAHHw,29,84,48,33,11,39,24,2,241,34.42857142857143,7,0.0,16,48,27,11,68,39,6,24,2,102,139,0
926,13780,EikisME12XnhqTfgnKK3O8hmfAWTmSd3,G8EPVSXsOYB5YQWZGiz1aVq5Pgr2GrQu,54,50,21,126,13,4,16,1,231,33.0,5,0.0,10,21,107,13,40,4,19,16,1,151,80,0
927,13788,xYZJv26kEF7oZiNSoEZMnXHo33iYNlMJ,A3fsA9Zfv1X2fVEQhTw51lKENdNrEqT3,30,15,7,62,2,2,7,1,96,13.714285714285714,3,0.0,2,7,55,2,13,2,7,7,1,66,30,1
928,14683,EK8cH2rqaeWCMjTFz8xL65N7r32HerY9,7GRhBDsirIGkRZBtSMEzNTyDr2JQm4xx,69,152,54,101,28,142,36,4,517,73.85714285714286,11,0.0,67,54,85,28,85,142,16,36,4,234,283,0
929,14690,ZbWUV0qkotaaSLhz8iJBNOk5nD7qDeuY,7GRhBDsirIGkRZBtSMEzNTyDr2JQm4xx,23,41,24,0,25,0,7,0,97,13.857142857142858,2,0.0,11,24,0,25,30,0,0,7,0,60,37,0
930,14815,IQhh6lXlVmCrcAcXbMrK8pYs2wjQgUqq,7GRhBDsirIGkRZBtSMEzNTyDr2JQm4xx,4,1,1,0,0,155,5,0,162,23.142857142857142,3,0.0,0,1,0,0,1,155,0,5,0,1,161,0
931,14818,UgETwjVUoQXyxwFA12B4jwRDb3R4sQSN,7GRhBDsirIGkRZBtSMEzNTyDr2JQm4xx,55,108,47,119,35,1,20,0,330,47.142857142857146,9,0.0,49,47,107,35,59,1,12,20,0,238,92,1
932,14829,QZIRHdwFgibI2SBehTrmLAZxED1F4JL7,7GRhBDsirIGkRZBtSMEzNTyDr2JQm4xx,9,9,4,0,3,0,2,0,18,2.5714285714285716,2,0.0,0,4,0,3,9,0,0,2,0,7,11,1
933,14836,lEIFkqeT396JMSPUyiaHNMN8g7bQ1x9p,7GRhBDsirIGkRZBtSMEzNTyDr2JQm4xx,6,1,1,0,1,0,3,0,6,0.8571428571428571,1,0.0,0,1,0,1,1,0,0,3,0,2,4,1
934,14837,CEMMuEEc653PcYnJ6cnr3jxrYZv9f8D1,7GRhBDsirIGkRZBtSMEzNTyDr2JQm4xx,1,0,0,0,0,0,1,0,1,0.14285714285714285,1,0.0,0,0,0,0,0,0,0,1,0,0,1,1
935,14846,5Xet5BwM6xDYh8pbaupnwmiq9T6jy7TC,7GRhBDsirIGkRZBtSMEzNTyDr2JQm4xx,47,62,18,73,21,23,17,0,214,30.571428571428573,4,0.0,44,18,62,21,18,23,11,17,0,145,69,1
936,14851,SDvatKCgfdtv12UzJLxR0GYxgD4pUkgT,7GRhBDsirIGkRZBtSMEzNTyDr2JQm4xx,24,37,14,36,4,5,9,0,105,15.0,4,0.0,16,14,31,4,21,5,5,9,0,65,40,1
937,14873,vJOKvfBreLyHqbEVMHx8ymKhM8KWKMc3,7GRhBDsirIGkRZBtSMEzNTyDr2JQm4xx,1,0,0,0,0,0,1,0,1,0.14285714285714285,1,0.0,0,0,0,0,0,0,0,1,0,0,1,1
938,14944,g4UocDcFYSnUbOlhUZMBUfqXzzGSRrqN,7GRhBDsirIGkRZBtSMEzNTyDr2JQm4xx,1,0,0,0,0,0,1,0,1,0.14285714285714285,1,0.0,0,0,0,0,0,0,0,1,0,0,1,1
939,14990,5VgPwWusKQIJc1LutXp6JyAv3fzKgfIX,7GRhBDsirIGkRZBtSMEzNTyDr2JQm4xx,43,79,33,45,30,1,10,0,198,28.285714285714285,6,0.0,38,33,42,30,41,1,3,10,0,143,55,1
940,15016,yZ9FndAKqVsKwZtO1B2JJJblefdbhZ02,7GRhBDsirIGkRZBtSMEzNTyDr2JQm4xx,33,38,11,52,14,18,18,0,151,21.571428571428573,5,0.0,26,11,52,14,12,18,0,18,0,103,48,1
941,15017,Qp9WPjKz2PASr9CWx9cGEYZGKd1Nemqr,7GRhBDsirIGkRZBtSMEzNTyDr2JQm4xx,11,15,6,0,5,1,15,0,42,6.0,1,0.0,4,6,0,5,11,1,0,15,0,15,27,1
942,15107,HFGNqnAY2MWiYF3III5EKx6o7tu1uiwJ,7GRhBDsirIGkRZBtSMEzNTyDr2JQm4xx,62,170,71,158,30,63,29,1,522,74.57142857142857,10,0.0,62,71,133,30,108,63,25,29,1,296,226,1
943,15110,5zX31TZPkBQ4nxGKP7lPYFABTGNW6PHa,7GRhBDsirIGkRZBtSMEzNTyDr2JQm4xx,1,0,0,0,0,0,1,0,1,0.14285714285714285,1,0.0,0,0,0,0,0,0,0,1,0,0,1,1
944,15132,uOfATV0WsL0BPHDdVyS70rl0sYjdudpd,7GRhBDsirIGkRZBtSMEzNTyDr2JQm4xx,19,20,9,0,7,0,3,0,39,5.571428571428571,2,0.0,9,9,0,7,11,0,0,3,0,25,14,1
945,15164,ziRAzdRuzlLfb854mAvEaRYGuXqnCERH,7GRhBDsirIGkRZBtSMEzNTyDr2JQm4xx,59,153,48,132,19,7,26,0,385,55.0,5,0.0,85,48,109,19,68,7,23,26,0,261,124,0
946,15178,28PHU9suTM8EqUKsQwsvQ03DzFXi0yDl,7GRhBDsirIGkRZBtSMEzNTyDr2JQm4xx,9,16,7,2,4,0,7,0,36,5.142857142857143,4,0.0,3,7,2,4,13,0,0,7,0,16,20,0
947,15282,FRiuKxH98VzIG6N65WQEkvVSqVJx6TSd,7GRhBDsirIGkRZBtSMEzNTyDr2JQm4xx,40,90,22,70,27,0,6,0,215,30.714285714285715,3,0.0,62,22,69,27,28,0,1,6,0,180,35,1
948,15318,5ApoT0ZoLbVQmiV8xOjwVDUBfTF6QDuq,7GRhBDsirIGkRZBtSMEzNTyDr2JQm4xx,25,47,19,35,15,21,23,2,162,23.142857142857142,3,0.0,23,19,29,15,24,21,6,23,2,86,76,1
949,15397,iWIAGeS3ATYiVCcaQcig63Lt0fYY4o8o,7GRhBDsirIGkRZBtSMEzNTyDr2JQm4xx,43,61,19,95,24,9,6,0,214,30.571428571428573,3,0.0,39,19,85,24,22,9,10,6,0,167,47,0
950,15445,hrmgRr5TKkTKcJMaNH4IpBZoiQT9X6aI,7GRhBDsirIGkRZBtSMEzNTyDr2JQm4xx,11,16,0,0,1,2,8,0,27,3.857142857142857,2,0.0,9,0,0,1,7,2,0,8,0,10,17,0
951,15469,udnRYxurswpE4GUZcnc80kafg0hn3fpz,7GRhBDsirIGkRZBtSMEzNTyDr2JQm4xx,6,7,2,4,1,0,1,0,15,2.142857142857143,1,0.0,1,2,3,1,6,0,1,1,0,7,8,1
952,15478,pHniYPYuaHgPmhy34oeWjiQMJE6eXmrA,7GRhBDsirIGkRZBtSMEzNTyDr2JQm4xx,1,0,0,0,0,0,1,0,1,0.14285714285714285,1,0.0,0,0,0,0,0,0,0,1,0,0,1,1
953,15484,2OBbYlHxjDvtkcifhxwhxMZlYPhEHOro,7GRhBDsirIGkRZBtSMEzNTyDr2JQm4xx,26,46,4,52,3,0,8,0,113,16.142857142857142,4,0.0,17,4,49,3,29,0,3,8,0,73,40,0
954,15541,ILkUjE8LhIAQFlZwnOqsyA4K0QvAbnzA,7GRhBDsirIGkRZBtSMEzNTyDr2JQm4xx,39,232,69,56,26,49,60,6,498,71.14285714285714,8,0.0,122,69,45,26,110,49,11,60,6,262,236,0
955,15577,WeG9Rj8lv2ekdTamRkXPOfgW6N9lzyds,7GRhBDsirIGkRZBtSMEzNTyDr2JQm4xx,39,52,18,63,12,0,9,0,154,22.0,4,0.0,25,18,57,12,27,0,6,9,0,112,42,1
956,15593,917a11esEUG2kjEBnxsgADWhvlUYEWb2,7GRhBDsirIGkRZBtSMEzNTyDr2JQm4xx,5,1,1,0,0,0,9,0,11,1.5714285714285714,2,0.0,0,1,0,0,1,0,0,9,0,1,10,1
957,15596,Jag1EXQWfAuTRiCgcVLyhRRkdOL9RtSD,7GRhBDsirIGkRZBtSMEzNTyDr2JQm4xx,36,41,20,38,9,28,27,1,164,23.428571428571427,7,0.0,12,20,37,9,29,28,1,27,1,78,86,1
958,15604,MUERAHHFAKMlIE27Ma0uSdeN9dFIyDRi,7GRhBDsirIGkRZBtSMEzNTyDr2JQm4xx,6,3,1,0,1,0,3,0,8,1.1428571428571428,2,0.0,0,1,0,1,3,0,0,3,0,2,6,1
959,15634,oco4sYAQqzdnYEwLykTSM4qmOTgkFoAN,7GRhBDsirIGkRZBtSMEzNTyDr2JQm4xx,38,39,15,46,12,11,23,1,147,21.0,4,0.0,15,15,37,12,24,11,9,23,1,79,68,0
960,15637,syrttArug8Mpzs9L0IHsvBtATawYF9J2,7GRhBDsirIGkRZBtSMEzNTyDr2JQm4xx,38,70,24,67,11,3,3,0,178,25.428571428571427,3,0.0,39,24,56,11,31,3,11,3,0,130,48,1
961,15676,fT8l2Rgir0TYnZP4X9UADbvRi0H8tycH,7GRhBDsirIGkRZBtSMEzNTyDr2JQm4xx,1,0,0,0,0,0,1,0,1,0.14285714285714285,1,0.0,0,0,0,0,0,0,0,1,0,0,1,1
962,15783,Jm4nQ05ndX10jbofbWx6S0r9VXrqia6S,7GRhBDsirIGkRZBtSMEzNTyDr2JQm4xx,28,51,21,51,11,0,9,0,143,20.428571428571427,4,0.0,20,21,45,11,31,0,6,9,0,97,46,0
963,15812,zTVBZ1zOMswSgDWxrOfzKUr5J9HO6HOE,7GRhBDsirIGkRZBtSMEzNTyDr2JQm4xx,70,174,52,152,35,5,21,0,439,62.714285714285715,5,0.0,77,52,133,35,97,5,19,21,0,297,142,1
964,15829,tD36vn1aCu8pvS184dpJPyASEvtRWzdE,7GRhBDsirIGkRZBtSMEzNTyDr2JQm4xx,35,49,20,60,16,14,5,0,164,23.428571428571427,5,0.0,22,20,53,16,27,14,7,5,0,111,53,0
965,15836,Ms0MC4W5moiGJLWP7iE3FImeH9CHN4KT,7GRhBDsirIGkRZBtSMEzNTyDr2JQm4xx,32,71,4,49,4,0,9,0,137,19.571428571428573,4,0.0,41,4,43,4,30,0,6,9,0,92,45,0
966,15867,itOUYtUQXKtiNJoDhHvixGSCtswgEapf,7GRhBDsirIGkRZBtSMEzNTyDr2JQm4xx,43,70,37,31,35,7,14,0,194,27.714285714285715,6,0.0,26,37,26,35,44,7,5,14,0,124,70,1
967,16009,Slk5JcZSYHmDLQZXaNVmcMDmjJ16kBhI,7GRhBDsirIGkRZBtSMEzNTyDr2JQm4xx,51,118,8,89,8,0,8,0,231,33.0,6,0.0,55,8,75,8,63,0,14,8,0,146,85,0
968,16016,SSM7wEvdZo8FZW0zxJcXGwdA1S6Vbn5Q,7GRhBDsirIGkRZBtSMEzNTyDr2JQm4xx,5,3,1,0,0,0,2,0,6,0.8571428571428571,1,0.0,0,1,0,0,3,0,0,2,0,1,5,1
969,16095,2WHRUx9c3z0u3SMwexxVlR2sgx8QCphl,7GRhBDsirIGkRZBtSMEzNTyDr2JQm4xx,2,0,0,0,0,0,3,0,3,0.42857142857142855,2,0.0,0,0,0,0,0,0,0,3,0,0,3,1
970,16109,cmnVKDF5NlWXx0AsUNgswSBrQUc0cjpO,7GRhBDsirIGkRZBtSMEzNTyDr2JQm4xx,6,3,2,0,1,0,2,0,8,1.1428571428571428,1,0.0,0,2,0,1,3,0,0,2,0,3,5,1
971,16126,6YaJxva3ruoxqQBNg2zA6CX5WSixFgrI,7GRhBDsirIGkRZBtSMEzNTyDr2JQm4xx,33,91,22,23,13,10,3,0,162,23.142857142857142,2,0.0,51,22,23,13,40,10,0,3,0,109,53,1
972,16137,qG2WjxxVTjr5YeDGnwFvACGaHzeUu9HC,7GRhBDsirIGkRZBtSMEzNTyDr2JQm4xx,32,21,11,23,11,1,10,1,78,11.142857142857142,3,0.0,8,11,21,11,13,1,2,10,1,51,27,1
973,16217,ESzAGDiQvgaXvzXTziuj7JqXtnuQhUld,7GRhBDsirIGkRZBtSMEzNTyDr2JQm4xx,20,23,12,12,7,0,8,0,62,8.857142857142858,3,0.0,2,12,10,7,21,0,2,8,0,31,31,1
974,16222,u6EnJOtoYTYGkLQOUZyVf756OPCxjorW,7GRhBDsirIGkRZBtSMEzNTyDr2JQm4xx,2,0,0,0,0,0,2,0,2,0.2857142857142857,1,0.0,0,0,0,0,0,0,0,2,0,0,2,1
975,16235,fV5QpAWiywuCcKLCcDbuJBbZ43MyivgG,7GRhBDsirIGkRZBtSMEzNTyDr2JQm4xx,43,74,17,66,17,10,15,1,200,28.571428571428573,4,0.0,29,17,55,17,45,10,11,15,1,118,82,1
976,16242,CtBdHmlYqpaYTMEPBvno3lS1o4khTfTp,7GRhBDsirIGkRZBtSMEzNTyDr2JQm4xx,68,108,41,110,48,16,16,4,343,49.0,7,0.0,52,41,99,48,56,16,11,16,4,240,103,1
977,16326,vEWkXCfBtnzPc8huJqQsoGlEGR1bS2AS,7GRhBDsirIGkRZBtSMEzNTyDr2JQm4xx,24,66,23,52,17,9,5,0,172,24.571428571428573,3,0.0,36,23,41,17,30,9,11,5,0,117,55,1
978,16350,jPtottuCTEl2a1fB4pqDjwAHNeUWQz5o,7GRhBDsirIGkRZBtSMEzNTyDr2JQm4xx,70,155,60,108,36,12,36,4,411,58.714285714285715,5,0.0,83,60,93,36,72,12,15,36,4,272,139,0
979,16353,bONRCO0uATZ9orvOXASjWia0swY9AaMZ,7GRhBDsirIGkRZBtSMEzNTyDr2JQm4xx,62,93,23,125,20,5,6,0,272,38.857142857142854,1,0.0,37,23,102,20,56,5,23,6,0,182,90,1
980,16384,DmRnf6emOOeLa4MI9vNggFDmgXu8cRIO,7GRhBDsirIGkRZBtSMEzNTyDr2JQm4xx,50,80,31,102,28,20,21,1,283,40.42857142857143,4,0.0,40,31,86,28,40,20,16,21,1,185,98,0
981,16467,pz4WzmrapGULqEk99lfOZVzJbwiC2Cl1,7GRhBDsirIGkRZBtSMEzNTyDr2JQm4xx,50,145,2,84,8,48,15,0,302,43.142857142857146,4,0.0,59,2,78,8,86,48,6,15,0,147,155,1
982,16473,aPM6Pkx8yXzDO1Wq6YMG1wXnFkTU2WLX,7GRhBDsirIGkRZBtSMEzNTyDr2JQm4xx,40,93,16,127,13,2,2,0,253,36.142857142857146,2,0.0,37,16,118,13,56,2,9,2,0,184,69,1
983,16572,ckaBfYMRcWDmM0gkDIb3PY6kSLd0nbzq,7GRhBDsirIGkRZBtSMEzNTyDr2JQm4xx,3,0,0,0,0,0,5,0,5,0.7142857142857143,1,0.0,0,0,0,0,0,0,0,5,0,0,5,0
984,16587,3l2AMuYrLjfvMGOYSOdPeQAMIHP0QDGn,7GRhBDsirIGkRZBtSMEzNTyDr2JQm4xx,13,20,9,10,4,9,5,0,57,8.142857142857142,3,0.0,9,9,8,4,11,9,2,5,0,30,27,0
985,16638,QJSnryS3zb1gL3fTkTse6gK6PnzljUD1,7GRhBDsirIGkRZBtSMEzNTyDr2JQm4xx,14,17,1,36,1,1,1,0,57,8.142857142857142,1,0.0,9,1,33,1,8,1,3,1,0,44,13,1
986,16641,nq7nltznx1EwtcnQOuGwGVLzMwD63I5W,7GRhBDsirIGkRZBtSMEzNTyDr2JQm4xx,4,6,3,0,0,0,2,0,11,1.5714285714285714,1,0.0,1,3,0,0,5,0,0,2,0,4,7,1
987,16669,D222lqyFrC2b1DAJCNvtq2cDPE2yWdSh,7GRhBDsirIGkRZBtSMEzNTyDr2JQm4xx,42,109,42,64,28,5,16,1,265,37.857142857142854,5,0.0,41,42,59,28,68,5,5,16,1,170,95,1
988,16792,fbDgsipajp0xhHFfXN21wQyuQBNdN7hy,7GRhBDsirIGkRZBtSMEzNTyDr2JQm4xx,65,88,35,133,34,8,11,2,311,44.42857142857143,3,0.0,41,35,116,34,47,8,17,11,2,226,85,0
989,16816,clv7wTDLUGVcdBnHuGK5igxvVYbUFhfO,7GRhBDsirIGkRZBtSMEzNTyDr2JQm4xx,1,0,0,0,0,0,1,0,1,0.14285714285714285,1,0.0,0,0,0,0,0,0,0,1,0,0,1,1
990,16838,krqPTjwq96uxScwTNs38D4Dn2uZHC91r,7GRhBDsirIGkRZBtSMEzNTyDr2JQm4xx,5,3,1,0,1,0,2,0,7,1.0,1,0.0,0,1,0,1,3,0,0,2,0,2,5,1
991,16880,JxLtKAnMek98G5fWpyeTaKlh0zheuNnU,7GRhBDsirIGkRZBtSMEzNTyDr2JQm4xx,5,2,1,0,1,0,3,0,7,1.0,2,0.0,0,1,0,1,2,0,0,3,0,2,5,1
992,16987,Ar7wri6od2sIMOfx95hPmMwDttR4wtOC,7GRhBDsirIGkRZBtSMEzNTyDr2JQm4xx,48,82,29,72,25,6,11,1,226,32.285714285714285,3,0.0,42,29,63,25,40,6,9,11,1,159,67,0
993,17035,M76ofI2UJItYXeusDRswE1mzVX9YlrVW,7GRhBDsirIGkRZBtSMEzNTyDr2JQm4xx,50,110,33,194,0,2,10,0,349,49.857142857142854,3,0.0,73,33,168,0,37,2,26,10,0,274,75,1
994,17060,WX5bge9EFbPypYuObEiSD1Gyvh8Z866G,7GRhBDsirIGkRZBtSMEzNTyDr2JQm4xx,38,38,19,0,22,2,9,0,90,12.857142857142858,2,0.0,14,19,0,22,24,2,0,9,0,55,35,1
995,17088,V08OBGRnuhGVZi2iGPXN66GxN6wKZmV9,7GRhBDsirIGkRZBtSMEzNTyDr2JQm4xx,2,0,0,0,0,0,2,0,2,0.2857142857142857,1,0.0,0,0,0,0,0,0,0,2,0,0,2,1
996,17102,queJQcMYiH8jxjXTFMi1fslIxDDACkNw,7GRhBDsirIGkRZBtSMEzNTyDr2JQm4xx,26,30,13,20,9,1,12,0,85,12.142857142857142,3,0.0,12,13,17,9,18,1,3,12,0,51,34,1
997,17124,xOB7vl3l1Tpb0i0cSWni40BfJ5FBclms,7GRhBDsirIGkRZBtSMEzNTyDr2JQm4xx,43,122,18,84,11,2,49,2,288,41.142857142857146,5,0.0,38,18,72,11,84,2,12,49,2,139,149,0
998,17240,g2VgGARpgGy9rA8aDCffqfXvItMu95Qi,7GRhBDsirIGkRZBtSMEzNTyDr2JQm4xx,40,78,42,60,23,17,30,1,251,35.857142857142854,5,0.0,10,42,53,23,68,17,7,30,1,128,123,0
999,17242,OcmM4lAJy1xB9HSsEUxVtaUQ7oE5dcTp,7GRhBDsirIGkRZBtSMEzNTyDr2JQm4xx,23,37,10,30,6,0,4,0,87,12.428571428571429,4,0.0,20,10,25,6,17,0,5,4,0,61,26,0
1000,17257,E4fUiWo3de6EW3llrqGI6KBrgWgpa0OH,7GRhBDsirIGkRZBtSMEzNTyDr2JQm4xx,31,40,5,52,8,11,13,0,129,18.428571428571427,2,0.0,19,5,48,8,21,11,4,13,0,80,49,1
1001,17338,RLvXqOMggPmNW2f1XGbARyW4Nurlrkjt,7GRhBDsirIGkRZBtSMEzNTyDr2JQm4xx,4,2,0,0,0,0,3,0,5,0.7142857142857143,1,0.0,0,0,0,0,2,0,0,3,0,0,5,1
1002,17408,yV812AacRwieF2jdqr0WB58v7NmmEdx5,7GRhBDsirIGkRZBtSMEzNTyDr2JQm4xx,1,0,0,0,0,0,2,0,2,0.2857142857142857,1,0.0,0,0,0,0,0,0,0,2,0,0,2,1
1003,17485,7fC3V6ivG07wUIMOmiYFzSlyjWvbYnYf,7GRhBDsirIGkRZBtSMEzNTyDr2JQm4xx,53,93,1,195,12,11,15,0,327,46.714285714285715,5,0.0,48,1,166,12,45,11,29,15,0,227,100,0
1004,17505,X0efozcVijJghBnDtnJGbXo656NrPVoZ,7GRhBDsirIGkRZBtSMEzNTyDr2JQm4xx,2,0,0,0,0,0,2,0,2,0.2857142857142857,1,0.0,0,0,0,0,0,0,0,2,0,0,2,1
1005,17545,DGDF7EtBLvOTcfUxrOsvdCg2Ar6LlSc6,7GRhBDsirIGkRZBtSMEzNTyDr2JQm4xx,21,87,34,0,1,0,10,0,132,18.857142857142858,5,0.0,9,34,0,1,78,0,0,10,0,44,88,0
1006,17634,UA8vU3s92g3lXc62U363PEO0xor6Mpeg,7GRhBDsirIGkRZBtSMEzNTyDr2JQm4xx,34,35,16,0,19,0,5,0,75,10.714285714285714,5,0.0,12,16,0,19,23,0,0,5,0,47,28,0
1007,17673,JSViK46d91E9ikMcvKp1rzZlHAqQuH4h,7GRhBDsirIGkRZBtSMEzNTyDr2JQm4xx,4,5,2,0,0,0,1,0,8,1.1428571428571428,1,0.0,0,2,0,0,5,0,0,1,0,2,6,1
1008,19583,EWAoo7AAzLTKxICthBrlzvoQ4jKqTV5Z,fbPkOYLVPtPgIt0MxizjfFJov3JbHyAi,3,2,0,0,0,2,1,0,5,0.7142857142857143,1,0.0,0,0,0,0,2,2,0,1,0,0,5,1
1009,19585,eUVqEtQR3HLmXjNHTc0FXKT2InqoH24Q,fbPkOYLVPtPgIt0MxizjfFJov3JbHyAi,4,7,2,0,2,0,2,0,13,1.8571428571428572,3,0.0,0,2,0,2,7,0,0,2,0,4,9,1
1010,19590,iES59bXqTODmGXmysyfu1geM8lUv5mwl,fbPkOYLVPtPgIt0MxizjfFJov3JbHyAi,7,7,2,0,2,0,8,0,19,2.7142857142857144,1,0.0,2,2,0,2,5,0,0,8,0,6,13,1
1011,19594,4x6w2QLFfXQ2dHDa4fBCOvJ1UYg7yE69,fbPkOYLVPtPgIt0MxizjfFJov3JbHyAi,11,12,6,5,3,12,13,2,53,7.571428571428571,3,0.0,1,6,4,3,11,12,1,13,2,14,39,1
1012,19596,lhkiaYX6n9dxQvsKk8vp6UZQBNlsuGnH,fbPkOYLVPtPgIt0MxizjfFJov3JbHyAi,46,126,56,63,35,113,51,1,445,63.57142857142857,5,0.0,55,56,45,35,71,113,18,51,1,191,254,0
1013,19605,BPDxtvSmkKR4nTdKjes8gGxzoOprTkK2,fbPkOYLVPtPgIt0MxizjfFJov3JbHyAi,6,2,1,0,1,2,4,1,11,1.5714285714285714,1,0.0,0,1,0,1,2,2,0,4,1,2,9,1
1014,19608,CJhqdTUUI9IhUemITUcGqZ2FNfX5tFcn,fbPkOYLVPtPgIt0MxizjfFJov3JbHyAi,3,1,0,0,0,0,2,0,3,0.42857142857142855,1,0.0,0,0,0,0,1,0,0,2,0,0,3,1
1015,19613,hPhvZr1dLTLTcIKq5t7vAfQqTozZXlRI,fbPkOYLVPtPgIt0MxizjfFJov3JbHyAi,20,12,10,0,8,0,2,0,32,4.571428571428571,2,0.0,0,10,0,8,12,0,0,2,0,18,14,1
1016,19614,3tr9vOqNQBlqx7G8lEAeoRN3dN5LTQt8,fbPkOYLVPtPgIt0MxizjfFJov3JbHyAi,6,5,3,0,2,0,3,1,14,2.0,1,0.0,0,3,0,2,5,0,0,3,1,5,9,1
1017,19618,oJ9j9ejTgKixczg3tSE8Sg8DPI7YQpJq,fbPkOYLVPtPgIt0MxizjfFJov3JbHyAi,10,17,8,0,4,14,3,0,46,6.571428571428571,2,0.0,4,8,0,4,13,14,0,3,0,16,30,0
1018,19619,BcKYeHv4ZKY4DeUPw2M71hKVyOhypokT,fbPkOYLVPtPgIt0MxizjfFJov3JbHyAi,21,28,16,0,11,16,10,1,82,11.714285714285714,2,0.0,0,16,0,11,28,16,0,10,1,27,55,1
1019,19625,TvUBYMbHTCcIGUIFw5l8y3Oo0Axsdspt,fbPkOYLVPtPgIt0MxizjfFJov3JbHyAi,19,31,24,0,15,4,7,0,81,11.571428571428571,3,0.0,0,24,0,15,31,4,0,7,0,39,42,1
1020,19628,eqpnrsO3UPO24LQNWGKYtfRd0DQ0MPDl,fbPkOYLVPtPgIt0MxizjfFJov3JbHyAi,13,18,1,9,3,18,15,1,65,9.285714285714286,2,0.0,9,1,7,3,9,18,2,15,1,20,45,1
1021,19632,QOCecwQRgvCytTVCFa2MB091bctR2VxO,fbPkOYLVPtPgIt0MxizjfFJov3JbHyAi,6,3,2,0,2,10,1,0,18,2.5714285714285716,1,0.0,0,2,0,2,3,10,0,1,0,4,14,1
1022,19635,fz559cnktTQw4xrHI1wICm1ao7bugAZA,fbPkOYLVPtPgIt0MxizjfFJov3JbHyAi,6,8,4,0,2,0,3,0,17,2.4285714285714284,2,0.0,0,4,0,2,8,0,0,3,0,6,11,1
1023,19637,8MQx62NrM26CEa5RRkhFUh36AiGGNx6S,fbPkOYLVPtPgIt0MxizjfFJov3JbHyAi,16,43,4,0,5,0,10,1,63,9.0,3,0.0,2,4,0,5,41,0,0,10,1,11,52,0
1024,19645,bazJXiq7ucQvx12BgvEogiLDadc2i22I,fbPkOYLVPtPgIt0MxizjfFJov3JbHyAi,6,6,2,0,2,0,3,0,13,1.8571428571428572,2,0.0,2,2,0,2,4,0,0,3,0,6,7,1
1025,19647,95Gw2yhEY17itkROcjsEWWGhFV0TNXNK,fbPkOYLVPtPgIt0MxizjfFJov3JbHyAi,26,36,19,14,9,11,10,0,99,14.142857142857142,2,0.0,11,19,14,9,25,11,0,10,0,53,46,1
1026,19651,czkVdqv8QRpY6SHliMvW81P6eofNIUuP,fbPkOYLVPtPgIt0MxizjfFJov3JbHyAi,6,2,1,0,1,0,3,0,7,1.0,1,0.0,0,1,0,1,2,0,0,3,0,2,5,1
1027,19652,UJay3MfkIPCa65Or9jDxIJTFTpNpxKv0,fbPkOYLVPtPgIt0MxizjfFJov3JbHyAi,5,10,3,0,0,0,4,0,17,2.4285714285714284,1,0.0,2,3,0,0,8,0,0,4,0,5,12,1
1028,19653,RZO451egqNvgwYLVc2DT5RZC5jtK41Wn,fbPkOYLVPtPgIt0MxizjfFJov3JbHyAi,25,26,11,18,10,0,8,1,74,10.571428571428571,3,0.0,12,11,18,10,14,0,0,8,1,51,23,0
1029,19662,tvh0r7BXEnkkRFvEGDSaxc2cnDAVPflf,fbPkOYLVPtPgIt0MxizjfFJov3JbHyAi,28,61,26,21,11,62,31,3,215,30.714285714285715,7,0.0,12,26,18,11,49,62,3,31,3,67,148,1
1030,19663,dqE1PGrWExsbP4JkEoKdSn4p50FzqbEb,fbPkOYLVPtPgIt0MxizjfFJov3JbHyAi,7,8,5,0,4,0,3,0,20,2.857142857142857,3,0.0,0,5,0,4,8,0,0,3,0,9,11,1
1031,19664,IAvuP4GGmvnNj3Zisz3jDfo3mSmXiJSb,fbPkOYLVPtPgIt0MxizjfFJov3JbHyAi,25,77,33,34,32,1,8,1,186,26.571428571428573,4,0.0,37,33,28,32,40,1,6,8,1,130,56,1
1032,19666,3mpQrDEY6qYqlUT3nGLIM1V0MOlZAk6h,fbPkOYLVPtPgIt0MxizjfFJov3JbHyAi,8,11,7,0,5,0,3,0,26,3.7142857142857144,2,0.0,1,7,0,5,10,0,0,3,0,13,13,1
1033,19669,5CV53T145kru57HDn4DelXde0UjT6xqn,fbPkOYLVPtPgIt0MxizjfFJov3JbHyAi,5,6,1,0,1,0,5,0,13,1.8571428571428572,1,0.0,3,1,0,1,3,0,0,5,0,5,8,1
1034,19670,CiNjO5C17d45NfmPbNPGATJqInGPv9eX,fbPkOYLVPtPgIt0MxizjfFJov3JbHyAi,2,0,0,0,0,0,8,0,8,1.1428571428571428,2,0.0,0,0,0,0,0,0,0,8,0,0,8,1
1035,19672,Thuw3SvsWAczQHNEJLdc52dNwXNFxJ27,fbPkOYLVPtPgIt0MxizjfFJov3JbHyAi,1,0,0,0,0,0,1,0,1,0.14285714285714285,1,0.0,0,0,0,0,0,0,0,1,0,0,1,1
1036,19673,5IM8g7YMOYo5qH7Yu3x31T3JkVOH9iqe,fbPkOYLVPtPgIt0MxizjfFJov3JbHyAi,10,18,6,0,3,5,4,0,36,5.142857142857143,2,0.0,0,6,0,3,18,5,0,4,0,9,27,1
1037,19676,gWLNrui4xJ6xOW9BQTEyWRBtLNqndryz,fbPkOYLVPtPgIt0MxizjfFJov3JbHyAi,5,3,1,0,1,3,4,0,12,1.7142857142857142,1,0.0,0,1,0,1,3,3,0,4,0,2,10,1
1038,19677,rl1ijjmPoVXrn0BLw0LMwhU2iQWvim3X,fbPkOYLVPtPgIt0MxizjfFJov3JbHyAi,45,108,65,38,30,82,14,0,337,48.142857142857146,7,0.0,33,65,34,30,75,82,4,14,0,162,175,0
1039,19680,PLKfIj5PWmJ1pq6F2TAT2ZidBGAMa6pt,fbPkOYLVPtPgIt0MxizjfFJov3JbHyAi,25,92,34,16,20,42,24,7,235,33.57142857142857,4,0.0,38,34,13,20,54,42,3,24,7,105,130,1
1040,19681,XY4zkM1XF8dydjqcvDmQyLNW1UDj6PeN,fbPkOYLVPtPgIt0MxizjfFJov3JbHyAi,18,29,15,17,10,4,7,0,82,11.714285714285714,3,0.0,8,15,15,10,21,4,2,7,0,48,34,1
1041,19682,jq3G4vNjVUo5sqAQquCFzqcPQiyiVAd4,fbPkOYLVPtPgIt0MxizjfFJov3JbHyAi,9,10,6,6,4,2,3,0,31,4.428571428571429,2,0.0,1,6,5,4,9,2,1,3,0,16,15,1
1042,19683,EqwF2QzEhw4NgIj4YX1bMoLFO7jCzOVt,fbPkOYLVPtPgIt0MxizjfFJov3JbHyAi,11,5,3,13,4,0,5,0,30,4.285714285714286,1,0.0,2,3,8,4,3,0,5,5,0,17,13,1
1043,19684,mya8TfxNbiDk3y9Od8avdqRP3ecWgTII,fbPkOYLVPtPgIt0MxizjfFJov3JbHyAi,4,3,2,0,2,19,2,0,28,4.0,2,0.0,0,2,0,2,3,19,0,2,0,4,24,1
1044,19686,CnbF8r7iTFBimMMahtVgMZeVp9U8TCPU,fbPkOYLVPtPgIt0MxizjfFJov3JbHyAi,8,14,3,0,2,5,4,1,29,4.142857142857143,1,0.0,2,3,0,2,12,5,0,4,1,7,22,1
1045,19688,RxXRKZYpbfKbF79XwFGwONhlZ3CWNuKc,fbPkOYLVPtPgIt0MxizjfFJov3JbHyAi,1,0,0,0,0,0,2,0,2,0.2857142857142857,2,0.0,0,0,0,0,0,0,0,2,0,0,2,1
1046,19691,j4HDn7pHd4SauRXrARz1vjrq9gR7efiY,fbPkOYLVPtPgIt0MxizjfFJov3JbHyAi,10,22,9,0,7,0,9,0,47,6.714285714285714,1,0.0,2,9,0,7,20,0,0,9,0,18,29,1
1047,19697,94kd1qvIZ0nokZPS6BCV8qxXnL5MM2jB,fbPkOYLVPtPgIt0MxizjfFJov3JbHyAi,46,316,146,41,84,90,64,2,743,106.14285714285714,11,0.0,44,146,36,84,272,90,5,64,2,310,433,0
1048,19700,WfC8bzRtjtkKnUrmorui57fDTiw7ripx,fbPkOYLVPtPgIt0MxizjfFJov3JbHyAi,1,0,0,0,0,0,1,0,1,0.14285714285714285,1,0.0,0,0,0,0,0,0,0,1,0,0,1,1
1049,19703,PNFwnD5V878zriXX4URfko4zocKM6AxT,fbPkOYLVPtPgIt0MxizjfFJov3JbHyAi,7,5,3,0,2,1,1,0,12,1.7142857142857142,1,0.0,0,3,0,2,5,1,0,1,0,5,7,1
1050,19704,5WAIxgqU8QRTpOrU8O3vmj4h4ZKof8jn,fbPkOYLVPtPgIt0MxizjfFJov3JbHyAi,6,6,2,0,2,3,1,0,14,2.0,1,0.0,3,2,0,2,3,3,0,1,0,7,7,1
1051,19706,ZgQ15hhI1Ucp5464waJfnBAlAZitQ6GS,fbPkOYLVPtPgIt0MxizjfFJov3JbHyAi,30,37,20,19,16,0,13,0,105,15.0,4,0.0,12,20,16,16,25,0,3,13,0,64,41,1
1052,19707,mFpiELMd2y5tbkdxs4m8pKS7gXHb7bIO,fbPkOYLVPtPgIt0MxizjfFJov3JbHyAi,6,3,2,0,2,0,1,0,8,1.1428571428571428,1,0.0,0,2,0,2,3,0,0,1,0,4,4,1
1053,19710,2mdoNlBiXpgUVSmoihAheHl3NISmi738,fbPkOYLVPtPgIt0MxizjfFJov3JbHyAi,26,37,18,14,19,0,3,0,91,13.0,3,0.0,16,18,13,19,21,0,1,3,0,66,25,1
1054,19711,qqdJa21dgyzvCuC2gEGuhgU9JUiH4Miw,fbPkOYLVPtPgIt0MxizjfFJov3JbHyAi,9,12,5,6,5,5,4,0,37,5.285714285714286,1,0.0,5,5,4,5,7,5,2,4,0,19,18,1
1055,19712,YviwWEN6zon2XUnzizUs5e4hMfvZTKyo,fbPkOYLVPtPgIt0MxizjfFJov3JbHyAi,10,19,10,0,6,4,9,0,48,6.857142857142857,4,0.0,0,10,0,6,19,4,0,9,0,16,32,1
1056,19716,VDczqRqblkMPJmrAoZEhPuTYAP3s4BVi,fbPkOYLVPtPgIt0MxizjfFJov3JbHyAi,8,6,4,0,3,0,5,0,18,2.5714285714285716,2,0.0,0,4,0,3,6,0,0,5,0,7,11,1
1057,19717,vs0vqlNXzuHsqVxOsB15kGfpvGf2pUt3,fbPkOYLVPtPgIt0MxizjfFJov3JbHyAi,1,0,0,0,0,0,1,0,1,0.14285714285714285,1,0.0,0,0,0,0,0,0,0,1,0,0,1,1
1058,19718,E4lbnSGpFm0DLoI5I2cB98rKNvfek7Pe,fbPkOYLVPtPgIt0MxizjfFJov3JbHyAi,9,3,2,0,2,0,6,1,14,2.0,1,0.0,0,2,0,2,3,0,0,6,1,4,10,1
1059,19724,iaR2pnkwyNY3r5zTqD1W39STthtx49ji,fbPkOYLVPtPgIt0MxizjfFJov3JbHyAi,26,56,18,17,16,0,11,0,118,16.857142857142858,4,0.0,23,18,15,16,33,0,2,11,0,72,46,1
1060,19725,47CO43LdBnUCItnxzVzNK8EGYhZB4UEL,fbPkOYLVPtPgIt0MxizjfFJov3JbHyAi,5,2,1,0,1,0,2,0,6,0.8571428571428571,1,0.0,0,1,0,1,2,0,0,2,0,2,4,0
1061,19727,bL3u5qIjoppYFsMUfGswfFLujxnAggge,fbPkOYLVPtPgIt0MxizjfFJov3JbHyAi,31,76,39,14,35,66,28,4,262,37.42857142857143,7,0.0,22,39,14,35,54,66,0,28,4,110,152,0
1062,19728,klABCgiMhTPJ0XO3mm3Xvqo3F5v3JzEw,fbPkOYLVPtPgIt0MxizjfFJov3JbHyAi,2,0,0,0,0,0,2,0,2,0.2857142857142857,1,0.0,0,0,0,0,0,0,0,2,0,0,2,1
1063,19729,GP9uxCl0w0ORUxGcBwBhHCA6EDx2EOSR,fbPkOYLVPtPgIt0MxizjfFJov3JbHyAi,10,13,9,0,6,6,16,1,51,7.285714285714286,2,0.0,0,9,0,6,13,6,0,16,1,15,36,1
1064,19734,PwwEqEv3o1wfWN5Eu8NuK3q82yRAO9LK,fbPkOYLVPtPgIt0MxizjfFJov3JbHyAi,1,0,0,0,0,0,1,0,1,0.14285714285714285,1,0.0,0,0,0,0,0,0,0,1,0,0,1,1
1065,19736,RTFyJMIqIq6xWTPdoUugdDSXlWY0NS3w,fbPkOYLVPtPgIt0MxizjfFJov3JbHyAi,3,0,0,0,0,2,3,0,5,0.7142857142857143,1,0.0,0,0,0,0,0,2,0,3,0,0,5,1
1066,19737,r5nHhhPp8wNqkUKwaWfUvmNqly1MZrKz,fbPkOYLVPtPgIt0MxizjfFJov3JbHyAi,8,10,2,0,2,1,2,0,17,2.4285714285714284,2,0.0,1,2,0,2,9,1,0,2,0,5,12,0
1067,19739,XyD01HhzMuHzP5ArHNJFexoSZMamD6Wh,fbPkOYLVPtPgIt0MxizjfFJov3JbHyAi,6,7,4,0,1,0,3,0,15,2.142857142857143,2,0.0,1,4,0,1,6,0,0,3,0,6,9,1
1068,19740,J0agIiDPDsO7EgNBs76RsZQyZ6XLl2nX,fbPkOYLVPtPgIt0MxizjfFJov3JbHyAi,9,5,5,0,4,0,6,0,20,2.857142857142857,2,0.0,0,5,0,4,5,0,0,6,0,9,11,1
1069,19741,IMwEerHys6R3vOnp3J0coaa20HaLBM5L,fbPkOYLVPtPgIt0MxizjfFJov3JbHyAi,8,8,4,0,2,0,6,0,20,2.857142857142857,2,0.0,1,4,0,2,7,0,0,6,0,7,13,1
1070,19747,5QI6OaFhCHlCtRcFfvDdZQ38fgw6K7ZS,fbPkOYLVPtPgIt0MxizjfFJov3JbHyAi,2,0,0,0,0,0,3,0,3,0.42857142857142855,1,0.0,0,0,0,0,0,0,0,3,0,0,3,1
1071,19749,0artPLh8IkCTAf124kxiUrz2J9bSLV97,fbPkOYLVPtPgIt0MxizjfFJov3JbHyAi,11,18,10,0,3,2,7,1,41,5.857142857142857,3,0.0,3,10,0,3,15,2,0,7,1,16,25,1
1072,19750,g80H6iY57adZtyt3qdJsUFLOZl0two6T,fbPkOYLVPtPgIt0MxizjfFJov3JbHyAi,6,3,1,0,1,0,4,0,9,1.2857142857142858,1,0.0,0,1,0,1,3,0,0,4,0,2,7,1
1073,19751,21WmZ1MYMXM5lnwi17lhbA5W7URRxFf7,fbPkOYLVPtPgIt0MxizjfFJov3JbHyAi,2,0,0,0,0,0,2,0,2,0.2857142857142857,1,0.0,0,0,0,0,0,0,0,2,0,0,2,1
1074,19755,jMt06vkBXL8VPGQpBPqacOfIuLzrVTe6,fbPkOYLVPtPgIt0MxizjfFJov3JbHyAi,14,18,11,5,8,37,7,0,86,12.285714285714286,2,0.0,3,11,4,8,15,37,1,7,0,26,60,1
1075,19756,rYmGXfabWDSzV9Y1YJe1P9bXx90UHqZS,fbPkOYLVPtPgIt0MxizjfFJov3JbHyAi,7,9,2,0,3,0,6,0,20,2.857142857142857,1,0.0,5,2,0,3,4,0,0,6,0,10,10,1
1076,19760,fKydOJi1gInT4LhNbAI1K5Nn83QpbQ9b,fbPkOYLVPtPgIt0MxizjfFJov3JbHyAi,10,6,4,0,3,0,15,1,29,4.142857142857143,3,0.0,0,4,0,3,6,0,0,15,1,7,22,1
1077,19761,2ZVrSpja22JYuBdqG7iHOipKnnGEm2ou,fbPkOYLVPtPgIt0MxizjfFJov3JbHyAi,45,74,36,30,24,22,29,2,217,31.0,4,0.0,25,36,24,24,49,22,6,29,2,109,108,0
1078,19764,IHJGcg8XuB6HPRBrjHVn1eWwbgo7JSEZ,fbPkOYLVPtPgIt0MxizjfFJov3JbHyAi,5,2,1,0,1,0,2,0,6,0.8571428571428571,1,0.0,0,1,0,1,2,0,0,2,0,2,4,1
1079,19765,oZrYS5rqR18A77jULvm9aJ8bGsP88f4h,fbPkOYLVPtPgIt0MxizjfFJov3JbHyAi,34,89,44,21,24,4,29,2,213,30.428571428571427,9,0.0,18,44,17,24,71,4,4,29,2,103,110,0
1080,19770,HneXab7aMQtYruvuxuZ9dNY5QxwlGitq,fbPkOYLVPtPgIt0MxizjfFJov3JbHyAi,8,2,1,0,1,0,8,1,13,1.8571428571428572,1,0.0,0,1,0,1,2,0,0,8,1,2,11,1
1081,19772,fKgU6PKVjgAnp4uvGa6MHJe7D2ZYaBc1,fbPkOYLVPtPgIt0MxizjfFJov3JbHyAi,12,11,8,0,7,0,3,0,29,4.142857142857143,2,0.0,0,8,0,7,11,0,0,3,0,15,14,1
1082,19773,VryhTUuSCWlg2ThKmkz8AynIgw8SfZgv,fbPkOYLVPtPgIt0MxizjfFJov3JbHyAi,10,5,3,0,3,0,3,0,14,2.0,1,0.0,0,3,0,3,5,0,0,3,0,6,8,1
1083,19774,R0JUZ056kzFL6PD0dHwCASPDjJEFALuj,fbPkOYLVPtPgIt0MxizjfFJov3JbHyAi,46,164,96,42,66,30,23,3,424,60.57142857142857,8,0.0,43,96,41,66,121,30,1,23,3,246,178,1
1084,19775,tA1lc3vnumj95Nh6FWr8EK0wWDHGYnC2,fbPkOYLVPtPgIt0MxizjfFJov3JbHyAi,16,16,7,10,9,3,16,3,64,9.142857142857142,2,0.0,8,7,7,9,8,3,3,16,3,31,33,1
1085,19778,8b7ZppycC3YQh10hFhgFNseCAwtseLj5,fbPkOYLVPtPgIt0MxizjfFJov3JbHyAi,5,2,1,0,1,0,2,0,6,0.8571428571428571,1,0.0,0,1,0,1,2,0,0,2,0,2,4,0
1086,19784,KqVrk2SHI9QdxCC7nQf6EBD4bfm6dNDK,fbPkOYLVPtPgIt0MxizjfFJov3JbHyAi,39,43,21,25,12,52,27,4,184,26.285714285714285,4,0.0,11,21,21,12,32,52,4,27,4,65,119,1
1087,19786,pVW1QDTezd5CM1iZ8cdugaLwJl6C95dO,fbPkOYLVPtPgIt0MxizjfFJov3JbHyAi,1,0,0,0,0,0,1,0,1,0.14285714285714285,1,0.0,0,0,0,0,0,0,0,1,0,0,1,1
1088,19787,Uud6ejfxjo2wR9C9pIlBSyKMyMrHfe52,fbPkOYLVPtPgIt0MxizjfFJov3JbHyAi,24,27,24,0,19,27,3,0,100,14.285714285714286,6,0.0,0,24,0,19,27,27,0,3,0,43,57,1
1089,19792,gmI36QrP5V0XjdeY5fw2LtMzPgNNn1eX,fbPkOYLVPtPgIt0MxizjfFJov3JbHyAi,12,10,5,5,6,0,2,0,28,4.0,1,0.0,2,5,4,6,8,0,1,2,0,17,11,1
1090,19796,szY7iRYrnZrzBCwm4obBzatvtWaWEKSz,fbPkOYLVPtPgIt0MxizjfFJov3JbHyAi,13,16,10,13,9,0,1,0,49,7.0,1,0.0,5,10,9,9,11,0,4,1,0,33,16,1
1091,19797,kV0etVT4eF07a55Y2wFFrCm2NuKlfy3O,fbPkOYLVPtPgIt0MxizjfFJov3JbHyAi,11,14,7,0,4,0,4,1,30,4.285714285714286,2,0.0,0,7,0,4,14,0,0,4,1,11,19,1
1092,19801,eRM1cqDGfrej4Riud5wVHQPpEv2yAjcd,fbPkOYLVPtPgIt0MxizjfFJov3JbHyAi,11,6,4,0,4,0,3,0,17,2.4285714285714284,2,0.0,0,4,0,4,6,0,0,3,0,8,9,1
1093,19802,JOTZzIfdhlRRSJT88VvraViqFb0FOnua,fbPkOYLVPtPgIt0MxizjfFJov3JbHyAi,9,8,5,0,1,0,7,0,21,3.0,2,0.0,0,5,0,1,8,0,0,7,0,6,15,1
1094,19830,J19fRobYymSKSws9Yoy23YPes8L6wyrW,fbPkOYLVPtPgIt0MxizjfFJov3JbHyAi,5,2,1,0,1,0,3,0,7,1.0,1,0.0,0,1,0,1,2,0,0,3,0,2,5,1
1095,19856,cNw6DSimidnnJTy63mT8fC6ow4HuQb5s,fbPkOYLVPtPgIt0MxizjfFJov3JbHyAi,37,73,51,22,25,34,17,1,223,31.857142857142858,3,0.0,15,51,19,25,58,34,3,17,1,110,113,0
1096,19864,xpAxjSreQEJGjM28FJsQcyiEt1VA8RXl,fbPkOYLVPtPgIt0MxizjfFJov3JbHyAi,42,97,34,58,15,14,18,0,236,33.714285714285715,10,0.0,17,34,56,15,80,14,2,18,0,122,114,0
1097,19880,7cdSr9CqRrEGZIWG84xbV4x3Kafz72lh,fbPkOYLVPtPgIt0MxizjfFJov3JbHyAi,15,15,6,10,9,1,5,1,47,6.714285714285714,2,0.0,9,6,8,9,6,1,2,5,1,32,15,1
1098,19883,oBB4V7EIN8ossAzWm6ldlqIytEJdobH7,fbPkOYLVPtPgIt0MxizjfFJov3JbHyAi,13,27,16,0,10,44,18,4,119,17.0,4,0.0,4,16,0,10,23,44,0,18,4,30,89,1
1099,19890,IVtvtdZLBtL9DhFAioWkcCx38OrFXpXg,fbPkOYLVPtPgIt0MxizjfFJov3JbHyAi,30,107,51,33,0,49,39,2,281,40.142857142857146,11,0.0,32,51,30,0,75,49,3,39,2,113,168,0
1100,19902,WaEPHAZo5pH7Npa5iwnKZ2EJATuLkfKt,fbPkOYLVPtPgIt0MxizjfFJov3JbHyAi,10,10,1,0,1,0,4,0,16,2.2857142857142856,1,0.0,1,1,0,1,9,0,0,4,0,3,13,1
1101,19913,XbORnKU4LaOdLNHafCieVF22rPhRdsHM,fbPkOYLVPtPgIt0MxizjfFJov3JbHyAi,1,0,0,0,0,0,1,0,1,0.14285714285714285,1,0.0,0,0,0,0,0,0,0,1,0,0,1,1
1102,19915,qFnFxVZ0kWnoJ6Z9EGCtfX2XIxJ2ju5D,fbPkOYLVPtPgIt0MxizjfFJov3JbHyAi,7,3,2,0,2,0,6,0,13,1.8571428571428572,1,0.0,0,2,0,2,3,0,0,6,0,4,9,0
1103,19922,1qrewX2JRhRs3lyeTFWMYnwQw6V9CpLd,fbPkOYLVPtPgIt0MxizjfFJov3JbHyAi,9,6,4,0,3,0,2,0,15,2.142857142857143,1,0.0,0,4,0,3,6,0,0,2,0,7,8,1
1104,19923,a0YvhqmPpF6B62CVp5XUUUyQ2cFSSLDq,fbPkOYLVPtPgIt0MxizjfFJov3JbHyAi,6,4,3,0,3,4,2,0,16,2.2857142857142856,1,0.0,0,3,0,3,4,4,0,2,0,6,10,1
1105,19924,OT5T42YlAbCtocwISa5ev3ROMYVra29q,fbPkOYLVPtPgIt0MxizjfFJov3JbHyAi,5,2,1,0,1,3,3,0,10,1.4285714285714286,1,0.0,0,1,0,1,2,3,0,3,0,2,8,1
1106,19925,u82lBhpDxJIwlZISEntCxj1zgVFdW0vT,fbPkOYLVPtPgIt0MxizjfFJov3JbHyAi,1,0,0,0,0,0,3,0,3,0.42857142857142855,1,0.0,0,0,0,0,0,0,0,3,0,0,3,1
1107,19929,rVO8IsFZOLqwyY7i49TyObO4q8Yse38O,fbPkOYLVPtPgIt0MxizjfFJov3JbHyAi,17,16,0,19,1,0,2,0,38,5.428571428571429,1,0.0,7,0,16,1,9,0,3,2,0,24,14,1
1108,21469,5oy5I8Xh5KkzBBzgBTkYXJ5uADqnzeVC,7GRhBDsirIGkRZBtSMEzNTyDr2JQm4xx,64,171,44,117,34,28,8,0,402,57.42857142857143,5,0.0,80,44,95,34,91,28,22,8,0,253,149,0
1109,21478,43nq30xhRsgmZVAWkH8Zjb7IyZDGRDeY,7GRhBDsirIGkRZBtSMEzNTyDr2JQm4xx,68,183,56,116,41,94,28,0,518,74.0,8,0.0,102,56,103,41,81,94,13,28,0,302,216,0
1110,21499,L74tKRZpBi1qsh0NM3EwE5D87acCLK8s,7GRhBDsirIGkRZBtSMEzNTyDr2JQm4xx,55,78,31,99,9,0,20,0,237,33.857142857142854,4,0.0,34,31,90,9,44,0,9,20,0,164,73,0
1111,21503,PUFh3BsQaDVIJMDvwsFTqkrgAzvjO9ME,7GRhBDsirIGkRZBtSMEzNTyDr2JQm4xx,6,2,1,0,1,0,4,0,8,1.1428571428571428,1,0.0,0,1,0,1,2,0,0,4,0,2,6,1
1112,21832,W5CVKONt5qsYlbCwSDDjPmuQMWPx8PFD,7GRhBDsirIGkRZBtSMEzNTyDr2JQm4xx,10,7,2,0,2,0,4,0,15,2.142857142857143,1,0.0,0,2,0,2,7,0,0,4,0,4,11,0
1113,22007,eovSKdG09ZHYTXNtS1zUIy1RfsRsCibs,7GRhBDsirIGkRZBtSMEzNTyDr2JQm4xx,68,375,119,164,67,925,103,5,1758,251.14285714285714,7,0.0,223,119,128,67,152,925,36,103,5,537,1221,0
1114,22130,lw56FfuS5fUETVCyRkCnysAZop6MzvUe,7GRhBDsirIGkRZBtSMEzNTyDr2JQm4xx,4,6,1,0,0,0,3,0,10,1.4285714285714286,1,0.0,2,1,0,0,4,0,0,3,0,3,7,0
1115,22148,IA6nFLwiYdBOXKobyV12AjVhFzxFaVpR,7GRhBDsirIGkRZBtSMEzNTyDr2JQm4xx,25,22,10,25,6,0,6,0,69,9.857142857142858,2,0.0,9,10,24,6,13,0,1,6,0,49,20,1
1116,22218,qpd1RINX0ghAugS9ZiQmRvWMQe2xJWfG,7GRhBDsirIGkRZBtSMEzNTyDr2JQm4xx,28,85,4,36,4,8,5,0,142,20.285714285714285,3,0.0,50,4,36,4,35,8,0,5,0,94,48,1
1117,22649,kpDqfPKqqQYJmKMTzN1Sox48V4ZPJuXL,SpATywNh6bZuzm8s1ceuBUnMUAeoAHHw,25,38,15,26,6,5,13,0,103,14.714285714285714,4,0.0,15,15,20,6,23,5,6,13,0,56,47,1
1118,22660,nwlJxZtiMdof1orslmN8VJv3ydVnbeg5,RXDvfPUBYFlVdlueBFbLW0mhhAyGEqpt,5,4,2,0,2,0,1,0,9,1.2857142857142858,1,0.0,0,2,0,2,4,0,0,1,0,4,5,1
1119,22676,CMoV5dPTzwxV3W6HJJmvW8wSnp90ZPh2,SpATywNh6bZuzm8s1ceuBUnMUAeoAHHw,21,21,16,0,10,0,8,0,55,7.857142857142857,5,0.0,0,16,0,10,21,0,0,8,0,26,29,0
1120,22715,3cB0rEpxJxC0jjqfQ9EPT6ntxFajOXrx,SpATywNh6bZuzm8s1ceuBUnMUAeoAHHw,26,76,33,32,11,25,18,1,196,28.0,6,0.0,23,33,26,11,53,25,6,18,1,93,103,0
1121,22724,GXmYCsHMMMsjIL2A9DYKMEw8AEscVD5s,A3fsA9Zfv1X2fVEQhTw51lKENdNrEqT3,25,26,17,32,7,3,15,3,103,14.714285714285714,3,0.0,2,17,26,7,24,3,6,15,3,52,51,0
1122,22738,83J9IXuPcwdDBJoFENdSQFWzvgELVzeu,G8EPVSXsOYB5YQWZGiz1aVq5Pgr2GrQu,25,110,37,70,7,25,22,2,273,39.0,3,0.0,42,37,55,7,68,25,15,22,2,141,132,1
1123,22741,ooFElJ4ZPOLTBMQwigtvKfnHk0DNrR2R,SpATywNh6bZuzm8s1ceuBUnMUAeoAHHw,6,3,2,0,2,0,2,0,9,1.2857142857142858,2,0.0,0,2,0,2,3,0,0,2,0,4,5,1
1124,22744,D2ho5VQQzNWAcdswkNScRjqQiNPjKhpn,A3fsA9Zfv1X2fVEQhTw51lKENdNrEqT3,11,12,1,0,1,0,15,0,29,4.142857142857143,1,0.0,0,1,0,1,12,0,0,15,0,2,27,1
1125,22747,5GeMwmyzCXMcMYfcWdKaXbpNNdL8bmPq,A3fsA9Zfv1X2fVEQhTw51lKENdNrEqT3,7,4,2,0,1,0,7,0,14,2.0,3,0.0,0,2,0,1,4,0,0,7,0,3,11,1
1126,22757,LJYBef7iIBiSZz8D7KTtMTsdkyd91gnR,SpATywNh6bZuzm8s1ceuBUnMUAeoAHHw,9,21,11,0,4,0,11,0,47,6.714285714285714,3,0.0,0,11,0,4,21,0,0,11,0,15,32,0
1127,22762,MCJiDMInWw8URpDdqHAwEp0pExHWdLRC,SpATywNh6bZuzm8s1ceuBUnMUAeoAHHw,4,2,1,0,1,0,1,0,5,0.7142857142857143,1,0.0,0,1,0,1,2,0,0,1,0,2,3,1
1128,22766,BImVQpNaWI5ZZjLENiRV2V2LYkbW88m0,RXDvfPUBYFlVdlueBFbLW0mhhAyGEqpt,39,48,24,52,12,0,3,0,139,19.857142857142858,3,0.0,11,24,50,12,37,0,2,3,0,97,42,0
1129,22776,jaMKMvlU4KDCkm4HrM0MWVH43rDA8rY1,A3fsA9Zfv1X2fVEQhTw51lKENdNrEqT3,17,11,8,0,6,0,6,1,32,4.571428571428571,3,0.0,0,8,0,6,11,0,0,6,1,14,18,1
1130,22777,jpXIq3stqWScWG27acYJbNKpdTmc6kli,A3fsA9Zfv1X2fVEQhTw51lKENdNrEqT3,51,58,44,50,29,21,19,0,221,31.571428571428573,5,0.0,3,44,44,29,55,21,6,19,0,120,101,1
1131,22787,XCY83tv4aCv2fMTPmH1QE6tZOtr7KzJT,G8EPVSXsOYB5YQWZGiz1aVq5Pgr2GrQu,93,170,55,234,14,40,38,4,555,79.28571428571429,6,0.0,72,55,182,14,98,40,52,38,4,323,232,0
1132,22800,xiHLAVx1lOeJhtdb9rNdxGApg3TIwPUZ,SpATywNh6bZuzm8s1ceuBUnMUAeoAHHw,10,12,1,6,0,0,2,0,21,3.0,2,0.0,3,1,5,0,9,0,1,2,0,9,12,1
1133,22814,zyIWmJjaz36PnMZpAzR2HEZCUbJWe8iQ,A3fsA9Zfv1X2fVEQhTw51lKENdNrEqT3,5,2,1,0,1,0,2,0,6,0.8571428571428571,1,0.0,0,1,0,1,2,0,0,2,0,2,4,1
1134,22859,JJDRXXLRU75H8Dx2cuK7Td1V7D7QoKg9,RXDvfPUBYFlVdlueBFbLW0mhhAyGEqpt,32,46,0,46,2,10,18,5,127,18.142857142857142,2,0.0,13,0,36,2,33,10,10,18,5,51,76,0
1135,22876,yZi2eaDxP9Hsc5TkKYLN2LUYSBmbQGTr,SpATywNh6bZuzm8s1ceuBUnMUAeoAHHw,28,32,13,27,7,0,4,0,83,11.857142857142858,2,0.0,17,13,21,7,15,0,6,4,0,58,25,0
1136,22877,qjNUBrpwN8flYc0VorTlQJNEWSbIR2KA,A3fsA9Zfv1X2fVEQhTw51lKENdNrEqT3,60,73,7,147,3,9,17,0,256,36.57142857142857,3,0.0,7,7,128,3,66,9,19,17,0,145,111,1
1137,22880,ti1hbICHLqROy8Y7XhKRxGlLqF2ITiDH,RXDvfPUBYFlVdlueBFbLW0mhhAyGEqpt,58,64,38,132,25,0,19,0,278,39.714285714285715,5,0.0,18,38,116,25,46,0,16,19,0,197,81,0
1138,22898,t2LtqHppiTuDN14mSCfUVu9qYG7mBNAD,A3fsA9Zfv1X2fVEQhTw51lKENdNrEqT3,70,43,24,180,14,6,8,0,275,39.285714285714285,2,0.0,5,24,157,14,38,6,23,8,0,200,75,0
1139,22899,AoDbGxsdtQ88iavwLYzXC5a1sZ4YMkt5,SpATywNh6bZuzm8s1ceuBUnMUAeoAHHw,21,30,14,18,8,12,9,0,91,13.0,3,0.0,12,14,15,8,18,12,3,9,0,49,42,1
1140,22905,i17yw0GYsvz8XFpq0Y9RtdPoiYFDGh9w,bWdj2GDclj5ofokWjzoa5jAwMkxCykd6,1,0,0,0,0,0,1,0,1,0.14285714285714285,1,0.0,0,0,0,0,0,0,0,1,0,0,1,1
1141,22906,CLsYy7g1hYWHJyj1aROfKK9oTeo5yxJx,A3fsA9Zfv1X2fVEQhTw51lKENdNrEqT3,58,26,21,66,17,2,11,1,144,20.571428571428573,2,0.0,1,21,60,17,25,2,6,11,1,99,45,1
1142,22911,i17yw0GYsvz8XFpq0Y9RtdPoiYFDGh9w,A3fsA9Zfv1X2fVEQhTw51lKENdNrEqT3,1,0,0,0,0,0,1,0,1,0.14285714285714285,1,0.0,0,0,0,0,0,0,0,1,0,0,1,1
1143,22915,dLoTMfurIDgppPqjn68MhR8oLIGjxbCC,bWdj2GDclj5ofokWjzoa5jAwMkxCykd6,17,37,18,42,7,17,7,0,128,18.285714285714285,4,0.0,5,18,37,7,32,17,5,7,0,67,61,1
1144,22924,SY3KixRowLNTROWYYZsbpxNmhMe23Wc3,SpATywNh6bZuzm8s1ceuBUnMUAeoAHHw,5,4,0,0,1,0,2,0,7,1.0,2,0.0,0,0,0,1,4,0,0,2,0,1,6,1
1145,22934,I4EJkH4zClhTB2lKNgq7Q2fKtUYoVDSA,A3fsA9Zfv1X2fVEQhTw51lKENdNrEqT3,13,36,5,0,2,3,20,2,68,9.714285714285714,4,0.0,0,5,0,2,36,3,0,20,2,7,61,1
1146,22937,7mQeRnk4E67KJHDHSAp1BOWEWVuxMvA2,SpATywNh6bZuzm8s1ceuBUnMUAeoAHHw,29,49,20,44,12,2,12,2,141,20.142857142857142,2,0.0,10,20,42,12,39,2,2,12,2,84,57,1
1147,22976,cVHCYdG6eoXKQe55dLZbvLgwBGbWam7p,RXDvfPUBYFlVdlueBFbLW0mhhAyGEqpt,1,0,0,0,0,0,1,0,1,0.14285714285714285,1,0.0,0,0,0,0,0,0,0,1,0,0,1,1
1148,22985,Dkp4ht4oz2wUhu9UvNTwrqC02rtqcSZH,SpATywNh6bZuzm8s1ceuBUnMUAeoAHHw,6,4,2,0,1,0,5,0,12,1.7142857142857142,2,0.0,0,2,0,1,4,0,0,5,0,3,9,1
1149,22998,nCARlKCtX8cCYdg9wv53tMq1HV8fOfAB,RXDvfPUBYFlVdlueBFbLW0mhhAyGEqpt,29,65,3,24,2,2,12,1,109,15.571428571428571,4,0.0,4,3,24,2,61,2,0,12,1,33,76,1
1150,22999,cbxqNQUcwI376TUiYgRRo2dXuIaImWoc,SpATywNh6bZuzm8s1ceuBUnMUAeoAHHw,26,50,32,2,15,1,25,2,127,18.142857142857142,2,0.0,7,32,2,15,43,1,0,25,2,56,71,1
1151,23011,Qi3PLuC7w2Yo9hFgq37MObjY8icnRdc6,A3fsA9Zfv1X2fVEQhTw51lKENdNrEqT3,63,61,26,168,8,24,29,2,318,45.42857142857143,8,0.0,5,26,131,8,56,24,37,29,2,170,148,0
1152,23016,jZn0klM9Bk084k9gvux7E5DK1oO1FwuJ,SpATywNh6bZuzm8s1ceuBUnMUAeoAHHw,20,27,18,9,8,0,7,0,69,9.857142857142858,4,0.0,0,18,8,8,27,0,1,7,0,34,35,0
1153,23032,UInMBEH8f1h2vxXVslRsWyLOTv8ggYq3,RXDvfPUBYFlVdlueBFbLW0mhhAyGEqpt,37,51,21,0,13,5,9,0,99,14.142857142857142,5,0.0,0,21,0,13,51,5,0,9,0,34,65,0
1154,23035,e09uq36QgLuBVK5DERoejsHeMH2uPMRM,SpATywNh6bZuzm8s1ceuBUnMUAeoAHHw,1,0,0,0,0,0,2,0,2,0.2857142857142857,2,0.0,0,0,0,0,0,0,0,2,0,0,2,1
1155,23038,0DzldTHKdoH90kklIAjpWyAEe6XDDjyM,SpATywNh6bZuzm8s1ceuBUnMUAeoAHHw,19,90,19,35,0,8,34,1,187,26.714285714285715,11,0.0,26,19,30,0,64,8,5,34,1,75,112,0
1156,23041,TJxPKDYS9NmvmYGlrCikboEkhHDTOEHy,SpATywNh6bZuzm8s1ceuBUnMUAeoAHHw,8,15,7,0,1,0,6,0,29,4.142857142857143,1,0.0,5,7,0,1,10,0,0,6,0,13,16,0
1157,23070,XHWdewLJ6o4Ir5vIcSMNfq1s8TFbjZbE,bWdj2GDclj5ofokWjzoa5jAwMkxCykd6,19,58,22,178,14,33,18,1,324,46.285714285714285,2,0.0,22,22,173,14,36,33,5,18,1,231,93,1
1158,23072,Pb0Dj6dRtTGmcuNxvaHjmGw0iPTyjSsN,bWdj2GDclj5ofokWjzoa5jAwMkxCykd6,7,5,3,0,2,0,7,0,17,2.4285714285714284,2,0.0,0,3,0,2,5,0,0,7,0,5,12,1
1159,23075,CUMuKIhvWkMSk50Or6FhgPf1tk7jntYp,SpATywNh6bZuzm8s1ceuBUnMUAeoAHHw,16,30,12,14,0,0,12,0,68,9.714285714285714,5,0.0,10,12,14,0,20,0,0,12,0,36,32,0
1160,23097,5wbqpjsRycE3Ij1gukLWuLp8it7vr80U,SpATywNh6bZuzm8s1ceuBUnMUAeoAHHw,25,100,42,14,1,255,40,4,456,65.14285714285714,7,0.0,36,42,14,1,64,255,0,40,4,93,363,1
1161,23113,Xcdjjhyr6mdJr4bRWqVyHg8s2pWIVQGq,SpATywNh6bZuzm8s1ceuBUnMUAeoAHHw,27,44,5,30,3,11,11,4,108,15.428571428571429,3,0.0,11,5,28,3,33,11,2,11,4,47,61,1
1162,23121,9S5uoFAiVHVF4D2DNR23wCkbQZ8LhtES,SpATywNh6bZuzm8s1ceuBUnMUAeoAHHw,17,22,4,14,1,0,7,0,48,6.857142857142857,4,0.0,4,4,13,1,18,0,1,7,0,22,26,0
1163,23123,rq9XJ5UGjNC0AliEbyfxvu7XJPaoSOc4,A3fsA9Zfv1X2fVEQhTw51lKENdNrEqT3,2,0,0,0,0,0,4,0,4,0.5714285714285714,1,0.0,0,0,0,0,0,0,0,4,0,0,4,1
1164,23131,hGDnsprgLmlBuNCzDAhbMdsa7xgZW8Z4,bWdj2GDclj5ofokWjzoa5jAwMkxCykd6,20,20,6,18,8,0,14,0,66,9.428571428571429,1,0.0,5,6,16,8,15,0,2,14,0,35,31,1
1165,23142,6j5Aoj3JOkcTRkyfXNVtTy229CS4uihi,G8EPVSXsOYB5YQWZGiz1aVq5Pgr2GrQu,85,172,68,163,53,1,19,3,479,68.42857142857143,12,0.0,43,68,130,53,129,1,33,19,3,294,185,0
1166,23166,4eKGhI4OMlwHB0DLaezQlJp1reuJgarH,SpATywNh6bZuzm8s1ceuBUnMUAeoAHHw,1,0,0,0,0,0,1,0,1,0.14285714285714285,1,0.0,0,0,0,0,0,0,0,1,0,0,1,1
1167,23183,HycevJIm7cBjf1oJ5QCBMMXEBTG8jyRF,A3fsA9Zfv1X2fVEQhTw51lKENdNrEqT3,66,53,34,78,8,0,18,0,191,27.285714285714285,4,0.0,8,34,77,8,45,0,1,18,0,127,64,0
1168,23185,HycevJIm7cBjf1oJ5QCBMMXEBTG8jyRF,bWdj2GDclj5ofokWjzoa5jAwMkxCykd6,14,26,17,4,2,0,15,0,64,9.142857142857142,6,0.0,4,17,3,2,22,0,1,15,0,26,38,0
1169,23197,BDdKHYPp1edgylVPYUBHaWJ6W3VobGdR,SpATywNh6bZuzm8s1ceuBUnMUAeoAHHw,30,78,37,32,15,9,12,0,183,26.142857142857142,4,0.0,29,37,28,15,49,9,4,12,0,109,74,1
1170,23201,mE5coXp72CvzVrqwpPF6wLVZrHDH0Vlq,SpATywNh6bZuzm8s1ceuBUnMUAeoAHHw,27,79,30,20,14,0,29,10,182,26.0,9,0.0,19,30,17,14,60,0,3,29,10,80,102,0
1171,23206,ieR2oDuOBOWrOSx08B7vLKsdvt41Kjgw,bWdj2GDclj5ofokWjzoa5jAwMkxCykd6,8,15,1,0,2,4,5,1,28,4.0,3,0.0,3,1,0,2,12,4,0,5,1,6,22,1
1172,23234,BDdKHYPp1edgylVPYUBHaWJ6W3VobGdR,A3fsA9Zfv1X2fVEQhTw51lKENdNrEqT3,5,2,1,0,1,0,2,0,6,0.8571428571428571,1,0.0,0,1,0,1,2,0,0,2,0,2,4,1
1173,23251,bzY7Zh4yWh2gGtmeq5pe4zgMiusHTGEG,SpATywNh6bZuzm8s1ceuBUnMUAeoAHHw,25,80,2,49,1,2,26,1,161,23.0,2,0.0,38,2,41,1,42,2,8,26,1,82,79,0
1174,23299,FuoDsqlUs6ZIyTkMTIVnWx4xFWKln8DR,SpATywNh6bZuzm8s1ceuBUnMUAeoAHHw,15,28,12,12,7,0,5,0,64,9.142857142857142,4,0.0,6,12,12,7,22,0,0,5,0,37,27,0
1175,23316,QdSH85e6TVvHCb4lCpuXbYzwkD8QbL3t,G8EPVSXsOYB5YQWZGiz1aVq5Pgr2GrQu,34,62,28,8,21,1,9,0,129,18.428571428571427,4,0.0,3,28,5,21,59,1,3,9,0,57,72,0
1176,23322,w2sKd0cOObBRKhbutYISAGM6GUL3hKiJ,A3fsA9Zfv1X2fVEQhTw51lKENdNrEqT3,1,0,0,0,0,0,3,0,3,0.42857142857142855,2,0.0,0,0,0,0,0,0,0,3,0,0,3,1
1177,23324,RPoX07eqJOUgad0B2fv5ckLas5jasaoP,SpATywNh6bZuzm8s1ceuBUnMUAeoAHHw,17,31,9,35,0,1,8,1,85,12.142857142857142,2,0.0,13,9,33,0,18,1,2,8,1,55,30,1
1178,23329,v8AEmfj5ScfNiqWSiB9twce4e05jQ9FQ,SpATywNh6bZuzm8s1ceuBUnMUAeoAHHw,14,36,3,22,2,0,3,0,66,9.428571428571429,3,0.0,23,3,19,2,13,0,3,3,0,47,19,1
1179,23332,V1z8w9SjLbULVqlANveH3qv7vwfEbAs7,A3fsA9Zfv1X2fVEQhTw51lKENdNrEqT3,66,52,32,136,11,7,58,2,298,42.57142857142857,9,0.0,4,32,119,11,48,7,17,58,2,166,132,0
1180,23382,JMglfzDzzLZlgpswShgX51nDQKwTuVTV,A3fsA9Zfv1X2fVEQhTw51lKENdNrEqT3,1,0,0,0,0,0,1,0,1,0.14285714285714285,1,0.0,0,0,0,0,0,0,0,1,0,0,1,1
1181,23385,YA61oYIgn1IPmbXidnuJfNVCdVlD8MoO,SpATywNh6bZuzm8s1ceuBUnMUAeoAHHw,15,12,0,14,0,0,3,0,29,4.142857142857143,1,0.0,1,0,12,0,11,0,2,3,0,13,16,1
1182,23387,BQkLFspAkEwZRgeuoSbQxFTr6POAaRzP,RXDvfPUBYFlVdlueBFbLW0mhhAyGEqpt,1,0,0,0,0,0,1,0,1,0.14285714285714285,1,0.0,0,0,0,0,0,0,0,1,0,0,1,1
1183,23391,X8qfNjsHrwR5R67KkU9t7FXc6jQSGsyo,bWdj2GDclj5ofokWjzoa5jAwMkxCykd6,19,34,3,40,5,60,21,0,163,23.285714285714285,4,0.0,6,3,35,5,28,60,5,21,0,49,114,1
1184,23401,xMuijSepoYpWnTVSuzhdordHJTyRt87I,SpATywNh6bZuzm8s1ceuBUnMUAeoAHHw,28,56,22,35,4,100,24,1,242,34.57142857142857,4,0.0,16,22,31,4,40,100,4,24,1,73,169,1
1185,23403,GWG8afsUfRei9CIZYg1Y2sBsF64D5J9k,A3fsA9Zfv1X2fVEQhTw51lKENdNrEqT3,63,37,22,140,14,0,7,0,220,31.428571428571427,5,0.0,3,22,118,14,34,0,22,7,0,157,63,0
1186,23408,3rgatvueGycmzmQ7x6De7keieQ0tMDvZ,A3fsA9Zfv1X2fVEQhTw51lKENdNrEqT3,43,42,20,50,18,14,8,1,153,21.857142857142858,2,0.0,1,20,45,18,41,14,5,8,1,84,69,1
1187,23410,yGTKMCuyZTpBDN6edeGIEf8UqO2mMowi,SpATywNh6bZuzm8s1ceuBUnMUAeoAHHw,20,17,10,18,6,0,3,0,54,7.714285714285714,2,0.0,4,10,15,6,13,0,3,3,0,35,19,1
1188,23425,rWIeDjJz93lBgbp2QkVHj8gv55De3Px0,G8EPVSXsOYB5YQWZGiz1aVq5Pgr2GrQu,58,59,27,62,16,2,12,4,182,26.0,3,0.0,17,27,44,16,42,2,18,12,4,104,78,1
1189,23443,2XRKCevyRsuXIpuLiEj19nm5B7ajsjxd,SpATywNh6bZuzm8s1ceuBUnMUAeoAHHw,15,16,10,2,5,1,10,1,45,6.428571428571429,2,0.0,1,10,2,5,15,1,0,10,1,18,27,1
1190,23454,mP7U4YN4Z2p45M3a970DvaALst8JAKLF,SpATywNh6bZuzm8s1ceuBUnMUAeoAHHw,22,41,1,32,1,0,14,0,89,12.714285714285714,2,0.0,25,1,28,1,16,0,4,14,0,55,34,1
1191,23458,cAyxesGtWW4tBzueSc3JcCfBcF1iSxzo,SpATywNh6bZuzm8s1ceuBUnMUAeoAHHw,29,52,24,40,13,0,10,0,139,19.857142857142858,3,0.0,20,24,33,13,32,0,7,10,0,90,49,0
1192,23469,OTkfNwsIOtoJh2hERixG2jmKnV6iaybJ,SpATywNh6bZuzm8s1ceuBUnMUAeoAHHw,1,0,0,0,0,0,1,0,1,0.14285714285714285,1,0.0,0,0,0,0,0,0,0,1,0,0,1,1
1193,23485,oAqokxwZETOc0FlXbPrJtKYU20wkk4k3,SpATywNh6bZuzm8s1ceuBUnMUAeoAHHw,16,10,6,0,6,0,2,0,24,3.4285714285714284,1,0.0,0,6,0,6,10,0,0,2,0,12,12,1
1194,23496,lbe9cMTwmlycpcYHc5ZN07ZsGdA6t7WW,SpATywNh6bZuzm8s1ceuBUnMUAeoAHHw,9,9,1,0,0,1,6,1,18,2.5714285714285716,1,0.0,2,1,0,0,7,1,0,6,1,3,15,1
1195,23502,wNbKFPX6oYsfVEr8buyWthBblPuPZGxv,A3fsA9Zfv1X2fVEQhTw51lKENdNrEqT3,68,20,15,116,12,16,9,1,189,27.0,2,0.0,4,15,101,12,16,16,15,9,1,132,57,0
1196,23521,sNkOLwlXc0EK57Dlcru7W9TUcu8lkNDn,bWdj2GDclj5ofokWjzoa5jAwMkxCykd6,16,17,11,0,7,0,6,0,41,5.857142857142857,1,0.0,1,11,0,7,16,0,0,6,0,19,22,1
1197,23523,DsdEYwXt7PO92K8VROCVVtUqrprzaIo4,RXDvfPUBYFlVdlueBFbLW0mhhAyGEqpt,18,48,0,0,0,19,7,1,75,10.714285714285714,2,0.0,0,0,0,0,48,19,0,7,1,0,75,1
1198,23526,xC7QA3lJWLoIMEwPvqIxcLnCt0KwsxwT,G8EPVSXsOYB5YQWZGiz1aVq5Pgr2GrQu,89,94,40,263,30,4,12,1,444,63.42857142857143,4,0.0,42,40,224,30,52,4,39,12,1,336,108,1
1199,23530,CfoeUJ6vk7a3PuEp1yrQNFUplkLjQYge,SpATywNh6bZuzm8s1ceuBUnMUAeoAHHw,19,46,18,20,9,1,4,0,98,14.0,3,0.0,22,18,17,9,24,1,3,4,0,66,32,0
1200,23541,ACrAvl4ssWNFndB2wDhI3oY0Vqi5B1FR,SpATywNh6bZuzm8s1ceuBUnMUAeoAHHw,27,29,14,24,7,6,14,0,94,13.428571428571429,4,0.0,12,14,23,7,17,6,1,14,0,56,38,0
1201,23550,7yphMCe2LQupOHSaDA3UQC9kbDeEuBie,SpATywNh6bZuzm8s1ceuBUnMUAeoAHHw,5,3,2,0,2,0,2,0,9,1.2857142857142858,1,0.0,0,2,0,2,3,0,0,2,0,4,5,0
1202,23557,M6VmJD8JYDR5w6GV5uzAgWpIXM5eanml,SpATywNh6bZuzm8s1ceuBUnMUAeoAHHw,29,39,23,22,11,4,11,0,110,15.714285714285714,3,0.0,7,23,19,11,32,4,3,11,0,60,50,0
1203,23574,N8e8TX5f8OfPjOu3ngCuXkApyUMeZAHw,A3fsA9Zfv1X2fVEQhTw51lKENdNrEqT3,6,2,1,0,1,0,4,1,9,1.2857142857142858,1,0.0,0,1,0,1,2,0,0,4,1,2,7,1
1204,23576,mRXmcsJQnNw2mccUFVukDwZxk7roAYf4,SpATywNh6bZuzm8s1ceuBUnMUAeoAHHw,11,19,10,0,2,0,15,3,49,7.0,3,0.0,0,10,0,2,19,0,0,15,3,12,37,1
1205,23589,mptZxS2IRXAopBdChMP75EgVt5rtRsUT,SpATywNh6bZuzm8s1ceuBUnMUAeoAHHw,20,28,16,0,6,0,10,0,60,8.571428571428571,8,0.0,0,16,0,6,28,0,0,10,0,22,38,1
1206,23601,jKWIhuXmlYFBIapfd4E50TBTHed3oveP,A3fsA9Zfv1X2fVEQhTw51lKENdNrEqT3,13,15,7,0,5,0,3,0,30,4.285714285714286,3,0.0,0,7,0,5,15,0,0,3,0,12,18,1
1207,23616,VADc1m6JjTG2LuLkbhEfhADWJMHaDmqK,SpATywNh6bZuzm8s1ceuBUnMUAeoAHHw,6,15,11,0,0,3,3,0,32,4.571428571428571,6,0.0,0,11,0,0,15,3,0,3,0,11,21,0
1208,23621,HRaTe8gWBsDiLkzfbQMnooVDWfwWVb7m,SpATywNh6bZuzm8s1ceuBUnMUAeoAHHw,28,93,9,39,3,46,63,15,268,38.285714285714285,8,0.0,19,9,33,3,74,46,6,63,15,64,204,0
1209,23629,1GEou0jUAwSZvf4K9js5E10dDnbmQpAC,bWdj2GDclj5ofokWjzoa5jAwMkxCykd6,16,14,9,0,5,0,11,0,39,5.571428571428571,3,0.0,0,9,0,5,14,0,0,11,0,14,25,1
1210,23634,hs0BkyfSJv3crs4cIvcxkt53zip5FMPg,SpATywNh6bZuzm8s1ceuBUnMUAeoAHHw,14,16,10,12,4,1,5,0,48,6.857142857142857,4,0.0,3,10,12,4,13,1,0,5,0,29,19,1
1211,23642,04gG5zVwZ7Vr68t1LtjimV9KPqGTDxDK,SpATywNh6bZuzm8s1ceuBUnMUAeoAHHw,20,45,17,20,4,43,39,1,169,24.142857142857142,7,0.0,9,17,16,4,36,43,4,39,1,46,123,0
1212,23651,35E85h2ExBPeTd1VmxNX0GKo8krIMsCP,RXDvfPUBYFlVdlueBFbLW0mhhAyGEqpt,18,29,16,0,5,0,10,0,60,8.571428571428571,5,0.0,2,16,0,5,27,0,0,10,0,23,37,1
1213,23657,xM0eQ8CWGY7oZgCPJhirOkGhAfAvdQUi,SpATywNh6bZuzm8s1ceuBUnMUAeoAHHw,5,3,2,0,1,0,1,0,7,1.0,1,0.0,0,2,0,1,3,0,0,1,0,3,4,1
1214,23667,1NMKv7RE12uBMKwNJI30Cx8Z5ltMGoee,SpATywNh6bZuzm8s1ceuBUnMUAeoAHHw,28,44,27,16,18,0,5,0,110,15.714285714285714,3,0.0,12,27,16,18,32,0,0,5,0,73,37,0
1215,23672,F9d8ehlFxvqouYiZgUKxdbX5NI44Sbpl,SpATywNh6bZuzm8s1ceuBUnMUAeoAHHw,29,49,25,42,9,28,23,1,177,25.285714285714285,2,0.0,12,25,36,9,37,28,6,23,1,82,95,1
1216,23682,iSZJZtUn8nc9fyool89gRRN7Cq78oUfm,SpATywNh6bZuzm8s1ceuBUnMUAeoAHHw,25,17,9,21,7,0,2,0,56,8.0,1,0.0,7,9,20,7,10,0,1,2,0,43,13,0
1217,23694,PjedxGW8p1bztGxVlzTokusg6LFto1Md,bWdj2GDclj5ofokWjzoa5jAwMkxCykd6,1,0,0,0,0,0,1,0,1,0.14285714285714285,1,0.0,0,0,0,0,0,0,0,1,0,0,1,1
1218,23699,jM1yIagOMV2CwD8o07UMrVdo7z0hqKJ4,bWdj2GDclj5ofokWjzoa5jAwMkxCykd6,6,6,3,0,1,0,1,0,11,1.5714285714285714,1,0.0,1,3,0,1,5,0,0,1,0,5,6,0
1219,23720,zJDljX1Y3FrDgAuEWJGqwBvE3KAWJPAz,A3fsA9Zfv1X2fVEQhTw51lKENdNrEqT3,6,1,1,0,1,0,5,0,8,1.1428571428571428,1,0.0,0,1,0,1,1,0,0,5,0,2,6,1
1220,23724,wQU3lY7mCoAWFqnxNLhiEFrdAWtS5Hh9,SpATywNh6bZuzm8s1ceuBUnMUAeoAHHw,24,27,14,6,8,0,9,0,64,9.142857142857142,4,0.0,0,14,6,8,27,0,0,9,0,28,36,0
1221,23747,x3sZblYMoUvQJbk7l9GY688n7RQqaQct,A3fsA9Zfv1X2fVEQhTw51lKENdNrEqT3,13,15,2,0,1,0,2,0,20,2.857142857142857,2,0.0,0,2,0,1,15,0,0,2,0,3,17,1
1222,23751,zvOHbaUWjxRZ9zCYxYPMcUH4Ef5dE8Ae,RXDvfPUBYFlVdlueBFbLW0mhhAyGEqpt,7,8,0,0,0,0,4,0,12,1.7142857142857142,1,0.0,0,0,0,0,8,0,0,4,0,0,12,1
1223,23772,bQK35cKsW9Hy5fNgckzz4Jo7bFzQOyma,G8EPVSXsOYB5YQWZGiz1aVq5Pgr2GrQu,34,54,26,52,13,8,14,4,171,24.428571428571427,1,0.0,24,26,41,13,30,8,11,14,4,104,67,0
1224,23776,JoruyAOmEeM1qjcSEWRUjLvQUHpNPZGp,SpATywNh6bZuzm8s1ceuBUnMUAeoAHHw,14,34,0,12,0,24,15,1,86,12.285714285714286,2,0.0,10,0,9,0,24,24,3,15,1,19,67,1
1225,23787,ct5yYqhcbduN7OPtxPDjwHer2K46eeEH,bWdj2GDclj5ofokWjzoa5jAwMkxCykd6,8,7,1,0,2,0,4,0,14,2.0,1,0.0,2,1,0,2,5,0,0,4,0,5,9,1
1226,23811,kj5o7wMZl1s4q0cggcmipnm7O7L6g4Ps,SpATywNh6bZuzm8s1ceuBUnMUAeoAHHw,32,29,15,30,7,3,13,1,98,14.0,3,0.0,8,15,27,7,21,3,3,13,1,57,41,1
1227,23818,oAs7swdosdDbKq3u64wlCP6EHVlCh67P,bWdj2GDclj5ofokWjzoa5jAwMkxCykd6,8,18,9,0,6,0,5,0,38,5.428571428571429,2,0.0,0,9,0,6,18,0,0,5,0,15,23,1
1228,23839,xHZbSROhwP4RRQerUVWvcNTfOGc2DHWf,bWdj2GDclj5ofokWjzoa5jAwMkxCykd6,8,24,10,0,1,22,20,0,77,11.0,10,0.0,0,10,0,1,24,22,0,20,0,11,66,0
1229,23845,TSxGfcluByCTxwgFYbniUiwGZJ5ZTUOD,RXDvfPUBYFlVdlueBFbLW0mhhAyGEqpt,16,8,7,0,7,0,5,0,27,3.857142857142857,2,0.0,0,7,0,7,8,0,0,5,0,14,13,1
1230,23853,RERZDO4CwF9dxtSu0h5YmBuy5kxPiJg0,SpATywNh6bZuzm8s1ceuBUnMUAeoAHHw,12,22,3,22,2,0,3,0,52,7.428571428571429,2,0.0,9,3,19,2,13,0,3,3,0,33,19,0
1231,23859,XNb7KU6KeHuNJzclGX2ePynnmu8yxV3v,SpATywNh6bZuzm8s1ceuBUnMUAeoAHHw,28,49,11,22,6,7,11,0,106,15.142857142857142,2,0.0,4,11,18,6,45,7,4,11,0,39,67,0
1232,23866,7WsRevbkgPhYSJirD1kBI2okhIiuBQwH,A3fsA9Zfv1X2fVEQhTw51lKENdNrEqT3,2,0,0,0,0,0,3,0,3,0.42857142857142855,1,0.0,0,0,0,0,0,0,0,3,0,0,3,1
1233,23884,GJmfZNR8PZRpI11B5boI8G7Sd4djdQgk,SpATywNh6bZuzm8s1ceuBUnMUAeoAHHw,14,17,8,19,4,0,4,0,52,7.428571428571429,3,0.0,3,8,16,4,14,0,3,4,0,31,21,1
1234,23906,XIUlzpQjeuAoBiPuklTmwavmE8N5buiR,bWdj2GDclj5ofokWjzoa5jAwMkxCykd6,9,6,4,0,3,0,6,1,20,2.857142857142857,1,0.0,0,4,0,3,6,0,0,6,1,7,13,1
1235,23913,6MGET4duNnhYB7elJoLURxwHMKRGtg9y,bWdj2GDclj5ofokWjzoa5jAwMkxCykd6,8,16,4,20,4,0,4,0,48,6.857142857142857,2,0.0,8,4,19,4,8,0,1,4,0,35,13,1
1236,23962,5pjAdY5K4FfgQPLSzQKwXaKF78ph9a0y,RXDvfPUBYFlVdlueBFbLW0mhhAyGEqpt,52,180,82,128,35,27,37,0,489,69.85714285714286,8,0.0,23,82,119,35,157,27,9,37,0,259,230,0
1237,23977,tkDslnD6NXbenEreFtnV2nvNZ4GDJajz,RXDvfPUBYFlVdlueBFbLW0mhhAyGEqpt,6,5,2,0,0,0,6,0,13,1.8571428571428572,2,0.0,0,2,0,0,5,0,0,6,0,2,11,1
1238,23984,HAPPxnLUjIhcauBZnnWBFk3JE6gETTxa,SpATywNh6bZuzm8s1ceuBUnMUAeoAHHw,19,17,8,12,5,1,7,2,52,7.428571428571429,2,0.0,6,8,11,5,11,1,1,7,2,30,22,1
1239,23994,AkYabqnQmQubmhD6vLFPcIqa194wOTvs,SpATywNh6bZuzm8s1ceuBUnMUAeoAHHw,1,0,0,0,0,0,1,0,1,0.14285714285714285,1,0.0,0,0,0,0,0,0,0,1,0,0,1,1
1240,24000,tML4IQ8jFiP4YuH9NbvzKQFqAdof0qcO,SpATywNh6bZuzm8s1ceuBUnMUAeoAHHw,24,54,0,36,0,135,28,4,257,36.714285714285715,7,0.0,16,0,31,0,38,135,5,28,4,47,210,0
1241,24021,wPWqnGAkrR45TEYOXZpjGrKRubMl9rFP,SpATywNh6bZuzm8s1ceuBUnMUAeoAHHw,22,69,1,28,1,29,15,0,143,20.428571428571427,8,0.0,17,1,25,1,52,29,3,15,0,44,99,0
1242,24024,OIPBfPb9802WcbHz02njDB4ysP5ao9fe,SpATywNh6bZuzm8s1ceuBUnMUAeoAHHw,22,27,0,22,0,2,10,2,63,9.0,2,0.0,9,0,20,0,18,2,2,10,2,29,34,0
1243,24025,REvshIGXuaBWprkQ9qA5D33qmf3QiAwV,SpATywNh6bZuzm8s1ceuBUnMUAeoAHHw,21,21,18,12,14,0,3,0,68,9.714285714285714,2,0.0,0,18,10,14,21,0,2,3,0,42,26,0
1244,24049,koZ8gxZRuDJaBnv7V4tJo48rZ57BbCd4,SpATywNh6bZuzm8s1ceuBUnMUAeoAHHw,19,13,7,18,4,0,4,0,46,6.571428571428571,1,0.0,4,7,17,4,9,0,1,4,0,32,14,1
1245,24056,UKrQdzHwNJRJK7ZoTzKsoWlrkEbsQk7X,A3fsA9Zfv1X2fVEQhTw51lKENdNrEqT3,1,0,0,0,0,0,1,0,1,0.14285714285714285,1,0.0,0,0,0,0,0,0,0,1,0,0,1,1
1246,24076,hWoXRoePYaW50QNR65rI6g0ffdFAubIq,SpATywNh6bZuzm8s1ceuBUnMUAeoAHHw,17,17,9,2,6,0,4,1,39,5.571428571428571,1,0.0,0,9,2,6,17,0,0,4,1,17,22,1
1247,24086,wx9LUKj4KCj2VrJqkWxv5NlmYX9Bw5rx,RXDvfPUBYFlVdlueBFbLW0mhhAyGEqpt,29,72,5,32,7,0,23,1,140,20.0,2,0.0,11,5,29,7,61,0,3,23,1,52,88,1
1248,24122,4e4wTy2Vsuz8jVFYgJOgi1kIGDWREiPH,bWdj2GDclj5ofokWjzoa5jAwMkxCykd6,25,65,19,46,7,1,23,6,167,23.857142857142858,4,0.0,16,19,43,7,49,1,3,23,6,85,82,0
1249,24132,je9A6l6tP7wnbFhNJD7vbbHTYhqshuqB,SpATywNh6bZuzm8s1ceuBUnMUAeoAHHw,8,28,9,0,2,1,6,0,46,6.571428571428571,4,0.0,12,9,0,2,16,1,0,6,0,23,23,1
1250,24135,yntNdGOvrRZS9CTrjjNKRRz96Mc1JGbf,bWdj2GDclj5ofokWjzoa5jAwMkxCykd6,7,10,2,46,2,0,2,0,62,8.857142857142858,2,0.0,5,2,46,2,5,0,0,2,0,55,7,1
1251,24138,tCb9JPhOhIatDlJOcmjorPeSIRsd6N1b,SpATywNh6bZuzm8s1ceuBUnMUAeoAHHw,26,56,3,26,3,0,11,0,99,14.142857142857142,3,0.0,13,3,20,3,43,0,6,11,0,39,60,0
1252,24148,uvl7kPB3Po3jrDtnQvCsunCWcJhdeQPU,bWdj2GDclj5ofokWjzoa5jAwMkxCykd6,1,0,0,0,0,0,2,0,2,0.2857142857142857,2,0.0,0,0,0,0,0,0,0,2,0,0,2,1
1253,24151,c7klirhrxknzNn3AkRTiBI36lun1Z17S,SpATywNh6bZuzm8s1ceuBUnMUAeoAHHw,7,4,3,0,2,0,2,0,11,1.5714285714285714,1,0.0,0,3,0,2,4,0,0,2,0,5,6,1
1254,24155,uUKSUB3HEdGhPX6CV6kspFVUkErIumI9,SpATywNh6bZuzm8s1ceuBUnMUAeoAHHw,18,11,5,14,4,6,4,0,44,6.285714285714286,2,0.0,2,5,12,4,9,6,2,4,0,23,21,1
1255,24169,s4TNdVBVykBR8x72RZEnjBx6ebkwwW3k,SpATywNh6bZuzm8s1ceuBUnMUAeoAHHw,1,0,0,0,0,0,1,0,1,0.14285714285714285,1,0.0,0,0,0,0,0,0,0,1,0,0,1,1
1256,24249,A1MWkFESy8kUA44NvA6UlE1jbCsV980k,SpATywNh6bZuzm8s1ceuBUnMUAeoAHHw,6,5,1,0,1,0,3,0,10,1.4285714285714286,1,0.0,0,1,0,1,5,0,0,3,0,2,8,1
1257,24277,hzJi6Q52SSiJSH5oo1cc45XsfYCFzZYG,SpATywNh6bZuzm8s1ceuBUnMUAeoAHHw,7,7,2,0,2,0,3,0,14,2.0,2,0.0,0,2,0,2,7,0,0,3,0,4,10,1
1258,24287,Ms0MC4W5moiGJLWP7iE3FImeH9CHN4KT,bWdj2GDclj5ofokWjzoa5jAwMkxCykd6,15,48,12,16,4,6,17,1,104,14.857142857142858,7,0.0,13,12,13,4,35,6,3,17,1,42,62,0
1259,24303,pYcnIzYPgb3xzrOvmR9y0UUIZo4gqKuO,RXDvfPUBYFlVdlueBFbLW0mhhAyGEqpt,50,97,57,92,19,5,20,3,293,41.857142857142854,7,0.0,19,57,81,19,78,5,11,20,3,176,117,0
1260,24304,UzwJVyLJF6Ih9iHYPyYWMullgIr89o5m,RXDvfPUBYFlVdlueBFbLW0mhhAyGEqpt,66,143,80,103,24,12,36,0,398,56.857142857142854,9,0.0,24,80,98,24,119,12,5,36,0,226,172,0
1261,24312,wGN3pCdk72KFTm52vXIRH474TFtQqduI,SpATywNh6bZuzm8s1ceuBUnMUAeoAHHw,29,35,20,29,14,0,5,0,103,14.714285714285714,2,0.0,10,20,28,14,25,0,1,5,0,72,31,0
1262,24325,bPrEBQILvyBjp3odJGGZ7KxlAV5Gu9sz,SpATywNh6bZuzm8s1ceuBUnMUAeoAHHw,18,26,14,17,5,3,14,6,85,12.142857142857142,2,0.0,6,14,16,5,20,3,1,14,6,41,44,0
1263,24332,NY9lbGArbud0VjFCO45IgKzDykuc5Wkn,SpATywNh6bZuzm8s1ceuBUnMUAeoAHHw,28,80,48,30,45,0,8,0,211,30.142857142857142,3,0.0,14,48,30,45,66,0,0,8,0,137,74,1
1264,24358,IIdYSsTHK0XdI7wZc5S09iVifP1zJLzN,SpATywNh6bZuzm8s1ceuBUnMUAeoAHHw,15,50,25,14,0,15,29,1,134,19.142857142857142,5,0.0,11,25,11,0,39,15,3,29,1,47,87,1
1265,24361,dWVj5G83xAxBDmPzLgLHfDC3pxyIk4K1,A3fsA9Zfv1X2fVEQhTw51lKENdNrEqT3,7,3,2,0,2,0,2,0,9,1.2857142857142858,1,0.0,0,2,0,2,3,0,0,2,0,4,5,1
1266,24370,nuKEM7FMFD9npzL9DafH3T1pYgMoLJoQ,SpATywNh6bZuzm8s1ceuBUnMUAeoAHHw,18,44,20,12,9,0,8,0,93,13.285714285714286,6,0.0,6,20,10,9,38,0,2,8,0,45,48,0
1267,24373,5p4xnVU1oXqeHfhqOsPC09VPLJWVQgy1,SpATywNh6bZuzm8s1ceuBUnMUAeoAHHw,20,18,13,8,6,2,12,1,60,8.571428571428571,3,0.0,2,13,7,6,16,2,1,12,1,28,32,1
1268,24383,Ialz252wY3knIVjOtCWLYcvvPO6EGRFT,SpATywNh6bZuzm8s1ceuBUnMUAeoAHHw,21,33,4,30,0,4,8,0,79,11.285714285714286,4,0.0,11,4,28,0,22,4,2,8,0,43,36,0
1269,24388,4v506xwnN2gFG9XeSNIeiBlmXImooi1O,SpATywNh6bZuzm8s1ceuBUnMUAeoAHHw,26,63,31,24,14,2,16,0,150,21.428571428571427,4,0.0,12,31,21,14,51,2,3,16,0,78,72,0
1270,24394,Zhz7dkJdB0wauB8JtGSDj0NsuH0ZH8Cd,SpATywNh6bZuzm8s1ceuBUnMUAeoAHHw,11,9,6,0,4,0,4,0,23,3.2857142857142856,2,0.0,0,6,0,4,9,0,0,4,0,10,13,1
1271,24410,F95Wv3qn0qNK1jUsJHuRDZbU4th6dVHD,RXDvfPUBYFlVdlueBFbLW0mhhAyGEqpt,1,0,0,0,0,0,1,0,1,0.14285714285714285,1,0.0,0,0,0,0,0,0,0,1,0,0,1,1
1272,24430,ADFd6U5gb8MuQY2di0urTV7aR0h11Ir1,bWdj2GDclj5ofokWjzoa5jAwMkxCykd6,2,0,0,0,0,0,2,0,2,0.2857142857142857,1,0.0,0,0,0,0,0,0,0,2,0,0,2,1
1273,24444,mFNGHC6aCmhHmhRXFCDO0uvnGnNYaro0,A3fsA9Zfv1X2fVEQhTw51lKENdNrEqT3,7,6,2,0,1,0,3,0,12,1.7142857142857142,3,0.0,0,2,0,1,6,0,0,3,0,3,9,1
1274,24476,1yAfuEW0CNQiRXnPO0v79LFUyx4hhTWm,A3fsA9Zfv1X2fVEQhTw51lKENdNrEqT3,1,0,0,0,0,0,1,0,1,0.14285714285714285,1,0.0,0,0,0,0,0,0,0,1,0,0,1,1
1275,24481,MlSRfdfvLbnwipGT1vckZAUcsWbqV0Nz,bWdj2GDclj5ofokWjzoa5jAwMkxCykd6,35,22,12,145,6,0,12,0,197,28.142857142857142,3,0.0,9,12,131,6,13,0,14,12,0,158,39,0
1276,24484,B5XH6YQeVGrE18VTFwIQP3iU5E4UvLjO,SpATywNh6bZuzm8s1ceuBUnMUAeoAHHw,1,0,0,0,0,0,1,0,1,0.14285714285714285,1,0.0,0,0,0,0,0,0,0,1,0,0,1,1
1277,24495,MhaNzTwlOubA2mdN8jvZF4ySj9a3XsvZ,G8EPVSXsOYB5YQWZGiz1aVq5Pgr2GrQu,18,19,16,32,6,0,4,0,77,11.0,1,0.0,0,16,29,6,19,0,3,4,0,51,26,1
1278,24518,iXoEMwcJ5o4IM7VKZ5pyam9GxPy4olUQ,A3fsA9Zfv1X2fVEQhTw51lKENdNrEqT3,1,0,0,0,0,0,2,0,2,0.2857142857142857,1,0.0,0,0,0,0,0,0,0,2,0,0,2,1
1279,24521,iXoEMwcJ5o4IM7VKZ5pyam9GxPy4olUQ,SpATywNh6bZuzm8s1ceuBUnMUAeoAHHw,6,5,2,0,1,0,2,0,10,1.4285714285714286,2,0.0,0,2,0,1,5,0,0,2,0,3,7,1
1280,24527,iXoEMwcJ5o4IM7VKZ5pyam9GxPy4olUQ,RXDvfPUBYFlVdlueBFbLW0mhhAyGEqpt,1,0,0,0,0,0,3,0,3,0.42857142857142855,1,0.0,0,0,0,0,0,0,0,3,0,0,3,1
1281,24532,Hxi6d4DzV7K1jcnZIhXlJzpIYDP4sYeZ,G8EPVSXsOYB5YQWZGiz1aVq5Pgr2GrQu,35,38,1,138,4,0,6,0,187,26.714285714285715,3,0.0,20,1,130,4,18,0,8,6,0,155,32,0
1282,24567,QDaW6SyhKIOYnUckUXKfy6A7QKIp9Kb8,bWdj2GDclj5ofokWjzoa5jAwMkxCykd6,3,0,0,0,0,8,4,0,12,1.7142857142857142,1,0.0,0,0,0,0,0,8,0,4,0,0,12,1
1283,24629,ja7eUjcxSqFnoRSNZAdtMUdo5WLyuwNj,RXDvfPUBYFlVdlueBFbLW0mhhAyGEqpt,17,16,10,0,6,0,8,3,43,6.142857142857143,3,0.0,2,10,0,6,14,0,0,8,3,18,25,1
1284,24645,0JvlwMe8wRQNeLJu71UvJCaEJca2naUP,bWdj2GDclj5ofokWjzoa5jAwMkxCykd6,11,17,12,0,7,4,13,0,53,7.571428571428571,3,0.0,0,12,0,7,17,4,0,13,0,19,34,0
1285,24656,LpLPysd45mBlrVFCgTTBBbMGnlXmZLO1,7GRhBDsirIGkRZBtSMEzNTyDr2JQm4xx,34,125,31,41,10,29,28,4,268,38.285714285714285,6,0.0,46,31,39,10,79,29,2,28,4,126,142,1
1286,24674,99qhCmy07rsquumjTFRELTtrLHpQpj07,bWdj2GDclj5ofokWjzoa5jAwMkxCykd6,7,11,5,0,2,0,5,0,23,3.2857142857142856,3,0.0,0,5,0,2,11,0,0,5,0,7,16,0
1287,24729,z9sj5HIJml1DMOMfRKKBQ7IvS2IoE424,7GRhBDsirIGkRZBtSMEzNTyDr2JQm4xx,18,55,18,0,2,4,9,5,93,13.285714285714286,2,0.0,19,18,0,2,36,4,0,9,5,39,54,1
1288,24760,NVJD7a4veZi4dOPtkddbSAsIN5dFV8jt,SpATywNh6bZuzm8s1ceuBUnMUAeoAHHw,20,30,14,17,4,24,29,4,122,17.428571428571427,3,0.0,11,14,16,4,19,24,1,29,4,45,77,0
1289,24775,FeUvHE3xENj0OT6fhaRqvHDDKwwtsMRR,SpATywNh6bZuzm8s1ceuBUnMUAeoAHHw,28,47,25,23,12,0,10,0,117,16.714285714285715,6,0.0,12,25,21,12,35,0,2,10,0,70,47,0
1290,24821,2Hx9g01WcHXaoIvHRFrUfZqDWuVhvV5b,SpATywNh6bZuzm8s1ceuBUnMUAeoAHHw,20,31,1,27,0,0,6,0,65,9.285714285714286,1,0.0,9,1,26,0,22,0,1,6,0,36,29,0
1291,24841,GfRp1O86gI5zJJh8SIJ1bczUJPWlAqoK,7GRhBDsirIGkRZBtSMEzNTyDr2JQm4xx,37,130,28,40,8,16,26,2,250,35.714285714285715,8,0.0,15,28,32,8,115,16,8,26,2,83,167,1
1292,24860,FPPbdZs5zRERbNXCB9udITtxlck6dBd9,SpATywNh6bZuzm8s1ceuBUnMUAeoAHHw,22,47,1,18,0,66,12,4,148,21.142857142857142,4,0.0,9,1,17,0,38,66,1,12,4,27,121,0
1293,24875,97rJErYjCaSZkM2sQr4Hy3em0yNLLl9Z,7GRhBDsirIGkRZBtSMEzNTyDr2JQm4xx,50,230,72,134,15,91,18,0,560,80.0,2,0.0,85,72,122,15,145,91,12,18,0,294,266,0
1294,24928,TG3ztGx3Y2jZOJDYHqGnCtBQf1aN9Xf7,7GRhBDsirIGkRZBtSMEzNTyDr2JQm4xx,15,36,15,12,11,2,17,1,94,13.428571428571429,3,0.0,14,15,10,11,22,2,2,17,1,50,44,1
1295,24975,KKySZH8Vhrdd4z2bRf8FAPkHeGpE3JpX,7GRhBDsirIGkRZBtSMEzNTyDr2JQm4xx,17,29,3,16,1,0,9,0,58,8.285714285714286,3,0.0,5,3,15,1,24,0,1,9,0,24,34,1
1296,25008,AlPSASl29ys7OO31KpYSADARO0IiSNGm,SpATywNh6bZuzm8s1ceuBUnMUAeoAHHw,9,10,6,0,3,0,3,0,22,3.142857142857143,2,0.0,0,6,0,3,10,0,0,3,0,9,13,1
1297,25128,5ysSxswt94Gjj7n5OSEcRzDBWhgbKFUg,SpATywNh6bZuzm8s1ceuBUnMUAeoAHHw,27,38,18,18,7,0,5,0,86,12.285714285714286,4,0.0,15,18,17,7,23,0,1,5,0,57,29,0
1298,25140,s4t4u8r9weCt43Z5PXbFAgqmS5WJ6hj5,G8EPVSXsOYB5YQWZGiz1aVq5Pgr2GrQu,30,47,2,50,2,27,12,1,141,20.142857142857142,4,0.0,20,2,32,2,27,27,18,12,1,56,85,1
1299,25196,3Oka5GvBd9TakXRvr9D5vxoJEhxwuxJA,RXDvfPUBYFlVdlueBFbLW0mhhAyGEqpt,72,123,78,169,27,22,28,6,453,64.71428571428571,7,0.0,27,78,159,27,96,22,10,28,6,291,162,0
1300,25206,36GRXkIW2SpIWQz7gvMq2JRXacytqSzV,SpATywNh6bZuzm8s1ceuBUnMUAeoAHHw,32,44,22,25,13,20,21,1,146,20.857142857142858,3,0.0,14,22,25,13,30,20,0,21,1,74,72,0
1301,25236,JmXGzVVfQa5TXaQwtZdggsgBkbZbIeH5,bWdj2GDclj5ofokWjzoa5jAwMkxCykd6,19,31,14,56,6,4,12,1,124,17.714285714285715,6,0.0,7,14,53,6,24,4,3,12,1,80,44,0
1302,25289,YfHmALaAUVJkTXPVPoa3sijNQuWgYS7R,SpATywNh6bZuzm8s1ceuBUnMUAeoAHHw,28,40,24,12,15,0,5,0,96,13.714285714285714,1,0.0,9,24,12,15,31,0,0,5,0,60,36,0
1303,25306,ETzcC9n39CwhBb4MTbqq1Ng4NqGIoiPj,7GRhBDsirIGkRZBtSMEzNTyDr2JQm4xx,4,2,1,0,1,0,1,0,5,0.7142857142857143,1,0.0,0,1,0,1,2,0,0,1,0,2,3,1
1304,25356,fi7yn2cMGfx1Smhd75ueCIU0DN0YeZ9i,7GRhBDsirIGkRZBtSMEzNTyDr2JQm4xx,12,14,9,6,5,0,3,0,37,5.285714285714286,1,0.0,2,9,6,5,12,0,0,3,0,22,15,1
1305,25416,RyJBTIZudHI18CHfqwWV9lrFHUkffvwx,SpATywNh6bZuzm8s1ceuBUnMUAeoAHHw,16,14,6,10,3,6,3,0,42,6.0,1,0.0,2,6,9,3,12,6,1,3,0,20,22,1
1306,25481,nXaqEEEC1RuDpdV8FF2KPpkhT6oc7g9j,bWdj2GDclj5ofokWjzoa5jAwMkxCykd6,13,14,5,84,4,6,3,1,117,16.714285714285715,1,0.0,8,5,83,4,6,6,1,3,1,100,17,1
1307,25504,QwlvYaP7UrFUsGUYZvCsolFqg7cM2XS7,7GRhBDsirIGkRZBtSMEzNTyDr2JQm4xx,35,95,45,49,16,8,27,3,243,34.714285714285715,2,0.0,36,45,40,16,59,8,9,27,3,137,106,1
1308,25508,ymIU6ycPRruHx8VRvXTFr9yvjJtz8pmG,SpATywNh6bZuzm8s1ceuBUnMUAeoAHHw,8,6,2,6,1,9,1,0,25,3.5714285714285716,1,0.0,2,2,6,1,4,9,0,1,0,11,14,0
1309,25510,SXQudUQxotVyHX3jIj58IdonMUWj4z4L,SpATywNh6bZuzm8s1ceuBUnMUAeoAHHw,30,62,35,31,16,26,36,3,209,29.857142857142858,3,0.0,12,35,27,16,50,26,4,36,3,90,119,0
1310,25577,s5bmHBniKJzstjkFlsJcJn6YQEnj7XjP,RXDvfPUBYFlVdlueBFbLW0mhhAyGEqpt,1,0,0,0,0,0,1,0,1,0.14285714285714285,1,0.0,0,0,0,0,0,0,0,1,0,0,1,1
1311,25593,BiaPgBnlrEY2EiwA20PKZL3VeANI5Sfw,SpATywNh6bZuzm8s1ceuBUnMUAeoAHHw,16,30,11,37,1,0,6,0,85,12.142857142857142,3,0.0,15,11,31,1,15,0,6,6,0,58,27,1
1312,25630,F1N61tazho7ZYPRPggPaCszBndAmmJFa,7GRhBDsirIGkRZBtSMEzNTyDr2JQm4xx,1,0,0,0,0,0,1,0,1,0.14285714285714285,1,0.0,0,0,0,0,0,0,0,1,0,0,1,1
1313,25633,LeLXLvHK2djzEG514AFcju6wr7gFXkH2,SpATywNh6bZuzm8s1ceuBUnMUAeoAHHw,27,84,33,41,10,89,51,10,318,45.42857142857143,7,0.0,29,33,35,10,55,89,6,51,10,107,211,1
1314,25637,zrKKa8AP5la65fKoXkp4sUMfYYb2eAtF,G8EPVSXsOYB5YQWZGiz1aVq5Pgr2GrQu,9,16,2,0,1,0,10,0,29,4.142857142857143,3,0.0,0,2,0,1,16,0,0,10,0,3,26,1
1315,25652,HrUHfBacH3u3gfsauI41ANlvNzWZshRh,A3fsA9Zfv1X2fVEQhTw51lKENdNrEqT3,67,34,23,160,16,0,7,0,240,34.285714285714285,5,0.0,2,23,143,16,32,0,17,7,0,184,56,0
1316,25653,TJlb1m2PM0vBaKFhpndqRNwoSVpMlE8f,A3fsA9Zfv1X2fVEQhTw51lKENdNrEqT3,2,0,0,0,0,0,3,0,3,0.42857142857142855,1,0.0,0,0,0,0,0,0,0,3,0,0,3,1
1317,25658,HlYiU2TA92it9HWOPDlsBmlpdZ7J7QTJ,bWdj2GDclj5ofokWjzoa5jAwMkxCykd6,8,7,3,0,1,1,7,1,20,2.857142857142857,3,0.0,0,3,0,1,7,1,0,7,1,4,16,1
1318,25673,gyFw0Vge0Tj4Yoavkd7TNvnmTGksA31j,SpATywNh6bZuzm8s1ceuBUnMUAeoAHHw,27,26,10,38,7,0,4,0,85,12.142857142857142,2,0.0,15,10,31,7,11,0,7,4,0,63,22,0
1319,25735,pwnvfCtqibSBzw9gewKZFVOUFkyHecrp,SpATywNh6bZuzm8s1ceuBUnMUAeoAHHw,6,5,0,0,0,0,2,0,7,1.0,1,0.0,0,0,0,0,5,0,0,2,0,0,7,1
1320,25765,E31WqWw5nCEWlSKgmhsOSj5j4T79ypCl,SpATywNh6bZuzm8s1ceuBUnMUAeoAHHw,31,67,31,47,11,3,18,1,178,25.428571428571427,5,0.0,26,31,38,11,41,3,9,18,1,106,72,0
1321,25807,Zl8ThqnwtmFsX5mPsLsbut5BCVNIbE7S,SpATywNh6bZuzm8s1ceuBUnMUAeoAHHw,3,3,0,0,0,0,1,0,4,0.5714285714285714,1,0.0,0,0,0,0,3,0,0,1,0,0,4,0
1322,25837,b5Gj1OyeYKLhLlGsleyNSSJpbJ2lneFj,SpATywNh6bZuzm8s1ceuBUnMUAeoAHHw,16,14,5,13,3,0,11,1,47,6.714285714285714,2,0.0,7,5,13,3,7,0,0,11,1,28,19,1
1323,25844,o9m1fMq17KjyGUhfLHLXFO5hoKQ5jU6O,SpATywNh6bZuzm8s1ceuBUnMUAeoAHHw,10,23,1,0,0,0,7,0,31,4.428571428571429,3,0.0,5,1,0,0,18,0,0,7,0,6,25,1
1324,25864,koGmxwg6FRa19ZshKXnyLXLosS5G7cau,7GRhBDsirIGkRZBtSMEzNTyDr2JQm4xx,29,120,1,75,10,1,20,5,232,33.142857142857146,3,0.0,66,1,65,10,54,1,10,20,5,142,90,1
1325,25883,HrUHfBacH3u3gfsauI41ANlvNzWZshRh,SpATywNh6bZuzm8s1ceuBUnMUAeoAHHw,21,44,20,19,4,6,19,4,116,16.571428571428573,5,0.0,15,20,18,4,29,6,1,19,4,57,59,0
1326,25888,81OLbBMdpNpbkVstjKtzJy0bjbBi99mi,SpATywNh6bZuzm8s1ceuBUnMUAeoAHHw,2,0,0,0,0,0,2,0,2,0.2857142857142857,1,0.0,0,0,0,0,0,0,0,2,0,0,2,1
1327,25895,DLDhUvvvfnnYFJuV65Zt2yaS0jPJgvzq,SpATywNh6bZuzm8s1ceuBUnMUAeoAHHw,18,43,0,26,0,1,13,1,84,12.0,4,0.0,25,0,24,0,18,1,2,13,1,49,35,0
1328,25901,pIkx6nDAjTla5NYVEsjhMXOIu5zXDzmO,SpATywNh6bZuzm8s1ceuBUnMUAeoAHHw,14,14,7,0,3,3,10,1,38,5.428571428571429,3,0.0,0,7,0,3,14,3,0,10,1,10,28,0
1329,25952,TzT0azKrocJxLmhFJi2IdfFfROivFDi7,7GRhBDsirIGkRZBtSMEzNTyDr2JQm4xx,7,7,0,0,0,0,4,1,12,1.7142857142857142,1,0.0,0,0,0,0,7,0,0,4,1,0,12,1
1330,25963,3Ew3yAxjSntFFYCyahG9TNwPBtEjhvBu,SpATywNh6bZuzm8s1ceuBUnMUAeoAHHw,26,28,18,4,11,8,11,3,83,11.857142857142858,2,0.0,6,18,4,11,22,8,0,11,3,39,44,1
1331,25994,2jj1hSNZOKn7YixrkMYiulmQRlxNCAKp,SpATywNh6bZuzm8s1ceuBUnMUAeoAHHw,7,5,0,4,0,0,1,0,10,1.4285714285714286,1,0.0,0,0,4,0,5,0,0,1,0,4,6,1
1332,26027,l5LfU8gApOG72AnBkdAbfOLQLwFH7Zo2,A3fsA9Zfv1X2fVEQhTw51lKENdNrEqT3,6,6,2,0,0,0,3,0,11,1.5714285714285714,1,0.0,1,2,0,0,5,0,0,3,0,3,8,0
1333,26033,6izQCEneEK1X6C1taxn0XENXkSv3cl84,A3fsA9Zfv1X2fVEQhTw51lKENdNrEqT3,20,16,8,22,5,0,2,0,53,7.571428571428571,1,0.0,0,8,20,5,16,0,2,2,0,33,20,0
1334,26148,JqvGTplcVBLcq3YzEUVslmYGYOBREBZ1,SpATywNh6bZuzm8s1ceuBUnMUAeoAHHw,19,26,5,18,2,5,10,0,66,9.428571428571429,5,0.0,6,5,16,2,20,5,2,10,0,29,37,0
1335,26208,USLTnsAwagwK2c83KXd1SNEeENnzkTTo,7GRhBDsirIGkRZBtSMEzNTyDr2JQm4xx,10,6,4,0,3,37,29,0,79,11.285714285714286,10,0.0,0,4,0,3,6,37,0,29,0,7,72,0
1336,26236,b3xaxczfVryBkeC1YPbXWEZUleYIZAnq,SpATywNh6bZuzm8s1ceuBUnMUAeoAHHw,18,26,10,21,6,15,15,1,94,13.428571428571429,3,0.0,15,10,18,6,11,15,3,15,1,49,45,1
1337,26255,v6GmjzoPMSZcgdRV04c3r4zmEQVHxeod,A3fsA9Zfv1X2fVEQhTw51lKENdNrEqT3,7,4,2,0,2,0,1,0,9,1.2857142857142858,1,0.0,0,2,0,2,4,0,0,1,0,4,5,1
1338,26286,d5fIWN5kvqsn40aHFJvoDDo4RHSEcHNo,SpATywNh6bZuzm8s1ceuBUnMUAeoAHHw,7,5,0,3,0,0,1,0,9,1.2857142857142858,1,0.0,0,0,3,0,5,0,0,1,0,3,6,1
1339,26297,UjnOd8eB67vR87Hc1uvDJpBawBhqSd4C,SpATywNh6bZuzm8s1ceuBUnMUAeoAHHw,11,35,7,31,1,0,5,0,79,11.285714285714286,4,0.0,21,7,27,1,14,0,4,5,0,56,23,1
1340,26310,vuslHI1UxdeXKs1vDUvKXYQqg3X9k91E,7GRhBDsirIGkRZBtSMEzNTyDr2JQm4xx,7,3,2,0,2,0,3,0,10,1.4285714285714286,3,0.0,0,2,0,2,3,0,0,3,0,4,6,1
1341,26322,XMtcnsDNasKCOMBWrsjCVH5NONQyEryR,A3fsA9Zfv1X2fVEQhTw51lKENdNrEqT3,45,31,24,70,21,1,10,1,158,22.571428571428573,2,0.0,2,24,60,21,29,1,10,10,1,107,51,0
1342,26326,drIV8ws6G2eFjZA06SdUOTyJLvhyaXrd,SpATywNh6bZuzm8s1ceuBUnMUAeoAHHw,16,16,8,12,0,0,10,1,47,6.714285714285714,5,0.0,4,8,12,0,12,0,0,10,1,24,23,0
1343,26407,Do8hbesbT6OBtmo3AMshqQTnDUWGEYzY,bWdj2GDclj5ofokWjzoa5jAwMkxCykd6,15,25,14,38,9,6,5,0,97,13.857142857142858,3,0.0,2,14,35,9,23,6,3,5,0,60,37,0
1344,26411,XGWArK05Wzjd8AdGaPxkShZOu2YZKkZ4,SpATywNh6bZuzm8s1ceuBUnMUAeoAHHw,11,18,8,0,3,3,6,0,38,5.428571428571429,2,0.0,0,8,0,3,18,3,0,6,0,11,27,0
1345,26435,N0Sos51WanCzoSGKDmMPzQtMlLxY3bFb,bWdj2GDclj5ofokWjzoa5jAwMkxCykd6,23,59,34,22,15,18,51,3,202,28.857142857142858,7,0.0,5,34,20,15,54,18,2,51,3,74,128,0
1346,26442,C8XrXSQZNN8RR6xEeSRWbKA5jTxVTtPT,SpATywNh6bZuzm8s1ceuBUnMUAeoAHHw,20,20,12,0,8,0,2,0,42,6.0,1,0.0,7,12,0,8,13,0,0,2,0,27,15,0
1347,26499,5dvfr5EjWeXuIobwrgh7MVbCslwNXi21,SpATywNh6bZuzm8s1ceuBUnMUAeoAHHw,9,5,2,0,1,0,5,0,13,1.8571428571428572,1,0.0,0,2,0,1,5,0,0,5,0,3,10,0
1348,26511,wdK5DIKl9qd73hM1uOx3ufcKj0J9AcRr,SpATywNh6bZuzm8s1ceuBUnMUAeoAHHw,28,56,38,27,24,1,8,0,154,22.0,5,0.0,11,38,24,24,45,1,3,8,0,97,57,1
1349,26593,yYrk7RmkclaZIv32ppfmidCUMKYlGdCg,7GRhBDsirIGkRZBtSMEzNTyDr2JQm4xx,34,38,10,61,11,13,10,1,144,20.571428571428573,2,0.0,26,10,53,11,12,13,8,10,1,100,44,1
1350,26625,chwuEH1iMc682zjOmO4zFwwfUl1drv8Q,RXDvfPUBYFlVdlueBFbLW0mhhAyGEqpt,65,59,30,95,23,7,13,0,227,32.42857142857143,6,0.0,23,30,91,23,36,7,4,13,0,167,60,0
1351,26678,OsS1Y0pb3ORCYhSo3uyNzAmfIGWlMI5F,SpATywNh6bZuzm8s1ceuBUnMUAeoAHHw,9,28,5,0,3,10,11,5,62,8.857142857142858,1,0.0,4,5,0,3,24,10,0,11,5,12,50,1
1352,26704,OF8cZCIXPsuM4CdS1yd3vA1SWWYblMbf,SpATywNh6bZuzm8s1ceuBUnMUAeoAHHw,16,19,8,12,3,0,5,0,47,6.714285714285714,2,0.0,8,8,12,3,11,0,0,5,0,31,16,0
1353,26733,M507IlBQp64NkSWnSkchjsahApLaE1kJ,7GRhBDsirIGkRZBtSMEzNTyDr2JQm4xx,4,2,1,0,1,0,1,0,5,0.7142857142857143,1,0.0,0,1,0,1,2,0,0,1,0,2,3,1
1354,26769,QKh6yCjm7KCBJwTgcTdbJMWujg3bWjbd,SpATywNh6bZuzm8s1ceuBUnMUAeoAHHw,25,53,14,30,5,12,14,0,128,18.285714285714285,4,0.0,17,14,27,5,36,12,3,14,0,63,65,0
1355,26806,v3af5rWc4AOfzZv6mvaIgDKPH5PLVH0T,RXDvfPUBYFlVdlueBFbLW0mhhAyGEqpt,16,29,17,0,3,62,19,2,132,18.857142857142858,2,0.0,0,17,0,3,29,62,0,19,2,20,112,0
1356,26857,g44r9jnfvUwG99HEAhIahumgutn1iCtI,SpATywNh6bZuzm8s1ceuBUnMUAeoAHHw,29,45,21,29,9,0,10,0,114,16.285714285714285,3,0.0,15,21,26,9,30,0,3,10,0,71,43,0
1357,26878,zNRtwNQkiCM9OW1nTIM2OGHUm9Iu3JVP,RXDvfPUBYFlVdlueBFbLW0mhhAyGEqpt,61,73,5,136,5,9,15,2,245,35.0,6,0.0,19,5,126,5,54,9,10,15,2,155,90,0
1358,26879,nE23LYiQpabdXkj6YvKSja9sZnHRizmo,A3fsA9Zfv1X2fVEQhTw51lKENdNrEqT3,5,11,0,0,0,0,3,0,14,2.0,4,0.0,0,0,0,0,11,0,0,3,0,0,14,0
1359,26899,SKqtOWa2uBCWLrCYlzFMjf1B70kuA2m8,SpATywNh6bZuzm8s1ceuBUnMUAeoAHHw,17,21,11,14,3,10,9,0,68,9.714285714285714,1,0.0,6,11,12,3,15,10,2,9,0,32,36,0
1360,26917,y4PYMDG8u2c0Sgi9Ir3ypCxWz9jGy1hk,7GRhBDsirIGkRZBtSMEzNTyDr2JQm4xx,2,0,0,0,0,0,2,0,2,0.2857142857142857,1,0.0,0,0,0,0,0,0,0,2,0,0,2,1
1361,26923,PQxAX7A8tQB7sGIcC9YvDjqPxTwtHPvm,SpATywNh6bZuzm8s1ceuBUnMUAeoAHHw,21,37,5,34,1,2,22,1,102,14.571428571428571,5,0.0,11,5,29,1,26,2,5,22,1,46,56,0
1362,26924,vptj4ETLtFQ4ma0zcDVByNO4VFhFTiIc,SpATywNh6bZuzm8s1ceuBUnMUAeoAHHw,10,13,4,0,1,5,6,1,30,4.285714285714286,1,0.0,6,4,0,1,7,5,0,6,1,11,19,0
1363,26946,DsHgWZRTJ1y1l15smwhB78ZQq3d8dyKP,A3fsA9Zfv1X2fVEQhTw51lKENdNrEqT3,2,0,0,0,0,0,4,0,4,0.5714285714285714,4,0.0,0,0,0,0,0,0,0,4,0,0,4,0
1364,27049,NyRX8nPDWLIgLtE9cch3ACh6oFi0cOSx,SpATywNh6bZuzm8s1ceuBUnMUAeoAHHw,4,7,0,0,0,0,1,0,8,1.1428571428571428,1,0.0,0,0,0,0,7,0,0,1,0,0,8,0
1365,27064,ZMTcKQbBQl56kBXzK6ZZeR0SWzh1XSjd,A3fsA9Zfv1X2fVEQhTw51lKENdNrEqT3,10,10,7,0,4,1,8,0,30,4.285714285714286,2,0.0,0,7,0,4,10,1,0,8,0,11,19,0
1366,27116,Y1uVq657IWCue4abNsh62IVHKtmwsQHQ,G8EPVSXsOYB5YQWZGiz1aVq5Pgr2GrQu,25,26,14,8,8,0,7,0,63,9.0,2,0.0,9,14,4,8,17,0,4,7,0,35,28,0
1367,27161,TNArortVQm3F09odJ2W3xdM27lVc5PiX,7GRhBDsirIGkRZBtSMEzNTyDr2JQm4xx,39,52,15,39,16,0,12,0,134,19.142857142857142,5,0.0,15,15,36,16,37,0,3,12,0,82,52,1
1368,27164,q0GZFChoVOuhzxYur1QICnKH6imiHQh6,SpATywNh6bZuzm8s1ceuBUnMUAeoAHHw,4,5,0,0,0,0,3,0,8,1.1428571428571428,2,0.0,0,0,0,0,5,0,0,3,0,0,8,0
1369,27169,TMLHDEunctUbbn16KffZHzQrVcud2Q9Y,bWdj2GDclj5ofokWjzoa5jAwMkxCykd6,7,6,3,0,2,0,3,0,14,2.0,1,0.0,0,3,0,2,6,0,0,3,0,5,9,0
1370,27176,cs1e0x90m3RHg7MlT1h0YOwuL4MzngHW,7GRhBDsirIGkRZBtSMEzNTyDr2JQm4xx,12,16,5,1,0,3,9,1,35,5.0,1,0.0,11,5,1,0,5,3,0,9,1,17,18,1
1371,27178,3GyWUBVi0ZEtgDniG78bG37zc4UZrPNu,RXDvfPUBYFlVdlueBFbLW0mhhAyGEqpt,49,71,31,105,11,11,14,1,244,34.857142857142854,3,0.0,15,31,101,11,56,11,4,14,1,158,86,1
1372,27186,dI0jOfzj8SJw9E2PkA63bWlxL71OLyUr,bWdj2GDclj5ofokWjzoa5jAwMkxCykd6,2,0,0,0,0,0,3,0,3,0.42857142857142855,1,0.0,0,0,0,0,0,0,0,3,0,0,3,0
1373,27187,imtJFGBCtMAkOvvJ09P5N0sgBTGSUYzd,SpATywNh6bZuzm8s1ceuBUnMUAeoAHHw,4,2,1,0,1,0,1,0,5,0.7142857142857143,1,0.0,0,1,0,1,2,0,0,1,0,2,3,0
1374,27223,amNosdi6Uiilljdy8esSBA3F29NKPLUW,SpATywNh6bZuzm8s1ceuBUnMUAeoAHHw,25,29,18,27,10,0,12,0,96,13.714285714285714,4,0.0,6,18,27,10,23,0,0,12,0,61,35,1
1375,27268,KmrafWa5j0EoSlyTehpuPHeKeDiU4jD1,SpATywNh6bZuzm8s1ceuBUnMUAeoAHHw,14,28,14,16,5,3,3,0,69,9.857142857142858,1,0.0,10,14,15,5,18,3,1,3,0,44,25,1
1376,27305,mvWG8WfFoikkAB9Wg1mtbCZJVje4NMeg,bWdj2GDclj5ofokWjzoa5jAwMkxCykd6,16,36,19,18,12,34,13,1,133,19.0,5,0.0,7,19,17,12,29,34,1,13,1,55,78,0
1377,27316,oJmCgDBYDqQXUsH41PFzwJxrFZzGvukQ,7GRhBDsirIGkRZBtSMEzNTyDr2JQm4xx,2,0,0,0,0,2,1,0,3,0.42857142857142855,1,0.0,0,0,0,0,0,2,0,1,0,0,3,1
1378,27324,fJRilHVpgCFPzgCMD6Xh8rgK6259Z6TQ,7GRhBDsirIGkRZBtSMEzNTyDr2JQm4xx,10,13,5,10,4,4,3,0,39,5.571428571428571,2,0.0,4,5,8,4,9,4,2,3,0,21,18,1
1379,27332,rz8gqb0xki7JyRvmBK5JfOlM8YmBiT6q,SpATywNh6bZuzm8s1ceuBUnMUAeoAHHw,30,56,22,33,12,6,14,1,144,20.571428571428573,8,0.0,24,22,30,12,32,6,3,14,1,88,56,0
1380,27336,uHeTIz8GkglZUts3zio1tGR2aBoYwiQE,A3fsA9Zfv1X2fVEQhTw51lKENdNrEqT3,43,16,14,58,13,11,7,1,120,17.142857142857142,1,0.0,1,14,54,13,15,11,4,7,1,82,38,1
1381,27364,VxTZo8wWibkIng7J8YPkqWh1rsEKvqTC,7GRhBDsirIGkRZBtSMEzNTyDr2JQm4xx,5,12,9,0,9,0,2,0,32,4.571428571428571,13,0.0,0,9,0,9,12,0,0,2,0,18,14,0
1382,27404,HDD1g3rYbRszzNZAvMB0irAHbU4W6xUO,SpATywNh6bZuzm8s1ceuBUnMUAeoAHHw,16,41,14,23,7,15,17,5,122,17.428571428571427,3,0.0,17,14,19,7,24,15,4,17,5,57,65,1
1383,27429,IYFIdswDKEsO4j14D9vS4fhZEQBqA7vK,SpATywNh6bZuzm8s1ceuBUnMUAeoAHHw,16,35,18,8,8,13,17,0,99,14.142857142857142,6,0.0,7,18,8,8,28,13,0,17,0,41,58,0
1384,27449,M8C9BDFICk4ida59GU0jjp556zazDEi1,SpATywNh6bZuzm8s1ceuBUnMUAeoAHHw,16,58,17,14,7,1,11,0,108,15.428571428571429,7,0.0,20,17,13,7,38,1,1,11,0,57,51,0
1385,27462,CYUGDG4GDnccqiwcMR066vcF013j1TMy,7GRhBDsirIGkRZBtSMEzNTyDr2JQm4xx,1,0,0,0,0,0,1,0,1,0.14285714285714285,1,0.0,0,0,0,0,0,0,0,1,0,0,1,1
1386,27535,VQ4FtoMJj29hpPrAQ6LMEGesAofjErC4,G8EPVSXsOYB5YQWZGiz1aVq5Pgr2GrQu,36,91,11,92,9,10,24,0,237,33.857142857142854,6,0.0,5,11,80,9,86,10,12,24,0,105,132,0
1387,27536,p7V6MquT5r2C7VmRzYjQEOsKx7s5gJug,SpATywNh6bZuzm8s1ceuBUnMUAeoAHHw,15,17,11,0,10,0,2,0,40,5.714285714285714,2,0.0,0,11,0,10,17,0,0,2,0,21,19,0
1388,30658,Sk4DUKJRImF6lijTnkABuH01jDj9zcnP,7GRhBDsirIGkRZBtSMEzNTyDr2JQm4xx,16,20,9,10,6,1,11,1,58,8.285714285714286,3,0.0,8,9,8,6,12,1,2,11,1,31,27,0
1389,30673,hMsNCldAkGadwgGX6yjkMuu7X3GLTjYs,7GRhBDsirIGkRZBtSMEzNTyDr2JQm4xx,4,2,1,0,1,0,1,0,5,0.7142857142857143,1,0.0,0,1,0,1,2,0,0,1,0,2,3,0
1390,30676,H98nROYI5ks5CHxEsgYii9bCzrDc1klK,7GRhBDsirIGkRZBtSMEzNTyDr2JQm4xx,6,9,5,0,3,1,2,0,20,2.857142857142857,1,0.0,2,5,0,3,7,1,0,2,0,10,10,0
1391,30700,uAXW7zeSaEEtMIdMcVsYpUquscAKUnr7,7GRhBDsirIGkRZBtSMEzNTyDr2JQm4xx,34,93,59,8,23,0,9,0,192,27.428571428571427,3,0.0,15,59,7,23,78,0,1,9,0,104,88,1
1392,30718,R2bf9dlDhtEUgfKzXR1GPBa12LhUfZ8W,7GRhBDsirIGkRZBtSMEzNTyDr2JQm4xx,13,17,7,8,6,0,3,0,41,5.857142857142857,1,0.0,9,7,7,6,8,0,1,3,0,29,12,0
1393,30778,vocq2qTAQIpXo7NloCyQjKAwRekZv7g6,A3fsA9Zfv1X2fVEQhTw51lKENdNrEqT3,46,42,21,68,11,38,31,3,214,30.571428571428573,2,0.0,1,21,55,11,41,38,13,31,3,88,126,1
1394,30785,rf4oo5VCac1USN0w21Ny3OOp1AZe5MC5,RXDvfPUBYFlVdlueBFbLW0mhhAyGEqpt,35,19,0,48,0,2,2,0,71,10.142857142857142,1,0.0,7,0,47,0,12,2,1,2,0,54,17,1
1395,30804,xVvNMYPAdkOMbR8cyTeqVHpVoO8wZQ2b,SpATywNh6bZuzm8s1ceuBUnMUAeoAHHw,4,2,0,0,0,0,2,0,4,0.5714285714285714,1,0.0,0,0,0,0,2,0,0,2,0,0,4,1
1396,30813,9mbf3ur4VQ377zp6wWXm0F44HQK66rP5,SpATywNh6bZuzm8s1ceuBUnMUAeoAHHw,7,9,2,0,2,0,3,0,16,2.2857142857142856,2,0.0,0,2,0,2,9,0,0,3,0,4,12,0
1397,30823,jLGWqcJWbPwbqDpaLuVE2buM1VcjzYrZ,A3fsA9Zfv1X2fVEQhTw51lKENdNrEqT3,38,16,12,80,9,0,3,0,120,17.142857142857142,2,0.0,1,12,67,9,15,0,13,3,0,89,31,0
1398,30856,4LLdV2zTWS697dAsOgAPJZPFwfNnrjt6,RXDvfPUBYFlVdlueBFbLW0mhhAyGEqpt,4,3,2,0,2,0,1,0,8,1.1428571428571428,1,0.0,0,2,0,2,3,0,0,1,0,4,4,1
1399,30875,7xwH0IGxUu9oyiAWk7HpSQpakcHGIuLy,G8EPVSXsOYB5YQWZGiz1aVq5Pgr2GrQu,26,93,19,44,19,92,22,3,292,41.714285714285715,6,0.0,28,19,37,19,65,92,7,22,3,103,189,0
1400,30876,oUNptzxKR6Tg3LMdUCW3RAFgD2fbf3ju,SpATywNh6bZuzm8s1ceuBUnMUAeoAHHw,17,29,3,15,2,9,13,1,72,10.285714285714286,3,0.0,7,3,14,2,22,9,1,13,1,26,46,0
1401,30884,XVh0ciKNvtUkxzspZoTcqEEmyNc2FeL5,7GRhBDsirIGkRZBtSMEzNTyDr2JQm4xx,3,3,1,0,0,0,1,0,5,0.7142857142857143,1,0.0,0,1,0,0,3,0,0,1,0,1,4,1
1402,30915,8HJiZoOTUArj8ouKObToEc9cbZd1p0Hh,SpATywNh6bZuzm8s1ceuBUnMUAeoAHHw,13,25,9,5,3,2,8,0,52,7.428571428571429,4,0.0,11,9,5,3,14,2,0,8,0,28,24,1
1403,30926,JODIGhSXEMOFdMb0BMfI1hphmGCcGiv9,7GRhBDsirIGkRZBtSMEzNTyDr2JQm4xx,31,27,11,42,12,1,7,0,100,14.285714285714286,2,0.0,14,11,37,12,13,1,5,7,0,74,26,1
1404,30929,9rkUO9AmZpdcwHkQIT6O3wGbPIgRHhIC,7GRhBDsirIGkRZBtSMEzNTyDr2JQm4xx,15,10,3,16,0,1,8,1,39,5.571428571428571,2,0.0,3,3,14,0,7,1,2,8,1,20,19,1
1405,30931,QX72AQjqYFwDzN5BrvMTm1brfdxDPl0n,7GRhBDsirIGkRZBtSMEzNTyDr2JQm4xx,24,44,16,20,13,0,3,1,97,13.857142857142858,2,0.0,20,16,19,13,24,0,1,3,1,68,29,1
1406,30958,pUAD8nrBU2agaJjO2oyqax3esP7bDAod,SpATywNh6bZuzm8s1ceuBUnMUAeoAHHw,18,31,8,9,4,39,38,11,140,20.0,3,0.0,4,8,9,4,27,39,0,38,11,25,115,0
1407,30986,8KSstsh3YYhIzd54fsYY1T96OfiCGWLi,SpATywNh6bZuzm8s1ceuBUnMUAeoAHHw,13,50,12,18,2,9,26,2,119,17.0,4,0.0,28,12,15,2,22,9,3,26,2,57,62,0
1408,30996,WNlTer437rP0ycEd1BKVfCjGSSopiPqX,SpATywNh6bZuzm8s1ceuBUnMUAeoAHHw,26,55,20,22,7,62,52,9,227,32.42857142857143,4,0.0,10,20,19,7,45,62,3,52,9,56,171,0
1409,31002,EfteYUnYYLq9uOBoKEC0F2UwFqIZoKtW,RXDvfPUBYFlVdlueBFbLW0mhhAyGEqpt,45,36,23,92,14,2,7,0,174,24.857142857142858,3,0.0,10,23,87,14,26,2,5,7,0,134,40,0
1410,31033,uUSTKM8g1hIskJbYHh1UiIQ6epHTSTNR,SpATywNh6bZuzm8s1ceuBUnMUAeoAHHw,10,23,10,0,5,0,4,0,42,6.0,2,0.0,8,10,0,5,15,0,0,4,0,23,19,0
1411,31123,UrqgguXQUa7JPAQb45jcbkHT0yjSwZHu,7GRhBDsirIGkRZBtSMEzNTyDr2JQm4xx,8,2,0,0,0,4,18,0,24,3.4285714285714284,2,0.0,0,0,0,0,2,4,0,18,0,0,24,1
1412,31152,AdsXlEjQFIksauSrVM6XkycFKpsPMY96,G8EPVSXsOYB5YQWZGiz1aVq5Pgr2GrQu,33,96,54,88,23,1,9,1,272,38.857142857142854,5,0.0,33,54,69,23,63,1,19,9,1,179,93,0
1413,31153,rIlg2veK76CYPAY7z09GokFHQqwC8sW7,SpATywNh6bZuzm8s1ceuBUnMUAeoAHHw,13,15,1,15,2,0,3,0,36,5.142857142857143,2,0.0,5,1,13,2,10,0,2,3,0,21,15,0
1414,31167,4bLrsVDvLnrTqHqeIpcqQPyvl02eai7n,A3fsA9Zfv1X2fVEQhTw51lKENdNrEqT3,17,9,9,0,9,0,8,0,35,5.0,2,0.0,0,9,0,9,9,0,0,8,0,18,17,1
1415,31186,71r0cSGOl797B6z3Ozx79KsmcnthtUKF,RXDvfPUBYFlVdlueBFbLW0mhhAyGEqpt,50,153,36,83,26,75,42,22,437,62.42857142857143,4,0.0,36,36,73,26,117,75,10,42,22,171,266,0
1416,31204,YOx6Tvp6HBSp6Lo310sbWxV28yIh3XN8,G8EPVSXsOYB5YQWZGiz1aVq5Pgr2GrQu,30,34,20,0,23,0,1,0,78,11.142857142857142,3,0.0,13,20,0,23,21,0,0,1,0,56,22,0
1417,31205,JzHC5tjVySaXz4V3Y0e4piHyrkmeSqU5,SpATywNh6bZuzm8s1ceuBUnMUAeoAHHw,32,135,35,30,10,148,87,7,452,64.57142857142857,10,0.0,6,35,27,10,129,148,3,87,7,78,374,0
1418,31220,s6iksgptFmyh2vfiarKdJkiKnp6RLi3f,SpATywNh6bZuzm8s1ceuBUnMUAeoAHHw,10,17,12,0,7,19,3,0,58,8.285714285714286,1,0.0,0,12,0,7,17,19,0,3,0,19,39,0
1419,31242,Qn3OccgDXQpcut9yLA9jXfau6FPbS72n,SpATywNh6bZuzm8s1ceuBUnMUAeoAHHw,23,32,0,12,0,9,10,1,64,9.142857142857142,1,0.0,9,0,12,0,23,9,0,10,1,21,43,0
1420,31250,oqq9xRnlYeqOhAsbS4FyM4hs04sEJX6q,7GRhBDsirIGkRZBtSMEzNTyDr2JQm4xx,13,20,11,0,0,2,5,1,39,5.571428571428571,2,0.0,4,11,0,0,16,2,0,5,1,15,24,1
1421,31254,m8tZWvMesr1zQS0esJJogsiMlXHxe2Cd,SpATywNh6bZuzm8s1ceuBUnMUAeoAHHw,14,27,9,15,4,2,2,0,59,8.428571428571429,1,0.0,11,9,13,4,16,2,2,2,0,37,22,1
1422,31273,llEGY9nmTOZhiXi105AGZUS4gAhSawAh,SpATywNh6bZuzm8s1ceuBUnMUAeoAHHw,14,26,10,18,5,1,2,0,62,8.857142857142858,1,0.0,5,10,15,5,21,1,3,2,0,35,27,0
1423,31313,vAwmKvW9O3gDJNDrzxbIT5kjf2troQFn,SpATywNh6bZuzm8s1ceuBUnMUAeoAHHw,17,17,7,10,4,3,12,1,54,7.714285714285714,5,0.0,2,7,10,4,15,3,0,12,1,23,31,1
1424,31316,sl67PTvziUv3kTFj6qEnYHRaFoNTaM8y,SpATywNh6bZuzm8s1ceuBUnMUAeoAHHw,14,42,12,14,5,0,5,0,78,11.142857142857142,3,0.0,23,12,13,5,19,0,1,5,0,53,25,0
1425,31356,zIHhHIwIbH6mJbe3ZAvW2ovaPewaq0E0,SpATywNh6bZuzm8s1ceuBUnMUAeoAHHw,22,50,16,24,4,77,19,1,191,27.285714285714285,7,0.0,19,16,23,4,31,77,1,19,1,62,129,0
1426,31360,QVtQEOECDBxqQMPDJLsWNOlhwI5DCP74,SpATywNh6bZuzm8s1ceuBUnMUAeoAHHw,17,19,9,17,4,53,14,1,117,16.714285714285715,3,0.0,6,9,16,4,13,53,1,14,1,35,82,0
1427,31371,YkxwabMuriYpqC21021WUsYLLutSSx4O,SpATywNh6bZuzm8s1ceuBUnMUAeoAHHw,14,14,6,12,3,0,6,0,41,5.857142857142857,2,0.0,6,6,9,3,8,0,3,6,0,24,17,0
1428,31389,QAV02IL7ajntDdHVirqabwTRIN1Sa6iz,SpATywNh6bZuzm8s1ceuBUnMUAeoAHHw,13,83,2,13,0,0,25,0,123,17.571428571428573,6,0.0,14,2,13,0,69,0,0,25,0,29,94,0
1429,31397,CGQBVll6e8XrZqlx2vLhIruhp3CAtM89,SpATywNh6bZuzm8s1ceuBUnMUAeoAHHw,6,9,5,0,3,3,6,0,26,3.7142857142857144,2,0.0,0,5,0,3,9,3,0,6,0,8,18,0
1430,31399,VBP5PzVQEKJYFH0y5ffEek5WfP9EW7uc,SpATywNh6bZuzm8s1ceuBUnMUAeoAHHw,30,27,18,16,7,1,12,1,82,11.714285714285714,5,0.0,4,18,15,7,23,1,1,12,1,44,38,0
1431,31400,S9MHz2GfayML2H9BuRARNQ0WUO9mAJgZ,SpATywNh6bZuzm8s1ceuBUnMUAeoAHHw,29,32,18,30,8,3,14,0,105,15.0,5,0.0,8,18,25,8,24,3,5,14,0,59,46,0
1432,31415,6pb2LEsVjBBvAGI7h0XcyCiR12k7UvwH,bWdj2GDclj5ofokWjzoa5jAwMkxCykd6,14,14,6,36,5,4,4,1,70,10.0,2,0.0,5,6,34,5,9,4,2,4,1,50,20,1
1433,31445,l7cIWSn2QdqLoOKMFO8yNQGKfk999nJh,SpATywNh6bZuzm8s1ceuBUnMUAeoAHHw,10,8,7,0,6,0,2,0,23,3.2857142857142856,1,0.0,0,7,0,6,8,0,0,2,0,13,10,0
1434,31459,1xFsl22T8LEiEJ3kwPWguQfPNcGWZ8JV,7GRhBDsirIGkRZBtSMEzNTyDr2JQm4xx,22,74,3,0,3,4,32,3,119,17.0,6,0.0,40,3,0,3,34,4,0,32,3,46,73,1
1435,31485,TJFpdHl1wQVU7Cnvm5Co4MJsJuGM9yMG,G8EPVSXsOYB5YQWZGiz1aVq5Pgr2GrQu,29,55,26,66,14,17,24,4,206,29.428571428571427,2,0.0,19,26,46,14,36,17,20,24,4,105,101,0
1436,31494,koNIIdoqi1yUhLIZAXp5I3Fl17qrPzNm,7GRhBDsirIGkRZBtSMEzNTyDr2JQm4xx,1,0,0,0,0,0,1,0,1,0.14285714285714285,1,0.0,0,0,0,0,0,0,0,1,0,0,1,1
1437,31500,EQgg3GYPXWNLa9U010kt5ZSvruPXJLGA,SpATywNh6bZuzm8s1ceuBUnMUAeoAHHw,16,25,9,21,3,20,10,3,91,13.0,3,0.0,11,9,18,3,14,20,3,10,3,41,50,0
1438,31503,YwFTXHSC31SX1LraRWOGlHPt5rdaD4Vy,SpATywNh6bZuzm8s1ceuBUnMUAeoAHHw,8,8,3,0,0,0,6,1,18,2.5714285714285716,1,0.0,2,3,0,0,6,0,0,6,1,5,13,0
1439,31573,VWrks7JFbeZpwdWqwwZkJoHpmfIv7cqz,7GRhBDsirIGkRZBtSMEzNTyDr2JQm4xx,25,32,16,39,13,1,2,0,103,14.714285714285714,3,0.0,10,16,37,13,22,1,2,2,0,76,27,0
1440,31642,Vr0kaKAkI4p2upUYNB1MMKsTShBZob66,7GRhBDsirIGkRZBtSMEzNTyDr2JQm4xx,29,50,22,56,10,63,3,0,204,29.142857142857142,5,0.0,22,22,45,10,28,63,11,3,0,99,105,1
1441,31691,TUAvpbJIqPqAXiWUMr89vm0HdACTuiA8,SpATywNh6bZuzm8s1ceuBUnMUAeoAHHw,20,41,1,23,2,2,10,0,79,11.285714285714286,5,0.0,7,1,19,2,34,2,4,10,0,29,50,0
1442,31728,mpNBMReKZvwryUvgjwY0cwVFK7aOune8,SpATywNh6bZuzm8s1ceuBUnMUAeoAHHw,18,21,10,21,5,7,18,2,84,12.0,4,0.0,6,10,17,5,15,7,4,18,2,38,46,0
1443,31739,xM8lVcqU5uqtxPXKRkobTl3b50GvL7Y6,G8EPVSXsOYB5YQWZGiz1aVq5Pgr2GrQu,3,2,0,0,0,0,1,0,3,0.42857142857142855,1,0.0,0,0,0,0,2,0,0,1,0,0,3,1
1444,31804,lHdOeTUXYVL6iAgJVxxf5RxusHAIMUqu,SpATywNh6bZuzm8s1ceuBUnMUAeoAHHw,31,68,26,27,12,18,19,1,171,24.428571428571427,7,0.0,25,26,27,12,43,18,0,19,1,90,81,0
1445,31878,VXwRO03Gu4QrNRkeAj0lYc8T94Ap4aw5,SpATywNh6bZuzm8s1ceuBUnMUAeoAHHw,12,29,1,14,0,7,4,0,55,7.857142857142857,2,0.0,16,1,14,0,13,7,0,4,0,31,24,0
1446,31984,uDOAJpmX4dISx06kO0710v1O7qHbWnTL,7GRhBDsirIGkRZBtSMEzNTyDr2JQm4xx,1,0,0,0,0,0,1,0,1,0.14285714285714285,1,0.0,0,0,0,0,0,0,0,1,0,0,1,1
1447,32014,t8eDuPU4MsZrMH2MoE1n7JeYLVBJZOGD,SpATywNh6bZuzm8s1ceuBUnMUAeoAHHw,23,38,17,29,4,12,19,3,122,17.428571428571427,5,0.0,15,17,26,4,23,12,3,19,3,62,60,0
1448,32052,2H4u8GVrslTygmZOsXRsjmcwUzRVI1ow,SpATywNh6bZuzm8s1ceuBUnMUAeoAHHw,12,23,19,6,8,0,8,0,64,9.142857142857142,3,0.0,0,19,5,8,23,0,1,8,0,32,32,0
1449,32114,MOcMwRKo0dtFqZ5xWBgRzquuZGKtQyf4,7GRhBDsirIGkRZBtSMEzNTyDr2JQm4xx,44,115,33,43,21,3,17,0,232,33.142857142857146,7,0.0,43,33,40,21,72,3,3,17,0,137,95,1
1450,32118,WMPYVFkG1npps8BU0n5fJtN4LOF8N9L7,7GRhBDsirIGkRZBtSMEzNTyDr2JQm4xx,5,7,2,0,0,0,2,0,11,1.5714285714285714,2,0.0,2,2,0,0,5,0,0,2,0,4,7,1
1451,32122,ZvU0YqNTtgKWTlVIbqvnVys23p5WRiDJ,SpATywNh6bZuzm8s1ceuBUnMUAeoAHHw,13,37,20,0,4,71,10,0,142,20.285714285714285,5,0.0,0,20,0,4,37,71,0,10,0,24,118,0
1452,32168,RHl3DsvAX7TisJ7qBptmgrrtDAQvH7mr,SpATywNh6bZuzm8s1ceuBUnMUAeoAHHw,5,3,1,0,1,0,2,0,7,1.0,1,0.0,0,1,0,1,3,0,0,2,0,2,5,0
1453,32208,bNZH4hUHavni696ZcBLvxZCrBSALUDxX,SpATywNh6bZuzm8s1ceuBUnMUAeoAHHw,23,41,4,31,3,29,11,0,119,17.0,11,0.0,5,4,28,3,36,29,3,11,0,40,79,0
1454,32211,EjR7iUwsiJVzqJrC7t3D1JWVRCEYToml,SpATywNh6bZuzm8s1ceuBUnMUAeoAHHw,10,19,0,18,0,5,3,0,45,6.428571428571429,1,0.0,9,0,15,0,10,5,3,3,0,24,21,0
1455,32226,4TtGjmtd4ISORDD5okRgx7kXAcGUW8IN,SpATywNh6bZuzm8s1ceuBUnMUAeoAHHw,29,47,20,23,9,4,40,5,148,21.142857142857142,9,0.0,20,20,20,9,27,4,3,40,5,69,79,0
1456,32241,kIttG9NXpnCAK6Uau8oyBBFc61rFQfTE,7GRhBDsirIGkRZBtSMEzNTyDr2JQm4xx,8,14,4,4,3,2,2,0,29,4.142857142857143,2,0.0,1,4,3,3,13,2,1,2,0,11,18,1
1457,32244,jN0wpnfaU5DsLxvEqII5WFiC356NJUbF,SpATywNh6bZuzm8s1ceuBUnMUAeoAHHw,23,28,11,24,5,1,24,4,97,13.857142857142858,3,0.0,12,11,22,5,16,1,2,24,4,50,47,1
1458,32256,pNgLScEwGgq81vg0a0cEXKNs5eG2UXph,SpATywNh6bZuzm8s1ceuBUnMUAeoAHHw,15,13,7,12,4,0,3,0,39,5.571428571428571,2,0.0,4,7,12,4,9,0,0,3,0,27,12,1
1459,32261,L6TEQcXe2Cfo7rlXEZ1k4dVXCx2fwc1Y,7GRhBDsirIGkRZBtSMEzNTyDr2JQm4xx,8,9,2,0,1,0,2,0,14,2.0,1,0.0,4,2,0,1,5,0,0,2,0,7,7,1
1460,32263,kAQFM0dEgOQIxOG9jTMe5puRtNxZZWMN,bWdj2GDclj5ofokWjzoa5jAwMkxCykd6,15,20,1,108,1,2,5,0,137,19.571428571428573,3,0.0,5,1,105,1,15,2,3,5,0,112,25,0
1461,32280,onsmNYIoPFEi185f5ZLsQXD70I3K25Cb,7GRhBDsirIGkRZBtSMEzNTyDr2JQm4xx,6,4,3,0,2,0,2,0,11,1.5714285714285714,1,0.0,0,3,0,2,4,0,0,2,0,5,6,1
1462,32284,wkkLqkPlDLOrNrbR4UCtQIDxtXcGov1B,SpATywNh6bZuzm8s1ceuBUnMUAeoAHHw,15,13,0,19,0,0,9,1,42,6.0,2,0.0,4,0,16,0,9,0,3,9,1,20,22,1
1463,32288,8rXJHeqrLpho5nIQgbDcpBTvBrVnGged,SpATywNh6bZuzm8s1ceuBUnMUAeoAHHw,24,53,10,39,4,0,9,0,115,16.428571428571427,4,0.0,17,10,33,4,36,0,6,9,0,64,51,0
1464,32309,MZpeXlPtlAGSfwuC5xwB1U0DIOZvGtVZ,SpATywNh6bZuzm8s1ceuBUnMUAeoAHHw,25,56,3,35,5,9,12,1,121,17.285714285714285,5,0.0,24,3,28,5,32,9,7,12,1,60,61,0
1465,32319,PZyZDM2uyBRGPZg3kQscavWjpR2bFYiU,SpATywNh6bZuzm8s1ceuBUnMUAeoAHHw,2,0,0,0,0,0,2,0,2,0.2857142857142857,1,0.0,0,0,0,0,0,0,0,2,0,0,2,0
1466,32346,rrZSZFoEgH3bOKdkZ0UyNzOq7Pdyx5G0,SpATywNh6bZuzm8s1ceuBUnMUAeoAHHw,14,27,16,0,4,0,11,0,58,8.285714285714286,2,0.0,0,16,0,4,27,0,0,11,0,20,38,0
1467,32358,nOWwmMm8RUDfPfoqvXy3xmkIL6qZiu0a,7GRhBDsirIGkRZBtSMEzNTyDr2JQm4xx,13,18,1,9,0,9,18,1,56,8.0,2,0.0,2,1,7,0,16,9,2,18,1,10,46,0
1468,32359,aLRP3ahB5SIcOn5vpM1VPEh9ib2QIioX,SpATywNh6bZuzm8s1ceuBUnMUAeoAHHw,10,32,1,17,0,0,15,0,65,9.285714285714286,6,0.0,8,1,14,0,24,0,3,15,0,23,42,0
1469,32385,rIb3lxEaK77vmLDTqDgCNFDZAYjyvbtK,7GRhBDsirIGkRZBtSMEzNTyDr2JQm4xx,30,37,17,32,8,0,6,0,100,14.285714285714286,3,0.0,15,17,30,8,22,0,2,6,0,70,30,1
1470,32409,9iGaqBGS5kkoXjLd87hUL2eIJMVUVKfU,G8EPVSXsOYB5YQWZGiz1aVq5Pgr2GrQu,16,13,8,16,1,0,4,0,42,6.0,2,0.0,0,8,15,1,13,0,1,4,0,24,18,0
1471,32426,gGSMkNgPdXpBQgdZzyjzifomyCxFSNyt,bWdj2GDclj5ofokWjzoa5jAwMkxCykd6,15,43,25,36,11,12,26,2,155,22.142857142857142,6,0.0,4,25,35,11,39,12,1,26,2,75,80,0
1472,32436,QqE2Xjwy9gUzOvFdkDqAwAaNZLBZkxvd,SpATywNh6bZuzm8s1ceuBUnMUAeoAHHw,24,67,1,28,2,30,17,0,145,20.714285714285715,7,0.0,11,1,23,2,56,30,5,17,0,37,108,0
1473,32464,QAguKdvn52pCJKW91rO3BCY8l8ZCAdvQ,A3fsA9Zfv1X2fVEQhTw51lKENdNrEqT3,4,4,1,0,0,0,2,0,7,1.0,2,0.0,0,1,0,0,4,0,0,2,0,1,6,0
1474,32484,QqE2Xjwy9gUzOvFdkDqAwAaNZLBZkxvd,A3fsA9Zfv1X2fVEQhTw51lKENdNrEqT3,18,45,2,0,2,0,29,0,78,11.142857142857142,8,0.0,0,2,0,2,45,0,0,29,0,4,74,0
1475,32492,5NsbP59FWlyl4NFONUzt3drLLr5EFRFj,G8EPVSXsOYB5YQWZGiz1aVq5Pgr2GrQu,64,96,37,154,14,9,14,1,325,46.42857142857143,3,0.0,52,37,114,14,44,9,40,14,1,217,108,1
1476,32501,mOJqDc22cg6Tc62XCr7iPStv8YxEXhpp,SpATywNh6bZuzm8s1ceuBUnMUAeoAHHw,29,83,37,37,13,76,35,4,285,40.714285714285715,6,0.0,20,37,31,13,63,76,6,35,4,101,184,0
1477,32512,wtJKiskMN99Zm4elrGO0NchnwPdR8XuA,7GRhBDsirIGkRZBtSMEzNTyDr2JQm4xx,1,0,0,0,0,0,1,0,1,0.14285714285714285,1,0.0,0,0,0,0,0,0,0,1,0,0,1,1
1478,32577,fNAZ3rWuqq8OkAKKKUzZOQQ9DpAle4lu,SpATywNh6bZuzm8s1ceuBUnMUAeoAHHw,32,90,29,34,10,3,35,2,203,29.0,7,0.0,39,29,31,10,51,3,3,35,2,109,94,0
1479,32616,MVcepYvxjrdyzudBtT6xf978LVM5p04U,SpATywNh6bZuzm8s1ceuBUnMUAeoAHHw,30,36,18,40,10,17,15,5,141,20.142857142857142,3,0.0,13,18,33,10,23,17,7,15,5,74,67,0
1480,32647,vBbIZDmFTh3FCbK0DEiE7jyE0eCpDvg4,RXDvfPUBYFlVdlueBFbLW0mhhAyGEqpt,5,2,1,0,1,0,2,0,6,0.8571428571428571,1,0.0,0,1,0,1,2,0,0,2,0,2,4,0
1481,32685,MaXB6YBpSNUvXtEuCcY3Jwa8jwvsWVE8,G8EPVSXsOYB5YQWZGiz1aVq5Pgr2GrQu,4,3,1,0,1,0,1,0,6,0.8571428571428571,1,0.0,0,1,0,1,3,0,0,1,0,2,4,0
1482,32694,bVveXRWwKdTb7eqX4rWDKBUhdf8PtEkw,SpATywNh6bZuzm8s1ceuBUnMUAeoAHHw,20,18,1,22,0,0,2,0,43,6.142857142857143,1,0.0,6,1,18,0,12,0,4,2,0,25,18,0
1483,32725,NHPpKvbnrSpxM8e1DORBWJbRCpmrxZw8,G8EPVSXsOYB5YQWZGiz1aVq5Pgr2GrQu,5,3,1,0,1,0,1,0,6,0.8571428571428571,1,0.0,0,1,0,1,3,0,0,1,0,2,4,0
1484,32805,mPCmohVETKOBEAkMNdnfTJW7kVWg1ArQ,7GRhBDsirIGkRZBtSMEzNTyDr2JQm4xx,1,0,0,0,0,0,1,0,1,0.14285714285714285,1,0.0,0,0,0,0,0,0,0,1,0,0,1,1
1485,32844,b1eRrhapWSjtM2Ih9Xn0eBEZAyjqmlvI,SpATywNh6bZuzm8s1ceuBUnMUAeoAHHw,31,125,55,47,11,92,50,11,391,55.857142857142854,7,0.0,41,55,37,11,84,92,10,50,11,144,247,0
1486,32891,yInJev2CVKf0hE352QQBnfHh6HRrGN4N,SpATywNh6bZuzm8s1ceuBUnMUAeoAHHw,6,7,3,0,2,0,2,0,14,2.0,2,0.0,0,3,0,2,7,0,0,2,0,5,9,1
1487,32901,4JyZWYWxxqGCPr9dTz7bgpLcCXWs003A,SpATywNh6bZuzm8s1ceuBUnMUAeoAHHw,18,33,14,27,6,3,21,3,107,15.285714285714286,2,0.0,15,14,26,6,18,3,1,21,3,61,46,0
1488,32931,8d3h1mcAmphWja0z3YCYQ3jOAHgKDV8O,7GRhBDsirIGkRZBtSMEzNTyDr2JQm4xx,6,4,1,6,1,0,1,0,13,1.8571428571428572,1,0.0,1,1,5,1,3,0,1,1,0,8,5,1
1489,32938,zZwP4suQybM1gcslFDQ5UITiG9iZ789v,SpATywNh6bZuzm8s1ceuBUnMUAeoAHHw,17,56,34,14,9,5,16,4,138,19.714285714285715,5,0.0,8,34,10,9,48,5,4,16,4,61,77,0
1490,32988,mZVWUPFbkuZINQtykHT2ZyZY5zMXgvJ7,SpATywNh6bZuzm8s1ceuBUnMUAeoAHHw,7,2,1,0,1,0,6,2,12,1.7142857142857142,1,0.0,0,1,0,1,2,0,0,6,2,2,10,0
1491,33001,ZFpXjzvya7Y5x9HmUsgToer6v1L16WM2,SpATywNh6bZuzm8s1ceuBUnMUAeoAHHw,10,9,4,10,1,2,7,0,33,4.714285714285714,1,0.0,2,4,10,1,7,2,0,7,0,17,16,0
1492,33017,GFBEJrga7DM4UEcrt340p3oRNaL97Gn4,SpATywNh6bZuzm8s1ceuBUnMUAeoAHHw,26,35,19,26,8,123,48,8,267,38.142857142857146,5,0.0,6,19,23,8,29,123,3,48,8,56,211,0
1493,33023,XzkMRCsMMuNT5Al9kV5PMqeThOnNDLN6,7GRhBDsirIGkRZBtSMEzNTyDr2JQm4xx,4,5,3,0,0,4,4,0,16,2.2857142857142856,2,0.0,0,3,0,0,5,4,0,4,0,3,13,1
1494,33050,rALCIi3DuIdQyJaY6En5rKpCFJjvIHQe,SpATywNh6bZuzm8s1ceuBUnMUAeoAHHw,6,7,3,0,1,0,7,0,18,2.5714285714285716,2,0.0,0,3,0,1,7,0,0,7,0,4,14,1
1495,33058,fNAZ3rWuqq8OkAKKKUzZOQQ9DpAle4lu,RXDvfPUBYFlVdlueBFbLW0mhhAyGEqpt,72,103,59,206,31,6,27,0,432,61.714285714285715,6,0.0,18,59,186,31,85,6,20,27,0,294,138,0
1496,33062,ZVmjT1rppq7ilCPRRtmAl1wo0gOugsCt,RXDvfPUBYFlVdlueBFbLW0mhhAyGEqpt,26,19,11,52,6,14,6,0,108,15.428571428571429,3,0.0,5,11,46,6,14,14,6,6,0,68,40,0
1497,33088,kpIACQKuTNWV6fjF4g1htB9bVtHJR1X6,A3fsA9Zfv1X2fVEQhTw51lKENdNrEqT3,2,0,0,0,0,0,2,0,2,0.2857142857142857,1,0.0,0,0,0,0,0,0,0,2,0,0,2,0
1498,33097,RJ1FVW8gXQIpK321uzh2Sh69ojlsqnvg,bWdj2GDclj5ofokWjzoa5jAwMkxCykd6,13,20,8,38,3,5,14,1,89,12.714285714285714,2,0.0,4,8,37,3,16,5,1,14,1,52,37,0
1499,33113,PjZvizXDkcC0c394BYUQIpEWacrPH7EJ,SpATywNh6bZuzm8s1ceuBUnMUAeoAHHw,13,18,0,20,0,6,7,0,51,7.285714285714286,2,0.0,9,0,18,0,9,6,2,7,0,27,24,1
1500,33121,pKcgftm88lERht9rjtO6yDT8uF9jnp1z,7GRhBDsirIGkRZBtSMEzNTyDr2JQm4xx,39,116,54,79,31,6,15,2,303,43.285714285714285,6,0.0,46,54,73,31,70,6,6,15,2,204,99,1
1501,33146,aFVLxK4Hau9wDglF79kWvvimpoa2MXNc,SpATywNh6bZuzm8s1ceuBUnMUAeoAHHw,23,31,6,30,3,71,12,3,156,22.285714285714285,2,0.0,10,6,27,3,21,71,3,12,3,46,110,1
1502,33156,NgffOurIf9EDLm5SB7efcduZd82QhoOU,RXDvfPUBYFlVdlueBFbLW0mhhAyGEqpt,20,19,10,12,6,13,5,0,65,9.285714285714286,2,0.0,4,10,12,6,15,13,0,5,0,32,33,0
1503,33173,poxISkj7mtTTcUTxHuC9BFrrsaF9KDef,7GRhBDsirIGkRZBtSMEzNTyDr2JQm4xx,30,69,23,54,20,5,5,0,176,25.142857142857142,3,0.0,42,23,48,20,27,5,6,5,0,133,43,1
1504,33187,yiWok4eQ5hgdJ8eYi2O0qHhy67Y9EA3E,SpATywNh6bZuzm8s1ceuBUnMUAeoAHHw,31,32,18,31,9,6,8,1,105,15.0,3,0.0,12,18,28,9,20,6,3,8,1,67,38,0
1505,33199,r9mrNmOIUUDf7AorDYXKUl4G7R8wfHcf,SpATywNh6bZuzm8s1ceuBUnMUAeoAHHw,17,21,12,21,5,1,8,3,71,10.142857142857142,1,0.0,5,12,18,5,16,1,3,8,3,40,31,0
1506,33234,we9tWnySpl1G7k7FqyXPj8wmC2gUYK0W,A3fsA9Zfv1X2fVEQhTw51lKENdNrEqT3,7,4,0,0,0,1,7,0,12,1.7142857142857142,2,0.0,0,0,0,0,4,1,0,7,0,0,12,0
1507,33280,1vY5OZ1u5dkB4jIpVDeMNw33uHVvYDm0,G8EPVSXsOYB5YQWZGiz1aVq5Pgr2GrQu,57,204,66,124,60,50,30,11,545,77.85714285714286,7,0.0,61,66,87,60,143,50,37,30,11,274,271,0
1508,33321,vIBcYbs1BLdmaaP30fcE2FS7kB7v7QRn,RXDvfPUBYFlVdlueBFbLW0mhhAyGEqpt,8,10,6,0,1,0,7,0,24,3.4285714285714284,2,0.0,0,6,0,1,10,0,0,7,0,7,17,1
1509,33325,jXgMhQKbkiBaFyvNHAIM6AePvnnTFQC0,SpATywNh6bZuzm8s1ceuBUnMUAeoAHHw,21,19,11,24,0,0,4,0,58,8.285714285714286,2,0.0,6,11,24,0,13,0,0,4,0,41,17,0
1510,33338,d5hgUNbUFsJ3QWa3NXhPxhtqZKrkuHi4,SpATywNh6bZuzm8s1ceuBUnMUAeoAHHw,15,14,6,8,3,0,5,0,36,5.142857142857143,3,0.0,6,6,8,3,8,0,0,5,0,23,13,0
1511,33366,fYLWMGJsW3Aq1nrs0wiSji5Q7ysltFRD,SpATywNh6bZuzm8s1ceuBUnMUAeoAHHw,10,8,4,0,2,0,7,0,21,3.0,2,0.0,0,4,0,2,8,0,0,7,0,6,15,1
1512,33375,BkBVFyB4tBI41wvM1Ppa7iaH93pA565M,7GRhBDsirIGkRZBtSMEzNTyDr2JQm4xx,3,0,0,0,0,12,2,0,14,2.0,1,0.0,0,0,0,0,0,12,0,2,0,0,14,1
1513,33400,R3LdCHGJ0oYuX8fUQhI8dRkzUs6gLWrE,SpATywNh6bZuzm8s1ceuBUnMUAeoAHHw,18,19,6,28,1,11,11,1,77,11.0,2,0.0,10,6,22,1,9,11,6,11,1,39,38,0
1514,33416,viuKt4GgrX0rYL5EpHoxJbsiC9TblSuk,SpATywNh6bZuzm8s1ceuBUnMUAeoAHHw,23,132,59,0,19,107,45,0,362,51.714285714285715,7,0.0,14,59,0,19,118,107,0,45,0,92,270,0
1515,33428,YlMrjX7ibus8JFFbvjYaUFTOz92jaztw,SpATywNh6bZuzm8s1ceuBUnMUAeoAHHw,10,15,10,0,5,22,2,0,54,7.714285714285714,2,0.0,1,10,0,5,14,22,0,2,0,16,38,0
1516,33475,0KNVWAChIRBDwntcO5Dr5l3KgkUsRh3O,SpATywNh6bZuzm8s1ceuBUnMUAeoAHHw,10,12,2,2,1,3,2,0,22,3.142857142857143,1,0.0,3,2,2,1,9,3,0,2,0,8,14,0
1517,33493,1vY5OZ1u5dkB4jIpVDeMNw33uHVvYDm0,SpATywNh6bZuzm8s1ceuBUnMUAeoAHHw,31,88,30,25,10,5,18,0,176,25.142857142857142,5,0.0,33,30,21,10,55,5,4,18,0,94,82,0
1518,33513,H2Rgqo3kRDsNdbNVEDl0788s9SSdLM8P,7GRhBDsirIGkRZBtSMEzNTyDr2JQm4xx,33,67,5,38,11,1,11,1,134,19.142857142857142,6,0.0,35,5,36,11,32,1,2,11,1,87,47,1
1519,33520,qmYTrueiQKfoQnGxjqfwlMlw7HOR9CKj,A3fsA9Zfv1X2fVEQhTw51lKENdNrEqT3,9,6,1,0,0,3,20,2,32,4.571428571428571,3,0.0,0,1,0,0,6,3,0,20,2,1,31,0
1520,33577,YZSZ4TOtqHUreAioK1x0YBDmIRumwoti,7GRhBDsirIGkRZBtSMEzNTyDr2JQm4xx,12,17,3,15,3,0,3,0,41,5.857142857142857,2,0.0,5,3,13,3,12,0,2,3,0,24,17,1
1521,33601,B9KqNNxXBxHFUsJnQKQysblL3f8zF7sg,7GRhBDsirIGkRZBtSMEzNTyDr2JQm4xx,27,66,4,0,8,0,9,0,87,12.428571428571429,5,0.0,23,4,0,8,43,0,0,9,0,35,52,0
1522,33639,3bwizzI2zhkZarj0AirZFGuMorcba8W4,SpATywNh6bZuzm8s1ceuBUnMUAeoAHHw,17,38,16,19,6,21,23,4,127,18.142857142857142,3,0.0,8,16,16,6,30,21,3,23,4,46,81,1
1523,33643,InrAmtl2MgoSpFoohTtv1oXbh4bisxXW,bWdj2GDclj5ofokWjzoa5jAwMkxCykd6,13,20,9,12,3,2,18,2,66,9.428571428571429,5,0.0,1,9,10,3,19,2,2,18,2,23,43,0
1524,33666,RCdcltNaQLfcoxT7YKTjQxAYUbCmzzKd,A3fsA9Zfv1X2fVEQhTw51lKENdNrEqT3,11,12,9,0,4,0,5,0,30,4.285714285714286,4,0.0,0,9,0,4,12,0,0,5,0,13,17,0
1525,34602,bS2IOWKbnbandmSXQXzI1vhjNhpDoKfN,7GRhBDsirIGkRZBtSMEzNTyDr2JQm4xx,14,19,7,36,1,8,9,0,80,11.428571428571429,4,0.0,8,7,32,1,11,8,4,9,0,48,32,1
1526,34883,C4q4gNQYEpjKh7pq1qjN8i3L7uSpUX9d,7GRhBDsirIGkRZBtSMEzNTyDr2JQm4xx,10,16,0,12,1,0,1,0,30,4.285714285714286,1,0.0,6,0,10,1,10,0,2,1,0,17,13,0
1527,34897,I7MInQU0IyHrO5RwKExwH0rTfGFmb00M,7GRhBDsirIGkRZBtSMEzNTyDr2JQm4xx,7,11,4,6,6,0,2,0,29,4.142857142857143,2,0.0,6,4,5,6,5,0,1,2,0,21,8,1
1528,35039,URPpxYyCEjr1OE9SkqYA4izrGFGWLVkB,7GRhBDsirIGkRZBtSMEzNTyDr2JQm4xx,24,22,8,30,6,0,4,0,70,10.0,1,0.0,7,8,25,6,15,0,5,4,0,46,24,1
1529,35143,7eHsOwDNMYF4417CWrgdB8gK0Wr4kfqA,7GRhBDsirIGkRZBtSMEzNTyDr2JQm4xx,39,87,41,60,11,2,23,1,225,32.142857142857146,4,0.0,31,41,49,11,56,2,11,23,1,132,93,0
1530,35607,2LWu6JMOYyxkKMq63i00WbtT7iPpdOSr,7GRhBDsirIGkRZBtSMEzNTyDr2JQm4xx,2,0,0,0,0,0,2,0,2,0.2857142857142857,1,0.0,0,0,0,0,0,0,0,2,0,0,2,1
1531,35608,nH0kSZNGQd9lZaOsssfRVpCIHD2KW4j6,7GRhBDsirIGkRZBtSMEzNTyDr2JQm4xx,41,65,22,77,21,3,2,0,190,27.142857142857142,2,0.0,28,22,69,21,37,3,8,2,0,140,50,1
1532,35634,U3LNfYcdRIeU9qhiaPG7Yg8NuZRGOnSS,7GRhBDsirIGkRZBtSMEzNTyDr2JQm4xx,1,0,0,0,0,0,1,0,1,0.14285714285714285,1,0.0,0,0,0,0,0,0,0,1,0,0,1,1
1533,35686,skJn7dtfSekFrPHRHs9swZ9AtSUKi36u,7GRhBDsirIGkRZBtSMEzNTyDr2JQm4xx,3,2,1,0,0,0,2,0,5,0.7142857142857143,2,0.0,0,1,0,0,2,0,0,2,0,1,4,0
1534,35696,Vtwq7W3DodckYgwQIiThiTk1zWdBpMl0,7GRhBDsirIGkRZBtSMEzNTyDr2JQm4xx,1,0,0,0,0,0,1,0,1,0.14285714285714285,1,0.0,0,0,0,0,0,0,0,1,0,0,1,1
1535,37552,gL9BFkziNrTyhzKvF4GTh7vW4ctCxqfr,SpATywNh6bZuzm8s1ceuBUnMUAeoAHHw,16,22,5,12,4,0,2,0,45,6.428571428571429,5,0.0,2,5,10,4,20,0,2,2,0,21,24,0
1536,37553,AVMp8F9T45cyhHDRnad5d9bxFkDP4PTv,A3fsA9Zfv1X2fVEQhTw51lKENdNrEqT3,35,21,2,74,1,1,11,1,111,15.857142857142858,3,0.0,2,2,66,1,19,1,8,11,1,71,40,1
1537,37581,mwc0YjZS72xD4dO6Zk7KmFewdh7PWkAS,SpATywNh6bZuzm8s1ceuBUnMUAeoAHHw,7,8,3,0,2,0,3,0,16,2.2857142857142856,4,0.0,0,3,0,2,8,0,0,3,0,5,11,0
1538,37584,06eFfwi64z4CVxg9kYU89F0UCK6M3gh2,G8EPVSXsOYB5YQWZGiz1aVq5Pgr2GrQu,12,10,1,0,3,0,3,0,17,2.4285714285714284,1,0.0,3,1,0,3,7,0,0,3,0,7,10,1
1539,37586,rVtxqWpWg55yh0PkkVeeVKt0oQv342j9,G8EPVSXsOYB5YQWZGiz1aVq5Pgr2GrQu,8,10,9,0,9,0,6,0,34,4.857142857142857,3,0.0,0,9,0,9,10,0,0,6,0,18,16,0
1540,37587,9RND50Xx7veKeepJEVVvFKwUGiemuZp5,G8EPVSXsOYB5YQWZGiz1aVq5Pgr2GrQu,10,8,4,0,3,0,3,0,18,2.5714285714285716,3,0.0,0,4,0,3,8,0,0,3,0,7,11,1
1541,37588,XY4zkM1XF8dydjqcvDmQyLNW1UDj6PeN,A3fsA9Zfv1X2fVEQhTw51lKENdNrEqT3,37,31,13,60,7,0,6,0,117,16.714285714285715,2,0.0,3,13,51,7,28,0,9,6,0,74,43,1
1542,37610,v7t0p3xAszbLv0yg1dCcAEjixfvU7JCE,SpATywNh6bZuzm8s1ceuBUnMUAeoAHHw,18,41,17,18,6,14,37,3,136,19.428571428571427,3,0.0,14,17,14,6,27,14,4,37,3,51,85,0
1543,37611,unrsquMc9aFN95z680VOYlXL0dwyjnVg,bWdj2GDclj5ofokWjzoa5jAwMkxCykd6,12,30,10,36,3,1,9,1,90,12.857142857142858,5,0.0,6,10,34,3,24,1,2,9,1,53,37,1
1544,37625,6lLAZ0WiQMBHvxtAmgARKrfLfmbRRaSM,A3fsA9Zfv1X2fVEQhTw51lKENdNrEqT3,1,0,0,0,0,0,1,0,1,0.14285714285714285,1,0.0,0,0,0,0,0,0,0,1,0,0,1,1
1545,37629,KxrIXB4R6FFhAWrOx18fBUJq6eOomhrO,bWdj2GDclj5ofokWjzoa5jAwMkxCykd6,5,2,1,0,1,0,4,0,8,1.1428571428571428,2,0.0,0,1,0,1,2,0,0,4,0,2,6,1
1546,37636,08uQSEeVi17JB9WOQMIOM89vv6wgWS2O,SpATywNh6bZuzm8s1ceuBUnMUAeoAHHw,15,14,2,17,1,2,12,2,50,7.142857142857143,2,0.0,5,2,15,1,9,2,2,12,2,23,27,1
1547,37644,9irvFFpWGWd3HRZTxsfDJTqmA07T10ig,SpATywNh6bZuzm8s1ceuBUnMUAeoAHHw,7,2,1,0,1,3,4,1,12,1.7142857142857142,1,0.0,0,1,0,1,2,3,0,4,1,2,10,1
1548,37666,zeUi2UnQZPPF6bRQXw2s8LZ41ZOdqRAa,SpATywNh6bZuzm8s1ceuBUnMUAeoAHHw,16,19,10,6,4,5,9,1,54,7.714285714285714,3,0.0,3,10,6,4,16,5,0,9,1,23,31,0
1549,37683,fmWFGOtr4qK1lNBCrTOCxVLVNU6IZ5bU,bWdj2GDclj5ofokWjzoa5jAwMkxCykd6,1,0,0,0,0,0,1,0,1,0.14285714285714285,1,0.0,0,0,0,0,0,0,0,1,0,0,1,1
1550,37688,GcLKL1EMGPSsuLaGpCB2Rrlv3EuS2ngA,SpATywNh6bZuzm8s1ceuBUnMUAeoAHHw,6,2,1,0,1,0,3,0,7,1.0,1,0.0,0,1,0,1,2,0,0,3,0,2,5,1
1551,37690,1Ti3XKNP5gzLh1si7Apz4GKt53UijsKr,SpATywNh6bZuzm8s1ceuBUnMUAeoAHHw,28,46,16,32,7,0,10,0,111,15.857142857142858,3,0.0,14,16,32,7,32,0,0,10,0,69,42,0
1552,37691,FisqRa6EMb5EsK7GdBjEQwdg4YXD4Xed,bWdj2GDclj5ofokWjzoa5jAwMkxCykd6,17,51,29,78,7,22,13,0,200,28.571428571428573,4,0.0,8,29,70,7,43,22,8,13,0,114,86,1
1553,37706,5D134KQAUnU8gDw5hYnvC82YSO8giiEU,SpATywNh6bZuzm8s1ceuBUnMUAeoAHHw,31,48,16,29,8,1,12,1,115,16.428571428571427,3,0.0,23,16,23,8,25,1,6,12,1,70,45,0
1554,37708,YQZ85qW2KiDmX9GD2Tq3oRYH6ucmQmKe,RXDvfPUBYFlVdlueBFbLW0mhhAyGEqpt,15,19,11,8,6,0,4,0,48,6.857142857142857,2,0.0,1,11,7,6,18,0,1,4,0,25,23,1
1555,37710,t89Lbc9NyQ1awHKwpUunu51m4E6DMYhk,SpATywNh6bZuzm8s1ceuBUnMUAeoAHHw,18,30,11,22,1,8,8,1,81,11.571428571428571,3,0.0,12,11,20,1,18,8,2,8,1,44,37,0
1556,37713,7fOZzyBcCx06Vw2a40A0eroSD5VkDcNa,SpATywNh6bZuzm8s1ceuBUnMUAeoAHHw,30,45,24,24,13,21,15,2,144,20.571428571428573,4,0.0,17,24,20,13,28,21,4,15,2,74,70,0
1557,37722,NuWa1wNN62sioyREqwjInndithPqIOD8,A3fsA9Zfv1X2fVEQhTw51lKENdNrEqT3,5,3,2,0,1,0,3,0,9,1.2857142857142858,1,0.0,0,2,0,1,3,0,0,3,0,3,6,1
1558,37737,m7GeMdFl22gaxUtAD72z73B5tIK1shlq,SpATywNh6bZuzm8s1ceuBUnMUAeoAHHw,13,7,5,0,4,0,7,2,25,3.5714285714285716,3,0.0,0,5,0,4,7,0,0,7,2,9,16,1
1559,37761,bzoYFRQVu6SapCnsZ0DOXeU3JXiLIJu3,SpATywNh6bZuzm8s1ceuBUnMUAeoAHHw,30,31,13,25,7,19,8,3,106,15.142857142857142,3,0.0,14,13,25,7,17,19,0,8,3,59,47,0
1560,37764,b9kodEhA94IDSBT3ykY4QWiqr6rjyws0,SpATywNh6bZuzm8s1ceuBUnMUAeoAHHw,2,0,0,0,0,0,2,0,2,0.2857142857142857,1,0.0,0,0,0,0,0,0,0,2,0,0,2,1
1561,37769,gsdvPbnmqv3G3TICTRxTHCvyG0vd5lw3,G8EPVSXsOYB5YQWZGiz1aVq5Pgr2GrQu,33,52,28,56,12,32,18,1,199,28.428571428571427,2,0.0,18,28,37,12,34,32,19,18,1,95,104,1
1562,37782,MT2eJtF59AVNdUs7mwFqputROb2HgEm3,SpATywNh6bZuzm8s1ceuBUnMUAeoAHHw,13,9,5,13,3,3,1,0,34,4.857142857142857,1,0.0,3,5,13,3,6,3,0,1,0,24,10,0
1563,37784,BarsBzOr7FgzlrusMqrDFOsYw63YD64d,A3fsA9Zfv1X2fVEQhTw51lKENdNrEqT3,6,3,0,0,0,5,6,2,16,2.2857142857142856,1,0.0,0,0,0,0,3,5,0,6,2,0,16,1
1564,37788,y1rNC08s1iP76iivJMPjmiTg1SiPQTDp,SpATywNh6bZuzm8s1ceuBUnMUAeoAHHw,8,10,0,4,0,2,2,0,18,2.5714285714285716,1,0.0,0,0,4,0,10,2,0,2,0,4,14,1
1565,37831,fmoIo5oPDyRcnHhnGH8MKyUTeXZvimIR,SpATywNh6bZuzm8s1ceuBUnMUAeoAHHw,17,44,22,13,6,58,35,1,179,25.571428571428573,6,0.0,3,22,11,6,41,58,2,35,1,42,137,0
1566,37834,nEvQSo5dnPEv9AKi5Mbvgqg4cF9OoMSW,SpATywNh6bZuzm8s1ceuBUnMUAeoAHHw,16,13,7,7,3,4,10,1,45,6.428571428571429,1,0.0,3,7,6,3,10,4,1,10,1,19,26,1
1567,37873,dpBOLaUWFOAehWXZrpwiocVfiOMhN5GL,SpATywNh6bZuzm8s1ceuBUnMUAeoAHHw,29,52,17,37,12,5,13,0,136,19.428571428571427,2,0.0,24,17,30,12,28,5,7,13,0,83,53,0
1568,37883,9Uee7oEuuMmgPx2IzPfFkWgkHZyPbWr0,SpATywNh6bZuzm8s1ceuBUnMUAeoAHHw,14,22,13,9,7,0,2,0,53,7.571428571428571,4,0.0,7,13,9,7,15,0,0,2,0,36,17,0
1569,37887,5vUuq5ZeDCNce4LmvH0naoUjpb3qbNOp,bWdj2GDclj5ofokWjzoa5jAwMkxCykd6,8,15,6,18,3,0,5,0,47,6.714285714285714,3,0.0,3,6,16,3,12,0,2,5,0,28,19,1
1570,37893,UOoqOWQxtJ6HvrytZgfqguIfOgaBqbBw,SpATywNh6bZuzm8s1ceuBUnMUAeoAHHw,7,5,1,0,1,0,2,0,9,1.2857142857142858,1,0.0,0,1,0,1,5,0,0,2,0,2,7,1
1571,37894,qPQsrCDbNr80CImeaDwXdvYkweQdyVus,RXDvfPUBYFlVdlueBFbLW0mhhAyGEqpt,13,5,5,0,2,1,5,1,19,2.7142857142857144,1,0.0,0,5,0,2,5,1,0,5,1,7,12,0
1572,37904,313ZU7SnTnilkzRb4b84vNDTmwgTEy5n,G8EPVSXsOYB5YQWZGiz1aVq5Pgr2GrQu,21,12,10,0,10,0,3,0,35,5.0,2,0.0,0,10,0,10,12,0,0,3,0,20,15,1
1573,37905,lV4ifbsehEXWBwQOY9bU762jcRSMFY5M,SpATywNh6bZuzm8s1ceuBUnMUAeoAHHw,30,49,20,16,7,0,12,1,105,15.0,4,0.0,14,20,16,7,35,0,0,12,1,57,48,0
1574,37908,JWUvlcN404PLe0TeFXcH9piP650rZWof,SpATywNh6bZuzm8s1ceuBUnMUAeoAHHw,9,36,9,0,2,1,16,0,64,9.142857142857142,4,0.0,0,9,0,2,36,1,0,16,0,11,53,1
1575,37913,iBI4oBYQahSrgJM5NHLRivWj4vPgILKH,G8EPVSXsOYB5YQWZGiz1aVq5Pgr2GrQu,9,10,4,0,4,0,2,0,20,2.857142857142857,2,0.0,5,4,0,4,5,0,0,2,0,13,7,1
1576,37926,mUOanMUrsiycv8pF8RX4xyc7qtUXAMUs,bWdj2GDclj5ofokWjzoa5jAwMkxCykd6,15,25,11,52,11,0,3,0,102,14.571428571428571,3,0.0,10,11,47,11,15,0,5,3,0,79,23,1
1577,37929,Trm6c0xRzFyegURuKBBdNUenucp5uZb9,G8EPVSXsOYB5YQWZGiz1aVq5Pgr2GrQu,8,21,8,0,3,1,8,0,41,5.857142857142857,1,0.0,7,8,0,3,14,1,0,8,0,18,23,1
1578,37932,UYyUkvxHd4tIc6aiQcuHfsTYHPlQXaAb,G8EPVSXsOYB5YQWZGiz1aVq5Pgr2GrQu,27,27,21,14,20,0,8,5,95,13.571428571428571,2,0.0,4,21,11,20,23,0,3,8,5,56,39,1
1579,37949,QRq9SneqdOEdNrPCbzGfNOJsUrpMzzSX,A3fsA9Zfv1X2fVEQhTw51lKENdNrEqT3,6,2,1,0,0,1,6,1,11,1.5714285714285714,1,0.0,0,1,0,0,2,1,0,6,1,1,10,1
1580,37958,O3fc8NICaVWUo8M4PzoZRSLRDAOYKQm9,G8EPVSXsOYB5YQWZGiz1aVq5Pgr2GrQu,6,12,0,6,0,0,2,0,20,2.857142857142857,2,0.0,3,0,4,0,9,0,2,2,0,7,13,1
1581,37961,lI4gYBH1elniUs6lU536XKdTVOMiS4n1,SpATywNh6bZuzm8s1ceuBUnMUAeoAHHw,16,37,11,11,3,0,21,2,85,12.142857142857142,3,0.0,7,11,11,3,30,0,0,21,2,32,53,1
1582,37963,zyXPxdyvET7shVCE1kkdKwMY47AukbuA,G8EPVSXsOYB5YQWZGiz1aVq5Pgr2GrQu,13,11,2,0,2,12,10,1,38,5.428571428571429,2,0.0,2,2,0,2,9,12,0,10,1,6,32,0
1583,37968,o4fNZaSYX3UHutrkuKOAdzPPx4q40e5R,G8EPVSXsOYB5YQWZGiz1aVq5Pgr2GrQu,4,5,0,0,0,0,2,0,7,1.0,2,0.0,0,0,0,0,5,0,0,2,0,0,7,1
1584,37972,k0lvFNaTVHTtB1XHBZ8229ej4v1r4rPk,A3fsA9Zfv1X2fVEQhTw51lKENdNrEqT3,13,11,5,0,2,3,12,1,34,4.857142857142857,3,0.0,0,5,0,2,11,3,0,12,1,7,27,0
1585,37977,0w9tP8TINgzfbBeYFJprB82ry0PjYiWn,A3fsA9Zfv1X2fVEQhTw51lKENdNrEqT3,8,9,1,0,1,0,2,0,13,1.8571428571428572,1,0.0,0,1,0,1,9,0,0,2,0,2,11,1
1586,37992,lFmplH6KaQigIQOByvMn1p8i4p6OLLhs,SpATywNh6bZuzm8s1ceuBUnMUAeoAHHw,14,13,5,16,3,0,4,0,41,5.857142857142857,1,0.0,6,5,13,3,7,0,3,4,0,27,14,1
1587,37993,pYcnIzYPgb3xzrOvmR9y0UUIZo4gqKuO,SpATywNh6bZuzm8s1ceuBUnMUAeoAHHw,18,46,26,12,13,7,15,1,120,17.142857142857142,3,0.0,12,26,10,13,34,7,2,15,1,61,59,0
1588,37997,Y65j88wkyz5DKML6XOG6DUVrzLQhWfST,A3fsA9Zfv1X2fVEQhTw51lKENdNrEqT3,1,0,0,0,0,0,1,0,1,0.14285714285714285,1,0.0,0,0,0,0,0,0,0,1,0,0,1,1
1589,38005,u82lBhpDxJIwlZISEntCxj1zgVFdW0vT,RXDvfPUBYFlVdlueBFbLW0mhhAyGEqpt,1,0,0,0,0,0,1,0,1,0.14285714285714285,1,0.0,0,0,0,0,0,0,0,1,0,0,1,1
1590,38028,vxPhImq7e3kAhm2TgSi6LMfFEt4O2oEs,G8EPVSXsOYB5YQWZGiz1aVq5Pgr2GrQu,1,0,0,0,0,0,1,0,1,0.14285714285714285,1,0.0,0,0,0,0,0,0,0,1,0,0,1,1
1591,38049,7n0QZ7z1Xa9itNmJQbQwoSvEI6n7oD9f,G8EPVSXsOYB5YQWZGiz1aVq5Pgr2GrQu,29,21,16,22,14,4,8,3,88,12.571428571428571,2,0.0,2,16,18,14,19,4,4,8,3,50,38,0
1592,38066,3JBai7u7WOgX09HExPUwVpNowvdvIz4R,SpATywNh6bZuzm8s1ceuBUnMUAeoAHHw,8,14,3,0,3,0,6,0,26,3.7142857142857144,1,0.0,0,3,0,3,14,0,0,6,0,6,20,1
1593,38077,ltTao4EsmrwmN0pXNyC05GxRX7ymLAGM,SpATywNh6bZuzm8s1ceuBUnMUAeoAHHw,15,41,1,21,1,23,15,2,104,14.857142857142858,2,0.0,10,1,15,1,31,23,6,15,2,27,77,1
1594,38080,OF5BECbAO5zdcqQHFPvLM1mTcTskbMIs,SpATywNh6bZuzm8s1ceuBUnMUAeoAHHw,5,2,1,0,1,0,2,0,6,0.8571428571428571,1,0.0,0,1,0,1,2,0,0,2,0,2,4,1
1595,38096,EjRGtyRd7Px8PMzWSSey4NzmMFY5f6ai,A3fsA9Zfv1X2fVEQhTw51lKENdNrEqT3,7,5,0,0,0,0,3,0,8,1.1428571428571428,1,0.0,1,0,0,0,4,0,0,3,0,1,7,1
1596,38115,iVCEmNfeCwWMGAqNUnWf3L8wEjKUErLk,SpATywNh6bZuzm8s1ceuBUnMUAeoAHHw,13,10,7,8,6,0,2,0,33,4.714285714285714,1,0.0,2,7,7,6,8,0,1,2,0,22,11,1
1597,38117,udxFfabXtaVUvVlT3wEleIvfDBGe9yE2,SpATywNh6bZuzm8s1ceuBUnMUAeoAHHw,25,68,3,36,1,33,23,3,167,23.857142857142858,4,0.0,22,3,30,1,46,33,6,23,3,56,111,0
1598,38119,53oi8zKKD3qFJiM7JZLKGYnyxQCMyuUV,SpATywNh6bZuzm8s1ceuBUnMUAeoAHHw,24,27,16,3,8,0,12,0,66,9.428571428571429,3,0.0,2,16,3,8,25,0,0,12,0,29,37,0
1599,38128,UwkR7Vh4zbozAucPqUcQw4h7SMZr9zo0,G8EPVSXsOYB5YQWZGiz1aVq5Pgr2GrQu,31,51,14,46,12,3,22,3,151,21.571428571428573,1,0.0,18,14,35,12,33,3,11,22,3,79,72,1
1600,38133,cqdnmjbJq0lDv2xgeKuzXqVr5xQytWr0,SpATywNh6bZuzm8s1ceuBUnMUAeoAHHw,14,31,13,12,5,5,13,2,81,11.571428571428571,3,0.0,10,13,10,5,21,5,2,13,2,38,43,1
1601,38138,mInRZ91i4VWL94xI1UV5JCnlg7Y6Us1i,SpATywNh6bZuzm8s1ceuBUnMUAeoAHHw,9,9,3,19,1,2,3,0,37,5.285714285714286,1,0.0,5,3,16,1,4,2,3,3,0,25,12,1
1602,38143,NuIu6w9t8Lc1HMDSYdxabpGimNAWlvNQ,SpATywNh6bZuzm8s1ceuBUnMUAeoAHHw,1,0,0,0,0,0,3,0,3,0.42857142857142855,1,0.0,0,0,0,0,0,0,0,3,0,0,3,1
1603,38158,i1weaEaafaiWi31Ms4bwoF6JM4IRf714,SpATywNh6bZuzm8s1ceuBUnMUAeoAHHw,17,33,14,14,6,0,12,0,79,11.285714285714286,3,0.0,10,14,10,6,23,0,4,12,0,40,39,0
1604,38221,cANiCKhLAefO0FGisAnCzMrx1JIRd95C,SpATywNh6bZuzm8s1ceuBUnMUAeoAHHw,1,0,0,0,0,0,1,0,1,0.14285714285714285,1,0.0,0,0,0,0,0,0,0,1,0,0,1,1
1605,38230,iazFnp0WwUGX79mDdFk78xSp9PPvWXim,G8EPVSXsOYB5YQWZGiz1aVq5Pgr2GrQu,9,2,1,0,1,5,9,1,19,2.7142857142857144,1,0.0,0,1,0,1,2,5,0,9,1,2,17,1
1606,38233,ysJor7TWBYA7e95uEgB7VNWumWxuU518,SpATywNh6bZuzm8s1ceuBUnMUAeoAHHw,17,19,10,8,4,7,4,1,53,7.571428571428571,1,0.0,7,10,8,4,12,7,0,4,1,29,24,1
1607,38246,LTRNxyAcyQ3kCcXCEOrswo8s3Qc2KMU6,SpATywNh6bZuzm8s1ceuBUnMUAeoAHHw,9,21,3,0,2,0,9,0,35,5.0,4,0.0,0,3,0,2,21,0,0,9,0,5,30,1
1608,38247,jSpQCS8wUT6MHpQaGbLVjdDCTF3dAoT8,SpATywNh6bZuzm8s1ceuBUnMUAeoAHHw,18,41,16,24,8,22,20,1,132,18.857142857142858,3,0.0,18,16,20,8,23,22,4,20,1,62,70,0
1609,38253,sfuANiSFq72qS7aoKnyvPaRtXw7bLFiY,RXDvfPUBYFlVdlueBFbLW0mhhAyGEqpt,29,17,12,24,10,0,2,0,65,9.285714285714286,2,0.0,3,12,24,10,14,0,0,2,0,49,16,1
1610,38268,JDTEn5xJLcPCagcpPFhmwRsZ0N8AbJZ6,A3fsA9Zfv1X2fVEQhTw51lKENdNrEqT3,29,27,15,32,12,0,7,0,93,13.285714285714286,3,0.0,1,15,25,12,26,0,7,7,0,53,40,1
1611,38270,Dw8R0agU0UT0CHCyap3lEB834WRdn2Bl,SpATywNh6bZuzm8s1ceuBUnMUAeoAHHw,12,65,24,5,14,0,24,0,132,18.857142857142858,6,0.0,0,24,5,14,65,0,0,24,0,43,89,1
1612,38298,5FKi7MQVDgjqvQXvzQgvsTDVCkGiyjdK,SpATywNh6bZuzm8s1ceuBUnMUAeoAHHw,26,20,15,10,12,0,24,2,83,11.857142857142858,4,0.0,4,15,10,12,16,0,0,24,2,41,42,0
1613,38314,AVyodBv8C1SQfOiSO7xOfqn4Ds4wiCRY,A3fsA9Zfv1X2fVEQhTw51lKENdNrEqT3,17,14,1,0,0,15,10,1,41,5.857142857142857,2,0.0,0,1,0,0,14,15,0,10,1,1,40,1
1614,38327,rB1ONc72srD5rc2RXozcacnvBYqDF9fo,SpATywNh6bZuzm8s1ceuBUnMUAeoAHHw,14,25,1,9,3,1,5,0,44,6.285714285714286,2,0.0,14,1,9,3,11,1,0,5,0,27,17,1
1615,38328,XwPjxWDcCDaPkH71IgDdIxnm3Wz6b30d,SpATywNh6bZuzm8s1ceuBUnMUAeoAHHw,7,5,4,0,3,0,2,0,14,2.0,1,0.0,0,4,0,3,5,0,0,2,0,7,7,1
1616,38346,0KKudduxSM0i9qq9j381LmD3t0z9aJ9R,SpATywNh6bZuzm8s1ceuBUnMUAeoAHHw,14,29,2,10,0,5,18,1,65,9.285714285714286,5,0.0,14,2,10,0,15,5,0,18,1,26,39,0
1617,38356,DJeWlgB4cP1RQ3JZLa1wZwd4zgAbYOxv,SpATywNh6bZuzm8s1ceuBUnMUAeoAHHw,19,24,19,0,12,0,4,0,59,8.428571428571429,3,0.0,1,19,0,12,23,0,0,4,0,32,27,1
1618,38373,tiRtyjdLAEYu3JNWmyxWqeCTg4ly9Ea3,A3fsA9Zfv1X2fVEQhTw51lKENdNrEqT3,1,0,0,0,0,0,1,0,1,0.14285714285714285,1,0.0,0,0,0,0,0,0,0,1,0,0,1,1
1619,38379,bA9VLpiTLkvmdt5uyFO2FBNAiu4jehWj,SpATywNh6bZuzm8s1ceuBUnMUAeoAHHw,6,2,1,0,1,0,3,1,8,1.1428571428571428,1,0.0,0,1,0,1,2,0,0,3,1,2,6,1
1620,38386,MAkHN0TS4uaTPgKLso4eQ3LTCDiU28De,A3fsA9Zfv1X2fVEQhTw51lKENdNrEqT3,5,2,1,0,1,0,7,0,11,1.5714285714285714,2,0.0,0,1,0,1,2,0,0,7,0,2,9,1
1621,38396,4hVUUGEGYiw6Bdgp8UlEBQC8ko8eVYqV,G8EPVSXsOYB5YQWZGiz1aVq5Pgr2GrQu,10,17,1,6,1,0,2,0,27,3.857142857142857,2,0.0,6,1,4,1,11,0,2,2,0,12,15,1
1622,38414,sDWigCKujHowENc4QsnIRZ8UQl2larGF,RXDvfPUBYFlVdlueBFbLW0mhhAyGEqpt,6,9,2,0,1,0,1,0,13,1.8571428571428572,1,0.0,1,2,0,1,8,0,0,1,0,4,9,1
1623,38416,3koO9aMoYp8zzErC814zevxBi6TaaAOF,SpATywNh6bZuzm8s1ceuBUnMUAeoAHHw,14,16,1,25,0,37,11,5,95,13.571428571428571,2,0.0,6,1,20,0,10,37,5,11,5,27,68,0
1624,38436,v9mjKPlqj9n2M1xFKzFtpQVo3yi6HxGV,A3fsA9Zfv1X2fVEQhTw51lKENdNrEqT3,32,59,35,54,17,1,14,0,180,25.714285714285715,4,0.0,9,35,43,17,50,1,11,14,0,104,76,1
1625,38441,iwk5jwRoUXpb7apwoAzA2sr9pA9dpqVB,bWdj2GDclj5ofokWjzoa5jAwMkxCykd6,2,0,0,0,0,0,6,0,6,0.8571428571428571,2,0.0,0,0,0,0,0,0,0,6,0,0,6,1
1626,38442,r6bvKJ2a2G72TbQZE3LacWwmKi7rGXEx,G8EPVSXsOYB5YQWZGiz1aVq5Pgr2GrQu,8,11,3,0,3,0,2,0,19,2.7142857142857144,1,0.0,0,3,0,3,11,0,0,2,0,6,13,1
1627,38444,hBkBlAVjz5BY7zZnohogA0eA3ndLKNkg,SpATywNh6bZuzm8s1ceuBUnMUAeoAHHw,16,26,9,4,3,0,21,1,64,9.142857142857142,3,0.0,5,9,4,3,21,0,0,21,1,21,43,1
1628,38462,VUqbVeGCU5BsVYNffcOAJ9BDqeO65P9U,G8EPVSXsOYB5YQWZGiz1aVq5Pgr2GrQu,34,9,6,126,3,9,8,1,162,23.142857142857142,1,0.0,0,6,105,3,9,9,21,8,1,114,48,1
1629,38468,SHRanMph56qnHJKMofxrIA8VyLg99gvL,SpATywNh6bZuzm8s1ceuBUnMUAeoAHHw,16,54,25,12,11,3,33,0,138,19.714285714285715,7,0.0,9,25,10,11,45,3,2,33,0,55,83,0
1630,38469,kOr03XnYLBaytLqdfTXgh6ll5b7wmEto,SpATywNh6bZuzm8s1ceuBUnMUAeoAHHw,22,24,11,36,3,16,7,1,98,14.0,3,0.0,10,11,30,3,14,16,6,7,1,54,44,0
1631,38478,wYSxpzhDGDxqe5tb8zcGOA1V0q1ivqUs,SpATywNh6bZuzm8s1ceuBUnMUAeoAHHw,9,14,5,0,2,0,2,0,23,3.2857142857142856,1,0.0,8,5,0,2,6,0,0,2,0,15,8,1
1632,38487,G9YOnYlxMjTyBQskKi3FlOCiDMxWpomt,SpATywNh6bZuzm8s1ceuBUnMUAeoAHHw,18,22,10,5,6,0,3,0,46,6.571428571428571,2,0.0,1,10,4,6,21,0,1,3,0,21,25,1
1633,38491,UEGgGFOddxp081siu8g5s2awm2LAgg2C,SpATywNh6bZuzm8s1ceuBUnMUAeoAHHw,5,5,0,0,0,0,2,0,7,1.0,1,0.0,2,0,0,0,3,0,0,2,0,2,5,0
1634,38510,OsVYZ2chBGfS6TvOshYA5qBASHIKNM7Z,SpATywNh6bZuzm8s1ceuBUnMUAeoAHHw,18,26,15,16,6,35,14,2,114,16.285714285714285,4,0.0,2,15,14,6,24,35,2,14,2,37,77,1
1635,38516,5zW7QL5PVg4tmiZ3UmDwoFtZ0u1EHg1C,G8EPVSXsOYB5YQWZGiz1aVq5Pgr2GrQu,1,0,0,0,0,0,1,0,1,0.14285714285714285,1,0.0,0,0,0,0,0,0,0,1,0,0,1,1
1636,38521,WRiHtWJX61VUGyAGQFSHJ3czdrgqxeQW,G8EPVSXsOYB5YQWZGiz1aVq5Pgr2GrQu,1,0,0,0,0,0,3,0,3,0.42857142857142855,3,0.0,0,0,0,0,0,0,0,3,0,0,3,1
1637,38524,0utD2vP6cBRtrip5Htxbgl8CGlMSWQLX,SpATywNh6bZuzm8s1ceuBUnMUAeoAHHw,6,1,1,0,1,2,5,0,10,1.4285714285714286,3,0.0,0,1,0,1,1,2,0,5,0,2,8,1
1638,38533,pqUcxq00SFcjmnxHDdHJfvpMD3HzyhM8,A3fsA9Zfv1X2fVEQhTw51lKENdNrEqT3,9,7,4,0,1,1,7,0,20,2.857142857142857,4,0.0,0,4,0,1,7,1,0,7,0,5,15,0
1639,38542,kzXC5gLwxzrAZMym3dLm7LbQsy5flpkC,SpATywNh6bZuzm8s1ceuBUnMUAeoAHHw,1,0,0,0,0,0,1,0,1,0.14285714285714285,1,0.0,0,0,0,0,0,0,0,1,0,0,1,1
1640,38559,fd1NhQTFxl8TsBhiRc4F6bEwrFxQh7qC,bWdj2GDclj5ofokWjzoa5jAwMkxCykd6,5,2,1,0,1,0,2,0,6,0.8571428571428571,1,0.0,0,1,0,1,2,0,0,2,0,2,4,1
1641,38560,op5Oi3uTeIRoABlsMVgAwjAoITQ3GmAH,SpATywNh6bZuzm8s1ceuBUnMUAeoAHHw,17,25,11,15,5,0,6,0,62,8.857142857142858,1,0.0,12,11,13,5,13,0,2,6,0,41,21,1
1642,38566,LU9kxt8aKnlOn8SnA2EuX2MLajf5Sg2a,A3fsA9Zfv1X2fVEQhTw51lKENdNrEqT3,9,5,2,0,3,0,2,0,12,1.7142857142857142,1,0.0,1,2,0,3,4,0,0,2,0,6,6,1
1643,38569,5Rbvag4nzKt7RfTqiThTliUWaR0ZVWak,RXDvfPUBYFlVdlueBFbLW0mhhAyGEqpt,29,32,25,29,12,21,20,17,156,22.285714285714285,3,0.0,3,25,27,12,29,21,2,20,17,67,89,1
1644,38603,BK89tGWFvtCB5b9BaDDNxW929HW7wR4P,G8EPVSXsOYB5YQWZGiz1aVq5Pgr2GrQu,12,14,4,8,3,0,4,0,33,4.714285714285714,3,0.0,5,4,5,3,9,0,3,4,0,17,16,0
1645,38604,piuFZPcLrtqUCR4Mz7Dvqp0k5ELkq8NC,G8EPVSXsOYB5YQWZGiz1aVq5Pgr2GrQu,12,16,10,0,9,0,6,0,41,5.857142857142857,2,0.0,3,10,0,9,13,0,0,6,0,22,19,1
1646,38608,J0IJ83RVowrJWkvIAkcS1VNIhpCHoyob,A3fsA9Zfv1X2fVEQhTw51lKENdNrEqT3,5,1,1,0,1,0,2,0,5,0.7142857142857143,1,0.0,0,1,0,1,1,0,0,2,0,2,3,1
1647,38624,1eeJGwVZl6tkgP8o5hxfgeveRzoyzGC1,SpATywNh6bZuzm8s1ceuBUnMUAeoAHHw,17,12,7,10,3,5,5,1,43,6.142857142857143,2,0.0,2,7,8,3,10,5,2,5,1,20,23,1
1648,38626,vmk0Cb97y6KFP4NN2aQejQh8kNwAKs9K,SpATywNh6bZuzm8s1ceuBUnMUAeoAHHw,5,5,0,0,0,0,2,0,7,1.0,2,0.0,0,0,0,0,5,0,0,2,0,0,7,1
1649,38648,74izHUTVIKwdbm5ACRGoK7PWOEfmZhU5,bWdj2GDclj5ofokWjzoa5jAwMkxCykd6,6,4,2,10,1,0,1,0,18,2.5714285714285716,1,0.0,1,2,9,1,3,0,1,1,0,13,5,0
1650,38650,k1hHR6rkUwES1hOj6qPmM0zEpPF3eP6v,SpATywNh6bZuzm8s1ceuBUnMUAeoAHHw,7,4,3,0,3,0,2,0,12,1.7142857142857142,1,0.0,0,3,0,3,4,0,0,2,0,6,6,1
1651,38654,wJIBDD9rPqnYMIKUazC26GmZhLI0Mfvr,RXDvfPUBYFlVdlueBFbLW0mhhAyGEqpt,26,46,24,0,14,12,19,3,118,16.857142857142858,5,0.0,9,24,0,14,37,12,0,19,3,47,71,1
1652,38678,TZQB6KsadY5lwvd9JKuw3u0s2cwQm2RY,A3fsA9Zfv1X2fVEQhTw51lKENdNrEqT3,1,0,0,0,0,0,1,0,1,0.14285714285714285,1,0.0,0,0,0,0,0,0,0,1,0,0,1,1
1653,38683,7uDVcwukNss0paMtTOJXNPZUXWP9vYuG,A3fsA9Zfv1X2fVEQhTw51lKENdNrEqT3,5,2,1,0,1,0,2,0,6,0.8571428571428571,1,0.0,0,1,0,1,2,0,0,2,0,2,4,1
1654,38686,pNgLScEwGgq81vg0a0cEXKNs5eG2UXph,A3fsA9Zfv1X2fVEQhTw51lKENdNrEqT3,44,28,14,88,9,9,10,1,159,22.714285714285715,3,0.0,2,14,88,9,26,9,0,10,1,113,46,1
1655,38691,dCqryZS5yEyDDbYzWpFyoRjFGlVzafA6,SpATywNh6bZuzm8s1ceuBUnMUAeoAHHw,22,46,23,5,10,0,6,0,90,12.857142857142858,5,0.0,14,23,4,10,32,0,1,6,0,51,39,0
1656,38701,E4KzNEU3ybRlAOiHqHHsGQEXiaxyHgoT,RXDvfPUBYFlVdlueBFbLW0mhhAyGEqpt,50,64,29,131,19,34,19,19,315,45.0,3,0.0,26,29,118,19,38,34,13,19,19,192,123,0
1657,38718,KtiXcHNNiby4TrKgvBuU25mstwPooCPe,SpATywNh6bZuzm8s1ceuBUnMUAeoAHHw,16,24,7,16,3,0,5,0,55,7.857142857142857,2,0.0,14,7,14,3,10,0,2,5,0,38,17,1
1658,38728,afat5vUgkwgUU0apBrv11YGTyd4OwYTu,SpATywNh6bZuzm8s1ceuBUnMUAeoAHHw,4,0,0,0,0,1,3,0,4,0.5714285714285714,1,0.0,0,0,0,0,0,1,0,3,0,0,4,1
1659,38737,afat5vUgkwgUU0apBrv11YGTyd4OwYTu,A3fsA9Zfv1X2fVEQhTw51lKENdNrEqT3,2,0,0,0,0,0,2,0,2,0.2857142857142857,1,0.0,0,0,0,0,0,0,0,2,0,0,2,1
1660,38739,nPRsjektHdbQkeAf1fIK4JbhrESPbPsA,A3fsA9Zfv1X2fVEQhTw51lKENdNrEqT3,5,4,0,0,0,21,3,0,28,4.0,2,0.0,0,0,0,0,4,21,0,3,0,0,28,1
1661,38742,0kgVI4xJnG62oDVcCEoC6XWb9EsWLjc0,bWdj2GDclj5ofokWjzoa5jAwMkxCykd6,1,0,0,0,0,0,1,0,1,0.14285714285714285,1,0.0,0,0,0,0,0,0,0,1,0,0,1,1
1662,38763,8YWaMVS3w7XpLYfFIo5KA8X2u5rBj2lm,bWdj2GDclj5ofokWjzoa5jAwMkxCykd6,1,0,0,0,0,0,1,0,1,0.14285714285714285,1,0.0,0,0,0,0,0,0,0,1,0,0,1,1
1663,38768,7mwJyfao5KIX49E5WhJbQSfLSpyhsypU,SpATywNh6bZuzm8s1ceuBUnMUAeoAHHw,2,0,0,0,0,0,2,0,2,0.2857142857142857,1,0.0,0,0,0,0,0,0,0,2,0,0,2,1
1664,38796,krjhlLET7SMyK6bykccAT1LqXqo0aBBB,A3fsA9Zfv1X2fVEQhTw51lKENdNrEqT3,1,0,0,0,0,0,1,0,1,0.14285714285714285,1,0.0,0,0,0,0,0,0,0,1,0,0,1,1
1665,38799,RzMIvT7jMzqf1FBzeYDC0G8NjaFmpbg8,SpATywNh6bZuzm8s1ceuBUnMUAeoAHHw,6,3,2,0,2,0,1,0,8,1.1428571428571428,1,0.0,0,2,0,2,3,0,0,1,0,4,4,0
1666,38828,RtAy5lws7b5k9geORbL2U1lmgZpp3fVx,SpATywNh6bZuzm8s1ceuBUnMUAeoAHHw,9,13,1,0,1,0,8,0,23,3.2857142857142856,2,0.0,0,1,0,1,13,0,0,8,0,2,21,1
1667,38840,cXYtpsZ2fQmsdTOBAQ6nuO3uUXQTXgSe,SpATywNh6bZuzm8s1ceuBUnMUAeoAHHw,2,0,0,0,0,0,2,0,2,0.2857142857142857,1,0.0,0,0,0,0,0,0,0,2,0,0,2,1
1668,38845,BuxVbSmnOVgkaYnbyCiqICvSSomeF2JH,G8EPVSXsOYB5YQWZGiz1aVq5Pgr2GrQu,12,16,1,2,1,2,10,0,32,4.571428571428571,2,0.0,1,1,1,1,15,2,1,10,0,4,28,1
1669,38854,Xi85gYtmIKPj1CmvXveeSMqfVqnWSguE,bWdj2GDclj5ofokWjzoa5jAwMkxCykd6,8,9,6,0,3,16,5,0,39,5.571428571428571,3,0.0,0,6,0,3,9,16,0,5,0,9,30,0
1670,38855,uEJhWNudTN4AiJAcLu3Q22sgnPRHYbuv,G8EPVSXsOYB5YQWZGiz1aVq5Pgr2GrQu,56,55,23,154,13,2,18,2,267,38.142857142857146,4,0.0,12,23,139,13,43,2,15,18,2,187,80,0
1671,38857,9803qM4isShkjkoVAPID7DQVAjFPwCDe,A3fsA9Zfv1X2fVEQhTw51lKENdNrEqT3,2,0,0,0,0,0,8,0,8,1.1428571428571428,2,0.0,0,0,0,0,0,0,0,8,0,0,8,1
1672,38870,jaeRBfNSkyTpFxAZieHe5vTAkzlHFDmm,A3fsA9Zfv1X2fVEQhTw51lKENdNrEqT3,18,9,7,0,6,5,10,1,38,5.428571428571429,1,0.0,0,7,0,6,9,5,0,10,1,13,25,1
1673,38878,gSi0VgWgYBTsmYmeH4PYrjNlMDLA1S2c,SpATywNh6bZuzm8s1ceuBUnMUAeoAHHw,12,14,1,7,3,1,7,3,36,5.142857142857143,2,0.0,2,1,6,3,12,1,1,7,3,12,24,1
1674,38882,KbRlzY47exomwt4drbIiBF6s4vNevAUk,bWdj2GDclj5ofokWjzoa5jAwMkxCykd6,8,5,4,0,3,0,1,0,13,1.8571428571428572,1,0.0,0,4,0,3,5,0,0,1,0,7,6,1
1675,38894,lxM1uzj9RbEKW6MEHQHbWmFRP8lCwFlm,RXDvfPUBYFlVdlueBFbLW0mhhAyGEqpt,5,2,1,0,1,0,2,0,6,0.8571428571428571,1,0.0,0,1,0,1,2,0,0,2,0,2,4,1
1676,38899,uOTUidrDT0SJfarFY02mqsETfS65OeG7,SpATywNh6bZuzm8s1ceuBUnMUAeoAHHw,1,0,0,0,0,0,1,0,1,0.14285714285714285,1,0.0,0,0,0,0,0,0,0,1,0,0,1,1
1677,38905,Zfldpr4XdX0KviQz44l3WyKQ1DUv2CZO,bWdj2GDclj5ofokWjzoa5jAwMkxCykd6,5,2,1,0,1,0,4,0,8,1.1428571428571428,2,0.0,0,1,0,1,2,0,0,4,0,2,6,1
1678,38907,arTGhRrKZksM4iY72XDJ8i8oBmMABS0m,bWdj2GDclj5ofokWjzoa5jAwMkxCykd6,8,6,1,0,0,1,5,1,14,2.0,2,0.0,0,1,0,0,6,1,0,5,1,1,13,1
1679,38920,0a9a6o0rpJD7kzJZwGRL9kB3jevQvRa8,SpATywNh6bZuzm8s1ceuBUnMUAeoAHHw,22,39,1,34,0,4,29,3,110,15.714285714285714,5,0.0,12,1,26,0,27,4,8,29,3,39,71,0
1680,38935,Bv9FSXvHlE6wLC4E4yrAKqe3BQhrrtfx,bWdj2GDclj5ofokWjzoa5jAwMkxCykd6,5,5,0,40,0,0,1,0,46,6.571428571428571,1,0.0,1,0,39,0,4,0,1,1,0,40,6,1
1681,38949,7HiGv3GGo0SXqM9pqC4B8FvUEghdfkna,A3fsA9Zfv1X2fVEQhTw51lKENdNrEqT3,19,28,5,0,3,3,20,0,59,8.428571428571429,4,0.0,0,5,0,3,28,3,0,20,0,8,51,0
1682,38975,pYuNHmli0QywI9Z1zHRuk8HH63MuG9ox,SpATywNh6bZuzm8s1ceuBUnMUAeoAHHw,7,4,3,0,1,0,2,0,10,1.4285714285714286,1,0.0,0,3,0,1,4,0,0,2,0,4,6,1
1683,38998,GxuI91smqBqnZvedxTapokE0d2tIuvjB,SpATywNh6bZuzm8s1ceuBUnMUAeoAHHw,11,12,1,16,0,0,3,1,33,4.714285714285714,1,0.0,5,1,14,0,7,0,2,3,1,20,13,1
1684,39003,kdrVEJc2I4GXXrnMfkE91hbE8pwDL5M5,SpATywNh6bZuzm8s1ceuBUnMUAeoAHHw,16,16,2,9,2,0,5,1,35,5.0,2,0.0,2,2,9,2,14,0,0,5,1,15,20,0
1685,39004,v74bXrlUV6ca8Hla1JfufyayJvtXjR7H,SpATywNh6bZuzm8s1ceuBUnMUAeoAHHw,6,3,1,0,1,0,2,0,7,1.0,1,0.0,0,1,0,1,3,0,0,2,0,2,5,1
1686,39023,t66hZYQIW0VPLqiRabyUSn9c1rXaD96i,G8EPVSXsOYB5YQWZGiz1aVq5Pgr2GrQu,9,12,4,0,5,0,3,1,25,3.5714285714285716,1,0.0,6,4,0,5,6,0,0,3,1,15,10,1
1687,39030,sUk3OLEiiNZtlo4krMYRLjkp5xwgbsPl,RXDvfPUBYFlVdlueBFbLW0mhhAyGEqpt,1,0,0,0,0,0,1,0,1,0.14285714285714285,1,0.0,0,0,0,0,0,0,0,1,0,0,1,1
1688,39031,3aJcxnpBDknIFELx5q7A1ed9nLB6csNj,A3fsA9Zfv1X2fVEQhTw51lKENdNrEqT3,8,4,3,0,3,0,1,0,11,1.5714285714285714,1,0.0,0,3,0,3,4,0,0,1,0,6,5,1
1689,39056,T4lMOZ9NGQ0RS4ue5IeZuDcW1ySIGZ9u,bWdj2GDclj5ofokWjzoa5jAwMkxCykd6,19,14,5,74,3,3,7,1,107,15.285714285714286,2,0.0,4,5,67,3,10,3,7,7,1,79,28,1
1690,39075,XyYnnl4AI9tScnU7RGEEZZNUDhUKeoxB,SpATywNh6bZuzm8s1ceuBUnMUAeoAHHw,4,3,2,0,1,0,3,0,9,1.2857142857142858,1,0.0,0,2,0,1,3,0,0,3,0,3,6,1
1691,39081,blQFA8HzhNQeb8MMYJXyJW6sPMdvZQKn,SpATywNh6bZuzm8s1ceuBUnMUAeoAHHw,13,14,5,6,4,1,1,0,31,4.428571428571429,1,0.0,8,5,6,4,6,1,0,1,0,23,8,1
1692,39083,1r2nGZGkg8GEqN3RApjS0ItoQ0nF4xaw,SpATywNh6bZuzm8s1ceuBUnMUAeoAHHw,1,0,0,0,0,0,2,0,2,0.2857142857142857,2,0.0,0,0,0,0,0,0,0,2,0,0,2,1
1693,39088,UvSPzXNBScAU9ByvT8o3qVBXbi67b3h8,G8EPVSXsOYB5YQWZGiz1aVq5Pgr2GrQu,5,5,1,0,1,0,1,0,8,1.1428571428571428,1,0.0,0,1,0,1,5,0,0,1,0,2,6,1
1694,39091,CJISoHtkGNnkB0CRrvBDw2uUj4sPNv5j,bWdj2GDclj5ofokWjzoa5jAwMkxCykd6,5,8,1,0,0,0,3,0,12,1.7142857142857142,3,0.0,0,1,0,0,8,0,0,3,0,1,11,1
1695,39095,Lc5TZPB93C58CDuO8VjF5g6g9boxDaHr,SpATywNh6bZuzm8s1ceuBUnMUAeoAHHw,15,33,1,22,0,45,17,1,119,17.0,2,0.0,15,1,19,0,18,45,3,17,1,35,84,1
1696,39098,N1NANPOEzVcSgsnoCvLHz8IcJu1p6TeM,bWdj2GDclj5ofokWjzoa5jAwMkxCykd6,1,0,0,0,0,0,1,0,1,0.14285714285714285,1,0.0,0,0,0,0,0,0,0,1,0,0,1,1
1697,39114,2nqqGgbA0MihvBXBZoRijk6wA6yRTkC8,SpATywNh6bZuzm8s1ceuBUnMUAeoAHHw,30,62,34,30,16,54,13,1,210,30.0,5,0.0,8,34,27,16,54,54,3,13,1,85,125,1
1698,39121,UflKWNcvi2MA5nN1C1yYIrKHClWLnxXf,SpATywNh6bZuzm8s1ceuBUnMUAeoAHHw,3,0,0,0,0,7,3,0,10,1.4285714285714286,2,0.0,0,0,0,0,0,7,0,3,0,0,10,1
1699,39134,wjTC7wnlKcnUR3GStNksYXKWSSmG8wiR,SpATywNh6bZuzm8s1ceuBUnMUAeoAHHw,9,5,4,0,3,0,5,0,17,2.4285714285714284,1,0.0,0,4,0,3,5,0,0,5,0,7,10,1
1700,39140,zVX5LPwTGC1SEitxSfv31cubNXKJSEc2,SpATywNh6bZuzm8s1ceuBUnMUAeoAHHw,2,0,0,0,0,0,2,0,2,0.2857142857142857,1,0.0,0,0,0,0,0,0,0,2,0,0,2,0
1701,39141,ILzL3Mkktf2JWNBXHKy152QukNojyWoV,SpATywNh6bZuzm8s1ceuBUnMUAeoAHHw,6,2,1,0,1,0,3,0,7,1.0,1,0.0,0,1,0,1,2,0,0,3,0,2,5,1
1702,39145,AVMp8F9T45cyhHDRnad5d9bxFkDP4PTv,bWdj2GDclj5ofokWjzoa5jAwMkxCykd6,1,0,0,0,0,0,1,0,1,0.14285714285714285,1,0.0,0,0,0,0,0,0,0,1,0,0,1,1
1703,39149,4UqKAySXvYrQJCWmxoUDAB7q5gWLAioi,SpATywNh6bZuzm8s1ceuBUnMUAeoAHHw,5,2,1,0,1,0,2,0,6,0.8571428571428571,1,0.0,0,1,0,1,2,0,0,2,0,2,4,1
1704,39154,BGVVwabO5K2aC65VwhxWT01Y18m3Nzj6,SpATywNh6bZuzm8s1ceuBUnMUAeoAHHw,15,40,1,14,1,86,11,3,156,22.285714285714285,3,0.0,14,1,13,1,26,86,1,11,3,29,127,0
1705,39157,1NMKv7RE12uBMKwNJI30Cx8Z5ltMGoee,RXDvfPUBYFlVdlueBFbLW0mhhAyGEqpt,1,0,0,0,0,0,1,0,1,0.14285714285714285,1,0.0,0,0,0,0,0,0,0,1,0,0,1,1
1706,39164,7GjcmlDBrfMQgiPOO8hsiYQuQLOINerQ,SpATywNh6bZuzm8s1ceuBUnMUAeoAHHw,28,43,17,32,7,0,7,0,106,15.142857142857142,3,0.0,20,17,28,7,23,0,4,7,0,72,34,0
1707,39173,ZzLLcAQUfjtXFFVyip2u00anhVLGCjVt,SpATywNh6bZuzm8s1ceuBUnMUAeoAHHw,6,3,1,0,1,0,2,0,7,1.0,1,0.0,0,1,0,1,3,0,0,2,0,2,5,1
1708,39177,HzHckETSltPKPBe9aHJBFKMPGsxyznRF,RXDvfPUBYFlVdlueBFbLW0mhhAyGEqpt,65,114,69,169,37,20,18,0,427,61.0,6,0.0,29,69,154,37,85,20,15,18,0,289,138,0
1709,39195,E4KzNEU3ybRlAOiHqHHsGQEXiaxyHgoT,G8EPVSXsOYB5YQWZGiz1aVq5Pgr2GrQu,16,38,9,34,7,3,5,0,96,13.714285714285714,2,0.0,25,9,21,7,13,3,13,5,0,62,34,0
1710,39200,mhEXeYR4fhAtV2BL9wCEhGJhQCxsqkvm,SpATywNh6bZuzm8s1ceuBUnMUAeoAHHw,10,8,3,0,5,0,11,0,27,3.857142857142857,1,0.0,5,3,0,5,3,0,0,11,0,13,14,1
1711,39228,46Kekotwda3n13NUXnmxT29j0BxeYz12,SpATywNh6bZuzm8s1ceuBUnMUAeoAHHw,5,2,1,0,1,0,2,0,6,0.8571428571428571,1,0.0,0,1,0,1,2,0,0,2,0,2,4,1
1712,39251,hmgBnYFDyZngu0mjeUhp0xYSYQ6O53Mz,SpATywNh6bZuzm8s1ceuBUnMUAeoAHHw,1,0,0,0,0,0,1,0,1,0.14285714285714285,1,0.0,0,0,0,0,0,0,0,1,0,0,1,1
1713,39253,eBPwvAxm4arXAr6DDABCeVRfgkKzrVG9,A3fsA9Zfv1X2fVEQhTw51lKENdNrEqT3,61,75,3,134,3,3,26,1,245,35.0,4,0.0,10,3,124,3,65,3,10,26,1,140,105,1
1714,39257,PATQ2JDuYcR1iRnRPNzs82w3vSQnScOh,A3fsA9Zfv1X2fVEQhTw51lKENdNrEqT3,1,0,0,0,0,0,1,0,1,0.14285714285714285,1,0.0,0,0,0,0,0,0,0,1,0,0,1,1
1715,39262,1w8EW76qmBSgQ2s8Jb4yoPsNX01KUcoD,SpATywNh6bZuzm8s1ceuBUnMUAeoAHHw,4,2,1,0,1,0,1,0,5,0.7142857142857143,1,0.0,0,1,0,1,2,0,0,1,0,2,3,1
1716,39271,MuWLBiVwYCkYNKOHYGJD8tH8opD9K24n,G8EPVSXsOYB5YQWZGiz1aVq5Pgr2GrQu,11,15,0,8,1,5,7,1,37,5.285714285714286,1,0.0,9,0,7,1,6,5,1,7,1,17,20,1
1717,39279,MbSy3vYucWpXbJ8XgmPxO6zrZOjC9oUB,SpATywNh6bZuzm8s1ceuBUnMUAeoAHHw,16,35,20,16,10,0,11,0,92,13.142857142857142,4,0.0,6,20,13,10,29,0,3,11,0,49,43,1
1718,39285,YqUtlfMe9rLKsCC9IaplFVEXt8vH7Xc8,SpATywNh6bZuzm8s1ceuBUnMUAeoAHHw,7,15,1,0,0,0,2,0,18,2.5714285714285716,1,0.0,4,1,0,0,11,0,0,2,0,5,13,1
1719,39321,zFmjJfAeKUvggwuYYEK06j1MuKf2V5Jp,G8EPVSXsOYB5YQWZGiz1aVq5Pgr2GrQu,8,2,1,0,1,0,5,1,10,1.4285714285714286,1,0.0,0,1,0,1,2,0,0,5,1,2,8,1
1720,39328,iJftBP3zncmjUCwGWSZ77IUrDb3Dt8rz,A3fsA9Zfv1X2fVEQhTw51lKENdNrEqT3,36,21,14,70,11,0,4,0,120,17.142857142857142,2,0.0,1,14,54,11,20,0,16,4,0,80,40,0
1721,39355,z3YnX73v2uoVHmuLGzQD2gKKBoJqIQxK,A3fsA9Zfv1X2fVEQhTw51lKENdNrEqT3,39,30,21,90,17,9,6,0,173,24.714285714285715,4,0.0,5,21,72,17,25,9,18,6,0,115,58,1
1722,39364,yl2extq9BiirsP1wIY2qyqtEIn2eAosn,A3fsA9Zfv1X2fVEQhTw51lKENdNrEqT3,12,15,7,0,1,2,8,1,34,4.857142857142857,1,0.0,1,7,0,1,14,2,0,8,1,9,25,1
1723,39369,nACUst6Z3nbYOefsNnWJBD4yiz9OCgPb,A3fsA9Zfv1X2fVEQhTw51lKENdNrEqT3,2,0,0,0,0,0,2,0,2,0.2857142857142857,1,0.0,0,0,0,0,0,0,0,2,0,0,2,1
1724,39386,xcD6YWhnGA2xukGmX4eaYrm6VS9ffz1H,A3fsA9Zfv1X2fVEQhTw51lKENdNrEqT3,1,0,0,0,0,0,1,0,1,0.14285714285714285,1,0.0,0,0,0,0,0,0,0,1,0,0,1,1
1725,39408,mC2fzvwPaO34Kq32ibCwzrJ2EjHwbRrb,A3fsA9Zfv1X2fVEQhTw51lKENdNrEqT3,23,63,34,0,23,0,12,1,133,19.0,3,0.0,0,34,0,23,63,0,0,12,1,57,76,1
1726,39416,NiOuJ51IxTtojHMts8OdX2AfCH09G7vK,SpATywNh6bZuzm8s1ceuBUnMUAeoAHHw,10,6,4,0,3,0,6,0,19,2.7142857142857144,2,0.0,0,4,0,3,6,0,0,6,0,7,12,1
1727,39435,eOxm8XEI11Xs6eiBi1Nu5QzIagZXwEm9,A3fsA9Zfv1X2fVEQhTw51lKENdNrEqT3,1,0,0,0,0,0,1,0,1,0.14285714285714285,1,0.0,0,0,0,0,0,0,0,1,0,0,1,1
1728,39437,YaP2AuckukEZITP3IVvIt6Z8ci6RHew7,A3fsA9Zfv1X2fVEQhTw51lKENdNrEqT3,33,39,35,18,21,1,7,1,122,17.428571428571427,2,0.0,0,35,15,21,39,1,3,7,1,71,51,1
1729,39438,PCU2OsmEUaGQvWJWbob5pKb7iiPbQ7ze,SpATywNh6bZuzm8s1ceuBUnMUAeoAHHw,17,31,5,8,4,2,30,1,81,11.571428571428571,6,0.0,11,5,8,4,20,2,0,30,1,28,53,1
1730,39445,P8w9ro0HOkoKzPyzFHSnLuYXXRtV1BHH,RXDvfPUBYFlVdlueBFbLW0mhhAyGEqpt,15,25,11,0,6,0,5,0,47,6.714285714285714,2,0.0,0,11,0,6,25,0,0,5,0,17,30,1
1731,39461,6Trp4kpO6fwwtbebtvF77MGUNovs9zvp,SpATywNh6bZuzm8s1ceuBUnMUAeoAHHw,15,12,8,14,6,0,5,0,45,6.428571428571429,2,0.0,3,8,13,6,9,0,1,5,0,30,15,1
1732,39480,CFP5BToaLlKEM1IV3uFEyj5nP0RKpJGG,RXDvfPUBYFlVdlueBFbLW0mhhAyGEqpt,14,20,11,0,6,5,8,0,50,7.142857142857143,1,0.0,0,11,0,6,20,5,0,8,0,17,33,1
1733,39481,evkJ1tKmVFYbszWTpTeoBUR5H84hykAY,SpATywNh6bZuzm8s1ceuBUnMUAeoAHHw,13,38,10,13,2,2,15,0,80,11.428571428571429,4,0.0,11,10,10,2,27,2,3,15,0,33,47,0
1734,39493,Sw0laYN5mow6XiHfrWCJl4qnRcU0Nesb,SpATywNh6bZuzm8s1ceuBUnMUAeoAHHw,14,17,9,14,3,0,5,0,48,6.857142857142857,4,0.0,3,9,13,3,14,0,1,5,0,28,20,0
1735,39498,iVCEmNfeCwWMGAqNUnWf3L8wEjKUErLk,A3fsA9Zfv1X2fVEQhTw51lKENdNrEqT3,1,0,0,0,0,0,1,0,1,0.14285714285714285,1,0.0,0,0,0,0,0,0,0,1,0,0,1,1
1736,39518,jeuXS3tUDyyNfvbrveLA3P9Aday4J2bg,SpATywNh6bZuzm8s1ceuBUnMUAeoAHHw,27,27,15,25,7,0,8,0,82,11.714285714285714,5,0.0,5,15,25,7,22,0,0,8,0,52,30,0
1737,39521,KkCL9hhbl4No8xC8Kgerd95M1LSlSYMD,G8EPVSXsOYB5YQWZGiz1aVq5Pgr2GrQu,29,77,4,50,2,14,32,2,181,25.857142857142858,3,0.0,30,4,38,2,47,14,12,32,2,74,107,0
1738,39522,WMPYVFkG1npps8BU0n5fJtN4LOF8N9L7,A3fsA9Zfv1X2fVEQhTw51lKENdNrEqT3,1,0,0,0,0,0,1,0,1,0.14285714285714285,1,0.0,0,0,0,0,0,0,0,1,0,0,1,1
1739,39523,U2HBhhMvJdYJzypYvAaM7auP4hEAIFmE,SpATywNh6bZuzm8s1ceuBUnMUAeoAHHw,25,25,12,29,4,10,9,2,91,13.0,2,0.0,9,12,27,4,16,10,2,9,2,52,39,0
1740,39528,UPv4XJg0qIN0z1e32NPBqipWdQJZCo5I,G8EPVSXsOYB5YQWZGiz1aVq5Pgr2GrQu,92,130,81,134,43,0,42,2,432,61.714285714285715,7,0.0,26,81,108,43,104,0,26,42,2,258,174,0
1741,39531,ZicPLcC85bFypm3Kcvbq59RwoYBxR8MH,A3fsA9Zfv1X2fVEQhTw51lKENdNrEqT3,32,20,8,50,2,1,21,2,104,14.857142857142858,5,0.0,4,8,45,2,16,1,5,21,2,59,45,1
1742,39532,cULoH8ZJIqrdeB8ADfKnnQ8THzmbMgQV,RXDvfPUBYFlVdlueBFbLW0mhhAyGEqpt,1,0,0,0,0,0,1,0,1,0.14285714285714285,1,0.0,0,0,0,0,0,0,0,1,0,0,1,1
1743,39542,rVLakh088SHEy7dbxY22je6HzyBvqGMw,A3fsA9Zfv1X2fVEQhTw51lKENdNrEqT3,5,2,1,0,1,0,2,0,6,0.8571428571428571,1,0.0,0,1,0,1,2,0,0,2,0,2,4,1
1744,39551,iwZaMWnVmB8vAWyB7qgI9UDj7NG1VyL9,G8EPVSXsOYB5YQWZGiz1aVq5Pgr2GrQu,17,36,14,14,4,1,1,0,70,10.0,3,0.0,3,14,12,4,33,1,2,1,0,33,37,1
1745,39566,Tgv3JnuulONnAU5nEHKsBYsIQCqMFPi1,SpATywNh6bZuzm8s1ceuBUnMUAeoAHHw,14,29,4,22,2,0,5,0,62,8.857142857142858,2,0.0,8,4,18,2,21,0,4,5,0,32,30,1
1746,39591,fqudw8MOLcF9t0i6q2XPWF2TIejKMZHF,SpATywNh6bZuzm8s1ceuBUnMUAeoAHHw,7,3,2,0,2,0,2,0,9,1.2857142857142858,1,0.0,0,2,0,2,3,0,0,2,0,4,5,1
1747,39602,il53m0D8iMReEupAF0qvTcyM0rInz34F,bWdj2GDclj5ofokWjzoa5jAwMkxCykd6,6,2,1,0,1,0,3,0,7,1.0,1,0.0,0,1,0,1,2,0,0,3,0,2,5,1
1748,39603,BYn6cWVQSMORsIVShYVRAnnkHpLyiUv8,A3fsA9Zfv1X2fVEQhTw51lKENdNrEqT3,14,11,8,0,4,0,5,0,28,4.0,3,0.0,0,8,0,4,11,0,0,5,0,12,16,1
1749,39610,5JJq364DIcWk9Vho0reVJETDCFza3l8p,SpATywNh6bZuzm8s1ceuBUnMUAeoAHHw,17,35,12,13,4,8,12,0,84,12.0,3,0.0,17,12,11,4,18,8,2,12,0,44,40,1
1750,39635,xcD6YWhnGA2xukGmX4eaYrm6VS9ffz1H,SpATywNh6bZuzm8s1ceuBUnMUAeoAHHw,30,54,30,24,12,11,16,0,147,21.0,5,0.0,13,30,21,12,41,11,3,16,0,76,71,0
1751,39643,IueU0b60sjtimOacIi9j88xjmyRWizli,G8EPVSXsOYB5YQWZGiz1aVq5Pgr2GrQu,15,16,9,12,3,4,16,8,68,9.714285714285714,3,0.0,0,9,10,3,16,4,2,16,8,22,46,0
1752,39650,6FzXe5nPWUHRxntREHsQRnp7x1pxuhUz,SpATywNh6bZuzm8s1ceuBUnMUAeoAHHw,27,71,31,16,15,0,11,0,144,20.571428571428573,5,0.0,18,31,16,15,53,0,0,11,0,80,64,0
1753,39665,XZfHeQwgEwa34fwsEe2zig6GAMNgCcPL,SpATywNh6bZuzm8s1ceuBUnMUAeoAHHw,16,48,19,5,9,4,20,1,106,15.142857142857142,3,0.0,11,19,4,9,37,4,1,20,1,43,63,1
1754,39667,eSr3zMoztxzII0MHEvdbKbrYmBK0ecDT,SpATywNh6bZuzm8s1ceuBUnMUAeoAHHw,9,13,6,0,3,2,4,0,28,4.0,2,0.0,0,6,0,3,13,2,0,4,0,9,19,1
1755,39692,s8yyjhcg4BVOip4HSP4txOTTHFJ4aWPU,bWdj2GDclj5ofokWjzoa5jAwMkxCykd6,1,0,0,0,0,0,4,0,4,0.5714285714285714,2,0.0,0,0,0,0,0,0,0,4,0,0,4,1
1756,39696,yvSkslbVS47eGhtXe3MSajZNXyqoO8P1,SpATywNh6bZuzm8s1ceuBUnMUAeoAHHw,16,14,9,12,4,3,9,0,51,7.285714285714286,1,0.0,2,9,11,4,12,3,1,9,0,26,25,1
1757,39708,eHl6vKLwTQcSxYHb6DIMnO9xh3WNvHJf,SpATywNh6bZuzm8s1ceuBUnMUAeoAHHw,23,25,13,18,9,4,6,0,75,10.714285714285714,3,0.0,10,13,18,9,15,4,0,6,0,50,25,0
1758,39712,wVfyl6WgFur5urtfx8TypP7osjiRs72N,SpATywNh6bZuzm8s1ceuBUnMUAeoAHHw,6,3,0,0,0,5,3,0,11,1.5714285714285714,1,0.0,1,0,0,0,2,5,0,3,0,1,10,1
1759,39737,qRawfA1fPOcB5hZkORgH0hm8Ghubmgi1,A3fsA9Zfv1X2fVEQhTw51lKENdNrEqT3,2,0,0,0,0,1,2,0,3,0.42857142857142855,1,0.0,0,0,0,0,0,1,0,2,0,0,3,0
1760,39748,Y6PIDel0N3JB5RPAU8dzX7ZliiFlTqHS,SpATywNh6bZuzm8s1ceuBUnMUAeoAHHw,10,15,0,0,0,2,9,0,26,3.7142857142857144,3,0.0,0,0,0,0,15,2,0,9,0,0,26,1
1761,39750,g6zfMiS5ibUHTabfgiFKHajbGLSVfwvj,SpATywNh6bZuzm8s1ceuBUnMUAeoAHHw,17,27,15,12,3,15,14,1,87,12.428571428571429,3,0.0,6,15,10,3,21,15,2,14,1,34,53,1
1762,39758,wIj7H8utbODHp6xu3FxVq3czUnyCOoPI,A3fsA9Zfv1X2fVEQhTw51lKENdNrEqT3,40,23,13,100,7,2,8,1,154,22.0,1,0.0,6,13,84,7,17,2,16,8,1,110,44,1
1763,39766,Bq3dgySLNxUfP2DnFVHYyEWwaDcd9ALN,A3fsA9Zfv1X2fVEQhTw51lKENdNrEqT3,21,14,10,0,9,0,4,0,37,5.285714285714286,3,0.0,0,10,0,9,14,0,0,4,0,19,18,1
1764,39785,LIcmzVFUc9QeLs85yNk05hYWndHHL2L3,A3fsA9Zfv1X2fVEQhTw51lKENdNrEqT3,10,6,5,0,5,0,4,2,22,3.142857142857143,1,0.0,0,5,0,5,6,0,0,4,2,10,12,1
1765,39793,suOeipVROVXXPGj0VZHJUUTxQ7mEMHZk,A3fsA9Zfv1X2fVEQhTw51lKENdNrEqT3,10,5,4,0,3,0,2,0,14,2.0,1,0.0,0,4,0,3,5,0,0,2,0,7,7,1
1766,39795,ePUeHwknBJGR0K3G08IRIZccLLyuYW03,SpATywNh6bZuzm8s1ceuBUnMUAeoAHHw,6,5,1,0,0,0,3,0,9,1.2857142857142858,2,0.0,0,1,0,0,5,0,0,3,0,1,8,1
1767,39803,VdNVtOVHu3uq36SFu7mu40diveL7bnVd,A3fsA9Zfv1X2fVEQhTw51lKENdNrEqT3,4,2,1,0,1,0,1,0,5,0.7142857142857143,1,0.0,0,1,0,1,2,0,0,1,0,2,3,1
1768,39804,KSzd6DMLdMMhFe5tf0DcSjOsxB002C2u,SpATywNh6bZuzm8s1ceuBUnMUAeoAHHw,9,10,4,0,2,1,15,2,34,4.857142857142857,1,0.0,0,4,0,2,10,1,0,15,2,6,28,1
1769,39840,eTm1NthBlqTXH0yqAhllYK6AeYLcvZS4,SpATywNh6bZuzm8s1ceuBUnMUAeoAHHw,28,29,16,31,8,2,5,0,91,13.0,5,0.0,7,16,27,8,22,2,4,5,0,58,33,1
1770,39841,9BRoND09uAkQha4X7ED5IFkfUaItyWWP,SpATywNh6bZuzm8s1ceuBUnMUAeoAHHw,4,3,1,0,1,0,1,0,6,0.8571428571428571,1,0.0,1,1,0,1,2,0,0,1,0,3,3,1
1771,39845,xwqLmgu4yZxUsX04FDtQMDL3awvB0E5w,SpATywNh6bZuzm8s1ceuBUnMUAeoAHHw,21,38,16,0,7,0,13,0,74,10.571428571428571,5,0.0,11,16,0,7,27,0,0,13,0,34,40,0
1772,39859,bgVZEKpin3FcOsrwuoniLCnRgCNbZTOm,G8EPVSXsOYB5YQWZGiz1aVq5Pgr2GrQu,17,21,16,30,8,0,4,0,79,11.285714285714286,3,0.0,0,16,24,8,21,0,6,4,0,48,31,1
1773,39878,pLB7K8hva7hpUpPIa0JWEXpoyBHIkbAO,SpATywNh6bZuzm8s1ceuBUnMUAeoAHHw,32,48,24,32,8,7,13,1,133,19.0,2,0.0,17,24,27,8,31,7,5,13,1,76,57,1
1774,39908,Ubjq3ZPvBATiaU1sX2JibbPoyNs9VBpQ,SpATywNh6bZuzm8s1ceuBUnMUAeoAHHw,1,0,0,0,0,0,1,0,1,0.14285714285714285,1,0.0,0,0,0,0,0,0,0,1,0,0,1,1
1775,39917,ElXKVW194Vk4gMqfG0BJNLqGRaVlSemx,bWdj2GDclj5ofokWjzoa5jAwMkxCykd6,1,0,0,0,0,0,1,0,1,0.14285714285714285,1,0.0,0,0,0,0,0,0,0,1,0,0,1,1
1776,39922,2GATpIfDBYFyTgYmFkr0bda9mVfNXuAl,SpATywNh6bZuzm8s1ceuBUnMUAeoAHHw,23,51,2,24,0,21,15,1,114,16.285714285714285,7,0.0,5,2,24,0,46,21,0,15,1,31,83,0
1777,39939,AVWcvCCDqAG8PgmRAI5YyxSBbxSiVsy5,SpATywNh6bZuzm8s1ceuBUnMUAeoAHHw,4,2,1,0,1,0,1,0,5,0.7142857142857143,1,0.0,0,1,0,1,2,0,0,1,0,2,3,1
1778,39942,ddMTOiTV5HSxEMNnjSDeiKLzuF1YmYcT,SpATywNh6bZuzm8s1ceuBUnMUAeoAHHw,4,3,2,0,0,0,1,0,6,0.8571428571428571,1,0.0,0,2,0,0,3,0,0,1,0,2,4,1
1779,39946,CkKaHAvtocTb1rem1r8BN1SLAQUDW1pY,bWdj2GDclj5ofokWjzoa5jAwMkxCykd6,6,1,1,0,1,1,4,0,8,1.1428571428571428,1,0.0,0,1,0,1,1,1,0,4,0,2,6,1
1780,39958,Peb8kjmFqGQvYDTvo4JTH8WhAEOnPF2h,SpATywNh6bZuzm8s1ceuBUnMUAeoAHHw,15,18,6,9,4,2,4,0,43,6.142857142857143,2,0.0,10,6,8,4,8,2,1,4,0,28,15,1
1781,39962,p3Cz4BAZGaZT08I2Dwew8OwWDC6PUWgc,SpATywNh6bZuzm8s1ceuBUnMUAeoAHHw,27,31,14,15,7,2,5,0,74,10.571428571428571,4,0.0,12,14,15,7,19,2,0,5,0,48,26,1
1782,39979,a3HtyjZsIXy0rlfdz7IVbfqFoPB13M3i,G8EPVSXsOYB5YQWZGiz1aVq5Pgr2GrQu,9,28,2,4,2,0,1,0,37,5.285714285714286,4,0.0,6,2,3,2,22,0,1,1,0,13,24,1
1783,39994,CFP5BToaLlKEM1IV3uFEyj5nP0RKpJGG,A3fsA9Zfv1X2fVEQhTw51lKENdNrEqT3,1,0,0,0,0,0,1,0,1,0.14285714285714285,1,0.0,0,0,0,0,0,0,0,1,0,0,1,1
1784,40026,JlRuZgjmv2hzO83ouspiZFc9FxGockFl,RXDvfPUBYFlVdlueBFbLW0mhhAyGEqpt,15,17,7,0,2,0,4,0,30,4.285714285714286,4,0.0,0,7,0,2,17,0,0,4,0,9,21,1
1785,40036,vUH5NhW2dOJJ7pGM4nFysRqnPlXzFZdY,SpATywNh6bZuzm8s1ceuBUnMUAeoAHHw,11,15,1,13,1,0,2,0,32,4.571428571428571,2,0.0,2,1,11,1,13,0,2,2,0,15,17,0
1786,40067,p2NSaI2ihMq1kpyPoZO7VVEhFNMs1UZl,G8EPVSXsOYB5YQWZGiz1aVq5Pgr2GrQu,62,57,1,354,2,8,20,1,443,63.285714285714285,3,0.0,21,1,294,2,36,8,60,20,1,318,125,0
1787,40073,gT1aUgmAT0anYSW9us4nwhFYETF9WL3j,bWdj2GDclj5ofokWjzoa5jAwMkxCykd6,5,3,1,0,1,0,3,0,8,1.1428571428571428,2,0.0,1,1,0,1,2,0,0,3,0,3,5,1
1788,40085,QWkN0K04zy6ocvNBygFS9V3b4yJPON6O,A3fsA9Zfv1X2fVEQhTw51lKENdNrEqT3,5,2,1,0,1,0,2,0,6,0.8571428571428571,2,0.0,0,1,0,1,2,0,0,2,0,2,4,1
1789,40097,Rf6xXor9EmVmU5Nrbaea2KpXMtqjkHJb,SpATywNh6bZuzm8s1ceuBUnMUAeoAHHw,14,20,9,22,5,4,2,0,62,8.857142857142858,1,0.0,5,9,18,5,15,4,4,2,0,37,25,0
1790,40105,D2f4XnvAFD8ZIkDvhpGbd6yCstJua9ut,G8EPVSXsOYB5YQWZGiz1aVq5Pgr2GrQu,1,0,0,0,0,0,1,0,1,0.14285714285714285,1,0.0,0,0,0,0,0,0,0,1,0,0,1,1
1791,40112,09EE7Mkw9FE0hqOEryjnyXTu6FbIkdRQ,SpATywNh6bZuzm8s1ceuBUnMUAeoAHHw,7,4,3,0,3,0,2,0,12,1.7142857142857142,2,0.0,0,3,0,3,4,0,0,2,0,6,6,1
1792,40123,KjOosnYqFuW1JYNSfMjuIU0UyjDNXuGi,SpATywNh6bZuzm8s1ceuBUnMUAeoAHHw,7,5,2,0,1,0,3,0,11,1.5714285714285714,2,0.0,1,2,0,1,4,0,0,3,0,4,7,1
1793,40125,znkDmOOvUgN8z7Q2bDidRTpqlGavufFM,SpATywNh6bZuzm8s1ceuBUnMUAeoAHHw,29,80,27,27,11,1,24,6,176,25.142857142857142,7,0.0,18,27,26,11,62,1,1,24,6,82,94,0
1794,40141,ysFko0fUHMpyKjTDsgomHFNCaIAr5cN9,A3fsA9Zfv1X2fVEQhTw51lKENdNrEqT3,1,0,0,0,0,0,1,0,1,0.14285714285714285,1,0.0,0,0,0,0,0,0,0,1,0,0,1,1
1795,40143,OZ02Yntpt8Hg8thsFgejT4NSsPYtVPPm,bWdj2GDclj5ofokWjzoa5jAwMkxCykd6,11,8,3,42,1,5,8,1,68,9.714285714285714,4,0.0,1,3,40,1,7,5,2,8,1,45,23,1
1796,40165,Vcn2Ncl6KVYaVVug7iW4LScBfpTMatic,RXDvfPUBYFlVdlueBFbLW0mhhAyGEqpt,12,25,1,0,1,4,15,1,47,6.714285714285714,3,0.0,5,1,0,1,20,4,0,15,1,7,40,1
1797,40178,JhXfd0Tlc69bJyZdJPZXaAHtjoBDG89W,A3fsA9Zfv1X2fVEQhTw51lKENdNrEqT3,21,46,4,14,2,1,20,1,88,12.571428571428571,5,0.0,5,4,10,2,41,1,4,20,1,21,67,0
1798,40185,abA1IbdNqvgGPTwvaYtddvUoLjzJEWlN,A3fsA9Zfv1X2fVEQhTw51lKENdNrEqT3,36,23,0,52,0,5,14,2,96,13.714285714285714,1,0.0,3,0,49,0,20,5,3,14,2,52,44,1
1799,40192,plUweHzNEQ6tYmm8ypkjZ9ZgEhzpu5iN,SpATywNh6bZuzm8s1ceuBUnMUAeoAHHw,14,14,7,12,3,0,4,0,40,5.714285714285714,2,0.0,2,7,9,3,12,0,3,4,0,21,19,1
1800,40195,8auKgQ1pXJtaAwUgQOq3AnlP8yJ8xKs8,SpATywNh6bZuzm8s1ceuBUnMUAeoAHHw,5,10,1,0,0,0,2,0,13,1.8571428571428572,2,0.0,0,1,0,0,10,0,0,2,0,1,12,1
1801,40206,5HnJOsNDqfUbmuHMu8iG6iEtOPev7Xxw,SpATywNh6bZuzm8s1ceuBUnMUAeoAHHw,6,3,1,0,1,0,3,0,8,1.1428571428571428,2,0.0,0,1,0,1,3,0,0,3,0,2,6,1
1802,40207,mVPS8qtXmBYw6oQCHhHlXYGOl1msXZRm,SpATywNh6bZuzm8s1ceuBUnMUAeoAHHw,16,23,8,18,3,0,6,0,58,8.285714285714286,2,0.0,5,8,15,3,18,0,3,6,0,31,27,1
1803,40208,5X4lGySxqBLFYnW7eAhu5WWLC7wvzcF3,A3fsA9Zfv1X2fVEQhTw51lKENdNrEqT3,39,33,15,72,11,0,1,0,132,18.857142857142858,1,0.0,1,15,63,11,32,0,9,1,0,90,42,1
1804,40223,cuLVLzIr2y459RDZRcVR3FYe8DHl8ZjT,SpATywNh6bZuzm8s1ceuBUnMUAeoAHHw,1,0,0,0,0,0,1,0,1,0.14285714285714285,1,0.0,0,0,0,0,0,0,0,1,0,0,1,1
1805,40224,sV3jtFrXfncSgh7Xsq4nWcxj42E0NrUb,SpATywNh6bZuzm8s1ceuBUnMUAeoAHHw,10,12,3,0,4,0,14,0,33,4.714285714285714,4,0.0,0,3,0,4,12,0,0,14,0,7,26,0
1806,40233,tBcWnrptNiGaZgy4k51BltzcKki801j1,bWdj2GDclj5ofokWjzoa5jAwMkxCykd6,1,0,0,0,0,0,1,0,1,0.14285714285714285,1,0.0,0,0,0,0,0,0,0,1,0,0,1,1
1807,40237,tBcWnrptNiGaZgy4k51BltzcKki801j1,A3fsA9Zfv1X2fVEQhTw51lKENdNrEqT3,1,0,0,0,0,0,2,0,2,0.2857142857142857,2,0.0,0,0,0,0,0,0,0,2,0,0,2,1
1808,40243,3LBUjm1FFFdQL8moOjwGZJaqcxdpVPTx,SpATywNh6bZuzm8s1ceuBUnMUAeoAHHw,12,19,2,0,2,4,10,0,37,5.285714285714286,3,0.0,6,2,0,2,13,4,0,10,0,10,27,1
1809,40258,vosTvFxoRyJk1cDtxUw2GTYeGEnrXcMJ,G8EPVSXsOYB5YQWZGiz1aVq5Pgr2GrQu,8,6,2,0,2,0,2,0,12,1.7142857142857142,1,0.0,0,2,0,2,6,0,0,2,0,4,8,0
1810,40272,FWTxDnNzcugqXGOfXWOseyRKl3gd7tL9,SpATywNh6bZuzm8s1ceuBUnMUAeoAHHw,9,12,2,0,1,0,3,0,18,2.5714285714285716,1,0.0,0,2,0,1,12,0,0,3,0,3,15,0
1811,40287,O1a4fHzT6b5r4IWUDa3zddRbshvfRlE4,A3fsA9Zfv1X2fVEQhTw51lKENdNrEqT3,35,25,18,62,2,0,6,0,113,16.142857142857142,3,0.0,2,18,53,2,23,0,9,6,0,75,38,1
1812,40310,qp5IXQZrLJFd9bS1JJL98d9ZDAq70kXN,SpATywNh6bZuzm8s1ceuBUnMUAeoAHHw,15,25,7,29,4,0,2,0,67,9.571428571428571,1,0.0,14,7,23,4,11,0,6,2,0,48,19,1
1813,40317,5FLIDnIga6PY7pJGfcQdTEADTcQg0s9O,G8EPVSXsOYB5YQWZGiz1aVq5Pgr2GrQu,4,2,1,0,0,0,3,0,6,0.8571428571428571,1,0.0,0,1,0,0,2,0,0,3,0,1,5,1
1814,40326,0JjJbtKs8dmrQQZXRwO3ezBCv1FqT0mM,SpATywNh6bZuzm8s1ceuBUnMUAeoAHHw,5,2,1,0,1,0,2,0,6,0.8571428571428571,1,0.0,0,1,0,1,2,0,0,2,0,2,4,1
1815,40330,e8tjBT4TkBUZGDf1oULgV0xlcUpSchNd,SpATywNh6bZuzm8s1ceuBUnMUAeoAHHw,14,37,16,0,6,0,22,2,83,11.857142857142858,4,0.0,3,16,0,6,34,0,0,22,2,25,58,0
1816,40335,xLE9ZE3BmJvIiYogSmZ2Qwy8Pm6jvutZ,SpATywNh6bZuzm8s1ceuBUnMUAeoAHHw,25,58,3,41,1,10,32,1,146,20.857142857142858,6,0.0,22,3,34,1,36,10,7,32,1,60,86,0
1817,40338,xoJqrbCgOTk6mALoHnYupKuyUFnXAEAL,SpATywNh6bZuzm8s1ceuBUnMUAeoAHHw,13,19,1,28,0,1,4,0,53,7.571428571428571,1,0.0,13,1,20,0,6,1,8,4,0,34,19,1
1818,40347,cC2qlM5WjvVF4gXhZ3ctfElOjyJIEAhi,SpATywNh6bZuzm8s1ceuBUnMUAeoAHHw,15,26,11,15,5,17,10,1,85,12.142857142857142,4,0.0,12,11,12,5,14,17,3,10,1,40,45,1
1819,40370,wD600Vm6nYpRlm6dPdneFPtwC1POqb2E,A3fsA9Zfv1X2fVEQhTw51lKENdNrEqT3,1,0,0,0,0,0,1,0,1,0.14285714285714285,1,0.0,0,0,0,0,0,0,0,1,0,0,1,1
1820,40385,uuGoGterx4QfmHoDE6WqQfMDG8gm4WOd,SpATywNh6bZuzm8s1ceuBUnMUAeoAHHw,6,4,3,0,2,0,2,0,11,1.5714285714285714,2,0.0,0,3,0,2,4,0,0,2,0,5,6,1
1821,40388,ZuoiR8ZSgQ4EIp0UPK1kvYAuneCl6lTF,G8EPVSXsOYB5YQWZGiz1aVq5Pgr2GrQu,18,23,4,24,4,0,1,0,56,8.0,1,0.0,18,4,13,4,5,0,11,1,0,39,17,1
1822,40392,zT5Abo7SNHsAkCFKMvhJJJDWNu2sl4mh,SpATywNh6bZuzm8s1ceuBUnMUAeoAHHw,25,50,16,26,4,3,29,1,129,18.428571428571427,6,0.0,14,16,24,4,36,3,2,29,1,58,71,0
1823,40395,55BMoXCnWKUmNoRDU7bcdmqWNuK9JpZ6,bWdj2GDclj5ofokWjzoa5jAwMkxCykd6,10,12,0,20,1,7,9,2,51,7.285714285714286,3,0.0,4,0,20,1,8,7,0,9,2,25,26,1
1824,40403,Anr82PPgHyVjFu2RaZRNpr3IKYwAUnAW,SpATywNh6bZuzm8s1ceuBUnMUAeoAHHw,5,7,4,0,1,0,2,0,14,2.0,1,0.0,0,4,0,1,7,0,0,2,0,5,9,1
1825,40410,lkFGShqBa18inWINppsv8Kl48gyf85dR,bWdj2GDclj5ofokWjzoa5jAwMkxCykd6,12,23,10,40,8,7,2,0,90,12.857142857142858,1,0.0,9,10,37,8,14,7,3,2,0,64,26,1
1826,40416,0Cx8S0i9vAPm7jZ8jXLUkrYp9xGpIHIS,bWdj2GDclj5ofokWjzoa5jAwMkxCykd6,3,2,1,0,0,0,2,0,5,0.7142857142857143,2,0.0,0,1,0,0,2,0,0,2,0,1,4,1
1827,40422,D35qeoxZpbN67fSLA7wfpVWpoAtTKXOD,SpATywNh6bZuzm8s1ceuBUnMUAeoAHHw,13,12,8,5,5,3,3,0,36,5.142857142857143,1,0.0,2,8,5,5,10,3,0,3,0,20,16,1
1828,40425,JuFQ1S3Curjho2OVO8cP3KLv8ROaeaOy,G8EPVSXsOYB5YQWZGiz1aVq5Pgr2GrQu,18,12,7,20,5,0,1,0,45,6.428571428571429,1,0.0,4,7,20,5,8,0,0,1,0,36,9,1
1829,40428,RSvPQSF8RarDsP4aI3ftScWWjvINqjc5,A3fsA9Zfv1X2fVEQhTw51lKENdNrEqT3,10,14,9,0,8,0,1,0,32,4.571428571428571,6,0.0,0,9,0,8,14,0,0,1,0,17,15,1
1830,40433,fVDgOkqeY2Y5uks1gBAvSdrqz781Wr7g,SpATywNh6bZuzm8s1ceuBUnMUAeoAHHw,7,8,4,0,3,0,4,0,19,2.7142857142857144,1,0.0,1,4,0,3,7,0,0,4,0,8,11,1
1831,40441,b11C6Y0UpRSFGpKvHTlz5TF2Rt9ScBoX,SpATywNh6bZuzm8s1ceuBUnMUAeoAHHw,12,16,6,20,1,0,14,2,59,8.428571428571429,3,0.0,8,6,16,1,8,0,4,14,2,31,28,0
1832,40462,9hqCAq1z2NOCYAE7PjnGwKxGA9KHvl0W,A3fsA9Zfv1X2fVEQhTw51lKENdNrEqT3,10,5,0,0,0,2,8,1,16,2.2857142857142856,1,0.0,0,0,0,0,5,2,0,8,1,0,16,1
1833,40502,PzBfPYmnOZYwUEXwnCaNraevSYiEicsw,G8EPVSXsOYB5YQWZGiz1aVq5Pgr2GrQu,10,11,6,0,1,2,10,2,32,4.571428571428571,1,0.0,1,6,0,1,10,2,0,10,2,8,24,1
1834,40509,Hz1gD3xapoX9NB1k77xvttI5SLCsWFqX,A3fsA9Zfv1X2fVEQhTw51lKENdNrEqT3,5,3,1,0,0,1,3,0,8,1.1428571428571428,1,0.0,0,1,0,0,3,1,0,3,0,1,7,1
1835,40537,KUjjznPFpWdBg0GS5p0fa4zyp2j0nULG,A3fsA9Zfv1X2fVEQhTw51lKENdNrEqT3,5,2,1,0,1,0,2,0,6,0.8571428571428571,1,0.0,0,1,0,1,2,0,0,2,0,2,4,1
1836,40584,mC2fzvwPaO34Kq32ibCwzrJ2EjHwbRrb,RXDvfPUBYFlVdlueBFbLW0mhhAyGEqpt,20,35,19,19,7,0,4,0,84,12.0,2,0.0,9,19,17,7,26,0,2,4,0,52,32,1
1837,40602,TxbcY6S66ftou9eniDMFpBcA0Q86cCVI,SpATywNh6bZuzm8s1ceuBUnMUAeoAHHw,1,0,0,0,0,0,1,0,1,0.14285714285714285,1,0.0,0,0,0,0,0,0,0,1,0,0,1,1
1838,40605,MiPYsLH8kYorLuTY5qJyDrWlYhyksO0w,bWdj2GDclj5ofokWjzoa5jAwMkxCykd6,1,0,0,0,0,0,1,0,1,0.14285714285714285,1,0.0,0,0,0,0,0,0,0,1,0,0,1,1
1839,40607,MiPYsLH8kYorLuTY5qJyDrWlYhyksO0w,A3fsA9Zfv1X2fVEQhTw51lKENdNrEqT3,15,21,1,2,1,0,13,0,38,5.428571428571429,2,0.0,0,1,2,1,21,0,0,13,0,4,34,1
1840,40643,4hVUUGEGYiw6Bdgp8UlEBQC8ko8eVYqV,SpATywNh6bZuzm8s1ceuBUnMUAeoAHHw,6,3,1,0,1,0,2,0,7,1.0,1,0.0,0,1,0,1,3,0,0,2,0,2,5,1
1841,40648,zUbaOnwFf34fsU2q7dIMt7fpEzRZebx6,SpATywNh6bZuzm8s1ceuBUnMUAeoAHHw,5,7,3,0,2,0,1,0,13,1.8571428571428572,1,0.0,3,3,0,2,4,0,0,1,0,8,5,1
1842,40662,C1sQeK9WfNApOsknFeDtbZSozuem8vKZ,A3fsA9Zfv1X2fVEQhTw51lKENdNrEqT3,5,2,1,0,1,0,3,0,7,1.0,1,0.0,0,1,0,1,2,0,0,3,0,2,5,1
1843,40664,oGGlzK2ht4ljgfC5PRL55MAob4FKnRhp,bWdj2GDclj5ofokWjzoa5jAwMkxCykd6,2,0,0,0,0,0,2,0,2,0.2857142857142857,1,0.0,0,0,0,0,0,0,0,2,0,0,2,1
1844,40667,oGGlzK2ht4ljgfC5PRL55MAob4FKnRhp,A3fsA9Zfv1X2fVEQhTw51lKENdNrEqT3,2,0,0,0,0,0,2,0,2,0.2857142857142857,1,0.0,0,0,0,0,0,0,0,2,0,0,2,1
1845,40702,eulwUG3HQzG3rg0A6GIWynY1beyNKKbn,SpATywNh6bZuzm8s1ceuBUnMUAeoAHHw,13,23,9,13,6,0,4,0,55,7.857142857142857,3,0.0,3,9,11,6,20,0,2,4,0,29,26,1
1846,40704,qmYTrueiQKfoQnGxjqfwlMlw7HOR9CKj,bWdj2GDclj5ofokWjzoa5jAwMkxCykd6,8,10,2,0,0,13,24,2,51,7.285714285714286,5,0.0,0,2,0,0,10,13,0,24,2,2,49,0
1847,40726,Y4FZdizgCfP48VyOuflC2D2a2JpAW4dz,G8EPVSXsOYB5YQWZGiz1aVq5Pgr2GrQu,6,2,1,0,1,0,3,0,7,1.0,1,0.0,0,1,0,1,2,0,0,3,0,2,5,1
1848,40737,G9SE33A9SwXRkrAwDpEWoUsFMADETyBJ,SpATywNh6bZuzm8s1ceuBUnMUAeoAHHw,2,0,0,0,0,0,3,0,3,0.42857142857142855,1,0.0,0,0,0,0,0,0,0,3,0,0,3,1
1849,40746,l7T8dOWG1cEtOxAxVcD5zNV6vn1g4oYM,bWdj2GDclj5ofokWjzoa5jAwMkxCykd6,2,0,0,0,0,0,4,0,4,0.5714285714285714,2,0.0,0,0,0,0,0,0,0,4,0,0,4,1
1850,40749,1UUWIp3PiN0CT0O96IXxrt6TRVFJmFUz,A3fsA9Zfv1X2fVEQhTw51lKENdNrEqT3,7,1,0,0,0,2,9,2,14,2.0,1,0.0,0,0,0,0,1,2,0,9,2,0,14,1
1851,40761,1Pk7jZ6bfmKYXcNnRyEd7kPSZWAEJN0N,A3fsA9Zfv1X2fVEQhTw51lKENdNrEqT3,1,0,0,0,0,0,1,0,1,0.14285714285714285,1,0.0,0,0,0,0,0,0,0,1,0,0,1,1
1852,40768,NlHO5hXiy7TmVTHiRgExH6y7p9gJG1YF,SpATywNh6bZuzm8s1ceuBUnMUAeoAHHw,19,18,9,23,5,0,4,0,59,8.428571428571429,3,0.0,5,9,19,5,13,0,4,4,0,38,21,1
1853,40780,EO0fRulUc32LbMOOGfwwNWyNgnF8pKY9,RXDvfPUBYFlVdlueBFbLW0mhhAyGEqpt,35,41,23,51,13,3,16,5,152,21.714285714285715,4,0.0,11,23,43,13,30,3,8,16,5,90,62,1
1854,40782,eEl2lnEvtyQyZa1YqA2JcBHBfdkh8SHK,SpATywNh6bZuzm8s1ceuBUnMUAeoAHHw,9,19,2,0,1,0,7,0,29,4.142857142857143,4,0.0,1,2,0,1,18,0,0,7,0,4,25,1
1855,40802,DFKzgJXlXxnZVHESIM4fYC543XX9ZfDV,SpATywNh6bZuzm8s1ceuBUnMUAeoAHHw,10,6,4,0,3,0,4,0,17,2.4285714285714284,3,0.0,0,4,0,3,6,0,0,4,0,7,10,1
1856,40823,BXn2aG9clWntQARvXpqDawWoxN1Iz4WO,A3fsA9Zfv1X2fVEQhTw51lKENdNrEqT3,20,27,13,0,8,0,7,0,55,7.857142857142857,4,0.0,0,13,0,8,27,0,0,7,0,21,34,1
1857,40824,0NGZq9HZW5KOrSfzSGGipuN20pCRDMWu,A3fsA9Zfv1X2fVEQhTw51lKENdNrEqT3,9,8,1,0,1,0,2,0,12,1.7142857142857142,1,0.0,0,1,0,1,8,0,0,2,0,2,10,1
1858,40835,pwTSmyT1ONwSAvUKrgRYh4Mr4sMKfCZD,SpATywNh6bZuzm8s1ceuBUnMUAeoAHHw,1,0,0,0,0,0,1,0,1,0.14285714285714285,1,0.0,0,0,0,0,0,0,0,1,0,0,1,1
1859,40857,9VkUnpQ2wwfpxrKU7ACzLosNtkitvYWk,bWdj2GDclj5ofokWjzoa5jAwMkxCykd6,9,14,0,62,0,3,2,0,81,11.571428571428571,3,0.0,3,0,58,0,11,3,4,2,0,61,20,1
1860,40867,rV9ZZTHmhxb84QCeG9gPkzE5xk42RTz0,SpATywNh6bZuzm8s1ceuBUnMUAeoAHHw,14,16,1,15,0,1,7,1,41,5.857142857142857,2,0.0,6,1,13,0,10,1,2,7,1,20,21,1
1861,40869,8gfCGxZ6lFjZr89RwPF8oXZs1Qn6Pq6X,A3fsA9Zfv1X2fVEQhTw51lKENdNrEqT3,27,5,4,78,0,0,10,0,97,13.857142857142858,4,0.0,1,4,69,0,4,0,9,10,0,74,23,1
1862,40896,o4j0NDzLh6XqpDKcvRg8Lx9N4HUYeTuP,RXDvfPUBYFlVdlueBFbLW0mhhAyGEqpt,1,0,0,0,0,0,1,0,1,0.14285714285714285,1,0.0,0,0,0,0,0,0,0,1,0,0,1,1
1863,40900,f6iCNPPMIJtA2FTvaT2H53upAxoDRLhb,SpATywNh6bZuzm8s1ceuBUnMUAeoAHHw,10,20,7,0,1,1,10,1,40,5.714285714285714,2,0.0,3,7,0,1,17,1,0,10,1,11,29,1
1864,40938,DJeWlgB4cP1RQ3JZLa1wZwd4zgAbYOxv,A3fsA9Zfv1X2fVEQhTw51lKENdNrEqT3,1,0,0,0,0,0,1,0,1,0.14285714285714285,1,0.0,0,0,0,0,0,0,0,1,0,0,1,1
1865,40940,qMeUlyVNhm3N1xROQ1pyK2NlohyIqF1x,G8EPVSXsOYB5YQWZGiz1aVq5Pgr2GrQu,1,0,0,0,0,0,1,0,1,0.14285714285714285,1,0.0,0,0,0,0,0,0,0,1,0,0,1,1
1866,40951,ah2KXEU3IJN3pCxNzFybzDR3Qrtpz7ty,SpATywNh6bZuzm8s1ceuBUnMUAeoAHHw,1,0,0,0,0,0,1,0,1,0.14285714285714285,1,0.0,0,0,0,0,0,0,0,1,0,0,1,1
1867,40964,gnxZfu6FrSp4wr4QPorHabuGoagxpXKv,SpATywNh6bZuzm8s1ceuBUnMUAeoAHHw,1,0,0,0,0,0,1,0,1,0.14285714285714285,1,0.0,0,0,0,0,0,0,0,1,0,0,1,1
1868,40966,xHfGdYj0sYZXXCzkQp0eF5wBXW7C2C6R,A3fsA9Zfv1X2fVEQhTw51lKENdNrEqT3,5,2,1,0,1,0,3,0,7,1.0,1,0.0,0,1,0,1,2,0,0,3,0,2,5,1
1869,40973,BasnDhJkjNSRVUOCCIoBniAgNajwACiL,SpATywNh6bZuzm8s1ceuBUnMUAeoAHHw,20,34,2,28,0,0,8,0,72,10.285714285714286,2,0.0,14,2,28,0,20,0,0,8,0,44,28,0
1870,40979,zeUi2UnQZPPF6bRQXw2s8LZ41ZOdqRAa,G8EPVSXsOYB5YQWZGiz1aVq5Pgr2GrQu,8,9,6,0,2,1,3,0,21,3.0,2,0.0,0,6,0,2,9,1,0,3,0,8,13,1
1871,40982,4IpWwTUOGPzGOpKLy9nKXcEDTyxApVd3,G8EPVSXsOYB5YQWZGiz1aVq5Pgr2GrQu,1,0,0,0,0,0,1,0,1,0.14285714285714285,1,0.0,0,0,0,0,0,0,0,1,0,0,1,1
1872,40984,xvXNoM4EBB4fcdWfVRuECibdILksVZE5,SpATywNh6bZuzm8s1ceuBUnMUAeoAHHw,4,2,0,0,0,0,3,0,5,0.7142857142857143,1,0.0,0,0,0,0,2,0,0,3,0,0,5,1
1873,40986,ikVmCxeXCKQtR8OPUUdHoGQCjATpEVdj,SpATywNh6bZuzm8s1ceuBUnMUAeoAHHw,14,17,9,15,5,0,2,0,48,6.857142857142857,3,0.0,7,9,13,5,10,0,2,2,0,34,14,1
1874,40991,WPAkKut2lu615mRXcePqeHjf7ZV10lWd,SpATywNh6bZuzm8s1ceuBUnMUAeoAHHw,13,14,9,10,4,0,2,0,39,5.571428571428571,3,0.0,2,9,9,4,12,0,1,2,0,24,15,1
1875,41010,uOFQjpYGMV24K1kl5khOKpWKqO5hcEHE,7GRhBDsirIGkRZBtSMEzNTyDr2JQm4xx,7,8,2,0,2,0,2,0,14,2.0,1,0.0,0,2,0,2,8,0,0,2,0,4,10,1
1876,41098,luetGJM4RCCEdMBc9OfxVqFFziudg0s4,7GRhBDsirIGkRZBtSMEzNTyDr2JQm4xx,2,0,0,0,0,0,3,0,3,0.42857142857142855,1,0.0,0,0,0,0,0,0,0,3,0,0,3,1
1877,41120,XpdeGVr67ypvPB6NlvDXEjF8wDCu5FS9,7GRhBDsirIGkRZBtSMEzNTyDr2JQm4xx,1,0,0,0,0,0,2,0,2,0.2857142857142857,2,0.0,0,0,0,0,0,0,0,2,0,0,2,1
1878,41133,sIrvXnSy3oMgG36f8e8UxJCnsTfr739w,7GRhBDsirIGkRZBtSMEzNTyDr2JQm4xx,6,3,1,0,1,2,6,0,13,1.8571428571428572,2,0.0,0,1,0,1,3,2,0,6,0,2,11,1
1879,41208,ttoFK5oOPrxtfVxJpGPFCiEs8J6AbuAg,7GRhBDsirIGkRZBtSMEzNTyDr2JQm4xx,2,0,0,0,0,0,2,0,2,0.2857142857142857,1,0.0,0,0,0,0,0,0,0,2,0,0,2,1
1880,41313,muzVsCrsBxqiBPr2RsB5pEdOhDGWWCl3,7GRhBDsirIGkRZBtSMEzNTyDr2JQm4xx,4,3,1,0,1,0,1,0,6,0.8571428571428571,1,0.0,1,1,0,1,2,0,0,1,0,3,3,1
1881,41408,xbPbNw5WluotpcGvfodgid2Z7Rc8OfQr,7GRhBDsirIGkRZBtSMEzNTyDr2JQm4xx,1,0,0,0,0,0,1,0,1,0.14285714285714285,1,0.0,0,0,0,0,0,0,0,1,0,0,1,1
1882,41424,Gn1QSm7WrSyhbej7tThohiyBKeBu1xtD,7GRhBDsirIGkRZBtSMEzNTyDr2JQm4xx,66,86,38,151,23,0,13,0,311,44.42857142857143,7,0.0,38,38,130,23,48,0,21,13,0,229,82,0
1883,41448,we9tWnySpl1G7k7FqyXPj8wmC2gUYK0W,7GRhBDsirIGkRZBtSMEzNTyDr2JQm4xx,1,0,0,0,0,0,1,0,1,0.14285714285714285,1,0.0,0,0,0,0,0,0,0,1,0,0,1,1
1884,41455,emCY4aIQuto3vHDbWyLccdGfPM1ClSuh,7GRhBDsirIGkRZBtSMEzNTyDr2JQm4xx,4,1,0,0,0,0,3,0,4,0.5714285714285714,1,0.0,0,0,0,0,1,0,0,3,0,0,4,1
1885,41589,JXidMLGzH1hCHEXJsiJMrwBekkp4L4vD,7GRhBDsirIGkRZBtSMEzNTyDr2JQm4xx,32,47,22,35,10,0,7,0,121,17.285714285714285,5,0.0,20,22,31,10,27,0,4,7,0,83,38,1
1886,41740,blaKT90TeOTAa2RsAkTxWQqeLxEi93Qu,7GRhBDsirIGkRZBtSMEzNTyDr2JQm4xx,1,0,0,0,0,0,1,0,1,0.14285714285714285,1,0.0,0,0,0,0,0,0,0,1,0,0,1,1
1887,41796,vpQq8XFeke8cuyYAJhpFzjSzZZBP51AP,7GRhBDsirIGkRZBtSMEzNTyDr2JQm4xx,1,0,0,0,0,0,1,0,1,0.14285714285714285,1,0.0,0,0,0,0,0,0,0,1,0,0,1,1
1888,41799,Qqy3TZdyBKfhf7zgHIRI72ZJ5QbTtpkb,7GRhBDsirIGkRZBtSMEzNTyDr2JQm4xx,11,12,4,0,3,0,3,0,22,3.142857142857143,1,0.0,0,4,0,3,12,0,0,3,0,7,15,1
1889,41805,kuZwBvEdgeUtKZ495C2FptBbxEtLtmVH,7GRhBDsirIGkRZBtSMEzNTyDr2JQm4xx,7,11,3,0,2,0,2,0,18,2.5714285714285716,2,0.0,3,3,0,2,8,0,0,2,0,8,10,1
1890,43653,79QUI05RY9ZPkyZ2QTF4ldf0I0DmjbaG,7GRhBDsirIGkRZBtSMEzNTyDr2JQm4xx,17,59,32,0,3,9,19,0,122,17.428571428571427,3,0.0,9,32,0,3,50,9,0,19,0,44,78,1
1891,43667,YwEhgJrFq2w9QJl2yCPd9xaL0Uk6VujF,7GRhBDsirIGkRZBtSMEzNTyDr2JQm4xx,9,10,1,21,0,0,5,0,37,5.285714285714286,1,0.0,8,1,19,0,2,0,2,5,0,28,9,0
1892,43672,tCqgfXrL2rXAh5RJpLuMHSLSRwrclyuQ,7GRhBDsirIGkRZBtSMEzNTyDr2JQm4xx,45,175,49,92,29,16,15,0,376,53.714285714285715,7,0.0,60,49,76,29,115,16,16,15,0,214,162,0
1893,43685,Up0igPeMCPcrrFPZ1HsfM8Bq5rwAfYwv,7GRhBDsirIGkRZBtSMEzNTyDr2JQm4xx,18,16,6,20,8,5,3,0,58,8.285714285714286,2,0.0,9,6,18,8,7,5,2,3,0,41,17,0
1894,43700,z4NoXHrcgkhn7BypZflRO6Tgobh52UXj,7GRhBDsirIGkRZBtSMEzNTyDr2JQm4xx,24,56,16,38,0,11,11,0,132,18.857142857142858,3,0.0,24,16,31,0,32,11,7,11,0,71,61,0
1895,43713,KjugBA6V5bkEA5fAIbJoGnSUlDhZoaIH,7GRhBDsirIGkRZBtSMEzNTyDr2JQm4xx,37,51,14,50,10,2,12,2,141,20.142857142857142,1,0.0,20,14,43,10,31,2,7,12,2,87,54,0
1896,43732,0OpVcmwG6bVPxKzOCpgJ9F6MfBtuGolr,7GRhBDsirIGkRZBtSMEzNTyDr2JQm4xx,1,0,0,0,0,0,1,0,1,0.14285714285714285,1,0.0,0,0,0,0,0,0,0,1,0,0,1,1
1897,43991,i936MfG3syIHVH4tehF88pJA63b8Vu78,fbPkOYLVPtPgIt0MxizjfFJov3JbHyAi,9,4,2,0,2,3,6,3,20,2.857142857142857,1,0.0,0,2,0,2,4,3,0,6,3,4,16,1
1898,43992,6UtqqjImjevYXkMdkukuwyWXLWcDEFFu,fbPkOYLVPtPgIt0MxizjfFJov3JbHyAi,11,29,11,6,9,5,13,2,75,10.714285714285714,2,0.0,4,11,4,9,25,5,2,13,2,28,47,1
1899,43998,e19ZEr9Yh5ILe0m8l9rWehMDuEWywMUJ,fbPkOYLVPtPgIt0MxizjfFJov3JbHyAi,1,0,0,0,0,0,1,0,1,0.14285714285714285,1,0.0,0,0,0,0,0,0,0,1,0,0,1,1
1900,44007,oPl0NnurlzpABskP5WrrITS0Jx7a7lgG,fbPkOYLVPtPgIt0MxizjfFJov3JbHyAi,9,15,8,0,7,0,6,1,37,5.285714285714286,2,0.0,4,8,0,7,11,0,0,6,1,19,18,1
1901,44008,uISGM4LqBUfXPHskRZuSs9XeQkD4VUeT,fbPkOYLVPtPgIt0MxizjfFJov3JbHyAi,27,60,31,16,15,43,18,1,184,26.285714285714285,5,0.0,18,31,14,15,42,43,2,18,1,78,106,1
1902,44009,inUZ2nCJKLY6kdHcpjk8OuyitRFog1f3,fbPkOYLVPtPgIt0MxizjfFJov3JbHyAi,3,2,0,0,0,0,2,0,4,0.5714285714285714,1,0.0,0,0,0,0,2,0,0,2,0,0,4,1
1903,44010,DQ9W5Vuawh3t7n6xTYzvjArLiUFtCoJH,fbPkOYLVPtPgIt0MxizjfFJov3JbHyAi,8,3,2,0,2,0,3,0,10,1.4285714285714286,1,0.0,0,2,0,2,3,0,0,3,0,4,6,1
1904,44012,3ovcvN6GJrfjQxnw4eUnC7Zf5NE35SVV,fbPkOYLVPtPgIt0MxizjfFJov3JbHyAi,4,2,0,0,0,2,6,0,10,1.4285714285714286,1,0.0,0,0,0,0,2,2,0,6,0,0,10,1
1905,44015,NHPpKvbnrSpxM8e1DORBWJbRCpmrxZw8,fbPkOYLVPtPgIt0MxizjfFJov3JbHyAi,13,18,10,0,7,42,9,0,86,12.285714285714286,4,0.0,4,10,0,7,14,42,0,9,0,21,65,1
1906,44017,axLHybd4Fc2iEZmnM9YqehKaeSBFTLUD,fbPkOYLVPtPgIt0MxizjfFJov3JbHyAi,2,0,0,0,0,0,2,0,2,0.2857142857142857,1,0.0,0,0,0,0,0,0,0,2,0,0,2,1
1907,44019,Oqf2KMc671oV8Cn8nfq2WN2xhEjMkCKi,fbPkOYLVPtPgIt0MxizjfFJov3JbHyAi,4,2,1,0,0,5,2,0,10,1.4285714285714286,1,0.0,0,1,0,0,2,5,0,2,0,1,9,1
1908,44021,9XnnqdyPvtBGS8L2kTzLO0S9Zq2a4kse,fbPkOYLVPtPgIt0MxizjfFJov3JbHyAi,4,5,0,0,0,0,1,0,6,0.8571428571428571,1,0.0,0,0,0,0,5,0,0,1,0,0,6,1
1909,44024,LeyaS1WvDVnHnV6ZSeQmCJao8bkVjN1j,fbPkOYLVPtPgIt0MxizjfFJov3JbHyAi,9,5,4,0,3,0,8,0,20,2.857142857142857,1,0.0,0,4,0,3,5,0,0,8,0,7,13,1
1910,44027,yfYI5syGDPun1q5rrD5IBdKLVoUhhItT,fbPkOYLVPtPgIt0MxizjfFJov3JbHyAi,11,5,4,0,4,0,4,0,17,2.4285714285714284,1,0.0,0,4,0,4,5,0,0,4,0,8,9,1
1911,44028,1brUgjk7oe1eohq9hpdKTnGa8wSkRKBL,fbPkOYLVPtPgIt0MxizjfFJov3JbHyAi,7,2,1,0,1,1,4,1,10,1.4285714285714286,1,0.0,0,1,0,1,2,1,0,4,1,2,8,1
1912,44032,g4BqtfArPu1P6dUgMW0j2r9GyrSqWjFl,fbPkOYLVPtPgIt0MxizjfFJov3JbHyAi,5,0,0,0,0,1,8,1,10,1.4285714285714286,1,0.0,0,0,0,0,0,1,0,8,1,0,10,1
1913,44034,qWEVgbmp31Yz7gV3k18he9mUiT0ZSaYx,fbPkOYLVPtPgIt0MxizjfFJov3JbHyAi,7,9,3,0,5,4,4,0,25,3.5714285714285716,1,0.0,4,3,0,5,5,4,0,4,0,12,13,1
1914,44036,jdE4Va4LkoFtXkdUlWOZzY1NPPK6qDDa,fbPkOYLVPtPgIt0MxizjfFJov3JbHyAi,9,3,2,0,2,1,8,1,17,2.4285714285714284,1,0.0,0,2,0,2,3,1,0,8,1,4,13,1
1915,44040,Rbjg9UrMjdBRLHwge6hMq2hF3DaLKFjG,fbPkOYLVPtPgIt0MxizjfFJov3JbHyAi,11,14,3,4,7,15,22,2,67,9.571428571428571,1,0.0,10,3,3,7,4,15,1,22,2,23,44,1
1916,44041,sg4VVv9cgk6nt80dZvUKhL5H7RMgLm0l,fbPkOYLVPtPgIt0MxizjfFJov3JbHyAi,9,9,6,0,3,8,3,0,29,4.142857142857143,2,0.0,1,6,0,3,8,8,0,3,0,10,19,1
1917,44044,h6WpsYrDbnnoeExgTZXkYo7GgIA3j8KF,fbPkOYLVPtPgIt0MxizjfFJov3JbHyAi,10,10,5,0,4,0,6,0,25,3.5714285714285716,1,0.0,3,5,0,4,7,0,0,6,0,12,13,1
1918,44046,76y1AbpXIG79W81ou4lYi6BwTmlPjyTW,fbPkOYLVPtPgIt0MxizjfFJov3JbHyAi,5,2,1,0,1,1,2,0,7,1.0,1,0.0,0,1,0,1,2,1,0,2,0,2,5,1
1919,44049,SnBsSMsyPBAPsHuU9YoDtuue1sZbKZBQ,fbPkOYLVPtPgIt0MxizjfFJov3JbHyAi,5,0,0,0,0,0,8,1,9,1.2857142857142858,2,0.0,0,0,0,0,0,0,0,8,1,0,9,1
1920,44052,BIBVHKjUSrjc5BHdvfhhLGTavi1WeSbD,fbPkOYLVPtPgIt0MxizjfFJov3JbHyAi,12,6,3,0,3,1,5,1,19,2.7142857142857144,1,0.0,1,3,0,3,5,1,0,5,1,7,12,1
1921,44054,nkBKSO0ZKz2Wst869GlQp6mO590hIJEZ,fbPkOYLVPtPgIt0MxizjfFJov3JbHyAi,1,0,0,0,0,0,1,0,1,0.14285714285714285,1,0.0,0,0,0,0,0,0,0,1,0,0,1,1
1922,44057,ZEbYOmWwQ4Xr4MxJtDQOJ8jnLIcd8Z5c,fbPkOYLVPtPgIt0MxizjfFJov3JbHyAi,5,2,1,0,1,0,2,0,6,0.8571428571428571,1,0.0,0,1,0,1,2,0,0,2,0,2,4,1
1923,44058,4ZVrwOJI0OZGv0iKNXpa2OrPWHTNPSKw,fbPkOYLVPtPgIt0MxizjfFJov3JbHyAi,7,5,3,0,2,3,2,0,15,2.142857142857143,1,0.0,0,3,0,2,5,3,0,2,0,5,10,1
1924,44060,HCuNeFLBULV55TbURLgBOnM01N7eaTIk,fbPkOYLVPtPgIt0MxizjfFJov3JbHyAi,8,19,10,0,8,5,24,0,66,9.428571428571429,2,0.0,0,10,0,8,19,5,0,24,0,18,48,1
1925,44062,eFC0KaZbDiJdIgbG1CR6r5jTa1z0727j,fbPkOYLVPtPgIt0MxizjfFJov3JbHyAi,11,18,11,10,9,0,5,0,53,7.571428571428571,2,0.0,3,11,7,9,15,0,3,5,0,30,23,0
1926,44063,l8chSgqUsX2ezoBZ8RO3OXA3HMPgq6Xo,fbPkOYLVPtPgIt0MxizjfFJov3JbHyAi,5,3,1,0,1,0,1,0,6,0.8571428571428571,1,0.0,0,1,0,1,3,0,0,1,0,2,4,1
1927,44069,sZ59BwHHS40O9b1LKGG4hE0LdlqpaIwv,fbPkOYLVPtPgIt0MxizjfFJov3JbHyAi,17,8,7,0,7,0,3,0,25,3.5714285714285716,1,0.0,0,7,0,7,8,0,0,3,0,14,11,1
1928,44070,eQaWyowDKjzkRJdrveWWiGAaGDkIAln1,fbPkOYLVPtPgIt0MxizjfFJov3JbHyAi,7,6,3,0,4,0,2,0,15,2.142857142857143,1,0.0,2,3,0,4,4,0,0,2,0,9,6,1
1929,44071,ZAJHLqPx7azIGtI8JwkpIz4DspMCXCFT,fbPkOYLVPtPgIt0MxizjfFJov3JbHyAi,1,0,0,0,0,0,1,0,1,0.14285714285714285,1,0.0,0,0,0,0,0,0,0,1,0,0,1,1
1930,44072,xCjpMcUUR38rFwI6LVi9moe3PuSjGvgc,fbPkOYLVPtPgIt0MxizjfFJov3JbHyAi,4,2,1,0,1,0,1,0,5,0.7142857142857143,1,0.0,0,1,0,1,2,0,0,1,0,2,3,1
1931,44076,R134yB2E94tOXCDag3zVHNWrBuFFRNfi,fbPkOYLVPtPgIt0MxizjfFJov3JbHyAi,6,3,2,0,2,0,1,0,8,1.1428571428571428,1,0.0,0,2,0,2,3,0,0,1,0,4,4,1
1932,44079,L5pA3H7m2qYFia4DHW15gmoKoflabQUC,fbPkOYLVPtPgIt0MxizjfFJov3JbHyAi,11,13,8,0,5,10,9,1,46,6.571428571428571,2,0.0,1,8,0,5,12,10,0,9,1,14,32,1
1933,44081,yRofSAhoibifpAqTO7qW5tQEYNWfWlsG,fbPkOYLVPtPgIt0MxizjfFJov3JbHyAi,10,19,4,0,3,0,10,1,37,5.285714285714286,2,0.0,13,4,0,3,6,0,0,10,1,20,17,1
1934,44083,KSfQPUyfWWfWDmmi6m3KXcKzxz89wkwt,fbPkOYLVPtPgIt0MxizjfFJov3JbHyAi,1,0,0,0,0,0,1,0,1,0.14285714285714285,1,0.0,0,0,0,0,0,0,0,1,0,0,1,1
1935,44084,kk72YEo7gxDpJjFfV60A1en59PCJ8Z09,fbPkOYLVPtPgIt0MxizjfFJov3JbHyAi,7,6,3,0,1,7,6,1,24,3.4285714285714284,1,0.0,0,3,0,1,6,7,0,6,1,4,20,1
1936,44093,9lvfANZJ7eXEtCdLExkxtGg3Vbd7Wyxt,fbPkOYLVPtPgIt0MxizjfFJov3JbHyAi,6,2,1,0,0,11,5,1,20,2.857142857142857,1,0.0,0,1,0,0,2,11,0,5,1,1,19,1
1937,44095,o61d02uP0OX8m0Pmj3Zu4on4UaOcYPIz,fbPkOYLVPtPgIt0MxizjfFJov3JbHyAi,13,8,5,3,3,3,5,2,29,4.142857142857143,2,0.0,1,5,2,3,7,3,1,5,2,11,18,0
1938,44097,2OnGZLO6PGk0y08tYvyYb6lXWyUABkGv,fbPkOYLVPtPgIt0MxizjfFJov3JbHyAi,9,8,4,0,3,0,6,2,23,3.2857142857142856,1,0.0,0,4,0,3,8,0,0,6,2,7,16,1
1939,44102,WpYtemwKZQxcuLGpndx0lQojfh6o5GOv,fbPkOYLVPtPgIt0MxizjfFJov3JbHyAi,4,4,0,0,0,0,1,0,5,0.7142857142857143,1,0.0,0,0,0,0,4,0,0,1,0,0,5,1
1940,44111,nWTDOg4ZYpkavWBGTPbOIHQSMseHgPvt,fbPkOYLVPtPgIt0MxizjfFJov3JbHyAi,8,4,2,0,2,0,3,0,11,1.5714285714285714,1,0.0,0,2,0,2,4,0,0,3,0,4,7,1
1941,44112,CKlck1NtRiTrxKTlx9u8mNsXnR4Cg2LR,fbPkOYLVPtPgIt0MxizjfFJov3JbHyAi,9,10,5,0,2,4,8,1,30,4.285714285714286,1,0.0,2,5,0,2,8,4,0,8,1,9,21,1
1942,44115,rQagJMIJxMWHybJu2qCbngkHoaC1bCF5,fbPkOYLVPtPgIt0MxizjfFJov3JbHyAi,2,0,0,0,0,0,2,0,2,0.2857142857142857,1,0.0,0,0,0,0,0,0,0,2,0,0,2,1
1943,44118,GmEmBf7c8vVD8NQKlYsc3CbTgcWxYLfx,fbPkOYLVPtPgIt0MxizjfFJov3JbHyAi,4,4,2,0,2,0,1,0,9,1.2857142857142858,1,0.0,0,2,0,2,4,0,0,1,0,4,5,1
1944,44119,hp1PeKFcESsUtrkTKF98ATmX1KKCPvia,fbPkOYLVPtPgIt0MxizjfFJov3JbHyAi,4,6,0,0,0,1,1,0,8,1.1428571428571428,1,0.0,0,0,0,0,6,1,0,1,0,0,8,0
1945,44122,bYjPoNbc5ILh7K7s9YR8HLOMNJGN6Ums,fbPkOYLVPtPgIt0MxizjfFJov3JbHyAi,9,5,4,0,4,1,2,0,16,2.2857142857142856,1,0.0,0,4,0,4,5,1,0,2,0,8,8,1
1946,44123,xl4s40OnU4HrS2dTDEZu2keSj0YY1fmn,fbPkOYLVPtPgIt0MxizjfFJov3JbHyAi,11,25,16,0,8,17,7,1,74,10.571428571428571,3,0.0,0,16,0,8,25,17,0,7,1,24,50,1
1947,44131,dzaUNwKZy91BtYj96fOhuSgIlp9lXQDU,fbPkOYLVPtPgIt0MxizjfFJov3JbHyAi,44,68,32,21,23,52,21,0,217,31.0,6,0.0,19,32,19,23,49,52,2,21,0,93,124,0
1948,44133,0bPKxjIIw0GaiIYeAS2yIr8ZqMELBNL4,fbPkOYLVPtPgIt0MxizjfFJov3JbHyAi,6,11,4,0,0,0,1,0,16,2.2857142857142856,1,0.0,3,4,0,0,8,0,0,1,0,7,9,1
1949,44134,aTtRtpFY1HDjnosUur6O1bYAGBELKNkH,fbPkOYLVPtPgIt0MxizjfFJov3JbHyAi,1,0,0,0,0,0,1,0,1,0.14285714285714285,1,0.0,0,0,0,0,0,0,0,1,0,0,1,1
1950,44135,ZD66lyh6v0XhCV6q1X0pQAccOqFGi52W,fbPkOYLVPtPgIt0MxizjfFJov3JbHyAi,3,2,0,0,0,0,1,0,3,0.42857142857142855,1,0.0,0,0,0,0,2,0,0,1,0,0,3,1
1951,44139,9CGgLBDhAl2a4vPzbTBoeDjYbqCZREDz,fbPkOYLVPtPgIt0MxizjfFJov3JbHyAi,6,5,3,0,3,0,1,0,12,1.7142857142857142,1,0.0,0,3,0,3,5,0,0,1,0,6,6,1
1952,44141,MykUjAz2RHfOismfBj3t8dCwbOEsrgDq,fbPkOYLVPtPgIt0MxizjfFJov3JbHyAi,5,4,2,0,1,0,3,0,10,1.4285714285714286,1,0.0,0,2,0,1,4,0,0,3,0,3,7,1
1953,44144,8ZsouqUolTSghSnsdTjJFuPUeDFeagv6,fbPkOYLVPtPgIt0MxizjfFJov3JbHyAi,1,0,0,0,0,0,1,0,1,0.14285714285714285,1,0.0,0,0,0,0,0,0,0,1,0,0,1,1
1954,44148,hd8cWgeUYWb4NyjYBEC7ZVh5Gsq9Y3Ff,fbPkOYLVPtPgIt0MxizjfFJov3JbHyAi,18,13,11,0,9,0,10,0,43,6.142857142857143,1,0.0,0,11,0,9,13,0,0,10,0,20,23,1
1955,44151,WRW8ZNpfTVG6ItpEWtCFOCrLdAppQEhA,fbPkOYLVPtPgIt0MxizjfFJov3JbHyAi,11,11,4,0,5,0,5,0,25,3.5714285714285716,1,0.0,6,4,0,5,5,0,0,5,0,15,10,1
1956,44152,ckUgzG88eR58uy370LgSc7zPpsWm2L4O,fbPkOYLVPtPgIt0MxizjfFJov3JbHyAi,11,12,7,0,5,7,6,0,37,5.285714285714286,2,0.0,0,7,0,5,12,7,0,6,0,12,25,1
1957,44155,ufy4LHvMWo0whrRq15door8x99FGdY4J,fbPkOYLVPtPgIt0MxizjfFJov3JbHyAi,25,78,38,24,10,21,5,0,176,25.142857142857142,6,0.0,31,38,20,10,47,21,4,5,0,99,77,1
1958,44159,tfcOvcMIVTpughZ66Us0P1WhX9cxijTo,fbPkOYLVPtPgIt0MxizjfFJov3JbHyAi,7,5,3,0,2,3,3,0,16,2.2857142857142856,2,0.0,0,3,0,2,5,3,0,3,0,5,11,1
1959,44161,VmHFwT6SFcmG2hmz0LuDgYb6XJYcUUSp,fbPkOYLVPtPgIt0MxizjfFJov3JbHyAi,5,2,1,0,1,3,2,0,9,1.2857142857142858,1,0.0,0,1,0,1,2,3,0,2,0,2,7,1
1960,44163,QHPITLtk56ZUotelsryOYmh753HhRll9,fbPkOYLVPtPgIt0MxizjfFJov3JbHyAi,6,3,2,0,2,0,1,0,8,1.1428571428571428,1,0.0,0,2,0,2,3,0,0,1,0,4,4,1
1961,44165,VBgEdkbZzukrjHaMBzmoJMWNefIhR359,fbPkOYLVPtPgIt0MxizjfFJov3JbHyAi,6,4,2,0,1,0,2,0,9,1.2857142857142858,1,0.0,0,2,0,1,4,0,0,2,0,3,6,1
1962,44168,b6tYxnTOArtoyrdJ0MLgwMZ9LCbErJm6,fbPkOYLVPtPgIt0MxizjfFJov3JbHyAi,8,5,3,0,2,1,5,1,17,2.4285714285714284,1,0.0,0,3,0,2,5,1,0,5,1,5,12,1
1963,44169,gMeKwVdV7xHR9zrsQTTuP5xOz4aKMsCh,fbPkOYLVPtPgIt0MxizjfFJov3JbHyAi,9,6,5,0,4,4,6,0,25,3.5714285714285716,1,0.0,0,5,0,4,6,4,0,6,0,9,16,1
1964,44170,wfBPTMOVZ2z78mcsSkE5pUWw8ps1YZeD,fbPkOYLVPtPgIt0MxizjfFJov3JbHyAi,7,7,2,0,3,0,3,0,15,2.142857142857143,1,0.0,2,2,0,3,5,0,0,3,0,7,8,1
1965,44173,kNdT4Mob6J1VkdvqbhmS4aPzbDLqNeYP,fbPkOYLVPtPgIt0MxizjfFJov3JbHyAi,11,14,6,0,4,3,8,1,36,5.142857142857143,1,0.0,3,6,0,4,11,3,0,8,1,13,23,1
1966,44176,8TCCmIoVZzZAPAuNITv5aLi5oDEbcxb0,fbPkOYLVPtPgIt0MxizjfFJov3JbHyAi,7,5,3,0,2,0,8,1,19,2.7142857142857144,1,0.0,0,3,0,2,5,0,0,8,1,5,14,1
1967,44177,MikH0dwnUPgwm1pOxLfLikTx2rTYR4VE,fbPkOYLVPtPgIt0MxizjfFJov3JbHyAi,6,2,1,0,1,0,5,1,10,1.4285714285714286,1,0.0,0,1,0,1,2,0,0,5,1,2,8,1
1968,44180,1MF1O9UiGEPKiN9XxCO7tMvYDB1feEh9,fbPkOYLVPtPgIt0MxizjfFJov3JbHyAi,7,2,1,0,1,0,7,1,12,1.7142857142857142,1,0.0,0,1,0,1,2,0,0,7,1,2,10,1
1969,44183,xdClWt95AonMUbXmVncDz7pyQAF4u9BG,fbPkOYLVPtPgIt0MxizjfFJov3JbHyAi,5,2,1,0,1,0,3,0,7,1.0,1,0.0,0,1,0,1,2,0,0,3,0,2,5,1
1970,44189,1eQmYbeMjDeGW0fORE6JAUI81WibJPEv,fbPkOYLVPtPgIt0MxizjfFJov3JbHyAi,1,0,0,0,0,0,1,0,1,0.14285714285714285,1,0.0,0,0,0,0,0,0,0,1,0,0,1,1
1971,44190,RJAPKuvNhyLyzVhUoacg3kyQMrusLDCW,fbPkOYLVPtPgIt0MxizjfFJov3JbHyAi,20,41,23,0,9,0,10,2,85,12.142857142857142,2,0.0,13,23,0,9,28,0,0,10,2,45,40,1
1972,44191,MkhWkWrDBg7jFp3XklVC8uZQ46nAon3u,fbPkOYLVPtPgIt0MxizjfFJov3JbHyAi,17,36,14,0,6,3,6,2,67,9.571428571428571,1,0.0,6,14,0,6,30,3,0,6,2,26,41,1
1973,44192,c1zULVJb8UrzwaeCwQXbXVIx3xb2chrp,fbPkOYLVPtPgIt0MxizjfFJov3JbHyAi,6,4,3,0,1,0,9,0,17,2.4285714285714284,4,0.0,1,3,0,1,3,0,0,9,0,5,12,0
1974,44197,ZqSAxgvVLUFu6IOm5zNZalNXouYaP76y,fbPkOYLVPtPgIt0MxizjfFJov3JbHyAi,18,23,12,9,9,6,5,1,65,9.285714285714286,2,0.0,9,12,7,9,14,6,2,5,1,37,28,1
1975,44198,H1kvrsGGsPor5huYrdsnL3Isag4wSKlt,fbPkOYLVPtPgIt0MxizjfFJov3JbHyAi,22,16,7,11,8,0,1,0,43,6.142857142857143,1,0.0,8,7,11,8,8,0,0,1,0,34,9,1
1976,44199,K28hkwMS8Ua9nbLnLUJX6puRWq44TrF0,fbPkOYLVPtPgIt0MxizjfFJov3JbHyAi,4,2,1,0,1,0,1,0,5,0.7142857142857143,1,0.0,0,1,0,1,2,0,0,1,0,2,3,1
1977,44200,UeDs0IsM5JGu9WKbkZDo576REb7pnQUn,fbPkOYLVPtPgIt0MxizjfFJov3JbHyAi,1,0,0,0,0,0,1,0,1,0.14285714285714285,1,0.0,0,0,0,0,0,0,0,1,0,0,1,1
1978,44204,VndQ6jKo03PwXryVilJVgpCAmWUkBbqD,fbPkOYLVPtPgIt0MxizjfFJov3JbHyAi,8,3,2,0,2,0,5,0,12,1.7142857142857142,1,0.0,0,2,0,2,3,0,0,5,0,4,8,1
1979,44205,xeper6lTTTduQkRnWSDeRoAUobRsjfTO,fbPkOYLVPtPgIt0MxizjfFJov3JbHyAi,12,10,5,2,4,15,4,1,41,5.857142857142857,1,0.0,3,5,2,4,7,15,0,4,1,14,27,1
1980,44206,pmP1vo676Ls6u06kxeOxjGCjZN5T0bfn,fbPkOYLVPtPgIt0MxizjfFJov3JbHyAi,7,5,2,0,2,0,2,0,11,1.5714285714285714,1,0.0,0,2,0,2,5,0,0,2,0,4,7,1
1981,44207,jWewOVeTfMYYPxwOYqT1SGXzvovpIvz3,fbPkOYLVPtPgIt0MxizjfFJov3JbHyAi,5,2,1,0,1,0,5,0,9,1.2857142857142858,1,0.0,0,1,0,1,2,0,0,5,0,2,7,1
1982,44210,3tTsLPRBksgsW30Yifh6MWgLDquCQM2g,fbPkOYLVPtPgIt0MxizjfFJov3JbHyAi,8,3,2,0,2,0,3,2,12,1.7142857142857142,1,0.0,0,2,0,2,3,0,0,3,2,4,8,1
1983,44211,u1AyJHfZVkCbqmaTVxNT62X9SEOZHm4M,fbPkOYLVPtPgIt0MxizjfFJov3JbHyAi,7,4,2,0,1,0,4,0,11,1.5714285714285714,1,0.0,0,2,0,1,4,0,0,4,0,3,8,1
1984,44214,90af6u7O75fWjzbthnMq7awDtdd9TeI9,fbPkOYLVPtPgIt0MxizjfFJov3JbHyAi,7,6,3,0,2,3,1,0,15,2.142857142857143,1,0.0,0,3,0,2,6,3,0,1,0,5,10,1
1985,44218,hJGj3kQ93iSqrSQuFovt8Qk2BphLpPcg,fbPkOYLVPtPgIt0MxizjfFJov3JbHyAi,2,0,0,0,0,0,6,0,6,0.8571428571428571,1,0.0,0,0,0,0,0,0,0,6,0,0,6,1
1986,44220,hy5uxKEcxvtHS3tlaeM1vWwbo38Hj0n0,fbPkOYLVPtPgIt0MxizjfFJov3JbHyAi,11,19,9,0,6,18,7,0,59,8.428571428571429,2,0.0,3,9,0,6,16,18,0,7,0,18,41,0
1987,44221,JBImmJkUH6RU5EuKvs04Gb9Ih8CxmZjg,fbPkOYLVPtPgIt0MxizjfFJov3JbHyAi,2,0,0,0,0,0,10,0,10,1.4285714285714286,2,0.0,0,0,0,0,0,0,0,10,0,0,10,1
1988,44222,cztDDQRMLEL2fROQpw4ZlOpH3qNEy4bb,fbPkOYLVPtPgIt0MxizjfFJov3JbHyAi,1,0,0,0,0,0,1,0,1,0.14285714285714285,1,0.0,0,0,0,0,0,0,0,1,0,0,1,1
1989,44223,1RzKq1UsN4x78Mgw0Ly9Is8DkKOORlnQ,fbPkOYLVPtPgIt0MxizjfFJov3JbHyAi,2,0,0,0,0,0,7,0,7,1.0,1,0.0,0,0,0,0,0,0,0,7,0,0,7,1
1990,44224,zpieVPimuNuvyfb8XZsK7ZjTM6u74cRF,fbPkOYLVPtPgIt0MxizjfFJov3JbHyAi,6,2,1,0,1,0,2,0,6,0.8571428571428571,1,0.0,0,1,0,1,2,0,0,2,0,2,4,1
1991,44226,VYNucadxJwAl4oUfBMF6a5hY4ZvYaLjQ,fbPkOYLVPtPgIt0MxizjfFJov3JbHyAi,26,55,18,30,16,4,14,1,138,19.714285714285715,3,0.0,30,18,28,16,25,4,2,14,1,92,46,1
1992,44231,AQMZ0ecVv6yIj8PNV5GC8bjPJquyjuSz,fbPkOYLVPtPgIt0MxizjfFJov3JbHyAi,18,52,21,14,14,23,15,2,141,20.142857142857142,5,0.0,19,21,12,14,33,23,2,15,2,66,75,1
1993,44234,UDo4onvYbb2pCnzrdvVIV4SfsdccpEQm,fbPkOYLVPtPgIt0MxizjfFJov3JbHyAi,4,3,1,0,1,2,1,0,8,1.1428571428571428,1,0.0,0,1,0,1,3,2,0,1,0,2,6,1
1994,44235,NotCBcEqqDsUQXSDLm2TrhVN2AkQ1PWh,fbPkOYLVPtPgIt0MxizjfFJov3JbHyAi,2,0,0,0,0,0,5,0,5,0.7142857142857143,1,0.0,0,0,0,0,0,0,0,5,0,0,5,1
1995,44238,9qv2s3k2hG6Dn32V5Dxzc9l86R5tLy2Y,fbPkOYLVPtPgIt0MxizjfFJov3JbHyAi,8,12,6,0,4,0,3,0,25,3.5714285714285716,2,0.0,1,6,0,4,11,0,0,3,0,11,14,1
1996,44241,RlfgxVU45fTUQ2rrZmOGyzpDUuAkm82S,fbPkOYLVPtPgIt0MxizjfFJov3JbHyAi,8,8,0,0,1,2,11,1,23,3.2857142857142856,1,0.0,2,0,0,1,6,2,0,11,1,3,20,1
1997,44245,Qs9VQJkriDZBH3FlG0bgTumvMa49MEaO,fbPkOYLVPtPgIt0MxizjfFJov3JbHyAi,17,69,26,7,27,5,14,1,149,21.285714285714285,7,0.0,17,26,6,27,52,5,1,14,1,76,73,0
1998,44246,kf48MnOeHkW7v0hNxfQUaCVe32or0xVe,fbPkOYLVPtPgIt0MxizjfFJov3JbHyAi,8,4,3,0,2,0,3,0,12,1.7142857142857142,1,0.0,0,3,0,2,4,0,0,3,0,5,7,1
1999,44247,0zumY6pgP7xEn5eA1MMsT2riPT41hmwE,fbPkOYLVPtPgIt0MxizjfFJov3JbHyAi,11,9,5,0,4,0,2,0,20,2.857142857142857,2,0.0,1,5,0,4,8,0,0,2,0,10,10,1
2000,44249,d6iEuc9ggOjxGIdMWyLvfDI4lEqo5BAX,fbPkOYLVPtPgIt0MxizjfFJov3JbHyAi,8,10,6,0,4,1,3,0,24,3.4285714285714284,2,0.0,1,6,0,4,9,1,0,3,0,11,13,1
2001,44250,g1tIXPWfZhmnEZEG9z52U31YrMwRUSiT,fbPkOYLVPtPgIt0MxizjfFJov3JbHyAi,15,30,15,12,12,15,15,1,100,14.285714285714286,2,0.0,8,15,8,12,22,15,4,15,1,43,57,1
2002,44254,DxX4QPcfDwxjWtFJm5EFgLobXDWqAEqS,fbPkOYLVPtPgIt0MxizjfFJov3JbHyAi,7,7,5,0,4,6,3,0,25,3.5714285714285716,2,0.0,0,5,0,4,7,6,0,3,0,9,16,1
2003,44255,zVdtg8NVS1UKsR7hBTuXsHvQ0Y2M8ZjR,fbPkOYLVPtPgIt0MxizjfFJov3JbHyAi,6,3,2,0,2,0,2,0,9,1.2857142857142858,1,0.0,0,2,0,2,3,0,0,2,0,4,5,1
2004,44259,v5DL1tRN6AvAeQThFmEHNCo6sn5M6uIG,fbPkOYLVPtPgIt0MxizjfFJov3JbHyAi,7,11,7,0,2,6,11,0,37,5.285714285714286,3,0.0,0,7,0,2,11,6,0,11,0,9,28,1
2005,44261,JaD7mqaE0bkEF64A4nrAbGGFeYQR80Ys,fbPkOYLVPtPgIt0MxizjfFJov3JbHyAi,21,37,3,17,8,0,9,0,74,10.571428571428571,5,0.0,22,3,14,8,15,0,3,9,0,47,27,1
2006,44262,EWKyvUI6fjHJ7AQcKlSBWUO2bca5ubo6,fbPkOYLVPtPgIt0MxizjfFJov3JbHyAi,19,31,11,11,12,6,30,1,102,14.571428571428571,1,0.0,13,11,9,12,18,6,2,30,1,45,57,1
2007,44266,8LoJ3UkmcZEmQsx5Wwgf18vm50gv36wN,fbPkOYLVPtPgIt0MxizjfFJov3JbHyAi,37,47,24,19,15,52,17,1,175,25.0,4,0.0,16,24,18,15,31,52,1,17,1,73,102,1
2008,44268,Fm9D7fGEScpbD1TbGjzCqweaOK1CX2Mr,fbPkOYLVPtPgIt0MxizjfFJov3JbHyAi,5,3,1,0,1,0,9,0,14,2.0,1,0.0,0,1,0,1,3,0,0,9,0,2,12,1
2009,44269,uDkm2sS75pRjgqry4uezxxAPyhgOOrpN,fbPkOYLVPtPgIt0MxizjfFJov3JbHyAi,6,16,1,0,1,4,2,0,24,3.4285714285714284,1,0.0,2,1,0,1,14,4,0,2,0,4,20,1
2010,44271,1V3TxSEX8RFiuvxHNXCh1zQbhpFBX9Tf,fbPkOYLVPtPgIt0MxizjfFJov3JbHyAi,2,0,0,0,0,0,3,0,3,0.42857142857142855,1,0.0,0,0,0,0,0,0,0,3,0,0,3,1
2011,44273,v4VtiypZ3gKvKYOCZEjKIfSgOk6hH0T6,fbPkOYLVPtPgIt0MxizjfFJov3JbHyAi,6,3,2,0,2,0,3,0,10,1.4285714285714286,1,0.0,0,2,0,2,3,0,0,3,0,4,6,1
2012,44276,oVGH1nEV79R6JEth0UtmMIUIu6BZjaDG,fbPkOYLVPtPgIt0MxizjfFJov3JbHyAi,7,11,3,0,2,9,7,0,32,4.571428571428571,1,0.0,0,3,0,2,11,9,0,7,0,5,27,1
2013,44278,0vLnRe5y9b9pBloxjGZQUFmqmEJONAkl,fbPkOYLVPtPgIt0MxizjfFJov3JbHyAi,6,4,2,0,2,0,1,0,9,1.2857142857142858,1,0.0,0,2,0,2,4,0,0,1,0,4,5,1
2014,44281,ocGAaC1x5z02wnoRsT01upUCTbjuENeN,fbPkOYLVPtPgIt0MxizjfFJov3JbHyAi,12,12,6,0,5,9,8,3,43,6.142857142857143,1,0.0,0,6,0,5,12,9,0,8,3,11,32,1
2015,44292,3ny9mc45r6qJQOOxmh4xg5QHGygeiHbu,fbPkOYLVPtPgIt0MxizjfFJov3JbHyAi,9,6,2,1,2,0,2,0,13,1.8571428571428572,1,0.0,1,2,1,2,5,0,0,2,0,6,7,1
2016,44293,XpTBA5oDkoJbl0jjlH57SraU2q4zBLWW,fbPkOYLVPtPgIt0MxizjfFJov3JbHyAi,5,0,0,0,0,3,4,1,8,1.1428571428571428,1,0.0,0,0,0,0,0,3,0,4,1,0,8,1
2017,44294,RTkGQ4UmTL2ed98p2vxbPQoTurdG2SAC,fbPkOYLVPtPgIt0MxizjfFJov3JbHyAi,13,11,7,0,5,2,2,0,27,3.857142857142857,2,0.0,0,7,0,5,11,2,0,2,0,12,15,1
2018,44298,ABJgMBFFKl294n68xTf25Os1AW439ijN,fbPkOYLVPtPgIt0MxizjfFJov3JbHyAi,1,0,0,0,0,0,1,0,1,0.14285714285714285,1,0.0,0,0,0,0,0,0,0,1,0,0,1,1
2019,44300,oO4ZerJgmfSMeyHkgVIxV4spEvg9yQJk,fbPkOYLVPtPgIt0MxizjfFJov3JbHyAi,6,3,2,0,2,0,1,0,8,1.1428571428571428,1,0.0,0,2,0,2,3,0,0,1,0,4,4,1
2020,44301,3zvHKS6M4U1m424fRhI52J9JeELqakS5,fbPkOYLVPtPgIt0MxizjfFJov3JbHyAi,4,5,1,0,0,0,3,0,9,1.2857142857142858,2,0.0,0,1,0,0,5,0,0,3,0,1,8,1
2021,44305,speERHm9QGPSObf8TcqRV8vukGx9NoGR,fbPkOYLVPtPgIt0MxizjfFJov3JbHyAi,4,3,2,0,0,0,5,0,10,1.4285714285714286,1,0.0,0,2,0,0,3,0,0,5,0,2,8,1
2022,44307,nxuexUreiYSzpSapqT3MF6tzgH9I1i5D,fbPkOYLVPtPgIt0MxizjfFJov3JbHyAi,5,2,1,0,1,0,3,0,7,1.0,1,0.0,0,1,0,1,2,0,0,3,0,2,5,1
2023,44309,LLsy8k18PLzqaAWgeu3HZsydISuZ18ow,fbPkOYLVPtPgIt0MxizjfFJov3JbHyAi,19,32,13,9,14,8,5,0,81,11.571428571428571,3,0.0,12,13,6,14,20,8,3,5,0,45,36,1
2024,45311,b28qvpjrNqMA0awJsB8hLMAyVGCoQbbk,G8EPVSXsOYB5YQWZGiz1aVq5Pgr2GrQu,7,6,1,0,2,0,5,0,14,2.0,2,0.0,4,1,0,2,2,0,0,5,0,7,7,1
2025,45351,YUDUYDMwNH7HxjxwbXkgNGbRIGFCEsrp,RXDvfPUBYFlVdlueBFbLW0mhhAyGEqpt,1,0,0,0,0,0,1,0,1,0.14285714285714285,1,0.0,0,0,0,0,0,0,0,1,0,0,1,1
2026,45360,n2Bw3Z0s4Gtstp5ZMzZilJIZC4rZeeNT,RXDvfPUBYFlVdlueBFbLW0mhhAyGEqpt,14,13,10,0,6,0,7,0,36,5.142857142857143,2,0.0,0,10,0,6,13,0,0,7,0,16,20,0
2027,45377,j1jdy8OF5VQw4rqSYOkbK2pQplvvvz37,RXDvfPUBYFlVdlueBFbLW0mhhAyGEqpt,1,0,0,0,0,0,3,0,3,0.42857142857142855,1,0.0,0,0,0,0,0,0,0,3,0,0,3,1
2028,45465,S2JQaGbkoCWVoXxNa4G5dVj0cKlAhzdj,G8EPVSXsOYB5YQWZGiz1aVq5Pgr2GrQu,1,0,0,0,0,0,1,0,1,0.14285714285714285,1,0.0,0,0,0,0,0,0,0,1,0,0,1,1
2029,45528,a6zSl0gjLWH0dh3jFMjFS9ulsRXPRoyp,G8EPVSXsOYB5YQWZGiz1aVq5Pgr2GrQu,12,12,6,12,1,1,8,1,41,5.857142857142857,2,0.0,3,6,10,1,9,1,2,8,1,20,21,1
2030,45530,BQi6o3YIDMuHZg7pBKL2EQvhTIhuaxJ1,RXDvfPUBYFlVdlueBFbLW0mhhAyGEqpt,13,10,0,0,0,0,6,0,16,2.2857142857142856,2,0.0,0,0,0,0,10,0,0,6,0,0,16,1
2031,45577,JXWz1gOpRnT7ZzNBuPorM6sgihC1HCez,G8EPVSXsOYB5YQWZGiz1aVq5Pgr2GrQu,26,33,13,10,11,5,11,1,84,12.0,4,0.0,15,13,9,11,18,5,1,11,1,48,36,1
2032,45591,cANiCKhLAefO0FGisAnCzMrx1JIRd95C,G8EPVSXsOYB5YQWZGiz1aVq5Pgr2GrQu,15,10,0,20,0,0,9,0,39,5.571428571428571,2,0.0,0,0,16,0,10,0,4,9,0,16,23,1
2033,45614,aCMLJ0A5ki1G82R2CtOxjr8OrznWuiC4,RXDvfPUBYFlVdlueBFbLW0mhhAyGEqpt,12,15,2,0,1,1,7,1,27,3.857142857142857,3,0.0,1,2,0,1,14,1,0,7,1,4,23,0
2034,45699,K1CIuuqKM8wD54LStvCDz7Yn5t0CkHIq,RXDvfPUBYFlVdlueBFbLW0mhhAyGEqpt,2,0,0,0,0,0,2,0,2,0.2857142857142857,2,0.0,0,0,0,0,0,0,0,2,0,0,2,1
2035,45831,VmamyIiK1jSOxNtAs2j1qAN0wTVBPgfx,RXDvfPUBYFlVdlueBFbLW0mhhAyGEqpt,1,0,0,0,0,0,2,0,2,0.2857142857142857,1,0.0,0,0,0,0,0,0,0,2,0,0,2,1
2036,45843,0DHsJAElXb9hqHUPTXAQocHtOXvWXP78,G8EPVSXsOYB5YQWZGiz1aVq5Pgr2GrQu,1,0,0,0,0,0,1,0,1,0.14285714285714285,1,0.0,0,0,0,0,0,0,0,1,0,0,1,1
2037,45847,CpJFUzNBBad8gxGQfFWcVCTdakqtlRdi,G8EPVSXsOYB5YQWZGiz1aVq5Pgr2GrQu,1,0,0,0,0,0,1,0,1,0.14285714285714285,1,0.0,0,0,0,0,0,0,0,1,0,0,1,1
2038,45896,xTXd8tIpTtdrquABXzBf4mWdlBXfSN1C,RXDvfPUBYFlVdlueBFbLW0mhhAyGEqpt,1,0,0,0,0,0,1,0,1,0.14285714285714285,1,0.0,0,0,0,0,0,0,0,1,0,0,1,1
2039,45921,0Uvd29I2Jn8OHG2XWh0gsDCQWSV0omOU,G8EPVSXsOYB5YQWZGiz1aVq5Pgr2GrQu,13,12,2,6,2,0,3,0,25,3.5714285714285716,3,0.0,3,2,3,2,9,0,3,3,0,10,15,1
2040,46035,0Zq8B7S84C5PTvA0nNf1DjHNx9AarY36,G8EPVSXsOYB5YQWZGiz1aVq5Pgr2GrQu,6,4,1,0,2,8,6,1,22,3.142857142857143,2,0.0,2,1,0,2,2,8,0,6,1,5,17,1
2041,46037,OQeiYxdljaHZZUTeWOEaPzOq9rygakd3,RXDvfPUBYFlVdlueBFbLW0mhhAyGEqpt,21,33,25,23,15,0,7,0,103,14.714285714285714,3,0.0,2,25,20,15,31,0,3,7,0,62,41,1
2042,46053,gvkM0LsKRQYuvgC8Hpf4C14gSdMpspZj,RXDvfPUBYFlVdlueBFbLW0mhhAyGEqpt,1,0,0,0,0,0,1,0,1,0.14285714285714285,1,0.0,0,0,0,0,0,0,0,1,0,0,1,1
2043,46068,H3iVkRV8UPZvsbvYrU1dnbX51IlHemsF,RXDvfPUBYFlVdlueBFbLW0mhhAyGEqpt,6,3,1,0,1,0,2,0,7,1.0,2,0.0,0,1,0,1,3,0,0,2,0,2,5,0
2044,46092,98ZYW8gcU4Hxzep6tki6R3HQndcbamAh,RXDvfPUBYFlVdlueBFbLW0mhhAyGEqpt,1,0,0,0,0,0,1,0,1,0.14285714285714285,1,0.0,0,0,0,0,0,0,0,1,0,0,1,1
2045,46102,sGJu15oKkQx4W6qHl6Xom6U8DHxzhJdN,G8EPVSXsOYB5YQWZGiz1aVq5Pgr2GrQu,1,0,0,0,0,0,1,0,1,0.14285714285714285,1,0.0,0,0,0,0,0,0,0,1,0,0,1,1
2046,46115,TY20DTNTajpRAyDCw2XYDvuFZloaGUMy,RXDvfPUBYFlVdlueBFbLW0mhhAyGEqpt,11,19,9,0,0,5,10,1,44,6.285714285714286,2,0.0,9,9,0,0,10,5,0,10,1,18,26,1
2047,46215,MEUnkhrmqL9ON8PWbJJQFcg86E54kgxb,RXDvfPUBYFlVdlueBFbLW0mhhAyGEqpt,1,0,0,0,0,0,1,0,1,0.14285714285714285,1,0.0,0,0,0,0,0,0,0,1,0,0,1,1
2048,46249,khWVYmdWxnvqYtc79BZbIfd9BwoftBF7,RXDvfPUBYFlVdlueBFbLW0mhhAyGEqpt,1,0,0,0,0,0,1,0,1,0.14285714285714285,1,0.0,0,0,0,0,0,0,0,1,0,0,1,1
2049,46269,ciDlATwKIeO3pzuVf93RXkCmSkEbDZee,RXDvfPUBYFlVdlueBFbLW0mhhAyGEqpt,18,42,1,12,1,0,9,1,66,9.428571428571429,3,0.0,4,1,10,1,38,0,2,9,1,16,50,1
2050,46337,Rsrb1XM1aPdEAzSt1ydc7TbF7ep7aOyM,G8EPVSXsOYB5YQWZGiz1aVq5Pgr2GrQu,1,0,0,0,0,0,2,0,2,0.2857142857142857,1,0.0,0,0,0,0,0,0,0,2,0,0,2,1
2051,46359,6prInvUnT1ahW1Psrbr1FgolDYnjdXNy,RXDvfPUBYFlVdlueBFbLW0mhhAyGEqpt,1,0,0,0,0,0,1,0,1,0.14285714285714285,1,0.0,0,0,0,0,0,0,0,1,0,0,1,1
2052,46423,mufweOLZc5URTsjF5U8S2NwmI2DUiqcr,G8EPVSXsOYB5YQWZGiz1aVq5Pgr2GrQu,1,0,0,0,0,0,1,0,1,0.14285714285714285,1,0.0,0,0,0,0,0,0,0,1,0,0,1,1
2053,46437,TOrqBZDp9GjgXoTZI9iOS0r8wbO7CyB1,RXDvfPUBYFlVdlueBFbLW0mhhAyGEqpt,6,2,1,0,1,2,6,0,12,1.7142857142857142,3,0.0,0,1,0,1,2,2,0,6,0,2,10,0
2054,46479,xSwC5YVwlqQI12zsRbCFcdEzFRC8jvLt,fbPkOYLVPtPgIt0MxizjfFJov3JbHyAi,36,160,11,28,9,114,29,2,353,50.42857142857143,5,0.0,59,11,27,9,101,114,1,29,2,106,247,1
2055,46480,MtDn5Hc2NrJY0NIN3hUo3bzbe51wyoG1,fbPkOYLVPtPgIt0MxizjfFJov3JbHyAi,6,2,1,0,1,0,4,0,8,1.1428571428571428,1,0.0,0,1,0,1,2,0,0,4,0,2,6,1
2056,46486,XYKEbaRABcMuBHmMB2I3YkBepzCp0swB,fbPkOYLVPtPgIt0MxizjfFJov3JbHyAi,21,55,2,17,11,56,11,1,153,21.857142857142858,3,0.0,28,2,12,11,27,56,5,11,1,53,100,1
2057,46488,5VcQW1dsZO9SFTtQE9ieV8dTnE3WZtAH,fbPkOYLVPtPgIt0MxizjfFJov3JbHyAi,42,95,26,39,16,1,14,4,195,27.857142857142858,3,0.0,24,26,33,16,71,1,6,14,4,99,96,1
2058,46490,GFOtGeWpej2vOEFvAlaIiOAxIuydKL8r,fbPkOYLVPtPgIt0MxizjfFJov3JbHyAi,1,0,0,0,0,0,1,0,1,0.14285714285714285,1,0.0,0,0,0,0,0,0,0,1,0,0,1,1
2059,46491,5DtI3jRGKF8MjArBAkeRlZ7S3llvU9hJ,fbPkOYLVPtPgIt0MxizjfFJov3JbHyAi,13,15,11,0,8,0,12,0,46,6.571428571428571,1,0.0,1,11,0,8,14,0,0,12,0,20,26,1
2060,46493,ZSamATIYC2PRfbcHh6ixkqUmlwzHYO9B,fbPkOYLVPtPgIt0MxizjfFJov3JbHyAi,7,2,1,0,1,4,4,2,14,2.0,1,0.0,0,1,0,1,2,4,0,4,2,2,12,1
2061,46495,kyoxb5V3l4e9xHjLzGcc4Zkj5x5jcbib,fbPkOYLVPtPgIt0MxizjfFJov3JbHyAi,27,30,16,29,14,11,5,1,106,15.142857142857142,2,0.0,12,16,21,14,18,11,8,5,1,63,43,1
2062,46497,S3wWlLKFbpoawwphxIy6q8DO9Rbo9Vr2,fbPkOYLVPtPgIt0MxizjfFJov3JbHyAi,2,0,0,0,0,0,2,0,2,0.2857142857142857,1,0.0,0,0,0,0,0,0,0,2,0,0,2,1
2063,46499,lRdsv9fYLnIcUL3TBjBQriZ2JWdvMb3q,fbPkOYLVPtPgIt0MxizjfFJov3JbHyAi,11,14,5,7,8,0,8,0,42,6.0,1,0.0,8,5,5,8,6,0,2,8,0,26,16,1
2064,46502,1jF4i27HOUbotwD2J9eQl8mWP4HNYpQb,fbPkOYLVPtPgIt0MxizjfFJov3JbHyAi,7,6,3,0,2,0,5,1,17,2.4285714285714284,1,0.0,1,3,0,2,5,0,0,5,1,6,11,1
2065,46506,zFt7rS5Ni4X3ECj04tcq3nH3EFoFZ84i,fbPkOYLVPtPgIt0MxizjfFJov3JbHyAi,6,5,2,0,2,0,2,0,11,1.5714285714285714,1,0.0,0,2,0,2,5,0,0,2,0,4,7,1
2066,46507,PCZm3QTx838vIR2ddmMUqYGr7hfCHZlX,fbPkOYLVPtPgIt0MxizjfFJov3JbHyAi,1,0,0,0,0,0,2,0,2,0.2857142857142857,1,0.0,0,0,0,0,0,0,0,2,0,0,2,1
2067,46508,sRnzromKdYo1GrGgSS37szKdSdhGa5G6,fbPkOYLVPtPgIt0MxizjfFJov3JbHyAi,18,10,9,0,8,0,2,0,29,4.142857142857143,1,0.0,0,9,0,8,10,0,0,2,0,17,12,1
2068,46509,wUS4QMZENKgcJOovrFGfoZniw3fDJWWg,fbPkOYLVPtPgIt0MxizjfFJov3JbHyAi,30,51,30,9,13,18,35,1,157,22.428571428571427,8,0.0,12,30,9,13,39,18,0,35,1,64,93,0
2069,46510,vCnaR7A3EMdV2eOQ4pBMh0byIjK5VwLE,fbPkOYLVPtPgIt0MxizjfFJov3JbHyAi,13,25,12,0,1,4,6,0,48,6.857142857142857,1,0.0,0,12,0,1,25,4,0,6,0,13,35,1
2070,46521,oSHVr2wJcX30QpIU9UqknqqlABAuhq3p,fbPkOYLVPtPgIt0MxizjfFJov3JbHyAi,8,4,3,0,2,0,7,0,16,2.2857142857142856,1,0.0,0,3,0,2,4,0,0,7,0,5,11,1
2071,46525,8leBy69GlSv8dJWktFbENy7QX7XuxXJV,fbPkOYLVPtPgIt0MxizjfFJov3JbHyAi,1,0,0,0,0,0,1,0,1,0.14285714285714285,1,0.0,0,0,0,0,0,0,0,1,0,0,1,1
2072,46528,0WR29JaRQtT4k6Qay1AHwZZo1wPFV6rM,fbPkOYLVPtPgIt0MxizjfFJov3JbHyAi,8,3,2,0,2,0,3,0,10,1.4285714285714286,1,0.0,0,2,0,2,3,0,0,3,0,4,6,1
2073,46532,iWEmpult7cdvgdjFW97TkROBvpRLqQNG,fbPkOYLVPtPgIt0MxizjfFJov3JbHyAi,1,0,0,0,0,0,1,0,1,0.14285714285714285,1,0.0,0,0,0,0,0,0,0,1,0,0,1,1
2074,46535,fdzq5tofwv4sAm3YqrsC6AMOnGl1oPA0,fbPkOYLVPtPgIt0MxizjfFJov3JbHyAi,26,48,1,18,9,13,20,2,111,15.857142857142858,3,0.0,25,1,15,9,23,13,3,20,2,50,61,1
2075,46537,TPC5VVSAcF8gFV38c4L30rHoJE6Gnwyt,fbPkOYLVPtPgIt0MxizjfFJov3JbHyAi,1,0,0,0,0,0,1,0,1,0.14285714285714285,1,0.0,0,0,0,0,0,0,0,1,0,0,1,1
2076,46538,PUFh3BsQaDVIJMDvwsFTqkrgAzvjO9ME,fbPkOYLVPtPgIt0MxizjfFJov3JbHyAi,5,4,2,0,1,0,1,0,8,1.1428571428571428,1,0.0,0,2,0,1,4,0,0,1,0,3,5,1
2077,46539,5lKHsIfbHqFuRTaXGCcOvuWTQPnbutQz,fbPkOYLVPtPgIt0MxizjfFJov3JbHyAi,14,16,4,4,8,5,13,1,51,7.285714285714286,1,0.0,10,4,3,8,6,5,1,13,1,25,26,1
2078,46542,pSw6NR4rsSse1CEq7lXuqdp47AxBAOW4,fbPkOYLVPtPgIt0MxizjfFJov3JbHyAi,12,8,5,6,4,0,6,0,29,4.142857142857143,2,0.0,1,5,5,4,7,0,1,6,0,15,14,1
2079,46545,z5vRcYNQa59xIDqKogHjXQX8tInd0ezN,fbPkOYLVPtPgIt0MxizjfFJov3JbHyAi,7,4,3,0,0,0,4,1,12,1.7142857142857142,1,0.0,0,3,0,0,4,0,0,4,1,3,9,1
2080,46546,RxVWvRN6nC74h4K2UUaoi1CZPrOsRdzT,fbPkOYLVPtPgIt0MxizjfFJov3JbHyAi,10,4,3,0,3,0,3,0,13,1.8571428571428572,1,0.0,0,3,0,3,4,0,0,3,0,6,7,1
2081,46548,85Gd0egbITBoZ0qf12CC4QmkR1r0ZNfP,fbPkOYLVPtPgIt0MxizjfFJov3JbHyAi,1,0,0,0,0,0,1,0,1,0.14285714285714285,1,0.0,0,0,0,0,0,0,0,1,0,0,1,1
2082,46551,kWet01DzGE5Z1z6FwJt5yEexIuvkBhsh,fbPkOYLVPtPgIt0MxizjfFJov3JbHyAi,7,21,3,0,4,16,5,0,49,7.0,3,0.0,8,3,0,4,13,16,0,5,0,15,34,0
2083,46553,3iTz6LNdmrAf4N1vHZusHFiE1Zs4S5Tp,fbPkOYLVPtPgIt0MxizjfFJov3JbHyAi,14,9,5,0,4,1,6,2,27,3.857142857142857,1,0.0,2,5,0,4,7,1,0,6,2,11,16,1
2084,46554,XDsU9hjOJ2JutIT7BD3Uu690qeQfLlzy,fbPkOYLVPtPgIt0MxizjfFJov3JbHyAi,8,6,4,0,3,0,6,0,19,2.7142857142857144,1,0.0,0,4,0,3,6,0,0,6,0,7,12,0
2085,46563,jeCWCRGTMsRbs6OIyOwUGbeuGaxOlgRf,fbPkOYLVPtPgIt0MxizjfFJov3JbHyAi,8,6,3,0,4,0,3,0,16,2.2857142857142856,2,0.0,2,3,0,4,4,0,0,3,0,9,7,1
2086,46572,ot3QeXNrfLK0N6qyT4MMuMtdNheYtJct,fbPkOYLVPtPgIt0MxizjfFJov3JbHyAi,8,2,1,0,1,2,6,1,13,1.8571428571428572,3,0.0,0,1,0,1,2,2,0,6,1,2,11,1
2087,46575,Qo1OAp8GglCOhKICbcJQhmG7Ih2RNYzD,fbPkOYLVPtPgIt0MxizjfFJov3JbHyAi,2,0,0,0,0,0,4,0,4,0.5714285714285714,1,0.0,0,0,0,0,0,0,0,4,0,0,4,1
2088,46583,oIYeGNswP9C35pzco2q8t5ZyALp7umIE,fbPkOYLVPtPgIt0MxizjfFJov3JbHyAi,1,0,0,0,0,0,1,0,1,0.14285714285714285,1,0.0,0,0,0,0,0,0,0,1,0,0,1,1
2089,46584,l6QkvTQevuUo95YVKmMOiOhmjs3kJ3PF,fbPkOYLVPtPgIt0MxizjfFJov3JbHyAi,1,0,0,0,0,0,1,0,1,0.14285714285714285,1,0.0,0,0,0,0,0,0,0,1,0,0,1,1
2090,46586,2sZGSeEPKMgpuspPc9ln3wAme2MWPynt,fbPkOYLVPtPgIt0MxizjfFJov3JbHyAi,1,0,0,0,0,0,1,0,1,0.14285714285714285,1,0.0,0,0,0,0,0,0,0,1,0,0,1,1
2091,46591,XQCUbONg6Qt5ssh0BzFokuANDDKZfnIv,fbPkOYLVPtPgIt0MxizjfFJov3JbHyAi,10,17,3,2,2,0,5,0,29,4.142857142857143,3,0.0,1,3,2,2,16,0,0,5,0,8,21,1
2092,46592,6EsKULTJVMq3E9IpeZllE0vOQuFiZwCm,fbPkOYLVPtPgIt0MxizjfFJov3JbHyAi,1,0,0,0,0,0,1,0,1,0.14285714285714285,1,0.0,0,0,0,0,0,0,0,1,0,0,1,1
2093,46594,43LGAyiQH2Nct9LoZlyA6wH2hSGoRMei,fbPkOYLVPtPgIt0MxizjfFJov3JbHyAi,1,0,0,0,0,0,1,0,1,0.14285714285714285,1,0.0,0,0,0,0,0,0,0,1,0,0,1,1
2094,47712,ilWzYGLWBh9DSc1MV8g2C4Go5wDNgUHX,7GRhBDsirIGkRZBtSMEzNTyDr2JQm4xx,30,22,7,30,9,20,3,0,91,13.0,1,0.0,14,7,26,9,8,20,4,3,0,56,35,1
2095,47737,kqS8BwWN9R1093oeblGkvtCsQJ68Gh0G,7GRhBDsirIGkRZBtSMEzNTyDr2JQm4xx,3,2,1,0,0,0,1,0,4,0.5714285714285714,1,0.0,0,1,0,0,2,0,0,1,0,1,3,1
2096,47748,kBcjUv7wCsLl51XfcJpKl8Rz4VIbTmWw,fbPkOYLVPtPgIt0MxizjfFJov3JbHyAi,27,23,9,8,9,3,11,1,64,9.142857142857142,3,0.0,10,9,8,9,13,3,0,11,1,36,28,1
2097,47750,0qPh5PrlrJCeTfTUrI9BQO9zneoMXi60,fbPkOYLVPtPgIt0MxizjfFJov3JbHyAi,9,12,3,0,4,1,5,1,26,3.7142857142857144,1,0.0,7,3,0,4,5,1,0,5,1,14,12,1
2098,47752,sssMJa5iFnCjQwIkqzgCnBND3LRzFTaw,fbPkOYLVPtPgIt0MxizjfFJov3JbHyAi,1,0,0,0,0,0,1,0,1,0.14285714285714285,1,0.0,0,0,0,0,0,0,0,1,0,0,1,1
2099,47753,vAnQOM98uBV9N4zlyAfd54z2JCZnwUx8,fbPkOYLVPtPgIt0MxizjfFJov3JbHyAi,21,41,14,24,13,0,9,0,101,14.428571428571429,3,0.0,8,14,19,13,33,0,5,9,0,54,47,1
2100,47758,Br3boNa1GOtMS8whgjxC8vFojVZKIJ8q,fbPkOYLVPtPgIt0MxizjfFJov3JbHyAi,7,3,2,0,2,0,5,0,12,1.7142857142857142,1,0.0,0,2,0,2,3,0,0,5,0,4,8,1
2101,47760,jWh61XkRTjwdqASpqvrGaFWBIry4gjxu,fbPkOYLVPtPgIt0MxizjfFJov3JbHyAi,5,2,1,0,1,0,8,0,12,1.7142857142857142,2,0.0,0,1,0,1,2,0,0,8,0,2,10,1
2102,47764,3ekpb9qQNnBvDGQePlspHv7VLn9RhUhL,fbPkOYLVPtPgIt0MxizjfFJov3JbHyAi,1,0,0,0,0,0,1,0,1,0.14285714285714285,1,0.0,0,0,0,0,0,0,0,1,0,0,1,1
2103,47770,KO9zYaiac2CNagQLdx3aJ9c2fXXMgIJX,fbPkOYLVPtPgIt0MxizjfFJov3JbHyAi,22,56,17,4,10,6,17,2,112,16.0,7,0.0,3,17,3,10,53,6,1,17,2,33,79,0
2104,47772,mMS5utPEE0kau31EdquwgaN1e0nxF2V4,fbPkOYLVPtPgIt0MxizjfFJov3JbHyAi,6,3,2,0,2,0,1,0,8,1.1428571428571428,1,0.0,0,2,0,2,3,0,0,1,0,4,4,1
2105,47776,zHeujEYh5L6paRQ7acJHcEFwTj5egykX,fbPkOYLVPtPgIt0MxizjfFJov3JbHyAi,5,6,2,0,0,0,3,0,11,1.5714285714285714,3,0.0,0,2,0,0,6,0,0,3,0,2,9,1
2106,47777,H2nT05aeA6Q1zZKHa66kquyct5PT5SXn,fbPkOYLVPtPgIt0MxizjfFJov3JbHyAi,9,9,3,0,3,8,2,0,25,3.5714285714285716,1,0.0,2,3,0,3,7,8,0,2,0,8,17,1
2107,47779,rVswAzjMLz5uIPbCwAU1SliCQFpiAqey,fbPkOYLVPtPgIt0MxizjfFJov3JbHyAi,6,4,3,0,2,0,2,0,11,1.5714285714285714,1,0.0,0,3,0,2,4,0,0,2,0,5,6,1
2108,47780,bhGqExUGpWPVtLHOBczGOZtP5NSlb2iV,fbPkOYLVPtPgIt0MxizjfFJov3JbHyAi,5,2,1,0,1,0,2,0,6,0.8571428571428571,1,0.0,0,1,0,1,2,0,0,2,0,2,4,1
2109,47783,LnBIzyfbdwaIzv1AmzgfFWCAT33UKIqQ,fbPkOYLVPtPgIt0MxizjfFJov3JbHyAi,5,3,1,0,1,0,4,0,9,1.2857142857142858,1,0.0,1,1,0,1,2,0,0,4,0,3,6,1
2110,47787,W3kCxGrfIFukJWUU9IJiC14IoMB2PgEG,fbPkOYLVPtPgIt0MxizjfFJov3JbHyAi,7,7,5,0,0,15,5,0,32,4.571428571428571,1,0.0,0,5,0,0,7,15,0,5,0,5,27,1
2111,47789,2LJu3awzGTK6KEvbTKsHaTWm40Uc2FME,fbPkOYLVPtPgIt0MxizjfFJov3JbHyAi,5,2,1,0,1,0,2,0,6,0.8571428571428571,1,0.0,0,1,0,1,2,0,0,2,0,2,4,1
2112,47790,0ieVgiGrluCsPP0YL5BydyAhM42qWcB4,fbPkOYLVPtPgIt0MxizjfFJov3JbHyAi,7,3,2,0,2,0,3,0,10,1.4285714285714286,1,0.0,0,2,0,2,3,0,0,3,0,4,6,1
2113,47793,hllwiqbKGoyJt5Tb2KABSErcKGSjkpFC,fbPkOYLVPtPgIt0MxizjfFJov3JbHyAi,1,0,0,0,0,0,1,0,1,0.14285714285714285,1,0.0,0,0,0,0,0,0,0,1,0,0,1,1
2114,47794,lQ3NA8rIFeBdMYWA2lzeVtp3TG4uBQXU,fbPkOYLVPtPgIt0MxizjfFJov3JbHyAi,15,56,33,13,31,30,8,0,171,24.428571428571427,5,0.0,10,33,9,31,46,30,4,8,0,83,88,1
2115,47802,0QSMkT1dSojdga3gOUuLnnXcPZoPeqgp,fbPkOYLVPtPgIt0MxizjfFJov3JbHyAi,5,2,1,0,1,0,2,0,6,0.8571428571428571,1,0.0,0,1,0,1,2,0,0,2,0,2,4,0
2116,47805,C1NrIu2z9b7sPd2GgrgPvw1qImibSsqR,fbPkOYLVPtPgIt0MxizjfFJov3JbHyAi,1,0,0,0,0,0,1,0,1,0.14285714285714285,1,0.0,0,0,0,0,0,0,0,1,0,0,1,1
2117,47806,uXSmZuPz2xNXPk2qFBcPykAtedr98vP4,fbPkOYLVPtPgIt0MxizjfFJov3JbHyAi,9,6,3,2,3,0,2,0,16,2.2857142857142856,1,0.0,1,3,2,3,5,0,0,2,0,9,7,1
2118,47809,LwiFBYAg8FxzttVYXUksrgMfJRvI4SFJ,fbPkOYLVPtPgIt0MxizjfFJov3JbHyAi,13,33,16,0,0,1,16,1,67,9.571428571428571,4,0.0,9,16,0,0,24,1,0,16,1,25,42,1
2119,47810,ZQszEDvefL66DoX1xrFttL5Z99UGUgJi,fbPkOYLVPtPgIt0MxizjfFJov3JbHyAi,14,25,17,1,7,58,14,2,124,17.714285714285715,4,0.0,1,17,1,7,24,58,0,14,2,26,98,0
2120,47812,FQ1LFgTnlxgM163pJYQ8F6cnOancinCK,fbPkOYLVPtPgIt0MxizjfFJov3JbHyAi,15,22,1,7,4,7,4,0,45,6.428571428571429,3,0.0,9,1,6,4,13,7,1,4,0,20,25,1
2121,47816,JyOwpTqxlZyOZXFXAlv3kcbVV4zSYrRf,fbPkOYLVPtPgIt0MxizjfFJov3JbHyAi,8,4,2,0,2,0,2,0,10,1.4285714285714286,1,0.0,0,2,0,2,4,0,0,2,0,4,6,1
2122,47817,5NX0UTrEG0Nosf3C8odmhhCWYxUKxKSk,fbPkOYLVPtPgIt0MxizjfFJov3JbHyAi,5,2,1,0,1,0,2,0,6,0.8571428571428571,1,0.0,0,1,0,1,2,0,0,2,0,2,4,1
2123,47818,4aUZNrEysB01BTDaMjEoJUWN7ca7RotB,fbPkOYLVPtPgIt0MxizjfFJov3JbHyAi,12,12,4,2,5,0,5,0,28,4.0,1,0.0,6,4,2,5,6,0,0,5,0,17,11,1
2124,47820,ZJVdccRSVGtL7lRrhASOIKDRLk41rGEl,fbPkOYLVPtPgIt0MxizjfFJov3JbHyAi,8,5,3,0,2,0,2,0,12,1.7142857142857142,1,0.0,0,3,0,2,5,0,0,2,0,5,7,1
2125,47822,T0bX8618p1zppaN2AzjlfD61pjXKKkDP,fbPkOYLVPtPgIt0MxizjfFJov3JbHyAi,2,0,0,0,0,0,2,0,2,0.2857142857142857,1,0.0,0,0,0,0,0,0,0,2,0,0,2,1
2126,47824,wwifhf2JKuRRsCekTCD33hbtOjxoHPnW,fbPkOYLVPtPgIt0MxizjfFJov3JbHyAi,44,79,35,33,25,34,10,0,216,30.857142857142858,5,0.0,36,35,27,25,43,34,6,10,0,123,93,1
2127,47826,6cy8BWaUGaMCAOjojQczbStvsRKYISdK,fbPkOYLVPtPgIt0MxizjfFJov3JbHyAi,12,20,13,9,10,0,8,0,60,8.571428571428571,5,0.0,3,13,6,10,17,0,3,8,0,32,28,1
2128,47828,W7e0QUNKaRKq7UxQ0gmzqrmRmeubAvn2,fbPkOYLVPtPgIt0MxizjfFJov3JbHyAi,5,2,1,0,1,0,2,0,6,0.8571428571428571,1,0.0,0,1,0,1,2,0,0,2,0,2,4,1
2129,47838,bJNzzdFbeXF3gRIHxGK6VlbnTQeUffyz,fbPkOYLVPtPgIt0MxizjfFJov3JbHyAi,12,13,3,4,5,3,10,1,39,5.571428571428571,2,0.0,7,3,3,5,6,3,1,10,1,18,21,1
2130,47839,ymWpwD3GRW9ut1JiVBQeAWpoDiatjwOa,fbPkOYLVPtPgIt0MxizjfFJov3JbHyAi,19,25,13,5,9,18,8,0,78,11.142857142857142,3,0.0,7,13,5,9,18,18,0,8,0,34,44,1
2131,47846,DUdBmTRQYTDfiJ48gpt3WzQELlnWqHAt,fbPkOYLVPtPgIt0MxizjfFJov3JbHyAi,27,34,21,15,17,36,16,1,140,20.0,4,0.0,8,21,12,17,26,36,3,16,1,58,82,1
2132,47848,bo0kzQtcVPpunN4Y9LfeiFpB6omq1iOi,fbPkOYLVPtPgIt0MxizjfFJov3JbHyAi,1,0,0,0,0,0,1,0,1,0.14285714285714285,1,0.0,0,0,0,0,0,0,0,1,0,0,1,1
2133,47850,EA93zC2FZSfWuUTy2fGF8qAEwUDl0X8s,fbPkOYLVPtPgIt0MxizjfFJov3JbHyAi,29,49,26,18,18,6,11,0,128,18.285714285714285,5,0.0,14,26,14,18,35,6,4,11,0,72,56,1
2134,47853,ZZRh21sVolimyM3CDUIIgG9cuzaZauji,fbPkOYLVPtPgIt0MxizjfFJov3JbHyAi,43,82,39,55,19,57,23,4,279,39.857142857142854,6,0.0,27,39,41,19,55,57,14,23,4,126,153,1
2135,47861,DIrQamaTjjU1PZti9ZjQXTxfEYtPLnQl,fbPkOYLVPtPgIt0MxizjfFJov3JbHyAi,29,48,26,19,13,3,14,1,124,17.714285714285715,3,0.0,12,26,15,13,36,3,4,14,1,66,58,1
2136,47894,Rz28tFT5qYZaEQ78Ly3OdJx8TpvsmLBy,bWdj2GDclj5ofokWjzoa5jAwMkxCykd6,9,9,6,0,1,0,6,0,22,3.142857142857143,1,0.0,0,6,0,1,9,0,0,6,0,7,15,0
2137,47900,t8SjYilFMTCG5Wi1o6mcbWFbM7fvPbYd,SpATywNh6bZuzm8s1ceuBUnMUAeoAHHw,29,36,23,12,16,0,4,0,91,13.0,2,0.0,9,23,12,16,27,0,0,4,0,60,31,0
2138,47938,szUZ2QsyqJuXPgyS49q35y1kTVrrBlKT,SpATywNh6bZuzm8s1ceuBUnMUAeoAHHw,28,81,31,52,9,7,11,1,192,27.428571428571427,4,0.0,35,31,40,9,46,7,12,11,1,115,77,0
2139,48018,xecOK3aJ3hCti9mz2pAAcwSq9d1S8ATw,SpATywNh6bZuzm8s1ceuBUnMUAeoAHHw,24,68,12,60,6,1,15,1,163,23.285714285714285,4,0.0,27,12,59,6,41,1,1,15,1,104,59,0
2140,48081,zCdZvanEH4w4mJiogg5VcFWhPxVyZDYs,RXDvfPUBYFlVdlueBFbLW0mhhAyGEqpt,39,39,1,112,1,6,3,0,162,23.142857142857142,1,0.0,9,1,110,1,30,6,2,3,0,121,41,0
2141,48093,23GFMJXBCJBMscnU5tVwAanleKYVql9b,SpATywNh6bZuzm8s1ceuBUnMUAeoAHHw,32,95,60,36,37,148,35,4,415,59.285714285714285,8,0.0,18,60,33,37,77,148,3,35,4,148,267,0
2142,48114,rzXoVvb6RM0hS48T1GDjFso4hKBDuhsd,bWdj2GDclj5ofokWjzoa5jAwMkxCykd6,1,0,0,0,0,0,1,0,1,0.14285714285714285,1,0.0,0,0,0,0,0,0,0,1,0,0,1,0
2143,48121,aDXyYOZH6u3WRzJTxPdI3vxwfFxiKOmm,SpATywNh6bZuzm8s1ceuBUnMUAeoAHHw,11,20,7,0,5,0,4,0,36,5.142857142857143,2,0.0,0,7,0,5,20,0,0,4,0,12,24,1
2144,48204,pl9XUoy865SinWI51RNAlmhqaJHEhs94,SpATywNh6bZuzm8s1ceuBUnMUAeoAHHw,17,16,6,18,3,1,9,1,54,7.714285714285714,1,0.0,8,6,15,3,8,1,3,9,1,32,22,1
2145,48246,ieR2oDuOBOWrOSx08B7vLKsdvt41Kjgw,A3fsA9Zfv1X2fVEQhTw51lKENdNrEqT3,16,35,1,0,1,0,7,0,44,6.285714285714286,3,0.0,1,1,0,1,34,0,0,7,0,3,41,0
2146,48261,wi7Ze896VO17gMeNUgqgfOVbxlFbfvaK,SpATywNh6bZuzm8s1ceuBUnMUAeoAHHw,30,85,41,23,20,5,29,4,207,29.571428571428573,5,0.0,15,41,19,20,70,5,4,29,4,95,112,0
2147,48370,3HC1D1DG8BjKUNFZlgm7gcIQVOGrzi6J,SpATywNh6bZuzm8s1ceuBUnMUAeoAHHw,20,36,23,0,13,29,5,0,106,15.142857142857142,3,0.0,9,23,0,13,27,29,0,5,0,45,61,0
2148,48372,WjTYaS8yfbxyQCBRfgx2LHwT0DLPXKM5,SpATywNh6bZuzm8s1ceuBUnMUAeoAHHw,8,7,6,0,0,0,7,10,30,4.285714285714286,1,0.0,0,6,0,0,7,0,0,7,10,6,24,1
2149,48386,5jz6qtmzJGoTjjzPCohz2U8oEp7qiszP,SpATywNh6bZuzm8s1ceuBUnMUAeoAHHw,29,53,20,39,9,21,17,3,162,23.142857142857142,5,0.0,17,20,32,9,36,21,7,17,3,78,84,0
2150,48446,QIQR6VwK3cpUKM5lDzadEKeQATM23w8z,A3fsA9Zfv1X2fVEQhTw51lKENdNrEqT3,1,0,0,0,0,0,1,0,1,0.14285714285714285,1,0.0,0,0,0,0,0,0,0,1,0,0,1,1
2151,48484,HsuSSkmNEe51pmwRC4MuavuxD1n89icY,SpATywNh6bZuzm8s1ceuBUnMUAeoAHHw,10,3,2,0,2,6,6,1,20,2.857142857142857,1,0.0,0,2,0,2,3,6,0,6,1,4,16,1
2152,48570,VTFDw2vJ6rzCiyEGWQUVkoldm7wzhtYa,SpATywNh6bZuzm8s1ceuBUnMUAeoAHHw,18,31,15,0,8,6,8,0,68,9.714285714285714,3,0.0,10,15,0,8,21,6,0,8,0,33,35,1
2153,48587,v6QLYqOum8NXSX8h0M5DMTP0vkr2qfHa,SpATywNh6bZuzm8s1ceuBUnMUAeoAHHw,32,82,39,24,18,117,38,1,319,45.57142857142857,8,0.0,26,39,24,18,56,117,0,38,1,107,212,0
2154,48617,LSvU72CFq1TrHd9SCZOiKQ0qcV2oa2Ok,A3fsA9Zfv1X2fVEQhTw51lKENdNrEqT3,13,32,2,0,2,2,8,0,46,6.571428571428571,5,0.0,0,2,0,2,32,2,0,8,0,4,42,0
2155,48643,RCdcltNaQLfcoxT7YKTjQxAYUbCmzzKd,SpATywNh6bZuzm8s1ceuBUnMUAeoAHHw,28,32,16,28,8,28,7,1,120,17.142857142857142,4,0.0,11,16,26,8,21,28,2,7,1,61,59,0
2156,48693,AnsnVs5AVUHmSDONSrxZt8MIRHsOXvcc,SpATywNh6bZuzm8s1ceuBUnMUAeoAHHw,16,11,7,15,3,12,6,4,58,8.285714285714286,2,0.0,2,7,14,3,9,12,1,6,4,26,32,0
2157,48701,z4snJqWxxByo4wMmQ2g1knGwZpMDrb1I,SpATywNh6bZuzm8s1ceuBUnMUAeoAHHw,22,63,34,20,28,9,8,0,162,23.142857142857142,8,0.0,6,34,17,28,57,9,3,8,0,85,77,0
2158,48724,oxWNSOCXM5YtqWviH5bNOZtEWIiiD3Ad,SpATywNh6bZuzm8s1ceuBUnMUAeoAHHw,13,22,0,18,0,6,8,1,55,7.857142857142857,2,0.0,13,0,15,0,9,6,3,8,1,28,27,0
2159,48851,U2YEyQJ6vRjLD9a41Fy3cKvRrxCg3qKu,SpATywNh6bZuzm8s1ceuBUnMUAeoAHHw,25,54,31,34,8,40,36,1,204,29.142857142857142,4,0.0,9,31,28,8,45,40,6,36,1,76,128,0
2160,48873,FgYPvBwLri7YiFI9og6clP9FuKJ08jX7,G8EPVSXsOYB5YQWZGiz1aVq5Pgr2GrQu,1,0,0,0,0,0,1,0,1,0.14285714285714285,1,0.0,0,0,0,0,0,0,0,1,0,0,1,1
2161,48910,oORy78WPGzz21oydfrdMfNTEPAbNPQ4N,SpATywNh6bZuzm8s1ceuBUnMUAeoAHHw,13,11,4,13,3,0,6,0,37,5.285714285714286,2,0.0,4,4,11,3,7,0,2,6,0,22,15,0
2162,48957,7xLRAUzJSfSBonILgUC8oEWPnbxwGYvj,RXDvfPUBYFlVdlueBFbLW0mhhAyGEqpt,19,30,2,0,1,1,6,1,41,5.857142857142857,2,0.0,0,2,0,1,30,1,0,6,1,3,38,1
2163,48958,CFwBanDE4eguHX9lcM62Yx5Bex6437kC,SpATywNh6bZuzm8s1ceuBUnMUAeoAHHw,5,2,1,0,1,3,3,0,10,1.4285714285714286,2,0.0,0,1,0,1,2,3,0,3,0,2,8,0
2164,48968,3Y0bPm3E3Ch9XQ8h4cbV56DUaTL5U5qc,SpATywNh6bZuzm8s1ceuBUnMUAeoAHHw,21,65,29,18,4,68,25,3,212,30.285714285714285,6,0.0,18,29,15,4,47,68,3,25,3,66,146,0
2165,48988,n0HFF3TwqKuBMzzkdLCbvb8Mji5ZUnVX,bWdj2GDclj5ofokWjzoa5jAwMkxCykd6,4,2,1,0,1,0,1,0,5,0.7142857142857143,1,0.0,0,1,0,1,2,0,0,1,0,2,3,0
2166,49082,21PlIQxHvCIRuT4YC0IvZYCzvQ1GOkuQ,SpATywNh6bZuzm8s1ceuBUnMUAeoAHHw,15,16,2,23,3,3,5,1,53,7.571428571428571,3,0.0,5,2,19,3,11,3,4,5,1,29,24,1
2167,49086,G7CuAdMTwHj5eYhpu5z9RBNQZMziV4KR,SpATywNh6bZuzm8s1ceuBUnMUAeoAHHw,11,15,10,0,9,4,12,3,53,7.571428571428571,2,0.0,0,10,0,9,15,4,0,12,3,19,34,0
2168,49173,1n5WyoQB7crKqtXBR0SIfThQpW2Y5gVs,SpATywNh6bZuzm8s1ceuBUnMUAeoAHHw,18,40,18,9,9,16,10,1,103,14.714285714285714,1,0.0,14,18,9,9,26,16,0,10,1,50,53,0
2169,49176,NPHytleW9ri0zHSbUOwP2d33PRO3w2MK,SpATywNh6bZuzm8s1ceuBUnMUAeoAHHw,17,16,6,31,1,17,10,0,81,11.571428571428571,3,0.0,8,6,29,1,8,17,2,10,0,44,37,0
2170,49181,XlmFJwnIeWSyzdPHIMvNTxkRpr6ZopMK,SpATywNh6bZuzm8s1ceuBUnMUAeoAHHw,14,28,14,21,6,4,5,0,78,11.142857142857142,4,0.0,8,14,17,6,20,4,4,5,0,45,33,1
2171,49183,TNa2CwMEhRRkLaiFBsLLeLu23oFHBijc,SpATywNh6bZuzm8s1ceuBUnMUAeoAHHw,23,34,1,27,1,16,14,2,95,13.571428571428571,4,0.0,12,1,23,1,22,16,4,14,2,37,58,0
2172,49202,l70wRZ2DS0s6LjbT7C4gRoGrF27x9p2H,A3fsA9Zfv1X2fVEQhTw51lKENdNrEqT3,46,34,0,92,0,14,24,0,164,23.428571428571427,5,0.0,5,0,88,0,29,14,4,24,0,93,71,1
2173,49238,Zi3R72s2HAt1ldLoA4VSH4SbCoNpJ8zo,SpATywNh6bZuzm8s1ceuBUnMUAeoAHHw,6,3,2,0,2,0,1,0,8,1.1428571428571428,1,0.0,0,2,0,2,3,0,0,1,0,4,4,1
2174,49254,Hw8jmGp4VI4tAz6cfKhHDOeLB2t7MJ9z,SpATywNh6bZuzm8s1ceuBUnMUAeoAHHw,12,13,7,6,0,20,4,0,50,7.142857142857143,3,0.0,4,7,6,0,9,20,0,4,0,17,33,1
2175,49271,L1EklyJfiTl8KTmYGUWKSBRLYXBLn3BW,SpATywNh6bZuzm8s1ceuBUnMUAeoAHHw,5,0,0,0,0,0,4,1,5,0.7142857142857143,1,0.0,0,0,0,0,0,0,0,4,1,0,5,0
2176,49276,vrm9Sqb4UFaJQirEdRETMq8oV2HNeZJI,bWdj2GDclj5ofokWjzoa5jAwMkxCykd6,9,8,0,0,0,21,5,1,35,5.0,2,0.0,0,0,0,0,8,21,0,5,1,0,35,0
2177,49302,3uU9hzp6POZeWb9TkpjJweQiyjZgKmLY,SpATywNh6bZuzm8s1ceuBUnMUAeoAHHw,27,42,24,28,14,1,7,1,117,16.714285714285715,5,0.0,10,24,26,14,32,1,2,7,1,74,43,0
2178,49423,S9Zsax2BYcPzUt4rHtigt6S1ZlRCRjuu,SpATywNh6bZuzm8s1ceuBUnMUAeoAHHw,16,42,14,10,5,7,12,0,90,12.857142857142858,4,0.0,8,14,10,5,34,7,0,12,0,37,53,0
2179,49460,cvdLaf0MdwYwJIsGvs9mqC9xuvaOoxKF,A3fsA9Zfv1X2fVEQhTw51lKENdNrEqT3,6,4,3,0,3,0,2,0,12,1.7142857142857142,2,0.0,0,3,0,3,4,0,0,2,0,6,6,1
2180,49511,H1nbdkC904EOh8jWeVVcV5piaqMVBsli,SpATywNh6bZuzm8s1ceuBUnMUAeoAHHw,25,26,3,24,1,2,8,0,64,9.142857142857142,4,0.0,8,3,24,1,18,2,0,8,0,36,28,0
2181,49541,NblSZLprYLuCPJABpiPhGyWCznOG5gpM,SpATywNh6bZuzm8s1ceuBUnMUAeoAHHw,16,19,11,0,6,0,2,0,38,5.428571428571429,2,0.0,0,11,0,6,19,0,0,2,0,17,21,1
2182,49543,0OsY8LWQHJyrf2iZ6AGYuDrpmW3bfvqO,SpATywNh6bZuzm8s1ceuBUnMUAeoAHHw,16,31,12,18,3,0,10,0,74,10.571428571428571,1,0.0,11,12,15,3,20,0,3,10,0,41,33,0
2183,49604,OXUkoQAJTqhVghuHGRHk1iSAl7CHffoQ,SpATywNh6bZuzm8s1ceuBUnMUAeoAHHw,1,0,0,0,0,0,1,0,1,0.14285714285714285,1,0.0,0,0,0,0,0,0,0,1,0,0,1,1
2184,49610,G43uBjhkBEsnK2sHC51NOglfCGNDkydQ,SpATywNh6bZuzm8s1ceuBUnMUAeoAHHw,23,32,15,16,9,2,10,0,84,12.0,3,0.0,15,15,15,9,17,2,1,10,0,54,30,1
2185,49620,twg5LqeyEPdLZyjl4T3Yb1man7ZRuOed,SpATywNh6bZuzm8s1ceuBUnMUAeoAHHw,29,74,20,20,9,2,23,2,150,21.428571428571427,5,0.0,21,20,20,9,53,2,0,23,2,70,80,0
2186,49630,Nvud1QIhR4FBjW055r9HSxywupZk5GAR,SpATywNh6bZuzm8s1ceuBUnMUAeoAHHw,5,4,1,0,0,0,1,0,6,0.8571428571428571,1,0.0,0,1,0,0,4,0,0,1,0,1,5,1
2187,49650,Y3zuofaAdrsNcwq0tuYyHFkAsBUWoV8a,SpATywNh6bZuzm8s1ceuBUnMUAeoAHHw,24,38,15,30,4,40,26,8,161,23.0,5,0.0,6,15,26,4,32,40,4,26,8,51,110,0
2188,49654,1bKMONcV6Mq58szdlIajPdFyqaw4BvrA,SpATywNh6bZuzm8s1ceuBUnMUAeoAHHw,6,3,1,0,1,0,2,0,7,1.0,1,0.0,0,1,0,1,3,0,0,2,0,2,5,1
2189,49655,H1nbdkC904EOh8jWeVVcV5piaqMVBsli,G8EPVSXsOYB5YQWZGiz1aVq5Pgr2GrQu,69,103,5,212,6,5,19,1,351,50.142857142857146,5,0.0,59,5,169,6,44,5,43,19,1,239,112,0
2190,49656,BoK7CAUaCFqnLgmWLxeOHg8YkXUSeCtc,SpATywNh6bZuzm8s1ceuBUnMUAeoAHHw,12,14,6,8,3,0,2,0,33,4.714285714285714,1,0.0,2,6,6,3,12,0,2,2,0,17,16,0
2191,49694,cszgTMCcWdEja3BpEwPP5MtLXTMUMJXE,SpATywNh6bZuzm8s1ceuBUnMUAeoAHHw,12,8,5,12,3,0,1,0,29,4.142857142857143,1,0.0,2,5,12,3,6,0,0,1,0,22,7,0
2192,49710,LzTBHDjLePaTqbybIwaptvUgkC0hWYCZ,SpATywNh6bZuzm8s1ceuBUnMUAeoAHHw,32,59,29,32,12,6,16,1,155,22.142857142857142,4,0.0,19,29,30,12,40,6,2,16,1,90,65,0
2193,49749,EwhKhClSv2Ps16I3uKtjdSj1YI7rGPIh,SpATywNh6bZuzm8s1ceuBUnMUAeoAHHw,5,7,2,0,0,0,4,0,13,1.8571428571428572,3,0.0,0,2,0,0,7,0,0,4,0,2,11,0
2194,49766,Lce2TIYgGhTbahYzTHHK4e5KxnEianpx,SpATywNh6bZuzm8s1ceuBUnMUAeoAHHw,5,2,1,0,1,0,2,0,6,0.8571428571428571,1,0.0,0,1,0,1,2,0,0,2,0,2,4,1
2195,49803,3FwKlBDtKGlNAYyQNzHL1qfkuXpNOPVW,A3fsA9Zfv1X2fVEQhTw51lKENdNrEqT3,44,17,14,80,9,3,9,1,133,19.0,2,0.0,1,14,66,9,16,3,14,9,1,90,43,0
2196,49836,0vUwtohBIGCms6pa9p1s0k5cJHWURa4P,SpATywNh6bZuzm8s1ceuBUnMUAeoAHHw,24,28,0,34,0,4,7,1,74,10.571428571428571,2,0.0,10,0,29,0,18,4,5,7,1,39,35,0
2197,49863,rVswAzjMLz5uIPbCwAU1SliCQFpiAqey,SpATywNh6bZuzm8s1ceuBUnMUAeoAHHw,25,15,10,15,7,0,1,0,48,6.857142857142857,1,0.0,4,10,14,7,11,0,1,1,0,35,13,0
2198,49883,m5Ev3sP4lHJ0ibeJ0LosEcT9fpQ7nqsa,SpATywNh6bZuzm8s1ceuBUnMUAeoAHHw,15,21,2,12,1,0,8,1,45,6.428571428571429,3,0.0,4,2,11,1,17,0,1,8,1,18,27,0
2199,49946,LNdimqsJkOxQDP9dT4IGwewg9YvH7zfV,G8EPVSXsOYB5YQWZGiz1aVq5Pgr2GrQu,58,70,23,80,14,3,8,0,198,28.285714285714285,5,0.0,38,23,55,14,32,3,25,8,0,130,68,0
2200,49949,8kmVwd95niwmuvSIAWJVA4Pqx2tMb8kH,A3fsA9Zfv1X2fVEQhTw51lKENdNrEqT3,16,15,11,0,8,0,3,0,37,5.285714285714286,1,0.0,1,11,0,8,14,0,0,3,0,20,17,1
2201,49967,7tmNprOSiahGzByaY8XiUnCFEIQfWwuf,bWdj2GDclj5ofokWjzoa5jAwMkxCykd6,8,15,6,0,0,1,8,1,31,4.428571428571429,4,0.0,3,6,0,0,12,1,0,8,1,9,22,0
2202,49987,ctfOhdlbQGiOVF89Y090EmsAqQEvSWmz,SpATywNh6bZuzm8s1ceuBUnMUAeoAHHw,14,14,0,22,0,2,8,1,47,6.714285714285714,2,0.0,5,0,18,0,9,2,4,8,1,23,24,0
2203,49990,uG5tavnQGh6e9leaVUY69Y8QlorpIOvo,SpATywNh6bZuzm8s1ceuBUnMUAeoAHHw,7,7,5,0,4,0,3,0,19,2.7142857142857144,1,0.0,0,5,0,4,7,0,0,3,0,9,10,0
2204,49999,46mPOafwambmi8gI5RDfSSG6CkqbcJr8,SpATywNh6bZuzm8s1ceuBUnMUAeoAHHw,15,12,6,21,2,0,5,0,46,6.571428571428571,1,0.0,4,6,17,2,8,0,4,5,0,29,17,0
2205,50039,Ib4hBLihYWrsRQnVhSZKjb9Z8z0NZ4FI,SpATywNh6bZuzm8s1ceuBUnMUAeoAHHw,26,56,1,34,1,13,17,3,125,17.857142857142858,6,0.0,20,1,27,1,36,13,7,17,3,49,76,1
2206,50046,Pot71eWzAwlFIQ6WGEu1vr9IkLdwRub9,SpATywNh6bZuzm8s1ceuBUnMUAeoAHHw,6,3,2,0,1,0,2,0,8,1.1428571428571428,1,0.0,0,2,0,1,3,0,0,2,0,3,5,0
2207,50067,nYSFDE8RCbcZhD46fRSvPHUvA1ahfupi,bWdj2GDclj5ofokWjzoa5jAwMkxCykd6,14,13,3,0,3,35,11,1,66,9.428571428571429,3,0.0,0,3,0,3,13,35,0,11,1,6,60,1
2208,50077,HNEdRWA988TWNlPkPkScnQdIH5zRazOo,SpATywNh6bZuzm8s1ceuBUnMUAeoAHHw,16,28,13,9,6,26,7,1,90,12.857142857142858,3,0.0,8,13,9,6,20,26,0,7,1,36,54,0
2209,50083,0lcODMnOtMqKwcOQQi0MUEWuUnIKYPe1,A3fsA9Zfv1X2fVEQhTw51lKENdNrEqT3,36,37,0,76,1,0,8,0,122,17.428571428571427,1,0.0,5,0,64,1,32,0,12,8,0,70,52,1
2210,50092,rPKaOWNl9cYkLvtQk035CJPYGwPAMUtv,SpATywNh6bZuzm8s1ceuBUnMUAeoAHHw,26,46,20,30,5,2,11,1,115,16.428571428571427,7,0.0,8,20,27,5,38,2,3,11,1,60,55,0
2211,50131,6k0P72adqZC6N7qhsceaS6tnkuUG2bub,SpATywNh6bZuzm8s1ceuBUnMUAeoAHHw,11,17,8,18,3,5,10,0,61,8.714285714285714,2,0.0,5,8,15,3,12,5,3,10,0,31,30,0
2212,50143,kmn6CGih1FILZybV8MrApq46D7xH5npO,SpATywNh6bZuzm8s1ceuBUnMUAeoAHHw,17,17,2,1,2,7,13,1,43,6.142857142857143,2,0.0,1,2,1,2,16,7,0,13,1,6,37,0
2213,50175,CfX84b3AnOREjEgHXp5gQV78osBjxVJV,RXDvfPUBYFlVdlueBFbLW0mhhAyGEqpt,5,6,0,0,0,2,1,0,9,1.2857142857142858,1,0.0,2,0,0,0,4,2,0,1,0,2,7,0
2214,50254,rf43ZHojMqXQ775bmX3nnHgQ62d9XvGK,A3fsA9Zfv1X2fVEQhTw51lKENdNrEqT3,25,26,13,0,9,4,10,1,63,9.0,3,0.0,0,13,0,9,26,4,0,10,1,22,41,1
2215,50315,1D9YAtx0zyELGBYY8fk5ML3KqjBc5hJQ,bWdj2GDclj5ofokWjzoa5jAwMkxCykd6,1,0,0,0,0,0,1,0,1,0.14285714285714285,1,0.0,0,0,0,0,0,0,0,1,0,0,1,1
2216,50319,7eLlsseV075nalpvk2K7Ka9Wx9qMiOW4,SpATywNh6bZuzm8s1ceuBUnMUAeoAHHw,8,2,2,0,2,1,8,1,16,2.2857142857142856,2,0.0,0,2,0,2,2,1,0,8,1,4,12,0
2217,50324,OIups6Cq9XY2CbwOPuI31XrOSt1FeD7G,SpATywNh6bZuzm8s1ceuBUnMUAeoAHHw,14,15,1,21,1,0,2,0,40,5.714285714285714,2,0.0,2,1,17,1,13,0,4,2,0,21,19,0
2218,50357,wXFfHtwd9smrvhh9NQW7SmEEo1001LDW,bWdj2GDclj5ofokWjzoa5jAwMkxCykd6,15,16,7,48,4,14,5,0,94,13.428571428571429,2,0.0,5,7,44,4,11,14,4,5,0,60,34,0
2219,50416,Xdag5jOmE7uWC3FmBvgPc5F7lO3QNcPW,SpATywNh6bZuzm8s1ceuBUnMUAeoAHHw,25,31,16,15,6,28,10,1,107,15.285714285714286,4,0.0,3,16,14,6,28,28,1,10,1,39,68,0
2220,50461,Mk1WltctY1vlvTjvcoOEN36uI9KP8emp,SpATywNh6bZuzm8s1ceuBUnMUAeoAHHw,14,69,30,5,8,0,13,0,125,17.857142857142858,4,0.0,2,30,4,8,67,0,1,13,0,44,81,0
2221,50500,RwMUq7SCIYrULeTtIYQzgTGTjkIjUHL3,SpATywNh6bZuzm8s1ceuBUnMUAeoAHHw,17,27,2,26,3,3,14,7,82,11.714285714285714,4,0.0,6,2,19,3,21,3,7,14,7,30,52,0
2222,50508,9VvuC4slhZy3KdxqSDDnJl1JHYWZF5th,A3fsA9Zfv1X2fVEQhTw51lKENdNrEqT3,10,14,6,0,1,20,26,2,69,9.857142857142858,2,0.0,2,6,0,1,12,20,0,26,2,9,60,1
2223,50528,faeF4I5p3gAJMB1p4LfYVeCLQZKervYV,A3fsA9Zfv1X2fVEQhTw51lKENdNrEqT3,38,47,1,66,0,0,4,0,118,16.857142857142858,3,0.0,2,1,59,0,45,0,7,4,0,62,56,1
2224,50546,8rXJHeqrLpho5nIQgbDcpBTvBrVnGged,A3fsA9Zfv1X2fVEQhTw51lKENdNrEqT3,13,8,6,0,3,0,7,0,24,3.4285714285714284,1,0.0,0,6,0,3,8,0,0,7,0,9,15,1
2225,50573,8ksQz9dz4s7ijHzYWnxMOGz2bplP7OAs,SpATywNh6bZuzm8s1ceuBUnMUAeoAHHw,6,6,1,3,0,0,1,0,11,1.5714285714285714,1,0.0,2,1,3,0,4,0,0,1,0,6,5,1
2226,50660,6jPw8ZwEXjLpnrxZT6HkwOQ20NkEyvU7,SpATywNh6bZuzm8s1ceuBUnMUAeoAHHw,31,73,11,34,9,360,36,1,524,74.85714285714286,8,0.0,19,11,29,9,54,360,5,36,1,68,456,0
2227,50679,tqvOTiQbipkIXQL7CIR5dckxV83rng9S,G8EPVSXsOYB5YQWZGiz1aVq5Pgr2GrQu,6,9,5,0,4,6,6,0,30,4.285714285714286,2,0.0,0,5,0,4,9,6,0,6,0,9,21,0
2228,50782,spcUWaGtojfez6ZdF6aqlTnU3zU2dqpy,A3fsA9Zfv1X2fVEQhTw51lKENdNrEqT3,11,6,4,0,2,0,6,1,19,2.7142857142857144,1,0.0,0,4,0,2,6,0,0,6,1,6,13,0
2229,52454,quFRN0nuO6SCdHOgmUhTlayoumtzVI29,7GRhBDsirIGkRZBtSMEzNTyDr2JQm4xx,31,32,2,65,7,0,2,0,108,15.428571428571429,1,0.0,18,2,58,7,14,0,7,2,0,85,23,1
2230,52537,Jm6sJTkF2CzUeH5fDnA3ZYS6v322ABBN,7GRhBDsirIGkRZBtSMEzNTyDr2JQm4xx,5,2,1,0,1,0,2,0,6,0.8571428571428571,1,0.0,0,1,0,1,2,0,0,2,0,2,4,1
2231,52546,dNx7yBBYuWpRM4BeMNLD1yOnUwcueGfB,7GRhBDsirIGkRZBtSMEzNTyDr2JQm4xx,4,2,1,0,1,0,2,0,6,0.8571428571428571,1,0.0,0,1,0,1,2,0,0,2,0,2,4,1
2232,52669,Q8hb0j5K90GRKBQLUtk9egje9fPULAJD,7GRhBDsirIGkRZBtSMEzNTyDr2JQm4xx,1,0,0,0,0,0,1,0,1,0.14285714285714285,1,0.0,0,0,0,0,0,0,0,1,0,0,1,0
2233,52789,OO7beVHPObBfPwHA9jIrdvSr48hMom1m,7GRhBDsirIGkRZBtSMEzNTyDr2JQm4xx,31,56,21,56,21,3,2,0,159,22.714285714285715,6,0.0,25,21,48,21,31,3,8,2,0,115,44,0
2234,52835,ESHOHiiFNOO5h5pqzByY0J6PmNipWo8U,7GRhBDsirIGkRZBtSMEzNTyDr2JQm4xx,1,0,0,0,0,0,1,0,1,0.14285714285714285,1,0.0,0,0,0,0,0,0,0,1,0,0,1,1
2235,52935,VQQV4EfxxGcWfIRpLvaTXUUXZHA1kehZ,7GRhBDsirIGkRZBtSMEzNTyDr2JQm4xx,1,0,0,0,0,0,1,0,1,0.14285714285714285,1,0.0,0,0,0,0,0,0,0,1,0,0,1,1
2236,53000,CGPCZptxVu9ER3GGm9DUJ9SpSOShg1OZ,7GRhBDsirIGkRZBtSMEzNTyDr2JQm4xx,37,53,14,60,12,3,1,0,143,20.428571428571427,1,0.0,25,14,52,12,28,3,8,1,0,103,40,1
2237,53020,Z4kedXjIF6f3uubwtldCvvLQcT4vIEro,7GRhBDsirIGkRZBtSMEzNTyDr2JQm4xx,3,2,0,0,0,0,1,0,3,0.42857142857142855,1,0.0,0,0,0,0,2,0,0,1,0,0,3,1
2238,53046,t8qBiDTvOvYmrxcVIErRuEOf38tywm6t,bWdj2GDclj5ofokWjzoa5jAwMkxCykd6,20,57,34,98,8,24,22,0,243,34.714285714285715,5,0.0,9,34,92,8,48,24,6,22,0,143,100,1
2239,53048,8gk5kBMYT20pCB4wpUHe3xKwSYDbtvzS,SpATywNh6bZuzm8s1ceuBUnMUAeoAHHw,23,26,12,15,5,21,8,2,89,12.714285714285714,3,0.0,5,12,14,5,21,21,1,8,2,36,53,1
2240,53049,8cVIhj7cvR0q9dzupEColmwPbOHZ624c,SpATywNh6bZuzm8s1ceuBUnMUAeoAHHw,30,35,18,33,10,24,13,3,136,19.428571428571427,3,0.0,8,18,29,10,27,24,4,13,3,65,71,0
2241,53063,LbpzBfhp2Wgcn9ayrU6jOBjfquY2961S,SpATywNh6bZuzm8s1ceuBUnMUAeoAHHw,7,3,2,0,2,0,2,0,9,1.2857142857142858,1,0.0,0,2,0,2,3,0,0,2,0,4,5,1
2242,53070,3Ph0mVs6YY4X7VkfoALrDqpzMeDhFoCj,A3fsA9Zfv1X2fVEQhTw51lKENdNrEqT3,36,49,24,42,12,0,11,0,138,19.714285714285715,5,0.0,0,24,39,12,49,0,3,11,0,75,63,1
2243,53118,5bplw4NcU21nNTIEcExDZZHISObWtI7D,SpATywNh6bZuzm8s1ceuBUnMUAeoAHHw,2,0,0,0,0,0,2,0,2,0.2857142857142857,1,0.0,0,0,0,0,0,0,0,2,0,0,2,1
2244,53119,AwKhkfPOqEnTXG1Cn8Gmf8HHhYnwnTgu,SpATywNh6bZuzm8s1ceuBUnMUAeoAHHw,20,25,13,18,5,21,9,0,91,13.0,3,0.0,8,13,15,5,17,21,3,9,0,41,50,1
2245,53124,1mZ7vCkgdZSC0cu4gxvMxxm9xwGvwvAR,SpATywNh6bZuzm8s1ceuBUnMUAeoAHHw,12,7,0,8,0,0,4,1,20,2.857142857142857,1,0.0,1,0,7,0,6,0,1,4,1,8,12,1
2246,53139,nNXdLwc4WRmQjF7qTMoDc98hNmIFSp8j,SpATywNh6bZuzm8s1ceuBUnMUAeoAHHw,8,9,5,0,1,0,5,0,20,2.857142857142857,4,0.0,1,5,0,1,8,0,0,5,0,7,13,1
2247,53140,Jf77UYIvUtofHBGpvQMQ0qUfMZBh9rRJ,A3fsA9Zfv1X2fVEQhTw51lKENdNrEqT3,56,30,19,72,14,0,5,1,141,20.142857142857142,3,0.0,2,19,68,14,28,0,4,5,1,103,38,1
2248,53155,PPZEwof9f8rZx0lcTpURHpbkLB2YY5hH,bWdj2GDclj5ofokWjzoa5jAwMkxCykd6,1,0,0,0,0,0,1,0,1,0.14285714285714285,1,0.0,0,0,0,0,0,0,0,1,0,0,1,1
2249,53161,oS1Vf0Ayi2kmK9AxKSgJ38BEbMfbnGmy,SpATywNh6bZuzm8s1ceuBUnMUAeoAHHw,19,33,2,12,1,17,5,1,71,10.142857142857142,3,0.0,14,2,10,1,19,17,2,5,1,27,44,1
2250,53163,MxIyDpIx03wSGr0H52jiRE3GZR3Xt5iM,SpATywNh6bZuzm8s1ceuBUnMUAeoAHHw,29,61,31,44,16,1,8,0,161,23.0,4,0.0,21,31,38,16,40,1,6,8,0,106,55,1
2251,53170,BBcMLJIRqEjAV0Iy0PZLL6aDRdsecvdG,G8EPVSXsOYB5YQWZGiz1aVq5Pgr2GrQu,21,22,1,26,1,0,8,0,58,8.285714285714286,2,0.0,4,1,22,1,18,0,4,8,0,28,30,1
2252,53194,5y4YA2mbDcwuEjNHeStgjLfqN1rsKZgP,SpATywNh6bZuzm8s1ceuBUnMUAeoAHHw,16,65,3,29,1,2,24,1,125,17.857142857142858,6,0.0,33,3,23,1,32,2,6,24,1,60,65,0
2253,53198,TVNQBfVHiiSK1QlXMueUvqhShIHov5rx,A3fsA9Zfv1X2fVEQhTw51lKENdNrEqT3,4,0,0,0,0,0,8,0,8,1.1428571428571428,1,0.0,0,0,0,0,0,0,0,8,0,0,8,1
2254,53209,GOcyurvQpr52NaTeXKp3vF6yg377GcU5,SpATywNh6bZuzm8s1ceuBUnMUAeoAHHw,17,18,5,27,1,15,22,2,90,12.857142857142858,6,0.0,5,5,27,1,13,15,0,22,2,38,52,0
2255,53219,igvNYxEcQQQ9zsQs0eESBN7rFelE1Oyt,SpATywNh6bZuzm8s1ceuBUnMUAeoAHHw,6,4,1,0,1,0,2,0,8,1.1428571428571428,1,0.0,1,1,0,1,3,0,0,2,0,3,5,1
2256,53223,xv3zPM1UCM9DtQrJ8sbmGYaRlj8FtrlB,SpATywNh6bZuzm8s1ceuBUnMUAeoAHHw,25,45,3,16,1,8,12,1,86,12.285714285714286,4,0.0,14,3,16,1,31,8,0,12,1,34,52,1
2257,53247,tHPSGx00vsFzhzr0zwBlWWarqJT4wPHF,A3fsA9Zfv1X2fVEQhTw51lKENdNrEqT3,38,14,11,56,8,0,5,0,94,13.428571428571429,3,0.0,1,11,51,8,13,0,5,5,0,71,23,1
2258,53255,mOyYFNs2t1Eh1aA09x8EHu6wqp81MSvv,bWdj2GDclj5ofokWjzoa5jAwMkxCykd6,3,2,1,0,0,0,1,0,4,0.5714285714285714,1,0.0,0,1,0,0,2,0,0,1,0,1,3,1
2259,53275,tixHTdVBfyAX1gHufSYbGyCBT9OKYh0u,SpATywNh6bZuzm8s1ceuBUnMUAeoAHHw,10,8,4,0,3,0,2,0,17,2.4285714285714284,1,0.0,3,4,0,3,5,0,0,2,0,10,7,1
2260,53280,N7f90nGBEKO2Wy697fsY7gOd7p4hRhpZ,SpATywNh6bZuzm8s1ceuBUnMUAeoAHHw,8,4,2,0,1,7,4,1,19,2.7142857142857144,1,0.0,0,2,0,1,4,7,0,4,1,3,16,1
2261,53281,1R6B3xPo1MU8MeIr72077lkCH6LzghZG,SpATywNh6bZuzm8s1ceuBUnMUAeoAHHw,18,15,9,16,5,0,6,0,51,7.285714285714286,1,0.0,2,9,13,5,13,0,3,6,0,29,22,1
2262,53295,yo1PAd1hBwimD9OOoxvyi6mwQC5bfK9g,bWdj2GDclj5ofokWjzoa5jAwMkxCykd6,6,11,6,0,2,0,7,0,26,3.7142857142857144,3,0.0,0,6,0,2,11,0,0,7,0,8,18,1
2263,53312,uQjl8NGtIQkRfoe9edBiMgtYYmdkzVXR,SpATywNh6bZuzm8s1ceuBUnMUAeoAHHw,1,0,0,0,0,0,1,0,1,0.14285714285714285,1,0.0,0,0,0,0,0,0,0,1,0,0,1,0
2264,53336,5naaONANTJUheGV6edn51qgkV97IPNdM,SpATywNh6bZuzm8s1ceuBUnMUAeoAHHw,1,0,0,0,0,0,1,0,1,0.14285714285714285,1,0.0,0,0,0,0,0,0,0,1,0,0,1,1
2265,53346,oNcOLZOgRKuqVCWgf9VQFQ2ph82THXaV,RXDvfPUBYFlVdlueBFbLW0mhhAyGEqpt,1,0,0,0,0,0,1,0,1,0.14285714285714285,1,0.0,0,0,0,0,0,0,0,1,0,0,1,0
2266,53360,boitIxZvCZ9przAKAQqxtWTvavMJkqzn,SpATywNh6bZuzm8s1ceuBUnMUAeoAHHw,28,26,16,16,7,2,6,0,73,10.428571428571429,4,0.0,5,16,16,7,21,2,0,6,0,44,29,0
2267,53368,mf00J2vS5aNSPGjL8Bq3W8G35vnnAtUS,SpATywNh6bZuzm8s1ceuBUnMUAeoAHHw,28,40,8,32,4,2,16,2,104,14.857142857142858,4,0.0,14,8,28,4,26,2,4,16,2,54,50,1
2268,53374,rSB9ieAhUU6VlZTakIYbk4lUm5NlM8Bf,SpATywNh6bZuzm8s1ceuBUnMUAeoAHHw,2,0,0,0,0,0,2,0,2,0.2857142857142857,1,0.0,0,0,0,0,0,0,0,2,0,0,2,1
2269,53381,hJ48EYDAUcnIubJFw4NRxQxCK6ApJIxf,SpATywNh6bZuzm8s1ceuBUnMUAeoAHHw,15,20,0,22,0,6,8,0,56,8.0,2,0.0,8,0,22,0,12,6,0,8,0,30,26,1
2270,53396,0qQG1Nylz3pu9h7MazaVuzCwo13YkYej,SpATywNh6bZuzm8s1ceuBUnMUAeoAHHw,10,12,5,0,3,0,3,0,23,3.2857142857142856,2,0.0,0,5,0,3,12,0,0,3,0,8,15,1
2271,53418,0uULbxMYxykuellS4DES6XbGTfaCngOW,A3fsA9Zfv1X2fVEQhTw51lKENdNrEqT3,8,10,0,0,0,0,4,0,14,2.0,1,0.0,0,0,0,0,10,0,0,4,0,0,14,1
2272,53421,oyKGOSyMOi0AM9nt7p8h8Y1cF1HEnPtq,SpATywNh6bZuzm8s1ceuBUnMUAeoAHHw,4,2,1,0,1,0,2,0,6,0.8571428571428571,2,0.0,0,1,0,1,2,0,0,2,0,2,4,1
2273,53423,26YZUhjQbxCihl3CNnlwudlVL638MFZI,SpATywNh6bZuzm8s1ceuBUnMUAeoAHHw,7,9,0,0,0,1,8,0,18,2.5714285714285716,1,0.0,0,0,0,0,9,1,0,8,0,0,18,1
2274,53453,A4vEkOAwhpQEgLFKtjOc7tdIxawwQcIi,SpATywNh6bZuzm8s1ceuBUnMUAeoAHHw,29,65,34,20,17,3,18,0,157,22.428571428571427,5,0.0,15,34,16,17,50,3,4,18,0,82,75,1
2275,53456,WFLWEfQrQsuFMQB4h1DfinKxHOxaJgRw,RXDvfPUBYFlVdlueBFbLW0mhhAyGEqpt,2,0,0,0,0,0,2,0,2,0.2857142857142857,2,0.0,0,0,0,0,0,0,0,2,0,0,2,1
2276,53462,9rLNySnV0yxkzZA7V8enLIbzXZCrF6IJ,RXDvfPUBYFlVdlueBFbLW0mhhAyGEqpt,51,45,30,74,14,8,12,0,183,26.142857142857142,4,0.0,7,30,70,14,38,8,4,12,0,121,62,0
2277,53483,t20VhGjJQwmwXV8X5LeBQDucO3YuiMru,SpATywNh6bZuzm8s1ceuBUnMUAeoAHHw,19,16,3,41,1,30,11,2,104,14.857142857142858,3,0.0,5,3,34,1,11,30,7,11,2,43,61,0
2278,53484,WyWFczdn2Y2i2D9wUJkB93D49zn2CheK,SpATywNh6bZuzm8s1ceuBUnMUAeoAHHw,1,0,0,0,0,0,3,0,3,0.42857142857142855,3,0.0,0,0,0,0,0,0,0,3,0,0,3,0
2279,53501,5vi4PfMqn3pILscFmPde7WIp5OpFzjzt,SpATywNh6bZuzm8s1ceuBUnMUAeoAHHw,4,3,1,0,1,0,2,0,7,1.0,1,0.0,0,1,0,1,3,0,0,2,0,2,5,0
2280,53505,nG7nzscbe2QtoUFUlgTpRDhBo6dlFgWT,SpATywNh6bZuzm8s1ceuBUnMUAeoAHHw,1,0,0,0,0,0,1,0,1,0.14285714285714285,1,0.0,0,0,0,0,0,0,0,1,0,0,1,1
2281,53507,sqZsZQq9LcjzbfCPmehLyMMrK3ClcYAT,A3fsA9Zfv1X2fVEQhTw51lKENdNrEqT3,7,3,2,0,2,0,3,0,10,1.4285714285714286,1,0.0,0,2,0,2,3,0,0,3,0,4,6,1
2282,53526,4XbWtzoFwF5LOOV7fIRFhXr7S6ATs5RB,SpATywNh6bZuzm8s1ceuBUnMUAeoAHHw,9,6,1,0,1,9,4,1,22,3.142857142857143,1,0.0,0,1,0,1,6,9,0,4,1,2,20,1
2283,53534,ssMidTFfcaAGjWiJzMk3J73LCswwO4yV,A3fsA9Zfv1X2fVEQhTw51lKENdNrEqT3,7,0,0,0,0,2,6,1,9,1.2857142857142858,1,0.0,0,0,0,0,0,2,0,6,1,0,9,1
2284,53565,0HsU2yFVHR5yKm9Hke3oyrM0twIu2eg3,bWdj2GDclj5ofokWjzoa5jAwMkxCykd6,8,12,1,58,2,0,6,0,79,11.285714285714286,2,0.0,8,1,57,2,4,0,1,6,0,68,11,1
2285,53587,VDscv2ylkQ5hVjxSl7FzkFmJDmBcIaMr,A3fsA9Zfv1X2fVEQhTw51lKENdNrEqT3,30,14,7,76,4,0,4,0,105,15.0,2,0.0,5,7,72,4,9,0,4,4,0,88,17,1
2286,53596,fHnWrc914HQUCHZRKa2nPteHkVOkvlJI,SpATywNh6bZuzm8s1ceuBUnMUAeoAHHw,23,44,4,30,1,8,18,1,106,15.142857142857142,5,0.0,16,4,27,1,28,8,3,18,1,48,58,0
2287,53630,w7s7CbDlE2P2RGY2w8kEYH9keSavEsec,SpATywNh6bZuzm8s1ceuBUnMUAeoAHHw,7,5,2,0,1,0,6,0,14,2.0,1,0.0,0,2,0,1,5,0,0,6,0,3,11,1
2288,53649,dtP0jNvfsrthiSc4EbxmbNOv0Ufz6AhB,RXDvfPUBYFlVdlueBFbLW0mhhAyGEqpt,7,4,3,0,3,0,4,0,14,2.0,2,0.0,0,3,0,3,4,0,0,4,0,6,8,1
2289,53666,uxWS9amhXxmjOvqXmZExJSg0LcMFBAvq,RXDvfPUBYFlVdlueBFbLW0mhhAyGEqpt,18,15,12,0,8,0,27,1,63,9.0,4,0.0,2,12,0,8,13,0,0,27,1,22,41,1
2290,53669,j79CPp6e09l3A1MeqgSV5ajYlxbk9Ixy,A3fsA9Zfv1X2fVEQhTw51lKENdNrEqT3,33,18,5,58,5,0,5,0,91,13.0,2,0.0,2,5,53,5,16,0,5,5,0,65,26,1
2291,53694,dXgGUXhGtPdqA3aOz733dBgKiaq7cvX6,SpATywNh6bZuzm8s1ceuBUnMUAeoAHHw,13,21,2,0,2,0,15,0,40,5.714285714285714,4,0.0,0,2,0,2,21,0,0,15,0,4,36,1
2292,53718,Ar22lkOE5FvesxoMKtYhm8Cbv4MUQUYF,SpATywNh6bZuzm8s1ceuBUnMUAeoAHHw,7,1,1,0,1,0,5,0,8,1.1428571428571428,2,0.0,0,1,0,1,1,0,0,5,0,2,6,1
2293,53721,lSVRjk6dkgEmIe9I21hvsRF98Lf2IKdM,SpATywNh6bZuzm8s1ceuBUnMUAeoAHHw,25,40,19,20,9,3,9,0,100,14.285714285714286,2,0.0,8,19,20,9,32,3,0,9,0,56,44,1
2294,53740,oUC5J8T9mINNExS4753FcPxbWA9dWDjN,SpATywNh6bZuzm8s1ceuBUnMUAeoAHHw,17,17,10,5,4,1,7,1,45,6.428571428571429,1,0.0,3,10,4,4,14,1,1,7,1,21,24,1
2295,53741,CV8kQrzk7Ma4h2GmuCAW4YCocO4w4WSf,bWdj2GDclj5ofokWjzoa5jAwMkxCykd6,4,4,1,0,2,0,1,0,8,1.1428571428571428,1,0.0,2,1,0,2,2,0,0,1,0,5,3,1
2296,53755,FOAFoPTPHDIp8ur1T09KgTEj3KeABYBf,SpATywNh6bZuzm8s1ceuBUnMUAeoAHHw,2,0,0,0,0,0,2,0,2,0.2857142857142857,1,0.0,0,0,0,0,0,0,0,2,0,0,2,1
2297,53760,KGXFn1n0h5LwrdyZxyMenRRVTJ2x6Rjd,RXDvfPUBYFlVdlueBFbLW0mhhAyGEqpt,4,3,2,0,2,0,1,0,8,1.1428571428571428,1,0.0,0,2,0,2,3,0,0,1,0,4,4,1
2298,53766,KIPXc8MOqmnlmMqnIzIeaBqliIw9pS44,SpATywNh6bZuzm8s1ceuBUnMUAeoAHHw,30,41,21,16,10,8,17,4,117,16.714285714285715,3,0.0,10,21,16,10,31,8,0,17,4,57,60,1
2299,53786,L5GEhRbHdd9onnNJ8EJkvOQW3HytY3G8,SpATywNh6bZuzm8s1ceuBUnMUAeoAHHw,13,10,5,0,5,0,5,0,25,3.5714285714285716,2,0.0,2,5,0,5,8,0,0,5,0,12,13,1
2300,53792,p62iTg6ZpvzODJCBLH2d7SVfdoSWuy8j,RXDvfPUBYFlVdlueBFbLW0mhhAyGEqpt,71,122,80,111,37,1,12,2,365,52.142857142857146,4,0.0,23,80,105,37,99,1,6,12,2,245,120,0
2301,53796,10a3aPUuiEikOQBzdtiLA8dXlMBNaCqq,A3fsA9Zfv1X2fVEQhTw51lKENdNrEqT3,1,0,0,0,0,0,1,0,1,0.14285714285714285,1,0.0,0,0,0,0,0,0,0,1,0,0,1,1
2302,53805,sytW49I21SJ70ElOkXGU5SHeeHl1E3fL,A3fsA9Zfv1X2fVEQhTw51lKENdNrEqT3,24,22,16,0,11,0,12,0,61,8.714285714285714,5,0.0,2,16,0,11,20,0,0,12,0,29,32,1
2303,53818,mBrhN2Nrf27UQ54otia4OdwjR0gGrIS1,SpATywNh6bZuzm8s1ceuBUnMUAeoAHHw,8,6,1,0,0,1,8,0,16,2.2857142857142856,1,0.0,0,1,0,0,6,1,0,8,0,1,15,1
2304,53835,8rXJHeqrLpho5nIQgbDcpBTvBrVnGged,bWdj2GDclj5ofokWjzoa5jAwMkxCykd6,14,27,5,38,1,10,10,1,92,13.142857142857142,2,0.0,6,5,34,1,21,10,4,10,1,46,46,1
2305,53856,4jDSfVr3FM2ZrR7U3LMbeRYrZXGv5CAV,SpATywNh6bZuzm8s1ceuBUnMUAeoAHHw,8,4,2,0,2,1,2,1,12,1.7142857142857142,1,0.0,0,2,0,2,4,1,0,2,1,4,8,1
2306,53865,jKfEyfk0HFbzE5vAszOX5qLRWBhzLYt2,A3fsA9Zfv1X2fVEQhTw51lKENdNrEqT3,1,0,0,0,0,0,2,0,2,0.2857142857142857,2,0.0,0,0,0,0,0,0,0,2,0,0,2,1
2307,53872,jKfEyfk0HFbzE5vAszOX5qLRWBhzLYt2,bWdj2GDclj5ofokWjzoa5jAwMkxCykd6,1,0,0,0,0,0,1,0,1,0.14285714285714285,1,0.0,0,0,0,0,0,0,0,1,0,0,1,1
2308,53893,8C3Ev7v016DKmnVXW2AvnqT9jJXWxsa8,SpATywNh6bZuzm8s1ceuBUnMUAeoAHHw,7,3,2,0,2,0,2,0,9,1.2857142857142858,1,0.0,0,2,0,2,3,0,0,2,0,4,5,1
2309,53903,4XxIEPI2UOvU2fn3nQAeJ4R1qsxwKTmu,SpATywNh6bZuzm8s1ceuBUnMUAeoAHHw,21,29,15,0,11,0,11,0,66,9.428571428571429,1,0.0,4,15,0,11,25,0,0,11,0,30,36,0
2310,53916,BsBj37bM37sYKQjSXV07xFL8gbIptVn8,bWdj2GDclj5ofokWjzoa5jAwMkxCykd6,2,0,0,0,0,0,2,0,2,0.2857142857142857,1,0.0,0,0,0,0,0,0,0,2,0,0,2,1
2311,53920,Oiq6C4nL7ZnZProqskptBCeXrYJ4FTge,A3fsA9Zfv1X2fVEQhTw51lKENdNrEqT3,1,0,0,0,0,0,2,0,2,0.2857142857142857,1,0.0,0,0,0,0,0,0,0,2,0,0,2,1
2312,53930,IARcq51sP2SqR9JLBLqyXGL88k6Z1aOe,SpATywNh6bZuzm8s1ceuBUnMUAeoAHHw,1,0,0,0,0,0,1,0,1,0.14285714285714285,1,0.0,0,0,0,0,0,0,0,1,0,0,1,1
2313,53970,mopAEhc4oYbNGgdB14MDU4Z5IjNO4SXn,SpATywNh6bZuzm8s1ceuBUnMUAeoAHHw,22,25,2,34,0,0,5,0,66,9.428571428571429,1,0.0,6,2,28,0,19,0,6,5,0,36,30,1
2314,53984,QYVRHTpooyTkzSbIywJ7ri5o4t73Xwty,SpATywNh6bZuzm8s1ceuBUnMUAeoAHHw,7,15,5,0,3,0,3,0,26,3.7142857142857144,1,0.0,0,5,0,3,15,0,0,3,0,8,18,1
2315,53986,z9sj5HIJml1DMOMfRKKBQ7IvS2IoE424,bWdj2GDclj5ofokWjzoa5jAwMkxCykd6,16,55,27,0,11,14,18,0,125,17.857142857142858,3,0.0,0,27,0,11,55,14,0,18,0,38,87,1
2316,53989,1kEIJj7vLRBM7EdRHp9VWjLFIqNPjA0F,SpATywNh6bZuzm8s1ceuBUnMUAeoAHHw,5,2,1,0,1,0,3,0,7,1.0,1,0.0,0,1,0,1,2,0,0,3,0,2,5,1
2317,54035,6UfIu5SKHPYfwZxBxJpGSqhLHKhbdsl0,SpATywNh6bZuzm8s1ceuBUnMUAeoAHHw,13,11,10,2,7,0,3,0,33,4.714285714285714,1,0.0,0,10,2,7,11,0,0,3,0,19,14,0
2318,54045,A9hKsxxgL4q5b7FGmUZTmhhYJ9IUDrBm,SpATywNh6bZuzm8s1ceuBUnMUAeoAHHw,17,42,21,0,14,2,8,0,87,12.428571428571429,4,0.0,6,21,0,14,36,2,0,8,0,41,46,0
2319,54054,W3FcEvxr2cIwq2NIdATNIqtjoGLetLLn,bWdj2GDclj5ofokWjzoa5jAwMkxCykd6,10,13,2,20,1,8,7,2,53,7.571428571428571,2,0.0,1,2,18,1,12,8,2,7,2,22,31,1
2320,54072,Y9YzwTET1OUYhHsLt97DLY5Tl5O9atqy,SpATywNh6bZuzm8s1ceuBUnMUAeoAHHw,12,21,10,0,10,0,1,0,42,6.0,2,0.0,0,10,0,10,21,0,0,1,0,20,22,1
2321,54086,uIIavYxNuEJ6NG2Ex383dBZvdILceLZJ,SpATywNh6bZuzm8s1ceuBUnMUAeoAHHw,7,7,3,0,3,0,2,0,15,2.142857142857143,2,0.0,0,3,0,3,7,0,0,2,0,6,9,0
2322,54090,IwRf58Af79ziuqQX85M6J2Lo8D4N0Ygn,A3fsA9Zfv1X2fVEQhTw51lKENdNrEqT3,8,5,3,0,3,0,2,0,13,1.8571428571428572,1,0.0,0,3,0,3,5,0,0,2,0,6,7,1
2323,54093,1rAHmNrxrqnzHEQFMlydmQ968LsZW0oG,RXDvfPUBYFlVdlueBFbLW0mhhAyGEqpt,15,8,5,10,2,7,7,3,42,6.0,2,0.0,1,5,9,2,7,7,1,7,3,17,25,1
2324,54095,mANHObgCOxed01sMVUE2CCh0Yy4sWlCz,bWdj2GDclj5ofokWjzoa5jAwMkxCykd6,4,2,0,0,0,0,3,0,5,0.7142857142857143,1,0.0,0,0,0,0,2,0,0,3,0,0,5,1
2325,54100,ULxriJOFgcYW8OKrxzYPWeTN4MYJZpRj,SpATywNh6bZuzm8s1ceuBUnMUAeoAHHw,11,36,3,6,3,0,7,0,55,7.857142857142857,5,0.0,3,3,6,3,33,0,0,7,0,15,40,1
2326,54105,On4dVQn2MRHkwqRorWIyGST4bzaBJgjb,SpATywNh6bZuzm8s1ceuBUnMUAeoAHHw,7,7,4,0,3,0,2,0,16,2.2857142857142856,2,0.0,0,4,0,3,7,0,0,2,0,7,9,1
2327,54107,puAOKUG4MdJZvu6TGCieg6bgD5WGJ0qf,bWdj2GDclj5ofokWjzoa5jAwMkxCykd6,16,15,9,68,0,40,15,3,150,21.428571428571427,2,0.0,3,9,65,0,12,40,3,15,3,77,73,1
2328,54112,GASbwPXxwryodKV3AqYKdU5jEaEhIE7r,SpATywNh6bZuzm8s1ceuBUnMUAeoAHHw,20,23,3,8,1,0,15,3,53,7.571428571428571,3,0.0,3,3,7,1,20,0,1,15,3,14,39,0
2329,54120,S9bleRJbl0xJFa4yPXuTgULWJ67nbMqi,SpATywNh6bZuzm8s1ceuBUnMUAeoAHHw,13,24,15,8,9,0,5,0,61,8.714285714285714,4,0.0,3,15,8,9,21,0,0,5,0,35,26,0
2330,54127,puAOKUG4MdJZvu6TGCieg6bgD5WGJ0qf,A3fsA9Zfv1X2fVEQhTw51lKENdNrEqT3,1,0,0,0,0,0,1,0,1,0.14285714285714285,1,0.0,0,0,0,0,0,0,0,1,0,0,1,1
2331,54142,oEOiBLMr97GK8O9ympHG9NMLQODJ0Xam,A3fsA9Zfv1X2fVEQhTw51lKENdNrEqT3,1,0,0,0,0,0,1,0,1,0.14285714285714285,1,0.0,0,0,0,0,0,0,0,1,0,0,1,1
2332,54151,6f80AuCxgLhEz4q3r0Z7Tne4jeBhxVpZ,SpATywNh6bZuzm8s1ceuBUnMUAeoAHHw,28,95,30,41,13,23,41,6,249,35.57142857142857,3,0.0,24,30,35,13,71,23,6,41,6,102,147,0
2333,54156,QYaJtD7z5M6YcGNpdHV2JTsxqV4tXm9a,SpATywNh6bZuzm8s1ceuBUnMUAeoAHHw,24,39,23,19,0,19,8,0,108,15.428571428571429,4,0.0,11,23,18,0,28,19,1,8,0,52,56,0
2334,54174,qsAhBackOo3cL2WuRLzyR4ErX4nTraFk,bWdj2GDclj5ofokWjzoa5jAwMkxCykd6,8,9,2,2,5,0,2,0,20,2.857142857142857,1,0.0,6,2,2,5,3,0,0,2,0,15,5,1
2335,54189,cN6OZq4ak5IqzN7Lw32XLOS12DhlWO8Q,A3fsA9Zfv1X2fVEQhTw51lKENdNrEqT3,42,57,30,86,11,18,10,1,213,30.428571428571427,2,0.0,6,30,68,11,51,18,18,10,1,115,98,0
2336,54190,U6zvwzZFC3hs6bhxG6asVA50snx1s2RU,SpATywNh6bZuzm8s1ceuBUnMUAeoAHHw,4,2,1,0,1,0,1,0,5,0.7142857142857143,1,0.0,0,1,0,1,2,0,0,1,0,2,3,1
2337,54191,Io3VzTK6sP3a0ZVRKkRhFNz8A2ULjris,G8EPVSXsOYB5YQWZGiz1aVq5Pgr2GrQu,2,0,0,0,0,0,3,0,3,0.42857142857142855,1,0.0,0,0,0,0,0,0,0,3,0,0,3,1
2338,54193,smg4SHkT0uQ59GP6Camalxkw6c32vtzM,SpATywNh6bZuzm8s1ceuBUnMUAeoAHHw,25,46,8,20,6,0,11,0,91,13.0,4,0.0,7,8,16,6,39,0,4,11,0,37,54,0
2339,54196,4mLn5YrkZbnxPXEuAYTSn9TKZyVmWQjo,SpATywNh6bZuzm8s1ceuBUnMUAeoAHHw,12,26,1,0,1,0,4,0,32,4.571428571428571,3,0.0,0,1,0,1,26,0,0,4,0,2,30,0
2340,54209,ke8J6J68PMmqZ8rK8FCDUgXlLZQpLLZW,bWdj2GDclj5ofokWjzoa5jAwMkxCykd6,18,33,11,100,8,7,10,1,170,24.285714285714285,5,0.0,7,11,93,8,26,7,7,10,1,119,51,1
2341,54215,ZbaPpC6DlaDgy5Ic6oj7YX9qkm2j3Pmr,A3fsA9Zfv1X2fVEQhTw51lKENdNrEqT3,1,0,0,0,0,0,1,0,1,0.14285714285714285,1,0.0,0,0,0,0,0,0,0,1,0,0,1,1
2342,54230,RJ1FVW8gXQIpK321uzh2Sh69ojlsqnvg,A3fsA9Zfv1X2fVEQhTw51lKENdNrEqT3,16,11,8,0,6,2,13,2,42,6.0,2,0.0,0,8,0,6,11,2,0,13,2,14,28,0
2343,54245,DauUa5EOQjYVJ9IOEZ6MNnCJpVrdodep,SpATywNh6bZuzm8s1ceuBUnMUAeoAHHw,5,2,1,0,1,0,2,0,6,0.8571428571428571,1,0.0,0,1,0,1,2,0,0,2,0,2,4,1
2344,54248,4rM5k15XYnxmy5xR9L5EVWP9CatXJ8wI,SpATywNh6bZuzm8s1ceuBUnMUAeoAHHw,4,2,0,0,0,0,3,0,5,0.7142857142857143,1,0.0,0,0,0,0,2,0,0,3,0,0,5,1
2345,54256,wtEiMTsSGyqVYmzAUWtaJeXU5b3t5li0,SpATywNh6bZuzm8s1ceuBUnMUAeoAHHw,1,0,0,0,0,0,1,0,1,0.14285714285714285,1,0.0,0,0,0,0,0,0,0,1,0,0,1,0
2346,54263,haOx3D2RVOqd6ga1rw8OsvbEHoupYgpz,SpATywNh6bZuzm8s1ceuBUnMUAeoAHHw,14,9,4,12,3,3,3,0,34,4.857142857142857,1,0.0,2,4,9,3,7,3,3,3,0,18,16,1
2347,54267,o4j0NDzLh6XqpDKcvRg8Lx9N4HUYeTuP,A3fsA9Zfv1X2fVEQhTw51lKENdNrEqT3,1,0,0,0,0,0,1,0,1,0.14285714285714285,1,0.0,0,0,0,0,0,0,0,1,0,0,1,1
2348,54269,7EEqnuI1QuwYA0sZvgr9zLDxbRgASZvg,A3fsA9Zfv1X2fVEQhTw51lKENdNrEqT3,1,0,0,0,0,0,1,0,1,0.14285714285714285,1,0.0,0,0,0,0,0,0,0,1,0,0,1,1
2349,54286,NCyQ1ytdiWvqyE3iylDLFJzABxi8HOfD,SpATywNh6bZuzm8s1ceuBUnMUAeoAHHw,3,0,0,0,0,0,5,0,5,0.7142857142857143,1,0.0,0,0,0,0,0,0,0,5,0,0,5,1
2350,54307,Io3VzTK6sP3a0ZVRKkRhFNz8A2ULjris,A3fsA9Zfv1X2fVEQhTw51lKENdNrEqT3,2,0,0,0,0,0,2,0,2,0.2857142857142857,1,0.0,0,0,0,0,0,0,0,2,0,0,2,1
2351,54317,uKEv904ylJe7cpj2OP28yUTrESfvx6LR,SpATywNh6bZuzm8s1ceuBUnMUAeoAHHw,5,3,2,0,1,0,2,0,8,1.1428571428571428,1,0.0,0,2,0,1,3,0,0,2,0,3,5,1
2352,54326,Fq6XRhpyARqo3e2KmYQqUPcebNvG6D8A,SpATywNh6bZuzm8s1ceuBUnMUAeoAHHw,4,3,0,0,0,0,2,0,5,0.7142857142857143,1,0.0,0,0,0,0,3,0,0,2,0,0,5,1
2353,54347,u4dhcCVujoYC7k1ILiJ5SLaS1NfapC9a,SpATywNh6bZuzm8s1ceuBUnMUAeoAHHw,4,2,1,0,1,0,1,0,5,0.7142857142857143,1,0.0,0,1,0,1,2,0,0,1,0,2,3,1
2354,54354,1GwCcPnawuwjaFyAi38hoJxQ9NHTHcHa,SpATywNh6bZuzm8s1ceuBUnMUAeoAHHw,5,8,5,0,3,0,2,0,18,2.5714285714285716,2,0.0,0,5,0,3,8,0,0,2,0,8,10,1
2355,54400,hMJOWQDhTMJkvOumtHtoyaiAzs72Ex16,A3fsA9Zfv1X2fVEQhTw51lKENdNrEqT3,1,0,0,0,0,0,2,0,2,0.2857142857142857,1,0.0,0,0,0,0,0,0,0,2,0,0,2,1
2356,54403,IiprEhfBJUF3Volv4Wt8hDKs67azhw4N,SpATywNh6bZuzm8s1ceuBUnMUAeoAHHw,25,44,2,34,0,65,25,4,174,24.857142857142858,8,0.0,11,2,29,0,33,65,5,25,4,42,132,0
2357,54406,WK8aAMlHaWKAnJlGkt1oHqYhwnCNU9kd,SpATywNh6bZuzm8s1ceuBUnMUAeoAHHw,13,10,8,0,6,4,6,0,34,4.857142857142857,3,0.0,0,8,0,6,10,4,0,6,0,14,20,1
2358,54424,iU4BkerxkC85turiATAPlGLqWWQBW3EA,SpATywNh6bZuzm8s1ceuBUnMUAeoAHHw,6,4,2,0,2,0,2,0,10,1.4285714285714286,1,0.0,0,2,0,2,4,0,0,2,0,4,6,0
2359,54428,fvcf8Mss4D9M5Dkk5Dn5T9NiTapwZ9dB,bWdj2GDclj5ofokWjzoa5jAwMkxCykd6,13,6,5,0,5,0,7,0,23,3.2857142857142856,3,0.0,0,5,0,5,6,0,0,7,0,10,13,1
2360,54433,0LlQk6hYRlvSzomDUaPkEEBmqmYnYmBf,A3fsA9Zfv1X2fVEQhTw51lKENdNrEqT3,8,9,3,0,3,0,3,0,18,2.5714285714285716,1,0.0,0,3,0,3,9,0,0,3,0,6,12,1
2361,54441,jWzOKFReJZdfMoypRkZGX0AJ4yOxVurG,SpATywNh6bZuzm8s1ceuBUnMUAeoAHHw,17,53,14,29,3,13,25,1,138,19.714285714285715,5,0.0,32,14,22,3,21,13,7,25,1,71,67,1
2362,54454,xPyi5tVWLdzwESKbVSwWQTZrKjlUSal4,A3fsA9Zfv1X2fVEQhTw51lKENdNrEqT3,11,6,1,0,1,0,12,2,22,3.142857142857143,3,0.0,0,1,0,1,6,0,0,12,2,2,20,1
2363,54456,9y3oRyXROykl3sBJ7TIi1TtD7SPjZS8A,RXDvfPUBYFlVdlueBFbLW0mhhAyGEqpt,1,0,0,0,0,0,1,0,1,0.14285714285714285,1,0.0,0,0,0,0,0,0,0,1,0,0,1,1
2364,54466,X0qRVbMFwtmOOuQv50UvryYfYmnstiNp,RXDvfPUBYFlVdlueBFbLW0mhhAyGEqpt,10,15,1,0,0,0,5,0,21,3.0,5,0.0,0,1,0,0,15,0,0,5,0,1,20,1
2365,54474,2cQfWhwRUGUv48S47s2aDWYzSM5LRy6r,SpATywNh6bZuzm8s1ceuBUnMUAeoAHHw,17,27,2,18,1,0,13,1,62,8.857142857142858,5,0.0,6,2,15,1,21,0,3,13,1,24,38,1
2366,54513,wD600Vm6nYpRlm6dPdneFPtwC1POqb2E,SpATywNh6bZuzm8s1ceuBUnMUAeoAHHw,19,41,18,20,7,0,11,0,97,13.857142857142858,4,0.0,10,18,16,7,31,0,4,11,0,51,46,1
2367,54539,obFplu8p0J5bdsesTSoaj6Bc4UGbTB6M,A3fsA9Zfv1X2fVEQhTw51lKENdNrEqT3,3,2,0,0,0,0,1,0,3,0.42857142857142855,1,0.0,0,0,0,0,2,0,0,1,0,0,3,1
2368,54560,PuyGNo8qc6xk0x7N225chheH1U0jpEmh,SpATywNh6bZuzm8s1ceuBUnMUAeoAHHw,16,23,9,14,0,0,9,0,55,7.857142857142857,2,0.0,8,9,11,0,15,0,3,9,0,28,27,0
2369,54562,FjbDR3UaxcNBkb6IH3GDQCUcWtWdh8Qq,RXDvfPUBYFlVdlueBFbLW0mhhAyGEqpt,34,22,12,36,10,0,3,0,83,11.857142857142858,1,0.0,7,12,34,10,15,0,2,3,0,63,20,1
2370,54579,UTQBVZwwRuN7bMqGkwJeqpNJF2PPrsFV,bWdj2GDclj5ofokWjzoa5jAwMkxCykd6,5,4,2,0,1,0,2,0,9,1.2857142857142858,2,0.0,0,2,0,1,4,0,0,2,0,3,6,1
2371,54583,CQQHZVTg11Q29ZpbkjEKlKziDTQM27vd,SpATywNh6bZuzm8s1ceuBUnMUAeoAHHw,2,0,0,0,0,0,2,0,2,0.2857142857142857,1,0.0,0,0,0,0,0,0,0,2,0,0,2,1
2372,54631,cZaJE9WXhMzWTnSMxu0NdfVeWxOkn7lj,fbPkOYLVPtPgIt0MxizjfFJov3JbHyAi,6,3,1,0,1,0,2,0,7,1.0,1,0.0,0,1,0,1,3,0,0,2,0,2,5,1
2373,54662,2oTvbzieHn2y5oozeOgSnruqE6N0BtR5,fbPkOYLVPtPgIt0MxizjfFJov3JbHyAi,7,7,5,0,0,4,3,0,19,2.7142857142857144,1,0.0,0,5,0,0,7,4,0,3,0,5,14,1
2374,54714,GtuEelYfNaXxzKOllxbFfafnobOPHIGx,A3fsA9Zfv1X2fVEQhTw51lKENdNrEqT3,6,5,1,0,0,8,4,0,18,2.5714285714285716,2,0.0,0,1,0,0,5,8,0,4,0,1,17,1
2375,54802,CyhW9ceUO9NYz6xFgPeXoLjeNitx4OvW,7GRhBDsirIGkRZBtSMEzNTyDr2JQm4xx,1,0,0,0,0,0,1,0,1,0.14285714285714285,1,0.0,0,0,0,0,0,0,0,1,0,0,1,1
2376,54874,zmKR9B5NLIRfAmSKdCbaIDXMZT9PoZip,7GRhBDsirIGkRZBtSMEzNTyDr2JQm4xx,1,0,0,0,0,0,1,0,1,0.14285714285714285,1,0.0,0,0,0,0,0,0,0,1,0,0,1,1
2377,54893,MZomFQTbHAKaDGd0B9fv7KQ9MRsZJ7m6,7GRhBDsirIGkRZBtSMEzNTyDr2JQm4xx,1,0,0,0,0,0,1,0,1,0.14285714285714285,1,0.0,0,0,0,0,0,0,0,1,0,0,1,1
2378,54970,YbQfcgwKrjskWW3wyOzQUUJYzdeHmY82,A3fsA9Zfv1X2fVEQhTw51lKENdNrEqT3,50,51,22,50,15,0,16,0,154,22.0,3,0.0,4,22,48,15,47,0,2,16,0,89,65,0
2379,55003,PnDN2WssnANedhxbDqo06cZR8VfXOHcf,SpATywNh6bZuzm8s1ceuBUnMUAeoAHHw,8,15,3,16,0,0,1,0,35,5.0,1,0.0,10,3,15,0,5,0,1,1,0,28,7,0
2380,55046,OsjipUObm67JsyJjOy7xHoa32L8CSYg5,7GRhBDsirIGkRZBtSMEzNTyDr2JQm4xx,47,53,2,75,1,1,6,0,138,19.714285714285715,4,0.0,27,2,73,1,26,1,2,6,0,103,35,1
2381,55086,PfTpx7WgTJY6IpNokJ2POml34GMs7LTI,A3fsA9Zfv1X2fVEQhTw51lKENdNrEqT3,45,11,8,110,5,0,2,0,136,19.428571428571427,2,0.0,1,8,104,5,10,0,6,2,0,118,18,0
2382,55102,tC06tDcyfiakkQ82nvNuQ9hOr0id1lp4,A3fsA9Zfv1X2fVEQhTw51lKENdNrEqT3,24,12,10,0,9,17,4,1,53,7.571428571428571,1,0.0,0,10,0,9,12,17,0,4,1,19,34,1
2383,55108,oASR1hbK6DD6OJfTJCDKLW9l2vPgw7kR,SpATywNh6bZuzm8s1ceuBUnMUAeoAHHw,19,26,14,10,10,0,4,0,64,9.142857142857142,2,0.0,6,14,10,10,20,0,0,4,0,40,24,0
2384,55162,gKSJfTKRpPRCZVoRPeT84zeHU3dzpwjK,7GRhBDsirIGkRZBtSMEzNTyDr2JQm4xx,1,0,0,0,0,0,1,0,1,0.14285714285714285,1,0.0,0,0,0,0,0,0,0,1,0,0,1,1
2385,55218,9DhjEr6688N0pGcvfzUDBy2Ch8BrzD6G,SpATywNh6bZuzm8s1ceuBUnMUAeoAHHw,6,5,0,0,0,0,3,0,8,1.1428571428571428,1,0.0,1,0,0,0,4,0,0,3,0,1,7,0
2386,55222,sl5gnvWQxJCaKuNiDBTD8Gtex2riuepC,7GRhBDsirIGkRZBtSMEzNTyDr2JQm4xx,12,17,1,3,1,0,2,0,24,3.4285714285714284,1,0.0,3,1,3,1,14,0,0,2,0,8,16,1
2387,55268,yRP1A8CWHIiqi7L2SKgryjvGOEaUovOk,SpATywNh6bZuzm8s1ceuBUnMUAeoAHHw,13,22,3,21,1,1,9,2,59,8.428571428571429,2,0.0,8,3,17,1,14,1,4,9,2,29,30,0
2388,55324,b9PnER5aWf7HLwZ7RJ62h9NvkqSBL8ua,7GRhBDsirIGkRZBtSMEzNTyDr2JQm4xx,1,0,0,0,0,0,1,0,1,0.14285714285714285,1,0.0,0,0,0,0,0,0,0,1,0,0,1,1
2389,55335,YPEupTuOqSGieSSneZcv3AcUcSBCtbGY,RXDvfPUBYFlVdlueBFbLW0mhhAyGEqpt,8,6,0,13,1,0,2,0,22,3.142857142857143,1,0.0,3,0,13,1,3,0,0,2,0,17,5,1
2390,55362,xkt3K6JWpnfeixDBdwkLXaHgXuuGt35v,7GRhBDsirIGkRZBtSMEzNTyDr2JQm4xx,37,74,31,55,21,0,12,0,193,27.571428571428573,7,0.0,25,31,48,21,49,0,7,12,0,125,68,1
2391,55394,4mCA51pF01hkyB9Dsn8cU0qpfh1iqOVS,7GRhBDsirIGkRZBtSMEzNTyDr2JQm4xx,5,2,0,0,1,0,2,0,5,0.7142857142857143,1,0.0,0,0,0,1,2,0,0,2,0,1,4,1
2392,55398,46OTr627jSWtC8wrPe4BZiyNeqDxFeE3,SpATywNh6bZuzm8s1ceuBUnMUAeoAHHw,14,28,7,24,2,0,7,0,68,9.714285714285714,3,0.0,7,7,19,2,21,0,5,7,0,35,33,0
2393,55482,87SYGQjFYUtEWda0pG12bcNker0JGBy3,SpATywNh6bZuzm8s1ceuBUnMUAeoAHHw,13,26,1,12,0,11,9,1,60,8.571428571428571,3,0.0,5,1,12,0,21,11,0,9,1,18,42,1
2394,55543,pUCIPJW1P8mn7ehxRb7s9lkHivSStKgb,7GRhBDsirIGkRZBtSMEzNTyDr2JQm4xx,12,13,2,0,2,0,5,0,22,3.142857142857143,2,0.0,0,2,0,2,13,0,0,5,0,4,18,1
2395,55554,iN5LRJ62Fzny0HSOI77UB3W5oJ1HoHwK,7GRhBDsirIGkRZBtSMEzNTyDr2JQm4xx,2,0,0,0,0,0,3,0,3,0.42857142857142855,1,0.0,0,0,0,0,0,0,0,3,0,0,3,1
2396,55606,QuPJMxHrI2abilMygWFCmLFsgGUQO9Wm,bWdj2GDclj5ofokWjzoa5jAwMkxCykd6,12,17,11,10,6,17,8,1,70,10.0,2,0.0,1,11,8,6,16,17,2,8,1,26,44,1
2397,55676,0KWLX80Me9j0YMYrLboMuYM0mrVWxRud,7GRhBDsirIGkRZBtSMEzNTyDr2JQm4xx,32,50,24,42,5,40,18,2,181,25.857142857142858,1,0.0,18,24,36,5,32,40,6,18,2,83,98,0
2398,55714,ycZVLmNiTgP7M4zqov9Nx3hYhdN2qhKF,A3fsA9Zfv1X2fVEQhTw51lKENdNrEqT3,20,10,9,0,9,0,2,0,30,4.285714285714286,1,0.0,0,9,0,9,10,0,0,2,0,18,12,1
2399,55731,ybcsmPlarjax7Mq4kzteIAIZbYqmFvSY,G8EPVSXsOYB5YQWZGiz1aVq5Pgr2GrQu,13,18,9,68,0,2,5,0,102,14.571428571428571,3,0.0,1,9,67,0,17,2,1,5,0,77,25,0
2400,55733,zVX5LPwTGC1SEitxSfv31cubNXKJSEc2,G8EPVSXsOYB5YQWZGiz1aVq5Pgr2GrQu,6,2,2,0,1,0,2,0,7,1.0,1,0.0,0,2,0,1,2,0,0,2,0,3,4,0
2401,55813,gykRbA7iJUFygOkXv9mNdsHLTYvvd4jI,bWdj2GDclj5ofokWjzoa5jAwMkxCykd6,11,22,1,78,1,35,22,7,166,23.714285714285715,1,0.0,5,1,77,1,17,35,1,22,7,84,82,1
2402,55818,EQ7wf57Maxtqueh0jcALSwDsSR4NE6Fa,7GRhBDsirIGkRZBtSMEzNTyDr2JQm4xx,1,0,0,0,0,0,1,0,1,0.14285714285714285,1,0.0,0,0,0,0,0,0,0,1,0,0,1,1
2403,55828,bXhvLL1DQzEIjyGvSUCfqx2LTtxg4cK2,7GRhBDsirIGkRZBtSMEzNTyDr2JQm4xx,34,55,22,40,18,61,15,1,212,30.285714285714285,3,0.0,27,22,32,18,28,61,8,15,1,99,113,1
2404,55852,zC2jRq3r9EI7fiKmdxBaoujmdY4A8FN5,G8EPVSXsOYB5YQWZGiz1aVq5Pgr2GrQu,12,18,1,8,1,2,8,2,40,5.714285714285714,2,0.0,8,1,7,1,10,2,1,8,2,17,23,0
2405,55860,PmH4XgxtQe1CNb3l16TlTY5tyEhuC40E,SpATywNh6bZuzm8s1ceuBUnMUAeoAHHw,31,59,30,38,18,16,12,1,174,24.857142857142858,1,0.0,18,30,32,18,41,16,6,12,1,98,76,0
2406,55918,JOqHNkiAQMopMtNnxSpHdAOKSp68V43j,A3fsA9Zfv1X2fVEQhTw51lKENdNrEqT3,54,24,14,136,5,9,11,0,199,28.428571428571427,5,0.0,5,14,114,5,19,9,22,11,0,138,61,1
2407,55967,EK7Y6jLbcTIHEzN8KJHD55mY3w7SjZfJ,SpATywNh6bZuzm8s1ceuBUnMUAeoAHHw,28,68,10,19,6,55,10,0,168,24.0,2,0.0,32,10,18,6,36,55,1,10,0,66,102,1
2408,55978,JVRk883TChkd8D0ZSH6CEb3OUHD06lXQ,SpATywNh6bZuzm8s1ceuBUnMUAeoAHHw,32,52,27,34,13,7,14,3,150,21.428571428571427,3,0.0,15,27,30,13,37,7,4,14,3,85,65,0
2409,55979,P7MRSD3CXumEAUVQkOjfu7iyOA6WzwhX,7GRhBDsirIGkRZBtSMEzNTyDr2JQm4xx,7,8,3,4,3,0,1,0,19,2.7142857142857144,1,0.0,1,3,4,3,7,0,0,1,0,11,8,0
2410,56003,UqClTQDqKMNYDPHUpaTnYqiluGgaVwby,7GRhBDsirIGkRZBtSMEzNTyDr2JQm4xx,25,31,15,25,8,7,5,0,91,13.0,2,0.0,13,15,20,8,18,7,5,5,0,56,35,1
2411,56004,o9m1fMq17KjyGUhfLHLXFO5hoKQ5jU6O,A3fsA9Zfv1X2fVEQhTw51lKENdNrEqT3,1,0,0,0,0,0,1,0,1,0.14285714285714285,1,0.0,0,0,0,0,0,0,0,1,0,0,1,1
2412,56058,c162xBeHQ1ehzoWsokUc8kKEtu9gLIte,SpATywNh6bZuzm8s1ceuBUnMUAeoAHHw,14,11,5,9,4,0,4,0,33,4.714285714285714,1,0.0,5,5,9,4,6,0,0,4,0,23,10,0
2413,56062,pKCzqYDvJAlWQNOnHiIQZJLfMk8J7wCX,G8EPVSXsOYB5YQWZGiz1aVq5Pgr2GrQu,13,18,4,30,4,11,11,8,86,12.285714285714286,1,0.0,14,4,26,4,4,11,4,11,8,48,38,0
2414,56078,kKj1FlDO03hIJs4qO2fYyQxEzv7HbwXh,SpATywNh6bZuzm8s1ceuBUnMUAeoAHHw,19,31,11,10,6,0,4,0,62,8.857142857142858,3,0.0,11,11,9,6,20,0,1,4,0,37,25,1
2415,56081,Ybi3cFvDqy1VWHiDJ2n2dPI1NwP5ZaHo,7GRhBDsirIGkRZBtSMEzNTyDr2JQm4xx,1,0,0,0,0,0,1,0,1,0.14285714285714285,1,0.0,0,0,0,0,0,0,0,1,0,0,1,1
2416,56090,CXsZzvE3iylo5KzyiPoa1X1kRLwsS4Km,7GRhBDsirIGkRZBtSMEzNTyDr2JQm4xx,2,0,0,0,0,0,2,0,2,0.2857142857142857,1,0.0,0,0,0,0,0,0,0,2,0,0,2,1
2417,56104,WZLkW7B5dsHccBcGjqVOiLakE0tHruAV,SpATywNh6bZuzm8s1ceuBUnMUAeoAHHw,5,5,0,0,0,0,2,0,7,1.0,1,0.0,0,0,0,0,5,0,0,2,0,0,7,1
2418,56114,PmaZVK1XohXhK9MuIDoeUlsnQ3xunZ0o,SpATywNh6bZuzm8s1ceuBUnMUAeoAHHw,6,6,1,0,1,0,7,0,15,2.142857142857143,3,0.0,0,1,0,1,6,0,0,7,0,2,13,1
2419,56138,0K6JPqiivQzicxY4EV4nqMLCL3a08A97,7GRhBDsirIGkRZBtSMEzNTyDr2JQm4xx,19,29,17,22,13,3,7,0,91,13.0,2,0.0,11,17,19,13,18,3,3,7,0,60,31,1
2420,56154,hcrd0JfkIltpZTYyzvBezmjxNHV3TQ2P,7GRhBDsirIGkRZBtSMEzNTyDr2JQm4xx,31,53,16,51,22,16,6,0,164,23.428571428571427,2,0.0,33,16,46,22,20,16,5,6,0,117,47,1
2421,56169,TNAUZUlDZyGbJQN7wls2QRBe2Cw7eeSK,bWdj2GDclj5ofokWjzoa5jAwMkxCykd6,2,0,0,0,0,0,2,0,2,0.2857142857142857,1,0.0,0,0,0,0,0,0,0,2,0,0,2,0
2422,56189,sMMDk03UePJILkRIn5YDW5tA5us6h51J,SpATywNh6bZuzm8s1ceuBUnMUAeoAHHw,18,20,10,12,4,1,11,1,59,8.428571428571429,2,0.0,4,10,10,4,16,1,2,11,1,28,31,1
2423,56221,mxDmiNiZbTWbG5eX6cuqeU6lZnYbJUhB,SpATywNh6bZuzm8s1ceuBUnMUAeoAHHw,9,13,5,0,0,4,16,1,39,5.571428571428571,2,0.0,1,5,0,0,12,4,0,16,1,6,33,0
2424,56234,qYhoMsNGFfjRIDh2DmSOTAEOExxbLNsi,7GRhBDsirIGkRZBtSMEzNTyDr2JQm4xx,8,8,4,0,1,1,5,0,19,2.7142857142857144,1,0.0,1,4,0,1,7,1,0,5,0,6,13,1
2425,56237,PlHOy9sO4wpd56kVnMDoRd2P9dW85wrW,A3fsA9Zfv1X2fVEQhTw51lKENdNrEqT3,3,0,0,0,0,0,6,0,6,0.8571428571428571,1,0.0,0,0,0,0,0,0,0,6,0,0,6,1
2426,56242,aJc8aUAetxPPGWFRPX4YOEm2nyZUaAWd,7GRhBDsirIGkRZBtSMEzNTyDr2JQm4xx,8,12,6,4,5,0,4,0,31,4.428571428571429,1,0.0,2,6,3,5,10,0,1,4,0,16,15,1
2427,56351,9EUUO7h64xEMsIYSdMrVOb4PBS93f8Du,SpATywNh6bZuzm8s1ceuBUnMUAeoAHHw,8,4,2,0,2,0,2,0,10,1.4285714285714286,1,0.0,0,2,0,2,4,0,0,2,0,4,6,1
2428,56363,JLoCQORXjvwdLxTSzHD1j5idBdhZN6jK,7GRhBDsirIGkRZBtSMEzNTyDr2JQm4xx,5,0,0,0,0,2,7,0,9,1.2857142857142858,1,0.0,0,0,0,0,0,2,0,7,0,0,9,1
2429,56380,4GCUZawdASarA3TMg6HAfW2kyE7xYxA6,7GRhBDsirIGkRZBtSMEzNTyDr2JQm4xx,2,0,0,0,0,0,2,0,2,0.2857142857142857,1,0.0,0,0,0,0,0,0,0,2,0,0,2,1
2430,56410,m7ppZFqoqxq4drq32V7wzPII9oNFXP01,SpATywNh6bZuzm8s1ceuBUnMUAeoAHHw,14,17,10,8,4,4,5,0,48,6.857142857142857,1,0.0,2,10,8,4,15,4,0,5,0,24,24,0
2431,56464,mUGiOApqSIPNJJAxx9ku1Ubhn4j7vYNp,SpATywNh6bZuzm8s1ceuBUnMUAeoAHHw,13,37,0,11,0,27,7,0,82,11.714285714285714,2,0.0,9,0,10,0,28,27,1,7,0,19,63,0
2432,56502,YAaB5kbzMpno3yyQhEjSC43PC6r4FUut,A3fsA9Zfv1X2fVEQhTw51lKENdNrEqT3,1,0,0,0,0,0,1,0,1,0.14285714285714285,1,0.0,0,0,0,0,0,0,0,1,0,0,1,1
2433,56505,K9sZStDxVlzslbizXAYcyYp63PWAyvJs,bWdj2GDclj5ofokWjzoa5jAwMkxCykd6,10,25,11,26,9,3,8,0,82,11.714285714285714,2,0.0,7,11,23,9,18,3,3,8,0,50,32,1
2434,56507,yh14zaFitCUTgvBPqRXiaZ6cUijtktL4,7GRhBDsirIGkRZBtSMEzNTyDr2JQm4xx,5,7,0,2,0,0,1,0,10,1.4285714285714286,1,0.0,1,0,2,0,6,0,0,1,0,3,7,1
2435,56516,yreSFZev8w2vccLGmUPWniYPFTHUVYuW,SpATywNh6bZuzm8s1ceuBUnMUAeoAHHw,16,20,4,21,3,10,7,1,66,9.428571428571429,1,0.0,15,4,18,3,5,10,3,7,1,40,26,1
2436,56517,Rz28tFT5qYZaEQ78Ly3OdJx8TpvsmLBy,A3fsA9Zfv1X2fVEQhTw51lKENdNrEqT3,9,7,4,0,1,0,19,0,31,4.428571428571429,1,0.0,0,4,0,1,7,0,0,19,0,5,26,0
2437,56566,6qgQAmX6y5wh5nEPRINOiKrZNoTl5yfT,G8EPVSXsOYB5YQWZGiz1aVq5Pgr2GrQu,85,122,37,172,28,46,13,0,418,59.714285714285715,6,0.0,72,37,108,28,50,46,64,13,0,245,173,0
2438,56617,hhlID9e9RXNsuOHzHvfjbzrkpQmbpeir,SpATywNh6bZuzm8s1ceuBUnMUAeoAHHw,14,19,12,8,5,9,9,1,63,9.0,5,0.0,3,12,8,5,16,9,0,9,1,28,35,1
2439,56628,nx5QFDeL3HGj8P6Q50AF1WAJHhbCqdYM,7GRhBDsirIGkRZBtSMEzNTyDr2JQm4xx,1,0,0,0,0,0,1,0,1,0.14285714285714285,1,0.0,0,0,0,0,0,0,0,1,0,0,1,1
2440,56636,PdrdE0IIRUHKPZyUMDrlUIJ0Ny8UuZco,A3fsA9Zfv1X2fVEQhTw51lKENdNrEqT3,37,31,17,62,7,1,13,1,132,18.857142857142858,3,0.0,4,17,58,7,27,1,4,13,1,86,46,1
2441,56642,7ttzq6sOsWQ5eEpZriKP7OLuIb0DcSbF,SpATywNh6bZuzm8s1ceuBUnMUAeoAHHw,15,14,6,18,3,3,3,0,47,6.714285714285714,1,0.0,7,6,15,3,7,3,3,3,0,31,16,0
2442,56652,uHeTIz8GkglZUts3zio1tGR2aBoYwiQE,bWdj2GDclj5ofokWjzoa5jAwMkxCykd6,31,55,31,122,14,53,9,1,285,40.714285714285715,3,0.0,11,31,114,14,44,53,8,9,1,170,115,1
2443,56653,A0M3i5nfjroJ4PM9wmVXYOoLY3tY0fag,SpATywNh6bZuzm8s1ceuBUnMUAeoAHHw,5,10,3,0,1,1,1,0,16,2.2857142857142856,1,0.0,0,3,0,1,10,1,0,1,0,4,12,0
2444,56758,3X0JLX6UvJnnRb5GkwbFJgAokE5g69D0,A3fsA9Zfv1X2fVEQhTw51lKENdNrEqT3,6,8,5,0,1,0,2,0,16,2.2857142857142856,1,0.0,0,5,0,1,8,0,0,2,0,6,10,1
2445,56787,73lhhrOcE2srJj5BkIzSweWSnQRZBT2o,bWdj2GDclj5ofokWjzoa5jAwMkxCykd6,13,46,26,42,0,0,10,0,124,17.714285714285715,6,0.0,10,26,40,0,36,0,2,10,0,76,48,1
2446,56824,1NMKAl678ZBpdBkhXfYTAgEyYygMZz0x,SpATywNh6bZuzm8s1ceuBUnMUAeoAHHw,7,16,1,0,1,1,1,0,20,2.857142857142857,1,0.0,5,1,0,1,11,1,0,1,0,7,13,1
2447,56826,ilWzYGLWBh9DSc1MV8g2C4Go5wDNgUHX,A3fsA9Zfv1X2fVEQhTw51lKENdNrEqT3,16,13,12,0,12,7,4,0,48,6.857142857142857,1,0.0,0,12,0,12,13,7,0,4,0,24,24,0
2448,56867,qDignCY8ZSbFAHDmfGr6um90qnmxvInL,bWdj2GDclj5ofokWjzoa5jAwMkxCykd6,11,18,9,0,2,1,7,1,38,5.428571428571429,2,0.0,1,9,0,2,17,1,0,7,1,12,26,1
2449,56959,qZhmmNUvkNXdf3u04DTUQOFEBxxO10p4,A3fsA9Zfv1X2fVEQhTw51lKENdNrEqT3,4,2,0,0,0,0,4,0,6,0.8571428571428571,3,0.0,0,0,0,0,2,0,0,4,0,0,6,1
2450,56999,vbTgITzq6jZRj0oUV5gFotgOlwSXnjML,G8EPVSXsOYB5YQWZGiz1aVq5Pgr2GrQu,82,97,36,299,11,0,12,0,455,65.0,4,0.0,51,36,239,11,46,0,60,12,0,337,118,0
2451,57029,I7IIrHAh1LzzCf8lcvI92o8deFulzAh8,SpATywNh6bZuzm8s1ceuBUnMUAeoAHHw,2,0,0,0,0,0,2,0,2,0.2857142857142857,1,0.0,0,0,0,0,0,0,0,2,0,0,2,1
2452,57044,I7IIrHAh1LzzCf8lcvI92o8deFulzAh8,bWdj2GDclj5ofokWjzoa5jAwMkxCykd6,1,0,0,0,0,0,3,0,3,0.42857142857142855,2,0.0,0,0,0,0,0,0,0,3,0,0,3,1
2453,57196,9hgjLw4OD5u1XjZx0s9EMRnEguVXBlYy,A3fsA9Zfv1X2fVEQhTw51lKENdNrEqT3,11,5,4,0,4,0,2,0,15,2.142857142857143,1,0.0,0,4,0,4,5,0,0,2,0,8,7,1
2454,57250,3Jq0rhguTOZ7fja70sOOKUPAPqu7fQyT,SpATywNh6bZuzm8s1ceuBUnMUAeoAHHw,28,49,29,19,16,50,16,0,179,25.571428571428573,4,0.0,11,29,17,16,38,50,2,16,0,73,106,0
2455,57265,NFGYUC7dcOkWJh2BiZLJheVSucAvXvpt,bWdj2GDclj5ofokWjzoa5jAwMkxCykd6,4,2,1,0,1,0,1,0,5,0.7142857142857143,1,0.0,0,1,0,1,2,0,0,1,0,2,3,0
2456,57277,bt7h6JIDcUKzJSKeXMoVM1LEqwbXUCBJ,SpATywNh6bZuzm8s1ceuBUnMUAeoAHHw,12,48,3,14,0,1,16,0,82,11.714285714285714,3,0.0,9,3,12,0,39,1,2,16,0,24,58,0
2457,57323,xayicpjClPkwcfGTr3r84hb5pfZk0nB8,RXDvfPUBYFlVdlueBFbLW0mhhAyGEqpt,23,18,15,2,12,6,4,3,60,8.571428571428571,1,0.0,0,15,2,12,18,6,0,4,3,29,31,1
2458,57327,RdOaDfHEeBBslFA96Ipf8QaGmA7wq7Rz,SpATywNh6bZuzm8s1ceuBUnMUAeoAHHw,16,33,17,13,4,1,12,0,80,11.428571428571429,4,0.0,7,17,10,4,26,1,3,12,0,38,42,0
2459,57329,XyoP35cBUiKk44G72mbtEXCBjk8FmHfo,bWdj2GDclj5ofokWjzoa5jAwMkxCykd6,19,28,14,15,7,0,6,0,70,10.0,3,0.0,8,14,13,7,20,0,2,6,0,42,28,1
2460,57345,SmBAgHRNeYWZKP2SpqpKXwVR3YhUZnjq,SpATywNh6bZuzm8s1ceuBUnMUAeoAHHw,12,11,0,18,0,12,7,0,48,6.857142857142857,2,0.0,6,0,15,0,5,12,3,7,0,21,27,0
2461,57525,OLSxCkluLildKVrVnzRIsj47tt9tVHj9,bWdj2GDclj5ofokWjzoa5jAwMkxCykd6,2,0,0,0,0,0,2,0,2,0.2857142857142857,1,0.0,0,0,0,0,0,0,0,2,0,0,2,1
2462,57657,r4CghvxKbP3R549p5B3LTdvr7lbYRqXF,G8EPVSXsOYB5YQWZGiz1aVq5Pgr2GrQu,22,38,15,20,4,25,15,2,119,17.0,1,0.0,16,15,12,4,22,25,8,15,2,47,72,0
2463,57710,pp3MkpuoWvkyzXCuYr4td0R2Hp9mxMXr,RXDvfPUBYFlVdlueBFbLW0mhhAyGEqpt,10,10,5,0,2,1,6,0,24,3.4285714285714284,1,0.0,0,5,0,2,10,1,0,6,0,7,17,1
2464,57761,tS5yd0InBPlA0CVUCBIjrGWKHeeeibf9,A3fsA9Zfv1X2fVEQhTw51lKENdNrEqT3,29,23,11,48,3,6,9,0,100,14.285714285714286,3,0.0,4,11,45,3,19,6,3,9,0,63,37,0
2465,57907,4lfVtIfwsnJZLFeonBqOpKEgIshst3Yq,SpATywNh6bZuzm8s1ceuBUnMUAeoAHHw,5,3,2,0,2,0,3,0,10,1.4285714285714286,2,0.0,0,2,0,2,3,0,0,3,0,4,6,0
2466,57910,se9ZVl8DNkiCW8i2nP0p3krrUcQqYC47,A3fsA9Zfv1X2fVEQhTw51lKENdNrEqT3,21,14,10,0,7,2,9,0,42,6.0,3,0.0,0,10,0,7,14,2,0,9,0,17,25,0
2467,57952,Axw4HBt3l6GD2DONFf7w1tmix5Mk5VUT,A3fsA9Zfv1X2fVEQhTw51lKENdNrEqT3,13,13,6,0,2,5,10,2,38,5.428571428571429,1,0.0,0,6,0,2,13,5,0,10,2,8,30,1
2468,57987,sqasMoGc0IU5lpNZsO5KtcLYxSWllMxq,RXDvfPUBYFlVdlueBFbLW0mhhAyGEqpt,46,52,12,68,13,18,22,8,193,27.571428571428573,2,0.0,19,12,65,13,33,18,3,22,8,109,84,0
2469,58013,Bf025FfgNrlcqN8gYGnmBAhjBy0v5Xmo,bWdj2GDclj5ofokWjzoa5jAwMkxCykd6,10,45,28,0,10,1,17,0,101,14.428571428571429,3,0.0,7,28,0,10,38,1,0,17,0,45,56,1
2470,58069,nWDRtsdyQI6TNTQknsvrXkgOEaTh8I0k,SpATywNh6bZuzm8s1ceuBUnMUAeoAHHw,25,23,13,16,8,5,3,0,68,9.714285714285714,1,0.0,8,13,16,8,15,5,0,3,0,45,23,0
2471,58142,G2OV1K6QAb8ZlrDRCrLDF7tfA5J7JUDN,SpATywNh6bZuzm8s1ceuBUnMUAeoAHHw,14,20,7,22,3,2,4,0,58,8.285714285714286,1,0.0,8,7,19,3,12,2,3,4,0,37,21,1
2472,58147,GHWD27wG643ibd6OSLThLJ3MzX9fgfxx,A3fsA9Zfv1X2fVEQhTw51lKENdNrEqT3,12,6,4,0,4,0,2,0,16,2.2857142857142856,1,0.0,0,4,0,4,6,0,0,2,0,8,8,1
2473,58217,v1amutsyDOYm3WMqvptGI8JyXdvsTElC,SpATywNh6bZuzm8s1ceuBUnMUAeoAHHw,15,29,7,21,2,3,15,2,79,11.285714285714286,2,0.0,9,7,18,2,20,3,3,15,2,36,43,1
2474,58251,9irOSn8DGZwWtwp11aWu1YWsaS4jzhvZ,SpATywNh6bZuzm8s1ceuBUnMUAeoAHHw,3,2,0,0,0,0,1,0,3,0.42857142857142855,1,0.0,0,0,0,0,2,0,0,1,0,0,3,1
2475,58282,Gqs4K8SBL8tl8fMHpBqpJerrgEsieHU3,SpATywNh6bZuzm8s1ceuBUnMUAeoAHHw,20,45,4,11,1,11,14,1,87,12.428571428571429,6,0.0,9,4,11,1,36,11,0,14,1,25,62,0
2476,58305,skJn7dtfSekFrPHRHs9swZ9AtSUKi36u,A3fsA9Zfv1X2fVEQhTw51lKENdNrEqT3,10,12,9,0,2,9,8,0,40,5.714285714285714,4,0.0,0,9,0,2,12,9,0,8,0,11,29,1
2477,58334,ROctVkWGGi4RH8QWmC2p1iWZZ8pihPaJ,SpATywNh6bZuzm8s1ceuBUnMUAeoAHHw,13,27,8,22,2,14,7,0,80,11.428571428571429,4,0.0,9,8,19,2,18,14,3,7,0,38,42,0
2478,58341,MU4dVyJTD7iIRSTZIdJZ9VoLOxogfKQN,SpATywNh6bZuzm8s1ceuBUnMUAeoAHHw,10,13,8,0,1,1,8,1,32,4.571428571428571,4,0.0,1,8,0,1,12,1,0,8,1,10,22,0
2479,58348,n2LjMxx7cFpUJ3R3HfCHwCtJjfcc1KR0,G8EPVSXsOYB5YQWZGiz1aVq5Pgr2GrQu,29,41,28,36,18,2,12,0,137,19.571428571428573,4,0.0,7,28,29,18,34,2,7,12,0,82,55,0
2480,58430,Ymf9IGFQ8uCjyMPNR9dFL9vuwfZDvaPV,SpATywNh6bZuzm8s1ceuBUnMUAeoAHHw,26,92,5,33,4,104,25,1,264,37.714285714285715,6,0.0,24,5,29,4,68,104,4,25,1,62,202,0
2481,58458,fgzbUfrTxXYCuiFYTG1cTemcEJUl36an,SpATywNh6bZuzm8s1ceuBUnMUAeoAHHw,18,50,26,9,5,6,22,1,119,17.0,6,0.0,5,26,9,5,45,6,0,22,1,45,74,0
2482,58509,HRP0Ut3HnZWoD62izV4kICPH3gchormt,SpATywNh6bZuzm8s1ceuBUnMUAeoAHHw,14,10,6,2,3,0,3,0,24,3.4285714285714284,1,0.0,0,6,2,3,10,0,0,3,0,11,13,0
2483,58535,tdWhb9WfoB7e0A5Gjo7JvSpPeeCoQg77,SpATywNh6bZuzm8s1ceuBUnMUAeoAHHw,14,23,9,16,3,0,5,0,56,8.0,1,0.0,5,9,15,3,18,0,1,5,0,32,24,0
2484,58626,AsYvTZR1ylqWCh3nfRxgHS2CzZpeou5v,SpATywNh6bZuzm8s1ceuBUnMUAeoAHHw,30,57,31,33,10,20,26,3,180,25.714285714285715,4,0.0,19,31,31,10,38,20,2,26,3,91,89,0
2485,58628,BvTWqNCI5Vv3DyY42Ht6x5bgcNEbXEjw,SpATywNh6bZuzm8s1ceuBUnMUAeoAHHw,14,18,7,8,4,0,3,0,40,5.714285714285714,4,0.0,2,7,8,4,16,0,0,3,0,21,19,1
2486,58661,t8qBiDTvOvYmrxcVIErRuEOf38tywm6t,SpATywNh6bZuzm8s1ceuBUnMUAeoAHHw,20,28,19,14,5,12,9,1,88,12.571428571428571,4,0.0,3,19,11,5,25,12,3,9,1,38,50,0
2487,58724,QEq8GPuIzTapWcXcWLs8dzh5C4ugJ6qX,G8EPVSXsOYB5YQWZGiz1aVq5Pgr2GrQu,64,131,56,118,34,21,13,2,375,53.57142857142857,4,0.0,60,56,77,34,71,21,41,13,2,227,148,0
2488,58851,HcP22z9Adhad0eR6ILSXQ1kzpXBgJlCr,bWdj2GDclj5ofokWjzoa5jAwMkxCykd6,6,14,3,0,2,0,6,0,25,3.5714285714285716,4,0.0,1,3,0,2,13,0,0,6,0,6,19,1
2489,58876,KynvXtYIsEUZo4QPbGVWVhUBwzeS3e9w,SpATywNh6bZuzm8s1ceuBUnMUAeoAHHw,6,3,2,0,2,0,1,0,8,1.1428571428571428,1,0.0,0,2,0,2,3,0,0,1,0,4,4,1
2490,58922,6HIBebNSnNEoSeekVShzxF3x0IcbgohT,SpATywNh6bZuzm8s1ceuBUnMUAeoAHHw,1,0,0,0,0,0,1,0,1,0.14285714285714285,1,0.0,0,0,0,0,0,0,0,1,0,0,1,1
2491,58996,w9HBKKfn4YUOWYdwRHKe80SIWiO37ZMJ,SpATywNh6bZuzm8s1ceuBUnMUAeoAHHw,26,50,26,14,14,1,20,0,125,17.857142857142858,6,0.0,9,26,13,14,41,1,1,20,0,62,63,0
2492,58997,1zErz13s8fNQRVaEvkOtvw6bLhr23yB4,bWdj2GDclj5ofokWjzoa5jAwMkxCykd6,12,20,10,34,2,0,5,0,71,10.142857142857142,3,0.0,3,10,28,2,17,0,6,5,0,43,28,0
2493,59056,HPaDTzk2xymxbpoa0VdcxdHl3uFfOfZk,A3fsA9Zfv1X2fVEQhTw51lKENdNrEqT3,4,2,1,0,0,0,6,0,9,1.2857142857142858,3,0.0,0,1,0,0,2,0,0,6,0,1,8,1
2494,59064,gzTBwYPoQwnODJJ2vedsUKp2EoGao5Fz,A3fsA9Zfv1X2fVEQhTw51lKENdNrEqT3,1,0,0,0,0,0,2,0,2,0.2857142857142857,2,0.0,0,0,0,0,0,0,0,2,0,0,2,1
2495,59132,3LOMe6pmkiIt95Dd5LqCGi1tBreM2BMk,A3fsA9Zfv1X2fVEQhTw51lKENdNrEqT3,4,3,0,0,0,0,1,0,4,0.5714285714285714,1,0.0,0,0,0,0,3,0,0,1,0,0,4,0
2496,59137,kqS8BwWN9R1093oeblGkvtCsQJ68Gh0G,bWdj2GDclj5ofokWjzoa5jAwMkxCykd6,4,2,1,0,1,0,1,0,5,0.7142857142857143,1,0.0,0,1,0,1,2,0,0,1,0,2,3,1
2497,60203,ntJs93C1h80peQsrk4sMYD3xVOjdEHeo,7GRhBDsirIGkRZBtSMEzNTyDr2JQm4xx,65,165,44,143,42,89,16,0,499,71.28571428571429,6,0.0,110,44,131,42,55,89,12,16,0,327,172,0
2498,60420,5hts9kMf50L6rxwk0MtgECu1e5TGRRGY,7GRhBDsirIGkRZBtSMEzNTyDr2JQm4xx,10,11,3,0,2,7,4,0,27,3.857142857142857,1,0.0,5,3,0,2,6,7,0,4,0,10,17,1
2499,60546,uQUPzFXltLm3Yz8qgEvw1fMPbbS4q4MZ,7GRhBDsirIGkRZBtSMEzNTyDr2JQm4xx,4,2,1,0,1,0,2,0,6,0.8571428571428571,1,0.0,0,1,0,1,2,0,0,2,0,2,4,1
2500,61118,pGlV0XYWRjXFSIdN56x9p6AvQyXwsZVS,7GRhBDsirIGkRZBtSMEzNTyDr2JQm4xx,26,30,10,49,6,4,4,0,103,14.714285714285714,3,0.0,16,10,40,6,14,4,9,4,0,72,31,0
2501,61594,gAvRDaA2RH7LeyEqnpEQ7DzPuz3btZqk,SpATywNh6bZuzm8s1ceuBUnMUAeoAHHw,11,16,6,8,0,7,5,1,43,6.142857142857143,3,0.0,9,6,7,0,7,7,1,5,1,22,21,0
2502,61595,3rZRyyAqQR0LHT7iXSTyhR4wZI7IzOpN,SpATywNh6bZuzm8s1ceuBUnMUAeoAHHw,21,28,1,27,1,0,2,0,59,8.428571428571429,2,0.0,8,1,25,1,20,0,2,2,0,35,24,0
2503,61601,gLjUrp9o3bBy4JIhHE7DImScxZdU76o3,bWdj2GDclj5ofokWjzoa5jAwMkxCykd6,19,17,7,36,6,0,2,0,68,9.714285714285714,5,0.0,6,7,32,6,11,0,4,2,0,51,17,0
2504,61613,gF4BAuOIIfmyUL9KgVWqdIaoDpcXFfvU,SpATywNh6bZuzm8s1ceuBUnMUAeoAHHw,19,55,16,18,4,0,7,0,100,14.285714285714286,2,0.0,9,16,16,4,46,0,2,7,0,45,55,1
2505,61633,nAYvdcBZT3LBrha8JRPtv9HcsoTpFg23,SpATywNh6bZuzm8s1ceuBUnMUAeoAHHw,7,5,1,16,0,0,2,0,24,3.4285714285714284,1,0.0,2,1,14,0,3,0,2,2,0,17,7,0
2506,61645,SFn8cPDrlBEOeUqlExt2aQA0JeO7ehU8,7GRhBDsirIGkRZBtSMEzNTyDr2JQm4xx,7,3,2,0,2,0,3,0,10,1.4285714285714286,1,0.0,0,2,0,2,3,0,0,3,0,4,6,1
2507,61783,9y6ouBDNmbaFfULhDrj0DUptWL9j98bK,A3fsA9Zfv1X2fVEQhTw51lKENdNrEqT3,9,4,2,0,2,0,5,0,13,1.8571428571428572,1,0.0,0,2,0,2,4,0,0,5,0,4,9,1
2508,61786,CE534SSZ9CscDvjbZWQWNUmxhQozf8Uw,SpATywNh6bZuzm8s1ceuBUnMUAeoAHHw,16,35,20,22,6,0,4,0,87,12.428571428571429,3,0.0,11,20,17,6,24,0,5,4,0,54,33,0
2509,61807,6ewbhsgJh7NTFUpGTc6v0or3nCOYP5Dz,7GRhBDsirIGkRZBtSMEzNTyDr2JQm4xx,1,0,0,0,0,0,1,0,1,0.14285714285714285,1,0.0,0,0,0,0,0,0,0,1,0,0,1,1
2510,61841,Oqve774ifHTeH2UMCaBdRSrpGoboQSMz,7GRhBDsirIGkRZBtSMEzNTyDr2JQm4xx,2,0,0,0,0,0,2,0,2,0.2857142857142857,1,0.0,0,0,0,0,0,0,0,2,0,0,2,1
2511,61871,P3kOv3cSNYdczGGa8D095f64NMPEAkCq,7GRhBDsirIGkRZBtSMEzNTyDr2JQm4xx,13,17,1,10,0,2,10,2,42,6.0,1,0.0,6,1,8,0,11,2,2,10,2,15,27,0
2512,61873,GjYrFH6x4o6vyLHEw4EuuSJvAfuLPk1y,SpATywNh6bZuzm8s1ceuBUnMUAeoAHHw,28,37,18,30,11,0,7,0,103,14.714285714285714,2,0.0,17,18,24,11,20,0,6,7,0,70,33,0
2513,61901,kMbNfi6zi59dGBz5Mew0yipwDJ0jO4S2,7GRhBDsirIGkRZBtSMEzNTyDr2JQm4xx,34,72,31,34,32,6,15,2,192,27.428571428571427,3,0.0,31,31,29,32,41,6,5,15,2,123,69,1
2514,61902,q2vdNmhZGOp0NF57Oy2lI01Qgjw4Vdei,SpATywNh6bZuzm8s1ceuBUnMUAeoAHHw,8,10,8,0,5,0,2,0,25,3.5714285714285716,1,0.0,0,8,0,5,10,0,0,2,0,13,12,1
2515,62017,2YGBvXv59qjJLs5KOOScSmZh8Ujmphvd,7GRhBDsirIGkRZBtSMEzNTyDr2JQm4xx,7,12,5,0,1,1,2,0,21,3.0,2,0.0,4,5,0,1,8,1,0,2,0,10,11,1
2516,62027,NcracMTfiaTPMbO6SSDnt9CDc4SnvBs9,bWdj2GDclj5ofokWjzoa5jAwMkxCykd6,40,27,13,110,7,11,15,2,185,26.428571428571427,4,0.0,7,13,103,7,20,11,7,15,2,130,55,0
2517,62042,ml2yAwYHzufxZ6xJCtzUFr2eNYyPECGG,SpATywNh6bZuzm8s1ceuBUnMUAeoAHHw,22,36,19,27,8,0,3,0,93,13.285714285714286,1,0.0,14,19,24,8,22,0,3,3,0,65,28,1
2518,62069,2Hz2Bz07sxK2sow8U4zT67rsa0lMVzzp,7GRhBDsirIGkRZBtSMEzNTyDr2JQm4xx,1,0,0,0,0,0,1,0,1,0.14285714285714285,1,0.0,0,0,0,0,0,0,0,1,0,0,1,1
2519,62071,gRHI1NeWW3c6BFrZIrJSlWu9NHDjRltm,7GRhBDsirIGkRZBtSMEzNTyDr2JQm4xx,1,0,0,0,0,0,1,0,1,0.14285714285714285,1,0.0,0,0,0,0,0,0,0,1,0,0,1,1
2520,62101,uJIh67cllxQLgAhipzdDZMEunDbuBxvF,SpATywNh6bZuzm8s1ceuBUnMUAeoAHHw,25,22,16,4,7,5,8,1,63,9.0,2,0.0,3,16,4,7,19,5,0,8,1,30,33,0
2521,62128,R2cga9JVVM2tXEVs2saYswslfxAU4nMk,A3fsA9Zfv1X2fVEQhTw51lKENdNrEqT3,9,4,3,0,2,0,5,0,14,2.0,1,0.0,0,3,0,2,4,0,0,5,0,5,9,1
2522,62140,WmzYkzlMNuHgERGSMthySa2d3K7cWcp2,7GRhBDsirIGkRZBtSMEzNTyDr2JQm4xx,12,7,5,0,4,0,4,0,20,2.857142857142857,1,0.0,0,5,0,4,7,0,0,4,0,9,11,1
2523,62169,9t1Jq485XoOlmuEU542k0g35doAqmykj,SpATywNh6bZuzm8s1ceuBUnMUAeoAHHw,7,8,5,0,2,0,2,0,17,2.4285714285714284,1,0.0,0,5,0,2,8,0,0,2,0,7,10,0
2524,62213,QbN1rcT6X70kGcCCu9qHO2zQXGCyhPMc,SpATywNh6bZuzm8s1ceuBUnMUAeoAHHw,19,27,15,12,8,0,6,0,68,9.714285714285714,2,0.0,3,15,9,8,24,0,3,6,0,35,33,1
2525,62214,P9ocaJAKrVY3fEwlpYkQdiICF2x4gV0B,7GRhBDsirIGkRZBtSMEzNTyDr2JQm4xx,5,6,3,0,2,1,1,0,13,1.8571428571428572,1,0.0,1,3,0,2,5,1,0,1,0,6,7,0
2526,62334,mxPD6RdGoMu7JHsQZE9N0YGZHXBsDKre,7GRhBDsirIGkRZBtSMEzNTyDr2JQm4xx,6,1,1,0,1,0,4,0,7,1.0,1,0.0,0,1,0,1,1,0,0,4,0,2,5,1
2527,62349,YBtKAFQt6fk6EIukc4Ut5J2kdzYxomaP,SpATywNh6bZuzm8s1ceuBUnMUAeoAHHw,4,2,1,0,1,0,2,0,6,0.8571428571428571,2,0.0,0,1,0,1,2,0,0,2,0,2,4,1
2528,62356,wjS8ie6ACTxewSCQo7zpBy0tu4z4RYPD,SpATywNh6bZuzm8s1ceuBUnMUAeoAHHw,14,25,1,24,0,1,20,1,72,10.285714285714286,3,0.0,6,1,20,0,19,1,4,20,1,27,45,0
2529,62360,g1maG24WsPdpEOMuZUsxQc7SlEYHJjT4,bWdj2GDclj5ofokWjzoa5jAwMkxCykd6,6,7,3,0,2,0,3,0,15,2.142857142857143,1,0.0,2,3,0,2,5,0,0,3,0,7,8,0
2530,62368,4ct6kljhf27XSdXxxeVXKJL0lQ4aKOK7,7GRhBDsirIGkRZBtSMEzNTyDr2JQm4xx,20,43,4,10,1,0,15,0,73,10.428571428571429,3,0.0,5,4,8,1,38,0,2,15,0,18,55,1
2531,62396,jGKZSsHerE5dciVNZBuJOf3EyWVEldkX,7GRhBDsirIGkRZBtSMEzNTyDr2JQm4xx,1,0,0,0,0,0,1,0,1,0.14285714285714285,1,0.0,0,0,0,0,0,0,0,1,0,0,1,1
2532,62410,rORIPSFi0Cq6NYeD2hhC73kNxeeqmFyP,7GRhBDsirIGkRZBtSMEzNTyDr2JQm4xx,3,2,0,0,0,0,1,0,3,0.42857142857142855,1,0.0,0,0,0,0,2,0,0,1,0,0,3,1
2533,62428,Y5CSlxjOPHMFV7ik3pSpx6t0PJdYKnrH,SpATywNh6bZuzm8s1ceuBUnMUAeoAHHw,27,26,16,14,8,5,6,0,75,10.714285714285714,3,0.0,7,16,12,8,19,5,2,6,0,43,32,0
2534,62437,vhnbHBui7nCh3pAshTJ2BoFD1CEurx5q,SpATywNh6bZuzm8s1ceuBUnMUAeoAHHw,15,27,4,13,4,1,12,5,66,9.428571428571429,4,0.0,5,4,11,4,22,1,2,12,5,24,42,0
2535,62458,j8vYdYwa9gvt7hkF8dykZR2D4h75QsII,SpATywNh6bZuzm8s1ceuBUnMUAeoAHHw,24,41,17,42,4,10,11,1,126,18.0,3,0.0,19,17,36,4,22,10,6,11,1,76,50,1
2536,62484,l0WeYpTymokLlVEEJTixsYdgJaxPgZqy,7GRhBDsirIGkRZBtSMEzNTyDr2JQm4xx,2,0,0,0,0,0,2,0,2,0.2857142857142857,2,0.0,0,0,0,0,0,0,0,2,0,0,2,1
2537,62490,GWSq56qmQUucFgSgP2raEZeoKP7Athee,SpATywNh6bZuzm8s1ceuBUnMUAeoAHHw,15,71,0,17,0,8,10,1,107,15.285714285714286,4,0.0,4,0,16,0,67,8,1,10,1,20,87,0
2538,62514,ggEr2STKTwtSSUdtGCmiPr3DBu3TJ34B,A3fsA9Zfv1X2fVEQhTw51lKENdNrEqT3,7,4,1,6,0,0,1,0,12,1.7142857142857142,1,0.0,0,1,6,0,4,0,0,1,0,7,5,1
2539,62530,l7f4vHvlZkxCYoU9qM63V45bmndBSeZQ,SpATywNh6bZuzm8s1ceuBUnMUAeoAHHw,13,12,4,28,0,0,4,0,48,6.857142857142857,2,0.0,4,4,24,0,8,0,4,4,0,32,16,0
2540,62557,7FBwqoodmzhvrGGLuwBjRrxsykocUv8u,bWdj2GDclj5ofokWjzoa5jAwMkxCykd6,14,8,3,22,3,2,9,1,48,6.857142857142857,1,0.0,4,3,21,3,4,2,1,9,1,31,17,1
2541,62593,fBjkk55LEjUXpgvkPNjyZGCtR2am4TcN,SpATywNh6bZuzm8s1ceuBUnMUAeoAHHw,24,33,18,16,12,0,5,0,84,12.0,4,0.0,3,18,15,12,30,0,1,5,0,48,36,0
2542,62611,i2NIot2usiDyEsWQY7zT18X1uj2FHoWH,7GRhBDsirIGkRZBtSMEzNTyDr2JQm4xx,31,38,8,71,12,0,2,0,131,18.714285714285715,1,0.0,30,8,62,12,8,0,9,2,0,112,19,1
2543,62642,uoDWDjctsplt3HhO40cJ31SItxonwlgR,SpATywNh6bZuzm8s1ceuBUnMUAeoAHHw,8,8,3,0,2,1,3,0,17,2.4285714285714284,2,0.0,1,3,0,2,7,1,0,3,0,6,11,1
2544,62648,tUrqZSUN7RW61T1PpyF2X9YW8Ok3vUek,A3fsA9Zfv1X2fVEQhTw51lKENdNrEqT3,4,2,1,0,1,0,1,0,5,0.7142857142857143,1,0.0,0,1,0,1,2,0,0,1,0,2,3,1
2545,62655,8qABUnBBHxxZkfUhEQNUn5NNMSRrqvPC,SpATywNh6bZuzm8s1ceuBUnMUAeoAHHw,12,38,16,23,0,0,6,0,83,11.857142857142858,4,0.0,16,16,20,0,22,0,3,6,0,52,31,1
2546,62664,6rvhZ1qSfYtmyLXdh13xI1z8Ly1xy1X7,A3fsA9Zfv1X2fVEQhTw51lKENdNrEqT3,2,0,0,0,0,0,2,0,2,0.2857142857142857,1,0.0,0,0,0,0,0,0,0,2,0,0,2,1
2547,62695,N0Sos51WanCzoSGKDmMPzQtMlLxY3bFb,A3fsA9Zfv1X2fVEQhTw51lKENdNrEqT3,71,78,43,124,17,74,58,5,399,57.0,6,0.0,7,43,107,17,71,74,17,58,5,174,225,0
2548,62751,RjUWkdPtbuKazr3SZ8iaujuOx2ne7ey1,7GRhBDsirIGkRZBtSMEzNTyDr2JQm4xx,18,32,14,20,3,16,6,1,92,13.142857142857142,2,0.0,15,14,20,3,17,16,0,6,1,52,40,0
2549,62780,7lWGgkVC73zkYVnYZAzOXyCIO3N3M6br,SpATywNh6bZuzm8s1ceuBUnMUAeoAHHw,11,17,5,14,2,1,4,0,43,6.142857142857143,3,0.0,6,5,11,2,11,1,3,4,0,24,19,0
2550,62788,N24rIsVu8N2zgaIu1cFWHYg7IEXvRm7B,SpATywNh6bZuzm8s1ceuBUnMUAeoAHHw,6,3,1,0,1,0,2,0,7,1.0,1,0.0,0,1,0,1,3,0,0,2,0,2,5,0
2551,62790,wLyViiqrdSPB3KP8OihPcsmMpcPB2yFu,7GRhBDsirIGkRZBtSMEzNTyDr2JQm4xx,6,3,1,0,1,0,2,0,7,1.0,1,0.0,0,1,0,1,3,0,0,2,0,2,5,1
2552,62822,LJYBef7iIBiSZz8D7KTtMTsdkyd91gnR,7GRhBDsirIGkRZBtSMEzNTyDr2JQm4xx,1,0,0,0,0,0,1,0,1,0.14285714285714285,1,0.0,0,0,0,0,0,0,0,1,0,0,1,1
2553,62834,TfNQptQajWTQqzlzDAn72SRQxELYzNd4,SpATywNh6bZuzm8s1ceuBUnMUAeoAHHw,14,32,2,21,1,31,6,1,94,13.428571428571429,2,0.0,12,2,18,1,20,31,3,6,1,33,61,0
2554,62888,mne1Bu1F2f0U7iravmS4eQYQtLTkVvPe,7GRhBDsirIGkRZBtSMEzNTyDr2JQm4xx,1,0,0,0,0,0,1,0,1,0.14285714285714285,1,0.0,0,0,0,0,0,0,0,1,0,0,1,1
2555,62900,eS5XywA64oauZkENyWLpeVNsSbZFhj1k,7GRhBDsirIGkRZBtSMEzNTyDr2JQm4xx,4,2,1,0,1,0,1,0,5,0.7142857142857143,1,0.0,0,1,0,1,2,0,0,1,0,2,3,0
2556,62902,ukCIrv5h45nbdIEPPmMlvipT87B8fFE7,7GRhBDsirIGkRZBtSMEzNTyDr2JQm4xx,1,0,0,0,0,0,1,0,1,0.14285714285714285,1,0.0,0,0,0,0,0,0,0,1,0,0,1,1
2557,62936,l6huwkyakLvA9G4ixwxpAcJxBdbbcmJP,SpATywNh6bZuzm8s1ceuBUnMUAeoAHHw,29,47,19,35,10,4,14,1,130,18.571428571428573,4,0.0,23,19,29,10,24,4,6,14,1,81,49,0
2558,62938,eLqag6twmL6nT6SLVrpY07QGG3bytKwe,SpATywNh6bZuzm8s1ceuBUnMUAeoAHHw,10,20,3,0,2,1,11,1,38,5.428571428571429,5,0.0,0,3,0,2,20,1,0,11,1,5,33,0
2559,62970,RS564zscXajJOiW9woDtEu4M9LDaNEPd,7GRhBDsirIGkRZBtSMEzNTyDr2JQm4xx,21,24,11,0,8,0,4,0,47,6.714285714285714,3,0.0,0,11,0,8,24,0,0,4,0,19,28,1
2560,62985,SDq3f6KWdckVLJCSJxIwedwz5gfJhoTJ,SpATywNh6bZuzm8s1ceuBUnMUAeoAHHw,20,41,18,18,3,12,15,1,108,15.428571428571429,5,0.0,15,18,15,3,26,12,3,15,1,51,57,1
2561,63072,TvDWPoJyTprTu0vxto5NxLIJOfQBmxVE,7GRhBDsirIGkRZBtSMEzNTyDr2JQm4xx,38,106,3,38,6,7,18,1,179,25.571428571428573,5,0.0,23,3,30,6,83,7,8,18,1,62,117,0
2562,63124,8nlNDsWSaxHCvsMKtqhBs81sknEiTCeb,A3fsA9Zfv1X2fVEQhTw51lKENdNrEqT3,32,21,17,0,12,0,6,0,56,8.0,3,0.0,0,17,0,12,21,0,0,6,0,29,27,0
2563,63161,CcZ2EQGxkq4lhEIujCU8FZkit7DT7C79,7GRhBDsirIGkRZBtSMEzNTyDr2JQm4xx,5,0,0,0,0,0,5,1,6,0.8571428571428571,2,0.0,0,0,0,0,0,0,0,5,1,0,6,0
2564,63242,jzQypdHgDGImzo6sjFmv4z8itS7CTk6P,7GRhBDsirIGkRZBtSMEzNTyDr2JQm4xx,33,105,2,88,9,9,26,2,241,34.42857142857143,4,0.0,47,2,75,9,58,9,13,26,2,133,108,1
2565,63271,DHenWrxVzReZszxo1qw3Im0Zj99tiAII,A3fsA9Zfv1X2fVEQhTw51lKENdNrEqT3,43,26,17,56,9,22,14,1,145,20.714285714285715,5,0.0,3,17,49,9,23,22,7,14,1,78,67,0
2566,63299,HvCZ1bV9L7D0erySzp1UH1mW8tuWfYPw,7GRhBDsirIGkRZBtSMEzNTyDr2JQm4xx,32,68,21,43,12,18,10,0,172,24.571428571428573,3,0.0,24,21,34,12,44,18,9,10,0,91,81,1
2567,63317,cCSfok1u0ViZa45fCaFvMzY0bswyqxIC,7GRhBDsirIGkRZBtSMEzNTyDr2JQm4xx,1,0,0,0,0,0,1,0,1,0.14285714285714285,1,0.0,0,0,0,0,0,0,0,1,0,0,1,1
2568,63322,Q7wqVDqz10tk4xe6QnkzI1dJqMLzdK4Z,7GRhBDsirIGkRZBtSMEzNTyDr2JQm4xx,1,0,0,0,0,0,1,0,1,0.14285714285714285,1,0.0,0,0,0,0,0,0,0,1,0,0,1,0
2569,63368,UkY8GL1wnGxl65A7vEeGH2v9yDS6ABDQ,7GRhBDsirIGkRZBtSMEzNTyDr2JQm4xx,1,0,0,0,0,0,1,0,1,0.14285714285714285,1,0.0,0,0,0,0,0,0,0,1,0,0,1,1
2570,63379,jSPgiXDCISXGmLFuOlDszBfMRRboKynI,7GRhBDsirIGkRZBtSMEzNTyDr2JQm4xx,7,6,3,0,2,0,2,0,13,1.8571428571428572,2,0.0,0,3,0,2,6,0,0,2,0,5,8,1
2571,63427,OcEwAP7KVM22YlzUoPdivyTSWtkZ4qVM,7GRhBDsirIGkRZBtSMEzNTyDr2JQm4xx,2,0,0,0,0,0,5,0,5,0.7142857142857143,2,0.0,0,0,0,0,0,0,0,5,0,0,5,1
2572,63439,YPxQmDfYnmHgiT7CBa1xK3KUyMZAnQfd,7GRhBDsirIGkRZBtSMEzNTyDr2JQm4xx,10,5,3,4,3,0,2,0,17,2.4285714285714284,1,0.0,1,3,4,3,4,0,0,2,0,11,6,1
2573,63461,4TtGjmtd4ISORDD5okRgx7kXAcGUW8IN,7GRhBDsirIGkRZBtSMEzNTyDr2JQm4xx,21,30,14,8,9,0,15,0,76,10.857142857142858,6,0.0,12,14,6,9,18,0,2,15,0,41,35,0
2574,63529,DPNeCmHDELHrss8mkRKEcvkApu8OfWuh,7GRhBDsirIGkRZBtSMEzNTyDr2JQm4xx,6,3,2,0,2,0,1,0,8,1.1428571428571428,1,0.0,0,2,0,2,3,0,0,1,0,4,4,1
2575,63565,AumBArZbFsuZrJ22dCd66gJYrxhP9K8S,7GRhBDsirIGkRZBtSMEzNTyDr2JQm4xx,6,2,1,0,1,0,4,0,8,1.1428571428571428,1,0.0,0,1,0,1,2,0,0,4,0,2,6,1
2576,63568,ibHntt3xSwry6DyouiN0fYSmzCgepI7L,7GRhBDsirIGkRZBtSMEzNTyDr2JQm4xx,5,2,1,0,1,0,2,0,6,0.8571428571428571,1,0.0,0,1,0,1,2,0,0,2,0,2,4,1
2577,63569,oioEx16Qafdl8cwDYVMh95PwtEgk5wrw,7GRhBDsirIGkRZBtSMEzNTyDr2JQm4xx,6,7,0,7,0,0,2,0,16,2.2857142857142856,1,0.0,1,0,6,0,6,0,1,2,0,7,9,1
2578,63602,d0OQm2fl37nUvfl8Q7XxAwON3v0i0KHs,7GRhBDsirIGkRZBtSMEzNTyDr2JQm4xx,1,0,0,0,0,0,1,0,1,0.14285714285714285,1,0.0,0,0,0,0,0,0,0,1,0,0,1,1
2579,63687,dtbXtMjPqeEvzoZBFe2y9uSDcjL0lnx2,A3fsA9Zfv1X2fVEQhTw51lKENdNrEqT3,30,98,35,8,24,18,26,1,210,30.0,4,0.0,2,35,6,24,96,18,2,26,1,67,143,0
2580,63698,uA8SH3KKGTykRcaxzO63OBZZtTvabLlI,7GRhBDsirIGkRZBtSMEzNTyDr2JQm4xx,7,3,1,0,1,0,3,0,8,1.1428571428571428,1,0.0,0,1,0,1,3,0,0,3,0,2,6,1
2581,63703,GulRMWFcPY5JE8HNbJPRyRdVqJqL2eEA,A3fsA9Zfv1X2fVEQhTw51lKENdNrEqT3,6,2,0,0,0,0,5,0,7,1.0,1,0.0,0,0,0,0,2,0,0,5,0,0,7,0
2582,63880,4RiemE5r88jWq9gaL0lVYzjeUhWq3sNP,7GRhBDsirIGkRZBtSMEzNTyDr2JQm4xx,2,0,0,0,0,0,3,0,3,0.42857142857142855,1,0.0,0,0,0,0,0,0,0,3,0,0,3,1
2583,63903,4RiemE5r88jWq9gaL0lVYzjeUhWq3sNP,A3fsA9Zfv1X2fVEQhTw51lKENdNrEqT3,9,4,3,0,3,0,2,0,12,1.7142857142857142,1,0.0,0,3,0,3,4,0,0,2,0,6,6,1
2584,63975,vSoHqjlgOX9Gp12iQzdBUtqEoI4dyxq9,7GRhBDsirIGkRZBtSMEzNTyDr2JQm4xx,1,0,0,0,0,0,1,0,1,0.14285714285714285,1,0.0,0,0,0,0,0,0,0,1,0,0,1,1
2585,63986,kYf958xQgpYsrp0Tv3pEoO2XCYRj674R,7GRhBDsirIGkRZBtSMEzNTyDr2JQm4xx,7,3,2,0,0,1,6,1,13,1.8571428571428572,1,0.0,0,2,0,0,3,1,0,6,1,2,11,1
2586,64056,dpaGOQqV12WO7eNeCUpu7DUPmdhwuEC5,7GRhBDsirIGkRZBtSMEzNTyDr2JQm4xx,1,0,0,0,0,0,1,0,1,0.14285714285714285,1,0.0,0,0,0,0,0,0,0,1,0,0,1,1
2587,64152,e6qJWnBH5Aakpza4HlA3Q0irc2hEFZ0M,7GRhBDsirIGkRZBtSMEzNTyDr2JQm4xx,1,0,0,0,0,0,1,0,1,0.14285714285714285,1,0.0,0,0,0,0,0,0,0,1,0,0,1,1
2588,65718,aPDsc8X2fcDutxzM0D9vmuKFKeVLb7iC,7GRhBDsirIGkRZBtSMEzNTyDr2JQm4xx,6,8,1,6,3,0,4,0,22,3.142857142857143,1,0.0,4,1,5,3,4,0,1,4,0,13,9,1
2589,65754,d7lqWAJ8cu1e9f8Lb1eNhG3YSdhF0Qy7,7GRhBDsirIGkRZBtSMEzNTyDr2JQm4xx,34,105,40,46,21,30,37,3,282,40.285714285714285,4,0.0,54,40,39,21,51,30,7,37,3,154,128,1
2590,66544,GsuSgvyvG4oCfnW3UaGKEeHZUImW7ybU,SpATywNh6bZuzm8s1ceuBUnMUAeoAHHw,12,30,4,13,3,1,6,0,57,8.142857142857142,4,0.0,9,4,12,3,21,1,1,6,0,28,29,1
2591,66553,X1KDcg6FJGcjALhOEz460JY2SzJ27Ewm,RXDvfPUBYFlVdlueBFbLW0mhhAyGEqpt,18,24,9,16,4,0,28,0,81,11.571428571428571,3,0.0,6,9,16,4,18,0,0,28,0,35,46,1
2592,66554,alnogGpZqhBWQHh6ZLeZUIXk896ksLOu,bWdj2GDclj5ofokWjzoa5jAwMkxCykd6,17,33,3,108,2,2,20,1,169,24.142857142857142,3,0.0,9,3,105,2,24,2,3,20,1,119,50,1
2593,66562,RbUxQb46RHLKt8MRdcRI6KFNQeGEWd4E,bWdj2GDclj5ofokWjzoa5jAwMkxCykd6,12,4,3,0,3,10,7,1,28,4.0,2,0.0,0,3,0,3,4,10,0,7,1,6,22,1
2594,66566,6PpQXjJomANl40NJZt5It7FhFUddOBZF,SpATywNh6bZuzm8s1ceuBUnMUAeoAHHw,16,19,8,12,3,23,7,1,73,10.428571428571429,2,0.0,6,8,9,3,13,23,3,7,1,26,47,1
2595,66567,Z5BNOGX3uaOaDJtXljja6tBV5seZD36x,SpATywNh6bZuzm8s1ceuBUnMUAeoAHHw,6,4,3,0,2,0,2,0,11,1.5714285714285714,1,0.0,0,3,0,2,4,0,0,2,0,5,6,1
2596,66572,IaHdA1JSOZlnXxW2Ea0M59RXapC6MjXI,SpATywNh6bZuzm8s1ceuBUnMUAeoAHHw,12,70,9,23,1,37,16,3,159,22.714285714285715,3,0.0,56,9,21,1,14,37,2,16,3,87,72,0
2597,66573,ES3MJj3KCIAnVbhhUwdNjoq2AG6ouBZT,SpATywNh6bZuzm8s1ceuBUnMUAeoAHHw,10,9,4,0,3,8,3,0,27,3.857142857142857,2,0.0,0,4,0,3,9,8,0,3,0,7,20,1
2598,66574,PizUKf6mRUas66X3VMYXf9aygnN1CUCf,RXDvfPUBYFlVdlueBFbLW0mhhAyGEqpt,27,31,22,0,10,11,8,3,85,12.142857142857142,1,0.0,3,22,0,10,28,11,0,8,3,35,50,1
2599,66583,L3sYIZrtCe33arrsIgJGTKImw4yL48kj,G8EPVSXsOYB5YQWZGiz1aVq5Pgr2GrQu,13,10,6,0,4,0,5,0,25,3.5714285714285716,2,0.0,0,6,0,4,10,0,0,5,0,10,15,0
2600,66584,ZRcEnEYSSBQbkjzMu7sidjbxasfrmw8l,RXDvfPUBYFlVdlueBFbLW0mhhAyGEqpt,24,42,21,31,2,2,8,0,106,15.142857142857142,4,0.0,5,21,29,2,37,2,2,8,0,57,49,1
2601,66587,Jag1EXQWfAuTRiCgcVLyhRRkdOL9RtSD,bWdj2GDclj5ofokWjzoa5jAwMkxCykd6,13,13,9,68,6,2,8,0,106,15.142857142857142,2,0.0,1,9,67,6,12,2,1,8,0,83,23,1
2602,66591,9EN3Z35raOUcrGDeovMj0gdxUNnPCeKU,SpATywNh6bZuzm8s1ceuBUnMUAeoAHHw,3,2,0,0,0,0,2,0,4,0.5714285714285714,1,0.0,0,0,0,0,2,0,0,2,0,0,4,1
2603,66598,nLUyFOoii85Kc6SiGICnU7SPdHRw1h9a,SpATywNh6bZuzm8s1ceuBUnMUAeoAHHw,9,5,2,0,1,15,5,3,31,4.428571428571429,1,0.0,2,2,0,1,3,15,0,5,3,5,26,1
2604,66605,XUPBJ1mitGxAzzRukKqjQOzBGJw166yc,G8EPVSXsOYB5YQWZGiz1aVq5Pgr2GrQu,10,6,5,0,4,0,3,0,18,2.5714285714285716,2,0.0,0,5,0,4,6,0,0,3,0,9,9,1
2605,66615,fxrAFCrsLimQV1XJURgnMX9KS4WUkexG,G8EPVSXsOYB5YQWZGiz1aVq5Pgr2GrQu,14,5,4,28,3,0,3,0,43,6.142857142857143,1,0.0,0,4,25,3,5,0,3,3,0,32,11,1
2606,66616,aQkZtyhfWM4x1GodnKorBxGkYsdqjpct,G8EPVSXsOYB5YQWZGiz1aVq5Pgr2GrQu,26,26,17,0,12,1,7,0,63,9.0,4,0.0,0,17,0,12,26,1,0,7,0,29,34,1
2607,66617,bXR5OQsnMadJ3r7Y5b33xdbV7KcP5Zyw,bWdj2GDclj5ofokWjzoa5jAwMkxCykd6,8,9,6,0,5,0,3,0,23,3.2857142857142856,2,0.0,1,6,0,5,8,0,0,3,0,12,11,1
2608,66618,wyLapvNSkzqLsQoXZV3N6mjrWCECacth,RXDvfPUBYFlVdlueBFbLW0mhhAyGEqpt,49,44,24,101,16,8,8,0,201,28.714285714285715,3,0.0,13,24,95,16,31,8,6,8,0,148,53,1
2609,66621,5TeLMYHqzQAKUmQpWnvEv2hxOy9X1UKJ,SpATywNh6bZuzm8s1ceuBUnMUAeoAHHw,18,36,19,22,5,7,15,3,107,15.285714285714286,3,0.0,11,19,17,5,25,7,5,15,3,52,55,1
2610,66635,8fOucDZ8PgruKfhbtaGML7zYng8oMl2j,SpATywNh6bZuzm8s1ceuBUnMUAeoAHHw,5,2,1,0,1,0,3,0,7,1.0,1,0.0,0,1,0,1,2,0,0,3,0,2,5,1
2611,66637,ddHByaCLR2ByNnOPbXOAqZ6eqJzLVO7n,bWdj2GDclj5ofokWjzoa5jAwMkxCykd6,5,3,1,0,1,0,4,0,9,1.2857142857142858,1,0.0,0,1,0,1,3,0,0,4,0,2,7,1
2612,66644,102hMvC6gN7rty2ashlvDMHaB3ep6GZh,SpATywNh6bZuzm8s1ceuBUnMUAeoAHHw,15,46,2,27,1,12,14,2,104,14.857142857142858,2,0.0,18,2,21,1,28,12,6,14,2,42,62,1
2613,66646,qZhmmNUvkNXdf3u04DTUQOFEBxxO10p4,G8EPVSXsOYB5YQWZGiz1aVq5Pgr2GrQu,101,106,42,226,23,0,13,1,411,58.714285714285715,5,0.0,39,42,176,23,67,0,50,13,1,280,131,1
2614,66650,j8DEcgUENzfnfHONFl2IMtBsrYZzGv40,bWdj2GDclj5ofokWjzoa5jAwMkxCykd6,8,4,2,42,1,0,2,0,51,7.285714285714286,1,0.0,2,2,41,1,2,0,1,2,0,46,5,1
2615,66654,AA7aVbrpQJ2zUau6VJLFiC8rutvLHi1m,bWdj2GDclj5ofokWjzoa5jAwMkxCykd6,7,17,4,0,0,1,6,0,28,4.0,1,0.0,0,4,0,0,17,1,0,6,0,4,24,1
2616,66657,bpLyNpLNqZrg4X6eObo787HrocrHo6XF,RXDvfPUBYFlVdlueBFbLW0mhhAyGEqpt,7,4,1,0,1,0,2,0,8,1.1428571428571428,1,0.0,0,1,0,1,4,0,0,2,0,2,6,1
2617,66658,NiYgf1FsQGPvHpxeTQuDCV5yUQ8cmKec,SpATywNh6bZuzm8s1ceuBUnMUAeoAHHw,1,0,0,0,0,0,1,0,1,0.14285714285714285,1,0.0,0,0,0,0,0,0,0,1,0,0,1,1
2618,66662,GHjtRW2SWnsNCYGrWfNWjwqhAcWXggqC,G8EPVSXsOYB5YQWZGiz1aVq5Pgr2GrQu,31,37,3,70,1,5,4,0,120,17.142857142857142,1,0.0,16,3,52,1,21,5,18,4,0,72,48,1
2619,66664,WpYtemwKZQxcuLGpndx0lQojfh6o5GOv,RXDvfPUBYFlVdlueBFbLW0mhhAyGEqpt,11,7,1,0,1,3,7,1,20,2.857142857142857,2,0.0,0,1,0,1,7,3,0,7,1,2,18,1
2620,66677,O65XWOLgEMKBGdUDD3HXTmDvI5lmhsk8,SpATywNh6bZuzm8s1ceuBUnMUAeoAHHw,8,7,4,0,1,0,6,0,18,2.5714285714285716,2,0.0,0,4,0,1,7,0,0,6,0,5,13,1
2621,66688,ehuVxu7A35eDUFqKYYT7us9o7kymvupC,SpATywNh6bZuzm8s1ceuBUnMUAeoAHHw,8,6,4,0,4,0,6,1,21,3.0,2,0.0,1,4,0,4,5,0,0,6,1,9,12,1
2622,66691,4X8SsO11KgTMY23mHrkIQxUJcM5ft92O,SpATywNh6bZuzm8s1ceuBUnMUAeoAHHw,6,3,2,0,2,0,2,0,9,1.2857142857142858,1,0.0,0,2,0,2,3,0,0,2,0,4,5,1
2623,66695,9hMYmYnY4O2N6jg4p4MNxwDczZbVqp3T,RXDvfPUBYFlVdlueBFbLW0mhhAyGEqpt,24,29,21,0,14,0,7,1,72,10.285714285714286,4,0.0,2,21,0,14,27,0,0,7,1,37,35,1
2624,66703,pdhviBPVRpP6jkLxXzSmGnBMX5GRwslr,SpATywNh6bZuzm8s1ceuBUnMUAeoAHHw,9,24,13,0,0,1,12,0,50,7.142857142857143,1,0.0,0,13,0,0,24,1,0,12,0,13,37,1
2625,66704,DAjbimE4V5oFXI5ZD4kyBHNztDPF7CGC,G8EPVSXsOYB5YQWZGiz1aVq5Pgr2GrQu,5,4,1,0,2,0,3,0,10,1.4285714285714286,2,0.0,2,1,0,2,2,0,0,3,0,5,5,1
2626,66711,VS8f8oTxWcbwLqrK393hBZWMoBFa1gFJ,SpATywNh6bZuzm8s1ceuBUnMUAeoAHHw,18,26,12,20,4,2,20,1,85,12.142857142857142,4,0.0,8,12,16,4,18,2,4,20,1,40,45,0
2627,66713,LMGbvXS3ZBgtTcKCRLMcqBHrfADBxwXe,G8EPVSXsOYB5YQWZGiz1aVq5Pgr2GrQu,14,28,12,0,3,18,14,0,75,10.714285714285714,4,0.0,5,12,0,3,23,18,0,14,0,20,55,0
2628,66730,BaoCwxmOrD7InrgOrpoiCi2VVkCIKJfh,SpATywNh6bZuzm8s1ceuBUnMUAeoAHHw,17,24,6,20,3,3,12,1,69,9.857142857142858,2,0.0,16,6,17,3,8,3,3,12,1,42,27,1
2629,66732,e4qTXKc7Qs1Hoa2gaTnt5MCSxqsevbSQ,SpATywNh6bZuzm8s1ceuBUnMUAeoAHHw,1,0,0,0,0,0,1,0,1,0.14285714285714285,1,0.0,0,0,0,0,0,0,0,1,0,0,1,1
2630,66745,qt9pojYUdSU9dxSioMDEso1f0UH6has1,SpATywNh6bZuzm8s1ceuBUnMUAeoAHHw,21,49,18,20,5,1,7,0,100,14.285714285714286,4,0.0,9,18,17,5,40,1,3,7,0,49,51,1
2631,66747,p2gF3LN3ZgatpYPMj263kKzwr7f9hjKm,SpATywNh6bZuzm8s1ceuBUnMUAeoAHHw,4,1,0,0,0,0,6,0,7,1.0,1,0.0,0,0,0,0,1,0,0,6,0,0,7,0
2632,66756,aR3fk0CNwd9ygarvr0BOVu5p8WeU32I1,SpATywNh6bZuzm8s1ceuBUnMUAeoAHHw,17,21,7,10,4,9,8,1,60,8.571428571428571,2,0.0,11,7,9,4,10,9,1,8,1,31,29,1
2633,66776,1bINdBCm1VS5Qjqh6m0QvNj7bfNPAIxT,bWdj2GDclj5ofokWjzoa5jAwMkxCykd6,2,0,0,0,0,0,2,0,2,0.2857142857142857,2,0.0,0,0,0,0,0,0,0,2,0,0,2,1
2634,66778,c7cZPwJhMtLXXFSxYHM0ztf18Qe267SR,SpATywNh6bZuzm8s1ceuBUnMUAeoAHHw,11,16,9,0,7,0,3,0,35,5.0,2,0.0,1,9,0,7,15,0,0,3,0,17,18,1
2635,66779,r8TxqoZCuxs9o8OQbbHm8IWDrVmolNmN,SpATywNh6bZuzm8s1ceuBUnMUAeoAHHw,1,0,0,0,0,0,1,0,1,0.14285714285714285,1,0.0,0,0,0,0,0,0,0,1,0,0,1,1
2636,66780,OnyZH4F3oW4crdu4EYjgcCg5L4Cq5yIA,bWdj2GDclj5ofokWjzoa5jAwMkxCykd6,5,9,1,0,0,0,4,0,14,2.0,1,0.0,0,1,0,0,9,0,0,4,0,1,13,1
2637,66789,5ZyvCd3AP7a8azCiLN5JfLAP53iZpAyD,SpATywNh6bZuzm8s1ceuBUnMUAeoAHHw,3,0,0,0,0,0,6,0,6,0.8571428571428571,2,0.0,0,0,0,0,0,0,0,6,0,0,6,0
2638,66804,AlgEd5IzXHm0JGTUI9jbrnVeF8FATpV3,bWdj2GDclj5ofokWjzoa5jAwMkxCykd6,13,12,7,48,3,4,5,0,79,11.285714285714286,1,0.0,4,7,48,3,8,4,0,5,0,62,17,1
2639,66806,Qo1OAp8GglCOhKICbcJQhmG7Ih2RNYzD,SpATywNh6bZuzm8s1ceuBUnMUAeoAHHw,12,14,5,0,3,0,24,0,46,6.571428571428571,2,0.0,4,5,0,3,10,0,0,24,0,12,34,1
2640,66808,WMHcQA8MVYUjJWAMAB6fugsBuCZpVoIb,SpATywNh6bZuzm8s1ceuBUnMUAeoAHHw,14,22,6,13,2,9,14,4,70,10.0,1,0.0,16,6,12,2,6,9,1,14,4,36,34,1
2641,66810,nNPKgGT2Dns3AcXj6vzeFxTea7ZZLJPg,G8EPVSXsOYB5YQWZGiz1aVq5Pgr2GrQu,27,12,11,0,10,12,6,1,52,7.428571428571429,1,0.0,0,11,0,10,12,12,0,6,1,21,31,1
2642,66813,jtvqYfTt0YMo9BknX2A672jXhl21ashI,SpATywNh6bZuzm8s1ceuBUnMUAeoAHHw,7,5,1,0,1,0,1,0,8,1.1428571428571428,1,0.0,0,1,0,1,5,0,0,1,0,2,6,1
2643,66820,MvNnLQma2eBM9bCcMIR159XYSNp8VREs,bWdj2GDclj5ofokWjzoa5jAwMkxCykd6,6,2,1,0,1,1,6,0,11,1.5714285714285714,3,0.0,0,1,0,1,2,1,0,6,0,2,9,1
2644,66828,U0qAQ57V9wygm6bDtrNRCaS95QeQ2J6g,G8EPVSXsOYB5YQWZGiz1aVq5Pgr2GrQu,31,56,30,0,17,4,18,2,127,18.142857142857142,3,0.0,13,30,0,17,43,4,0,18,2,60,67,1
2645,66844,zPWIhn8QAXkwvZr0vXSWUOjtKdeOxnx0,SpATywNh6bZuzm8s1ceuBUnMUAeoAHHw,4,4,0,0,0,0,2,0,6,0.8571428571428571,1,0.0,0,0,0,0,4,0,0,2,0,0,6,1
2646,66854,9uGUU0TH4lqYEkuGLK9jp9MwW0oSvGiG,SpATywNh6bZuzm8s1ceuBUnMUAeoAHHw,1,0,0,0,0,0,1,0,1,0.14285714285714285,1,0.0,0,0,0,0,0,0,0,1,0,0,1,1
2647,66859,YD54LiXoRcgp9TgUQFqtUoAuCL64ULEG,RXDvfPUBYFlVdlueBFbLW0mhhAyGEqpt,1,0,0,0,0,0,1,0,1,0.14285714285714285,1,0.0,0,0,0,0,0,0,0,1,0,0,1,1
2648,66862,grxgFxuiaSTlMIk1kWcHwbLAYZVnIvkA,RXDvfPUBYFlVdlueBFbLW0mhhAyGEqpt,7,5,1,0,1,0,3,0,10,1.4285714285714286,1,0.0,0,1,0,1,5,0,0,3,0,2,8,1
2649,66871,TkGLgRow1Lh4XUIZJk3PPt8KzHEZuW9e,SpATywNh6bZuzm8s1ceuBUnMUAeoAHHw,12,12,8,1,7,0,4,0,32,4.571428571428571,2,0.0,2,8,1,7,10,0,0,4,0,18,14,1
2650,66878,9uGUU0TH4lqYEkuGLK9jp9MwW0oSvGiG,bWdj2GDclj5ofokWjzoa5jAwMkxCykd6,1,0,0,0,0,0,1,0,1,0.14285714285714285,1,0.0,0,0,0,0,0,0,0,1,0,0,1,1
2651,66880,tBWD1VTj6Jcj3AQ0AXY8eZtUzkjmoiNH,bWdj2GDclj5ofokWjzoa5jAwMkxCykd6,9,12,5,14,1,8,10,0,50,7.142857142857143,2,0.0,1,5,13,1,11,8,1,10,0,20,30,1
2652,66893,HBNOGDmQrCA8ZCNHwMOm4mGR9448iscJ,SpATywNh6bZuzm8s1ceuBUnMUAeoAHHw,6,2,0,0,0,0,13,0,15,2.142857142857143,3,0.0,0,0,0,0,2,0,0,13,0,0,15,0
2653,66900,SOap4GRyA4qmYvVJbfGh1nFSvLnlIhQw,SpATywNh6bZuzm8s1ceuBUnMUAeoAHHw,13,13,8,0,6,2,9,1,39,5.571428571428571,2,0.0,1,8,0,6,12,2,0,9,1,15,24,1
2654,66911,n0HFF3TwqKuBMzzkdLCbvb8Mji5ZUnVX,RXDvfPUBYFlVdlueBFbLW0mhhAyGEqpt,7,6,3,0,2,0,2,0,13,1.8571428571428572,2,0.0,0,3,0,2,6,0,0,2,0,5,8,1
2655,66922,wEaTyOJwwvOCk7eUttQISK5WPXL7ANNV,RXDvfPUBYFlVdlueBFbLW0mhhAyGEqpt,5,11,1,0,0,0,4,0,16,2.2857142857142856,3,0.0,1,1,0,0,10,0,0,4,0,2,14,0
2656,66928,UnlpBoCCKa1g59dweQPJmefdPMpfSVLe,G8EPVSXsOYB5YQWZGiz1aVq5Pgr2GrQu,50,99,42,102,28,21,13,1,306,43.714285714285715,6,0.0,36,42,61,28,63,21,41,13,1,167,139,1
2657,66937,LYK1SCUULDZfFbUf8SQuy4cGJ6KDov7Z,G8EPVSXsOYB5YQWZGiz1aVq5Pgr2GrQu,13,8,4,0,2,2,15,2,33,4.714285714285714,3,0.0,0,4,0,2,8,2,0,15,2,6,27,1
2658,66938,mLUKkahZJn2S9K7hZVXpun7HflxZlNfK,RXDvfPUBYFlVdlueBFbLW0mhhAyGEqpt,36,49,3,98,3,0,3,0,156,22.285714285714285,2,0.0,15,3,91,3,34,0,7,3,0,112,44,1
2659,66947,8OfBrECVDzmqJABpw3ayApk0DiWDa3gF,SpATywNh6bZuzm8s1ceuBUnMUAeoAHHw,1,0,0,0,0,0,1,0,1,0.14285714285714285,1,0.0,0,0,0,0,0,0,0,1,0,0,1,1
2660,66948,ylHVd8NK0xyUeGJijtfFcdu7sSX07hsS,SpATywNh6bZuzm8s1ceuBUnMUAeoAHHw,16,15,2,8,1,1,11,3,41,5.857142857142857,3,0.0,2,2,8,1,13,1,0,11,3,13,28,1
2661,66959,wpRLL3XDggpsn9xMAH6hM6LGULXpz3ki,SpATywNh6bZuzm8s1ceuBUnMUAeoAHHw,3,2,0,0,0,0,2,0,4,0.5714285714285714,1,0.0,0,0,0,0,2,0,0,2,0,0,4,1
2662,66965,FXFJNl5vYMfodb6wUkei0GFkJtJALVJo,SpATywNh6bZuzm8s1ceuBUnMUAeoAHHw,1,0,0,0,0,0,2,0,2,0.2857142857142857,1,0.0,0,0,0,0,0,0,0,2,0,0,2,1
2663,66967,TZMHSuVEUzvE9F9oFUPDubVVCOh0OUwA,SpATywNh6bZuzm8s1ceuBUnMUAeoAHHw,6,7,3,0,2,0,3,0,15,2.142857142857143,2,0.0,0,3,0,2,7,0,0,3,0,5,10,1
2664,66972,4mxqWsjuug2blsnsk9e2hDH5ZKMeIfme,SpATywNh6bZuzm8s1ceuBUnMUAeoAHHw,19,33,12,24,5,1,13,2,90,12.857142857142858,3,0.0,17,12,20,5,16,1,4,13,2,54,36,1
2665,66981,ApSfmGvydhCGgdp1GU2OyiUFr43yEuYJ,RXDvfPUBYFlVdlueBFbLW0mhhAyGEqpt,9,11,6,0,2,0,5,3,27,3.857142857142857,1,0.0,1,6,0,2,10,0,0,5,3,9,18,1
2666,66983,e7lti3fBvO8XZNtS4I7hMo5JFh6PqMCH,SpATywNh6bZuzm8s1ceuBUnMUAeoAHHw,9,6,0,0,0,1,8,1,16,2.2857142857142856,2,0.0,0,0,0,0,6,1,0,8,1,0,16,1
2667,66991,c5MkJ205AcjWsm07YpOktUEc4lrC6DvN,bWdj2GDclj5ofokWjzoa5jAwMkxCykd6,4,3,0,0,0,0,4,0,7,1.0,2,0.0,0,0,0,0,3,0,0,4,0,0,7,1
2668,66995,RE0yxLQPG2DsKP2fVObFsaZxTyIGWyd9,SpATywNh6bZuzm8s1ceuBUnMUAeoAHHw,1,0,0,0,0,0,1,0,1,0.14285714285714285,1,0.0,0,0,0,0,0,0,0,1,0,0,1,1
2669,67003,jK7giBjce5DH7ZDYgKKwuLGFjg8bBMY3,SpATywNh6bZuzm8s1ceuBUnMUAeoAHHw,1,0,0,0,0,0,1,0,1,0.14285714285714285,1,0.0,0,0,0,0,0,0,0,1,0,0,1,1
2670,67017,R8e7xg0PB3WHpeFUd7XjboUcUmtjBoqn,G8EPVSXsOYB5YQWZGiz1aVq5Pgr2GrQu,57,50,12,162,10,2,3,0,239,34.142857142857146,3,0.0,35,12,123,10,15,2,39,3,0,180,59,1
2671,67020,jWJjb2ULtCbg7TxaVgejXvNjReg1rWMJ,SpATywNh6bZuzm8s1ceuBUnMUAeoAHHw,7,5,0,0,0,0,15,0,20,2.857142857142857,3,0.0,0,0,0,0,5,0,0,15,0,0,20,1
2672,67027,a1PUZwDv53lPTEF9hvk5ypoKBKNjAetJ,SpATywNh6bZuzm8s1ceuBUnMUAeoAHHw,1,0,0,0,0,0,1,0,1,0.14285714285714285,1,0.0,0,0,0,0,0,0,0,1,0,0,1,1
2673,67028,Up0SfqXbbz6NGY2S4ku6GM2FOwYrzCdN,G8EPVSXsOYB5YQWZGiz1aVq5Pgr2GrQu,17,25,9,56,5,5,6,1,107,15.285714285714286,1,0.0,15,9,44,5,10,5,12,6,1,73,34,1
2674,67031,bhM1l0w4WfwmiUZ8JL3hioN6rh1txoNY,G8EPVSXsOYB5YQWZGiz1aVq5Pgr2GrQu,1,0,0,0,0,0,1,0,1,0.14285714285714285,1,0.0,0,0,0,0,0,0,0,1,0,0,1,1
2675,67032,YLfjSoU2JNGG7f9SEbr83b8mp8z1n7i3,SpATywNh6bZuzm8s1ceuBUnMUAeoAHHw,5,3,2,0,1,0,2,0,8,1.1428571428571428,1,0.0,0,2,0,1,3,0,0,2,0,3,5,1
2676,67057,YGm3RWWdh53qv43WofC48V9ZiIjgJjMn,bWdj2GDclj5ofokWjzoa5jAwMkxCykd6,7,13,6,6,2,0,5,0,32,4.571428571428571,1,0.0,1,6,5,2,12,0,1,5,0,14,18,0
2677,67062,lsez2NExtDzqmHTj1WxlkldAKydbGpGz,SpATywNh6bZuzm8s1ceuBUnMUAeoAHHw,24,27,8,20,4,0,6,0,65,9.285714285714286,5,0.0,6,8,19,4,21,0,1,6,0,37,28,0
2678,67064,rgWDWnR8cl7dIVcqtFoTnaVoLEy1VLxc,SpATywNh6bZuzm8s1ceuBUnMUAeoAHHw,8,12,4,0,2,0,3,0,21,3.0,3,0.0,0,4,0,2,12,0,0,3,0,6,15,1
2679,67084,t2CefH6ir3GuQXTz3Lok7bxtMew2Evw7,RXDvfPUBYFlVdlueBFbLW0mhhAyGEqpt,19,19,15,0,10,0,10,4,58,8.285714285714286,3,0.0,0,15,0,10,19,0,0,10,4,25,33,1
2680,67088,k6QLpQDqSxoScgN883dLN4OsoeXNCHXO,RXDvfPUBYFlVdlueBFbLW0mhhAyGEqpt,47,56,29,123,15,2,4,0,229,32.714285714285715,2,0.0,18,29,115,15,38,2,8,4,0,177,52,0
2681,67089,JrNueBhmifdFgGWHM8aWG8EzCwr3tqQr,SpATywNh6bZuzm8s1ceuBUnMUAeoAHHw,14,33,11,21,5,0,2,0,72,10.285714285714286,1,0.0,18,11,18,5,15,0,3,2,0,52,20,1
2682,67100,zpsnILpURwXmIVlozwqgT5YIvGr5WOxX,bWdj2GDclj5ofokWjzoa5jAwMkxCykd6,13,18,1,58,1,0,13,0,91,13.0,4,0.0,6,1,54,1,12,0,4,13,0,62,29,1
2683,67101,a3HtyjZsIXy0rlfdz7IVbfqFoPB13M3i,SpATywNh6bZuzm8s1ceuBUnMUAeoAHHw,10,24,1,11,0,0,2,0,38,5.428571428571429,2,0.0,2,1,11,0,22,0,0,2,0,14,24,1
2684,67108,37B6M9S02XwjLkdM8Uyceavdi8PgXeFK,SpATywNh6bZuzm8s1ceuBUnMUAeoAHHw,7,6,0,0,0,3,4,1,14,2.0,1,0.0,1,0,0,0,5,3,0,4,1,1,13,1
2685,67109,MoirjNgz2xCcf95deN6TNEo1dg7pa7Td,RXDvfPUBYFlVdlueBFbLW0mhhAyGEqpt,5,3,0,0,0,0,2,0,5,0.7142857142857143,1,0.0,0,0,0,0,3,0,0,2,0,0,5,1
2686,67113,3WF0lrMOUTt8kHZhSzrGOICZhAfsfzhb,SpATywNh6bZuzm8s1ceuBUnMUAeoAHHw,15,53,20,21,8,6,17,0,125,17.857142857142858,3,0.0,15,20,18,8,38,6,3,17,0,61,64,0
2687,67124,LFivYoM8eQkzo9oGvIWHE5E2ixWSM4Zt,SpATywNh6bZuzm8s1ceuBUnMUAeoAHHw,8,9,3,6,2,0,1,0,21,3.0,1,0.0,1,3,5,2,8,0,1,1,0,11,10,1
2688,67125,NEAc7vMacEwIBrIHn90danMCNJSj65mj,SpATywNh6bZuzm8s1ceuBUnMUAeoAHHw,5,2,1,0,1,0,3,0,7,1.0,1,0.0,0,1,0,1,2,0,0,3,0,2,5,1
2689,67135,HeVeuuFVpMfNb8W01LL9Sl7iyoZqremo,SpATywNh6bZuzm8s1ceuBUnMUAeoAHHw,6,2,1,0,0,0,5,1,9,1.2857142857142858,1,0.0,0,1,0,0,2,0,0,5,1,1,8,1
2690,67146,cAjVoc8wOYDE8lScDAhEgvHdzkmg6Oh2,SpATywNh6bZuzm8s1ceuBUnMUAeoAHHw,7,13,6,0,3,0,4,0,26,3.7142857142857144,4,0.0,0,6,0,3,13,0,0,4,0,9,17,1
2691,67147,4O78nHzzZKRW7OphkkAmy8uaIoFo0RWM,bWdj2GDclj5ofokWjzoa5jAwMkxCykd6,1,0,0,0,0,0,1,0,1,0.14285714285714285,1,0.0,0,0,0,0,0,0,0,1,0,0,1,1
2692,67148,zBl0JzlLEJg6YrWwxVeTxU6A3wSwUgq8,SpATywNh6bZuzm8s1ceuBUnMUAeoAHHw,7,19,0,0,0,1,2,0,22,3.142857142857143,1,0.0,0,0,0,0,19,1,0,2,0,0,22,1
2693,67162,G2vTTAEhPpy1uiGVOSc3WfzCmuUhZyw6,G8EPVSXsOYB5YQWZGiz1aVq5Pgr2GrQu,8,2,2,0,2,0,6,0,12,1.7142857142857142,2,0.0,0,2,0,2,2,0,0,6,0,4,8,1
2694,67172,IdbptVxItEcsF1HvcM0Mmm9AW3Imyhv4,SpATywNh6bZuzm8s1ceuBUnMUAeoAHHw,4,3,0,0,0,0,2,0,5,0.7142857142857143,1,0.0,0,0,0,0,3,0,0,2,0,0,5,1
2695,67179,5Zxu05K7VSTA0XR5o51TQgeWQSwtutqu,SpATywNh6bZuzm8s1ceuBUnMUAeoAHHw,13,9,5,6,1,2,5,1,29,4.142857142857143,2,0.0,2,5,6,1,7,2,0,5,1,14,15,1
2696,67186,2mFdcZdKuSUvueHyZE3zvpjXpyVcJptR,bWdj2GDclj5ofokWjzoa5jAwMkxCykd6,25,50,3,79,1,9,18,3,163,23.285714285714285,5,0.0,16,3,72,1,34,9,7,18,3,92,71,1
2697,67197,OvFsbGXgDD3DXdRTUFBoMvrSVsi4VT3x,SpATywNh6bZuzm8s1ceuBUnMUAeoAHHw,25,27,12,36,6,18,14,1,114,16.285714285714285,2,0.0,8,12,30,6,19,18,6,14,1,56,58,0
2698,67201,oYST4cfTE5cxIGh0kVtzNelTkJwqpSI4,bWdj2GDclj5ofokWjzoa5jAwMkxCykd6,2,0,0,0,0,0,2,0,2,0.2857142857142857,1,0.0,0,0,0,0,0,0,0,2,0,0,2,1
2699,67204,IJDnP8nIf6GZvQ8vvewi9Kan2f5aO9mE,SpATywNh6bZuzm8s1ceuBUnMUAeoAHHw,8,3,1,0,1,1,5,1,12,1.7142857142857142,1,0.0,0,1,0,1,3,1,0,5,1,2,10,1
2700,67208,urQLwPNeBD6YiDmQkO3zzeclg8J0Lcqs,SpATywNh6bZuzm8s1ceuBUnMUAeoAHHw,9,10,1,0,0,19,14,3,47,6.714285714285714,1,0.0,2,1,0,0,8,19,0,14,3,3,44,1
2701,67210,Mw3CgUU6IvX32BhuujNu75RHWA7Tzf9A,bWdj2GDclj5ofokWjzoa5jAwMkxCykd6,2,0,0,0,0,0,4,0,4,0.5714285714285714,1,0.0,0,0,0,0,0,0,0,4,0,0,4,1
2702,67216,fxBTxCWQMcuL1ujf7SabjHZ1ZIFJ9pkF,SpATywNh6bZuzm8s1ceuBUnMUAeoAHHw,10,4,3,0,2,10,12,1,32,4.571428571428571,1,0.0,0,3,0,2,4,10,0,12,1,5,27,1
2703,67218,2XkiS6Di6usC8n7ND637MKllSt6TChsJ,SpATywNh6bZuzm8s1ceuBUnMUAeoAHHw,14,25,9,12,2,1,9,0,58,8.285714285714286,4,0.0,10,9,10,2,15,1,2,9,0,31,27,1
2704,67225,i2lUV72IHqqXWYqLFMWv3y4XGmlq2lXa,G8EPVSXsOYB5YQWZGiz1aVq5Pgr2GrQu,2,0,0,0,0,0,2,0,2,0.2857142857142857,1,0.0,0,0,0,0,0,0,0,2,0,0,2,1
2705,67227,8QIwRllpGKgpURtcmS5hWJ0AInSKESf0,SpATywNh6bZuzm8s1ceuBUnMUAeoAHHw,7,6,2,0,2,0,5,0,15,2.142857142857143,2,0.0,0,2,0,2,6,0,0,5,0,4,11,1
2706,67233,sIyBSBxCvJj2SnsLY9k322Y8X6bvKHy5,bWdj2GDclj5ofokWjzoa5jAwMkxCykd6,2,0,0,0,0,0,2,0,2,0.2857142857142857,1,0.0,0,0,0,0,0,0,0,2,0,0,2,1
2707,67242,vy0D7u7Ahtj15h3nmn3LQzZAhD31JIs2,G8EPVSXsOYB5YQWZGiz1aVq5Pgr2GrQu,20,24,9,40,4,0,1,0,78,11.142857142857142,1,0.0,14,9,30,4,10,0,10,1,0,57,21,1
2708,67251,hfSXPDFaR2dzrQsij0JMBqqFRCNkzN0i,bWdj2GDclj5ofokWjzoa5jAwMkxCykd6,8,8,1,0,1,0,5,0,15,2.142857142857143,1,0.0,1,1,0,1,7,0,0,5,0,3,12,1
2709,67252,ZTdgLXHyPcHYh3Bqv5Ymq9ISFbVAj0an,SpATywNh6bZuzm8s1ceuBUnMUAeoAHHw,14,7,4,14,3,0,5,0,33,4.714285714285714,2,0.0,2,4,12,3,5,0,2,5,0,21,12,1
2710,67256,FZEwaAUaiR6zemazrUHMMvDLCgHez3sb,RXDvfPUBYFlVdlueBFbLW0mhhAyGEqpt,36,25,5,67,1,29,6,0,133,19.0,3,0.0,7,5,66,1,18,29,1,6,0,79,54,1
2711,67268,hZupBIfJ4ZGjbfVSNHt4j151AWxFYbOy,SpATywNh6bZuzm8s1ceuBUnMUAeoAHHw,15,20,9,7,6,1,5,0,48,6.857142857142857,2,0.0,8,9,7,6,12,1,0,5,0,30,18,1
2712,67271,1SJmhRDD4Bzcm6S9X3GSNxkp9PjEl8e5,G8EPVSXsOYB5YQWZGiz1aVq5Pgr2GrQu,25,27,12,34,8,4,2,0,87,12.428571428571429,1,0.0,11,12,24,8,16,4,10,2,0,55,32,0
2713,67274,ywsBc3bK8Vte1Tvgz902Tgp2J7M95FMX,RXDvfPUBYFlVdlueBFbLW0mhhAyGEqpt,19,20,13,0,4,12,18,5,72,10.285714285714286,2,0.0,0,13,0,4,20,12,0,18,5,17,55,1
2714,67292,grxgFxuiaSTlMIk1kWcHwbLAYZVnIvkA,SpATywNh6bZuzm8s1ceuBUnMUAeoAHHw,6,3,1,0,1,0,2,0,7,1.0,1,0.0,0,1,0,1,3,0,0,2,0,2,5,0
2715,67301,5ZZ7ac02MMtLItQmBAzvselJyRLR3oem,G8EPVSXsOYB5YQWZGiz1aVq5Pgr2GrQu,23,25,7,20,6,0,2,0,60,8.571428571428571,2,0.0,15,7,13,6,10,0,7,2,0,41,19,1
2716,67304,WYUvDmjrCchGW5prlJ6BZEDjHOYsgZsG,G8EPVSXsOYB5YQWZGiz1aVq5Pgr2GrQu,51,73,28,86,16,5,14,0,222,31.714285714285715,5,0.0,39,28,55,16,34,5,31,14,0,138,84,1
2717,67311,rRP9Jqic5Mwtv2NanjU01SwWXGZ8kuBu,SpATywNh6bZuzm8s1ceuBUnMUAeoAHHw,7,7,2,0,1,0,6,0,16,2.2857142857142856,3,0.0,0,2,0,1,7,0,0,6,0,3,13,1
2718,67315,gc2449Ag0boGNd6nrwcfyjhFar24UaYH,RXDvfPUBYFlVdlueBFbLW0mhhAyGEqpt,24,54,47,0,21,0,5,0,127,18.142857142857142,5,0.0,2,47,0,21,52,0,0,5,0,70,57,1
2719,67317,F5h4PBXJhKNor6Y20FkKW5ER39HKkW7z,SpATywNh6bZuzm8s1ceuBUnMUAeoAHHw,16,16,6,19,3,0,6,0,50,7.142857142857143,1,0.0,6,6,16,3,10,0,3,6,0,31,19,1
2720,67320,CJYyYE64ZjIblJNrc9qIS4a8OLIz3Slp,SpATywNh6bZuzm8s1ceuBUnMUAeoAHHw,1,0,0,0,0,0,1,0,1,0.14285714285714285,1,0.0,0,0,0,0,0,0,0,1,0,0,1,1
2721,67330,CXuXsLGeGwubGiU0pZVYOuy4zs49HMdw,SpATywNh6bZuzm8s1ceuBUnMUAeoAHHw,5,4,0,0,0,1,2,0,7,1.0,1,0.0,0,0,0,0,4,1,0,2,0,0,7,1
2722,67337,6JTisM1m4JxBhgrxr4NqMSmvvRfyxGKO,bWdj2GDclj5ofokWjzoa5jAwMkxCykd6,3,5,2,0,0,0,1,0,8,1.1428571428571428,1,0.0,2,2,0,0,3,0,0,1,0,4,4,1
2723,67339,3w3NoRuE9idoCLL2jfurkkC3vZE468Ey,G8EPVSXsOYB5YQWZGiz1aVq5Pgr2GrQu,7,8,3,0,3,0,4,0,18,2.5714285714285716,1,0.0,3,3,0,3,5,0,0,4,0,9,9,1
2724,67342,S8ozQPoki5gs21RwfromQBp1WzImlYaZ,SpATywNh6bZuzm8s1ceuBUnMUAeoAHHw,16,19,1,16,2,6,14,2,60,8.571428571428571,2,0.0,4,1,14,2,15,6,2,14,2,21,39,1
2725,67344,dWJvaQw3sMX6buidtTfwYxdEvR1DZxlK,bWdj2GDclj5ofokWjzoa5jAwMkxCykd6,7,6,1,0,1,0,7,0,15,2.142857142857143,2,0.0,0,1,0,1,6,0,0,7,0,2,13,1
2726,67356,T6lJMwNIVHZiShXC2FiLzuiG8wkuUByo,SpATywNh6bZuzm8s1ceuBUnMUAeoAHHw,7,2,0,0,0,1,6,1,10,1.4285714285714286,2,0.0,0,0,0,0,2,1,0,6,1,0,10,1
2727,67369,gNMjI69u5dKUTa6c5HKwijZOxWQK60Ms,RXDvfPUBYFlVdlueBFbLW0mhhAyGEqpt,9,5,0,0,0,1,6,1,13,1.8571428571428572,1,0.0,0,0,0,0,5,1,0,6,1,0,13,1
2728,67370,xutmfomAAAlPAVNt9XPAtdu3rEswaJtg,G8EPVSXsOYB5YQWZGiz1aVq5Pgr2GrQu,12,16,7,28,4,0,5,0,60,8.571428571428571,1,0.0,8,7,23,4,8,0,5,5,0,42,18,1
2729,67378,ICAkQ3nKBh6NBvMxfnhNNqVJis2pQKso,SpATywNh6bZuzm8s1ceuBUnMUAeoAHHw,8,1,1,0,1,1,12,1,17,2.4285714285714284,1,0.0,0,1,0,1,1,1,0,12,1,2,15,1
2730,67379,YkDfLiDseHtCR7dJh5rdSPT60rVAbQA9,bWdj2GDclj5ofokWjzoa5jAwMkxCykd6,5,10,7,0,0,0,4,0,21,3.0,2,0.0,0,7,0,0,10,0,0,4,0,7,14,1
2731,67390,aQ6WrdDe9pTNwVW3vmaMOs1pxy5r3Dxa,RXDvfPUBYFlVdlueBFbLW0mhhAyGEqpt,39,56,33,38,18,44,12,3,204,29.142857142857142,5,0.0,8,33,31,18,48,44,7,12,3,90,114,1
2732,67398,gYz3DXiXiB2ygQdrSqkvFFqa3NbdbDQD,SpATywNh6bZuzm8s1ceuBUnMUAeoAHHw,1,0,0,0,0,0,1,0,1,0.14285714285714285,1,0.0,0,0,0,0,0,0,0,1,0,0,1,1
2733,67399,dX8G0MwLqG7R1v0a5bVLBBEO2QeJVwW8,SpATywNh6bZuzm8s1ceuBUnMUAeoAHHw,13,7,4,13,3,0,2,0,29,4.142857142857143,1,0.0,2,4,11,3,5,0,2,2,0,20,9,1
2734,67403,s42YRljOqExiv71QhA2soTLfn9kHZdPI,bWdj2GDclj5ofokWjzoa5jAwMkxCykd6,6,6,4,0,0,0,4,0,14,2.0,2,0.0,0,4,0,0,6,0,0,4,0,4,10,1
2735,67407,s42YRljOqExiv71QhA2soTLfn9kHZdPI,G8EPVSXsOYB5YQWZGiz1aVq5Pgr2GrQu,10,17,12,0,0,0,5,0,34,4.857142857142857,3,0.0,0,12,0,0,17,0,0,5,0,12,22,1
2736,67410,SUuO92fg900YcWp4Zs3wbFF13otrTK0v,SpATywNh6bZuzm8s1ceuBUnMUAeoAHHw,9,10,0,11,0,0,4,0,25,3.5714285714285716,1,0.0,4,0,11,0,6,0,0,4,0,15,10,0
2737,67411,tvf3NtE6iYQ6D7C3fM47X9eIcuZU3rZg,SpATywNh6bZuzm8s1ceuBUnMUAeoAHHw,1,0,0,0,0,0,1,0,1,0.14285714285714285,1,0.0,0,0,0,0,0,0,0,1,0,0,1,1
2738,67415,JBvV2euLTmN1KOC1bV6ujBU9dbXkql5n,SpATywNh6bZuzm8s1ceuBUnMUAeoAHHw,7,3,1,0,2,0,3,0,9,1.2857142857142858,1,0.0,0,1,0,2,3,0,0,3,0,3,6,1
2739,67420,IQ0KwwSF7jAVaA1XdkRcnXVwTeEvf1Lv,G8EPVSXsOYB5YQWZGiz1aVq5Pgr2GrQu,8,8,2,0,1,0,7,0,18,2.5714285714285716,2,0.0,3,2,0,1,5,0,0,7,0,6,12,1
2740,67426,VFYk1GyeJyGqK1t09cLe0E5m7KsULmvc,G8EPVSXsOYB5YQWZGiz1aVq5Pgr2GrQu,54,118,57,100,41,43,20,1,380,54.285714285714285,5,0.0,8,57,86,41,110,43,14,20,1,192,188,1
2741,67428,oKLMQAZTIOtP37CLM9yXiFLXKHfYljGQ,SpATywNh6bZuzm8s1ceuBUnMUAeoAHHw,6,10,3,0,1,0,2,0,16,2.2857142857142856,2,0.0,0,3,0,1,10,0,0,2,0,4,12,1
2742,67430,RQJ9jLgqxRIRHJ3Dya9dRIuO3dlScgvn,SpATywNh6bZuzm8s1ceuBUnMUAeoAHHw,13,18,0,16,0,10,6,1,51,7.285714285714286,2,0.0,10,0,13,0,8,10,3,6,1,23,28,1
2743,67432,FdsEBC0mHy1vT6x3hjK3QpB4Q1Uhf4Gh,SpATywNh6bZuzm8s1ceuBUnMUAeoAHHw,23,28,0,24,0,1,14,1,68,9.714285714285714,4,0.0,4,0,20,0,24,1,4,14,1,24,44,0
2744,67453,BuFcLJJOy4ywnCaR2obicsAMubCpPv8W,G8EPVSXsOYB5YQWZGiz1aVq5Pgr2GrQu,14,34,8,0,6,1,14,1,64,9.142857142857142,1,0.0,3,8,0,6,31,1,0,14,1,17,47,1
2745,67459,Gb2kkDHyDR8EKKTcjBRaUmubTYuyJhiK,G8EPVSXsOYB5YQWZGiz1aVq5Pgr2GrQu,27,34,15,18,11,0,8,0,86,12.285714285714286,3,0.0,7,15,13,11,27,0,5,8,0,46,40,1
2746,67471,a6W98SSI7NFdfjtHnUJXqYQ7M2ljRDYt,SpATywNh6bZuzm8s1ceuBUnMUAeoAHHw,12,21,7,23,1,4,12,2,70,10.0,3,0.0,8,7,20,1,13,4,3,12,2,36,34,0
2747,67477,SivEvgGr7pG5rlJGO3LDvmVfpVlkOk9l,SpATywNh6bZuzm8s1ceuBUnMUAeoAHHw,11,17,3,0,1,0,7,1,29,4.142857142857143,3,0.0,1,3,0,1,16,0,0,7,1,5,24,1
2748,67502,aqNbKvnpDmE6ISe0Qz8K64tYcLrFHQcz,SpATywNh6bZuzm8s1ceuBUnMUAeoAHHw,6,3,2,0,2,0,1,0,8,1.1428571428571428,1,0.0,0,2,0,2,3,0,0,1,0,4,4,1
2749,67524,VaOhD86uWnK2TjloSi50DgiXbw9C3K0T,bWdj2GDclj5ofokWjzoa5jAwMkxCykd6,8,32,2,0,1,0,13,0,48,6.857142857142857,1,0.0,0,2,0,1,32,0,0,13,0,3,45,1
2750,67525,UwnKbl2ARSQ7IikE1xisJoI3ICSxWK5v,SpATywNh6bZuzm8s1ceuBUnMUAeoAHHw,3,2,1,0,0,0,2,0,5,0.7142857142857143,2,0.0,0,1,0,0,2,0,0,2,0,1,4,1
2751,67531,HXqJJTXStUqZG7I7cVStlMobVqz7irG0,SpATywNh6bZuzm8s1ceuBUnMUAeoAHHw,8,6,4,0,2,0,2,0,14,2.0,1,0.0,0,4,0,2,6,0,0,2,0,6,8,1
2752,67538,6IcVTIvgSxxMCCqvswEKCMSbCJJ6BHWS,RXDvfPUBYFlVdlueBFbLW0mhhAyGEqpt,25,33,19,28,11,3,4,0,98,14.0,2,0.0,7,19,25,11,26,3,3,4,0,62,36,1
2753,67541,wb1auupOEOByBWLVmCpIzBal9pmTApTW,bWdj2GDclj5ofokWjzoa5jAwMkxCykd6,16,19,8,78,8,18,5,2,138,19.714285714285715,2,0.0,7,8,75,8,12,18,3,5,2,98,40,1
2754,67544,gSzwbDlzeyvDrdHnrWsBTEKJeSjOW5Jb,RXDvfPUBYFlVdlueBFbLW0mhhAyGEqpt,16,17,9,0,5,0,17,0,48,6.857142857142857,2,0.0,2,9,0,5,15,0,0,17,0,16,32,1
2755,67552,Bfvp2pdOjaKzYdBNQKGPqSn1IHYZcfBw,SpATywNh6bZuzm8s1ceuBUnMUAeoAHHw,4,2,1,0,1,0,1,0,5,0.7142857142857143,1,0.0,0,1,0,1,2,0,0,1,0,2,3,1
2756,67553,YGhHDAwBdNiyL9eKoJUrnR1s8ObHumpL,SpATywNh6bZuzm8s1ceuBUnMUAeoAHHw,5,3,1,0,1,0,1,0,6,0.8571428571428571,1,0.0,0,1,0,1,3,0,0,1,0,2,4,1
2757,67559,q2OeaRVSMsymXTCsCZPucygIuEsf22CD,SpATywNh6bZuzm8s1ceuBUnMUAeoAHHw,1,0,0,0,0,0,1,0,1,0.14285714285714285,1,0.0,0,0,0,0,0,0,0,1,0,0,1,1
2758,67567,2famc4S1vDEuGFyXiIN218hXpJ7I8XBG,SpATywNh6bZuzm8s1ceuBUnMUAeoAHHw,5,2,1,0,1,2,2,0,8,1.1428571428571428,1,0.0,0,1,0,1,2,2,0,2,0,2,6,1
2759,67570,I1340YsGXK2BIG96XRWppOvFniqpKDu7,RXDvfPUBYFlVdlueBFbLW0mhhAyGEqpt,47,69,25,147,13,7,11,0,272,38.857142857142854,2,0.0,22,25,131,13,47,7,16,11,0,191,81,0
2760,67574,3bThVr1RhSpIoI7gmUCoVwEy4UIBaasx,RXDvfPUBYFlVdlueBFbLW0mhhAyGEqpt,5,2,1,0,1,9,3,0,16,2.2857142857142856,2,0.0,0,1,0,1,2,9,0,3,0,2,14,1
2761,67600,nSn0VSHBRSmwKbK0c8WkxsGEmgkNhPeq,SpATywNh6bZuzm8s1ceuBUnMUAeoAHHw,1,0,0,0,0,0,1,0,1,0.14285714285714285,1,0.0,0,0,0,0,0,0,0,1,0,0,1,1
2762,67609,VaOhD86uWnK2TjloSi50DgiXbw9C3K0T,SpATywNh6bZuzm8s1ceuBUnMUAeoAHHw,4,2,0,0,0,0,2,0,4,0.5714285714285714,1,0.0,0,0,0,0,2,0,0,2,0,0,4,1
2763,67623,Sqd3Eviij3ahMVLlwINw4LiDCg7rwrfy,RXDvfPUBYFlVdlueBFbLW0mhhAyGEqpt,8,6,4,0,3,0,1,0,14,2.0,1,0.0,0,4,0,3,6,0,0,1,0,7,7,1
2764,67629,BMgk3lhp6DaLc2hrRyAZS5f3pfgtil58,RXDvfPUBYFlVdlueBFbLW0mhhAyGEqpt,14,14,5,24,0,1,3,0,47,6.714285714285714,1,0.0,2,5,24,0,12,1,0,3,0,31,16,1
2765,67632,rztgByxlqb0NHiCkVNMSLs4z23c2EnGy,RXDvfPUBYFlVdlueBFbLW0mhhAyGEqpt,7,8,5,0,2,0,3,0,18,2.5714285714285716,3,0.0,1,5,0,2,7,0,0,3,0,8,10,1
2766,67641,8QtgTaOo9DCjgt6kc4Db1wXfaWgbOe0I,SpATywNh6bZuzm8s1ceuBUnMUAeoAHHw,16,22,9,15,3,0,16,0,65,9.285714285714286,3,0.0,7,9,13,3,15,0,2,16,0,32,33,1
2767,67642,BwXR7IzUtCAN8pzY1XJl6dbItwnWn8P1,SpATywNh6bZuzm8s1ceuBUnMUAeoAHHw,23,59,26,23,4,3,20,1,136,19.428571428571427,6,0.0,17,26,23,4,42,3,0,20,1,70,66,0
2768,67645,7qacCXNHfhtV3QzmLTTx2G76bXaJZKdF,SpATywNh6bZuzm8s1ceuBUnMUAeoAHHw,16,35,10,26,4,2,8,1,86,12.285714285714286,3,0.0,7,10,21,4,28,2,5,8,1,42,44,1
2769,67658,h5afPVcogbI1QW4dfwFBz4UIlWjjM3RW,SpATywNh6bZuzm8s1ceuBUnMUAeoAHHw,27,34,11,26,5,10,24,5,115,16.428571428571427,3,0.0,10,11,24,5,24,10,2,24,5,50,65,0
2770,67667,6uiFMn8grVARFSiZJzUXdXUiSRmDc7wn,SpATywNh6bZuzm8s1ceuBUnMUAeoAHHw,5,2,1,0,1,0,2,0,6,0.8571428571428571,1,0.0,0,1,0,1,2,0,0,2,0,2,4,1
2771,67673,kXJgNJrJLFK7Wt9KanP6QLSHH0toxORn,bWdj2GDclj5ofokWjzoa5jAwMkxCykd6,8,5,1,16,2,0,4,0,28,4.0,1,0.0,3,1,15,2,2,0,1,4,0,21,7,1
2772,67698,3T1Ajx8AzLKpkWsqnzq5ndyNCwXcvT6Q,G8EPVSXsOYB5YQWZGiz1aVq5Pgr2GrQu,9,10,3,4,2,0,1,0,20,2.857142857142857,1,0.0,6,3,2,2,4,0,2,1,0,13,7,1
2773,67700,Rj8CRmBx55LfZEmX69tsiuIQYQCOEvVu,bWdj2GDclj5ofokWjzoa5jAwMkxCykd6,4,6,1,0,1,0,2,0,10,1.4285714285714286,2,0.0,2,1,0,1,4,0,0,2,0,4,6,1
2774,67705,3cEo76QwJwldypMfZu21btn9IT8f6eL0,SpATywNh6bZuzm8s1ceuBUnMUAeoAHHw,15,27,3,22,2,5,8,4,71,10.142857142857142,1,0.0,15,3,19,2,12,5,3,8,4,39,32,1
2775,67729,KY9QavBrusW9AVV6DEyZrJ3FCnXy59JE,SpATywNh6bZuzm8s1ceuBUnMUAeoAHHw,9,19,10,0,3,0,12,0,44,6.285714285714286,3,0.0,0,10,0,3,19,0,0,12,0,13,31,1
2776,67732,2gXHY5qLgY96Nt3kImmboPawcy43EQXt,bWdj2GDclj5ofokWjzoa5jAwMkxCykd6,7,14,13,0,11,0,7,1,46,6.571428571428571,2,0.0,0,13,0,11,14,0,0,7,1,24,22,1
2777,67740,uCpSmjtsmbP6Tx3GZFwKoiUihKYXvJaM,SpATywNh6bZuzm8s1ceuBUnMUAeoAHHw,12,21,0,20,0,0,3,0,44,6.285714285714286,1,0.0,12,0,17,0,9,0,3,3,0,29,15,1
2778,67750,myyvmwvFjycfP5QErbd6tsUl0M6ndOJg,bWdj2GDclj5ofokWjzoa5jAwMkxCykd6,1,0,0,0,0,0,1,0,1,0.14285714285714285,1,0.0,0,0,0,0,0,0,0,1,0,0,1,1
2779,67751,myyvmwvFjycfP5QErbd6tsUl0M6ndOJg,SpATywNh6bZuzm8s1ceuBUnMUAeoAHHw,17,28,7,21,3,14,17,1,91,13.0,2,0.0,14,7,18,3,14,14,3,17,1,42,49,1
2780,67753,KY9QavBrusW9AVV6DEyZrJ3FCnXy59JE,bWdj2GDclj5ofokWjzoa5jAwMkxCykd6,5,2,1,0,1,0,2,0,6,0.8571428571428571,1,0.0,0,1,0,1,2,0,0,2,0,2,4,1
2781,67780,GlNbCQHDc8z8JZPiUwkPuJYi1fBEr1Uj,SpATywNh6bZuzm8s1ceuBUnMUAeoAHHw,8,27,9,0,0,0,5,0,41,5.857142857142857,2,0.0,8,9,0,0,19,0,0,5,0,17,24,1
2782,67782,0hRwE5vbowYRJTF6rcWCTgSh4yHA34bg,bWdj2GDclj5ofokWjzoa5jAwMkxCykd6,15,19,1,28,1,5,10,3,67,9.571428571428571,2,0.0,3,1,24,1,16,5,4,10,3,29,38,1
2783,67785,rqqNQl0bghaqvkPV1u2C08foWzi8FdRA,SpATywNh6bZuzm8s1ceuBUnMUAeoAHHw,12,13,5,11,3,0,2,0,34,4.857142857142857,2,0.0,4,5,10,3,9,0,1,2,0,22,12,1
2784,67791,knXx0VSX34ZZdw5j0pCDnRFFDbxG6IJ6,G8EPVSXsOYB5YQWZGiz1aVq5Pgr2GrQu,12,9,5,8,3,0,2,0,27,3.857142857142857,1,0.0,3,5,5,3,6,0,3,2,0,16,11,1
2785,67792,nhiUGENuXs75W6QlSu5vemDE5ZazLnGr,SpATywNh6bZuzm8s1ceuBUnMUAeoAHHw,11,13,5,13,2,0,4,0,37,5.285714285714286,2,0.0,6,5,11,2,7,0,2,4,0,24,13,1
2786,67795,ryJpL5sHkbmvdjizu6MIIT96L8Kj1MfG,SpATywNh6bZuzm8s1ceuBUnMUAeoAHHw,13,16,8,13,4,1,2,0,44,6.285714285714286,2,0.0,5,8,10,4,11,1,3,2,0,27,17,1
2787,67802,IEfUasRNK7F4OXmh9ZRgY5RLlk7j6VcY,bWdj2GDclj5ofokWjzoa5jAwMkxCykd6,9,11,6,6,3,0,4,0,30,4.285714285714286,2,0.0,1,6,6,3,10,0,0,4,0,16,14,1
2788,67805,3g0CiljEiblxCvXeNEcFARnThDq8TtPt,SpATywNh6bZuzm8s1ceuBUnMUAeoAHHw,17,42,16,13,9,15,8,1,104,14.857142857142858,5,0.0,12,16,12,9,30,15,1,8,1,49,55,0
2789,67814,7YAyDVo7GNQL9jwTCNlUB5NS22KP2Dmb,bWdj2GDclj5ofokWjzoa5jAwMkxCykd6,1,0,0,0,0,0,1,0,1,0.14285714285714285,1,0.0,0,0,0,0,0,0,0,1,0,0,1,1
2790,67826,arUYdy6tAdeT8uL5IVe1ucPvbGcQUSs0,RXDvfPUBYFlVdlueBFbLW0mhhAyGEqpt,45,32,19,89,14,2,8,1,165,23.571428571428573,3,0.0,10,19,82,14,22,2,7,8,1,125,40,0
2791,67828,8MQx62NrM26CEa5RRkhFUh36AiGGNx6S,SpATywNh6bZuzm8s1ceuBUnMUAeoAHHw,1,0,0,0,0,0,1,0,1,0.14285714285714285,1,0.0,0,0,0,0,0,0,0,1,0,0,1,1
2792,67840,liGkK11lmEt5l6sf4BenFBe3u0IYqC3Z,bWdj2GDclj5ofokWjzoa5jAwMkxCykd6,1,0,0,0,0,0,1,0,1,0.14285714285714285,1,0.0,0,0,0,0,0,0,0,1,0,0,1,1
2793,67844,e2v0YuUkw7VpGwXO9DL86A4Bv6MP4mEu,SpATywNh6bZuzm8s1ceuBUnMUAeoAHHw,6,3,1,0,1,0,3,0,8,1.1428571428571428,1,0.0,0,1,0,1,3,0,0,3,0,2,6,1
2794,67852,3Aezv8lgcVyIW4Uwgi3KMiL4RZSkwke5,SpATywNh6bZuzm8s1ceuBUnMUAeoAHHw,21,29,13,26,4,29,13,0,114,16.285714285714285,5,0.0,12,13,22,4,17,29,4,13,0,51,63,1
2795,67860,zILXfIGJjWXm6dA2MrEQWr2XeEUry8lN,G8EPVSXsOYB5YQWZGiz1aVq5Pgr2GrQu,7,2,1,0,1,0,4,0,8,1.1428571428571428,1,0.0,0,1,0,1,2,0,0,4,0,2,6,1
2796,67870,w3ElIgawNC8WwURVJSAJ04McneT8QIvi,G8EPVSXsOYB5YQWZGiz1aVq5Pgr2GrQu,22,22,19,48,10,3,4,0,106,15.142857142857142,2,0.0,0,19,38,10,22,3,10,4,0,67,39,1
2797,67877,3kPbFQO63O023TRazY2t5V1M3b8brUv8,SpATywNh6bZuzm8s1ceuBUnMUAeoAHHw,7,10,0,0,0,1,3,0,14,2.0,2,0.0,0,0,0,0,10,1,0,3,0,0,14,1
2798,67879,bRwq2z1Yz5KS0MW4CkmNDI34p59fmbas,RXDvfPUBYFlVdlueBFbLW0mhhAyGEqpt,5,3,1,0,0,0,2,0,6,0.8571428571428571,1,0.0,0,1,0,0,3,0,0,2,0,1,5,1
2799,67909,sFJi6moEGD2T3AyA8nWt11YDR7GEvwod,bWdj2GDclj5ofokWjzoa5jAwMkxCykd6,8,7,4,0,2,2,10,1,26,3.7142857142857144,2,0.0,0,4,0,2,7,2,0,10,1,6,20,1
2800,67912,P0LyrpZzGdWXSuU2oQCFUf1LzUdIEooV,SpATywNh6bZuzm8s1ceuBUnMUAeoAHHw,5,2,1,0,1,0,2,0,6,0.8571428571428571,1,0.0,0,1,0,1,2,0,0,2,0,2,4,1
2801,67916,kbnRP5v2Cp1hRovzbBsM6Gb1jKCIVIhL,bWdj2GDclj5ofokWjzoa5jAwMkxCykd6,5,8,2,0,2,0,5,0,17,2.4285714285714284,3,0.0,0,2,0,2,8,0,0,5,0,4,13,1
2802,67918,pzHaWUcmzb5LgLjIjpaBYBq7daMNFpyk,SpATywNh6bZuzm8s1ceuBUnMUAeoAHHw,23,36,1,35,0,0,22,0,94,13.428571428571429,4,0.0,11,1,31,0,25,0,4,22,0,43,51,1
2803,67921,QqqCImBc1OlgaSz0c9g0FVsZigKUtiqT,SpATywNh6bZuzm8s1ceuBUnMUAeoAHHw,6,1,1,0,1,0,3,0,6,0.8571428571428571,1,0.0,0,1,0,1,1,0,0,3,0,2,4,1
2804,67923,GDzMP0flkQ2hBX32d5dxAzabEDzF5Okt,SpATywNh6bZuzm8s1ceuBUnMUAeoAHHw,8,21,9,0,7,0,1,0,38,5.428571428571429,1,0.0,0,9,0,7,21,0,0,1,0,16,22,1
2805,67930,x6K6gEN1bi7EtUHqEXEFGztPxJcTq3NW,SpATywNh6bZuzm8s1ceuBUnMUAeoAHHw,16,23,10,16,3,0,8,0,60,8.571428571428571,3,0.0,4,10,14,3,19,0,2,8,0,31,29,1
2806,67931,OYfteiWNoHqPLaPu97Z12Qs0dcDVEU6S,SpATywNh6bZuzm8s1ceuBUnMUAeoAHHw,10,5,4,0,3,0,2,0,14,2.0,1,0.0,0,4,0,3,5,0,0,2,0,7,7,1
2807,67933,f517pkeTgS2hq8EkZsCwn6jk8FMpBlHa,bWdj2GDclj5ofokWjzoa5jAwMkxCykd6,5,5,3,0,2,0,2,0,12,1.7142857142857142,2,0.0,0,3,0,2,5,0,0,2,0,5,7,1
2808,67939,96BILLwhKLX5Hn5XJ4XGCvMlo8QDhAAj,bWdj2GDclj5ofokWjzoa5jAwMkxCykd6,1,0,0,0,0,0,1,0,1,0.14285714285714285,1,0.0,0,0,0,0,0,0,0,1,0,0,1,1
2809,67951,p9mlVtqvvgTSd0U238vycamcjMBfubit,SpATywNh6bZuzm8s1ceuBUnMUAeoAHHw,8,9,7,0,4,0,5,0,25,3.5714285714285716,1,0.0,0,7,0,4,9,0,0,5,0,11,14,1
2810,67956,laZtrdxzAU1QbcDNiYt367rO7zb5NT6r,SpATywNh6bZuzm8s1ceuBUnMUAeoAHHw,1,0,0,0,0,0,1,0,1,0.14285714285714285,1,0.0,0,0,0,0,0,0,0,1,0,0,1,1
2811,67974,5RgoX61rBJXf0CtdNHC5FjUHV0bRPnZt,SpATywNh6bZuzm8s1ceuBUnMUAeoAHHw,10,3,3,0,2,1,4,1,14,2.0,1,0.0,0,3,0,2,3,1,0,4,1,5,9,1
2812,67989,hSX8yZ4n5gfrq8om8peGXZoF496tHdJ6,SpATywNh6bZuzm8s1ceuBUnMUAeoAHHw,1,0,0,0,0,0,1,0,1,0.14285714285714285,1,0.0,0,0,0,0,0,0,0,1,0,0,1,1
2813,67995,LHXRg7L7kOMUaNixGAIsvmtlbCTLBkt1,G8EPVSXsOYB5YQWZGiz1aVq5Pgr2GrQu,12,10,1,26,0,0,5,0,42,6.0,1,0.0,1,1,23,0,9,0,3,5,0,25,17,1
2814,68000,zP7Uswh6CHfnx5kLYcdPpqokCtUDEMqC,SpATywNh6bZuzm8s1ceuBUnMUAeoAHHw,9,6,4,0,2,0,5,0,17,2.4285714285714284,1,0.0,0,4,0,2,6,0,0,5,0,6,11,1
2815,68003,hc3dSrci35Dy3FgQbfVD88Ol0CqYSCR2,RXDvfPUBYFlVdlueBFbLW0mhhAyGEqpt,39,34,20,56,13,5,1,0,129,18.428571428571427,1,0.0,12,20,53,13,22,5,3,1,0,98,31,1
2816,68011,Y0dtU5bUn0PrrnfgvOUCPfb1rktwn4CX,SpATywNh6bZuzm8s1ceuBUnMUAeoAHHw,4,2,1,0,1,0,1,0,5,0.7142857142857143,1,0.0,0,1,0,1,2,0,0,1,0,2,3,1
2817,68014,eSHpbUzZvfLR4whtzGnR3u58hC1o1DTb,SpATywNh6bZuzm8s1ceuBUnMUAeoAHHw,8,5,3,0,2,1,6,0,17,2.4285714285714284,2,0.0,0,3,0,2,5,1,0,6,0,5,12,1
2818,68031,bez5lZ7uTfbzlLF7Tc3pJJ6gxAYK8BMg,RXDvfPUBYFlVdlueBFbLW0mhhAyGEqpt,1,0,0,0,0,0,1,0,1,0.14285714285714285,1,0.0,0,0,0,0,0,0,0,1,0,0,1,1
2819,68033,g3VeqRwacliKE1TZTgZHIE5PL7TPQV85,SpATywNh6bZuzm8s1ceuBUnMUAeoAHHw,3,2,0,0,0,0,1,0,3,0.42857142857142855,1,0.0,0,0,0,0,2,0,0,1,0,0,3,1
2820,68043,mHfTvd1CfaCURBT44fgL7AymprwCoavs,SpATywNh6bZuzm8s1ceuBUnMUAeoAHHw,17,34,5,20,3,3,18,1,84,12.0,3,0.0,5,5,16,3,29,3,4,18,1,29,55,1
2821,68045,Qxy5KsClrN9vr6xM8xy9xnCXA2MaJ6Yo,SpATywNh6bZuzm8s1ceuBUnMUAeoAHHw,4,4,0,0,0,0,4,0,8,1.1428571428571428,2,0.0,0,0,0,0,4,0,0,4,0,0,8,1
2822,68057,zmlL73g2U1Ek37ZDQ2H6P7dwK1MBsxuX,SpATywNh6bZuzm8s1ceuBUnMUAeoAHHw,12,32,19,0,13,6,7,1,78,11.142857142857142,3,0.0,0,19,0,13,32,6,0,7,1,32,46,1
2823,68059,V87r8ov3AJYZnaKsWbASGu8Ya7b0fguH,SpATywNh6bZuzm8s1ceuBUnMUAeoAHHw,9,11,5,2,1,0,3,0,22,3.142857142857143,2,0.0,3,5,2,1,8,0,0,3,0,11,11,1
2824,68070,1VCQvdBqSLamldHF1ZwYh2NF4ESIqek2,bWdj2GDclj5ofokWjzoa5jAwMkxCykd6,1,0,0,0,0,0,1,0,1,0.14285714285714285,1,0.0,0,0,0,0,0,0,0,1,0,0,1,1
2825,68073,Q3zfa1BaaSk3KZquv3yDWk8LnczxvujV,SpATywNh6bZuzm8s1ceuBUnMUAeoAHHw,13,8,5,0,4,1,10,1,29,4.142857142857143,1,0.0,2,5,0,4,6,1,0,10,1,11,18,1
2826,68080,PwGj8ON4yrWpMaoZE0ES8sG2eAqFQNfN,bWdj2GDclj5ofokWjzoa5jAwMkxCykd6,8,11,6,0,3,17,7,2,46,6.571428571428571,3,0.0,0,6,0,3,11,17,0,7,2,9,37,1
2827,68106,13DcuqcvvZMyCe7b78EqeBeeWiXw335e,G8EPVSXsOYB5YQWZGiz1aVq5Pgr2GrQu,28,119,5,0,35,0,20,2,181,25.857142857142858,4,0.0,73,5,0,35,46,0,0,20,2,113,68,1
2828,68109,uFrJImuWBoPsyUWzay10wbSOjd0eMaSI,SpATywNh6bZuzm8s1ceuBUnMUAeoAHHw,15,15,5,18,3,1,10,0,52,7.428571428571429,2,0.0,10,5,15,3,5,1,3,10,0,33,19,1
2829,68117,MDJGW12z1ZhMFT2gTIbEYAqP2tu7pkDh,SpATywNh6bZuzm8s1ceuBUnMUAeoAHHw,32,51,26,29,9,60,29,3,207,29.571428571428573,5,0.0,14,26,27,9,37,60,2,29,3,76,131,0
2830,68119,Wigd4PnyDnjfDcFOxsTBcEnXo7kl9GSg,RXDvfPUBYFlVdlueBFbLW0mhhAyGEqpt,15,37,5,29,1,0,8,4,84,12.0,3,0.0,5,5,22,1,32,0,7,8,4,33,51,1
2831,68122,q1MlrkW0KNfJjOXajII1Q1GZBULc6aNj,SpATywNh6bZuzm8s1ceuBUnMUAeoAHHw,13,14,1,21,1,11,13,3,64,9.142857142857142,2,0.0,6,1,18,1,8,11,3,13,3,26,38,1
2832,68135,HStxcO1eYnD7c9LphwK9HrPR7VO3IHfm,SpATywNh6bZuzm8s1ceuBUnMUAeoAHHw,12,11,0,13,0,7,5,1,37,5.285714285714286,1,0.0,3,0,11,0,8,7,2,5,1,14,23,1
2833,68153,EY0G0vEEEoCokHenoT1cdgE4rcGAf4FL,G8EPVSXsOYB5YQWZGiz1aVq5Pgr2GrQu,4,2,1,0,1,0,1,0,5,0.7142857142857143,1,0.0,0,1,0,1,2,0,0,1,0,2,3,0
2834,68154,APkKPEpve0ecRJut2qy8IYwsafYtrJRq,bWdj2GDclj5ofokWjzoa5jAwMkxCykd6,3,2,0,0,0,0,3,0,5,0.7142857142857143,2,0.0,0,0,0,0,2,0,0,3,0,0,5,1
2835,68160,DYC2TKuAWipp9UNJIdqFLJgrkLj9mdOD,bWdj2GDclj5ofokWjzoa5jAwMkxCykd6,15,22,7,36,2,0,10,1,78,11.142857142857142,3,0.0,5,7,32,2,17,0,4,10,1,46,32,0
2836,68169,U8vo2wOZC3Q8EW1kIl6iwoIzgmQUZ4u1,bWdj2GDclj5ofokWjzoa5jAwMkxCykd6,1,0,0,0,0,0,1,0,1,0.14285714285714285,1,0.0,0,0,0,0,0,0,0,1,0,0,1,1
2837,68170,bpxaFadaQixJuWRVtAAq5miKiBM3zC6u,bWdj2GDclj5ofokWjzoa5jAwMkxCykd6,16,42,10,32,3,0,19,0,106,15.142857142857142,4,0.0,7,10,31,3,35,0,1,19,0,51,55,1
2838,68171,XNe46LXabpvEI4s4Cxqc45erOVco8nzW,RXDvfPUBYFlVdlueBFbLW0mhhAyGEqpt,38,30,18,42,7,16,11,3,127,18.142857142857142,3,0.0,7,18,35,7,23,16,7,11,3,67,60,0
2839,68177,y6oK2aw09rZ1km46IcOJlYdWLv4Nbbgi,G8EPVSXsOYB5YQWZGiz1aVq5Pgr2GrQu,3,5,1,0,1,0,1,0,8,1.1428571428571428,1,0.0,3,1,0,1,2,0,0,1,0,5,3,1
2840,68185,LGH5sOmtpw8WtitJ1dxQtTEBLQHqJEi1,SpATywNh6bZuzm8s1ceuBUnMUAeoAHHw,8,5,4,0,3,1,8,0,21,3.0,1,0.0,0,4,0,3,5,1,0,8,0,7,14,1
2841,68190,hWdLPP6trGxWYA1TuFBESlsN42OdBR5S,G8EPVSXsOYB5YQWZGiz1aVq5Pgr2GrQu,6,4,1,0,1,0,2,0,8,1.1428571428571428,1,0.0,0,1,0,1,4,0,0,2,0,2,6,1
2842,68192,TWLIxoyQjwriLBEzpRamZWHBF7mx1bZa,SpATywNh6bZuzm8s1ceuBUnMUAeoAHHw,6,11,0,0,0,0,4,0,15,2.142857142857143,2,0.0,1,0,0,0,10,0,0,4,0,1,14,1
2843,68199,rcnv42t7RT4fLoWqKHgTKDC8e00KMJQL,G8EPVSXsOYB5YQWZGiz1aVq5Pgr2GrQu,43,52,20,134,1,7,20,2,236,33.714285714285715,2,0.0,15,20,107,1,37,7,27,20,2,143,93,1
2844,68216,PiwCisYixMxmp8HVjRmlBlqNy6QSUUjE,SpATywNh6bZuzm8s1ceuBUnMUAeoAHHw,11,19,8,0,3,13,9,1,53,7.571428571428571,3,0.0,0,8,0,3,19,13,0,9,1,11,42,1
2845,68218,Lbpr3xWnQcIYr1qRkqlNlsrYRpIeuPh8,SpATywNh6bZuzm8s1ceuBUnMUAeoAHHw,9,31,7,0,4,2,12,0,56,8.0,6,0.0,2,7,0,4,29,2,0,12,0,13,43,1
2846,68219,PLTytqL5kLJdDGm9MvAFVaFDS2S7nPDO,SpATywNh6bZuzm8s1ceuBUnMUAeoAHHw,24,26,14,10,7,0,6,0,63,9.0,5,0.0,3,14,10,7,23,0,0,6,0,34,29,1
2847,68231,c21M8vKZ0MTakbncwKdeoIofnrY81cjv,SpATywNh6bZuzm8s1ceuBUnMUAeoAHHw,1,0,0,0,0,0,1,0,1,0.14285714285714285,1,0.0,0,0,0,0,0,0,0,1,0,0,1,1
2848,68232,afcoJmZ0nAGqrhElRzMbfqW6LhEtEJYc,bWdj2GDclj5ofokWjzoa5jAwMkxCykd6,7,8,4,0,3,0,4,0,19,2.7142857142857144,1,0.0,2,4,0,3,6,0,0,4,0,9,10,1
2849,68233,MulztkDP8i6NO9fvTruczDhNDdweXQmA,SpATywNh6bZuzm8s1ceuBUnMUAeoAHHw,7,6,5,0,1,0,1,0,13,1.8571428571428572,1,0.0,0,5,0,1,6,0,0,1,0,6,7,0
2850,68255,KkwBRsW7iwfoq3LjJ8XmEzXVsYBRv2GT,RXDvfPUBYFlVdlueBFbLW0mhhAyGEqpt,8,5,0,0,0,8,7,1,21,3.0,2,0.0,0,0,0,0,5,8,0,7,1,0,21,1
2851,68284,AffDAPGfOBWNdcJAjvPAA03wTtMubBsN,SpATywNh6bZuzm8s1ceuBUnMUAeoAHHw,14,7,4,9,3,0,3,0,26,3.7142857142857144,1,0.0,2,4,9,3,5,0,0,3,0,18,8,1
2852,68291,uuLKbFK5mMvYPMLqDF2i3zslYpeZQmHn,SpATywNh6bZuzm8s1ceuBUnMUAeoAHHw,3,0,0,0,0,1,3,0,4,0.5714285714285714,1,0.0,0,0,0,0,0,1,0,3,0,0,4,1
2853,68297,KGm62I3mVkjiGl4NGvCWbKWuafRNbMyV,SpATywNh6bZuzm8s1ceuBUnMUAeoAHHw,8,9,4,0,2,0,4,0,19,2.7142857142857144,2,0.0,1,4,0,2,8,0,0,4,0,7,12,0
2854,68301,NRKadp4j4jPDuLDbaa9Nm62h1VN187qT,SpATywNh6bZuzm8s1ceuBUnMUAeoAHHw,17,28,12,16,4,71,27,2,160,22.857142857142858,2,0.0,9,12,15,4,19,71,1,27,2,40,120,1
2855,68311,HbZIH6bmQW1HcPZo94YfjT1UBGLpCJBJ,SpATywNh6bZuzm8s1ceuBUnMUAeoAHHw,5,2,1,0,1,0,2,0,6,0.8571428571428571,1,0.0,0,1,0,1,2,0,0,2,0,2,4,1
2856,68315,egnijdxL4Cz1CfzoCQSNIgWry6KIzA7P,G8EPVSXsOYB5YQWZGiz1aVq5Pgr2GrQu,11,15,6,2,4,0,2,0,29,4.142857142857143,2,0.0,2,6,2,4,13,0,0,2,0,14,15,1
2857,68322,FfFp5bobRPRps1SNXZNMmjBhJWfjO7gk,RXDvfPUBYFlVdlueBFbLW0mhhAyGEqpt,5,2,1,0,1,0,2,0,6,0.8571428571428571,1,0.0,0,1,0,1,2,0,0,2,0,2,4,1
2858,68328,y9yy4SYGgNo4YF8eQGlTVidGNj2rzbsP,G8EPVSXsOYB5YQWZGiz1aVq5Pgr2GrQu,5,3,2,0,1,0,1,0,7,1.0,1,0.0,0,2,0,1,3,0,0,1,0,3,4,1
2859,68354,ojZgxZ6gEjMazXpFaRfu4Ae98N9ZNMRK,bWdj2GDclj5ofokWjzoa5jAwMkxCykd6,7,3,1,0,1,0,5,0,10,1.4285714285714286,2,0.0,1,1,0,1,2,0,0,5,0,3,7,1
2860,68355,Su5k7DFmddHd0lx2vnzPJZVUiGwHL7uO,SpATywNh6bZuzm8s1ceuBUnMUAeoAHHw,1,0,0,0,0,0,1,0,1,0.14285714285714285,1,0.0,0,0,0,0,0,0,0,1,0,0,1,1
2861,68358,MKeSX2kzyiQphau2C7yhMMzLx4acc2Cv,SpATywNh6bZuzm8s1ceuBUnMUAeoAHHw,9,11,6,0,3,0,2,0,22,3.142857142857143,1,0.0,0,6,0,3,11,0,0,2,0,9,13,1
2862,68366,KWreIfKGdz3TT4Efo15YH7GPido1RPFL,RXDvfPUBYFlVdlueBFbLW0mhhAyGEqpt,7,8,5,0,2,0,7,0,22,3.142857142857143,3,0.0,0,5,0,2,8,0,0,7,0,7,15,1
2863,68367,sU7Jp2ENUb9Oqtzi9ZG3CKbDOgPtBcP1,SpATywNh6bZuzm8s1ceuBUnMUAeoAHHw,11,22,11,0,6,19,13,1,72,10.285714285714286,1,0.0,6,11,0,6,16,19,0,13,1,23,49,1
2864,68368,jzWvwaTexkgbyBrPkQbXDb98Viqx6cSS,bWdj2GDclj5ofokWjzoa5jAwMkxCykd6,11,7,3,22,2,0,1,0,35,5.0,1,0.0,3,3,21,2,4,0,1,1,0,29,6,1
2865,68381,tx4grxmlQgEoy6eADYfJTj1STA6T1B91,RXDvfPUBYFlVdlueBFbLW0mhhAyGEqpt,4,2,1,0,1,0,1,0,5,0.7142857142857143,2,0.0,0,1,0,1,2,0,0,1,0,2,3,1
2866,68391,GVe9EjZzf7ESYXvbkluFC1UhcDJcs9er,bWdj2GDclj5ofokWjzoa5jAwMkxCykd6,9,26,12,40,5,10,7,0,100,14.285714285714286,3,0.0,5,12,37,5,21,10,3,7,0,59,41,1
2867,68431,lrklBeCwIZ4DDBQy8VTt6d0eH3oNMMDo,G8EPVSXsOYB5YQWZGiz1aVq5Pgr2GrQu,10,12,8,0,4,0,6,0,30,4.285714285714286,2,0.0,0,8,0,4,12,0,0,6,0,12,18,1
2868,68434,Ebz4oSsfYjG2sZnxJFfxROe10fAGS03Z,bWdj2GDclj5ofokWjzoa5jAwMkxCykd6,8,3,2,0,1,3,6,1,16,2.2857142857142856,1,0.0,0,2,0,1,3,3,0,6,1,3,13,1
2869,68452,BmDa42DEGdvrNnigHMvPc7GGH9qDy89v,bWdj2GDclj5ofokWjzoa5jAwMkxCykd6,3,0,0,0,0,0,3,0,3,0.42857142857142855,1,0.0,0,0,0,0,0,0,0,3,0,0,3,1
2870,68460,dxAA51K7owVPQlCgekrtAuSBHXcBEsAY,SpATywNh6bZuzm8s1ceuBUnMUAeoAHHw,8,5,3,0,3,0,1,0,12,1.7142857142857142,2,0.0,0,3,0,3,5,0,0,1,0,6,6,0
2871,68466,ZDEv7xdHlbONQGNdkwzMgbMsJFIzjdrJ,bWdj2GDclj5ofokWjzoa5jAwMkxCykd6,5,3,2,0,1,0,2,0,8,1.1428571428571428,1,0.0,0,2,0,1,3,0,0,2,0,3,5,1
2872,68469,Xa3jTMZEURd4gE5fwojMlxo2QtjAxwez,bWdj2GDclj5ofokWjzoa5jAwMkxCykd6,2,0,0,0,0,0,4,0,4,0.5714285714285714,3,0.0,0,0,0,0,0,0,0,4,0,0,4,1
2873,68481,pXqbqKhLN9u2vMm4aIB5JwL5PRPhZDCp,SpATywNh6bZuzm8s1ceuBUnMUAeoAHHw,14,20,2,13,1,8,7,2,53,7.571428571428571,3,0.0,9,2,11,1,11,8,2,7,2,23,30,0
2874,68486,DudAvEFW2YcxyABZugZo1M6Olvw9DyeE,SpATywNh6bZuzm8s1ceuBUnMUAeoAHHw,6,1,1,0,1,0,3,0,6,0.8571428571428571,1,0.0,0,1,0,1,1,0,0,3,0,2,4,1
2875,68490,hjbzzLF0uZqUL22zLBiQhzq51chcw6mb,SpATywNh6bZuzm8s1ceuBUnMUAeoAHHw,14,29,14,15,6,1,4,0,69,9.857142857142858,1,0.0,9,14,11,6,20,1,4,4,0,40,29,1
2876,68495,MT2eJtF59AVNdUs7mwFqputROb2HgEm3,bWdj2GDclj5ofokWjzoa5jAwMkxCykd6,6,8,4,0,4,0,3,0,19,2.7142857142857144,2,0.0,2,4,0,4,6,0,0,3,0,10,9,0
2877,68504,nB3KwulRK6CdNkJMXAR7thY3WeV5E2Rs,bWdj2GDclj5ofokWjzoa5jAwMkxCykd6,5,2,1,0,1,1,4,0,9,1.2857142857142858,1,0.0,0,1,0,1,2,1,0,4,0,2,7,1
2878,68506,FjEPRVEQHV2jJGjIE0BfvDTSFq9OoqAS,SpATywNh6bZuzm8s1ceuBUnMUAeoAHHw,15,18,11,4,7,0,11,2,53,7.571428571428571,3,0.0,5,11,4,7,13,0,0,11,2,27,26,1
2879,68512,hg5y95p09bcGVElNVwoGOakcfzg7TGFk,bWdj2GDclj5ofokWjzoa5jAwMkxCykd6,6,5,3,0,2,0,6,0,16,2.2857142857142856,1,0.0,0,3,0,2,5,0,0,6,0,5,11,1
2880,68518,FwweMXtSQjX7f97OVLsz3BQNG8M83X1n,SpATywNh6bZuzm8s1ceuBUnMUAeoAHHw,7,2,1,0,1,0,4,0,8,1.1428571428571428,1,0.0,0,1,0,1,2,0,0,4,0,2,6,1
2881,68522,iSIDy53M1GeZpXt46JkUT1CVMnifiRBT,G8EPVSXsOYB5YQWZGiz1aVq5Pgr2GrQu,40,76,45,52,20,89,41,21,344,49.142857142857146,6,0.0,8,45,44,20,68,89,8,41,21,117,227,1
2882,68525,y0PkAopIdLmRFrkWC9eBHvWT77KfVWMh,RXDvfPUBYFlVdlueBFbLW0mhhAyGEqpt,1,0,0,0,0,0,1,0,1,0.14285714285714285,1,0.0,0,0,0,0,0,0,0,1,0,0,1,1
2883,68530,roxYJjIM3BSzWIDsW2TPAjzeyToX557n,SpATywNh6bZuzm8s1ceuBUnMUAeoAHHw,1,0,0,0,0,0,1,0,1,0.14285714285714285,1,0.0,0,0,0,0,0,0,0,1,0,0,1,1
2884,68531,hZR4MwcYec4g0GoOyJFngJGEyWOySpv2,RXDvfPUBYFlVdlueBFbLW0mhhAyGEqpt,17,14,9,8,5,8,15,0,59,8.428571428571429,3,0.0,1,9,6,5,13,8,2,15,0,21,38,0
2885,68546,op92WqXlATrimvc1hvYZEQwtjHkoChge,RXDvfPUBYFlVdlueBFbLW0mhhAyGEqpt,13,11,2,0,2,7,11,0,33,4.714285714285714,3,0.0,5,2,0,2,6,7,0,11,0,9,24,1
2886,68557,5yc0fnnf6Ve0yL1SBLUJVE35F9aXHffP,bWdj2GDclj5ofokWjzoa5jAwMkxCykd6,1,0,0,0,0,0,2,0,2,0.2857142857142857,1,0.0,0,0,0,0,0,0,0,2,0,0,2,1
2887,68570,w66Ys32IF7bg4QEY48rFtd8o9lijcjC3,SpATywNh6bZuzm8s1ceuBUnMUAeoAHHw,7,5,2,0,2,0,5,0,14,2.0,2,0.0,0,2,0,2,5,0,0,5,0,4,10,1
2888,68576,eC5OrlIfDx9Fw0Jh12C4RyvK1vDrMSLj,SpATywNh6bZuzm8s1ceuBUnMUAeoAHHw,11,12,1,0,0,2,9,1,25,3.5714285714285716,2,0.0,0,1,0,0,12,2,0,9,1,1,24,1
2889,68579,forPgRyluFqH5fyMZfnKJctNYjPII95b,SpATywNh6bZuzm8s1ceuBUnMUAeoAHHw,1,0,0,0,0,0,1,0,1,0.14285714285714285,1,0.0,0,0,0,0,0,0,0,1,0,0,1,1
2890,68583,forPgRyluFqH5fyMZfnKJctNYjPII95b,RXDvfPUBYFlVdlueBFbLW0mhhAyGEqpt,15,17,2,0,1,23,18,6,67,9.571428571428571,2,0.0,0,2,0,1,17,23,0,18,6,3,64,1
2891,68588,yIoYmR4ll93f7EHu29moXjbx4kT37xAM,bWdj2GDclj5ofokWjzoa5jAwMkxCykd6,18,27,4,70,7,7,16,2,133,19.0,2,0.0,10,4,64,7,17,7,6,16,2,85,48,1
2892,68591,b8js5e6thEnzYItgffCHQwfAl1iYfizN,SpATywNh6bZuzm8s1ceuBUnMUAeoAHHw,9,9,6,0,4,1,12,2,34,4.857142857142857,1,0.0,0,6,0,4,9,1,0,12,2,10,24,1
2893,68605,SZOXOmDilP1KR3OJXHpIlLf61tEoqX1S,G8EPVSXsOYB5YQWZGiz1aVq5Pgr2GrQu,4,2,1,0,1,0,1,0,5,0.7142857142857143,1,0.0,0,1,0,1,2,0,0,1,0,2,3,1
2894,68625,4QX0UVH2mWoWEvrk1Om8ECy2pBWoKhcm,SpATywNh6bZuzm8s1ceuBUnMUAeoAHHw,6,5,1,0,1,0,1,0,8,1.1428571428571428,1,0.0,1,1,0,1,4,0,0,1,0,3,5,1
2895,68629,M2AmcvqhvMtUlyRV6vMvvoM2IhrMmAwT,bWdj2GDclj5ofokWjzoa5jAwMkxCykd6,8,7,3,0,1,0,4,0,15,2.142857142857143,3,0.0,0,3,0,1,7,0,0,4,0,4,11,1
2896,68637,M4sV24yJlA7UYO36nFDbwFj49msCFYqO,SpATywNh6bZuzm8s1ceuBUnMUAeoAHHw,1,0,0,0,0,0,1,0,1,0.14285714285714285,1,0.0,0,0,0,0,0,0,0,1,0,0,1,1
2897,68650,3blAUsZiu4FW1Jp6vOBSuHfrNCEPv1lZ,RXDvfPUBYFlVdlueBFbLW0mhhAyGEqpt,11,10,3,0,2,0,6,0,21,3.0,2,0.0,0,3,0,2,10,0,0,6,0,5,16,0
2898,68657,kouVFmC9KYKK6YQi2WuQuIKCuxGX5ljt,RXDvfPUBYFlVdlueBFbLW0mhhAyGEqpt,37,36,4,79,3,3,7,1,133,19.0,5,0.0,10,4,75,3,26,3,4,7,1,92,41,0
2899,68662,JZ0cPuTVmC70maYF6NIorZr3bOTKKvsS,SpATywNh6bZuzm8s1ceuBUnMUAeoAHHw,1,0,0,0,0,0,1,0,1,0.14285714285714285,1,0.0,0,0,0,0,0,0,0,1,0,0,1,1
2900,68664,DfCrd6VP4inLGSvbDnl7Xl7qOqvm6UpO,SpATywNh6bZuzm8s1ceuBUnMUAeoAHHw,4,2,1,0,1,0,1,0,5,0.7142857142857143,1,0.0,0,1,0,1,2,0,0,1,0,2,3,1
2901,68665,9LD2dY2JJUiq4N2gerCXLTVCO162xgQP,G8EPVSXsOYB5YQWZGiz1aVq5Pgr2GrQu,7,3,0,0,0,1,5,1,10,1.4285714285714286,1,0.0,0,0,0,0,3,1,0,5,1,0,10,1
2902,68667,13fzVwLJSsgGzTLwjEHCuvf0Ks8dgxYZ,RXDvfPUBYFlVdlueBFbLW0mhhAyGEqpt,1,0,0,0,0,0,1,0,1,0.14285714285714285,1,0.0,0,0,0,0,0,0,0,1,0,0,1,1
2903,68676,OvG0QIZOPiV3oa4UqFgxzNEprO7pKVmV,SpATywNh6bZuzm8s1ceuBUnMUAeoAHHw,29,25,11,16,7,5,14,1,79,11.285714285714286,4,0.0,4,11,16,7,21,5,0,14,1,38,41,0
2904,68687,lPU0lJqSA3OSdb8bK1yzncqCybAP9bUO,SpATywNh6bZuzm8s1ceuBUnMUAeoAHHw,16,59,31,18,7,29,18,0,162,23.142857142857142,2,0.0,9,31,16,7,50,29,2,18,0,63,99,1
2905,68688,s4immbICvRMkMxvZyJBqO325qtK1yhVk,G8EPVSXsOYB5YQWZGiz1aVq5Pgr2GrQu,3,3,0,0,0,0,1,0,4,0.5714285714285714,1,0.0,1,0,0,0,2,0,0,1,0,1,3,1
2906,68699,lyCFhIpUX9eBaODrOlziE1wpuE5i2FcV,bWdj2GDclj5ofokWjzoa5jAwMkxCykd6,2,0,0,0,0,0,2,0,2,0.2857142857142857,1,0.0,0,0,0,0,0,0,0,2,0,0,2,1
2907,68703,Th6GGIKucyCokdQsUn3aOeloTzqx0Qbo,SpATywNh6bZuzm8s1ceuBUnMUAeoAHHw,1,0,0,0,0,0,1,0,1,0.14285714285714285,1,0.0,0,0,0,0,0,0,0,1,0,0,1,1
2908,68704,5MOHfgPntZIsRWkQebauzpUgUSaHvhFJ,SpATywNh6bZuzm8s1ceuBUnMUAeoAHHw,15,41,22,9,2,9,12,0,95,13.571428571428571,6,0.0,6,22,7,2,35,9,2,12,0,37,58,0
2909,68705,yZYTsrvrgsLaQebVaD5W80s8tJxpcy3t,SpATywNh6bZuzm8s1ceuBUnMUAeoAHHw,7,8,4,0,3,0,3,0,18,2.5714285714285716,1,0.0,0,4,0,3,8,0,0,3,0,7,11,1
2910,68711,fFCTtQQCOOjijvFKvRDQiA777EKDq9kt,RXDvfPUBYFlVdlueBFbLW0mhhAyGEqpt,33,29,19,52,0,0,9,7,116,16.571428571428573,4,0.0,7,19,49,0,22,0,3,9,7,75,41,1
2911,68717,XB4WTxkP3vNmHXjALkkfZII5POid4TAu,SpATywNh6bZuzm8s1ceuBUnMUAeoAHHw,3,2,0,0,0,0,1,0,3,0.42857142857142855,1,0.0,0,0,0,0,2,0,0,1,0,0,3,1
2912,68720,XJxfWg6ep0iC8D7yOZX3PZy18MtrFPsI,SpATywNh6bZuzm8s1ceuBUnMUAeoAHHw,9,13,10,0,5,0,2,0,30,4.285714285714286,2,0.0,0,10,0,5,13,0,0,2,0,15,15,1
2913,68731,KgATxoqrB3vgLjFK8Jvt9HJ7S86x88Nt,SpATywNh6bZuzm8s1ceuBUnMUAeoAHHw,1,0,0,0,0,0,1,0,1,0.14285714285714285,1,0.0,0,0,0,0,0,0,0,1,0,0,1,1
2914,68732,pyElpGpHSNzEpZ3jrGlcGeNI8YUApbgQ,bWdj2GDclj5ofokWjzoa5jAwMkxCykd6,19,45,19,38,8,20,7,4,141,20.142857142857142,3,0.0,6,19,35,8,39,20,3,7,4,68,73,1
2915,68739,kNijCkWRNCwIOtL9mKx9mB8Vau6ujWr3,SpATywNh6bZuzm8s1ceuBUnMUAeoAHHw,31,50,16,29,8,18,7,3,131,18.714285714285715,2,0.0,29,16,28,8,21,18,1,7,3,81,50,1
2916,68750,gf8nHDqKPX2j100RHCT9dT19AZw0vESt,bWdj2GDclj5ofokWjzoa5jAwMkxCykd6,4,2,1,0,1,0,1,0,5,0.7142857142857143,1,0.0,0,1,0,1,2,0,0,1,0,2,3,1
2917,68771,2DRl1D33z6i9gsgW5IB0KBdkJJ1Zsu7a,RXDvfPUBYFlVdlueBFbLW0mhhAyGEqpt,1,0,0,0,0,0,1,0,1,0.14285714285714285,1,0.0,0,0,0,0,0,0,0,1,0,0,1,1
2918,68776,n5lHa6MzF6UuuHLbdbmhitfwFFej0cUG,bWdj2GDclj5ofokWjzoa5jAwMkxCykd6,1,0,0,0,0,0,1,0,1,0.14285714285714285,1,0.0,0,0,0,0,0,0,0,1,0,0,1,1
2919,68785,g2zZYnTJ1Pk3cSjsVP5SH4UjJdsbDJv7,SpATywNh6bZuzm8s1ceuBUnMUAeoAHHw,14,19,7,16,4,23,4,0,73,10.428571428571429,2,0.0,9,7,14,4,10,23,2,4,0,34,39,1
2920,68794,xqGP5lHPgGUPDIL6gt03S8kze9HpOEIL,SpATywNh6bZuzm8s1ceuBUnMUAeoAHHw,4,2,1,0,1,0,1,0,5,0.7142857142857143,1,0.0,0,1,0,1,2,0,0,1,0,2,3,1
2921,68799,8uISS2OyAivNghskvH7qzmmtfHvBWiyo,SpATywNh6bZuzm8s1ceuBUnMUAeoAHHw,8,13,5,0,3,1,7,1,30,4.285714285714286,2,0.0,5,5,0,3,8,1,0,7,1,13,17,1
2922,68803,8DvAxou540FD0LKoQccPN3Xyo1nrtg8U,bWdj2GDclj5ofokWjzoa5jAwMkxCykd6,6,3,0,0,1,0,2,0,6,0.8571428571428571,2,0.0,0,0,0,1,3,0,0,2,0,1,5,1
2923,68804,3o4QanEzrLxU7IR8E0SkDLt6uwLmz5BV,G8EPVSXsOYB5YQWZGiz1aVq5Pgr2GrQu,53,79,29,82,10,0,9,0,209,29.857142857142858,4,0.0,30,29,54,10,49,0,28,9,0,123,86,1
2924,68806,J4cKirSbcBOsAeFSIp9ObJYWVvlxjPLO,SpATywNh6bZuzm8s1ceuBUnMUAeoAHHw,8,17,4,0,4,0,7,0,32,4.571428571428571,2,0.0,0,4,0,4,17,0,0,7,0,8,24,1
2925,68811,JXT9wmO8lGZMBaQQK0U8pHKQIW1oOnDo,RXDvfPUBYFlVdlueBFbLW0mhhAyGEqpt,14,12,12,0,6,0,6,0,36,5.142857142857143,2,0.0,0,12,0,6,12,0,0,6,0,18,18,1
2926,68815,jEfIANn9M5UCRbhWqJtJFlsF2uyG4fk6,A3fsA9Zfv1X2fVEQhTw51lKENdNrEqT3,4,5,1,0,0,0,3,0,9,1.2857142857142858,1,0.0,0,1,0,0,5,0,0,3,0,1,8,1
2927,68822,T3xcwszBjaOdB7YgVcZfsRhjJ9lfkEVZ,SpATywNh6bZuzm8s1ceuBUnMUAeoAHHw,1,0,0,0,0,0,1,0,1,0.14285714285714285,1,0.0,0,0,0,0,0,0,0,1,0,0,1,1
2928,68833,tn5nSlJLNdxx4Uni5Dn3S8nwDR8GJibq,SpATywNh6bZuzm8s1ceuBUnMUAeoAHHw,30,32,19,29,10,6,8,1,105,15.0,2,0.0,8,19,26,10,24,6,3,8,1,63,42,0
2929,68839,ci6w9FxXwoWvsu2Aw9ojvjfPhjaGgaxN,SpATywNh6bZuzm8s1ceuBUnMUAeoAHHw,16,36,17,21,1,21,18,0,114,16.285714285714285,5,0.0,7,17,17,1,29,21,4,18,0,42,72,1
2930,68849,l21tCwOolR7RD0CZyqRiNHHeEZC1D67K,bWdj2GDclj5ofokWjzoa5jAwMkxCykd6,5,6,3,0,2,0,2,0,13,1.8571428571428572,2,0.0,1,3,0,2,5,0,0,2,0,6,7,1
2931,68852,IC3lGAGjjevFNisK97Sg5rNNaiFl6GUf,SpATywNh6bZuzm8s1ceuBUnMUAeoAHHw,8,9,1,0,0,0,7,2,19,2.7142857142857144,1,0.0,0,1,0,0,9,0,0,7,2,1,18,1
2932,68855,QfnbskMOJDzclneyUxl9CDLAwpjYY8bi,SpATywNh6bZuzm8s1ceuBUnMUAeoAHHw,5,3,1,0,1,0,1,0,6,0.8571428571428571,1,0.0,0,1,0,1,3,0,0,1,0,2,4,1
2933,68858,nrnVeosxoYxlthTbtXiJng8EyjNCisBw,SpATywNh6bZuzm8s1ceuBUnMUAeoAHHw,22,28,2,35,1,1,16,5,88,12.571428571428571,3,0.0,8,2,27,1,20,1,8,16,5,38,50,1
2934,68867,mJAgtJKHxy28GsPIeuAEUCIOXmHzCywF,A3fsA9Zfv1X2fVEQhTw51lKENdNrEqT3,52,70,50,78,31,16,20,0,265,37.857142857142854,5,0.0,3,50,65,31,67,16,13,20,0,149,116,0
2935,68876,5IM8g7YMOYo5qH7Yu3x31T3JkVOH9iqe,SpATywNh6bZuzm8s1ceuBUnMUAeoAHHw,13,13,6,0,5,0,2,0,26,3.7142857142857144,2,0.0,0,6,0,5,13,0,0,2,0,11,15,0
2936,68889,jagu0OJDhWTGFhfCMk0ghqluLpW3kzdC,A3fsA9Zfv1X2fVEQhTw51lKENdNrEqT3,7,6,3,0,2,0,10,0,21,3.0,3,0.0,0,3,0,2,6,0,0,10,0,5,16,1
2937,68891,AyMpxTtI93rQBcmn1hZDJ5NB66ddrTt8,bWdj2GDclj5ofokWjzoa5jAwMkxCykd6,15,16,7,62,5,20,3,0,113,16.142857142857142,1,0.0,7,7,59,5,9,20,3,3,0,78,35,1
2938,68894,SG7N8DhpCuhIu06IIzLX0CSolbyIDsIx,SpATywNh6bZuzm8s1ceuBUnMUAeoAHHw,31,53,24,27,9,3,9,0,125,17.857142857142858,5,0.0,17,24,26,9,36,3,1,9,0,76,49,1
2939,68925,ObpezNQRvm77jf0ubZxdLKEQMiNil6VQ,bWdj2GDclj5ofokWjzoa5jAwMkxCykd6,7,9,2,0,1,0,10,0,22,3.142857142857143,1,0.0,0,2,0,1,9,0,0,10,0,3,19,1
2940,68941,g5OpPhveV3tEyIL9sXOQK1bIZWgyqgNP,SpATywNh6bZuzm8s1ceuBUnMUAeoAHHw,1,0,0,0,0,0,1,0,1,0.14285714285714285,1,0.0,0,0,0,0,0,0,0,1,0,0,1,1
2941,68966,GiA8pWWKZYTUi7chN7ntBN35fCWU2nBu,SpATywNh6bZuzm8s1ceuBUnMUAeoAHHw,8,1,1,0,1,0,6,1,10,1.4285714285714286,1,0.0,0,1,0,1,1,0,0,6,1,2,8,1
2942,68969,koujvnfMBhMkCgSrbEaysh2AE5Gpg2YT,G8EPVSXsOYB5YQWZGiz1aVq5Pgr2GrQu,15,7,5,0,5,0,7,0,24,3.4285714285714284,1,0.0,0,5,0,5,7,0,0,7,0,10,14,0
2943,68970,TxEB3EFyNbwMBYmqmAZljhKEWyORCpLb,SpATywNh6bZuzm8s1ceuBUnMUAeoAHHw,1,0,0,0,0,0,1,0,1,0.14285714285714285,1,0.0,0,0,0,0,0,0,0,1,0,0,1,1
2944,68979,ugU2OsTm2YN2IbGmjW7DHhMX6BMMKbiK,G8EPVSXsOYB5YQWZGiz1aVq5Pgr2GrQu,8,7,4,6,0,0,2,0,19,2.7142857142857144,1,0.0,2,4,4,0,5,0,2,2,0,10,9,1
2945,68986,c7CZsOAhREk5r7i8Wn5QXe6C7ebs3xYP,A3fsA9Zfv1X2fVEQhTw51lKENdNrEqT3,2,0,0,0,0,0,3,0,3,0.42857142857142855,2,0.0,0,0,0,0,0,0,0,3,0,0,3,1
2946,68994,Xl37kHv8hz1ETmkFgpIsXpoKOIdQzB5H,SpATywNh6bZuzm8s1ceuBUnMUAeoAHHw,5,2,1,0,1,0,2,0,6,0.8571428571428571,1,0.0,0,1,0,1,2,0,0,2,0,2,4,1
2947,68996,xC7QA3lJWLoIMEwPvqIxcLnCt0KwsxwT,SpATywNh6bZuzm8s1ceuBUnMUAeoAHHw,2,0,0,0,0,0,2,0,2,0.2857142857142857,1,0.0,0,0,0,0,0,0,0,2,0,0,2,1
2948,68998,sNC7XF6Nlmfza5mofBS4sZLhOb44U4Ts,G8EPVSXsOYB5YQWZGiz1aVq5Pgr2GrQu,1,0,0,0,0,0,1,0,1,0.14285714285714285,1,0.0,0,0,0,0,0,0,0,1,0,0,1,1
2949,69007,wYGhiFjdBLkU2x7JJ3K1n2UAh76fIcQi,SpATywNh6bZuzm8s1ceuBUnMUAeoAHHw,10,11,9,0,7,1,2,0,30,4.285714285714286,2,0.0,0,9,0,7,11,1,0,2,0,16,14,1
2950,69014,souC6CA0wrFXemJ5RC2IcVOFZKY3Ud6D,A3fsA9Zfv1X2fVEQhTw51lKENdNrEqT3,42,71,19,40,8,4,15,1,158,22.571428571428573,1,0.0,3,19,40,8,68,4,0,15,1,70,88,0
2951,69031,8lWVuB48GCoDnvIn7Nn1tDxRI6ibKTRq,SpATywNh6bZuzm8s1ceuBUnMUAeoAHHw,5,2,1,0,1,0,2,0,6,0.8571428571428571,1,0.0,0,1,0,1,2,0,0,2,0,2,4,1
2952,69043,YVCPApRVJS0XKKCEpBt52bsseKQk9Woy,SpATywNh6bZuzm8s1ceuBUnMUAeoAHHw,1,0,0,0,0,0,1,0,1,0.14285714285714285,1,0.0,0,0,0,0,0,0,0,1,0,0,1,1
2953,69054,CJYdZ6F1UmkUhSW1DIBQ5YjVYvVCeBEf,A3fsA9Zfv1X2fVEQhTw51lKENdNrEqT3,6,3,1,0,1,0,2,0,7,1.0,1,0.0,0,1,0,1,3,0,0,2,0,2,5,1
2954,69065,57ya2ykgKZwUUOXe4VfUt0HWtgZeemvj,SpATywNh6bZuzm8s1ceuBUnMUAeoAHHw,1,0,0,0,0,0,1,0,1,0.14285714285714285,1,0.0,0,0,0,0,0,0,0,1,0,0,1,1
2955,69080,WgYQBUzSJJLcj6PwA0d8MdNri6k7nN4s,A3fsA9Zfv1X2fVEQhTw51lKENdNrEqT3,2,0,0,0,0,0,2,0,2,0.2857142857142857,1,0.0,0,0,0,0,0,0,0,2,0,0,2,1
2956,69082,lt7x7W9L5dc1lSFEc965LhUn5shsg0v8,SpATywNh6bZuzm8s1ceuBUnMUAeoAHHw,4,3,0,0,0,0,2,0,5,0.7142857142857143,1,0.0,0,0,0,0,3,0,0,2,0,0,5,1
2957,69095,dK22lzU3sHpxa7kQiSzhTpdq8w2wdIKM,G8EPVSXsOYB5YQWZGiz1aVq5Pgr2GrQu,5,3,0,0,0,0,6,1,10,1.4285714285714286,2,0.0,1,0,0,0,2,0,0,6,1,1,9,0
2958,69103,ZwACmcXP1dFceMUleNJ3flkTstESRohK,SpATywNh6bZuzm8s1ceuBUnMUAeoAHHw,29,35,16,39,6,0,9,0,105,15.0,2,0.0,14,16,36,6,21,0,3,9,0,72,33,1
2959,69115,Vd6ebRuiLfwgqB5waj4eS9hJ1uyBDxCf,A3fsA9Zfv1X2fVEQhTw51lKENdNrEqT3,10,12,1,0,0,0,5,0,18,2.5714285714285716,1,0.0,0,1,0,0,12,0,0,5,0,1,17,1
2960,69116,8RAttpsmVeGyWHWVdhomVf58WbsxdKtJ,SpATywNh6bZuzm8s1ceuBUnMUAeoAHHw,9,7,6,0,6,0,2,0,21,3.0,4,0.0,0,6,0,6,7,0,0,2,0,12,9,1
2961,69131,8Ir6rIjO15kuvM3s5xrQH1rB1m97Mcy9,SpATywNh6bZuzm8s1ceuBUnMUAeoAHHw,15,33,1,20,1,18,13,2,88,12.571428571428571,3,0.0,14,1,18,1,19,18,2,13,2,34,54,0
2962,69147,cRQPwEYCK3Iw8dKAOD2ODiUgaKZ6yPed,SpATywNh6bZuzm8s1ceuBUnMUAeoAHHw,23,47,1,18,0,3,14,1,84,12.0,3,0.0,15,1,16,0,32,3,2,14,1,32,52,1
2963,69154,oBZQGNxV159KYVTxhJiCHURpoG2050SJ,SpATywNh6bZuzm8s1ceuBUnMUAeoAHHw,2,0,0,0,0,0,2,0,2,0.2857142857142857,1,0.0,0,0,0,0,0,0,0,2,0,0,2,1
2964,69155,K0iCXE1mno7izlBrkQAs4SEkYDRU9qXa,SpATywNh6bZuzm8s1ceuBUnMUAeoAHHw,5,3,1,0,1,0,2,0,7,1.0,1,0.0,2,1,0,1,1,0,0,2,0,4,3,1
2965,69161,3X0JLX6UvJnnRb5GkwbFJgAokE5g69D0,SpATywNh6bZuzm8s1ceuBUnMUAeoAHHw,25,50,16,14,6,1,11,0,98,14.0,6,0.0,15,16,14,6,35,1,0,11,0,51,47,0
2966,69165,4DUZBFD9Fwl71r8i0SB6pVZCzmNoxKnn,A3fsA9Zfv1X2fVEQhTw51lKENdNrEqT3,8,11,6,0,1,1,3,0,22,3.142857142857143,2,0.0,0,6,0,1,11,1,0,3,0,7,15,1
2967,69192,agX8fi6SsMsbGjpTUuXM1FgToYG9zbAn,SpATywNh6bZuzm8s1ceuBUnMUAeoAHHw,11,20,12,0,7,4,5,0,48,6.857142857142857,5,0.0,0,12,0,7,20,4,0,5,0,19,29,0
2968,69200,udnRYxurswpE4GUZcnc80kafg0hn3fpz,A3fsA9Zfv1X2fVEQhTw51lKENdNrEqT3,3,3,1,0,0,0,2,0,6,0.8571428571428571,1,0.0,0,1,0,0,3,0,0,2,0,1,5,0
2969,69231,yRvmuoOlApBAgoa9MY5Qvy0RDYuNtlAF,G8EPVSXsOYB5YQWZGiz1aVq5Pgr2GrQu,7,5,0,0,0,0,5,0,10,1.4285714285714286,1,0.0,0,0,0,0,5,0,0,5,0,0,10,1
2970,69237,xG3AmboF4HBUiYwQZV4JGVdvJNCIXdwN,SpATywNh6bZuzm8s1ceuBUnMUAeoAHHw,10,26,13,1,7,0,4,0,51,7.285714285714286,2,0.0,9,13,1,7,17,0,0,4,0,30,21,1
2971,69240,IXJE6OTajH0Geh8I1ZW7ljkRPJ4pkmfl,SpATywNh6bZuzm8s1ceuBUnMUAeoAHHw,10,9,6,4,0,0,1,0,20,2.857142857142857,1,0.0,1,6,3,0,8,0,1,1,0,10,10,1
2972,69259,7bRPtq6P8Xywkbl391z1cfKif2lsM9WW,SpATywNh6bZuzm8s1ceuBUnMUAeoAHHw,29,26,16,40,7,0,4,0,93,13.285714285714286,2,0.0,7,16,36,7,19,0,4,4,0,66,27,1
2973,69268,Eq98WSTQOt9fRmYbHT449FU0RWdVZ5zB,SpATywNh6bZuzm8s1ceuBUnMUAeoAHHw,5,2,1,0,1,0,2,0,6,0.8571428571428571,1,0.0,0,1,0,1,2,0,0,2,0,2,4,1
2974,69276,FSJWTYbpEABu1Che9CXJ2jTRzNOHiIPA,SpATywNh6bZuzm8s1ceuBUnMUAeoAHHw,9,6,2,0,2,0,7,0,17,2.4285714285714284,1,0.0,0,2,0,2,6,0,0,7,0,4,13,1
2975,69284,UhXyunBodgS5DssUOIaVTTsNfgvZZxEV,bWdj2GDclj5ofokWjzoa5jAwMkxCykd6,4,3,1,0,0,0,2,0,6,0.8571428571428571,1,0.0,0,1,0,0,3,0,0,2,0,1,5,1
2976,69285,3bqMPd7dmQ6bVwYt9AjfxpDPMW8ppczj,RXDvfPUBYFlVdlueBFbLW0mhhAyGEqpt,1,0,0,0,0,0,1,0,1,0.14285714285714285,1,0.0,0,0,0,0,0,0,0,1,0,0,1,1
2977,69293,ovvuiEhj0QBv4xi11GVjXr8JhlCgaPmd,A3fsA9Zfv1X2fVEQhTw51lKENdNrEqT3,9,3,3,0,3,0,5,0,14,2.0,2,0.0,0,3,0,3,3,0,0,5,0,6,8,1
2978,69297,X9IKf8GgqS6dvoKX3VBo51mIr8yb4uFC,bWdj2GDclj5ofokWjzoa5jAwMkxCykd6,10,23,6,0,8,4,5,0,46,6.571428571428571,2,0.0,8,6,0,8,15,4,0,5,0,22,24,1
2979,69308,YtPY6V9gKVYBGYaBakDnRKgXM0SCPhH8,RXDvfPUBYFlVdlueBFbLW0mhhAyGEqpt,69,70,43,95,27,2,12,0,249,35.57142857142857,5,0.0,21,43,91,27,49,2,4,12,0,182,67,0
2980,69322,WfiWheCcfnYrlo1ljQjtyFUB6mwR6CMB,SpATywNh6bZuzm8s1ceuBUnMUAeoAHHw,13,12,8,0,4,0,12,1,37,5.285714285714286,2,0.0,0,8,0,4,12,0,0,12,1,12,25,1
2981,69324,byxGWUJV72XqYw0RcV5v8EuZ9oh6gief,G8EPVSXsOYB5YQWZGiz1aVq5Pgr2GrQu,13,10,6,0,4,0,8,0,28,4.0,1,0.0,0,6,0,4,10,0,0,8,0,10,18,1
2982,69337,wMBHEwMS1ke1XCIE6pdAhfvU7lKPIoig,A3fsA9Zfv1X2fVEQhTw51lKENdNrEqT3,6,5,4,0,0,0,2,0,11,1.5714285714285714,1,0.0,0,4,0,0,5,0,0,2,0,4,7,1
2983,69345,pNeNjRs1mK0wHcAzJFxLXdAPA9xgPVV6,bWdj2GDclj5ofokWjzoa5jAwMkxCykd6,5,2,1,0,1,0,2,0,6,0.8571428571428571,1,0.0,0,1,0,1,2,0,0,2,0,2,4,1
2984,69360,VtYfYYb8PipDmwJ9fAnXpdTb4dF89SFx,SpATywNh6bZuzm8s1ceuBUnMUAeoAHHw,11,5,4,0,4,0,2,0,15,2.142857142857143,1,0.0,0,4,0,4,5,0,0,2,0,8,7,1
2985,69367,UeHaetwViLI5gC5HiwzWUg3JwpoZmRrG,A3fsA9Zfv1X2fVEQhTw51lKENdNrEqT3,1,0,0,0,0,0,1,0,1,0.14285714285714285,1,0.0,0,0,0,0,0,0,0,1,0,0,1,1
2986,69371,YaUoJwJr3oO9HJ6WDm7V4UT5kFsGziL7,bWdj2GDclj5ofokWjzoa5jAwMkxCykd6,1,0,0,0,0,0,1,0,1,0.14285714285714285,1,0.0,0,0,0,0,0,0,0,1,0,0,1,1
2987,69382,7jncvDKBN22Fxg064o0NyimMY6U2A5Li,SpATywNh6bZuzm8s1ceuBUnMUAeoAHHw,5,2,1,0,1,0,2,0,6,0.8571428571428571,1,0.0,0,1,0,1,2,0,0,2,0,2,4,1
2988,69387,hPdb7IzvQK13aLXEDwxSH4zOMfPRUsSC,SpATywNh6bZuzm8s1ceuBUnMUAeoAHHw,1,0,0,0,0,0,1,0,1,0.14285714285714285,1,0.0,0,0,0,0,0,0,0,1,0,0,1,1
2989,69391,d5euO6JYPz1tRdmilapWDL1Th3AQudPQ,SpATywNh6bZuzm8s1ceuBUnMUAeoAHHw,6,3,1,0,1,0,2,0,7,1.0,1,0.0,0,1,0,1,3,0,0,2,0,2,5,1
2990,69393,sQMQGXUKDLttJ8ntfMuRvWEcncBHKCzb,G8EPVSXsOYB5YQWZGiz1aVq5Pgr2GrQu,5,4,0,0,0,0,2,0,6,0.8571428571428571,1,0.0,0,0,0,0,4,0,0,2,0,0,6,1
2991,69394,9fEcx2YdFV830apuhCo8G8R1veKyhCNk,G8EPVSXsOYB5YQWZGiz1aVq5Pgr2GrQu,1,0,0,0,0,0,1,0,1,0.14285714285714285,1,0.0,0,0,0,0,0,0,0,1,0,0,1,1
2992,69396,x87E9Qmbnh2qCEUiaevhSD7rp8sUrupo,SpATywNh6bZuzm8s1ceuBUnMUAeoAHHw,6,4,3,0,2,0,3,0,12,1.7142857142857142,2,0.0,0,3,0,2,4,0,0,3,0,5,7,1
2993,69397,egpXv13dykaiU64GCgTaQGg1ErRD7Rsb,SpATywNh6bZuzm8s1ceuBUnMUAeoAHHw,17,14,11,2,6,15,7,1,56,8.0,3,0.0,0,11,2,6,14,15,0,7,1,19,37,0
2994,69400,FlAkKX6ow9SvOzk0dTWPWgnX5766zY29,SpATywNh6bZuzm8s1ceuBUnMUAeoAHHw,22,27,10,12,7,1,3,0,60,8.571428571428571,2,0.0,6,10,12,7,21,1,0,3,0,35,25,1
2995,69420,aI2WbSCktVyijPTHCbgAdpzpfdnFGcq9,bWdj2GDclj5ofokWjzoa5jAwMkxCykd6,1,0,0,0,0,0,1,0,1,0.14285714285714285,1,0.0,0,0,0,0,0,0,0,1,0,0,1,1
2996,69421,wj8cbMyESeAf93mp00EllV31jkPIrA6z,SpATywNh6bZuzm8s1ceuBUnMUAeoAHHw,7,4,2,0,0,0,7,3,16,2.2857142857142856,1,0.0,0,2,0,0,4,0,0,7,3,2,14,1
2997,69436,vEfGT3eaoianaMgM5zzcNn9WTzHGX3lJ,bWdj2GDclj5ofokWjzoa5jAwMkxCykd6,12,5,4,0,4,0,3,0,16,2.2857142857142856,1,0.0,0,4,0,4,5,0,0,3,0,8,8,1
2998,69445,raxo74HBCa6UxUGfmq3EGBBeCoVCmLfg,SpATywNh6bZuzm8s1ceuBUnMUAeoAHHw,13,26,3,21,1,4,13,1,69,9.857142857142858,2,0.0,11,3,18,1,15,4,3,13,1,33,36,1
2999,69462,SzqR1lIvSkqy1yQXOqGRgT5uhu7VR5Jw,SpATywNh6bZuzm8s1ceuBUnMUAeoAHHw,32,37,22,24,10,12,12,2,119,17.0,3,0.0,5,22,23,10,32,12,1,12,2,60,59,0
3000,69484,RbewLSSgBXbMSLEvzESHw0b6pdUZ0dT1,SpATywNh6bZuzm8s1ceuBUnMUAeoAHHw,15,17,7,0,5,0,2,0,31,4.428571428571429,1,0.0,0,7,0,5,17,0,0,2,0,12,19,1
3001,69488,0n2rFsphNy9JVeuypULNewx4jCGSFGND,bWdj2GDclj5ofokWjzoa5jAwMkxCykd6,5,2,1,0,1,0,2,0,6,0.8571428571428571,1,0.0,0,1,0,1,2,0,0,2,0,2,4,1
3002,69489,pAlH2DhoFB2i4Ut8T7hcWTIp67bJvsYn,SpATywNh6bZuzm8s1ceuBUnMUAeoAHHw,5,2,1,0,1,0,2,0,6,0.8571428571428571,1,0.0,0,1,0,1,2,0,0,2,0,2,4,1
3003,69512,3MwBdkgOXpVBf89tXLybMhGjxxsiq8lW,SpATywNh6bZuzm8s1ceuBUnMUAeoAHHw,5,7,3,0,2,0,2,0,14,2.0,1,0.0,0,3,0,2,7,0,0,2,0,5,9,1
3004,69522,ujYI83byKXzx4VeC0hyxjCKBGRrqMCEx,SpATywNh6bZuzm8s1ceuBUnMUAeoAHHw,6,7,2,0,1,0,2,0,12,1.7142857142857142,1,0.0,0,2,0,1,7,0,0,2,0,3,9,1
3005,69525,wRAgiRhqkN35cIVBbnaU2eOM8fyImml7,SpATywNh6bZuzm8s1ceuBUnMUAeoAHHw,5,2,1,0,1,0,2,0,6,0.8571428571428571,1,0.0,0,1,0,1,2,0,0,2,0,2,4,1
3006,69528,ujAdSwtAMW0jWhrnzge1oByew4uYe5CY,SpATywNh6bZuzm8s1ceuBUnMUAeoAHHw,5,2,1,0,1,0,2,0,6,0.8571428571428571,1,0.0,0,1,0,1,2,0,0,2,0,2,4,1
3007,69550,rY4HuopoXNauFhpb4SYxSCmQkbvhS34C,SpATywNh6bZuzm8s1ceuBUnMUAeoAHHw,17,32,12,18,6,8,7,1,84,12.0,3,0.0,18,12,15,6,14,8,3,7,1,51,33,0
3008,69552,ZAi0jAKRdwQEtga2Yygb9adNtNc26TKH,A3fsA9Zfv1X2fVEQhTw51lKENdNrEqT3,1,0,0,0,0,0,1,0,1,0.14285714285714285,1,0.0,0,0,0,0,0,0,0,1,0,0,1,1
3009,69575,HnVGC3qJM46V1b2wdd4Z0HoEFuWu57RL,A3fsA9Zfv1X2fVEQhTw51lKENdNrEqT3,3,2,0,0,0,0,3,0,5,0.7142857142857143,2,0.0,0,0,0,0,2,0,0,3,0,0,5,1
3010,69598,KYXtOFYh9POr4cq75pjZ8a127l5uxf5U,SpATywNh6bZuzm8s1ceuBUnMUAeoAHHw,20,33,17,20,10,0,4,0,84,12.0,3,0.0,10,17,17,10,23,0,3,4,0,54,30,1
3011,69600,ebvWYER6Bde0EUcNXXIX0vyTB9ur6Kqi,A3fsA9Zfv1X2fVEQhTw51lKENdNrEqT3,6,7,0,0,0,0,2,0,9,1.2857142857142858,2,0.0,0,0,0,0,7,0,0,2,0,0,9,1
3012,69612,kgME9COu6f9ljQ8FhJeUQLVyeGDbkeLG,A3fsA9Zfv1X2fVEQhTw51lKENdNrEqT3,3,3,1,0,0,0,3,0,7,1.0,2,0.0,0,1,0,0,3,0,0,3,0,1,6,0
3013,69634,jnvcTpUtga8frGP2ONxrK4VjvbZCmOcF,A3fsA9Zfv1X2fVEQhTw51lKENdNrEqT3,7,10,0,0,0,0,4,0,14,2.0,2,0.0,3,0,0,0,7,0,0,4,0,3,11,1
3014,69636,xZLWfpPSNmIdAksyQxOWlrAmgCyQKxwi,A3fsA9Zfv1X2fVEQhTw51lKENdNrEqT3,3,2,0,0,0,0,2,0,4,0.5714285714285714,1,0.0,0,0,0,0,2,0,0,2,0,0,4,1
3015,69640,C78Rc70fLP1AFI7RwOL8R7Vch3jy9civ,bWdj2GDclj5ofokWjzoa5jAwMkxCykd6,7,8,1,4,4,0,2,0,19,2.7142857142857144,1,0.0,6,1,4,4,2,0,0,2,0,15,4,1
3016,69642,V5AS4ngknDMHs5ddf49SxlAoYguZsiN3,A3fsA9Zfv1X2fVEQhTw51lKENdNrEqT3,29,9,6,48,2,0,7,1,73,10.428571428571429,2,0.0,1,6,43,2,8,0,5,7,1,52,21,0
3017,69678,zprnKj46wnzt21jHYpriZ9OaUlDuPgz5,SpATywNh6bZuzm8s1ceuBUnMUAeoAHHw,8,6,4,0,3,3,4,0,20,2.857142857142857,1,0.0,0,4,0,3,6,3,0,4,0,7,13,1
3018,69691,C8X9Lf56reSC06tYvkcDbAXogOIv2aQH,SpATywNh6bZuzm8s1ceuBUnMUAeoAHHw,6,3,1,0,1,0,2,0,7,1.0,1,0.0,0,1,0,1,3,0,0,2,0,2,5,1
3019,69711,I8DzhVfDWUcYhRFQ0yqaOgzpzxPiQBKk,bWdj2GDclj5ofokWjzoa5jAwMkxCykd6,6,5,2,0,1,0,3,0,11,1.5714285714285714,1,0.0,0,2,0,1,5,0,0,3,0,3,8,1
3020,69731,mQNenLPD3Qc7tSPYw2VwygE2NmpBhKsk,A3fsA9Zfv1X2fVEQhTw51lKENdNrEqT3,10,3,2,0,2,1,5,3,16,2.2857142857142856,1,0.0,0,2,0,2,3,1,0,5,3,4,12,1
3021,69764,BLvQXA2YaaLZxMBjVQ5Po1TXbL69VEdH,SpATywNh6bZuzm8s1ceuBUnMUAeoAHHw,5,2,1,0,1,0,2,0,6,0.8571428571428571,1,0.0,0,1,0,1,2,0,0,2,0,2,4,1
3022,69770,JgN8P3Oh101qfcWX1dxprWYo04K2OTYg,bWdj2GDclj5ofokWjzoa5jAwMkxCykd6,4,2,1,0,1,0,1,0,5,0.7142857142857143,1,0.0,0,1,0,1,2,0,0,1,0,2,3,1
3023,69778,Lcc8QujJbkTuweBtBrKCB15IfiVLUIVq,A3fsA9Zfv1X2fVEQhTw51lKENdNrEqT3,20,21,15,0,10,0,3,0,49,7.0,2,0.0,1,15,0,10,20,0,0,3,0,26,23,1
3024,69786,231vKE9Ghn3hPwkNFyzJyi0Car52cYe1,bWdj2GDclj5ofokWjzoa5jAwMkxCykd6,1,0,0,0,0,0,1,0,1,0.14285714285714285,1,0.0,0,0,0,0,0,0,0,1,0,0,1,1
3025,69804,RBKGxYBfWpgkY9AF7ooiIKdEMpAJTvzp,bWdj2GDclj5ofokWjzoa5jAwMkxCykd6,1,0,0,0,0,0,1,0,1,0.14285714285714285,1,0.0,0,0,0,0,0,0,0,1,0,0,1,1
3026,69813,UOpfm9RdmrM2DaZfYaiUthWSvj5wRhpf,A3fsA9Zfv1X2fVEQhTw51lKENdNrEqT3,9,4,2,0,1,1,12,0,20,2.857142857142857,2,0.0,0,2,0,1,4,1,0,12,0,3,17,1
3027,69823,pD1s3J2DAVHqxnTOsnHBHGIq9d5lcpqD,SpATywNh6bZuzm8s1ceuBUnMUAeoAHHw,29,48,16,24,7,8,14,1,118,16.857142857142858,5,0.0,17,16,22,7,31,8,2,14,1,62,56,0
3028,69828,RI0oJHr7vWXzPLP3ybfgZBQolmA0lbjl,SpATywNh6bZuzm8s1ceuBUnMUAeoAHHw,25,26,11,30,7,0,3,0,77,11.0,2,0.0,4,11,24,7,22,0,6,3,0,46,31,0
3029,69868,gV1Y6A8RpgDuAD47r6UGF54v9TD2f7uU,SpATywNh6bZuzm8s1ceuBUnMUAeoAHHw,22,26,16,27,9,0,6,0,84,12.0,2,0.0,6,16,24,9,20,0,3,6,0,55,29,0
3030,69870,JosNAk0Jss8nuybl3t8YWavpQFNL43lY,A3fsA9Zfv1X2fVEQhTw51lKENdNrEqT3,13,8,6,0,5,0,7,0,26,3.7142857142857144,2,0.0,0,6,0,5,8,0,0,7,0,11,15,1
3031,69880,wJ6pUrPXT2xprnVlaCeorPmn4kCAli3G,A3fsA9Zfv1X2fVEQhTw51lKENdNrEqT3,44,41,29,70,19,74,14,1,248,35.42857142857143,5,0.0,1,29,55,19,40,74,15,14,1,104,144,1
3032,69900,KXHDxoyacxCXhUbcgqweNNZf38mVEmJs,SpATywNh6bZuzm8s1ceuBUnMUAeoAHHw,14,11,7,16,4,0,2,0,40,5.714285714285714,1,0.0,3,7,14,4,8,0,2,2,0,28,12,1
3033,69902,ZLrfFX2a65pmAVGtiIPK4faxDMnbmzh2,SpATywNh6bZuzm8s1ceuBUnMUAeoAHHw,4,5,2,0,0,0,3,0,10,1.4285714285714286,1,0.0,0,2,0,0,5,0,0,3,0,2,8,1
3034,69906,qowpjfcpUK1iU9rrtJ9U3WvarOVtt4V0,SpATywNh6bZuzm8s1ceuBUnMUAeoAHHw,30,47,28,24,13,16,10,1,139,19.857142857142858,2,0.0,9,28,21,13,38,16,3,10,1,71,68,0
3035,69916,V80I9ihOq6qwBn52j4Qxq5UKfYpTJipj,A3fsA9Zfv1X2fVEQhTw51lKENdNrEqT3,1,0,0,0,0,0,1,0,1,0.14285714285714285,1,0.0,0,0,0,0,0,0,0,1,0,0,1,1
3036,69970,dYC6Q6IXtOHRHCawBvKivQeuFVOWFZ5M,SpATywNh6bZuzm8s1ceuBUnMUAeoAHHw,14,10,7,6,5,1,5,1,35,5.0,2,0.0,1,7,5,5,9,1,1,5,1,18,17,1
3037,69972,6AqVXM3NzhPR7CIRltoRCDhzdk8YVusO,SpATywNh6bZuzm8s1ceuBUnMUAeoAHHw,30,32,18,32,7,9,15,4,117,16.714285714285715,3,0.0,10,18,28,7,22,9,4,15,4,63,54,0
3038,69983,CabsQjb2Sd2I3ynTdtsErAG67rLex08f,SpATywNh6bZuzm8s1ceuBUnMUAeoAHHw,7,3,0,0,0,1,4,1,9,1.2857142857142858,1,0.0,0,0,0,0,3,1,0,4,1,0,9,1
3039,69984,979PHlsnLj7fGUBEOVls6yVfgExSRWl0,SpATywNh6bZuzm8s1ceuBUnMUAeoAHHw,2,0,0,0,0,0,2,0,2,0.2857142857142857,1,0.0,0,0,0,0,0,0,0,2,0,0,2,0
3040,70011,gfov2YfhzgUzN6Vbd3DOhS3J4f6Zpsmw,SpATywNh6bZuzm8s1ceuBUnMUAeoAHHw,17,19,14,19,12,0,2,0,66,9.428571428571429,4,0.0,2,14,16,12,17,0,3,2,0,44,22,1
3041,70019,mRVxG27OAHo6TDwz5EATZqlFWV3ONpTz,SpATywNh6bZuzm8s1ceuBUnMUAeoAHHw,2,0,0,0,0,0,2,0,2,0.2857142857142857,1,0.0,0,0,0,0,0,0,0,2,0,0,2,1
3042,70021,J782awhmjhWAohIOvWifbZTNvhSxGcmf,SpATywNh6bZuzm8s1ceuBUnMUAeoAHHw,14,21,11,0,7,0,9,0,48,6.857142857142857,2,0.0,0,11,0,7,21,0,0,9,0,18,30,1
3043,70042,7VdMdsntecIH9xdStqUN45Z6l4PdR7Lf,SpATywNh6bZuzm8s1ceuBUnMUAeoAHHw,4,4,1,0,0,0,3,0,8,1.1428571428571428,1,0.0,0,1,0,0,4,0,0,3,0,1,7,1
3044,70054,DyupaV8BmUavHjvovvxyDg1D0z37S8dm,SpATywNh6bZuzm8s1ceuBUnMUAeoAHHw,10,9,7,0,5,0,4,0,25,3.5714285714285716,2,0.0,0,7,0,5,9,0,0,4,0,12,13,1
3045,70060,nXqrD0yeRarrFPn56WxkuqRZ3ny2kh9R,SpATywNh6bZuzm8s1ceuBUnMUAeoAHHw,2,0,0,0,0,0,2,0,2,0.2857142857142857,1,0.0,0,0,0,0,0,0,0,2,0,0,2,1
3046,70066,wKNO0Jje7WXvAVQ9yfigFflnCrR4q8AL,A3fsA9Zfv1X2fVEQhTw51lKENdNrEqT3,9,7,4,0,2,0,8,0,21,3.0,2,0.0,0,4,0,2,7,0,0,8,0,6,15,1
3047,70080,lhSfCfPZnDk6mpF0h6gOX9NA2ZuZUrvg,SpATywNh6bZuzm8s1ceuBUnMUAeoAHHw,15,38,5,19,4,1,17,3,87,12.428571428571429,3,0.0,6,5,16,4,32,1,3,17,3,31,56,0
3048,70081,S0YS2NCKuZXB21pPEkAadXWVZsUyQWb2,SpATywNh6bZuzm8s1ceuBUnMUAeoAHHw,9,19,6,0,4,0,6,0,35,5.0,3,0.0,0,6,0,4,19,0,0,6,0,10,25,1
3049,70084,0uULbxMYxykuellS4DES6XbGTfaCngOW,SpATywNh6bZuzm8s1ceuBUnMUAeoAHHw,4,2,0,0,0,0,3,0,5,0.7142857142857143,2,0.0,0,0,0,0,2,0,0,3,0,0,5,1
3050,70086,05tZSn1VpjmBZfEP79jJJrxZA1bk8Ov5,SpATywNh6bZuzm8s1ceuBUnMUAeoAHHw,5,15,5,0,0,0,1,0,21,3.0,4,0.0,3,5,0,0,12,0,0,1,0,8,13,0
3051,70094,vjGeuAzCU9VuvJBAkOsbOGPQ1dhGyEOw,SpATywNh6bZuzm8s1ceuBUnMUAeoAHHw,10,11,1,0,0,0,6,2,20,2.857142857142857,1,0.0,3,1,0,0,8,0,0,6,2,4,16,1
3052,70097,0uULbxMYxykuellS4DES6XbGTfaCngOW,bWdj2GDclj5ofokWjzoa5jAwMkxCykd6,6,4,0,10,1,0,2,0,17,2.4285714285714284,1,0.0,2,0,10,1,2,0,0,2,0,13,4,1
3053,70112,CNg7OyU6zWgKAN5K0oJtHsglhaU3oGQ9,SpATywNh6bZuzm8s1ceuBUnMUAeoAHHw,5,4,1,0,1,0,1,0,7,1.0,1,0.0,0,1,0,1,4,0,0,1,0,2,5,1
3054,70113,xPyi5tVWLdzwESKbVSwWQTZrKjlUSal4,bWdj2GDclj5ofokWjzoa5jAwMkxCykd6,2,0,0,0,0,0,2,0,2,0.2857142857142857,1,0.0,0,0,0,0,0,0,0,2,0,0,2,1
3055,70117,Unmtjjmp5vQtsUKiq2OfCGrdrro6CfzN,SpATywNh6bZuzm8s1ceuBUnMUAeoAHHw,31,148,77,34,14,177,44,1,495,70.71428571428571,9,0.0,42,77,30,14,106,177,4,44,1,163,332,0
3056,70118,ynRrL3n4SK143BrBaMe5mVlDwKfYLlFe,SpATywNh6bZuzm8s1ceuBUnMUAeoAHHw,5,2,1,0,1,0,2,0,6,0.8571428571428571,1,0.0,0,1,0,1,2,0,0,2,0,2,4,1
3057,70130,r9R01U9QisCDxxLmorZFQ60ReGG1wPEx,SpATywNh6bZuzm8s1ceuBUnMUAeoAHHw,20,17,16,0,13,0,3,0,49,7.0,1,0.0,0,16,0,13,17,0,0,3,0,29,20,1
3058,70141,j4hecXKY3USBQpRwMuzKA9d9SPzBKhRY,SpATywNh6bZuzm8s1ceuBUnMUAeoAHHw,6,7,0,0,0,0,2,0,9,1.2857142857142858,1,0.0,3,0,0,0,4,0,0,2,0,3,6,1
3059,70364,d11XQPw4CaDnMkkvSEo4JqU6avErSb1R,fbPkOYLVPtPgIt0MxizjfFJov3JbHyAi,5,2,1,0,1,9,8,0,21,3.0,1,0.0,0,1,0,1,2,9,0,8,0,2,19,1
3060,70383,Op31ey1e8ia2T8lQ6kca7MllnthYRRtp,fbPkOYLVPtPgIt0MxizjfFJov3JbHyAi,15,21,13,8,4,11,16,5,78,11.142857142857142,3,0.0,4,13,8,4,17,11,0,16,5,29,49,1
3061,70408,rPtP72DMEyNlpUomeqVVqrg44j30SIpW,fbPkOYLVPtPgIt0MxizjfFJov3JbHyAi,9,10,7,0,3,16,7,1,44,6.285714285714286,2,0.0,0,7,0,3,10,16,0,7,1,10,34,1
3062,70416,TkGkraxFZeISMMLd87fcbklBTVTLGOhm,fbPkOYLVPtPgIt0MxizjfFJov3JbHyAi,18,17,11,10,8,7,10,1,64,9.142857142857142,1,0.0,5,11,9,8,12,7,1,10,1,33,31,1
3063,70483,F8PplJ0MdSBFJMkvQSa7z6RMAQvcxOkt,fbPkOYLVPtPgIt0MxizjfFJov3JbHyAi,4,7,0,0,0,1,2,0,10,1.4285714285714286,3,0.0,0,0,0,0,7,1,0,2,0,0,10,0
3064,70499,R0fqJCKSDdlape9O3QiJvxhX8OJnijdc,fbPkOYLVPtPgIt0MxizjfFJov3JbHyAi,7,4,3,0,1,0,6,0,14,2.0,1,0.0,0,3,0,1,4,0,0,6,0,4,10,1
3065,70619,EUbYS528SLpUvydqHGhniNAZDkRxQSUM,fbPkOYLVPtPgIt0MxizjfFJov3JbHyAi,1,0,0,0,0,0,1,0,1,0.14285714285714285,1,0.0,0,0,0,0,0,0,0,1,0,0,1,1
3066,70621,w0u223fmMcj8R0XYvkRYTxBWPO2H34gs,fbPkOYLVPtPgIt0MxizjfFJov3JbHyAi,10,8,6,9,5,0,3,0,31,4.428571428571429,2,0.0,1,6,6,5,7,0,3,3,0,18,13,0
3067,70628,cDndPN0bU03X7W27vQCXFKmVpa2a5fXn,fbPkOYLVPtPgIt0MxizjfFJov3JbHyAi,6,3,2,0,0,1,4,1,11,1.5714285714285714,1,0.0,0,2,0,0,3,1,0,4,1,2,9,1
3068,70630,6BV3xjXq9ekiRfYm3O3pN6jZMMACVAnm,fbPkOYLVPtPgIt0MxizjfFJov3JbHyAi,1,0,0,0,0,0,1,0,1,0.14285714285714285,1,0.0,0,0,0,0,0,0,0,1,0,0,1,0
3069,70631,zhUkf3kMMzWlXsKEezEHBm9LsgVJDdTP,fbPkOYLVPtPgIt0MxizjfFJov3JbHyAi,5,2,1,0,1,0,10,0,14,2.0,2,0.0,0,1,0,1,2,0,0,10,0,2,12,1
3070,70633,PnTAr4JQ7W1gITYEASL2GPQdvilj2Kny,fbPkOYLVPtPgIt0MxizjfFJov3JbHyAi,3,2,0,0,0,0,1,0,3,0.42857142857142855,1,0.0,0,0,0,0,2,0,0,1,0,0,3,1
3071,70634,HU8ThwxdRuW919irq38IcjLXhEvT4bai,fbPkOYLVPtPgIt0MxizjfFJov3JbHyAi,9,9,6,0,4,1,12,0,32,4.571428571428571,2,0.0,0,6,0,4,9,1,0,12,0,10,22,1
3072,70639,NjNUHcUgwvm9xYQvil0yjwq6PWKHWHr6,fbPkOYLVPtPgIt0MxizjfFJov3JbHyAi,7,3,2,0,1,4,13,0,23,3.2857142857142856,2,0.0,0,2,0,1,3,4,0,13,0,3,20,1
3073,70640,KqGhfmSqWtSa4SJELlmAXcwsyTwdeOL4,fbPkOYLVPtPgIt0MxizjfFJov3JbHyAi,7,6,4,0,4,0,2,0,16,2.2857142857142856,1,0.0,1,4,0,4,5,0,0,2,0,9,7,1
3074,70643,cdEsk1qpGnOY8M8xILMNOVhPCtmvS3gr,fbPkOYLVPtPgIt0MxizjfFJov3JbHyAi,7,3,2,0,2,0,4,0,11,1.5714285714285714,1,0.0,0,2,0,2,3,0,0,4,0,4,7,1
3075,70645,sikVclrYgcpS3p4V6eW44EtX4b5SsNLE,fbPkOYLVPtPgIt0MxizjfFJov3JbHyAi,11,30,1,3,8,4,3,0,49,7.0,1,0.0,20,1,3,8,10,4,0,3,0,32,17,1
3076,70650,kbSUu2Z40fu4lSlgv22Wu70hAt5BnJoC,fbPkOYLVPtPgIt0MxizjfFJov3JbHyAi,22,45,0,12,6,52,16,1,132,18.857142857142858,4,0.0,21,0,10,6,24,52,2,16,1,37,95,1
3077,70654,LAVkRDyEDRYFfA0FMc6U4JnWPWsDLjhi,fbPkOYLVPtPgIt0MxizjfFJov3JbHyAi,7,12,1,0,2,0,3,0,18,2.5714285714285716,1,0.0,2,1,0,2,10,0,0,3,0,5,13,1
3078,70660,J1bBTxr7xQhu6wEykZt3Bd9gSlmRIWmq,fbPkOYLVPtPgIt0MxizjfFJov3JbHyAi,2,0,0,0,0,0,3,0,3,0.42857142857142855,1,0.0,0,0,0,0,0,0,0,3,0,0,3,1
3079,70662,u3wB3K0Js3pmFsJGQpe7V7v42hnAvDay,fbPkOYLVPtPgIt0MxizjfFJov3JbHyAi,5,2,1,0,1,0,4,0,8,1.1428571428571428,2,0.0,0,1,0,1,2,0,0,4,0,2,6,1
3080,70663,EpLshGb6fxFM19N1QN5M0uUEP2YQoz65,fbPkOYLVPtPgIt0MxizjfFJov3JbHyAi,6,6,2,0,2,0,5,0,15,2.142857142857143,1,0.0,2,2,0,2,4,0,0,5,0,6,9,1
3081,70665,jWXtvduhcSeQYRX8KBGNnUGlWXZhf8j7,fbPkOYLVPtPgIt0MxizjfFJov3JbHyAi,7,4,2,0,1,0,9,0,16,2.2857142857142856,1,0.0,0,2,0,1,4,0,0,9,0,3,13,1
3082,70667,m6MSFO9wulR4Nf5CljOSKizOwoCC2JYl,fbPkOYLVPtPgIt0MxizjfFJov3JbHyAi,21,44,19,21,14,25,6,0,129,18.428571428571427,4,0.0,20,19,15,14,24,25,6,6,0,68,61,1
3083,70668,6Bdl0MkwJ5lZUJnVsPp6IjSTHrXnqeTx,fbPkOYLVPtPgIt0MxizjfFJov3JbHyAi,2,0,0,0,0,0,9,0,9,1.2857142857142858,1,0.0,0,0,0,0,0,0,0,9,0,0,9,1
3084,70671,RMxcBkJoAGieBk6NcKXJqusraN8qxLZ7,fbPkOYLVPtPgIt0MxizjfFJov3JbHyAi,1,0,0,0,0,0,1,0,1,0.14285714285714285,1,0.0,0,0,0,0,0,0,0,1,0,0,1,1
3085,70673,RyoftXJlSPPQnlnD7mk7JNhtKBWRLRWG,fbPkOYLVPtPgIt0MxizjfFJov3JbHyAi,2,0,0,0,0,0,5,0,5,0.7142857142857143,1,0.0,0,0,0,0,0,0,0,5,0,0,5,1
3086,70679,YXIqJ6spT3Ja1ygrmNWuBLibK013t0q5,fbPkOYLVPtPgIt0MxizjfFJov3JbHyAi,1,0,0,0,0,0,1,0,1,0.14285714285714285,1,0.0,0,0,0,0,0,0,0,1,0,0,1,1
3087,70680,I2YlhnUPXZKF2nHJmVrtwRFgGB2nHSiZ,fbPkOYLVPtPgIt0MxizjfFJov3JbHyAi,9,12,3,0,3,1,8,1,28,4.0,1,0.0,6,3,0,3,6,1,0,8,1,12,16,1
3088,70681,XSTWk85DGQnV3ClLFIpSnGKTu2dEFPYv,fbPkOYLVPtPgIt0MxizjfFJov3JbHyAi,6,1,1,0,1,0,8,0,11,1.5714285714285714,1,0.0,0,1,0,1,1,0,0,8,0,2,9,1
3089,70686,NUUrfkmQ6PTn8vYLlenz4k9BmiPCmi7I,fbPkOYLVPtPgIt0MxizjfFJov3JbHyAi,5,3,2,0,0,0,2,0,7,1.0,1,0.0,0,2,0,0,3,0,0,2,0,2,5,0
3090,70692,6qrT2bYbFD0verDQZWOnrOjhEccqo56g,fbPkOYLVPtPgIt0MxizjfFJov3JbHyAi,45,148,64,28,44,122,40,2,448,64.0,11,0.0,58,64,27,44,90,122,1,40,2,193,255,0
3091,70935,JiFgudQA4nZtHR8rdanNuKW7boGcferp,SpATywNh6bZuzm8s1ceuBUnMUAeoAHHw,11,10,7,0,6,0,3,0,26,3.7142857142857144,1,0.0,0,7,0,6,10,0,0,3,0,13,13,1
3092,71104,zxmge3ZElgX2vkJ2cCOzkeMQCnk45k6Y,G8EPVSXsOYB5YQWZGiz1aVq5Pgr2GrQu,3,2,1,0,0,0,1,0,4,0.5714285714285714,1,0.0,0,1,0,0,2,0,0,1,0,1,3,1
3093,71277,ZzEeIm98vbP9lRunZYePLW46UyhiVxbR,bWdj2GDclj5ofokWjzoa5jAwMkxCykd6,5,6,2,0,1,0,2,0,11,1.5714285714285714,1,0.0,0,2,0,1,6,0,0,2,0,3,8,1
3094,71279,YYCI1ivPCDRa3x25VBUTnS1EqXk51k7P,A3fsA9Zfv1X2fVEQhTw51lKENdNrEqT3,42,24,18,70,11,11,7,1,142,20.285714285714285,2,0.0,2,18,60,11,22,11,10,7,1,91,51,1
3095,71280,YUT6CW7iSh1xoUpF2nfmR8w0ThlxeIYe,SpATywNh6bZuzm8s1ceuBUnMUAeoAHHw,1,0,0,0,0,0,1,0,1,0.14285714285714285,1,0.0,0,0,0,0,0,0,0,1,0,0,1,0
3096,71358,WfFzDu02yVQhznDpti9qz88KkaHNMAz5,SpATywNh6bZuzm8s1ceuBUnMUAeoAHHw,14,9,7,0,7,0,14,0,37,5.285714285714286,5,0.0,0,7,0,7,9,0,0,14,0,14,23,1
3097,71426,onsmNYIoPFEi185f5ZLsQXD70I3K25Cb,bWdj2GDclj5ofokWjzoa5jAwMkxCykd6,6,9,1,16,1,0,2,0,29,4.142857142857143,1,0.0,5,1,15,1,4,0,1,2,0,22,7,1
3098,71611,KWdhtnEkrke9rgi3l1csNclNjZVhn1s4,SpATywNh6bZuzm8s1ceuBUnMUAeoAHHw,20,126,5,17,0,58,38,15,259,37.0,7,0.0,4,5,14,0,122,58,3,38,15,23,236,1
3099,71759,foGsrANktd6dCLnplglYgW0LYGi2yeuV,bWdj2GDclj5ofokWjzoa5jAwMkxCykd6,4,2,1,0,1,0,2,0,6,0.8571428571428571,1,0.0,0,1,0,1,2,0,0,2,0,2,4,1
3100,71829,n1JdH8HPXOUoCHQIEd4YCo0nlAshsKdG,SpATywNh6bZuzm8s1ceuBUnMUAeoAHHw,19,18,10,19,3,2,11,2,65,9.285714285714286,2,0.0,4,10,16,3,14,2,3,11,2,33,32,0
3101,71860,kTJIJds7bRsw0KFlLhCoB2PivF66Tf3q,A3fsA9Zfv1X2fVEQhTw51lKENdNrEqT3,8,6,3,0,1,0,7,1,18,2.5714285714285716,2,0.0,0,3,0,1,6,0,0,7,1,4,14,1
3102,71865,nvXkSuJjNwPy4x4PN83PXogIa9iXtJsm,A3fsA9Zfv1X2fVEQhTw51lKENdNrEqT3,13,6,5,0,5,0,3,0,19,2.7142857142857144,2,0.0,0,5,0,5,6,0,0,3,0,10,9,1
3103,71892,AimQk6bFhhGPpMH9HY88V7PvSxxOwe07,SpATywNh6bZuzm8s1ceuBUnMUAeoAHHw,5,2,1,0,1,0,2,0,6,0.8571428571428571,1,0.0,0,1,0,1,2,0,0,2,0,2,4,1
3104,71961,LyDM0yrwn8zKtQsuxEGqFMxdhffaZNVY,A3fsA9Zfv1X2fVEQhTw51lKENdNrEqT3,9,10,1,0,1,0,4,0,16,2.2857142857142856,1,0.0,0,1,0,1,10,0,0,4,0,2,14,1
3105,71999,Pe5WMotTf5HMq3hNpICq7pbnjQeqT1z5,SpATywNh6bZuzm8s1ceuBUnMUAeoAHHw,14,12,9,4,5,15,5,0,50,7.142857142857143,2,0.0,1,9,4,5,11,15,0,5,0,19,31,0
3106,72086,0LMHRy44jwjr4gUThAzfzfGCUeg2Lm1J,SpATywNh6bZuzm8s1ceuBUnMUAeoAHHw,17,47,26,17,9,67,16,0,182,26.0,3,0.0,11,26,14,9,36,67,3,16,0,60,122,1
3107,72120,a8HvMkBRr1QnoDxivZVIhrkeiZFWplka,A3fsA9Zfv1X2fVEQhTw51lKENdNrEqT3,11,14,9,0,7,0,4,0,34,4.857142857142857,3,0.0,0,9,0,7,14,0,0,4,0,16,18,1
3108,72128,6oNhI3z3lPtYcSpGC1lnWpyyeDMBUOtK,SpATywNh6bZuzm8s1ceuBUnMUAeoAHHw,5,2,1,0,1,0,2,0,6,0.8571428571428571,1,0.0,0,1,0,1,2,0,0,2,0,2,4,1
3109,72133,2qQuu2Qhkw7hRYngnGfnNzXYklrDkMwy,SpATywNh6bZuzm8s1ceuBUnMUAeoAHHw,16,25,4,20,2,0,7,0,58,8.285714285714286,4,0.0,5,4,17,2,20,0,3,7,0,28,30,1
3110,72150,dDLv4oouOmVB45Y4hnRyV7IUqT7tMKiq,A3fsA9Zfv1X2fVEQhTw51lKENdNrEqT3,52,43,28,100,15,8,19,2,215,30.714285714285715,3,0.0,6,28,81,15,37,8,19,19,2,130,85,0
3111,72158,kiNfuRpgeROReVuBtap1KwDDZc9hG55i,A3fsA9Zfv1X2fVEQhTw51lKENdNrEqT3,9,2,1,0,1,0,6,1,11,1.5714285714285714,1,0.0,0,1,0,1,2,0,0,6,1,2,9,1
3112,72169,Lb7wmhbhC16FSS5Xq3dqazq7PwTHyvZu,bWdj2GDclj5ofokWjzoa5jAwMkxCykd6,4,2,1,0,1,0,1,0,5,0.7142857142857143,1,0.0,0,1,0,1,2,0,0,1,0,2,3,1
3113,72222,Fdt86Xu5OLPdaOgl6M1XDpiJ3zar7SU6,RXDvfPUBYFlVdlueBFbLW0mhhAyGEqpt,22,14,10,38,7,1,5,1,76,10.857142857142858,1,0.0,3,10,30,7,11,1,8,5,1,50,26,1
3114,72255,H9uyY7qx5i6ZDOUonFHaANKxCA5aZsQi,G8EPVSXsOYB5YQWZGiz1aVq5Pgr2GrQu,24,27,2,52,3,0,7,0,91,13.0,2,0.0,12,2,42,3,15,0,10,7,0,59,32,1
3115,72280,Daw06K1PSOXldo19kBgHP5sewulb7Vu5,RXDvfPUBYFlVdlueBFbLW0mhhAyGEqpt,1,0,0,0,0,0,1,0,1,0.14285714285714285,1,0.0,0,0,0,0,0,0,0,1,0,0,1,1
3116,72303,hrPjKcL9rUfM1fnC8qta4lu2HmlsBLv6,RXDvfPUBYFlVdlueBFbLW0mhhAyGEqpt,24,28,2,24,2,0,17,0,73,10.428571428571429,2,0.0,7,2,22,2,21,0,2,17,0,33,40,0
3117,72333,uqA5Smdw6BACOcL0f2tmxwTTxZXBpZpE,bWdj2GDclj5ofokWjzoa5jAwMkxCykd6,4,2,1,0,1,0,1,0,5,0.7142857142857143,1,0.0,0,1,0,1,2,0,0,1,0,2,3,1
3118,72390,L6W8jpUrnYiTQTQzsQIQrX6pgKIdMfa4,SpATywNh6bZuzm8s1ceuBUnMUAeoAHHw,9,3,2,0,2,0,5,0,12,1.7142857142857142,1,0.0,0,2,0,2,3,0,0,5,0,4,8,1
3119,72392,dQQ8UnfzoKHmhQlZOaaW0cB14DhE2hvY,A3fsA9Zfv1X2fVEQhTw51lKENdNrEqT3,33,36,0,58,0,3,7,0,104,14.857142857142858,3,0.0,6,0,51,0,30,3,7,7,0,57,47,0
3120,72455,tAelht5FQdpcbtZQoKgvZA90XQy6zeRb,RXDvfPUBYFlVdlueBFbLW0mhhAyGEqpt,11,12,1,0,1,1,2,4,21,3.0,1,0.0,2,1,0,1,10,1,0,2,4,4,17,1
3121,72456,IP3TW53lg1ZMqNldZdGWMD6MaLDRhhOf,SpATywNh6bZuzm8s1ceuBUnMUAeoAHHw,14,10,6,15,3,0,3,0,37,5.285714285714286,2,0.0,2,6,14,3,8,0,1,3,0,25,12,1
3122,72476,gpgk1aIkjyvlgo7OYZtMXPlVgE39gvnr,SpATywNh6bZuzm8s1ceuBUnMUAeoAHHw,19,42,18,15,8,2,12,1,98,14.0,3,0.0,15,18,13,8,27,2,2,12,1,54,44,0
3123,72533,kPw5nR6GIfIGfnUDhfrz9sq3P6l2CmOK,RXDvfPUBYFlVdlueBFbLW0mhhAyGEqpt,21,38,24,16,12,14,7,0,111,15.857142857142858,4,0.0,5,24,14,12,33,14,2,7,0,55,56,1
3124,72564,R5b7anZZznZcISIbyICZwboB1D1ac57s,SpATywNh6bZuzm8s1ceuBUnMUAeoAHHw,4,1,0,0,0,0,3,0,4,0.5714285714285714,1,0.0,0,0,0,0,1,0,0,3,0,0,4,1
3125,72621,RDShgnILA5yAnXM7kXsfq5adI49HPdeC,A3fsA9Zfv1X2fVEQhTw51lKENdNrEqT3,1,0,0,0,0,0,1,0,1,0.14285714285714285,1,0.0,0,0,0,0,0,0,0,1,0,0,1,1
3126,72649,rPY59o3LLmGBPTPMGcA5vX57KVfmywv5,A3fsA9Zfv1X2fVEQhTw51lKENdNrEqT3,1,0,0,0,0,0,1,0,1,0.14285714285714285,1,0.0,0,0,0,0,0,0,0,1,0,0,1,1
3127,72667,9FaPBbsYKn0C9myyRYf9vYNhns2eJDpD,A3fsA9Zfv1X2fVEQhTw51lKENdNrEqT3,5,4,2,0,1,0,4,0,11,1.5714285714285714,2,0.0,0,2,0,1,4,0,0,4,0,3,8,1
3128,72686,JoqAGqbao71wc04PyVzx7SVvlZZ0knbI,A3fsA9Zfv1X2fVEQhTw51lKENdNrEqT3,51,37,16,116,3,39,13,0,224,32.0,6,0.0,4,16,115,3,33,39,1,13,0,138,86,0
3129,72758,IU4mzAYv3AON3EBKGRzZhQZqrR0hM5uu,SpATywNh6bZuzm8s1ceuBUnMUAeoAHHw,13,13,7,14,5,22,4,0,65,9.285714285714286,2,0.0,3,7,13,5,10,22,1,4,0,28,37,1
3130,72780,DLQjQ8KI2pm8VfJepKRqQrT7eYq3mD8r,RXDvfPUBYFlVdlueBFbLW0mhhAyGEqpt,27,26,20,0,12,2,9,1,70,10.0,1,0.0,3,20,0,12,23,2,0,9,1,35,35,0
3131,72848,pQdSl7i5ZuZeH9uPILgdHrvwskp4vc4V,bWdj2GDclj5ofokWjzoa5jAwMkxCykd6,2,0,0,0,0,0,2,0,2,0.2857142857142857,1,0.0,0,0,0,0,0,0,0,2,0,0,2,1
3132,72936,oIV4CHUFSVzLmdvea6ZMZ3tpsiIb8a2U,RXDvfPUBYFlVdlueBFbLW0mhhAyGEqpt,21,45,3,16,4,0,7,1,76,10.857142857142858,2,0.0,10,3,14,4,35,0,2,7,1,31,45,0
3133,73001,NlHO5hXiy7TmVTHiRgExH6y7p9gJG1YF,A3fsA9Zfv1X2fVEQhTw51lKENdNrEqT3,11,9,6,0,5,0,3,0,23,3.2857142857142856,2,0.0,0,6,0,5,9,0,0,3,0,11,12,1
3134,73101,AeXY5V6bNirN94d0GfQQQX1fFim1uqSr,SpATywNh6bZuzm8s1ceuBUnMUAeoAHHw,1,0,0,0,0,0,2,0,2,0.2857142857142857,2,0.0,0,0,0,0,0,0,0,2,0,0,2,0
3135,73110,TOybu3VTl57Gwz61jxLAAYZF2xYkGB5M,SpATywNh6bZuzm8s1ceuBUnMUAeoAHHw,25,17,13,12,7,7,5,0,61,8.714285714285714,1,0.0,0,13,10,7,17,7,2,5,0,30,31,1
3136,73144,rSEfJyHxNlxmmbC9ORIbqcFKKq08QDrh,bWdj2GDclj5ofokWjzoa5jAwMkxCykd6,9,11,5,0,2,11,7,0,36,5.142857142857143,2,0.0,0,5,0,2,11,11,0,7,0,7,29,0
3137,73502,UGYGSfRkJhOkgkdlCI6YSCshpNvwBF31,fbPkOYLVPtPgIt0MxizjfFJov3JbHyAi,6,6,4,0,1,0,6,0,17,2.4285714285714284,1,0.0,0,4,0,1,6,0,0,6,0,5,12,1
3138,73504,50aSuabL02e7lLNBHTRXsMQnBChV2lSX,fbPkOYLVPtPgIt0MxizjfFJov3JbHyAi,7,5,2,0,2,0,4,0,13,1.8571428571428572,1,0.0,0,2,0,2,5,0,0,4,0,4,9,1
3139,73508,YNIWjVVReCMnb4p25EmH6YanIJI1UWGe,fbPkOYLVPtPgIt0MxizjfFJov3JbHyAi,4,2,0,0,0,0,4,0,6,0.8571428571428571,1,0.0,0,0,0,0,2,0,0,4,0,0,6,1
3140,73518,mEXms676UX2nEtOWi785T3a9YDRXn6eo,fbPkOYLVPtPgIt0MxizjfFJov3JbHyAi,7,6,1,0,1,3,4,1,16,2.2857142857142856,2,0.0,0,1,0,1,6,3,0,4,1,2,14,1
3141,73519,BjBet1XrpmufRo3nJSBrADvKxDiooNdd,fbPkOYLVPtPgIt0MxizjfFJov3JbHyAi,1,0,0,0,0,0,1,0,1,0.14285714285714285,1,0.0,0,0,0,0,0,0,0,1,0,0,1,1
3142,73546,ffYbnIyANDjzLf3ELTXl50wDF2eVsyNm,fbPkOYLVPtPgIt0MxizjfFJov3JbHyAi,2,0,0,0,0,0,2,0,2,0.2857142857142857,1,0.0,0,0,0,0,0,0,0,2,0,0,2,1
3143,73906,oXeIIZJhS8XqLTW0ryKumqV3ZtrZlFuh,7GRhBDsirIGkRZBtSMEzNTyDr2JQm4xx,42,71,18,55,20,3,14,0,181,25.857142857142858,4,0.0,27,18,47,20,44,3,8,14,0,112,69,1
3144,73908,4sCPuVlkq4rBRlBYNyTR5EDg94co1oy4,7GRhBDsirIGkRZBtSMEzNTyDr2JQm4xx,28,49,18,34,12,0,4,0,117,16.714285714285715,3,0.0,27,18,28,12,22,0,6,4,0,85,32,1
3145,73928,VBP5PzVQEKJYFH0y5ffEek5WfP9EW7uc,7GRhBDsirIGkRZBtSMEzNTyDr2JQm4xx,17,16,10,10,8,0,4,0,48,6.857142857142857,2,0.0,3,10,9,8,13,0,1,4,0,30,18,1
3146,73935,ZjAnj7LejyrDjdytaW8xiEftNjkACZgi,7GRhBDsirIGkRZBtSMEzNTyDr2JQm4xx,31,48,22,43,16,0,10,2,141,20.142857142857142,2,0.0,19,22,40,16,29,0,3,10,2,97,44,1
3147,73953,7VDn6ntyPpx1GsPLNVgZQF03WDWTuKJo,bWdj2GDclj5ofokWjzoa5jAwMkxCykd6,38,91,55,126,15,24,27,0,338,48.285714285714285,5,0.0,11,55,107,15,80,24,19,27,0,188,150,0
3148,73956,ks4Bg3QCnzBSrFPW18QfINyVAhl01iQP,7GRhBDsirIGkRZBtSMEzNTyDr2JQm4xx,1,0,0,0,0,0,1,0,1,0.14285714285714285,1,0.0,0,0,0,0,0,0,0,1,0,0,1,1
3149,73959,UNKWHkTsZ3RudPGKkhB4ao4XLNWXegZ9,7GRhBDsirIGkRZBtSMEzNTyDr2JQm4xx,25,49,2,84,7,7,8,1,158,22.571428571428573,2,0.0,31,2,72,7,18,7,12,8,1,112,46,1
3150,73967,31aB1n1dsQQ1ksrWlX8ZehnLm4yKoPC4,7GRhBDsirIGkRZBtSMEzNTyDr2JQm4xx,1,0,0,0,0,0,2,0,2,0.2857142857142857,2,0.0,0,0,0,0,0,0,0,2,0,0,2,1
3151,73968,fwlGH5gehdOA0f9hZd0xb19Diqa5Heyh,7GRhBDsirIGkRZBtSMEzNTyDr2JQm4xx,4,2,1,0,0,0,3,0,6,0.8571428571428571,1,0.0,0,1,0,0,2,0,0,3,0,1,5,1
3152,73980,4sSRGcSDSLzxYWcglxw7d9PzYXxgOT88,7GRhBDsirIGkRZBtSMEzNTyDr2JQm4xx,5,4,1,0,0,1,2,0,8,1.1428571428571428,2,0.0,0,1,0,0,4,1,0,2,0,1,7,1
3153,73985,58MUEzrczRikT4gXBjyXknuMU1aGIyQK,7GRhBDsirIGkRZBtSMEzNTyDr2JQm4xx,1,0,0,0,0,0,1,0,1,0.14285714285714285,1,0.0,0,0,0,0,0,0,0,1,0,0,1,1
3154,74021,EPmLjBxeWpwhjwoRgtmLV8RkhFOu2zzj,A3fsA9Zfv1X2fVEQhTw51lKENdNrEqT3,2,0,0,0,0,0,2,0,2,0.2857142857142857,1,0.0,0,0,0,0,0,0,0,2,0,0,2,1
3155,74035,79Eh0WdhadJNiwxQWsLXR8INp63Y21nq,7GRhBDsirIGkRZBtSMEzNTyDr2JQm4xx,9,19,5,6,3,2,7,0,42,6.0,1,0.0,7,5,5,3,12,2,1,7,0,20,22,1
3156,74062,1cBYtB7KOC3ODHrTHPWmdxuvdPQZ4YhT,SpATywNh6bZuzm8s1ceuBUnMUAeoAHHw,4,2,1,0,1,0,1,0,5,0.7142857142857143,1,0.0,0,1,0,1,2,0,0,1,0,2,3,0
3157,74067,ve7Ft3pn5zWGBanwhSnSQvIFg9ZaO7O3,7GRhBDsirIGkRZBtSMEzNTyDr2JQm4xx,1,0,0,0,0,0,1,0,1,0.14285714285714285,1,0.0,0,0,0,0,0,0,0,1,0,0,1,1
3158,74101,Uvr135kFC9KlMOM943bFXvTUT71uSm4O,G8EPVSXsOYB5YQWZGiz1aVq5Pgr2GrQu,17,19,9,8,7,2,9,1,55,7.857142857142857,1,0.0,7,9,6,7,12,2,2,9,1,29,26,0
3159,74104,7TkkuA0EEQqi6jLSaHSvDaS7U5kNSv36,SpATywNh6bZuzm8s1ceuBUnMUAeoAHHw,20,49,16,25,5,7,24,5,131,18.714285714285715,5,0.0,14,16,23,5,35,7,2,24,5,58,73,0
3160,74107,0oxo9rZM5dGgpN8rq6aFGU3IpbIKGlK0,7GRhBDsirIGkRZBtSMEzNTyDr2JQm4xx,7,6,4,0,2,0,2,0,14,2.0,1,0.0,0,4,0,2,6,0,0,2,0,6,8,1
3161,74125,FxNNtpAKePULpDZjsrs8zCvX1MSFauHF,7GRhBDsirIGkRZBtSMEzNTyDr2JQm4xx,29,32,11,45,13,1,2,0,104,14.857142857142858,1,0.0,20,11,42,13,12,1,3,2,0,86,18,1
3162,74139,gVHbwM9IOrk1olFEuw0FAfVujUgJm8AG,7GRhBDsirIGkRZBtSMEzNTyDr2JQm4xx,37,101,27,62,14,14,21,2,241,34.42857142857143,4,0.0,67,27,56,14,34,14,6,21,2,164,77,0
3163,74149,mWao7cvXlyZJViXXeBzOOV4p4AC8rvCX,7GRhBDsirIGkRZBtSMEzNTyDr2JQm4xx,35,53,19,38,20,1,18,1,150,21.428571428571427,2,0.0,33,19,32,20,20,1,6,18,1,104,46,1
3164,74167,qEQGNCv0DTznAP1gMwDRVGTAjB8ymoH3,7GRhBDsirIGkRZBtSMEzNTyDr2JQm4xx,1,0,0,0,0,0,1,0,1,0.14285714285714285,1,0.0,0,0,0,0,0,0,0,1,0,0,1,1
3165,74213,Hzo5Ctg10ZQey5IjMeCvl0CH7lPNTM5X,7GRhBDsirIGkRZBtSMEzNTyDr2JQm4xx,2,0,0,0,0,0,4,0,4,0.5714285714285714,2,0.0,0,0,0,0,0,0,0,4,0,0,4,1
3166,74244,ipQCHpy6wiUwlX5KYwBvpzBdqgm7xLba,7GRhBDsirIGkRZBtSMEzNTyDr2JQm4xx,5,2,1,0,1,0,2,0,6,0.8571428571428571,1,0.0,0,1,0,1,2,0,0,2,0,2,4,1
3167,74301,WCAIb19YcAzAlp07XtATiiwpdzMqbAbp,7GRhBDsirIGkRZBtSMEzNTyDr2JQm4xx,21,26,12,39,4,0,2,0,83,11.857142857142858,1,0.0,13,12,35,4,13,0,4,2,0,64,19,0
3168,74334,ovvuiEhj0QBv4xi11GVjXr8JhlCgaPmd,SpATywNh6bZuzm8s1ceuBUnMUAeoAHHw,26,42,22,22,16,0,23,0,125,17.857142857142858,3,0.0,8,22,19,16,34,0,3,23,0,65,60,0
3169,74386,QlvFciinGDGt7csjDmjYPPZqFlKAzfUP,SpATywNh6bZuzm8s1ceuBUnMUAeoAHHw,23,33,6,13,5,2,7,1,67,9.571428571428571,2,0.0,9,6,12,5,24,2,1,7,1,32,35,0
3170,74408,Ra9AxcPuu5j5vTOkoJFrcEzyHUcLxhn0,7GRhBDsirIGkRZBtSMEzNTyDr2JQm4xx,6,2,1,0,1,0,4,0,8,1.1428571428571428,1,0.0,0,1,0,1,2,0,0,4,0,2,6,1
3171,74468,rgJ7j684KtaDcmKD94RFdpwPnoKFUmIV,7GRhBDsirIGkRZBtSMEzNTyDr2JQm4xx,22,23,16,30,9,9,4,0,91,13.0,3,0.0,2,16,26,9,21,9,4,4,0,53,38,1
3172,74473,GVRJN4wkoooaXJUVmwnX983A87KsrZPK,7GRhBDsirIGkRZBtSMEzNTyDr2JQm4xx,4,2,1,0,1,0,1,0,5,0.7142857142857143,1,0.0,0,1,0,1,2,0,0,1,0,2,3,1
3173,74509,QfBD8mMClwgY0rD8w1rSnRjdXKLH7oSP,7GRhBDsirIGkRZBtSMEzNTyDr2JQm4xx,2,0,0,0,0,0,3,0,3,0.42857142857142855,1,0.0,0,0,0,0,0,0,0,3,0,0,3,1
3174,74529,YfLkHn3sP8pusiYlKK6o5F2jXKBNkL8d,SpATywNh6bZuzm8s1ceuBUnMUAeoAHHw,19,52,18,6,7,9,21,3,116,16.571428571428573,8,0.0,8,18,6,7,44,9,0,21,3,39,77,0
3175,74555,Q8RGPBI5Ez4dcsYeaCg7LkbJmto9C3oj,SpATywNh6bZuzm8s1ceuBUnMUAeoAHHw,17,29,17,23,5,15,27,4,120,17.142857142857142,3,0.0,8,17,20,5,21,15,3,27,4,50,70,0
3176,74608,U3R4m4eLMm2lirgI7HLueBKsNpxhFpn9,7GRhBDsirIGkRZBtSMEzNTyDr2JQm4xx,27,29,13,26,5,0,4,0,77,11.0,3,0.0,12,13,26,5,17,0,0,4,0,56,21,1
3177,74618,RtmYmukzSU8h3Uq6suOYxJKRcISOQfvL,RXDvfPUBYFlVdlueBFbLW0mhhAyGEqpt,47,32,20,94,9,1,9,0,165,23.571428571428573,4,0.0,8,20,90,9,24,1,4,9,0,127,38,0
3178,74653,HL0jm7zWkHTTtUFklIJxsfljBDgcIEre,SpATywNh6bZuzm8s1ceuBUnMUAeoAHHw,12,31,3,14,1,5,6,0,60,8.571428571428571,3,0.0,8,3,13,1,23,5,1,6,0,25,35,1
3179,74669,QYUKXD6RJtSdizcdlNjQSBFOXbEQl1FA,SpATywNh6bZuzm8s1ceuBUnMUAeoAHHw,6,2,0,0,0,8,5,0,15,2.142857142857143,1,0.0,0,0,0,0,2,8,0,5,0,0,15,1
3180,74703,vSL0kRsKOWBMpC6pqEAxri0eLNug5E20,RXDvfPUBYFlVdlueBFbLW0mhhAyGEqpt,39,58,5,65,2,9,11,0,150,21.428571428571427,4,0.0,12,5,63,2,46,9,2,11,0,82,68,0
3181,74717,tBy7E7qZZZ98Oih5sTNUdDZRIpZZM98z,SpATywNh6bZuzm8s1ceuBUnMUAeoAHHw,14,40,10,22,0,14,8,0,94,13.428571428571429,4,0.0,20,10,19,0,20,14,3,8,0,49,45,0
3182,74736,sgWvC8NRvYtrmKjALzTvn9SNvnbzDMjJ,SpATywNh6bZuzm8s1ceuBUnMUAeoAHHw,6,5,3,0,1,0,2,0,11,1.5714285714285714,1,0.0,0,3,0,1,5,0,0,2,0,4,7,1
3183,74755,MLEFHCMFllWu55FD5Lk76TFNbtPRpP0W,7GRhBDsirIGkRZBtSMEzNTyDr2JQm4xx,21,27,2,16,1,0,12,2,60,8.571428571428571,1,0.0,8,2,13,1,19,0,3,12,2,24,36,0
3184,74792,DSoedfH3iEqkDSoEfnR9hPK9fGA03nvE,A3fsA9Zfv1X2fVEQhTw51lKENdNrEqT3,50,19,15,114,10,8,5,0,171,24.428571428571427,2,0.0,1,15,94,10,18,8,20,5,0,120,51,1
3185,74801,L0e1YP7bRzjNsIzxzTyXlM0Ldh6xltNG,SpATywNh6bZuzm8s1ceuBUnMUAeoAHHw,32,44,21,38,10,2,8,1,124,17.714285714285715,1,0.0,9,21,35,10,35,2,3,8,1,75,49,0
3186,74809,0UD2r7gmc85Ip6GdTUss7ocdGASnZDTz,7GRhBDsirIGkRZBtSMEzNTyDr2JQm4xx,14,15,8,8,6,0,7,0,44,6.285714285714286,2,0.0,2,8,6,6,13,0,2,7,0,22,22,1
3187,74818,knxAJpSFDgjN8jBmnCV7BB7s4fbgoTt1,7GRhBDsirIGkRZBtSMEzNTyDr2JQm4xx,7,3,2,4,0,1,6,0,16,2.2857142857142856,2,0.0,1,2,3,0,2,1,1,6,0,6,10,1
3188,74841,lFMbkCaY0FKfyGbh1VOL30jTZ1USVgB2,RXDvfPUBYFlVdlueBFbLW0mhhAyGEqpt,20,19,10,16,10,0,2,0,57,8.142857142857142,2,0.0,8,10,16,10,11,0,0,2,0,44,13,0
3189,74881,user4NErzgNZOQPby0IMjoZc4clvyOrp,7GRhBDsirIGkRZBtSMEzNTyDr2JQm4xx,6,4,2,0,1,0,2,0,9,1.2857142857142858,1,0.0,1,2,0,1,3,0,0,2,0,4,5,1
3190,74882,uFxbwM61ZWFC5xnxVOlmiGXCTyHmK3HX,RXDvfPUBYFlVdlueBFbLW0mhhAyGEqpt,8,8,5,0,2,2,7,3,27,3.857142857142857,1,0.0,0,5,0,2,8,2,0,7,3,7,20,1
3191,74915,1f1vpzICnoH8kVwL3WpPvvH9Fnzvagoq,7GRhBDsirIGkRZBtSMEzNTyDr2JQm4xx,5,3,1,0,0,0,3,0,7,1.0,1,0.0,0,1,0,0,3,0,0,3,0,1,6,1
3192,75011,CDVTgNquYdsNoldLURSKppemY0oOGcjg,SpATywNh6bZuzm8s1ceuBUnMUAeoAHHw,14,24,1,9,1,3,6,2,46,6.571428571428571,1,0.0,7,1,9,1,17,3,0,6,2,18,28,0
3193,75046,JxLtKAnMek98G5fWpyeTaKlh0zheuNnU,A3fsA9Zfv1X2fVEQhTw51lKENdNrEqT3,8,7,2,0,1,1,4,1,16,2.2857142857142856,1,0.0,1,2,0,1,6,1,0,4,1,4,12,1
3194,75054,dtbXtMjPqeEvzoZBFe2y9uSDcjL0lnx2,RXDvfPUBYFlVdlueBFbLW0mhhAyGEqpt,31,72,15,0,8,37,10,0,142,20.285714285714285,4,0.0,13,15,0,8,59,37,0,10,0,36,106,0
3195,75113,5EOGhyHOLLtbW0eEa8Dnfl5My4kdYkdc,SpATywNh6bZuzm8s1ceuBUnMUAeoAHHw,29,41,19,18,10,1,11,2,102,14.571428571428571,4,0.0,12,19,18,10,29,1,0,11,2,59,43,0
3196,75143,KKE8q8DWecTGi2Mp6eRnxhZGGD7eG4J3,SpATywNh6bZuzm8s1ceuBUnMUAeoAHHw,6,3,1,0,1,0,2,0,7,1.0,1,0.0,0,1,0,1,3,0,0,2,0,2,5,1
3197,75195,9zNI4EpVujSV8TU9o7NY46vrkl8qX3Ys,G8EPVSXsOYB5YQWZGiz1aVq5Pgr2GrQu,8,6,1,0,2,0,3,0,12,1.7142857142857142,1,0.0,2,1,0,2,4,0,0,3,0,5,7,0
3198,75206,ZXWRS3Ah3Q3TKxtUJXxAAlsPTxzCg1Vz,SpATywNh6bZuzm8s1ceuBUnMUAeoAHHw,17,17,9,21,1,4,8,1,61,8.714285714285714,2,0.0,4,9,20,1,13,4,1,8,1,34,27,0
3199,75350,mFNGHC6aCmhHmhRXFCDO0uvnGnNYaro0,7GRhBDsirIGkRZBtSMEzNTyDr2JQm4xx,4,2,1,0,1,0,1,0,5,0.7142857142857143,1,0.0,0,1,0,1,2,0,0,1,0,2,3,1
3200,75382,O0pFwh56sT4vz63TrFMWxlTyZHTENk1t,SpATywNh6bZuzm8s1ceuBUnMUAeoAHHw,20,27,0,17,0,1,2,0,47,6.714285714285714,1,0.0,15,0,16,0,12,1,1,2,0,31,16,0
3201,75440,0wpIasMdCfOA3dQLJWO9ecakBEpIFnbg,7GRhBDsirIGkRZBtSMEzNTyDr2JQm4xx,38,70,33,53,14,29,13,0,212,30.285714285714285,3,0.0,33,33,45,14,37,29,8,13,0,125,87,1
3202,75486,l7cIWSn2QdqLoOKMFO8yNQGKfk999nJh,7GRhBDsirIGkRZBtSMEzNTyDr2JQm4xx,13,18,7,0,3,3,8,1,40,5.714285714285714,2,0.0,8,7,0,3,10,3,0,8,1,18,22,0
3203,75557,514TWhkGGUhLu2MdvTnb8eiBH3DCFHzg,SpATywNh6bZuzm8s1ceuBUnMUAeoAHHw,26,40,15,31,3,3,13,1,106,15.142857142857142,3,0.0,12,15,29,3,28,3,2,13,1,59,47,0
3204,75565,A8uNxAeXRi6PUyfK3nbO106vNrsfyDAv,SpATywNh6bZuzm8s1ceuBUnMUAeoAHHw,30,38,20,32,11,12,20,0,133,19.0,4,0.0,14,20,29,11,24,12,3,20,0,74,59,0
3205,75599,yBKc8UQ3yoU6nYnfaJz62fH80CgKFtOX,SpATywNh6bZuzm8s1ceuBUnMUAeoAHHw,17,23,10,24,5,0,11,1,74,10.571428571428571,2,0.0,8,10,20,5,15,0,4,11,1,43,31,0
3206,75619,qwKwEhJ5oWm5TB1Q6emluPsrjHPCR2z1,SpATywNh6bZuzm8s1ceuBUnMUAeoAHHw,22,21,13,20,6,0,7,0,67,9.571428571428571,1,0.0,4,13,17,6,17,0,3,7,0,40,27,1
3207,75724,39HyRvZGGM2Q03BAuIzlN9IBewYhVnfo,7GRhBDsirIGkRZBtSMEzNTyDr2JQm4xx,9,8,2,2,4,0,5,0,21,3.0,1,0.0,6,2,2,4,2,0,0,5,0,14,7,0
3208,75741,3x63reHnPUEpxvneROppT18TTVHKvgH3,bWdj2GDclj5ofokWjzoa5jAwMkxCykd6,8,9,2,22,3,0,1,0,37,5.285714285714286,1,0.0,3,2,20,3,6,0,2,1,0,28,9,1
3209,75759,8wgkhDh9t3XtyzQtRpizifGx20DUK4F9,7GRhBDsirIGkRZBtSMEzNTyDr2JQm4xx,2,0,0,0,0,0,2,0,2,0.2857142857142857,1,0.0,0,0,0,0,0,0,0,2,0,0,2,1
3210,75770,FGD2s7sTUqsP3QU1o8nPIzNgmxXe4CYW,7GRhBDsirIGkRZBtSMEzNTyDr2JQm4xx,25,53,23,12,13,3,19,0,123,17.571428571428573,2,0.0,22,23,9,13,31,3,3,19,0,67,56,1
3211,75792,dhPF0MOUpHT5OZTFAONgRdkH1ZwnZtFz,SpATywNh6bZuzm8s1ceuBUnMUAeoAHHw,7,4,3,0,3,0,2,0,12,1.7142857142857142,1,0.0,0,3,0,3,4,0,0,2,0,6,6,0
3212,75890,Y89GJdSZUpoYFMgx00SCe6qFoYoXIpUj,7GRhBDsirIGkRZBtSMEzNTyDr2JQm4xx,1,0,0,0,0,0,1,0,1,0.14285714285714285,1,0.0,0,0,0,0,0,0,0,1,0,0,1,1
3213,75964,kiVzCvDoEqSB7iO0TU3ERoanC9pEAYCs,7GRhBDsirIGkRZBtSMEzNTyDr2JQm4xx,4,2,1,0,1,0,2,0,6,0.8571428571428571,1,0.0,0,1,0,1,2,0,0,2,0,2,4,1
3214,75969,8Dno8ERd119JayTOKlG7uDmGtkfLJOke,SpATywNh6bZuzm8s1ceuBUnMUAeoAHHw,6,3,2,0,2,0,1,0,8,1.1428571428571428,1,0.0,0,2,0,2,3,0,0,1,0,4,4,0
3215,75980,mDHr8WvVVX9KSvXMqxtLvZ6vP4uuNF6E,A3fsA9Zfv1X2fVEQhTw51lKENdNrEqT3,6,6,0,0,0,1,4,0,11,1.5714285714285714,1,0.0,0,0,0,0,6,1,0,4,0,0,11,1
3216,75992,YvdTgocCzBmHhfLuAH349Li5za8uToFU,7GRhBDsirIGkRZBtSMEzNTyDr2JQm4xx,9,5,0,0,0,2,5,1,13,1.8571428571428572,1,0.0,0,0,0,0,5,2,0,5,1,0,13,1
3217,76038,6RuWsSvS3Ngnjl37PzNAaaGn8Jd9a1lW,bWdj2GDclj5ofokWjzoa5jAwMkxCykd6,10,51,5,0,5,1,19,0,81,11.571428571428571,4,0.0,2,5,0,5,49,1,0,19,0,12,69,0
3218,76070,4rBJgH2pAgasw5ZtgiBnBNfRcNJLZp5J,7GRhBDsirIGkRZBtSMEzNTyDr2JQm4xx,9,2,1,0,1,4,7,1,16,2.2857142857142856,1,0.0,0,1,0,1,2,4,0,7,1,2,14,1
3219,76119,FXen1VSms29mqypmBsJLgiCW5lwzRuUO,7GRhBDsirIGkRZBtSMEzNTyDr2JQm4xx,19,20,9,8,7,5,7,0,56,8.0,2,0.0,7,9,6,7,13,5,2,7,0,29,27,1
3220,76193,yhuEFjYPx53KuMNRSkVNQIkCv2xuEbeq,7GRhBDsirIGkRZBtSMEzNTyDr2JQm4xx,1,0,0,0,0,0,2,0,2,0.2857142857142857,1,0.0,0,0,0,0,0,0,0,2,0,0,2,1
3221,76245,FYdTGqTHtRATfo802agJiucYRW9Mfn1L,7GRhBDsirIGkRZBtSMEzNTyDr2JQm4xx,1,0,0,0,0,0,1,0,1,0.14285714285714285,1,0.0,0,0,0,0,0,0,0,1,0,0,1,1
3222,76261,wzJUcvl4LpGNAis186Xl9ztjI1WNWkac,bWdj2GDclj5ofokWjzoa5jAwMkxCykd6,7,5,0,0,1,0,15,1,22,3.142857142857143,3,0.0,3,0,0,1,2,0,0,15,1,4,18,1
3223,76314,0htS0wNp12VQ7YgJ628sRK5TB1tJHlRO,7GRhBDsirIGkRZBtSMEzNTyDr2JQm4xx,8,5,3,0,3,0,1,0,12,1.7142857142857142,1,0.0,1,3,0,3,4,0,0,1,0,7,5,1
3224,77044,bikkCYRyUxervPNSkXQBtcADPD3aMEN1,7GRhBDsirIGkRZBtSMEzNTyDr2JQm4xx,2,0,0,0,0,0,2,0,2,0.2857142857142857,1,0.0,0,0,0,0,0,0,0,2,0,0,2,1
3225,77126,qg6GOCuPcDwehPMMAEed7GZuAdyiaV9B,7GRhBDsirIGkRZBtSMEzNTyDr2JQm4xx,36,87,2,70,6,61,20,1,247,35.285714285714285,10,0.0,42,2,59,6,45,61,11,20,1,109,138,1
3226,77170,jOMPEpDTypAwtZP0adzz5Y6TGIr0Cgak,fbPkOYLVPtPgIt0MxizjfFJov3JbHyAi,6,10,1,1,4,0,1,0,17,2.4285714285714284,1,0.0,7,1,1,4,3,0,0,1,0,13,4,1
3227,77172,mI1vyeEbuUIxkGVi9aK5r9kjcaPF7SVi,fbPkOYLVPtPgIt0MxizjfFJov3JbHyAi,8,11,7,0,4,0,2,0,24,3.4285714285714284,1,0.0,0,7,0,4,11,0,0,2,0,11,13,1
3228,77173,GkJR3TNQR5bDjgiA7ByPHRWSb3vgtDKO,fbPkOYLVPtPgIt0MxizjfFJov3JbHyAi,9,10,5,0,3,6,4,1,29,4.142857142857143,1,0.0,1,5,0,3,9,6,0,4,1,9,20,1
3229,77176,hNJz0qbOhrUgajUkzqSdDbybHkuRglfs,fbPkOYLVPtPgIt0MxizjfFJov3JbHyAi,6,5,2,0,2,0,1,0,10,1.4285714285714286,1,0.0,0,2,0,2,5,0,0,1,0,4,6,1
3230,77177,NHGmMinB9WoQusKCx50F4M4nJF124Ms4,fbPkOYLVPtPgIt0MxizjfFJov3JbHyAi,4,2,1,0,1,0,1,0,5,0.7142857142857143,1,0.0,0,1,0,1,2,0,0,1,0,2,3,1
3231,77181,SFygdEesOWeEamKu8iZBsgHneiDiai0R,fbPkOYLVPtPgIt0MxizjfFJov3JbHyAi,4,5,0,0,0,0,2,0,7,1.0,2,0.0,0,0,0,0,5,0,0,2,0,0,7,1
3232,77182,kmeB6Kxx4KEk3yK7YODyZKeWU8kJfyJH,fbPkOYLVPtPgIt0MxizjfFJov3JbHyAi,4,2,1,0,1,0,1,0,5,0.7142857142857143,1,0.0,0,1,0,1,2,0,0,1,0,2,3,1
3233,77184,wf4sRCFbvakokDkU4vw1lmU1y8DrYHz0,fbPkOYLVPtPgIt0MxizjfFJov3JbHyAi,15,42,14,15,10,23,13,0,117,16.714285714285715,3,0.0,13,14,12,10,29,23,3,13,0,49,68,1
3234,77185,QQjzUMnFih1Op25f6SGBPhOGRMF8l0bA,fbPkOYLVPtPgIt0MxizjfFJov3JbHyAi,24,49,20,13,15,6,5,0,108,15.428571428571429,3,0.0,14,20,11,15,35,6,2,5,0,60,48,1
3235,77187,JGkH5G6iVBgcA8nzn9agd5N20Wo6tva5,fbPkOYLVPtPgIt0MxizjfFJov3JbHyAi,21,17,14,0,9,0,6,0,46,6.571428571428571,2,0.0,0,14,0,9,17,0,0,6,0,23,23,1
3236,77188,DiP7fLvMTHut4vp8IPCEmth5BO8Y3xyZ,fbPkOYLVPtPgIt0MxizjfFJov3JbHyAi,9,10,5,0,4,13,7,3,42,6.0,1,0.0,2,5,0,4,8,13,0,7,3,11,31,1
3237,77189,Qj3OHkTzcEQwSk4fOQ3gLUAEOg61tV0J,fbPkOYLVPtPgIt0MxizjfFJov3JbHyAi,6,4,2,0,2,0,2,0,10,1.4285714285714286,1,0.0,0,2,0,2,4,0,0,2,0,4,6,1
3238,77190,YK4AUh2swGXXiib7M9ur8qjJXCBGfumK,fbPkOYLVPtPgIt0MxizjfFJov3JbHyAi,1,0,0,0,0,0,1,0,1,0.14285714285714285,1,0.0,0,0,0,0,0,0,0,1,0,0,1,1
3239,77191,E4C4yZPrf8ephwcq1p7RUy4dbVmvF86s,fbPkOYLVPtPgIt0MxizjfFJov3JbHyAi,1,0,0,0,0,0,2,0,2,0.2857142857142857,1,0.0,0,0,0,0,0,0,0,2,0,0,2,1
3240,77194,uOfATV0WsL0BPHDdVyS70rl0sYjdudpd,fbPkOYLVPtPgIt0MxizjfFJov3JbHyAi,10,18,8,4,3,0,7,0,40,5.714285714285714,1,0.0,4,8,3,3,14,0,1,7,0,18,22,1
3241,77197,4UvxElQD05jrzT8uj3rOHyCF67vFPUKP,fbPkOYLVPtPgIt0MxizjfFJov3JbHyAi,16,36,21,7,14,5,4,0,87,12.428571428571429,5,0.0,9,21,6,14,27,5,1,4,0,50,37,1
3242,77198,nctrJ6DXEbLac5Q8LCtyQd0IItjuRIih,fbPkOYLVPtPgIt0MxizjfFJov3JbHyAi,10,21,4,0,4,3,27,3,62,8.857142857142858,2,0.0,3,4,0,4,18,3,0,27,3,11,51,1
3243,77200,rwyVxnMY0KdYFbt5Rt6BKFYkmT4l68h9,fbPkOYLVPtPgIt0MxizjfFJov3JbHyAi,5,2,1,0,1,0,2,0,6,0.8571428571428571,1,0.0,0,1,0,1,2,0,0,2,0,2,4,1
3244,77206,OE8YoNemuZxKuixEPGeEQM6Dw53MRjvX,fbPkOYLVPtPgIt0MxizjfFJov3JbHyAi,1,0,0,0,0,0,1,0,1,0.14285714285714285,1,0.0,0,0,0,0,0,0,0,1,0,0,1,1
3245,77208,H47G4l8xfadoi35VSQjLwEe5Da3Pfkds,fbPkOYLVPtPgIt0MxizjfFJov3JbHyAi,4,2,1,0,1,0,1,0,5,0.7142857142857143,1,0.0,0,1,0,1,2,0,0,1,0,2,3,1
3246,77278,y7yLjFt2yMwjL5qqPUFP5MHo49CCR80j,fbPkOYLVPtPgIt0MxizjfFJov3JbHyAi,6,1,0,0,0,1,6,1,9,1.2857142857142858,1,0.0,0,0,0,0,1,1,0,6,1,0,9,0
3247,77302,KRi80h1uK84snC5HvtQKWlsjwt9i3oa5,fbPkOYLVPtPgIt0MxizjfFJov3JbHyAi,10,5,3,0,2,0,5,1,16,2.2857142857142856,2,0.0,0,3,0,2,5,0,0,5,1,5,11,1
3248,77850,embp7e5rTedl4SQPXvv0NKkthNGlazF4,SpATywNh6bZuzm8s1ceuBUnMUAeoAHHw,31,40,15,44,8,8,9,1,125,17.857142857142858,3,0.0,14,15,34,8,26,8,10,9,1,71,54,0
3249,77861,j6kVkVGKYZT7ozL2NE5rOIexD3a1ewYn,SpATywNh6bZuzm8s1ceuBUnMUAeoAHHw,18,32,12,11,3,68,13,3,142,20.285714285714285,6,0.0,9,12,11,3,23,68,0,13,3,35,107,1
3250,77902,k6QLpQDqSxoScgN883dLN4OsoeXNCHXO,A3fsA9Zfv1X2fVEQhTw51lKENdNrEqT3,20,13,11,0,9,0,3,0,36,5.142857142857143,2,0.0,0,11,0,9,13,0,0,3,0,20,16,1
3251,77930,I0nVBKgpf6bHOhRUWavCqORVydlrPxcM,SpATywNh6bZuzm8s1ceuBUnMUAeoAHHw,16,33,14,29,3,30,16,0,125,17.857142857142858,2,0.0,12,14,22,3,21,30,7,16,0,51,74,1
3252,77948,HAqiq102XDB03bRDdmGODD1MUBTXSItL,G8EPVSXsOYB5YQWZGiz1aVq5Pgr2GrQu,10,7,2,8,3,0,5,0,25,3.5714285714285716,1,0.0,5,2,4,3,2,0,4,5,0,14,11,1
3253,78064,SfR30NvxnwHQ5GQOQOoN6OMoANxaB8dS,SpATywNh6bZuzm8s1ceuBUnMUAeoAHHw,13,16,8,18,3,0,4,0,49,7.0,2,0.0,5,8,15,3,11,0,3,4,0,31,18,0
3254,78106,hu8eak1Xmf8voE8pnxPzkSD2dZP9Sipf,bWdj2GDclj5ofokWjzoa5jAwMkxCykd6,8,9,0,20,0,4,11,0,44,6.285714285714286,4,0.0,2,0,18,0,7,4,2,11,0,20,24,0
3255,78134,CNb0Sul2DOkX3VhMOeM6DWqvlrGgHagf,SpATywNh6bZuzm8s1ceuBUnMUAeoAHHw,17,19,8,23,5,1,7,1,64,9.142857142857142,2,0.0,6,8,20,5,13,1,3,7,1,39,25,1
3256,78144,GcwFf1WfRMSdZDYsPn5itkdYlvMUCmT9,SpATywNh6bZuzm8s1ceuBUnMUAeoAHHw,16,23,7,13,3,1,8,2,57,8.142857142857142,3,0.0,3,7,12,3,20,1,1,8,2,25,32,0
3257,78188,CNb0Sul2DOkX3VhMOeM6DWqvlrGgHagf,bWdj2GDclj5ofokWjzoa5jAwMkxCykd6,7,5,2,0,1,0,5,1,14,2.0,2,0.0,0,2,0,1,5,0,0,5,1,3,11,1
3258,78247,BLoa1RvSOgexbSH4hGzCihmBc8pXd0Db,A3fsA9Zfv1X2fVEQhTw51lKENdNrEqT3,29,23,11,14,9,6,11,5,79,11.285714285714286,1,0.0,0,11,12,9,23,6,2,11,5,32,47,1
3259,78294,kj5o7wMZl1s4q0cggcmipnm7O7L6g4Ps,bWdj2GDclj5ofokWjzoa5jAwMkxCykd6,16,17,9,90,8,0,6,0,130,18.571428571428573,2,0.0,6,9,87,8,11,0,3,6,0,110,20,0
3260,78356,l8Cml1vejHI8GVsgohdNxJJsxeTOpjUQ,SpATywNh6bZuzm8s1ceuBUnMUAeoAHHw,14,11,7,5,5,1,5,1,35,5.0,1,0.0,3,7,4,5,8,1,1,5,1,19,16,1
3261,78462,4N9xQarXAZMYyOjOJvMQmOHnVfoe0iL0,A3fsA9Zfv1X2fVEQhTw51lKENdNrEqT3,1,0,0,0,0,0,2,0,2,0.2857142857142857,1,0.0,0,0,0,0,0,0,0,2,0,0,2,1
3262,78478,CVkN7W2203PPB4rzsX0i8SBpQ0bSRkaq,SpATywNh6bZuzm8s1ceuBUnMUAeoAHHw,2,0,0,0,0,0,3,0,3,0.42857142857142855,1,0.0,0,0,0,0,0,0,0,3,0,0,3,1
3263,78546,Ckb71Ev9RlsIUvVDfkFS0AumQJilppvB,G8EPVSXsOYB5YQWZGiz1aVq5Pgr2GrQu,5,2,1,0,1,0,2,0,6,0.8571428571428571,1,0.0,0,1,0,1,2,0,0,2,0,2,4,1
3264,78603,7u0QfTKQg4itZK9m8foLXkIGwUxxHMsT,SpATywNh6bZuzm8s1ceuBUnMUAeoAHHw,15,11,5,6,4,0,4,0,30,4.285714285714286,1,0.0,5,5,6,4,6,0,0,4,0,20,10,0
3265,78648,fjIKsKO6rizBomnPFn2db56S1nui3RlN,A3fsA9Zfv1X2fVEQhTw51lKENdNrEqT3,27,19,15,12,10,8,6,1,71,10.142857142857142,1,0.0,2,15,9,10,17,8,3,6,1,36,35,1
3266,78715,5Zgwu2mRcsc21AmNDehMpm5vDwlgKfhs,SpATywNh6bZuzm8s1ceuBUnMUAeoAHHw,17,17,7,19,4,1,10,2,60,8.571428571428571,1,0.0,8,7,18,4,9,1,1,10,2,37,23,1
3267,78786,r62e9eSPsszv1Iv2O1V4lcMcbaHlq1ob,SpATywNh6bZuzm8s1ceuBUnMUAeoAHHw,18,19,1,25,0,0,2,0,47,6.714285714285714,1,0.0,6,1,21,0,13,0,4,2,0,28,19,0
3268,78797,5NRnaGcpNIGEuH61FLOcxB7Rjs6WPiNk,SpATywNh6bZuzm8s1ceuBUnMUAeoAHHw,30,41,24,14,10,1,8,0,98,14.0,2,0.0,9,24,13,10,32,1,1,8,0,56,42,0
3269,78848,oZKhsAromYlsN9MhR64yAv55dJDSDM8L,G8EPVSXsOYB5YQWZGiz1aVq5Pgr2GrQu,14,12,4,10,3,0,7,1,37,5.285714285714286,2,0.0,6,4,7,3,6,0,3,7,1,20,17,1
3270,78886,pgMwb3FHEjNb1xNpBTJ5ysmRdBbuUNFr,bWdj2GDclj5ofokWjzoa5jAwMkxCykd6,9,7,1,14,1,0,2,0,25,3.5714285714285716,2,0.0,1,1,14,1,6,0,0,2,0,17,8,1
3271,78910,R6RINUtJNooptLfHmBRIBRqFOknkjv0Y,A3fsA9Zfv1X2fVEQhTw51lKENdNrEqT3,22,67,27,0,21,6,24,0,145,20.714285714285715,5,0.0,0,27,0,21,67,6,0,24,0,48,97,1
3272,78953,AZZvRPcRkLSa6vwofzfwsEULTUhiKy0E,SpATywNh6bZuzm8s1ceuBUnMUAeoAHHw,29,88,37,27,10,83,50,3,298,42.57142857142857,8,0.0,26,37,24,10,62,83,3,50,3,97,201,0
3273,78971,d1mccaMvv72HL0M2QdKzu9aosPAbZ4Jm,SpATywNh6bZuzm8s1ceuBUnMUAeoAHHw,13,11,4,6,3,7,2,1,34,4.857142857142857,1,0.0,3,4,6,3,8,7,0,2,1,16,18,0
3274,79085,jByBG50ghoSer5UP92qpkAfDGFpraaH7,RXDvfPUBYFlVdlueBFbLW0mhhAyGEqpt,1,0,0,0,0,0,1,0,1,0.14285714285714285,1,0.0,0,0,0,0,0,0,0,1,0,0,1,1
3275,79088,oA5bEHkRJtiDJKnesmAjUtrhTVSOkHe2,SpATywNh6bZuzm8s1ceuBUnMUAeoAHHw,8,11,9,0,7,0,3,0,30,4.285714285714286,1,0.0,0,9,0,7,11,0,0,3,0,16,14,1
3276,79114,oBHfkEBZPsjUqPWXyw1yW9Gipn9KMPDQ,SpATywNh6bZuzm8s1ceuBUnMUAeoAHHw,8,14,6,0,3,0,4,0,27,3.857142857142857,2,0.0,0,6,0,3,14,0,0,4,0,9,18,1
3277,79116,oeEXBADlWmjYmDN9P4tzDfKaayj6OdaD,G8EPVSXsOYB5YQWZGiz1aVq5Pgr2GrQu,29,47,17,62,6,3,7,3,145,20.714285714285715,1,0.0,28,17,40,6,19,3,22,7,3,91,54,1
3278,79164,wGfXRYqHkdAo1fVEEY9NvW8qy6M9m0mI,A3fsA9Zfv1X2fVEQhTw51lKENdNrEqT3,45,42,18,62,10,26,17,6,181,25.857142857142858,5,0.0,2,18,59,10,40,26,3,17,6,89,92,1
3279,79208,88xoeZRrDqjjjrf57zHp7JPU0EIVMG6O,SpATywNh6bZuzm8s1ceuBUnMUAeoAHHw,8,9,0,14,0,0,2,0,25,3.5714285714285716,1,0.0,5,0,14,0,4,0,0,2,0,19,6,1
3280,79265,V1B34PKYcESnicIbQVUA4gpuU2uOqNWz,bWdj2GDclj5ofokWjzoa5jAwMkxCykd6,8,17,6,0,3,0,6,0,32,4.571428571428571,1,0.0,5,6,0,3,12,0,0,6,0,14,18,1
3281,79268,V1B34PKYcESnicIbQVUA4gpuU2uOqNWz,SpATywNh6bZuzm8s1ceuBUnMUAeoAHHw,9,11,10,0,5,3,7,1,37,5.285714285714286,1,0.0,0,10,0,5,11,3,0,7,1,15,22,1
3282,79322,b9hN1tjIpM67gB8PuwPQ3u561lqo1V2f,RXDvfPUBYFlVdlueBFbLW0mhhAyGEqpt,12,10,8,0,5,0,11,3,37,5.285714285714286,2,0.0,0,8,0,5,10,0,0,11,3,13,24,0
3283,79391,Q3913BpDariYbEj8ZlFy9MQJV1rZlZAJ,SpATywNh6bZuzm8s1ceuBUnMUAeoAHHw,3,2,0,0,0,0,1,0,3,0.42857142857142855,1,0.0,0,0,0,0,2,0,0,1,0,0,3,1
3284,79439,crl3o7sxyMWLnKWiaz3BBw0rhIdF3cXr,bWdj2GDclj5ofokWjzoa5jAwMkxCykd6,10,11,0,20,1,8,6,1,47,6.714285714285714,1,0.0,6,0,20,1,5,8,0,6,1,27,20,1
3285,79449,qwFDXKt0M8f2bQWHQ9IwMnRpFGf93NNf,SpATywNh6bZuzm8s1ceuBUnMUAeoAHHw,16,16,10,23,4,1,10,1,65,9.285714285714286,4,0.0,2,10,18,4,14,1,5,10,1,34,31,1
3286,79450,IKVKcza5vT9JehCbhoro1CRnVpL575lj,SpATywNh6bZuzm8s1ceuBUnMUAeoAHHw,15,9,5,3,3,0,4,0,24,3.4285714285714284,1,0.0,3,5,3,3,6,0,0,4,0,14,10,1
3287,79483,i39wrwOFUT4cBFVx9tMMQ3lQ2qJwZK9W,A3fsA9Zfv1X2fVEQhTw51lKENdNrEqT3,18,15,7,0,6,4,5,2,39,5.571428571428571,1,0.0,0,7,0,6,15,4,0,5,2,13,26,1
3288,79509,G0i0hCTwH2K62ld1aO6Hf5Ntp0ahokSh,SpATywNh6bZuzm8s1ceuBUnMUAeoAHHw,30,62,29,19,11,16,40,4,181,25.857142857142858,4,0.0,14,29,19,11,48,16,0,40,4,73,108,0
3289,79519,NUQJxbePNRtXQQBXCQFchv4ww5sWUrml,SpATywNh6bZuzm8s1ceuBUnMUAeoAHHw,24,38,0,41,1,3,15,1,99,14.142857142857142,3,0.0,15,0,35,1,23,3,6,15,1,51,48,0
3290,79538,68aPv7D3ZE4JVkIRm8IjOcsEwxcFlwFO,A3fsA9Zfv1X2fVEQhTw51lKENdNrEqT3,3,3,0,0,0,0,1,0,4,0.5714285714285714,1,0.0,0,0,0,0,3,0,0,1,0,0,4,1
3291,79548,xt59FC0u82DgUh4CRpEaJwaXZlH1aLO1,SpATywNh6bZuzm8s1ceuBUnMUAeoAHHw,9,11,7,0,5,0,8,0,31,4.428571428571429,2,0.0,1,7,0,5,10,0,0,8,0,13,18,0
3292,79555,ygHFzUOzEqkLxFm5OclfxvG9i48BUAuT,SpATywNh6bZuzm8s1ceuBUnMUAeoAHHw,17,37,3,0,1,10,8,3,62,8.857142857142858,2,0.0,3,3,0,1,34,10,0,8,3,7,55,0
3293,79668,7nUtazUwwSnnXJpIKdQBJGpXV6Po42DQ,bWdj2GDclj5ofokWjzoa5jAwMkxCykd6,19,25,2,127,4,0,15,0,173,24.714285714285715,2,0.0,6,2,121,4,19,0,6,15,0,133,40,1
3294,79735,e9EeV5SqA2AUMzzKRuYh9383pOYfTL5t,A3fsA9Zfv1X2fVEQhTw51lKENdNrEqT3,7,7,0,0,0,0,5,0,12,1.7142857142857142,2,0.0,0,0,0,0,7,0,0,5,0,0,12,1
3295,79761,ffg9VbmMkFKj2DfO61ClA5PDHr5Xa6gN,SpATywNh6bZuzm8s1ceuBUnMUAeoAHHw,11,22,14,2,7,0,6,0,51,7.285714285714286,4,0.0,0,14,2,7,22,0,0,6,0,23,28,0
3296,79801,Tdve80vJG7bg0NAfZoErDkCePh9ZdZtG,SpATywNh6bZuzm8s1ceuBUnMUAeoAHHw,9,8,5,0,3,0,4,1,21,3.0,1,0.0,1,5,0,3,7,0,0,4,1,9,12,1
3297,79809,5tD3trtPQ6jzqFRimP1PMPhgvFtRmfA4,SpATywNh6bZuzm8s1ceuBUnMUAeoAHHw,15,27,6,9,1,3,11,0,57,8.142857142857142,2,0.0,7,6,9,1,20,3,0,11,0,23,34,1
3298,79818,dCAqk9uHiS99GMTcJQtThG8XWnwwbp5Q,SpATywNh6bZuzm8s1ceuBUnMUAeoAHHw,12,26,1,19,0,2,4,0,52,7.428571428571429,2,0.0,11,1,16,0,15,2,3,4,0,28,24,1
3299,79822,WUz9eKwwTabZi4dE6GkJ03kYfBXiol2h,A3fsA9Zfv1X2fVEQhTw51lKENdNrEqT3,2,0,0,0,0,9,6,0,15,2.142857142857143,3,0.0,0,0,0,0,0,9,0,6,0,0,15,1
3300,79831,7kTdvih7UMOiFKC9aXRp88JppGP4qSKH,SpATywNh6bZuzm8s1ceuBUnMUAeoAHHw,7,3,2,0,2,0,2,0,9,1.2857142857142858,1,0.0,0,2,0,2,3,0,0,2,0,4,5,1
3301,79878,ccvSRrE3qWZJWxhZblz5YcekpwGotPgS,SpATywNh6bZuzm8s1ceuBUnMUAeoAHHw,14,14,3,1,2,1,13,0,34,4.857142857142857,2,0.0,2,3,1,2,12,1,0,13,0,8,26,1
3302,79956,hcKYo6bLhlANvHE0FxLuR4YY8jocfBwJ,A3fsA9Zfv1X2fVEQhTw51lKENdNrEqT3,9,14,0,0,0,28,3,0,45,6.428571428571429,2,0.0,0,0,0,0,14,28,0,3,0,0,45,1
3303,79984,oKZwUGrYHqdyevQMbQx5wJjMj1yq2zA6,A3fsA9Zfv1X2fVEQhTw51lKENdNrEqT3,4,3,1,0,0,0,2,0,6,0.8571428571428571,1,0.0,0,1,0,0,3,0,0,2,0,1,5,1
3304,79998,q3XMARasETEzJyvJUxEAfFYsH6Z5s8Zv,bWdj2GDclj5ofokWjzoa5jAwMkxCykd6,8,11,4,0,1,6,10,0,32,4.571428571428571,3,0.0,0,4,0,1,11,6,0,10,0,5,27,0
3305,80019,YOBshYgk5gyR7XdL7ay26cecY2tdQtWp,SpATywNh6bZuzm8s1ceuBUnMUAeoAHHw,6,10,5,0,0,0,5,0,20,2.857142857142857,1,0.0,1,5,0,0,9,0,0,5,0,6,14,0
3306,80040,4AJWWnsd8QGDSRF4HLmdDQcz8kiBAcGz,SpATywNh6bZuzm8s1ceuBUnMUAeoAHHw,8,12,8,0,4,0,5,0,29,4.142857142857143,1,0.0,1,8,0,4,11,0,0,5,0,13,16,1
3307,80138,TcTuC5hiyHRmVc5qZWpzVJY3ugVLXB30,SpATywNh6bZuzm8s1ceuBUnMUAeoAHHw,3,2,0,0,0,0,1,0,3,0.42857142857142855,1,0.0,0,0,0,0,2,0,0,1,0,0,3,1
3308,80163,qepVwgjKQRsdgtfeDxtXZatdyxHVESv4,SpATywNh6bZuzm8s1ceuBUnMUAeoAHHw,5,4,0,0,0,0,2,0,6,0.8571428571428571,1,0.0,0,0,0,0,4,0,0,2,0,0,6,1
3309,80164,6iOLSqRTRABETCaDgzA6NufDV3dLbSSl,A3fsA9Zfv1X2fVEQhTw51lKENdNrEqT3,2,0,0,0,0,0,2,0,2,0.2857142857142857,1,0.0,0,0,0,0,0,0,0,2,0,0,2,1
3310,80236,V9sr2zgjH2joKkLVi0Sqvx5Qp7qYhjJ9,A3fsA9Zfv1X2fVEQhTw51lKENdNrEqT3,6,5,0,0,0,0,1,0,6,0.8571428571428571,1,0.0,0,0,0,0,5,0,0,1,0,0,6,1
3311,80251,P6CjwZWiHeS0SJlPQAf4bN1TR1u7fnyP,A3fsA9Zfv1X2fVEQhTw51lKENdNrEqT3,14,13,10,0,7,2,9,2,43,6.142857142857143,2,0.0,0,10,0,7,13,2,0,9,2,17,26,0
3312,80320,pz6FqQOVyf4J4lzlAfhLNtZDyqwAxEPh,A3fsA9Zfv1X2fVEQhTw51lKENdNrEqT3,12,9,6,0,5,0,3,0,23,3.2857142857142856,1,0.0,0,6,0,5,9,0,0,3,0,11,12,1
3313,80342,eq0DfIOiXorIpuNIOqxe4ooh3gnV5qKw,A3fsA9Zfv1X2fVEQhTw51lKENdNrEqT3,7,3,2,0,2,0,3,0,10,1.4285714285714286,1,0.0,0,2,0,2,3,0,0,3,0,4,6,1
3314,80393,S8OVDYMWVqlXct5SL79m7HIG5CpKKYZc,SpATywNh6bZuzm8s1ceuBUnMUAeoAHHw,10,8,6,0,4,0,2,0,20,2.857142857142857,1,0.0,0,6,0,4,8,0,0,2,0,10,10,0
3315,80411,GC4OF9yGz21AkcWehLa95SfLGyYuVKMP,SpATywNh6bZuzm8s1ceuBUnMUAeoAHHw,16,32,11,33,0,41,16,3,136,19.428571428571427,5,0.0,13,11,30,0,19,41,3,16,3,54,82,0
3316,80471,AZ8hE11Dcjz74P3tHeZJFdS8MoworAxL,G8EPVSXsOYB5YQWZGiz1aVq5Pgr2GrQu,10,15,0,0,0,5,9,0,29,4.142857142857143,1,0.0,2,0,0,0,13,5,0,9,0,2,27,0
3317,80472,2tSCGGcBbyusCnHqpGiQkgQi3re0uZxB,G8EPVSXsOYB5YQWZGiz1aVq5Pgr2GrQu,24,35,20,37,14,1,10,1,118,16.857142857142858,4,0.0,0,20,30,14,35,1,7,10,1,64,54,1
3318,80497,YotAwxbRJChtPJRmqiR2vpTmWxO7oSJ0,A3fsA9Zfv1X2fVEQhTw51lKENdNrEqT3,1,0,0,0,0,0,1,0,1,0.14285714285714285,1,0.0,0,0,0,0,0,0,0,1,0,0,1,1
3319,80514,DdUTtw4QPNiBxHI38HgtVDIMn8onRmHc,A3fsA9Zfv1X2fVEQhTw51lKENdNrEqT3,10,12,5,0,3,0,4,0,24,3.4285714285714284,3,0.0,0,5,0,3,12,0,0,4,0,8,16,0
3320,80578,WCnGcaqoXPOoj0smksJ3AG2zfJ5bQ6q1,A3fsA9Zfv1X2fVEQhTw51lKENdNrEqT3,6,1,1,0,1,0,3,0,6,0.8571428571428571,1,0.0,0,1,0,1,1,0,0,3,0,2,4,1
3321,80593,z9sj5HIJml1DMOMfRKKBQ7IvS2IoE424,A3fsA9Zfv1X2fVEQhTw51lKENdNrEqT3,1,0,0,0,0,0,4,0,4,0.5714285714285714,2,0.0,0,0,0,0,0,0,0,4,0,0,4,1
3322,80606,2cQfWhwRUGUv48S47s2aDWYzSM5LRy6r,RXDvfPUBYFlVdlueBFbLW0mhhAyGEqpt,15,13,0,0,0,0,5,0,18,2.5714285714285716,1,0.0,0,0,0,0,13,0,0,5,0,0,18,1
3323,80621,L5BsWcgN6IMgchaeVR0q3PWadEiOivUf,A3fsA9Zfv1X2fVEQhTw51lKENdNrEqT3,6,2,1,0,1,1,3,1,9,1.2857142857142858,1,0.0,0,1,0,1,2,1,0,3,1,2,7,1
3324,80646,1XuOICh6QrUFIc1MJAW7XRUBUSTY0RN7,SpATywNh6bZuzm8s1ceuBUnMUAeoAHHw,3,2,1,0,0,0,1,0,4,0.5714285714285714,1,0.0,0,1,0,0,2,0,0,1,0,1,3,1
3325,80650,CViRSkXaB71kW0MpqfES8A240EKnhiKp,A3fsA9Zfv1X2fVEQhTw51lKENdNrEqT3,5,5,3,0,2,0,2,0,12,1.7142857142857142,1,0.0,0,3,0,2,5,0,0,2,0,5,7,1
3326,80718,a5enjFKHyOqV9BlzZwj7DoNQQjSWFxve,SpATywNh6bZuzm8s1ceuBUnMUAeoAHHw,5,5,2,0,1,0,1,0,9,1.2857142857142858,1,0.0,2,2,0,1,3,0,0,1,0,5,4,1
3327,80721,9pnVOC0WBepjoyI2qcaWMzrSP0RPnX7J,A3fsA9Zfv1X2fVEQhTw51lKENdNrEqT3,4,2,0,0,0,0,2,0,4,0.5714285714285714,1,0.0,0,0,0,0,2,0,0,2,0,0,4,1
3328,80725,eVZffGeL4uoEevrNNMdcmW6f0YwT8plW,bWdj2GDclj5ofokWjzoa5jAwMkxCykd6,4,2,1,0,1,0,2,0,6,0.8571428571428571,2,0.0,0,1,0,1,2,0,0,2,0,2,4,1
3329,80744,EGvZuk2o6udfOjbP1e9MeD8Ju07DscTY,A3fsA9Zfv1X2fVEQhTw51lKENdNrEqT3,1,0,0,0,0,0,3,0,3,0.42857142857142855,1,0.0,0,0,0,0,0,0,0,3,0,0,3,1
3330,80748,H6iwP0B7nHcYZaQbDpLJEx2H7FXYxL7S,RXDvfPUBYFlVdlueBFbLW0mhhAyGEqpt,19,19,6,32,2,0,4,2,65,9.285714285714286,2,0.0,4,6,28,2,15,0,4,4,2,40,25,0
3331,80800,a98Mt6r9LLCkAEPo2R3JVMN20OhIPoaG,SpATywNh6bZuzm8s1ceuBUnMUAeoAHHw,15,13,8,0,6,1,8,1,37,5.285714285714286,3,0.0,0,8,0,6,13,1,0,8,1,14,23,1
3332,80820,auTfNrVnLCOPJ3vRg0BBNLuEGlk6Jhzf,A3fsA9Zfv1X2fVEQhTw51lKENdNrEqT3,1,0,0,0,0,0,1,0,1,0.14285714285714285,1,0.0,0,0,0,0,0,0,0,1,0,0,1,1
3333,80865,detHMtXeNBDLl1yfq61M11qScSHezCTa,fbPkOYLVPtPgIt0MxizjfFJov3JbHyAi,7,5,3,0,3,0,5,0,16,2.2857142857142856,1,0.0,1,3,0,3,4,0,0,5,0,7,9,1
3334,80866,lPCl89OkL3ywqPQ9tkoc7yQfPt2jOe8J,fbPkOYLVPtPgIt0MxizjfFJov3JbHyAi,11,22,8,6,9,27,15,4,91,13.0,1,0.0,12,8,4,9,10,27,2,15,4,33,58,1
3335,80872,pGAbpSQSqm8kO5KHqj1P91gbLxgxqLMR,fbPkOYLVPtPgIt0MxizjfFJov3JbHyAi,1,0,0,0,0,0,1,0,1,0.14285714285714285,1,0.0,0,0,0,0,0,0,0,1,0,0,1,1
3336,80874,tH916xRbn4bSZXJ6Z57PlnTAPQfz04PX,fbPkOYLVPtPgIt0MxizjfFJov3JbHyAi,13,10,5,3,4,0,3,0,25,3.5714285714285716,1,0.0,2,5,3,4,8,0,0,3,0,14,11,1
3337,80875,zgLhc8F17sS6o8GPDEBAA43SRssMOYHD,fbPkOYLVPtPgIt0MxizjfFJov3JbHyAi,8,7,3,0,1,1,6,1,19,2.7142857142857144,2,0.0,0,3,0,1,7,1,0,6,1,4,15,1
3338,80876,yoqZagpPshUzxT5y74jKK6qgFqUHTRAQ,fbPkOYLVPtPgIt0MxizjfFJov3JbHyAi,7,4,2,0,2,0,3,0,11,1.5714285714285714,1,0.0,1,2,0,2,3,0,0,3,0,5,6,1
3339,80879,QRBHeXWoh4Eq5qFFGeXnL66X034DcN82,fbPkOYLVPtPgIt0MxizjfFJov3JbHyAi,7,5,4,0,3,0,2,0,14,2.0,1,0.0,0,4,0,3,5,0,0,2,0,7,7,1
3340,80880,nwSsR1adl0WQZ5D0MOHLkrBumdQn65bS,fbPkOYLVPtPgIt0MxizjfFJov3JbHyAi,1,0,0,0,0,0,1,0,1,0.14285714285714285,1,0.0,0,0,0,0,0,0,0,1,0,0,1,1
3341,80883,dl3uJviN00Na5GELdMJFr7DikNXKgldw,fbPkOYLVPtPgIt0MxizjfFJov3JbHyAi,12,13,4,8,4,0,11,1,41,5.857142857142857,1,0.0,5,4,6,4,8,0,2,11,1,19,22,1
3342,80885,OJ0LoXMYeoupgtCsqXPKoTXc19jkOfHU,fbPkOYLVPtPgIt0MxizjfFJov3JbHyAi,6,13,0,2,2,0,3,0,20,2.857142857142857,1,0.0,7,0,2,2,6,0,0,3,0,11,9,1
3343,80890,9iv095QjZS4Q7X9b663JhI4Y5VIooOZJ,fbPkOYLVPtPgIt0MxizjfFJov3JbHyAi,7,4,3,0,2,0,8,0,17,2.4285714285714284,1,0.0,0,3,0,2,4,0,0,8,0,5,12,1
3344,80891,1IMOvf9v1bRH0tUTRkiIkzGe833lnAgf,fbPkOYLVPtPgIt0MxizjfFJov3JbHyAi,5,2,1,0,1,0,3,0,7,1.0,2,0.0,0,1,0,1,2,0,0,3,0,2,5,0
3345,80892,OqzJYk2L0XqYLfMs4LljNI8HpBsCF1TU,fbPkOYLVPtPgIt0MxizjfFJov3JbHyAi,24,31,16,13,11,10,7,1,89,12.714285714285714,5,0.0,7,16,11,11,24,10,2,7,1,45,44,1
3346,80894,wa9yiDToqQTrEAjEFYLZvJZ6yii3aZEK,fbPkOYLVPtPgIt0MxizjfFJov3JbHyAi,9,3,3,0,3,3,9,2,23,3.2857142857142856,1,0.0,0,3,0,3,3,3,0,9,2,6,17,1
3347,80896,F7beo1Qs8FACPdfc8t0SncgEfDkdNWKi,fbPkOYLVPtPgIt0MxizjfFJov3JbHyAi,12,28,18,0,9,35,29,4,123,17.571428571428573,4,0.0,3,18,0,9,25,35,0,29,4,30,93,1
3348,82399,viuKt4GgrX0rYL5EpHoxJbsiC9TblSuk,7GRhBDsirIGkRZBtSMEzNTyDr2JQm4xx,1,0,0,0,0,0,1,0,1,0.14285714285714285,1,0.0,0,0,0,0,0,0,0,1,0,0,1,1
3349,82405,TciQEzJA4hKxeo0Ve5JLByGDZHpNx3uy,7GRhBDsirIGkRZBtSMEzNTyDr2JQm4xx,7,6,2,0,0,10,9,0,27,3.857142857142857,1,0.0,0,2,0,0,6,10,0,9,0,2,25,1
3350,82549,LzZbSzxCF6j5IK4opjLkxGirHE6VTy2b,7GRhBDsirIGkRZBtSMEzNTyDr2JQm4xx,8,9,1,0,2,0,1,0,13,1.8571428571428572,1,0.0,2,1,0,2,7,0,0,1,0,5,8,0
3351,82645,CSh5hGbaSFu2yCb31iVMOVwKocrH471Q,RXDvfPUBYFlVdlueBFbLW0mhhAyGEqpt,8,27,16,0,2,0,6,0,51,7.285714285714286,4,0.0,0,16,0,2,27,0,0,6,0,18,33,0
3352,82797,BzvzyDIHLe9MZwFkiZf5BNkVkHrFZ1uP,SpATywNh6bZuzm8s1ceuBUnMUAeoAHHw,8,5,4,0,3,0,2,0,14,2.0,1,0.0,0,4,0,3,5,0,0,2,0,7,7,1
3353,82815,IYjgMeQycDQkXIpTAZqsKVDfOfuGTmr6,G8EPVSXsOYB5YQWZGiz1aVq5Pgr2GrQu,17,32,3,28,2,2,4,0,71,10.142857142857142,3,0.0,9,3,25,2,23,2,3,4,0,39,32,1
3354,82826,6PLrCNmfEwPk8NveiZ2kjz8b6TJ4tdFy,SpATywNh6bZuzm8s1ceuBUnMUAeoAHHw,25,45,0,34,0,9,19,6,113,16.142857142857142,2,0.0,18,0,28,0,27,9,6,19,6,46,67,1
3355,82980,KJHVgwvyEGSqeXuZ6P7l6YnOOdmnECg0,G8EPVSXsOYB5YQWZGiz1aVq5Pgr2GrQu,8,13,0,0,0,13,6,0,32,4.571428571428571,3,0.0,0,0,0,0,13,13,0,6,0,0,32,1
3356,83008,OifsLGRBGBgFFNsSrNDnK5W8Vbn9qLGX,bWdj2GDclj5ofokWjzoa5jAwMkxCykd6,5,7,0,0,0,0,0,0,7,1.0,1,0.0,0,0,0,0,7,0,0,0,0,0,7,1
3357,83034,JfftjOGdDbpgbrupi0Gwr899R0jzXikJ,RXDvfPUBYFlVdlueBFbLW0mhhAyGEqpt,17,30,18,0,7,0,10,0,65,9.285714285714286,6,0.0,0,18,0,7,30,0,0,10,0,25,40,1
3358,83156,wSQurJctKIVWroKFEwLtZd7EI4FKyqnr,G8EPVSXsOYB5YQWZGiz1aVq5Pgr2GrQu,25,45,12,74,8,0,2,0,141,20.142857142857142,1,0.0,19,12,57,8,26,0,17,2,0,96,45,0
3359,83174,5A8qgesuumI82DPHv10fhG2s0pO5oVZR,A3fsA9Zfv1X2fVEQhTw51lKENdNrEqT3,6,4,0,0,0,0,4,0,8,1.1428571428571428,2,0.0,0,0,0,0,4,0,0,4,0,0,8,1
3360,83211,Wr4SmSlfffOCt9SGCoEYbe3u98RIz0dN,A3fsA9Zfv1X2fVEQhTw51lKENdNrEqT3,42,40,31,42,21,0,7,0,141,20.142857142857142,2,0.0,3,31,42,21,37,0,0,7,0,97,44,1
3361,83277,dT92IjRcuruPiAlpqVUTtu3wNL9IIegT,SpATywNh6bZuzm8s1ceuBUnMUAeoAHHw,1,0,0,0,0,0,1,0,1,0.14285714285714285,1,0.0,0,0,0,0,0,0,0,1,0,0,1,1
3362,83290,V5AS4ngknDMHs5ddf49SxlAoYguZsiN3,SpATywNh6bZuzm8s1ceuBUnMUAeoAHHw,8,10,2,0,2,0,3,0,17,2.4285714285714284,1,0.0,0,2,0,2,10,0,0,3,0,4,13,1
3363,83513,FN4Q8gUJQiuKtRiPQS3gBMUWwSnDptW4,SpATywNh6bZuzm8s1ceuBUnMUAeoAHHw,14,26,12,17,5,0,3,0,63,9.0,2,0.0,9,12,14,5,17,0,3,3,0,40,23,1
3364,83577,ew5XZC7WSosl0QdXH45kYD3syMSGbOj6,A3fsA9Zfv1X2fVEQhTw51lKENdNrEqT3,22,30,12,0,10,0,2,0,54,7.714285714285714,2,0.0,4,12,0,10,26,0,0,2,0,26,28,1
3365,83613,puN480TO3qbGXrXmM5qoOdmstQ51OC6E,bWdj2GDclj5ofokWjzoa5jAwMkxCykd6,12,29,13,0,8,23,31,4,108,15.428571428571429,2,0.0,6,13,0,8,23,23,0,31,4,27,81,0
3366,83623,H6I6nkJ6DtlIXdQ1opNRFdSYIFjksvYQ,SpATywNh6bZuzm8s1ceuBUnMUAeoAHHw,17,23,10,19,3,34,13,1,103,14.714285714285714,5,0.0,6,10,16,3,17,34,3,13,1,35,68,1
3367,83890,hkZJZMuEk3eRSgWhjH7jPcJrlgv2RTNl,bWdj2GDclj5ofokWjzoa5jAwMkxCykd6,15,13,6,40,3,5,1,0,68,9.714285714285714,1,0.0,5,6,39,3,8,5,1,1,0,53,15,1
3368,83902,9fqjCwCWiE2ZIs1HrK3mm4R5MSyOKac5,A3fsA9Zfv1X2fVEQhTw51lKENdNrEqT3,13,24,11,0,7,0,6,0,48,6.857142857142857,1,0.0,0,11,0,7,24,0,0,6,0,18,30,1
3369,83909,lQbf9gXsN1R7oTfmD8ApJzd1F5wN4xv1,RXDvfPUBYFlVdlueBFbLW0mhhAyGEqpt,6,1,1,0,1,1,4,0,8,1.1428571428571428,1,0.0,0,1,0,1,1,1,0,4,0,2,6,1
3370,84034,lDJqver3AFFUyXISNdqvZpmq6OeWVl0r,A3fsA9Zfv1X2fVEQhTw51lKENdNrEqT3,21,14,11,0,8,0,6,0,39,5.571428571428571,2,0.0,0,11,0,8,14,0,0,6,0,19,20,0
3371,84058,mMS5utPEE0kau31EdquwgaN1e0nxF2V4,SpATywNh6bZuzm8s1ceuBUnMUAeoAHHw,11,15,9,8,6,0,2,0,40,5.714285714285714,2,0.0,0,9,8,6,15,0,0,2,0,23,17,1
3372,84176,Xv4cOEYZEExzsBdbjc8lrCLUZHXLo5uk,SpATywNh6bZuzm8s1ceuBUnMUAeoAHHw,28,43,14,39,8,14,8,1,127,18.142857142857142,2,0.0,21,14,32,8,22,14,7,8,1,75,52,0
3373,84183,xXxqqh9yVGi9oZiE57nohuMrqKDnoyIS,A3fsA9Zfv1X2fVEQhTw51lKENdNrEqT3,8,5,3,0,1,0,3,0,12,1.7142857142857142,1,0.0,0,3,0,1,5,0,0,3,0,4,8,1
3374,84258,HOl7cCI0BgZTJ7INtqfMX4dKD4xHl51U,fbPkOYLVPtPgIt0MxizjfFJov3JbHyAi,14,29,6,12,7,0,1,0,55,7.857142857142857,1,0.0,15,6,9,7,14,0,3,1,0,37,18,1
3375,84259,xi2KO7WcXIB6LKlzLxLjQ5IcXn6cZQFV,fbPkOYLVPtPgIt0MxizjfFJov3JbHyAi,7,3,2,0,2,0,4,0,11,1.5714285714285714,1,0.0,0,2,0,2,3,0,0,4,0,4,7,1
3376,84261,lBljSQvIVCpw7S5SELQHg4JfMSTvCBRe,fbPkOYLVPtPgIt0MxizjfFJov3JbHyAi,10,13,1,0,1,0,3,0,18,2.5714285714285716,1,0.0,0,1,0,1,13,0,0,3,0,2,16,0
3377,84264,MSLYJeLT8SYZ3UpCzbTuM5WBLAn4P9C0,fbPkOYLVPtPgIt0MxizjfFJov3JbHyAi,5,2,1,0,1,0,2,0,6,0.8571428571428571,1,0.0,0,1,0,1,2,0,0,2,0,2,4,0
3378,84268,MaxCNnPaLK24RRWF9HKJTqddyOCcvhNc,fbPkOYLVPtPgIt0MxizjfFJov3JbHyAi,8,7,4,0,2,0,4,0,17,2.4285714285714284,1,0.0,0,4,0,2,7,0,0,4,0,6,11,1
3379,84270,HRxHszLswfw468mOCwAnOXdKGRZhTUPo,fbPkOYLVPtPgIt0MxizjfFJov3JbHyAi,9,9,1,0,2,0,2,0,14,2.0,1,0.0,2,1,0,2,7,0,0,2,0,5,9,1
3380,84273,Mbzz4hCvkXsTjBUMTZvnUnOUU5DkeepD,fbPkOYLVPtPgIt0MxizjfFJov3JbHyAi,18,30,18,0,9,16,18,0,91,13.0,2,0.0,0,18,0,9,30,16,0,18,0,27,64,1
3381,84274,KSAnx8l7GLibIHVjfaVpoMytCY29O5jV,fbPkOYLVPtPgIt0MxizjfFJov3JbHyAi,14,10,7,0,6,0,6,0,29,4.142857142857143,1,0.0,0,7,0,6,10,0,0,6,0,13,16,1
3382,84276,FHZxLNKuH41dzVdZ6xZP53e1ChodL4Nf,fbPkOYLVPtPgIt0MxizjfFJov3JbHyAi,2,0,0,0,0,0,2,0,2,0.2857142857142857,1,0.0,0,0,0,0,0,0,0,2,0,0,2,1
3383,84277,2j1tzVxn26ffq0mMvPPBIt1027gHtJr2,fbPkOYLVPtPgIt0MxizjfFJov3JbHyAi,3,0,0,0,0,0,4,0,4,0.5714285714285714,1,0.0,0,0,0,0,0,0,0,4,0,0,4,1
3384,84278,sW5iKRsVcoKx4Fgip5uKQwojFhK3kh4H,fbPkOYLVPtPgIt0MxizjfFJov3JbHyAi,7,8,3,0,2,0,4,0,17,2.4285714285714284,1,0.0,3,3,0,2,5,0,0,4,0,8,9,1
3385,84279,IKnWhfStgn6HzF4rCtxpMA6vaE95bkoN,fbPkOYLVPtPgIt0MxizjfFJov3JbHyAi,41,56,31,28,21,7,6,0,149,21.285714285714285,1,0.0,18,31,23,21,38,7,5,6,0,93,56,1
3386,84281,E6x1c22fqqwc9Xq0TREOCZPgn8h5NZRY,fbPkOYLVPtPgIt0MxizjfFJov3JbHyAi,2,0,0,0,0,0,2,0,2,0.2857142857142857,1,0.0,0,0,0,0,0,0,0,2,0,0,2,1
3387,84282,oyKcbflIhFWjfv9zJsn9ws83l2i6sd8B,fbPkOYLVPtPgIt0MxizjfFJov3JbHyAi,5,0,0,0,0,0,4,1,5,0.7142857142857143,1,0.0,0,0,0,0,0,0,0,4,1,0,5,1
3388,84284,SfvT6FHCLeajKH96s2LkoIO8YQ9sAqIE,fbPkOYLVPtPgIt0MxizjfFJov3JbHyAi,1,0,0,0,0,0,1,0,1,0.14285714285714285,1,0.0,0,0,0,0,0,0,0,1,0,0,1,1
3389,84285,6dxWIDqaYjsp7lwDHFYen9IBERKYGMUl,fbPkOYLVPtPgIt0MxizjfFJov3JbHyAi,11,12,8,0,6,1,8,1,36,5.142857142857143,3,0.0,0,8,0,6,12,1,0,8,1,14,22,1
3390,84289,8a6lcOY5tqRSg2M4LEQLAhRHX2NBy9qe,fbPkOYLVPtPgIt0MxizjfFJov3JbHyAi,1,0,0,0,0,0,1,0,1,0.14285714285714285,1,0.0,0,0,0,0,0,0,0,1,0,0,1,1
3391,84291,8V79kzOnHwVk0Szz0Nr0pjOSCgEaC0bl,fbPkOYLVPtPgIt0MxizjfFJov3JbHyAi,1,0,0,0,0,0,1,0,1,0.14285714285714285,1,0.0,0,0,0,0,0,0,0,1,0,0,1,0
3392,84433,Vu8rN942EwDIOj6iE8IDqvSFXpvGHO9R,A3fsA9Zfv1X2fVEQhTw51lKENdNrEqT3,49,28,21,72,12,0,10,0,143,20.428571428571427,2,0.0,4,21,57,12,24,0,15,10,0,94,49,1
3393,84438,zo3To03Q5Rdok3x4Zu1wNdsKqNDBlzyd,SpATywNh6bZuzm8s1ceuBUnMUAeoAHHw,3,2,1,0,0,2,1,0,6,0.8571428571428571,2,0.0,0,1,0,0,2,2,0,1,0,1,5,1
3394,84439,lmCPiW6l0WNp9Ttn0lhwFDs7FfVubtvY,SpATywNh6bZuzm8s1ceuBUnMUAeoAHHw,25,59,7,48,3,0,8,2,127,18.142857142857142,4,0.0,33,7,43,3,26,0,5,8,2,86,41,0
3395,84443,d27sJazbqmVDzx5twhACbiEBxUXvQf2a,SpATywNh6bZuzm8s1ceuBUnMUAeoAHHw,8,4,1,0,1,0,6,0,12,1.7142857142857142,1,0.0,0,1,0,1,4,0,0,6,0,2,10,1
3396,84463,ROXnyv16zBgjdP3dwdWTQaFrI7qQfgov,bWdj2GDclj5ofokWjzoa5jAwMkxCykd6,3,0,0,0,0,0,3,0,3,0.42857142857142855,1,0.0,0,0,0,0,0,0,0,3,0,0,3,1
3397,84487,dlcs3mIk1dQaLsNVv2V1gEVdgllvLwJb,SpATywNh6bZuzm8s1ceuBUnMUAeoAHHw,8,10,4,0,1,1,5,0,21,3.0,2,0.0,2,4,0,1,8,1,0,5,0,7,14,1
3398,84488,Hb1qgsgjtdXdXqLzZUND7Apyl9dV7sNn,SpATywNh6bZuzm8s1ceuBUnMUAeoAHHw,15,26,1,18,1,0,2,0,48,6.857142857142857,1,0.0,6,1,15,1,20,0,3,2,0,23,25,1
3399,84493,yEniPsoZW8Rgn4eOpAbvQhjj6pD8iwKc,bWdj2GDclj5ofokWjzoa5jAwMkxCykd6,3,2,0,0,0,0,1,0,3,0.42857142857142855,1,0.0,0,0,0,0,2,0,0,1,0,0,3,1
3400,84511,IDZ1AkiRXaR9yEtXb4Bo4nmlcF9ha0Jw,A3fsA9Zfv1X2fVEQhTw51lKENdNrEqT3,11,10,1,0,1,0,2,0,14,2.0,1,0.0,0,1,0,1,10,0,0,2,0,2,12,1
3401,84515,7zovZ3nFJhhuFND78aqDkmZfLWj3rVkx,bWdj2GDclj5ofokWjzoa5jAwMkxCykd6,8,11,3,0,4,1,5,1,25,3.5714285714285716,1,0.0,5,3,0,4,6,1,0,5,1,12,13,1
3402,84531,UwNh19bGTGX7YEBtcKZFqxDpmh2gUs3A,SpATywNh6bZuzm8s1ceuBUnMUAeoAHHw,26,42,19,30,11,1,5,0,108,15.428571428571429,3,0.0,11,19,27,11,31,1,3,5,0,68,40,0
3403,84533,KYp9UMy6aThBgyjsQnGoWdfiTDRtgnUO,A3fsA9Zfv1X2fVEQhTw51lKENdNrEqT3,4,3,1,0,0,0,1,0,5,0.7142857142857143,1,0.0,0,1,0,0,3,0,0,1,0,1,4,1
3404,84562,k6RJ44LpfDefc4BqSfb5Ks3bqRLzpbPs,SpATywNh6bZuzm8s1ceuBUnMUAeoAHHw,3,2,0,0,0,0,1,0,3,0.42857142857142855,1,0.0,0,0,0,0,2,0,0,1,0,0,3,1
3405,84570,3ROVLcXTo6OjIxmsQ13CBJ7pM5RMLVRs,SpATywNh6bZuzm8s1ceuBUnMUAeoAHHw,1,0,0,0,0,0,1,0,1,0.14285714285714285,1,0.0,0,0,0,0,0,0,0,1,0,0,1,1
3406,84622,UkZfNxIrXEzpCVrNVYStVn9ei74ROLV5,SpATywNh6bZuzm8s1ceuBUnMUAeoAHHw,9,4,3,0,3,0,2,0,12,1.7142857142857142,1,0.0,0,3,0,3,4,0,0,2,0,6,6,1
3407,84637,uqV3t3wNYphdy7WkOt07V9fSIpdy9v7v,SpATywNh6bZuzm8s1ceuBUnMUAeoAHHw,1,0,0,0,0,0,1,0,1,0.14285714285714285,1,0.0,0,0,0,0,0,0,0,1,0,0,1,1
3408,84650,rM6lHK7hiIUNX1NSrJxSbqLCGaqN5u1S,bWdj2GDclj5ofokWjzoa5jAwMkxCykd6,1,0,0,0,0,0,1,0,1,0.14285714285714285,1,0.0,0,0,0,0,0,0,0,1,0,0,1,1
3409,84655,fuprfcX49r5QcUYvMQnvvzEf76cx4sRp,A3fsA9Zfv1X2fVEQhTw51lKENdNrEqT3,1,0,0,0,0,0,1,0,1,0.14285714285714285,1,0.0,0,0,0,0,0,0,0,1,0,0,1,1
3410,84656,DA41CWRarbj2LaaLGDHgoyCQ99QpXH1z,SpATywNh6bZuzm8s1ceuBUnMUAeoAHHw,1,0,0,0,0,0,1,0,1,0.14285714285714285,1,0.0,0,0,0,0,0,0,0,1,0,0,1,1
3411,84696,HDx7XT9cwQtHtGFe0Ylk6QLaCz2f0GRa,bWdj2GDclj5ofokWjzoa5jAwMkxCykd6,11,17,11,0,2,11,7,0,48,6.857142857142857,3,0.0,1,11,0,2,16,11,0,7,0,14,34,1
3412,84712,rK4055OdlTymOWiwkxW7eIve09mowPhX,bWdj2GDclj5ofokWjzoa5jAwMkxCykd6,8,7,4,0,2,1,8,1,23,3.2857142857142856,1,0.0,0,4,0,2,7,1,0,8,1,6,17,1
3413,84733,9WmzxyamLAgd2LnrO6zydiN7WV3MNZZt,SpATywNh6bZuzm8s1ceuBUnMUAeoAHHw,30,55,40,26,13,44,18,3,199,28.428571428571427,3,0.0,11,40,26,13,44,44,0,18,3,90,109,1
3414,84746,KyernIkPskZZLcEZuqJdIALK35DoR4YD,SpATywNh6bZuzm8s1ceuBUnMUAeoAHHw,9,7,4,7,3,0,1,0,22,3.142857142857143,1,0.0,1,4,6,3,6,0,1,1,0,14,8,0
3415,84764,l0LgYDne2SMH172pM6WtwTolJro40hEN,bWdj2GDclj5ofokWjzoa5jAwMkxCykd6,8,8,5,0,2,0,2,0,17,2.4285714285714284,1,0.0,0,5,0,2,8,0,0,2,0,7,10,1
3416,84768,DsHgWZRTJ1y1l15smwhB78ZQq3d8dyKP,bWdj2GDclj5ofokWjzoa5jAwMkxCykd6,12,73,5,24,7,2,17,0,128,18.285714285714285,8,0.0,8,5,23,7,65,2,1,17,0,43,85,1
3417,84803,RijiZcjqs3Sau2onXuynGNDorKgFFeFF,A3fsA9Zfv1X2fVEQhTw51lKENdNrEqT3,1,0,0,0,0,0,1,0,1,0.14285714285714285,1,0.0,0,0,0,0,0,0,0,1,0,0,1,1
3418,84807,lBDP0bEGdpXmY1IAvAuALKqFWFlEuPft,A3fsA9Zfv1X2fVEQhTw51lKENdNrEqT3,1,0,0,0,0,0,1,0,1,0.14285714285714285,1,0.0,0,0,0,0,0,0,0,1,0,0,1,1
3419,84823,Wefj86tFjwJZnMq6IAWMjbzJgYWyoGE5,A3fsA9Zfv1X2fVEQhTw51lKENdNrEqT3,7,4,1,0,1,0,2,0,8,1.1428571428571428,1,0.0,0,1,0,1,4,0,0,2,0,2,6,1
3420,84824,CCr7XJJW4dK2W5QL9m4z2ZC42b4ulnok,SpATywNh6bZuzm8s1ceuBUnMUAeoAHHw,23,25,15,0,7,2,13,2,64,9.142857142857142,4,0.0,5,15,0,7,20,2,0,13,2,27,37,0
3421,84837,yv537v6H4lKuJBGFGcy0VRT6imwv3rrr,SpATywNh6bZuzm8s1ceuBUnMUAeoAHHw,1,0,0,0,0,0,2,0,2,0.2857142857142857,1,0.0,0,0,0,0,0,0,0,2,0,0,2,1
3422,84840,nMDev1avOgY53G2oqsCYhN7adTYqimPz,SpATywNh6bZuzm8s1ceuBUnMUAeoAHHw,20,20,10,13,7,0,4,0,54,7.714285714285714,3,0.0,6,10,12,7,14,0,1,4,0,35,19,1
3423,84856,IKpNQ2VJXcBrssoIsB3X4wtY2qE1YTKj,bWdj2GDclj5ofokWjzoa5jAwMkxCykd6,8,14,8,0,6,3,4,0,35,5.0,3,0.0,0,8,0,6,14,3,0,4,0,14,21,1
3424,84879,Wq9v1J863GLs0FXJcY6870pE4xwQWj9c,SpATywNh6bZuzm8s1ceuBUnMUAeoAHHw,7,6,3,0,2,1,5,0,17,2.4285714285714284,1,0.0,0,3,0,2,6,1,0,5,0,5,12,1
3425,84893,aXizpBfL2fbBc8SAHrmAdMBwyiDoIJ3v,SpATywNh6bZuzm8s1ceuBUnMUAeoAHHw,3,2,0,0,0,0,2,0,4,0.5714285714285714,1,0.0,0,0,0,0,2,0,0,2,0,0,4,1
3426,84898,BNaKyL5AxH5r8ATMyUD5dD2w9iqh31Mt,SpATywNh6bZuzm8s1ceuBUnMUAeoAHHw,8,6,4,0,3,0,4,0,17,2.4285714285714284,1,0.0,0,4,0,3,6,0,0,4,0,7,10,1
3427,84899,AMjnZTCZ82BDNCUbVBOLwJQKlTsIjteg,bWdj2GDclj5ofokWjzoa5jAwMkxCykd6,1,0,0,0,0,0,1,0,1,0.14285714285714285,1,0.0,0,0,0,0,0,0,0,1,0,0,1,1
3428,84914,CAJCBn0iJNYHHRrNYpaEyoUpQFaCqopf,SpATywNh6bZuzm8s1ceuBUnMUAeoAHHw,3,0,0,0,0,11,2,0,13,1.8571428571428572,1,0.0,0,0,0,0,0,11,0,2,0,0,13,1
3429,84920,P8HECw7bHyNqGqPTlWbv24tTg1SG6bAf,A3fsA9Zfv1X2fVEQhTw51lKENdNrEqT3,11,5,4,0,4,0,2,0,15,2.142857142857143,1,0.0,0,4,0,4,5,0,0,2,0,8,7,1
3430,84924,bkuP1EtN8mdTFJXvfsUwoFetipNOKV1x,A3fsA9Zfv1X2fVEQhTw51lKENdNrEqT3,6,4,0,0,0,2,3,0,9,1.2857142857142858,2,0.0,0,0,0,0,4,2,0,3,0,0,9,0
3431,84933,u0SrW65Zdf0RG2PPgt52qf6MWWYZDmbZ,A3fsA9Zfv1X2fVEQhTw51lKENdNrEqT3,4,2,1,0,1,0,2,0,6,0.8571428571428571,1,0.0,0,1,0,1,2,0,0,2,0,2,4,0
3432,84941,wdyLBUXnKZHWy3hjP9iEUMTvoZlBkTI1,A3fsA9Zfv1X2fVEQhTw51lKENdNrEqT3,28,8,5,84,2,2,3,0,104,14.857142857142858,1,0.0,1,5,66,2,7,2,18,3,0,74,30,1
3433,84943,tqYPV9KH0m40QH4HM703oTrUL5BNNo84,bWdj2GDclj5ofokWjzoa5jAwMkxCykd6,3,3,0,0,0,0,2,0,5,0.7142857142857143,1,0.0,0,0,0,0,3,0,0,2,0,0,5,1
3434,84959,hkI32MAgHvJ4T3I3Up79daEJ8l4sKHaC,A3fsA9Zfv1X2fVEQhTw51lKENdNrEqT3,19,11,10,16,9,0,1,0,47,6.714285714285714,1,0.0,0,10,15,9,11,0,1,1,0,34,13,1
3435,84967,cnF5YfjX3CQt7JMSCL8P4leqdmCPbBni,A3fsA9Zfv1X2fVEQhTw51lKENdNrEqT3,8,8,1,0,1,0,2,0,12,1.7142857142857142,2,0.0,1,1,0,1,7,0,0,2,0,3,9,1
3436,84969,AhGz4Es1bWdEWhXy7JGcFI2vY1lHgQNv,A3fsA9Zfv1X2fVEQhTw51lKENdNrEqT3,11,14,7,0,4,0,9,0,34,4.857142857142857,1,0.0,0,7,0,4,14,0,0,9,0,11,23,1
3437,84982,KogrHROquIJLSXIZqzhYU9Hcb9zVebwT,A3fsA9Zfv1X2fVEQhTw51lKENdNrEqT3,68,28,21,134,13,39,12,1,248,35.42857142857143,3,0.0,3,21,108,13,25,39,26,12,1,145,103,1
3438,85000,7ZT5u11YEDTZhD4NZDPzOcLz6uLhq9Bd,RXDvfPUBYFlVdlueBFbLW0mhhAyGEqpt,9,5,4,0,2,0,2,0,13,1.8571428571428572,1,0.0,0,4,0,2,5,0,0,2,0,6,7,1
3439,85006,tj54X35V4FNci4Kh3LQpxJqVKMwouLiV,SpATywNh6bZuzm8s1ceuBUnMUAeoAHHw,1,0,0,0,0,0,1,0,1,0.14285714285714285,1,0.0,0,0,0,0,0,0,0,1,0,0,1,1
3440,85036,Dieqd8f4UcwVzwl01TlWitYgH9I2P4ID,SpATywNh6bZuzm8s1ceuBUnMUAeoAHHw,14,16,5,15,3,0,2,0,41,5.857142857142857,1,0.0,10,5,12,3,6,0,3,2,0,30,11,1
3441,85058,aIIHBjdeRcv9jhajcTkxD39vpVMqF1ri,SpATywNh6bZuzm8s1ceuBUnMUAeoAHHw,1,0,0,0,0,0,1,0,1,0.14285714285714285,1,0.0,0,0,0,0,0,0,0,1,0,0,1,1
3442,85071,aO0LEwjTmeNegVPIDdxnfGASlS2PDBPM,bWdj2GDclj5ofokWjzoa5jAwMkxCykd6,4,2,0,0,0,0,2,0,4,0.5714285714285714,1,0.0,0,0,0,0,2,0,0,2,0,0,4,1
3443,85074,DxH75iZ2vwK7RWdx8JWNqysBZPhRedJP,SpATywNh6bZuzm8s1ceuBUnMUAeoAHHw,14,9,7,0,6,0,4,0,26,3.7142857142857144,1,0.0,0,7,0,6,9,0,0,4,0,13,13,1
3444,85101,eUiPnt4yNOhbT6A4YKzKQWtxymmKMqK8,SpATywNh6bZuzm8s1ceuBUnMUAeoAHHw,5,2,1,0,1,0,2,0,6,0.8571428571428571,1,0.0,0,1,0,1,2,0,0,2,0,2,4,0
3445,85143,cnF5YfjX3CQt7JMSCL8P4leqdmCPbBni,SpATywNh6bZuzm8s1ceuBUnMUAeoAHHw,15,22,4,19,2,1,8,2,58,8.285714285714286,3,0.0,2,4,17,2,20,1,2,8,2,25,33,1
3446,85161,bjM6n8DVZxyRbCs3zMbeKGW5iCOjCuf2,SpATywNh6bZuzm8s1ceuBUnMUAeoAHHw,30,32,17,38,7,20,9,1,124,17.714285714285715,3,0.0,12,17,31,7,20,20,7,9,1,67,57,0
3447,85163,W8y6AnXsJBrDnPij0rvHOisz3iKgMu0I,A3fsA9Zfv1X2fVEQhTw51lKENdNrEqT3,1,0,0,0,0,0,1,0,1,0.14285714285714285,1,0.0,0,0,0,0,0,0,0,1,0,0,1,1
3448,85203,9WmzxyamLAgd2LnrO6zydiN7WV3MNZZt,A3fsA9Zfv1X2fVEQhTw51lKENdNrEqT3,20,40,37,0,19,4,6,1,107,15.285714285714286,1,0.0,0,37,0,19,40,4,0,6,1,56,51,1
3449,85214,t5GAapz2qu7QW3ZA52Mo1qG5gvWMLT4H,SpATywNh6bZuzm8s1ceuBUnMUAeoAHHw,19,25,12,0,8,0,1,0,46,6.571428571428571,1,0.0,12,12,0,8,13,0,0,1,0,32,14,0
3450,85217,LgWCkAUxSRrYwIgyk3EiLrbm8VtT63oN,SpATywNh6bZuzm8s1ceuBUnMUAeoAHHw,5,3,0,0,0,0,2,0,5,0.7142857142857143,1,0.0,0,0,0,0,3,0,0,2,0,0,5,1
3451,85224,1DHzwL80UljY6lJVpTYvYIaqwxFV4OAM,A3fsA9Zfv1X2fVEQhTw51lKENdNrEqT3,4,4,0,0,0,0,2,0,6,0.8571428571428571,1,0.0,0,0,0,0,4,0,0,2,0,0,6,1
3452,85249,p6TgFJdLQMaMzbR16kycIPcRPnBj3paK,A3fsA9Zfv1X2fVEQhTw51lKENdNrEqT3,4,2,1,0,1,0,1,0,5,0.7142857142857143,1,0.0,0,1,0,1,2,0,0,1,0,2,3,1
3453,85253,XJf8gYhDJm1hrkVJvLQ4HKEnvPd3mIMq,G8EPVSXsOYB5YQWZGiz1aVq5Pgr2GrQu,5,9,1,0,0,3,4,0,17,2.4285714285714284,2,0.0,3,1,0,0,6,3,0,4,0,4,13,1
3454,85262,F2owRK2SDPW5FCDK4TxmBVHsTtJ44Nxq,A3fsA9Zfv1X2fVEQhTw51lKENdNrEqT3,12,19,2,0,2,0,3,0,26,3.7142857142857144,2,0.0,0,2,0,2,19,0,0,3,0,4,22,1
3455,85271,pMl3OskiuqgHNgKCqbUXUq2PDmPkrU2r,bWdj2GDclj5ofokWjzoa5jAwMkxCykd6,5,2,1,0,1,0,2,0,6,0.8571428571428571,1,0.0,0,1,0,1,2,0,0,2,0,2,4,1
3456,85283,9WmzxyamLAgd2LnrO6zydiN7WV3MNZZt,RXDvfPUBYFlVdlueBFbLW0mhhAyGEqpt,4,2,1,0,1,0,5,0,9,1.2857142857142858,2,0.0,0,1,0,1,2,0,0,5,0,2,7,1
3457,85284,Ws4jgichwsX0H8doBZ8nJsfB9pxtw9wh,SpATywNh6bZuzm8s1ceuBUnMUAeoAHHw,1,0,0,0,0,0,1,0,1,0.14285714285714285,1,0.0,0,0,0,0,0,0,0,1,0,0,1,1
3458,85286,pMl3OskiuqgHNgKCqbUXUq2PDmPkrU2r,A3fsA9Zfv1X2fVEQhTw51lKENdNrEqT3,2,0,0,0,0,0,2,0,2,0.2857142857142857,1,0.0,0,0,0,0,0,0,0,2,0,0,2,1
3459,85295,Zp1ZZPWn2kKT7nmilqO0Enc4rubJRG8n,SpATywNh6bZuzm8s1ceuBUnMUAeoAHHw,13,39,2,0,1,1,42,0,85,12.142857142857142,6,0.0,0,2,0,1,39,1,0,42,0,3,82,0
3460,85297,4VgoVQWGOr2mBZAQVNzDshzPrpqcYbQA,SpATywNh6bZuzm8s1ceuBUnMUAeoAHHw,4,2,0,0,0,0,2,0,4,0.5714285714285714,1,0.0,0,0,0,0,2,0,0,2,0,0,4,1
3461,85328,VZ5o45Yr5Bm8WANLZeoMpkPB24du6vYe,SpATywNh6bZuzm8s1ceuBUnMUAeoAHHw,1,0,0,0,0,0,1,0,1,0.14285714285714285,1,0.0,0,0,0,0,0,0,0,1,0,0,1,1
3462,85331,RZI7KROUR7i2T6MB71TuoKGbXE5WXiwO,SpATywNh6bZuzm8s1ceuBUnMUAeoAHHw,5,10,0,0,0,0,5,0,15,2.142857142857143,2,0.0,0,0,0,0,10,0,0,5,0,0,15,1
3463,85337,176ILS8J1NMmZsoc0RxEg8JQJcz6ksLo,SpATywNh6bZuzm8s1ceuBUnMUAeoAHHw,1,0,0,0,0,0,1,0,1,0.14285714285714285,1,0.0,0,0,0,0,0,0,0,1,0,0,1,1
3464,85351,4E7spFhBfl0gEqkMBOstVjR5pQXkTXaF,SpATywNh6bZuzm8s1ceuBUnMUAeoAHHw,1,0,0,0,0,0,1,0,1,0.14285714285714285,1,0.0,0,0,0,0,0,0,0,1,0,0,1,1
3465,85376,tO135VWcqma21HvgPTdpgoHPq5kDsz9m,SpATywNh6bZuzm8s1ceuBUnMUAeoAHHw,4,2,1,0,1,0,2,0,6,0.8571428571428571,1,0.0,0,1,0,1,2,0,0,2,0,2,4,1
3466,85377,tO135VWcqma21HvgPTdpgoHPq5kDsz9m,A3fsA9Zfv1X2fVEQhTw51lKENdNrEqT3,4,2,1,0,1,0,1,0,5,0.7142857142857143,1,0.0,0,1,0,1,2,0,0,1,0,2,3,1
3467,86978,w4c5I9GnSWI6sLkTNrP2S1NFytPszceZ,SpATywNh6bZuzm8s1ceuBUnMUAeoAHHw,7,6,4,0,3,0,2,0,15,2.142857142857143,2,0.0,0,4,0,3,6,0,0,2,0,7,8,1
3468,87018,puN480TO3qbGXrXmM5qoOdmstQ51OC6E,A3fsA9Zfv1X2fVEQhTw51lKENdNrEqT3,26,28,20,0,14,3,19,1,85,12.142857142857142,2,0.0,1,20,0,14,27,3,0,19,1,35,50,0
3469,87044,BcU9hDrDz2F2xEd3tqF67ZptaAdextzP,SpATywNh6bZuzm8s1ceuBUnMUAeoAHHw,6,3,1,0,1,0,2,0,7,1.0,1,0.0,0,1,0,1,3,0,0,2,0,2,5,1
3470,87057,SWjmkEB4DVctTeY4CrwF2QrGDf4olJAZ,RXDvfPUBYFlVdlueBFbLW0mhhAyGEqpt,49,83,35,73,20,32,11,2,256,36.57142857142857,1,0.0,32,35,67,20,51,32,6,11,2,154,102,0
3471,87111,fDs5TBVrvPHEIMLkBACIVQ2YkCdHCFLD,SpATywNh6bZuzm8s1ceuBUnMUAeoAHHw,10,11,8,0,5,0,3,0,27,3.857142857142857,2,0.0,0,8,0,5,11,0,0,3,0,13,14,1
3472,87127,dNFEIzn0depAU4oAUIlHxTqSNcin3JsM,SpATywNh6bZuzm8s1ceuBUnMUAeoAHHw,26,80,25,37,4,18,28,4,196,28.0,6,0.0,9,25,33,4,71,18,4,28,4,71,125,0
3473,87281,8fWrC0LYUq5E0gzy0gw2GD73h6o6q5AG,SpATywNh6bZuzm8s1ceuBUnMUAeoAHHw,14,56,5,16,3,1,7,0,88,12.571428571428571,5,0.0,25,5,14,3,31,1,2,7,0,47,41,0
3474,87383,7zKNYNlQe19MsOrdmzXSTtaqDWKHEPlA,SpATywNh6bZuzm8s1ceuBUnMUAeoAHHw,3,2,1,0,0,0,1,0,4,0.5714285714285714,1,0.0,0,1,0,0,2,0,0,1,0,1,3,0
3475,87440,MvkQjmVQSq3aFQKnqlTw1GsAe1sz0UUt,RXDvfPUBYFlVdlueBFbLW0mhhAyGEqpt,14,9,8,0,6,0,1,0,24,3.4285714285714284,1,0.0,0,8,0,6,9,0,0,1,0,14,10,1
3476,87584,NtOBKvqn4kjpyBFY5EbWAhwnHWFAQxgf,A3fsA9Zfv1X2fVEQhTw51lKENdNrEqT3,2,0,0,0,0,0,2,0,2,0.2857142857142857,1,0.0,0,0,0,0,0,0,0,2,0,0,2,1
3477,87630,IUn6MADAjAYkGlJisA1WiDvCeNlJd5Xd,A3fsA9Zfv1X2fVEQhTw51lKENdNrEqT3,1,0,0,0,0,0,1,0,1,0.14285714285714285,1,0.0,0,0,0,0,0,0,0,1,0,0,1,1
3478,87652,CeA39yEXem4lTmymvIZvr20kWcsmIjJE,SpATywNh6bZuzm8s1ceuBUnMUAeoAHHw,13,15,7,14,3,0,2,0,41,5.857142857142857,1,0.0,6,7,13,3,9,0,1,2,0,29,12,0
3479,87691,9vlKLLRVHTgTa2OMtndxw1oJeJABVSGY,RXDvfPUBYFlVdlueBFbLW0mhhAyGEqpt,48,77,33,144,16,15,7,2,294,42.0,2,0.0,14,33,123,16,63,15,21,7,2,186,108,0
3480,87695,oL1G89Phk4nduULmJ17br7A4xddcHdc4,A3fsA9Zfv1X2fVEQhTw51lKENdNrEqT3,5,2,1,0,1,0,5,0,9,1.2857142857142858,3,0.0,0,1,0,1,2,0,0,5,0,2,7,0
3481,87775,Tk65NSEWZoGK32sB9eYUeC558zBlLPIW,RXDvfPUBYFlVdlueBFbLW0mhhAyGEqpt,8,8,5,0,3,0,1,0,17,2.4285714285714284,1,0.0,2,5,0,3,6,0,0,1,0,10,7,0
3482,87802,3JEt0I9b0JhZhM0RD2D5jI5S8zjjeHFo,SpATywNh6bZuzm8s1ceuBUnMUAeoAHHw,7,2,1,0,1,1,5,1,11,1.5714285714285714,1,0.0,0,1,0,1,2,1,0,5,1,2,9,0
3483,87858,0LERVBlr0s6pvZPTHfS8Y74dmJWxJhcj,A3fsA9Zfv1X2fVEQhTw51lKENdNrEqT3,45,25,18,62,12,2,21,5,145,20.714285714285715,2,0.0,3,18,57,12,22,2,5,21,5,90,55,0
3484,87860,Uggn85R7OMhc9c2ThQoRc9ji4ASPnsWa,SpATywNh6bZuzm8s1ceuBUnMUAeoAHHw,17,51,19,20,8,15,17,2,132,18.857142857142858,4,0.0,19,19,17,8,32,15,3,17,2,63,69,0
3485,87912,j9L0wsMRR1iguKEo2FSLNGEw5WM5csHy,SpATywNh6bZuzm8s1ceuBUnMUAeoAHHw,5,0,0,0,0,3,6,1,10,1.4285714285714286,1,0.0,0,0,0,0,0,3,0,6,1,0,10,0
3486,88097,dCAqk9uHiS99GMTcJQtThG8XWnwwbp5Q,A3fsA9Zfv1X2fVEQhTw51lKENdNrEqT3,4,3,0,0,0,0,2,0,5,0.7142857142857143,1,0.0,0,0,0,0,3,0,0,2,0,0,5,1
3487,88197,Gvc7BFl5Q4FP2VRb1ZvRJI4nuqv9yacP,SpATywNh6bZuzm8s1ceuBUnMUAeoAHHw,16,19,7,13,4,0,6,0,49,7.0,2,0.0,10,7,11,4,9,0,2,6,0,32,17,0
3488,88213,6mJ65eKOiDJ0B2UMjBjMI3Dy4vxZcYQe,A3fsA9Zfv1X2fVEQhTw51lKENdNrEqT3,15,17,11,0,5,4,2,0,39,5.571428571428571,2,0.0,0,11,0,5,17,4,0,2,0,16,23,0
3489,88216,M8C9BDFICk4ida59GU0jjp556zazDEi1,RXDvfPUBYFlVdlueBFbLW0mhhAyGEqpt,16,16,10,21,5,0,4,0,56,8.0,2,0.0,4,10,21,5,12,0,0,4,0,40,16,1
3490,88378,Re4UOQXOMU2zm8GKuNadx9755IwHNGSX,7GRhBDsirIGkRZBtSMEzNTyDr2JQm4xx,2,0,0,0,0,0,4,0,4,0.5714285714285714,1,0.0,0,0,0,0,0,0,0,4,0,0,4,1
3491,88379,uXRfDeihF0hkAkJm7sgGsGBDRqSDq177,7GRhBDsirIGkRZBtSMEzNTyDr2JQm4xx,9,15,6,0,3,1,5,0,30,4.285714285714286,1,0.0,1,6,0,3,14,1,0,5,0,10,20,1
3492,88421,QOc3KAKkR4oB1aPHWnnoHskpc1gxhWoJ,7GRhBDsirIGkRZBtSMEzNTyDr2JQm4xx,5,2,1,0,0,0,6,2,11,1.5714285714285714,2,0.0,0,1,0,0,2,0,0,6,2,1,10,0
3493,88481,N2FuIOQxHi4oGMJNbbYINfgS8eLaVkEY,7GRhBDsirIGkRZBtSMEzNTyDr2JQm4xx,2,0,0,0,0,0,2,0,2,0.2857142857142857,1,0.0,0,0,0,0,0,0,0,2,0,0,2,1
3494,88527,VwAQN5jl3pwsYKyGQTMhCoHGJ3YHi87f,7GRhBDsirIGkRZBtSMEzNTyDr2JQm4xx,2,0,0,0,0,0,2,0,2,0.2857142857142857,1,0.0,0,0,0,0,0,0,0,2,0,0,2,1
3495,88536,8gfCGxZ6lFjZr89RwPF8oXZs1Qn6Pq6X,7GRhBDsirIGkRZBtSMEzNTyDr2JQm4xx,5,1,1,0,0,0,4,0,6,0.8571428571428571,1,0.0,0,1,0,0,1,0,0,4,0,1,5,1
3496,88562,LLVsvExZGFAkPOPauc0mDK88Em0n3cCC,7GRhBDsirIGkRZBtSMEzNTyDr2JQm4xx,6,8,4,0,0,0,7,0,19,2.7142857142857144,1,0.0,0,4,0,0,8,0,0,7,0,4,15,1
3497,88585,I45Q3yivyiRN2kHVhbV8bUCfrXvtpUvU,7GRhBDsirIGkRZBtSMEzNTyDr2JQm4xx,6,4,2,0,2,0,2,0,10,1.4285714285714286,1,0.0,0,2,0,2,4,0,0,2,0,4,6,1
3498,88625,tWlnNsUcyPPaUr4wTjyNOcGM9Bihy4wT,7GRhBDsirIGkRZBtSMEzNTyDr2JQm4xx,1,0,0,0,0,0,1,0,1,0.14285714285714285,1,0.0,0,0,0,0,0,0,0,1,0,0,1,1
3499,88656,dehhpoRrM4rg7t676Y7qCiumWRV2WOzS,7GRhBDsirIGkRZBtSMEzNTyDr2JQm4xx,32,42,18,79,13,12,2,0,166,23.714285714285715,1,0.0,22,18,76,13,20,12,3,2,0,129,37,1
3500,88774,bu1uIofAEXp6y759RqllOrvBV32SRihX,fbPkOYLVPtPgIt0MxizjfFJov3JbHyAi,6,7,2,0,3,0,1,0,13,1.8571428571428572,1,0.0,2,2,0,3,5,0,0,1,0,7,6,1
3501,88776,vYczGhgY6hRrqG3zxTp11QHECk2atn6B,fbPkOYLVPtPgIt0MxizjfFJov3JbHyAi,1,0,0,0,0,0,1,0,1,0.14285714285714285,1,0.0,0,0,0,0,0,0,0,1,0,0,1,1
3502,88779,iNn3GY2iMNNtDv4o6NBexjhb9hKLROis,fbPkOYLVPtPgIt0MxizjfFJov3JbHyAi,8,3,2,0,2,1,7,0,15,2.142857142857143,1,0.0,0,2,0,2,3,1,0,7,0,4,11,1
3503,88781,qWMwjLnEJjczF5VTHIYJc2IYsIWCauLR,fbPkOYLVPtPgIt0MxizjfFJov3JbHyAi,1,0,0,0,0,0,1,0,1,0.14285714285714285,1,0.0,0,0,0,0,0,0,0,1,0,0,1,1
3504,88786,vSChBkDKZDj0rGwM1GtwFmYGnjiDkIOW,fbPkOYLVPtPgIt0MxizjfFJov3JbHyAi,7,3,2,0,2,0,3,0,10,1.4285714285714286,1,0.0,0,2,0,2,3,0,0,3,0,4,6,1
3505,88792,iSqOqP6glvJYYgjvVVmRA8ZoUSLDsK6d,fbPkOYLVPtPgIt0MxizjfFJov3JbHyAi,10,17,0,0,0,4,4,0,25,3.5714285714285716,1,0.0,0,0,0,0,17,4,0,4,0,0,25,1
3506,88794,kkbu1cG9inVmqEkdKJKJuXBK4YtOWY9c,fbPkOYLVPtPgIt0MxizjfFJov3JbHyAi,12,17,11,0,7,31,18,2,86,12.285714285714286,2,0.0,0,11,0,7,17,31,0,18,2,18,68,1
3507,88795,0Ak7DRLBwBUTJguUJwEJj8xSRI6vwPPn,fbPkOYLVPtPgIt0MxizjfFJov3JbHyAi,1,0,0,0,0,0,1,0,1,0.14285714285714285,1,0.0,0,0,0,0,0,0,0,1,0,0,1,1
3508,88796,UiiOcn6NP18L6Qa9IVzPK487RvBT0lsx,fbPkOYLVPtPgIt0MxizjfFJov3JbHyAi,9,7,2,2,3,0,6,0,20,2.857142857142857,2,0.0,3,2,2,3,4,0,0,6,0,10,10,1
3509,88798,ve5RU3FKgJWxFE29I7niN6ycQVJrJFg4,fbPkOYLVPtPgIt0MxizjfFJov3JbHyAi,1,0,0,0,0,0,1,0,1,0.14285714285714285,1,0.0,0,0,0,0,0,0,0,1,0,0,1,0
3510,88801,o7nB1nybhMcFgLy31X3R6RDOK94b1Iaa,fbPkOYLVPtPgIt0MxizjfFJov3JbHyAi,1,0,0,0,0,0,1,0,1,0.14285714285714285,1,0.0,0,0,0,0,0,0,0,1,0,0,1,1
3511,88807,7NFw5LeL3eVsvkPDcb0VUxu8lVItKrJ1,fbPkOYLVPtPgIt0MxizjfFJov3JbHyAi,6,1,1,0,1,0,3,0,6,0.8571428571428571,1,0.0,0,1,0,1,1,0,0,3,0,2,4,1
3512,88812,PeUQJJiLjuIkI3TtwdkKlVprakOI9tf7,fbPkOYLVPtPgIt0MxizjfFJov3JbHyAi,11,14,9,2,5,12,5,0,47,6.714285714285714,3,0.0,1,9,2,5,13,12,0,5,0,17,30,1
3513,88816,X6obkU5FlEZFIiOk6MXrjhBqZaDGxW04,fbPkOYLVPtPgIt0MxizjfFJov3JbHyAi,5,5,2,0,0,0,4,0,11,1.5714285714285714,1,0.0,2,2,0,0,3,0,0,4,0,4,7,1
3514,88817,8fvsCrC8dcOje6DxrGntnTxmufYXJCrq,fbPkOYLVPtPgIt0MxizjfFJov3JbHyAi,5,3,2,0,2,3,0,0,10,1.4285714285714286,1,0.0,0,2,0,2,3,3,0,0,0,4,6,1
3515,88819,b0RJDCT6ztjQgqXKC4k3XnnVgTiN1Yo8,fbPkOYLVPtPgIt0MxizjfFJov3JbHyAi,7,4,2,0,2,0,3,0,11,1.5714285714285714,1,0.0,1,2,0,2,3,0,0,3,0,5,6,1
3516,88827,HRqYDSGbWA4dSXQsJ8hpWgRfS7ylZUt3,fbPkOYLVPtPgIt0MxizjfFJov3JbHyAi,1,0,0,0,0,0,1,0,1,0.14285714285714285,1,0.0,0,0,0,0,0,0,0,1,0,0,1,1
3517,88829,Wz7BSBOI9rzgAwf2xVcld90BewMcWv25,fbPkOYLVPtPgIt0MxizjfFJov3JbHyAi,2,0,0,0,0,0,3,0,3,0.42857142857142855,2,0.0,0,0,0,0,0,0,0,3,0,0,3,1
3518,88830,OH8WnAV2MBaaFDQHpnLQPXNjc3Qpxqk2,fbPkOYLVPtPgIt0MxizjfFJov3JbHyAi,5,2,1,0,1,0,2,0,6,0.8571428571428571,1,0.0,0,1,0,1,2,0,0,2,0,2,4,1
3519,88831,54BZa2PEVowNqI6EO6NzeCnkR49ry3oS,fbPkOYLVPtPgIt0MxizjfFJov3JbHyAi,15,11,7,0,6,0,3,1,28,4.0,2,0.0,0,7,0,6,11,0,0,3,1,13,15,0
3520,88836,Q5WIg2xkKAnXbT25kMzwfPcqhoeXQ6O6,fbPkOYLVPtPgIt0MxizjfFJov3JbHyAi,5,4,1,0,0,0,6,0,11,1.5714285714285714,1,0.0,0,1,0,0,4,0,0,6,0,1,10,1
3521,88842,gqL1AoJbIkLDCmEi1SGH37fAu1Zdec1f,fbPkOYLVPtPgIt0MxizjfFJov3JbHyAi,4,2,1,0,1,1,2,0,7,1.0,1,0.0,0,1,0,1,2,1,0,2,0,2,5,1
3522,88844,ZDHeqiQjfEk7rIDSgnURnMSZOtUwJ10H,fbPkOYLVPtPgIt0MxizjfFJov3JbHyAi,2,0,0,0,0,0,5,0,5,0.7142857142857143,1,0.0,0,0,0,0,0,0,0,5,0,0,5,1
3523,88845,eIlDqSEsjE2VA3vAbhP1Z42JoYB6Ak2T,fbPkOYLVPtPgIt0MxizjfFJov3JbHyAi,5,2,1,0,1,0,6,0,10,1.4285714285714286,1,0.0,0,1,0,1,2,0,0,6,0,2,8,1
3524,88848,QNLtuhI0bPryV8RMsGGTDcbcPdbX4kMs,fbPkOYLVPtPgIt0MxizjfFJov3JbHyAi,2,0,0,0,0,0,3,0,3,0.42857142857142855,1,0.0,0,0,0,0,0,0,0,3,0,0,3,1
3525,88849,LSAqQ9qRJ6IA5mDIPLRj3aw5O17rNapz,fbPkOYLVPtPgIt0MxizjfFJov3JbHyAi,9,15,8,0,3,12,6,1,45,6.428571428571429,3,0.0,0,8,0,3,15,12,0,6,1,11,34,1
3526,88854,1kjyC7ahZCsVlNSBwjZNyonjDeeXb2jh,fbPkOYLVPtPgIt0MxizjfFJov3JbHyAi,9,16,7,0,5,103,9,3,143,20.428571428571427,4,0.0,4,7,0,5,12,103,0,9,3,16,127,0
3527,88857,bw9UxZPjqLSacLegO6BK4IbuCk1Em4xv,fbPkOYLVPtPgIt0MxizjfFJov3JbHyAi,8,5,2,0,3,3,4,1,18,2.5714285714285716,1,0.0,2,2,0,3,3,3,0,4,1,7,11,1
3528,89192,qdtUflOgjNtEwAQs5kfj08fBL21x3VNU,SpATywNh6bZuzm8s1ceuBUnMUAeoAHHw,1,0,0,0,0,0,2,0,2,0.2857142857142857,1,0.0,0,0,0,0,0,0,0,2,0,0,2,1
3529,89200,KgPlJUOxzo6K50clHm6VhLAZdTWxAeXA,bWdj2GDclj5ofokWjzoa5jAwMkxCykd6,9,10,4,0,4,0,6,0,24,3.4285714285714284,1,0.0,4,4,0,4,6,0,0,6,0,12,12,1
3530,89203,Uu9HJTuPU1AJpa1Ej1uv2nh5k9DxfLwn,SpATywNh6bZuzm8s1ceuBUnMUAeoAHHw,1,0,0,0,0,0,1,0,1,0.14285714285714285,1,0.0,0,0,0,0,0,0,0,1,0,0,1,1
3531,89218,7LucM9vSYQRj5WElUEHVyxCSXUCCbwlX,SpATywNh6bZuzm8s1ceuBUnMUAeoAHHw,10,12,0,0,0,0,12,1,25,3.5714285714285716,2,0.0,0,0,0,0,12,0,0,12,1,0,25,1
3532,89223,BWy2motGgrgIUCZ4P1YohdMfi2tPp47Y,RXDvfPUBYFlVdlueBFbLW0mhhAyGEqpt,5,5,2,0,1,0,1,0,9,1.2857142857142858,1,0.0,0,2,0,1,5,0,0,1,0,3,6,1
3533,89228,1ZTeBIrbRrFVlBGh19J78zN1bkBytKqn,SpATywNh6bZuzm8s1ceuBUnMUAeoAHHw,2,0,0,0,0,0,2,0,2,0.2857142857142857,1,0.0,0,0,0,0,0,0,0,2,0,0,2,1
3534,89233,8eAdemzlZoqb3LPXg3UGAyOaCroYfZmg,RXDvfPUBYFlVdlueBFbLW0mhhAyGEqpt,17,18,10,11,7,0,2,0,48,6.857142857142857,3,0.0,1,10,10,7,17,0,1,2,0,28,20,1
3535,89236,QM2pO4xP1MmCGymVeJBe4Ub355o8EWcr,bWdj2GDclj5ofokWjzoa5jAwMkxCykd6,5,3,1,0,1,0,2,0,7,1.0,1,0.0,0,1,0,1,3,0,0,2,0,2,5,1
3536,89237,h9qmMnJv0qklBUNKS7VMrlLJy4CMBo05,SpATywNh6bZuzm8s1ceuBUnMUAeoAHHw,5,4,2,0,0,0,3,0,9,1.2857142857142858,1,0.0,0,2,0,0,4,0,0,3,0,2,7,1
3537,89239,UGMWl4hUVp9QjwcWkjjH1sbPQBgn5xrQ,SpATywNh6bZuzm8s1ceuBUnMUAeoAHHw,3,1,0,0,0,0,2,0,3,0.42857142857142855,1,0.0,0,0,0,0,1,0,0,2,0,0,3,1
3538,89241,wegnaf6UPYTo0llSdU8mAv6LbtaJoiyd,SpATywNh6bZuzm8s1ceuBUnMUAeoAHHw,2,1,0,0,0,0,2,0,3,0.42857142857142855,1,0.0,0,0,0,0,1,0,0,2,0,0,3,1
3539,89250,RKKZYIeeZxcb4bVVzfjEMLxVYtQktlhB,G8EPVSXsOYB5YQWZGiz1aVq5Pgr2GrQu,1,0,0,0,0,0,1,0,1,0.14285714285714285,1,0.0,0,0,0,0,0,0,0,1,0,0,1,1
3540,89251,gleoXCfE3tA6f5uM3pUTeqQbfFckrfVd,RXDvfPUBYFlVdlueBFbLW0mhhAyGEqpt,1,0,0,0,0,0,1,0,1,0.14285714285714285,1,0.0,0,0,0,0,0,0,0,1,0,0,1,1
3541,89256,ChYzFAABctmbTCcKox1jjUslr0LvrjbV,SpATywNh6bZuzm8s1ceuBUnMUAeoAHHw,4,1,0,0,0,1,5,0,7,1.0,1,0.0,0,0,0,0,1,1,0,5,0,0,7,1
3542,89270,gEfSYt3WBpt849T4WTB0FbXbrRt5CLQv,SpATywNh6bZuzm8s1ceuBUnMUAeoAHHw,11,21,8,0,0,15,19,3,66,9.428571428571429,1,0.0,4,8,0,0,17,15,0,19,3,12,54,1
3543,89281,yKv3mdAWukUWum1t61vTABExIrvKJ0AU,SpATywNh6bZuzm8s1ceuBUnMUAeoAHHw,7,3,1,0,1,1,8,1,15,2.142857142857143,1,0.0,0,1,0,1,3,1,0,8,1,2,13,1
3544,89299,jBvTFD7LxuGGBRz8wehp1f9k2WItIuV7,SpATywNh6bZuzm8s1ceuBUnMUAeoAHHw,8,3,1,0,1,10,6,1,22,3.142857142857143,1,0.0,0,1,0,1,3,10,0,6,1,2,20,1
3545,89306,5NHJ5bwX3OLzU7LroLiUkr7DhCqHm7Yd,G8EPVSXsOYB5YQWZGiz1aVq5Pgr2GrQu,1,0,0,0,0,0,1,0,1,0.14285714285714285,1,0.0,0,0,0,0,0,0,0,1,0,0,1,1
3546,89318,gBSqr7imZMe4VvRAJjAvzXdfEDgvP8wY,SpATywNh6bZuzm8s1ceuBUnMUAeoAHHw,5,2,1,0,1,0,2,0,6,0.8571428571428571,1,0.0,0,1,0,1,2,0,0,2,0,2,4,1
3547,89324,BOna3ORacJGhjt4FcGMkKNwkDYsEjcvt,SpATywNh6bZuzm8s1ceuBUnMUAeoAHHw,14,22,12,0,6,0,7,0,47,6.714285714285714,3,0.0,0,12,0,6,22,0,0,7,0,18,29,1
3548,89326,wNXelOaGj6HkY91hCddHRdOCiLagph7q,SpATywNh6bZuzm8s1ceuBUnMUAeoAHHw,13,9,4,18,3,0,3,0,37,5.285714285714286,1,0.0,5,4,15,3,4,0,3,3,0,27,10,0
3549,89332,orWLR4UhuJawyT3Ov1vj8DpKoW3alfLI,SpATywNh6bZuzm8s1ceuBUnMUAeoAHHw,7,5,1,0,1,1,4,0,12,1.7142857142857142,1,0.0,0,1,0,1,5,1,0,4,0,2,10,1
3550,89333,NkHKHGQ1t9WfF0WY6b3ThoMuQiXODoZm,SpATywNh6bZuzm8s1ceuBUnMUAeoAHHw,17,34,13,18,7,0,34,2,108,15.428571428571429,2,0.0,4,13,15,7,30,0,3,34,2,39,69,1
3551,89336,Pmww0SJUHaKN8gulRmzkCa5ajmPTXJLo,SpATywNh6bZuzm8s1ceuBUnMUAeoAHHw,15,14,5,10,4,1,5,0,39,5.571428571428571,1,0.0,5,5,9,4,9,1,1,5,0,23,16,1
3552,89342,HkLybTJ0rEPGE4JvzzYK050V4PCx14xg,SpATywNh6bZuzm8s1ceuBUnMUAeoAHHw,12,18,10,4,4,0,9,0,45,6.428571428571429,2,0.0,0,10,4,4,18,0,0,9,0,18,27,1
3553,89366,DswbrMY6sPJD5b1m5ODFx580irKlb07k,SpATywNh6bZuzm8s1ceuBUnMUAeoAHHw,3,2,0,0,0,0,1,0,3,0.42857142857142855,1,0.0,0,0,0,0,2,0,0,1,0,0,3,1
3554,89369,aulAQhL9pTbme70JKMz61j88uhAKeUZs,SpATywNh6bZuzm8s1ceuBUnMUAeoAHHw,1,0,0,0,0,0,1,0,1,0.14285714285714285,1,0.0,0,0,0,0,0,0,0,1,0,0,1,1
3555,89373,PqxW0fs8xtO0oqw8MXcVBsN6WdOuPEkP,SpATywNh6bZuzm8s1ceuBUnMUAeoAHHw,16,15,8,8,5,1,9,1,47,6.714285714285714,1,0.0,6,8,7,5,9,1,1,9,1,26,21,1
3556,89380,5rjYFuFo5D0yRo1dV2LjaXf9wIi8Axa0,SpATywNh6bZuzm8s1ceuBUnMUAeoAHHw,3,2,0,0,0,2,5,0,9,1.2857142857142858,1,0.0,0,0,0,0,2,2,0,5,0,0,9,1
3557,89381,Ryr7edEzpzXZS735AEqOzJJJwXWQPdd0,SpATywNh6bZuzm8s1ceuBUnMUAeoAHHw,4,2,1,0,0,0,2,0,5,0.7142857142857143,1,0.0,0,1,0,0,2,0,0,2,0,1,4,1
3558,89383,bEdF35UbCc85Bz4pUhhoEkUONzXdnpDg,SpATywNh6bZuzm8s1ceuBUnMUAeoAHHw,11,6,0,14,0,8,5,1,34,4.857142857142857,1,0.0,2,0,11,0,4,8,3,5,1,13,21,1
3559,89390,3Ks5QZGHTPRjC7k0qconLYz2L7E6QNo7,SpATywNh6bZuzm8s1ceuBUnMUAeoAHHw,7,2,1,0,1,0,9,0,13,1.8571428571428572,1,0.0,0,1,0,1,2,0,0,9,0,2,11,1
3560,89393,ishZb4e9jFXg2QviC2ko889EaUZeTZU9,SpATywNh6bZuzm8s1ceuBUnMUAeoAHHw,15,40,15,28,8,19,21,1,132,18.857142857142858,4,0.0,20,15,23,8,20,19,5,21,1,66,66,1
3561,89395,3bFfBpBuKdxav891YoVnpf8j830LveoM,SpATywNh6bZuzm8s1ceuBUnMUAeoAHHw,8,10,8,0,7,0,3,0,28,4.0,1,0.0,0,8,0,7,10,0,0,3,0,15,13,1
3562,89407,5dwj8tU2wkUoDpYyu0cC8IGAIxW1A4P6,SpATywNh6bZuzm8s1ceuBUnMUAeoAHHw,13,7,4,15,3,0,2,0,31,4.428571428571429,1,0.0,2,4,13,3,5,0,2,2,0,22,9,1
3563,89411,xSMp0r4oxogHBl1WzBSO421fVgDtvwXN,SpATywNh6bZuzm8s1ceuBUnMUAeoAHHw,16,11,6,12,3,12,9,1,54,7.714285714285714,3,0.0,2,6,9,3,9,12,3,9,1,20,34,1
3564,89415,mzOGsK1l4jUAAFEU0Ebe2O2EryG7sXnC,SpATywNh6bZuzm8s1ceuBUnMUAeoAHHw,9,5,1,0,0,4,17,1,28,4.0,3,0.0,0,1,0,0,5,4,0,17,1,1,27,1
3565,89424,QwfRZLEwZGuNcU9jWD0umpLbrwVdhurg,bWdj2GDclj5ofokWjzoa5jAwMkxCykd6,2,0,0,0,0,0,2,0,2,0.2857142857142857,1,0.0,0,0,0,0,0,0,0,2,0,0,2,1
3566,89425,pp1wOcFtHNfcc3zqTz1uxK4VRHQ4zZyX,SpATywNh6bZuzm8s1ceuBUnMUAeoAHHw,6,6,4,0,3,0,3,0,16,2.2857142857142856,1,0.0,0,4,0,3,6,0,0,3,0,7,9,1
3567,89444,KxE6jjAaHiS10lURgTs1mFbTR6SMOswm,SpATywNh6bZuzm8s1ceuBUnMUAeoAHHw,9,11,5,0,4,0,5,0,25,3.5714285714285716,1,0.0,0,5,0,4,11,0,0,5,0,9,16,1
3568,89452,uqXaJBjlB2fR1jGFPXdDLi7hSsdUaco6,bWdj2GDclj5ofokWjzoa5jAwMkxCykd6,5,2,1,0,1,0,3,0,7,1.0,2,0.0,0,1,0,1,2,0,0,3,0,2,5,1
3569,89453,13KVd5Q0kPTyZsaU7eMkcHJocQWxd1Ax,SpATywNh6bZuzm8s1ceuBUnMUAeoAHHw,6,3,1,0,1,0,2,0,7,1.0,1,0.0,0,1,0,1,3,0,0,2,0,2,5,1
3570,89458,iIWDWKAN8CRJ0yZ5zDSccFCRQRwFgxP8,SpATywNh6bZuzm8s1ceuBUnMUAeoAHHw,10,18,4,0,2,0,5,0,29,4.142857142857143,4,0.0,0,4,0,2,18,0,0,5,0,6,23,1
3571,89462,bX1EJ8H8O7LvPaK2JoRVQC0BaLpmhHE6,SpATywNh6bZuzm8s1ceuBUnMUAeoAHHw,9,10,4,0,1,14,11,2,42,6.0,2,0.0,2,4,0,1,8,14,0,11,2,7,35,0
3572,89463,lV4ifbsehEXWBwQOY9bU762jcRSMFY5M,G8EPVSXsOYB5YQWZGiz1aVq5Pgr2GrQu,4,3,1,0,1,0,1,0,6,0.8571428571428571,1,0.0,0,1,0,1,3,0,0,1,0,2,4,1
3573,89466,IQDJ7vNX3TboLO3MBJIrKiI8pMYx3UfV,SpATywNh6bZuzm8s1ceuBUnMUAeoAHHw,3,0,0,0,0,2,3,0,5,0.7142857142857143,2,0.0,0,0,0,0,0,2,0,3,0,0,5,1
3574,89468,mqlH8gZPP9MOgmB9cgrLKBfSrQuIKKN0,SpATywNh6bZuzm8s1ceuBUnMUAeoAHHw,11,9,6,0,4,1,12,2,34,4.857142857142857,1,0.0,0,6,0,4,9,1,0,12,2,10,24,1
3575,89473,1xcKG4Eeqo6PRlQtqz4lRNBDzvKhe7qL,RXDvfPUBYFlVdlueBFbLW0mhhAyGEqpt,1,0,0,0,0,0,1,0,1,0.14285714285714285,1,0.0,0,0,0,0,0,0,0,1,0,0,1,1
3576,89474,4d7nO3w6797t7DH3QeDnTWHOfNO2pqQC,bWdj2GDclj5ofokWjzoa5jAwMkxCykd6,6,3,1,0,1,3,4,0,12,1.7142857142857142,1,0.0,0,1,0,1,3,3,0,4,0,2,10,1
3577,89476,rX7gdFv8DKFX0CCz7kGKG6ViXpNH34BO,SpATywNh6bZuzm8s1ceuBUnMUAeoAHHw,3,2,0,0,0,0,1,0,3,0.42857142857142855,1,0.0,0,0,0,0,2,0,0,1,0,0,3,0
3578,89489,yxJSlYQPHVk2OJMV54ToOtJy9WMHex3A,SpATywNh6bZuzm8s1ceuBUnMUAeoAHHw,9,8,6,0,5,0,3,0,22,3.142857142857143,1,0.0,0,6,0,5,8,0,0,3,0,11,11,1
3579,89495,5pjAdY5K4FfgQPLSzQKwXaKF78ph9a0y,SpATywNh6bZuzm8s1ceuBUnMUAeoAHHw,5,12,6,0,4,0,4,0,26,3.7142857142857144,2,0.0,0,6,0,4,12,0,0,4,0,10,16,1
3580,89507,mR9Awu9GGhq6cpZDsN1vhsOMBBjHJTwu,RXDvfPUBYFlVdlueBFbLW0mhhAyGEqpt,5,2,1,0,1,0,2,0,6,0.8571428571428571,1,0.0,0,1,0,1,2,0,0,2,0,2,4,1
3581,89516,EzpgLqOBulY4ZVl8QROIPzKxMW9zpKpw,RXDvfPUBYFlVdlueBFbLW0mhhAyGEqpt,1,0,0,0,0,0,1,0,1,0.14285714285714285,1,0.0,0,0,0,0,0,0,0,1,0,0,1,1
3582,89532,8irCUZa4UAKsYYFeHrY9ttb5xgcL2ou7,SpATywNh6bZuzm8s1ceuBUnMUAeoAHHw,8,4,3,0,3,0,1,0,11,1.5714285714285714,1,0.0,0,3,0,3,4,0,0,1,0,6,5,1
3583,89534,k9cA91Q0OJFR9AY1JvRoKP3p8rLkgPCD,bWdj2GDclj5ofokWjzoa5jAwMkxCykd6,18,33,2,82,5,0,16,1,139,19.857142857142858,1,0.0,12,2,73,5,21,0,9,16,1,92,47,1
3584,89540,rHj6Vmp3P9JbmX7QWrSBu45DuiDb8koF,SpATywNh6bZuzm8s1ceuBUnMUAeoAHHw,10,17,2,0,1,1,11,0,32,4.571428571428571,3,0.0,0,2,0,1,17,1,0,11,0,3,29,1
3585,89560,fUNdgzfWSE4HzsYQQ7FDu5pyDUIMQ40m,G8EPVSXsOYB5YQWZGiz1aVq5Pgr2GrQu,38,113,46,72,25,4,6,0,266,38.0,3,0.0,32,46,53,25,81,4,19,6,0,156,110,1
3586,89561,4t1KNzzepvalCibuzOk5JUX041jKqU9v,SpATywNh6bZuzm8s1ceuBUnMUAeoAHHw,6,3,1,0,1,0,2,0,7,1.0,1,0.0,0,1,0,1,3,0,0,2,0,2,5,1
3587,89566,EDtcftLQ1x638xVsHSB1SBOPZ3SKRCar,G8EPVSXsOYB5YQWZGiz1aVq5Pgr2GrQu,18,69,0,42,8,0,4,0,123,17.571428571428573,2,0.0,33,0,30,8,36,0,12,4,0,71,52,1
3588,89571,YuqMJYvTgiTQGQOAOb2fKJpGas8AG3Wr,SpATywNh6bZuzm8s1ceuBUnMUAeoAHHw,7,8,0,0,1,0,2,0,11,1.5714285714285714,2,0.0,0,0,0,1,8,0,0,2,0,1,10,0
3589,89574,EJIkk1z1GAyTxouBU8smmsjhIBwzBhn1,G8EPVSXsOYB5YQWZGiz1aVq5Pgr2GrQu,1,0,0,0,0,0,1,0,1,0.14285714285714285,1,0.0,0,0,0,0,0,0,0,1,0,0,1,1
3590,89578,2fyY2ZIcA0PnrwGuxHsgvHzUiuyeQCT0,bWdj2GDclj5ofokWjzoa5jAwMkxCykd6,5,9,1,0,0,0,7,0,17,2.4285714285714284,2,0.0,0,1,0,0,9,0,0,7,0,1,16,1
3591,89579,Jeu98URtKOymkXqWZxWi1Dpseg2MOPzv,SpATywNh6bZuzm8s1ceuBUnMUAeoAHHw,8,3,2,0,2,1,4,0,12,1.7142857142857142,1,0.0,0,2,0,2,3,1,0,4,0,4,8,1
3592,89580,UhOcaLqs0mKdRyLwomBmAslkjoePthdJ,SpATywNh6bZuzm8s1ceuBUnMUAeoAHHw,6,0,0,0,0,1,5,1,7,1.0,1,0.0,0,0,0,0,0,1,0,5,1,0,7,1
3593,89584,oiThQK6e6zf4TZYBDNHB9rtiG2PNPeXO,SpATywNh6bZuzm8s1ceuBUnMUAeoAHHw,19,49,23,7,10,1,25,1,116,16.571428571428573,6,0.0,15,23,7,10,34,1,0,25,1,55,61,1
3594,89588,kbrfSPxlM4KkcRw6pTtSThBRf28etAVC,SpATywNh6bZuzm8s1ceuBUnMUAeoAHHw,11,7,1,0,1,2,7,1,19,2.7142857142857144,1,0.0,0,1,0,1,7,2,0,7,1,2,17,1
3595,89591,O6XTfrmBXPHHKFN07CLCPWqyMP9NsQuf,bWdj2GDclj5ofokWjzoa5jAwMkxCykd6,10,10,7,0,4,1,13,0,35,5.0,1,0.0,0,7,0,4,10,1,0,13,0,11,24,1
3596,89592,IkodCQwdqpqIcCcUv2ohgHFT9sJ1SLin,SpATywNh6bZuzm8s1ceuBUnMUAeoAHHw,5,2,1,0,1,0,2,0,6,0.8571428571428571,1,0.0,0,1,0,1,2,0,0,2,0,2,4,1
3597,89593,D8IYaZZCq2kwCopNPookpH1TvQs8o6b0,SpATywNh6bZuzm8s1ceuBUnMUAeoAHHw,11,8,3,0,2,4,8,1,26,3.7142857142857144,1,0.0,0,3,0,2,8,4,0,8,1,5,21,1
3598,89595,6OfXNoCI7Waq7DTFUWFiUcQXC3Cg0WKC,SpATywNh6bZuzm8s1ceuBUnMUAeoAHHw,12,7,4,18,3,0,1,0,33,4.714285714285714,1,0.0,2,4,15,3,5,0,3,1,0,24,9,1
3599,89598,ApFdQQBcLqTLoA4wIvtlnnwFs4FrlVS1,bWdj2GDclj5ofokWjzoa5jAwMkxCykd6,7,4,2,0,0,1,8,1,16,2.2857142857142856,3,0.0,0,2,0,0,4,1,0,8,1,2,14,1
3600,89602,a2CgRiICJuj7paJToANbolKFuh4xahGM,SpATywNh6bZuzm8s1ceuBUnMUAeoAHHw,1,0,0,0,0,0,1,0,1,0.14285714285714285,1,0.0,0,0,0,0,0,0,0,1,0,0,1,1
3601,89612,tYV9adHfuBbrO1GuvSyU9WLWt5LNmPTX,SpATywNh6bZuzm8s1ceuBUnMUAeoAHHw,11,11,4,0,2,8,7,1,33,4.714285714285714,2,0.0,1,4,0,2,10,8,0,7,1,7,26,1
3602,89618,q1qea15PiUc6DOfucwnleCxcnYIfvxHK,SpATywNh6bZuzm8s1ceuBUnMUAeoAHHw,5,6,0,0,0,0,4,1,11,1.5714285714285714,1,0.0,0,0,0,0,6,0,0,4,1,0,11,1
3603,89619,s6NTLcoRryN4aDfvO1qsCQXhze6kEfOl,G8EPVSXsOYB5YQWZGiz1aVq5Pgr2GrQu,6,0,0,0,0,0,7,1,8,1.1428571428571428,1,0.0,0,0,0,0,0,0,0,7,1,0,8,1
3604,89625,LUfJKoRDjcYKUaxb5bwr7doPqmv3K3xe,SpATywNh6bZuzm8s1ceuBUnMUAeoAHHw,31,33,18,39,9,0,9,0,108,15.428571428571429,3,0.0,11,18,33,9,22,0,6,9,0,71,37,1
3605,89628,K34V3e7xSbcwBnfPQw1X6hTJl6udnY0r,RXDvfPUBYFlVdlueBFbLW0mhhAyGEqpt,6,6,3,0,2,1,2,0,14,2.0,1,0.0,0,3,0,2,6,1,0,2,0,5,9,1
3606,89630,Z86ZMxsvWnnyZOKQGNVOWlv60hWLfFNN,G8EPVSXsOYB5YQWZGiz1aVq5Pgr2GrQu,8,10,1,0,1,1,4,0,17,2.4285714285714284,1,0.0,0,1,0,1,10,1,0,4,0,2,15,1
3607,89643,162MrslUTKGd3KlPrbeWS5Qw6KVPvj8q,SpATywNh6bZuzm8s1ceuBUnMUAeoAHHw,5,7,3,0,2,0,3,0,15,2.142857142857143,2,0.0,0,3,0,2,7,0,0,3,0,5,10,1
3608,89645,162MrslUTKGd3KlPrbeWS5Qw6KVPvj8q,bWdj2GDclj5ofokWjzoa5jAwMkxCykd6,6,7,3,0,2,1,2,0,15,2.142857142857143,1,0.0,0,3,0,2,7,1,0,2,0,5,10,1
3609,89655,Ev3g9egQXLhml9mOEMZMdMQN5Z5Fjc5k,G8EPVSXsOYB5YQWZGiz1aVq5Pgr2GrQu,6,3,2,0,2,0,2,0,9,1.2857142857142858,1,0.0,0,2,0,2,3,0,0,2,0,4,5,1
3610,89662,g8m22R7W0Wo8v9RXY0TMbj5qf5RFgvht,bWdj2GDclj5ofokWjzoa5jAwMkxCykd6,7,4,2,0,1,0,6,0,13,1.8571428571428572,2,0.0,0,2,0,1,4,0,0,6,0,3,10,1
3611,89668,EDtcftLQ1x638xVsHSB1SBOPZ3SKRCar,bWdj2GDclj5ofokWjzoa5jAwMkxCykd6,3,4,0,0,1,0,1,0,6,0.8571428571428571,1,0.0,2,0,0,1,2,0,0,1,0,3,3,1
3612,89671,wJC86gc3viBGM4vTuYg8647vhYAtlLLc,G8EPVSXsOYB5YQWZGiz1aVq5Pgr2GrQu,6,3,2,0,2,0,2,0,9,1.2857142857142858,1,0.0,0,2,0,2,3,0,0,2,0,4,5,1
3613,89673,I3y8UhgjOmrKX2NiYCp9q6amv1bHjqBJ,SpATywNh6bZuzm8s1ceuBUnMUAeoAHHw,2,0,0,0,0,0,2,0,2,0.2857142857142857,1,0.0,0,0,0,0,0,0,0,2,0,0,2,1
3614,89674,X1EwqmDy4MdORdVb79oGgVGVtNlVZgX3,SpATywNh6bZuzm8s1ceuBUnMUAeoAHHw,11,11,7,0,3,4,13,3,41,5.857142857142857,1,0.0,0,7,0,3,11,4,0,13,3,10,31,0
3615,89679,8MQx62NrM26CEa5RRkhFUh36AiGGNx6S,bWdj2GDclj5ofokWjzoa5jAwMkxCykd6,1,0,0,0,0,0,1,0,1,0.14285714285714285,1,0.0,0,0,0,0,0,0,0,1,0,0,1,1
3616,89680,xOGjXyyeq87fCMSZ9z7Yuds9sMvR7Ohh,bWdj2GDclj5ofokWjzoa5jAwMkxCykd6,7,5,1,0,2,1,4,2,15,2.142857142857143,1,0.0,3,1,0,2,2,1,0,4,2,6,9,1
3617,89683,JGkH5G6iVBgcA8nzn9agd5N20Wo6tva5,SpATywNh6bZuzm8s1ceuBUnMUAeoAHHw,7,5,3,0,2,0,2,0,12,1.7142857142857142,1,0.0,0,3,0,2,5,0,0,2,0,5,7,1
3618,89701,BawZLFtQaV6cG6ZH5ggA2jwB1HVUhop0,SpATywNh6bZuzm8s1ceuBUnMUAeoAHHw,4,3,1,0,1,0,1,0,6,0.8571428571428571,1,0.0,1,1,0,1,2,0,0,1,0,3,3,1
3619,89702,jsOwPYXTKA5LkdsyLdqfrvO6hpqy63Mk,SpATywNh6bZuzm8s1ceuBUnMUAeoAHHw,6,2,1,0,0,0,4,1,8,1.1428571428571428,1,0.0,0,1,0,0,2,0,0,4,1,1,7,1
3620,89711,Jm4nQ05ndX10jbofbWx6S0r9VXrqia6S,RXDvfPUBYFlVdlueBFbLW0mhhAyGEqpt,15,11,8,14,3,0,4,0,40,5.714285714285714,2,0.0,1,8,12,3,10,0,2,4,0,24,16,0
3621,89717,oyvbie49Qmum2sCNKvrecvOzGpEvkIP4,SpATywNh6bZuzm8s1ceuBUnMUAeoAHHw,16,52,13,16,4,6,8,1,100,14.285714285714286,2,0.0,19,13,13,4,33,6,3,8,1,49,51,1
3622,89722,TvtAHA9SMsJXnMoIbE5m05sk6M63p1ir,SpATywNh6bZuzm8s1ceuBUnMUAeoAHHw,16,14,5,22,3,44,7,1,96,13.714285714285714,1,0.0,8,5,19,3,6,44,3,7,1,35,61,1
3623,89732,pdAqVvKgeCIaihAcxhTXOYjPQxxjaa8K,RXDvfPUBYFlVdlueBFbLW0mhhAyGEqpt,16,29,15,0,8,0,4,0,56,8.0,1,0.0,0,15,0,8,29,0,0,4,0,23,33,1
3624,89751,CFwBanDE4eguHX9lcM62Yx5Bex6437kC,G8EPVSXsOYB5YQWZGiz1aVq5Pgr2GrQu,8,8,3,0,1,0,6,0,18,2.5714285714285716,2,0.0,1,3,0,1,7,0,0,6,0,5,13,0
3625,89756,5NinyROX9yWmUO2bbNeT57UVFrKKhh1e,bWdj2GDclj5ofokWjzoa5jAwMkxCykd6,8,3,2,0,2,7,7,1,22,3.142857142857143,1,0.0,0,2,0,2,3,7,0,7,1,4,18,1
3626,89761,z7RFKPeiml5DwwuxMd7W3zDeb96W3IO0,RXDvfPUBYFlVdlueBFbLW0mhhAyGEqpt,10,6,1,0,0,4,6,1,18,2.5714285714285716,1,0.0,0,1,0,0,6,4,0,6,1,1,17,1
3627,89768,F9x8grjHwXdHsc7U2XmuUJNLu8xnTwnR,bWdj2GDclj5ofokWjzoa5jAwMkxCykd6,6,2,1,0,1,0,3,0,7,1.0,2,0.0,0,1,0,1,2,0,0,3,0,2,5,1
3628,89769,CSJLoVtcCokkcrypV6hcHsBSCZUBCpjE,bWdj2GDclj5ofokWjzoa5jAwMkxCykd6,1,0,0,0,0,0,1,0,1,0.14285714285714285,1,0.0,0,0,0,0,0,0,0,1,0,0,1,1
3629,89790,TY6sQZiKCIo3eegNCTkjQ3fisPy9bRK1,SpATywNh6bZuzm8s1ceuBUnMUAeoAHHw,14,14,6,13,4,0,4,0,41,5.857142857142857,1,0.0,6,6,10,4,8,0,3,4,0,26,15,1
3630,89794,4Veu3UF7DzwSpX1OH30ULcMtQdVZ7ynq,SpATywNh6bZuzm8s1ceuBUnMUAeoAHHw,2,0,0,0,0,0,2,0,2,0.2857142857142857,1,0.0,0,0,0,0,0,0,0,2,0,0,2,1
3631,89803,md5EYhUly1ZvdBwm1DSKfst7q3ukcqZb,G8EPVSXsOYB5YQWZGiz1aVq5Pgr2GrQu,13,5,4,26,1,0,7,0,43,6.142857142857143,1,0.0,0,4,21,1,5,0,5,7,0,26,17,1
3632,89805,aLRP3ahB5SIcOn5vpM1VPEh9ib2QIioX,RXDvfPUBYFlVdlueBFbLW0mhhAyGEqpt,7,7,0,0,0,0,3,0,10,1.4285714285714286,1,0.0,0,0,0,0,7,0,0,3,0,0,10,1
3633,89815,hAvRuLAx7AEDY4wHRae0fvokMiSUSODR,SpATywNh6bZuzm8s1ceuBUnMUAeoAHHw,12,9,5,0,3,1,7,1,26,3.7142857142857144,1,0.0,0,5,0,3,9,1,0,7,1,8,18,1
3634,89820,9q1YIqGYM9tyKLlkxbnN8O6FbjsGmlHe,SpATywNh6bZuzm8s1ceuBUnMUAeoAHHw,12,10,0,6,0,0,4,2,22,3.142857142857143,1,0.0,4,0,6,0,6,0,0,4,2,10,12,1
3635,89821,hOSvBRM2cv2WmjSd4f7WDA9Dp5KsacO1,RXDvfPUBYFlVdlueBFbLW0mhhAyGEqpt,2,0,0,0,0,0,2,0,2,0.2857142857142857,1,0.0,0,0,0,0,0,0,0,2,0,0,2,1
3636,89834,lt4iWOuay8QhJ4JJzXkh1WtUiAfTTub9,G8EPVSXsOYB5YQWZGiz1aVq5Pgr2GrQu,29,39,9,10,8,2,7,1,76,10.857142857142858,2,0.0,12,9,9,8,27,2,1,7,1,38,38,0
3637,89848,aM0OXe9fMQycCDgfZRBso2FFVWDCpMzh,SpATywNh6bZuzm8s1ceuBUnMUAeoAHHw,6,3,2,0,2,0,1,0,8,1.1428571428571428,1,0.0,0,2,0,2,3,0,0,1,0,4,4,1
3638,89860,Hie5jI1V7aqUGyRciLGioIx6C3WNaVxM,SpATywNh6bZuzm8s1ceuBUnMUAeoAHHw,3,2,0,0,0,0,3,0,5,0.7142857142857143,1,0.0,0,0,0,0,2,0,0,3,0,0,5,1
3639,89862,0K4xNLo4N99mMtk7G0MOnorF2w7z0D9v,SpATywNh6bZuzm8s1ceuBUnMUAeoAHHw,7,4,0,0,0,4,4,1,13,1.8571428571428572,1,0.0,0,0,0,0,4,4,0,4,1,0,13,1
3640,89879,MfeGN5negD9kI6SBc6Puji7S43aQKdkb,SpATywNh6bZuzm8s1ceuBUnMUAeoAHHw,12,13,4,11,3,0,1,0,32,4.571428571428571,1,0.0,8,4,10,3,5,0,1,1,0,25,7,1
3641,89882,eCrgnRWcbj9qFyB1Y7Sof16QQaB01Zyn,SpATywNh6bZuzm8s1ceuBUnMUAeoAHHw,5,2,0,0,0,1,6,2,11,1.5714285714285714,1,0.0,0,0,0,0,2,1,0,6,2,0,11,1
3642,89884,V8mzud5EnZ6pyyl8PZ8V5xSQioudW4lS,SpATywNh6bZuzm8s1ceuBUnMUAeoAHHw,17,21,10,28,5,12,17,5,98,14.0,1,0.0,7,10,20,5,14,12,8,17,5,42,56,1
3643,89888,RFyhyx4ydAt8kwrNtnUfQ8908pWCv8M5,SpATywNh6bZuzm8s1ceuBUnMUAeoAHHw,5,2,1,0,1,4,2,0,10,1.4285714285714286,1,0.0,0,1,0,1,2,4,0,2,0,2,8,1
3644,89891,MrptC6k13DRD7ZeJDHvlsVV8mT19fxZF,SpATywNh6bZuzm8s1ceuBUnMUAeoAHHw,29,42,10,36,7,2,16,3,116,16.571428571428573,3,0.0,21,10,29,7,21,2,7,16,3,67,49,1
3645,89894,0aBA3ELzBRvBOUi1HyR68fXgk8gRhEIU,SpATywNh6bZuzm8s1ceuBUnMUAeoAHHw,10,7,4,0,1,1,8,5,26,3.7142857142857144,1,0.0,0,4,0,1,7,1,0,8,5,5,21,1
3646,89904,zOr0niRplBKfkwpPHNykN96u1FhzegfK,RXDvfPUBYFlVdlueBFbLW0mhhAyGEqpt,7,5,4,0,2,0,1,0,12,1.7142857142857142,1,0.0,0,4,0,2,5,0,0,1,0,6,6,1
3647,89905,5a50T7ZMXA2vPYLquN0RqbmeQaCoB8BF,SpATywNh6bZuzm8s1ceuBUnMUAeoAHHw,9,15,3,0,1,1,8,1,29,4.142857142857143,1,0.0,0,3,0,1,15,1,0,8,1,4,25,1
3648,89915,5JgomgwKuM4fVZ9Q4k6YVCtNM8AozehT,G8EPVSXsOYB5YQWZGiz1aVq5Pgr2GrQu,1,0,0,0,0,0,4,0,4,0.5714285714285714,1,0.0,0,0,0,0,0,0,0,4,0,0,4,1
3649,89924,W3ZCbN2PXgpguBAgrApub7dxzAkot7du,G8EPVSXsOYB5YQWZGiz1aVq5Pgr2GrQu,5,2,1,0,1,0,2,0,6,0.8571428571428571,1,0.0,0,1,0,1,2,0,0,2,0,2,4,1
3650,89934,SHyeADEp9dBkknD932WIgfilEMsUK5Yp,SpATywNh6bZuzm8s1ceuBUnMUAeoAHHw,12,18,1,10,0,15,22,2,68,9.714285714285714,3,0.0,0,1,7,0,18,15,3,22,2,8,60,0
3651,89936,PmZJAFj6wJkOD163WkhaJjRHdYOMjBZW,G8EPVSXsOYB5YQWZGiz1aVq5Pgr2GrQu,6,1,1,0,1,0,3,0,6,0.8571428571428571,1,0.0,0,1,0,1,1,0,0,3,0,2,4,1
3652,89949,dumOcYgAwS6Z3oz3fspRWkVIy9xvyAHF,RXDvfPUBYFlVdlueBFbLW0mhhAyGEqpt,18,21,17,0,2,2,5,4,51,7.285714285714286,1,0.0,0,17,0,2,21,2,0,5,4,19,32,0
3653,89958,3nOS3JEH08BgwunQqioyEFfja4qIND4p,RXDvfPUBYFlVdlueBFbLW0mhhAyGEqpt,13,12,10,0,4,2,1,0,29,4.142857142857143,1,0.0,0,10,0,4,12,2,0,1,0,14,15,1
3654,89974,NrKjQ2TY0jNxjlxFQqBMk613jEN7v6dJ,G8EPVSXsOYB5YQWZGiz1aVq5Pgr2GrQu,28,21,1,50,0,7,5,8,92,13.142857142857142,1,0.0,1,1,45,0,20,7,5,5,8,47,45,1
3655,89981,bjtjAbfCAjoDC0dQv8FIuhfAxmQlWFXq,SpATywNh6bZuzm8s1ceuBUnMUAeoAHHw,1,0,0,0,0,0,1,0,1,0.14285714285714285,1,0.0,0,0,0,0,0,0,0,1,0,0,1,1
3656,89989,SkGcRN6XF7Ju1v3VtnK0PLpmtvUvO3VU,SpATywNh6bZuzm8s1ceuBUnMUAeoAHHw,12,10,5,0,4,0,6,1,26,3.7142857142857144,1,0.0,0,5,0,4,10,0,0,6,1,9,17,1
3657,90001,7slcWSRDm7z3xCcURvkPzfUA6HpEf1rv,SpATywNh6bZuzm8s1ceuBUnMUAeoAHHw,13,8,6,0,4,1,11,3,33,4.714285714285714,1,0.0,0,6,0,4,8,1,0,11,3,10,23,1
3658,90007,LSvU72CFq1TrHd9SCZOiKQ0qcV2oa2Ok,bWdj2GDclj5ofokWjzoa5jAwMkxCykd6,8,10,1,0,1,0,5,0,17,2.4285714285714284,3,0.0,0,1,0,1,10,0,0,5,0,2,15,1
3659,90018,bjoQsxzy5xWbIlWJOK88FLxI1KzCehRN,bWdj2GDclj5ofokWjzoa5jAwMkxCykd6,1,0,0,0,0,0,1,0,1,0.14285714285714285,1,0.0,0,0,0,0,0,0,0,1,0,0,1,1
3660,90026,RyilkQdPLBJZ4lFr5oZI0Ei4sfkfiESh,SpATywNh6bZuzm8s1ceuBUnMUAeoAHHw,12,28,19,20,16,0,2,0,85,12.142857142857142,1,0.0,8,19,17,16,20,0,3,2,0,60,25,0
3661,90031,4dfnEKxHCmGabkBCiKHt5nKr3H7Bwo1x,SpATywNh6bZuzm8s1ceuBUnMUAeoAHHw,7,15,6,0,0,0,4,0,25,3.5714285714285716,3,0.0,3,6,0,0,12,0,0,4,0,9,16,0
3662,90036,FSLbHGHYGlPWdXBDC9WjMUDDSGRCqhaq,SpATywNh6bZuzm8s1ceuBUnMUAeoAHHw,5,6,1,0,0,0,1,0,8,1.1428571428571428,1,0.0,0,1,0,0,6,0,0,1,0,1,7,0
3663,90037,vXbuazCIyAq6baj5We5wdO94RIfbomSS,SpATywNh6bZuzm8s1ceuBUnMUAeoAHHw,11,11,7,0,4,0,5,1,28,4.0,1,0.0,0,7,0,4,11,0,0,5,1,11,17,1
3664,90038,fxZYes73ffCsV30TZKy38cwDGRpz9rUn,RXDvfPUBYFlVdlueBFbLW0mhhAyGEqpt,9,9,5,0,0,0,8,1,23,3.2857142857142856,1,0.0,2,5,0,0,7,0,0,8,1,7,16,0
3665,90043,lm5ZaZLPfaDrtGky2mMb4F6wcz9jTJq6,SpATywNh6bZuzm8s1ceuBUnMUAeoAHHw,5,3,1,0,1,0,1,0,6,0.8571428571428571,1,0.0,0,1,0,1,3,0,0,1,0,2,4,1
3666,90046,xAsW6FY0K65CydYHAmfVcUYiwrdudkde,RXDvfPUBYFlVdlueBFbLW0mhhAyGEqpt,12,11,9,0,7,0,1,0,28,4.0,1,0.0,1,9,0,7,10,0,0,1,0,17,11,1
3667,90048,Vn131dD12fh0kapodbBhio0q4dV4IYmG,G8EPVSXsOYB5YQWZGiz1aVq5Pgr2GrQu,4,2,1,0,1,0,1,0,5,0.7142857142857143,1,0.0,0,1,0,1,2,0,0,1,0,2,3,1
3668,90050,zKJi4lYCojHniGlUzfyvIjevdGsHA6Tj,RXDvfPUBYFlVdlueBFbLW0mhhAyGEqpt,1,0,0,0,0,0,1,0,1,0.14285714285714285,1,0.0,0,0,0,0,0,0,0,1,0,0,1,1
3669,90053,Fz2fUb8uF4DthRTOepts8mTN1u7KYtSZ,SpATywNh6bZuzm8s1ceuBUnMUAeoAHHw,10,7,3,0,3,0,5,0,18,2.5714285714285716,1,0.0,0,3,0,3,7,0,0,5,0,6,12,1
3670,90056,JaIi02fnjAZfoUxjYtpyJ7uZYWKdC5yF,bWdj2GDclj5ofokWjzoa5jAwMkxCykd6,10,32,1,52,4,1,6,1,97,13.857142857142858,1,0.0,10,1,50,4,22,1,2,6,1,65,32,1
3671,90058,OFJM9gLiEJFta7GOEBOgZlB17rEajfDQ,G8EPVSXsOYB5YQWZGiz1aVq5Pgr2GrQu,11,4,1,26,1,0,5,0,37,5.285714285714286,1,0.0,1,1,23,1,3,0,3,5,0,26,11,0
3672,90075,K9KQOSU4fRa8yZTo6p3wgevh5IisB83T,RXDvfPUBYFlVdlueBFbLW0mhhAyGEqpt,2,0,0,0,0,0,2,0,2,0.2857142857142857,1,0.0,0,0,0,0,0,0,0,2,0,0,2,1
3673,90095,pplAmbuLk2c8g7K4eYBlhKFfYSpZgbNo,G8EPVSXsOYB5YQWZGiz1aVq5Pgr2GrQu,1,0,0,0,0,0,1,0,1,0.14285714285714285,1,0.0,0,0,0,0,0,0,0,1,0,0,1,1
3674,90102,GN70rVGXob8SU4MUwDOnczNAPbVNEJYJ,SpATywNh6bZuzm8s1ceuBUnMUAeoAHHw,14,17,2,9,1,1,11,2,43,6.142857142857143,2,0.0,0,2,7,1,17,1,2,11,2,10,33,1
3675,90116,T7izEMyckZ14Dpb0HXCCbCEgRCtemG2v,RXDvfPUBYFlVdlueBFbLW0mhhAyGEqpt,26,41,2,0,1,24,12,14,94,13.428571428571429,5,0.0,2,2,0,1,39,24,0,12,14,5,89,1
3676,90121,PD0QXI0Ip2PVwJ6kJaKkkINkj7BvGZMC,bWdj2GDclj5ofokWjzoa5jAwMkxCykd6,8,1,1,0,1,6,5,1,15,2.142857142857143,1,0.0,0,1,0,1,1,6,0,5,1,2,13,1
3677,90124,NlgFEWO87VQbCzq3S6FQjH7bzvdUhuql,bWdj2GDclj5ofokWjzoa5jAwMkxCykd6,10,12,5,44,3,0,6,0,70,10.0,1,0.0,4,5,43,3,8,0,1,6,0,55,15,1
3678,90126,Q1m0mfQJyZWS3bGl8oxr6Sp3MEPl2r6y,RXDvfPUBYFlVdlueBFbLW0mhhAyGEqpt,10,7,5,0,2,2,9,2,27,3.857142857142857,2,0.0,0,5,0,2,7,2,0,9,2,7,20,1
3679,90127,8inbpMs7MgzODmQl3BpmuUuKMVmeoVgB,RXDvfPUBYFlVdlueBFbLW0mhhAyGEqpt,4,0,0,0,0,0,9,0,9,1.2857142857142858,1,0.0,0,0,0,0,0,0,0,9,0,0,9,1
3680,90129,ErRtUnOkAfZfIgzAYrZFJqhMiEZstwA2,G8EPVSXsOYB5YQWZGiz1aVq5Pgr2GrQu,1,0,0,0,0,0,1,0,1,0.14285714285714285,1,0.0,0,0,0,0,0,0,0,1,0,0,1,1
3681,90133,s1Khmx0UXmesPVY2G1JDbBc7N2AstlLy,bWdj2GDclj5ofokWjzoa5jAwMkxCykd6,1,0,0,0,0,0,1,0,1,0.14285714285714285,1,0.0,0,0,0,0,0,0,0,1,0,0,1,1
3682,90140,jNfz1HF8kGQzQgXHBSG4Wy17SyrpVswM,RXDvfPUBYFlVdlueBFbLW0mhhAyGEqpt,19,30,18,0,12,1,11,1,73,10.428571428571429,1,0.0,0,18,0,12,30,1,0,11,1,30,43,1
3683,90144,clUDzV1xLWOCz6yJz1NXsCWqgZVFuU6d,SpATywNh6bZuzm8s1ceuBUnMUAeoAHHw,13,23,7,0,5,0,5,0,40,5.714285714285714,2,0.0,0,7,0,5,23,0,0,5,0,12,28,0
3684,90145,vFTyJ5TiVtOMNTDle7WFtHDAgvur1Shs,RXDvfPUBYFlVdlueBFbLW0mhhAyGEqpt,70,89,60,105,34,10,11,0,309,44.142857142857146,5,0.0,17,60,95,34,72,10,10,11,0,206,103,1
3685,90154,pBNN08SB8Xk0wCmBzmhWqayfqNGQdsD0,G8EPVSXsOYB5YQWZGiz1aVq5Pgr2GrQu,5,2,1,0,1,0,3,0,7,1.0,1,0.0,0,1,0,1,2,0,0,3,0,2,5,1
3686,90159,uhbUne0Zqx7l0LKNWrxxR44WistJmxKI,G8EPVSXsOYB5YQWZGiz1aVq5Pgr2GrQu,6,9,1,0,0,0,7,0,17,2.4285714285714284,3,0.0,0,1,0,0,9,0,0,7,0,1,16,1
3687,90163,oSabIe7L5topw6hwV4H4ZV0Ug7ZVNxfV,SpATywNh6bZuzm8s1ceuBUnMUAeoAHHw,7,12,1,0,1,0,5,0,19,2.7142857142857144,2,0.0,2,1,0,1,10,0,0,5,0,4,15,0
3688,90164,EJkZzukbCIAgIlh7QDQUWfa1bYDEcyN6,SpATywNh6bZuzm8s1ceuBUnMUAeoAHHw,6,2,1,0,1,0,3,0,7,1.0,1,0.0,0,1,0,1,2,0,0,3,0,2,5,1
3689,90171,5rZEwm9dIq2r0OGFOO4xuxIdyDM4ihsM,G8EPVSXsOYB5YQWZGiz1aVq5Pgr2GrQu,4,3,0,0,0,0,4,0,7,1.0,1,0.0,0,0,0,0,3,0,0,4,0,0,7,1
3690,90181,dtnFILXxHCPYki6VgARxaWrGiWunvtDQ,bWdj2GDclj5ofokWjzoa5jAwMkxCykd6,3,3,0,0,0,0,1,0,4,0.5714285714285714,1,0.0,0,0,0,0,3,0,0,1,0,0,4,1
3691,90186,BizISzUat4hEvOv57S0DwyJf8vib0NUf,G8EPVSXsOYB5YQWZGiz1aVq5Pgr2GrQu,17,25,13,22,9,0,6,0,75,10.714285714285714,2,0.0,10,13,15,9,15,0,7,6,0,47,28,1
3692,90191,rb0bCeAP0PjUKM6QZmb5eDbdcmhSPRHl,bWdj2GDclj5ofokWjzoa5jAwMkxCykd6,1,0,0,0,0,0,1,0,1,0.14285714285714285,1,0.0,0,0,0,0,0,0,0,1,0,0,1,1
3693,90193,8DMqMykxY7va5LQM1D9Brc3KIasQ5uaX,SpATywNh6bZuzm8s1ceuBUnMUAeoAHHw,9,5,2,0,1,1,5,1,15,2.142857142857143,1,0.0,2,2,0,1,3,1,0,5,1,5,10,1
3694,90195,kS1KejA8lXABafXOlB6Mjw2acU9s1o0J,G8EPVSXsOYB5YQWZGiz1aVq5Pgr2GrQu,9,5,4,0,3,0,1,0,13,1.8571428571428572,2,0.0,0,4,0,3,5,0,0,1,0,7,6,1
3695,90197,W0qiE6YA9tIRl3nKsDWz4QDyI0fyNkAl,G8EPVSXsOYB5YQWZGiz1aVq5Pgr2GrQu,5,7,1,2,2,0,1,0,13,1.8571428571428572,1,0.0,5,1,1,2,2,0,1,1,0,9,4,1
3696,90198,EfKEF8uyLDaJrFfOiyHDnHogAmFLFMEz,SpATywNh6bZuzm8s1ceuBUnMUAeoAHHw,16,18,8,21,5,4,6,0,62,8.857142857142858,1,0.0,8,8,17,5,10,4,4,6,0,38,24,1
3697,90202,mb1hbQ7DEVC7kPqNe1ZOaERjsdGO9KG6,SpATywNh6bZuzm8s1ceuBUnMUAeoAHHw,6,1,1,0,1,0,3,0,6,0.8571428571428571,1,0.0,0,1,0,1,1,0,0,3,0,2,4,1
3698,90204,iwXjEgqbyIO3u8ruP2aohYqr4OGu36oj,bWdj2GDclj5ofokWjzoa5jAwMkxCykd6,1,0,0,0,0,0,1,0,1,0.14285714285714285,1,0.0,0,0,0,0,0,0,0,1,0,0,1,1
3699,90205,CDMI3gQZrAOAZ9Cf4jB5NzA4daPYwjjn,RXDvfPUBYFlVdlueBFbLW0mhhAyGEqpt,45,20,12,77,8,2,6,12,137,19.571428571428573,1,0.0,7,12,70,8,13,2,7,6,12,97,40,1
3700,90208,1oBn81XXDSWJtnCZIRPmhZcBWe7qP0iB,bWdj2GDclj5ofokWjzoa5jAwMkxCykd6,15,19,9,30,4,0,5,0,67,9.571428571428571,1,0.0,5,9,28,4,14,0,2,5,0,46,21,1
3701,90210,J3voZmUSvdysAYoBmB8pkqxDgJNK9RLm,SpATywNh6bZuzm8s1ceuBUnMUAeoAHHw,10,8,4,0,3,0,5,0,20,2.857142857142857,1,0.0,1,4,0,3,7,0,0,5,0,8,12,1
3702,90212,Kc2ZLOGfjK9xNvMUO1HfN3eAcuOUNA78,bWdj2GDclj5ofokWjzoa5jAwMkxCykd6,4,2,1,0,1,0,1,0,5,0.7142857142857143,1,0.0,0,1,0,1,2,0,0,1,0,2,3,0
3703,90213,flscvDNEOPPNPzScLBbNDP0ZzEaAlrV7,SpATywNh6bZuzm8s1ceuBUnMUAeoAHHw,3,2,1,0,0,0,1,0,4,0.5714285714285714,1,0.0,0,1,0,0,2,0,0,1,0,1,3,1
3704,90216,2YneJEOhCqieo20wPFwWEVhM7PP0cUkK,SpATywNh6bZuzm8s1ceuBUnMUAeoAHHw,6,5,2,0,1,0,3,0,11,1.5714285714285714,1,0.0,0,2,0,1,5,0,0,3,0,3,8,1
3705,90231,5rZEwm9dIq2r0OGFOO4xuxIdyDM4ihsM,SpATywNh6bZuzm8s1ceuBUnMUAeoAHHw,6,3,1,0,1,0,4,0,9,1.2857142857142858,1,0.0,0,1,0,1,3,0,0,4,0,2,7,1
3706,90234,TWBh4mQwoOKN7YTAA8WBkn32Y1dNu7yV,SpATywNh6bZuzm8s1ceuBUnMUAeoAHHw,3,3,1,0,0,0,1,0,5,0.7142857142857143,1,0.0,0,1,0,0,3,0,0,1,0,1,4,1
3707,90236,MqKzIfAUNs7agMDut61Vb2gr4UeXiv4L,SpATywNh6bZuzm8s1ceuBUnMUAeoAHHw,14,13,4,18,3,4,4,0,46,6.571428571428571,1,0.0,8,4,16,3,5,4,2,4,0,31,15,1
3708,90237,RkMMgfrDoCy0k6xciXBqfQqum2o9XEow,bWdj2GDclj5ofokWjzoa5jAwMkxCykd6,8,9,5,0,1,2,10,0,27,3.857142857142857,2,0.0,0,5,0,1,9,2,0,10,0,6,21,0
3709,90243,ufAesqkQpYzEnUzTTmFCVE5lhPwgEzNz,bWdj2GDclj5ofokWjzoa5jAwMkxCykd6,7,4,1,0,1,2,4,1,13,1.8571428571428572,1,0.0,1,1,0,1,3,2,0,4,1,3,10,1
3710,90257,ZPbUovw1YoDeaWUVrbGEj5A5WdIXTYjf,bWdj2GDclj5ofokWjzoa5jAwMkxCykd6,5,2,1,0,1,0,2,0,6,0.8571428571428571,1,0.0,0,1,0,1,2,0,0,2,0,2,4,1
3711,90264,SFTx34tVIUz5DNNfU98ofZLPwnaVsmDt,bWdj2GDclj5ofokWjzoa5jAwMkxCykd6,2,0,0,0,0,0,4,0,4,0.5714285714285714,1,0.0,0,0,0,0,0,0,0,4,0,0,4,1
3712,90265,BjHFvQWQadfUNfwyKUemgxPvpTYl6Oeu,SpATywNh6bZuzm8s1ceuBUnMUAeoAHHw,16,25,9,16,4,0,11,0,65,9.285714285714286,2,0.0,7,9,15,4,18,0,1,11,0,35,30,1
3713,90273,1A7feF5h8rReJF4PIjze7GoTvueVZhno,bWdj2GDclj5ofokWjzoa5jAwMkxCykd6,2,0,0,0,0,0,3,0,3,0.42857142857142855,1,0.0,0,0,0,0,0,0,0,3,0,0,3,1
3714,90281,0nJUVE3hT3v1fqbd9NpHDszm9KS6NNTn,SpATywNh6bZuzm8s1ceuBUnMUAeoAHHw,12,15,11,0,4,2,10,0,42,6.0,3,0.0,0,11,0,4,15,2,0,10,0,15,27,1
3715,90284,fhq6eq9rBvb40aWEwDCQV6m3MUswh0wF,SpATywNh6bZuzm8s1ceuBUnMUAeoAHHw,6,4,2,1,1,0,2,0,10,1.4285714285714286,1,0.0,1,2,1,1,3,0,0,2,0,5,5,1
3716,90299,iysEaAaeQU9ULnAIVWQxyonskhHfsgrB,bWdj2GDclj5ofokWjzoa5jAwMkxCykd6,1,0,0,0,0,0,1,0,1,0.14285714285714285,1,0.0,0,0,0,0,0,0,0,1,0,0,1,1
3717,90300,5w7iVX59M3R4nFK1Ak0et8WYZIQEnE4r,SpATywNh6bZuzm8s1ceuBUnMUAeoAHHw,5,4,1,0,1,1,8,0,15,2.142857142857143,3,0.0,2,1,0,1,2,1,0,8,0,4,11,1
3718,90301,nNRUhTxrQUyQlj0B4LUbcGCoMBsVhXak,SpATywNh6bZuzm8s1ceuBUnMUAeoAHHw,15,41,14,21,4,2,8,3,93,13.285714285714286,1,0.0,16,14,18,4,25,2,3,8,3,52,41,1
3719,90307,YSoWzxWxgklu4RCnOacbfcJC3S3J8kdF,bWdj2GDclj5ofokWjzoa5jAwMkxCykd6,4,2,1,0,0,0,2,0,5,0.7142857142857143,1,0.0,0,1,0,0,2,0,0,2,0,1,4,1
3720,90308,mf7XL5Qu5rUTCHBZ2HgPEiHdci32GQxj,SpATywNh6bZuzm8s1ceuBUnMUAeoAHHw,5,2,1,0,1,0,2,0,6,0.8571428571428571,1,0.0,0,1,0,1,2,0,0,2,0,2,4,1
3721,90319,BnT6Uo8UffnhlvQEwsGCaHRftIbYh6of,SpATywNh6bZuzm8s1ceuBUnMUAeoAHHw,9,13,5,0,3,0,2,0,23,3.2857142857142856,1,0.0,2,5,0,3,11,0,0,2,0,10,13,1
3722,90322,xnhot3CAENInz6vjTxOmSNIIldllQEtz,bWdj2GDclj5ofokWjzoa5jAwMkxCykd6,4,2,1,0,1,0,1,0,5,0.7142857142857143,1,0.0,0,1,0,1,2,0,0,1,0,2,3,1
3723,90328,ytG2DdLhfkfx34dUnTrzjRTBamVwR6Tt,G8EPVSXsOYB5YQWZGiz1aVq5Pgr2GrQu,4,2,0,0,0,0,2,0,4,0.5714285714285714,1,0.0,0,0,0,0,2,0,0,2,0,0,4,1
3724,90331,gSg4PIaWl0hBhOgVlpN9o8YrQn4pTOeq,RXDvfPUBYFlVdlueBFbLW0mhhAyGEqpt,3,0,0,0,0,9,2,0,11,1.5714285714285714,2,0.0,0,0,0,0,0,9,0,2,0,0,11,0
3725,90334,gSg4PIaWl0hBhOgVlpN9o8YrQn4pTOeq,bWdj2GDclj5ofokWjzoa5jAwMkxCykd6,5,2,1,0,1,0,2,0,6,0.8571428571428571,2,0.0,0,1,0,1,2,0,0,2,0,2,4,0
3726,90338,FniFp3wFmWOPWRnBcExVHfzUs5yEbBTd,G8EPVSXsOYB5YQWZGiz1aVq5Pgr2GrQu,1,0,0,0,0,0,1,0,1,0.14285714285714285,1,0.0,0,0,0,0,0,0,0,1,0,0,1,1
3727,90341,MSmZzIC0hTqFynGLQ4hbcd9aVVVROmvE,RXDvfPUBYFlVdlueBFbLW0mhhAyGEqpt,43,22,14,95,7,22,3,4,167,23.857142857142858,1,0.0,7,14,88,7,15,22,7,3,4,116,51,1
3728,90363,4GMbKnTV7f2uA3paM09GNAdyVnypDTbs,bWdj2GDclj5ofokWjzoa5jAwMkxCykd6,7,1,1,0,1,0,10,0,13,1.8571428571428572,1,0.0,0,1,0,1,1,0,0,10,0,2,11,1
3729,90365,XnbCTPxDHPmE6f3SM7gG3S4zRIik2pF4,SpATywNh6bZuzm8s1ceuBUnMUAeoAHHw,1,0,0,0,0,0,1,0,1,0.14285714285714285,1,0.0,0,0,0,0,0,0,0,1,0,0,1,1
3730,90368,aVj2n54Hek70fJUdNTLLf71YkfuWdwdm,bWdj2GDclj5ofokWjzoa5jAwMkxCykd6,7,12,5,0,5,0,4,0,26,3.7142857142857144,2,0.0,2,5,0,5,10,0,0,4,0,12,14,1
3731,90370,1cbn6mbdbvkgaRHmtNkyztYkaJcKUMeq,bWdj2GDclj5ofokWjzoa5jAwMkxCykd6,15,20,8,50,6,0,11,0,95,13.571428571428571,3,0.0,7,8,44,6,13,0,6,11,0,65,30,0
3732,90384,HOZheAyAGMSpb5Rm4jAeFCDd0CkpsnTU,SpATywNh6bZuzm8s1ceuBUnMUAeoAHHw,14,36,0,22,0,105,19,0,182,26.0,5,0.0,16,0,21,0,20,105,1,19,0,37,145,1
3733,90388,af1GfUKSTAzLFQRgO3DNnNJQEXmJbieP,SpATywNh6bZuzm8s1ceuBUnMUAeoAHHw,15,16,4,13,3,0,6,0,42,6.0,1,0.0,10,4,12,3,6,0,1,6,0,29,13,0
3734,90390,gZ5Dz1At6qO7ZUvRyINA6LQ2UEYea4Ji,SpATywNh6bZuzm8s1ceuBUnMUAeoAHHw,4,2,1,0,0,0,2,0,5,0.7142857142857143,1,0.0,0,1,0,0,2,0,0,2,0,1,4,0
3735,90398,U4FGCuNkJ0sAAh4fnj0EDvRbz5l6NaeB,RXDvfPUBYFlVdlueBFbLW0mhhAyGEqpt,5,4,1,0,1,0,1,0,7,1.0,1,0.0,0,1,0,1,4,0,0,1,0,2,5,1
3736,90401,U8woUOpngQnqlgGzBG9Q1wRVWIkAfJH5,bWdj2GDclj5ofokWjzoa5jAwMkxCykd6,7,15,0,0,0,0,7,0,22,3.142857142857143,3,0.0,0,0,0,0,15,0,0,7,0,0,22,0
3737,90406,eAZCjo0LfDvIGTflBEZPo5MmANUFycim,G8EPVSXsOYB5YQWZGiz1aVq5Pgr2GrQu,1,0,0,0,0,0,1,0,1,0.14285714285714285,1,0.0,0,0,0,0,0,0,0,1,0,0,1,1
3738,90415,ZYv52Mbq7iLq8T3oy7c5ln6ts5h7dtMY,bWdj2GDclj5ofokWjzoa5jAwMkxCykd6,2,0,0,0,0,0,2,0,2,0.2857142857142857,1,0.0,0,0,0,0,0,0,0,2,0,0,2,1
3739,90424,DtwqebReG8Q4J8W1z8GMg58bM2jjZyjN,SpATywNh6bZuzm8s1ceuBUnMUAeoAHHw,5,2,0,0,0,0,3,0,5,0.7142857142857143,1,0.0,0,0,0,0,2,0,0,3,0,0,5,1
3740,90427,MffUlJKjo94UllFioq799jfMhgBUKfBS,RXDvfPUBYFlVdlueBFbLW0mhhAyGEqpt,22,18,11,29,8,0,2,0,68,9.714285714285714,1,0.0,5,11,27,8,13,0,2,2,0,51,17,1
3741,90434,ajSnZNRHXRc8Lp3Apzl9jhBHJ93vaNPi,SpATywNh6bZuzm8s1ceuBUnMUAeoAHHw,8,6,1,0,1,14,5,0,27,3.857142857142857,1,0.0,0,1,0,1,6,14,0,5,0,2,25,1
3742,90438,h70SV9keTNnvlQQ1p9K83AbbtQXt9ALt,SpATywNh6bZuzm8s1ceuBUnMUAeoAHHw,11,18,12,0,9,0,7,0,46,6.571428571428571,1,0.0,4,12,0,9,14,0,0,7,0,25,21,1
3743,90441,QJPLyO9GsNSTHpL4UletoFcKnrwBbT1T,SpATywNh6bZuzm8s1ceuBUnMUAeoAHHw,15,27,13,23,6,0,3,0,72,10.285714285714286,2,0.0,10,13,18,6,17,0,5,3,0,47,25,1
3744,90447,SF4fH5sh7kP5eYY1hHp8Un6FMFdPAYUn,RXDvfPUBYFlVdlueBFbLW0mhhAyGEqpt,15,14,11,0,3,4,6,2,40,5.714285714285714,1,0.0,0,11,0,3,14,4,0,6,2,14,26,1
3745,90465,ZJZvmc4yPSLW7LhJST5KGAXq34PSa4bN,SpATywNh6bZuzm8s1ceuBUnMUAeoAHHw,9,6,4,0,2,1,5,1,19,2.7142857142857144,1,0.0,1,4,0,2,5,1,0,5,1,7,12,1
3746,90475,nA22SpKv9tvgwIZ0mm2k7ziqx1NGMQHb,SpATywNh6bZuzm8s1ceuBUnMUAeoAHHw,4,1,0,0,0,0,5,0,6,0.8571428571428571,1,0.0,0,0,0,0,1,0,0,5,0,0,6,1
3747,90476,Pr9ourxtng5DzY47on8h7xABMdbE3A0L,SpATywNh6bZuzm8s1ceuBUnMUAeoAHHw,2,0,0,0,0,0,2,0,2,0.2857142857142857,1,0.0,0,0,0,0,0,0,0,2,0,0,2,1
3748,90481,8cTpnP5XMC7urAa32DMaQfZt2CABz0xm,SpATywNh6bZuzm8s1ceuBUnMUAeoAHHw,2,0,0,0,0,0,2,0,2,0.2857142857142857,1,0.0,0,0,0,0,0,0,0,2,0,0,2,1
3749,90496,Xs5JYGOD3p8qnunCvDbRtmUT4YrLSZAt,G8EPVSXsOYB5YQWZGiz1aVq5Pgr2GrQu,2,0,0,0,0,0,2,0,2,0.2857142857142857,1,0.0,0,0,0,0,0,0,0,2,0,0,2,1
3750,90505,GQ6O8zYgypKOWgEHgpHaUgffzhyPlA4a,SpATywNh6bZuzm8s1ceuBUnMUAeoAHHw,11,23,9,0,5,0,10,0,47,6.714285714285714,2,0.0,0,9,0,5,23,0,0,10,0,14,33,1
3751,90509,6DhqODqzoN3QpHDTGOfm1J0Z2tXsvw8Q,RXDvfPUBYFlVdlueBFbLW0mhhAyGEqpt,11,9,5,0,1,1,6,1,23,3.2857142857142856,1,0.0,2,5,0,1,7,1,0,6,1,8,15,1
3752,90510,RI0pRWsSeNWCFuNbvYcUkrnZSxgLkzXM,G8EPVSXsOYB5YQWZGiz1aVq5Pgr2GrQu,4,2,1,0,1,0,1,0,5,0.7142857142857143,1,0.0,0,1,0,1,2,0,0,1,0,2,3,1
3753,90512,v5nYdsvl6GCjyW7kGrOo9PXd3XM536ac,bWdj2GDclj5ofokWjzoa5jAwMkxCykd6,8,7,3,36,3,0,1,0,50,7.142857142857143,1,0.0,3,3,36,3,4,0,0,1,0,45,5,1
3754,90522,SrT5cEoKhuuDcaYDitYZtr8rudf3aNHn,RXDvfPUBYFlVdlueBFbLW0mhhAyGEqpt,5,3,0,0,0,1,2,0,6,0.8571428571428571,1,0.0,0,0,0,0,3,1,0,2,0,0,6,1
3755,90533,979T9akr0rVByN7anKgrxGgT1cwuQ4G0,bWdj2GDclj5ofokWjzoa5jAwMkxCykd6,1,0,0,0,0,0,2,0,2,0.2857142857142857,1,0.0,0,0,0,0,0,0,0,2,0,0,2,1
3756,90536,87BoPwsFRJc93Ed9Le7qjm6Wu8pcwGb4,SpATywNh6bZuzm8s1ceuBUnMUAeoAHHw,14,13,8,15,5,0,7,0,48,6.857142857142857,1,0.0,4,8,12,5,9,0,3,7,0,29,19,1
3757,90541,f3Or6Lei7Xsh5kVuWwAXKtVQvHetVASw,SpATywNh6bZuzm8s1ceuBUnMUAeoAHHw,7,2,1,0,1,0,7,1,12,1.7142857142857142,1,0.0,0,1,0,1,2,0,0,7,1,2,10,1
3758,90542,oBmksukoqTKiKpWhco7hv7dHpVNhiTm0,RXDvfPUBYFlVdlueBFbLW0mhhAyGEqpt,2,0,0,0,0,0,2,0,2,0.2857142857142857,1,0.0,0,0,0,0,0,0,0,2,0,0,2,1
3759,90544,Wn0YHSgI2frE5VS0ME4PMnw7OIRxxODE,bWdj2GDclj5ofokWjzoa5jAwMkxCykd6,14,12,6,32,5,0,4,0,59,8.428571428571429,1,0.0,4,6,32,5,8,0,0,4,0,47,12,1
3760,90552,isJvm2sBgrZmIVBqIVzAr4eLhAZMDuWI,SpATywNh6bZuzm8s1ceuBUnMUAeoAHHw,2,0,0,0,0,4,1,0,5,0.7142857142857143,1,0.0,0,0,0,0,0,4,0,1,0,0,5,1
3761,90555,tn5nSlJLNdxx4Uni5Dn3S8nwDR8GJibq,bWdj2GDclj5ofokWjzoa5jAwMkxCykd6,20,41,21,114,10,16,15,2,219,31.285714285714285,3,0.0,7,21,109,10,34,16,5,15,2,147,72,1
3762,90557,86vaLs6Psnmr3RZvUAsRR8mS9F0SSYDy,RXDvfPUBYFlVdlueBFbLW0mhhAyGEqpt,1,0,0,0,0,0,1,0,1,0.14285714285714285,1,0.0,0,0,0,0,0,0,0,1,0,0,1,1
3763,90561,zoNJrqU9R3rbwqXOfdPMHYJWQ1mfYn8B,SpATywNh6bZuzm8s1ceuBUnMUAeoAHHw,9,6,3,0,3,0,4,0,16,2.2857142857142856,1,0.0,0,3,0,3,6,0,0,4,0,6,10,1
3764,90573,mnrOB2joseu3XXqZgB40ASUizDwax7xs,SpATywNh6bZuzm8s1ceuBUnMUAeoAHHw,16,23,7,22,4,1,9,0,66,9.428571428571429,1,0.0,12,7,18,4,11,1,4,9,0,41,25,1
3765,90574,SaJRa20OXDY1LCrTPWwAL4qw1OJoFlxd,SpATywNh6bZuzm8s1ceuBUnMUAeoAHHw,2,0,0,0,0,0,2,0,2,0.2857142857142857,1,0.0,0,0,0,0,0,0,0,2,0,0,2,1
3766,90580,lk8VGt0yosXmu7XbHzsqLBKwzzzp9GK0,SpATywNh6bZuzm8s1ceuBUnMUAeoAHHw,5,3,1,0,0,5,6,0,15,2.142857142857143,1,0.0,0,1,0,0,3,5,0,6,0,1,14,1
3767,90587,LdmiXWzPIjxgi3vXfrG7UNuf9aR1t25A,G8EPVSXsOYB5YQWZGiz1aVq5Pgr2GrQu,2,0,0,0,0,1,1,0,2,0.2857142857142857,1,0.0,0,0,0,0,0,1,0,1,0,0,2,1
3768,90591,dVnTQl9ANUhHsXIPIWBdmTgLVkOgcfeV,SpATywNh6bZuzm8s1ceuBUnMUAeoAHHw,8,5,0,0,0,1,6,1,13,1.8571428571428572,1,0.0,0,0,0,0,5,1,0,6,1,0,13,1
3769,90601,OA2ppL3NBxQQN7UDC41vrrAGRoypzEU8,SpATywNh6bZuzm8s1ceuBUnMUAeoAHHw,6,2,1,0,1,0,4,0,8,1.1428571428571428,1,0.0,0,1,0,1,2,0,0,4,0,2,6,1
3770,90602,OCAzb1VfLGBRFoguhxZLxVaO4EgntnGi,bWdj2GDclj5ofokWjzoa5jAwMkxCykd6,1,0,0,0,0,0,1,0,1,0.14285714285714285,1,0.0,0,0,0,0,0,0,0,1,0,0,1,1
3771,90606,k0hnEE00KysC1NJbTPcs2Jo2pXfE8XJY,RXDvfPUBYFlVdlueBFbLW0mhhAyGEqpt,8,6,1,0,1,0,3,0,11,1.5714285714285714,1,0.0,0,1,0,1,6,0,0,3,0,2,9,1
3772,90615,YfZkWYeVjjwTERIBF4VpFk8mjgVdzlCM,SpATywNh6bZuzm8s1ceuBUnMUAeoAHHw,9,7,4,0,1,5,14,1,32,4.571428571428571,1,0.0,0,4,0,1,7,5,0,14,1,5,27,1
3773,90621,RX2I20RYdT3gZCbZOCxQyWjgnFxuLLo0,SpATywNh6bZuzm8s1ceuBUnMUAeoAHHw,6,3,2,0,2,0,1,0,8,1.1428571428571428,1,0.0,0,2,0,2,3,0,0,1,0,4,4,1
3774,90623,yZoviGGxgr5NFf9klHeC5PfXfdVd14QP,bWdj2GDclj5ofokWjzoa5jAwMkxCykd6,11,9,6,0,4,0,9,0,28,4.0,3,0.0,0,6,0,4,9,0,0,9,0,10,18,1
3775,90626,mYdiJuyvQQSE4J489nl9NbGaNmN8t5fJ,SpATywNh6bZuzm8s1ceuBUnMUAeoAHHw,5,3,1,0,1,0,1,0,6,0.8571428571428571,1,0.0,0,1,0,1,3,0,0,1,0,2,4,1
3776,90629,7y90Jaoh9A6ecz0W5HFrSOzo0GUJhND0,bWdj2GDclj5ofokWjzoa5jAwMkxCykd6,5,3,1,0,0,1,4,0,9,1.2857142857142858,1,0.0,0,1,0,0,3,1,0,4,0,1,8,1
3777,90633,gIghghMxU1G3VEKF49uuB975s41nqI8g,SpATywNh6bZuzm8s1ceuBUnMUAeoAHHw,16,20,11,14,5,13,7,0,70,10.0,2,0.0,6,11,13,5,14,13,1,7,0,35,35,0
3778,90646,yZoviGGxgr5NFf9klHeC5PfXfdVd14QP,RXDvfPUBYFlVdlueBFbLW0mhhAyGEqpt,13,7,6,0,4,0,2,0,19,2.7142857142857144,1,0.0,0,6,0,4,7,0,0,2,0,10,9,1
3779,90648,Ct4CYJV4ldK3GNAcCiI1V5iy769QQWR5,RXDvfPUBYFlVdlueBFbLW0mhhAyGEqpt,8,16,0,0,0,0,5,0,21,3.0,1,0.0,3,0,0,0,13,0,0,5,0,3,18,1
3780,90651,4vJSIQ5zmHwvN98SbnaURZ3kwY3XSM5D,SpATywNh6bZuzm8s1ceuBUnMUAeoAHHw,1,0,0,0,0,0,1,0,1,0.14285714285714285,1,0.0,0,0,0,0,0,0,0,1,0,0,1,1
3781,90654,bA5X6ch4ADNfhanzi2mM69bwbihODbQ4,G8EPVSXsOYB5YQWZGiz1aVq5Pgr2GrQu,81,109,36,234,11,8,12,2,412,58.857142857142854,2,0.0,66,36,185,11,43,8,49,12,2,298,114,0
3782,90659,07a6x7KN30qug4fofBdEl2HySgB5YdgR,bWdj2GDclj5ofokWjzoa5jAwMkxCykd6,5,5,2,0,1,0,2,0,10,1.4285714285714286,2,0.0,0,2,0,1,5,0,0,2,0,3,7,1
3783,90660,YUNLPiSOifGnuGgTqdDXRMjnI0RJBa0e,bWdj2GDclj5ofokWjzoa5jAwMkxCykd6,10,11,6,0,4,3,9,0,33,4.714285714285714,1,0.0,2,6,0,4,9,3,0,9,0,12,21,1
3784,90667,XFmrH2WQYMYLXRE1Jm7VValFt236PUJr,G8EPVSXsOYB5YQWZGiz1aVq5Pgr2GrQu,10,13,1,10,1,0,1,0,26,3.7142857142857144,1,0.0,8,1,6,1,5,0,4,1,0,16,10,1
3785,90684,gBZJD6jZRMZdZxyaZgCjGPROu8WcWTne,G8EPVSXsOYB5YQWZGiz1aVq5Pgr2GrQu,13,25,10,8,8,17,6,2,76,10.857142857142858,1,0.0,12,10,6,8,13,17,2,6,2,36,40,0
3786,90686,tKsi1lDahv8YDRhfKnuEFzTSYneTazEo,RXDvfPUBYFlVdlueBFbLW0mhhAyGEqpt,10,9,5,0,5,3,4,0,26,3.7142857142857144,1,0.0,0,5,0,5,9,3,0,4,0,10,16,1
3787,90688,j8vYdYwa9gvt7hkF8dykZR2D4h75QsII,RXDvfPUBYFlVdlueBFbLW0mhhAyGEqpt,28,28,23,0,9,5,13,3,81,11.571428571428571,4,0.0,0,23,0,9,28,5,0,13,3,32,49,1
3788,90699,tKsi1lDahv8YDRhfKnuEFzTSYneTazEo,SpATywNh6bZuzm8s1ceuBUnMUAeoAHHw,4,1,1,0,1,0,1,0,4,0.5714285714285714,1,0.0,0,1,0,1,1,0,0,1,0,2,2,1
3789,90704,84Ouo0RSw7BvmNUER147KiTqxaHgRaR6,SpATywNh6bZuzm8s1ceuBUnMUAeoAHHw,7,5,3,0,2,0,6,0,16,2.2857142857142856,2,0.0,0,3,0,2,5,0,0,6,0,5,11,1
3790,90710,7fC3V6ivG07wUIMOmiYFzSlyjWvbYnYf,RXDvfPUBYFlVdlueBFbLW0mhhAyGEqpt,11,10,0,0,0,4,5,0,19,2.7142857142857144,1,0.0,0,0,0,0,10,4,0,5,0,0,19,0
3791,90715,BJT6wOznqaiCipmbeEqX4tC1TuhKxC7c,SpATywNh6bZuzm8s1ceuBUnMUAeoAHHw,14,34,14,0,6,3,13,1,71,10.142857142857142,3,0.0,3,14,0,6,31,3,0,13,1,23,48,1
3792,90717,Vmvdv9k8S1ONPkUHSdXPEenyx7UNVISW,bWdj2GDclj5ofokWjzoa5jAwMkxCykd6,19,35,4,68,2,50,18,2,179,25.571428571428573,4,0.0,8,4,61,2,27,50,7,18,2,75,104,1
3793,90719,5KhUU1d5DOX9YzVEFt1mBdZffexByyEY,SpATywNh6bZuzm8s1ceuBUnMUAeoAHHw,13,8,6,0,4,0,6,2,26,3.7142857142857144,1,0.0,0,6,0,4,8,0,0,6,2,10,16,1
3794,90724,5vkNIYp2bYY1LtZU7tLxethQegJYgNo1,bWdj2GDclj5ofokWjzoa5jAwMkxCykd6,14,10,5,74,3,0,7,0,99,14.142857142857142,2,0.0,3,5,69,3,7,0,5,7,0,80,19,1
3795,90731,Kq1HFxeACwjg0zmXbvWkQZ7IB9SIFprl,G8EPVSXsOYB5YQWZGiz1aVq5Pgr2GrQu,14,9,7,0,4,1,7,1,29,4.142857142857143,1,0.0,0,7,0,4,9,1,0,7,1,11,18,1
3796,90734,lHTZAvBbd0zcUoZ0ZCqy0WxYTp3sveXN,RXDvfPUBYFlVdlueBFbLW0mhhAyGEqpt,12,14,3,0,3,2,6,1,29,4.142857142857143,2,0.0,4,3,0,3,10,2,0,6,1,10,19,1
3797,90738,GvWa7qIm5RkYdVcaG192SG5MlRfjDYSk,SpATywNh6bZuzm8s1ceuBUnMUAeoAHHw,5,1,1,0,1,0,2,0,5,0.7142857142857143,1,0.0,0,1,0,1,1,0,0,2,0,2,3,1
3798,90744,2viub6InFwMLthqb8hJjmGF9NgF8w6Xs,bWdj2GDclj5ofokWjzoa5jAwMkxCykd6,4,9,3,0,2,0,1,0,15,2.142857142857143,3,0.0,0,3,0,2,9,0,0,1,0,5,10,1
3799,90745,3VPAWlfwG5nkf9ioSIdd0yq9SoYaPOsq,bWdj2GDclj5ofokWjzoa5jAwMkxCykd6,3,2,0,0,0,0,1,0,3,0.42857142857142855,1,0.0,0,0,0,0,2,0,0,1,0,0,3,1
3800,90751,LrnqEdfBj0D0yEwqlIwYFq7gG4yeMv2F,SpATywNh6bZuzm8s1ceuBUnMUAeoAHHw,12,26,9,19,3,1,5,0,63,9.0,1,0.0,15,9,17,3,11,1,2,5,0,44,19,1
3801,90759,ap9egrEAtqnjEf8GN2Q0V7LnZMXCwsuh,RXDvfPUBYFlVdlueBFbLW0mhhAyGEqpt,9,8,5,0,2,9,4,0,28,4.0,2,0.0,0,5,0,2,8,9,0,4,0,7,21,1
3802,90763,KLWMzt2lbmi8onKYKX9eWLl5lpM0wx0M,SpATywNh6bZuzm8s1ceuBUnMUAeoAHHw,3,2,1,0,0,0,2,0,5,0.7142857142857143,1,0.0,0,1,0,0,2,0,0,2,0,1,4,1
3803,90766,ypPkmbHBKQqVHaDjkpbJ8CKEoLgDbQlR,SpATywNh6bZuzm8s1ceuBUnMUAeoAHHw,6,3,1,0,1,0,3,0,8,1.1428571428571428,1,0.0,0,1,0,1,3,0,0,3,0,2,6,1
3804,90783,bpxaFadaQixJuWRVtAAq5miKiBM3zC6u,RXDvfPUBYFlVdlueBFbLW0mhhAyGEqpt,1,0,0,0,0,0,2,0,2,0.2857142857142857,2,0.0,0,0,0,0,0,0,0,2,0,0,2,1
3805,90793,5yUesVpQg6VbfIA01sOzitb9Qf8no8xc,bWdj2GDclj5ofokWjzoa5jAwMkxCykd6,4,2,1,0,1,0,1,0,5,0.7142857142857143,1,0.0,0,1,0,1,2,0,0,1,0,2,3,1
3806,90797,xkhW0o7SPQFIOs4D7mnb6RH3kX3k2QhW,SpATywNh6bZuzm8s1ceuBUnMUAeoAHHw,6,2,0,0,0,0,5,0,7,1.0,1,0.0,0,0,0,0,2,0,0,5,0,0,7,1
3807,90798,V95Tt6b4Z06nKuvQsXC9kpbsyH3YIGk4,SpATywNh6bZuzm8s1ceuBUnMUAeoAHHw,3,2,0,0,0,6,1,0,9,1.2857142857142858,1,0.0,0,0,0,0,2,6,0,1,0,0,9,1
3808,90807,DYC2TKuAWipp9UNJIdqFLJgrkLj9mdOD,SpATywNh6bZuzm8s1ceuBUnMUAeoAHHw,17,36,12,16,4,7,23,6,104,14.857142857142858,3,0.0,12,12,13,4,24,7,3,23,6,41,63,0
3809,90814,EzH5vTFvKXPmDbmZZs9qDP4fhOA2tS8t,SpATywNh6bZuzm8s1ceuBUnMUAeoAHHw,15,29,5,12,5,7,7,2,67,9.571428571428571,1,0.0,18,5,11,5,11,7,1,7,2,39,28,1
3810,90827,Nu895EVx5N8YMgmc6Rsn4OVZESOkiczT,bWdj2GDclj5ofokWjzoa5jAwMkxCykd6,4,3,1,0,1,0,1,0,6,0.8571428571428571,1,0.0,0,1,0,1,3,0,0,1,0,2,4,1
3811,90829,r1uzabdEU8Xrw9e89SInzZPTwxnUupS6,SpATywNh6bZuzm8s1ceuBUnMUAeoAHHw,19,18,11,22,8,2,15,1,77,11.0,2,0.0,4,11,17,8,14,2,5,15,1,40,37,1
3812,90834,FajLS6BmkKgqb4XY9XPhCU4sFK1uRQ8Y,SpATywNh6bZuzm8s1ceuBUnMUAeoAHHw,6,2,1,0,1,0,3,0,7,1.0,1,0.0,1,1,0,1,1,0,0,3,0,3,4,1
3813,90838,J5zz2fAd7wtYMISsvWzFdYy7sZtBfDuG,SpATywNh6bZuzm8s1ceuBUnMUAeoAHHw,11,17,7,0,3,7,9,1,44,6.285714285714286,1,0.0,8,7,0,3,9,7,0,9,1,18,26,1
3814,90840,b1jxzfFtNrlmaMGoYNWOYfEAHOoLdx2j,bWdj2GDclj5ofokWjzoa5jAwMkxCykd6,7,6,2,4,1,0,7,0,20,2.857142857142857,1,0.0,2,2,4,1,4,0,0,7,0,9,11,1
3815,90860,JNtIRj6hnKiaMOhcBlcWRjLc0QwYKSxo,RXDvfPUBYFlVdlueBFbLW0mhhAyGEqpt,5,2,1,0,1,0,2,0,6,0.8571428571428571,1,0.0,0,1,0,1,2,0,0,2,0,2,4,1
3816,90871,pS71kwyejWdfiaeMEH40zntKPU95klQC,SpATywNh6bZuzm8s1ceuBUnMUAeoAHHw,6,3,0,0,0,0,3,1,7,1.0,1,0.0,0,0,0,0,3,0,0,3,1,0,7,1
3817,90873,LoEfaid2dOKAK1Vb6WcaGJbgN3PRNGde,SpATywNh6bZuzm8s1ceuBUnMUAeoAHHw,4,2,1,0,1,0,2,0,6,0.8571428571428571,1,0.0,0,1,0,1,2,0,0,2,0,2,4,1
3818,90886,U6j39msbwkx5j8wcgHIrrZSEw6jir138,SpATywNh6bZuzm8s1ceuBUnMUAeoAHHw,5,4,2,0,2,0,2,0,10,1.4285714285714286,1,0.0,1,2,0,2,3,0,0,2,0,5,5,1
3819,90895,TRCrdidmG6eXWyA1xpJbOiCViWff58Ia,bWdj2GDclj5ofokWjzoa5jAwMkxCykd6,5,2,1,0,1,0,2,0,6,0.8571428571428571,1,0.0,0,1,0,1,2,0,0,2,0,2,4,1
3820,90898,KuNFtG4l08F89uoxUeo0jGAYIKWrBRbs,SpATywNh6bZuzm8s1ceuBUnMUAeoAHHw,11,8,4,5,3,0,2,0,22,3.142857142857143,2,0.0,1,4,4,3,7,0,1,2,0,12,10,1
3821,90900,ZlJV9a7edMx2HyEVyPzwwfS7y67dq8Ki,SpATywNh6bZuzm8s1ceuBUnMUAeoAHHw,7,6,4,0,4,0,2,0,16,2.2857142857142856,1,0.0,1,4,0,4,5,0,0,2,0,9,7,1
3822,90917,nazeZS8BdRMOGGuVriyb5M21Pn5Qng36,bWdj2GDclj5ofokWjzoa5jAwMkxCykd6,7,18,9,0,17,0,9,0,53,7.571428571428571,3,0.0,0,9,0,17,18,0,0,9,0,26,27,1
3823,90924,8dce3jvQILzvCt2gqdxC1GXJeAlwT2XG,SpATywNh6bZuzm8s1ceuBUnMUAeoAHHw,5,2,1,0,1,0,3,0,7,1.0,1,0.0,0,1,0,1,2,0,0,3,0,2,5,1
3824,90931,MhTSP1UwQzeoqedkBfla3LYw7KA6P5RM,bWdj2GDclj5ofokWjzoa5jAwMkxCykd6,3,2,0,0,0,0,2,0,4,0.5714285714285714,1,0.0,0,0,0,0,2,0,0,2,0,0,4,1
3825,90935,T6uKBu9byfRvxDh9TTWa54gKMCltkicT,G8EPVSXsOYB5YQWZGiz1aVq5Pgr2GrQu,4,4,3,0,3,0,1,0,11,1.5714285714285714,2,0.0,0,3,0,3,4,0,0,1,0,6,5,1
3826,90936,ElLz2aBJCCMb80RAglralkX1EvljkdsQ,SpATywNh6bZuzm8s1ceuBUnMUAeoAHHw,5,3,1,0,1,0,2,0,7,1.0,1,0.0,0,1,0,1,3,0,0,2,0,2,5,1
3827,90941,XTcsDe1fuCzXOnCFHuWkz7K8gAjPZJM4,bWdj2GDclj5ofokWjzoa5jAwMkxCykd6,2,0,0,0,0,0,5,0,5,0.7142857142857143,1,0.0,0,0,0,0,0,0,0,5,0,0,5,1
3828,90942,oh70wjHZNiJm6YMEO2zTeIrDQMUiqmDd,bWdj2GDclj5ofokWjzoa5jAwMkxCykd6,8,14,2,0,2,0,3,0,21,3.0,2,0.0,4,2,0,2,10,0,0,3,0,8,13,1
3829,90943,iz51PdaMdn80ICs5ffsXdIXAEkxQQqv2,SpATywNh6bZuzm8s1ceuBUnMUAeoAHHw,17,9,5,16,3,2,9,1,45,6.428571428571429,1,0.0,3,5,15,3,6,2,1,9,1,26,19,1
3830,90944,Sz8jNgPmKJ1IbqEEVQqTtQlVUDGarqh2,bWdj2GDclj5ofokWjzoa5jAwMkxCykd6,11,8,3,0,4,0,11,1,27,3.857142857142857,1,0.0,3,3,0,4,5,0,0,11,1,10,17,1
3831,90950,FwoYWsRBSR2prQ90dYeOBoYOgqUPkA0R,G8EPVSXsOYB5YQWZGiz1aVq5Pgr2GrQu,2,0,0,0,0,0,3,0,3,0.42857142857142855,2,0.0,0,0,0,0,0,0,0,3,0,0,3,1
3832,90952,YQuE8HipF2FTxF6yilCc6Hjt2hO1hf9q,bWdj2GDclj5ofokWjzoa5jAwMkxCykd6,7,5,1,0,2,2,6,2,18,2.5714285714285716,1,0.0,3,1,0,2,2,2,0,6,2,6,12,1
3833,90965,1YzhwwWLdVM4bzJMYH49O7nplNitMAxK,bWdj2GDclj5ofokWjzoa5jAwMkxCykd6,4,2,1,0,1,0,2,0,6,0.8571428571428571,1,0.0,0,1,0,1,2,0,0,2,0,2,4,1
3834,90971,0Any9bve5RgMfxHre7giBaaR9aLeQ2Lh,G8EPVSXsOYB5YQWZGiz1aVq5Pgr2GrQu,31,27,9,48,5,1,6,1,97,13.857142857142858,2,0.0,10,9,36,5,17,1,12,6,1,60,37,1
3835,90972,zZsHSLX7Hk1sqhZYCfBgGlYJnqetGIKf,RXDvfPUBYFlVdlueBFbLW0mhhAyGEqpt,7,6,2,0,2,4,2,0,16,2.2857142857142856,2,0.0,0,2,0,2,6,4,0,2,0,4,12,1
3836,90977,54WxhKjSN8T9wal7LR6RLgJ4OJYZ4MI7,SpATywNh6bZuzm8s1ceuBUnMUAeoAHHw,7,2,1,0,1,0,4,2,10,1.4285714285714286,1,0.0,0,1,0,1,2,0,0,4,2,2,8,1
3837,90981,WaDGEoZt5VlIPyIkYuUem7AfSknoei62,SpATywNh6bZuzm8s1ceuBUnMUAeoAHHw,5,3,2,0,2,0,2,0,9,1.2857142857142858,1,0.0,0,2,0,2,3,0,0,2,0,4,5,1
3838,90983,6bHj9PZ0VE3b8eSJI8u4oP72tokPXLXO,G8EPVSXsOYB5YQWZGiz1aVq5Pgr2GrQu,1,0,0,0,0,0,1,0,1,0.14285714285714285,1,0.0,0,0,0,0,0,0,0,1,0,0,1,1
3839,90985,1fUklgl0Md6ScDLqDSo4HCeoLeD6eKIu,SpATywNh6bZuzm8s1ceuBUnMUAeoAHHw,4,2,1,0,1,0,1,0,5,0.7142857142857143,1,0.0,0,1,0,1,2,0,0,1,0,2,3,1
3840,90988,088SASUPOVYUGhoEly8vlrkGvRBJoNwp,bWdj2GDclj5ofokWjzoa5jAwMkxCykd6,1,0,0,0,0,0,1,0,1,0.14285714285714285,1,0.0,0,0,0,0,0,0,0,1,0,0,1,1
3841,90993,o9jg8F69R1QHiPj2Cseo8eHEbgUVa0SI,SpATywNh6bZuzm8s1ceuBUnMUAeoAHHw,14,12,7,8,3,0,4,0,34,4.857142857142857,1,0.0,3,7,8,3,9,0,0,4,0,21,13,1
3842,90994,aRm0bLcx1zhfrL1xTMfT090YII1zkLc3,SpATywNh6bZuzm8s1ceuBUnMUAeoAHHw,9,7,3,0,0,9,7,1,27,3.857142857142857,1,0.0,0,3,0,0,7,9,0,7,1,3,24,1
3843,90999,CwyOL3RMOVLomxrxyN9D4jPa9R0iWrS5,G8EPVSXsOYB5YQWZGiz1aVq5Pgr2GrQu,6,2,0,0,1,0,4,0,7,1.0,3,0.0,0,0,0,1,2,0,0,4,0,1,6,0
3844,91026,MjeqDLbJZr4I90t51p6C9NVAFWnc6WKs,SpATywNh6bZuzm8s1ceuBUnMUAeoAHHw,4,2,1,0,1,0,1,0,5,0.7142857142857143,1,0.0,0,1,0,1,2,0,0,1,0,2,3,1
3845,91034,QFBztpG3zDUpKNEaUDnlRETY3MvJRJAi,SpATywNh6bZuzm8s1ceuBUnMUAeoAHHw,5,2,1,0,1,0,2,0,6,0.8571428571428571,1,0.0,0,1,0,1,2,0,0,2,0,2,4,1
3846,91042,NkVQGteS9t3nbfagAzHcxD3mnVkb9mPC,bWdj2GDclj5ofokWjzoa5jAwMkxCykd6,18,22,12,54,6,10,13,0,117,16.714285714285715,4,0.0,4,12,46,6,18,10,8,13,0,68,49,1
3847,91048,niLMw8MCObO7SSR2V1jNg9WQt5oSjDFJ,bWdj2GDclj5ofokWjzoa5jAwMkxCykd6,6,5,3,0,2,0,3,0,13,1.8571428571428572,2,0.0,0,3,0,2,5,0,0,3,0,5,8,1
3848,91051,xl5sOWFbG0Tv8T4ljEfZxFv4R7vezkE6,SpATywNh6bZuzm8s1ceuBUnMUAeoAHHw,7,1,1,0,1,0,5,1,9,1.2857142857142858,1,0.0,0,1,0,1,1,0,0,5,1,2,7,1
3849,91052,OoFskl7apYDC7BHDdb3sEQXj1CchwYwD,bWdj2GDclj5ofokWjzoa5jAwMkxCykd6,2,0,0,0,0,0,2,0,2,0.2857142857142857,1,0.0,0,0,0,0,0,0,0,2,0,0,2,1
3850,91056,Iji9dmQW7A2gOcEtvLASbynNxhfIM21F,bWdj2GDclj5ofokWjzoa5jAwMkxCykd6,6,5,2,0,1,0,4,0,12,1.7142857142857142,2,0.0,0,2,0,1,5,0,0,4,0,3,9,1
3851,91069,YYUyHWUcinXU8cifTlXoJnuPjgxGAJi5,SpATywNh6bZuzm8s1ceuBUnMUAeoAHHw,1,0,0,0,0,0,1,0,1,0.14285714285714285,1,0.0,0,0,0,0,0,0,0,1,0,0,1,1
3852,91074,JpAMTeX7S86zOjUKZJzvXPct8ySEHYBj,G8EPVSXsOYB5YQWZGiz1aVq5Pgr2GrQu,6,3,1,0,1,0,4,0,9,1.2857142857142858,1,0.0,0,1,0,1,3,0,0,4,0,2,7,1
3853,91077,6LSxEzHekfBjzdBuVJRrkvGn3CBVWXBO,SpATywNh6bZuzm8s1ceuBUnMUAeoAHHw,12,14,6,0,4,1,5,1,31,4.428571428571429,1,0.0,2,6,0,4,12,1,0,5,1,12,19,1
3854,91085,WzyxlFqmZtRh9gdD2KRH7ykffyZqisUy,SpATywNh6bZuzm8s1ceuBUnMUAeoAHHw,13,26,2,17,1,2,9,0,57,8.142857142857142,1,0.0,9,2,15,1,17,2,2,9,0,27,30,1
3855,91091,UlE0oj4kFfHwymOFgqOZSWzrZZdGbIRC,SpATywNh6bZuzm8s1ceuBUnMUAeoAHHw,9,5,1,0,1,1,6,1,15,2.142857142857143,1,0.0,0,1,0,1,5,1,0,6,1,2,13,1
3856,91092,mXfwwTIVjHMqoVKAh2iEQbinKUCJHwTp,SpATywNh6bZuzm8s1ceuBUnMUAeoAHHw,10,27,13,0,9,6,12,0,67,9.571428571428571,2,0.0,0,13,0,9,27,6,0,12,0,22,45,1
3857,91113,LDDV5GLR4T4AoJ4swm7PTuKciMVwXQ01,G8EPVSXsOYB5YQWZGiz1aVq5Pgr2GrQu,24,26,5,22,5,6,15,1,80,11.428571428571429,3,0.0,8,5,19,5,18,6,3,15,1,37,43,0
3858,91123,b49trtJTjAjBwZY0yqpUQlVmAVV99Apg,SpATywNh6bZuzm8s1ceuBUnMUAeoAHHw,12,14,7,4,5,1,5,0,36,5.142857142857143,1,0.0,2,7,4,5,12,1,0,5,0,18,18,1
3859,91133,eYnqJ330oueH4EH7KeCLJxm6knixAbKs,SpATywNh6bZuzm8s1ceuBUnMUAeoAHHw,10,7,5,0,4,0,4,0,20,2.857142857142857,2,0.0,0,5,0,4,7,0,0,4,0,9,11,1
3860,91136,IVuLX03K95bXWOSaQ9TjOxhrrnD2P8LK,SpATywNh6bZuzm8s1ceuBUnMUAeoAHHw,16,14,7,11,4,0,6,1,43,6.142857142857143,1,0.0,4,7,11,4,10,0,0,6,1,26,17,1
3861,91139,Dw8R0agU0UT0CHCyap3lEB834WRdn2Bl,G8EPVSXsOYB5YQWZGiz1aVq5Pgr2GrQu,9,5,3,0,3,0,2,0,13,1.8571428571428572,1,0.0,1,3,0,3,4,0,0,2,0,7,6,1
3862,91149,SOPkGQWWnRmFTO7wOQhPDwNSzqEUHcJN,RXDvfPUBYFlVdlueBFbLW0mhhAyGEqpt,9,6,5,0,3,0,1,0,15,2.142857142857143,1,0.0,0,5,0,3,6,0,0,1,0,8,7,1
3863,91152,ogzXep3azQvjQ2uIPIxw4TZLNiUXYlgD,RXDvfPUBYFlVdlueBFbLW0mhhAyGEqpt,21,12,8,16,4,16,8,6,70,10.0,2,0.0,2,8,15,4,10,16,1,8,6,29,41,1
3864,91175,5q13Swk6MXZ4N9xLOgcxgjrrx1DdXb4Y,G8EPVSXsOYB5YQWZGiz1aVq5Pgr2GrQu,2,0,0,0,0,0,2,0,2,0.2857142857142857,1,0.0,0,0,0,0,0,0,0,2,0,0,2,1
3865,91177,CwCqnH1O0RObsR0eBW9cv5anjwotHyXi,SpATywNh6bZuzm8s1ceuBUnMUAeoAHHw,8,4,3,0,3,0,1,0,11,1.5714285714285714,1,0.0,0,3,0,3,4,0,0,1,0,6,5,1
3866,91180,MBIWth5fpiCntqhZOrmXyFENe8IPo1si,G8EPVSXsOYB5YQWZGiz1aVq5Pgr2GrQu,5,2,1,0,1,0,3,0,7,1.0,1,0.0,0,1,0,1,2,0,0,3,0,2,5,1
3867,91185,bUI06hErQBLCI8IpvZBPVsO5ApTPyNZ8,bWdj2GDclj5ofokWjzoa5jAwMkxCykd6,6,3,1,0,1,0,2,0,7,1.0,2,0.0,0,1,0,1,3,0,0,2,0,2,5,1
3868,91186,N3cFMZkDkwJjlqfThZ0MJktu3s2FDQhu,SpATywNh6bZuzm8s1ceuBUnMUAeoAHHw,14,12,6,10,4,0,5,0,37,5.285714285714286,1,0.0,2,6,10,4,10,0,0,5,0,22,15,1
3869,91195,sD1p5VuSw3mE3A3cEGdX778feL3umtle,G8EPVSXsOYB5YQWZGiz1aVq5Pgr2GrQu,1,0,0,0,0,0,2,0,2,0.2857142857142857,1,0.0,0,0,0,0,0,0,0,2,0,0,2,1
3870,91197,MfRaHJKkD3QtNBNxriSuNn50bOkDWFU2,G8EPVSXsOYB5YQWZGiz1aVq5Pgr2GrQu,4,4,1,0,2,0,1,0,8,1.1428571428571428,1,0.0,2,1,0,2,2,0,0,1,0,5,3,0
3871,91200,Zw1bdKbgaMzUzlqlieQSaucEQ8wggZlx,RXDvfPUBYFlVdlueBFbLW0mhhAyGEqpt,7,6,4,0,2,0,2,0,14,2.0,1,0.0,0,4,0,2,6,0,0,2,0,6,8,1
3872,91211,YlWJRLkP5QIlBcoTrKDrquHDRSLUHmOs,SpATywNh6bZuzm8s1ceuBUnMUAeoAHHw,14,21,0,17,0,24,7,1,70,10.0,3,0.0,10,0,15,0,11,24,2,7,1,25,45,0
3873,91224,0b8coo9JZwKqcLwikgVi0uCa0HK4ngVT,SpATywNh6bZuzm8s1ceuBUnMUAeoAHHw,7,7,3,0,3,0,2,0,15,2.142857142857143,1,0.0,2,3,0,3,5,0,0,2,0,8,7,1
3874,91227,wrG2kznqDzNLV2b2BDLa9oNAZZomHWM1,bWdj2GDclj5ofokWjzoa5jAwMkxCykd6,5,3,0,0,0,0,2,0,5,0.7142857142857143,1,0.0,0,0,0,0,3,0,0,2,0,0,5,1
3875,91234,Zw1bdKbgaMzUzlqlieQSaucEQ8wggZlx,SpATywNh6bZuzm8s1ceuBUnMUAeoAHHw,8,10,7,0,5,0,4,0,26,3.7142857142857144,2,0.0,0,7,0,5,10,0,0,4,0,12,14,1
3876,91237,JLChl7mOWMB1KaATZ4zO6thYfhhSEMFx,bWdj2GDclj5ofokWjzoa5jAwMkxCykd6,4,2,0,0,0,2,3,0,7,1.0,1,0.0,0,0,0,0,2,2,0,3,0,0,7,1
3877,91248,20Kk6BKHam3XYBZHLn3cb7mbeQ3wjB0A,SpATywNh6bZuzm8s1ceuBUnMUAeoAHHw,5,3,1,0,1,0,2,0,7,1.0,1,0.0,0,1,0,1,3,0,0,2,0,2,5,1
3878,91288,il7MvONte06QnYiXs4eT4KVZhcQaTvCn,bWdj2GDclj5ofokWjzoa5jAwMkxCykd6,2,0,0,0,0,0,2,0,2,0.2857142857142857,1,0.0,0,0,0,0,0,0,0,2,0,0,2,1
3879,91290,4BCWVZMgSyk2ZEk4MHhm6b7lpgXWTd1k,SpATywNh6bZuzm8s1ceuBUnMUAeoAHHw,16,27,21,10,11,12,13,1,95,13.571428571428571,3,0.0,0,21,7,11,27,12,3,13,1,39,56,0
3880,91292,f6cpMj2XDptMqY9BMDiLiCW1lYt1B5HJ,bWdj2GDclj5ofokWjzoa5jAwMkxCykd6,2,0,0,0,0,2,2,0,4,0.5714285714285714,1,0.0,0,0,0,0,0,2,0,2,0,0,4,1
3881,91295,R0mUc8n4TzKl7Gj3gQcARJOPoEK9YWes,SpATywNh6bZuzm8s1ceuBUnMUAeoAHHw,9,10,4,0,2,0,9,1,26,3.7142857142857144,1,0.0,0,4,0,2,10,0,0,9,1,6,20,1
3882,91298,q4LihsiR4OZ2DrDNHviQwvJKphS7fKLx,SpATywNh6bZuzm8s1ceuBUnMUAeoAHHw,5,3,1,0,1,0,3,0,8,1.1428571428571428,1,0.0,0,1,0,1,3,0,0,3,0,2,6,1
3883,91308,aUncRjNtcPfHDYIbstir1RL5J34mNVnM,SpATywNh6bZuzm8s1ceuBUnMUAeoAHHw,1,0,0,0,0,0,1,0,1,0.14285714285714285,1,0.0,0,0,0,0,0,0,0,1,0,0,1,1
3884,91309,i0UAMwrjj2eXydsjRtQeHBmAMB3Ngwx3,SpATywNh6bZuzm8s1ceuBUnMUAeoAHHw,3,3,1,0,0,0,1,0,5,0.7142857142857143,1,0.0,0,1,0,0,3,0,0,1,0,1,4,1
3885,91311,StzJzmbhGW7cEyMLQz7mJx8nKnB6WL4m,bWdj2GDclj5ofokWjzoa5jAwMkxCykd6,1,0,0,0,0,0,1,0,1,0.14285714285714285,1,0.0,0,0,0,0,0,0,0,1,0,0,1,1
3886,91313,SHYKz4VRgTlESEEhjzd6VibUsZchMKQH,G8EPVSXsOYB5YQWZGiz1aVq5Pgr2GrQu,6,5,2,0,2,0,3,0,12,1.7142857142857142,2,0.0,0,2,0,2,5,0,0,3,0,4,8,0
3887,91318,p1lN44XlRZ80wopUQc4ZNciWVb9r8nPI,RXDvfPUBYFlVdlueBFbLW0mhhAyGEqpt,18,26,10,26,3,0,4,0,69,9.857142857142858,2,0.0,4,10,22,3,22,0,4,4,0,39,30,1
3888,91321,qRCFXu9SKQXvPlpvjvNkgxm9VD5k2SNq,SpATywNh6bZuzm8s1ceuBUnMUAeoAHHw,15,19,8,17,3,1,9,0,57,8.142857142857142,3,0.0,8,8,15,3,11,1,2,9,0,34,23,1
3889,91342,za2dBkPPLD9IPRBjooK7GJit2ulI5UgN,bWdj2GDclj5ofokWjzoa5jAwMkxCykd6,1,0,0,0,0,0,1,0,1,0.14285714285714285,1,0.0,0,0,0,0,0,0,0,1,0,0,1,1
3890,91366,fE7crtUj4hDSQo6ITE7OJYFi4AN2F95M,RXDvfPUBYFlVdlueBFbLW0mhhAyGEqpt,9,7,0,9,1,0,1,0,18,2.5714285714285716,1,0.0,2,0,9,1,5,0,0,1,0,12,6,1
3891,91383,BcJnhjzA1hw0WNze9uWUZQ49uBAiBHyH,SpATywNh6bZuzm8s1ceuBUnMUAeoAHHw,11,15,3,6,3,0,5,0,32,4.571428571428571,2,0.0,3,3,6,3,12,0,0,5,0,15,17,0
3892,91385,2GLZl96ZIgoKdw26t6xniq9LngPm9HvA,SpATywNh6bZuzm8s1ceuBUnMUAeoAHHw,8,3,2,0,2,0,3,0,10,1.4285714285714286,1,0.0,0,2,0,2,3,0,0,3,0,4,6,1
3893,91386,Id4UmIRRQiLXHoJYSjh5OCO1CRaFgQ2K,bWdj2GDclj5ofokWjzoa5jAwMkxCykd6,4,2,1,0,1,0,1,0,5,0.7142857142857143,1,0.0,0,1,0,1,2,0,0,1,0,2,3,1
3894,91389,j6Gbqu7tKtq8czp36zzxzHhI2ZEexibX,RXDvfPUBYFlVdlueBFbLW0mhhAyGEqpt,5,5,3,0,0,0,4,0,12,1.7142857142857142,2,0.0,0,3,0,0,5,0,0,4,0,3,9,1
3895,91393,pIUtN3HLfZAw0y37LPvuW9XkUHMVBvrO,bWdj2GDclj5ofokWjzoa5jAwMkxCykd6,1,0,0,0,0,0,1,0,1,0.14285714285714285,1,0.0,0,0,0,0,0,0,0,1,0,0,1,1
3896,91394,E7lyNwGYkG4o0UtCNjPSm6tmdy5hs4Mj,SpATywNh6bZuzm8s1ceuBUnMUAeoAHHw,7,1,1,0,1,0,5,0,8,1.1428571428571428,1,0.0,0,1,0,1,1,0,0,5,0,2,6,1
3897,91395,NzJuOfalEsOT54AavPrqSe3rsSE0cQkZ,bWdj2GDclj5ofokWjzoa5jAwMkxCykd6,1,0,0,0,0,0,1,0,1,0.14285714285714285,1,0.0,0,0,0,0,0,0,0,1,0,0,1,1
3898,91401,iM4WoC15lD8jmFLbUdaT8GwiDe76pgOg,G8EPVSXsOYB5YQWZGiz1aVq5Pgr2GrQu,2,0,0,0,0,0,2,0,2,0.2857142857142857,2,0.0,0,0,0,0,0,0,0,2,0,0,2,1
3899,91404,pSX4Dt8N2zVP05X1Tx0KEKzwWiZKDmer,SpATywNh6bZuzm8s1ceuBUnMUAeoAHHw,6,4,1,0,0,0,4,0,9,1.2857142857142858,2,0.0,0,1,0,0,4,0,0,4,0,1,8,1
3900,91405,piFN5eqEaJK1fUd2Yaiy8tquOTQSgzuN,RXDvfPUBYFlVdlueBFbLW0mhhAyGEqpt,2,0,0,0,0,0,3,0,3,0.42857142857142855,1,0.0,0,0,0,0,0,0,0,3,0,0,3,1
3901,91408,ov4pd0r7G3aHxyRJ3zd0jj3VwbkwbsuS,SpATywNh6bZuzm8s1ceuBUnMUAeoAHHw,8,2,1,0,1,2,11,1,18,2.5714285714285716,1,0.0,0,1,0,1,2,2,0,11,1,2,16,1
3902,91410,sEqMP3dTCfBAru35lgG6C0VuJq3LG5mE,SpATywNh6bZuzm8s1ceuBUnMUAeoAHHw,6,4,1,0,1,3,5,0,14,2.0,3,0.0,0,1,0,1,4,3,0,5,0,2,12,1
3903,91414,HSyljcmKCDSksgg7xJb6gUib0wBvYjVv,G8EPVSXsOYB5YQWZGiz1aVq5Pgr2GrQu,29,36,21,46,9,13,9,1,135,19.285714285714285,2,0.0,12,21,32,9,24,13,14,9,1,74,61,1
3904,91423,g6UH67YbvJtewLNXQNVZTYui0XC1Hxpo,bWdj2GDclj5ofokWjzoa5jAwMkxCykd6,7,12,7,0,1,5,6,0,31,4.428571428571429,1,0.0,1,7,0,1,11,5,0,6,0,9,22,1
3905,91429,Ocd58hpNcygqCXglTTmZd1ZSNvH3SCps,RXDvfPUBYFlVdlueBFbLW0mhhAyGEqpt,6,6,4,0,1,0,1,0,12,1.7142857142857142,1,0.0,0,4,0,1,6,0,0,1,0,5,7,1
3906,91430,vrpzudIR4dEiVdhwxbfDnInMv3JRRfJv,SpATywNh6bZuzm8s1ceuBUnMUAeoAHHw,5,3,1,0,1,0,1,0,6,0.8571428571428571,1,0.0,0,1,0,1,3,0,0,1,0,2,4,1
3907,91434,0CSUGuJXm53wz281T7wy30wWcjmP6Jhd,bWdj2GDclj5ofokWjzoa5jAwMkxCykd6,1,0,0,0,0,0,1,0,1,0.14285714285714285,1,0.0,0,0,0,0,0,0,0,1,0,0,1,1
3908,91438,FUkw8gvbqykqbH4tdSuG6VwP03f4pQvB,RXDvfPUBYFlVdlueBFbLW0mhhAyGEqpt,1,0,0,0,0,0,1,0,1,0.14285714285714285,1,0.0,0,0,0,0,0,0,0,1,0,0,1,1
3909,91442,XR5Z5kfmQ9E4GIPtNaMkJo2oa530uh94,SpATywNh6bZuzm8s1ceuBUnMUAeoAHHw,11,6,4,0,3,0,5,1,19,2.7142857142857144,1,0.0,0,4,0,3,6,0,0,5,1,7,12,1
3910,91456,pIUtN3HLfZAw0y37LPvuW9XkUHMVBvrO,SpATywNh6bZuzm8s1ceuBUnMUAeoAHHw,5,2,1,0,1,0,2,0,6,0.8571428571428571,1,0.0,0,1,0,1,2,0,0,2,0,2,4,1
3911,91460,qzjZHUzfivuSEB3h2CxO69AUVaBX51Ki,bWdj2GDclj5ofokWjzoa5jAwMkxCykd6,3,0,0,0,0,1,7,0,8,1.1428571428571428,2,0.0,0,0,0,0,0,1,0,7,0,0,8,1
3912,91474,XDng1mliVGDk6IontbBqBdoGZnODrUp1,SpATywNh6bZuzm8s1ceuBUnMUAeoAHHw,1,0,0,0,0,0,1,0,1,0.14285714285714285,1,0.0,0,0,0,0,0,0,0,1,0,0,1,0
3913,91477,Rhpf6lbWeFbBg91LchhBc713YgETI2ib,SpATywNh6bZuzm8s1ceuBUnMUAeoAHHw,11,10,0,14,0,2,6,2,34,4.857142857142857,1,0.0,4,0,13,0,6,2,1,6,2,17,17,1
3914,91478,mB7kFNAvy0IlvYKinAyQDJ9wbSStqolr,SpATywNh6bZuzm8s1ceuBUnMUAeoAHHw,9,3,1,0,1,15,7,6,33,4.714285714285714,1,0.0,0,1,0,1,3,15,0,7,6,2,31,1
3915,91480,3NG42RQfrkx04BX4rgjNYVd7JioduuEW,SpATywNh6bZuzm8s1ceuBUnMUAeoAHHw,17,53,22,14,7,12,16,1,125,17.857142857142858,3,0.0,19,22,13,7,34,12,1,16,1,61,64,0
3916,91484,Ja9aSTrbcYBJIk0knND32MhX73YVzDja,SpATywNh6bZuzm8s1ceuBUnMUAeoAHHw,15,31,6,19,3,5,7,1,72,10.285714285714286,1,0.0,23,6,17,3,8,5,2,7,1,49,23,1
3917,91498,Hh0poBt7neEeproKcOr3UwYd1l0mAkdY,SpATywNh6bZuzm8s1ceuBUnMUAeoAHHw,3,2,0,0,0,0,1,0,3,0.42857142857142855,1,0.0,0,0,0,0,2,0,0,1,0,0,3,1
3918,91499,MpyJrzGdf4KkfpgI13J4Ob9OCNumnSCn,G8EPVSXsOYB5YQWZGiz1aVq5Pgr2GrQu,19,22,8,38,8,0,4,1,81,11.571428571428571,3,0.0,1,8,34,8,21,0,4,4,1,51,30,1
3919,91503,Zx58r1nZicPZKjfYD5NgFYMSoAobbtxC,SpATywNh6bZuzm8s1ceuBUnMUAeoAHHw,12,11,7,0,5,0,5,0,28,4.0,1,0.0,1,7,0,5,10,0,0,5,0,13,15,1
3920,91510,NjgQeSBBMWIwQySsR5ymtqiugkMaOyYh,RXDvfPUBYFlVdlueBFbLW0mhhAyGEqpt,1,0,0,0,0,0,1,0,1,0.14285714285714285,1,0.0,0,0,0,0,0,0,0,1,0,0,1,1
3921,91512,IOj0PjWZoY0P8vGiPElep0GUuIa0VzfB,SpATywNh6bZuzm8s1ceuBUnMUAeoAHHw,8,2,1,0,1,0,5,1,10,1.4285714285714286,2,0.0,0,1,0,1,2,0,0,5,1,2,8,1
3922,91513,mlU6Sa4kvQqDwrJTiTVy3DXIlsysw3Tt,bWdj2GDclj5ofokWjzoa5jAwMkxCykd6,7,2,1,0,1,2,6,1,13,1.8571428571428572,1,0.0,0,1,0,1,2,2,0,6,1,2,11,0
3923,91521,1wUGa0IVsURQxQCvq0df7PLHs6Y2zNr7,bWdj2GDclj5ofokWjzoa5jAwMkxCykd6,5,5,0,0,0,0,7,0,12,1.7142857142857142,1,0.0,0,0,0,0,5,0,0,7,0,0,12,1
3924,91534,QM4BAIMqANq73zFQSTCtWv7Gn7ptHHhB,SpATywNh6bZuzm8s1ceuBUnMUAeoAHHw,7,3,2,0,1,0,6,0,12,1.7142857142857142,1,0.0,0,2,0,1,3,0,0,6,0,3,9,1
3925,91537,OiZVspQp0F9iJRMGMp4WIKFfxCHFzZhd,SpATywNh6bZuzm8s1ceuBUnMUAeoAHHw,1,0,0,0,0,0,1,0,1,0.14285714285714285,1,0.0,0,0,0,0,0,0,0,1,0,0,1,1
3926,91542,gpepovLBdtRKFzmC4QxqUbBL1lSM59qa,G8EPVSXsOYB5YQWZGiz1aVq5Pgr2GrQu,6,5,2,0,1,0,2,0,10,1.4285714285714286,1,0.0,0,2,0,1,5,0,0,2,0,3,7,1
3927,91555,nQTEVD6AAIYz8tW67vxXg9EsDxe19v25,SpATywNh6bZuzm8s1ceuBUnMUAeoAHHw,1,0,0,0,0,0,1,0,1,0.14285714285714285,1,0.0,0,0,0,0,0,0,0,1,0,0,1,1
3928,91558,JaxQCd7UV5o1rvWxAibMy6iOMU3fCV5H,SpATywNh6bZuzm8s1ceuBUnMUAeoAHHw,5,2,1,0,1,0,2,0,6,0.8571428571428571,1,0.0,0,1,0,1,2,0,0,2,0,2,4,1
3929,91574,Utp3WJ8WUPD5DMyG8PNbE11goCMql2Z7,SpATywNh6bZuzm8s1ceuBUnMUAeoAHHw,7,3,2,0,2,0,3,0,10,1.4285714285714286,2,0.0,0,2,0,2,3,0,0,3,0,4,6,1
3930,91587,gGccjvdbrNrajnyHrtaox144rWbV1SPy,SpATywNh6bZuzm8s1ceuBUnMUAeoAHHw,14,31,15,21,7,3,6,0,83,11.857142857142858,3,0.0,4,15,18,7,27,3,3,6,0,44,39,0
3931,91598,7T9YIDVeH18g5BhUfy7opy4UBmEqkepp,bWdj2GDclj5ofokWjzoa5jAwMkxCykd6,2,0,0,0,0,0,3,0,3,0.42857142857142855,1,0.0,0,0,0,0,0,0,0,3,0,0,3,1
3932,92831,B2UTUKN3bAFFBRPjVt44lFW6bWnjSKKh,G8EPVSXsOYB5YQWZGiz1aVq5Pgr2GrQu,10,10,1,0,1,0,3,0,15,2.142857142857143,1,0.0,0,1,0,1,10,0,0,3,0,2,13,1
3933,92837,bUI06hErQBLCI8IpvZBPVsO5ApTPyNZ8,A3fsA9Zfv1X2fVEQhTw51lKENdNrEqT3,7,0,0,0,0,10,7,1,18,2.5714285714285716,1,0.0,0,0,0,0,0,10,0,7,1,0,18,1
3934,92842,5fh1jlCU7jXB4QIW6qiZqp3idmC7zGIG,SpATywNh6bZuzm8s1ceuBUnMUAeoAHHw,9,5,3,0,2,1,6,1,18,2.5714285714285716,1,0.0,0,3,0,2,5,1,0,6,1,5,13,1
3935,92850,Q2m4p3E1xU5tjACIAMpsbnVuTeuD9Zj8,bWdj2GDclj5ofokWjzoa5jAwMkxCykd6,17,32,2,78,4,11,14,1,142,20.285714285714285,2,0.0,3,2,75,4,29,11,3,14,1,84,58,1
3936,92858,PO9UqxqUlWjKdLcKUuvXjpBUsCJBV13h,SpATywNh6bZuzm8s1ceuBUnMUAeoAHHw,18,32,5,8,3,6,7,1,62,8.857142857142858,4,0.0,15,5,8,3,17,6,0,7,1,31,31,0
3937,92869,1WP7C2GzJDZRslYYccdoHTPh8lrMzeDB,G8EPVSXsOYB5YQWZGiz1aVq5Pgr2GrQu,22,25,14,26,10,4,15,3,97,13.857142857142858,3,0.0,7,14,25,10,18,4,1,15,3,56,41,1
3938,92883,TY1XSpzUxZYHUqU0tQYtstvuwKCsGYpR,G8EPVSXsOYB5YQWZGiz1aVq5Pgr2GrQu,30,35,19,6,13,22,17,2,114,16.285714285714285,3,0.0,8,19,3,13,27,22,3,17,2,43,71,1
3939,92918,k8Gwazobmq79kvZvGEmSVe54OgHin1Sn,bWdj2GDclj5ofokWjzoa5jAwMkxCykd6,1,0,0,0,0,0,1,0,1,0.14285714285714285,1,0.0,0,0,0,0,0,0,0,1,0,0,1,1
3940,92920,k8Gwazobmq79kvZvGEmSVe54OgHin1Sn,RXDvfPUBYFlVdlueBFbLW0mhhAyGEqpt,1,0,0,0,0,0,1,0,1,0.14285714285714285,1,0.0,0,0,0,0,0,0,0,1,0,0,1,1
3941,92927,xKVU4KxHH7yw4gLTDP7X9Lm3WXZQ3SDL,SpATywNh6bZuzm8s1ceuBUnMUAeoAHHw,7,6,1,0,1,0,1,0,9,1.2857142857142858,1,0.0,0,1,0,1,6,0,0,1,0,2,7,1
3942,92929,0Rhh8KlMvGRxFbePsrW63o0GE8JJ4ZBr,bWdj2GDclj5ofokWjzoa5jAwMkxCykd6,3,0,0,0,0,0,4,0,4,0.5714285714285714,2,0.0,0,0,0,0,0,0,0,4,0,0,4,1
3943,92942,erkNYBqLpKRElyeL8GeAgO43CMazg6Rt,SpATywNh6bZuzm8s1ceuBUnMUAeoAHHw,7,4,3,0,1,0,5,0,13,1.8571428571428572,1,0.0,0,3,0,1,4,0,0,5,0,4,9,1
3944,92943,9HqwJ8d4m6K7QOSGhF3dVzXYAYpOl0vj,RXDvfPUBYFlVdlueBFbLW0mhhAyGEqpt,20,27,11,0,8,0,4,0,50,7.142857142857143,2,0.0,0,11,0,8,27,0,0,4,0,19,31,1
3945,92946,bab14MPTgN4CshxZkY1kRnkvwuN9o8mj,SpATywNh6bZuzm8s1ceuBUnMUAeoAHHw,7,6,3,0,0,0,4,0,13,1.8571428571428572,1,0.0,0,3,0,0,6,0,0,4,0,3,10,1
3946,92994,NOoY36GVhU97rerOUVOIRgnbHjJMMwCG,G8EPVSXsOYB5YQWZGiz1aVq5Pgr2GrQu,4,3,0,0,0,0,2,0,5,0.7142857142857143,1,0.0,0,0,0,0,3,0,0,2,0,0,5,1
3947,93001,0lnyhqsWvNqdzPtTAPrrtxMTUBGxwge7,bWdj2GDclj5ofokWjzoa5jAwMkxCykd6,19,26,16,60,4,21,13,1,141,20.142857142857142,2,0.0,3,16,54,4,23,21,6,13,1,77,64,1
3948,93003,jX688Ad4bKlzkVM1SgNhwbdpN9xeTtmq,SpATywNh6bZuzm8s1ceuBUnMUAeoAHHw,7,3,2,0,2,0,2,0,9,1.2857142857142858,1,0.0,0,2,0,2,3,0,0,2,0,4,5,1
3949,93008,OdMr7dE5UlAme9Tp979vREBvY5CV50po,SpATywNh6bZuzm8s1ceuBUnMUAeoAHHw,28,35,17,21,7,0,10,0,90,12.857142857142858,6,0.0,5,17,19,7,30,0,2,10,0,48,42,0
3950,93018,bvvXbZgPtHbMGEZyEKJpOMNTPWYUJwvY,SpATywNh6bZuzm8s1ceuBUnMUAeoAHHw,1,0,0,0,0,0,1,0,1,0.14285714285714285,1,0.0,0,0,0,0,0,0,0,1,0,0,1,1
3951,93021,O2zNu3OLMNHq2ZjC3tlYs2TX12EEuIAG,bWdj2GDclj5ofokWjzoa5jAwMkxCykd6,13,39,21,60,15,18,14,1,168,24.0,4,0.0,8,21,58,15,31,18,2,14,1,102,66,0
3952,93031,4ihKyViABUcTrutAyMvzpqSavA9xsDnC,SpATywNh6bZuzm8s1ceuBUnMUAeoAHHw,14,13,10,0,7,0,2,0,32,4.571428571428571,2,0.0,1,10,0,7,12,0,0,2,0,18,14,1
3953,93036,m9qgZNgP3Zn0sGVjbTdK1WyVxg0SzTDj,SpATywNh6bZuzm8s1ceuBUnMUAeoAHHw,2,0,0,0,0,0,2,0,2,0.2857142857142857,1,0.0,0,0,0,0,0,0,0,2,0,0,2,1
3954,93045,WDD9a1qNUJX21r5OnYzYbe9snqA1PiYA,SpATywNh6bZuzm8s1ceuBUnMUAeoAHHw,10,11,9,0,5,0,5,0,30,4.285714285714286,2,0.0,0,9,0,5,11,0,0,5,0,14,16,1
3955,93046,0hRwE5vbowYRJTF6rcWCTgSh4yHA34bg,A3fsA9Zfv1X2fVEQhTw51lKENdNrEqT3,36,31,2,70,0,8,20,1,132,18.857142857142858,3,0.0,1,2,57,0,30,8,13,20,1,60,72,1
3956,93051,35QP8hkG1fMgJT5B2mWO7L1K5UDzKccP,RXDvfPUBYFlVdlueBFbLW0mhhAyGEqpt,1,0,0,0,0,0,1,0,1,0.14285714285714285,1,0.0,0,0,0,0,0,0,0,1,0,0,1,1
3957,93079,nVktdU2hPjrulp1NoJo2DLy3TGZQ0Uld,A3fsA9Zfv1X2fVEQhTw51lKENdNrEqT3,7,6,0,0,0,0,2,0,8,1.1428571428571428,1,0.0,0,0,0,0,6,0,0,2,0,0,8,0
3958,93100,FOMKrwD1FP5IWZmKryOBAWZkzJtszFo9,SpATywNh6bZuzm8s1ceuBUnMUAeoAHHw,6,3,2,0,1,0,4,0,10,1.4285714285714286,1,0.0,0,2,0,1,3,0,0,4,0,3,7,1
3959,93122,YYCI1ivPCDRa3x25VBUTnS1EqXk51k7P,SpATywNh6bZuzm8s1ceuBUnMUAeoAHHw,7,12,4,4,1,0,1,0,22,3.142857142857143,1,0.0,6,4,3,1,6,0,1,1,0,14,8,0
3960,93134,dtoXBrWvzofUQqyHToiF0PcYE9x06cjk,SpATywNh6bZuzm8s1ceuBUnMUAeoAHHw,13,16,7,0,3,1,9,1,37,5.285714285714286,2,0.0,2,7,0,3,14,1,0,9,1,12,25,1
3961,93138,qS74cvHEfXf7yNOdjRQHxs4K6Mb0fkmB,SpATywNh6bZuzm8s1ceuBUnMUAeoAHHw,5,5,3,0,0,0,7,0,15,2.142857142857143,1,0.0,0,3,0,0,5,0,0,7,0,3,12,1
3962,93146,ZBPGXZQPhYZwTG0U8gbjH8byD6eXCds5,SpATywNh6bZuzm8s1ceuBUnMUAeoAHHw,6,5,2,0,1,0,2,0,10,1.4285714285714286,1,0.0,0,2,0,1,5,0,0,2,0,3,7,1
3963,93155,nSGQJTGjP40uh7YNQd2M7oeyj4wFgY5k,SpATywNh6bZuzm8s1ceuBUnMUAeoAHHw,2,0,0,0,0,0,2,0,2,0.2857142857142857,1,0.0,0,0,0,0,0,0,0,2,0,0,2,1
3964,93172,9IDnKSSeA9OzPUrVvzlwiLBkpPo3uKJE,SpATywNh6bZuzm8s1ceuBUnMUAeoAHHw,11,14,9,0,6,0,12,2,43,6.142857142857143,1,0.0,0,9,0,6,14,0,0,12,2,15,28,1
3965,93195,ky5OAnymGB6zQeiaZNCLcaybyAjfTGVL,SpATywNh6bZuzm8s1ceuBUnMUAeoAHHw,15,22,8,11,2,12,9,0,64,9.142857142857142,1,0.0,11,8,10,2,11,12,1,9,0,31,33,1
3966,93201,tT3q39TssUZPXoxVdRzgRUu1SUheNubE,RXDvfPUBYFlVdlueBFbLW0mhhAyGEqpt,45,36,16,55,11,6,7,4,135,19.285714285714285,1,0.0,13,16,54,11,23,6,1,7,4,94,41,1
3967,93211,CANUVyVkYrlpItUerZN2eMCH6gNsEzSe,SpATywNh6bZuzm8s1ceuBUnMUAeoAHHw,12,16,2,0,1,0,10,3,32,4.571428571428571,3,0.0,0,2,0,1,16,0,0,10,3,3,29,1
3968,93219,fFsk9opmVFrs9gVmzPsOgmxgpsHLQliL,RXDvfPUBYFlVdlueBFbLW0mhhAyGEqpt,5,2,1,0,1,0,2,0,6,0.8571428571428571,1,0.0,0,1,0,1,2,0,0,2,0,2,4,1
3969,93227,ZBHFsE2c9ve1GkdeoBpHdlFbQkWYYfYc,A3fsA9Zfv1X2fVEQhTw51lKENdNrEqT3,4,5,1,0,0,0,2,0,8,1.1428571428571428,1,0.0,0,1,0,0,5,0,0,2,0,1,7,1
3970,93232,PoEjlZTjKWZ6BdoswaJwpEc5iphj2X1w,SpATywNh6bZuzm8s1ceuBUnMUAeoAHHw,1,0,0,0,0,0,1,0,1,0.14285714285714285,1,0.0,0,0,0,0,0,0,0,1,0,0,1,1
3971,93243,IsU1RKSKxT8SmvRzyXcC6emxRwMddmTJ,G8EPVSXsOYB5YQWZGiz1aVq5Pgr2GrQu,39,37,29,0,25,11,12,2,116,16.571428571428573,3,0.0,0,29,0,25,37,11,0,12,2,54,62,0
3972,93246,IAOTVxG7e06ArppQIZcVBCeppiZS52Zi,SpATywNh6bZuzm8s1ceuBUnMUAeoAHHw,10,7,2,0,2,1,7,1,20,2.857142857142857,2,0.0,0,2,0,2,7,1,0,7,1,4,16,1
3973,93271,RU7DM4q1MiWySLBD1tZoVnYmW4ZnJ0DL,RXDvfPUBYFlVdlueBFbLW0mhhAyGEqpt,1,0,0,0,0,0,1,0,1,0.14285714285714285,1,0.0,0,0,0,0,0,0,0,1,0,0,1,1
3974,93276,0e7xKBaDw3RmIMJpdHntjD8WC2jIp95k,SpATywNh6bZuzm8s1ceuBUnMUAeoAHHw,8,21,0,0,0,0,1,0,22,3.142857142857143,1,0.0,6,0,0,0,15,0,0,1,0,6,16,1
3975,93303,bHLTcAQFvIQJ6YaYh6r99cb370HZ5sPT,SpATywNh6bZuzm8s1ceuBUnMUAeoAHHw,1,0,0,0,0,0,1,0,1,0.14285714285714285,1,0.0,0,0,0,0,0,0,0,1,0,0,1,1
3976,93323,tyChfLhRWgtuzBYIo0LShbD6knUykDjv,G8EPVSXsOYB5YQWZGiz1aVq5Pgr2GrQu,23,14,10,66,6,11,8,1,116,16.571428571428573,1,0.0,4,10,56,6,10,11,10,8,1,76,40,1
3977,93330,HkYdxX3voGkfjdg703KviJnQhukKhxOh,G8EPVSXsOYB5YQWZGiz1aVq5Pgr2GrQu,1,0,0,0,0,0,2,0,2,0.2857142857142857,1,0.0,0,0,0,0,0,0,0,2,0,0,2,1
3978,93334,KFG6G55toGAeaWBt5UmyioW5n1NVxSjT,bWdj2GDclj5ofokWjzoa5jAwMkxCykd6,29,95,55,109,25,2,43,1,330,47.142857142857146,9,0.0,13,55,103,25,82,2,6,43,1,196,134,0
3979,93344,05Pe1SQ9Q2cBjcEFXjoLImyNIG21bK6A,RXDvfPUBYFlVdlueBFbLW0mhhAyGEqpt,2,0,0,0,0,0,2,0,2,0.2857142857142857,1,0.0,0,0,0,0,0,0,0,2,0,0,2,1
3980,93352,PR6nGGqGE6eMvOu04QC9agInMN1u3Vt7,A3fsA9Zfv1X2fVEQhTw51lKENdNrEqT3,23,16,14,0,13,0,3,0,46,6.571428571428571,1,0.0,0,14,0,13,16,0,0,3,0,27,19,1
3981,93367,hQNy1TJdPWXJGnnjdyetV1l4iHaSeol4,A3fsA9Zfv1X2fVEQhTw51lKENdNrEqT3,35,33,10,34,7,2,12,1,99,14.142857142857142,3,0.0,2,10,32,7,31,2,2,12,1,51,48,1
3982,93371,2XEzBTMWqAbDwimqhpYNFpmeQsMJgIYu,G8EPVSXsOYB5YQWZGiz1aVq5Pgr2GrQu,10,25,13,0,2,0,10,0,50,7.142857142857143,2,0.0,0,13,0,2,25,0,0,10,0,15,35,1
3983,93372,rdlkz4QUHd85FYWQkxx9tuSVm08spAcj,bWdj2GDclj5ofokWjzoa5jAwMkxCykd6,1,0,0,0,0,0,1,0,1,0.14285714285714285,1,0.0,0,0,0,0,0,0,0,1,0,0,1,1
3984,93389,CgiSBY8umD4OFxzPTCRENtvLfSjhJE4Q,A3fsA9Zfv1X2fVEQhTw51lKENdNrEqT3,1,0,0,0,0,0,1,0,1,0.14285714285714285,1,0.0,0,0,0,0,0,0,0,1,0,0,1,1
3985,93391,zFhrdwHMxq2geDsJ6rOF9PjKHNvVI11p,A3fsA9Zfv1X2fVEQhTw51lKENdNrEqT3,12,6,5,0,5,0,1,0,17,2.4285714285714284,1,0.0,0,5,0,5,6,0,0,1,0,10,7,1
3986,93394,grc1pAXqdUQaBlZrZyROqjuEtg08nen2,A3fsA9Zfv1X2fVEQhTw51lKENdNrEqT3,6,4,1,0,0,0,3,0,8,1.1428571428571428,1,0.0,0,1,0,0,4,0,0,3,0,1,7,0
3987,93398,EjONyt33Kb19bd7xhGUM8lVieVH4ABMt,SpATywNh6bZuzm8s1ceuBUnMUAeoAHHw,5,2,1,0,1,0,2,0,6,0.8571428571428571,1,0.0,0,1,0,1,2,0,0,2,0,2,4,1
3988,93406,wCSstPXY2jshjpNaBAQvMm9l3Kvl06VT,bWdj2GDclj5ofokWjzoa5jAwMkxCykd6,9,70,8,0,2,0,23,0,103,14.714285714285714,7,0.0,2,8,0,2,68,0,0,23,0,12,91,1
3989,93430,ThGblU6q4nWmu3ORXgM7eQc8q9vcBP4r,bWdj2GDclj5ofokWjzoa5jAwMkxCykd6,11,48,13,20,9,24,31,0,145,20.714285714285715,7,0.0,6,13,19,9,42,24,1,31,0,47,98,1
3990,93443,urLIpfHBZDaCypO84XCYKp0hFEe7SU3u,SpATywNh6bZuzm8s1ceuBUnMUAeoAHHw,1,0,0,0,0,0,1,0,1,0.14285714285714285,1,0.0,0,0,0,0,0,0,0,1,0,0,1,1
3991,93469,rBjcfaRB4ipdhdlaYne0HS9fWNfJaL2z,A3fsA9Zfv1X2fVEQhTw51lKENdNrEqT3,2,0,0,0,0,1,4,0,5,0.7142857142857143,1,0.0,0,0,0,0,0,1,0,4,0,0,5,1
3992,93474,lsFZ5c3HC6SK6E53cEs8WDQLHZpNYjV8,A3fsA9Zfv1X2fVEQhTw51lKENdNrEqT3,1,0,0,0,0,0,1,0,1,0.14285714285714285,1,0.0,0,0,0,0,0,0,0,1,0,0,1,1
3993,93502,rukBWzj11e0XTZm12B6q1NVFBvhUpKcw,A3fsA9Zfv1X2fVEQhTw51lKENdNrEqT3,34,22,0,44,0,1,5,0,72,10.285714285714286,1,0.0,2,0,41,0,20,1,3,5,0,43,29,1
3994,93508,ESEu5Ebb0Dwu6eqKhLWhzsorI0PztGwh,bWdj2GDclj5ofokWjzoa5jAwMkxCykd6,7,10,0,0,0,0,7,0,17,2.4285714285714284,1,0.0,0,0,0,0,10,0,0,7,0,0,17,1
3995,93516,dkuQt2AJ3psLoe6oAyOQ02agP8eEbROK,A3fsA9Zfv1X2fVEQhTw51lKENdNrEqT3,1,0,0,0,0,0,1,0,1,0.14285714285714285,1,0.0,0,0,0,0,0,0,0,1,0,0,1,1
3996,93532,d78tyy5GbLAmAIYTt0zQeNafrfAUEUnp,SpATywNh6bZuzm8s1ceuBUnMUAeoAHHw,1,0,0,0,0,0,1,0,1,0.14285714285714285,1,0.0,0,0,0,0,0,0,0,1,0,0,1,1
3997,93539,hZR4MwcYec4g0GoOyJFngJGEyWOySpv2,SpATywNh6bZuzm8s1ceuBUnMUAeoAHHw,23,56,37,10,23,23,31,0,180,25.714285714285715,6,0.0,7,37,8,23,49,23,2,31,0,75,105,0
3998,93540,uSL2RaFO9pFGmE8bYQrfyJmRnbBOdoyU,SpATywNh6bZuzm8s1ceuBUnMUAeoAHHw,15,19,0,17,0,31,6,1,74,10.571428571428571,1,0.0,2,0,15,0,17,31,2,6,1,17,57,1
3999,93541,ThGblU6q4nWmu3ORXgM7eQc8q9vcBP4r,SpATywNh6bZuzm8s1ceuBUnMUAeoAHHw,29,79,25,22,8,77,37,1,249,35.57142857142857,7,0.0,13,25,20,8,66,77,2,37,1,66,183,1
4000,93555,mG2KwufBG46hwF0tMEUG2jvsfUa3PSHf,SpATywNh6bZuzm8s1ceuBUnMUAeoAHHw,11,11,7,0,4,0,2,0,24,3.4285714285714284,1,0.0,1,7,0,4,10,0,0,2,0,12,12,0
4001,93571,XqasR5GIfOx9ytwr0b8Q6Z12NNCt5pqh,bWdj2GDclj5ofokWjzoa5jAwMkxCykd6,6,4,2,0,2,0,3,0,11,1.5714285714285714,2,0.0,0,2,0,2,4,0,0,3,0,4,7,0
4002,93574,we9tWnySpl1G7k7FqyXPj8wmC2gUYK0W,bWdj2GDclj5ofokWjzoa5jAwMkxCykd6,1,0,0,0,0,0,1,0,1,0.14285714285714285,1,0.0,0,0,0,0,0,0,0,1,0,0,1,1
4003,93575,kRwbDFbRADlNU7lsdYCaasRGNiEpQeeP,SpATywNh6bZuzm8s1ceuBUnMUAeoAHHw,8,7,3,0,3,0,1,0,14,2.0,1,0.0,0,3,0,3,7,0,0,1,0,6,8,1
4004,93597,i0nkxYulaHR9i5zqaHNFQeOz0iG2pS8U,A3fsA9Zfv1X2fVEQhTw51lKENdNrEqT3,9,13,6,0,2,0,4,0,25,3.5714285714285716,2,0.0,0,6,0,2,13,0,0,4,0,8,17,0
4005,93611,mG2KwufBG46hwF0tMEUG2jvsfUa3PSHf,RXDvfPUBYFlVdlueBFbLW0mhhAyGEqpt,22,15,13,0,9,0,1,0,38,5.428571428571429,1,0.0,1,13,0,9,14,0,0,1,0,23,15,0
4006,93620,HJ2Te0AnFOdWtPQ1mbU0gvcfD3BsPlu2,SpATywNh6bZuzm8s1ceuBUnMUAeoAHHw,17,31,18,8,3,13,16,1,90,12.857142857142858,3,0.0,6,18,8,3,25,13,0,16,1,35,55,0
4007,93625,MrZt24U8nbuIX2mCMw4lqKt5FUFOZURE,SpATywNh6bZuzm8s1ceuBUnMUAeoAHHw,1,0,0,0,0,0,1,0,1,0.14285714285714285,1,0.0,0,0,0,0,0,0,0,1,0,0,1,1
4008,93626,ae9lMjY6PaxC3JKoLUmKZvfdwEZiOBPx,G8EPVSXsOYB5YQWZGiz1aVq5Pgr2GrQu,5,2,1,0,1,0,2,0,6,0.8571428571428571,1,0.0,0,1,0,1,2,0,0,2,0,2,4,1
4009,93639,Pd0CZHVPAay5ceQzChjGxlgmgiQ8cqjG,G8EPVSXsOYB5YQWZGiz1aVq5Pgr2GrQu,5,2,1,0,1,0,4,0,8,1.1428571428571428,1,0.0,0,1,0,1,2,0,0,4,0,2,6,1
4010,93645,Qbhh4psghTMTs2MbZkpJwwkpxbM26vfP,SpATywNh6bZuzm8s1ceuBUnMUAeoAHHw,4,0,0,0,0,0,3,2,5,0.7142857142857143,1,0.0,0,0,0,0,0,0,0,3,2,0,5,1
4011,93657,QO30UexmdD88uyPYe6YK3wSk3JLKQBe3,A3fsA9Zfv1X2fVEQhTw51lKENdNrEqT3,8,2,1,0,1,1,10,1,16,2.2857142857142856,2,0.0,0,1,0,1,2,1,0,10,1,2,14,1
4012,93659,F731sqjciH519ML4GCaVvNQuuR5Oaq9t,A3fsA9Zfv1X2fVEQhTw51lKENdNrEqT3,4,2,1,0,1,0,2,0,6,0.8571428571428571,1,0.0,0,1,0,1,2,0,0,2,0,2,4,1
4013,93679,ju4nY4FL2KNi1hifJCQn8sVUqJICxh4O,SpATywNh6bZuzm8s1ceuBUnMUAeoAHHw,23,24,11,34,5,0,8,0,82,11.714285714285714,3,0.0,4,11,29,5,20,0,5,8,0,49,33,1
4014,93686,pXBkDxIpO7cvN4HkForKspl0UN1aLwbn,A3fsA9Zfv1X2fVEQhTw51lKENdNrEqT3,1,0,0,0,0,0,1,0,1,0.14285714285714285,1,0.0,0,0,0,0,0,0,0,1,0,0,1,1
4015,93689,KXi2lu4GlKmrO1lJTLg3t4l701rvNXNZ,A3fsA9Zfv1X2fVEQhTw51lKENdNrEqT3,70,44,28,102,17,9,22,3,225,32.142857142857146,8,0.0,7,28,93,17,37,9,9,22,3,145,80,0
4016,93702,5JlWaFjebQSvyUeyQLJ4C0BlriWkf8Hy,SpATywNh6bZuzm8s1ceuBUnMUAeoAHHw,14,23,1,17,2,0,4,0,47,6.714285714285714,2,0.0,15,1,15,2,8,0,2,4,0,33,14,1
4017,93706,OCOZunZP01no4Zh4NYF1FDXoOWZrc1Yv,G8EPVSXsOYB5YQWZGiz1aVq5Pgr2GrQu,16,14,4,0,5,1,8,1,33,4.714285714285714,1,0.0,6,4,0,5,8,1,0,8,1,15,18,1
4018,93724,VvbZjK8y9aernnsSHvAW377h2uAEkOuF,SpATywNh6bZuzm8s1ceuBUnMUAeoAHHw,6,0,0,0,0,1,5,1,7,1.0,1,0.0,0,0,0,0,0,1,0,5,1,0,7,1
4019,93748,qYBrztNE2m7Kv5jO5Me3GoAEoNnGgBEu,G8EPVSXsOYB5YQWZGiz1aVq5Pgr2GrQu,10,13,3,0,2,5,13,2,38,5.428571428571429,1,0.0,3,3,0,2,10,5,0,13,2,8,30,1
4020,93749,jqfntS6RKR0gZFQrp9eaCMToaEgoc2Xi,SpATywNh6bZuzm8s1ceuBUnMUAeoAHHw,1,0,0,0,0,0,1,0,1,0.14285714285714285,1,0.0,0,0,0,0,0,0,0,1,0,0,1,1
4021,93753,fCj90D5XHmebJ0IrbbuHaVfcb7tqMxkl,bWdj2GDclj5ofokWjzoa5jAwMkxCykd6,28,151,47,46,28,2,26,1,301,43.0,5,0.0,36,47,38,28,115,2,8,26,1,149,152,1
4022,93815,F7cOObRHTu5td8ezD8oRze1BhvyOKDSk,SpATywNh6bZuzm8s1ceuBUnMUAeoAHHw,8,6,3,0,1,0,2,0,12,1.7142857142857142,1,0.0,2,3,0,1,4,0,0,2,0,6,6,1
4023,93825,mEXFRacWKZUZ0ZrkucFcb0mHAIpc1jKZ,G8EPVSXsOYB5YQWZGiz1aVq5Pgr2GrQu,6,3,0,0,1,1,2,0,7,1.0,1,0.0,0,0,0,1,3,1,0,2,0,1,6,1
4024,93827,qKm0x9dl3CcMx4vyQxKmKiMsD63vzUte,bWdj2GDclj5ofokWjzoa5jAwMkxCykd6,1,0,0,0,0,0,1,0,1,0.14285714285714285,1,0.0,0,0,0,0,0,0,0,1,0,0,1,1
4025,93829,O9HNCpYyjeUf5Yv9cKak2CowRvtq7CSH,SpATywNh6bZuzm8s1ceuBUnMUAeoAHHw,12,16,9,0,4,0,12,1,42,6.0,3,0.0,1,9,0,4,15,0,0,12,1,14,28,1
4026,93832,60ov46MOFnBiXMZrd5NKEQiqC0SiurVf,A3fsA9Zfv1X2fVEQhTw51lKENdNrEqT3,9,9,1,0,1,0,7,0,18,2.5714285714285716,2,0.0,0,1,0,1,9,0,0,7,0,2,16,1
4027,93836,b3eTIICIpBOeQwbL52WcSz5BKSnmXD5x,SpATywNh6bZuzm8s1ceuBUnMUAeoAHHw,10,6,4,0,2,0,6,1,19,2.7142857142857144,1,0.0,0,4,0,2,6,0,0,6,1,6,13,1
4028,93838,fkbxkXpN20umRnEu1JAMVCW41OYjb7dl,A3fsA9Zfv1X2fVEQhTw51lKENdNrEqT3,6,3,1,0,0,1,5,0,10,1.4285714285714286,1,0.0,0,1,0,0,3,1,0,5,0,1,9,1
4029,93874,mSs5bB1Rxg3xYWjWjJY9pVTt7WAiMgyu,SpATywNh6bZuzm8s1ceuBUnMUAeoAHHw,9,19,10,0,3,34,24,0,90,12.857142857142858,4,0.0,0,10,0,3,19,34,0,24,0,13,77,0
4030,93877,SjBgrEi81Cf6wmEgkI03BQFCuncsAECU,SpATywNh6bZuzm8s1ceuBUnMUAeoAHHw,4,0,0,0,0,0,4,0,4,0.5714285714285714,1,0.0,0,0,0,0,0,0,0,4,0,0,4,0
4031,93909,5Ikem26Scse18GVLkwyf1cheWsOPE25C,SpATywNh6bZuzm8s1ceuBUnMUAeoAHHw,8,5,3,0,2,0,3,0,13,1.8571428571428572,2,0.0,0,3,0,2,5,0,0,3,0,5,8,1
4032,93912,EicwSyKru5cUE8FbnBvU3nlCh4zs6SDU,SpATywNh6bZuzm8s1ceuBUnMUAeoAHHw,1,0,0,0,0,0,1,0,1,0.14285714285714285,1,0.0,0,0,0,0,0,0,0,1,0,0,1,1
4033,93943,oNQaCuO2rlrLriXUbP7yibkLZ8kZEP0A,SpATywNh6bZuzm8s1ceuBUnMUAeoAHHw,13,11,5,12,3,0,2,0,33,4.714285714285714,2,0.0,2,5,12,3,9,0,0,2,0,22,11,1
4034,93964,0bPKxjIIw0GaiIYeAS2yIr8ZqMELBNL4,RXDvfPUBYFlVdlueBFbLW0mhhAyGEqpt,5,6,4,0,0,0,2,0,12,1.7142857142857142,2,0.0,0,4,0,0,6,0,0,2,0,4,8,0
4035,93996,xV4buLLcPPEcE2C8BKOwlQiGdSlriMdM,RXDvfPUBYFlVdlueBFbLW0mhhAyGEqpt,1,0,0,0,0,0,2,0,2,0.2857142857142857,1,0.0,0,0,0,0,0,0,0,2,0,0,2,1
4036,94003,aj6uF4XWV3XUUfOpWCk3NuntI2wXym6n,A3fsA9Zfv1X2fVEQhTw51lKENdNrEqT3,9,6,0,0,0,0,17,1,24,3.4285714285714284,1,0.0,0,0,0,0,6,0,0,17,1,0,24,1
4037,94042,75ii7mb7d3VTc7Qrw6mG6DwTa15X98oH,SpATywNh6bZuzm8s1ceuBUnMUAeoAHHw,4,5,2,0,0,0,2,0,9,1.2857142857142858,1,0.0,0,2,0,0,5,0,0,2,0,2,7,0
4038,94044,t88wfrSqhn6m3ghlAqrTBAHAFrsZ2sxt,bWdj2GDclj5ofokWjzoa5jAwMkxCykd6,10,8,4,0,2,15,12,0,41,5.857142857142857,2,0.0,0,4,0,2,8,15,0,12,0,6,35,1
4039,94053,x5ZyS8ChPKTwgxrKWhGeApVsRxKYNf86,bWdj2GDclj5ofokWjzoa5jAwMkxCykd6,1,0,0,0,0,0,1,0,1,0.14285714285714285,1,0.0,0,0,0,0,0,0,0,1,0,0,1,1
4040,94054,nNPe0gYBpuLKMy034NoRKs4SMhD1YQxV,G8EPVSXsOYB5YQWZGiz1aVq5Pgr2GrQu,12,7,6,0,5,0,2,0,20,2.857142857142857,1,0.0,0,6,0,5,7,0,0,2,0,11,9,1
4041,94055,OK36i7c8u9GmSfG9DXL0YN94pRFkcmzE,SpATywNh6bZuzm8s1ceuBUnMUAeoAHHw,16,19,10,12,3,1,6,0,51,7.285714285714286,2,0.0,4,10,11,3,15,1,1,6,0,28,23,1
4042,94073,60AYcG1Aqq07FBEqNwevaiEWsxsSm68V,SpATywNh6bZuzm8s1ceuBUnMUAeoAHHw,18,31,12,6,4,39,15,1,108,15.428571428571429,3,0.0,8,12,6,4,23,39,0,15,1,30,78,1
4043,94075,8msGv7I17o9HQpLUg1Ukk6N7MNl4HPMn,A3fsA9Zfv1X2fVEQhTw51lKENdNrEqT3,5,3,0,0,0,0,5,0,8,1.1428571428571428,1,0.0,1,0,0,0,2,0,0,5,0,1,7,1
4044,94105,Crjc5H6MpWbzy0UxdiisUjbxslQAKkU9,SpATywNh6bZuzm8s1ceuBUnMUAeoAHHw,16,24,9,10,4,2,8,1,58,8.285714285714286,2,0.0,9,9,9,4,15,2,1,8,1,31,27,0
4045,94112,DHDCrD1ELgYhngP3vqwv1nXGZcmsEo8S,G8EPVSXsOYB5YQWZGiz1aVq5Pgr2GrQu,1,0,0,0,0,0,1,0,1,0.14285714285714285,1,0.0,0,0,0,0,0,0,0,1,0,0,1,1
4046,94115,uCjPUqEQP5ztmFjHYApjKLEWGDYVXats,bWdj2GDclj5ofokWjzoa5jAwMkxCykd6,4,2,1,0,0,0,3,0,6,0.8571428571428571,1,0.0,0,1,0,0,2,0,0,3,0,1,5,1
4047,94117,dW2So4dhz8sFwZQzndBoTpsFa69MFo0q,SpATywNh6bZuzm8s1ceuBUnMUAeoAHHw,15,16,9,12,2,1,5,1,46,6.571428571428571,1,0.0,5,9,11,2,11,1,1,5,1,27,19,1
4048,94123,u3SPm1HFwlhJpJKaAvQIjwvJr5QcuOph,SpATywNh6bZuzm8s1ceuBUnMUAeoAHHw,5,2,1,0,1,0,2,0,6,0.8571428571428571,1,0.0,0,1,0,1,2,0,0,2,0,2,4,1
4049,94137,DHDCrD1ELgYhngP3vqwv1nXGZcmsEo8S,SpATywNh6bZuzm8s1ceuBUnMUAeoAHHw,1,0,0,0,0,0,2,0,2,0.2857142857142857,1,0.0,0,0,0,0,0,0,0,2,0,0,2,1
4050,94144,uJQbjSAUKl9mATLkoLUgrR5h8oVXq5wA,bWdj2GDclj5ofokWjzoa5jAwMkxCykd6,7,2,1,0,1,0,5,2,11,1.5714285714285714,1,0.0,0,1,0,1,2,0,0,5,2,2,9,1
4051,94146,kvf1WFygeLGKOFkoertca6J9TDxV9fcY,bWdj2GDclj5ofokWjzoa5jAwMkxCykd6,8,9,6,10,6,0,1,0,32,4.571428571428571,2,0.0,1,6,8,6,8,0,2,1,0,21,11,1
4052,94147,kvf1WFygeLGKOFkoertca6J9TDxV9fcY,A3fsA9Zfv1X2fVEQhTw51lKENdNrEqT3,10,7,6,0,6,0,1,0,20,2.857142857142857,2,0.0,0,6,0,6,7,0,0,1,0,12,8,1
4053,94165,SoWAM0SsQFATkJWX6mveBwbG0XzudUfF,RXDvfPUBYFlVdlueBFbLW0mhhAyGEqpt,6,3,2,0,1,0,3,0,9,1.2857142857142858,1,0.0,0,2,0,1,3,0,0,3,0,3,6,1
4054,94182,iFoaVRNiF8fcNT1I1ii4FKoAviHvnVwj,SpATywNh6bZuzm8s1ceuBUnMUAeoAHHw,1,0,0,0,0,0,1,0,1,0.14285714285714285,1,0.0,0,0,0,0,0,0,0,1,0,0,1,1
4055,94188,OFXXpJjmXQdJCa3neipnRUGCkhEYKOcL,SpATywNh6bZuzm8s1ceuBUnMUAeoAHHw,7,6,1,0,0,0,3,0,10,1.4285714285714286,1,0.0,0,1,0,0,6,0,0,3,0,1,9,0
4056,94196,BZpQDGkWvmHTN4poCEi9fdZmAWn1G3Rj,RXDvfPUBYFlVdlueBFbLW0mhhAyGEqpt,11,8,7,0,7,0,5,0,27,3.857142857142857,1,0.0,0,7,0,7,8,0,0,5,0,14,13,1
4057,94201,68BjCXfBFqeZ01fFx1csrFmvef5xs0w2,A3fsA9Zfv1X2fVEQhTw51lKENdNrEqT3,5,2,1,0,1,0,3,0,7,1.0,1,0.0,0,1,0,1,2,0,0,3,0,2,5,1
4058,94216,4cB4y17zVi4jfdrlreMIHGN1aQJHMMST,A3fsA9Zfv1X2fVEQhTw51lKENdNrEqT3,4,2,0,0,0,0,2,0,4,0.5714285714285714,1,0.0,0,0,0,0,2,0,0,2,0,0,4,1
4059,94230,dW2So4dhz8sFwZQzndBoTpsFa69MFo0q,A3fsA9Zfv1X2fVEQhTw51lKENdNrEqT3,1,0,0,0,0,0,1,0,1,0.14285714285714285,1,0.0,0,0,0,0,0,0,0,1,0,0,1,1
4060,94238,Zy1VvDhL0b8E5oL4KNZb2wbF72hVCk4q,bWdj2GDclj5ofokWjzoa5jAwMkxCykd6,1,0,0,0,0,0,1,0,1,0.14285714285714285,1,0.0,0,0,0,0,0,0,0,1,0,0,1,1
4061,94250,hhHp518gAY3TOdaw37KX2gsPHN1LkpFC,G8EPVSXsOYB5YQWZGiz1aVq5Pgr2GrQu,7,6,1,0,2,0,2,0,11,1.5714285714285714,1,0.0,2,1,0,2,4,0,0,2,0,5,6,1
4062,94252,jKLLTSaN1oSiVcsyuWIwr9NVnuZSs3oX,A3fsA9Zfv1X2fVEQhTw51lKENdNrEqT3,5,4,2,0,1,0,3,0,10,1.4285714285714286,1,0.0,0,2,0,1,4,0,0,3,0,3,7,1
4063,94254,r9IhUgJi3OB3rtBncFGHCU1M0fOjKF1s,SpATywNh6bZuzm8s1ceuBUnMUAeoAHHw,14,20,8,17,4,0,2,0,51,7.285714285714286,2,0.0,10,8,15,4,10,0,2,2,0,37,14,1
4064,94263,9BiLYY350hgtHO5tL7nbMfcZU0JcfZbs,A3fsA9Zfv1X2fVEQhTw51lKENdNrEqT3,7,7,2,0,1,0,6,0,16,2.2857142857142856,2,0.0,2,2,0,1,5,0,0,6,0,5,11,1
4065,94275,gxKNGjI9pNbjjsMSjrRysbX0ykCNYwqn,bWdj2GDclj5ofokWjzoa5jAwMkxCykd6,4,3,1,0,1,0,1,0,6,0.8571428571428571,1,0.0,0,1,0,1,3,0,0,1,0,2,4,1
4066,94283,PSQvTxj1y3we6BHzfg47qDUvmFQLocrD,A3fsA9Zfv1X2fVEQhTw51lKENdNrEqT3,1,0,0,0,0,0,1,0,1,0.14285714285714285,1,0.0,0,0,0,0,0,0,0,1,0,0,1,1
4067,94300,5Lcwdb3Myw57AK6P9mHbDDRptSFCTb8f,A3fsA9Zfv1X2fVEQhTw51lKENdNrEqT3,11,5,4,0,4,0,5,0,18,2.5714285714285716,1,0.0,0,4,0,4,5,0,0,5,0,8,10,1
4068,94311,Gl03eSeNtb7juYcfyy4T6xQkEEhQalIx,SpATywNh6bZuzm8s1ceuBUnMUAeoAHHw,10,10,3,14,2,0,1,0,30,4.285714285714286,3,0.0,2,3,10,2,8,0,4,1,0,17,13,1
4069,94322,7CHeHg2oDOu9Zq2LKINtBF6E413tCv88,SpATywNh6bZuzm8s1ceuBUnMUAeoAHHw,9,8,3,0,3,0,6,0,20,2.857142857142857,2,0.0,0,3,0,3,8,0,0,6,0,6,14,1
4070,94328,plAreEiDkQpc8zc9xmMhqujDBy2S6jmC,SpATywNh6bZuzm8s1ceuBUnMUAeoAHHw,12,55,10,9,2,0,19,0,95,13.571428571428571,2,0.0,0,10,7,2,55,0,2,19,0,19,76,1
4071,94331,MreMBBpkQsLa4FQRsMj3EyXahyuFtEaB,SpATywNh6bZuzm8s1ceuBUnMUAeoAHHw,1,0,0,0,0,0,1,0,1,0.14285714285714285,1,0.0,0,0,0,0,0,0,0,1,0,0,1,1
4072,94358,9aS1NSJb2Hj0xHbbuoyhLmktYrjypxsy,G8EPVSXsOYB5YQWZGiz1aVq5Pgr2GrQu,38,31,12,96,7,0,8,1,155,22.142857142857142,2,0.0,18,12,70,7,13,0,26,8,1,107,48,1
4073,94376,uJRuDDw60tHrnuGJQZHSpoPAWASu6Wpf,SpATywNh6bZuzm8s1ceuBUnMUAeoAHHw,1,0,0,0,0,0,1,0,1,0.14285714285714285,1,0.0,0,0,0,0,0,0,0,1,0,0,1,0
4074,94382,au8A4X0QHQjQtIJwXFEgDKJdutxB5gYJ,SpATywNh6bZuzm8s1ceuBUnMUAeoAHHw,1,0,0,0,0,0,1,0,1,0.14285714285714285,1,0.0,0,0,0,0,0,0,0,1,0,0,1,1
4075,94383,OEUelCFKE8Wek74t5oKIe6H8MCi9M5Fi,RXDvfPUBYFlVdlueBFbLW0mhhAyGEqpt,1,0,0,0,0,0,1,0,1,0.14285714285714285,1,0.0,0,0,0,0,0,0,0,1,0,0,1,1
4076,94407,vCP75aDcEh5tNmLpxZodjHI02YfPV1g7,SpATywNh6bZuzm8s1ceuBUnMUAeoAHHw,2,0,0,0,0,0,8,0,8,1.1428571428571428,3,0.0,0,0,0,0,0,0,0,8,0,0,8,1
4077,94408,kdTkyJM1xm4AQ2tXVSlZpNtOhQ8qhZ4V,SpATywNh6bZuzm8s1ceuBUnMUAeoAHHw,7,8,4,0,2,0,4,0,18,2.5714285714285716,3,0.0,0,4,0,2,8,0,0,4,0,6,12,0
4078,94410,nTOZ6H8wygvPupRg4OwxXR9Zcu1XdDxE,RXDvfPUBYFlVdlueBFbLW0mhhAyGEqpt,1,0,0,0,0,0,1,0,1,0.14285714285714285,1,0.0,0,0,0,0,0,0,0,1,0,0,1,1
4079,94435,ZYJOgN8hxER8FBZMxsFqu3ZMgr4hrlRX,A3fsA9Zfv1X2fVEQhTw51lKENdNrEqT3,8,8,1,0,1,0,6,0,16,2.2857142857142856,1,0.0,0,1,0,1,8,0,0,6,0,2,14,1
4080,94443,FZWt1vapJFvo3kXFvlr3Pcq5dqSsXIdl,SpATywNh6bZuzm8s1ceuBUnMUAeoAHHw,29,38,23,31,11,8,8,4,123,17.571428571428573,3,0.0,9,23,28,11,29,8,3,8,4,71,52,1
4081,94449,YxWG3o8ByCvMoGHw8Fk45RhqzVf3tFyr,A3fsA9Zfv1X2fVEQhTw51lKENdNrEqT3,6,1,1,0,1,0,3,0,6,0.8571428571428571,1,0.0,0,1,0,1,1,0,0,3,0,2,4,1
4082,94454,HH9Roah3kzSupaHq1oHsqsjNMJy1K6WP,SpATywNh6bZuzm8s1ceuBUnMUAeoAHHw,6,8,1,0,1,0,2,0,12,1.7142857142857142,1,0.0,0,1,0,1,8,0,0,2,0,2,10,1
4083,94456,Yanv54bl6PB6cYN02rxbrTLlDFz7wAgw,A3fsA9Zfv1X2fVEQhTw51lKENdNrEqT3,2,0,0,0,0,0,2,0,2,0.2857142857142857,1,0.0,0,0,0,0,0,0,0,2,0,0,2,1
4084,94463,1dYxxqjVQ41eWA49zU6M54bp0RizbhKR,SpATywNh6bZuzm8s1ceuBUnMUAeoAHHw,6,5,3,0,1,0,3,0,12,1.7142857142857142,1,0.0,0,3,0,1,5,0,0,3,0,4,8,1
4085,94464,VvCLt24WQ5JOcwPfT9E7uWcGIgf1BHix,SpATywNh6bZuzm8s1ceuBUnMUAeoAHHw,14,15,10,14,5,2,3,0,49,7.0,1,0.0,3,10,11,5,12,2,3,3,0,29,20,1
4086,94486,gl2YVlebVAvCcxsYaIoTwLj5l1IGqntH,SpATywNh6bZuzm8s1ceuBUnMUAeoAHHw,9,16,7,4,0,0,2,0,29,4.142857142857143,2,0.0,6,7,4,0,10,0,0,2,0,17,12,0
4087,94496,We4HBkPE9Li2HHwmAADy328h9IORRs2l,G8EPVSXsOYB5YQWZGiz1aVq5Pgr2GrQu,1,0,0,0,0,0,1,0,1,0.14285714285714285,1,0.0,0,0,0,0,0,0,0,1,0,0,1,1
4088,94914,JdoyFe3ty0dkGc2UNdH7TaneDWe8Wbb5,fbPkOYLVPtPgIt0MxizjfFJov3JbHyAi,4,2,1,0,1,0,2,0,6,0.8571428571428571,2,0.0,0,1,0,1,2,0,0,2,0,2,4,1
4089,94917,GGhAGkRWD8jJVxrhUk5siJ00MzWLACx9,fbPkOYLVPtPgIt0MxizjfFJov3JbHyAi,2,0,0,0,0,0,3,0,3,0.42857142857142855,1,0.0,0,0,0,0,0,0,0,3,0,0,3,1
4090,94918,kWBY2KD53mjK2UMWhmo4HB3TIG4iJtfA,fbPkOYLVPtPgIt0MxizjfFJov3JbHyAi,11,7,4,6,4,0,3,0,24,3.4285714285714284,1,0.0,2,4,5,4,5,0,1,3,0,15,9,1
4091,94919,nLVkMUicIATb5XjlrKkVLbPcf3PrrUv6,fbPkOYLVPtPgIt0MxizjfFJov3JbHyAi,6,3,2,0,1,0,2,0,8,1.1428571428571428,1,0.0,0,2,0,1,3,0,0,2,0,3,5,1
4092,94920,AP8Ylu2Hp0YwQapv0VHVFwlhcyAdQlKm,fbPkOYLVPtPgIt0MxizjfFJov3JbHyAi,5,2,1,0,1,2,2,0,8,1.1428571428571428,1,0.0,0,1,0,1,2,2,0,2,0,2,6,1
4093,94921,1befQ3fLzEOh8IrvCOjGmYb6nrbCw6Ba,fbPkOYLVPtPgIt0MxizjfFJov3JbHyAi,3,0,0,0,0,0,5,0,5,0.7142857142857143,1,0.0,0,0,0,0,0,0,0,5,0,0,5,1
4094,94922,21C2qWSN1ubnQXVLo4VQ89cKYqN6OnV0,fbPkOYLVPtPgIt0MxizjfFJov3JbHyAi,5,2,1,0,1,0,3,0,7,1.0,1,0.0,0,1,0,1,2,0,0,3,0,2,5,1
4095,94923,ZSOqN2ncEDCf8kkfE2fTiwunpGip3a3v,fbPkOYLVPtPgIt0MxizjfFJov3JbHyAi,6,3,2,0,2,0,2,0,9,1.2857142857142858,1,0.0,0,2,0,2,3,0,0,2,0,4,5,1
4096,94924,iPQOLnMFMpAtiKO2f4vUT5fNNyluHmyN,fbPkOYLVPtPgIt0MxizjfFJov3JbHyAi,1,0,0,0,0,0,1,0,1,0.14285714285714285,1,0.0,0,0,0,0,0,0,0,1,0,0,1,1
4097,94928,rrKLV6p6Omqho3GHHSoh0noB8Eyb4dBf,fbPkOYLVPtPgIt0MxizjfFJov3JbHyAi,8,3,2,0,2,3,6,1,17,2.4285714285714284,1,0.0,0,2,0,2,3,3,0,6,1,4,13,1
4098,94929,rrZSZFoEgH3bOKdkZ0UyNzOq7Pdyx5G0,fbPkOYLVPtPgIt0MxizjfFJov3JbHyAi,2,0,0,0,0,0,2,0,2,0.2857142857142857,1,0.0,0,0,0,0,0,0,0,2,0,0,2,1
4099,94930,m81QFtDkjk8PmvblUhrkX50T3OfNUlpC,fbPkOYLVPtPgIt0MxizjfFJov3JbHyAi,1,0,0,0,0,0,1,0,1,0.14285714285714285,1,0.0,0,0,0,0,0,0,0,1,0,0,1,1
4100,94931,YLWMEkP67YDwtagmvU5WKcZzKqdf99Vy,fbPkOYLVPtPgIt0MxizjfFJov3JbHyAi,7,5,2,0,1,0,4,0,12,1.7142857142857142,1,0.0,0,2,0,1,5,0,0,4,0,3,9,1
4101,94934,53AX9rmI3k6LH6bFgA3smsUSiak9PiH8,fbPkOYLVPtPgIt0MxizjfFJov3JbHyAi,9,15,5,5,2,1,3,0,31,4.428571428571429,1,0.0,3,5,5,2,12,1,0,3,0,15,16,1
4102,94938,ATZ830ERUxX8pXsrEHiyTC9qIj0J3xKL,fbPkOYLVPtPgIt0MxizjfFJov3JbHyAi,1,0,0,0,0,0,1,0,1,0.14285714285714285,1,0.0,0,0,0,0,0,0,0,1,0,0,1,1
4103,94941,PksTe80EnSZRP5IgVxGPpb2S7NuUyS61,fbPkOYLVPtPgIt0MxizjfFJov3JbHyAi,8,8,6,0,5,0,5,0,24,3.4285714285714284,1,0.0,0,6,0,5,8,0,0,5,0,11,13,1
4104,94943,2slXWNniikORlDrKt6rdY1XwdvOyFwgH,fbPkOYLVPtPgIt0MxizjfFJov3JbHyAi,6,3,2,0,2,0,1,0,8,1.1428571428571428,1,0.0,0,2,0,2,3,0,0,1,0,4,4,1
4105,94946,7uAP6PCGaUrEF1zOYcYy8DKDCb9pFsmY,fbPkOYLVPtPgIt0MxizjfFJov3JbHyAi,26,82,17,36,23,31,17,3,209,29.857142857142858,3,0.0,34,17,30,23,48,31,6,17,3,104,105,1
4106,94950,uf9uxJ0q9fqnk8v2mIZk18f6DfpdKvW8,fbPkOYLVPtPgIt0MxizjfFJov3JbHyAi,8,5,3,0,2,0,3,0,13,1.8571428571428572,1,0.0,0,3,0,2,5,0,0,3,0,5,8,1
4107,95305,NzceHZYafdRYNlSM9Nht2IC1aPdIvfsS,G8EPVSXsOYB5YQWZGiz1aVq5Pgr2GrQu,7,6,4,2,0,0,1,0,13,1.8571428571428572,1,0.0,1,4,1,0,5,0,1,1,0,6,7,1
4108,95313,qosnWICleDjB0mAqFG1weKjFjwPkMIbX,SpATywNh6bZuzm8s1ceuBUnMUAeoAHHw,12,9,7,0,4,0,4,0,24,3.4285714285714284,1,0.0,0,7,0,4,9,0,0,4,0,11,13,1
4109,95361,Djs1zlGGz9CjaytXVMiGNIbCd4ODEdqG,A3fsA9Zfv1X2fVEQhTw51lKENdNrEqT3,3,0,0,0,0,0,3,0,3,0.42857142857142855,1,0.0,0,0,0,0,0,0,0,3,0,0,3,1
4110,95383,ZHBg1MltX3XrB2nTtco0amjezusVv1FZ,bWdj2GDclj5ofokWjzoa5jAwMkxCykd6,4,3,1,0,1,0,1,0,6,0.8571428571428571,1,0.0,0,1,0,1,3,0,0,1,0,2,4,1
4111,95384,9vMfKHFzhvmzdCBc05dqw5icnEdTUd5x,bWdj2GDclj5ofokWjzoa5jAwMkxCykd6,38,95,43,89,13,4,27,0,271,38.714285714285715,5,0.0,16,43,80,13,79,4,9,27,0,152,119,1
4112,95386,lVwgv61cg8fkhW9rg5b1PIPnuUWxb0Vk,A3fsA9Zfv1X2fVEQhTw51lKENdNrEqT3,49,44,30,76,16,276,58,11,511,73.0,11,0.0,4,30,58,16,40,276,18,58,11,108,403,0
4113,95388,WVU6lNV4yCEYBx8BfYMKeJgO2PfYQmk7,bWdj2GDclj5ofokWjzoa5jAwMkxCykd6,25,13,0,40,0,0,6,1,60,8.571428571428571,1,0.0,7,0,37,0,6,0,3,6,1,44,16,1
4114,95397,aFMNRUeRxFSXjv2yTdRuJu4lTCyXCFDD,bWdj2GDclj5ofokWjzoa5jAwMkxCykd6,4,2,1,0,1,1,3,0,8,1.1428571428571428,1,0.0,0,1,0,1,2,1,0,3,0,2,6,1
4115,95398,SM6SmE3aMr36NQr3MbQQW1aFlehpkSNf,bWdj2GDclj5ofokWjzoa5jAwMkxCykd6,2,0,0,0,0,0,4,0,4,0.5714285714285714,2,0.0,0,0,0,0,0,0,0,4,0,0,4,1
4116,95399,Id4UmIRRQiLXHoJYSjh5OCO1CRaFgQ2K,A3fsA9Zfv1X2fVEQhTw51lKENdNrEqT3,41,43,20,76,17,2,4,0,162,23.142857142857142,1,0.0,1,20,59,17,42,2,17,4,0,97,65,1
4117,95408,OdsEBh425XZxll0hTUv04OAotDf6aGtE,RXDvfPUBYFlVdlueBFbLW0mhhAyGEqpt,7,13,7,0,3,0,1,0,24,3.4285714285714284,1,0.0,0,7,0,3,13,0,0,1,0,10,14,1
4118,95425,79rw5BhFSnhvdIaVsXl3jeEXJRviIjGz,A3fsA9Zfv1X2fVEQhTw51lKENdNrEqT3,67,32,20,150,11,4,11,1,229,32.714285714285715,2,0.0,9,20,129,11,23,4,21,11,1,169,60,0
4119,95427,GdhgDlZa5ZJ9AzwBGC942HC991fsxvHr,G8EPVSXsOYB5YQWZGiz1aVq5Pgr2GrQu,18,19,2,16,2,0,9,6,54,7.714285714285714,1,0.0,0,2,13,2,19,0,3,9,6,17,37,1
4120,95440,NT7bBO2hHEg05ci9UTFOwIHaUZMIdh9x,SpATywNh6bZuzm8s1ceuBUnMUAeoAHHw,21,26,10,32,3,2,6,2,81,11.571428571428571,3,0.0,10,10,27,3,16,2,5,6,2,50,31,1
4121,95461,M507IlBQp64NkSWnSkchjsahApLaE1kJ,A3fsA9Zfv1X2fVEQhTw51lKENdNrEqT3,50,48,35,80,21,7,19,1,211,30.142857142857142,3,0.0,3,35,61,21,45,7,19,19,1,120,91,1
4122,95472,Dsiw0jpMBHHLbjdF7l3UeGKLOlfgXUpd,SpATywNh6bZuzm8s1ceuBUnMUAeoAHHw,29,25,15,31,7,1,5,0,84,12.0,1,0.0,5,15,28,7,20,1,3,5,0,55,29,1
4123,95490,pJLSeQHIu4aZZbYoyPq22AsdfE0vwv53,bWdj2GDclj5ofokWjzoa5jAwMkxCykd6,2,0,0,0,0,0,2,0,2,0.2857142857142857,1,0.0,0,0,0,0,0,0,0,2,0,0,2,0
4124,95493,N0D8gfv74t8uM2LFiOg2xy8nVL0vO7Kx,SpATywNh6bZuzm8s1ceuBUnMUAeoAHHw,7,3,2,0,2,0,2,0,9,1.2857142857142858,1,0.0,0,2,0,2,3,0,0,2,0,4,5,1
4125,95507,YLfjSoU2JNGG7f9SEbr83b8mp8z1n7i3,A3fsA9Zfv1X2fVEQhTw51lKENdNrEqT3,1,0,0,0,0,0,1,0,1,0.14285714285714285,1,0.0,0,0,0,0,0,0,0,1,0,0,1,1
4126,95517,WzkRGtR4EenxksGL0ftvaO4vHssxZDFt,A3fsA9Zfv1X2fVEQhTw51lKENdNrEqT3,3,0,0,0,0,0,3,0,3,0.42857142857142855,1,0.0,0,0,0,0,0,0,0,3,0,0,3,1
4127,95521,OF90Hu2g8vPUjKHCP4ULPYNMvRFKxBj6,SpATywNh6bZuzm8s1ceuBUnMUAeoAHHw,32,49,25,36,10,11,17,2,150,21.428571428571427,4,0.0,15,25,28,10,34,11,8,17,2,78,72,0
4128,95561,BILNjgDM4z6ewRYZ6qt3YLHpB6O5FFua,SpATywNh6bZuzm8s1ceuBUnMUAeoAHHw,7,4,3,0,3,0,2,0,12,1.7142857142857142,1,0.0,0,3,0,3,4,0,0,2,0,6,6,1
4129,95583,YaP2AuckukEZITP3IVvIt6Z8ci6RHew7,bWdj2GDclj5ofokWjzoa5jAwMkxCykd6,12,8,5,0,3,0,4,0,20,2.857142857142857,2,0.0,0,5,0,3,8,0,0,4,0,8,12,1
4130,95588,DxGyu8XXv7e8wbVx0mvEABKcoqoolLlv,bWdj2GDclj5ofokWjzoa5jAwMkxCykd6,4,0,0,0,0,0,11,0,11,1.5714285714285714,1,0.0,0,0,0,0,0,0,0,11,0,0,11,1
4131,95590,XfiCSk5eLAbq9rzQtnLkX2OQTd6M8xFG,A3fsA9Zfv1X2fVEQhTw51lKENdNrEqT3,1,0,0,0,0,0,1,0,1,0.14285714285714285,1,0.0,0,0,0,0,0,0,0,1,0,0,1,1
4132,95593,DHUv7XpIZcPp2QYGNmTXjhgg7Zq4BpJ7,A3fsA9Zfv1X2fVEQhTw51lKENdNrEqT3,18,10,8,12,6,0,2,0,38,5.428571428571429,2,0.0,0,8,10,6,10,0,2,2,0,24,14,1
4133,95595,ZBEHpTfGoLiomhe8zt7rkm2uZVd9b9kk,SpATywNh6bZuzm8s1ceuBUnMUAeoAHHw,5,7,0,0,1,0,1,0,9,1.2857142857142858,1,0.0,0,0,0,1,7,0,0,1,0,1,8,1
4134,95605,UaSh8dwx8gnofYbXlmpqj9uYDbpJ89pX,A3fsA9Zfv1X2fVEQhTw51lKENdNrEqT3,13,19,0,0,0,21,17,3,60,8.571428571428571,4,0.0,1,0,0,0,18,21,0,17,3,1,59,1
4135,95617,Daw06K1PSOXldo19kBgHP5sewulb7Vu5,A3fsA9Zfv1X2fVEQhTw51lKENdNrEqT3,4,2,1,0,1,0,3,0,7,1.0,2,0.0,0,1,0,1,2,0,0,3,0,2,5,0
4136,95620,Daw06K1PSOXldo19kBgHP5sewulb7Vu5,G8EPVSXsOYB5YQWZGiz1aVq5Pgr2GrQu,1,0,0,0,0,0,1,0,1,0.14285714285714285,1,0.0,0,0,0,0,0,0,0,1,0,0,1,1
4137,95622,DGrwRqi3z3Y9GhMsPFPJjWU0FULJtTwp,A3fsA9Zfv1X2fVEQhTw51lKENdNrEqT3,5,0,0,0,0,0,5,1,6,0.8571428571428571,2,0.0,0,0,0,0,0,0,0,5,1,0,6,1
4138,95624,YLJN09Je7GNR4wBomW2iH8q4HAK5TPdc,RXDvfPUBYFlVdlueBFbLW0mhhAyGEqpt,29,29,8,20,6,23,5,0,91,13.0,1,0.0,3,8,20,6,26,23,0,5,0,37,54,1
4139,95627,fxfoo3EegutxQePINTymJFzExTdNcKVI,SpATywNh6bZuzm8s1ceuBUnMUAeoAHHw,28,20,9,32,7,1,12,1,82,11.714285714285714,3,0.0,6,9,29,7,14,1,3,12,1,51,31,1
4140,95631,cW2QGOVqGX1ONxdDTXMiDqmocWqOnU5N,A3fsA9Zfv1X2fVEQhTw51lKENdNrEqT3,4,3,1,0,0,0,2,0,6,0.8571428571428571,1,0.0,0,1,0,0,3,0,0,2,0,1,5,1
4141,95633,ZtofBugo33Zo9FroLN9tXtgl9O0zgDWY,SpATywNh6bZuzm8s1ceuBUnMUAeoAHHw,20,18,6,27,2,0,3,0,56,8.0,3,0.0,4,6,24,2,14,0,3,3,0,36,20,0
4142,95646,kHWuc10C4T4imgPGXw1iL9DdxxMDyloj,RXDvfPUBYFlVdlueBFbLW0mhhAyGEqpt,1,0,0,0,0,0,1,0,1,0.14285714285714285,1,0.0,0,0,0,0,0,0,0,1,0,0,1,1
4143,95653,fn3RgMp4JCABnOK3IDXz6cUAXpmeuiYQ,G8EPVSXsOYB5YQWZGiz1aVq5Pgr2GrQu,9,6,3,0,4,0,2,0,15,2.142857142857143,1,0.0,2,3,0,4,4,0,0,2,0,9,6,1
4144,95659,y8wihgxEdHfGcxMV16au6pgiPnSQwx23,RXDvfPUBYFlVdlueBFbLW0mhhAyGEqpt,7,1,1,0,1,0,6,0,9,1.2857142857142858,1,0.0,0,1,0,1,1,0,0,6,0,2,7,1
4145,95662,4NPDuZC5Eo397A2ZzeMAm6BBPfedAt7V,SpATywNh6bZuzm8s1ceuBUnMUAeoAHHw,9,3,2,0,2,0,9,2,18,2.5714285714285716,1,0.0,0,2,0,2,3,0,0,9,2,4,14,1
4146,95669,k24Ps3wdaeoSwT1eSTFmxgPUJ0moWYPO,SpATywNh6bZuzm8s1ceuBUnMUAeoAHHw,6,4,1,0,1,0,3,0,9,1.2857142857142858,1,0.0,0,1,0,1,4,0,0,3,0,2,7,1
4147,95684,Nsz2zYB7CSRbOtMFEx5HNBJ0rxH2o1F7,A3fsA9Zfv1X2fVEQhTw51lKENdNrEqT3,4,0,0,0,0,0,8,0,8,1.1428571428571428,1,0.0,0,0,0,0,0,0,0,8,0,0,8,1
4148,95690,4NPDuZC5Eo397A2ZzeMAm6BBPfedAt7V,G8EPVSXsOYB5YQWZGiz1aVq5Pgr2GrQu,1,0,0,0,0,0,1,0,1,0.14285714285714285,1,0.0,0,0,0,0,0,0,0,1,0,0,1,1
4149,95694,m1Erwr4qiZRddhtJBwtwyQxEqeaRgIgi,SpATywNh6bZuzm8s1ceuBUnMUAeoAHHw,7,3,1,0,1,0,3,1,9,1.2857142857142858,1,0.0,0,1,0,1,3,0,0,3,1,2,7,1
4150,95699,zPbUIdTRPjnN9GVjy7Vs8SVwjdhRAaUM,SpATywNh6bZuzm8s1ceuBUnMUAeoAHHw,4,3,1,0,1,0,2,0,7,1.0,1,0.0,0,1,0,1,3,0,0,2,0,2,5,1
4151,95726,9yvWwncWvyjvEU2gkB98t6ra5ZlqpOOe,SpATywNh6bZuzm8s1ceuBUnMUAeoAHHw,31,31,15,16,8,0,10,1,81,11.571428571428571,2,0.0,6,15,15,8,25,0,1,10,1,44,37,1
4152,95737,CLsYy7g1hYWHJyj1aROfKK9oTeo5yxJx,bWdj2GDclj5ofokWjzoa5jAwMkxCykd6,1,0,0,0,0,0,1,0,1,0.14285714285714285,1,0.0,0,0,0,0,0,0,0,1,0,0,1,1
4153,95744,FXy6zIwT4trAO2Fwnqm3Ehrt0HqoYcIs,SpATywNh6bZuzm8s1ceuBUnMUAeoAHHw,6,5,1,0,1,0,2,0,9,1.2857142857142858,1,0.0,0,1,0,1,5,0,0,2,0,2,7,1
4154,95751,nMyFoPqXKsdnuE6mgxy1XpE5LPKy9GOa,G8EPVSXsOYB5YQWZGiz1aVq5Pgr2GrQu,1,0,0,0,0,0,1,0,1,0.14285714285714285,1,0.0,0,0,0,0,0,0,0,1,0,0,1,1
4155,95768,tKaMjS6KWA4OmqzSfTJZDMyzIRtISbIo,SpATywNh6bZuzm8s1ceuBUnMUAeoAHHw,1,0,0,0,0,0,1,0,1,0.14285714285714285,1,0.0,0,0,0,0,0,0,0,1,0,0,1,0
4156,95785,1SCPwRp6zs8beWzgpgsNRS1NXyUeSOy8,bWdj2GDclj5ofokWjzoa5jAwMkxCykd6,8,13,5,58,2,9,3,0,90,12.857142857142858,1,0.0,5,5,56,2,8,9,2,3,0,68,22,1
4157,95809,gMeKwVdV7xHR9zrsQTTuP5xOz4aKMsCh,RXDvfPUBYFlVdlueBFbLW0mhhAyGEqpt,10,4,4,0,2,0,4,0,14,2.0,1,0.0,0,4,0,2,4,0,0,4,0,6,8,1
4158,95814,pK3w2ljSu5UCiWTsVPCK8fUfSVn5X9S6,SpATywNh6bZuzm8s1ceuBUnMUAeoAHHw,28,43,21,23,13,0,5,0,105,15.0,1,0.0,13,21,23,13,30,0,0,5,0,70,35,1
4159,95815,forPgRyluFqH5fyMZfnKJctNYjPII95b,A3fsA9Zfv1X2fVEQhTw51lKENdNrEqT3,15,5,1,30,0,0,3,0,39,5.571428571428571,1,0.0,0,1,27,0,5,0,3,3,0,28,11,1
4160,95850,NvdQzMD14NnCAS0YAW6YP4m31ATjV5UA,SpATywNh6bZuzm8s1ceuBUnMUAeoAHHw,12,12,6,0,8,1,2,0,29,4.142857142857143,1,0.0,0,6,0,8,12,1,0,2,0,14,15,1
4161,95852,nB9RnfPmq1WfPeBn5EUZt5ffKcXJEdE4,A3fsA9Zfv1X2fVEQhTw51lKENdNrEqT3,2,0,0,0,0,0,4,0,4,0.5714285714285714,3,0.0,0,0,0,0,0,0,0,4,0,0,4,1
4162,95860,JcocKAtlN5pNw3B6wmg6BZFKdvxcJRHw,bWdj2GDclj5ofokWjzoa5jAwMkxCykd6,14,16,8,36,7,0,2,0,69,9.857142857142858,1,0.0,5,8,29,7,11,0,7,2,0,49,20,1
4163,95880,XNJvqr2ia2XRTEmLeguLZckH2aLyvBMM,SpATywNh6bZuzm8s1ceuBUnMUAeoAHHw,6,6,3,0,0,0,3,0,12,1.7142857142857142,2,0.0,0,3,0,0,6,0,0,3,0,3,9,1
4164,95899,qwWysWdLmrwh0JmjPYNGVFqdat8Jy8Lb,bWdj2GDclj5ofokWjzoa5jAwMkxCykd6,7,9,2,0,2,0,7,0,20,2.857142857142857,2,0.0,2,2,0,2,7,0,0,7,0,6,14,0
4165,95901,jzWvwaTexkgbyBrPkQbXDb98Viqx6cSS,A3fsA9Zfv1X2fVEQhTw51lKENdNrEqT3,42,7,3,114,0,0,5,0,129,18.428571428571427,2,0.0,3,3,100,0,4,0,14,5,0,106,23,1
4166,95908,b80Lkn7xNHauWWmN3QIwsLauRSXsSHrY,SpATywNh6bZuzm8s1ceuBUnMUAeoAHHw,6,6,0,0,1,0,2,0,9,1.2857142857142858,1,0.0,2,0,0,1,4,0,0,2,0,3,6,1
4167,95913,m7hBmfvQj5nDU6vEGQuVMa4fkSxlliz4,G8EPVSXsOYB5YQWZGiz1aVq5Pgr2GrQu,4,2,0,0,0,0,2,0,4,0.5714285714285714,1,0.0,0,0,0,0,2,0,0,2,0,0,4,1
4168,95933,pwoJhGEuCXUAzWggYD0Vpr6rlqs95MdC,SpATywNh6bZuzm8s1ceuBUnMUAeoAHHw,6,3,2,0,2,0,1,0,8,1.1428571428571428,1,0.0,0,2,0,2,3,0,0,1,0,4,4,1
4169,95939,q7ixHJ98uI7DV9nBYxjXxbopCkuH6DX6,SpATywNh6bZuzm8s1ceuBUnMUAeoAHHw,3,0,0,0,0,0,3,0,3,0.42857142857142855,1,0.0,0,0,0,0,0,0,0,3,0,0,3,1
4170,95941,5FCCqL18D5yTiqyAg5N299Ugwsv8CI3G,SpATywNh6bZuzm8s1ceuBUnMUAeoAHHw,6,3,1,0,1,0,2,0,7,1.0,1,0.0,0,1,0,1,3,0,0,2,0,2,5,0
4171,95951,Uvg7ZsdO3eZ12twQcai6zLQJvqq6H5qj,G8EPVSXsOYB5YQWZGiz1aVq5Pgr2GrQu,9,5,1,0,1,0,5,0,12,1.7142857142857142,2,0.0,0,1,0,1,5,0,0,5,0,2,10,0
4172,95958,Ar7wri6od2sIMOfx95hPmMwDttR4wtOC,A3fsA9Zfv1X2fVEQhTw51lKENdNrEqT3,30,7,3,56,2,0,6,1,75,10.714285714285714,1,0.0,1,3,49,2,6,0,7,6,1,55,20,0
4173,95978,wfyGhtXQXfiz6Xnx0YIucq6EMEmHdLu2,SpATywNh6bZuzm8s1ceuBUnMUAeoAHHw,1,0,0,0,0,0,1,0,1,0.14285714285714285,1,0.0,0,0,0,0,0,0,0,1,0,0,1,1
4174,95993,pcy81jlx7huLaDPvWWRXTEiJTAUolrbh,A3fsA9Zfv1X2fVEQhTw51lKENdNrEqT3,8,4,3,0,3,0,1,0,11,1.5714285714285714,1,0.0,0,3,0,3,4,0,0,1,0,6,5,1
4175,96003,Hxd16O3nQG6ddXQCBbAu8BGBmmZmiixl,G8EPVSXsOYB5YQWZGiz1aVq5Pgr2GrQu,1,0,0,0,0,0,1,0,1,0.14285714285714285,1,0.0,0,0,0,0,0,0,0,1,0,0,1,1
4176,96011,XtXVGX6xZjaXboxbRFBRNJiE8mlrJ6RY,SpATywNh6bZuzm8s1ceuBUnMUAeoAHHw,1,0,0,0,0,0,2,0,2,0.2857142857142857,1,0.0,0,0,0,0,0,0,0,2,0,0,2,1
4177,96035,NGxVJQppNBMfgJiFwD3Ox6xl5bHm79ig,SpATywNh6bZuzm8s1ceuBUnMUAeoAHHw,7,3,2,0,2,0,2,0,9,1.2857142857142858,1,0.0,0,2,0,2,3,0,0,2,0,4,5,1
4178,96036,zwqhxdboQszkcKvPN5pyN1nGDFR4ub3y,A3fsA9Zfv1X2fVEQhTw51lKENdNrEqT3,6,2,1,0,1,0,4,0,8,1.1428571428571428,1,0.0,0,1,0,1,2,0,0,4,0,2,6,1
4179,96054,G9ja1Sell6i4GCvRpZMszshIwT0u0uoK,SpATywNh6bZuzm8s1ceuBUnMUAeoAHHw,4,3,1,0,1,0,1,0,6,0.8571428571428571,1,0.0,0,1,0,1,3,0,0,1,0,2,4,0
4180,96073,FZWt1vapJFvo3kXFvlr3Pcq5dqSsXIdl,G8EPVSXsOYB5YQWZGiz1aVq5Pgr2GrQu,4,2,0,0,0,0,3,0,5,0.7142857142857143,1,0.0,0,0,0,0,2,0,0,3,0,0,5,1
4181,96099,ps5VcFUapZM31sy4VNJWOTFBzN98932v,RXDvfPUBYFlVdlueBFbLW0mhhAyGEqpt,1,0,0,0,0,0,1,0,1,0.14285714285714285,1,0.0,0,0,0,0,0,0,0,1,0,0,1,0
4182,96116,liXvDig5u9dxIPwxTVIf3BkkLMQ16JFo,SpATywNh6bZuzm8s1ceuBUnMUAeoAHHw,2,0,0,0,0,0,2,0,2,0.2857142857142857,1,0.0,0,0,0,0,0,0,0,2,0,0,2,1
4183,96129,8n73BBd3mvRJq2a0KZ4WJWTYj65s8f61,A3fsA9Zfv1X2fVEQhTw51lKENdNrEqT3,1,0,0,0,0,0,1,0,1,0.14285714285714285,1,0.0,0,0,0,0,0,0,0,1,0,0,1,1
4184,96134,VeFENcSXAiXgJQaSjlXiodtIBxgSrzaH,bWdj2GDclj5ofokWjzoa5jAwMkxCykd6,6,5,0,0,0,0,3,0,8,1.1428571428571428,1,0.0,1,0,0,0,4,0,0,3,0,1,7,0
4185,96677,xOjhmcafCtLT2q16oVNZpjeZh4FUCy6U,A3fsA9Zfv1X2fVEQhTw51lKENdNrEqT3,1,0,0,0,0,0,1,0,1,0.14285714285714285,1,0.0,0,0,0,0,0,0,0,1,0,0,1,1
4186,96695,plWW2jbmbdQAaG18LPwZIwpV7ZE0ypXp,SpATywNh6bZuzm8s1ceuBUnMUAeoAHHw,7,1,1,0,1,0,4,1,8,1.1428571428571428,1,0.0,0,1,0,1,1,0,0,4,1,2,6,0
4187,96724,Vqh7IxciNu3w4ryq9DwYRMQWb1h8f16V,SpATywNh6bZuzm8s1ceuBUnMUAeoAHHw,15,18,6,22,4,23,9,3,85,12.142857142857142,1,0.0,6,6,19,4,12,23,3,9,3,35,50,1
4188,96732,RHsk3gHUm8VEfb9FwEFf8vBDNKZZ0LWe,A3fsA9Zfv1X2fVEQhTw51lKENdNrEqT3,70,30,23,142,16,5,10,2,228,32.57142857142857,2,0.0,2,23,108,16,28,5,34,10,2,149,79,1
4189,96893,UAyWvSjTLiO8ve7HkUm43OX3XFSgIZD0,7GRhBDsirIGkRZBtSMEzNTyDr2JQm4xx,1,0,0,0,0,0,1,0,1,0.14285714285714285,1,0.0,0,0,0,0,0,0,0,1,0,0,1,1
4190,96895,Ip3irZsxFvOeGg8WSppVhJArbPhoH3qm,A3fsA9Zfv1X2fVEQhTw51lKENdNrEqT3,10,7,6,0,6,0,1,0,20,2.857142857142857,1,0.0,0,6,0,6,7,0,0,1,0,12,8,1
4191,96929,uaGHWOyiH6GRJNYQ5wYQgdGgJiyGijb7,SpATywNh6bZuzm8s1ceuBUnMUAeoAHHw,13,16,11,4,5,0,10,0,46,6.571428571428571,3,0.0,0,11,3,5,16,0,1,10,0,19,27,0
4192,96933,mgC2SKl3BkBHgSzUjS94KW5V0rxosMWt,SpATywNh6bZuzm8s1ceuBUnMUAeoAHHw,13,12,7,13,4,5,3,0,44,6.285714285714286,1,0.0,3,7,11,4,9,5,2,3,0,25,19,0
4193,96976,7pD3XwJqYTfsh0zZ4M07qj3DJAHtjtGm,7GRhBDsirIGkRZBtSMEzNTyDr2JQm4xx,1,0,0,0,0,0,1,0,1,0.14285714285714285,1,0.0,0,0,0,0,0,0,0,1,0,0,1,1
4194,96978,XoAmaAEiCQyqxGtldGa1yHbrXfsnSjbj,7GRhBDsirIGkRZBtSMEzNTyDr2JQm4xx,1,0,0,0,0,0,1,0,1,0.14285714285714285,1,0.0,0,0,0,0,0,0,0,1,0,0,1,1
4195,97014,MSXFOc30HZVbYZtATkSJwT5euFO05BA1,7GRhBDsirIGkRZBtSMEzNTyDr2JQm4xx,6,5,1,0,2,0,3,0,11,1.5714285714285714,1,0.0,3,1,0,2,2,0,0,3,0,6,5,1
4196,97068,XlT7X7Rn0fLTh36Iz42hC1Epd5u3ukUS,7GRhBDsirIGkRZBtSMEzNTyDr2JQm4xx,2,0,0,0,0,0,4,0,4,0.5714285714285714,1,0.0,0,0,0,0,0,0,0,4,0,0,4,1
4197,97102,RJ2AN96oZxuBCR52LgUmQpj4g9Y4mcD4,A3fsA9Zfv1X2fVEQhTw51lKENdNrEqT3,1,0,0,0,0,0,1,0,1,0.14285714285714285,1,0.0,0,0,0,0,0,0,0,1,0,0,1,1
4198,97104,pSX00XUyCx7VlmgWGN0d39OwC9BZ8bRV,7GRhBDsirIGkRZBtSMEzNTyDr2JQm4xx,1,0,0,0,0,0,1,0,1,0.14285714285714285,1,0.0,0,0,0,0,0,0,0,1,0,0,1,0
4199,97143,vcLosQzAVwhadotVELXCMAgXnlN9Qppp,7GRhBDsirIGkRZBtSMEzNTyDr2JQm4xx,12,4,3,0,1,8,7,1,24,3.4285714285714284,1,0.0,0,3,0,1,4,8,0,7,1,4,20,1
4200,97152,JGnVyZ53gH9wjqC3YYjpGEbabkw7ZVhR,A3fsA9Zfv1X2fVEQhTw51lKENdNrEqT3,1,0,0,0,0,0,1,0,1,0.14285714285714285,1,0.0,0,0,0,0,0,0,0,1,0,0,1,1
4201,97165,YE22fRNdaFtk3nhWfjSOMHWERX5O7Ymi,7GRhBDsirIGkRZBtSMEzNTyDr2JQm4xx,28,77,6,42,9,0,12,0,146,20.857142857142858,4,0.0,20,6,38,9,57,0,4,12,0,73,73,1
4202,97184,5DIcniD9kRbDupVPBNugV5by0SZHtD2e,7GRhBDsirIGkRZBtSMEzNTyDr2JQm4xx,1,0,0,0,0,0,1,0,1,0.14285714285714285,1,0.0,0,0,0,0,0,0,0,1,0,0,1,1
4203,97255,Ds7Ql2Fzh0y89y9XQaeLbThJFJ8LYIlx,7GRhBDsirIGkRZBtSMEzNTyDr2JQm4xx,1,0,0,0,0,0,1,0,1,0.14285714285714285,1,0.0,0,0,0,0,0,0,0,1,0,0,1,1
4204,97295,yrlVnbrSR0LAW13A08wi2wUW5yoGSw1G,7GRhBDsirIGkRZBtSMEzNTyDr2JQm4xx,5,6,3,0,0,0,1,0,10,1.4285714285714286,1,0.0,2,3,0,0,4,0,0,1,0,5,5,1
4205,97390,wHh7IyZg69gls07QnvzBvWbwxDpKJO6L,7GRhBDsirIGkRZBtSMEzNTyDr2JQm4xx,4,2,1,0,1,0,1,0,5,0.7142857142857143,1,0.0,0,1,0,1,2,0,0,1,0,2,3,1
4206,97410,TzuMwfaAW66vzYCJbLJUrM2CQWUNVBwC,A3fsA9Zfv1X2fVEQhTw51lKENdNrEqT3,2,0,0,0,0,0,4,0,4,0.5714285714285714,1,0.0,0,0,0,0,0,0,0,4,0,0,4,1
4207,97437,YcAjMEQHzjEkIappgCA5LKxL8wrCHqZx,7GRhBDsirIGkRZBtSMEzNTyDr2JQm4xx,6,3,2,0,2,0,1,0,8,1.1428571428571428,1,0.0,0,2,0,2,3,0,0,1,0,4,4,1
4208,97447,DK4tMY4hv5jCEWYRZnAyqsGRGzDp2xfD,7GRhBDsirIGkRZBtSMEzNTyDr2JQm4xx,7,3,2,0,1,0,4,1,11,1.5714285714285714,1,0.0,0,2,0,1,3,0,0,4,1,3,8,1
4209,97459,gtKTzkXHwS41ljYVmjlLLf4WyQSkK02q,A3fsA9Zfv1X2fVEQhTw51lKENdNrEqT3,1,0,0,0,0,0,1,0,1,0.14285714285714285,1,0.0,0,0,0,0,0,0,0,1,0,0,1,0
4210,97468,LhMGo1H458StfoGsiIJMkiDJEIOqqbKe,7GRhBDsirIGkRZBtSMEzNTyDr2JQm4xx,1,0,0,0,0,0,1,0,1,0.14285714285714285,1,0.0,0,0,0,0,0,0,0,1,0,0,1,1
4211,97476,LDoKVa67JbCj3bIYTGTgWGEVPIBUkRDs,7GRhBDsirIGkRZBtSMEzNTyDr2JQm4xx,1,0,0,0,0,0,1,0,1,0.14285714285714285,1,0.0,0,0,0,0,0,0,0,1,0,0,1,1
4212,97478,9yD6wRS2N3SNxMC2ibpNMzfizxpTbLsY,7GRhBDsirIGkRZBtSMEzNTyDr2JQm4xx,4,2,1,0,1,0,1,0,5,0.7142857142857143,1,0.0,0,1,0,1,2,0,0,1,0,2,3,1
4213,97502,BVpzzXeXh42vyU3wE9rUQpEUs8P1ZpSo,7GRhBDsirIGkRZBtSMEzNTyDr2JQm4xx,33,43,15,96,8,2,12,0,176,25.142857142857142,4,0.0,23,15,88,8,20,2,8,12,0,134,42,1
4214,97578,tJSuuWZXDdoXjZXIctAWwDLD7oHTWJ9T,7GRhBDsirIGkRZBtSMEzNTyDr2JQm4xx,1,0,0,0,0,0,2,0,2,0.2857142857142857,2,0.0,0,0,0,0,0,0,0,2,0,0,2,1
4215,97701,PlRR5bewxY5s5UPrV9qsB2qkDqRzxPQw,7GRhBDsirIGkRZBtSMEzNTyDr2JQm4xx,20,14,7,19,5,0,3,0,48,6.857142857142857,2,0.0,5,7,16,5,9,0,3,3,0,33,15,1
4216,97805,tPYh43YRHAzuf09xESxSKtWvST0aCsjn,7GRhBDsirIGkRZBtSMEzNTyDr2JQm4xx,30,31,10,40,7,0,3,0,91,13.0,2,0.0,19,10,39,7,12,0,1,3,0,75,16,1
4217,97840,Ffohn9JNnGJQD2IavzMTS00ubnVtcb2T,A3fsA9Zfv1X2fVEQhTw51lKENdNrEqT3,69,42,27,166,15,0,15,0,265,37.857142857142854,7,0.0,5,27,135,15,37,0,31,15,0,182,83,0
4218,97846,DwUuHlykLcu2QOJPkMlSk4MpGYyYCYXn,7GRhBDsirIGkRZBtSMEzNTyDr2JQm4xx,4,0,0,0,0,0,4,1,5,0.7142857142857143,1,0.0,0,0,0,0,0,0,0,4,1,0,5,1
4219,98953,lcykm3uj0WkC2rJwnpw8jWVXHYstRrPs,bWdj2GDclj5ofokWjzoa5jAwMkxCykd6,2,0,0,0,0,0,2,0,2,0.2857142857142857,1,0.0,0,0,0,0,0,0,0,2,0,0,2,1
4220,98956,O2hEYcKpW3bz7TyhhkMeHOTvhvdMjulM,bWdj2GDclj5ofokWjzoa5jAwMkxCykd6,5,6,1,0,1,0,1,0,9,1.2857142857142858,1,0.0,0,1,0,1,6,0,0,1,0,2,7,1
4221,98966,oy7Pg8T5wy30VY5zamAkBAwv1iuWjap6,RXDvfPUBYFlVdlueBFbLW0mhhAyGEqpt,11,9,5,0,3,0,3,0,20,2.857142857142857,1,0.0,0,5,0,3,9,0,0,3,0,8,12,1
4222,98978,RbFI9SCNoIyFjKexw9cTU5NZ0thYBnL5,bWdj2GDclj5ofokWjzoa5jAwMkxCykd6,6,2,1,0,1,0,3,0,7,1.0,1,0.0,0,1,0,1,2,0,0,3,0,2,5,1
4223,98994,m30r8XAusN1tKwuw4RNeOZUufFJ19O18,RXDvfPUBYFlVdlueBFbLW0mhhAyGEqpt,1,0,0,0,0,0,1,0,1,0.14285714285714285,1,0.0,0,0,0,0,0,0,0,1,0,0,1,1
4224,98997,514TWhkGGUhLu2MdvTnb8eiBH3DCFHzg,A3fsA9Zfv1X2fVEQhTw51lKENdNrEqT3,10,11,6,0,3,1,3,0,24,3.4285714285714284,3,0.0,0,6,0,3,11,1,0,3,0,9,15,1
4225,99000,JqdbZyx8jQDjvl0RCDBDldcliaXwceyv,bWdj2GDclj5ofokWjzoa5jAwMkxCykd6,8,8,2,0,2,0,2,0,14,2.0,1,0.0,0,2,0,2,8,0,0,2,0,4,10,1
4226,99004,nqSx2YqVg8XBgQNFVkp5HECPuoyoztFf,SpATywNh6bZuzm8s1ceuBUnMUAeoAHHw,1,0,0,0,0,0,1,0,1,0.14285714285714285,1,0.0,0,0,0,0,0,0,0,1,0,0,1,1
4227,99008,udqxlb4h6NzlXvNGaijkJTXRrNX6DSPh,SpATywNh6bZuzm8s1ceuBUnMUAeoAHHw,1,0,0,0,0,0,1,0,1,0.14285714285714285,1,0.0,0,0,0,0,0,0,0,1,0,0,1,1
4228,99015,fe6JA2o6NTgNBdf1OgbAshmKUEnJCT1r,bWdj2GDclj5ofokWjzoa5jAwMkxCykd6,7,15,2,0,2,6,4,1,30,4.285714285714286,2,0.0,8,2,0,2,7,6,0,4,1,12,18,1
4229,99032,Ya8dmcUSDz09ym2vaNemTt41Djt01YaN,SpATywNh6bZuzm8s1ceuBUnMUAeoAHHw,5,5,1,0,1,0,2,0,9,1.2857142857142858,1,0.0,0,1,0,1,5,0,0,2,0,2,7,1
4230,99052,XzLXD7FWHRTDP7XVgC5p2Do9UmUukeQz,SpATywNh6bZuzm8s1ceuBUnMUAeoAHHw,3,3,0,0,0,0,1,0,4,0.5714285714285714,1,0.0,0,0,0,0,3,0,0,1,0,0,4,1
4231,99055,cR6ka5k7tAsfYo9cLOUPkpzWO6OItcGJ,SpATywNh6bZuzm8s1ceuBUnMUAeoAHHw,32,45,28,36,10,23,27,1,170,24.285714285714285,6,0.0,5,28,33,10,40,23,3,27,1,76,94,1
4232,99062,jP3AB3LItmtaoVvn4CaCoqw1w2QWhLKQ,G8EPVSXsOYB5YQWZGiz1aVq5Pgr2GrQu,27,41,0,106,2,1,14,1,165,23.571428571428573,1,0.0,20,0,84,2,21,1,22,14,1,106,59,1
4233,99068,T3sGbyIt0UjiteEMsVXGzcCDHseJZwlW,A3fsA9Zfv1X2fVEQhTw51lKENdNrEqT3,1,0,0,0,0,0,1,0,1,0.14285714285714285,1,0.0,0,0,0,0,0,0,0,1,0,0,1,1
4234,99071,Ein91FWFv0A9qDhWUbZlH2368EmphQmt,SpATywNh6bZuzm8s1ceuBUnMUAeoAHHw,11,10,1,15,0,0,3,0,29,4.142857142857143,1,0.0,5,1,12,0,5,0,3,3,0,18,11,1
4235,99093,XZ82RV9AD9npmDtj5hyoVvxIFU4kzejE,SpATywNh6bZuzm8s1ceuBUnMUAeoAHHw,5,3,1,0,1,0,1,0,6,0.8571428571428571,1,0.0,0,1,0,1,3,0,0,1,0,2,4,1
4236,99105,hCxVGafW6uZuzswuD2GRzZf6ODUAaVFJ,bWdj2GDclj5ofokWjzoa5jAwMkxCykd6,2,0,0,0,0,0,4,0,4,0.5714285714285714,1,0.0,0,0,0,0,0,0,0,4,0,0,4,0
4237,99124,DVOHqEW2vUL1QpZynG6huVjAWwl1vI6M,G8EPVSXsOYB5YQWZGiz1aVq5Pgr2GrQu,27,26,21,56,9,0,6,0,118,16.857142857142858,3,0.0,0,21,42,9,26,0,14,6,0,72,46,1
4238,99128,vGk4gKtQutULkRGPcSts7AdXqOR6DK2Z,RXDvfPUBYFlVdlueBFbLW0mhhAyGEqpt,10,9,7,0,4,0,3,0,23,3.2857142857142856,1,0.0,0,7,0,4,9,0,0,3,0,11,12,1
4239,99131,jVKznnDuZGyXtBgvnWMRtPXsgImk4qlt,SpATywNh6bZuzm8s1ceuBUnMUAeoAHHw,7,4,1,0,1,0,4,0,10,1.4285714285714286,1,0.0,0,1,0,1,4,0,0,4,0,2,8,1
4240,99138,eww5R49fPAYUK2L57nGKDp5FexxMvqZv,bWdj2GDclj5ofokWjzoa5jAwMkxCykd6,7,6,3,0,3,1,10,1,24,3.4285714285714284,1,0.0,2,3,0,3,4,1,0,10,1,8,16,1
4241,99147,1j3W4Jw1KafoLSgTmOItRSa20eh1CtOK,SpATywNh6bZuzm8s1ceuBUnMUAeoAHHw,1,0,0,0,0,0,1,0,1,0.14285714285714285,1,0.0,0,0,0,0,0,0,0,1,0,0,1,1
4242,99165,NojuWwUw3FQaTJhIEuVtN6uUtxeXYBaz,A3fsA9Zfv1X2fVEQhTw51lKENdNrEqT3,1,0,0,0,0,0,1,0,1,0.14285714285714285,1,0.0,0,0,0,0,0,0,0,1,0,0,1,1
4243,99182,N0P6Yrg1zRuUPyVufFpM0ZExnJnGTKKG,bWdj2GDclj5ofokWjzoa5jAwMkxCykd6,16,18,1,52,3,0,5,0,79,11.285714285714286,1,0.0,7,1,45,3,11,0,7,5,0,56,23,1
4244,99193,mS4KVP7r7MB15ORyOGtOcG2IZUAuYo4F,SpATywNh6bZuzm8s1ceuBUnMUAeoAHHw,4,3,1,0,0,0,2,0,6,0.8571428571428571,1,0.0,0,1,0,0,3,0,0,2,0,1,5,1
4245,99198,KUppVPuFnFs0vLCUrPJOIfquMy1mUooq,bWdj2GDclj5ofokWjzoa5jAwMkxCykd6,12,7,4,26,0,0,3,0,40,5.714285714285714,1,0.0,3,4,25,0,4,0,1,3,0,32,8,1
4246,99204,cKCzrCCCXe9nkBgWepq9AEXje7SITRTz,bWdj2GDclj5ofokWjzoa5jAwMkxCykd6,1,0,0,0,0,0,1,0,1,0.14285714285714285,1,0.0,0,0,0,0,0,0,0,1,0,0,1,1
4247,99206,cKCzrCCCXe9nkBgWepq9AEXje7SITRTz,G8EPVSXsOYB5YQWZGiz1aVq5Pgr2GrQu,1,0,0,0,0,0,1,0,1,0.14285714285714285,1,0.0,0,0,0,0,0,0,0,1,0,0,1,1
4248,99214,cKCzrCCCXe9nkBgWepq9AEXje7SITRTz,A3fsA9Zfv1X2fVEQhTw51lKENdNrEqT3,1,0,0,0,0,0,2,0,2,0.2857142857142857,2,0.0,0,0,0,0,0,0,0,2,0,0,2,1
4249,99221,wMqCiRTcG9DrOFV3mIQWVG2TWCqZLDsf,G8EPVSXsOYB5YQWZGiz1aVq5Pgr2GrQu,10,8,5,0,2,44,9,1,69,9.857142857142858,3,0.0,0,5,0,2,8,44,0,9,1,7,62,1
4250,99223,TBKTMcAi6pddCN8hy5SiGUXjC5YxeY5H,SpATywNh6bZuzm8s1ceuBUnMUAeoAHHw,8,2,1,0,1,0,6,0,10,1.4285714285714286,1,0.0,0,1,0,1,2,0,0,6,0,2,8,1
4251,99232,cdtMETRRUGW6e2sQh5Xd2C69HmYkARZ5,SpATywNh6bZuzm8s1ceuBUnMUAeoAHHw,7,6,0,0,0,1,3,0,10,1.4285714285714286,1,0.0,0,0,0,0,6,1,0,3,0,0,10,1
4252,99237,LHfLvP0G4hEksRdVPdjxg85LuBgQzx3S,bWdj2GDclj5ofokWjzoa5jAwMkxCykd6,3,4,1,0,0,0,2,0,7,1.0,1,0.0,2,1,0,0,2,0,0,2,0,3,4,0
4253,99243,T0WYTVwYJgFl0x8drZ3acqWyc5rt9vgS,A3fsA9Zfv1X2fVEQhTw51lKENdNrEqT3,1,0,0,0,0,0,1,0,1,0.14285714285714285,1,0.0,0,0,0,0,0,0,0,1,0,0,1,1
4254,99269,Ft3L9H2tidLSHsWi4FR179aCWB2oFssD,SpATywNh6bZuzm8s1ceuBUnMUAeoAHHw,9,3,2,0,2,0,5,0,12,1.7142857142857142,1,0.0,0,2,0,2,3,0,0,5,0,4,8,1
4255,99280,Zm35PP1kxKgQnBdrsL9FDU6gwqPBncBy,A3fsA9Zfv1X2fVEQhTw51lKENdNrEqT3,1,0,0,0,0,0,2,0,2,0.2857142857142857,1,0.0,0,0,0,0,0,0,0,2,0,0,2,1
4256,99292,KQNAn65G00s1hNhpNIZbIlQjdMIvn0te,G8EPVSXsOYB5YQWZGiz1aVq5Pgr2GrQu,2,0,0,0,0,2,1,0,3,0.42857142857142855,1,0.0,0,0,0,0,0,2,0,1,0,0,3,1
4257,99336,3gXjYz3VFr0TvsDYUgKtksPt5WrPBmEo,SpATywNh6bZuzm8s1ceuBUnMUAeoAHHw,28,56,29,22,9,0,16,0,132,18.857142857142858,8,0.0,12,29,21,9,44,0,1,16,0,71,61,0
4258,99371,7M1gTpajHgYWFRBJBTE3YPlAjNYb9gfx,G8EPVSXsOYB5YQWZGiz1aVq5Pgr2GrQu,1,0,0,0,0,0,1,0,1,0.14285714285714285,1,0.0,0,0,0,0,0,0,0,1,0,0,1,1
4259,99373,hJa6EP3vokxemW59iPrCWIQh0FEzTU7g,SpATywNh6bZuzm8s1ceuBUnMUAeoAHHw,10,11,1,17,1,0,2,0,32,4.571428571428571,1,0.0,6,1,15,1,5,0,2,2,0,23,9,1
4260,99376,aj90O66SXOM5h12FqdZrbSHiEhNvI2bA,SpATywNh6bZuzm8s1ceuBUnMUAeoAHHw,7,3,1,0,1,0,4,0,9,1.2857142857142858,1,0.0,1,1,0,1,2,0,0,4,0,3,6,1
4261,99400,q7MIcgFTiHmr8BKHm7XlaHNh6w8Fx7eG,A3fsA9Zfv1X2fVEQhTw51lKENdNrEqT3,1,0,0,0,0,0,1,0,1,0.14285714285714285,1,0.0,0,0,0,0,0,0,0,1,0,0,1,1
4262,99403,BSIRDTutz8KkNQ3VOx9kKk09R8urb0Ri,A3fsA9Zfv1X2fVEQhTw51lKENdNrEqT3,16,23,10,0,9,2,4,0,48,6.857142857142857,2,0.0,1,10,0,9,22,2,0,4,0,20,28,1
4263,99407,pC4iK2nDWej1Ecj7cZAC5BA8XCgOmZJi,bWdj2GDclj5ofokWjzoa5jAwMkxCykd6,3,0,0,0,0,1,2,0,3,0.42857142857142855,1,0.0,0,0,0,0,0,1,0,2,0,0,3,1
4264,99414,FbLnPRUJ3cO7BepRzJ4PsDHt79T7vpl0,SpATywNh6bZuzm8s1ceuBUnMUAeoAHHw,13,31,10,16,4,10,4,0,75,10.714285714285714,3,0.0,12,10,14,4,19,10,2,4,0,40,35,1
4265,99417,rAtBVPfi6wGHmo9go039lvWtKolaTQH4,SpATywNh6bZuzm8s1ceuBUnMUAeoAHHw,9,15,2,6,0,1,3,0,27,3.857142857142857,2,0.0,2,2,5,0,13,1,1,3,0,9,18,1
4266,99426,Uij5k6d5krJ4mWqsJUOAHKJ3rKlnctQu,A3fsA9Zfv1X2fVEQhTw51lKENdNrEqT3,1,0,0,0,0,0,1,0,1,0.14285714285714285,1,0.0,0,0,0,0,0,0,0,1,0,0,1,1
4267,99448,OLHje3sy9oD0UuSdVmOH9aE7DHL6V9Rf,G8EPVSXsOYB5YQWZGiz1aVq5Pgr2GrQu,2,0,0,0,0,0,3,0,3,0.42857142857142855,1,0.0,0,0,0,0,0,0,0,3,0,0,3,1
4268,99455,FBwWi8qV5T9PVUUQgTFb6EjAi12CMavu,SpATywNh6bZuzm8s1ceuBUnMUAeoAHHw,1,0,0,0,0,0,1,0,1,0.14285714285714285,1,0.0,0,0,0,0,0,0,0,1,0,0,1,1
4269,99464,VFYk1GyeJyGqK1t09cLe0E5m7KsULmvc,SpATywNh6bZuzm8s1ceuBUnMUAeoAHHw,15,32,17,4,9,6,8,1,77,11.0,4,0.0,0,17,3,9,32,6,1,8,1,29,48,1
4270,99470,H1SXscwZbeBIGdJtjznbLlFWKEefKgS4,A3fsA9Zfv1X2fVEQhTw51lKENdNrEqT3,9,7,3,0,3,0,4,0,17,2.4285714285714284,2,0.0,0,3,0,3,7,0,0,4,0,6,11,1
4271,99505,dDLv4oouOmVB45Y4hnRyV7IUqT7tMKiq,bWdj2GDclj5ofokWjzoa5jAwMkxCykd6,5,2,1,0,1,1,3,0,8,1.1428571428571428,1,0.0,0,1,0,1,2,1,0,3,0,2,6,1
4272,99527,4wk7mOQJdY2Tc4re4huOqsVY4BWqzpwG,SpATywNh6bZuzm8s1ceuBUnMUAeoAHHw,6,4,1,0,1,0,2,0,8,1.1428571428571428,1,0.0,0,1,0,1,4,0,0,2,0,2,6,1
4273,99558,qxVdjGWmrHaAXtxLFdUqWOB5LTvLLOy9,SpATywNh6bZuzm8s1ceuBUnMUAeoAHHw,13,15,1,3,0,8,7,0,34,4.857142857142857,1,0.0,6,1,3,0,9,8,0,7,0,10,24,1
4274,99566,WpcBrbawQCY5l6KXuhzbDIXB3ksftawE,SpATywNh6bZuzm8s1ceuBUnMUAeoAHHw,9,15,0,8,0,0,1,0,24,3.4285714285714284,1,0.0,10,0,8,0,5,0,0,1,0,18,6,1
4275,99568,oRL4hbvIrWhhsMx6uS8zWxFrJBWT9qS8,SpATywNh6bZuzm8s1ceuBUnMUAeoAHHw,8,2,1,0,1,1,6,1,12,1.7142857142857142,1,0.0,0,1,0,1,2,1,0,6,1,2,10,1
4276,99583,qe1lbudcDc26TUDIjWwsWCMadyJdvBEX,G8EPVSXsOYB5YQWZGiz1aVq5Pgr2GrQu,4,2,1,0,1,0,1,0,5,0.7142857142857143,1,0.0,0,1,0,1,2,0,0,1,0,2,3,1
4277,99663,9jzVaD1WPdcDwGhb2eIEjRQirdvM6f1C,bWdj2GDclj5ofokWjzoa5jAwMkxCykd6,1,0,0,0,0,0,1,0,1,0.14285714285714285,1,0.0,0,0,0,0,0,0,0,1,0,0,1,1
4278,99677,IL1F6pxCqZ5QZxZqthAXWrxFzw6RlKfD,SpATywNh6bZuzm8s1ceuBUnMUAeoAHHw,4,2,1,0,1,0,1,0,5,0.7142857142857143,1,0.0,0,1,0,1,2,0,0,1,0,2,3,1
4279,99682,MKYE6pEwq1YWgBTN9g77yl7jNJ14fFVC,SpATywNh6bZuzm8s1ceuBUnMUAeoAHHw,13,9,0,15,0,4,7,1,36,5.142857142857143,2,0.0,2,0,13,0,7,4,2,7,1,15,21,1
4280,99697,nGESIoGySD5XO5mI6jFhqZA6YIAniYb4,SpATywNh6bZuzm8s1ceuBUnMUAeoAHHw,5,2,0,0,0,0,3,1,6,0.8571428571428571,1,0.0,0,0,0,0,2,0,0,3,1,0,6,1
4281,99707,xg8dkQPzve0MzcpgxvEsbKyY4VwKrxAC,bWdj2GDclj5ofokWjzoa5jAwMkxCykd6,2,0,0,0,0,0,2,0,2,0.2857142857142857,1,0.0,0,0,0,0,0,0,0,2,0,0,2,1
4282,99721,i4u0VWs6ASAfOx6UbgpWUmxBkJHoZ0lf,SpATywNh6bZuzm8s1ceuBUnMUAeoAHHw,11,29,1,8,0,6,7,0,51,7.285714285714286,2,0.0,2,1,7,0,27,6,1,7,0,10,41,1
4283,99722,F5WXvUA8z1Vfdvlva1pujweut7tGE04r,A3fsA9Zfv1X2fVEQhTw51lKENdNrEqT3,6,3,1,0,0,2,4,1,11,1.5714285714285714,2,0.0,0,1,0,0,3,2,0,4,1,1,10,1
4284,99746,wfbRnjTCW6bqPFwlexPPeehj3HWJM2LV,SpATywNh6bZuzm8s1ceuBUnMUAeoAHHw,6,5,1,0,0,2,3,1,12,1.7142857142857142,1,0.0,0,1,0,0,5,2,0,3,1,1,11,1
4285,99776,s1C9M00kZ3td5Y1QHJpo6evzlHG7Bu17,A3fsA9Zfv1X2fVEQhTw51lKENdNrEqT3,1,0,0,0,0,0,1,0,1,0.14285714285714285,1,0.0,0,0,0,0,0,0,0,1,0,0,1,1
4286,99777,1umo7etGwkx7NcpFxVialzDD37NdyqRT,SpATywNh6bZuzm8s1ceuBUnMUAeoAHHw,14,23,9,12,4,1,4,0,53,7.571428571428571,3,0.0,11,9,12,4,12,1,0,4,0,36,17,0
4287,99801,Z4v9dtdXvLGvBdUbEHKilzESZFJ5MomJ,A3fsA9Zfv1X2fVEQhTw51lKENdNrEqT3,1,0,0,0,0,0,1,0,1,0.14285714285714285,1,0.0,0,0,0,0,0,0,0,1,0,0,1,1
4288,99803,wRn9VzYdznEJJbl33573ksufDlNbloBs,SpATywNh6bZuzm8s1ceuBUnMUAeoAHHw,1,0,0,0,0,0,1,0,1,0.14285714285714285,1,0.0,0,0,0,0,0,0,0,1,0,0,1,1
4289,99820,FW9yCFN4uGknAcdu3E5QkbxhIgnspzES,bWdj2GDclj5ofokWjzoa5jAwMkxCykd6,1,0,0,0,0,0,1,0,1,0.14285714285714285,1,0.0,0,0,0,0,0,0,0,1,0,0,1,1
4290,99830,l0hVKXTPSdIHJhYbRQF17YM8eZTkWoXS,SpATywNh6bZuzm8s1ceuBUnMUAeoAHHw,3,2,0,0,0,0,2,0,4,0.5714285714285714,1,0.0,0,0,0,0,2,0,0,2,0,0,4,1
4291,99841,l0hVKXTPSdIHJhYbRQF17YM8eZTkWoXS,bWdj2GDclj5ofokWjzoa5jAwMkxCykd6,1,0,0,0,0,0,1,0,1,0.14285714285714285,1,0.0,0,0,0,0,0,0,0,1,0,0,1,1
4292,99845,neKK2ykNimyF7kqeZQOYIIEzgIv0MPcH,RXDvfPUBYFlVdlueBFbLW0mhhAyGEqpt,5,2,1,0,1,0,2,0,6,0.8571428571428571,1,0.0,0,1,0,1,2,0,0,2,0,2,4,1
4293,99854,FQLZyFqiWjNudHf8Xwrwvb0mFmqAZa3g,SpATywNh6bZuzm8s1ceuBUnMUAeoAHHw,1,0,0,0,0,0,1,0,1,0.14285714285714285,1,0.0,0,0,0,0,0,0,0,1,0,0,1,1
4294,99860,Q8SrRVeWzJizOf34g4fWFcHi3GfFJHUN,SpATywNh6bZuzm8s1ceuBUnMUAeoAHHw,23,37,19,20,8,2,10,1,97,13.857142857142858,3,0.0,8,19,17,8,29,2,3,10,1,52,45,1
4295,99868,Qu1AvUJr7Rf2PLTyoAjhLhIJ5dIRQjGn,SpATywNh6bZuzm8s1ceuBUnMUAeoAHHw,8,7,6,0,2,0,2,0,17,2.4285714285714284,1,0.0,0,6,0,2,7,0,0,2,0,8,9,1
4296,99897,Qd7FMxYi2RP0CzetZmwspMbrYY8Z7160,G8EPVSXsOYB5YQWZGiz1aVq5Pgr2GrQu,2,0,0,0,0,0,2,0,2,0.2857142857142857,1,0.0,0,0,0,0,0,0,0,2,0,0,2,1
4297,99912,MW4oBOQoe8OTcAvm3yfi1VDCozBvyTdm,G8EPVSXsOYB5YQWZGiz1aVq5Pgr2GrQu,1,0,0,0,0,0,1,0,1,0.14285714285714285,1,0.0,0,0,0,0,0,0,0,1,0,0,1,1
4298,99931,T0V1MC6bsX3mZxJfTJfqpva6BwB6iZOI,RXDvfPUBYFlVdlueBFbLW0mhhAyGEqpt,4,0,0,0,0,0,3,1,4,0.5714285714285714,1,0.0,0,0,0,0,0,0,0,3,1,0,4,1
4299,99966,cUJIvx4QB7gYkEkbk184VKn3Y3N8dBd7,RXDvfPUBYFlVdlueBFbLW0mhhAyGEqpt,1,0,0,0,0,0,1,0,1,0.14285714285714285,1,0.0,0,0,0,0,0,0,0,1,0,0,1,1
4300,99979,oUNptzxKR6Tg3LMdUCW3RAFgD2fbf3ju,G8EPVSXsOYB5YQWZGiz1aVq5Pgr2GrQu,1,0,0,0,0,0,1,0,1,0.14285714285714285,1,0.0,0,0,0,0,0,0,0,1,0,0,1,1
4301,99981,irIVLRvkXyea4TMdg5wZQ17APoQLOStn,bWdj2GDclj5ofokWjzoa5jAwMkxCykd6,3,2,0,0,0,0,1,0,3,0.42857142857142855,1,0.0,0,0,0,0,2,0,0,1,0,0,3,1
4302,100046,uqIn0vdfJ1SDJCOeCVEAQPRFBBKQA2eB,RXDvfPUBYFlVdlueBFbLW0mhhAyGEqpt,1,0,0,0,0,0,1,0,1,0.14285714285714285,1,0.0,0,0,0,0,0,0,0,1,0,0,1,1
4303,100048,ZmILkESSKwaUf7dlv2MYezsPM9kEgn0g,SpATywNh6bZuzm8s1ceuBUnMUAeoAHHw,1,0,0,0,0,0,1,0,1,0.14285714285714285,1,0.0,0,0,0,0,0,0,0,1,0,0,1,1
4304,100065,C79HFTpOf1aC6aMRuXhus1qHumhqEAFk,SpATywNh6bZuzm8s1ceuBUnMUAeoAHHw,15,18,1,20,1,5,12,1,58,8.285714285714286,2,0.0,6,1,16,1,12,5,4,12,1,24,34,0
4305,100089,9MPGQ80LKMiZcqzI4e7ZT4LxgluBoFal,SpATywNh6bZuzm8s1ceuBUnMUAeoAHHw,12,14,2,0,1,0,6,2,25,3.5714285714285716,1,0.0,4,2,0,1,10,0,0,6,2,7,18,1
4306,100105,MKNBl3hhuuRZuBxyPOWBVV1OHzyXBuxg,SpATywNh6bZuzm8s1ceuBUnMUAeoAHHw,13,14,7,18,3,2,2,0,46,6.571428571428571,1,0.0,3,7,16,3,11,2,2,2,0,29,17,0
4307,100136,zhtf7EZUjW6s3Guz5lXD8KDXJ4lw9cuB,RXDvfPUBYFlVdlueBFbLW0mhhAyGEqpt,18,11,6,31,6,0,4,0,58,8.285714285714286,2,0.0,4,6,29,6,7,0,2,4,0,45,13,1
4308,100176,pfwNUWwL0srYZTJGvtMmP5xqlr01qeDv,bWdj2GDclj5ofokWjzoa5jAwMkxCykd6,4,2,0,0,0,0,9,0,11,1.5714285714285714,2,0.0,0,0,0,0,2,0,0,9,0,0,11,1
4309,100177,CD5yEeFA8Zn4o0HC0sLfKl1HGxKwer5w,A3fsA9Zfv1X2fVEQhTw51lKENdNrEqT3,1,0,0,0,0,0,2,0,2,0.2857142857142857,1,0.0,0,0,0,0,0,0,0,2,0,0,2,1
4310,100200,walE7JsvJqHl8yLz0PR8Oim32Lz4OIQ0,SpATywNh6bZuzm8s1ceuBUnMUAeoAHHw,14,17,0,14,0,20,20,1,72,10.285714285714286,2,0.0,8,0,13,0,9,20,1,20,1,21,51,1
4311,100208,oakvvUa4BMx0VOuNxMNhZr6bo8hbB626,SpATywNh6bZuzm8s1ceuBUnMUAeoAHHw,4,0,0,0,0,0,4,0,4,0.5714285714285714,1,0.0,0,0,0,0,0,0,0,4,0,0,4,1
4312,100216,iukICc3JPXkGjh0WhluWsphhopQF3KWw,SpATywNh6bZuzm8s1ceuBUnMUAeoAHHw,8,8,4,0,0,0,5,0,17,2.4285714285714284,1,0.0,0,4,0,0,8,0,0,5,0,4,13,1
4313,100243,CyLrnwOuvkEKQhwjogaYhZvzxTeqKBge,A3fsA9Zfv1X2fVEQhTw51lKENdNrEqT3,1,0,0,0,0,0,1,0,1,0.14285714285714285,1,0.0,0,0,0,0,0,0,0,1,0,0,1,1
4314,100244,3jzy20tHqZfBlzIZRWQh7hEsGbNNyC02,SpATywNh6bZuzm8s1ceuBUnMUAeoAHHw,5,2,1,0,1,0,2,0,6,0.8571428571428571,1,0.0,0,1,0,1,2,0,0,2,0,2,4,1
4315,100249,XyoP35cBUiKk44G72mbtEXCBjk8FmHfo,SpATywNh6bZuzm8s1ceuBUnMUAeoAHHw,15,12,6,18,3,3,5,0,47,6.714285714285714,2,0.0,2,6,14,3,10,3,4,5,0,25,22,1
4316,100257,8IdCnPo0KQab6PkHRu5Y6zvRlgGVQPUd,RXDvfPUBYFlVdlueBFbLW0mhhAyGEqpt,21,100,22,0,17,0,8,0,147,21.0,3,0.0,7,22,0,17,93,0,0,8,0,46,101,1
4317,100265,McYATdhZDDMDpni6a4GbjI06ustMpvdV,SpATywNh6bZuzm8s1ceuBUnMUAeoAHHw,3,0,0,0,0,1,2,0,3,0.42857142857142855,2,0.0,0,0,0,0,0,1,0,2,0,0,3,1
4318,100266,n2r6kyDnsWpbtliBFHcr0YWSTfVt0HhQ,G8EPVSXsOYB5YQWZGiz1aVq5Pgr2GrQu,17,18,1,12,1,1,5,1,39,5.571428571428571,2,0.0,8,1,6,1,10,1,6,5,1,16,23,1
4319,100294,G7KJV0aUuu9N2GhQ0BQmtfVIkYBSsISM,SpATywNh6bZuzm8s1ceuBUnMUAeoAHHw,13,54,25,16,16,2,7,0,120,17.142857142857142,2,0.0,4,25,15,16,50,2,1,7,0,60,60,1
4320,100360,09033btLbIofAoxmgr9GoACTYHCpwfe7,SpATywNh6bZuzm8s1ceuBUnMUAeoAHHw,5,3,1,0,1,0,1,0,6,0.8571428571428571,1,0.0,0,1,0,1,3,0,0,1,0,2,4,1
4321,100375,FMxvsapRPXXXNxGG3GDsHR7zl4E2ofKu,A3fsA9Zfv1X2fVEQhTw51lKENdNrEqT3,1,0,0,0,0,0,2,0,2,0.2857142857142857,1,0.0,0,0,0,0,0,0,0,2,0,0,2,1
4322,100382,dDpqWlhYBkdNBy4JfnDE71OkEoQKGKDx,bWdj2GDclj5ofokWjzoa5jAwMkxCykd6,10,6,3,4,3,0,4,0,20,2.857142857142857,1,0.0,2,3,4,3,4,0,0,4,0,12,8,0
4323,100389,Q9YOU7BuWjkOYwh9pr1oIgYKYXPPRz5K,RXDvfPUBYFlVdlueBFbLW0mhhAyGEqpt,44,42,24,98,15,2,6,0,187,26.714285714285715,6,0.0,12,24,91,15,30,2,7,6,0,142,45,0
4324,100462,MRV5bQ8CaXcdaRHJL4krm33UMDJEAYUq,SpATywNh6bZuzm8s1ceuBUnMUAeoAHHw,1,0,0,0,0,0,1,0,1,0.14285714285714285,1,0.0,0,0,0,0,0,0,0,1,0,0,1,1
4325,100518,6DFg8IrvITdyV3FmRQrzgnl2oAgir5Pb,SpATywNh6bZuzm8s1ceuBUnMUAeoAHHw,28,43,12,24,6,13,18,1,117,16.714285714285715,3,0.0,8,12,21,6,35,13,3,18,1,47,70,0
4326,100563,IVE4TocWI6FDY4RoOKamDYCfOcH2PbRL,SpATywNh6bZuzm8s1ceuBUnMUAeoAHHw,12,26,0,15,0,25,5,0,71,10.142857142857142,1,0.0,18,0,15,0,8,25,0,5,0,33,38,1
4327,100566,O9Ff0eipZjXCZhuBVdpYtN4eMe1OZ5wo,SpATywNh6bZuzm8s1ceuBUnMUAeoAHHw,5,3,1,0,1,0,2,0,7,1.0,1,0.0,0,1,0,1,3,0,0,2,0,2,5,1
4328,100567,Is7lqncTs1EDN9QmzrTbcU6KnB0BCGNX,SpATywNh6bZuzm8s1ceuBUnMUAeoAHHw,11,11,5,0,3,1,9,1,30,4.285714285714286,2,0.0,3,5,0,3,8,1,0,9,1,11,19,1
4329,100592,1W42KMSdpCt6ldPd7y6qVJ23jr8xz7L8,SpATywNh6bZuzm8s1ceuBUnMUAeoAHHw,5,3,1,0,1,0,2,0,7,1.0,1,0.0,1,1,0,1,2,0,0,2,0,3,4,1
4330,100595,MdGTO2svRwIj7bz3FYKLlYB5eW0NcpSb,SpATywNh6bZuzm8s1ceuBUnMUAeoAHHw,16,17,7,20,4,0,5,1,54,7.714285714285714,1,0.0,5,7,16,4,12,0,4,5,1,32,22,0
4331,100611,qrBxOx4xvfJbTRNtYXFo4mMHRch3LE9R,A3fsA9Zfv1X2fVEQhTw51lKENdNrEqT3,1,0,0,0,0,0,1,0,1,0.14285714285714285,1,0.0,0,0,0,0,0,0,0,1,0,0,1,1
4332,100640,NfAbLg5OeUTUtF15GhHCETvzoFPtTDPd,SpATywNh6bZuzm8s1ceuBUnMUAeoAHHw,20,29,3,30,0,25,18,0,105,15.0,3,0.0,7,3,28,0,22,25,2,18,0,38,67,1
4333,100662,DfabbQQ3v42eWYnRYIQLMUYykm14gtcZ,A3fsA9Zfv1X2fVEQhTw51lKENdNrEqT3,1,0,0,0,0,0,1,0,1,0.14285714285714285,1,0.0,0,0,0,0,0,0,0,1,0,0,1,1
4334,100670,RApdsmrncG4ay8F6bpKxBswTJBXZ7CEo,SpATywNh6bZuzm8s1ceuBUnMUAeoAHHw,11,7,6,0,9,0,27,0,49,7.0,3,0.0,0,6,0,9,7,0,0,27,0,15,34,1
4335,100686,sFr2RCMewYMYiXOoTtSwzbAYMNnrzmY5,SpATywNh6bZuzm8s1ceuBUnMUAeoAHHw,9,3,3,0,2,0,3,0,11,1.5714285714285714,1,0.0,0,3,0,2,3,0,0,3,0,5,6,1
4336,100711,dGI6yveNenjFfT8c0PjNzk1ugu0VsvkU,SpATywNh6bZuzm8s1ceuBUnMUAeoAHHw,10,6,3,0,3,0,4,1,17,2.4285714285714284,1,0.0,1,3,0,3,5,0,0,4,1,7,10,1
4337,100731,vt827MYpYgT0JKXBC62SZ24Gxa8OJ87k,SpATywNh6bZuzm8s1ceuBUnMUAeoAHHw,4,3,0,0,0,0,2,0,5,0.7142857142857143,1,0.0,0,0,0,0,3,0,0,2,0,0,5,1
4338,100736,uJVJyY1XUciqhggpcXtgNPSVAHeYLBGB,G8EPVSXsOYB5YQWZGiz1aVq5Pgr2GrQu,9,14,4,0,0,0,4,0,22,3.142857142857143,2,0.0,0,4,0,0,14,0,0,4,0,4,18,1
4339,100740,MFMS4D6VcY65iaLs08cZFKnb6UYd2dkX,SpATywNh6bZuzm8s1ceuBUnMUAeoAHHw,1,0,0,0,0,0,1,0,1,0.14285714285714285,1,0.0,0,0,0,0,0,0,0,1,0,0,1,1
4340,100744,tMihxLso3qJJt2vQUNT2SznMjAGohiuT,SpATywNh6bZuzm8s1ceuBUnMUAeoAHHw,7,3,1,0,1,1,5,1,12,1.7142857142857142,1,0.0,0,1,0,1,3,1,0,5,1,2,10,1
4341,100749,1AsQo0zAkltKFUhbJK8sQo8EMtQlw4Zw,A3fsA9Zfv1X2fVEQhTw51lKENdNrEqT3,9,8,5,0,2,2,6,0,23,3.2857142857142856,4,0.0,0,5,0,2,8,2,0,6,0,7,16,1
4342,100754,UOjfyFlJmFc3i5kjWKRuDpWzrJIEqMHc,SpATywNh6bZuzm8s1ceuBUnMUAeoAHHw,2,0,0,0,0,0,2,0,2,0.2857142857142857,1,0.0,0,0,0,0,0,0,0,2,0,0,2,1
4343,100769,pjSCT01VrN3yLmICdcrZWQnnyzvIOi9x,SpATywNh6bZuzm8s1ceuBUnMUAeoAHHw,1,0,0,0,0,0,1,0,1,0.14285714285714285,1,0.0,0,0,0,0,0,0,0,1,0,0,1,1
4344,100794,Qj3zkBoKOajqBdArgJNrQ3sw89X3j0VX,SpATywNh6bZuzm8s1ceuBUnMUAeoAHHw,6,2,1,0,1,0,4,0,8,1.1428571428571428,1,0.0,0,1,0,1,2,0,0,4,0,2,6,1
4345,100859,xRb4cp7PVGLqlqc7BJgnld2XsE0F6wB3,SpATywNh6bZuzm8s1ceuBUnMUAeoAHHw,16,26,9,13,1,0,7,1,57,8.142857142857142,3,0.0,9,9,12,1,17,0,1,7,1,31,26,0
4346,100860,KFG6G55toGAeaWBt5UmyioW5n1NVxSjT,A3fsA9Zfv1X2fVEQhTw51lKENdNrEqT3,1,0,0,0,0,0,1,0,1,0.14285714285714285,1,0.0,0,0,0,0,0,0,0,1,0,0,1,1
4347,100863,VOKNou0BOm9l4CocxGjdRfkeAbtz86uT,SpATywNh6bZuzm8s1ceuBUnMUAeoAHHw,7,4,1,0,0,9,5,2,21,3.0,1,0.0,1,1,0,0,3,9,0,5,2,2,19,1
4348,100872,ES4n41HdZ3mzmajBMbCDY4C23oBD6LSY,RXDvfPUBYFlVdlueBFbLW0mhhAyGEqpt,9,7,5,0,2,0,3,0,17,2.4285714285714284,1,0.0,0,5,0,2,7,0,0,3,0,7,10,1
4349,100885,GpdW10m4i4o8zebocaIwKcYTi9ALrnVK,SpATywNh6bZuzm8s1ceuBUnMUAeoAHHw,1,0,0,0,0,0,2,0,2,0.2857142857142857,1,0.0,0,0,0,0,0,0,0,2,0,0,2,1
4350,100901,3ZkHeNhSscgbNC1k9L8lbe6SROwSZPLx,SpATywNh6bZuzm8s1ceuBUnMUAeoAHHw,4,0,0,0,0,1,8,0,9,1.2857142857142858,1,0.0,0,0,0,0,0,1,0,8,0,0,9,1
4351,100936,QAQOQC9orxaSCK47wTUjk6OT4uXNA4IV,RXDvfPUBYFlVdlueBFbLW0mhhAyGEqpt,1,0,0,0,0,0,1,0,1,0.14285714285714285,1,0.0,0,0,0,0,0,0,0,1,0,0,1,1
4352,100939,QJcScxtP8sOhNP5cvZ8cp3A76mQqjuPz,SpATywNh6bZuzm8s1ceuBUnMUAeoAHHw,5,2,1,0,1,0,2,0,6,0.8571428571428571,1,0.0,0,1,0,1,2,0,0,2,0,2,4,1
4353,100951,dpzYaESA6MCFHXGYe2bLHvSr1kNOP50p,SpATywNh6bZuzm8s1ceuBUnMUAeoAHHw,1,0,0,0,0,0,1,0,1,0.14285714285714285,1,0.0,0,0,0,0,0,0,0,1,0,0,1,1
4354,100967,pdDWSL0qqW5lqoVLDvyIeqmUWuTqLvQ6,bWdj2GDclj5ofokWjzoa5jAwMkxCykd6,2,0,0,0,0,0,2,0,2,0.2857142857142857,1,0.0,0,0,0,0,0,0,0,2,0,0,2,1
4355,100982,1QJEJ5a9sT1rwzf5IhaKshE565OOWiB4,G8EPVSXsOYB5YQWZGiz1aVq5Pgr2GrQu,6,5,2,0,2,0,1,0,10,1.4285714285714286,1,0.0,0,2,0,2,5,0,0,1,0,4,6,1
4356,100989,MaNbEqxyOcaRJ63ZfC9DudJtV0A5y3yK,SpATywNh6bZuzm8s1ceuBUnMUAeoAHHw,16,16,5,25,3,6,5,1,61,8.714285714285714,1,0.0,6,5,20,3,10,6,5,5,1,34,27,0
4357,100992,pdDWSL0qqW5lqoVLDvyIeqmUWuTqLvQ6,A3fsA9Zfv1X2fVEQhTw51lKENdNrEqT3,1,0,0,0,0,0,1,0,1,0.14285714285714285,1,0.0,0,0,0,0,0,0,0,1,0,0,1,1
4358,101003,XPA1Jv5NXHfUcU7CMUA4EKvCqSxl1bO3,RXDvfPUBYFlVdlueBFbLW0mhhAyGEqpt,1,0,0,0,0,0,1,0,1,0.14285714285714285,1,0.0,0,0,0,0,0,0,0,1,0,0,1,1
4359,101033,eWW5LWmp2L4jfpnZTKTrpHZw2NPytGoT,G8EPVSXsOYB5YQWZGiz1aVq5Pgr2GrQu,2,0,0,0,0,0,2,0,2,0.2857142857142857,1,0.0,0,0,0,0,0,0,0,2,0,0,2,1
4360,101041,R5b8KqsMsDfKAxdLfUK6LRx0WUFDD5Xb,bWdj2GDclj5ofokWjzoa5jAwMkxCykd6,10,19,0,10,0,3,4,1,37,5.285714285714286,2,0.0,5,0,9,0,14,3,1,4,1,14,23,1
4361,101044,0MInlyhRLhTct7ctvAmGIMuZ2WCCEQOJ,bWdj2GDclj5ofokWjzoa5jAwMkxCykd6,1,0,0,0,0,0,1,0,1,0.14285714285714285,1,0.0,0,0,0,0,0,0,0,1,0,0,1,1
4362,101045,PCtqctDcjJHl3GW7yk0aug87eqbAmlqT,SpATywNh6bZuzm8s1ceuBUnMUAeoAHHw,22,26,3,32,1,0,8,0,70,10.0,2,0.0,4,3,28,1,22,0,4,8,0,36,34,1
4363,101047,MhrFHIexWYn2dilUXh03cpnfpoe9tMBe,bWdj2GDclj5ofokWjzoa5jAwMkxCykd6,1,0,0,0,0,0,1,0,1,0.14285714285714285,1,0.0,0,0,0,0,0,0,0,1,0,0,1,1
4364,101059,H4F1BzGEbgWgPoxlFORCSmUf8fAP6V7l,RXDvfPUBYFlVdlueBFbLW0mhhAyGEqpt,13,12,4,6,1,0,7,0,30,4.285714285714286,2,0.0,2,4,6,1,10,0,0,7,0,13,17,1
4365,101074,D9nQsPz9172rPurdQOY1oS88oPJMaAUd,bWdj2GDclj5ofokWjzoa5jAwMkxCykd6,13,40,1,26,2,19,14,0,102,14.571428571428571,3,0.0,7,1,21,2,33,19,5,14,0,31,71,1
4366,101091,NbOkuaMYNn1DiAgigOMCG3fDUQt3bFUa,SpATywNh6bZuzm8s1ceuBUnMUAeoAHHw,13,42,14,13,0,33,13,1,116,16.571428571428573,3,0.0,21,14,13,0,21,33,0,13,1,48,68,1
4367,101098,Jxd0Gyi2eFjuuzujg1eSA5QBX1QonMfb,bWdj2GDclj5ofokWjzoa5jAwMkxCykd6,11,12,10,0,7,0,8,3,40,5.714285714285714,2,0.0,0,10,0,7,12,0,0,8,3,17,23,1
4368,101103,KxUegLpOtUB19LVwgBAOjYKSbicZaJLZ,SpATywNh6bZuzm8s1ceuBUnMUAeoAHHw,5,15,1,0,0,0,4,0,20,2.857142857142857,4,0.0,0,1,0,0,15,0,0,4,0,1,19,0
4369,101112,wnkgyfR4roxhmJZsqCCxH9EfyI2qd5YM,SpATywNh6bZuzm8s1ceuBUnMUAeoAHHw,5,3,2,0,2,0,3,0,10,1.4285714285714286,2,0.0,0,2,0,2,3,0,0,3,0,4,6,1
4370,101122,B0jVKFlvXfKwVR9pXnhJZcf2VbxqeEJP,RXDvfPUBYFlVdlueBFbLW0mhhAyGEqpt,7,3,2,0,2,0,2,0,9,1.2857142857142858,2,0.0,0,2,0,2,3,0,0,2,0,4,5,1
4371,101125,B0jVKFlvXfKwVR9pXnhJZcf2VbxqeEJP,A3fsA9Zfv1X2fVEQhTw51lKENdNrEqT3,1,0,0,0,0,0,1,0,1,0.14285714285714285,1,0.0,0,0,0,0,0,0,0,1,0,0,1,1
4372,101130,4TBbHxtdM6KlXwrDZvHlXfXL45mqy6bL,SpATywNh6bZuzm8s1ceuBUnMUAeoAHHw,13,38,10,0,2,0,12,0,62,8.857142857142858,5,0.0,1,10,0,2,37,0,0,12,0,13,49,1
4373,101137,nnpMilWm5u9YfSzlEw0i8QiLM3F4GePR,G8EPVSXsOYB5YQWZGiz1aVq5Pgr2GrQu,7,1,1,0,1,2,5,1,11,1.5714285714285714,1,0.0,0,1,0,1,1,2,0,5,1,2,9,1
4374,101141,2qEZpMTxWlr35xXuNBb8vvZZiY1soKKq,SpATywNh6bZuzm8s1ceuBUnMUAeoAHHw,5,5,0,0,0,0,4,0,9,1.2857142857142858,1,0.0,0,0,0,0,5,0,0,4,0,0,9,1
4375,101154,fnJf5uFFfrA3RuutRVGe8qQuGwat3ZCQ,SpATywNh6bZuzm8s1ceuBUnMUAeoAHHw,1,0,0,0,0,0,1,0,1,0.14285714285714285,1,0.0,0,0,0,0,0,0,0,1,0,0,1,1
4376,101186,gtKTzkXHwS41ljYVmjlLLf4WyQSkK02q,bWdj2GDclj5ofokWjzoa5jAwMkxCykd6,2,0,0,0,0,0,2,0,2,0.2857142857142857,1,0.0,0,0,0,0,0,0,0,2,0,0,2,1
4377,101189,yrhXE3OyNatOr3jElQ1DJhAKv2cy7Hqx,SpATywNh6bZuzm8s1ceuBUnMUAeoAHHw,1,0,0,0,0,0,1,0,1,0.14285714285714285,1,0.0,0,0,0,0,0,0,0,1,0,0,1,1
4378,101191,yrlVnbrSR0LAW13A08wi2wUW5yoGSw1G,bWdj2GDclj5ofokWjzoa5jAwMkxCykd6,1,0,0,0,0,0,1,0,1,0.14285714285714285,1,0.0,0,0,0,0,0,0,0,1,0,0,1,1
4379,101198,OCAzb1VfLGBRFoguhxZLxVaO4EgntnGi,A3fsA9Zfv1X2fVEQhTw51lKENdNrEqT3,15,11,8,0,6,4,14,1,44,6.285714285714286,2,0.0,0,8,0,6,11,4,0,14,1,14,30,1
4380,101201,YewrI0crAA2lhm09K28QZKb66KLxgFIr,SpATywNh6bZuzm8s1ceuBUnMUAeoAHHw,5,2,1,0,1,0,2,0,6,0.8571428571428571,1,0.0,0,1,0,1,2,0,0,2,0,2,4,1
4381,101219,NIlxh2g7VTAquieuVc9RGErPkOzbSh2Z,A3fsA9Zfv1X2fVEQhTw51lKENdNrEqT3,1,0,0,0,0,0,1,0,1,0.14285714285714285,1,0.0,0,0,0,0,0,0,0,1,0,0,1,1
4382,101223,MwRVXLIjs7ObnboXYRMgXHQa3UWpN5i5,SpATywNh6bZuzm8s1ceuBUnMUAeoAHHw,16,18,13,0,5,0,4,0,40,5.714285714285714,3,0.0,0,13,0,5,18,0,0,4,0,18,22,1
4383,101248,9FCTgAxdOH7TtkaWvHpzLeDt6G1gJ5Bo,bWdj2GDclj5ofokWjzoa5jAwMkxCykd6,14,8,4,20,4,0,8,0,44,6.285714285714286,1,0.0,3,4,19,4,5,0,1,8,0,30,14,1
4384,101259,lgjOCnqMh3jm1TNv306EqOQLtLVGnS97,SpATywNh6bZuzm8s1ceuBUnMUAeoAHHw,4,2,0,0,0,2,2,0,6,0.8571428571428571,1,0.0,0,0,0,0,2,2,0,2,0,0,6,1
4385,102824,WmG8kTcU8MK2hNkFFl9oxdCyXNm8K8Ej,7GRhBDsirIGkRZBtSMEzNTyDr2JQm4xx,1,0,0,0,0,0,1,0,1,0.14285714285714285,1,0.0,0,0,0,0,0,0,0,1,0,0,1,1
4386,102932,0zaZMwzUlPvudODMBJsoUQT9Stnqz6b0,SpATywNh6bZuzm8s1ceuBUnMUAeoAHHw,4,2,1,0,1,2,3,0,9,1.2857142857142858,1,0.0,0,1,0,1,2,2,0,3,0,2,7,1
4387,103011,A3hbg0sRzJCuZelHR2utUpF4kEQMHGoX,A3fsA9Zfv1X2fVEQhTw51lKENdNrEqT3,2,0,0,0,0,0,6,0,6,0.8571428571428571,2,0.0,0,0,0,0,0,0,0,6,0,0,6,1
4388,103131,KKoJVU8RPVKYX0YtUEw7IyEbFA7WdrnE,SpATywNh6bZuzm8s1ceuBUnMUAeoAHHw,27,29,10,40,6,0,6,0,91,13.0,2,0.0,10,10,34,6,19,0,6,6,0,60,31,0
4389,103133,pmbdGuMJDBIMvlssCxECy27GzvD3oiIB,SpATywNh6bZuzm8s1ceuBUnMUAeoAHHw,4,2,1,0,1,0,1,0,5,0.7142857142857143,1,0.0,0,1,0,1,2,0,0,1,0,2,3,1
4390,103220,8c2gk77rfHeG4kEZpifVHT547X2ayTNE,A3fsA9Zfv1X2fVEQhTw51lKENdNrEqT3,23,14,10,0,7,4,13,1,49,7.0,4,0.0,0,10,0,7,14,4,0,13,1,17,32,1
4391,103291,3xICsH6EXuYyV8kexin75XnVadi3rENN,SpATywNh6bZuzm8s1ceuBUnMUAeoAHHw,7,4,3,0,2,0,2,0,11,1.5714285714285714,1,0.0,0,3,0,2,4,0,0,2,0,5,6,1
4392,103349,hNJz0qbOhrUgajUkzqSdDbybHkuRglfs,bWdj2GDclj5ofokWjzoa5jAwMkxCykd6,15,13,6,86,3,0,3,0,111,15.857142857142858,2,0.0,5,6,79,3,8,0,7,3,0,93,18,1
4393,103401,BfcoBJeBA5nEQ2BMwBPOzhifSeHVOPF7,A3fsA9Zfv1X2fVEQhTw51lKENdNrEqT3,14,15,1,0,1,4,9,4,34,4.857142857142857,2,0.0,0,1,0,1,15,4,0,9,4,2,32,1
4394,103852,VJiHrUKuVkG2Wd7Jui04ER4qa9ZGvV1t,SpATywNh6bZuzm8s1ceuBUnMUAeoAHHw,17,26,11,8,3,4,6,1,59,8.428571428571429,3,0.0,6,11,7,3,20,4,1,6,1,27,32,1
4395,103903,0w9tP8TINgzfbBeYFJprB82ry0PjYiWn,SpATywNh6bZuzm8s1ceuBUnMUAeoAHHw,8,23,2,2,0,0,2,0,29,4.142857142857143,1,0.0,2,2,2,0,21,0,0,2,0,6,23,0
4396,103932,nMJrb50Z6QbaFrpJMS3h5YwSiL2VcT7z,bWdj2GDclj5ofokWjzoa5jAwMkxCykd6,2,0,0,0,0,0,2,0,2,0.2857142857142857,1,0.0,0,0,0,0,0,0,0,2,0,0,2,1
4397,103967,kjoYyxOsZaiCA9S8PMK5B69QLaH15SYn,SpATywNh6bZuzm8s1ceuBUnMUAeoAHHw,12,21,6,18,3,15,1,0,64,9.142857142857142,1,0.0,14,6,15,3,7,15,3,1,0,38,26,0
4398,104081,eGnXUl0T4jiT9b8r6xuMUjzOt9Gv7xEL,A3fsA9Zfv1X2fVEQhTw51lKENdNrEqT3,29,27,19,22,12,1,12,2,95,13.571428571428571,3,0.0,0,19,19,12,27,1,3,12,2,50,45,1
4399,104257,JnJdiqdl8G12l0bbDCbx68wMLkGjKDPl,bWdj2GDclj5ofokWjzoa5jAwMkxCykd6,5,4,2,0,0,0,4,0,10,1.4285714285714286,1,0.0,0,2,0,0,4,0,0,4,0,2,8,1
4400,104281,nQnbQ4USuQPKS5dsskLpLD6Vp5PD3y57,SpATywNh6bZuzm8s1ceuBUnMUAeoAHHw,5,2,1,0,1,1,3,0,8,1.1428571428571428,1,0.0,0,1,0,1,2,1,0,3,0,2,6,0
4401,104285,eYFN65l456TZjqLokXcupn8BpQg7vecw,G8EPVSXsOYB5YQWZGiz1aVq5Pgr2GrQu,9,7,0,0,1,0,11,0,19,2.7142857142857144,1,0.0,0,0,0,1,7,0,0,11,0,1,18,1
4402,104287,E4KzNEU3ybRlAOiHqHHsGQEXiaxyHgoT,SpATywNh6bZuzm8s1ceuBUnMUAeoAHHw,18,19,9,12,5,14,10,1,70,10.0,2,0.0,6,9,12,5,13,14,0,10,1,32,38,0
4403,104293,mKHQM9iW9olu6z2WamdxK7ySH3UwX3JX,RXDvfPUBYFlVdlueBFbLW0mhhAyGEqpt,16,16,9,21,6,1,9,1,63,9.0,3,0.0,5,9,18,6,11,1,3,9,1,38,25,1
4404,104312,Q5TmTVdy8nnH2vTL73s67ZseaCMO3k91,bWdj2GDclj5ofokWjzoa5jAwMkxCykd6,1,0,0,0,0,0,1,0,1,0.14285714285714285,1,0.0,0,0,0,0,0,0,0,1,0,0,1,1
4405,104316,FdqXptfn5rlMpIwU40MbDz6o7uZKXv6A,SpATywNh6bZuzm8s1ceuBUnMUAeoAHHw,2,0,0,0,0,0,2,0,2,0.2857142857142857,1,0.0,0,0,0,0,0,0,0,2,0,0,2,1
4406,104331,sC7fymsB6mbxhnSeg6NeWpGdnl2lVglT,SpATywNh6bZuzm8s1ceuBUnMUAeoAHHw,17,27,11,19,5,0,8,3,73,10.428571428571429,1,0.0,12,11,17,5,15,0,2,8,3,45,28,0
4407,104338,rB9PPwxIRyt27C89H153o2lH09tVr1nK,G8EPVSXsOYB5YQWZGiz1aVq5Pgr2GrQu,6,11,3,0,4,0,2,0,20,2.857142857142857,1,0.0,7,3,0,4,4,0,0,2,0,14,6,1
4408,104345,2XkaIutgoPZ3laInMFqUtqSwL8hEETLH,SpATywNh6bZuzm8s1ceuBUnMUAeoAHHw,4,3,1,0,1,0,1,0,6,0.8571428571428571,1,0.0,0,1,0,1,3,0,0,1,0,2,4,1
4409,104346,wGfXRYqHkdAo1fVEEY9NvW8qy6M9m0mI,SpATywNh6bZuzm8s1ceuBUnMUAeoAHHw,7,5,2,0,2,0,2,0,11,1.5714285714285714,1,0.0,0,2,0,2,5,0,0,2,0,4,7,1
4410,104353,Nvx1FqKYM0wMKIIRgD0fWbHs2ulluJLe,SpATywNh6bZuzm8s1ceuBUnMUAeoAHHw,1,0,0,0,0,0,1,0,1,0.14285714285714285,1,0.0,0,0,0,0,0,0,0,1,0,0,1,0
4411,104362,QVxxpDseuNfbakex6vp7iIpmgTn9LMT8,G8EPVSXsOYB5YQWZGiz1aVq5Pgr2GrQu,7,4,0,0,0,0,3,1,8,1.1428571428571428,1,0.0,0,0,0,0,4,0,0,3,1,0,8,1
4412,104388,hGNdlaqDmXk6lg7T5WbaNaGNDHY5myAS,SpATywNh6bZuzm8s1ceuBUnMUAeoAHHw,7,7,3,0,2,0,3,0,15,2.142857142857143,1,0.0,3,3,0,2,4,0,0,3,0,8,7,1
4413,104394,dlHDytKql5TohtYHxgnGbeQGgJYZWDGJ,A3fsA9Zfv1X2fVEQhTw51lKENdNrEqT3,1,0,0,0,0,0,1,0,1,0.14285714285714285,1,0.0,0,0,0,0,0,0,0,1,0,0,1,1
4414,104407,8XstJLDa8agdHppUFVVZbvtgkIjc1hSo,SpATywNh6bZuzm8s1ceuBUnMUAeoAHHw,6,4,2,0,1,1,3,0,11,1.5714285714285714,2,0.0,0,2,0,1,4,1,0,3,0,3,8,1
4415,104418,pcsiSS3QOPo0n8yKp6skJyBWeonG4c8P,bWdj2GDclj5ofokWjzoa5jAwMkxCykd6,4,5,3,0,2,6,1,0,17,2.4285714285714284,1,0.0,0,3,0,2,5,6,0,1,0,5,12,1
4416,104435,GEHMGUKZ7lJGT0NAhukMXCgY3uHGI1vW,SpATywNh6bZuzm8s1ceuBUnMUAeoAHHw,7,3,2,0,2,0,2,0,9,1.2857142857142858,1,0.0,0,2,0,2,3,0,0,2,0,4,5,1
4417,104438,KJtTFVCUZxFPCdrcl94b8VUY3eA2PtX6,SpATywNh6bZuzm8s1ceuBUnMUAeoAHHw,16,22,8,8,3,9,5,3,58,8.285714285714286,1,0.0,12,8,7,3,10,9,1,5,3,30,28,0
4418,104450,fa5L7BR4QPdW8LaRhyZa9SLAtcvpLQse,SpATywNh6bZuzm8s1ceuBUnMUAeoAHHw,9,3,2,0,2,0,5,1,13,1.8571428571428572,1,0.0,0,2,0,2,3,0,0,5,1,4,9,1
4419,104454,S6zuEdHkGvIDnx9FvNNHc7xwyevTBNEw,G8EPVSXsOYB5YQWZGiz1aVq5Pgr2GrQu,74,60,25,207,22,0,6,0,320,45.714285714285715,4,0.0,23,25,174,22,37,0,33,6,0,244,76,0
4420,104471,1MR6SIEh8IgMKrYcKoTYc2JC43hmTJbZ,A3fsA9Zfv1X2fVEQhTw51lKENdNrEqT3,6,3,0,0,0,2,5,0,10,1.4285714285714286,1,0.0,0,0,0,0,3,2,0,5,0,0,10,1
4421,104488,IYFrqEdSROOp3Z1UK2YOma0RYGRatAQT,A3fsA9Zfv1X2fVEQhTw51lKENdNrEqT3,4,2,1,0,1,0,1,0,5,0.7142857142857143,1,0.0,0,1,0,1,2,0,0,1,0,2,3,1
4422,104491,yEc0qGRUsnGavj0JPbk8pVtWktClrURk,A3fsA9Zfv1X2fVEQhTw51lKENdNrEqT3,1,0,0,0,0,0,1,0,1,0.14285714285714285,1,0.0,0,0,0,0,0,0,0,1,0,0,1,1
4423,104497,jKfEyfk0HFbzE5vAszOX5qLRWBhzLYt2,SpATywNh6bZuzm8s1ceuBUnMUAeoAHHw,1,0,0,0,0,0,1,0,1,0.14285714285714285,1,0.0,0,0,0,0,0,0,0,1,0,0,1,1
4424,104501,vZWQs3w0XkSs89Ucm6ojt59ZxMUAhe1V,A3fsA9Zfv1X2fVEQhTw51lKENdNrEqT3,11,7,3,0,1,2,16,1,30,4.285714285714286,1,0.0,0,3,0,1,7,2,0,16,1,4,26,1
4425,104510,1fqT0899kRcDDGHbdo7SAtzTiZ0jb6Gw,SpATywNh6bZuzm8s1ceuBUnMUAeoAHHw,5,4,1,0,1,0,4,0,10,1.4285714285714286,1,0.0,0,1,0,1,4,0,0,4,0,2,8,1
4426,104519,4BEj7gptNyb11PfZw5Zij4k5rhZkomv9,SpATywNh6bZuzm8s1ceuBUnMUAeoAHHw,16,25,7,15,3,0,4,0,54,7.714285714285714,1,0.0,16,7,14,3,9,0,1,4,0,40,14,1
4427,104520,AXWWqNDiRDejTjo5V7yUaMbjtzXKhlP0,A3fsA9Zfv1X2fVEQhTw51lKENdNrEqT3,9,5,4,0,3,0,2,0,14,2.0,1,0.0,0,4,0,3,5,0,0,2,0,7,7,1
4428,104529,pRsdTtgRf3HNRCFBVE8ZUsyswXD2QiAk,SpATywNh6bZuzm8s1ceuBUnMUAeoAHHw,9,6,3,0,3,0,2,0,14,2.0,2,0.0,2,3,0,3,4,0,0,2,0,8,6,1
4429,104541,WrS9TB9uT4oSW7UbFINDhj14Cq6LHmEj,G8EPVSXsOYB5YQWZGiz1aVq5Pgr2GrQu,21,20,7,12,5,3,12,1,60,8.571428571428571,1,0.0,5,7,9,5,15,3,3,12,1,26,34,0
4430,104544,gUXmx34tXzFZkM4gYbNbIwLhuZfANkS1,A3fsA9Zfv1X2fVEQhTw51lKENdNrEqT3,4,3,1,0,0,0,1,0,5,0.7142857142857143,1,0.0,0,1,0,0,3,0,0,1,0,1,4,1
4431,104549,XVzLVlcu5Oyf6iAJpPwexFxr52kUVMk6,SpATywNh6bZuzm8s1ceuBUnMUAeoAHHw,1,0,0,0,0,0,1,0,1,0.14285714285714285,1,0.0,0,0,0,0,0,0,0,1,0,0,1,1
4432,104552,nR9dAgKzSlgvrJWELbwHBtX83ee7HVxY,SpATywNh6bZuzm8s1ceuBUnMUAeoAHHw,7,4,3,0,3,0,2,0,12,1.7142857142857142,1,0.0,0,3,0,3,4,0,0,2,0,6,6,1
4433,104559,efXmiwkTuBoeL7S5luYeU6sYtxURlop6,G8EPVSXsOYB5YQWZGiz1aVq5Pgr2GrQu,2,0,0,0,0,0,2,0,2,0.2857142857142857,1,0.0,0,0,0,0,0,0,0,2,0,0,2,1
4434,104583,hd3AGD7h3p4wKWEGL7m8RwayFKIA3oY6,SpATywNh6bZuzm8s1ceuBUnMUAeoAHHw,9,10,5,0,5,1,1,0,22,3.142857142857143,1,0.0,2,5,0,5,8,1,0,1,0,12,10,1
4435,104638,pVcyz42RqwGdgjmvwllHMEUwVR1vdXWF,SpATywNh6bZuzm8s1ceuBUnMUAeoAHHw,9,13,5,0,3,0,2,0,23,3.2857142857142856,1,0.0,4,5,0,3,9,0,0,2,0,12,11,0
4436,104643,OUOJlObKrXM0JmEUq0o8KzZHzr8jy9dn,SpATywNh6bZuzm8s1ceuBUnMUAeoAHHw,1,0,0,0,0,0,1,0,1,0.14285714285714285,1,0.0,0,0,0,0,0,0,0,1,0,0,1,1
4437,104660,T118Cf7QnojriLhCFYL99xCQBHodaMMt,A3fsA9Zfv1X2fVEQhTw51lKENdNrEqT3,6,5,2,0,1,0,2,0,10,1.4285714285714286,1,0.0,0,2,0,1,5,0,0,2,0,3,7,1
4438,104679,b7OkWz3nq7Lb9oLoadHyvvkdfFcSwihz,bWdj2GDclj5ofokWjzoa5jAwMkxCykd6,1,0,0,0,0,0,1,0,1,0.14285714285714285,1,0.0,0,0,0,0,0,0,0,1,0,0,1,1
4439,104695,pFPFJKqqsl7E3HmJN66ulC7SsHL61zY0,G8EPVSXsOYB5YQWZGiz1aVq5Pgr2GrQu,7,1,1,0,1,0,4,1,8,1.1428571428571428,1,0.0,0,1,0,1,1,0,0,4,1,2,6,1
4440,104700,HTW0MXRsyGWqdNcPrMPEaXwWOjVd82Bo,SpATywNh6bZuzm8s1ceuBUnMUAeoAHHw,13,34,12,12,5,0,5,0,68,9.714285714285714,2,0.0,10,12,10,5,24,0,2,5,0,37,31,1
4441,104725,kOUbZbVS3Tp5fnMvFRgXRDdwa2qwOZPQ,SpATywNh6bZuzm8s1ceuBUnMUAeoAHHw,10,11,9,0,5,0,1,0,26,3.7142857142857144,1,0.0,1,9,0,5,10,0,0,1,0,15,11,1
4442,104729,EJ7udUHYDMabOR6DK8F5Y2Y2wljl56Yz,SpATywNh6bZuzm8s1ceuBUnMUAeoAHHw,13,22,6,11,1,5,6,1,52,7.428571428571429,1,0.0,14,6,10,1,8,5,1,6,1,31,21,1
4443,104732,Xp3hqJUxQ1JyPcuVR21XzaJTaS6J32IL,SpATywNh6bZuzm8s1ceuBUnMUAeoAHHw,5,2,1,0,1,0,2,0,6,0.8571428571428571,1,0.0,0,1,0,1,2,0,0,2,0,2,4,1
4444,104752,howLdYpe9Zal9CPA1BP3DgH0uhVpiT5i,SpATywNh6bZuzm8s1ceuBUnMUAeoAHHw,18,13,6,14,4,3,6,2,48,6.857142857142857,1,0.0,4,6,13,4,9,3,1,6,2,27,21,1
4445,104772,AaS8GsfaaiK26oA6b0QdGhs8opVCkjvV,A3fsA9Zfv1X2fVEQhTw51lKENdNrEqT3,31,17,12,54,0,7,6,0,96,13.714285714285714,1,0.0,2,12,47,0,15,7,7,6,0,61,35,1
4446,104790,EPmLjBxeWpwhjwoRgtmLV8RkhFOu2zzj,SpATywNh6bZuzm8s1ceuBUnMUAeoAHHw,2,0,0,0,0,0,2,0,2,0.2857142857142857,1,0.0,0,0,0,0,0,0,0,2,0,0,2,1
4447,104791,Xv7W8Uu75U6tMRhwrAaphCnFwKom9DXj,SpATywNh6bZuzm8s1ceuBUnMUAeoAHHw,2,0,0,0,0,0,2,0,2,0.2857142857142857,1,0.0,0,0,0,0,0,0,0,2,0,0,2,1
4448,104798,705a1tvxnZT7omctMx7Fjakho000VDxN,SpATywNh6bZuzm8s1ceuBUnMUAeoAHHw,3,2,0,0,0,0,1,0,3,0.42857142857142855,1,0.0,0,0,0,0,2,0,0,1,0,0,3,1
4449,104803,GHw9ck750jm0mkRym0HeCGrJelDoub5a,SpATywNh6bZuzm8s1ceuBUnMUAeoAHHw,15,20,12,0,5,2,7,0,46,6.571428571428571,2,0.0,5,12,0,5,15,2,0,7,0,22,24,0
4450,104805,O5Xv4tBkDAfcRTJRImpaIMgi7dTTYJal,SpATywNh6bZuzm8s1ceuBUnMUAeoAHHw,17,20,8,19,3,12,7,1,70,10.0,2,0.0,8,8,15,3,12,12,4,7,1,34,36,1
4451,104818,6i24nlUBlDMs5njijO1qqAg2zNti0ug9,SpATywNh6bZuzm8s1ceuBUnMUAeoAHHw,8,6,4,0,3,0,5,0,18,2.5714285714285716,1,0.0,0,4,0,3,6,0,0,5,0,7,11,1
4452,104826,1EoPeAPt0rQExpDMUB0Oh9LRcg1yhFWa,SpATywNh6bZuzm8s1ceuBUnMUAeoAHHw,1,0,0,0,0,0,1,0,1,0.14285714285714285,1,0.0,0,0,0,0,0,0,0,1,0,0,1,1
4453,104838,PzXoGwLC1Wc9fp2FSg9WCVxYfOKqR6tz,SpATywNh6bZuzm8s1ceuBUnMUAeoAHHw,9,14,9,0,0,0,5,0,28,4.0,2,0.0,0,9,0,0,14,0,0,5,0,9,19,1
4454,104840,wBcELLuAHs6lwDaecxC5fVgtQ5lnLu3S,RXDvfPUBYFlVdlueBFbLW0mhhAyGEqpt,5,3,0,0,0,0,2,0,5,0.7142857142857143,1,0.0,0,0,0,0,3,0,0,2,0,0,5,1
4455,104843,8NRsKZ3hMeinWXhN3qtntd7OTP25jyWY,SpATywNh6bZuzm8s1ceuBUnMUAeoAHHw,4,3,1,0,1,0,2,0,7,1.0,1,0.0,0,1,0,1,3,0,0,2,0,2,5,1
4456,104847,gPygmoGilNQtwbFXETY0FWnDTdZxsr6L,bWdj2GDclj5ofokWjzoa5jAwMkxCykd6,5,4,1,0,2,0,2,0,9,1.2857142857142858,1,0.0,2,1,0,2,2,0,0,2,0,5,4,1
4457,104870,vO07VFd2DYWPdrvNiSqsqXFTXPKE00c4,SpATywNh6bZuzm8s1ceuBUnMUAeoAHHw,1,0,0,0,0,0,1,0,1,0.14285714285714285,1,0.0,0,0,0,0,0,0,0,1,0,0,1,1
4458,104888,7UoJlZNmkXe9KUxED9211lah5PpgHmBQ,A3fsA9Zfv1X2fVEQhTw51lKENdNrEqT3,8,4,2,0,2,0,3,0,11,1.5714285714285714,2,0.0,0,2,0,2,4,0,0,3,0,4,7,1
4459,104899,fYcx29YG0OyhjbzerOxQ4rwr3ES74fln,bWdj2GDclj5ofokWjzoa5jAwMkxCykd6,7,9,6,0,0,0,6,0,21,3.0,2,0.0,0,6,0,0,9,0,0,6,0,6,15,1
4460,104911,0lHtTzCCkTGgpl3mL2eT9kPoN3ydIlHv,bWdj2GDclj5ofokWjzoa5jAwMkxCykd6,10,8,6,0,5,0,3,0,22,3.142857142857143,2,0.0,0,6,0,5,8,0,0,3,0,11,11,1
4461,104921,xBMlDE0EhLrV6UTu12C10f1Ev99CwT31,SpATywNh6bZuzm8s1ceuBUnMUAeoAHHw,10,16,8,0,3,0,3,0,30,4.285714285714286,1,0.0,0,8,0,3,16,0,0,3,0,11,19,1
4462,104937,nyhARUyj7ejuonDDMRnWtxhqKty5CGUe,A3fsA9Zfv1X2fVEQhTw51lKENdNrEqT3,1,0,0,0,0,0,1,0,1,0.14285714285714285,1,0.0,0,0,0,0,0,0,0,1,0,0,1,1
4463,104940,8yrIKDtnkYcLfERwrXrvcRGxHxbt2Jd3,A3fsA9Zfv1X2fVEQhTw51lKENdNrEqT3,2,0,0,0,0,0,2,0,2,0.2857142857142857,1,0.0,0,0,0,0,0,0,0,2,0,0,2,1
4464,104950,0NdMcTtal4BOZ1xlXUgTc3KVGUjBSUot,SpATywNh6bZuzm8s1ceuBUnMUAeoAHHw,16,15,10,21,3,13,10,6,78,11.142857142857142,1,0.0,4,10,18,3,11,13,3,10,6,35,43,1
4465,104951,0FkQyM0LbhhmKgkelCOZLJl6X4aMe6Y7,bWdj2GDclj5ofokWjzoa5jAwMkxCykd6,6,3,1,0,1,0,2,0,7,1.0,1,0.0,0,1,0,1,3,0,0,2,0,2,5,1
4466,104963,Gp514eONX8HiKW2kWtPnfdmsO2W1ys65,SpATywNh6bZuzm8s1ceuBUnMUAeoAHHw,7,8,0,0,0,1,5,0,14,2.0,1,0.0,0,0,0,0,8,1,0,5,0,0,14,1
4467,104973,r6HTx0usTVh2rZ8xnqG9NraBW5uoCbAW,G8EPVSXsOYB5YQWZGiz1aVq5Pgr2GrQu,3,2,0,0,0,0,1,0,3,0.42857142857142855,1,0.0,0,0,0,0,2,0,0,1,0,0,3,1
4468,104983,as0OGPaqUNY2AJHdTO1ghRp7pegJOTda,A3fsA9Zfv1X2fVEQhTw51lKENdNrEqT3,13,7,5,0,4,0,7,0,23,3.2857142857142856,1,0.0,0,5,0,4,7,0,0,7,0,9,14,1
4469,105000,pRiGzDKgwOgFTBnFOQaqzu3UaMPe8uNF,SpATywNh6bZuzm8s1ceuBUnMUAeoAHHw,16,15,6,10,3,2,5,0,41,5.857142857142857,1,0.0,6,6,9,3,9,2,1,5,0,24,17,0
4470,105006,0fpX00EX1TEQvQDvfUOFFIekoZBhUJ55,SpATywNh6bZuzm8s1ceuBUnMUAeoAHHw,10,19,0,20,0,3,4,0,46,6.571428571428571,1,0.0,9,0,16,0,10,3,4,4,0,25,21,1
4471,105009,MoIyInVwEhZdoyGdxNDzoAKuJ4ab4usf,G8EPVSXsOYB5YQWZGiz1aVq5Pgr2GrQu,44,19,7,140,3,0,8,1,178,25.428571428571427,2,0.0,9,7,111,3,10,0,29,8,1,130,48,1
4472,105045,AsBtR21xGFKZ6c2LKvPTdlawgiUBcaPL,A3fsA9Zfv1X2fVEQhTw51lKENdNrEqT3,7,6,3,0,2,0,1,0,12,1.7142857142857142,1,0.0,0,3,0,2,6,0,0,1,0,5,7,1
4473,105048,skA6GV4QKGFVtxye7Nlz906gXUD3qCvf,SpATywNh6bZuzm8s1ceuBUnMUAeoAHHw,18,49,6,20,0,4,7,1,87,12.428571428571429,3,0.0,22,6,18,0,27,4,2,7,1,46,41,1
4474,105077,0V54aOwQrSAMewtMntBBMI7Ks56rZdIS,SpATywNh6bZuzm8s1ceuBUnMUAeoAHHw,8,3,2,0,2,0,3,0,10,1.4285714285714286,1,0.0,0,2,0,2,3,0,0,3,0,4,6,1
4475,105087,il5WSyfV8t3AlDaoTevF0gOGZQXdoXsc,SpATywNh6bZuzm8s1ceuBUnMUAeoAHHw,10,3,3,0,3,0,5,0,14,2.0,2,0.0,0,3,0,3,3,0,0,5,0,6,8,1
4476,105102,Oh8nsiPPTE9TLZe9wGx8wAMkvZwDEBik,SpATywNh6bZuzm8s1ceuBUnMUAeoAHHw,7,6,3,0,3,0,2,0,14,2.0,2,0.0,0,3,0,3,6,0,0,2,0,6,8,1
4477,105108,HJsFc87NFCDg5yRkkakXIT7nSH8XGxhF,RXDvfPUBYFlVdlueBFbLW0mhhAyGEqpt,2,0,0,0,0,0,3,0,3,0.42857142857142855,2,0.0,0,0,0,0,0,0,0,3,0,0,3,0
4478,105118,Qs7Gy3lEvMM83esFdoZ1zZvUeRYTAxxM,bWdj2GDclj5ofokWjzoa5jAwMkxCykd6,4,2,1,0,1,0,3,0,7,1.0,2,0.0,0,1,0,1,2,0,0,3,0,2,5,1
4479,105126,5THwHjTl3CwrsU1mIg0WeedsGDfvyUMr,G8EPVSXsOYB5YQWZGiz1aVq5Pgr2GrQu,11,10,5,0,3,1,10,0,29,4.142857142857143,2,0.0,0,5,0,3,10,1,0,10,0,8,21,1
4480,105127,Vr52BPz4QZ36FT4KFVQoT6q0kUFkYRGt,A3fsA9Zfv1X2fVEQhTw51lKENdNrEqT3,2,0,0,0,0,0,4,0,4,0.5714285714285714,1,0.0,0,0,0,0,0,0,0,4,0,0,4,1
4481,105140,BAa1TxCsHWVGWhK6xiubabaADa3eqEud,A3fsA9Zfv1X2fVEQhTw51lKENdNrEqT3,2,0,0,0,0,0,2,0,2,0.2857142857142857,1,0.0,0,0,0,0,0,0,0,2,0,0,2,1
4482,105147,B5KRIhKjqiTl7SsQUviM99Uk4X6GH6qt,SpATywNh6bZuzm8s1ceuBUnMUAeoAHHw,4,2,1,0,0,0,2,0,5,0.7142857142857143,1,0.0,0,1,0,0,2,0,0,2,0,1,4,1
4483,105169,Ruj4G7IwBWWMNjdkNO62PMD51YZNkIvC,SpATywNh6bZuzm8s1ceuBUnMUAeoAHHw,6,1,1,0,1,0,3,0,6,0.8571428571428571,1,0.0,0,1,0,1,1,0,0,3,0,2,4,1
4484,105174,ek3MzKxIa2dEtIB8F3GcpuahHmTwWTB6,SpATywNh6bZuzm8s1ceuBUnMUAeoAHHw,7,14,2,0,1,0,3,0,20,2.857142857142857,2,0.0,5,2,0,1,9,0,0,3,0,8,12,1
4485,105179,3ZE4TsW4kNV4MayVbDMw5du6BBHsJQ28,bWdj2GDclj5ofokWjzoa5jAwMkxCykd6,4,2,0,0,0,1,3,0,6,0.8571428571428571,1,0.0,0,0,0,0,2,1,0,3,0,0,6,1
4486,105183,vIlcyxyCAnrnNirD1pT1JNHi1Wuqkh6N,G8EPVSXsOYB5YQWZGiz1aVq5Pgr2GrQu,1,0,0,0,0,0,1,0,1,0.14285714285714285,1,0.0,0,0,0,0,0,0,0,1,0,0,1,1
4487,105193,3KmURJPHsPOw8V9aGbkBVqZ8GfDwNzjb,SpATywNh6bZuzm8s1ceuBUnMUAeoAHHw,7,3,2,0,2,0,2,0,9,1.2857142857142858,1,0.0,0,2,0,2,3,0,0,2,0,4,5,1
4488,105213,f6fUoSUJslaShApLLQ3C3hAE39t0Ewco,A3fsA9Zfv1X2fVEQhTw51lKENdNrEqT3,1,0,0,0,0,0,1,0,1,0.14285714285714285,1,0.0,0,0,0,0,0,0,0,1,0,0,1,1
4489,105215,XqjUxB8l2EDnNsPmb4GmXeJWVp4D1ShM,SpATywNh6bZuzm8s1ceuBUnMUAeoAHHw,5,4,0,0,0,1,3,0,8,1.1428571428571428,1,0.0,0,0,0,0,4,1,0,3,0,0,8,1
4490,105238,D49L08bhYMDNZcjv8FPy2UNVru9gYK6t,bWdj2GDclj5ofokWjzoa5jAwMkxCykd6,5,1,1,0,1,0,2,0,5,0.7142857142857143,1,0.0,0,1,0,1,1,0,0,2,0,2,3,1
4491,105258,iaVYLE1BI86xpC2ERUpI1xclzmGmTOg0,SpATywNh6bZuzm8s1ceuBUnMUAeoAHHw,4,2,0,0,0,0,2,0,4,0.5714285714285714,1,0.0,0,0,0,0,2,0,0,2,0,0,4,1
4492,105265,yvMe4l8GZJNWinwQEogjzWQJd9z0H33J,SpATywNh6bZuzm8s1ceuBUnMUAeoAHHw,8,7,5,0,1,2,3,1,19,2.7142857142857144,1,0.0,0,5,0,1,7,2,0,3,1,6,13,1
4493,105277,KUZLnWk3DnESTDfMbkIGdOBiU12ntmts,A3fsA9Zfv1X2fVEQhTw51lKENdNrEqT3,7,4,2,0,1,0,8,0,15,2.142857142857143,1,0.0,1,2,0,1,3,0,0,8,0,4,11,1
4494,105309,8yGhHOYnj9M6W9ULBEe6c9dxuWlFPuyX,SpATywNh6bZuzm8s1ceuBUnMUAeoAHHw,5,3,2,0,1,0,2,0,8,1.1428571428571428,1,0.0,0,2,0,1,3,0,0,2,0,3,5,1
4495,105310,drUu3tyovHqnF7EAaPHayHDYbWMe2Od6,G8EPVSXsOYB5YQWZGiz1aVq5Pgr2GrQu,1,0,0,0,0,0,1,0,1,0.14285714285714285,1,0.0,0,0,0,0,0,0,0,1,0,0,1,1
4496,105311,drUu3tyovHqnF7EAaPHayHDYbWMe2Od6,RXDvfPUBYFlVdlueBFbLW0mhhAyGEqpt,1,0,0,0,0,0,1,0,1,0.14285714285714285,1,0.0,0,0,0,0,0,0,0,1,0,0,1,1
4497,105313,drUu3tyovHqnF7EAaPHayHDYbWMe2Od6,A3fsA9Zfv1X2fVEQhTw51lKENdNrEqT3,1,0,0,0,0,0,1,0,1,0.14285714285714285,1,0.0,0,0,0,0,0,0,0,1,0,0,1,1
4498,105323,yiX0lNiEyuJnsK7G0Hy1jjUqzZwKTcF0,SpATywNh6bZuzm8s1ceuBUnMUAeoAHHw,24,41,2,20,1,15,17,2,98,14.0,6,0.0,5,2,19,1,36,15,1,17,2,27,71,1
4499,105325,afcoJmZ0nAGqrhElRzMbfqW6LhEtEJYc,A3fsA9Zfv1X2fVEQhTw51lKENdNrEqT3,10,5,4,0,4,0,2,0,15,2.142857142857143,1,0.0,0,4,0,4,5,0,0,2,0,8,7,1
4500,105329,e7lti3fBvO8XZNtS4I7hMo5JFh6PqMCH,A3fsA9Zfv1X2fVEQhTw51lKENdNrEqT3,3,2,0,0,0,0,2,0,4,0.5714285714285714,1,0.0,0,0,0,0,2,0,0,2,0,0,4,1
4501,105330,l1I3uQILh7eNNq6Rwc2qZc5y0kyUy4xt,SpATywNh6bZuzm8s1ceuBUnMUAeoAHHw,1,0,0,0,0,0,1,0,1,0.14285714285714285,1,0.0,0,0,0,0,0,0,0,1,0,0,1,1
4502,105337,DI0mr4BQNoklidHTIy9m8FuU69db5M3W,SpATywNh6bZuzm8s1ceuBUnMUAeoAHHw,6,6,2,0,1,0,2,0,11,1.5714285714285714,2,0.0,0,2,0,1,6,0,0,2,0,3,8,1
4503,105339,fa4GjkZRgCxI5T2nX0B0SnNvYjPJTUJZ,bWdj2GDclj5ofokWjzoa5jAwMkxCykd6,2,0,0,0,0,0,3,0,3,0.42857142857142855,1,0.0,0,0,0,0,0,0,0,3,0,0,3,1
4504,105346,8cxCnT3STAEth9x4HzjOcerWufkhGlX3,SpATywNh6bZuzm8s1ceuBUnMUAeoAHHw,10,3,2,0,2,4,7,1,19,2.7142857142857144,1,0.0,0,2,0,2,3,4,0,7,1,4,15,1
4505,105348,jyuEVmbrPcyGnV7pufxSb0rPrKJZItsk,SpATywNh6bZuzm8s1ceuBUnMUAeoAHHw,16,26,12,19,7,2,4,0,70,10.0,2,0.0,12,12,16,7,14,2,3,4,0,47,23,1
4506,105354,yPqVjRtl1ZeCcEk7haS4nj4BOuHk3MT1,A3fsA9Zfv1X2fVEQhTw51lKENdNrEqT3,1,0,0,0,0,0,2,0,2,0.2857142857142857,1,0.0,0,0,0,0,0,0,0,2,0,0,2,1
4507,105357,Q9q5caNwjGe6Mi6I72wyiS18BJTL4KH1,SpATywNh6bZuzm8s1ceuBUnMUAeoAHHw,11,15,4,16,0,0,4,0,39,5.571428571428571,1,0.0,8,4,14,0,7,0,2,4,0,26,13,1
4508,105362,IqTYyD7L0euRgN3diEzqrprrc2W9uyF6,A3fsA9Zfv1X2fVEQhTw51lKENdNrEqT3,14,8,6,0,5,4,5,1,29,4.142857142857143,2,0.0,0,6,0,5,8,4,0,5,1,11,18,1
4509,105369,ATdd6t2UWonXImy5O3tzf7AEJJ0cHqzx,SpATywNh6bZuzm8s1ceuBUnMUAeoAHHw,3,0,0,0,0,0,3,0,3,0.42857142857142855,1,0.0,0,0,0,0,0,0,0,3,0,0,3,1
4510,105392,m52MhXMTVGYF4Y9Pc8zOC6jKXo973eSz,SpATywNh6bZuzm8s1ceuBUnMUAeoAHHw,1,0,0,0,0,0,1,0,1,0.14285714285714285,1,0.0,0,0,0,0,0,0,0,1,0,0,1,1
4511,105410,vqSgORDp5PsEpveQVJoPh4dnJvR6AQkK,A3fsA9Zfv1X2fVEQhTw51lKENdNrEqT3,1,0,0,0,0,0,1,0,1,0.14285714285714285,1,0.0,0,0,0,0,0,0,0,1,0,0,1,1
4512,105420,biOEnvJNbNmJmtnLohBToN5g3ppQrMj4,SpATywNh6bZuzm8s1ceuBUnMUAeoAHHw,3,3,1,0,0,0,2,0,6,0.8571428571428571,1,0.0,0,1,0,0,3,0,0,2,0,1,5,1
4513,105421,DgZ8el6keJUnUjxjYHQCrfhij2kpBixa,bWdj2GDclj5ofokWjzoa5jAwMkxCykd6,7,9,3,0,1,0,1,0,14,2.0,1,0.0,0,3,0,1,9,0,0,1,0,4,10,0
4514,105425,EBjWbzPkmDW0GuiUkHj889OvqfrdDhI2,SpATywNh6bZuzm8s1ceuBUnMUAeoAHHw,9,8,5,4,0,0,3,0,20,2.857142857142857,1,0.0,1,5,4,0,7,0,0,3,0,10,10,1
4515,105428,h3LsKXMnT4HqL0yI33YFdQ7c6aiA632R,SpATywNh6bZuzm8s1ceuBUnMUAeoAHHw,15,24,7,9,3,10,3,2,58,8.285714285714286,1,0.0,15,7,9,3,9,10,0,3,2,34,24,1
4516,105434,3n6ajKAkQu8rgtUnNpdWOfMF8VSNsMVs,A3fsA9Zfv1X2fVEQhTw51lKENdNrEqT3,4,2,1,0,0,0,3,0,6,0.8571428571428571,2,0.0,0,1,0,0,2,0,0,3,0,1,5,1
4517,105436,wbX1noywm1bmZy8t47H8TCRwxZP7RsKK,bWdj2GDclj5ofokWjzoa5jAwMkxCykd6,1,0,0,0,0,0,1,0,1,0.14285714285714285,1,0.0,0,0,0,0,0,0,0,1,0,0,1,1
4518,105438,4bmL6hoAF72J4V8IxCYpOyypEujwyDUs,A3fsA9Zfv1X2fVEQhTw51lKENdNrEqT3,6,2,0,0,0,1,5,0,8,1.1428571428571428,1,0.0,0,0,0,0,2,1,0,5,0,0,8,1
4519,105442,1YSmilr2ajm5pFk4iAawwfB3mRapy4GR,A3fsA9Zfv1X2fVEQhTw51lKENdNrEqT3,4,2,1,0,1,0,1,0,5,0.7142857142857143,1,0.0,0,1,0,1,2,0,0,1,0,2,3,1
4520,105467,dEPUxcdyZTnKUVP0o2JXv6VWX3ETnwmr,bWdj2GDclj5ofokWjzoa5jAwMkxCykd6,6,2,1,0,0,0,4,0,7,1.0,1,0.0,1,1,0,0,1,0,0,4,0,2,5,1
4521,105476,pMxyBMX7n5deuUC9YyUONEJJAyoPl0BG,SpATywNh6bZuzm8s1ceuBUnMUAeoAHHw,7,5,0,0,0,0,2,0,7,1.0,1,0.0,0,0,0,0,5,0,0,2,0,0,7,1
4522,105477,uMcognJuP2U8fvNcuj2o9G4hdrHlzffM,SpATywNh6bZuzm8s1ceuBUnMUAeoAHHw,8,13,6,0,0,1,11,1,32,4.571428571428571,1,0.0,2,6,0,0,11,1,0,11,1,8,24,1
4523,105482,sVA3jWGeZiIVEsBLKNyDfSGu7oUE3Uyc,A3fsA9Zfv1X2fVEQhTw51lKENdNrEqT3,2,0,0,0,0,0,5,0,5,0.7142857142857143,3,0.0,0,0,0,0,0,0,0,5,0,0,5,1
4524,105494,RS3yqsxA8GMaO1hS4uSnfa6jOPVVMGWD,bWdj2GDclj5ofokWjzoa5jAwMkxCykd6,6,3,1,0,1,0,2,0,7,1.0,1,0.0,0,1,0,1,3,0,0,2,0,2,5,1
4525,105522,Sj6pTyY9d8gvsSx1FCIqF3bTiiQB5ISO,RXDvfPUBYFlVdlueBFbLW0mhhAyGEqpt,1,0,0,0,0,0,1,0,1,0.14285714285714285,1,0.0,0,0,0,0,0,0,0,1,0,0,1,1
4526,105531,E9EKlY1j2c1T8yweLd0nuHvfVuBiMa1Z,SpATywNh6bZuzm8s1ceuBUnMUAeoAHHw,1,0,0,0,0,0,1,0,1,0.14285714285714285,1,0.0,0,0,0,0,0,0,0,1,0,0,1,1
4527,105536,JiGlqAbyZaZegus8dku8k8Xk9BHhTCdV,SpATywNh6bZuzm8s1ceuBUnMUAeoAHHw,8,2,1,0,1,5,7,1,17,2.4285714285714284,1,0.0,0,1,0,1,2,5,0,7,1,2,15,1
4528,105547,x3ZcCHvytIJQEMLj5E05tgfA0i9bCC3E,SpATywNh6bZuzm8s1ceuBUnMUAeoAHHw,1,0,0,0,0,0,1,0,1,0.14285714285714285,1,0.0,0,0,0,0,0,0,0,1,0,0,1,1
4529,105556,aa0arothpvvvORCnYecBgFktA9Cuu0Tk,SpATywNh6bZuzm8s1ceuBUnMUAeoAHHw,12,10,7,4,5,0,2,0,28,4.0,1,0.0,0,7,4,5,10,0,0,2,0,16,12,1
4530,105558,GbO46rd9u4nTIYKWQ4uqsc2u6MxCvlf3,A3fsA9Zfv1X2fVEQhTw51lKENdNrEqT3,7,6,4,0,0,0,4,0,14,2.0,2,0.0,0,4,0,0,6,0,0,4,0,4,10,1
4531,105566,QsEau4BvaT6rjAper2QSXSr2L9nKgnZa,SpATywNh6bZuzm8s1ceuBUnMUAeoAHHw,1,0,0,0,0,0,1,0,1,0.14285714285714285,1,0.0,0,0,0,0,0,0,0,1,0,0,1,0
4532,105583,Cb1oMMLwTjTacmho2xz7pvU7NsoZgScq,A3fsA9Zfv1X2fVEQhTw51lKENdNrEqT3,6,3,2,0,2,0,1,0,8,1.1428571428571428,1,0.0,0,2,0,2,3,0,0,1,0,4,4,1
4533,105593,CVNZnTiRds77aV88t7oO5JnyjLjE4gZ5,A3fsA9Zfv1X2fVEQhTw51lKENdNrEqT3,8,6,3,0,3,0,1,0,13,1.8571428571428572,1,0.0,0,3,0,3,6,0,0,1,0,6,7,1
4534,105607,Z91ylcCa0QBPuZRAZnN7Bi8KMhEMk84I,SpATywNh6bZuzm8s1ceuBUnMUAeoAHHw,1,0,0,0,0,0,1,0,1,0.14285714285714285,1,0.0,0,0,0,0,0,0,0,1,0,0,1,1
4535,105612,kTfeD1yVO5Jc7Nzx4cKtELWtok3ws4tr,bWdj2GDclj5ofokWjzoa5jAwMkxCykd6,8,10,0,0,0,36,8,1,55,7.857142857142857,2,0.0,2,0,0,0,8,36,0,8,1,2,53,1
4536,105613,Z91ylcCa0QBPuZRAZnN7Bi8KMhEMk84I,RXDvfPUBYFlVdlueBFbLW0mhhAyGEqpt,1,0,0,0,0,0,1,0,1,0.14285714285714285,1,0.0,0,0,0,0,0,0,0,1,0,0,1,1
4537,105617,6ZG1BmPHf4xACRz5Wb0XhmecfqdoDBrw,SpATywNh6bZuzm8s1ceuBUnMUAeoAHHw,9,10,2,0,0,1,7,1,21,3.0,1,0.0,0,2,0,0,10,1,0,7,1,2,19,1
4538,105619,XDUz0oVcNwke0CqAlFlmwOWSA32SgeFl,RXDvfPUBYFlVdlueBFbLW0mhhAyGEqpt,1,0,0,0,0,0,1,0,1,0.14285714285714285,1,0.0,0,0,0,0,0,0,0,1,0,0,1,1
4539,105621,Z2LpxeyN5IUym4huJGBt4liqsVm2EQ7Q,SpATywNh6bZuzm8s1ceuBUnMUAeoAHHw,24,38,11,33,3,35,28,1,149,21.285714285714285,6,0.0,8,11,27,3,30,35,6,28,1,49,100,0
4540,105630,UU4MEikmCGklRVK3djHNSk7yxxkesa3p,bWdj2GDclj5ofokWjzoa5jAwMkxCykd6,12,15,10,0,4,4,15,0,48,6.857142857142857,2,0.0,0,10,0,4,15,4,0,15,0,14,34,1
4541,105631,RWrD2aL8EikwNOiemk8w8nKZlf66LQBh,SpATywNh6bZuzm8s1ceuBUnMUAeoAHHw,4,5,3,0,3,0,2,0,13,1.8571428571428572,2,0.0,1,3,0,3,4,0,0,2,0,7,6,1
4542,105635,6UsHFnhiB8wUPOMCvGQlekDt4oV3KUX3,A3fsA9Zfv1X2fVEQhTw51lKENdNrEqT3,5,3,2,0,0,0,7,1,13,1.8571428571428572,2,0.0,0,2,0,0,3,0,0,7,1,2,11,1
4543,105657,GRVPWiEvNASyREwGmbaFNHUClZD26ajQ,A3fsA9Zfv1X2fVEQhTw51lKENdNrEqT3,9,3,3,0,3,0,3,0,12,1.7142857142857142,1,0.0,0,3,0,3,3,0,0,3,0,6,6,1
4544,105659,HDn8BqQviq3qzBRDiLH1seTa1wZLl2Fv,SpATywNh6bZuzm8s1ceuBUnMUAeoAHHw,2,0,0,0,0,0,2,0,2,0.2857142857142857,1,0.0,0,0,0,0,0,0,0,2,0,0,2,1
4545,105674,pPG4IhCdtFDb0ApVQ8Cw5mvhtg1pBVlc,A3fsA9Zfv1X2fVEQhTw51lKENdNrEqT3,1,0,0,0,0,0,1,0,1,0.14285714285714285,1,0.0,0,0,0,0,0,0,0,1,0,0,1,1
4546,105683,RyhsCovpAO4Tu33MEtD28G55TyhpodT7,bWdj2GDclj5ofokWjzoa5jAwMkxCykd6,1,0,0,0,0,0,2,0,2,0.2857142857142857,1,0.0,0,0,0,0,0,0,0,2,0,0,2,1
4547,105686,ZMYniXzfaHfNUK3JevOZjrK1dOWNKOE7,A3fsA9Zfv1X2fVEQhTw51lKENdNrEqT3,2,0,0,0,0,0,2,0,2,0.2857142857142857,1,0.0,0,0,0,0,0,0,0,2,0,0,2,1
4548,105692,vP4adNJVoKfOfC59LI5B3RjnV290gjOc,SpATywNh6bZuzm8s1ceuBUnMUAeoAHHw,4,2,0,0,0,0,2,0,4,0.5714285714285714,1,0.0,0,0,0,0,2,0,0,2,0,0,4,1
4549,105705,Higp7tL2evAdDfwxJ7Fv3MD5xI1FILhG,bWdj2GDclj5ofokWjzoa5jAwMkxCykd6,1,0,0,0,0,0,1,0,1,0.14285714285714285,1,0.0,0,0,0,0,0,0,0,1,0,0,1,1
4550,105717,YGd4irzc5KMR1PH2KdOtbCkghLMZ2dPk,SpATywNh6bZuzm8s1ceuBUnMUAeoAHHw,9,6,4,10,0,0,2,0,22,3.142857142857143,1,0.0,2,4,9,0,4,0,1,2,0,15,7,1
4551,106440,FiDLmZS7SZoCB8c2FPrLrdnRZi9p4XPX,bWdj2GDclj5ofokWjzoa5jAwMkxCykd6,4,2,1,0,1,0,1,0,5,0.7142857142857143,1,0.0,0,1,0,1,2,0,0,1,0,2,3,0
4552,106860,6lERIt9LK72b4gBh1gc6JqDmon4igZIH,A3fsA9Zfv1X2fVEQhTw51lKENdNrEqT3,4,2,1,0,1,0,1,0,5,0.7142857142857143,1,0.0,0,1,0,1,2,0,0,1,0,2,3,0
4553,106897,yrxUCbkwiU0Qgu0wZMF5MylHBneN7zri,SpATywNh6bZuzm8s1ceuBUnMUAeoAHHw,15,24,13,5,7,0,3,0,52,7.428571428571429,2,0.0,0,13,5,7,24,0,0,3,0,25,27,0
4554,107984,ZvjGFQSLt8Pf81ZTzV1faPXh7hwFiT2P,bWdj2GDclj5ofokWjzoa5jAwMkxCykd6,5,2,1,0,1,0,2,0,6,0.8571428571428571,1,0.0,0,1,0,1,2,0,0,2,0,2,4,1
4555,108010,Yw9EoSKbruOuBH6aQRkV9fYbTLRt0cv4,RXDvfPUBYFlVdlueBFbLW0mhhAyGEqpt,17,26,14,0,4,33,8,11,96,13.714285714285714,2,0.0,3,14,0,4,23,33,0,8,11,21,75,0
4556,108016,oqv7kZUhC1l3nFsgavJo476khlgSwYid,SpATywNh6bZuzm8s1ceuBUnMUAeoAHHw,1,0,0,0,0,0,1,0,1,0.14285714285714285,1,0.0,0,0,0,0,0,0,0,1,0,0,1,1
4557,108020,0vxEa23unQMrxuymP5mTGCJs9sE8CeTU,SpATywNh6bZuzm8s1ceuBUnMUAeoAHHw,1,0,0,0,0,0,2,0,2,0.2857142857142857,1,0.0,0,0,0,0,0,0,0,2,0,0,2,1
4558,108024,0twK7rhgKGqeqt1sYkdUHMDWvjIusJRc,SpATywNh6bZuzm8s1ceuBUnMUAeoAHHw,7,3,2,0,2,0,2,0,9,1.2857142857142858,1,0.0,0,2,0,2,3,0,0,2,0,4,5,1
4559,108034,2jvZGTQOv5HI5u69PvJ98o1zG3YXhtLw,G8EPVSXsOYB5YQWZGiz1aVq5Pgr2GrQu,14,12,1,38,0,0,3,0,54,7.714285714285714,1,0.0,5,1,34,0,7,0,4,3,0,40,14,1
4560,108042,aF4i8JIBNexmNiVkNsVLybq4ZcEaP7YR,SpATywNh6bZuzm8s1ceuBUnMUAeoAHHw,6,2,1,0,1,0,3,0,7,1.0,1,0.0,0,1,0,1,2,0,0,3,0,2,5,1
4561,108050,eJGGi2xDKgvawXthli4R4Tq9NtEOUzLF,SpATywNh6bZuzm8s1ceuBUnMUAeoAHHw,1,0,0,0,0,0,1,0,1,0.14285714285714285,1,0.0,0,0,0,0,0,0,0,1,0,0,1,1
4562,108052,wBGtqMIqfQE0VLJPhcCJAUkBOhFNa6qW,SpATywNh6bZuzm8s1ceuBUnMUAeoAHHw,8,3,2,0,2,1,6,1,15,2.142857142857143,1,0.0,0,2,0,2,3,1,0,6,1,4,11,1
4563,108071,EboqTOLce3Kcnbr13rePsINEM3noHrcD,G8EPVSXsOYB5YQWZGiz1aVq5Pgr2GrQu,18,13,7,16,4,2,13,6,61,8.714285714285714,3,0.0,1,7,13,4,12,2,3,13,6,25,36,0
4564,108073,RMWokNypcdQUZgRk5KLBAzdNAXoaWUZf,G8EPVSXsOYB5YQWZGiz1aVq5Pgr2GrQu,6,6,1,0,0,1,4,0,12,1.7142857142857142,2,0.0,0,1,0,0,6,1,0,4,0,1,11,1
4565,108131,IBlECzoX8mSOCzZYc1uWUiXexIzVTXM2,SpATywNh6bZuzm8s1ceuBUnMUAeoAHHw,8,5,3,0,2,1,5,0,16,2.2857142857142856,1,0.0,0,3,0,2,5,1,0,5,0,5,11,1
4566,108136,JtMmp5BCDQnYE7CMI3NvnX4aRCZsQW9K,SpATywNh6bZuzm8s1ceuBUnMUAeoAHHw,1,0,0,0,0,0,1,0,1,0.14285714285714285,1,0.0,0,0,0,0,0,0,0,1,0,0,1,1
4567,108150,JtMmp5BCDQnYE7CMI3NvnX4aRCZsQW9K,G8EPVSXsOYB5YQWZGiz1aVq5Pgr2GrQu,1,0,0,0,0,0,1,0,1,0.14285714285714285,1,0.0,0,0,0,0,0,0,0,1,0,0,1,1
4568,108157,qkSLpyUXo3wNVtHKY2foszTLsaaG0zFf,SpATywNh6bZuzm8s1ceuBUnMUAeoAHHw,7,9,5,0,1,0,6,0,21,3.0,1,0.0,0,5,0,1,9,0,0,6,0,6,15,1
4569,108159,7wwnUxCzQI2wyfpl5OyzTa3WTS3Ri45e,A3fsA9Zfv1X2fVEQhTw51lKENdNrEqT3,6,3,1,0,1,0,5,0,10,1.4285714285714286,1,0.0,0,1,0,1,3,0,0,5,0,2,8,1
4570,108176,3uS5WA36Sj3PVBnvxWDx1MwVkWDCgzsS,SpATywNh6bZuzm8s1ceuBUnMUAeoAHHw,2,0,0,0,0,0,2,0,2,0.2857142857142857,1,0.0,0,0,0,0,0,0,0,2,0,0,2,1
4571,108194,BUjI8VQSt0tGyIQBRIK2BBh4HRC6a57H,SpATywNh6bZuzm8s1ceuBUnMUAeoAHHw,7,11,5,0,2,0,4,0,22,3.142857142857143,2,0.0,0,5,0,2,11,0,0,4,0,7,15,1
4572,108212,dbPMzxs1MK4eXxSu7capyuymr7qmuT7h,SpATywNh6bZuzm8s1ceuBUnMUAeoAHHw,13,13,4,12,3,0,3,0,35,5.0,1,0.0,7,4,11,3,6,0,1,3,0,25,10,1
4573,108216,vpqIMSPa2wuLU7jLHJxpKglWXRMFM5XG,G8EPVSXsOYB5YQWZGiz1aVq5Pgr2GrQu,10,6,3,0,3,0,3,0,15,2.142857142857143,1,0.0,1,3,0,3,5,0,0,3,0,7,8,1
4574,108224,Q5TmTVdy8nnH2vTL73s67ZseaCMO3k91,A3fsA9Zfv1X2fVEQhTw51lKENdNrEqT3,22,16,14,22,3,0,15,0,70,10.0,1,0.0,0,14,17,3,16,0,5,15,0,34,36,1
4575,108232,Vuj7KEezi5cbt5TkGTsUazylLOCSeSWW,G8EPVSXsOYB5YQWZGiz1aVq5Pgr2GrQu,6,7,1,0,1,1,5,0,15,2.142857142857143,1,0.0,4,1,0,1,3,1,0,5,0,6,9,1
4576,108238,kacdt9t6znrlEBdAnqrcK2PQA5VKsmyU,bWdj2GDclj5ofokWjzoa5jAwMkxCykd6,1,0,0,0,0,0,1,0,1,0.14285714285714285,1,0.0,0,0,0,0,0,0,0,1,0,0,1,1
4577,108248,GfEp1fhW8V7ekci3T3EdNbH3NBJ6ewC2,bWdj2GDclj5ofokWjzoa5jAwMkxCykd6,10,14,9,0,4,0,6,0,33,4.714285714285714,2,0.0,0,9,0,4,14,0,0,6,0,13,20,1
4578,108249,U86H0D53uFDssNj4hNXQwNhRzNF9WB0g,SpATywNh6bZuzm8s1ceuBUnMUAeoAHHw,10,3,2,0,2,0,5,0,12,1.7142857142857142,2,0.0,0,2,0,2,3,0,0,5,0,4,8,1
4579,108253,ZBWbhIaLqDYBcX3S1kBM4TsAR4PCNgfw,SpATywNh6bZuzm8s1ceuBUnMUAeoAHHw,1,0,0,0,0,0,1,0,1,0.14285714285714285,1,0.0,0,0,0,0,0,0,0,1,0,0,1,1
4580,108260,BKTGezJoHjleu4tXARXtOL0EOZtL4wb9,A3fsA9Zfv1X2fVEQhTw51lKENdNrEqT3,5,6,3,0,0,0,2,0,11,1.5714285714285714,1,0.0,0,3,0,0,6,0,0,2,0,3,8,1
4581,108287,vD0of5WrmeM0o4WJQ1K1mROO3xI4vaqL,A3fsA9Zfv1X2fVEQhTw51lKENdNrEqT3,8,11,9,0,0,0,3,0,23,3.2857142857142856,1,0.0,0,9,0,0,11,0,0,3,0,9,14,1
4582,108322,fDs5TBVrvPHEIMLkBACIVQ2YkCdHCFLD,G8EPVSXsOYB5YQWZGiz1aVq5Pgr2GrQu,1,0,0,0,0,0,1,0,1,0.14285714285714285,1,0.0,0,0,0,0,0,0,0,1,0,0,1,1
4583,108332,t3IeBt0q2KGXGh8PROvXa3GntwInvrsf,SpATywNh6bZuzm8s1ceuBUnMUAeoAHHw,12,19,5,15,3,5,6,0,53,7.571428571428571,1,0.0,14,5,14,3,5,5,1,6,0,36,17,1
4584,108334,OTVmyM3oMOEh3RPUJ9JvZ1cqJuClk9Op,bWdj2GDclj5ofokWjzoa5jAwMkxCykd6,6,5,2,0,1,0,3,0,11,1.5714285714285714,1,0.0,1,2,0,1,4,0,0,3,0,4,7,1
4585,108352,iqv1ZLT0r4OWnPHIoXugw2YP50zRTQ28,SpATywNh6bZuzm8s1ceuBUnMUAeoAHHw,8,4,3,0,2,0,2,0,11,1.5714285714285714,1,0.0,0,3,0,2,4,0,0,2,0,5,6,1
4586,108405,uyomj5PLSD8MuBnIm3UXNOM2zJB1f3kv,A3fsA9Zfv1X2fVEQhTw51lKENdNrEqT3,13,11,1,22,0,0,4,0,38,5.428571428571429,1,0.0,0,1,18,0,11,0,4,4,0,19,19,1
4587,108406,bQyZ6DmGQSg1Dv1lCa5q9TEfeZ36WEXr,SpATywNh6bZuzm8s1ceuBUnMUAeoAHHw,5,2,1,0,1,0,2,0,6,0.8571428571428571,1,0.0,0,1,0,1,2,0,0,2,0,2,4,1
4588,108412,SEiKj37VG0PEpKDpAqYMYNdcODsfurcu,SpATywNh6bZuzm8s1ceuBUnMUAeoAHHw,1,0,0,0,0,0,1,0,1,0.14285714285714285,1,0.0,0,0,0,0,0,0,0,1,0,0,1,1
4589,108421,Z8VFKUoySr9L7FZfGeoeDWQqxwnJbTos,SpATywNh6bZuzm8s1ceuBUnMUAeoAHHw,21,42,1,25,1,8,7,0,84,12.0,3,0.0,11,1,25,1,31,8,0,7,0,38,46,0
4590,108427,xVeg2852GnVdRuLPSlBP0iZfvv9oAoyC,SpATywNh6bZuzm8s1ceuBUnMUAeoAHHw,9,3,2,0,2,1,4,1,13,1.8571428571428572,1,0.0,0,2,0,2,3,1,0,4,1,4,9,1
4591,108446,d08ApNp1WFaPBGXKvD3xbJPFNLpPIfS7,A3fsA9Zfv1X2fVEQhTw51lKENdNrEqT3,1,0,0,0,0,0,1,0,1,0.14285714285714285,1,0.0,0,0,0,0,0,0,0,1,0,0,1,1
4592,108449,dclSFP3hreeLXdhyb5AYWKpQgF9cKZB8,A3fsA9Zfv1X2fVEQhTw51lKENdNrEqT3,1,0,0,0,0,0,2,0,2,0.2857142857142857,1,0.0,0,0,0,0,0,0,0,2,0,0,2,1
4593,108452,Da1XsE2lZHBZahEFVPSmxclehQ2xZK1j,RXDvfPUBYFlVdlueBFbLW0mhhAyGEqpt,1,0,0,0,0,0,2,0,2,0.2857142857142857,2,0.0,0,0,0,0,0,0,0,2,0,0,2,1
4594,108457,AeCrxYByugIwu4XUBpI0LhoTguBozLAa,A3fsA9Zfv1X2fVEQhTw51lKENdNrEqT3,41,26,13,74,10,0,4,0,127,18.142857142857142,2,0.0,1,13,66,10,25,0,8,4,0,90,37,1
4595,108519,Wz77TRcICZ17h9qFLsblYtkOSc4ixQ6c,G8EPVSXsOYB5YQWZGiz1aVq5Pgr2GrQu,11,8,3,0,3,1,6,1,22,3.142857142857143,1,0.0,3,3,0,3,5,1,0,6,1,9,13,1
4596,108541,vZzTgGwK0cR24BSm1xzdfANP52hj4iMk,bWdj2GDclj5ofokWjzoa5jAwMkxCykd6,2,0,0,0,0,0,2,0,2,0.2857142857142857,1,0.0,0,0,0,0,0,0,0,2,0,0,2,1
4597,108543,vZzTgGwK0cR24BSm1xzdfANP52hj4iMk,A3fsA9Zfv1X2fVEQhTw51lKENdNrEqT3,6,4,1,0,0,0,7,0,12,1.7142857142857142,2,0.0,0,1,0,0,4,0,0,7,0,1,11,1
4598,108545,RzzALWvRctgoyhkcvSWQNXbBdfBwiqD5,A3fsA9Zfv1X2fVEQhTw51lKENdNrEqT3,26,11,10,24,8,0,1,0,54,7.714285714285714,1,0.0,0,10,23,8,11,0,1,1,0,41,13,1
4599,108563,cJebZdZYNfcRFrDILULKtUjsVZucvQNZ,A3fsA9Zfv1X2fVEQhTw51lKENdNrEqT3,1,0,0,0,0,0,2,0,2,0.2857142857142857,1,0.0,0,0,0,0,0,0,0,2,0,0,2,1
4600,108568,nMLZADizXQkPbs7I128RAOQN3Z54bNq5,G8EPVSXsOYB5YQWZGiz1aVq5Pgr2GrQu,1,0,0,0,0,0,1,0,1,0.14285714285714285,1,0.0,0,0,0,0,0,0,0,1,0,0,1,1
4601,108580,T96tu0kAAtO9h4UaJoJi1p0l5O91f75g,SpATywNh6bZuzm8s1ceuBUnMUAeoAHHw,1,0,0,0,0,0,1,0,1,0.14285714285714285,1,0.0,0,0,0,0,0,0,0,1,0,0,1,1
4602,108593,b5A378d0kY1phoH7ZEYLGeRu5gSN3Jom,bWdj2GDclj5ofokWjzoa5jAwMkxCykd6,3,3,0,0,0,0,1,0,4,0.5714285714285714,1,0.0,0,0,0,0,3,0,0,1,0,0,4,1
4603,108610,fwSe9M4wVBk21yhnHfi9Elq0Dtd4QFmB,A3fsA9Zfv1X2fVEQhTw51lKENdNrEqT3,1,0,0,0,0,0,1,0,1,0.14285714285714285,1,0.0,0,0,0,0,0,0,0,1,0,0,1,1
4604,108613,8QplB1koC0Z3ESwyMSDlYtTT9MlUMn1q,SpATywNh6bZuzm8s1ceuBUnMUAeoAHHw,15,23,8,17,3,4,3,1,59,8.428571428571429,1,0.0,6,8,15,3,17,4,2,3,1,32,27,1
4605,108618,6pZAnEuoA7RiYeKYKN3oDQwjOWGfm51A,A3fsA9Zfv1X2fVEQhTw51lKENdNrEqT3,6,7,3,0,1,0,2,0,13,1.8571428571428572,1,0.0,0,3,0,1,7,0,0,2,0,4,9,1
4606,108642,kjQDeVPqENR6xvjjKnsVoxY8hUaoqktw,A3fsA9Zfv1X2fVEQhTw51lKENdNrEqT3,1,0,0,0,0,0,1,0,1,0.14285714285714285,1,0.0,0,0,0,0,0,0,0,1,0,0,1,1
4607,108643,hkTx4XunczsnVq4H9eVYRZURkkofvB6I,A3fsA9Zfv1X2fVEQhTw51lKENdNrEqT3,39,22,11,60,8,0,4,0,105,15.0,1,0.0,1,11,48,8,21,0,12,4,0,68,37,1
4608,108645,GC5D689aLkJhzPWQtqYm81ojaLgS2Wpz,A3fsA9Zfv1X2fVEQhTw51lKENdNrEqT3,6,1,0,0,0,0,4,1,6,0.8571428571428571,1,0.0,0,0,0,0,1,0,0,4,1,0,6,1
4609,108650,9RsO9nEnlOjxAtY8xl5lBuOHOGbVMyeg,A3fsA9Zfv1X2fVEQhTw51lKENdNrEqT3,11,9,5,0,4,0,3,0,21,3.0,1,0.0,0,5,0,4,9,0,0,3,0,9,12,1
4610,108658,FAjTaGnsfZLBQS9slQbYMPpuh5mcYxue,SpATywNh6bZuzm8s1ceuBUnMUAeoAHHw,16,14,6,20,0,9,9,1,59,8.428571428571429,2,0.0,4,6,17,0,10,9,3,9,1,27,32,0
4611,108675,EQrILQPubl10Uf5lVjVEtCpelMBJDysL,A3fsA9Zfv1X2fVEQhTw51lKENdNrEqT3,4,2,1,0,1,0,1,0,5,0.7142857142857143,1,0.0,0,1,0,1,2,0,0,1,0,2,3,1
4612,108685,vUg72yuNvNQBasGeqPwQue3GKgSAK3Os,A3fsA9Zfv1X2fVEQhTw51lKENdNrEqT3,43,13,11,70,10,6,5,1,116,16.571428571428573,1,0.0,1,11,61,10,12,6,9,5,1,83,33,1
4613,108690,Ofc6ixmmoavYN92PkloL7C1g0H36jbU2,bWdj2GDclj5ofokWjzoa5jAwMkxCykd6,5,2,1,0,1,0,2,0,6,0.8571428571428571,1,0.0,0,1,0,1,2,0,0,2,0,2,4,1
4614,108691,ETnDIYS5Ij7vrZAmbXEAqG1htLhXjsuH,SpATywNh6bZuzm8s1ceuBUnMUAeoAHHw,2,0,0,0,0,0,3,0,3,0.42857142857142855,1,0.0,0,0,0,0,0,0,0,3,0,0,3,1
4615,108692,Ofc6ixmmoavYN92PkloL7C1g0H36jbU2,RXDvfPUBYFlVdlueBFbLW0mhhAyGEqpt,5,3,1,0,1,0,2,0,7,1.0,1,0.0,0,1,0,1,3,0,0,2,0,2,5,1
4616,108709,WVlATpkkXvQVe3Tvai8IoxKvCeKjRiIw,A3fsA9Zfv1X2fVEQhTw51lKENdNrEqT3,4,2,1,0,1,0,1,0,5,0.7142857142857143,1,0.0,0,1,0,1,2,0,0,1,0,2,3,1
4617,108716,vEKYOhRdGZ59kfXY6wTO63YZY4EqPYqX,A3fsA9Zfv1X2fVEQhTw51lKENdNrEqT3,1,0,0,0,0,0,2,0,2,0.2857142857142857,1,0.0,0,0,0,0,0,0,0,2,0,0,2,1
4618,108726,SjPvBG8Fb7d7fOOQdZd3mlZyesFaFzzS,SpATywNh6bZuzm8s1ceuBUnMUAeoAHHw,12,16,4,9,3,8,1,0,41,5.857142857142857,1,0.0,11,4,9,3,5,8,0,1,0,27,14,1
4619,108730,APkKPEpve0ecRJut2qy8IYwsafYtrJRq,A3fsA9Zfv1X2fVEQhTw51lKENdNrEqT3,1,0,0,0,0,0,1,0,1,0.14285714285714285,1,0.0,0,0,0,0,0,0,0,1,0,0,1,1
4620,108759,bhb17IwRClCqRNHE7gBYbr4QuZbINJH7,SpATywNh6bZuzm8s1ceuBUnMUAeoAHHw,8,2,1,0,1,0,4,1,9,1.2857142857142858,1,0.0,0,1,0,1,2,0,0,4,1,2,7,1
4621,108770,i91HA7YyZRSQdFHabHG3p2UNPo1UnEE9,SpATywNh6bZuzm8s1ceuBUnMUAeoAHHw,6,0,0,0,0,1,5,1,7,1.0,1,0.0,0,0,0,0,0,1,0,5,1,0,7,1
4622,108777,jqvna1BzHcNX8F2L51mHo8iTsRvtrp5h,G8EPVSXsOYB5YQWZGiz1aVq5Pgr2GrQu,5,2,0,0,0,0,3,1,6,0.8571428571428571,1,0.0,0,0,0,0,2,0,0,3,1,0,6,1
4623,108783,XJEGQFjl8bj0TlozEJx10miZtxUTAzR8,G8EPVSXsOYB5YQWZGiz1aVq5Pgr2GrQu,6,5,2,0,0,0,2,0,9,1.2857142857142858,1,0.0,0,2,0,0,5,0,0,2,0,2,7,1
4624,108788,lE2eUyNgAborZHVo0d0toAQgs9JY0elm,bWdj2GDclj5ofokWjzoa5jAwMkxCykd6,1,0,0,0,0,0,1,0,1,0.14285714285714285,1,0.0,0,0,0,0,0,0,0,1,0,0,1,1
4625,108794,YpN0FUGuAT4i4OgsV1AMvBTJ03FCi4h4,SpATywNh6bZuzm8s1ceuBUnMUAeoAHHw,13,19,6,19,3,0,1,0,48,6.857142857142857,1,0.0,11,6,18,3,8,0,1,1,0,38,10,1
4626,108802,G6Ra4LKWBFlkpiQLwJKXdjsFL1NYBNU7,SpATywNh6bZuzm8s1ceuBUnMUAeoAHHw,8,10,7,0,4,0,8,1,30,4.285714285714286,1,0.0,0,7,0,4,10,0,0,8,1,11,19,1
4627,108816,7tzKJch94HYBj1yvg1gEwizifcqZuqol,SpATywNh6bZuzm8s1ceuBUnMUAeoAHHw,14,16,8,9,5,11,6,2,57,8.142857142857142,1,0.0,7,8,9,5,9,11,0,6,2,29,28,1
4628,108817,JJML5NgT9kE9CQ1mkNivVNVP1TfRNDmZ,G8EPVSXsOYB5YQWZGiz1aVq5Pgr2GrQu,10,11,3,0,3,0,3,0,20,2.857142857142857,2,0.0,5,3,0,3,6,0,0,3,0,11,9,1
4629,108819,y2DmmWW7ijkXHglZV8tDd3ydHBY1lyEP,SpATywNh6bZuzm8s1ceuBUnMUAeoAHHw,11,7,2,12,1,6,5,1,34,4.857142857142857,1,0.0,4,2,12,1,3,6,0,5,1,19,15,1
4630,108823,ToFnQfVVYpsgtNup5oaVFrzJEXqZqLe7,SpATywNh6bZuzm8s1ceuBUnMUAeoAHHw,4,3,1,0,1,0,1,0,6,0.8571428571428571,1,0.0,0,1,0,1,3,0,0,1,0,2,4,1
4631,108832,fZ0FA06F54ZxAJdajcaJsw9dO9sZFuoy,SpATywNh6bZuzm8s1ceuBUnMUAeoAHHw,8,3,2,0,2,2,4,1,14,2.0,1,0.0,0,2,0,2,3,2,0,4,1,4,10,1
4632,108836,S2vZm8iaot7LbfQexObVqVFppwpxyTJj,RXDvfPUBYFlVdlueBFbLW0mhhAyGEqpt,13,9,1,0,1,2,7,2,22,3.142857142857143,1,0.0,0,1,0,1,9,2,0,7,2,2,20,1
4633,108840,Gmz5iMjiwcyTx4KusyWM0rOecmUutZaf,bWdj2GDclj5ofokWjzoa5jAwMkxCykd6,7,4,2,0,1,0,3,0,10,1.4285714285714286,1,0.0,0,2,0,1,4,0,0,3,0,3,7,1
4634,108848,Aj8S98OGNNNrJMemSZdPdZipwwjNd5vE,A3fsA9Zfv1X2fVEQhTw51lKENdNrEqT3,8,7,3,0,3,0,1,0,14,2.0,1,0.0,0,3,0,3,7,0,0,1,0,6,8,0
4635,108863,rFLx9fxaxLoqhUJucYhN0TS80ql3o0el,G8EPVSXsOYB5YQWZGiz1aVq5Pgr2GrQu,6,3,2,0,2,4,1,0,12,1.7142857142857142,1,0.0,0,2,0,2,3,4,0,1,0,4,8,1
4636,108870,EyBRRLQ9lC714P9pZPb13KmtdxaOzX2x,A3fsA9Zfv1X2fVEQhTw51lKENdNrEqT3,5,2,1,0,1,0,2,0,6,0.8571428571428571,1,0.0,0,1,0,1,2,0,0,2,0,2,4,1
4637,108881,wKWD0CLruBoVWyxPKWZ61pmQ3HoT2Bog,SpATywNh6bZuzm8s1ceuBUnMUAeoAHHw,4,2,0,0,0,0,2,0,4,0.5714285714285714,1,0.0,0,0,0,0,2,0,0,2,0,0,4,1
4638,108896,rFLx9fxaxLoqhUJucYhN0TS80ql3o0el,SpATywNh6bZuzm8s1ceuBUnMUAeoAHHw,6,3,2,0,2,14,1,0,22,3.142857142857143,1,0.0,0,2,0,2,3,14,0,1,0,4,18,1
4639,108911,IcSi6sLfpSlHjHhdlf5rd2h3NSptZDO1,A3fsA9Zfv1X2fVEQhTw51lKENdNrEqT3,1,0,0,0,0,0,2,0,2,0.2857142857142857,1,0.0,0,0,0,0,0,0,0,2,0,0,2,1
4640,108918,vSo169SOn6AJKRTPbSllZALjmnCkOElL,G8EPVSXsOYB5YQWZGiz1aVq5Pgr2GrQu,12,28,4,0,3,1,23,1,60,8.571428571428571,3,0.0,0,4,0,3,28,1,0,23,1,7,53,1
4641,108937,GrD7pvZobVcyydLOoZLt2XOTjKEE4rVN,A3fsA9Zfv1X2fVEQhTw51lKENdNrEqT3,1,0,0,0,0,0,1,0,1,0.14285714285714285,1,0.0,0,0,0,0,0,0,0,1,0,0,1,1
4642,108940,4JgrlxTTs75mHh4mrh8qrfNDEELryL3p,A3fsA9Zfv1X2fVEQhTw51lKENdNrEqT3,22,30,13,0,10,0,5,0,58,8.285714285714286,1,0.0,0,13,0,10,30,0,0,5,0,23,35,1
4643,108943,tBILMisvPJumSCkGoqvXZmjsWBPsAhcx,RXDvfPUBYFlVdlueBFbLW0mhhAyGEqpt,1,0,0,0,0,0,1,0,1,0.14285714285714285,1,0.0,0,0,0,0,0,0,0,1,0,0,1,1
4644,108949,jcbtaVIpxYLzIPm0BM5PQEVvcUjaS5Wk,SpATywNh6bZuzm8s1ceuBUnMUAeoAHHw,5,2,1,0,1,0,4,0,8,1.1428571428571428,2,0.0,0,1,0,1,2,0,0,4,0,2,6,1
4645,108954,kLrl7hvNIzvhv6K321CFhgLYEgDfA62M,A3fsA9Zfv1X2fVEQhTw51lKENdNrEqT3,3,3,1,0,0,0,1,0,5,0.7142857142857143,1,0.0,0,1,0,0,3,0,0,1,0,1,4,1
4646,108956,cQImh85eb0T3yUp3SL5f7uBssRRbM6Re,A3fsA9Zfv1X2fVEQhTw51lKENdNrEqT3,9,9,1,0,1,0,3,0,14,2.0,1,0.0,0,1,0,1,9,0,0,3,0,2,12,1
4647,108964,a5FYs3qIaiIKIJ0gF2U8byHoJI2aZV3O,SpATywNh6bZuzm8s1ceuBUnMUAeoAHHw,2,0,0,0,0,0,2,0,2,0.2857142857142857,1,0.0,0,0,0,0,0,0,0,2,0,0,2,1
4648,108986,YCpaFH59BZea33ilZmurVIrcGKs7kkSW,A3fsA9Zfv1X2fVEQhTw51lKENdNrEqT3,8,7,5,0,0,1,4,2,19,2.7142857142857144,1,0.0,0,5,0,0,7,1,0,4,2,5,14,1
4649,109051,QzYbn86ruFNwqcTxxFURk0zGhEatBUQQ,RXDvfPUBYFlVdlueBFbLW0mhhAyGEqpt,1,0,0,0,0,0,1,0,1,0.14285714285714285,1,0.0,0,0,0,0,0,0,0,1,0,0,1,1
4650,109052,YQuE8HipF2FTxF6yilCc6Hjt2hO1hf9q,A3fsA9Zfv1X2fVEQhTw51lKENdNrEqT3,14,6,4,0,3,3,9,2,27,3.857142857142857,1,0.0,0,4,0,3,6,3,0,9,2,7,20,1
4651,109053,L7J2caDjAzkqOGAjsx5a9Dl5Aldyaum1,G8EPVSXsOYB5YQWZGiz1aVq5Pgr2GrQu,20,15,10,40,5,0,6,0,76,10.857142857142858,1,0.0,5,10,35,5,10,0,5,6,0,55,21,1
4652,109068,XkjQH424HqtaqeKw3sfi1hEAdISSsUfo,SpATywNh6bZuzm8s1ceuBUnMUAeoAHHw,5,2,1,0,1,0,2,0,6,0.8571428571428571,1,0.0,0,1,0,1,2,0,0,2,0,2,4,1
4653,109076,rqibqLTSyQMTu8RtpalbPrVfa4YBNses,A3fsA9Zfv1X2fVEQhTw51lKENdNrEqT3,1,0,0,0,0,0,1,0,1,0.14285714285714285,1,0.0,0,0,0,0,0,0,0,1,0,0,1,1
4654,109083,eRuuxh46RK1wEtA4qinnmcAexePgrgfl,A3fsA9Zfv1X2fVEQhTw51lKENdNrEqT3,2,0,0,0,0,0,4,0,4,0.5714285714285714,1,0.0,0,0,0,0,0,0,0,4,0,0,4,1
4655,109094,W72vMFAqWF3rx04XbAdkI4z1Q7B2JuRi,A3fsA9Zfv1X2fVEQhTw51lKENdNrEqT3,6,2,1,0,1,1,3,0,8,1.1428571428571428,1,0.0,0,1,0,1,2,1,0,3,0,2,6,1
4656,109103,MZomFQTbHAKaDGd0B9fv7KQ9MRsZJ7m6,A3fsA9Zfv1X2fVEQhTw51lKENdNrEqT3,7,7,2,0,1,0,4,0,14,2.0,2,0.0,0,2,0,1,7,0,0,4,0,3,11,1
4657,109113,PsjDYcq0jr7p5zzKT5Q6GyQwL0TaEGxZ,SpATywNh6bZuzm8s1ceuBUnMUAeoAHHw,1,0,0,0,0,0,1,0,1,0.14285714285714285,1,0.0,0,0,0,0,0,0,0,1,0,0,1,1
4658,109133,ktJXKKINyOPjiCF3mohYZXSugYepgG15,bWdj2GDclj5ofokWjzoa5jAwMkxCykd6,6,2,0,0,0,2,4,2,10,1.4285714285714286,1,0.0,0,0,0,0,2,2,0,4,2,0,10,1
4659,109134,V9A9B2T9pRTU3AqvpqzuKs4MfRcAEte2,A3fsA9Zfv1X2fVEQhTw51lKENdNrEqT3,10,21,13,0,10,0,9,0,53,7.571428571428571,2,0.0,0,13,0,10,21,0,0,9,0,23,30,1
4660,109141,cj6ogEjauZu0hDMlOaFW3lBaL32xGBVV,A3fsA9Zfv1X2fVEQhTw51lKENdNrEqT3,33,18,0,44,0,1,5,0,68,9.714285714285714,1,0.0,1,0,44,0,17,1,0,5,0,45,23,1
4661,109159,qflx2gEpsoPySBX8xNwFSgJhYyLnWK68,SpATywNh6bZuzm8s1ceuBUnMUAeoAHHw,5,2,1,0,1,0,2,0,6,0.8571428571428571,1,0.0,0,1,0,1,2,0,0,2,0,2,4,1
4662,109160,BjBet1XrpmufRo3nJSBrADvKxDiooNdd,SpATywNh6bZuzm8s1ceuBUnMUAeoAHHw,17,19,9,10,6,4,6,2,56,8.0,1,0.0,8,9,9,6,11,4,1,6,2,32,24,0
4663,109168,75JIeVMZStYpkimfm5Z5dMpV25aOohZB,A3fsA9Zfv1X2fVEQhTw51lKENdNrEqT3,1,0,0,0,0,0,1,0,1,0.14285714285714285,1,0.0,0,0,0,0,0,0,0,1,0,0,1,1
4664,109175,3HlwwUK8TRPXkUKapLyYM8Mklh9O7Jts,SpATywNh6bZuzm8s1ceuBUnMUAeoAHHw,1,0,0,0,0,0,1,0,1,0.14285714285714285,1,0.0,0,0,0,0,0,0,0,1,0,0,1,1
4665,109197,JWGtW72K75u0pLec4sms8rsOXm4SeKAG,SpATywNh6bZuzm8s1ceuBUnMUAeoAHHw,15,27,10,15,2,8,11,1,74,10.571428571428571,3,0.0,12,10,12,2,15,8,3,11,1,36,38,1
4666,109229,txSjWYX3TEWx5QLOiaADcbFdCZMHt7yE,A3fsA9Zfv1X2fVEQhTw51lKENdNrEqT3,8,5,0,0,0,0,4,3,12,1.7142857142857142,1,0.0,0,0,0,0,5,0,0,4,3,0,12,0
4667,109249,xHkJ6XK0y35MSFhta6m6oK3R3vwlFDsX,SpATywNh6bZuzm8s1ceuBUnMUAeoAHHw,6,3,1,0,1,0,2,0,7,1.0,1,0.0,0,1,0,1,3,0,0,2,0,2,5,1
4668,109255,N8EIkrIEEI0tSrQnptuBZRzWsVxCnAJ9,bWdj2GDclj5ofokWjzoa5jAwMkxCykd6,1,0,0,0,0,0,1,0,1,0.14285714285714285,1,0.0,0,0,0,0,0,0,0,1,0,0,1,1
4669,109285,PTDwgRsRPDT7EScAgKe30PHvW2ZEf3hf,SpATywNh6bZuzm8s1ceuBUnMUAeoAHHw,1,0,0,0,0,0,1,0,1,0.14285714285714285,1,0.0,0,0,0,0,0,0,0,1,0,0,1,1
4670,109288,J2q8zoWRny7YrAZZQIJQYIKpfAnrsg3t,SpATywNh6bZuzm8s1ceuBUnMUAeoAHHw,18,26,10,19,5,11,10,1,82,11.714285714285714,2,0.0,12,10,16,5,14,11,3,10,1,43,39,1
4671,109294,Qs7Gy3lEvMM83esFdoZ1zZvUeRYTAxxM,A3fsA9Zfv1X2fVEQhTw51lKENdNrEqT3,1,0,0,0,0,0,2,0,2,0.2857142857142857,1,0.0,0,0,0,0,0,0,0,2,0,0,2,1
4672,109308,giXuT5U1RtMqgo8IXt5j9x4mrlpr0AWq,bWdj2GDclj5ofokWjzoa5jAwMkxCykd6,10,22,2,28,3,0,17,0,72,10.285714285714286,4,0.0,6,2,26,3,16,0,2,17,0,37,35,1
4673,109309,WAUVjfvcVVKr4l1eRzgNNfyqoF4mUwKn,SpATywNh6bZuzm8s1ceuBUnMUAeoAHHw,20,27,18,17,5,0,8,0,75,10.714285714285714,2,0.0,4,18,15,5,23,0,2,8,0,42,33,1
4674,109323,h7wsu0U7FXIgaCVLolzif2WMIHfC12Bp,RXDvfPUBYFlVdlueBFbLW0mhhAyGEqpt,9,6,0,0,0,0,4,0,10,1.4285714285714286,2,0.0,0,0,0,0,6,0,0,4,0,0,10,1
4675,109342,obFxfGLSP12hWUYqYGw1SR5lINNLUPlg,SpATywNh6bZuzm8s1ceuBUnMUAeoAHHw,13,26,10,10,5,0,2,0,53,7.571428571428571,1,0.0,6,10,9,5,20,0,1,2,0,30,23,1
4676,109357,E3qy0Aw6hJTYQ75juho52GdWukHpC8PO,A3fsA9Zfv1X2fVEQhTw51lKENdNrEqT3,38,32,15,70,9,0,1,0,127,18.142857142857142,1,0.0,3,15,58,9,29,0,12,1,0,85,42,1
4677,109362,GzwlErGyP5vVrMuPju1CoSG91uAwN5Ll,A3fsA9Zfv1X2fVEQhTw51lKENdNrEqT3,1,0,0,0,0,0,1,0,1,0.14285714285714285,1,0.0,0,0,0,0,0,0,0,1,0,0,1,1
4678,109370,PgyyNRYpQtA302ymgWhOo3FWJ5ZVr14a,A3fsA9Zfv1X2fVEQhTw51lKENdNrEqT3,9,2,1,0,1,1,9,1,15,2.142857142857143,1,0.0,0,1,0,1,2,1,0,9,1,2,13,1
4679,109386,wRfMgDoh08sOJ1iN7xQ6xWeUhnvT3LS5,SpATywNh6bZuzm8s1ceuBUnMUAeoAHHw,5,2,1,0,1,0,4,0,8,1.1428571428571428,1,0.0,1,1,0,1,1,0,0,4,0,3,5,1
4680,109397,fwSe9M4wVBk21yhnHfi9Elq0Dtd4QFmB,bWdj2GDclj5ofokWjzoa5jAwMkxCykd6,5,3,1,0,1,0,2,0,7,1.0,1,0.0,0,1,0,1,3,0,0,2,0,2,5,1
4681,109399,r9Iw8qv5Gd0slmKCVr3aUz7TALROG0cf,bWdj2GDclj5ofokWjzoa5jAwMkxCykd6,1,0,0,0,0,0,1,0,1,0.14285714285714285,1,0.0,0,0,0,0,0,0,0,1,0,0,1,1
4682,109400,9uGUU0TH4lqYEkuGLK9jp9MwW0oSvGiG,A3fsA9Zfv1X2fVEQhTw51lKENdNrEqT3,9,4,1,0,1,10,8,2,26,3.7142857142857144,3,0.0,0,1,0,1,4,10,0,8,2,2,24,1
4683,109426,Sq3omHTGoSF2f0DuMM8gp5rI7SBr6tWj,A3fsA9Zfv1X2fVEQhTw51lKENdNrEqT3,20,8,8,0,8,0,4,0,28,4.0,2,0.0,0,8,0,8,8,0,0,4,0,16,12,1
4684,109429,HoFYxRSokx9ZKuDwytJP5rWsXC8CIKJC,A3fsA9Zfv1X2fVEQhTw51lKENdNrEqT3,30,7,4,44,2,3,9,1,70,10.0,1,0.0,1,4,42,2,6,3,2,9,1,49,21,1
4685,109431,1UiNR1aBQTbqc6GjmZAuykRrYIV3jOJO,SpATywNh6bZuzm8s1ceuBUnMUAeoAHHw,7,3,1,0,1,2,4,1,12,1.7142857142857142,1,0.0,1,1,0,1,2,2,0,4,1,3,9,1
4686,109442,uMcGJbFLkrWwli3FYGfWHtIVPBjXGyBh,SpATywNh6bZuzm8s1ceuBUnMUAeoAHHw,1,0,0,0,0,0,1,0,1,0.14285714285714285,1,0.0,0,0,0,0,0,0,0,1,0,0,1,1
4687,109459,AFA8ekqoAZiNztO6KW91x6d2D9lFcQ7X,RXDvfPUBYFlVdlueBFbLW0mhhAyGEqpt,5,1,0,0,1,0,5,0,7,1.0,1,0.0,0,0,0,1,1,0,0,5,0,1,6,1
4688,109468,An4Cs2oUOz8lYcIplHFLdygweoh5kMIV,A3fsA9Zfv1X2fVEQhTw51lKENdNrEqT3,8,5,1,0,1,0,2,0,9,1.2857142857142858,1,0.0,0,1,0,1,5,0,0,2,0,2,7,1
4689,109494,dvvW9sSxW5mjEruYpucTZ2qRrmMv8qM8,SpATywNh6bZuzm8s1ceuBUnMUAeoAHHw,4,2,1,0,0,1,2,0,6,0.8571428571428571,1,0.0,0,1,0,0,2,1,0,2,0,1,5,1
4690,109497,CB1M4aW1J3aRGdW8HkF8tezfCYyk7Eoq,RXDvfPUBYFlVdlueBFbLW0mhhAyGEqpt,12,8,6,0,5,0,4,0,23,3.2857142857142856,3,0.0,0,6,0,5,8,0,0,4,0,11,12,1
4691,109501,eAowQ45OiNPPsLkfxUtBSZ5lhWPhAgzz,SpATywNh6bZuzm8s1ceuBUnMUAeoAHHw,5,2,0,0,0,1,5,0,8,1.1428571428571428,1,0.0,0,0,0,0,2,1,0,5,0,0,8,1
4692,109507,IgPmhYztZgoutItcrcEcsnhrRrb2KvYs,A3fsA9Zfv1X2fVEQhTw51lKENdNrEqT3,9,17,3,0,1,0,6,0,27,3.857142857142857,1,0.0,0,3,0,1,17,0,0,6,0,4,23,1
4693,109508,pKS0bXWim4kclZTTgr34KULrUojenqdP,SpATywNh6bZuzm8s1ceuBUnMUAeoAHHw,1,0,0,0,0,0,1,0,1,0.14285714285714285,1,0.0,0,0,0,0,0,0,0,1,0,0,1,1
4694,109526,wZ6yWCylvqNezqFzx20ftEJc7jYDipih,A3fsA9Zfv1X2fVEQhTw51lKENdNrEqT3,16,9,7,0,5,0,8,0,29,4.142857142857143,2,0.0,1,7,0,5,8,0,0,8,0,13,16,1
4695,109536,Cv1aavObJnuABKfipF6OGePzg0BnGPFs,SpATywNh6bZuzm8s1ceuBUnMUAeoAHHw,11,11,4,14,0,1,16,0,46,6.571428571428571,5,0.0,7,4,14,0,4,1,0,16,0,25,21,1
4696,109538,Cv1aavObJnuABKfipF6OGePzg0BnGPFs,A3fsA9Zfv1X2fVEQhTw51lKENdNrEqT3,41,8,6,156,0,0,10,0,180,25.714285714285715,4,0.0,2,6,156,0,6,0,0,10,0,164,16,1
4697,109542,UzfhQlNSIoLM6AVYNl7JKilqEEtlOXJC,bWdj2GDclj5ofokWjzoa5jAwMkxCykd6,13,17,7,26,3,0,8,0,61,8.714285714285714,4,0.0,2,7,23,3,15,0,3,8,0,35,26,1
4698,109543,Cv1aavObJnuABKfipF6OGePzg0BnGPFs,bWdj2GDclj5ofokWjzoa5jAwMkxCykd6,21,13,7,96,0,0,10,0,126,18.0,4,0.0,6,7,93,0,7,0,3,10,0,106,20,1
4699,109586,tnFgBBhxwl3ThYwRfbs1nBP0c5GsC0Nt,G8EPVSXsOYB5YQWZGiz1aVq5Pgr2GrQu,6,2,1,0,1,0,3,0,7,1.0,1,0.0,0,1,0,1,2,0,0,3,0,2,5,1
4700,109588,4QzNBqELMiYit65uUaxWvkflyE9kKEti,RXDvfPUBYFlVdlueBFbLW0mhhAyGEqpt,45,39,24,58,11,0,4,0,136,19.428571428571427,2,0.0,7,24,57,11,32,0,1,4,0,99,37,1
4701,109596,yH5UPr6OYjoduVn8gG4Lqcccv4nGJLGC,A3fsA9Zfv1X2fVEQhTw51lKENdNrEqT3,5,3,2,0,0,0,2,0,7,1.0,1,0.0,0,2,0,0,3,0,0,2,0,2,5,1
4702,109617,47U1Ft55cUwsb6d6kZ6WNRfAgXy0966b,A3fsA9Zfv1X2fVEQhTw51lKENdNrEqT3,20,12,8,18,5,0,3,0,46,6.571428571428571,1,0.0,0,8,16,5,12,0,2,3,0,29,17,1
4703,109630,OnyZH4F3oW4crdu4EYjgcCg5L4Cq5yIA,A3fsA9Zfv1X2fVEQhTw51lKENdNrEqT3,6,11,1,0,1,0,1,0,14,2.0,1,0.0,0,1,0,1,11,0,0,1,0,2,12,1
4704,109633,CxbJpiz9m1eHAB0gIyTtLs7Pvx86qvPB,A3fsA9Zfv1X2fVEQhTw51lKENdNrEqT3,15,26,15,0,7,4,9,0,61,8.714285714285714,2,0.0,0,15,0,7,26,4,0,9,0,22,39,1
4705,109635,S7YgWZv0zfBDCXesrYQobA6r2Ns5N7Tq,A3fsA9Zfv1X2fVEQhTw51lKENdNrEqT3,2,0,0,0,0,0,4,0,4,0.5714285714285714,1,0.0,0,0,0,0,0,0,0,4,0,0,4,1
4706,109645,t36cT9Msm4Hh3sPjMIr6iaOAbn6g4BQN,bWdj2GDclj5ofokWjzoa5jAwMkxCykd6,7,8,3,2,0,0,7,0,20,2.857142857142857,2,0.0,4,3,2,0,4,0,0,7,0,9,11,1
4707,109661,vlxKYuyoAuMqS1coFL9iKQUv0EZG5cjH,RXDvfPUBYFlVdlueBFbLW0mhhAyGEqpt,13,16,10,0,3,13,10,2,54,7.714285714285714,2,0.0,2,10,0,3,14,13,0,10,2,15,39,1
4708,109662,tVIaEH9O89RTqDCRllWVA85ShLX4ujE7,SpATywNh6bZuzm8s1ceuBUnMUAeoAHHw,7,12,6,0,1,0,6,0,25,3.5714285714285716,1,0.0,3,6,0,1,9,0,0,6,0,10,15,1
4709,109663,yNBmodc8EXXXXDprMuN3jSh3qPXFcpn8,SpATywNh6bZuzm8s1ceuBUnMUAeoAHHw,10,11,6,0,3,1,3,0,24,3.4285714285714284,1,0.0,0,6,0,3,11,1,0,3,0,9,15,1
4710,109677,Wq5vw9D8EzxIbQ18OklpNCvzPZVsfETA,G8EPVSXsOYB5YQWZGiz1aVq5Pgr2GrQu,6,2,1,0,1,0,2,0,6,0.8571428571428571,1,0.0,0,1,0,1,2,0,0,2,0,2,4,1
4711,109688,TQrIrIwuSwem0ov7co8TUDqNlQcIvB5k,SpATywNh6bZuzm8s1ceuBUnMUAeoAHHw,15,28,11,6,3,8,3,0,59,8.428571428571429,1,0.0,4,11,6,3,24,8,0,3,0,24,35,1
4712,109696,1IVW102tL25hf5DslCWoTGf8umKhKStK,A3fsA9Zfv1X2fVEQhTw51lKENdNrEqT3,9,4,3,0,3,0,2,0,12,1.7142857142857142,1,0.0,1,3,0,3,3,0,0,2,0,7,5,1
4713,109697,pGYP47am2d3xk9zOKdaE6fuoOc52iQiA,A3fsA9Zfv1X2fVEQhTw51lKENdNrEqT3,58,40,0,150,0,0,11,0,201,28.714285714285715,4,0.0,6,0,130,0,34,0,20,11,0,136,65,1
4714,109726,YsCj2vq22thtrABlGTiHQmd1Rq7WC2yD,G8EPVSXsOYB5YQWZGiz1aVq5Pgr2GrQu,1,0,0,0,0,0,1,0,1,0.14285714285714285,1,0.0,0,0,0,0,0,0,0,1,0,0,1,1
4715,109736,Pw5qvLGpB0h5kMFVFGpEeHaRx9RXaDPK,A3fsA9Zfv1X2fVEQhTw51lKENdNrEqT3,14,8,6,0,5,0,4,0,23,3.2857142857142856,2,0.0,0,6,0,5,8,0,0,4,0,11,12,1
4716,109762,Ag1hVTrJxORxsKul36O8LJkzu7JsNNWP,SpATywNh6bZuzm8s1ceuBUnMUAeoAHHw,14,21,9,10,7,0,6,2,55,7.857142857142857,2,0.0,7,9,9,7,14,0,1,6,2,32,23,1
4717,109765,MJcUUCn8PV6c1s6azIezqfn8QYa8QKmD,SpATywNh6bZuzm8s1ceuBUnMUAeoAHHw,1,0,0,0,0,0,1,0,1,0.14285714285714285,1,0.0,0,0,0,0,0,0,0,1,0,0,1,1
4718,109788,YK9goZgoN0rvofZU4YE46jMvnter3goc,G8EPVSXsOYB5YQWZGiz1aVq5Pgr2GrQu,8,7,3,0,2,1,3,0,16,2.2857142857142856,1,0.0,2,3,0,2,5,1,0,3,0,7,9,1
4719,109790,p7ttFbRCERCwhTg2CGSQKJTx8BwPrv0X,SpATywNh6bZuzm8s1ceuBUnMUAeoAHHw,16,15,7,12,3,0,5,0,42,6.0,1,0.0,8,7,12,3,7,0,0,5,0,30,12,1
4720,109797,BvGZp7WaxxtjkCv9TCLYGxFTwKxW9SN6,SpATywNh6bZuzm8s1ceuBUnMUAeoAHHw,1,0,0,0,0,0,1,0,1,0.14285714285714285,1,0.0,0,0,0,0,0,0,0,1,0,0,1,1
4721,109798,K1BSnyoMMyobTomJrER9oQIG5DUTaz3Q,SpATywNh6bZuzm8s1ceuBUnMUAeoAHHw,4,2,1,0,0,0,2,0,5,0.7142857142857143,1,0.0,0,1,0,0,2,0,0,2,0,1,4,1
4722,109817,S9Szq6g9ved8FvqRXhj5wFkk1JBdWVxm,SpATywNh6bZuzm8s1ceuBUnMUAeoAHHw,16,33,14,4,7,2,16,7,83,11.857142857142858,2,0.0,13,14,4,7,20,2,0,16,7,38,45,1
4723,109822,kNz6Otgr0OzNKmI1vQVj8WSVh9NxP9ty,A3fsA9Zfv1X2fVEQhTw51lKENdNrEqT3,13,5,3,0,3,7,10,3,31,4.428571428571429,2,0.0,1,3,0,3,4,7,0,10,3,7,24,1
4724,109838,5G14OqJhAMEtcEWhkGrUvPjxVR4dIAwN,SpATywNh6bZuzm8s1ceuBUnMUAeoAHHw,9,17,1,0,1,1,5,1,26,3.7142857142857144,1,0.0,12,1,0,1,5,1,0,5,1,14,12,1
4725,109844,hvsRGWJp5579jHaZrBOzJk6TUYpgGqDO,A3fsA9Zfv1X2fVEQhTw51lKENdNrEqT3,10,5,4,0,4,0,1,0,14,2.0,1,0.0,0,4,0,4,5,0,0,1,0,8,6,1
4726,109892,mbcohNJJNHml8jzBeHm74GmBbBH9udey,bWdj2GDclj5ofokWjzoa5jAwMkxCykd6,1,0,0,0,0,0,1,0,1,0.14285714285714285,1,0.0,0,0,0,0,0,0,0,1,0,0,1,1
4727,109897,YQYuuodMZUFMR21jPqGx2gjrHZSeRDRA,A3fsA9Zfv1X2fVEQhTw51lKENdNrEqT3,18,17,7,0,6,0,10,0,40,5.714285714285714,4,0.0,0,7,0,6,17,0,0,10,0,13,27,1
4728,109901,mbcohNJJNHml8jzBeHm74GmBbBH9udey,A3fsA9Zfv1X2fVEQhTw51lKENdNrEqT3,1,0,0,0,0,0,1,0,1,0.14285714285714285,1,0.0,0,0,0,0,0,0,0,1,0,0,1,1
4729,109908,HCwGALsXdQRvdnW9Y1SicRkbFYJcehRz,G8EPVSXsOYB5YQWZGiz1aVq5Pgr2GrQu,12,17,2,4,1,4,5,0,33,4.714285714285714,2,0.0,6,2,3,1,11,4,1,5,0,12,21,0
4730,109914,y8NaQIDe3D7l0VzaS1fuEDzV6bcaTY0g,bWdj2GDclj5ofokWjzoa5jAwMkxCykd6,4,2,1,0,1,0,1,0,5,0.7142857142857143,1,0.0,0,1,0,1,2,0,0,1,0,2,3,1
4731,109927,CwyOL3RMOVLomxrxyN9D4jPa9R0iWrS5,bWdj2GDclj5ofokWjzoa5jAwMkxCykd6,12,14,9,16,5,0,9,0,53,7.571428571428571,1,0.0,2,9,16,5,12,0,0,9,0,32,21,1
4732,109942,69mjZoNGtUdd47OHaI2iQubsVwSBE5CT,A3fsA9Zfv1X2fVEQhTw51lKENdNrEqT3,7,9,4,0,2,0,4,0,19,2.7142857142857144,1,0.0,0,4,0,2,9,0,0,4,0,6,13,1
4733,109946,mdF4VSOHdhU4Fo37q40c5lLreOU7ezPS,A3fsA9Zfv1X2fVEQhTw51lKENdNrEqT3,8,5,3,0,0,1,8,1,18,2.5714285714285716,1,0.0,0,3,0,0,5,1,0,8,1,3,15,1
4734,109955,c5FmvWqHimPY3en4KzYtEePuWbXPcm4V,bWdj2GDclj5ofokWjzoa5jAwMkxCykd6,4,2,1,0,0,1,4,0,8,1.1428571428571428,1,0.0,0,1,0,0,2,1,0,4,0,1,7,1
4735,109956,HNOGJwV4rdRhqUou8hYUuOI1xR3yp1lD,SpATywNh6bZuzm8s1ceuBUnMUAeoAHHw,2,0,0,0,0,0,2,0,2,0.2857142857142857,1,0.0,0,0,0,0,0,0,0,2,0,0,2,1
4736,109982,DmULS2tEq0maGheqJ8Xg7VkvUxmleIug,SpATywNh6bZuzm8s1ceuBUnMUAeoAHHw,10,19,1,0,1,0,3,0,24,3.4285714285714284,2,0.0,1,1,0,1,18,0,0,3,0,3,21,0
4737,109983,5Dqq361dkHzqa5S9GQLfoF5pBVvOZxtV,SpATywNh6bZuzm8s1ceuBUnMUAeoAHHw,1,0,0,0,0,0,1,0,1,0.14285714285714285,1,0.0,0,0,0,0,0,0,0,1,0,0,1,1
4738,110026,KC30Cns1M10UV49aokZvWIXO8ZPauHoR,bWdj2GDclj5ofokWjzoa5jAwMkxCykd6,2,0,0,0,0,0,2,0,2,0.2857142857142857,1,0.0,0,0,0,0,0,0,0,2,0,0,2,1
4739,110029,KC30Cns1M10UV49aokZvWIXO8ZPauHoR,RXDvfPUBYFlVdlueBFbLW0mhhAyGEqpt,2,0,0,0,0,0,2,0,2,0.2857142857142857,1,0.0,0,0,0,0,0,0,0,2,0,0,2,1
4740,113276,eswvbpHhxCUZC3kUIoEHkNpn6ukXHFpo,7GRhBDsirIGkRZBtSMEzNTyDr2JQm4xx,1,0,0,0,0,0,2,0,2,0.2857142857142857,1,0.0,0,0,0,0,0,0,0,2,0,0,2,0
4741,113891,9d8tCYKPfh5NHPKNlwRKmrZh3Cuf1Ls2,7GRhBDsirIGkRZBtSMEzNTyDr2JQm4xx,23,55,24,4,9,0,14,0,106,15.142857142857142,3,0.0,12,24,4,9,43,0,0,14,0,49,57,0
4742,113892,YvqXtgBNC43WLi1Y1OHrc4YV5wJZj5BZ,7GRhBDsirIGkRZBtSMEzNTyDr2JQm4xx,36,105,2,59,10,0,4,0,180,25.714285714285715,1,0.0,20,2,50,10,85,0,9,4,0,82,98,1
4743,113921,cQJEH4N9NA86ElT2x4zkE6ToN6rVT4MQ,7GRhBDsirIGkRZBtSMEzNTyDr2JQm4xx,35,45,18,40,14,2,7,0,126,18.0,2,0.0,21,18,34,14,24,2,6,7,0,87,39,1
4744,113977,AnqzEiR7s4CfuKEZI3xmlDjhp0SJ9rWN,7GRhBDsirIGkRZBtSMEzNTyDr2JQm4xx,19,33,10,25,13,0,6,0,87,12.428571428571429,1,0.0,10,10,20,13,23,0,5,6,0,53,34,0
4745,113978,pi6uVUUcWdM15szjsg09SfyhPrGkMugT,7GRhBDsirIGkRZBtSMEzNTyDr2JQm4xx,7,5,1,0,0,0,5,0,11,1.5714285714285714,2,0.0,0,1,0,0,5,0,0,5,0,1,10,1
4746,113991,z7I1QeH8tOlWf6s0Xi8QGEEG8QaCPAno,7GRhBDsirIGkRZBtSMEzNTyDr2JQm4xx,66,126,44,97,24,74,29,9,403,57.57142857142857,6,0.0,73,44,88,24,53,74,9,29,9,229,174,1
4747,114084,HolfiiRMNIE2y1ufEDM4W3kjJIHyUraM,7GRhBDsirIGkRZBtSMEzNTyDr2JQm4xx,1,0,0,0,0,0,1,0,1,0.14285714285714285,1,0.0,0,0,0,0,0,0,0,1,0,0,1,1
4748,114122,4Pd3e254V1ylErxapJL6FJZ2vSaLD95s,7GRhBDsirIGkRZBtSMEzNTyDr2JQm4xx,37,147,5,58,8,40,24,3,285,40.714285714285715,7,0.0,38,5,53,8,109,40,5,24,3,104,181,0
4749,114193,w43NdaSTOQbbSDTdI0RJiLpdaaUTMsHa,7GRhBDsirIGkRZBtSMEzNTyDr2JQm4xx,1,0,0,0,0,0,1,0,1,0.14285714285714285,1,0.0,0,0,0,0,0,0,0,1,0,0,1,1
4750,114299,uuzc81RWrrz7iGcyTE1vS0JQYD0lJgbY,7GRhBDsirIGkRZBtSMEzNTyDr2JQm4xx,24,59,2,44,3,9,9,0,126,18.0,2,0.0,45,2,37,3,14,9,7,9,0,87,39,1
4751,114411,2jRIZMWHA5rH4ew2UCv2iZrYBWoFczyG,7GRhBDsirIGkRZBtSMEzNTyDr2JQm4xx,2,0,0,0,0,0,3,0,3,0.42857142857142855,1,0.0,0,0,0,0,0,0,0,3,0,0,3,0
4752,114496,rqwp0DRxlrzViX8K4jHTHKpfYZPPmBwb,7GRhBDsirIGkRZBtSMEzNTyDr2JQm4xx,1,0,0,0,0,0,1,0,1,0.14285714285714285,1,0.0,0,0,0,0,0,0,0,1,0,0,1,1
4753,114497,3RcsrMTbPrb8ZHYXLlgwoRK7zrqTGSuq,7GRhBDsirIGkRZBtSMEzNTyDr2JQm4xx,11,19,6,0,0,7,4,0,36,5.142857142857143,1,0.0,8,6,0,0,11,7,0,4,0,14,22,1
4754,114543,aEgt3dXm9v9Y3bAdN5dHXVwqStuJSLzy,7GRhBDsirIGkRZBtSMEzNTyDr2JQm4xx,1,0,0,0,0,0,1,0,1,0.14285714285714285,1,0.0,0,0,0,0,0,0,0,1,0,0,1,1
4755,114559,KkSinTdG2PbGrJIRATMZos8HES46UawO,7GRhBDsirIGkRZBtSMEzNTyDr2JQm4xx,31,86,23,10,16,0,11,0,146,20.857142857142858,7,0.0,31,23,10,16,55,0,0,11,0,80,66,0
4756,114568,39kDK9y6rUMxkyJQwaOrfTRJDkq1CpVh,7GRhBDsirIGkRZBtSMEzNTyDr2JQm4xx,3,2,0,0,0,0,2,0,4,0.5714285714285714,1,0.0,0,0,0,0,2,0,0,2,0,0,4,1
4757,114615,dADOrE6FAWkIPcnZuLBj5KGmzjdxSunH,fbPkOYLVPtPgIt0MxizjfFJov3JbHyAi,32,71,37,44,25,4,7,0,188,26.857142857142858,9,0.0,25,37,40,25,46,4,4,7,0,127,61,0
4758,114620,6T8cBNKGNp544PxJriaeroN36khQqLPz,fbPkOYLVPtPgIt0MxizjfFJov3JbHyAi,9,6,4,0,2,11,5,0,28,4.0,1,0.0,0,4,0,2,6,11,0,5,0,6,22,1
4759,114648,aqQTf2fLQrJTXefctm75awHMgV3chcLI,fbPkOYLVPtPgIt0MxizjfFJov3JbHyAi,4,2,1,0,1,0,1,0,5,0.7142857142857143,1,0.0,0,1,0,1,2,0,0,1,0,2,3,1
4760,117367,z9oiQyplHlMmhFVKenfY0OjMOlRO24Ty,fbPkOYLVPtPgIt0MxizjfFJov3JbHyAi,6,6,2,0,2,0,1,0,11,1.5714285714285714,1,0.0,0,2,0,2,6,0,0,1,0,4,7,1
4761,117368,6AwbnbZTB5s1lrnTdEnSshjUPytTPXpI,fbPkOYLVPtPgIt0MxizjfFJov3JbHyAi,1,0,0,0,0,0,1,0,1,0.14285714285714285,1,0.0,0,0,0,0,0,0,0,1,0,0,1,1
4762,117370,3JEt0I9b0JhZhM0RD2D5jI5S8zjjeHFo,fbPkOYLVPtPgIt0MxizjfFJov3JbHyAi,8,10,6,0,4,3,5,0,28,4.0,3,0.0,1,6,0,4,9,3,0,5,0,11,17,0
4763,117377,ED2RRaLgnPevoSmZx4Qg8rLBDplQ4qIA,fbPkOYLVPtPgIt0MxizjfFJov3JbHyAi,5,2,1,0,1,0,2,0,6,0.8571428571428571,1,0.0,0,1,0,1,2,0,0,2,0,2,4,1
4764,117379,h77jUHQjzYddHbYwLAoFxVw2uSIfwhBs,fbPkOYLVPtPgIt0MxizjfFJov3JbHyAi,4,2,0,0,0,1,6,0,9,1.2857142857142858,1,0.0,0,0,0,0,2,1,0,6,0,0,9,1
4765,117380,RArjmmV02rd6h9pGPjgt5onR6MwVvvt1,fbPkOYLVPtPgIt0MxizjfFJov3JbHyAi,8,5,3,0,2,6,5,0,21,3.0,1,0.0,0,3,0,2,5,6,0,5,0,5,16,1
4766,117382,W4YcttFAI3GezJalLYSgr5LsB9fMfJw6,fbPkOYLVPtPgIt0MxizjfFJov3JbHyAi,5,2,1,0,1,0,2,0,6,0.8571428571428571,1,0.0,0,1,0,1,2,0,0,2,0,2,4,1
4767,117385,AuMjwLeYBChETH8L0EPQQLBqdJg4wXaV,fbPkOYLVPtPgIt0MxizjfFJov3JbHyAi,14,14,7,0,8,22,6,0,57,8.142857142857142,1,0.0,5,7,0,8,9,22,0,6,0,20,37,1
4768,117386,i0ksX07HnsV5rQlWqOr1uKEuc7yNU24c,fbPkOYLVPtPgIt0MxizjfFJov3JbHyAi,7,2,1,0,1,4,8,1,17,2.4285714285714284,2,0.0,0,1,0,1,2,4,0,8,1,2,15,1
4769,117389,mXfwwTIVjHMqoVKAh2iEQbinKUCJHwTp,fbPkOYLVPtPgIt0MxizjfFJov3JbHyAi,1,0,0,0,0,0,9,0,9,1.2857142857142858,1,0.0,0,0,0,0,0,0,0,9,0,0,9,0
4770,117396,pNEyURvIjTiESJT2evjPVs5QcamqwYsg,fbPkOYLVPtPgIt0MxizjfFJov3JbHyAi,1,0,0,0,0,0,1,0,1,0.14285714285714285,1,0.0,0,0,0,0,0,0,0,1,0,0,1,1
4771,117397,2XVXsblIDsQNrX8upAtO1F8OiAwOV3sC,fbPkOYLVPtPgIt0MxizjfFJov3JbHyAi,1,0,0,0,0,0,1,0,1,0.14285714285714285,1,0.0,0,0,0,0,0,0,0,1,0,0,1,1
4772,117399,bPCJkP9ZTzzi0I9DbpQGe5iKBkWKaKhH,fbPkOYLVPtPgIt0MxizjfFJov3JbHyAi,10,8,6,0,3,2,4,1,24,3.4285714285714284,1,0.0,0,6,0,3,8,2,0,4,1,9,15,1
4773,117405,fu0f20KU28Bd4xE03nYnaxnydSL4s6JV,fbPkOYLVPtPgIt0MxizjfFJov3JbHyAi,3,3,1,0,0,0,3,0,7,1.0,1,0.0,0,1,0,0,3,0,0,3,0,1,6,1
4774,117407,u3ha5zP0wtMcDDWbo2YVGmhJ5EihdJ7B,fbPkOYLVPtPgIt0MxizjfFJov3JbHyAi,1,0,0,0,0,0,1,0,1,0.14285714285714285,1,0.0,0,0,0,0,0,0,0,1,0,0,1,1
4775,117408,T7YlTqIDVTZFYEYihxD1Zij5IkDsmVZP,fbPkOYLVPtPgIt0MxizjfFJov3JbHyAi,8,11,3,0,3,6,3,0,26,3.7142857142857144,1,0.0,3,3,0,3,8,6,0,3,0,9,17,1
4776,117409,oZFc1qOsYmuXaa2y9yuDE2JOyaJ6tpRo,fbPkOYLVPtPgIt0MxizjfFJov3JbHyAi,12,19,11,0,6,0,6,0,42,6.0,4,0.0,0,11,0,6,19,0,0,6,0,17,25,1
4777,117410,Lpjd1s2Qa852YWnveC5CAHyEzqzKjCKM,fbPkOYLVPtPgIt0MxizjfFJov3JbHyAi,8,4,1,0,1,4,6,1,17,2.4285714285714284,2,0.0,0,1,0,1,4,4,0,6,1,2,15,1
4778,117420,sATu1yjmTMxfV1UwbY34TM5sGL4dFyhU,fbPkOYLVPtPgIt0MxizjfFJov3JbHyAi,4,6,1,0,0,0,3,0,10,1.4285714285714286,2,0.0,0,1,0,0,6,0,0,3,0,1,9,1
4779,117421,6o1ZSS0MBiJ4i90ElFoAvCZGSxQxxLtD,fbPkOYLVPtPgIt0MxizjfFJov3JbHyAi,1,0,0,0,0,0,1,0,1,0.14285714285714285,1,0.0,0,0,0,0,0,0,0,1,0,0,1,1
4780,117425,YjySOKJ8Qhep1ksiy3pkGK8hyQnj63Bg,fbPkOYLVPtPgIt0MxizjfFJov3JbHyAi,2,0,0,0,0,0,4,0,4,0.5714285714285714,1,0.0,0,0,0,0,0,0,0,4,0,0,4,1
4781,117426,1I29v8UmoBuouK5thDbwjYUDiAkrMElJ,fbPkOYLVPtPgIt0MxizjfFJov3JbHyAi,2,0,0,0,0,0,6,0,6,0.8571428571428571,1,0.0,0,0,0,0,0,0,0,6,0,0,6,1
4782,117429,pbZR4GJe7P6eoTNcArXxFSrGW6cVA8YU,fbPkOYLVPtPgIt0MxizjfFJov3JbHyAi,15,15,11,0,8,0,8,0,42,6.0,3,0.0,0,11,0,8,15,0,0,8,0,19,23,1
4783,117430,MmozMzpVuu7lJ9WhybOg7LnFJamucwNf,fbPkOYLVPtPgIt0MxizjfFJov3JbHyAi,5,3,1,0,1,0,2,0,7,1.0,1,0.0,0,1,0,1,3,0,0,2,0,2,5,1
4784,117432,CN6hYLtHy52UqiF5PRGtJEkOeeMIm2un,fbPkOYLVPtPgIt0MxizjfFJov3JbHyAi,7,3,2,0,2,0,4,0,11,1.5714285714285714,1,0.0,0,2,0,2,3,0,0,4,0,4,7,1
4785,117434,T6F7StAhzA9Nt1gx3xcfSamiwd1hA4kb,fbPkOYLVPtPgIt0MxizjfFJov3JbHyAi,2,0,0,0,0,0,2,0,2,0.2857142857142857,1,0.0,0,0,0,0,0,0,0,2,0,0,2,1
4786,117437,HOh9uzKRHmixUSVl017qRO1fRhTakF2v,fbPkOYLVPtPgIt0MxizjfFJov3JbHyAi,16,37,16,6,10,5,11,1,86,12.285714285714286,6,0.0,8,16,4,10,29,5,2,11,1,38,48,1
4787,117442,kyRDtUassKyWkKwd2NxuRMWbNGMmYQuD,fbPkOYLVPtPgIt0MxizjfFJov3JbHyAi,36,81,43,24,22,25,34,2,231,33.0,8,0.0,22,43,19,22,59,25,5,34,2,106,125,1
4788,117443,V44Q36yyz0HxZhlrCwrLJjYwv8UzqoCn,fbPkOYLVPtPgIt0MxizjfFJov3JbHyAi,6,3,2,0,2,0,2,0,9,1.2857142857142858,1,0.0,0,2,0,2,3,0,0,2,0,4,5,1
4789,117444,oWOfoMSwxFJkBlwLG8XI3GNMHdlBBaGM,fbPkOYLVPtPgIt0MxizjfFJov3JbHyAi,17,39,24,4,5,4,15,1,92,13.142857142857142,10,0.0,6,24,3,5,33,4,1,15,1,38,54,1
4790,117445,gkiUIfN50TiqMc6ruS3MmgF2p099c98R,fbPkOYLVPtPgIt0MxizjfFJov3JbHyAi,7,8,5,0,3,0,3,0,19,2.7142857142857144,1,0.0,0,5,0,3,8,0,0,3,0,8,11,1
4791,117446,Q3CFFFFeztddQPg34HzeWJOUWopSHXqI,fbPkOYLVPtPgIt0MxizjfFJov3JbHyAi,5,2,1,0,1,0,3,0,7,1.0,1,0.0,0,1,0,1,2,0,0,3,0,2,5,1
4792,117447,OvHFca8fZMJjxNBJonj6ZM9Jmu5uZHn1,fbPkOYLVPtPgIt0MxizjfFJov3JbHyAi,5,3,1,0,0,0,3,0,7,1.0,1,0.0,0,1,0,0,3,0,0,3,0,1,6,1
4793,117452,XD3SfNDDSMmRivtrECVvGAm4sTgAQhtN,fbPkOYLVPtPgIt0MxizjfFJov3JbHyAi,11,6,3,6,3,0,4,0,22,3.142857142857143,1,0.0,1,3,5,3,5,0,1,4,0,12,10,1
4794,117454,m6lnook0RtQLOadkyTjepku2EsfPQUkf,fbPkOYLVPtPgIt0MxizjfFJov3JbHyAi,1,0,0,0,0,0,1,0,1,0.14285714285714285,1,0.0,0,0,0,0,0,0,0,1,0,0,1,1
4795,117460,ZCWIo0rlDJYX4bFrxwqUtfFzcyFGtbPC,fbPkOYLVPtPgIt0MxizjfFJov3JbHyAi,7,5,1,0,1,0,1,0,8,1.1428571428571428,1,0.0,0,1,0,1,5,0,0,1,0,2,6,1
4796,117467,hDNiOFPvRB9cUydss5Qxpv78aI19HlnV,fbPkOYLVPtPgIt0MxizjfFJov3JbHyAi,15,10,7,0,7,0,5,0,29,4.142857142857143,2,0.0,2,7,0,7,8,0,0,5,0,16,13,1
4797,117470,mT6waBgPTnOBUmAiQrY4keGZNquTpjJI,fbPkOYLVPtPgIt0MxizjfFJov3JbHyAi,7,5,0,0,0,1,6,1,13,1.8571428571428572,1,0.0,0,0,0,0,5,1,0,6,1,0,13,1
4798,117472,GaQzOXFZJNvUueucyW3BfG1sfbLN7TqZ,fbPkOYLVPtPgIt0MxizjfFJov3JbHyAi,6,2,1,0,1,0,3,0,7,1.0,1,0.0,0,1,0,1,2,0,0,3,0,2,5,1
4799,117476,RwvuGEh3euIR11rktJrGBhzDqcQMkhOC,fbPkOYLVPtPgIt0MxizjfFJov3JbHyAi,11,24,14,4,7,1,7,0,57,8.142857142857142,4,0.0,3,14,3,7,21,1,1,7,0,27,30,1
4800,117477,0VSuyC2fbUM3VIvEXql75XtNw7kg5Izm,fbPkOYLVPtPgIt0MxizjfFJov3JbHyAi,16,15,7,8,6,0,3,0,39,5.571428571428571,3,0.0,5,7,7,6,10,0,1,3,0,25,14,1
4801,117478,W7oz4HopNsS4RPNw2s87918URq124P2s,fbPkOYLVPtPgIt0MxizjfFJov3JbHyAi,4,2,0,0,0,1,5,0,8,1.1428571428571428,1,0.0,0,0,0,0,2,1,0,5,0,0,8,1
4802,117483,ckU7S9iTSheBHJPYCUZtMgrhgDvQPsUY,fbPkOYLVPtPgIt0MxizjfFJov3JbHyAi,6,3,2,0,2,0,1,0,8,1.1428571428571428,1,0.0,0,2,0,2,3,0,0,1,0,4,4,1
4803,117484,5bnbtuO3BHv5NYIfEbfBpvStPzGdNjte,fbPkOYLVPtPgIt0MxizjfFJov3JbHyAi,5,2,1,0,1,0,2,0,6,0.8571428571428571,1,0.0,0,1,0,1,2,0,0,2,0,2,4,1
4804,117485,V1BKbINyQwKyububdNQHUPGcGTvoZmLt,fbPkOYLVPtPgIt0MxizjfFJov3JbHyAi,7,3,2,0,2,0,5,0,12,1.7142857142857142,1,0.0,0,2,0,2,3,0,0,5,0,4,8,1
4805,117497,TZ8M7GqMqYnKB1lP0bgNhFJYSqdTmbQI,fbPkOYLVPtPgIt0MxizjfFJov3JbHyAi,7,13,6,0,3,0,3,0,25,3.5714285714285716,2,0.0,0,6,0,3,13,0,0,3,0,9,16,1
4806,117498,aRBsP3RNC28m05qU4AuLdcShaMIKbk0T,fbPkOYLVPtPgIt0MxizjfFJov3JbHyAi,5,2,1,0,1,0,2,0,6,0.8571428571428571,1,0.0,0,1,0,1,2,0,0,2,0,2,4,1
4807,117504,7nfwj1I7hYBfuxm4jUuStM2n17LzzRmj,SpATywNh6bZuzm8s1ceuBUnMUAeoAHHw,28,26,18,26,12,121,50,2,255,36.42857142857143,11,0.0,6,18,23,12,20,121,3,50,2,59,196,0
4808,117532,qX3w4IgztgXyu9swieirFObama3kJyza,G8EPVSXsOYB5YQWZGiz1aVq5Pgr2GrQu,60,65,3,189,1,2,19,6,285,40.714285714285715,4,0.0,4,3,151,1,61,2,38,19,6,159,126,1
4809,117567,KlEAwfTXNSli6vdNdYlm5CYknLkxK1Br,SpATywNh6bZuzm8s1ceuBUnMUAeoAHHw,20,43,25,4,15,0,8,0,95,13.571428571428571,5,0.0,10,25,4,15,33,0,0,8,0,54,41,0
4810,117568,VK6VYsFJEy8hhWdKq52KmrJkO3b6jNbn,A3fsA9Zfv1X2fVEQhTw51lKENdNrEqT3,36,25,16,36,14,1,18,1,111,15.857142857142858,5,0.0,2,16,30,14,23,1,6,18,1,62,49,0
4811,117609,hyhyxhn6qO7nii28PZygBx2DF5Qsnp6b,SpATywNh6bZuzm8s1ceuBUnMUAeoAHHw,10,10,5,0,4,0,1,0,20,2.857142857142857,1,0.0,0,5,0,4,10,0,0,1,0,9,11,1
4812,117610,ByImt5XiYRVr6hSHRVc9HRcRiIYkoT5Y,SpATywNh6bZuzm8s1ceuBUnMUAeoAHHw,9,5,1,0,1,0,8,3,18,2.5714285714285716,2,0.0,0,1,0,1,5,0,0,8,3,2,16,0
4813,117612,Kd69M9W1nim0woqVm1QxfVaSebsYtFIh,SpATywNh6bZuzm8s1ceuBUnMUAeoAHHw,5,5,2,0,1,0,2,0,10,1.4285714285714286,2,0.0,0,2,0,1,5,0,0,2,0,3,7,1
4814,117613,VEmnuZOsoHSPcS4ojGYL7wyh1ioGqsGt,SpATywNh6bZuzm8s1ceuBUnMUAeoAHHw,29,25,17,22,11,0,5,0,80,11.428571428571429,3,0.0,4,17,22,11,21,0,0,5,0,54,26,0
4815,117615,NdhfP9LezOw47EKstFkVNQYaCX8DmoQI,SpATywNh6bZuzm8s1ceuBUnMUAeoAHHw,14,25,2,20,2,0,9,0,58,8.285714285714286,3,0.0,2,2,16,2,23,0,4,9,0,22,36,0
4816,117655,MkluYfJDefHhcRPY3QsRGiWxg2BDcm18,SpATywNh6bZuzm8s1ceuBUnMUAeoAHHw,10,6,1,0,1,3,9,2,22,3.142857142857143,1,0.0,0,1,0,1,6,3,0,9,2,2,20,0
4817,117666,GGjg9S36MZkhfOc2c4FtP7oUCiriIkzW,A3fsA9Zfv1X2fVEQhTw51lKENdNrEqT3,1,0,0,0,0,0,1,0,1,0.14285714285714285,1,0.0,0,0,0,0,0,0,0,1,0,0,1,1
4818,117671,LvmRr9NACuniPuboiWpXG15NCOEyIfpb,SpATywNh6bZuzm8s1ceuBUnMUAeoAHHw,11,20,12,0,4,0,12,0,48,6.857142857142857,5,0.0,0,12,0,4,20,0,0,12,0,16,32,0
4819,117672,NdhfP9LezOw47EKstFkVNQYaCX8DmoQI,RXDvfPUBYFlVdlueBFbLW0mhhAyGEqpt,24,39,2,54,1,10,7,0,113,16.142857142857142,3,0.0,10,2,46,1,29,10,8,7,0,59,54,0
4820,117675,l64zD2DC6Q6fZRqMhhM1r4HOjVM4BOX7,SpATywNh6bZuzm8s1ceuBUnMUAeoAHHw,18,47,3,22,3,1,18,1,95,13.571428571428571,4,0.0,7,3,17,3,40,1,5,18,1,30,65,0
4821,117679,VE9HD5yzeCmqc2pNGfTQWsVbRdaqJBIV,SpATywNh6bZuzm8s1ceuBUnMUAeoAHHw,28,38,18,12,9,0,6,1,84,12.0,4,0.0,8,18,12,9,30,0,0,6,1,47,37,0
4822,117700,hKd0tEZKHss60gUM0z43MBrDD3KnSpLX,bWdj2GDclj5ofokWjzoa5jAwMkxCykd6,7,11,2,0,2,0,4,0,19,2.7142857142857144,2,0.0,0,2,0,2,11,0,0,4,0,4,15,1
4823,117701,VgmFAu9L9uoZcxRAsErY5yMnCkdw48U0,SpATywNh6bZuzm8s1ceuBUnMUAeoAHHw,22,18,12,36,8,0,12,0,86,12.285714285714286,3,0.0,4,12,33,8,14,0,3,12,0,57,29,0
4824,117704,imCqSahSQFbp2MKSKmbn03XNPhpj1Zgr,bWdj2GDclj5ofokWjzoa5jAwMkxCykd6,18,21,10,61,4,5,3,0,104,14.857142857142858,1,0.0,3,10,56,4,18,5,5,3,0,73,31,1
4825,117705,KM2jhllffvH7le7smUIPpeiXHGu50JUy,G8EPVSXsOYB5YQWZGiz1aVq5Pgr2GrQu,19,65,1,26,5,4,8,1,110,15.714285714285714,2,0.0,37,1,18,5,28,4,8,8,1,61,49,1
4826,117713,BdtTUaUgpTqIzhF2tLHXM8NXK8k0XF8q,bWdj2GDclj5ofokWjzoa5jAwMkxCykd6,36,102,53,58,6,27,22,0,268,38.285714285714285,6,0.0,17,53,55,6,85,27,3,22,0,131,137,0
4827,117723,B1Gq6e77yv7kkDqJ7SH2TygdPDzPBwQh,RXDvfPUBYFlVdlueBFbLW0mhhAyGEqpt,73,99,67,109,25,136,19,9,464,66.28571428571429,5,0.0,15,67,98,25,84,136,11,19,9,205,259,0
4828,117725,HPir8NcsI5RSXTzlx3oC2YqcMhZG1iu7,bWdj2GDclj5ofokWjzoa5jAwMkxCykd6,8,6,2,0,2,0,12,1,23,3.2857142857142856,3,0.0,2,2,0,2,4,0,0,12,1,6,17,0
4829,117734,cQJEH4N9NA86ElT2x4zkE6ToN6rVT4MQ,bWdj2GDclj5ofokWjzoa5jAwMkxCykd6,7,3,1,18,1,0,2,0,25,3.5714285714285716,1,0.0,1,1,17,1,2,0,1,2,0,20,5,0
4830,117742,FhtwGNNoWtYYBXhYRu77jAPRU1UPxpBL,SpATywNh6bZuzm8s1ceuBUnMUAeoAHHw,7,4,2,0,1,5,5,0,17,2.4285714285714284,2,0.0,0,2,0,1,4,5,0,5,0,3,14,0
4831,117774,jFYWygr5nLqLhHkXltZRkT0S1zQoLEVR,A3fsA9Zfv1X2fVEQhTw51lKENdNrEqT3,64,26,16,162,11,8,16,1,240,34.285714285714285,3,0.0,4,16,141,11,22,8,21,16,1,172,68,0
4832,117784,CFQksue0mvvarj6k4PvTddPXnYjnyZ25,SpATywNh6bZuzm8s1ceuBUnMUAeoAHHw,11,12,0,9,0,19,5,1,46,6.571428571428571,1,0.0,0,0,7,0,12,19,2,5,1,7,39,1
4833,117791,efPQEaUnbKTGcoOM9khi0sSrVhfE9TxE,bWdj2GDclj5ofokWjzoa5jAwMkxCykd6,11,48,21,4,2,0,9,0,84,12.0,4,0.0,2,21,3,2,46,0,1,9,0,28,56,1
4834,117800,RJv5TI20pjqK3VtKSctdVBLm65ceGNPu,SpATywNh6bZuzm8s1ceuBUnMUAeoAHHw,29,70,31,25,8,38,18,3,193,27.571428571428573,6,0.0,18,31,24,8,52,38,1,18,3,81,112,0
4835,117893,Bos3zEEnAcYzPXQktMkJJ0ak5mhGWCAf,SpATywNh6bZuzm8s1ceuBUnMUAeoAHHw,21,32,11,26,6,0,1,0,76,10.857142857142858,1,0.0,13,11,25,6,19,0,1,1,0,55,21,0
4836,117897,uww7NsJbMYsrx0EthqYUSLQnuRAcw7nQ,A3fsA9Zfv1X2fVEQhTw51lKENdNrEqT3,5,1,1,0,1,0,5,0,8,1.1428571428571428,1,0.0,0,1,0,1,1,0,0,5,0,2,6,1
4837,117935,1R1zO9aMB7Mx1Lw84JzsChVEV5JpwmZv,SpATywNh6bZuzm8s1ceuBUnMUAeoAHHw,26,80,4,18,2,40,44,5,193,27.571428571428573,13,0.0,22,4,18,2,58,40,0,44,5,46,147,0
4838,118040,Eemq3hk1Q3P1Pw1UumR7jNQlYsAdhi76,SpATywNh6bZuzm8s1ceuBUnMUAeoAHHw,11,16,4,19,1,2,4,1,47,6.714285714285714,1,0.0,11,4,17,1,5,2,2,4,1,33,14,1
4839,118056,skJn7dtfSekFrPHRHs9swZ9AtSUKi36u,bWdj2GDclj5ofokWjzoa5jAwMkxCykd6,3,2,1,0,0,0,1,0,4,0.5714285714285714,1,0.0,0,1,0,0,2,0,0,1,0,1,3,1
4840,118084,hJwtwnOzJaTrAeP4eXJAEwz2xbKsgc4M,A3fsA9Zfv1X2fVEQhTw51lKENdNrEqT3,9,3,2,0,1,1,25,1,33,4.714285714285714,11,0.0,0,2,0,1,3,1,0,25,1,3,30,0
4841,118085,hJwtwnOzJaTrAeP4eXJAEwz2xbKsgc4M,bWdj2GDclj5ofokWjzoa5jAwMkxCykd6,2,0,0,0,0,0,16,0,16,2.2857142857142856,8,0.0,0,0,0,0,0,0,0,16,0,0,16,0
4842,118091,hJwtwnOzJaTrAeP4eXJAEwz2xbKsgc4M,RXDvfPUBYFlVdlueBFbLW0mhhAyGEqpt,7,2,1,0,1,1,16,4,25,3.5714285714285716,8,0.0,0,1,0,1,2,1,0,16,4,2,23,1
4843,118111,vlcrE6RvFFuyjHZx9sgpQaFTegXr4wza,bWdj2GDclj5ofokWjzoa5jAwMkxCykd6,8,5,3,0,1,0,4,0,13,1.8571428571428572,1,0.0,0,3,0,1,5,0,0,4,0,4,9,1
4844,118118,l3b9HlsGDQW9AY17jLNuKVLgfuE5tsF4,SpATywNh6bZuzm8s1ceuBUnMUAeoAHHw,24,53,11,35,4,1,6,0,110,15.714285714285714,6,0.0,21,11,32,4,32,1,3,6,0,68,42,0
4845,118127,h4Ts0QZ9Axnf77ZfOuF03oUEp9wmSbSp,SpATywNh6bZuzm8s1ceuBUnMUAeoAHHw,17,12,7,7,4,1,7,1,39,5.571428571428571,1,0.0,3,7,7,4,9,1,0,7,1,21,18,1
4846,118130,0sa6kP9h4ahNr7Hzfeaa1Mssp5M7IVmw,SpATywNh6bZuzm8s1ceuBUnMUAeoAHHw,19,18,7,18,4,15,8,1,71,10.142857142857142,2,0.0,4,7,15,4,14,15,3,8,1,30,41,1
4847,118203,HX0eOrMEwIw9JyfkWs6Tn0Lny06N2ZVO,SpATywNh6bZuzm8s1ceuBUnMUAeoAHHw,16,39,15,21,7,22,15,0,119,17.0,3,0.0,16,15,17,7,23,22,4,15,0,55,64,0
4848,118208,iPn4eHBBcGh91aOsj9d5XOb4QbfUGe6N,bWdj2GDclj5ofokWjzoa5jAwMkxCykd6,5,7,2,0,4,0,8,0,21,3.0,2,0.0,4,2,0,4,3,0,0,8,0,10,11,1
4849,118218,66rxtelZjlVaBERuinHZ5AhHu9R6Idp5,SpATywNh6bZuzm8s1ceuBUnMUAeoAHHw,2,0,0,0,0,0,2,0,2,0.2857142857142857,1,0.0,0,0,0,0,0,0,0,2,0,0,2,1
4850,118230,2HbabEHSEnqM0bBaiJs30PG9549v5yOk,A3fsA9Zfv1X2fVEQhTw51lKENdNrEqT3,2,0,0,0,0,0,2,0,2,0.2857142857142857,1,0.0,0,0,0,0,0,0,0,2,0,0,2,1
4851,118232,TANF2ueHbJbwPsuSCbh96NH4X4PT1TeC,SpATywNh6bZuzm8s1ceuBUnMUAeoAHHw,5,2,0,0,1,0,2,0,5,0.7142857142857143,1,0.0,0,0,0,1,2,0,0,2,0,1,4,1
4852,118239,4uAdkCJ4XUaD1NQGV93nNifOuyurJNKS,SpATywNh6bZuzm8s1ceuBUnMUAeoAHHw,7,2,1,0,1,1,7,2,14,2.0,1,0.0,0,1,0,1,2,1,0,7,2,2,12,0
4853,118258,5rpYxIaCTDb4PhszkJWpACOx5VMpNGcQ,SpATywNh6bZuzm8s1ceuBUnMUAeoAHHw,30,36,18,20,8,10,16,0,108,15.428571428571429,5,0.0,12,18,19,8,24,10,1,16,0,57,51,0
4854,118318,7hhGe4WcGEHypOzIVz3DLRx9GS52ozkE,RXDvfPUBYFlVdlueBFbLW0mhhAyGEqpt,68,77,48,95,31,28,15,0,294,42.0,4,0.0,22,48,89,31,55,28,6,15,0,190,104,0
4855,118326,yKuiBw79vz6YoDe6ZvtlnOfjIuGqFl4A,A3fsA9Zfv1X2fVEQhTw51lKENdNrEqT3,5,4,1,0,0,0,1,0,6,0.8571428571428571,1,0.0,0,1,0,0,4,0,0,1,0,1,5,1
4856,118332,5ZiEBByu9KqLLuVXJILf5031ejtxPgIX,A3fsA9Zfv1X2fVEQhTw51lKENdNrEqT3,1,0,0,0,0,0,1,0,1,0.14285714285714285,1,0.0,0,0,0,0,0,0,0,1,0,0,1,1
4857,118339,cu2czfUbk8fdWWzCcDvTVYWH50Wg3XUq,SpATywNh6bZuzm8s1ceuBUnMUAeoAHHw,14,25,1,18,0,19,8,0,71,10.142857142857142,6,0.0,5,1,15,0,20,19,3,8,0,21,50,0
4858,118369,httl8KJFJiDMZk4tgEQADrIoYysynrAv,SpATywNh6bZuzm8s1ceuBUnMUAeoAHHw,11,13,1,17,0,0,2,0,33,4.714285714285714,1,0.0,7,1,16,0,6,0,1,2,0,24,9,1
4859,118371,hZtYMC0K38gXqBKrTDOxWf2kSwG06wA4,RXDvfPUBYFlVdlueBFbLW0mhhAyGEqpt,49,84,43,70,10,47,24,4,282,40.285714285714285,5,0.0,11,43,67,10,73,47,3,24,4,131,151,0
4860,118393,LVTU4qA4F3wWkxH81iGfu4ZuIt77nyhh,SpATywNh6bZuzm8s1ceuBUnMUAeoAHHw,32,37,25,43,8,17,11,1,142,20.285714285714285,1,0.0,5,25,37,8,32,17,6,11,1,75,67,0
4861,118422,ZNBGAlJve4TYJ3FcDlTLBdyuklADldDZ,bWdj2GDclj5ofokWjzoa5jAwMkxCykd6,10,7,2,12,3,0,7,1,32,4.571428571428571,3,0.0,4,2,12,3,3,0,0,7,1,21,11,1
4862,118467,Lu93o5GXoxd6qTdHk7BshqxRhX67SrrE,SpATywNh6bZuzm8s1ceuBUnMUAeoAHHw,24,48,11,16,7,0,4,0,86,12.285714285714286,3,0.0,18,11,15,7,30,0,1,4,0,51,35,0
4863,118468,s18XVhMq5o50489RseclkjZSQF8K6sqD,G8EPVSXsOYB5YQWZGiz1aVq5Pgr2GrQu,22,46,1,14,1,9,9,0,80,11.428571428571429,3,0.0,13,1,7,1,33,9,7,9,0,22,58,1
4864,118506,GrjEbVPh1uYw8afH98AN7VXn6UMAVnC8,A3fsA9Zfv1X2fVEQhTw51lKENdNrEqT3,6,5,0,0,0,0,6,0,11,1.5714285714285714,1,0.0,0,0,0,0,5,0,0,6,0,0,11,1
4865,118508,TnL4ialg6Pf5M7cIMrmaVmE9VMhEtv14,RXDvfPUBYFlVdlueBFbLW0mhhAyGEqpt,17,16,2,16,3,0,5,0,42,6.0,2,0.0,4,2,15,3,12,0,1,5,0,24,18,1
4866,118514,W3axEfDtpWFQrOsjh1ju6UWJlt7DtE7b,SpATywNh6bZuzm8s1ceuBUnMUAeoAHHw,13,20,3,8,0,9,18,4,62,8.857142857142858,5,0.0,1,3,6,0,19,9,2,18,4,10,52,1
4867,118548,2i4UZQIumoYMpXAy2hMZiboq0bmSvHzQ,RXDvfPUBYFlVdlueBFbLW0mhhAyGEqpt,6,16,1,0,0,0,3,0,20,2.857142857142857,1,0.0,0,1,0,0,16,0,0,3,0,1,19,1
4868,118554,YBwTM3Bv2witVJ0Ed4zAbHn1UCLHLsEN,G8EPVSXsOYB5YQWZGiz1aVq5Pgr2GrQu,27,37,22,42,11,1,7,1,121,17.285714285714285,2,0.0,11,22,30,11,26,1,12,7,1,74,47,0
4869,118620,tKs772tHpR5tE8Ceee9VXQcqKPNhx6zt,SpATywNh6bZuzm8s1ceuBUnMUAeoAHHw,11,11,2,6,1,0,3,1,24,3.4285714285714284,2,0.0,3,2,5,1,8,0,1,3,1,11,13,1
4870,118642,PpZEAa1Mdati01h1lf363alLOjmVtvBB,A3fsA9Zfv1X2fVEQhTw51lKENdNrEqT3,7,8,4,0,2,0,2,0,16,2.2857142857142856,1,0.0,1,4,0,2,7,0,0,2,0,7,9,1
4871,118650,ANtHTaCISHkEW6ENLanE6G1HEnRFLZdw,A3fsA9Zfv1X2fVEQhTw51lKENdNrEqT3,3,2,1,0,0,0,1,0,4,0.5714285714285714,1,0.0,0,1,0,0,2,0,0,1,0,1,3,0
4872,118652,eNgDL8k9xOLyBlZ3UNlseJHly8SfPZZu,bWdj2GDclj5ofokWjzoa5jAwMkxCykd6,18,100,55,90,4,114,37,1,401,57.285714285714285,9,0.0,22,55,86,4,78,114,4,37,1,167,234,0
4873,118658,eJLeV7Xq2bhq90HDU7vo6Tpmzbd63FDZ,SpATywNh6bZuzm8s1ceuBUnMUAeoAHHw,15,12,9,0,7,0,3,0,31,4.428571428571429,2,0.0,0,9,0,7,12,0,0,3,0,16,15,0
4874,118687,c1BXmJNemroOPh6WUefTBD28s2WzSNwi,A3fsA9Zfv1X2fVEQhTw51lKENdNrEqT3,26,30,3,24,2,1,13,2,75,10.714285714285714,5,0.0,0,3,24,2,30,1,0,13,2,29,46,1
4875,118688,c1BXmJNemroOPh6WUefTBD28s2WzSNwi,SpATywNh6bZuzm8s1ceuBUnMUAeoAHHw,14,25,0,12,0,2,6,1,46,6.571428571428571,1,0.0,12,0,12,0,13,2,0,6,1,24,22,0
4876,118704,ZfIQYurnR6gJbWxLJ81cU3ZqzX4mpHm0,bWdj2GDclj5ofokWjzoa5jAwMkxCykd6,9,16,7,0,1,0,10,0,34,4.857142857142857,4,0.0,1,7,0,1,15,0,0,10,0,9,25,0
4877,118716,fomJrwdlOVBB27jkNMuLttmiA1XIZPzf,SpATywNh6bZuzm8s1ceuBUnMUAeoAHHw,6,4,1,0,1,0,2,0,8,1.1428571428571428,1,0.0,0,1,0,1,4,0,0,2,0,2,6,1
4878,118723,9Gk0qMwFPQMSYtSGwJwjevbzKboXiTpg,SpATywNh6bZuzm8s1ceuBUnMUAeoAHHw,13,20,2,0,1,0,1,0,24,3.4285714285714284,1,0.0,5,2,0,1,15,0,0,1,0,8,16,1
4879,118735,f6FNE8vNtrL6TKWAyYNA5KZvLoAoDp49,SpATywNh6bZuzm8s1ceuBUnMUAeoAHHw,15,17,1,23,2,2,10,0,55,7.857142857142857,1,0.0,8,1,20,2,9,2,3,10,0,31,24,1
4880,118740,7pYjVdOmbPwcRdb5BQqrv1P4hFEqv8iv,A3fsA9Zfv1X2fVEQhTw51lKENdNrEqT3,7,4,1,0,1,0,2,0,8,1.1428571428571428,1,0.0,0,1,0,1,4,0,0,2,0,2,6,1
4881,118748,grNuFIQJF1sOOkw8RJjaExhlwTJt52uU,G8EPVSXsOYB5YQWZGiz1aVq5Pgr2GrQu,47,97,46,112,31,19,15,1,321,45.857142857142854,8,0.0,5,46,104,31,92,19,8,15,1,186,135,0
4882,118757,8x72g1EnsW8bYBL6HWtA15C4pKj2sPjA,G8EPVSXsOYB5YQWZGiz1aVq5Pgr2GrQu,5,3,1,0,1,0,2,0,7,1.0,1,0.0,0,1,0,1,3,0,0,2,0,2,5,1
4883,118787,bKVslXuzEQ1pv4c6iV5mVjs6X6avUbmL,A3fsA9Zfv1X2fVEQhTw51lKENdNrEqT3,40,14,11,56,10,0,3,0,94,13.428571428571429,2,0.0,1,11,53,10,13,0,3,3,0,75,19,1
4884,118792,bKVslXuzEQ1pv4c6iV5mVjs6X6avUbmL,SpATywNh6bZuzm8s1ceuBUnMUAeoAHHw,6,3,2,0,2,0,1,0,8,1.1428571428571428,1,0.0,0,2,0,2,3,0,0,1,0,4,4,1
4885,118793,lrp5AGJUh69hKuCI5IYUEU19E2beipwd,bWdj2GDclj5ofokWjzoa5jAwMkxCykd6,13,28,3,0,5,6,11,0,53,7.571428571428571,6,0.0,0,3,0,5,28,6,0,11,0,8,45,1
4886,118803,AXOBQLaknxwaGBasKpj34YfhU436HR6z,A3fsA9Zfv1X2fVEQhTw51lKENdNrEqT3,1,0,0,0,0,0,1,0,1,0.14285714285714285,1,0.0,0,0,0,0,0,0,0,1,0,0,1,1
4887,118805,c9mIdDAhRczXEb5UJiDqrnVR2zYNOBwR,A3fsA9Zfv1X2fVEQhTw51lKENdNrEqT3,1,0,0,0,0,0,1,0,1,0.14285714285714285,1,0.0,0,0,0,0,0,0,0,1,0,0,1,1
4888,118806,NbUyHCtjlZY38KWhmKKrrw2eE1rI3XlV,SpATywNh6bZuzm8s1ceuBUnMUAeoAHHw,1,0,0,0,0,0,1,0,1,0.14285714285714285,1,0.0,0,0,0,0,0,0,0,1,0,0,1,0
4889,118864,uvmnuTMWO7CUJMGmbknJbfcrAcbdWpqR,A3fsA9Zfv1X2fVEQhTw51lKENdNrEqT3,1,0,0,0,0,0,1,0,1,0.14285714285714285,1,0.0,0,0,0,0,0,0,0,1,0,0,1,1
4890,118880,bqWpav7ocOhCfb3xc4QgAvBDK5g8BmiZ,RXDvfPUBYFlVdlueBFbLW0mhhAyGEqpt,12,19,12,0,5,0,7,0,43,6.142857142857143,3,0.0,2,12,0,5,17,0,0,7,0,19,24,0
4891,118884,c8WJAdYLV71mOx4ZXSglpCNd0dBUR3Om,SpATywNh6bZuzm8s1ceuBUnMUAeoAHHw,27,26,16,26,9,0,9,0,86,12.285714285714286,5,0.0,4,16,22,9,22,0,4,9,0,51,35,0
4892,118934,9Nk7mnk1e8KYLiEHu7uBQQPnqWiwScVk,RXDvfPUBYFlVdlueBFbLW0mhhAyGEqpt,47,77,29,93,16,11,25,2,253,36.142857142857146,4,0.0,16,29,83,16,61,11,10,25,2,144,109,1
4893,118936,0PuPhUY9SiHUBSSrbkLAmF5o2IPgOmxV,SpATywNh6bZuzm8s1ceuBUnMUAeoAHHw,9,14,12,0,11,1,2,0,40,5.714285714285714,3,0.0,0,12,0,11,14,1,0,2,0,23,17,1
4894,118948,59I5in7ieFGusS8qxVtrv60LZ3ifOtyr,bWdj2GDclj5ofokWjzoa5jAwMkxCykd6,19,52,23,128,10,0,8,0,221,31.571428571428573,5,0.0,15,23,128,10,37,0,0,8,0,176,45,1
4895,118949,ELJa8A81VOfiqD4Bg0Px962sx2WBYvb0,SpATywNh6bZuzm8s1ceuBUnMUAeoAHHw,12,7,4,0,3,9,5,1,29,4.142857142857143,2,0.0,2,4,0,3,5,9,0,5,1,9,20,0
4896,118951,TBPsTKQ0wiJelelFqXJF9QW001tGl6zy,A3fsA9Zfv1X2fVEQhTw51lKENdNrEqT3,35,28,1,50,0,0,25,1,105,15.0,3,0.0,3,1,45,0,25,0,5,25,1,49,56,1
4897,118960,TzZdxcOoymQCIG3dwqgzf7xbUV8iLHy5,SpATywNh6bZuzm8s1ceuBUnMUAeoAHHw,1,0,0,0,0,0,1,0,1,0.14285714285714285,1,0.0,0,0,0,0,0,0,0,1,0,0,1,1
4898,118971,u2BXxIc4z9dAiJXDpFgnfPpgZoYcSTcc,bWdj2GDclj5ofokWjzoa5jAwMkxCykd6,6,17,11,0,4,0,10,0,42,6.0,5,0.0,0,11,0,4,17,0,0,10,0,15,27,1
4899,118997,mlU6Sa4kvQqDwrJTiTVy3DXIlsysw3Tt,A3fsA9Zfv1X2fVEQhTw51lKENdNrEqT3,35,22,0,92,0,12,9,1,136,19.428571428571427,2,0.0,2,0,75,0,20,12,17,9,1,77,59,1
4900,118998,Xi5jJx0Z2MOBm1fPpYwlvuzwElYhyszd,G8EPVSXsOYB5YQWZGiz1aVq5Pgr2GrQu,7,9,3,0,2,0,1,0,15,2.142857142857143,1,0.0,0,3,0,2,9,0,0,1,0,5,10,1
4901,119004,3eP3vquJMvO37pCrMFuVqCWmbxwqBlGj,A3fsA9Zfv1X2fVEQhTw51lKENdNrEqT3,15,10,8,2,7,0,3,0,30,4.285714285714286,2,0.0,0,8,2,7,10,0,0,3,0,17,13,1
4902,119006,4dfnEKxHCmGabkBCiKHt5nKr3H7Bwo1x,bWdj2GDclj5ofokWjzoa5jAwMkxCykd6,4,3,1,0,1,0,1,0,6,0.8571428571428571,1,0.0,1,1,0,1,2,0,0,1,0,3,3,1
4903,119018,YlBjTpSiRd0E60X9iyws01NkNrRpj13s,SpATywNh6bZuzm8s1ceuBUnMUAeoAHHw,20,16,10,4,8,0,2,0,40,5.714285714285714,1,0.0,5,10,4,8,11,0,0,2,0,27,13,1
4904,119032,1Y8zyxJNFqsbAxngaSR4MBCJMYy7aumA,bWdj2GDclj5ofokWjzoa5jAwMkxCykd6,1,0,0,0,0,0,1,0,1,0.14285714285714285,1,0.0,0,0,0,0,0,0,0,1,0,0,1,1
4905,119045,VXXH6vGXZQbtzT48oIYSMTaYkPq1TVm5,SpATywNh6bZuzm8s1ceuBUnMUAeoAHHw,17,12,7,12,5,3,8,1,48,6.857142857142857,2,0.0,3,7,11,5,9,3,1,8,1,26,22,0
4906,119053,fS72R3kjN9mNNeiYurwm3Uc8w1dF6aYm,SpATywNh6bZuzm8s1ceuBUnMUAeoAHHw,17,37,17,12,6,14,13,1,100,14.285714285714286,5,0.0,13,17,9,6,24,14,3,13,1,45,55,0
4907,119078,JMeqbYMJuCTPv5oP8GGGEcVIzkVIeo33,G8EPVSXsOYB5YQWZGiz1aVq5Pgr2GrQu,5,2,1,0,1,0,4,0,8,1.1428571428571428,1,0.0,0,1,0,1,2,0,0,4,0,2,6,1
4908,119081,GXJYNcNV7uKT2JtMLlsgpwRjSgogNoCV,SpATywNh6bZuzm8s1ceuBUnMUAeoAHHw,15,20,9,24,0,7,8,1,69,9.857142857142858,5,0.0,7,9,18,0,13,7,6,8,1,34,35,1
4909,119083,gqAkLU7vUDjTRzHCYv88c6gFo2DAkAbW,G8EPVSXsOYB5YQWZGiz1aVq5Pgr2GrQu,8,4,2,0,2,0,5,0,13,1.8571428571428572,2,0.0,1,2,0,2,3,0,0,5,0,5,8,1
4910,119099,AcUSYBssFtIXtGaa6RbLXgLyfwfDcCt8,SpATywNh6bZuzm8s1ceuBUnMUAeoAHHw,8,2,1,0,1,0,5,1,10,1.4285714285714286,1,0.0,0,1,0,1,2,0,0,5,1,2,8,1
4911,119114,99Z3XYkjkHbSSUTlX3TBtdd4he2ej5Yp,SpATywNh6bZuzm8s1ceuBUnMUAeoAHHw,6,3,1,0,1,0,2,0,7,1.0,2,0.0,0,1,0,1,3,0,0,2,0,2,5,1
4912,119116,syYCTgfx3QIfokZD3KllJs2hnCVUuN4D,G8EPVSXsOYB5YQWZGiz1aVq5Pgr2GrQu,15,22,15,0,12,0,5,0,54,7.714285714285714,3,0.0,0,15,0,12,22,0,0,5,0,27,27,1
4913,119118,oxh7qXSiU691JDzseRI3suXHok8L6Fau,SpATywNh6bZuzm8s1ceuBUnMUAeoAHHw,1,0,0,0,0,0,1,0,1,0.14285714285714285,1,0.0,0,0,0,0,0,0,0,1,0,0,1,1
4914,119119,t1xspb1k3lEGBshWKCwAoW44MsPqXHk5,SpATywNh6bZuzm8s1ceuBUnMUAeoAHHw,1,0,0,0,0,0,1,0,1,0.14285714285714285,1,0.0,0,0,0,0,0,0,0,1,0,0,1,1
4915,119122,2GmODuvdJOOWe3lnyYMmKWQOHBH828Cm,SpATywNh6bZuzm8s1ceuBUnMUAeoAHHw,21,21,9,18,7,0,3,0,58,8.285714285714286,2,0.0,10,9,17,7,11,0,1,3,0,43,15,1
4916,119128,OUbrW18OgibVb4I41eHFiFhkobpgjEP2,bWdj2GDclj5ofokWjzoa5jAwMkxCykd6,16,17,12,0,9,0,9,0,47,6.714285714285714,2,0.0,0,12,0,9,17,0,0,9,0,21,26,0
4917,119135,LU9kxt8aKnlOn8SnA2EuX2MLajf5Sg2a,RXDvfPUBYFlVdlueBFbLW0mhhAyGEqpt,8,4,2,0,2,0,3,0,11,1.5714285714285714,1,0.0,0,2,0,2,4,0,0,3,0,4,7,1
4918,119144,ppepyuI84wHcCSvA9T6Tm0AI9MVxK9O7,SpATywNh6bZuzm8s1ceuBUnMUAeoAHHw,19,37,16,18,7,14,13,1,106,15.142857142857142,4,0.0,14,16,15,7,23,14,3,13,1,52,54,0
4919,119156,M2R4IY0V8T0jxOaASirvYDTUV5jV2Rus,bWdj2GDclj5ofokWjzoa5jAwMkxCykd6,4,2,0,0,0,0,2,0,4,0.5714285714285714,1,0.0,0,0,0,0,2,0,0,2,0,0,4,1
4920,119158,y71lRBqIdu5iPiLn9Yi5PQm6GFIvgLwB,SpATywNh6bZuzm8s1ceuBUnMUAeoAHHw,17,32,14,22,2,0,8,0,78,11.142857142857142,2,0.0,10,14,20,2,22,0,2,8,0,46,32,0
4921,119168,ekf83KLNEhO9pLixPeJLFRG8dewqTHZv,A3fsA9Zfv1X2fVEQhTw51lKENdNrEqT3,41,39,16,72,7,1,17,2,154,22.0,1,0.0,4,16,57,7,35,1,15,17,2,84,70,1
4922,119181,mu7Zdr1ChN6xNMWE8Otd7Si7TQhm7pEQ,A3fsA9Zfv1X2fVEQhTw51lKENdNrEqT3,15,30,15,0,6,0,25,0,76,10.857142857142858,5,0.0,2,15,0,6,28,0,0,25,0,23,53,1
4923,119186,3RNLJ31M9nSB8CG0xpg62lnc8uIPaM9a,A3fsA9Zfv1X2fVEQhTw51lKENdNrEqT3,1,0,0,0,0,0,1,0,1,0.14285714285714285,1,0.0,0,0,0,0,0,0,0,1,0,0,1,1
4924,119189,OXg5CDewbDZIhWJ50yEsGOqULuWAjfkH,SpATywNh6bZuzm8s1ceuBUnMUAeoAHHw,29,46,16,33,8,0,10,1,114,16.285714285714285,3,0.0,27,16,32,8,19,0,1,10,1,83,31,0
4925,119210,MgBJbfRXH0QNEJmIiGY28SpmFvbhxSoF,SpATywNh6bZuzm8s1ceuBUnMUAeoAHHw,28,56,21,25,7,10,12,0,131,18.714285714285715,4,0.0,6,21,23,7,50,10,2,12,0,57,74,0
4926,119216,jFlacyEy6lTVCBjW1JtG8q0M3te6pg5n,SpATywNh6bZuzm8s1ceuBUnMUAeoAHHw,8,8,7,0,4,0,1,0,20,2.857142857142857,1,0.0,0,7,0,4,8,0,0,1,0,11,9,1
4927,119226,62W3eQBI1VOzt0BqCcwSBPoLO4GuQy3m,SpATywNh6bZuzm8s1ceuBUnMUAeoAHHw,2,0,0,0,0,0,2,0,2,0.2857142857142857,1,0.0,0,0,0,0,0,0,0,2,0,0,2,1
4928,119227,xxkjaaKQsdSI27nMseGDTa7U8FtH9OJW,SpATywNh6bZuzm8s1ceuBUnMUAeoAHHw,1,0,0,0,0,0,2,0,2,0.2857142857142857,2,0.0,0,0,0,0,0,0,0,2,0,0,2,0
4929,119231,eZgbWFMeI0otfUV1lMfDbtMKCRIv32Fs,bWdj2GDclj5ofokWjzoa5jAwMkxCykd6,4,2,1,0,1,0,1,0,5,0.7142857142857143,1,0.0,0,1,0,1,2,0,0,1,0,2,3,1
4930,119244,l5XRpi9H4fQ2XUHeEPRXRHL6Y4BckIOB,SpATywNh6bZuzm8s1ceuBUnMUAeoAHHw,5,2,1,0,1,0,2,0,6,0.8571428571428571,1,0.0,0,1,0,1,2,0,0,2,0,2,4,1
4931,119254,i0ksX07HnsV5rQlWqOr1uKEuc7yNU24c,SpATywNh6bZuzm8s1ceuBUnMUAeoAHHw,23,39,19,10,7,26,19,2,122,17.428571428571427,8,0.0,8,19,8,7,31,26,2,19,2,42,80,0
4932,119269,NLv4FgxnCzxez4sx4x5czDhMA2RThzip,bWdj2GDclj5ofokWjzoa5jAwMkxCykd6,5,2,1,0,1,0,2,0,6,0.8571428571428571,1,0.0,0,1,0,1,2,0,0,2,0,2,4,1
4933,119277,sBmxTL0paOf5h6iJST2iiGwB52qodqPr,bWdj2GDclj5ofokWjzoa5jAwMkxCykd6,22,36,18,78,4,36,31,3,206,29.428571428571427,6,0.0,7,18,76,4,29,36,2,31,3,105,101,0
4934,119279,FOCwtnRC84DvGRNwirqX2TIHG72pPbnw,SpATywNh6bZuzm8s1ceuBUnMUAeoAHHw,24,36,18,15,0,4,10,2,85,12.142857142857142,3,0.0,5,18,15,0,31,4,0,10,2,38,47,0
4935,119282,YoVBBM37O51IO7pPJxiQFT0wqXwSlTU1,SpATywNh6bZuzm8s1ceuBUnMUAeoAHHw,1,0,0,0,0,0,2,0,2,0.2857142857142857,1,0.0,0,0,0,0,0,0,0,2,0,0,2,1
4936,119302,YRQYtB97mu5D5o5X26cOj03m1GAHWWGU,A3fsA9Zfv1X2fVEQhTw51lKENdNrEqT3,1,0,0,0,0,0,1,0,1,0.14285714285714285,1,0.0,0,0,0,0,0,0,0,1,0,0,1,1
4937,119311,o5C13ZWWgtJ11zB44EfcDF5SUBXAMxu8,SpATywNh6bZuzm8s1ceuBUnMUAeoAHHw,20,22,4,10,3,2,16,2,59,8.428571428571429,4,0.0,2,4,8,3,20,2,2,16,2,17,42,0
4938,119315,ektlnuTUH55osIRyBZ2zIfPZcGRkwXyX,SpATywNh6bZuzm8s1ceuBUnMUAeoAHHw,6,2,1,0,1,0,2,0,6,0.8571428571428571,1,0.0,0,1,0,1,2,0,0,2,0,2,4,1
4939,119318,LKEJY5MvP0gj7M4NL5iRnXDBazXBKsOA,A3fsA9Zfv1X2fVEQhTw51lKENdNrEqT3,11,14,4,0,3,0,2,0,23,3.2857142857142856,1,0.0,0,4,0,3,14,0,0,2,0,7,16,1
4940,119333,om0KjvovtBK0gZUSboAPRv5A6Jkm00Ei,SpATywNh6bZuzm8s1ceuBUnMUAeoAHHw,2,0,0,0,0,0,2,0,2,0.2857142857142857,2,0.0,0,0,0,0,0,0,0,2,0,0,2,1
4941,119347,hpQLTEd5unsxchTVftQsLrZknN9z8sq4,bWdj2GDclj5ofokWjzoa5jAwMkxCykd6,6,4,1,0,1,0,2,0,8,1.1428571428571428,1,0.0,0,1,0,1,4,0,0,2,0,2,6,1
4942,119352,8EUVcR3i03tV4r6XHeEe98sUtzrKJPIp,SpATywNh6bZuzm8s1ceuBUnMUAeoAHHw,25,25,15,12,6,2,9,0,69,9.857142857142858,6,0.0,5,15,12,6,20,2,0,9,0,38,31,0
4943,119354,dTKURyZ9dyqGbe4l7wsUGgSU85JHBAFq,SpATywNh6bZuzm8s1ceuBUnMUAeoAHHw,13,10,3,0,3,0,2,0,18,2.5714285714285716,2,0.0,0,3,0,3,10,0,0,2,0,6,12,0
4944,119356,a7ZVMpb0c7CARO4liNTBsp4hgkFIkG4C,bWdj2GDclj5ofokWjzoa5jAwMkxCykd6,1,0,0,0,0,0,2,0,2,0.2857142857142857,1,0.0,0,0,0,0,0,0,0,2,0,0,2,1
4945,119380,6CE4R3S7kL46D5t23wqANpKa4VUqa9S2,SpATywNh6bZuzm8s1ceuBUnMUAeoAHHw,8,10,1,0,1,0,4,0,16,2.2857142857142856,2,0.0,0,1,0,1,10,0,0,4,0,2,14,1
4946,119386,nIvIddlMAmTQagaACOulbZ6PInxlyOy2,SpATywNh6bZuzm8s1ceuBUnMUAeoAHHw,24,41,22,24,8,5,7,1,108,15.428571428571429,2,0.0,14,22,24,8,27,5,0,7,1,68,40,1
4947,119390,hZR4MwcYec4g0GoOyJFngJGEyWOySpv2,A3fsA9Zfv1X2fVEQhTw51lKENdNrEqT3,9,12,8,0,6,5,10,0,41,5.857142857142857,4,0.0,0,8,0,6,12,5,0,10,0,14,27,0
4948,119391,mxHDkP66knN7zmdYEUQKDHYwEophbx3W,SpATywNh6bZuzm8s1ceuBUnMUAeoAHHw,30,47,26,18,16,135,16,4,262,37.42857142857143,5,0.0,10,26,16,16,37,135,2,16,4,68,194,0
4949,119429,OTXI4wiLpFntQK2eNytsM7PA1sOBHBSJ,G8EPVSXsOYB5YQWZGiz1aVq5Pgr2GrQu,14,39,3,40,6,7,2,0,97,13.857142857142858,2,0.0,23,3,32,6,16,7,8,2,0,64,33,0
4950,119430,dHUuZjpItF11lyBzOZmo46k7ssSyfCST,SpATywNh6bZuzm8s1ceuBUnMUAeoAHHw,7,5,3,0,2,0,2,0,12,1.7142857142857142,1,0.0,0,3,0,2,5,0,0,2,0,5,7,1
4951,119439,lzAfN1BunM1OtPEKsFi16ad7rFshkF39,A3fsA9Zfv1X2fVEQhTw51lKENdNrEqT3,10,5,3,0,2,0,7,0,17,2.4285714285714284,1,0.0,0,3,0,2,5,0,0,7,0,5,12,1
4952,119467,HTcH1TxkMChxNxwRHZ3kkRRHs5Azwnka,SpATywNh6bZuzm8s1ceuBUnMUAeoAHHw,14,47,7,24,1,10,19,0,108,15.428571428571429,3,0.0,14,7,20,1,33,10,4,19,0,42,66,0
4953,119487,pPq1reHOvROgjdMRqZ7zZoFjsUW0sHcE,SpATywNh6bZuzm8s1ceuBUnMUAeoAHHw,8,21,12,0,6,0,7,0,46,6.571428571428571,2,0.0,0,12,0,6,21,0,0,7,0,18,28,1
4954,119490,83cBV2IXkwoW1nUaa1kxaJ98L3bxFsPn,RXDvfPUBYFlVdlueBFbLW0mhhAyGEqpt,27,71,51,16,2,31,17,0,188,26.857142857142858,8,0.0,7,51,15,2,64,31,1,17,0,75,113,1
4955,119494,4SbF4DhXcYorYYyJ4XmwwPJZFVh1ZUhY,bWdj2GDclj5ofokWjzoa5jAwMkxCykd6,2,0,0,0,0,0,2,0,2,0.2857142857142857,1,0.0,0,0,0,0,0,0,0,2,0,0,2,1
4956,119495,QXg7RHDSlJliIBbIO3xqJ8cmekKDZLIJ,RXDvfPUBYFlVdlueBFbLW0mhhAyGEqpt,1,0,0,0,0,0,1,0,1,0.14285714285714285,1,0.0,0,0,0,0,0,0,0,1,0,0,1,1
4957,119499,j55CnsxXtuPHDTIgqOvx7oExU3RRtQ4I,bWdj2GDclj5ofokWjzoa5jAwMkxCykd6,1,0,0,0,0,0,1,0,1,0.14285714285714285,1,0.0,0,0,0,0,0,0,0,1,0,0,1,1
4958,119506,KouA4JUz2i1n0FC6Xu2JucWPd7vnGUb0,SpATywNh6bZuzm8s1ceuBUnMUAeoAHHw,28,85,16,18,7,1,29,0,156,22.285714285714285,9,0.0,6,16,18,7,79,1,0,29,0,47,109,0
4959,119509,8MuGb55gUM18pukCITXgZoTSobqXs9G4,SpATywNh6bZuzm8s1ceuBUnMUAeoAHHw,9,7,0,14,0,2,1,0,24,3.4285714285714284,1,0.0,2,0,13,0,5,2,1,1,0,15,9,1
4960,119522,VC4hf15u71ct6dl0hPNvhbtubU19kXe5,RXDvfPUBYFlVdlueBFbLW0mhhAyGEqpt,8,17,2,0,3,0,4,0,26,3.7142857142857144,2,0.0,4,2,0,3,13,0,0,4,0,9,17,1
4961,119524,RRKT0H2BFDE1dQIQFr3IpZgVIVSJVg71,SpATywNh6bZuzm8s1ceuBUnMUAeoAHHw,29,73,28,27,8,2,19,0,157,22.428571428571427,8,0.0,26,28,23,8,47,2,4,19,0,85,72,0
4962,119543,Cf7GCeUZzG7WjvUIyGfwv9hfcwXPVq5G,G8EPVSXsOYB5YQWZGiz1aVq5Pgr2GrQu,71,139,5,178,6,0,18,1,347,49.57142857142857,6,0.0,41,5,140,6,98,0,38,18,1,192,155,0
4963,119566,TeehsynnhYxXCw31hnpNtyZisOmQoW1M,A3fsA9Zfv1X2fVEQhTw51lKENdNrEqT3,12,11,9,0,7,0,5,0,32,4.571428571428571,1,0.0,0,9,0,7,11,0,0,5,0,16,16,1
4964,119567,Dl433WBzpFXMdRxwA66dmtxmpsyN7fkX,SpATywNh6bZuzm8s1ceuBUnMUAeoAHHw,13,17,3,0,2,0,5,0,27,3.857142857142857,4,0.0,0,3,0,2,17,0,0,5,0,5,22,0
4965,119571,sZV7O4QepCcao3DEyr879t5mUWopWkVJ,SpATywNh6bZuzm8s1ceuBUnMUAeoAHHw,8,10,2,14,0,0,1,0,27,3.857142857142857,1,0.0,6,2,14,0,4,0,0,1,0,22,5,0
4966,119594,LKtddpPnbyASKztptrkj08yJIKu8wvyQ,SpATywNh6bZuzm8s1ceuBUnMUAeoAHHw,7,10,2,0,2,0,3,0,17,2.4285714285714284,2,0.0,0,2,0,2,10,0,0,3,0,4,13,1
4967,119600,SSpeewBDHUNKkvUJM5ASinNHvMXIOEwr,G8EPVSXsOYB5YQWZGiz1aVq5Pgr2GrQu,2,0,0,0,0,2,1,0,3,0.42857142857142855,1,0.0,0,0,0,0,0,2,0,1,0,0,3,1
4968,119618,nIvIddlMAmTQagaACOulbZ6PInxlyOy2,A3fsA9Zfv1X2fVEQhTw51lKENdNrEqT3,1,0,0,0,0,0,1,0,1,0.14285714285714285,1,0.0,0,0,0,0,0,0,0,1,0,0,1,1
4969,119619,nIvIddlMAmTQagaACOulbZ6PInxlyOy2,bWdj2GDclj5ofokWjzoa5jAwMkxCykd6,5,2,1,0,1,0,3,0,7,1.0,2,0.0,0,1,0,1,2,0,0,3,0,2,5,1
4970,119631,ltVEinCK1OZ9CXJhcqdDg6iZlAvKKTwQ,SpATywNh6bZuzm8s1ceuBUnMUAeoAHHw,20,24,12,16,5,8,15,3,83,11.857142857142858,2,0.0,8,12,13,5,16,8,3,15,3,38,45,0
4971,119652,Zu9dYhL9acZhCeqBcc9hWzPmaWR78jEQ,SpATywNh6bZuzm8s1ceuBUnMUAeoAHHw,27,31,16,28,8,23,23,4,133,19.0,4,0.0,8,16,26,8,23,23,2,23,4,58,75,1
4972,119657,3uRdpkkFK8afBf0m3EhgoX6LxrN8Pbes,SpATywNh6bZuzm8s1ceuBUnMUAeoAHHw,7,4,2,0,1,0,2,0,9,1.2857142857142858,1,0.0,0,2,0,1,4,0,0,2,0,3,6,1
4973,119664,8pu9JNwVnUBnBwmPCcdXCPyTfkNF9IyH,SpATywNh6bZuzm8s1ceuBUnMUAeoAHHw,1,0,0,0,0,0,1,0,1,0.14285714285714285,1,0.0,0,0,0,0,0,0,0,1,0,0,1,1
4974,119695,EGp6xRzNCnsCPDRg0mfvtfy8t2jZt4I9,SpATywNh6bZuzm8s1ceuBUnMUAeoAHHw,29,81,18,44,7,11,11,0,172,24.571428571428573,4,0.0,58,18,38,7,23,11,6,11,0,121,51,0
4975,119701,dkqBzIxmPMIDvZ06VSkMjfODuMzZmTP8,A3fsA9Zfv1X2fVEQhTw51lKENdNrEqT3,7,5,3,0,2,0,3,0,13,1.8571428571428572,3,0.0,0,3,0,2,5,0,0,3,0,5,8,1
4976,119717,uNXbTIc96Uw6O7qA5DEUx7vv6h22TWxF,SpATywNh6bZuzm8s1ceuBUnMUAeoAHHw,5,2,1,0,1,0,2,0,6,0.8571428571428571,1,0.0,0,1,0,1,2,0,0,2,0,2,4,1
4977,119722,xdLtxzmqjHKGxCxWUtaHyGHCjlQjqauy,SpATywNh6bZuzm8s1ceuBUnMUAeoAHHw,5,2,1,0,1,0,2,0,6,0.8571428571428571,1,0.0,0,1,0,1,2,0,0,2,0,2,4,1
4978,119745,UvgRbw5a5wuG6YWcUt1dwOeNyn0b7Smd,SpATywNh6bZuzm8s1ceuBUnMUAeoAHHw,12,17,2,4,3,0,5,0,31,4.428571428571429,5,0.0,3,2,4,3,14,0,0,5,0,12,19,1
4979,119756,xdLtxzmqjHKGxCxWUtaHyGHCjlQjqauy,RXDvfPUBYFlVdlueBFbLW0mhhAyGEqpt,6,1,1,0,1,0,3,0,6,0.8571428571428571,1,0.0,0,1,0,1,1,0,0,3,0,2,4,1
4980,119780,6r9w9XrCXpAInFHxfDIxOD9m18cX5jcd,bWdj2GDclj5ofokWjzoa5jAwMkxCykd6,1,0,0,0,0,0,1,0,1,0.14285714285714285,1,0.0,0,0,0,0,0,0,0,1,0,0,1,1
4981,119787,lWx0TIRF08ECAhAH5cUKSzERq6JEXGBg,A3fsA9Zfv1X2fVEQhTw51lKENdNrEqT3,1,0,0,0,0,0,1,0,1,0.14285714285714285,1,0.0,0,0,0,0,0,0,0,1,0,0,1,1
4982,119829,evMifCtMisukBDxvYkui0DyIUgVf4aQM,SpATywNh6bZuzm8s1ceuBUnMUAeoAHHw,1,0,0,0,0,0,1,0,1,0.14285714285714285,1,0.0,0,0,0,0,0,0,0,1,0,0,1,1
4983,119831,xrGttsK9FjNRictE1FckUAFqkfpHfKEh,bWdj2GDclj5ofokWjzoa5jAwMkxCykd6,13,14,8,64,3,2,4,2,97,13.857142857142858,1,0.0,1,8,63,3,13,2,1,4,2,75,22,1
4984,119853,uF2Lhc31StnMPtUmgamWrmnuCJ4n9iAe,bWdj2GDclj5ofokWjzoa5jAwMkxCykd6,7,2,1,0,1,1,5,1,11,1.5714285714285714,1,0.0,0,1,0,1,2,1,0,5,1,2,9,0
4985,119860,zvwdGnH0aGIXM4GZVb8XpCl4QdIDbhPS,G8EPVSXsOYB5YQWZGiz1aVq5Pgr2GrQu,60,102,45,67,26,34,37,4,315,45.0,7,0.0,26,45,59,26,76,34,8,37,4,156,159,1
4986,119863,C8zDhaG0vPsQegBtS55u3JZHiYuueFnE,A3fsA9Zfv1X2fVEQhTw51lKENdNrEqT3,22,26,3,14,1,3,21,3,71,10.142857142857142,4,0.0,0,3,12,1,26,3,2,21,3,16,55,0
4987,119864,i9tnH9kRJ3DOJJRtKKsLYacNrvT4eUwS,SpATywNh6bZuzm8s1ceuBUnMUAeoAHHw,1,0,0,0,0,0,1,0,1,0.14285714285714285,1,0.0,0,0,0,0,0,0,0,1,0,0,1,1
4988,119865,fl8sEptrcl2JvFWXejFcnsM7BqWtKl9w,SpATywNh6bZuzm8s1ceuBUnMUAeoAHHw,30,61,25,32,12,0,9,2,141,20.142857142857142,4,0.0,20,25,22,12,41,0,10,9,2,79,62,1
4989,119866,VLCI0RtMsYSrwlXRiyKxAF4TijVOF7sG,SpATywNh6bZuzm8s1ceuBUnMUAeoAHHw,23,83,14,18,2,15,11,2,145,20.714285714285715,6,0.0,34,14,18,2,49,15,0,11,2,68,77,0
4990,119941,5rpYxIaCTDb4PhszkJWpACOx5VMpNGcQ,RXDvfPUBYFlVdlueBFbLW0mhhAyGEqpt,1,0,0,0,0,0,1,0,1,0.14285714285714285,1,0.0,0,0,0,0,0,0,0,1,0,0,1,1
4991,119944,ico4mWfX6sj6OUii1pav0Sth51UYo7la,SpATywNh6bZuzm8s1ceuBUnMUAeoAHHw,4,2,1,0,1,0,1,0,5,0.7142857142857143,1,0.0,0,1,0,1,2,0,0,1,0,2,3,1
4992,119957,u08BFRXkclhXgm6zX4b6QASKB5vRi3vI,G8EPVSXsOYB5YQWZGiz1aVq5Pgr2GrQu,81,132,78,539,30,28,27,2,836,119.42857142857143,5,0.0,42,78,510,30,90,28,29,27,2,660,176,1
4993,119963,CjBVUSApACPW9BPUvs2DTjIpAnotUs5g,SpATywNh6bZuzm8s1ceuBUnMUAeoAHHw,14,18,1,19,1,1,9,1,50,7.142857142857143,1,0.0,11,1,16,1,7,1,3,9,1,29,21,1
4994,119979,SplRKhPt7Yggv7MXNRiesXXwYzrLK9vJ,G8EPVSXsOYB5YQWZGiz1aVq5Pgr2GrQu,4,3,1,0,1,0,1,0,6,0.8571428571428571,3,0.0,0,1,0,1,3,0,0,1,0,2,4,1
4995,119986,EjqS3A2Iv9J8JTjinbKy3gdtrrXaSQyJ,A3fsA9Zfv1X2fVEQhTw51lKENdNrEqT3,3,2,1,0,0,0,1,0,4,0.5714285714285714,1,0.0,0,1,0,0,2,0,0,1,0,1,3,1
4996,120002,12gMTBWTVUlnqCedZPd5qmMR4GGhf0zr,SpATywNh6bZuzm8s1ceuBUnMUAeoAHHw,5,4,2,0,0,0,2,1,9,1.2857142857142858,1,0.0,0,2,0,0,4,0,0,2,1,2,7,1
4997,120012,i2raPzmlvNePAOSFdEUwI0BA2bKyQ3vM,G8EPVSXsOYB5YQWZGiz1aVq5Pgr2GrQu,1,0,0,0,0,0,1,0,1,0.14285714285714285,1,0.0,0,0,0,0,0,0,0,1,0,0,1,1
4998,120030,OCy6YOUNXmqhix568ujBGQdiiP42aDkJ,A3fsA9Zfv1X2fVEQhTw51lKENdNrEqT3,2,0,0,0,0,0,2,0,2,0.2857142857142857,1,0.0,0,0,0,0,0,0,0,2,0,0,2,1
4999,120034,ZdyJOuWyQCEC2K6zkBmHBJ8KuSKqmluL,SpATywNh6bZuzm8s1ceuBUnMUAeoAHHw,1,0,0,0,0,0,1,0,1,0.14285714285714285,1,0.0,0,0,0,0,0,0,0,1,0,0,1,1
5000,120045,sUwmc6V8FwsEYMDv4tIg9OLo8ph5JoxU,SpATywNh6bZuzm8s1ceuBUnMUAeoAHHw,21,21,13,25,11,1,4,1,76,10.857142857142858,1,0.0,6,13,20,11,15,1,5,4,1,50,26,1
5001,120047,YeW4hKsNTCNPhFuRao1EDcfgQ0cnIKSL,SpATywNh6bZuzm8s1ceuBUnMUAeoAHHw,17,23,10,19,4,2,6,0,64,9.142857142857142,3,0.0,5,10,16,4,18,2,3,6,0,35,29,0
5002,120057,UUY3BPLR7A3Xa6FGsztMCn6xCbxtdCYu,RXDvfPUBYFlVdlueBFbLW0mhhAyGEqpt,1,0,0,0,0,0,1,0,1,0.14285714285714285,1,0.0,0,0,0,0,0,0,0,1,0,0,1,0
5003,120065,fFuKiCeoQQwOgD8VAud2ta198Mbq05KK,A3fsA9Zfv1X2fVEQhTw51lKENdNrEqT3,19,23,10,0,8,4,9,1,55,7.857142857142857,2,0.0,0,10,0,8,23,4,0,9,1,18,37,1
5004,120079,L8OTKfJAxDSZZQ12fQtkWrcZUlsGAJb9,RXDvfPUBYFlVdlueBFbLW0mhhAyGEqpt,18,29,9,24,5,4,15,0,86,12.285714285714286,3,0.0,8,9,24,5,21,4,0,15,0,46,40,1
5005,120090,ZOVfvlm206voHlGJ4V6McNGjtxTxB7JQ,bWdj2GDclj5ofokWjzoa5jAwMkxCykd6,5,4,2,0,1,0,3,0,10,1.4285714285714286,2,0.0,0,2,0,1,4,0,0,3,0,3,7,1
5006,120094,rn4nO5004kgupfgjaXh0qv5wJPGuOGCi,RXDvfPUBYFlVdlueBFbLW0mhhAyGEqpt,44,120,1,107,33,0,10,1,272,38.857142857142854,2,0.0,74,1,85,33,46,0,22,10,1,193,79,1
5007,120112,1mkiIDsUp1k3i5MLWwlZyMuhsxinTdaD,SpATywNh6bZuzm8s1ceuBUnMUAeoAHHw,2,0,0,0,0,0,2,0,2,0.2857142857142857,1,0.0,0,0,0,0,0,0,0,2,0,0,2,0
5008,120117,rZEWlNSgKDNaTi3a1r581EGtpdBLkfvY,bWdj2GDclj5ofokWjzoa5jAwMkxCykd6,4,2,1,0,1,6,1,0,11,1.5714285714285714,1,0.0,0,1,0,1,2,6,0,1,0,2,9,1
5009,120128,5cb6e9jDwVr8l5vkAvM3VmmyddxE34Qz,SpATywNh6bZuzm8s1ceuBUnMUAeoAHHw,13,8,5,13,3,0,1,0,30,4.285714285714286,1,0.0,2,5,13,3,6,0,0,1,0,23,7,1
5010,120139,n82RJkzFXSSDMIdkMmtipPuRNBWDUBXQ,SpATywNh6bZuzm8s1ceuBUnMUAeoAHHw,16,33,16,14,5,0,10,3,81,11.571428571428571,3,0.0,5,16,12,5,28,0,2,10,3,38,43,1
5011,120168,oXcCXnNaPGvzw5MpNzQ49lDnTqlhdcyO,A3fsA9Zfv1X2fVEQhTw51lKENdNrEqT3,8,5,3,0,2,0,3,0,13,1.8571428571428572,2,0.0,0,3,0,2,5,0,0,3,0,5,8,1
5012,120195,1LkX4t7QGG0LPbqqJvnwJmrweFNAYkvm,A3fsA9Zfv1X2fVEQhTw51lKENdNrEqT3,11,9,1,0,0,0,9,2,21,3.0,2,0.0,0,1,0,0,9,0,0,9,2,1,20,1
5013,120215,UnBwSmlOPbYUmVq2fUKodPbT52jzjDn0,A3fsA9Zfv1X2fVEQhTw51lKENdNrEqT3,23,18,16,0,12,0,3,0,49,7.0,2,0.0,0,16,0,12,18,0,0,3,0,28,21,0
5014,120223,nrDkIZH2wqEVh6i4pBxcbRBJIMc9s20b,G8EPVSXsOYB5YQWZGiz1aVq5Pgr2GrQu,59,104,4,186,4,0,24,0,322,46.0,5,0.0,34,4,161,4,70,0,25,24,0,203,119,0
5015,120226,Y9zzxa8aT5mj3vCCOFRszZ8rRbH90TaX,SpATywNh6bZuzm8s1ceuBUnMUAeoAHHw,5,2,1,0,1,0,2,0,6,0.8571428571428571,1,0.0,0,1,0,1,2,0,0,2,0,2,4,1
5016,120232,RYd1k9DojojPZwrkV3NjsTI5OdZnPV9W,SpATywNh6bZuzm8s1ceuBUnMUAeoAHHw,12,21,0,12,2,0,5,0,40,5.714285714285714,2,0.0,2,0,12,2,19,0,0,5,0,16,24,0
5017,120235,RYd1k9DojojPZwrkV3NjsTI5OdZnPV9W,RXDvfPUBYFlVdlueBFbLW0mhhAyGEqpt,8,11,0,0,0,0,3,0,14,2.0,2,0.0,0,0,0,0,11,0,0,3,0,0,14,1
5018,120239,80Av2RXrFoxNOdv7EQUM2TDOM0gyNH0J,SpATywNh6bZuzm8s1ceuBUnMUAeoAHHw,25,19,12,27,7,13,3,0,81,11.571428571428571,2,0.0,2,12,23,7,17,13,4,3,0,44,37,1
5019,120266,kV6dnmPo3GuG7esOG3uZN9iddNOehLbM,SpATywNh6bZuzm8s1ceuBUnMUAeoAHHw,18,30,2,7,1,4,14,2,60,8.571428571428571,3,0.0,5,2,7,1,25,4,0,14,2,15,45,1
5020,120275,wx3mAGKFM6cge9w8piWfsYKppmWVhkYO,A3fsA9Zfv1X2fVEQhTw51lKENdNrEqT3,8,8,4,0,2,0,4,0,18,2.5714285714285716,3,0.0,0,4,0,2,8,0,0,4,0,6,12,1
5021,120282,nWkYRwHsKkKnBVjIvOv2LYBdEyL0lZTL,A3fsA9Zfv1X2fVEQhTw51lKENdNrEqT3,6,9,1,0,1,0,2,0,13,1.8571428571428572,1,0.0,0,1,0,1,9,0,0,2,0,2,11,1
5022,120288,MWFzxiL4ehMt7chFh9qPkkqOh2NLyxIv,bWdj2GDclj5ofokWjzoa5jAwMkxCykd6,2,0,0,0,0,0,2,0,2,0.2857142857142857,1,0.0,0,0,0,0,0,0,0,2,0,0,2,1
5023,120297,7xobbz91DmuqnSowtdCPvlArDkv1wvpY,bWdj2GDclj5ofokWjzoa5jAwMkxCykd6,8,5,1,0,1,1,10,1,19,2.7142857142857144,4,0.0,0,1,0,1,5,1,0,10,1,2,17,0
5024,120300,8ZCGZdwxBMJVwPZ7vVYEdVzHcXfqVToG,SpATywNh6bZuzm8s1ceuBUnMUAeoAHHw,26,29,7,39,4,24,14,3,120,17.142857142857142,2,0.0,9,7,34,4,20,24,5,14,3,54,66,1
5025,120301,R65nId6muEQL5ltvz9x70wBSJAG43Ylw,SpATywNh6bZuzm8s1ceuBUnMUAeoAHHw,1,0,0,0,0,0,1,0,1,0.14285714285714285,1,0.0,0,0,0,0,0,0,0,1,0,0,1,1
5026,120312,1cbn6mbdbvkgaRHmtNkyztYkaJcKUMeq,A3fsA9Zfv1X2fVEQhTw51lKENdNrEqT3,26,6,4,88,1,0,9,0,108,15.428571428571429,2,0.0,2,4,73,1,4,0,15,9,0,80,28,1
5027,120319,SslryCWQFxjgJq7Qzkpxu4WYyOvHjfIA,SpATywNh6bZuzm8s1ceuBUnMUAeoAHHw,12,19,0,10,0,0,5,0,34,4.857142857142857,2,0.0,2,0,9,0,17,0,1,5,0,11,23,1
5028,120324,BFpj8Vxul230N4kCbxR9rjWJ12ZQLtAV,RXDvfPUBYFlVdlueBFbLW0mhhAyGEqpt,12,30,1,0,2,0,7,1,41,5.857142857142857,3,0.0,2,1,0,2,28,0,0,7,1,5,36,0
5029,120327,gxxdbeVvaQEKyOVBSC4fF8ei2zEnQClv,SpATywNh6bZuzm8s1ceuBUnMUAeoAHHw,7,3,3,0,2,0,3,0,11,1.5714285714285714,1,0.0,0,3,0,2,3,0,0,3,0,5,6,1
5030,120357,v5FeWqSlnditqY6z5ibAMUPKlbcY2Zcg,bWdj2GDclj5ofokWjzoa5jAwMkxCykd6,1,0,0,0,0,0,1,0,1,0.14285714285714285,1,0.0,0,0,0,0,0,0,0,1,0,0,1,1
5031,120395,jFlacyEy6lTVCBjW1JtG8q0M3te6pg5n,RXDvfPUBYFlVdlueBFbLW0mhhAyGEqpt,4,3,2,0,1,0,1,0,7,1.0,1,0.0,0,2,0,1,3,0,0,1,0,3,4,1
5032,120424,PazYalgu71qbC99y9FrRjNpcniWiR2x1,RXDvfPUBYFlVdlueBFbLW0mhhAyGEqpt,11,5,4,0,2,0,4,1,16,2.2857142857142856,1,0.0,0,4,0,2,5,0,0,4,1,6,10,1
5033,120452,5PCeecJ7dPIRTUfiwjNNMWT45OJxiKsA,SpATywNh6bZuzm8s1ceuBUnMUAeoAHHw,24,37,19,43,7,0,5,0,111,15.857142857142858,3,0.0,13,19,34,7,24,0,9,5,0,73,38,1
5034,120497,pb5Jjq3Ash9pKloUfJAc3dsHOjXwUSUN,SpATywNh6bZuzm8s1ceuBUnMUAeoAHHw,4,8,0,0,0,0,4,0,12,1.7142857142857142,2,0.0,0,0,0,0,8,0,0,4,0,0,12,1
5035,120499,5scsz5bGh8T1roTXhO7UpMXlEDKIsK9l,SpATywNh6bZuzm8s1ceuBUnMUAeoAHHw,19,28,10,17,5,7,6,1,74,10.571428571428571,2,0.0,10,10,15,5,18,7,2,6,1,40,34,1
5036,120528,QHRLeTLFcpDFqErTvT3KvB62zPnO9tRZ,SpATywNh6bZuzm8s1ceuBUnMUAeoAHHw,4,4,0,0,0,0,1,0,5,0.7142857142857143,1,0.0,0,0,0,0,4,0,0,1,0,0,5,1
5037,120544,OektSQ9TNN3cEy3ZKuUs35c7BdSOqtaQ,bWdj2GDclj5ofokWjzoa5jAwMkxCykd6,7,7,4,0,1,0,7,0,19,2.7142857142857144,1,0.0,0,4,0,1,7,0,0,7,0,5,14,1
5038,120579,s7QoBInBc5uVUNfTUCWn8dY2DMQUeNQJ,SpATywNh6bZuzm8s1ceuBUnMUAeoAHHw,6,1,1,0,1,1,3,1,8,1.1428571428571428,1,0.0,0,1,0,1,1,1,0,3,1,2,6,1
5039,120583,cOTtp4pVPpt9GEFdMZaLCIG1IBXouqo8,SpATywNh6bZuzm8s1ceuBUnMUAeoAHHw,2,0,0,0,0,0,2,0,2,0.2857142857142857,1,0.0,0,0,0,0,0,0,0,2,0,0,2,1
5040,120613,o5eh9IEuVj6wwGOFQd5A60hJwFcyh5aW,SpATywNh6bZuzm8s1ceuBUnMUAeoAHHw,2,0,0,0,0,0,2,0,2,0.2857142857142857,1,0.0,0,0,0,0,0,0,0,2,0,0,2,1
5041,120641,bVdTa6NU9Mptus5JV6dyU7pKOHw1EO1M,bWdj2GDclj5ofokWjzoa5jAwMkxCykd6,1,0,0,0,0,0,1,0,1,0.14285714285714285,1,0.0,0,0,0,0,0,0,0,1,0,0,1,1
5042,120666,NTsLMBrSdSgh32E5eAwn0TyewK2E1eGS,A3fsA9Zfv1X2fVEQhTw51lKENdNrEqT3,1,0,0,0,0,0,1,0,1,0.14285714285714285,1,0.0,0,0,0,0,0,0,0,1,0,0,1,1
5043,120674,cR6ka5k7tAsfYo9cLOUPkpzWO6OItcGJ,G8EPVSXsOYB5YQWZGiz1aVq5Pgr2GrQu,29,30,24,6,17,0,7,0,84,12.0,3,0.0,0,24,5,17,30,0,1,7,0,46,38,1
5044,120675,CaJSrSiICAfSlo2FFV44vmQh9prPvDrE,A3fsA9Zfv1X2fVEQhTw51lKENdNrEqT3,12,12,5,0,3,0,6,0,26,3.7142857142857144,1,0.0,0,5,0,3,12,0,0,6,0,8,18,1
5045,120686,u5ObOMoHUcvVsOQTGkiv0BRKKcn8v2w8,bWdj2GDclj5ofokWjzoa5jAwMkxCykd6,4,2,1,0,1,0,1,0,5,0.7142857142857143,1,0.0,0,1,0,1,2,0,0,1,0,2,3,1
5046,120697,FJyrOX14z7chWU6pIsUghN5yUhlIZ5Lj,SpATywNh6bZuzm8s1ceuBUnMUAeoAHHw,3,2,0,0,0,0,2,0,4,0.5714285714285714,1,0.0,0,0,0,0,2,0,0,2,0,0,4,0
5047,120703,4dodDlxC4kpDOhgavFhn4UZKBioEfZ2a,SpATywNh6bZuzm8s1ceuBUnMUAeoAHHw,17,46,2,20,2,18,37,5,130,18.571428571428573,4,0.0,25,2,17,2,21,18,3,37,5,46,84,1
5048,120716,RhtPF62U20vYvwTeCimLFb40aCkmO2cH,SpATywNh6bZuzm8s1ceuBUnMUAeoAHHw,5,2,1,0,1,0,2,0,6,0.8571428571428571,1,0.0,0,1,0,1,2,0,0,2,0,2,4,1
5049,120722,1R1zO9aMB7Mx1Lw84JzsChVEV5JpwmZv,G8EPVSXsOYB5YQWZGiz1aVq5Pgr2GrQu,75,113,21,166,17,12,26,0,355,50.714285714285715,10,0.0,37,21,121,17,76,12,45,26,0,196,159,1
5050,120751,fTZGf1uwMtb2LTyvoTILgCp8LRW0SKIe,RXDvfPUBYFlVdlueBFbLW0mhhAyGEqpt,11,20,8,18,7,0,1,0,54,7.714285714285714,3,0.0,9,8,15,7,11,0,3,1,0,39,15,1
5051,120759,yTPVosjRFgkyQAyVowXjYrsQYKByzY4B,A3fsA9Zfv1X2fVEQhTw51lKENdNrEqT3,20,19,1,56,0,29,7,1,113,16.142857142857142,3,0.0,4,1,44,0,15,29,12,7,1,49,64,1
5052,120771,IvdoAzckjyWWCkzCy6V0BjWvOwMyZEwg,bWdj2GDclj5ofokWjzoa5jAwMkxCykd6,21,33,18,28,8,14,21,2,124,17.714285714285715,6,0.0,7,18,27,8,26,14,1,21,2,60,64,1
5053,120774,7hx1Kw9WXBMDyaoF5WfFzTdCBmNZ2uMk,SpATywNh6bZuzm8s1ceuBUnMUAeoAHHw,26,66,12,18,6,20,39,4,165,23.571428571428573,7,0.0,18,12,15,6,48,20,3,39,4,51,114,1
5054,120788,qwhxcjW9iIMBAQoGSWDtst34AFkcFQoV,G8EPVSXsOYB5YQWZGiz1aVq5Pgr2GrQu,6,6,3,0,0,0,4,0,13,1.8571428571428572,2,0.0,0,3,0,0,6,0,0,4,0,3,10,0
5055,120808,OTAUIgoWBEWsq2kd8lnvB0dKpj3SXEdR,SpATywNh6bZuzm8s1ceuBUnMUAeoAHHw,20,28,14,16,7,22,8,2,97,13.857142857142858,2,0.0,12,14,15,7,16,22,1,8,2,48,49,1
5056,120815,qwhxcjW9iIMBAQoGSWDtst34AFkcFQoV,A3fsA9Zfv1X2fVEQhTw51lKENdNrEqT3,10,19,9,0,1,1,6,0,36,5.142857142857143,3,0.0,0,9,0,1,19,1,0,6,0,10,26,0
5057,120818,hn9Zjyg7I7mBsVCg91jyZTDh6RPM5yRT,G8EPVSXsOYB5YQWZGiz1aVq5Pgr2GrQu,2,0,0,0,0,0,3,0,3,0.42857142857142855,3,0.0,0,0,0,0,0,0,0,3,0,0,3,0
5058,120824,tCQ9JALurTpI0v0jgUfmOoOzw21YvN4S,SpATywNh6bZuzm8s1ceuBUnMUAeoAHHw,1,0,0,0,0,0,1,0,1,0.14285714285714285,1,0.0,0,0,0,0,0,0,0,1,0,0,1,1
5059,120835,EaFWRMbtKR52j7nbPydGVwuzgPsml9aN,A3fsA9Zfv1X2fVEQhTw51lKENdNrEqT3,10,10,5,0,0,7,18,1,41,5.857142857142857,3,0.0,0,5,0,0,10,7,0,18,1,5,36,1
5060,120839,A1aBNAF3YIuzOOCwNaMQAGMwKE189BXm,bWdj2GDclj5ofokWjzoa5jAwMkxCykd6,6,5,1,38,2,0,2,0,48,6.857142857142857,1,0.0,3,1,36,2,2,0,2,2,0,42,6,1
5061,120845,W8fFTJpe1dBAUeFKonCjFttbIjzEdynN,bWdj2GDclj5ofokWjzoa5jAwMkxCykd6,1,0,0,0,0,0,1,0,1,0.14285714285714285,1,0.0,0,0,0,0,0,0,0,1,0,0,1,1
5062,120853,DPc69RrqfbFv98j4qSzKI4WCbxWESHfA,SpATywNh6bZuzm8s1ceuBUnMUAeoAHHw,5,2,1,0,1,0,2,0,6,0.8571428571428571,1,0.0,0,1,0,1,2,0,0,2,0,2,4,1
5063,120854,fl8sEptrcl2JvFWXejFcnsM7BqWtKl9w,A3fsA9Zfv1X2fVEQhTw51lKENdNrEqT3,7,5,1,0,1,0,4,0,11,1.5714285714285714,2,0.0,0,1,0,1,5,0,0,4,0,2,9,1
5064,120861,bRG3KNKPz8MtEb5G1Duc4i5IiNMa8ZLU,G8EPVSXsOYB5YQWZGiz1aVq5Pgr2GrQu,5,4,1,0,0,0,1,0,6,0.8571428571428571,1,0.0,0,1,0,0,4,0,0,1,0,1,5,1
5065,120866,mVNF27p0nlEqUBMpiQFD5RxVmxKtsSbe,bWdj2GDclj5ofokWjzoa5jAwMkxCykd6,1,0,0,0,0,0,1,0,1,0.14285714285714285,1,0.0,0,0,0,0,0,0,0,1,0,0,1,1
5066,120891,ABAPRQWSFErhHUFQsJmCoj4Rpg4DtQ8w,A3fsA9Zfv1X2fVEQhTw51lKENdNrEqT3,13,44,20,0,13,0,10,0,87,12.428571428571429,2,0.0,1,20,0,13,43,0,0,10,0,34,53,1
5067,120892,pAkhnLI0s5vboktZycO7Tobv6jbspULh,SpATywNh6bZuzm8s1ceuBUnMUAeoAHHw,19,22,14,0,9,0,8,0,53,7.571428571428571,7,0.0,0,14,0,9,22,0,0,8,0,23,30,1
5068,120894,dQweEcdBCmNmUPOeO7X4TTmH8zuMq2aJ,A3fsA9Zfv1X2fVEQhTw51lKENdNrEqT3,13,19,9,0,2,7,13,0,50,7.142857142857143,4,0.0,1,9,0,2,18,7,0,13,0,12,38,1
5069,120906,Z9nbZek76s4RBuA56w1WtME3e9ClZkaP,A3fsA9Zfv1X2fVEQhTw51lKENdNrEqT3,41,28,21,58,11,16,5,1,140,20.0,3,0.0,1,21,50,11,27,16,8,5,1,83,57,0
5070,120907,m83RtezfCwMfEmG0rXtpbc1svhl7ugt0,SpATywNh6bZuzm8s1ceuBUnMUAeoAHHw,4,3,1,0,1,0,1,0,6,0.8571428571428571,1,0.0,0,1,0,1,3,0,0,1,0,2,4,1
5071,120909,aldLXGpzmiip2CUSDhqN8A5UpGMVUHxY,A3fsA9Zfv1X2fVEQhTw51lKENdNrEqT3,67,43,32,116,11,0,12,0,214,30.571428571428573,7,0.0,4,32,110,11,39,0,6,12,0,157,57,0
5072,120915,i8nJS6rmQ6UIbavrvT6pTvkCZLUx9z01,SpATywNh6bZuzm8s1ceuBUnMUAeoAHHw,3,4,0,0,0,0,1,0,5,0.7142857142857143,1,0.0,0,0,0,0,4,0,0,1,0,0,5,1
5073,120928,sApH95kwlTdIi3RvuRD74A0dFhVPKais,SpATywNh6bZuzm8s1ceuBUnMUAeoAHHw,9,14,4,0,3,2,8,0,31,4.428571428571429,2,0.0,0,4,0,3,14,2,0,8,0,7,24,1
5074,120930,fHz7VQRoJHHTDfRPDpvJLuPlruuvrNnm,SpATywNh6bZuzm8s1ceuBUnMUAeoAHHw,23,30,1,29,1,0,12,0,73,10.428571428571429,2,0.0,11,1,26,1,19,0,3,12,0,39,34,1
5075,120937,qVkkNycc5Psi9bXy8jDUR44I6IjXsj9g,bWdj2GDclj5ofokWjzoa5jAwMkxCykd6,2,0,0,0,0,0,2,0,2,0.2857142857142857,1,0.0,0,0,0,0,0,0,0,2,0,0,2,1
5076,120944,jcYhugRahKquP2fynVIQQrbdtwxaAHse,G8EPVSXsOYB5YQWZGiz1aVq5Pgr2GrQu,1,0,0,0,0,0,1,0,1,0.14285714285714285,1,0.0,0,0,0,0,0,0,0,1,0,0,1,1
5077,120949,ONK0Esb7fhLc69POI06k3Sj1alNC6Fij,SpATywNh6bZuzm8s1ceuBUnMUAeoAHHw,16,17,7,14,5,8,17,0,68,9.714285714285714,7,0.0,9,7,13,5,8,8,1,17,0,34,34,0
5078,120966,JCDOEMgsanA2Wd8RJtg9ctpT52Gae7ak,bWdj2GDclj5ofokWjzoa5jAwMkxCykd6,7,8,2,0,1,0,5,0,16,2.2857142857142856,2,0.0,0,2,0,1,8,0,0,5,0,3,13,0
5079,120973,VsZvGrXbL1e6v6hmpJQH8MldIkCBO9P7,RXDvfPUBYFlVdlueBFbLW0mhhAyGEqpt,72,120,38,192,23,11,23,14,421,60.142857142857146,4,0.0,27,38,181,23,93,11,11,23,14,269,152,0
5080,120975,KjHOE07fI9pBFKqiwhrvCwjITj7tyFWN,G8EPVSXsOYB5YQWZGiz1aVq5Pgr2GrQu,21,26,13,0,11,0,11,1,62,8.857142857142858,3,0.0,6,13,0,11,20,0,0,11,1,30,32,1
5081,120979,VsZvGrXbL1e6v6hmpJQH8MldIkCBO9P7,A3fsA9Zfv1X2fVEQhTw51lKENdNrEqT3,63,52,25,132,14,4,22,1,250,35.714285714285715,4,0.0,1,25,119,14,51,4,13,22,1,159,91,1
5082,120982,JBjDnQZVwVLGdsvKJqTw57nrx9uYY0vn,A3fsA9Zfv1X2fVEQhTw51lKENdNrEqT3,9,30,1,0,1,0,6,0,38,5.428571428571429,3,0.0,0,1,0,1,30,0,0,6,0,2,36,0
5083,120999,evts3oSRq3OSuFymJPKdix8vzAStq0uA,G8EPVSXsOYB5YQWZGiz1aVq5Pgr2GrQu,2,0,0,0,0,0,2,0,2,0.2857142857142857,1,0.0,0,0,0,0,0,0,0,2,0,0,2,1
5084,121006,fiuPlQpFhdwy7ZB3d9YZTvFtxVmpTcZ2,SpATywNh6bZuzm8s1ceuBUnMUAeoAHHw,8,10,1,0,1,0,6,0,18,2.5714285714285716,2,0.0,0,1,0,1,10,0,0,6,0,2,16,1
5085,121019,bA4tnPZD0UU4XAL3OkL7nUjtkAzbgj9d,A3fsA9Zfv1X2fVEQhTw51lKENdNrEqT3,6,8,5,0,1,0,2,0,16,2.2857142857142856,2,0.0,1,5,0,1,7,0,0,2,0,7,9,1
5086,121023,TzRDOFjVsHxcJLvrJENTAv7iaJPhFHB5,SpATywNh6bZuzm8s1ceuBUnMUAeoAHHw,10,5,4,0,3,0,2,0,14,2.0,2,0.0,0,4,0,3,5,0,0,2,0,7,7,1
5087,121044,KkBPwixR7onoXlZ2HnK8cYokgUE3P396,A3fsA9Zfv1X2fVEQhTw51lKENdNrEqT3,1,0,0,0,0,0,1,0,1,0.14285714285714285,1,0.0,0,0,0,0,0,0,0,1,0,0,1,1
5088,121048,nwFT4lnmg30fCvHRB6tbALo9FpcanuLx,bWdj2GDclj5ofokWjzoa5jAwMkxCykd6,7,6,2,0,2,0,4,0,14,2.0,3,0.0,0,2,0,2,6,0,0,4,0,4,10,0
5089,121066,gV1Y6A8RpgDuAD47r6UGF54v9TD2f7uU,bWdj2GDclj5ofokWjzoa5jAwMkxCykd6,6,3,1,0,1,0,2,0,7,1.0,1,0.0,0,1,0,1,3,0,0,2,0,2,5,1
5090,121100,8mYFryxeRH8GSnHog9hmhUPRk60LCyFI,SpATywNh6bZuzm8s1ceuBUnMUAeoAHHw,14,16,14,0,7,0,7,0,44,6.285714285714286,2,0.0,0,14,0,7,16,0,0,7,0,21,23,1
5091,121105,M8ur292SdHouJ1LnQyJMDkHJM5sUPxnX,SpATywNh6bZuzm8s1ceuBUnMUAeoAHHw,14,23,2,3,3,0,6,0,37,5.285714285714286,4,0.0,6,2,3,3,17,0,0,6,0,14,23,0
5092,121134,4IxaKtzWvkfFEFZ43UhJQOyIahcBxrF2,SpATywNh6bZuzm8s1ceuBUnMUAeoAHHw,17,27,1,12,1,0,6,0,47,6.714285714285714,3,0.0,2,1,11,1,25,0,1,6,0,15,32,1
5093,121136,kHp5QZURLzbWn4koqFYZnQmO0kliz5hb,SpATywNh6bZuzm8s1ceuBUnMUAeoAHHw,27,35,17,20,11,3,4,0,90,12.857142857142858,4,0.0,11,17,17,11,24,3,3,4,0,56,34,1
5094,121174,BK9rzOWePcPYHbJ23OB9suKImXFOyhRl,bWdj2GDclj5ofokWjzoa5jAwMkxCykd6,10,8,1,0,1,5,9,4,28,4.0,1,0.0,0,1,0,1,8,5,0,9,4,2,26,1
5095,121191,MbmumbK7FHZlEn2oNe4YMQEQzBas1u6w,bWdj2GDclj5ofokWjzoa5jAwMkxCykd6,12,21,10,6,5,6,11,2,61,8.714285714285714,2,0.0,3,10,5,5,18,6,1,11,2,23,38,0
5096,121196,VdaBmv5ItdWz4RwMA62FKAWjG3bRe1Fn,SpATywNh6bZuzm8s1ceuBUnMUAeoAHHw,4,3,1,0,1,0,1,0,6,0.8571428571428571,1,0.0,0,1,0,1,3,0,0,1,0,2,4,1
5097,121216,kepzW866hAW80jPanDRXCDYAup0gf1qr,bWdj2GDclj5ofokWjzoa5jAwMkxCykd6,4,2,1,0,1,0,1,0,5,0.7142857142857143,1,0.0,0,1,0,1,2,0,0,1,0,2,3,0
5098,121220,XOhs3C3hEbYCXLCkazKW0gKNbUWn1jg2,SpATywNh6bZuzm8s1ceuBUnMUAeoAHHw,8,6,3,0,3,0,4,0,16,2.2857142857142856,1,0.0,0,3,0,3,6,0,0,4,0,6,10,1
5099,121271,GAKCidUQ8hdeh0WMwEYlK9cUZXNPRN5R,SpATywNh6bZuzm8s1ceuBUnMUAeoAHHw,7,2,1,0,1,0,7,1,12,1.7142857142857142,2,0.0,0,1,0,1,2,0,0,7,1,2,10,1
5100,121284,Sb4VRiha9yR6Zwo717x7pWDjO7cnV2Bc,A3fsA9Zfv1X2fVEQhTw51lKENdNrEqT3,2,0,0,0,0,0,2,0,2,0.2857142857142857,1,0.0,0,0,0,0,0,0,0,2,0,0,2,1
5101,121303,33pzyjn4blqUcVq0e7rGSyVoVXsnplTp,SpATywNh6bZuzm8s1ceuBUnMUAeoAHHw,5,1,1,0,1,0,3,0,6,0.8571428571428571,1,0.0,0,1,0,1,1,0,0,3,0,2,4,1
5102,121304,WOGsOMHGMnkSlS91ohBsyVdWGOJVOnT1,G8EPVSXsOYB5YQWZGiz1aVq5Pgr2GrQu,2,0,0,0,0,0,2,0,2,0.2857142857142857,1,0.0,0,0,0,0,0,0,0,2,0,0,2,1
5103,121313,VrcAU2QLiPqVHHKHjhnkgJoQe1xmnYFr,SpATywNh6bZuzm8s1ceuBUnMUAeoAHHw,4,2,1,0,1,0,1,0,5,0.7142857142857143,1,0.0,0,1,0,1,2,0,0,1,0,2,3,1
5104,121328,o1wU0MfzmEznHSZOZDS8DejIhVczhoMt,A3fsA9Zfv1X2fVEQhTw51lKENdNrEqT3,1,0,0,0,0,0,2,0,2,0.2857142857142857,1,0.0,0,0,0,0,0,0,0,2,0,0,2,1
5105,121330,o1wU0MfzmEznHSZOZDS8DejIhVczhoMt,bWdj2GDclj5ofokWjzoa5jAwMkxCykd6,1,0,0,0,0,0,2,0,2,0.2857142857142857,1,0.0,0,0,0,0,0,0,0,2,0,0,2,1
5106,121339,oKz0rKWQtHW8DkPwxTgdemWb21NvE4BO,SpATywNh6bZuzm8s1ceuBUnMUAeoAHHw,23,33,1,35,0,10,8,0,87,12.428571428571429,3,0.0,17,1,33,0,16,10,2,8,0,51,36,1
5107,121345,ePaTLgBKhclwas3ClxzVVmTCgYzhx4go,SpATywNh6bZuzm8s1ceuBUnMUAeoAHHw,26,50,3,46,0,37,18,0,154,22.0,4,0.0,14,3,37,0,36,37,9,18,0,54,100,0
5108,121373,HSjT6fK4xHlufEG141acXPeMw5gqxgnK,G8EPVSXsOYB5YQWZGiz1aVq5Pgr2GrQu,6,1,1,0,1,0,3,1,7,1.0,1,0.0,0,1,0,1,1,0,0,3,1,2,5,1
5109,121391,7af3IyECXIPSWoeM4guaEGHMHNE9EYdr,A3fsA9Zfv1X2fVEQhTw51lKENdNrEqT3,1,0,0,0,0,0,1,0,1,0.14285714285714285,1,0.0,0,0,0,0,0,0,0,1,0,0,1,1
5110,121405,H8Mro2560yUzikYuATdEg57a9V5oxWPK,bWdj2GDclj5ofokWjzoa5jAwMkxCykd6,1,0,0,0,0,0,2,0,2,0.2857142857142857,1,0.0,0,0,0,0,0,0,0,2,0,0,2,1
5111,121415,5tRF7MIiw9rvKGI9GzHJVDzIS50Mqb8o,RXDvfPUBYFlVdlueBFbLW0mhhAyGEqpt,32,43,3,50,3,0,7,0,106,15.142857142857142,3,0.0,9,3,46,3,34,0,4,7,0,61,45,1
5112,121424,vthDe5chpuGwbDUyc90EI2Y8jHRBb15H,bWdj2GDclj5ofokWjzoa5jAwMkxCykd6,4,2,1,0,1,0,1,0,5,0.7142857142857143,1,0.0,0,1,0,1,2,0,0,1,0,2,3,1
5113,121438,3w2Xuq08gulsgNUr7oA3MOaceNv4Akte,bWdj2GDclj5ofokWjzoa5jAwMkxCykd6,15,27,11,50,7,5,7,0,107,15.285714285714286,3,0.0,8,11,46,7,19,5,4,7,0,72,35,1
5114,121446,Haz3G1DnETqwzmdUg5ALbCZo1Lv5wDs9,SpATywNh6bZuzm8s1ceuBUnMUAeoAHHw,28,28,18,30,10,3,7,0,96,13.714285714285714,4,0.0,6,18,27,10,22,3,3,7,0,61,35,1
5115,121452,NoyfNn91CGqIll5CyV3XCcTClgT3U7jT,A3fsA9Zfv1X2fVEQhTw51lKENdNrEqT3,2,0,0,0,0,0,2,0,2,0.2857142857142857,1,0.0,0,0,0,0,0,0,0,2,0,0,2,1
5116,121455,I8yPwCESlVyB1LCVpuWYAkN68pAAeUAB,G8EPVSXsOYB5YQWZGiz1aVq5Pgr2GrQu,4,3,2,0,2,0,1,0,8,1.1428571428571428,1,0.0,0,2,0,2,3,0,0,1,0,4,4,1
5117,121473,kEe7j5p6NF8FFSn6q8Y544hGSIcyGGey,G8EPVSXsOYB5YQWZGiz1aVq5Pgr2GrQu,1,0,0,0,0,0,1,0,1,0.14285714285714285,1,0.0,0,0,0,0,0,0,0,1,0,0,1,1
5118,121532,OUbh6hvaOJDp9RK7kgTBzzPmjzmkYhZF,A3fsA9Zfv1X2fVEQhTw51lKENdNrEqT3,57,33,0,190,0,2,11,1,237,33.857142857142854,2,0.0,2,0,171,0,31,2,19,11,1,173,64,1
5119,121540,Ys7L3fRt7UujHv4RzbntGwrrv6Omn2bm,A3fsA9Zfv1X2fVEQhTw51lKENdNrEqT3,11,3,2,0,2,0,7,1,15,2.142857142857143,1,0.0,0,2,0,2,3,0,0,7,1,4,11,1
5120,121576,RPsysYLHG9V8ibC4agPmUkz49odzJ61i,SpATywNh6bZuzm8s1ceuBUnMUAeoAHHw,25,22,6,20,4,11,4,0,67,9.571428571428571,2,0.0,5,6,18,4,17,11,2,4,0,33,34,0
5121,121625,ZULomXsITwM6vNxcJN8imzU1pyfKn8Cw,A3fsA9Zfv1X2fVEQhTw51lKENdNrEqT3,14,10,8,0,6,0,3,0,27,3.857142857142857,1,0.0,0,8,0,6,10,0,0,3,0,14,13,1
5122,121656,aVeyGdrz6Ir4LmiLkJqBoRjG1lQ7MsV8,bWdj2GDclj5ofokWjzoa5jAwMkxCykd6,11,34,12,4,1,0,9,0,60,8.571428571428571,7,0.0,9,12,3,1,25,0,1,9,0,25,35,0
5123,121711,5U79KRZxDDBIetuxjK0KXphUhzbxTzjr,A3fsA9Zfv1X2fVEQhTw51lKENdNrEqT3,12,7,5,0,1,0,9,1,23,3.2857142857142856,2,0.0,0,5,0,1,7,0,0,9,1,6,17,1
5124,121712,zdC6SE3iIVhpYTGT1Ftflp0F2V48NqFq,SpATywNh6bZuzm8s1ceuBUnMUAeoAHHw,32,66,24,24,9,3,14,1,141,20.142857142857142,4,0.0,29,24,23,9,37,3,1,14,1,85,56,1
5125,121721,RNEuStAlTxZHIZFwvfCfasMOM5Hny2Pn,SpATywNh6bZuzm8s1ceuBUnMUAeoAHHw,7,12,4,0,4,0,7,0,27,3.857142857142857,3,0.0,0,4,0,4,12,0,0,7,0,8,19,1
5126,121728,VeR8jO0l4tKfTebOc6UlIMBBM4qQ6Yxm,bWdj2GDclj5ofokWjzoa5jAwMkxCykd6,4,2,0,0,0,0,3,0,5,0.7142857142857143,1,0.0,0,0,0,0,2,0,0,3,0,0,5,1
5127,121730,qCS1MIh1oAUEDPfrxnKYyGX5hZIJFt3C,bWdj2GDclj5ofokWjzoa5jAwMkxCykd6,1,0,0,0,0,0,1,0,1,0.14285714285714285,1,0.0,0,0,0,0,0,0,0,1,0,0,1,1
5128,121731,wBp63rzsgy2LzOR2gkxDj87VT9Ja70XK,SpATywNh6bZuzm8s1ceuBUnMUAeoAHHw,30,37,18,42,8,18,18,3,144,20.571428571428573,2,0.0,11,18,35,8,26,18,7,18,3,72,72,1
5129,121738,V6LNlp0n6EiMGFhm98i6D7Pk9T5LWptM,SpATywNh6bZuzm8s1ceuBUnMUAeoAHHw,7,12,6,0,3,0,3,0,24,3.4285714285714284,2,0.0,0,6,0,3,12,0,0,3,0,9,15,1
5130,121743,bFBipIvg3ynAbrvo3mXNRP6i8NWVQRYx,A3fsA9Zfv1X2fVEQhTw51lKENdNrEqT3,9,3,2,0,1,1,9,2,18,2.5714285714285716,1,0.0,0,2,0,1,3,1,0,9,2,3,15,1
5131,121746,bFBipIvg3ynAbrvo3mXNRP6i8NWVQRYx,bWdj2GDclj5ofokWjzoa5jAwMkxCykd6,10,13,5,46,4,5,7,1,81,11.571428571428571,1,0.0,5,5,45,4,8,5,1,7,1,59,22,1
5132,121766,EbdsJCzME79IdKcgnIKOnAggJJmkpV77,G8EPVSXsOYB5YQWZGiz1aVq5Pgr2GrQu,30,30,23,34,17,0,8,0,112,16.0,3,0.0,3,23,25,17,27,0,9,8,0,68,44,0
5133,121768,Zt3P4JGoAgyqFxw766ynWY30ef3EfJ1u,SpATywNh6bZuzm8s1ceuBUnMUAeoAHHw,20,31,11,26,4,10,14,2,98,14.0,2,0.0,15,11,23,4,16,10,3,14,2,53,45,0
5134,121771,mfnQ4udtiPturvDlSRmiBQpHTrOVoPze,G8EPVSXsOYB5YQWZGiz1aVq5Pgr2GrQu,5,2,1,0,1,0,2,0,6,0.8571428571428571,1,0.0,0,1,0,1,2,0,0,2,0,2,4,1
5135,121772,rwS7FTXVRFYQBGZ8fdPbUhnEsoTUJSWr,SpATywNh6bZuzm8s1ceuBUnMUAeoAHHw,6,3,2,0,1,0,3,0,9,1.2857142857142858,1,0.0,0,2,0,1,3,0,0,3,0,3,6,1
5136,121776,sOhMuZ2KPBl6wLWzfGcWvrQoSfIarVJv,SpATywNh6bZuzm8s1ceuBUnMUAeoAHHw,5,2,1,0,1,0,3,0,7,1.0,2,0.0,0,1,0,1,2,0,0,3,0,2,5,1
5137,121780,0P5PalAjTetGhnhGgd58OrrRVeAS6i1x,A3fsA9Zfv1X2fVEQhTw51lKENdNrEqT3,13,8,7,0,5,0,2,0,22,3.142857142857143,1,0.0,0,7,0,5,8,0,0,2,0,12,10,1
5138,121789,XC5tRBKME8ONyczymYjZjR1MyrCYegPM,G8EPVSXsOYB5YQWZGiz1aVq5Pgr2GrQu,27,50,16,56,7,1,3,0,133,19.0,2,0.0,31,16,44,7,19,1,12,3,0,98,35,0
5139,121824,VmpOwZ3zs5p6NuGKzo8TbAiFkD0EdD5q,SpATywNh6bZuzm8s1ceuBUnMUAeoAHHw,1,0,0,0,0,0,1,0,1,0.14285714285714285,1,0.0,0,0,0,0,0,0,0,1,0,0,1,1
5140,121827,LPuVvdpKRDBdr0DGqQ4yh9fw0WfNvnkW,SpATywNh6bZuzm8s1ceuBUnMUAeoAHHw,6,9,0,0,0,0,5,0,14,2.0,2,0.0,0,0,0,0,9,0,0,5,0,0,14,1
5141,121829,gOODBz9FfXPZcnKA2RT49UqbScA5gVkT,SpATywNh6bZuzm8s1ceuBUnMUAeoAHHw,11,13,8,0,5,0,3,0,29,4.142857142857143,1,0.0,0,8,0,5,13,0,0,3,0,13,16,1
5142,121870,iY0UWsKzM76w2sBfvkSz2A0A6313cEPM,SpATywNh6bZuzm8s1ceuBUnMUAeoAHHw,24,28,8,13,4,0,2,0,55,7.857142857142857,2,0.0,7,8,12,4,21,0,1,2,0,31,24,1
5143,121881,PUdcV8hfT4fAKFK5ZdHY1Ahxf6WKmDC8,bWdj2GDclj5ofokWjzoa5jAwMkxCykd6,5,3,1,0,1,0,2,0,7,1.0,1,0.0,0,1,0,1,3,0,0,2,0,2,5,1
5144,121915,QQOQ1mBFT0hbDG4vhxUnw8WQ7hq3XsN0,SpATywNh6bZuzm8s1ceuBUnMUAeoAHHw,19,19,13,3,10,0,2,0,47,6.714285714285714,2,0.0,3,13,3,10,16,0,0,2,0,29,18,1
5145,121927,7HtfIn2KlQH9UsbhFgGhveKOzfNOg6MC,SpATywNh6bZuzm8s1ceuBUnMUAeoAHHw,5,3,2,0,1,0,1,0,7,1.0,1,0.0,0,2,0,1,3,0,0,1,0,3,4,1
5146,121945,sTlxlEkJ3MbMUAeSajnaHOGfpyW9hgq1,RXDvfPUBYFlVdlueBFbLW0mhhAyGEqpt,5,3,1,0,1,0,2,0,7,1.0,1,0.0,0,1,0,1,3,0,0,2,0,2,5,1
5147,121953,ahM4WE7sAySvmZ0R8lWqo09z8fOCvKFZ,SpATywNh6bZuzm8s1ceuBUnMUAeoAHHw,11,10,4,0,2,1,12,1,30,4.285714285714286,3,0.0,3,4,0,2,7,1,0,12,1,9,21,1
5148,121987,8FfbeT2vcqiuyS9VPg4k7f5KonVLWvGH,A3fsA9Zfv1X2fVEQhTw51lKENdNrEqT3,14,5,0,12,0,1,8,1,27,3.857142857142857,1,0.0,0,0,12,0,5,1,0,8,1,12,15,1
5149,121994,u5RnzaYe9alTOldsdopsRhwom5jR9n5h,SpATywNh6bZuzm8s1ceuBUnMUAeoAHHw,5,2,1,0,1,0,3,0,7,1.0,1,0.0,0,1,0,1,2,0,0,3,0,2,5,1
5150,121997,qkTj1KHhnruIpJto1LtBmn4usHKfmPXZ,G8EPVSXsOYB5YQWZGiz1aVq5Pgr2GrQu,16,9,9,32,5,0,2,0,57,8.142857142857142,1,0.0,0,9,29,5,9,0,3,2,0,43,14,1
5151,122003,s25WPHgkqnodCLzw3vLGSH1CPEjHMBJ5,A3fsA9Zfv1X2fVEQhTw51lKENdNrEqT3,6,5,1,0,1,0,2,0,9,1.2857142857142858,2,0.0,0,1,0,1,5,0,0,2,0,2,7,1
5152,122051,PFXaSbylT2XRWmnFTzI7TT06KKEcrU02,SpATywNh6bZuzm8s1ceuBUnMUAeoAHHw,1,0,0,0,0,0,1,0,1,0.14285714285714285,1,0.0,0,0,0,0,0,0,0,1,0,0,1,1
5153,122058,zBcT1Z0xXooVqe1Y23Zi33CckLeXOFNF,A3fsA9Zfv1X2fVEQhTw51lKENdNrEqT3,2,0,0,0,0,0,2,0,2,0.2857142857142857,1,0.0,0,0,0,0,0,0,0,2,0,0,2,1
5154,122069,Cyazs2KNzeLH7rwO0YD9wLQWGHR2SXrB,RXDvfPUBYFlVdlueBFbLW0mhhAyGEqpt,5,8,4,0,1,0,4,0,17,2.4285714285714284,3,0.0,0,4,0,1,8,0,0,4,0,5,12,1
5155,124667,15vqe2Z6zLmyPR70QAa8Kn2V8zhvh9Uk,7GRhBDsirIGkRZBtSMEzNTyDr2JQm4xx,11,6,3,0,1,2,19,1,32,4.571428571428571,4,0.0,0,3,0,1,6,2,0,19,1,4,28,1
5156,124685,qwhxcjW9iIMBAQoGSWDtst34AFkcFQoV,7GRhBDsirIGkRZBtSMEzNTyDr2JQm4xx,9,21,9,4,2,0,6,0,42,6.0,4,0.0,1,9,3,2,20,0,1,6,0,15,27,0
5157,124687,eQeAZJfAlQDBFNhBayGkUGtYxXtMJqJ1,7GRhBDsirIGkRZBtSMEzNTyDr2JQm4xx,50,172,61,57,39,26,20,0,375,53.57142857142857,3,0.0,88,61,45,39,84,26,12,20,0,233,142,1
5158,124688,MTBFJm3bIEaE6OQdIPJiDEIIoJhDDIeA,7GRhBDsirIGkRZBtSMEzNTyDr2JQm4xx,33,36,12,33,19,3,14,0,117,16.714285714285715,4,0.0,16,12,31,19,20,3,2,14,0,78,39,0
5159,124719,s1zoJG6TsTv8LP9PRWCYbeiv4OLIivpy,7GRhBDsirIGkRZBtSMEzNTyDr2JQm4xx,6,2,1,0,1,0,3,0,7,1.0,1,0.0,0,1,0,1,2,0,0,3,0,2,5,1
5160,124723,pyk8IpgYoJC2oe3kCohOVZ3WNjOmgeaA,7GRhBDsirIGkRZBtSMEzNTyDr2JQm4xx,53,78,23,84,31,2,8,0,226,32.285714285714285,4,0.0,48,23,72,31,30,2,12,8,0,174,52,1
5161,124848,LsB37SHCi56YIWKTwUYRQPUU0IwClcqd,7GRhBDsirIGkRZBtSMEzNTyDr2JQm4xx,32,47,14,88,9,0,4,0,162,23.142857142857142,4,0.0,13,14,76,9,34,0,12,4,0,112,50,1
5162,124904,x2sgXnRqpzo0sPEyNVV2LCKHGLD7HPOD,7GRhBDsirIGkRZBtSMEzNTyDr2JQm4xx,4,0,0,0,0,0,4,0,4,0.5714285714285714,1,0.0,0,0,0,0,0,0,0,4,0,0,4,0
5163,124923,O4ePTyZvjwNQI9EDfljqO5u6UAawTsHN,7GRhBDsirIGkRZBtSMEzNTyDr2JQm4xx,1,0,0,0,0,0,1,0,1,0.14285714285714285,1,0.0,0,0,0,0,0,0,0,1,0,0,1,1
5164,124975,Z4Ol2MWosmvKrLpBOUDzuhHb0EYhkqtT,7GRhBDsirIGkRZBtSMEzNTyDr2JQm4xx,39,97,36,87,35,4,24,0,283,40.42857142857143,8,0.0,47,36,75,35,50,4,12,24,0,193,90,1
5165,125017,xVQ88VrIuIA75ygDlevnROobNkwcFnsc,7GRhBDsirIGkRZBtSMEzNTyDr2JQm4xx,4,4,1,0,0,0,2,0,7,1.0,2,0.0,0,1,0,0,4,0,0,2,0,1,6,1
5166,125036,CUg5atNUld0AFLgUdvlLcFARmcmAn91I,7GRhBDsirIGkRZBtSMEzNTyDr2JQm4xx,1,0,0,0,0,0,1,0,1,0.14285714285714285,1,0.0,0,0,0,0,0,0,0,1,0,0,1,1
5167,125068,clB9MUAuqkslRUltlqk0A6RGOlCJEK6u,7GRhBDsirIGkRZBtSMEzNTyDr2JQm4xx,2,0,0,0,0,0,2,0,2,0.2857142857142857,1,0.0,0,0,0,0,0,0,0,2,0,0,2,1
5168,125071,PUBGBOFNCd7rxLxHUMk2Fsee5aukfpD6,7GRhBDsirIGkRZBtSMEzNTyDr2JQm4xx,15,17,8,18,3,0,5,1,52,7.428571428571429,2,0.0,3,8,14,3,14,0,4,5,1,28,24,1
5169,125316,zQuOUrw5AhGHdFoJTVTDSPmJiftbKo67,7GRhBDsirIGkRZBtSMEzNTyDr2JQm4xx,2,0,0,0,0,0,2,0,2,0.2857142857142857,1,0.0,0,0,0,0,0,0,0,2,0,0,2,1
5170,125330,qCvAPTsWorFEreRKcqadivyOxQ7Qqyf8,7GRhBDsirIGkRZBtSMEzNTyDr2JQm4xx,2,0,0,0,0,0,2,0,2,0.2857142857142857,1,0.0,0,0,0,0,0,0,0,2,0,0,2,1
5171,125477,rEGrLtnwjrNQJxABPiEg16R7c6zG1e99,7GRhBDsirIGkRZBtSMEzNTyDr2JQm4xx,1,0,0,0,0,0,1,0,1,0.14285714285714285,1,0.0,0,0,0,0,0,0,0,1,0,0,1,1
5172,125569,E4FyPOdTetglhG27zHn1AaZVeKlotKQC,7GRhBDsirIGkRZBtSMEzNTyDr2JQm4xx,1,0,0,0,0,0,1,0,1,0.14285714285714285,1,0.0,0,0,0,0,0,0,0,1,0,0,1,1
5173,125664,RFEAx8yelAgvfPsQekcPEQ1kwjrp5Mon,7GRhBDsirIGkRZBtSMEzNTyDr2JQm4xx,7,3,2,0,2,0,2,0,9,1.2857142857142858,1,0.0,0,2,0,2,3,0,0,2,0,4,5,1
5174,125668,bZtNzDzO2qmGZ75gSzCr8t2M40vhOtlI,7GRhBDsirIGkRZBtSMEzNTyDr2JQm4xx,5,4,2,0,1,0,2,0,9,1.2857142857142858,2,0.0,0,2,0,1,4,0,0,2,0,3,6,1
5175,125913,rPGMKO3AhLxN6LWflYbraX7SC5U9X2nK,7GRhBDsirIGkRZBtSMEzNTyDr2JQm4xx,10,4,1,4,2,12,13,2,38,5.428571428571429,3,0.0,2,1,3,2,2,12,1,13,2,8,30,1
5176,125976,okxt3sY9reE4jjoKn2yrA6i7c1T3ZGZn,7GRhBDsirIGkRZBtSMEzNTyDr2JQm4xx,4,0,0,0,0,6,4,0,10,1.4285714285714286,1,0.0,0,0,0,0,0,6,0,4,0,0,10,1
5177,126611,AoOeu50PBcRJGzXnTeyvy2HLmQU50HHC,fbPkOYLVPtPgIt0MxizjfFJov3JbHyAi,4,2,1,0,1,0,1,0,5,0.7142857142857143,1,0.0,0,1,0,1,2,0,0,1,0,2,3,1
5178,126619,ITwd7xpRvyZSfkB4lL2L6OmpyXYVHZGs,fbPkOYLVPtPgIt0MxizjfFJov3JbHyAi,7,9,6,0,0,7,8,1,31,4.428571428571429,1,0.0,0,6,0,0,9,7,0,8,1,6,25,1
5179,126622,27Xik6MkaFL4yWSO9zEEJwVQHW9Np8S6,fbPkOYLVPtPgIt0MxizjfFJov3JbHyAi,17,9,8,0,8,2,6,0,33,4.714285714285714,2,0.0,0,8,0,8,9,2,0,6,0,16,17,1
5180,126623,TiN4z0dSpp09iMKqN066qAoKwqCoLlNB,fbPkOYLVPtPgIt0MxizjfFJov3JbHyAi,6,3,2,0,2,2,1,0,10,1.4285714285714286,1,0.0,0,2,0,2,3,2,0,1,0,4,6,1
5181,126624,YRDulTOgIWgR8cFwTAVhhuxX46WtWav7,fbPkOYLVPtPgIt0MxizjfFJov3JbHyAi,9,9,5,0,3,0,7,1,25,3.5714285714285716,1,0.0,1,5,0,3,8,0,0,7,1,9,16,1
5182,126630,EDMSGPNYA9U08P3iZyDo7po9ZIKNfhJJ,fbPkOYLVPtPgIt0MxizjfFJov3JbHyAi,8,9,2,6,5,0,5,0,27,3.857142857142857,1,0.0,6,2,4,5,3,0,2,5,0,17,10,1
5183,126632,yjkClXSb67ZKWAEvHxmMMyNPfAsPBpjl,fbPkOYLVPtPgIt0MxizjfFJov3JbHyAi,8,6,3,0,3,0,7,0,19,2.7142857142857144,1,0.0,2,3,0,3,4,0,0,7,0,8,11,1
5184,126633,KmIlNo2pbRKBzhZUiCgI2YhiW6w8iosj,fbPkOYLVPtPgIt0MxizjfFJov3JbHyAi,4,2,1,0,1,0,3,0,7,1.0,1,0.0,0,1,0,1,2,0,0,3,0,2,5,1
5185,126641,z8UfBjDXGrDWc9AMM6dseoK9YyEoRq02,fbPkOYLVPtPgIt0MxizjfFJov3JbHyAi,6,3,2,0,2,0,1,0,8,1.1428571428571428,1,0.0,0,2,0,2,3,0,0,1,0,4,4,1
5186,126645,sUFqKFuTqKGNKIqwb0vqeiIMtCX1CVCE,fbPkOYLVPtPgIt0MxizjfFJov3JbHyAi,10,3,3,0,3,0,3,1,13,1.8571428571428572,1,0.0,0,3,0,3,3,0,0,3,1,6,7,1
5187,126648,j9gdcEQiWF4hz17rFxv9vKJSxkrv7Ewo,fbPkOYLVPtPgIt0MxizjfFJov3JbHyAi,11,24,13,1,9,16,12,0,75,10.714285714285714,4,0.0,5,13,1,9,19,16,0,12,0,28,47,1
5188,126652,pSX00XUyCx7VlmgWGN0d39OwC9BZ8bRV,fbPkOYLVPtPgIt0MxizjfFJov3JbHyAi,5,2,1,0,1,3,2,1,10,1.4285714285714286,1,0.0,0,1,0,1,2,3,0,2,1,2,8,1
5189,126653,gGWMG6Gfcgv0VgsqH5vhbRzqRTXFEicG,fbPkOYLVPtPgIt0MxizjfFJov3JbHyAi,14,5,5,0,5,1,3,0,19,2.7142857142857144,1,0.0,0,5,0,5,5,1,0,3,0,10,9,1
5190,126655,qoqukLLERBRiJBIq9ZPYNUr2ljNWoAkB,fbPkOYLVPtPgIt0MxizjfFJov3JbHyAi,1,0,0,0,0,0,1,0,1,0.14285714285714285,1,0.0,0,0,0,0,0,0,0,1,0,0,1,1
5191,126664,BX9KMh9DUbDRkGw8SYAs3wHv0hHJ990Z,fbPkOYLVPtPgIt0MxizjfFJov3JbHyAi,4,2,1,0,1,0,1,0,5,0.7142857142857143,1,0.0,0,1,0,1,2,0,0,1,0,2,3,1
5192,126666,VD3NZWF3TQVEEWjdXtLLn0PBfH2lUBVv,fbPkOYLVPtPgIt0MxizjfFJov3JbHyAi,4,2,1,0,1,0,1,0,5,0.7142857142857143,1,0.0,0,1,0,1,2,0,0,1,0,2,3,1
5193,126667,CRnzue1RDSVRfMQMEjwDVoUKh1AdXpZz,fbPkOYLVPtPgIt0MxizjfFJov3JbHyAi,10,7,5,0,4,1,8,0,25,3.5714285714285716,2,0.0,0,5,0,4,7,1,0,8,0,9,16,1
5194,126671,XirdNKPxR3QK6AqsS5xwiQuah55CHklz,fbPkOYLVPtPgIt0MxizjfFJov3JbHyAi,5,3,2,0,1,0,1,0,7,1.0,1,0.0,0,2,0,1,3,0,0,1,0,3,4,1
5195,126677,cjIjalOkynRvNiMkIirdnL3eRD5dBGGC,fbPkOYLVPtPgIt0MxizjfFJov3JbHyAi,18,26,11,18,8,0,7,0,70,10.0,2,0.0,11,11,13,8,15,0,5,7,0,43,27,1
5196,126678,txSjWYX3TEWx5QLOiaADcbFdCZMHt7yE,fbPkOYLVPtPgIt0MxizjfFJov3JbHyAi,1,0,0,0,0,0,1,0,1,0.14285714285714285,1,0.0,0,0,0,0,0,0,0,1,0,0,1,1
5197,126679,GQHwUvP1dMnkB7BOvyel6l6pMIROCScP,fbPkOYLVPtPgIt0MxizjfFJov3JbHyAi,9,5,3,0,3,1,7,1,20,2.857142857142857,1,0.0,1,3,0,3,4,1,0,7,1,7,13,1
5198,126680,xnRmrsH4zMsCSnzjnexftwj0rbTRSH4o,fbPkOYLVPtPgIt0MxizjfFJov3JbHyAi,2,0,0,0,0,0,5,0,5,0.7142857142857143,1,0.0,0,0,0,0,0,0,0,5,0,0,5,1
5199,126681,Ed4keAaeu2f9Adr8MAUlkgc9PEPDZ5XH,fbPkOYLVPtPgIt0MxizjfFJov3JbHyAi,10,7,3,0,4,4,5,0,23,3.2857142857142856,1,0.0,3,3,0,4,4,4,0,5,0,10,13,1
5200,126683,1aQRKQfEUKBCXZxsytzFHSfkOMz94sSd,fbPkOYLVPtPgIt0MxizjfFJov3JbHyAi,5,2,1,0,1,0,3,0,7,1.0,1,0.0,0,1,0,1,2,0,0,3,0,2,5,1
5201,126685,kv9R1giIEQZwW9B0426lejYI0Lidtzlp,fbPkOYLVPtPgIt0MxizjfFJov3JbHyAi,1,0,0,0,0,0,1,0,1,0.14285714285714285,1,0.0,0,0,0,0,0,0,0,1,0,0,1,1
5202,126688,Ot1qGo61IYwNj80zMpFrqao7vUDTpF4u,fbPkOYLVPtPgIt0MxizjfFJov3JbHyAi,11,9,5,0,3,7,5,1,30,4.285714285714286,1,0.0,0,5,0,3,9,7,0,5,1,8,22,1
5203,126689,JYjqQWzRkQGlz0fASDON6Nnhdq6VSXiT,fbPkOYLVPtPgIt0MxizjfFJov3JbHyAi,1,0,0,0,0,0,1,0,1,0.14285714285714285,1,0.0,0,0,0,0,0,0,0,1,0,0,1,0
5204,126691,PUmV9uRuFVROTlnbrxJwOENyVx54i3f7,fbPkOYLVPtPgIt0MxizjfFJov3JbHyAi,4,2,1,0,1,0,1,0,5,0.7142857142857143,1,0.0,0,1,0,1,2,0,0,1,0,2,3,1
5205,126692,Sfke50zBDjAoEapgUNGacTteD024syFJ,fbPkOYLVPtPgIt0MxizjfFJov3JbHyAi,4,2,0,0,0,0,7,0,9,1.2857142857142858,1,0.0,0,0,0,0,2,0,0,7,0,0,9,1
5206,126697,ER1xz0N5sLgbnEZoIss9jV4E4vyRYggy,fbPkOYLVPtPgIt0MxizjfFJov3JbHyAi,11,25,9,0,7,18,4,0,63,9.0,2,0.0,2,9,0,7,23,18,0,4,0,18,45,1
5207,126699,AGXZupnvuozaRzZmgdrKKyAy6oGdUdjZ,fbPkOYLVPtPgIt0MxizjfFJov3JbHyAi,6,5,1,0,1,0,4,0,11,1.5714285714285714,1,0.0,2,1,0,1,3,0,0,4,0,4,7,1
5208,126701,ZflTj2bpwRqbD9BtY63IMMYDj3wgOSNe,fbPkOYLVPtPgIt0MxizjfFJov3JbHyAi,7,6,2,0,2,6,11,0,27,3.857142857142857,2,0.0,0,2,0,2,6,6,0,11,0,4,23,1
5209,126703,6HmdNYWkOfKPcsSkwkqnh7uY2Gqe1cX7,fbPkOYLVPtPgIt0MxizjfFJov3JbHyAi,5,7,4,0,2,3,2,0,18,2.5714285714285716,2,0.0,0,4,0,2,7,3,0,2,0,6,12,0
5210,126705,gVGEUb9jfMmddRlcGqXsnz4ZV26w6q4e,fbPkOYLVPtPgIt0MxizjfFJov3JbHyAi,1,0,0,0,0,0,1,0,1,0.14285714285714285,1,0.0,0,0,0,0,0,0,0,1,0,0,1,1
5211,126708,1i94xoT1OVM1lTP3R294JlD5odSrEcP5,fbPkOYLVPtPgIt0MxizjfFJov3JbHyAi,28,67,37,12,27,1,15,1,160,22.857142857142858,6,0.0,13,37,10,27,54,1,2,15,1,87,73,1
5212,126711,dTyb50y12ITIbvAI5f6oE5PPvIq2Oszo,fbPkOYLVPtPgIt0MxizjfFJov3JbHyAi,7,3,2,0,2,0,2,0,9,1.2857142857142858,1,0.0,0,2,0,2,3,0,0,2,0,4,5,1
5213,126712,0Au7FrQGJI1dB5PAH0C5RtkL9GE7xsrQ,fbPkOYLVPtPgIt0MxizjfFJov3JbHyAi,27,25,16,0,13,0,6,0,60,8.571428571428571,4,0.0,1,16,0,13,24,0,0,6,0,30,30,1
5214,126713,hIFTaIv0NzQ1m69V2AIINZ2J51nUdfKB,fbPkOYLVPtPgIt0MxizjfFJov3JbHyAi,5,2,1,0,1,0,3,0,7,1.0,1,0.0,0,1,0,1,2,0,0,3,0,2,5,1
5215,126714,E3YF9AxDXKzlOoePQC9jwZYlzCkx0nRD,fbPkOYLVPtPgIt0MxizjfFJov3JbHyAi,1,0,0,0,0,0,1,0,1,0.14285714285714285,1,0.0,0,0,0,0,0,0,0,1,0,0,1,1
5216,126715,Z7UOgoOv3zZwU9zvjSxLYTFWLOhyMpWi,fbPkOYLVPtPgIt0MxizjfFJov3JbHyAi,11,29,13,6,8,0,10,0,66,9.428571428571429,2,0.0,10,13,6,8,19,0,0,10,0,37,29,1
5217,126717,k0sYEKzK3c3rv35gACdjIcc2Y8cPzQsK,fbPkOYLVPtPgIt0MxizjfFJov3JbHyAi,10,6,5,0,4,0,2,0,17,2.4285714285714284,1,0.0,0,5,0,4,6,0,0,2,0,9,8,1
5218,126718,H3ilxL6ewH8ns8mJBuSJ1FZhvBCjmjMc,fbPkOYLVPtPgIt0MxizjfFJov3JbHyAi,8,2,1,0,1,1,5,1,11,1.5714285714285714,1,0.0,0,1,0,1,2,1,0,5,1,2,9,1
5219,126722,tzAUOAeBXYCK0qh741cOA4XmhuNpOqLn,fbPkOYLVPtPgIt0MxizjfFJov3JbHyAi,7,6,3,0,3,0,2,0,14,2.0,1,0.0,2,3,0,3,4,0,0,2,0,8,6,1
5220,126724,SuzQYmo3OPVDT9qC8VJnnRm1Cxq00x1u,fbPkOYLVPtPgIt0MxizjfFJov3JbHyAi,6,6,5,0,5,0,1,0,17,2.4285714285714284,1,0.0,0,5,0,5,6,0,0,1,0,10,7,1
5221,126728,REzwc4szUdXMxC6Nuk8XTJfPS15NQoOL,fbPkOYLVPtPgIt0MxizjfFJov3JbHyAi,8,6,4,0,3,0,7,0,20,2.857142857142857,1,0.0,0,4,0,3,6,0,0,7,0,7,13,1
5222,126729,eNsbOW0YP21FZLJqRprbqTldsfqGKDug,fbPkOYLVPtPgIt0MxizjfFJov3JbHyAi,4,2,0,0,0,0,3,0,5,0.7142857142857143,1,0.0,0,0,0,0,2,0,0,3,0,0,5,1
5223,126730,K5koBmqwsfMijOIDdKHMgmXnCecYfcPf,fbPkOYLVPtPgIt0MxizjfFJov3JbHyAi,9,3,2,0,2,2,8,2,19,2.7142857142857144,1,0.0,0,2,0,2,3,2,0,8,2,4,15,1
5224,126731,DFFDn6kzjxm3QeQyKXF89GDFKDcalqmY,fbPkOYLVPtPgIt0MxizjfFJov3JbHyAi,1,0,0,0,0,0,2,0,2,0.2857142857142857,1,0.0,0,0,0,0,0,0,0,2,0,0,2,1
5225,126737,vaWLVKWyrsUzDV0qs20ZUq8M3VNW01Uk,fbPkOYLVPtPgIt0MxizjfFJov3JbHyAi,1,0,0,0,0,0,1,0,1,0.14285714285714285,1,0.0,0,0,0,0,0,0,0,1,0,0,1,1
5226,126739,8LFa90D8AIcBXO1V4uhC5TnOcq5mvsUm,fbPkOYLVPtPgIt0MxizjfFJov3JbHyAi,8,3,2,0,2,0,3,0,10,1.4285714285714286,2,0.0,0,2,0,2,3,0,0,3,0,4,6,1
5227,126742,B1Gq6e77yv7kkDqJ7SH2TygdPDzPBwQh,fbPkOYLVPtPgIt0MxizjfFJov3JbHyAi,44,74,39,30,24,13,26,3,209,29.857142857142858,6,0.0,22,39,23,24,52,13,7,26,3,108,101,1
5228,126746,waB7QF553HzTXuwTUim6Y0QTXghcJvpK,fbPkOYLVPtPgIt0MxizjfFJov3JbHyAi,5,2,1,0,1,0,2,0,6,0.8571428571428571,1,0.0,0,1,0,1,2,0,0,2,0,2,4,1
5229,126748,NDe8spAMYp0FsctHBGO44DCP0jh5ivtW,fbPkOYLVPtPgIt0MxizjfFJov3JbHyAi,7,5,2,0,1,15,3,0,26,3.7142857142857144,2,0.0,0,2,0,1,5,15,0,3,0,3,23,1
5230,126750,bpsYUsj9C1SHgZpkPYxDXsRDOrg2cbuw,fbPkOYLVPtPgIt0MxizjfFJov3JbHyAi,16,29,14,1,13,2,6,0,65,9.285714285714286,3,0.0,10,14,1,13,19,2,0,6,0,38,27,1
5231,126751,XYrC5UYcATLlP8wN3KwZIBFYvNYdBJrS,fbPkOYLVPtPgIt0MxizjfFJov3JbHyAi,4,3,1,0,0,0,3,0,7,1.0,1,0.0,0,1,0,0,3,0,0,3,0,1,6,1
5232,126753,bo2onan1tteC9PtOvOwWhHvlR04pcJEI,fbPkOYLVPtPgIt0MxizjfFJov3JbHyAi,1,0,0,0,0,0,1,0,1,0.14285714285714285,1,0.0,0,0,0,0,0,0,0,1,0,0,1,1
5233,126756,UQ2ITfvqEyrVlMsMiud1odTDb3yeUeeN,fbPkOYLVPtPgIt0MxizjfFJov3JbHyAi,8,6,3,0,3,0,2,0,14,2.0,1,0.0,2,3,0,3,4,0,0,2,0,8,6,1
5234,126782,TbkRfFxVYcq9Rq8GnS46iBuAWkShuGej,fbPkOYLVPtPgIt0MxizjfFJov3JbHyAi,6,3,1,0,0,1,4,0,9,1.2857142857142858,2,0.0,0,1,0,0,3,1,0,4,0,1,8,0
5235,130073,IGWRz8xQdPwjKqBNKTjONoXgcj0XdulM,7GRhBDsirIGkRZBtSMEzNTyDr2JQm4xx,36,74,2,88,7,6,32,1,210,30.0,9,0.0,42,2,77,7,32,6,11,32,1,128,82,0
5236,134911,6ne76rFv6J6TLXUe0mStK4MXCR4J8Kt5,bWdj2GDclj5ofokWjzoa5jAwMkxCykd6,5,1,1,0,1,0,2,0,5,0.7142857142857143,1,0.0,0,1,0,1,1,0,0,2,0,2,3,1
5237,134914,yNC8T7gdWO96Y2q3tzTQeJUMY0F51xnO,SpATywNh6bZuzm8s1ceuBUnMUAeoAHHw,18,28,14,18,5,0,10,0,75,10.714285714285714,4,0.0,7,14,17,5,21,0,1,10,0,43,32,0
5238,134937,9CJfWVOWO2uvtgL9sMlN6s46G91IqAvr,A3fsA9Zfv1X2fVEQhTw51lKENdNrEqT3,4,2,1,0,1,2,2,0,8,1.1428571428571428,1,0.0,0,1,0,1,2,2,0,2,0,2,6,1
5239,134938,1ryg7vHF3PEsYEqZENe5bXv9yZs2dA3V,SpATywNh6bZuzm8s1ceuBUnMUAeoAHHw,4,1,0,0,0,0,4,0,5,0.7142857142857143,1,0.0,0,0,0,0,1,0,0,4,0,0,5,1
5240,134943,YfHmALaAUVJkTXPVPoa3sijNQuWgYS7R,G8EPVSXsOYB5YQWZGiz1aVq5Pgr2GrQu,15,20,9,12,7,0,1,0,49,7.0,1,0.0,9,9,6,7,11,0,6,1,0,31,18,1
5241,134957,oaNAVS5nMmZPkgC88QZyCkxZpo6GIFQk,G8EPVSXsOYB5YQWZGiz1aVq5Pgr2GrQu,15,28,23,12,12,0,3,0,78,11.142857142857142,2,0.0,0,23,11,12,28,0,1,3,0,46,32,1
5242,134996,mr6SHndrMUFTgJeI3Xsa4qtu794cguyo,bWdj2GDclj5ofokWjzoa5jAwMkxCykd6,14,15,3,40,6,0,1,0,65,9.285714285714286,1,0.0,11,3,39,6,4,0,1,1,0,59,6,1
5243,135000,nToY9YbKok17BpaPlTxZF9mLZdFu0iiS,SpATywNh6bZuzm8s1ceuBUnMUAeoAHHw,5,2,1,0,1,0,2,0,6,0.8571428571428571,1,0.0,0,1,0,1,2,0,0,2,0,2,4,1
5244,135012,BTEY71NgAZGYnRCsSAITWHUZps70gyN4,A3fsA9Zfv1X2fVEQhTw51lKENdNrEqT3,3,0,0,0,0,2,4,2,8,1.1428571428571428,1,0.0,0,0,0,0,0,2,0,4,2,0,8,1
5245,135013,BTEY71NgAZGYnRCsSAITWHUZps70gyN4,bWdj2GDclj5ofokWjzoa5jAwMkxCykd6,1,0,0,0,0,0,1,0,1,0.14285714285714285,1,0.0,0,0,0,0,0,0,0,1,0,0,1,1
5246,135029,aLOGAfDRvmZG085q2HFFKLaRHVWlMbeZ,A3fsA9Zfv1X2fVEQhTw51lKENdNrEqT3,11,5,4,0,3,3,10,2,27,3.857142857142857,1,0.0,0,4,0,3,5,3,0,10,2,7,20,1
5247,135036,wFvodFqghxL7iISMFbYXkYNq6P6eK5gH,A3fsA9Zfv1X2fVEQhTw51lKENdNrEqT3,1,0,0,0,0,0,1,0,1,0.14285714285714285,1,0.0,0,0,0,0,0,0,0,1,0,0,1,1
5248,135043,XoKIP4RGpnZk163890vUyWhLOIUSaapU,A3fsA9Zfv1X2fVEQhTw51lKENdNrEqT3,35,25,11,94,3,0,7,0,140,20.0,1,0.0,5,11,75,3,20,0,19,7,0,94,46,1
5249,135068,L0MAfJMwT0DciI5hH53QWdE0NS8GzvBn,A3fsA9Zfv1X2fVEQhTw51lKENdNrEqT3,6,3,2,0,2,0,1,0,8,1.1428571428571428,1,0.0,0,2,0,2,3,0,0,1,0,4,4,1
5250,135069,bgBLWArC7sr7mZdIi75AaJrBI0yN4gRx,SpATywNh6bZuzm8s1ceuBUnMUAeoAHHw,28,74,9,26,7,23,52,5,196,28.0,7,0.0,18,9,23,7,56,23,3,52,5,57,139,0
5251,135071,5OhdzLluLI4b0UetZ6QtwaKcHtelD4GM,A3fsA9Zfv1X2fVEQhTw51lKENdNrEqT3,25,11,11,0,11,0,3,0,36,5.142857142857143,1,0.0,0,11,0,11,11,0,0,3,0,22,14,1
5252,135077,ml2yAwYHzufxZ6xJCtzUFr2eNYyPECGG,bWdj2GDclj5ofokWjzoa5jAwMkxCykd6,7,5,3,0,1,2,3,0,14,2.0,1,0.0,0,3,0,1,5,2,0,3,0,4,10,1
5253,135103,gZWf27ETcHz4bBmwZPjiPumw55JZ4IOR,RXDvfPUBYFlVdlueBFbLW0mhhAyGEqpt,1,0,0,0,0,0,1,0,1,0.14285714285714285,1,0.0,0,0,0,0,0,0,0,1,0,0,1,1
5254,135109,EJXR6GjvUW4ftcdNw7M6s3AjFADQ5nWH,G8EPVSXsOYB5YQWZGiz1aVq5Pgr2GrQu,20,36,0,46,0,4,11,1,98,14.0,1,0.0,6,0,42,0,30,4,4,11,1,48,50,1
5255,135110,czraR8jl3tjb5vvHKbMcAmZkpcCxXmtq,SpATywNh6bZuzm8s1ceuBUnMUAeoAHHw,6,4,2,0,1,0,2,0,9,1.2857142857142858,1,0.0,0,2,0,1,4,0,0,2,0,3,6,1
5256,135114,lPsprPvnz2KazNU0HiuebkPap36Sy8nd,A3fsA9Zfv1X2fVEQhTw51lKENdNrEqT3,7,3,2,0,2,0,2,0,9,1.2857142857142858,1,0.0,0,2,0,2,3,0,0,2,0,4,5,1
5257,135124,NOmOOlAJE5nKLDW211ZOVqBtRY1AgNoT,A3fsA9Zfv1X2fVEQhTw51lKENdNrEqT3,21,24,2,0,2,1,8,1,38,5.428571428571429,1,0.0,0,2,0,2,24,1,0,8,1,4,34,1
5258,135142,XoKIP4RGpnZk163890vUyWhLOIUSaapU,bWdj2GDclj5ofokWjzoa5jAwMkxCykd6,10,10,2,28,0,0,1,0,41,5.857142857142857,1,0.0,3,2,23,0,7,0,5,1,0,28,13,1
5259,135159,yAxjMvvPF3HDitgCGIcnFlXrbnOszGcQ,bWdj2GDclj5ofokWjzoa5jAwMkxCykd6,8,16,5,114,1,0,3,0,139,19.857142857142858,2,0.0,3,5,112,1,13,0,2,3,0,121,18,1
5260,135164,jRV8IFAqLHlnm6Yo5f3lbOm8y9FKnSQS,SpATywNh6bZuzm8s1ceuBUnMUAeoAHHw,24,24,13,16,8,2,6,1,70,10.0,2,0.0,8,13,14,8,16,2,2,6,1,43,27,1
5261,135165,72z519PMt8GGBXLvF1FG0oMJuciCSWYJ,G8EPVSXsOYB5YQWZGiz1aVq5Pgr2GrQu,7,7,3,0,1,0,9,0,20,2.857142857142857,5,0.0,0,3,0,1,7,0,0,9,0,4,16,1
5262,135210,XPNYQB8BXxVJKoqXsnIXNkzgmqWM9Jf1,A3fsA9Zfv1X2fVEQhTw51lKENdNrEqT3,1,0,0,0,0,0,1,0,1,0.14285714285714285,1,0.0,0,0,0,0,0,0,0,1,0,0,1,1
5263,135236,8JTz84ZDdJm6tvsd7hgyCl1RB6wU6r2e,bWdj2GDclj5ofokWjzoa5jAwMkxCykd6,10,8,4,2,3,5,7,1,30,4.285714285714286,2,0.0,2,4,2,3,6,5,0,7,1,11,19,0
5264,135266,orkLWN7Jw88UrSJVImY9WyAA9wO3axVi,SpATywNh6bZuzm8s1ceuBUnMUAeoAHHw,29,28,17,24,9,3,8,1,90,12.857142857142858,1,0.0,4,17,19,9,24,3,5,8,1,49,41,1
5265,135270,orkLWN7Jw88UrSJVImY9WyAA9wO3axVi,bWdj2GDclj5ofokWjzoa5jAwMkxCykd6,1,0,0,0,0,0,1,0,1,0.14285714285714285,1,0.0,0,0,0,0,0,0,0,1,0,0,1,1
5266,135274,FJJqBn1iTJmAbav7Ov5Y4ycyF65fvY1E,SpATywNh6bZuzm8s1ceuBUnMUAeoAHHw,13,9,7,0,3,2,7,2,30,4.285714285714286,2,0.0,0,7,0,3,9,2,0,7,2,10,20,0
5267,135285,ORZA67vQIOSB05DsIbFIoGl0EWiKz8Mx,RXDvfPUBYFlVdlueBFbLW0mhhAyGEqpt,15,20,3,0,3,0,2,0,28,4.0,2,0.0,2,3,0,3,18,0,0,2,0,8,20,1
5268,135289,eXv6ACzt62C4hMSoDSIQMvmz4LEnGBtm,A3fsA9Zfv1X2fVEQhTw51lKENdNrEqT3,13,7,5,0,3,0,7,0,22,3.142857142857143,2,0.0,0,5,0,3,7,0,0,7,0,8,14,1
5269,135321,x6BtQH70uuLHaxqzHA21U9wmfT0SxzD9,G8EPVSXsOYB5YQWZGiz1aVq5Pgr2GrQu,10,8,0,14,0,0,8,0,30,4.285714285714286,2,0.0,4,0,10,0,4,0,4,8,0,14,16,1
5270,135333,Hmy7IERSuMBFx0LPTwulENadvjRMvkqo,SpATywNh6bZuzm8s1ceuBUnMUAeoAHHw,10,19,0,18,0,0,1,0,38,5.428571428571429,1,0.0,4,0,17,0,15,0,1,1,0,21,17,1
5271,135370,DpB3NoJLarAGiHUaBV6zvSP8bR0qw4yk,bWdj2GDclj5ofokWjzoa5jAwMkxCykd6,11,7,6,0,5,0,1,0,19,2.7142857142857144,2,0.0,0,6,0,5,7,0,0,1,0,11,8,1
5272,135376,lg9ClFc1WU5afD4IeCy9GllsKX7cYoEB,A3fsA9Zfv1X2fVEQhTw51lKENdNrEqT3,5,2,0,0,0,0,6,0,8,1.1428571428571428,1,0.0,0,0,0,0,2,0,0,6,0,0,8,1
5273,135378,0G28t6RwNA6XV451Zq3Rvj4OEqQwVjgc,SpATywNh6bZuzm8s1ceuBUnMUAeoAHHw,4,3,1,0,0,0,2,0,6,0.8571428571428571,1,0.0,1,1,0,0,2,0,0,2,0,2,4,1
5274,135405,1R1zO9aMB7Mx1Lw84JzsChVEV5JpwmZv,bWdj2GDclj5ofokWjzoa5jAwMkxCykd6,6,15,4,0,3,0,6,0,28,4.0,6,0.0,4,4,0,3,11,0,0,6,0,11,17,1
5275,135422,GR5uAqC8TkTRctStVcrTSN6GkRpM0Sgw,bWdj2GDclj5ofokWjzoa5jAwMkxCykd6,2,0,0,0,0,0,3,0,3,0.42857142857142855,1,0.0,0,0,0,0,0,0,0,3,0,0,3,1
5276,135435,WK0Fgs86cA55qEjGdACCPsAyup9yYjBW,SpATywNh6bZuzm8s1ceuBUnMUAeoAHHw,3,2,0,0,0,0,1,0,3,0.42857142857142855,1,0.0,0,0,0,0,2,0,0,1,0,0,3,1
5277,135449,MzVpgt6eIu33aOAUbbblQyleNNMrWM7t,SpATywNh6bZuzm8s1ceuBUnMUAeoAHHw,6,5,3,0,1,0,1,0,10,1.4285714285714286,1,0.0,0,3,0,1,5,0,0,1,0,4,6,1
5278,135466,JX7kh5ZfjpOmdoUQ8rczM8ziszP4alom,SpATywNh6bZuzm8s1ceuBUnMUAeoAHHw,14,18,7,0,4,0,6,1,36,5.142857142857143,1,0.0,4,7,0,4,14,0,0,6,1,15,21,1
5279,135498,hnr1SrvwKs73pIl4Y8iA8BBWZr0Bh6Qj,SpATywNh6bZuzm8s1ceuBUnMUAeoAHHw,16,19,0,14,0,1,7,1,42,6.0,1,0.0,6,0,12,0,13,1,2,7,1,18,24,1
5280,135509,cVCoN7HidGGECgrwLZ0Mg4plpA9ST0kb,A3fsA9Zfv1X2fVEQhTw51lKENdNrEqT3,1,0,0,0,0,0,1,0,1,0.14285714285714285,1,0.0,0,0,0,0,0,0,0,1,0,0,1,1
5281,135519,0oRPUvEsJVbkR952hI1neMgRcrJImgj3,A3fsA9Zfv1X2fVEQhTw51lKENdNrEqT3,16,9,8,0,7,0,2,0,26,3.7142857142857144,1,0.0,0,8,0,7,9,0,0,2,0,15,11,1
5282,135527,kF53IpFKMxCV7VctlhpV2lrkHuEbgiU3,RXDvfPUBYFlVdlueBFbLW0mhhAyGEqpt,18,12,0,46,0,3,7,2,70,10.0,1,0.0,8,0,41,0,4,3,5,7,2,49,21,0
5283,135549,N1UAN9F5SFtgblynTSPZlPcIrBcrhldq,A3fsA9Zfv1X2fVEQhTw51lKENdNrEqT3,17,12,11,0,11,5,4,1,44,6.285714285714286,1,0.0,0,11,0,11,12,5,0,4,1,22,22,1
5284,135559,LPkDtPFF5RxOnDnsqEeKxwZe2JS0rusW,SpATywNh6bZuzm8s1ceuBUnMUAeoAHHw,29,37,18,32,11,0,4,0,102,14.571428571428571,2,0.0,13,18,28,11,24,0,4,4,0,70,32,1
5285,135574,KNNMSW3oLxGqEqv2czanNkhQgdUkOWgY,A3fsA9Zfv1X2fVEQhTw51lKENdNrEqT3,8,5,4,0,4,0,1,0,14,2.0,1,0.0,0,4,0,4,5,0,0,1,0,8,6,1
5286,135578,WAeA3Wxi4ox0P2eDgiY2JLtPyMIFhfp0,bWdj2GDclj5ofokWjzoa5jAwMkxCykd6,18,35,15,16,15,2,15,2,100,14.285714285714286,2,0.0,14,15,13,15,21,2,3,15,2,57,43,1
5287,135583,ix15aF6FOEF1waZCSZt01VrPOuPGJ3yM,bWdj2GDclj5ofokWjzoa5jAwMkxCykd6,1,0,0,0,0,0,1,0,1,0.14285714285714285,1,0.0,0,0,0,0,0,0,0,1,0,0,1,1
5288,135586,dH1fJFd4EUa9cDGkzaH97LNe2YTOAGRI,SpATywNh6bZuzm8s1ceuBUnMUAeoAHHw,5,4,0,0,0,0,3,0,7,1.0,1,0.0,0,0,0,0,4,0,0,3,0,0,7,1
5289,135592,pO9i2Ab1by3uoxklbewkfKRXc2dQyl5M,SpATywNh6bZuzm8s1ceuBUnMUAeoAHHw,5,3,2,0,2,0,2,0,9,1.2857142857142858,1,0.0,0,2,0,2,3,0,0,2,0,4,5,1
5290,135593,rFiKT35F4vi8a7NpfY1bEgz4HT50lSZd,SpATywNh6bZuzm8s1ceuBUnMUAeoAHHw,8,9,2,0,2,0,4,0,17,2.4285714285714284,3,0.0,0,2,0,2,9,0,0,4,0,4,13,1
5291,135594,gikp9GqTKNuof6stdLjZVJv1OHEXFMyZ,G8EPVSXsOYB5YQWZGiz1aVq5Pgr2GrQu,33,43,18,66,0,0,4,0,131,18.714285714285715,3,0.0,22,18,44,0,21,0,22,4,0,84,47,0
5292,135604,MFpshextOJLHhySF4C6u9eWxWZPDeRiA,G8EPVSXsOYB5YQWZGiz1aVq5Pgr2GrQu,1,0,0,0,0,0,1,0,1,0.14285714285714285,1,0.0,0,0,0,0,0,0,0,1,0,0,1,1
5293,135605,Ql4EosuzRo0tVj3lvTLhkLOyEsWZly6m,A3fsA9Zfv1X2fVEQhTw51lKENdNrEqT3,1,0,0,0,0,0,1,0,1,0.14285714285714285,1,0.0,0,0,0,0,0,0,0,1,0,0,1,1
5294,135618,8vBpgDrBoNVwqQQYIlW93nRYlEk72d2F,A3fsA9Zfv1X2fVEQhTw51lKENdNrEqT3,2,0,0,0,0,0,3,0,3,0.42857142857142855,1,0.0,0,0,0,0,0,0,0,3,0,0,3,1
5295,135620,xe0pnwtsOXCGbwfmaX74fYK9PfsU6JPN,SpATywNh6bZuzm8s1ceuBUnMUAeoAHHw,1,0,0,0,0,0,1,0,1,0.14285714285714285,1,0.0,0,0,0,0,0,0,0,1,0,0,1,1
5296,135625,OQFJERUfDkJREmuh848c2NVEfKc13k0Z,SpATywNh6bZuzm8s1ceuBUnMUAeoAHHw,13,8,7,0,6,0,1,0,22,3.142857142857143,1,0.0,0,7,0,6,8,0,0,1,0,13,9,1
5297,135636,Or5tbal17XyYWYBFOcz5Axiks4gsj2rC,SpATywNh6bZuzm8s1ceuBUnMUAeoAHHw,27,27,12,39,7,0,3,0,88,12.571428571428571,3,0.0,14,12,33,7,13,0,6,3,0,66,22,1
5298,135644,9w2MJQeZHeyFkqwhaftUSXLuvPN6lDkw,SpATywNh6bZuzm8s1ceuBUnMUAeoAHHw,11,33,11,0,3,0,2,0,49,7.0,2,0.0,20,11,0,3,13,0,0,2,0,34,15,1
5299,135671,rmx82oLaycREVuiUJS5poc97xd1UWvXB,SpATywNh6bZuzm8s1ceuBUnMUAeoAHHw,5,2,1,0,1,0,2,0,6,0.8571428571428571,1,0.0,0,1,0,1,2,0,0,2,0,2,4,1
5300,135673,5ZrPblaWYg1V0nkRfCyVA4ssWqd4pnQb,SpATywNh6bZuzm8s1ceuBUnMUAeoAHHw,11,5,2,4,2,0,15,1,29,4.142857142857143,2,0.0,0,2,4,2,5,0,0,15,1,8,21,0
5301,135674,zILXfIGJjWXm6dA2MrEQWr2XeEUry8lN,A3fsA9Zfv1X2fVEQhTw51lKENdNrEqT3,11,12,7,0,3,0,8,0,30,4.285714285714286,3,0.0,0,7,0,3,12,0,0,8,0,10,20,1
5302,135676,f8veUZRhdgLfRgcJyscv3SPrRGXUYeUM,bWdj2GDclj5ofokWjzoa5jAwMkxCykd6,1,0,0,0,0,0,4,0,4,0.5714285714285714,1,0.0,0,0,0,0,0,0,0,4,0,0,4,1
5303,135688,dXV6CXhMuL2MovsaBcVnWuwVAfDnBy3D,bWdj2GDclj5ofokWjzoa5jAwMkxCykd6,1,0,0,0,0,0,1,0,1,0.14285714285714285,1,0.0,0,0,0,0,0,0,0,1,0,0,1,1
5304,135691,ZtI7VkDL2OGaTLjYGXUs2OJh9j1CJRBG,bWdj2GDclj5ofokWjzoa5jAwMkxCykd6,1,0,0,0,0,0,3,0,3,0.42857142857142855,1,0.0,0,0,0,0,0,0,0,3,0,0,3,1
5305,135705,HHLCfoI58dWnfKs7QJD7m07PMcmUWFLH,bWdj2GDclj5ofokWjzoa5jAwMkxCykd6,1,0,0,0,0,0,1,0,1,0.14285714285714285,1,0.0,0,0,0,0,0,0,0,1,0,0,1,1
5306,135715,Gur5FuhE9EyV9K1F0qLPk7AenhoY8PBS,RXDvfPUBYFlVdlueBFbLW0mhhAyGEqpt,1,0,0,0,0,0,1,0,1,0.14285714285714285,1,0.0,0,0,0,0,0,0,0,1,0,0,1,1
5307,135719,bkOkn0C7FOzFPypI63kak65ajOi43hAv,SpATywNh6bZuzm8s1ceuBUnMUAeoAHHw,4,3,2,0,2,0,1,0,8,1.1428571428571428,1,0.0,0,2,0,2,3,0,0,1,0,4,4,1
5308,135721,pvAe37z1FjLTGYdwlJFjXex25zlpyHtu,G8EPVSXsOYB5YQWZGiz1aVq5Pgr2GrQu,5,2,1,0,1,0,4,0,8,1.1428571428571428,2,0.0,0,1,0,1,2,0,0,4,0,2,6,1
5309,135723,AQfzx8ZlEOE2Pwd3sng1DQ0krIzvYrKM,RXDvfPUBYFlVdlueBFbLW0mhhAyGEqpt,2,0,0,0,0,0,2,0,2,0.2857142857142857,1,0.0,0,0,0,0,0,0,0,2,0,0,2,1
5310,135757,oj8ZT8gny2t1bI3zTIIqiwK9yqWuzw78,SpATywNh6bZuzm8s1ceuBUnMUAeoAHHw,3,2,0,0,0,0,2,0,4,0.5714285714285714,1,0.0,0,0,0,0,2,0,0,2,0,0,4,1
5311,135766,lOkl9iaUDyjk0zbwJLRgFqBRBNNBSRwr,SpATywNh6bZuzm8s1ceuBUnMUAeoAHHw,27,61,10,26,3,21,20,2,143,20.428571428571427,8,0.0,15,10,23,3,46,21,3,20,2,51,92,0
5312,135784,UsP8UHahXGHaChNTAHL4dZh6OmvP94L7,A3fsA9Zfv1X2fVEQhTw51lKENdNrEqT3,1,0,0,0,0,0,1,0,1,0.14285714285714285,1,0.0,0,0,0,0,0,0,0,1,0,0,1,1
5313,135807,mgLL2TOXKEK8di2v3UUyM4FMUqEuj4kl,SpATywNh6bZuzm8s1ceuBUnMUAeoAHHw,13,15,11,0,3,0,4,0,33,4.714285714285714,3,0.0,0,11,0,3,15,0,0,4,0,14,19,0
5314,135811,5sps38f5Y5pZOFcONQeuy3Uw9461fahZ,SpATywNh6bZuzm8s1ceuBUnMUAeoAHHw,9,20,9,0,4,1,9,1,44,6.285714285714286,2,0.0,1,9,0,4,19,1,0,9,1,14,30,1
5315,135817,E47JGU8OIEWEHQErVOIbVuBKL7eug9kL,SpATywNh6bZuzm8s1ceuBUnMUAeoAHHw,1,0,0,0,0,0,1,0,1,0.14285714285714285,1,0.0,0,0,0,0,0,0,0,1,0,0,1,1
5316,135825,ETvKJXrBLwN7msxC91B5PIQrzaf0kAW1,bWdj2GDclj5ofokWjzoa5jAwMkxCykd6,1,0,0,0,0,0,1,0,1,0.14285714285714285,1,0.0,0,0,0,0,0,0,0,1,0,0,1,1
5317,135854,up6Dm3KbNQ1ouTMs5v0fwblubVxwKJMi,7GRhBDsirIGkRZBtSMEzNTyDr2JQm4xx,16,9,9,0,9,0,6,0,33,4.714285714285714,2,0.0,0,9,0,9,9,0,0,6,0,18,15,1
5318,135858,mTOoYxpCIgV1V8PFGNgwuxdFg8JU7kb9,7GRhBDsirIGkRZBtSMEzNTyDr2JQm4xx,12,3,2,0,2,1,7,1,16,2.2857142857142856,1,0.0,0,2,0,2,3,1,0,7,1,4,12,1
5319,136038,P38VxMH253jjoDZHRNefTKyEAydphpb2,SpATywNh6bZuzm8s1ceuBUnMUAeoAHHw,17,26,10,22,5,15,14,3,95,13.571428571428571,2,0.0,10,10,18,5,16,15,4,14,3,43,52,1
5320,136064,o3T0K8ec78cQHSHsSLzMA1PbvYi8mwTI,7GRhBDsirIGkRZBtSMEzNTyDr2JQm4xx,16,44,10,30,0,31,13,2,130,18.571428571428573,3,0.0,20,10,26,0,24,31,4,13,2,56,74,1
5321,136096,msM56OM0TrhCVyicpbYafJdknfubqkzk,7GRhBDsirIGkRZBtSMEzNTyDr2JQm4xx,8,9,2,6,2,1,3,1,24,3.4285714285714284,1,0.0,3,2,5,2,6,1,1,3,1,12,12,1
5322,136098,YQZ85qW2KiDmX9GD2Tq3oRYH6ucmQmKe,7GRhBDsirIGkRZBtSMEzNTyDr2JQm4xx,16,42,0,22,4,1,2,0,71,10.142857142857142,1,0.0,24,0,19,4,18,1,3,2,0,47,24,1
5323,136149,St6usTSSgX5U9v7wchuMWqmBKoCcDwN2,SpATywNh6bZuzm8s1ceuBUnMUAeoAHHw,15,19,1,8,1,0,6,0,35,5.0,2,0.0,9,1,7,1,10,0,1,6,0,18,17,0
5324,136152,FmYyMdFUePtcDBVgDdhDyxnbGBctrwZJ,SpATywNh6bZuzm8s1ceuBUnMUAeoAHHw,7,2,1,0,1,0,4,1,9,1.2857142857142858,1,0.0,1,1,0,1,1,0,0,4,1,3,6,0
5325,136209,oGK3c8nk6Ftl3V2u1zOvslszD4LDLr3w,G8EPVSXsOYB5YQWZGiz1aVq5Pgr2GrQu,4,2,1,0,1,0,1,0,5,0.7142857142857143,1,0.0,0,1,0,1,2,0,0,1,0,2,3,1
5326,136230,FZEwaAUaiR6zemazrUHMMvDLCgHez3sb,SpATywNh6bZuzm8s1ceuBUnMUAeoAHHw,12,24,11,19,1,21,10,1,87,12.428571428571429,2,0.0,6,11,16,1,18,21,3,10,1,34,53,1
5327,136247,8FGs2DlahZoB3KBpV3eIicZF3v5DtTbf,SpATywNh6bZuzm8s1ceuBUnMUAeoAHHw,16,10,7,5,3,2,9,1,37,5.285714285714286,2,0.0,2,7,5,3,8,2,0,9,1,17,20,0
5328,136265,7fwVXF5ctPhb8pPmrNYDi2ycSDGABklq,SpATywNh6bZuzm8s1ceuBUnMUAeoAHHw,5,5,0,0,0,0,1,0,6,0.8571428571428571,1,0.0,0,0,0,0,5,0,0,1,0,0,6,1
5329,136312,DysXuoUoTtoCjfxHxEQdZhXHC6tNfwru,7GRhBDsirIGkRZBtSMEzNTyDr2JQm4xx,34,37,18,44,20,0,12,0,131,18.714285714285715,4,0.0,19,18,36,20,18,0,8,12,0,93,38,1
5330,136327,xFOMKgrHGqKyL5uPk9RcNRWczzZxvoeN,7GRhBDsirIGkRZBtSMEzNTyDr2JQm4xx,1,0,0,0,0,0,1,0,1,0.14285714285714285,1,0.0,0,0,0,0,0,0,0,1,0,0,1,1
5331,136398,gtKTzkXHwS41ljYVmjlLLf4WyQSkK02q,7GRhBDsirIGkRZBtSMEzNTyDr2JQm4xx,23,35,9,64,0,0,3,0,111,15.857142857142858,1,0.0,23,9,54,0,12,0,10,3,0,86,25,1
5332,136413,SAZKFz2NUOxVKdkBgcAx84BjxoboQOlS,SpATywNh6bZuzm8s1ceuBUnMUAeoAHHw,20,23,2,16,1,10,11,0,63,9.0,3,0.0,3,2,16,1,20,10,0,11,0,22,41,0
5333,136445,qtck8S6SMYpkxbIZosuQoFSB26vuEbBy,7GRhBDsirIGkRZBtSMEzNTyDr2JQm4xx,2,0,0,0,0,0,2,0,2,0.2857142857142857,1,0.0,0,0,0,0,0,0,0,2,0,0,2,1
5334,136468,YVboeUnAYRezL6JF0VMVpiapYahgjIwn,SpATywNh6bZuzm8s1ceuBUnMUAeoAHHw,17,34,12,21,5,22,15,2,111,15.857142857142858,3,0.0,11,12,18,5,23,22,3,15,2,46,65,0
5335,136500,AAAvWauitKfXD0xRpNsfpOKQu223kCXG,bWdj2GDclj5ofokWjzoa5jAwMkxCykd6,6,3,2,0,2,0,2,0,9,1.2857142857142858,1,0.0,0,2,0,2,3,0,0,2,0,4,5,1
5336,136540,hZR4MwcYec4g0GoOyJFngJGEyWOySpv2,7GRhBDsirIGkRZBtSMEzNTyDr2JQm4xx,7,4,2,0,0,13,10,1,30,4.285714285714286,4,0.0,0,2,0,0,4,13,0,10,1,2,28,0
5337,136564,JHhY30IKFzw4LWcyrHuTEglWNqRkqdDU,SpATywNh6bZuzm8s1ceuBUnMUAeoAHHw,12,6,2,16,0,0,7,0,31,4.428571428571429,2,0.0,4,2,16,0,2,0,0,7,0,22,9,1
5338,136592,JHhY30IKFzw4LWcyrHuTEglWNqRkqdDU,RXDvfPUBYFlVdlueBFbLW0mhhAyGEqpt,38,16,8,114,3,1,6,0,148,21.142857142857142,1,0.0,7,8,103,3,9,1,11,6,0,121,27,1
5339,136596,YqY5WPa8kwIoLBKGaVnXfSZOMvkSrEdU,SpATywNh6bZuzm8s1ceuBUnMUAeoAHHw,15,16,9,8,5,13,3,0,54,7.714285714285714,2,0.0,5,9,8,5,11,13,0,3,0,27,27,0
5340,136602,YqY5WPa8kwIoLBKGaVnXfSZOMvkSrEdU,A3fsA9Zfv1X2fVEQhTw51lKENdNrEqT3,7,5,3,0,1,0,3,0,12,1.7142857142857142,2,0.0,0,3,0,1,5,0,0,3,0,4,8,1
5341,136635,jedE3nTKdlUnNjeeZxONdSIgUVRjrOri,7GRhBDsirIGkRZBtSMEzNTyDr2JQm4xx,8,4,2,4,2,2,2,0,16,2.2857142857142856,2,0.0,1,2,3,2,3,2,1,2,0,8,8,1
5342,136652,qU5mfkjhD9M0R49RmBMaCeXLeTqIOyhm,7GRhBDsirIGkRZBtSMEzNTyDr2JQm4xx,4,4,0,0,0,0,1,0,5,0.7142857142857143,1,0.0,0,0,0,0,4,0,0,1,0,0,5,1
5343,136673,St6usTSSgX5U9v7wchuMWqmBKoCcDwN2,A3fsA9Zfv1X2fVEQhTw51lKENdNrEqT3,5,3,0,0,0,3,3,0,9,1.2857142857142858,2,0.0,0,0,0,0,3,3,0,3,0,0,9,1
5344,136743,PV4ahNYgW8Lcd9nNe0xrpkqG7Ws3zMb1,SpATywNh6bZuzm8s1ceuBUnMUAeoAHHw,17,25,15,12,6,18,43,6,125,17.857142857142858,2,0.0,4,15,11,6,21,18,1,43,6,36,89,0
5345,136752,YUPaOsEEFOH7xpyMBcCkViDpUqkz1A5I,7GRhBDsirIGkRZBtSMEzNTyDr2JQm4xx,1,0,0,0,0,0,1,0,1,0.14285714285714285,1,0.0,0,0,0,0,0,0,0,1,0,0,1,1
5346,136785,nsbeAj5BI7VK72NYmPa0cGgkMq0PU2h6,SpATywNh6bZuzm8s1ceuBUnMUAeoAHHw,7,6,3,0,3,0,1,0,13,1.8571428571428572,2,0.0,0,3,0,3,6,0,0,1,0,6,7,0
5347,136797,uXoi7oqvj5HXbvnVGMMeQOqZvw3BW3QM,G8EPVSXsOYB5YQWZGiz1aVq5Pgr2GrQu,23,54,1,32,4,3,8,3,105,15.0,2,0.0,42,1,18,4,12,3,14,8,3,65,40,0
5348,136860,5NKHIcFKbvZvjnI6x0vdD0R4rE65640c,SpATywNh6bZuzm8s1ceuBUnMUAeoAHHw,16,27,2,26,1,4,23,2,85,12.142857142857142,3,0.0,10,2,21,1,17,4,5,23,2,34,51,0
5349,136874,P6rNkkuxGZS8wdNcuNCJoPQNsegCUIqx,7GRhBDsirIGkRZBtSMEzNTyDr2JQm4xx,2,0,0,0,0,0,2,0,2,0.2857142857142857,1,0.0,0,0,0,0,0,0,0,2,0,0,2,1
5350,136897,xNcMMIyB0y99dNaEOIqDnvCMrU2SAEOP,G8EPVSXsOYB5YQWZGiz1aVq5Pgr2GrQu,8,3,2,0,1,1,6,1,14,2.0,2,0.0,0,2,0,1,3,1,0,6,1,3,11,0
5351,136920,HjlZu5CgYZQVUJqRZv1KCIOR0lFMSkiS,7GRhBDsirIGkRZBtSMEzNTyDr2JQm4xx,10,9,0,10,0,0,7,0,26,3.7142857142857144,2,0.0,2,0,8,0,7,0,2,7,0,10,16,1
5352,136942,BJcIgaOnWdAOKf7jzUg9DKOlERmjwn2s,7GRhBDsirIGkRZBtSMEzNTyDr2JQm4xx,1,0,0,0,0,0,2,0,2,0.2857142857142857,1,0.0,0,0,0,0,0,0,0,2,0,0,2,1
5353,137016,00bDiL0A6W9npxn52kzhmAfK2Yag1Gik,bWdj2GDclj5ofokWjzoa5jAwMkxCykd6,9,6,3,0,0,19,7,1,36,5.142857142857143,1,0.0,2,3,0,0,4,19,0,7,1,5,31,0
5354,137077,xIsNJgqYQ4WcvbQ1A0Us7q1c1NYtR1tF,bWdj2GDclj5ofokWjzoa5jAwMkxCykd6,5,2,0,0,1,0,2,0,5,0.7142857142857143,1,0.0,0,0,0,1,2,0,0,2,0,1,4,0
5355,137214,nmlYjXdaqWSjPWm2kQhmjZqjjBKhkQAm,A3fsA9Zfv1X2fVEQhTw51lKENdNrEqT3,2,0,0,0,0,0,2,0,2,0.2857142857142857,1,0.0,0,0,0,0,0,0,0,2,0,0,2,1
5356,137290,RmlLLXW8yVeVv6IlxP4h82on7YcnLjlC,fbPkOYLVPtPgIt0MxizjfFJov3JbHyAi,5,2,0,0,0,0,19,1,22,3.142857142857143,1,0.0,0,0,0,0,2,0,0,19,1,0,22,1
5357,137292,1nw5LJsxTSlYBcpPAO0FPean8WSWknnT,fbPkOYLVPtPgIt0MxizjfFJov3JbHyAi,5,2,0,0,0,4,6,0,12,1.7142857142857142,1,0.0,0,0,0,0,2,4,0,6,0,0,12,1
5358,137296,bJ8AAxZ3JuvigCWd3VGvoJ2Ns2zJszXZ,fbPkOYLVPtPgIt0MxizjfFJov3JbHyAi,10,28,14,1,9,0,3,0,55,7.857142857142857,2,0.0,10,14,1,9,18,0,0,3,0,34,21,1
5359,137299,fQ2qYe5HNta8P0G8uXdGrvFPejbwucPN,fbPkOYLVPtPgIt0MxizjfFJov3JbHyAi,18,25,11,0,7,14,9,0,66,9.428571428571429,1,0.0,0,11,0,7,25,14,0,9,0,18,48,1
5360,137300,O5osNpvARQ134oncM7N5QGhst9sMjRtB,fbPkOYLVPtPgIt0MxizjfFJov3JbHyAi,4,2,1,0,1,7,1,0,12,1.7142857142857142,1,0.0,0,1,0,1,2,7,0,1,0,2,10,1
5361,137301,h774wdF6vIIcl50Js74gckwUtlv9SBGH,fbPkOYLVPtPgIt0MxizjfFJov3JbHyAi,26,83,40,13,24,8,10,0,178,25.428571428571427,4,0.0,21,40,11,24,62,8,2,10,0,96,82,1
5362,137304,fV9PFchRO9NFkeyKqjI60ieBb4YfIgSO,fbPkOYLVPtPgIt0MxizjfFJov3JbHyAi,4,3,0,0,0,16,4,0,23,3.2857142857142856,1,0.0,0,0,0,0,3,16,0,4,0,0,23,1
5363,137306,CTPK2LGRvMaPvlFasZdjTmXOqyM1Lmi8,fbPkOYLVPtPgIt0MxizjfFJov3JbHyAi,23,25,14,14,15,7,3,0,78,11.142857142857142,1,0.0,10,14,13,15,15,7,1,3,0,52,26,1
5364,137308,UAggpZPNL1hZ0kLwEDSUplsT3ghk1d6y,fbPkOYLVPtPgIt0MxizjfFJov3JbHyAi,9,5,3,0,1,2,6,1,18,2.5714285714285716,2,0.0,0,3,0,1,5,2,0,6,1,4,14,1
5365,137309,gL1o6jsIwD6Ip8uBaHnoUMfUbsYcrCmr,fbPkOYLVPtPgIt0MxizjfFJov3JbHyAi,7,3,2,0,2,3,3,1,14,2.0,1,0.0,0,2,0,2,3,3,0,3,1,4,10,1
5366,137313,n1ESpvyobZkFsfrWJhKOuY4URaa1sUc5,fbPkOYLVPtPgIt0MxizjfFJov3JbHyAi,5,2,1,0,1,0,4,0,8,1.1428571428571428,1,0.0,0,1,0,1,2,0,0,4,0,2,6,1
5367,137315,f0jKRSnLVIejbfFzT0M2iiXUyVwMVp4e,fbPkOYLVPtPgIt0MxizjfFJov3JbHyAi,5,3,2,0,2,0,2,0,9,1.2857142857142858,1,0.0,0,2,0,2,3,0,0,2,0,4,5,1
5368,137319,glXXkvEu5VWOG069hJZn4a1ogKzxsZqy,fbPkOYLVPtPgIt0MxizjfFJov3JbHyAi,2,0,0,0,0,0,6,0,6,0.8571428571428571,1,0.0,0,0,0,0,0,0,0,6,0,0,6,1
5369,137321,owHNspB8DrsecsPRNmUB7UBdqXOlW955,fbPkOYLVPtPgIt0MxizjfFJov3JbHyAi,7,8,3,0,2,0,1,0,14,2.0,1,0.0,0,3,0,2,8,0,0,1,0,5,9,1
5370,137323,iTjfGmkhI7qYgG8rBAfSzNVyjUvKbeUV,fbPkOYLVPtPgIt0MxizjfFJov3JbHyAi,4,2,1,0,1,0,1,0,5,0.7142857142857143,1,0.0,0,1,0,1,2,0,0,1,0,2,3,1
5371,137324,nyH7Jx4kN1AdDJdwkZQoUDqYoovHgbk5,fbPkOYLVPtPgIt0MxizjfFJov3JbHyAi,8,8,5,0,4,10,4,0,31,4.428571428571429,2,0.0,0,5,0,4,8,10,0,4,0,9,22,0
5372,137325,8WSLblwPqv9lrYeGgJiG7aFvD2e5FjPW,fbPkOYLVPtPgIt0MxizjfFJov3JbHyAi,2,0,0,0,0,0,2,0,2,0.2857142857142857,1,0.0,0,0,0,0,0,0,0,2,0,0,2,1
5373,137326,3cVj7hdkALbjY726IM3M6Ud07m4las2t,fbPkOYLVPtPgIt0MxizjfFJov3JbHyAi,9,3,2,0,2,4,6,1,18,2.5714285714285716,1,0.0,0,2,0,2,3,4,0,6,1,4,14,1
5374,137329,LnsTOCnKQwSd834VWj8Se5P6LDNk8RHo,fbPkOYLVPtPgIt0MxizjfFJov3JbHyAi,5,7,0,0,0,0,1,0,8,1.1428571428571428,1,0.0,0,0,0,0,7,0,0,1,0,0,8,1
5375,137331,5fdjSFb0UnHfjLD83iptHyG30XcBntML,fbPkOYLVPtPgIt0MxizjfFJov3JbHyAi,8,6,2,0,3,0,3,0,14,2.0,1,0.0,2,2,0,3,4,0,0,3,0,7,7,1
5376,137332,V5n4KmrCt6qTaNCHvn8AZsixldOhtrqM,fbPkOYLVPtPgIt0MxizjfFJov3JbHyAi,8,5,3,0,2,5,4,0,19,2.7142857142857144,2,0.0,0,3,0,2,5,5,0,4,0,5,14,1
5377,137335,b2ohpFiEgZaZsBBPqUMnfjpywCAbNR88,fbPkOYLVPtPgIt0MxizjfFJov3JbHyAi,10,11,4,0,4,0,2,0,21,3.0,1,0.0,0,4,0,4,11,0,0,2,0,8,13,1
5378,137336,D35Hr8NmMeH1abGin8hsVg1eeYI1rkMx,fbPkOYLVPtPgIt0MxizjfFJov3JbHyAi,19,15,11,0,9,0,5,2,42,6.0,1,0.0,0,11,0,9,15,0,0,5,2,20,22,1
5379,137339,Q4RfMohp0VyMzzF8aoHnH7xFgkQEGrSz,fbPkOYLVPtPgIt0MxizjfFJov3JbHyAi,5,2,1,0,1,0,3,0,7,1.0,1,0.0,0,1,0,1,2,0,0,3,0,2,5,1
5380,137340,7RIgMHzHpMzY7qBXHPj6WiDKK3U9H2Wz,fbPkOYLVPtPgIt0MxizjfFJov3JbHyAi,7,8,5,0,3,2,4,0,22,3.142857142857143,2,0.0,0,5,0,3,8,2,0,4,0,8,14,1
5381,137341,EVRzOGDcK6HIoRC4TyM175kAEkfMvm8k,fbPkOYLVPtPgIt0MxizjfFJov3JbHyAi,6,5,2,0,3,0,3,0,13,1.8571428571428572,1,0.0,2,2,0,3,3,0,0,3,0,7,6,1
5382,137342,G3uUdYmcbUGjsucepMY504O6KIKoDegj,fbPkOYLVPtPgIt0MxizjfFJov3JbHyAi,2,0,0,0,0,0,7,0,7,1.0,1,0.0,0,0,0,0,0,0,0,7,0,0,7,1
5383,137343,cquObqcJUxOFEWJ4OzhgFktpn4MuuvGh,fbPkOYLVPtPgIt0MxizjfFJov3JbHyAi,2,0,0,0,0,0,2,0,2,0.2857142857142857,1,0.0,0,0,0,0,0,0,0,2,0,0,2,1
5384,137345,MCZHS6CBpJ75tmAXNSc4ArD5vu4UQMmf,fbPkOYLVPtPgIt0MxizjfFJov3JbHyAi,2,0,0,0,0,0,6,0,6,0.8571428571428571,1,0.0,0,0,0,0,0,0,0,6,0,0,6,1
5385,137348,T5moiKfoqYwkBJrrQj3QEFYZxN8QkHfc,fbPkOYLVPtPgIt0MxizjfFJov3JbHyAi,8,5,2,0,1,9,6,1,24,3.4285714285714284,1,0.0,0,2,0,1,5,9,0,6,1,3,21,1
5386,137353,0yZD4fjReiCp5h9L5wxeZCsj4C8snJgU,fbPkOYLVPtPgIt0MxizjfFJov3JbHyAi,2,0,0,0,0,0,3,0,3,0.42857142857142855,1,0.0,0,0,0,0,0,0,0,3,0,0,3,1
5387,137355,UaIcSFKSsXMkLJoEB18mPucIS2F5HMZt,fbPkOYLVPtPgIt0MxizjfFJov3JbHyAi,4,2,1,0,0,0,2,0,5,0.7142857142857143,1,0.0,0,1,0,0,2,0,0,2,0,1,4,1
5388,137357,Dxumuu0iESds4rdkin6IFLqksHFKYmBa,fbPkOYLVPtPgIt0MxizjfFJov3JbHyAi,2,0,0,0,0,0,3,0,3,0.42857142857142855,1,0.0,0,0,0,0,0,0,0,3,0,0,3,1
5389,137358,htmCxkgAOIvbjO4xq8D0LMRC4XX4uXb4,fbPkOYLVPtPgIt0MxizjfFJov3JbHyAi,7,3,2,0,2,0,3,0,10,1.4285714285714286,1,0.0,0,2,0,2,3,0,0,3,0,4,6,1
5390,137361,c3Q7zBkcz9A9C9axYIiO1QysEG1V4UAO,fbPkOYLVPtPgIt0MxizjfFJov3JbHyAi,9,5,4,0,3,0,5,0,17,2.4285714285714284,1,0.0,0,4,0,3,5,0,0,5,0,7,10,1
5391,137370,qNDvS5AGNuAWPmsY8v3e0mmJNktcZlln,fbPkOYLVPtPgIt0MxizjfFJov3JbHyAi,7,8,2,0,2,0,7,0,19,2.7142857142857144,1,0.0,4,2,0,2,4,0,0,7,0,8,11,1
5392,137372,lOBLdw8F0Df8BSa1UipMpaST2r1WwJcV,fbPkOYLVPtPgIt0MxizjfFJov3JbHyAi,9,4,3,0,3,6,6,1,23,3.2857142857142856,1,0.0,0,3,0,3,4,6,0,6,1,6,17,1
5393,137373,sndae06qc0KQXBA5AxxztXDWy4HQwsmF,fbPkOYLVPtPgIt0MxizjfFJov3JbHyAi,10,15,6,10,7,0,5,0,43,6.142857142857143,1,0.0,6,6,6,7,9,0,4,5,0,25,18,1
5394,137375,CKl647uBpzhaV8Bs4OjoA2KfJg2713it,fbPkOYLVPtPgIt0MxizjfFJov3JbHyAi,9,11,4,4,5,0,3,0,27,3.857142857142857,1,0.0,6,4,3,5,5,0,1,3,0,18,9,1
5395,137377,Ep4Q95tKnG1eQgBqFXbKyAx3i4zRNHfc,fbPkOYLVPtPgIt0MxizjfFJov3JbHyAi,1,0,0,0,0,0,1,0,1,0.14285714285714285,1,0.0,0,0,0,0,0,0,0,1,0,0,1,1
5396,137379,QuG2234wZAOXxXJpYa4PWsH3trXo84qK,fbPkOYLVPtPgIt0MxizjfFJov3JbHyAi,8,4,3,0,3,0,1,0,11,1.5714285714285714,1,0.0,0,3,0,3,4,0,0,1,0,6,5,1
5397,137383,yukNWaYJAZyHIfSpFgr2lENAGZdY7HBJ,fbPkOYLVPtPgIt0MxizjfFJov3JbHyAi,7,5,3,0,2,8,1,0,19,2.7142857142857144,1,0.0,0,3,0,2,5,8,0,1,0,5,14,1
5398,137384,EKfl5y1NkN1Xn8ASWOcqUOIlKCaC7Rgd,fbPkOYLVPtPgIt0MxizjfFJov3JbHyAi,1,0,0,0,0,0,1,0,1,0.14285714285714285,1,0.0,0,0,0,0,0,0,0,1,0,0,1,1
5399,137386,5XQirr9i0TWpiYbsECZzYQuaZyvNkBXn,fbPkOYLVPtPgIt0MxizjfFJov3JbHyAi,8,11,2,0,1,0,8,0,22,3.142857142857143,3,0.0,0,2,0,1,11,0,0,8,0,3,19,1
5400,137388,5FX74tSsqVOdvsPJFln5AHRuURmp41HT,fbPkOYLVPtPgIt0MxizjfFJov3JbHyAi,8,6,3,0,2,0,4,0,15,2.142857142857143,2,0.0,1,3,0,2,5,0,0,4,0,6,9,0
5401,137391,m6Zwht6K5r3XL6tnCyfbnnByGD7T5f2R,fbPkOYLVPtPgIt0MxizjfFJov3JbHyAi,5,2,1,0,1,0,2,0,6,0.8571428571428571,1,0.0,0,1,0,1,2,0,0,2,0,2,4,1
5402,137397,Qv1iNPNlhVNOmWMs92FkzrrHMbJaVyPk,fbPkOYLVPtPgIt0MxizjfFJov3JbHyAi,8,4,2,0,1,1,11,1,20,2.857142857142857,1,0.0,0,2,0,1,4,1,0,11,1,3,17,1
5403,137399,mqVpGUWCMkNcDZMRD2pJxKGV8oQAE2Qj,fbPkOYLVPtPgIt0MxizjfFJov3JbHyAi,8,4,3,0,2,0,4,0,13,1.8571428571428572,1,0.0,1,3,0,2,3,0,0,4,0,6,7,1
5404,137405,yLjINTUbScao5ufShTGxxbbMK1JbRcNK,fbPkOYLVPtPgIt0MxizjfFJov3JbHyAi,7,6,2,0,3,0,3,0,14,2.0,1,0.0,2,2,0,3,4,0,0,3,0,7,7,1
5405,137406,e4YalnUrFKcUfgQELCwKNGRSXvIfj3rn,fbPkOYLVPtPgIt0MxizjfFJov3JbHyAi,2,0,0,0,0,0,3,0,3,0.42857142857142855,1,0.0,0,0,0,0,0,0,0,3,0,0,3,1
5406,137407,xeJgmT2GlcKPs7xiwWbHClhY602CtyUx,fbPkOYLVPtPgIt0MxizjfFJov3JbHyAi,5,1,1,0,1,0,2,0,5,0.7142857142857143,1,0.0,0,1,0,1,1,0,0,2,0,2,3,1
5407,137408,7ZpK2Qdkfg6qjiDNvxUiqNClV9f1rdSE,fbPkOYLVPtPgIt0MxizjfFJov3JbHyAi,8,4,3,0,3,6,3,1,20,2.857142857142857,1,0.0,0,3,0,3,4,6,0,3,1,6,14,1
5408,137410,cp3YBtv3LBPQsC9KSWwASci6TDzE2JIe,fbPkOYLVPtPgIt0MxizjfFJov3JbHyAi,1,0,0,0,0,0,1,0,1,0.14285714285714285,1,0.0,0,0,0,0,0,0,0,1,0,0,1,1
5409,137411,RDChRApYRv6Sfe9dw6iFymmd1hK0JhGY,fbPkOYLVPtPgIt0MxizjfFJov3JbHyAi,1,0,0,0,0,0,1,0,1,0.14285714285714285,1,0.0,0,0,0,0,0,0,0,1,0,0,1,1
5410,137412,qZpXWzENd8vPQkANcwupj0acfmacGtsr,fbPkOYLVPtPgIt0MxizjfFJov3JbHyAi,16,9,8,0,8,0,1,0,26,3.7142857142857144,1,0.0,0,8,0,8,9,0,0,1,0,16,10,1
5411,137414,DTvfa3fS3ROp7pjogLjRtY4RzKRlF9Cy,fbPkOYLVPtPgIt0MxizjfFJov3JbHyAi,6,8,1,0,2,0,5,0,16,2.2857142857142856,1,0.0,3,1,0,2,5,0,0,5,0,6,10,1
5412,137415,zs8AbWxu3oihhi0RdSLs1xmLXXgmhkzY,fbPkOYLVPtPgIt0MxizjfFJov3JbHyAi,23,47,2,20,6,20,9,2,106,15.142857142857142,2,0.0,29,2,18,6,18,20,2,9,2,55,51,1
5413,137417,bCFz6hqpGZgCTv9FmzDlmLq86tdtyvtb,fbPkOYLVPtPgIt0MxizjfFJov3JbHyAi,6,4,1,0,1,2,3,0,11,1.5714285714285714,1,0.0,0,1,0,1,4,2,0,3,0,2,9,1
5414,137418,y71lRBqIdu5iPiLn9Yi5PQm6GFIvgLwB,fbPkOYLVPtPgIt0MxizjfFJov3JbHyAi,5,4,2,0,1,4,2,0,13,1.8571428571428572,1,0.0,0,2,0,1,4,4,0,2,0,3,10,1
5415,137420,vuqFPhnjwQKBPhmOAdfWdPVUnftTeBnB,fbPkOYLVPtPgIt0MxizjfFJov3JbHyAi,5,2,1,0,1,0,3,0,7,1.0,1,0.0,0,1,0,1,2,0,0,3,0,2,5,1
5416,137421,3y3fLWnaqy4gjWzUuftSoOxerFuYM9Ss,fbPkOYLVPtPgIt0MxizjfFJov3JbHyAi,7,4,2,0,2,0,2,0,10,1.4285714285714286,1,0.0,0,2,0,2,4,0,0,2,0,4,6,1
5417,137427,g5cfvDvYqz1BC4LMGanzPaVPPBmwbapa,fbPkOYLVPtPgIt0MxizjfFJov3JbHyAi,33,24,19,0,16,4,9,0,72,10.285714285714286,3,0.0,2,19,0,16,22,4,0,9,0,37,35,0
5418,137429,JdJ1SwT93OWgPbpS5GdJzD3RLASaE4SR,fbPkOYLVPtPgIt0MxizjfFJov3JbHyAi,6,6,2,0,2,1,1,0,12,1.7142857142857142,1,0.0,1,2,0,2,5,1,0,1,0,5,7,1
5419,137431,c9KdNBnieysx6xfzwOvt0c21meENYGDu,fbPkOYLVPtPgIt0MxizjfFJov3JbHyAi,1,0,0,0,0,0,4,0,4,0.5714285714285714,1,0.0,0,0,0,0,0,0,0,4,0,0,4,1
5420,137434,ibNm0O3c3f87o7PAtnGdJbl2Dgr9gb8M,fbPkOYLVPtPgIt0MxizjfFJov3JbHyAi,13,9,4,0,4,1,7,1,26,3.7142857142857144,1,0.0,0,4,0,4,9,1,0,7,1,8,18,1
5421,137438,fE8AsLCA0TCwN2lFIpEAgt949Oz2zi2M,fbPkOYLVPtPgIt0MxizjfFJov3JbHyAi,5,6,1,0,1,0,2,0,10,1.4285714285714286,1,0.0,4,1,0,1,2,0,0,2,0,6,4,1
5422,137440,zHooznrj1lbipo0SwGxaARgac1BP3h4H,fbPkOYLVPtPgIt0MxizjfFJov3JbHyAi,37,75,32,48,15,5,13,0,188,26.857142857142858,3,0.0,19,32,42,15,56,5,6,13,0,108,80,1
5423,137443,HHjw6PARN0UbkiffbOwvG4RULtVIyY0R,fbPkOYLVPtPgIt0MxizjfFJov3JbHyAi,9,7,5,0,4,14,3,0,33,4.714285714285714,1,0.0,0,5,0,4,7,14,0,3,0,9,24,1
5424,137446,qqhQVv0ytFz6QcrUJzKAl8hETJ9ZzkHe,fbPkOYLVPtPgIt0MxizjfFJov3JbHyAi,6,3,2,0,2,0,1,0,8,1.1428571428571428,1,0.0,0,2,0,2,3,0,0,1,0,4,4,1
5425,137449,NRHQ3tSUEv4DHf8jZg8RV7YWaKkLB0Yk,fbPkOYLVPtPgIt0MxizjfFJov3JbHyAi,7,3,1,0,1,0,9,0,14,2.0,1,0.0,0,1,0,1,3,0,0,9,0,2,12,1
5426,137451,aIezEPAtj2Pok0cm2TtbLS3CmQjoEYqT,fbPkOYLVPtPgIt0MxizjfFJov3JbHyAi,2,0,0,0,0,0,4,0,4,0.5714285714285714,1,0.0,0,0,0,0,0,0,0,4,0,0,4,1
5427,137453,gSg4PIaWl0hBhOgVlpN9o8YrQn4pTOeq,fbPkOYLVPtPgIt0MxizjfFJov3JbHyAi,9,12,7,0,2,1,4,0,26,3.7142857142857144,1,0.0,1,7,0,2,11,1,0,4,0,10,16,1
5428,138176,dFJ5slXqGymdZnNlAUvtsyJDritH7dGq,7GRhBDsirIGkRZBtSMEzNTyDr2JQm4xx,9,24,1,14,0,2,1,0,42,6.0,1,0.0,18,1,14,0,6,2,0,1,0,33,9,1
5429,138204,oanYJczRVsQsFyE3TEwPYW17rzmwBQIL,7GRhBDsirIGkRZBtSMEzNTyDr2JQm4xx,5,4,1,0,1,0,1,0,7,1.0,1,0.0,0,1,0,1,4,0,0,1,0,2,5,1
5430,138214,adfbW7xBPY784GRXAIq3fInFogIbD6ro,7GRhBDsirIGkRZBtSMEzNTyDr2JQm4xx,24,34,13,32,0,0,2,0,81,11.571428571428571,2,0.0,19,13,29,0,15,0,3,2,0,61,20,0
5431,138239,JEJrnVrKGVjrX2yiet4Z0AOP8Myw4oGI,7GRhBDsirIGkRZBtSMEzNTyDr2JQm4xx,1,0,0,0,0,0,1,0,1,0.14285714285714285,1,0.0,0,0,0,0,0,0,0,1,0,0,1,1
5432,138243,DKNUSy56RJeSuYO3Dp6WYMwUBdoAcQ0a,7GRhBDsirIGkRZBtSMEzNTyDr2JQm4xx,5,2,1,0,1,0,3,0,7,1.0,2,0.0,0,1,0,1,2,0,0,3,0,2,5,1
5433,138250,szmVnhPypUPoSdN8Z8D02a6M8Gjrnwmf,A3fsA9Zfv1X2fVEQhTw51lKENdNrEqT3,63,38,27,162,19,0,5,0,251,35.857142857142854,4,0.0,4,27,136,19,34,0,26,5,0,186,65,1
5434,138261,JL9rcevmVnCXKLKkXE87B1mrZmlYAcd1,SpATywNh6bZuzm8s1ceuBUnMUAeoAHHw,17,33,15,16,5,48,18,1,136,19.428571428571427,4,0.0,9,15,13,5,24,48,3,18,1,42,94,0
5435,138287,UJP97i2EJO4yjxI3DoA9AGA9qgzPRSeL,SpATywNh6bZuzm8s1ceuBUnMUAeoAHHw,10,15,3,5,0,0,7,8,38,5.428571428571429,3,0.0,0,3,5,0,15,0,0,7,8,8,30,0
5436,138385,R6r85AVni0tNGUvDSXb5ztmJaVo4FSr1,G8EPVSXsOYB5YQWZGiz1aVq5Pgr2GrQu,14,10,1,12,2,0,3,0,28,4.0,1,0.0,7,1,6,2,3,0,6,3,0,16,12,0
5437,138392,U1Nl2HcAAPdRP1Sw1krEueSkSr1F7plD,7GRhBDsirIGkRZBtSMEzNTyDr2JQm4xx,21,28,17,0,12,1,10,1,69,9.857142857142858,2,0.0,1,17,0,12,27,1,0,10,1,30,39,1
5438,138411,MF5edVvM6lCZDxnMdHelos9TUh3KERjn,G8EPVSXsOYB5YQWZGiz1aVq5Pgr2GrQu,1,0,0,0,0,0,1,0,1,0.14285714285714285,1,0.0,0,0,0,0,0,0,0,1,0,0,1,1
5439,138422,PBT0xI17u81InQO08yLXpu6kSLQPC6l6,SpATywNh6bZuzm8s1ceuBUnMUAeoAHHw,23,33,3,36,1,2,13,0,88,12.571428571428571,5,0.0,7,3,29,1,26,2,7,13,0,40,48,0
5440,138491,NXEwBXbU6vvce77sujWgRB6LivhFJvRb,7GRhBDsirIGkRZBtSMEzNTyDr2JQm4xx,6,6,3,0,1,0,4,0,14,2.0,3,0.0,0,3,0,1,6,0,0,4,0,4,10,1
5441,138496,mSXZKJ9e3RCTXopgrFUphpxYgeKp7tlG,SpATywNh6bZuzm8s1ceuBUnMUAeoAHHw,17,19,8,8,3,1,6,1,46,6.571428571428571,2,0.0,8,8,8,3,11,1,0,6,1,27,19,0
5442,138518,SVfMOf78rQIhc5bUdZbaTCmOKKmn1NJW,7GRhBDsirIGkRZBtSMEzNTyDr2JQm4xx,1,0,0,0,0,0,1,0,1,0.14285714285714285,1,0.0,0,0,0,0,0,0,0,1,0,0,1,1
5443,138554,Px8gWLqn4P0S59C09B0pkBi24hj9iKEG,7GRhBDsirIGkRZBtSMEzNTyDr2JQm4xx,13,14,5,1,2,0,16,0,38,5.428571428571429,4,0.0,4,5,1,2,10,0,0,16,0,12,26,1
5444,138602,TlFcqTzRzzK0wdjPXKgY6Grw7xbgRspB,7GRhBDsirIGkRZBtSMEzNTyDr2JQm4xx,1,0,0,0,0,0,1,0,1,0.14285714285714285,1,0.0,0,0,0,0,0,0,0,1,0,0,1,1
5445,138613,ONe4iInwtHkZ5gtlbWN831JopVHbaD8L,G8EPVSXsOYB5YQWZGiz1aVq5Pgr2GrQu,2,0,0,0,0,0,2,0,2,0.2857142857142857,1,0.0,0,0,0,0,0,0,0,2,0,0,2,1
5446,138643,QiZHycbjNbbRnz73j2CxBu0cfmT0MxFq,7GRhBDsirIGkRZBtSMEzNTyDr2JQm4xx,2,0,0,0,0,0,2,0,2,0.2857142857142857,1,0.0,0,0,0,0,0,0,0,2,0,0,2,1
5447,138644,klFfeIWt13kJyzZ8QBX8igiJe3NNykgD,SpATywNh6bZuzm8s1ceuBUnMUAeoAHHw,11,22,11,18,3,9,3,0,66,9.428571428571429,3,0.0,7,11,15,3,15,9,3,3,0,36,30,1
5448,138800,OhEerYX6jubgMlujry1FJzH6tFAkAkV2,7GRhBDsirIGkRZBtSMEzNTyDr2JQm4xx,7,4,1,0,0,3,4,1,13,1.8571428571428572,1,0.0,0,1,0,0,4,3,0,4,1,1,12,1
5449,138818,okqN4nBVKRYYrkYonKicKGOmPqVGYjZh,RXDvfPUBYFlVdlueBFbLW0mhhAyGEqpt,7,11,4,0,0,0,13,0,28,4.0,3,0.0,0,4,0,0,11,0,0,13,0,4,24,0
5450,138839,AYb0mQx5aj7cvHvgDba3CV4jlkuCTKMg,7GRhBDsirIGkRZBtSMEzNTyDr2JQm4xx,4,2,0,0,0,0,2,0,4,0.5714285714285714,1,0.0,0,0,0,0,2,0,0,2,0,0,4,1
5451,138865,AYiGvgKDaGiBpYEcJ7Espvi6dQy2aiFd,SpATywNh6bZuzm8s1ceuBUnMUAeoAHHw,12,39,4,10,0,2,4,1,60,8.571428571428571,3,0.0,13,4,10,0,26,2,0,4,1,27,33,0
5452,138900,bHqXWqN9pt89j5bH9fnt5jMZVOQZImRj,7GRhBDsirIGkRZBtSMEzNTyDr2JQm4xx,1,0,0,0,0,0,1,0,1,0.14285714285714285,1,0.0,0,0,0,0,0,0,0,1,0,0,1,1
5453,138947,2Ueq99WOxFkvLjKvdAbi1TRY9isnfhGR,SpATywNh6bZuzm8s1ceuBUnMUAeoAHHw,8,6,4,0,3,2,3,0,18,2.5714285714285716,2,0.0,2,4,0,3,4,2,0,3,0,9,9,1
5454,138957,LDYjWqhrIxv22jlLe9In731UT9Ne6fvw,SpATywNh6bZuzm8s1ceuBUnMUAeoAHHw,26,17,9,15,7,3,19,0,70,10.0,6,0.0,5,9,15,7,12,3,0,19,0,36,34,1
5455,138974,ouL32O71NoAWgx7epnnVebKIsbBDnj9P,SpATywNh6bZuzm8s1ceuBUnMUAeoAHHw,17,34,14,19,9,50,18,4,148,21.142857142857142,2,0.0,9,14,15,9,25,50,4,18,4,47,101,0
5456,139004,aKtqxPEfMnVhEPAMX3aHrnYTfbYN9i8f,A3fsA9Zfv1X2fVEQhTw51lKENdNrEqT3,6,3,0,0,0,3,5,0,11,1.5714285714285714,1,0.0,0,0,0,0,3,3,0,5,0,0,11,1
5457,139006,3wXMZkXBm1ATxVfwmh0YqzBsBRzhFw8P,SpATywNh6bZuzm8s1ceuBUnMUAeoAHHw,18,20,11,16,4,0,12,1,64,9.142857142857142,2,0.0,6,11,14,4,14,0,2,12,1,35,29,0
5458,139081,AUQbcN6sP8jOc3r7pDcomR6R8baoxLvG,RXDvfPUBYFlVdlueBFbLW0mhhAyGEqpt,51,89,56,151,23,10,20,2,351,50.142857142857146,4,0.0,22,56,137,23,67,10,14,20,2,238,113,0
5459,139085,heVJWbQBtCN8obfXQBAbcR0I5MnOvCPs,G8EPVSXsOYB5YQWZGiz1aVq5Pgr2GrQu,61,116,39,116,24,11,31,7,344,49.142857142857146,6,0.0,45,39,83,24,71,11,33,31,7,191,153,0
5460,139134,tS8frxV0M3TGWaoIiOl49ThYexkN4UpR,7GRhBDsirIGkRZBtSMEzNTyDr2JQm4xx,8,14,5,0,3,0,5,0,27,3.857142857142857,2,0.0,0,5,0,3,14,0,0,5,0,8,19,1
5461,139241,mR38LOzPkDgy4Z7CZO92yHt4TSlNwfzC,A3fsA9Zfv1X2fVEQhTw51lKENdNrEqT3,1,0,0,0,0,0,2,0,2,0.2857142857142857,1,0.0,0,0,0,0,0,0,0,2,0,0,2,1
5462,139243,St6usTSSgX5U9v7wchuMWqmBKoCcDwN2,7GRhBDsirIGkRZBtSMEzNTyDr2JQm4xx,2,0,0,0,0,0,2,0,2,0.2857142857142857,1,0.0,0,0,0,0,0,0,0,2,0,0,2,1
5463,139312,vlarE7zCdES78rsfbZ9s0PTdwVr1rAk4,A3fsA9Zfv1X2fVEQhTw51lKENdNrEqT3,12,20,1,0,0,1,8,3,33,4.714285714285714,2,0.0,0,1,0,0,20,1,0,8,3,1,32,1
5464,139354,QXg7RHDSlJliIBbIO3xqJ8cmekKDZLIJ,7GRhBDsirIGkRZBtSMEzNTyDr2JQm4xx,8,9,5,0,0,0,4,0,18,2.5714285714285716,1,0.0,1,5,0,0,8,0,0,4,0,6,12,1
5465,139391,iLtON4OdzeG1y617iqhiryM9G4xoGAr5,SpATywNh6bZuzm8s1ceuBUnMUAeoAHHw,21,59,18,75,3,33,27,4,219,31.285714285714285,3,0.0,32,18,66,3,27,33,9,27,4,119,100,0
5466,139479,cDV3uv01OqR28HAw8WapmztMslx9jbkZ,A3fsA9Zfv1X2fVEQhTw51lKENdNrEqT3,4,4,1,0,0,0,3,0,8,1.1428571428571428,2,0.0,0,1,0,0,4,0,0,3,0,1,7,1
5467,139497,CQdAGcIvDdIBklDWFKtch5fpBdl4NTjN,SpATywNh6bZuzm8s1ceuBUnMUAeoAHHw,17,25,12,18,4,0,5,1,65,9.285714285714286,1,0.0,10,12,14,4,15,0,4,5,1,40,25,1
5468,139575,j4fKJGSFGeDK8KfTLiburPdJXY2cNIyf,7GRhBDsirIGkRZBtSMEzNTyDr2JQm4xx,5,2,1,0,1,0,2,0,6,0.8571428571428571,1,0.0,0,1,0,1,2,0,0,2,0,2,4,1
5469,139625,NHjxa47feJ9sWQnmg6HoO6L78eHIRwnl,7GRhBDsirIGkRZBtSMEzNTyDr2JQm4xx,1,0,0,0,0,0,2,0,2,0.2857142857142857,1,0.0,0,0,0,0,0,0,0,2,0,0,2,0
5470,139640,S33lH053HmB7Cz0IWipiL27cwx1QXBWr,7GRhBDsirIGkRZBtSMEzNTyDr2JQm4xx,3,2,0,0,0,0,1,0,3,0.42857142857142855,1,0.0,0,0,0,0,2,0,0,1,0,0,3,1
5471,139657,eC4StSuQwImpW962lXYQQlRlP4Dxmsjm,7GRhBDsirIGkRZBtSMEzNTyDr2JQm4xx,2,0,0,0,0,0,2,0,2,0.2857142857142857,1,0.0,0,0,0,0,0,0,0,2,0,0,2,1
5472,139701,bDbKEMrZzcFQTQT7Qrji0QYF25s6ADsY,7GRhBDsirIGkRZBtSMEzNTyDr2JQm4xx,1,0,0,0,0,0,1,0,1,0.14285714285714285,1,0.0,0,0,0,0,0,0,0,1,0,0,1,1
5473,140333,bqWpav7ocOhCfb3xc4QgAvBDK5g8BmiZ,7GRhBDsirIGkRZBtSMEzNTyDr2JQm4xx,30,40,18,32,14,0,7,0,111,15.857142857142858,3,0.0,16,18,27,14,24,0,5,7,0,75,36,1
5474,140338,vixag6bpwzwtdrSKIAHFpP8XohE3IVGO,7GRhBDsirIGkRZBtSMEzNTyDr2JQm4xx,36,81,32,78,13,41,21,0,266,38.0,3,0.0,21,32,65,13,60,41,13,21,0,131,135,0
5475,140362,DpqUZKEZpIFvZzvEXk8oaJMRAbEfypNN,7GRhBDsirIGkRZBtSMEzNTyDr2JQm4xx,18,11,8,0,9,0,6,0,34,4.857142857142857,2,0.0,3,8,0,9,8,0,0,6,0,20,14,1
5476,140606,RthO8kTkOrnZ3vUDn574hHyfG3vroBt1,7GRhBDsirIGkRZBtSMEzNTyDr2JQm4xx,10,15,9,0,4,0,8,0,36,5.142857142857143,1,0.0,2,9,0,4,13,0,0,8,0,15,21,0
5477,143586,o2z1lYhmt3dNuWADVCZXyE0sw3eHFzWq,G8EPVSXsOYB5YQWZGiz1aVq5Pgr2GrQu,12,3,2,6,1,1,6,1,20,2.857142857142857,1,0.0,0,2,5,1,3,1,1,6,1,8,12,1
5478,143589,z7uFh58nBoces7c1gc4iOr2l4NXGSjok,SpATywNh6bZuzm8s1ceuBUnMUAeoAHHw,11,14,6,13,0,0,8,0,41,5.857142857142857,1,0.0,4,6,13,0,10,0,0,8,0,23,18,0
5479,143599,43nq30xhRsgmZVAWkH8Zjb7IyZDGRDeY,A3fsA9Zfv1X2fVEQhTw51lKENdNrEqT3,6,4,1,0,0,0,3,0,8,1.1428571428571428,1,0.0,0,1,0,0,4,0,0,3,0,1,7,1
5480,143601,tXegIvrCsh9OUalSxRPl6DBhe0HWN5J1,bWdj2GDclj5ofokWjzoa5jAwMkxCykd6,4,2,0,0,0,0,4,0,6,0.8571428571428571,1,0.0,0,0,0,0,2,0,0,4,0,0,6,1
5481,143612,MKvKDEIiF4MpIyn9vn0Yw7gT3feDOAo3,bWdj2GDclj5ofokWjzoa5jAwMkxCykd6,3,2,0,0,0,0,1,0,3,0.42857142857142855,1,0.0,0,0,0,0,2,0,0,1,0,0,3,1
5482,143618,SAdK4BrTbltHilVBy10zBoad8iM8mXa4,G8EPVSXsOYB5YQWZGiz1aVq5Pgr2GrQu,12,19,10,0,10,12,9,0,60,8.571428571428571,1,0.0,2,10,0,10,17,12,0,9,0,22,38,0
5483,143632,BFi14w12zqsNleSplrknYhvmJy8GL2FY,bWdj2GDclj5ofokWjzoa5jAwMkxCykd6,18,27,8,44,5,0,5,0,89,12.714285714285714,2,0.0,9,8,37,5,18,0,7,5,0,59,30,1
5484,143636,HwdB7Xtsh4qUznoQGIINfFO0z6SlgPWN,G8EPVSXsOYB5YQWZGiz1aVq5Pgr2GrQu,7,3,2,0,1,0,4,0,10,1.4285714285714286,1,0.0,0,2,0,1,3,0,0,4,0,3,7,1
5485,143646,BQAHxDKbPTX2OmvOEbIJrtNWABd3lWzF,G8EPVSXsOYB5YQWZGiz1aVq5Pgr2GrQu,80,97,26,198,15,9,21,2,368,52.57142857142857,3,0.0,54,26,147,15,43,9,51,21,2,242,126,1
5486,143658,qCIGCxbEF5IZjc2KbYsE1TkH5yxiGth5,SpATywNh6bZuzm8s1ceuBUnMUAeoAHHw,15,27,2,12,1,1,12,0,55,7.857142857142857,5,0.0,8,2,11,1,19,1,1,12,0,22,33,1
5487,143662,rZhamd6VgzDuUbGwNlJUwteIExfrDmL0,SpATywNh6bZuzm8s1ceuBUnMUAeoAHHw,13,17,13,6,9,0,3,0,48,6.857142857142857,1,0.0,2,13,6,9,15,0,0,3,0,30,18,1
5488,143663,DtdInjZr4k2oFve3KkbkHNxJxR1ugIKn,SpATywNh6bZuzm8s1ceuBUnMUAeoAHHw,9,5,1,0,1,2,8,2,19,2.7142857142857144,2,0.0,1,1,0,1,4,2,0,8,2,3,16,1
5489,143674,7lzEjeizq2WryXPCFV63iiJ0sRC0XsD5,A3fsA9Zfv1X2fVEQhTw51lKENdNrEqT3,3,2,0,0,0,0,1,0,3,0.42857142857142855,1,0.0,0,0,0,0,2,0,0,1,0,0,3,1
5490,143678,P1PW7aZzx8NF90gRnrYjkf5ZxxKRlBng,SpATywNh6bZuzm8s1ceuBUnMUAeoAHHw,25,83,45,32,10,75,50,10,305,43.57142857142857,4,0.0,13,45,26,10,70,75,6,50,10,94,211,1
5491,143685,s2CLgeYgKwvHdG0n6HyjEsmd9rHYgz53,RXDvfPUBYFlVdlueBFbLW0mhhAyGEqpt,45,42,17,109,9,10,9,2,198,28.285714285714285,3,0.0,11,17,102,9,31,10,7,9,2,139,59,1
5492,143686,xhoMHYDn0DYj6NEexX867ukahPmWhSwf,bWdj2GDclj5ofokWjzoa5jAwMkxCykd6,14,16,8,0,7,0,6,0,37,5.285714285714286,2,0.0,5,8,0,7,11,0,0,6,0,20,17,1
5493,143701,BCr2GOpOyeEKOuzlRV7PJCL1CEnRyr6Q,G8EPVSXsOYB5YQWZGiz1aVq5Pgr2GrQu,19,18,12,0,9,0,8,1,48,6.857142857142857,3,0.0,3,12,0,9,15,0,0,8,1,24,24,1
5494,143729,YITGGXKhxzNHdElox232lzcaZdJ61YFn,G8EPVSXsOYB5YQWZGiz1aVq5Pgr2GrQu,8,8,2,0,2,0,3,0,15,2.142857142857143,2,0.0,0,2,0,2,8,0,0,3,0,4,11,1
5495,143753,BFi14w12zqsNleSplrknYhvmJy8GL2FY,SpATywNh6bZuzm8s1ceuBUnMUAeoAHHw,6,10,3,0,1,0,2,0,16,2.2857142857142856,2,0.0,4,3,0,1,6,0,0,2,0,8,8,1
5496,143757,CNd98TtnFYCKW8sIKXbo0EVDlFn0r29F,SpATywNh6bZuzm8s1ceuBUnMUAeoAHHw,14,14,7,12,3,1,5,0,42,6.0,2,0.0,2,7,10,3,12,1,2,5,0,22,20,1
5497,143759,qjm8uLcDpLtNxtPMuyI6LdPbp6n70fuZ,bWdj2GDclj5ofokWjzoa5jAwMkxCykd6,6,2,1,0,0,0,4,1,8,1.1428571428571428,1,0.0,0,1,0,0,2,0,0,4,1,1,7,1
5498,143765,UI53aostODbFE1SZneA6yZKpOYnaewLS,G8EPVSXsOYB5YQWZGiz1aVq5Pgr2GrQu,19,8,7,20,6,0,2,0,43,6.142857142857143,1,0.0,0,7,15,6,8,0,5,2,0,28,15,1
5499,143775,kJR7SORW78mX9yl9TvMAdIrYcwnnZz4r,RXDvfPUBYFlVdlueBFbLW0mhhAyGEqpt,2,0,0,0,0,0,2,0,2,0.2857142857142857,1,0.0,0,0,0,0,0,0,0,2,0,0,2,1
5500,143785,OStdVLf6yEEZ6snmnFowdmcaKWpdnJbL,RXDvfPUBYFlVdlueBFbLW0mhhAyGEqpt,1,0,0,0,0,0,1,0,1,0.14285714285714285,1,0.0,0,0,0,0,0,0,0,1,0,0,1,1
5501,143812,ee58foeX64HQVEJT3urOlMI7BjSHbs8j,SpATywNh6bZuzm8s1ceuBUnMUAeoAHHw,15,20,1,12,0,0,14,3,50,7.142857142857143,4,0.0,5,1,11,0,15,0,1,14,3,17,33,1
5502,143813,GJGZOa9ckBlFcfojmDXHYkGGywyzKOaN,SpATywNh6bZuzm8s1ceuBUnMUAeoAHHw,21,30,0,36,0,51,25,6,148,21.142857142857142,4,0.0,15,0,33,0,15,51,3,25,6,48,100,1
5503,143822,kfS0nefl4PODD2Wbg3xDtahejAoyK8Co,RXDvfPUBYFlVdlueBFbLW0mhhAyGEqpt,47,31,18,81,12,31,7,1,181,25.857142857142858,2,0.0,9,18,74,12,22,31,7,7,1,113,68,0
5504,143829,wBxOvXavxcvDHQtsCbkdt1VRzmB8Qh9E,A3fsA9Zfv1X2fVEQhTw51lKENdNrEqT3,1,0,0,0,0,0,1,0,1,0.14285714285714285,1,0.0,0,0,0,0,0,0,0,1,0,0,1,1
5505,143836,GmLQtlg8yrQT4o49Mau9FkoR2KxlaFCK,A3fsA9Zfv1X2fVEQhTw51lKENdNrEqT3,3,0,0,0,0,1,5,0,6,0.8571428571428571,1,0.0,0,0,0,0,0,1,0,5,0,0,6,1
5506,143845,JlEwtKnXvqCWlVkvWLsPOkSZfN8DgLlO,SpATywNh6bZuzm8s1ceuBUnMUAeoAHHw,8,9,3,0,1,0,3,0,16,2.2857142857142856,1,0.0,1,3,0,1,8,0,0,3,0,5,11,1
5507,143846,i0sekElajxS5N9A9gI4ciPHJzCFHyEzA,SpATywNh6bZuzm8s1ceuBUnMUAeoAHHw,7,4,2,0,2,0,1,0,9,1.2857142857142858,1,0.0,0,2,0,2,4,0,0,1,0,4,5,1
5508,143852,6pc1PztS8sMKmk9TBeVVlDzbAlFBojkU,bWdj2GDclj5ofokWjzoa5jAwMkxCykd6,4,2,1,0,1,0,1,0,5,0.7142857142857143,1,0.0,0,1,0,1,2,0,0,1,0,2,3,1
5509,143871,i0Fe8GkgETgJLYZf4oG1MMDT0SsDr0Jw,bWdj2GDclj5ofokWjzoa5jAwMkxCykd6,8,8,4,0,2,0,3,0,17,2.4285714285714284,3,0.0,0,4,0,2,8,0,0,3,0,6,11,1
5510,143878,OMrkn9SYYoJHeW009nGi3tN8klhPSmaY,G8EPVSXsOYB5YQWZGiz1aVq5Pgr2GrQu,1,0,0,0,0,0,1,0,1,0.14285714285714285,1,0.0,0,0,0,0,0,0,0,1,0,0,1,1
5511,143885,ix15aF6FOEF1waZCSZt01VrPOuPGJ3yM,A3fsA9Zfv1X2fVEQhTw51lKENdNrEqT3,17,21,1,10,1,1,2,0,36,5.142857142857143,2,0.0,0,1,10,1,21,1,0,2,0,12,24,1
5512,143903,Vd6Fw7jRvBeu91l91UPCADQJMohO1ulC,SpATywNh6bZuzm8s1ceuBUnMUAeoAHHw,13,18,1,16,1,5,7,0,48,6.857142857142857,4,0.0,5,1,13,1,13,5,3,7,0,20,28,0
5513,143914,qDW8D89X9oTRJFDDcQZTLb3PUIxnDi04,A3fsA9Zfv1X2fVEQhTw51lKENdNrEqT3,7,4,1,0,1,0,2,0,8,1.1428571428571428,1,0.0,0,1,0,1,4,0,0,2,0,2,6,1
5514,143916,YGuMlMRO0oSJvGD54x9bLYiGJQjDsQL5,G8EPVSXsOYB5YQWZGiz1aVq5Pgr2GrQu,7,8,1,6,0,3,3,0,21,3.0,1,0.0,6,1,3,0,2,3,3,3,0,10,11,1
5515,143919,0Wa2kEuzurHwd29qlJEDljKGNBFtcml7,G8EPVSXsOYB5YQWZGiz1aVq5Pgr2GrQu,6,1,1,0,1,0,3,0,6,0.8571428571428571,1,0.0,0,1,0,1,1,0,0,3,0,2,4,1
5516,143922,kjGwgryJuZFnPYPKqBQ3NNskwkNfGn3d,A3fsA9Zfv1X2fVEQhTw51lKENdNrEqT3,1,0,0,0,0,0,2,0,2,0.2857142857142857,1,0.0,0,0,0,0,0,0,0,2,0,0,2,1
5517,143926,kjGwgryJuZFnPYPKqBQ3NNskwkNfGn3d,bWdj2GDclj5ofokWjzoa5jAwMkxCykd6,7,2,0,0,0,7,6,1,16,2.2857142857142856,1,0.0,0,0,0,0,2,7,0,6,1,0,16,1
5518,143942,kS57PN5w4M8SePVOR15O2soQi4RHoCPq,SpATywNh6bZuzm8s1ceuBUnMUAeoAHHw,14,20,6,20,3,0,1,0,50,7.142857142857143,1,0.0,7,6,19,3,13,0,1,1,0,35,15,0
5519,143954,8jktIbkTyfsrxSTzXB9djfwFIqhVk9sD,G8EPVSXsOYB5YQWZGiz1aVq5Pgr2GrQu,11,8,1,0,1,0,5,0,15,2.142857142857143,1,0.0,0,1,0,1,8,0,0,5,0,2,13,1
5520,143962,xqtF7kz0ECRMGC9cksHZcAo5S9h7Xs8O,A3fsA9Zfv1X2fVEQhTw51lKENdNrEqT3,3,3,2,0,0,0,1,0,6,0.8571428571428571,2,0.0,0,2,0,0,3,0,0,1,0,2,4,1
5521,143978,Bj8ATra8VoYTzA097NzbEns3tHpy9inW,SpATywNh6bZuzm8s1ceuBUnMUAeoAHHw,3,1,0,0,0,0,4,0,5,0.7142857142857143,2,0.0,0,0,0,0,1,0,0,4,0,0,5,1
5522,143985,VYyLsKD1rNE6IEMOVHtWy3gAcazZXSjf,SpATywNh6bZuzm8s1ceuBUnMUAeoAHHw,10,8,6,0,0,1,7,1,23,3.2857142857142856,1,0.0,0,6,0,0,8,1,0,7,1,6,17,1
5523,144002,ldTDPaSBa3R7vzg6xAgzmxomfcP7FtgG,G8EPVSXsOYB5YQWZGiz1aVq5Pgr2GrQu,7,3,0,0,0,0,4,1,8,1.1428571428571428,1,0.0,1,0,0,0,2,0,0,4,1,1,7,1
5524,144004,U62bUOUAMvRVibRWhVYvsfcC0FytLRv5,A3fsA9Zfv1X2fVEQhTw51lKENdNrEqT3,12,7,5,0,5,0,2,0,19,2.7142857142857144,2,0.0,0,5,0,5,7,0,0,2,0,10,9,1
5525,144031,LAQONTh6B8YO6fNJXryzQnYCV0hkbp2b,SpATywNh6bZuzm8s1ceuBUnMUAeoAHHw,15,21,12,8,4,0,7,0,52,7.428571428571429,3,0.0,5,12,7,4,16,0,1,7,0,28,24,1
5526,144074,JHhY30IKFzw4LWcyrHuTEglWNqRkqdDU,A3fsA9Zfv1X2fVEQhTw51lKENdNrEqT3,1,0,0,0,0,0,5,0,5,0.7142857142857143,1,0.0,0,0,0,0,0,0,0,5,0,0,5,1
5527,144077,0gS5Q732yxgOQo1BReYmVwLNG0PEmJtw,bWdj2GDclj5ofokWjzoa5jAwMkxCykd6,10,32,11,12,3,7,6,2,73,10.428571428571429,3,0.0,2,11,11,3,30,7,1,6,2,27,46,1
5528,144080,M8cV3FHZsXmaSmJz43zOWXbhj6ecftQ6,bWdj2GDclj5ofokWjzoa5jAwMkxCykd6,9,7,1,0,1,1,9,2,21,3.0,2,0.0,0,1,0,1,7,1,0,9,2,2,19,1
5529,144083,jVbyR2K2eRZglkuIyxRotkq1vJB87WuF,A3fsA9Zfv1X2fVEQhTw51lKENdNrEqT3,15,19,15,0,11,0,4,0,49,7.0,3,0.0,0,15,0,11,19,0,0,4,0,26,23,0
5530,144085,jVbyR2K2eRZglkuIyxRotkq1vJB87WuF,bWdj2GDclj5ofokWjzoa5jAwMkxCykd6,4,3,2,0,2,0,2,0,9,1.2857142857142858,2,0.0,0,2,0,2,3,0,0,2,0,4,5,1
5531,144106,Kky2aVSeER09Ccbe6jHNmsRuAd2julij,A3fsA9Zfv1X2fVEQhTw51lKENdNrEqT3,4,2,1,0,1,0,1,0,5,0.7142857142857143,1,0.0,0,1,0,1,2,0,0,1,0,2,3,1
5532,144110,ZkodedaetKv5naAeRDAkOlSxAXe0IboP,A3fsA9Zfv1X2fVEQhTw51lKENdNrEqT3,9,5,4,0,2,2,5,0,18,2.5714285714285716,1,0.0,0,4,0,2,5,2,0,5,0,6,12,1
5533,144123,VbTtM6XJ2ULINXtlzPV5CdmpUQ96Z4m1,A3fsA9Zfv1X2fVEQhTw51lKENdNrEqT3,2,0,0,0,0,0,2,0,2,0.2857142857142857,1,0.0,0,0,0,0,0,0,0,2,0,0,2,1
5534,144125,9T6sJuPiEkwFHn4VyREnKyR6Ni1hFol4,A3fsA9Zfv1X2fVEQhTw51lKENdNrEqT3,43,23,15,76,11,0,8,0,133,19.0,2,0.0,1,15,61,11,22,0,15,8,0,88,45,0
5535,144128,XFHjgUTOXGdMfDJPVsJ9fIgVszICPgyz,SpATywNh6bZuzm8s1ceuBUnMUAeoAHHw,4,2,0,0,0,0,2,0,4,0.5714285714285714,1,0.0,0,0,0,0,2,0,0,2,0,0,4,1
5536,144149,Q0aJXENLM8Ba7eSfqdpvheSc04S1CuaH,SpATywNh6bZuzm8s1ceuBUnMUAeoAHHw,2,0,0,0,0,0,2,0,2,0.2857142857142857,1,0.0,0,0,0,0,0,0,0,2,0,0,2,1
5537,144160,rukMFkuKsi65w6w0x0BTdkn9Ums9NFFL,RXDvfPUBYFlVdlueBFbLW0mhhAyGEqpt,8,3,2,0,1,1,6,1,14,2.0,2,0.0,0,2,0,1,3,1,0,6,1,3,11,1
5538,144164,OD1pqN8En0iNd52vQpaf4DwGLH3W4dof,SpATywNh6bZuzm8s1ceuBUnMUAeoAHHw,5,2,1,0,1,0,3,0,7,1.0,2,0.0,0,1,0,1,2,0,0,3,0,2,5,1
5539,144179,L1IQ56wH1SqkL7PACuNGk2Nkhk5s11JQ,SpATywNh6bZuzm8s1ceuBUnMUAeoAHHw,7,3,2,0,2,0,2,0,9,1.2857142857142858,1,0.0,0,2,0,2,3,0,0,2,0,4,5,1
5540,144183,ZG0u2uQ1GPj4pTtPSRFTX9ZynYPgcWTk,G8EPVSXsOYB5YQWZGiz1aVq5Pgr2GrQu,14,26,3,22,2,0,3,0,56,8.0,3,0.0,12,3,15,2,14,0,7,3,0,32,24,1
5541,144192,soXc1elBesZE0RSRAIRToGxlZRocKEhG,G8EPVSXsOYB5YQWZGiz1aVq5Pgr2GrQu,18,12,7,22,2,1,8,1,53,7.571428571428571,2,0.0,0,7,17,2,12,1,5,8,1,26,27,1
5542,144193,vSPx0Rg8IfOWpaATb7kkPj0mZPaLkdwk,RXDvfPUBYFlVdlueBFbLW0mhhAyGEqpt,3,2,0,0,0,0,1,0,3,0.42857142857142855,1,0.0,0,0,0,0,2,0,0,1,0,0,3,1
5543,144197,8eAVRzls7MGQwc3WaPP7ONmygmpXQE3K,A3fsA9Zfv1X2fVEQhTw51lKENdNrEqT3,7,5,3,0,2,0,1,0,11,1.5714285714285714,1,0.0,0,3,0,2,5,0,0,1,0,5,6,1
5544,144202,CLjs31mL2a4HrNzVlnTt15ZnHVg4guKy,bWdj2GDclj5ofokWjzoa5jAwMkxCykd6,5,3,1,0,1,0,3,0,8,1.1428571428571428,2,0.0,1,1,0,1,2,0,0,3,0,3,5,1
5545,144207,q8Ghyemwk98Z0FJ5i93VufZPwN70TN9G,G8EPVSXsOYB5YQWZGiz1aVq5Pgr2GrQu,2,0,0,0,0,0,2,0,2,0.2857142857142857,1,0.0,0,0,0,0,0,0,0,2,0,0,2,1
5546,144221,KkSinTdG2PbGrJIRATMZos8HES46UawO,bWdj2GDclj5ofokWjzoa5jAwMkxCykd6,9,39,8,0,7,0,5,0,59,8.428571428571429,2,0.0,13,8,0,7,26,0,0,5,0,28,31,0
5547,144226,KkSinTdG2PbGrJIRATMZos8HES46UawO,A3fsA9Zfv1X2fVEQhTw51lKENdNrEqT3,21,33,15,0,12,2,4,1,67,9.571428571428571,2,0.0,0,15,0,12,33,2,0,4,1,27,40,0
5548,144228,tLK4qfNEt0O7kdBEQmDtMwddSX278qz9,SpATywNh6bZuzm8s1ceuBUnMUAeoAHHw,2,0,0,0,0,0,2,0,2,0.2857142857142857,1,0.0,0,0,0,0,0,0,0,2,0,0,2,1
5549,144239,YCrhaujUJb2ysdJEAlnTFggfP634EwtZ,A3fsA9Zfv1X2fVEQhTw51lKENdNrEqT3,1,0,0,0,0,0,1,0,1,0.14285714285714285,1,0.0,0,0,0,0,0,0,0,1,0,0,1,1
5550,144242,asiNuyAOWs6SCiRYMsJjoOdnVeDfmCWA,A3fsA9Zfv1X2fVEQhTw51lKENdNrEqT3,7,3,0,0,0,1,8,0,12,1.7142857142857142,1,0.0,0,0,0,0,3,1,0,8,0,0,12,1
5551,144264,1La5rp9ZSz9cfpqCRJiC01Rwvuq5VVrf,A3fsA9Zfv1X2fVEQhTw51lKENdNrEqT3,13,7,4,6,3,0,4,0,24,3.4285714285714284,1,0.0,2,4,5,3,5,0,1,4,0,14,10,0
5552,144273,myIIBocNFelldmuN47bMrRiORGKDSj7S,A3fsA9Zfv1X2fVEQhTw51lKENdNrEqT3,8,4,3,0,3,0,1,0,11,1.5714285714285714,1,0.0,0,3,0,3,4,0,0,1,0,6,5,1
5553,144279,QGuKTIBC2KLaYpPdOnB4nXCWgxMM1Dog,A3fsA9Zfv1X2fVEQhTw51lKENdNrEqT3,8,4,3,0,3,0,1,0,11,1.5714285714285714,1,0.0,0,3,0,3,4,0,0,1,0,6,5,0
5554,144307,xzsDRI5lJyx0VDWOgYiu4gtqXBQyCAlZ,SpATywNh6bZuzm8s1ceuBUnMUAeoAHHw,5,2,1,0,1,0,2,0,6,0.8571428571428571,1,0.0,0,1,0,1,2,0,0,2,0,2,4,1
5555,144321,l9yVkoh4OzNZS3boMvfvu1qkbaccG6pv,SpATywNh6bZuzm8s1ceuBUnMUAeoAHHw,13,26,15,4,7,0,5,0,57,8.142857142857142,4,0.0,8,15,3,7,18,0,1,5,0,33,24,0
5556,144328,1z8xVGdONRHgttCsFcaiTYfHNmdRXPsG,SpATywNh6bZuzm8s1ceuBUnMUAeoAHHw,8,8,3,0,2,0,2,0,15,2.142857142857143,1,0.0,2,3,0,2,6,0,0,2,0,7,8,1
5557,144352,15iBXbgbmcpqKkeTya1vwlvLo9VSZF3Q,G8EPVSXsOYB5YQWZGiz1aVq5Pgr2GrQu,14,7,6,34,4,0,3,0,54,7.714285714285714,1,0.0,1,6,29,4,6,0,5,3,0,40,14,1
5558,144367,j6kVkVGKYZT7ozL2NE5rOIexD3a1ewYn,bWdj2GDclj5ofokWjzoa5jAwMkxCykd6,8,6,2,18,3,0,1,0,30,4.285714285714286,1,0.0,3,2,16,3,3,0,2,1,0,24,6,1
5559,144376,rTLMEQB78zn1g6bt6KRypanGZ8QWPbQv,bWdj2GDclj5ofokWjzoa5jAwMkxCykd6,1,0,0,0,0,0,1,0,1,0.14285714285714285,1,0.0,0,0,0,0,0,0,0,1,0,0,1,1
5560,144389,BeS19JPMXzXPGfXk6YRJuHRmyxH0T7Wj,A3fsA9Zfv1X2fVEQhTw51lKENdNrEqT3,2,0,0,0,0,0,4,0,4,0.5714285714285714,1,0.0,0,0,0,0,0,0,0,4,0,0,4,1
5561,144393,15iBXbgbmcpqKkeTya1vwlvLo9VSZF3Q,SpATywNh6bZuzm8s1ceuBUnMUAeoAHHw,2,0,0,0,0,0,2,0,2,0.2857142857142857,1,0.0,0,0,0,0,0,0,0,2,0,0,2,1
5562,144406,Y4L4Q01m86olYens1XXjwQSIKQK0VXY8,SpATywNh6bZuzm8s1ceuBUnMUAeoAHHw,11,6,5,4,3,0,1,0,19,2.7142857142857144,1,0.0,0,5,3,3,6,0,1,1,0,11,8,1
5563,144421,IH3Fpf227mcEx04r510MqQHERjzGveWM,A3fsA9Zfv1X2fVEQhTw51lKENdNrEqT3,21,31,24,0,14,1,12,0,82,11.714285714285714,4,0.0,0,24,0,14,31,1,0,12,0,38,44,1
5564,144422,6ElmeAobgOVWMQKbfyTe96fhVbG33C2X,G8EPVSXsOYB5YQWZGiz1aVq5Pgr2GrQu,1,0,0,0,0,0,1,0,1,0.14285714285714285,1,0.0,0,0,0,0,0,0,0,1,0,0,1,1
5565,144429,tVItbLut2hv4GIKzxM0DVZ7s3PzDPaT6,RXDvfPUBYFlVdlueBFbLW0mhhAyGEqpt,1,0,0,0,0,0,1,0,1,0.14285714285714285,1,0.0,0,0,0,0,0,0,0,1,0,0,1,1
5566,144439,7WYyQ5o657nnaDs90V9cVaz7JKBLQO6T,bWdj2GDclj5ofokWjzoa5jAwMkxCykd6,12,10,4,34,4,0,6,0,58,8.285714285714286,1,0.0,4,4,33,4,6,0,1,6,0,45,13,1
5567,144443,OocLfrCOBb0PIIRDKMfTM554g3aeKj99,A3fsA9Zfv1X2fVEQhTw51lKENdNrEqT3,9,4,3,0,3,0,2,0,12,1.7142857142857142,1,0.0,0,3,0,3,4,0,0,2,0,6,6,1
5568,144455,uzKo5XybDLGWG8pNxiIda7r0TfSQ9SeA,A3fsA9Zfv1X2fVEQhTw51lKENdNrEqT3,10,7,6,0,6,0,1,0,20,2.857142857142857,1,0.0,0,6,0,6,7,0,0,1,0,12,8,1
5569,144460,QhamLDlsBIMrNG9NsQtpJBjMOuVLF7Tg,SpATywNh6bZuzm8s1ceuBUnMUAeoAHHw,1,0,0,0,0,0,1,0,1,0.14285714285714285,1,0.0,0,0,0,0,0,0,0,1,0,0,1,1
5570,144462,98Rmjqd0huhIhiHJIK65vNiEBdUVwDLb,bWdj2GDclj5ofokWjzoa5jAwMkxCykd6,1,0,0,0,0,0,1,0,1,0.14285714285714285,1,0.0,0,0,0,0,0,0,0,1,0,0,1,1
5571,144505,XYAJcmpULCxF9eHnylLtZOUd3WBca1G2,SpATywNh6bZuzm8s1ceuBUnMUAeoAHHw,6,4,1,0,1,0,4,0,10,1.4285714285714286,1,0.0,0,1,0,1,4,0,0,4,0,2,8,1
5572,144510,M8d3qfut8VxaqPRwVms9OlOmOpQg63xG,SpATywNh6bZuzm8s1ceuBUnMUAeoAHHw,18,56,11,18,4,29,21,4,143,20.428571428571427,2,0.0,23,11,15,4,33,29,3,21,4,53,90,1
5573,144511,XqxXHlwlYxd9RSTeUV9pBamG1DPgHOIg,G8EPVSXsOYB5YQWZGiz1aVq5Pgr2GrQu,7,9,3,4,2,0,2,0,20,2.857142857142857,1,0.0,4,3,3,2,5,0,1,2,0,12,8,1
5574,144515,g3liImBcMScJKznyarQ0IVXqD3a9da64,bWdj2GDclj5ofokWjzoa5jAwMkxCykd6,2,0,0,0,0,0,2,0,2,0.2857142857142857,1,0.0,0,0,0,0,0,0,0,2,0,0,2,1
5575,144523,a47rhYVhWUpsdxtGQACB0YgDJVPXyOje,G8EPVSXsOYB5YQWZGiz1aVq5Pgr2GrQu,15,10,0,18,0,1,5,1,35,5.0,1,0.0,6,0,14,0,4,1,4,5,1,20,15,1
5576,144538,E030rU1LpxP75gCwLYOV4Fo0HxMZiV04,bWdj2GDclj5ofokWjzoa5jAwMkxCykd6,4,2,1,0,1,0,1,0,5,0.7142857142857143,1,0.0,0,1,0,1,2,0,0,1,0,2,3,1
5577,144543,3myCXWasasCDpepMqlfZ17VF0Gt1zPNm,SpATywNh6bZuzm8s1ceuBUnMUAeoAHHw,9,31,5,0,4,0,9,0,49,7.0,2,0.0,0,5,0,4,31,0,0,9,0,9,40,1
5578,144550,dRD1DS5DuggVygcG59W7832HdVYwtgOn,SpATywNh6bZuzm8s1ceuBUnMUAeoAHHw,11,12,3,0,3,1,8,1,28,4.0,3,0.0,0,3,0,3,12,1,0,8,1,6,22,0
5579,144554,a98Mt6r9LLCkAEPo2R3JVMN20OhIPoaG,G8EPVSXsOYB5YQWZGiz1aVq5Pgr2GrQu,12,9,8,0,8,1,13,3,42,6.0,1,0.0,0,8,0,8,9,1,0,13,3,16,26,1
5580,144565,aGxe7bEAMBiGMI7BWz3muh2QIgH75sEQ,SpATywNh6bZuzm8s1ceuBUnMUAeoAHHw,7,6,3,0,2,1,4,1,17,2.4285714285714284,1,0.0,0,3,0,2,6,1,0,4,1,5,12,1
5581,144576,K938KGiMd2B4Ec49syEZjpINF1qucFfC,RXDvfPUBYFlVdlueBFbLW0mhhAyGEqpt,8,6,5,0,3,0,1,0,15,2.142857142857143,1,0.0,0,5,0,3,6,0,0,1,0,8,7,1
5582,144588,TfgVRC9skFsGu3qq14caEQmfjmrp7rot,A3fsA9Zfv1X2fVEQhTw51lKENdNrEqT3,7,9,2,2,0,41,8,0,62,8.857142857142858,3,0.0,1,2,2,0,8,41,0,8,0,5,57,1
5583,144595,ILvCdOvVnKq9RshqMB5c6cdDGIsepuiz,SpATywNh6bZuzm8s1ceuBUnMUAeoAHHw,15,26,10,16,7,1,4,0,64,9.142857142857142,2,0.0,10,10,14,7,16,1,2,4,0,41,23,0
5584,144597,8sZcaktUJCX4PaAufyDgY0i3vpLY8cZl,SpATywNh6bZuzm8s1ceuBUnMUAeoAHHw,16,48,21,20,10,11,13,0,123,17.571428571428573,6,0.0,9,21,17,10,39,11,3,13,0,57,66,1
5585,144603,FKroAYBvJIjpEDPtuLwEtwENqpzITIVV,G8EPVSXsOYB5YQWZGiz1aVq5Pgr2GrQu,2,0,0,0,0,0,2,0,2,0.2857142857142857,1,0.0,0,0,0,0,0,0,0,2,0,0,2,1
5586,144617,pU8vRE1UHTj9vg59DuOCQhz7JoOflgLu,A3fsA9Zfv1X2fVEQhTw51lKENdNrEqT3,7,3,2,0,2,0,2,0,9,1.2857142857142858,1,0.0,0,2,0,2,3,0,0,2,0,4,5,1
5587,144618,MXpZg6Y3WvwOURUS1VvgXTxhk1pXKVY7,A3fsA9Zfv1X2fVEQhTw51lKENdNrEqT3,1,0,0,0,0,0,1,0,1,0.14285714285714285,1,0.0,0,0,0,0,0,0,0,1,0,0,1,1
5588,144629,BP5bWGw3QHuTeDApT0DMqwZyLZFJNObH,bWdj2GDclj5ofokWjzoa5jAwMkxCykd6,2,0,0,0,0,0,4,0,4,0.5714285714285714,2,0.0,0,0,0,0,0,0,0,4,0,0,4,1
5589,144631,HOzFChSOtA5eaxaGdVcuMk1vnx6fpMBO,A3fsA9Zfv1X2fVEQhTw51lKENdNrEqT3,8,6,5,0,5,0,1,0,17,2.4285714285714284,1,0.0,0,5,0,5,6,0,0,1,0,10,7,1
5590,144636,JUXaUT76xGfe9CQCOTjnER9kYb6QPZYj,SpATywNh6bZuzm8s1ceuBUnMUAeoAHHw,1,0,0,0,0,0,1,0,1,0.14285714285714285,1,0.0,0,0,0,0,0,0,0,1,0,0,1,1
5591,144640,BP5bWGw3QHuTeDApT0DMqwZyLZFJNObH,G8EPVSXsOYB5YQWZGiz1aVq5Pgr2GrQu,1,0,0,0,0,0,1,0,1,0.14285714285714285,1,0.0,0,0,0,0,0,0,0,1,0,0,1,1
5592,144641,BP5bWGw3QHuTeDApT0DMqwZyLZFJNObH,RXDvfPUBYFlVdlueBFbLW0mhhAyGEqpt,1,0,0,0,0,0,1,0,1,0.14285714285714285,1,0.0,0,0,0,0,0,0,0,1,0,0,1,1
5593,144643,BP5bWGw3QHuTeDApT0DMqwZyLZFJNObH,A3fsA9Zfv1X2fVEQhTw51lKENdNrEqT3,1,0,0,0,0,0,1,0,1,0.14285714285714285,1,0.0,0,0,0,0,0,0,0,1,0,0,1,0
5594,144649,uKGXhzbiDEpxCHjVlf9dmkGcQbxLosVe,A3fsA9Zfv1X2fVEQhTw51lKENdNrEqT3,25,23,5,68,2,0,4,0,102,14.571428571428571,1,0.0,16,5,68,2,7,0,0,4,0,91,11,1
5595,144672,0CSUGuJXm53wz281T7wy30wWcjmP6Jhd,A3fsA9Zfv1X2fVEQhTw51lKENdNrEqT3,1,0,0,0,0,0,1,0,1,0.14285714285714285,1,0.0,0,0,0,0,0,0,0,1,0,0,1,1
5596,144675,R6EtBVYzIOtYw5JSZPuQBl0alOVcbr6I,A3fsA9Zfv1X2fVEQhTw51lKENdNrEqT3,12,7,4,0,2,0,10,1,24,3.4285714285714284,3,0.0,0,4,0,2,7,0,0,10,1,6,18,1
5597,144681,ZbpLZuhcPXDt8MCBlzIEU31Qmn57Ldle,SpATywNh6bZuzm8s1ceuBUnMUAeoAHHw,5,6,3,0,1,0,5,0,15,2.142857142857143,3,0.0,0,3,0,1,6,0,0,5,0,4,11,0
5598,144684,3URMlJ8WFfbFx3SvBMPqUCA5oJqCky66,SpATywNh6bZuzm8s1ceuBUnMUAeoAHHw,1,0,0,0,0,0,1,0,1,0.14285714285714285,1,0.0,0,0,0,0,0,0,0,1,0,0,1,1
5599,144685,3URMlJ8WFfbFx3SvBMPqUCA5oJqCky66,A3fsA9Zfv1X2fVEQhTw51lKENdNrEqT3,1,0,0,0,0,0,1,0,1,0.14285714285714285,1,0.0,0,0,0,0,0,0,0,1,0,0,1,1
5600,144715,xQxCv7HVGUZGKsbGAuM07smPdylb1xSw,SpATywNh6bZuzm8s1ceuBUnMUAeoAHHw,17,20,10,12,3,3,11,2,61,8.714285714285714,2,0.0,6,10,12,3,14,3,0,11,2,31,30,1
5601,144717,dSEPqlVIJhcDJWr692RG1EpaZWCLqDyG,SpATywNh6bZuzm8s1ceuBUnMUAeoAHHw,18,23,15,17,8,0,10,1,74,10.571428571428571,2,0.0,3,15,14,8,20,0,3,10,1,40,34,1
5602,144718,4ZrtrSJyUYRfKbXFhTQGaeeh25vDmius,A3fsA9Zfv1X2fVEQhTw51lKENdNrEqT3,1,0,0,0,0,0,1,0,1,0.14285714285714285,1,0.0,0,0,0,0,0,0,0,1,0,0,1,1
5603,144719,xQxCv7HVGUZGKsbGAuM07smPdylb1xSw,A3fsA9Zfv1X2fVEQhTw51lKENdNrEqT3,43,17,12,50,9,0,4,0,92,13.142857142857142,1,0.0,3,12,48,9,14,0,2,4,0,72,20,1
5604,144725,AIfINm6P1sC5sVX3hdv80PZXLkhHXqk1,G8EPVSXsOYB5YQWZGiz1aVq5Pgr2GrQu,12,23,8,14,6,1,6,0,58,8.285714285714286,1,0.0,12,8,11,6,11,1,3,6,0,37,21,1
5605,144738,WQgX9jQZlUNhL3E2Z5eSuSFzKxNFacOF,SpATywNh6bZuzm8s1ceuBUnMUAeoAHHw,7,3,1,0,2,0,2,0,8,1.1428571428571428,1,0.0,0,1,0,2,3,0,0,2,0,3,5,1
5606,144767,D4wnvxE0dpHZJOcudMfhDCLWhQhwv6kG,RXDvfPUBYFlVdlueBFbLW0mhhAyGEqpt,5,2,1,0,1,0,3,0,7,1.0,1,0.0,0,1,0,1,2,0,0,3,0,2,5,1
5607,144783,tLtF2xuv7ODjuOISevnoALqvBz99SIrS,A3fsA9Zfv1X2fVEQhTw51lKENdNrEqT3,11,14,0,0,0,0,3,0,17,2.4285714285714284,2,0.0,0,0,0,0,14,0,0,3,0,0,17,1
5608,144786,pOHHE099KbMGj1W8GOyTSnGwPkWGlTwN,SpATywNh6bZuzm8s1ceuBUnMUAeoAHHw,6,3,2,0,2,0,1,0,8,1.1428571428571428,1,0.0,0,2,0,2,3,0,0,1,0,4,4,1
5609,144794,NSeMeg6h5JDvAoSbt1mktNuQe2nQivm2,SpATywNh6bZuzm8s1ceuBUnMUAeoAHHw,7,7,4,0,3,0,2,0,16,2.2857142857142856,3,0.0,0,4,0,3,7,0,0,2,0,7,9,1
5610,144796,kVjEgLBjlwxZOZHT9ChhdKAcv24WA2AK,A3fsA9Zfv1X2fVEQhTw51lKENdNrEqT3,5,4,0,0,0,0,3,0,7,1.0,1,0.0,0,0,0,0,4,0,0,3,0,0,7,1
5611,144799,mJTYU2VNehzj4vso65R9VtV3DFyktCio,A3fsA9Zfv1X2fVEQhTw51lKENdNrEqT3,1,0,0,0,0,0,1,0,1,0.14285714285714285,1,0.0,0,0,0,0,0,0,0,1,0,0,1,1
5612,144806,7vmy4dx8h1nmyk40XB1bVEo0ZK716pcj,SpATywNh6bZuzm8s1ceuBUnMUAeoAHHw,19,55,15,9,10,7,12,0,108,15.428571428571429,6,0.0,11,15,9,10,44,7,0,12,0,45,63,0
5613,144811,EORWbUeiO6FyoVtc0SbozxGi0vBVCOhI,RXDvfPUBYFlVdlueBFbLW0mhhAyGEqpt,7,6,0,0,0,1,9,0,16,2.2857142857142856,1,0.0,0,0,0,0,6,1,0,9,0,0,16,0
5614,144815,YB7yB7CNt6VhEWaKJG02XZ1X013EpWWP,SpATywNh6bZuzm8s1ceuBUnMUAeoAHHw,10,6,3,6,2,0,2,0,19,2.7142857142857144,1,0.0,0,3,6,2,6,0,0,2,0,11,8,1
5615,144837,w1HLpf01ff60tSyrkRwOPpdSlz3uqa1C,G8EPVSXsOYB5YQWZGiz1aVq5Pgr2GrQu,8,29,8,2,4,0,11,0,54,7.714285714285714,1,0.0,16,8,2,4,13,0,0,11,0,30,24,1
5616,144840,8EW2D448XGSlxAI534l0xtNnCA9hxB1o,SpATywNh6bZuzm8s1ceuBUnMUAeoAHHw,18,36,21,17,6,21,18,2,121,17.285714285714285,3,0.0,9,21,15,6,27,21,2,18,2,51,70,0
5617,144848,lWrAH12K4dJ1TRkFPwboUyykF2mRtmZq,SpATywNh6bZuzm8s1ceuBUnMUAeoAHHw,13,24,0,23,0,13,6,1,67,9.571428571428571,1,0.0,9,0,18,0,15,13,5,6,1,27,40,0
5618,144849,3Szk0pKijWd9ul5APNqiXkIk1r9cxADp,SpATywNh6bZuzm8s1ceuBUnMUAeoAHHw,14,21,2,5,1,3,13,5,50,7.142857142857143,3,0.0,3,2,4,1,18,3,1,13,5,10,40,1
5619,144857,nN9pe51IpLVxUmywITIZON7RGbeNZPas,SpATywNh6bZuzm8s1ceuBUnMUAeoAHHw,1,0,0,0,0,0,1,0,1,0.14285714285714285,1,0.0,0,0,0,0,0,0,0,1,0,0,1,1
5620,144869,wdtTKNG0uA9GskMOgg4nh6i8cQYwrWBl,A3fsA9Zfv1X2fVEQhTw51lKENdNrEqT3,2,0,0,0,0,0,2,0,2,0.2857142857142857,1,0.0,0,0,0,0,0,0,0,2,0,0,2,1
5621,144871,1R1zO9aMB7Mx1Lw84JzsChVEV5JpwmZv,A3fsA9Zfv1X2fVEQhTw51lKENdNrEqT3,12,13,3,0,2,0,7,0,25,3.5714285714285716,3,0.0,0,3,0,2,13,0,0,7,0,5,20,1
5622,144880,DPiNWGgyN27xfAyZbYcImdtWAWiA8G6T,A3fsA9Zfv1X2fVEQhTw51lKENdNrEqT3,2,0,0,0,0,0,6,0,6,0.8571428571428571,1,0.0,0,0,0,0,0,0,0,6,0,0,6,1
5623,144888,Fa0j89udkjEUrIyHxCII6V32n0NpiqGO,SpATywNh6bZuzm8s1ceuBUnMUAeoAHHw,4,5,0,0,0,0,2,0,7,1.0,1,0.0,1,0,0,0,4,0,0,2,0,1,6,1
5624,144889,y9hyyqGNd76OPDqzcsRztJJMWbz6UZny,bWdj2GDclj5ofokWjzoa5jAwMkxCykd6,5,2,1,0,1,0,2,0,6,0.8571428571428571,1,0.0,0,1,0,1,2,0,0,2,0,2,4,1
5625,144892,TBXYAxwexaNd47Tj9eT3p3QhXiwNSKj3,A3fsA9Zfv1X2fVEQhTw51lKENdNrEqT3,5,2,1,0,1,0,2,0,6,0.8571428571428571,1,0.0,0,1,0,1,2,0,0,2,0,2,4,1
5626,144900,k0mvvZulPoyJiICbYxKkU42hG2G5I80n,G8EPVSXsOYB5YQWZGiz1aVq5Pgr2GrQu,15,5,5,0,4,5,8,1,28,4.0,1,0.0,0,5,0,4,5,5,0,8,1,9,19,0
5627,144902,xbjVL5LPvdMl78h4grzGu4EO36e7wFtJ,G8EPVSXsOYB5YQWZGiz1aVq5Pgr2GrQu,17,24,14,14,9,0,4,0,65,9.285714285714286,1,0.0,7,14,13,9,17,0,1,4,0,43,22,1
5628,144906,ltWU63DD5GSM3zr2uNJoqVqAhziwXNdd,A3fsA9Zfv1X2fVEQhTw51lKENdNrEqT3,1,0,0,0,0,0,1,0,1,0.14285714285714285,1,0.0,0,0,0,0,0,0,0,1,0,0,1,1
5629,144910,3QwYnxvK4cR8IsGQGOLRPbhjjuJL7iw4,bWdj2GDclj5ofokWjzoa5jAwMkxCykd6,1,0,0,0,0,0,1,0,1,0.14285714285714285,1,0.0,0,0,0,0,0,0,0,1,0,0,1,1
5630,144913,xbjVL5LPvdMl78h4grzGu4EO36e7wFtJ,SpATywNh6bZuzm8s1ceuBUnMUAeoAHHw,16,14,5,18,2,5,6,1,51,7.285714285714286,1,0.0,7,5,15,2,7,5,3,6,1,29,22,1
5631,144917,qIeFceRzEPXi4DRrMYWrvBiuDgAZSOfu,SpATywNh6bZuzm8s1ceuBUnMUAeoAHHw,6,4,3,0,2,0,2,0,11,1.5714285714285714,1,0.0,0,3,0,2,4,0,0,2,0,5,6,1
5632,144929,j32U9Y949ZW1nXMwG0aPWZXCmluBzel9,A3fsA9Zfv1X2fVEQhTw51lKENdNrEqT3,2,0,0,0,0,0,2,0,2,0.2857142857142857,1,0.0,0,0,0,0,0,0,0,2,0,0,2,1
5633,144953,FDUH5NLrpwAq9aLqLXeux2jUy8LXyyH1,SpATywNh6bZuzm8s1ceuBUnMUAeoAHHw,4,2,0,0,0,0,2,0,4,0.5714285714285714,1,0.0,0,0,0,0,2,0,0,2,0,0,4,0
5634,144955,eE1Ts31Y4vQL30WuFQSepkqre5sjHOf7,A3fsA9Zfv1X2fVEQhTw51lKENdNrEqT3,1,0,0,0,0,0,1,0,1,0.14285714285714285,1,0.0,0,0,0,0,0,0,0,1,0,0,1,1
5635,144957,spFI1Ow5BGpTh0oHb0EunsXhby1WBBGm,A3fsA9Zfv1X2fVEQhTw51lKENdNrEqT3,2,0,0,0,0,0,2,0,2,0.2857142857142857,1,0.0,0,0,0,0,0,0,0,2,0,0,2,1
5636,144963,BohRHH2vBIgnEZGZjM3WnHwJbVFmITRG,A3fsA9Zfv1X2fVEQhTw51lKENdNrEqT3,1,0,0,0,0,0,4,0,4,0.5714285714285714,1,0.0,0,0,0,0,0,0,0,4,0,0,4,1
5637,144970,9fBHqnUYCnvcFTWqd4TwpElPXxWTxMR8,G8EPVSXsOYB5YQWZGiz1aVq5Pgr2GrQu,7,4,1,0,1,0,3,0,9,1.2857142857142858,2,0.0,0,1,0,1,4,0,0,3,0,2,7,1
5638,144985,UdRvlfQEjfzv2meiEECQoQ6VdSnYEWcK,RXDvfPUBYFlVdlueBFbLW0mhhAyGEqpt,17,21,12,30,10,6,5,0,84,12.0,2,0.0,6,12,22,10,15,6,8,5,0,50,34,1
5639,145015,MOcMwRKo0dtFqZ5xWBgRzquuZGKtQyf4,A3fsA9Zfv1X2fVEQhTw51lKENdNrEqT3,6,3,2,0,2,0,1,0,8,1.1428571428571428,1,0.0,0,2,0,2,3,0,0,1,0,4,4,1
5640,145021,qwhxcjW9iIMBAQoGSWDtst34AFkcFQoV,bWdj2GDclj5ofokWjzoa5jAwMkxCykd6,5,7,3,0,0,1,5,0,16,2.2857142857142856,2,0.0,0,3,0,0,7,1,0,5,0,3,13,0
5641,145032,9KLyc4q5evm7m8P2TqAkjsYxwe72QOQ1,bWdj2GDclj5ofokWjzoa5jAwMkxCykd6,7,6,2,0,3,0,2,0,13,1.8571428571428572,1,0.0,2,2,0,3,4,0,0,2,0,7,6,1
5642,145045,fAwXW6DQAyNHjMN17jlyBSVcZRO4da21,bWdj2GDclj5ofokWjzoa5jAwMkxCykd6,3,2,0,0,0,0,1,0,3,0.42857142857142855,1,0.0,0,0,0,0,2,0,0,1,0,0,3,1
5643,145049,OoYnFZVZGncVBxTvo4CMvSktXlZzaVm6,SpATywNh6bZuzm8s1ceuBUnMUAeoAHHw,1,0,0,0,0,0,1,0,1,0.14285714285714285,1,0.0,0,0,0,0,0,0,0,1,0,0,1,1
5644,145054,aRdmmgSzM3Ga3svQ0ZT0DvTgw1R0bnD6,SpATywNh6bZuzm8s1ceuBUnMUAeoAHHw,13,13,1,11,0,7,11,0,43,6.142857142857143,3,0.0,2,1,10,0,11,7,1,11,0,13,30,0
5645,145066,YOvd9uht0tZm889aIFQH8jd68xtH7inE,A3fsA9Zfv1X2fVEQhTw51lKENdNrEqT3,27,29,13,16,7,0,6,0,71,10.142857142857142,3,0.0,2,13,14,7,27,0,2,6,0,36,35,0
5646,145068,sytW49I21SJ70ElOkXGU5SHeeHl1E3fL,SpATywNh6bZuzm8s1ceuBUnMUAeoAHHw,5,4,2,0,1,0,2,0,9,1.2857142857142858,2,0.0,0,2,0,1,4,0,0,2,0,3,6,1
5647,145074,zKArdfpgac7e9qM8jxPrRvIXOkmrDk9Z,SpATywNh6bZuzm8s1ceuBUnMUAeoAHHw,6,2,1,0,1,0,3,0,7,1.0,1,0.0,0,1,0,1,2,0,0,3,0,2,5,1
5648,145075,aVjhXoDZEpZewbee7kboIyQDdDGbqzp9,G8EPVSXsOYB5YQWZGiz1aVq5Pgr2GrQu,2,0,0,0,0,0,2,0,2,0.2857142857142857,1,0.0,0,0,0,0,0,0,0,2,0,0,2,1
5649,145091,ung1DnQyYgd0tfz7mAKTwJrrm5UPHWt1,SpATywNh6bZuzm8s1ceuBUnMUAeoAHHw,1,0,0,0,0,0,2,0,2,0.2857142857142857,1,0.0,0,0,0,0,0,0,0,2,0,0,2,1
5650,145095,tXsXr7pk3kL9xbg1D57dnKxY4YjIc1Gu,SpATywNh6bZuzm8s1ceuBUnMUAeoAHHw,1,0,0,0,0,0,1,0,1,0.14285714285714285,1,0.0,0,0,0,0,0,0,0,1,0,0,1,1
5651,145097,oQl0xDZ6pRPXU9L7MUpc2rUtjHufKB7J,RXDvfPUBYFlVdlueBFbLW0mhhAyGEqpt,4,3,2,0,0,0,1,0,6,0.8571428571428571,1,0.0,0,2,0,0,3,0,0,1,0,2,4,1
5652,145103,DSKmSALREyqQ6TTRJZ71cZdSUivRfs4F,A3fsA9Zfv1X2fVEQhTw51lKENdNrEqT3,8,6,3,0,2,0,3,0,14,2.0,1,0.0,0,3,0,2,6,0,0,3,0,5,9,1
5653,145104,GIGWJmYKqXl2NDr50MFNWHRPBdEAyP24,SpATywNh6bZuzm8s1ceuBUnMUAeoAHHw,6,2,1,0,1,0,7,1,12,1.7142857142857142,2,0.0,0,1,0,1,2,0,0,7,1,2,10,1
5654,145105,RjP92xCHXSUOtRBYjOBBQtIX0x4y84M8,SpATywNh6bZuzm8s1ceuBUnMUAeoAHHw,5,2,1,0,1,0,3,0,7,1.0,1,0.0,0,1,0,1,2,0,0,3,0,2,5,1
5655,145131,y7ML2j3yhLTXFlpVgDfbFQ7iV1QJE8KN,A3fsA9Zfv1X2fVEQhTw51lKENdNrEqT3,8,4,0,0,0,0,8,1,13,1.8571428571428572,2,0.0,0,0,0,0,4,0,0,8,1,0,13,1
5656,145132,VtMJYS2BOcqNwb9vhCBVs8m6rwGm1W7t,A3fsA9Zfv1X2fVEQhTw51lKENdNrEqT3,9,4,3,0,3,0,2,0,12,1.7142857142857142,1,0.0,0,3,0,3,4,0,0,2,0,6,6,1
5657,145133,gcAX0pXem59fO2vK8c72MGTEEeEu58YB,SpATywNh6bZuzm8s1ceuBUnMUAeoAHHw,9,8,4,0,2,0,10,1,25,3.5714285714285716,5,0.0,0,4,0,2,8,0,0,10,1,6,19,1
5658,145138,RiLBe5rsNsQ05e1l2H5DyOu2jxJ20lju,SpATywNh6bZuzm8s1ceuBUnMUAeoAHHw,5,6,0,0,0,0,2,0,8,1.1428571428571428,1,0.0,0,0,0,0,6,0,0,2,0,0,8,1
5659,145141,sytW49I21SJ70ElOkXGU5SHeeHl1E3fL,G8EPVSXsOYB5YQWZGiz1aVq5Pgr2GrQu,1,0,0,0,0,0,1,0,1,0.14285714285714285,1,0.0,0,0,0,0,0,0,0,1,0,0,1,1
5660,145177,2HllbOBswZcfya5rDzlXYMHVB93oWjxb,SpATywNh6bZuzm8s1ceuBUnMUAeoAHHw,17,59,19,22,4,21,13,0,138,19.714285714285715,4,0.0,15,19,19,4,44,21,3,13,0,57,81,1
5661,145209,VDfyMtI3GxFkSIKeQUI9WFdkBVMRRXiz,SpATywNh6bZuzm8s1ceuBUnMUAeoAHHw,5,3,0,0,0,0,4,0,7,1.0,1,0.0,0,0,0,0,3,0,0,4,0,0,7,1
5662,145213,paYCysIECekGmZR2IMHuvcxiMIpmnCQ8,SpATywNh6bZuzm8s1ceuBUnMUAeoAHHw,7,5,0,0,0,1,2,0,8,1.1428571428571428,1,0.0,0,0,0,0,5,1,0,2,0,0,8,1
5663,145218,gBdCgqP4ofpM7Vyy2N6nMT9XqzCjM1Oh,SpATywNh6bZuzm8s1ceuBUnMUAeoAHHw,7,3,2,0,2,0,2,0,9,1.2857142857142858,1,0.0,0,2,0,2,3,0,0,2,0,4,5,1
5664,145221,twJpEV6sOcVGisdKOs7bOfiwkX5tFRQS,SpATywNh6bZuzm8s1ceuBUnMUAeoAHHw,10,12,1,0,1,3,6,1,24,3.4285714285714284,1,0.0,0,1,0,1,12,3,0,6,1,2,22,1
5665,145265,OpGwtUbMGweipJr0vMybah9tM3IHgiea,bWdj2GDclj5ofokWjzoa5jAwMkxCykd6,12,24,2,60,4,0,3,0,93,13.285714285714286,3,0.0,11,2,57,4,13,0,3,3,0,74,19,1
5666,145278,TxcS8XkQULHRvLzAPNlWKiWhaRYPoBRt,G8EPVSXsOYB5YQWZGiz1aVq5Pgr2GrQu,6,2,1,0,1,0,4,0,8,1.1428571428571428,1,0.0,0,1,0,1,2,0,0,4,0,2,6,1
5667,145288,qJfYTCfAKzghj5i0hFgmRNbo2RAMR1vj,A3fsA9Zfv1X2fVEQhTw51lKENdNrEqT3,1,0,0,0,0,0,1,0,1,0.14285714285714285,1,0.0,0,0,0,0,0,0,0,1,0,0,1,1
5668,145291,hnuoUj2kTW5DzBnYNuL5k21Q4R9tMedy,G8EPVSXsOYB5YQWZGiz1aVq5Pgr2GrQu,1,0,0,0,0,0,1,0,1,0.14285714285714285,1,0.0,0,0,0,0,0,0,0,1,0,0,1,1
5669,145292,rwtLVsXV0McQpa98tIZ3wTZOVSCGNjDc,A3fsA9Zfv1X2fVEQhTw51lKENdNrEqT3,2,0,0,0,0,0,2,0,2,0.2857142857142857,1,0.0,0,0,0,0,0,0,0,2,0,0,2,1
5670,145295,vBbCzoxWi1xTyTmmDeTUsTbUY4qjPd8y,G8EPVSXsOYB5YQWZGiz1aVq5Pgr2GrQu,21,26,8,36,7,7,5,1,90,12.857142857142858,2,0.0,16,8,26,7,10,7,10,5,1,57,33,1
5671,145299,Msbm8ecHOfoRqpOAXpgLpOJMSb42Fh1S,bWdj2GDclj5ofokWjzoa5jAwMkxCykd6,1,0,0,0,0,0,2,0,2,0.2857142857142857,2,0.0,0,0,0,0,0,0,0,2,0,0,2,1
5672,145317,xXaLTSrOfjZMoecs1p8kChNEzFzZxcjE,bWdj2GDclj5ofokWjzoa5jAwMkxCykd6,2,0,0,0,0,0,2,0,2,0.2857142857142857,1,0.0,0,0,0,0,0,0,0,2,0,0,2,1
5673,145341,Cgu1GLWn7izWpBdNFknarDBOnLjP2HFo,SpATywNh6bZuzm8s1ceuBUnMUAeoAHHw,1,0,0,0,0,0,1,0,1,0.14285714285714285,1,0.0,0,0,0,0,0,0,0,1,0,0,1,1
5674,145345,RjNr7pqr5wdbMZIOQUnJioAJdhoV1M2t,A3fsA9Zfv1X2fVEQhTw51lKENdNrEqT3,2,0,0,0,0,0,2,0,2,0.2857142857142857,1,0.0,0,0,0,0,0,0,0,2,0,0,2,1
5675,145356,yODUqFZFhl66c3de8GWk0KnGzndelUJ3,SpATywNh6bZuzm8s1ceuBUnMUAeoAHHw,5,4,0,0,0,0,2,0,6,0.8571428571428571,1,0.0,0,0,0,0,4,0,0,2,0,0,6,1
5676,145357,vBbCzoxWi1xTyTmmDeTUsTbUY4qjPd8y,bWdj2GDclj5ofokWjzoa5jAwMkxCykd6,12,11,5,18,4,0,5,0,43,6.142857142857143,2,0.0,3,5,18,4,8,0,0,5,0,30,13,1
5677,145372,N7bFFbLK2teqNFII1ql8vn5jRsylN8ml,A3fsA9Zfv1X2fVEQhTw51lKENdNrEqT3,2,0,0,0,0,0,3,0,3,0.42857142857142855,1,0.0,0,0,0,0,0,0,0,3,0,0,3,1
5678,145379,7DPRFpgqZz2tLX453UgkvNfatiWrVLIi,bWdj2GDclj5ofokWjzoa5jAwMkxCykd6,1,0,0,0,0,0,1,0,1,0.14285714285714285,1,0.0,0,0,0,0,0,0,0,1,0,0,1,1
5679,145406,DaYS7gf8DVgCD84ya5YqgMFFiGYw1ps2,SpATywNh6bZuzm8s1ceuBUnMUAeoAHHw,5,2,1,0,1,0,2,0,6,0.8571428571428571,1,0.0,0,1,0,1,2,0,0,2,0,2,4,1
5680,145432,KMY78k4PWHNGUKa8SpxqTI7uzFKhJIDC,bWdj2GDclj5ofokWjzoa5jAwMkxCykd6,1,0,0,0,0,0,1,0,1,0.14285714285714285,1,0.0,0,0,0,0,0,0,0,1,0,0,1,1
5681,145434,r0Dep3QHNNWSPLkR08tICGVj5Fu7r77t,A3fsA9Zfv1X2fVEQhTw51lKENdNrEqT3,4,2,0,0,0,0,3,0,5,0.7142857142857143,2,0.0,0,0,0,0,2,0,0,3,0,0,5,1
5682,145436,uO6I869Gu09HIUH9g2koYFrRZOQcNS34,SpATywNh6bZuzm8s1ceuBUnMUAeoAHHw,1,0,0,0,0,0,1,0,1,0.14285714285714285,1,0.0,0,0,0,0,0,0,0,1,0,0,1,1
5683,145438,sETZmDR5b3CheYe2K5IvWb1lrRsZmOT8,A3fsA9Zfv1X2fVEQhTw51lKENdNrEqT3,4,2,1,0,1,0,2,0,6,0.8571428571428571,1,0.0,0,1,0,1,2,0,0,2,0,2,4,1
5684,145443,YjyR7WtUqlaMl5G5DWaaUx9XfYg7ssrK,G8EPVSXsOYB5YQWZGiz1aVq5Pgr2GrQu,1,0,0,0,0,0,1,0,1,0.14285714285714285,1,0.0,0,0,0,0,0,0,0,1,0,0,1,1
5685,145450,YAsCREgt5tIqJEvOtaek3jtgsLn87nEr,SpATywNh6bZuzm8s1ceuBUnMUAeoAHHw,4,2,0,0,0,2,2,0,6,0.8571428571428571,1,0.0,0,0,0,0,2,2,0,2,0,0,6,1
5686,145454,kjrJbHri2dhD9BduhqLwj0qNbqxkh9F5,G8EPVSXsOYB5YQWZGiz1aVq5Pgr2GrQu,3,3,0,0,0,0,1,0,4,0.5714285714285714,1,0.0,0,0,0,0,3,0,0,1,0,0,4,1
5687,145465,IvdoAzckjyWWCkzCy6V0BjWvOwMyZEwg,A3fsA9Zfv1X2fVEQhTw51lKENdNrEqT3,21,20,16,14,1,1,8,0,60,8.571428571428571,3,0.0,0,16,13,1,20,1,1,8,0,30,30,1
5688,145469,cRlXLJdkIX4KH74JKLBjP86zQb3lppxR,bWdj2GDclj5ofokWjzoa5jAwMkxCykd6,5,2,1,0,1,0,2,0,6,0.8571428571428571,1,0.0,0,1,0,1,2,0,0,2,0,2,4,1
5689,145472,vUg72yuNvNQBasGeqPwQue3GKgSAK3Os,bWdj2GDclj5ofokWjzoa5jAwMkxCykd6,7,3,2,0,2,0,2,0,9,1.2857142857142858,2,0.0,0,2,0,2,3,0,0,2,0,4,5,1
5690,145526,SxwYiL0K8imHewBqHVzk62D1lCszL0BN,SpATywNh6bZuzm8s1ceuBUnMUAeoAHHw,1,0,0,0,0,0,1,0,1,0.14285714285714285,1,0.0,0,0,0,0,0,0,0,1,0,0,1,1
5691,145527,lmlSe7ne5kLVEzM7wObkzo8bsMDoN8xr,SpATywNh6bZuzm8s1ceuBUnMUAeoAHHw,10,5,4,0,3,0,3,0,15,2.142857142857143,1,0.0,0,4,0,3,5,0,0,3,0,7,8,1
5692,145556,W7jA7ye7B2WHwijEGRwBOnLy8XlzJD6d,7GRhBDsirIGkRZBtSMEzNTyDr2JQm4xx,9,13,6,3,6,0,3,0,31,4.428571428571429,2,0.0,5,6,3,6,8,0,0,3,0,20,11,1
5693,145573,azsfvKoTKLQ8ipwpPOtqZMAvWCpOjcns,7GRhBDsirIGkRZBtSMEzNTyDr2JQm4xx,11,4,3,0,3,0,5,0,15,2.142857142857143,2,0.0,0,3,0,3,4,0,0,5,0,6,9,1
5694,145591,zUUxzMGQmBZk6tO8vnbhkaGffbYWZvas,7GRhBDsirIGkRZBtSMEzNTyDr2JQm4xx,1,0,0,0,0,0,1,0,1,0.14285714285714285,1,0.0,0,0,0,0,0,0,0,1,0,0,1,1
5695,145734,hzecatREssedFdFCykKMURt84PE7MA6q,7GRhBDsirIGkRZBtSMEzNTyDr2JQm4xx,1,0,0,0,0,0,1,0,1,0.14285714285714285,1,0.0,0,0,0,0,0,0,0,1,0,0,1,1
5696,145746,qWYBo2adrtMVzANonhELRQVrWKW8T9T5,7GRhBDsirIGkRZBtSMEzNTyDr2JQm4xx,1,0,0,0,0,0,1,0,1,0.14285714285714285,1,0.0,0,0,0,0,0,0,0,1,0,0,1,1
5697,145767,PUvUSLbNhJCmhl8hY6hN43xWGmaNTEJm,7GRhBDsirIGkRZBtSMEzNTyDr2JQm4xx,3,2,1,0,0,0,1,0,4,0.5714285714285714,1,0.0,0,1,0,0,2,0,0,1,0,1,3,1
5698,145806,oIeIfwhQt9r1G6uZ62W7p7DLvDQ1KzcN,7GRhBDsirIGkRZBtSMEzNTyDr2JQm4xx,1,0,0,0,0,0,1,0,1,0.14285714285714285,1,0.0,0,0,0,0,0,0,0,1,0,0,1,1
5699,145824,iOFL9rLCMe8MjMlK3933AhOhA0dxbzTJ,7GRhBDsirIGkRZBtSMEzNTyDr2JQm4xx,2,0,0,0,0,0,2,0,2,0.2857142857142857,1,0.0,0,0,0,0,0,0,0,2,0,0,2,1
5700,145865,YYoTz5aT6oXhrDferhw1rplLYmNDgFub,7GRhBDsirIGkRZBtSMEzNTyDr2JQm4xx,4,2,1,0,1,0,1,0,5,0.7142857142857143,1,0.0,0,1,0,1,2,0,0,1,0,2,3,0
5701,145878,vkI2g6NMz3qUYtvneHWPmtBdkC0OUJ1I,7GRhBDsirIGkRZBtSMEzNTyDr2JQm4xx,10,6,3,0,1,1,9,1,21,3.0,1,0.0,0,3,0,1,6,1,0,9,1,4,17,1
5702,145953,TUdJl2punKYQuyj7cqcfXJ5p7FVAGa9A,7GRhBDsirIGkRZBtSMEzNTyDr2JQm4xx,12,30,13,0,4,1,2,0,50,7.142857142857143,1,0.0,8,13,0,4,22,1,0,2,0,25,25,1
5703,145989,ULvgH0dn9cMQ7RqvqnSWbMcAlKJJQ0Fk,7GRhBDsirIGkRZBtSMEzNTyDr2JQm4xx,2,0,0,0,0,0,2,0,2,0.2857142857142857,1,0.0,0,0,0,0,0,0,0,2,0,0,2,1
5704,146936,c5MkJ205AcjWsm07YpOktUEc4lrC6DvN,RXDvfPUBYFlVdlueBFbLW0mhhAyGEqpt,1,0,0,0,0,0,1,0,1,0.14285714285714285,1,0.0,0,0,0,0,0,0,0,1,0,0,1,1
5705,146953,TkwNaNrSLynIgxaNvilfhFA70R9L2fY3,RXDvfPUBYFlVdlueBFbLW0mhhAyGEqpt,1,0,0,0,0,0,3,0,3,0.42857142857142855,1,0.0,0,0,0,0,0,0,0,3,0,0,3,0
5706,147072,8yNyyy8aPKd19nuqwaynaLkU67KuROpn,G8EPVSXsOYB5YQWZGiz1aVq5Pgr2GrQu,9,7,3,0,3,0,3,0,16,2.2857142857142856,2,0.0,0,3,0,3,7,0,0,3,0,6,10,1
5707,147073,aFc1dZRXyhduGfLgWKifgShSyZKIHAn2,G8EPVSXsOYB5YQWZGiz1aVq5Pgr2GrQu,1,0,0,0,0,0,1,0,1,0.14285714285714285,1,0.0,0,0,0,0,0,0,0,1,0,0,1,1
5708,147106,114X1vLT3OTzchhxfRGg24FTsgrs6Boi,G8EPVSXsOYB5YQWZGiz1aVq5Pgr2GrQu,1,0,0,0,0,0,1,0,1,0.14285714285714285,1,0.0,0,0,0,0,0,0,0,1,0,0,1,1
5709,147113,sL5jw3pLWZoRI7avI17oM60mfF67Acgz,RXDvfPUBYFlVdlueBFbLW0mhhAyGEqpt,1,0,0,0,0,0,2,0,2,0.2857142857142857,2,0.0,0,0,0,0,0,0,0,2,0,0,2,0
5710,147134,FmbW6BMW2tvli3L6T9qC97SAIzFg6ww1,G8EPVSXsOYB5YQWZGiz1aVq5Pgr2GrQu,1,0,0,0,0,0,1,0,1,0.14285714285714285,1,0.0,0,0,0,0,0,0,0,1,0,0,1,1
5711,147182,Z8r3kWGF2ZuWSy5TZGg00SEG4qfRh2Ag,RXDvfPUBYFlVdlueBFbLW0mhhAyGEqpt,1,0,0,0,0,0,1,0,1,0.14285714285714285,1,0.0,0,0,0,0,0,0,0,1,0,0,1,1
5712,147195,CabsQjb2Sd2I3ynTdtsErAG67rLex08f,RXDvfPUBYFlVdlueBFbLW0mhhAyGEqpt,1,0,0,0,0,0,1,0,1,0.14285714285714285,1,0.0,0,0,0,0,0,0,0,1,0,0,1,1
5713,147226,G6cW0d2bzLHgB0vreFbhNx3GSiMBKbtv,RXDvfPUBYFlVdlueBFbLW0mhhAyGEqpt,1,0,0,0,0,0,1,0,1,0.14285714285714285,1,0.0,0,0,0,0,0,0,0,1,0,0,1,1
5714,147256,mKHQM9iW9olu6z2WamdxK7ySH3UwX3JX,G8EPVSXsOYB5YQWZGiz1aVq5Pgr2GrQu,1,0,0,0,0,0,1,0,1,0.14285714285714285,1,0.0,0,0,0,0,0,0,0,1,0,0,1,1
5715,147302,yYdEa9txfr33mPdKZaxK9a9x3sCFYrvO,RXDvfPUBYFlVdlueBFbLW0mhhAyGEqpt,1,0,0,0,0,0,1,0,1,0.14285714285714285,1,0.0,0,0,0,0,0,0,0,1,0,0,1,1
5716,147396,fr3LtKJIFGCsR1nz5ebBpapeX9CBJz4r,RXDvfPUBYFlVdlueBFbLW0mhhAyGEqpt,1,0,0,0,0,0,1,0,1,0.14285714285714285,1,0.0,0,0,0,0,0,0,0,1,0,0,1,1
5717,147400,W0jA3kW6UFNLExCUVwSYpHHYwJL1vqo8,G8EPVSXsOYB5YQWZGiz1aVq5Pgr2GrQu,1,0,0,0,0,0,1,0,1,0.14285714285714285,1,0.0,0,0,0,0,0,0,0,1,0,0,1,1
5718,147402,hlub8IQ6xr3M5qQPn6YnEFWROpuhMcwL,RXDvfPUBYFlVdlueBFbLW0mhhAyGEqpt,1,0,0,0,0,0,1,0,1,0.14285714285714285,1,0.0,0,0,0,0,0,0,0,1,0,0,1,1
5719,147419,T7YlTqIDVTZFYEYihxD1Zij5IkDsmVZP,RXDvfPUBYFlVdlueBFbLW0mhhAyGEqpt,1,0,0,0,0,0,1,0,1,0.14285714285714285,1,0.0,0,0,0,0,0,0,0,1,0,0,1,1
5720,147428,qyJkLuZ2kSoWLr9To4rUoAUCy3t2DtqK,RXDvfPUBYFlVdlueBFbLW0mhhAyGEqpt,22,23,1,23,2,1,6,1,57,8.142857142857142,2,0.0,4,1,23,2,19,1,0,6,1,30,27,1
5721,147484,ly5oRv8hiewZ1JUIP5AGbwWRi69QKnfA,G8EPVSXsOYB5YQWZGiz1aVq5Pgr2GrQu,1,0,0,0,0,0,1,0,1,0.14285714285714285,1,0.0,0,0,0,0,0,0,0,1,0,0,1,1
5722,147496,fJRilHVpgCFPzgCMD6Xh8rgK6259Z6TQ,RXDvfPUBYFlVdlueBFbLW0mhhAyGEqpt,1,0,0,0,0,0,1,0,1,0.14285714285714285,1,0.0,0,0,0,0,0,0,0,1,0,0,1,1
5723,147511,GXuacM1G2BzxiXouSVLnDv1V97NGwCCe,G8EPVSXsOYB5YQWZGiz1aVq5Pgr2GrQu,1,0,0,0,0,0,1,0,1,0.14285714285714285,1,0.0,0,0,0,0,0,0,0,1,0,0,1,1
5724,147512,WnXohtCVTjGmg2VYZ7QMusUaSQiMqg1z,G8EPVSXsOYB5YQWZGiz1aVq5Pgr2GrQu,1,0,0,0,0,0,1,0,1,0.14285714285714285,1,0.0,0,0,0,0,0,0,0,1,0,0,1,1
5725,147519,nYcDj7802ShzcCKfMPZblsaYoLQlLfFa,RXDvfPUBYFlVdlueBFbLW0mhhAyGEqpt,1,0,0,0,0,0,2,0,2,0.2857142857142857,1,0.0,0,0,0,0,0,0,0,2,0,0,2,1
5726,147558,FgDDMWCPhLKDQm2tOcaDRFOiW3MmNhxn,RXDvfPUBYFlVdlueBFbLW0mhhAyGEqpt,1,0,0,0,0,0,1,0,1,0.14285714285714285,1,0.0,0,0,0,0,0,0,0,1,0,0,1,1
5727,147627,qtx0N6lbHC7rLYVDABZMZjBHS66niL8J,RXDvfPUBYFlVdlueBFbLW0mhhAyGEqpt,1,0,0,0,0,0,1,0,1,0.14285714285714285,1,0.0,0,0,0,0,0,0,0,1,0,0,1,1
5728,147631,V1B34PKYcESnicIbQVUA4gpuU2uOqNWz,G8EPVSXsOYB5YQWZGiz1aVq5Pgr2GrQu,1,0,0,0,0,0,1,0,1,0.14285714285714285,1,0.0,0,0,0,0,0,0,0,1,0,0,1,1
5729,147661,8Eqf4bSicFmRziRU1kFgF89C5yGB8WDX,RXDvfPUBYFlVdlueBFbLW0mhhAyGEqpt,1,0,0,0,0,0,2,0,2,0.2857142857142857,2,0.0,0,0,0,0,0,0,0,2,0,0,2,1
5730,147668,RXybWoyBfxb1StD4gTX3cQ7Ir2hHF7eD,G8EPVSXsOYB5YQWZGiz1aVq5Pgr2GrQu,1,0,0,0,0,0,1,0,1,0.14285714285714285,1,0.0,0,0,0,0,0,0,0,1,0,0,1,1
5731,147692,97s9Gq3v1SpdnbcXTUeP0PbnntkfF2Gl,G8EPVSXsOYB5YQWZGiz1aVq5Pgr2GrQu,1,0,0,0,0,0,1,0,1,0.14285714285714285,1,0.0,0,0,0,0,0,0,0,1,0,0,1,1
5732,147731,y25cTP8mHUkaHLXFWhaRvqNBGzTMte3f,RXDvfPUBYFlVdlueBFbLW0mhhAyGEqpt,1,0,0,0,0,0,1,0,1,0.14285714285714285,1,0.0,0,0,0,0,0,0,0,1,0,0,1,1
5733,147756,kjYtN2fLOM5h2d7NgR39VaAB4M2wF6SJ,fbPkOYLVPtPgIt0MxizjfFJov3JbHyAi,3,0,0,0,0,0,4,0,4,0.5714285714285714,1,0.0,0,0,0,0,0,0,0,4,0,0,4,0
5734,147757,PR1Ko3tMvIqClzd4kShPXdxxynmXc5v2,fbPkOYLVPtPgIt0MxizjfFJov3JbHyAi,3,2,0,0,0,0,1,0,3,0.42857142857142855,1,0.0,0,0,0,0,2,0,0,1,0,0,3,1
5735,147760,Ie773JkkSDQvIHXsBZsmS2dO9aRzKpSr,fbPkOYLVPtPgIt0MxizjfFJov3JbHyAi,5,2,1,0,1,0,2,0,6,0.8571428571428571,1,0.0,0,1,0,1,2,0,0,2,0,2,4,0
5736,147765,FTc6jHk7ojdVaEQtsGdTEiSOrQxUe2mX,fbPkOYLVPtPgIt0MxizjfFJov3JbHyAi,5,2,1,0,1,0,2,0,6,0.8571428571428571,1,0.0,0,1,0,1,2,0,0,2,0,2,4,1
5737,147766,V7i4XepTGJkVDBndf2aQyywvfMxZi1VZ,fbPkOYLVPtPgIt0MxizjfFJov3JbHyAi,5,3,1,0,1,0,3,0,8,1.1428571428571428,1,0.0,0,1,0,1,3,0,0,3,0,2,6,1
5738,147767,pfujrhh6IFsgpvQm0YrnHZDUVmO3MMCt,fbPkOYLVPtPgIt0MxizjfFJov3JbHyAi,2,0,0,0,0,0,3,0,3,0.42857142857142855,1,0.0,0,0,0,0,0,0,0,3,0,0,3,1
5739,147777,ADt4SeNSXIM0T3FNDJeQ4CFmAhPZqDNW,fbPkOYLVPtPgIt0MxizjfFJov3JbHyAi,7,3,2,0,2,0,2,0,9,1.2857142857142858,1,0.0,0,2,0,2,3,0,0,2,0,4,5,1
5740,147779,BucCzwL2XP7gPTz7VVXQ2NN15VleWmxc,fbPkOYLVPtPgIt0MxizjfFJov3JbHyAi,7,3,2,0,2,0,2,0,9,1.2857142857142858,1,0.0,0,2,0,2,3,0,0,2,0,4,5,1
5741,147788,v80xARhw6o0qWoZhV3Z6c6dVXIF7GAis,fbPkOYLVPtPgIt0MxizjfFJov3JbHyAi,8,5,2,0,2,2,5,0,16,2.2857142857142856,1,0.0,0,2,0,2,5,2,0,5,0,4,12,1
5742,147792,rT1OrFQC18rdvYkTGYqwRgC7eDvihHsc,fbPkOYLVPtPgIt0MxizjfFJov3JbHyAi,1,0,0,0,0,2,0,0,2,0.2857142857142857,1,0.0,0,0,0,0,0,2,0,0,0,0,2,1
5743,148297,mSs5bB1Rxg3xYWjWjJY9pVTt7WAiMgyu,7GRhBDsirIGkRZBtSMEzNTyDr2JQm4xx,1,0,0,0,0,0,2,0,2,0.2857142857142857,1,0.0,0,0,0,0,0,0,0,2,0,0,2,0
5744,148349,9ygD0mCVCT1xftgjX9ZtkVBAEBAxmXMV,fbPkOYLVPtPgIt0MxizjfFJov3JbHyAi,4,3,2,0,2,0,1,0,8,1.1428571428571428,1,0.0,0,2,0,2,3,0,0,1,0,4,4,1
5745,148350,c9Dj079MYKUiWTTvAk5TtHXcSaCd3TDw,fbPkOYLVPtPgIt0MxizjfFJov3JbHyAi,5,3,2,0,0,0,8,0,13,1.8571428571428572,1,0.0,0,2,0,0,3,0,0,8,0,2,11,1
5746,148353,kxG2Ez4bVR5aERCBG6xs61rr9emGwqKo,fbPkOYLVPtPgIt0MxizjfFJov3JbHyAi,6,3,2,0,2,0,4,0,11,1.5714285714285714,3,0.0,0,2,0,2,3,0,0,4,0,4,7,1
5747,148358,bgLrRcnTjnOSlAj1yyvNbcR2GZlKU2gU,fbPkOYLVPtPgIt0MxizjfFJov3JbHyAi,25,30,13,12,10,15,2,0,82,11.714285714285714,1,0.0,12,13,10,10,18,15,2,2,0,45,37,1
5748,148366,fi4TXeoZ9lfPojTLqkoAXZWQgcUwi3WY,fbPkOYLVPtPgIt0MxizjfFJov3JbHyAi,9,5,5,0,5,4,7,1,27,3.857142857142857,2,0.0,0,5,0,5,5,4,0,7,1,10,17,1
5749,148367,CUHsvexAAfaCEMKsM3644JTxXL5DgSss,fbPkOYLVPtPgIt0MxizjfFJov3JbHyAi,5,3,2,0,2,0,2,0,9,1.2857142857142858,1,0.0,0,2,0,2,3,0,0,2,0,4,5,1
5750,148368,0oCNqxLZfnQykzt9jEtrYeCAvyN5aMiK,fbPkOYLVPtPgIt0MxizjfFJov3JbHyAi,2,0,0,0,0,0,5,0,5,0.7142857142857143,1,0.0,0,0,0,0,0,0,0,5,0,0,5,1
5751,148371,ULdF32fTmMpV957Ngz6P80D0kuxYFb2A,fbPkOYLVPtPgIt0MxizjfFJov3JbHyAi,1,0,0,0,0,0,1,0,1,0.14285714285714285,1,0.0,0,0,0,0,0,0,0,1,0,0,1,1
5752,148375,9LHCfUuBRybCFmCd7bbV3yZ92Mp8tv7j,fbPkOYLVPtPgIt0MxizjfFJov3JbHyAi,1,0,0,0,0,0,1,0,1,0.14285714285714285,1,0.0,0,0,0,0,0,0,0,1,0,0,1,1
5753,148378,KalDXAC9uFbnu9AKEx3pGk1aVT7IBvd6,fbPkOYLVPtPgIt0MxizjfFJov3JbHyAi,2,0,0,0,0,0,3,0,3,0.42857142857142855,1,0.0,0,0,0,0,0,0,0,3,0,0,3,1
5754,148379,MKj9RE36KMaNQttYmK1FP436E01YmNeZ,fbPkOYLVPtPgIt0MxizjfFJov3JbHyAi,2,0,0,0,0,0,2,0,2,0.2857142857142857,1,0.0,0,0,0,0,0,0,0,2,0,0,2,1
5755,148381,WYlT48XIScuGFSR7mYrH3M5CfjOCOMTP,fbPkOYLVPtPgIt0MxizjfFJov3JbHyAi,13,12,1,0,1,0,3,0,17,2.4285714285714284,1,0.0,0,1,0,1,12,0,0,3,0,2,15,1
5756,148382,qJEf5DGSDkSxZ1JIhipEbBFRbrhnAj1a,fbPkOYLVPtPgIt0MxizjfFJov3JbHyAi,6,8,2,0,1,0,2,0,13,1.8571428571428572,1,0.0,0,2,0,1,8,0,0,2,0,3,10,1
5757,148383,9TLjVfAVQirUv9D0iCSnjtMLWmZOKr0C,fbPkOYLVPtPgIt0MxizjfFJov3JbHyAi,7,3,2,0,2,0,4,0,11,1.5714285714285714,1,0.0,0,2,0,2,3,0,0,4,0,4,7,1
5758,148384,EQVGtOGC6NrveIndUoSckLgaBol5CW91,fbPkOYLVPtPgIt0MxizjfFJov3JbHyAi,1,0,0,0,0,0,1,0,1,0.14285714285714285,1,0.0,0,0,0,0,0,0,0,1,0,0,1,1
5759,148385,ciDinbfum1guAgZtUPEyI6UQ7y3ahoVh,fbPkOYLVPtPgIt0MxizjfFJov3JbHyAi,6,3,2,0,2,0,1,0,8,1.1428571428571428,1,0.0,0,2,0,2,3,0,0,1,0,4,4,1
5760,148388,idmrxuEoIjSYuzZhdG66vR2sh6aBS2ui,fbPkOYLVPtPgIt0MxizjfFJov3JbHyAi,2,0,0,0,0,0,2,0,2,0.2857142857142857,1,0.0,0,0,0,0,0,0,0,2,0,0,2,1
5761,148465,aISyThuiw10fsCPPUtqVz2ccwIDIESls,G8EPVSXsOYB5YQWZGiz1aVq5Pgr2GrQu,67,129,74,156,0,80,36,6,481,68.71428571428571,7,0.0,9,74,137,0,120,80,19,36,6,220,261,0
5762,148503,9CQfIvDiQz4gDArSnTXOgxNKUwJW75pD,SpATywNh6bZuzm8s1ceuBUnMUAeoAHHw,31,46,27,35,10,2,24,3,147,21.0,3,0.0,7,27,30,10,39,2,5,24,3,74,73,0
5763,148611,oGTSG0bYZEKmqMQUI2QOgfbr6I1mZJJh,SpATywNh6bZuzm8s1ceuBUnMUAeoAHHw,14,22,1,18,1,0,21,1,64,9.142857142857142,2,0.0,7,1,15,1,15,0,3,21,1,24,40,1
5764,148708,QffrhmaCXbaB9XOhV3NLOmPuRvGWA3G5,SpATywNh6bZuzm8s1ceuBUnMUAeoAHHw,16,7,4,9,3,0,5,1,29,4.142857142857143,1,0.0,2,4,9,3,5,0,0,5,1,18,11,1
5765,148724,4YDp1nxKf6ZgyVxOrG2MY3nyG30jIlTN,SpATywNh6bZuzm8s1ceuBUnMUAeoAHHw,14,25,11,10,6,0,9,0,61,8.714285714285714,3,0.0,3,11,9,6,22,0,1,9,0,29,32,1
5766,148773,f2RxaLdYf2Tr0XIXAiBwlA7VXVA1XDPz,SpATywNh6bZuzm8s1ceuBUnMUAeoAHHw,17,39,16,20,6,4,12,1,98,14.0,1,0.0,17,16,16,6,22,4,4,12,1,55,43,1
5767,148776,6EaK0gHFiSwbLJpDVBHv9ZNNoyIiEert,SpATywNh6bZuzm8s1ceuBUnMUAeoAHHw,13,36,7,17,0,0,4,0,64,9.142857142857142,2,0.0,23,7,17,0,13,0,0,4,0,47,17,0
5768,148992,4OV0W0nOUO05rXo3pxbmiSLc9O458KIT,SpATywNh6bZuzm8s1ceuBUnMUAeoAHHw,3,1,0,0,0,0,2,0,3,0.42857142857142855,1,0.0,0,0,0,0,1,0,0,2,0,0,3,0
5769,149014,5UJZmEar1AX3gQXOzkh3MnQcYdErI17M,bWdj2GDclj5ofokWjzoa5jAwMkxCykd6,6,5,3,0,2,7,2,0,19,2.7142857142857144,1,0.0,0,3,0,2,5,7,0,2,0,5,14,0
5770,149570,8958pt2z4OHwTl32JK0k9CAPziEN4Bzu,SpATywNh6bZuzm8s1ceuBUnMUAeoAHHw,5,3,0,0,0,11,4,0,18,2.5714285714285716,1,0.0,0,0,0,0,3,11,0,4,0,0,18,1
5771,149617,8aV4yRTVM0HzdlWjuQKHgiNXm0RErk1U,bWdj2GDclj5ofokWjzoa5jAwMkxCykd6,4,2,0,0,0,0,5,0,7,1.0,1,0.0,0,0,0,0,2,0,0,5,0,0,7,0
5772,149692,7AAdXAGWvappN7B38jOB9fzxLSuIXADG,RXDvfPUBYFlVdlueBFbLW0mhhAyGEqpt,5,2,1,0,1,0,2,0,6,0.8571428571428571,1,0.0,0,1,0,1,2,0,0,2,0,2,4,0
5773,149724,p5nLTT7lxlGHa4qmyYsgcjTpAWKheo2V,A3fsA9Zfv1X2fVEQhTw51lKENdNrEqT3,14,5,4,0,4,0,19,2,34,4.857142857142857,1,0.0,0,4,0,4,5,0,0,19,2,8,26,1
5774,149816,U8u2oofRYkvAFc5S0d9MPpENNm076FZl,G8EPVSXsOYB5YQWZGiz1aVq5Pgr2GrQu,16,17,1,28,1,3,8,0,58,8.285714285714286,1,0.0,2,1,24,1,15,3,4,8,0,28,30,0
5775,149877,SANLEmv2xqr9UbPUpTzbFGNJfLVXFrzf,SpATywNh6bZuzm8s1ceuBUnMUAeoAHHw,15,21,1,21,0,38,9,1,91,13.0,1,0.0,7,1,17,0,14,38,4,9,1,25,66,1
5776,149950,byUmCtzRLWWrWRajFZnozMEalaeEKWAr,RXDvfPUBYFlVdlueBFbLW0mhhAyGEqpt,24,16,10,28,7,0,2,0,63,9.0,2,0.0,3,10,26,7,13,0,2,2,0,46,17,1
5777,152852,8eAVRzls7MGQwc3WaPP7ONmygmpXQE3K,7GRhBDsirIGkRZBtSMEzNTyDr2JQm4xx,29,32,12,33,9,1,2,0,89,12.714285714285714,1,0.0,18,12,30,9,14,1,3,2,0,69,20,1
5778,152889,4BpRE14XuCFERPNFltqE4ojcMHw6pKyT,7GRhBDsirIGkRZBtSMEzNTyDr2JQm4xx,6,2,1,0,1,0,3,0,7,1.0,1,0.0,0,1,0,1,2,0,0,3,0,2,5,1
5779,152924,1UDHQI8imw8nweB1TYtOC79yWWeAk6dI,7GRhBDsirIGkRZBtSMEzNTyDr2JQm4xx,1,0,0,0,0,0,1,0,1,0.14285714285714285,1,0.0,0,0,0,0,0,0,0,1,0,0,1,1
5780,152950,2bFnB4uI8l4fyqIbUzJ6PgGAsqDupazk,7GRhBDsirIGkRZBtSMEzNTyDr2JQm4xx,5,2,0,0,0,2,4,0,8,1.1428571428571428,1,0.0,0,0,0,0,2,2,0,4,0,0,8,1
5781,153021,dcAfcDe1XQG4OPzTBHUeq4qqwRgLRIBM,7GRhBDsirIGkRZBtSMEzNTyDr2JQm4xx,33,36,18,42,20,3,3,0,122,17.428571428571427,1,0.0,16,18,40,20,20,3,2,3,0,94,28,1
5782,153052,UfBZxbp3dHdvs4dmjpPF1a599SiVHfq9,7GRhBDsirIGkRZBtSMEzNTyDr2JQm4xx,13,14,7,0,4,0,3,0,28,4.0,1,0.0,0,7,0,4,14,0,0,3,0,11,17,1
5783,153070,nNeSwHjoP91mmln5SrcL87TOEBs15zTk,7GRhBDsirIGkRZBtSMEzNTyDr2JQm4xx,2,0,0,0,0,0,2,0,2,0.2857142857142857,1,0.0,0,0,0,0,0,0,0,2,0,0,2,1
5784,153072,IOcEoixO9HVhIQeLNHKaS3iQynrmSTmV,7GRhBDsirIGkRZBtSMEzNTyDr2JQm4xx,40,148,34,63,6,37,29,3,320,45.714285714285715,4,0.0,87,34,49,6,61,37,14,29,3,176,144,0
5785,153082,pc8Cijkar16XHq3iOS71C2O61xVOM7hS,7GRhBDsirIGkRZBtSMEzNTyDr2JQm4xx,1,0,0,0,0,0,1,0,1,0.14285714285714285,1,0.0,0,0,0,0,0,0,0,1,0,0,1,1
5786,153106,4dWOmHqqlMb2FlRY2mDnSBR6FrPBKxXO,7GRhBDsirIGkRZBtSMEzNTyDr2JQm4xx,2,0,0,0,0,0,5,0,5,0.7142857142857143,1,0.0,0,0,0,0,0,0,0,5,0,0,5,1
5787,153205,pvxjw4szSuluDWQ3DWPes9Mzs1MCvxjI,SpATywNh6bZuzm8s1ceuBUnMUAeoAHHw,29,33,19,36,10,6,18,4,126,18.0,5,0.0,6,19,30,10,27,6,6,18,4,65,61,1
5788,153209,5ZHw0M7FTk5cO1fK8KsZKsofS7GANtcz,SpATywNh6bZuzm8s1ceuBUnMUAeoAHHw,14,22,2,10,0,17,7,1,59,8.428571428571429,1,0.0,5,2,9,0,17,17,1,7,1,16,43,1
5789,153222,qGeBgOr7St26ZmQVIT5NibjBEisNw9ln,SpATywNh6bZuzm8s1ceuBUnMUAeoAHHw,23,34,21,11,5,2,11,1,85,12.142857142857142,5,0.0,2,21,10,5,32,2,1,11,1,38,47,1
5790,153223,4iqKNHeZS5JSEDCOEGY9iVAlANRyx0Hy,bWdj2GDclj5ofokWjzoa5jAwMkxCykd6,1,0,0,0,0,0,1,0,1,0.14285714285714285,1,0.0,0,0,0,0,0,0,0,1,0,0,1,1
5791,153230,9pfskqYp4pvR53OXPIHxfdcjDCQolJRR,SpATywNh6bZuzm8s1ceuBUnMUAeoAHHw,25,14,9,19,5,4,8,0,59,8.428571428571429,2,0.0,4,9,17,5,10,4,2,8,0,35,24,1
5792,153240,HKDSRzc7MQzCfJsk49D6xFQK4oFHHvy7,G8EPVSXsOYB5YQWZGiz1aVq5Pgr2GrQu,11,7,1,6,2,0,7,0,23,3.2857142857142856,2,0.0,5,1,3,2,2,0,3,7,0,11,12,1
5793,153250,b9mxLoVADmerKv5HkkvTTWu7wHJ0K2g8,RXDvfPUBYFlVdlueBFbLW0mhhAyGEqpt,5,3,1,0,1,0,1,0,6,0.8571428571428571,1,0.0,0,1,0,1,3,0,0,1,0,2,4,1
5794,153254,CxT0CHLq6J1c8Jut4aoI3ctVaIuJrmZd,SpATywNh6bZuzm8s1ceuBUnMUAeoAHHw,6,2,1,0,1,0,4,0,8,1.1428571428571428,1,0.0,0,1,0,1,2,0,0,4,0,2,6,1
5795,153304,AxjnggPTKyT2aYQCBpgnjenDZZbNsOpc,SpATywNh6bZuzm8s1ceuBUnMUAeoAHHw,15,13,2,4,0,0,2,0,21,3.0,2,0.0,0,2,4,0,13,0,0,2,0,6,15,0
5796,153320,17nF9FTjTWCsbOCjXVTb0OZUIQSKIDV1,SpATywNh6bZuzm8s1ceuBUnMUAeoAHHw,5,3,1,0,1,0,1,0,6,0.8571428571428571,1,0.0,0,1,0,1,3,0,0,1,0,2,4,1
5797,153335,OgqpjGMMInWS9PhYsy4mlMX0fhVM7tcA,SpATywNh6bZuzm8s1ceuBUnMUAeoAHHw,16,32,9,16,5,4,2,0,68,9.714285714285714,2,0.0,11,9,14,5,21,4,2,2,0,39,29,1
5798,153344,zFxBEkWmbKmgcm9gb8oYLXK8dhxOMTgG,bWdj2GDclj5ofokWjzoa5jAwMkxCykd6,4,2,1,0,1,0,1,0,5,0.7142857142857143,1,0.0,0,1,0,1,2,0,0,1,0,2,3,1
5799,153359,OsZOOHLTzswhvwcqovfIZ4d3mMdzbQV4,bWdj2GDclj5ofokWjzoa5jAwMkxCykd6,4,2,0,0,0,0,2,0,4,0.5714285714285714,1,0.0,0,0,0,0,2,0,0,2,0,0,4,1
5800,153377,pShr7F4fdPHy76vFAX1gnyjDQNfbMT7w,SpATywNh6bZuzm8s1ceuBUnMUAeoAHHw,9,6,4,0,3,0,5,0,18,2.5714285714285716,1,0.0,0,4,0,3,6,0,0,5,0,7,11,1
5801,153381,mgLL2TOXKEK8di2v3UUyM4FMUqEuj4kl,bWdj2GDclj5ofokWjzoa5jAwMkxCykd6,1,0,0,0,0,0,1,0,1,0.14285714285714285,1,0.0,0,0,0,0,0,0,0,1,0,0,1,1
5802,153388,afQkAxUvdLu532EqkP2BO2E822Re7HYk,A3fsA9Zfv1X2fVEQhTw51lKENdNrEqT3,1,0,0,0,0,0,1,0,1,0.14285714285714285,1,0.0,0,0,0,0,0,0,0,1,0,0,1,1
5803,153389,afQkAxUvdLu532EqkP2BO2E822Re7HYk,bWdj2GDclj5ofokWjzoa5jAwMkxCykd6,1,0,0,0,0,0,1,0,1,0.14285714285714285,1,0.0,0,0,0,0,0,0,0,1,0,0,1,1
5804,153404,ZoDpWjHIWpxSzHmkG8xPsIIgTQq9K5uN,SpATywNh6bZuzm8s1ceuBUnMUAeoAHHw,15,20,7,15,1,2,6,1,52,7.428571428571429,3,0.0,9,7,14,1,11,2,1,6,1,31,21,1
5805,153443,ngup3fucB3JZQIAGeEk4g3OEqzwFokS0,A3fsA9Zfv1X2fVEQhTw51lKENdNrEqT3,15,7,6,0,6,3,6,0,28,4.0,1,0.0,0,6,0,6,7,3,0,6,0,12,16,1
5806,153457,cYe4n4c9KPDfBEWjGIRj6ImLxtmj3FnE,SpATywNh6bZuzm8s1ceuBUnMUAeoAHHw,24,32,15,4,8,1,9,2,71,10.142857142857142,3,0.0,0,15,4,8,32,1,0,9,2,27,44,0
5807,153527,7abxlkdMiNWAIk78NzVnHWo2fZI6eMvl,G8EPVSXsOYB5YQWZGiz1aVq5Pgr2GrQu,1,0,0,0,0,0,1,0,1,0.14285714285714285,1,0.0,0,0,0,0,0,0,0,1,0,0,1,1
5808,153528,Xbyo7HUsTZeFyBz3S4UH7TOjaOcOatNR,G8EPVSXsOYB5YQWZGiz1aVq5Pgr2GrQu,14,9,4,10,2,1,7,0,33,4.714285714285714,1,0.0,3,4,7,2,6,1,3,7,0,16,17,1
5809,153554,5ESBYT4YXwThMhRWcyNvUGRmyEr1sxDg,A3fsA9Zfv1X2fVEQhTw51lKENdNrEqT3,8,9,4,0,2,0,2,0,17,2.4285714285714284,2,0.0,0,4,0,2,9,0,0,2,0,6,11,0
5810,153591,wnrnl9khoFP1InwfVTZawT3pFxBvI7k9,SpATywNh6bZuzm8s1ceuBUnMUAeoAHHw,16,15,2,10,3,0,4,0,34,4.857142857142857,1,0.0,4,2,8,3,11,0,2,4,0,17,17,1
5811,153593,UBlBWZ3qSNiPpjfNB2f0HBLc8JT09fQp,bWdj2GDclj5ofokWjzoa5jAwMkxCykd6,1,0,0,0,0,0,1,0,1,0.14285714285714285,1,0.0,0,0,0,0,0,0,0,1,0,0,1,1
5812,153600,f1mXA42Iut2h3an7dNcb6e25YzQPcYho,SpATywNh6bZuzm8s1ceuBUnMUAeoAHHw,28,47,20,27,11,0,6,0,111,15.857142857142858,3,0.0,10,20,25,11,37,0,2,6,0,66,45,1
5813,153603,bGlyGIDBiTQ9cORO6s00PigGAgG0feOe,bWdj2GDclj5ofokWjzoa5jAwMkxCykd6,12,14,0,48,2,6,3,1,74,10.571428571428571,1,0.0,6,0,47,2,8,6,1,3,1,55,19,1
5814,153638,npggYhQDuWIBT1CD0vElHVM5v5VjjGlP,SpATywNh6bZuzm8s1ceuBUnMUAeoAHHw,12,9,5,0,4,0,3,0,21,3.0,2,0.0,0,5,0,4,9,0,0,3,0,9,12,1
5815,153642,y0PkAopIdLmRFrkWC9eBHvWT77KfVWMh,SpATywNh6bZuzm8s1ceuBUnMUAeoAHHw,13,24,11,0,7,0,3,0,45,6.428571428571429,2,0.0,0,11,0,7,24,0,0,3,0,18,27,1
5816,153643,1pusTPLSLF5m0UuZqZkNpGlAq8VrQ1KA,G8EPVSXsOYB5YQWZGiz1aVq5Pgr2GrQu,1,0,0,0,0,0,1,0,1,0.14285714285714285,1,0.0,0,0,0,0,0,0,0,1,0,0,1,1
5817,153651,4arExpTK1wIuXqxD9mjuWbelMebzEsNU,SpATywNh6bZuzm8s1ceuBUnMUAeoAHHw,5,2,1,0,1,0,2,0,6,0.8571428571428571,1,0.0,0,1,0,1,2,0,0,2,0,2,4,1
5818,153665,2mwblOfAIlWCnOpKEy9s0V1Ag6iOs76e,SpATywNh6bZuzm8s1ceuBUnMUAeoAHHw,1,0,0,0,0,0,1,0,1,0.14285714285714285,1,0.0,0,0,0,0,0,0,0,1,0,0,1,1
5819,153668,0ORnjZDNtR58wRPjDahIQtI1SSJa0QxJ,SpATywNh6bZuzm8s1ceuBUnMUAeoAHHw,14,13,7,15,5,0,4,0,44,6.285714285714286,1,0.0,5,7,14,5,8,0,1,4,0,31,13,1
5820,153684,htua1xywlnpsMMY7EJSOsurL86GI912X,A3fsA9Zfv1X2fVEQhTw51lKENdNrEqT3,28,8,4,96,1,0,7,0,116,16.571428571428573,1,0.0,2,4,80,1,6,0,16,7,0,87,29,1
5821,153697,JVadOLmYm00UY6RpVFCz6oCIzPWjF9Xb,bWdj2GDclj5ofokWjzoa5jAwMkxCykd6,4,4,1,0,2,0,1,0,8,1.1428571428571428,1,0.0,2,1,0,2,2,0,0,1,0,5,3,1
5822,153698,imNhKIaFauvST7J9xfEWryq9BWP5AbNf,SpATywNh6bZuzm8s1ceuBUnMUAeoAHHw,1,0,0,0,0,0,1,0,1,0.14285714285714285,1,0.0,0,0,0,0,0,0,0,1,0,0,1,1
5823,153705,imNhKIaFauvST7J9xfEWryq9BWP5AbNf,RXDvfPUBYFlVdlueBFbLW0mhhAyGEqpt,1,0,0,0,0,0,1,0,1,0.14285714285714285,1,0.0,0,0,0,0,0,0,0,1,0,0,1,1
5824,153708,cX96KcLUG7eWbqHO7enIWngg59YqtKEY,SpATywNh6bZuzm8s1ceuBUnMUAeoAHHw,13,32,14,14,1,4,9,2,76,10.857142857142858,3,0.0,13,14,13,1,19,4,1,9,2,41,35,1
5825,153744,ttb5iuebPMlcVHZPAjxVbJ8njCe9OqDr,SpATywNh6bZuzm8s1ceuBUnMUAeoAHHw,15,17,3,18,3,0,7,0,48,6.857142857142857,3,0.0,2,3,15,3,15,0,3,7,0,23,25,1
5826,153745,lBUrinPM7S9o6yK6K8JSMwJaVRnBcZFO,bWdj2GDclj5ofokWjzoa5jAwMkxCykd6,4,2,0,0,0,0,3,0,5,0.7142857142857143,1,0.0,0,0,0,0,2,0,0,3,0,0,5,1
5827,153761,VEn1n8siGoYMgQvsRJOH6Mt6C0Cu6W64,SpATywNh6bZuzm8s1ceuBUnMUAeoAHHw,28,23,17,24,11,0,3,0,78,11.142857142857142,3,0.0,4,17,23,11,19,0,1,3,0,55,23,1
5828,153775,NDTWRDiLyYPUSKAzpsOEnrkggSOfO91T,SpATywNh6bZuzm8s1ceuBUnMUAeoAHHw,27,62,36,36,17,0,6,0,157,22.428571428571427,3,0.0,17,36,32,17,45,0,4,6,0,102,55,1
5829,153790,IA8IlgrjDUbf5IQm26Ve5t8QQHZhw82k,SpATywNh6bZuzm8s1ceuBUnMUAeoAHHw,1,0,0,0,0,0,1,0,1,0.14285714285714285,1,0.0,0,0,0,0,0,0,0,1,0,0,1,1
5830,153802,JrfTo5GNjMn6EHzlMiG1fSQLURYPPGKs,bWdj2GDclj5ofokWjzoa5jAwMkxCykd6,2,0,0,0,0,0,4,0,4,0.5714285714285714,1,0.0,0,0,0,0,0,0,0,4,0,0,4,1
5831,153806,VhpXVmuePjSLeMVIlElMMladDGd0odWC,bWdj2GDclj5ofokWjzoa5jAwMkxCykd6,17,17,6,24,0,3,4,0,54,7.714285714285714,1,0.0,6,6,23,0,11,3,1,4,0,35,19,0
5832,153810,pGNIRV05CYiaTTY4zIoziuGcEcxqXgio,A3fsA9Zfv1X2fVEQhTw51lKENdNrEqT3,5,1,0,0,0,0,3,2,6,0.8571428571428571,1,0.0,0,0,0,0,1,0,0,3,2,0,6,1
5833,153815,ocmyq6MXRULfgpYdGM8QGfWnP2Queprt,RXDvfPUBYFlVdlueBFbLW0mhhAyGEqpt,1,0,0,0,0,0,1,0,1,0.14285714285714285,1,0.0,0,0,0,0,0,0,0,1,0,0,1,1
5834,153857,BsO4gYCEUXQGKYLyHXV4q0f2CE6gKQPc,bWdj2GDclj5ofokWjzoa5jAwMkxCykd6,2,0,0,0,0,0,2,0,2,0.2857142857142857,1,0.0,0,0,0,0,0,0,0,2,0,0,2,1
5835,153860,ZNBGAlJve4TYJ3FcDlTLBdyuklADldDZ,A3fsA9Zfv1X2fVEQhTw51lKENdNrEqT3,6,5,3,0,1,0,2,0,11,1.5714285714285714,2,0.0,0,3,0,1,5,0,0,2,0,4,7,1
5836,153882,WY9Kk93NuRsoZvVUYcqVREh3xtBHbvAb,SpATywNh6bZuzm8s1ceuBUnMUAeoAHHw,1,0,0,0,0,0,2,0,2,0.2857142857142857,1,0.0,0,0,0,0,0,0,0,2,0,0,2,1
5837,153883,5hosZ8hQASGCVLdW9XYMecTXS9o9Kexh,G8EPVSXsOYB5YQWZGiz1aVq5Pgr2GrQu,7,3,2,0,2,0,2,0,9,1.2857142857142858,1,0.0,0,2,0,2,3,0,0,2,0,4,5,1
5838,153898,q9ayVwEoKiDDsIKc3IAHGSTn37C2BcId,SpATywNh6bZuzm8s1ceuBUnMUAeoAHHw,1,0,0,0,0,0,4,0,4,0.5714285714285714,1,0.0,0,0,0,0,0,0,0,4,0,0,4,1
5839,153916,fg9xG7J3hLazBdFakHteLNxtYgOMtOn7,SpATywNh6bZuzm8s1ceuBUnMUAeoAHHw,5,5,1,0,1,0,3,0,10,1.4285714285714286,1,0.0,2,1,0,1,3,0,0,3,0,4,6,1
5840,153925,LH8Ugxvjxhypkt5v1imhfncDCGMVYvOX,SpATywNh6bZuzm8s1ceuBUnMUAeoAHHw,7,46,3,0,1,1,15,0,66,9.428571428571429,1,0.0,0,3,0,1,46,1,0,15,0,4,62,1
5841,153930,a7HqL5rVaBWdmJJ0LA7o4pdEGfF0vFCf,SpATywNh6bZuzm8s1ceuBUnMUAeoAHHw,24,18,11,29,6,0,3,0,67,9.571428571428571,1,0.0,6,11,28,6,12,0,1,3,0,51,16,1
5842,153939,ECkqmAuIkv3ncN9wNJby8oOn15qTd9kR,bWdj2GDclj5ofokWjzoa5jAwMkxCykd6,2,0,0,0,0,0,3,0,3,0.42857142857142855,3,0.0,0,0,0,0,0,0,0,3,0,0,3,1
5843,153960,lHqG7UT3evpRhAVEeXMKWozC3OBfRB6b,bWdj2GDclj5ofokWjzoa5jAwMkxCykd6,4,1,1,0,0,0,2,0,4,0.5714285714285714,1,0.0,0,1,0,0,1,0,0,2,0,1,3,1
5844,153970,rK6GKHeyjKWUALwDzkIRQ6keCnDOngXi,SpATywNh6bZuzm8s1ceuBUnMUAeoAHHw,9,10,3,8,0,0,6,0,27,3.857142857142857,3,0.0,6,3,8,0,4,0,0,6,0,17,10,1
5845,153980,RuTxY8DaJW8mZYxEAeQrQJD3l4wbq41Q,A3fsA9Zfv1X2fVEQhTw51lKENdNrEqT3,9,5,1,0,1,0,5,0,12,1.7142857142857142,1,0.0,0,1,0,1,5,0,0,5,0,2,10,1
5846,153981,PWSenA2xTFV9h2dRBUmJc6Dd5CU49Bfk,SpATywNh6bZuzm8s1ceuBUnMUAeoAHHw,8,3,3,0,2,0,6,0,14,2.0,3,0.0,0,3,0,2,3,0,0,6,0,5,9,1
5847,153987,tWEnJYIhXMJ03Foo959mubaAJUHZPTw0,bWdj2GDclj5ofokWjzoa5jAwMkxCykd6,1,0,0,0,0,0,1,0,1,0.14285714285714285,1,0.0,0,0,0,0,0,0,0,1,0,0,1,1
5848,153994,y0CnonzJAddQ4oYr5LBSP0Y6KP3RgPGg,bWdj2GDclj5ofokWjzoa5jAwMkxCykd6,3,2,1,0,0,0,1,0,4,0.5714285714285714,1,0.0,0,1,0,0,2,0,0,1,0,1,3,1
5849,154004,Cf7GCeUZzG7WjvUIyGfwv9hfcwXPVq5G,SpATywNh6bZuzm8s1ceuBUnMUAeoAHHw,16,34,1,15,1,9,9,0,69,9.857142857142858,6,0.0,3,1,14,1,31,9,1,9,0,19,50,0
5850,154030,ijmzTkXDQO41J49xgIf8BYjGtAGyN9zu,SpATywNh6bZuzm8s1ceuBUnMUAeoAHHw,1,0,0,0,0,0,1,0,1,0.14285714285714285,1,0.0,0,0,0,0,0,0,0,1,0,0,1,1
5851,154035,DHCzWncH94ErnybHPppeaE2nTRJmmMhY,SpATywNh6bZuzm8s1ceuBUnMUAeoAHHw,32,95,37,41,13,44,17,6,253,36.142857142857146,2,0.0,45,37,33,13,50,44,8,17,6,128,125,1
5852,154042,2K1Z8MHkxSfa3IoXQMOOkvPRYry0VFvS,A3fsA9Zfv1X2fVEQhTw51lKENdNrEqT3,6,3,2,0,2,0,1,0,8,1.1428571428571428,1,0.0,0,2,0,2,3,0,0,1,0,4,4,1
5853,154089,HiNePj7VyLNET123cNCa7VjP10PYv5CS,SpATywNh6bZuzm8s1ceuBUnMUAeoAHHw,9,9,4,0,2,0,2,0,17,2.4285714285714284,1,0.0,4,4,0,2,5,0,0,2,0,10,7,1
5854,154117,BdPEjrNeRWORvoAvmySSATaD7FpfgjJ7,bWdj2GDclj5ofokWjzoa5jAwMkxCykd6,1,0,0,0,0,0,1,0,1,0.14285714285714285,1,0.0,0,0,0,0,0,0,0,1,0,0,1,1
5855,154119,BdPEjrNeRWORvoAvmySSATaD7FpfgjJ7,A3fsA9Zfv1X2fVEQhTw51lKENdNrEqT3,4,0,0,0,0,0,3,1,4,0.5714285714285714,1,0.0,0,0,0,0,0,0,0,3,1,0,4,1
5856,154123,vljlAhHGhHZt2ciFpy2bQxMoEL2SUwdk,SpATywNh6bZuzm8s1ceuBUnMUAeoAHHw,7,4,1,0,1,0,2,0,8,1.1428571428571428,1,0.0,0,1,0,1,4,0,0,2,0,2,6,1
5857,154133,zUPpTYisLLzFG12BVDvWrty0j8q1G6Si,SpATywNh6bZuzm8s1ceuBUnMUAeoAHHw,14,21,1,11,2,5,7,1,48,6.857142857142857,4,0.0,8,1,10,2,13,5,1,7,1,21,27,0
5858,154181,BXV7sGq2IrRSqCFuLKgoxpKYDPSPpUSj,A3fsA9Zfv1X2fVEQhTw51lKENdNrEqT3,2,0,0,0,0,0,2,0,2,0.2857142857142857,2,0.0,0,0,0,0,0,0,0,2,0,0,2,1
5859,154194,fZpfLVVUEp7GXISLcNFyxWveiOP0dldp,G8EPVSXsOYB5YQWZGiz1aVq5Pgr2GrQu,10,10,0,0,1,0,2,0,13,1.8571428571428572,1,0.0,0,0,0,1,10,0,0,2,0,1,12,0
5860,154222,Csfk45aTs4wr0LJ69dzlrUlkEXjL89zd,bWdj2GDclj5ofokWjzoa5jAwMkxCykd6,4,2,1,0,1,3,2,0,9,1.2857142857142858,1,0.0,0,1,0,1,2,3,0,2,0,2,7,0
5861,154303,UsP8UHahXGHaChNTAHL4dZh6OmvP94L7,7GRhBDsirIGkRZBtSMEzNTyDr2JQm4xx,15,12,6,0,5,13,9,1,46,6.571428571428571,2,0.0,0,6,0,5,12,13,0,9,1,11,35,1
5862,154318,27pUZlupG1aVjIY0f9PLE1OvbJSBVMXw,SpATywNh6bZuzm8s1ceuBUnMUAeoAHHw,30,29,17,33,9,2,6,1,97,13.857142857142858,1,0.0,8,17,27,9,21,2,6,6,1,61,36,1
5863,154341,zHI8MHuExufwDJ1uuBe75QQrzwho6OSZ,RXDvfPUBYFlVdlueBFbLW0mhhAyGEqpt,49,127,41,133,33,31,42,1,408,58.285714285714285,1,0.0,68,41,114,33,59,31,19,42,1,256,152,0
5864,154415,sL5jw3pLWZoRI7avI17oM60mfF67Acgz,bWdj2GDclj5ofokWjzoa5jAwMkxCykd6,1,0,0,0,0,0,1,0,1,0.14285714285714285,1,0.0,0,0,0,0,0,0,0,1,0,0,1,0
5865,154555,hUoOQP103jtoSjE8huNXPy5FlXS050j3,7GRhBDsirIGkRZBtSMEzNTyDr2JQm4xx,4,2,1,0,0,0,2,0,5,0.7142857142857143,1,0.0,0,1,0,0,2,0,0,2,0,1,4,1
5866,154570,EXZ81qqSldwR1xdBEwBZ7wmgbTHF86sl,A3fsA9Zfv1X2fVEQhTw51lKENdNrEqT3,39,22,19,88,15,0,2,0,146,20.857142857142858,2,0.0,1,19,69,15,21,0,19,2,0,104,42,0
5867,154572,IZjvzkwq6mW6mk7nIYbEArtjalxzWdW9,SpATywNh6bZuzm8s1ceuBUnMUAeoAHHw,4,2,1,0,1,0,1,0,5,0.7142857142857143,1,0.0,0,1,0,1,2,0,0,1,0,2,3,1
5868,154617,Z9nbZek76s4RBuA56w1WtME3e9ClZkaP,7GRhBDsirIGkRZBtSMEzNTyDr2JQm4xx,4,2,0,0,0,0,2,0,4,0.5714285714285714,1,0.0,0,0,0,0,2,0,0,2,0,0,4,1
5869,154630,PE4KBwh4ltl7dienGR8pJbew7yjFv3Vz,RXDvfPUBYFlVdlueBFbLW0mhhAyGEqpt,51,83,37,82,24,16,18,1,261,37.285714285714285,1,0.0,33,37,76,24,50,16,6,18,1,170,91,0
5870,154662,5U79KRZxDDBIetuxjK0KXphUhzbxTzjr,SpATywNh6bZuzm8s1ceuBUnMUAeoAHHw,7,6,3,0,2,0,3,0,14,2.0,2,0.0,0,3,0,2,6,0,0,3,0,5,9,0
5871,154691,ZnPDiA6jmqQOIbODvVYNoIgZSaO1dso9,7GRhBDsirIGkRZBtSMEzNTyDr2JQm4xx,5,2,1,0,1,0,2,0,6,0.8571428571428571,1,0.0,0,1,0,1,2,0,0,2,0,2,4,1
5872,154722,wEtddkCnDW67OGRvoryp7gzDvLpg5XYx,7GRhBDsirIGkRZBtSMEzNTyDr2JQm4xx,2,0,0,0,0,0,2,0,2,0.2857142857142857,1,0.0,0,0,0,0,0,0,0,2,0,0,2,1
5873,154784,Hz0LP3au6HFJJqiLBqYxNiliqJ4HLt82,7GRhBDsirIGkRZBtSMEzNTyDr2JQm4xx,2,0,0,0,0,0,2,0,2,0.2857142857142857,1,0.0,0,0,0,0,0,0,0,2,0,0,2,1
5874,154795,X7yAkPsl5rqRM0rJWJ1Nk7IUSPBbdZXP,7GRhBDsirIGkRZBtSMEzNTyDr2JQm4xx,2,0,0,0,0,0,3,0,3,0.42857142857142855,2,0.0,0,0,0,0,0,0,0,3,0,0,3,1
5875,154819,9bv4TssyKs6woXSaEFvigyhEyIkdO1mQ,SpATywNh6bZuzm8s1ceuBUnMUAeoAHHw,7,5,4,0,3,0,1,0,13,1.8571428571428572,1,0.0,0,4,0,3,5,0,0,1,0,7,6,1
5876,154867,GnGb3MjVBgYFavJRehOmmU05ktvVgJLM,SpATywNh6bZuzm8s1ceuBUnMUAeoAHHw,12,16,2,9,0,0,8,0,35,5.0,3,0.0,2,2,9,0,14,0,0,8,0,13,22,0
5877,154879,eLVxEJXOj5JCDBaPnfFyMxorDIkKR9kF,7GRhBDsirIGkRZBtSMEzNTyDr2JQm4xx,5,4,0,0,0,0,2,0,6,0.8571428571428571,1,0.0,0,0,0,0,4,0,0,2,0,0,6,1
5878,154900,MQZ83qOJRka3gcNvl5FCRvHenmiUnsd9,7GRhBDsirIGkRZBtSMEzNTyDr2JQm4xx,7,5,0,0,0,4,4,0,13,1.8571428571428572,1,0.0,1,0,0,0,4,4,0,4,0,1,12,1
5879,154958,uCkUGoRSr1o0e7C3DgvaHjtZmuIVbEoc,7GRhBDsirIGkRZBtSMEzNTyDr2JQm4xx,16,19,4,16,7,0,4,0,50,7.142857142857143,1,0.0,14,4,14,7,5,0,2,4,0,39,11,1
5880,154969,zWDepCfjbS7ISrpw6SZrVfUm7fvpWJYm,RXDvfPUBYFlVdlueBFbLW0mhhAyGEqpt,44,33,19,56,20,0,4,0,132,18.857142857142858,1,0.0,11,19,54,20,22,0,2,4,0,104,28,1
5881,154971,T6EWQ7jVP89JlHzj41KN1gEtGYevpSQM,7GRhBDsirIGkRZBtSMEzNTyDr2JQm4xx,22,29,16,5,10,1,3,0,64,9.142857142857142,2,0.0,10,16,5,10,19,1,0,3,0,41,23,1
5882,155081,erkNYBqLpKRElyeL8GeAgO43CMazg6Rt,7GRhBDsirIGkRZBtSMEzNTyDr2JQm4xx,4,0,0,0,0,0,4,0,4,0.5714285714285714,1,0.0,0,0,0,0,0,0,0,4,0,0,4,1
5883,155201,Yg9hgHRSCdpITsjHOmkyqEwp1aNMC9ra,7GRhBDsirIGkRZBtSMEzNTyDr2JQm4xx,4,2,0,0,0,0,4,0,6,0.8571428571428571,2,0.0,0,0,0,0,2,0,0,4,0,0,6,1
5884,155228,QZIRHdwFgibI2SBehTrmLAZxED1F4JL7,SpATywNh6bZuzm8s1ceuBUnMUAeoAHHw,7,8,3,0,1,0,2,0,14,2.0,2,0.0,0,3,0,1,8,0,0,2,0,4,10,0
5885,155249,6T4qq3cdISFF5pyvVKMrcmEINY6BysCY,7GRhBDsirIGkRZBtSMEzNTyDr2JQm4xx,1,0,0,0,0,0,1,0,1,0.14285714285714285,1,0.0,0,0,0,0,0,0,0,1,0,0,1,1
5886,155260,RYxlkEfybScjuURHdWSAT0EfdWxxzl53,G8EPVSXsOYB5YQWZGiz1aVq5Pgr2GrQu,12,10,3,8,3,0,2,0,26,3.7142857142857144,1,0.0,6,3,5,3,4,0,3,2,0,17,9,1
5887,155367,LSvU72CFq1TrHd9SCZOiKQ0qcV2oa2Ok,SpATywNh6bZuzm8s1ceuBUnMUAeoAHHw,3,2,0,0,0,0,1,0,3,0.42857142857142855,1,0.0,0,0,0,0,2,0,0,1,0,0,3,1
5888,155391,mV4YsIiA8Oc8PxZhA2HzdmyhI1ZXRUSS,SpATywNh6bZuzm8s1ceuBUnMUAeoAHHw,16,28,12,10,5,0,7,0,62,8.857142857142858,1,0.0,6,12,10,5,22,0,0,7,0,33,29,1
5889,155453,lmCPiW6l0WNp9Ttn0lhwFDs7FfVubtvY,bWdj2GDclj5ofokWjzoa5jAwMkxCykd6,5,6,0,0,0,0,1,0,7,1.0,1,0.0,0,0,0,0,6,0,0,1,0,0,7,1
5890,155553,bpGV6fnSXAO5YTgsxVkdmYC0rSgonD8Y,SpATywNh6bZuzm8s1ceuBUnMUAeoAHHw,5,5,1,0,1,0,1,0,8,1.1428571428571428,1,0.0,0,1,0,1,5,0,0,1,0,2,6,1
5891,155580,RRM0TElcCY25pdcWRkMGxwCn30ehvK5c,SpATywNh6bZuzm8s1ceuBUnMUAeoAHHw,2,0,0,0,0,0,4,0,4,0.5714285714285714,2,0.0,0,0,0,0,0,0,0,4,0,0,4,0
5892,155745,bcDgsH6ZU4RUVLG7I2fsAvcl6B7ySYCd,RXDvfPUBYFlVdlueBFbLW0mhhAyGEqpt,1,0,0,0,0,0,1,0,1,0.14285714285714285,1,0.0,0,0,0,0,0,0,0,1,0,0,1,1
5893,155826,VFaDw1WYcOtIcsxfLW3x5fsJ2JkUIOUZ,G8EPVSXsOYB5YQWZGiz1aVq5Pgr2GrQu,47,53,22,70,15,9,15,1,185,26.428571428571427,3,0.0,20,22,60,15,33,9,10,15,1,117,68,0
5894,155885,4G4cusC28dHeOh2Typ91i1q3Okbvvqth,bWdj2GDclj5ofokWjzoa5jAwMkxCykd6,6,4,1,4,2,0,2,0,13,1.8571428571428572,1,0.0,2,1,3,2,2,0,1,2,0,8,5,1
5895,156562,Un3EzEE4Sz8i5Z84q9e50URbIAEkkVSB,A3fsA9Zfv1X2fVEQhTw51lKENdNrEqT3,1,0,0,0,0,0,2,0,2,0.2857142857142857,1,0.0,0,0,0,0,0,0,0,2,0,0,2,1
5896,156569,OLSxCkluLildKVrVnzRIsj47tt9tVHj9,A3fsA9Zfv1X2fVEQhTw51lKENdNrEqT3,1,0,0,0,0,0,1,0,1,0.14285714285714285,1,0.0,0,0,0,0,0,0,0,1,0,0,1,1
5897,156717,X535Iu5jdKv0ppLqkwhIGZajlbhLXvmn,bWdj2GDclj5ofokWjzoa5jAwMkxCykd6,6,2,1,0,1,0,3,0,7,1.0,1,0.0,0,1,0,1,2,0,0,3,0,2,5,1
5898,157347,5ehf4EFN8WhDbvmb2WvfZwpaBD0cj1oj,7GRhBDsirIGkRZBtSMEzNTyDr2JQm4xx,11,10,0,0,0,0,3,0,13,1.8571428571428572,2,0.0,0,0,0,0,10,0,0,3,0,0,13,1
5899,157488,abZjyy6CkJwLuRnRyGB2GrxhAkPifaxi,7GRhBDsirIGkRZBtSMEzNTyDr2JQm4xx,5,2,0,0,0,0,5,0,7,1.0,1,0.0,0,0,0,0,2,0,0,5,0,0,7,1
5900,160693,0bGwsopOrJy9wTuBbyPfl2hvYAxstsYA,7GRhBDsirIGkRZBtSMEzNTyDr2JQm4xx,1,0,0,0,0,0,1,0,1,0.14285714285714285,1,0.0,0,0,0,0,0,0,0,1,0,0,1,1
5901,160716,Jov3UvG5K4pASWh5oCQTME29q3GomczT,7GRhBDsirIGkRZBtSMEzNTyDr2JQm4xx,1,0,0,0,0,0,1,0,1,0.14285714285714285,1,0.0,0,0,0,0,0,0,0,1,0,0,1,1
5902,160726,8E88mVxxHiSEV3ReMbiLkIuYAxJ6YXeO,bWdj2GDclj5ofokWjzoa5jAwMkxCykd6,4,9,5,0,0,0,6,0,20,2.857142857142857,2,0.0,0,5,0,0,9,0,0,6,0,5,15,1
5903,160802,vaWLVKWyrsUzDV0qs20ZUq8M3VNW01Uk,SpATywNh6bZuzm8s1ceuBUnMUAeoAHHw,1,0,0,0,0,0,2,0,2,0.2857142857142857,1,0.0,0,0,0,0,0,0,0,2,0,0,2,1
5904,161011,1b3NSfxfxI6DroelosS7m4rEEtzhJZdR,7GRhBDsirIGkRZBtSMEzNTyDr2JQm4xx,1,0,0,0,0,0,1,0,1,0.14285714285714285,1,0.0,0,0,0,0,0,0,0,1,0,0,1,1
5905,161065,2JYViuOLvusjF5jXM0OPt6GS91aIip1x,SpATywNh6bZuzm8s1ceuBUnMUAeoAHHw,1,0,0,0,0,0,1,0,1,0.14285714285714285,1,0.0,0,0,0,0,0,0,0,1,0,0,1,1
5906,161171,rhgA2X0g2BW5I3tYIXFENYW4L8ORdfpR,7GRhBDsirIGkRZBtSMEzNTyDr2JQm4xx,14,11,2,28,3,0,2,0,46,6.571428571428571,1,0.0,6,2,25,3,5,0,3,2,0,36,10,1
5907,161244,F5WXvUA8z1Vfdvlva1pujweut7tGE04r,7GRhBDsirIGkRZBtSMEzNTyDr2JQm4xx,2,0,0,0,0,0,2,0,2,0.2857142857142857,1,0.0,0,0,0,0,0,0,0,2,0,0,2,1
5908,161310,B5jlZpEDxUNGCe4UQsaYbJ99Z8y5d2lN,7GRhBDsirIGkRZBtSMEzNTyDr2JQm4xx,9,4,3,0,3,0,2,0,12,1.7142857142857142,1,0.0,0,3,0,3,4,0,0,2,0,6,6,1
5909,161369,NMciPbdIeB9uIZwCMcw6mXU2i3BtnB5v,7GRhBDsirIGkRZBtSMEzNTyDr2JQm4xx,7,5,4,0,4,0,2,0,15,2.142857142857143,1,0.0,0,4,0,4,5,0,0,2,0,8,7,1
5910,161526,6HIBebNSnNEoSeekVShzxF3x0IcbgohT,7GRhBDsirIGkRZBtSMEzNTyDr2JQm4xx,1,0,0,0,0,0,1,0,1,0.14285714285714285,1,0.0,0,0,0,0,0,0,0,1,0,0,1,1
5911,161578,Xo1RSitSiG1YTKsWiGb48lb1j1pDp5LC,7GRhBDsirIGkRZBtSMEzNTyDr2JQm4xx,1,0,0,0,0,0,1,0,1,0.14285714285714285,1,0.0,0,0,0,0,0,0,0,1,0,0,1,1
5912,161642,zT5Abo7SNHsAkCFKMvhJJJDWNu2sl4mh,bWdj2GDclj5ofokWjzoa5jAwMkxCykd6,5,0,0,0,0,1,4,3,8,1.1428571428571428,1,0.0,0,0,0,0,0,1,0,4,3,0,8,1
5913,161670,IFqWOl32JJm0W3Ap2jxVCpJeXeLJlYDp,7GRhBDsirIGkRZBtSMEzNTyDr2JQm4xx,1,0,0,0,0,0,1,0,1,0.14285714285714285,1,0.0,0,0,0,0,0,0,0,1,0,0,1,1
5914,161671,Rlp934Hm4YHO5gcLihEiFevqZ5FBvHF8,SpATywNh6bZuzm8s1ceuBUnMUAeoAHHw,8,6,3,0,3,0,2,0,14,2.0,1,0.0,0,3,0,3,6,0,0,2,0,6,8,0
5915,161682,HE0yFYNeyW3jGh5EhXv7uoc6O18ATk5R,7GRhBDsirIGkRZBtSMEzNTyDr2JQm4xx,16,15,10,6,8,0,1,0,40,5.714285714285714,1,0.0,3,10,6,8,12,0,0,1,0,27,13,1
5916,161695,5UJZmEar1AX3gQXOzkh3MnQcYdErI17M,7GRhBDsirIGkRZBtSMEzNTyDr2JQm4xx,5,3,1,4,1,0,1,0,10,1.4285714285714286,1,0.0,1,1,3,1,2,0,1,1,0,6,4,1
5917,161723,SKx8r8WhDZSzytfk5iQ25ROJsaDkrIXF,7GRhBDsirIGkRZBtSMEzNTyDr2JQm4xx,11,7,4,0,0,0,22,1,34,4.857142857142857,2,0.0,0,4,0,0,7,0,0,22,1,4,30,1
5918,161805,UCk78TeP5wO91gE0mNeB2p1adOEwLGvE,7GRhBDsirIGkRZBtSMEzNTyDr2JQm4xx,1,0,0,0,0,0,1,0,1,0.14285714285714285,1,0.0,0,0,0,0,0,0,0,1,0,0,1,1
5919,161809,IW1yqY6AJLLD0UdkPHoBC5FNys4RF3Rc,A3fsA9Zfv1X2fVEQhTw51lKENdNrEqT3,10,5,1,0,0,1,12,1,20,2.857142857142857,1,0.0,0,1,0,0,5,1,0,12,1,1,19,0
5920,161860,XWulLs8vbnA3SFvatYUqLQya4PNZCGWN,7GRhBDsirIGkRZBtSMEzNTyDr2JQm4xx,2,0,0,0,0,0,2,0,2,0.2857142857142857,1,0.0,0,0,0,0,0,0,0,2,0,0,2,1
5921,161918,SYWOoChsgDN3vqDh0zFb5J4GFaNN5CHm,7GRhBDsirIGkRZBtSMEzNTyDr2JQm4xx,2,0,0,0,0,0,2,0,2,0.2857142857142857,1,0.0,0,0,0,0,0,0,0,2,0,0,2,1
5922,161927,OhL5zrdNWQNDdkrpoCKKJc0ohGhIkdNF,7GRhBDsirIGkRZBtSMEzNTyDr2JQm4xx,7,3,1,0,1,0,6,0,11,1.5714285714285714,1,0.0,0,1,0,1,3,0,0,6,0,2,9,1
5923,161959,AZZvRPcRkLSa6vwofzfwsEULTUhiKy0E,7GRhBDsirIGkRZBtSMEzNTyDr2JQm4xx,1,0,0,0,0,0,1,0,1,0.14285714285714285,1,0.0,0,0,0,0,0,0,0,1,0,0,1,1
5924,161969,MaC2my4u05k7bh5sqzN5aBA80G2sJbiN,7GRhBDsirIGkRZBtSMEzNTyDr2JQm4xx,2,0,0,0,0,0,2,0,2,0.2857142857142857,1,0.0,0,0,0,0,0,0,0,2,0,0,2,1
5925,161977,1eR532KvihOWCrlFgRH6WOHtkLSsyMIL,7GRhBDsirIGkRZBtSMEzNTyDr2JQm4xx,1,0,0,0,0,0,1,0,1,0.14285714285714285,1,0.0,0,0,0,0,0,0,0,1,0,0,1,1
5926,162021,zEeoIZORCHI2d73VPIkIvoJfr8OXEKux,7GRhBDsirIGkRZBtSMEzNTyDr2JQm4xx,2,0,0,0,0,0,4,0,4,0.5714285714285714,1,0.0,0,0,0,0,0,0,0,4,0,0,4,1
5927,162029,OUbrW18OgibVb4I41eHFiFhkobpgjEP2,A3fsA9Zfv1X2fVEQhTw51lKENdNrEqT3,31,23,16,0,13,0,7,0,59,8.428571428571429,2,0.0,0,16,0,13,23,0,0,7,0,29,30,0
5928,162051,EPVEir3f8DxjouE65Q4kYI9YaQMxGE89,7GRhBDsirIGkRZBtSMEzNTyDr2JQm4xx,1,0,0,0,0,0,1,0,1,0.14285714285714285,1,0.0,0,0,0,0,0,0,0,1,0,0,1,1
5929,162089,KN2cc8h9ZKfIgxIX3NczsQQI5NEtrUt5,7GRhBDsirIGkRZBtSMEzNTyDr2JQm4xx,1,0,0,0,0,0,1,0,1,0.14285714285714285,1,0.0,0,0,0,0,0,0,0,1,0,0,1,1
5930,162174,WUH5fKgyK0ITY5YtWCIxwze8XvwwESM5,7GRhBDsirIGkRZBtSMEzNTyDr2JQm4xx,5,4,1,0,1,1,1,0,8,1.1428571428571428,1,0.0,0,1,0,1,4,1,0,1,0,2,6,1
5931,162177,1K0DpvOOuk8vTEPD17uO46UmxJ6dP2I7,7GRhBDsirIGkRZBtSMEzNTyDr2JQm4xx,23,41,14,8,7,0,4,0,74,10.571428571428571,1,0.0,21,14,8,7,20,0,0,4,0,50,24,1
5932,162182,o69BaNn8nNwkn0WRwXTNaYgGrUvOyxv9,7GRhBDsirIGkRZBtSMEzNTyDr2JQm4xx,1,0,0,0,0,0,1,0,1,0.14285714285714285,1,0.0,0,0,0,0,0,0,0,1,0,0,1,1
5933,162210,DtMnsqy6X2aMCS8gI4UYHBMONV1kA6dl,7GRhBDsirIGkRZBtSMEzNTyDr2JQm4xx,6,2,1,0,1,0,3,0,7,1.0,1,0.0,0,1,0,1,2,0,0,3,0,2,5,1
5934,162227,uuKeKkPXlaVWeKPj7Eoyh2mpLD36WFad,7GRhBDsirIGkRZBtSMEzNTyDr2JQm4xx,4,2,1,0,0,0,3,0,6,0.8571428571428571,1,0.0,1,1,0,0,1,0,0,3,0,2,4,1
5935,162252,pUVYMZKME7oxYlcseSFG7zGaoCPbxz6o,7GRhBDsirIGkRZBtSMEzNTyDr2JQm4xx,1,0,0,0,0,0,1,0,1,0.14285714285714285,1,0.0,0,0,0,0,0,0,0,1,0,0,1,1
5936,162347,d0EMfPN6PawhWgPDlCBNVjvE3wPPt43m,7GRhBDsirIGkRZBtSMEzNTyDr2JQm4xx,6,4,2,0,1,1,3,0,11,1.5714285714285714,1,0.0,0,2,0,1,4,1,0,3,0,3,8,1
5937,162653,6yKvwDs84lm1ZlLZzY92MDe16cYzJo5V,fbPkOYLVPtPgIt0MxizjfFJov3JbHyAi,7,6,3,0,4,0,2,0,15,2.142857142857143,1,0.0,2,3,0,4,4,0,0,2,0,9,6,1
5938,162654,8sS5OxFNiGXZ5DUb7jXq3k5CIC9MaMcF,fbPkOYLVPtPgIt0MxizjfFJov3JbHyAi,11,5,2,0,2,10,5,1,25,3.5714285714285716,1,0.0,0,2,0,2,5,10,0,5,1,4,21,1
5939,162655,G8NfWWfRwceCubJJsygDkNdWqvz6p8r7,fbPkOYLVPtPgIt0MxizjfFJov3JbHyAi,4,3,0,0,0,0,3,0,6,0.8571428571428571,1,0.0,0,0,0,0,3,0,0,3,0,0,6,1
5940,162662,7SOATalw6HkrZim2p905lRKSzVKbYoeJ,fbPkOYLVPtPgIt0MxizjfFJov3JbHyAi,1,0,0,0,0,0,1,0,1,0.14285714285714285,1,0.0,0,0,0,0,0,0,0,1,0,0,1,1
5941,162663,HDuNX4LLsLDTkuyYIBGkGV7jAGXEtOuc,fbPkOYLVPtPgIt0MxizjfFJov3JbHyAi,2,0,0,0,0,0,3,0,3,0.42857142857142855,1,0.0,0,0,0,0,0,0,0,3,0,0,3,1
5942,162664,92eKrHML8uFDQVHOmZmmhaJ4gTyx9NDt,fbPkOYLVPtPgIt0MxizjfFJov3JbHyAi,8,4,2,0,2,0,5,0,13,1.8571428571428572,1,0.0,1,2,0,2,3,0,0,5,0,5,8,1
5943,162665,1jbzhg6dAhJ3AT5rxEEXSMGEXTVvHdIx,fbPkOYLVPtPgIt0MxizjfFJov3JbHyAi,2,0,0,0,0,0,3,0,3,0.42857142857142855,1,0.0,0,0,0,0,0,0,0,3,0,0,3,1
5944,162667,ftYE47yTOAFIMqTQk12eUimylWQiUH5C,fbPkOYLVPtPgIt0MxizjfFJov3JbHyAi,5,2,1,0,1,0,3,0,7,1.0,1,0.0,0,1,0,1,2,0,0,3,0,2,5,1
5945,162668,UVZ0046mDQtSPXatD3KanD1N0mcrpfEe,fbPkOYLVPtPgIt0MxizjfFJov3JbHyAi,1,0,0,0,0,0,1,0,1,0.14285714285714285,1,0.0,0,0,0,0,0,0,0,1,0,0,1,1
5946,162669,MEiWJmtZSdxLL8HEGVkX5lxXxAUsGu0A,fbPkOYLVPtPgIt0MxizjfFJov3JbHyAi,1,0,0,0,0,0,1,0,1,0.14285714285714285,1,0.0,0,0,0,0,0,0,0,1,0,0,1,1
5947,162670,0FtVS7ZBI4rrErVUUUqJzFuZedQkaBu3,fbPkOYLVPtPgIt0MxizjfFJov3JbHyAi,1,0,0,0,0,0,1,0,1,0.14285714285714285,1,0.0,0,0,0,0,0,0,0,1,0,0,1,1
5948,162672,tBbrCdeCzTMG76NlqGynFt4AvfyJdikM,fbPkOYLVPtPgIt0MxizjfFJov3JbHyAi,43,32,15,48,13,1,5,1,115,16.428571428571427,1,0.0,14,15,42,13,18,1,6,5,1,84,31,1
5949,162674,Kz3qhdfTJukDJF9DtNWUYj5BtfRsMvnw,fbPkOYLVPtPgIt0MxizjfFJov3JbHyAi,2,0,0,0,0,0,2,0,2,0.2857142857142857,1,0.0,0,0,0,0,0,0,0,2,0,0,2,1
5950,162675,rde4SOUWKvk9DJZt1L0gZmVDXeNYiqdM,fbPkOYLVPtPgIt0MxizjfFJov3JbHyAi,11,6,4,0,3,0,7,1,21,3.0,1,0.0,1,4,0,3,5,0,0,7,1,8,13,1
5951,162677,JJDWSR5T5OI58OQCJ2rXYW6lv04IiDvD,fbPkOYLVPtPgIt0MxizjfFJov3JbHyAi,12,6,3,0,3,15,7,1,35,5.0,2,0.0,0,3,0,3,6,15,0,7,1,6,29,1
5952,162683,8zAtOSKV7R70cZuke03f42P9Tj2cyqBy,fbPkOYLVPtPgIt0MxizjfFJov3JbHyAi,5,3,1,0,1,0,2,0,7,1.0,1,0.0,0,1,0,1,3,0,0,2,0,2,5,1
5953,162684,EehddsodITByQl4qGuajkHZ7QOdMQQgV,fbPkOYLVPtPgIt0MxizjfFJov3JbHyAi,7,7,2,0,4,0,2,0,15,2.142857142857143,1,0.0,4,2,0,4,3,0,0,2,0,10,5,1
5954,162686,HIfBwadqUOHP4H0miQANqcPd7btb1kCW,fbPkOYLVPtPgIt0MxizjfFJov3JbHyAi,1,0,0,0,0,0,1,0,1,0.14285714285714285,1,0.0,0,0,0,0,0,0,0,1,0,0,1,1
5955,162688,TfMiuu9vyAM0w8qFqC2lCZDreJEc3tGS,fbPkOYLVPtPgIt0MxizjfFJov3JbHyAi,6,0,0,0,0,1,15,1,17,2.4285714285714284,1,0.0,0,0,0,0,0,1,0,15,1,0,17,1
5956,162700,M9qzbHqIRAsNV3bD2hj1DPeNp2k6AjqO,fbPkOYLVPtPgIt0MxizjfFJov3JbHyAi,6,2,1,0,1,0,4,0,8,1.1428571428571428,1,0.0,0,1,0,1,2,0,0,4,0,2,6,1
5957,162702,hS70rXH0G94qmb9N1eBGrleH41NX9STz,fbPkOYLVPtPgIt0MxizjfFJov3JbHyAi,2,0,0,0,0,0,5,0,5,0.7142857142857143,1,0.0,0,0,0,0,0,0,0,5,0,0,5,1
5958,162704,fX40yNA4s3myhUDdO7ujIUD2VjxgqD1R,fbPkOYLVPtPgIt0MxizjfFJov3JbHyAi,1,0,0,0,0,0,1,0,1,0.14285714285714285,1,0.0,0,0,0,0,0,0,0,1,0,0,1,1
5959,162706,4D3Mr9GTnnSeHqe4k4RduVTIffzivKXV,fbPkOYLVPtPgIt0MxizjfFJov3JbHyAi,10,16,5,0,3,2,11,0,37,5.285714285714286,2,0.0,0,5,0,3,16,2,0,11,0,8,29,1
5960,162708,C9lLMTQ4ry2uksEvYVANv0oVpPhZMbc2,fbPkOYLVPtPgIt0MxizjfFJov3JbHyAi,8,5,3,0,2,0,4,0,14,2.0,1,0.0,0,3,0,2,5,0,0,4,0,5,9,1
5961,162710,724Z1dFlMACAt3kWIjNXL2F7EImzegCP,fbPkOYLVPtPgIt0MxizjfFJov3JbHyAi,1,0,0,0,0,0,1,0,1,0.14285714285714285,1,0.0,0,0,0,0,0,0,0,1,0,0,1,1
5962,162711,xIi7bi5lsr2kQs0Ruk7tQjf4xYRaSVFg,fbPkOYLVPtPgIt0MxizjfFJov3JbHyAi,9,6,4,0,3,0,2,0,15,2.142857142857143,1,0.0,0,4,0,3,6,0,0,2,0,7,8,1
5963,162713,FEsfreZNllfO9KbF7SZ3ITs14Rmiz03Y,fbPkOYLVPtPgIt0MxizjfFJov3JbHyAi,1,0,0,0,0,0,1,0,1,0.14285714285714285,1,0.0,0,0,0,0,0,0,0,1,0,0,1,1
5964,163446,vYZLFtHzbRZEyiuRAYkPU2TurFaRRb3e,bWdj2GDclj5ofokWjzoa5jAwMkxCykd6,7,7,4,0,3,0,3,0,17,2.4285714285714284,3,0.0,1,4,0,3,6,0,0,3,0,8,9,1
5965,163447,CR6hbwvXPZHEYYcI4AAX4civM4Pp6Aex,bWdj2GDclj5ofokWjzoa5jAwMkxCykd6,7,2,1,0,1,0,4,0,8,1.1428571428571428,2,0.0,0,1,0,1,2,0,0,4,0,2,6,1
5966,163451,rUr3hxt1niPeDbjT1dWASqAoHDERYMHJ,bWdj2GDclj5ofokWjzoa5jAwMkxCykd6,16,12,4,44,2,5,2,0,69,9.857142857142858,2,0.0,4,4,41,2,8,5,3,2,0,51,18,0
5967,163452,CLgDvHjU8d0JuEtHgdUcLQg1OZ6hE3A8,RXDvfPUBYFlVdlueBFbLW0mhhAyGEqpt,21,24,15,22,8,2,6,0,77,11.0,3,0.0,4,15,22,8,20,2,0,6,0,49,28,1
5968,163456,QW07WKWuMa47F3DVH5YhQbGmBNCRc0FZ,SpATywNh6bZuzm8s1ceuBUnMUAeoAHHw,9,5,1,16,1,2,4,1,30,4.285714285714286,1,0.0,2,1,13,1,3,2,3,4,1,17,13,1
5969,163459,eq3avF6QxxFlcD9gaMIYsKSt5Td1igiD,SpATywNh6bZuzm8s1ceuBUnMUAeoAHHw,12,16,2,18,0,0,5,0,41,5.857142857142857,1,0.0,5,2,15,0,11,0,3,5,0,22,19,1
5970,163463,hFpufo5lTiocFSjp5de4hLz459xEY6dx,G8EPVSXsOYB5YQWZGiz1aVq5Pgr2GrQu,12,5,3,0,2,4,8,1,23,3.2857142857142856,1,0.0,0,3,0,2,5,4,0,8,1,5,18,1
5971,163468,GGdBzvTskjxKAvNdibnhPPkGKFTKpZaL,SpATywNh6bZuzm8s1ceuBUnMUAeoAHHw,4,3,0,0,0,0,3,0,6,0.8571428571428571,1,0.0,0,0,0,0,3,0,0,3,0,0,6,1
5972,163473,m580K62zl9ih2EBTcM6Y53ygfq7rAv69,RXDvfPUBYFlVdlueBFbLW0mhhAyGEqpt,1,0,0,0,0,0,1,0,1,0.14285714285714285,1,0.0,0,0,0,0,0,0,0,1,0,0,1,1
5973,163474,2sDQ5DmJB14fdhYiHWrjTNImvS7e7hHg,RXDvfPUBYFlVdlueBFbLW0mhhAyGEqpt,9,6,5,0,4,1,5,1,22,3.142857142857143,2,0.0,0,5,0,4,6,1,0,5,1,9,13,1
5974,163489,5IM8g7YMOYo5qH7Yu3x31T3JkVOH9iqe,RXDvfPUBYFlVdlueBFbLW0mhhAyGEqpt,8,12,4,0,2,0,1,0,19,2.7142857142857144,2,0.0,1,4,0,2,11,0,0,1,0,7,12,1
5975,163492,ni5dUdHYqNJ6ClZBex2HryO1vDE1ZkoU,SpATywNh6bZuzm8s1ceuBUnMUAeoAHHw,4,1,0,0,0,0,3,0,4,0.5714285714285714,1,0.0,0,0,0,0,1,0,0,3,0,0,4,1
5976,163495,ww05exVvqmTpHRLpMlcyyiyf25IJQarF,bWdj2GDclj5ofokWjzoa5jAwMkxCykd6,4,2,1,0,1,0,2,0,6,0.8571428571428571,1,0.0,0,1,0,1,2,0,0,2,0,2,4,1
5977,163498,KemVogD4rWuutYcMfAZRpTjVQNkGCf1a,bWdj2GDclj5ofokWjzoa5jAwMkxCykd6,6,6,2,0,2,0,1,0,11,1.5714285714285714,1,0.0,2,2,0,2,4,0,0,1,0,6,5,1
5978,163503,q1KcO9Dg3vZiLgj3uBWo2HFsUXBuH0Hl,RXDvfPUBYFlVdlueBFbLW0mhhAyGEqpt,12,8,1,21,1,0,2,0,33,4.714285714285714,1,0.0,2,1,17,1,6,0,4,2,0,21,12,1
5979,163511,i0ksX07HnsV5rQlWqOr1uKEuc7yNU24c,bWdj2GDclj5ofokWjzoa5jAwMkxCykd6,13,23,10,0,6,48,13,1,101,14.428571428571429,2,0.0,7,10,0,6,16,48,0,13,1,23,78,1
5980,163517,RAAFt7jgkqGMpy4rUVomxkKt5lfbto8C,SpATywNh6bZuzm8s1ceuBUnMUAeoAHHw,5,1,0,0,0,1,7,1,10,1.4285714285714286,2,0.0,0,0,0,0,1,1,0,7,1,0,10,1
5981,163520,gFwcy6HlQMHgKm8VCXe5qQxUXfgM5CMM,RXDvfPUBYFlVdlueBFbLW0mhhAyGEqpt,18,31,11,2,5,0,3,0,52,7.428571428571429,2,0.0,1,11,2,5,30,0,0,3,0,19,33,1
5982,163521,vvZAdi1giBsqNJd2MIMUF2BeNIuSYzIL,bWdj2GDclj5ofokWjzoa5jAwMkxCykd6,5,2,1,0,1,0,2,0,6,0.8571428571428571,1,0.0,0,1,0,1,2,0,0,2,0,2,4,1
5983,163522,0z2VYcRtlKJQ1Og2a3In5C7pwhw0mXLE,SpATywNh6bZuzm8s1ceuBUnMUAeoAHHw,17,51,26,17,10,178,26,4,312,44.57142857142857,4,0.0,12,26,15,10,39,178,2,26,4,63,249,1
5984,163524,Qp6nTYSBUXdSPjEoOGaLaIU4K702QdpX,SpATywNh6bZuzm8s1ceuBUnMUAeoAHHw,9,3,2,0,2,0,6,1,14,2.0,1,0.0,0,2,0,2,3,0,0,6,1,4,10,1
5985,163545,aNuWWNOgxdbqnpWne8VHd2WyMrEEuUHw,SpATywNh6bZuzm8s1ceuBUnMUAeoAHHw,13,13,0,24,0,3,5,6,51,7.285714285714286,1,0.0,6,0,19,0,7,3,5,5,6,25,26,1
5986,163548,MYL9KYDmBF9vDici6Dv3saVcxgkvpmKP,SpATywNh6bZuzm8s1ceuBUnMUAeoAHHw,8,2,2,0,2,0,3,0,9,1.2857142857142858,2,0.0,0,2,0,2,2,0,0,3,0,4,5,1
5987,163553,RfHHoRL5TB9R1ardH3KUBDMoKbTvmS64,G8EPVSXsOYB5YQWZGiz1aVq5Pgr2GrQu,9,2,1,0,1,2,8,1,15,2.142857142857143,1,0.0,0,1,0,1,2,2,0,8,1,2,13,1
5988,163556,x1RDUiG4hzdFvWaarIV1g7s3ecNKiDPi,bWdj2GDclj5ofokWjzoa5jAwMkxCykd6,6,5,1,0,1,6,3,0,16,2.2857142857142856,1,0.0,2,1,0,1,3,6,0,3,0,4,12,1
5989,163561,0QwOyzDB4SU53NQhq9XNeT5ngIq83qZV,SpATywNh6bZuzm8s1ceuBUnMUAeoAHHw,14,20,6,18,4,4,5,0,57,8.142857142857142,1,0.0,12,6,16,4,8,4,2,5,0,38,19,1
5990,163566,7OkCZWJW1Ow4wpTBUq53amL13pV2vy2v,bWdj2GDclj5ofokWjzoa5jAwMkxCykd6,1,0,0,0,0,0,1,0,1,0.14285714285714285,1,0.0,0,0,0,0,0,0,0,1,0,0,1,1
5991,163575,pUCG45Dx4PCk37xolhUilbrK2zyzqYUw,SpATywNh6bZuzm8s1ceuBUnMUAeoAHHw,5,2,1,0,1,0,2,0,6,0.8571428571428571,1,0.0,0,1,0,1,2,0,0,2,0,2,4,1
5992,163584,pUCG45Dx4PCk37xolhUilbrK2zyzqYUw,RXDvfPUBYFlVdlueBFbLW0mhhAyGEqpt,5,2,1,0,1,0,2,0,6,0.8571428571428571,1,0.0,0,1,0,1,2,0,0,2,0,2,4,1
5993,163587,LOW2vjVehrf0M1x4W4dAc3vEUlAV2GoS,SpATywNh6bZuzm8s1ceuBUnMUAeoAHHw,1,0,0,0,0,0,1,0,1,0.14285714285714285,1,0.0,0,0,0,0,0,0,0,1,0,0,1,1
5994,163591,pvAe37z1FjLTGYdwlJFjXex25zlpyHtu,SpATywNh6bZuzm8s1ceuBUnMUAeoAHHw,1,0,0,0,0,0,1,0,1,0.14285714285714285,1,0.0,0,0,0,0,0,0,0,1,0,0,1,1
5995,163594,cJ2sQIvcbMYmAtm7wZLrjdPU3A4J8Vmy,RXDvfPUBYFlVdlueBFbLW0mhhAyGEqpt,1,0,0,0,0,0,1,0,1,0.14285714285714285,1,0.0,0,0,0,0,0,0,0,1,0,0,1,1
5996,163602,1n5nYyRZ2V4rGDvhlysxQQrSnQWtjpF0,SpATywNh6bZuzm8s1ceuBUnMUAeoAHHw,5,2,0,0,0,0,4,0,6,0.8571428571428571,1,0.0,0,0,0,0,2,0,0,4,0,0,6,1
5997,163606,muDFJRueLAzQJIObWxRY78oBQLrrl8ME,RXDvfPUBYFlVdlueBFbLW0mhhAyGEqpt,5,1,1,0,1,0,2,0,5,0.7142857142857143,1,0.0,0,1,0,1,1,0,0,2,0,2,3,1
5998,163608,zgldUj8PQLoCMFvq4CFx27ajGTiUzuNA,SpATywNh6bZuzm8s1ceuBUnMUAeoAHHw,8,3,1,0,1,0,5,1,11,1.5714285714285714,1,0.0,0,1,0,1,3,0,0,5,1,2,9,1
5999,163610,shpNJBWz5XXztT7QSTTkv5TBZhc2j7a5,bWdj2GDclj5ofokWjzoa5jAwMkxCykd6,5,2,1,0,1,0,2,0,6,0.8571428571428571,1,0.0,0,1,0,1,2,0,0,2,0,2,4,1
6000,163620,BRQa1dSoPdGgh4T8YhbATcVtUAwS3CTv,G8EPVSXsOYB5YQWZGiz1aVq5Pgr2GrQu,1,0,0,0,0,0,1,0,1,0.14285714285714285,1,0.0,0,0,0,0,0,0,0,1,0,0,1,1
6001,163624,J4pjYRUS78455k3x6FlgE0qLyKCkWPB4,SpATywNh6bZuzm8s1ceuBUnMUAeoAHHw,4,3,1,0,1,0,4,0,9,1.2857142857142858,1,0.0,0,1,0,1,3,0,0,4,0,2,7,1
6002,163626,h1vKdFPTvdJ38bRqZwCXLGITqLqjjxQ8,bWdj2GDclj5ofokWjzoa5jAwMkxCykd6,2,0,0,0,0,0,5,0,5,0.7142857142857143,4,0.0,0,0,0,0,0,0,0,5,0,0,5,1
6003,163633,loY20pnf7suv2LWREXjC0h3XNawzaj7l,SpATywNh6bZuzm8s1ceuBUnMUAeoAHHw,15,13,4,13,3,0,5,0,38,5.428571428571429,1,0.0,5,4,11,3,8,0,2,5,0,23,15,1
6004,163657,3NITGQuylcrTi63aoWqnzXuF5Rtf7QVq,bWdj2GDclj5ofokWjzoa5jAwMkxCykd6,15,24,12,52,8,0,4,0,100,14.285714285714286,2,0.0,9,12,51,8,15,0,1,4,0,80,20,1
6005,163661,TC06DZHDGaAT9UQHd1v4hOYj6DcF04C0,SpATywNh6bZuzm8s1ceuBUnMUAeoAHHw,1,0,0,0,0,0,1,0,1,0.14285714285714285,1,0.0,0,0,0,0,0,0,0,1,0,0,1,1
6006,163664,75QwID9vkHNyAC3jIqeF9fNTGOKWDCMd,SpATywNh6bZuzm8s1ceuBUnMUAeoAHHw,15,27,1,24,1,2,17,3,75,10.714285714285714,3,0.0,10,1,18,1,17,2,6,17,3,30,45,0
6007,163665,mSLVZlcG3d9P9nR1btPulwDUjqta6d8Y,RXDvfPUBYFlVdlueBFbLW0mhhAyGEqpt,2,0,0,0,0,0,2,0,2,0.2857142857142857,1,0.0,0,0,0,0,0,0,0,2,0,0,2,1
6008,163668,BB5Nl9ZKGNNXpCTY1I2k14qOsWmBwuLj,SpATywNh6bZuzm8s1ceuBUnMUAeoAHHw,5,2,1,0,1,0,2,0,6,0.8571428571428571,1,0.0,0,1,0,1,2,0,0,2,0,2,4,1
6009,163670,zBcT1Z0xXooVqe1Y23Zi33CckLeXOFNF,RXDvfPUBYFlVdlueBFbLW0mhhAyGEqpt,1,0,0,0,0,0,1,0,1,0.14285714285714285,1,0.0,0,0,0,0,0,0,0,1,0,0,1,1
6010,163671,jMDxIZZpgmR8gnZ9CfiXAFFCthv2NGRW,SpATywNh6bZuzm8s1ceuBUnMUAeoAHHw,15,13,8,14,3,6,7,0,51,7.285714285714286,2,0.0,2,8,12,3,11,6,2,7,0,25,26,1
6011,163672,Xdw2Hwx0RPjHhvzIV1hR51APAU4mGupY,SpATywNh6bZuzm8s1ceuBUnMUAeoAHHw,5,5,2,0,2,0,1,0,10,1.4285714285714286,1,0.0,1,2,0,2,4,0,0,1,0,5,5,1
6012,163676,JoqAGqbao71wc04PyVzx7SVvlZZ0knbI,bWdj2GDclj5ofokWjzoa5jAwMkxCykd6,11,15,7,24,4,13,5,0,68,9.714285714285714,2,0.0,3,7,22,4,12,13,2,5,0,36,32,1
6013,163677,HcOpBFh3ZPBJu7PjBFffM3Zedw54RSXN,bWdj2GDclj5ofokWjzoa5jAwMkxCykd6,4,3,1,0,1,0,2,0,7,1.0,2,0.0,0,1,0,1,3,0,0,2,0,2,5,1
6014,163682,vqdEPdTaMaLXqSh5cxznXuMHlVEqT6bt,SpATywNh6bZuzm8s1ceuBUnMUAeoAHHw,12,29,22,0,8,0,9,1,69,9.857142857142858,2,0.0,0,22,0,8,29,0,0,9,1,30,39,0
6015,163688,cENALtdHRJFXtEKpdDktmgl2ZGC3sBgO,SpATywNh6bZuzm8s1ceuBUnMUAeoAHHw,12,9,1,17,0,0,4,0,31,4.428571428571429,1,0.0,4,1,15,0,5,0,2,4,0,20,11,1
6016,163690,komVuIpJ79AnXgdOwFqR0q8Eqk6fTXb3,SpATywNh6bZuzm8s1ceuBUnMUAeoAHHw,1,0,0,0,0,0,1,0,1,0.14285714285714285,1,0.0,0,0,0,0,0,0,0,1,0,0,1,1
6017,163694,sEHJPtMDHp3vOEZBdXoH3aRuuTFrugcC,G8EPVSXsOYB5YQWZGiz1aVq5Pgr2GrQu,10,22,13,0,8,2,5,0,50,7.142857142857143,2,0.0,4,13,0,8,18,2,0,5,0,25,25,1
6018,163698,pDVnQJMhWdSLNejm9F2A6uzPWohSMQmu,G8EPVSXsOYB5YQWZGiz1aVq5Pgr2GrQu,16,12,0,18,0,15,4,1,50,7.142857142857143,1,0.0,7,0,10,0,5,15,8,4,1,17,33,1
6019,163700,zUFpvfPNIssMYrypcxpRp9lQfW6g2Sf6,SpATywNh6bZuzm8s1ceuBUnMUAeoAHHw,7,7,0,0,0,6,11,0,24,3.4285714285714284,1,0.0,2,0,0,0,5,6,0,11,0,2,22,1
6020,163706,CrPF9cMk7uOWPFKqLXtVzkBmR606gvwU,SpATywNh6bZuzm8s1ceuBUnMUAeoAHHw,13,8,4,15,3,2,4,0,36,5.142857142857143,1,0.0,3,4,14,3,5,2,1,4,0,24,12,1
6021,163720,2nKcL79UGpRMTprt0KTar2VFqD9nuGkh,SpATywNh6bZuzm8s1ceuBUnMUAeoAHHw,2,0,0,0,0,0,2,0,2,0.2857142857142857,1,0.0,0,0,0,0,0,0,0,2,0,0,2,1
6022,163724,0YUJjVhFBVhA8wNUqY2rEXkCnd7riq8C,G8EPVSXsOYB5YQWZGiz1aVq5Pgr2GrQu,26,83,20,58,13,13,7,0,194,27.714285714285715,2,0.0,21,20,37,13,62,13,21,7,0,91,103,1
6023,163729,S6XUZDRPe3B3jFFcpBw3sZVQuamNJyiN,SpATywNh6bZuzm8s1ceuBUnMUAeoAHHw,10,6,2,0,2,0,11,1,22,3.142857142857143,1,0.0,0,2,0,2,6,0,0,11,1,4,18,1
6024,163741,D9KO1ppIRpnoCoycPkHQYcH9KJWpl4W7,bWdj2GDclj5ofokWjzoa5jAwMkxCykd6,4,3,1,0,1,0,1,0,6,0.8571428571428571,1,0.0,0,1,0,1,3,0,0,1,0,2,4,1
6025,163745,etVgnbIdb29nIYhfw4jRXWTSVqDVpgA6,bWdj2GDclj5ofokWjzoa5jAwMkxCykd6,5,2,1,0,1,0,2,0,6,0.8571428571428571,1,0.0,0,1,0,1,2,0,0,2,0,2,4,1
6026,163750,Cyn71axG1s2H4lOUgGzQPfwHEpQH7ztK,SpATywNh6bZuzm8s1ceuBUnMUAeoAHHw,15,19,8,12,4,12,3,0,58,8.285714285714286,2,0.0,8,8,12,4,11,12,0,3,0,32,26,1
6027,163768,RqamfvIhC4c7Es8bljx9jvwLrjWv2ac0,RXDvfPUBYFlVdlueBFbLW0mhhAyGEqpt,2,0,0,0,0,0,4,0,4,0.5714285714285714,1,0.0,0,0,0,0,0,0,0,4,0,0,4,1
6028,163778,btnHCoy9MQOM6yfSVhDpkIBjedtnrWxU,RXDvfPUBYFlVdlueBFbLW0mhhAyGEqpt,8,5,4,0,2,0,1,0,12,1.7142857142857142,1,0.0,0,4,0,2,5,0,0,1,0,6,6,1
6029,163779,NerpsmnngCHcZrL9Hd5ZneLeL3p095KD,SpATywNh6bZuzm8s1ceuBUnMUAeoAHHw,6,5,3,0,1,0,4,0,13,1.8571428571428572,1,0.0,0,3,0,1,5,0,0,4,0,4,9,1
6030,163786,SkZlhcjqZI4qlpvHtuOmZh7bgPo5Ar9M,bWdj2GDclj5ofokWjzoa5jAwMkxCykd6,2,0,0,0,0,0,2,0,2,0.2857142857142857,1,0.0,0,0,0,0,0,0,0,2,0,0,2,1
6031,163788,n3c2ApJ73TKxIh3DdiEwlTAkgOAhKXpG,SpATywNh6bZuzm8s1ceuBUnMUAeoAHHw,17,21,12,25,4,16,16,2,96,13.714285714285714,1,0.0,5,12,19,4,16,16,6,16,2,40,56,1
6032,163792,l2L8xysJvlmTPvgXglY4OYbhmyGaWoEy,RXDvfPUBYFlVdlueBFbLW0mhhAyGEqpt,16,8,6,42,3,0,11,1,71,10.142857142857142,1,0.0,2,6,34,3,6,0,8,11,1,45,26,1
6033,163795,YgSP6VTXTaMFsmPeWIUxWWzafDI82Gyz,SpATywNh6bZuzm8s1ceuBUnMUAeoAHHw,5,4,1,0,0,0,5,0,10,1.4285714285714286,3,0.0,0,1,0,0,4,0,0,5,0,1,9,1
6034,163797,Cmo75ZUENQku9o2Ve6I8FB5t9KDDKDgA,SpATywNh6bZuzm8s1ceuBUnMUAeoAHHw,4,4,1,0,1,0,2,0,8,1.1428571428571428,1,0.0,2,1,0,1,2,0,0,2,0,4,4,1
6035,163807,ejqIFmdt0kSod99aitO8eyB1a9BPL17H,SpATywNh6bZuzm8s1ceuBUnMUAeoAHHw,1,0,0,0,0,0,1,0,1,0.14285714285714285,1,0.0,0,0,0,0,0,0,0,1,0,0,1,1
6036,163815,Kp1vLJAjI5XcavfLMkR7KVaehYzBATxU,bWdj2GDclj5ofokWjzoa5jAwMkxCykd6,8,2,1,0,1,1,8,1,14,2.0,1,0.0,0,1,0,1,2,1,0,8,1,2,12,1
6037,163818,Jk2x4OpxMPaHdO7EMry509YRkCM2Yc2p,SpATywNh6bZuzm8s1ceuBUnMUAeoAHHw,12,10,4,16,0,8,7,1,46,6.571428571428571,1,0.0,6,4,14,0,4,8,2,7,1,24,22,1
6038,163843,6ifSGyv1OJBX59YUfupEGQzaFg12QLcw,RXDvfPUBYFlVdlueBFbLW0mhhAyGEqpt,20,29,23,0,2,0,11,0,65,9.285714285714286,3,0.0,0,23,0,2,29,0,0,11,0,25,40,1
6039,163848,KL1kUzCOuvYfkjBJ6sFRxEo1isQ1OD4Z,bWdj2GDclj5ofokWjzoa5jAwMkxCykd6,4,3,0,0,0,0,2,0,5,0.7142857142857143,1,0.0,0,0,0,0,3,0,0,2,0,0,5,1
6040,163856,xKB2JQIJ9xKYEvQWCbLYsbszDegqqoDj,bWdj2GDclj5ofokWjzoa5jAwMkxCykd6,4,3,1,0,1,0,1,0,6,0.8571428571428571,1,0.0,1,1,0,1,2,0,0,1,0,3,3,1
6041,163861,dIc7Ag2KIstBuuBNcnhZG1Qo98HOHtHH,SpATywNh6bZuzm8s1ceuBUnMUAeoAHHw,1,0,0,0,0,0,1,0,1,0.14285714285714285,1,0.0,0,0,0,0,0,0,0,1,0,0,1,1
6042,163872,bUOsk5wGaEvBO4I3alFT753psxzUkzse,RXDvfPUBYFlVdlueBFbLW0mhhAyGEqpt,5,2,1,0,1,0,2,0,6,0.8571428571428571,1,0.0,0,1,0,1,2,0,0,2,0,2,4,1
6043,163876,SSpeewBDHUNKkvUJM5ASinNHvMXIOEwr,SpATywNh6bZuzm8s1ceuBUnMUAeoAHHw,7,7,3,0,1,6,4,0,21,3.0,3,0.0,0,3,0,1,7,6,0,4,0,4,17,1
6044,163878,jX1wtG8uym7vm2Ny85W79HCXnEeqhUm4,SpATywNh6bZuzm8s1ceuBUnMUAeoAHHw,1,0,0,0,0,0,1,0,1,0.14285714285714285,1,0.0,0,0,0,0,0,0,0,1,0,0,1,1
6045,163891,GyWTABuPpZEqO585EnNTIpM2B2faPYN3,bWdj2GDclj5ofokWjzoa5jAwMkxCykd6,4,2,1,0,1,0,1,0,5,0.7142857142857143,1,0.0,0,1,0,1,2,0,0,1,0,2,3,1
6046,163897,HPHciqd0NAfLXfMlyuoYEVDWJNUonGj0,bWdj2GDclj5ofokWjzoa5jAwMkxCykd6,7,59,6,0,4,0,5,0,74,10.571428571428571,2,0.0,3,6,0,4,56,0,0,5,0,13,61,1
6047,163912,KAW52VBDXCvurEAry0tITiLWjcxVkV8S,RXDvfPUBYFlVdlueBFbLW0mhhAyGEqpt,41,34,20,96,13,2,4,0,169,24.142857142857142,1,0.0,9,20,86,13,25,2,10,4,0,128,41,1
6048,163913,aKmGG28IIMsmRYbcnkO5kp7ipo4I9wj0,SpATywNh6bZuzm8s1ceuBUnMUAeoAHHw,9,7,1,6,0,1,5,1,21,3.0,2,0.0,0,1,5,0,7,1,1,5,1,6,15,1
6049,163921,MSZ49Aqf4KMvK8xA9amgTCzlSE1z7F0F,bWdj2GDclj5ofokWjzoa5jAwMkxCykd6,2,0,0,0,0,0,2,0,2,0.2857142857142857,1,0.0,0,0,0,0,0,0,0,2,0,0,2,1
6050,163926,2K1Z8MHkxSfa3IoXQMOOkvPRYry0VFvS,bWdj2GDclj5ofokWjzoa5jAwMkxCykd6,10,9,4,0,1,1,8,1,24,3.4285714285714284,2,0.0,0,4,0,1,9,1,0,8,1,5,19,0
6051,163933,caAQbOI1NkkZKVF3oGPK3OdsY0lbDlYb,RXDvfPUBYFlVdlueBFbLW0mhhAyGEqpt,1,0,0,0,0,0,2,0,2,0.2857142857142857,1,0.0,0,0,0,0,0,0,0,2,0,0,2,1
6052,163943,MIuMzVdl8gwQZWh4ux7IRLhRo5aprHQC,SpATywNh6bZuzm8s1ceuBUnMUAeoAHHw,1,0,0,0,0,0,1,0,1,0.14285714285714285,1,0.0,0,0,0,0,0,0,0,1,0,0,1,1
6053,163953,YgxPec9PZk03SxcMpde0DWwnbgHU13wT,SpATywNh6bZuzm8s1ceuBUnMUAeoAHHw,1,0,0,0,0,0,1,0,1,0.14285714285714285,1,0.0,0,0,0,0,0,0,0,1,0,0,1,1
6054,163958,0bsBNQsCMEE2O55Mpr8lzwhfGggHG2nb,SpATywNh6bZuzm8s1ceuBUnMUAeoAHHw,5,2,1,0,1,0,2,0,6,0.8571428571428571,1,0.0,0,1,0,1,2,0,0,2,0,2,4,1
6055,163964,ncIBIt1kRS23NRG3HklaOrwS2ep1UY7z,SpATywNh6bZuzm8s1ceuBUnMUAeoAHHw,2,0,0,0,0,0,2,0,2,0.2857142857142857,1,0.0,0,0,0,0,0,0,0,2,0,0,2,1
6056,163969,0bsBNQsCMEE2O55Mpr8lzwhfGggHG2nb,G8EPVSXsOYB5YQWZGiz1aVq5Pgr2GrQu,5,2,1,0,1,0,2,0,6,0.8571428571428571,1,0.0,0,1,0,1,2,0,0,2,0,2,4,1
6057,163989,u4a9xsMW9UMqx1X32x8LQI0FlTLRy0KL,SpATywNh6bZuzm8s1ceuBUnMUAeoAHHw,2,0,0,0,0,9,1,0,10,1.4285714285714286,1,0.0,0,0,0,0,0,9,0,1,0,0,10,0
6058,163991,anEiPiaERCYvJFKhHPaXaVlQmETZOxzh,SpATywNh6bZuzm8s1ceuBUnMUAeoAHHw,1,0,0,0,0,0,2,0,2,0.2857142857142857,1,0.0,0,0,0,0,0,0,0,2,0,0,2,1
6059,163992,RiuaU3j9glvJbW4ph026KXgBcE6tugPM,RXDvfPUBYFlVdlueBFbLW0mhhAyGEqpt,1,0,0,0,0,0,1,0,1,0.14285714285714285,1,0.0,0,0,0,0,0,0,0,1,0,0,1,1
6060,164011,JRm4q27yt4AaEMn6KL3V0UaldpldX8N9,SpATywNh6bZuzm8s1ceuBUnMUAeoAHHw,6,1,1,0,1,0,4,0,7,1.0,2,0.0,0,1,0,1,1,0,0,4,0,2,5,1
6061,164016,2CKOPbc4gInQJsnnTPuzmf6nPJ7m7X0V,bWdj2GDclj5ofokWjzoa5jAwMkxCykd6,1,0,0,0,0,0,1,0,1,0.14285714285714285,1,0.0,0,0,0,0,0,0,0,1,0,0,1,1
6062,164019,zDzmXMYgrAR2y36omcEUWoshe9A93Rqa,G8EPVSXsOYB5YQWZGiz1aVq5Pgr2GrQu,3,2,0,0,0,0,4,0,6,0.8571428571428571,1,0.0,0,0,0,0,2,0,0,4,0,0,6,1
6063,164042,HmNDAe5361OzVlrz8LBClXTWLyGOsfB7,SpATywNh6bZuzm8s1ceuBUnMUAeoAHHw,11,12,3,0,2,9,14,0,40,5.714285714285714,2,0.0,0,3,0,2,12,9,0,14,0,5,35,1
6064,164055,eeroiGZDLkmy8hYlMjhf0wHZNeoAekbw,SpATywNh6bZuzm8s1ceuBUnMUAeoAHHw,9,19,7,0,2,1,7,0,36,5.142857142857143,4,0.0,0,7,0,2,19,1,0,7,0,9,27,1
6065,164057,YKkBpxb8WAuGDSQU1z7LvNmikgJLWtZj,SpATywNh6bZuzm8s1ceuBUnMUAeoAHHw,11,18,1,6,1,0,8,0,34,4.857142857142857,3,0.0,1,1,5,1,17,0,1,8,0,8,26,1
6066,164069,NoDqq3WQEPxb31LrvCuk6iDV8wGhNbVA,G8EPVSXsOYB5YQWZGiz1aVq5Pgr2GrQu,17,25,12,24,8,0,3,0,72,10.285714285714286,3,0.0,9,12,18,8,16,0,6,3,0,47,25,1
6067,164070,Rv6gVo5TL2yRLbTriDaWEPebl1P4Qs2d,SpATywNh6bZuzm8s1ceuBUnMUAeoAHHw,15,39,17,13,7,27,11,0,114,16.285714285714285,3,0.0,3,17,12,7,36,27,1,11,0,39,75,1
6068,164080,om0kp3yKpxrkFaqYJciQiQMcbCOWwtTu,SpATywNh6bZuzm8s1ceuBUnMUAeoAHHw,7,6,3,0,2,1,3,1,16,2.2857142857142856,1,0.0,1,3,0,2,5,1,0,3,1,6,10,1
6069,164082,p3rNyoksJ9TEfFEu0f5KZsbSwUZIEvsu,SpATywNh6bZuzm8s1ceuBUnMUAeoAHHw,15,11,4,10,3,2,5,3,38,5.428571428571429,1,0.0,3,4,8,3,8,2,2,5,3,18,20,1
6070,164084,sjjMSkWB5IXcRcDmE2j3kfDFuBFIoN8k,bWdj2GDclj5ofokWjzoa5jAwMkxCykd6,12,21,9,26,6,1,9,1,73,10.428571428571429,1,0.0,6,9,25,6,15,1,1,9,1,46,27,1
6071,164085,EstzqNEYeufsEWzgLWtGlb7e6FUCscoH,SpATywNh6bZuzm8s1ceuBUnMUAeoAHHw,1,0,0,0,0,0,1,0,1,0.14285714285714285,1,0.0,0,0,0,0,0,0,0,1,0,0,1,1
6072,164096,WZJCLDDXV5Wl4Svb3H2g8hACnctxCrNZ,G8EPVSXsOYB5YQWZGiz1aVq5Pgr2GrQu,9,6,2,8,1,0,4,1,22,3.142857142857143,1,0.0,4,2,6,1,2,0,2,4,1,13,9,1
6073,164099,T0RArQ3lSZeSD0MbnDejlzkMufYho8lt,bWdj2GDclj5ofokWjzoa5jAwMkxCykd6,12,11,8,0,8,0,7,2,36,5.142857142857143,2,0.0,0,8,0,8,11,0,0,7,2,16,20,1
6074,164103,LuPgMCIdX2ugHzDAngaEsA394qOat0id,bWdj2GDclj5ofokWjzoa5jAwMkxCykd6,6,9,4,0,0,0,8,0,21,3.0,2,0.0,0,4,0,0,9,0,0,8,0,4,17,1
6075,164104,e6HjcHFSQL7s0bn6pVFAYgFBkk1qs0K8,SpATywNh6bZuzm8s1ceuBUnMUAeoAHHw,4,4,0,0,0,0,2,0,6,0.8571428571428571,1,0.0,1,0,0,0,3,0,0,2,0,1,5,1
6076,164133,C800geUBh3GYBhoh4cW6ReKUGj5LAMGi,RXDvfPUBYFlVdlueBFbLW0mhhAyGEqpt,1,0,0,0,0,0,1,0,1,0.14285714285714285,1,0.0,0,0,0,0,0,0,0,1,0,0,1,1
6077,164145,sG64hLkOLC3BnIsKXDBdltBd6B2Qop5m,SpATywNh6bZuzm8s1ceuBUnMUAeoAHHw,16,23,19,0,13,2,5,0,62,8.857142857142858,3,0.0,0,19,0,13,23,2,0,5,0,32,30,1
6078,164147,jSIHGu9DhhauxAb5p4KNEdGcYL30YLp5,SpATywNh6bZuzm8s1ceuBUnMUAeoAHHw,13,10,1,26,1,0,15,1,54,7.714285714285714,2,0.0,4,1,21,1,6,0,5,15,1,27,27,1
6079,164151,qxuL6lm7O1L6ePIrQ7pAlpyCErX7NoG2,G8EPVSXsOYB5YQWZGiz1aVq5Pgr2GrQu,2,0,0,0,0,0,2,0,2,0.2857142857142857,1,0.0,0,0,0,0,0,0,0,2,0,0,2,0
6080,164161,hf4d4QAFiVVt3bxQ1i3sb92NQtXr4NWg,RXDvfPUBYFlVdlueBFbLW0mhhAyGEqpt,7,5,3,0,1,0,3,0,12,1.7142857142857142,1,0.0,0,3,0,1,5,0,0,3,0,4,8,1
6081,164166,VNMcZCNkGFRxehwmtxH5s6s6Jm24lIUf,G8EPVSXsOYB5YQWZGiz1aVq5Pgr2GrQu,6,8,3,0,2,0,2,0,15,2.142857142857143,1,0.0,3,3,0,2,5,0,0,2,0,8,7,1
6082,164169,g8GaCwXJUf6SPnVxk3h41vOpn1g2rMNj,G8EPVSXsOYB5YQWZGiz1aVq5Pgr2GrQu,20,13,9,20,3,5,9,1,60,8.571428571428571,1,0.0,0,9,18,3,13,5,2,9,1,30,30,1
6083,164174,CVy4kNAaUGvRYYQgXmKQWG6L2OSWreYS,SpATywNh6bZuzm8s1ceuBUnMUAeoAHHw,10,12,1,0,2,1,6,1,23,3.2857142857142856,2,0.0,3,1,0,2,9,1,0,6,1,6,17,1
6084,164183,w4DmyCRPmcVeeul1i1ztSEkbof1km1Nb,bWdj2GDclj5ofokWjzoa5jAwMkxCykd6,5,2,1,0,1,0,2,0,6,0.8571428571428571,1,0.0,0,1,0,1,2,0,0,2,0,2,4,1
6085,164193,ciqNol40it2TXmTV6HAJsQTHc113ipRy,bWdj2GDclj5ofokWjzoa5jAwMkxCykd6,10,24,7,56,5,0,10,0,102,14.571428571428571,2,0.0,11,7,56,5,13,0,0,10,0,79,23,1
6086,164194,nGALou9220OOdyTmGQUn7ZDRMR4UkSXJ,SpATywNh6bZuzm8s1ceuBUnMUAeoAHHw,13,5,4,0,3,0,6,1,19,2.7142857142857144,1,0.0,0,4,0,3,5,0,0,6,1,7,12,1
6087,164206,2YuUQch1UOdzblixrhGJqRyfiL57cYEN,RXDvfPUBYFlVdlueBFbLW0mhhAyGEqpt,2,0,0,0,0,0,2,0,2,0.2857142857142857,1,0.0,0,0,0,0,0,0,0,2,0,0,2,1
6088,164227,DSUKhhpRDohNouwSJME8rOv0HnE7IUjD,G8EPVSXsOYB5YQWZGiz1aVq5Pgr2GrQu,5,1,1,0,1,1,2,0,6,0.8571428571428571,1,0.0,0,1,0,1,1,1,0,2,0,2,4,1
6089,164233,kuZwBvEdgeUtKZ495C2FptBbxEtLtmVH,G8EPVSXsOYB5YQWZGiz1aVq5Pgr2GrQu,9,6,3,0,0,0,7,0,16,2.2857142857142856,2,0.0,0,3,0,0,6,0,0,7,0,3,13,1
6090,164239,puEuN6Xf1uW7cjSgYlTKI73OSHVfNsuZ,SpATywNh6bZuzm8s1ceuBUnMUAeoAHHw,13,12,6,0,4,8,5,1,36,5.142857142857143,1,0.0,5,6,0,4,7,8,0,5,1,15,21,1
6091,164242,wFvodFqghxL7iISMFbYXkYNq6P6eK5gH,bWdj2GDclj5ofokWjzoa5jAwMkxCykd6,1,0,0,0,0,0,2,0,2,0.2857142857142857,1,0.0,0,0,0,0,0,0,0,2,0,0,2,1
6092,164251,vBJL7coMRkaE4FxkSvahGksjBaWY15De,bWdj2GDclj5ofokWjzoa5jAwMkxCykd6,5,2,1,0,1,2,2,0,8,1.1428571428571428,1,0.0,0,1,0,1,2,2,0,2,0,2,6,1
6093,164258,Or6EoLeKHgxe5lrewrc5kj5wcFrtEOsX,G8EPVSXsOYB5YQWZGiz1aVq5Pgr2GrQu,16,20,5,34,2,0,3,0,64,9.142857142857142,4,0.0,2,5,29,2,18,0,5,3,0,38,26,1
6094,164264,Kch5WBTMofTOaqsqvrCwdJnTOQRJP2KH,RXDvfPUBYFlVdlueBFbLW0mhhAyGEqpt,8,5,4,0,2,0,1,0,12,1.7142857142857142,1,0.0,0,4,0,2,5,0,0,1,0,6,6,1
6095,164274,oTNjNy2VCNhMEHkpw5RoIwGj6ModXkSd,SpATywNh6bZuzm8s1ceuBUnMUAeoAHHw,8,2,2,0,2,0,5,0,11,1.5714285714285714,1,0.0,0,2,0,2,2,0,0,5,0,4,7,1
6096,164282,wBacPbVnOV4SRh0JUUHmWhDIds03R7aM,bWdj2GDclj5ofokWjzoa5jAwMkxCykd6,15,23,14,66,5,0,11,0,119,17.0,5,0.0,3,14,63,5,20,0,3,11,0,85,34,1
6097,164286,kargVzTieknsOD52RwWWxzR3bhPo7xCn,bWdj2GDclj5ofokWjzoa5jAwMkxCykd6,2,0,0,0,0,0,2,0,2,0.2857142857142857,1,0.0,0,0,0,0,0,0,0,2,0,0,2,1
6098,164289,OimNh540xAgKAtol4nYQSyjwRKBWvHjV,bWdj2GDclj5ofokWjzoa5jAwMkxCykd6,9,23,8,0,4,1,9,2,47,6.714285714285714,2,0.0,0,8,0,4,23,1,0,9,2,12,35,1
6099,164305,wm5eo4PFQKBWWCDwO21MewWgtJRcPge6,SpATywNh6bZuzm8s1ceuBUnMUAeoAHHw,9,8,5,0,3,1,8,2,27,3.857142857142857,2,0.0,0,5,0,3,8,1,0,8,2,8,19,1
6100,164309,kIQJn1ZGNZIZ21dizjiWH4EHSNMGXOiq,SpATywNh6bZuzm8s1ceuBUnMUAeoAHHw,6,2,1,0,1,0,3,0,7,1.0,1,0.0,0,1,0,1,2,0,0,3,0,2,5,1
6101,164315,cYibpCaMUGq0WjgUWfTv0iIvJ7QbFj5E,bWdj2GDclj5ofokWjzoa5jAwMkxCykd6,1,0,0,0,0,0,1,0,1,0.14285714285714285,1,0.0,0,0,0,0,0,0,0,1,0,0,1,0
6102,164330,5JojY8Vvgh7rjfcAS5764ZRMTC8fo9QP,G8EPVSXsOYB5YQWZGiz1aVq5Pgr2GrQu,21,31,0,36,1,0,4,0,72,10.285714285714286,1,0.0,15,0,28,1,16,0,8,4,0,44,28,1
6103,164370,K6SnVyYj4JLYSaBAXjv9gYLyrrnyqRP0,SpATywNh6bZuzm8s1ceuBUnMUAeoAHHw,4,0,0,0,0,1,5,0,6,0.8571428571428571,1,0.0,0,0,0,0,0,1,0,5,0,0,6,1
6104,164371,5fUv2a4WMEi2Bc60cQo0Uzo1I7SufPfI,RXDvfPUBYFlVdlueBFbLW0mhhAyGEqpt,21,26,0,52,1,15,9,6,109,15.571428571428571,2,0.0,6,0,48,1,20,15,4,9,6,55,54,1
6105,164373,HIaaOq9UrLvo3UC4FIJStVsYhdTvdkJ9,SpATywNh6bZuzm8s1ceuBUnMUAeoAHHw,10,12,0,10,0,0,5,0,27,3.857142857142857,1,0.0,3,0,8,0,9,0,2,5,0,11,16,1
6106,164374,ocTIjxG8zBs0mQRpUtpuAKc7MDpzU7Sd,bWdj2GDclj5ofokWjzoa5jAwMkxCykd6,19,19,8,34,6,19,14,0,100,14.285714285714286,2,0.0,8,8,30,6,11,19,4,14,0,52,48,0
6107,164380,V3KgKcJl8bgXAGMp5c8bz9HnZzQfd0IE,SpATywNh6bZuzm8s1ceuBUnMUAeoAHHw,22,35,17,6,9,9,4,0,80,11.428571428571429,2,0.0,0,17,5,9,35,9,1,4,0,31,49,1
6108,164385,zhF9aamFaaPbw8uvKpkg1m1HOa3rg91T,RXDvfPUBYFlVdlueBFbLW0mhhAyGEqpt,34,25,19,0,13,0,7,0,64,9.142857142857142,3,0.0,0,19,0,13,25,0,0,7,0,32,32,1
6109,164389,9XEvRIJ3KorQF4OT61u2doOr3f5pwaHZ,bWdj2GDclj5ofokWjzoa5jAwMkxCykd6,3,3,1,0,0,0,1,0,5,0.7142857142857143,1,0.0,0,1,0,0,3,0,0,1,0,1,4,1
6110,164392,vfnNYDz3ao0khQiXn6s0MRVTGqDcFM0x,bWdj2GDclj5ofokWjzoa5jAwMkxCykd6,5,5,0,0,1,0,3,1,10,1.4285714285714286,1,0.0,3,0,0,1,2,0,0,3,1,4,6,1
6111,164393,gh8ZFa6DAiOnR8V5MntcWerJGzv2wFJI,SpATywNh6bZuzm8s1ceuBUnMUAeoAHHw,15,24,9,4,5,3,5,0,50,7.142857142857143,2,0.0,10,9,4,5,14,3,0,5,0,28,22,1
6112,164397,xmv8WUz0fQb7fJNMHkcUN733RgAFZjFP,bWdj2GDclj5ofokWjzoa5jAwMkxCykd6,5,10,1,0,1,0,6,0,18,2.5714285714285716,1,0.0,2,1,0,1,8,0,0,6,0,4,14,1
6113,164398,0dNy0sRvDF0sROrAnnVZV2SWJaZTZV2q,SpATywNh6bZuzm8s1ceuBUnMUAeoAHHw,3,2,0,0,0,0,1,0,3,0.42857142857142855,1,0.0,0,0,0,0,2,0,0,1,0,0,3,1
6114,164408,O7I8HNg1rvyItYLfAtm0x1WuepktYnst,SpATywNh6bZuzm8s1ceuBUnMUAeoAHHw,8,11,4,0,4,1,1,0,21,3.0,1,0.0,0,4,0,4,11,1,0,1,0,8,13,1
6115,164422,svMXR8fHg4TBhSD6JDFH6qsNGvdxTr0h,RXDvfPUBYFlVdlueBFbLW0mhhAyGEqpt,11,7,0,0,0,2,8,1,18,2.5714285714285716,1,0.0,0,0,0,0,7,2,0,8,1,0,18,1
6116,164439,g61tiKR5XFhd8PF4WUyM648Aa5Kvlcf3,G8EPVSXsOYB5YQWZGiz1aVq5Pgr2GrQu,6,1,1,0,1,4,4,0,11,1.5714285714285714,2,0.0,0,1,0,1,1,4,0,4,0,2,9,1
6117,164459,viXqqg0vx2jNkZn6Nty7fAz4j4zmpVoE,SpATywNh6bZuzm8s1ceuBUnMUAeoAHHw,17,34,13,23,3,30,17,2,122,17.428571428571427,6,0.0,9,13,18,3,25,30,5,17,2,43,79,0
6118,164462,gD7dR7qYBA1tFY5jHEs9UR01plTA8iId,SpATywNh6bZuzm8s1ceuBUnMUAeoAHHw,13,17,11,11,5,2,2,0,48,6.857142857142857,1,0.0,3,11,10,5,14,2,1,2,0,29,19,0
6119,164463,aczUQgOO0ASt0xksHzYEHmyu3n5i1eK4,SpATywNh6bZuzm8s1ceuBUnMUAeoAHHw,10,14,8,0,4,0,8,0,34,4.857142857142857,1,0.0,3,8,0,4,11,0,0,8,0,15,19,1
6120,164464,Xg16SpIo3MJ3Q7kbAScLhtP5JZXXJDfv,SpATywNh6bZuzm8s1ceuBUnMUAeoAHHw,8,6,4,0,3,0,3,0,16,2.2857142857142856,1,0.0,0,4,0,3,6,0,0,3,0,7,9,1
6121,164465,viXqqg0vx2jNkZn6Nty7fAz4j4zmpVoE,G8EPVSXsOYB5YQWZGiz1aVq5Pgr2GrQu,13,14,6,0,5,0,2,0,27,3.857142857142857,1,0.0,0,6,0,5,14,0,0,2,0,11,16,1
6122,164466,4IAsFbl3b7m8BHNHwE02AfsOFCbBUG0L,SpATywNh6bZuzm8s1ceuBUnMUAeoAHHw,6,4,2,0,2,0,1,0,9,1.2857142857142858,1,0.0,1,2,0,2,3,0,0,1,0,5,4,1
6123,164470,XF7WFiRmBAV2t6CIl4aiymZi2mf5tiFp,SpATywNh6bZuzm8s1ceuBUnMUAeoAHHw,9,3,2,0,2,0,6,0,13,1.8571428571428572,1,0.0,0,2,0,2,3,0,0,6,0,4,9,1
6124,164490,c6KChK06Rh7fb4zwLQYLlfB5pAi9XDtG,bWdj2GDclj5ofokWjzoa5jAwMkxCykd6,8,4,4,0,4,0,3,0,15,2.142857142857143,1,0.0,0,4,0,4,4,0,0,3,0,8,7,1
6125,164493,hjoHxSgIY6b9g4BQWlz8arItNzc0bPJL,G8EPVSXsOYB5YQWZGiz1aVq5Pgr2GrQu,5,2,1,0,1,0,2,0,6,0.8571428571428571,1,0.0,0,1,0,1,2,0,0,2,0,2,4,1
6126,164502,gjOO3qwnQCAatqMKu7gZIW5sztiBAppS,SpATywNh6bZuzm8s1ceuBUnMUAeoAHHw,1,0,0,0,0,0,1,0,1,0.14285714285714285,1,0.0,0,0,0,0,0,0,0,1,0,0,1,1
6127,164506,uydIb4MWCn95KWcEhKwj3VRfjvxXo8Nj,RXDvfPUBYFlVdlueBFbLW0mhhAyGEqpt,6,4,3,0,0,0,2,0,9,1.2857142857142858,1,0.0,0,3,0,0,4,0,0,2,0,3,6,1
6128,164510,mMPoHvW2FNyPz9OBdiCmgMl0cCEFfarc,SpATywNh6bZuzm8s1ceuBUnMUAeoAHHw,10,19,6,0,4,5,3,0,37,5.285714285714286,1,0.0,5,6,0,4,14,5,0,3,0,15,22,1
6129,164511,uydIb4MWCn95KWcEhKwj3VRfjvxXo8Nj,G8EPVSXsOYB5YQWZGiz1aVq5Pgr2GrQu,5,3,2,0,0,0,2,0,7,1.0,1,0.0,0,2,0,0,3,0,0,2,0,2,5,1
6130,164512,Pkfxv8tlzjsegGEz3Xh7AUnCzKYEVDxE,bWdj2GDclj5ofokWjzoa5jAwMkxCykd6,6,4,2,0,1,0,3,0,10,1.4285714285714286,1,0.0,0,2,0,1,4,0,0,3,0,3,7,1
6131,164521,VKk9JpwG9p3VFd3uL9koumwFrK1tXoky,RXDvfPUBYFlVdlueBFbLW0mhhAyGEqpt,10,5,4,0,3,0,2,0,14,2.0,1,0.0,0,4,0,3,5,0,0,2,0,7,7,1
6132,164540,jPMuHTmaLyG60VmyNtfExbwyn5kE5j3d,bWdj2GDclj5ofokWjzoa5jAwMkxCykd6,1,0,0,0,0,0,1,0,1,0.14285714285714285,1,0.0,0,0,0,0,0,0,0,1,0,0,1,1
6133,164543,SFDSK6D3ITcq2gCqSV4NXsxobQMiKjKb,bWdj2GDclj5ofokWjzoa5jAwMkxCykd6,5,2,1,0,1,0,3,0,7,1.0,1,0.0,0,1,0,1,2,0,0,3,0,2,5,1
6134,164548,w7L1HWyOfKnPicf69CWEIAgi9ciJCz91,SpATywNh6bZuzm8s1ceuBUnMUAeoAHHw,11,12,1,12,0,0,3,1,29,4.142857142857143,1,0.0,7,1,10,0,5,0,2,3,1,18,11,1
6135,164549,uDLEkuBy3ymjXkWGDerrVKjWfVpjtLcy,SpATywNh6bZuzm8s1ceuBUnMUAeoAHHw,13,18,4,10,3,0,3,2,40,5.714285714285714,1,0.0,10,4,9,3,8,0,1,3,2,26,14,1
6136,164551,Cs1l7tXWhg4bHVkjgKntjzb2IwXtRhyR,RXDvfPUBYFlVdlueBFbLW0mhhAyGEqpt,5,2,1,0,1,0,3,0,7,1.0,1,0.0,0,1,0,1,2,0,0,3,0,2,5,1
6137,164563,PFKfwO5QSawWdwaylbr1GRPNNNfcQLNj,SpATywNh6bZuzm8s1ceuBUnMUAeoAHHw,23,31,13,22,9,6,16,1,98,14.0,3,0.0,13,13,17,9,18,6,5,16,1,52,46,1
6138,164564,ldTrxeIYDfkDUNaJhbVmYcQDlmvbdP2w,bWdj2GDclj5ofokWjzoa5jAwMkxCykd6,10,3,2,0,2,0,6,0,13,1.8571428571428572,1,0.0,0,2,0,2,3,0,0,6,0,4,9,1
6139,164569,p5rebimhkI0boSbnQg3KGGgWIQAEeFXU,SpATywNh6bZuzm8s1ceuBUnMUAeoAHHw,5,4,2,0,1,2,2,0,11,1.5714285714285714,1,0.0,0,2,0,1,4,2,0,2,0,3,8,1
6140,164572,Vlk2b9egCmW1kemn8Fl1v1olMRLDZnR0,SpATywNh6bZuzm8s1ceuBUnMUAeoAHHw,7,4,3,0,2,0,3,0,12,1.7142857142857142,1,0.0,0,3,0,2,4,0,0,3,0,5,7,1
6141,164577,LzbTNpWVn6fl2StGvYLxuW4MppuRwiQH,G8EPVSXsOYB5YQWZGiz1aVq5Pgr2GrQu,13,10,1,28,0,0,1,0,40,5.714285714285714,1,0.0,0,1,24,0,10,0,4,1,0,25,15,1
6142,164579,qo9UDSPYx7cYCq1gHLr348Aal9eXzAVb,SpATywNh6bZuzm8s1ceuBUnMUAeoAHHw,5,2,1,0,1,0,2,0,6,0.8571428571428571,1,0.0,0,1,0,1,2,0,0,2,0,2,4,1
6143,164584,cd5M4uWjG6TOaf0Pz31O3hIF99iIERs5,RXDvfPUBYFlVdlueBFbLW0mhhAyGEqpt,5,6,1,0,0,1,2,0,10,1.4285714285714286,2,0.0,2,1,0,0,4,1,0,2,0,3,7,1
6144,164589,sXsn7NeZRfEp7S6T00dl609YN1DnViK8,bWdj2GDclj5ofokWjzoa5jAwMkxCykd6,5,2,1,0,1,0,2,0,6,0.8571428571428571,1,0.0,0,1,0,1,2,0,0,2,0,2,4,1
6145,164590,JHnOuSquWHAEnk5XcKmxcm446qLMalAz,SpATywNh6bZuzm8s1ceuBUnMUAeoAHHw,13,32,12,15,9,1,7,0,76,10.857142857142858,1,0.0,9,12,14,9,23,1,1,7,0,44,32,0
6146,164593,SufYsQHcxz6kvXSXszQU44Defcxsd4P8,RXDvfPUBYFlVdlueBFbLW0mhhAyGEqpt,20,30,20,14,8,2,11,6,91,13.0,5,0.0,3,20,14,8,27,2,0,11,6,45,46,1
6147,164595,Mjc1uhwVJSwBIY7NCmz9HAIqxkVGiNWp,SpATywNh6bZuzm8s1ceuBUnMUAeoAHHw,1,0,0,0,0,0,1,0,1,0.14285714285714285,1,0.0,0,0,0,0,0,0,0,1,0,0,1,1
6148,164597,WI9rk8aS11tBAJzjcX0JSIgomYYRQVjW,G8EPVSXsOYB5YQWZGiz1aVq5Pgr2GrQu,4,3,1,0,1,0,1,0,6,0.8571428571428571,1,0.0,0,1,0,1,3,0,0,1,0,2,4,1
6149,164607,2TfX1z2kNH0aJpmX3zI7D0BaWO1JZh1N,G8EPVSXsOYB5YQWZGiz1aVq5Pgr2GrQu,7,2,1,0,1,2,3,0,9,1.2857142857142858,1,0.0,0,1,0,1,2,2,0,3,0,2,7,1
6150,164613,EBMQHva9lsULDK4s7iJrovR7inTeu6Ks,SpATywNh6bZuzm8s1ceuBUnMUAeoAHHw,4,2,1,0,1,0,1,0,5,0.7142857142857143,1,0.0,0,1,0,1,2,0,0,1,0,2,3,1
6151,164627,rCsU9p98QKUXEKegYmRuzzYV8BmhIRdS,SpATywNh6bZuzm8s1ceuBUnMUAeoAHHw,1,0,0,0,0,0,1,0,1,0.14285714285714285,1,0.0,0,0,0,0,0,0,0,1,0,0,1,1
6152,164640,Oi8ENv1r0fh4xZfmyvx6AY0XCiLDaP57,SpATywNh6bZuzm8s1ceuBUnMUAeoAHHw,5,2,1,0,1,0,2,0,6,0.8571428571428571,1,0.0,0,1,0,1,2,0,0,2,0,2,4,1
6153,164641,mneYPOl2fXbFIQgZuY7V0tw2SDw7ktpW,SpATywNh6bZuzm8s1ceuBUnMUAeoAHHw,8,11,2,0,0,0,5,0,18,2.5714285714285716,3,0.0,0,2,0,0,11,0,0,5,0,2,16,1
6154,164643,YxEAEqB4R6GTRBWDvga1GWE0URAxGc6U,bWdj2GDclj5ofokWjzoa5jAwMkxCykd6,3,2,1,0,0,0,1,0,4,0.5714285714285714,1,0.0,0,1,0,0,2,0,0,1,0,1,3,1
6155,164646,iMWyVW74QNpkzwAJujvmKOU3siri8Fgn,RXDvfPUBYFlVdlueBFbLW0mhhAyGEqpt,21,22,9,15,9,0,3,0,58,8.285714285714286,2,0.0,11,9,15,9,11,0,0,3,0,44,14,1
6156,164653,NzAcUY76dhfwRLfnT8WUtgPXMkNyrCBL,SpATywNh6bZuzm8s1ceuBUnMUAeoAHHw,5,2,1,0,1,0,2,0,6,0.8571428571428571,1,0.0,0,1,0,1,2,0,0,2,0,2,4,1
6157,164659,xs8FwmyIICdFtTqViprbjnWxSS7J89Al,G8EPVSXsOYB5YQWZGiz1aVq5Pgr2GrQu,4,7,0,0,0,0,1,0,8,1.1428571428571428,1,0.0,3,0,0,0,4,0,0,1,0,3,5,1
6158,164660,yqw7ro5WJlrZH88vsKBmg60OfoWnl19q,SpATywNh6bZuzm8s1ceuBUnMUAeoAHHw,6,6,2,0,2,0,2,0,12,1.7142857142857142,2,0.0,0,2,0,2,6,0,0,2,0,4,8,1
6159,164673,5HX4czL6Sp8ee3UX2kWAHqmFW5CMMTjE,SpATywNh6bZuzm8s1ceuBUnMUAeoAHHw,1,0,0,0,0,0,1,0,1,0.14285714285714285,1,0.0,0,0,0,0,0,0,0,1,0,0,1,1
6160,164676,3SCBHiEI4HvwPrOQDNTIAqp1rZOAx5IK,SpATywNh6bZuzm8s1ceuBUnMUAeoAHHw,13,11,6,16,3,0,3,0,39,5.571428571428571,2,0.0,3,6,14,3,8,0,2,3,0,26,13,1
6161,164679,3SCBHiEI4HvwPrOQDNTIAqp1rZOAx5IK,G8EPVSXsOYB5YQWZGiz1aVq5Pgr2GrQu,27,9,5,142,0,0,5,0,161,23.0,3,0.0,0,5,124,0,9,0,18,5,0,129,32,1
6162,164683,RLJL0sLgyeMOTE7yAIublGPUVoAHuvDx,G8EPVSXsOYB5YQWZGiz1aVq5Pgr2GrQu,18,17,16,20,10,0,2,0,65,9.285714285714286,1,0.0,0,16,16,10,17,0,4,2,0,42,23,1
6163,164692,yc3vj6DBU7J8xD482LnMAUcmHp7gOl84,SpATywNh6bZuzm8s1ceuBUnMUAeoAHHw,1,0,0,0,0,0,3,0,3,0.42857142857142855,2,0.0,0,0,0,0,0,0,0,3,0,0,3,1
6164,164727,caSt06ZROuiH9pArEzpLM7jwlm2pIP8u,SpATywNh6bZuzm8s1ceuBUnMUAeoAHHw,1,0,0,0,0,0,3,0,3,0.42857142857142855,1,0.0,0,0,0,0,0,0,0,3,0,0,3,1
6165,164748,m5oXLk5fStXUe1mP1ujV3P2Gk727qBkB,SpATywNh6bZuzm8s1ceuBUnMUAeoAHHw,1,0,0,0,0,0,1,0,1,0.14285714285714285,1,0.0,0,0,0,0,0,0,0,1,0,0,1,1
6166,164756,tedGThhHMqVARfBh6zyzyocTKbTJYJpB,RXDvfPUBYFlVdlueBFbLW0mhhAyGEqpt,5,3,2,0,0,0,2,0,7,1.0,1,0.0,0,2,0,0,3,0,0,2,0,2,5,1
6167,164761,DhCQzcFGsfZK6cdFiI5FQU3kb44TMCVX,SpATywNh6bZuzm8s1ceuBUnMUAeoAHHw,3,0,0,0,0,1,2,0,3,0.42857142857142855,1,0.0,0,0,0,0,0,1,0,2,0,0,3,1
6168,164774,ztw81mUsVcWqQkxlUbURYmOFyO40Z11S,SpATywNh6bZuzm8s1ceuBUnMUAeoAHHw,1,0,0,0,0,0,1,0,1,0.14285714285714285,1,0.0,0,0,0,0,0,0,0,1,0,0,1,1
6169,164777,VGDu6m0Ea8YNSzlZeUPCdOS7FC8K56j0,SpATywNh6bZuzm8s1ceuBUnMUAeoAHHw,12,23,10,19,4,0,6,0,62,8.857142857142858,4,0.0,2,10,16,4,21,0,3,6,0,32,30,1
6170,164782,AZ1a6e6HDgHh4sN10TmubQgIG7lRhvX7,bWdj2GDclj5ofokWjzoa5jAwMkxCykd6,3,3,1,0,0,1,1,0,6,0.8571428571428571,1,0.0,0,1,0,0,3,1,0,1,0,1,5,1
6171,164783,HNOiqLBLlemqEjDq99MX1KCbGHtf7sfC,SpATywNh6bZuzm8s1ceuBUnMUAeoAHHw,5,2,1,0,1,0,3,0,7,1.0,1,0.0,0,1,0,1,2,0,0,3,0,2,5,1
6172,164784,vuyiZXIHubBxUI6I8fEoaPJZI5irtStd,SpATywNh6bZuzm8s1ceuBUnMUAeoAHHw,12,22,16,0,10,1,7,2,58,8.285714285714286,2,0.0,2,16,0,10,20,1,0,7,2,28,30,1
6173,164789,0drSvAjmQGn3JsM9rLj67sU9ycFdNRi4,SpATywNh6bZuzm8s1ceuBUnMUAeoAHHw,5,13,0,0,1,0,1,0,15,2.142857142857143,2,0.0,3,0,0,1,10,0,0,1,0,4,11,1
6174,164810,j9RRCN4Cgg3M5ymRYEPqwWpJ0OwCWsXl,G8EPVSXsOYB5YQWZGiz1aVq5Pgr2GrQu,1,0,0,0,0,0,1,0,1,0.14285714285714285,1,0.0,0,0,0,0,0,0,0,1,0,0,1,1
6175,164876,jqdafBVztOaU7B8oBuajiXxvz1FDItGv,SpATywNh6bZuzm8s1ceuBUnMUAeoAHHw,1,0,0,0,0,0,1,0,1,0.14285714285714285,1,0.0,0,0,0,0,0,0,0,1,0,0,1,1
6176,164881,R7ptDQN35cKkqrWYU1EoWDk89h01yGje,RXDvfPUBYFlVdlueBFbLW0mhhAyGEqpt,1,0,0,0,0,0,1,0,1,0.14285714285714285,1,0.0,0,0,0,0,0,0,0,1,0,0,1,1
6177,164889,DivG3ogmCJeK3pKkDuguqXmAxv3265HB,bWdj2GDclj5ofokWjzoa5jAwMkxCykd6,8,11,1,0,2,0,10,0,24,3.4285714285714284,2,0.0,2,1,0,2,9,0,0,10,0,5,19,1
6178,164895,fr5elk998a9p9TdUbECrRSQ9rGDS8c9D,SpATywNh6bZuzm8s1ceuBUnMUAeoAHHw,3,0,0,0,0,1,2,0,3,0.42857142857142855,1,0.0,0,0,0,0,0,1,0,2,0,0,3,1
6179,164900,vqI4nA1oYdvinhdwhAimFfTLZs6qGSC5,G8EPVSXsOYB5YQWZGiz1aVq5Pgr2GrQu,8,6,2,4,2,0,2,0,16,2.2857142857142856,1,0.0,3,2,3,2,3,0,1,2,0,10,6,1
6180,164909,DttwjifTB7tngrOzE4lsIB8DzMDnSPZc,SpATywNh6bZuzm8s1ceuBUnMUAeoAHHw,8,2,1,0,1,1,6,1,12,1.7142857142857142,1,0.0,0,1,0,1,2,1,0,6,1,2,10,0
6181,164914,VAF0Nhm4Uogjf17s6SveryaIcEEMWJow,SpATywNh6bZuzm8s1ceuBUnMUAeoAHHw,6,6,1,0,1,0,2,0,10,1.4285714285714286,1,0.0,0,1,0,1,6,0,0,2,0,2,8,1
6182,164918,R7wdnz7rd7yU47Qq2pD3NnafkKkL5gzl,bWdj2GDclj5ofokWjzoa5jAwMkxCykd6,3,2,0,0,0,0,1,0,3,0.42857142857142855,1,0.0,0,0,0,0,2,0,0,1,0,0,3,1
6183,164919,re5aCokPT0KNmuJHbgQvisAT0CcTxib5,SpATywNh6bZuzm8s1ceuBUnMUAeoAHHw,7,5,1,0,1,0,3,0,10,1.4285714285714286,2,0.0,0,1,0,1,5,0,0,3,0,2,8,1
6184,164922,JYJhzhhLcfWnYO62UZR1KbHHs0q9wRVk,bWdj2GDclj5ofokWjzoa5jAwMkxCykd6,13,18,12,0,11,5,14,3,63,9.0,3,0.0,0,12,0,11,18,5,0,14,3,23,40,1
6185,164923,Zoez9P6Io2KASPtKsQZfhyeC8nEU9r7r,SpATywNh6bZuzm8s1ceuBUnMUAeoAHHw,9,3,2,0,2,1,6,0,14,2.0,1,0.0,0,2,0,2,3,1,0,6,0,4,10,1
6186,164927,qr1Y8xuPrcpdzScNHYsirGXqasfUdOVa,bWdj2GDclj5ofokWjzoa5jAwMkxCykd6,8,10,6,0,3,1,8,0,28,4.0,2,0.0,0,6,0,3,10,1,0,8,0,9,19,1
6187,164937,i39wrwOFUT4cBFVx9tMMQ3lQ2qJwZK9W,G8EPVSXsOYB5YQWZGiz1aVq5Pgr2GrQu,4,7,1,0,0,0,2,0,10,1.4285714285714286,1,0.0,0,1,0,0,7,0,0,2,0,1,9,1
6188,164942,OOJh2Yrr6RQf9QAHFBo7EBzeZ2OAmLfw,bWdj2GDclj5ofokWjzoa5jAwMkxCykd6,5,5,2,0,1,0,2,0,10,1.4285714285714286,2,0.0,0,2,0,1,5,0,0,2,0,3,7,1
6189,164944,stWyUqkAGnjcutkepILPjL3dk2mkjbHM,SpATywNh6bZuzm8s1ceuBUnMUAeoAHHw,1,0,0,0,0,0,1,0,1,0.14285714285714285,1,0.0,0,0,0,0,0,0,0,1,0,0,1,1
6190,164953,8lCrBaMkcXk8KsL7M8AYgjnsyFuSP4yK,RXDvfPUBYFlVdlueBFbLW0mhhAyGEqpt,9,10,7,0,3,0,3,0,23,3.2857142857142856,2,0.0,0,7,0,3,10,0,0,3,0,10,13,1
6191,164975,QWhWii7LiCaC2aGmlsc9abDahkygX2yj,RXDvfPUBYFlVdlueBFbLW0mhhAyGEqpt,35,54,1,52,16,6,14,2,145,20.714285714285715,2,0.0,39,1,52,16,15,6,0,14,2,108,37,1
6192,164977,PEXlBba7AOVIBit4NUGVqaiGwqnJFccE,SpATywNh6bZuzm8s1ceuBUnMUAeoAHHw,7,2,1,0,1,1,6,7,18,2.5714285714285716,1,0.0,0,1,0,1,2,1,0,6,7,2,16,1
6193,164986,lOmRRXGlwgiYmSj7mCzKIIlzTAddACO4,G8EPVSXsOYB5YQWZGiz1aVq5Pgr2GrQu,5,3,0,0,0,0,2,0,5,0.7142857142857143,1,0.0,0,0,0,0,3,0,0,2,0,0,5,1
6194,164996,jXdIWOuPNFgWCy1owZ0YCDgHmNjNpxj3,A3fsA9Zfv1X2fVEQhTw51lKENdNrEqT3,1,0,0,0,0,0,1,0,1,0.14285714285714285,1,0.0,0,0,0,0,0,0,0,1,0,0,1,1
6195,165010,vl5hKvQ1HbHB8mWdynets5dYianhkkEw,SpATywNh6bZuzm8s1ceuBUnMUAeoAHHw,23,26,2,41,1,2,8,0,80,11.428571428571429,1,0.0,9,2,34,1,17,2,7,8,0,46,34,1
6196,165032,KAsAnmW0W2sAx9iOumNKdePG23m5o5NZ,G8EPVSXsOYB5YQWZGiz1aVq5Pgr2GrQu,5,2,1,0,1,0,2,0,6,0.8571428571428571,1,0.0,0,1,0,1,2,0,0,2,0,2,4,1
6197,165033,YtmzH8LgN5OvtPELquH1F749iO0gQ3Tb,A3fsA9Zfv1X2fVEQhTw51lKENdNrEqT3,2,0,0,0,0,0,2,0,2,0.2857142857142857,1,0.0,0,0,0,0,0,0,0,2,0,0,2,1
6198,165036,qLiLNfiu26gzDxiYwA4Ap7WJgGvbO54T,G8EPVSXsOYB5YQWZGiz1aVq5Pgr2GrQu,18,11,10,18,9,0,1,0,49,7.0,1,0.0,0,10,14,9,11,0,4,1,0,33,16,1
6199,165060,YroV7xThop5SUet6C6S1SEBaTvc7XX29,bWdj2GDclj5ofokWjzoa5jAwMkxCykd6,4,2,1,0,1,0,1,0,5,0.7142857142857143,1,0.0,0,1,0,1,2,0,0,1,0,2,3,1
6200,165071,gW23nkmgj3NMln4Q9bQA0x4tJhRu8aiU,SpATywNh6bZuzm8s1ceuBUnMUAeoAHHw,16,25,11,16,6,0,10,1,69,9.857142857142858,1,0.0,6,11,15,6,19,0,1,10,1,38,31,1
6201,165081,L0W17t6QNDHcTTYTnmTQY5Vw4L806sfw,SpATywNh6bZuzm8s1ceuBUnMUAeoAHHw,9,7,5,0,3,0,3,0,18,2.5714285714285716,2,0.0,0,5,0,3,7,0,0,3,0,8,10,1
6202,165092,HA5bOUyNRCHCSCRIajqqX7k2ZeKuADcF,A3fsA9Zfv1X2fVEQhTw51lKENdNrEqT3,1,0,0,0,0,0,1,0,1,0.14285714285714285,1,0.0,0,0,0,0,0,0,0,1,0,0,1,1
6203,165093,S58o7T8J2JcEBTi3bdMATXeMdhJbXqYq,A3fsA9Zfv1X2fVEQhTw51lKENdNrEqT3,3,0,0,0,0,0,4,0,4,0.5714285714285714,1,0.0,0,0,0,0,0,0,0,4,0,0,4,1
6204,165099,eSLdnCsz2kfsBjZ0LZmqHuo4kYNor6E7,SpATywNh6bZuzm8s1ceuBUnMUAeoAHHw,20,22,1,17,0,7,3,0,50,7.142857142857143,1,0.0,6,1,17,0,16,7,0,3,0,24,26,1
6205,165101,RdxIloCKNwZUjAJCbmYybZmkq8rwh2UY,bWdj2GDclj5ofokWjzoa5jAwMkxCykd6,4,2,1,0,1,0,1,0,5,0.7142857142857143,1,0.0,0,1,0,1,2,0,0,1,0,2,3,1
6206,165138,iqnxkAIvXEPq7LutRrGOzst5meEvTsYz,SpATywNh6bZuzm8s1ceuBUnMUAeoAHHw,15,13,5,1,4,0,7,0,30,4.285714285714286,2,0.0,5,5,1,4,8,0,0,7,0,15,15,1
6207,165145,DSvps80WgA0EgfU877YLgHsnaYGMmkvB,SpATywNh6bZuzm8s1ceuBUnMUAeoAHHw,8,3,2,0,2,7,3,1,18,2.5714285714285716,1,0.0,0,2,0,2,3,7,0,3,1,4,14,1
6208,165151,CXDFvBGg10x2RDdl5BC09Fv76dN9FJm7,G8EPVSXsOYB5YQWZGiz1aVq5Pgr2GrQu,18,25,11,16,3,2,2,0,59,8.428571428571429,2,0.0,7,11,9,3,18,2,7,2,0,30,29,1
6209,165162,5VFQZe1xiEoGXldz0K3uPFcNAeVpHehR,SpATywNh6bZuzm8s1ceuBUnMUAeoAHHw,10,4,4,0,3,0,4,0,15,2.142857142857143,1,0.0,0,4,0,3,4,0,0,4,0,7,8,1
6210,165188,3G9snyduwX0rdXWU1KviPhf7GghlChs3,RXDvfPUBYFlVdlueBFbLW0mhhAyGEqpt,10,12,7,0,1,4,11,0,35,5.0,1,0.0,0,7,0,1,12,4,0,11,0,8,27,1
6211,165191,gR8vpBOtEmg1p0U3mlFoyPZ2gKmD8M8k,A3fsA9Zfv1X2fVEQhTw51lKENdNrEqT3,1,0,0,0,0,0,1,0,1,0.14285714285714285,1,0.0,0,0,0,0,0,0,0,1,0,0,1,1
6212,165219,wxXN8RNX3CwZNnolATAAIEVSki3SPiEo,SpATywNh6bZuzm8s1ceuBUnMUAeoAHHw,2,0,0,0,0,0,2,0,2,0.2857142857142857,1,0.0,0,0,0,0,0,0,0,2,0,0,2,1
6213,165237,gKv0B6A68Wpl10k5COv8OtVYBXqYOYRH,SpATywNh6bZuzm8s1ceuBUnMUAeoAHHw,1,0,0,0,0,0,1,0,1,0.14285714285714285,1,0.0,0,0,0,0,0,0,0,1,0,0,1,1
6214,165253,muJ6MIRhOdDL6SrbHsZ7Ks5a50Iz9AeC,bWdj2GDclj5ofokWjzoa5jAwMkxCykd6,5,2,1,0,1,0,2,0,6,0.8571428571428571,1,0.0,0,1,0,1,2,0,0,2,0,2,4,0
6215,165271,jcO499WyDjlHOvUgk4ks7QVYWjH4e9LQ,SpATywNh6bZuzm8s1ceuBUnMUAeoAHHw,1,0,0,0,0,0,1,0,1,0.14285714285714285,1,0.0,0,0,0,0,0,0,0,1,0,0,1,1
6216,165281,GFb1F59UyYIHTp4jDg01zdNYbr3jH9yn,SpATywNh6bZuzm8s1ceuBUnMUAeoAHHw,11,5,3,0,2,3,8,2,23,3.2857142857142856,1,0.0,0,3,0,2,5,3,0,8,2,5,18,1
6217,165285,GFb1F59UyYIHTp4jDg01zdNYbr3jH9yn,A3fsA9Zfv1X2fVEQhTw51lKENdNrEqT3,1,0,0,0,0,0,1,0,1,0.14285714285714285,1,0.0,0,0,0,0,0,0,0,1,0,0,1,1
6218,165290,ACy24Kiib1ICxyQzhy0EUbYqbqlHiujI,bWdj2GDclj5ofokWjzoa5jAwMkxCykd6,10,8,3,0,2,1,4,1,19,2.7142857142857144,1,0.0,0,3,0,2,8,1,0,4,1,5,14,1
6219,165308,FGZPr41giRou6aZ5USTD1C0RRSJGXFKn,G8EPVSXsOYB5YQWZGiz1aVq5Pgr2GrQu,8,7,3,0,2,0,2,0,14,2.0,1,0.0,0,3,0,2,7,0,0,2,0,5,9,1
6220,165339,LOR1iUTDul78F0nRew73RCh87CQAgj7q,SpATywNh6bZuzm8s1ceuBUnMUAeoAHHw,1,0,0,0,0,0,1,0,1,0.14285714285714285,1,0.0,0,0,0,0,0,0,0,1,0,0,1,1
6221,165347,oaoj9be4jW2Hot8wYgYrzLRvB0RU4KYy,RXDvfPUBYFlVdlueBFbLW0mhhAyGEqpt,5,6,3,0,1,0,3,0,13,1.8571428571428572,3,0.0,0,3,0,1,6,0,0,3,0,4,9,1
6222,165351,5NsbP59FWlyl4NFONUzt3drLLr5EFRFj,SpATywNh6bZuzm8s1ceuBUnMUAeoAHHw,2,0,0,0,0,0,2,0,2,0.2857142857142857,1,0.0,0,0,0,0,0,0,0,2,0,0,2,1
6223,165355,gmPDrqW0AqIaoYWNfDXV8E4PTJ0tnkbT,SpATywNh6bZuzm8s1ceuBUnMUAeoAHHw,10,4,3,0,1,5,8,1,22,3.142857142857143,1,0.0,0,3,0,1,4,5,0,8,1,4,18,1
6224,165387,eXv6ACzt62C4hMSoDSIQMvmz4LEnGBtm,bWdj2GDclj5ofokWjzoa5jAwMkxCykd6,6,4,3,0,2,0,2,0,11,1.5714285714285714,1,0.0,0,3,0,2,4,0,0,2,0,5,6,1
6225,165391,4BWY4WoZwowebQpACrizuzaSUpqFUPYV,SpATywNh6bZuzm8s1ceuBUnMUAeoAHHw,7,2,0,0,0,1,8,2,13,1.8571428571428572,1,0.0,0,0,0,0,2,1,0,8,2,0,13,1
6226,165395,wJflvpFe05Aoyiv7JkqhQs7iDcvnIpoZ,SpATywNh6bZuzm8s1ceuBUnMUAeoAHHw,3,0,0,0,0,0,4,0,4,0.5714285714285714,1,0.0,0,0,0,0,0,0,0,4,0,0,4,1
6227,165397,4BWY4WoZwowebQpACrizuzaSUpqFUPYV,RXDvfPUBYFlVdlueBFbLW0mhhAyGEqpt,1,0,0,0,0,0,2,0,2,0.2857142857142857,1,0.0,0,0,0,0,0,0,0,2,0,0,2,1
6228,165408,PpFcLwYNJUnxth5yje9ruR1epB1qasdR,G8EPVSXsOYB5YQWZGiz1aVq5Pgr2GrQu,1,0,0,0,0,0,1,0,1,0.14285714285714285,1,0.0,0,0,0,0,0,0,0,1,0,0,1,1
6229,165416,7gfKKxmAEuUaewGGeFJgV5nEPJNQy1ri,bWdj2GDclj5ofokWjzoa5jAwMkxCykd6,6,3,1,0,1,0,2,0,7,1.0,1,0.0,0,1,0,1,3,0,0,2,0,2,5,1
6230,165421,MuPHXkwjCSwz1RoycqAjYJvCwPC5fRHQ,SpATywNh6bZuzm8s1ceuBUnMUAeoAHHw,4,2,0,0,0,0,3,0,5,0.7142857142857143,1,0.0,0,0,0,0,2,0,0,3,0,0,5,0
6231,165424,unnmDTt6VikDSSld76xj3NnZu4moxEml,SpATywNh6bZuzm8s1ceuBUnMUAeoAHHw,4,2,1,0,1,0,1,0,5,0.7142857142857143,1,0.0,0,1,0,1,2,0,0,1,0,2,3,1
6232,165443,Q9be6Sv8ddFyvZit7vIIJ8yY710RxCDU,A3fsA9Zfv1X2fVEQhTw51lKENdNrEqT3,2,0,0,0,0,0,3,0,3,0.42857142857142855,1,0.0,0,0,0,0,0,0,0,3,0,0,3,1
6233,165466,mURbRAHPKPnW9MwIb0RLcTIXqQNH7qbA,G8EPVSXsOYB5YQWZGiz1aVq5Pgr2GrQu,8,4,3,4,2,0,1,0,14,2.0,1,0.0,0,3,3,2,4,0,1,1,0,8,6,1
6234,165471,zrTXSfdUWbNWByIycayXKhWX2nhPdOah,SpATywNh6bZuzm8s1ceuBUnMUAeoAHHw,5,3,2,0,2,0,2,0,9,1.2857142857142858,1,0.0,0,2,0,2,3,0,0,2,0,4,5,1
6235,165474,ef55znmweQJrijlI0fO1Ekc271nZnV0m,bWdj2GDclj5ofokWjzoa5jAwMkxCykd6,4,0,0,0,0,0,3,1,4,0.5714285714285714,1,0.0,0,0,0,0,0,0,0,3,1,0,4,1
6236,165476,wg9kzusa79hS4fFC5hU9Laht66GWJcDA,SpATywNh6bZuzm8s1ceuBUnMUAeoAHHw,2,0,0,0,0,0,2,0,2,0.2857142857142857,1,0.0,0,0,0,0,0,0,0,2,0,0,2,1
6237,165480,u8gc5TatjVTaxEyEUtNlqAAFJuTBFyST,SpATywNh6bZuzm8s1ceuBUnMUAeoAHHw,1,0,0,0,0,0,1,0,1,0.14285714285714285,1,0.0,0,0,0,0,0,0,0,1,0,0,1,1
6238,165494,kVwgJQqzaO15lvZkwwinpycbi4tCASRL,G8EPVSXsOYB5YQWZGiz1aVq5Pgr2GrQu,17,23,3,18,4,13,2,1,64,9.142857142857142,1,0.0,15,3,10,4,8,13,8,2,1,32,32,1
6239,165498,khqyesGKZx6MpifmBhKg4XXFdITB5Rat,bWdj2GDclj5ofokWjzoa5jAwMkxCykd6,2,0,0,0,0,0,2,0,2,0.2857142857142857,1,0.0,0,0,0,0,0,0,0,2,0,0,2,1
6240,165517,K96pKWxanyeEDM8caXTjQInVlZNIUXf3,SpATywNh6bZuzm8s1ceuBUnMUAeoAHHw,25,19,9,19,6,15,11,2,81,11.571428571428571,2,0.0,7,9,16,6,12,15,3,11,2,38,43,1
6241,165533,CTzsOL49UPUArAP2sAfnnQhe79FdliFF,A3fsA9Zfv1X2fVEQhTw51lKENdNrEqT3,7,8,1,0,1,0,2,0,12,1.7142857142857142,1,0.0,2,1,0,1,6,0,0,2,0,4,8,1
6242,165544,cLRv4oHsLxWfkE6gs4eN6fO5y0RK8Odw,SpATywNh6bZuzm8s1ceuBUnMUAeoAHHw,21,22,3,23,1,0,5,0,54,7.714285714285714,2,0.0,7,3,22,1,15,0,1,5,0,33,21,1
6243,165551,8HRO39ObdbulUBajMG3YAwK0YHdJtgkL,SpATywNh6bZuzm8s1ceuBUnMUAeoAHHw,13,19,5,20,2,0,1,0,47,6.714285714285714,1,0.0,10,5,17,2,9,0,3,1,0,34,13,1
6244,165561,31ac9IJz27HinkIEt0yrmmYrar7i8NEX,SpATywNh6bZuzm8s1ceuBUnMUAeoAHHw,1,0,0,0,0,0,1,0,1,0.14285714285714285,1,0.0,0,0,0,0,0,0,0,1,0,0,1,1
6245,165574,JfftjOGdDbpgbrupi0Gwr899R0jzXikJ,G8EPVSXsOYB5YQWZGiz1aVq5Pgr2GrQu,14,14,7,0,4,2,7,1,35,5.0,3,0.0,0,7,0,4,14,2,0,7,1,11,24,1
6246,165575,8aKlO5cCI4yOnqtrz5S83gXv1equhodS,G8EPVSXsOYB5YQWZGiz1aVq5Pgr2GrQu,8,8,2,0,3,0,3,0,16,2.2857142857142856,1,0.0,6,2,0,3,2,0,0,3,0,11,5,1
6247,165579,L1KQaJmsFUgy5JpGUsnj3yIIihvD4WWY,SpATywNh6bZuzm8s1ceuBUnMUAeoAHHw,7,10,5,0,2,0,2,0,19,2.7142857142857144,1,0.0,3,5,0,2,7,0,0,2,0,10,9,1
6248,165580,qoIGs6RP8XMC5yN9VowJtSVp77FsPrRk,bWdj2GDclj5ofokWjzoa5jAwMkxCykd6,16,16,8,4,6,1,6,4,45,6.428571428571429,2,0.0,1,8,4,6,15,1,0,6,4,19,26,1
6249,165594,JlrarspOUiM43Q1LxxzJX6UJ5zQZ4pa3,G8EPVSXsOYB5YQWZGiz1aVq5Pgr2GrQu,4,2,1,0,1,0,1,0,5,0.7142857142857143,1,0.0,0,1,0,1,2,0,0,1,0,2,3,1
6250,165631,GEZRjwL8K0Izm01jtEreajWlGeO5rHqg,SpATywNh6bZuzm8s1ceuBUnMUAeoAHHw,10,9,3,22,1,0,5,0,40,5.714285714285714,2,0.0,3,3,18,1,6,0,4,5,0,25,15,1
6251,165637,OLNUzQUHvlNsi2WFlH5eEyaieqKXrEz7,G8EPVSXsOYB5YQWZGiz1aVq5Pgr2GrQu,1,0,0,0,0,0,1,0,1,0.14285714285714285,1,0.0,0,0,0,0,0,0,0,1,0,0,1,1
6252,165660,Jxd0Gyi2eFjuuzujg1eSA5QBX1QonMfb,A3fsA9Zfv1X2fVEQhTw51lKENdNrEqT3,8,8,7,0,7,0,4,0,26,3.7142857142857144,1,0.0,0,7,0,7,8,0,0,4,0,14,12,1
6253,165668,e4SJlWpUdMlW0LkwuTE29pgj3noS6rgx,SpATywNh6bZuzm8s1ceuBUnMUAeoAHHw,1,0,0,0,0,0,2,0,2,0.2857142857142857,2,0.0,0,0,0,0,0,0,0,2,0,0,2,1
6254,165670,ec1LcdXAjzvm4pz4UlXIURCzEb68OOjY,SpATywNh6bZuzm8s1ceuBUnMUAeoAHHw,1,0,0,0,0,0,1,0,1,0.14285714285714285,1,0.0,0,0,0,0,0,0,0,1,0,0,1,0
6255,165671,ldzbIC4VdNsM8t2O505cyUmYK0rWwYfY,bWdj2GDclj5ofokWjzoa5jAwMkxCykd6,5,0,0,0,0,0,4,1,5,0.7142857142857143,1,0.0,0,0,0,0,0,0,0,4,1,0,5,1
6256,165674,q8fKbbyHDwglzqbsTcqtDnNuKFFWoakG,SpATywNh6bZuzm8s1ceuBUnMUAeoAHHw,5,2,1,0,1,0,2,0,6,0.8571428571428571,1,0.0,0,1,0,1,2,0,0,2,0,2,4,1
6257,165687,rzRsiRIy5S5PJ3F6R6iAFiLgtXERTKGk,SpATywNh6bZuzm8s1ceuBUnMUAeoAHHw,12,16,9,0,2,1,5,1,34,4.857142857142857,1,0.0,0,9,0,2,16,1,0,5,1,11,23,1
6258,165704,aBWIo3Zb0x1GrHxSSFQ0sr4ViufznfA6,bWdj2GDclj5ofokWjzoa5jAwMkxCykd6,2,0,0,0,0,0,5,0,5,0.7142857142857143,2,0.0,0,0,0,0,0,0,0,5,0,0,5,0
6259,165720,EelpZh5xWl6mtPCPTTMGh3oiYl9f9eIu,SpATywNh6bZuzm8s1ceuBUnMUAeoAHHw,4,3,2,0,0,0,1,0,6,0.8571428571428571,1,0.0,0,2,0,0,3,0,0,1,0,2,4,1
6260,165753,K7gxH2H2bYXoDZcS1lp3t0a4OCfbOLwQ,bWdj2GDclj5ofokWjzoa5jAwMkxCykd6,6,1,1,0,1,0,5,0,8,1.1428571428571428,1,0.0,0,1,0,1,1,0,0,5,0,2,6,1
6261,165754,K6ObBSwI3jvthL8D7fF5vG4yQ857Kh2f,SpATywNh6bZuzm8s1ceuBUnMUAeoAHHw,1,0,0,0,0,0,1,0,1,0.14285714285714285,1,0.0,0,0,0,0,0,0,0,1,0,0,1,1
6262,165767,hbzbE3YW3TFJZGn3KQWHVTTu9qGbrE8v,bWdj2GDclj5ofokWjzoa5jAwMkxCykd6,5,2,1,0,1,0,2,0,6,0.8571428571428571,1,0.0,0,1,0,1,2,0,0,2,0,2,4,1
6263,165772,HpI5z92WE9TCj3JyfZi0b0yrE9hT84vs,A3fsA9Zfv1X2fVEQhTw51lKENdNrEqT3,1,0,0,0,0,0,1,0,1,0.14285714285714285,1,0.0,0,0,0,0,0,0,0,1,0,0,1,1
6264,165774,OOTqWE5x0MzBGyALni92jmdLSQIdjajZ,G8EPVSXsOYB5YQWZGiz1aVq5Pgr2GrQu,5,4,1,0,0,0,3,0,8,1.1428571428571428,1,0.0,0,1,0,0,4,0,0,3,0,1,7,1
6265,165784,rh0SgumcqbNnCp7Kv0VptrPMVPtrWDm8,RXDvfPUBYFlVdlueBFbLW0mhhAyGEqpt,1,0,0,0,0,0,1,0,1,0.14285714285714285,1,0.0,0,0,0,0,0,0,0,1,0,0,1,1
6266,165796,0Au7FrQGJI1dB5PAH0C5RtkL9GE7xsrQ,G8EPVSXsOYB5YQWZGiz1aVq5Pgr2GrQu,2,0,0,0,0,0,2,0,2,0.2857142857142857,1,0.0,0,0,0,0,0,0,0,2,0,0,2,1
6267,165809,Be8IM2i8TFABf4hrPs9xmqBicVH2EMoi,SpATywNh6bZuzm8s1ceuBUnMUAeoAHHw,5,2,1,0,1,0,2,0,6,0.8571428571428571,1,0.0,0,1,0,1,2,0,0,2,0,2,4,1
6268,165968,m2dEISaBvHWrLGQEI5zibEiH1nbUMDmE,fbPkOYLVPtPgIt0MxizjfFJov3JbHyAi,9,5,4,0,4,0,2,0,15,2.142857142857143,1,0.0,0,4,0,4,5,0,0,2,0,8,7,1
6269,165971,No3uaZVX8QfUWi2WuoYFYrVrLQNiuZit,fbPkOYLVPtPgIt0MxizjfFJov3JbHyAi,7,7,5,0,1,0,2,0,15,2.142857142857143,1,0.0,1,5,0,1,6,0,0,2,0,7,8,0
6270,166041,LShHu6uYlRN5bIHuJkopPqEfnHxBTC8i,fbPkOYLVPtPgIt0MxizjfFJov3JbHyAi,2,0,0,0,0,0,5,0,5,0.7142857142857143,1,0.0,0,0,0,0,0,0,0,5,0,0,5,1
6271,166043,N9J0YMMUvYV85FVJ0qX5eo6FonnNSF85,fbPkOYLVPtPgIt0MxizjfFJov3JbHyAi,2,0,0,0,0,0,2,0,2,0.2857142857142857,1,0.0,0,0,0,0,0,0,0,2,0,0,2,1
6272,166046,r0yZNwEG828V0TMkCl61Reya5Y5HO5aR,fbPkOYLVPtPgIt0MxizjfFJov3JbHyAi,4,3,1,0,1,0,1,0,6,0.8571428571428571,1,0.0,0,1,0,1,3,0,0,1,0,2,4,0
6273,166050,dTKURyZ9dyqGbe4l7wsUGgSU85JHBAFq,fbPkOYLVPtPgIt0MxizjfFJov3JbHyAi,4,2,1,0,1,0,1,0,5,0.7142857142857143,1,0.0,0,1,0,1,2,0,0,1,0,2,3,0
6274,166051,zys4H0zoKgEwqaSlxuoMh0ylzZsMRp6B,fbPkOYLVPtPgIt0MxizjfFJov3JbHyAi,8,2,2,0,2,0,3,0,9,1.2857142857142858,1,0.0,0,2,0,2,2,0,0,3,0,4,5,1
6275,166052,zRVD6VEUKDrryOP1TvtbSCWZetILcTFA,fbPkOYLVPtPgIt0MxizjfFJov3JbHyAi,5,3,1,0,1,0,2,0,7,1.0,1,0.0,1,1,0,1,2,0,0,2,0,3,4,1
6276,166054,aCi7yBADL9TO8ilUuxPHdQalGIRg3aJr,fbPkOYLVPtPgIt0MxizjfFJov3JbHyAi,6,1,1,0,1,3,4,0,10,1.4285714285714286,1,0.0,0,1,0,1,1,3,0,4,0,2,8,1
6277,166055,dMp1KIJnUk3pJLRma1sY50MtqbX92XeU,fbPkOYLVPtPgIt0MxizjfFJov3JbHyAi,4,2,1,0,0,0,2,0,5,0.7142857142857143,1,0.0,0,1,0,0,2,0,0,2,0,1,4,1
6278,166056,RXpyLiihGXUCA8h1EctnHTjiraMHD0a4,fbPkOYLVPtPgIt0MxizjfFJov3JbHyAi,7,5,3,0,2,4,2,0,16,2.2857142857142856,1,0.0,0,3,0,2,5,4,0,2,0,5,11,1
6279,166061,8gVI3RCzdwrb0srHH9NO7stO8AUu1uCR,fbPkOYLVPtPgIt0MxizjfFJov3JbHyAi,3,0,0,0,0,34,2,0,36,5.142857142857143,1,0.0,0,0,0,0,0,34,0,2,0,0,36,1
6280,166063,tJFzrDg5BaUKwBS7uJ8wgIWbLiKiPTve,fbPkOYLVPtPgIt0MxizjfFJov3JbHyAi,2,0,0,0,0,0,3,0,3,0.42857142857142855,1,0.0,0,0,0,0,0,0,0,3,0,0,3,1
6281,166064,lxeXZ87M0UdQbm9QL7lTn6YACn14X0PC,fbPkOYLVPtPgIt0MxizjfFJov3JbHyAi,11,6,5,0,4,0,2,0,17,2.4285714285714284,1,0.0,0,5,0,4,6,0,0,2,0,9,8,1
6282,166065,ijyyGxSCkTNXshxGrWCb96rdtgSJNssR,fbPkOYLVPtPgIt0MxizjfFJov3JbHyAi,7,3,2,0,2,0,2,0,9,1.2857142857142858,1,0.0,0,2,0,2,3,0,0,2,0,4,5,1
6283,166067,7fC3V6ivG07wUIMOmiYFzSlyjWvbYnYf,fbPkOYLVPtPgIt0MxizjfFJov3JbHyAi,1,0,0,0,0,0,1,0,1,0.14285714285714285,1,0.0,0,0,0,0,0,0,0,1,0,0,1,1
6284,166068,uUEAEHuEOlAvsHurjyTj6J9XqJZTLr4r,fbPkOYLVPtPgIt0MxizjfFJov3JbHyAi,10,10,5,3,7,0,2,0,27,3.857142857142857,1,0.0,4,5,2,7,6,0,1,2,0,18,9,1
6285,166069,icJiAKjBBiURMzSKaDbpsCD4jk8ynifx,fbPkOYLVPtPgIt0MxizjfFJov3JbHyAi,3,0,0,0,0,0,7,0,7,1.0,1,0.0,0,0,0,0,0,0,0,7,0,0,7,1
6286,166070,lUDEsCpeeCxZyURyjEd7RvRXvuIDJHXc,fbPkOYLVPtPgIt0MxizjfFJov3JbHyAi,8,6,4,0,3,0,3,0,16,2.2857142857142856,1,0.0,0,4,0,3,6,0,0,3,0,7,9,1
6287,166073,Sy0IBVghIdDN5uhsYaAtE4EZP4lbDR6C,fbPkOYLVPtPgIt0MxizjfFJov3JbHyAi,10,7,5,0,4,0,7,0,23,3.2857142857142856,3,0.0,0,5,0,4,7,0,0,7,0,9,14,1
6288,166076,tlV5mNtKN8OpE3fnEW9HsMaTsOyR1fSl,fbPkOYLVPtPgIt0MxizjfFJov3JbHyAi,2,0,0,0,0,0,2,0,2,0.2857142857142857,1,0.0,0,0,0,0,0,0,0,2,0,0,2,1
6289,166096,d2dMin38z1mvwoR5boGKYx3URnEXiseW,fbPkOYLVPtPgIt0MxizjfFJov3JbHyAi,7,5,2,0,2,23,4,0,36,5.142857142857143,1,0.0,2,2,0,2,3,23,0,4,0,6,30,1
6290,166952,V52G1wHOq5zd0Up8zjShFJCn7Er4GImu,SpATywNh6bZuzm8s1ceuBUnMUAeoAHHw,3,3,0,0,0,0,1,0,4,0.5714285714285714,1,0.0,0,0,0,0,3,0,0,1,0,0,4,1
6291,167115,WAC7RGZ1uYeT92igfYiLgTnHWPEtN2IA,A3fsA9Zfv1X2fVEQhTw51lKENdNrEqT3,8,4,3,0,3,0,3,0,13,1.8571428571428572,1,0.0,0,3,0,3,4,0,0,3,0,6,7,1
6292,167244,Cie8MgBDvC4HVRvuqtFzP8SkWOhgrE8X,SpATywNh6bZuzm8s1ceuBUnMUAeoAHHw,10,26,18,0,7,0,6,0,57,8.142857142857142,1,0.0,3,18,0,7,23,0,0,6,0,28,29,1
6293,167779,BWZyBrJDBbkcDEXyE3CSVFoVlT2CRRku,A3fsA9Zfv1X2fVEQhTw51lKENdNrEqT3,1,0,0,0,0,0,1,0,1,0.14285714285714285,1,0.0,0,0,0,0,0,0,0,1,0,0,1,1
6294,169711,gzmN8VLkF6QCaC4IobudOv6PTgb6exUk,fbPkOYLVPtPgIt0MxizjfFJov3JbHyAi,4,2,1,0,1,0,1,0,5,0.7142857142857143,1,0.0,0,1,0,1,2,0,0,1,0,2,3,1
6295,169764,O8pydf8wdA8EjOBMj6o80eWX7PkIMpuy,7GRhBDsirIGkRZBtSMEzNTyDr2JQm4xx,7,1,1,0,1,1,4,1,9,1.2857142857142858,1,0.0,0,1,0,1,1,1,0,4,1,2,7,1
6296,169767,l1rg3D8Gp1lv7dbBBYKvzTS3OZ5DRjWH,7GRhBDsirIGkRZBtSMEzNTyDr2JQm4xx,11,15,6,0,3,0,2,0,26,3.7142857142857144,2,0.0,0,6,0,3,15,0,0,2,0,9,17,1
6297,169814,w7UkLHeAPhvA1M8odbbK7J9zzLA0KhPR,7GRhBDsirIGkRZBtSMEzNTyDr2JQm4xx,10,12,0,10,0,2,5,0,29,4.142857142857143,1,0.0,5,0,9,0,7,2,1,5,0,14,15,1
6298,169845,QFfUN9yxUlsMNYgpicOpe1up7xBAfW6Y,7GRhBDsirIGkRZBtSMEzNTyDr2JQm4xx,4,2,1,0,1,0,1,0,5,0.7142857142857143,1,0.0,0,1,0,1,2,0,0,1,0,2,3,1
6299,169853,Qi3PLuC7w2Yo9hFgq37MObjY8icnRdc6,7GRhBDsirIGkRZBtSMEzNTyDr2JQm4xx,14,25,9,14,1,2,4,0,55,7.857142857142857,1,0.0,6,9,12,1,19,2,2,4,0,28,27,1
6300,169963,i0ksX07HnsV5rQlWqOr1uKEuc7yNU24c,7GRhBDsirIGkRZBtSMEzNTyDr2JQm4xx,14,7,5,0,4,1,7,0,24,3.4285714285714284,1,0.0,1,5,0,4,6,1,0,7,0,10,14,1
6301,169984,f6KJlC1ScrQZtGOzsyUMpOtZeSqtR8rB,7GRhBDsirIGkRZBtSMEzNTyDr2JQm4xx,1,0,0,0,0,0,1,0,1,0.14285714285714285,1,0.0,0,0,0,0,0,0,0,1,0,0,1,1
6302,170023,c1BXmJNemroOPh6WUefTBD28s2WzSNwi,7GRhBDsirIGkRZBtSMEzNTyDr2JQm4xx,5,4,0,0,0,0,2,0,6,0.8571428571428571,1,0.0,1,0,0,0,3,0,0,2,0,1,5,1
6303,170043,n0HFF3TwqKuBMzzkdLCbvb8Mji5ZUnVX,7GRhBDsirIGkRZBtSMEzNTyDr2JQm4xx,5,2,1,0,1,0,2,0,6,0.8571428571428571,1,0.0,0,1,0,1,2,0,0,2,0,2,4,1
6304,170078,S6Mv1aKyTUf7xcwwDYCs3vpkSwBRaGU9,SpATywNh6bZuzm8s1ceuBUnMUAeoAHHw,3,2,0,0,0,0,1,0,3,0.42857142857142855,1,0.0,0,0,0,0,2,0,0,1,0,0,3,0
6305,170102,3v1JFL0HMqiuFdQBduyDYGcupFiSmqdG,7GRhBDsirIGkRZBtSMEzNTyDr2JQm4xx,21,26,7,14,7,0,4,0,58,8.285714285714286,2,0.0,18,7,12,7,8,0,2,4,0,44,14,1
6306,170198,W8psMt8K6E7obsinwdemXzpwbpxCP9R1,7GRhBDsirIGkRZBtSMEzNTyDr2JQm4xx,5,10,5,0,0,0,2,0,17,2.4285714285714284,1,0.0,1,5,0,0,9,0,0,2,0,6,11,1
6307,170248,9b2fchNyVZPjqpmxjleqzL9edi9EOH23,7GRhBDsirIGkRZBtSMEzNTyDr2JQm4xx,1,0,0,0,0,0,1,0,1,0.14285714285714285,1,0.0,0,0,0,0,0,0,0,1,0,0,1,1
6308,170272,CvkCRHPN9Kdm6u8tUG5peGiWArNJEfk8,7GRhBDsirIGkRZBtSMEzNTyDr2JQm4xx,22,27,7,33,14,3,7,1,92,13.142857142857142,1,0.0,19,7,28,14,8,3,5,7,1,68,24,1
6309,170436,68jxA2PUjT1NQfZbUcdmPfGR0u6r2zeM,7GRhBDsirIGkRZBtSMEzNTyDr2JQm4xx,1,0,0,0,0,0,3,0,3,0.42857142857142855,1,0.0,0,0,0,0,0,0,0,3,0,0,3,1
6310,170454,68jxA2PUjT1NQfZbUcdmPfGR0u6r2zeM,A3fsA9Zfv1X2fVEQhTw51lKENdNrEqT3,1,0,0,0,0,0,1,0,1,0.14285714285714285,1,0.0,0,0,0,0,0,0,0,1,0,0,1,1
6311,170543,Z4MdM7wvbK2oPoLlwXYYW0r3PZvWrL6Z,7GRhBDsirIGkRZBtSMEzNTyDr2JQm4xx,5,2,1,0,1,0,2,0,6,0.8571428571428571,1,0.0,0,1,0,1,2,0,0,2,0,2,4,1
6312,170558,40L77km5z19sJEVeJ6u4qpa9SAG2ZSIF,G8EPVSXsOYB5YQWZGiz1aVq5Pgr2GrQu,6,7,2,0,0,0,3,0,12,1.7142857142857142,1,0.0,4,2,0,0,3,0,0,3,0,6,6,1
6313,170628,1FJgNHNZRyIkv3hAgs29ZaCmWBTNZtcq,7GRhBDsirIGkRZBtSMEzNTyDr2JQm4xx,1,0,0,0,0,0,1,0,1,0.14285714285714285,1,0.0,0,0,0,0,0,0,0,1,0,0,1,1
6314,170635,dcCbaqbKHCs7CPRffWThbopWB8akROlP,7GRhBDsirIGkRZBtSMEzNTyDr2JQm4xx,8,3,1,0,1,0,5,3,13,1.8571428571428572,1,0.0,0,1,0,1,3,0,0,5,3,2,11,1
6315,170680,xfIXdIbpI0XdgPBSDtKqxzOIzP21Dq8x,7GRhBDsirIGkRZBtSMEzNTyDr2JQm4xx,1,0,0,0,0,0,1,0,1,0.14285714285714285,1,0.0,0,0,0,0,0,0,0,1,0,0,1,1
6316,170682,K3RmvehnU0yLuzkdfShsHIJB4RyDPmXO,bWdj2GDclj5ofokWjzoa5jAwMkxCykd6,4,3,1,0,1,0,1,0,6,0.8571428571428571,1,0.0,1,1,0,1,2,0,0,1,0,3,3,1
6317,172639,ZkfFwyK1OgVihBxVb6PuDCZttx0mY0GH,7GRhBDsirIGkRZBtSMEzNTyDr2JQm4xx,1,0,0,0,0,0,1,0,1,0.14285714285714285,1,0.0,0,0,0,0,0,0,0,1,0,0,1,1
6318,172787,YY7yHizDn0UpGHVq4qoTfbulP3ev5TkC,fbPkOYLVPtPgIt0MxizjfFJov3JbHyAi,6,3,2,0,2,0,1,0,8,1.1428571428571428,1,0.0,0,2,0,2,3,0,0,1,0,4,4,1
6319,173146,p9UNvuDUoGgEq49Fv2ZMxggXXq1CzTMu,SpATywNh6bZuzm8s1ceuBUnMUAeoAHHw,13,35,10,10,2,4,8,1,70,10.0,1,0.0,20,10,10,2,15,4,0,8,1,42,28,1
6320,173471,zvLkVcjFtCYyIxQ5AgxEHNEKFJjc1e0w,SpATywNh6bZuzm8s1ceuBUnMUAeoAHHw,16,10,7,12,5,3,6,1,44,6.285714285714286,1,0.0,2,7,9,5,8,3,3,6,1,23,21,1
6321,173934,WI9rk8aS11tBAJzjcX0JSIgomYYRQVjW,RXDvfPUBYFlVdlueBFbLW0mhhAyGEqpt,16,16,0,0,0,2,9,3,30,4.285714285714286,1,0.0,0,0,0,0,16,2,0,9,3,0,30,0
6322,174116,89IraAtUfhoGAQgzdMP1844g2s2iN4Ox,SpATywNh6bZuzm8s1ceuBUnMUAeoAHHw,12,9,3,13,3,0,2,0,30,4.285714285714286,1,0.0,4,3,13,3,5,0,0,2,0,23,7,1
6323,174168,y4jCbRq0ZMCabQVeAWisCVju9AF82joj,SpATywNh6bZuzm8s1ceuBUnMUAeoAHHw,2,0,0,0,0,0,2,0,2,0.2857142857142857,1,0.0,0,0,0,0,0,0,0,2,0,0,2,1
6324,174377,BeoWdDFNsVFqWVq3B4qjYh8vNjNTgwSB,bWdj2GDclj5ofokWjzoa5jAwMkxCykd6,12,9,6,0,4,0,14,0,33,4.714285714285714,1,0.0,0,6,0,4,9,0,0,14,0,10,23,1
6325,174421,mSZYyfRNnqnDs7qyuaQEMEvx5vC2JS4M,A3fsA9Zfv1X2fVEQhTw51lKENdNrEqT3,23,14,11,34,9,0,2,0,70,10.0,1,0.0,2,11,26,9,12,0,8,2,0,48,22,0
6326,174478,EhHrinjt1AkEWC09AFZwBuP61S5NJgjn,SpATywNh6bZuzm8s1ceuBUnMUAeoAHHw,10,10,3,19,0,9,3,0,44,6.285714285714286,1,0.0,5,3,16,0,5,9,3,3,0,24,20,0
6327,174502,4G31JkuuWxQoMwYLKWmTZsOhrqR0raRg,A3fsA9Zfv1X2fVEQhTw51lKENdNrEqT3,10,7,1,0,1,0,2,0,11,1.5714285714285714,1,0.0,0,1,0,1,7,0,0,2,0,2,9,1
6328,174510,1JwhB7sCpqQuMWgVLCoQdnUSus34sW5p,SpATywNh6bZuzm8s1ceuBUnMUAeoAHHw,16,31,14,12,8,1,6,2,74,10.571428571428571,1,0.0,10,14,9,8,21,1,3,6,2,41,33,1
6329,174513,1JwhB7sCpqQuMWgVLCoQdnUSus34sW5p,A3fsA9Zfv1X2fVEQhTw51lKENdNrEqT3,8,12,1,0,0,0,5,0,18,2.5714285714285716,2,0.0,0,1,0,0,12,0,0,5,0,1,17,1
6330,174541,FOCCuGaJ7zYTl7CCCo7T3PqrLtxGVeiU,A3fsA9Zfv1X2fVEQhTw51lKENdNrEqT3,36,25,0,50,0,6,7,0,88,12.571428571428571,1,0.0,2,0,45,0,23,6,5,7,0,47,41,1
6331,174563,m98O4dP1opmo7o2tpUGDqrUnbkirc7sM,A3fsA9Zfv1X2fVEQhTw51lKENdNrEqT3,12,17,0,0,0,1,2,0,20,2.857142857142857,1,0.0,1,0,0,0,16,1,0,2,0,1,19,1
6332,174665,6WpUAvOn0104PVGU1qRupfdkikcVBl8O,bWdj2GDclj5ofokWjzoa5jAwMkxCykd6,4,3,1,0,1,0,1,0,6,0.8571428571428571,1,0.0,0,1,0,1,3,0,0,1,0,2,4,1
6333,174692,xMCJ7gcgv1mN5rb4Qh9dpQVUc9zQ1NLX,SpATywNh6bZuzm8s1ceuBUnMUAeoAHHw,11,16,3,2,0,16,15,3,55,7.857142857142857,3,0.0,0,3,2,0,16,16,0,15,3,5,50,1
6334,174703,Nu3CWEbOlEVCvqetIYQvBCpTSFLSYvQK,SpATywNh6bZuzm8s1ceuBUnMUAeoAHHw,6,5,2,0,2,0,3,0,12,1.7142857142857142,1,0.0,0,2,0,2,5,0,0,3,0,4,8,1
6335,174704,ExNrdfeKsdYl3xmpiJlCBa13JPKyssuX,bWdj2GDclj5ofokWjzoa5jAwMkxCykd6,1,0,0,0,0,0,1,0,1,0.14285714285714285,1,0.0,0,0,0,0,0,0,0,1,0,0,1,1
6336,174813,Bau8Ni7vPFHL0Lb3hYTZjsOuiN8oYfUJ,A3fsA9Zfv1X2fVEQhTw51lKENdNrEqT3,1,0,0,0,0,0,1,0,1,0.14285714285714285,1,0.0,0,0,0,0,0,0,0,1,0,0,1,1
6337,174878,fUQHFT4QEMRSPqJAQlXlvlyNwca9Q0dU,RXDvfPUBYFlVdlueBFbLW0mhhAyGEqpt,13,23,1,12,1,0,1,0,38,5.428571428571429,1,0.0,1,1,12,1,22,0,0,1,0,15,23,1
6338,174900,5zea5vrXS7Bt1LjTuEN0slFtYiNlymMO,A3fsA9Zfv1X2fVEQhTw51lKENdNrEqT3,7,5,0,0,0,0,3,0,8,1.1428571428571428,1,0.0,0,0,0,0,5,0,0,3,0,0,8,1
6339,174927,A6qBZik0VBfWjUh1l97ldNrUQvZV7VDA,A3fsA9Zfv1X2fVEQhTw51lKENdNrEqT3,1,0,0,0,0,0,1,0,1,0.14285714285714285,1,0.0,0,0,0,0,0,0,0,1,0,0,1,1
6340,175021,cpZrl3oP8x5CfyDGz9KAwfLq9wo2kZMm,RXDvfPUBYFlVdlueBFbLW0mhhAyGEqpt,8,5,1,0,1,0,2,0,9,1.2857142857142858,1,0.0,0,1,0,1,5,0,0,2,0,2,7,1
6341,175194,8RK6HQkv51lSsSE1n9EptQjyHrkMwfO0,A3fsA9Zfv1X2fVEQhTw51lKENdNrEqT3,1,0,0,0,0,0,1,0,1,0.14285714285714285,1,0.0,0,0,0,0,0,0,0,1,0,0,1,1
6342,175196,rtg3Ki4vk14kI9MkEBE0pkOCAO2AnCnU,bWdj2GDclj5ofokWjzoa5jAwMkxCykd6,18,25,16,106,4,6,10,1,168,24.0,2,0.0,4,16,103,4,21,6,3,10,1,127,41,1
6343,175240,xCHQAq5m2mtyQES4gfg6MjCHDUVD1J71,A3fsA9Zfv1X2fVEQhTw51lKENdNrEqT3,5,6,0,0,0,0,2,0,8,1.1428571428571428,1,0.0,0,0,0,0,6,0,0,2,0,0,8,1
6344,175245,ltkP6i2vq0mcbwSjcj4Xv8kSZr3VUqSC,A3fsA9Zfv1X2fVEQhTw51lKENdNrEqT3,8,3,1,0,1,1,4,0,10,1.4285714285714286,1,0.0,0,1,0,1,3,1,0,4,0,2,8,1
6345,175284,Fl2rv0GIrb1pZGPCAVV4X3WnsKhjbfP2,A3fsA9Zfv1X2fVEQhTw51lKENdNrEqT3,8,3,1,0,1,0,5,0,10,1.4285714285714286,1,0.0,0,1,0,1,3,0,0,5,0,2,8,1
6346,175297,cZy6FfSysDXCciyaQBXiY1ElSSQnaYdy,A3fsA9Zfv1X2fVEQhTw51lKENdNrEqT3,1,0,0,0,0,0,1,0,1,0.14285714285714285,1,0.0,0,0,0,0,0,0,0,1,0,0,1,1
6347,175301,QHPjxy7GRZxkE11G18jf1qUIPRoUJGTA,A3fsA9Zfv1X2fVEQhTw51lKENdNrEqT3,2,0,0,0,0,0,2,0,2,0.2857142857142857,1,0.0,0,0,0,0,0,0,0,2,0,0,2,1
6348,175308,SZHxM16r0lTBVocJi0Li5OQAgxZ4K7jz,A3fsA9Zfv1X2fVEQhTw51lKENdNrEqT3,1,0,0,0,0,0,1,0,1,0.14285714285714285,1,0.0,0,0,0,0,0,0,0,1,0,0,1,1
6349,175379,9WmzxyamLAgd2LnrO6zydiN7WV3MNZZt,bWdj2GDclj5ofokWjzoa5jAwMkxCykd6,7,4,3,0,1,4,4,1,17,2.4285714285714284,1,0.0,0,3,0,1,4,4,0,4,1,4,13,1
6350,175402,Sy0IBVghIdDN5uhsYaAtE4EZP4lbDR6C,A3fsA9Zfv1X2fVEQhTw51lKENdNrEqT3,2,0,0,0,0,0,2,0,2,0.2857142857142857,1,0.0,0,0,0,0,0,0,0,2,0,0,2,1
6351,175439,GYW6F4RrALjPRMj1o3hg6mOIhsonMLzv,fbPkOYLVPtPgIt0MxizjfFJov3JbHyAi,8,6,4,0,2,1,6,1,20,2.857142857142857,1,0.0,0,4,0,2,6,1,0,6,1,6,14,1
6352,175440,nNNmD0vjq4euECk9TASJLqcY7Yh4uOs7,fbPkOYLVPtPgIt0MxizjfFJov3JbHyAi,1,0,0,0,0,0,1,0,1,0.14285714285714285,1,0.0,0,0,0,0,0,0,0,1,0,0,1,1
6353,175444,m7igssBCJoYXk9iLEbegzoIoWBibQRze,fbPkOYLVPtPgIt0MxizjfFJov3JbHyAi,7,3,2,0,2,0,4,0,11,1.5714285714285714,1,0.0,0,2,0,2,3,0,0,4,0,4,7,1
6354,175445,G6eTAhE9AzVlPFZeS2VRSwDOXtmFA3PX,fbPkOYLVPtPgIt0MxizjfFJov3JbHyAi,4,2,1,0,1,0,1,0,5,0.7142857142857143,1,0.0,0,1,0,1,2,0,0,1,0,2,3,1
6355,175446,juzfwxHXCKii6ul7funGUBQbDVPCyrBB,fbPkOYLVPtPgIt0MxizjfFJov3JbHyAi,8,5,3,0,2,0,3,0,13,1.8571428571428572,1,0.0,0,3,0,2,5,0,0,3,0,5,8,1
6356,175447,S9lWYm9a6FVZ2ODtiJC49kgBYS9VqhGG,fbPkOYLVPtPgIt0MxizjfFJov3JbHyAi,1,0,0,0,0,0,1,0,1,0.14285714285714285,1,0.0,0,0,0,0,0,0,0,1,0,0,1,1
6357,175450,iM7LGMV4VAjVfcFaZFGWFvZYzMBFfU3L,fbPkOYLVPtPgIt0MxizjfFJov3JbHyAi,4,2,1,0,0,0,2,0,5,0.7142857142857143,1,0.0,0,1,0,0,2,0,0,2,0,1,4,1
6358,175451,CH7rIEiCYJderq7iXskzAGjPNDy8sGGS,fbPkOYLVPtPgIt0MxizjfFJov3JbHyAi,6,4,2,0,2,0,1,0,9,1.2857142857142858,1,0.0,0,2,0,2,4,0,0,1,0,4,5,1
6359,175453,BbTCRpsgAELmbNInOYYMcpD2adqJUxaz,fbPkOYLVPtPgIt0MxizjfFJov3JbHyAi,9,9,6,0,2,0,1,0,18,2.5714285714285716,1,0.0,0,6,0,2,9,0,0,1,0,8,10,1
6360,175458,QtQR4oqQYT2ypg7Ijhn9emxLfIBM3Int,fbPkOYLVPtPgIt0MxizjfFJov3JbHyAi,5,3,0,0,0,0,3,0,6,0.8571428571428571,1,0.0,0,0,0,0,3,0,0,3,0,0,6,1
6361,175459,DwjBo7B8hqv5XCU5nIWsl6HyuOZ8ub9E,fbPkOYLVPtPgIt0MxizjfFJov3JbHyAi,8,3,2,0,2,7,5,1,20,2.857142857142857,1,0.0,0,2,0,2,3,7,0,5,1,4,16,1
6362,175460,XCvldc0Z25dIQokzzDRNDq71ULXBAM8F,fbPkOYLVPtPgIt0MxizjfFJov3JbHyAi,1,0,0,0,0,0,1,0,1,0.14285714285714285,1,0.0,0,0,0,0,0,0,0,1,0,0,1,1
6363,175462,IxfgoqdA7w5aqdySNUMg1lSOzs1KfDTQ,fbPkOYLVPtPgIt0MxizjfFJov3JbHyAi,1,0,0,0,0,0,1,0,1,0.14285714285714285,1,0.0,0,0,0,0,0,0,0,1,0,0,1,1
6364,175463,X9Zz94IfisZgL8IIKroVo2fOO5DotKd5,fbPkOYLVPtPgIt0MxizjfFJov3JbHyAi,5,2,1,0,1,0,4,0,8,1.1428571428571428,1,0.0,0,1,0,1,2,0,0,4,0,2,6,1
6365,175464,lo7UFRSxvdl5IBJpBfFiWaG1K4lSvIph,fbPkOYLVPtPgIt0MxizjfFJov3JbHyAi,8,20,1,0,1,3,6,1,32,4.571428571428571,1,0.0,2,1,0,1,18,3,0,6,1,4,28,1
6366,175466,WOZ2OKb8udE0dHnoi6x9XrHwhNGFHraB,fbPkOYLVPtPgIt0MxizjfFJov3JbHyAi,9,5,4,0,4,0,6,0,19,2.7142857142857144,1,0.0,0,4,0,4,5,0,0,6,0,8,11,1
6367,175470,JVXyLCa1OOjkw5FBCNd333Deiv79lmst,fbPkOYLVPtPgIt0MxizjfFJov3JbHyAi,8,4,1,0,1,0,4,1,11,1.5714285714285714,1,0.0,0,1,0,1,4,0,0,4,1,2,9,1
6368,175472,h6X7uJXHEtMGd13bXyyZ1xP1ebsu9X0Q,fbPkOYLVPtPgIt0MxizjfFJov3JbHyAi,1,0,0,0,0,0,1,0,1,0.14285714285714285,1,0.0,0,0,0,0,0,0,0,1,0,0,1,1
6369,175473,DLoC6wyjO8HZpRQISW7NxAXHzLyIHStZ,fbPkOYLVPtPgIt0MxizjfFJov3JbHyAi,11,11,7,0,5,5,9,2,39,5.571428571428571,1,0.0,2,7,0,5,9,5,0,9,2,14,25,1
6370,175482,ifbjnZ4tXcK4dpvbMG3JmLnAWvMTSG5S,fbPkOYLVPtPgIt0MxizjfFJov3JbHyAi,10,6,4,0,3,1,5,1,20,2.857142857142857,1,0.0,0,4,0,3,6,1,0,5,1,7,13,1
6371,175483,1mlsGNriImtvI5bJf0wHc3mOCBScmLWj,fbPkOYLVPtPgIt0MxizjfFJov3JbHyAi,9,9,6,0,2,0,4,0,21,3.0,1,0.0,0,6,0,2,9,0,0,4,0,8,13,1
6372,175488,nQ8zyPaxuBVV0E4EnN5ZsvrgPzjbJntO,fbPkOYLVPtPgIt0MxizjfFJov3JbHyAi,1,0,0,0,0,0,1,0,1,0.14285714285714285,1,0.0,0,0,0,0,0,0,0,1,0,0,1,1
6373,175491,TSm2R7cUPaXhbTrj1LddmwVL7dduRSSa,fbPkOYLVPtPgIt0MxizjfFJov3JbHyAi,1,0,0,0,0,0,1,0,1,0.14285714285714285,1,0.0,0,0,0,0,0,0,0,1,0,0,1,1
6374,175495,zfwGGWHtlXaIDlcPdgrN93eHfeWgyv8l,fbPkOYLVPtPgIt0MxizjfFJov3JbHyAi,1,0,0,0,0,0,1,0,1,0.14285714285714285,1,0.0,0,0,0,0,0,0,0,1,0,0,1,1
6375,175498,1hpNOEDtPnezHqQbgrwjtuMuvCrx4S8A,fbPkOYLVPtPgIt0MxizjfFJov3JbHyAi,13,8,5,0,5,0,2,0,20,2.857142857142857,1,0.0,0,5,0,5,8,0,0,2,0,10,10,1
6376,175509,Nqm1BU7DDwtz5J6sAMZajfpCtdyka8BU,fbPkOYLVPtPgIt0MxizjfFJov3JbHyAi,6,2,0,0,0,1,5,1,9,1.2857142857142858,1,0.0,0,0,0,0,2,1,0,5,1,0,9,1
6377,175511,lFbeWg5shoMMNqLk9Vsb1yCv5tI9us0k,fbPkOYLVPtPgIt0MxizjfFJov3JbHyAi,10,7,3,1,4,0,2,0,17,2.4285714285714284,1,0.0,3,3,1,4,4,0,0,2,0,11,6,1
6378,175512,IybfLDxPgLkzxuWcMtBTeSNmrb96OWvv,fbPkOYLVPtPgIt0MxizjfFJov3JbHyAi,7,3,2,0,2,0,5,0,12,1.7142857142857142,1,0.0,0,2,0,2,3,0,0,5,0,4,8,1
6379,175513,PtpNjyWIZGFluToFVMnoVp1uIp4PTNlV,fbPkOYLVPtPgIt0MxizjfFJov3JbHyAi,4,2,1,0,1,0,1,0,5,0.7142857142857143,1,0.0,0,1,0,1,2,0,0,1,0,2,3,1
6380,175514,lreXxc1V0mKbQc1Fk3HBAHJga7i3ZlPb,fbPkOYLVPtPgIt0MxizjfFJov3JbHyAi,4,0,0,0,0,2,3,1,6,0.8571428571428571,1,0.0,0,0,0,0,0,2,0,3,1,0,6,1
6381,175517,vM4VSeTdZPRUwUiCQKf2BuawElru5sNo,fbPkOYLVPtPgIt0MxizjfFJov3JbHyAi,5,2,1,0,1,0,4,0,8,1.1428571428571428,1,0.0,0,1,0,1,2,0,0,4,0,2,6,1
6382,175519,zZcLo3UhXrAelR5FTKmHlxSZl0wW5YNH,fbPkOYLVPtPgIt0MxizjfFJov3JbHyAi,2,0,0,0,0,0,2,0,2,0.2857142857142857,1,0.0,0,0,0,0,0,0,0,2,0,0,2,1
6383,175521,Z6WF7UnPSWhERdL5zMrsQHVgRqZ42S1n,fbPkOYLVPtPgIt0MxizjfFJov3JbHyAi,2,0,0,0,0,0,2,0,2,0.2857142857142857,1,0.0,0,0,0,0,0,0,0,2,0,0,2,1
6384,175522,wmNYHs69T6CHydhCxfzhydbjA79LMuTD,fbPkOYLVPtPgIt0MxizjfFJov3JbHyAi,7,3,2,0,2,0,2,0,9,1.2857142857142858,1,0.0,0,2,0,2,3,0,0,2,0,4,5,1
6385,175525,QYaJtD7z5M6YcGNpdHV2JTsxqV4tXm9a,fbPkOYLVPtPgIt0MxizjfFJov3JbHyAi,1,0,0,0,0,0,1,0,1,0.14285714285714285,1,0.0,0,0,0,0,0,0,0,1,0,0,1,1
6386,175527,nWRrumnCgp6om94YmjE4CGN8JbKK91s6,fbPkOYLVPtPgIt0MxizjfFJov3JbHyAi,5,2,1,0,1,0,2,0,6,0.8571428571428571,1,0.0,0,1,0,1,2,0,0,2,0,2,4,1
6387,175529,vZY5RTyvAOyjF1AYeCntOYrEo9bIz6lQ,fbPkOYLVPtPgIt0MxizjfFJov3JbHyAi,4,2,1,0,1,0,1,0,5,0.7142857142857143,1,0.0,0,1,0,1,2,0,0,1,0,2,3,1
6388,175530,pmVmbJyOmxphdEXp0eyLXWB51e0e00i9,fbPkOYLVPtPgIt0MxizjfFJov3JbHyAi,7,4,2,0,2,0,3,0,11,1.5714285714285714,1,0.0,0,2,0,2,4,0,0,3,0,4,7,1
6389,175532,Fov1WBMQ9iK40YBqm6CCLgYUxW79OKx1,fbPkOYLVPtPgIt0MxizjfFJov3JbHyAi,10,10,4,0,3,2,9,2,30,4.285714285714286,1,0.0,4,4,0,3,6,2,0,9,2,11,19,1
6390,175538,8DjKcd2LJZN4ior4lkPdphxSMFfQLRGu,fbPkOYLVPtPgIt0MxizjfFJov3JbHyAi,3,0,0,0,0,4,2,0,6,0.8571428571428571,1,0.0,0,0,0,0,0,4,0,2,0,0,6,1
6391,175541,GrlLrE19mhpGaNnXMSNrKxn7KnB7PvUl,fbPkOYLVPtPgIt0MxizjfFJov3JbHyAi,7,4,3,0,3,0,2,0,12,1.7142857142857142,1,0.0,0,3,0,3,4,0,0,2,0,6,6,1
6392,175546,uCYmXbV69zfGcUg2j8bzRMpMZlMnqjT7,fbPkOYLVPtPgIt0MxizjfFJov3JbHyAi,1,0,0,0,0,0,1,0,1,0.14285714285714285,1,0.0,0,0,0,0,0,0,0,1,0,0,1,0
6393,176576,1ZnERDT2WSNZGJeanMnjXX2EswCJEUwX,SpATywNh6bZuzm8s1ceuBUnMUAeoAHHw,6,5,2,0,2,0,4,0,13,1.8571428571428572,1,0.0,0,2,0,2,5,0,0,4,0,4,9,1
6394,176706,RPNytg6jKosKSPSkg7bLhh3BAXDjaY9a,RXDvfPUBYFlVdlueBFbLW0mhhAyGEqpt,11,7,3,6,2,0,2,0,20,2.857142857142857,1,0.0,1,3,6,2,6,0,0,2,0,12,8,1
6395,176714,mP0oq4UFI55XwGbomuLjnKyaYZ9Irhl8,RXDvfPUBYFlVdlueBFbLW0mhhAyGEqpt,1,0,0,0,0,0,1,0,1,0.14285714285714285,1,0.0,0,0,0,0,0,0,0,1,0,0,1,1
6396,177060,Et66VbQRwkFnF42twZ8Z4ErFWQLehmwC,A3fsA9Zfv1X2fVEQhTw51lKENdNrEqT3,1,0,0,0,0,0,1,0,1,0.14285714285714285,1,0.0,0,0,0,0,0,0,0,1,0,0,1,0
6397,177113,66JqxLLiEx06fBDzS4MuyYNc7nIpYGk9,A3fsA9Zfv1X2fVEQhTw51lKENdNrEqT3,13,12,8,0,6,0,2,0,28,4.0,1,0.0,0,8,0,6,12,0,0,2,0,14,14,0
6398,177325,LchclclKlrYHOcXtmhi0Eqhs9daD9eJz,RXDvfPUBYFlVdlueBFbLW0mhhAyGEqpt,46,56,24,124,20,2,2,0,228,32.57142857142857,1,0.0,31,24,115,20,25,2,9,2,0,190,38,1
6399,177347,fGIeAB7IRJCHxzCo8u4GLaPKxQfHeCdi,bWdj2GDclj5ofokWjzoa5jAwMkxCykd6,8,13,5,0,2,0,2,0,22,3.142857142857143,1,0.0,2,5,0,2,11,0,0,2,0,9,13,1
6400,177460,NXEwBXbU6vvce77sujWgRB6LivhFJvRb,A3fsA9Zfv1X2fVEQhTw51lKENdNrEqT3,4,2,1,0,1,0,1,0,5,0.7142857142857143,1,0.0,0,1,0,1,2,0,0,1,0,2,3,1
6401,177501,K3eaSd5rYP9Gkimldqt40pigYQrGeLsH,bWdj2GDclj5ofokWjzoa5jAwMkxCykd6,10,8,4,14,3,0,2,0,31,4.428571428571429,1,0.0,2,4,13,3,6,0,1,2,0,22,9,1
6402,177667,ipVvzWInHV8LAm6qVHoFaV0nnfOGT5ry,SpATywNh6bZuzm8s1ceuBUnMUAeoAHHw,1,0,0,0,0,0,1,0,1,0.14285714285714285,1,0.0,0,0,0,0,0,0,0,1,0,0,1,1
6403,177668,p54dVByd9epbS397rAmrAwTW19iwa3UI,bWdj2GDclj5ofokWjzoa5jAwMkxCykd6,15,12,1,40,4,1,11,1,70,10.0,2,0.0,7,1,35,4,5,1,5,11,1,47,23,1
6404,177691,A6oLHbyuoChPN0ROQ5fG10dHGRIiYTTe,SpATywNh6bZuzm8s1ceuBUnMUAeoAHHw,28,29,15,29,10,3,4,0,90,12.857142857142858,1,0.0,11,15,23,10,18,3,6,4,0,59,31,1
6405,177727,G4leME9fPSQLSwsbbKKP6ouczXxo1Wlw,SpATywNh6bZuzm8s1ceuBUnMUAeoAHHw,27,30,12,22,7,0,6,0,77,11.0,2,0.0,9,12,21,7,21,0,1,6,0,49,28,1
6406,177730,Mvi2iSl7G6NCzuzRtyT9FnCVUPePQVy1,bWdj2GDclj5ofokWjzoa5jAwMkxCykd6,9,18,6,34,5,0,4,0,67,9.571428571428571,1,0.0,9,6,33,5,9,0,1,4,0,53,14,1
6407,177736,3kQ25Y1n5ZQOWjLlVHwcdpzmvrmbPTL3,SpATywNh6bZuzm8s1ceuBUnMUAeoAHHw,14,13,0,0,0,0,4,0,17,2.4285714285714284,1,0.0,0,0,0,0,13,0,0,4,0,0,17,1
6408,177750,QjqGEc1MUmw3VEVWGhyD00LM60lNtKPh,SpATywNh6bZuzm8s1ceuBUnMUAeoAHHw,16,9,5,8,3,7,13,2,47,6.714285714285714,2,0.0,3,5,8,3,6,7,0,13,2,19,28,1
6409,177755,JHMFz2Gy459G1ldyhA75ALSO8YlPxA4n,A3fsA9Zfv1X2fVEQhTw51lKENdNrEqT3,6,5,2,0,1,0,3,0,11,1.5714285714285714,2,0.0,0,2,0,1,5,0,0,3,0,3,8,1
6410,177766,zmIcVKuNFZm39Xd0zSmSfRofuInASrOB,A3fsA9Zfv1X2fVEQhTw51lKENdNrEqT3,5,2,1,0,1,0,2,0,6,0.8571428571428571,1,0.0,0,1,0,1,2,0,0,2,0,2,4,1
6411,177770,AsCRvwtleeGS6D6WD7MD0zpcijqiUpJg,SpATywNh6bZuzm8s1ceuBUnMUAeoAHHw,1,0,0,0,0,0,1,0,1,0.14285714285714285,1,0.0,0,0,0,0,0,0,0,1,0,0,1,1
6412,177792,Xrjgmm5mgiySWho5SEzdacBLSLkDfygK,SpATywNh6bZuzm8s1ceuBUnMUAeoAHHw,19,9,8,0,7,0,4,0,28,4.0,1,0.0,0,8,0,7,9,0,0,4,0,15,13,1
6413,177799,Yyccad96I3hbgqqNLycAhyGOxNsdJzLL,SpATywNh6bZuzm8s1ceuBUnMUAeoAHHw,15,19,2,0,1,1,9,1,33,4.714285714285714,1,0.0,2,2,0,1,17,1,0,9,1,5,28,1
6414,177809,h1QswJ31uhxfyhfP3OhNVJBUvcTub6pW,bWdj2GDclj5ofokWjzoa5jAwMkxCykd6,2,0,0,0,0,0,2,0,2,0.2857142857142857,1,0.0,0,0,0,0,0,0,0,2,0,0,2,1
6415,177811,KVNNbfG6UQEmke4Oy3hBc7o3aqspqwkG,bWdj2GDclj5ofokWjzoa5jAwMkxCykd6,4,0,0,0,0,0,6,0,6,0.8571428571428571,1,0.0,0,0,0,0,0,0,0,6,0,0,6,1
6416,177817,1lCKn2N8CWNZFqkAXfsrQhctsw90ZkSX,bWdj2GDclj5ofokWjzoa5jAwMkxCykd6,5,2,1,0,1,0,3,0,7,1.0,1,0.0,0,1,0,1,2,0,0,3,0,2,5,1
6417,177866,Pk6H5V6IGPh6QxXblrwO7oI0RG2f9ujy,A3fsA9Zfv1X2fVEQhTw51lKENdNrEqT3,18,17,13,10,9,0,5,0,54,7.714285714285714,2,0.0,1,13,9,9,16,0,1,5,0,32,22,1
6418,177883,3KDcn3HvW3CpzWtc78PKWcm3CxgBERCi,SpATywNh6bZuzm8s1ceuBUnMUAeoAHHw,1,0,0,0,0,0,1,0,1,0.14285714285714285,1,0.0,0,0,0,0,0,0,0,1,0,0,1,1
6419,177898,qKod71hGHVj3I0edUan3ZmfswQIOaBhk,SpATywNh6bZuzm8s1ceuBUnMUAeoAHHw,4,2,0,0,0,0,2,0,4,0.5714285714285714,1,0.0,0,0,0,0,2,0,0,2,0,0,4,0
6420,177913,vMJQI9w07ZiISGIPIFnaaxiyY7O127F5,bWdj2GDclj5ofokWjzoa5jAwMkxCykd6,1,0,0,0,0,0,1,0,1,0.14285714285714285,1,0.0,0,0,0,0,0,0,0,1,0,0,1,1
6421,177917,0Rhh8KlMvGRxFbePsrW63o0GE8JJ4ZBr,A3fsA9Zfv1X2fVEQhTw51lKENdNrEqT3,4,0,0,0,0,0,5,0,5,0.7142857142857143,1,0.0,0,0,0,0,0,0,0,5,0,0,5,1
6422,177935,fCHhd4TOkyXDtd95SIvxpoNr5KiduXIc,bWdj2GDclj5ofokWjzoa5jAwMkxCykd6,7,3,2,0,2,0,2,0,9,1.2857142857142858,1,0.0,0,2,0,2,3,0,0,2,0,4,5,1
6423,177958,kvoUslzLG0mKlFKuSPgqASK2op5HSx76,A3fsA9Zfv1X2fVEQhTw51lKENdNrEqT3,6,5,2,0,1,0,2,0,10,1.4285714285714286,1,0.0,0,2,0,1,5,0,0,2,0,3,7,1
6424,177964,DHUv7XpIZcPp2QYGNmTXjhgg7Zq4BpJ7,bWdj2GDclj5ofokWjzoa5jAwMkxCykd6,1,0,0,0,0,0,1,0,1,0.14285714285714285,1,0.0,0,0,0,0,0,0,0,1,0,0,1,1
6425,177966,IuR34QWilyKtRzmb7qMgvf0gIZLKgowR,SpATywNh6bZuzm8s1ceuBUnMUAeoAHHw,1,0,0,0,0,0,1,0,1,0.14285714285714285,1,0.0,0,0,0,0,0,0,0,1,0,0,1,1
6426,177970,YeBJe2tNupEMDdAag9Wv20aFIU63DOgj,SpATywNh6bZuzm8s1ceuBUnMUAeoAHHw,1,0,0,0,0,0,1,0,1,0.14285714285714285,1,0.0,0,0,0,0,0,0,0,1,0,0,1,1
6427,178000,PhLYSq5B07iE4fjll2EKADOqnDhqPRc7,A3fsA9Zfv1X2fVEQhTw51lKENdNrEqT3,1,0,0,0,0,0,1,0,1,0.14285714285714285,1,0.0,0,0,0,0,0,0,0,1,0,0,1,1
6428,178016,IC7EvxrdI6aK6zztlqGy7t8EMIkvsLWH,SpATywNh6bZuzm8s1ceuBUnMUAeoAHHw,2,2,0,0,0,0,0,0,2,0.2857142857142857,1,0.0,0,0,0,0,2,0,0,0,0,0,2,1
6429,178022,LiD14ALXLddUqpdQnujGFxQiBSoJOZGF,A3fsA9Zfv1X2fVEQhTw51lKENdNrEqT3,3,3,1,0,0,0,1,0,5,0.7142857142857143,1,0.0,0,1,0,0,3,0,0,1,0,1,4,1
6430,178047,g5hqByjT71l7XQpoHooh42h6aYalEjyF,RXDvfPUBYFlVdlueBFbLW0mhhAyGEqpt,5,2,1,0,1,0,2,0,6,0.8571428571428571,1,0.0,0,1,0,1,2,0,0,2,0,2,4,1
6431,178054,HyVNcqbXwwt4x7Lh0NDvZJuGvdEMSlMz,bWdj2GDclj5ofokWjzoa5jAwMkxCykd6,1,0,0,0,0,0,1,0,1,0.14285714285714285,1,0.0,0,0,0,0,0,0,0,1,0,0,1,1
6432,178056,xk56WEVJEAYlfTe18KDPHjwyCpm6eESo,RXDvfPUBYFlVdlueBFbLW0mhhAyGEqpt,4,0,0,0,0,2,4,1,7,1.0,1,0.0,0,0,0,0,0,2,0,4,1,0,7,1
6433,178067,SM0peUZSWYQguXepyPBRDLnLmqFvDaRW,A3fsA9Zfv1X2fVEQhTw51lKENdNrEqT3,16,16,9,0,5,0,5,0,35,5.0,1,0.0,0,9,0,5,16,0,0,5,0,14,21,1
6434,178076,ctPyLd013hzE9dQTFFYRA7Z6fW1VhLt5,SpATywNh6bZuzm8s1ceuBUnMUAeoAHHw,11,14,4,10,2,0,1,0,31,4.428571428571429,1,0.0,9,4,10,2,5,0,0,1,0,25,6,1
6435,178096,YRvoydpc37Vpysmtw8O9rzowfgsZu7lO,bWdj2GDclj5ofokWjzoa5jAwMkxCykd6,3,4,0,0,0,0,1,0,5,0.7142857142857143,1,0.0,1,0,0,0,3,0,0,1,0,1,4,1
6436,178120,yiEYYQaKbyzpwJWElvWXAXdPO93zfPgh,A3fsA9Zfv1X2fVEQhTw51lKENdNrEqT3,1,0,0,0,0,0,1,0,1,0.14285714285714285,1,0.0,0,0,0,0,0,0,0,1,0,0,1,1
6437,178123,jpxpIqdWMtlxqJfj67lnudhyEHl6x8Bm,RXDvfPUBYFlVdlueBFbLW0mhhAyGEqpt,13,10,8,0,6,0,2,0,26,3.7142857142857144,1,0.0,2,8,0,6,8,0,0,2,0,16,10,1
6438,178135,7vNqxUIgpaCj3NnoU9xg00b9Tp3tF5Ri,SpATywNh6bZuzm8s1ceuBUnMUAeoAHHw,9,8,4,0,3,1,5,1,22,3.142857142857143,3,0.0,0,4,0,3,8,1,0,5,1,7,15,1
6439,178152,oRBxd78DtsQ3mEkDyjGaQEGbdrTlmw6j,bWdj2GDclj5ofokWjzoa5jAwMkxCykd6,10,6,2,0,2,0,5,0,15,2.142857142857143,1,0.0,0,2,0,2,6,0,0,5,0,4,11,1
6440,178159,aXJa1zRW8xrdcYprvRlDR2amMkiONMef,SpATywNh6bZuzm8s1ceuBUnMUAeoAHHw,1,0,0,0,0,0,1,0,1,0.14285714285714285,1,0.0,0,0,0,0,0,0,0,1,0,0,1,1
6441,178161,PJ1wLAp2McpPLRMTf6gnqm4Wj7JimEv0,A3fsA9Zfv1X2fVEQhTw51lKENdNrEqT3,5,7,1,0,1,0,1,0,10,1.4285714285714286,1,0.0,0,1,0,1,7,0,0,1,0,2,8,1
6442,178164,dqE1PGrWExsbP4JkEoKdSn4p50FzqbEb,SpATywNh6bZuzm8s1ceuBUnMUAeoAHHw,8,75,41,0,25,7,13,0,161,23.0,1,0.0,6,41,0,25,69,7,0,13,0,72,89,1
6443,178177,bovRkt8OOEauRqwvmsqsFz6hCg8Axl1M,SpATywNh6bZuzm8s1ceuBUnMUAeoAHHw,1,0,0,0,0,0,1,0,1,0.14285714285714285,1,0.0,0,0,0,0,0,0,0,1,0,0,1,1
6444,178204,wMH9y8Ndp4UrZ98WukfHH3BPMXWwQMTj,A3fsA9Zfv1X2fVEQhTw51lKENdNrEqT3,8,6,4,0,1,0,3,0,14,2.0,1,0.0,0,4,0,1,6,0,0,3,0,5,9,1
6445,179630,KNNMSW3oLxGqEqv2czanNkhQgdUkOWgY,G8EPVSXsOYB5YQWZGiz1aVq5Pgr2GrQu,4,2,1,0,1,0,1,0,5,0.7142857142857143,1,0.0,0,1,0,1,2,0,0,1,0,2,3,1
6446,179809,FrcNdFNfLYMOg5fdBzjs15qKbgtHEYZH,bWdj2GDclj5ofokWjzoa5jAwMkxCykd6,12,8,5,0,3,0,6,1,23,3.2857142857142856,2,0.0,1,5,0,3,7,0,0,6,1,9,14,1
6447,180085,faKL2n0gPoXoql4sSWDfZo6er3NptGIb,7GRhBDsirIGkRZBtSMEzNTyDr2JQm4xx,2,0,0,0,0,0,2,0,2,0.2857142857142857,1,0.0,0,0,0,0,0,0,0,2,0,0,2,1
6448,180112,tqvV2MwKeLemDHIUsPAVAoV4nZW7CEvr,7GRhBDsirIGkRZBtSMEzNTyDr2JQm4xx,22,18,12,15,10,0,3,0,58,8.285714285714286,1,0.0,4,12,15,10,14,0,0,3,0,41,17,1
6449,180113,gQlwXyK2UfJePDb32xo4quF0aS1cebFG,7GRhBDsirIGkRZBtSMEzNTyDr2JQm4xx,2,0,0,0,0,0,2,0,2,0.2857142857142857,1,0.0,0,0,0,0,0,0,0,2,0,0,2,1
6450,180217,RtFjOHQ78yo3bQ6aRAVmoLevb4Ve3GxB,7GRhBDsirIGkRZBtSMEzNTyDr2JQm4xx,5,2,1,0,0,0,5,0,8,1.1428571428571428,1,0.0,0,1,0,0,2,0,0,5,0,1,7,1
6451,180225,5p1pugPSQA7ekfeoqop7HHA1WjATAX83,7GRhBDsirIGkRZBtSMEzNTyDr2JQm4xx,1,0,0,0,0,0,1,0,1,0.14285714285714285,1,0.0,0,0,0,0,0,0,0,1,0,0,1,1
6452,180244,A6zX6I2GfUhXHkfxx6hY7fkYNihUgWzR,7GRhBDsirIGkRZBtSMEzNTyDr2JQm4xx,1,0,0,0,0,0,1,0,1,0.14285714285714285,1,0.0,0,0,0,0,0,0,0,1,0,0,1,1
6453,180312,hYTVG5ANDBem3sg8QIDjen4BqqV0JGFL,7GRhBDsirIGkRZBtSMEzNTyDr2JQm4xx,1,0,0,0,0,0,1,0,1,0.14285714285714285,1,0.0,0,0,0,0,0,0,0,1,0,0,1,1
6454,182110,74kxele4p3nZqMdSzyWOOH2cXxk0mF2n,fbPkOYLVPtPgIt0MxizjfFJov3JbHyAi,7,5,2,0,3,0,5,0,15,2.142857142857143,1,0.0,2,2,0,3,3,0,0,5,0,7,8,1
6455,182111,1RfSO2DiyVK1bsd1s7TaxenvqJaPeVpp,fbPkOYLVPtPgIt0MxizjfFJov3JbHyAi,5,2,1,0,1,0,3,0,7,1.0,1,0.0,0,1,0,1,2,0,0,3,0,2,5,1
6456,182114,FIhbLaUliLEAJsxsc7jKlH4XCeC9DPXv,fbPkOYLVPtPgIt0MxizjfFJov3JbHyAi,10,5,4,0,3,0,7,1,20,2.857142857142857,1,0.0,0,4,0,3,5,0,0,7,1,7,13,1
6457,182115,5O3cQgHyrDFUqJDA7J5HOtUVaVPsBSzt,fbPkOYLVPtPgIt0MxizjfFJov3JbHyAi,6,5,2,0,2,0,1,0,10,1.4285714285714286,1,0.0,0,2,0,2,5,0,0,1,0,4,6,1
6458,182117,17rg9STHXDHiRzS91SaQJyD9M8yu2605,fbPkOYLVPtPgIt0MxizjfFJov3JbHyAi,14,10,5,7,6,0,6,0,34,4.857142857142857,1,0.0,4,5,6,6,6,0,1,6,0,21,13,1
6459,182118,ytQygmlMNZc9yKIahmW7Nv1t8JgEizoV,fbPkOYLVPtPgIt0MxizjfFJov3JbHyAi,2,0,0,0,0,0,2,0,2,0.2857142857142857,1,0.0,0,0,0,0,0,0,0,2,0,0,2,1
6460,182124,sIANk8CDDpmYWYdg4Th4BflYvOf56CEK,fbPkOYLVPtPgIt0MxizjfFJov3JbHyAi,6,5,1,0,2,0,2,0,10,1.4285714285714286,1,0.0,2,1,0,2,3,0,0,2,0,5,5,1
6461,182125,aDT6m9laxK2gk5mLuphqqVgMaj2Iqzzo,fbPkOYLVPtPgIt0MxizjfFJov3JbHyAi,1,0,0,0,0,0,1,0,1,0.14285714285714285,1,0.0,0,0,0,0,0,0,0,1,0,0,1,1
6462,182128,FgihPmscVblrwMVdNFApI0UuOBmm5ZAb,fbPkOYLVPtPgIt0MxizjfFJov3JbHyAi,1,0,0,0,0,0,1,0,1,0.14285714285714285,1,0.0,0,0,0,0,0,0,0,1,0,0,1,1
6463,182134,NZSWYEaOe1aGzYbLbh5XgSdJLgnj2k8M,fbPkOYLVPtPgIt0MxizjfFJov3JbHyAi,7,3,2,0,2,0,10,0,17,2.4285714285714284,1,0.0,0,2,0,2,3,0,0,10,0,4,13,1
6464,182135,iejOj5OrmiAxzthyfxCU4HfOTTqB4wPz,fbPkOYLVPtPgIt0MxizjfFJov3JbHyAi,6,3,2,0,1,0,3,0,9,1.2857142857142858,1,0.0,0,2,0,1,3,0,0,3,0,3,6,1
6465,182138,QLWeBu2uxsDdky4Sdm2eq1MPlPyoR8PH,fbPkOYLVPtPgIt0MxizjfFJov3JbHyAi,2,0,0,0,0,0,8,0,8,1.1428571428571428,1,0.0,0,0,0,0,0,0,0,8,0,0,8,1
6466,182139,zlBC6rRu9jlWaXBFQagY5lGC2179zznK,fbPkOYLVPtPgIt0MxizjfFJov3JbHyAi,9,4,3,0,3,8,13,0,31,4.428571428571429,1,0.0,0,3,0,3,4,8,0,13,0,6,25,1
6467,182143,dX17jSABXDRMoXQfnDhuEq3sAW2GzYho,fbPkOYLVPtPgIt0MxizjfFJov3JbHyAi,6,1,1,0,1,0,5,0,8,1.1428571428571428,1,0.0,0,1,0,1,1,0,0,5,0,2,6,1
6468,182144,65phBvShfMs4BgpXceOfsAexAndxdKUb,fbPkOYLVPtPgIt0MxizjfFJov3JbHyAi,8,5,3,0,2,0,3,0,13,1.8571428571428572,1,0.0,0,3,0,2,5,0,0,3,0,5,8,1
6469,182145,s9ikAKfIHizdIit72lZmNDpOCL8RyNmr,fbPkOYLVPtPgIt0MxizjfFJov3JbHyAi,1,0,0,0,0,0,1,0,1,0.14285714285714285,1,0.0,0,0,0,0,0,0,0,1,0,0,1,1
6470,182146,je4a6LCViJiZST1Qe1r42SwknRjAiEHX,fbPkOYLVPtPgIt0MxizjfFJov3JbHyAi,9,6,4,0,3,2,7,0,22,3.142857142857143,1,0.0,0,4,0,3,6,2,0,7,0,7,15,1
6471,182147,w6ZOM4xdCTA9pBKt304kiLQIHLSshQf0,fbPkOYLVPtPgIt0MxizjfFJov3JbHyAi,9,4,3,0,3,0,5,0,15,2.142857142857143,1,0.0,0,3,0,3,4,0,0,5,0,6,9,1
6472,182152,eXbUPJJ8vgGBYCYeE2hEC0aNbKdSDbEs,fbPkOYLVPtPgIt0MxizjfFJov3JbHyAi,1,0,0,0,0,0,1,0,1,0.14285714285714285,1,0.0,0,0,0,0,0,0,0,1,0,0,1,1
6473,182154,0TrmohedmafnRfHAroMKgKRtGWbbpH4N,fbPkOYLVPtPgIt0MxizjfFJov3JbHyAi,2,0,0,0,0,0,6,0,6,0.8571428571428571,1,0.0,0,0,0,0,0,0,0,6,0,0,6,1
6474,182155,BoBgrmtQAbGEQdCkYjgMVVWzk508tw3x,fbPkOYLVPtPgIt0MxizjfFJov3JbHyAi,4,2,1,0,1,0,1,0,5,0.7142857142857143,1,0.0,0,1,0,1,2,0,0,1,0,2,3,1
6475,182156,DLmLcsmmZc2iMAWHNtxeaYm4TYub9M4W,fbPkOYLVPtPgIt0MxizjfFJov3JbHyAi,1,0,0,0,0,0,1,0,1,0.14285714285714285,1,0.0,0,0,0,0,0,0,0,1,0,0,1,1
6476,182159,ntaJKTMgiTQfD5Tbv9HcsBpNugCaYi0b,fbPkOYLVPtPgIt0MxizjfFJov3JbHyAi,1,0,0,0,0,0,2,0,2,0.2857142857142857,1,0.0,0,0,0,0,0,0,0,2,0,0,2,1
6477,182160,wKSiPD3ccCI47tDYWhx56Wd2BJP8ki2L,fbPkOYLVPtPgIt0MxizjfFJov3JbHyAi,9,7,3,0,3,5,4,1,23,3.2857142857142856,1,0.0,2,3,0,3,5,5,0,4,1,8,15,1
6478,182162,itIzAmwxr6fy2yhmRnAPbRxBE6DJmsTD,fbPkOYLVPtPgIt0MxizjfFJov3JbHyAi,23,27,14,17,15,0,2,0,75,10.714285714285714,1,0.0,12,14,14,15,15,0,3,2,0,55,20,1
6479,182318,dVj05AozpSMnDp2rhv4XKLX2a6Zq0Qtw,SpATywNh6bZuzm8s1ceuBUnMUAeoAHHw,2,0,0,0,0,0,2,0,2,0.2857142857142857,1,0.0,0,0,0,0,0,0,0,2,0,0,2,1
6480,182332,ssNBIPbMZoiJEHlxM1JuEFEFm67Micu2,SpATywNh6bZuzm8s1ceuBUnMUAeoAHHw,6,2,0,0,0,4,14,6,26,3.7142857142857144,1,0.0,0,0,0,0,2,4,0,14,6,0,26,1
6481,182346,yuwVVMBtTYqYgFk8HBT2CeCSsbPznS4I,SpATywNh6bZuzm8s1ceuBUnMUAeoAHHw,6,8,1,0,1,4,6,0,20,2.857142857142857,2,0.0,0,1,0,1,8,4,0,6,0,2,18,1
6482,182375,L7M3Ksh9UBx3xOMl31gqtqz6gfclvqlN,SpATywNh6bZuzm8s1ceuBUnMUAeoAHHw,7,11,4,0,1,1,6,0,23,3.2857142857142856,3,0.0,0,4,0,1,11,1,0,6,0,5,18,1
6483,182376,QlyEMMfomXdFJCE0WvpazQe9ZaXY0FQw,SpATywNh6bZuzm8s1ceuBUnMUAeoAHHw,1,0,0,0,0,0,2,0,2,0.2857142857142857,1,0.0,0,0,0,0,0,0,0,2,0,0,2,1
6484,182379,JdJ1SwT93OWgPbpS5GdJzD3RLASaE4SR,RXDvfPUBYFlVdlueBFbLW0mhhAyGEqpt,22,14,10,44,7,0,1,0,76,10.857142857142858,1,0.0,3,10,40,7,11,0,4,1,0,60,16,1
6485,182384,ORzIK1DF1vIanXrZDWEgyHCiC4GvvfBc,SpATywNh6bZuzm8s1ceuBUnMUAeoAHHw,4,3,1,0,1,0,3,0,8,1.1428571428571428,1,0.0,0,1,0,1,3,0,0,3,0,2,6,1
6486,182391,UoSDdKW8bXtB0Kuj20V0r0Rw6UViB6yh,SpATywNh6bZuzm8s1ceuBUnMUAeoAHHw,5,1,0,0,0,2,7,1,11,1.5714285714285714,1,0.0,0,0,0,0,1,2,0,7,1,0,11,1
6487,182394,0f1EqzZzcXc3MSIWeoaoeCrrqcxrvxwo,bWdj2GDclj5ofokWjzoa5jAwMkxCykd6,2,0,0,0,0,0,2,0,2,0.2857142857142857,1,0.0,0,0,0,0,0,0,0,2,0,0,2,1
6488,182395,pvxjw4szSuluDWQ3DWPes9Mzs1MCvxjI,G8EPVSXsOYB5YQWZGiz1aVq5Pgr2GrQu,6,3,2,0,2,0,1,0,8,1.1428571428571428,1,0.0,0,2,0,2,3,0,0,1,0,4,4,1
6489,182399,vheHPiBs6HjJGbv3Snt0SQIKMYHc5UaU,SpATywNh6bZuzm8s1ceuBUnMUAeoAHHw,3,2,1,0,0,0,1,0,4,0.5714285714285714,1,0.0,0,1,0,0,2,0,0,1,0,1,3,1
6490,182402,UdmIlH1y5ROywT4Ry6jaou64JO5vWiAz,RXDvfPUBYFlVdlueBFbLW0mhhAyGEqpt,1,0,0,0,0,0,1,0,1,0.14285714285714285,1,0.0,0,0,0,0,0,0,0,1,0,0,1,1
6491,182403,ED2sXONkBYI0OZyQYOJ9ygAn9aUKK1Wk,SpATywNh6bZuzm8s1ceuBUnMUAeoAHHw,11,11,6,0,3,4,4,1,29,4.142857142857143,1,0.0,3,6,0,3,8,4,0,4,1,12,17,1
6492,182404,zfXJRVQB9jP4gtyolibVkLvC6I4sMq4Z,SpATywNh6bZuzm8s1ceuBUnMUAeoAHHw,13,9,7,0,3,1,6,1,27,3.857142857142857,1,0.0,0,7,0,3,9,1,0,6,1,10,17,1
6493,182416,Efp2zT9GZ53ahT7m5PosJWOFPjhn8JqA,SpATywNh6bZuzm8s1ceuBUnMUAeoAHHw,1,0,0,0,0,0,1,0,1,0.14285714285714285,1,0.0,0,0,0,0,0,0,0,1,0,0,1,1
6494,182417,4PtDSHhkS4yeMTirE5mvkBBwP3dmM9Qp,SpATywNh6bZuzm8s1ceuBUnMUAeoAHHw,9,8,1,8,0,0,1,0,18,2.5714285714285716,1,0.0,3,1,8,0,5,0,0,1,0,12,6,1
6495,182419,x22fjNSFy0R926MDZKZwS7I3gfP8Gm84,SpATywNh6bZuzm8s1ceuBUnMUAeoAHHw,7,3,2,0,2,0,4,0,11,1.5714285714285714,1,0.0,0,2,0,2,3,0,0,4,0,4,7,1
6496,182420,pYlHnfVkpsPzITBRcvdTXUYMyNXMgg3O,SpATywNh6bZuzm8s1ceuBUnMUAeoAHHw,1,0,0,0,0,0,1,0,1,0.14285714285714285,1,0.0,0,0,0,0,0,0,0,1,0,0,1,1
6497,182427,cZXuWsaeYW0DT1jWDe6bxRqc9qfzrr3C,SpATywNh6bZuzm8s1ceuBUnMUAeoAHHw,5,3,1,0,1,4,3,0,12,1.7142857142857142,1,0.0,0,1,0,1,3,4,0,3,0,2,10,1
6498,182430,3Gc9QM94u4cd0Dw8TEKRCkl8s35hHWXM,SpATywNh6bZuzm8s1ceuBUnMUAeoAHHw,9,4,3,0,3,0,2,0,12,1.7142857142857142,1,0.0,0,3,0,3,4,0,0,2,0,6,6,1
6499,182436,UvIGBO3KU0rWCndAPFCCP6wfS7NUy3B1,SpATywNh6bZuzm8s1ceuBUnMUAeoAHHw,2,0,0,0,0,0,3,0,3,0.42857142857142855,1,0.0,0,0,0,0,0,0,0,3,0,0,3,1
6500,182439,Ilz4MVKb2TGAxWTIiq19EE5elYfPlhdl,SpATywNh6bZuzm8s1ceuBUnMUAeoAHHw,9,6,4,0,3,0,5,0,18,2.5714285714285716,1,0.0,0,4,0,3,6,0,0,5,0,7,11,1
6501,182441,vaWLVKWyrsUzDV0qs20ZUq8M3VNW01Uk,RXDvfPUBYFlVdlueBFbLW0mhhAyGEqpt,1,0,0,0,0,0,1,0,1,0.14285714285714285,1,0.0,0,0,0,0,0,0,0,1,0,0,1,1
6502,182444,SPRinDndbzCEO5Ph1nH3gJGoP1uaeA7R,G8EPVSXsOYB5YQWZGiz1aVq5Pgr2GrQu,1,0,0,0,0,0,1,0,1,0.14285714285714285,1,0.0,0,0,0,0,0,0,0,1,0,0,1,1
6503,182445,Ww3MvCXkT8tDnrpdz1E1wBxJBjpXj1Rq,SpATywNh6bZuzm8s1ceuBUnMUAeoAHHw,5,2,1,0,1,0,2,0,6,0.8571428571428571,1,0.0,0,1,0,1,2,0,0,2,0,2,4,1
6504,182448,hFzrRa1GPtD5a7H30wae91F5SOZlRQO1,SpATywNh6bZuzm8s1ceuBUnMUAeoAHHw,9,8,1,0,0,2,6,1,18,2.5714285714285716,1,0.0,0,1,0,0,8,2,0,6,1,1,17,1
6505,182450,8NJMmSdWvECNT7Pwfk6FLAypMClX0z5v,SpATywNh6bZuzm8s1ceuBUnMUAeoAHHw,4,2,1,0,0,0,2,0,5,0.7142857142857143,1,0.0,0,1,0,0,2,0,0,2,0,1,4,1
6506,182453,8ZePp5sXciCV5oXPjTIQbWFxt1SxfcLl,SpATywNh6bZuzm8s1ceuBUnMUAeoAHHw,10,3,2,0,2,2,5,1,15,2.142857142857143,1,0.0,0,2,0,2,3,2,0,5,1,4,11,1
6507,182466,FYh1ETHUxyunx6o3SR9eAC4QbrxXPzoc,RXDvfPUBYFlVdlueBFbLW0mhhAyGEqpt,8,7,3,0,2,0,3,0,15,2.142857142857143,1,0.0,0,3,0,2,7,0,0,3,0,5,10,1
6508,182470,YITGGXKhxzNHdElox232lzcaZdJ61YFn,bWdj2GDclj5ofokWjzoa5jAwMkxCykd6,5,2,1,0,1,3,3,0,10,1.4285714285714286,1,0.0,0,1,0,1,2,3,0,3,0,2,8,1
6509,182472,BeFe1KokGOrbanlGLijG18LEqInxi9W4,RXDvfPUBYFlVdlueBFbLW0mhhAyGEqpt,1,0,0,0,0,0,1,0,1,0.14285714285714285,1,0.0,0,0,0,0,0,0,0,1,0,0,1,1
6510,182476,ryyeh5DB53zHNKeo2vkO5VPfDAHRLLxK,SpATywNh6bZuzm8s1ceuBUnMUAeoAHHw,5,4,0,0,0,0,2,0,6,0.8571428571428571,1,0.0,0,0,0,0,4,0,0,2,0,0,6,1
6511,182478,ywCBITW2Nk5KrEWUjIfEEyRW364OA7v3,SpATywNh6bZuzm8s1ceuBUnMUAeoAHHw,7,4,2,0,0,0,4,0,10,1.4285714285714286,1,0.0,0,2,0,0,4,0,0,4,0,2,8,1
6512,182483,Wm4boeiuAufaIeI7PkgbnseZNqzvwXoA,RXDvfPUBYFlVdlueBFbLW0mhhAyGEqpt,1,0,0,0,0,0,1,0,1,0.14285714285714285,1,0.0,0,0,0,0,0,0,0,1,0,0,1,1
6513,182484,nJFL4ZgVlk8vsvSCMEvmMvfyFCPNkQbb,bWdj2GDclj5ofokWjzoa5jAwMkxCykd6,2,0,0,0,0,0,2,0,2,0.2857142857142857,1,0.0,0,0,0,0,0,0,0,2,0,0,2,1
6514,182490,5kux74rVeqoEvbABYMpdIOO6ta3zLim7,bWdj2GDclj5ofokWjzoa5jAwMkxCykd6,3,2,1,0,0,0,1,0,4,0.5714285714285714,1,0.0,0,1,0,0,2,0,0,1,0,1,3,1
6515,182491,HxeyM7hnjqqrHkT4PVJnwDZtWwoxUMiy,RXDvfPUBYFlVdlueBFbLW0mhhAyGEqpt,1,0,0,0,0,0,1,0,1,0.14285714285714285,1,0.0,0,0,0,0,0,0,0,1,0,0,1,1
6516,182496,FWAi9SzUY3hC5pRVyJkleZ3oNtaFNi6V,SpATywNh6bZuzm8s1ceuBUnMUAeoAHHw,2,0,0,0,0,0,2,0,2,0.2857142857142857,1,0.0,0,0,0,0,0,0,0,2,0,0,2,1
6517,182497,zsHSwvXoubMUxhT2AYVzfcvRGMppEBUX,G8EPVSXsOYB5YQWZGiz1aVq5Pgr2GrQu,1,0,0,0,0,0,1,0,1,0.14285714285714285,1,0.0,0,0,0,0,0,0,0,1,0,0,1,1
6518,182499,9bY2ODFG0JcDRpzNxe1p1poGx2Xx1OUa,SpATywNh6bZuzm8s1ceuBUnMUAeoAHHw,6,6,0,0,0,0,4,0,10,1.4285714285714286,1,0.0,0,0,0,0,6,0,0,4,0,0,10,1
6519,182508,e3jS2U1BhNpArENK983B1rVL1JoqwREV,SpATywNh6bZuzm8s1ceuBUnMUAeoAHHw,8,6,3,0,3,0,1,0,13,1.8571428571428572,1,0.0,0,3,0,3,6,0,0,1,0,6,7,1
6520,182515,oElQ0NJpFnzZRtGV3YErd6rr4i8DxzbB,SpATywNh6bZuzm8s1ceuBUnMUAeoAHHw,6,4,2,0,1,0,2,0,9,1.2857142857142858,1,0.0,0,2,0,1,4,0,0,2,0,3,6,1
6521,182524,IKXwL3bDtlAxjRP4WWhZczJlcbIhG3ib,G8EPVSXsOYB5YQWZGiz1aVq5Pgr2GrQu,9,7,5,0,4,1,6,1,24,3.4285714285714284,1,0.0,0,5,0,4,7,1,0,6,1,9,15,1
6522,182527,QoLZveDbZCrcOypIzCYKhgphRVMR37f0,SpATywNh6bZuzm8s1ceuBUnMUAeoAHHw,7,11,5,0,3,0,5,0,24,3.4285714285714284,1,0.0,2,5,0,3,9,0,0,5,0,10,14,1
6523,182540,68zow3PIETzGkbgKSgGqp4cft1zzT0Wg,SpATywNh6bZuzm8s1ceuBUnMUAeoAHHw,15,29,13,18,5,23,11,0,99,14.142857142857142,2,0.0,6,13,15,5,23,23,3,11,0,39,60,1
6524,182548,1wTTPpSWNZRGQY72YsG9M4kDyp3wXVIX,SpATywNh6bZuzm8s1ceuBUnMUAeoAHHw,9,4,0,3,0,0,5,2,14,2.0,1,0.0,1,0,3,0,3,0,0,5,2,4,10,1
6525,182552,ykEW9evpDPHZbB36kn5ppyB9XHnMY2SE,bWdj2GDclj5ofokWjzoa5jAwMkxCykd6,4,2,1,0,0,0,2,0,5,0.7142857142857143,1,0.0,0,1,0,0,2,0,0,2,0,1,4,1
6526,182556,0dYUj8IzWWp9WKVei3srYo9Z7019GkyS,SpATywNh6bZuzm8s1ceuBUnMUAeoAHHw,6,2,1,0,1,0,3,0,7,1.0,1,0.0,0,1,0,1,2,0,0,3,0,2,5,1
6527,182565,BtOoPJiqJpi7FXEZFIq8NLvECwNXeaZ8,SpATywNh6bZuzm8s1ceuBUnMUAeoAHHw,6,1,1,0,1,0,3,0,6,0.8571428571428571,1,0.0,0,1,0,1,1,0,0,3,0,2,4,1
6528,182572,L3vH8w9MBmyNbE6zYIQcQAgtUd2AVGJ2,bWdj2GDclj5ofokWjzoa5jAwMkxCykd6,2,0,0,0,0,0,2,0,2,0.2857142857142857,1,0.0,0,0,0,0,0,0,0,2,0,0,2,1
6529,182574,9HtqmGFwW9nlaXQoPiq8Q0exBzv6okJA,SpATywNh6bZuzm8s1ceuBUnMUAeoAHHw,6,2,1,0,1,0,10,0,14,2.0,1,0.0,0,1,0,1,2,0,0,10,0,2,12,1
6530,182583,67xpG0g0SaNRrqSFMK3Slz5FQV4uaOHQ,SpATywNh6bZuzm8s1ceuBUnMUAeoAHHw,7,2,1,0,1,0,4,2,10,1.4285714285714286,1,0.0,0,1,0,1,2,0,0,4,2,2,8,1
6531,182590,AgVRfkL9ddoBcgWiMEqgB28oDseRQMfR,G8EPVSXsOYB5YQWZGiz1aVq5Pgr2GrQu,7,10,0,0,0,0,2,0,12,1.7142857142857142,1,0.0,1,0,0,0,9,0,0,2,0,1,11,1
6532,182592,o8FE9F7Hj949CAE87fPDQyCYZ9zgH4qv,SpATywNh6bZuzm8s1ceuBUnMUAeoAHHw,1,0,0,0,0,0,1,0,1,0.14285714285714285,1,0.0,0,0,0,0,0,0,0,1,0,0,1,1
6533,182593,MV8XdB3h6ePuBNN3BGaZCvIfimFFX0Mk,SpATywNh6bZuzm8s1ceuBUnMUAeoAHHw,1,0,0,0,0,0,1,0,1,0.14285714285714285,1,0.0,0,0,0,0,0,0,0,1,0,0,1,1
6534,182595,iQCW6W4nBE7M3nPE1JFW3uJTussgN79A,SpATywNh6bZuzm8s1ceuBUnMUAeoAHHw,7,2,1,0,1,0,5,1,10,1.4285714285714286,1,0.0,0,1,0,1,2,0,0,5,1,2,8,1
6535,182596,i1weaEaafaiWi31Ms4bwoF6JM4IRf714,G8EPVSXsOYB5YQWZGiz1aVq5Pgr2GrQu,14,27,11,20,7,0,2,0,67,9.571428571428571,1,0.0,14,11,11,7,13,0,9,2,0,43,24,1
6536,182599,C82stxYBdobab5s8FnzuMHxgMBwKu2tD,SpATywNh6bZuzm8s1ceuBUnMUAeoAHHw,3,2,0,0,0,0,2,0,4,0.5714285714285714,1,0.0,0,0,0,0,2,0,0,2,0,0,4,1
6537,182602,pC6FwYDHxh9swUa6nvJYcLLtE0AYC1Cg,bWdj2GDclj5ofokWjzoa5jAwMkxCykd6,1,0,0,0,0,0,1,0,1,0.14285714285714285,1,0.0,0,0,0,0,0,0,0,1,0,0,1,1
6538,182604,YYm9SLmjJQnTtFQLnNCxEK5OKVRWWeS9,SpATywNh6bZuzm8s1ceuBUnMUAeoAHHw,7,7,3,0,3,1,2,0,16,2.2857142857142856,1,0.0,0,3,0,3,7,1,0,2,0,6,10,1
6539,182610,VR4kpCHjSnr2YglEgcuTrivL0Gg47pGL,SpATywNh6bZuzm8s1ceuBUnMUAeoAHHw,13,15,7,18,5,0,2,0,47,6.714285714285714,1,0.0,6,7,15,5,9,0,3,2,0,33,14,1
6540,182611,WtbenHJvVPK6SiW3psJUnjqNlshJ00ku,SpATywNh6bZuzm8s1ceuBUnMUAeoAHHw,9,5,0,0,0,1,5,1,12,1.7142857142857142,1,0.0,0,0,0,0,5,1,0,5,1,0,12,1
6541,182614,UuSIoFbtQOfzMmWUxokidkbXgJFaHXwx,bWdj2GDclj5ofokWjzoa5jAwMkxCykd6,1,0,0,0,0,0,1,0,1,0.14285714285714285,1,0.0,0,0,0,0,0,0,0,1,0,0,1,1
6542,182623,Vqh7IxciNu3w4ryq9DwYRMQWb1h8f16V,G8EPVSXsOYB5YQWZGiz1aVq5Pgr2GrQu,11,13,7,0,4,19,5,0,48,6.857142857142857,1,0.0,0,7,0,4,13,19,0,5,0,11,37,1
6543,182626,1P2LChndrUiRCjj6mVB5w5hmLH8bp8jB,SpATywNh6bZuzm8s1ceuBUnMUAeoAHHw,7,6,1,0,1,0,3,0,11,1.5714285714285714,1,0.0,0,1,0,1,6,0,0,3,0,2,9,1
6544,182629,x5W7px1blVgXPSeduQeF8luvK0oCFfzJ,RXDvfPUBYFlVdlueBFbLW0mhhAyGEqpt,1,0,0,0,0,0,1,0,1,0.14285714285714285,1,0.0,0,0,0,0,0,0,0,1,0,0,1,1
6545,182633,XO0d4deCWOy3mmgL5fsAr1MAAwghPAkB,RXDvfPUBYFlVdlueBFbLW0mhhAyGEqpt,38,50,3,86,5,1,11,0,156,22.285714285714285,1,0.0,16,3,80,5,34,1,6,11,0,104,52,1
6546,182639,COhPD73W4lvIiazL2vbp3j5FVs5HQ601,SpATywNh6bZuzm8s1ceuBUnMUAeoAHHw,5,2,1,0,1,0,2,0,6,0.8571428571428571,1,0.0,0,1,0,1,2,0,0,2,0,2,4,1
6547,182640,2Wz9ixAR47Et860ivxArFAVvspY1IqDz,bWdj2GDclj5ofokWjzoa5jAwMkxCykd6,6,3,0,24,0,1,2,0,30,4.285714285714286,1,0.0,1,0,23,0,2,1,1,2,0,24,6,1
6548,182643,1IgVs7QdLHhnPG0jFRERCqu2Y9FlWiVF,G8EPVSXsOYB5YQWZGiz1aVq5Pgr2GrQu,3,0,0,0,0,3,2,0,5,0.7142857142857143,1,0.0,0,0,0,0,0,3,0,2,0,0,5,1
6549,182647,8P2IV2kWoU5ZCAhZNesFZXBCmVIcwHGV,SpATywNh6bZuzm8s1ceuBUnMUAeoAHHw,15,33,2,18,0,5,15,2,75,10.714285714285714,2,0.0,7,2,15,0,26,5,3,15,2,24,51,1
6550,182664,VHKy90msZ6s6PWErEswELl083Xh3kNC6,SpATywNh6bZuzm8s1ceuBUnMUAeoAHHw,10,7,1,14,1,9,5,0,37,5.285714285714286,2,0.0,2,1,13,1,5,9,1,5,0,17,20,1
6551,182669,PhL2ZyLw1V28vd4DfOVSi8FZIcPFQkVx,bWdj2GDclj5ofokWjzoa5jAwMkxCykd6,4,2,1,0,1,1,1,0,6,0.8571428571428571,1,0.0,0,1,0,1,2,1,0,1,0,2,4,1
6552,182671,GANbW2mfChK4bd2m73sodc3ItJtDn1ba,SpATywNh6bZuzm8s1ceuBUnMUAeoAHHw,4,0,0,0,0,0,3,1,4,0.5714285714285714,1,0.0,0,0,0,0,0,0,0,3,1,0,4,1
6553,182672,L8GepxGnZH9aQkkBlOp07iXjAUHLfNwr,SpATywNh6bZuzm8s1ceuBUnMUAeoAHHw,3,5,0,0,0,0,1,0,6,0.8571428571428571,1,0.0,2,0,0,0,3,0,0,1,0,2,4,1
6554,182675,XYKEbaRABcMuBHmMB2I3YkBepzCp0swB,bWdj2GDclj5ofokWjzoa5jAwMkxCykd6,5,14,2,0,1,0,4,0,21,3.0,2,0.0,2,2,0,1,12,0,0,4,0,5,16,1
6555,182696,GcJFzpyOdnnoWwg3V1INu4JCOvQXcJgJ,SpATywNh6bZuzm8s1ceuBUnMUAeoAHHw,1,0,0,0,0,0,1,0,1,0.14285714285714285,1,0.0,0,0,0,0,0,0,0,1,0,0,1,1
6556,182699,RAGQmaCMG2kfcGeGG7CgUDmUq1d4kIyn,G8EPVSXsOYB5YQWZGiz1aVq5Pgr2GrQu,2,0,0,0,0,0,4,0,4,0.5714285714285714,1,0.0,0,0,0,0,0,0,0,4,0,0,4,1
6557,182702,3QS27JowcKsai44171i1lf7TLJ6jrzZW,SpATywNh6bZuzm8s1ceuBUnMUAeoAHHw,6,5,2,0,1,0,2,0,10,1.4285714285714286,1,0.0,2,2,0,1,3,0,0,2,0,5,5,1
6558,182705,vgiQpvSAFn3WqqXXyEm42CrUfpctzUEX,SpATywNh6bZuzm8s1ceuBUnMUAeoAHHw,5,2,1,0,1,0,2,0,6,0.8571428571428571,1,0.0,0,1,0,1,2,0,0,2,0,2,4,1
6559,182714,SDvatKCgfdtv12UzJLxR0GYxgD4pUkgT,bWdj2GDclj5ofokWjzoa5jAwMkxCykd6,3,3,1,0,0,0,2,0,6,0.8571428571428571,1,0.0,0,1,0,0,3,0,0,2,0,1,5,1
6560,182718,e9IMJZnDOQwZUgVPoYAYW4meXQnaglvw,SpATywNh6bZuzm8s1ceuBUnMUAeoAHHw,10,2,2,0,2,0,8,3,17,2.4285714285714284,1,0.0,0,2,0,2,2,0,0,8,3,4,13,1
6561,182724,TV8zrBdNM1adKaAPI8D2c3PyvuLKkNEi,SpATywNh6bZuzm8s1ceuBUnMUAeoAHHw,8,2,1,0,1,3,7,1,15,2.142857142857143,1,0.0,0,1,0,1,2,3,0,7,1,2,13,1
6562,182742,YMU8P29wy18QfGxug1svcdE5aeLt8eef,SpATywNh6bZuzm8s1ceuBUnMUAeoAHHw,13,14,5,0,2,5,10,1,37,5.285714285714286,1,0.0,2,5,0,2,12,5,0,10,1,9,28,1
6563,182744,AXhSW785x6j50916e34SRK9faB9FqLBm,SpATywNh6bZuzm8s1ceuBUnMUAeoAHHw,2,0,0,0,0,0,2,0,2,0.2857142857142857,1,0.0,0,0,0,0,0,0,0,2,0,0,2,1
6564,182746,ADL0cXowUMs4wyiAOHKMOrtTHu5tmUqi,SpATywNh6bZuzm8s1ceuBUnMUAeoAHHw,5,5,3,0,2,0,2,0,12,1.7142857142857142,1,0.0,0,3,0,2,5,0,0,2,0,5,7,1
6565,182751,s4TEJX3ZSvr4kBLGdjg6CpTOCIceK5wi,SpATywNh6bZuzm8s1ceuBUnMUAeoAHHw,1,0,0,0,0,0,1,0,1,0.14285714285714285,1,0.0,0,0,0,0,0,0,0,1,0,0,1,1
6566,182755,CwJSAfmXBIxjg0tYJaLcAWBrHja9U2kJ,SpATywNh6bZuzm8s1ceuBUnMUAeoAHHw,5,3,0,0,0,0,5,0,8,1.1428571428571428,1,0.0,0,0,0,0,3,0,0,5,0,0,8,1
6567,182766,ywNFtohqWrdbrhEW62rPnGjVYfzTZ181,SpATywNh6bZuzm8s1ceuBUnMUAeoAHHw,1,0,0,0,0,0,1,0,1,0.14285714285714285,1,0.0,0,0,0,0,0,0,0,1,0,0,1,1
6568,182768,wVdlJl1TkeMQ7fPs3s7SDiFZ9EQoXXFL,RXDvfPUBYFlVdlueBFbLW0mhhAyGEqpt,1,0,0,0,0,0,1,0,1,0.14285714285714285,1,0.0,0,0,0,0,0,0,0,1,0,0,1,1
6569,182781,myIIBocNFelldmuN47bMrRiORGKDSj7S,RXDvfPUBYFlVdlueBFbLW0mhhAyGEqpt,1,0,0,0,0,0,1,0,1,0.14285714285714285,1,0.0,0,0,0,0,0,0,0,1,0,0,1,1
6570,182783,H5XDLEjPVO5GyYRwYkINM9ORsYQG2YvW,SpATywNh6bZuzm8s1ceuBUnMUAeoAHHw,13,12,4,14,3,0,1,0,34,4.857142857142857,1,0.0,5,4,13,3,7,0,1,1,0,25,9,1
6571,182796,G1LkA451FC6E6IOfdWKqpy8y2lc8YSzz,SpATywNh6bZuzm8s1ceuBUnMUAeoAHHw,6,5,2,0,0,0,4,0,11,1.5714285714285714,1,0.0,0,2,0,0,5,0,0,4,0,2,9,1
6572,182815,JfAsemHlarA2F9Qw0stOCWfmH1qVmt8W,SpATywNh6bZuzm8s1ceuBUnMUAeoAHHw,1,0,0,0,0,0,1,0,1,0.14285714285714285,1,0.0,0,0,0,0,0,0,0,1,0,0,1,1
6573,182831,ZNcLOAJ2r3H5DqhbGk1CiPtwI7ixaCeK,RXDvfPUBYFlVdlueBFbLW0mhhAyGEqpt,5,7,4,0,1,0,4,0,16,2.2857142857142856,2,0.0,0,4,0,1,7,0,0,4,0,5,11,1
6574,182833,7cuOR7XN3OKWyCY4rmOlBcFyB6vgzoQs,bWdj2GDclj5ofokWjzoa5jAwMkxCykd6,9,13,3,34,3,0,4,0,57,8.142857142857142,1,0.0,5,3,33,3,8,0,1,4,0,44,13,1
6575,182849,2CWwtE86TUtrUhYms4GqpHHdjjzejIiw,RXDvfPUBYFlVdlueBFbLW0mhhAyGEqpt,10,9,0,0,0,0,1,0,10,1.4285714285714286,1,0.0,0,0,0,0,9,0,0,1,0,0,10,1
6576,182851,dJrIkntdHmFqt2nNdHl0WRj6RFfeHhWR,G8EPVSXsOYB5YQWZGiz1aVq5Pgr2GrQu,3,0,0,0,0,1,2,0,3,0.42857142857142855,1,0.0,0,0,0,0,0,1,0,2,0,0,3,1
6577,182860,foTg5qEPNfrsoDSNAhj65g7lMuh2VdSR,SpATywNh6bZuzm8s1ceuBUnMUAeoAHHw,1,0,0,0,0,0,1,0,1,0.14285714285714285,1,0.0,0,0,0,0,0,0,0,1,0,0,1,1
6578,182872,Klt9qoufCaIWdba44x7MkMWwmjaj9rrO,G8EPVSXsOYB5YQWZGiz1aVq5Pgr2GrQu,8,5,3,0,2,0,4,0,14,2.0,1,0.0,0,3,0,2,5,0,0,4,0,5,9,1
6579,182876,73K789g4e0jr9RbqLOh1RUOvDP0ZYtaO,SpATywNh6bZuzm8s1ceuBUnMUAeoAHHw,1,0,0,0,0,0,1,0,1,0.14285714285714285,1,0.0,0,0,0,0,0,0,0,1,0,0,1,1
6580,182884,q1zfV7JQnPHYBA4GkSf8RBmBmzIBSPXp,SpATywNh6bZuzm8s1ceuBUnMUAeoAHHw,1,0,0,0,0,0,2,0,2,0.2857142857142857,1,0.0,0,0,0,0,0,0,0,2,0,0,2,1
6581,182901,ROcCBAUDWCCmSmJWa8UkAc38NUTaJmvd,SpATywNh6bZuzm8s1ceuBUnMUAeoAHHw,7,7,6,0,4,0,1,0,18,2.5714285714285716,1,0.0,0,6,0,4,7,0,0,1,0,10,8,1
6582,182902,Gj3pHpaNgZrapEPZYhvbfuaS2aMS6tgO,SpATywNh6bZuzm8s1ceuBUnMUAeoAHHw,1,0,0,0,0,0,1,0,1,0.14285714285714285,1,0.0,0,0,0,0,0,0,0,1,0,0,1,1
6583,182909,kZLA3umCB77AeK17F9sH7z1Ojbpf7TLv,RXDvfPUBYFlVdlueBFbLW0mhhAyGEqpt,11,9,6,0,3,0,2,0,20,2.857142857142857,1,0.0,3,6,0,3,6,0,0,2,0,12,8,1
6584,182910,woTsCvW1lUQJlNZPTxvW6TWDeSBjlE3x,SpATywNh6bZuzm8s1ceuBUnMUAeoAHHw,15,45,2,21,2,4,7,1,82,11.714285714285714,1,0.0,32,2,16,2,13,4,5,7,1,52,30,1
6585,182923,7kYJ9SFEtYe6Heh67x8Vp6BF2X3NW60w,SpATywNh6bZuzm8s1ceuBUnMUAeoAHHw,5,2,1,0,0,0,5,0,8,1.1428571428571428,1,0.0,0,1,0,0,2,0,0,5,0,1,7,1
6586,182928,hOv5RKQK1RGRxpJJGcW0k2cA3RwQ8Rk5,SpATywNh6bZuzm8s1ceuBUnMUAeoAHHw,8,9,5,0,3,0,3,0,20,2.857142857142857,2,0.0,2,5,0,3,7,0,0,3,0,10,10,1
6587,182929,czJlHgmBYIN2fkWm8DMCxTMvIB7CPSjD,SpATywNh6bZuzm8s1ceuBUnMUAeoAHHw,1,0,0,0,0,0,1,0,1,0.14285714285714285,1,0.0,0,0,0,0,0,0,0,1,0,0,1,1
6588,182953,tmP3hiAxOmIcth7vkvpHKk2OIqOO5u37,bWdj2GDclj5ofokWjzoa5jAwMkxCykd6,4,5,1,0,0,0,1,0,7,1.0,1,0.0,0,1,0,0,5,0,0,1,0,1,6,1
6589,182959,4uRRd3ZIFdyKPTDLtcF8p2hJfez66l8b,bWdj2GDclj5ofokWjzoa5jAwMkxCykd6,4,2,1,0,1,0,1,0,5,0.7142857142857143,1,0.0,0,1,0,1,2,0,0,1,0,2,3,1
6590,182961,XNpvXjwLvaeOlYFUhwJmIuJfOHxWLTUx,SpATywNh6bZuzm8s1ceuBUnMUAeoAHHw,8,11,5,3,0,0,2,0,21,3.0,1,0.0,5,5,3,0,6,0,0,2,0,13,8,1
6591,182971,LslskpvRu2kdJKdLBrkhLUwON3Gy18Vo,bWdj2GDclj5ofokWjzoa5jAwMkxCykd6,10,3,2,12,2,0,3,0,22,3.142857142857143,1,0.0,1,2,12,2,2,0,0,3,0,17,5,0
6592,182975,TVBdP57RgHmXdzDOQxhhxrruZniECnNa,SpATywNh6bZuzm8s1ceuBUnMUAeoAHHw,10,11,7,0,3,10,10,2,43,6.142857142857143,2,0.0,0,7,0,3,11,10,0,10,2,10,33,1
6593,182978,WRGP3RiE3PgQD7N1Gw3XyQmMvgPUNX5x,SpATywNh6bZuzm8s1ceuBUnMUAeoAHHw,10,15,9,0,5,1,13,2,45,6.428571428571429,1,0.0,0,9,0,5,15,1,0,13,2,14,31,1
6594,182990,LHjZbHCdMckrMwOq7c5kO6EdbIUV0ZXr,SpATywNh6bZuzm8s1ceuBUnMUAeoAHHw,1,0,0,0,0,0,1,0,1,0.14285714285714285,1,0.0,0,0,0,0,0,0,0,1,0,0,1,1
6595,182992,p0pdpDYYJlDvrp00zDzLRGjYUqDxuGfa,SpATywNh6bZuzm8s1ceuBUnMUAeoAHHw,8,3,1,0,1,1,5,1,12,1.7142857142857142,1,0.0,0,1,0,1,3,1,0,5,1,2,10,1
6596,182994,64m0Q8jwm0bupg7LuUgGhNi3maBhbH3Y,SpATywNh6bZuzm8s1ceuBUnMUAeoAHHw,5,1,1,0,1,0,2,0,5,0.7142857142857143,1,0.0,0,1,0,1,1,0,0,2,0,2,3,1
6597,182998,aliLWjsmDZq4LP4uTi2kUntAc8WQqjiN,SpATywNh6bZuzm8s1ceuBUnMUAeoAHHw,6,3,2,0,2,0,1,0,8,1.1428571428571428,1,0.0,0,2,0,2,3,0,0,1,0,4,4,1
6598,183000,mjiGg0j06CInyeszEq1InPQHaMEdBBQC,SpATywNh6bZuzm8s1ceuBUnMUAeoAHHw,1,0,0,0,0,0,1,0,1,0.14285714285714285,1,0.0,0,0,0,0,0,0,0,1,0,0,1,1
6599,183015,Klt9qoufCaIWdba44x7MkMWwmjaj9rrO,RXDvfPUBYFlVdlueBFbLW0mhhAyGEqpt,5,2,1,0,1,0,2,0,6,0.8571428571428571,1,0.0,0,1,0,1,2,0,0,2,0,2,4,1
6600,183020,ktn21iQNCuR3oHHXVI0NrarzymknVPKy,bWdj2GDclj5ofokWjzoa5jAwMkxCykd6,14,17,6,60,3,0,4,0,90,12.857142857142858,1,0.0,4,6,59,3,13,0,1,4,0,72,18,1
6601,183023,iVDV62MoJzFeSGfSaOdA9lfvHL2Xprv8,bWdj2GDclj5ofokWjzoa5jAwMkxCykd6,1,0,0,0,0,0,1,0,1,0.14285714285714285,1,0.0,0,0,0,0,0,0,0,1,0,0,1,1
6602,183035,A23dnlnLlkfS4Hk14geJvIKVXuW282iT,SpATywNh6bZuzm8s1ceuBUnMUAeoAHHw,7,2,1,0,1,0,4,0,8,1.1428571428571428,1,0.0,0,1,0,1,2,0,0,4,0,2,6,1
6603,183046,wgSBRoX5zgs9VU58GuULiQecnpPq9Lqh,RXDvfPUBYFlVdlueBFbLW0mhhAyGEqpt,6,3,2,0,2,0,1,0,8,1.1428571428571428,1,0.0,0,2,0,2,3,0,0,1,0,4,4,1
6604,183051,rlQIqtgsDfEVihltHvVH3EnaOkFIJWY2,bWdj2GDclj5ofokWjzoa5jAwMkxCykd6,2,0,0,0,0,0,2,0,2,0.2857142857142857,1,0.0,0,0,0,0,0,0,0,2,0,0,2,1
6605,183053,lmeMhWa8hXVoeC6vmJbPTxkNCUltvvzl,bWdj2GDclj5ofokWjzoa5jAwMkxCykd6,1,0,0,0,0,0,1,0,1,0.14285714285714285,1,0.0,0,0,0,0,0,0,0,1,0,0,1,0
6606,183074,hDvxnDgro87cypkqHin6LwVYFrNPTTLE,RXDvfPUBYFlVdlueBFbLW0mhhAyGEqpt,11,5,3,0,2,0,8,1,19,2.7142857142857144,1,0.0,0,3,0,2,5,0,0,8,1,5,14,0
6607,183099,VerLbwiPxmF2ThOpDXTyChlnDHBPqkR9,SpATywNh6bZuzm8s1ceuBUnMUAeoAHHw,1,0,0,0,0,0,1,0,1,0.14285714285714285,1,0.0,0,0,0,0,0,0,0,1,0,0,1,1
6608,183102,Kl5tK7ooc00n8wf3ct9g9Ke76aOxJvfm,RXDvfPUBYFlVdlueBFbLW0mhhAyGEqpt,2,0,0,0,0,0,3,0,3,0.42857142857142855,1,0.0,0,0,0,0,0,0,0,3,0,0,3,1
6609,183108,jVeR6Ygg8woHLAlxijrDAiyFqfotJXuz,SpATywNh6bZuzm8s1ceuBUnMUAeoAHHw,1,0,0,0,0,0,1,0,1,0.14285714285714285,1,0.0,0,0,0,0,0,0,0,1,0,0,1,1
6610,183109,AildxiB1DfzGkzpFkUFcF6xLBoz939kN,SpATywNh6bZuzm8s1ceuBUnMUAeoAHHw,4,2,1,0,1,0,1,0,5,0.7142857142857143,1,0.0,0,1,0,1,2,0,0,1,0,2,3,1
6611,183115,lKZ6PIEzVkW9yjCyAe8hsmBYDIXs5abt,RXDvfPUBYFlVdlueBFbLW0mhhAyGEqpt,4,3,0,0,0,0,4,0,7,1.0,1,0.0,0,0,0,0,3,0,0,4,0,0,7,1
6612,183119,BoPqpHAIR2FQ1yjN5I6jPiYn67RLyUD3,bWdj2GDclj5ofokWjzoa5jAwMkxCykd6,1,0,0,0,0,0,2,0,2,0.2857142857142857,1,0.0,0,0,0,0,0,0,0,2,0,0,2,1
6613,183123,CkLUnVGhbMVv40VnwKxHWwmtgjnmo4A6,G8EPVSXsOYB5YQWZGiz1aVq5Pgr2GrQu,77,101,41,204,25,34,16,5,426,60.857142857142854,2,0.0,55,41,158,25,46,34,46,16,5,279,147,0
6614,183129,eOxm8XEI11Xs6eiBi1Nu5QzIagZXwEm9,RXDvfPUBYFlVdlueBFbLW0mhhAyGEqpt,12,13,8,0,1,8,2,0,32,4.571428571428571,1,0.0,4,8,0,1,9,8,0,2,0,13,19,0
6615,183130,w2Erm8d51TR8x1zaznDbwXn8kjSZE4Bu,G8EPVSXsOYB5YQWZGiz1aVq5Pgr2GrQu,8,8,5,0,3,0,8,0,24,3.4285714285714284,1,0.0,0,5,0,3,8,0,0,8,0,8,16,1
6616,183131,xWIW5AMIa14HXXQklcDbkiec2fixez0X,SpATywNh6bZuzm8s1ceuBUnMUAeoAHHw,2,0,0,0,0,0,2,0,2,0.2857142857142857,1,0.0,0,0,0,0,0,0,0,2,0,0,2,1
6617,183144,NFQYK3FjmQHQ82RJihsHHyxDsiLlEhiy,G8EPVSXsOYB5YQWZGiz1aVq5Pgr2GrQu,6,3,2,0,2,0,1,0,8,1.1428571428571428,1,0.0,0,2,0,2,3,0,0,1,0,4,4,1
6618,183150,RDDLwVBt5GubTYBjjqKExEAvJzlxgV07,G8EPVSXsOYB5YQWZGiz1aVq5Pgr2GrQu,4,2,1,0,1,0,1,0,5,0.7142857142857143,1,0.0,0,1,0,1,2,0,0,1,0,2,3,1
6619,183151,mXfwwTIVjHMqoVKAh2iEQbinKUCJHwTp,RXDvfPUBYFlVdlueBFbLW0mhhAyGEqpt,1,0,0,0,0,0,1,0,1,0.14285714285714285,1,0.0,0,0,0,0,0,0,0,1,0,0,1,1
6620,183153,meaga1KCWxPmzsqVBplIkGxQedzxaUD2,bWdj2GDclj5ofokWjzoa5jAwMkxCykd6,7,3,2,0,2,0,2,0,9,1.2857142857142858,1,0.0,0,2,0,2,3,0,0,2,0,4,5,1
6621,183156,BWYYcHsqCzhUpDFvLBDv5oyoAjPbY2ao,G8EPVSXsOYB5YQWZGiz1aVq5Pgr2GrQu,6,1,1,0,1,0,3,0,6,0.8571428571428571,1,0.0,0,1,0,1,1,0,0,3,0,2,4,1
6622,183166,1vUHALYrvSKjWqmr07cdKDwJ3ETsWONf,G8EPVSXsOYB5YQWZGiz1aVq5Pgr2GrQu,8,12,6,0,0,0,4,0,22,3.142857142857143,1,0.0,0,6,0,0,12,0,0,4,0,6,16,1
6623,183167,98I0uRRrxrvjOLcZ6vxnPf4VwE1fUSbw,SpATywNh6bZuzm8s1ceuBUnMUAeoAHHw,10,7,5,0,3,1,4,0,20,2.857142857142857,1,0.0,0,5,0,3,7,1,0,4,0,8,12,1
6624,183169,Ha83qom95SRdPZQ3GDUlHj6Txt7HaICx,RXDvfPUBYFlVdlueBFbLW0mhhAyGEqpt,5,1,0,0,0,0,3,1,5,0.7142857142857143,1,0.0,0,0,0,0,1,0,0,3,1,0,5,1
6625,183171,uWoWmi6BUckUwLrnQ5aAr8mNZ3FhCJCq,bWdj2GDclj5ofokWjzoa5jAwMkxCykd6,6,6,1,6,2,0,3,0,18,2.5714285714285716,1,0.0,4,1,6,2,2,0,0,3,0,13,5,1
6626,183175,uWoWmi6BUckUwLrnQ5aAr8mNZ3FhCJCq,SpATywNh6bZuzm8s1ceuBUnMUAeoAHHw,13,19,6,17,3,0,1,0,46,6.571428571428571,1,0.0,11,6,15,3,8,0,2,1,0,35,11,1
6627,183176,vmxFgUyErGGqygNyLIYogRrMCWwWAOsK,SpATywNh6bZuzm8s1ceuBUnMUAeoAHHw,3,0,0,0,0,0,2,1,3,0.42857142857142855,1,0.0,0,0,0,0,0,0,0,2,1,0,3,1
6628,183179,cBEtpnUSjx0dg8glJzii42d18FEs4ecN,bWdj2GDclj5ofokWjzoa5jAwMkxCykd6,4,2,1,0,1,0,1,0,5,0.7142857142857143,1,0.0,0,1,0,1,2,0,0,1,0,2,3,1
6629,183185,6UfIu5SKHPYfwZxBxJpGSqhLHKhbdsl0,RXDvfPUBYFlVdlueBFbLW0mhhAyGEqpt,6,4,3,0,0,0,3,0,10,1.4285714285714286,1,0.0,0,3,0,0,4,0,0,3,0,3,7,1
6630,183195,ZUG5m2QmH8RqkCO5a89mIgt4zubZUyS0,SpATywNh6bZuzm8s1ceuBUnMUAeoAHHw,6,0,0,0,0,6,6,1,13,1.8571428571428572,1,0.0,0,0,0,0,0,6,0,6,1,0,13,1
6631,183205,rtxwCWIEQDwTZ37mLeJaxSUkUCTNLEOP,SpATywNh6bZuzm8s1ceuBUnMUAeoAHHw,9,6,3,0,1,0,5,2,17,2.4285714285714284,1,0.0,0,3,0,1,6,0,0,5,2,4,13,1
6632,183228,EnOE2zcU3adIQka8zXE5uaDcwrIceQaF,SpATywNh6bZuzm8s1ceuBUnMUAeoAHHw,15,8,5,16,4,11,5,1,50,7.142857142857143,1,0.0,2,5,14,4,6,11,2,5,1,25,25,1
6633,183230,RYd1k9DojojPZwrkV3NjsTI5OdZnPV9W,bWdj2GDclj5ofokWjzoa5jAwMkxCykd6,6,12,0,0,1,0,4,0,17,2.4285714285714284,1,0.0,0,0,0,1,12,0,0,4,0,1,16,1
6634,183232,7RSTSE7CX0EZRW2RDRnKS7CJkHtK7gJx,SpATywNh6bZuzm8s1ceuBUnMUAeoAHHw,5,3,2,0,1,0,2,0,8,1.1428571428571428,1,0.0,0,2,0,1,3,0,0,2,0,3,5,1
6635,183236,DIfj5Ba2axfDE4LFDWqKjVBCgesW8XXW,bWdj2GDclj5ofokWjzoa5jAwMkxCykd6,1,0,0,0,0,0,2,0,2,0.2857142857142857,1,0.0,0,0,0,0,0,0,0,2,0,0,2,1
6636,183238,L44FpqBwTo2JSXh1jKpzwO4TUp5s63E0,SpATywNh6bZuzm8s1ceuBUnMUAeoAHHw,5,2,1,0,1,0,2,0,6,0.8571428571428571,1,0.0,0,1,0,1,2,0,0,2,0,2,4,1
6637,183250,zvOHbaUWjxRZ9zCYxYPMcUH4Ef5dE8Ae,SpATywNh6bZuzm8s1ceuBUnMUAeoAHHw,6,3,1,0,1,0,2,0,7,1.0,1,0.0,0,1,0,1,3,0,0,2,0,2,5,1
6638,183254,1EtDFoshTxvFPxLRYfA4KzHCN6a1sUab,RXDvfPUBYFlVdlueBFbLW0mhhAyGEqpt,8,8,5,0,2,2,2,0,19,2.7142857142857144,1,0.0,0,5,0,2,8,2,0,2,0,7,12,1
6639,183258,cwjdhzGq04zCTXyAv16dQv37UeRHYh5B,G8EPVSXsOYB5YQWZGiz1aVq5Pgr2GrQu,6,3,2,0,2,0,1,0,8,1.1428571428571428,1,0.0,0,2,0,2,3,0,0,1,0,4,4,1
6640,183260,5nq8zs9A2tdQgPir7vYvctaqXkR3aFiH,SpATywNh6bZuzm8s1ceuBUnMUAeoAHHw,12,17,2,15,1,0,5,0,40,5.714285714285714,1,0.0,6,2,13,1,11,0,2,5,0,22,18,1
6641,183265,QT9CjDkbeQDwB2YMvS9MmI6T8kS9zKHi,RXDvfPUBYFlVdlueBFbLW0mhhAyGEqpt,5,1,1,0,1,0,2,0,5,0.7142857142857143,1,0.0,0,1,0,1,1,0,0,2,0,2,3,1
6642,183267,9nmSiMdYrhU2xelQs2wN4VWDOzZHLs5V,G8EPVSXsOYB5YQWZGiz1aVq5Pgr2GrQu,1,0,0,0,0,0,1,0,1,0.14285714285714285,1,0.0,0,0,0,0,0,0,0,1,0,0,1,1
6643,183291,KA8RyaMJzO49U5Bg2GbjpW1mpD8UFvq1,bWdj2GDclj5ofokWjzoa5jAwMkxCykd6,1,0,0,0,0,0,1,0,1,0.14285714285714285,1,0.0,0,0,0,0,0,0,0,1,0,0,1,1
6644,183294,x0GEvwkvyx0g8nTyKguqj2gMY7vcYmyU,SpATywNh6bZuzm8s1ceuBUnMUAeoAHHw,6,3,1,0,1,0,2,0,7,1.0,1,0.0,0,1,0,1,3,0,0,2,0,2,5,1
6645,183297,11kDA8TSGRrd2fZeDsp1CDJVYBIctE55,RXDvfPUBYFlVdlueBFbLW0mhhAyGEqpt,6,6,4,0,1,0,1,0,12,1.7142857142857142,1,0.0,0,4,0,1,6,0,0,1,0,5,7,1
6646,183300,K6sgJjXLg94pFHcJsnQvREqPhcrsQGLq,SpATywNh6bZuzm8s1ceuBUnMUAeoAHHw,2,0,0,0,0,0,3,0,3,0.42857142857142855,1,0.0,0,0,0,0,0,0,0,3,0,0,3,1
6647,183306,uufXnXOfmStAymRAiMYAROVtj5hPlDvd,bWdj2GDclj5ofokWjzoa5jAwMkxCykd6,5,2,1,0,1,0,3,0,7,1.0,1,0.0,0,1,0,1,2,0,0,3,0,2,5,1
6648,183315,G77tKik9NyptRJFC9Rot5qsRZiF0D6mk,SpATywNh6bZuzm8s1ceuBUnMUAeoAHHw,6,6,3,0,2,0,2,0,13,1.8571428571428572,1,0.0,2,3,0,2,4,0,0,2,0,7,6,1
6649,183316,Dm8rUUBDQqhrTm6PWZMMnJPt5PSDMko0,G8EPVSXsOYB5YQWZGiz1aVq5Pgr2GrQu,3,2,0,0,0,1,2,0,5,0.7142857142857143,1,0.0,0,0,0,0,2,1,0,2,0,0,5,1
6650,183317,jTtPdqNIV0C6SwNZGMhf4DTx667U70VG,SpATywNh6bZuzm8s1ceuBUnMUAeoAHHw,12,21,0,18,0,13,5,2,59,8.428571428571429,1,0.0,4,0,15,0,17,13,3,5,2,19,40,1
6651,183319,olHirIGJLYzj8TwhRxe1Dm9DLgoQbNvO,SpATywNh6bZuzm8s1ceuBUnMUAeoAHHw,9,7,6,0,5,0,5,0,23,3.2857142857142856,1,0.0,0,6,0,5,7,0,0,5,0,11,12,1
6652,183340,0Vj24SN7QK68fxZGEj9b6pGHh8nTXfGG,bWdj2GDclj5ofokWjzoa5jAwMkxCykd6,1,0,0,0,0,0,1,0,1,0.14285714285714285,1,0.0,0,0,0,0,0,0,0,1,0,0,1,1
6653,183345,7QIKpGgitmD7tk807kQNY8RClDv3488Y,SpATywNh6bZuzm8s1ceuBUnMUAeoAHHw,5,2,1,0,1,1,2,1,8,1.1428571428571428,1,0.0,0,1,0,1,2,1,0,2,1,2,6,1
6654,183350,89IraAtUfhoGAQgzdMP1844g2s2iN4Ox,RXDvfPUBYFlVdlueBFbLW0mhhAyGEqpt,16,18,6,15,6,4,6,10,65,9.285714285714286,1,0.0,5,6,15,6,13,4,0,6,10,32,33,1
6655,183353,geebTbOsD2liuGCoIF7cu53Xft014LYQ,bWdj2GDclj5ofokWjzoa5jAwMkxCykd6,5,2,1,0,1,0,2,1,7,1.0,1,0.0,0,1,0,1,2,0,0,2,1,2,5,1
6656,183399,5e8eBFhY8m9197wxmtpeMKTT5Js0t5oX,SpATywNh6bZuzm8s1ceuBUnMUAeoAHHw,1,0,0,0,0,0,1,0,1,0.14285714285714285,1,0.0,0,0,0,0,0,0,0,1,0,0,1,1
6657,183400,dWLPd7W4XxJuKssPJAJlISLlvxj9YqGO,G8EPVSXsOYB5YQWZGiz1aVq5Pgr2GrQu,14,14,6,10,3,0,6,1,40,5.714285714285714,1,0.0,3,6,7,3,11,0,3,6,1,19,21,1
6658,183411,GO3MGrx4XteeFiOXpQf53F1doJGXYUJh,G8EPVSXsOYB5YQWZGiz1aVq5Pgr2GrQu,11,14,10,0,5,1,9,3,42,6.0,2,0.0,0,10,0,5,14,1,0,9,3,15,27,1
6659,183413,qvBe3rKX4kTO2XRpAwHefqsXVjGwcgVZ,SpATywNh6bZuzm8s1ceuBUnMUAeoAHHw,6,7,0,0,0,2,2,0,11,1.5714285714285714,1,0.0,3,0,0,0,4,2,0,2,0,3,8,1
6660,183416,orkcYdEVQqlH9SJjCRUiZ5P3bFy172XW,bWdj2GDclj5ofokWjzoa5jAwMkxCykd6,2,0,0,0,0,0,5,0,5,0.7142857142857143,2,0.0,0,0,0,0,0,0,0,5,0,0,5,1
6661,183434,OocLfrCOBb0PIIRDKMfTM554g3aeKj99,bWdj2GDclj5ofokWjzoa5jAwMkxCykd6,5,2,1,0,1,0,2,0,6,0.8571428571428571,1,0.0,0,1,0,1,2,0,0,2,0,2,4,1
6662,183441,AGnMVhenXKmXw34icDYbSubheSiHLlFC,bWdj2GDclj5ofokWjzoa5jAwMkxCykd6,1,0,0,0,0,0,1,0,1,0.14285714285714285,1,0.0,0,0,0,0,0,0,0,1,0,0,1,1
6663,183444,7OyOaefKbOX5xGdSnzdHd0CL6VXfEf8T,G8EPVSXsOYB5YQWZGiz1aVq5Pgr2GrQu,2,0,0,0,0,0,2,0,2,0.2857142857142857,1,0.0,0,0,0,0,0,0,0,2,0,0,2,1
6664,183447,IGdK3d2q4pwzeowbu1fnlncF2G0mIESt,SpATywNh6bZuzm8s1ceuBUnMUAeoAHHw,6,12,0,0,0,0,2,0,14,2.0,1,0.0,1,0,0,0,11,0,0,2,0,1,13,1
6665,183449,NhOj8NHtxbWRVl1n7CiUbpZQHLOfubek,RXDvfPUBYFlVdlueBFbLW0mhhAyGEqpt,13,16,2,0,1,21,12,1,53,7.571428571428571,1,0.0,0,2,0,1,16,21,0,12,1,3,50,1
6666,183460,zsosD9YlCDywhEUV3Vphbp3IXW8MeBYM,bWdj2GDclj5ofokWjzoa5jAwMkxCykd6,1,0,0,0,0,0,1,0,1,0.14285714285714285,1,0.0,0,0,0,0,0,0,0,1,0,0,1,1
6667,183476,069ftOw6ldZ1V3ipXwZemwIwoCreCmPS,G8EPVSXsOYB5YQWZGiz1aVq5Pgr2GrQu,16,15,5,36,3,0,1,0,60,8.571428571428571,1,0.0,9,5,27,3,6,0,9,1,0,44,16,1
6668,183481,zpoCbNcTK6iqE6Hm4JrK6lHIZV2VXvYX,SpATywNh6bZuzm8s1ceuBUnMUAeoAHHw,1,0,0,0,0,0,3,0,3,0.42857142857142855,1,0.0,0,0,0,0,0,0,0,3,0,0,3,1
6669,183488,kUJcgErkiF8AsEDKHMMLmp1H5MenUsXw,G8EPVSXsOYB5YQWZGiz1aVq5Pgr2GrQu,2,0,0,0,0,0,3,0,3,0.42857142857142855,1,0.0,0,0,0,0,0,0,0,3,0,0,3,1
6670,183500,fsFbJ8UrfADOZi56VOg1TSjQKQnG4WLk,RXDvfPUBYFlVdlueBFbLW0mhhAyGEqpt,8,5,0,0,0,0,3,0,8,1.1428571428571428,1,0.0,0,0,0,0,5,0,0,3,0,0,8,1
6671,183502,VtCUQBk0TlN0AJOAq0bEC4tTAH6HVrBA,SpATywNh6bZuzm8s1ceuBUnMUAeoAHHw,3,2,0,0,0,0,1,0,3,0.42857142857142855,1,0.0,0,0,0,0,2,0,0,1,0,0,3,1
6672,183514,f2GMLkjrqGdN19ysxF64zEiQj9fxR4cG,G8EPVSXsOYB5YQWZGiz1aVq5Pgr2GrQu,5,2,1,0,1,0,2,0,6,0.8571428571428571,1,0.0,0,1,0,1,2,0,0,2,0,2,4,1
6673,183527,66KnlNHw8D8zXFB0ktOwarKa6xDfCRsA,SpATywNh6bZuzm8s1ceuBUnMUAeoAHHw,2,0,0,0,0,0,2,0,2,0.2857142857142857,1,0.0,0,0,0,0,0,0,0,2,0,0,2,1
6674,183534,joi2hmNEoOCl0stUXbrsaehVDAdpUejn,SpATywNh6bZuzm8s1ceuBUnMUAeoAHHw,1,0,0,0,0,0,1,0,1,0.14285714285714285,1,0.0,0,0,0,0,0,0,0,1,0,0,1,1
6675,183537,GNsGzjFSidI9fBCvT9fI5F8kfuYTc1I2,RXDvfPUBYFlVdlueBFbLW0mhhAyGEqpt,13,16,9,0,3,0,7,1,36,5.142857142857143,2,0.0,2,9,0,3,14,0,0,7,1,14,22,0
6676,183541,gqy9Iq3u49oICISghrOoeZuPt4tAVyjr,SpATywNh6bZuzm8s1ceuBUnMUAeoAHHw,5,2,1,0,1,0,2,0,6,0.8571428571428571,1,0.0,0,1,0,1,2,0,0,2,0,2,4,1
6677,183543,RrZIh1Er4YeabEoYA6SJyDj40LWgHTn5,SpATywNh6bZuzm8s1ceuBUnMUAeoAHHw,6,2,0,0,0,0,5,0,7,1.0,1,0.0,0,0,0,0,2,0,0,5,0,0,7,1
6678,183549,oAjXymbDbd4Rt4XO0pdep7ez7kmoJtvA,bWdj2GDclj5ofokWjzoa5jAwMkxCykd6,2,0,0,0,0,0,2,0,2,0.2857142857142857,1,0.0,0,0,0,0,0,0,0,2,0,0,2,1
6679,183550,JaYbgvhgx43SysY9J8DaCR3IcdUzCcUf,bWdj2GDclj5ofokWjzoa5jAwMkxCykd6,4,4,1,0,0,0,2,0,7,1.0,2,0.0,0,1,0,0,4,0,0,2,0,1,6,1
6680,183552,tCPCenWlAqHKYLuxwQ692ECgp8ponIEe,SpATywNh6bZuzm8s1ceuBUnMUAeoAHHw,2,0,0,0,0,0,2,0,2,0.2857142857142857,1,0.0,0,0,0,0,0,0,0,2,0,0,2,1
6681,183560,539icBw2nmvBmBkzeMPm9mMNpWONyi1a,bWdj2GDclj5ofokWjzoa5jAwMkxCykd6,2,0,0,0,0,0,2,0,2,0.2857142857142857,1,0.0,0,0,0,0,0,0,0,2,0,0,2,1
6682,183569,iJJNhRwyvCNK6HRXY0B7B0PcxR090Rv4,SpATywNh6bZuzm8s1ceuBUnMUAeoAHHw,1,0,0,0,0,0,1,0,1,0.14285714285714285,1,0.0,0,0,0,0,0,0,0,1,0,0,1,1
6683,183570,mORy2uEWeq5FPaYREt08zxVhXzxOvG5x,SpATywNh6bZuzm8s1ceuBUnMUAeoAHHw,4,2,1,0,1,18,1,0,23,3.2857142857142856,1,0.0,0,1,0,1,2,18,0,1,0,2,21,1
6684,183579,hKd0tEZKHss60gUM0z43MBrDD3KnSpLX,SpATywNh6bZuzm8s1ceuBUnMUAeoAHHw,6,3,1,0,1,0,3,0,8,1.1428571428571428,1,0.0,0,1,0,1,3,0,0,3,0,2,6,1
6685,183585,bGVVh5mMYkn1gHW6CnpRuYzXwIcX6sC6,SpATywNh6bZuzm8s1ceuBUnMUAeoAHHw,6,1,1,0,1,1,3,1,8,1.1428571428571428,1,0.0,0,1,0,1,1,1,0,3,1,2,6,1
6686,183590,iwLRjFCEFjJtmNgQnRk4kXqxuLSCzbLr,SpATywNh6bZuzm8s1ceuBUnMUAeoAHHw,7,4,2,0,2,0,4,1,13,1.8571428571428572,1,0.0,1,2,0,2,3,0,0,4,1,5,8,1
6687,183603,yMScB1KMRz60XZtblJXZ7cOwpx8nYT9h,G8EPVSXsOYB5YQWZGiz1aVq5Pgr2GrQu,9,9,1,18,2,0,2,0,32,4.571428571428571,1,0.0,7,1,12,2,2,0,6,2,0,22,10,1
6688,183613,7jDyNmBRkEY6fNon9RWGerv8blE7YVJd,bWdj2GDclj5ofokWjzoa5jAwMkxCykd6,4,2,0,0,0,0,2,0,4,0.5714285714285714,1,0.0,0,0,0,0,2,0,0,2,0,0,4,1
6689,183614,x967IREOKVWVVneKjnOdD8ZruuMl1VE7,SpATywNh6bZuzm8s1ceuBUnMUAeoAHHw,9,21,9,0,7,0,3,0,40,5.714285714285714,1,0.0,1,9,0,7,20,0,0,3,0,17,23,1
6690,183624,Tfb5kzD9uzk4IFFKiGmgMSkZRj1tZ0K9,bWdj2GDclj5ofokWjzoa5jAwMkxCykd6,8,22,5,26,8,0,4,0,65,9.285714285714286,2,0.0,16,5,26,8,6,0,0,4,0,55,10,0
6691,183631,FbdmHwhDtQoDvNNbH5NO4UO0Yhp01nUq,SpATywNh6bZuzm8s1ceuBUnMUAeoAHHw,5,2,1,0,1,0,2,0,6,0.8571428571428571,1,0.0,0,1,0,1,2,0,0,2,0,2,4,1
6692,183634,R4jzs50fuf1JavV9xGEb7vRBguxW8cYa,SpATywNh6bZuzm8s1ceuBUnMUAeoAHHw,8,13,6,0,2,1,4,0,26,3.7142857142857144,1,0.0,0,6,0,2,13,1,0,4,0,8,18,1
6693,183641,CAXYMnI26CJKVZLm27KWhrQ5wZxlWBLx,SpATywNh6bZuzm8s1ceuBUnMUAeoAHHw,5,6,1,0,1,0,1,0,9,1.2857142857142858,1,0.0,0,1,0,1,6,0,0,1,0,2,7,1
6694,183645,rzux1UjWNNs1GqyksFiTFp3NDiKcqZIA,SpATywNh6bZuzm8s1ceuBUnMUAeoAHHw,5,2,1,0,1,0,2,0,6,0.8571428571428571,1,0.0,0,1,0,1,2,0,0,2,0,2,4,1
6695,183649,tHouYbJheFPQJDK2n6XJK9jRREGEheXi,G8EPVSXsOYB5YQWZGiz1aVq5Pgr2GrQu,36,43,12,44,10,2,6,1,118,16.857142857142858,1,0.0,25,12,29,10,18,2,15,6,1,76,42,1
6696,183651,QP3bOKPbx70fYEywL9MXgcXTnFgBdqPj,SpATywNh6bZuzm8s1ceuBUnMUAeoAHHw,6,3,1,0,1,0,3,0,8,1.1428571428571428,1,0.0,0,1,0,1,3,0,0,3,0,2,6,1
6697,183655,Mbj5txvZRTAvPuGny65LvJcTeJZzO2Xr,SpATywNh6bZuzm8s1ceuBUnMUAeoAHHw,5,4,3,0,1,0,1,0,9,1.2857142857142858,1,0.0,0,3,0,1,4,0,0,1,0,4,5,1
6698,183664,o19vb57bgfx9sNjmUMNmIakP5nctIJ3O,bWdj2GDclj5ofokWjzoa5jAwMkxCykd6,5,4,0,0,0,0,2,0,6,0.8571428571428571,1,0.0,0,0,0,0,4,0,0,2,0,0,6,1
6699,183675,cpH6ushFbRO23LBN96kMSHMHQ5CDuqWx,SpATywNh6bZuzm8s1ceuBUnMUAeoAHHw,10,8,4,0,3,0,2,0,17,2.4285714285714284,1,0.0,3,4,0,3,5,0,0,2,0,10,7,1
6700,183689,tVDSRebDM9kj4eZBXWEp0omzaKHFumrl,SpATywNh6bZuzm8s1ceuBUnMUAeoAHHw,4,2,1,0,1,0,1,0,5,0.7142857142857143,1,0.0,0,1,0,1,2,0,0,1,0,2,3,1
6701,183698,o19vb57bgfx9sNjmUMNmIakP5nctIJ3O,G8EPVSXsOYB5YQWZGiz1aVq5Pgr2GrQu,1,0,0,0,0,0,1,0,1,0.14285714285714285,1,0.0,0,0,0,0,0,0,0,1,0,0,1,1
6702,183699,qjQ6GiU7sehnY7qaKKajZBfA0GV2t1bA,SpATywNh6bZuzm8s1ceuBUnMUAeoAHHw,5,2,0,0,1,0,2,0,5,0.7142857142857143,1,0.0,0,0,0,1,2,0,0,2,0,1,4,1
6703,183716,2hMeaUc14fgUG8b3kgXxN1xDYogexPXy,bWdj2GDclj5ofokWjzoa5jAwMkxCykd6,5,9,0,0,1,0,1,0,11,1.5714285714285714,1,0.0,3,0,0,1,6,0,0,1,0,4,7,1
6704,183718,Lf0mThPYOrtlCzgRGBCVTPy1hiGUII8h,bWdj2GDclj5ofokWjzoa5jAwMkxCykd6,7,2,1,0,1,0,4,0,8,1.1428571428571428,1,0.0,0,1,0,1,2,0,0,4,0,2,6,1
6705,183726,hB6lALXH4sMaj6Hr4qOJgZbelF7wY5ML,SpATywNh6bZuzm8s1ceuBUnMUAeoAHHw,5,2,1,0,1,0,2,0,6,0.8571428571428571,1,0.0,0,1,0,1,2,0,0,2,0,2,4,1
6706,183734,bUWUvqWKJBmYgRNIoWQO6VIVyvpJs3GG,bWdj2GDclj5ofokWjzoa5jAwMkxCykd6,14,16,6,16,2,0,3,0,43,6.142857142857143,1,0.0,3,6,14,2,13,0,2,3,0,25,18,1
6707,183736,CJjWj5QSoyqJ23EMwHZtEX525JWA2E7K,SpATywNh6bZuzm8s1ceuBUnMUAeoAHHw,5,2,1,0,1,0,2,0,6,0.8571428571428571,1,0.0,0,1,0,1,2,0,0,2,0,2,4,1
6708,183737,EEKM5fD1OwESnar1FjU8hxj0L9tVWx44,RXDvfPUBYFlVdlueBFbLW0mhhAyGEqpt,10,9,1,0,1,5,2,0,18,2.5714285714285716,1,0.0,0,1,0,1,9,5,0,2,0,2,16,1
6709,183740,e1dzN81UKTvb4PNCErZLbC2uYa0wPNos,SpATywNh6bZuzm8s1ceuBUnMUAeoAHHw,6,5,2,0,2,0,1,0,10,1.4285714285714286,1,0.0,0,2,0,2,5,0,0,1,0,4,6,1
6710,183743,Tkxf1Z89UY3ofefoIUKYhYMqhRZ3ElpY,SpATywNh6bZuzm8s1ceuBUnMUAeoAHHw,1,0,0,0,0,0,1,0,1,0.14285714285714285,1,0.0,0,0,0,0,0,0,0,1,0,0,1,1
6711,183755,5UWxjYJaVNtau37O89p9sB7M5HwhMo3z,bWdj2GDclj5ofokWjzoa5jAwMkxCykd6,1,0,0,0,0,0,1,0,1,0.14285714285714285,1,0.0,0,0,0,0,0,0,0,1,0,0,1,1
6712,183759,NplT7OhnAZOp9hCAdGLFNwSMTc3LAhF2,G8EPVSXsOYB5YQWZGiz1aVq5Pgr2GrQu,23,32,6,38,4,0,2,0,82,11.714285714285714,1,0.0,23,6,23,4,9,0,15,2,0,56,26,1
6713,183766,bY2gh2mIojoS37RuKr0mq0gh4QBiW0z8,G8EPVSXsOYB5YQWZGiz1aVq5Pgr2GrQu,11,18,5,16,2,3,2,0,46,6.571428571428571,1,0.0,10,5,14,2,8,3,2,2,0,31,15,1
6714,183781,HL5HEUPq5k60nwiHmjiz48idVIW7iDWP,SpATywNh6bZuzm8s1ceuBUnMUAeoAHHw,5,2,1,0,1,0,2,0,6,0.8571428571428571,1,0.0,0,1,0,1,2,0,0,2,0,2,4,1
6715,183784,QzFNcWcdt9jKMCztuclgA8fbidhRkaqv,SpATywNh6bZuzm8s1ceuBUnMUAeoAHHw,7,6,0,0,0,0,13,1,20,2.857142857142857,1,0.0,0,0,0,0,6,0,0,13,1,0,20,1
6716,183796,MhvviuZNTmfoceElB9BVHo0GzJkIAz9b,G8EPVSXsOYB5YQWZGiz1aVq5Pgr2GrQu,7,6,2,0,2,0,1,0,11,1.5714285714285714,1,0.0,0,2,0,2,6,0,0,1,0,4,7,1
6717,183800,4T6e9tf501hupPEmmZRZG7Lv5vYmRX6i,SpATywNh6bZuzm8s1ceuBUnMUAeoAHHw,6,4,3,0,3,0,1,0,11,1.5714285714285714,1,0.0,0,3,0,3,4,0,0,1,0,6,5,1
6718,183802,4Y8z1fVuk8HPWGVOteuQwAFNrdo0CBpu,SpATywNh6bZuzm8s1ceuBUnMUAeoAHHw,1,0,0,0,0,0,2,0,2,0.2857142857142857,1,0.0,0,0,0,0,0,0,0,2,0,0,2,1
6719,183805,6Ysh3EXeoiNCd1uXxsjEQronkryNKRU5,RXDvfPUBYFlVdlueBFbLW0mhhAyGEqpt,1,0,0,0,0,0,1,0,1,0.14285714285714285,1,0.0,0,0,0,0,0,0,0,1,0,0,1,1
6720,183808,cLRv4oHsLxWfkE6gs4eN6fO5y0RK8Odw,G8EPVSXsOYB5YQWZGiz1aVq5Pgr2GrQu,6,4,2,0,1,0,4,0,11,1.5714285714285714,1,0.0,0,2,0,1,4,0,0,4,0,3,8,1
6721,183822,OuPUar7X5BJymhikUDnyE5tFiUVuL09j,bWdj2GDclj5ofokWjzoa5jAwMkxCykd6,4,2,1,0,1,0,1,0,5,0.7142857142857143,1,0.0,0,1,0,1,2,0,0,1,0,2,3,1
6722,183839,yzbVurZnZZ3LzSESEDTD8mBP09kqyBBh,G8EPVSXsOYB5YQWZGiz1aVq5Pgr2GrQu,5,2,1,0,0,0,4,0,7,1.0,1,0.0,0,1,0,0,2,0,0,4,0,1,6,1
6723,183842,e3vAZGPddv8GG7o51Df54H5d3GJcihRZ,G8EPVSXsOYB5YQWZGiz1aVq5Pgr2GrQu,5,2,1,0,1,0,2,0,6,0.8571428571428571,1,0.0,0,1,0,1,2,0,0,2,0,2,4,1
6724,183843,KqeR1ihSDa1Ej9nVqHYeUS5y6oETFEfM,bWdj2GDclj5ofokWjzoa5jAwMkxCykd6,4,2,0,0,1,0,1,0,4,0.5714285714285714,1,0.0,0,0,0,1,2,0,0,1,0,1,3,1
6725,183850,N9VYkIRf4aydaM9gnOlftZxNGDW8I3Zp,SpATywNh6bZuzm8s1ceuBUnMUAeoAHHw,5,6,3,0,1,1,3,0,14,2.0,3,0.0,0,3,0,1,6,1,0,3,0,4,10,1
6726,183851,ls613vLH6fBQyqRMeuiCg3ot5Tyb4DDz,RXDvfPUBYFlVdlueBFbLW0mhhAyGEqpt,1,0,0,0,0,0,1,0,1,0.14285714285714285,1,0.0,0,0,0,0,0,0,0,1,0,0,1,1
6727,183852,NyPL3YppErvC9cRYCzI4gxKdO7060UB2,SpATywNh6bZuzm8s1ceuBUnMUAeoAHHw,4,2,1,0,0,0,2,0,5,0.7142857142857143,1,0.0,0,1,0,0,2,0,0,2,0,1,4,1
6728,183854,3aJcxnpBDknIFELx5q7A1ed9nLB6csNj,bWdj2GDclj5ofokWjzoa5jAwMkxCykd6,3,3,0,0,0,0,1,0,4,0.5714285714285714,1,0.0,0,0,0,0,3,0,0,1,0,0,4,1
6729,183856,PN6HDAlC1c0mDwWmACSk2v8uGfyNjwaH,SpATywNh6bZuzm8s1ceuBUnMUAeoAHHw,5,1,1,0,1,0,2,0,5,0.7142857142857143,1,0.0,0,1,0,1,1,0,0,2,0,2,3,1
6730,183857,xaz3R9QEFJxcfadxPNec99QMlGTDEIiY,SpATywNh6bZuzm8s1ceuBUnMUAeoAHHw,16,20,6,24,5,7,5,1,68,9.714285714285714,1,0.0,12,6,21,5,8,7,3,5,1,44,24,1
6731,183870,56VZldyBA7sJdFNsW4uyCbKalKBMfJny,SpATywNh6bZuzm8s1ceuBUnMUAeoAHHw,5,3,0,0,0,0,4,0,7,1.0,1,0.0,0,0,0,0,3,0,0,4,0,0,7,1
6732,183872,KLhUlREKq0O2xglSDOcFfaFp54qACtHM,SpATywNh6bZuzm8s1ceuBUnMUAeoAHHw,1,0,0,0,0,0,1,0,1,0.14285714285714285,1,0.0,0,0,0,0,0,0,0,1,0,0,1,1
6733,183875,fgQYCS5dRFsryAHcjDowcgqd9vNhjm9J,SpATywNh6bZuzm8s1ceuBUnMUAeoAHHw,6,7,0,0,0,0,2,0,9,1.2857142857142858,1,0.0,0,0,0,0,7,0,0,2,0,0,9,1
6734,183886,jhJPaGwU7dqU4ZwAVfiDn0qBdh771kri,G8EPVSXsOYB5YQWZGiz1aVq5Pgr2GrQu,15,66,32,50,17,0,2,0,167,23.857142857142858,1,0.0,0,32,47,17,66,0,3,2,0,96,71,1
6735,183895,HdOvDLzexKNSAsc0DtnaPUszT8VuZf1r,SpATywNh6bZuzm8s1ceuBUnMUAeoAHHw,7,3,2,0,2,0,3,0,10,1.4285714285714286,1,0.0,0,2,0,2,3,0,0,3,0,4,6,1
6736,183899,BDTbCzD1BP0Zvh6WPG7fuO5jLB3vSWaq,SpATywNh6bZuzm8s1ceuBUnMUAeoAHHw,4,2,1,0,1,0,1,0,5,0.7142857142857143,1,0.0,0,1,0,1,2,0,0,1,0,2,3,1
6737,183909,hpKSHIi4bRo1DEIvbfvzcRke2iP1vwgF,RXDvfPUBYFlVdlueBFbLW0mhhAyGEqpt,5,6,4,0,1,0,2,0,13,1.8571428571428572,1,0.0,0,4,0,1,6,0,0,2,0,5,8,1
6738,183910,52QsTv4Uo7nj5fP154PK0QEBA8xMFRXc,G8EPVSXsOYB5YQWZGiz1aVq5Pgr2GrQu,10,15,1,10,1,0,3,0,30,4.285714285714286,2,0.0,9,1,7,1,6,0,3,3,0,18,12,1
6739,183919,5BY2554FQkXzWEII8U25cUr1TyLfBPj6,RXDvfPUBYFlVdlueBFbLW0mhhAyGEqpt,5,2,1,0,0,0,3,0,6,0.8571428571428571,1,0.0,0,1,0,0,2,0,0,3,0,1,5,1
6740,183923,2HllbOBswZcfya5rDzlXYMHVB93oWjxb,bWdj2GDclj5ofokWjzoa5jAwMkxCykd6,1,0,0,0,0,0,1,0,1,0.14285714285714285,1,0.0,0,0,0,0,0,0,0,1,0,0,1,1
6741,183926,DiwcwcqzaE6lFsZWpJEHbAW7aioGreHg,SpATywNh6bZuzm8s1ceuBUnMUAeoAHHw,8,3,2,0,2,0,4,0,11,1.5714285714285714,1,0.0,0,2,0,2,3,0,0,4,0,4,7,1
6742,183935,oFr2hzwQRg7T6VDIxFir4OUQxI2WAOox,SpATywNh6bZuzm8s1ceuBUnMUAeoAHHw,6,5,1,0,0,0,2,0,8,1.1428571428571428,1,0.0,0,1,0,0,5,0,0,2,0,1,7,1
6743,183947,3SCBHiEI4HvwPrOQDNTIAqp1rZOAx5IK,RXDvfPUBYFlVdlueBFbLW0mhhAyGEqpt,4,2,1,0,1,0,1,0,5,0.7142857142857143,1,0.0,0,1,0,1,2,0,0,1,0,2,3,1
6744,183950,9ihleSS6gtfYUO7B3tfCDZConGdOxWz6,SpATywNh6bZuzm8s1ceuBUnMUAeoAHHw,7,3,0,0,0,0,4,0,7,1.0,1,0.0,0,0,0,0,3,0,0,4,0,0,7,1
6745,183952,ojd6JmvYlEsNwy0j8rsyD9P7isML33mP,SpATywNh6bZuzm8s1ceuBUnMUAeoAHHw,7,3,2,0,2,0,3,0,10,1.4285714285714286,1,0.0,0,2,0,2,3,0,0,3,0,4,6,1
6746,183958,5cpP5I4qy02g5JK1VuduuXdg8Frcarq0,SpATywNh6bZuzm8s1ceuBUnMUAeoAHHw,5,2,1,0,1,0,3,0,7,1.0,1,0.0,0,1,0,1,2,0,0,3,0,2,5,1
6747,183969,xZnb7uXmxIWQ7sisovgxwTXG7X7Be4Tl,bWdj2GDclj5ofokWjzoa5jAwMkxCykd6,11,15,7,8,2,10,8,1,51,7.285714285714286,1,0.0,2,7,6,2,13,10,2,8,1,17,34,1
6748,183973,qQ4S9PtUViLcUYCg7MK0igZg7IO7I0HK,SpATywNh6bZuzm8s1ceuBUnMUAeoAHHw,4,3,0,0,0,0,2,0,5,0.7142857142857143,1,0.0,0,0,0,0,3,0,0,2,0,0,5,1
6749,183988,qgG4OU0HRuoi21bBKmy9fO5g8h7KcP6E,RXDvfPUBYFlVdlueBFbLW0mhhAyGEqpt,20,16,7,18,7,0,8,0,56,8.0,1,0.0,8,7,16,7,8,0,2,8,0,38,18,1
6750,183997,FZXhILo2dZIp84xBqa5ZKNF9O2Wx35MO,SpATywNh6bZuzm8s1ceuBUnMUAeoAHHw,2,0,0,0,0,0,2,0,2,0.2857142857142857,1,0.0,0,0,0,0,0,0,0,2,0,0,2,1
6751,184003,ZqhWTPWWREP1gJARqRhQXMYloraIQQwo,SpATywNh6bZuzm8s1ceuBUnMUAeoAHHw,5,5,3,0,0,0,2,0,10,1.4285714285714286,2,0.0,0,3,0,0,5,0,0,2,0,3,7,1
6752,184008,UJHNe0sYjldvLe2oh1mb1WNNcWhYLg5J,SpATywNh6bZuzm8s1ceuBUnMUAeoAHHw,1,0,0,0,0,0,1,0,1,0.14285714285714285,1,0.0,0,0,0,0,0,0,0,1,0,0,1,1
6753,184017,m4zdr76CpU472F6wsJffFbslI27LpI4g,bWdj2GDclj5ofokWjzoa5jAwMkxCykd6,4,2,1,0,1,0,5,0,9,1.2857142857142858,2,0.0,0,1,0,1,2,0,0,5,0,2,7,1
6754,184024,h774wdF6vIIcl50Js74gckwUtlv9SBGH,G8EPVSXsOYB5YQWZGiz1aVq5Pgr2GrQu,8,14,5,0,4,0,3,0,26,3.7142857142857144,1,0.0,6,5,0,4,8,0,0,3,0,15,11,1
6755,184025,rXd7sBSm51uTyzv9MhrGYApbktwAzsFy,SpATywNh6bZuzm8s1ceuBUnMUAeoAHHw,3,3,1,0,0,0,1,0,5,0.7142857142857143,1,0.0,0,1,0,0,3,0,0,1,0,1,4,1
6756,184027,iu7Na8oZcPlYaVeI8FJk9aKFI4xc19c4,G8EPVSXsOYB5YQWZGiz1aVq5Pgr2GrQu,4,0,0,0,0,1,3,0,4,0.5714285714285714,1,0.0,0,0,0,0,0,1,0,3,0,0,4,1
6757,184029,CrwOvQpdA842UJZ7DoCSM957jMvz9EeO,SpATywNh6bZuzm8s1ceuBUnMUAeoAHHw,6,3,2,0,2,0,1,0,8,1.1428571428571428,1,0.0,0,2,0,2,3,0,0,1,0,4,4,1
6758,184046,5kCR1wjWWz9eEHdizA4crFyxKTH4mIdl,SpATywNh6bZuzm8s1ceuBUnMUAeoAHHw,7,7,2,0,1,0,4,0,14,2.0,1,0.0,2,2,0,1,5,0,0,4,0,5,9,1
6759,184054,dcJH2SRBlozVvsUdEPFKC47IdUh8xpq7,SpATywNh6bZuzm8s1ceuBUnMUAeoAHHw,16,20,9,12,5,4,13,1,64,9.142857142857142,1,0.0,8,9,9,5,12,4,3,13,1,31,33,1
6760,184080,Q0ABMzqV4ZKePGWKS9YO1g6VONZhZLgg,RXDvfPUBYFlVdlueBFbLW0mhhAyGEqpt,13,12,6,25,0,0,1,0,44,6.285714285714286,1,0.0,4,6,21,0,8,0,4,1,0,31,13,0
6761,184093,NslicJCNMxB9cZhzoMFtRxmqPnqyw5Ii,RXDvfPUBYFlVdlueBFbLW0mhhAyGEqpt,5,2,1,0,1,0,2,0,6,0.8571428571428571,1,0.0,0,1,0,1,2,0,0,2,0,2,4,1
6762,184099,jb1WJE68F4yEoD652bth3JuHIrLPIvo8,SpATywNh6bZuzm8s1ceuBUnMUAeoAHHw,8,7,2,0,1,0,5,0,15,2.142857142857143,1,0.0,0,2,0,1,7,0,0,5,0,3,12,1
6763,184108,Jr0wwW2Pnso55z8kcFx2vv1KjdLnz1KD,bWdj2GDclj5ofokWjzoa5jAwMkxCykd6,2,0,0,0,0,0,2,0,2,0.2857142857142857,1,0.0,0,0,0,0,0,0,0,2,0,0,2,1
6764,184121,fqQqpuKLzyQIMrl6XKL3tfcygq4Er6K5,bWdj2GDclj5ofokWjzoa5jAwMkxCykd6,1,0,0,0,0,0,1,0,1,0.14285714285714285,1,0.0,0,0,0,0,0,0,0,1,0,0,1,1
6765,184128,vQs4K4jFbbnMTWF8mXp4DI5eKN8aBPM9,SpATywNh6bZuzm8s1ceuBUnMUAeoAHHw,9,6,3,0,2,0,4,1,16,2.2857142857142856,2,0.0,0,3,0,2,6,0,0,4,1,5,11,1
6766,184130,hHVyNQkfLcybgeO1W2xMmju5SBV0vBkh,SpATywNh6bZuzm8s1ceuBUnMUAeoAHHw,7,6,3,0,2,0,3,0,14,2.0,1,0.0,0,3,0,2,6,0,0,3,0,5,9,1
6767,184135,01vp16vMBdfdzNflK84lEgGXfBDKyb7S,bWdj2GDclj5ofokWjzoa5jAwMkxCykd6,8,6,4,0,2,0,5,0,17,2.4285714285714284,2,0.0,0,4,0,2,6,0,0,5,0,6,11,1
6768,184139,87SYGQjFYUtEWda0pG12bcNker0JGBy3,bWdj2GDclj5ofokWjzoa5jAwMkxCykd6,10,10,0,12,0,2,5,1,30,4.285714285714286,1,0.0,3,0,12,0,7,2,0,5,1,15,15,1
6769,184140,erOlfnGmmzlHYZTaWMuJdUpNjOjYMpjJ,G8EPVSXsOYB5YQWZGiz1aVq5Pgr2GrQu,16,15,15,0,0,0,3,0,33,4.714285714285714,1,0.0,0,15,0,0,15,0,0,3,0,15,18,1
6770,184141,rhwYpyX6KgM0VDKsxgisgjFhLGxmCQNh,SpATywNh6bZuzm8s1ceuBUnMUAeoAHHw,10,5,3,0,3,0,3,0,14,2.0,1,0.0,0,3,0,3,5,0,0,3,0,6,8,1
6771,184159,grKJZKhbDMTJWn0gJUYvmKRwIdpcuPd3,SpATywNh6bZuzm8s1ceuBUnMUAeoAHHw,1,0,0,0,0,0,1,0,1,0.14285714285714285,1,0.0,0,0,0,0,0,0,0,1,0,0,1,1
6772,184162,wrzzafNhG6GCvwxPDE3fRWCo6aRW8DwL,SpATywNh6bZuzm8s1ceuBUnMUAeoAHHw,7,3,2,0,2,0,3,0,10,1.4285714285714286,1,0.0,0,2,0,2,3,0,0,3,0,4,6,1
6773,184177,OOKe107tRCXEu4JY5tmAfF1YLRgWymlM,SpATywNh6bZuzm8s1ceuBUnMUAeoAHHw,7,2,1,0,1,0,4,1,9,1.2857142857142858,1,0.0,0,1,0,1,2,0,0,4,1,2,7,1
6774,184186,VVnP6JrqXx0kcUSjOpF3nGJjlaJ7pttn,RXDvfPUBYFlVdlueBFbLW0mhhAyGEqpt,6,3,2,0,2,4,2,0,13,1.8571428571428572,1,0.0,0,2,0,2,3,4,0,2,0,4,9,1
6775,184196,fz9iMau4c5Sc5pf7Ev3deQnz7r6jSD21,bWdj2GDclj5ofokWjzoa5jAwMkxCykd6,7,4,2,0,1,3,4,0,14,2.0,1,0.0,0,2,0,1,4,3,0,4,0,3,11,1
6776,184198,T5b4rlcXzzOiQabsmSU227C710oPv1q6,SpATywNh6bZuzm8s1ceuBUnMUAeoAHHw,1,0,0,0,0,0,1,0,1,0.14285714285714285,1,0.0,0,0,0,0,0,0,0,1,0,0,1,1
6777,184200,fgbY9PHcmr11G1IYkEJJMMaayPBzrdUL,bWdj2GDclj5ofokWjzoa5jAwMkxCykd6,1,0,0,0,0,0,1,0,1,0.14285714285714285,1,0.0,0,0,0,0,0,0,0,1,0,0,1,1
6778,184206,6YsryIPZKCMdT9rBoswcMetX0bA1SxAS,G8EPVSXsOYB5YQWZGiz1aVq5Pgr2GrQu,1,0,0,0,0,0,1,0,1,0.14285714285714285,1,0.0,0,0,0,0,0,0,0,1,0,0,1,1
6779,185695,GeBQuszwSQRCopSsB1wYZb4YBk7b0Cp6,SpATywNh6bZuzm8s1ceuBUnMUAeoAHHw,5,4,3,0,0,0,2,0,9,1.2857142857142858,1,0.0,0,3,0,0,4,0,0,2,0,3,6,1
6780,185708,XKXeDYTx8c3NYYfheBcuxoUZV0qXomPt,RXDvfPUBYFlVdlueBFbLW0mhhAyGEqpt,7,2,1,0,1,0,4,0,8,1.1428571428571428,1,0.0,0,1,0,1,2,0,0,4,0,2,6,1
6781,185744,Az4YfhTihzekQWxQtUyhZcCNXF1QoO5A,A3fsA9Zfv1X2fVEQhTw51lKENdNrEqT3,2,0,0,0,0,0,2,0,2,0.2857142857142857,1,0.0,0,0,0,0,0,0,0,2,0,0,2,1
6782,185750,sJThH3sI3ghUBWEkkF5jl318HrGCcG4Q,SpATywNh6bZuzm8s1ceuBUnMUAeoAHHw,8,14,0,10,0,0,6,0,30,4.285714285714286,1,0.0,11,0,9,0,3,0,1,6,0,20,10,1
6783,185765,EcTOYzny90oltpyqEhmLnMxAbahxVt33,A3fsA9Zfv1X2fVEQhTw51lKENdNrEqT3,16,8,7,0,6,6,4,1,32,4.571428571428571,2,0.0,0,7,0,6,8,6,0,4,1,13,19,1
6784,185777,VDLlgOqW7FFpT6uHqFXXlnnZR1JOz0x8,G8EPVSXsOYB5YQWZGiz1aVq5Pgr2GrQu,2,0,0,0,0,0,2,0,2,0.2857142857142857,1,0.0,0,0,0,0,0,0,0,2,0,0,2,1
6785,185787,pX5xieCfpPW4jfU74i0ayJdMShXi7ShL,A3fsA9Zfv1X2fVEQhTw51lKENdNrEqT3,2,0,0,0,0,0,2,0,2,0.2857142857142857,1,0.0,0,0,0,0,0,0,0,2,0,0,2,1
6786,185791,OLSxCkluLildKVrVnzRIsj47tt9tVHj9,SpATywNh6bZuzm8s1ceuBUnMUAeoAHHw,1,0,0,0,0,0,1,0,1,0.14285714285714285,1,0.0,0,0,0,0,0,0,0,1,0,0,1,1
6787,185804,YxKCslAege9DFmBzH0U7gCkLRow3CW1P,SpATywNh6bZuzm8s1ceuBUnMUAeoAHHw,9,9,7,0,6,0,1,0,23,3.2857142857142856,1,0.0,1,7,0,6,8,0,0,1,0,14,9,1
6788,185828,IlZMDuyHlB01hS9oHYhp77XsI0vMQkwN,bWdj2GDclj5ofokWjzoa5jAwMkxCykd6,7,9,2,0,1,0,5,0,17,2.4285714285714284,2,0.0,0,2,0,1,9,0,0,5,0,3,14,1
6789,185840,9UxAqNYuBtvS2ppV37y5D8wZyoNAl3Em,bWdj2GDclj5ofokWjzoa5jAwMkxCykd6,9,22,7,0,6,0,7,12,54,7.714285714285714,1,0.0,7,7,0,6,15,0,0,7,12,20,34,1
6790,185842,gQqEJZs7B37MmzRexP5otRszUHd2KLYy,SpATywNh6bZuzm8s1ceuBUnMUAeoAHHw,14,11,7,3,4,0,2,0,27,3.857142857142857,1,0.0,2,7,3,4,9,0,0,2,0,16,11,1
6791,185845,nSUHoNpp8PQSdMavNp5bhwMOhBRAUKca,bWdj2GDclj5ofokWjzoa5jAwMkxCykd6,1,0,0,0,0,0,1,0,1,0.14285714285714285,1,0.0,0,0,0,0,0,0,0,1,0,0,1,1
6792,185855,mIK1AsuZnsKqFebwZwvDET5yr9oF0NY2,bWdj2GDclj5ofokWjzoa5jAwMkxCykd6,1,0,0,0,0,0,1,0,1,0.14285714285714285,1,0.0,0,0,0,0,0,0,0,1,0,0,1,1
6793,185864,eQeAZJfAlQDBFNhBayGkUGtYxXtMJqJ1,SpATywNh6bZuzm8s1ceuBUnMUAeoAHHw,11,6,5,0,3,0,6,0,20,2.857142857142857,1,0.0,0,5,0,3,6,0,0,6,0,8,12,1
6794,185868,KZ6GY3fLdtMBq5t6dJwyKZUQ4aE5PB3r,SpATywNh6bZuzm8s1ceuBUnMUAeoAHHw,11,16,1,18,0,0,5,0,40,5.714285714285714,1,0.0,10,1,17,0,6,0,1,5,0,28,12,1
6795,185871,TOGjSTNLmP1U3WLV68xOjR9qYmcLTX2F,bWdj2GDclj5ofokWjzoa5jAwMkxCykd6,4,2,1,0,1,0,1,0,5,0.7142857142857143,1,0.0,0,1,0,1,2,0,0,1,0,2,3,1
6796,185874,U6w2qwGH0WBMPRrilbl2Pu4q8r7wV2i5,RXDvfPUBYFlVdlueBFbLW0mhhAyGEqpt,4,2,1,0,1,0,2,0,6,0.8571428571428571,1,0.0,0,1,0,1,2,0,0,2,0,2,4,0
6797,185878,BCr2GOpOyeEKOuzlRV7PJCL1CEnRyr6Q,A3fsA9Zfv1X2fVEQhTw51lKENdNrEqT3,1,0,0,0,0,0,1,0,1,0.14285714285714285,1,0.0,0,0,0,0,0,0,0,1,0,0,1,1
6798,185900,mP0oq4UFI55XwGbomuLjnKyaYZ9Irhl8,SpATywNh6bZuzm8s1ceuBUnMUAeoAHHw,1,0,0,0,0,0,1,0,1,0.14285714285714285,1,0.0,0,0,0,0,0,0,0,1,0,0,1,1
6799,185906,3RLcNHh9pobwm6kdbgPM3yL4oOSbkTV7,bWdj2GDclj5ofokWjzoa5jAwMkxCykd6,11,8,3,12,2,1,10,3,39,5.571428571428571,1,0.0,1,3,11,2,7,1,1,10,3,17,22,1
6800,185913,JNo2rLqKe6aBGDwGzu8tXd13uOC5tEnq,A3fsA9Zfv1X2fVEQhTw51lKENdNrEqT3,11,8,7,0,0,0,7,0,22,3.142857142857143,1,0.0,0,7,0,0,8,0,0,7,0,7,15,0
6801,185916,AZzjcou5vNOE04RAMAJi2EeLUqqymRTr,SpATywNh6bZuzm8s1ceuBUnMUAeoAHHw,5,2,1,0,1,0,2,0,6,0.8571428571428571,1,0.0,0,1,0,1,2,0,0,2,0,2,4,1
6802,185958,brnRegHqgNF4oAtC7Z92Gvb6wNpNm0iX,SpATywNh6bZuzm8s1ceuBUnMUAeoAHHw,5,2,1,0,1,1,2,0,7,1.0,1,0.0,0,1,0,1,2,1,0,2,0,2,5,1
6803,185973,xpLT6AJby37iITmsTgKzOCviwStat3HT,RXDvfPUBYFlVdlueBFbLW0mhhAyGEqpt,23,38,26,42,16,0,7,0,129,18.428571428571427,3,0.0,3,26,36,16,35,0,6,7,0,81,48,1
6804,186015,IZAsMmFtzA3Z4w092UEvwBTSkmDLpELL,bWdj2GDclj5ofokWjzoa5jAwMkxCykd6,1,0,0,0,0,0,1,0,1,0.14285714285714285,1,0.0,0,0,0,0,0,0,0,1,0,0,1,1
6805,186026,CQWretzMoQOL7mDTUjZusG4cd4L6wPQK,G8EPVSXsOYB5YQWZGiz1aVq5Pgr2GrQu,8,7,5,0,4,0,3,0,19,2.7142857142857144,2,0.0,0,5,0,4,7,0,0,3,0,9,10,1
6806,186031,OrXQ89uxDLDCGqiuZJDaLKhVuW8wRjFm,SpATywNh6bZuzm8s1ceuBUnMUAeoAHHw,1,0,0,0,0,0,1,0,1,0.14285714285714285,1,0.0,0,0,0,0,0,0,0,1,0,0,1,1
6807,186032,q8cwoymgEO62c2PjNUcCMU666aFjaHHf,RXDvfPUBYFlVdlueBFbLW0mhhAyGEqpt,9,4,3,0,3,0,2,0,12,1.7142857142857142,1,0.0,0,3,0,3,4,0,0,2,0,6,6,0
6808,186036,3CK0J1tusVtSvx6F6S9RQr6rj3f2luQC,A3fsA9Zfv1X2fVEQhTw51lKENdNrEqT3,4,1,0,0,0,0,5,0,6,0.8571428571428571,2,0.0,0,0,0,0,1,0,0,5,0,0,6,1
6809,186037,l2J6DNpa2tfvVIbHf48MlgRXXDizR7ZU,RXDvfPUBYFlVdlueBFbLW0mhhAyGEqpt,21,21,2,26,1,0,1,0,51,7.285714285714286,1,0.0,4,2,24,1,17,0,2,1,0,31,20,1
6810,186043,pwdsR2guw7jGBDVAdaksGODr7uJoy6bJ,SpATywNh6bZuzm8s1ceuBUnMUAeoAHHw,1,0,0,0,0,0,1,0,1,0.14285714285714285,1,0.0,0,0,0,0,0,0,0,1,0,0,1,1
6811,186051,pwdsR2guw7jGBDVAdaksGODr7uJoy6bJ,bWdj2GDclj5ofokWjzoa5jAwMkxCykd6,1,0,0,0,0,0,1,0,1,0.14285714285714285,1,0.0,0,0,0,0,0,0,0,1,0,0,1,1
6812,186083,vbZxM4TDv9mGZl0HuTBLAdzQ0iLXNnWT,SpATywNh6bZuzm8s1ceuBUnMUAeoAHHw,7,4,2,0,2,0,2,0,10,1.4285714285714286,2,0.0,0,2,0,2,4,0,0,2,0,4,6,1
6813,186122,tzFDwEYPmJ3KvE5ftnVNKM2NcL054uAX,G8EPVSXsOYB5YQWZGiz1aVq5Pgr2GrQu,6,3,1,0,0,1,4,1,10,1.4285714285714286,1,0.0,0,1,0,0,3,1,0,4,1,1,9,1
6814,186142,JozaCp1AeR7tr4bIEFDuRD5emwNjHpcL,SpATywNh6bZuzm8s1ceuBUnMUAeoAHHw,7,4,0,0,0,10,3,0,17,2.4285714285714284,1,0.0,0,0,0,0,4,10,0,3,0,0,17,1
6815,186154,UY0l6TfHASkV3r4lAYBX1Kuh54Mk5Xfi,RXDvfPUBYFlVdlueBFbLW0mhhAyGEqpt,23,33,2,28,5,0,4,0,72,10.285714285714286,2,0.0,10,2,25,5,23,0,3,4,0,42,30,1
6816,186155,Xl8Tem8G8sPah3KAWnbWgv7GNqLZqPFw,RXDvfPUBYFlVdlueBFbLW0mhhAyGEqpt,1,0,0,0,0,0,1,0,1,0.14285714285714285,1,0.0,0,0,0,0,0,0,0,1,0,0,1,1
6817,186156,ujpnoFj9Sccm69HUxcPfoVG6MkkjyaiE,G8EPVSXsOYB5YQWZGiz1aVq5Pgr2GrQu,10,4,1,0,1,14,10,1,31,4.428571428571429,2,0.0,0,1,0,1,4,14,0,10,1,2,29,0
6818,186158,gHhm2qXabgimtxCoVqwGNu3GtN0RfHoU,G8EPVSXsOYB5YQWZGiz1aVq5Pgr2GrQu,6,2,1,0,1,0,4,0,8,1.1428571428571428,1,0.0,0,1,0,1,2,0,0,4,0,2,6,1
6819,186170,3ULN82Jhvo9A1lCK71PqFv86yozEWjuj,SpATywNh6bZuzm8s1ceuBUnMUAeoAHHw,10,8,5,0,3,0,2,0,18,2.5714285714285716,1,0.0,0,5,0,3,8,0,0,2,0,8,10,1
6820,186194,kQWd08MJREYjLYHoBUU4DknlUSMQ7cCV,SpATywNh6bZuzm8s1ceuBUnMUAeoAHHw,6,4,2,0,2,3,2,0,13,1.8571428571428572,1,0.0,0,2,0,2,4,3,0,2,0,4,9,1
6821,186196,POFpLFsQBaugY3YnnocJIKLsXXkLzRDf,SpATywNh6bZuzm8s1ceuBUnMUAeoAHHw,1,0,0,0,0,0,1,0,1,0.14285714285714285,1,0.0,0,0,0,0,0,0,0,1,0,0,1,1
6822,186198,v6v1hayEEXofBruMyo9TZ2ggXeu5UD3T,A3fsA9Zfv1X2fVEQhTw51lKENdNrEqT3,5,3,1,0,1,0,3,0,8,1.1428571428571428,1,0.0,0,1,0,1,3,0,0,3,0,2,6,1
6823,186211,Zc1PnahT9ISh4c9DBr5jGFkTq2VN1Ayy,G8EPVSXsOYB5YQWZGiz1aVq5Pgr2GrQu,11,14,8,10,3,2,1,0,38,5.428571428571429,1,0.0,5,8,7,3,9,2,3,1,0,23,15,1
6824,186222,vlarE7zCdES78rsfbZ9s0PTdwVr1rAk4,bWdj2GDclj5ofokWjzoa5jAwMkxCykd6,3,3,0,0,0,0,1,0,4,0.5714285714285714,1,0.0,0,0,0,0,3,0,0,1,0,0,4,1
6825,186224,MSWIy7wC5VROeIgPqQIhPQ6v5vOa7TXY,G8EPVSXsOYB5YQWZGiz1aVq5Pgr2GrQu,6,0,0,0,0,1,13,3,17,2.4285714285714284,1,0.0,0,0,0,0,0,1,0,13,3,0,17,1
6826,186246,UY0l6TfHASkV3r4lAYBX1Kuh54Mk5Xfi,A3fsA9Zfv1X2fVEQhTw51lKENdNrEqT3,35,32,1,62,1,0,14,5,115,16.428571428571427,2,0.0,7,1,56,1,25,0,6,14,5,65,50,1
6827,186252,6HmdNYWkOfKPcsSkwkqnh7uY2Gqe1cX7,SpATywNh6bZuzm8s1ceuBUnMUAeoAHHw,5,4,3,0,3,0,2,0,12,1.7142857142857142,2,0.0,0,3,0,3,4,0,0,2,0,6,6,1
6828,186255,vbQsfStPUAntkNJPXL2TWQHB0509Qjr7,A3fsA9Zfv1X2fVEQhTw51lKENdNrEqT3,3,0,0,0,0,0,4,0,4,0.5714285714285714,1,0.0,0,0,0,0,0,0,0,4,0,0,4,1
6829,186266,dehhpoRrM4rg7t676Y7qCiumWRV2WOzS,SpATywNh6bZuzm8s1ceuBUnMUAeoAHHw,1,0,0,0,0,0,1,0,1,0.14285714285714285,1,0.0,0,0,0,0,0,0,0,1,0,0,1,1
6830,186271,XAjd05OrffFBimg6dLsDVkG5Gjsx6XlT,A3fsA9Zfv1X2fVEQhTw51lKENdNrEqT3,1,0,0,0,0,0,1,0,1,0.14285714285714285,1,0.0,0,0,0,0,0,0,0,1,0,0,1,1
6831,186289,rkWpVW2n5cp9IeLZVRLQUrt1dID41LRY,SpATywNh6bZuzm8s1ceuBUnMUAeoAHHw,7,10,6,0,3,0,1,0,20,2.857142857142857,1,0.0,3,6,0,3,7,0,0,1,0,12,8,1
6832,186292,tWw75YIFgGadaRnkyPeGlfSVpk3ysa4L,A3fsA9Zfv1X2fVEQhTw51lKENdNrEqT3,5,3,1,0,1,0,1,0,6,0.8571428571428571,1,0.0,0,1,0,1,3,0,0,1,0,2,4,1
6833,186318,OSHDYiz33FI0tkAswcTI5uxK5gdfibj6,A3fsA9Zfv1X2fVEQhTw51lKENdNrEqT3,3,0,0,0,0,0,3,0,3,0.42857142857142855,1,0.0,0,0,0,0,0,0,0,3,0,0,3,1
6834,186319,8UDPY0GORYpQM3S1dtt5YkG0CDkJUfAi,SpATywNh6bZuzm8s1ceuBUnMUAeoAHHw,8,7,5,0,2,0,2,0,16,2.2857142857142856,1,0.0,0,5,0,2,7,0,0,2,0,7,9,1
6835,186332,SdUI7MFv1cY1lGHTqsLRYstBYRI0xIIR,SpATywNh6bZuzm8s1ceuBUnMUAeoAHHw,13,10,0,18,0,0,5,2,35,5.0,1,0.0,2,0,15,0,8,0,3,5,2,17,18,1
6836,186359,GMzSpgZQ6jzVsfHn8W8i83JsYNxnP00b,RXDvfPUBYFlVdlueBFbLW0mhhAyGEqpt,4,2,1,0,1,0,1,0,5,0.7142857142857143,1,0.0,0,1,0,1,2,0,0,1,0,2,3,1
6837,186375,uQzrox8H38SjXEhLoth5A55QRUWPEK46,G8EPVSXsOYB5YQWZGiz1aVq5Pgr2GrQu,7,4,1,0,1,0,3,0,9,1.2857142857142858,1,0.0,0,1,0,1,4,0,0,3,0,2,7,1
6838,186378,4lhCwJo7yYXKFlssNpVO8DZHuYKFBvLp,A3fsA9Zfv1X2fVEQhTw51lKENdNrEqT3,7,3,2,0,2,6,3,0,16,2.2857142857142856,1,0.0,0,2,0,2,3,6,0,3,0,4,12,1
6839,186398,59oEIRULxWLaLldaaHbqaw4nucIn93k4,G8EPVSXsOYB5YQWZGiz1aVq5Pgr2GrQu,5,2,1,0,1,0,2,0,6,0.8571428571428571,1,0.0,0,1,0,1,2,0,0,2,0,2,4,1
6840,186433,KZqJQBCdtksPSQ3TutEdK8fy0LKI4eut,RXDvfPUBYFlVdlueBFbLW0mhhAyGEqpt,1,0,0,0,0,0,1,0,1,0.14285714285714285,1,0.0,0,0,0,0,0,0,0,1,0,0,1,1
6841,186446,bIezVonf0N1LpjwByS1ltzDSkDe7OlG8,SpATywNh6bZuzm8s1ceuBUnMUAeoAHHw,12,19,10,0,3,1,9,2,44,6.285714285714286,1,0.0,0,10,0,3,19,1,0,9,2,13,31,1
6842,186457,LjhFDdYhdfVWWRFvrc4aNHUi5SD6clAR,bWdj2GDclj5ofokWjzoa5jAwMkxCykd6,4,2,1,0,1,0,1,0,5,0.7142857142857143,1,0.0,0,1,0,1,2,0,0,1,0,2,3,1
6843,186461,qIinMseAcQ8q8AFqNGAlgGp8FqmURvdC,bWdj2GDclj5ofokWjzoa5jAwMkxCykd6,6,3,0,0,0,0,4,0,7,1.0,1,0.0,0,0,0,0,3,0,0,4,0,0,7,1
6844,186471,T7YlTqIDVTZFYEYihxD1Zij5IkDsmVZP,SpATywNh6bZuzm8s1ceuBUnMUAeoAHHw,5,6,3,0,1,0,1,0,11,1.5714285714285714,1,0.0,2,3,0,1,4,0,0,1,0,6,5,1
6845,186475,qsPGhZXTxPpaTY2qxQgCzRxNrBA26TIJ,A3fsA9Zfv1X2fVEQhTw51lKENdNrEqT3,3,1,0,0,0,0,4,0,5,0.7142857142857143,1,0.0,0,0,0,0,1,0,0,4,0,0,5,1
6846,186479,FtIGPSLlLHlXJuNP4CbCwrQzSedZBL0g,SpATywNh6bZuzm8s1ceuBUnMUAeoAHHw,9,9,5,0,3,0,2,0,19,2.7142857142857144,1,0.0,3,5,0,3,6,0,0,2,0,11,8,1
6847,186490,V7rVXKT1jqsQDinfnUz1gk0ep5LdnCQz,SpATywNh6bZuzm8s1ceuBUnMUAeoAHHw,8,2,1,0,1,1,5,1,11,1.5714285714285714,1,0.0,0,1,0,1,2,1,0,5,1,2,9,1
6848,186493,htua1xywlnpsMMY7EJSOsurL86GI912X,bWdj2GDclj5ofokWjzoa5jAwMkxCykd6,3,3,1,0,0,0,1,0,5,0.7142857142857143,1,0.0,0,1,0,0,3,0,0,1,0,1,4,1
6849,186521,4BrXOKatej2Wdv61aLL3SraA7e0yYTLh,SpATywNh6bZuzm8s1ceuBUnMUAeoAHHw,2,0,0,0,0,0,2,0,2,0.2857142857142857,1,0.0,0,0,0,0,0,0,0,2,0,0,2,1
6850,186524,5pfeeYLWSB4wCSWnPZbrmiSBS3yXgMsk,SpATywNh6bZuzm8s1ceuBUnMUAeoAHHw,5,4,0,0,0,0,3,0,7,1.0,1,0.0,0,0,0,0,4,0,0,3,0,0,7,1
6851,186543,bJDihmOTOP8tzchQo3EmXDlLmnZksGMI,SpATywNh6bZuzm8s1ceuBUnMUAeoAHHw,1,0,0,0,0,0,1,0,1,0.14285714285714285,1,0.0,0,0,0,0,0,0,0,1,0,0,1,1
6852,186551,ITnBh4AcTaOdkBvoDVqj5ARkv2J54QTG,SpATywNh6bZuzm8s1ceuBUnMUAeoAHHw,7,2,1,0,1,0,6,1,11,1.5714285714285714,1,0.0,0,1,0,1,2,0,0,6,1,2,9,1
6853,186556,VIptmPegATK5qvvl8OyUabYRGHZdqxvU,SpATywNh6bZuzm8s1ceuBUnMUAeoAHHw,9,4,2,0,2,0,4,1,13,1.8571428571428572,1,0.0,1,2,0,2,3,0,0,4,1,5,8,1
6854,186563,itb7buqF5mtGNemnlGyYA2pmGWssLWjE,SpATywNh6bZuzm8s1ceuBUnMUAeoAHHw,10,6,4,0,3,0,3,0,16,2.2857142857142856,2,0.0,0,4,0,3,6,0,0,3,0,7,9,1
6855,186570,QZIRHdwFgibI2SBehTrmLAZxED1F4JL7,A3fsA9Zfv1X2fVEQhTw51lKENdNrEqT3,14,15,7,0,7,0,1,0,30,4.285714285714286,1,0.0,0,7,0,7,15,0,0,1,0,14,16,1
6856,186572,MYsCU1zkMrWxPhV1b7wSL5LZIo1zGyhU,SpATywNh6bZuzm8s1ceuBUnMUAeoAHHw,1,0,0,0,0,0,1,0,1,0.14285714285714285,1,0.0,0,0,0,0,0,0,0,1,0,0,1,1
6857,186585,4GCFGR3S6zyUaFCN0ANuEVdNqsmLUl3s,SpATywNh6bZuzm8s1ceuBUnMUAeoAHHw,14,43,2,16,0,17,25,3,106,15.142857142857142,2,0.0,14,2,14,0,29,17,2,25,3,30,76,1
6858,186591,ZUogtQULz2GfCq4cni0kVmwpD4O6JuwY,SpATywNh6bZuzm8s1ceuBUnMUAeoAHHw,8,6,1,6,0,0,2,0,15,2.142857142857143,1,0.0,1,1,5,0,5,0,1,2,0,7,8,1
6859,186592,UDgUCnq3QLzgpXlB51yXFWzxVoQqQtdJ,G8EPVSXsOYB5YQWZGiz1aVq5Pgr2GrQu,29,18,15,0,10,0,9,3,55,7.857142857142857,1,0.0,0,15,0,10,18,0,0,9,3,25,30,0
6860,186593,dFhW5phJnKOqlVjNkJknZ8QVATFpUOzD,bWdj2GDclj5ofokWjzoa5jAwMkxCykd6,2,0,0,0,0,0,3,0,3,0.42857142857142855,1,0.0,0,0,0,0,0,0,0,3,0,0,3,1
6861,186596,KZqJQBCdtksPSQ3TutEdK8fy0LKI4eut,bWdj2GDclj5ofokWjzoa5jAwMkxCykd6,1,0,0,0,0,0,1,0,1,0.14285714285714285,1,0.0,0,0,0,0,0,0,0,1,0,0,1,1
6862,186597,KZqJQBCdtksPSQ3TutEdK8fy0LKI4eut,A3fsA9Zfv1X2fVEQhTw51lKENdNrEqT3,1,0,0,0,0,0,1,0,1,0.14285714285714285,1,0.0,0,0,0,0,0,0,0,1,0,0,1,1
6863,186600,RCImAeGNpwksr5OoLexzhMJb9tVjxo1e,SpATywNh6bZuzm8s1ceuBUnMUAeoAHHw,1,0,0,0,0,0,1,0,1,0.14285714285714285,1,0.0,0,0,0,0,0,0,0,1,0,0,1,1
6864,186602,vavfgCcT5IuD68jWJDk0XbOVSfTIDT0M,G8EPVSXsOYB5YQWZGiz1aVq5Pgr2GrQu,7,11,0,0,0,0,6,1,18,2.5714285714285716,1,0.0,0,0,0,0,11,0,0,6,1,0,18,1
6865,186610,BOiGxHn3raRj9eGIKlFjQQHhXEBtSDbh,SpATywNh6bZuzm8s1ceuBUnMUAeoAHHw,2,0,0,0,0,0,2,0,2,0.2857142857142857,1,0.0,0,0,0,0,0,0,0,2,0,0,2,1
6866,186623,OyDMa8JOXSYbsE31qL3fL6emrgq0mwJU,SpATywNh6bZuzm8s1ceuBUnMUAeoAHHw,1,0,0,0,0,0,1,0,1,0.14285714285714285,1,0.0,0,0,0,0,0,0,0,1,0,0,1,1
6867,186635,MZdlzL4gO74etRlgkUDa9eGtQZo9ovTN,SpATywNh6bZuzm8s1ceuBUnMUAeoAHHw,1,0,0,0,0,0,1,0,1,0.14285714285714285,1,0.0,0,0,0,0,0,0,0,1,0,0,1,1
6868,186644,Rv6gVo5TL2yRLbTriDaWEPebl1P4Qs2d,A3fsA9Zfv1X2fVEQhTw51lKENdNrEqT3,1,0,0,0,0,0,1,0,1,0.14285714285714285,1,0.0,0,0,0,0,0,0,0,1,0,0,1,1
6869,186646,EXWNkRXjkZOc8AsQnQXXGYq4K74jND3i,SpATywNh6bZuzm8s1ceuBUnMUAeoAHHw,5,2,1,0,1,0,2,0,6,0.8571428571428571,1,0.0,0,1,0,1,2,0,0,2,0,2,4,1
6870,186650,Rv6gVo5TL2yRLbTriDaWEPebl1P4Qs2d,bWdj2GDclj5ofokWjzoa5jAwMkxCykd6,16,23,9,124,9,0,2,0,167,23.857142857142858,1,0.0,12,9,119,9,11,0,5,2,0,149,18,1
6871,186657,cEMxPdpNr0sg7WlHPqAdbLiWdfHH1ZVi,RXDvfPUBYFlVdlueBFbLW0mhhAyGEqpt,8,5,4,0,2,0,1,0,12,1.7142857142857142,1,0.0,0,4,0,2,5,0,0,1,0,6,6,1
6872,186663,w67bG97cTw7otOM2uWqK71mG1zCn2Z71,RXDvfPUBYFlVdlueBFbLW0mhhAyGEqpt,6,2,1,0,1,0,3,0,7,1.0,1,0.0,1,1,0,1,1,0,0,3,0,3,4,1
6873,186685,NkVQGteS9t3nbfagAzHcxD3mnVkb9mPC,A3fsA9Zfv1X2fVEQhTw51lKENdNrEqT3,35,28,21,64,12,0,7,0,132,18.857142857142858,2,0.0,3,21,56,12,25,0,8,7,0,92,40,1
6874,186707,mnhLxfC9FQKYouYyd3LS1enEfHJfDKsX,G8EPVSXsOYB5YQWZGiz1aVq5Pgr2GrQu,17,18,1,0,1,1,6,0,27,3.857142857142857,2,0.0,0,1,0,1,18,1,0,6,0,2,25,0
6875,186721,XO4yOVP7eCwBTi6pYIgtRmMh0ft7YdHb,bWdj2GDclj5ofokWjzoa5jAwMkxCykd6,6,4,0,0,0,2,8,0,14,2.0,1,0.0,0,0,0,0,4,2,0,8,0,0,14,1
6876,186759,hHVyNQkfLcybgeO1W2xMmju5SBV0vBkh,A3fsA9Zfv1X2fVEQhTw51lKENdNrEqT3,3,2,0,0,0,0,1,0,3,0.42857142857142855,1,0.0,0,0,0,0,2,0,0,1,0,0,3,1
6877,186789,zaUwSB02aOgiyf49lPt6UjZNYDYC7fjT,A3fsA9Zfv1X2fVEQhTw51lKENdNrEqT3,4,2,0,0,0,0,3,0,5,0.7142857142857143,1,0.0,0,0,0,0,2,0,0,3,0,0,5,1
6878,186792,eREFizdpriB0dfyYOU7lPptHy7Cm4d3g,SpATywNh6bZuzm8s1ceuBUnMUAeoAHHw,4,2,0,0,0,0,2,0,4,0.5714285714285714,1,0.0,0,0,0,0,2,0,0,2,0,0,4,1
6879,186797,Eh8pkmowXyhtJAd3Rq2bSawvaaJrouRd,RXDvfPUBYFlVdlueBFbLW0mhhAyGEqpt,6,5,2,0,1,0,4,0,12,1.7142857142857142,2,0.0,0,2,0,1,5,0,0,4,0,3,9,1
6880,186819,vAnLr8TMB4xrFCa1bt8zTG1qXKp0tpM2,SpATywNh6bZuzm8s1ceuBUnMUAeoAHHw,8,2,2,0,1,0,8,0,13,1.8571428571428572,1,0.0,0,2,0,1,2,0,0,8,0,3,10,1
6881,186845,rztgByxlqb0NHiCkVNMSLs4z23c2EnGy,SpATywNh6bZuzm8s1ceuBUnMUAeoAHHw,6,3,2,0,2,0,1,0,8,1.1428571428571428,1,0.0,0,2,0,2,3,0,0,1,0,4,4,1
6882,186852,h8UWLevhpVfEbcVzC3XxVtErwnEzlHV5,RXDvfPUBYFlVdlueBFbLW0mhhAyGEqpt,1,0,0,0,0,0,3,0,3,0.42857142857142855,2,0.0,0,0,0,0,0,0,0,3,0,0,3,0
6883,186879,f5d2qvzqNcWdC1ycnE8TG7hK2snW07TA,SpATywNh6bZuzm8s1ceuBUnMUAeoAHHw,6,8,5,0,4,0,7,0,24,3.4285714285714284,2,0.0,0,5,0,4,8,0,0,7,0,9,15,1
6884,186886,1Che5WZp8JOnI2bMKJvtmSYY66gIbE1b,SpATywNh6bZuzm8s1ceuBUnMUAeoAHHw,8,6,0,0,0,0,3,0,9,1.2857142857142858,1,0.0,0,0,0,0,6,0,0,3,0,0,9,1
6885,188096,w8S7oPNGWahl5gDDyBTLSciA1VA7haw4,A3fsA9Zfv1X2fVEQhTw51lKENdNrEqT3,19,17,11,0,8,0,2,0,38,5.428571428571429,1,0.0,3,11,0,8,14,0,0,2,0,22,16,1
6886,188103,O8GYzagsTrclNZXR3HZD1CBdMlg7RUB6,SpATywNh6bZuzm8s1ceuBUnMUAeoAHHw,4,2,0,0,0,0,2,0,4,0.5714285714285714,1,0.0,0,0,0,0,2,0,0,2,0,0,4,1
6887,188113,Q8i7XHeUD92Ae2WeCoNsZYF9vQYf3HPz,SpATywNh6bZuzm8s1ceuBUnMUAeoAHHw,1,0,0,0,0,0,1,0,1,0.14285714285714285,1,0.0,0,0,0,0,0,0,0,1,0,0,1,1
6888,188129,bA4tnPZD0UU4XAL3OkL7nUjtkAzbgj9d,SpATywNh6bZuzm8s1ceuBUnMUAeoAHHw,13,26,11,0,6,0,3,0,46,6.571428571428571,1,0.0,7,11,0,6,19,0,0,3,0,24,22,1
6889,188157,2hMeaUc14fgUG8b3kgXxN1xDYogexPXy,A3fsA9Zfv1X2fVEQhTw51lKENdNrEqT3,8,5,4,0,3,0,1,0,13,1.8571428571428572,1,0.0,0,4,0,3,5,0,0,1,0,7,6,1
6890,188168,Q2xVgvnqNYVNG5kOgvnpJvY9QuBN0RbG,bWdj2GDclj5ofokWjzoa5jAwMkxCykd6,6,3,1,0,1,0,2,0,7,1.0,1,0.0,0,1,0,1,3,0,0,2,0,2,5,1
6891,188176,wwrhZcbbsWF5UNfVZIIcfrs0NelO6L0J,bWdj2GDclj5ofokWjzoa5jAwMkxCykd6,5,2,1,0,1,0,2,0,6,0.8571428571428571,1,0.0,0,1,0,1,2,0,0,2,0,2,4,1
6892,188188,Vhmq36VBivLuLEONnhTEAZGyc0lOW8HG,SpATywNh6bZuzm8s1ceuBUnMUAeoAHHw,1,0,0,0,0,0,1,0,1,0.14285714285714285,1,0.0,0,0,0,0,0,0,0,1,0,0,1,1
6893,188191,K6d2j7PmZmtKVENKrnd412mUvCD6G0Iq,A3fsA9Zfv1X2fVEQhTw51lKENdNrEqT3,36,21,10,52,8,0,9,1,101,14.428571428571429,1,0.0,3,10,47,8,18,0,5,9,1,68,33,1
6894,188218,ycZck16llBAZloBk10bwfMcnaMnaXQWK,RXDvfPUBYFlVdlueBFbLW0mhhAyGEqpt,6,5,0,0,0,0,5,0,10,1.4285714285714286,1,0.0,0,0,0,0,5,0,0,5,0,0,10,1
6895,188241,UQu58ECfm706pzTxKdZuMBkLVofX5BYJ,bWdj2GDclj5ofokWjzoa5jAwMkxCykd6,7,3,2,0,2,0,2,0,9,1.2857142857142858,1,0.0,0,2,0,2,3,0,0,2,0,4,5,1
6896,188249,55wiWWDY37Jvz4XRR5WZBukpONx2E6zf,bWdj2GDclj5ofokWjzoa5jAwMkxCykd6,5,5,3,0,2,0,2,0,12,1.7142857142857142,1,0.0,0,3,0,2,5,0,0,2,0,5,7,1
6897,188256,QycCZ3StVS9Q0gqdzH8YDRcbrA6KQPic,SpATywNh6bZuzm8s1ceuBUnMUAeoAHHw,22,35,11,15,6,0,2,0,69,9.857142857142858,1,0.0,21,11,15,6,14,0,0,2,0,53,16,1
6898,188301,CwrmTUMTRx5M6yQJpPEbrBRyJawjn4Ps,SpATywNh6bZuzm8s1ceuBUnMUAeoAHHw,1,0,0,0,0,0,1,0,1,0.14285714285714285,1,0.0,0,0,0,0,0,0,0,1,0,0,1,1
6899,188323,08FXiN9E2j1PM7CMfj415B4erdhymv4G,SpATywNh6bZuzm8s1ceuBUnMUAeoAHHw,9,2,2,0,2,0,7,1,14,2.0,1,0.0,0,2,0,2,2,0,0,7,1,4,10,1
6900,188332,WxVM9kOqNmenlQy1YKMo3yVYKYKkewCz,bWdj2GDclj5ofokWjzoa5jAwMkxCykd6,1,0,0,0,0,0,1,0,1,0.14285714285714285,1,0.0,0,0,0,0,0,0,0,1,0,0,1,1
6901,188338,7xGbu9oc4JWGY9fgiUO3Qqm473RvS2PB,SpATywNh6bZuzm8s1ceuBUnMUAeoAHHw,7,3,2,0,2,0,2,0,9,1.2857142857142858,1,0.0,0,2,0,2,3,0,0,2,0,4,5,1
6902,188348,4ly9tFjgsKJLiMP1XUHFz2i27nHiXdvU,A3fsA9Zfv1X2fVEQhTw51lKENdNrEqT3,8,3,2,0,0,5,6,1,17,2.4285714285714284,1,0.0,0,2,0,0,3,5,0,6,1,2,15,1
6903,188374,U30BvMtyZpL38NHSSIWCu0FHJgAKw4Fr,A3fsA9Zfv1X2fVEQhTw51lKENdNrEqT3,2,0,0,0,0,0,3,0,3,0.42857142857142855,1,0.0,0,0,0,0,0,0,0,3,0,0,3,0
6904,188386,q3NLZCkaVgPCeFUby9MsDXbo2vYw2wOB,SpATywNh6bZuzm8s1ceuBUnMUAeoAHHw,1,0,0,0,0,0,1,0,1,0.14285714285714285,1,0.0,0,0,0,0,0,0,0,1,0,0,1,1
6905,188415,GAKCidUQ8hdeh0WMwEYlK9cUZXNPRN5R,RXDvfPUBYFlVdlueBFbLW0mhhAyGEqpt,1,0,0,0,0,0,1,0,1,0.14285714285714285,1,0.0,0,0,0,0,0,0,0,1,0,0,1,1
6906,188427,btK3RdfuvWrDzNhOkrOpUgTbQUI2vrLY,SpATywNh6bZuzm8s1ceuBUnMUAeoAHHw,6,7,1,0,1,0,1,0,10,1.4285714285714286,1,0.0,3,1,0,1,4,0,0,1,0,5,5,1
6907,188446,3tkincdjsTSFt3awGPKGfVv9zR1YRwuC,SpATywNh6bZuzm8s1ceuBUnMUAeoAHHw,1,0,0,0,0,0,1,0,1,0.14285714285714285,1,0.0,0,0,0,0,0,0,0,1,0,0,1,1
6908,188447,DUw85TcNpxyZaZKIM1HlHxvgtSm7uwxY,G8EPVSXsOYB5YQWZGiz1aVq5Pgr2GrQu,5,2,1,0,1,0,2,0,6,0.8571428571428571,1,0.0,0,1,0,1,2,0,0,2,0,2,4,0
6909,188458,jFwDcIl1Tm6UHlfb8PtOob6kZkOEjdQr,RXDvfPUBYFlVdlueBFbLW0mhhAyGEqpt,1,0,0,0,0,0,1,0,1,0.14285714285714285,1,0.0,0,0,0,0,0,0,0,1,0,0,1,1
6910,188461,blQKCpClzsxilnQtKRruTVl5WFjEiUZ7,SpATywNh6bZuzm8s1ceuBUnMUAeoAHHw,5,4,3,0,2,0,1,0,10,1.4285714285714286,1,0.0,0,3,0,2,4,0,0,1,0,5,5,1
6911,188475,Onp8u1IlkiXCdEq7Tg9xltw0KEKQAxrs,SpATywNh6bZuzm8s1ceuBUnMUAeoAHHw,6,3,2,0,2,0,1,0,8,1.1428571428571428,1,0.0,0,2,0,2,3,0,0,1,0,4,4,1
6912,188481,gkv9GP4XDvDQ4me5aOnbcgCOOilwq0mr,SpATywNh6bZuzm8s1ceuBUnMUAeoAHHw,1,0,0,0,0,0,1,0,1,0.14285714285714285,1,0.0,0,0,0,0,0,0,0,1,0,0,1,1
6913,188487,yQM2e0pQ43tZ4WbvgNqCdUjXo9r9zUpY,bWdj2GDclj5ofokWjzoa5jAwMkxCykd6,1,0,0,0,0,0,1,0,1,0.14285714285714285,1,0.0,0,0,0,0,0,0,0,1,0,0,1,1
6914,188509,NhmfopX2bIkd9yTnVyho2Qq41VTy8NFx,SpATywNh6bZuzm8s1ceuBUnMUAeoAHHw,6,1,1,0,1,0,3,0,6,0.8571428571428571,1,0.0,0,1,0,1,1,0,0,3,0,2,4,1
6915,188511,g6p03sN0Mi0uDRMoaBI65emUrtGFnpP4,RXDvfPUBYFlVdlueBFbLW0mhhAyGEqpt,20,13,9,14,7,0,7,1,51,7.285714285714286,1,0.0,2,9,14,7,11,0,0,7,1,32,19,1
6916,188522,VZRd1DrilkNeD7Ya8MVZCNtIczH3eEMz,G8EPVSXsOYB5YQWZGiz1aVq5Pgr2GrQu,21,42,24,26,6,0,15,1,114,16.285714285714285,2,0.0,9,24,17,6,33,0,9,15,1,56,58,1
6917,188544,wiVLWKqdbOlotFq1ag8KwC6Hw3JbpdNh,SpATywNh6bZuzm8s1ceuBUnMUAeoAHHw,6,3,1,0,1,0,2,0,7,1.0,1,0.0,0,1,0,1,3,0,0,2,0,2,5,1
6918,188555,uo8XRoO08TmpTH4gap159tNYVx3xop3U,G8EPVSXsOYB5YQWZGiz1aVq5Pgr2GrQu,1,0,0,0,0,0,1,0,1,0.14285714285714285,1,0.0,0,0,0,0,0,0,0,1,0,0,1,1
6919,188558,xqboiFlp42vyY93nDStsbVWBCL5sgIRH,A3fsA9Zfv1X2fVEQhTw51lKENdNrEqT3,24,23,1,16,1,0,7,0,48,6.857142857142857,1,0.0,0,1,13,1,23,0,3,7,0,15,33,1
6920,188561,6mdM8AvYlfditnue2TYJQLFDiBvxSUej,G8EPVSXsOYB5YQWZGiz1aVq5Pgr2GrQu,7,3,0,0,0,0,4,0,7,1.0,1,0.0,0,0,0,0,3,0,0,4,0,0,7,1
6921,188563,SiYxfRymwR9ZXmdv7LpkIYvuHNblUn46,bWdj2GDclj5ofokWjzoa5jAwMkxCykd6,2,0,0,0,0,0,2,0,2,0.2857142857142857,1,0.0,0,0,0,0,0,0,0,2,0,0,2,1
6922,188568,SiYxfRymwR9ZXmdv7LpkIYvuHNblUn46,RXDvfPUBYFlVdlueBFbLW0mhhAyGEqpt,1,0,0,0,0,0,1,0,1,0.14285714285714285,1,0.0,0,0,0,0,0,0,0,1,0,0,1,1
6923,188587,giGUAF5TXBP4oix75tUgV16Pg3alJM4Y,SpATywNh6bZuzm8s1ceuBUnMUAeoAHHw,1,0,0,0,0,0,1,0,1,0.14285714285714285,1,0.0,0,0,0,0,0,0,0,1,0,0,1,1
6924,188602,faupOzOQrYnrhUP3CZcXERH5hL8Q3xd2,bWdj2GDclj5ofokWjzoa5jAwMkxCykd6,8,6,2,32,1,3,3,0,47,6.714285714285714,2,0.0,1,2,31,1,5,3,1,3,0,35,12,1
6925,188639,sKKYS1ogqmOcjeYfYtZMxdkgoIt3cEVK,SpATywNh6bZuzm8s1ceuBUnMUAeoAHHw,18,15,7,0,7,0,4,0,33,4.714285714285714,1,0.0,0,7,0,7,15,0,0,4,0,14,19,1
6926,188952,tuXkXzLKLtIRrgeepCbs4ws8aCl66h43,7GRhBDsirIGkRZBtSMEzNTyDr2JQm4xx,34,119,36,50,30,53,17,1,306,43.714285714285715,1,0.0,69,36,39,30,50,53,11,17,1,174,132,1
6927,188957,UcAhBIdVZpMELDlnTcMm9mzDJ1F9Jhg3,7GRhBDsirIGkRZBtSMEzNTyDr2JQm4xx,1,0,0,0,0,0,1,0,1,0.14285714285714285,1,0.0,0,0,0,0,0,0,0,1,0,0,1,1
6928,188980,b9SN0Via9Qc1lw25HlIBgqllvaoVGqZR,7GRhBDsirIGkRZBtSMEzNTyDr2JQm4xx,1,0,0,0,0,0,1,0,1,0.14285714285714285,1,0.0,0,0,0,0,0,0,0,1,0,0,1,1
6929,188988,ljmWZCzWPqv1RXsn1q2wpsQtrnA1zct2,7GRhBDsirIGkRZBtSMEzNTyDr2JQm4xx,6,3,2,0,2,0,1,0,8,1.1428571428571428,1,0.0,0,2,0,2,3,0,0,1,0,4,4,1
6930,188998,kGchkvQPmF7DV3eBhLNc2GVWP2dYDeVK,7GRhBDsirIGkRZBtSMEzNTyDr2JQm4xx,4,2,1,0,1,0,1,0,5,0.7142857142857143,1,0.0,0,1,0,1,2,0,0,1,0,2,3,1
6931,189006,fOtwdZktYnpxoylqFRzXhWQ4IRQZkjMB,7GRhBDsirIGkRZBtSMEzNTyDr2JQm4xx,5,7,2,0,1,0,1,0,11,1.5714285714285714,1,0.0,0,2,0,1,7,0,0,1,0,3,8,1
6932,189008,6sr5fFi7rfC2NnnMJfyjbVZzoXpjJRhH,7GRhBDsirIGkRZBtSMEzNTyDr2JQm4xx,4,1,1,0,0,3,3,0,8,1.1428571428571428,1,0.0,0,1,0,0,1,3,0,3,0,1,7,1
6933,189027,Tb3iSIl4j6IIWQqGXGjvVBDqMgnRJLyl,7GRhBDsirIGkRZBtSMEzNTyDr2JQm4xx,5,7,1,0,2,0,1,0,11,1.5714285714285714,1,0.0,3,1,0,2,4,0,0,1,0,6,5,1
6934,189098,YX2r5oewraL6wIQ6yI9Js4hkHPlQTVjj,7GRhBDsirIGkRZBtSMEzNTyDr2JQm4xx,9,2,1,0,1,1,7,1,13,1.8571428571428572,1,0.0,0,1,0,1,2,1,0,7,1,2,11,1
6935,189104,NumNFW5RaIHDi6n0KLy5Cf1kLDxHgZZ0,G8EPVSXsOYB5YQWZGiz1aVq5Pgr2GrQu,6,4,1,0,0,0,2,0,7,1.0,1,0.0,0,1,0,0,4,0,0,2,0,1,6,1
6936,189107,krtZQqbvUpNsJjcNARYP8JsIRTz2QIeg,7GRhBDsirIGkRZBtSMEzNTyDr2JQm4xx,8,5,2,0,0,3,7,1,18,2.5714285714285716,1,0.0,0,2,0,0,5,3,0,7,1,2,16,1
6937,189109,ejIJpZTu0P4rcWcZmBKl6OiURGceVpiA,7GRhBDsirIGkRZBtSMEzNTyDr2JQm4xx,1,0,0,0,0,0,1,0,1,0.14285714285714285,1,0.0,0,0,0,0,0,0,0,1,0,0,1,1
6938,189110,sYKWdML3lybCcfZ8QzVXzUviXjVArLUH,7GRhBDsirIGkRZBtSMEzNTyDr2JQm4xx,2,0,0,0,0,0,2,0,2,0.2857142857142857,1,0.0,0,0,0,0,0,0,0,2,0,0,2,1
6939,189128,2wo3X72grgQzEbc3L58KSbNxJ33Bf4SU,7GRhBDsirIGkRZBtSMEzNTyDr2JQm4xx,4,2,1,0,1,0,1,0,5,0.7142857142857143,1,0.0,0,1,0,1,2,0,0,1,0,2,3,1
6940,189136,zNtPMkFrc8ewnZZhVeVhVYVOPd8vhwG9,7GRhBDsirIGkRZBtSMEzNTyDr2JQm4xx,13,15,3,34,1,10,6,0,69,9.857142857142858,1,0.0,8,3,26,1,7,10,8,6,0,38,31,1
6941,189162,o1LtNqe9OsdaahKJ5pz4qvaOsnGwGQzD,7GRhBDsirIGkRZBtSMEzNTyDr2JQm4xx,1,0,0,0,0,0,1,0,1,0.14285714285714285,1,0.0,0,0,0,0,0,0,0,1,0,0,1,1
6942,189203,ae9f7NnRGKtEuH4u37koNvJrDj4cou5c,7GRhBDsirIGkRZBtSMEzNTyDr2JQm4xx,13,24,0,0,3,0,9,0,36,5.142857142857143,1,0.0,10,0,0,3,14,0,0,9,0,13,23,1
6943,189221,8BLT2rbjNDvBkr2B6AQHpQ2yNooLf1CU,SpATywNh6bZuzm8s1ceuBUnMUAeoAHHw,12,22,13,18,0,2,3,0,58,8.285714285714286,1,0.0,5,13,15,0,17,2,3,3,0,33,25,1
6944,189324,RHO2J6AKDheXb2vKjeepgmCGgMG6BTYE,7GRhBDsirIGkRZBtSMEzNTyDr2JQm4xx,5,4,1,0,2,0,2,0,9,1.2857142857142858,1,0.0,2,1,0,2,2,0,0,2,0,5,4,1
6945,189353,iNXUknYcsccIKS8GgjuItiXxtSErv2BI,7GRhBDsirIGkRZBtSMEzNTyDr2JQm4xx,1,0,0,0,0,0,1,0,1,0.14285714285714285,1,0.0,0,0,0,0,0,0,0,1,0,0,1,1
6946,189395,aJzfntQTIfp35A305talVl9pd4o3Uf8u,7GRhBDsirIGkRZBtSMEzNTyDr2JQm4xx,1,0,0,0,0,0,1,0,1,0.14285714285714285,1,0.0,0,0,0,0,0,0,0,1,0,0,1,1
6947,189423,XE68NKSR0NgsUmxAP8OC135kqBLzzb9D,7GRhBDsirIGkRZBtSMEzNTyDr2JQm4xx,5,3,2,0,2,0,2,0,9,1.2857142857142858,1,0.0,0,2,0,2,3,0,0,2,0,4,5,1
6948,189429,UqksMVZ1lLvn2u7s6dT9SU5OFeNJnaAy,7GRhBDsirIGkRZBtSMEzNTyDr2JQm4xx,5,3,1,0,1,0,4,0,9,1.2857142857142858,1,0.0,0,1,0,1,3,0,0,4,0,2,7,1
6949,189463,8YAsQsQu6K1gQ9X3j9OO3pg6TTWyhygc,7GRhBDsirIGkRZBtSMEzNTyDr2JQm4xx,5,3,1,0,1,0,2,0,7,1.0,1,0.0,0,1,0,1,3,0,0,2,0,2,5,1
6950,189495,5O6gO2IHLbVMXXDwdapXEnrWY7rrDpQl,7GRhBDsirIGkRZBtSMEzNTyDr2JQm4xx,1,0,0,0,0,0,1,0,1,0.14285714285714285,1,0.0,0,0,0,0,0,0,0,1,0,0,1,1
6951,189513,W44EUSPSAj1fZWLor5hD25joUoQF1Axq,A3fsA9Zfv1X2fVEQhTw51lKENdNrEqT3,9,4,1,0,1,2,8,1,17,2.4285714285714284,1,0.0,0,1,0,1,4,2,0,8,1,2,15,1
6952,189554,7ZT5u11YEDTZhD4NZDPzOcLz6uLhq9Bd,7GRhBDsirIGkRZBtSMEzNTyDr2JQm4xx,1,0,0,0,0,0,1,0,1,0.14285714285714285,1,0.0,0,0,0,0,0,0,0,1,0,0,1,1
6953,189566,UIWPjpONY8VKQTSxeNrHquVi8SXHJ9tU,7GRhBDsirIGkRZBtSMEzNTyDr2JQm4xx,16,20,8,0,6,0,1,0,35,5.0,1,0.0,0,8,0,6,20,0,0,1,0,14,21,1
6954,189570,BRlaUe6oMRYCNox0BajKnWHes3A3ujyM,A3fsA9Zfv1X2fVEQhTw51lKENdNrEqT3,6,4,0,0,0,0,3,0,7,1.0,1,0.0,0,0,0,0,4,0,0,3,0,0,7,1
6955,189597,0vAWgNGUpLVRA2RW70tZzBBxiCN36t8Y,7GRhBDsirIGkRZBtSMEzNTyDr2JQm4xx,8,4,3,0,3,0,1,0,11,1.5714285714285714,1,0.0,0,3,0,3,4,0,0,1,0,6,5,1
6956,189636,JBk9P3H9SpNENMmKz8O8B3au3Kj5XKWF,7GRhBDsirIGkRZBtSMEzNTyDr2JQm4xx,1,0,0,0,0,0,1,0,1,0.14285714285714285,1,0.0,0,0,0,0,0,0,0,1,0,0,1,1
6957,189647,0a9LRwLYq2zam4NcdU9Yh5C7IQvHBC1m,A3fsA9Zfv1X2fVEQhTw51lKENdNrEqT3,1,0,0,0,0,0,1,0,1,0.14285714285714285,1,0.0,0,0,0,0,0,0,0,1,0,0,1,1
6958,189662,AykjJday1wTguij5gx88Emm7vsRmhjsn,7GRhBDsirIGkRZBtSMEzNTyDr2JQm4xx,1,0,0,0,0,0,1,0,1,0.14285714285714285,1,0.0,0,0,0,0,0,0,0,1,0,0,1,1
6959,189702,OyEvoRilpzFxIY7Xkwhpuz3t7yWiHYAD,7GRhBDsirIGkRZBtSMEzNTyDr2JQm4xx,1,0,0,0,0,0,1,0,1,0.14285714285714285,1,0.0,0,0,0,0,0,0,0,1,0,0,1,1
6960,189742,XtbEYUqZcMVM0EiUYCXC2IEORNMWz2mD,7GRhBDsirIGkRZBtSMEzNTyDr2JQm4xx,1,0,0,0,0,0,1,0,1,0.14285714285714285,1,0.0,0,0,0,0,0,0,0,1,0,0,1,1
6961,189788,DFDnEvNaTkvfy3RohV4MJVwGUkEZrUrx,7GRhBDsirIGkRZBtSMEzNTyDr2JQm4xx,2,0,0,0,0,0,2,0,2,0.2857142857142857,1,0.0,0,0,0,0,0,0,0,2,0,0,2,1
6962,189818,Y65j88wkyz5DKML6XOG6DUVrzLQhWfST,7GRhBDsirIGkRZBtSMEzNTyDr2JQm4xx,1,0,0,0,0,0,1,0,1,0.14285714285714285,1,0.0,0,0,0,0,0,0,0,1,0,0,1,1
6963,189830,cfto4CbYTItqNRa3py5uJG0bkzsfzUco,7GRhBDsirIGkRZBtSMEzNTyDr2JQm4xx,1,0,0,0,0,0,1,0,1,0.14285714285714285,1,0.0,0,0,0,0,0,0,0,1,0,0,1,1
6964,189869,mG2HKIW4KvK5MNtCekVvEvxXHT51PCPq,7GRhBDsirIGkRZBtSMEzNTyDr2JQm4xx,6,3,1,0,1,0,2,0,7,1.0,1,0.0,0,1,0,1,3,0,0,2,0,2,5,1
6965,190011,flCkd2hO7iQUUhaB3sp4v9WlXmzkKaLL,7GRhBDsirIGkRZBtSMEzNTyDr2JQm4xx,4,2,1,0,0,6,2,0,11,1.5714285714285714,1,0.0,0,1,0,0,2,6,0,2,0,1,10,1
6966,190081,iNidvGpmnGwj0TQ5PtdizeiguG8bztuW,7GRhBDsirIGkRZBtSMEzNTyDr2JQm4xx,10,10,6,0,5,0,3,0,24,3.4285714285714284,1,0.0,0,6,0,5,10,0,0,3,0,11,13,1
6967,190088,3SVVs5mG0aNsXrE6M2lNU1XqYm152qHm,7GRhBDsirIGkRZBtSMEzNTyDr2JQm4xx,3,2,1,0,0,0,1,0,4,0.5714285714285714,1,0.0,0,1,0,0,2,0,0,1,0,1,3,1
6968,190110,BohRHH2vBIgnEZGZjM3WnHwJbVFmITRG,7GRhBDsirIGkRZBtSMEzNTyDr2JQm4xx,1,0,0,0,0,0,1,0,1,0.14285714285714285,1,0.0,0,0,0,0,0,0,0,1,0,0,1,1
6969,190169,FaHW93yZCBwugzWZBbJAJZvMZt2lRMiJ,7GRhBDsirIGkRZBtSMEzNTyDr2JQm4xx,6,3,0,0,0,0,4,1,8,1.1428571428571428,1,0.0,1,0,0,0,2,0,0,4,1,1,7,1
6970,190190,p7LK5YIYyaPhnePVXdi7X5HGSzcJjL2r,7GRhBDsirIGkRZBtSMEzNTyDr2JQm4xx,1,0,0,0,0,0,1,0,1,0.14285714285714285,1,0.0,0,0,0,0,0,0,0,1,0,0,1,0
6971,190234,snhKj7MALyM2LCqV5sSwFpjNBeCB9QMT,7GRhBDsirIGkRZBtSMEzNTyDr2JQm4xx,4,1,0,0,1,0,2,0,4,0.5714285714285714,1,0.0,0,0,0,1,1,0,0,2,0,1,3,1
6972,190254,AA7aVbrpQJ2zUau6VJLFiC8rutvLHi1m,A3fsA9Zfv1X2fVEQhTw51lKENdNrEqT3,12,20,9,0,0,0,1,0,30,4.285714285714286,1,0.0,0,9,0,0,20,0,0,1,0,9,21,1
6973,190717,bKF5MosBqVKnYq47osSfpVQVg6H93E3y,SpATywNh6bZuzm8s1ceuBUnMUAeoAHHw,11,6,4,0,3,7,10,3,33,4.714285714285714,1,0.0,0,4,0,3,6,7,0,10,3,7,26,0
6974,190734,clv7wTDLUGVcdBnHuGK5igxvVYbUFhfO,A3fsA9Zfv1X2fVEQhTw51lKENdNrEqT3,1,0,0,0,0,0,1,0,1,0.14285714285714285,1,0.0,0,0,0,0,0,0,0,1,0,0,1,1
6975,190737,SqKmRlxZATrsBxFcgKwGzFSyWis0fRul,SpATywNh6bZuzm8s1ceuBUnMUAeoAHHw,12,8,5,0,3,2,6,1,25,3.5714285714285716,1,0.0,2,5,0,3,6,2,0,6,1,10,15,1
6976,190739,FFNnY7di7du4c5wFNDNV6nMH5bqqpuVS,G8EPVSXsOYB5YQWZGiz1aVq5Pgr2GrQu,16,5,5,28,3,1,4,0,46,6.571428571428571,1,0.0,0,5,24,3,5,1,4,4,0,32,14,1
6977,190747,cTeA1f2AYHCTzaLCFeSZpEjefvjGhNJD,G8EPVSXsOYB5YQWZGiz1aVq5Pgr2GrQu,8,8,3,0,2,0,2,0,15,2.142857142857143,1,0.0,3,3,0,2,5,0,0,2,0,8,7,1
6978,190756,wIcAqiIkhVke6PQk1FQ10LQjFUOa268K,bWdj2GDclj5ofokWjzoa5jAwMkxCykd6,1,0,0,0,0,0,1,0,1,0.14285714285714285,1,0.0,0,0,0,0,0,0,0,1,0,0,1,1
6979,190767,ErHRXoQE3PAKpLvIUT0gh504hJR8YxvQ,SpATywNh6bZuzm8s1ceuBUnMUAeoAHHw,1,0,0,0,0,0,1,0,1,0.14285714285714285,1,0.0,0,0,0,0,0,0,0,1,0,0,1,1
6980,190769,FZEwaAUaiR6zemazrUHMMvDLCgHez3sb,A3fsA9Zfv1X2fVEQhTw51lKENdNrEqT3,1,0,0,0,0,0,2,0,2,0.2857142857142857,1,0.0,0,0,0,0,0,0,0,2,0,0,2,1
6981,190774,xClBQDVnnmCO9u08LGuvxGj9xJyOTeqG,SpATywNh6bZuzm8s1ceuBUnMUAeoAHHw,6,3,1,0,1,0,2,0,7,1.0,1,0.0,0,1,0,1,3,0,0,2,0,2,5,1
6982,190775,uf9uxJ0q9fqnk8v2mIZk18f6DfpdKvW8,bWdj2GDclj5ofokWjzoa5jAwMkxCykd6,9,13,5,44,5,0,5,1,73,10.428571428571429,1,0.0,4,5,42,5,9,0,2,5,1,56,17,1
6983,190781,WgwvOVLxVR0cLBIPFfdMgIZsyrXu2dEM,RXDvfPUBYFlVdlueBFbLW0mhhAyGEqpt,10,6,1,0,1,1,11,7,27,3.857142857142857,1,0.0,0,1,0,1,6,1,0,11,7,2,25,1
6984,190794,jImHfNEIObE674KdIbKVj7cCJ4ufqzHJ,A3fsA9Zfv1X2fVEQhTw51lKENdNrEqT3,1,0,0,0,0,0,1,0,1,0.14285714285714285,1,0.0,0,0,0,0,0,0,0,1,0,0,1,1
6985,190795,cHDpTfio4QPhERzYfGBXzFYjVYPP50Cv,SpATywNh6bZuzm8s1ceuBUnMUAeoAHHw,7,5,3,0,2,0,4,0,14,2.0,1,0.0,0,3,0,2,5,0,0,4,0,5,9,1
6986,190797,pHifOW1icP08PuJhI8vGjqOw0aKfYcAe,bWdj2GDclj5ofokWjzoa5jAwMkxCykd6,15,11,6,60,4,6,8,1,96,13.714285714285714,1,0.0,2,6,53,4,9,6,7,8,1,65,31,1
6987,190807,UuSIoFbtQOfzMmWUxokidkbXgJFaHXwx,A3fsA9Zfv1X2fVEQhTw51lKENdNrEqT3,1,0,0,0,0,0,1,0,1,0.14285714285714285,1,0.0,0,0,0,0,0,0,0,1,0,0,1,0
6988,190808,wU9dwS3WWOQY9ZgttcIaOxUTFKpzQrwI,bWdj2GDclj5ofokWjzoa5jAwMkxCykd6,1,0,0,0,0,0,1,0,1,0.14285714285714285,1,0.0,0,0,0,0,0,0,0,1,0,0,1,0
6989,190809,hHLItJoAM7XEkMep3WUdcTboIWoYySm9,SpATywNh6bZuzm8s1ceuBUnMUAeoAHHw,7,5,0,0,0,4,6,1,16,2.2857142857142856,1,0.0,0,0,0,0,5,4,0,6,1,0,16,1
6990,190815,xnAaa3WYxuN7DFkNBugIG5RWGpSS1yS8,bWdj2GDclj5ofokWjzoa5jAwMkxCykd6,1,0,0,0,0,0,1,0,1,0.14285714285714285,1,0.0,0,0,0,0,0,0,0,1,0,0,1,1
6991,190818,uDXojcZmAjRrYpbHg6OiLrdKtE8isYPI,G8EPVSXsOYB5YQWZGiz1aVq5Pgr2GrQu,1,0,0,0,0,0,1,0,1,0.14285714285714285,1,0.0,0,0,0,0,0,0,0,1,0,0,1,1
6992,190822,8pF3cyLxq0AckySwkuwDRCVUkL6fkRLY,SpATywNh6bZuzm8s1ceuBUnMUAeoAHHw,6,2,0,0,0,0,9,0,11,1.5714285714285714,1,0.0,0,0,0,0,2,0,0,9,0,0,11,1
6993,190826,5ae8aSisBHmEo0mgVwdFagGGHfcfDsIo,G8EPVSXsOYB5YQWZGiz1aVq5Pgr2GrQu,1,0,0,0,0,0,1,0,1,0.14285714285714285,1,0.0,0,0,0,0,0,0,0,1,0,0,1,1
6994,190834,PUW0i4IuafllkJEtV0GCqmTDeLHkDmH3,SpATywNh6bZuzm8s1ceuBUnMUAeoAHHw,1,0,0,0,0,0,1,0,1,0.14285714285714285,1,0.0,0,0,0,0,0,0,0,1,0,0,1,1
6995,190852,5FKNtYsTkByroijTHxSZ2wThgqvXV2F5,SpATywNh6bZuzm8s1ceuBUnMUAeoAHHw,4,2,1,0,1,0,1,0,5,0.7142857142857143,1,0.0,0,1,0,1,2,0,0,1,0,2,3,1
6996,190861,HkcPmWCSdk3INCYsquWGQGZKijdTCD0w,A3fsA9Zfv1X2fVEQhTw51lKENdNrEqT3,1,0,0,0,0,0,1,0,1,0.14285714285714285,1,0.0,0,0,0,0,0,0,0,1,0,0,1,1
6997,190883,NtWIu4J0HPOWOANC7ZYns4tsHx1TBJoi,bWdj2GDclj5ofokWjzoa5jAwMkxCykd6,1,0,0,0,0,0,1,0,1,0.14285714285714285,1,0.0,0,0,0,0,0,0,0,1,0,0,1,1
6998,190889,9Yh9BGNzlB70iEC7VABYNXfepXjXz9Ik,RXDvfPUBYFlVdlueBFbLW0mhhAyGEqpt,1,0,0,0,0,0,1,0,1,0.14285714285714285,1,0.0,0,0,0,0,0,0,0,1,0,0,1,1
6999,190895,RJe7xu782OWYH4oamOQryIYQy1schp1L,SpATywNh6bZuzm8s1ceuBUnMUAeoAHHw,14,29,12,16,0,7,6,1,71,10.142857142857142,1,0.0,6,12,14,0,23,7,2,6,1,32,39,1
7000,190903,x71DJUx1l6jseHCehLwk4aITn2PbPyqZ,SpATywNh6bZuzm8s1ceuBUnMUAeoAHHw,5,2,1,0,1,0,2,0,6,0.8571428571428571,1,0.0,0,1,0,1,2,0,0,2,0,2,4,1
7001,190904,vyEmNT9CTTZs1s1eotM7mTmxUqBkMZB7,A3fsA9Zfv1X2fVEQhTw51lKENdNrEqT3,1,0,0,0,0,0,1,0,1,0.14285714285714285,1,0.0,0,0,0,0,0,0,0,1,0,0,1,1
7002,190917,KK8c9Dmj5I63bhg4LxlQHTWu5jCGLVNt,G8EPVSXsOYB5YQWZGiz1aVq5Pgr2GrQu,1,0,0,0,0,0,1,0,1,0.14285714285714285,1,0.0,0,0,0,0,0,0,0,1,0,0,1,1
7003,190947,ok4VFpKhZuAEe6hS0zrBXKoNseBmFZze,SpATywNh6bZuzm8s1ceuBUnMUAeoAHHw,14,22,2,25,0,2,9,1,61,8.714285714285714,2,0.0,4,2,22,0,18,2,3,9,1,28,33,1
7004,190954,WsLtEmeFmoC69MkLWoUcJ9ig36NGyKM9,SpATywNh6bZuzm8s1ceuBUnMUAeoAHHw,6,3,1,0,1,0,2,0,7,1.0,1,0.0,0,1,0,1,3,0,0,2,0,2,5,1
7005,190958,2xUoAPKuvFamkqgtuAisQsHAYFznYGmc,RXDvfPUBYFlVdlueBFbLW0mhhAyGEqpt,21,22,5,31,10,0,4,0,72,10.285714285714286,2,0.0,15,5,28,10,7,0,3,4,0,58,14,0
7006,190967,FENPBJBmeLAdvUkUsPg7akiTSdA52zTP,SpATywNh6bZuzm8s1ceuBUnMUAeoAHHw,7,6,2,0,1,0,3,0,12,1.7142857142857142,1,0.0,1,2,0,1,5,0,0,3,0,4,8,1
7007,190972,iACYFngARHwRlBD1uz8Bwi5b1szxFkra,SpATywNh6bZuzm8s1ceuBUnMUAeoAHHw,8,29,1,0,1,0,5,0,36,5.142857142857143,1,0.0,2,1,0,1,27,0,0,5,0,4,32,1
7008,190977,oaoj9be4jW2Hot8wYgYrzLRvB0RU4KYy,bWdj2GDclj5ofokWjzoa5jAwMkxCykd6,3,2,1,0,0,0,1,0,4,0.5714285714285714,1,0.0,0,1,0,0,2,0,0,1,0,1,3,1
7009,190991,M7fcRt21bsAgtvsrrzEizQkpE9mFW4i5,G8EPVSXsOYB5YQWZGiz1aVq5Pgr2GrQu,1,0,0,0,0,0,2,0,2,0.2857142857142857,1,0.0,0,0,0,0,0,0,0,2,0,0,2,1
7010,191001,nT8w17cJcdO2lsrz7cGSY123lCPnSOcs,SpATywNh6bZuzm8s1ceuBUnMUAeoAHHw,11,11,0,19,0,2,5,2,39,5.571428571428571,1,0.0,4,0,17,0,7,2,2,5,2,21,18,1
7011,191008,HQaEPrkmOsZZRI0w0Zd2GpWW5QsOPUNb,RXDvfPUBYFlVdlueBFbLW0mhhAyGEqpt,7,7,1,0,1,0,5,0,14,2.0,1,0.0,0,1,0,1,7,0,0,5,0,2,12,1
7012,191076,kLjseYEqrk7qJRpdsFaZefvj0uwqDQlm,SpATywNh6bZuzm8s1ceuBUnMUAeoAHHw,1,0,0,0,0,0,1,0,1,0.14285714285714285,1,0.0,0,0,0,0,0,0,0,1,0,0,1,1
7013,191092,arrrU4WiLIpECIetBxOM4AIL8R5yPrJI,SpATywNh6bZuzm8s1ceuBUnMUAeoAHHw,3,0,0,0,0,0,3,0,3,0.42857142857142855,1,0.0,0,0,0,0,0,0,0,3,0,0,3,1
7014,191108,geEAXwfPbJ0MhEZG0COad1UptHNAilTd,A3fsA9Zfv1X2fVEQhTw51lKENdNrEqT3,1,0,0,0,0,0,1,0,1,0.14285714285714285,1,0.0,0,0,0,0,0,0,0,1,0,0,1,1
7015,191177,cd5GtUhUnzyOzoyRaUudZZpk7s0Fqqr1,SpATywNh6bZuzm8s1ceuBUnMUAeoAHHw,2,0,0,0,0,0,2,0,2,0.2857142857142857,1,0.0,0,0,0,0,0,0,0,2,0,0,2,1
7016,191193,5isrCsGh9CKWlpcsbDYSNSmskNZ5RJjk,A3fsA9Zfv1X2fVEQhTw51lKENdNrEqT3,1,0,0,0,0,0,1,0,1,0.14285714285714285,1,0.0,0,0,0,0,0,0,0,1,0,0,1,1
7017,191204,p8HUn53OHQxlBbPvpqicSSSkhMnoLuUk,SpATywNh6bZuzm8s1ceuBUnMUAeoAHHw,1,0,0,0,0,0,1,0,1,0.14285714285714285,1,0.0,0,0,0,0,0,0,0,1,0,0,1,1
7018,191228,kMzMJEHy7fAHiNUZU0um3I2BsPC7gMll,RXDvfPUBYFlVdlueBFbLW0mhhAyGEqpt,1,0,0,0,0,0,1,0,1,0.14285714285714285,1,0.0,0,0,0,0,0,0,0,1,0,0,1,1
7019,191255,2WxDTXrRtDNHrqbb0X9iRKeiD9MDTDVK,SpATywNh6bZuzm8s1ceuBUnMUAeoAHHw,9,25,9,0,0,1,7,0,42,6.0,1,0.0,12,9,0,0,13,1,0,7,0,21,21,1
7020,191284,WgQR6nrfyl7yDpgHC595JSoog2R9VhVs,A3fsA9Zfv1X2fVEQhTw51lKENdNrEqT3,1,0,0,0,0,0,1,0,1,0.14285714285714285,1,0.0,0,0,0,0,0,0,0,1,0,0,1,1
7021,191309,V2MW5TTOl8erA9KB40i6ShoB0MXn3LUC,SpATywNh6bZuzm8s1ceuBUnMUAeoAHHw,5,2,1,0,1,0,4,0,8,1.1428571428571428,1,0.0,0,1,0,1,2,0,0,4,0,2,6,1
7022,191314,GRgjzx7VHY5z0cMezCfvrpSTKqpE3kNZ,SpATywNh6bZuzm8s1ceuBUnMUAeoAHHw,6,5,2,0,2,0,1,0,10,1.4285714285714286,1,0.0,0,2,0,2,5,0,0,1,0,4,6,1
7023,191320,SFvWBN0LUhWN6O8eK5tB1YryzhojhfkD,SpATywNh6bZuzm8s1ceuBUnMUAeoAHHw,1,0,0,0,0,0,1,0,1,0.14285714285714285,1,0.0,0,0,0,0,0,0,0,1,0,0,1,1
7024,191334,iwS4gRr8dUdengK5x37B93sG4oePIfDx,SpATywNh6bZuzm8s1ceuBUnMUAeoAHHw,1,0,0,0,0,0,1,0,1,0.14285714285714285,1,0.0,0,0,0,0,0,0,0,1,0,0,1,1
7025,191346,p6TgFJdLQMaMzbR16kycIPcRPnBj3paK,bWdj2GDclj5ofokWjzoa5jAwMkxCykd6,4,5,1,0,0,0,3,0,9,1.2857142857142858,1,0.0,0,1,0,0,5,0,0,3,0,1,8,1
7026,191365,v0iISMadlSfH1jVtRvOUuiYm96jA1BgF,SpATywNh6bZuzm8s1ceuBUnMUAeoAHHw,3,2,0,0,0,0,1,0,3,0.42857142857142855,1,0.0,0,0,0,0,2,0,0,1,0,0,3,1
7027,191390,T6EWQ7jVP89JlHzj41KN1gEtGYevpSQM,RXDvfPUBYFlVdlueBFbLW0mhhAyGEqpt,1,0,0,0,0,0,1,0,1,0.14285714285714285,1,0.0,0,0,0,0,0,0,0,1,0,0,1,1
7028,191396,kFbAoBQLoBy3cufqfKmpAxdN84jZuyGv,SpATywNh6bZuzm8s1ceuBUnMUAeoAHHw,1,0,0,0,0,0,1,0,1,0.14285714285714285,1,0.0,0,0,0,0,0,0,0,1,0,0,1,1
7029,191399,RknKWTR2QlcaofxNlEIJO86tIh9EMpGt,SpATywNh6bZuzm8s1ceuBUnMUAeoAHHw,6,8,3,0,2,0,2,0,15,2.142857142857143,1,0.0,0,3,0,2,8,0,0,2,0,5,10,1
7030,191400,oB66Su2y0fKCmlftIiys81THD7pT5Kwq,SpATywNh6bZuzm8s1ceuBUnMUAeoAHHw,3,2,0,0,0,0,2,0,4,0.5714285714285714,1,0.0,0,0,0,0,2,0,0,2,0,0,4,1
7031,191418,cBqC4wQ0uum34JxjmDvje145C1HEdpV7,A3fsA9Zfv1X2fVEQhTw51lKENdNrEqT3,1,0,0,0,0,0,1,0,1,0.14285714285714285,1,0.0,0,0,0,0,0,0,0,1,0,0,1,1
7032,191426,if3F5GyFS3tLy1wJ6MlpPAYmdoRWmS4a,G8EPVSXsOYB5YQWZGiz1aVq5Pgr2GrQu,15,9,8,24,6,0,2,0,49,7.0,1,0.0,0,8,19,6,9,0,5,2,0,33,16,1
7033,191428,0g874SF3SMbHGyq5A3NVcdw5ZagrIMLX,A3fsA9Zfv1X2fVEQhTw51lKENdNrEqT3,1,0,0,0,0,0,1,0,1,0.14285714285714285,1,0.0,0,0,0,0,0,0,0,1,0,0,1,1
7034,191439,7k95jHpTPudDL0r9ern1lqZsX7khTblO,SpATywNh6bZuzm8s1ceuBUnMUAeoAHHw,10,3,2,0,2,4,8,2,21,3.0,1,0.0,0,2,0,2,3,4,0,8,2,4,17,1
7035,191470,WmysxkCsgnQj3BaPOZ0U0HkLBTddwtEo,RXDvfPUBYFlVdlueBFbLW0mhhAyGEqpt,18,8,4,15,3,8,10,4,52,7.428571428571429,1,0.0,3,4,15,3,5,8,0,10,4,25,27,1
7036,191474,URsMDmBXxCzQPD8yy0pnaAiUOwpb4Aof,G8EPVSXsOYB5YQWZGiz1aVq5Pgr2GrQu,1,0,0,0,0,0,1,0,1,0.14285714285714285,1,0.0,0,0,0,0,0,0,0,1,0,0,1,1
7037,191485,XFJ68m78eqRR6RTXtGyyLhWYKyJpG8am,SpATywNh6bZuzm8s1ceuBUnMUAeoAHHw,13,20,7,28,3,3,6,0,67,9.571428571428571,1,0.0,7,7,24,3,13,3,4,6,0,41,26,1
7038,191503,wuaIkUodYTr49NZ7BbMPsEdpO0t0C8Nt,bWdj2GDclj5ofokWjzoa5jAwMkxCykd6,1,0,0,0,0,0,1,0,1,0.14285714285714285,1,0.0,0,0,0,0,0,0,0,1,0,0,1,0
7039,191513,8Hc0b25bgfH6lNfQjbdydA9Vr0ij1wAo,RXDvfPUBYFlVdlueBFbLW0mhhAyGEqpt,6,3,2,0,1,0,2,0,8,1.1428571428571428,1,0.0,0,2,0,1,3,0,0,2,0,3,5,1
7040,191520,aQZ3ue6sZAjGbF4xHc1nd423AeIpShr7,SpATywNh6bZuzm8s1ceuBUnMUAeoAHHw,6,1,1,0,0,7,7,2,18,2.5714285714285716,1,0.0,0,1,0,0,1,7,0,7,2,1,17,1
7041,191555,xJg5Rk4cV40ktI4XCqJwerPySa8KdDum,SpATywNh6bZuzm8s1ceuBUnMUAeoAHHw,4,2,0,0,0,0,5,0,7,1.0,1,0.0,0,0,0,0,2,0,0,5,0,0,7,1
7042,191557,H7bZ54NuzkB5Nw5q0ZI1nld9qDoHNngL,RXDvfPUBYFlVdlueBFbLW0mhhAyGEqpt,7,3,2,0,2,0,2,0,9,1.2857142857142858,1,0.0,0,2,0,2,3,0,0,2,0,4,5,0
7043,191558,bxybXAkYqJdxWDLSPlh74sjGoIJub8gI,A3fsA9Zfv1X2fVEQhTw51lKENdNrEqT3,1,0,0,0,0,0,1,0,1,0.14285714285714285,1,0.0,0,0,0,0,0,0,0,1,0,0,1,1
7044,191566,dPo2apv0Dzwh69Z1mYMogRvND7Zqb5Dp,SpATywNh6bZuzm8s1ceuBUnMUAeoAHHw,1,0,0,0,0,0,1,0,1,0.14285714285714285,1,0.0,0,0,0,0,0,0,0,1,0,0,1,1
7045,191595,6VqcRtEStIFn65gZeMiEFRDlkNKCPpuX,SpATywNh6bZuzm8s1ceuBUnMUAeoAHHw,1,0,0,0,0,0,1,0,1,0.14285714285714285,1,0.0,0,0,0,0,0,0,0,1,0,0,1,1
7046,191600,6hpnm3HPpj7kwmlYcJCdnCjcQP3bgA8P,SpATywNh6bZuzm8s1ceuBUnMUAeoAHHw,1,0,0,0,0,0,1,0,1,0.14285714285714285,1,0.0,0,0,0,0,0,0,0,1,0,0,1,1
7047,191609,VRZ45dbdEaezkrEYnjvv0A7uj4TRC509,RXDvfPUBYFlVdlueBFbLW0mhhAyGEqpt,1,0,0,0,0,0,2,0,2,0.2857142857142857,1,0.0,0,0,0,0,0,0,0,2,0,0,2,1
7048,191619,WlHV3frRLxQmTIY14HccRXj4N1zg8F2y,A3fsA9Zfv1X2fVEQhTw51lKENdNrEqT3,1,0,0,0,0,0,1,0,1,0.14285714285714285,1,0.0,0,0,0,0,0,0,0,1,0,0,1,1
7049,191625,WlHV3frRLxQmTIY14HccRXj4N1zg8F2y,SpATywNh6bZuzm8s1ceuBUnMUAeoAHHw,1,0,0,0,0,0,1,0,1,0.14285714285714285,1,0.0,0,0,0,0,0,0,0,1,0,0,1,1
7050,191629,XdXU1POVy8aDaqRsnREruSsMPvgxWetA,A3fsA9Zfv1X2fVEQhTw51lKENdNrEqT3,1,0,0,0,0,0,1,0,1,0.14285714285714285,1,0.0,0,0,0,0,0,0,0,1,0,0,1,0
7051,191655,p04QzukP32kpPk8EGoBhDUGJJQqJUoNz,G8EPVSXsOYB5YQWZGiz1aVq5Pgr2GrQu,1,0,0,0,0,0,2,0,2,0.2857142857142857,1,0.0,0,0,0,0,0,0,0,2,0,0,2,1
7052,191678,vWQfaR79jDjjXdq7DWLb4Yep3Hqk0KZU,SpATywNh6bZuzm8s1ceuBUnMUAeoAHHw,1,0,0,0,0,0,1,0,1,0.14285714285714285,1,0.0,0,0,0,0,0,0,0,1,0,0,1,1
7053,191692,KNNMSW3oLxGqEqv2czanNkhQgdUkOWgY,RXDvfPUBYFlVdlueBFbLW0mhhAyGEqpt,7,6,4,0,1,0,2,0,13,1.8571428571428572,1,0.0,0,4,0,1,6,0,0,2,0,5,8,0
7054,191725,OnbafhawH0rPSL0N5ij1JID10mYyXSki,RXDvfPUBYFlVdlueBFbLW0mhhAyGEqpt,15,23,1,14,1,1,4,0,44,6.285714285714286,1,0.0,3,1,12,1,20,1,2,4,0,17,27,1
7055,191729,N7U6b4ydC4LyBj5GQ1EeCbwlZ2DqZbJ6,bWdj2GDclj5ofokWjzoa5jAwMkxCykd6,5,4,1,0,1,0,4,0,10,1.4285714285714286,1,0.0,0,1,0,1,4,0,0,4,0,2,8,1
7056,191733,dZqFLbQhzRGv0XrnoR6Btyn7eZPLWNcs,G8EPVSXsOYB5YQWZGiz1aVq5Pgr2GrQu,5,3,1,0,1,0,1,0,6,0.8571428571428571,1,0.0,0,1,0,1,3,0,0,1,0,2,4,1
7057,191735,qwG1GCNkwhgE1heJRoYjfA2CYeRyFFBD,SpATywNh6bZuzm8s1ceuBUnMUAeoAHHw,5,2,1,0,1,0,2,0,6,0.8571428571428571,1,0.0,0,1,0,1,2,0,0,2,0,2,4,1
7058,191740,0A6FjHxqeczBpR079Zm0ynsuWpteOCkO,A3fsA9Zfv1X2fVEQhTw51lKENdNrEqT3,1,0,0,0,0,0,1,0,1,0.14285714285714285,1,0.0,0,0,0,0,0,0,0,1,0,0,1,1
7059,191744,ifBHT3U3Q2vZ9dQs2fpRYsiXqMAEWHBB,SpATywNh6bZuzm8s1ceuBUnMUAeoAHHw,1,0,0,0,0,0,1,0,1,0.14285714285714285,1,0.0,0,0,0,0,0,0,0,1,0,0,1,1
7060,191751,inFcOljKYTbAioEZelr7FOpytUh6Wwwm,A3fsA9Zfv1X2fVEQhTw51lKENdNrEqT3,1,0,0,0,0,0,2,0,2,0.2857142857142857,1,0.0,0,0,0,0,0,0,0,2,0,0,2,1
7061,191755,BgRqBvDqiEwBpSmGhgFl2BztVgNMTQzO,SpATywNh6bZuzm8s1ceuBUnMUAeoAHHw,5,5,1,2,0,0,1,0,9,1.2857142857142858,1,0.0,1,1,2,0,4,0,0,1,0,4,5,1
7062,191758,RpI9z3V0AgaYDbaVWpv7K8qBLot9xbZ1,SpATywNh6bZuzm8s1ceuBUnMUAeoAHHw,2,0,0,0,0,2,1,0,3,0.42857142857142855,1,0.0,0,0,0,0,0,2,0,1,0,0,3,1
7063,191784,yPgZKtTbqfPKTL2LU9Q3PsQCk4gWnK9n,bWdj2GDclj5ofokWjzoa5jAwMkxCykd6,2,0,0,0,0,0,2,0,2,0.2857142857142857,1,0.0,0,0,0,0,0,0,0,2,0,0,2,1
7064,191792,kmiB7WIX79F3dncKlftv8WHURaepCY2a,G8EPVSXsOYB5YQWZGiz1aVq5Pgr2GrQu,5,3,1,0,1,0,1,0,6,0.8571428571428571,1,0.0,0,1,0,1,3,0,0,1,0,2,4,1
7065,191795,I4TQ7Q1utfRs4sHagyenl8ox4pkFBHHE,bWdj2GDclj5ofokWjzoa5jAwMkxCykd6,2,0,0,0,0,0,2,0,2,0.2857142857142857,1,0.0,0,0,0,0,0,0,0,2,0,0,2,1
7066,191796,HsUrz2Tvq8sRzoPDsx1zZZFVKu21a9Fj,bWdj2GDclj5ofokWjzoa5jAwMkxCykd6,1,0,0,0,0,0,1,0,1,0.14285714285714285,1,0.0,0,0,0,0,0,0,0,1,0,0,1,1
7067,191809,RkMMgfrDoCy0k6xciXBqfQqum2o9XEow,A3fsA9Zfv1X2fVEQhTw51lKENdNrEqT3,1,0,0,0,0,0,1,0,1,0.14285714285714285,1,0.0,0,0,0,0,0,0,0,1,0,0,1,1
7068,191820,GPXoKOYBnmTprrhcUmupBdNFpJRyodal,G8EPVSXsOYB5YQWZGiz1aVq5Pgr2GrQu,8,7,2,0,2,0,4,0,15,2.142857142857143,1,0.0,4,2,0,2,3,0,0,4,0,8,7,1
7069,191826,apfvYM10NU1k5W582bvs0kUbUD2jx0Pf,SpATywNh6bZuzm8s1ceuBUnMUAeoAHHw,1,0,0,0,0,0,2,0,2,0.2857142857142857,1,0.0,0,0,0,0,0,0,0,2,0,0,2,1
7070,191827,hMmMWG2mCSPmBVJCfg0hTnXWgrWTXDtT,bWdj2GDclj5ofokWjzoa5jAwMkxCykd6,1,0,0,0,0,0,1,0,1,0.14285714285714285,1,0.0,0,0,0,0,0,0,0,1,0,0,1,1
7071,191837,Fq5B003Bt4YEeqhrth8SMHf096RbzYAO,SpATywNh6bZuzm8s1ceuBUnMUAeoAHHw,16,16,4,16,3,0,6,1,46,6.571428571428571,1,0.0,11,4,14,3,5,0,2,6,1,32,14,1
7072,191840,bR8wdPBdFHSsMQ5cBBQOeSecEHoEdU3R,SpATywNh6bZuzm8s1ceuBUnMUAeoAHHw,1,0,0,0,0,0,1,0,1,0.14285714285714285,1,0.0,0,0,0,0,0,0,0,1,0,0,1,1
7073,191850,eRPwUTqaIsUryY9jPBGa7k7RWRZnrrvU,A3fsA9Zfv1X2fVEQhTw51lKENdNrEqT3,1,0,0,0,0,0,1,0,1,0.14285714285714285,1,0.0,0,0,0,0,0,0,0,1,0,0,1,1
7074,191861,AdLAJ2czvUY9AyeUk5B4rn58TrqeeWxO,RXDvfPUBYFlVdlueBFbLW0mhhAyGEqpt,1,0,0,0,0,0,1,0,1,0.14285714285714285,1,0.0,0,0,0,0,0,0,0,1,0,0,1,1
7075,191865,XVfEU97madT1zlAJ4ceeVrr8RhA7IGa2,SpATywNh6bZuzm8s1ceuBUnMUAeoAHHw,5,3,1,0,1,0,1,0,6,0.8571428571428571,1,0.0,0,1,0,1,3,0,0,1,0,2,4,1
7076,191889,kvp7nv1Fk7hbG5ZfWGkJtc8xaumUx9u9,bWdj2GDclj5ofokWjzoa5jAwMkxCykd6,5,6,1,0,2,0,2,0,11,1.5714285714285714,1,0.0,2,1,0,2,4,0,0,2,0,5,6,1
7077,191891,lej2dE7o05DOz003uw82zCNwZA2EHApG,SpATywNh6bZuzm8s1ceuBUnMUAeoAHHw,6,0,0,0,0,1,12,1,14,2.0,1,0.0,0,0,0,0,0,1,0,12,1,0,14,1
7078,191926,3h1FKqVdnDmZ3yTfOEvfGnfVX1CtMfQe,SpATywNh6bZuzm8s1ceuBUnMUAeoAHHw,4,2,1,0,1,0,1,0,5,0.7142857142857143,1,0.0,0,1,0,1,2,0,0,1,0,2,3,1
7079,191941,P7vHBcOeIbOXFo3TPWP2lDcTM83EhGeU,bWdj2GDclj5ofokWjzoa5jAwMkxCykd6,1,0,0,0,0,0,4,0,4,0.5714285714285714,1,0.0,0,0,0,0,0,0,0,4,0,0,4,1
7080,191955,BoMnQ757r2rWyLplEG42Z5wOai4BClQl,SpATywNh6bZuzm8s1ceuBUnMUAeoAHHw,5,2,1,0,1,0,2,0,6,0.8571428571428571,1,0.0,0,1,0,1,2,0,0,2,0,2,4,1
7081,191956,Rb4RoMnOmkTH16vQxR6FJxXkteFqMsSl,SpATywNh6bZuzm8s1ceuBUnMUAeoAHHw,5,2,1,0,1,0,3,0,7,1.0,1,0.0,0,1,0,1,2,0,0,3,0,2,5,1
7082,191985,IN6qMq7COdhsPUWIeIwbfkPbP9c7KKGp,A3fsA9Zfv1X2fVEQhTw51lKENdNrEqT3,1,0,0,0,0,0,1,0,1,0.14285714285714285,1,0.0,0,0,0,0,0,0,0,1,0,0,1,1
7083,191989,WFLWEfQrQsuFMQB4h1DfinKxHOxaJgRw,SpATywNh6bZuzm8s1ceuBUnMUAeoAHHw,1,0,0,0,0,0,1,0,1,0.14285714285714285,1,0.0,0,0,0,0,0,0,0,1,0,0,1,1
7084,192026,Efh1AOucFRD20ZMCFA52VPOCblceahzE,SpATywNh6bZuzm8s1ceuBUnMUAeoAHHw,13,25,12,23,7,0,4,0,71,10.142857142857142,1,0.0,10,12,19,7,15,0,4,4,0,48,23,1
7085,192041,XMT1fxCKn20PfgVrzu92ZEp8ge6Hh1C8,SpATywNh6bZuzm8s1ceuBUnMUAeoAHHw,1,0,0,0,0,0,2,0,2,0.2857142857142857,1,0.0,0,0,0,0,0,0,0,2,0,0,2,1
7086,192045,dMRYTOUYlQ9p1SCjA1w6Lggb6GRAcl7F,SpATywNh6bZuzm8s1ceuBUnMUAeoAHHw,1,0,0,0,0,0,2,0,2,0.2857142857142857,1,0.0,0,0,0,0,0,0,0,2,0,0,2,1
7087,192054,AFTEQHbalt54u0CSOEb5Gff5gtuUeG8b,SpATywNh6bZuzm8s1ceuBUnMUAeoAHHw,6,2,1,0,1,0,3,0,7,1.0,1,0.0,0,1,0,1,2,0,0,3,0,2,5,1
7088,192061,uTVTksRdwbB07oR2uLGlNMnBpRxCQAXg,SpATywNh6bZuzm8s1ceuBUnMUAeoAHHw,3,5,1,0,0,0,1,0,7,1.0,1,0.0,0,1,0,0,5,0,0,1,0,1,6,1
7089,192077,vsDIa2pTzMsANsuFnkRlfs0CNdNFRShO,A3fsA9Zfv1X2fVEQhTw51lKENdNrEqT3,1,0,0,0,0,0,1,0,1,0.14285714285714285,1,0.0,0,0,0,0,0,0,0,1,0,0,1,1
7090,192094,1JKF7DnCOdaXTBELvpKByyY2uKECcREV,A3fsA9Zfv1X2fVEQhTw51lKENdNrEqT3,1,0,0,0,0,0,1,0,1,0.14285714285714285,1,0.0,0,0,0,0,0,0,0,1,0,0,1,1
7091,192104,Dk2p6h1MYjykCuVHQMak8GN098n0FvGH,SpATywNh6bZuzm8s1ceuBUnMUAeoAHHw,10,13,3,10,0,2,3,0,31,4.428571428571429,1,0.0,2,3,8,0,11,2,2,3,0,13,18,1
7092,192115,ROeS4r0zXNXDfvEicSssoPyhkNCzHO0O,SpATywNh6bZuzm8s1ceuBUnMUAeoAHHw,6,3,2,0,2,0,5,0,12,1.7142857142857142,1,0.0,0,2,0,2,3,0,0,5,0,4,8,1
7093,192133,ItSWWp12ZmgzUSMzIbnzpzxw5V6GCE6O,SpATywNh6bZuzm8s1ceuBUnMUAeoAHHw,8,2,1,0,1,2,4,2,12,1.7142857142857142,1,0.0,0,1,0,1,2,2,0,4,2,2,10,1
7094,192137,VYiSBPiiJFjQtdS8d7Gp4hibwyjeIeC0,G8EPVSXsOYB5YQWZGiz1aVq5Pgr2GrQu,9,2,0,0,0,1,14,2,19,2.7142857142857144,1,0.0,0,0,0,0,2,1,0,14,2,0,19,1
7095,192146,luNGlNTmJ26UVXohAPNf4yZNgIUDcpxK,G8EPVSXsOYB5YQWZGiz1aVq5Pgr2GrQu,1,0,0,0,0,0,1,0,1,0.14285714285714285,1,0.0,0,0,0,0,0,0,0,1,0,0,1,1
7096,192154,D0xF5k3pRFZOFsh7BuEa1nD61TTGPmxo,SpATywNh6bZuzm8s1ceuBUnMUAeoAHHw,6,4,2,0,1,2,4,0,13,1.8571428571428572,2,0.0,0,2,0,1,4,2,0,4,0,3,10,1
7097,192163,12jrpDfrACe14hfSyU7dlcaDb6lV0AX7,SpATywNh6bZuzm8s1ceuBUnMUAeoAHHw,6,3,1,0,1,0,2,0,7,1.0,1,0.0,0,1,0,1,3,0,0,2,0,2,5,1
7098,192173,ezgBG4pn9egd5PGuIQdeghPmBuYsQq9O,bWdj2GDclj5ofokWjzoa5jAwMkxCykd6,2,0,0,0,0,0,3,0,3,0.42857142857142855,1,0.0,0,0,0,0,0,0,0,3,0,0,3,1
7099,192174,gdWcAsoLOdR54U3HxoDgKlKnKUBV7xCX,G8EPVSXsOYB5YQWZGiz1aVq5Pgr2GrQu,5,7,2,0,2,0,2,0,13,1.8571428571428572,1,0.0,2,2,0,2,5,0,0,2,0,6,7,1
7100,192180,3bqYNHEttQnrSXCOjNHPi8cuvQEsNCSU,SpATywNh6bZuzm8s1ceuBUnMUAeoAHHw,16,17,9,17,7,4,6,1,61,8.714285714285714,2,0.0,4,9,14,7,13,4,3,6,1,34,27,1
7101,192182,Zn2WcWGw1Iq8LSMueWFynbJxp3D9ATzp,bWdj2GDclj5ofokWjzoa5jAwMkxCykd6,6,3,2,0,2,0,1,0,8,1.1428571428571428,1,0.0,0,2,0,2,3,0,0,1,0,4,4,1
7102,192202,4WRiJt7yDLRdAnLXyL07imUb9PD066er,G8EPVSXsOYB5YQWZGiz1aVq5Pgr2GrQu,10,3,2,0,2,0,8,2,17,2.4285714285714284,2,0.0,0,2,0,2,3,0,0,8,2,4,13,1
7103,192212,FCG6YWuKaaz2zD1Uj2uT7JnTQhXHO8IA,SpATywNh6bZuzm8s1ceuBUnMUAeoAHHw,7,12,1,0,1,0,3,0,17,2.4285714285714284,1,0.0,0,1,0,1,12,0,0,3,0,2,15,1
7104,192235,fB1Ln4rTpVlSNSwZArMTX9xX5MOVzyer,SpATywNh6bZuzm8s1ceuBUnMUAeoAHHw,7,3,2,0,2,0,3,0,10,1.4285714285714286,1,0.0,0,2,0,2,3,0,0,3,0,4,6,1
7105,192244,43uMTKmmKD0ZGUfjI6gHffJ1F3eBB7HV,SpATywNh6bZuzm8s1ceuBUnMUAeoAHHw,12,10,5,11,3,0,2,0,31,4.428571428571429,1,0.0,3,5,10,3,7,0,1,2,0,21,10,1
7106,192255,NqQoXS07qNtJAkIAmOpEhw2wLcRnmrrU,SpATywNh6bZuzm8s1ceuBUnMUAeoAHHw,4,3,1,0,0,0,1,0,5,0.7142857142857143,1,0.0,0,1,0,0,3,0,0,1,0,1,4,1
7107,192264,WnUfGeFilK9N1GtlbmsLVr7aEjsrhuHu,SpATywNh6bZuzm8s1ceuBUnMUAeoAHHw,5,3,1,0,1,0,2,0,7,1.0,1,0.0,0,1,0,1,3,0,0,2,0,2,5,1
7108,192277,MExPU9M982R5ikM7jDJpvEjyfJ2HFRXK,G8EPVSXsOYB5YQWZGiz1aVq5Pgr2GrQu,1,0,0,0,0,0,2,0,2,0.2857142857142857,1,0.0,0,0,0,0,0,0,0,2,0,0,2,1
7109,192288,8ZHyO9qRnMfYwp3tP7QulKpzu10sbQSr,A3fsA9Zfv1X2fVEQhTw51lKENdNrEqT3,1,0,0,0,0,0,1,0,1,0.14285714285714285,1,0.0,0,0,0,0,0,0,0,1,0,0,1,1
7110,192289,a7ccLvSmzFTDxQ153X5LPl9qw8dtjwJS,bWdj2GDclj5ofokWjzoa5jAwMkxCykd6,1,0,0,0,0,0,1,0,1,0.14285714285714285,1,0.0,0,0,0,0,0,0,0,1,0,0,1,1
7111,192291,u5ObOMoHUcvVsOQTGkiv0BRKKcn8v2w8,SpATywNh6bZuzm8s1ceuBUnMUAeoAHHw,5,5,4,0,2,0,1,0,12,1.7142857142857142,1,0.0,0,4,0,2,5,0,0,1,0,6,6,1
7112,192315,eGRaiLXqwboqQlaTTQYr1FB1cM61jV4I,A3fsA9Zfv1X2fVEQhTw51lKENdNrEqT3,1,0,0,0,0,0,1,0,1,0.14285714285714285,1,0.0,0,0,0,0,0,0,0,1,0,0,1,1
7113,192324,cHLNWYCLO1WUu673oiGBHY06ztWWlBMP,bWdj2GDclj5ofokWjzoa5jAwMkxCykd6,1,0,0,0,0,0,1,0,1,0.14285714285714285,1,0.0,0,0,0,0,0,0,0,1,0,0,1,1
7114,192327,ZW8MI4gpXd8J54W8a3uuPTjmv3mJCgoT,G8EPVSXsOYB5YQWZGiz1aVq5Pgr2GrQu,2,0,0,0,0,0,2,0,2,0.2857142857142857,1,0.0,0,0,0,0,0,0,0,2,0,0,2,1
7115,192367,cBgZxnbCWuxd2FofXugFoDh4OfmFe8dT,bWdj2GDclj5ofokWjzoa5jAwMkxCykd6,5,2,1,0,1,0,2,0,6,0.8571428571428571,1,0.0,0,1,0,1,2,0,0,2,0,2,4,1
7116,192372,shnL5ct8qob4HtqjYuzsqQN09ccan9RZ,bWdj2GDclj5ofokWjzoa5jAwMkxCykd6,4,5,1,0,2,0,4,0,12,1.7142857142857142,1,0.0,2,1,0,2,3,0,0,4,0,5,7,1
7117,192374,ooAUGXFOFAguQ9s1QlStBjM610gDeFBk,A3fsA9Zfv1X2fVEQhTw51lKENdNrEqT3,1,0,0,0,0,0,1,0,1,0.14285714285714285,1,0.0,0,0,0,0,0,0,0,1,0,0,1,1
7118,192378,0Tg2flbTUdD7fODqYIfpiJiK0IDdFiOP,G8EPVSXsOYB5YQWZGiz1aVq5Pgr2GrQu,7,6,1,0,0,0,9,2,18,2.5714285714285716,1,0.0,0,1,0,0,6,0,0,9,2,1,17,1
7119,192390,xWEkYGAfNptAwZnPYzVBCVMgcZk3qKaB,SpATywNh6bZuzm8s1ceuBUnMUAeoAHHw,9,15,0,0,0,0,4,0,19,2.7142857142857144,2,0.0,1,0,0,0,14,0,0,4,0,1,18,0
7120,192412,31BGhLl5fMPdcRk1AZsl6rdwMvdi9CfF,SpATywNh6bZuzm8s1ceuBUnMUAeoAHHw,7,6,5,0,5,0,2,0,18,2.5714285714285716,1,0.0,0,5,0,5,6,0,0,2,0,10,8,1
7121,192416,2aLPbnt4moA8gfuPTpLKAlOHQIQiYuAh,SpATywNh6bZuzm8s1ceuBUnMUAeoAHHw,9,4,3,0,3,0,2,0,12,1.7142857142857142,1,0.0,0,3,0,3,4,0,0,2,0,6,6,1
7122,192423,6ZFGnTjh94PbXkR7sbTLWokikXbcLQlV,SpATywNh6bZuzm8s1ceuBUnMUAeoAHHw,1,0,0,0,0,0,1,0,1,0.14285714285714285,1,0.0,0,0,0,0,0,0,0,1,0,0,1,1
7123,192429,9LhQI6E10btWpLjiUrRwj3MG72TIQ74Y,SpATywNh6bZuzm8s1ceuBUnMUAeoAHHw,7,2,0,0,0,1,5,2,10,1.4285714285714286,1,0.0,0,0,0,0,2,1,0,5,2,0,10,1
7124,192436,xHQ7Ypd5S1OzYjBAcoZTGl29nW3kI889,SpATywNh6bZuzm8s1ceuBUnMUAeoAHHw,9,15,9,0,4,4,7,1,40,5.714285714285714,1,0.0,2,9,0,4,13,4,0,7,1,15,25,1
7125,192454,2o2Mu0kizqtKfAG0EeAIvXT3SodGLvCM,A3fsA9Zfv1X2fVEQhTw51lKENdNrEqT3,1,0,0,0,0,0,2,0,2,0.2857142857142857,1,0.0,0,0,0,0,0,0,0,2,0,0,2,1
7126,192457,2o2Mu0kizqtKfAG0EeAIvXT3SodGLvCM,bWdj2GDclj5ofokWjzoa5jAwMkxCykd6,1,0,0,0,0,0,1,0,1,0.14285714285714285,1,0.0,0,0,0,0,0,0,0,1,0,0,1,1
7127,192458,3h1zqwMTeQWdhoWHPgvllPWyD6P0qFtr,A3fsA9Zfv1X2fVEQhTw51lKENdNrEqT3,2,0,0,0,0,0,2,0,2,0.2857142857142857,2,0.0,0,0,0,0,0,0,0,2,0,0,2,1
7128,193755,nKyehpqCzFKe7AQ0H2jeEWUcUDLPIpGO,SpATywNh6bZuzm8s1ceuBUnMUAeoAHHw,4,2,1,0,1,0,1,0,5,0.7142857142857143,1,0.0,0,1,0,1,2,0,0,1,0,2,3,1
7129,194249,pYpEHiiN5hrwCDFMKyLxLiOaj9mHQ7GD,SpATywNh6bZuzm8s1ceuBUnMUAeoAHHw,8,10,3,0,2,0,3,0,18,2.5714285714285716,1,0.0,0,3,0,2,10,0,0,3,0,5,13,1
7130,194505,j5jVj2bcu5kXIDJr17WzWDRjLxNGLUuO,SpATywNh6bZuzm8s1ceuBUnMUAeoAHHw,11,9,1,3,0,0,2,0,15,2.142857142857143,1,0.0,2,1,3,0,7,0,0,2,0,6,9,1
7131,194513,0SWFrShD2Nk1V8wWNIvbhD4Wg61qxonB,SpATywNh6bZuzm8s1ceuBUnMUAeoAHHw,4,2,0,0,1,0,2,0,5,0.7142857142857143,1,0.0,1,0,0,1,1,0,0,2,0,2,3,1
7132,194532,K5Sy6doI03r5uctdEcvObhW1bpzNGROt,SpATywNh6bZuzm8s1ceuBUnMUAeoAHHw,1,0,0,0,0,0,1,0,1,0.14285714285714285,1,0.0,0,0,0,0,0,0,0,1,0,0,1,1
7133,194535,fHK2jlK24YNeyNqHHz5jsgZSw0Zz3G3h,G8EPVSXsOYB5YQWZGiz1aVq5Pgr2GrQu,9,6,4,0,2,0,3,0,15,2.142857142857143,1,0.0,0,4,0,2,6,0,0,3,0,6,9,1
7134,194537,H3KvIatiAwzsCPQBVABALz431TkTR6tW,A3fsA9Zfv1X2fVEQhTw51lKENdNrEqT3,5,4,0,0,0,0,3,0,7,1.0,1,0.0,0,0,0,0,4,0,0,3,0,0,7,1
7135,194547,CBNFR2yvlMJ76Qf0H5A5aLcRXIsTpjTt,A3fsA9Zfv1X2fVEQhTw51lKENdNrEqT3,8,2,1,0,1,0,6,0,10,1.4285714285714286,1,0.0,0,1,0,1,2,0,0,6,0,2,8,1
7136,194552,VJiHrUKuVkG2Wd7Jui04ER4qa9ZGvV1t,RXDvfPUBYFlVdlueBFbLW0mhhAyGEqpt,1,0,0,0,0,0,1,0,1,0.14285714285714285,1,0.0,0,0,0,0,0,0,0,1,0,0,1,1
7137,194559,AZZvRPcRkLSa6vwofzfwsEULTUhiKy0E,bWdj2GDclj5ofokWjzoa5jAwMkxCykd6,1,0,0,0,0,0,1,0,1,0.14285714285714285,1,0.0,0,0,0,0,0,0,0,1,0,0,1,1
7138,194561,n5wUv34AuAx6Xa4DLYxEIV5L4Btui37s,SpATywNh6bZuzm8s1ceuBUnMUAeoAHHw,3,2,0,0,0,0,2,0,4,0.5714285714285714,1,0.0,0,0,0,0,2,0,0,2,0,0,4,1
7139,194575,0a9LRwLYq2zam4NcdU9Yh5C7IQvHBC1m,bWdj2GDclj5ofokWjzoa5jAwMkxCykd6,1,0,0,0,0,0,2,0,2,0.2857142857142857,1,0.0,0,0,0,0,0,0,0,2,0,0,2,0
7140,194594,GzXqA08hGJ8jcoopZQLhcubV2m4jl8LU,SpATywNh6bZuzm8s1ceuBUnMUAeoAHHw,8,7,3,0,0,1,8,1,20,2.857142857142857,1,0.0,0,3,0,0,7,1,0,8,1,3,17,1
7141,194598,fQCBMBoRMdmYhgrCFbeJRBZ7kML0GboZ,SpATywNh6bZuzm8s1ceuBUnMUAeoAHHw,10,6,5,0,4,0,2,0,17,2.4285714285714284,1,0.0,0,5,0,4,6,0,0,2,0,9,8,1
7142,194605,L7tS5WxhPVvFnR9bkUR4sVMKwjpwOVxP,bWdj2GDclj5ofokWjzoa5jAwMkxCykd6,6,11,1,0,1,0,5,0,18,2.5714285714285716,1,0.0,0,1,0,1,11,0,0,5,0,2,16,1
7143,194606,fQCBMBoRMdmYhgrCFbeJRBZ7kML0GboZ,RXDvfPUBYFlVdlueBFbLW0mhhAyGEqpt,1,0,0,0,0,0,1,0,1,0.14285714285714285,1,0.0,0,0,0,0,0,0,0,1,0,0,1,1
7144,194612,QbCiNdlMyqDCsAbTGmu0rgI2d2IPTQYV,SpATywNh6bZuzm8s1ceuBUnMUAeoAHHw,1,0,0,0,0,0,1,0,1,0.14285714285714285,1,0.0,0,0,0,0,0,0,0,1,0,0,1,1
7145,194616,0RzZnN2VlQfnUgC4UWcMDxWp2iZsqlCl,SpATywNh6bZuzm8s1ceuBUnMUAeoAHHw,9,6,3,0,1,2,7,1,20,2.857142857142857,1,0.0,0,3,0,1,6,2,0,7,1,4,16,1
7146,194620,aZ7bXLhm88jb64CpmaMPaGfxwPdIjnoI,SpATywNh6bZuzm8s1ceuBUnMUAeoAHHw,2,0,0,0,0,0,2,0,2,0.2857142857142857,1,0.0,0,0,0,0,0,0,0,2,0,0,2,1
7147,194660,6S42i3UQWxx5Vy8tElcT4nwPzZzrdR85,SpATywNh6bZuzm8s1ceuBUnMUAeoAHHw,2,0,0,0,0,0,2,0,2,0.2857142857142857,1,0.0,0,0,0,0,0,0,0,2,0,0,2,1
7148,194671,HPJrmwivOMEDkgdyN7JDkONun7b8CtmQ,SpATywNh6bZuzm8s1ceuBUnMUAeoAHHw,5,3,1,0,1,0,1,0,6,0.8571428571428571,1,0.0,0,1,0,1,3,0,0,1,0,2,4,1
7149,194673,4sHw1UrsiyaJNXlPeVCwFs89kPI7rFXb,SpATywNh6bZuzm8s1ceuBUnMUAeoAHHw,10,8,2,0,2,0,5,1,18,2.5714285714285716,1,0.0,5,2,0,2,3,0,0,5,1,9,9,1
7150,194682,fOtwdZktYnpxoylqFRzXhWQ4IRQZkjMB,A3fsA9Zfv1X2fVEQhTw51lKENdNrEqT3,7,3,2,0,2,0,2,0,9,1.2857142857142858,1,0.0,0,2,0,2,3,0,0,2,0,4,5,1
7151,194683,BoPqpHAIR2FQ1yjN5I6jPiYn67RLyUD3,A3fsA9Zfv1X2fVEQhTw51lKENdNrEqT3,3,2,0,0,0,0,1,0,3,0.42857142857142855,1,0.0,0,0,0,0,2,0,0,1,0,0,3,1
7152,194687,zeGNUT3jrsWIuoEonUpuQekYC6uAy3VD,SpATywNh6bZuzm8s1ceuBUnMUAeoAHHw,10,17,5,0,3,0,2,0,27,3.857142857142857,1,0.0,11,5,0,3,6,0,0,2,0,19,8,1
7153,194689,jWHZ4vPCIn46Q1yqOYKTzhu7yXXPh48K,SpATywNh6bZuzm8s1ceuBUnMUAeoAHHw,4,2,1,0,1,0,1,0,5,0.7142857142857143,1,0.0,0,1,0,1,2,0,0,1,0,2,3,1
7154,194700,UV3gRhbCQYEkFRwtzHQKR8Uz1PLcy3Cv,A3fsA9Zfv1X2fVEQhTw51lKENdNrEqT3,9,3,2,0,2,0,6,1,14,2.0,1,0.0,0,2,0,2,3,0,0,6,1,4,10,1
7155,194704,aBLoyZmvDn4bo6KaMYT6oQr1olyWZk2d,SpATywNh6bZuzm8s1ceuBUnMUAeoAHHw,6,3,1,0,1,0,2,0,7,1.0,1,0.0,0,1,0,1,3,0,0,2,0,2,5,1
7156,194707,JlZc44brK6lbQxfSfaJSAohGFJLWA41f,SpATywNh6bZuzm8s1ceuBUnMUAeoAHHw,1,0,0,0,0,0,1,0,1,0.14285714285714285,1,0.0,0,0,0,0,0,0,0,1,0,0,1,1
7157,194708,9T6sJuPiEkwFHn4VyREnKyR6Ni1hFol4,bWdj2GDclj5ofokWjzoa5jAwMkxCykd6,5,2,1,0,1,0,3,0,7,1.0,1,0.0,0,1,0,1,2,0,0,3,0,2,5,1
7158,194715,Ynti1kEVPZ88eymZgi4Ldsdb7WhG2uKG,SpATywNh6bZuzm8s1ceuBUnMUAeoAHHw,6,7,3,0,3,0,1,0,14,2.0,1,0.0,0,3,0,3,7,0,0,1,0,6,8,0
7159,194718,We3kejZMHXKEdbxhEAiN4oVd8fYmz3y9,A3fsA9Zfv1X2fVEQhTw51lKENdNrEqT3,2,0,0,0,0,0,3,0,3,0.42857142857142855,1,0.0,0,0,0,0,0,0,0,3,0,0,3,1
7160,194750,I2ghGumCKIaVsnJOGZA0xyJzTnEm5KtW,A3fsA9Zfv1X2fVEQhTw51lKENdNrEqT3,32,27,14,50,2,2,14,1,110,15.714285714285714,2,0.0,8,14,47,2,19,2,3,14,1,71,39,1
7161,194769,6bu6C39hyqa2rqkbngsN91OKjCxnxMLI,SpATywNh6bZuzm8s1ceuBUnMUAeoAHHw,10,12,4,16,0,0,2,0,34,4.857142857142857,1,0.0,7,4,14,0,5,0,2,2,0,25,9,1
7162,194770,L7M3Ksh9UBx3xOMl31gqtqz6gfclvqlN,G8EPVSXsOYB5YQWZGiz1aVq5Pgr2GrQu,4,3,1,0,1,0,1,0,6,0.8571428571428571,1,0.0,0,1,0,1,3,0,0,1,0,2,4,1
7163,194797,NFBFv8TG60SG6ScKXY2TuDjWLm29gAEO,G8EPVSXsOYB5YQWZGiz1aVq5Pgr2GrQu,21,19,10,18,4,2,7,1,61,8.714285714285714,1,0.0,5,10,15,4,14,2,3,7,1,34,27,0
7164,194812,U1JFUNAXc1AkReOZ8wdY4hTFUY2t5lXd,SpATywNh6bZuzm8s1ceuBUnMUAeoAHHw,4,3,1,0,1,0,1,0,6,0.8571428571428571,1,0.0,0,1,0,1,3,0,0,1,0,2,4,1
7165,194819,8mJzNtbbhYVCgZPRtpQ3nYyV12q5x7iP,SpATywNh6bZuzm8s1ceuBUnMUAeoAHHw,6,3,1,0,1,0,2,0,7,1.0,1,0.0,0,1,0,1,3,0,0,2,0,2,5,1
7166,194838,0Rc9QmalpGXvwxh2iIaT1Kf7aHCEMOJW,bWdj2GDclj5ofokWjzoa5jAwMkxCykd6,2,0,0,0,0,0,2,0,2,0.2857142857142857,1,0.0,0,0,0,0,0,0,0,2,0,0,2,1
7167,194840,9uetg4jrkfyr9l65M4782Ix4xyAceyAw,SpATywNh6bZuzm8s1ceuBUnMUAeoAHHw,4,2,1,0,0,0,2,0,5,0.7142857142857143,1,0.0,0,1,0,0,2,0,0,2,0,1,4,1
7168,194856,TfgVRC9skFsGu3qq14caEQmfjmrp7rot,SpATywNh6bZuzm8s1ceuBUnMUAeoAHHw,1,0,0,0,0,0,1,0,1,0.14285714285714285,1,0.0,0,0,0,0,0,0,0,1,0,0,1,1
7169,194884,hjZ9Xmjh9fy8zpJXBG9oc3s2Pno9M1Qj,G8EPVSXsOYB5YQWZGiz1aVq5Pgr2GrQu,16,14,5,12,5,0,9,1,46,6.571428571428571,1,0.0,8,5,10,5,6,0,2,9,1,28,18,1
7170,194894,KpYtE2oiCacGgvHDiOR9EPHvEG8K5VAH,A3fsA9Zfv1X2fVEQhTw51lKENdNrEqT3,14,4,3,42,1,0,1,0,51,7.285714285714286,1,0.0,0,3,37,1,4,0,5,1,0,41,10,1
7171,194898,EoYsxsuekHFOGMEOJolKStlPHqzqAJps,SpATywNh6bZuzm8s1ceuBUnMUAeoAHHw,1,0,0,0,0,0,1,0,1,0.14285714285714285,1,0.0,0,0,0,0,0,0,0,1,0,0,1,1
7172,194899,CJ8rz0JWIuI4wzHfaCoKLPdQC5hP7L8o,SpATywNh6bZuzm8s1ceuBUnMUAeoAHHw,2,0,0,0,0,0,2,0,2,0.2857142857142857,1,0.0,0,0,0,0,0,0,0,2,0,0,2,1
7173,194911,coZTr10eytnE55me2AxqRWq6qrVXEB7M,A3fsA9Zfv1X2fVEQhTw51lKENdNrEqT3,6,6,3,0,1,0,3,0,13,1.8571428571428572,1,0.0,0,3,0,1,6,0,0,3,0,4,9,1
7174,194920,nAKoJ3KJH4tNdKl2KzEFM3pKVZsfxNEo,SpATywNh6bZuzm8s1ceuBUnMUAeoAHHw,9,7,1,0,1,0,3,0,12,1.7142857142857142,1,0.0,0,1,0,1,7,0,0,3,0,2,10,1
7175,194938,iUqEEHE7KFlYvrJ9lttneq6sdDOxoE0o,A3fsA9Zfv1X2fVEQhTw51lKENdNrEqT3,1,0,0,0,0,0,1,0,1,0.14285714285714285,1,0.0,0,0,0,0,0,0,0,1,0,0,1,1
7176,194944,5yeJY3nTHKOfgXEh2NQejnxfnR8LFeFo,SpATywNh6bZuzm8s1ceuBUnMUAeoAHHw,6,5,2,0,2,0,1,0,10,1.4285714285714286,1,0.0,0,2,0,2,5,0,0,1,0,4,6,1
7177,194964,i0Fe8GkgETgJLYZf4oG1MMDT0SsDr0Jw,G8EPVSXsOYB5YQWZGiz1aVq5Pgr2GrQu,13,5,4,8,3,0,1,0,21,3.0,1,0.0,0,4,8,3,5,0,0,1,0,15,6,1
7178,194990,ULvgH0dn9cMQ7RqvqnSWbMcAlKJJQ0Fk,A3fsA9Zfv1X2fVEQhTw51lKENdNrEqT3,4,3,1,0,1,0,2,0,7,1.0,1,0.0,0,1,0,1,3,0,0,2,0,2,5,0
7179,194991,ULvgH0dn9cMQ7RqvqnSWbMcAlKJJQ0Fk,RXDvfPUBYFlVdlueBFbLW0mhhAyGEqpt,4,3,1,0,1,0,2,0,7,1.0,1,0.0,0,1,0,1,3,0,0,2,0,2,5,1
7180,195000,h2BiSzi5m6dXS3KusokZajeewmz5ASZK,SpATywNh6bZuzm8s1ceuBUnMUAeoAHHw,1,0,0,0,0,0,1,0,1,0.14285714285714285,1,0.0,0,0,0,0,0,0,0,1,0,0,1,1
7181,195011,NgAo8zTwzEL5kdUZa1oY4oYdY9RywdJx,bWdj2GDclj5ofokWjzoa5jAwMkxCykd6,1,0,0,0,0,0,1,0,1,0.14285714285714285,1,0.0,0,0,0,0,0,0,0,1,0,0,1,1
7182,195028,A7Dy7wBvIZYcTIZR94lL6Ks9jKNwU0Wy,bWdj2GDclj5ofokWjzoa5jAwMkxCykd6,6,2,1,0,1,0,3,0,7,1.0,1,0.0,0,1,0,1,2,0,0,3,0,2,5,1
7183,195048,KGzfXe849hKjIs0BHn7D33gnH3hOFhhi,A3fsA9Zfv1X2fVEQhTw51lKENdNrEqT3,1,0,0,0,0,0,1,0,1,0.14285714285714285,1,0.0,0,0,0,0,0,0,0,1,0,0,1,1
7184,195050,1qqlfnvXgcooPyZOwWYRIPDMSQDSWipF,A3fsA9Zfv1X2fVEQhTw51lKENdNrEqT3,8,4,3,0,2,0,2,0,11,1.5714285714285714,1,0.0,0,3,0,2,4,0,0,2,0,5,6,1
7185,195054,EboqTOLce3Kcnbr13rePsINEM3noHrcD,SpATywNh6bZuzm8s1ceuBUnMUAeoAHHw,1,0,0,0,0,0,3,0,3,0.42857142857142855,1,0.0,0,0,0,0,0,0,0,3,0,0,3,1
7186,195067,0hhH7SwEpwXhVryAlzllJZZoxMiaryTB,A3fsA9Zfv1X2fVEQhTw51lKENdNrEqT3,2,0,0,0,0,0,3,0,3,0.42857142857142855,1,0.0,0,0,0,0,0,0,0,3,0,0,3,1
7187,195070,LcDHI9VirEpxfDmLtYSK63dNG6QfI1o9,bWdj2GDclj5ofokWjzoa5jAwMkxCykd6,1,0,0,0,0,0,2,0,2,0.2857142857142857,1,0.0,0,0,0,0,0,0,0,2,0,0,2,1
7188,195096,VblkSmB0qnt2Sn7mKykILqjl5hQ7D7Rd,SpATywNh6bZuzm8s1ceuBUnMUAeoAHHw,8,3,0,0,0,4,5,1,13,1.8571428571428572,1,0.0,0,0,0,0,3,4,0,5,1,0,13,1
7189,195105,L8lHLh6Mth1S7I3sErP5oDZD885a1BOh,RXDvfPUBYFlVdlueBFbLW0mhhAyGEqpt,4,4,3,0,2,0,1,0,10,1.4285714285714286,1,0.0,0,3,0,2,4,0,0,1,0,5,5,1
7190,195123,9bRCoX5aFYQHE9DZm9jyLHKfMlQ7Zegu,A3fsA9Zfv1X2fVEQhTw51lKENdNrEqT3,15,10,8,0,6,0,19,1,44,6.285714285714286,1,0.0,0,8,0,6,10,0,0,19,1,14,30,1
7191,195133,0vh8eAAsIFnTSYCbme0HYH2GZabOpyjO,SpATywNh6bZuzm8s1ceuBUnMUAeoAHHw,6,4,3,0,0,0,2,0,9,1.2857142857142858,1,0.0,0,3,0,0,4,0,0,2,0,3,6,1
7192,195134,lIXwq3JER4SWrE0O7y1NzGhial9PDy2H,RXDvfPUBYFlVdlueBFbLW0mhhAyGEqpt,9,4,3,0,3,0,2,0,12,1.7142857142857142,1,0.0,0,3,0,3,4,0,0,2,0,6,6,1
7193,195138,zcYW5hQJaAne538I54YBHKKIHPYdcKzR,SpATywNh6bZuzm8s1ceuBUnMUAeoAHHw,3,0,0,0,0,0,3,0,3,0.42857142857142855,1,0.0,0,0,0,0,0,0,0,3,0,0,3,1
7194,195139,WKjm9NNrYTUj7AQwUBj4LGUEStoUuQbI,A3fsA9Zfv1X2fVEQhTw51lKENdNrEqT3,5,2,1,0,1,0,3,0,7,1.0,1,0.0,0,1,0,1,2,0,0,3,0,2,5,1
7195,195143,ZD6KzBJPXfWBkZLRMcl4p14dD6WWX4Ih,SpATywNh6bZuzm8s1ceuBUnMUAeoAHHw,10,14,0,2,0,0,4,0,20,2.857142857142857,1,0.0,2,0,2,0,12,0,0,4,0,4,16,1
7196,195148,AH5vrBLwc7s7uQQh3dO8uaZFfBQDcQxi,SpATywNh6bZuzm8s1ceuBUnMUAeoAHHw,1,0,0,0,0,0,1,0,1,0.14285714285714285,1,0.0,0,0,0,0,0,0,0,1,0,0,1,1
7197,195168,lk6sSo2mEoREiTaQjIlY6dKahZkFRKmP,A3fsA9Zfv1X2fVEQhTw51lKENdNrEqT3,1,0,0,0,0,0,1,0,1,0.14285714285714285,1,0.0,0,0,0,0,0,0,0,1,0,0,1,1
7198,195172,TzUoSJ3pyMjwCKLIHuVSKLad9h9hLr5U,A3fsA9Zfv1X2fVEQhTw51lKENdNrEqT3,4,4,0,0,0,0,1,0,5,0.7142857142857143,1,0.0,0,0,0,0,4,0,0,1,0,0,5,1
7199,195192,hT3gwKIRPmJxcgYf5liQovlZBdIJz1xq,SpATywNh6bZuzm8s1ceuBUnMUAeoAHHw,1,0,0,0,0,0,1,0,1,0.14285714285714285,1,0.0,0,0,0,0,0,0,0,1,0,0,1,1
7200,195202,FVkmb2ERZAYNUD3Q1ZAc0irCEUsLVQQz,SpATywNh6bZuzm8s1ceuBUnMUAeoAHHw,5,2,1,0,1,0,2,0,6,0.8571428571428571,1,0.0,0,1,0,1,2,0,0,2,0,2,4,1
7201,195215,MTAnkeTQnWs9GdHH6O5LRyYCh9iX5uP4,RXDvfPUBYFlVdlueBFbLW0mhhAyGEqpt,1,0,0,0,0,0,2,0,2,0.2857142857142857,1,0.0,0,0,0,0,0,0,0,2,0,0,2,1
7202,195218,abz0JUG7GWWef4jRyaayLqZkxtxXeHAT,SpATywNh6bZuzm8s1ceuBUnMUAeoAHHw,5,3,2,0,2,0,2,0,9,1.2857142857142858,1,0.0,0,2,0,2,3,0,0,2,0,4,5,1
7203,195226,xQ2ZtBKsHIRujsTwaOBWpiIEohBtlo5W,SpATywNh6bZuzm8s1ceuBUnMUAeoAHHw,7,10,5,0,1,0,2,0,18,2.5714285714285716,1,0.0,3,5,0,1,7,0,0,2,0,9,9,1
7204,195234,r0nvOJG3TaeLm69nhbeK6crtYznkTFB2,SpATywNh6bZuzm8s1ceuBUnMUAeoAHHw,7,5,2,0,2,0,4,0,13,1.8571428571428572,1,0.0,2,2,0,2,3,0,0,4,0,6,7,1
7205,195236,fIET0xNMcDIlnjd0AnC9TZEnn5s3AA6i,A3fsA9Zfv1X2fVEQhTw51lKENdNrEqT3,1,0,0,0,0,0,1,0,1,0.14285714285714285,1,0.0,0,0,0,0,0,0,0,1,0,0,1,1
7206,195239,bONRCO0uATZ9orvOXASjWia0swY9AaMZ,bWdj2GDclj5ofokWjzoa5jAwMkxCykd6,6,2,1,0,1,0,3,0,7,1.0,1,0.0,0,1,0,1,2,0,0,3,0,2,5,1
7207,195258,JIBg2bFQYc7ncSPQhvBWrAlcobShyiXA,G8EPVSXsOYB5YQWZGiz1aVq5Pgr2GrQu,5,2,0,0,0,0,3,1,6,0.8571428571428571,1,0.0,0,0,0,0,2,0,0,3,1,0,6,1
7208,195271,H9TBxem7IeyaJ30CPoPNOnkpc9xO2MQu,SpATywNh6bZuzm8s1ceuBUnMUAeoAHHw,1,0,0,0,0,0,1,0,1,0.14285714285714285,1,0.0,0,0,0,0,0,0,0,1,0,0,1,1
7209,195274,83JPfkin3GX4GLKqML2uaHSZ5KvsuJhM,G8EPVSXsOYB5YQWZGiz1aVq5Pgr2GrQu,2,0,0,0,0,3,1,0,4,0.5714285714285714,1,0.0,0,0,0,0,0,3,0,1,0,0,4,1
7210,195281,JHMFz2Gy459G1ldyhA75ALSO8YlPxA4n,bWdj2GDclj5ofokWjzoa5jAwMkxCykd6,9,7,3,0,3,0,2,0,15,2.142857142857143,1,0.0,0,3,0,3,7,0,0,2,0,6,9,1
7211,195287,ouhJVRUNWH7xFlD4xC7qUWcBbb5kOVSM,G8EPVSXsOYB5YQWZGiz1aVq5Pgr2GrQu,4,2,0,0,0,1,6,0,9,1.2857142857142858,1,0.0,0,0,0,0,2,1,0,6,0,0,9,1
7212,195305,jvZodiJQZU7RrA7XB4M3G0LE2sozlnz7,SpATywNh6bZuzm8s1ceuBUnMUAeoAHHw,10,22,2,0,2,1,10,0,37,5.285714285714286,1,0.0,9,2,0,2,13,1,0,10,0,13,24,1
7213,195310,a4n3ibeXbsub5EdlaCwB08x9krqRlEDa,A3fsA9Zfv1X2fVEQhTw51lKENdNrEqT3,1,0,0,0,0,0,1,0,1,0.14285714285714285,1,0.0,0,0,0,0,0,0,0,1,0,0,1,1
7214,195330,0htbMyPoZSLGh1Ogweb6zD7W8pfwScFx,SpATywNh6bZuzm8s1ceuBUnMUAeoAHHw,6,0,0,0,0,0,6,1,7,1.0,1,0.0,0,0,0,0,0,0,0,6,1,0,7,1
7215,195344,cA8asOLHRHcK3Kr0VMyGtrDdcfovAiM5,SpATywNh6bZuzm8s1ceuBUnMUAeoAHHw,10,4,4,0,4,0,3,0,15,2.142857142857143,1,0.0,0,4,0,4,4,0,0,3,0,8,7,1
7216,195347,P608wg2hLiaVE1CUhuKbnmhkIP7IEvsI,A3fsA9Zfv1X2fVEQhTw51lKENdNrEqT3,1,0,0,0,0,0,1,0,1,0.14285714285714285,1,0.0,0,0,0,0,0,0,0,1,0,0,1,1
7217,195366,EnaSTRqxkWjMR8pSWQe4ipdWniwPtGKE,SpATywNh6bZuzm8s1ceuBUnMUAeoAHHw,9,8,2,0,2,0,4,0,16,2.2857142857142856,1,0.0,0,2,0,2,8,0,0,4,0,4,12,1
7218,195370,OxLv0CDANbcaaaoNVUlIdXfqEbT45GpW,SpATywNh6bZuzm8s1ceuBUnMUAeoAHHw,1,0,0,0,0,0,3,0,3,0.42857142857142855,1,0.0,0,0,0,0,0,0,0,3,0,0,3,1
7219,195381,KMHV70a7rpZuAmNpI2Il8aVBDDazbOMO,A3fsA9Zfv1X2fVEQhTw51lKENdNrEqT3,5,2,1,0,1,1,2,0,7,1.0,1,0.0,0,1,0,1,2,1,0,2,0,2,5,1
7220,195383,NXEwBXbU6vvce77sujWgRB6LivhFJvRb,G8EPVSXsOYB5YQWZGiz1aVq5Pgr2GrQu,1,0,0,0,0,0,1,0,1,0.14285714285714285,1,0.0,0,0,0,0,0,0,0,1,0,0,1,1
7221,195392,e5lpY3trke6nXvypvGSIiUjB91TX04sJ,G8EPVSXsOYB5YQWZGiz1aVq5Pgr2GrQu,11,7,4,0,4,0,3,0,18,2.5714285714285716,1,0.0,2,4,0,4,5,0,0,3,0,10,8,1
7222,195405,GR3TNNEdaPxz3Wim5wCYlS1FUuZ9ygFu,SpATywNh6bZuzm8s1ceuBUnMUAeoAHHw,6,2,1,0,1,1,4,0,9,1.2857142857142858,1,0.0,0,1,0,1,2,1,0,4,0,2,7,1
7223,195420,c8hHWOR1LOb1dNnGiimGKTmT5f2lhdqf,G8EPVSXsOYB5YQWZGiz1aVq5Pgr2GrQu,2,1,0,0,0,0,1,0,2,0.2857142857142857,1,0.0,0,0,0,0,1,0,0,1,0,0,2,1
7224,195431,uo6XWLpCc9aLEsRInaYzNhRYRrPEd76a,A3fsA9Zfv1X2fVEQhTw51lKENdNrEqT3,13,6,5,0,5,0,3,0,19,2.7142857142857144,1,0.0,0,5,0,5,6,0,0,3,0,10,9,1
7225,195433,nJkkRmbTjzmjz5X8FxdffFf8Y1I78bGw,SpATywNh6bZuzm8s1ceuBUnMUAeoAHHw,6,4,2,0,2,0,2,0,10,1.4285714285714286,1,0.0,0,2,0,2,4,0,0,2,0,4,6,0
7226,195439,rwvZ7FfuNpbh9VhQHt7eVb6FQWLjKGy4,SpATywNh6bZuzm8s1ceuBUnMUAeoAHHw,1,0,0,0,0,0,1,0,1,0.14285714285714285,1,0.0,0,0,0,0,0,0,0,1,0,0,1,1
7227,195455,HIY4CHwa8u7VF0AwJglD4ImtKKzbU3gm,G8EPVSXsOYB5YQWZGiz1aVq5Pgr2GrQu,8,9,0,0,1,13,6,2,31,4.428571428571429,1,0.0,2,0,0,1,7,13,0,6,2,3,28,1
7228,195459,IyN6z4xrJLEbmfDFZipqdcIPNBoMNgik,SpATywNh6bZuzm8s1ceuBUnMUAeoAHHw,5,2,1,0,1,0,2,0,6,0.8571428571428571,1,0.0,0,1,0,1,2,0,0,2,0,2,4,1
7229,195462,x5Bs4lB8d8XfmyyIE5x0cYPvnoiorBpL,SpATywNh6bZuzm8s1ceuBUnMUAeoAHHw,5,3,2,0,1,0,1,0,7,1.0,1,0.0,0,2,0,1,3,0,0,1,0,3,4,1
7230,195485,WnSnDWbUpPwgyOqh9KapbEmhFpxGdgxn,SpATywNh6bZuzm8s1ceuBUnMUAeoAHHw,1,0,0,0,0,0,1,0,1,0.14285714285714285,1,0.0,0,0,0,0,0,0,0,1,0,0,1,1
7231,195504,dfSV6MVOjiUgDK7JKupNIc842GwgOkeF,A3fsA9Zfv1X2fVEQhTw51lKENdNrEqT3,1,0,0,0,0,0,1,0,1,0.14285714285714285,1,0.0,0,0,0,0,0,0,0,1,0,0,1,1
7232,195532,7ckF3LPSV13LgZ2Fg6VdSWg1opJZgrXH,SpATywNh6bZuzm8s1ceuBUnMUAeoAHHw,2,0,0,0,0,0,2,0,2,0.2857142857142857,1,0.0,0,0,0,0,0,0,0,2,0,0,2,1
7233,195537,EaFWRMbtKR52j7nbPydGVwuzgPsml9aN,RXDvfPUBYFlVdlueBFbLW0mhhAyGEqpt,1,0,0,0,0,0,1,0,1,0.14285714285714285,1,0.0,0,0,0,0,0,0,0,1,0,0,1,1
7234,195556,GmAgRxUlxl118Xo8rOFwbcuTp9uDnYde,SpATywNh6bZuzm8s1ceuBUnMUAeoAHHw,17,14,8,16,5,1,9,1,54,7.714285714285714,1,0.0,5,8,13,5,9,1,3,9,1,31,23,1
7235,195561,iZqC3Cf6t3CzqiiohlVddd9vHxMr4jyG,bWdj2GDclj5ofokWjzoa5jAwMkxCykd6,8,2,1,0,1,0,6,1,11,1.5714285714285714,1,0.0,0,1,0,1,2,0,0,6,1,2,9,1
7236,195564,augCFReFBQs2gO1ZsbARNIDALhMdNkTr,SpATywNh6bZuzm8s1ceuBUnMUAeoAHHw,1,0,0,0,0,0,2,0,2,0.2857142857142857,1,0.0,0,0,0,0,0,0,0,2,0,0,2,1
7237,195566,V7zoEtLfhU5rtj42pQGAui9L72mSu8fB,SpATywNh6bZuzm8s1ceuBUnMUAeoAHHw,5,3,1,0,1,0,1,0,6,0.8571428571428571,1,0.0,0,1,0,1,3,0,0,1,0,2,4,1
7238,196306,X6Lezij464ccKeng4uwKJTPF9kfTAT6Z,SpATywNh6bZuzm8s1ceuBUnMUAeoAHHw,1,0,0,0,0,0,1,0,1,0.14285714285714285,1,0.0,0,0,0,0,0,0,0,1,0,0,1,1
7239,196307,X6Lezij464ccKeng4uwKJTPF9kfTAT6Z,RXDvfPUBYFlVdlueBFbLW0mhhAyGEqpt,7,8,4,0,2,0,3,0,17,2.4285714285714284,1,0.0,0,4,0,2,8,0,0,3,0,6,11,1
7240,196705,bZa2cKnNlVdaH2zh1KBEDwy94lOurAbl,A3fsA9Zfv1X2fVEQhTw51lKENdNrEqT3,5,2,1,0,1,0,3,0,7,1.0,1,0.0,0,1,0,1,2,0,0,3,0,2,5,1
7241,197539,KgsFs481TCjQwvLPKxf7Q7ylhhpHCPhV,A3fsA9Zfv1X2fVEQhTw51lKENdNrEqT3,1,0,0,0,0,0,1,0,1,0.14285714285714285,1,0.0,0,0,0,0,0,0,0,1,0,0,1,1
7242,197555,mI8VCRBSYdxznLkfNYlx0gUNvZ04sNfj,SpATywNh6bZuzm8s1ceuBUnMUAeoAHHw,1,0,0,0,0,0,1,0,1,0.14285714285714285,1,0.0,0,0,0,0,0,0,0,1,0,0,1,1
7243,197567,zGQkx7I5R9FuZgfmXPXAegIJkfQnaSVg,SpATywNh6bZuzm8s1ceuBUnMUAeoAHHw,9,4,2,0,2,0,4,3,15,2.142857142857143,1,0.0,1,2,0,2,3,0,0,4,3,5,10,1
7244,197568,fBs8B9TyWeZ3NFnjocJnCJ1lDFqvyofp,SpATywNh6bZuzm8s1ceuBUnMUAeoAHHw,1,0,0,0,0,0,1,0,1,0.14285714285714285,1,0.0,0,0,0,0,0,0,0,1,0,0,1,1
7245,197590,sszCBt8cghX6qgFnXDzG8r5isZBGG9No,bWdj2GDclj5ofokWjzoa5jAwMkxCykd6,1,0,0,0,0,0,1,0,1,0.14285714285714285,1,0.0,0,0,0,0,0,0,0,1,0,0,1,1
7246,197605,xWQhq9RZKw08hANIa0LgFXN2DnwycQf4,A3fsA9Zfv1X2fVEQhTw51lKENdNrEqT3,1,0,0,0,0,0,1,0,1,0.14285714285714285,1,0.0,0,0,0,0,0,0,0,1,0,0,1,1
7247,197607,oarWFl12GJz5VOCw3d9cT9LuNMnlfaty,SpATywNh6bZuzm8s1ceuBUnMUAeoAHHw,9,11,1,8,0,5,7,0,32,4.571428571428571,1,0.0,0,1,6,0,11,5,2,7,0,7,25,1
7248,197610,PsqZXIXDMOG5Y38IYf7VtFHU6aWciJTC,A3fsA9Zfv1X2fVEQhTw51lKENdNrEqT3,4,2,0,0,0,0,3,0,5,0.7142857142857143,1,0.0,0,0,0,0,2,0,0,3,0,0,5,1
7249,197613,McYATdhZDDMDpni6a4GbjI06ustMpvdV,RXDvfPUBYFlVdlueBFbLW0mhhAyGEqpt,5,2,1,0,1,0,2,0,6,0.8571428571428571,1,0.0,0,1,0,1,2,0,0,2,0,2,4,1
7250,197630,GlVmjWGZ8XsOuLGdZvtzRw0xzELGNzxx,A3fsA9Zfv1X2fVEQhTw51lKENdNrEqT3,1,0,0,0,0,0,1,0,1,0.14285714285714285,1,0.0,0,0,0,0,0,0,0,1,0,0,1,1
7251,197637,y0PkAopIdLmRFrkWC9eBHvWT77KfVWMh,bWdj2GDclj5ofokWjzoa5jAwMkxCykd6,5,5,2,0,2,0,2,0,11,1.5714285714285714,1,0.0,0,2,0,2,5,0,0,2,0,4,7,1
7252,197647,yJyieqiQ74x4K1fGefSNl8T336TNyMah,G8EPVSXsOYB5YQWZGiz1aVq5Pgr2GrQu,7,5,3,0,1,0,3,0,12,1.7142857142857142,1,0.0,0,3,0,1,5,0,0,3,0,4,8,1
7253,197666,NXEwBXbU6vvce77sujWgRB6LivhFJvRb,bWdj2GDclj5ofokWjzoa5jAwMkxCykd6,4,2,1,0,1,0,2,0,6,0.8571428571428571,1,0.0,0,1,0,1,2,0,0,2,0,2,4,0
7254,197686,IlMRFFFNuG5w9EpYG3Dyt8Sj1nCtwb6Z,SpATywNh6bZuzm8s1ceuBUnMUAeoAHHw,6,8,4,0,0,0,1,0,13,1.8571428571428572,1,0.0,0,4,0,0,8,0,0,1,0,4,9,1
7255,197694,CLJmxLRlSw5V2HPI140IDE0f4EOszt4Y,SpATywNh6bZuzm8s1ceuBUnMUAeoAHHw,1,0,0,0,0,0,1,0,1,0.14285714285714285,1,0.0,0,0,0,0,0,0,0,1,0,0,1,1
7256,197701,irsB3oA9q2Yuz0rnZheRoFNJtkEWBPEv,SpATywNh6bZuzm8s1ceuBUnMUAeoAHHw,1,0,0,0,0,0,1,0,1,0.14285714285714285,1,0.0,0,0,0,0,0,0,0,1,0,0,1,1
7257,197705,Q2m4p3E1xU5tjACIAMpsbnVuTeuD9Zj8,RXDvfPUBYFlVdlueBFbLW0mhhAyGEqpt,1,0,0,0,0,0,1,0,1,0.14285714285714285,1,0.0,0,0,0,0,0,0,0,1,0,0,1,1
7258,197748,lvB2HAmzN6WpjnZWZKcaAAjy9p9VjGaG,SpATywNh6bZuzm8s1ceuBUnMUAeoAHHw,4,4,1,0,0,0,1,0,6,0.8571428571428571,1,0.0,1,1,0,0,3,0,0,1,0,2,4,1
7259,197754,DIr3Wrj5z4hYJwtDO9ijYT7A5ei5kcOt,SpATywNh6bZuzm8s1ceuBUnMUAeoAHHw,5,4,0,0,0,1,2,0,7,1.0,1,0.0,0,0,0,0,4,1,0,2,0,0,7,1
7260,197760,syyc0SZ7JGCYLXzo3H6grsNKbnA69vWI,SpATywNh6bZuzm8s1ceuBUnMUAeoAHHw,15,14,4,12,3,1,6,1,41,5.857142857142857,1,0.0,9,4,12,3,5,1,0,6,1,28,13,1
7261,197775,ate9cHga4fvGZQe84ZmaH3duYZ3g1R1F,G8EPVSXsOYB5YQWZGiz1aVq5Pgr2GrQu,9,5,4,0,3,2,4,0,18,2.5714285714285716,1,0.0,0,4,0,3,5,2,0,4,0,7,11,1
7262,197793,BxOnqjgkTpP6bgtURLXQygVvMj5N3Ti3,SpATywNh6bZuzm8s1ceuBUnMUAeoAHHw,7,4,0,0,0,0,5,1,10,1.4285714285714286,1,0.0,0,0,0,0,4,0,0,5,1,0,10,1
7263,197798,ZECsrQDWNf4nPUfo4HpZsLiXc2swEQ6q,SpATywNh6bZuzm8s1ceuBUnMUAeoAHHw,5,4,3,0,1,0,1,0,9,1.2857142857142858,1,0.0,0,3,0,1,4,0,0,1,0,4,5,1
7264,197810,doaL1TzO9FZY2ziOksLPhVRKrqvsMpej,SpATywNh6bZuzm8s1ceuBUnMUAeoAHHw,6,2,1,0,1,0,3,0,7,1.0,1,0.0,0,1,0,1,2,0,0,3,0,2,5,1
7265,197820,6WpUAvOn0104PVGU1qRupfdkikcVBl8O,SpATywNh6bZuzm8s1ceuBUnMUAeoAHHw,7,11,3,6,0,0,2,0,22,3.142857142857143,1,0.0,2,3,5,0,9,0,1,2,0,10,12,1
7266,197829,4ZyQJ5jYIytY6BbDJp7B3MYaAhi1NvbZ,SpATywNh6bZuzm8s1ceuBUnMUAeoAHHw,1,0,0,0,0,0,1,0,1,0.14285714285714285,1,0.0,0,0,0,0,0,0,0,1,0,0,1,1
7267,197846,qePcgnp7eGbGREyZzIMf7xZBiRdT6s9H,SpATywNh6bZuzm8s1ceuBUnMUAeoAHHw,5,2,1,0,1,0,2,0,6,0.8571428571428571,1,0.0,0,1,0,1,2,0,0,2,0,2,4,1
7268,197851,HwQlDqQYrfHrBUx2SSkCNQ3Dej1xgfkf,A3fsA9Zfv1X2fVEQhTw51lKENdNrEqT3,4,3,0,0,0,0,5,0,8,1.1428571428571428,1,0.0,0,0,0,0,3,0,0,5,0,0,8,1
7269,197889,bjP4zb5x0G9Cc1USSNLgNUtaJAQzeUAu,A3fsA9Zfv1X2fVEQhTw51lKENdNrEqT3,4,4,0,0,0,0,2,0,6,0.8571428571428571,1,0.0,0,0,0,0,4,0,0,2,0,0,6,1
7270,197898,QTE6XpirXhdZj0nCidu516iE2M5a9YWy,SpATywNh6bZuzm8s1ceuBUnMUAeoAHHw,4,3,2,0,2,0,1,0,8,1.1428571428571428,1,0.0,0,2,0,2,3,0,0,1,0,4,4,1
7271,197940,pXqF8hGJZiVQMekFKWzwpXptQULIbit3,A3fsA9Zfv1X2fVEQhTw51lKENdNrEqT3,1,0,0,0,0,0,1,0,1,0.14285714285714285,1,0.0,0,0,0,0,0,0,0,1,0,0,1,1
7272,197946,hICMvevjXddBWDZc80Udm3Jkv903MANA,A3fsA9Zfv1X2fVEQhTw51lKENdNrEqT3,7,4,2,0,2,0,1,0,9,1.2857142857142858,1,0.0,0,2,0,2,4,0,0,1,0,4,5,1
7273,197948,hw7IvcaYFJuJeZABsZjmbMK4OkcJdM6i,bWdj2GDclj5ofokWjzoa5jAwMkxCykd6,6,5,4,0,4,0,2,0,15,2.142857142857143,1,0.0,0,4,0,4,5,0,0,2,0,8,7,1
7274,197962,xp0PGlV4qhp60qYyxRe8xCxRmmPbM3Jj,A3fsA9Zfv1X2fVEQhTw51lKENdNrEqT3,2,0,0,0,0,0,4,0,4,0.5714285714285714,1,0.0,0,0,0,0,0,0,0,4,0,0,4,1
7275,197980,lQYiHkk4y0zDXyHNzb0tlv73qls5L2Vm,SpATywNh6bZuzm8s1ceuBUnMUAeoAHHw,5,4,0,0,0,0,4,0,8,1.1428571428571428,1,0.0,0,0,0,0,4,0,0,4,0,0,8,1
7276,198003,mJztKjO5nESo6T2c5pukm2m7KLliSS8S,A3fsA9Zfv1X2fVEQhTw51lKENdNrEqT3,10,5,3,0,3,4,3,0,18,2.5714285714285716,1,0.0,0,3,0,3,5,4,0,3,0,6,12,1
7277,198006,zkqKiyV6OvwyKPkyCN37KC4hTRCpZYCH,A3fsA9Zfv1X2fVEQhTw51lKENdNrEqT3,10,7,5,0,4,0,3,0,19,2.7142857142857144,1,0.0,0,5,0,4,7,0,0,3,0,9,10,1
7278,198018,XwJMK5oKK2pkH5F1a5Sx8BXHH3EqGmzs,A3fsA9Zfv1X2fVEQhTw51lKENdNrEqT3,25,3,1,56,1,0,4,0,65,9.285714285714286,1,0.0,1,1,55,1,2,0,1,4,0,58,7,1
7279,198022,Mv7lfepPwMiuMAg4tPzXsqZKJDYbRo5M,RXDvfPUBYFlVdlueBFbLW0mhhAyGEqpt,6,3,1,0,0,0,5,0,9,1.2857142857142858,1,0.0,0,1,0,0,3,0,0,5,0,1,8,1
7280,198026,NrHk4qmJXuD0TsjkQSnghKpk9ZjGAOyU,A3fsA9Zfv1X2fVEQhTw51lKENdNrEqT3,8,9,6,0,6,0,1,0,22,3.142857142857143,1,0.0,0,6,0,6,9,0,0,1,0,12,10,1
7281,198028,HePRyod5aTSIcFeoVudB8huyR12d5o5i,A3fsA9Zfv1X2fVEQhTw51lKENdNrEqT3,7,3,2,0,2,0,4,0,11,1.5714285714285714,1,0.0,0,2,0,2,3,0,0,4,0,4,7,0
7282,198029,4SbF4DhXcYorYYyJ4XmwwPJZFVh1ZUhY,A3fsA9Zfv1X2fVEQhTw51lKENdNrEqT3,6,3,2,0,1,0,5,0,11,1.5714285714285714,1,0.0,0,2,0,1,3,0,0,5,0,3,8,1
7283,198046,aDI9D7tn5adCCbKFB0sAA8QdbVuXFqVk,RXDvfPUBYFlVdlueBFbLW0mhhAyGEqpt,17,16,11,31,7,0,1,0,66,9.428571428571429,1,0.0,4,11,29,7,12,0,2,1,0,51,15,1
7284,198047,26YSBPGFrjIOM80TFQ5XwHijdAXAx6uk,bWdj2GDclj5ofokWjzoa5jAwMkxCykd6,12,5,3,0,3,0,5,2,18,2.5714285714285716,1,0.0,0,3,0,3,5,0,0,5,2,6,12,1
7285,198073,tBWD1VTj6Jcj3AQ0AXY8eZtUzkjmoiNH,A3fsA9Zfv1X2fVEQhTw51lKENdNrEqT3,34,31,1,62,1,0,10,1,106,15.142857142857142,1,0.0,3,1,54,1,28,0,8,10,1,59,47,1
7286,198086,xq1s7UZZ1wrCX5Lo1UzeFrdUUjRT403R,SpATywNh6bZuzm8s1ceuBUnMUAeoAHHw,11,12,1,12,0,0,3,1,29,4.142857142857143,1,0.0,6,1,12,0,6,0,0,3,1,19,10,1
7287,198098,AjlQRJzysjPIR7iVlK5KoW1nu66aTyed,SpATywNh6bZuzm8s1ceuBUnMUAeoAHHw,1,0,0,0,0,0,1,0,1,0.14285714285714285,1,0.0,0,0,0,0,0,0,0,1,0,0,1,0
7288,198105,gMfSnnrpIllvTRFx8lm7ezHNF6v0Kz0J,A3fsA9Zfv1X2fVEQhTw51lKENdNrEqT3,8,4,2,0,1,4,9,2,22,3.142857142857143,1,0.0,0,2,0,1,4,4,0,9,2,3,19,1
7289,198115,qB4NKZzfw5ku2R1El6nAmpvYSqoEp884,SpATywNh6bZuzm8s1ceuBUnMUAeoAHHw,4,3,1,0,0,0,2,0,6,0.8571428571428571,1,0.0,0,1,0,0,3,0,0,2,0,1,5,0
7290,198145,4GJSwwikGuUWXSajcKoSlvfsoiC8eEZq,bWdj2GDclj5ofokWjzoa5jAwMkxCykd6,13,17,7,0,3,3,7,1,38,5.428571428571429,1,0.0,1,7,0,3,16,3,0,7,1,11,27,1
7291,198154,S0gkXMGtXyRSx8zYg1gsCVaZEuGxgZkA,bWdj2GDclj5ofokWjzoa5jAwMkxCykd6,4,2,1,0,1,0,3,0,7,1.0,1,0.0,0,1,0,1,2,0,0,3,0,2,5,1
7292,198161,T6EWQ7jVP89JlHzj41KN1gEtGYevpSQM,A3fsA9Zfv1X2fVEQhTw51lKENdNrEqT3,12,8,6,0,4,0,2,0,20,2.857142857142857,1,0.0,0,6,0,4,8,0,0,2,0,10,10,1
7293,198163,plvcgi97Dmyn6KmfywjhqH2jaOdxU3cF,SpATywNh6bZuzm8s1ceuBUnMUAeoAHHw,8,5,3,0,0,1,5,1,15,2.142857142857143,1,0.0,0,3,0,0,5,1,0,5,1,3,12,1
7294,198180,gykRbA7iJUFygOkXv9mNdsHLTYvvd4jI,A3fsA9Zfv1X2fVEQhTw51lKENdNrEqT3,9,7,0,0,0,5,3,0,15,2.142857142857143,1,0.0,0,0,0,0,7,5,0,3,0,0,15,1
7295,198184,XeY97U0dths6K286UoEX2Zr2QUaKKAXx,SpATywNh6bZuzm8s1ceuBUnMUAeoAHHw,1,0,0,0,0,0,1,0,1,0.14285714285714285,1,0.0,0,0,0,0,0,0,0,1,0,0,1,1
7296,198186,73Lo5aiYTeasg8R5eGVwIsechNk0OHx6,G8EPVSXsOYB5YQWZGiz1aVq5Pgr2GrQu,9,4,3,0,3,0,2,0,12,1.7142857142857142,1,0.0,0,3,0,3,4,0,0,2,0,6,6,1
7297,198189,OtQITYEhL1ZwLf1P3GqZbaC4QV1QHl7a,A3fsA9Zfv1X2fVEQhTw51lKENdNrEqT3,9,15,7,0,0,0,2,0,24,3.4285714285714284,1,0.0,0,7,0,0,15,0,0,2,0,7,17,1
7298,198208,G2J62R4OLusX5hri0oMn1VajtiIn6i9q,bWdj2GDclj5ofokWjzoa5jAwMkxCykd6,6,1,1,0,1,0,3,0,6,0.8571428571428571,1,0.0,0,1,0,1,1,0,0,3,0,2,4,1
7299,198215,nrvDpyOlV5T6ZU5wiBAqPXpBwJOtawqO,A3fsA9Zfv1X2fVEQhTw51lKENdNrEqT3,20,17,9,0,7,8,8,0,49,7.0,1,0.0,1,9,0,7,16,8,0,8,0,17,32,1
7300,198221,9Mbi6CksSOlTvzJd1jV7pzorOP4mmF9E,A3fsA9Zfv1X2fVEQhTw51lKENdNrEqT3,5,2,1,0,1,0,2,0,6,0.8571428571428571,1,0.0,0,1,0,1,2,0,0,2,0,2,4,1
7301,198226,So8gZ8cXseEZ7lXf4idNMqcN46bXtlIA,A3fsA9Zfv1X2fVEQhTw51lKENdNrEqT3,8,8,5,0,1,0,6,0,20,2.857142857142857,1,0.0,1,5,0,1,7,0,0,6,0,7,13,1
7302,198241,qq2f8Akny1ajULPtgXYv9fMRWduKMr9q,bWdj2GDclj5ofokWjzoa5jAwMkxCykd6,1,0,0,0,0,0,1,0,1,0.14285714285714285,1,0.0,0,0,0,0,0,0,0,1,0,0,1,1
7303,198265,tblYMREbAeB7j9qmk5L4ctIeWrhD9ybH,bWdj2GDclj5ofokWjzoa5jAwMkxCykd6,3,2,1,0,0,0,2,0,5,0.7142857142857143,1,0.0,0,1,0,0,2,0,0,2,0,1,4,1
7304,198305,XMS4dHK4VF2mldxN8JQikVR6RXER8Fkw,bWdj2GDclj5ofokWjzoa5jAwMkxCykd6,5,3,1,0,1,0,2,0,7,1.0,1,0.0,0,1,0,1,3,0,0,2,0,2,5,1
7305,198318,6I2t4qPvSGFHgotoOOeNtMQj1MijCM5Q,A3fsA9Zfv1X2fVEQhTw51lKENdNrEqT3,10,7,5,0,5,0,2,0,19,2.7142857142857144,1,0.0,1,5,0,5,6,0,0,2,0,11,8,1
7306,198321,VLCI0RtMsYSrwlXRiyKxAF4TijVOF7sG,G8EPVSXsOYB5YQWZGiz1aVq5Pgr2GrQu,6,10,0,2,0,0,1,0,13,1.8571428571428572,1,0.0,1,0,2,0,9,0,0,1,0,3,10,1
7307,198326,Dq2cCGdJlkpRnI9Tq5kE4JyzjGIGvpDz,bWdj2GDclj5ofokWjzoa5jAwMkxCykd6,3,2,0,0,0,0,1,0,3,0.42857142857142855,1,0.0,0,0,0,0,2,0,0,1,0,0,3,1
7308,198371,LWF5YNBuaLmRzZBpMALW00OMClXmBQ67,SpATywNh6bZuzm8s1ceuBUnMUAeoAHHw,2,0,0,0,0,0,2,0,2,0.2857142857142857,1,0.0,0,0,0,0,0,0,0,2,0,0,2,1
7309,198409,ipd4iDlo57xlncm3PxcBpEpu3rjoDaW0,SpATywNh6bZuzm8s1ceuBUnMUAeoAHHw,7,4,2,0,0,3,5,2,16,2.2857142857142856,1,0.0,0,2,0,0,4,3,0,5,2,2,14,1
7310,198412,MW1CCUAVszgiBJBxxvrBhzMkhEDfscQF,SpATywNh6bZuzm8s1ceuBUnMUAeoAHHw,6,0,0,0,0,0,11,8,19,2.7142857142857144,1,0.0,0,0,0,0,0,0,0,11,8,0,19,1
7311,198425,Im7Gqlg4DTaApzafTWanJWaOLzYDgQ9W,A3fsA9Zfv1X2fVEQhTw51lKENdNrEqT3,3,2,0,0,0,0,1,0,3,0.42857142857142855,1,0.0,0,0,0,0,2,0,0,1,0,0,3,1
7312,198427,LUXdrYaxg0yAPMJIVFuGpyCbBaRkWcyF,G8EPVSXsOYB5YQWZGiz1aVq5Pgr2GrQu,1,0,0,0,0,0,1,0,1,0.14285714285714285,1,0.0,0,0,0,0,0,0,0,1,0,0,1,1
7313,198437,itsIv2TK9169ecmSXMRGqFj2himLJ6iM,A3fsA9Zfv1X2fVEQhTw51lKENdNrEqT3,6,2,1,0,1,0,3,0,7,1.0,1,0.0,0,1,0,1,2,0,0,3,0,2,5,1
7314,198439,ap1pnANC6OX2VWawEUL9RM8TJxJj0bNk,SpATywNh6bZuzm8s1ceuBUnMUAeoAHHw,5,2,1,0,1,0,2,0,6,0.8571428571428571,1,0.0,0,1,0,1,2,0,0,2,0,2,4,1
7315,198451,hB4kfP3FOz99INk6teFtXjDJ0tVrgCfz,A3fsA9Zfv1X2fVEQhTw51lKENdNrEqT3,7,4,1,0,1,0,3,1,10,1.4285714285714286,1,0.0,0,1,0,1,4,0,0,3,1,2,8,1
7316,198471,rVGqmbwIRU16AVLpkBRDBFOfZ4AeaSVo,G8EPVSXsOYB5YQWZGiz1aVq5Pgr2GrQu,8,2,0,0,0,4,6,1,13,1.8571428571428572,1,0.0,0,0,0,0,2,4,0,6,1,0,13,1
7317,198513,h4OSpklHSinT7B8HRJJ34ZVL6q4IdQwV,A3fsA9Zfv1X2fVEQhTw51lKENdNrEqT3,10,7,1,0,1,0,6,1,16,2.2857142857142856,1,0.0,0,1,0,1,7,0,0,6,1,2,14,1
7318,198521,I3IP7zznUTOp2SzpkCoD3Y916MRFIMEQ,G8EPVSXsOYB5YQWZGiz1aVq5Pgr2GrQu,17,18,1,24,3,0,2,0,48,6.857142857142857,1,0.0,12,1,14,3,6,0,10,2,0,30,18,1
7319,198524,3nkAYJy31glMu7RttArFOqU7gmkfxNPM,RXDvfPUBYFlVdlueBFbLW0mhhAyGEqpt,1,0,0,0,0,0,1,0,1,0.14285714285714285,1,0.0,0,0,0,0,0,0,0,1,0,0,1,1
7320,198527,7UnGK0lAfGMjUxMyS4n60DI4CBHlFUHS,SpATywNh6bZuzm8s1ceuBUnMUAeoAHHw,4,2,0,0,0,1,2,0,5,0.7142857142857143,1,0.0,0,0,0,0,2,1,0,2,0,0,5,1
7321,198540,PQpooRd3Dcd7MsTxOspuuB35YLvA2JZK,SpATywNh6bZuzm8s1ceuBUnMUAeoAHHw,5,5,4,0,2,0,2,0,13,1.8571428571428572,1,0.0,0,4,0,2,5,0,0,2,0,6,7,1
7322,198541,cIviUx1oarGZRWOqPuxscIM6aOUp7v5L,G8EPVSXsOYB5YQWZGiz1aVq5Pgr2GrQu,11,3,3,0,3,0,5,0,14,2.0,1,0.0,0,3,0,3,3,0,0,5,0,6,8,1
7323,198543,7UnGK0lAfGMjUxMyS4n60DI4CBHlFUHS,bWdj2GDclj5ofokWjzoa5jAwMkxCykd6,1,0,0,0,0,0,1,0,1,0.14285714285714285,1,0.0,0,0,0,0,0,0,0,1,0,0,1,1
7324,198563,IR9p9WuPGPaaA4f6RkgkUYRRmOTg8aPE,bWdj2GDclj5ofokWjzoa5jAwMkxCykd6,3,2,1,0,0,0,1,0,4,0.5714285714285714,1,0.0,0,1,0,0,2,0,0,1,0,1,3,1
7325,198573,0Rc9QmalpGXvwxh2iIaT1Kf7aHCEMOJW,A3fsA9Zfv1X2fVEQhTw51lKENdNrEqT3,1,0,0,0,0,0,1,0,1,0.14285714285714285,1,0.0,0,0,0,0,0,0,0,1,0,0,1,1
7326,198585,pHj2ScU15UNB28eYcbm9r11wq0WKivrS,bWdj2GDclj5ofokWjzoa5jAwMkxCykd6,4,5,2,0,2,0,1,0,10,1.4285714285714286,1,0.0,2,2,0,2,3,0,0,1,0,6,4,1
7327,198590,Zr4KLz2ZL4aSF5gVvs5p4LZP1ixAwF6u,SpATywNh6bZuzm8s1ceuBUnMUAeoAHHw,8,3,1,0,1,1,5,1,12,1.7142857142857142,1,0.0,0,1,0,1,3,1,0,5,1,2,10,1
7328,198592,CiLev4iw4aDKDkfbO8GSdlCCB3fQXQsY,A3fsA9Zfv1X2fVEQhTw51lKENdNrEqT3,10,4,3,0,2,0,4,0,13,1.8571428571428572,1,0.0,0,3,0,2,4,0,0,4,0,5,8,1
7329,198611,lMscwAq4rucD5Y2Dxs1NCZ0Ax6V2NgJ7,SpATywNh6bZuzm8s1ceuBUnMUAeoAHHw,5,3,2,0,1,0,1,0,7,1.0,1,0.0,0,2,0,1,3,0,0,1,0,3,4,1
7330,198616,odybwv6zTY9TMhO6yi1EIRr2WfIsx8N5,SpATywNh6bZuzm8s1ceuBUnMUAeoAHHw,1,0,0,0,0,0,1,0,1,0.14285714285714285,1,0.0,0,0,0,0,0,0,0,1,0,0,1,1
7331,198622,WV3YkTyrIBT24sYf1NcBchbLSWfuPseq,A3fsA9Zfv1X2fVEQhTw51lKENdNrEqT3,4,3,2,0,2,0,1,0,8,1.1428571428571428,1,0.0,0,2,0,2,3,0,0,1,0,4,4,1
7332,198623,Dzu6GQmc5vuwFq9gJBuCSSuvGPsIdsSj,SpATywNh6bZuzm8s1ceuBUnMUAeoAHHw,6,0,0,0,0,0,7,2,9,1.2857142857142858,1,0.0,0,0,0,0,0,0,0,7,2,0,9,1
7333,198631,Jvu0Hx9YHJ8mxetJAU2xMbziN16z8eDf,SpATywNh6bZuzm8s1ceuBUnMUAeoAHHw,12,7,5,0,4,1,5,1,23,3.2857142857142856,1,0.0,0,5,0,4,7,1,0,5,1,9,14,1
7334,198633,v8AEmfj5ScfNiqWSiB9twce4e05jQ9FQ,bWdj2GDclj5ofokWjzoa5jAwMkxCykd6,1,0,0,0,0,0,1,0,1,0.14285714285714285,1,0.0,0,0,0,0,0,0,0,1,0,0,1,1
7335,198639,9Nsgp7LQN84rKL9niMUlqjv8b2ci26i2,A3fsA9Zfv1X2fVEQhTw51lKENdNrEqT3,1,0,0,0,0,0,1,0,1,0.14285714285714285,1,0.0,0,0,0,0,0,0,0,1,0,0,1,1
7336,198641,boqZBuL5xdPgOX9TFr0s595aQRVHTZHS,SpATywNh6bZuzm8s1ceuBUnMUAeoAHHw,1,0,0,0,0,0,1,0,1,0.14285714285714285,1,0.0,0,0,0,0,0,0,0,1,0,0,1,1
7337,198648,pGAAxK6WZxbSHdtKKBvQSoYltPRqe43C,SpATywNh6bZuzm8s1ceuBUnMUAeoAHHw,6,3,1,0,1,0,2,0,7,1.0,1,0.0,0,1,0,1,3,0,0,2,0,2,5,1
7338,198672,GSkYUOcl4XzYMWSWhE6gXRGQ9kqPeXsi,bWdj2GDclj5ofokWjzoa5jAwMkxCykd6,9,5,3,28,3,0,2,0,41,5.857142857142857,1,0.0,1,3,27,3,4,0,1,2,0,34,7,1
7339,198675,34cVbMGyVO1SqQjOK9RNk00q4uKA3nIE,A3fsA9Zfv1X2fVEQhTw51lKENdNrEqT3,5,3,1,0,1,2,4,0,11,1.5714285714285714,1,0.0,1,1,0,1,2,2,0,4,0,3,8,1
7340,198714,MZXb9jchKEtLA37ZVUIxBtaUGdZhYeJT,G8EPVSXsOYB5YQWZGiz1aVq5Pgr2GrQu,4,2,1,0,1,0,1,0,5,0.7142857142857143,1,0.0,0,1,0,1,2,0,0,1,0,2,3,1
7341,198717,I2yihQ33CDsuDBZLIV6bzhSjVdIOvgGC,bWdj2GDclj5ofokWjzoa5jAwMkxCykd6,7,3,0,0,2,0,4,0,9,1.2857142857142858,1,0.0,2,0,0,2,1,0,0,4,0,4,5,1
7342,198720,GdwsSQDD3RD1ds1JuZBmFzmfEkBslekC,SpATywNh6bZuzm8s1ceuBUnMUAeoAHHw,4,3,0,0,0,0,2,0,5,0.7142857142857143,1,0.0,0,0,0,0,3,0,0,2,0,0,5,1
7343,198721,foGVhKIFjMIFQYicH2TLfLzHHE7pM4bi,A3fsA9Zfv1X2fVEQhTw51lKENdNrEqT3,7,2,1,0,0,1,6,1,11,1.5714285714285714,1,0.0,0,1,0,0,2,1,0,6,1,1,10,1
7344,198753,xX0iYdUwlCBlooAwOCU3ud9UtqInVGRm,A3fsA9Zfv1X2fVEQhTw51lKENdNrEqT3,12,8,6,0,3,7,6,1,31,4.428571428571429,1,0.0,0,6,0,3,8,7,0,6,1,9,22,1
7345,198758,7FTb8qcMeGic1m25RrAdw1gNnGsbUnQN,SpATywNh6bZuzm8s1ceuBUnMUAeoAHHw,13,17,7,0,3,0,8,1,36,5.142857142857143,1,0.0,4,7,0,3,13,0,0,8,1,14,22,1
7346,198767,rdXBX56hdm6MgOkqvDTZw84EG2v9Ij01,A3fsA9Zfv1X2fVEQhTw51lKENdNrEqT3,5,2,1,0,1,0,4,0,8,1.1428571428571428,1,0.0,0,1,0,1,2,0,0,4,0,2,6,1
7347,198777,bWklEyYoSpuuB2ZTCwBPrnaJDLkOGTMp,SpATywNh6bZuzm8s1ceuBUnMUAeoAHHw,1,0,0,0,0,0,1,0,1,0.14285714285714285,1,0.0,0,0,0,0,0,0,0,1,0,0,1,1
7348,198781,hkPW1meCvutegNytZP5zAHZkZdu7wM1N,G8EPVSXsOYB5YQWZGiz1aVq5Pgr2GrQu,6,7,5,0,4,0,4,0,20,2.857142857142857,1,0.0,0,5,0,4,7,0,0,4,0,9,11,1
7349,198795,v4qKKz4EWeiMbiMd1pppvrFEFDQHnpRJ,G8EPVSXsOYB5YQWZGiz1aVq5Pgr2GrQu,8,7,3,0,3,0,1,0,14,2.0,1,0.0,3,3,0,3,4,0,0,1,0,9,5,1
7350,198797,u601bf5LgTloUnzWrvF8VsEbNdAIplE1,A3fsA9Zfv1X2fVEQhTw51lKENdNrEqT3,1,0,0,0,0,0,2,0,2,0.2857142857142857,1,0.0,0,0,0,0,0,0,0,2,0,0,2,1
7351,198800,wnDMDigjN4PlQ0HWg6PwACxEoBUS4Gx4,A3fsA9Zfv1X2fVEQhTw51lKENdNrEqT3,4,2,0,0,0,0,2,0,4,0.5714285714285714,1,0.0,0,0,0,0,2,0,0,2,0,0,4,1
7352,198803,9N7TqBwx16hmfqT5WweyvUVrAeU2Gds6,SpATywNh6bZuzm8s1ceuBUnMUAeoAHHw,10,15,6,0,4,1,1,0,27,3.857142857142857,1,0.0,3,6,0,4,12,1,0,1,0,13,14,1
7353,198804,oOPW8b1yKsHdoM2CKb7DyH4zCUGTI2L7,G8EPVSXsOYB5YQWZGiz1aVq5Pgr2GrQu,7,3,2,0,2,0,4,0,11,1.5714285714285714,1,0.0,0,2,0,2,3,0,0,4,0,4,7,1
7354,198813,bu3K5v9qe8b55yPk6H1Kzu2kZgUnBQeS,bWdj2GDclj5ofokWjzoa5jAwMkxCykd6,1,0,0,0,0,0,1,0,1,0.14285714285714285,1,0.0,0,0,0,0,0,0,0,1,0,0,1,1
7355,198818,4JyZWYWxxqGCPr9dTz7bgpLcCXWs003A,G8EPVSXsOYB5YQWZGiz1aVq5Pgr2GrQu,7,1,1,0,1,0,5,0,8,1.1428571428571428,1,0.0,0,1,0,1,1,0,0,5,0,2,6,1
7356,198824,AG3Ywlgg0zeoJMMzx5kl7d9PzkM3xyjk,A3fsA9Zfv1X2fVEQhTw51lKENdNrEqT3,18,9,7,0,6,0,6,1,29,4.142857142857143,1,0.0,0,7,0,6,9,0,0,6,1,13,16,1
7357,198827,2ULjUBKcAnyQSi1NZFeDGBWEU4kETCtv,G8EPVSXsOYB5YQWZGiz1aVq5Pgr2GrQu,18,24,11,40,5,3,4,0,87,12.428571428571429,1,0.0,7,11,33,5,17,3,7,4,0,56,31,1
7358,198843,nhKo3n0QtoNri1dTW77ZJUsuajlfq52l,SpATywNh6bZuzm8s1ceuBUnMUAeoAHHw,6,4,3,0,3,0,1,0,11,1.5714285714285714,1,0.0,0,3,0,3,4,0,0,1,0,6,5,1
7359,198861,HhUNMDqxiy7U4QVsVWLmXLfoPctCDoGr,SpATywNh6bZuzm8s1ceuBUnMUAeoAHHw,3,0,0,0,0,1,2,0,3,0.42857142857142855,1,0.0,0,0,0,0,0,1,0,2,0,0,3,1
7360,198876,3FwKlBDtKGlNAYyQNzHL1qfkuXpNOPVW,bWdj2GDclj5ofokWjzoa5jAwMkxCykd6,1,0,0,0,0,0,1,0,1,0.14285714285714285,1,0.0,0,0,0,0,0,0,0,1,0,0,1,1
7361,198881,R2bf9dlDhtEUgfKzXR1GPBa12LhUfZ8W,A3fsA9Zfv1X2fVEQhTw51lKENdNrEqT3,6,4,3,0,2,0,1,0,10,1.4285714285714286,1,0.0,0,3,0,2,4,0,0,1,0,5,5,1
7362,198883,TwsuaxQpuQH4X71hofoKVQ1FXkHOyr0Z,bWdj2GDclj5ofokWjzoa5jAwMkxCykd6,8,2,1,0,1,0,5,1,10,1.4285714285714286,1,0.0,1,1,0,1,1,0,0,5,1,3,7,1
7363,198887,IGs2FsXHkQDnXVyqCPa0nawJqdQ0PAsD,SpATywNh6bZuzm8s1ceuBUnMUAeoAHHw,1,0,0,0,0,0,1,0,1,0.14285714285714285,1,0.0,0,0,0,0,0,0,0,1,0,0,1,1
7364,198897,Isy1saDmyEIfHHr1kPm1JUuUBknEItqI,SpATywNh6bZuzm8s1ceuBUnMUAeoAHHw,1,0,0,0,0,0,1,0,1,0.14285714285714285,1,0.0,0,0,0,0,0,0,0,1,0,0,1,1
7365,198900,r4qXpyLtUsV0WLMpP48wcQ1UcY1so2Nu,G8EPVSXsOYB5YQWZGiz1aVq5Pgr2GrQu,10,5,4,0,3,0,2,0,14,2.0,1,0.0,0,4,0,3,5,0,0,2,0,7,7,1
7366,198908,pSRqXJrhW3cpcIMqshrNJY13lAR5UPwX,bWdj2GDclj5ofokWjzoa5jAwMkxCykd6,1,0,0,0,0,0,1,0,1,0.14285714285714285,1,0.0,0,0,0,0,0,0,0,1,0,0,1,1
7367,198912,nKVAY2GHYnzf4BfG261ddlVdtqvsIA9B,bWdj2GDclj5ofokWjzoa5jAwMkxCykd6,4,2,1,0,1,0,2,0,6,0.8571428571428571,1,0.0,0,1,0,1,2,0,0,2,0,2,4,1
7368,198919,1j8gbclC0lfQw1ATQbildJE9fULo0ecU,A3fsA9Zfv1X2fVEQhTw51lKENdNrEqT3,5,2,1,0,1,0,2,0,6,0.8571428571428571,1,0.0,0,1,0,1,2,0,0,2,0,2,4,1
7369,198934,YQQ0U1ySGhxQGw2MpzkqAJru8VuefP0L,A3fsA9Zfv1X2fVEQhTw51lKENdNrEqT3,6,2,1,0,1,7,7,1,19,2.7142857142857144,1,0.0,0,1,0,1,2,7,0,7,1,2,17,1
7370,198949,sNbuAEBvvCL9s1FspvGXLJVjQkFzxwpw,bWdj2GDclj5ofokWjzoa5jAwMkxCykd6,4,2,0,0,0,0,2,0,4,0.5714285714285714,1,0.0,0,0,0,0,2,0,0,2,0,0,4,1
7371,198961,mJt5KMSSr7JvGBEQNnS7zxJqeuNThNSs,SpATywNh6bZuzm8s1ceuBUnMUAeoAHHw,7,5,4,0,4,0,2,0,15,2.142857142857143,1,0.0,0,4,0,4,5,0,0,2,0,8,7,1
7372,198967,2oTvbzieHn2y5oozeOgSnruqE6N0BtR5,SpATywNh6bZuzm8s1ceuBUnMUAeoAHHw,7,3,2,0,2,3,2,0,12,1.7142857142857142,1,0.0,0,2,0,2,3,3,0,2,0,4,8,1
7373,198990,2SHX7pefWKxAdle5f43dow0MyPOF6YGF,SpATywNh6bZuzm8s1ceuBUnMUAeoAHHw,6,3,0,0,0,1,4,0,8,1.1428571428571428,1,0.0,0,0,0,0,3,1,0,4,0,0,8,1
7374,198997,37OFfdd4jVDH9Wkzlzun8gwzZeYEoVZi,SpATywNh6bZuzm8s1ceuBUnMUAeoAHHw,7,3,2,0,2,0,2,0,9,1.2857142857142858,1,0.0,0,2,0,2,3,0,0,2,0,4,5,1
7375,198998,2oTvbzieHn2y5oozeOgSnruqE6N0BtR5,G8EPVSXsOYB5YQWZGiz1aVq5Pgr2GrQu,11,6,4,0,4,8,2,0,24,3.4285714285714284,1,0.0,1,4,0,4,5,8,0,2,0,9,15,1
7376,199003,z8AZNvy0mvqias2V5LoDHYpS46oKfDaS,RXDvfPUBYFlVdlueBFbLW0mhhAyGEqpt,2,0,0,0,0,0,2,0,2,0.2857142857142857,1,0.0,0,0,0,0,0,0,0,2,0,0,2,1
7377,199007,TqIBAk7ZVNx5vdURE7Yh8YGgkMcauYpn,A3fsA9Zfv1X2fVEQhTw51lKENdNrEqT3,5,4,3,0,0,0,2,0,9,1.2857142857142858,1,0.0,0,3,0,0,4,0,0,2,0,3,6,1
7378,199048,seGsWY5pHJdYc0dygxkfgWkiK3wzJxVH,A3fsA9Zfv1X2fVEQhTw51lKENdNrEqT3,5,3,1,0,1,0,2,0,7,1.0,1,0.0,1,1,0,1,2,0,0,2,0,3,4,1
7379,199063,ODCx2UO2z0ldelF48alKkiQzrvYMM8sJ,G8EPVSXsOYB5YQWZGiz1aVq5Pgr2GrQu,9,6,3,2,1,0,9,0,21,3.0,1,0.0,3,3,2,1,3,0,0,9,0,9,12,1
7380,199068,TTLR6K3ZlbSrGOfX2kjd2U4ChldGiopU,RXDvfPUBYFlVdlueBFbLW0mhhAyGEqpt,5,3,1,0,0,0,3,0,7,1.0,1,0.0,0,1,0,0,3,0,0,3,0,1,6,1
7381,199070,mne1Bu1F2f0U7iravmS4eQYQtLTkVvPe,A3fsA9Zfv1X2fVEQhTw51lKENdNrEqT3,9,4,3,0,3,0,3,0,13,1.8571428571428572,1,0.0,0,3,0,3,4,0,0,3,0,6,7,1
7382,199075,zmFq2MrnMqSFLtSy4w1SV24s7OiYosym,A3fsA9Zfv1X2fVEQhTw51lKENdNrEqT3,4,2,1,0,1,0,1,0,5,0.7142857142857143,1,0.0,0,1,0,1,2,0,0,1,0,2,3,1
