,enrollment_id,username,course_id,no_of_objects123,bno_access123,bno_pageclose123,bno_problem123,bno_video123,bno_discussion123,bno_navigate123,bno_wiki123,bno_total123,bno_avg123,no_of_active_days123,time_consumption123,browser_access123,browser_pageclose123,browser_problem123,browser_video123,server_access123,server_discussion123,server_problem123,server_navigate123,server_wiki123,bno_browser123,bno_server123,label
0,34,OeLBIzS0gNQ56euxy5b66gAZMzQCGE7n,7GRhBDsirIGkRZBtSMEzNTyDr2JQm4xx,71,152,42,110,33,8,37,3,385,55.0,15,-11760450.0,83,42,95,33,69,8,15,37,3,253,132,0
1,66,cGrHiRjztN9fSltHujpfWaaWfYWiidiG,7GRhBDsirIGkRZBtSMEzNTyDr2JQm4xx,100,386,73,205,39,258,49,0,1010,144.28571428571428,15,0.0,142,73,159,39,244,258,46,49,0,413,597,0
2,85,OdsEBh425XZxll0hTUv04OAotDf6aGtE,7GRhBDsirIGkRZBtSMEzNTyDr2JQm4xx,10,14,4,2,3,0,5,0,28,4.0,3,0.0,1,4,2,3,13,0,0,5,0,10,18,1
3,89,Po17baTutQqG3KBkMaahpxQ7IpjhFfZa,7GRhBDsirIGkRZBtSMEzNTyDr2JQm4xx,52,133,7,95,30,11,8,0,284,40.57142857142857,9,0.0,76,7,81,30,57,11,14,8,0,194,90,1
4,145,TZOWoG0yzTTzAfx5K054mpl5rZTlZIcZ,7GRhBDsirIGkRZBtSMEzNTyDr2JQm4xx,61,187,63,96,37,31,16,4,434,62.0,12,0.0,56,63,88,37,131,31,8,16,4,244,190,1
5,163,jJZ8z8M2beLy33Z7JJbNFq1bQd8o43FV,7GRhBDsirIGkRZBtSMEzNTyDr2JQm4xx,7,15,5,0,0,1,7,0,28,4.0,4,0.0,5,5,0,0,10,1,0,7,0,10,18,1
6,312,BCPhbcVTukJPsOtUJJbyOWvpso8GiEV1,7GRhBDsirIGkRZBtSMEzNTyDr2JQm4xx,70,250,73,204,53,351,72,3,1006,143.71428571428572,15,0.0,138,73,171,53,112,351,33,72,3,435,571,0
7,384,zcVNiJm0X4Vm9oBHkuQez1iW6Hb7iAYl,7GRhBDsirIGkRZBtSMEzNTyDr2JQm4xx,45,96,35,65,33,3,6,0,238,34.0,2,0.0,59,35,61,33,37,3,4,6,0,188,50,1
8,397,9JGDpM8F0Ioe7WqwIugLWqE5Qa4gQNAo,7GRhBDsirIGkRZBtSMEzNTyDr2JQm4xx,5,0,0,0,0,0,6,0,6,0.8571428571428571,1,0.0,0,0,0,0,0,0,0,6,0,0,6,1
9,405,jWgeQ7calOYQcs5lv7T9mWy3KUSp4lwk,7GRhBDsirIGkRZBtSMEzNTyDr2JQm4xx,7,4,1,0,1,0,3,0,9,1.2857142857142858,2,0.0,0,1,0,1,4,0,0,3,0,2,7,1
10,457,LP0dfF7fyuhmmsZ61rjoy3gAmrNgZfWE,7GRhBDsirIGkRZBtSMEzNTyDr2JQm4xx,5,3,0,0,0,0,2,0,5,0.7142857142857143,1,0.0,0,0,0,0,3,0,0,2,0,0,5,1
11,488,j2rHuSroJ2LNNnea5uXtGt5k8dfNg0dE,7GRhBDsirIGkRZBtSMEzNTyDr2JQm4xx,5,2,1,0,1,0,3,0,7,1.0,2,0.0,0,1,0,1,2,0,0,3,0,2,5,1
12,508,hbwWiZJx2DqUaUjG4c2EvTFTwMA32fWP,7GRhBDsirIGkRZBtSMEzNTyDr2JQm4xx,71,203,75,155,25,2,12,1,473,67.57142857142857,6,0.0,104,75,139,25,99,2,16,12,1,343,130,1
13,529,VjgzAw2H8q9OHgJwlSzUGU3MhKciCosm,7GRhBDsirIGkRZBtSMEzNTyDr2JQm4xx,1,0,0,0,0,0,1,0,1,0.14285714285714285,1,0.0,0,0,0,0,0,0,0,1,0,0,1,1
14,559,gZhclo8obnDdq4Hpc6ohnKIqNEyfFli3,7GRhBDsirIGkRZBtSMEzNTyDr2JQm4xx,39,49,24,47,19,0,6,0,145,20.714285714285715,2,0.0,21,24,39,19,28,0,8,6,0,103,42,1
15,571,cuuYGTWWAmhidQoRHdGzANriCatcPrlK,7GRhBDsirIGkRZBtSMEzNTyDr2JQm4xx,66,154,63,120,49,22,11,0,419,59.857142857142854,11,0.0,82,63,103,49,72,22,17,11,0,297,122,0
16,578,eER8RoiVQhlBLlO4WV7kKfWOx4XE0E9c,7GRhBDsirIGkRZBtSMEzNTyDr2JQm4xx,41,106,45,60,28,61,17,0,317,45.285714285714285,9,0.0,45,45,50,28,61,61,10,17,0,168,149,1
17,618,M5ID2aNMWGm5ShsGkFPYgTgN2UReXK8g,7GRhBDsirIGkRZBtSMEzNTyDr2JQm4xx,58,125,52,113,50,3,10,0,353,50.42857142857143,6,0.0,57,52,96,50,68,3,17,10,0,255,98,1
18,694,DVxZxPUgYsodJVtjUg4HG3ZucfJoWgwo,7GRhBDsirIGkRZBtSMEzNTyDr2JQm4xx,61,80,21,185,20,0,42,0,348,49.714285714285715,8,0.0,33,21,175,20,47,0,10,42,0,249,99,1
19,755,qVDHsjIzoOtZnTwpJtbJGpvapy4sRYpW,7GRhBDsirIGkRZBtSMEzNTyDr2JQm4xx,64,158,48,110,36,12,25,1,390,55.714285714285715,11,0.0,82,48,99,36,76,12,11,25,1,265,125,1
20,849,se5zs87qj8m5HDpiAuY9fHW8e8hfOFuJ,7GRhBDsirIGkRZBtSMEzNTyDr2JQm4xx,38,143,64,60,20,62,22,1,372,53.142857142857146,4,0.0,55,64,53,20,88,62,7,22,1,192,180,0
21,874,QpsLmP3WeC01C1T5jY6uw1yDvPjAiorO,7GRhBDsirIGkRZBtSMEzNTyDr2JQm4xx,1,0,0,0,0,0,1,0,1,0.14285714285714285,1,0.0,0,0,0,0,0,0,0,1,0,0,1,1
22,948,iYWLR7w0j5yEEe1bCu5IYYyXjnXbv448,7GRhBDsirIGkRZBtSMEzNTyDr2JQm4xx,44,101,42,53,20,27,13,4,260,37.142857142857146,8,0.0,43,42,46,20,58,27,7,13,4,151,109,0
23,998,RJ1FVW8gXQIpK321uzh2Sh69ojlsqnvg,7GRhBDsirIGkRZBtSMEzNTyDr2JQm4xx,1,0,0,0,0,0,1,0,1,0.14285714285714285,1,0.0,0,0,0,0,0,0,0,1,0,0,1,1
24,1042,ypoGZw2r9uT31DVWRK8Ak5IwBPQDf2ZW,7GRhBDsirIGkRZBtSMEzNTyDr2JQm4xx,29,104,33,45,12,3,8,0,205,29.285714285714285,4,0.0,58,33,40,12,46,3,5,8,0,143,62,1
25,1067,9XUvtVr9N38jFL9d3KSBLe5NN0NI5Xv8,7GRhBDsirIGkRZBtSMEzNTyDr2JQm4xx,1,0,0,0,0,0,2,0,2,0.2857142857142857,2,0.0,0,0,0,0,0,0,0,2,0,0,2,1
26,1130,aaJeZnIT5e0GpVZyGMksW5aGfCnXK0Ln,7GRhBDsirIGkRZBtSMEzNTyDr2JQm4xx,49,185,2,134,0,63,23,3,410,58.57142857142857,4,0.0,108,2,98,0,77,63,36,23,3,208,202,1
27,1194,WFh9KL1sDhp4NpPSjJuGtUwdjU2As3jU,7GRhBDsirIGkRZBtSMEzNTyDr2JQm4xx,44,87,14,132,10,7,31,1,282,40.285714285714285,7,0.0,46,14,124,10,41,7,8,31,1,194,88,1
28,1197,x9GXQQjoWNWecF7wnG4Lnubsxy4Sbicl,7GRhBDsirIGkRZBtSMEzNTyDr2JQm4xx,71,172,55,155,44,20,32,0,478,68.28571428571429,5,0.0,99,55,132,44,73,20,23,32,0,330,148,1
29,1293,2CIqPxwfpdleLKAwuxTPlDujU1ToKMCe,7GRhBDsirIGkRZBtSMEzNTyDr2JQm4xx,65,133,58,131,23,101,54,3,503,71.85714285714286,12,0.0,51,58,112,23,82,101,19,54,3,244,259,0
30,1298,xdVF44pcmC57LxybIN6S03WC3lkijhye,7GRhBDsirIGkRZBtSMEzNTyDr2JQm4xx,5,3,2,0,2,0,2,0,9,1.2857142857142858,1,0.0,0,2,0,2,3,0,0,2,0,4,5,0
31,1304,CSh5hGbaSFu2yCb31iVMOVwKocrH471Q,7GRhBDsirIGkRZBtSMEzNTyDr2JQm4xx,8,23,14,0,7,0,9,0,53,7.571428571428571,7,0.0,2,14,0,7,21,0,0,9,0,23,30,1
32,1327,2cWT2r9kI6XDpveso7mwMhmCGJDMpJ6X,7GRhBDsirIGkRZBtSMEzNTyDr2JQm4xx,27,52,1,68,5,6,15,1,148,21.142857142857142,2,0.0,23,1,59,5,29,6,9,15,1,88,60,1
33,1334,BdwcZr5MO8X0sPJO0Tqucc1g1g6IA4vq,7GRhBDsirIGkRZBtSMEzNTyDr2JQm4xx,48,273,61,83,15,18,15,0,465,66.42857142857143,6,0.0,143,61,75,15,130,18,8,15,0,294,171,0
34,1395,YAuAlaDad79jVXW80O0RGtQjJBBOLDit,7GRhBDsirIGkRZBtSMEzNTyDr2JQm4xx,5,4,1,0,0,0,3,1,9,1.2857142857142858,1,0.0,1,1,0,0,3,0,0,3,1,2,7,1
35,1396,4pgEahxP0BMucPOaES4iKt1glSEl2goc,7GRhBDsirIGkRZBtSMEzNTyDr2JQm4xx,103,411,106,191,46,66,67,5,892,127.42857142857143,12,0.0,195,106,151,46,216,66,40,67,5,498,394,0
36,1434,M3xTB6LenTJvMpybZKparVtRZKzrRM1R,7GRhBDsirIGkRZBtSMEzNTyDr2JQm4xx,1,0,0,0,0,0,2,0,2,0.2857142857142857,2,0.0,0,0,0,0,0,0,0,2,0,0,2,1
37,1436,hmtOqZVjWQ6rLJb3YkFWytQIy20ogszh,7GRhBDsirIGkRZBtSMEzNTyDr2JQm4xx,43,47,17,75,19,10,17,0,185,26.428571428571427,4,0.0,20,17,64,19,27,10,11,17,0,120,65,1
38,1644,P18honwQPPbELUE86qFIATuZK3YDtjvG,7GRhBDsirIGkRZBtSMEzNTyDr2JQm4xx,34,61,7,52,7,7,8,0,142,20.285714285714285,7,0.0,30,7,42,7,31,7,10,8,0,86,56,1
39,1682,rGP2g0AMaZmMVMjLaxKJkSmzZgbB3U4e,7GRhBDsirIGkRZBtSMEzNTyDr2JQm4xx,4,0,0,0,0,0,4,0,4,0.5714285714285714,1,0.0,0,0,0,0,0,0,0,4,0,0,4,0
40,1739,MSwjf2I17FAgMFqknSNlHHVpwcQKsxyQ,7GRhBDsirIGkRZBtSMEzNTyDr2JQm4xx,102,185,54,158,62,112,21,5,597,85.28571428571429,6,0.0,89,54,128,62,96,112,30,21,5,333,264,1
41,1765,8nlNDsWSaxHCvsMKtqhBs81sknEiTCeb,7GRhBDsirIGkRZBtSMEzNTyDr2JQm4xx,72,95,47,56,48,0,12,0,258,36.857142857142854,9,0.0,31,47,43,48,64,0,13,12,0,169,89,0
42,1771,jImHfNEIObE674KdIbKVj7cCJ4ufqzHJ,7GRhBDsirIGkRZBtSMEzNTyDr2JQm4xx,46,121,58,44,10,683,83,7,1006,143.71428571428572,18,0.0,36,58,37,10,85,683,7,83,7,141,865,0
43,1775,mIe8dQN3qDFpsTsivIoOXC4yOCPP2RyG,7GRhBDsirIGkRZBtSMEzNTyDr2JQm4xx,58,244,49,41,38,35,29,2,438,62.57142857142857,8,0.0,119,49,40,38,125,35,1,29,2,246,192,0
44,1802,STdhsQG5tLZHsan5xGUL8YXDFoc6MDRe,fbPkOYLVPtPgIt0MxizjfFJov3JbHyAi,21,48,3,30,3,9,8,0,101,14.428571428571429,2,0.0,20,3,30,3,28,9,0,8,0,56,45,0
45,1808,Slk5JcZSYHmDLQZXaNVmcMDmjJ16kBhI,fbPkOYLVPtPgIt0MxizjfFJov3JbHyAi,40,200,5,62,10,45,31,3,356,50.857142857142854,14,0.0,66,5,51,10,134,45,11,31,3,132,224,1
46,1809,oo6yDppb7lwtVg5iRhFytpMjmAuhJrAW,fbPkOYLVPtPgIt0MxizjfFJov3JbHyAi,16,41,22,3,9,134,30,5,244,34.857142857142854,4,0.0,10,22,3,9,31,134,0,30,5,44,200,0
47,1814,KVMcZ0CphnUUs4jbRYRdgMvMogJko09j,fbPkOYLVPtPgIt0MxizjfFJov3JbHyAi,62,116,76,50,37,42,31,0,352,50.285714285714285,7,0.0,26,76,43,37,90,42,7,31,0,182,170,0
48,1824,iQpP0qT2CHD9i5LDED8ej6YadyfX6mXh,fbPkOYLVPtPgIt0MxizjfFJov3JbHyAi,5,3,1,0,1,0,2,0,7,1.0,1,0.0,0,1,0,1,3,0,0,2,0,2,5,1
49,1836,XlDfnhryafmarvecZhKZMWL7AupGjwi4,fbPkOYLVPtPgIt0MxizjfFJov3JbHyAi,6,16,5,0,1,0,4,0,26,3.7142857142857144,3,0.0,0,5,0,1,16,0,0,4,0,6,20,1
50,1837,QvqMF8oqvOJDLWUvXbTcLl7n0z5cypNQ,fbPkOYLVPtPgIt0MxizjfFJov3JbHyAi,10,12,8,0,6,1,12,2,41,5.857142857142857,1,0.0,1,8,0,6,11,1,0,12,2,15,26,1
51,1846,82UlWF6Fm1gkNum7nNbVw0yOV1BUdNoS,fbPkOYLVPtPgIt0MxizjfFJov3JbHyAi,4,2,1,0,1,18,2,0,24,3.4285714285714284,1,0.0,0,1,0,1,2,18,0,2,0,2,22,1
52,1848,JfQVgXDVu1NGs9lcRBOD4w6V7BSaZCc2,fbPkOYLVPtPgIt0MxizjfFJov3JbHyAi,62,77,40,48,23,42,29,0,259,37.0,12,0.0,20,40,41,23,57,42,7,29,0,124,135,0
53,1850,62aEkx5hiqjq7miMyrFwVbP7Jkesq4eo,fbPkOYLVPtPgIt0MxizjfFJov3JbHyAi,10,8,5,0,4,0,3,0,20,2.857142857142857,2,0.0,1,5,0,4,7,0,0,3,0,10,10,0
54,1851,cAUuHXvOoCXwQjZWWRqNDA8udivSTUZW,fbPkOYLVPtPgIt0MxizjfFJov3JbHyAi,13,14,0,0,2,0,2,0,18,2.5714285714285716,1,0.0,2,0,0,2,12,0,0,2,0,4,14,0
55,1854,sjBn8oayOINN3T3JZLXHY4beCfaHLSkq,fbPkOYLVPtPgIt0MxizjfFJov3JbHyAi,29,53,17,21,17,19,9,1,137,19.571428571428573,4,0.0,26,17,19,17,27,19,2,9,1,79,58,0
56,1855,cy2CnLMLxJkryBCEHSwR3ZMTpAjnoO1C,fbPkOYLVPtPgIt0MxizjfFJov3JbHyAi,66,259,44,26,21,772,114,1,1237,176.71428571428572,15,0.0,26,44,24,21,233,772,2,114,1,115,1122,0
57,1857,3LBSAbcxxmlIGNLvUbxOBHP17eWw2EWo,fbPkOYLVPtPgIt0MxizjfFJov3JbHyAi,45,61,38,27,18,26,13,1,184,26.285714285714285,4,0.0,13,38,26,18,48,26,1,13,1,95,89,0
58,1858,K0OSl2yDmHYQ9TtZdxy9shErNwx3ga0n,fbPkOYLVPtPgIt0MxizjfFJov3JbHyAi,9,8,2,1,4,5,7,0,27,3.857142857142857,1,0.0,4,2,1,4,4,5,0,7,0,11,16,0
59,1866,mrzCfkgyM6KyC9H5Ok54xCLYWyp2COiw,fbPkOYLVPtPgIt0MxizjfFJov3JbHyAi,9,7,3,0,3,17,3,1,34,4.857142857142857,1,0.0,2,3,0,3,5,17,0,3,1,8,26,1
60,1868,euJ8gpxfARpnWjt9X8Fyxm47A6A32cKl,fbPkOYLVPtPgIt0MxizjfFJov3JbHyAi,61,194,106,49,53,121,52,2,577,82.42857142857143,16,0.0,32,106,39,53,162,121,10,52,2,230,347,0
61,1877,BPWa0SjleiqllaywZCKubwGSdtmQ6n1j,fbPkOYLVPtPgIt0MxizjfFJov3JbHyAi,6,3,1,0,1,0,2,0,7,1.0,1,0.0,0,1,0,1,3,0,0,2,0,2,5,1
62,1885,9sckfYHCSe28pCKnT8xoBCq2thEZcsel,fbPkOYLVPtPgIt0MxizjfFJov3JbHyAi,11,34,3,5,3,0,4,0,49,7.0,2,0.0,5,3,4,3,29,0,1,4,0,15,34,1
63,1887,K4MChPhhtYZYK5nsYtiS9NQwcF94wGaC,fbPkOYLVPtPgIt0MxizjfFJov3JbHyAi,1,0,0,0,0,0,1,0,1,0.14285714285714285,1,0.0,0,0,0,0,0,0,0,1,0,0,1,1
64,1889,9lZ5nNFJAuEwr4dRJLRoTk52o5oWJaUg,fbPkOYLVPtPgIt0MxizjfFJov3JbHyAi,60,100,50,27,28,128,35,2,370,52.857142857142854,12,0.0,29,50,26,28,71,128,1,35,2,133,237,0
65,1892,h8BwrBZ61dHhi5fhxZzTUeeYh9J3sER4,fbPkOYLVPtPgIt0MxizjfFJov3JbHyAi,35,42,32,0,22,5,13,0,114,16.285714285714285,5,0.0,1,32,0,22,41,5,0,13,0,55,59,0
66,1900,FELnhQR0c7GZZX82ioYJEZsqujOrfyf7,fbPkOYLVPtPgIt0MxizjfFJov3JbHyAi,11,8,5,0,3,23,6,2,47,6.714285714285714,2,0.0,1,5,0,3,7,23,0,6,2,9,38,1
67,1905,rH9yibot6cCOaAZphZeWIT7V2pydvksO,fbPkOYLVPtPgIt0MxizjfFJov3JbHyAi,7,5,3,0,2,0,2,0,12,1.7142857142857142,2,0.0,0,3,0,2,5,0,0,2,0,5,7,1
68,1907,O4E7as3W8jLvygS4k9RX6VKdAkX7GkpR,fbPkOYLVPtPgIt0MxizjfFJov3JbHyAi,19,32,5,18,7,4,22,0,88,12.571428571428571,3,0.0,13,5,14,7,19,4,4,22,0,39,49,0
69,1908,uJfbc9I7P24gwBxCb4NuFSYLPcQJXbJC,fbPkOYLVPtPgIt0MxizjfFJov3JbHyAi,61,227,140,56,86,158,76,10,753,107.57142857142857,14,0.0,60,140,46,86,167,158,10,76,10,332,421,0
70,1914,Ms0MC4W5moiGJLWP7iE3FImeH9CHN4KT,fbPkOYLVPtPgIt0MxizjfFJov3JbHyAi,42,51,32,0,23,3,12,2,123,17.571428571428573,5,0.0,8,32,0,23,43,3,0,12,2,63,60,0
71,1919,ZVE1PX7xOz79BV4QTr7JFzHx09U83o43,fbPkOYLVPtPgIt0MxizjfFJov3JbHyAi,35,91,52,17,30,26,9,1,226,32.285714285714285,5,0.0,22,52,15,30,69,26,2,9,1,119,107,0
72,1920,3Nb5o5OohsDNIgLceYbTurAWBMiIQRDh,fbPkOYLVPtPgIt0MxizjfFJov3JbHyAi,44,62,35,31,26,21,12,0,187,26.714285714285715,5,0.0,19,35,26,26,43,21,5,12,0,106,81,0
73,1924,bRmU4ghbgx16XrcSMiRmwAVngSF9Tm10,fbPkOYLVPtPgIt0MxizjfFJov3JbHyAi,7,8,4,0,3,0,3,0,18,2.5714285714285716,3,0.0,0,4,0,3,8,0,0,3,0,7,11,0
74,1925,UHEdqIfQMlcBmdDDlAACqjd4uHB22PZR,fbPkOYLVPtPgIt0MxizjfFJov3JbHyAi,7,10,5,0,0,5,4,1,25,3.5714285714285716,4,0.0,0,5,0,0,10,5,0,4,1,5,20,0
75,1927,KGKXtIu1hkHju7SCZs8gtmA9OwHIqK9w,fbPkOYLVPtPgIt0MxizjfFJov3JbHyAi,60,277,193,1,80,418,96,2,1067,152.42857142857142,18,0.0,29,193,1,80,248,418,0,96,2,303,764,0
76,1930,7Qi8MZVdpAWF6Jx24ApQvOp3KudDuUEC,fbPkOYLVPtPgIt0MxizjfFJov3JbHyAi,11,16,10,0,6,0,4,0,36,5.142857142857143,3,0.0,0,10,0,6,16,0,0,4,0,16,20,1
77,1937,vtrHNbtnxRGyZem1sSOdKIp109fZtSKY,fbPkOYLVPtPgIt0MxizjfFJov3JbHyAi,31,43,20,22,10,49,25,1,170,24.285714285714285,4,0.0,9,20,18,10,34,49,4,25,1,57,113,0
78,1944,FPtAc2MhfpwZkpPIx5xZqPDLAMDq2xlZ,fbPkOYLVPtPgIt0MxizjfFJov3JbHyAi,26,53,20,17,7,30,19,2,148,21.142857142857142,5,0.0,11,20,13,7,42,30,4,19,2,51,97,0
79,1946,oNX40hvUpCseO8BHKhGJvG2jyQpYKQyk,fbPkOYLVPtPgIt0MxizjfFJov3JbHyAi,24,34,18,12,11,7,7,0,89,12.714285714285714,5,0.0,8,18,12,11,26,7,0,7,0,49,40,0
80,3978,h8n9HekAuyT08sLL5qmdMZ3BdSJVR4QF,fbPkOYLVPtPgIt0MxizjfFJov3JbHyAi,19,52,29,0,8,114,34,2,239,34.142857142857146,10,0.0,3,29,0,8,49,114,0,34,2,40,199,0
81,3979,2GATpIfDBYFyTgYmFkr0bda9mVfNXuAl,fbPkOYLVPtPgIt0MxizjfFJov3JbHyAi,62,137,57,50,40,6,23,1,314,44.857142857142854,9,0.0,45,57,47,40,92,6,3,23,1,189,125,0
82,3980,7CTS8g5RByDUjwfG52XdQusTnAWGmBhD,fbPkOYLVPtPgIt0MxizjfFJov3JbHyAi,7,8,3,0,3,0,5,0,19,2.7142857142857144,4,0.0,0,3,0,3,8,0,0,5,0,6,13,1
83,3981,fbTCtGbhuEEqIHlqmw0iRyoH7wNTYXlV,fbPkOYLVPtPgIt0MxizjfFJov3JbHyAi,7,3,2,0,2,0,3,0,10,1.4285714285714286,1,0.0,0,2,0,2,3,0,0,3,0,4,6,1
84,3983,eQnxTOv5tF733HrH1v8IIfXTQQ20WB86,fbPkOYLVPtPgIt0MxizjfFJov3JbHyAi,5,2,1,0,1,7,9,0,20,2.857142857142857,2,0.0,0,1,0,1,2,7,0,9,0,2,18,1
85,3984,oY9JHCaqebrwbBFVvySUXQvzoRiFSB12,fbPkOYLVPtPgIt0MxizjfFJov3JbHyAi,8,5,2,0,2,3,6,1,19,2.7142857142857144,1,0.0,2,2,0,2,3,3,0,6,1,6,13,1
86,3985,d4cb9OZbLbDBqzuhcJemwCaulhBw3XcA,fbPkOYLVPtPgIt0MxizjfFJov3JbHyAi,18,55,10,21,9,15,2,0,112,16.0,2,0.0,19,10,18,9,36,15,3,2,0,56,56,1
87,3996,w2cvWGtYDFIPnh2ovYoWa5sxrg1Qp0H1,fbPkOYLVPtPgIt0MxizjfFJov3JbHyAi,11,13,9,0,6,0,6,0,34,4.857142857142857,2,0.0,0,9,0,6,13,0,0,6,0,15,19,1
88,3997,ZoqTlt1YSWNa9KffVPpNehpQugTpP3Na,fbPkOYLVPtPgIt0MxizjfFJov3JbHyAi,18,14,9,0,8,0,12,0,43,6.142857142857143,2,0.0,0,9,0,8,14,0,0,12,0,17,26,1
89,3998,q4Yehmjs3jQT9rXdV6cXhcGjESMqINf5,fbPkOYLVPtPgIt0MxizjfFJov3JbHyAi,61,127,80,41,45,27,24,2,346,49.42857142857143,12,0.0,26,80,38,45,101,27,3,24,2,189,157,0
90,4004,guY4SSn1fy4TWThod7s2lBFrUtiOX15g,fbPkOYLVPtPgIt0MxizjfFJov3JbHyAi,23,24,13,1,11,3,9,1,62,8.857142857142858,4,0.0,5,13,1,11,19,3,0,9,1,30,32,1
91,4007,tfoakS3EMOjWuYWNRSgWZTjBxe3Mf9Te,fbPkOYLVPtPgIt0MxizjfFJov3JbHyAi,10,15,8,0,4,3,13,1,44,6.285714285714286,5,0.0,0,8,0,4,15,3,0,13,1,12,32,0
92,4008,54s32diFNl04mUbmkn3h7tEt4XEhQ65w,fbPkOYLVPtPgIt0MxizjfFJov3JbHyAi,13,18,4,11,5,0,4,0,42,6.0,3,0.0,8,4,10,5,10,0,1,4,0,27,15,0
93,4009,yQdl23AC4WuqLN6qLaK80XdAyoAoH1QK,fbPkOYLVPtPgIt0MxizjfFJov3JbHyAi,9,3,2,0,2,1,10,1,19,2.7142857142857144,1,0.0,0,2,0,2,3,1,0,10,1,4,15,1
94,4011,cHr4Ma0WfX0OLiO7JvZC8s1q3EauwDjN,fbPkOYLVPtPgIt0MxizjfFJov3JbHyAi,25,66,27,5,24,9,24,5,160,22.857142857142858,5,0.0,15,27,4,24,51,9,1,24,5,70,90,1
95,4012,bZSiNUbAIuydDBd77IMAJ15Hy6k2A1kT,fbPkOYLVPtPgIt0MxizjfFJov3JbHyAi,1,0,0,0,0,0,1,0,1,0.14285714285714285,1,0.0,0,0,0,0,0,0,0,1,0,0,1,1
96,4020,s7dtbhPs1iKqu788xCkGZggRAum1oJgW,fbPkOYLVPtPgIt0MxizjfFJov3JbHyAi,7,2,1,0,1,1,5,2,12,1.7142857142857142,1,0.0,0,1,0,1,2,1,0,5,2,2,10,1
97,4023,A98oANyiAwfle2kQ1TjJxeaYVrk9o9i7,fbPkOYLVPtPgIt0MxizjfFJov3JbHyAi,26,84,43,25,17,126,30,3,328,46.857142857142854,5,0.0,22,43,19,17,62,126,6,30,3,101,227,1
98,4027,WYF6gnZ4xRpre5Df26WMDKWFofwrAPRG,fbPkOYLVPtPgIt0MxizjfFJov3JbHyAi,15,107,0,8,0,19,28,1,163,23.285714285714285,11,0.0,14,0,8,0,93,19,0,28,1,22,141,1
99,4032,rLDet26H0uxPJ5dsCZ5fa0WL1GxwPxuK,fbPkOYLVPtPgIt0MxizjfFJov3JbHyAi,9,7,4,0,2,19,8,0,40,5.714285714285714,3,0.0,0,4,0,2,7,19,0,8,0,6,34,1
100,4033,OkJ0lKmMXuQ2MGftQ8Isfw1JciMpapRC,fbPkOYLVPtPgIt0MxizjfFJov3JbHyAi,5,3,2,0,2,2,2,0,11,1.5714285714285714,1,0.0,0,2,0,2,3,2,0,2,0,4,7,0
101,4034,rGQNVCuxfrzbvnkFPCMdRGiz6QMgyFzA,fbPkOYLVPtPgIt0MxizjfFJov3JbHyAi,6,5,2,0,3,0,1,0,11,1.5714285714285714,1,0.0,2,2,0,3,3,0,0,1,0,7,4,1
102,4037,87Lm8BclRnYN39dmpTmFhTgJtRlJLHVz,fbPkOYLVPtPgIt0MxizjfFJov3JbHyAi,5,2,1,0,1,0,2,0,6,0.8571428571428571,1,0.0,0,1,0,1,2,0,0,2,0,2,4,1
103,4038,RZRLmBfJaLV1U3x2iNOo982VF2lx4M5E,fbPkOYLVPtPgIt0MxizjfFJov3JbHyAi,35,45,20,26,12,65,9,1,178,25.428571428571427,9,0.0,10,20,23,12,35,65,3,9,1,65,113,0
104,4041,mmBEzZ1YFdSzzY513HhhaTI5HINoZNej,fbPkOYLVPtPgIt0MxizjfFJov3JbHyAi,6,3,0,0,0,0,5,0,8,1.1428571428571428,1,0.0,0,0,0,0,3,0,0,5,0,0,8,1
105,4043,AzVXW4kCWHtvQbdNXdZjm5qxnXDAkj3A,fbPkOYLVPtPgIt0MxizjfFJov3JbHyAi,7,5,2,0,2,0,2,0,11,1.5714285714285714,1,0.0,2,2,0,2,3,0,0,2,0,6,5,1
106,4045,hC8ztRi3EjwyWcSJecvgX15KmWpaGcdW,fbPkOYLVPtPgIt0MxizjfFJov3JbHyAi,11,15,9,0,6,1,27,1,59,8.428571428571429,6,0.0,0,9,0,6,15,1,0,27,1,15,44,1
107,4047,lHHgniZkyeFRjJGU3HLkOi9ieHbZHJUQ,fbPkOYLVPtPgIt0MxizjfFJov3JbHyAi,4,2,0,0,0,0,2,0,4,0.5714285714285714,1,0.0,0,0,0,0,2,0,0,2,0,0,4,1
108,4049,L9qMLlGWAeAI6zWAZIyJtn0wISNa3dxg,fbPkOYLVPtPgIt0MxizjfFJov3JbHyAi,4,2,1,0,1,0,2,0,6,0.8571428571428571,2,0.0,0,1,0,1,2,0,0,2,0,2,4,1
109,4050,0MTpVXdT8ASYCb3Z08epLhiKNkl8GgEQ,fbPkOYLVPtPgIt0MxizjfFJov3JbHyAi,18,16,9,11,8,0,6,0,50,7.142857142857143,2,0.0,5,9,9,8,11,0,2,6,0,31,19,1
110,4051,cT78xvKkV1UFGcRKty0V03Jr4RRPh50F,fbPkOYLVPtPgIt0MxizjfFJov3JbHyAi,11,14,5,4,3,0,12,3,41,5.857142857142857,1,0.0,3,5,3,3,11,0,1,12,3,14,27,1
111,4053,AOW4X6UkiHewUAs5OuRwOBQZ55uoQosX,fbPkOYLVPtPgIt0MxizjfFJov3JbHyAi,8,4,2,0,1,2,8,1,18,2.5714285714285716,3,0.0,0,2,0,1,4,2,0,8,1,3,15,1
112,4055,rAB3GdBf2kyPvfhSALJZpfL3o8n2yfaM,fbPkOYLVPtPgIt0MxizjfFJov3JbHyAi,13,16,10,4,6,0,6,0,42,6.0,4,0.0,1,10,3,6,15,0,1,6,0,20,22,1
113,4057,FsCZ2JlPdTOKccvkXXkGRkEo9MNtfR49,fbPkOYLVPtPgIt0MxizjfFJov3JbHyAi,4,2,1,0,1,0,1,0,5,0.7142857142857143,1,0.0,0,1,0,1,2,0,0,1,0,2,3,1
114,4058,CZqROpwtMfkuBimM2AQHyYwmYC0nRQMX,fbPkOYLVPtPgIt0MxizjfFJov3JbHyAi,2,0,0,0,0,0,6,0,6,0.8571428571428571,1,0.0,0,0,0,0,0,0,0,6,0,0,6,1
115,4059,k7E3UdMFCxZGbJkrqWFVZo27sTFlZitl,fbPkOYLVPtPgIt0MxizjfFJov3JbHyAi,2,0,0,0,0,0,4,0,4,0.5714285714285714,1,0.0,0,0,0,0,0,0,0,4,0,0,4,1
116,4063,DYy3OcZHNqaAwRPZTK5mmyz2pajxcVFG,fbPkOYLVPtPgIt0MxizjfFJov3JbHyAi,10,21,14,8,10,3,3,0,59,8.428571428571429,4,0.0,3,14,5,10,18,3,3,3,0,32,27,1
117,4067,etwrJvnLVRKl99lXJcTlVgF9a5u8b4IB,fbPkOYLVPtPgIt0MxizjfFJov3JbHyAi,4,2,1,0,1,0,1,0,5,0.7142857142857143,1,0.0,0,1,0,1,2,0,0,1,0,2,3,1
118,4068,Xtya7Ut5RfqXdKIJyeRno0pknCSJ0KQ9,fbPkOYLVPtPgIt0MxizjfFJov3JbHyAi,5,2,1,0,1,0,4,0,8,1.1428571428571428,1,0.0,0,1,0,1,2,0,0,4,0,2,6,1
119,4069,cvrniaRluzl5M2YhJj6gzVR22hfoNS7o,fbPkOYLVPtPgIt0MxizjfFJov3JbHyAi,5,2,1,0,1,0,3,0,7,1.0,1,0.0,0,1,0,1,2,0,0,3,0,2,5,1
120,4073,muLa1Vo0bC9fvm6n6sXrTQPXWjmeflat,fbPkOYLVPtPgIt0MxizjfFJov3JbHyAi,2,0,0,0,0,0,2,0,2,0.2857142857142857,1,0.0,0,0,0,0,0,0,0,2,0,0,2,0
121,4074,pPhnCYGqjbUED63FvqrsKWCb9oPSb13A,fbPkOYLVPtPgIt0MxizjfFJov3JbHyAi,8,8,5,0,3,4,6,0,26,3.7142857142857144,2,0.0,0,5,0,3,8,4,0,6,0,8,18,1
122,4075,p9RSc47fxU5KZrLFjwRWdfPjsbrYYsbL,fbPkOYLVPtPgIt0MxizjfFJov3JbHyAi,17,36,11,20,10,26,16,1,120,17.142857142857142,4,0.0,12,11,16,10,24,26,4,16,1,49,71,1
123,4076,xyBRzNYMnXahEQBoehtwEHCPr5ttcqSy,fbPkOYLVPtPgIt0MxizjfFJov3JbHyAi,9,7,3,0,4,0,4,0,18,2.5714285714285716,1,0.0,3,3,0,4,4,0,0,4,0,10,8,1
124,4078,yZ6537rd8avkULuEwmDtoeWv0g2tI9No,fbPkOYLVPtPgIt0MxizjfFJov3JbHyAi,6,5,4,0,4,5,2,0,20,2.857142857142857,1,0.0,0,4,0,4,5,5,0,2,0,8,12,1
125,4079,k6RJ44LpfDefc4BqSfb5Ks3bqRLzpbPs,fbPkOYLVPtPgIt0MxizjfFJov3JbHyAi,5,4,2,0,1,0,3,0,10,1.4285714285714286,2,0.0,0,2,0,1,4,0,0,3,0,3,7,1
126,4080,wGCry3EmryoBv7Csae49tbGzHF0lQra2,fbPkOYLVPtPgIt0MxizjfFJov3JbHyAi,7,4,2,0,1,5,10,0,22,3.142857142857143,2,0.0,0,2,0,1,4,5,0,10,0,3,19,1
127,4082,Intzo0A8tpMyd3IA01YG1BctRIdPWdNV,fbPkOYLVPtPgIt0MxizjfFJov3JbHyAi,10,22,1,4,0,35,9,0,71,10.142857142857142,4,0.0,4,1,3,0,18,35,1,9,0,8,63,0
128,4085,kjoYyxOsZaiCA9S8PMK5B69QLaH15SYn,fbPkOYLVPtPgIt0MxizjfFJov3JbHyAi,10,19,12,0,6,21,9,0,67,9.571428571428571,4,0.0,0,12,0,6,19,21,0,9,0,18,49,1
129,4086,99KAycUWIde0VU3hu66xpS6f8Dw5XMUf,fbPkOYLVPtPgIt0MxizjfFJov3JbHyAi,6,3,0,0,0,9,5,1,18,2.5714285714285716,1,0.0,0,0,0,0,3,9,0,5,1,0,18,1
130,4087,kyUPY0MEVeZNvkmrQxOn0CHNXLZiD03b,fbPkOYLVPtPgIt0MxizjfFJov3JbHyAi,17,37,21,0,8,19,15,0,100,14.285714285714286,5,0.0,6,21,0,8,31,19,0,15,0,35,65,0
131,4089,xHHwDRtwZQVvSchbI5GuritLImybQBlY,fbPkOYLVPtPgIt0MxizjfFJov3JbHyAi,22,60,47,0,39,13,11,0,170,24.285714285714285,5,0.0,0,47,0,39,60,13,0,11,0,86,84,1
132,4092,FWBo1Ve6aUEc5FnBNwSlwL8Ejasy32Ah,fbPkOYLVPtPgIt0MxizjfFJov3JbHyAi,24,207,5,21,8,62,18,3,324,46.285714285714285,11,0.0,59,5,17,8,148,62,4,18,3,89,235,1
133,4094,aHy0SOLp5TIYEPrUDsA19thlT8zgE9kw,fbPkOYLVPtPgIt0MxizjfFJov3JbHyAi,7,3,2,0,2,0,2,0,9,1.2857142857142858,1,0.0,0,2,0,2,3,0,0,2,0,4,5,1
134,4096,7f5BucMg0feISwFBvqaHF0DKL8QG4WFt,fbPkOYLVPtPgIt0MxizjfFJov3JbHyAi,6,10,4,0,2,2,7,0,25,3.5714285714285716,4,0.0,0,4,0,2,10,2,0,7,0,6,19,1
135,4098,7t6XdKZrxDN4lQnu2mS0b8xNunzNVAPj,fbPkOYLVPtPgIt0MxizjfFJov3JbHyAi,6,3,2,0,2,0,1,0,8,1.1428571428571428,1,0.0,0,2,0,2,3,0,0,1,0,4,4,1
136,4099,Rp1QUon6WyfjWJdUcBo02v2P6oL5StoN,fbPkOYLVPtPgIt0MxizjfFJov3JbHyAi,40,82,47,10,33,132,39,9,352,50.285714285714285,8,0.0,19,47,8,33,63,132,2,39,9,107,245,0
137,4100,biOEnvJNbNmJmtnLohBToN5g3ppQrMj4,fbPkOYLVPtPgIt0MxizjfFJov3JbHyAi,49,188,70,55,44,29,21,4,411,58.714285714285715,6,0.0,54,70,47,44,134,29,8,21,4,215,196,0
138,4102,DQcZziMBGJTQn4VwY66mMsTqydvYxO88,fbPkOYLVPtPgIt0MxizjfFJov3JbHyAi,15,31,17,4,8,4,9,0,73,10.428571428571429,5,0.0,5,17,3,8,26,4,1,9,0,33,40,1
139,4104,cT38CQfUVEuJ2lsb0Hk89Z8ENzEcFYoN,fbPkOYLVPtPgIt0MxizjfFJov3JbHyAi,11,12,3,4,4,17,15,5,60,8.571428571428571,1,0.0,6,3,3,4,6,17,1,15,5,16,44,1
140,4107,hXZgc5Oc8L3KNvO8ElQE29RF6Exzr76M,fbPkOYLVPtPgIt0MxizjfFJov3JbHyAi,35,232,7,30,9,45,36,1,360,51.42857142857143,15,0.0,56,7,28,9,176,45,2,36,1,100,260,1
141,4109,UTHVC9ResLri50kLlwVRolzN0EU0QbSV,fbPkOYLVPtPgIt0MxizjfFJov3JbHyAi,7,9,3,0,4,0,3,0,19,2.7142857142857144,1,0.0,4,3,0,4,5,0,0,3,0,11,8,1
142,4110,IhZdPOtOeXyg0OwsQIkD0XHc4IVBLzMp,fbPkOYLVPtPgIt0MxizjfFJov3JbHyAi,12,20,12,0,3,15,4,0,54,7.714285714285714,2,0.0,4,12,0,3,16,15,0,4,0,19,35,1
143,4115,JxLtKAnMek98G5fWpyeTaKlh0zheuNnU,fbPkOYLVPtPgIt0MxizjfFJov3JbHyAi,9,14,8,0,5,2,6,0,35,5.0,3,0.0,0,8,0,5,14,2,0,6,0,13,22,1
144,4118,lJBDlJfqpfLWNzA9gJNRBPGPdfnA8FjE,fbPkOYLVPtPgIt0MxizjfFJov3JbHyAi,11,14,4,5,5,0,10,0,38,5.428571428571429,2,0.0,6,4,4,5,8,0,1,10,0,19,19,1
145,4119,NDGD5kd43PPvwOqGnZbnmRA4IWxJUUWC,fbPkOYLVPtPgIt0MxizjfFJov3JbHyAi,11,10,6,0,5,13,5,1,40,5.714285714285714,1,0.0,0,6,0,5,10,13,0,5,1,11,29,1
146,4120,PLiz4R37f42hgWuNrDCM4We21NotfdFu,fbPkOYLVPtPgIt0MxizjfFJov3JbHyAi,10,8,3,0,3,0,4,0,18,2.5714285714285716,1,0.0,0,3,0,3,8,0,0,4,0,6,12,1
147,4123,v5fgLzwSp4csuplvg9kjWtplfkZ2GwCX,fbPkOYLVPtPgIt0MxizjfFJov3JbHyAi,53,93,52,51,30,94,32,1,353,50.42857142857143,11,0.0,18,52,48,30,75,94,3,32,1,148,205,1
148,4128,QFQlbn421RXpUzVVaKhkxpBlvQfTJy18,fbPkOYLVPtPgIt0MxizjfFJov3JbHyAi,1,0,0,0,0,0,2,0,2,0.2857142857142857,2,0.0,0,0,0,0,0,0,0,2,0,0,2,1
149,4131,IeoenmsgL9uI9DnVMbUVvL3IGBjOCvft,fbPkOYLVPtPgIt0MxizjfFJov3JbHyAi,7,22,10,0,6,6,4,0,48,6.857142857142857,2,0.0,1,10,0,6,21,6,0,4,0,17,31,1
150,4132,0EnifHYs46yDInpwwIuVTnoLaWAcGzwI,fbPkOYLVPtPgIt0MxizjfFJov3JbHyAi,2,0,0,0,0,0,7,0,7,1.0,1,0.0,0,0,0,0,0,0,0,7,0,0,7,1
151,4139,KGmMkFplDRCxys7XWInR8BCBSZINLZGV,fbPkOYLVPtPgIt0MxizjfFJov3JbHyAi,7,3,2,0,2,0,6,0,13,1.8571428571428572,1,0.0,0,2,0,2,3,0,0,6,0,4,9,1
152,4142,lnvoZ2tnJVetz4XYfY83aKXEsZTCt6TJ,fbPkOYLVPtPgIt0MxizjfFJov3JbHyAi,5,2,1,0,1,0,2,0,6,0.8571428571428571,1,0.0,0,1,0,1,2,0,0,2,0,2,4,1
153,4144,8FXCmdqVnzf3TYAPHoGg8tXyARiNLHCI,fbPkOYLVPtPgIt0MxizjfFJov3JbHyAi,14,34,24,0,13,5,19,1,96,13.714285714285714,3,0.0,2,24,0,13,32,5,0,19,1,39,57,1
154,4151,Ke8VwfqDMnQ67aDANakOnH0vYOFJh9kP,fbPkOYLVPtPgIt0MxizjfFJov3JbHyAi,5,2,0,0,0,0,4,0,6,0.8571428571428571,1,0.0,0,0,0,0,2,0,0,4,0,0,6,1
155,4153,9bv4TssyKs6woXSaEFvigyhEyIkdO1mQ,fbPkOYLVPtPgIt0MxizjfFJov3JbHyAi,24,65,26,9,18,6,22,1,147,21.0,7,0.0,17,26,9,18,48,6,0,22,1,70,77,1
156,4154,P7HoHyQzVXLghYr6m3MYTEIsDQbHfDfp,fbPkOYLVPtPgIt0MxizjfFJov3JbHyAi,8,7,4,0,3,2,5,0,21,3.0,2,0.0,1,4,0,3,6,2,0,5,0,8,13,1
157,4156,7wnX5auEB03UpnNYej7D6uFMFlr0UMF4,fbPkOYLVPtPgIt0MxizjfFJov3JbHyAi,45,92,26,38,30,60,29,1,276,39.42857142857143,7,0.0,40,26,31,30,52,60,7,29,1,127,149,1
158,4158,i2lUV72IHqqXWYqLFMWv3y4XGmlq2lXa,fbPkOYLVPtPgIt0MxizjfFJov3JbHyAi,15,36,18,18,0,0,13,0,85,12.142857142857142,7,0.0,7,18,17,0,29,0,1,13,0,42,43,0
159,4159,K7x1FBngM9kl9ILUtVAk9JDodBBRiKnk,fbPkOYLVPtPgIt0MxizjfFJov3JbHyAi,5,2,0,0,1,0,2,0,5,0.7142857142857143,1,0.0,0,0,0,1,2,0,0,2,0,1,4,1
160,4165,PQXXfcguNvwGC13fUA8grymIl8Xku68T,fbPkOYLVPtPgIt0MxizjfFJov3JbHyAi,8,5,4,0,1,4,9,1,24,3.4285714285714284,1,0.0,0,4,0,1,5,4,0,9,1,5,19,1
161,4166,bUnyK1hKhmXoEcHzbj5c3xR9U7XUAY5Y,fbPkOYLVPtPgIt0MxizjfFJov3JbHyAi,17,25,6,5,5,4,0,0,45,6.428571428571429,5,0.0,3,6,4,5,22,4,1,0,0,18,27,1
162,4167,1LwHP3062AHKmQwDl3FPlP3B3adaBvx7,fbPkOYLVPtPgIt0MxizjfFJov3JbHyAi,13,7,4,0,4,0,9,1,25,3.5714285714285716,3,0.0,0,4,0,4,7,0,0,9,1,8,17,1
163,4180,vQkP6BX5beW8TPAuFxWcKaAXLl3r77bC,SpATywNh6bZuzm8s1ceuBUnMUAeoAHHw,4,3,2,0,2,0,2,0,9,1.2857142857142858,1,0.0,0,2,0,2,3,0,0,2,0,4,5,1
164,4188,Em0hjKXRkhdtpThrexhSS4wvCtqaUFMH,SpATywNh6bZuzm8s1ceuBUnMUAeoAHHw,28,41,15,35,8,0,6,0,105,15.0,3,0.0,22,15,29,8,19,0,6,6,0,74,31,0
165,4189,DMRT6aSto1hsV85RHmev1d5IWcNMIFEq,SpATywNh6bZuzm8s1ceuBUnMUAeoAHHw,28,45,17,16,5,19,9,0,111,15.857142857142858,6,0.0,11,17,15,5,34,19,1,9,0,48,63,0
166,4191,s0DIFg7W3dnddXITKcNP8LHUkKIQHugk,A3fsA9Zfv1X2fVEQhTw51lKENdNrEqT3,42,28,16,36,13,0,8,2,103,14.714285714285714,6,0.0,1,16,35,13,27,0,1,8,2,65,38,0
167,4240,bN6JhUz4s97Xsh7eq2ZH1ilTMaKJDuUF,A3fsA9Zfv1X2fVEQhTw51lKENdNrEqT3,69,124,47,138,26,44,28,2,409,58.42857142857143,9,0.0,6,47,109,26,118,44,29,28,2,188,221,1
168,4257,7FYMj2bFfaTXHKfoaKa59KqAPXY4BWgD,SpATywNh6bZuzm8s1ceuBUnMUAeoAHHw,28,37,22,29,7,0,17,0,112,16.0,8,0.0,4,22,27,7,33,0,2,17,0,60,52,0
169,4264,I91CCtQfetYUPwkEXIvTFBP6tbrp1spN,SpATywNh6bZuzm8s1ceuBUnMUAeoAHHw,31,49,25,14,13,3,12,2,118,16.857142857142858,6,0.0,16,25,13,13,33,3,1,12,2,67,51,0
170,4267,RGl45e2VVMMdpatWhMc5IOKclnuxXpA1,SpATywNh6bZuzm8s1ceuBUnMUAeoAHHw,18,19,13,8,7,0,12,0,59,8.428571428571429,3,0.0,1,13,6,7,18,0,2,12,0,27,32,0
171,4282,sm8Pt42lYmt5RjZttn9EWmBp0Dzh6yOg,G8EPVSXsOYB5YQWZGiz1aVq5Pgr2GrQu,35,34,19,0,16,0,5,0,74,10.571428571428571,2,0.0,3,19,0,16,31,0,0,5,0,38,36,1
172,4289,zEiNHlokNuJTLVoV4Hy4kJd9kzaIjztD,G8EPVSXsOYB5YQWZGiz1aVq5Pgr2GrQu,78,160,54,166,30,214,12,3,639,91.28571428571429,11,0.0,61,54,126,30,99,214,40,12,3,271,368,1
173,4307,T90Hs0qj1GFlvauwj06O8IdnwXmrJzdZ,SpATywNh6bZuzm8s1ceuBUnMUAeoAHHw,9,24,1,5,0,0,2,0,32,4.571428571428571,1,0.0,1,1,4,0,23,0,1,2,0,6,26,1
174,4315,BQkLFspAkEwZRgeuoSbQxFTr6POAaRzP,SpATywNh6bZuzm8s1ceuBUnMUAeoAHHw,15,22,4,38,0,5,11,3,83,11.857142857142858,4,0.0,15,4,35,0,7,5,3,11,3,54,29,0
175,4356,4K59wuCrpPJyRcx38K4BUYetxztFLpnt,SpATywNh6bZuzm8s1ceuBUnMUAeoAHHw,9,4,3,0,3,0,4,0,14,2.0,1,0.0,0,3,0,3,4,0,0,4,0,6,8,1
176,4363,TQnfaXCRCgVZx9kYYn4s6Q3eXGXW2mAu,SpATywNh6bZuzm8s1ceuBUnMUAeoAHHw,27,51,14,34,6,77,17,2,201,28.714285714285715,6,0.0,11,14,28,6,40,77,6,17,2,59,142,0
177,4367,5I2aLwWP8vG6g175Y3fJi9X9n53v6aCn,SpATywNh6bZuzm8s1ceuBUnMUAeoAHHw,31,96,56,44,19,334,74,3,626,89.42857142857143,15,0.0,16,56,34,19,80,334,10,74,3,125,501,1
178,4380,5GeMwmyzCXMcMYfcWdKaXbpNNdL8bmPq,bWdj2GDclj5ofokWjzoa5jAwMkxCykd6,52,77,39,168,11,254,76,2,627,89.57142857142857,11,0.0,14,39,134,11,63,254,34,76,2,198,429,0
179,4385,wzrtLsMLUwSE1eXDXVMESg2JjrWZl4JD,SpATywNh6bZuzm8s1ceuBUnMUAeoAHHw,8,29,14,0,0,6,10,0,59,8.428571428571429,8,0.0,6,14,0,0,23,6,0,10,0,20,39,0
180,4417,0wJhtCWK60WPCeRF62m8T80DtNpWhRrg,A3fsA9Zfv1X2fVEQhTw51lKENdNrEqT3,46,40,20,72,12,0,7,0,151,21.571428571428573,5,0.0,1,20,69,12,39,0,3,7,0,102,49,1
181,4427,8DDe6pT3DTsk8IoUaxeHbA3kSbfeV3pT,SpATywNh6bZuzm8s1ceuBUnMUAeoAHHw,15,30,9,3,2,0,25,0,69,9.857142857142858,4,0.0,5,9,3,2,25,0,0,25,0,19,50,1
182,4429,BKMLDrZrwnjIMy3sAyFHQhrFM6liXbvY,SpATywNh6bZuzm8s1ceuBUnMUAeoAHHw,17,23,0,24,0,0,3,0,50,7.142857142857143,2,0.0,9,0,24,0,14,0,0,3,0,33,17,1
183,4438,3IgwuZBiVdgdYRQ9ySaEvpMizbjCJFS0,SpATywNh6bZuzm8s1ceuBUnMUAeoAHHw,30,44,18,20,9,59,23,1,174,24.857142857142858,6,0.0,15,18,18,9,29,59,2,23,1,60,114,0
184,4460,oxOzo82Nq65tcwE6AZvxglw3lN8SeywJ,bWdj2GDclj5ofokWjzoa5jAwMkxCykd6,19,33,17,104,10,0,9,0,173,24.714285714285715,3,0.0,7,17,98,10,26,0,6,9,0,132,41,1
185,4467,ud8Y2EsnBupML3rKElwJORvnGy1H8SMp,bWdj2GDclj5ofokWjzoa5jAwMkxCykd6,4,2,1,0,1,0,1,0,5,0.7142857142857143,1,0.0,0,1,0,1,2,0,0,1,0,2,3,1
186,4471,lEIFkqeT396JMSPUyiaHNMN8g7bQ1x9p,RXDvfPUBYFlVdlueBFbLW0mhhAyGEqpt,72,85,66,94,54,11,32,3,345,49.285714285714285,7,0.0,15,66,93,54,70,11,1,32,3,228,117,0
187,4492,800Nw5pvfdV7zCXCGav7KOLaYLAdOKht,SpATywNh6bZuzm8s1ceuBUnMUAeoAHHw,25,80,3,26,1,48,70,1,229,32.714285714285715,9,0.0,18,3,26,1,62,48,0,70,1,48,181,0
188,4494,wONMmUHIYwPBmEB9lgpOY3KCldKiuZFl,G8EPVSXsOYB5YQWZGiz1aVq5Pgr2GrQu,59,75,31,58,19,7,41,2,233,33.285714285714285,9,0.0,34,31,36,19,41,7,22,41,2,120,113,0
189,4501,dQuJ0DGjqbpnmQbHBTUIoBt7YzvOBCuV,SpATywNh6bZuzm8s1ceuBUnMUAeoAHHw,11,12,7,0,4,0,1,0,24,3.4285714285714284,1,0.0,3,7,0,4,9,0,0,1,0,14,10,1
190,4503,JJDRXXLRU75H8Dx2cuK7Td1V7D7QoKg9,SpATywNh6bZuzm8s1ceuBUnMUAeoAHHw,26,38,1,26,2,2,19,1,89,12.714285714285714,6,0.0,10,1,25,2,28,2,1,19,1,38,51,0
191,4529,DB1URyLII1znnmxnZlmmkOEalzIpmvtZ,A3fsA9Zfv1X2fVEQhTw51lKENdNrEqT3,18,18,9,0,5,0,6,0,38,5.428571428571429,1,0.0,0,9,0,5,18,0,0,6,0,14,24,1
192,4557,s4xNNQ4RZ35amMfmvZawsu7u8CabnIey,A3fsA9Zfv1X2fVEQhTw51lKENdNrEqT3,48,42,26,78,13,87,38,2,286,40.857142857142854,6,0.0,4,26,61,13,38,87,17,38,2,104,182,0
193,4558,oxOzo82Nq65tcwE6AZvxglw3lN8SeywJ,A3fsA9Zfv1X2fVEQhTw51lKENdNrEqT3,21,18,13,0,9,0,5,0,45,6.428571428571429,2,0.0,0,13,0,9,18,0,0,5,0,22,23,1
194,4562,sOkc0wEXSSLpxtxlqjZObJqg94IyLpuY,bWdj2GDclj5ofokWjzoa5jAwMkxCykd6,45,82,2,118,0,17,35,1,255,36.42857142857143,11,0.0,11,2,103,0,71,17,15,35,1,116,139,1
195,4576,alnogGpZqhBWQHh6ZLeZUIXk896ksLOu,RXDvfPUBYFlVdlueBFbLW0mhhAyGEqpt,14,31,2,2,1,4,17,3,60,8.571428571428571,4,0.0,2,2,2,1,29,4,0,17,3,7,53,1
196,4580,PUW0i4IuafllkJEtV0GCqmTDeLHkDmH3,A3fsA9Zfv1X2fVEQhTw51lKENdNrEqT3,65,108,24,169,8,251,57,2,619,88.42857142857143,10,0.0,3,24,133,8,105,251,36,57,2,168,451,0
197,4597,y7HHpDc09mCS3h1lthBIJASJI1RnROT7,RXDvfPUBYFlVdlueBFbLW0mhhAyGEqpt,7,4,3,0,2,0,1,0,10,1.4285714285714286,1,0.0,0,3,0,2,4,0,0,1,0,5,5,1
198,4609,UqksMVZ1lLvn2u7s6dT9SU5OFeNJnaAy,A3fsA9Zfv1X2fVEQhTw51lKENdNrEqT3,45,73,34,42,21,3,9,2,184,26.285714285714285,4,0.0,4,34,38,21,69,3,4,9,2,97,87,1
199,4639,3OcDTnCwcizCpcOtz2UR6tflsBOvlv2R,SpATywNh6bZuzm8s1ceuBUnMUAeoAHHw,26,67,4,37,1,1,39,2,151,21.571428571428573,11,0.0,15,4,34,1,52,1,3,39,2,54,97,0
200,4642,qP2KbX0Pm1BCeErne0g8Q8oALeaVx7L6,SpATywNh6bZuzm8s1ceuBUnMUAeoAHHw,4,2,1,0,1,0,1,0,5,0.7142857142857143,1,0.0,0,1,0,1,2,0,0,1,0,2,3,0
201,4653,IeSddciCla7lkuGxlh3rPQuCAXyzOV2D,SpATywNh6bZuzm8s1ceuBUnMUAeoAHHw,31,47,18,35,11,16,10,2,139,19.857142857142858,4,0.0,26,18,31,11,21,16,4,10,2,86,53,1
202,4654,DsHgWZRTJ1y1l15smwhB78ZQq3d8dyKP,SpATywNh6bZuzm8s1ceuBUnMUAeoAHHw,25,86,4,42,3,26,31,3,195,27.857142857142858,11,0.0,21,4,37,3,65,26,5,31,3,65,130,0
203,4668,r5RSR6lot2jmkfKvV1hMDjuwwaPyA58W,SpATywNh6bZuzm8s1ceuBUnMUAeoAHHw,23,51,8,21,6,0,16,0,102,14.571428571428571,6,0.0,21,8,17,6,30,0,4,16,0,52,50,0
204,4678,SXmv5BCLsa8KcmJ2wx7Xg5CRI8Gu1aDd,bWdj2GDclj5ofokWjzoa5jAwMkxCykd6,20,48,23,0,11,19,15,0,116,16.571428571428573,5,0.0,0,23,0,11,48,19,0,15,0,34,82,0
205,4682,a59vIKGy87nbLYAxp6cxkmNDzOYhSXnX,SpATywNh6bZuzm8s1ceuBUnMUAeoAHHw,31,44,33,31,17,2,15,0,142,20.285714285714285,5,0.0,4,33,28,17,40,2,3,15,0,82,60,1
206,4699,7xdvqdjwrTcnpU47VRFtnMnSYVyjOAaR,SpATywNh6bZuzm8s1ceuBUnMUAeoAHHw,20,30,4,26,0,0,7,0,67,9.571428571428571,4,0.0,4,4,25,0,26,0,1,7,0,33,34,0
207,4701,eg4vjaGd0e6Yp3fu5azU2ZqedIZ6GBxl,SpATywNh6bZuzm8s1ceuBUnMUAeoAHHw,24,53,2,28,0,8,28,2,121,17.285714285714285,8,0.0,19,2,21,0,34,8,7,28,2,42,79,0
208,4703,C8ZlatATbcer8D4Z8pCX4rv1Rcx870po,RXDvfPUBYFlVdlueBFbLW0mhhAyGEqpt,47,59,30,93,16,21,22,7,248,35.42857142857143,6,0.0,12,30,74,16,47,21,19,22,7,132,116,0
209,4778,xcD6YWhnGA2xukGmX4eaYrm6VS9ffz1H,G8EPVSXsOYB5YQWZGiz1aVq5Pgr2GrQu,46,67,41,68,11,3,15,0,205,29.285714285714285,3,0.0,13,41,52,11,54,3,16,15,0,117,88,0
210,4810,2LtuchYgE8Pco2t6mZeF2PkyT5iYJ1L1,SpATywNh6bZuzm8s1ceuBUnMUAeoAHHw,25,39,8,14,4,36,16,0,117,16.714285714285715,7,0.0,4,8,14,4,35,36,0,16,0,30,87,0
211,4814,SmONSyS4YgG4Afnv6ZxU81t7p4CQPV5P,A3fsA9Zfv1X2fVEQhTw51lKENdNrEqT3,42,79,16,16,8,0,25,1,145,20.714285714285715,8,0.0,0,16,13,8,79,0,3,25,1,37,108,1
212,4828,f2h2VLvmMjqsSE1GgoTjiV7kOBQ7ba5D,SpATywNh6bZuzm8s1ceuBUnMUAeoAHHw,25,49,16,19,11,16,9,1,121,17.285714285714285,6,0.0,24,16,17,11,25,16,2,9,1,68,53,0
213,4853,6dSQI7mEgoqnNix7RTxCbRowcn4dgEn6,SpATywNh6bZuzm8s1ceuBUnMUAeoAHHw,7,3,2,7,1,0,3,0,16,2.2857142857142856,2,0.0,0,2,6,1,3,0,1,3,0,9,7,0
214,4862,9k6Repn2h6zXTygwvpy8LAM7GzTSYQBm,G8EPVSXsOYB5YQWZGiz1aVq5Pgr2GrQu,107,145,87,169,57,8,24,3,493,70.42857142857143,9,0.0,41,87,140,57,104,8,29,24,3,325,168,0
215,4866,GmHJt2279LUj6P2OGQD6V5Y1W95kmZpl,SpATywNh6bZuzm8s1ceuBUnMUAeoAHHw,22,60,9,14,4,17,19,0,123,17.571428571428573,8,0.0,0,9,13,4,60,17,1,19,0,26,97,1
216,4870,T2tyjiaDe9s4tWUugE6FZTShWofnfMqo,bWdj2GDclj5ofokWjzoa5jAwMkxCykd6,39,103,7,180,12,64,20,3,389,55.57142857142857,12,0.0,32,7,166,12,71,64,14,20,3,217,172,0
217,4885,sOkc0wEXSSLpxtxlqjZObJqg94IyLpuY,A3fsA9Zfv1X2fVEQhTw51lKENdNrEqT3,64,114,5,124,2,24,50,0,319,45.57142857142857,13,0.0,5,5,108,2,109,24,16,50,0,120,199,0
218,4912,gVGEUb9jfMmddRlcGqXsnz4ZV26w6q4e,SpATywNh6bZuzm8s1ceuBUnMUAeoAHHw,22,27,18,16,8,0,6,0,75,10.714285714285714,4,0.0,3,18,13,8,24,0,3,6,0,42,33,0
219,4918,QDpN8D19Mr8RZumTONWpZNlCWcHCCTbH,A3fsA9Zfv1X2fVEQhTw51lKENdNrEqT3,19,42,5,0,1,0,6,0,54,7.714285714285714,5,0.0,0,5,0,1,42,0,0,6,0,6,48,0
220,4945,ySy2zYThCkVZr5MjEXuKxq60wfOynxkJ,SpATywNh6bZuzm8s1ceuBUnMUAeoAHHw,25,59,1,33,1,49,33,3,179,25.571428571428573,9,0.0,6,1,29,1,53,49,4,33,3,37,142,0
221,4946,SVwfCRY50hd9Fz0klab9XqT7QROcyhqY,SpATywNh6bZuzm8s1ceuBUnMUAeoAHHw,29,41,22,36,10,6,7,0,122,17.428571428571427,3,0.0,15,22,30,10,26,6,6,7,0,77,45,0
222,4950,QIQydLQKNp8IAhwJcWzcTMkwBUNbfwOF,SpATywNh6bZuzm8s1ceuBUnMUAeoAHHw,26,90,3,31,2,483,32,6,647,92.42857142857143,8,0.0,33,3,29,2,57,483,2,32,6,67,580,0
223,4953,VZdYnvKDyQlSbZcXkY9T9OB3rX2Vy7uz,SpATywNh6bZuzm8s1ceuBUnMUAeoAHHw,2,0,0,0,0,0,3,0,3,0.42857142857142855,2,0.0,0,0,0,0,0,0,0,3,0,0,3,1
224,4957,W4dUmcINvn4EmYk22ZRR3EuEX8WaEqL8,bWdj2GDclj5ofokWjzoa5jAwMkxCykd6,5,5,2,0,1,1,2,0,11,1.5714285714285714,1,0.0,0,2,0,1,5,1,0,2,0,3,8,1
225,4959,DCJHya56uWCPb8fqNJdPu3ruMX2t5RgK,bWdj2GDclj5ofokWjzoa5jAwMkxCykd6,1,0,0,0,0,0,1,0,1,0.14285714285714285,1,0.0,0,0,0,0,0,0,0,1,0,0,1,1
226,4981,syrttArug8Mpzs9L0IHsvBtATawYF9J2,bWdj2GDclj5ofokWjzoa5jAwMkxCykd6,53,47,19,109,19,14,10,1,219,31.285714285714285,3,0.0,23,19,90,19,24,14,19,10,1,151,68,0
227,4991,meJV5qRzmJA836PpWZKeoFo4ZX1xiQOS,RXDvfPUBYFlVdlueBFbLW0mhhAyGEqpt,28,41,21,30,13,7,4,0,116,16.571428571428573,5,0.0,2,21,27,13,39,7,3,4,0,63,53,1
228,5020,7kNYuUNvdIVdadzDsnKIKM0Ln3KLHYo2,SpATywNh6bZuzm8s1ceuBUnMUAeoAHHw,32,95,39,28,12,25,61,5,265,37.857142857142854,11,0.0,23,39,23,12,72,25,5,61,5,97,168,1
229,5022,QCXbyb2FyuLlETPxf3u27tgIYTs9gTM4,SpATywNh6bZuzm8s1ceuBUnMUAeoAHHw,31,76,39,35,15,45,19,1,230,32.857142857142854,6,0.0,24,39,30,15,52,45,5,19,1,108,122,0
230,5031,6Qw49dxLKsjbapN7r9Da43ajoDW7rCxT,G8EPVSXsOYB5YQWZGiz1aVq5Pgr2GrQu,22,59,37,10,7,549,44,12,718,102.57142857142857,17,0.0,4,37,5,7,55,549,5,44,12,53,665,0
231,5041,m9R5p8ELPeEGL2TgmgmNZypetc0YKw9N,SpATywNh6bZuzm8s1ceuBUnMUAeoAHHw,5,2,1,0,1,0,2,0,6,0.8571428571428571,1,0.0,0,1,0,1,2,0,0,2,0,2,4,1
232,5069,pOySDxOmbrI0pDd4UMGfMc77U1VB32Te,A3fsA9Zfv1X2fVEQhTw51lKENdNrEqT3,2,0,0,0,0,0,2,0,2,0.2857142857142857,1,0.0,0,0,0,0,0,0,0,2,0,0,2,1
233,5082,rVF6sxySmleXKBlMsWpXjKDnmQNSzrnS,G8EPVSXsOYB5YQWZGiz1aVq5Pgr2GrQu,134,218,136,358,73,22,64,1,872,124.57142857142857,8,0.0,51,136,292,73,167,22,66,64,1,552,320,0
234,5096,rsMqzQV4BJo2NdhTX79HDXS5zRZgLPX5,SpATywNh6bZuzm8s1ceuBUnMUAeoAHHw,29,33,19,42,9,1,12,0,116,16.571428571428573,4,0.0,13,19,37,9,20,1,5,12,0,78,38,0
235,5142,B6vCUtkVL8SVuEEWctSPinCUr9rxihnh,G8EPVSXsOYB5YQWZGiz1aVq5Pgr2GrQu,44,85,38,86,20,20,13,1,263,37.57142857142857,4,0.0,36,38,65,20,49,20,21,13,1,159,104,0
236,5152,RZI7KROUR7i2T6MB71TuoKGbXE5WXiwO,bWdj2GDclj5ofokWjzoa5jAwMkxCykd6,7,8,0,0,0,0,4,0,12,1.7142857142857142,2,0.0,0,0,0,0,8,0,0,4,0,0,12,1
237,5153,JiVwV8l6zLIAeTDli3uYE3CMxT1oG8Me,SpATywNh6bZuzm8s1ceuBUnMUAeoAHHw,19,43,7,18,2,0,30,0,100,14.285714285714286,8,0.0,7,7,15,2,36,0,3,30,0,31,69,0
238,5173,d6aHeIWZcsirh8eDlHrmG2KrUzDWnJuj,A3fsA9Zfv1X2fVEQhTw51lKENdNrEqT3,14,17,12,0,10,0,8,0,47,6.714285714285714,2,0.0,0,12,0,10,17,0,0,8,0,22,25,1
239,5217,EP1XQRGS4HZOG1hdGzNZdD1HFhJcHpos,RXDvfPUBYFlVdlueBFbLW0mhhAyGEqpt,56,58,6,102,0,36,19,0,221,31.571428571428573,7,0.0,14,6,96,0,44,36,6,19,0,116,105,0
240,5224,vEkraIjbJw9RkPvqczZeJYSVVtpO2PkE,G8EPVSXsOYB5YQWZGiz1aVq5Pgr2GrQu,18,15,9,0,10,0,15,0,49,7.0,4,0.0,5,9,0,10,10,0,0,15,0,24,25,1
241,5259,hdKqkkWKrDzbKE9btGChBqiCfsTwp68E,bWdj2GDclj5ofokWjzoa5jAwMkxCykd6,38,89,50,120,12,202,74,3,550,78.57142857142857,16,0.0,9,50,105,12,80,202,15,74,3,176,374,0
242,5279,cs5iJZEgrhw6pymo9S5BmSlmIVmjOxuC,A3fsA9Zfv1X2fVEQhTw51lKENdNrEqT3,4,2,1,0,1,0,1,0,5,0.7142857142857143,1,0.0,0,1,0,1,2,0,0,1,0,2,3,1
243,5303,o9EVHnUUU8I3f9dlC8NAcnHlKvZOnRmy,bWdj2GDclj5ofokWjzoa5jAwMkxCykd6,48,58,14,120,10,3,12,1,218,31.142857142857142,6,0.0,13,14,111,10,45,3,9,12,1,148,70,0
244,5305,o9EVHnUUU8I3f9dlC8NAcnHlKvZOnRmy,A3fsA9Zfv1X2fVEQhTw51lKENdNrEqT3,88,67,11,150,6,23,25,1,283,40.42857142857143,11,0.0,3,11,141,6,64,23,9,25,1,161,122,0
245,5310,OMEL4ay2FeLAUvBpF5PNfopRFoBTNYW8,SpATywNh6bZuzm8s1ceuBUnMUAeoAHHw,12,29,0,11,0,0,5,0,45,6.428571428571429,4,0.0,11,0,10,0,18,0,1,5,0,21,24,0
246,5319,hDWTDNoM8bIQS3Q25EYxxHniqW2wmxDn,bWdj2GDclj5ofokWjzoa5jAwMkxCykd6,13,17,7,18,4,2,6,1,55,7.857142857142857,2,0.0,1,7,16,4,16,2,2,6,1,28,27,0
247,5332,DJ09O49b2a0ZKXkFKbGfN66X8003c5sz,SpATywNh6bZuzm8s1ceuBUnMUAeoAHHw,10,31,23,0,11,0,7,0,72,10.285714285714286,6,0.0,0,23,0,11,31,0,0,7,0,34,38,1
248,5340,oDnQYjxji4p3XVFJMOGI9NvIvASqoqC1,SpATywNh6bZuzm8s1ceuBUnMUAeoAHHw,12,5,5,0,3,0,5,0,18,2.5714285714285716,3,0.0,0,5,0,3,5,0,0,5,0,8,10,1
249,5345,Kssd3yKtVgKi0ua0svvR8GgbZwRwIJMZ,SpATywNh6bZuzm8s1ceuBUnMUAeoAHHw,25,71,15,12,2,13,15,2,130,18.571428571428573,13,0.0,15,15,12,2,56,13,0,15,2,44,86,0
250,5354,lMGiEKoNsKRALWBxyYFHfE9Y79x8NYWS,G8EPVSXsOYB5YQWZGiz1aVq5Pgr2GrQu,1,0,0,0,0,0,1,0,1,0.14285714285714285,1,0.0,0,0,0,0,0,0,0,1,0,0,1,1
251,5363,WXWUGznWk133hcEltnw7lYbm2oVZoXLf,SpATywNh6bZuzm8s1ceuBUnMUAeoAHHw,31,122,41,21,7,20,55,24,290,41.42857142857143,11,0.0,6,41,20,7,116,20,1,55,24,74,216,1
252,5389,cd7VGHrZb4Blwr9YuFp9MqF71m5wWUVd,G8EPVSXsOYB5YQWZGiz1aVq5Pgr2GrQu,86,75,5,170,8,2,8,0,268,38.285714285714285,5,0.0,46,5,117,8,29,2,53,8,0,176,92,0
253,5390,NL3IFunZJHMkqSLqiaHHbVIge1Bdgn26,G8EPVSXsOYB5YQWZGiz1aVq5Pgr2GrQu,47,92,34,58,18,36,30,2,270,38.57142857142857,6,0.0,42,34,38,18,50,36,20,30,2,132,138,0
254,5392,Tj9gyzxktEEAGnL07HQ3qbd2V0oCt16o,SpATywNh6bZuzm8s1ceuBUnMUAeoAHHw,31,134,53,35,14,92,65,8,401,57.285714285714285,9,0.0,28,53,28,14,106,92,7,65,8,123,278,0
255,5397,I6gFU4rZZ1rIaEMk0n0tBNQZ2tGcnjLw,SpATywNh6bZuzm8s1ceuBUnMUAeoAHHw,26,45,19,40,13,0,18,0,135,19.285714285714285,6,0.0,25,19,33,13,20,0,7,18,0,90,45,0
256,5414,4qM7n65VbCTp8lq3dbzhDmImmEZcwgn8,A3fsA9Zfv1X2fVEQhTw51lKENdNrEqT3,42,87,6,118,1,153,54,3,422,60.285714285714285,10,0.0,7,6,99,1,80,153,19,54,3,113,309,0
257,5454,3ZzNkdWgGb47Go07PRKPf0XZ6jjhVCB4,bWdj2GDclj5ofokWjzoa5jAwMkxCykd6,17,42,20,40,13,43,15,0,173,24.714285714285715,7,0.0,11,20,34,13,31,43,6,15,0,78,95,0
258,5458,YOkiW0yIzjAwppKQnKaeEhWktVPNCIFb,A3fsA9Zfv1X2fVEQhTw51lKENdNrEqT3,43,29,20,80,9,2,21,1,162,23.142857142857142,7,0.0,2,20,64,9,27,2,16,21,1,95,67,1
259,5469,fn3RgMp4JCABnOK3IDXz6cUAXpmeuiYQ,SpATywNh6bZuzm8s1ceuBUnMUAeoAHHw,20,22,16,0,10,1,7,0,56,8.0,4,0.0,0,16,0,10,22,1,0,7,0,26,30,1
260,5472,OLX98cHycOH1FdInwYYk8PZBVFPyIkIG,SpATywNh6bZuzm8s1ceuBUnMUAeoAHHw,28,46,18,17,7,0,10,0,98,14.0,6,0.0,21,18,17,7,25,0,0,10,0,63,35,0
261,5486,TMdqZjFm6eGvpWCVvOj8xDCqkoxEsWlO,RXDvfPUBYFlVdlueBFbLW0mhhAyGEqpt,15,18,11,0,5,0,2,0,36,5.142857142857143,3,0.0,0,11,0,5,18,0,0,2,0,16,20,1
262,5487,gqe5NXbZbf5uXY0rPviLeIFOMpQyekdp,SpATywNh6bZuzm8s1ceuBUnMUAeoAHHw,16,15,1,18,0,0,7,0,41,5.857142857142857,3,0.0,2,1,15,0,13,0,3,7,0,18,23,1
263,5498,F2owRK2SDPW5FCDK4TxmBVHsTtJ44Nxq,bWdj2GDclj5ofokWjzoa5jAwMkxCykd6,9,14,1,0,2,0,6,0,23,3.2857142857142856,4,0.0,0,1,0,2,14,0,0,6,0,3,20,1
264,5499,F2owRK2SDPW5FCDK4TxmBVHsTtJ44Nxq,SpATywNh6bZuzm8s1ceuBUnMUAeoAHHw,20,32,2,27,1,0,4,1,67,9.571428571428571,3,0.0,16,2,23,1,16,0,4,4,1,42,25,1
265,5511,YTuPtoiiUgMUEO0EcQhHENEgNCcauWbW,SpATywNh6bZuzm8s1ceuBUnMUAeoAHHw,5,2,1,0,1,0,5,0,9,1.2857142857142858,4,0.0,0,1,0,1,2,0,0,5,0,2,7,1
266,5535,0N8Aw17N0N8m1sn7piRGEu1YkeZIgvRo,SpATywNh6bZuzm8s1ceuBUnMUAeoAHHw,11,16,5,0,5,0,2,0,28,4.0,2,0.0,0,5,0,5,16,0,0,2,0,10,18,0
267,5554,C6xrhZPOmVH2gCVNP26gSSPka2CcwgB5,A3fsA9Zfv1X2fVEQhTw51lKENdNrEqT3,67,37,27,106,19,0,17,0,206,29.428571428571427,6,0.0,10,27,104,19,27,0,2,17,0,160,46,1
268,5568,w1PJeTTskG2DF1TtLUpuz9MkqxNdq5EB,bWdj2GDclj5ofokWjzoa5jAwMkxCykd6,20,44,10,81,6,0,19,3,163,23.285714285714285,2,0.0,16,10,77,6,28,0,4,19,3,109,54,1
269,5573,GdXLROZTUYTypGrrX0BjPE53M0Un36D7,SpATywNh6bZuzm8s1ceuBUnMUAeoAHHw,28,87,13,24,5,44,27,5,205,29.285714285714285,5,0.0,44,13,24,5,43,44,0,27,5,86,119,1
270,5582,kKBIfyZmN22zBj263eKBa0SA1U5xYMsR,SpATywNh6bZuzm8s1ceuBUnMUAeoAHHw,27,99,10,18,5,212,26,5,375,53.57142857142857,7,0.0,10,10,17,5,89,212,1,26,5,42,333,0
271,5601,i2rj1wVH6A7tnVQEIJcyKc1jnWx6tXOX,G8EPVSXsOYB5YQWZGiz1aVq5Pgr2GrQu,19,6,0,32,0,0,3,0,41,5.857142857142857,3,0.0,0,0,27,0,6,0,5,3,0,27,14,1
272,5605,k2w7Fl2HRg9SZoDIHFnK8RXCKuBBE2y7,bWdj2GDclj5ofokWjzoa5jAwMkxCykd6,51,116,52,89,11,247,81,4,600,85.71428571428571,17,0.0,13,52,79,11,103,247,10,81,4,155,445,0
273,5620,ZOxTwY2wRpdYn3qbKBoyT1PgdUitZ7Hl,RXDvfPUBYFlVdlueBFbLW0mhhAyGEqpt,42,57,36,10,15,16,20,0,154,22.0,4,0.0,0,36,10,15,57,16,0,20,0,61,93,1
274,5645,UCDPR1k7RkPBDIde3KiukiosB55WbRVo,A3fsA9Zfv1X2fVEQhTw51lKENdNrEqT3,10,8,4,0,3,0,4,0,19,2.7142857142857144,3,0.0,0,4,0,3,8,0,0,4,0,7,12,1
275,5669,HbDaABEakQmE8DQEoFoIphu2SH13rFRy,SpATywNh6bZuzm8s1ceuBUnMUAeoAHHw,28,50,31,16,13,4,7,0,121,17.285714285714285,4,0.0,12,31,15,13,38,4,1,7,0,71,50,0
276,5692,KtQYnyrETXqJCvCxj7ZUnFcjZBBdiT7G,SpATywNh6bZuzm8s1ceuBUnMUAeoAHHw,32,40,22,30,9,10,16,1,128,18.285714285714285,5,0.0,7,22,27,9,33,10,3,16,1,65,63,0
277,5698,YflGnFPlp9G4H12kW5BF7wIEcEPJDElk,SpATywNh6bZuzm8s1ceuBUnMUAeoAHHw,28,35,21,22,9,0,7,0,94,13.428571428571429,2,0.0,7,21,20,9,28,0,2,7,0,57,37,0
278,5725,DLDhUvvvfnnYFJuV65Zt2yaS0jPJgvzq,bWdj2GDclj5ofokWjzoa5jAwMkxCykd6,45,87,0,156,4,60,29,1,337,48.142857142857146,5,0.0,29,0,125,4,58,60,31,29,1,158,179,0
279,5726,tzyyAYK7Q2hNPhv988H6lH5D7hdM24rK,SpATywNh6bZuzm8s1ceuBUnMUAeoAHHw,28,24,11,24,6,4,8,0,77,11.0,4,0.0,9,11,24,6,15,4,0,8,0,50,27,0
280,5738,SfZbjjvyiSDCCOAoK4WFbDb5dRmW5oVl,bWdj2GDclj5ofokWjzoa5jAwMkxCykd6,2,0,0,0,0,0,2,0,2,0.2857142857142857,1,0.0,0,0,0,0,0,0,0,2,0,0,2,1
281,5745,PpMDt0ql3KtH4YMuxusWOnbL4LfspwvV,A3fsA9Zfv1X2fVEQhTw51lKENdNrEqT3,40,43,29,68,12,28,13,0,193,27.571428571428573,8,0.0,2,29,57,12,41,28,11,13,0,100,93,1
282,5775,TO8Y79YghtROlTlvlXU7LRtpWyGNF6ec,SpATywNh6bZuzm8s1ceuBUnMUAeoAHHw,18,29,7,25,4,0,3,0,68,9.714285714285714,3,0.0,8,7,21,4,21,0,4,3,0,40,28,1
283,5776,wQWBo1X8BGkSznCww6CpwIPV7Jbmgkei,SpATywNh6bZuzm8s1ceuBUnMUAeoAHHw,9,8,4,0,2,0,1,0,15,2.142857142857143,1,0.0,0,4,0,2,8,0,0,1,0,6,9,1
284,5778,A3AW3c7i1MF6oyHBEYvrXWvBxZwqeuYh,SpATywNh6bZuzm8s1ceuBUnMUAeoAHHw,21,19,2,21,1,21,16,2,82,11.714285714285714,5,0.0,6,2,18,1,13,21,3,16,2,27,55,0
285,5782,hjUSUM6roI2mLGkMAqBjE0uxFRBSMYHJ,A3fsA9Zfv1X2fVEQhTw51lKENdNrEqT3,82,73,53,134,24,4,21,0,309,44.142857142857146,9,0.0,2,53,112,24,71,4,22,21,0,191,118,1
286,5787,I6LLxQVZ3Y3gFYxr9F3TFVba9rYQ1D0f,RXDvfPUBYFlVdlueBFbLW0mhhAyGEqpt,1,0,0,0,0,0,1,0,1,0.14285714285714285,1,0.0,0,0,0,0,0,0,0,1,0,0,1,1
287,5796,8tzllCaQFf5FO2XcYgqoYiMGBjUwujYx,SpATywNh6bZuzm8s1ceuBUnMUAeoAHHw,9,20,1,0,1,0,8,3,33,4.714285714285714,2,0.0,2,1,0,1,18,0,0,8,3,4,29,1
288,5835,unk5CPF7I3bAjMFdo7PROcIzOFweEiwK,SpATywNh6bZuzm8s1ceuBUnMUAeoAHHw,1,0,0,0,0,0,1,0,1,0.14285714285714285,1,0.0,0,0,0,0,0,0,0,1,0,0,1,1
289,5859,pGMnNtuqcZlCojrlW4Qh2PIHblJQmotx,SpATywNh6bZuzm8s1ceuBUnMUAeoAHHw,32,34,16,28,8,1,10,1,98,14.0,3,0.0,15,16,27,8,19,1,1,10,1,66,32,1
290,5889,Oe7zyPdqUKEu4xpqbiVxJiAwdUxxeOQv,A3fsA9Zfv1X2fVEQhTw51lKENdNrEqT3,18,25,15,0,8,0,20,0,68,9.714285714285714,4,0.0,0,15,0,8,25,0,0,20,0,23,45,1
291,5904,L4jaFu0vxNsfaC1OhafSk08ztmq6goZk,SpATywNh6bZuzm8s1ceuBUnMUAeoAHHw,19,42,15,0,8,0,16,0,81,11.571428571428571,5,0.0,0,15,0,8,42,0,0,16,0,23,58,0
292,5925,sc5S8mzwcw7LbcetViv5Dahuhyet4uF1,A3fsA9Zfv1X2fVEQhTw51lKENdNrEqT3,36,33,19,94,2,20,24,3,195,27.857142857142858,3,0.0,7,19,81,2,26,20,13,24,3,109,86,1
293,5928,QJQFN1rOmy0JEkg26kEuCjYYvoywuFFu,A3fsA9Zfv1X2fVEQhTw51lKENdNrEqT3,5,2,1,0,1,0,2,0,6,0.8571428571428571,2,0.0,0,1,0,1,2,0,0,2,0,2,4,1
294,5987,x3bTgsr7QSCiaq6OJXRLOfvMZYUxrJaI,G8EPVSXsOYB5YQWZGiz1aVq5Pgr2GrQu,4,2,0,0,0,0,2,0,4,0.5714285714285714,1,0.0,0,0,0,0,2,0,0,2,0,0,4,1
295,5992,Ov9SdOcJjrPsko4RxSRp3diSYNiMCffC,bWdj2GDclj5ofokWjzoa5jAwMkxCykd6,5,2,1,0,1,0,2,0,6,0.8571428571428571,1,0.0,0,1,0,1,2,0,0,2,0,2,4,1
296,6000,2mD1u3b1vLrSJM0DZTrsvLcZVBVwwd27,RXDvfPUBYFlVdlueBFbLW0mhhAyGEqpt,18,22,20,0,12,2,10,0,66,9.428571428571429,10,0.0,0,20,0,12,22,2,0,10,0,32,34,0
297,6010,gEPTO2jN7POX6QtJlMdktFPT74irRyFu,SpATywNh6bZuzm8s1ceuBUnMUAeoAHHw,23,41,19,28,13,18,8,0,127,18.142857142857142,12,0.0,10,19,26,13,31,18,2,8,0,68,59,0
298,6060,1gK3jCeXNxEbn9wGz2jRwqB6S5hBMDkt,bWdj2GDclj5ofokWjzoa5jAwMkxCykd6,34,73,31,126,12,47,17,2,308,44.0,3,0.0,12,31,117,12,61,47,9,17,2,172,136,1
299,6070,Hj4fYYa64lvHLVeQZBqs9EQ1OtgHTvl6,SpATywNh6bZuzm8s1ceuBUnMUAeoAHHw,17,29,9,16,1,3,9,0,67,9.571428571428571,3,0.0,7,9,14,1,22,3,2,9,0,31,36,0
300,6074,xQWsagZWr4hwuLscur4NAIFNIWIrJTay,RXDvfPUBYFlVdlueBFbLW0mhhAyGEqpt,20,22,19,30,10,0,13,0,94,13.428571428571429,3,0.0,2,19,28,10,20,0,2,13,0,59,35,0
301,6075,4pJCNd3c3ApEtuK2GDe7eGNzOhsu04W5,G8EPVSXsOYB5YQWZGiz1aVq5Pgr2GrQu,61,148,87,81,13,390,88,12,819,117.0,18,0.0,14,87,61,13,134,390,20,88,12,175,644,0
302,6077,X6F4jGrpHmts6Pi9fPAm5nX0OzNeK6MU,SpATywNh6bZuzm8s1ceuBUnMUAeoAHHw,13,14,0,8,0,0,4,0,26,3.7142857142857144,1,0.0,0,0,6,0,14,0,2,4,0,6,20,1
303,6102,DJPrQ8k1R0aSF2q32X8eWoHfRxJjw6WA,SpATywNh6bZuzm8s1ceuBUnMUAeoAHHw,30,48,24,41,9,19,25,9,175,25.0,4,0.0,14,24,35,9,34,19,6,25,9,82,93,1
304,6105,lVM3D8yPmd62Fdb29hI2YI0VPwlNvI4t,A3fsA9Zfv1X2fVEQhTw51lKENdNrEqT3,31,46,36,0,26,2,19,0,129,18.428571428571427,8,0.0,2,36,0,26,44,2,0,19,0,64,65,1
305,6106,lPxeEtjpZuY166gKAbN1CLkUMLrqY98p,SpATywNh6bZuzm8s1ceuBUnMUAeoAHHw,14,27,0,13,1,3,18,1,63,9.0,2,0.0,4,0,13,1,23,3,0,18,1,18,45,1
306,6108,WWWH5rGgnKzcRMEBKWqCKBbIYZVZp9Wi,SpATywNh6bZuzm8s1ceuBUnMUAeoAHHw,24,49,4,30,1,7,9,0,100,14.285714285714286,6,0.0,15,4,28,1,34,7,2,9,0,48,52,0
307,6114,PIxnueIZLpBbMAAHbhlsEVGPkWRYGpMI,RXDvfPUBYFlVdlueBFbLW0mhhAyGEqpt,42,61,1,47,3,1,21,0,134,19.142857142857142,5,0.0,8,1,43,3,53,1,4,21,0,55,79,0
308,6123,onsmNYIoPFEi185f5ZLsQXD70I3K25Cb,A3fsA9Zfv1X2fVEQhTw51lKENdNrEqT3,25,59,33,0,17,8,13,1,131,18.714285714285715,3,0.0,2,33,0,17,57,8,0,13,1,52,79,1
309,6134,UhLO5kko2VQ90AI2af3XOU7N46nRv9TM,SpATywNh6bZuzm8s1ceuBUnMUAeoAHHw,20,26,5,34,5,1,22,1,94,13.428571428571429,3,0.0,10,5,33,5,16,1,1,22,1,53,41,0
310,6140,IBg4xmPqhTfP3qhSQ0m2yOJeGxXoGyqu,RXDvfPUBYFlVdlueBFbLW0mhhAyGEqpt,48,50,29,123,16,303,96,12,629,89.85714285714286,13,0.0,17,29,116,16,33,303,7,96,12,178,451,0
311,6158,hdYiR72pQ6vIYKybYRC3s5GFqsrsnSH9,SpATywNh6bZuzm8s1ceuBUnMUAeoAHHw,1,0,0,0,0,0,1,0,1,0.14285714285714285,1,0.0,0,0,0,0,0,0,0,1,0,0,1,1
312,6168,H2ZjrPimYfiWwdYkdNOPsZZk83kbIBCz,bWdj2GDclj5ofokWjzoa5jAwMkxCykd6,6,5,0,0,0,0,4,0,9,1.2857142857142858,2,0.0,0,0,0,0,5,0,0,4,0,0,9,1
313,6185,rowlJHASOW6yJNtP0z67l2i9CtJCMokD,SpATywNh6bZuzm8s1ceuBUnMUAeoAHHw,23,30,2,37,1,11,14,3,98,14.0,5,0.0,8,2,31,1,22,11,6,14,3,42,56,0
314,6192,uFKxt8ud4wgPXsnEMlnj4koWPrsJIWsU,SpATywNh6bZuzm8s1ceuBUnMUAeoAHHw,28,66,23,22,8,17,39,1,176,25.142857142857142,9,0.0,13,23,21,8,53,17,1,39,1,65,111,0
315,6220,hyKcsvbAZrS0MucDsyUSihT6aOgvgztm,A3fsA9Zfv1X2fVEQhTw51lKENdNrEqT3,8,9,4,0,4,0,1,0,18,2.5714285714285716,1,0.0,0,4,0,4,9,0,0,1,0,8,10,1
316,6240,IkJ5dxCbqNRxBRuENFqjes2Z4rIDUrXn,SpATywNh6bZuzm8s1ceuBUnMUAeoAHHw,31,49,18,43,9,13,9,0,141,20.142857142857142,3,0.0,22,18,35,9,27,13,8,9,0,84,57,0
317,6271,q2xQCstASp96wpspi8iqsuaqJ7gzfsux,A3fsA9Zfv1X2fVEQhTw51lKENdNrEqT3,52,43,14,90,0,0,5,0,152,21.714285714285715,5,0.0,7,14,81,0,36,0,9,5,0,102,50,0
318,6273,pP1hwdPGxzBA8F4ZSgJiv9MEvr2pc047,SpATywNh6bZuzm8s1ceuBUnMUAeoAHHw,17,59,4,9,1,53,47,3,176,25.142857142857142,5,0.0,15,4,9,1,44,53,0,47,3,29,147,1
319,6292,TmCsqieGLPEH7gIm9lIZtj95nwJ99JkM,A3fsA9Zfv1X2fVEQhTw51lKENdNrEqT3,7,3,2,0,2,0,3,0,10,1.4285714285714286,1,0.0,0,2,0,2,3,0,0,3,0,4,6,1
320,6303,jqoeUpESPoqODjA4STQaMBhAr7OND2EP,bWdj2GDclj5ofokWjzoa5jAwMkxCykd6,5,6,2,0,0,0,10,0,18,2.5714285714285716,2,0.0,0,2,0,0,6,0,0,10,0,2,16,1
321,6306,Q8L1mPYwfiwtGo48PB0N9B5ppVi0px10,SpATywNh6bZuzm8s1ceuBUnMUAeoAHHw,31,68,32,30,11,4,37,0,182,26.0,8,0.0,24,32,27,11,44,4,3,37,0,94,88,0
322,6317,3Bw18YJt9vJt2emNNJ6GnWW50YrVLdEa,bWdj2GDclj5ofokWjzoa5jAwMkxCykd6,36,18,7,157,3,57,16,0,258,36.857142857142854,3,0.0,6,7,144,3,12,57,13,16,0,160,98,0
323,6331,SYptj19Xjkw9HEWtBs53CLIV7bhIU7QA,SpATywNh6bZuzm8s1ceuBUnMUAeoAHHw,30,66,35,19,11,31,21,0,183,26.142857142857142,4,0.0,6,35,18,11,60,31,1,21,0,70,113,1
324,6347,TAjGGV7oJgeUhPcj5Eum0tnVYrY7qjOE,RXDvfPUBYFlVdlueBFbLW0mhhAyGEqpt,69,204,69,131,33,7,43,4,491,70.14285714285714,9,0.0,34,69,114,33,170,7,17,43,4,250,241,0
325,6357,Aay6TeSPyFLmKNsg9Z4tXGnlIddPmJBP,SpATywNh6bZuzm8s1ceuBUnMUAeoAHHw,4,6,0,0,0,0,2,0,8,1.1428571428571428,2,0.0,0,0,0,0,6,0,0,2,0,0,8,1
326,6368,Fa7tOqP1WKllvNDMgvUWmTzPr8J8vhy8,A3fsA9Zfv1X2fVEQhTw51lKENdNrEqT3,48,45,35,64,24,0,15,0,183,26.142857142857142,10,0.0,1,35,58,24,44,0,6,15,0,118,65,1
327,6382,9a1CkPBtfy1cinURU7wYCdYhBZbPuPSf,A3fsA9Zfv1X2fVEQhTw51lKENdNrEqT3,29,9,3,56,1,2,6,1,78,11.142857142857142,3,0.0,5,3,52,1,4,2,4,6,1,61,17,1
328,6406,LA9dJIvAE6FLxCCQV1kWQN6m88ZCSRLZ,bWdj2GDclj5ofokWjzoa5jAwMkxCykd6,9,9,1,0,2,1,4,0,17,2.4285714285714284,1,0.0,3,1,0,2,6,1,0,4,0,6,11,1
329,6411,eI6xeMCc7v1nfOYfnKZdOO91PA7nex8M,bWdj2GDclj5ofokWjzoa5jAwMkxCykd6,9,3,2,0,2,0,4,1,12,1.7142857142857142,1,0.0,0,2,0,2,3,0,0,4,1,4,8,1
330,6420,oQDGeS36nDLt1VqHdqEgamkq2vJOp7Bp,SpATywNh6bZuzm8s1ceuBUnMUAeoAHHw,5,3,1,0,1,0,1,0,6,0.8571428571428571,1,0.0,0,1,0,1,3,0,0,1,0,2,4,1
331,6424,SmSrrYBj6KLZ39TqXb57CVWv6gX6sF7Q,SpATywNh6bZuzm8s1ceuBUnMUAeoAHHw,32,60,26,37,11,13,26,9,182,26.0,7,0.0,21,26,31,11,39,13,6,26,9,89,93,0
332,6426,e3L16MrCoJp6rSpz1IWKaDG3S5tGTRpK,RXDvfPUBYFlVdlueBFbLW0mhhAyGEqpt,35,20,17,26,14,0,8,0,85,12.142857142857142,4,0.0,2,17,23,14,18,0,3,8,0,56,29,0
333,6435,nFeXukK9uLZggTwgBm3mDIxskaBXISqn,SpATywNh6bZuzm8s1ceuBUnMUAeoAHHw,20,43,11,34,0,0,3,0,91,13.0,11,0.0,7,11,29,0,36,0,5,3,0,47,44,1
334,6448,yau38b5UXLNmzsSxrtZsXYfKt6l52ZSP,A3fsA9Zfv1X2fVEQhTw51lKENdNrEqT3,13,27,4,0,2,0,7,0,40,5.714285714285714,4,0.0,1,4,0,2,26,0,0,7,0,7,33,0
335,6457,wxlTuL6FVeoyKGq1xWxdRI4GRTsaG1Ha,SpATywNh6bZuzm8s1ceuBUnMUAeoAHHw,5,6,3,0,0,0,1,0,10,1.4285714285714286,1,0.0,2,3,0,0,4,0,0,1,0,5,5,1
336,6466,GUIjXzC11NU91af1UN0XPnms1Mnty0es,G8EPVSXsOYB5YQWZGiz1aVq5Pgr2GrQu,13,10,8,0,5,0,6,0,29,4.142857142857143,2,0.0,0,8,0,5,10,0,0,6,0,13,16,1
337,6472,wxlTuL6FVeoyKGq1xWxdRI4GRTsaG1Ha,A3fsA9Zfv1X2fVEQhTw51lKENdNrEqT3,5,4,3,0,0,0,1,0,8,1.1428571428571428,1,0.0,0,3,0,0,4,0,0,1,0,3,5,1
338,6488,aYhMdR5xaez3fr0lBrD6kCxYiCOyculR,RXDvfPUBYFlVdlueBFbLW0mhhAyGEqpt,81,177,110,117,14,2573,75,116,3182,454.57142857142856,19,0.0,29,110,83,14,148,2573,34,75,116,236,2946,0
339,6506,DCJPPLzeeZhBbsYhL4xGedJzVmW41Gnk,SpATywNh6bZuzm8s1ceuBUnMUAeoAHHw,29,42,26,31,11,25,12,0,147,21.0,6,0.0,11,26,28,11,31,25,3,12,0,76,71,0
340,6516,1CrVBOpFvr6rOy553Xrye0bjPdL11eu8,RXDvfPUBYFlVdlueBFbLW0mhhAyGEqpt,67,114,55,81,19,51,26,2,348,49.714285714285715,11,0.0,14,55,77,19,100,51,4,26,2,165,183,0
341,6517,7u3azzypzNqPYEFxf0DcbGOgDVhkOXos,A3fsA9Zfv1X2fVEQhTw51lKENdNrEqT3,87,29,18,212,13,1,28,1,302,43.142857142857146,6,0.0,3,18,193,13,26,1,19,28,1,227,75,0
342,6523,dna1EUjVeT7Ka4gaXCCa53DsP3COwQS1,SpATywNh6bZuzm8s1ceuBUnMUAeoAHHw,21,23,3,31,0,0,6,0,63,9.0,4,0.0,4,3,25,0,19,0,6,6,0,32,31,0
343,6528,97yjJniO9qlZAjgn3gm4HXnkbwnHzt9O,SpATywNh6bZuzm8s1ceuBUnMUAeoAHHw,17,52,5,21,3,11,11,0,103,14.714285714285714,4,0.0,13,5,15,3,39,11,6,11,0,36,67,1
344,6535,tuBxNlu8Vf06uK8sXGF2P17UeyGdHKNN,SpATywNh6bZuzm8s1ceuBUnMUAeoAHHw,26,35,26,6,11,2,9,1,90,12.857142857142858,4,0.0,0,26,5,11,35,2,1,9,1,42,48,1
345,6574,09vierxoREaD4msGgreYQSyOiGeSiZdQ,SpATywNh6bZuzm8s1ceuBUnMUAeoAHHw,9,22,13,0,7,0,4,0,46,6.571428571428571,3,0.0,0,13,0,7,22,0,0,4,0,20,26,0
346,6587,Y89GJdSZUpoYFMgx00SCe6qFoYoXIpUj,A3fsA9Zfv1X2fVEQhTw51lKENdNrEqT3,65,108,5,172,2,0,8,0,295,42.142857142857146,8,0.0,0,5,145,2,108,0,27,8,0,152,143,0
347,6620,ImttANzrjJymFPMjHDf4wrhhCWWSpYTI,A3fsA9Zfv1X2fVEQhTw51lKENdNrEqT3,25,64,19,0,0,0,10,0,93,13.285714285714286,4,0.0,2,19,0,0,62,0,0,10,0,21,72,1
348,6637,qcaVl4qf6hxavlIQkbkKC1Gm28s0psJd,SpATywNh6bZuzm8s1ceuBUnMUAeoAHHw,20,30,2,40,0,0,3,0,75,10.714285714285714,2,0.0,9,2,34,0,21,0,6,3,0,45,30,1
349,6643,lDflzmK9F6H42Kj6EtaBezWOcB4UUWiV,SpATywNh6bZuzm8s1ceuBUnMUAeoAHHw,31,46,26,14,11,4,22,1,124,17.714285714285715,10,0.0,8,26,13,11,38,4,1,22,1,58,66,0
350,6675,1K9ntuEgUSRWzXpTTqORcRDzpeO83CFG,SpATywNh6bZuzm8s1ceuBUnMUAeoAHHw,5,2,1,0,1,0,2,0,6,0.8571428571428571,1,0.0,0,1,0,1,2,0,0,2,0,2,4,1
351,6679,tY5a0NX1zue0V7W3ml5X4bo1Gus2ozCa,SpATywNh6bZuzm8s1ceuBUnMUAeoAHHw,28,38,17,22,7,0,15,0,99,14.142857142857142,4,0.0,13,17,20,7,25,0,2,15,0,57,42,0
352,6685,mfQ48K9Gnf187sLZBiTNegL6UkMDsKbJ,SpATywNh6bZuzm8s1ceuBUnMUAeoAHHw,25,51,4,34,1,0,12,1,103,14.714285714285714,4,0.0,24,4,31,1,27,0,3,12,1,60,43,0
353,6708,7FUJzRatex45Tiw3cL91Uz5fZD5gpQMy,G8EPVSXsOYB5YQWZGiz1aVq5Pgr2GrQu,2,0,0,0,0,0,2,0,2,0.2857142857142857,1,0.0,0,0,0,0,0,0,0,2,0,0,2,1
354,6760,yh14zaFitCUTgvBPqRXiaZ6cUijtktL4,A3fsA9Zfv1X2fVEQhTw51lKENdNrEqT3,70,39,24,112,14,3,13,3,208,29.714285714285715,3,0.0,6,24,98,14,33,3,14,13,3,142,66,1
355,6813,UvqKXPrebnykj7gkohis9MIhsKJQCjxw,G8EPVSXsOYB5YQWZGiz1aVq5Pgr2GrQu,17,38,34,32,18,0,7,0,129,18.428571428571427,4,0.0,0,34,31,18,38,0,1,7,0,83,46,0
356,6816,dSloiolTuQA1YnIVrIEZb5m23cL24cRw,A3fsA9Zfv1X2fVEQhTw51lKENdNrEqT3,28,48,5,34,3,5,16,1,112,16.0,4,0.0,5,5,29,3,43,5,5,16,1,42,70,1
357,6824,e12uQn96OlYfknMdqSXCXdImglIj4IRR,bWdj2GDclj5ofokWjzoa5jAwMkxCykd6,26,67,40,0,18,96,50,7,278,39.714285714285715,7,0.0,6,40,0,18,61,96,0,50,7,64,214,0
358,6835,05hxkbgK0IX5639oITtQjU5YEEUBb8L1,SpATywNh6bZuzm8s1ceuBUnMUAeoAHHw,26,115,6,36,5,4,17,2,185,26.428571428571427,5,0.0,40,6,31,5,75,4,5,17,2,82,103,0
359,6838,AyhJARh0xhxObM9zhvUdDxlTCtu309eW,SpATywNh6bZuzm8s1ceuBUnMUAeoAHHw,28,42,25,20,13,88,10,0,198,28.285714285714285,6,0.0,7,25,20,13,35,88,0,10,0,65,133,1
360,6873,NAuTAy6LFtpkSTeaDzpzRRxCaq6qJCQ5,A3fsA9Zfv1X2fVEQhTw51lKENdNrEqT3,56,73,54,73,30,3,42,0,275,39.285714285714285,8,0.0,5,54,65,30,68,3,8,42,0,154,121,0
361,6881,jzWvwaTexkgbyBrPkQbXDb98Viqx6cSS,G8EPVSXsOYB5YQWZGiz1aVq5Pgr2GrQu,20,20,6,30,4,11,11,1,83,11.857142857142858,5,0.0,11,6,23,4,9,11,7,11,1,44,39,1
362,6889,M2RAm5z8WwQ5y9jyAQgRWh88PDVhS1V9,RXDvfPUBYFlVdlueBFbLW0mhhAyGEqpt,1,0,0,0,0,0,1,0,1,0.14285714285714285,1,0.0,0,0,0,0,0,0,0,1,0,0,1,1
363,6898,UxSaaQ6GZyl7nlDC1x0TA1qshXRkMyH8,RXDvfPUBYFlVdlueBFbLW0mhhAyGEqpt,70,127,42,111,30,23,17,0,350,50.0,2,0.0,41,42,107,30,86,23,4,17,0,220,130,0
364,6914,5XorWInOikFQGiy06qBvCZ6iOgBDDoJu,SpATywNh6bZuzm8s1ceuBUnMUAeoAHHw,27,83,37,17,19,43,20,3,222,31.714285714285715,4,0.0,35,37,16,19,48,43,1,20,3,107,115,0
365,6916,x6r7USCSuVFGzUeOMsU9rcLC4WDuI3GF,A3fsA9Zfv1X2fVEQhTw51lKENdNrEqT3,13,22,13,0,0,1,17,1,54,7.714285714285714,4,0.0,0,13,0,0,22,1,0,17,1,13,41,0
366,6917,ZolI9SZEN13j7gv74MFUKg6bUxZlsWPc,G8EPVSXsOYB5YQWZGiz1aVq5Pgr2GrQu,7,5,2,0,2,0,2,0,11,1.5714285714285714,1,0.0,0,2,0,2,5,0,0,2,0,4,7,1
367,6925,h9168zUD8zDtaVgTWmp8akLV044AqETE,G8EPVSXsOYB5YQWZGiz1aVq5Pgr2GrQu,59,72,23,196,0,19,4,0,314,44.857142857142854,2,0.0,46,23,157,0,26,19,39,4,0,226,88,0
368,6931,s6iPd6MFpHWkQ354d5Z6XCZ6dbx7CutD,SpATywNh6bZuzm8s1ceuBUnMUAeoAHHw,13,9,7,4,3,0,4,0,27,3.857142857142857,3,0.0,0,7,3,3,9,0,1,4,0,13,14,0
369,6938,a6f3gPi6axX0cfBnUGVliBDQrPx92l1r,A3fsA9Zfv1X2fVEQhTw51lKENdNrEqT3,78,136,89,246,62,1,21,0,555,79.28571428571429,11,0.0,15,89,206,62,121,1,40,21,0,372,183,1
370,6948,4r712Cp6HawShlWfCnD4BeT5bNCQMkQ4,SpATywNh6bZuzm8s1ceuBUnMUAeoAHHw,22,28,3,24,0,7,7,1,70,10.0,4,0.0,7,3,19,0,21,7,5,7,1,29,41,0
371,6956,ykaUPJW4Nc9r2mv4b25QxgdHgIcQ63RQ,SpATywNh6bZuzm8s1ceuBUnMUAeoAHHw,25,32,10,27,4,35,7,1,116,16.571428571428573,9,0.0,15,10,26,4,17,35,1,7,1,55,61,0
372,6969,YfVqOdQV9ZXJgq8aC5ARPHksMFUwqOvU,SpATywNh6bZuzm8s1ceuBUnMUAeoAHHw,13,11,7,0,4,4,16,0,42,6.0,2,0.0,0,7,0,4,11,4,0,16,0,11,31,1
373,6981,Pp5JJMKWhHjqXDQq6vl852N5LskPEcDA,bWdj2GDclj5ofokWjzoa5jAwMkxCykd6,16,29,7,54,8,0,5,0,103,14.714285714285714,3,0.0,18,7,49,8,11,0,5,5,0,82,21,1
374,6983,7fC3V6ivG07wUIMOmiYFzSlyjWvbYnYf,A3fsA9Zfv1X2fVEQhTw51lKENdNrEqT3,83,61,2,322,2,2,21,0,410,58.57142857142857,10,0.0,6,2,268,2,55,2,54,21,0,278,132,0
375,6985,Pp5JJMKWhHjqXDQq6vl852N5LskPEcDA,A3fsA9Zfv1X2fVEQhTw51lKENdNrEqT3,5,4,1,0,1,0,4,0,10,1.4285714285714286,2,0.0,0,1,0,1,4,0,0,4,0,2,8,1
376,6989,QXMWMAYLhXvptULktpThtcXNRQ6JansN,SpATywNh6bZuzm8s1ceuBUnMUAeoAHHw,30,107,49,14,11,15,77,0,273,39.0,19,0.0,18,49,14,11,89,15,0,77,0,92,181,0
377,7004,4L8FEL9uQ33lr2hJ5CSJNyGu6GEq5daD,A3fsA9Zfv1X2fVEQhTw51lKENdNrEqT3,2,0,0,0,0,0,2,0,2,0.2857142857142857,1,0.0,0,0,0,0,0,0,0,2,0,0,2,1
378,7020,43QhXZfKBBZHpTmjLSVuTzbc6djzr40d,SpATywNh6bZuzm8s1ceuBUnMUAeoAHHw,25,58,1,26,3,11,18,0,117,16.714285714285715,4,0.0,16,1,24,3,42,11,2,18,0,44,73,0
379,7032,ogcVEHXlejDZ3EsIUfi0CHUmNlnDccd3,A3fsA9Zfv1X2fVEQhTw51lKENdNrEqT3,4,0,0,0,0,0,4,0,4,0.5714285714285714,1,0.0,0,0,0,0,0,0,0,4,0,0,4,1
380,7051,86WaolA0zlcsNwK3PQQKKGFDOSiqigXx,SpATywNh6bZuzm8s1ceuBUnMUAeoAHHw,26,25,10,28,7,0,3,0,73,10.428571428571429,1,0.0,4,10,24,7,21,0,4,3,0,45,28,1
381,7070,NHNfeNYNs1K8l9QFLPxdhmQxgpP2pCve,SpATywNh6bZuzm8s1ceuBUnMUAeoAHHw,13,7,5,0,4,1,5,1,23,3.2857142857142856,1,0.0,1,5,0,4,6,1,0,5,1,10,13,1
382,7085,UrENN1zIfJIc4hCxDDWe8c7coKokiTdF,A3fsA9Zfv1X2fVEQhTw51lKENdNrEqT3,56,37,26,76,18,3,7,1,168,24.0,4,0.0,4,26,62,18,33,3,14,7,1,110,58,1
383,7107,oBmksukoqTKiKpWhco7hv7dHpVNhiTm0,SpATywNh6bZuzm8s1ceuBUnMUAeoAHHw,15,17,0,7,0,0,6,0,30,4.285714285714286,2,0.0,3,0,7,0,14,0,0,6,0,10,20,1
384,7119,03YAuQnjuYjTWwgHqE1110CZpZwknRbj,RXDvfPUBYFlVdlueBFbLW0mhhAyGEqpt,69,56,32,165,16,1,16,1,287,41.0,5,0.0,13,32,157,16,43,1,8,16,1,218,69,0
385,7138,tJ7FzaUMbzSP2K4BtZobNqzCoEbllcH1,RXDvfPUBYFlVdlueBFbLW0mhhAyGEqpt,68,199,77,157,5,970,235,928,2571,367.2857142857143,21,0.0,28,77,146,5,171,970,11,235,928,256,2315,0
386,7143,ahFkMpqRNclNalhsRFgKmc75UZfOTdgQ,SpATywNh6bZuzm8s1ceuBUnMUAeoAHHw,32,103,44,45,10,5,20,2,229,32.714285714285715,14,0.0,33,44,35,10,70,5,10,20,2,122,107,1
387,7151,2QwHrFxGcIFGuR6TyUnlExhchaRL2Ipx,SpATywNh6bZuzm8s1ceuBUnMUAeoAHHw,28,105,20,34,4,14,28,1,206,29.428571428571427,14,0.0,33,20,29,4,72,14,5,28,1,86,120,0
388,7182,HlYiU2TA92it9HWOPDlsBmlpdZ7J7QTJ,SpATywNh6bZuzm8s1ceuBUnMUAeoAHHw,23,43,16,16,4,0,15,0,94,13.428571428571429,7,0.0,8,16,16,4,35,0,0,15,0,44,50,1
389,7211,KcnsNeA0wAhOuQ7U5h8zRsePAeKM7tfj,SpATywNh6bZuzm8s1ceuBUnMUAeoAHHw,6,3,0,0,1,0,2,0,6,0.8571428571428571,1,0.0,0,0,0,1,3,0,0,2,0,1,5,1
390,7225,WixZusYrasZzR9owXlaQpXrbIZeJOheR,SpATywNh6bZuzm8s1ceuBUnMUAeoAHHw,12,20,9,0,3,3,9,1,45,6.428571428571429,5,0.0,6,9,0,3,14,3,0,9,1,18,27,0
391,7233,Kv9yM6Ye606xOusGmqGDWX6SW9fdHP2Q,bWdj2GDclj5ofokWjzoa5jAwMkxCykd6,9,7,2,0,1,25,7,1,43,6.142857142857143,2,0.0,0,2,0,1,7,25,0,7,1,3,40,1
392,7246,WixZusYrasZzR9owXlaQpXrbIZeJOheR,RXDvfPUBYFlVdlueBFbLW0mhhAyGEqpt,1,0,0,0,0,0,2,0,2,0.2857142857142857,2,0.0,0,0,0,0,0,0,0,2,0,0,2,1
393,7258,sT9hGAnww95aeGvqwQpJlS3ORhWDT49F,A3fsA9Zfv1X2fVEQhTw51lKENdNrEqT3,11,16,9,0,3,0,4,0,32,4.571428571428571,3,0.0,1,9,0,3,15,0,0,4,0,13,19,1
394,7282,gMP76SzwbIEJUCyidRWCdRJzafVqamrK,bWdj2GDclj5ofokWjzoa5jAwMkxCykd6,10,17,4,0,2,1,17,1,42,6.0,3,0.0,3,4,0,2,14,1,0,17,1,9,33,1
395,7283,K5Sy6doI03r5uctdEcvObhW1bpzNGROt,G8EPVSXsOYB5YQWZGiz1aVq5Pgr2GrQu,32,80,43,30,17,7,34,1,212,30.285714285714285,8,0.0,6,43,21,17,74,7,9,34,1,87,125,0
396,7304,VSEOcWZYpZiKC2PUmidzj4VqbBnc3GAo,A3fsA9Zfv1X2fVEQhTw51lKENdNrEqT3,63,23,11,187,0,13,72,0,306,43.714285714285715,12,0.0,9,11,162,0,14,13,25,72,0,182,124,0
397,7332,5kqorcxIJejDFcc1de7q3uie94xFSgMJ,SpATywNh6bZuzm8s1ceuBUnMUAeoAHHw,29,104,55,19,8,3,22,0,211,30.142857142857142,9,0.0,21,55,18,8,83,3,1,22,0,102,109,0
398,7336,XaZ9suMr2OUkXLhyKSMfk6SMeajIT5ha,A3fsA9Zfv1X2fVEQhTw51lKENdNrEqT3,7,6,1,0,1,0,5,0,13,1.8571428571428572,1,0.0,0,1,0,1,6,0,0,5,0,2,11,1
399,7337,J5FkxM9o8L4y51xbaKwQjZuay8KpJMzH,SpATywNh6bZuzm8s1ceuBUnMUAeoAHHw,27,62,7,33,2,28,17,1,150,21.428571428571427,8,0.0,25,7,27,2,37,28,6,17,1,61,89,1
400,7338,XpquNqg2EIDRwNL88GzK6drchpRZMQN1,A3fsA9Zfv1X2fVEQhTw51lKENdNrEqT3,23,22,18,0,14,1,6,0,61,8.714285714285714,5,0.0,0,18,0,14,22,1,0,6,0,32,29,0
401,7345,B9KqNNxXBxHFUsJnQKQysblL3f8zF7sg,bWdj2GDclj5ofokWjzoa5jAwMkxCykd6,17,38,5,0,2,0,15,0,60,8.571428571428571,10,0.0,6,5,0,2,32,0,0,15,0,13,47,0
402,7348,5a7fehAo0Ol3kwHzhNqAYRGEzPLIE5FD,SpATywNh6bZuzm8s1ceuBUnMUAeoAHHw,24,36,25,11,15,2,14,0,103,14.714285714285714,6,0.0,2,25,10,15,34,2,1,14,0,52,51,1
403,7364,84Vq27rxsidbGJFxLO0cd5e2CSiXRChu,A3fsA9Zfv1X2fVEQhTw51lKENdNrEqT3,80,85,58,120,19,10,32,2,326,46.57142857142857,12,0.0,6,58,109,19,79,10,11,32,2,192,134,1
404,7377,84Vq27rxsidbGJFxLO0cd5e2CSiXRChu,SpATywNh6bZuzm8s1ceuBUnMUAeoAHHw,17,10,9,0,7,0,2,0,28,4.0,2,0.0,0,9,0,7,10,0,0,2,0,16,12,1
405,7380,y4ROZxtUW2SffaQ3DMgCK81r0GDNLnMO,SpATywNh6bZuzm8s1ceuBUnMUAeoAHHw,29,32,12,23,7,2,11,1,88,12.571428571428571,7,0.0,10,12,20,7,22,2,3,11,1,49,39,0
406,7387,u82lBhpDxJIwlZISEntCxj1zgVFdW0vT,SpATywNh6bZuzm8s1ceuBUnMUAeoAHHw,32,234,117,43,41,196,97,9,737,105.28571428571429,19,0.0,74,117,31,41,160,196,12,97,9,263,474,0
407,7402,XESEnxXOxYn0sEg8u7X5S27rymbaMzNA,SpATywNh6bZuzm8s1ceuBUnMUAeoAHHw,31,74,39,42,16,11,33,0,215,30.714285714285715,6,0.0,21,39,34,16,53,11,8,33,0,110,105,0
408,7405,thbVK5OkB13GLXnOCtBegvQeqDmjraYm,SpATywNh6bZuzm8s1ceuBUnMUAeoAHHw,28,47,20,27,7,14,16,0,131,18.714285714285715,5,0.0,20,20,26,7,27,14,1,16,0,73,58,0
409,7410,MRybyq1cnqatDusvwSwOpxgKfQSDJUE3,bWdj2GDclj5ofokWjzoa5jAwMkxCykd6,12,7,4,14,1,0,6,1,33,4.714285714285714,1,0.0,1,4,14,1,6,0,0,6,1,20,13,1
410,7425,AV3xIWfwsQ5uGH8Qf1BwlVsUBUI5kjl1,SpATywNh6bZuzm8s1ceuBUnMUAeoAHHw,10,26,7,0,3,0,10,0,46,6.571428571428571,4,0.0,0,7,0,3,26,0,0,10,0,10,36,1
411,7445,mawBMWVaMDuwBgxqJlSNvSnxuZmWfWRW,SpATywNh6bZuzm8s1ceuBUnMUAeoAHHw,25,67,23,18,6,4,26,0,144,20.571428571428573,8,0.0,8,23,17,6,59,4,1,26,0,54,90,0
412,7456,1CrVBOpFvr6rOy553Xrye0bjPdL11eu8,A3fsA9Zfv1X2fVEQhTw51lKENdNrEqT3,89,110,58,94,20,89,43,1,415,59.285714285714285,10,0.0,13,58,92,20,97,89,2,43,1,183,232,0
413,7459,RvbHqbSC41GB9aoXWEA7k8GnWBXN8w9e,SpATywNh6bZuzm8s1ceuBUnMUAeoAHHw,5,3,0,0,0,0,2,0,5,0.7142857142857143,1,0.0,0,0,0,0,3,0,0,2,0,0,5,1
414,7460,oTbhbArArMYa19mRFQxnzp4vm2INrkSU,SpATywNh6bZuzm8s1ceuBUnMUAeoAHHw,13,15,2,0,1,2,7,1,28,4.0,1,0.0,3,2,0,1,12,2,0,7,1,6,22,1
415,7470,zwtc7XYkGr4Bhsl8UEIZlPO0o9lpzfSZ,A3fsA9Zfv1X2fVEQhTw51lKENdNrEqT3,65,56,23,150,13,0,12,0,254,36.285714285714285,6,0.0,2,23,135,13,54,0,15,12,0,173,81,0
416,7477,5DIcniD9kRbDupVPBNugV5by0SZHtD2e,SpATywNh6bZuzm8s1ceuBUnMUAeoAHHw,26,58,6,34,3,2,19,2,124,17.714285714285715,6,0.0,14,6,29,3,44,2,5,19,2,52,72,0
417,7484,ZghgmsFKGlL396BKFJoJeIy2X7crdnN0,SpATywNh6bZuzm8s1ceuBUnMUAeoAHHw,27,62,21,44,6,42,28,4,207,29.571428571428573,5,0.0,31,21,37,6,31,42,7,28,4,95,112,0
418,7489,uUSTKM8g1hIskJbYHh1UiIQ6epHTSTNR,bWdj2GDclj5ofokWjzoa5jAwMkxCykd6,20,41,22,30,6,3,16,0,118,16.857142857142858,7,0.0,3,22,28,6,38,3,2,16,0,59,59,1
419,7490,uUSTKM8g1hIskJbYHh1UiIQ6epHTSTNR,G8EPVSXsOYB5YQWZGiz1aVq5Pgr2GrQu,90,107,42,184,21,3,17,1,375,53.57142857142857,5,0.0,55,42,129,21,52,3,55,17,1,247,128,0
420,7494,CSp8QkNZa6B12LzJipxPFgC5w6lKLtbn,RXDvfPUBYFlVdlueBFbLW0mhhAyGEqpt,29,67,7,45,9,10,17,1,156,22.285714285714285,3,0.0,14,7,43,9,53,10,2,17,1,73,83,0
421,7497,guprsx2yFQ5jOFQRa2OmDTvoe1Qtus0L,SpATywNh6bZuzm8s1ceuBUnMUAeoAHHw,10,18,9,0,5,0,4,0,36,5.142857142857143,2,0.0,0,9,0,5,18,0,0,4,0,14,22,1
422,7500,BQwuBUR4WYRdCAVoQUNUZK3Ln34YX0iv,SpATywNh6bZuzm8s1ceuBUnMUAeoAHHw,18,40,22,13,12,15,30,6,138,19.714285714285715,5,0.0,10,22,11,12,30,15,2,30,6,55,83,1
423,7505,1sFJ1Szdx1WU21TgC1PRv3tkQ09H4qed,SpATywNh6bZuzm8s1ceuBUnMUAeoAHHw,17,17,9,10,4,8,14,1,63,9.0,3,0.0,4,9,9,4,13,8,1,14,1,26,37,1
424,7524,UNtI3N6D9AZsFIjfiItWfMe73uBfp0VS,SpATywNh6bZuzm8s1ceuBUnMUAeoAHHw,14,18,8,17,5,0,9,0,57,8.142857142857142,4,0.0,9,8,16,5,9,0,1,9,0,38,19,0
425,7541,CGIwACA114zcxKI2ZiGPCkXleQcVHz2y,SpATywNh6bZuzm8s1ceuBUnMUAeoAHHw,25,50,8,28,3,21,24,2,136,19.428571428571427,9,0.0,19,8,25,3,31,21,3,24,2,55,81,0
426,7543,fGIeAB7IRJCHxzCo8u4GLaPKxQfHeCdi,SpATywNh6bZuzm8s1ceuBUnMUAeoAHHw,30,100,49,30,22,8,44,0,253,36.142857142857146,8,0.0,16,49,27,22,84,8,3,44,0,114,139,0
427,7551,dnay2jAX3cgskuo0IcUq4nB4ZOtSKU5x,SpATywNh6bZuzm8s1ceuBUnMUAeoAHHw,27,56,21,28,8,1,18,0,132,18.857142857142858,8,0.0,9,21,26,8,47,1,2,18,0,64,68,0
428,7554,eO5CgKdvPHZfZ8krv7wlSTYp2EdmZAmV,RXDvfPUBYFlVdlueBFbLW0mhhAyGEqpt,43,147,4,82,10,17,21,6,287,41.0,5,0.0,38,4,74,10,109,17,8,21,6,126,161,1
429,7586,40eiF3ZEuOYP1RP6XBUcW4OUQFmNxf9i,SpATywNh6bZuzm8s1ceuBUnMUAeoAHHw,31,38,19,27,7,9,18,3,121,17.285714285714285,3,0.0,8,19,24,7,30,9,3,18,3,58,63,0
430,7587,wEaTyOJwwvOCk7eUttQISK5WPXL7ANNV,SpATywNh6bZuzm8s1ceuBUnMUAeoAHHw,23,34,13,21,5,15,18,3,109,15.571428571428571,4,0.0,6,13,18,5,28,15,3,18,3,42,67,0
431,7616,PcrKUgtxZcGXBYkLOmECh99m3fhAOabf,SpATywNh6bZuzm8s1ceuBUnMUAeoAHHw,24,79,26,37,5,3,13,0,163,23.285714285714285,5,0.0,15,26,31,5,64,3,6,13,0,77,86,0
432,7623,uRIMG7KJWhHO81Kf9MvAfUFzZC6juL3s,bWdj2GDclj5ofokWjzoa5jAwMkxCykd6,20,30,13,72,7,9,7,0,138,19.714285714285715,7,0.0,6,13,67,7,24,9,5,7,0,93,45,0
433,7649,cauH4YekuRKFsHZgdw9jChinljVOhzCP,SpATywNh6bZuzm8s1ceuBUnMUAeoAHHw,21,18,10,19,8,0,3,0,58,8.285714285714286,3,0.0,4,10,16,8,14,0,3,3,0,38,20,1
434,7651,HL6JESJ9UfnK7mtp7EsklcgEKja4gTaC,RXDvfPUBYFlVdlueBFbLW0mhhAyGEqpt,56,79,3,82,11,14,9,0,198,28.285714285714285,4,0.0,34,3,80,11,45,14,2,9,0,128,70,1
435,7656,v9Jp2iBPSFTVxP8FrUe1odwfz8Hd1wS3,SpATywNh6bZuzm8s1ceuBUnMUAeoAHHw,28,33,17,12,8,35,15,0,120,17.142857142857142,5,0.0,10,17,12,8,23,35,0,15,0,47,73,0
436,7659,1KSlK2xXHUc3PjC1CsQEQaomGBagqDXf,A3fsA9Zfv1X2fVEQhTw51lKENdNrEqT3,17,10,8,0,7,0,2,0,27,3.857142857142857,4,0.0,0,8,0,7,10,0,0,2,0,15,12,1
437,7660,ae4nSawB3M11Wmq3zKGmekxyJPcADmL9,bWdj2GDclj5ofokWjzoa5jAwMkxCykd6,1,0,0,0,0,0,1,0,1,0.14285714285714285,1,0.0,0,0,0,0,0,0,0,1,0,0,1,1
438,7667,ImCVHOP1jti1S73II8BRabWE6aqK4I6u,SpATywNh6bZuzm8s1ceuBUnMUAeoAHHw,2,0,0,0,0,0,3,0,3,0.42857142857142855,2,0.0,0,0,0,0,0,0,0,3,0,0,3,1
439,7670,NKzNFHK6LaJqjMec69ZX5HfBigF4yyJV,SpATywNh6bZuzm8s1ceuBUnMUAeoAHHw,29,29,16,14,9,16,24,3,111,15.857142857142858,3,0.0,10,16,14,9,19,16,0,24,3,49,62,0
440,7677,HPp2Yy992FcBIXDjeQl0bEftbV1QFRDS,SpATywNh6bZuzm8s1ceuBUnMUAeoAHHw,31,89,32,47,9,19,19,3,218,31.142857142857142,6,0.0,28,32,37,9,61,19,10,19,3,106,112,0
441,7681,3RcsrMTbPrb8ZHYXLlgwoRK7zrqTGSuq,bWdj2GDclj5ofokWjzoa5jAwMkxCykd6,6,3,2,0,2,0,1,0,8,1.1428571428571428,1,0.0,0,2,0,2,3,0,0,1,0,4,4,1
442,7683,uydIb4MWCn95KWcEhKwj3VRfjvxXo8Nj,A3fsA9Zfv1X2fVEQhTw51lKENdNrEqT3,77,231,131,214,2,1073,194,5,1850,264.2857142857143,21,0.0,25,131,158,2,206,1073,56,194,5,316,1534,0
443,7694,a6f3gPi6axX0cfBnUGVliBDQrPx92l1r,SpATywNh6bZuzm8s1ceuBUnMUAeoAHHw,25,59,38,36,17,0,14,0,164,23.428571428571427,9,0.0,5,38,28,17,54,0,8,14,0,88,76,0
444,7701,f81JJCqMlkJdA9lV7uQBviuGlLm2CDkR,SpATywNh6bZuzm8s1ceuBUnMUAeoAHHw,26,92,7,39,6,13,36,0,193,27.571428571428573,8,0.0,27,7,31,6,65,13,8,36,0,71,122,0
445,7720,LyBG9vpZvAGsIKFzeD4gB6XRCVzk12fF,A3fsA9Zfv1X2fVEQhTw51lKENdNrEqT3,13,7,6,10,4,0,6,0,33,4.714285714285714,2,0.0,0,6,9,4,7,0,1,6,0,19,14,1
446,7729,xkt3K6JWpnfeixDBdwkLXaHgXuuGt35v,A3fsA9Zfv1X2fVEQhTw51lKENdNrEqT3,64,38,25,168,9,2,20,0,262,37.42857142857143,6,0.0,2,25,148,9,36,2,20,20,0,184,78,1
447,7731,ZD844NRFhgHqwskHd8pIBuIwDiTAY4NC,SpATywNh6bZuzm8s1ceuBUnMUAeoAHHw,26,46,30,31,17,6,9,0,139,19.857142857142858,5,0.0,7,30,26,17,39,6,5,9,0,80,59,0
448,7766,3kfsZtV93tVXeg8YtF9PTasYswVdOeLx,SpATywNh6bZuzm8s1ceuBUnMUAeoAHHw,25,72,20,32,7,2,29,0,162,23.142857142857142,13,0.0,10,20,28,7,62,2,4,29,0,65,97,0
449,7767,GcInGCXKYnNWAnYbqUyxJe7hi4ZjhElg,RXDvfPUBYFlVdlueBFbLW0mhhAyGEqpt,27,27,15,8,14,0,5,0,69,9.857142857142858,3,0.0,5,15,8,14,22,0,0,5,0,42,27,1
450,7771,Rdvgrardg53H2oeCgmOt8vFxIUu5nogb,SpATywNh6bZuzm8s1ceuBUnMUAeoAHHw,29,60,33,28,13,1,14,0,149,21.285714285714285,6,0.0,13,33,22,13,47,1,6,14,0,81,68,0
451,7774,EQU3KQKmF0NpNwQmPmUw90ptahwADmIz,SpATywNh6bZuzm8s1ceuBUnMUAeoAHHw,20,53,5,0,1,13,26,2,100,14.285714285714286,5,0.0,17,5,0,1,36,13,0,26,2,23,77,1
452,7778,moK1GdnqoYxhSRCf5a95lgXdVNdzYrjs,A3fsA9Zfv1X2fVEQhTw51lKENdNrEqT3,89,90,16,134,8,16,69,0,333,47.57142857142857,13,0.0,3,16,127,8,87,16,7,69,0,154,179,0
453,7781,h1PVCD4diCwozuU4ZjcMLdFycUmYpSIc,G8EPVSXsOYB5YQWZGiz1aVq5Pgr2GrQu,33,30,13,58,5,1,15,1,123,17.571428571428573,4,0.0,10,13,42,5,20,1,16,15,1,70,53,0
454,7786,7aA6BrVZipLHOrozlrYBMEmfMq4MXahq,RXDvfPUBYFlVdlueBFbLW0mhhAyGEqpt,62,196,60,130,39,25,55,3,508,72.57142857142857,13,0.0,27,60,112,39,169,25,18,55,3,238,270,0
455,7789,pdotXwlXOl4cuEJn7TjzheQq2EZaH9qB,SpATywNh6bZuzm8s1ceuBUnMUAeoAHHw,6,6,0,0,0,0,2,0,8,1.1428571428571428,3,0.0,0,0,0,0,6,0,0,2,0,0,8,1
456,7793,z2zhro5MCTuNkAWXNKBS5L7zEtJc0Vs9,SpATywNh6bZuzm8s1ceuBUnMUAeoAHHw,29,107,43,24,19,184,66,14,457,65.28571428571429,6,0.0,30,43,21,19,77,184,3,66,14,113,344,0
457,7820,tcrOs8a5NYKg0fcf0qJ4buK5RKIEFS5o,RXDvfPUBYFlVdlueBFbLW0mhhAyGEqpt,43,31,14,107,8,0,6,0,166,23.714285714285715,3,0.0,7,14,102,8,24,0,5,6,0,131,35,0
458,7831,SozLQk8695JG7fvj1Enp26s5ACJQjjq5,SpATywNh6bZuzm8s1ceuBUnMUAeoAHHw,30,35,23,20,10,25,18,2,133,19.0,4,0.0,4,23,19,10,31,25,1,18,2,56,77,0
459,7844,cSB2xmj1Zot5hgCLSHhxDNISJzHyYsXf,SpATywNh6bZuzm8s1ceuBUnMUAeoAHHw,13,21,3,0,1,0,15,0,40,5.714285714285714,6,0.0,0,3,0,1,21,0,0,15,0,4,36,1
460,7869,34oDxV5jJfVaGWSsgPNGJP2ott7rJu7I,SpATywNh6bZuzm8s1ceuBUnMUAeoAHHw,29,123,61,34,47,3,16,0,284,40.57142857142857,6,0.0,35,61,30,47,88,3,4,16,0,173,111,0
461,7872,ZosutOeXAHBSIvZIuIxhmKGfV7JZESP5,SpATywNh6bZuzm8s1ceuBUnMUAeoAHHw,23,29,17,1,15,1,68,1,132,18.857142857142858,5,0.0,5,17,1,15,24,1,0,68,1,38,94,0
462,7885,S58o7T8J2JcEBTi3bdMATXeMdhJbXqYq,SpATywNh6bZuzm8s1ceuBUnMUAeoAHHw,31,30,17,27,9,11,11,2,107,15.285714285714286,2,0.0,7,17,24,9,23,11,3,11,2,57,50,0
463,7900,pVR5qyfYJN582jaXWwJ4YRpKGyADx6Eu,RXDvfPUBYFlVdlueBFbLW0mhhAyGEqpt,29,18,15,0,11,0,4,0,48,6.857142857142857,1,0.0,2,15,0,11,16,0,0,4,0,28,20,1
464,7916,TIvBCmMDquWj2iwTixxUP6A3HzcrQyq3,SpATywNh6bZuzm8s1ceuBUnMUAeoAHHw,31,75,32,30,13,54,83,5,292,41.714285714285715,12,0.0,11,32,22,13,64,54,8,83,5,78,214,0
465,7932,Dm0fTQ5hQ4vZLMdCz8HpFheMP2yCMt3n,SpATywNh6bZuzm8s1ceuBUnMUAeoAHHw,6,6,4,0,3,0,5,1,19,2.7142857142857144,3,0.0,0,4,0,3,6,0,0,5,1,7,12,0
466,7953,KIPXc8MOqmnlmMqnIzIeaBqliIw9pS44,RXDvfPUBYFlVdlueBFbLW0mhhAyGEqpt,16,28,14,14,7,2,12,0,77,11.0,2,0.0,2,14,13,7,26,2,1,12,0,36,41,1
467,7971,Y7KMNxUWz3B2grUtFCf2FgfpqFMvSy0l,G8EPVSXsOYB5YQWZGiz1aVq5Pgr2GrQu,60,59,39,146,20,14,37,5,320,45.714285714285715,7,0.0,3,39,119,20,56,14,27,37,5,181,139,0
468,7982,9MK6uRaOnLFmxpxcsZHlBDf4ITU7Vvr6,SpATywNh6bZuzm8s1ceuBUnMUAeoAHHw,7,3,0,0,0,0,4,0,7,1.0,1,0.0,0,0,0,0,3,0,0,4,0,0,7,1
469,8012,jagu0OJDhWTGFhfCMk0ghqluLpW3kzdC,SpATywNh6bZuzm8s1ceuBUnMUAeoAHHw,30,26,16,26,8,2,18,4,100,14.285714285714286,5,0.0,6,16,21,8,20,2,5,18,4,51,49,0
470,8033,e2lOOqKSlF9Fw65H87m0cJslmAtz6Yej,SpATywNh6bZuzm8s1ceuBUnMUAeoAHHw,5,2,1,0,1,0,2,0,6,0.8571428571428571,1,0.0,0,1,0,1,2,0,0,2,0,2,4,1
471,8035,Q7WmsII1N0h11nYfhimDkafAIQtH8FBe,A3fsA9Zfv1X2fVEQhTw51lKENdNrEqT3,27,16,11,0,9,3,12,2,53,7.571428571428571,1,0.0,3,11,0,9,13,3,0,12,2,23,30,1
472,8040,IjI8O6qhXWrzvoHGjD0jKSLTrkjwywnZ,SpATywNh6bZuzm8s1ceuBUnMUAeoAHHw,25,50,1,40,0,41,17,1,150,21.428571428571427,4,0.0,26,1,34,0,24,41,6,17,1,61,89,0
473,8042,XDPvGyFLLEYwbNEQik2MM4yiADs5rrYJ,SpATywNh6bZuzm8s1ceuBUnMUAeoAHHw,14,18,9,0,3,15,6,0,51,7.285714285714286,4,0.0,4,9,0,3,14,15,0,6,0,16,35,1
474,8048,lPfsYctvOlk2KshSTR0YzF9fsG0sDcXm,SpATywNh6bZuzm8s1ceuBUnMUAeoAHHw,18,40,17,27,4,7,14,3,112,16.0,5,0.0,16,17,21,4,24,7,6,14,3,58,54,0
475,8054,3nOS3JEH08BgwunQqioyEFfja4qIND4p,SpATywNh6bZuzm8s1ceuBUnMUAeoAHHw,8,6,4,0,1,0,3,0,14,2.0,2,0.0,0,4,0,1,6,0,0,3,0,5,9,1
476,8060,aJPDWxjvWh7cfVWUTg8ZVK8q5wjeFEdQ,SpATywNh6bZuzm8s1ceuBUnMUAeoAHHw,13,30,12,8,4,1,17,1,73,10.428571428571429,3,0.0,1,12,7,4,29,1,1,17,1,24,49,1
477,8084,Rl9j2cgwioq6OBXKad44x4Um0fdVh2gk,SpATywNh6bZuzm8s1ceuBUnMUAeoAHHw,6,2,1,0,1,0,3,0,7,1.0,1,0.0,0,1,0,1,2,0,0,3,0,2,5,1
478,8090,cXITZ8Hjmr6myIyBLbDLY8s8nux0OPPJ,SpATywNh6bZuzm8s1ceuBUnMUAeoAHHw,6,9,2,0,0,0,7,0,18,2.5714285714285716,2,0.0,0,2,0,0,9,0,0,7,0,2,16,1
479,8091,Nt122dpzJdE1gwkHUV6Ncnzj3MDda3Gr,G8EPVSXsOYB5YQWZGiz1aVq5Pgr2GrQu,5,9,1,2,1,0,3,0,16,2.2857142857142856,1,0.0,3,1,1,1,6,0,1,3,0,6,10,1
480,8094,cZCWNPGtcdIiIlOnNkFDWI8KTo9TOlAC,SpATywNh6bZuzm8s1ceuBUnMUAeoAHHw,6,1,1,0,1,0,4,0,7,1.0,1,0.0,0,1,0,1,1,0,0,4,0,2,5,1
481,8108,D8ad6YCP4S8e1UHCQjU17HMPa0udSxjF,A3fsA9Zfv1X2fVEQhTw51lKENdNrEqT3,37,10,8,64,5,12,17,2,118,16.857142857142858,2,0.0,1,8,60,5,9,12,4,17,2,74,44,1
482,8112,X4PGvTm4F0x49zE1LPpj4etdmQj6eS9S,SpATywNh6bZuzm8s1ceuBUnMUAeoAHHw,9,14,8,0,5,0,3,0,30,4.285714285714286,1,0.0,0,8,0,5,14,0,0,3,0,13,17,0
483,8123,q6JeU48PcDOdiZ368tb3IoCh3BVgnxVp,bWdj2GDclj5ofokWjzoa5jAwMkxCykd6,22,79,37,24,31,14,10,0,195,27.857142857142858,6,0.0,11,37,20,31,68,14,4,10,0,99,96,1
484,8145,ZDVmuYiPoGm0gu1bR2BaE1soF6dU5v1W,A3fsA9Zfv1X2fVEQhTw51lKENdNrEqT3,23,73,32,4,13,0,3,0,125,17.857142857142858,2,0.0,0,32,4,13,73,0,0,3,0,49,76,1
485,8148,nx1z63DgmeEAxW8gQgEbpcNs34kbRne4,A3fsA9Zfv1X2fVEQhTw51lKENdNrEqT3,4,1,1,0,0,0,3,0,5,0.7142857142857143,1,0.0,0,1,0,0,1,0,0,3,0,1,4,1
486,8166,eOxm8XEI11Xs6eiBi1Nu5QzIagZXwEm9,SpATywNh6bZuzm8s1ceuBUnMUAeoAHHw,22,34,22,19,5,106,16,0,202,28.857142857142858,8,0.0,3,22,17,5,31,106,2,16,0,47,155,0
487,8168,jtxvuHBV8ZOgNnNCL1A1WerzR2TVfFNy,A3fsA9Zfv1X2fVEQhTw51lKENdNrEqT3,42,24,17,62,12,0,4,0,119,17.0,3,0.0,3,17,52,12,21,0,10,4,0,84,35,1
488,8185,WgYQBUzSJJLcj6PwA0d8MdNri6k7nN4s,RXDvfPUBYFlVdlueBFbLW0mhhAyGEqpt,5,2,1,0,1,0,4,0,8,1.1428571428571428,2,0.0,0,1,0,1,2,0,0,4,0,2,6,1
489,8188,XpMzbdWNf7VknZxctjGvDzxNpyCLWCaP,SpATywNh6bZuzm8s1ceuBUnMUAeoAHHw,22,35,14,16,8,1,14,2,90,12.857142857142858,4,0.0,13,14,15,8,22,1,1,14,2,50,40,1
490,8210,YxqHC7YRxEYSyD66BTdrU6f4qZw3IxAu,SpATywNh6bZuzm8s1ceuBUnMUAeoAHHw,7,1,1,0,1,0,4,0,7,1.0,1,0.0,0,1,0,1,1,0,0,4,0,2,5,1
491,8243,VAe2acDlYib7o05H0M3tg4gQoc5gLI96,SpATywNh6bZuzm8s1ceuBUnMUAeoAHHw,29,39,21,17,7,0,9,1,94,13.428571428571429,5,0.0,10,21,17,7,29,0,0,9,1,55,39,1
492,8254,rD3x5Ovuza1MLiqkvaHksaL42hepSLSa,bWdj2GDclj5ofokWjzoa5jAwMkxCykd6,12,29,13,8,4,1,15,0,70,10.0,6,0.0,1,13,8,4,28,1,0,15,0,26,44,1
493,8257,ANOp8mWNHTZUswLhYddMTdBChUriYZaX,RXDvfPUBYFlVdlueBFbLW0mhhAyGEqpt,61,448,14,234,12,171,76,3,958,136.85714285714286,13,0.0,93,14,214,12,355,171,20,76,3,333,625,0
494,8284,X9u2Hncxz9A6DpGBhCZ5wulJhsMdyVac,RXDvfPUBYFlVdlueBFbLW0mhhAyGEqpt,13,11,9,0,4,0,6,0,30,4.285714285714286,3,0.0,0,9,0,4,11,0,0,6,0,13,17,1
495,8291,ljmWZCzWPqv1RXsn1q2wpsQtrnA1zct2,bWdj2GDclj5ofokWjzoa5jAwMkxCykd6,16,31,1,194,2,46,21,1,296,42.285714285714285,4,0.0,9,1,186,2,22,46,8,21,1,198,98,1
496,8301,KdYI01F9Xc7qTt82weazWGHtHsUvxDB7,SpATywNh6bZuzm8s1ceuBUnMUAeoAHHw,24,42,6,15,5,19,12,1,100,14.285714285714286,6,0.0,13,6,12,5,29,19,3,12,1,36,64,1
497,8305,kpS5tMAHQr9yJyfVB9Mkc4TlfmouYjNE,SpATywNh6bZuzm8s1ceuBUnMUAeoAHHw,21,94,36,0,14,3,31,4,182,26.0,11,0.0,0,36,0,14,94,3,0,31,4,50,132,0
498,8312,cYibpCaMUGq0WjgUWfTv0iIvJ7QbFj5E,SpATywNh6bZuzm8s1ceuBUnMUAeoAHHw,29,31,14,32,8,37,48,0,170,24.285714285714285,11,0.0,12,14,28,8,19,37,4,48,0,62,108,0
499,8345,qDcPjYl3DZy0WT2lmJT9GmZYgAdLwjE1,SpATywNh6bZuzm8s1ceuBUnMUAeoAHHw,5,6,1,0,0,0,2,0,9,1.2857142857142858,1,0.0,3,1,0,0,3,0,0,2,0,4,5,1
500,8348,f6fUoSUJslaShApLLQ3C3hAE39t0Ewco,SpATywNh6bZuzm8s1ceuBUnMUAeoAHHw,28,52,15,18,7,31,11,2,136,19.428571428571427,2,0.0,23,15,17,7,29,31,1,11,2,62,74,1
501,8375,U7C8tpNUwsrK1uIrWw0ieIQJYwOo61Uc,SpATywNh6bZuzm8s1ceuBUnMUAeoAHHw,20,25,16,8,7,0,3,0,59,8.428571428571429,3,0.0,2,16,6,7,23,0,2,3,0,31,28,1
502,8378,ZipuPEeCqze6LFrYfkIZBU7ronXF3JAb,SpATywNh6bZuzm8s1ceuBUnMUAeoAHHw,30,38,21,23,10,0,9,1,102,14.571428571428571,3,0.0,12,21,22,10,26,0,1,9,1,65,37,0
503,8381,XDUz0oVcNwke0CqAlFlmwOWSA32SgeFl,SpATywNh6bZuzm8s1ceuBUnMUAeoAHHw,18,45,2,4,1,0,17,0,69,9.857142857142858,11,0.0,3,2,4,1,42,0,0,17,0,10,59,0
504,8397,a9P7gN6Av72Gjg1AVS7Rv4BiyiW2xpDS,bWdj2GDclj5ofokWjzoa5jAwMkxCykd6,3,0,0,0,0,1,3,0,4,0.5714285714285714,1,0.0,0,0,0,0,0,1,0,3,0,0,4,1
505,8408,NYt3HW4iIDKFfkoDHUmE2GfhEi6C8Rqu,bWdj2GDclj5ofokWjzoa5jAwMkxCykd6,8,11,6,0,0,6,18,1,42,6.0,5,0.0,0,6,0,0,11,6,0,18,1,6,36,1
506,8410,kWUbu8oK1dFJKpHhiF15MwcSzNzv8GaS,A3fsA9Zfv1X2fVEQhTw51lKENdNrEqT3,6,8,5,0,3,0,4,0,20,2.857142857142857,2,0.0,0,5,0,3,8,0,0,4,0,8,12,1
507,8424,ukCIrv5h45nbdIEPPmMlvipT87B8fFE7,RXDvfPUBYFlVdlueBFbLW0mhhAyGEqpt,41,93,73,2,34,19,20,5,246,35.142857142857146,12,0.0,0,73,2,34,93,19,0,20,5,109,137,0
508,8427,sOkc0wEXSSLpxtxlqjZObJqg94IyLpuY,SpATywNh6bZuzm8s1ceuBUnMUAeoAHHw,24,81,2,21,0,34,37,0,175,25.0,11,0.0,26,2,17,0,55,34,4,37,0,45,130,0
509,8443,ITkxDxE80MnM3R1P6Tny4qeXU1QIqBHa,A3fsA9Zfv1X2fVEQhTw51lKENdNrEqT3,73,53,34,192,14,42,23,1,359,51.285714285714285,5,0.0,4,34,163,14,49,42,29,23,1,215,144,1
510,8449,TTJoWZMu9qE69gK338lM1DPPuzOJjTS2,SpATywNh6bZuzm8s1ceuBUnMUAeoAHHw,18,31,2,20,2,5,8,1,69,9.857142857142858,3,0.0,5,2,17,2,26,5,3,8,1,26,43,1
511,8457,jcXoYFaI9QPcliotiwIgOLeObkrSUvNn,SpATywNh6bZuzm8s1ceuBUnMUAeoAHHw,16,24,1,14,0,3,4,0,46,6.571428571428571,4,0.0,5,1,13,0,19,3,1,4,0,19,27,0
512,8471,qLCBP0aNIaDp6cyqIvUit2p06Y7zVnQy,G8EPVSXsOYB5YQWZGiz1aVq5Pgr2GrQu,7,6,1,0,1,0,2,0,10,1.4285714285714286,1,0.0,1,1,0,1,5,0,0,2,0,3,7,1
513,8478,UY6XF5Ob1mgKcqmlUI5FgYfIUUIUAwxR,SpATywNh6bZuzm8s1ceuBUnMUAeoAHHw,30,91,29,34,13,5,32,3,207,29.571428571428573,8,0.0,28,29,28,13,63,5,6,32,3,98,109,0
514,8504,2cKDRLsZWRQVPO7xdF2dpJ6vw1EsD7pk,bWdj2GDclj5ofokWjzoa5jAwMkxCykd6,14,35,8,102,3,0,4,0,152,21.714285714285715,5,0.0,3,8,96,3,32,0,6,4,0,110,42,1
515,8505,DpXkrIHIAIPNESKyvFah0WhpVT5PHFeL,SpATywNh6bZuzm8s1ceuBUnMUAeoAHHw,21,32,16,19,0,20,14,2,103,14.714285714285714,6,0.0,8,16,17,0,24,20,2,14,2,41,62,0
516,8510,2cKDRLsZWRQVPO7xdF2dpJ6vw1EsD7pk,A3fsA9Zfv1X2fVEQhTw51lKENdNrEqT3,66,76,28,218,13,0,4,0,339,48.42857142857143,4,0.0,10,28,182,13,66,0,36,4,0,233,106,1
517,8516,WFBeS5f6wWn1eFBxyujnTFuvM6fqEpDk,A3fsA9Zfv1X2fVEQhTw51lKENdNrEqT3,7,3,2,0,2,0,2,0,9,1.2857142857142858,1,0.0,0,2,0,2,3,0,0,2,0,4,5,1
518,8517,4tj4DQ4XnBvn4uM9Mw2kTJbN1KPDkno4,SpATywNh6bZuzm8s1ceuBUnMUAeoAHHw,28,78,31,34,8,24,29,8,212,30.285714285714285,7,0.0,26,31,33,8,52,24,1,29,8,98,114,0
519,8522,aLRP3ahB5SIcOn5vpM1VPEh9ib2QIioX,bWdj2GDclj5ofokWjzoa5jAwMkxCykd6,5,10,0,0,0,19,5,0,34,4.857142857142857,3,0.0,0,0,0,0,10,19,0,5,0,0,34,1
520,8523,0Vj24SN7QK68fxZGEj9b6pGHh8nTXfGG,A3fsA9Zfv1X2fVEQhTw51lKENdNrEqT3,51,30,18,150,2,0,10,0,210,30.0,8,0.0,3,18,139,2,27,0,11,10,0,162,48,0
521,8526,HBfe50okXo4yGURKfz5xhaX3ToIkoF7Q,bWdj2GDclj5ofokWjzoa5jAwMkxCykd6,38,95,44,88,13,58,23,1,322,46.0,8,0.0,9,44,81,13,86,58,7,23,1,147,175,1
522,8529,lnzFfoDYtlWPJMTPbihufULiQk1Jv9SB,SpATywNh6bZuzm8s1ceuBUnMUAeoAHHw,6,2,1,0,1,0,3,0,7,1.0,1,0.0,0,1,0,1,2,0,0,3,0,2,5,1
523,8540,83bogZlv4TVHMx4MUYOU3yEQWNYHnGAe,G8EPVSXsOYB5YQWZGiz1aVq5Pgr2GrQu,3,17,4,0,0,0,2,0,23,3.2857142857142856,6,0.0,1,4,0,0,16,0,0,2,0,5,18,1
524,8553,aGkT5uzDJUsKsLNIW3C8wBL1bUhJSBfn,SpATywNh6bZuzm8s1ceuBUnMUAeoAHHw,22,39,3,36,2,0,3,0,83,11.857142857142858,7,0.0,10,3,30,2,29,0,6,3,0,45,38,0
525,8570,ApFdQQBcLqTLoA4wIvtlnnwFs4FrlVS1,RXDvfPUBYFlVdlueBFbLW0mhhAyGEqpt,47,72,41,60,15,1,37,1,227,32.42857142857143,10,0.0,22,41,55,15,50,1,5,37,1,133,94,0
526,8574,7jkKKf5Pb7FrtJ3WnuF11G7ePioUPJm3,A3fsA9Zfv1X2fVEQhTw51lKENdNrEqT3,47,29,22,68,14,6,8,0,147,21.0,3,0.0,1,22,58,14,28,6,10,8,0,95,52,1
527,8582,x0VzAeYdlywtGLqE1HF68qQMYZTLfsw9,SpATywNh6bZuzm8s1ceuBUnMUAeoAHHw,30,61,30,16,13,1,19,1,141,20.142857142857142,8,0.0,19,30,16,13,42,1,0,19,1,78,63,0
528,8585,28jQkMYgDOh7TIBKdGn62G1sm2slN0BP,A3fsA9Zfv1X2fVEQhTw51lKENdNrEqT3,78,53,35,191,21,0,11,0,311,44.42857142857143,7,0.0,1,35,166,21,52,0,25,11,0,223,88,0
529,8586,Xci1viGBABzXjikcwwlwGEGBfmePUlzw,SpATywNh6bZuzm8s1ceuBUnMUAeoAHHw,24,134,54,13,5,45,41,4,296,42.285714285714285,8,0.0,59,54,13,5,75,45,0,41,4,131,165,1
530,8616,GexMn1szbSD50sX3ghgNlwAzziO50D2R,SpATywNh6bZuzm8s1ceuBUnMUAeoAHHw,30,76,20,23,10,52,33,2,216,30.857142857142858,7,0.0,18,20,22,10,58,52,1,33,2,70,146,0
531,8619,7yfm92CNSrFqBw5yp2Efl7B2jNSXGlux,SpATywNh6bZuzm8s1ceuBUnMUAeoAHHw,1,0,0,0,0,0,1,0,1,0.14285714285714285,1,0.0,0,0,0,0,0,0,0,1,0,0,1,1
532,8620,x0VzAeYdlywtGLqE1HF68qQMYZTLfsw9,bWdj2GDclj5ofokWjzoa5jAwMkxCykd6,8,7,5,0,3,0,2,0,17,2.4285714285714284,1,0.0,0,5,0,3,7,0,0,2,0,8,9,1
533,8628,nQgK4glIoTighvWZSrb5cpZqSgT49IUz,SpATywNh6bZuzm8s1ceuBUnMUAeoAHHw,29,46,22,18,9,2,14,0,111,15.857142857142858,7,0.0,15,22,18,9,31,2,0,14,0,64,47,0
534,8636,2tNnsKlcvz4IV4xQh5sF75J9zNq5DtzC,SpATywNh6bZuzm8s1ceuBUnMUAeoAHHw,23,49,8,32,3,27,5,0,124,17.714285714285715,3,0.0,26,8,28,3,23,27,4,5,0,65,59,1
535,8640,g2XbJogybHS3UQDYBcO0HoCO8HfG7ABm,A3fsA9Zfv1X2fVEQhTw51lKENdNrEqT3,42,58,2,38,0,5,20,3,126,18.0,5,0.0,3,2,38,0,55,5,0,20,3,43,83,1
536,8641,3dlrFJzmVyUebS1oyKqPiquAJj3CweSU,SpATywNh6bZuzm8s1ceuBUnMUAeoAHHw,29,60,15,29,5,2,20,2,133,19.0,4,0.0,16,15,23,5,44,2,6,20,2,59,74,1
537,8649,uQjl8NGtIQkRfoe9edBiMgtYYmdkzVXR,bWdj2GDclj5ofokWjzoa5jAwMkxCykd6,37,126,65,105,24,38,43,3,404,57.714285714285715,13,0.0,14,65,89,24,112,38,16,43,3,192,212,0
538,8652,15n53eqSRMLQKZaiigI2Vgclm7aKceka,A3fsA9Zfv1X2fVEQhTw51lKENdNrEqT3,20,26,5,0,3,1,17,2,54,7.714285714285714,5,0.0,0,5,0,3,26,1,0,17,2,8,46,0
539,8660,CxUPOQRaQMGLmbOcfniIQOhh24PXLDR6,A3fsA9Zfv1X2fVEQhTw51lKENdNrEqT3,53,96,47,79,16,22,34,4,298,42.57142857142857,13,0.0,6,47,63,16,90,22,16,34,4,132,166,0
540,8677,k6Ev3pOofJatsjXYv6yHRgeWPlAQcaXL,SpATywNh6bZuzm8s1ceuBUnMUAeoAHHw,28,26,16,20,6,1,10,1,80,11.428571428571429,3,0.0,4,16,19,6,22,1,1,10,1,45,35,1
541,8683,xlLP2MUG9CBaax1U0Ai47Er5upBZhMpV,SpATywNh6bZuzm8s1ceuBUnMUAeoAHHw,17,45,21,11,8,1,9,0,95,13.571428571428571,5,0.0,15,21,10,8,30,1,1,9,0,54,41,1
542,8690,NuBf7vtWvcfQjgrelnmNuJu6a5WC9FFT,SpATywNh6bZuzm8s1ceuBUnMUAeoAHHw,29,97,26,66,9,33,55,5,291,41.57142857142857,8,0.0,20,26,59,9,77,33,7,55,5,114,177,0
543,8734,fxq584v5hQmVOHgm4uohGT9XrYo1FGMS,SpATywNh6bZuzm8s1ceuBUnMUAeoAHHw,30,111,36,47,11,5,26,1,237,33.857142857142854,6,0.0,17,36,38,11,94,5,9,26,1,102,135,0
544,8741,XWElpBT4PKnC5pi96PLjtYP5u9l1rrKm,SpATywNh6bZuzm8s1ceuBUnMUAeoAHHw,27,93,27,18,7,6,44,2,197,28.142857142857142,9,0.0,17,27,17,7,76,6,1,44,2,68,129,0
545,8748,IZ5pWpBLzW50MjCCGxCjTz4w6DVz2MU3,A3fsA9Zfv1X2fVEQhTw51lKENdNrEqT3,5,4,2,0,1,0,3,0,10,1.4285714285714286,2,0.0,0,2,0,1,4,0,0,3,0,3,7,0
546,8752,tsTDNHtkzUQqr6Le5CiKzEb1J3ub8XpE,G8EPVSXsOYB5YQWZGiz1aVq5Pgr2GrQu,65,74,12,105,13,0,7,0,211,30.142857142857142,11,0.0,24,12,85,13,50,0,20,7,0,134,77,0
547,8756,cPzUMr5q8dc3UpQvyyBObvWhUfY89oua,SpATywNh6bZuzm8s1ceuBUnMUAeoAHHw,28,23,15,30,9,0,4,0,81,11.571428571428571,1,0.0,5,15,25,9,18,0,5,4,0,54,27,1
548,8766,V8icfAYA9I8myBnRTjbheMwStuoZOBk5,SpATywNh6bZuzm8s1ceuBUnMUAeoAHHw,27,98,35,35,10,20,41,6,245,35.0,7,0.0,29,35,30,10,69,20,5,41,6,104,141,1
549,8768,Za0SfT4qDZpXUZtWaYX1DLLmm9w6G9yO,RXDvfPUBYFlVdlueBFbLW0mhhAyGEqpt,28,32,18,0,10,14,7,1,82,11.714285714285714,2,0.0,0,18,0,10,32,14,0,7,1,28,54,1
550,8772,NLUFE7ndaVQ8A2tkIa8xBpPqWZbahAYT,SpATywNh6bZuzm8s1ceuBUnMUAeoAHHw,30,43,20,53,10,12,24,1,163,23.285714285714285,5,0.0,13,20,42,10,30,12,11,24,1,85,78,0
551,8778,hkmT0j8GDy3ymXnKaIcUDPdFkebvKRou,SpATywNh6bZuzm8s1ceuBUnMUAeoAHHw,30,68,32,45,15,17,29,3,209,29.857142857142858,7,0.0,20,32,37,15,48,17,8,29,3,104,105,0
552,8783,V9A9B2T9pRTU3AqvpqzuKs4MfRcAEte2,RXDvfPUBYFlVdlueBFbLW0mhhAyGEqpt,32,40,25,12,10,0,22,1,110,15.714285714285714,5,0.0,4,25,10,10,36,0,2,22,1,49,61,1
553,8790,hShFZH2IARrzxZjv2Hbws9rmf9bt3f58,SpATywNh6bZuzm8s1ceuBUnMUAeoAHHw,29,78,19,36,7,0,12,1,153,21.857142857142858,6,0.0,33,19,31,7,45,0,5,12,1,90,63,0
554,8820,sqKEuRhvHf94SnQ2C0IdhOfhaSrrM6tg,SpATywNh6bZuzm8s1ceuBUnMUAeoAHHw,30,115,7,41,9,19,38,3,232,33.142857142857146,10,0.0,33,7,35,9,82,19,6,38,3,84,148,0
555,8830,LfzKT52vEtoxbNqX2vKaJI7cIpPCsgUd,SpATywNh6bZuzm8s1ceuBUnMUAeoAHHw,7,3,2,0,2,0,4,0,11,1.5714285714285714,1,0.0,0,2,0,2,3,0,0,4,0,4,7,1
556,8831,SoFzOO60yRk0ggHCvfEgIFgyAhcbDPEU,SpATywNh6bZuzm8s1ceuBUnMUAeoAHHw,5,2,1,0,1,0,2,0,6,0.8571428571428571,1,0.0,0,1,0,1,2,0,0,2,0,2,4,1
557,8833,BX9KMh9DUbDRkGw8SYAs3wHv0hHJ990Z,SpATywNh6bZuzm8s1ceuBUnMUAeoAHHw,26,50,30,30,14,0,13,0,137,19.571428571428573,9,0.0,6,30,25,14,44,0,5,13,0,75,62,0
558,8862,5QXD7nGlfa5LD2DcNq8Av61TrcRi85rU,G8EPVSXsOYB5YQWZGiz1aVq5Pgr2GrQu,15,15,1,39,3,0,2,0,60,8.571428571428571,1,0.0,8,1,32,3,7,0,7,2,0,44,16,0
559,8863,4vEHDSGKXu9Cie3on99cieDjI4lud9xW,SpATywNh6bZuzm8s1ceuBUnMUAeoAHHw,12,26,1,14,0,0,2,0,43,6.142857142857143,1,0.0,13,1,13,0,13,0,1,2,0,27,16,1
560,8874,XrkmN79zYVHhoXA87bb44oUhAS8HKFji,SpATywNh6bZuzm8s1ceuBUnMUAeoAHHw,16,35,20,0,3,6,12,1,77,11.0,1,0.0,2,20,0,3,33,6,0,12,1,25,52,1
561,8880,mVMuUEeLKa3SdL5JnStqlN0fzPnKsCAA,SpATywNh6bZuzm8s1ceuBUnMUAeoAHHw,1,0,0,0,0,0,1,0,1,0.14285714285714285,1,0.0,0,0,0,0,0,0,0,1,0,0,1,1
562,8882,NAmyRYUXoAoJaF1WmEUzfZdW5j2jsFh1,SpATywNh6bZuzm8s1ceuBUnMUAeoAHHw,13,11,7,14,3,0,9,0,44,6.285714285714286,2,0.0,2,7,12,3,9,0,2,9,0,24,20,0
563,8894,8IuzZOXaXVUql9pLZtNuJIyLoDJ8ZL4V,bWdj2GDclj5ofokWjzoa5jAwMkxCykd6,8,13,5,0,0,0,13,0,31,4.428571428571429,5,0.0,0,5,0,0,13,0,0,13,0,5,26,1
564,8903,cvlNPzqQj2LOz3Z7WcczCYX7AEEZY5z2,RXDvfPUBYFlVdlueBFbLW0mhhAyGEqpt,7,5,2,0,1,2,6,0,16,2.2857142857142856,1,0.0,0,2,0,1,5,2,0,6,0,3,13,1
565,8908,9lksmcPg7FQE2FGQIA9VvWum1Z9DYrHM,SpATywNh6bZuzm8s1ceuBUnMUAeoAHHw,13,25,14,0,4,3,12,0,58,8.285714285714286,3,0.0,5,14,0,4,20,3,0,12,0,23,35,1
566,8915,RlIzEuK7g6sugNWIIhijiyryQft8qZof,SpATywNh6bZuzm8s1ceuBUnMUAeoAHHw,20,21,13,10,6,4,7,0,61,8.714285714285714,3,0.0,4,13,9,6,17,4,1,7,0,32,29,1
567,8939,awz7o49PrUBSNrYng5ZPMFSJBn6RXWK1,G8EPVSXsOYB5YQWZGiz1aVq5Pgr2GrQu,108,184,111,142,60,2,40,0,539,77.0,15,0.0,15,111,121,60,169,2,21,40,0,307,232,0
568,8943,dQggCBdg5KVSltApPCgVZB7TTUQzzzoI,RXDvfPUBYFlVdlueBFbLW0mhhAyGEqpt,51,49,28,101,11,22,8,0,219,31.285714285714285,5,0.0,10,28,86,11,39,22,15,8,0,135,84,1
569,8954,N7x6rez9AavUVus2y33zQwbgvW9e4FwN,bWdj2GDclj5ofokWjzoa5jAwMkxCykd6,4,2,1,0,1,0,1,0,5,0.7142857142857143,1,0.0,0,1,0,1,2,0,0,1,0,2,3,1
570,8972,3NITGQuylcrTi63aoWqnzXuF5Rtf7QVq,SpATywNh6bZuzm8s1ceuBUnMUAeoAHHw,25,45,19,15,17,19,23,0,138,19.714285714285715,4,0.0,7,19,14,17,38,19,1,23,0,57,81,1
571,8976,7uaenfsWfnarv8At387iUkznBBW20T7a,SpATywNh6bZuzm8s1ceuBUnMUAeoAHHw,20,38,12,13,4,7,12,1,87,12.428571428571429,4,0.0,16,12,10,4,22,7,3,12,1,42,45,0
572,8978,WCRryRCEKP6zK3AUHtR5dzBwncEtNUH8,G8EPVSXsOYB5YQWZGiz1aVq5Pgr2GrQu,126,295,46,310,25,4,70,2,752,107.42857142857143,18,0.0,94,46,225,25,201,4,85,70,2,390,362,0
573,8986,Ucr48Rnt4CA9YgbeIcM1jITCIMHtgMC0,A3fsA9Zfv1X2fVEQhTw51lKENdNrEqT3,3,0,0,0,0,0,6,0,6,0.8571428571428571,2,0.0,0,0,0,0,0,0,0,6,0,0,6,1
574,9001,lvwGRCEVK5ut59266fZHM9ppN9a4Qw6i,SpATywNh6bZuzm8s1ceuBUnMUAeoAHHw,6,5,3,0,2,0,3,0,13,1.8571428571428572,2,0.0,0,3,0,2,5,0,0,3,0,5,8,1
575,9007,WDMP5c2Ubx8vVSFegA0mXeU23cYb0qCY,RXDvfPUBYFlVdlueBFbLW0mhhAyGEqpt,60,112,9,88,4,61,25,2,301,43.0,15,0.0,15,9,81,4,97,61,7,25,2,109,192,0
576,9035,ANOp8mWNHTZUswLhYddMTdBChUriYZaX,SpATywNh6bZuzm8s1ceuBUnMUAeoAHHw,24,67,0,49,0,13,21,2,152,21.714285714285715,6,0.0,16,0,42,0,51,13,7,21,2,58,94,0
577,9039,AoGNGJBevj5UJJAo0rhBglhkcP4W6WBy,G8EPVSXsOYB5YQWZGiz1aVq5Pgr2GrQu,1,0,0,0,0,0,1,0,1,0.14285714285714285,1,0.0,0,0,0,0,0,0,0,1,0,0,1,1
578,9043,aiXR63FJxLzLjxOw200I9QHjcVwt5TEN,SpATywNh6bZuzm8s1ceuBUnMUAeoAHHw,18,33,1,25,1,34,15,1,110,15.714285714285714,2,0.0,14,1,21,1,19,34,4,15,1,37,73,1
579,9136,UqGW2x76mENodjXkUPPKnojGcrLxXcJN,SpATywNh6bZuzm8s1ceuBUnMUAeoAHHw,28,57,29,42,16,2,11,0,157,22.428571428571427,6,0.0,17,29,36,16,40,2,6,11,0,98,59,0
580,9146,ZZYUdx90J4oaTxXr1v9ckDyAAO4fdRrW,bWdj2GDclj5ofokWjzoa5jAwMkxCykd6,7,4,2,0,2,0,4,0,12,1.7142857142857142,2,0.0,0,2,0,2,4,0,0,4,0,4,8,1
581,9149,8SekjqaLbfUPHiuX7ZCPwYfF03sn6XJi,RXDvfPUBYFlVdlueBFbLW0mhhAyGEqpt,46,73,30,101,15,3,10,0,232,33.142857142857146,7,0.0,16,30,99,15,57,3,2,10,0,160,72,1
582,9159,9DysAmMC3i4TW1eruWnww7wyDSDGRjXp,A3fsA9Zfv1X2fVEQhTw51lKENdNrEqT3,2,0,0,0,0,0,2,0,2,0.2857142857142857,1,0.0,0,0,0,0,0,0,0,2,0,0,2,1
583,9190,aP7onqFgeKEyIpEWyf9FmzL3YmPhzgtY,SpATywNh6bZuzm8s1ceuBUnMUAeoAHHw,5,4,2,0,0,0,2,0,8,1.1428571428571428,1,0.0,0,2,0,0,4,0,0,2,0,2,6,1
584,9197,1F8H7rmfvGmKxlm2143vBRoEH3vbZnuH,SpATywNh6bZuzm8s1ceuBUnMUAeoAHHw,7,5,2,0,2,0,4,0,13,1.8571428571428572,1,0.0,0,2,0,2,5,0,0,4,0,4,9,1
585,9206,Gdklwa0GJ75FwxPq1eHDC2rS99nIOtyi,bWdj2GDclj5ofokWjzoa5jAwMkxCykd6,38,53,31,116,12,12,14,2,240,34.285714285714285,4,0.0,12,31,102,12,41,12,14,14,2,157,83,1
586,9211,wSA7fJey1UFj4xGAji5nvUhhmZ43Jtbi,SpATywNh6bZuzm8s1ceuBUnMUAeoAHHw,7,7,2,0,1,0,8,0,18,2.5714285714285716,1,0.0,0,2,0,1,7,0,0,8,0,3,15,1
587,9220,lnpRXkDrSwjGYP4CoWLvjg5xZj4SSBHh,SpATywNh6bZuzm8s1ceuBUnMUAeoAHHw,32,93,37,21,10,85,27,2,275,39.285714285714285,8,0.0,18,37,20,10,75,85,1,27,2,85,190,0
588,9229,pSPqM0wxHLvU8pOPPVGkhJ6iIpXOwE0D,SpATywNh6bZuzm8s1ceuBUnMUAeoAHHw,5,2,1,0,1,3,3,0,10,1.4285714285714286,1,0.0,0,1,0,1,2,3,0,3,0,2,8,1
589,9232,b3doS3mx4rZAsWrCVosVej8UMBCaG0ZM,SpATywNh6bZuzm8s1ceuBUnMUAeoAHHw,23,35,15,18,7,0,5,0,80,11.428571428571429,2,0.0,16,15,17,7,19,0,1,5,0,55,25,1
590,9246,oolYEp2BotSva2yfmUYiIDYQiMjym92z,SpATywNh6bZuzm8s1ceuBUnMUAeoAHHw,9,11,6,0,4,0,5,0,26,3.7142857142857144,4,0.0,0,6,0,4,11,0,0,5,0,10,16,0
591,9257,XQsLTRxBgT09jhwR2kw4g3k34p5O8kHV,A3fsA9Zfv1X2fVEQhTw51lKENdNrEqT3,25,48,28,0,13,12,18,3,122,17.428571428571427,8,0.0,5,28,0,13,43,12,0,18,3,46,76,1
592,9260,OXDIjQPBiuWpB7PdzfniEtiITaq40Kxq,SpATywNh6bZuzm8s1ceuBUnMUAeoAHHw,31,44,20,35,8,2,16,1,126,18.0,8,0.0,11,20,31,8,33,2,4,16,1,70,56,1
593,9272,8lhedVUrxjbKOOXrDoKpLvh9BgBDrVND,SpATywNh6bZuzm8s1ceuBUnMUAeoAHHw,29,61,17,30,8,7,24,5,152,21.714285714285715,4,0.0,13,17,25,8,48,7,5,24,5,63,89,0
594,9273,Mu4L96Qo7KWrVAKYK2IsPfV4EjP9aNL4,G8EPVSXsOYB5YQWZGiz1aVq5Pgr2GrQu,14,9,5,2,4,13,16,1,50,7.142857142857143,5,0.0,4,5,1,4,5,13,1,16,1,14,36,1
595,9275,Mu4L96Qo7KWrVAKYK2IsPfV4EjP9aNL4,SpATywNh6bZuzm8s1ceuBUnMUAeoAHHw,30,36,21,47,9,34,19,0,166,23.714285714285715,5,0.0,7,21,39,9,29,34,8,19,0,76,90,1
596,9291,0rBpfipIkPUXXv4992tUqetb5IpoweSC,SpATywNh6bZuzm8s1ceuBUnMUAeoAHHw,12,13,1,12,0,0,6,1,33,4.714285714285714,2,0.0,4,1,12,0,9,0,0,6,1,17,16,1
597,9295,Xj0ZJ92JN6F4CNXTzd0Bvhi4bYi9S3VP,SpATywNh6bZuzm8s1ceuBUnMUAeoAHHw,20,26,15,11,12,6,27,2,99,14.142857142857142,8,0.0,4,15,11,12,22,6,0,27,2,42,57,0
598,9315,MjPA7JgM9XbkzRn3BICo8xJPG5qfeCcD,bWdj2GDclj5ofokWjzoa5jAwMkxCykd6,8,30,23,0,21,0,8,0,82,11.714285714285714,8,0.0,0,23,0,21,30,0,0,8,0,44,38,1
599,9327,tJN8ZYcrD7OwnBb01xCqUSDOnzwFRPdf,SpATywNh6bZuzm8s1ceuBUnMUAeoAHHw,22,60,8,24,0,11,25,0,128,18.285714285714285,9,0.0,15,8,21,0,45,11,3,25,0,44,84,0
600,9328,3SP9iNDvUt8m67ZMqC5DpQRe6ekkTpsP,SpATywNh6bZuzm8s1ceuBUnMUAeoAHHw,1,0,0,0,0,0,32,0,32,4.571428571428571,11,0.0,0,0,0,0,0,0,0,32,0,0,32,1
601,9329,sh6bGbGsbHzTVrRuQUATUDypFgGrJyhP,bWdj2GDclj5ofokWjzoa5jAwMkxCykd6,1,0,0,0,0,0,1,0,1,0.14285714285714285,1,0.0,0,0,0,0,0,0,0,1,0,0,1,1
602,9335,hsFDq5MhfyyJ0opvBTTLO0xNuy1mKh4f,SpATywNh6bZuzm8s1ceuBUnMUAeoAHHw,25,28,14,8,7,0,8,0,65,9.285714285714286,4,0.0,6,14,8,7,22,0,0,8,0,35,30,1
603,9339,4GxaPPzHsA8XSeyZ6ySVKPYJkeTDhbmO,A3fsA9Zfv1X2fVEQhTw51lKENdNrEqT3,11,2,2,0,2,5,15,3,29,4.142857142857143,1,0.0,0,2,0,2,2,5,0,15,3,4,25,1
604,9347,dQweEcdBCmNmUPOeO7X4TTmH8zuMq2aJ,bWdj2GDclj5ofokWjzoa5jAwMkxCykd6,36,93,41,174,1,30,27,0,366,52.285714285714285,5,0.0,20,41,124,1,73,30,50,27,0,186,180,1
605,9357,aSYSmBNLMzBrel3rF1bQSMOfc7OKhL4q,SpATywNh6bZuzm8s1ceuBUnMUAeoAHHw,18,25,10,20,7,0,9,0,71,10.142857142857142,4,0.0,3,10,16,7,22,0,4,9,0,36,35,1
606,9358,I2ghGumCKIaVsnJOGZA0xyJzTnEm5KtW,RXDvfPUBYFlVdlueBFbLW0mhhAyGEqpt,28,30,18,0,8,16,4,0,76,10.857142857142858,3,0.0,6,18,0,8,24,16,0,4,0,32,44,1
607,9362,EoYFOaJU19EU8QGJeHpIRqrgzpIVI4Qd,bWdj2GDclj5ofokWjzoa5jAwMkxCykd6,9,13,5,28,3,0,9,0,58,8.285714285714286,4,0.0,4,5,27,3,9,0,1,9,0,39,19,1
608,9389,UGnGGFIGvpoYWCshdaVb9HHg3HECfvUa,A3fsA9Zfv1X2fVEQhTw51lKENdNrEqT3,9,4,3,0,3,0,4,0,14,2.0,1,0.0,0,3,0,3,4,0,0,4,0,6,8,1
609,9391,ZVsvi9Hs3gwMngikgiUNz4ONY4BYnfbY,SpATywNh6bZuzm8s1ceuBUnMUAeoAHHw,1,0,0,0,0,0,1,0,1,0.14285714285714285,1,0.0,0,0,0,0,0,0,0,1,0,0,1,1
610,9419,JZCy2v8CZ2nSCAUiBMrG3NWUkCCn6jiz,G8EPVSXsOYB5YQWZGiz1aVq5Pgr2GrQu,32,73,8,6,3,1,11,1,103,14.714285714285714,5,0.0,14,8,5,3,59,1,1,11,1,30,73,1
611,9422,KqXKhfoS0ErJVO04c2y8uGBxUt61ck8m,SpATywNh6bZuzm8s1ceuBUnMUAeoAHHw,15,18,1,20,1,0,6,0,46,6.571428571428571,2,0.0,9,1,19,1,9,0,1,6,0,30,16,1
612,9460,zOr0niRplBKfkwpPHNykN96u1FhzegfK,G8EPVSXsOYB5YQWZGiz1aVq5Pgr2GrQu,61,251,138,22,33,118,57,1,620,88.57142857142857,13,0.0,17,138,16,33,234,118,6,57,1,204,416,0
613,9466,XDPvGyFLLEYwbNEQik2MM4yiADs5rrYJ,G8EPVSXsOYB5YQWZGiz1aVq5Pgr2GrQu,2,0,0,0,0,0,2,0,2,0.2857142857142857,1,0.0,0,0,0,0,0,0,0,2,0,0,2,1
614,9468,JnhPqAOFLEpgEufKhwt0tmkUNhkNteVd,SpATywNh6bZuzm8s1ceuBUnMUAeoAHHw,22,41,8,36,2,0,14,0,101,14.428571428571429,6,0.0,11,8,34,2,30,0,2,14,0,55,46,1
615,9469,V4PEne3FGwC3uaaGa4t7iLZtyEIE0fzF,SpATywNh6bZuzm8s1ceuBUnMUAeoAHHw,27,50,11,29,4,15,27,3,139,19.857142857142858,6,0.0,13,11,24,4,37,15,5,27,3,52,87,1
616,9470,XDPvGyFLLEYwbNEQik2MM4yiADs5rrYJ,RXDvfPUBYFlVdlueBFbLW0mhhAyGEqpt,2,0,0,0,0,0,2,0,2,0.2857142857142857,1,0.0,0,0,0,0,0,0,0,2,0,0,2,1
617,9480,xNIFyatWugs5Maa0edr0HyKzFRsz7FQp,G8EPVSXsOYB5YQWZGiz1aVq5Pgr2GrQu,2,0,0,0,0,0,2,0,2,0.2857142857142857,1,0.0,0,0,0,0,0,0,0,2,0,0,2,1
618,9482,2YohZ5UKGzy1qUgVAShosLdhgm3pfvsR,SpATywNh6bZuzm8s1ceuBUnMUAeoAHHw,6,3,1,0,1,0,2,0,7,1.0,1,0.0,0,1,0,1,3,0,0,2,0,2,5,1
619,9510,20lTdK7j1fcbNyoe9mD2q7qXvA5Z8HOD,SpATywNh6bZuzm8s1ceuBUnMUAeoAHHw,27,109,64,11,42,3,18,1,248,35.42857142857143,5,0.0,13,64,10,42,96,3,1,18,1,129,119,0
620,9517,fN4I0M2Yv3uPvseFkDyQdSg5ZokzJaMj,RXDvfPUBYFlVdlueBFbLW0mhhAyGEqpt,71,78,47,186,19,119,11,10,470,67.14285714285714,7,0.0,17,47,169,19,61,119,17,11,10,252,218,1
621,9533,xdUSsALCLmQFNaGX8BEyTR2RhmvhWdsB,SpATywNh6bZuzm8s1ceuBUnMUAeoAHHw,28,35,10,32,5,4,32,0,118,16.857142857142858,7,0.0,8,10,28,5,27,4,4,32,0,51,67,0
622,9549,RV3mgnFEm5em6PXoEJeQNSKFCpjzfVyy,bWdj2GDclj5ofokWjzoa5jAwMkxCykd6,11,10,4,4,1,206,41,0,266,38.0,12,0.0,1,4,3,1,9,206,1,41,0,9,257,0
623,9550,7J9JIWVCQG1g6yXh3uTVbrSu3pa18Ezn,SpATywNh6bZuzm8s1ceuBUnMUAeoAHHw,29,42,26,18,7,7,12,2,114,16.285714285714285,4,0.0,9,26,17,7,33,7,1,12,2,59,55,0
624,9581,c9jAWas5mvRKYRBHiOkTzLeYoPWRHLa3,G8EPVSXsOYB5YQWZGiz1aVq5Pgr2GrQu,1,0,0,0,0,0,2,0,2,0.2857142857142857,1,0.0,0,0,0,0,0,0,0,2,0,0,2,1
625,9624,GD8FRA1y66qb4KlW9w61HoAU1TWGpDoa,G8EPVSXsOYB5YQWZGiz1aVq5Pgr2GrQu,53,107,48,76,8,1278,161,123,1801,257.2857142857143,21,0.0,16,48,59,8,91,1278,17,161,123,131,1670,0
626,9636,zcw6JFT1cBTyKAWUWt6eG4jvVYxHMSLq,SpATywNh6bZuzm8s1ceuBUnMUAeoAHHw,24,26,15,23,6,8,7,0,85,12.142857142857142,3,0.0,6,15,20,6,20,8,3,7,0,47,38,0
627,9643,UzwJVyLJF6Ih9iHYPyYWMullgIr89o5m,SpATywNh6bZuzm8s1ceuBUnMUAeoAHHw,20,42,22,14,2,2,16,0,98,14.0,8,0.0,9,22,14,2,33,2,0,16,0,47,51,0
628,9655,66U3TkcZA1aSl7HKRun9CzahgGH85zQD,SpATywNh6bZuzm8s1ceuBUnMUAeoAHHw,29,59,22,14,8,22,19,0,144,20.571428571428573,7,0.0,23,22,14,8,36,22,0,19,0,67,77,0
629,9663,C4q4gNQYEpjKh7pq1qjN8i3L7uSpUX9d,bWdj2GDclj5ofokWjzoa5jAwMkxCykd6,52,88,55,198,31,4,22,2,400,57.142857142857146,6,0.0,13,55,176,31,75,4,22,22,2,275,125,0
630,9672,Bi4hHmeTLwTbUCScu9tC6ZZN7frLUhVP,A3fsA9Zfv1X2fVEQhTw51lKENdNrEqT3,98,44,33,118,21,15,23,0,254,36.285714285714285,4,0.0,4,33,117,21,40,15,1,23,0,175,79,0
631,9720,0dBn4alo7QBTd62VD5XO0yNMbQ5QN2OQ,bWdj2GDclj5ofokWjzoa5jAwMkxCykd6,10,32,12,0,5,0,5,0,54,7.714285714285714,4,0.0,0,12,0,5,32,0,0,5,0,17,37,1
632,9724,YwojqO58bCgaotjJoOTtpKH2oiEFOZyB,bWdj2GDclj5ofokWjzoa5jAwMkxCykd6,15,25,16,10,16,1,7,0,75,10.714285714285714,6,0.0,6,16,8,16,19,1,2,7,0,46,29,1
633,9746,ZPXEPNmHJO62FgTOVc5NtKcudTAnHNKW,SpATywNh6bZuzm8s1ceuBUnMUAeoAHHw,5,2,1,0,1,0,2,0,6,0.8571428571428571,2,0.0,0,1,0,1,2,0,0,2,0,2,4,1
634,9760,HNHEsc9fD0OwHisMoqyCkexAkrQ9Muqq,bWdj2GDclj5ofokWjzoa5jAwMkxCykd6,6,4,2,0,1,0,5,0,12,1.7142857142857142,1,0.0,0,2,0,1,4,0,0,5,0,3,9,0
635,9767,Bv9FSXvHlE6wLC4E4yrAKqe3BQhrrtfx,A3fsA9Zfv1X2fVEQhTw51lKENdNrEqT3,9,18,2,0,0,0,5,0,25,3.5714285714285716,3,0.0,0,2,0,0,18,0,0,5,0,2,23,1
636,9783,CZfXDHVnNPClikyXrFzPhkQoFiILzXmF,SpATywNh6bZuzm8s1ceuBUnMUAeoAHHw,21,46,3,24,0,0,7,0,80,11.428571428571429,5,0.0,13,3,22,0,33,0,2,7,0,38,42,0
637,9784,WnYAypmYi03odcBC7NgJFsh1FzqrpNw6,SpATywNh6bZuzm8s1ceuBUnMUAeoAHHw,5,8,4,0,1,0,3,0,16,2.2857142857142856,3,0.0,0,4,0,1,8,0,0,3,0,5,11,0
638,9790,yUvG5Vqh097epwWCIkZetr2ZlwvQRcLL,SpATywNh6bZuzm8s1ceuBUnMUAeoAHHw,18,29,7,16,1,0,12,0,65,9.285714285714286,7,0.0,11,7,15,1,18,0,1,12,0,34,31,0
639,9793,B2ahwtOo16YsNrAQ9LRd2yjP18Ni9l2c,SpATywNh6bZuzm8s1ceuBUnMUAeoAHHw,23,103,14,17,9,0,20,0,163,23.285714285714285,10,0.0,5,14,15,9,98,0,2,20,0,43,120,0
640,9797,Dnyzk8ev480byt0tTEIN8mPtG79PwCH1,RXDvfPUBYFlVdlueBFbLW0mhhAyGEqpt,38,44,37,2,22,20,5,0,130,18.571428571428573,8,0.0,1,37,2,22,43,20,0,5,0,62,68,1
641,9812,fARr9B8lZ63xDV7GkxAczvRhzY3xBLi6,RXDvfPUBYFlVdlueBFbLW0mhhAyGEqpt,18,24,0,1,0,24,4,0,53,7.571428571428571,4,0.0,1,0,1,0,23,24,0,4,0,2,51,1
642,9823,hEw8FL1KT7bCC88Jn3Nko4dT9ob6cai1,A3fsA9Zfv1X2fVEQhTw51lKENdNrEqT3,10,9,1,0,1,0,1,0,12,1.7142857142857142,1,0.0,0,1,0,1,9,0,0,1,0,2,10,0
643,9839,bunHowa0BgtekXN64zdm8G1L1XdN8gBZ,bWdj2GDclj5ofokWjzoa5jAwMkxCykd6,7,7,1,4,1,0,6,0,19,2.7142857142857144,2,0.0,4,1,4,1,3,0,0,6,0,10,9,1
644,9852,1wIqcRX58Bpw6RXvGnbxsc6WbPwWGwXd,SpATywNh6bZuzm8s1ceuBUnMUAeoAHHw,15,41,5,17,0,0,12,0,75,10.714285714285714,5,0.0,15,5,16,0,26,0,1,12,0,36,39,0
645,9869,0RNr6P08D2zaPSoifoE3KvUeNCFcBSvA,SpATywNh6bZuzm8s1ceuBUnMUAeoAHHw,26,50,10,19,3,17,10,1,110,15.714285714285714,6,0.0,15,10,16,3,35,17,3,10,1,44,66,0
646,9873,u4s0SPiIkynucY7ReF58TL89R2q4zw1x,SpATywNh6bZuzm8s1ceuBUnMUAeoAHHw,15,42,23,6,11,0,6,0,88,12.571428571428571,6,0.0,2,23,6,11,40,0,0,6,0,42,46,1
647,9876,vn6QiPL2hNfbQVlbP4Lnj04J2ZQusfUk,A3fsA9Zfv1X2fVEQhTw51lKENdNrEqT3,7,10,7,0,0,0,4,0,21,3.0,2,0.0,1,7,0,0,9,0,0,4,0,8,13,1
648,9904,OfMabADNCpK7MfQ7IaqBsUw8RvPeHL0S,RXDvfPUBYFlVdlueBFbLW0mhhAyGEqpt,71,99,57,147,26,11,28,0,368,52.57142857142857,8,0.0,23,57,142,26,76,11,5,28,0,248,120,0
649,9923,CRrOxkmi8hXpA4NrCBnJ87Z2odaZzKo5,SpATywNh6bZuzm8s1ceuBUnMUAeoAHHw,31,49,22,37,11,19,16,2,156,22.285714285714285,3,0.0,23,22,33,11,26,19,4,16,2,89,67,1
650,9928,ylxIxsQV8oDzYk1f9bdd1UWiUi1ODLbL,SpATywNh6bZuzm8s1ceuBUnMUAeoAHHw,25,107,2,33,1,32,41,3,219,31.285714285714285,10,0.0,32,2,28,1,75,32,5,41,3,63,156,0
651,9929,oaL3pbpAfEH9L4o42G6X4xjme1kXt2tm,SpATywNh6bZuzm8s1ceuBUnMUAeoAHHw,27,57,31,22,17,0,11,0,138,19.714285714285715,7,0.0,6,31,21,17,51,0,1,11,0,75,63,0
652,9943,KXKbDyPytrUZAnNaQjyZgMFkA2w3Wpvj,SpATywNh6bZuzm8s1ceuBUnMUAeoAHHw,32,101,64,46,29,102,46,4,392,56.0,9,0.0,20,64,37,29,81,102,9,46,4,150,242,1
653,9946,Jd5OP6GIsguRdsq9k3eSYNENmzhPbdGe,G8EPVSXsOYB5YQWZGiz1aVq5Pgr2GrQu,5,6,3,0,1,0,4,0,14,2.0,4,0.0,0,3,0,1,6,0,0,4,0,4,10,0
654,9949,IUn6MADAjAYkGlJisA1WiDvCeNlJd5Xd,SpATywNh6bZuzm8s1ceuBUnMUAeoAHHw,28,35,22,18,15,8,11,0,109,15.571428571428571,7,0.0,8,22,16,15,27,8,2,11,0,61,48,0
655,9953,KeGByI8uvXcUVBvZaFAzVTfOuPfjSv5Y,SpATywNh6bZuzm8s1ceuBUnMUAeoAHHw,11,24,6,0,0,36,27,6,99,14.142857142857142,5,0.0,5,6,0,0,19,36,0,27,6,11,88,1
656,9963,YleydB3G0OM4jGw8hrXeA6aAbHfKvakN,SpATywNh6bZuzm8s1ceuBUnMUAeoAHHw,21,31,16,12,5,0,9,0,73,10.428571428571429,7,0.0,8,16,12,5,23,0,0,9,0,41,32,1
657,9970,Eok9XbYPb68kijAV2YozwwDkJT3HyKxy,RXDvfPUBYFlVdlueBFbLW0mhhAyGEqpt,6,4,3,0,1,0,1,0,9,1.2857142857142858,1,0.0,0,3,0,1,4,0,0,1,0,4,5,1
658,9976,lGkFqL5UAvY3j67ej7JQek066TD04jDH,bWdj2GDclj5ofokWjzoa5jAwMkxCykd6,1,0,0,0,0,0,1,0,1,0.14285714285714285,1,0.0,0,0,0,0,0,0,0,1,0,0,1,1
659,9988,GVRJN4wkoooaXJUVmwnX983A87KsrZPK,SpATywNh6bZuzm8s1ceuBUnMUAeoAHHw,27,41,25,16,10,182,14,1,289,41.285714285714285,9,0.0,7,25,15,10,34,182,1,14,1,57,232,0
660,10015,gFtSwrFBdsFWgLyqjSCzwaUhlQmEHgOq,SpATywNh6bZuzm8s1ceuBUnMUAeoAHHw,28,46,31,28,15,0,10,0,130,18.571428571428573,9,0.0,4,31,26,15,42,0,2,10,0,76,54,0
661,10016,5z0TnHJcRYhCDHjnNu4kmaWirO8lucwr,SpATywNh6bZuzm8s1ceuBUnMUAeoAHHw,20,152,6,9,5,3,17,0,192,27.428571428571427,7,0.0,27,6,8,5,125,3,1,17,0,46,146,1
662,10018,yzEVvmdwGMRoO2gS2DXIrqQbxP7DOJod,SpATywNh6bZuzm8s1ceuBUnMUAeoAHHw,7,3,2,0,2,0,2,0,9,1.2857142857142858,1,0.0,0,2,0,2,3,0,0,2,0,4,5,1
663,10024,FELnhQR0c7GZZX82ioYJEZsqujOrfyf7,bWdj2GDclj5ofokWjzoa5jAwMkxCykd6,10,8,5,0,2,9,8,0,32,4.571428571428571,2,0.0,0,5,0,2,8,9,0,8,0,7,25,1
664,10025,SozAkRr5kfRi3urQaoczmRXQoW70onBa,A3fsA9Zfv1X2fVEQhTw51lKENdNrEqT3,21,30,1,0,1,0,9,1,42,6.0,2,0.0,0,1,0,1,30,0,0,9,1,2,40,1
665,10035,FELnhQR0c7GZZX82ioYJEZsqujOrfyf7,A3fsA9Zfv1X2fVEQhTw51lKENdNrEqT3,10,4,2,0,1,25,12,1,45,6.428571428571429,4,0.0,0,2,0,1,4,25,0,12,1,3,42,1
666,10050,syrttArug8Mpzs9L0IHsvBtATawYF9J2,RXDvfPUBYFlVdlueBFbLW0mhhAyGEqpt,7,5,3,0,2,0,4,0,14,2.0,2,0.0,0,3,0,2,5,0,0,4,0,5,9,1
667,10059,UOOsauq1lFlLECbNF7MRjSfLxlpKxsoG,SpATywNh6bZuzm8s1ceuBUnMUAeoAHHw,29,26,15,20,10,2,22,2,97,13.857142857142858,8,0.0,7,15,19,10,19,2,1,22,2,51,46,0
668,10062,e0buQlxlHVWdQd03EOAehldJOI8AeFTm,SpATywNh6bZuzm8s1ceuBUnMUAeoAHHw,29,72,27,20,14,3,28,0,164,23.428571428571427,9,0.0,21,27,19,14,51,3,1,28,0,81,83,1
669,10077,Hm4CsH22c8YOwrQia0hrSt9jO8gMpoFd,SpATywNh6bZuzm8s1ceuBUnMUAeoAHHw,9,7,2,0,2,0,4,0,15,2.142857142857143,1,0.0,0,2,0,2,7,0,0,4,0,4,11,1
670,10101,30Velr3UVYghs85WZNOKXFcrgzOgBsfI,SpATywNh6bZuzm8s1ceuBUnMUAeoAHHw,30,23,13,26,7,75,15,0,159,22.714285714285715,5,0.0,6,13,25,7,17,75,1,15,0,51,108,0
671,10103,yS4oyG8z71VcMw1yy9w2LWRiDWgGhtKA,SpATywNh6bZuzm8s1ceuBUnMUAeoAHHw,16,31,16,18,7,1,7,0,80,11.428571428571429,4,0.0,5,16,15,7,26,1,3,7,0,43,37,0
672,10113,D1iAkJgGLDV90w339eOp4Bqd5z6wvBY6,G8EPVSXsOYB5YQWZGiz1aVq5Pgr2GrQu,26,25,13,41,7,0,6,1,93,13.285714285714286,1,0.0,8,13,34,7,17,0,7,6,1,62,31,1
673,10123,pAxOMca5gwJLembsUpWhZwow68Ox9dFB,SpATywNh6bZuzm8s1ceuBUnMUAeoAHHw,31,65,23,44,11,21,15,0,179,25.571428571428573,4,0.0,26,23,34,11,39,21,10,15,0,94,85,0
674,10132,ILMhPMpEir8VP8Uy0NQI7guQFniKAiGh,SpATywNh6bZuzm8s1ceuBUnMUAeoAHHw,31,66,23,12,10,5,25,2,143,20.428571428571427,10,0.0,20,23,12,10,46,5,0,25,2,65,78,0
675,10149,KG1VMsurgFKqkMv9nVqkO9ppjva59kYw,SpATywNh6bZuzm8s1ceuBUnMUAeoAHHw,10,22,11,0,2,4,13,1,53,7.571428571428571,3,0.0,3,11,0,2,19,4,0,13,1,16,37,0
676,10157,CUHsvexAAfaCEMKsM3644JTxXL5DgSss,SpATywNh6bZuzm8s1ceuBUnMUAeoAHHw,11,13,8,0,5,0,3,0,29,4.142857142857143,3,0.0,1,8,0,5,12,0,0,3,0,14,15,1
677,10173,ewZzdypyl0fDIzKshXnlZXjyO7oizoCq,SpATywNh6bZuzm8s1ceuBUnMUAeoAHHw,21,22,5,18,3,1,6,0,55,7.857142857142857,4,0.0,5,5,15,3,17,1,3,6,0,28,27,1
678,10183,rf43ZHojMqXQ775bmX3nnHgQ62d9XvGK,SpATywNh6bZuzm8s1ceuBUnMUAeoAHHw,28,53,25,25,7,3,12,0,125,17.857142857142858,9,0.0,12,25,23,7,41,3,2,12,0,67,58,1
679,10188,2rS9ufrltSIJVkQHjlKCjTvqcoR7anzz,A3fsA9Zfv1X2fVEQhTw51lKENdNrEqT3,47,68,11,68,4,0,16,0,167,23.857142857142858,6,0.0,7,11,56,4,61,0,12,16,0,78,89,1
680,10189,sY8CcZG79KJSl2UAc47IiYJD1k5ghqCN,SpATywNh6bZuzm8s1ceuBUnMUAeoAHHw,21,56,26,16,11,11,20,2,142,20.285714285714285,9,0.0,13,26,14,11,43,11,2,20,2,64,78,1
681,10197,tqvOTiQbipkIXQL7CIR5dckxV83rng9S,SpATywNh6bZuzm8s1ceuBUnMUAeoAHHw,25,44,24,15,13,17,18,1,132,18.857142857142858,6,0.0,8,24,13,13,36,17,2,18,1,58,74,0
682,10201,MB156dsmOWVhw7SmCPNYcmBUK9V54bIt,SpATywNh6bZuzm8s1ceuBUnMUAeoAHHw,23,89,8,9,7,1,24,4,142,20.285714285714285,5,0.0,9,8,9,7,80,1,0,24,4,33,109,1
683,10217,VWRhwnsbyy7kINpd5Pldlp01a86tVlAt,SpATywNh6bZuzm8s1ceuBUnMUAeoAHHw,32,177,62,39,21,9,41,6,355,50.714285714285715,7,0.0,56,62,31,21,121,9,8,41,6,170,185,0
684,10220,L4Uo99RvQ1cxFdSSaMag731dHicuHxV2,SpATywNh6bZuzm8s1ceuBUnMUAeoAHHw,23,51,2,55,0,11,28,7,154,22.0,5,0.0,15,2,41,0,36,11,14,28,7,58,96,0
685,10226,DHenWrxVzReZszxo1qw3Im0Zj99tiAII,bWdj2GDclj5ofokWjzoa5jAwMkxCykd6,17,31,19,0,14,22,22,5,113,16.142857142857142,6,0.0,2,19,0,14,29,22,0,22,5,35,78,1
686,10229,NF3XhJyO8NABn8EYOnk4mda6QMNEzq1R,SpATywNh6bZuzm8s1ceuBUnMUAeoAHHw,5,4,1,0,1,0,1,0,7,1.0,1,0.0,0,1,0,1,4,0,0,1,0,2,5,1
687,10239,tFhufiT6u4TsvucRy3FgIz40XsxZ2qh7,SpATywNh6bZuzm8s1ceuBUnMUAeoAHHw,7,4,3,0,3,0,4,0,14,2.0,1,0.0,0,3,0,3,4,0,0,4,0,6,8,1
688,10241,7kTdvih7UMOiFKC9aXRp88JppGP4qSKH,G8EPVSXsOYB5YQWZGiz1aVq5Pgr2GrQu,15,11,5,8,4,0,2,0,30,4.285714285714286,2,0.0,4,5,4,4,7,0,4,2,0,17,13,1
689,10243,YdCaKimqYb8kuFiHEtjPDsCbtIch1tfO,SpATywNh6bZuzm8s1ceuBUnMUAeoAHHw,20,37,15,27,3,0,8,0,90,12.857142857142858,4,0.0,15,15,21,3,22,0,6,8,0,54,36,0
690,10266,8Q42Hi4bJP7SqbH4XystURHk2B8tBI5i,G8EPVSXsOYB5YQWZGiz1aVq5Pgr2GrQu,52,43,27,98,21,0,8,0,197,28.142857142857142,7,0.0,0,27,83,21,43,0,15,8,0,131,66,0
691,10285,GIsRCDxWVYGm4So2chhYPzgj7oVxCsSB,SpATywNh6bZuzm8s1ceuBUnMUAeoAHHw,13,10,2,0,2,0,7,0,21,3.0,3,0.0,0,2,0,2,10,0,0,7,0,4,17,1
692,10321,njb10SfHXKB30cApzPJzWBcqA8VQx0HA,A3fsA9Zfv1X2fVEQhTw51lKENdNrEqT3,3,0,0,0,0,0,3,0,3,0.42857142857142855,1,0.0,0,0,0,0,0,0,0,3,0,0,3,1
693,10332,86utfBtmFqtE8TLsj2h1BusfBdMTH1O8,G8EPVSXsOYB5YQWZGiz1aVq5Pgr2GrQu,1,0,0,0,0,0,1,0,1,0.14285714285714285,1,0.0,0,0,0,0,0,0,0,1,0,0,1,1
694,10338,j2MboDReb1SoSFb2jmGT6OHiYADxn3PT,A3fsA9Zfv1X2fVEQhTw51lKENdNrEqT3,4,3,0,0,0,0,2,0,5,0.7142857142857143,1,0.0,0,0,0,0,3,0,0,2,0,0,5,1
695,10345,cRvonGDWMKfxHYP6TdkGqL61F16M4yAA,SpATywNh6bZuzm8s1ceuBUnMUAeoAHHw,23,45,11,23,8,7,10,1,105,15.0,4,0.0,16,11,18,8,29,7,5,10,1,53,52,1
696,10350,VPNixAQG356EF5jDEqbiZrQi2WBUwBq3,bWdj2GDclj5ofokWjzoa5jAwMkxCykd6,1,0,0,0,0,0,1,0,1,0.14285714285714285,1,0.0,0,0,0,0,0,0,0,1,0,0,1,1
697,10366,c4eku5xKmsJEaRwRx0NUj58EVKBhTUlh,bWdj2GDclj5ofokWjzoa5jAwMkxCykd6,1,0,0,0,0,0,1,0,1,0.14285714285714285,1,0.0,0,0,0,0,0,0,0,1,0,0,1,1
698,10385,4SjsVB9NX97jh5FCSnOdHgEUANJ1svZm,SpATywNh6bZuzm8s1ceuBUnMUAeoAHHw,24,22,13,13,7,0,13,1,69,9.857142857142858,3,0.0,6,13,11,7,16,0,2,13,1,37,32,0
699,10387,MicTROP14z0YujgzSBBjIifCsW8T6Yg4,RXDvfPUBYFlVdlueBFbLW0mhhAyGEqpt,6,0,0,0,0,1,6,1,8,1.1428571428571428,1,0.0,0,0,0,0,0,1,0,6,1,0,8,1
700,10394,EF3EfvSrA0c1KnpZ3bhY87a1rscondwY,SpATywNh6bZuzm8s1ceuBUnMUAeoAHHw,29,56,27,43,11,0,18,0,155,22.142857142857142,5,0.0,17,27,36,11,39,0,7,18,0,91,64,0
701,10399,D2M0lUAbb3NbvYyEfkDkoqJ8mQHTb4db,G8EPVSXsOYB5YQWZGiz1aVq5Pgr2GrQu,58,67,27,102,16,14,9,1,236,33.714285714285715,3,0.0,34,27,77,16,33,14,25,9,1,154,82,0
702,10402,CQOn4KWCA0duDCOSP1DQzvXZ3yAfq1zW,RXDvfPUBYFlVdlueBFbLW0mhhAyGEqpt,74,109,71,223,32,143,38,17,633,90.42857142857143,10,0.0,17,71,201,32,92,143,22,38,17,321,312,0
703,10420,Eu9HoDt3WhECHgcXaERosbI6lMj7Hipb,bWdj2GDclj5ofokWjzoa5jAwMkxCykd6,23,79,39,44,25,20,22,1,230,32.857142857142854,5,0.0,22,39,36,25,57,20,8,22,1,122,108,0
704,10437,N0P6Yrg1zRuUPyVufFpM0ZExnJnGTKKG,SpATywNh6bZuzm8s1ceuBUnMUAeoAHHw,23,34,2,31,0,1,15,1,84,12.0,5,0.0,8,2,26,0,26,1,5,15,1,36,48,0
705,10445,wXYPFlL861BbeAt6BcFbVApC7BUFADjk,A3fsA9Zfv1X2fVEQhTw51lKENdNrEqT3,8,16,1,0,1,0,3,0,21,3.0,2,0.0,0,1,0,1,16,0,0,3,0,2,19,1
706,10451,JLVzu9EMywyHTSJk37J5rGpw1UsulAZc,SpATywNh6bZuzm8s1ceuBUnMUAeoAHHw,15,68,24,0,10,1,22,3,128,18.285714285714285,2,0.0,10,24,0,10,58,1,0,22,3,44,84,1
707,10454,6tpE26inQQeNPyhZ0HoRMm7l4NlMiWJC,SpATywNh6bZuzm8s1ceuBUnMUAeoAHHw,21,46,3,37,1,13,33,5,138,19.714285714285715,6,0.0,16,3,34,1,30,13,3,33,5,54,84,0
708,10463,uhU9XFMHqXe19d0SBpTzsSNqTtdSMXBT,SpATywNh6bZuzm8s1ceuBUnMUAeoAHHw,24,54,27,16,8,33,20,1,159,22.714285714285715,6,0.0,21,27,15,8,33,33,1,20,1,71,88,1
709,10471,l7T8dOWG1cEtOxAxVcD5zNV6vn1g4oYM,G8EPVSXsOYB5YQWZGiz1aVq5Pgr2GrQu,27,54,4,66,2,7,21,0,154,22.0,11,0.0,14,4,59,2,40,7,7,21,0,79,75,1
710,10475,haRKCROopZUqu2HvR7rfja2IzweZ0l2Z,G8EPVSXsOYB5YQWZGiz1aVq5Pgr2GrQu,1,0,0,0,0,0,1,0,1,0.14285714285714285,1,0.0,0,0,0,0,0,0,0,1,0,0,1,1
711,10483,TroWrp5S8FhNJSgSuQ7Yk9WR8zsmBapA,SpATywNh6bZuzm8s1ceuBUnMUAeoAHHw,6,3,2,0,1,0,2,0,8,1.1428571428571428,1,0.0,0,2,0,1,3,0,0,2,0,3,5,1
712,10491,egnijdxL4Cz1CfzoCQSNIgWry6KIzA7P,SpATywNh6bZuzm8s1ceuBUnMUAeoAHHw,15,25,7,16,3,0,6,0,57,8.142857142857142,6,0.0,2,7,13,3,23,0,3,6,0,25,32,0
713,10505,L5cqiD5dkEVfnPDeQYK5cFR9ssDpnyPm,SpATywNh6bZuzm8s1ceuBUnMUAeoAHHw,2,0,0,0,0,0,2,0,2,0.2857142857142857,1,0.0,0,0,0,0,0,0,0,2,0,0,2,1
714,10507,rf43ZHojMqXQ775bmX3nnHgQ62d9XvGK,bWdj2GDclj5ofokWjzoa5jAwMkxCykd6,14,33,16,4,2,2,14,0,71,10.142857142857142,7,0.0,2,16,4,2,31,2,0,14,0,24,47,0
715,10519,lnzFfoDYtlWPJMTPbihufULiQk1Jv9SB,bWdj2GDclj5ofokWjzoa5jAwMkxCykd6,7,7,1,0,1,0,3,0,12,1.7142857142857142,1,0.0,0,1,0,1,7,0,0,3,0,2,10,1
716,10525,w8NGfLpAxSvlcPdxr1N6ClRtnCD7UkJu,A3fsA9Zfv1X2fVEQhTw51lKENdNrEqT3,34,15,4,82,2,4,14,1,122,17.428571428571427,4,0.0,1,4,70,2,14,4,12,14,1,77,45,0
717,10537,4zppanuK6US9rtvd04IL60AQkgDx5lm5,RXDvfPUBYFlVdlueBFbLW0mhhAyGEqpt,22,47,1,0,0,3,7,0,58,8.285714285714286,2,0.0,0,1,0,0,47,3,0,7,0,1,57,1
718,10538,xhM6sGbifURQLX65jKTsRiTJp9ePqM2R,RXDvfPUBYFlVdlueBFbLW0mhhAyGEqpt,1,0,0,0,0,0,1,0,1,0.14285714285714285,1,0.0,0,0,0,0,0,0,0,1,0,0,1,1
719,10560,m4jrmeR3FtkOUCbFelK4w5ennRkxlxWD,A3fsA9Zfv1X2fVEQhTw51lKENdNrEqT3,26,37,23,24,16,0,7,0,107,15.285714285714286,4,0.0,1,23,19,16,36,0,5,7,0,59,48,0
720,10563,IQCtPVNPylpjpNjZtQrr88vV5qPansN0,SpATywNh6bZuzm8s1ceuBUnMUAeoAHHw,28,26,17,16,7,3,4,0,73,10.428571428571429,3,0.0,5,17,16,7,21,3,0,4,0,45,28,0
721,10569,54BZa2PEVowNqI6EO6NzeCnkR49ry3oS,SpATywNh6bZuzm8s1ceuBUnMUAeoAHHw,22,47,1,32,1,37,19,1,138,19.714285714285715,8,0.0,6,1,24,1,41,37,8,19,1,32,106,0
722,10574,NFgPnsok64XIrx8pioLRAIHoliaoDIvn,SpATywNh6bZuzm8s1ceuBUnMUAeoAHHw,17,58,11,28,0,8,17,0,122,17.428571428571427,5,0.0,22,11,25,0,36,8,3,17,0,58,64,0
723,10579,QoRl6lUIBIR1pRLScf6eg36kOBc6a9q5,SpATywNh6bZuzm8s1ceuBUnMUAeoAHHw,2,0,0,0,0,0,4,0,4,0.5714285714285714,1,0.0,0,0,0,0,0,0,0,4,0,0,4,1
724,10607,ySOA4rbQpe1GOPfJP5VkUnJIGjlF7GXO,SpATywNh6bZuzm8s1ceuBUnMUAeoAHHw,23,41,0,30,0,4,15,4,94,13.428571428571429,4,0.0,18,0,26,0,23,4,4,15,4,44,50,1
725,10612,BTSZE2PXdA7MkOyBKPCnqqHRa0lxJtHO,SpATywNh6bZuzm8s1ceuBUnMUAeoAHHw,23,65,2,49,1,0,12,0,129,18.428571428571427,9,0.0,22,2,42,1,43,0,7,12,0,67,62,0
726,10627,80aCDppJ7kPmOrquzLdsI5OBB47H5IdW,G8EPVSXsOYB5YQWZGiz1aVq5Pgr2GrQu,2,0,0,0,0,0,2,0,2,0.2857142857142857,1,0.0,0,0,0,0,0,0,0,2,0,0,2,1
727,10629,okYlHVritwXcHhkiNLd9pfhBZv2uubiO,SpATywNh6bZuzm8s1ceuBUnMUAeoAHHw,27,22,12,33,9,1,5,0,82,11.714285714285714,3,0.0,7,12,29,9,15,1,4,5,0,57,25,1
728,10641,Q5TmTVdy8nnH2vTL73s67ZseaCMO3k91,SpATywNh6bZuzm8s1ceuBUnMUAeoAHHw,22,16,13,12,7,0,12,0,60,8.571428571428571,5,0.0,2,13,12,7,14,0,0,12,0,34,26,0
729,10652,teqJGecOr4a6oVYU1O9bgvPkX5ZSKA8N,SpATywNh6bZuzm8s1ceuBUnMUAeoAHHw,16,16,10,0,6,0,5,0,37,5.285714285714286,3,0.0,0,10,0,6,16,0,0,5,0,16,21,0
730,10653,7xJbwgQFzeH69YJLbZncWAGT3dRrKubC,bWdj2GDclj5ofokWjzoa5jAwMkxCykd6,51,117,59,235,32,10,45,4,502,71.71428571428571,4,0.0,35,59,211,32,82,10,24,45,4,337,165,0
731,10659,DLCsXj6afYeXedkEor8cSwWpPMWMukEN,A3fsA9Zfv1X2fVEQhTw51lKENdNrEqT3,2,0,0,0,0,0,2,0,2,0.2857142857142857,1,0.0,0,0,0,0,0,0,0,2,0,0,2,1
732,10687,CXT3urKvwCIfBmuQmODRcZXAAAJs07Dk,RXDvfPUBYFlVdlueBFbLW0mhhAyGEqpt,1,0,0,0,0,0,1,0,1,0.14285714285714285,1,0.0,0,0,0,0,0,0,0,1,0,0,1,1
733,10705,CeupRRMHE9iQJGvyrBKaDsPPM9lhEl5t,SpATywNh6bZuzm8s1ceuBUnMUAeoAHHw,28,36,14,24,5,13,16,0,108,15.428571428571429,7,0.0,6,14,19,5,30,13,5,16,0,44,64,0
734,10721,trG5MFuNMIgyTGz1X8WvOUa7Zgqkp3Oe,SpATywNh6bZuzm8s1ceuBUnMUAeoAHHw,17,18,7,18,3,3,7,2,58,8.285714285714286,1,0.0,9,7,15,3,9,3,3,7,2,34,24,1
735,10738,uyomj5PLSD8MuBnIm3UXNOM2zJB1f3kv,bWdj2GDclj5ofokWjzoa5jAwMkxCykd6,21,61,12,52,6,23,16,0,170,24.285714285714285,4,0.0,17,12,43,6,44,23,9,16,0,78,92,1
736,10766,puC0Dx9PufKMVxVv15STTWR0hwd8EG3K,A3fsA9Zfv1X2fVEQhTw51lKENdNrEqT3,6,3,2,0,1,0,2,0,8,1.1428571428571428,1,0.0,0,2,0,1,3,0,0,2,0,3,5,1
737,10804,kGzsRVbG5WMbWj0lYrhayqrDZ1knQphM,SpATywNh6bZuzm8s1ceuBUnMUAeoAHHw,1,0,0,0,0,0,1,0,1,0.14285714285714285,1,0.0,0,0,0,0,0,0,0,1,0,0,1,1
738,10808,8dXlYKMlojZ10oWsfo0feSv9eUr2FQcM,G8EPVSXsOYB5YQWZGiz1aVq5Pgr2GrQu,5,2,1,0,1,0,2,0,6,0.8571428571428571,1,0.0,0,1,0,1,2,0,0,2,0,2,4,1
739,10809,gzv7fk7jLAAb6tXwbmA5ceisqqnvcETz,SpATywNh6bZuzm8s1ceuBUnMUAeoAHHw,13,12,8,0,3,3,11,1,38,5.428571428571429,3,0.0,0,8,0,3,12,3,0,11,1,11,27,0
740,10819,v21GnAmoo56SIXGBSOh9jDiYo8T7Od29,SpATywNh6bZuzm8s1ceuBUnMUAeoAHHw,23,48,7,10,3,0,8,0,76,10.857142857142858,6,0.0,18,7,10,3,30,0,0,8,0,38,38,0
741,10822,xYLJB56SVkFUOdT5vN3Qq6OYNlnP0Fjc,RXDvfPUBYFlVdlueBFbLW0mhhAyGEqpt,34,106,45,26,22,8,33,7,247,35.285714285714285,8,0.0,0,45,22,22,106,8,4,33,7,89,158,0
742,10823,aGY42WVQQtCQKQRks3knIxGWrLxCy60h,G8EPVSXsOYB5YQWZGiz1aVq5Pgr2GrQu,10,4,0,0,0,3,7,1,15,2.142857142857143,1,0.0,0,0,0,0,4,3,0,7,1,0,15,1
743,10835,kGzsRVbG5WMbWj0lYrhayqrDZ1knQphM,bWdj2GDclj5ofokWjzoa5jAwMkxCykd6,1,0,0,0,0,0,1,0,1,0.14285714285714285,1,0.0,0,0,0,0,0,0,0,1,0,0,1,1
744,10853,2uZ2ZHQBnnVrb5vAtTu1AloVYtZL1MXg,G8EPVSXsOYB5YQWZGiz1aVq5Pgr2GrQu,131,429,138,245,49,36,79,11,987,141.0,15,0.0,86,138,185,49,343,36,60,79,11,458,529,0
745,10869,fuprfcX49r5QcUYvMQnvvzEf76cx4sRp,bWdj2GDclj5ofokWjzoa5jAwMkxCykd6,9,12,1,6,1,1,6,4,31,4.428571428571429,2,0.0,5,1,5,1,7,1,1,6,4,12,19,1
746,10876,4vKI2gaXrHATS50fqVyDxXcmRy0MrgJS,A3fsA9Zfv1X2fVEQhTw51lKENdNrEqT3,34,62,42,2,29,8,20,3,166,23.714285714285715,4,0.0,12,42,2,29,50,8,0,20,3,85,81,1
747,10891,L5fA3BAe6FOUhd5mq4cXOYYHxtSuGgKM,SpATywNh6bZuzm8s1ceuBUnMUAeoAHHw,32,82,37,25,15,19,28,2,208,29.714285714285715,7,0.0,33,37,23,15,49,19,2,28,2,108,100,0
748,10917,Bf9it9d08iLIslwAMDaZjQzh1Kdl2qhf,SpATywNh6bZuzm8s1ceuBUnMUAeoAHHw,4,2,0,0,0,0,3,0,5,0.7142857142857143,2,0.0,0,0,0,0,2,0,0,3,0,0,5,0
749,10922,Bf9it9d08iLIslwAMDaZjQzh1Kdl2qhf,A3fsA9Zfv1X2fVEQhTw51lKENdNrEqT3,5,3,0,0,0,0,2,0,5,0.7142857142857143,1,0.0,0,0,0,0,3,0,0,2,0,0,5,0
750,10952,nKH0niV76APk64AIPNglQ4nJBpaxE108,SpATywNh6bZuzm8s1ceuBUnMUAeoAHHw,19,40,2,19,1,12,15,1,90,12.857142857142858,2,0.0,9,2,16,1,31,12,3,15,1,28,62,0
751,10955,rieeUlMbLxJ13UbEQlJjvhM4prlyBS6B,SpATywNh6bZuzm8s1ceuBUnMUAeoAHHw,30,35,15,35,7,92,21,5,210,30.0,8,0.0,7,15,31,7,28,92,4,21,5,60,150,0
752,10990,xxd1UUpRh1yQGgGLMyjshPknKZCNEYlg,A3fsA9Zfv1X2fVEQhTw51lKENdNrEqT3,81,89,45,126,23,5,24,0,312,44.57142857142857,11,0.0,6,45,105,23,83,5,21,24,0,179,133,0
753,10998,h5xiKkT5i4jRXd69Uq7dCU9wazCqxrHf,bWdj2GDclj5ofokWjzoa5jAwMkxCykd6,2,0,0,0,0,0,2,0,2,0.2857142857142857,1,0.0,0,0,0,0,0,0,0,2,0,0,2,1
754,11001,4vKI2gaXrHATS50fqVyDxXcmRy0MrgJS,bWdj2GDclj5ofokWjzoa5jAwMkxCykd6,21,69,41,26,17,45,27,1,226,32.285714285714285,8,0.0,6,41,24,17,63,45,2,27,1,88,138,0
755,11008,nKH0niV76APk64AIPNglQ4nJBpaxE108,A3fsA9Zfv1X2fVEQhTw51lKENdNrEqT3,1,0,0,0,0,0,1,0,1,0.14285714285714285,1,0.0,0,0,0,0,0,0,0,1,0,0,1,1
756,11023,T1BAt2dEt9EzWcybuzXyLq6mHbiEQWZt,G8EPVSXsOYB5YQWZGiz1aVq5Pgr2GrQu,6,3,2,0,2,0,1,0,8,1.1428571428571428,1,0.0,0,2,0,2,3,0,0,1,0,4,4,1
757,11029,1PM9jc7cZ3C091LId9Ek5VaVwRreQ0TH,A3fsA9Zfv1X2fVEQhTw51lKENdNrEqT3,5,3,1,0,1,0,2,0,7,1.0,1,0.0,0,1,0,1,3,0,0,2,0,2,5,1
758,11036,0kTYCEXFiuNuYfSpCOb8HIL3aF9nkrGc,SpATywNh6bZuzm8s1ceuBUnMUAeoAHHw,29,33,13,21,7,12,14,1,101,14.428571428571429,5,0.0,17,13,19,7,16,12,2,14,1,56,45,0
759,11052,T1BAt2dEt9EzWcybuzXyLq6mHbiEQWZt,SpATywNh6bZuzm8s1ceuBUnMUAeoAHHw,4,2,1,0,1,0,2,0,6,0.8571428571428571,1,0.0,0,1,0,1,2,0,0,2,0,2,4,1
760,11068,E6SywimuBT6ZGpGjcedDyV1LTcQRc9ds,A3fsA9Zfv1X2fVEQhTw51lKENdNrEqT3,47,31,24,90,15,24,21,2,207,29.571428571428573,4,0.0,2,24,75,15,29,24,15,21,2,116,91,1
761,11087,vrHzQ6JF32OpLCmbxoOSorIkJkRXwSrS,SpATywNh6bZuzm8s1ceuBUnMUAeoAHHw,5,7,2,0,1,0,3,0,13,1.8571428571428572,2,0.0,0,2,0,1,7,0,0,3,0,3,10,1
762,11092,WFURYJe5F7dgP6i0YwgNFeyKSFpNu7xS,A3fsA9Zfv1X2fVEQhTw51lKENdNrEqT3,17,17,9,0,7,0,4,0,37,5.285714285714286,2,0.0,0,9,0,7,17,0,0,4,0,16,21,1
763,11103,hGRsAtrDXcgCObVXPjFeCVGCoNSaOPeW,SpATywNh6bZuzm8s1ceuBUnMUAeoAHHw,5,3,2,0,1,0,2,0,8,1.1428571428571428,1,0.0,0,2,0,1,3,0,0,2,0,3,5,1
764,11104,hGRsAtrDXcgCObVXPjFeCVGCoNSaOPeW,G8EPVSXsOYB5YQWZGiz1aVq5Pgr2GrQu,4,2,1,0,1,0,1,0,5,0.7142857142857143,1,0.0,0,1,0,1,2,0,0,1,0,2,3,1
765,11113,tDwPtwMZBHQrqhm9RKWd7GW4j1pmFbeZ,A3fsA9Zfv1X2fVEQhTw51lKENdNrEqT3,2,0,0,0,0,0,6,0,6,0.8571428571428571,2,0.0,0,0,0,0,0,0,0,6,0,0,6,1
766,11136,iVrbldNmEASAlMSnUTWFx7qcEdScVNde,SpATywNh6bZuzm8s1ceuBUnMUAeoAHHw,15,33,20,0,13,0,8,0,74,10.571428571428571,5,0.0,0,20,0,13,33,0,0,8,0,33,41,1
767,11143,P9MGcZfmosEjD4PEwCVp6vB9MzPbeKLI,G8EPVSXsOYB5YQWZGiz1aVq5Pgr2GrQu,1,0,0,0,0,0,1,0,1,0.14285714285714285,1,0.0,0,0,0,0,0,0,0,1,0,0,1,1
768,11146,e2vebmlDc23PpKpfRYyd1By1iCXcv3UO,RXDvfPUBYFlVdlueBFbLW0mhhAyGEqpt,42,32,0,58,0,0,3,0,93,13.285714285714286,3,0.0,9,0,56,0,23,0,2,3,0,65,28,1
769,11163,arCKlRkqmCQRumxhAEQROrAdYVJBCNWo,SpATywNh6bZuzm8s1ceuBUnMUAeoAHHw,11,13,8,0,3,0,5,0,29,4.142857142857143,3,0.0,0,8,0,3,13,0,0,5,0,11,18,0
770,11165,xebgVIBazn8SEoqG6RUzBHRE4EbzaN4t,A3fsA9Zfv1X2fVEQhTw51lKENdNrEqT3,8,2,1,0,1,1,8,1,14,2.0,1,0.0,0,1,0,1,2,1,0,8,1,2,12,1
771,11179,gryVUwWLvrsNv4F8O3kiEBAQILnJg7OT,SpATywNh6bZuzm8s1ceuBUnMUAeoAHHw,20,38,0,24,0,38,24,4,128,18.285714285714285,7,0.0,16,0,23,0,22,38,1,24,4,39,89,0
772,11198,HbdIEiZ1jslj2pBp8czn7lhBbxLYjtpj,SpATywNh6bZuzm8s1ceuBUnMUAeoAHHw,7,14,6,0,2,0,3,0,25,3.5714285714285716,3,0.0,2,6,0,2,12,0,0,3,0,10,15,1
773,11225,Vmvdv9k8S1ONPkUHSdXPEenyx7UNVISW,SpATywNh6bZuzm8s1ceuBUnMUAeoAHHw,15,31,1,12,0,20,12,3,79,11.285714285714286,3,0.0,10,1,9,0,21,20,3,12,3,20,59,1
774,11290,JZZnn79hJZh6uernNE50Bi5HDewJf78E,RXDvfPUBYFlVdlueBFbLW0mhhAyGEqpt,15,14,5,0,2,8,3,0,32,4.571428571428571,1,0.0,0,5,0,2,14,8,0,3,0,7,25,1
775,11303,gnjZOoI8BeitDTrO8bhWhoFLWjid4LeA,bWdj2GDclj5ofokWjzoa5jAwMkxCykd6,7,9,4,0,0,0,5,0,18,2.5714285714285716,1,0.0,2,4,0,0,7,0,0,5,0,6,12,1
776,11306,5ZQSBzYZG0AalCCLt1PNSHaXvEDYOMak,SpATywNh6bZuzm8s1ceuBUnMUAeoAHHw,1,0,0,0,0,0,2,0,2,0.2857142857142857,1,0.0,0,0,0,0,0,0,0,2,0,0,2,1
777,11314,o7HGnjuXHyEfteJtxVQ5dpBJz7Yzz0T1,SpATywNh6bZuzm8s1ceuBUnMUAeoAHHw,7,3,0,0,0,2,4,0,9,1.2857142857142858,1,0.0,0,0,0,0,3,2,0,4,0,0,9,1
778,11326,IFQQStJmvfA3NyTN88jNEn631VKsGQET,SpATywNh6bZuzm8s1ceuBUnMUAeoAHHw,7,2,1,0,1,1,4,0,9,1.2857142857142858,1,0.0,0,1,0,1,2,1,0,4,0,2,7,1
779,11331,eqaDSMjkkLr4V8zwKAYzNF193Wm3l9Pg,A3fsA9Zfv1X2fVEQhTw51lKENdNrEqT3,1,0,0,0,0,0,1,0,1,0.14285714285714285,1,0.0,0,0,0,0,0,0,0,1,0,0,1,1
780,11344,SHXTFVyrdbzmF1pJEIvr2zpR8jK358bb,SpATywNh6bZuzm8s1ceuBUnMUAeoAHHw,22,46,3,28,1,25,9,1,113,16.142857142857142,5,0.0,11,3,24,1,35,25,4,9,1,39,74,1
781,11355,Z5t6AGEyADeSVHWZTgBW4lR5XMnM5VWU,SpATywNh6bZuzm8s1ceuBUnMUAeoAHHw,29,43,15,12,10,0,6,0,86,12.285714285714286,4,0.0,13,15,12,10,30,0,0,6,0,50,36,0
782,11356,KXkOWXgIJuvmtvaUVHrKWAaqrFaY5cx8,SpATywNh6bZuzm8s1ceuBUnMUAeoAHHw,11,18,0,22,0,3,7,3,53,7.571428571428571,3,0.0,13,0,18,0,5,3,4,7,3,31,22,1
783,11357,WJKEaeH3ob9wscd3i5dXEY7kRPHMEwVj,bWdj2GDclj5ofokWjzoa5jAwMkxCykd6,5,3,1,0,1,0,2,0,7,1.0,2,0.0,0,1,0,1,3,0,0,2,0,2,5,1
784,11362,13fzVwLJSsgGzTLwjEHCuvf0Ks8dgxYZ,SpATywNh6bZuzm8s1ceuBUnMUAeoAHHw,28,49,13,24,5,12,42,7,152,21.714285714285715,8,0.0,12,13,20,5,37,12,4,42,7,50,102,1
785,11389,PqLnOjm8gCkS4EhgcnGtGCfdwzyBuNjz,A3fsA9Zfv1X2fVEQhTw51lKENdNrEqT3,10,3,2,0,2,0,8,2,17,2.4285714285714284,1,0.0,0,2,0,2,3,0,0,8,2,4,13,1
786,11403,HYCkyEJhW9QtzilmanJKsxRLSBi9UGoV,A3fsA9Zfv1X2fVEQhTw51lKENdNrEqT3,1,0,0,0,0,0,1,0,1,0.14285714285714285,1,0.0,0,0,0,0,0,0,0,1,0,0,1,1
787,11410,YEYkPWHcftKd8bKe1Q9b21lzhv1SChRM,SpATywNh6bZuzm8s1ceuBUnMUAeoAHHw,31,35,20,21,8,6,17,2,109,15.571428571428571,5,0.0,7,20,21,8,28,6,0,17,2,56,53,1
788,11414,HYCkyEJhW9QtzilmanJKsxRLSBi9UGoV,bWdj2GDclj5ofokWjzoa5jAwMkxCykd6,2,0,0,0,0,0,2,0,2,0.2857142857142857,1,0.0,0,0,0,0,0,0,0,2,0,0,2,1
789,11425,82UlWF6Fm1gkNum7nNbVw0yOV1BUdNoS,bWdj2GDclj5ofokWjzoa5jAwMkxCykd6,25,25,16,46,4,47,15,1,154,22.0,7,0.0,1,16,39,4,24,47,7,15,1,60,94,0
790,11428,82UlWF6Fm1gkNum7nNbVw0yOV1BUdNoS,A3fsA9Zfv1X2fVEQhTw51lKENdNrEqT3,58,82,50,118,21,68,39,6,384,54.857142857142854,13,0.0,11,50,90,21,71,68,28,39,6,172,212,0
791,11463,uFcd6yCTniScAvbMiWJYRQ8Du52ubELm,RXDvfPUBYFlVdlueBFbLW0mhhAyGEqpt,31,45,8,18,5,6,8,0,90,12.857142857142858,6,0.0,0,8,17,5,45,6,1,8,0,30,60,0
792,11475,UJiJ4PvH4qodyDnURbFXyi5LWwaSKUwb,RXDvfPUBYFlVdlueBFbLW0mhhAyGEqpt,74,91,47,172,20,95,51,6,482,68.85714285714286,10,0.0,16,47,163,20,75,95,9,51,6,246,236,0
793,11478,RGf4k3THi4AV4qsAjc1UEOWiIeDYcchf,A3fsA9Zfv1X2fVEQhTw51lKENdNrEqT3,62,88,52,128,21,20,22,0,331,47.285714285714285,10,0.0,10,52,105,21,78,20,23,22,0,188,143,0
794,11492,zKdMAgWBKjA8jF1t74QW0q0ZxGMcvW9t,RXDvfPUBYFlVdlueBFbLW0mhhAyGEqpt,42,25,15,56,11,2,9,0,118,16.857142857142858,2,0.0,6,15,55,11,19,2,1,9,0,87,31,1
795,11509,sQVxVjeT9NfPAT9IdDUsY0RSB3XrvO2y,SpATywNh6bZuzm8s1ceuBUnMUAeoAHHw,25,66,32,45,0,29,24,1,197,28.142857142857142,6,0.0,25,32,36,0,41,29,9,24,1,93,104,0
796,11515,iIwpETh60BkJfJQJqvWucH2tzh64j0U3,SpATywNh6bZuzm8s1ceuBUnMUAeoAHHw,27,86,34,34,7,4,29,3,197,28.142857142857142,9,0.0,16,34,31,7,70,4,3,29,3,88,109,0
797,11522,MOJ1BiwMK7lBUiFS9DTwwPvbUWIkdFFP,A3fsA9Zfv1X2fVEQhTw51lKENdNrEqT3,35,87,52,22,29,0,15,0,205,29.285714285714285,16,0.0,2,52,21,29,85,0,1,15,0,104,101,1
798,11547,NKnL5oTIIxOmPf0Ep5iKaKIecNheR2t7,SpATywNh6bZuzm8s1ceuBUnMUAeoAHHw,27,73,41,16,19,0,11,0,160,22.857142857142858,5,0.0,19,41,16,19,54,0,0,11,0,95,65,0
799,11555,7OkCZWJW1Ow4wpTBUq53amL13pV2vy2v,G8EPVSXsOYB5YQWZGiz1aVq5Pgr2GrQu,32,89,25,48,19,13,39,0,233,33.285714285714285,10,0.0,8,25,40,19,81,13,8,39,0,92,141,0
800,11618,FftGEmgyFF5pWtfM0EZJwp0rzcGMH1JL,SpATywNh6bZuzm8s1ceuBUnMUAeoAHHw,31,74,44,28,17,4,42,10,219,31.285714285714285,5,0.0,9,44,25,17,65,4,3,42,10,95,124,1
801,11636,Y3uwxWCm13Ol5xozrT2GPjOPhBlC2kOq,RXDvfPUBYFlVdlueBFbLW0mhhAyGEqpt,14,22,2,35,0,0,3,0,62,8.857142857142858,3,0.0,0,2,32,0,22,0,3,3,0,34,28,1
802,11646,MR4k3wv95Ttq1fQaT9W4WgxrPezl0N4j,G8EPVSXsOYB5YQWZGiz1aVq5Pgr2GrQu,11,15,5,16,2,0,3,0,41,5.857142857142857,1,0.0,2,5,12,2,13,0,4,3,0,21,20,1
803,11647,KAHcIFqF1cp4MJN69oD7XlQBuGCiexCt,bWdj2GDclj5ofokWjzoa5jAwMkxCykd6,2,0,0,0,0,0,2,0,2,0.2857142857142857,1,0.0,0,0,0,0,0,0,0,2,0,0,2,1
804,11677,FduexGuoL0tC7LqIuSFtIm03lXvHHbSw,SpATywNh6bZuzm8s1ceuBUnMUAeoAHHw,11,37,2,0,1,4,32,4,80,11.428571428571429,5,0.0,0,2,0,1,37,4,0,32,4,3,77,1
805,11690,37daqGAbA6x2VvXkiqdWX1nBv2Tqqgte,G8EPVSXsOYB5YQWZGiz1aVq5Pgr2GrQu,71,298,137,168,35,75,73,2,788,112.57142857142857,11,0.0,51,137,139,35,247,75,29,73,2,362,426,0
806,11741,n3cFXGx3rjoPJPOmeF5tlnmkFmFFJI7p,A3fsA9Zfv1X2fVEQhTw51lKENdNrEqT3,50,49,28,72,10,24,32,2,217,31.0,8,0.0,4,28,54,10,45,24,18,32,2,96,121,1
807,11758,7UZLQknm2A0Xcs9lZDmhCq5ocQIOEmmj,SpATywNh6bZuzm8s1ceuBUnMUAeoAHHw,26,25,11,16,6,0,11,1,70,10.0,2,0.0,10,11,14,6,15,0,2,11,1,41,29,1
808,11811,YRnTGuoAQA7UM3uV59YNXUYN4n1CR9jv,SpATywNh6bZuzm8s1ceuBUnMUAeoAHHw,27,26,14,16,7,1,9,0,73,10.428571428571429,7,0.0,7,14,14,7,19,1,2,9,0,42,31,0
809,11827,McYATdhZDDMDpni6a4GbjI06ustMpvdV,G8EPVSXsOYB5YQWZGiz1aVq5Pgr2GrQu,7,3,2,0,2,4,3,0,14,2.0,2,0.0,0,2,0,2,3,4,0,3,0,4,10,1
810,11836,zm7kTPWc2Ij7nyP9Co8cVtDEuAGTQRmn,A3fsA9Zfv1X2fVEQhTw51lKENdNrEqT3,5,3,1,0,1,0,2,0,7,1.0,1,0.0,0,1,0,1,3,0,0,2,0,2,5,1
811,11839,McYATdhZDDMDpni6a4GbjI06ustMpvdV,A3fsA9Zfv1X2fVEQhTw51lKENdNrEqT3,10,8,6,0,5,6,2,0,27,3.857142857142857,2,0.0,0,6,0,5,8,6,0,2,0,11,16,1
812,11841,4GMbKnTV7f2uA3paM09GNAdyVnypDTbs,A3fsA9Zfv1X2fVEQhTw51lKENdNrEqT3,58,35,5,110,2,0,15,0,167,23.857142857142858,6,0.0,6,5,104,2,29,0,6,15,0,117,50,0
813,11842,MFEX8ieEZqjvGSzLHf4hJjdY1BCifo1Q,G8EPVSXsOYB5YQWZGiz1aVq5Pgr2GrQu,9,5,2,4,2,0,3,0,16,2.2857142857142856,1,0.0,1,2,3,2,4,0,1,3,0,8,8,1
814,11862,n42jeLyeDpoJPwT1pkhXRyhzHjUnC2KC,SpATywNh6bZuzm8s1ceuBUnMUAeoAHHw,26,51,16,12,4,2,21,5,111,15.857142857142858,8,0.0,12,16,9,4,39,2,3,21,5,41,70,1
815,11867,2axjl9Byq908rUlMrYGzo2sfhA3p18fU,SpATywNh6bZuzm8s1ceuBUnMUAeoAHHw,11,6,4,1,3,0,2,0,16,2.2857142857142856,1,0.0,1,4,1,3,5,0,0,2,0,9,7,1
816,11892,QkpDyGn4qqqwpxvXRrFsAsKSrEtfkQJQ,SpATywNh6bZuzm8s1ceuBUnMUAeoAHHw,28,29,16,24,8,4,6,0,87,12.428571428571429,4,0.0,8,16,23,8,21,4,1,6,0,55,32,0
817,11895,Er0phLmicWoU9yr3sUBC2BCne0YIK1vQ,A3fsA9Zfv1X2fVEQhTw51lKENdNrEqT3,39,37,22,34,15,0,25,0,133,19.0,7,0.0,0,22,29,15,37,0,5,25,0,66,67,1
818,11896,UzuB1gScsXJ6b46FForXq5x2wnZw4QoH,SpATywNh6bZuzm8s1ceuBUnMUAeoAHHw,31,61,30,26,17,6,21,2,163,23.285714285714285,4,0.0,14,30,24,17,47,6,2,21,2,85,78,0
819,11900,8xT75XL9dKm7CwLmOxtys3bmWBh3OJmY,RXDvfPUBYFlVdlueBFbLW0mhhAyGEqpt,58,79,4,35,2,0,7,0,127,18.142857142857142,4,0.0,25,4,35,2,54,0,0,7,0,66,61,0
820,11914,5YO2NGkR6BZ1s4HfeOrLezgFkpBKmNPV,SpATywNh6bZuzm8s1ceuBUnMUAeoAHHw,25,26,21,13,11,0,7,0,78,11.142857142857142,3,0.0,1,21,11,11,25,0,2,7,0,44,34,0
821,11917,uuxrUSHn3GpYFneZnY8GpLgr5XiyDABs,A3fsA9Zfv1X2fVEQhTw51lKENdNrEqT3,19,22,18,0,12,0,9,1,62,8.857142857142858,2,0.0,0,18,0,12,22,0,0,9,1,30,32,0
822,11920,uarVJhEs6XLW7Dw1D7iBgEK6zPe65WwX,A3fsA9Zfv1X2fVEQhTw51lKENdNrEqT3,15,16,13,0,2,0,6,0,37,5.285714285714286,3,0.0,1,13,0,2,15,0,0,6,0,16,21,1
823,11921,JERgMmFADxaPxEUdcYHhaMN4ZwNAyErv,A3fsA9Zfv1X2fVEQhTw51lKENdNrEqT3,71,39,22,164,13,24,17,1,280,40.0,4,0.0,6,22,137,13,33,24,27,17,1,178,102,0
824,11922,gKme5KJOgqJrjNwDUsRPKwK3QFyN7vPD,RXDvfPUBYFlVdlueBFbLW0mhhAyGEqpt,65,111,62,153,33,4,12,1,376,53.714285714285715,8,0.0,29,62,145,33,82,4,8,12,1,269,107,0
825,11951,Nsiwn7635mGlMs5nxmspwUbmVQaPZWQ6,G8EPVSXsOYB5YQWZGiz1aVq5Pgr2GrQu,21,18,10,26,7,1,11,1,74,10.571428571428571,3,0.0,2,10,21,7,16,1,5,11,1,40,34,1
826,11956,oyFfPK6y9oPPwQR5mbsXW98FJaEnU88b,bWdj2GDclj5ofokWjzoa5jAwMkxCykd6,4,2,1,0,1,0,2,0,6,0.8571428571428571,1,0.0,0,1,0,1,2,0,0,2,0,2,4,1
827,11977,JtbtRyqX4dZ0edFKFJwGNY9JG3aidrlj,SpATywNh6bZuzm8s1ceuBUnMUAeoAHHw,29,44,20,26,12,4,26,1,133,19.0,5,0.0,16,20,20,12,28,4,6,26,1,68,65,0
828,11983,058hmyJK1lejTwX8sX29U5yFETfrvQ95,G8EPVSXsOYB5YQWZGiz1aVq5Pgr2GrQu,1,0,0,0,0,0,1,0,1,0.14285714285714285,1,0.0,0,0,0,0,0,0,0,1,0,0,1,1
829,11986,058hmyJK1lejTwX8sX29U5yFETfrvQ95,A3fsA9Zfv1X2fVEQhTw51lKENdNrEqT3,1,0,0,0,0,0,1,0,1,0.14285714285714285,1,0.0,0,0,0,0,0,0,0,1,0,0,1,1
830,12007,Uwggq8NcihxhBLnReA5tboVbRLkIS371,SpATywNh6bZuzm8s1ceuBUnMUAeoAHHw,1,0,0,0,0,0,1,0,1,0.14285714285714285,1,0.0,0,0,0,0,0,0,0,1,0,0,1,1
831,12011,q36eiA77bwwsXGg05ifhgnTFDpR9Ar4V,bWdj2GDclj5ofokWjzoa5jAwMkxCykd6,52,83,43,222,14,35,17,1,415,59.285714285714285,8,0.0,26,43,199,14,57,35,23,17,1,282,133,0
832,12020,LHFojLmJ5Ll3LGp6GnqLClTkRFP5a32j,bWdj2GDclj5ofokWjzoa5jAwMkxCykd6,1,0,0,0,0,0,1,0,1,0.14285714285714285,1,0.0,0,0,0,0,0,0,0,1,0,0,1,1
833,12030,gSxiLtAU3HWIGwL9IJcAr6lB3iS2AC6Z,A3fsA9Zfv1X2fVEQhTw51lKENdNrEqT3,2,0,0,0,0,0,2,0,2,0.2857142857142857,1,0.0,0,0,0,0,0,0,0,2,0,0,2,1
834,12053,7m381KBoEq7nybFxitllQlgHOa7YYR1i,SpATywNh6bZuzm8s1ceuBUnMUAeoAHHw,26,76,13,27,5,7,19,0,147,21.0,9,0.0,4,13,26,5,72,7,1,19,0,48,99,0
835,12090,M7Vbw5q1oL32IfEMSI9AM5uHCUMDFHmm,A3fsA9Zfv1X2fVEQhTw51lKENdNrEqT3,19,17,11,2,5,1,17,3,56,8.0,2,0.0,0,11,2,5,17,1,0,17,3,18,38,1
836,12099,tCXa4pMsMXRuliZWNM9so3Odte6UmpYj,bWdj2GDclj5ofokWjzoa5jAwMkxCykd6,1,0,0,0,0,0,1,0,1,0.14285714285714285,1,0.0,0,0,0,0,0,0,0,1,0,0,1,1
837,12113,l6nLhBWETqCazxhjGSPbpZQRNqpsMPRD,bWdj2GDclj5ofokWjzoa5jAwMkxCykd6,2,0,0,0,0,0,4,0,4,0.5714285714285714,1,0.0,0,0,0,0,0,0,0,4,0,0,4,1
838,12141,4n0eavxCNp4F6LlqtEg5gsmyBVEbRBeE,G8EPVSXsOYB5YQWZGiz1aVq5Pgr2GrQu,71,152,59,114,47,0,15,0,387,55.285714285714285,7,0.0,77,59,83,47,75,0,31,15,0,266,121,1
839,12147,VJw4zFdkpwcu4sXr2e3LyD2CU2ajLhIu,SpATywNh6bZuzm8s1ceuBUnMUAeoAHHw,31,45,22,20,9,22,17,0,135,19.285714285714285,3,0.0,7,22,18,9,38,22,2,17,0,56,79,0
840,12178,V2ut0n3Er1p82GdKRcLWOrmZXj3No2ts,bWdj2GDclj5ofokWjzoa5jAwMkxCykd6,1,0,0,0,0,0,1,0,1,0.14285714285714285,1,0.0,0,0,0,0,0,0,0,1,0,0,1,1
841,12203,TSpDTvH7tx13LMObu1OWRVwKh8isSitO,SpATywNh6bZuzm8s1ceuBUnMUAeoAHHw,14,16,4,3,3,0,6,1,33,4.714285714285714,1,0.0,4,4,3,3,12,0,0,6,1,14,19,1
842,12208,dOjwcbpJoBEbemc7xmUKlO5o5THYYuWb,RXDvfPUBYFlVdlueBFbLW0mhhAyGEqpt,67,76,26,85,14,25,15,2,243,34.714285714285715,3,0.0,23,26,83,14,53,25,2,15,2,146,97,0
843,12223,ysTOTg8n91NBng8BrzlEom4lR6CnDwPC,SpATywNh6bZuzm8s1ceuBUnMUAeoAHHw,26,57,22,17,7,12,29,10,154,22.0,4,0.0,13,22,16,7,44,12,1,29,10,58,96,1
844,12241,YqzonIu9nUz3X2nkdJiReRrylaOckiCC,SpATywNh6bZuzm8s1ceuBUnMUAeoAHHw,21,31,2,24,1,4,14,1,77,11.0,2,0.0,17,2,21,1,14,4,3,14,1,41,36,0
845,12246,I0uHaMvDeJM1w1AenEVj8xWzg3OizAzv,G8EPVSXsOYB5YQWZGiz1aVq5Pgr2GrQu,35,45,1,60,0,2,19,2,129,18.428571428571427,3,0.0,10,1,48,0,35,2,12,19,2,59,70,1
846,12253,Kxifrwa9ntGWJyRtJS6owg0ZQfSyRPcW,A3fsA9Zfv1X2fVEQhTw51lKENdNrEqT3,2,0,0,0,0,0,2,0,2,0.2857142857142857,1,0.0,0,0,0,0,0,0,0,2,0,0,2,0
847,12262,GAfZCFoItZF6u2g6TmFIAYqk177Q5kZH,SpATywNh6bZuzm8s1ceuBUnMUAeoAHHw,30,25,13,25,7,1,8,0,79,11.285714285714286,1,0.0,8,13,21,7,17,1,4,8,0,49,30,1
848,12287,zZK4lWrYYn5bTLcjHRRO0XA8xNwpu7OT,RXDvfPUBYFlVdlueBFbLW0mhhAyGEqpt,63,47,23,115,18,1,17,7,228,32.57142857142857,5,0.0,17,23,106,18,30,1,9,17,7,164,64,0
849,12293,UxPdjVFzcqqJoB99RNTW4pwswAcQ32eZ,RXDvfPUBYFlVdlueBFbLW0mhhAyGEqpt,32,20,18,0,15,0,25,0,78,11.142857142857142,5,0.0,2,18,0,15,18,0,0,25,0,35,43,0
850,12302,OeLBIzS0gNQ56euxy5b66gAZMzQCGE7n,A3fsA9Zfv1X2fVEQhTw51lKENdNrEqT3,71,31,21,140,14,2,30,2,240,34.285714285714285,3,0.0,2,21,116,14,29,2,24,30,2,153,87,1
851,12316,8SG0IoRU1kfooCNm4CWXEAnDe54VjVcy,A3fsA9Zfv1X2fVEQhTw51lKENdNrEqT3,22,16,11,0,8,2,10,2,49,7.0,2,0.0,2,11,0,8,14,2,0,10,2,21,28,1
852,12330,9iGaqBGS5kkoXjLd87hUL2eIJMVUVKfU,A3fsA9Zfv1X2fVEQhTw51lKENdNrEqT3,54,60,30,150,4,0,20,1,265,37.857142857142854,5,0.0,9,30,135,4,51,0,15,20,1,178,87,0
853,12350,7m381KBoEq7nybFxitllQlgHOa7YYR1i,G8EPVSXsOYB5YQWZGiz1aVq5Pgr2GrQu,63,153,37,122,23,15,20,0,370,52.857142857142854,8,0.0,3,37,113,23,150,15,9,20,0,176,194,1
854,12356,GW78UVODV1oPxxynjXG1U7em3gdA8wQF,SpATywNh6bZuzm8s1ceuBUnMUAeoAHHw,25,22,16,8,9,0,7,1,63,9.0,3,0.0,0,16,8,9,22,0,0,7,1,33,30,0
855,12358,nlf7AlI08jbhXKXagULClsgDoakDOx2G,SpATywNh6bZuzm8s1ceuBUnMUAeoAHHw,12,8,6,0,5,2,6,1,28,4.0,1,0.0,0,6,0,5,8,2,0,6,1,11,17,1
856,12363,5wKAjfQ5T37M2WWxYAwMeUeLhDScm1Z0,bWdj2GDclj5ofokWjzoa5jAwMkxCykd6,4,2,0,0,0,56,27,0,85,12.142857142857142,7,0.0,0,0,0,0,2,56,0,27,0,0,85,0
857,12372,Dx1ZzKpwFtwNhE9gdaLaohssqGyqrqjD,A3fsA9Zfv1X2fVEQhTw51lKENdNrEqT3,45,42,23,60,10,17,11,0,163,23.285714285714285,3,0.0,6,23,50,10,36,17,10,11,0,89,74,1
858,12374,dkmoSmrpP5gK9Xi6ySwrroCNfUlumbtO,G8EPVSXsOYB5YQWZGiz1aVq5Pgr2GrQu,12,7,0,10,0,0,2,0,19,2.7142857142857144,1,0.0,0,0,8,0,7,0,2,2,0,8,11,1
859,12381,zZsHSLX7Hk1sqhZYCfBgGlYJnqetGIKf,SpATywNh6bZuzm8s1ceuBUnMUAeoAHHw,9,12,2,0,0,4,7,1,26,3.7142857142857144,3,0.0,0,2,0,0,12,4,0,7,1,2,24,1
860,12383,7OkCZWJW1Ow4wpTBUq53amL13pV2vy2v,SpATywNh6bZuzm8s1ceuBUnMUAeoAHHw,15,45,1,14,2,106,39,8,215,30.714285714285715,6,0.0,13,1,13,2,32,106,1,39,8,29,186,0
861,12394,HXDAyPRsApqduwAe8pSs8BlStcKWeCOs,bWdj2GDclj5ofokWjzoa5jAwMkxCykd6,5,6,3,0,1,0,3,0,13,1.8571428571428572,2,0.0,0,3,0,1,6,0,0,3,0,4,9,1
862,12410,wXFfHtwd9smrvhh9NQW7SmEEo1001LDW,A3fsA9Zfv1X2fVEQhTw51lKENdNrEqT3,27,42,26,10,9,10,33,4,134,19.142857142857142,8,0.0,2,26,8,9,40,10,2,33,4,45,89,1
863,12412,s24Qk0ZpAXR97ldBDtgP8DE6rT8or69U,SpATywNh6bZuzm8s1ceuBUnMUAeoAHHw,17,52,3,34,0,0,9,0,98,14.0,6,0.0,13,3,31,0,39,0,3,9,0,47,51,0
864,12442,HbmZzALzRW0CJmaD07o1oMpvJwGgfjK4,SpATywNh6bZuzm8s1ceuBUnMUAeoAHHw,8,12,2,0,2,2,4,1,23,3.2857142857142856,3,0.0,1,2,0,2,11,2,0,4,1,5,18,1
865,12445,CqxK3XGagGgLgWXJIkp8qfeo0SWv94XW,RXDvfPUBYFlVdlueBFbLW0mhhAyGEqpt,65,176,102,115,25,131,48,25,622,88.85714285714286,12,0.0,45,102,98,25,131,131,17,48,25,270,352,0
866,12464,NSrMJ69WS92LaJ6a09xOpViELCrjji8S,SpATywNh6bZuzm8s1ceuBUnMUAeoAHHw,22,49,11,30,1,43,23,0,157,22.428571428571427,12,0.0,8,11,26,1,41,43,4,23,0,46,111,0
867,12480,q54oCvxsY1LE19jtoD23qGpHSrkdhUlF,A3fsA9Zfv1X2fVEQhTw51lKENdNrEqT3,36,26,1,66,1,1,16,0,111,15.857142857142858,2,0.0,2,1,62,1,24,1,4,16,0,66,45,1
868,12482,35upFtDrqCqWhj8RVNLHqe6Xg75dIX7z,G8EPVSXsOYB5YQWZGiz1aVq5Pgr2GrQu,4,3,1,2,0,0,2,0,8,1.1428571428571428,2,0.0,1,1,2,0,2,0,0,2,0,4,4,1
869,12515,UKrQdzHwNJRJK7ZoTzKsoWlrkEbsQk7X,RXDvfPUBYFlVdlueBFbLW0mhhAyGEqpt,1,0,0,0,0,0,1,0,1,0.14285714285714285,1,0.0,0,0,0,0,0,0,0,1,0,0,1,1
870,12522,MRCD9XxqQVpIexf9EdSwdaoHW691k7OH,SpATywNh6bZuzm8s1ceuBUnMUAeoAHHw,21,33,17,16,0,0,5,0,71,10.142857142857142,2,0.0,9,17,14,0,24,0,2,5,0,40,31,1
871,12569,4Z7n4wdauhlOTY95FN6j39vUUWT0ZgYl,SpATywNh6bZuzm8s1ceuBUnMUAeoAHHw,19,66,29,24,10,0,15,0,144,20.571428571428573,8,0.0,16,29,18,10,50,0,6,15,0,73,71,1
872,12580,kB76SiSV4uYN77hHUOgf3IbLpFWkgJbj,SpATywNh6bZuzm8s1ceuBUnMUAeoAHHw,32,33,19,35,10,1,17,1,116,16.571428571428573,5,0.0,6,19,30,10,27,1,5,17,1,65,51,0
873,12583,JRuzCriX6hvuTQ943ttXKlmrFVyfxMHr,SpATywNh6bZuzm8s1ceuBUnMUAeoAHHw,24,37,23,8,7,0,7,0,82,11.714285714285714,6,0.0,0,23,7,7,37,0,1,7,0,37,45,0
874,12586,jfC6fPTH59GZUrxarremx8AmMC8XNgfG,SpATywNh6bZuzm8s1ceuBUnMUAeoAHHw,26,36,22,13,9,2,3,0,85,12.142857142857142,4,0.0,7,22,13,9,29,2,0,3,0,51,34,1
875,12588,XQTN1LOe7iul8RvZ4acTOpEntRORT1SG,SpATywNh6bZuzm8s1ceuBUnMUAeoAHHw,6,6,0,0,0,0,4,0,10,1.4285714285714286,3,0.0,2,0,0,0,4,0,0,4,0,2,8,1
876,12597,R8tAdEYq32rVkLXscE5SipLgbsEEPIk8,bWdj2GDclj5ofokWjzoa5jAwMkxCykd6,1,0,0,0,0,0,2,0,2,0.2857142857142857,1,0.0,0,0,0,0,0,0,0,2,0,0,2,1
877,12600,NO22WSq5lVGwq6WPEcqalEaMjYIZxX3u,bWdj2GDclj5ofokWjzoa5jAwMkxCykd6,10,27,0,9,1,0,10,0,47,6.714285714285714,3,0.0,13,0,8,1,14,0,1,10,0,22,25,1
878,12616,gLKRPeA7yYfxDrcYMLyblT6wVEjgwKPH,SpATywNh6bZuzm8s1ceuBUnMUAeoAHHw,32,48,23,16,14,5,10,1,117,16.714285714285715,5,0.0,9,23,14,14,39,5,2,10,1,60,57,0
879,12620,LxV8BE7SALs1WsK81jAFnmtwnc7yS8ck,G8EPVSXsOYB5YQWZGiz1aVq5Pgr2GrQu,12,21,11,0,5,0,6,0,43,6.142857142857143,3,0.0,4,11,0,5,17,0,0,6,0,20,23,1
880,12626,NSkQyRZ5kDInEI8yx5AGmbuyJ28eG48A,SpATywNh6bZuzm8s1ceuBUnMUAeoAHHw,31,38,21,24,10,5,10,0,108,15.428571428571429,3,0.0,5,21,19,10,33,5,5,10,0,55,53,0
881,12633,8DlfU1bgriTJuUO8vI8x268Lnn7yRdfp,A3fsA9Zfv1X2fVEQhTw51lKENdNrEqT3,5,2,1,0,1,4,6,0,14,2.0,2,0.0,0,1,0,1,2,4,0,6,0,2,12,1
882,12649,TexDHGk8F5I6X0NlqVQwzJ9MMWpLdMbB,SpATywNh6bZuzm8s1ceuBUnMUAeoAHHw,31,45,21,35,8,6,10,1,126,18.0,6,0.0,13,21,27,8,32,6,8,10,1,69,57,0
883,12667,h1g6Jk0YES6cZKnPtmszwjPCneFTGd3j,bWdj2GDclj5ofokWjzoa5jAwMkxCykd6,13,14,9,0,6,18,15,2,64,9.142857142857142,3,0.0,0,9,0,6,14,18,0,15,2,15,49,1
884,12682,I19aG6zmdTntoy0T8VxEogbN4WVEZZNa,SpATywNh6bZuzm8s1ceuBUnMUAeoAHHw,22,37,3,28,0,0,6,0,74,10.571428571428571,3,0.0,14,3,26,0,23,0,2,6,0,43,31,1
885,12689,1Ld3jQU8M0eiaLBshs8gjcgQEfdlgHyZ,RXDvfPUBYFlVdlueBFbLW0mhhAyGEqpt,30,21,15,0,12,0,4,0,52,7.428571428571429,3,0.0,2,15,0,12,19,0,0,4,0,29,23,1
886,12707,Hr9mm3bIoeLv4wyDeAcwJNdd3K6mgRy4,SpATywNh6bZuzm8s1ceuBUnMUAeoAHHw,30,41,23,26,8,3,9,0,110,15.714285714285714,3,0.0,9,23,25,8,32,3,1,9,0,65,45,0
887,12711,rDEv38jBkahw1DC082iTP7UbA4sE1KaP,SpATywNh6bZuzm8s1ceuBUnMUAeoAHHw,13,9,1,17,1,0,3,0,31,4.428571428571429,1,0.0,2,1,15,1,7,0,2,3,0,19,12,0
888,12726,bQve3ajdEL4IqADUWqNBP99IoqvejzJV,A3fsA9Zfv1X2fVEQhTw51lKENdNrEqT3,6,3,0,0,0,4,8,1,16,2.2857142857142856,2,0.0,0,0,0,0,3,4,0,8,1,0,16,1
889,12735,KBt3gvTJLTIjt4EkmG3y3LICooEML1xW,G8EPVSXsOYB5YQWZGiz1aVq5Pgr2GrQu,32,43,25,26,14,0,18,2,128,18.285714285714285,5,0.0,11,25,19,14,32,0,7,18,2,69,59,1
890,12742,arTGhRrKZksM4iY72XDJ8i8oBmMABS0m,SpATywNh6bZuzm8s1ceuBUnMUAeoAHHw,26,63,7,7,2,75,21,1,176,25.142857142857142,9,0.0,15,7,7,2,48,75,0,21,1,31,145,0
891,12745,rRt0QHymEdl6Kph5VPgdVUvepB7ZBNXt,SpATywNh6bZuzm8s1ceuBUnMUAeoAHHw,30,81,31,25,14,2,21,0,174,24.857142857142858,7,0.0,12,31,23,14,69,2,2,21,0,80,94,0
892,12750,i67qzouvUD7nINgK6d1xrH4pvufZqbFd,SpATywNh6bZuzm8s1ceuBUnMUAeoAHHw,21,38,1,27,0,4,8,0,78,11.142857142857142,5,0.0,7,1,25,0,31,4,2,8,0,33,45,0
893,12753,79Po0Awyh8Z7ruF9y6agajWClv9uUoPL,SpATywNh6bZuzm8s1ceuBUnMUAeoAHHw,27,88,2,15,2,6,18,1,132,18.857142857142858,6,0.0,8,2,15,2,80,6,0,18,1,27,105,1
894,12761,rtYqtRTnqUXb6diSp0MKjdA0eLt2BJ3X,SpATywNh6bZuzm8s1ceuBUnMUAeoAHHw,19,30,14,17,4,20,11,0,96,13.714285714285714,3,0.0,8,14,15,4,22,20,2,11,0,41,55,0
895,12768,ghgdA2SJuIXQM23Hgf4BrlUd29ois5mW,SpATywNh6bZuzm8s1ceuBUnMUAeoAHHw,14,19,1,12,1,6,5,0,44,6.285714285714286,2,0.0,6,1,11,1,13,6,1,5,0,19,25,1
896,12784,rZSLmwiYX8trzeLsBLeg8r0IN1GBbqOC,bWdj2GDclj5ofokWjzoa5jAwMkxCykd6,1,0,0,0,0,0,1,0,1,0.14285714285714285,1,0.0,0,0,0,0,0,0,0,1,0,0,1,1
897,12796,P5jfghvfecmYY6IMTqwwXqe4o108QRc4,SpATywNh6bZuzm8s1ceuBUnMUAeoAHHw,18,11,9,0,8,0,4,0,32,4.571428571428571,3,0.0,0,9,0,8,11,0,0,4,0,17,15,1
898,12805,P0uW8e7uWJsgVO5MWg1krlEvXljM181Y,G8EPVSXsOYB5YQWZGiz1aVq5Pgr2GrQu,1,0,0,0,0,0,4,0,4,0.5714285714285714,3,0.0,0,0,0,0,0,0,0,4,0,0,4,1
899,12808,idxWUfEs3kYL0r7IC35umYY3ZJQ22Zab,SpATywNh6bZuzm8s1ceuBUnMUAeoAHHw,6,9,4,0,2,0,3,0,18,2.5714285714285716,2,0.0,0,4,0,2,9,0,0,3,0,6,12,1
900,12813,L3khlyhxkzKPVeEgnV2Dt5jl6Pe5Thm4,RXDvfPUBYFlVdlueBFbLW0mhhAyGEqpt,20,27,17,25,9,1,8,0,87,12.428571428571429,4,0.0,8,17,22,9,19,1,3,8,0,56,31,1
901,12834,ZYxocA1Ix9ILa1C9VKK1bM1W4sEOXUVw,SpATywNh6bZuzm8s1ceuBUnMUAeoAHHw,19,29,0,29,0,0,8,0,66,9.428571428571429,4,0.0,12,0,28,0,17,0,1,8,0,40,26,0
902,12845,syrttArug8Mpzs9L0IHsvBtATawYF9J2,SpATywNh6bZuzm8s1ceuBUnMUAeoAHHw,8,8,5,0,2,0,4,0,19,2.7142857142857144,4,0.0,0,5,0,2,8,0,0,4,0,7,12,1
903,12853,55dttExESw0iXI74tkLBOaeITFkRCx90,A3fsA9Zfv1X2fVEQhTw51lKENdNrEqT3,42,39,21,58,8,2,15,1,144,20.571428571428573,3,0.0,1,21,48,8,38,2,10,15,1,78,66,1
904,12854,cVHCYdG6eoXKQe55dLZbvLgwBGbWam7p,A3fsA9Zfv1X2fVEQhTw51lKENdNrEqT3,11,11,2,0,1,0,6,0,20,2.857142857142857,3,0.0,0,2,0,1,11,0,0,6,0,3,17,1
905,12856,0wSRq6mRtt7ajwm8CWZxYMig1mbMrg7d,bWdj2GDclj5ofokWjzoa5jAwMkxCykd6,1,0,0,0,0,0,1,0,1,0.14285714285714285,1,0.0,0,0,0,0,0,0,0,1,0,0,1,1
906,12883,KKz5C2CIERGp4d0g7P8ZO1hnR4NT39t2,SpATywNh6bZuzm8s1ceuBUnMUAeoAHHw,30,34,21,20,12,9,6,0,102,14.571428571428571,3,0.0,7,21,16,12,27,9,4,6,0,56,46,0
907,12888,lMy0A59BRo4770ALzvOjsBS5HJkCRV78,A3fsA9Zfv1X2fVEQhTw51lKENdNrEqT3,43,66,11,50,3,27,48,2,207,29.571428571428573,9,0.0,4,11,48,3,62,27,2,48,2,66,141,1
908,12892,P0uW8e7uWJsgVO5MWg1krlEvXljM181Y,bWdj2GDclj5ofokWjzoa5jAwMkxCykd6,11,13,4,8,2,0,11,0,38,5.428571428571429,4,0.0,1,4,7,2,12,0,1,11,0,14,24,1
909,12948,f7pgA2Hp0s8DkqzKuvE0Kw8QRuoBh3Zv,A3fsA9Zfv1X2fVEQhTw51lKENdNrEqT3,51,23,12,125,1,17,10,0,188,26.857142857142858,4,0.0,4,12,109,1,19,17,16,10,0,126,62,0
910,12956,lEIFkqeT396JMSPUyiaHNMN8g7bQ1x9p,SpATywNh6bZuzm8s1ceuBUnMUAeoAHHw,30,70,31,18,19,5,25,1,169,24.142857142857142,8,0.0,38,31,17,19,32,5,1,25,1,105,64,0
911,12976,KpbHdGVlZIWVraCiFee7Cav2rNnqqrsJ,SpATywNh6bZuzm8s1ceuBUnMUAeoAHHw,27,33,23,20,13,7,7,0,103,14.714285714285714,3,0.0,4,23,20,13,29,7,0,7,0,60,43,1
912,12993,8r4M2l7ATXMXEQUCAknekZVeyUGIpRyK,SpATywNh6bZuzm8s1ceuBUnMUAeoAHHw,18,80,8,15,5,2,42,0,152,21.714285714285715,10,0.0,8,8,12,5,72,2,3,42,0,33,119,1
913,13011,3Eee8QbVtHhcwedqstQME1x67jOdVLkK,SpATywNh6bZuzm8s1ceuBUnMUAeoAHHw,5,3,0,0,0,1,4,3,11,1.5714285714285714,1,0.0,0,0,0,0,3,1,0,4,3,0,11,1
914,13023,MAktGJIumyskhJp25e79u9tVhauVJ2c6,SpATywNh6bZuzm8s1ceuBUnMUAeoAHHw,31,42,18,36,11,56,28,1,192,27.428571428571427,5,0.0,10,18,30,11,32,56,6,28,1,69,123,0
915,13088,AbunVo6pGQTlDxnSJmOS7flQ0Vb2S3xP,bWdj2GDclj5ofokWjzoa5jAwMkxCykd6,13,13,5,18,3,6,12,1,58,8.285714285714286,2,0.0,4,5,18,3,9,6,0,12,1,30,28,1
916,13109,YW2vWUP3xrebFWQq20TaENvqpb9ZdJV6,SpATywNh6bZuzm8s1ceuBUnMUAeoAHHw,28,27,13,26,7,5,17,1,96,13.714285714285714,4,0.0,4,13,22,7,23,5,4,17,1,46,50,0
917,13129,AbunVo6pGQTlDxnSJmOS7flQ0Vb2S3xP,A3fsA9Zfv1X2fVEQhTw51lKENdNrEqT3,1,0,0,0,0,0,3,0,3,0.42857142857142855,2,0.0,0,0,0,0,0,0,0,3,0,0,3,1
918,13135,nF3fyodzvP9Kt8uvHxBDafFDSHuZ38jd,SpATywNh6bZuzm8s1ceuBUnMUAeoAHHw,30,75,13,38,10,50,25,4,215,30.714285714285715,7,0.0,8,13,31,10,67,50,7,25,4,62,153,1
919,13143,igeK6rUQT7Ehyj7yY5oAEj8DvOITiuBO,SpATywNh6bZuzm8s1ceuBUnMUAeoAHHw,29,80,31,35,11,5,21,0,183,26.142857142857142,10,0.0,18,31,30,11,62,5,5,21,0,90,93,0
920,13147,p9Pgf9XUtcr2kL39MqLlMakadbFqlUtX,RXDvfPUBYFlVdlueBFbLW0mhhAyGEqpt,19,57,37,22,17,9,17,2,161,23.0,6,0.0,7,37,17,17,50,9,5,17,2,78,83,1
921,13159,gMZKWOenFyVb6m3mcpDQmzDRcu1zvYbF,G8EPVSXsOYB5YQWZGiz1aVq5Pgr2GrQu,12,21,8,50,5,0,9,0,93,13.285714285714286,3,0.0,6,8,47,5,15,0,3,9,0,66,27,1
922,13179,pOKZyBql9SdI7DoREUHq99ghEycAS0cI,bWdj2GDclj5ofokWjzoa5jAwMkxCykd6,6,6,0,0,1,0,2,0,9,1.2857142857142858,2,0.0,0,0,0,1,6,0,0,2,0,1,8,1
923,13187,i67qzouvUD7nINgK6d1xrH4pvufZqbFd,bWdj2GDclj5ofokWjzoa5jAwMkxCykd6,3,2,0,0,0,0,3,0,5,0.7142857142857143,1,0.0,0,0,0,0,2,0,0,3,0,0,5,1
924,13206,GSkYUOcl4XzYMWSWhE6gXRGQ9kqPeXsi,RXDvfPUBYFlVdlueBFbLW0mhhAyGEqpt,50,35,20,84,11,0,7,0,157,22.428571428571427,5,0.0,8,20,82,11,27,0,2,7,0,121,36,1
925,13207,PMDa1SUjeddLyhfDscbnAxL67GyZb6sD,SpATywNh6bZuzm8s1ceuBUnMUAeoAHHw,20,47,21,16,1,13,12,0,110,15.714285714285714,7,0.0,3,21,16,1,44,13,0,12,0,41,69,0
926,13212,pR0rEzd43YPn1ujQN1oHxqL0z3U4G8ju,SpATywNh6bZuzm8s1ceuBUnMUAeoAHHw,7,6,1,0,1,0,3,0,11,1.5714285714285714,2,0.0,2,1,0,1,4,0,0,3,0,4,7,1
927,13214,XFmrH2WQYMYLXRE1Jm7VValFt236PUJr,SpATywNh6bZuzm8s1ceuBUnMUAeoAHHw,22,24,1,24,1,0,3,0,53,7.571428571428571,2,0.0,8,1,20,1,16,0,4,3,0,30,23,1
928,13227,0wJhtCWK60WPCeRF62m8T80DtNpWhRrg,RXDvfPUBYFlVdlueBFbLW0mhhAyGEqpt,68,100,48,156,24,12,12,0,352,50.285714285714285,8,0.0,15,48,146,24,85,12,10,12,0,233,119,0
929,13233,UM3F51S6vWhAORUn5XfgddMSa2NpuDR3,bWdj2GDclj5ofokWjzoa5jAwMkxCykd6,5,4,1,0,1,0,3,0,9,1.2857142857142858,2,0.0,0,1,0,1,4,0,0,3,0,2,7,1
930,13240,m52orXncJIuZMWO7LnwS1hFqDU5X5m24,SpATywNh6bZuzm8s1ceuBUnMUAeoAHHw,29,37,9,49,5,38,21,2,161,23.0,6,0.0,16,9,40,5,21,38,9,21,2,70,91,0
931,13259,KovPBJesZmgqVCWR3DXdtvcd4XyHL9BT,SpATywNh6bZuzm8s1ceuBUnMUAeoAHHw,27,48,4,35,3,36,27,7,160,22.857142857142858,6,0.0,13,4,29,3,35,36,6,27,7,49,111,0
932,13263,CZ6gFOo6OnSPq5AGDZTDmf17XM8Rum8M,SpATywNh6bZuzm8s1ceuBUnMUAeoAHHw,10,8,0,11,0,0,3,0,22,3.142857142857143,1,0.0,3,0,10,0,5,0,1,3,0,13,9,1
933,13273,bKbwS8bsj3eNxoCQcsrg5SKpHAoJ8uGu,A3fsA9Zfv1X2fVEQhTw51lKENdNrEqT3,49,44,2,148,0,8,12,0,214,30.571428571428573,6,0.0,11,2,120,0,33,8,28,12,0,133,81,1
934,13290,bDOMCQV7nFdKo0pDqOPr3ECLpgkdBCSt,A3fsA9Zfv1X2fVEQhTw51lKENdNrEqT3,34,67,4,38,2,1,10,0,122,17.428571428571427,3,0.0,2,4,35,2,65,1,3,10,0,43,79,1
935,13316,7P8eMWaZZgnw2duzHVId8BVYAnTZapE1,SpATywNh6bZuzm8s1ceuBUnMUAeoAHHw,8,4,2,0,2,0,8,0,16,2.2857142857142856,1,0.0,0,2,0,2,4,0,0,8,0,4,12,1
936,13319,sqZsZQq9LcjzbfCPmehLyMMrK3ClcYAT,SpATywNh6bZuzm8s1ceuBUnMUAeoAHHw,3,2,0,0,0,0,1,0,3,0.42857142857142855,1,0.0,0,0,0,0,2,0,0,1,0,0,3,1
937,13338,UidTeyEs50r1zTQVJtstLvLcMUKrNN3b,SpATywNh6bZuzm8s1ceuBUnMUAeoAHHw,21,32,2,12,1,2,13,1,63,9.0,6,0.0,11,2,12,1,21,2,0,13,1,26,37,0
938,13358,Aw7PeIkLW9CDHbPpPSjrFUdtBaUuHUXm,bWdj2GDclj5ofokWjzoa5jAwMkxCykd6,49,99,39,144,13,95,93,5,488,69.71428571428571,12,0.0,39,39,123,13,60,95,21,93,5,214,274,0
939,13379,TGngiWN6RHpSD048KJCksxngjFh0emXm,A3fsA9Zfv1X2fVEQhTw51lKENdNrEqT3,7,6,1,0,1,0,3,0,11,1.5714285714285714,1,0.0,0,1,0,1,6,0,0,3,0,2,9,1
940,13386,5KSMnQXKnbRqNWod4v539vcEvMedku3c,bWdj2GDclj5ofokWjzoa5jAwMkxCykd6,2,0,0,0,0,0,2,0,2,0.2857142857142857,1,0.0,0,0,0,0,0,0,0,2,0,0,2,1
941,13398,bqWpav7ocOhCfb3xc4QgAvBDK5g8BmiZ,SpATywNh6bZuzm8s1ceuBUnMUAeoAHHw,18,44,24,12,4,55,19,1,159,22.714285714285715,7,0.0,10,24,9,4,34,55,3,19,1,47,112,0
942,13402,mGb99e4ZiyyEapZp3B98Pssar5eWGHEz,G8EPVSXsOYB5YQWZGiz1aVq5Pgr2GrQu,24,29,3,48,3,0,6,0,89,12.714285714285714,4,0.0,4,3,40,3,25,0,8,6,0,50,39,1
943,13424,PfZH4Yubwsve9DvShzAvHjayDN16nhpN,G8EPVSXsOYB5YQWZGiz1aVq5Pgr2GrQu,1,0,0,0,0,0,1,0,1,0.14285714285714285,1,0.0,0,0,0,0,0,0,0,1,0,0,1,1
944,13430,j0gxXks7DZitzyeEGG2agLKFp30HqXVu,bWdj2GDclj5ofokWjzoa5jAwMkxCykd6,18,82,31,0,6,16,23,2,160,22.857142857142858,5,0.0,17,31,0,6,65,16,0,23,2,54,106,0
945,13460,mG2HKIW4KvK5MNtCekVvEvxXHT51PCPq,A3fsA9Zfv1X2fVEQhTw51lKENdNrEqT3,1,0,0,0,0,0,1,0,1,0.14285714285714285,1,0.0,0,0,0,0,0,0,0,1,0,0,1,1
946,13469,OLmaTq1VRWq8uhF6WwamKt59rXmIqMgh,SpATywNh6bZuzm8s1ceuBUnMUAeoAHHw,11,17,9,0,5,4,12,0,47,6.714285714285714,4,0.0,0,9,0,5,17,4,0,12,0,14,33,1
947,13477,9pzI899XVNJmMa8xv35JoCa2P4C0Faa4,bWdj2GDclj5ofokWjzoa5jAwMkxCykd6,14,31,3,0,2,39,13,1,89,12.714285714285714,2,0.0,0,3,0,2,31,39,0,13,1,5,84,1
948,13479,sfuANiSFq72qS7aoKnyvPaRtXw7bLFiY,SpATywNh6bZuzm8s1ceuBUnMUAeoAHHw,17,27,12,10,5,0,7,0,61,8.714285714285714,6,0.0,4,12,10,5,23,0,0,7,0,31,30,1
949,13490,RtDHl5nE4LpZJE4fPWaXYE5l5ziJJw3q,SpATywNh6bZuzm8s1ceuBUnMUAeoAHHw,6,7,3,0,3,0,1,0,14,2.0,1,0.0,0,3,0,3,7,0,0,1,0,6,8,1
950,13491,KKBYOCb35hszQy5vSfsxbAFYFgilEECF,SpATywNh6bZuzm8s1ceuBUnMUAeoAHHw,23,19,12,18,5,0,17,0,71,10.142857142857142,7,0.0,6,12,18,5,13,0,0,17,0,41,30,1
951,13518,OcFLLEI56U80V98vNeJ7LrlE5FWxkkpp,SpATywNh6bZuzm8s1ceuBUnMUAeoAHHw,30,53,24,23,12,35,23,2,172,24.571428571428573,6,0.0,13,24,22,12,40,35,1,23,2,71,101,0
952,13525,J1f9rNzR7t1WQhWY7vU0QrkaWuS9xCeR,bWdj2GDclj5ofokWjzoa5jAwMkxCykd6,23,17,10,48,8,27,31,1,142,20.285714285714285,4,0.0,5,10,44,8,12,27,4,31,1,67,75,1
953,13530,7dPYuxC1NExRQjXFHnhWbTviIyBFUDmL,SpATywNh6bZuzm8s1ceuBUnMUAeoAHHw,5,20,14,0,1,0,2,0,37,5.285714285714286,15,0.0,0,14,0,1,20,0,0,2,0,15,22,1
954,13537,LDoffeIzXBaEA3EoYd9Gp4Kl36LUuUJD,SpATywNh6bZuzm8s1ceuBUnMUAeoAHHw,10,12,6,0,1,17,10,4,50,7.142857142857143,3,0.0,0,6,0,1,12,17,0,10,4,7,43,1
955,13552,IGnubmoC2Z3kyMhnm5cfb5h7HnKkMEVq,G8EPVSXsOYB5YQWZGiz1aVq5Pgr2GrQu,6,6,2,0,1,3,7,0,19,2.7142857142857144,2,0.0,0,2,0,1,6,3,0,7,0,3,16,1
956,13578,7XgWWxsOrwxcFjioh5NncRGrx77dSS5r,SpATywNh6bZuzm8s1ceuBUnMUAeoAHHw,23,43,1,21,1,1,11,0,78,11.142857142857142,4,0.0,9,1,19,1,34,1,2,11,0,30,48,0
957,13583,UmlMF2TsgsipXk92JRV0A7TQAmCZuKWV,SpATywNh6bZuzm8s1ceuBUnMUAeoAHHw,6,4,1,0,0,0,2,0,7,1.0,1,0.0,0,1,0,0,4,0,0,2,0,1,6,1
958,13587,zFEKyzORyNtVsN87mi1ReZjFEUKvm21T,SpATywNh6bZuzm8s1ceuBUnMUAeoAHHw,25,32,19,12,9,9,6,2,89,12.714285714285714,3,0.0,3,19,10,9,29,9,2,6,2,41,48,1
959,13594,sZYvW7O1yC1PAj5iYABgZ056jCM2PsNq,SpATywNh6bZuzm8s1ceuBUnMUAeoAHHw,13,37,20,4,6,0,11,0,78,11.142857142857142,6,0.0,9,20,4,6,28,0,0,11,0,39,39,0
960,13605,g2crr0D1YRZspeg3aG0QVrkBBPBltTjz,SpATywNh6bZuzm8s1ceuBUnMUAeoAHHw,23,31,6,31,1,5,4,0,78,11.142857142857142,6,0.0,11,6,27,1,20,5,4,4,0,45,33,0
961,13610,r10mjNLAOjkXo9ipKqWrD4Hts48L6lcD,G8EPVSXsOYB5YQWZGiz1aVq5Pgr2GrQu,54,30,22,134,18,0,4,0,208,29.714285714285715,3,0.0,0,22,113,18,30,0,21,4,0,153,55,0
962,13672,kP6GmMO1OBG46GzGpGgNEkhdNz0eN2Yt,SpATywNh6bZuzm8s1ceuBUnMUAeoAHHw,1,0,0,0,0,0,1,0,1,0.14285714285714285,1,0.0,0,0,0,0,0,0,0,1,0,0,1,1
963,13684,XkKS323fFxBVezQ5JyIgzxHDxEKEwwEf,A3fsA9Zfv1X2fVEQhTw51lKENdNrEqT3,18,14,9,10,5,3,5,0,46,6.571428571428571,2,0.0,1,9,10,5,13,3,0,5,0,25,21,0
964,13696,r0yAsNzYkqEPYi6zNhQfzuueDjmcyFRr,bWdj2GDclj5ofokWjzoa5jAwMkxCykd6,2,0,0,0,0,0,3,0,3,0.42857142857142855,1,0.0,0,0,0,0,0,0,0,3,0,0,3,1
965,13703,FaZLW3HiYLflnTCxi4BN21oHHvNYhtue,SpATywNh6bZuzm8s1ceuBUnMUAeoAHHw,20,46,22,18,6,1,13,0,106,15.142857142857142,10,0.0,9,22,15,6,37,1,3,13,0,52,54,1
966,13711,H2Rgqo3kRDsNdbNVEDl0788s9SSdLM8P,bWdj2GDclj5ofokWjzoa5jAwMkxCykd6,6,5,2,0,2,0,4,0,13,1.8571428571428572,3,0.0,0,2,0,2,5,0,0,4,0,4,9,1
967,13714,e4xoItGqdt7VvYzxou1Pv23rnKAXXXsC,SpATywNh6bZuzm8s1ceuBUnMUAeoAHHw,19,34,5,9,3,6,15,2,74,10.571428571428571,4,0.0,7,5,8,3,27,6,1,15,2,23,51,1
968,13720,9JsNhrsWtCheE46kbgKiC6TCsPPGBSze,SpATywNh6bZuzm8s1ceuBUnMUAeoAHHw,19,34,19,9,6,4,7,0,79,11.285714285714286,3,0.0,7,19,9,6,27,4,0,7,0,41,38,1
969,13750,6UfeuZvS7L15CgcbiecsOUDWQezuLDJz,SpATywNh6bZuzm8s1ceuBUnMUAeoAHHw,1,0,0,0,0,0,1,0,1,0.14285714285714285,1,0.0,0,0,0,0,0,0,0,1,0,0,1,1
970,13751,wfHTtk8oy0CiP4p3waBMhlIvxeVIbZqk,SpATywNh6bZuzm8s1ceuBUnMUAeoAHHw,29,50,16,15,7,8,26,0,122,17.428571428571427,7,0.0,8,16,15,7,42,8,0,26,0,46,76,0
971,13758,Pt4CHQaH2Lj9ri6xbjrkQ0IBNpZPKhdM,SpATywNh6bZuzm8s1ceuBUnMUAeoAHHw,2,0,0,0,0,0,2,0,2,0.2857142857142857,1,0.0,0,0,0,0,0,0,0,2,0,0,2,1
972,13764,fdJXQSSucuzaRljy096jXgInnW2TakHQ,SpATywNh6bZuzm8s1ceuBUnMUAeoAHHw,29,89,50,33,11,39,26,2,250,35.714285714285715,8,0.0,18,50,27,11,71,39,6,26,2,106,144,0
973,13780,EikisME12XnhqTfgnKK3O8hmfAWTmSd3,G8EPVSXsOYB5YQWZGiz1aVq5Pgr2GrQu,54,50,21,126,13,4,16,1,231,33.0,5,0.0,10,21,107,13,40,4,19,16,1,151,80,0
974,13788,xYZJv26kEF7oZiNSoEZMnXHo33iYNlMJ,A3fsA9Zfv1X2fVEQhTw51lKENdNrEqT3,30,18,9,62,2,2,9,1,103,14.714285714285714,4,0.0,2,9,55,2,16,2,7,9,1,68,35,1
975,14683,EK8cH2rqaeWCMjTFz8xL65N7r32HerY9,7GRhBDsirIGkRZBtSMEzNTyDr2JQm4xx,97,201,77,127,44,183,41,4,677,96.71428571428571,14,0.0,85,77,106,44,116,183,21,41,4,312,365,0
976,14690,ZbWUV0qkotaaSLhz8iJBNOk5nD7qDeuY,7GRhBDsirIGkRZBtSMEzNTyDr2JQm4xx,37,57,33,4,35,0,10,0,139,19.857142857142858,3,0.0,17,33,4,35,40,0,0,10,0,89,50,0
977,14815,IQhh6lXlVmCrcAcXbMrK8pYs2wjQgUqq,7GRhBDsirIGkRZBtSMEzNTyDr2JQm4xx,4,1,1,0,0,184,6,0,192,27.428571428571427,4,0.0,0,1,0,0,1,184,0,6,0,1,191,0
978,14818,UgETwjVUoQXyxwFA12B4jwRDb3R4sQSN,7GRhBDsirIGkRZBtSMEzNTyDr2JQm4xx,60,125,54,131,40,1,22,0,373,53.285714285714285,10,0.0,57,54,117,40,68,1,14,22,0,268,105,1
979,14829,QZIRHdwFgibI2SBehTrmLAZxED1F4JL7,7GRhBDsirIGkRZBtSMEzNTyDr2JQm4xx,26,47,16,12,18,0,4,0,97,13.857142857142858,3,0.0,8,16,10,18,39,0,2,4,0,52,45,1
980,14836,lEIFkqeT396JMSPUyiaHNMN8g7bQ1x9p,7GRhBDsirIGkRZBtSMEzNTyDr2JQm4xx,6,1,1,0,1,0,3,0,6,0.8571428571428571,1,0.0,0,1,0,1,1,0,0,3,0,2,4,1
981,14837,CEMMuEEc653PcYnJ6cnr3jxrYZv9f8D1,7GRhBDsirIGkRZBtSMEzNTyDr2JQm4xx,1,0,0,0,0,0,1,0,1,0.14285714285714285,1,0.0,0,0,0,0,0,0,0,1,0,0,1,1
982,14846,5Xet5BwM6xDYh8pbaupnwmiq9T6jy7TC,7GRhBDsirIGkRZBtSMEzNTyDr2JQm4xx,47,64,20,73,23,23,19,0,222,31.714285714285715,5,0.0,44,20,62,23,20,23,11,19,0,149,73,1
983,14851,SDvatKCgfdtv12UzJLxR0GYxgD4pUkgT,7GRhBDsirIGkRZBtSMEzNTyDr2JQm4xx,24,37,14,36,4,5,9,0,105,15.0,4,0.0,16,14,31,4,21,5,5,9,0,65,40,1
984,14873,vJOKvfBreLyHqbEVMHx8ymKhM8KWKMc3,7GRhBDsirIGkRZBtSMEzNTyDr2JQm4xx,1,0,0,0,0,0,1,0,1,0.14285714285714285,1,0.0,0,0,0,0,0,0,0,1,0,0,1,1
985,14944,g4UocDcFYSnUbOlhUZMBUfqXzzGSRrqN,7GRhBDsirIGkRZBtSMEzNTyDr2JQm4xx,1,0,0,0,0,0,1,0,1,0.14285714285714285,1,0.0,0,0,0,0,0,0,0,1,0,0,1,1
986,14990,5VgPwWusKQIJc1LutXp6JyAv3fzKgfIX,7GRhBDsirIGkRZBtSMEzNTyDr2JQm4xx,43,79,33,45,30,1,10,0,198,28.285714285714285,6,0.0,38,33,42,30,41,1,3,10,0,143,55,1
987,15016,yZ9FndAKqVsKwZtO1B2JJJblefdbhZ02,7GRhBDsirIGkRZBtSMEzNTyDr2JQm4xx,41,46,11,60,14,36,27,0,194,27.714285714285715,6,0.0,28,11,60,14,18,36,0,27,0,113,81,1
988,15017,Qp9WPjKz2PASr9CWx9cGEYZGKd1Nemqr,7GRhBDsirIGkRZBtSMEzNTyDr2JQm4xx,20,34,11,27,5,62,23,0,162,23.142857142857142,2,0.0,18,11,24,5,16,62,3,23,0,58,104,1
989,15107,HFGNqnAY2MWiYF3III5EKx6o7tu1uiwJ,7GRhBDsirIGkRZBtSMEzNTyDr2JQm4xx,85,219,93,173,49,72,33,1,640,91.42857142857143,12,0.0,79,93,146,49,140,72,27,33,1,367,273,1
990,15110,5zX31TZPkBQ4nxGKP7lPYFABTGNW6PHa,7GRhBDsirIGkRZBtSMEzNTyDr2JQm4xx,8,5,3,0,3,2,2,0,15,2.142857142857143,2,0.0,1,3,0,3,4,2,0,2,0,7,8,1
991,15132,uOfATV0WsL0BPHDdVyS70rl0sYjdudpd,7GRhBDsirIGkRZBtSMEzNTyDr2JQm4xx,19,20,9,0,7,0,3,0,39,5.571428571428571,2,0.0,9,9,0,7,11,0,0,3,0,25,14,1
992,15164,ziRAzdRuzlLfb854mAvEaRYGuXqnCERH,7GRhBDsirIGkRZBtSMEzNTyDr2JQm4xx,71,168,52,142,24,7,28,0,421,60.142857142857146,6,0.0,92,52,117,24,76,7,25,28,0,285,136,0
993,15178,28PHU9suTM8EqUKsQwsvQ03DzFXi0yDl,7GRhBDsirIGkRZBtSMEzNTyDr2JQm4xx,61,102,33,110,37,14,8,0,304,43.42857142857143,6,0.0,63,33,87,37,39,14,23,8,0,220,84,0
994,15282,FRiuKxH98VzIG6N65WQEkvVSqVJx6TSd,7GRhBDsirIGkRZBtSMEzNTyDr2JQm4xx,40,90,22,70,27,0,6,0,215,30.714285714285715,3,0.0,62,22,69,27,28,0,1,6,0,180,35,1
995,15318,5ApoT0ZoLbVQmiV8xOjwVDUBfTF6QDuq,7GRhBDsirIGkRZBtSMEzNTyDr2JQm4xx,25,47,19,35,15,21,23,2,162,23.142857142857142,3,0.0,23,19,29,15,24,21,6,23,2,86,76,1
996,15397,iWIAGeS3ATYiVCcaQcig63Lt0fYY4o8o,7GRhBDsirIGkRZBtSMEzNTyDr2JQm4xx,55,80,30,150,26,13,10,0,309,44.142857142857146,4,0.0,43,30,135,26,37,13,15,10,0,234,75,0
997,15445,hrmgRr5TKkTKcJMaNH4IpBZoiQT9X6aI,7GRhBDsirIGkRZBtSMEzNTyDr2JQm4xx,27,67,3,21,17,2,17,0,127,18.142857142857142,6,0.0,44,3,17,17,23,2,4,17,0,81,46,0
998,15469,udnRYxurswpE4GUZcnc80kafg0hn3fpz,7GRhBDsirIGkRZBtSMEzNTyDr2JQm4xx,6,7,2,4,1,0,1,0,15,2.142857142857143,1,0.0,1,2,3,1,6,0,1,1,0,7,8,1
999,15478,pHniYPYuaHgPmhy34oeWjiQMJE6eXmrA,7GRhBDsirIGkRZBtSMEzNTyDr2JQm4xx,1,0,0,0,0,0,1,0,1,0.14285714285714285,1,0.0,0,0,0,0,0,0,0,1,0,0,1,1
1000,15484,2OBbYlHxjDvtkcifhxwhxMZlYPhEHOro,7GRhBDsirIGkRZBtSMEzNTyDr2JQm4xx,47,84,7,151,4,0,14,0,260,37.142857142857146,8,0.0,36,7,132,4,48,0,19,14,0,179,81,0
1001,15541,ILkUjE8LhIAQFlZwnOqsyA4K0QvAbnzA,7GRhBDsirIGkRZBtSMEzNTyDr2JQm4xx,72,407,103,121,52,210,75,7,975,139.28571428571428,15,0.0,229,103,100,52,178,210,21,75,7,484,491,0
1002,15577,WeG9Rj8lv2ekdTamRkXPOfgW6N9lzyds,7GRhBDsirIGkRZBtSMEzNTyDr2JQm4xx,47,68,24,73,18,10,13,0,206,29.428571428571427,6,0.0,32,24,65,18,36,10,8,13,0,139,67,1
1003,15593,917a11esEUG2kjEBnxsgADWhvlUYEWb2,7GRhBDsirIGkRZBtSMEzNTyDr2JQm4xx,5,1,1,0,0,0,9,0,11,1.5714285714285714,2,0.0,0,1,0,0,1,0,0,9,0,1,10,1
1004,15596,Jag1EXQWfAuTRiCgcVLyhRRkdOL9RtSD,7GRhBDsirIGkRZBtSMEzNTyDr2JQm4xx,37,43,21,38,9,28,29,1,169,24.142857142857142,8,0.0,12,21,37,9,31,28,1,29,1,79,90,1
1005,15604,MUERAHHFAKMlIE27Ma0uSdeN9dFIyDRi,7GRhBDsirIGkRZBtSMEzNTyDr2JQm4xx,6,3,1,0,1,0,3,0,8,1.1428571428571428,2,0.0,0,1,0,1,3,0,0,3,0,2,6,1
1006,15634,oco4sYAQqzdnYEwLykTSM4qmOTgkFoAN,7GRhBDsirIGkRZBtSMEzNTyDr2JQm4xx,65,197,73,132,28,21,52,2,505,72.14285714285714,8,0.0,96,73,110,28,101,21,22,52,2,307,198,0
1007,15637,syrttArug8Mpzs9L0IHsvBtATawYF9J2,7GRhBDsirIGkRZBtSMEzNTyDr2JQm4xx,38,79,29,67,11,3,5,0,194,27.714285714285715,5,0.0,41,29,56,11,38,3,11,5,0,137,57,1
1008,15676,fT8l2Rgir0TYnZP4X9UADbvRi0H8tycH,7GRhBDsirIGkRZBtSMEzNTyDr2JQm4xx,1,0,0,0,0,0,1,0,1,0.14285714285714285,1,0.0,0,0,0,0,0,0,0,1,0,0,1,1
1009,15783,Jm4nQ05ndX10jbofbWx6S0r9VXrqia6S,7GRhBDsirIGkRZBtSMEzNTyDr2JQm4xx,52,82,33,142,14,0,12,0,283,40.42857142857143,6,0.0,32,33,123,14,50,0,19,12,0,202,81,0
1010,15812,zTVBZ1zOMswSgDWxrOfzKUr5J9HO6HOE,7GRhBDsirIGkRZBtSMEzNTyDr2JQm4xx,94,235,72,178,45,8,31,0,569,81.28571428571429,9,0.0,95,72,155,45,140,8,23,31,0,367,202,1
1011,15829,tD36vn1aCu8pvS184dpJPyASEvtRWzdE,7GRhBDsirIGkRZBtSMEzNTyDr2JQm4xx,35,49,20,60,16,14,5,0,164,23.428571428571427,5,0.0,22,20,53,16,27,14,7,5,0,111,53,0
1012,15836,Ms0MC4W5moiGJLWP7iE3FImeH9CHN4KT,7GRhBDsirIGkRZBtSMEzNTyDr2JQm4xx,34,83,6,49,5,0,11,0,154,22.0,6,0.0,44,6,43,5,39,0,6,11,0,98,56,0
1013,15867,itOUYtUQXKtiNJoDhHvixGSCtswgEapf,7GRhBDsirIGkRZBtSMEzNTyDr2JQm4xx,48,79,39,33,39,7,14,0,211,30.142857142857142,7,0.0,32,39,28,39,47,7,5,14,0,138,73,1
1014,16009,Slk5JcZSYHmDLQZXaNVmcMDmjJ16kBhI,7GRhBDsirIGkRZBtSMEzNTyDr2JQm4xx,76,214,27,127,19,0,17,0,404,57.714285714285715,10,0.0,98,27,106,19,116,0,21,17,0,250,154,0
1015,16016,SSM7wEvdZo8FZW0zxJcXGwdA1S6Vbn5Q,7GRhBDsirIGkRZBtSMEzNTyDr2JQm4xx,5,3,1,0,0,0,2,0,6,0.8571428571428571,1,0.0,0,1,0,0,3,0,0,2,0,1,5,1
1016,16095,2WHRUx9c3z0u3SMwexxVlR2sgx8QCphl,7GRhBDsirIGkRZBtSMEzNTyDr2JQm4xx,2,0,0,0,0,0,4,0,4,0.5714285714285714,3,0.0,0,0,0,0,0,0,0,4,0,0,4,1
1017,16109,cmnVKDF5NlWXx0AsUNgswSBrQUc0cjpO,7GRhBDsirIGkRZBtSMEzNTyDr2JQm4xx,6,3,2,0,1,0,2,0,8,1.1428571428571428,1,0.0,0,2,0,1,3,0,0,2,0,3,5,1
1018,16126,6YaJxva3ruoxqQBNg2zA6CX5WSixFgrI,7GRhBDsirIGkRZBtSMEzNTyDr2JQm4xx,59,153,46,47,33,13,14,0,306,43.714285714285715,5,0.0,80,46,47,33,73,13,0,14,0,206,100,1
1019,16137,qG2WjxxVTjr5YeDGnwFvACGaHzeUu9HC,7GRhBDsirIGkRZBtSMEzNTyDr2JQm4xx,60,63,24,32,31,3,20,2,175,25.0,5,0.0,34,24,30,31,29,3,2,20,2,119,56,1
1020,16217,ESzAGDiQvgaXvzXTziuj7JqXtnuQhUld,7GRhBDsirIGkRZBtSMEzNTyDr2JQm4xx,20,23,12,12,7,0,8,0,62,8.857142857142858,3,0.0,2,12,10,7,21,0,2,8,0,31,31,1
1021,16222,u6EnJOtoYTYGkLQOUZyVf756OPCxjorW,7GRhBDsirIGkRZBtSMEzNTyDr2JQm4xx,2,0,0,0,0,0,2,0,2,0.2857142857142857,1,0.0,0,0,0,0,0,0,0,2,0,0,2,1
1022,16235,fV5QpAWiywuCcKLCcDbuJBbZ43MyivgG,7GRhBDsirIGkRZBtSMEzNTyDr2JQm4xx,43,74,17,66,17,10,15,1,200,28.571428571428573,4,0.0,29,17,55,17,45,10,11,15,1,118,82,1
1023,16242,CtBdHmlYqpaYTMEPBvno3lS1o4khTfTp,7GRhBDsirIGkRZBtSMEzNTyDr2JQm4xx,96,134,53,136,61,28,17,4,433,61.857142857142854,8,0.0,65,53,123,61,69,28,13,17,4,302,131,1
1024,16326,vEWkXCfBtnzPc8huJqQsoGlEGR1bS2AS,7GRhBDsirIGkRZBtSMEzNTyDr2JQm4xx,29,79,33,52,20,9,7,0,200,28.571428571428573,4,0.0,38,33,41,20,41,9,11,7,0,132,68,1
1025,16350,jPtottuCTEl2a1fB4pqDjwAHNeUWQz5o,7GRhBDsirIGkRZBtSMEzNTyDr2JQm4xx,70,155,60,108,36,12,36,4,411,58.714285714285715,5,0.0,83,60,93,36,72,12,15,36,4,272,139,0
1026,16353,bONRCO0uATZ9orvOXASjWia0swY9AaMZ,7GRhBDsirIGkRZBtSMEzNTyDr2JQm4xx,62,93,23,125,20,5,6,0,272,38.857142857142854,1,0.0,37,23,102,20,56,5,23,6,0,182,90,1
1027,16384,DmRnf6emOOeLa4MI9vNggFDmgXu8cRIO,7GRhBDsirIGkRZBtSMEzNTyDr2JQm4xx,94,239,101,223,46,54,59,5,727,103.85714285714286,7,0.0,110,101,188,46,129,54,35,59,5,445,282,0
1028,16467,pz4WzmrapGULqEk99lfOZVzJbwiC2Cl1,7GRhBDsirIGkRZBtSMEzNTyDr2JQm4xx,80,257,2,166,16,84,26,5,556,79.42857142857143,7,0.0,111,2,147,16,146,84,19,26,5,276,280,1
1029,16473,aPM6Pkx8yXzDO1Wq6YMG1wXnFkTU2WLX,7GRhBDsirIGkRZBtSMEzNTyDr2JQm4xx,58,128,16,145,23,2,4,0,318,45.42857142857143,3,0.0,59,16,132,23,69,2,13,4,0,230,88,1
1030,16572,ckaBfYMRcWDmM0gkDIb3PY6kSLd0nbzq,7GRhBDsirIGkRZBtSMEzNTyDr2JQm4xx,3,0,0,0,0,0,5,0,5,0.7142857142857143,1,0.0,0,0,0,0,0,0,0,5,0,0,5,0
1031,16587,3l2AMuYrLjfvMGOYSOdPeQAMIHP0QDGn,7GRhBDsirIGkRZBtSMEzNTyDr2JQm4xx,13,20,9,10,4,9,5,0,57,8.142857142857142,3,0.0,9,9,8,4,11,9,2,5,0,30,27,0
1032,16638,QJSnryS3zb1gL3fTkTse6gK6PnzljUD1,7GRhBDsirIGkRZBtSMEzNTyDr2JQm4xx,14,17,1,36,1,1,1,0,57,8.142857142857142,1,0.0,9,1,33,1,8,1,3,1,0,44,13,1
1033,16641,nq7nltznx1EwtcnQOuGwGVLzMwD63I5W,7GRhBDsirIGkRZBtSMEzNTyDr2JQm4xx,4,6,3,0,0,0,2,0,11,1.5714285714285714,1,0.0,1,3,0,0,5,0,0,2,0,4,7,1
1034,16669,D222lqyFrC2b1DAJCNvtq2cDPE2yWdSh,7GRhBDsirIGkRZBtSMEzNTyDr2JQm4xx,46,128,49,64,35,10,24,5,315,45.0,7,0.0,49,49,59,35,79,10,5,24,5,192,123,1
1035,16792,fbDgsipajp0xhHFfXN21wQyuQBNdN7hy,7GRhBDsirIGkRZBtSMEzNTyDr2JQm4xx,93,116,47,162,50,8,12,2,397,56.714285714285715,4,0.0,55,47,140,50,61,8,22,12,2,292,105,0
1036,16816,clv7wTDLUGVcdBnHuGK5igxvVYbUFhfO,7GRhBDsirIGkRZBtSMEzNTyDr2JQm4xx,1,0,0,0,0,0,1,0,1,0.14285714285714285,1,0.0,0,0,0,0,0,0,0,1,0,0,1,1
1037,16838,krqPTjwq96uxScwTNs38D4Dn2uZHC91r,7GRhBDsirIGkRZBtSMEzNTyDr2JQm4xx,5,3,1,0,1,0,2,0,7,1.0,1,0.0,0,1,0,1,3,0,0,2,0,2,5,1
1038,16880,JxLtKAnMek98G5fWpyeTaKlh0zheuNnU,7GRhBDsirIGkRZBtSMEzNTyDr2JQm4xx,5,2,1,0,1,0,3,0,7,1.0,2,0.0,0,1,0,1,2,0,0,3,0,2,5,1
1039,16987,Ar7wri6od2sIMOfx95hPmMwDttR4wtOC,7GRhBDsirIGkRZBtSMEzNTyDr2JQm4xx,71,123,44,139,30,6,16,1,359,51.285714285714285,7,0.0,64,44,123,30,59,6,16,16,1,261,98,0
1040,17035,M76ofI2UJItYXeusDRswE1mzVX9YlrVW,7GRhBDsirIGkRZBtSMEzNTyDr2JQm4xx,75,163,51,275,4,2,12,0,507,72.42857142857143,5,0.0,105,51,239,4,58,2,36,12,0,399,108,1
1041,17060,WX5bge9EFbPypYuObEiSD1Gyvh8Z866G,7GRhBDsirIGkRZBtSMEzNTyDr2JQm4xx,38,38,19,0,22,2,9,0,90,12.857142857142858,2,0.0,14,19,0,22,24,2,0,9,0,55,35,1
1042,17088,V08OBGRnuhGVZi2iGPXN66GxN6wKZmV9,7GRhBDsirIGkRZBtSMEzNTyDr2JQm4xx,2,0,0,0,0,0,2,0,2,0.2857142857142857,1,0.0,0,0,0,0,0,0,0,2,0,0,2,1
1043,17102,queJQcMYiH8jxjXTFMi1fslIxDDACkNw,7GRhBDsirIGkRZBtSMEzNTyDr2JQm4xx,26,30,13,20,9,1,12,0,85,12.142857142857142,3,0.0,12,13,17,9,18,1,3,12,0,51,34,1
1044,17124,xOB7vl3l1Tpb0i0cSWni40BfJ5FBclms,7GRhBDsirIGkRZBtSMEzNTyDr2JQm4xx,46,139,21,94,15,2,51,2,324,46.285714285714285,7,0.0,46,21,80,15,93,2,14,51,2,162,162,0
1045,17240,g2VgGARpgGy9rA8aDCffqfXvItMu95Qi,7GRhBDsirIGkRZBtSMEzNTyDr2JQm4xx,40,78,42,60,23,17,30,1,251,35.857142857142854,5,0.0,10,42,53,23,68,17,7,30,1,128,123,0
1046,17242,OcmM4lAJy1xB9HSsEUxVtaUQ7oE5dcTp,7GRhBDsirIGkRZBtSMEzNTyDr2JQm4xx,32,69,22,30,15,1,7,0,144,20.571428571428573,6,0.0,20,22,25,15,49,1,5,7,0,82,62,0
1047,17257,E4fUiWo3de6EW3llrqGI6KBrgWgpa0OH,7GRhBDsirIGkRZBtSMEzNTyDr2JQm4xx,31,40,5,52,8,11,13,0,129,18.428571428571427,2,0.0,19,5,48,8,21,11,4,13,0,80,49,1
1048,17338,RLvXqOMggPmNW2f1XGbARyW4Nurlrkjt,7GRhBDsirIGkRZBtSMEzNTyDr2JQm4xx,4,2,0,0,0,0,3,0,5,0.7142857142857143,1,0.0,0,0,0,0,2,0,0,3,0,0,5,1
1049,17408,yV812AacRwieF2jdqr0WB58v7NmmEdx5,7GRhBDsirIGkRZBtSMEzNTyDr2JQm4xx,1,0,0,0,0,0,2,0,2,0.2857142857142857,1,0.0,0,0,0,0,0,0,0,2,0,0,2,1
1050,17485,7fC3V6ivG07wUIMOmiYFzSlyjWvbYnYf,7GRhBDsirIGkRZBtSMEzNTyDr2JQm4xx,74,117,1,275,15,11,19,0,438,62.57142857142857,7,0.0,61,1,233,15,56,11,42,19,0,310,128,0
1051,17505,X0efozcVijJghBnDtnJGbXo656NrPVoZ,7GRhBDsirIGkRZBtSMEzNTyDr2JQm4xx,2,0,0,0,0,0,2,0,2,0.2857142857142857,1,0.0,0,0,0,0,0,0,0,2,0,0,2,1
1052,17545,DGDF7EtBLvOTcfUxrOsvdCg2Ar6LlSc6,7GRhBDsirIGkRZBtSMEzNTyDr2JQm4xx,21,87,34,0,1,0,13,0,135,19.285714285714285,8,0.0,9,34,0,1,78,0,0,13,0,44,91,0
1053,17634,UA8vU3s92g3lXc62U363PEO0xor6Mpeg,7GRhBDsirIGkRZBtSMEzNTyDr2JQm4xx,53,52,23,0,33,0,6,0,114,16.285714285714285,6,0.0,21,23,0,33,31,0,0,6,0,77,37,0
1054,17673,JSViK46d91E9ikMcvKp1rzZlHAqQuH4h,7GRhBDsirIGkRZBtSMEzNTyDr2JQm4xx,4,9,4,0,0,0,1,0,14,2.0,5,0.0,0,4,0,0,9,0,0,1,0,4,10,1
1055,19583,EWAoo7AAzLTKxICthBrlzvoQ4jKqTV5Z,fbPkOYLVPtPgIt0MxizjfFJov3JbHyAi,3,2,0,0,0,2,1,0,5,0.7142857142857143,1,0.0,0,0,0,0,2,2,0,1,0,0,5,1
1056,19585,eUVqEtQR3HLmXjNHTc0FXKT2InqoH24Q,fbPkOYLVPtPgIt0MxizjfFJov3JbHyAi,4,7,2,0,2,0,2,0,13,1.8571428571428572,3,0.0,0,2,0,2,7,0,0,2,0,4,9,1
1057,19590,iES59bXqTODmGXmysyfu1geM8lUv5mwl,fbPkOYLVPtPgIt0MxizjfFJov3JbHyAi,7,7,2,0,2,0,8,0,19,2.7142857142857144,1,0.0,2,2,0,2,5,0,0,8,0,6,13,1
1058,19594,4x6w2QLFfXQ2dHDa4fBCOvJ1UYg7yE69,fbPkOYLVPtPgIt0MxizjfFJov3JbHyAi,19,19,10,13,6,12,14,2,76,10.857142857142858,4,0.0,3,10,9,6,16,12,4,14,2,28,48,1
1059,19596,lhkiaYX6n9dxQvsKk8vp6UZQBNlsuGnH,fbPkOYLVPtPgIt0MxizjfFJov3JbHyAi,46,126,56,63,35,113,54,1,448,64.0,6,0.0,55,56,45,35,71,113,18,54,1,191,257,0
1060,19605,BPDxtvSmkKR4nTdKjes8gGxzoOprTkK2,fbPkOYLVPtPgIt0MxizjfFJov3JbHyAi,6,2,1,0,1,2,4,1,11,1.5714285714285714,1,0.0,0,1,0,1,2,2,0,4,1,2,9,1
1061,19608,CJhqdTUUI9IhUemITUcGqZ2FNfX5tFcn,fbPkOYLVPtPgIt0MxizjfFJov3JbHyAi,3,1,0,0,0,0,2,0,3,0.42857142857142855,1,0.0,0,0,0,0,1,0,0,2,0,0,3,1
1062,19613,hPhvZr1dLTLTcIKq5t7vAfQqTozZXlRI,fbPkOYLVPtPgIt0MxizjfFJov3JbHyAi,38,32,25,0,19,0,4,0,80,11.428571428571429,4,0.0,0,25,0,19,32,0,0,4,0,44,36,1
1063,19614,3tr9vOqNQBlqx7G8lEAeoRN3dN5LTQt8,fbPkOYLVPtPgIt0MxizjfFJov3JbHyAi,6,5,3,0,2,0,3,1,14,2.0,1,0.0,0,3,0,2,5,0,0,3,1,5,9,1
1064,19618,oJ9j9ejTgKixczg3tSE8Sg8DPI7YQpJq,fbPkOYLVPtPgIt0MxizjfFJov3JbHyAi,10,17,8,0,4,14,3,0,46,6.571428571428571,2,0.0,4,8,0,4,13,14,0,3,0,16,30,0
1065,19619,BcKYeHv4ZKY4DeUPw2M71hKVyOhypokT,fbPkOYLVPtPgIt0MxizjfFJov3JbHyAi,21,28,16,0,11,16,10,1,82,11.714285714285714,2,0.0,0,16,0,11,28,16,0,10,1,27,55,1
1066,19625,TvUBYMbHTCcIGUIFw5l8y3Oo0Axsdspt,fbPkOYLVPtPgIt0MxizjfFJov3JbHyAi,19,31,24,0,15,4,7,0,81,11.571428571428571,3,0.0,0,24,0,15,31,4,0,7,0,39,42,1
1067,19628,eqpnrsO3UPO24LQNWGKYtfRd0DQ0MPDl,fbPkOYLVPtPgIt0MxizjfFJov3JbHyAi,13,18,1,9,3,18,15,1,65,9.285714285714286,2,0.0,9,1,7,3,9,18,2,15,1,20,45,1
1068,19632,QOCecwQRgvCytTVCFa2MB091bctR2VxO,fbPkOYLVPtPgIt0MxizjfFJov3JbHyAi,6,3,2,0,2,10,1,0,18,2.5714285714285716,1,0.0,0,2,0,2,3,10,0,1,0,4,14,1
1069,19635,fz559cnktTQw4xrHI1wICm1ao7bugAZA,fbPkOYLVPtPgIt0MxizjfFJov3JbHyAi,6,8,4,0,2,0,3,0,17,2.4285714285714284,2,0.0,0,4,0,2,8,0,0,3,0,6,11,1
1070,19637,8MQx62NrM26CEa5RRkhFUh36AiGGNx6S,fbPkOYLVPtPgIt0MxizjfFJov3JbHyAi,22,57,5,0,6,0,13,1,82,11.714285714285714,5,0.0,2,5,0,6,55,0,0,13,1,13,69,0
1071,19645,bazJXiq7ucQvx12BgvEogiLDadc2i22I,fbPkOYLVPtPgIt0MxizjfFJov3JbHyAi,6,6,2,0,2,0,3,0,13,1.8571428571428572,2,0.0,2,2,0,2,4,0,0,3,0,6,7,1
1072,19647,95Gw2yhEY17itkROcjsEWWGhFV0TNXNK,fbPkOYLVPtPgIt0MxizjfFJov3JbHyAi,26,36,19,14,9,11,10,0,99,14.142857142857142,2,0.0,11,19,14,9,25,11,0,10,0,53,46,1
1073,19651,czkVdqv8QRpY6SHliMvW81P6eofNIUuP,fbPkOYLVPtPgIt0MxizjfFJov3JbHyAi,6,2,1,0,1,0,3,0,7,1.0,1,0.0,0,1,0,1,2,0,0,3,0,2,5,1
1074,19652,UJay3MfkIPCa65Or9jDxIJTFTpNpxKv0,fbPkOYLVPtPgIt0MxizjfFJov3JbHyAi,5,10,3,0,0,0,4,0,17,2.4285714285714284,1,0.0,2,3,0,0,8,0,0,4,0,5,12,1
1075,19653,RZO451egqNvgwYLVc2DT5RZC5jtK41Wn,fbPkOYLVPtPgIt0MxizjfFJov3JbHyAi,25,26,11,18,10,0,8,1,74,10.571428571428571,3,0.0,12,11,18,10,14,0,0,8,1,51,23,0
1076,19662,tvh0r7BXEnkkRFvEGDSaxc2cnDAVPflf,fbPkOYLVPtPgIt0MxizjfFJov3JbHyAi,32,70,27,21,11,62,39,3,233,33.285714285714285,12,0.0,12,27,18,11,58,62,3,39,3,68,165,1
1077,19663,dqE1PGrWExsbP4JkEoKdSn4p50FzqbEb,fbPkOYLVPtPgIt0MxizjfFJov3JbHyAi,7,8,5,0,4,0,3,0,20,2.857142857142857,3,0.0,0,5,0,4,8,0,0,3,0,9,11,1
1078,19664,IAvuP4GGmvnNj3Zisz3jDfo3mSmXiJSb,fbPkOYLVPtPgIt0MxizjfFJov3JbHyAi,25,77,33,34,32,1,8,1,186,26.571428571428573,4,0.0,37,33,28,32,40,1,6,8,1,130,56,1
1079,19666,3mpQrDEY6qYqlUT3nGLIM1V0MOlZAk6h,fbPkOYLVPtPgIt0MxizjfFJov3JbHyAi,8,11,7,0,5,0,3,0,26,3.7142857142857144,2,0.0,1,7,0,5,10,0,0,3,0,13,13,1
1080,19669,5CV53T145kru57HDn4DelXde0UjT6xqn,fbPkOYLVPtPgIt0MxizjfFJov3JbHyAi,5,6,1,0,1,0,5,0,13,1.8571428571428572,1,0.0,3,1,0,1,3,0,0,5,0,5,8,1
1081,19670,CiNjO5C17d45NfmPbNPGATJqInGPv9eX,fbPkOYLVPtPgIt0MxizjfFJov3JbHyAi,2,0,0,0,0,0,8,0,8,1.1428571428571428,2,0.0,0,0,0,0,0,0,0,8,0,0,8,1
1082,19672,Thuw3SvsWAczQHNEJLdc52dNwXNFxJ27,fbPkOYLVPtPgIt0MxizjfFJov3JbHyAi,1,0,0,0,0,0,1,0,1,0.14285714285714285,1,0.0,0,0,0,0,0,0,0,1,0,0,1,1
1083,19673,5IM8g7YMOYo5qH7Yu3x31T3JkVOH9iqe,fbPkOYLVPtPgIt0MxizjfFJov3JbHyAi,10,18,6,0,3,5,4,0,36,5.142857142857143,2,0.0,0,6,0,3,18,5,0,4,0,9,27,1
1084,19676,gWLNrui4xJ6xOW9BQTEyWRBtLNqndryz,fbPkOYLVPtPgIt0MxizjfFJov3JbHyAi,5,3,1,0,1,3,4,0,12,1.7142857142857142,1,0.0,0,1,0,1,3,3,0,4,0,2,10,1
1085,19677,rl1ijjmPoVXrn0BLw0LMwhU2iQWvim3X,fbPkOYLVPtPgIt0MxizjfFJov3JbHyAi,61,123,74,48,35,90,14,0,384,54.857142857142854,9,0.0,38,74,44,35,85,90,4,14,0,191,193,0
1086,19680,PLKfIj5PWmJ1pq6F2TAT2ZidBGAMa6pt,fbPkOYLVPtPgIt0MxizjfFJov3JbHyAi,29,96,37,16,20,43,30,7,249,35.57142857142857,5,0.0,38,37,13,20,58,43,3,30,7,108,141,1
1087,19681,XY4zkM1XF8dydjqcvDmQyLNW1UDj6PeN,fbPkOYLVPtPgIt0MxizjfFJov3JbHyAi,18,29,15,17,10,4,7,0,82,11.714285714285714,3,0.0,8,15,15,10,21,4,2,7,0,48,34,1
1088,19682,jq3G4vNjVUo5sqAQquCFzqcPQiyiVAd4,fbPkOYLVPtPgIt0MxizjfFJov3JbHyAi,10,18,9,6,4,2,5,0,44,6.285714285714286,3,0.0,1,9,5,4,17,2,1,5,0,19,25,1
1089,19683,EqwF2QzEhw4NgIj4YX1bMoLFO7jCzOVt,fbPkOYLVPtPgIt0MxizjfFJov3JbHyAi,11,5,3,13,4,0,5,0,30,4.285714285714286,1,0.0,2,3,8,4,3,0,5,5,0,17,13,1
1090,19684,mya8TfxNbiDk3y9Od8avdqRP3ecWgTII,fbPkOYLVPtPgIt0MxizjfFJov3JbHyAi,4,3,2,0,2,19,2,0,28,4.0,2,0.0,0,2,0,2,3,19,0,2,0,4,24,1
1091,19686,CnbF8r7iTFBimMMahtVgMZeVp9U8TCPU,fbPkOYLVPtPgIt0MxizjfFJov3JbHyAi,8,14,3,0,2,5,4,1,29,4.142857142857143,1,0.0,2,3,0,2,12,5,0,4,1,7,22,1
1092,19688,RxXRKZYpbfKbF79XwFGwONhlZ3CWNuKc,fbPkOYLVPtPgIt0MxizjfFJov3JbHyAi,5,2,1,0,1,0,3,0,7,1.0,3,0.0,0,1,0,1,2,0,0,3,0,2,5,1
1093,19691,j4HDn7pHd4SauRXrARz1vjrq9gR7efiY,fbPkOYLVPtPgIt0MxizjfFJov3JbHyAi,10,22,9,0,7,0,9,0,47,6.714285714285714,1,0.0,2,9,0,7,20,0,0,9,0,18,29,1
1094,19697,94kd1qvIZ0nokZPS6BCV8qxXnL5MM2jB,fbPkOYLVPtPgIt0MxizjfFJov3JbHyAi,63,391,180,55,107,92,75,2,902,128.85714285714286,14,0.0,59,180,50,107,332,92,5,75,2,396,506,0
1095,19700,WfC8bzRtjtkKnUrmorui57fDTiw7ripx,fbPkOYLVPtPgIt0MxizjfFJov3JbHyAi,1,0,0,0,0,0,1,0,1,0.14285714285714285,1,0.0,0,0,0,0,0,0,0,1,0,0,1,1
1096,19703,PNFwnD5V878zriXX4URfko4zocKM6AxT,fbPkOYLVPtPgIt0MxizjfFJov3JbHyAi,7,5,3,0,2,1,1,0,12,1.7142857142857142,1,0.0,0,3,0,2,5,1,0,1,0,5,7,1
1097,19704,5WAIxgqU8QRTpOrU8O3vmj4h4ZKof8jn,fbPkOYLVPtPgIt0MxizjfFJov3JbHyAi,6,6,2,0,2,3,1,0,14,2.0,1,0.0,3,2,0,2,3,3,0,1,0,7,7,1
1098,19706,ZgQ15hhI1Ucp5464waJfnBAlAZitQ6GS,fbPkOYLVPtPgIt0MxizjfFJov3JbHyAi,30,37,20,19,16,0,13,0,105,15.0,4,0.0,12,20,16,16,25,0,3,13,0,64,41,1
1099,19707,mFpiELMd2y5tbkdxs4m8pKS7gXHb7bIO,fbPkOYLVPtPgIt0MxizjfFJov3JbHyAi,6,3,2,0,2,0,1,0,8,1.1428571428571428,1,0.0,0,2,0,2,3,0,0,1,0,4,4,1
1100,19710,2mdoNlBiXpgUVSmoihAheHl3NISmi738,fbPkOYLVPtPgIt0MxizjfFJov3JbHyAi,62,97,57,31,35,1,20,1,242,34.57142857142857,4,0.0,27,57,29,35,70,1,2,20,1,148,94,1
1101,19711,qqdJa21dgyzvCuC2gEGuhgU9JUiH4Miw,fbPkOYLVPtPgIt0MxizjfFJov3JbHyAi,9,12,5,6,5,5,4,0,37,5.285714285714286,1,0.0,5,5,4,5,7,5,2,4,0,19,18,1
1102,19712,YviwWEN6zon2XUnzizUs5e4hMfvZTKyo,fbPkOYLVPtPgIt0MxizjfFJov3JbHyAi,10,19,10,0,6,4,9,0,48,6.857142857142857,4,0.0,0,10,0,6,19,4,0,9,0,16,32,1
1103,19716,VDczqRqblkMPJmrAoZEhPuTYAP3s4BVi,fbPkOYLVPtPgIt0MxizjfFJov3JbHyAi,8,6,4,0,3,0,5,0,18,2.5714285714285716,2,0.0,0,4,0,3,6,0,0,5,0,7,11,1
1104,19717,vs0vqlNXzuHsqVxOsB15kGfpvGf2pUt3,fbPkOYLVPtPgIt0MxizjfFJov3JbHyAi,1,0,0,0,0,0,1,0,1,0.14285714285714285,1,0.0,0,0,0,0,0,0,0,1,0,0,1,1
1105,19718,E4lbnSGpFm0DLoI5I2cB98rKNvfek7Pe,fbPkOYLVPtPgIt0MxizjfFJov3JbHyAi,9,3,2,0,2,0,6,1,14,2.0,1,0.0,0,2,0,2,3,0,0,6,1,4,10,1
1106,19724,iaR2pnkwyNY3r5zTqD1W39STthtx49ji,fbPkOYLVPtPgIt0MxizjfFJov3JbHyAi,26,56,18,17,16,0,11,0,118,16.857142857142858,4,0.0,23,18,15,16,33,0,2,11,0,72,46,1
1107,19725,47CO43LdBnUCItnxzVzNK8EGYhZB4UEL,fbPkOYLVPtPgIt0MxizjfFJov3JbHyAi,5,2,1,0,1,0,2,0,6,0.8571428571428571,1,0.0,0,1,0,1,2,0,0,2,0,2,4,0
1108,19727,bL3u5qIjoppYFsMUfGswfFLujxnAggge,fbPkOYLVPtPgIt0MxizjfFJov3JbHyAi,31,76,39,14,35,66,28,4,262,37.42857142857143,7,0.0,22,39,14,35,54,66,0,28,4,110,152,0
1109,19728,klABCgiMhTPJ0XO3mm3Xvqo3F5v3JzEw,fbPkOYLVPtPgIt0MxizjfFJov3JbHyAi,2,0,0,0,0,0,2,0,2,0.2857142857142857,1,0.0,0,0,0,0,0,0,0,2,0,0,2,1
1110,19729,GP9uxCl0w0ORUxGcBwBhHCA6EDx2EOSR,fbPkOYLVPtPgIt0MxizjfFJov3JbHyAi,10,13,9,0,6,6,16,1,51,7.285714285714286,2,0.0,0,9,0,6,13,6,0,16,1,15,36,1
1111,19734,PwwEqEv3o1wfWN5Eu8NuK3q82yRAO9LK,fbPkOYLVPtPgIt0MxizjfFJov3JbHyAi,9,4,3,0,3,0,3,0,13,1.8571428571428572,2,0.0,0,3,0,3,4,0,0,3,0,6,7,1
1112,19736,RTFyJMIqIq6xWTPdoUugdDSXlWY0NS3w,fbPkOYLVPtPgIt0MxizjfFJov3JbHyAi,3,0,0,0,0,2,3,0,5,0.7142857142857143,1,0.0,0,0,0,0,0,2,0,3,0,0,5,1
1113,19737,r5nHhhPp8wNqkUKwaWfUvmNqly1MZrKz,fbPkOYLVPtPgIt0MxizjfFJov3JbHyAi,8,10,2,0,2,1,2,0,17,2.4285714285714284,2,0.0,1,2,0,2,9,1,0,2,0,5,12,0
1114,19739,XyD01HhzMuHzP5ArHNJFexoSZMamD6Wh,fbPkOYLVPtPgIt0MxizjfFJov3JbHyAi,6,7,4,0,1,0,3,0,15,2.142857142857143,2,0.0,1,4,0,1,6,0,0,3,0,6,9,1
1115,19740,J0agIiDPDsO7EgNBs76RsZQyZ6XLl2nX,fbPkOYLVPtPgIt0MxizjfFJov3JbHyAi,9,5,5,0,4,0,6,0,20,2.857142857142857,2,0.0,0,5,0,4,5,0,0,6,0,9,11,1
1116,19741,IMwEerHys6R3vOnp3J0coaa20HaLBM5L,fbPkOYLVPtPgIt0MxizjfFJov3JbHyAi,8,8,4,0,2,0,6,0,20,2.857142857142857,2,0.0,1,4,0,2,7,0,0,6,0,7,13,1
1117,19747,5QI6OaFhCHlCtRcFfvDdZQ38fgw6K7ZS,fbPkOYLVPtPgIt0MxizjfFJov3JbHyAi,2,0,0,0,0,0,3,0,3,0.42857142857142855,1,0.0,0,0,0,0,0,0,0,3,0,0,3,1
1118,19749,0artPLh8IkCTAf124kxiUrz2J9bSLV97,fbPkOYLVPtPgIt0MxizjfFJov3JbHyAi,13,23,13,0,4,2,10,1,53,7.571428571428571,5,0.0,3,13,0,4,20,2,0,10,1,20,33,1
1119,19750,g80H6iY57adZtyt3qdJsUFLOZl0two6T,fbPkOYLVPtPgIt0MxizjfFJov3JbHyAi,6,3,1,0,1,0,4,0,9,1.2857142857142858,1,0.0,0,1,0,1,3,0,0,4,0,2,7,1
1120,19751,21WmZ1MYMXM5lnwi17lhbA5W7URRxFf7,fbPkOYLVPtPgIt0MxizjfFJov3JbHyAi,2,0,0,0,0,0,2,0,2,0.2857142857142857,1,0.0,0,0,0,0,0,0,0,2,0,0,2,1
1121,19755,jMt06vkBXL8VPGQpBPqacOfIuLzrVTe6,fbPkOYLVPtPgIt0MxizjfFJov3JbHyAi,14,18,11,5,8,37,7,0,86,12.285714285714286,2,0.0,3,11,4,8,15,37,1,7,0,26,60,1
1122,19756,rYmGXfabWDSzV9Y1YJe1P9bXx90UHqZS,fbPkOYLVPtPgIt0MxizjfFJov3JbHyAi,7,9,2,0,3,0,6,0,20,2.857142857142857,1,0.0,5,2,0,3,4,0,0,6,0,10,10,1
1123,19760,fKydOJi1gInT4LhNbAI1K5Nn83QpbQ9b,fbPkOYLVPtPgIt0MxizjfFJov3JbHyAi,10,6,4,0,3,0,15,1,29,4.142857142857143,3,0.0,0,4,0,3,6,0,0,15,1,7,22,1
1124,19761,2ZVrSpja22JYuBdqG7iHOipKnnGEm2ou,fbPkOYLVPtPgIt0MxizjfFJov3JbHyAi,46,79,38,30,24,25,32,2,230,32.857142857142854,6,0.0,25,38,24,24,54,25,6,32,2,111,119,0
1125,19764,IHJGcg8XuB6HPRBrjHVn1eWwbgo7JSEZ,fbPkOYLVPtPgIt0MxizjfFJov3JbHyAi,26,23,12,18,9,0,5,0,67,9.571428571428571,3,0.0,6,12,18,9,17,0,0,5,0,45,22,1
1126,19765,oZrYS5rqR18A77jULvm9aJ8bGsP88f4h,fbPkOYLVPtPgIt0MxizjfFJov3JbHyAi,37,103,52,21,25,8,33,2,244,34.857142857142854,12,0.0,18,52,17,25,85,8,4,33,2,112,132,0
1127,19770,HneXab7aMQtYruvuxuZ9dNY5QxwlGitq,fbPkOYLVPtPgIt0MxizjfFJov3JbHyAi,17,19,11,12,8,2,11,1,64,9.142857142857142,2,0.0,4,11,9,8,15,2,3,11,1,32,32,1
1128,19772,fKgU6PKVjgAnp4uvGa6MHJe7D2ZYaBc1,fbPkOYLVPtPgIt0MxizjfFJov3JbHyAi,22,56,27,17,24,16,8,3,151,21.571428571428573,4,0.0,20,27,13,24,36,16,4,8,3,84,67,1
1129,19773,VryhTUuSCWlg2ThKmkz8AynIgw8SfZgv,fbPkOYLVPtPgIt0MxizjfFJov3JbHyAi,10,5,3,0,3,0,3,0,14,2.0,1,0.0,0,3,0,3,5,0,0,3,0,6,8,1
1130,19774,R0JUZ056kzFL6PD0dHwCASPDjJEFALuj,fbPkOYLVPtPgIt0MxizjfFJov3JbHyAi,68,189,109,63,76,33,27,3,500,71.42857142857143,11,0.0,51,109,60,76,138,33,3,27,3,296,204,1
1131,19775,tA1lc3vnumj95Nh6FWr8EK0wWDHGYnC2,fbPkOYLVPtPgIt0MxizjfFJov3JbHyAi,23,23,14,10,15,4,18,3,87,12.428571428571429,3,0.0,8,14,7,15,15,4,3,18,3,44,43,1
1132,19778,8b7ZppycC3YQh10hFhgFNseCAwtseLj5,fbPkOYLVPtPgIt0MxizjfFJov3JbHyAi,5,2,1,0,1,0,2,0,6,0.8571428571428571,1,0.0,0,1,0,1,2,0,0,2,0,2,4,0
1133,19784,KqVrk2SHI9QdxCC7nQf6EBD4bfm6dNDK,fbPkOYLVPtPgIt0MxizjfFJov3JbHyAi,39,43,21,25,12,52,27,4,184,26.285714285714285,4,0.0,11,21,21,12,32,52,4,27,4,65,119,1
1134,19786,pVW1QDTezd5CM1iZ8cdugaLwJl6C95dO,fbPkOYLVPtPgIt0MxizjfFJov3JbHyAi,1,0,0,0,0,0,1,0,1,0.14285714285714285,1,0.0,0,0,0,0,0,0,0,1,0,0,1,1
1135,19787,Uud6ejfxjo2wR9C9pIlBSyKMyMrHfe52,fbPkOYLVPtPgIt0MxizjfFJov3JbHyAi,24,30,26,0,21,29,4,0,110,15.714285714285714,8,0.0,0,26,0,21,30,29,0,4,0,47,63,1
1136,19792,gmI36QrP5V0XjdeY5fw2LtMzPgNNn1eX,fbPkOYLVPtPgIt0MxizjfFJov3JbHyAi,12,10,5,5,6,0,2,0,28,4.0,1,0.0,2,5,4,6,8,0,1,2,0,17,11,1
1137,19796,szY7iRYrnZrzBCwm4obBzatvtWaWEKSz,fbPkOYLVPtPgIt0MxizjfFJov3JbHyAi,13,16,10,13,9,0,1,0,49,7.0,1,0.0,5,10,9,9,11,0,4,1,0,33,16,1
1138,19797,kV0etVT4eF07a55Y2wFFrCm2NuKlfy3O,fbPkOYLVPtPgIt0MxizjfFJov3JbHyAi,11,14,7,0,4,0,4,1,30,4.285714285714286,2,0.0,0,7,0,4,14,0,0,4,1,11,19,1
1139,19801,eRM1cqDGfrej4Riud5wVHQPpEv2yAjcd,fbPkOYLVPtPgIt0MxizjfFJov3JbHyAi,12,11,8,0,7,1,3,0,30,4.285714285714286,3,0.0,0,8,0,7,11,1,0,3,0,15,15,1
1140,19802,JOTZzIfdhlRRSJT88VvraViqFb0FOnua,fbPkOYLVPtPgIt0MxizjfFJov3JbHyAi,9,8,5,0,1,0,7,0,21,3.0,2,0.0,0,5,0,1,8,0,0,7,0,6,15,1
1141,19805,mulCI7iOK8lLmqauH7xJJcesnUywr862,fbPkOYLVPtPgIt0MxizjfFJov3JbHyAi,1,0,0,0,0,0,1,0,1,0.14285714285714285,1,0.0,0,0,0,0,0,0,0,1,0,0,1,1
1142,19808,iv92crQZIzkBMlffqmkcGn935WuSz4il,fbPkOYLVPtPgIt0MxizjfFJov3JbHyAi,12,14,7,0,4,1,9,1,36,5.142857142857143,1,0.0,0,7,0,4,14,1,0,9,1,11,25,1
1143,19811,i3UVHHN0j4qIwZlYLBYHJICyHTcdcLCq,fbPkOYLVPtPgIt0MxizjfFJov3JbHyAi,5,2,1,0,1,0,2,0,6,0.8571428571428571,1,0.0,0,1,0,1,2,0,0,2,0,2,4,1
1144,19812,mnOHLhQDMWuHBooceLF0rczqDD9bUim8,fbPkOYLVPtPgIt0MxizjfFJov3JbHyAi,7,8,5,0,3,0,3,0,19,2.7142857142857144,2,0.0,1,5,0,3,7,0,0,3,0,9,10,1
1145,19813,QBgKSCSCtuy3kameVOAw6Wwz0K2iKBbH,fbPkOYLVPtPgIt0MxizjfFJov3JbHyAi,7,1,1,0,1,0,7,0,10,1.4285714285714286,1,0.0,0,1,0,1,1,0,0,7,0,2,8,1
1146,19816,08IVc3h7dXZMEursFSIPoikCC2aZN7Rx,fbPkOYLVPtPgIt0MxizjfFJov3JbHyAi,6,2,1,0,1,0,5,1,10,1.4285714285714286,1,0.0,0,1,0,1,2,0,0,5,1,2,8,1
1147,19817,8FipiYFD5ufymfN3QkHjea5yaJKq4FqA,fbPkOYLVPtPgIt0MxizjfFJov3JbHyAi,14,13,7,0,5,0,14,1,40,5.714285714285714,2,0.0,3,7,0,5,10,0,0,14,1,15,25,1
1148,19826,HuDb7M7dL9QrDMvQSMZiZjXQu7KASVlk,fbPkOYLVPtPgIt0MxizjfFJov3JbHyAi,1,0,0,0,0,0,1,0,1,0.14285714285714285,1,0.0,0,0,0,0,0,0,0,1,0,0,1,1
1149,19830,J19fRobYymSKSws9Yoy23YPes8L6wyrW,fbPkOYLVPtPgIt0MxizjfFJov3JbHyAi,22,22,16,0,10,6,21,3,78,11.142857142857142,4,0.0,0,16,0,10,22,6,0,21,3,26,52,1
1150,19831,TuwawmYF5vKqxlkjFW9KLE2z6pGSYesW,fbPkOYLVPtPgIt0MxizjfFJov3JbHyAi,7,3,2,0,2,0,2,0,9,1.2857142857142858,1,0.0,0,2,0,2,3,0,0,2,0,4,5,1
1151,19832,5SmzJtCsl9zVvD6aNu6O5oGjHDZpcVHV,fbPkOYLVPtPgIt0MxizjfFJov3JbHyAi,5,3,2,0,0,1,3,1,10,1.4285714285714286,1,0.0,0,2,0,0,3,1,0,3,1,2,8,1
1152,19835,ERdNSLuXe4QWBWuCUcfh6NqIoQCrGXv1,fbPkOYLVPtPgIt0MxizjfFJov3JbHyAi,23,21,10,19,10,0,2,0,62,8.857142857142858,3,0.0,7,10,15,10,14,0,4,2,0,42,20,1
1153,19837,iPJRBluqQatkmbuqumnMGE3SRxlXa7A1,fbPkOYLVPtPgIt0MxizjfFJov3JbHyAi,1,0,0,0,0,0,1,0,1,0.14285714285714285,1,0.0,0,0,0,0,0,0,0,1,0,0,1,1
1154,19839,dsDDZP1tTIurmngds776Mxkx99B7QaoD,fbPkOYLVPtPgIt0MxizjfFJov3JbHyAi,8,7,5,0,4,0,3,0,19,2.7142857142857144,2,0.0,0,5,0,4,7,0,0,3,0,9,10,1
1155,19845,FOhKzePMHLals6J3nHBPn1VH8EqTuIWc,fbPkOYLVPtPgIt0MxizjfFJov3JbHyAi,7,3,2,0,2,0,6,0,13,1.8571428571428572,2,0.0,0,2,0,2,3,0,0,6,0,4,9,1
1156,19846,3mL78JhEm154Hwp0XQW8ZVuzbvUw5uCk,fbPkOYLVPtPgIt0MxizjfFJov3JbHyAi,4,2,1,0,0,0,3,0,6,0.8571428571428571,1,0.0,0,1,0,0,2,0,0,3,0,1,5,1
1157,19848,VZNenETJcretQ75QoBMXgygqhUZNWX9e,fbPkOYLVPtPgIt0MxizjfFJov3JbHyAi,7,6,2,0,1,0,2,0,11,1.5714285714285714,1,0.0,0,2,0,1,6,0,0,2,0,3,8,1
1158,19856,cNw6DSimidnnJTy63mT8fC6ow4HuQb5s,fbPkOYLVPtPgIt0MxizjfFJov3JbHyAi,46,91,59,27,32,38,21,2,270,38.57142857142857,4,0.0,24,59,24,32,67,38,3,21,2,139,131,0
1159,19858,j0qtw4MyzPS0BrZiuGQy55Y9HiEw9Wyz,fbPkOYLVPtPgIt0MxizjfFJov3JbHyAi,7,7,2,0,2,0,7,0,18,2.5714285714285716,2,0.0,0,2,0,2,7,0,0,7,0,4,14,1
1160,19862,jWsLxS98Uf5iPgurn9PRvQM3beT2rSkF,fbPkOYLVPtPgIt0MxizjfFJov3JbHyAi,2,0,0,0,0,0,3,0,3,0.42857142857142855,1,0.0,0,0,0,0,0,0,0,3,0,0,3,1
1161,19863,cL4725Y58Cl01IjeOv5CCdtpjNF0EqJp,fbPkOYLVPtPgIt0MxizjfFJov3JbHyAi,1,0,0,0,0,0,1,0,1,0.14285714285714285,1,0.0,0,0,0,0,0,0,0,1,0,0,1,1
1162,19864,xpAxjSreQEJGjM28FJsQcyiEt1VA8RXl,fbPkOYLVPtPgIt0MxizjfFJov3JbHyAi,60,140,55,68,21,21,26,0,331,47.285714285714285,13,0.0,24,55,66,21,116,21,2,26,0,166,165,0
1163,19865,bVTv3LNbSDemleiUP48OewgXg39Jt9HM,fbPkOYLVPtPgIt0MxizjfFJov3JbHyAi,2,0,0,0,0,0,3,0,3,0.42857142857142855,1,0.0,0,0,0,0,0,0,0,3,0,0,3,1
1164,19878,iuOmDEhpvOE7SqnGlPzkF3AFhAsHx7fO,fbPkOYLVPtPgIt0MxizjfFJov3JbHyAi,18,30,9,21,6,0,11,0,77,11.0,4,0.0,8,9,17,6,22,0,4,11,0,40,37,1
1165,19880,7cdSr9CqRrEGZIWG84xbV4x3Kafz72lh,fbPkOYLVPtPgIt0MxizjfFJov3JbHyAi,16,17,7,10,9,1,5,1,50,7.142857142857143,3,0.0,9,7,8,9,8,1,2,5,1,33,17,1
1166,19881,PW9Md9XLqRR5MZXK4hL3T3H1o4IZAcWS,fbPkOYLVPtPgIt0MxizjfFJov3JbHyAi,5,3,1,0,1,0,2,0,7,1.0,1,0.0,0,1,0,1,3,0,0,2,0,2,5,1
1167,19882,bISN9xXdPBM2gxjOPU4uIyceAQnHyeaO,fbPkOYLVPtPgIt0MxizjfFJov3JbHyAi,9,11,3,0,1,0,5,0,20,2.857142857142857,1,0.0,0,3,0,1,11,0,0,5,0,4,16,1
1168,19883,oBB4V7EIN8ossAzWm6ldlqIytEJdobH7,fbPkOYLVPtPgIt0MxizjfFJov3JbHyAi,13,27,16,0,10,53,19,4,129,18.428571428571427,5,0.0,4,16,0,10,23,53,0,19,4,30,99,1
1169,19890,IVtvtdZLBtL9DhFAioWkcCx38OrFXpXg,fbPkOYLVPtPgIt0MxizjfFJov3JbHyAi,40,141,64,47,0,60,51,2,365,52.142857142857146,15,0.0,45,64,44,0,96,60,3,51,2,153,212,0
1170,19891,wgvtQPGwXLcgDRyRFzsNLvjTzjo4pZey,fbPkOYLVPtPgIt0MxizjfFJov3JbHyAi,11,7,4,0,2,1,11,1,26,3.7142857142857144,1,0.0,0,4,0,2,7,1,0,11,1,6,20,1
1171,19892,W2otfyc3X4TPBPK1UZBOKMi0pFwInYnb,fbPkOYLVPtPgIt0MxizjfFJov3JbHyAi,8,2,1,0,1,1,5,1,11,1.5714285714285714,1,0.0,0,1,0,1,2,1,0,5,1,2,9,0
1172,19899,g1LjBGhO06u71QjhH8AiBdRCV0auffeV,fbPkOYLVPtPgIt0MxizjfFJov3JbHyAi,5,2,1,0,1,0,2,0,6,0.8571428571428571,1,0.0,0,1,0,1,2,0,0,2,0,2,4,1
1173,19900,b7PuwalmdIR7gI2f0kgWK9mhLJEyGy0c,fbPkOYLVPtPgIt0MxizjfFJov3JbHyAi,1,0,0,0,0,0,1,0,1,0.14285714285714285,1,0.0,0,0,0,0,0,0,0,1,0,0,1,1
1174,19901,d45S9FtiK3JaUn5gt0gBKZnLs0OGVQHt,fbPkOYLVPtPgIt0MxizjfFJov3JbHyAi,18,13,10,0,10,1,7,1,42,6.0,2,0.0,2,10,0,10,11,1,0,7,1,22,20,1
1175,19902,WaEPHAZo5pH7Npa5iwnKZ2EJATuLkfKt,fbPkOYLVPtPgIt0MxizjfFJov3JbHyAi,15,23,2,0,2,0,7,0,34,4.857142857142857,2,0.0,2,2,0,2,21,0,0,7,0,6,28,1
1176,19904,C7C4g4nHC5w1aNh5moBHlv2F8Oo4TbRT,fbPkOYLVPtPgIt0MxizjfFJov3JbHyAi,11,8,5,0,4,0,2,0,19,2.7142857142857144,1,0.0,0,5,0,4,8,0,0,2,0,9,10,1
1177,19909,eGMQ402zeENVOKkP29KRxs0f1wZX1TvA,fbPkOYLVPtPgIt0MxizjfFJov3JbHyAi,5,4,0,0,0,0,2,0,6,0.8571428571428571,1,0.0,0,0,0,0,4,0,0,2,0,0,6,1
1178,19910,1Epnr53yLJpI4d6wSWAUymSv0Yujn22A,fbPkOYLVPtPgIt0MxizjfFJov3JbHyAi,44,77,41,43,27,1,25,0,214,30.571428571428573,4,0.0,25,41,38,27,52,1,5,25,0,131,83,0
1179,19911,JZFzammsPtqI96gZi5jjWsT1PaVAEh64,fbPkOYLVPtPgIt0MxizjfFJov3JbHyAi,4,2,1,0,1,0,3,0,7,1.0,1,0.0,0,1,0,1,2,0,0,3,0,2,5,1
1180,19913,XbORnKU4LaOdLNHafCieVF22rPhRdsHM,fbPkOYLVPtPgIt0MxizjfFJov3JbHyAi,8,9,5,0,4,0,2,0,20,2.857142857142857,2,0.0,0,5,0,4,9,0,0,2,0,9,11,1
1181,19914,iUELwsAOi144Gv3ZwF4pg4MHhyg4VTy9,fbPkOYLVPtPgIt0MxizjfFJov3JbHyAi,7,3,2,0,2,0,2,0,9,1.2857142857142858,1,0.0,0,2,0,2,3,0,0,2,0,4,5,1
1182,19915,qFnFxVZ0kWnoJ6Z9EGCtfX2XIxJ2ju5D,fbPkOYLVPtPgIt0MxizjfFJov3JbHyAi,9,5,3,0,2,0,8,0,18,2.5714285714285716,2,0.0,0,3,0,2,5,0,0,8,0,5,13,0
1183,19919,RIeL3dVlafJn0CvzFRWYuhAjPOY5jm6q,fbPkOYLVPtPgIt0MxizjfFJov3JbHyAi,8,9,3,0,2,0,4,0,18,2.5714285714285716,1,0.0,0,3,0,2,9,0,0,4,0,5,13,1
1184,19921,3CdjWVi2KulUMxBQEG35wDbgAd5vv1rf,fbPkOYLVPtPgIt0MxizjfFJov3JbHyAi,1,0,0,0,0,0,1,0,1,0.14285714285714285,1,0.0,0,0,0,0,0,0,0,1,0,0,1,1
1185,19922,1qrewX2JRhRs3lyeTFWMYnwQw6V9CpLd,fbPkOYLVPtPgIt0MxizjfFJov3JbHyAi,12,9,5,0,4,0,4,0,22,3.142857142857143,2,0.0,0,5,0,4,9,0,0,4,0,9,13,1
1186,19923,a0YvhqmPpF6B62CVp5XUUUyQ2cFSSLDq,fbPkOYLVPtPgIt0MxizjfFJov3JbHyAi,7,8,6,0,5,4,3,0,26,3.7142857142857144,2,0.0,0,6,0,5,8,4,0,3,0,11,15,1
1187,19924,OT5T42YlAbCtocwISa5ev3ROMYVra29q,fbPkOYLVPtPgIt0MxizjfFJov3JbHyAi,5,2,1,0,1,3,4,0,11,1.5714285714285714,2,0.0,0,1,0,1,2,3,0,4,0,2,9,1
1188,19925,u82lBhpDxJIwlZISEntCxj1zgVFdW0vT,fbPkOYLVPtPgIt0MxizjfFJov3JbHyAi,1,0,0,0,0,0,5,0,5,0.7142857142857143,2,0.0,0,0,0,0,0,0,0,5,0,0,5,1
1189,19927,tfmBOfTcprRGNfQ7gzFBd9blOJuDxGOv,fbPkOYLVPtPgIt0MxizjfFJov3JbHyAi,1,0,0,0,0,0,1,0,1,0.14285714285714285,1,0.0,0,0,0,0,0,0,0,1,0,0,1,1
1190,19929,rVO8IsFZOLqwyY7i49TyObO4q8Yse38O,fbPkOYLVPtPgIt0MxizjfFJov3JbHyAi,23,27,0,19,1,8,9,1,65,9.285714285714286,3,0.0,8,0,16,1,19,8,3,9,1,25,40,1
1191,19930,5YTEHfbdjCMCzr5G677ZGUzXcQxELgAb,fbPkOYLVPtPgIt0MxizjfFJov3JbHyAi,5,3,2,0,2,0,3,0,10,1.4285714285714286,2,0.0,0,2,0,2,3,0,0,3,0,4,6,1
1192,19931,Mae23dMejP7a3ejG0UsFTeoQgkbLs5l7,fbPkOYLVPtPgIt0MxizjfFJov3JbHyAi,2,0,0,0,0,0,4,0,4,0.5714285714285714,1,0.0,0,0,0,0,0,0,0,4,0,0,4,1
1193,19944,tShEWwQUmNvdJJLgb6IWQwSvspfEXM5K,fbPkOYLVPtPgIt0MxizjfFJov3JbHyAi,8,6,4,0,2,0,3,0,15,2.142857142857143,2,0.0,0,4,0,2,6,0,0,3,0,6,9,1
1194,19945,k6ezCrD5h8una2gKZ9FLMwuP5gpk8HYa,fbPkOYLVPtPgIt0MxizjfFJov3JbHyAi,8,3,2,0,2,0,5,0,12,1.7142857142857142,1,0.0,0,2,0,2,3,0,0,5,0,4,8,1
1195,19946,l9HZDhlAzMA7SQE77dy0GfpgPqHQZI8y,fbPkOYLVPtPgIt0MxizjfFJov3JbHyAi,12,24,11,11,9,1,12,0,68,9.714285714285714,1,0.0,7,11,8,9,17,1,3,12,0,35,33,0
1196,19950,ok15ssTMon44FKUffK29mVEN6xTGU7F9,fbPkOYLVPtPgIt0MxizjfFJov3JbHyAi,4,2,0,0,0,0,2,0,4,0.5714285714285714,1,0.0,0,0,0,0,2,0,0,2,0,0,4,1
1197,19952,qzE4xRGg4xgP1uXuFdpBCVtFm7DMRWEv,fbPkOYLVPtPgIt0MxizjfFJov3JbHyAi,17,53,0,27,13,1,13,5,112,16.0,1,0.0,35,0,19,13,18,1,8,13,5,67,45,1
1198,19954,eL4FSQJCTtWaJ5Qlsbb1oH9XvIKsOuUy,fbPkOYLVPtPgIt0MxizjfFJov3JbHyAi,9,3,2,0,2,5,6,0,18,2.5714285714285716,1,0.0,0,2,0,2,3,5,0,6,0,4,14,1
1199,19957,1dkRu3NI0VUWfhY3RmHWMkMxYXCnS1Uj,fbPkOYLVPtPgIt0MxizjfFJov3JbHyAi,11,14,10,0,9,1,10,3,47,6.714285714285714,1,0.0,2,10,0,9,12,1,0,10,3,21,26,1
1200,21469,5oy5I8Xh5KkzBBzgBTkYXJ5uADqnzeVC,7GRhBDsirIGkRZBtSMEzNTyDr2JQm4xx,69,192,52,119,37,30,14,0,444,63.42857142857143,7,0.0,84,52,97,37,108,30,22,14,0,270,174,0
1201,21478,43nq30xhRsgmZVAWkH8Zjb7IyZDGRDeY,7GRhBDsirIGkRZBtSMEzNTyDr2JQm4xx,68,194,59,116,41,94,30,0,534,76.28571428571429,9,0.0,108,59,103,41,86,94,13,30,0,311,223,0
1202,21498,pqUcxq00SFcjmnxHDdHJfvpMD3HzyhM8,7GRhBDsirIGkRZBtSMEzNTyDr2JQm4xx,40,75,26,51,18,19,13,3,205,29.285714285714285,2,0.0,25,26,42,18,50,19,9,13,3,111,94,1
1203,21499,L74tKRZpBi1qsh0NM3EwE5D87acCLK8s,7GRhBDsirIGkRZBtSMEzNTyDr2JQm4xx,77,120,44,149,12,0,32,0,357,51.0,7,0.0,58,44,133,12,62,0,16,32,0,247,110,0
1204,21500,SkSNdONKSsRL2ZUQhM3bWRg6jfQsm6hV,7GRhBDsirIGkRZBtSMEzNTyDr2JQm4xx,20,12,8,0,7,1,6,0,34,4.857142857142857,2,0.0,2,8,0,7,10,1,0,6,0,17,17,1
1205,21503,PUFh3BsQaDVIJMDvwsFTqkrgAzvjO9ME,7GRhBDsirIGkRZBtSMEzNTyDr2JQm4xx,8,7,2,0,1,0,9,0,19,2.7142857142857144,3,0.0,0,2,0,1,7,0,0,9,0,3,16,1
1206,21528,S5RuYbQmA5K156juNY12D97yGDmISJaQ,7GRhBDsirIGkRZBtSMEzNTyDr2JQm4xx,26,68,1,19,1,0,4,0,93,13.285714285714286,3,0.0,29,1,12,1,39,0,7,4,0,43,50,0
1207,21533,zqwrod4FlqaduP76a40P1VYHXufy1EKD,7GRhBDsirIGkRZBtSMEzNTyDr2JQm4xx,7,3,2,0,1,5,5,1,17,2.4285714285714284,1,0.0,1,2,0,1,2,5,0,5,1,4,13,0
1208,21566,r0xLQZJ7XErj8hBxXhgtLAa0ZIpucchx,7GRhBDsirIGkRZBtSMEzNTyDr2JQm4xx,16,16,13,0,10,0,2,0,41,5.857142857142857,2,0.0,0,13,0,10,16,0,0,2,0,23,18,0
1209,21832,W5CVKONt5qsYlbCwSDDjPmuQMWPx8PFD,7GRhBDsirIGkRZBtSMEzNTyDr2JQm4xx,25,35,13,10,16,0,6,0,80,11.428571428571429,2,0.0,8,13,5,16,27,0,5,6,0,42,38,0
1210,22007,eovSKdG09ZHYTXNtS1zUIy1RfsRsCibs,7GRhBDsirIGkRZBtSMEzNTyDr2JQm4xx,103,568,201,225,134,1867,197,5,3197,456.7142857142857,14,0.0,312,201,174,134,256,1867,51,197,5,821,2376,0
1211,22020,xdfT7UfbG0ewFi6FNN3zlNGBGpobyBrO,7GRhBDsirIGkRZBtSMEzNTyDr2JQm4xx,14,17,1,0,1,0,2,0,21,3.0,2,0.0,0,1,0,1,17,0,0,2,0,2,19,1
1212,22130,lw56FfuS5fUETVCyRkCnysAZop6MzvUe,7GRhBDsirIGkRZBtSMEzNTyDr2JQm4xx,15,27,10,4,3,4,8,0,56,8.0,3,0.0,8,10,3,3,19,4,1,8,0,24,32,0
1213,22148,IA6nFLwiYdBOXKobyV12AjVhFzxFaVpR,7GRhBDsirIGkRZBtSMEzNTyDr2JQm4xx,25,22,10,25,6,0,6,0,69,9.857142857142858,2,0.0,9,10,24,6,13,0,1,6,0,49,20,1
1214,22218,qpd1RINX0ghAugS9ZiQmRvWMQe2xJWfG,7GRhBDsirIGkRZBtSMEzNTyDr2JQm4xx,28,85,4,36,4,8,5,0,142,20.285714285714285,3,0.0,50,4,36,4,35,8,0,5,0,94,48,1
1215,22649,kpDqfPKqqQYJmKMTzN1Sox48V4ZPJuXL,SpATywNh6bZuzm8s1ceuBUnMUAeoAHHw,25,38,15,26,6,5,13,0,103,14.714285714285714,4,0.0,15,15,20,6,23,5,6,13,0,56,47,1
1216,22660,nwlJxZtiMdof1orslmN8VJv3ydVnbeg5,RXDvfPUBYFlVdlueBFbLW0mhhAyGEqpt,5,4,2,0,2,0,1,0,9,1.2857142857142858,1,0.0,0,2,0,2,4,0,0,1,0,4,5,1
1217,22676,CMoV5dPTzwxV3W6HJJmvW8wSnp90ZPh2,SpATywNh6bZuzm8s1ceuBUnMUAeoAHHw,21,25,18,0,10,0,10,0,63,9.0,7,0.0,0,18,0,10,25,0,0,10,0,28,35,0
1218,22715,3cB0rEpxJxC0jjqfQ9EPT6ntxFajOXrx,SpATywNh6bZuzm8s1ceuBUnMUAeoAHHw,26,76,33,32,11,25,18,1,196,28.0,6,0.0,23,33,26,11,53,25,6,18,1,93,103,0
1219,22724,GXmYCsHMMMsjIL2A9DYKMEw8AEscVD5s,A3fsA9Zfv1X2fVEQhTw51lKENdNrEqT3,25,26,17,32,7,3,15,3,103,14.714285714285714,3,0.0,2,17,26,7,24,3,6,15,3,52,51,0
1220,22738,83J9IXuPcwdDBJoFENdSQFWzvgELVzeu,G8EPVSXsOYB5YQWZGiz1aVq5Pgr2GrQu,25,132,43,82,9,30,26,2,324,46.285714285714285,4,0.0,52,43,61,9,80,30,21,26,2,165,159,1
1221,22741,ooFElJ4ZPOLTBMQwigtvKfnHk0DNrR2R,SpATywNh6bZuzm8s1ceuBUnMUAeoAHHw,6,3,2,0,2,0,2,0,9,1.2857142857142858,2,0.0,0,2,0,2,3,0,0,2,0,4,5,1
1222,22744,D2ho5VQQzNWAcdswkNScRjqQiNPjKhpn,A3fsA9Zfv1X2fVEQhTw51lKENdNrEqT3,11,12,1,0,1,0,15,0,29,4.142857142857143,1,0.0,0,1,0,1,12,0,0,15,0,2,27,1
1223,22747,5GeMwmyzCXMcMYfcWdKaXbpNNdL8bmPq,A3fsA9Zfv1X2fVEQhTw51lKENdNrEqT3,7,4,2,0,1,0,7,0,14,2.0,3,0.0,0,2,0,1,4,0,0,7,0,3,11,1
1224,22757,LJYBef7iIBiSZz8D7KTtMTsdkyd91gnR,SpATywNh6bZuzm8s1ceuBUnMUAeoAHHw,28,52,27,18,12,8,14,0,131,18.714285714285715,6,0.0,9,27,16,12,43,8,2,14,0,64,67,0
1225,22762,MCJiDMInWw8URpDdqHAwEp0pExHWdLRC,SpATywNh6bZuzm8s1ceuBUnMUAeoAHHw,4,2,1,0,1,0,1,0,5,0.7142857142857143,1,0.0,0,1,0,1,2,0,0,1,0,2,3,1
1226,22766,BImVQpNaWI5ZZjLENiRV2V2LYkbW88m0,RXDvfPUBYFlVdlueBFbLW0mhhAyGEqpt,40,51,25,52,12,0,4,0,144,20.571428571428573,4,0.0,11,25,50,12,40,0,2,4,0,98,46,0
1227,22776,jaMKMvlU4KDCkm4HrM0MWVH43rDA8rY1,A3fsA9Zfv1X2fVEQhTw51lKENdNrEqT3,28,22,16,0,13,0,8,1,60,8.571428571428571,4,0.0,0,16,0,13,22,0,0,8,1,29,31,1
1228,22777,jpXIq3stqWScWG27acYJbNKpdTmc6kli,A3fsA9Zfv1X2fVEQhTw51lKENdNrEqT3,51,58,44,50,29,21,19,0,221,31.571428571428573,5,0.0,3,44,44,29,55,21,6,19,0,120,101,1
1229,22787,XCY83tv4aCv2fMTPmH1QE6tZOtr7KzJT,G8EPVSXsOYB5YQWZGiz1aVq5Pgr2GrQu,133,225,93,410,16,78,63,4,889,127.0,11,0.0,79,93,331,16,146,78,79,63,4,519,370,0
1230,22800,xiHLAVx1lOeJhtdb9rNdxGApg3TIwPUZ,SpATywNh6bZuzm8s1ceuBUnMUAeoAHHw,10,12,1,6,0,0,2,0,21,3.0,2,0.0,3,1,5,0,9,0,1,2,0,9,12,1
1231,22814,zyIWmJjaz36PnMZpAzR2HEZCUbJWe8iQ,A3fsA9Zfv1X2fVEQhTw51lKENdNrEqT3,13,11,8,2,5,0,5,0,31,4.428571428571429,3,0.0,0,8,2,5,11,0,0,5,0,15,16,1
1232,22859,JJDRXXLRU75H8Dx2cuK7Td1V7D7QoKg9,RXDvfPUBYFlVdlueBFbLW0mhhAyGEqpt,43,95,2,90,12,10,26,5,240,34.285714285714285,7,0.0,34,2,72,12,61,10,18,26,5,120,120,0
1233,22876,yZi2eaDxP9Hsc5TkKYLN2LUYSBmbQGTr,SpATywNh6bZuzm8s1ceuBUnMUAeoAHHw,28,32,13,27,7,0,4,0,83,11.857142857142858,2,0.0,17,13,21,7,15,0,6,4,0,58,25,0
1234,22877,qjNUBrpwN8flYc0VorTlQJNEWSbIR2KA,A3fsA9Zfv1X2fVEQhTw51lKENdNrEqT3,60,73,7,147,3,9,17,0,256,36.57142857142857,3,0.0,7,7,128,3,66,9,19,17,0,145,111,1
1235,22880,ti1hbICHLqROy8Y7XhKRxGlLqF2ITiDH,RXDvfPUBYFlVdlueBFbLW0mhhAyGEqpt,58,64,38,132,25,0,21,0,280,40.0,6,0.0,18,38,116,25,46,0,16,21,0,197,83,0
1236,22898,t2LtqHppiTuDN14mSCfUVu9qYG7mBNAD,A3fsA9Zfv1X2fVEQhTw51lKENdNrEqT3,72,49,29,180,17,6,9,0,290,41.42857142857143,3,0.0,5,29,157,17,44,6,23,9,0,208,82,0
1237,22899,AoDbGxsdtQ88iavwLYzXC5a1sZ4YMkt5,SpATywNh6bZuzm8s1ceuBUnMUAeoAHHw,21,30,14,18,8,12,9,0,91,13.0,3,0.0,12,14,15,8,18,12,3,9,0,49,42,1
1238,22905,i17yw0GYsvz8XFpq0Y9RtdPoiYFDGh9w,bWdj2GDclj5ofokWjzoa5jAwMkxCykd6,1,0,0,0,0,0,1,0,1,0.14285714285714285,1,0.0,0,0,0,0,0,0,0,1,0,0,1,1
1239,22906,CLsYy7g1hYWHJyj1aROfKK9oTeo5yxJx,A3fsA9Zfv1X2fVEQhTw51lKENdNrEqT3,58,26,21,66,17,2,11,1,144,20.571428571428573,2,0.0,1,21,60,17,25,2,6,11,1,99,45,1
1240,22911,i17yw0GYsvz8XFpq0Y9RtdPoiYFDGh9w,A3fsA9Zfv1X2fVEQhTw51lKENdNrEqT3,1,0,0,0,0,0,1,0,1,0.14285714285714285,1,0.0,0,0,0,0,0,0,0,1,0,0,1,1
1241,22915,dLoTMfurIDgppPqjn68MhR8oLIGjxbCC,bWdj2GDclj5ofokWjzoa5jAwMkxCykd6,37,105,43,92,28,54,15,0,337,48.142857142857146,6,0.0,35,43,85,28,70,54,7,15,0,191,146,1
1242,22924,SY3KixRowLNTROWYYZsbpxNmhMe23Wc3,SpATywNh6bZuzm8s1ceuBUnMUAeoAHHw,8,20,5,0,3,0,4,0,32,4.571428571428571,6,0.0,0,5,0,3,20,0,0,4,0,8,24,1
1243,22934,I4EJkH4zClhTB2lKNgq7Q2fKtUYoVDSA,A3fsA9Zfv1X2fVEQhTw51lKENdNrEqT3,13,36,5,0,2,3,20,2,68,9.714285714285714,4,0.0,0,5,0,2,36,3,0,20,2,7,61,1
1244,22937,7mQeRnk4E67KJHDHSAp1BOWEWVuxMvA2,SpATywNh6bZuzm8s1ceuBUnMUAeoAHHw,29,51,21,44,12,2,14,2,146,20.857142857142858,3,0.0,10,21,42,12,41,2,2,14,2,85,61,1
1245,22976,cVHCYdG6eoXKQe55dLZbvLgwBGbWam7p,RXDvfPUBYFlVdlueBFbLW0mhhAyGEqpt,1,0,0,0,0,0,1,0,1,0.14285714285714285,1,0.0,0,0,0,0,0,0,0,1,0,0,1,1
1246,22985,Dkp4ht4oz2wUhu9UvNTwrqC02rtqcSZH,SpATywNh6bZuzm8s1ceuBUnMUAeoAHHw,6,4,2,0,1,0,5,0,12,1.7142857142857142,2,0.0,0,2,0,1,4,0,0,5,0,3,9,1
1247,22998,nCARlKCtX8cCYdg9wv53tMq1HV8fOfAB,RXDvfPUBYFlVdlueBFbLW0mhhAyGEqpt,29,65,3,24,2,2,12,1,109,15.571428571428571,4,0.0,4,3,24,2,61,2,0,12,1,33,76,1
1248,22999,cbxqNQUcwI376TUiYgRRo2dXuIaImWoc,SpATywNh6bZuzm8s1ceuBUnMUAeoAHHw,26,50,32,2,15,1,25,2,127,18.142857142857142,2,0.0,7,32,2,15,43,1,0,25,2,56,71,1
1249,23011,Qi3PLuC7w2Yo9hFgq37MObjY8icnRdc6,A3fsA9Zfv1X2fVEQhTw51lKENdNrEqT3,70,98,43,168,11,37,43,2,402,57.42857142857143,10,0.0,5,43,131,11,93,37,37,43,2,190,212,0
1250,23016,jZn0klM9Bk084k9gvux7E5DK1oO1FwuJ,SpATywNh6bZuzm8s1ceuBUnMUAeoAHHw,20,29,19,9,8,0,8,0,73,10.428571428571429,5,0.0,0,19,8,8,29,0,1,8,0,35,38,0
1251,23032,UInMBEH8f1h2vxXVslRsWyLOTv8ggYq3,RXDvfPUBYFlVdlueBFbLW0mhhAyGEqpt,37,51,21,0,13,5,9,0,99,14.142857142857142,5,0.0,0,21,0,13,51,5,0,9,0,34,65,0
1252,23035,e09uq36QgLuBVK5DERoejsHeMH2uPMRM,SpATywNh6bZuzm8s1ceuBUnMUAeoAHHw,1,0,0,0,0,0,2,0,2,0.2857142857142857,2,0.0,0,0,0,0,0,0,0,2,0,0,2,1
1253,23038,0DzldTHKdoH90kklIAjpWyAEe6XDDjyM,SpATywNh6bZuzm8s1ceuBUnMUAeoAHHw,19,114,19,35,0,8,49,1,226,32.285714285714285,15,0.0,29,19,30,0,85,8,5,49,1,78,148,0
1254,23041,TJxPKDYS9NmvmYGlrCikboEkhHDTOEHy,SpATywNh6bZuzm8s1ceuBUnMUAeoAHHw,8,15,7,0,1,0,6,0,29,4.142857142857143,1,0.0,5,7,0,1,10,0,0,6,0,13,16,0
1255,23070,XHWdewLJ6o4Ir5vIcSMNfq1s8TFbjZbE,bWdj2GDclj5ofokWjzoa5jAwMkxCykd6,19,58,22,178,14,33,18,1,324,46.285714285714285,2,0.0,22,22,173,14,36,33,5,18,1,231,93,1
1256,23072,Pb0Dj6dRtTGmcuNxvaHjmGw0iPTyjSsN,bWdj2GDclj5ofokWjzoa5jAwMkxCykd6,7,5,3,0,2,0,7,0,17,2.4285714285714284,2,0.0,0,3,0,2,5,0,0,7,0,5,12,1
1257,23075,CUMuKIhvWkMSk50Or6FhgPf1tk7jntYp,SpATywNh6bZuzm8s1ceuBUnMUAeoAHHw,16,33,14,14,0,0,13,0,74,10.571428571428571,6,0.0,10,14,14,0,23,0,0,13,0,38,36,0
1258,23097,5wbqpjsRycE3Ij1gukLWuLp8it7vr80U,SpATywNh6bZuzm8s1ceuBUnMUAeoAHHw,25,102,43,14,1,255,42,4,461,65.85714285714286,8,0.0,36,43,14,1,66,255,0,42,4,94,367,1
1259,23113,Xcdjjhyr6mdJr4bRWqVyHg8s2pWIVQGq,SpATywNh6bZuzm8s1ceuBUnMUAeoAHHw,27,44,5,30,3,11,11,4,108,15.428571428571429,3,0.0,11,5,28,3,33,11,2,11,4,47,61,1
1260,23121,9S5uoFAiVHVF4D2DNR23wCkbQZ8LhtES,SpATywNh6bZuzm8s1ceuBUnMUAeoAHHw,17,25,5,14,1,0,8,0,53,7.571428571428571,5,0.0,4,5,13,1,21,0,1,8,0,23,30,0
1261,23123,rq9XJ5UGjNC0AliEbyfxvu7XJPaoSOc4,A3fsA9Zfv1X2fVEQhTw51lKENdNrEqT3,2,0,0,0,0,0,4,0,4,0.5714285714285714,1,0.0,0,0,0,0,0,0,0,4,0,0,4,1
1262,23131,hGDnsprgLmlBuNCzDAhbMdsa7xgZW8Z4,bWdj2GDclj5ofokWjzoa5jAwMkxCykd6,37,30,10,85,9,0,20,0,154,22.0,3,0.0,8,10,78,9,22,0,7,20,0,105,49,1
1263,23142,6j5Aoj3JOkcTRkyfXNVtTy229CS4uihi,G8EPVSXsOYB5YQWZGiz1aVq5Pgr2GrQu,104,206,88,192,66,1,25,3,581,83.0,17,0.0,52,88,156,66,154,1,36,25,3,362,219,0
1264,23166,4eKGhI4OMlwHB0DLaezQlJp1reuJgarH,SpATywNh6bZuzm8s1ceuBUnMUAeoAHHw,1,0,0,0,0,0,1,0,1,0.14285714285714285,1,0.0,0,0,0,0,0,0,0,1,0,0,1,1
1265,23183,HycevJIm7cBjf1oJ5QCBMMXEBTG8jyRF,A3fsA9Zfv1X2fVEQhTw51lKENdNrEqT3,74,69,44,78,10,0,26,0,227,32.42857142857143,6,0.0,10,44,77,10,59,0,1,26,0,141,86,0
1266,23185,HycevJIm7cBjf1oJ5QCBMMXEBTG8jyRF,bWdj2GDclj5ofokWjzoa5jAwMkxCykd6,30,40,26,28,4,1,22,0,121,17.285714285714285,9,0.0,5,26,27,4,35,1,1,22,0,62,59,0
1267,23197,BDdKHYPp1edgylVPYUBHaWJ6W3VobGdR,SpATywNh6bZuzm8s1ceuBUnMUAeoAHHw,30,78,37,32,15,9,12,0,183,26.142857142857142,4,0.0,29,37,28,15,49,9,4,12,0,109,74,1
1268,23201,mE5coXp72CvzVrqwpPF6wLVZrHDH0Vlq,SpATywNh6bZuzm8s1ceuBUnMUAeoAHHw,27,82,31,20,14,0,30,10,187,26.714285714285715,10,0.0,19,31,17,14,63,0,3,30,10,81,106,0
1269,23206,ieR2oDuOBOWrOSx08B7vLKsdvt41Kjgw,bWdj2GDclj5ofokWjzoa5jAwMkxCykd6,8,15,1,0,2,4,5,1,28,4.0,3,0.0,3,1,0,2,12,4,0,5,1,6,22,1
1270,23234,BDdKHYPp1edgylVPYUBHaWJ6W3VobGdR,A3fsA9Zfv1X2fVEQhTw51lKENdNrEqT3,5,2,1,0,1,0,2,0,6,0.8571428571428571,1,0.0,0,1,0,1,2,0,0,2,0,2,4,1
1271,23251,bzY7Zh4yWh2gGtmeq5pe4zgMiusHTGEG,SpATywNh6bZuzm8s1ceuBUnMUAeoAHHw,25,80,2,49,1,2,26,1,161,23.0,2,0.0,38,2,41,1,42,2,8,26,1,82,79,0
1272,23299,FuoDsqlUs6ZIyTkMTIVnWx4xFWKln8DR,SpATywNh6bZuzm8s1ceuBUnMUAeoAHHw,21,38,18,27,8,0,7,0,98,14.0,6,0.0,8,18,26,8,30,0,1,7,0,60,38,0
1273,23316,QdSH85e6TVvHCb4lCpuXbYzwkD8QbL3t,G8EPVSXsOYB5YQWZGiz1aVq5Pgr2GrQu,47,78,36,8,26,1,12,0,161,23.0,6,0.0,5,36,5,26,73,1,3,12,0,72,89,0
1274,23322,w2sKd0cOObBRKhbutYISAGM6GUL3hKiJ,A3fsA9Zfv1X2fVEQhTw51lKENdNrEqT3,1,0,0,0,0,0,3,0,3,0.42857142857142855,2,0.0,0,0,0,0,0,0,0,3,0,0,3,1
1275,23324,RPoX07eqJOUgad0B2fv5ckLas5jasaoP,SpATywNh6bZuzm8s1ceuBUnMUAeoAHHw,17,31,9,35,0,1,8,1,85,12.142857142857142,2,0.0,13,9,33,0,18,1,2,8,1,55,30,1
1276,23329,v8AEmfj5ScfNiqWSiB9twce4e05jQ9FQ,SpATywNh6bZuzm8s1ceuBUnMUAeoAHHw,14,36,3,22,2,0,3,0,66,9.428571428571429,3,0.0,23,3,19,2,13,0,3,3,0,47,19,1
1277,23332,V1z8w9SjLbULVqlANveH3qv7vwfEbAs7,A3fsA9Zfv1X2fVEQhTw51lKENdNrEqT3,66,56,33,136,11,7,65,2,310,44.285714285714285,10,0.0,4,33,119,11,52,7,17,65,2,167,143,0
1278,23382,JMglfzDzzLZlgpswShgX51nDQKwTuVTV,A3fsA9Zfv1X2fVEQhTw51lKENdNrEqT3,1,0,0,0,0,0,1,0,1,0.14285714285714285,1,0.0,0,0,0,0,0,0,0,1,0,0,1,1
1279,23385,YA61oYIgn1IPmbXidnuJfNVCdVlD8MoO,SpATywNh6bZuzm8s1ceuBUnMUAeoAHHw,15,12,0,14,0,0,3,0,29,4.142857142857143,1,0.0,1,0,12,0,11,0,2,3,0,13,16,1
1280,23387,BQkLFspAkEwZRgeuoSbQxFTr6POAaRzP,RXDvfPUBYFlVdlueBFbLW0mhhAyGEqpt,1,0,0,0,0,0,1,0,1,0.14285714285714285,1,0.0,0,0,0,0,0,0,0,1,0,0,1,1
1281,23391,X8qfNjsHrwR5R67KkU9t7FXc6jQSGsyo,bWdj2GDclj5ofokWjzoa5jAwMkxCykd6,30,57,8,58,8,67,32,0,230,32.857142857142854,6,0.0,8,8,51,8,49,67,7,32,0,75,155,1
1282,23401,xMuijSepoYpWnTVSuzhdordHJTyRt87I,SpATywNh6bZuzm8s1ceuBUnMUAeoAHHw,28,58,23,35,4,100,26,1,247,35.285714285714285,5,0.0,16,23,31,4,42,100,4,26,1,74,173,1
1283,23403,GWG8afsUfRei9CIZYg1Y2sBsF64D5J9k,A3fsA9Zfv1X2fVEQhTw51lKENdNrEqT3,93,54,32,218,19,0,11,0,334,47.714285714285715,7,0.0,6,32,183,19,48,0,35,11,0,240,94,0
1284,23408,3rgatvueGycmzmQ7x6De7keieQ0tMDvZ,A3fsA9Zfv1X2fVEQhTw51lKENdNrEqT3,43,42,20,50,18,14,8,1,153,21.857142857142858,2,0.0,1,20,45,18,41,14,5,8,1,84,69,1
1285,23410,yGTKMCuyZTpBDN6edeGIEf8UqO2mMowi,SpATywNh6bZuzm8s1ceuBUnMUAeoAHHw,23,20,12,18,7,0,4,0,61,8.714285714285714,3,0.0,4,12,15,7,16,0,3,4,0,38,23,1
1286,23425,rWIeDjJz93lBgbp2QkVHj8gv55De3Px0,G8EPVSXsOYB5YQWZGiz1aVq5Pgr2GrQu,58,59,27,62,16,2,12,4,182,26.0,3,0.0,17,27,44,16,42,2,18,12,4,104,78,1
1287,23443,2XRKCevyRsuXIpuLiEj19nm5B7ajsjxd,SpATywNh6bZuzm8s1ceuBUnMUAeoAHHw,15,16,10,2,5,1,10,1,45,6.428571428571429,2,0.0,1,10,2,5,15,1,0,10,1,18,27,1
1288,23454,mP7U4YN4Z2p45M3a970DvaALst8JAKLF,SpATywNh6bZuzm8s1ceuBUnMUAeoAHHw,22,41,1,32,1,0,14,0,89,12.714285714285714,2,0.0,25,1,28,1,16,0,4,14,0,55,34,1
1289,23458,cAyxesGtWW4tBzueSc3JcCfBcF1iSxzo,SpATywNh6bZuzm8s1ceuBUnMUAeoAHHw,29,54,25,40,13,0,11,0,143,20.428571428571427,4,0.0,20,25,33,13,34,0,7,11,0,91,52,0
1290,23469,OTkfNwsIOtoJh2hERixG2jmKnV6iaybJ,SpATywNh6bZuzm8s1ceuBUnMUAeoAHHw,1,0,0,0,0,0,1,0,1,0.14285714285714285,1,0.0,0,0,0,0,0,0,0,1,0,0,1,1
1291,23485,oAqokxwZETOc0FlXbPrJtKYU20wkk4k3,SpATywNh6bZuzm8s1ceuBUnMUAeoAHHw,16,10,6,0,6,0,2,0,24,3.4285714285714284,1,0.0,0,6,0,6,10,0,0,2,0,12,12,1
1292,23496,lbe9cMTwmlycpcYHc5ZN07ZsGdA6t7WW,SpATywNh6bZuzm8s1ceuBUnMUAeoAHHw,9,9,1,0,0,1,6,1,18,2.5714285714285716,1,0.0,2,1,0,0,7,1,0,6,1,3,15,1
1293,23502,wNbKFPX6oYsfVEr8buyWthBblPuPZGxv,A3fsA9Zfv1X2fVEQhTw51lKENdNrEqT3,99,42,29,216,17,39,15,1,359,51.285714285714285,4,0.0,7,29,183,17,35,39,33,15,1,236,123,0
1294,23521,sNkOLwlXc0EK57Dlcru7W9TUcu8lkNDn,bWdj2GDclj5ofokWjzoa5jAwMkxCykd6,16,17,11,0,7,0,6,0,41,5.857142857142857,1,0.0,1,11,0,7,16,0,0,6,0,19,22,1
1295,23523,DsdEYwXt7PO92K8VROCVVtUqrprzaIo4,RXDvfPUBYFlVdlueBFbLW0mhhAyGEqpt,18,48,0,0,0,19,7,1,75,10.714285714285714,2,0.0,0,0,0,0,48,19,0,7,1,0,75,1
1296,23526,xC7QA3lJWLoIMEwPvqIxcLnCt0KwsxwT,G8EPVSXsOYB5YQWZGiz1aVq5Pgr2GrQu,89,94,40,263,30,4,12,1,444,63.42857142857143,4,0.0,42,40,224,30,52,4,39,12,1,336,108,1
1297,23530,CfoeUJ6vk7a3PuEp1yrQNFUplkLjQYge,SpATywNh6bZuzm8s1ceuBUnMUAeoAHHw,19,46,18,20,9,1,4,0,98,14.0,3,0.0,22,18,17,9,24,1,3,4,0,66,32,0
1298,23541,ACrAvl4ssWNFndB2wDhI3oY0Vqi5B1FR,SpATywNh6bZuzm8s1ceuBUnMUAeoAHHw,27,35,17,24,7,6,16,0,105,15.0,6,0.0,12,17,23,7,23,6,1,16,0,59,46,0
1299,23550,7yphMCe2LQupOHSaDA3UQC9kbDeEuBie,SpATywNh6bZuzm8s1ceuBUnMUAeoAHHw,25,37,16,25,8,0,5,0,91,13.0,4,0.0,8,16,24,8,29,0,1,5,0,56,35,0
1300,23557,M6VmJD8JYDR5w6GV5uzAgWpIXM5eanml,SpATywNh6bZuzm8s1ceuBUnMUAeoAHHw,29,39,23,22,11,4,12,0,111,15.857142857142858,4,0.0,7,23,19,11,32,4,3,12,0,60,51,0
1301,23574,N8e8TX5f8OfPjOu3ngCuXkApyUMeZAHw,A3fsA9Zfv1X2fVEQhTw51lKENdNrEqT3,6,2,1,0,1,0,4,1,9,1.2857142857142858,1,0.0,0,1,0,1,2,0,0,4,1,2,7,1
1302,23576,mRXmcsJQnNw2mccUFVukDwZxk7roAYf4,SpATywNh6bZuzm8s1ceuBUnMUAeoAHHw,11,19,10,0,2,0,15,3,49,7.0,3,0.0,0,10,0,2,19,0,0,15,3,12,37,1
1303,23589,mptZxS2IRXAopBdChMP75EgVt5rtRsUT,SpATywNh6bZuzm8s1ceuBUnMUAeoAHHw,20,35,19,0,6,0,13,0,73,10.428571428571429,11,0.0,0,19,0,6,35,0,0,13,0,25,48,1
1304,23601,jKWIhuXmlYFBIapfd4E50TBTHed3oveP,A3fsA9Zfv1X2fVEQhTw51lKENdNrEqT3,13,15,7,0,5,0,3,0,30,4.285714285714286,3,0.0,0,7,0,5,15,0,0,3,0,12,18,1
1305,23616,VADc1m6JjTG2LuLkbhEfhADWJMHaDmqK,SpATywNh6bZuzm8s1ceuBUnMUAeoAHHw,30,69,41,28,10,20,12,1,181,25.857142857142858,9,0.0,13,41,26,10,56,20,2,12,1,90,91,0
1306,23621,HRaTe8gWBsDiLkzfbQMnooVDWfwWVb7m,SpATywNh6bZuzm8s1ceuBUnMUAeoAHHw,28,99,11,39,3,46,65,15,278,39.714285714285715,10,0.0,19,11,33,3,80,46,6,65,15,66,212,0
1307,23629,1GEou0jUAwSZvf4K9js5E10dDnbmQpAC,bWdj2GDclj5ofokWjzoa5jAwMkxCykd6,16,14,9,0,5,0,11,0,39,5.571428571428571,3,0.0,0,9,0,5,14,0,0,11,0,14,25,1
1308,23634,hs0BkyfSJv3crs4cIvcxkt53zip5FMPg,SpATywNh6bZuzm8s1ceuBUnMUAeoAHHw,15,20,13,12,4,1,6,0,56,8.0,5,0.0,3,13,12,4,17,1,0,6,0,32,24,1
1309,23642,04gG5zVwZ7Vr68t1LtjimV9KPqGTDxDK,SpATywNh6bZuzm8s1ceuBUnMUAeoAHHw,31,66,31,39,8,45,49,1,239,34.142857142857146,12,0.0,15,31,32,8,51,45,7,49,1,86,153,0
1310,23651,35E85h2ExBPeTd1VmxNX0GKo8krIMsCP,RXDvfPUBYFlVdlueBFbLW0mhhAyGEqpt,18,29,16,0,5,0,10,0,60,8.571428571428571,5,0.0,2,16,0,5,27,0,0,10,0,23,37,1
1311,23657,xM0eQ8CWGY7oZgCPJhirOkGhAfAvdQUi,SpATywNh6bZuzm8s1ceuBUnMUAeoAHHw,5,3,2,0,1,0,1,0,7,1.0,1,0.0,0,2,0,1,3,0,0,1,0,3,4,1
1312,23667,1NMKv7RE12uBMKwNJI30Cx8Z5ltMGoee,SpATywNh6bZuzm8s1ceuBUnMUAeoAHHw,28,46,28,16,18,0,7,0,115,16.428571428571427,4,0.0,12,28,16,18,34,0,0,7,0,74,41,0
1313,23672,F9d8ehlFxvqouYiZgUKxdbX5NI44Sbpl,SpATywNh6bZuzm8s1ceuBUnMUAeoAHHw,30,52,27,42,10,28,24,1,184,26.285714285714285,3,0.0,12,27,36,10,40,28,6,24,1,85,99,1
1314,23682,iSZJZtUn8nc9fyool89gRRN7Cq78oUfm,SpATywNh6bZuzm8s1ceuBUnMUAeoAHHw,26,19,10,21,7,8,5,0,70,10.0,3,0.0,7,10,20,7,12,8,1,5,0,44,26,0
1315,23694,PjedxGW8p1bztGxVlzTokusg6LFto1Md,bWdj2GDclj5ofokWjzoa5jAwMkxCykd6,1,0,0,0,0,0,1,0,1,0.14285714285714285,1,0.0,0,0,0,0,0,0,0,1,0,0,1,1
1316,23699,jM1yIagOMV2CwD8o07UMrVdo7z0hqKJ4,bWdj2GDclj5ofokWjzoa5jAwMkxCykd6,35,19,16,76,7,0,2,0,120,17.142857142857142,2,0.0,5,16,75,7,14,0,1,2,0,103,17,0
1317,23720,zJDljX1Y3FrDgAuEWJGqwBvE3KAWJPAz,A3fsA9Zfv1X2fVEQhTw51lKENdNrEqT3,6,1,1,0,1,0,5,0,8,1.1428571428571428,1,0.0,0,1,0,1,1,0,0,5,0,2,6,1
1318,23724,wQU3lY7mCoAWFqnxNLhiEFrdAWtS5Hh9,SpATywNh6bZuzm8s1ceuBUnMUAeoAHHw,24,27,14,6,8,4,12,0,71,10.142857142857142,5,0.0,0,14,6,8,27,4,0,12,0,28,43,0
1319,23747,x3sZblYMoUvQJbk7l9GY688n7RQqaQct,A3fsA9Zfv1X2fVEQhTw51lKENdNrEqT3,13,15,2,0,1,0,2,0,20,2.857142857142857,2,0.0,0,2,0,1,15,0,0,2,0,3,17,1
1320,23751,zvOHbaUWjxRZ9zCYxYPMcUH4Ef5dE8Ae,RXDvfPUBYFlVdlueBFbLW0mhhAyGEqpt,9,11,1,0,1,0,6,0,19,2.7142857142857144,2,0.0,0,1,0,1,11,0,0,6,0,2,17,1
1321,23772,bQK35cKsW9Hy5fNgckzz4Jo7bFzQOyma,G8EPVSXsOYB5YQWZGiz1aVq5Pgr2GrQu,47,79,31,74,17,8,15,4,228,32.57142857142857,2,0.0,41,31,52,17,38,8,22,15,4,141,87,0
1322,23776,JoruyAOmEeM1qjcSEWRUjLvQUHpNPZGp,SpATywNh6bZuzm8s1ceuBUnMUAeoAHHw,19,49,0,12,0,24,20,1,106,15.142857142857142,3,0.0,10,0,9,0,39,24,3,20,1,19,87,1
1323,23787,ct5yYqhcbduN7OPtxPDjwHer2K46eeEH,bWdj2GDclj5ofokWjzoa5jAwMkxCykd6,8,7,1,0,2,0,4,0,14,2.0,1,0.0,2,1,0,2,5,0,0,4,0,5,9,1
1324,23811,kj5o7wMZl1s4q0cggcmipnm7O7L6g4Ps,SpATywNh6bZuzm8s1ceuBUnMUAeoAHHw,32,29,15,30,7,3,13,1,98,14.0,3,0.0,8,15,27,7,21,3,3,13,1,57,41,1
1325,23818,oAs7swdosdDbKq3u64wlCP6EHVlCh67P,bWdj2GDclj5ofokWjzoa5jAwMkxCykd6,8,20,10,0,6,0,7,0,43,6.142857142857143,3,0.0,0,10,0,6,20,0,0,7,0,16,27,1
1326,23839,xHZbSROhwP4RRQerUVWvcNTfOGc2DHWf,bWdj2GDclj5ofokWjzoa5jAwMkxCykd6,15,65,33,0,6,22,42,0,168,24.0,16,0.0,0,33,0,6,65,22,0,42,0,39,129,0
1327,23845,TSxGfcluByCTxwgFYbniUiwGZJ5ZTUOD,RXDvfPUBYFlVdlueBFbLW0mhhAyGEqpt,24,18,15,13,9,4,6,0,65,9.285714285714286,3,0.0,0,15,12,9,18,4,1,6,0,36,29,1
1328,23853,RERZDO4CwF9dxtSu0h5YmBuy5kxPiJg0,SpATywNh6bZuzm8s1ceuBUnMUAeoAHHw,12,22,3,22,2,0,3,0,52,7.428571428571429,2,0.0,9,3,19,2,13,0,3,3,0,33,19,0
1329,23859,XNb7KU6KeHuNJzclGX2ePynnmu8yxV3v,SpATywNh6bZuzm8s1ceuBUnMUAeoAHHw,28,63,12,22,6,7,18,0,128,18.285714285714285,4,0.0,4,12,18,6,59,7,4,18,0,40,88,0
1330,23866,7WsRevbkgPhYSJirD1kBI2okhIiuBQwH,A3fsA9Zfv1X2fVEQhTw51lKENdNrEqT3,2,0,0,0,0,0,3,0,3,0.42857142857142855,1,0.0,0,0,0,0,0,0,0,3,0,0,3,1
1331,23884,GJmfZNR8PZRpI11B5boI8G7Sd4djdQgk,SpATywNh6bZuzm8s1ceuBUnMUAeoAHHw,14,17,8,19,4,0,4,0,52,7.428571428571429,3,0.0,3,8,16,4,14,0,3,4,0,31,21,1
1332,23906,XIUlzpQjeuAoBiPuklTmwavmE8N5buiR,bWdj2GDclj5ofokWjzoa5jAwMkxCykd6,9,6,4,0,3,0,6,1,20,2.857142857142857,1,0.0,0,4,0,3,6,0,0,6,1,7,13,1
1333,23913,6MGET4duNnhYB7elJoLURxwHMKRGtg9y,bWdj2GDclj5ofokWjzoa5jAwMkxCykd6,8,16,4,20,4,0,4,0,48,6.857142857142857,2,0.0,8,4,19,4,8,0,1,4,0,35,13,1
1334,23962,5pjAdY5K4FfgQPLSzQKwXaKF78ph9a0y,RXDvfPUBYFlVdlueBFbLW0mhhAyGEqpt,71,241,119,158,53,55,55,1,682,97.42857142857143,12,0.0,33,119,147,53,208,55,11,55,1,352,330,0
1335,23977,tkDslnD6NXbenEreFtnV2nvNZ4GDJajz,RXDvfPUBYFlVdlueBFbLW0mhhAyGEqpt,6,5,2,0,0,0,6,0,13,1.8571428571428572,2,0.0,0,2,0,0,5,0,0,6,0,2,11,1
1336,23984,HAPPxnLUjIhcauBZnnWBFk3JE6gETTxa,SpATywNh6bZuzm8s1ceuBUnMUAeoAHHw,19,17,8,12,5,1,7,2,52,7.428571428571429,2,0.0,6,8,11,5,11,1,1,7,2,30,22,1
1337,23994,AkYabqnQmQubmhD6vLFPcIqa194wOTvs,SpATywNh6bZuzm8s1ceuBUnMUAeoAHHw,8,5,1,0,1,0,3,0,10,1.4285714285714286,2,0.0,0,1,0,1,5,0,0,3,0,2,8,1
1338,24000,tML4IQ8jFiP4YuH9NbvzKQFqAdof0qcO,SpATywNh6bZuzm8s1ceuBUnMUAeoAHHw,24,54,0,36,0,135,29,4,258,36.857142857142854,8,0.0,16,0,31,0,38,135,5,29,4,47,211,0
1339,24021,wPWqnGAkrR45TEYOXZpjGrKRubMl9rFP,SpATywNh6bZuzm8s1ceuBUnMUAeoAHHw,23,73,3,28,1,29,19,0,153,21.857142857142858,10,0.0,17,3,25,1,56,29,3,19,0,46,107,0
1340,24024,OIPBfPb9802WcbHz02njDB4ysP5ao9fe,SpATywNh6bZuzm8s1ceuBUnMUAeoAHHw,22,31,0,22,0,2,13,2,70,10.0,3,0.0,9,0,20,0,22,2,2,13,2,29,41,0
1341,24025,REvshIGXuaBWprkQ9qA5D33qmf3QiAwV,SpATywNh6bZuzm8s1ceuBUnMUAeoAHHw,22,29,22,12,14,0,13,0,90,12.857142857142858,5,0.0,0,22,10,14,29,0,2,13,0,46,44,0
1342,24049,koZ8gxZRuDJaBnv7V4tJo48rZ57BbCd4,SpATywNh6bZuzm8s1ceuBUnMUAeoAHHw,19,13,7,18,4,0,4,0,46,6.571428571428571,1,0.0,4,7,17,4,9,0,1,4,0,32,14,1
1343,24056,UKrQdzHwNJRJK7ZoTzKsoWlrkEbsQk7X,A3fsA9Zfv1X2fVEQhTw51lKENdNrEqT3,1,0,0,0,0,0,1,0,1,0.14285714285714285,1,0.0,0,0,0,0,0,0,0,1,0,0,1,1
1344,24076,hWoXRoePYaW50QNR65rI6g0ffdFAubIq,SpATywNh6bZuzm8s1ceuBUnMUAeoAHHw,22,23,14,2,10,0,4,1,54,7.714285714285714,2,0.0,1,14,2,10,22,0,0,4,1,27,27,1
1345,24086,wx9LUKj4KCj2VrJqkWxv5NlmYX9Bw5rx,RXDvfPUBYFlVdlueBFbLW0mhhAyGEqpt,41,151,11,40,12,0,36,1,251,35.857142857142854,4,0.0,13,11,36,12,138,0,4,36,1,72,179,1
1346,24122,4e4wTy2Vsuz8jVFYgJOgi1kIGDWREiPH,bWdj2GDclj5ofokWjzoa5jAwMkxCykd6,25,65,19,46,7,1,23,6,167,23.857142857142858,4,0.0,16,19,43,7,49,1,3,23,6,85,82,0
1347,24132,je9A6l6tP7wnbFhNJD7vbbHTYhqshuqB,SpATywNh6bZuzm8s1ceuBUnMUAeoAHHw,8,28,9,0,2,1,6,0,46,6.571428571428571,4,0.0,12,9,0,2,16,1,0,6,0,23,23,1
1348,24135,yntNdGOvrRZS9CTrjjNKRRz96Mc1JGbf,bWdj2GDclj5ofokWjzoa5jAwMkxCykd6,7,10,2,46,2,0,2,0,62,8.857142857142858,2,0.0,5,2,46,2,5,0,0,2,0,55,7,1
1349,24138,tCb9JPhOhIatDlJOcmjorPeSIRsd6N1b,SpATywNh6bZuzm8s1ceuBUnMUAeoAHHw,26,61,3,26,3,0,16,0,109,15.571428571428571,5,0.0,13,3,20,3,48,0,6,16,0,39,70,0
1350,24148,uvl7kPB3Po3jrDtnQvCsunCWcJhdeQPU,bWdj2GDclj5ofokWjzoa5jAwMkxCykd6,1,0,0,0,0,0,2,0,2,0.2857142857142857,2,0.0,0,0,0,0,0,0,0,2,0,0,2,1
1351,24151,c7klirhrxknzNn3AkRTiBI36lun1Z17S,SpATywNh6bZuzm8s1ceuBUnMUAeoAHHw,7,4,3,0,2,0,2,0,11,1.5714285714285714,1,0.0,0,3,0,2,4,0,0,2,0,5,6,1
1352,24155,uUKSUB3HEdGhPX6CV6kspFVUkErIumI9,SpATywNh6bZuzm8s1ceuBUnMUAeoAHHw,18,11,5,14,4,6,4,0,44,6.285714285714286,2,0.0,2,5,12,4,9,6,2,4,0,23,21,1
1353,24169,s4TNdVBVykBR8x72RZEnjBx6ebkwwW3k,SpATywNh6bZuzm8s1ceuBUnMUAeoAHHw,1,0,0,0,0,0,1,0,1,0.14285714285714285,1,0.0,0,0,0,0,0,0,0,1,0,0,1,1
1354,24249,A1MWkFESy8kUA44NvA6UlE1jbCsV980k,SpATywNh6bZuzm8s1ceuBUnMUAeoAHHw,6,5,1,0,1,0,3,0,10,1.4285714285714286,1,0.0,0,1,0,1,5,0,0,3,0,2,8,1
1355,24277,hzJi6Q52SSiJSH5oo1cc45XsfYCFzZYG,SpATywNh6bZuzm8s1ceuBUnMUAeoAHHw,7,7,2,0,2,0,3,0,14,2.0,2,0.0,0,2,0,2,7,0,0,3,0,4,10,1
1356,24287,Ms0MC4W5moiGJLWP7iE3FImeH9CHN4KT,bWdj2GDclj5ofokWjzoa5jAwMkxCykd6,27,56,12,62,4,20,25,1,180,25.714285714285715,10,0.0,14,12,52,4,42,20,10,25,1,82,98,0
1357,24303,pYcnIzYPgb3xzrOvmR9y0UUIZo4gqKuO,RXDvfPUBYFlVdlueBFbLW0mhhAyGEqpt,69,135,76,111,28,17,28,3,398,56.857142857142854,11,0.0,26,76,99,28,109,17,12,28,3,229,169,0
1358,24304,UzwJVyLJF6Ih9iHYPyYWMullgIr89o5m,RXDvfPUBYFlVdlueBFbLW0mhhAyGEqpt,67,154,88,103,27,12,39,0,423,60.42857142857143,11,0.0,25,88,98,27,129,12,5,39,0,238,185,0
1359,24312,wGN3pCdk72KFTm52vXIRH474TFtQqduI,SpATywNh6bZuzm8s1ceuBUnMUAeoAHHw,29,42,24,29,15,0,7,0,117,16.714285714285715,4,0.0,11,24,28,15,31,0,1,7,0,78,39,0
1360,24325,bPrEBQILvyBjp3odJGGZ7KxlAV5Gu9sz,SpATywNh6bZuzm8s1ceuBUnMUAeoAHHw,18,32,18,17,6,3,16,6,98,14.0,3,0.0,7,18,16,6,25,3,1,16,6,47,51,0
1361,24332,NY9lbGArbud0VjFCO45IgKzDykuc5Wkn,SpATywNh6bZuzm8s1ceuBUnMUAeoAHHw,31,100,51,30,45,3,24,1,254,36.285714285714285,7,0.0,17,51,30,45,83,3,0,24,1,143,111,1
1362,24358,IIdYSsTHK0XdI7wZc5S09iVifP1zJLzN,SpATywNh6bZuzm8s1ceuBUnMUAeoAHHw,15,50,25,14,0,15,29,1,134,19.142857142857142,5,0.0,11,25,11,0,39,15,3,29,1,47,87,1
1363,24361,dWVj5G83xAxBDmPzLgLHfDC3pxyIk4K1,A3fsA9Zfv1X2fVEQhTw51lKENdNrEqT3,7,3,2,0,2,0,2,0,9,1.2857142857142858,1,0.0,0,2,0,2,3,0,0,2,0,4,5,1
1364,24370,nuKEM7FMFD9npzL9DafH3T1pYgMoLJoQ,SpATywNh6bZuzm8s1ceuBUnMUAeoAHHw,18,44,20,12,9,0,8,0,93,13.285714285714286,6,0.0,6,20,10,9,38,0,2,8,0,45,48,0
1365,24373,5p4xnVU1oXqeHfhqOsPC09VPLJWVQgy1,SpATywNh6bZuzm8s1ceuBUnMUAeoAHHw,20,18,13,8,6,2,12,1,60,8.571428571428571,3,0.0,2,13,7,6,16,2,1,12,1,28,32,1
1366,24383,Ialz252wY3knIVjOtCWLYcvvPO6EGRFT,SpATywNh6bZuzm8s1ceuBUnMUAeoAHHw,25,45,4,30,0,4,21,2,106,15.142857142857142,7,0.0,13,4,28,0,32,4,2,21,2,45,61,0
1367,24388,4v506xwnN2gFG9XeSNIeiBlmXImooi1O,SpATywNh6bZuzm8s1ceuBUnMUAeoAHHw,26,63,31,24,14,2,16,0,150,21.428571428571427,4,0.0,12,31,21,14,51,2,3,16,0,78,72,0
1368,24394,Zhz7dkJdB0wauB8JtGSDj0NsuH0ZH8Cd,SpATywNh6bZuzm8s1ceuBUnMUAeoAHHw,11,9,6,0,4,0,4,0,23,3.2857142857142856,2,0.0,0,6,0,4,9,0,0,4,0,10,13,1
1369,24410,F95Wv3qn0qNK1jUsJHuRDZbU4th6dVHD,RXDvfPUBYFlVdlueBFbLW0mhhAyGEqpt,1,0,0,0,0,0,1,0,1,0.14285714285714285,1,0.0,0,0,0,0,0,0,0,1,0,0,1,1
1370,24430,ADFd6U5gb8MuQY2di0urTV7aR0h11Ir1,bWdj2GDclj5ofokWjzoa5jAwMkxCykd6,2,0,0,0,0,0,2,0,2,0.2857142857142857,1,0.0,0,0,0,0,0,0,0,2,0,0,2,1
1371,24444,mFNGHC6aCmhHmhRXFCDO0uvnGnNYaro0,A3fsA9Zfv1X2fVEQhTw51lKENdNrEqT3,10,13,6,0,1,0,6,0,26,3.7142857142857144,5,0.0,0,6,0,1,13,0,0,6,0,7,19,1
1372,24476,1yAfuEW0CNQiRXnPO0v79LFUyx4hhTWm,A3fsA9Zfv1X2fVEQhTw51lKENdNrEqT3,1,0,0,0,0,0,1,0,1,0.14285714285714285,1,0.0,0,0,0,0,0,0,0,1,0,0,1,1
1373,24481,MlSRfdfvLbnwipGT1vckZAUcsWbqV0Nz,bWdj2GDclj5ofokWjzoa5jAwMkxCykd6,45,33,15,179,6,0,21,0,254,36.285714285714285,5,0.0,12,15,160,6,21,0,19,21,0,193,61,0
1374,24484,B5XH6YQeVGrE18VTFwIQP3iU5E4UvLjO,SpATywNh6bZuzm8s1ceuBUnMUAeoAHHw,1,0,0,0,0,0,1,0,1,0.14285714285714285,1,0.0,0,0,0,0,0,0,0,1,0,0,1,1
1375,24495,MhaNzTwlOubA2mdN8jvZF4ySj9a3XsvZ,G8EPVSXsOYB5YQWZGiz1aVq5Pgr2GrQu,21,28,20,40,6,0,8,0,102,14.571428571428571,2,0.0,2,20,35,6,26,0,5,8,0,63,39,1
1376,24518,iXoEMwcJ5o4IM7VKZ5pyam9GxPy4olUQ,A3fsA9Zfv1X2fVEQhTw51lKENdNrEqT3,1,0,0,0,0,0,2,0,2,0.2857142857142857,1,0.0,0,0,0,0,0,0,0,2,0,0,2,1
1377,24521,iXoEMwcJ5o4IM7VKZ5pyam9GxPy4olUQ,SpATywNh6bZuzm8s1ceuBUnMUAeoAHHw,6,5,2,0,1,0,2,0,10,1.4285714285714286,2,0.0,0,2,0,1,5,0,0,2,0,3,7,1
1378,24527,iXoEMwcJ5o4IM7VKZ5pyam9GxPy4olUQ,RXDvfPUBYFlVdlueBFbLW0mhhAyGEqpt,1,0,0,0,0,0,3,0,3,0.42857142857142855,1,0.0,0,0,0,0,0,0,0,3,0,0,3,1
1379,24532,Hxi6d4DzV7K1jcnZIhXlJzpIYDP4sYeZ,G8EPVSXsOYB5YQWZGiz1aVq5Pgr2GrQu,36,41,1,138,4,0,7,0,191,27.285714285714285,4,0.0,20,1,130,4,21,0,8,7,0,155,36,0
1380,24567,QDaW6SyhKIOYnUckUXKfy6A7QKIp9Kb8,bWdj2GDclj5ofokWjzoa5jAwMkxCykd6,3,0,0,0,0,8,4,0,12,1.7142857142857142,1,0.0,0,0,0,0,0,8,0,4,0,0,12,1
1381,24629,ja7eUjcxSqFnoRSNZAdtMUdo5WLyuwNj,RXDvfPUBYFlVdlueBFbLW0mhhAyGEqpt,23,21,13,22,7,0,9,3,75,10.714285714285714,4,0.0,3,13,17,7,18,0,5,9,3,40,35,1
1382,24645,0JvlwMe8wRQNeLJu71UvJCaEJca2naUP,bWdj2GDclj5ofokWjzoa5jAwMkxCykd6,11,17,12,0,7,4,13,0,53,7.571428571428571,3,0.0,0,12,0,7,17,4,0,13,0,19,34,0
1383,24656,LpLPysd45mBlrVFCgTTBBbMGnlXmZLO1,7GRhBDsirIGkRZBtSMEzNTyDr2JQm4xx,34,125,31,41,10,29,28,4,268,38.285714285714285,6,0.0,46,31,39,10,79,29,2,28,4,126,142,1
1384,24674,99qhCmy07rsquumjTFRELTtrLHpQpj07,bWdj2GDclj5ofokWjzoa5jAwMkxCykd6,7,11,5,0,2,0,5,0,23,3.2857142857142856,3,0.0,0,5,0,2,11,0,0,5,0,7,16,0
1385,24702,VPT5ZBddqdKmipdjPIcaTABROj9B5qkg,bWdj2GDclj5ofokWjzoa5jAwMkxCykd6,37,36,26,91,14,9,8,1,185,26.428571428571427,3,0.0,7,26,78,14,29,9,13,8,1,125,60,0
1386,24729,z9sj5HIJml1DMOMfRKKBQ7IvS2IoE424,7GRhBDsirIGkRZBtSMEzNTyDr2JQm4xx,18,55,18,0,2,4,9,5,93,13.285714285714286,2,0.0,19,18,0,2,36,4,0,9,5,39,54,1
1387,24760,NVJD7a4veZi4dOPtkddbSAsIN5dFV8jt,SpATywNh6bZuzm8s1ceuBUnMUAeoAHHw,20,30,14,17,4,24,29,4,122,17.428571428571427,3,0.0,11,14,16,4,19,24,1,29,4,45,77,0
1388,24775,FeUvHE3xENj0OT6fhaRqvHDDKwwtsMRR,SpATywNh6bZuzm8s1ceuBUnMUAeoAHHw,28,47,25,23,12,0,11,0,118,16.857142857142858,7,0.0,12,25,21,12,35,0,2,11,0,70,48,0
1389,24821,2Hx9g01WcHXaoIvHRFrUfZqDWuVhvV5b,SpATywNh6bZuzm8s1ceuBUnMUAeoAHHw,20,46,6,27,0,2,15,0,96,13.714285714285714,5,0.0,9,6,26,0,37,2,1,15,0,41,55,0
1390,24841,GfRp1O86gI5zJJh8SIJ1bczUJPWlAqoK,7GRhBDsirIGkRZBtSMEzNTyDr2JQm4xx,37,130,28,40,8,16,26,2,250,35.714285714285715,8,0.0,15,28,32,8,115,16,8,26,2,83,167,1
1391,24847,IhWjcgRzoXcWcgj0TSEsE1klKuKl9aDP,G8EPVSXsOYB5YQWZGiz1aVq5Pgr2GrQu,33,44,15,58,16,1,8,1,143,20.428571428571427,2,0.0,26,15,39,16,18,1,19,8,1,96,47,0
1392,24860,FPPbdZs5zRERbNXCB9udITtxlck6dBd9,SpATywNh6bZuzm8s1ceuBUnMUAeoAHHw,24,54,2,18,0,68,16,4,162,23.142857142857142,5,0.0,9,2,17,0,45,68,1,16,4,28,134,0
1393,24875,97rJErYjCaSZkM2sQr4Hy3em0yNLLl9Z,7GRhBDsirIGkRZBtSMEzNTyDr2JQm4xx,72,305,93,178,17,91,23,0,707,101.0,3,0.0,109,93,161,17,196,91,17,23,0,380,327,0
1394,24928,TG3ztGx3Y2jZOJDYHqGnCtBQf1aN9Xf7,7GRhBDsirIGkRZBtSMEzNTyDr2JQm4xx,15,36,15,12,11,2,17,1,94,13.428571428571429,3,0.0,14,15,10,11,22,2,2,17,1,50,44,1
1395,24975,KKySZH8Vhrdd4z2bRf8FAPkHeGpE3JpX,7GRhBDsirIGkRZBtSMEzNTyDr2JQm4xx,17,29,3,16,1,0,9,0,58,8.285714285714286,3,0.0,5,3,15,1,24,0,1,9,0,24,34,1
1396,25008,AlPSASl29ys7OO31KpYSADARO0IiSNGm,SpATywNh6bZuzm8s1ceuBUnMUAeoAHHw,17,16,11,0,7,0,4,0,38,5.428571428571429,3,0.0,0,11,0,7,16,0,0,4,0,18,20,1
1397,25047,e8HsYbNWN6cCQbTmxFf7TraoRlE6iBxd,A3fsA9Zfv1X2fVEQhTw51lKENdNrEqT3,70,51,29,152,22,9,27,1,291,41.57142857142857,3,0.0,2,29,140,22,49,9,12,27,1,193,98,0
1398,25086,ljqvAdk5ocV9irAsEHJ87jRvF9JOTCHu,SpATywNh6bZuzm8s1ceuBUnMUAeoAHHw,31,48,18,38,7,30,22,1,164,23.428571428571427,4,0.0,25,18,33,7,23,30,5,22,1,83,81,1
1399,25128,5ysSxswt94Gjj7n5OSEcRzDBWhgbKFUg,SpATywNh6bZuzm8s1ceuBUnMUAeoAHHw,27,48,21,18,7,0,8,0,102,14.571428571428571,7,0.0,19,21,17,7,29,0,1,8,0,64,38,0
1400,25140,s4t4u8r9weCt43Z5PXbFAgqmS5WJ6hj5,G8EPVSXsOYB5YQWZGiz1aVq5Pgr2GrQu,34,55,3,54,3,27,14,1,157,22.428571428571427,6,0.0,22,3,34,3,33,27,20,14,1,62,95,1
1401,25196,3Oka5GvBd9TakXRvr9D5vxoJEhxwuxJA,RXDvfPUBYFlVdlueBFbLW0mhhAyGEqpt,72,123,78,169,27,22,28,6,453,64.71428571428571,7,0.0,27,78,159,27,96,22,10,28,6,291,162,0
1402,25206,36GRXkIW2SpIWQz7gvMq2JRXacytqSzV,SpATywNh6bZuzm8s1ceuBUnMUAeoAHHw,32,56,31,25,16,24,27,1,180,25.714285714285715,6,0.0,14,31,25,16,42,24,0,27,1,86,94,0
1403,25236,JmXGzVVfQa5TXaQwtZdggsgBkbZbIeH5,bWdj2GDclj5ofokWjzoa5jAwMkxCykd6,23,37,19,56,10,4,13,1,140,20.0,7,0.0,7,19,53,10,30,4,3,13,1,89,51,0
1404,25289,YfHmALaAUVJkTXPVPoa3sijNQuWgYS7R,SpATywNh6bZuzm8s1ceuBUnMUAeoAHHw,29,47,27,12,15,0,8,0,109,15.571428571428571,3,0.0,11,27,12,15,36,0,0,8,0,65,44,0
1405,25292,ETzcC9n39CwhBb4MTbqq1Ng4NqGIoiPj,A3fsA9Zfv1X2fVEQhTw51lKENdNrEqT3,10,16,0,0,0,0,6,0,22,3.142857142857143,1,0.0,0,0,0,0,16,0,0,6,0,0,22,1
1406,25306,ETzcC9n39CwhBb4MTbqq1Ng4NqGIoiPj,7GRhBDsirIGkRZBtSMEzNTyDr2JQm4xx,4,2,1,0,1,0,1,0,5,0.7142857142857143,1,0.0,0,1,0,1,2,0,0,1,0,2,3,1
1407,25311,yG8wEEmCuC5YTy4CQDGA5I639Z9JzSu0,SpATywNh6bZuzm8s1ceuBUnMUAeoAHHw,9,9,4,0,4,0,2,0,19,2.7142857142857144,1,0.0,0,4,0,4,9,0,0,2,0,8,11,1
1408,25333,SIdEQEXoagJ5WwAcAkPtkVF6pipatiIa,A3fsA9Zfv1X2fVEQhTw51lKENdNrEqT3,2,0,0,0,0,0,2,0,2,0.2857142857142857,1,0.0,0,0,0,0,0,0,0,2,0,0,2,0
1409,25356,fi7yn2cMGfx1Smhd75ueCIU0DN0YeZ9i,7GRhBDsirIGkRZBtSMEzNTyDr2JQm4xx,12,14,9,6,5,0,3,0,37,5.285714285714286,1,0.0,2,9,6,5,12,0,0,3,0,22,15,1
1410,25416,RyJBTIZudHI18CHfqwWV9lrFHUkffvwx,SpATywNh6bZuzm8s1ceuBUnMUAeoAHHw,16,14,6,10,3,6,3,0,42,6.0,1,0.0,2,6,9,3,12,6,1,3,0,20,22,1
1411,25481,nXaqEEEC1RuDpdV8FF2KPpkhT6oc7g9j,bWdj2GDclj5ofokWjzoa5jAwMkxCykd6,13,14,5,84,4,6,3,1,117,16.714285714285715,1,0.0,8,5,83,4,6,6,1,3,1,100,17,1
1412,25504,QwlvYaP7UrFUsGUYZvCsolFqg7cM2XS7,7GRhBDsirIGkRZBtSMEzNTyDr2JQm4xx,35,95,45,49,16,8,27,3,243,34.714285714285715,2,0.0,36,45,40,16,59,8,9,27,3,137,106,1
1413,25508,ymIU6ycPRruHx8VRvXTFr9yvjJtz8pmG,SpATywNh6bZuzm8s1ceuBUnMUAeoAHHw,8,6,2,6,1,9,1,0,25,3.5714285714285716,1,0.0,2,2,6,1,4,9,0,1,0,11,14,0
1414,25510,SXQudUQxotVyHX3jIj58IdonMUWj4z4L,SpATywNh6bZuzm8s1ceuBUnMUAeoAHHw,32,79,45,31,18,26,46,3,248,35.42857142857143,7,0.0,15,45,27,18,64,26,4,46,3,105,143,0
1415,25577,s5bmHBniKJzstjkFlsJcJn6YQEnj7XjP,RXDvfPUBYFlVdlueBFbLW0mhhAyGEqpt,7,8,3,0,2,0,3,0,16,2.2857142857142856,2,0.0,2,3,0,2,6,0,0,3,0,7,9,1
1416,25593,BiaPgBnlrEY2EiwA20PKZL3VeANI5Sfw,SpATywNh6bZuzm8s1ceuBUnMUAeoAHHw,17,33,13,37,1,0,8,0,92,13.142857142857142,4,0.0,15,13,31,1,18,0,6,8,0,60,32,1
1417,25630,F1N61tazho7ZYPRPggPaCszBndAmmJFa,7GRhBDsirIGkRZBtSMEzNTyDr2JQm4xx,1,0,0,0,0,0,1,0,1,0.14285714285714285,1,0.0,0,0,0,0,0,0,0,1,0,0,1,1
1418,25633,LeLXLvHK2djzEG514AFcju6wr7gFXkH2,SpATywNh6bZuzm8s1ceuBUnMUAeoAHHw,27,84,33,41,10,89,51,10,318,45.42857142857143,7,0.0,29,33,35,10,55,89,6,51,10,107,211,1
1419,25637,zrKKa8AP5la65fKoXkp4sUMfYYb2eAtF,G8EPVSXsOYB5YQWZGiz1aVq5Pgr2GrQu,9,16,2,0,1,0,10,0,29,4.142857142857143,3,0.0,0,2,0,1,16,0,0,10,0,3,26,1
1420,25652,HrUHfBacH3u3gfsauI41ANlvNzWZshRh,A3fsA9Zfv1X2fVEQhTw51lKENdNrEqT3,68,37,25,160,16,0,8,0,246,35.142857142857146,6,0.0,2,25,143,16,35,0,17,8,0,186,60,0
1421,25653,TJlb1m2PM0vBaKFhpndqRNwoSVpMlE8f,A3fsA9Zfv1X2fVEQhTw51lKENdNrEqT3,4,2,0,0,0,0,4,0,6,0.8571428571428571,2,0.0,0,0,0,0,2,0,0,4,0,0,6,1
1422,25658,HlYiU2TA92it9HWOPDlsBmlpdZ7J7QTJ,bWdj2GDclj5ofokWjzoa5jAwMkxCykd6,8,7,3,0,1,1,7,1,20,2.857142857142857,3,0.0,0,3,0,1,7,1,0,7,1,4,16,1
1423,25673,gyFw0Vge0Tj4Yoavkd7TNvnmTGksA31j,SpATywNh6bZuzm8s1ceuBUnMUAeoAHHw,27,26,10,38,7,0,4,0,85,12.142857142857142,2,0.0,15,10,31,7,11,0,7,4,0,63,22,0
1424,25735,pwnvfCtqibSBzw9gewKZFVOUFkyHecrp,SpATywNh6bZuzm8s1ceuBUnMUAeoAHHw,6,5,0,0,0,0,2,0,7,1.0,1,0.0,0,0,0,0,5,0,0,2,0,0,7,1
1425,25765,E31WqWw5nCEWlSKgmhsOSj5j4T79ypCl,SpATywNh6bZuzm8s1ceuBUnMUAeoAHHw,31,71,33,47,11,3,22,1,188,26.857142857142858,8,0.0,26,33,38,11,45,3,9,22,1,108,80,0
1426,25793,V2mnxM1tJc479TW7qqC55qpZNUZBAJ2y,G8EPVSXsOYB5YQWZGiz1aVq5Pgr2GrQu,35,47,23,102,7,24,22,1,226,32.285714285714285,2,0.0,19,23,82,7,28,24,20,22,1,131,95,0
1427,25807,Zl8ThqnwtmFsX5mPsLsbut5BCVNIbE7S,SpATywNh6bZuzm8s1ceuBUnMUAeoAHHw,27,39,24,12,9,3,10,1,98,14.0,3,0.0,3,24,10,9,36,3,2,10,1,46,52,0
1428,25837,b5Gj1OyeYKLhLlGsleyNSSJpbJ2lneFj,SpATywNh6bZuzm8s1ceuBUnMUAeoAHHw,26,32,7,30,3,0,13,1,86,12.285714285714286,4,0.0,13,7,28,3,19,0,2,13,1,51,35,1
1429,25844,o9m1fMq17KjyGUhfLHLXFO5hoKQ5jU6O,SpATywNh6bZuzm8s1ceuBUnMUAeoAHHw,10,23,1,0,0,0,7,0,31,4.428571428571429,3,0.0,5,1,0,0,18,0,0,7,0,6,25,1
1430,25864,koGmxwg6FRa19ZshKXnyLXLosS5G7cau,7GRhBDsirIGkRZBtSMEzNTyDr2JQm4xx,29,122,1,75,10,1,22,5,236,33.714285714285715,4,0.0,66,1,65,10,56,1,10,22,5,142,94,1
1431,25867,8AVk1xYha38NNysY3dSGM9P4W7fXA7gi,SpATywNh6bZuzm8s1ceuBUnMUAeoAHHw,12,14,6,0,5,0,2,0,27,3.857142857142857,1,0.0,0,6,0,5,14,0,0,2,0,11,16,0
1432,25883,HrUHfBacH3u3gfsauI41ANlvNzWZshRh,SpATywNh6bZuzm8s1ceuBUnMUAeoAHHw,21,54,25,19,4,6,25,4,137,19.571428571428573,8,0.0,17,25,18,4,37,6,1,25,4,64,73,0
1433,25888,81OLbBMdpNpbkVstjKtzJy0bjbBi99mi,SpATywNh6bZuzm8s1ceuBUnMUAeoAHHw,2,0,0,0,0,0,2,0,2,0.2857142857142857,1,0.0,0,0,0,0,0,0,0,2,0,0,2,1
1434,25895,DLDhUvvvfnnYFJuV65Zt2yaS0jPJgvzq,SpATywNh6bZuzm8s1ceuBUnMUAeoAHHw,20,54,0,26,0,15,28,2,125,17.857142857142858,8,0.0,25,0,24,0,29,15,2,28,2,49,76,0
1435,25901,pIkx6nDAjTla5NYVEsjhMXOIu5zXDzmO,SpATywNh6bZuzm8s1ceuBUnMUAeoAHHw,23,24,13,0,7,3,15,3,65,9.285714285714286,4,0.0,0,13,0,7,24,3,0,15,3,20,45,0
1436,25952,TzT0azKrocJxLmhFJi2IdfFfROivFDi7,7GRhBDsirIGkRZBtSMEzNTyDr2JQm4xx,7,7,0,0,0,0,4,1,12,1.7142857142857142,1,0.0,0,0,0,0,7,0,0,4,1,0,12,1
1437,25963,3Ew3yAxjSntFFYCyahG9TNwPBtEjhvBu,SpATywNh6bZuzm8s1ceuBUnMUAeoAHHw,27,43,29,4,18,11,16,6,127,18.142857142857142,5,0.0,7,29,4,18,36,11,0,16,6,58,69,1
1438,25994,2jj1hSNZOKn7YixrkMYiulmQRlxNCAKp,SpATywNh6bZuzm8s1ceuBUnMUAeoAHHw,7,5,0,4,0,0,1,0,10,1.4285714285714286,1,0.0,0,0,4,0,5,0,0,1,0,4,6,1
1439,26027,l5LfU8gApOG72AnBkdAbfOLQLwFH7Zo2,A3fsA9Zfv1X2fVEQhTw51lKENdNrEqT3,11,17,3,0,1,0,6,0,27,3.857142857142857,3,0.0,2,3,0,1,15,0,0,6,0,6,21,0
1440,26033,6izQCEneEK1X6C1taxn0XENXkSv3cl84,A3fsA9Zfv1X2fVEQhTw51lKENdNrEqT3,20,16,8,22,5,0,2,0,53,7.571428571428571,1,0.0,0,8,20,5,16,0,2,2,0,33,20,0
1441,26148,JqvGTplcVBLcq3YzEUVslmYGYOBREBZ1,SpATywNh6bZuzm8s1ceuBUnMUAeoAHHw,21,38,6,18,2,27,20,0,111,15.857142857142858,9,0.0,9,6,16,2,29,27,2,20,0,33,78,0
1442,26208,USLTnsAwagwK2c83KXd1SNEeENnzkTTo,7GRhBDsirIGkRZBtSMEzNTyDr2JQm4xx,10,6,4,0,3,37,32,0,82,11.714285714285714,13,0.0,0,4,0,3,6,37,0,32,0,7,75,0
1443,26236,b3xaxczfVryBkeC1YPbXWEZUleYIZAnq,SpATywNh6bZuzm8s1ceuBUnMUAeoAHHw,18,26,10,21,6,15,15,1,94,13.428571428571429,3,0.0,15,10,18,6,11,15,3,15,1,49,45,1
1444,26255,v6GmjzoPMSZcgdRV04c3r4zmEQVHxeod,A3fsA9Zfv1X2fVEQhTw51lKENdNrEqT3,7,4,2,0,2,0,1,0,9,1.2857142857142858,1,0.0,0,2,0,2,4,0,0,1,0,4,5,1
1445,26277,m3MqtCVwUomC1r1STaTTddPYjy0l0hZb,bWdj2GDclj5ofokWjzoa5jAwMkxCykd6,1,0,0,0,0,0,1,0,1,0.14285714285714285,1,0.0,0,0,0,0,0,0,0,1,0,0,1,1
1446,26286,d5fIWN5kvqsn40aHFJvoDDo4RHSEcHNo,SpATywNh6bZuzm8s1ceuBUnMUAeoAHHw,13,15,8,3,5,0,3,0,34,4.857142857142857,3,0.0,0,8,3,5,15,0,0,3,0,16,18,1
1447,26297,UjnOd8eB67vR87Hc1uvDJpBawBhqSd4C,SpATywNh6bZuzm8s1ceuBUnMUAeoAHHw,24,58,18,49,9,0,8,0,142,20.285714285714285,6,0.0,29,18,42,9,29,0,7,8,0,98,44,1
1448,26310,vuslHI1UxdeXKs1vDUvKXYQqg3X9k91E,7GRhBDsirIGkRZBtSMEzNTyDr2JQm4xx,7,3,2,0,2,0,3,0,10,1.4285714285714286,3,0.0,0,2,0,2,3,0,0,3,0,4,6,1
1449,26322,XMtcnsDNasKCOMBWrsjCVH5NONQyEryR,A3fsA9Zfv1X2fVEQhTw51lKENdNrEqT3,46,37,28,70,21,2,13,1,172,24.571428571428573,3,0.0,2,28,60,21,35,2,10,13,1,111,61,0
1450,26326,drIV8ws6G2eFjZA06SdUOTyJLvhyaXrd,SpATywNh6bZuzm8s1ceuBUnMUAeoAHHw,16,16,8,12,0,0,12,1,49,7.0,7,0.0,4,8,12,0,12,0,0,12,1,24,25,0
1451,26335,IW0jtTZGLkJezOCVgyOKwdgLTuPt0owB,SpATywNh6bZuzm8s1ceuBUnMUAeoAHHw,20,24,0,34,1,5,5,1,70,10.0,1,0.0,10,0,29,1,14,5,5,5,1,40,30,0
1452,26372,n9pMeUNiRSC6CgcSbq2dPbx8FhUkGah9,A3fsA9Zfv1X2fVEQhTw51lKENdNrEqT3,44,32,24,0,20,2,11,0,89,12.714285714285714,3,0.0,0,24,0,20,32,2,0,11,0,44,45,0
1453,26407,Do8hbesbT6OBtmo3AMshqQTnDUWGEYzY,bWdj2GDclj5ofokWjzoa5jAwMkxCykd6,15,25,14,38,9,6,5,0,97,13.857142857142858,3,0.0,2,14,35,9,23,6,3,5,0,60,37,0
1454,26411,XGWArK05Wzjd8AdGaPxkShZOu2YZKkZ4,SpATywNh6bZuzm8s1ceuBUnMUAeoAHHw,11,18,8,0,3,3,6,0,38,5.428571428571429,2,0.0,0,8,0,3,18,3,0,6,0,11,27,0
1455,26435,N0Sos51WanCzoSGKDmMPzQtMlLxY3bFb,bWdj2GDclj5ofokWjzoa5jAwMkxCykd6,23,69,41,22,16,28,58,4,238,34.0,10,0.0,6,41,20,16,63,28,2,58,4,83,155,0
1456,26442,C8XrXSQZNN8RR6xEeSRWbKA5jTxVTtPT,SpATywNh6bZuzm8s1ceuBUnMUAeoAHHw,22,30,20,0,12,0,6,0,68,9.714285714285714,3,0.0,7,20,0,12,23,0,0,6,0,39,29,0
1457,26499,5dvfr5EjWeXuIobwrgh7MVbCslwNXi21,SpATywNh6bZuzm8s1ceuBUnMUAeoAHHw,18,54,7,9,4,0,8,0,82,11.714285714285714,3,0.0,15,7,8,4,39,0,1,8,0,34,48,0
1458,26511,wdK5DIKl9qd73hM1uOx3ufcKj0J9AcRr,SpATywNh6bZuzm8s1ceuBUnMUAeoAHHw,29,67,44,27,24,1,12,0,175,25.0,9,0.0,11,44,24,24,56,1,3,12,0,103,72,1
1459,26593,yYrk7RmkclaZIv32ppfmidCUMKYlGdCg,7GRhBDsirIGkRZBtSMEzNTyDr2JQm4xx,34,38,10,61,11,13,10,1,144,20.571428571428573,2,0.0,26,10,53,11,12,13,8,10,1,100,44,1
1460,26595,ZRB8OhpRpRUzGZm1XUTryPd3ZIuqeZkS,SpATywNh6bZuzm8s1ceuBUnMUAeoAHHw,24,38,5,28,3,0,6,0,80,11.428571428571429,2,0.0,11,5,23,3,27,0,5,6,0,42,38,0
1461,26625,chwuEH1iMc682zjOmO4zFwwfUl1drv8Q,RXDvfPUBYFlVdlueBFbLW0mhhAyGEqpt,65,60,31,95,24,7,22,0,239,34.142857142857146,9,0.0,23,31,91,24,37,7,4,22,0,169,70,0
1462,26678,OsS1Y0pb3ORCYhSo3uyNzAmfIGWlMI5F,SpATywNh6bZuzm8s1ceuBUnMUAeoAHHw,22,56,5,19,3,22,20,7,132,18.857142857142858,3,0.0,11,5,18,3,45,22,1,20,7,37,95,1
1463,26699,2WPAcVd6xHOkO7YPphHLRGJqR9SuLhLc,SpATywNh6bZuzm8s1ceuBUnMUAeoAHHw,19,22,10,26,5,0,4,0,67,9.571428571428571,1,0.0,11,10,23,5,11,0,3,4,0,49,18,0
1464,26704,OF8cZCIXPsuM4CdS1yd3vA1SWWYblMbf,SpATywNh6bZuzm8s1ceuBUnMUAeoAHHw,30,36,17,26,7,0,8,0,94,13.428571428571429,5,0.0,13,17,25,7,23,0,1,8,0,62,32,0
1465,26733,M507IlBQp64NkSWnSkchjsahApLaE1kJ,7GRhBDsirIGkRZBtSMEzNTyDr2JQm4xx,4,2,1,0,1,0,1,0,5,0.7142857142857143,1,0.0,0,1,0,1,2,0,0,1,0,2,3,1
1466,26769,QKh6yCjm7KCBJwTgcTdbJMWujg3bWjbd,SpATywNh6bZuzm8s1ceuBUnMUAeoAHHw,26,55,15,30,5,12,15,0,132,18.857142857142858,5,0.0,17,15,27,5,38,12,3,15,0,64,68,0
1467,26806,v3af5rWc4AOfzZv6mvaIgDKPH5PLVH0T,RXDvfPUBYFlVdlueBFbLW0mhhAyGEqpt,21,44,24,0,4,102,36,4,214,30.571428571428573,4,0.0,0,24,0,4,44,102,0,36,4,28,186,0
1468,26857,g44r9jnfvUwG99HEAhIahumgutn1iCtI,SpATywNh6bZuzm8s1ceuBUnMUAeoAHHw,29,47,21,29,9,0,13,0,119,17.0,5,0.0,15,21,26,9,32,0,3,13,0,71,48,0
1469,26878,zNRtwNQkiCM9OW1nTIM2OGHUm9Iu3JVP,RXDvfPUBYFlVdlueBFbLW0mhhAyGEqpt,61,73,5,136,5,9,17,2,247,35.285714285714285,7,0.0,19,5,126,5,54,9,10,17,2,155,92,0
1470,26879,nE23LYiQpabdXkj6YvKSja9sZnHRizmo,A3fsA9Zfv1X2fVEQhTw51lKENdNrEqT3,15,56,0,0,0,0,9,0,65,9.285714285714286,10,0.0,0,0,0,0,56,0,0,9,0,0,65,0
1471,26894,oEaD8Zao03KxJihTh9QEYpbyK6kjdhuu,bWdj2GDclj5ofokWjzoa5jAwMkxCykd6,1,0,0,0,0,0,1,0,1,0.14285714285714285,1,0.0,0,0,0,0,0,0,0,1,0,0,1,1
1472,26899,SKqtOWa2uBCWLrCYlzFMjf1B70kuA2m8,SpATywNh6bZuzm8s1ceuBUnMUAeoAHHw,30,35,20,23,6,10,12,0,106,15.142857142857142,3,0.0,8,20,20,6,27,10,3,12,0,54,52,0
1473,26917,y4PYMDG8u2c0Sgi9Ir3ypCxWz9jGy1hk,7GRhBDsirIGkRZBtSMEzNTyDr2JQm4xx,2,0,0,0,0,0,2,0,2,0.2857142857142857,1,0.0,0,0,0,0,0,0,0,2,0,0,2,1
1474,26923,PQxAX7A8tQB7sGIcC9YvDjqPxTwtHPvm,SpATywNh6bZuzm8s1ceuBUnMUAeoAHHw,21,44,8,34,1,2,27,1,117,16.714285714285715,7,0.0,11,8,29,1,33,2,5,27,1,49,68,0
1475,26924,vptj4ETLtFQ4ma0zcDVByNO4VFhFTiIc,SpATywNh6bZuzm8s1ceuBUnMUAeoAHHw,19,66,10,15,3,8,9,1,112,16.0,5,0.0,28,10,15,3,38,8,0,9,1,56,56,0
1476,26946,DsHgWZRTJ1y1l15smwhB78ZQq3d8dyKP,A3fsA9Zfv1X2fVEQhTw51lKENdNrEqT3,2,0,0,0,0,0,5,0,5,0.7142857142857143,5,0.0,0,0,0,0,0,0,0,5,0,0,5,0
1477,26980,eHoa4dnAqoZqw72CCle00GlHxpp5Lihg,SpATywNh6bZuzm8s1ceuBUnMUAeoAHHw,27,39,19,27,11,5,5,0,106,15.142857142857142,4,0.0,16,19,26,11,23,5,1,5,0,72,34,0
1478,27049,NyRX8nPDWLIgLtE9cch3ACh6oFi0cOSx,SpATywNh6bZuzm8s1ceuBUnMUAeoAHHw,4,7,0,0,0,0,1,0,8,1.1428571428571428,1,0.0,0,0,0,0,7,0,0,1,0,0,8,0
1479,27064,ZMTcKQbBQl56kBXzK6ZZeR0SWzh1XSjd,A3fsA9Zfv1X2fVEQhTw51lKENdNrEqT3,13,14,10,0,4,1,9,0,38,5.428571428571429,3,0.0,0,10,0,4,14,1,0,9,0,14,24,0
1480,27107,GNsGzjFSidI9fBCvT9fI5F8kfuYTc1I2,SpATywNh6bZuzm8s1ceuBUnMUAeoAHHw,2,0,0,0,0,2,1,0,3,0.42857142857142855,1,0.0,0,0,0,0,0,2,0,1,0,0,3,0
1481,27116,Y1uVq657IWCue4abNsh62IVHKtmwsQHQ,G8EPVSXsOYB5YQWZGiz1aVq5Pgr2GrQu,25,26,14,8,8,0,8,0,64,9.142857142857142,3,0.0,9,14,4,8,17,0,4,8,0,35,29,0
1482,27161,TNArortVQm3F09odJ2W3xdM27lVc5PiX,7GRhBDsirIGkRZBtSMEzNTyDr2JQm4xx,44,58,16,45,18,0,13,0,150,21.428571428571427,6,0.0,18,16,41,18,40,0,4,13,0,93,57,1
1483,27164,q0GZFChoVOuhzxYur1QICnKH6imiHQh6,SpATywNh6bZuzm8s1ceuBUnMUAeoAHHw,18,29,9,24,0,1,14,1,78,11.142857142857142,5,0.0,4,9,24,0,25,1,0,14,1,37,41,0
1484,27169,TMLHDEunctUbbn16KffZHzQrVcud2Q9Y,bWdj2GDclj5ofokWjzoa5jAwMkxCykd6,7,6,3,0,2,0,3,0,14,2.0,1,0.0,0,3,0,2,6,0,0,3,0,5,9,0
1485,27176,cs1e0x90m3RHg7MlT1h0YOwuL4MzngHW,7GRhBDsirIGkRZBtSMEzNTyDr2JQm4xx,12,16,5,1,0,3,9,1,35,5.0,1,0.0,11,5,1,0,5,3,0,9,1,17,18,1
1486,27178,3GyWUBVi0ZEtgDniG78bG37zc4UZrPNu,RXDvfPUBYFlVdlueBFbLW0mhhAyGEqpt,66,98,42,129,17,17,18,1,322,46.0,5,0.0,22,42,124,17,76,17,5,18,1,205,117,1
1487,27186,dI0jOfzj8SJw9E2PkA63bWlxL71OLyUr,bWdj2GDclj5ofokWjzoa5jAwMkxCykd6,2,0,0,0,0,0,3,0,3,0.42857142857142855,1,0.0,0,0,0,0,0,0,0,3,0,0,3,0
1488,27187,imtJFGBCtMAkOvvJ09P5N0sgBTGSUYzd,SpATywNh6bZuzm8s1ceuBUnMUAeoAHHw,14,16,7,16,4,0,2,0,45,6.428571428571429,2,0.0,7,7,14,4,9,0,2,2,0,32,13,0
1489,27189,PYm9QxL1CCjHYX7XOqp8vXAiT1dnOhc3,SpATywNh6bZuzm8s1ceuBUnMUAeoAHHw,1,0,0,0,0,0,1,0,1,0.14285714285714285,1,0.0,0,0,0,0,0,0,0,1,0,0,1,1
1490,27223,amNosdi6Uiilljdy8esSBA3F29NKPLUW,SpATywNh6bZuzm8s1ceuBUnMUAeoAHHw,25,29,18,27,10,0,13,0,97,13.857142857142858,5,0.0,6,18,27,10,23,0,0,13,0,61,36,1
1491,27268,KmrafWa5j0EoSlyTehpuPHeKeDiU4jD1,SpATywNh6bZuzm8s1ceuBUnMUAeoAHHw,14,28,14,16,5,3,3,0,69,9.857142857142858,1,0.0,10,14,15,5,18,3,1,3,0,44,25,1
1492,27305,mvWG8WfFoikkAB9Wg1mtbCZJVje4NMeg,bWdj2GDclj5ofokWjzoa5jAwMkxCykd6,16,36,19,18,12,34,13,1,133,19.0,5,0.0,7,19,17,12,29,34,1,13,1,55,78,0
1493,27316,oJmCgDBYDqQXUsH41PFzwJxrFZzGvukQ,7GRhBDsirIGkRZBtSMEzNTyDr2JQm4xx,2,0,0,0,0,2,1,0,3,0.42857142857142855,1,0.0,0,0,0,0,0,2,0,1,0,0,3,1
1494,27324,fJRilHVpgCFPzgCMD6Xh8rgK6259Z6TQ,7GRhBDsirIGkRZBtSMEzNTyDr2JQm4xx,10,13,5,10,4,4,3,0,39,5.571428571428571,2,0.0,4,5,8,4,9,4,2,3,0,21,18,1
1495,27332,rz8gqb0xki7JyRvmBK5JfOlM8YmBiT6q,SpATywNh6bZuzm8s1ceuBUnMUAeoAHHw,30,56,22,33,12,6,14,1,144,20.571428571428573,8,0.0,24,22,30,12,32,6,3,14,1,88,56,0
1496,27336,uHeTIz8GkglZUts3zio1tGR2aBoYwiQE,A3fsA9Zfv1X2fVEQhTw51lKENdNrEqT3,69,25,19,118,15,11,8,1,197,28.142857142857142,2,0.0,2,19,112,15,23,11,6,8,1,148,49,1
1497,27364,VxTZo8wWibkIng7J8YPkqWh1rsEKvqTC,7GRhBDsirIGkRZBtSMEzNTyDr2JQm4xx,5,16,11,0,11,0,2,0,40,5.714285714285714,16,0.0,0,11,0,11,16,0,0,2,0,22,18,0
1498,27404,HDD1g3rYbRszzNZAvMB0irAHbU4W6xUO,SpATywNh6bZuzm8s1ceuBUnMUAeoAHHw,25,89,15,38,7,21,22,6,198,28.285714285714285,6,0.0,31,15,33,7,58,21,5,22,6,86,112,1
1499,27429,IYFIdswDKEsO4j14D9vS4fhZEQBqA7vK,SpATywNh6bZuzm8s1ceuBUnMUAeoAHHw,16,37,19,8,8,13,19,0,104,14.857142857142858,8,0.0,7,19,8,8,30,13,0,19,0,42,62,0
1500,27449,M8C9BDFICk4ida59GU0jjp556zazDEi1,SpATywNh6bZuzm8s1ceuBUnMUAeoAHHw,16,58,17,14,7,1,11,0,108,15.428571428571429,7,0.0,20,17,13,7,38,1,1,11,0,57,51,0
1501,27462,CYUGDG4GDnccqiwcMR066vcF013j1TMy,7GRhBDsirIGkRZBtSMEzNTyDr2JQm4xx,1,0,0,0,0,0,1,0,1,0.14285714285714285,1,0.0,0,0,0,0,0,0,0,1,0,0,1,1
1502,27497,g6Nv7zrAUSY5suYgQ1EV1HY4bAaM1IoO,A3fsA9Zfv1X2fVEQhTw51lKENdNrEqT3,2,0,0,0,0,0,6,0,6,0.8571428571428571,1,0.0,0,0,0,0,0,0,0,6,0,0,6,1
1503,27501,rfOApTbQ4xF2665bHZIBhoJqQcTU6i9L,SpATywNh6bZuzm8s1ceuBUnMUAeoAHHw,31,33,18,12,10,5,8,0,86,12.285714285714286,2,0.0,11,18,12,10,22,5,0,8,0,51,35,0
1504,27535,VQ4FtoMJj29hpPrAQ6LMEGesAofjErC4,G8EPVSXsOYB5YQWZGiz1aVq5Pgr2GrQu,40,111,12,96,9,19,31,2,280,40.0,8,0.0,15,12,82,9,96,19,14,31,2,118,162,0
1505,27536,p7V6MquT5r2C7VmRzYjQEOsKx7s5gJug,SpATywNh6bZuzm8s1ceuBUnMUAeoAHHw,16,21,13,0,10,0,5,0,49,7.0,4,0.0,0,13,0,10,21,0,0,5,0,23,26,0
1506,30658,Sk4DUKJRImF6lijTnkABuH01jDj9zcnP,7GRhBDsirIGkRZBtSMEzNTyDr2JQm4xx,19,29,12,10,7,1,12,1,72,10.285714285714286,4,0.0,13,12,8,7,16,1,2,12,1,40,32,0
1507,30673,hMsNCldAkGadwgGX6yjkMuu7X3GLTjYs,7GRhBDsirIGkRZBtSMEzNTyDr2JQm4xx,4,2,1,0,1,0,1,0,5,0.7142857142857143,1,0.0,0,1,0,1,2,0,0,1,0,2,3,0
1508,30676,H98nROYI5ks5CHxEsgYii9bCzrDc1klK,7GRhBDsirIGkRZBtSMEzNTyDr2JQm4xx,6,9,5,0,3,1,2,0,20,2.857142857142857,1,0.0,2,5,0,3,7,1,0,2,0,10,10,0
1509,30700,uAXW7zeSaEEtMIdMcVsYpUquscAKUnr7,7GRhBDsirIGkRZBtSMEzNTyDr2JQm4xx,38,103,68,8,30,0,10,0,219,31.285714285714285,4,0.0,15,68,7,30,88,0,1,10,0,120,99,1
1510,30706,2aVoBs6PX62Evhzhd5ZYUQ5juZY4Z8Ua,7GRhBDsirIGkRZBtSMEzNTyDr2JQm4xx,4,4,1,0,1,0,0,0,6,0.8571428571428571,2,0.0,0,1,0,1,4,0,0,0,0,2,4,0
1511,30718,R2bf9dlDhtEUgfKzXR1GPBa12LhUfZ8W,7GRhBDsirIGkRZBtSMEzNTyDr2JQm4xx,13,17,7,8,6,0,3,0,41,5.857142857142857,1,0.0,9,7,7,6,8,0,1,3,0,29,12,0
1512,30778,vocq2qTAQIpXo7NloCyQjKAwRekZv7g6,A3fsA9Zfv1X2fVEQhTw51lKENdNrEqT3,46,90,28,68,11,38,50,3,288,41.142857142857146,6,0.0,1,28,55,11,89,38,13,50,3,95,193,1
1513,30785,rf4oo5VCac1USN0w21Ny3OOp1AZe5MC5,RXDvfPUBYFlVdlueBFbLW0mhhAyGEqpt,35,19,0,48,0,2,2,0,71,10.142857142857142,1,0.0,7,0,47,0,12,2,1,2,0,54,17,1
1514,30804,xVvNMYPAdkOMbR8cyTeqVHpVoO8wZQ2b,SpATywNh6bZuzm8s1ceuBUnMUAeoAHHw,4,2,0,0,0,0,2,0,4,0.5714285714285714,1,0.0,0,0,0,0,2,0,0,2,0,0,4,1
1515,30813,9mbf3ur4VQ377zp6wWXm0F44HQK66rP5,SpATywNh6bZuzm8s1ceuBUnMUAeoAHHw,24,42,6,12,6,6,15,4,91,13.0,5,0.0,10,6,10,6,32,6,2,15,4,32,59,0
1516,30818,aRrVk5Mj3FLAOkeQfPKXeuOPNpHy5HUB,RXDvfPUBYFlVdlueBFbLW0mhhAyGEqpt,71,84,49,143,21,20,19,2,338,48.285714285714285,3,0.0,17,49,132,21,67,20,11,19,2,219,119,0
1517,30823,jLGWqcJWbPwbqDpaLuVE2buM1VcjzYrZ,A3fsA9Zfv1X2fVEQhTw51lKENdNrEqT3,95,56,46,250,37,0,7,0,396,56.57142857142857,4,0.0,3,46,215,37,53,0,35,7,0,301,95,0
1518,30856,4LLdV2zTWS697dAsOgAPJZPFwfNnrjt6,RXDvfPUBYFlVdlueBFbLW0mhhAyGEqpt,4,3,2,0,2,0,1,0,8,1.1428571428571428,1,0.0,0,2,0,2,3,0,0,1,0,4,4,1
1519,30875,7xwH0IGxUu9oyiAWk7HpSQpakcHGIuLy,G8EPVSXsOYB5YQWZGiz1aVq5Pgr2GrQu,26,95,19,44,19,96,24,3,300,42.857142857142854,7,0.0,28,19,37,19,67,96,7,24,3,103,197,0
1520,30876,oUNptzxKR6Tg3LMdUCW3RAFgD2fbf3ju,SpATywNh6bZuzm8s1ceuBUnMUAeoAHHw,17,29,3,15,2,9,13,1,72,10.285714285714286,3,0.0,7,3,14,2,22,9,1,13,1,26,46,0
1521,30884,XVh0ciKNvtUkxzspZoTcqEEmyNc2FeL5,7GRhBDsirIGkRZBtSMEzNTyDr2JQm4xx,3,3,1,0,0,0,1,0,5,0.7142857142857143,1,0.0,0,1,0,0,3,0,0,1,0,1,4,1
1522,30915,8HJiZoOTUArj8ouKObToEc9cbZd1p0Hh,SpATywNh6bZuzm8s1ceuBUnMUAeoAHHw,26,46,20,17,10,2,10,0,105,15.0,5,0.0,19,20,17,10,27,2,0,10,0,66,39,1
1523,30926,JODIGhSXEMOFdMb0BMfI1hphmGCcGiv9,7GRhBDsirIGkRZBtSMEzNTyDr2JQm4xx,34,33,15,42,14,1,9,0,114,16.285714285714285,3,0.0,14,15,37,14,19,1,5,9,0,80,34,1
1524,30929,9rkUO9AmZpdcwHkQIT6O3wGbPIgRHhIC,7GRhBDsirIGkRZBtSMEzNTyDr2JQm4xx,15,10,3,16,0,1,8,1,39,5.571428571428571,2,0.0,3,3,14,0,7,1,2,8,1,20,19,1
1525,30931,QX72AQjqYFwDzN5BrvMTm1brfdxDPl0n,7GRhBDsirIGkRZBtSMEzNTyDr2JQm4xx,24,44,16,20,13,0,3,1,97,13.857142857142858,2,0.0,20,16,19,13,24,0,1,3,1,68,29,1
1526,30958,pUAD8nrBU2agaJjO2oyqax3esP7bDAod,SpATywNh6bZuzm8s1ceuBUnMUAeoAHHw,18,31,8,9,4,39,38,11,140,20.0,3,0.0,4,8,9,4,27,39,0,38,11,25,115,0
1527,30960,HFSA5mZu8SjtTZt5y8xxQ1NSNLuijpbs,SpATywNh6bZuzm8s1ceuBUnMUAeoAHHw,14,7,4,9,3,1,6,0,30,4.285714285714286,1,0.0,2,4,8,3,5,1,1,6,0,17,13,0
1528,30986,8KSstsh3YYhIzd54fsYY1T96OfiCGWLi,SpATywNh6bZuzm8s1ceuBUnMUAeoAHHw,18,85,21,40,2,9,40,2,199,28.428571428571427,7,0.0,50,21,36,2,35,9,4,40,2,109,90,0
1529,30996,WNlTer437rP0ycEd1BKVfCjGSSopiPqX,SpATywNh6bZuzm8s1ceuBUnMUAeoAHHw,27,63,22,22,7,91,65,9,279,39.857142857142854,8,0.0,11,22,19,7,52,91,3,65,9,59,220,0
1530,31002,EfteYUnYYLq9uOBoKEC0F2UwFqIZoKtW,RXDvfPUBYFlVdlueBFbLW0mhhAyGEqpt,67,70,44,138,27,2,9,0,290,41.42857142857143,7,0.0,20,44,132,27,50,2,6,9,0,223,67,0
1531,31033,uUSTKM8g1hIskJbYHh1UiIQ6epHTSTNR,SpATywNh6bZuzm8s1ceuBUnMUAeoAHHw,23,51,20,32,7,0,5,0,115,16.428571428571427,3,0.0,23,20,28,7,28,0,4,5,0,78,37,0
1532,31123,UrqgguXQUa7JPAQb45jcbkHT0yjSwZHu,7GRhBDsirIGkRZBtSMEzNTyDr2JQm4xx,8,2,0,0,0,4,18,0,24,3.4285714285714284,2,0.0,0,0,0,0,2,4,0,18,0,0,24,1
1533,31152,AdsXlEjQFIksauSrVM6XkycFKpsPMY96,G8EPVSXsOYB5YQWZGiz1aVq5Pgr2GrQu,33,96,54,88,23,1,9,1,272,38.857142857142854,5,0.0,33,54,69,23,63,1,19,9,1,179,93,0
1534,31153,rIlg2veK76CYPAY7z09GokFHQqwC8sW7,SpATywNh6bZuzm8s1ceuBUnMUAeoAHHw,22,37,2,23,3,0,7,0,72,10.285714285714286,5,0.0,9,2,20,3,28,0,3,7,0,34,38,0
1535,31167,4bLrsVDvLnrTqHqeIpcqQPyvl02eai7n,A3fsA9Zfv1X2fVEQhTw51lKENdNrEqT3,17,9,9,0,9,0,9,0,36,5.142857142857143,3,0.0,0,9,0,9,9,0,0,9,0,18,18,1
1536,31186,71r0cSGOl797B6z3Ozx79KsmcnthtUKF,RXDvfPUBYFlVdlueBFbLW0mhhAyGEqpt,66,194,40,102,30,87,50,23,526,75.14285714285714,7,0.0,41,40,92,30,153,87,10,50,23,203,323,0
1537,31204,YOx6Tvp6HBSp6Lo310sbWxV28yIh3XN8,G8EPVSXsOYB5YQWZGiz1aVq5Pgr2GrQu,34,46,25,0,23,0,5,0,99,14.142857142857142,5,0.0,16,25,0,23,30,0,0,5,0,64,35,0
1538,31205,JzHC5tjVySaXz4V3Y0e4piHyrkmeSqU5,SpATywNh6bZuzm8s1ceuBUnMUAeoAHHw,32,135,35,30,10,148,87,7,452,64.57142857142857,10,0.0,6,35,27,10,129,148,3,87,7,78,374,0
1539,31220,s6iksgptFmyh2vfiarKdJkiKnp6RLi3f,SpATywNh6bZuzm8s1ceuBUnMUAeoAHHw,26,39,24,13,13,44,6,0,139,19.857142857142858,3,0.0,6,24,12,13,33,44,1,6,0,55,84,0
1540,31242,Qn3OccgDXQpcut9yLA9jXfau6FPbS72n,SpATywNh6bZuzm8s1ceuBUnMUAeoAHHw,24,36,0,12,0,9,16,1,74,10.571428571428571,3,0.0,9,0,12,0,27,9,0,16,1,21,53,0
1541,31250,oqq9xRnlYeqOhAsbS4FyM4hs04sEJX6q,7GRhBDsirIGkRZBtSMEzNTyDr2JQm4xx,13,20,11,0,0,2,5,1,39,5.571428571428571,2,0.0,4,11,0,0,16,2,0,5,1,15,24,1
1542,31254,m8tZWvMesr1zQS0esJJogsiMlXHxe2Cd,SpATywNh6bZuzm8s1ceuBUnMUAeoAHHw,14,27,9,15,4,2,2,0,59,8.428571428571429,1,0.0,11,9,13,4,16,2,2,2,0,37,22,1
1543,31273,llEGY9nmTOZhiXi105AGZUS4gAhSawAh,SpATywNh6bZuzm8s1ceuBUnMUAeoAHHw,30,47,19,36,9,5,10,1,127,18.142857142857142,3,0.0,10,19,31,9,37,5,5,10,1,69,58,0
1544,31280,juUpKesViORjdDJidJ4RSlxH0qwbmcck,SpATywNh6bZuzm8s1ceuBUnMUAeoAHHw,19,48,24,5,18,3,2,0,100,14.285714285714286,2,0.0,8,24,4,18,40,3,1,2,0,54,46,0
1545,31313,vAwmKvW9O3gDJNDrzxbIT5kjf2troQFn,SpATywNh6bZuzm8s1ceuBUnMUAeoAHHw,17,17,7,10,4,3,12,1,54,7.714285714285714,5,0.0,2,7,10,4,15,3,0,12,1,23,31,1
1546,31316,sl67PTvziUv3kTFj6qEnYHRaFoNTaM8y,SpATywNh6bZuzm8s1ceuBUnMUAeoAHHw,22,51,19,14,10,0,7,0,101,14.428571428571429,4,0.0,23,19,13,10,28,0,1,7,0,65,36,0
1547,31356,zIHhHIwIbH6mJbe3ZAvW2ovaPewaq0E0,SpATywNh6bZuzm8s1ceuBUnMUAeoAHHw,22,52,17,24,4,77,20,1,195,27.857142857142858,8,0.0,19,17,23,4,33,77,1,20,1,63,132,0
1548,31360,QVtQEOECDBxqQMPDJLsWNOlhwI5DCP74,SpATywNh6bZuzm8s1ceuBUnMUAeoAHHw,30,71,31,35,15,95,22,4,273,39.0,6,0.0,16,31,31,15,55,95,4,22,4,93,180,0
1549,31371,YkxwabMuriYpqC21021WUsYLLutSSx4O,SpATywNh6bZuzm8s1ceuBUnMUAeoAHHw,29,35,20,24,10,0,9,6,104,14.857142857142858,7,0.0,9,20,20,10,26,0,4,9,6,59,45,0
1550,31389,QAV02IL7ajntDdHVirqabwTRIN1Sa6iz,SpATywNh6bZuzm8s1ceuBUnMUAeoAHHw,13,89,2,13,0,0,30,0,134,19.142857142857142,8,0.0,14,2,13,0,75,0,0,30,0,29,105,0
1551,31392,p6Izm60d3R0uvZiSe15AoVnOEu77nAhg,SpATywNh6bZuzm8s1ceuBUnMUAeoAHHw,3,0,0,0,0,4,3,0,7,1.0,1,0.0,0,0,0,0,0,4,0,3,0,0,7,0
1552,31397,CGQBVll6e8XrZqlx2vLhIruhp3CAtM89,SpATywNh6bZuzm8s1ceuBUnMUAeoAHHw,6,9,5,0,3,3,6,0,26,3.7142857142857144,2,0.0,0,5,0,3,9,3,0,6,0,8,18,0
1553,31399,VBP5PzVQEKJYFH0y5ffEek5WfP9EW7uc,SpATywNh6bZuzm8s1ceuBUnMUAeoAHHw,30,27,18,16,7,1,16,1,86,12.285714285714286,8,0.0,4,18,15,7,23,1,1,16,1,44,42,0
1554,31400,S9MHz2GfayML2H9BuRARNQ0WUO9mAJgZ,SpATywNh6bZuzm8s1ceuBUnMUAeoAHHw,30,34,19,30,8,3,17,0,111,15.857142857142858,7,0.0,8,19,25,8,26,3,5,17,0,60,51,0
1555,31415,6pb2LEsVjBBvAGI7h0XcyCiR12k7UvwH,bWdj2GDclj5ofokWjzoa5jAwMkxCykd6,14,14,6,36,5,4,4,1,70,10.0,2,0.0,5,6,34,5,9,4,2,4,1,50,20,1
1556,31445,l7cIWSn2QdqLoOKMFO8yNQGKfk999nJh,SpATywNh6bZuzm8s1ceuBUnMUAeoAHHw,10,8,7,0,6,0,2,0,23,3.2857142857142856,1,0.0,0,7,0,6,8,0,0,2,0,13,10,0
1557,31459,1xFsl22T8LEiEJ3kwPWguQfPNcGWZ8JV,7GRhBDsirIGkRZBtSMEzNTyDr2JQm4xx,22,75,3,0,3,4,32,3,120,17.142857142857142,7,0.0,40,3,0,3,35,4,0,32,3,46,74,1
1558,31485,TJFpdHl1wQVU7Cnvm5Co4MJsJuGM9yMG,G8EPVSXsOYB5YQWZGiz1aVq5Pgr2GrQu,29,55,26,66,14,17,24,4,206,29.428571428571427,2,0.0,19,26,46,14,36,17,20,24,4,105,101,0
1559,31494,koNIIdoqi1yUhLIZAXp5I3Fl17qrPzNm,7GRhBDsirIGkRZBtSMEzNTyDr2JQm4xx,1,0,0,0,0,0,1,0,1,0.14285714285714285,1,0.0,0,0,0,0,0,0,0,1,0,0,1,1
1560,31500,EQgg3GYPXWNLa9U010kt5ZSvruPXJLGA,SpATywNh6bZuzm8s1ceuBUnMUAeoAHHw,19,34,14,21,6,20,12,3,110,15.714285714285714,5,0.0,11,14,18,6,23,20,3,12,3,49,61,0
1561,31503,YwFTXHSC31SX1LraRWOGlHPt5rdaD4Vy,SpATywNh6bZuzm8s1ceuBUnMUAeoAHHw,11,22,10,3,0,85,12,1,133,19.0,3,0.0,7,10,3,0,15,85,0,12,1,20,113,0
1562,31544,NqCDW2Wa7d0wWx7VYLXJDwB6ylSM8NEL,G8EPVSXsOYB5YQWZGiz1aVq5Pgr2GrQu,35,44,11,50,0,1,10,0,116,16.571428571428573,2,0.0,17,11,31,0,27,1,19,10,0,59,57,0
1563,31573,VWrks7JFbeZpwdWqwwZkJoHpmfIv7cqz,7GRhBDsirIGkRZBtSMEzNTyDr2JQm4xx,27,37,20,39,14,1,2,0,113,16.142857142857142,4,0.0,10,20,37,14,27,1,2,2,0,81,32,0
1564,31642,Vr0kaKAkI4p2upUYNB1MMKsTShBZob66,7GRhBDsirIGkRZBtSMEzNTyDr2JQm4xx,29,50,22,56,10,63,3,0,204,29.142857142857142,5,0.0,22,22,45,10,28,63,11,3,0,99,105,1
1565,31691,TUAvpbJIqPqAXiWUMr89vm0HdACTuiA8,SpATywNh6bZuzm8s1ceuBUnMUAeoAHHw,20,41,1,23,2,2,10,0,79,11.285714285714286,5,0.0,7,1,19,2,34,2,4,10,0,29,50,0
1566,31728,mpNBMReKZvwryUvgjwY0cwVFK7aOune8,SpATywNh6bZuzm8s1ceuBUnMUAeoAHHw,32,40,19,36,9,7,23,2,136,19.428571428571427,6,0.0,14,19,32,9,26,7,4,23,2,74,62,0
1567,31739,xM8lVcqU5uqtxPXKRkobTl3b50GvL7Y6,G8EPVSXsOYB5YQWZGiz1aVq5Pgr2GrQu,3,2,0,0,0,0,1,0,3,0.42857142857142855,1,0.0,0,0,0,0,2,0,0,1,0,0,3,1
1568,31804,lHdOeTUXYVL6iAgJVxxf5RxusHAIMUqu,SpATywNh6bZuzm8s1ceuBUnMUAeoAHHw,31,68,26,27,12,18,21,1,173,24.714285714285715,8,0.0,25,26,27,12,43,18,0,21,1,90,83,0
1569,31834,8nijJeJQ3xDzhCTAr7Z0RTVPHqfdjajs,SpATywNh6bZuzm8s1ceuBUnMUAeoAHHw,1,0,0,0,0,0,1,0,1,0.14285714285714285,1,0.0,0,0,0,0,0,0,0,1,0,0,1,0
1570,31878,VXwRO03Gu4QrNRkeAj0lYc8T94Ap4aw5,SpATywNh6bZuzm8s1ceuBUnMUAeoAHHw,22,46,3,35,1,7,6,0,98,14.0,4,0.0,20,3,32,1,26,7,3,6,0,56,42,0
1571,31984,uDOAJpmX4dISx06kO0710v1O7qHbWnTL,7GRhBDsirIGkRZBtSMEzNTyDr2JQm4xx,1,0,0,0,0,0,1,0,1,0.14285714285714285,1,0.0,0,0,0,0,0,0,0,1,0,0,1,1
1572,32014,t8eDuPU4MsZrMH2MoE1n7JeYLVBJZOGD,SpATywNh6bZuzm8s1ceuBUnMUAeoAHHw,23,40,18,29,4,12,21,3,127,18.142857142857142,6,0.0,15,18,26,4,25,12,3,21,3,63,64,0
1573,32052,2H4u8GVrslTygmZOsXRsjmcwUzRVI1ow,SpATywNh6bZuzm8s1ceuBUnMUAeoAHHw,12,23,19,6,8,0,8,0,64,9.142857142857142,3,0.0,0,19,5,8,23,0,1,8,0,32,32,0
1574,32114,MOcMwRKo0dtFqZ5xWBgRzquuZGKtQyf4,7GRhBDsirIGkRZBtSMEzNTyDr2JQm4xx,53,151,45,47,32,3,21,0,299,42.714285714285715,9,0.0,49,45,44,32,102,3,3,21,0,170,129,1
1575,32118,WMPYVFkG1npps8BU0n5fJtN4LOF8N9L7,7GRhBDsirIGkRZBtSMEzNTyDr2JQm4xx,5,7,2,0,0,0,2,0,11,1.5714285714285714,2,0.0,2,2,0,0,5,0,0,2,0,4,7,1
1576,32122,ZvU0YqNTtgKWTlVIbqvnVys23p5WRiDJ,SpATywNh6bZuzm8s1ceuBUnMUAeoAHHw,13,39,21,0,4,129,10,0,203,29.0,6,0.0,0,21,0,4,39,129,0,10,0,25,178,0
1577,32168,RHl3DsvAX7TisJ7qBptmgrrtDAQvH7mr,SpATywNh6bZuzm8s1ceuBUnMUAeoAHHw,10,16,5,14,1,0,5,0,41,5.857142857142857,4,0.0,2,5,12,1,14,0,2,5,0,20,21,0
1578,32208,bNZH4hUHavni696ZcBLvxZCrBSALUDxX,SpATywNh6bZuzm8s1ceuBUnMUAeoAHHw,23,43,5,31,4,29,12,0,124,17.714285714285715,13,0.0,5,5,28,4,38,29,3,12,0,42,82,0
1579,32211,EjR7iUwsiJVzqJrC7t3D1JWVRCEYToml,SpATywNh6bZuzm8s1ceuBUnMUAeoAHHw,10,19,0,18,0,5,3,0,45,6.428571428571429,1,0.0,9,0,15,0,10,5,3,3,0,24,21,0
1580,32226,4TtGjmtd4ISORDD5okRgx7kXAcGUW8IN,SpATywNh6bZuzm8s1ceuBUnMUAeoAHHw,29,47,20,23,9,4,40,5,148,21.142857142857142,9,0.0,20,20,20,9,27,4,3,40,5,69,79,0
1581,32241,kIttG9NXpnCAK6Uau8oyBBFc61rFQfTE,7GRhBDsirIGkRZBtSMEzNTyDr2JQm4xx,8,14,4,4,3,2,2,0,29,4.142857142857143,2,0.0,1,4,3,3,13,2,1,2,0,11,18,1
1582,32244,jN0wpnfaU5DsLxvEqII5WFiC356NJUbF,SpATywNh6bZuzm8s1ceuBUnMUAeoAHHw,23,30,12,24,5,1,25,4,101,14.428571428571429,4,0.0,12,12,22,5,18,1,2,25,4,51,50,1
1583,32256,pNgLScEwGgq81vg0a0cEXKNs5eG2UXph,SpATywNh6bZuzm8s1ceuBUnMUAeoAHHw,15,13,7,12,4,0,3,0,39,5.571428571428571,2,0.0,4,7,12,4,9,0,0,3,0,27,12,1
1584,32261,L6TEQcXe2Cfo7rlXEZ1k4dVXCx2fwc1Y,7GRhBDsirIGkRZBtSMEzNTyDr2JQm4xx,8,9,2,0,1,0,2,0,14,2.0,1,0.0,4,2,0,1,5,0,0,2,0,7,7,1
1585,32263,kAQFM0dEgOQIxOG9jTMe5puRtNxZZWMN,bWdj2GDclj5ofokWjzoa5jAwMkxCykd6,43,40,3,192,3,2,8,0,248,35.42857142857143,6,0.0,11,3,178,3,29,2,14,8,0,195,53,0
1586,32269,kCqsvQZpasUHfVJzYbijAKww9O0shrRg,RXDvfPUBYFlVdlueBFbLW0mhhAyGEqpt,25,37,5,20,2,14,14,0,92,13.142857142857142,3,0.0,0,5,14,2,37,14,6,14,0,21,71,0
1587,32280,onsmNYIoPFEi185f5ZLsQXD70I3K25Cb,7GRhBDsirIGkRZBtSMEzNTyDr2JQm4xx,6,4,3,0,2,0,2,0,11,1.5714285714285714,1,0.0,0,3,0,2,4,0,0,2,0,5,6,1
1588,32284,wkkLqkPlDLOrNrbR4UCtQIDxtXcGov1B,SpATywNh6bZuzm8s1ceuBUnMUAeoAHHw,15,17,1,19,0,0,11,1,49,7.0,3,0.0,4,1,16,0,13,0,3,11,1,21,28,1
1589,32288,8rXJHeqrLpho5nIQgbDcpBTvBrVnGged,SpATywNh6bZuzm8s1ceuBUnMUAeoAHHw,24,53,10,39,4,0,9,0,115,16.428571428571427,4,0.0,17,10,33,4,36,0,6,9,0,64,51,0
1590,32309,MZpeXlPtlAGSfwuC5xwB1U0DIOZvGtVZ,SpATywNh6bZuzm8s1ceuBUnMUAeoAHHw,25,56,3,35,5,9,16,1,125,17.857142857142858,7,0.0,24,3,28,5,32,9,7,16,1,60,65,0
1591,32319,PZyZDM2uyBRGPZg3kQscavWjpR2bFYiU,SpATywNh6bZuzm8s1ceuBUnMUAeoAHHw,16,11,9,11,5,4,9,1,50,7.142857142857143,2,0.0,0,9,11,5,11,4,0,9,1,25,25,0
1592,32346,rrZSZFoEgH3bOKdkZ0UyNzOq7Pdyx5G0,SpATywNh6bZuzm8s1ceuBUnMUAeoAHHw,25,70,18,4,5,13,23,3,136,19.428571428571427,3,0.0,5,18,4,5,65,13,0,23,3,32,104,0
1593,32358,nOWwmMm8RUDfPfoqvXy3xmkIL6qZiu0a,7GRhBDsirIGkRZBtSMEzNTyDr2JQm4xx,13,18,1,9,0,9,18,1,56,8.0,2,0.0,2,1,7,0,16,9,2,18,1,10,46,0
1594,32359,aLRP3ahB5SIcOn5vpM1VPEh9ib2QIioX,SpATywNh6bZuzm8s1ceuBUnMUAeoAHHw,24,58,11,25,5,0,23,0,122,17.428571428571427,12,0.0,10,11,21,5,48,0,4,23,0,47,75,0
1595,32385,rIb3lxEaK77vmLDTqDgCNFDZAYjyvbtK,7GRhBDsirIGkRZBtSMEzNTyDr2JQm4xx,31,41,19,32,8,0,8,0,108,15.428571428571429,5,0.0,15,19,30,8,26,0,2,8,0,72,36,1
1596,32409,9iGaqBGS5kkoXjLd87hUL2eIJMVUVKfU,G8EPVSXsOYB5YQWZGiz1aVq5Pgr2GrQu,16,22,11,16,1,0,7,0,57,8.142857142857142,3,0.0,0,11,15,1,22,0,1,7,0,27,30,0
1597,32426,gGSMkNgPdXpBQgdZzyjzifomyCxFSNyt,bWdj2GDclj5ofokWjzoa5jAwMkxCykd6,17,63,33,36,12,12,36,2,194,27.714285714285715,10,0.0,4,33,35,12,59,12,1,36,2,84,110,0
1598,32436,QqE2Xjwy9gUzOvFdkDqAwAaNZLBZkxvd,SpATywNh6bZuzm8s1ceuBUnMUAeoAHHw,25,84,2,28,2,30,30,0,176,25.142857142857142,10,0.0,11,2,23,2,73,30,5,30,0,38,138,0
1599,32464,QAguKdvn52pCJKW91rO3BCY8l8ZCAdvQ,A3fsA9Zfv1X2fVEQhTw51lKENdNrEqT3,53,42,30,62,21,5,18,3,181,25.857142857142858,4,0.0,1,30,59,21,41,5,3,18,3,111,70,0
1600,32484,QqE2Xjwy9gUzOvFdkDqAwAaNZLBZkxvd,A3fsA9Zfv1X2fVEQhTw51lKENdNrEqT3,18,45,2,0,2,0,33,0,82,11.714285714285714,10,0.0,0,2,0,2,45,0,0,33,0,4,78,0
1601,32492,5NsbP59FWlyl4NFONUzt3drLLr5EFRFj,G8EPVSXsOYB5YQWZGiz1aVq5Pgr2GrQu,64,98,38,154,14,9,15,1,329,47.0,4,0.0,52,38,114,14,46,9,40,15,1,218,111,1
1602,32501,mOJqDc22cg6Tc62XCr7iPStv8YxEXhpp,SpATywNh6bZuzm8s1ceuBUnMUAeoAHHw,29,83,37,37,13,76,35,4,285,40.714285714285715,6,0.0,20,37,31,13,63,76,6,35,4,101,184,0
1603,32512,wtJKiskMN99Zm4elrGO0NchnwPdR8XuA,7GRhBDsirIGkRZBtSMEzNTyDr2JQm4xx,1,0,0,0,0,0,1,0,1,0.14285714285714285,1,0.0,0,0,0,0,0,0,0,1,0,0,1,1
1604,32577,fNAZ3rWuqq8OkAKKKUzZOQQ9DpAle4lu,SpATywNh6bZuzm8s1ceuBUnMUAeoAHHw,32,92,30,34,10,3,37,2,208,29.714285714285715,8,0.0,39,30,31,10,53,3,3,37,2,110,98,0
1605,32616,MVcepYvxjrdyzudBtT6xf978LVM5p04U,SpATywNh6bZuzm8s1ceuBUnMUAeoAHHw,30,36,18,40,10,17,15,5,141,20.142857142857142,3,0.0,13,18,33,10,23,17,7,15,5,74,67,0
1606,32647,vBbIZDmFTh3FCbK0DEiE7jyE0eCpDvg4,RXDvfPUBYFlVdlueBFbLW0mhhAyGEqpt,27,21,12,32,5,4,10,1,85,12.142857142857142,2,0.0,4,12,31,5,17,4,1,10,1,52,33,0
1607,32685,MaXB6YBpSNUvXtEuCcY3Jwa8jwvsWVE8,G8EPVSXsOYB5YQWZGiz1aVq5Pgr2GrQu,37,74,3,8,3,0,8,1,97,13.857142857142858,2,0.0,16,3,4,3,58,0,4,8,1,26,71,0
1608,32694,bVveXRWwKdTb7eqX4rWDKBUhdf8PtEkw,SpATywNh6bZuzm8s1ceuBUnMUAeoAHHw,21,22,3,22,0,0,3,0,50,7.142857142857143,4,0.0,6,3,18,0,16,0,4,3,0,27,23,0
1609,32725,NHPpKvbnrSpxM8e1DORBWJbRCpmrxZw8,G8EPVSXsOYB5YQWZGiz1aVq5Pgr2GrQu,5,3,1,0,1,0,1,0,6,0.8571428571428571,1,0.0,0,1,0,1,3,0,0,1,0,2,4,0
1610,32805,mPCmohVETKOBEAkMNdnfTJW7kVWg1ArQ,7GRhBDsirIGkRZBtSMEzNTyDr2JQm4xx,1,0,0,0,0,0,1,0,1,0.14285714285714285,1,0.0,0,0,0,0,0,0,0,1,0,0,1,1
1611,32844,b1eRrhapWSjtM2Ih9Xn0eBEZAyjqmlvI,SpATywNh6bZuzm8s1ceuBUnMUAeoAHHw,31,129,57,47,11,98,54,11,407,58.142857142857146,10,0.0,41,57,37,11,88,98,10,54,11,146,261,0
1612,32874,67ZqfHh3zcLqo5qUacGllEiszIkOne95,G8EPVSXsOYB5YQWZGiz1aVq5Pgr2GrQu,26,96,63,0,67,1,18,1,246,35.142857142857146,5,0.0,12,63,0,67,84,1,0,18,1,142,104,0
1613,32891,yInJev2CVKf0hE352QQBnfHh6HRrGN4N,SpATywNh6bZuzm8s1ceuBUnMUAeoAHHw,6,7,3,0,2,0,2,0,14,2.0,2,0.0,0,3,0,2,7,0,0,2,0,5,9,1
1614,32901,4JyZWYWxxqGCPr9dTz7bgpLcCXWs003A,SpATywNh6bZuzm8s1ceuBUnMUAeoAHHw,22,44,19,27,10,3,31,3,137,19.571428571428573,3,0.0,15,19,26,10,29,3,1,31,3,70,67,0
1615,32931,8d3h1mcAmphWja0z3YCYQ3jOAHgKDV8O,7GRhBDsirIGkRZBtSMEzNTyDr2JQm4xx,6,4,1,6,1,0,1,0,13,1.8571428571428572,1,0.0,1,1,5,1,3,0,1,1,0,8,5,1
1616,32938,zZwP4suQybM1gcslFDQ5UITiG9iZ789v,SpATywNh6bZuzm8s1ceuBUnMUAeoAHHw,27,76,46,26,11,9,20,6,194,27.714285714285715,6,0.0,12,46,19,11,64,9,7,20,6,88,106,0
1617,32988,mZVWUPFbkuZINQtykHT2ZyZY5zMXgvJ7,SpATywNh6bZuzm8s1ceuBUnMUAeoAHHw,20,18,3,16,3,0,11,3,54,7.714285714285714,3,0.0,2,3,14,3,16,0,2,11,3,22,32,0
1618,33001,ZFpXjzvya7Y5x9HmUsgToer6v1L16WM2,SpATywNh6bZuzm8s1ceuBUnMUAeoAHHw,12,13,7,10,2,2,8,0,42,6.0,2,0.0,2,7,10,2,11,2,0,8,0,21,21,0
1619,33017,GFBEJrga7DM4UEcrt340p3oRNaL97Gn4,SpATywNh6bZuzm8s1ceuBUnMUAeoAHHw,27,38,21,26,8,123,51,8,275,39.285714285714285,6,0.0,6,21,23,8,32,123,3,51,8,58,217,0
1620,33018,gi1cGXmBNmpbe6lA2hzKFh8EEd7gQMCM,SpATywNh6bZuzm8s1ceuBUnMUAeoAHHw,2,0,0,0,0,0,2,0,2,0.2857142857142857,1,0.0,0,0,0,0,0,0,0,2,0,0,2,0
1621,33023,XzkMRCsMMuNT5Al9kV5PMqeThOnNDLN6,7GRhBDsirIGkRZBtSMEzNTyDr2JQm4xx,4,5,3,0,0,4,4,0,16,2.2857142857142856,2,0.0,0,3,0,0,5,4,0,4,0,3,13,1
1622,33050,rALCIi3DuIdQyJaY6En5rKpCFJjvIHQe,SpATywNh6bZuzm8s1ceuBUnMUAeoAHHw,6,7,3,0,1,0,7,0,18,2.5714285714285716,2,0.0,0,3,0,1,7,0,0,7,0,4,14,1
1623,33058,fNAZ3rWuqq8OkAKKKUzZOQQ9DpAle4lu,RXDvfPUBYFlVdlueBFbLW0mhhAyGEqpt,72,105,60,206,31,6,29,0,437,62.42857142857143,7,0.0,18,60,186,31,87,6,20,29,0,295,142,0
1624,33062,ZVmjT1rppq7ilCPRRtmAl1wo0gOugsCt,RXDvfPUBYFlVdlueBFbLW0mhhAyGEqpt,67,97,65,156,43,16,13,0,390,55.714285714285715,7,0.0,21,65,147,43,76,16,9,13,0,276,114,0
1625,33088,kpIACQKuTNWV6fjF4g1htB9bVtHJR1X6,A3fsA9Zfv1X2fVEQhTw51lKENdNrEqT3,2,0,0,0,0,0,2,0,2,0.2857142857142857,1,0.0,0,0,0,0,0,0,0,2,0,0,2,0
1626,33097,RJ1FVW8gXQIpK321uzh2Sh69ojlsqnvg,bWdj2GDclj5ofokWjzoa5jAwMkxCykd6,13,20,8,38,3,5,14,1,89,12.714285714285714,2,0.0,4,8,37,3,16,5,1,14,1,52,37,0
1627,33113,PjZvizXDkcC0c394BYUQIpEWacrPH7EJ,SpATywNh6bZuzm8s1ceuBUnMUAeoAHHw,22,28,0,30,0,25,15,2,100,14.285714285714286,3,0.0,11,0,27,0,17,25,3,15,2,38,62,1
1628,33121,pKcgftm88lERht9rjtO6yDT8uF9jnp1z,7GRhBDsirIGkRZBtSMEzNTyDr2JQm4xx,39,116,54,79,31,6,15,2,303,43.285714285714285,6,0.0,46,54,73,31,70,6,6,15,2,204,99,1
1629,33145,UUY3BPLR7A3Xa6FGsztMCn6xCbxtdCYu,SpATywNh6bZuzm8s1ceuBUnMUAeoAHHw,22,18,10,6,8,2,2,0,46,6.571428571428571,2,0.0,7,10,6,8,11,2,0,2,0,31,15,0
1630,33146,aFVLxK4Hau9wDglF79kWvvimpoa2MXNc,SpATywNh6bZuzm8s1ceuBUnMUAeoAHHw,25,36,10,30,3,71,14,3,167,23.857142857142858,3,0.0,10,10,27,3,26,71,3,14,3,50,117,1
1631,33156,NgffOurIf9EDLm5SB7efcduZd82QhoOU,RXDvfPUBYFlVdlueBFbLW0mhhAyGEqpt,20,19,10,12,6,13,5,0,65,9.285714285714286,2,0.0,4,10,12,6,15,13,0,5,0,32,33,0
1632,33173,poxISkj7mtTTcUTxHuC9BFrrsaF9KDef,7GRhBDsirIGkRZBtSMEzNTyDr2JQm4xx,30,69,23,54,20,5,5,0,176,25.142857142857142,3,0.0,42,23,48,20,27,5,6,5,0,133,43,1
1633,33187,yiWok4eQ5hgdJ8eYi2O0qHhy67Y9EA3E,SpATywNh6bZuzm8s1ceuBUnMUAeoAHHw,31,32,18,31,9,6,9,1,106,15.142857142857142,4,0.0,12,18,28,9,20,6,3,9,1,67,39,0
1634,33199,r9mrNmOIUUDf7AorDYXKUl4G7R8wfHcf,SpATywNh6bZuzm8s1ceuBUnMUAeoAHHw,30,39,21,40,11,2,10,3,126,18.0,2,0.0,10,21,35,11,29,2,5,10,3,77,49,0
1635,33234,we9tWnySpl1G7k7FqyXPj8wmC2gUYK0W,A3fsA9Zfv1X2fVEQhTw51lKENdNrEqT3,8,7,0,0,0,1,8,0,16,2.2857142857142856,3,0.0,0,0,0,0,7,1,0,8,0,0,16,0
1636,33280,1vY5OZ1u5dkB4jIpVDeMNw33uHVvYDm0,G8EPVSXsOYB5YQWZGiz1aVq5Pgr2GrQu,65,227,74,124,90,50,31,11,607,86.71428571428571,8,0.0,62,74,87,90,165,50,37,31,11,313,294,0
1637,33321,vIBcYbs1BLdmaaP30fcE2FS7kB7v7QRn,RXDvfPUBYFlVdlueBFbLW0mhhAyGEqpt,8,10,6,0,1,0,7,0,24,3.4285714285714284,2,0.0,0,6,0,1,10,0,0,7,0,7,17,1
1638,33325,jXgMhQKbkiBaFyvNHAIM6AePvnnTFQC0,SpATywNh6bZuzm8s1ceuBUnMUAeoAHHw,21,19,11,24,0,0,4,0,58,8.285714285714286,2,0.0,6,11,24,0,13,0,0,4,0,41,17,0
1639,33338,d5hgUNbUFsJ3QWa3NXhPxhtqZKrkuHi4,SpATywNh6bZuzm8s1ceuBUnMUAeoAHHw,15,14,6,8,3,0,5,0,36,5.142857142857143,3,0.0,6,6,8,3,8,0,0,5,0,23,13,0
1640,33366,fYLWMGJsW3Aq1nrs0wiSji5Q7ysltFRD,SpATywNh6bZuzm8s1ceuBUnMUAeoAHHw,10,8,4,0,2,0,7,0,21,3.0,2,0.0,0,4,0,2,8,0,0,7,0,6,15,1
1641,33375,BkBVFyB4tBI41wvM1Ppa7iaH93pA565M,7GRhBDsirIGkRZBtSMEzNTyDr2JQm4xx,3,0,0,0,0,12,2,0,14,2.0,1,0.0,0,0,0,0,0,12,0,2,0,0,14,1
1642,33400,R3LdCHGJ0oYuX8fUQhI8dRkzUs6gLWrE,SpATywNh6bZuzm8s1ceuBUnMUAeoAHHw,18,19,6,28,1,11,11,1,77,11.0,2,0.0,10,6,22,1,9,11,6,11,1,39,38,0
1643,33401,qV3ci4HSmOh0O2gqYUVjaVHqqz2r9u2d,G8EPVSXsOYB5YQWZGiz1aVq5Pgr2GrQu,5,3,1,0,0,0,2,0,6,0.8571428571428571,1,0.0,0,1,0,0,3,0,0,2,0,1,5,1
1644,33416,viuKt4GgrX0rYL5EpHoxJbsiC9TblSuk,SpATywNh6bZuzm8s1ceuBUnMUAeoAHHw,36,185,84,0,30,192,65,2,558,79.71428571428571,11,0.0,34,84,0,30,151,192,0,65,2,148,410,0
1645,33426,SbSUciasvLhHVTorJDvZBPRhwTmOgntH,SpATywNh6bZuzm8s1ceuBUnMUAeoAHHw,8,9,1,0,1,0,3,0,14,2.0,1,0.0,0,1,0,1,9,0,0,3,0,2,12,0
1646,33428,YlMrjX7ibus8JFFbvjYaUFTOz92jaztw,SpATywNh6bZuzm8s1ceuBUnMUAeoAHHw,10,15,10,0,5,22,2,0,54,7.714285714285714,2,0.0,1,10,0,5,14,22,0,2,0,16,38,0
1647,33475,0KNVWAChIRBDwntcO5Dr5l3KgkUsRh3O,SpATywNh6bZuzm8s1ceuBUnMUAeoAHHw,14,25,3,2,1,3,3,0,37,5.285714285714286,4,0.0,3,3,2,1,22,3,0,3,0,9,28,0
1648,33493,1vY5OZ1u5dkB4jIpVDeMNw33uHVvYDm0,SpATywNh6bZuzm8s1ceuBUnMUAeoAHHw,31,95,34,25,11,5,21,0,191,27.285714285714285,6,0.0,33,34,21,11,62,5,4,21,0,99,92,0
1649,33513,H2Rgqo3kRDsNdbNVEDl0788s9SSdLM8P,7GRhBDsirIGkRZBtSMEzNTyDr2JQm4xx,39,91,9,42,15,1,14,1,173,24.714285714285715,9,0.0,41,9,39,15,50,1,3,14,1,104,69,1
1650,33520,qmYTrueiQKfoQnGxjqfwlMlw7HOR9CKj,A3fsA9Zfv1X2fVEQhTw51lKENdNrEqT3,53,1287,53,78,20,3,34,2,1477,211.0,8,0.0,3,53,60,20,1284,3,18,34,2,136,1341,0
1651,33577,YZSZ4TOtqHUreAioK1x0YBDmIRumwoti,7GRhBDsirIGkRZBtSMEzNTyDr2JQm4xx,12,17,3,15,3,0,3,0,41,5.857142857142857,2,0.0,5,3,13,3,12,0,2,3,0,24,17,1
1652,33579,wFWVvTUKN4Nj5vWrbX5PVi6EvLKq8sqa,SpATywNh6bZuzm8s1ceuBUnMUAeoAHHw,32,34,14,38,8,4,10,5,113,16.142857142857142,2,0.0,15,14,31,8,19,4,7,10,5,68,45,0
1653,33601,B9KqNNxXBxHFUsJnQKQysblL3f8zF7sg,7GRhBDsirIGkRZBtSMEzNTyDr2JQm4xx,44,143,8,0,16,0,13,0,180,25.714285714285715,8,0.0,68,8,0,16,75,0,0,13,0,92,88,0
1654,33639,3bwizzI2zhkZarj0AirZFGuMorcba8W4,SpATywNh6bZuzm8s1ceuBUnMUAeoAHHw,32,56,29,29,14,25,35,8,196,28.0,5,0.0,10,29,25,14,46,25,4,35,8,78,118,1
1655,33643,InrAmtl2MgoSpFoohTtv1oXbh4bisxXW,bWdj2GDclj5ofokWjzoa5jAwMkxCykd6,13,22,9,12,3,2,19,2,69,9.857142857142858,6,0.0,1,9,10,3,21,2,2,19,2,23,46,0
1656,33666,RCdcltNaQLfcoxT7YKTjQxAYUbCmzzKd,A3fsA9Zfv1X2fVEQhTw51lKENdNrEqT3,41,39,30,86,15,2,12,0,184,26.285714285714285,7,0.0,1,30,71,15,38,2,15,12,0,117,67,0
1657,34602,bS2IOWKbnbandmSXQXzI1vhjNhpDoKfN,7GRhBDsirIGkRZBtSMEzNTyDr2JQm4xx,28,42,13,90,5,10,11,0,171,24.428571428571427,10,0.0,14,13,78,5,28,10,12,11,0,110,61,1
1658,34683,tEGUB4A2P1CFVrtUpVRZCuET3K7QndSr,7GRhBDsirIGkRZBtSMEzNTyDr2JQm4xx,8,5,3,0,2,0,6,0,16,2.2857142857142856,3,0.0,0,3,0,2,5,0,0,6,0,5,11,1
1659,34750,dZiWNJzMYOhdEdmTnxnlGn0TB2qVPzZP,7GRhBDsirIGkRZBtSMEzNTyDr2JQm4xx,2,0,0,0,0,0,3,0,3,0.42857142857142855,1,0.0,0,0,0,0,0,0,0,3,0,0,3,1
1660,34758,phhASQ029vNNdFMJmgP5NypplnmnI83R,7GRhBDsirIGkRZBtSMEzNTyDr2JQm4xx,13,16,9,49,1,0,5,0,80,11.428571428571429,3,0.0,2,9,43,1,14,0,6,5,0,55,25,0
1661,34766,PJE8xaLvi7LkfqoaW5URpwOl6Zp0XkBz,7GRhBDsirIGkRZBtSMEzNTyDr2JQm4xx,1,0,0,0,0,0,1,0,1,0.14285714285714285,1,0.0,0,0,0,0,0,0,0,1,0,0,1,1
1662,34792,dIopyk7eN7utmmbDdsk2JIW9Z0tySqPS,7GRhBDsirIGkRZBtSMEzNTyDr2JQm4xx,58,80,3,59,17,1,6,0,166,23.714285714285715,5,0.0,41,3,45,17,39,1,14,6,0,106,60,0
1663,34804,27KU7J0xhwne5RAwWlMtoP7JA6sMyYoP,7GRhBDsirIGkRZBtSMEzNTyDr2JQm4xx,1,0,0,0,0,0,1,0,1,0.14285714285714285,1,0.0,0,0,0,0,0,0,0,1,0,0,1,1
1664,34821,TRB5qhhumnbB7Yl6OQQJ0TCXgatMT1rj,7GRhBDsirIGkRZBtSMEzNTyDr2JQm4xx,6,3,2,0,2,0,1,0,8,1.1428571428571428,1,0.0,0,2,0,2,3,0,0,1,0,4,4,1
1665,34842,LyBG9vpZvAGsIKFzeD4gB6XRCVzk12fF,7GRhBDsirIGkRZBtSMEzNTyDr2JQm4xx,9,11,7,0,5,0,4,0,27,3.857142857142857,1,0.0,2,7,0,5,9,0,0,4,0,14,13,1
1666,34846,zVTKdKxLJYjz5XCh3vZ8AWdcMxkpEsE1,7GRhBDsirIGkRZBtSMEzNTyDr2JQm4xx,7,6,4,0,3,0,4,0,17,2.4285714285714284,1,0.0,0,4,0,3,6,0,0,4,0,7,10,1
1667,34848,iBXl7c5cfIbBo4iOvRO7FtL1YDwjYkZC,7GRhBDsirIGkRZBtSMEzNTyDr2JQm4xx,1,0,0,0,0,0,1,0,1,0.14285714285714285,1,0.0,0,0,0,0,0,0,0,1,0,0,1,1
1668,34857,pelK71W03sE3yGvlh2inDZDZzii32E4l,7GRhBDsirIGkRZBtSMEzNTyDr2JQm4xx,1,0,0,0,0,0,2,0,2,0.2857142857142857,1,0.0,0,0,0,0,0,0,0,2,0,0,2,1
1669,34883,C4q4gNQYEpjKh7pq1qjN8i3L7uSpUX9d,7GRhBDsirIGkRZBtSMEzNTyDr2JQm4xx,55,91,20,12,32,0,4,0,159,22.714285714285715,3,0.0,26,20,10,32,65,0,2,4,0,88,71,0
1670,34897,I7MInQU0IyHrO5RwKExwH0rTfGFmb00M,7GRhBDsirIGkRZBtSMEzNTyDr2JQm4xx,33,39,16,32,18,0,2,0,107,15.285714285714286,4,0.0,20,16,18,18,19,0,14,2,0,72,35,1
1671,35039,URPpxYyCEjr1OE9SkqYA4izrGFGWLVkB,7GRhBDsirIGkRZBtSMEzNTyDr2JQm4xx,42,115,28,62,17,1,8,0,231,33.0,3,0.0,41,28,53,17,74,1,9,8,0,139,92,1
1672,35082,8WC0ll7mpckRF9WawvJVdrokISfPhV8m,7GRhBDsirIGkRZBtSMEzNTyDr2JQm4xx,1,0,0,0,0,0,1,0,1,0.14285714285714285,1,0.0,0,0,0,0,0,0,0,1,0,0,1,1
1673,35109,oiUHDt5e0cU5z0JTxVcs5GBEfUv9FQOW,7GRhBDsirIGkRZBtSMEzNTyDr2JQm4xx,1,0,0,0,0,0,1,0,1,0.14285714285714285,1,0.0,0,0,0,0,0,0,0,1,0,0,1,1
1674,35143,7eHsOwDNMYF4417CWrgdB8gK0Wr4kfqA,7GRhBDsirIGkRZBtSMEzNTyDr2JQm4xx,76,237,73,161,35,3,37,1,547,78.14285714285714,8,0.0,132,73,136,35,105,3,25,37,1,376,171,0
1675,35149,0MLatjoztZTXhoA4l9vLnoup5p3z66PW,7GRhBDsirIGkRZBtSMEzNTyDr2JQm4xx,9,7,5,0,5,0,5,0,22,3.142857142857143,1,0.0,0,5,0,5,7,0,0,5,0,10,12,1
1676,35208,c0bjMduOwhlaRS3h8xRhAhid9jTsLzPD,7GRhBDsirIGkRZBtSMEzNTyDr2JQm4xx,5,5,2,0,1,0,1,0,9,1.2857142857142858,1,0.0,0,2,0,1,5,0,0,1,0,3,6,1
1677,35607,2LWu6JMOYyxkKMq63i00WbtT7iPpdOSr,7GRhBDsirIGkRZBtSMEzNTyDr2JQm4xx,2,0,0,0,0,0,2,0,2,0.2857142857142857,1,0.0,0,0,0,0,0,0,0,2,0,0,2,1
1678,35608,nH0kSZNGQd9lZaOsssfRVpCIHD2KW4j6,7GRhBDsirIGkRZBtSMEzNTyDr2JQm4xx,48,90,33,98,30,3,4,0,258,36.857142857142854,4,0.0,39,33,86,30,51,3,12,4,0,188,70,1
1679,35634,U3LNfYcdRIeU9qhiaPG7Yg8NuZRGOnSS,7GRhBDsirIGkRZBtSMEzNTyDr2JQm4xx,1,0,0,0,0,0,1,0,1,0.14285714285714285,1,0.0,0,0,0,0,0,0,0,1,0,0,1,1
1680,35662,ISNkLbVsU7lMqk5vdrFnPCVx4y3a9MZD,7GRhBDsirIGkRZBtSMEzNTyDr2JQm4xx,41,73,32,26,23,15,5,0,174,24.857142857142858,1,0.0,30,32,16,23,43,15,10,5,0,101,73,1
1681,35686,skJn7dtfSekFrPHRHs9swZ9AtSUKi36u,7GRhBDsirIGkRZBtSMEzNTyDr2JQm4xx,5,4,2,0,0,0,5,0,11,1.5714285714285714,3,0.0,0,2,0,0,4,0,0,5,0,2,9,0
1682,35696,Vtwq7W3DodckYgwQIiThiTk1zWdBpMl0,7GRhBDsirIGkRZBtSMEzNTyDr2JQm4xx,10,8,2,2,2,0,5,1,20,2.857142857142857,3,0.0,3,2,2,2,5,0,0,5,1,9,11,1
1683,35725,BqXfJC2PEXaOut3jaDziE5COnZJ5tCVg,7GRhBDsirIGkRZBtSMEzNTyDr2JQm4xx,19,14,5,12,6,0,2,0,39,5.571428571428571,2,0.0,7,5,7,6,7,0,5,2,0,25,14,1
1684,35881,712ruuJBHxwe16Nyde1AP6y2j0cVhIJD,7GRhBDsirIGkRZBtSMEzNTyDr2JQm4xx,68,51,16,76,11,0,5,0,159,22.714285714285715,1,0.0,28,16,75,11,23,0,1,5,0,130,29,0
1685,37552,gL9BFkziNrTyhzKvF4GTh7vW4ctCxqfr,SpATywNh6bZuzm8s1ceuBUnMUAeoAHHw,16,22,5,12,4,0,2,0,45,6.428571428571429,5,0.0,2,5,10,4,20,0,2,2,0,21,24,0
1686,37553,AVMp8F9T45cyhHDRnad5d9bxFkDP4PTv,A3fsA9Zfv1X2fVEQhTw51lKENdNrEqT3,35,21,2,74,1,1,11,1,111,15.857142857142858,3,0.0,2,2,66,1,19,1,8,11,1,71,40,1
1687,37581,mwc0YjZS72xD4dO6Zk7KmFewdh7PWkAS,SpATywNh6bZuzm8s1ceuBUnMUAeoAHHw,7,8,3,0,2,0,3,0,16,2.2857142857142856,4,0.0,0,3,0,2,8,0,0,3,0,5,11,0
1688,37584,06eFfwi64z4CVxg9kYU89F0UCK6M3gh2,G8EPVSXsOYB5YQWZGiz1aVq5Pgr2GrQu,12,10,1,0,3,0,3,0,17,2.4285714285714284,1,0.0,3,1,0,3,7,0,0,3,0,7,10,1
1689,37586,rVtxqWpWg55yh0PkkVeeVKt0oQv342j9,G8EPVSXsOYB5YQWZGiz1aVq5Pgr2GrQu,8,10,9,0,9,0,6,0,34,4.857142857142857,3,0.0,0,9,0,9,10,0,0,6,0,18,16,0
1690,37587,9RND50Xx7veKeepJEVVvFKwUGiemuZp5,G8EPVSXsOYB5YQWZGiz1aVq5Pgr2GrQu,10,10,5,0,3,0,4,0,22,3.142857142857143,4,0.0,0,5,0,3,10,0,0,4,0,8,14,1
1691,37588,XY4zkM1XF8dydjqcvDmQyLNW1UDj6PeN,A3fsA9Zfv1X2fVEQhTw51lKENdNrEqT3,37,31,13,60,7,0,6,0,117,16.714285714285715,2,0.0,3,13,51,7,28,0,9,6,0,74,43,1
1692,37610,v7t0p3xAszbLv0yg1dCcAEjixfvU7JCE,SpATywNh6bZuzm8s1ceuBUnMUAeoAHHw,32,74,34,34,12,14,40,3,211,30.142857142857142,6,0.0,27,34,27,12,47,14,7,40,3,100,111,0
1693,37611,unrsquMc9aFN95z680VOYlXL0dwyjnVg,bWdj2GDclj5ofokWjzoa5jAwMkxCykd6,12,30,10,36,3,1,9,1,90,12.857142857142858,5,0.0,6,10,34,3,24,1,2,9,1,53,37,1
1694,37625,6lLAZ0WiQMBHvxtAmgARKrfLfmbRRaSM,A3fsA9Zfv1X2fVEQhTw51lKENdNrEqT3,1,0,0,0,0,0,1,0,1,0.14285714285714285,1,0.0,0,0,0,0,0,0,0,1,0,0,1,1
1695,37629,KxrIXB4R6FFhAWrOx18fBUJq6eOomhrO,bWdj2GDclj5ofokWjzoa5jAwMkxCykd6,5,2,1,0,1,0,4,0,8,1.1428571428571428,2,0.0,0,1,0,1,2,0,0,4,0,2,6,1
1696,37636,08uQSEeVi17JB9WOQMIOM89vv6wgWS2O,SpATywNh6bZuzm8s1ceuBUnMUAeoAHHw,15,14,2,17,1,2,12,2,50,7.142857142857143,2,0.0,5,2,15,1,9,2,2,12,2,23,27,1
1697,37644,9irvFFpWGWd3HRZTxsfDJTqmA07T10ig,SpATywNh6bZuzm8s1ceuBUnMUAeoAHHw,7,2,1,0,1,3,4,1,12,1.7142857142857142,1,0.0,0,1,0,1,2,3,0,4,1,2,10,1
1698,37666,zeUi2UnQZPPF6bRQXw2s8LZ41ZOdqRAa,SpATywNh6bZuzm8s1ceuBUnMUAeoAHHw,30,35,19,12,8,5,12,1,92,13.142857142857142,7,0.0,7,19,12,8,28,5,0,12,1,46,46,0
1699,37683,fmWFGOtr4qK1lNBCrTOCxVLVNU6IZ5bU,bWdj2GDclj5ofokWjzoa5jAwMkxCykd6,1,0,0,0,0,0,1,0,1,0.14285714285714285,1,0.0,0,0,0,0,0,0,0,1,0,0,1,1
1700,37688,GcLKL1EMGPSsuLaGpCB2Rrlv3EuS2ngA,SpATywNh6bZuzm8s1ceuBUnMUAeoAHHw,6,2,1,0,1,0,3,0,7,1.0,1,0.0,0,1,0,1,2,0,0,3,0,2,5,1
1701,37690,1Ti3XKNP5gzLh1si7Apz4GKt53UijsKr,SpATywNh6bZuzm8s1ceuBUnMUAeoAHHw,29,48,17,32,7,0,12,0,116,16.571428571428573,4,0.0,14,17,32,7,34,0,0,12,0,70,46,0
1702,37691,FisqRa6EMb5EsK7GdBjEQwdg4YXD4Xed,bWdj2GDclj5ofokWjzoa5jAwMkxCykd6,26,69,42,90,12,25,17,0,255,36.42857142857143,6,0.0,9,42,81,12,60,25,9,17,0,144,111,1
1703,37706,5D134KQAUnU8gDw5hYnvC82YSO8giiEU,SpATywNh6bZuzm8s1ceuBUnMUAeoAHHw,31,50,17,29,8,10,14,1,129,18.428571428571427,5,0.0,23,17,23,8,27,10,6,14,1,71,58,0
1704,37708,YQZ85qW2KiDmX9GD2Tq3oRYH6ucmQmKe,RXDvfPUBYFlVdlueBFbLW0mhhAyGEqpt,15,19,11,8,6,0,4,0,48,6.857142857142857,2,0.0,1,11,7,6,18,0,1,4,0,25,23,1
1705,37710,t89Lbc9NyQ1awHKwpUunu51m4E6DMYhk,SpATywNh6bZuzm8s1ceuBUnMUAeoAHHw,18,30,11,22,1,8,9,1,82,11.714285714285714,4,0.0,12,11,20,1,18,8,2,9,1,44,38,0
1706,37713,7fOZzyBcCx06Vw2a40A0eroSD5VkDcNa,SpATywNh6bZuzm8s1ceuBUnMUAeoAHHw,30,47,25,24,13,31,18,2,160,22.857142857142858,6,0.0,17,25,20,13,30,31,4,18,2,75,85,0
1707,37722,NuWa1wNN62sioyREqwjInndithPqIOD8,A3fsA9Zfv1X2fVEQhTw51lKENdNrEqT3,5,3,2,0,1,0,3,0,9,1.2857142857142858,1,0.0,0,2,0,1,3,0,0,3,0,3,6,1
1708,37737,m7GeMdFl22gaxUtAD72z73B5tIK1shlq,SpATywNh6bZuzm8s1ceuBUnMUAeoAHHw,13,7,5,0,4,0,7,2,25,3.5714285714285716,3,0.0,0,5,0,4,7,0,0,7,2,9,16,1
1709,37761,bzoYFRQVu6SapCnsZ0DOXeU3JXiLIJu3,SpATywNh6bZuzm8s1ceuBUnMUAeoAHHw,30,31,13,25,7,19,12,3,110,15.714285714285714,5,0.0,14,13,25,7,17,19,0,12,3,59,51,0
1710,37764,b9kodEhA94IDSBT3ykY4QWiqr6rjyws0,SpATywNh6bZuzm8s1ceuBUnMUAeoAHHw,2,0,0,0,0,0,2,0,2,0.2857142857142857,1,0.0,0,0,0,0,0,0,0,2,0,0,2,1
1711,37769,gsdvPbnmqv3G3TICTRxTHCvyG0vd5lw3,G8EPVSXsOYB5YQWZGiz1aVq5Pgr2GrQu,33,52,28,56,12,32,18,1,199,28.428571428571427,2,0.0,18,28,37,12,34,32,19,18,1,95,104,1
1712,37782,MT2eJtF59AVNdUs7mwFqputROb2HgEm3,SpATywNh6bZuzm8s1ceuBUnMUAeoAHHw,23,18,10,25,5,3,3,0,64,9.142857142857142,3,0.0,5,10,22,5,13,3,3,3,0,42,22,0
1713,37784,BarsBzOr7FgzlrusMqrDFOsYw63YD64d,A3fsA9Zfv1X2fVEQhTw51lKENdNrEqT3,6,3,0,0,0,5,6,2,16,2.2857142857142856,1,0.0,0,0,0,0,3,5,0,6,2,0,16,1
1714,37788,y1rNC08s1iP76iivJMPjmiTg1SiPQTDp,SpATywNh6bZuzm8s1ceuBUnMUAeoAHHw,9,17,0,4,0,2,3,0,26,3.7142857142857144,2,0.0,1,0,4,0,16,2,0,3,0,5,21,1
1715,37831,fmoIo5oPDyRcnHhnGH8MKyUTeXZvimIR,SpATywNh6bZuzm8s1ceuBUnMUAeoAHHw,30,64,30,22,11,70,38,1,236,33.714285714285715,7,0.0,14,30,20,11,50,70,2,38,1,75,161,0
1716,37834,nEvQSo5dnPEv9AKi5Mbvgqg4cF9OoMSW,SpATywNh6bZuzm8s1ceuBUnMUAeoAHHw,16,13,7,7,3,4,10,1,45,6.428571428571429,1,0.0,3,7,6,3,10,4,1,10,1,19,26,1
1717,37873,dpBOLaUWFOAehWXZrpwiocVfiOMhN5GL,SpATywNh6bZuzm8s1ceuBUnMUAeoAHHw,29,52,17,37,12,5,13,0,136,19.428571428571427,2,0.0,24,17,30,12,28,5,7,13,0,83,53,0
1718,37883,9Uee7oEuuMmgPx2IzPfFkWgkHZyPbWr0,SpATywNh6bZuzm8s1ceuBUnMUAeoAHHw,21,34,17,19,7,0,5,0,82,11.714285714285714,5,0.0,12,17,19,7,22,0,0,5,0,55,27,0
1719,37887,5vUuq5ZeDCNce4LmvH0naoUjpb3qbNOp,bWdj2GDclj5ofokWjzoa5jAwMkxCykd6,8,17,7,18,3,0,6,0,51,7.285714285714286,4,0.0,3,7,16,3,14,0,2,6,0,29,22,1
1720,37893,UOoqOWQxtJ6HvrytZgfqguIfOgaBqbBw,SpATywNh6bZuzm8s1ceuBUnMUAeoAHHw,7,5,1,0,1,0,2,0,9,1.2857142857142858,1,0.0,0,1,0,1,5,0,0,2,0,2,7,1
1721,37894,qPQsrCDbNr80CImeaDwXdvYkweQdyVus,RXDvfPUBYFlVdlueBFbLW0mhhAyGEqpt,13,5,5,0,2,1,5,1,19,2.7142857142857144,1,0.0,0,5,0,2,5,1,0,5,1,7,12,0
1722,37904,313ZU7SnTnilkzRb4b84vNDTmwgTEy5n,G8EPVSXsOYB5YQWZGiz1aVq5Pgr2GrQu,21,12,10,0,10,0,3,0,35,5.0,2,0.0,0,10,0,10,12,0,0,3,0,20,15,1
1723,37905,lV4ifbsehEXWBwQOY9bU762jcRSMFY5M,SpATywNh6bZuzm8s1ceuBUnMUAeoAHHw,30,51,21,16,7,0,14,1,110,15.714285714285714,6,0.0,14,21,16,7,37,0,0,14,1,58,52,0
1724,37908,JWUvlcN404PLe0TeFXcH9piP650rZWof,SpATywNh6bZuzm8s1ceuBUnMUAeoAHHw,9,36,9,0,2,1,16,0,64,9.142857142857142,4,0.0,0,9,0,2,36,1,0,16,0,11,53,1
1725,37913,iBI4oBYQahSrgJM5NHLRivWj4vPgILKH,G8EPVSXsOYB5YQWZGiz1aVq5Pgr2GrQu,9,10,4,0,4,0,2,0,20,2.857142857142857,2,0.0,5,4,0,4,5,0,0,2,0,13,7,1
1726,37926,mUOanMUrsiycv8pF8RX4xyc7qtUXAMUs,bWdj2GDclj5ofokWjzoa5jAwMkxCykd6,15,25,11,52,11,0,4,0,103,14.714285714285714,4,0.0,10,11,47,11,15,0,5,4,0,79,24,1
1727,37929,Trm6c0xRzFyegURuKBBdNUenucp5uZb9,G8EPVSXsOYB5YQWZGiz1aVq5Pgr2GrQu,8,21,8,0,3,1,8,0,41,5.857142857142857,1,0.0,7,8,0,3,14,1,0,8,0,18,23,1
1728,37932,UYyUkvxHd4tIc6aiQcuHfsTYHPlQXaAb,G8EPVSXsOYB5YQWZGiz1aVq5Pgr2GrQu,88,112,55,240,33,9,22,8,479,68.42857142857143,4,0.0,52,55,172,33,60,9,68,22,8,312,167,1
1729,37949,QRq9SneqdOEdNrPCbzGfNOJsUrpMzzSX,A3fsA9Zfv1X2fVEQhTw51lKENdNrEqT3,6,2,1,0,0,1,6,1,11,1.5714285714285714,1,0.0,0,1,0,0,2,1,0,6,1,1,10,1
1730,37958,O3fc8NICaVWUo8M4PzoZRSLRDAOYKQm9,G8EPVSXsOYB5YQWZGiz1aVq5Pgr2GrQu,6,12,0,6,0,0,2,0,20,2.857142857142857,2,0.0,3,0,4,0,9,0,2,2,0,7,13,1
1731,37961,lI4gYBH1elniUs6lU536XKdTVOMiS4n1,SpATywNh6bZuzm8s1ceuBUnMUAeoAHHw,16,37,11,11,3,0,21,2,85,12.142857142857142,3,0.0,7,11,11,3,30,0,0,21,2,32,53,1
1732,37963,zyXPxdyvET7shVCE1kkdKwMY47AukbuA,G8EPVSXsOYB5YQWZGiz1aVq5Pgr2GrQu,13,11,2,0,2,12,10,1,38,5.428571428571429,2,0.0,2,2,0,2,9,12,0,10,1,6,32,0
1733,37968,o4fNZaSYX3UHutrkuKOAdzPPx4q40e5R,G8EPVSXsOYB5YQWZGiz1aVq5Pgr2GrQu,4,5,0,0,0,0,2,0,7,1.0,2,0.0,0,0,0,0,5,0,0,2,0,0,7,1
1734,37972,k0lvFNaTVHTtB1XHBZ8229ej4v1r4rPk,A3fsA9Zfv1X2fVEQhTw51lKENdNrEqT3,13,11,5,0,2,3,12,1,34,4.857142857142857,3,0.0,0,5,0,2,11,3,0,12,1,7,27,0
1735,37977,0w9tP8TINgzfbBeYFJprB82ry0PjYiWn,A3fsA9Zfv1X2fVEQhTw51lKENdNrEqT3,8,9,1,0,1,0,2,0,13,1.8571428571428572,1,0.0,0,1,0,1,9,0,0,2,0,2,11,1
1736,37992,lFmplH6KaQigIQOByvMn1p8i4p6OLLhs,SpATywNh6bZuzm8s1ceuBUnMUAeoAHHw,27,28,15,29,9,0,7,0,88,12.571428571428571,3,0.0,8,15,25,9,20,0,4,7,0,57,31,1
1737,37993,pYcnIzYPgb3xzrOvmR9y0UUIZo4gqKuO,SpATywNh6bZuzm8s1ceuBUnMUAeoAHHw,32,88,56,20,24,8,21,1,218,31.142857142857142,7,0.0,16,56,17,24,72,8,3,21,1,113,105,0
1738,37997,Y65j88wkyz5DKML6XOG6DUVrzLQhWfST,A3fsA9Zfv1X2fVEQhTw51lKENdNrEqT3,1,0,0,0,0,0,1,0,1,0.14285714285714285,1,0.0,0,0,0,0,0,0,0,1,0,0,1,1
1739,38005,u82lBhpDxJIwlZISEntCxj1zgVFdW0vT,RXDvfPUBYFlVdlueBFbLW0mhhAyGEqpt,1,0,0,0,0,0,1,0,1,0.14285714285714285,1,0.0,0,0,0,0,0,0,0,1,0,0,1,1
1740,38028,vxPhImq7e3kAhm2TgSi6LMfFEt4O2oEs,G8EPVSXsOYB5YQWZGiz1aVq5Pgr2GrQu,1,0,0,0,0,0,1,0,1,0.14285714285714285,1,0.0,0,0,0,0,0,0,0,1,0,0,1,1
1741,38049,7n0QZ7z1Xa9itNmJQbQwoSvEI6n7oD9f,G8EPVSXsOYB5YQWZGiz1aVq5Pgr2GrQu,29,21,16,22,14,4,8,3,88,12.571428571428571,2,0.0,2,16,18,14,19,4,4,8,3,50,38,0
1742,38066,3JBai7u7WOgX09HExPUwVpNowvdvIz4R,SpATywNh6bZuzm8s1ceuBUnMUAeoAHHw,8,14,3,0,3,0,6,0,26,3.7142857142857144,1,0.0,0,3,0,3,14,0,0,6,0,6,20,1
1743,38077,ltTao4EsmrwmN0pXNyC05GxRX7ymLAGM,SpATywNh6bZuzm8s1ceuBUnMUAeoAHHw,28,58,10,39,7,49,19,4,186,26.571428571428573,3,0.0,13,10,31,7,45,49,8,19,4,61,125,1
1744,38080,OF5BECbAO5zdcqQHFPvLM1mTcTskbMIs,SpATywNh6bZuzm8s1ceuBUnMUAeoAHHw,5,2,1,0,1,0,2,0,6,0.8571428571428571,1,0.0,0,1,0,1,2,0,0,2,0,2,4,1
1745,38096,EjRGtyRd7Px8PMzWSSey4NzmMFY5f6ai,A3fsA9Zfv1X2fVEQhTw51lKENdNrEqT3,7,5,0,0,0,0,3,0,8,1.1428571428571428,1,0.0,1,0,0,0,4,0,0,3,0,1,7,1
1746,38115,iVCEmNfeCwWMGAqNUnWf3L8wEjKUErLk,SpATywNh6bZuzm8s1ceuBUnMUAeoAHHw,13,10,7,8,6,0,2,0,33,4.714285714285714,1,0.0,2,7,7,6,8,0,1,2,0,22,11,1
1747,38117,udxFfabXtaVUvVlT3wEleIvfDBGe9yE2,SpATywNh6bZuzm8s1ceuBUnMUAeoAHHw,28,103,10,36,5,33,35,3,225,32.142857142857146,9,0.0,25,10,30,5,78,33,6,35,3,70,155,0
1748,38119,53oi8zKKD3qFJiM7JZLKGYnyxQCMyuUV,SpATywNh6bZuzm8s1ceuBUnMUAeoAHHw,24,31,19,3,10,0,13,0,76,10.857142857142858,4,0.0,2,19,3,10,29,0,0,13,0,34,42,0
1749,38128,UwkR7Vh4zbozAucPqUcQw4h7SMZr9zo0,G8EPVSXsOYB5YQWZGiz1aVq5Pgr2GrQu,31,51,14,46,12,3,22,3,151,21.571428571428573,1,0.0,18,14,35,12,33,3,11,22,3,79,72,1
1750,38133,cqdnmjbJq0lDv2xgeKuzXqVr5xQytWr0,SpATywNh6bZuzm8s1ceuBUnMUAeoAHHw,14,31,13,12,5,5,13,2,81,11.571428571428571,3,0.0,10,13,10,5,21,5,2,13,2,38,43,1
1751,38138,mInRZ91i4VWL94xI1UV5JCnlg7Y6Us1i,SpATywNh6bZuzm8s1ceuBUnMUAeoAHHw,9,9,3,19,1,2,3,0,37,5.285714285714286,1,0.0,5,3,16,1,4,2,3,3,0,25,12,1
1752,38143,NuIu6w9t8Lc1HMDSYdxabpGimNAWlvNQ,SpATywNh6bZuzm8s1ceuBUnMUAeoAHHw,1,0,0,0,0,0,3,0,3,0.42857142857142855,1,0.0,0,0,0,0,0,0,0,3,0,0,3,1
1753,38158,i1weaEaafaiWi31Ms4bwoF6JM4IRf714,SpATywNh6bZuzm8s1ceuBUnMUAeoAHHw,19,38,18,14,8,0,13,0,91,13.0,4,0.0,10,18,10,8,28,0,4,13,0,46,45,0
1754,38221,cANiCKhLAefO0FGisAnCzMrx1JIRd95C,SpATywNh6bZuzm8s1ceuBUnMUAeoAHHw,1,0,0,0,0,0,1,0,1,0.14285714285714285,1,0.0,0,0,0,0,0,0,0,1,0,0,1,1
1755,38230,iazFnp0WwUGX79mDdFk78xSp9PPvWXim,G8EPVSXsOYB5YQWZGiz1aVq5Pgr2GrQu,9,2,1,0,1,5,9,1,19,2.7142857142857144,1,0.0,0,1,0,1,2,5,0,9,1,2,17,1
1756,38233,ysJor7TWBYA7e95uEgB7VNWumWxuU518,SpATywNh6bZuzm8s1ceuBUnMUAeoAHHw,17,19,10,8,4,7,4,1,53,7.571428571428571,1,0.0,7,10,8,4,12,7,0,4,1,29,24,1
1757,38246,LTRNxyAcyQ3kCcXCEOrswo8s3Qc2KMU6,SpATywNh6bZuzm8s1ceuBUnMUAeoAHHw,9,21,3,0,2,0,9,0,35,5.0,4,0.0,0,3,0,2,21,0,0,9,0,5,30,1
1758,38247,jSpQCS8wUT6MHpQaGbLVjdDCTF3dAoT8,SpATywNh6bZuzm8s1ceuBUnMUAeoAHHw,18,41,16,24,8,22,20,1,132,18.857142857142858,3,0.0,18,16,20,8,23,22,4,20,1,62,70,0
1759,38253,sfuANiSFq72qS7aoKnyvPaRtXw7bLFiY,RXDvfPUBYFlVdlueBFbLW0mhhAyGEqpt,29,17,12,24,10,0,2,0,65,9.285714285714286,2,0.0,3,12,24,10,14,0,0,2,0,49,16,1
1760,38268,JDTEn5xJLcPCagcpPFhmwRsZ0N8AbJZ6,A3fsA9Zfv1X2fVEQhTw51lKENdNrEqT3,33,39,15,32,12,0,16,1,115,16.428571428571427,5,0.0,3,15,25,12,36,0,7,16,1,55,60,1
1761,38270,Dw8R0agU0UT0CHCyap3lEB834WRdn2Bl,SpATywNh6bZuzm8s1ceuBUnMUAeoAHHw,12,65,24,5,14,0,24,0,132,18.857142857142858,6,0.0,0,24,5,14,65,0,0,24,0,43,89,1
1762,38298,5FKi7MQVDgjqvQXvzQgvsTDVCkGiyjdK,SpATywNh6bZuzm8s1ceuBUnMUAeoAHHw,26,22,17,10,14,0,32,2,97,13.857142857142858,6,0.0,4,17,10,14,18,0,0,32,2,45,52,0
1763,38314,AVyodBv8C1SQfOiSO7xOfqn4Ds4wiCRY,A3fsA9Zfv1X2fVEQhTw51lKENdNrEqT3,17,14,1,0,0,15,10,1,41,5.857142857142857,2,0.0,0,1,0,0,14,15,0,10,1,1,40,1
1764,38327,rB1ONc72srD5rc2RXozcacnvBYqDF9fo,SpATywNh6bZuzm8s1ceuBUnMUAeoAHHw,14,25,1,9,3,1,5,0,44,6.285714285714286,2,0.0,14,1,9,3,11,1,0,5,0,27,17,1
1765,38328,XwPjxWDcCDaPkH71IgDdIxnm3Wz6b30d,SpATywNh6bZuzm8s1ceuBUnMUAeoAHHw,7,5,4,0,3,0,2,0,14,2.0,1,0.0,0,4,0,3,5,0,0,2,0,7,7,1
1766,38346,0KKudduxSM0i9qq9j381LmD3t0z9aJ9R,SpATywNh6bZuzm8s1ceuBUnMUAeoAHHw,14,29,2,10,0,5,19,1,66,9.428571428571429,6,0.0,14,2,10,0,15,5,0,19,1,26,40,0
1767,38356,DJeWlgB4cP1RQ3JZLa1wZwd4zgAbYOxv,SpATywNh6bZuzm8s1ceuBUnMUAeoAHHw,20,26,20,0,12,0,5,0,63,9.0,4,0.0,1,20,0,12,25,0,0,5,0,33,30,1
1768,38373,tiRtyjdLAEYu3JNWmyxWqeCTg4ly9Ea3,A3fsA9Zfv1X2fVEQhTw51lKENdNrEqT3,1,0,0,0,0,0,1,0,1,0.14285714285714285,1,0.0,0,0,0,0,0,0,0,1,0,0,1,1
1769,38379,bA9VLpiTLkvmdt5uyFO2FBNAiu4jehWj,SpATywNh6bZuzm8s1ceuBUnMUAeoAHHw,6,2,1,0,1,0,3,1,8,1.1428571428571428,1,0.0,0,1,0,1,2,0,0,3,1,2,6,1
1770,38386,MAkHN0TS4uaTPgKLso4eQ3LTCDiU28De,A3fsA9Zfv1X2fVEQhTw51lKENdNrEqT3,5,2,1,0,1,0,7,0,11,1.5714285714285714,2,0.0,0,1,0,1,2,0,0,7,0,2,9,1
1771,38396,4hVUUGEGYiw6Bdgp8UlEBQC8ko8eVYqV,G8EPVSXsOYB5YQWZGiz1aVq5Pgr2GrQu,10,17,1,6,1,0,2,0,27,3.857142857142857,2,0.0,6,1,4,1,11,0,2,2,0,12,15,1
1772,38414,sDWigCKujHowENc4QsnIRZ8UQl2larGF,RXDvfPUBYFlVdlueBFbLW0mhhAyGEqpt,6,9,2,0,1,0,1,0,13,1.8571428571428572,1,0.0,1,2,0,1,8,0,0,1,0,4,9,1
1773,38416,3koO9aMoYp8zzErC814zevxBi6TaaAOF,SpATywNh6bZuzm8s1ceuBUnMUAeoAHHw,14,16,1,25,0,37,11,5,95,13.571428571428571,2,0.0,6,1,20,0,10,37,5,11,5,27,68,0
1774,38436,v9mjKPlqj9n2M1xFKzFtpQVo3yi6HxGV,A3fsA9Zfv1X2fVEQhTw51lKENdNrEqT3,32,59,35,54,17,1,14,0,180,25.714285714285715,4,0.0,9,35,43,17,50,1,11,14,0,104,76,1
1775,38441,iwk5jwRoUXpb7apwoAzA2sr9pA9dpqVB,bWdj2GDclj5ofokWjzoa5jAwMkxCykd6,2,0,0,0,0,0,6,0,6,0.8571428571428571,2,0.0,0,0,0,0,0,0,0,6,0,0,6,1
1776,38442,r6bvKJ2a2G72TbQZE3LacWwmKi7rGXEx,G8EPVSXsOYB5YQWZGiz1aVq5Pgr2GrQu,8,11,3,0,3,0,2,0,19,2.7142857142857144,1,0.0,0,3,0,3,11,0,0,2,0,6,13,1
1777,38444,hBkBlAVjz5BY7zZnohogA0eA3ndLKNkg,SpATywNh6bZuzm8s1ceuBUnMUAeoAHHw,32,61,27,30,8,8,29,3,166,23.714285714285715,4,0.0,18,27,28,8,43,8,2,29,3,81,85,1
1778,38462,VUqbVeGCU5BsVYNffcOAJ9BDqeO65P9U,G8EPVSXsOYB5YQWZGiz1aVq5Pgr2GrQu,34,9,6,126,3,9,8,1,162,23.142857142857142,1,0.0,0,6,105,3,9,9,21,8,1,114,48,1
1779,38468,SHRanMph56qnHJKMofxrIA8VyLg99gvL,SpATywNh6bZuzm8s1ceuBUnMUAeoAHHw,16,57,25,12,11,3,35,0,143,20.428571428571427,9,0.0,9,25,10,11,48,3,2,35,0,55,88,0
1780,38469,kOr03XnYLBaytLqdfTXgh6ll5b7wmEto,SpATywNh6bZuzm8s1ceuBUnMUAeoAHHw,23,29,13,36,3,17,9,1,108,15.428571428571429,5,0.0,12,13,30,3,17,17,6,9,1,58,50,0
1781,38478,wYSxpzhDGDxqe5tb8zcGOA1V0q1ivqUs,SpATywNh6bZuzm8s1ceuBUnMUAeoAHHw,9,14,5,0,2,0,2,0,23,3.2857142857142856,1,0.0,8,5,0,2,6,0,0,2,0,15,8,1
1782,38487,G9YOnYlxMjTyBQskKi3FlOCiDMxWpomt,SpATywNh6bZuzm8s1ceuBUnMUAeoAHHw,18,22,10,5,6,0,3,0,46,6.571428571428571,2,0.0,1,10,4,6,21,0,1,3,0,21,25,1
1783,38491,UEGgGFOddxp081siu8g5s2awm2LAgg2C,SpATywNh6bZuzm8s1ceuBUnMUAeoAHHw,5,5,0,0,0,0,2,0,7,1.0,1,0.0,2,0,0,0,3,0,0,2,0,2,5,0
1784,38510,OsVYZ2chBGfS6TvOshYA5qBASHIKNM7Z,SpATywNh6bZuzm8s1ceuBUnMUAeoAHHw,18,26,15,16,6,35,14,2,114,16.285714285714285,4,0.0,2,15,14,6,24,35,2,14,2,37,77,1
1785,38516,5zW7QL5PVg4tmiZ3UmDwoFtZ0u1EHg1C,G8EPVSXsOYB5YQWZGiz1aVq5Pgr2GrQu,1,0,0,0,0,0,1,0,1,0.14285714285714285,1,0.0,0,0,0,0,0,0,0,1,0,0,1,1
1786,38521,WRiHtWJX61VUGyAGQFSHJ3czdrgqxeQW,G8EPVSXsOYB5YQWZGiz1aVq5Pgr2GrQu,1,0,0,0,0,0,3,0,3,0.42857142857142855,3,0.0,0,0,0,0,0,0,0,3,0,0,3,1
1787,38524,0utD2vP6cBRtrip5Htxbgl8CGlMSWQLX,SpATywNh6bZuzm8s1ceuBUnMUAeoAHHw,6,1,1,0,1,2,5,0,10,1.4285714285714286,3,0.0,0,1,0,1,1,2,0,5,0,2,8,1
1788,38533,pqUcxq00SFcjmnxHDdHJfvpMD3HzyhM8,A3fsA9Zfv1X2fVEQhTw51lKENdNrEqT3,9,12,6,0,1,2,8,0,29,4.142857142857143,6,0.0,0,6,0,1,12,2,0,8,0,7,22,0
1789,38542,kzXC5gLwxzrAZMym3dLm7LbQsy5flpkC,SpATywNh6bZuzm8s1ceuBUnMUAeoAHHw,1,0,0,0,0,0,1,0,1,0.14285714285714285,1,0.0,0,0,0,0,0,0,0,1,0,0,1,1
1790,38559,fd1NhQTFxl8TsBhiRc4F6bEwrFxQh7qC,bWdj2GDclj5ofokWjzoa5jAwMkxCykd6,5,2,1,0,1,0,2,0,6,0.8571428571428571,1,0.0,0,1,0,1,2,0,0,2,0,2,4,1
1791,38560,op5Oi3uTeIRoABlsMVgAwjAoITQ3GmAH,SpATywNh6bZuzm8s1ceuBUnMUAeoAHHw,17,27,11,15,5,0,8,0,66,9.428571428571429,2,0.0,12,11,13,5,15,0,2,8,0,41,25,1
1792,38566,LU9kxt8aKnlOn8SnA2EuX2MLajf5Sg2a,A3fsA9Zfv1X2fVEQhTw51lKENdNrEqT3,9,5,2,0,3,0,2,0,12,1.7142857142857142,1,0.0,1,2,0,3,4,0,0,2,0,6,6,1
1793,38569,5Rbvag4nzKt7RfTqiThTliUWaR0ZVWak,RXDvfPUBYFlVdlueBFbLW0mhhAyGEqpt,29,32,25,29,12,21,20,17,156,22.285714285714285,3,0.0,3,25,27,12,29,21,2,20,17,67,89,1
1794,38603,BK89tGWFvtCB5b9BaDDNxW929HW7wR4P,G8EPVSXsOYB5YQWZGiz1aVq5Pgr2GrQu,12,14,4,8,3,0,4,0,33,4.714285714285714,3,0.0,5,4,5,3,9,0,3,4,0,17,16,0
1795,38604,piuFZPcLrtqUCR4Mz7Dvqp0k5ELkq8NC,G8EPVSXsOYB5YQWZGiz1aVq5Pgr2GrQu,12,16,10,0,9,0,6,0,41,5.857142857142857,2,0.0,3,10,0,9,13,0,0,6,0,22,19,1
1796,38608,J0IJ83RVowrJWkvIAkcS1VNIhpCHoyob,A3fsA9Zfv1X2fVEQhTw51lKENdNrEqT3,5,1,1,0,1,0,2,0,5,0.7142857142857143,1,0.0,0,1,0,1,1,0,0,2,0,2,3,1
1797,38624,1eeJGwVZl6tkgP8o5hxfgeveRzoyzGC1,SpATywNh6bZuzm8s1ceuBUnMUAeoAHHw,17,12,7,10,3,5,5,1,43,6.142857142857143,2,0.0,2,7,8,3,10,5,2,5,1,20,23,1
1798,38626,vmk0Cb97y6KFP4NN2aQejQh8kNwAKs9K,SpATywNh6bZuzm8s1ceuBUnMUAeoAHHw,5,5,0,0,0,0,2,0,7,1.0,2,0.0,0,0,0,0,5,0,0,2,0,0,7,1
1799,38648,74izHUTVIKwdbm5ACRGoK7PWOEfmZhU5,bWdj2GDclj5ofokWjzoa5jAwMkxCykd6,6,4,2,10,1,0,1,0,18,2.5714285714285716,1,0.0,1,2,9,1,3,0,1,1,0,13,5,0
1800,38650,k1hHR6rkUwES1hOj6qPmM0zEpPF3eP6v,SpATywNh6bZuzm8s1ceuBUnMUAeoAHHw,7,4,3,0,3,0,2,0,12,1.7142857142857142,1,0.0,0,3,0,3,4,0,0,2,0,6,6,1
1801,38654,wJIBDD9rPqnYMIKUazC26GmZhLI0Mfvr,RXDvfPUBYFlVdlueBFbLW0mhhAyGEqpt,30,49,27,0,17,12,19,3,127,18.142857142857142,7,0.0,9,27,0,17,40,12,0,19,3,53,74,1
1802,38678,TZQB6KsadY5lwvd9JKuw3u0s2cwQm2RY,A3fsA9Zfv1X2fVEQhTw51lKENdNrEqT3,1,0,0,0,0,0,1,0,1,0.14285714285714285,1,0.0,0,0,0,0,0,0,0,1,0,0,1,1
1803,38683,7uDVcwukNss0paMtTOJXNPZUXWP9vYuG,A3fsA9Zfv1X2fVEQhTw51lKENdNrEqT3,5,2,1,0,1,0,2,0,6,0.8571428571428571,1,0.0,0,1,0,1,2,0,0,2,0,2,4,1
1804,38686,pNgLScEwGgq81vg0a0cEXKNs5eG2UXph,A3fsA9Zfv1X2fVEQhTw51lKENdNrEqT3,44,28,14,88,9,9,10,1,159,22.714285714285715,3,0.0,2,14,88,9,26,9,0,10,1,113,46,1
1805,38691,dCqryZS5yEyDDbYzWpFyoRjFGlVzafA6,SpATywNh6bZuzm8s1ceuBUnMUAeoAHHw,23,50,25,5,10,0,8,0,98,14.0,6,0.0,14,25,4,10,36,0,1,8,0,53,45,0
1806,38701,E4KzNEU3ybRlAOiHqHHsGQEXiaxyHgoT,RXDvfPUBYFlVdlueBFbLW0mhhAyGEqpt,50,67,31,131,19,34,21,19,322,46.0,4,0.0,26,31,118,19,41,34,13,21,19,194,128,0
1807,38718,KtiXcHNNiby4TrKgvBuU25mstwPooCPe,SpATywNh6bZuzm8s1ceuBUnMUAeoAHHw,16,24,7,16,3,0,5,0,55,7.857142857142857,2,0.0,14,7,14,3,10,0,2,5,0,38,17,1
1808,38728,afat5vUgkwgUU0apBrv11YGTyd4OwYTu,SpATywNh6bZuzm8s1ceuBUnMUAeoAHHw,4,0,0,0,0,1,3,0,4,0.5714285714285714,1,0.0,0,0,0,0,0,1,0,3,0,0,4,1
1809,38737,afat5vUgkwgUU0apBrv11YGTyd4OwYTu,A3fsA9Zfv1X2fVEQhTw51lKENdNrEqT3,2,0,0,0,0,0,2,0,2,0.2857142857142857,1,0.0,0,0,0,0,0,0,0,2,0,0,2,1
1810,38739,nPRsjektHdbQkeAf1fIK4JbhrESPbPsA,A3fsA9Zfv1X2fVEQhTw51lKENdNrEqT3,5,4,0,0,0,21,3,0,28,4.0,2,0.0,0,0,0,0,4,21,0,3,0,0,28,1
1811,38742,0kgVI4xJnG62oDVcCEoC6XWb9EsWLjc0,bWdj2GDclj5ofokWjzoa5jAwMkxCykd6,1,0,0,0,0,0,1,0,1,0.14285714285714285,1,0.0,0,0,0,0,0,0,0,1,0,0,1,1
1812,38763,8YWaMVS3w7XpLYfFIo5KA8X2u5rBj2lm,bWdj2GDclj5ofokWjzoa5jAwMkxCykd6,1,0,0,0,0,0,1,0,1,0.14285714285714285,1,0.0,0,0,0,0,0,0,0,1,0,0,1,1
1813,38768,7mwJyfao5KIX49E5WhJbQSfLSpyhsypU,SpATywNh6bZuzm8s1ceuBUnMUAeoAHHw,2,0,0,0,0,0,2,0,2,0.2857142857142857,1,0.0,0,0,0,0,0,0,0,2,0,0,2,1
1814,38796,krjhlLET7SMyK6bykccAT1LqXqo0aBBB,A3fsA9Zfv1X2fVEQhTw51lKENdNrEqT3,1,0,0,0,0,0,1,0,1,0.14285714285714285,1,0.0,0,0,0,0,0,0,0,1,0,0,1,1
1815,38799,RzMIvT7jMzqf1FBzeYDC0G8NjaFmpbg8,SpATywNh6bZuzm8s1ceuBUnMUAeoAHHw,6,3,2,0,2,0,1,0,8,1.1428571428571428,1,0.0,0,2,0,2,3,0,0,1,0,4,4,0
1816,38828,RtAy5lws7b5k9geORbL2U1lmgZpp3fVx,SpATywNh6bZuzm8s1ceuBUnMUAeoAHHw,9,13,1,0,1,0,8,0,23,3.2857142857142856,2,0.0,0,1,0,1,13,0,0,8,0,2,21,1
1817,38840,cXYtpsZ2fQmsdTOBAQ6nuO3uUXQTXgSe,SpATywNh6bZuzm8s1ceuBUnMUAeoAHHw,2,0,0,0,0,0,2,0,2,0.2857142857142857,1,0.0,0,0,0,0,0,0,0,2,0,0,2,1
1818,38845,BuxVbSmnOVgkaYnbyCiqICvSSomeF2JH,G8EPVSXsOYB5YQWZGiz1aVq5Pgr2GrQu,12,16,1,2,1,2,10,0,32,4.571428571428571,2,0.0,1,1,1,1,15,2,1,10,0,4,28,1
1819,38854,Xi85gYtmIKPj1CmvXveeSMqfVqnWSguE,bWdj2GDclj5ofokWjzoa5jAwMkxCykd6,8,9,6,0,3,32,6,0,56,8.0,4,0.0,0,6,0,3,9,32,0,6,0,9,47,0
1820,38855,uEJhWNudTN4AiJAcLu3Q22sgnPRHYbuv,G8EPVSXsOYB5YQWZGiz1aVq5Pgr2GrQu,56,55,23,154,13,2,18,2,267,38.142857142857146,4,0.0,12,23,139,13,43,2,15,18,2,187,80,0
1821,38857,9803qM4isShkjkoVAPID7DQVAjFPwCDe,A3fsA9Zfv1X2fVEQhTw51lKENdNrEqT3,2,0,0,0,0,0,8,0,8,1.1428571428571428,2,0.0,0,0,0,0,0,0,0,8,0,0,8,1
1822,38870,jaeRBfNSkyTpFxAZieHe5vTAkzlHFDmm,A3fsA9Zfv1X2fVEQhTw51lKENdNrEqT3,40,32,19,66,6,11,13,1,148,21.142857142857142,2,0.0,4,19,54,6,28,11,12,13,1,83,65,1
1823,38878,gSi0VgWgYBTsmYmeH4PYrjNlMDLA1S2c,SpATywNh6bZuzm8s1ceuBUnMUAeoAHHw,12,14,1,7,3,1,7,3,36,5.142857142857143,2,0.0,2,1,6,3,12,1,1,7,3,12,24,1
1824,38882,KbRlzY47exomwt4drbIiBF6s4vNevAUk,bWdj2GDclj5ofokWjzoa5jAwMkxCykd6,8,5,4,0,3,0,1,0,13,1.8571428571428572,1,0.0,0,4,0,3,5,0,0,1,0,7,6,1
1825,38894,lxM1uzj9RbEKW6MEHQHbWmFRP8lCwFlm,RXDvfPUBYFlVdlueBFbLW0mhhAyGEqpt,5,2,1,0,1,0,2,0,6,0.8571428571428571,1,0.0,0,1,0,1,2,0,0,2,0,2,4,1
1826,38899,uOTUidrDT0SJfarFY02mqsETfS65OeG7,SpATywNh6bZuzm8s1ceuBUnMUAeoAHHw,1,0,0,0,0,0,1,0,1,0.14285714285714285,1,0.0,0,0,0,0,0,0,0,1,0,0,1,1
1827,38905,Zfldpr4XdX0KviQz44l3WyKQ1DUv2CZO,bWdj2GDclj5ofokWjzoa5jAwMkxCykd6,5,2,1,0,1,0,4,0,8,1.1428571428571428,2,0.0,0,1,0,1,2,0,0,4,0,2,6,1
1828,38907,arTGhRrKZksM4iY72XDJ8i8oBmMABS0m,bWdj2GDclj5ofokWjzoa5jAwMkxCykd6,8,6,1,0,0,1,5,1,14,2.0,2,0.0,0,1,0,0,6,1,0,5,1,1,13,1
1829,38920,0a9a6o0rpJD7kzJZwGRL9kB3jevQvRa8,SpATywNh6bZuzm8s1ceuBUnMUAeoAHHw,22,39,1,34,0,4,29,3,110,15.714285714285714,5,0.0,12,1,26,0,27,4,8,29,3,39,71,0
1830,38935,Bv9FSXvHlE6wLC4E4yrAKqe3BQhrrtfx,bWdj2GDclj5ofokWjzoa5jAwMkxCykd6,11,16,0,40,1,0,4,0,61,8.714285714285714,2,0.0,5,0,39,1,11,0,1,4,0,45,16,1
1831,38949,7HiGv3GGo0SXqM9pqC4B8FvUEghdfkna,A3fsA9Zfv1X2fVEQhTw51lKENdNrEqT3,50,58,20,68,13,3,30,0,192,27.428571428571427,8,0.0,2,20,58,13,56,3,10,30,0,93,99,0
1832,38975,pYuNHmli0QywI9Z1zHRuk8HH63MuG9ox,SpATywNh6bZuzm8s1ceuBUnMUAeoAHHw,7,4,3,0,1,0,2,0,10,1.4285714285714286,1,0.0,0,3,0,1,4,0,0,2,0,4,6,1
1833,38998,GxuI91smqBqnZvedxTapokE0d2tIuvjB,SpATywNh6bZuzm8s1ceuBUnMUAeoAHHw,11,12,1,16,0,0,3,1,33,4.714285714285714,1,0.0,5,1,14,0,7,0,2,3,1,20,13,1
1834,39003,kdrVEJc2I4GXXrnMfkE91hbE8pwDL5M5,SpATywNh6bZuzm8s1ceuBUnMUAeoAHHw,16,16,2,9,2,0,5,1,35,5.0,2,0.0,2,2,9,2,14,0,0,5,1,15,20,0
1835,39004,v74bXrlUV6ca8Hla1JfufyayJvtXjR7H,SpATywNh6bZuzm8s1ceuBUnMUAeoAHHw,6,3,1,0,1,0,2,0,7,1.0,1,0.0,0,1,0,1,3,0,0,2,0,2,5,1
1836,39023,t66hZYQIW0VPLqiRabyUSn9c1rXaD96i,G8EPVSXsOYB5YQWZGiz1aVq5Pgr2GrQu,10,13,5,0,6,0,6,1,31,4.428571428571429,2,0.0,6,5,0,6,7,0,0,6,1,17,14,1
1837,39030,sUk3OLEiiNZtlo4krMYRLjkp5xwgbsPl,RXDvfPUBYFlVdlueBFbLW0mhhAyGEqpt,1,0,0,0,0,0,1,0,1,0.14285714285714285,1,0.0,0,0,0,0,0,0,0,1,0,0,1,1
1838,39031,3aJcxnpBDknIFELx5q7A1ed9nLB6csNj,A3fsA9Zfv1X2fVEQhTw51lKENdNrEqT3,8,4,3,0,3,0,1,0,11,1.5714285714285714,1,0.0,0,3,0,3,4,0,0,1,0,6,5,1
1839,39056,T4lMOZ9NGQ0RS4ue5IeZuDcW1ySIGZ9u,bWdj2GDclj5ofokWjzoa5jAwMkxCykd6,19,14,5,74,3,3,7,1,107,15.285714285714286,2,0.0,4,5,67,3,10,3,7,7,1,79,28,1
1840,39075,XyYnnl4AI9tScnU7RGEEZZNUDhUKeoxB,SpATywNh6bZuzm8s1ceuBUnMUAeoAHHw,4,3,2,0,1,0,3,0,9,1.2857142857142858,1,0.0,0,2,0,1,3,0,0,3,0,3,6,1
1841,39081,blQFA8HzhNQeb8MMYJXyJW6sPMdvZQKn,SpATywNh6bZuzm8s1ceuBUnMUAeoAHHw,13,14,5,6,4,1,1,0,31,4.428571428571429,1,0.0,8,5,6,4,6,1,0,1,0,23,8,1
1842,39083,1r2nGZGkg8GEqN3RApjS0ItoQ0nF4xaw,SpATywNh6bZuzm8s1ceuBUnMUAeoAHHw,1,0,0,0,0,0,2,0,2,0.2857142857142857,2,0.0,0,0,0,0,0,0,0,2,0,0,2,1
1843,39088,UvSPzXNBScAU9ByvT8o3qVBXbi67b3h8,G8EPVSXsOYB5YQWZGiz1aVq5Pgr2GrQu,5,5,1,0,1,0,1,0,8,1.1428571428571428,1,0.0,0,1,0,1,5,0,0,1,0,2,6,1
1844,39091,CJISoHtkGNnkB0CRrvBDw2uUj4sPNv5j,bWdj2GDclj5ofokWjzoa5jAwMkxCykd6,5,8,1,0,0,0,3,0,12,1.7142857142857142,3,0.0,0,1,0,0,8,0,0,3,0,1,11,1
1845,39095,Lc5TZPB93C58CDuO8VjF5g6g9boxDaHr,SpATywNh6bZuzm8s1ceuBUnMUAeoAHHw,15,33,1,22,0,45,18,1,120,17.142857142857142,3,0.0,15,1,19,0,18,45,3,18,1,35,85,1
1846,39098,N1NANPOEzVcSgsnoCvLHz8IcJu1p6TeM,bWdj2GDclj5ofokWjzoa5jAwMkxCykd6,1,0,0,0,0,0,1,0,1,0.14285714285714285,1,0.0,0,0,0,0,0,0,0,1,0,0,1,1
1847,39114,2nqqGgbA0MihvBXBZoRijk6wA6yRTkC8,SpATywNh6bZuzm8s1ceuBUnMUAeoAHHw,30,71,39,30,16,56,17,1,230,32.857142857142854,9,0.0,8,39,27,16,63,56,3,17,1,90,140,1
1848,39121,UflKWNcvi2MA5nN1C1yYIrKHClWLnxXf,SpATywNh6bZuzm8s1ceuBUnMUAeoAHHw,3,0,0,0,0,7,3,0,10,1.4285714285714286,2,0.0,0,0,0,0,0,7,0,3,0,0,10,1
1849,39134,wjTC7wnlKcnUR3GStNksYXKWSSmG8wiR,SpATywNh6bZuzm8s1ceuBUnMUAeoAHHw,28,37,21,28,10,1,14,1,112,16.0,2,0.0,11,21,25,10,26,1,3,14,1,67,45,1
1850,39140,zVX5LPwTGC1SEitxSfv31cubNXKJSEc2,SpATywNh6bZuzm8s1ceuBUnMUAeoAHHw,12,8,4,28,0,0,11,0,51,7.285714285714286,3,0.0,4,4,26,0,4,0,2,11,0,34,17,0
1851,39141,ILzL3Mkktf2JWNBXHKy152QukNojyWoV,SpATywNh6bZuzm8s1ceuBUnMUAeoAHHw,6,2,1,0,1,0,3,0,7,1.0,1,0.0,0,1,0,1,2,0,0,3,0,2,5,1
1852,39145,AVMp8F9T45cyhHDRnad5d9bxFkDP4PTv,bWdj2GDclj5ofokWjzoa5jAwMkxCykd6,1,0,0,0,0,0,1,0,1,0.14285714285714285,1,0.0,0,0,0,0,0,0,0,1,0,0,1,1
1853,39149,4UqKAySXvYrQJCWmxoUDAB7q5gWLAioi,SpATywNh6bZuzm8s1ceuBUnMUAeoAHHw,5,2,1,0,1,0,2,0,6,0.8571428571428571,1,0.0,0,1,0,1,2,0,0,2,0,2,4,1
1854,39154,BGVVwabO5K2aC65VwhxWT01Y18m3Nzj6,SpATywNh6bZuzm8s1ceuBUnMUAeoAHHw,26,69,1,27,2,90,13,3,205,29.285714285714285,4,0.0,19,1,24,2,50,90,3,13,3,46,159,0
1855,39157,1NMKv7RE12uBMKwNJI30Cx8Z5ltMGoee,RXDvfPUBYFlVdlueBFbLW0mhhAyGEqpt,1,0,0,0,0,0,1,0,1,0.14285714285714285,1,0.0,0,0,0,0,0,0,0,1,0,0,1,1
1856,39164,7GjcmlDBrfMQgiPOO8hsiYQuQLOINerQ,SpATywNh6bZuzm8s1ceuBUnMUAeoAHHw,29,48,20,32,7,0,9,0,116,16.571428571428573,4,0.0,21,20,28,7,27,0,4,9,0,76,40,0
1857,39173,ZzLLcAQUfjtXFFVyip2u00anhVLGCjVt,SpATywNh6bZuzm8s1ceuBUnMUAeoAHHw,6,3,1,0,1,0,2,0,7,1.0,1,0.0,0,1,0,1,3,0,0,2,0,2,5,1
1858,39177,HzHckETSltPKPBe9aHJBFKMPGsxyznRF,RXDvfPUBYFlVdlueBFbLW0mhhAyGEqpt,70,131,82,193,41,24,21,0,492,70.28571428571429,8,0.0,31,82,175,41,100,24,18,21,0,329,163,0
1859,39195,E4KzNEU3ybRlAOiHqHHsGQEXiaxyHgoT,G8EPVSXsOYB5YQWZGiz1aVq5Pgr2GrQu,38,70,23,92,13,3,9,0,210,30.0,3,0.0,40,23,63,13,30,3,29,9,0,139,71,0
1860,39200,mhEXeYR4fhAtV2BL9wCEhGJhQCxsqkvm,SpATywNh6bZuzm8s1ceuBUnMUAeoAHHw,10,8,3,0,5,0,11,0,27,3.857142857142857,1,0.0,5,3,0,5,3,0,0,11,0,13,14,1
1861,39228,46Kekotwda3n13NUXnmxT29j0BxeYz12,SpATywNh6bZuzm8s1ceuBUnMUAeoAHHw,5,2,1,0,1,0,2,0,6,0.8571428571428571,1,0.0,0,1,0,1,2,0,0,2,0,2,4,1
1862,39251,hmgBnYFDyZngu0mjeUhp0xYSYQ6O53Mz,SpATywNh6bZuzm8s1ceuBUnMUAeoAHHw,1,0,0,0,0,0,1,0,1,0.14285714285714285,1,0.0,0,0,0,0,0,0,0,1,0,0,1,1
1863,39253,eBPwvAxm4arXAr6DDABCeVRfgkKzrVG9,A3fsA9Zfv1X2fVEQhTw51lKENdNrEqT3,63,78,4,134,4,3,27,1,251,35.857142857142854,5,0.0,10,4,124,4,68,3,10,27,1,142,109,1
1864,39257,PATQ2JDuYcR1iRnRPNzs82w3vSQnScOh,A3fsA9Zfv1X2fVEQhTw51lKENdNrEqT3,1,0,0,0,0,0,1,0,1,0.14285714285714285,1,0.0,0,0,0,0,0,0,0,1,0,0,1,1
1865,39262,1w8EW76qmBSgQ2s8Jb4yoPsNX01KUcoD,SpATywNh6bZuzm8s1ceuBUnMUAeoAHHw,4,2,1,0,1,0,1,0,5,0.7142857142857143,1,0.0,0,1,0,1,2,0,0,1,0,2,3,1
1866,39271,MuWLBiVwYCkYNKOHYGJD8tH8opD9K24n,G8EPVSXsOYB5YQWZGiz1aVq5Pgr2GrQu,24,30,0,36,1,5,9,1,82,11.714285714285714,2,0.0,12,0,27,1,18,5,9,9,1,40,42,1
1867,39279,MbSy3vYucWpXbJ8XgmPxO6zrZOjC9oUB,SpATywNh6bZuzm8s1ceuBUnMUAeoAHHw,16,37,21,16,10,0,12,0,96,13.714285714285714,5,0.0,6,21,13,10,31,0,3,12,0,50,46,1
1868,39285,YqUtlfMe9rLKsCC9IaplFVEXt8vH7Xc8,SpATywNh6bZuzm8s1ceuBUnMUAeoAHHw,7,15,1,0,0,0,2,0,18,2.5714285714285716,1,0.0,4,1,0,0,11,0,0,2,0,5,13,1
1869,39321,zFmjJfAeKUvggwuYYEK06j1MuKf2V5Jp,G8EPVSXsOYB5YQWZGiz1aVq5Pgr2GrQu,8,2,1,0,1,0,5,1,10,1.4285714285714286,1,0.0,0,1,0,1,2,0,0,5,1,2,8,1
1870,39328,iJftBP3zncmjUCwGWSZ77IUrDb3Dt8rz,A3fsA9Zfv1X2fVEQhTw51lKENdNrEqT3,36,21,14,70,11,0,4,0,120,17.142857142857142,2,0.0,1,14,54,11,20,0,16,4,0,80,40,0
1871,39355,z3YnX73v2uoVHmuLGzQD2gKKBoJqIQxK,A3fsA9Zfv1X2fVEQhTw51lKENdNrEqT3,39,30,21,90,17,9,6,0,173,24.714285714285715,4,0.0,5,21,72,17,25,9,18,6,0,115,58,1
1872,39364,yl2extq9BiirsP1wIY2qyqtEIn2eAosn,A3fsA9Zfv1X2fVEQhTw51lKENdNrEqT3,12,15,7,0,1,2,8,1,34,4.857142857142857,1,0.0,1,7,0,1,14,2,0,8,1,9,25,1
1873,39369,nACUst6Z3nbYOefsNnWJBD4yiz9OCgPb,A3fsA9Zfv1X2fVEQhTw51lKENdNrEqT3,2,0,0,0,0,0,2,0,2,0.2857142857142857,1,0.0,0,0,0,0,0,0,0,2,0,0,2,1
1874,39386,xcD6YWhnGA2xukGmX4eaYrm6VS9ffz1H,A3fsA9Zfv1X2fVEQhTw51lKENdNrEqT3,1,0,0,0,0,0,1,0,1,0.14285714285714285,1,0.0,0,0,0,0,0,0,0,1,0,0,1,1
1875,39408,mC2fzvwPaO34Kq32ibCwzrJ2EjHwbRrb,A3fsA9Zfv1X2fVEQhTw51lKENdNrEqT3,23,63,34,0,23,0,12,1,133,19.0,3,0.0,0,34,0,23,63,0,0,12,1,57,76,1
1876,39416,NiOuJ51IxTtojHMts8OdX2AfCH09G7vK,SpATywNh6bZuzm8s1ceuBUnMUAeoAHHw,13,12,8,0,5,0,8,0,33,4.714285714285714,3,0.0,0,8,0,5,12,0,0,8,0,13,20,1
1877,39435,eOxm8XEI11Xs6eiBi1Nu5QzIagZXwEm9,A3fsA9Zfv1X2fVEQhTw51lKENdNrEqT3,1,0,0,0,0,0,1,0,1,0.14285714285714285,1,0.0,0,0,0,0,0,0,0,1,0,0,1,1
1878,39437,YaP2AuckukEZITP3IVvIt6Z8ci6RHew7,A3fsA9Zfv1X2fVEQhTw51lKENdNrEqT3,33,39,35,18,21,1,7,1,122,17.428571428571427,2,0.0,0,35,15,21,39,1,3,7,1,71,51,1
1879,39438,PCU2OsmEUaGQvWJWbob5pKb7iiPbQ7ze,SpATywNh6bZuzm8s1ceuBUnMUAeoAHHw,20,46,5,8,4,2,35,1,101,14.428571428571429,8,0.0,11,5,8,4,35,2,0,35,1,28,73,1
1880,39445,P8w9ro0HOkoKzPyzFHSnLuYXXRtV1BHH,RXDvfPUBYFlVdlueBFbLW0mhhAyGEqpt,15,25,11,0,6,0,5,0,47,6.714285714285714,2,0.0,0,11,0,6,25,0,0,5,0,17,30,1
1881,39461,6Trp4kpO6fwwtbebtvF77MGUNovs9zvp,SpATywNh6bZuzm8s1ceuBUnMUAeoAHHw,15,12,8,14,6,0,5,0,45,6.428571428571429,2,0.0,3,8,13,6,9,0,1,5,0,30,15,1
1882,39480,CFP5BToaLlKEM1IV3uFEyj5nP0RKpJGG,RXDvfPUBYFlVdlueBFbLW0mhhAyGEqpt,14,20,11,0,6,5,8,0,50,7.142857142857143,1,0.0,0,11,0,6,20,5,0,8,0,17,33,1
1883,39481,evkJ1tKmVFYbszWTpTeoBUR5H84hykAY,SpATywNh6bZuzm8s1ceuBUnMUAeoAHHw,13,38,10,13,2,2,15,0,80,11.428571428571429,4,0.0,11,10,10,2,27,2,3,15,0,33,47,0
1884,39493,Sw0laYN5mow6XiHfrWCJl4qnRcU0Nesb,SpATywNh6bZuzm8s1ceuBUnMUAeoAHHw,27,30,18,29,7,0,7,0,91,13.0,5,0.0,5,18,27,7,25,0,2,7,0,57,34,0
1885,39498,iVCEmNfeCwWMGAqNUnWf3L8wEjKUErLk,A3fsA9Zfv1X2fVEQhTw51lKENdNrEqT3,1,0,0,0,0,0,1,0,1,0.14285714285714285,1,0.0,0,0,0,0,0,0,0,1,0,0,1,1
1886,39518,jeuXS3tUDyyNfvbrveLA3P9Aday4J2bg,SpATywNh6bZuzm8s1ceuBUnMUAeoAHHw,27,29,15,25,7,0,10,0,86,12.285714285714286,6,0.0,5,15,25,7,24,0,0,10,0,52,34,0
1887,39521,KkCL9hhbl4No8xC8Kgerd95M1LSlSYMD,G8EPVSXsOYB5YQWZGiz1aVq5Pgr2GrQu,29,77,4,50,2,14,32,2,181,25.857142857142858,3,0.0,30,4,38,2,47,14,12,32,2,74,107,0
1888,39522,WMPYVFkG1npps8BU0n5fJtN4LOF8N9L7,A3fsA9Zfv1X2fVEQhTw51lKENdNrEqT3,1,0,0,0,0,0,1,0,1,0.14285714285714285,1,0.0,0,0,0,0,0,0,0,1,0,0,1,1
1889,39523,U2HBhhMvJdYJzypYvAaM7auP4hEAIFmE,SpATywNh6bZuzm8s1ceuBUnMUAeoAHHw,26,29,13,29,4,11,13,2,101,14.428571428571429,4,0.0,9,13,27,4,20,11,2,13,2,53,48,0
1890,39528,UPv4XJg0qIN0z1e32NPBqipWdQJZCo5I,G8EPVSXsOYB5YQWZGiz1aVq5Pgr2GrQu,123,180,118,243,55,0,71,3,670,95.71428571428571,13,0.0,26,118,203,55,154,0,40,71,3,402,268,0
1891,39531,ZicPLcC85bFypm3Kcvbq59RwoYBxR8MH,A3fsA9Zfv1X2fVEQhTw51lKENdNrEqT3,36,32,14,58,2,2,29,3,140,20.0,8,0.0,7,14,52,2,25,2,6,29,3,75,65,1
1892,39532,cULoH8ZJIqrdeB8ADfKnnQ8THzmbMgQV,RXDvfPUBYFlVdlueBFbLW0mhhAyGEqpt,1,0,0,0,0,0,1,0,1,0.14285714285714285,1,0.0,0,0,0,0,0,0,0,1,0,0,1,1
1893,39542,rVLakh088SHEy7dbxY22je6HzyBvqGMw,A3fsA9Zfv1X2fVEQhTw51lKENdNrEqT3,5,2,1,0,1,0,2,0,6,0.8571428571428571,1,0.0,0,1,0,1,2,0,0,2,0,2,4,1
1894,39551,iwZaMWnVmB8vAWyB7qgI9UDj7NG1VyL9,G8EPVSXsOYB5YQWZGiz1aVq5Pgr2GrQu,17,36,14,14,4,1,1,0,70,10.0,3,0.0,3,14,12,4,33,1,2,1,0,33,37,1
1895,39566,Tgv3JnuulONnAU5nEHKsBYsIQCqMFPi1,SpATywNh6bZuzm8s1ceuBUnMUAeoAHHw,14,29,4,22,2,0,5,0,62,8.857142857142858,2,0.0,8,4,18,2,21,0,4,5,0,32,30,1
1896,39591,fqudw8MOLcF9t0i6q2XPWF2TIejKMZHF,SpATywNh6bZuzm8s1ceuBUnMUAeoAHHw,7,3,2,0,2,0,2,0,9,1.2857142857142858,1,0.0,0,2,0,2,3,0,0,2,0,4,5,1
1897,39602,il53m0D8iMReEupAF0qvTcyM0rInz34F,bWdj2GDclj5ofokWjzoa5jAwMkxCykd6,6,2,1,0,1,0,3,0,7,1.0,1,0.0,0,1,0,1,2,0,0,3,0,2,5,1
1898,39603,BYn6cWVQSMORsIVShYVRAnnkHpLyiUv8,A3fsA9Zfv1X2fVEQhTw51lKENdNrEqT3,14,11,8,0,4,0,5,0,28,4.0,3,0.0,0,8,0,4,11,0,0,5,0,12,16,1
1899,39610,5JJq364DIcWk9Vho0reVJETDCFza3l8p,SpATywNh6bZuzm8s1ceuBUnMUAeoAHHw,17,37,13,13,4,8,14,0,89,12.714285714285714,4,0.0,17,13,11,4,20,8,2,14,0,45,44,1
1900,39635,xcD6YWhnGA2xukGmX4eaYrm6VS9ffz1H,SpATywNh6bZuzm8s1ceuBUnMUAeoAHHw,30,54,30,24,12,11,17,0,148,21.142857142857142,6,0.0,13,30,21,12,41,11,3,17,0,76,72,0
1901,39643,IueU0b60sjtimOacIi9j88xjmyRWizli,G8EPVSXsOYB5YQWZGiz1aVq5Pgr2GrQu,15,16,9,12,3,4,16,8,68,9.714285714285714,3,0.0,0,9,10,3,16,4,2,16,8,22,46,0
1902,39650,6FzXe5nPWUHRxntREHsQRnp7x1pxuhUz,SpATywNh6bZuzm8s1ceuBUnMUAeoAHHw,27,75,33,16,15,0,14,0,153,21.857142857142858,8,0.0,18,33,16,15,57,0,0,14,0,82,71,0
1903,39665,XZfHeQwgEwa34fwsEe2zig6GAMNgCcPL,SpATywNh6bZuzm8s1ceuBUnMUAeoAHHw,16,48,19,5,9,4,20,1,106,15.142857142857142,3,0.0,11,19,4,9,37,4,1,20,1,43,63,1
1904,39667,eSr3zMoztxzII0MHEvdbKbrYmBK0ecDT,SpATywNh6bZuzm8s1ceuBUnMUAeoAHHw,9,13,6,0,3,2,4,0,28,4.0,2,0.0,0,6,0,3,13,2,0,4,0,9,19,1
1905,39692,s8yyjhcg4BVOip4HSP4txOTTHFJ4aWPU,bWdj2GDclj5ofokWjzoa5jAwMkxCykd6,1,0,0,0,0,0,4,0,4,0.5714285714285714,2,0.0,0,0,0,0,0,0,0,4,0,0,4,1
1906,39696,yvSkslbVS47eGhtXe3MSajZNXyqoO8P1,SpATywNh6bZuzm8s1ceuBUnMUAeoAHHw,16,14,9,12,4,3,9,0,51,7.285714285714286,1,0.0,2,9,11,4,12,3,1,9,0,26,25,1
1907,39708,eHl6vKLwTQcSxYHb6DIMnO9xh3WNvHJf,SpATywNh6bZuzm8s1ceuBUnMUAeoAHHw,23,25,13,18,9,4,6,0,75,10.714285714285714,3,0.0,10,13,18,9,15,4,0,6,0,50,25,0
1908,39712,wVfyl6WgFur5urtfx8TypP7osjiRs72N,SpATywNh6bZuzm8s1ceuBUnMUAeoAHHw,6,3,0,0,0,5,3,0,11,1.5714285714285714,1,0.0,1,0,0,0,2,5,0,3,0,1,10,1
1909,39737,qRawfA1fPOcB5hZkORgH0hm8Ghubmgi1,A3fsA9Zfv1X2fVEQhTw51lKENdNrEqT3,2,0,0,0,0,1,2,0,3,0.42857142857142855,1,0.0,0,0,0,0,0,1,0,2,0,0,3,0
1910,39748,Y6PIDel0N3JB5RPAU8dzX7ZliiFlTqHS,SpATywNh6bZuzm8s1ceuBUnMUAeoAHHw,10,15,0,0,0,2,9,0,26,3.7142857142857144,3,0.0,0,0,0,0,15,2,0,9,0,0,26,1
1911,39750,g6zfMiS5ibUHTabfgiFKHajbGLSVfwvj,SpATywNh6bZuzm8s1ceuBUnMUAeoAHHw,22,33,19,12,5,15,16,1,101,14.428571428571429,4,0.0,6,19,10,5,27,15,2,16,1,40,61,1
1912,39758,wIj7H8utbODHp6xu3FxVq3czUnyCOoPI,A3fsA9Zfv1X2fVEQhTw51lKENdNrEqT3,40,23,13,100,7,2,8,1,154,22.0,1,0.0,6,13,84,7,17,2,16,8,1,110,44,1
1913,39766,Bq3dgySLNxUfP2DnFVHYyEWwaDcd9ALN,A3fsA9Zfv1X2fVEQhTw51lKENdNrEqT3,23,17,11,0,9,0,5,0,42,6.0,4,0.0,0,11,0,9,17,0,0,5,0,20,22,1
1914,39785,LIcmzVFUc9QeLs85yNk05hYWndHHL2L3,A3fsA9Zfv1X2fVEQhTw51lKENdNrEqT3,10,6,5,0,5,0,4,2,22,3.142857142857143,1,0.0,0,5,0,5,6,0,0,4,2,10,12,1
1915,39793,suOeipVROVXXPGj0VZHJUUTxQ7mEMHZk,A3fsA9Zfv1X2fVEQhTw51lKENdNrEqT3,10,5,4,0,3,0,2,0,14,2.0,1,0.0,0,4,0,3,5,0,0,2,0,7,7,1
1916,39795,ePUeHwknBJGR0K3G08IRIZccLLyuYW03,SpATywNh6bZuzm8s1ceuBUnMUAeoAHHw,6,5,1,0,0,0,3,0,9,1.2857142857142858,2,0.0,0,1,0,0,5,0,0,3,0,1,8,1
1917,39803,VdNVtOVHu3uq36SFu7mu40diveL7bnVd,A3fsA9Zfv1X2fVEQhTw51lKENdNrEqT3,11,11,8,0,6,0,4,0,29,4.142857142857143,2,0.0,0,8,0,6,11,0,0,4,0,14,15,1
1918,39804,KSzd6DMLdMMhFe5tf0DcSjOsxB002C2u,SpATywNh6bZuzm8s1ceuBUnMUAeoAHHw,9,10,4,0,2,1,15,2,34,4.857142857142857,1,0.0,0,4,0,2,10,1,0,15,2,6,28,1
1919,39840,eTm1NthBlqTXH0yqAhllYK6AeYLcvZS4,SpATywNh6bZuzm8s1ceuBUnMUAeoAHHw,28,29,16,31,8,2,5,0,91,13.0,5,0.0,7,16,27,8,22,2,4,5,0,58,33,1
1920,39841,9BRoND09uAkQha4X7ED5IFkfUaItyWWP,SpATywNh6bZuzm8s1ceuBUnMUAeoAHHw,9,8,2,0,2,0,3,0,15,2.142857142857143,2,0.0,2,2,0,2,6,0,0,3,0,6,9,1
1921,39845,xwqLmgu4yZxUsX04FDtQMDL3awvB0E5w,SpATywNh6bZuzm8s1ceuBUnMUAeoAHHw,24,47,19,18,7,0,16,0,107,15.285714285714286,7,0.0,15,19,15,7,32,0,3,16,0,56,51,0
1922,39859,bgVZEKpin3FcOsrwuoniLCnRgCNbZTOm,G8EPVSXsOYB5YQWZGiz1aVq5Pgr2GrQu,17,21,16,30,8,0,4,0,79,11.285714285714286,3,0.0,0,16,24,8,21,0,6,4,0,48,31,1
1923,39878,pLB7K8hva7hpUpPIa0JWEXpoyBHIkbAO,SpATywNh6bZuzm8s1ceuBUnMUAeoAHHw,32,50,25,32,8,7,14,1,137,19.571428571428573,3,0.0,17,25,27,8,33,7,5,14,1,77,60,1
1924,39908,Ubjq3ZPvBATiaU1sX2JibbPoyNs9VBpQ,SpATywNh6bZuzm8s1ceuBUnMUAeoAHHw,1,0,0,0,0,0,1,0,1,0.14285714285714285,1,0.0,0,0,0,0,0,0,0,1,0,0,1,1
1925,39917,ElXKVW194Vk4gMqfG0BJNLqGRaVlSemx,bWdj2GDclj5ofokWjzoa5jAwMkxCykd6,1,0,0,0,0,0,1,0,1,0.14285714285714285,1,0.0,0,0,0,0,0,0,0,1,0,0,1,1
1926,39922,2GATpIfDBYFyTgYmFkr0bda9mVfNXuAl,SpATywNh6bZuzm8s1ceuBUnMUAeoAHHw,23,57,2,24,0,21,17,1,122,17.428571428571427,9,0.0,5,2,24,0,52,21,0,17,1,31,91,0
1927,39939,AVWcvCCDqAG8PgmRAI5YyxSBbxSiVsy5,SpATywNh6bZuzm8s1ceuBUnMUAeoAHHw,4,2,1,0,1,0,1,0,5,0.7142857142857143,1,0.0,0,1,0,1,2,0,0,1,0,2,3,1
1928,39942,ddMTOiTV5HSxEMNnjSDeiKLzuF1YmYcT,SpATywNh6bZuzm8s1ceuBUnMUAeoAHHw,4,3,2,0,0,0,1,0,6,0.8571428571428571,1,0.0,0,2,0,0,3,0,0,1,0,2,4,1
1929,39946,CkKaHAvtocTb1rem1r8BN1SLAQUDW1pY,bWdj2GDclj5ofokWjzoa5jAwMkxCykd6,6,1,1,0,1,1,4,0,8,1.1428571428571428,1,0.0,0,1,0,1,1,1,0,4,0,2,6,1
1930,39958,Peb8kjmFqGQvYDTvo4JTH8WhAEOnPF2h,SpATywNh6bZuzm8s1ceuBUnMUAeoAHHw,15,18,6,9,4,2,5,0,44,6.285714285714286,3,0.0,10,6,8,4,8,2,1,5,0,28,16,1
1931,39962,p3Cz4BAZGaZT08I2Dwew8OwWDC6PUWgc,SpATywNh6bZuzm8s1ceuBUnMUAeoAHHw,27,31,14,15,7,2,7,0,76,10.857142857142858,6,0.0,12,14,15,7,19,2,0,7,0,48,28,1
1932,39979,a3HtyjZsIXy0rlfdz7IVbfqFoPB13M3i,G8EPVSXsOYB5YQWZGiz1aVq5Pgr2GrQu,9,28,2,4,2,0,1,0,37,5.285714285714286,4,0.0,6,2,3,2,22,0,1,1,0,13,24,1
1933,39994,CFP5BToaLlKEM1IV3uFEyj5nP0RKpJGG,A3fsA9Zfv1X2fVEQhTw51lKENdNrEqT3,1,0,0,0,0,0,1,0,1,0.14285714285714285,1,0.0,0,0,0,0,0,0,0,1,0,0,1,1
1934,40026,JlRuZgjmv2hzO83ouspiZFc9FxGockFl,RXDvfPUBYFlVdlueBFbLW0mhhAyGEqpt,16,20,9,0,3,0,5,0,37,5.285714285714286,5,0.0,0,9,0,3,20,0,0,5,0,12,25,1
1935,40036,vUH5NhW2dOJJ7pGM4nFysRqnPlXzFZdY,SpATywNh6bZuzm8s1ceuBUnMUAeoAHHw,24,33,4,33,3,0,5,0,78,11.142857142857142,4,0.0,4,4,28,3,29,0,5,5,0,39,39,0
1936,40067,p2NSaI2ihMq1kpyPoZO7VVEhFNMs1UZl,G8EPVSXsOYB5YQWZGiz1aVq5Pgr2GrQu,62,57,1,354,2,8,20,1,443,63.285714285714285,3,0.0,21,1,294,2,36,8,60,20,1,318,125,0
1937,40073,gT1aUgmAT0anYSW9us4nwhFYETF9WL3j,bWdj2GDclj5ofokWjzoa5jAwMkxCykd6,5,3,1,0,1,0,3,0,8,1.1428571428571428,2,0.0,1,1,0,1,2,0,0,3,0,3,5,1
1938,40085,QWkN0K04zy6ocvNBygFS9V3b4yJPON6O,A3fsA9Zfv1X2fVEQhTw51lKENdNrEqT3,5,2,1,0,1,0,2,0,6,0.8571428571428571,2,0.0,0,1,0,1,2,0,0,2,0,2,4,1
1939,40097,Rf6xXor9EmVmU5Nrbaea2KpXMtqjkHJb,SpATywNh6bZuzm8s1ceuBUnMUAeoAHHw,24,32,15,22,9,4,4,0,86,12.285714285714286,2,0.0,5,15,18,9,27,4,4,4,0,47,39,0
1940,40105,D2f4XnvAFD8ZIkDvhpGbd6yCstJua9ut,G8EPVSXsOYB5YQWZGiz1aVq5Pgr2GrQu,1,0,0,0,0,0,1,0,1,0.14285714285714285,1,0.0,0,0,0,0,0,0,0,1,0,0,1,1
1941,40112,09EE7Mkw9FE0hqOEryjnyXTu6FbIkdRQ,SpATywNh6bZuzm8s1ceuBUnMUAeoAHHw,7,4,3,0,3,0,2,0,12,1.7142857142857142,2,0.0,0,3,0,3,4,0,0,2,0,6,6,1
1942,40123,KjOosnYqFuW1JYNSfMjuIU0UyjDNXuGi,SpATywNh6bZuzm8s1ceuBUnMUAeoAHHw,7,5,2,0,1,0,3,0,11,1.5714285714285714,2,0.0,1,2,0,1,4,0,0,3,0,4,7,1
1943,40125,znkDmOOvUgN8z7Q2bDidRTpqlGavufFM,SpATywNh6bZuzm8s1ceuBUnMUAeoAHHw,29,82,28,27,11,1,26,6,181,25.857142857142858,8,0.0,18,28,26,11,64,1,1,26,6,83,98,0
1944,40141,ysFko0fUHMpyKjTDsgomHFNCaIAr5cN9,A3fsA9Zfv1X2fVEQhTw51lKENdNrEqT3,1,0,0,0,0,0,1,0,1,0.14285714285714285,1,0.0,0,0,0,0,0,0,0,1,0,0,1,1
1945,40143,OZ02Yntpt8Hg8thsFgejT4NSsPYtVPPm,bWdj2GDclj5ofokWjzoa5jAwMkxCykd6,11,8,3,42,1,5,8,1,68,9.714285714285714,4,0.0,1,3,40,1,7,5,2,8,1,45,23,1
1946,40165,Vcn2Ncl6KVYaVVug7iW4LScBfpTMatic,RXDvfPUBYFlVdlueBFbLW0mhhAyGEqpt,12,25,1,0,1,4,15,1,47,6.714285714285714,3,0.0,5,1,0,1,20,4,0,15,1,7,40,1
1947,40178,JhXfd0Tlc69bJyZdJPZXaAHtjoBDG89W,A3fsA9Zfv1X2fVEQhTw51lKENdNrEqT3,33,88,6,14,4,1,32,1,146,20.857142857142858,9,0.0,5,6,10,4,83,1,4,32,1,25,121,0
1948,40185,abA1IbdNqvgGPTwvaYtddvUoLjzJEWlN,A3fsA9Zfv1X2fVEQhTw51lKENdNrEqT3,36,23,0,52,0,5,14,2,96,13.714285714285714,1,0.0,3,0,49,0,20,5,3,14,2,52,44,1
1949,40192,plUweHzNEQ6tYmm8ypkjZ9ZgEhzpu5iN,SpATywNh6bZuzm8s1ceuBUnMUAeoAHHw,14,14,7,12,3,0,4,0,40,5.714285714285714,2,0.0,2,7,9,3,12,0,3,4,0,21,19,1
1950,40195,8auKgQ1pXJtaAwUgQOq3AnlP8yJ8xKs8,SpATywNh6bZuzm8s1ceuBUnMUAeoAHHw,5,10,1,0,0,0,2,0,13,1.8571428571428572,2,0.0,0,1,0,0,10,0,0,2,0,1,12,1
1951,40206,5HnJOsNDqfUbmuHMu8iG6iEtOPev7Xxw,SpATywNh6bZuzm8s1ceuBUnMUAeoAHHw,6,3,1,0,1,0,3,0,8,1.1428571428571428,2,0.0,0,1,0,1,3,0,0,3,0,2,6,1
1952,40207,mVPS8qtXmBYw6oQCHhHlXYGOl1msXZRm,SpATywNh6bZuzm8s1ceuBUnMUAeoAHHw,27,35,15,30,6,0,9,0,95,13.571428571428571,3,0.0,7,15,27,6,28,0,3,9,0,55,40,1
1953,40208,5X4lGySxqBLFYnW7eAhu5WWLC7wvzcF3,A3fsA9Zfv1X2fVEQhTw51lKENdNrEqT3,39,33,15,72,11,0,1,0,132,18.857142857142858,1,0.0,1,15,63,11,32,0,9,1,0,90,42,1
1954,40223,cuLVLzIr2y459RDZRcVR3FYe8DHl8ZjT,SpATywNh6bZuzm8s1ceuBUnMUAeoAHHw,1,0,0,0,0,0,1,0,1,0.14285714285714285,1,0.0,0,0,0,0,0,0,0,1,0,0,1,1
1955,40224,sV3jtFrXfncSgh7Xsq4nWcxj42E0NrUb,SpATywNh6bZuzm8s1ceuBUnMUAeoAHHw,16,27,5,0,7,0,23,0,62,8.857142857142858,7,0.0,0,5,0,7,27,0,0,23,0,12,50,0
1956,40233,tBcWnrptNiGaZgy4k51BltzcKki801j1,bWdj2GDclj5ofokWjzoa5jAwMkxCykd6,1,0,0,0,0,0,1,0,1,0.14285714285714285,1,0.0,0,0,0,0,0,0,0,1,0,0,1,1
1957,40237,tBcWnrptNiGaZgy4k51BltzcKki801j1,A3fsA9Zfv1X2fVEQhTw51lKENdNrEqT3,1,0,0,0,0,0,2,0,2,0.2857142857142857,2,0.0,0,0,0,0,0,0,0,2,0,0,2,1
1958,40243,3LBUjm1FFFdQL8moOjwGZJaqcxdpVPTx,SpATywNh6bZuzm8s1ceuBUnMUAeoAHHw,12,19,2,0,2,4,10,0,37,5.285714285714286,3,0.0,6,2,0,2,13,4,0,10,0,10,27,1
1959,40258,vosTvFxoRyJk1cDtxUw2GTYeGEnrXcMJ,G8EPVSXsOYB5YQWZGiz1aVq5Pgr2GrQu,8,6,2,0,2,0,2,0,12,1.7142857142857142,1,0.0,0,2,0,2,6,0,0,2,0,4,8,0
1960,40272,FWTxDnNzcugqXGOfXWOseyRKl3gd7tL9,SpATywNh6bZuzm8s1ceuBUnMUAeoAHHw,9,12,2,0,1,0,3,0,18,2.5714285714285716,1,0.0,0,2,0,1,12,0,0,3,0,3,15,0
1961,40287,O1a4fHzT6b5r4IWUDa3zddRbshvfRlE4,A3fsA9Zfv1X2fVEQhTw51lKENdNrEqT3,35,25,18,62,2,0,6,0,113,16.142857142857142,3,0.0,2,18,53,2,23,0,9,6,0,75,38,1
1962,40310,qp5IXQZrLJFd9bS1JJL98d9ZDAq70kXN,SpATywNh6bZuzm8s1ceuBUnMUAeoAHHw,15,25,7,29,4,0,2,0,67,9.571428571428571,1,0.0,14,7,23,4,11,0,6,2,0,48,19,1
1963,40317,5FLIDnIga6PY7pJGfcQdTEADTcQg0s9O,G8EPVSXsOYB5YQWZGiz1aVq5Pgr2GrQu,4,2,1,0,0,0,3,0,6,0.8571428571428571,1,0.0,0,1,0,0,2,0,0,3,0,1,5,1
1964,40326,0JjJbtKs8dmrQQZXRwO3ezBCv1FqT0mM,SpATywNh6bZuzm8s1ceuBUnMUAeoAHHw,5,2,1,0,1,0,2,0,6,0.8571428571428571,1,0.0,0,1,0,1,2,0,0,2,0,2,4,1
1965,40330,e8tjBT4TkBUZGDf1oULgV0xlcUpSchNd,SpATywNh6bZuzm8s1ceuBUnMUAeoAHHw,27,87,43,14,21,0,24,2,191,27.285714285714285,5,0.0,23,43,13,21,64,0,1,24,2,100,91,0
1966,40335,xLE9ZE3BmJvIiYogSmZ2Qwy8Pm6jvutZ,SpATywNh6bZuzm8s1ceuBUnMUAeoAHHw,25,58,3,41,1,10,33,1,147,21.0,7,0.0,22,3,34,1,36,10,7,33,1,60,87,0
1967,40338,xoJqrbCgOTk6mALoHnYupKuyUFnXAEAL,SpATywNh6bZuzm8s1ceuBUnMUAeoAHHw,13,19,1,28,0,1,4,0,53,7.571428571428571,1,0.0,13,1,20,0,6,1,8,4,0,34,19,1
1968,40347,cC2qlM5WjvVF4gXhZ3ctfElOjyJIEAhi,SpATywNh6bZuzm8s1ceuBUnMUAeoAHHw,15,26,11,15,5,17,10,1,85,12.142857142857142,4,0.0,12,11,12,5,14,17,3,10,1,40,45,1
1969,40370,wD600Vm6nYpRlm6dPdneFPtwC1POqb2E,A3fsA9Zfv1X2fVEQhTw51lKENdNrEqT3,1,0,0,0,0,0,1,0,1,0.14285714285714285,1,0.0,0,0,0,0,0,0,0,1,0,0,1,1
1970,40385,uuGoGterx4QfmHoDE6WqQfMDG8gm4WOd,SpATywNh6bZuzm8s1ceuBUnMUAeoAHHw,6,4,3,0,2,0,2,0,11,1.5714285714285714,2,0.0,0,3,0,2,4,0,0,2,0,5,6,1
1971,40388,ZuoiR8ZSgQ4EIp0UPK1kvYAuneCl6lTF,G8EPVSXsOYB5YQWZGiz1aVq5Pgr2GrQu,18,23,4,24,4,0,1,0,56,8.0,1,0.0,18,4,13,4,5,0,11,1,0,39,17,1
1972,40392,zT5Abo7SNHsAkCFKMvhJJJDWNu2sl4mh,SpATywNh6bZuzm8s1ceuBUnMUAeoAHHw,25,50,16,26,4,3,30,1,130,18.571428571428573,7,0.0,14,16,24,4,36,3,2,30,1,58,72,0
1973,40395,55BMoXCnWKUmNoRDU7bcdmqWNuK9JpZ6,bWdj2GDclj5ofokWjzoa5jAwMkxCykd6,10,12,0,20,1,7,9,2,51,7.285714285714286,3,0.0,4,0,20,1,8,7,0,9,2,25,26,1
1974,40403,Anr82PPgHyVjFu2RaZRNpr3IKYwAUnAW,SpATywNh6bZuzm8s1ceuBUnMUAeoAHHw,8,18,10,0,4,0,5,0,37,5.285714285714286,3,0.0,0,10,0,4,18,0,0,5,0,14,23,1
1975,40410,lkFGShqBa18inWINppsv8Kl48gyf85dR,bWdj2GDclj5ofokWjzoa5jAwMkxCykd6,12,23,10,40,8,7,2,0,90,12.857142857142858,1,0.0,9,10,37,8,14,7,3,2,0,64,26,1
1976,40416,0Cx8S0i9vAPm7jZ8jXLUkrYp9xGpIHIS,bWdj2GDclj5ofokWjzoa5jAwMkxCykd6,4,6,3,0,0,3,4,0,16,2.2857142857142856,3,0.0,0,3,0,0,6,3,0,4,0,3,13,1
1977,40422,D35qeoxZpbN67fSLA7wfpVWpoAtTKXOD,SpATywNh6bZuzm8s1ceuBUnMUAeoAHHw,13,12,8,5,5,3,3,0,36,5.142857142857143,1,0.0,2,8,5,5,10,3,0,3,0,20,16,1
1978,40425,JuFQ1S3Curjho2OVO8cP3KLv8ROaeaOy,G8EPVSXsOYB5YQWZGiz1aVq5Pgr2GrQu,18,12,7,20,5,0,1,0,45,6.428571428571429,1,0.0,4,7,20,5,8,0,0,1,0,36,9,1
1979,40428,RSvPQSF8RarDsP4aI3ftScWWjvINqjc5,A3fsA9Zfv1X2fVEQhTw51lKENdNrEqT3,10,16,10,0,9,0,1,0,36,5.142857142857143,8,0.0,0,10,0,9,16,0,0,1,0,19,17,1
1980,40433,fVDgOkqeY2Y5uks1gBAvSdrqz781Wr7g,SpATywNh6bZuzm8s1ceuBUnMUAeoAHHw,7,8,4,0,3,0,4,0,19,2.7142857142857144,1,0.0,1,4,0,3,7,0,0,4,0,8,11,1
1981,40441,b11C6Y0UpRSFGpKvHTlz5TF2Rt9ScBoX,SpATywNh6bZuzm8s1ceuBUnMUAeoAHHw,12,16,6,20,1,0,14,3,60,8.571428571428571,4,0.0,8,6,16,1,8,0,4,14,3,31,29,0
1982,40462,9hqCAq1z2NOCYAE7PjnGwKxGA9KHvl0W,A3fsA9Zfv1X2fVEQhTw51lKENdNrEqT3,11,7,0,0,0,2,8,1,18,2.5714285714285716,2,0.0,0,0,0,0,7,2,0,8,1,0,18,1
1983,40502,PzBfPYmnOZYwUEXwnCaNraevSYiEicsw,G8EPVSXsOYB5YQWZGiz1aVq5Pgr2GrQu,16,25,6,18,1,5,19,4,78,11.142857142857142,2,0.0,7,6,13,1,18,5,5,19,4,27,51,1
1984,40509,Hz1gD3xapoX9NB1k77xvttI5SLCsWFqX,A3fsA9Zfv1X2fVEQhTw51lKENdNrEqT3,5,3,1,0,0,1,3,0,8,1.1428571428571428,1,0.0,0,1,0,0,3,1,0,3,0,1,7,1
1985,40537,KUjjznPFpWdBg0GS5p0fa4zyp2j0nULG,A3fsA9Zfv1X2fVEQhTw51lKENdNrEqT3,5,2,1,0,1,0,2,0,6,0.8571428571428571,1,0.0,0,1,0,1,2,0,0,2,0,2,4,1
1986,40584,mC2fzvwPaO34Kq32ibCwzrJ2EjHwbRrb,RXDvfPUBYFlVdlueBFbLW0mhhAyGEqpt,20,35,19,19,7,0,4,0,84,12.0,2,0.0,9,19,17,7,26,0,2,4,0,52,32,1
1987,40602,TxbcY6S66ftou9eniDMFpBcA0Q86cCVI,SpATywNh6bZuzm8s1ceuBUnMUAeoAHHw,1,0,0,0,0,0,1,0,1,0.14285714285714285,1,0.0,0,0,0,0,0,0,0,1,0,0,1,1
1988,40605,MiPYsLH8kYorLuTY5qJyDrWlYhyksO0w,bWdj2GDclj5ofokWjzoa5jAwMkxCykd6,1,0,0,0,0,0,1,0,1,0.14285714285714285,1,0.0,0,0,0,0,0,0,0,1,0,0,1,1
1989,40607,MiPYsLH8kYorLuTY5qJyDrWlYhyksO0w,A3fsA9Zfv1X2fVEQhTw51lKENdNrEqT3,15,21,1,2,1,0,13,0,38,5.428571428571429,2,0.0,0,1,2,1,21,0,0,13,0,4,34,1
1990,40643,4hVUUGEGYiw6Bdgp8UlEBQC8ko8eVYqV,SpATywNh6bZuzm8s1ceuBUnMUAeoAHHw,6,3,1,0,1,0,2,0,7,1.0,1,0.0,0,1,0,1,3,0,0,2,0,2,5,1
1991,40648,zUbaOnwFf34fsU2q7dIMt7fpEzRZebx6,SpATywNh6bZuzm8s1ceuBUnMUAeoAHHw,11,26,12,0,8,0,3,0,49,7.0,2,0.0,11,12,0,8,15,0,0,3,0,31,18,1
1992,40662,C1sQeK9WfNApOsknFeDtbZSozuem8vKZ,A3fsA9Zfv1X2fVEQhTw51lKENdNrEqT3,5,2,1,0,1,0,3,0,7,1.0,1,0.0,0,1,0,1,2,0,0,3,0,2,5,1
1993,40664,oGGlzK2ht4ljgfC5PRL55MAob4FKnRhp,bWdj2GDclj5ofokWjzoa5jAwMkxCykd6,2,0,0,0,0,0,2,0,2,0.2857142857142857,1,0.0,0,0,0,0,0,0,0,2,0,0,2,1
1994,40667,oGGlzK2ht4ljgfC5PRL55MAob4FKnRhp,A3fsA9Zfv1X2fVEQhTw51lKENdNrEqT3,2,0,0,0,0,0,2,0,2,0.2857142857142857,1,0.0,0,0,0,0,0,0,0,2,0,0,2,1
1995,40702,eulwUG3HQzG3rg0A6GIWynY1beyNKKbn,SpATywNh6bZuzm8s1ceuBUnMUAeoAHHw,13,23,9,13,6,0,4,0,55,7.857142857142857,3,0.0,3,9,11,6,20,0,2,4,0,29,26,1
1996,40704,qmYTrueiQKfoQnGxjqfwlMlw7HOR9CKj,bWdj2GDclj5ofokWjzoa5jAwMkxCykd6,8,10,2,0,0,13,26,2,53,7.571428571428571,7,0.0,0,2,0,0,10,13,0,26,2,2,51,0
1997,40726,Y4FZdizgCfP48VyOuflC2D2a2JpAW4dz,G8EPVSXsOYB5YQWZGiz1aVq5Pgr2GrQu,6,2,1,0,1,0,3,0,7,1.0,1,0.0,0,1,0,1,2,0,0,3,0,2,5,1
1998,40737,G9SE33A9SwXRkrAwDpEWoUsFMADETyBJ,SpATywNh6bZuzm8s1ceuBUnMUAeoAHHw,2,0,0,0,0,0,3,0,3,0.42857142857142855,1,0.0,0,0,0,0,0,0,0,3,0,0,3,1
1999,40746,l7T8dOWG1cEtOxAxVcD5zNV6vn1g4oYM,bWdj2GDclj5ofokWjzoa5jAwMkxCykd6,2,0,0,0,0,0,4,0,4,0.5714285714285714,2,0.0,0,0,0,0,0,0,0,4,0,0,4,1
2000,40749,1UUWIp3PiN0CT0O96IXxrt6TRVFJmFUz,A3fsA9Zfv1X2fVEQhTw51lKENdNrEqT3,7,1,0,0,0,2,9,2,14,2.0,1,0.0,0,0,0,0,1,2,0,9,2,0,14,1
2001,40761,1Pk7jZ6bfmKYXcNnRyEd7kPSZWAEJN0N,A3fsA9Zfv1X2fVEQhTw51lKENdNrEqT3,1,0,0,0,0,0,1,0,1,0.14285714285714285,1,0.0,0,0,0,0,0,0,0,1,0,0,1,1
2002,40768,NlHO5hXiy7TmVTHiRgExH6y7p9gJG1YF,SpATywNh6bZuzm8s1ceuBUnMUAeoAHHw,19,18,9,23,5,0,4,0,59,8.428571428571429,3,0.0,5,9,19,5,13,0,4,4,0,38,21,1
2003,40780,EO0fRulUc32LbMOOGfwwNWyNgnF8pKY9,RXDvfPUBYFlVdlueBFbLW0mhhAyGEqpt,35,41,23,51,13,3,16,5,152,21.714285714285715,4,0.0,11,23,43,13,30,3,8,16,5,90,62,1
2004,40782,eEl2lnEvtyQyZa1YqA2JcBHBfdkh8SHK,SpATywNh6bZuzm8s1ceuBUnMUAeoAHHw,9,19,2,0,1,0,7,0,29,4.142857142857143,4,0.0,1,2,0,1,18,0,0,7,0,4,25,1
2005,40802,DFKzgJXlXxnZVHESIM4fYC543XX9ZfDV,SpATywNh6bZuzm8s1ceuBUnMUAeoAHHw,10,8,5,0,3,0,5,0,21,3.0,4,0.0,0,5,0,3,8,0,0,5,0,8,13,1
2006,40823,BXn2aG9clWntQARvXpqDawWoxN1Iz4WO,A3fsA9Zfv1X2fVEQhTw51lKENdNrEqT3,20,27,13,0,8,0,7,0,55,7.857142857142857,4,0.0,0,13,0,8,27,0,0,7,0,21,34,1
2007,40824,0NGZq9HZW5KOrSfzSGGipuN20pCRDMWu,A3fsA9Zfv1X2fVEQhTw51lKENdNrEqT3,9,8,1,0,1,0,2,0,12,1.7142857142857142,1,0.0,0,1,0,1,8,0,0,2,0,2,10,1
2008,40835,pwTSmyT1ONwSAvUKrgRYh4Mr4sMKfCZD,SpATywNh6bZuzm8s1ceuBUnMUAeoAHHw,1,0,0,0,0,0,1,0,1,0.14285714285714285,1,0.0,0,0,0,0,0,0,0,1,0,0,1,1
2009,40857,9VkUnpQ2wwfpxrKU7ACzLosNtkitvYWk,bWdj2GDclj5ofokWjzoa5jAwMkxCykd6,9,14,0,62,0,3,2,0,81,11.571428571428571,3,0.0,3,0,58,0,11,3,4,2,0,61,20,1
2010,40867,rV9ZZTHmhxb84QCeG9gPkzE5xk42RTz0,SpATywNh6bZuzm8s1ceuBUnMUAeoAHHw,14,16,1,15,0,1,7,1,41,5.857142857142857,2,0.0,6,1,13,0,10,1,2,7,1,20,21,1
2011,40869,8gfCGxZ6lFjZr89RwPF8oXZs1Qn6Pq6X,A3fsA9Zfv1X2fVEQhTw51lKENdNrEqT3,27,5,4,78,0,0,10,0,97,13.857142857142858,4,0.0,1,4,69,0,4,0,9,10,0,74,23,1
2012,40896,o4j0NDzLh6XqpDKcvRg8Lx9N4HUYeTuP,RXDvfPUBYFlVdlueBFbLW0mhhAyGEqpt,1,0,0,0,0,0,1,0,1,0.14285714285714285,1,0.0,0,0,0,0,0,0,0,1,0,0,1,1
2013,40900,f6iCNPPMIJtA2FTvaT2H53upAxoDRLhb,SpATywNh6bZuzm8s1ceuBUnMUAeoAHHw,10,28,10,0,1,1,13,1,54,7.714285714285714,3,0.0,5,10,0,1,23,1,0,13,1,16,38,1
2014,40938,DJeWlgB4cP1RQ3JZLa1wZwd4zgAbYOxv,A3fsA9Zfv1X2fVEQhTw51lKENdNrEqT3,1,0,0,0,0,0,1,0,1,0.14285714285714285,1,0.0,0,0,0,0,0,0,0,1,0,0,1,1
2015,40940,qMeUlyVNhm3N1xROQ1pyK2NlohyIqF1x,G8EPVSXsOYB5YQWZGiz1aVq5Pgr2GrQu,1,0,0,0,0,0,1,0,1,0.14285714285714285,1,0.0,0,0,0,0,0,0,0,1,0,0,1,1
2016,40951,ah2KXEU3IJN3pCxNzFybzDR3Qrtpz7ty,SpATywNh6bZuzm8s1ceuBUnMUAeoAHHw,1,0,0,0,0,0,1,0,1,0.14285714285714285,1,0.0,0,0,0,0,0,0,0,1,0,0,1,1
2017,40964,gnxZfu6FrSp4wr4QPorHabuGoagxpXKv,SpATywNh6bZuzm8s1ceuBUnMUAeoAHHw,1,0,0,0,0,0,1,0,1,0.14285714285714285,1,0.0,0,0,0,0,0,0,0,1,0,0,1,1
2018,40966,xHfGdYj0sYZXXCzkQp0eF5wBXW7C2C6R,A3fsA9Zfv1X2fVEQhTw51lKENdNrEqT3,6,5,2,0,2,0,4,0,13,1.8571428571428572,2,0.0,0,2,0,2,5,0,0,4,0,4,9,1
2019,40973,BasnDhJkjNSRVUOCCIoBniAgNajwACiL,SpATywNh6bZuzm8s1ceuBUnMUAeoAHHw,20,34,2,28,0,0,11,0,75,10.714285714285714,4,0.0,14,2,28,0,20,0,0,11,0,44,31,0
2020,40979,zeUi2UnQZPPF6bRQXw2s8LZ41ZOdqRAa,G8EPVSXsOYB5YQWZGiz1aVq5Pgr2GrQu,8,9,6,0,2,1,3,0,21,3.0,2,0.0,0,6,0,2,9,1,0,3,0,8,13,1
2021,40982,4IpWwTUOGPzGOpKLy9nKXcEDTyxApVd3,G8EPVSXsOYB5YQWZGiz1aVq5Pgr2GrQu,1,0,0,0,0,0,1,0,1,0.14285714285714285,1,0.0,0,0,0,0,0,0,0,1,0,0,1,1
2022,40984,xvXNoM4EBB4fcdWfVRuECibdILksVZE5,SpATywNh6bZuzm8s1ceuBUnMUAeoAHHw,4,2,0,0,0,0,3,0,5,0.7142857142857143,1,0.0,0,0,0,0,2,0,0,3,0,0,5,1
2023,40986,ikVmCxeXCKQtR8OPUUdHoGQCjATpEVdj,SpATywNh6bZuzm8s1ceuBUnMUAeoAHHw,14,17,9,15,5,0,2,0,48,6.857142857142857,3,0.0,7,9,13,5,10,0,2,2,0,34,14,1
2024,40991,WPAkKut2lu615mRXcePqeHjf7ZV10lWd,SpATywNh6bZuzm8s1ceuBUnMUAeoAHHw,13,14,9,10,4,0,2,0,39,5.571428571428571,3,0.0,2,9,9,4,12,0,1,2,0,24,15,1
2025,41010,uOFQjpYGMV24K1kl5khOKpWKqO5hcEHE,7GRhBDsirIGkRZBtSMEzNTyDr2JQm4xx,7,8,2,0,2,0,2,0,14,2.0,1,0.0,0,2,0,2,8,0,0,2,0,4,10,1
2026,41098,luetGJM4RCCEdMBc9OfxVqFFziudg0s4,7GRhBDsirIGkRZBtSMEzNTyDr2JQm4xx,2,0,0,0,0,0,3,0,3,0.42857142857142855,1,0.0,0,0,0,0,0,0,0,3,0,0,3,1
2027,41120,XpdeGVr67ypvPB6NlvDXEjF8wDCu5FS9,7GRhBDsirIGkRZBtSMEzNTyDr2JQm4xx,1,0,0,0,0,0,2,0,2,0.2857142857142857,2,0.0,0,0,0,0,0,0,0,2,0,0,2,1
2028,41133,sIrvXnSy3oMgG36f8e8UxJCnsTfr739w,7GRhBDsirIGkRZBtSMEzNTyDr2JQm4xx,17,24,1,0,1,2,10,0,38,5.428571428571429,3,0.0,3,1,0,1,21,2,0,10,0,5,33,1
2029,41208,ttoFK5oOPrxtfVxJpGPFCiEs8J6AbuAg,7GRhBDsirIGkRZBtSMEzNTyDr2JQm4xx,2,0,0,0,0,0,3,0,3,0.42857142857142855,2,0.0,0,0,0,0,0,0,0,3,0,0,3,1
2030,41313,muzVsCrsBxqiBPr2RsB5pEdOhDGWWCl3,7GRhBDsirIGkRZBtSMEzNTyDr2JQm4xx,4,3,1,0,1,0,1,0,6,0.8571428571428571,1,0.0,1,1,0,1,2,0,0,1,0,3,3,1
2031,41408,xbPbNw5WluotpcGvfodgid2Z7Rc8OfQr,7GRhBDsirIGkRZBtSMEzNTyDr2JQm4xx,1,0,0,0,0,0,1,0,1,0.14285714285714285,1,0.0,0,0,0,0,0,0,0,1,0,0,1,1
2032,41424,Gn1QSm7WrSyhbej7tThohiyBKeBu1xtD,7GRhBDsirIGkRZBtSMEzNTyDr2JQm4xx,103,130,53,213,38,2,23,1,460,65.71428571428571,10,0.0,57,53,181,38,73,2,32,23,1,329,131,0
2033,41448,we9tWnySpl1G7k7FqyXPj8wmC2gUYK0W,7GRhBDsirIGkRZBtSMEzNTyDr2JQm4xx,1,0,0,0,0,0,1,0,1,0.14285714285714285,1,0.0,0,0,0,0,0,0,0,1,0,0,1,1
2034,41455,emCY4aIQuto3vHDbWyLccdGfPM1ClSuh,7GRhBDsirIGkRZBtSMEzNTyDr2JQm4xx,4,1,0,0,0,0,3,0,4,0.5714285714285714,1,0.0,0,0,0,0,1,0,0,3,0,0,4,1
2035,41589,JXidMLGzH1hCHEXJsiJMrwBekkp4L4vD,7GRhBDsirIGkRZBtSMEzNTyDr2JQm4xx,34,52,24,41,10,3,8,0,138,19.714285714285715,6,0.0,22,24,34,10,30,3,7,8,0,90,48,1
2036,41740,blaKT90TeOTAa2RsAkTxWQqeLxEi93Qu,7GRhBDsirIGkRZBtSMEzNTyDr2JQm4xx,1,0,0,0,0,0,2,0,2,0.2857142857142857,2,0.0,0,0,0,0,0,0,0,2,0,0,2,1
2037,41796,vpQq8XFeke8cuyYAJhpFzjSzZZBP51AP,7GRhBDsirIGkRZBtSMEzNTyDr2JQm4xx,1,0,0,0,0,0,1,0,1,0.14285714285714285,1,0.0,0,0,0,0,0,0,0,1,0,0,1,1
2038,41799,Qqy3TZdyBKfhf7zgHIRI72ZJ5QbTtpkb,7GRhBDsirIGkRZBtSMEzNTyDr2JQm4xx,11,12,4,0,3,0,3,0,22,3.142857142857143,1,0.0,0,4,0,3,12,0,0,3,0,7,15,1
2039,41805,kuZwBvEdgeUtKZ495C2FptBbxEtLtmVH,7GRhBDsirIGkRZBtSMEzNTyDr2JQm4xx,7,11,3,0,2,0,2,0,18,2.5714285714285716,2,0.0,3,3,0,2,8,0,0,2,0,8,10,1
2040,43653,79QUI05RY9ZPkyZ2QTF4ldf0I0DmjbaG,7GRhBDsirIGkRZBtSMEzNTyDr2JQm4xx,19,64,34,0,3,11,21,0,133,19.0,5,0.0,9,34,0,3,55,11,0,21,0,46,87,1
2041,43667,YwEhgJrFq2w9QJl2yCPd9xaL0Uk6VujF,7GRhBDsirIGkRZBtSMEzNTyDr2JQm4xx,26,29,7,290,2,0,9,0,337,48.142857142857146,2,0.0,17,7,270,2,12,0,20,9,0,296,41,0
2042,43672,tCqgfXrL2rXAh5RJpLuMHSLSRwrclyuQ,7GRhBDsirIGkRZBtSMEzNTyDr2JQm4xx,70,332,92,223,54,38,26,0,765,109.28571428571429,12,0.0,116,92,189,54,216,38,34,26,0,451,314,0
2043,43674,zkqKiyV6OvwyKPkyCN37KC4hTRCpZYCH,7GRhBDsirIGkRZBtSMEzNTyDr2JQm4xx,17,20,10,10,10,0,2,0,52,7.428571428571429,2,0.0,8,10,9,10,12,0,1,2,0,37,15,0
2044,43685,Up0igPeMCPcrrFPZ1HsfM8Bq5rwAfYwv,7GRhBDsirIGkRZBtSMEzNTyDr2JQm4xx,54,70,22,72,26,22,6,0,218,31.142857142857142,4,0.0,42,22,60,26,28,22,12,6,0,150,68,0
2045,43697,ta4rrlwAs90RPkpFC9k1ckRd8n8Nkgxn,7GRhBDsirIGkRZBtSMEzNTyDr2JQm4xx,4,0,0,0,0,0,4,0,4,0.5714285714285714,1,0.0,0,0,0,0,0,0,0,4,0,0,4,1
2046,43700,z4NoXHrcgkhn7BypZflRO6Tgobh52UXj,7GRhBDsirIGkRZBtSMEzNTyDr2JQm4xx,25,59,18,38,0,11,12,0,138,19.714285714285715,4,0.0,24,18,31,0,35,11,7,12,0,73,65,0
2047,43713,KjugBA6V5bkEA5fAIbJoGnSUlDhZoaIH,7GRhBDsirIGkRZBtSMEzNTyDr2JQm4xx,62,140,38,130,21,4,20,2,355,50.714285714285715,3,0.0,54,38,115,21,86,4,15,20,2,228,127,0
2048,43732,0OpVcmwG6bVPxKzOCpgJ9F6MfBtuGolr,7GRhBDsirIGkRZBtSMEzNTyDr2JQm4xx,1,0,0,0,0,0,1,0,1,0.14285714285714285,1,0.0,0,0,0,0,0,0,0,1,0,0,1,1
2049,43991,i936MfG3syIHVH4tehF88pJA63b8Vu78,fbPkOYLVPtPgIt0MxizjfFJov3JbHyAi,9,4,2,0,2,3,6,3,20,2.857142857142857,1,0.0,0,2,0,2,4,3,0,6,3,4,16,1
2050,43992,6UtqqjImjevYXkMdkukuwyWXLWcDEFFu,fbPkOYLVPtPgIt0MxizjfFJov3JbHyAi,11,29,11,6,9,5,13,2,75,10.714285714285714,2,0.0,4,11,4,9,25,5,2,13,2,28,47,1
2051,43998,e19ZEr9Yh5ILe0m8l9rWehMDuEWywMUJ,fbPkOYLVPtPgIt0MxizjfFJov3JbHyAi,1,0,0,0,0,0,1,0,1,0.14285714285714285,1,0.0,0,0,0,0,0,0,0,1,0,0,1,1
2052,44007,oPl0NnurlzpABskP5WrrITS0Jx7a7lgG,fbPkOYLVPtPgIt0MxizjfFJov3JbHyAi,9,15,8,0,7,0,6,1,37,5.285714285714286,2,0.0,4,8,0,7,11,0,0,6,1,19,18,1
2053,44008,uISGM4LqBUfXPHskRZuSs9XeQkD4VUeT,fbPkOYLVPtPgIt0MxizjfFJov3JbHyAi,27,60,31,16,15,43,18,1,184,26.285714285714285,5,0.0,18,31,14,15,42,43,2,18,1,78,106,1
2054,44009,inUZ2nCJKLY6kdHcpjk8OuyitRFog1f3,fbPkOYLVPtPgIt0MxizjfFJov3JbHyAi,3,2,0,0,0,0,2,0,4,0.5714285714285714,1,0.0,0,0,0,0,2,0,0,2,0,0,4,1
2055,44010,DQ9W5Vuawh3t7n6xTYzvjArLiUFtCoJH,fbPkOYLVPtPgIt0MxizjfFJov3JbHyAi,8,3,2,0,2,0,3,0,10,1.4285714285714286,1,0.0,0,2,0,2,3,0,0,3,0,4,6,1
2056,44012,3ovcvN6GJrfjQxnw4eUnC7Zf5NE35SVV,fbPkOYLVPtPgIt0MxizjfFJov3JbHyAi,4,2,0,0,0,2,6,0,10,1.4285714285714286,1,0.0,0,0,0,0,2,2,0,6,0,0,10,1
2057,44015,NHPpKvbnrSpxM8e1DORBWJbRCpmrxZw8,fbPkOYLVPtPgIt0MxizjfFJov3JbHyAi,13,18,10,0,7,42,9,0,86,12.285714285714286,4,0.0,4,10,0,7,14,42,0,9,0,21,65,1
2058,44017,axLHybd4Fc2iEZmnM9YqehKaeSBFTLUD,fbPkOYLVPtPgIt0MxizjfFJov3JbHyAi,2,0,0,0,0,0,2,0,2,0.2857142857142857,1,0.0,0,0,0,0,0,0,0,2,0,0,2,1
2059,44019,Oqf2KMc671oV8Cn8nfq2WN2xhEjMkCKi,fbPkOYLVPtPgIt0MxizjfFJov3JbHyAi,4,2,1,0,0,5,2,0,10,1.4285714285714286,1,0.0,0,1,0,0,2,5,0,2,0,1,9,1
2060,44021,9XnnqdyPvtBGS8L2kTzLO0S9Zq2a4kse,fbPkOYLVPtPgIt0MxizjfFJov3JbHyAi,4,5,0,0,0,0,1,0,6,0.8571428571428571,1,0.0,0,0,0,0,5,0,0,1,0,0,6,1
2061,44024,LeyaS1WvDVnHnV6ZSeQmCJao8bkVjN1j,fbPkOYLVPtPgIt0MxizjfFJov3JbHyAi,9,5,4,0,3,0,8,0,20,2.857142857142857,1,0.0,0,4,0,3,5,0,0,8,0,7,13,1
2062,44027,yfYI5syGDPun1q5rrD5IBdKLVoUhhItT,fbPkOYLVPtPgIt0MxizjfFJov3JbHyAi,11,5,4,0,4,0,4,0,17,2.4285714285714284,1,0.0,0,4,0,4,5,0,0,4,0,8,9,1
2063,44028,1brUgjk7oe1eohq9hpdKTnGa8wSkRKBL,fbPkOYLVPtPgIt0MxizjfFJov3JbHyAi,7,2,1,0,1,1,4,1,10,1.4285714285714286,1,0.0,0,1,0,1,2,1,0,4,1,2,8,1
2064,44032,g4BqtfArPu1P6dUgMW0j2r9GyrSqWjFl,fbPkOYLVPtPgIt0MxizjfFJov3JbHyAi,5,0,0,0,0,1,8,1,10,1.4285714285714286,1,0.0,0,0,0,0,0,1,0,8,1,0,10,1
2065,44034,qWEVgbmp31Yz7gV3k18he9mUiT0ZSaYx,fbPkOYLVPtPgIt0MxizjfFJov3JbHyAi,7,9,3,0,5,4,4,0,25,3.5714285714285716,1,0.0,4,3,0,5,5,4,0,4,0,12,13,1
2066,44036,jdE4Va4LkoFtXkdUlWOZzY1NPPK6qDDa,fbPkOYLVPtPgIt0MxizjfFJov3JbHyAi,9,3,2,0,2,1,8,1,17,2.4285714285714284,1,0.0,0,2,0,2,3,1,0,8,1,4,13,1
2067,44040,Rbjg9UrMjdBRLHwge6hMq2hF3DaLKFjG,fbPkOYLVPtPgIt0MxizjfFJov3JbHyAi,11,14,3,4,7,15,22,2,67,9.571428571428571,1,0.0,10,3,3,7,4,15,1,22,2,23,44,1
2068,44041,sg4VVv9cgk6nt80dZvUKhL5H7RMgLm0l,fbPkOYLVPtPgIt0MxizjfFJov3JbHyAi,9,9,6,0,3,8,3,0,29,4.142857142857143,2,0.0,1,6,0,3,8,8,0,3,0,10,19,1
2069,44044,h6WpsYrDbnnoeExgTZXkYo7GgIA3j8KF,fbPkOYLVPtPgIt0MxizjfFJov3JbHyAi,10,10,5,0,4,0,6,0,25,3.5714285714285716,1,0.0,3,5,0,4,7,0,0,6,0,12,13,1
2070,44046,76y1AbpXIG79W81ou4lYi6BwTmlPjyTW,fbPkOYLVPtPgIt0MxizjfFJov3JbHyAi,5,2,1,0,1,1,2,0,7,1.0,1,0.0,0,1,0,1,2,1,0,2,0,2,5,1
2071,44049,SnBsSMsyPBAPsHuU9YoDtuue1sZbKZBQ,fbPkOYLVPtPgIt0MxizjfFJov3JbHyAi,5,0,0,0,0,0,8,1,9,1.2857142857142858,2,0.0,0,0,0,0,0,0,0,8,1,0,9,1
2072,44052,BIBVHKjUSrjc5BHdvfhhLGTavi1WeSbD,fbPkOYLVPtPgIt0MxizjfFJov3JbHyAi,12,6,3,0,3,1,5,1,19,2.7142857142857144,1,0.0,1,3,0,3,5,1,0,5,1,7,12,1
2073,44054,nkBKSO0ZKz2Wst869GlQp6mO590hIJEZ,fbPkOYLVPtPgIt0MxizjfFJov3JbHyAi,1,0,0,0,0,0,1,0,1,0.14285714285714285,1,0.0,0,0,0,0,0,0,0,1,0,0,1,1
2074,44057,ZEbYOmWwQ4Xr4MxJtDQOJ8jnLIcd8Z5c,fbPkOYLVPtPgIt0MxizjfFJov3JbHyAi,8,9,6,0,4,0,4,0,23,3.2857142857142856,2,0.0,0,6,0,4,9,0,0,4,0,10,13,1
2075,44058,4ZVrwOJI0OZGv0iKNXpa2OrPWHTNPSKw,fbPkOYLVPtPgIt0MxizjfFJov3JbHyAi,7,5,3,0,2,3,2,0,15,2.142857142857143,1,0.0,0,3,0,2,5,3,0,2,0,5,10,1
2076,44060,HCuNeFLBULV55TbURLgBOnM01N7eaTIk,fbPkOYLVPtPgIt0MxizjfFJov3JbHyAi,8,19,10,0,8,5,24,0,66,9.428571428571429,2,0.0,0,10,0,8,19,5,0,24,0,18,48,1
2077,44062,eFC0KaZbDiJdIgbG1CR6r5jTa1z0727j,fbPkOYLVPtPgIt0MxizjfFJov3JbHyAi,11,18,11,10,9,0,5,0,53,7.571428571428571,2,0.0,3,11,7,9,15,0,3,5,0,30,23,0
2078,44063,l8chSgqUsX2ezoBZ8RO3OXA3HMPgq6Xo,fbPkOYLVPtPgIt0MxizjfFJov3JbHyAi,5,3,1,0,1,0,1,0,6,0.8571428571428571,1,0.0,0,1,0,1,3,0,0,1,0,2,4,1
2079,44069,sZ59BwHHS40O9b1LKGG4hE0LdlqpaIwv,fbPkOYLVPtPgIt0MxizjfFJov3JbHyAi,17,8,7,0,7,0,3,0,25,3.5714285714285716,1,0.0,0,7,0,7,8,0,0,3,0,14,11,1
2080,44070,eQaWyowDKjzkRJdrveWWiGAaGDkIAln1,fbPkOYLVPtPgIt0MxizjfFJov3JbHyAi,7,6,3,0,4,0,2,0,15,2.142857142857143,1,0.0,2,3,0,4,4,0,0,2,0,9,6,1
2081,44071,ZAJHLqPx7azIGtI8JwkpIz4DspMCXCFT,fbPkOYLVPtPgIt0MxizjfFJov3JbHyAi,1,0,0,0,0,0,1,0,1,0.14285714285714285,1,0.0,0,0,0,0,0,0,0,1,0,0,1,1
2082,44072,xCjpMcUUR38rFwI6LVi9moe3PuSjGvgc,fbPkOYLVPtPgIt0MxizjfFJov3JbHyAi,4,2,1,0,1,0,1,0,5,0.7142857142857143,1,0.0,0,1,0,1,2,0,0,1,0,2,3,1
2083,44076,R134yB2E94tOXCDag3zVHNWrBuFFRNfi,fbPkOYLVPtPgIt0MxizjfFJov3JbHyAi,6,3,2,0,2,0,1,0,8,1.1428571428571428,1,0.0,0,2,0,2,3,0,0,1,0,4,4,1
2084,44079,L5pA3H7m2qYFia4DHW15gmoKoflabQUC,fbPkOYLVPtPgIt0MxizjfFJov3JbHyAi,11,13,8,0,5,10,9,1,46,6.571428571428571,2,0.0,1,8,0,5,12,10,0,9,1,14,32,1
2085,44081,yRofSAhoibifpAqTO7qW5tQEYNWfWlsG,fbPkOYLVPtPgIt0MxizjfFJov3JbHyAi,10,19,4,0,3,0,10,1,37,5.285714285714286,2,0.0,13,4,0,3,6,0,0,10,1,20,17,1
2086,44083,KSfQPUyfWWfWDmmi6m3KXcKzxz89wkwt,fbPkOYLVPtPgIt0MxizjfFJov3JbHyAi,1,0,0,0,0,0,1,0,1,0.14285714285714285,1,0.0,0,0,0,0,0,0,0,1,0,0,1,1
2087,44084,kk72YEo7gxDpJjFfV60A1en59PCJ8Z09,fbPkOYLVPtPgIt0MxizjfFJov3JbHyAi,7,6,3,0,1,7,6,1,24,3.4285714285714284,1,0.0,0,3,0,1,6,7,0,6,1,4,20,1
2088,44093,9lvfANZJ7eXEtCdLExkxtGg3Vbd7Wyxt,fbPkOYLVPtPgIt0MxizjfFJov3JbHyAi,6,2,1,0,0,11,5,1,20,2.857142857142857,1,0.0,0,1,0,0,2,11,0,5,1,1,19,1
2089,44095,o61d02uP0OX8m0Pmj3Zu4on4UaOcYPIz,fbPkOYLVPtPgIt0MxizjfFJov3JbHyAi,13,8,5,3,3,3,5,2,29,4.142857142857143,2,0.0,1,5,2,3,7,3,1,5,2,11,18,0
2090,44097,2OnGZLO6PGk0y08tYvyYb6lXWyUABkGv,fbPkOYLVPtPgIt0MxizjfFJov3JbHyAi,9,8,4,0,3,0,6,2,23,3.2857142857142856,1,0.0,0,4,0,3,8,0,0,6,2,7,16,1
2091,44102,WpYtemwKZQxcuLGpndx0lQojfh6o5GOv,fbPkOYLVPtPgIt0MxizjfFJov3JbHyAi,4,4,0,0,0,0,1,0,5,0.7142857142857143,1,0.0,0,0,0,0,4,0,0,1,0,0,5,1
2092,44111,nWTDOg4ZYpkavWBGTPbOIHQSMseHgPvt,fbPkOYLVPtPgIt0MxizjfFJov3JbHyAi,8,4,2,0,2,0,3,0,11,1.5714285714285714,1,0.0,0,2,0,2,4,0,0,3,0,4,7,1
2093,44112,CKlck1NtRiTrxKTlx9u8mNsXnR4Cg2LR,fbPkOYLVPtPgIt0MxizjfFJov3JbHyAi,9,10,5,0,2,4,8,1,30,4.285714285714286,1,0.0,2,5,0,2,8,4,0,8,1,9,21,1
2094,44115,rQagJMIJxMWHybJu2qCbngkHoaC1bCF5,fbPkOYLVPtPgIt0MxizjfFJov3JbHyAi,2,0,0,0,0,0,2,0,2,0.2857142857142857,1,0.0,0,0,0,0,0,0,0,2,0,0,2,1
2095,44118,GmEmBf7c8vVD8NQKlYsc3CbTgcWxYLfx,fbPkOYLVPtPgIt0MxizjfFJov3JbHyAi,4,4,2,0,2,0,1,0,9,1.2857142857142858,1,0.0,0,2,0,2,4,0,0,1,0,4,5,1
2096,44119,hp1PeKFcESsUtrkTKF98ATmX1KKCPvia,fbPkOYLVPtPgIt0MxizjfFJov3JbHyAi,4,6,0,0,0,1,1,0,8,1.1428571428571428,1,0.0,0,0,0,0,6,1,0,1,0,0,8,0
2097,44122,bYjPoNbc5ILh7K7s9YR8HLOMNJGN6Ums,fbPkOYLVPtPgIt0MxizjfFJov3JbHyAi,9,5,4,0,4,1,2,0,16,2.2857142857142856,1,0.0,0,4,0,4,5,1,0,2,0,8,8,1
2098,44123,xl4s40OnU4HrS2dTDEZu2keSj0YY1fmn,fbPkOYLVPtPgIt0MxizjfFJov3JbHyAi,11,25,16,0,8,17,7,1,74,10.571428571428571,3,0.0,0,16,0,8,25,17,0,7,1,24,50,1
2099,44131,dzaUNwKZy91BtYj96fOhuSgIlp9lXQDU,fbPkOYLVPtPgIt0MxizjfFJov3JbHyAi,61,85,42,27,28,52,25,0,259,37.0,8,0.0,24,42,25,28,61,52,2,25,0,119,140,0
2100,44133,0bPKxjIIw0GaiIYeAS2yIr8ZqMELBNL4,fbPkOYLVPtPgIt0MxizjfFJov3JbHyAi,6,11,4,0,0,0,1,0,16,2.2857142857142856,1,0.0,3,4,0,0,8,0,0,1,0,7,9,1
2101,44134,aTtRtpFY1HDjnosUur6O1bYAGBELKNkH,fbPkOYLVPtPgIt0MxizjfFJov3JbHyAi,1,0,0,0,0,0,1,0,1,0.14285714285714285,1,0.0,0,0,0,0,0,0,0,1,0,0,1,1
2102,44135,ZD66lyh6v0XhCV6q1X0pQAccOqFGi52W,fbPkOYLVPtPgIt0MxizjfFJov3JbHyAi,3,2,0,0,0,0,1,0,3,0.42857142857142855,1,0.0,0,0,0,0,2,0,0,1,0,0,3,1
2103,44139,9CGgLBDhAl2a4vPzbTBoeDjYbqCZREDz,fbPkOYLVPtPgIt0MxizjfFJov3JbHyAi,6,5,3,0,3,0,1,0,12,1.7142857142857142,1,0.0,0,3,0,3,5,0,0,1,0,6,6,1
2104,44141,MykUjAz2RHfOismfBj3t8dCwbOEsrgDq,fbPkOYLVPtPgIt0MxizjfFJov3JbHyAi,5,4,2,0,1,0,3,0,10,1.4285714285714286,1,0.0,0,2,0,1,4,0,0,3,0,3,7,1
2105,44144,8ZsouqUolTSghSnsdTjJFuPUeDFeagv6,fbPkOYLVPtPgIt0MxizjfFJov3JbHyAi,1,0,0,0,0,0,1,0,1,0.14285714285714285,1,0.0,0,0,0,0,0,0,0,1,0,0,1,1
2106,44148,hd8cWgeUYWb4NyjYBEC7ZVh5Gsq9Y3Ff,fbPkOYLVPtPgIt0MxizjfFJov3JbHyAi,18,13,11,0,9,0,10,0,43,6.142857142857143,1,0.0,0,11,0,9,13,0,0,10,0,20,23,1
2107,44151,WRW8ZNpfTVG6ItpEWtCFOCrLdAppQEhA,fbPkOYLVPtPgIt0MxizjfFJov3JbHyAi,11,11,4,0,5,0,5,0,25,3.5714285714285716,1,0.0,6,4,0,5,5,0,0,5,0,15,10,1
2108,44152,ckUgzG88eR58uy370LgSc7zPpsWm2L4O,fbPkOYLVPtPgIt0MxizjfFJov3JbHyAi,11,12,7,0,5,7,6,0,37,5.285714285714286,2,0.0,0,7,0,5,12,7,0,6,0,12,25,1
2109,44155,ufy4LHvMWo0whrRq15door8x99FGdY4J,fbPkOYLVPtPgIt0MxizjfFJov3JbHyAi,26,84,42,24,10,21,5,0,186,26.571428571428573,7,0.0,33,42,20,10,51,21,4,5,0,105,81,1
2110,44159,tfcOvcMIVTpughZ66Us0P1WhX9cxijTo,fbPkOYLVPtPgIt0MxizjfFJov3JbHyAi,7,5,3,0,2,3,3,0,16,2.2857142857142856,2,0.0,0,3,0,2,5,3,0,3,0,5,11,1
2111,44161,VmHFwT6SFcmG2hmz0LuDgYb6XJYcUUSp,fbPkOYLVPtPgIt0MxizjfFJov3JbHyAi,5,2,1,0,1,3,2,0,9,1.2857142857142858,1,0.0,0,1,0,1,2,3,0,2,0,2,7,1
2112,44163,QHPITLtk56ZUotelsryOYmh753HhRll9,fbPkOYLVPtPgIt0MxizjfFJov3JbHyAi,6,3,2,0,2,0,1,0,8,1.1428571428571428,1,0.0,0,2,0,2,3,0,0,1,0,4,4,1
2113,44165,VBgEdkbZzukrjHaMBzmoJMWNefIhR359,fbPkOYLVPtPgIt0MxizjfFJov3JbHyAi,6,4,2,0,1,0,2,0,9,1.2857142857142858,1,0.0,0,2,0,1,4,0,0,2,0,3,6,1
2114,44168,b6tYxnTOArtoyrdJ0MLgwMZ9LCbErJm6,fbPkOYLVPtPgIt0MxizjfFJov3JbHyAi,8,5,3,0,2,1,5,1,17,2.4285714285714284,1,0.0,0,3,0,2,5,1,0,5,1,5,12,1
2115,44169,gMeKwVdV7xHR9zrsQTTuP5xOz4aKMsCh,fbPkOYLVPtPgIt0MxizjfFJov3JbHyAi,9,6,5,0,4,4,6,0,25,3.5714285714285716,1,0.0,0,5,0,4,6,4,0,6,0,9,16,1
2116,44170,wfBPTMOVZ2z78mcsSkE5pUWw8ps1YZeD,fbPkOYLVPtPgIt0MxizjfFJov3JbHyAi,7,7,2,0,3,0,3,0,15,2.142857142857143,1,0.0,2,2,0,3,5,0,0,3,0,7,8,1
2117,44173,kNdT4Mob6J1VkdvqbhmS4aPzbDLqNeYP,fbPkOYLVPtPgIt0MxizjfFJov3JbHyAi,11,14,6,0,4,3,8,1,36,5.142857142857143,1,0.0,3,6,0,4,11,3,0,8,1,13,23,1
2118,44176,8TCCmIoVZzZAPAuNITv5aLi5oDEbcxb0,fbPkOYLVPtPgIt0MxizjfFJov3JbHyAi,7,5,3,0,2,0,8,1,19,2.7142857142857144,1,0.0,0,3,0,2,5,0,0,8,1,5,14,1
2119,44177,MikH0dwnUPgwm1pOxLfLikTx2rTYR4VE,fbPkOYLVPtPgIt0MxizjfFJov3JbHyAi,6,2,1,0,1,0,5,1,10,1.4285714285714286,1,0.0,0,1,0,1,2,0,0,5,1,2,8,1
2120,44180,1MF1O9UiGEPKiN9XxCO7tMvYDB1feEh9,fbPkOYLVPtPgIt0MxizjfFJov3JbHyAi,7,2,1,0,1,0,7,1,12,1.7142857142857142,1,0.0,0,1,0,1,2,0,0,7,1,2,10,1
2121,44183,xdClWt95AonMUbXmVncDz7pyQAF4u9BG,fbPkOYLVPtPgIt0MxizjfFJov3JbHyAi,5,2,1,0,1,0,3,0,7,1.0,1,0.0,0,1,0,1,2,0,0,3,0,2,5,1
2122,44189,1eQmYbeMjDeGW0fORE6JAUI81WibJPEv,fbPkOYLVPtPgIt0MxizjfFJov3JbHyAi,1,0,0,0,0,0,1,0,1,0.14285714285714285,1,0.0,0,0,0,0,0,0,0,1,0,0,1,1
2123,44190,RJAPKuvNhyLyzVhUoacg3kyQMrusLDCW,fbPkOYLVPtPgIt0MxizjfFJov3JbHyAi,20,41,23,0,9,0,10,2,85,12.142857142857142,2,0.0,13,23,0,9,28,0,0,10,2,45,40,1
2124,44191,MkhWkWrDBg7jFp3XklVC8uZQ46nAon3u,fbPkOYLVPtPgIt0MxizjfFJov3JbHyAi,17,36,14,0,6,3,6,2,67,9.571428571428571,1,0.0,6,14,0,6,30,3,0,6,2,26,41,1
2125,44192,c1zULVJb8UrzwaeCwQXbXVIx3xb2chrp,fbPkOYLVPtPgIt0MxizjfFJov3JbHyAi,6,4,3,0,1,0,11,0,19,2.7142857142857144,5,0.0,1,3,0,1,3,0,0,11,0,5,14,0
2126,44197,ZqSAxgvVLUFu6IOm5zNZalNXouYaP76y,fbPkOYLVPtPgIt0MxizjfFJov3JbHyAi,18,23,12,9,9,6,5,1,65,9.285714285714286,2,0.0,9,12,7,9,14,6,2,5,1,37,28,1
2127,44198,H1kvrsGGsPor5huYrdsnL3Isag4wSKlt,fbPkOYLVPtPgIt0MxizjfFJov3JbHyAi,22,16,7,11,8,0,1,0,43,6.142857142857143,1,0.0,8,7,11,8,8,0,0,1,0,34,9,1
2128,44199,K28hkwMS8Ua9nbLnLUJX6puRWq44TrF0,fbPkOYLVPtPgIt0MxizjfFJov3JbHyAi,4,2,1,0,1,0,1,0,5,0.7142857142857143,1,0.0,0,1,0,1,2,0,0,1,0,2,3,1
2129,44200,UeDs0IsM5JGu9WKbkZDo576REb7pnQUn,fbPkOYLVPtPgIt0MxizjfFJov3JbHyAi,1,0,0,0,0,0,1,0,1,0.14285714285714285,1,0.0,0,0,0,0,0,0,0,1,0,0,1,1
2130,44204,VndQ6jKo03PwXryVilJVgpCAmWUkBbqD,fbPkOYLVPtPgIt0MxizjfFJov3JbHyAi,8,3,2,0,2,0,5,0,12,1.7142857142857142,1,0.0,0,2,0,2,3,0,0,5,0,4,8,1
2131,44205,xeper6lTTTduQkRnWSDeRoAUobRsjfTO,fbPkOYLVPtPgIt0MxizjfFJov3JbHyAi,12,10,5,2,4,15,4,1,41,5.857142857142857,1,0.0,3,5,2,4,7,15,0,4,1,14,27,1
2132,44206,pmP1vo676Ls6u06kxeOxjGCjZN5T0bfn,fbPkOYLVPtPgIt0MxizjfFJov3JbHyAi,7,5,2,0,2,0,2,0,11,1.5714285714285714,1,0.0,0,2,0,2,5,0,0,2,0,4,7,1
2133,44207,jWewOVeTfMYYPxwOYqT1SGXzvovpIvz3,fbPkOYLVPtPgIt0MxizjfFJov3JbHyAi,5,2,1,0,1,0,5,0,9,1.2857142857142858,1,0.0,0,1,0,1,2,0,0,5,0,2,7,1
2134,44210,3tTsLPRBksgsW30Yifh6MWgLDquCQM2g,fbPkOYLVPtPgIt0MxizjfFJov3JbHyAi,8,3,2,0,2,0,3,2,12,1.7142857142857142,1,0.0,0,2,0,2,3,0,0,3,2,4,8,1
2135,44211,u1AyJHfZVkCbqmaTVxNT62X9SEOZHm4M,fbPkOYLVPtPgIt0MxizjfFJov3JbHyAi,7,4,2,0,1,0,4,0,11,1.5714285714285714,1,0.0,0,2,0,1,4,0,0,4,0,3,8,1
2136,44214,90af6u7O75fWjzbthnMq7awDtdd9TeI9,fbPkOYLVPtPgIt0MxizjfFJov3JbHyAi,7,6,3,0,2,3,1,0,15,2.142857142857143,1,0.0,0,3,0,2,6,3,0,1,0,5,10,1
2137,44218,hJGj3kQ93iSqrSQuFovt8Qk2BphLpPcg,fbPkOYLVPtPgIt0MxizjfFJov3JbHyAi,2,0,0,0,0,0,6,0,6,0.8571428571428571,1,0.0,0,0,0,0,0,0,0,6,0,0,6,1
2138,44220,hy5uxKEcxvtHS3tlaeM1vWwbo38Hj0n0,fbPkOYLVPtPgIt0MxizjfFJov3JbHyAi,11,19,9,0,6,18,7,0,59,8.428571428571429,2,0.0,3,9,0,6,16,18,0,7,0,18,41,0
2139,44221,JBImmJkUH6RU5EuKvs04Gb9Ih8CxmZjg,fbPkOYLVPtPgIt0MxizjfFJov3JbHyAi,2,0,0,0,0,0,10,0,10,1.4285714285714286,2,0.0,0,0,0,0,0,0,0,10,0,0,10,1
2140,44222,cztDDQRMLEL2fROQpw4ZlOpH3qNEy4bb,fbPkOYLVPtPgIt0MxizjfFJov3JbHyAi,1,0,0,0,0,0,1,0,1,0.14285714285714285,1,0.0,0,0,0,0,0,0,0,1,0,0,1,1
2141,44223,1RzKq1UsN4x78Mgw0Ly9Is8DkKOORlnQ,fbPkOYLVPtPgIt0MxizjfFJov3JbHyAi,2,0,0,0,0,0,7,0,7,1.0,1,0.0,0,0,0,0,0,0,0,7,0,0,7,1
2142,44224,zpieVPimuNuvyfb8XZsK7ZjTM6u74cRF,fbPkOYLVPtPgIt0MxizjfFJov3JbHyAi,6,2,1,0,1,0,2,0,6,0.8571428571428571,1,0.0,0,1,0,1,2,0,0,2,0,2,4,1
2143,44226,VYNucadxJwAl4oUfBMF6a5hY4ZvYaLjQ,fbPkOYLVPtPgIt0MxizjfFJov3JbHyAi,26,55,18,30,16,4,14,1,138,19.714285714285715,3,0.0,30,18,28,16,25,4,2,14,1,92,46,1
2144,44231,AQMZ0ecVv6yIj8PNV5GC8bjPJquyjuSz,fbPkOYLVPtPgIt0MxizjfFJov3JbHyAi,18,52,21,14,14,23,15,2,141,20.142857142857142,5,0.0,19,21,12,14,33,23,2,15,2,66,75,1
2145,44234,UDo4onvYbb2pCnzrdvVIV4SfsdccpEQm,fbPkOYLVPtPgIt0MxizjfFJov3JbHyAi,4,3,1,0,1,2,1,0,8,1.1428571428571428,1,0.0,0,1,0,1,3,2,0,1,0,2,6,1
2146,44235,NotCBcEqqDsUQXSDLm2TrhVN2AkQ1PWh,fbPkOYLVPtPgIt0MxizjfFJov3JbHyAi,2,0,0,0,0,0,5,0,5,0.7142857142857143,1,0.0,0,0,0,0,0,0,0,5,0,0,5,1
2147,44238,9qv2s3k2hG6Dn32V5Dxzc9l86R5tLy2Y,fbPkOYLVPtPgIt0MxizjfFJov3JbHyAi,8,12,6,0,4,0,3,0,25,3.5714285714285716,2,0.0,1,6,0,4,11,0,0,3,0,11,14,1
2148,44241,RlfgxVU45fTUQ2rrZmOGyzpDUuAkm82S,fbPkOYLVPtPgIt0MxizjfFJov3JbHyAi,8,8,0,0,1,2,11,1,23,3.2857142857142856,1,0.0,2,0,0,1,6,2,0,11,1,3,20,1
2149,44245,Qs9VQJkriDZBH3FlG0bgTumvMa49MEaO,fbPkOYLVPtPgIt0MxizjfFJov3JbHyAi,20,88,33,10,32,12,16,1,192,27.428571428571427,9,0.0,23,33,9,32,65,12,1,16,1,97,95,0
2150,44246,kf48MnOeHkW7v0hNxfQUaCVe32or0xVe,fbPkOYLVPtPgIt0MxizjfFJov3JbHyAi,8,4,3,0,2,0,3,0,12,1.7142857142857142,1,0.0,0,3,0,2,4,0,0,3,0,5,7,1
2151,44247,0zumY6pgP7xEn5eA1MMsT2riPT41hmwE,fbPkOYLVPtPgIt0MxizjfFJov3JbHyAi,11,9,5,0,4,0,2,0,20,2.857142857142857,2,0.0,1,5,0,4,8,0,0,2,0,10,10,1
2152,44249,d6iEuc9ggOjxGIdMWyLvfDI4lEqo5BAX,fbPkOYLVPtPgIt0MxizjfFJov3JbHyAi,8,10,6,0,4,1,3,0,24,3.4285714285714284,2,0.0,1,6,0,4,9,1,0,3,0,11,13,1
2153,44250,g1tIXPWfZhmnEZEG9z52U31YrMwRUSiT,fbPkOYLVPtPgIt0MxizjfFJov3JbHyAi,15,30,15,12,12,15,15,1,100,14.285714285714286,2,0.0,8,15,8,12,22,15,4,15,1,43,57,1
2154,44254,DxX4QPcfDwxjWtFJm5EFgLobXDWqAEqS,fbPkOYLVPtPgIt0MxizjfFJov3JbHyAi,7,7,5,0,4,6,3,0,25,3.5714285714285716,2,0.0,0,5,0,4,7,6,0,3,0,9,16,1
2155,44255,zVdtg8NVS1UKsR7hBTuXsHvQ0Y2M8ZjR,fbPkOYLVPtPgIt0MxizjfFJov3JbHyAi,6,3,2,0,2,0,2,0,9,1.2857142857142858,1,0.0,0,2,0,2,3,0,0,2,0,4,5,1
2156,44259,v5DL1tRN6AvAeQThFmEHNCo6sn5M6uIG,fbPkOYLVPtPgIt0MxizjfFJov3JbHyAi,7,11,7,0,2,6,11,0,37,5.285714285714286,3,0.0,0,7,0,2,11,6,0,11,0,9,28,1
2157,44261,JaD7mqaE0bkEF64A4nrAbGGFeYQR80Ys,fbPkOYLVPtPgIt0MxizjfFJov3JbHyAi,21,37,3,17,8,0,9,0,74,10.571428571428571,5,0.0,22,3,14,8,15,0,3,9,0,47,27,1
2158,44262,EWKyvUI6fjHJ7AQcKlSBWUO2bca5ubo6,fbPkOYLVPtPgIt0MxizjfFJov3JbHyAi,19,31,11,11,12,6,30,1,102,14.571428571428571,1,0.0,13,11,9,12,18,6,2,30,1,45,57,1
2159,44266,8LoJ3UkmcZEmQsx5Wwgf18vm50gv36wN,fbPkOYLVPtPgIt0MxizjfFJov3JbHyAi,37,47,24,19,15,52,17,1,175,25.0,4,0.0,16,24,18,15,31,52,1,17,1,73,102,1
2160,44268,Fm9D7fGEScpbD1TbGjzCqweaOK1CX2Mr,fbPkOYLVPtPgIt0MxizjfFJov3JbHyAi,5,3,1,0,1,0,9,0,14,2.0,1,0.0,0,1,0,1,3,0,0,9,0,2,12,1
2161,44269,uDkm2sS75pRjgqry4uezxxAPyhgOOrpN,fbPkOYLVPtPgIt0MxizjfFJov3JbHyAi,6,16,1,0,1,4,2,0,24,3.4285714285714284,1,0.0,2,1,0,1,14,4,0,2,0,4,20,1
2162,44271,1V3TxSEX8RFiuvxHNXCh1zQbhpFBX9Tf,fbPkOYLVPtPgIt0MxizjfFJov3JbHyAi,2,0,0,0,0,0,3,0,3,0.42857142857142855,1,0.0,0,0,0,0,0,0,0,3,0,0,3,1
2163,44273,v4VtiypZ3gKvKYOCZEjKIfSgOk6hH0T6,fbPkOYLVPtPgIt0MxizjfFJov3JbHyAi,18,18,9,16,8,0,6,0,57,8.142857142857142,2,0.0,5,9,12,8,13,0,4,6,0,34,23,1
2164,44276,oVGH1nEV79R6JEth0UtmMIUIu6BZjaDG,fbPkOYLVPtPgIt0MxizjfFJov3JbHyAi,7,11,3,0,2,9,7,0,32,4.571428571428571,1,0.0,0,3,0,2,11,9,0,7,0,5,27,1
2165,44278,0vLnRe5y9b9pBloxjGZQUFmqmEJONAkl,fbPkOYLVPtPgIt0MxizjfFJov3JbHyAi,6,4,2,0,2,0,1,0,9,1.2857142857142858,1,0.0,0,2,0,2,4,0,0,1,0,4,5,1
2166,44281,ocGAaC1x5z02wnoRsT01upUCTbjuENeN,fbPkOYLVPtPgIt0MxizjfFJov3JbHyAi,12,12,6,0,5,9,8,3,43,6.142857142857143,1,0.0,0,6,0,5,12,9,0,8,3,11,32,1
2167,44292,3ny9mc45r6qJQOOxmh4xg5QHGygeiHbu,fbPkOYLVPtPgIt0MxizjfFJov3JbHyAi,9,6,2,1,2,0,2,0,13,1.8571428571428572,1,0.0,1,2,1,2,5,0,0,2,0,6,7,1
2168,44293,XpTBA5oDkoJbl0jjlH57SraU2q4zBLWW,fbPkOYLVPtPgIt0MxizjfFJov3JbHyAi,5,0,0,0,0,3,4,1,8,1.1428571428571428,1,0.0,0,0,0,0,0,3,0,4,1,0,8,1
2169,44294,RTkGQ4UmTL2ed98p2vxbPQoTurdG2SAC,fbPkOYLVPtPgIt0MxizjfFJov3JbHyAi,13,11,7,0,5,2,2,0,27,3.857142857142857,2,0.0,0,7,0,5,11,2,0,2,0,12,15,1
2170,44298,ABJgMBFFKl294n68xTf25Os1AW439ijN,fbPkOYLVPtPgIt0MxizjfFJov3JbHyAi,1,0,0,0,0,0,1,0,1,0.14285714285714285,1,0.0,0,0,0,0,0,0,0,1,0,0,1,1
2171,44300,oO4ZerJgmfSMeyHkgVIxV4spEvg9yQJk,fbPkOYLVPtPgIt0MxizjfFJov3JbHyAi,6,3,2,0,2,0,1,0,8,1.1428571428571428,1,0.0,0,2,0,2,3,0,0,1,0,4,4,1
2172,44301,3zvHKS6M4U1m424fRhI52J9JeELqakS5,fbPkOYLVPtPgIt0MxizjfFJov3JbHyAi,4,5,1,0,0,0,3,0,9,1.2857142857142858,2,0.0,0,1,0,0,5,0,0,3,0,1,8,1
2173,44305,speERHm9QGPSObf8TcqRV8vukGx9NoGR,fbPkOYLVPtPgIt0MxizjfFJov3JbHyAi,4,3,2,0,0,0,5,0,10,1.4285714285714286,1,0.0,0,2,0,0,3,0,0,5,0,2,8,1
2174,44307,nxuexUreiYSzpSapqT3MF6tzgH9I1i5D,fbPkOYLVPtPgIt0MxizjfFJov3JbHyAi,5,2,1,0,1,0,3,0,7,1.0,1,0.0,0,1,0,1,2,0,0,3,0,2,5,1
2175,44309,LLsy8k18PLzqaAWgeu3HZsydISuZ18ow,fbPkOYLVPtPgIt0MxizjfFJov3JbHyAi,19,32,13,9,14,8,5,0,81,11.571428571428571,3,0.0,12,13,6,14,20,8,3,5,0,45,36,1
2176,45311,b28qvpjrNqMA0awJsB8hLMAyVGCoQbbk,G8EPVSXsOYB5YQWZGiz1aVq5Pgr2GrQu,7,6,1,0,2,0,5,0,14,2.0,2,0.0,4,1,0,2,2,0,0,5,0,7,7,1
2177,45351,YUDUYDMwNH7HxjxwbXkgNGbRIGFCEsrp,RXDvfPUBYFlVdlueBFbLW0mhhAyGEqpt,1,0,0,0,0,0,1,0,1,0.14285714285714285,1,0.0,0,0,0,0,0,0,0,1,0,0,1,1
2178,45360,n2Bw3Z0s4Gtstp5ZMzZilJIZC4rZeeNT,RXDvfPUBYFlVdlueBFbLW0mhhAyGEqpt,14,13,10,0,6,0,7,0,36,5.142857142857143,2,0.0,0,10,0,6,13,0,0,7,0,16,20,0
2179,45377,j1jdy8OF5VQw4rqSYOkbK2pQplvvvz37,RXDvfPUBYFlVdlueBFbLW0mhhAyGEqpt,1,0,0,0,0,0,3,0,3,0.42857142857142855,1,0.0,0,0,0,0,0,0,0,3,0,0,3,1
2180,45465,S2JQaGbkoCWVoXxNa4G5dVj0cKlAhzdj,G8EPVSXsOYB5YQWZGiz1aVq5Pgr2GrQu,1,0,0,0,0,0,1,0,1,0.14285714285714285,1,0.0,0,0,0,0,0,0,0,1,0,0,1,1
2181,45528,a6zSl0gjLWH0dh3jFMjFS9ulsRXPRoyp,G8EPVSXsOYB5YQWZGiz1aVq5Pgr2GrQu,12,12,6,12,1,1,8,1,41,5.857142857142857,2,0.0,3,6,10,1,9,1,2,8,1,20,21,1
2182,45530,BQi6o3YIDMuHZg7pBKL2EQvhTIhuaxJ1,RXDvfPUBYFlVdlueBFbLW0mhhAyGEqpt,13,10,0,0,0,0,6,0,16,2.2857142857142856,2,0.0,0,0,0,0,10,0,0,6,0,0,16,1
2183,45577,JXWz1gOpRnT7ZzNBuPorM6sgihC1HCez,G8EPVSXsOYB5YQWZGiz1aVq5Pgr2GrQu,26,33,13,10,11,5,11,1,84,12.0,4,0.0,15,13,9,11,18,5,1,11,1,48,36,1
2184,45591,cANiCKhLAefO0FGisAnCzMrx1JIRd95C,G8EPVSXsOYB5YQWZGiz1aVq5Pgr2GrQu,15,10,0,20,0,0,9,0,39,5.571428571428571,2,0.0,0,0,16,0,10,0,4,9,0,16,23,1
2185,45614,aCMLJ0A5ki1G82R2CtOxjr8OrznWuiC4,RXDvfPUBYFlVdlueBFbLW0mhhAyGEqpt,17,24,3,2,2,1,8,1,41,5.857142857142857,4,0.0,3,3,2,2,21,1,0,8,1,10,31,0
2186,45699,K1CIuuqKM8wD54LStvCDz7Yn5t0CkHIq,RXDvfPUBYFlVdlueBFbLW0mhhAyGEqpt,2,0,0,0,0,0,2,0,2,0.2857142857142857,2,0.0,0,0,0,0,0,0,0,2,0,0,2,1
2187,45831,VmamyIiK1jSOxNtAs2j1qAN0wTVBPgfx,RXDvfPUBYFlVdlueBFbLW0mhhAyGEqpt,1,0,0,0,0,0,2,0,2,0.2857142857142857,1,0.0,0,0,0,0,0,0,0,2,0,0,2,1
2188,45843,0DHsJAElXb9hqHUPTXAQocHtOXvWXP78,G8EPVSXsOYB5YQWZGiz1aVq5Pgr2GrQu,1,0,0,0,0,0,1,0,1,0.14285714285714285,1,0.0,0,0,0,0,0,0,0,1,0,0,1,1
2189,45847,CpJFUzNBBad8gxGQfFWcVCTdakqtlRdi,G8EPVSXsOYB5YQWZGiz1aVq5Pgr2GrQu,1,0,0,0,0,0,1,0,1,0.14285714285714285,1,0.0,0,0,0,0,0,0,0,1,0,0,1,1
2190,45896,xTXd8tIpTtdrquABXzBf4mWdlBXfSN1C,RXDvfPUBYFlVdlueBFbLW0mhhAyGEqpt,1,0,0,0,0,0,1,0,1,0.14285714285714285,1,0.0,0,0,0,0,0,0,0,1,0,0,1,1
2191,45921,0Uvd29I2Jn8OHG2XWh0gsDCQWSV0omOU,G8EPVSXsOYB5YQWZGiz1aVq5Pgr2GrQu,13,12,2,6,2,0,3,0,25,3.5714285714285716,3,0.0,3,2,3,2,9,0,3,3,0,10,15,1
2192,46035,0Zq8B7S84C5PTvA0nNf1DjHNx9AarY36,G8EPVSXsOYB5YQWZGiz1aVq5Pgr2GrQu,6,4,1,0,2,8,6,1,22,3.142857142857143,2,0.0,2,1,0,2,2,8,0,6,1,5,17,1
2193,46037,OQeiYxdljaHZZUTeWOEaPzOq9rygakd3,RXDvfPUBYFlVdlueBFbLW0mhhAyGEqpt,21,33,25,23,15,0,7,0,103,14.714285714285714,3,0.0,2,25,20,15,31,0,3,7,0,62,41,1
2194,46053,gvkM0LsKRQYuvgC8Hpf4C14gSdMpspZj,RXDvfPUBYFlVdlueBFbLW0mhhAyGEqpt,15,17,4,21,8,0,3,0,53,7.571428571428571,2,0.0,13,4,18,8,4,0,3,3,0,43,10,1
2195,46068,H3iVkRV8UPZvsbvYrU1dnbX51IlHemsF,RXDvfPUBYFlVdlueBFbLW0mhhAyGEqpt,8,6,1,0,1,0,4,0,12,1.7142857142857142,4,0.0,0,1,0,1,6,0,0,4,0,2,10,0
2196,46092,98ZYW8gcU4Hxzep6tki6R3HQndcbamAh,RXDvfPUBYFlVdlueBFbLW0mhhAyGEqpt,1,0,0,0,0,0,1,0,1,0.14285714285714285,1,0.0,0,0,0,0,0,0,0,1,0,0,1,1
2197,46102,sGJu15oKkQx4W6qHl6Xom6U8DHxzhJdN,G8EPVSXsOYB5YQWZGiz1aVq5Pgr2GrQu,1,0,0,0,0,0,1,0,1,0.14285714285714285,1,0.0,0,0,0,0,0,0,0,1,0,0,1,1
2198,46115,TY20DTNTajpRAyDCw2XYDvuFZloaGUMy,RXDvfPUBYFlVdlueBFbLW0mhhAyGEqpt,11,19,9,0,0,5,10,1,44,6.285714285714286,2,0.0,9,9,0,0,10,5,0,10,1,18,26,1
2199,46215,MEUnkhrmqL9ON8PWbJJQFcg86E54kgxb,RXDvfPUBYFlVdlueBFbLW0mhhAyGEqpt,1,0,0,0,0,0,1,0,1,0.14285714285714285,1,0.0,0,0,0,0,0,0,0,1,0,0,1,1
2200,46249,khWVYmdWxnvqYtc79BZbIfd9BwoftBF7,RXDvfPUBYFlVdlueBFbLW0mhhAyGEqpt,1,0,0,0,0,0,1,0,1,0.14285714285714285,1,0.0,0,0,0,0,0,0,0,1,0,0,1,1
2201,46269,ciDlATwKIeO3pzuVf93RXkCmSkEbDZee,RXDvfPUBYFlVdlueBFbLW0mhhAyGEqpt,18,42,1,12,1,0,9,1,66,9.428571428571429,3,0.0,4,1,10,1,38,0,2,9,1,16,50,1
2202,46337,Rsrb1XM1aPdEAzSt1ydc7TbF7ep7aOyM,G8EPVSXsOYB5YQWZGiz1aVq5Pgr2GrQu,1,0,0,0,0,0,2,0,2,0.2857142857142857,1,0.0,0,0,0,0,0,0,0,2,0,0,2,1
2203,46359,6prInvUnT1ahW1Psrbr1FgolDYnjdXNy,RXDvfPUBYFlVdlueBFbLW0mhhAyGEqpt,1,0,0,0,0,0,1,0,1,0.14285714285714285,1,0.0,0,0,0,0,0,0,0,1,0,0,1,1
2204,46423,mufweOLZc5URTsjF5U8S2NwmI2DUiqcr,G8EPVSXsOYB5YQWZGiz1aVq5Pgr2GrQu,1,0,0,0,0,0,1,0,1,0.14285714285714285,1,0.0,0,0,0,0,0,0,0,1,0,0,1,1
2205,46437,TOrqBZDp9GjgXoTZI9iOS0r8wbO7CyB1,RXDvfPUBYFlVdlueBFbLW0mhhAyGEqpt,28,27,20,32,12,2,8,0,101,14.428571428571429,4,0.0,5,20,31,12,22,2,1,8,0,68,33,0
2206,46479,xSwC5YVwlqQI12zsRbCFcdEzFRC8jvLt,fbPkOYLVPtPgIt0MxizjfFJov3JbHyAi,45,205,12,43,9,118,31,2,420,60.0,8,0.0,85,12,40,9,120,118,3,31,2,146,274,1
2207,46480,MtDn5Hc2NrJY0NIN3hUo3bzbe51wyoG1,fbPkOYLVPtPgIt0MxizjfFJov3JbHyAi,6,2,1,0,1,0,4,0,8,1.1428571428571428,1,0.0,0,1,0,1,2,0,0,4,0,2,6,1
2208,46486,XYKEbaRABcMuBHmMB2I3YkBepzCp0swB,fbPkOYLVPtPgIt0MxizjfFJov3JbHyAi,34,79,3,31,13,75,17,1,219,31.285714285714285,6,0.0,37,3,23,13,42,75,8,17,1,76,143,1
2209,46488,5VcQW1dsZO9SFTtQE9ieV8dTnE3WZtAH,fbPkOYLVPtPgIt0MxizjfFJov3JbHyAi,42,95,26,39,16,1,14,4,195,27.857142857142858,3,0.0,24,26,33,16,71,1,6,14,4,99,96,1
2210,46490,GFOtGeWpej2vOEFvAlaIiOAxIuydKL8r,fbPkOYLVPtPgIt0MxizjfFJov3JbHyAi,1,0,0,0,0,0,1,0,1,0.14285714285714285,1,0.0,0,0,0,0,0,0,0,1,0,0,1,1
2211,46491,5DtI3jRGKF8MjArBAkeRlZ7S3llvU9hJ,fbPkOYLVPtPgIt0MxizjfFJov3JbHyAi,13,15,11,0,8,0,12,0,46,6.571428571428571,1,0.0,1,11,0,8,14,0,0,12,0,20,26,1
2212,46493,ZSamATIYC2PRfbcHh6ixkqUmlwzHYO9B,fbPkOYLVPtPgIt0MxizjfFJov3JbHyAi,7,2,1,0,1,4,4,2,14,2.0,1,0.0,0,1,0,1,2,4,0,4,2,2,12,1
2213,46495,kyoxb5V3l4e9xHjLzGcc4Zkj5x5jcbib,fbPkOYLVPtPgIt0MxizjfFJov3JbHyAi,27,30,16,29,14,11,5,1,106,15.142857142857142,2,0.0,12,16,21,14,18,11,8,5,1,63,43,1
2214,46497,S3wWlLKFbpoawwphxIy6q8DO9Rbo9Vr2,fbPkOYLVPtPgIt0MxizjfFJov3JbHyAi,2,0,0,0,0,0,2,0,2,0.2857142857142857,1,0.0,0,0,0,0,0,0,0,2,0,0,2,1
2215,46499,lRdsv9fYLnIcUL3TBjBQriZ2JWdvMb3q,fbPkOYLVPtPgIt0MxizjfFJov3JbHyAi,11,14,5,7,8,0,8,0,42,6.0,1,0.0,8,5,5,8,6,0,2,8,0,26,16,1
2216,46502,1jF4i27HOUbotwD2J9eQl8mWP4HNYpQb,fbPkOYLVPtPgIt0MxizjfFJov3JbHyAi,7,6,3,0,2,0,5,1,17,2.4285714285714284,1,0.0,1,3,0,2,5,0,0,5,1,6,11,1
2217,46506,zFt7rS5Ni4X3ECj04tcq3nH3EFoFZ84i,fbPkOYLVPtPgIt0MxizjfFJov3JbHyAi,6,5,2,0,2,0,2,0,11,1.5714285714285714,1,0.0,0,2,0,2,5,0,0,2,0,4,7,1
2218,46507,PCZm3QTx838vIR2ddmMUqYGr7hfCHZlX,fbPkOYLVPtPgIt0MxizjfFJov3JbHyAi,1,0,0,0,0,0,2,0,2,0.2857142857142857,1,0.0,0,0,0,0,0,0,0,2,0,0,2,1
2219,46508,sRnzromKdYo1GrGgSS37szKdSdhGa5G6,fbPkOYLVPtPgIt0MxizjfFJov3JbHyAi,18,10,9,0,8,0,2,0,29,4.142857142857143,1,0.0,0,9,0,8,10,0,0,2,0,17,12,1
2220,46509,wUS4QMZENKgcJOovrFGfoZniw3fDJWWg,fbPkOYLVPtPgIt0MxizjfFJov3JbHyAi,58,84,49,22,19,34,47,1,256,36.57142857142857,11,0.0,22,49,22,19,62,34,0,47,1,112,144,0
2221,46510,vCnaR7A3EMdV2eOQ4pBMh0byIjK5VwLE,fbPkOYLVPtPgIt0MxizjfFJov3JbHyAi,13,25,12,0,1,4,6,0,48,6.857142857142857,1,0.0,0,12,0,1,25,4,0,6,0,13,35,1
2222,46521,oSHVr2wJcX30QpIU9UqknqqlABAuhq3p,fbPkOYLVPtPgIt0MxizjfFJov3JbHyAi,8,4,3,0,2,0,7,0,16,2.2857142857142856,1,0.0,0,3,0,2,4,0,0,7,0,5,11,1
2223,46525,8leBy69GlSv8dJWktFbENy7QX7XuxXJV,fbPkOYLVPtPgIt0MxizjfFJov3JbHyAi,1,0,0,0,0,0,1,0,1,0.14285714285714285,1,0.0,0,0,0,0,0,0,0,1,0,0,1,1
2224,46528,0WR29JaRQtT4k6Qay1AHwZZo1wPFV6rM,fbPkOYLVPtPgIt0MxizjfFJov3JbHyAi,8,3,2,0,2,0,3,0,10,1.4285714285714286,1,0.0,0,2,0,2,3,0,0,3,0,4,6,1
2225,46532,iWEmpult7cdvgdjFW97TkROBvpRLqQNG,fbPkOYLVPtPgIt0MxizjfFJov3JbHyAi,1,0,0,0,0,0,1,0,1,0.14285714285714285,1,0.0,0,0,0,0,0,0,0,1,0,0,1,1
2226,46535,fdzq5tofwv4sAm3YqrsC6AMOnGl1oPA0,fbPkOYLVPtPgIt0MxizjfFJov3JbHyAi,26,48,1,18,9,13,21,2,112,16.0,4,0.0,25,1,15,9,23,13,3,21,2,50,62,1
2227,46537,TPC5VVSAcF8gFV38c4L30rHoJE6Gnwyt,fbPkOYLVPtPgIt0MxizjfFJov3JbHyAi,1,0,0,0,0,0,1,0,1,0.14285714285714285,1,0.0,0,0,0,0,0,0,0,1,0,0,1,1
2228,46538,PUFh3BsQaDVIJMDvwsFTqkrgAzvjO9ME,fbPkOYLVPtPgIt0MxizjfFJov3JbHyAi,5,4,2,0,1,0,1,0,8,1.1428571428571428,1,0.0,0,2,0,1,4,0,0,1,0,3,5,1
2229,46539,5lKHsIfbHqFuRTaXGCcOvuWTQPnbutQz,fbPkOYLVPtPgIt0MxizjfFJov3JbHyAi,14,16,4,4,8,5,13,1,51,7.285714285714286,1,0.0,10,4,3,8,6,5,1,13,1,25,26,1
2230,46542,pSw6NR4rsSse1CEq7lXuqdp47AxBAOW4,fbPkOYLVPtPgIt0MxizjfFJov3JbHyAi,12,8,5,6,4,0,6,0,29,4.142857142857143,2,0.0,1,5,5,4,7,0,1,6,0,15,14,1
2231,46545,z5vRcYNQa59xIDqKogHjXQX8tInd0ezN,fbPkOYLVPtPgIt0MxizjfFJov3JbHyAi,7,4,3,0,0,0,4,1,12,1.7142857142857142,1,0.0,0,3,0,0,4,0,0,4,1,3,9,1
2232,46546,RxVWvRN6nC74h4K2UUaoi1CZPrOsRdzT,fbPkOYLVPtPgIt0MxizjfFJov3JbHyAi,10,4,3,0,3,0,3,0,13,1.8571428571428572,1,0.0,0,3,0,3,4,0,0,3,0,6,7,1
2233,46548,85Gd0egbITBoZ0qf12CC4QmkR1r0ZNfP,fbPkOYLVPtPgIt0MxizjfFJov3JbHyAi,1,0,0,0,0,0,1,0,1,0.14285714285714285,1,0.0,0,0,0,0,0,0,0,1,0,0,1,1
2234,46551,kWet01DzGE5Z1z6FwJt5yEexIuvkBhsh,fbPkOYLVPtPgIt0MxizjfFJov3JbHyAi,7,21,3,0,4,16,5,0,49,7.0,3,0.0,8,3,0,4,13,16,0,5,0,15,34,0
2235,46553,3iTz6LNdmrAf4N1vHZusHFiE1Zs4S5Tp,fbPkOYLVPtPgIt0MxizjfFJov3JbHyAi,14,9,5,0,4,1,6,2,27,3.857142857142857,1,0.0,2,5,0,4,7,1,0,6,2,11,16,1
2236,46554,XDsU9hjOJ2JutIT7BD3Uu690qeQfLlzy,fbPkOYLVPtPgIt0MxizjfFJov3JbHyAi,8,9,6,0,4,0,7,0,26,3.7142857142857144,2,0.0,0,6,0,4,9,0,0,7,0,10,16,0
2237,46563,jeCWCRGTMsRbs6OIyOwUGbeuGaxOlgRf,fbPkOYLVPtPgIt0MxizjfFJov3JbHyAi,8,6,3,0,4,0,3,0,16,2.2857142857142856,2,0.0,2,3,0,4,4,0,0,3,0,9,7,1
2238,46572,ot3QeXNrfLK0N6qyT4MMuMtdNheYtJct,fbPkOYLVPtPgIt0MxizjfFJov3JbHyAi,8,2,1,0,1,2,6,1,13,1.8571428571428572,3,0.0,0,1,0,1,2,2,0,6,1,2,11,1
2239,46575,Qo1OAp8GglCOhKICbcJQhmG7Ih2RNYzD,fbPkOYLVPtPgIt0MxizjfFJov3JbHyAi,2,0,0,0,0,0,4,0,4,0.5714285714285714,1,0.0,0,0,0,0,0,0,0,4,0,0,4,1
2240,46583,oIYeGNswP9C35pzco2q8t5ZyALp7umIE,fbPkOYLVPtPgIt0MxizjfFJov3JbHyAi,1,0,0,0,0,0,1,0,1,0.14285714285714285,1,0.0,0,0,0,0,0,0,0,1,0,0,1,1
2241,46584,l6QkvTQevuUo95YVKmMOiOhmjs3kJ3PF,fbPkOYLVPtPgIt0MxizjfFJov3JbHyAi,1,0,0,0,0,0,1,0,1,0.14285714285714285,1,0.0,0,0,0,0,0,0,0,1,0,0,1,1
2242,46586,2sZGSeEPKMgpuspPc9ln3wAme2MWPynt,fbPkOYLVPtPgIt0MxizjfFJov3JbHyAi,1,0,0,0,0,0,1,0,1,0.14285714285714285,1,0.0,0,0,0,0,0,0,0,1,0,0,1,1
2243,46591,XQCUbONg6Qt5ssh0BzFokuANDDKZfnIv,fbPkOYLVPtPgIt0MxizjfFJov3JbHyAi,10,17,3,2,2,0,5,0,29,4.142857142857143,3,0.0,1,3,2,2,16,0,0,5,0,8,21,1
2244,46592,6EsKULTJVMq3E9IpeZllE0vOQuFiZwCm,fbPkOYLVPtPgIt0MxizjfFJov3JbHyAi,1,0,0,0,0,0,1,0,1,0.14285714285714285,1,0.0,0,0,0,0,0,0,0,1,0,0,1,1
2245,46594,43LGAyiQH2Nct9LoZlyA6wH2hSGoRMei,fbPkOYLVPtPgIt0MxizjfFJov3JbHyAi,1,0,0,0,0,0,1,0,1,0.14285714285714285,1,0.0,0,0,0,0,0,0,0,1,0,0,1,1
2246,47706,P59zgxkiZZAY4L2oDvB0C7gvcL7QBtyx,7GRhBDsirIGkRZBtSMEzNTyDr2JQm4xx,20,23,9,62,2,0,1,0,97,13.857142857142858,1,0.0,13,9,59,2,10,0,3,1,0,83,14,0
2247,47712,ilWzYGLWBh9DSc1MV8g2C4Go5wDNgUHX,7GRhBDsirIGkRZBtSMEzNTyDr2JQm4xx,31,24,8,30,9,20,4,0,95,13.571428571428571,2,0.0,14,8,26,9,10,20,4,4,0,57,38,1
2248,47737,kqS8BwWN9R1093oeblGkvtCsQJ68Gh0G,7GRhBDsirIGkRZBtSMEzNTyDr2JQm4xx,7,6,3,2,1,0,2,0,14,2.0,2,0.0,1,3,1,1,5,0,1,2,0,6,8,1
2249,47748,kBcjUv7wCsLl51XfcJpKl8Rz4VIbTmWw,fbPkOYLVPtPgIt0MxizjfFJov3JbHyAi,27,23,9,8,9,3,11,1,64,9.142857142857142,3,0.0,10,9,8,9,13,3,0,11,1,36,28,1
2250,47750,0qPh5PrlrJCeTfTUrI9BQO9zneoMXi60,fbPkOYLVPtPgIt0MxizjfFJov3JbHyAi,9,12,3,0,4,1,5,1,26,3.7142857142857144,1,0.0,7,3,0,4,5,1,0,5,1,14,12,1
2251,47752,sssMJa5iFnCjQwIkqzgCnBND3LRzFTaw,fbPkOYLVPtPgIt0MxizjfFJov3JbHyAi,1,0,0,0,0,0,1,0,1,0.14285714285714285,1,0.0,0,0,0,0,0,0,0,1,0,0,1,1
2252,47753,vAnQOM98uBV9N4zlyAfd54z2JCZnwUx8,fbPkOYLVPtPgIt0MxizjfFJov3JbHyAi,21,41,14,24,13,0,9,0,101,14.428571428571429,3,0.0,8,14,19,13,33,0,5,9,0,54,47,1
2253,47758,Br3boNa1GOtMS8whgjxC8vFojVZKIJ8q,fbPkOYLVPtPgIt0MxizjfFJov3JbHyAi,7,3,2,0,2,0,5,0,12,1.7142857142857142,1,0.0,0,2,0,2,3,0,0,5,0,4,8,1
2254,47760,jWh61XkRTjwdqASpqvrGaFWBIry4gjxu,fbPkOYLVPtPgIt0MxizjfFJov3JbHyAi,5,4,3,0,3,0,8,0,18,2.5714285714285716,4,0.0,0,3,0,3,4,0,0,8,0,6,12,1
2255,47764,3ekpb9qQNnBvDGQePlspHv7VLn9RhUhL,fbPkOYLVPtPgIt0MxizjfFJov3JbHyAi,1,0,0,0,0,0,1,0,1,0.14285714285714285,1,0.0,0,0,0,0,0,0,0,1,0,0,1,1
2256,47770,KO9zYaiac2CNagQLdx3aJ9c2fXXMgIJX,fbPkOYLVPtPgIt0MxizjfFJov3JbHyAi,22,56,17,4,10,6,17,2,112,16.0,7,0.0,3,17,3,10,53,6,1,17,2,33,79,0
2257,47772,mMS5utPEE0kau31EdquwgaN1e0nxF2V4,fbPkOYLVPtPgIt0MxizjfFJov3JbHyAi,6,3,2,0,2,0,1,0,8,1.1428571428571428,1,0.0,0,2,0,2,3,0,0,1,0,4,4,1
2258,47776,zHeujEYh5L6paRQ7acJHcEFwTj5egykX,fbPkOYLVPtPgIt0MxizjfFJov3JbHyAi,5,6,2,0,0,0,3,0,11,1.5714285714285714,3,0.0,0,2,0,0,6,0,0,3,0,2,9,1
2259,47777,H2nT05aeA6Q1zZKHa66kquyct5PT5SXn,fbPkOYLVPtPgIt0MxizjfFJov3JbHyAi,9,9,3,0,3,8,2,0,25,3.5714285714285716,1,0.0,2,3,0,3,7,8,0,2,0,8,17,1
2260,47779,rVswAzjMLz5uIPbCwAU1SliCQFpiAqey,fbPkOYLVPtPgIt0MxizjfFJov3JbHyAi,7,7,5,0,3,0,4,0,19,2.7142857142857144,2,0.0,0,5,0,3,7,0,0,4,0,8,11,1
2261,47780,bhGqExUGpWPVtLHOBczGOZtP5NSlb2iV,fbPkOYLVPtPgIt0MxizjfFJov3JbHyAi,5,2,1,0,1,0,2,0,6,0.8571428571428571,1,0.0,0,1,0,1,2,0,0,2,0,2,4,1
2262,47783,LnBIzyfbdwaIzv1AmzgfFWCAT33UKIqQ,fbPkOYLVPtPgIt0MxizjfFJov3JbHyAi,5,3,1,0,1,0,4,0,9,1.2857142857142858,1,0.0,1,1,0,1,2,0,0,4,0,3,6,1
2263,47787,W3kCxGrfIFukJWUU9IJiC14IoMB2PgEG,fbPkOYLVPtPgIt0MxizjfFJov3JbHyAi,7,7,5,0,0,15,5,0,32,4.571428571428571,1,0.0,0,5,0,0,7,15,0,5,0,5,27,1
2264,47789,2LJu3awzGTK6KEvbTKsHaTWm40Uc2FME,fbPkOYLVPtPgIt0MxizjfFJov3JbHyAi,5,2,1,0,1,0,2,0,6,0.8571428571428571,1,0.0,0,1,0,1,2,0,0,2,0,2,4,1
2265,47790,0ieVgiGrluCsPP0YL5BydyAhM42qWcB4,fbPkOYLVPtPgIt0MxizjfFJov3JbHyAi,7,3,2,0,2,0,3,0,10,1.4285714285714286,1,0.0,0,2,0,2,3,0,0,3,0,4,6,1
2266,47793,hllwiqbKGoyJt5Tb2KABSErcKGSjkpFC,fbPkOYLVPtPgIt0MxizjfFJov3JbHyAi,1,0,0,0,0,0,1,0,1,0.14285714285714285,1,0.0,0,0,0,0,0,0,0,1,0,0,1,1
2267,47794,lQ3NA8rIFeBdMYWA2lzeVtp3TG4uBQXU,fbPkOYLVPtPgIt0MxizjfFJov3JbHyAi,15,56,33,13,31,30,8,0,171,24.428571428571427,5,0.0,10,33,9,31,46,30,4,8,0,83,88,1
2268,47802,0QSMkT1dSojdga3gOUuLnnXcPZoPeqgp,fbPkOYLVPtPgIt0MxizjfFJov3JbHyAi,5,2,1,0,1,0,2,0,6,0.8571428571428571,1,0.0,0,1,0,1,2,0,0,2,0,2,4,0
2269,47805,C1NrIu2z9b7sPd2GgrgPvw1qImibSsqR,fbPkOYLVPtPgIt0MxizjfFJov3JbHyAi,1,0,0,0,0,0,1,0,1,0.14285714285714285,1,0.0,0,0,0,0,0,0,0,1,0,0,1,1
2270,47806,uXSmZuPz2xNXPk2qFBcPykAtedr98vP4,fbPkOYLVPtPgIt0MxizjfFJov3JbHyAi,14,11,7,2,5,0,3,0,28,4.0,2,0.0,1,7,2,5,10,0,0,3,0,15,13,1
2271,47809,LwiFBYAg8FxzttVYXUksrgMfJRvI4SFJ,fbPkOYLVPtPgIt0MxizjfFJov3JbHyAi,13,33,16,0,0,1,16,1,67,9.571428571428571,4,0.0,9,16,0,0,24,1,0,16,1,25,42,1
2272,47810,ZQszEDvefL66DoX1xrFttL5Z99UGUgJi,fbPkOYLVPtPgIt0MxizjfFJov3JbHyAi,14,25,17,1,7,58,15,2,125,17.857142857142858,5,0.0,1,17,1,7,24,58,0,15,2,26,99,0
2273,47812,FQ1LFgTnlxgM163pJYQ8F6cnOancinCK,fbPkOYLVPtPgIt0MxizjfFJov3JbHyAi,15,22,1,7,4,7,4,0,45,6.428571428571429,3,0.0,9,1,6,4,13,7,1,4,0,20,25,1
2274,47816,JyOwpTqxlZyOZXFXAlv3kcbVV4zSYrRf,fbPkOYLVPtPgIt0MxizjfFJov3JbHyAi,8,4,2,0,2,0,2,0,10,1.4285714285714286,1,0.0,0,2,0,2,4,0,0,2,0,4,6,1
2275,47817,5NX0UTrEG0Nosf3C8odmhhCWYxUKxKSk,fbPkOYLVPtPgIt0MxizjfFJov3JbHyAi,5,2,1,0,1,0,2,0,6,0.8571428571428571,1,0.0,0,1,0,1,2,0,0,2,0,2,4,1
2276,47818,4aUZNrEysB01BTDaMjEoJUWN7ca7RotB,fbPkOYLVPtPgIt0MxizjfFJov3JbHyAi,12,12,4,2,5,0,5,0,28,4.0,1,0.0,6,4,2,5,6,0,0,5,0,17,11,1
2277,47820,ZJVdccRSVGtL7lRrhASOIKDRLk41rGEl,fbPkOYLVPtPgIt0MxizjfFJov3JbHyAi,8,5,3,0,2,0,2,0,12,1.7142857142857142,1,0.0,0,3,0,2,5,0,0,2,0,5,7,1
2278,47822,T0bX8618p1zppaN2AzjlfD61pjXKKkDP,fbPkOYLVPtPgIt0MxizjfFJov3JbHyAi,2,0,0,0,0,0,2,0,2,0.2857142857142857,1,0.0,0,0,0,0,0,0,0,2,0,0,2,1
2279,47824,wwifhf2JKuRRsCekTCD33hbtOjxoHPnW,fbPkOYLVPtPgIt0MxizjfFJov3JbHyAi,44,79,35,33,25,34,10,0,216,30.857142857142858,5,0.0,36,35,27,25,43,34,6,10,0,123,93,1
2280,47826,6cy8BWaUGaMCAOjojQczbStvsRKYISdK,fbPkOYLVPtPgIt0MxizjfFJov3JbHyAi,12,20,13,9,10,0,8,0,60,8.571428571428571,5,0.0,3,13,6,10,17,0,3,8,0,32,28,1
2281,47828,W7e0QUNKaRKq7UxQ0gmzqrmRmeubAvn2,fbPkOYLVPtPgIt0MxizjfFJov3JbHyAi,5,2,1,0,1,0,2,0,6,0.8571428571428571,1,0.0,0,1,0,1,2,0,0,2,0,2,4,1
2282,47838,bJNzzdFbeXF3gRIHxGK6VlbnTQeUffyz,fbPkOYLVPtPgIt0MxizjfFJov3JbHyAi,12,13,3,4,5,3,11,1,40,5.714285714285714,3,0.0,7,3,3,5,6,3,1,11,1,18,22,1
2283,47839,ymWpwD3GRW9ut1JiVBQeAWpoDiatjwOa,fbPkOYLVPtPgIt0MxizjfFJov3JbHyAi,19,25,13,5,9,18,8,0,78,11.142857142857142,3,0.0,7,13,5,9,18,18,0,8,0,34,44,1
2284,47846,DUdBmTRQYTDfiJ48gpt3WzQELlnWqHAt,fbPkOYLVPtPgIt0MxizjfFJov3JbHyAi,27,34,21,15,17,36,16,1,140,20.0,4,0.0,8,21,12,17,26,36,3,16,1,58,82,1
2285,47848,bo0kzQtcVPpunN4Y9LfeiFpB6omq1iOi,fbPkOYLVPtPgIt0MxizjfFJov3JbHyAi,1,0,0,0,0,0,1,0,1,0.14285714285714285,1,0.0,0,0,0,0,0,0,0,1,0,0,1,1
2286,47850,EA93zC2FZSfWuUTy2fGF8qAEwUDl0X8s,fbPkOYLVPtPgIt0MxizjfFJov3JbHyAi,44,65,36,26,22,24,17,1,191,27.285714285714285,8,0.0,18,36,22,22,47,24,4,17,1,98,93,1
2287,47853,ZZRh21sVolimyM3CDUIIgG9cuzaZauji,fbPkOYLVPtPgIt0MxizjfFJov3JbHyAi,49,89,44,57,20,60,27,5,302,43.142857142857146,7,0.0,28,44,43,20,61,60,14,27,5,135,167,1
2288,47861,DIrQamaTjjU1PZti9ZjQXTxfEYtPLnQl,fbPkOYLVPtPgIt0MxizjfFJov3JbHyAi,33,53,29,19,15,3,14,1,134,19.142857142857142,4,0.0,12,29,15,15,41,3,4,14,1,71,63,1
2289,47894,Rz28tFT5qYZaEQ78Ly3OdJx8TpvsmLBy,bWdj2GDclj5ofokWjzoa5jAwMkxCykd6,12,20,10,20,1,0,12,0,63,9.0,4,0.0,0,10,19,1,20,0,1,12,0,30,33,0
2290,47900,t8SjYilFMTCG5Wi1o6mcbWFbM7fvPbYd,SpATywNh6bZuzm8s1ceuBUnMUAeoAHHw,29,36,23,12,16,0,5,0,92,13.142857142857142,3,0.0,9,23,12,16,27,0,0,5,0,60,32,0
2291,47938,szUZ2QsyqJuXPgyS49q35y1kTVrrBlKT,SpATywNh6bZuzm8s1ceuBUnMUAeoAHHw,28,86,34,52,9,7,16,1,205,29.285714285714285,7,0.0,35,34,40,9,51,7,12,16,1,118,87,0
2292,48018,xecOK3aJ3hCti9mz2pAAcwSq9d1S8ATw,SpATywNh6bZuzm8s1ceuBUnMUAeoAHHw,24,70,12,60,6,1,17,1,167,23.857142857142858,5,0.0,27,12,59,6,43,1,1,17,1,104,63,0
2293,48041,SmONSyS4YgG4Afnv6ZxU81t7p4CQPV5P,bWdj2GDclj5ofokWjzoa5jAwMkxCykd6,1,0,0,0,0,0,1,0,1,0.14285714285714285,1,0.0,0,0,0,0,0,0,0,1,0,0,1,1
2294,48045,O6XTfrmBXPHHKFN07CLCPWqyMP9NsQuf,A3fsA9Zfv1X2fVEQhTw51lKENdNrEqT3,7,3,2,0,2,0,3,0,10,1.4285714285714286,1,0.0,0,2,0,2,3,0,0,3,0,4,6,0
2295,48081,zCdZvanEH4w4mJiogg5VcFWhPxVyZDYs,RXDvfPUBYFlVdlueBFbLW0mhhAyGEqpt,39,39,1,112,1,6,3,0,162,23.142857142857142,1,0.0,9,1,110,1,30,6,2,3,0,121,41,0
2296,48093,23GFMJXBCJBMscnU5tVwAanleKYVql9b,SpATywNh6bZuzm8s1ceuBUnMUAeoAHHw,32,99,62,36,37,163,43,7,447,63.857142857142854,12,0.0,18,62,33,37,81,163,3,43,7,150,297,0
2297,48114,rzXoVvb6RM0hS48T1GDjFso4hKBDuhsd,bWdj2GDclj5ofokWjzoa5jAwMkxCykd6,32,33,22,61,14,0,7,0,137,19.571428571428573,2,0.0,5,22,54,14,28,0,7,7,0,95,42,0
2298,48121,aDXyYOZH6u3WRzJTxPdI3vxwfFxiKOmm,SpATywNh6bZuzm8s1ceuBUnMUAeoAHHw,11,20,7,0,5,0,4,0,36,5.142857142857143,2,0.0,0,7,0,5,20,0,0,4,0,12,24,1
2299,48204,pl9XUoy865SinWI51RNAlmhqaJHEhs94,SpATywNh6bZuzm8s1ceuBUnMUAeoAHHw,21,21,9,18,5,1,10,1,65,9.285714285714286,2,0.0,8,9,15,5,13,1,3,10,1,37,28,1
2300,48246,ieR2oDuOBOWrOSx08B7vLKsdvt41Kjgw,A3fsA9Zfv1X2fVEQhTw51lKENdNrEqT3,26,52,12,0,8,0,11,0,83,11.857142857142858,4,0.0,4,12,0,8,48,0,0,11,0,24,59,0
2301,48261,wi7Ze896VO17gMeNUgqgfOVbxlFbfvaK,SpATywNh6bZuzm8s1ceuBUnMUAeoAHHw,30,85,41,23,20,5,30,4,208,29.714285714285715,6,0.0,15,41,19,20,70,5,4,30,4,95,113,0
2302,48307,xqNT9GHVIeGkzMPTfiXtvyG6m6zaY6B9,A3fsA9Zfv1X2fVEQhTw51lKENdNrEqT3,3,0,0,0,0,0,4,0,4,0.5714285714285714,1,0.0,0,0,0,0,0,0,0,4,0,0,4,1
2303,48325,vkfHpP1V5bzhsiIUQc7ID6uM0xIbyM6G,bWdj2GDclj5ofokWjzoa5jAwMkxCykd6,6,5,2,0,3,0,1,0,11,1.5714285714285714,3,0.0,2,2,0,3,3,0,0,1,0,7,4,1
2304,48345,pnW8XX8zC0UKr9mm25Bt1RQ7xgXCstp3,A3fsA9Zfv1X2fVEQhTw51lKENdNrEqT3,2,0,0,0,0,0,4,0,4,0.5714285714285714,2,0.0,0,0,0,0,0,0,0,4,0,0,4,0
2305,48370,3HC1D1DG8BjKUNFZlgm7gcIQVOGrzi6J,SpATywNh6bZuzm8s1ceuBUnMUAeoAHHw,20,36,23,0,13,29,7,0,108,15.428571428571429,5,0.0,9,23,0,13,27,29,0,7,0,45,63,0
2306,48372,WjTYaS8yfbxyQCBRfgx2LHwT0DLPXKM5,SpATywNh6bZuzm8s1ceuBUnMUAeoAHHw,8,7,6,0,0,0,7,10,30,4.285714285714286,1,0.0,0,6,0,0,7,0,0,7,10,6,24,1
2307,48386,5jz6qtmzJGoTjjzPCohz2U8oEp7qiszP,SpATywNh6bZuzm8s1ceuBUnMUAeoAHHw,29,53,20,39,9,21,18,3,163,23.285714285714285,6,0.0,17,20,32,9,36,21,7,18,3,78,85,0
2308,48446,QIQR6VwK3cpUKM5lDzadEKeQATM23w8z,A3fsA9Zfv1X2fVEQhTw51lKENdNrEqT3,15,26,0,0,0,0,5,0,31,4.428571428571429,4,0.0,0,0,0,0,26,0,0,5,0,0,31,1
2309,48454,g1ncrxE30iLPOXYuzSV4ccCqY3Ww9KwB,A3fsA9Zfv1X2fVEQhTw51lKENdNrEqT3,4,2,1,0,0,1,3,0,7,1.0,2,0.0,0,1,0,0,2,1,0,3,0,1,6,1
2310,48484,HsuSSkmNEe51pmwRC4MuavuxD1n89icY,SpATywNh6bZuzm8s1ceuBUnMUAeoAHHw,10,3,2,0,2,6,6,1,20,2.857142857142857,1,0.0,0,2,0,2,3,6,0,6,1,4,16,1
2311,48492,Av4RUzIKiBksZoh2Q0L0akgGSwn9yOvk,SpATywNh6bZuzm8s1ceuBUnMUAeoAHHw,24,19,15,8,8,8,3,0,61,8.714285714285714,1,0.0,2,15,8,8,17,8,0,3,0,33,28,0
2312,48529,hkwn5MNEUKXaOvo8i7hJxIoCohTDhE10,SpATywNh6bZuzm8s1ceuBUnMUAeoAHHw,7,4,3,0,2,0,2,0,11,1.5714285714285714,1,0.0,0,3,0,2,4,0,0,2,0,5,6,0
2313,48570,VTFDw2vJ6rzCiyEGWQUVkoldm7wzhtYa,SpATywNh6bZuzm8s1ceuBUnMUAeoAHHw,18,31,15,0,8,6,8,0,68,9.714285714285714,3,0.0,10,15,0,8,21,6,0,8,0,33,35,1
2314,48587,v6QLYqOum8NXSX8h0M5DMTP0vkr2qfHa,SpATywNh6bZuzm8s1ceuBUnMUAeoAHHw,32,87,42,24,18,148,51,1,371,53.0,12,0.0,26,42,24,18,61,148,0,51,1,110,261,0
2315,48617,LSvU72CFq1TrHd9SCZOiKQ0qcV2oa2Ok,A3fsA9Zfv1X2fVEQhTw51lKENdNrEqT3,13,40,3,0,2,2,10,0,57,8.142857142857142,7,0.0,2,3,0,2,38,2,0,10,0,7,50,0
2316,48630,oymhnrhhZTojmhR9U4GGxnwHZLmXRmW8,SpATywNh6bZuzm8s1ceuBUnMUAeoAHHw,4,4,1,0,0,0,4,0,9,1.2857142857142858,2,0.0,0,1,0,0,4,0,0,4,0,1,8,1
2317,48643,RCdcltNaQLfcoxT7YKTjQxAYUbCmzzKd,SpATywNh6bZuzm8s1ceuBUnMUAeoAHHw,29,39,20,28,8,31,13,1,140,20.0,7,0.0,11,20,26,8,28,31,2,13,1,65,75,0
2318,48684,ugIvWXr0VKdRfQslnLOrtvUMZY9HB5mg,A3fsA9Zfv1X2fVEQhTw51lKENdNrEqT3,1,0,0,0,0,0,1,0,1,0.14285714285714285,1,0.0,0,0,0,0,0,0,0,1,0,0,1,1
2319,48693,AnsnVs5AVUHmSDONSrxZt8MIRHsOXvcc,SpATywNh6bZuzm8s1ceuBUnMUAeoAHHw,16,11,7,15,3,21,8,4,69,9.857142857142858,4,0.0,2,7,14,3,9,21,1,8,4,26,43,0
2320,48701,z4snJqWxxByo4wMmQ2g1knGwZpMDrb1I,SpATywNh6bZuzm8s1ceuBUnMUAeoAHHw,22,66,36,20,30,9,8,0,169,24.142857142857142,9,0.0,6,36,17,30,60,9,3,8,0,89,80,0
2321,48716,EJmjPRM04Uqau3e0OiUKVcHUyavQV9Hd,SpATywNh6bZuzm8s1ceuBUnMUAeoAHHw,5,4,1,0,1,0,2,0,8,1.1428571428571428,2,0.0,0,1,0,1,4,0,0,2,0,2,6,0
2322,48717,Kkk2oty8lHBEgyFYDiZgsO24fUpD8pZQ,A3fsA9Zfv1X2fVEQhTw51lKENdNrEqT3,12,11,9,0,7,0,4,0,31,4.428571428571429,2,0.0,0,9,0,7,11,0,0,4,0,16,15,1
2323,48724,oxWNSOCXM5YtqWviH5bNOZtEWIiiD3Ad,SpATywNh6bZuzm8s1ceuBUnMUAeoAHHw,22,34,0,37,0,6,10,1,88,12.571428571428571,3,0.0,17,0,31,0,17,6,6,10,1,48,40,0
2324,48851,U2YEyQJ6vRjLD9a41Fy3cKvRrxCg3qKu,SpATywNh6bZuzm8s1ceuBUnMUAeoAHHw,25,61,34,34,8,41,40,1,219,31.285714285714285,7,0.0,9,34,28,8,52,41,6,40,1,79,140,0
2325,48873,FgYPvBwLri7YiFI9og6clP9FuKJ08jX7,G8EPVSXsOYB5YQWZGiz1aVq5Pgr2GrQu,6,4,2,0,1,0,3,0,10,1.4285714285714286,3,0.0,0,2,0,1,4,0,0,3,0,3,7,1
2326,48910,oORy78WPGzz21oydfrdMfNTEPAbNPQ4N,SpATywNh6bZuzm8s1ceuBUnMUAeoAHHw,13,11,4,13,3,0,6,0,37,5.285714285714286,2,0.0,4,4,11,3,7,0,2,6,0,22,15,0
2327,48923,rJ7deFT9ohZCOevrsW5L4Px2yVgiatFT,A3fsA9Zfv1X2fVEQhTw51lKENdNrEqT3,24,28,21,0,13,0,4,0,66,9.428571428571429,1,0.0,2,21,0,13,26,0,0,4,0,36,30,1
2328,48934,PPMgD0y4ftWviyNbM56pMh7QBTyoyQi0,A3fsA9Zfv1X2fVEQhTw51lKENdNrEqT3,35,23,0,64,0,0,5,0,92,13.142857142857142,2,0.0,1,0,57,0,22,0,7,5,0,58,34,1
2329,48957,7xLRAUzJSfSBonILgUC8oEWPnbxwGYvj,RXDvfPUBYFlVdlueBFbLW0mhhAyGEqpt,31,51,3,21,1,1,6,1,84,12.0,4,0.0,0,3,18,1,51,1,3,6,1,22,62,1
2330,48958,CFwBanDE4eguHX9lcM62Yx5Bex6437kC,SpATywNh6bZuzm8s1ceuBUnMUAeoAHHw,5,2,1,0,1,3,3,0,10,1.4285714285714286,2,0.0,0,1,0,1,2,3,0,3,0,2,8,0
2331,48968,3Y0bPm3E3Ch9XQ8h4cbV56DUaTL5U5qc,SpATywNh6bZuzm8s1ceuBUnMUAeoAHHw,28,95,39,37,4,77,31,4,287,41.0,10,0.0,26,39,31,4,69,77,6,31,4,100,187,0
2332,48974,Ze9kgklMuT1yRhjZzYqZ128xNCVJ9Ing,SpATywNh6bZuzm8s1ceuBUnMUAeoAHHw,13,13,5,13,4,0,2,0,37,5.285714285714286,1,0.0,2,5,11,4,11,0,2,2,0,22,15,0
2333,48988,n0HFF3TwqKuBMzzkdLCbvb8Mji5ZUnVX,bWdj2GDclj5ofokWjzoa5jAwMkxCykd6,4,2,1,0,1,0,1,0,5,0.7142857142857143,1,0.0,0,1,0,1,2,0,0,1,0,2,3,0
2334,49079,uqA5Smdw6BACOcL0f2tmxwTTxZXBpZpE,A3fsA9Zfv1X2fVEQhTw51lKENdNrEqT3,6,7,3,0,1,0,3,0,14,2.0,2,0.0,0,3,0,1,7,0,0,3,0,4,10,1
2335,49082,21PlIQxHvCIRuT4YC0IvZYCzvQ1GOkuQ,SpATywNh6bZuzm8s1ceuBUnMUAeoAHHw,15,16,2,23,3,3,5,1,53,7.571428571428571,3,0.0,5,2,19,3,11,3,4,5,1,29,24,1
2336,49086,G7CuAdMTwHj5eYhpu5z9RBNQZMziV4KR,SpATywNh6bZuzm8s1ceuBUnMUAeoAHHw,14,24,12,0,10,4,14,3,67,9.571428571428571,3,0.0,0,12,0,10,24,4,0,14,3,22,45,0
2337,49123,hZuqApg1u2xIALq7aPkxAemxANyM5ZQO,SpATywNh6bZuzm8s1ceuBUnMUAeoAHHw,26,19,15,26,10,0,7,0,77,11.0,1,0.0,4,15,24,10,15,0,2,7,0,53,24,0
2338,49154,ahTQ6twHrEgeLAYHLb7pWZDspU6rrM6J,A3fsA9Zfv1X2fVEQhTw51lKENdNrEqT3,14,13,12,0,6,0,1,0,32,4.571428571428571,1,0.0,0,12,0,6,13,0,0,1,0,18,14,1
2339,49173,1n5WyoQB7crKqtXBR0SIfThQpW2Y5gVs,SpATywNh6bZuzm8s1ceuBUnMUAeoAHHw,20,43,20,9,10,16,11,1,110,15.714285714285714,2,0.0,14,20,9,10,29,16,0,11,1,53,57,0
2340,49176,NPHytleW9ri0zHSbUOwP2d33PRO3w2MK,SpATywNh6bZuzm8s1ceuBUnMUAeoAHHw,17,18,7,31,1,17,11,0,85,12.142857142857142,4,0.0,8,7,29,1,10,17,2,11,0,45,40,0
2341,49181,XlmFJwnIeWSyzdPHIMvNTxkRpr6ZopMK,SpATywNh6bZuzm8s1ceuBUnMUAeoAHHw,14,28,14,21,6,4,5,0,78,11.142857142857142,4,0.0,8,14,17,6,20,4,4,5,0,45,33,1
2342,49183,TNa2CwMEhRRkLaiFBsLLeLu23oFHBijc,SpATywNh6bZuzm8s1ceuBUnMUAeoAHHw,23,36,1,27,1,16,16,2,99,14.142857142857142,5,0.0,12,1,23,1,24,16,4,16,2,37,62,0
2343,49202,l70wRZ2DS0s6LjbT7C4gRoGrF27x9p2H,A3fsA9Zfv1X2fVEQhTw51lKENdNrEqT3,48,45,0,92,0,16,30,0,183,26.142857142857142,8,0.0,5,0,88,0,40,16,4,30,0,93,90,1
2344,49238,Zi3R72s2HAt1ldLoA4VSH4SbCoNpJ8zo,SpATywNh6bZuzm8s1ceuBUnMUAeoAHHw,6,3,2,0,2,0,1,0,8,1.1428571428571428,1,0.0,0,2,0,2,3,0,0,1,0,4,4,1
2345,49254,Hw8jmGp4VI4tAz6cfKhHDOeLB2t7MJ9z,SpATywNh6bZuzm8s1ceuBUnMUAeoAHHw,12,13,7,6,0,20,5,0,51,7.285714285714286,4,0.0,4,7,6,0,9,20,0,5,0,17,34,1
2346,49271,L1EklyJfiTl8KTmYGUWKSBRLYXBLn3BW,SpATywNh6bZuzm8s1ceuBUnMUAeoAHHw,18,23,17,12,9,0,5,1,67,9.571428571428571,3,0.0,3,17,11,9,20,0,1,5,1,40,27,0
2347,49276,vrm9Sqb4UFaJQirEdRETMq8oV2HNeZJI,bWdj2GDclj5ofokWjzoa5jAwMkxCykd6,9,8,0,0,0,21,5,1,35,5.0,2,0.0,0,0,0,0,8,21,0,5,1,0,35,0
2348,49279,SAT7bMoLoVZhaMB8v6lFFmYFR0NgSYce,A3fsA9Zfv1X2fVEQhTw51lKENdNrEqT3,9,2,1,0,1,2,8,1,15,2.142857142857143,1,0.0,0,1,0,1,2,2,0,8,1,2,13,1
2349,49280,CGjJFqZQSngbEn6BLTOwdJsdGHCnhvU8,SpATywNh6bZuzm8s1ceuBUnMUAeoAHHw,14,14,6,5,4,0,3,0,32,4.571428571428571,1,0.0,3,6,4,4,11,0,1,3,0,17,15,1
2350,49302,3uU9hzp6POZeWb9TkpjJweQiyjZgKmLY,SpATywNh6bZuzm8s1ceuBUnMUAeoAHHw,27,42,24,28,14,1,8,1,118,16.857142857142858,6,0.0,10,24,26,14,32,1,2,8,1,74,44,0
2351,49398,829nD15I0zFbxTlo9Kk4QZLCipO4Bdiu,A3fsA9Zfv1X2fVEQhTw51lKENdNrEqT3,2,0,0,0,0,0,2,0,2,0.2857142857142857,1,0.0,0,0,0,0,0,0,0,2,0,0,2,1
2352,49423,S9Zsax2BYcPzUt4rHtigt6S1ZlRCRjuu,SpATywNh6bZuzm8s1ceuBUnMUAeoAHHw,31,67,28,16,9,9,22,1,152,21.714285714285715,7,0.0,10,28,16,9,57,9,0,22,1,63,89,0
2353,49460,cvdLaf0MdwYwJIsGvs9mqC9xuvaOoxKF,A3fsA9Zfv1X2fVEQhTw51lKENdNrEqT3,24,47,12,0,9,0,9,1,78,11.142857142857142,4,0.0,0,12,0,9,47,0,0,9,1,21,57,1
2354,49511,H1nbdkC904EOh8jWeVVcV5piaqMVBsli,SpATywNh6bZuzm8s1ceuBUnMUAeoAHHw,25,30,4,24,1,2,10,0,71,10.142857142857142,6,0.0,8,4,24,1,22,2,0,10,0,37,34,0
2355,49513,I15DoIEv5oOQwZnGe2Nztxp5iKM5K2pr,SpATywNh6bZuzm8s1ceuBUnMUAeoAHHw,25,44,2,22,5,3,10,0,86,12.285714285714286,2,0.0,5,2,18,5,39,3,4,10,0,30,56,0
2356,49541,NblSZLprYLuCPJABpiPhGyWCznOG5gpM,SpATywNh6bZuzm8s1ceuBUnMUAeoAHHw,16,19,11,0,6,0,2,0,38,5.428571428571429,2,0.0,0,11,0,6,19,0,0,2,0,17,21,1
2357,49543,0OsY8LWQHJyrf2iZ6AGYuDrpmW3bfvqO,SpATywNh6bZuzm8s1ceuBUnMUAeoAHHw,29,60,25,29,7,0,20,0,141,20.142857142857142,5,0.0,19,25,25,7,41,0,4,20,0,76,65,0
2358,49553,bFQZxr4iRVJaZh2fO7R9dida2Y7glw1T,SpATywNh6bZuzm8s1ceuBUnMUAeoAHHw,31,28,13,37,8,1,7,1,95,13.571428571428571,2,0.0,13,13,32,8,15,1,5,7,1,66,29,0
2359,49604,OXUkoQAJTqhVghuHGRHk1iSAl7CHffoQ,SpATywNh6bZuzm8s1ceuBUnMUAeoAHHw,1,0,0,0,0,0,1,0,1,0.14285714285714285,1,0.0,0,0,0,0,0,0,0,1,0,0,1,1
2360,49610,G43uBjhkBEsnK2sHC51NOglfCGNDkydQ,SpATywNh6bZuzm8s1ceuBUnMUAeoAHHw,31,44,22,20,13,2,14,0,115,16.428571428571427,4,0.0,19,22,19,13,25,2,1,14,0,73,42,1
2361,49611,00SOCgKq1H6iYExhbauCeUrQFSjIMetG,SpATywNh6bZuzm8s1ceuBUnMUAeoAHHw,7,3,2,0,1,0,4,0,10,1.4285714285714286,1,0.0,0,2,0,1,3,0,0,4,0,3,7,0
2362,49620,twg5LqeyEPdLZyjl4T3Yb1man7ZRuOed,SpATywNh6bZuzm8s1ceuBUnMUAeoAHHw,29,74,20,20,9,2,26,2,153,21.857142857142858,8,0.0,21,20,20,9,53,2,0,26,2,70,83,0
2363,49626,LiONc59joHBCh6XOJp7hfXs4mjQEsGy4,SpATywNh6bZuzm8s1ceuBUnMUAeoAHHw,14,15,7,17,3,0,6,0,48,6.857142857142857,2,0.0,5,7,17,3,10,0,0,6,0,32,16,1
2364,49630,Nvud1QIhR4FBjW055r9HSxywupZk5GAR,SpATywNh6bZuzm8s1ceuBUnMUAeoAHHw,5,4,1,0,0,0,1,0,6,0.8571428571428571,1,0.0,0,1,0,0,4,0,0,1,0,1,5,1
2365,49633,lcYZKeyU0m8T0hVxudGSh4HqQiun1Pb4,SpATywNh6bZuzm8s1ceuBUnMUAeoAHHw,13,12,0,4,0,0,4,0,20,2.857142857142857,1,0.0,4,0,4,0,8,0,0,4,0,8,12,1
2366,49650,Y3zuofaAdrsNcwq0tuYyHFkAsBUWoV8a,SpATywNh6bZuzm8s1ceuBUnMUAeoAHHw,24,40,15,30,4,40,28,8,165,23.571428571428573,6,0.0,6,15,26,4,34,40,4,28,8,51,114,0
2367,49654,1bKMONcV6Mq58szdlIajPdFyqaw4BvrA,SpATywNh6bZuzm8s1ceuBUnMUAeoAHHw,7,5,1,0,1,0,3,0,10,1.4285714285714286,2,0.0,0,1,0,1,5,0,0,3,0,2,8,1
2368,49655,H1nbdkC904EOh8jWeVVcV5piaqMVBsli,G8EPVSXsOYB5YQWZGiz1aVq5Pgr2GrQu,119,159,9,391,8,5,35,1,608,86.85714285714286,8,0.0,69,9,332,8,90,5,59,35,1,418,190,0
2369,49656,BoK7CAUaCFqnLgmWLxeOHg8YkXUSeCtc,SpATywNh6bZuzm8s1ceuBUnMUAeoAHHw,12,22,10,8,5,0,4,0,49,7.0,2,0.0,2,10,6,5,20,0,2,4,0,23,26,0
2370,49679,GF5Rflu9cCcL8EFuacKpsHdGIeCCsr9m,SpATywNh6bZuzm8s1ceuBUnMUAeoAHHw,9,13,2,0,1,0,2,0,18,2.5714285714285716,1,0.0,0,2,0,1,13,0,0,2,0,3,15,0
2371,49691,bVLtn3iBc4ibW8xWVzLLM3Hs9gCB0qb7,SpATywNh6bZuzm8s1ceuBUnMUAeoAHHw,1,0,0,0,0,0,1,0,1,0.14285714285714285,1,0.0,0,0,0,0,0,0,0,1,0,0,1,0
2372,49694,cszgTMCcWdEja3BpEwPP5MtLXTMUMJXE,SpATywNh6bZuzm8s1ceuBUnMUAeoAHHw,12,8,5,12,3,0,1,0,29,4.142857142857143,1,0.0,2,5,12,3,6,0,0,1,0,22,7,0
2373,49705,Lce2TIYgGhTbahYzTHHK4e5KxnEianpx,G8EPVSXsOYB5YQWZGiz1aVq5Pgr2GrQu,5,2,1,0,1,0,3,0,7,1.0,2,0.0,0,1,0,1,2,0,0,3,0,2,5,1
2374,49710,LzTBHDjLePaTqbybIwaptvUgkC0hWYCZ,SpATywNh6bZuzm8s1ceuBUnMUAeoAHHw,32,59,29,32,12,6,18,1,157,22.428571428571427,5,0.0,19,29,30,12,40,6,2,18,1,90,67,0
2375,49749,EwhKhClSv2Ps16I3uKtjdSj1YI7rGPIh,SpATywNh6bZuzm8s1ceuBUnMUAeoAHHw,6,11,4,0,0,0,5,0,20,2.857142857142857,4,0.0,0,4,0,0,11,0,0,5,0,4,16,0
2376,49759,k9PbwipCcCjE65bhyUr029mHfI0NwL1R,A3fsA9Zfv1X2fVEQhTw51lKENdNrEqT3,5,2,1,0,1,0,2,0,6,0.8571428571428571,1,0.0,0,1,0,1,2,0,0,2,0,2,4,1
2377,49766,Lce2TIYgGhTbahYzTHHK4e5KxnEianpx,SpATywNh6bZuzm8s1ceuBUnMUAeoAHHw,7,10,4,0,2,0,5,0,21,3.0,3,0.0,0,4,0,2,10,0,0,5,0,6,15,1
2378,49803,3FwKlBDtKGlNAYyQNzHL1qfkuXpNOPVW,A3fsA9Zfv1X2fVEQhTw51lKENdNrEqT3,52,34,26,80,14,5,23,1,183,26.142857142857142,5,0.0,1,26,66,14,33,5,14,23,1,107,76,0
2379,49836,0vUwtohBIGCms6pa9p1s0k5cJHWURa4P,SpATywNh6bZuzm8s1ceuBUnMUAeoAHHw,24,28,0,34,0,4,7,1,74,10.571428571428571,2,0.0,10,0,29,0,18,4,5,7,1,39,35,0
2380,49863,rVswAzjMLz5uIPbCwAU1SliCQFpiAqey,SpATywNh6bZuzm8s1ceuBUnMUAeoAHHw,26,19,12,15,7,0,5,0,58,8.285714285714286,3,0.0,4,12,14,7,15,0,1,5,0,37,21,0
2381,49883,m5Ev3sP4lHJ0ibeJ0LosEcT9fpQ7nqsa,SpATywNh6bZuzm8s1ceuBUnMUAeoAHHw,24,38,2,27,1,0,12,1,81,11.571428571428571,5,0.0,7,2,25,1,31,0,2,12,1,35,46,0
2382,49918,ydYJlUXOoM7xCFpD6o4c1fr3yZVc0YKb,SpATywNh6bZuzm8s1ceuBUnMUAeoAHHw,7,5,4,0,4,0,2,0,15,2.142857142857143,1,0.0,0,4,0,4,5,0,0,2,0,8,7,0
2383,49946,LNdimqsJkOxQDP9dT4IGwewg9YvH7zfV,G8EPVSXsOYB5YQWZGiz1aVq5Pgr2GrQu,73,83,29,102,18,3,9,0,244,34.857142857142854,6,0.0,44,29,72,18,39,3,30,9,0,163,81,0
2384,49949,8kmVwd95niwmuvSIAWJVA4Pqx2tMb8kH,A3fsA9Zfv1X2fVEQhTw51lKENdNrEqT3,21,24,11,0,8,0,4,0,47,6.714285714285714,2,0.0,1,11,0,8,23,0,0,4,0,20,27,1
2385,49954,wUH86mMJYdGCZbgyy3OXf5PGskcw9ISy,RXDvfPUBYFlVdlueBFbLW0mhhAyGEqpt,12,9,1,0,0,6,7,1,24,3.4285714285714284,2,0.0,0,1,0,0,9,6,0,7,1,1,23,1
2386,49967,7tmNprOSiahGzByaY8XiUnCFEIQfWwuf,bWdj2GDclj5ofokWjzoa5jAwMkxCykd6,9,18,8,0,0,1,9,1,37,5.285714285714286,5,0.0,3,8,0,0,15,1,0,9,1,11,26,0
2387,49987,ctfOhdlbQGiOVF89Y090EmsAqQEvSWmz,SpATywNh6bZuzm8s1ceuBUnMUAeoAHHw,25,50,1,34,0,2,18,1,106,15.142857142857142,7,0.0,17,1,29,0,33,2,5,18,1,47,59,0
2388,49990,uG5tavnQGh6e9leaVUY69Y8QlorpIOvo,SpATywNh6bZuzm8s1ceuBUnMUAeoAHHw,7,7,5,0,4,0,3,0,19,2.7142857142857144,1,0.0,0,5,0,4,7,0,0,3,0,9,10,0
2389,49999,46mPOafwambmi8gI5RDfSSG6CkqbcJr8,SpATywNh6bZuzm8s1ceuBUnMUAeoAHHw,15,12,6,21,2,0,5,0,46,6.571428571428571,1,0.0,4,6,17,2,8,0,4,5,0,29,17,0
2390,50039,Ib4hBLihYWrsRQnVhSZKjb9Z8z0NZ4FI,SpATywNh6bZuzm8s1ceuBUnMUAeoAHHw,26,56,1,34,1,13,17,3,125,17.857142857142858,6,0.0,20,1,27,1,36,13,7,17,3,49,76,1
2391,50046,Pot71eWzAwlFIQ6WGEu1vr9IkLdwRub9,SpATywNh6bZuzm8s1ceuBUnMUAeoAHHw,10,12,8,0,4,0,5,0,29,4.142857142857143,2,0.0,0,8,0,4,12,0,0,5,0,12,17,0
2392,50067,nYSFDE8RCbcZhD46fRSvPHUvA1ahfupi,bWdj2GDclj5ofokWjzoa5jAwMkxCykd6,14,13,3,0,3,35,11,1,66,9.428571428571429,3,0.0,0,3,0,3,13,35,0,11,1,6,60,1
2393,50077,HNEdRWA988TWNlPkPkScnQdIH5zRazOo,SpATywNh6bZuzm8s1ceuBUnMUAeoAHHw,30,55,25,22,11,32,9,1,155,22.142857142857142,5,0.0,16,25,21,11,39,32,1,9,1,73,82,0
2394,50083,0lcODMnOtMqKwcOQQi0MUEWuUnIKYPe1,A3fsA9Zfv1X2fVEQhTw51lKENdNrEqT3,59,52,0,160,2,0,14,0,228,32.57142857142857,4,0.0,6,0,140,2,46,0,20,14,0,148,80,1
2395,50092,rPKaOWNl9cYkLvtQk035CJPYGwPAMUtv,SpATywNh6bZuzm8s1ceuBUnMUAeoAHHw,26,48,21,30,5,2,12,1,119,17.0,8,0.0,8,21,27,5,40,2,3,12,1,61,58,0
2396,50099,sDoPeRFIl4sblcl7cpIozq9zgLVwKPZK,SpATywNh6bZuzm8s1ceuBUnMUAeoAHHw,9,6,1,2,0,0,2,0,11,1.5714285714285714,1,0.0,0,1,2,0,6,0,0,2,0,3,8,0
2397,50100,5u5MqcjfkyBtFhEFfICuuKJJdSbQMwNN,SpATywNh6bZuzm8s1ceuBUnMUAeoAHHw,14,27,12,19,5,0,4,0,67,9.571428571428571,1,0.0,11,12,16,5,16,0,3,4,0,44,23,1
2398,50131,6k0P72adqZC6N7qhsceaS6tnkuUG2bub,SpATywNh6bZuzm8s1ceuBUnMUAeoAHHw,11,17,8,18,3,5,10,0,61,8.714285714285714,2,0.0,5,8,15,3,12,5,3,10,0,31,30,0
2399,50143,kmn6CGih1FILZybV8MrApq46D7xH5npO,SpATywNh6bZuzm8s1ceuBUnMUAeoAHHw,23,28,9,1,7,11,20,1,77,11.0,5,0.0,1,9,1,7,27,11,0,20,1,18,59,0
2400,50175,CfX84b3AnOREjEgHXp5gQV78osBjxVJV,RXDvfPUBYFlVdlueBFbLW0mhhAyGEqpt,20,30,0,46,0,2,6,0,84,12.0,4,0.0,9,0,39,0,21,2,7,6,0,48,36,0
2401,50176,CU5xrwbVWBzQZTDEzCWYaPDOJwNXjtq2,A3fsA9Zfv1X2fVEQhTw51lKENdNrEqT3,15,22,3,0,3,7,2,0,37,5.285714285714286,5,0.0,0,3,0,3,22,7,0,2,0,6,31,0
2402,50254,rf43ZHojMqXQ775bmX3nnHgQ62d9XvGK,A3fsA9Zfv1X2fVEQhTw51lKENdNrEqT3,27,34,19,0,9,4,14,1,81,11.571428571428571,5,0.0,0,19,0,9,34,4,0,14,1,28,53,1
2403,50280,8kmVwd95niwmuvSIAWJVA4Pqx2tMb8kH,bWdj2GDclj5ofokWjzoa5jAwMkxCykd6,1,0,0,0,0,0,1,0,1,0.14285714285714285,1,0.0,0,0,0,0,0,0,0,1,0,0,1,1
2404,50315,1D9YAtx0zyELGBYY8fk5ML3KqjBc5hJQ,bWdj2GDclj5ofokWjzoa5jAwMkxCykd6,1,0,0,0,0,0,1,0,1,0.14285714285714285,1,0.0,0,0,0,0,0,0,0,1,0,0,1,1
2405,50319,7eLlsseV075nalpvk2K7Ka9Wx9qMiOW4,SpATywNh6bZuzm8s1ceuBUnMUAeoAHHw,14,21,17,0,10,3,16,3,70,10.0,5,0.0,2,17,0,10,19,3,0,16,3,29,41,0
2406,50324,OIups6Cq9XY2CbwOPuI31XrOSt1FeD7G,SpATywNh6bZuzm8s1ceuBUnMUAeoAHHw,17,23,1,21,1,0,3,0,49,7.0,3,0.0,2,1,17,1,21,0,4,3,0,21,28,0
2407,50348,4clLK6Y8CprtsnOm6pLtpUpbGTeCufAu,SpATywNh6bZuzm8s1ceuBUnMUAeoAHHw,15,22,9,9,5,0,3,0,48,6.857142857142857,1,0.0,9,9,9,5,13,0,0,3,0,32,16,0
2408,50357,wXFfHtwd9smrvhh9NQW7SmEEo1001LDW,bWdj2GDclj5ofokWjzoa5jAwMkxCykd6,15,16,7,48,4,14,5,0,94,13.428571428571429,2,0.0,5,7,44,4,11,14,4,5,0,60,34,0
2409,50374,hAzZgxrFOBoGWYS4hUaB1UgnpeWilVGC,SpATywNh6bZuzm8s1ceuBUnMUAeoAHHw,18,13,7,17,5,0,3,0,45,6.428571428571429,1,0.0,3,7,15,5,10,0,2,3,0,30,15,1
2410,50410,dy5U2Hr6hWmpYZri5b9XY0EijWuyuZjO,A3fsA9Zfv1X2fVEQhTw51lKENdNrEqT3,2,0,0,0,0,0,2,0,2,0.2857142857142857,1,0.0,0,0,0,0,0,0,0,2,0,0,2,1
2411,50414,x29OOChdmJGXK62DnUpwKbwJurqULmnD,A3fsA9Zfv1X2fVEQhTw51lKENdNrEqT3,2,0,0,0,0,0,2,0,2,0.2857142857142857,1,0.0,0,0,0,0,0,0,0,2,0,0,2,1
2412,50416,Xdag5jOmE7uWC3FmBvgPc5F7lO3QNcPW,SpATywNh6bZuzm8s1ceuBUnMUAeoAHHw,32,53,26,36,7,38,15,4,179,25.571428571428573,6,0.0,7,26,32,7,46,38,4,15,4,72,107,0
2413,50453,oeAE2ju0pElvnhTP1w6Sla895xthJTKj,A3fsA9Zfv1X2fVEQhTw51lKENdNrEqT3,1,0,0,0,0,0,1,0,1,0.14285714285714285,1,0.0,0,0,0,0,0,0,0,1,0,0,1,1
2414,50461,Mk1WltctY1vlvTjvcoOEN36uI9KP8emp,SpATywNh6bZuzm8s1ceuBUnMUAeoAHHw,24,93,44,5,15,0,18,0,175,25.0,7,0.0,3,44,4,15,90,0,1,18,0,66,109,0
2415,50500,RwMUq7SCIYrULeTtIYQzgTGTjkIjUHL3,SpATywNh6bZuzm8s1ceuBUnMUAeoAHHw,17,27,2,26,3,3,14,7,82,11.714285714285714,4,0.0,6,2,19,3,21,3,7,14,7,30,52,0
2416,50508,9VvuC4slhZy3KdxqSDDnJl1JHYWZF5th,A3fsA9Zfv1X2fVEQhTw51lKENdNrEqT3,21,30,17,0,7,20,32,2,108,15.428571428571429,5,0.0,2,17,0,7,28,20,0,32,2,26,82,1
2417,50528,faeF4I5p3gAJMB1p4LfYVeCLQZKervYV,A3fsA9Zfv1X2fVEQhTw51lKENdNrEqT3,41,52,3,66,1,0,8,0,130,18.571428571428573,6,0.0,2,3,59,1,50,0,7,8,0,65,65,1
2418,50546,8rXJHeqrLpho5nIQgbDcpBTvBrVnGged,A3fsA9Zfv1X2fVEQhTw51lKENdNrEqT3,31,12,6,54,3,0,25,0,100,14.285714285714286,4,0.0,1,6,50,3,11,0,4,25,0,60,40,1
2419,50573,8ksQz9dz4s7ijHzYWnxMOGz2bplP7OAs,SpATywNh6bZuzm8s1ceuBUnMUAeoAHHw,10,19,2,19,0,0,2,0,42,6.0,2,0.0,10,2,16,0,9,0,3,2,0,28,14,1
2420,50583,RDYqKiZt9A6fUXvjmZNUfSbfEZdDLqXa,A3fsA9Zfv1X2fVEQhTw51lKENdNrEqT3,8,3,2,0,2,0,3,0,10,1.4285714285714286,1,0.0,0,2,0,2,3,0,0,3,0,4,6,1
2421,50595,y1ePxH9bhUBdav1d6VZPfHfp0HugcSgX,A3fsA9Zfv1X2fVEQhTw51lKENdNrEqT3,7,3,2,0,2,0,2,0,9,1.2857142857142858,1,0.0,0,2,0,2,3,0,0,2,0,4,5,1
2422,50611,RgxmGDfKcBuOKimrAda6q6r1m3kTwJWg,A3fsA9Zfv1X2fVEQhTw51lKENdNrEqT3,5,2,1,0,1,0,2,0,6,0.8571428571428571,2,0.0,0,1,0,1,2,0,0,2,0,2,4,1
2423,50660,6jPw8ZwEXjLpnrxZT6HkwOQ20NkEyvU7,SpATywNh6bZuzm8s1ceuBUnMUAeoAHHw,31,73,11,34,9,360,37,1,525,75.0,9,0.0,19,11,29,9,54,360,5,37,1,68,457,0
2424,50679,tqvOTiQbipkIXQL7CIR5dckxV83rng9S,G8EPVSXsOYB5YQWZGiz1aVq5Pgr2GrQu,6,11,6,0,4,6,7,0,34,4.857142857142857,3,0.0,0,6,0,4,11,6,0,7,0,10,24,0
2425,50707,Aa2R9ra7UkMT71HsVEpaQpVn5z60q5tc,G8EPVSXsOYB5YQWZGiz1aVq5Pgr2GrQu,18,14,9,0,5,8,12,1,49,7.0,1,0.0,0,9,0,5,14,8,0,12,1,14,35,1
2426,50723,85CdJb1zpoAUDtR6sIsTNXjrVvfGwx1A,SpATywNh6bZuzm8s1ceuBUnMUAeoAHHw,28,70,26,20,7,16,12,0,151,21.571428571428573,4,0.0,31,26,16,7,39,16,4,12,0,80,71,0
2427,50754,FJxbzfYvIetXhjzEILF0NWt1RCss96LW,A3fsA9Zfv1X2fVEQhTw51lKENdNrEqT3,32,31,21,0,19,0,14,2,87,12.428571428571429,5,0.0,0,21,0,19,31,0,0,14,2,40,47,0
2428,50782,spcUWaGtojfez6ZdF6aqlTnU3zU2dqpy,A3fsA9Zfv1X2fVEQhTw51lKENdNrEqT3,70,81,39,122,23,10,30,2,307,43.857142857142854,3,0.0,5,39,102,23,76,10,20,30,2,169,138,0
2429,52454,quFRN0nuO6SCdHOgmUhTlayoumtzVI29,7GRhBDsirIGkRZBtSMEzNTyDr2JQm4xx,50,65,3,125,16,0,2,0,211,30.142857142857142,3,0.0,37,3,109,16,28,0,16,2,0,165,46,1
2430,52537,Jm6sJTkF2CzUeH5fDnA3ZYS6v322ABBN,7GRhBDsirIGkRZBtSMEzNTyDr2JQm4xx,5,2,1,0,1,0,2,0,6,0.8571428571428571,1,0.0,0,1,0,1,2,0,0,2,0,2,4,1
2431,52546,dNx7yBBYuWpRM4BeMNLD1yOnUwcueGfB,7GRhBDsirIGkRZBtSMEzNTyDr2JQm4xx,8,12,7,4,3,0,4,0,30,4.285714285714286,2,0.0,1,7,2,3,11,0,2,4,0,13,17,1
2432,52669,Q8hb0j5K90GRKBQLUtk9egje9fPULAJD,7GRhBDsirIGkRZBtSMEzNTyDr2JQm4xx,2,0,0,0,0,0,3,0,3,0.42857142857142855,2,0.0,0,0,0,0,0,0,0,3,0,0,3,0
2433,52789,OO7beVHPObBfPwHA9jIrdvSr48hMom1m,7GRhBDsirIGkRZBtSMEzNTyDr2JQm4xx,31,56,21,56,21,3,2,0,159,22.714285714285715,6,0.0,25,21,48,21,31,3,8,2,0,115,44,0
2434,52835,ESHOHiiFNOO5h5pqzByY0J6PmNipWo8U,7GRhBDsirIGkRZBtSMEzNTyDr2JQm4xx,1,0,0,0,0,0,1,0,1,0.14285714285714285,1,0.0,0,0,0,0,0,0,0,1,0,0,1,1
2435,52935,VQQV4EfxxGcWfIRpLvaTXUUXZHA1kehZ,7GRhBDsirIGkRZBtSMEzNTyDr2JQm4xx,1,0,0,0,0,0,1,0,1,0.14285714285714285,1,0.0,0,0,0,0,0,0,0,1,0,0,1,1
2436,53000,CGPCZptxVu9ER3GGm9DUJ9SpSOShg1OZ,7GRhBDsirIGkRZBtSMEzNTyDr2JQm4xx,37,53,14,60,12,3,1,0,143,20.428571428571427,1,0.0,25,14,52,12,28,3,8,1,0,103,40,1
2437,53020,Z4kedXjIF6f3uubwtldCvvLQcT4vIEro,7GRhBDsirIGkRZBtSMEzNTyDr2JQm4xx,5,8,2,0,0,0,2,0,12,1.7142857142857142,2,0.0,3,2,0,0,5,0,0,2,0,5,7,1
2438,53046,t8qBiDTvOvYmrxcVIErRuEOf38tywm6t,bWdj2GDclj5ofokWjzoa5jAwMkxCykd6,20,57,34,98,8,24,22,0,243,34.714285714285715,5,0.0,9,34,92,8,48,24,6,22,0,143,100,1
2439,53048,8gk5kBMYT20pCB4wpUHe3xKwSYDbtvzS,SpATywNh6bZuzm8s1ceuBUnMUAeoAHHw,23,32,15,15,5,21,11,2,101,14.428571428571429,5,0.0,5,15,14,5,27,21,1,11,2,39,62,1
2440,53049,8cVIhj7cvR0q9dzupEColmwPbOHZ624c,SpATywNh6bZuzm8s1ceuBUnMUAeoAHHw,30,35,18,33,10,24,14,3,137,19.571428571428573,4,0.0,8,18,29,10,27,24,4,14,3,65,72,0
2441,53063,LbpzBfhp2Wgcn9ayrU6jOBjfquY2961S,SpATywNh6bZuzm8s1ceuBUnMUAeoAHHw,7,3,2,0,2,0,2,0,9,1.2857142857142858,1,0.0,0,2,0,2,3,0,0,2,0,4,5,1
2442,53070,3Ph0mVs6YY4X7VkfoALrDqpzMeDhFoCj,A3fsA9Zfv1X2fVEQhTw51lKENdNrEqT3,36,49,24,42,12,0,11,0,138,19.714285714285715,5,0.0,0,24,39,12,49,0,3,11,0,75,63,1
2443,53118,5bplw4NcU21nNTIEcExDZZHISObWtI7D,SpATywNh6bZuzm8s1ceuBUnMUAeoAHHw,2,0,0,0,0,0,2,0,2,0.2857142857142857,1,0.0,0,0,0,0,0,0,0,2,0,0,2,1
2444,53119,AwKhkfPOqEnTXG1Cn8Gmf8HHhYnwnTgu,SpATywNh6bZuzm8s1ceuBUnMUAeoAHHw,22,39,13,24,5,36,11,0,128,18.285714285714285,4,0.0,11,13,20,5,28,36,4,11,0,49,79,1
2445,53124,1mZ7vCkgdZSC0cu4gxvMxxm9xwGvwvAR,SpATywNh6bZuzm8s1ceuBUnMUAeoAHHw,12,7,0,8,0,0,4,1,20,2.857142857142857,1,0.0,1,0,7,0,6,0,1,4,1,8,12,1
2446,53139,nNXdLwc4WRmQjF7qTMoDc98hNmIFSp8j,SpATywNh6bZuzm8s1ceuBUnMUAeoAHHw,8,9,5,0,1,0,5,0,20,2.857142857142857,4,0.0,1,5,0,1,8,0,0,5,0,7,13,1
2447,53140,Jf77UYIvUtofHBGpvQMQ0qUfMZBh9rRJ,A3fsA9Zfv1X2fVEQhTw51lKENdNrEqT3,58,43,26,78,16,0,7,1,171,24.428571428571427,4,0.0,6,26,73,16,37,0,5,7,1,121,50,1
2448,53155,PPZEwof9f8rZx0lcTpURHpbkLB2YY5hH,bWdj2GDclj5ofokWjzoa5jAwMkxCykd6,1,0,0,0,0,0,1,0,1,0.14285714285714285,1,0.0,0,0,0,0,0,0,0,1,0,0,1,1
2449,53161,oS1Vf0Ayi2kmK9AxKSgJ38BEbMfbnGmy,SpATywNh6bZuzm8s1ceuBUnMUAeoAHHw,19,33,2,12,1,17,5,1,71,10.142857142857142,3,0.0,14,2,10,1,19,17,2,5,1,27,44,1
2450,53163,MxIyDpIx03wSGr0H52jiRE3GZR3Xt5iM,SpATywNh6bZuzm8s1ceuBUnMUAeoAHHw,29,61,31,44,16,1,8,0,161,23.0,4,0.0,21,31,38,16,40,1,6,8,0,106,55,1
2451,53170,BBcMLJIRqEjAV0Iy0PZLL6aDRdsecvdG,G8EPVSXsOYB5YQWZGiz1aVq5Pgr2GrQu,21,22,1,26,1,0,8,0,58,8.285714285714286,2,0.0,4,1,22,1,18,0,4,8,0,28,30,1
2452,53194,5y4YA2mbDcwuEjNHeStgjLfqN1rsKZgP,SpATywNh6bZuzm8s1ceuBUnMUAeoAHHw,17,68,3,29,1,2,25,1,129,18.428571428571427,7,0.0,33,3,23,1,35,2,6,25,1,60,69,0
2453,53198,TVNQBfVHiiSK1QlXMueUvqhShIHov5rx,A3fsA9Zfv1X2fVEQhTw51lKENdNrEqT3,4,0,0,0,0,0,8,0,8,1.1428571428571428,1,0.0,0,0,0,0,0,0,0,8,0,0,8,1
2454,53209,GOcyurvQpr52NaTeXKp3vF6yg377GcU5,SpATywNh6bZuzm8s1ceuBUnMUAeoAHHw,17,18,5,27,1,22,24,3,100,14.285714285714286,7,0.0,5,5,27,1,13,22,0,24,3,38,62,0
2455,53219,igvNYxEcQQQ9zsQs0eESBN7rFelE1Oyt,SpATywNh6bZuzm8s1ceuBUnMUAeoAHHw,6,4,1,0,1,0,2,0,8,1.1428571428571428,1,0.0,1,1,0,1,3,0,0,2,0,3,5,1
2456,53223,xv3zPM1UCM9DtQrJ8sbmGYaRlj8FtrlB,SpATywNh6bZuzm8s1ceuBUnMUAeoAHHw,25,45,3,16,1,8,12,1,86,12.285714285714286,4,0.0,14,3,16,1,31,8,0,12,1,34,52,1
2457,53247,tHPSGx00vsFzhzr0zwBlWWarqJT4wPHF,A3fsA9Zfv1X2fVEQhTw51lKENdNrEqT3,38,14,11,56,8,0,5,0,94,13.428571428571429,3,0.0,1,11,51,8,13,0,5,5,0,71,23,1
2458,53255,mOyYFNs2t1Eh1aA09x8EHu6wqp81MSvv,bWdj2GDclj5ofokWjzoa5jAwMkxCykd6,3,2,1,0,0,0,1,0,4,0.5714285714285714,1,0.0,0,1,0,0,2,0,0,1,0,1,3,1
2459,53275,tixHTdVBfyAX1gHufSYbGyCBT9OKYh0u,SpATywNh6bZuzm8s1ceuBUnMUAeoAHHw,10,8,4,0,3,0,2,0,17,2.4285714285714284,1,0.0,3,4,0,3,5,0,0,2,0,10,7,1
2460,53280,N7f90nGBEKO2Wy697fsY7gOd7p4hRhpZ,SpATywNh6bZuzm8s1ceuBUnMUAeoAHHw,8,4,2,0,1,7,4,1,19,2.7142857142857144,1,0.0,0,2,0,1,4,7,0,4,1,3,16,1
2461,53281,1R6B3xPo1MU8MeIr72077lkCH6LzghZG,SpATywNh6bZuzm8s1ceuBUnMUAeoAHHw,18,15,9,16,5,0,6,0,51,7.285714285714286,1,0.0,2,9,13,5,13,0,3,6,0,29,22,1
2462,53295,yo1PAd1hBwimD9OOoxvyi6mwQC5bfK9g,bWdj2GDclj5ofokWjzoa5jAwMkxCykd6,6,11,6,0,2,0,7,0,26,3.7142857142857144,3,0.0,0,6,0,2,11,0,0,7,0,8,18,1
2463,53312,uQjl8NGtIQkRfoe9edBiMgtYYmdkzVXR,SpATywNh6bZuzm8s1ceuBUnMUAeoAHHw,1,0,0,0,0,0,1,0,1,0.14285714285714285,1,0.0,0,0,0,0,0,0,0,1,0,0,1,0
2464,53336,5naaONANTJUheGV6edn51qgkV97IPNdM,SpATywNh6bZuzm8s1ceuBUnMUAeoAHHw,1,0,0,0,0,0,1,0,1,0.14285714285714285,1,0.0,0,0,0,0,0,0,0,1,0,0,1,1
2465,53346,oNcOLZOgRKuqVCWgf9VQFQ2ph82THXaV,RXDvfPUBYFlVdlueBFbLW0mhhAyGEqpt,1,0,0,0,0,0,1,0,1,0.14285714285714285,1,0.0,0,0,0,0,0,0,0,1,0,0,1,0
2466,53360,boitIxZvCZ9przAKAQqxtWTvavMJkqzn,SpATywNh6bZuzm8s1ceuBUnMUAeoAHHw,29,28,17,16,7,2,8,0,78,11.142857142857142,6,0.0,5,17,16,7,23,2,0,8,0,45,33,0
2467,53368,mf00J2vS5aNSPGjL8Bq3W8G35vnnAtUS,SpATywNh6bZuzm8s1ceuBUnMUAeoAHHw,28,40,8,32,4,2,16,2,104,14.857142857142858,4,0.0,14,8,28,4,26,2,4,16,2,54,50,1
2468,53374,rSB9ieAhUU6VlZTakIYbk4lUm5NlM8Bf,SpATywNh6bZuzm8s1ceuBUnMUAeoAHHw,2,0,0,0,0,0,2,0,2,0.2857142857142857,1,0.0,0,0,0,0,0,0,0,2,0,0,2,1
2469,53381,hJ48EYDAUcnIubJFw4NRxQxCK6ApJIxf,SpATywNh6bZuzm8s1ceuBUnMUAeoAHHw,15,20,0,22,0,6,9,0,57,8.142857142857142,3,0.0,8,0,22,0,12,6,0,9,0,30,27,1
2470,53396,0qQG1Nylz3pu9h7MazaVuzCwo13YkYej,SpATywNh6bZuzm8s1ceuBUnMUAeoAHHw,10,12,5,0,3,0,3,0,23,3.2857142857142856,2,0.0,0,5,0,3,12,0,0,3,0,8,15,1
2471,53418,0uULbxMYxykuellS4DES6XbGTfaCngOW,A3fsA9Zfv1X2fVEQhTw51lKENdNrEqT3,8,10,0,0,0,0,4,0,14,2.0,1,0.0,0,0,0,0,10,0,0,4,0,0,14,1
2472,53421,oyKGOSyMOi0AM9nt7p8h8Y1cF1HEnPtq,SpATywNh6bZuzm8s1ceuBUnMUAeoAHHw,4,2,1,0,1,0,2,0,6,0.8571428571428571,2,0.0,0,1,0,1,2,0,0,2,0,2,4,1
2473,53423,26YZUhjQbxCihl3CNnlwudlVL638MFZI,SpATywNh6bZuzm8s1ceuBUnMUAeoAHHw,7,9,0,0,0,1,8,0,18,2.5714285714285716,1,0.0,0,0,0,0,9,1,0,8,0,0,18,1
2474,53453,A4vEkOAwhpQEgLFKtjOc7tdIxawwQcIi,SpATywNh6bZuzm8s1ceuBUnMUAeoAHHw,29,65,34,20,17,3,19,0,158,22.571428571428573,6,0.0,15,34,16,17,50,3,4,19,0,82,76,1
2475,53456,WFLWEfQrQsuFMQB4h1DfinKxHOxaJgRw,RXDvfPUBYFlVdlueBFbLW0mhhAyGEqpt,2,0,0,0,0,0,2,0,2,0.2857142857142857,2,0.0,0,0,0,0,0,0,0,2,0,0,2,1
2476,53462,9rLNySnV0yxkzZA7V8enLIbzXZCrF6IJ,RXDvfPUBYFlVdlueBFbLW0mhhAyGEqpt,63,79,47,84,25,9,24,3,271,38.714285714285715,7,0.0,9,47,80,25,70,9,4,24,3,161,110,0
2477,53483,t20VhGjJQwmwXV8X5LeBQDucO3YuiMru,SpATywNh6bZuzm8s1ceuBUnMUAeoAHHw,21,33,4,41,1,56,16,3,154,22.0,5,0.0,10,4,34,1,23,56,7,16,3,49,105,0
2478,53484,WyWFczdn2Y2i2D9wUJkB93D49zn2CheK,SpATywNh6bZuzm8s1ceuBUnMUAeoAHHw,1,0,0,0,0,0,5,0,5,0.7142857142857143,4,0.0,0,0,0,0,0,0,0,5,0,0,5,0
2479,53501,5vi4PfMqn3pILscFmPde7WIp5OpFzjzt,SpATywNh6bZuzm8s1ceuBUnMUAeoAHHw,4,3,1,0,1,0,2,0,7,1.0,1,0.0,0,1,0,1,3,0,0,2,0,2,5,0
2480,53505,nG7nzscbe2QtoUFUlgTpRDhBo6dlFgWT,SpATywNh6bZuzm8s1ceuBUnMUAeoAHHw,1,0,0,0,0,0,1,0,1,0.14285714285714285,1,0.0,0,0,0,0,0,0,0,1,0,0,1,1
2481,53507,sqZsZQq9LcjzbfCPmehLyMMrK3ClcYAT,A3fsA9Zfv1X2fVEQhTw51lKENdNrEqT3,7,3,2,0,2,0,4,0,11,1.5714285714285714,2,0.0,0,2,0,2,3,0,0,4,0,4,7,1
2482,53526,4XbWtzoFwF5LOOV7fIRFhXr7S6ATs5RB,SpATywNh6bZuzm8s1ceuBUnMUAeoAHHw,9,6,1,0,1,9,4,1,22,3.142857142857143,1,0.0,0,1,0,1,6,9,0,4,1,2,20,1
2483,53534,ssMidTFfcaAGjWiJzMk3J73LCswwO4yV,A3fsA9Zfv1X2fVEQhTw51lKENdNrEqT3,7,0,0,0,0,2,6,1,9,1.2857142857142858,1,0.0,0,0,0,0,0,2,0,6,1,0,9,1
2484,53565,0HsU2yFVHR5yKm9Hke3oyrM0twIu2eg3,bWdj2GDclj5ofokWjzoa5jAwMkxCykd6,8,12,1,58,2,0,6,0,79,11.285714285714286,2,0.0,8,1,57,2,4,0,1,6,0,68,11,1
2485,53587,VDscv2ylkQ5hVjxSl7FzkFmJDmBcIaMr,A3fsA9Zfv1X2fVEQhTw51lKENdNrEqT3,30,14,7,76,4,0,4,0,105,15.0,2,0.0,5,7,72,4,9,0,4,4,0,88,17,1
2486,53596,fHnWrc914HQUCHZRKa2nPteHkVOkvlJI,SpATywNh6bZuzm8s1ceuBUnMUAeoAHHw,23,44,4,30,1,8,18,1,106,15.142857142857142,5,0.0,16,4,27,1,28,8,3,18,1,48,58,0
2487,53630,w7s7CbDlE2P2RGY2w8kEYH9keSavEsec,SpATywNh6bZuzm8s1ceuBUnMUAeoAHHw,7,5,2,0,1,0,6,0,14,2.0,1,0.0,0,2,0,1,5,0,0,6,0,3,11,1
2488,53649,dtP0jNvfsrthiSc4EbxmbNOv0Ufz6AhB,RXDvfPUBYFlVdlueBFbLW0mhhAyGEqpt,7,4,3,0,3,0,4,0,14,2.0,2,0.0,0,3,0,3,4,0,0,4,0,6,8,1
2489,53666,uxWS9amhXxmjOvqXmZExJSg0LcMFBAvq,RXDvfPUBYFlVdlueBFbLW0mhhAyGEqpt,20,20,16,0,9,1,39,3,88,12.571428571428571,5,0.0,2,16,0,9,18,1,0,39,3,27,61,1
2490,53669,j79CPp6e09l3A1MeqgSV5ajYlxbk9Ixy,A3fsA9Zfv1X2fVEQhTw51lKENdNrEqT3,33,18,5,58,5,0,5,0,91,13.0,2,0.0,2,5,53,5,16,0,5,5,0,65,26,1
2491,53694,dXgGUXhGtPdqA3aOz733dBgKiaq7cvX6,SpATywNh6bZuzm8s1ceuBUnMUAeoAHHw,13,21,2,0,2,0,15,0,40,5.714285714285714,4,0.0,0,2,0,2,21,0,0,15,0,4,36,1
2492,53718,Ar22lkOE5FvesxoMKtYhm8Cbv4MUQUYF,SpATywNh6bZuzm8s1ceuBUnMUAeoAHHw,7,1,1,0,1,0,5,0,8,1.1428571428571428,2,0.0,0,1,0,1,1,0,0,5,0,2,6,1
2493,53721,lSVRjk6dkgEmIe9I21hvsRF98Lf2IKdM,SpATywNh6bZuzm8s1ceuBUnMUAeoAHHw,25,40,19,20,9,3,9,0,100,14.285714285714286,2,0.0,8,19,20,9,32,3,0,9,0,56,44,1
2494,53740,oUC5J8T9mINNExS4753FcPxbWA9dWDjN,SpATywNh6bZuzm8s1ceuBUnMUAeoAHHw,17,17,10,5,4,1,7,1,45,6.428571428571429,1,0.0,3,10,4,4,14,1,1,7,1,21,24,1
2495,53741,CV8kQrzk7Ma4h2GmuCAW4YCocO4w4WSf,bWdj2GDclj5ofokWjzoa5jAwMkxCykd6,4,4,1,0,2,0,2,0,9,1.2857142857142858,2,0.0,2,1,0,2,2,0,0,2,0,5,4,1
2496,53755,FOAFoPTPHDIp8ur1T09KgTEj3KeABYBf,SpATywNh6bZuzm8s1ceuBUnMUAeoAHHw,2,0,0,0,0,0,2,0,2,0.2857142857142857,1,0.0,0,0,0,0,0,0,0,2,0,0,2,1
2497,53760,KGXFn1n0h5LwrdyZxyMenRRVTJ2x6Rjd,RXDvfPUBYFlVdlueBFbLW0mhhAyGEqpt,4,3,2,0,2,0,1,0,8,1.1428571428571428,1,0.0,0,2,0,2,3,0,0,1,0,4,4,1
2498,53766,KIPXc8MOqmnlmMqnIzIeaBqliIw9pS44,SpATywNh6bZuzm8s1ceuBUnMUAeoAHHw,30,41,21,16,10,8,17,4,117,16.714285714285715,3,0.0,10,21,16,10,31,8,0,17,4,57,60,1
2499,53786,L5GEhRbHdd9onnNJ8EJkvOQW3HytY3G8,SpATywNh6bZuzm8s1ceuBUnMUAeoAHHw,13,10,5,0,5,0,5,0,25,3.5714285714285716,2,0.0,2,5,0,5,8,0,0,5,0,12,13,1
2500,53792,p62iTg6ZpvzODJCBLH2d7SVfdoSWuy8j,RXDvfPUBYFlVdlueBFbLW0mhhAyGEqpt,71,122,80,111,37,1,13,2,366,52.285714285714285,5,0.0,23,80,105,37,99,1,6,13,2,245,121,0
2501,53796,10a3aPUuiEikOQBzdtiLA8dXlMBNaCqq,A3fsA9Zfv1X2fVEQhTw51lKENdNrEqT3,1,0,0,0,0,0,1,0,1,0.14285714285714285,1,0.0,0,0,0,0,0,0,0,1,0,0,1,1
2502,53805,sytW49I21SJ70ElOkXGU5SHeeHl1E3fL,A3fsA9Zfv1X2fVEQhTw51lKENdNrEqT3,24,24,17,0,11,0,13,0,65,9.285714285714286,6,0.0,2,17,0,11,22,0,0,13,0,30,35,1
2503,53818,mBrhN2Nrf27UQ54otia4OdwjR0gGrIS1,SpATywNh6bZuzm8s1ceuBUnMUAeoAHHw,8,6,1,0,0,1,8,0,16,2.2857142857142856,1,0.0,0,1,0,0,6,1,0,8,0,1,15,1
2504,53835,8rXJHeqrLpho5nIQgbDcpBTvBrVnGged,bWdj2GDclj5ofokWjzoa5jAwMkxCykd6,14,27,5,38,1,10,10,1,92,13.142857142857142,2,0.0,6,5,34,1,21,10,4,10,1,46,46,1
2505,53856,4jDSfVr3FM2ZrR7U3LMbeRYrZXGv5CAV,SpATywNh6bZuzm8s1ceuBUnMUAeoAHHw,17,29,9,20,4,1,3,1,67,9.571428571428571,2,0.0,17,9,17,4,12,1,3,3,1,47,20,1
2506,53865,jKfEyfk0HFbzE5vAszOX5qLRWBhzLYt2,A3fsA9Zfv1X2fVEQhTw51lKENdNrEqT3,1,0,0,0,0,0,2,0,2,0.2857142857142857,2,0.0,0,0,0,0,0,0,0,2,0,0,2,1
2507,53872,jKfEyfk0HFbzE5vAszOX5qLRWBhzLYt2,bWdj2GDclj5ofokWjzoa5jAwMkxCykd6,1,0,0,0,0,0,1,0,1,0.14285714285714285,1,0.0,0,0,0,0,0,0,0,1,0,0,1,1
2508,53893,8C3Ev7v016DKmnVXW2AvnqT9jJXWxsa8,SpATywNh6bZuzm8s1ceuBUnMUAeoAHHw,7,3,2,0,2,0,2,0,9,1.2857142857142858,1,0.0,0,2,0,2,3,0,0,2,0,4,5,1
2509,53903,4XxIEPI2UOvU2fn3nQAeJ4R1qsxwKTmu,SpATywNh6bZuzm8s1ceuBUnMUAeoAHHw,21,29,15,0,11,0,11,0,66,9.428571428571429,1,0.0,4,15,0,11,25,0,0,11,0,30,36,0
2510,53916,BsBj37bM37sYKQjSXV07xFL8gbIptVn8,bWdj2GDclj5ofokWjzoa5jAwMkxCykd6,2,0,0,0,0,0,2,0,2,0.2857142857142857,1,0.0,0,0,0,0,0,0,0,2,0,0,2,1
2511,53920,Oiq6C4nL7ZnZProqskptBCeXrYJ4FTge,A3fsA9Zfv1X2fVEQhTw51lKENdNrEqT3,1,0,0,0,0,0,2,0,2,0.2857142857142857,1,0.0,0,0,0,0,0,0,0,2,0,0,2,1
2512,53930,IARcq51sP2SqR9JLBLqyXGL88k6Z1aOe,SpATywNh6bZuzm8s1ceuBUnMUAeoAHHw,1,0,0,0,0,0,1,0,1,0.14285714285714285,1,0.0,0,0,0,0,0,0,0,1,0,0,1,1
2513,53970,mopAEhc4oYbNGgdB14MDU4Z5IjNO4SXn,SpATywNh6bZuzm8s1ceuBUnMUAeoAHHw,22,25,2,34,0,0,5,0,66,9.428571428571429,1,0.0,6,2,28,0,19,0,6,5,0,36,30,1
2514,53984,QYVRHTpooyTkzSbIywJ7ri5o4t73Xwty,SpATywNh6bZuzm8s1ceuBUnMUAeoAHHw,7,15,5,0,3,0,3,0,26,3.7142857142857144,1,0.0,0,5,0,3,15,0,0,3,0,8,18,1
2515,53986,z9sj5HIJml1DMOMfRKKBQ7IvS2IoE424,bWdj2GDclj5ofokWjzoa5jAwMkxCykd6,21,102,51,24,11,33,34,0,255,36.42857142857143,5,0.0,9,51,22,11,93,33,2,34,0,93,162,1
2516,53989,1kEIJj7vLRBM7EdRHp9VWjLFIqNPjA0F,SpATywNh6bZuzm8s1ceuBUnMUAeoAHHw,5,2,1,0,1,0,3,0,7,1.0,1,0.0,0,1,0,1,2,0,0,3,0,2,5,1
2517,54035,6UfIu5SKHPYfwZxBxJpGSqhLHKhbdsl0,SpATywNh6bZuzm8s1ceuBUnMUAeoAHHw,14,13,11,2,7,0,5,0,38,5.428571428571429,2,0.0,0,11,2,7,13,0,0,5,0,20,18,0
2518,54045,A9hKsxxgL4q5b7FGmUZTmhhYJ9IUDrBm,SpATywNh6bZuzm8s1ceuBUnMUAeoAHHw,17,42,21,0,14,2,8,0,87,12.428571428571429,4,0.0,6,21,0,14,36,2,0,8,0,41,46,0
2519,54054,W3FcEvxr2cIwq2NIdATNIqtjoGLetLLn,bWdj2GDclj5ofokWjzoa5jAwMkxCykd6,10,13,2,20,1,8,7,2,53,7.571428571428571,2,0.0,1,2,18,1,12,8,2,7,2,22,31,1
2520,54072,Y9YzwTET1OUYhHsLt97DLY5Tl5O9atqy,SpATywNh6bZuzm8s1ceuBUnMUAeoAHHw,12,21,10,0,10,0,1,0,42,6.0,2,0.0,0,10,0,10,21,0,0,1,0,20,22,1
2521,54086,uIIavYxNuEJ6NG2Ex383dBZvdILceLZJ,SpATywNh6bZuzm8s1ceuBUnMUAeoAHHw,18,34,14,17,7,0,8,1,81,11.571428571428571,3,0.0,13,14,16,7,21,0,1,8,1,50,31,0
2522,54090,IwRf58Af79ziuqQX85M6J2Lo8D4N0Ygn,A3fsA9Zfv1X2fVEQhTw51lKENdNrEqT3,8,5,3,0,3,0,2,0,13,1.8571428571428572,1,0.0,0,3,0,3,5,0,0,2,0,6,7,1
2523,54093,1rAHmNrxrqnzHEQFMlydmQ968LsZW0oG,RXDvfPUBYFlVdlueBFbLW0mhhAyGEqpt,15,8,5,10,2,7,7,3,42,6.0,2,0.0,1,5,9,2,7,7,1,7,3,17,25,1
2524,54095,mANHObgCOxed01sMVUE2CCh0Yy4sWlCz,bWdj2GDclj5ofokWjzoa5jAwMkxCykd6,4,2,0,0,0,0,3,0,5,0.7142857142857143,1,0.0,0,0,0,0,2,0,0,3,0,0,5,1
2525,54100,ULxriJOFgcYW8OKrxzYPWeTN4MYJZpRj,SpATywNh6bZuzm8s1ceuBUnMUAeoAHHw,16,51,5,6,4,0,12,0,78,11.142857142857142,7,0.0,3,5,6,4,48,0,0,12,0,18,60,1
2526,54105,On4dVQn2MRHkwqRorWIyGST4bzaBJgjb,SpATywNh6bZuzm8s1ceuBUnMUAeoAHHw,7,7,4,0,3,0,2,0,16,2.2857142857142856,2,0.0,0,4,0,3,7,0,0,2,0,7,9,1
2527,54107,puAOKUG4MdJZvu6TGCieg6bgD5WGJ0qf,bWdj2GDclj5ofokWjzoa5jAwMkxCykd6,16,15,9,68,0,40,15,3,150,21.428571428571427,2,0.0,3,9,65,0,12,40,3,15,3,77,73,1
2528,54112,GASbwPXxwryodKV3AqYKdU5jEaEhIE7r,SpATywNh6bZuzm8s1ceuBUnMUAeoAHHw,20,23,3,8,1,0,17,3,55,7.857142857142857,4,0.0,3,3,7,1,20,0,1,17,3,14,41,0
2529,54120,S9bleRJbl0xJFa4yPXuTgULWJ67nbMqi,SpATywNh6bZuzm8s1ceuBUnMUAeoAHHw,26,42,26,20,15,0,9,0,112,16.0,7,0.0,5,26,18,15,37,0,2,9,0,64,48,0
2530,54127,puAOKUG4MdJZvu6TGCieg6bgD5WGJ0qf,A3fsA9Zfv1X2fVEQhTw51lKENdNrEqT3,1,0,0,0,0,0,1,0,1,0.14285714285714285,1,0.0,0,0,0,0,0,0,0,1,0,0,1,1
2531,54142,oEOiBLMr97GK8O9ympHG9NMLQODJ0Xam,A3fsA9Zfv1X2fVEQhTw51lKENdNrEqT3,1,0,0,0,0,0,1,0,1,0.14285714285714285,1,0.0,0,0,0,0,0,0,0,1,0,0,1,1
2532,54151,6f80AuCxgLhEz4q3r0Z7Tne4jeBhxVpZ,SpATywNh6bZuzm8s1ceuBUnMUAeoAHHw,28,95,30,41,13,23,41,6,249,35.57142857142857,3,0.0,24,30,35,13,71,23,6,41,6,102,147,0
2533,54156,QYaJtD7z5M6YcGNpdHV2JTsxqV4tXm9a,SpATywNh6bZuzm8s1ceuBUnMUAeoAHHw,24,39,23,19,0,19,10,0,110,15.714285714285714,6,0.0,11,23,18,0,28,19,1,10,0,52,58,0
2534,54174,qsAhBackOo3cL2WuRLzyR4ErX4nTraFk,bWdj2GDclj5ofokWjzoa5jAwMkxCykd6,8,9,2,2,5,0,2,0,20,2.857142857142857,1,0.0,6,2,2,5,3,0,0,2,0,15,5,1
2535,54189,cN6OZq4ak5IqzN7Lw32XLOS12DhlWO8Q,A3fsA9Zfv1X2fVEQhTw51lKENdNrEqT3,98,103,55,242,24,25,15,1,465,66.42857142857143,4,0.0,10,55,189,24,93,25,53,15,1,278,187,0
2536,54190,U6zvwzZFC3hs6bhxG6asVA50snx1s2RU,SpATywNh6bZuzm8s1ceuBUnMUAeoAHHw,4,2,1,0,1,0,1,0,5,0.7142857142857143,1,0.0,0,1,0,1,2,0,0,1,0,2,3,1
2537,54191,Io3VzTK6sP3a0ZVRKkRhFNz8A2ULjris,G8EPVSXsOYB5YQWZGiz1aVq5Pgr2GrQu,2,0,0,0,0,0,3,0,3,0.42857142857142855,1,0.0,0,0,0,0,0,0,0,3,0,0,3,1
2538,54193,smg4SHkT0uQ59GP6Camalxkw6c32vtzM,SpATywNh6bZuzm8s1ceuBUnMUAeoAHHw,25,46,8,20,6,1,14,0,95,13.571428571428571,5,0.0,7,8,16,6,39,1,4,14,0,37,58,0
2539,54196,4mLn5YrkZbnxPXEuAYTSn9TKZyVmWQjo,SpATywNh6bZuzm8s1ceuBUnMUAeoAHHw,12,28,1,0,1,0,5,0,35,5.0,4,0.0,0,1,0,1,28,0,0,5,0,2,33,0
2540,54209,ke8J6J68PMmqZ8rK8FCDUgXlLZQpLLZW,bWdj2GDclj5ofokWjzoa5jAwMkxCykd6,20,43,14,100,9,7,12,1,186,26.571428571428573,7,0.0,7,14,93,9,36,7,7,12,1,123,63,1
2541,54215,ZbaPpC6DlaDgy5Ic6oj7YX9qkm2j3Pmr,A3fsA9Zfv1X2fVEQhTw51lKENdNrEqT3,1,0,0,0,0,0,1,0,1,0.14285714285714285,1,0.0,0,0,0,0,0,0,0,1,0,0,1,1
2542,54230,RJ1FVW8gXQIpK321uzh2Sh69ojlsqnvg,A3fsA9Zfv1X2fVEQhTw51lKENdNrEqT3,16,11,8,0,6,2,13,2,42,6.0,2,0.0,0,8,0,6,11,2,0,13,2,14,28,0
2543,54245,DauUa5EOQjYVJ9IOEZ6MNnCJpVrdodep,SpATywNh6bZuzm8s1ceuBUnMUAeoAHHw,5,2,1,0,1,0,2,0,6,0.8571428571428571,1,0.0,0,1,0,1,2,0,0,2,0,2,4,1
2544,54248,4rM5k15XYnxmy5xR9L5EVWP9CatXJ8wI,SpATywNh6bZuzm8s1ceuBUnMUAeoAHHw,4,2,0,0,0,0,3,0,5,0.7142857142857143,1,0.0,0,0,0,0,2,0,0,3,0,0,5,1
2545,54256,wtEiMTsSGyqVYmzAUWtaJeXU5b3t5li0,SpATywNh6bZuzm8s1ceuBUnMUAeoAHHw,4,2,1,0,1,0,3,0,7,1.0,2,0.0,0,1,0,1,2,0,0,3,0,2,5,0
2546,54263,haOx3D2RVOqd6ga1rw8OsvbEHoupYgpz,SpATywNh6bZuzm8s1ceuBUnMUAeoAHHw,14,9,4,12,3,3,3,0,34,4.857142857142857,1,0.0,2,4,9,3,7,3,3,3,0,18,16,1
2547,54267,o4j0NDzLh6XqpDKcvRg8Lx9N4HUYeTuP,A3fsA9Zfv1X2fVEQhTw51lKENdNrEqT3,1,0,0,0,0,0,1,0,1,0.14285714285714285,1,0.0,0,0,0,0,0,0,0,1,0,0,1,1
2548,54269,7EEqnuI1QuwYA0sZvgr9zLDxbRgASZvg,A3fsA9Zfv1X2fVEQhTw51lKENdNrEqT3,1,0,0,0,0,0,1,0,1,0.14285714285714285,1,0.0,0,0,0,0,0,0,0,1,0,0,1,1
2549,54286,NCyQ1ytdiWvqyE3iylDLFJzABxi8HOfD,SpATywNh6bZuzm8s1ceuBUnMUAeoAHHw,3,0,0,0,0,0,5,0,5,0.7142857142857143,1,0.0,0,0,0,0,0,0,0,5,0,0,5,1
2550,54307,Io3VzTK6sP3a0ZVRKkRhFNz8A2ULjris,A3fsA9Zfv1X2fVEQhTw51lKENdNrEqT3,2,0,0,0,0,0,2,0,2,0.2857142857142857,1,0.0,0,0,0,0,0,0,0,2,0,0,2,1
2551,54317,uKEv904ylJe7cpj2OP28yUTrESfvx6LR,SpATywNh6bZuzm8s1ceuBUnMUAeoAHHw,5,3,2,0,1,0,2,0,8,1.1428571428571428,1,0.0,0,2,0,1,3,0,0,2,0,3,5,1
2552,54326,Fq6XRhpyARqo3e2KmYQqUPcebNvG6D8A,SpATywNh6bZuzm8s1ceuBUnMUAeoAHHw,4,3,0,0,0,0,2,0,5,0.7142857142857143,1,0.0,0,0,0,0,3,0,0,2,0,0,5,1
2553,54347,u4dhcCVujoYC7k1ILiJ5SLaS1NfapC9a,SpATywNh6bZuzm8s1ceuBUnMUAeoAHHw,4,2,1,0,1,0,1,0,5,0.7142857142857143,1,0.0,0,1,0,1,2,0,0,1,0,2,3,1
2554,54354,1GwCcPnawuwjaFyAi38hoJxQ9NHTHcHa,SpATywNh6bZuzm8s1ceuBUnMUAeoAHHw,17,37,14,35,3,0,7,1,97,13.857142857142858,4,0.0,17,14,32,3,20,0,3,7,1,66,31,1
2555,54400,hMJOWQDhTMJkvOumtHtoyaiAzs72Ex16,A3fsA9Zfv1X2fVEQhTw51lKENdNrEqT3,1,0,0,0,0,0,2,0,2,0.2857142857142857,1,0.0,0,0,0,0,0,0,0,2,0,0,2,1
2556,54403,IiprEhfBJUF3Volv4Wt8hDKs67azhw4N,SpATywNh6bZuzm8s1ceuBUnMUAeoAHHw,25,48,4,34,0,65,28,4,183,26.142857142857142,11,0.0,11,4,29,0,37,65,5,28,4,44,139,0
2557,54406,WK8aAMlHaWKAnJlGkt1oHqYhwnCNU9kd,SpATywNh6bZuzm8s1ceuBUnMUAeoAHHw,13,10,8,0,6,4,6,0,34,4.857142857142857,3,0.0,0,8,0,6,10,4,0,6,0,14,20,1
2558,54424,iU4BkerxkC85turiATAPlGLqWWQBW3EA,SpATywNh6bZuzm8s1ceuBUnMUAeoAHHw,6,4,2,0,2,0,2,0,10,1.4285714285714286,1,0.0,0,2,0,2,4,0,0,2,0,4,6,0
2559,54428,fvcf8Mss4D9M5Dkk5Dn5T9NiTapwZ9dB,bWdj2GDclj5ofokWjzoa5jAwMkxCykd6,13,6,5,0,5,0,7,0,23,3.2857142857142856,3,0.0,0,5,0,5,6,0,0,7,0,10,13,1
2560,54433,0LlQk6hYRlvSzomDUaPkEEBmqmYnYmBf,A3fsA9Zfv1X2fVEQhTw51lKENdNrEqT3,8,9,3,0,3,0,3,0,18,2.5714285714285716,1,0.0,0,3,0,3,9,0,0,3,0,6,12,1
2561,54441,jWzOKFReJZdfMoypRkZGX0AJ4yOxVurG,SpATywNh6bZuzm8s1ceuBUnMUAeoAHHw,18,56,15,29,3,13,26,1,143,20.428571428571427,6,0.0,32,15,22,3,24,13,7,26,1,72,71,1
2562,54454,xPyi5tVWLdzwESKbVSwWQTZrKjlUSal4,A3fsA9Zfv1X2fVEQhTw51lKENdNrEqT3,11,6,1,0,1,0,12,2,22,3.142857142857143,3,0.0,0,1,0,1,6,0,0,12,2,2,20,1
2563,54456,9y3oRyXROykl3sBJ7TIi1TtD7SPjZS8A,RXDvfPUBYFlVdlueBFbLW0mhhAyGEqpt,1,0,0,0,0,0,1,0,1,0.14285714285714285,1,0.0,0,0,0,0,0,0,0,1,0,0,1,1
2564,54466,X0qRVbMFwtmOOuQv50UvryYfYmnstiNp,RXDvfPUBYFlVdlueBFbLW0mhhAyGEqpt,10,15,1,0,0,0,5,0,21,3.0,5,0.0,0,1,0,0,15,0,0,5,0,1,20,1
2565,54474,2cQfWhwRUGUv48S47s2aDWYzSM5LRy6r,SpATywNh6bZuzm8s1ceuBUnMUAeoAHHw,24,39,3,34,1,0,15,1,93,13.285714285714286,7,0.0,8,3,29,1,31,0,5,15,1,41,52,1
2566,54513,wD600Vm6nYpRlm6dPdneFPtwC1POqb2E,SpATywNh6bZuzm8s1ceuBUnMUAeoAHHw,19,41,18,20,7,0,11,0,97,13.857142857142858,4,0.0,10,18,16,7,31,0,4,11,0,51,46,1
2567,54539,obFplu8p0J5bdsesTSoaj6Bc4UGbTB6M,A3fsA9Zfv1X2fVEQhTw51lKENdNrEqT3,3,2,0,0,0,0,3,0,5,0.7142857142857143,2,0.0,0,0,0,0,2,0,0,3,0,0,5,1
2568,54560,PuyGNo8qc6xk0x7N225chheH1U0jpEmh,SpATywNh6bZuzm8s1ceuBUnMUAeoAHHw,16,23,9,14,0,0,9,0,55,7.857142857142857,2,0.0,8,9,11,0,15,0,3,9,0,28,27,0
2569,54562,FjbDR3UaxcNBkb6IH3GDQCUcWtWdh8Qq,RXDvfPUBYFlVdlueBFbLW0mhhAyGEqpt,34,22,12,36,10,0,3,0,83,11.857142857142858,1,0.0,7,12,34,10,15,0,2,3,0,63,20,1
2570,54579,UTQBVZwwRuN7bMqGkwJeqpNJF2PPrsFV,bWdj2GDclj5ofokWjzoa5jAwMkxCykd6,5,4,2,0,1,0,2,0,9,1.2857142857142858,2,0.0,0,2,0,1,4,0,0,2,0,3,6,1
2571,54583,CQQHZVTg11Q29ZpbkjEKlKziDTQM27vd,SpATywNh6bZuzm8s1ceuBUnMUAeoAHHw,2,0,0,0,0,0,2,0,2,0.2857142857142857,1,0.0,0,0,0,0,0,0,0,2,0,0,2,1
2572,54609,zqJYLp2Za4wDRWdLkC6hOzbgm2qW4Dc0,fbPkOYLVPtPgIt0MxizjfFJov3JbHyAi,6,3,2,0,2,0,2,0,9,1.2857142857142858,1,0.0,0,2,0,2,3,0,0,2,0,4,5,1
2573,54631,cZaJE9WXhMzWTnSMxu0NdfVeWxOkn7lj,fbPkOYLVPtPgIt0MxizjfFJov3JbHyAi,6,3,1,0,1,0,2,0,7,1.0,1,0.0,0,1,0,1,3,0,0,2,0,2,5,1
2574,54633,dTyQ7W3SS3T02L83rAdjVWHrGRV4tFve,fbPkOYLVPtPgIt0MxizjfFJov3JbHyAi,2,0,0,0,0,0,2,0,2,0.2857142857142857,1,0.0,0,0,0,0,0,0,0,2,0,0,2,1
2575,54642,1SXEIjzcoG8fdGB2rpSblj2HngER2yeu,fbPkOYLVPtPgIt0MxizjfFJov3JbHyAi,1,0,0,0,0,0,1,0,1,0.14285714285714285,1,0.0,0,0,0,0,0,0,0,1,0,0,1,1
2576,54662,2oTvbzieHn2y5oozeOgSnruqE6N0BtR5,fbPkOYLVPtPgIt0MxizjfFJov3JbHyAi,7,7,5,0,0,4,3,0,19,2.7142857142857144,1,0.0,0,5,0,0,7,4,0,3,0,5,14,1
2577,54714,GtuEelYfNaXxzKOllxbFfafnobOPHIGx,A3fsA9Zfv1X2fVEQhTw51lKENdNrEqT3,6,5,1,0,0,8,4,0,18,2.5714285714285716,2,0.0,0,1,0,0,5,8,0,4,0,1,17,1
2578,54802,CyhW9ceUO9NYz6xFgPeXoLjeNitx4OvW,7GRhBDsirIGkRZBtSMEzNTyDr2JQm4xx,1,0,0,0,0,0,1,0,1,0.14285714285714285,1,0.0,0,0,0,0,0,0,0,1,0,0,1,1
2579,54832,XTByA0ecuKljeTXiSoi3vawyiYSNo5Ez,SpATywNh6bZuzm8s1ceuBUnMUAeoAHHw,6,5,3,0,2,0,6,0,16,2.2857142857142856,1,0.0,0,3,0,2,5,0,0,6,0,5,11,0
2580,54874,zmKR9B5NLIRfAmSKdCbaIDXMZT9PoZip,7GRhBDsirIGkRZBtSMEzNTyDr2JQm4xx,1,0,0,0,0,0,1,0,1,0.14285714285714285,1,0.0,0,0,0,0,0,0,0,1,0,0,1,1
2581,54893,MZomFQTbHAKaDGd0B9fv7KQ9MRsZJ7m6,7GRhBDsirIGkRZBtSMEzNTyDr2JQm4xx,1,0,0,0,0,0,1,0,1,0.14285714285714285,1,0.0,0,0,0,0,0,0,0,1,0,0,1,1
2582,54970,YbQfcgwKrjskWW3wyOzQUUJYzdeHmY82,A3fsA9Zfv1X2fVEQhTw51lKENdNrEqT3,69,64,29,138,15,4,23,0,273,39.0,6,0.0,5,29,124,15,59,4,14,23,0,173,100,0
2583,54997,IJWUl0dWQiuiW9w5y2FbSbROivrhPUri,G8EPVSXsOYB5YQWZGiz1aVq5Pgr2GrQu,21,19,8,16,4,0,6,1,54,7.714285714285714,1,0.0,9,8,8,4,10,0,8,6,1,29,25,0
2584,55003,PnDN2WssnANedhxbDqo06cZR8VfXOHcf,SpATywNh6bZuzm8s1ceuBUnMUAeoAHHw,20,49,17,41,1,44,9,1,162,23.142857142857142,3,0.0,26,17,35,1,23,44,6,9,1,79,83,0
2585,55046,OsjipUObm67JsyJjOy7xHoa32L8CSYg5,7GRhBDsirIGkRZBtSMEzNTyDr2JQm4xx,67,76,3,97,3,1,8,0,188,26.857142857142858,6,0.0,37,3,95,3,39,1,2,8,0,138,50,1
2586,55086,PfTpx7WgTJY6IpNokJ2POml34GMs7LTI,A3fsA9Zfv1X2fVEQhTw51lKENdNrEqT3,77,24,17,174,10,0,6,0,231,33.0,5,0.0,2,17,168,10,22,0,6,6,0,197,34,0
2587,55102,tC06tDcyfiakkQ82nvNuQ9hOr0id1lp4,A3fsA9Zfv1X2fVEQhTw51lKENdNrEqT3,25,12,10,0,9,19,9,2,61,8.714285714285714,2,0.0,0,10,0,9,12,19,0,9,2,19,42,1
2588,55108,oASR1hbK6DD6OJfTJCDKLW9l2vPgw7kR,SpATywNh6bZuzm8s1ceuBUnMUAeoAHHw,19,26,14,10,10,0,4,0,64,9.142857142857142,2,0.0,6,14,10,10,20,0,0,4,0,40,24,0
2589,55162,gKSJfTKRpPRCZVoRPeT84zeHU3dzpwjK,7GRhBDsirIGkRZBtSMEzNTyDr2JQm4xx,1,0,0,0,0,0,1,0,1,0.14285714285714285,1,0.0,0,0,0,0,0,0,0,1,0,0,1,1
2590,55218,9DhjEr6688N0pGcvfzUDBy2Ch8BrzD6G,SpATywNh6bZuzm8s1ceuBUnMUAeoAHHw,25,69,3,25,0,12,31,4,144,20.571428571428573,5,0.0,21,3,21,0,48,12,4,31,4,45,99,0
2591,55222,sl5gnvWQxJCaKuNiDBTD8Gtex2riuepC,7GRhBDsirIGkRZBtSMEzNTyDr2JQm4xx,12,17,1,3,1,0,2,0,24,3.4285714285714284,1,0.0,3,1,3,1,14,0,0,2,0,8,16,1
2592,55268,yRP1A8CWHIiqi7L2SKgryjvGOEaUovOk,SpATywNh6bZuzm8s1ceuBUnMUAeoAHHw,24,49,5,37,2,1,13,2,109,15.571428571428571,3,0.0,14,5,32,2,35,1,5,13,2,53,56,0
2593,55324,b9PnER5aWf7HLwZ7RJ62h9NvkqSBL8ua,7GRhBDsirIGkRZBtSMEzNTyDr2JQm4xx,1,0,0,0,0,0,1,0,1,0.14285714285714285,1,0.0,0,0,0,0,0,0,0,1,0,0,1,1
2594,55335,YPEupTuOqSGieSSneZcv3AcUcSBCtbGY,RXDvfPUBYFlVdlueBFbLW0mhhAyGEqpt,45,60,3,75,6,15,15,1,175,25.0,3,0.0,15,3,71,6,45,15,4,15,1,95,80,1
2595,55362,xkt3K6JWpnfeixDBdwkLXaHgXuuGt35v,7GRhBDsirIGkRZBtSMEzNTyDr2JQm4xx,37,74,31,55,21,0,12,0,193,27.571428571428573,7,0.0,25,31,48,21,49,0,7,12,0,125,68,1
2596,55394,4mCA51pF01hkyB9Dsn8cU0qpfh1iqOVS,7GRhBDsirIGkRZBtSMEzNTyDr2JQm4xx,5,2,0,0,1,0,2,0,5,0.7142857142857143,1,0.0,0,0,0,1,2,0,0,2,0,1,4,1
2597,55398,46OTr627jSWtC8wrPe4BZiyNeqDxFeE3,SpATywNh6bZuzm8s1ceuBUnMUAeoAHHw,14,28,7,24,2,0,7,0,68,9.714285714285714,3,0.0,7,7,19,2,21,0,5,7,0,35,33,0
2598,55482,87SYGQjFYUtEWda0pG12bcNker0JGBy3,SpATywNh6bZuzm8s1ceuBUnMUAeoAHHw,13,26,1,12,0,11,9,1,60,8.571428571428571,3,0.0,5,1,12,0,21,11,0,9,1,18,42,1
2599,55543,pUCIPJW1P8mn7ehxRb7s9lkHivSStKgb,7GRhBDsirIGkRZBtSMEzNTyDr2JQm4xx,12,13,2,0,2,0,5,0,22,3.142857142857143,2,0.0,0,2,0,2,13,0,0,5,0,4,18,1
2600,55554,iN5LRJ62Fzny0HSOI77UB3W5oJ1HoHwK,7GRhBDsirIGkRZBtSMEzNTyDr2JQm4xx,2,0,0,0,0,0,3,0,3,0.42857142857142855,1,0.0,0,0,0,0,0,0,0,3,0,0,3,1
2601,55587,dNMg8HqASFn9pIW9ZR7BiQy6ZwZupOce,A3fsA9Zfv1X2fVEQhTw51lKENdNrEqT3,6,3,1,0,1,0,3,0,8,1.1428571428571428,1,0.0,0,1,0,1,3,0,0,3,0,2,6,1
2602,55589,dNMg8HqASFn9pIW9ZR7BiQy6ZwZupOce,bWdj2GDclj5ofokWjzoa5jAwMkxCykd6,5,2,1,0,1,0,2,0,6,0.8571428571428571,1,0.0,0,1,0,1,2,0,0,2,0,2,4,0
2603,55606,QuPJMxHrI2abilMygWFCmLFsgGUQO9Wm,bWdj2GDclj5ofokWjzoa5jAwMkxCykd6,16,30,18,22,9,17,11,1,108,15.428571428571429,3,0.0,4,18,17,9,26,17,5,11,1,48,60,1
2604,55676,0KWLX80Me9j0YMYrLboMuYM0mrVWxRud,7GRhBDsirIGkRZBtSMEzNTyDr2JQm4xx,32,50,24,42,5,40,18,2,181,25.857142857142858,1,0.0,18,24,36,5,32,40,6,18,2,83,98,0
2605,55714,ycZVLmNiTgP7M4zqov9Nx3hYhdN2qhKF,A3fsA9Zfv1X2fVEQhTw51lKENdNrEqT3,31,39,32,0,26,0,8,0,105,15.0,5,0.0,0,32,0,26,39,0,0,8,0,58,47,1
2606,55731,ybcsmPlarjax7Mq4kzteIAIZbYqmFvSY,G8EPVSXsOYB5YQWZGiz1aVq5Pgr2GrQu,13,21,11,68,0,2,6,0,108,15.428571428571429,4,0.0,1,11,67,0,20,2,1,6,0,79,29,0
2607,55733,zVX5LPwTGC1SEitxSfv31cubNXKJSEc2,G8EPVSXsOYB5YQWZGiz1aVq5Pgr2GrQu,29,16,13,170,1,0,12,3,215,30.714285714285715,2,0.0,0,13,163,1,16,0,7,12,3,177,38,0
2608,55813,gykRbA7iJUFygOkXv9mNdsHLTYvvd4jI,bWdj2GDclj5ofokWjzoa5jAwMkxCykd6,11,22,1,78,1,35,22,7,166,23.714285714285715,1,0.0,5,1,77,1,17,35,1,22,7,84,82,1
2609,55818,EQ7wf57Maxtqueh0jcALSwDsSR4NE6Fa,7GRhBDsirIGkRZBtSMEzNTyDr2JQm4xx,1,0,0,0,0,0,1,0,1,0.14285714285714285,1,0.0,0,0,0,0,0,0,0,1,0,0,1,1
2610,55828,bXhvLL1DQzEIjyGvSUCfqx2LTtxg4cK2,7GRhBDsirIGkRZBtSMEzNTyDr2JQm4xx,34,55,22,40,18,61,15,1,212,30.285714285714285,3,0.0,27,22,32,18,28,61,8,15,1,99,113,1
2611,55852,zC2jRq3r9EI7fiKmdxBaoujmdY4A8FN5,G8EPVSXsOYB5YQWZGiz1aVq5Pgr2GrQu,30,44,3,40,6,16,12,3,124,17.714285714285715,4,0.0,17,3,33,6,27,16,7,12,3,59,65,0
2612,55860,PmH4XgxtQe1CNb3l16TlTY5tyEhuC40E,SpATywNh6bZuzm8s1ceuBUnMUAeoAHHw,31,65,33,38,18,16,14,1,185,26.428571428571427,3,0.0,18,33,32,18,47,16,6,14,1,101,84,0
2613,55918,JOqHNkiAQMopMtNnxSpHdAOKSp68V43j,A3fsA9Zfv1X2fVEQhTw51lKENdNrEqT3,74,28,16,214,5,16,16,0,295,42.142857142857146,6,0.0,6,16,179,5,22,16,35,16,0,206,89,1
2614,55928,ar4cwuAwjqKFHUFshoX4Vj4edt6iUva1,bWdj2GDclj5ofokWjzoa5jAwMkxCykd6,6,2,1,0,1,0,5,1,10,1.4285714285714286,1,0.0,0,1,0,1,2,0,0,5,1,2,8,0
2615,55967,EK7Y6jLbcTIHEzN8KJHD55mY3w7SjZfJ,SpATywNh6bZuzm8s1ceuBUnMUAeoAHHw,28,68,10,19,6,55,10,0,168,24.0,2,0.0,32,10,18,6,36,55,1,10,0,66,102,1
2616,55978,JVRk883TChkd8D0ZSH6CEb3OUHD06lXQ,SpATywNh6bZuzm8s1ceuBUnMUAeoAHHw,32,52,27,34,13,7,17,3,153,21.857142857142858,5,0.0,15,27,30,13,37,7,4,17,3,85,68,0
2617,55979,P7MRSD3CXumEAUVQkOjfu7iyOA6WzwhX,7GRhBDsirIGkRZBtSMEzNTyDr2JQm4xx,7,8,3,4,3,0,1,0,19,2.7142857142857144,1,0.0,1,3,4,3,7,0,0,1,0,11,8,0
2618,56003,UqClTQDqKMNYDPHUpaTnYqiluGgaVwby,7GRhBDsirIGkRZBtSMEzNTyDr2JQm4xx,27,34,17,25,9,7,6,0,98,14.0,4,0.0,13,17,20,9,21,7,5,6,0,59,39,1
2619,56004,o9m1fMq17KjyGUhfLHLXFO5hoKQ5jU6O,A3fsA9Zfv1X2fVEQhTw51lKENdNrEqT3,1,0,0,0,0,0,1,0,1,0.14285714285714285,1,0.0,0,0,0,0,0,0,0,1,0,0,1,1
2620,56031,QOTn8ztUNlHS3hl3hqCv4ofIiB3cOmPL,SpATywNh6bZuzm8s1ceuBUnMUAeoAHHw,10,8,4,0,1,3,6,0,22,3.142857142857143,1,0.0,2,4,0,1,6,3,0,6,0,7,15,0
2621,56058,c162xBeHQ1ehzoWsokUc8kKEtu9gLIte,SpATywNh6bZuzm8s1ceuBUnMUAeoAHHw,14,11,5,9,4,0,4,0,33,4.714285714285714,1,0.0,5,5,9,4,6,0,0,4,0,23,10,0
2622,56062,pKCzqYDvJAlWQNOnHiIQZJLfMk8J7wCX,G8EPVSXsOYB5YQWZGiz1aVq5Pgr2GrQu,13,18,4,30,4,11,11,8,86,12.285714285714286,1,0.0,14,4,26,4,4,11,4,11,8,48,38,0
2623,56078,kKj1FlDO03hIJs4qO2fYyQxEzv7HbwXh,SpATywNh6bZuzm8s1ceuBUnMUAeoAHHw,23,50,11,10,6,0,8,0,85,12.142857142857142,5,0.0,11,11,9,6,39,0,1,8,0,37,48,1
2624,56081,Ybi3cFvDqy1VWHiDJ2n2dPI1NwP5ZaHo,7GRhBDsirIGkRZBtSMEzNTyDr2JQm4xx,1,0,0,0,0,0,1,0,1,0.14285714285714285,1,0.0,0,0,0,0,0,0,0,1,0,0,1,1
2625,56090,CXsZzvE3iylo5KzyiPoa1X1kRLwsS4Km,7GRhBDsirIGkRZBtSMEzNTyDr2JQm4xx,2,0,0,0,0,0,2,0,2,0.2857142857142857,1,0.0,0,0,0,0,0,0,0,2,0,0,2,1
2626,56104,WZLkW7B5dsHccBcGjqVOiLakE0tHruAV,SpATywNh6bZuzm8s1ceuBUnMUAeoAHHw,8,12,1,0,1,0,3,0,17,2.4285714285714284,2,0.0,0,1,0,1,12,0,0,3,0,2,15,1
2627,56114,PmaZVK1XohXhK9MuIDoeUlsnQ3xunZ0o,SpATywNh6bZuzm8s1ceuBUnMUAeoAHHw,6,6,1,0,1,0,7,0,15,2.142857142857143,3,0.0,0,1,0,1,6,0,0,7,0,2,13,1
2628,56138,0K6JPqiivQzicxY4EV4nqMLCL3a08A97,7GRhBDsirIGkRZBtSMEzNTyDr2JQm4xx,20,29,17,22,13,3,9,0,93,13.285714285714286,3,0.0,11,17,19,13,18,3,3,9,0,60,33,1
2629,56153,YgnjU1hWSGf8038ZkUT6S1YfeICauUtf,SpATywNh6bZuzm8s1ceuBUnMUAeoAHHw,17,16,7,9,5,2,1,0,40,5.714285714285714,1,0.0,8,7,9,5,8,2,0,1,0,29,11,0
2630,56154,hcrd0JfkIltpZTYyzvBezmjxNHV3TQ2P,7GRhBDsirIGkRZBtSMEzNTyDr2JQm4xx,31,53,16,51,22,16,6,0,164,23.428571428571427,2,0.0,33,16,46,22,20,16,5,6,0,117,47,1
2631,56160,e3Xx0LWeS8euUOsFo80XF3J80EQ2D87p,SpATywNh6bZuzm8s1ceuBUnMUAeoAHHw,24,44,3,22,3,0,7,1,80,11.428571428571429,3,0.0,8,3,18,3,36,0,4,7,1,32,48,0
2632,56169,TNAUZUlDZyGbJQN7wls2QRBe2Cw7eeSK,bWdj2GDclj5ofokWjzoa5jAwMkxCykd6,2,0,0,0,0,0,2,0,2,0.2857142857142857,1,0.0,0,0,0,0,0,0,0,2,0,0,2,0
2633,56189,sMMDk03UePJILkRIn5YDW5tA5us6h51J,SpATywNh6bZuzm8s1ceuBUnMUAeoAHHw,32,45,25,33,9,4,18,1,135,19.285714285714285,5,0.0,7,25,29,9,38,4,4,18,1,70,65,1
2634,56221,mxDmiNiZbTWbG5eX6cuqeU6lZnYbJUhB,SpATywNh6bZuzm8s1ceuBUnMUAeoAHHw,10,22,9,0,0,5,24,2,62,8.857142857142858,4,0.0,1,9,0,0,21,5,0,24,2,10,52,0
2635,56234,qYhoMsNGFfjRIDh2DmSOTAEOExxbLNsi,7GRhBDsirIGkRZBtSMEzNTyDr2JQm4xx,8,8,4,0,1,1,5,0,19,2.7142857142857144,1,0.0,1,4,0,1,7,1,0,5,0,6,13,1
2636,56237,PlHOy9sO4wpd56kVnMDoRd2P9dW85wrW,A3fsA9Zfv1X2fVEQhTw51lKENdNrEqT3,3,0,0,0,0,0,6,0,6,0.8571428571428571,1,0.0,0,0,0,0,0,0,0,6,0,0,6,1
2637,56242,aJc8aUAetxPPGWFRPX4YOEm2nyZUaAWd,7GRhBDsirIGkRZBtSMEzNTyDr2JQm4xx,8,12,6,4,5,0,4,0,31,4.428571428571429,1,0.0,2,6,3,5,10,0,1,4,0,16,15,1
2638,56260,GLN4A8S1FfCje62RkokqBLEULjMYf2Jo,SpATywNh6bZuzm8s1ceuBUnMUAeoAHHw,17,14,1,8,1,0,12,1,37,5.285714285714286,3,0.0,0,1,6,1,14,0,2,12,1,8,29,0
2639,56283,eCJEYxlte8R6sbqh66Nohv34rvkne1DG,SpATywNh6bZuzm8s1ceuBUnMUAeoAHHw,28,28,14,12,8,10,6,0,78,11.142857142857142,1,0.0,12,14,12,8,16,10,0,6,0,46,32,1
2640,56334,6A5mn3Pn8IBDZpMvNejUh5y2X9g7rQUJ,SpATywNh6bZuzm8s1ceuBUnMUAeoAHHw,10,9,1,7,1,0,7,0,25,3.5714285714285716,1,0.0,0,1,6,1,9,0,1,7,0,8,17,0
2641,56351,9EUUO7h64xEMsIYSdMrVOb4PBS93f8Du,SpATywNh6bZuzm8s1ceuBUnMUAeoAHHw,8,4,2,0,2,0,2,0,10,1.4285714285714286,1,0.0,0,2,0,2,4,0,0,2,0,4,6,1
2642,56363,JLoCQORXjvwdLxTSzHD1j5idBdhZN6jK,7GRhBDsirIGkRZBtSMEzNTyDr2JQm4xx,5,0,0,0,0,2,7,0,9,1.2857142857142858,1,0.0,0,0,0,0,0,2,0,7,0,0,9,1
2643,56380,4GCUZawdASarA3TMg6HAfW2kyE7xYxA6,7GRhBDsirIGkRZBtSMEzNTyDr2JQm4xx,2,0,0,0,0,0,2,0,2,0.2857142857142857,1,0.0,0,0,0,0,0,0,0,2,0,0,2,1
2644,56397,1KCmpfcoDnRnd9ITYAgYi4eQPwc5jiJz,SpATywNh6bZuzm8s1ceuBUnMUAeoAHHw,15,19,0,6,0,0,6,0,31,4.428571428571429,5,0.0,2,0,6,0,17,0,0,6,0,8,23,1
2645,56410,m7ppZFqoqxq4drq32V7wzPII9oNFXP01,SpATywNh6bZuzm8s1ceuBUnMUAeoAHHw,28,43,27,14,11,4,8,0,107,15.285714285714286,3,0.0,8,27,14,11,35,4,0,8,0,60,47,0
2646,56436,2B1Sa19tBbYgocD2xlB5fX7K09dmclmZ,SpATywNh6bZuzm8s1ceuBUnMUAeoAHHw,27,47,12,35,6,2,13,2,117,16.714285714285715,4,0.0,5,12,31,6,42,2,4,13,2,54,63,1
2647,56464,mUGiOApqSIPNJJAxx9ku1Ubhn4j7vYNp,SpATywNh6bZuzm8s1ceuBUnMUAeoAHHw,25,58,5,20,3,30,12,0,128,18.285714285714285,4,0.0,15,5,19,3,43,30,1,12,0,42,86,0
2648,56502,YAaB5kbzMpno3yyQhEjSC43PC6r4FUut,A3fsA9Zfv1X2fVEQhTw51lKENdNrEqT3,1,0,0,0,0,0,1,0,1,0.14285714285714285,1,0.0,0,0,0,0,0,0,0,1,0,0,1,1
2649,56505,K9sZStDxVlzslbizXAYcyYp63PWAyvJs,bWdj2GDclj5ofokWjzoa5jAwMkxCykd6,10,25,11,26,9,3,8,0,82,11.714285714285714,2,0.0,7,11,23,9,18,3,3,8,0,50,32,1
2650,56507,yh14zaFitCUTgvBPqRXiaZ6cUijtktL4,7GRhBDsirIGkRZBtSMEzNTyDr2JQm4xx,5,7,0,2,0,0,1,0,10,1.4285714285714286,1,0.0,1,0,2,0,6,0,0,1,0,3,7,1
2651,56516,yreSFZev8w2vccLGmUPWniYPFTHUVYuW,SpATywNh6bZuzm8s1ceuBUnMUAeoAHHw,16,20,4,21,3,10,7,1,66,9.428571428571429,1,0.0,15,4,18,3,5,10,3,7,1,40,26,1
2652,56517,Rz28tFT5qYZaEQ78Ly3OdJx8TpvsmLBy,A3fsA9Zfv1X2fVEQhTw51lKENdNrEqT3,10,13,6,0,1,0,24,0,44,6.285714285714286,3,0.0,0,6,0,1,13,0,0,24,0,7,37,0
2653,56566,6qgQAmX6y5wh5nEPRINOiKrZNoTl5yfT,G8EPVSXsOYB5YQWZGiz1aVq5Pgr2GrQu,131,168,63,236,41,46,21,3,578,82.57142857142857,9,0.0,85,63,160,41,83,46,76,21,3,349,229,0
2654,56617,hhlID9e9RXNsuOHzHvfjbzrkpQmbpeir,SpATywNh6bZuzm8s1ceuBUnMUAeoAHHw,28,32,21,18,9,9,11,1,101,14.428571428571429,8,0.0,6,21,17,9,26,9,1,11,1,53,48,1
2655,56628,nx5QFDeL3HGj8P6Q50AF1WAJHhbCqdYM,7GRhBDsirIGkRZBtSMEzNTyDr2JQm4xx,1,0,0,0,0,0,1,0,1,0.14285714285714285,1,0.0,0,0,0,0,0,0,0,1,0,0,1,1
2656,56636,PdrdE0IIRUHKPZyUMDrlUIJ0Ny8UuZco,A3fsA9Zfv1X2fVEQhTw51lKENdNrEqT3,44,37,20,76,8,1,22,1,165,23.571428571428573,5,0.0,4,20,71,8,33,1,5,22,1,103,62,1
2657,56642,7ttzq6sOsWQ5eEpZriKP7OLuIb0DcSbF,SpATywNh6bZuzm8s1ceuBUnMUAeoAHHw,31,36,17,36,7,5,8,1,110,15.714285714285714,3,0.0,16,17,30,7,20,5,6,8,1,70,40,0
2658,56652,uHeTIz8GkglZUts3zio1tGR2aBoYwiQE,bWdj2GDclj5ofokWjzoa5jAwMkxCykd6,44,71,39,145,18,53,11,1,338,48.285714285714285,5,0.0,15,39,137,18,56,53,8,11,1,209,129,1
2659,56653,A0M3i5nfjroJ4PM9wmVXYOoLY3tY0fag,SpATywNh6bZuzm8s1ceuBUnMUAeoAHHw,13,53,3,19,1,1,1,0,78,11.142857142857142,4,0.0,17,3,17,1,36,1,2,1,0,38,40,0
2660,56657,QjRqlcg02MPH1ssCHCoMGSYCtFlPbtU9,A3fsA9Zfv1X2fVEQhTw51lKENdNrEqT3,5,4,1,0,1,0,5,0,11,1.5714285714285714,3,0.0,0,1,0,1,4,0,0,5,0,2,9,1
2661,56678,GHx2mQF50a1TJotiqGtGfhTS2ssF34QK,A3fsA9Zfv1X2fVEQhTw51lKENdNrEqT3,5,2,1,0,1,0,2,0,6,0.8571428571428571,1,0.0,0,1,0,1,2,0,0,2,0,2,4,1
2662,56721,SK7IxqKpOFb3vAlYnYjFjD4PVuXVBlrm,SpATywNh6bZuzm8s1ceuBUnMUAeoAHHw,24,48,4,36,1,19,15,2,125,17.857142857142858,2,0.0,14,4,32,1,34,19,4,15,2,51,74,0
2663,56732,csg0yBjjrshmLGGyq6UVgiiqMZP9T0vI,bWdj2GDclj5ofokWjzoa5jAwMkxCykd6,9,7,5,0,4,0,7,1,24,3.4285714285714284,3,0.0,0,5,0,4,7,0,0,7,1,9,15,1
2664,56733,i9CWvduTcskommMHOeHEvsItP05JGHxW,SpATywNh6bZuzm8s1ceuBUnMUAeoAHHw,17,29,9,10,4,0,3,0,55,7.857142857142857,3,0.0,8,9,8,4,21,0,2,3,0,29,26,0
2665,56741,GXi0JiFESUZlctzkqcyy8vfaIeTzKOhp,SpATywNh6bZuzm8s1ceuBUnMUAeoAHHw,21,22,12,0,8,0,5,0,47,6.714285714285714,3,0.0,6,12,0,8,16,0,0,5,0,26,21,1
2666,56758,3X0JLX6UvJnnRb5GkwbFJgAokE5g69D0,A3fsA9Zfv1X2fVEQhTw51lKENdNrEqT3,48,31,18,162,2,0,5,0,218,31.142857142857142,2,0.0,5,18,145,2,26,0,17,5,0,170,48,1
2667,56782,Kh53GURdm4wzt7JTpZoCCzo0wL64E4IV,SpATywNh6bZuzm8s1ceuBUnMUAeoAHHw,1,0,0,0,0,0,1,0,1,0.14285714285714285,1,0.0,0,0,0,0,0,0,0,1,0,0,1,1
2668,56787,73lhhrOcE2srJj5BkIzSweWSnQRZBT2o,bWdj2GDclj5ofokWjzoa5jAwMkxCykd6,40,85,51,126,0,0,18,0,280,40.0,9,0.0,15,51,111,0,70,0,15,18,0,177,103,1
2669,56824,1NMKAl678ZBpdBkhXfYTAgEyYygMZz0x,SpATywNh6bZuzm8s1ceuBUnMUAeoAHHw,15,34,3,0,3,1,6,0,47,6.714285714285714,3,0.0,6,3,0,3,28,1,0,6,0,12,35,1
2670,56826,ilWzYGLWBh9DSc1MV8g2C4Go5wDNgUHX,A3fsA9Zfv1X2fVEQhTw51lKENdNrEqT3,18,19,16,0,12,10,9,0,66,9.428571428571429,3,0.0,0,16,0,12,19,10,0,9,0,28,38,0
2671,56867,qDignCY8ZSbFAHDmfGr6um90qnmxvInL,bWdj2GDclj5ofokWjzoa5jAwMkxCykd6,39,56,31,74,14,22,16,2,215,30.714285714285715,4,0.0,10,31,60,14,46,22,14,16,2,115,100,1
2672,56869,F1uYmg9j3YwgNnk0aXzCliVPelaqL3Ra,G8EPVSXsOYB5YQWZGiz1aVq5Pgr2GrQu,2,0,0,0,0,0,2,0,2,0.2857142857142857,1,0.0,0,0,0,0,0,0,0,2,0,0,2,1
2673,56879,7bo2b6hOKJdeJMUZPegC3OXRiqnOBuKu,SpATywNh6bZuzm8s1ceuBUnMUAeoAHHw,1,0,0,0,0,0,2,0,2,0.2857142857142857,1,0.0,0,0,0,0,0,0,0,2,0,0,2,1
2674,56886,PJRBo6fo8GkTYEZAj3yApWIU4z2xQiJ3,SpATywNh6bZuzm8s1ceuBUnMUAeoAHHw,12,26,9,0,9,0,3,0,47,6.714285714285714,1,0.0,0,9,0,9,26,0,0,3,0,18,29,1
2675,56891,afVQ7OP9Yg7nQrenfRDF9heWvtL5syxt,SpATywNh6bZuzm8s1ceuBUnMUAeoAHHw,1,0,0,0,0,0,2,0,2,0.2857142857142857,1,0.0,0,0,0,0,0,0,0,2,0,0,2,1
2676,56952,H7pGBNaBrGHYeUmvNiEOm731zZ0Xqtux,RXDvfPUBYFlVdlueBFbLW0mhhAyGEqpt,14,20,6,0,6,2,8,1,43,6.142857142857143,2,0.0,2,6,0,6,18,2,0,8,1,14,29,1
2677,56959,qZhmmNUvkNXdf3u04DTUQOFEBxxO10p4,A3fsA9Zfv1X2fVEQhTw51lKENdNrEqT3,11,7,4,0,3,0,5,0,19,2.7142857142857144,4,0.0,0,4,0,3,7,0,0,5,0,7,12,1
2678,56994,7W8jjJVFEvdsz605K0BoRU3E0G6E9Kji,G8EPVSXsOYB5YQWZGiz1aVq5Pgr2GrQu,1,0,0,0,0,0,1,0,1,0.14285714285714285,1,0.0,0,0,0,0,0,0,0,1,0,0,1,1
2679,56999,vbTgITzq6jZRj0oUV5gFotgOlwSXnjML,G8EPVSXsOYB5YQWZGiz1aVq5Pgr2GrQu,113,139,60,381,18,7,20,0,625,89.28571428571429,5,0.0,64,60,304,18,75,7,77,20,0,446,179,0
2680,57006,dJ2h8ddhmpweKKIE5BpE7xXimjPVsm52,G8EPVSXsOYB5YQWZGiz1aVq5Pgr2GrQu,1,0,0,0,0,0,1,0,1,0.14285714285714285,1,0.0,0,0,0,0,0,0,0,1,0,0,1,0
2681,57008,ZtLnEkCqeRnvyqFQdbYPmQSGK8YkXNE8,SpATywNh6bZuzm8s1ceuBUnMUAeoAHHw,15,15,1,15,1,0,6,1,39,5.571428571428571,2,0.0,4,1,15,1,11,0,0,6,1,21,18,0
2682,57029,I7IIrHAh1LzzCf8lcvI92o8deFulzAh8,SpATywNh6bZuzm8s1ceuBUnMUAeoAHHw,2,0,0,0,0,0,3,0,3,0.42857142857142855,2,0.0,0,0,0,0,0,0,0,3,0,0,3,1
2683,57044,I7IIrHAh1LzzCf8lcvI92o8deFulzAh8,bWdj2GDclj5ofokWjzoa5jAwMkxCykd6,1,0,0,0,0,0,4,0,4,0.5714285714285714,3,0.0,0,0,0,0,0,0,0,4,0,0,4,1
2684,57046,AKrswbnpGlIzlwfZKfo5lwKhJzNpXmb1,SpATywNh6bZuzm8s1ceuBUnMUAeoAHHw,13,35,1,17,0,0,3,0,56,8.0,1,0.0,18,1,15,0,17,0,2,3,0,34,22,0
2685,57056,uMWcv4ZmW7X4PBv6egGkJZliUjuRluME,RXDvfPUBYFlVdlueBFbLW0mhhAyGEqpt,1,0,0,0,0,0,1,0,1,0.14285714285714285,1,0.0,0,0,0,0,0,0,0,1,0,0,1,1
2686,57059,cYibpCaMUGq0WjgUWfTv0iIvJ7QbFj5E,A3fsA9Zfv1X2fVEQhTw51lKENdNrEqT3,18,8,8,0,8,0,12,0,36,5.142857142857143,3,0.0,0,8,0,8,8,0,0,12,0,16,20,1
2687,57064,vAq6n4okEOzm4Q7527tzA1bof68awv28,G8EPVSXsOYB5YQWZGiz1aVq5Pgr2GrQu,9,6,1,0,1,0,2,0,10,1.4285714285714286,1,0.0,0,1,0,1,6,0,0,2,0,2,8,1
2688,57065,nxmaEvO6WAl9UO0RB8OmpscRPO1Nbssm,A3fsA9Zfv1X2fVEQhTw51lKENdNrEqT3,6,4,1,0,1,0,1,0,7,1.0,1,0.0,0,1,0,1,4,0,0,1,0,2,5,1
2689,57070,uMWcv4ZmW7X4PBv6egGkJZliUjuRluME,G8EPVSXsOYB5YQWZGiz1aVq5Pgr2GrQu,5,5,0,0,0,0,2,0,7,1.0,1,0.0,0,0,0,0,5,0,0,2,0,0,7,1
2690,57196,9hgjLw4OD5u1XjZx0s9EMRnEguVXBlYy,A3fsA9Zfv1X2fVEQhTw51lKENdNrEqT3,23,17,12,0,10,0,3,0,42,6.0,2,0.0,0,12,0,10,17,0,0,3,0,22,20,1
2691,57250,3Jq0rhguTOZ7fja70sOOKUPAPqu7fQyT,SpATywNh6bZuzm8s1ceuBUnMUAeoAHHw,29,54,33,19,16,51,20,0,193,27.571428571428573,7,0.0,11,33,17,16,43,51,2,20,0,77,116,0
2692,57265,NFGYUC7dcOkWJh2BiZLJheVSucAvXvpt,bWdj2GDclj5ofokWjzoa5jAwMkxCykd6,17,20,3,47,1,18,12,2,103,14.714285714285714,4,0.0,1,3,43,1,19,18,4,12,2,48,55,0
2693,57277,bt7h6JIDcUKzJSKeXMoVM1LEqwbXUCBJ,SpATywNh6bZuzm8s1ceuBUnMUAeoAHHw,21,80,4,32,0,1,23,0,140,20.0,6,0.0,13,4,27,0,67,1,5,23,0,44,96,0
2694,57321,mSToVMacc08MhsUyEFn562K69bpANB3P,A3fsA9Zfv1X2fVEQhTw51lKENdNrEqT3,76,25,21,74,18,0,3,0,141,20.142857142857142,1,0.0,3,21,74,18,22,0,0,3,0,116,25,1
2695,57323,xayicpjClPkwcfGTr3r84hb5pfZk0nB8,RXDvfPUBYFlVdlueBFbLW0mhhAyGEqpt,39,37,27,8,21,10,12,4,119,17.0,3,0.0,4,27,8,21,33,10,0,12,4,60,59,1
2696,57327,RdOaDfHEeBBslFA96Ipf8QaGmA7wq7Rz,SpATywNh6bZuzm8s1ceuBUnMUAeoAHHw,16,36,17,13,4,1,15,0,86,12.285714285714286,5,0.0,7,17,10,4,29,1,3,15,0,38,48,0
2697,57329,XyoP35cBUiKk44G72mbtEXCBjk8FmHfo,bWdj2GDclj5ofokWjzoa5jAwMkxCykd6,38,71,41,51,16,1,32,0,212,30.285714285714285,6,0.0,12,41,41,16,59,1,10,32,0,110,102,1
2698,57345,SmBAgHRNeYWZKP2SpqpKXwVR3YhUZnjq,SpATywNh6bZuzm8s1ceuBUnMUAeoAHHw,22,33,0,34,0,19,18,0,104,14.857142857142858,4,0.0,15,0,29,0,18,19,5,18,0,44,60,0
2699,57353,3SNPt0tgFaFs22ZCc56rWyLmizBS9I72,SpATywNh6bZuzm8s1ceuBUnMUAeoAHHw,1,0,0,0,0,0,1,0,1,0.14285714285714285,1,0.0,0,0,0,0,0,0,0,1,0,0,1,1
2700,57423,MJQDYgQSk0Dles3B2EOjCe8Rc6SLp0Te,SpATywNh6bZuzm8s1ceuBUnMUAeoAHHw,1,0,0,0,0,0,1,0,1,0.14285714285714285,1,0.0,0,0,0,0,0,0,0,1,0,0,1,1
2701,57424,ITiFsDuHkhq2oCixW0Woe4mx6l3FjxPc,SpATywNh6bZuzm8s1ceuBUnMUAeoAHHw,7,5,2,0,2,0,2,0,11,1.5714285714285714,1,0.0,0,2,0,2,5,0,0,2,0,4,7,1
2702,57453,1ITGuQ2R8DpLVa12S7xW3GeCStKCoFln,SpATywNh6bZuzm8s1ceuBUnMUAeoAHHw,6,5,1,12,0,0,4,0,22,3.142857142857143,1,0.0,1,1,10,0,4,0,2,4,0,12,10,1
2703,57522,FCOtK161WkcVOQohkw4NuKVb2dJLDsJS,A3fsA9Zfv1X2fVEQhTw51lKENdNrEqT3,1,0,0,0,0,0,1,0,1,0.14285714285714285,1,0.0,0,0,0,0,0,0,0,1,0,0,1,1
2704,57525,OLSxCkluLildKVrVnzRIsj47tt9tVHj9,bWdj2GDclj5ofokWjzoa5jAwMkxCykd6,5,2,1,0,1,0,5,0,9,1.2857142857142858,2,0.0,0,1,0,1,2,0,0,5,0,2,7,1
2705,57544,rwwtkpIIPQWlSN0q7WUWaQBBUS2Mm6IT,SpATywNh6bZuzm8s1ceuBUnMUAeoAHHw,1,0,0,0,0,0,1,0,1,0.14285714285714285,1,0.0,0,0,0,0,0,0,0,1,0,0,1,1
2706,57550,mN3Kbbx6eP7NH0lwyK6LVlERNttoP58u,SpATywNh6bZuzm8s1ceuBUnMUAeoAHHw,2,0,0,0,0,0,3,0,3,0.42857142857142855,1,0.0,0,0,0,0,0,0,0,3,0,0,3,1
2707,57552,JjC5gQBcEdEGxqUfdmNRpoNHaHUkhFr3,SpATywNh6bZuzm8s1ceuBUnMUAeoAHHw,18,15,5,11,3,0,5,1,40,5.714285714285714,1,0.0,4,5,10,3,11,0,1,5,1,22,18,1
2708,57576,uA7r7QkkxMOoLmO6n5eQTQ4mcfRiz1sY,SpATywNh6bZuzm8s1ceuBUnMUAeoAHHw,7,1,1,0,1,0,5,0,8,1.1428571428571428,1,0.0,0,1,0,1,1,0,0,5,0,2,6,1
2709,57641,C2kNfLlJQRAYF9jyyvOY33F0K0B7w85s,bWdj2GDclj5ofokWjzoa5jAwMkxCykd6,6,4,2,0,2,0,1,0,9,1.2857142857142858,1,0.0,0,2,0,2,4,0,0,1,0,4,5,1
2710,57657,r4CghvxKbP3R549p5B3LTdvr7lbYRqXF,G8EPVSXsOYB5YQWZGiz1aVq5Pgr2GrQu,22,40,16,20,4,25,16,2,123,17.571428571428573,2,0.0,16,16,12,4,24,25,8,16,2,48,75,0
2711,57679,f3dcnqPelEIMHduho80ktIjNJSihd3u6,SpATywNh6bZuzm8s1ceuBUnMUAeoAHHw,8,6,3,0,1,0,8,1,19,2.7142857142857144,2,0.0,0,3,0,1,6,0,0,8,1,4,15,1
2712,57684,uq4F79CzLXcUWikv4BbYmEqP6niBgdHB,SpATywNh6bZuzm8s1ceuBUnMUAeoAHHw,6,3,2,0,2,0,1,0,8,1.1428571428571428,1,0.0,0,2,0,2,3,0,0,1,0,4,4,1
2713,57687,pRBbSmiVEBaGz4jkeqwSc7HR4j4zPAwQ,RXDvfPUBYFlVdlueBFbLW0mhhAyGEqpt,5,0,0,0,0,1,4,1,6,0.8571428571428571,1,0.0,0,0,0,0,0,1,0,4,1,0,6,1
2714,57710,pp3MkpuoWvkyzXCuYr4td0R2Hp9mxMXr,RXDvfPUBYFlVdlueBFbLW0mhhAyGEqpt,11,13,7,0,2,1,7,0,30,4.285714285714286,2,0.0,0,7,0,2,13,1,0,7,0,9,21,1
2715,57716,oDMwcP97XCFhatRKDALyEk29j0A66Zee,SpATywNh6bZuzm8s1ceuBUnMUAeoAHHw,6,1,1,0,1,0,5,0,8,1.1428571428571428,2,0.0,0,1,0,1,1,0,0,5,0,2,6,1
2716,57761,tS5yd0InBPlA0CVUCBIjrGWKHeeeibf9,A3fsA9Zfv1X2fVEQhTw51lKENdNrEqT3,33,36,18,48,4,6,15,0,127,18.142857142857142,4,0.0,6,18,45,4,30,6,3,15,0,73,54,0
2717,57796,oieeinmRIRZuvg1KZp8yYpFAojV2pQvR,SpATywNh6bZuzm8s1ceuBUnMUAeoAHHw,9,8,5,0,3,1,6,0,23,3.2857142857142856,1,0.0,0,5,0,3,8,1,0,6,0,8,15,1
2718,57841,7J9JIWVCQG1g6yXh3uTVbrSu3pa18Ezn,bWdj2GDclj5ofokWjzoa5jAwMkxCykd6,10,14,6,6,3,1,3,0,33,4.714285714285714,2,0.0,4,6,6,3,10,1,0,3,0,19,14,1
2719,57843,23LSJ7PS8hJRx4MiulnRK0RfIKtQHqFP,SpATywNh6bZuzm8s1ceuBUnMUAeoAHHw,1,0,0,0,0,0,1,0,1,0.14285714285714285,1,0.0,0,0,0,0,0,0,0,1,0,0,1,1
2720,57857,4dPv5sV5dbfclN0Y8IwI4Ic117ct14yS,SpATywNh6bZuzm8s1ceuBUnMUAeoAHHw,5,3,0,0,0,0,3,0,6,0.8571428571428571,2,0.0,0,0,0,0,3,0,0,3,0,0,6,1
2721,57876,ftjlnmyEYFbgOc72QgwdUJYu6fgVXYpz,A3fsA9Zfv1X2fVEQhTw51lKENdNrEqT3,7,3,2,0,2,0,3,0,10,1.4285714285714286,1,0.0,0,2,0,2,3,0,0,3,0,4,6,1
2722,57907,4lfVtIfwsnJZLFeonBqOpKEgIshst3Yq,SpATywNh6bZuzm8s1ceuBUnMUAeoAHHw,10,27,14,5,9,0,12,0,67,9.571428571428571,3,0.0,6,14,4,9,21,0,1,12,0,33,34,0
2723,57910,se9ZVl8DNkiCW8i2nP0p3krrUcQqYC47,A3fsA9Zfv1X2fVEQhTw51lKENdNrEqT3,22,17,12,10,7,2,14,0,62,8.857142857142858,4,0.0,0,12,10,7,17,2,0,14,0,29,33,0
2724,57952,Axw4HBt3l6GD2DONFf7w1tmix5Mk5VUT,A3fsA9Zfv1X2fVEQhTw51lKENdNrEqT3,13,13,6,0,2,5,11,2,39,5.571428571428571,2,0.0,0,6,0,2,13,5,0,11,2,8,31,1
2725,57987,sqasMoGc0IU5lpNZsO5KtcLYxSWllMxq,RXDvfPUBYFlVdlueBFbLW0mhhAyGEqpt,49,70,20,72,20,22,31,17,252,36.0,3,0.0,21,20,67,20,49,22,5,31,17,128,124,0
2726,58013,Bf025FfgNrlcqN8gYGnmBAhjBy0v5Xmo,bWdj2GDclj5ofokWjzoa5jAwMkxCykd6,12,49,31,0,12,1,18,0,111,15.857142857142858,4,0.0,7,31,0,12,42,1,0,18,0,50,61,1
2727,58025,SJPM6RlM27WGlBQJlWcTA7fvsKmlPxUf,SpATywNh6bZuzm8s1ceuBUnMUAeoAHHw,7,2,1,0,1,0,6,0,10,1.4285714285714286,1,0.0,0,1,0,1,2,0,0,6,0,2,8,1
2728,58062,rGJvvNRNeS4weXphC4pxwlmBwDQi7NXo,SpATywNh6bZuzm8s1ceuBUnMUAeoAHHw,19,29,13,8,9,1,11,2,73,10.428571428571429,2,0.0,12,13,7,9,17,1,1,11,2,41,32,0
2729,58069,nWDRtsdyQI6TNTQknsvrXkgOEaTh8I0k,SpATywNh6bZuzm8s1ceuBUnMUAeoAHHw,25,26,15,16,8,5,5,0,75,10.714285714285714,2,0.0,8,15,16,8,18,5,0,5,0,47,28,0
2730,58142,G2OV1K6QAb8ZlrDRCrLDF7tfA5J7JUDN,SpATywNh6bZuzm8s1ceuBUnMUAeoAHHw,16,25,10,22,4,2,5,0,68,9.714285714285714,2,0.0,8,10,19,4,17,2,3,5,0,41,27,1
2731,58147,GHWD27wG643ibd6OSLThLJ3MzX9fgfxx,A3fsA9Zfv1X2fVEQhTw51lKENdNrEqT3,30,25,16,0,13,0,7,0,61,8.714285714285714,3,0.0,0,16,0,13,25,0,0,7,0,29,32,1
2732,58148,yvxDmdTtwak3ePh9ZZvgT2yHbtqhLJuU,SpATywNh6bZuzm8s1ceuBUnMUAeoAHHw,5,2,1,0,1,0,2,0,6,0.8571428571428571,1,0.0,0,1,0,1,2,0,0,2,0,2,4,1
2733,58156,wXw48gUOB5BEkScgUyQMzs63eq0ygNDQ,RXDvfPUBYFlVdlueBFbLW0mhhAyGEqpt,2,0,0,0,0,0,5,0,5,0.7142857142857143,2,0.0,0,0,0,0,0,0,0,5,0,0,5,1
2734,58162,g2crr0D1YRZspeg3aG0QVrkBBPBltTjz,RXDvfPUBYFlVdlueBFbLW0mhhAyGEqpt,6,4,1,0,0,0,2,0,7,1.0,1,0.0,0,1,0,0,4,0,0,2,0,1,6,0
2735,58172,I4jcIexarcejSCh8gI54DZO3U7SFfRnT,A3fsA9Zfv1X2fVEQhTw51lKENdNrEqT3,3,0,0,0,0,0,4,0,4,0.5714285714285714,1,0.0,0,0,0,0,0,0,0,4,0,0,4,1
2736,58212,ZguimpvCE02pFqkl0KfDAtmrarDM70Qf,SpATywNh6bZuzm8s1ceuBUnMUAeoAHHw,6,3,1,0,0,0,4,0,8,1.1428571428571428,1,0.0,0,1,0,0,3,0,0,4,0,1,7,1
2737,58217,v1amutsyDOYm3WMqvptGI8JyXdvsTElC,SpATywNh6bZuzm8s1ceuBUnMUAeoAHHw,17,35,8,21,2,5,24,4,99,14.142857142857142,4,0.0,9,8,18,2,26,5,3,24,4,37,62,1
2738,58219,edP9uXMvyr9FSmSy32CnOxTQSMqfGr89,bWdj2GDclj5ofokWjzoa5jAwMkxCykd6,14,25,11,154,4,3,6,0,203,29.0,1,0.0,8,11,145,4,17,3,9,6,0,168,35,1
2739,58223,nZTn5dZMRyIKKNGuMbIWH6lpWaWoYX62,A3fsA9Zfv1X2fVEQhTw51lKENdNrEqT3,6,5,0,0,0,2,7,0,14,2.0,1,0.0,0,0,0,0,5,2,0,7,0,0,14,1
2740,58235,L4PW9E8umRTJy4rgt9ZPyCVXzCxIYlU4,SpATywNh6bZuzm8s1ceuBUnMUAeoAHHw,13,22,7,13,1,20,4,0,67,9.571428571428571,2,0.0,12,7,11,1,10,20,2,4,0,31,36,0
2741,58251,9irOSn8DGZwWtwp11aWu1YWsaS4jzhvZ,SpATywNh6bZuzm8s1ceuBUnMUAeoAHHw,5,6,0,0,0,0,2,0,8,1.1428571428571428,2,0.0,0,0,0,0,6,0,0,2,0,0,8,1
2742,58280,5lq0KJvq1lt50dcD5m6Vr40ogvrDdcc4,bWdj2GDclj5ofokWjzoa5jAwMkxCykd6,6,8,5,0,3,0,5,0,21,3.0,2,0.0,0,5,0,3,8,0,0,5,0,8,13,1
2743,58282,Gqs4K8SBL8tl8fMHpBqpJerrgEsieHU3,SpATywNh6bZuzm8s1ceuBUnMUAeoAHHw,29,64,13,25,5,11,16,1,135,19.285714285714285,9,0.0,11,13,24,5,53,11,1,16,1,53,82,0
2744,58305,skJn7dtfSekFrPHRHs9swZ9AtSUKi36u,A3fsA9Zfv1X2fVEQhTw51lKENdNrEqT3,10,16,12,0,2,9,9,0,48,6.857142857142857,5,0.0,0,12,0,2,16,9,0,9,0,14,34,1
2745,58333,e3wUoJuzsENUfMiDHKcPh8dxiNI0W3xf,G8EPVSXsOYB5YQWZGiz1aVq5Pgr2GrQu,12,9,1,22,1,0,2,0,35,5.0,1,0.0,6,1,16,1,3,0,6,2,0,24,11,0
2746,58334,ROctVkWGGi4RH8QWmC2p1iWZZ8pihPaJ,SpATywNh6bZuzm8s1ceuBUnMUAeoAHHw,15,43,8,22,2,14,9,0,98,14.0,5,0.0,9,8,19,2,34,14,3,9,0,38,60,0
2747,58336,LceCGRrY68iwKOq6ziCnmuJ3uxzNypKD,SpATywNh6bZuzm8s1ceuBUnMUAeoAHHw,12,13,4,0,3,0,7,2,29,4.142857142857143,1,0.0,2,4,0,3,11,0,0,7,2,9,20,1
2748,58341,MU4dVyJTD7iIRSTZIdJZ9VoLOxogfKQN,SpATywNh6bZuzm8s1ceuBUnMUAeoAHHw,24,31,18,24,5,1,11,1,91,13.0,7,0.0,6,18,24,5,25,1,0,11,1,53,38,0
2749,58348,n2LjMxx7cFpUJ3R3HfCHwCtJjfcc1KR0,G8EPVSXsOYB5YQWZGiz1aVq5Pgr2GrQu,29,44,30,36,19,2,13,0,144,20.571428571428573,5,0.0,7,30,29,19,37,2,7,13,0,85,59,0
2750,58356,O28nyHG0T9JeDH3GQl7amYJuULZ1QRpo,SpATywNh6bZuzm8s1ceuBUnMUAeoAHHw,12,16,2,14,0,0,4,0,36,5.142857142857143,2,0.0,7,2,12,0,9,0,2,4,0,21,15,1
2751,58385,ewcDv7X6I323ciCMJsU4n4MdvO632A9I,RXDvfPUBYFlVdlueBFbLW0mhhAyGEqpt,10,5,1,15,1,0,2,0,24,3.4285714285714284,1,0.0,1,1,15,1,4,0,0,2,0,18,6,1
2752,58409,TfXAnflKNnQz6DuwkJiGkjk0fNqIcdbb,RXDvfPUBYFlVdlueBFbLW0mhhAyGEqpt,5,0,0,0,0,0,5,1,6,0.8571428571428571,1,0.0,0,0,0,0,0,0,0,5,1,0,6,1
2753,58411,yvRYzlOzyvQRJ6DXF1Anm7UfajnELRZn,A3fsA9Zfv1X2fVEQhTw51lKENdNrEqT3,5,3,0,0,0,1,2,0,6,0.8571428571428571,1,0.0,0,0,0,0,3,1,0,2,0,0,6,1
2754,58414,TfXAnflKNnQz6DuwkJiGkjk0fNqIcdbb,G8EPVSXsOYB5YQWZGiz1aVq5Pgr2GrQu,5,1,0,0,1,0,3,0,5,0.7142857142857143,1,0.0,0,0,0,1,1,0,0,3,0,1,4,1
2755,58419,WuM67GwQW9M3d1mnuGHuvAdo907S9qb5,bWdj2GDclj5ofokWjzoa5jAwMkxCykd6,1,0,0,0,0,0,1,0,1,0.14285714285714285,1,0.0,0,0,0,0,0,0,0,1,0,0,1,1
2756,58428,tuO76fueBYFOMVa8D7FaN7k7B9sFUsap,SpATywNh6bZuzm8s1ceuBUnMUAeoAHHw,5,5,2,0,2,0,2,0,11,1.5714285714285714,1,0.0,0,2,0,2,5,0,0,2,0,4,7,1
2757,58430,Ymf9IGFQ8uCjyMPNR9dFL9vuwfZDvaPV,SpATywNh6bZuzm8s1ceuBUnMUAeoAHHw,26,98,5,33,4,126,28,1,295,42.142857142857146,8,0.0,24,5,29,4,74,126,4,28,1,62,233,0
2758,58458,fgzbUfrTxXYCuiFYTG1cTemcEJUl36an,SpATywNh6bZuzm8s1ceuBUnMUAeoAHHw,29,71,30,23,7,6,28,1,166,23.714285714285715,11,0.0,7,30,22,7,64,6,1,28,1,66,100,0
2759,58467,4ZEbiCstCbPqjH1vXT26zSCciOWvR8I5,G8EPVSXsOYB5YQWZGiz1aVq5Pgr2GrQu,5,2,1,0,1,0,2,0,6,0.8571428571428571,1,0.0,0,1,0,1,2,0,0,2,0,2,4,1
2760,58484,P84G9ZsyavajrfOKINVq0Jyux3TvjGmZ,G8EPVSXsOYB5YQWZGiz1aVq5Pgr2GrQu,7,6,5,12,2,0,2,0,27,3.857142857142857,1,0.0,0,5,10,2,6,0,2,2,0,17,10,1
2761,58509,HRP0Ut3HnZWoD62izV4kICPH3gchormt,SpATywNh6bZuzm8s1ceuBUnMUAeoAHHw,22,37,6,6,3,0,4,0,56,8.0,2,0.0,0,6,6,3,37,0,0,4,0,15,41,0
2762,58535,tdWhb9WfoB7e0A5Gjo7JvSpPeeCoQg77,SpATywNh6bZuzm8s1ceuBUnMUAeoAHHw,27,39,16,22,8,0,7,0,92,13.142857142857142,2,0.0,8,16,21,8,31,0,1,7,0,53,39,0
2763,58572,rFRGZ1wCWpRq5Le1v28DF6OVdqA54N4w,SpATywNh6bZuzm8s1ceuBUnMUAeoAHHw,6,2,0,0,0,0,4,0,6,0.8571428571428571,1,0.0,0,0,0,0,2,0,0,4,0,0,6,1
2764,58576,3mm3mJxVS0eLh8IUtBxaLL8aknBAQjDa,SpATywNh6bZuzm8s1ceuBUnMUAeoAHHw,6,5,0,0,0,0,2,0,7,1.0,1,0.0,0,0,0,0,5,0,0,2,0,0,7,1
2765,58580,likrBm8tgfB2kgdZuLI51EWK70wAYbOl,SpATywNh6bZuzm8s1ceuBUnMUAeoAHHw,4,2,1,0,0,0,2,0,5,0.7142857142857143,1,0.0,0,1,0,0,2,0,0,2,0,1,4,1
2766,58626,AsYvTZR1ylqWCh3nfRxgHS2CzZpeou5v,SpATywNh6bZuzm8s1ceuBUnMUAeoAHHw,30,57,31,33,10,20,30,3,184,26.285714285714285,7,0.0,19,31,31,10,38,20,2,30,3,91,93,0
2767,58628,BvTWqNCI5Vv3DyY42Ht6x5bgcNEbXEjw,SpATywNh6bZuzm8s1ceuBUnMUAeoAHHw,27,28,14,18,8,0,4,0,72,10.285714285714286,6,0.0,4,14,17,8,24,0,1,4,0,43,29,1
2768,58639,GaLDEM0QPnCAP0wDlZ6pkRoEABK9VTLg,bWdj2GDclj5ofokWjzoa5jAwMkxCykd6,4,5,0,0,1,3,1,0,10,1.4285714285714286,1,0.0,2,0,0,1,3,3,0,1,0,3,7,1
2769,58656,OtgLotOlNqEcaPG4XzsiqBelLdYnlk9e,A3fsA9Zfv1X2fVEQhTw51lKENdNrEqT3,33,20,16,32,13,0,1,0,82,11.714285714285714,1,0.0,2,16,32,13,18,0,0,1,0,63,19,1
2770,58661,t8qBiDTvOvYmrxcVIErRuEOf38tywm6t,SpATywNh6bZuzm8s1ceuBUnMUAeoAHHw,31,47,33,26,14,29,17,3,169,24.142857142857142,7,0.0,5,33,20,14,42,29,6,17,3,72,97,0
2771,58690,y9A8XMlmfPaglBBuQFjiuxUOvb1WQu2v,A3fsA9Zfv1X2fVEQhTw51lKENdNrEqT3,12,11,6,0,5,0,8,0,30,4.285714285714286,2,0.0,0,6,0,5,11,0,0,8,0,11,19,1
2772,58716,wvyfPUc1aKmHhDODOwE0BnlNIGHCCfJd,G8EPVSXsOYB5YQWZGiz1aVq5Pgr2GrQu,5,3,1,0,1,0,2,0,7,1.0,1,0.0,0,1,0,1,3,0,0,2,0,2,5,1
2773,58724,QEq8GPuIzTapWcXcWLs8dzh5C4ugJ6qX,G8EPVSXsOYB5YQWZGiz1aVq5Pgr2GrQu,88,168,74,167,39,24,19,2,493,70.42857142857143,7,0.0,75,74,118,39,93,24,49,19,2,306,187,0
2774,58725,kQl6hEKF14dslDmIkyc1xBQGSSHXGS8M,bWdj2GDclj5ofokWjzoa5jAwMkxCykd6,4,0,0,0,0,0,4,1,5,0.7142857142857143,1,0.0,0,0,0,0,0,0,0,4,1,0,5,1
2775,58739,IUn6MADAjAYkGlJisA1WiDvCeNlJd5Xd,bWdj2GDclj5ofokWjzoa5jAwMkxCykd6,8,7,3,0,3,6,2,0,21,3.0,1,0.0,2,3,0,3,5,6,0,2,0,8,13,1
2776,58805,HaNTytYTKLUDOv5j8ZGLMuMeNQsJjViU,SpATywNh6bZuzm8s1ceuBUnMUAeoAHHw,8,8,5,0,4,0,5,0,22,3.142857142857143,2,0.0,1,5,0,4,7,0,0,5,0,10,12,1
2777,58831,f1TK7a3kaFF32JoXcfjlq2WtR27QUBak,SpATywNh6bZuzm8s1ceuBUnMUAeoAHHw,22,22,0,23,0,1,8,1,55,7.857142857142857,1,0.0,8,0,21,0,14,1,2,8,1,29,26,1
2778,58840,uuM5V1CEd7qVq722bOUrzRwoxB5HlAl5,SpATywNh6bZuzm8s1ceuBUnMUAeoAHHw,19,22,12,8,9,0,3,0,54,7.714285714285714,2,0.0,3,12,8,9,19,0,0,3,0,32,22,1
2779,58851,HcP22z9Adhad0eR6ILSXQ1kzpXBgJlCr,bWdj2GDclj5ofokWjzoa5jAwMkxCykd6,17,26,5,68,2,0,8,0,109,15.571428571428571,6,0.0,3,5,60,2,23,0,8,8,0,70,39,1
2780,58853,7wyfXvc1g99QNmXzEb4w8C1vE0Vi2bHm,A3fsA9Zfv1X2fVEQhTw51lKENdNrEqT3,4,2,1,0,1,0,1,0,5,0.7142857142857143,1,0.0,0,1,0,1,2,0,0,1,0,2,3,0
2781,58869,qUEvY9WI1m6Sm8flMRVsOdJpkuUerQfo,A3fsA9Zfv1X2fVEQhTw51lKENdNrEqT3,3,0,0,0,0,0,5,2,7,1.0,1,0.0,0,0,0,0,0,0,0,5,2,0,7,1
2782,58876,KynvXtYIsEUZo4QPbGVWVhUBwzeS3e9w,SpATywNh6bZuzm8s1ceuBUnMUAeoAHHw,11,9,6,0,5,0,3,0,23,3.2857142857142856,2,0.0,0,6,0,5,9,0,0,3,0,11,12,1
2783,58909,BeY1QEJLx8hEoll66FHHZbsUvI2zt7s5,A3fsA9Zfv1X2fVEQhTw51lKENdNrEqT3,1,0,0,0,0,0,1,0,1,0.14285714285714285,1,0.0,0,0,0,0,0,0,0,1,0,0,1,1
2784,58914,DnweC9zfy9ur38RHmjIuaW6oqiFXCgkS,A3fsA9Zfv1X2fVEQhTw51lKENdNrEqT3,39,36,4,82,11,2,4,0,139,19.857142857142858,3,0.0,4,4,69,11,32,2,13,4,0,88,51,1
2785,58922,6HIBebNSnNEoSeekVShzxF3x0IcbgohT,SpATywNh6bZuzm8s1ceuBUnMUAeoAHHw,5,5,0,0,0,0,3,0,8,1.1428571428571428,2,0.0,0,0,0,0,5,0,0,3,0,0,8,1
2786,58970,PvDd5wrDKH5IBJRRd1ycECXD88pHC4R8,SpATywNh6bZuzm8s1ceuBUnMUAeoAHHw,7,6,2,0,1,0,4,0,13,1.8571428571428572,1,0.0,0,2,0,1,6,0,0,4,0,3,10,1
2787,58996,w9HBKKfn4YUOWYdwRHKe80SIWiO37ZMJ,SpATywNh6bZuzm8s1ceuBUnMUAeoAHHw,30,64,32,28,14,1,26,0,165,23.571428571428573,9,0.0,13,32,26,14,51,1,2,26,0,85,80,0
2788,58997,1zErz13s8fNQRVaEvkOtvw6bLhr23yB4,bWdj2GDclj5ofokWjzoa5jAwMkxCykd6,16,28,17,98,2,0,6,0,151,21.571428571428573,4,0.0,3,17,90,2,25,0,8,6,0,112,39,0
2789,59002,yQ30DktO8KD929ApuNMOdNKTtmTpkfc3,G8EPVSXsOYB5YQWZGiz1aVq5Pgr2GrQu,3,0,0,0,0,4,2,0,6,0.8571428571428571,1,0.0,0,0,0,0,0,4,0,2,0,0,6,1
2790,59005,yQ30DktO8KD929ApuNMOdNKTtmTpkfc3,A3fsA9Zfv1X2fVEQhTw51lKENdNrEqT3,3,0,0,0,0,4,2,0,6,0.8571428571428571,1,0.0,0,0,0,0,0,4,0,2,0,0,6,1
2791,59014,D2lFXeOodglgSTRNVccRvVrNvHlYgfLJ,G8EPVSXsOYB5YQWZGiz1aVq5Pgr2GrQu,1,0,0,0,0,0,1,0,1,0.14285714285714285,1,0.0,0,0,0,0,0,0,0,1,0,0,1,1
2792,59018,Sz4iN9vM7plSJObu2Kgng7aJijtNNsts,A3fsA9Zfv1X2fVEQhTw51lKENdNrEqT3,7,12,0,0,0,0,9,0,21,3.0,2,0.0,0,0,0,0,12,0,0,9,0,0,21,1
2793,59056,HPaDTzk2xymxbpoa0VdcxdHl3uFfOfZk,A3fsA9Zfv1X2fVEQhTw51lKENdNrEqT3,11,17,12,0,0,1,27,0,57,8.142857142857142,6,0.0,0,12,0,0,17,1,0,27,0,12,45,1
2794,59064,gzTBwYPoQwnODJJ2vedsUKp2EoGao5Fz,A3fsA9Zfv1X2fVEQhTw51lKENdNrEqT3,2,0,0,0,0,0,4,0,4,0.5714285714285714,3,0.0,0,0,0,0,0,0,0,4,0,0,4,1
2795,59081,QscGDFmAAH7jp4ntcbRqVptjZvFSEe7R,SpATywNh6bZuzm8s1ceuBUnMUAeoAHHw,1,0,0,0,0,0,1,0,1,0.14285714285714285,1,0.0,0,0,0,0,0,0,0,1,0,0,1,1
2796,59085,FJb17GnhVysnDMr4UIVdFwaw18TJ0gzC,A3fsA9Zfv1X2fVEQhTw51lKENdNrEqT3,8,3,2,0,2,0,4,0,11,1.5714285714285714,1,0.0,0,2,0,2,3,0,0,4,0,4,7,1
2797,59087,QscGDFmAAH7jp4ntcbRqVptjZvFSEe7R,A3fsA9Zfv1X2fVEQhTw51lKENdNrEqT3,13,7,6,0,6,0,5,0,24,3.4285714285714284,1,0.0,0,6,0,6,7,0,0,5,0,12,12,1
2798,59099,NXeUyqTgIKYglW6oNMecGCOxIW2GzUKK,bWdj2GDclj5ofokWjzoa5jAwMkxCykd6,2,0,0,0,0,0,5,0,5,0.7142857142857143,1,0.0,0,0,0,0,0,0,0,5,0,0,5,1
2799,59100,Vn4kuqpkxWqlMyrGvyBY4A7iKQdYdIwO,SpATywNh6bZuzm8s1ceuBUnMUAeoAHHw,2,0,0,0,0,0,2,0,2,0.2857142857142857,1,0.0,0,0,0,0,0,0,0,2,0,0,2,1
2800,59102,Vn4kuqpkxWqlMyrGvyBY4A7iKQdYdIwO,A3fsA9Zfv1X2fVEQhTw51lKENdNrEqT3,5,2,1,0,1,0,2,0,6,0.8571428571428571,1,0.0,0,1,0,1,2,0,0,2,0,2,4,1
2801,59118,bEjkLIwm3iSyqTCwCLyh4lFO7vLzJeAj,SpATywNh6bZuzm8s1ceuBUnMUAeoAHHw,33,25,17,29,7,12,19,2,111,15.857142857142858,2,0.0,4,17,27,7,21,12,2,19,2,55,56,0
2802,59132,3LOMe6pmkiIt95Dd5LqCGi1tBreM2BMk,A3fsA9Zfv1X2fVEQhTw51lKENdNrEqT3,6,5,0,0,0,0,3,0,8,1.1428571428571428,2,0.0,0,0,0,0,5,0,0,3,0,0,8,0
2803,59136,3LOMe6pmkiIt95Dd5LqCGi1tBreM2BMk,bWdj2GDclj5ofokWjzoa5jAwMkxCykd6,1,0,0,0,0,0,1,0,1,0.14285714285714285,1,0.0,0,0,0,0,0,0,0,1,0,0,1,1
2804,59137,kqS8BwWN9R1093oeblGkvtCsQJ68Gh0G,bWdj2GDclj5ofokWjzoa5jAwMkxCykd6,6,8,6,0,2,0,3,0,19,2.7142857142857144,2,0.0,0,6,0,2,8,0,0,3,0,8,11,1
2805,60048,BVLL3tf1KrYCKKfxj1p07nnbpn909YvK,7GRhBDsirIGkRZBtSMEzNTyDr2JQm4xx,1,0,0,0,0,0,1,0,1,0.14285714285714285,1,0.0,0,0,0,0,0,0,0,1,0,0,1,0
2806,60082,Yre3ZpWIJIVmlOfN5qpPiUgPhyFZbBYP,7GRhBDsirIGkRZBtSMEzNTyDr2JQm4xx,1,0,0,0,0,0,1,0,1,0.14285714285714285,1,0.0,0,0,0,0,0,0,0,1,0,0,1,1
2807,60085,n63tS6f6RbAUQIT0fHxjepUtvV0en8Ph,7GRhBDsirIGkRZBtSMEzNTyDr2JQm4xx,21,19,1,50,2,0,2,0,74,10.571428571428571,1,0.0,9,1,42,2,10,0,8,2,0,54,20,1
2808,60203,ntJs93C1h80peQsrk4sMYD3xVOjdEHeo,7GRhBDsirIGkRZBtSMEzNTyDr2JQm4xx,98,263,58,173,62,93,29,0,678,96.85714285714286,8,0.0,193,58,160,62,70,93,13,29,0,473,205,0
2809,60281,jzL5Nt58a8ZENNg776MwldmnOh4VPeJQ,7GRhBDsirIGkRZBtSMEzNTyDr2JQm4xx,2,0,0,0,0,0,2,0,2,0.2857142857142857,1,0.0,0,0,0,0,0,0,0,2,0,0,2,1
2810,60353,kf5ROCzcgJvsKj9HScT2CaHiyyffBGek,7GRhBDsirIGkRZBtSMEzNTyDr2JQm4xx,12,6,5,0,5,1,1,0,18,2.5714285714285716,1,0.0,0,5,0,5,6,1,0,1,0,10,8,0
2811,60413,i67qzouvUD7nINgK6d1xrH4pvufZqbFd,7GRhBDsirIGkRZBtSMEzNTyDr2JQm4xx,14,14,0,4,1,0,3,0,22,3.142857142857143,2,0.0,4,0,2,1,10,0,2,3,0,7,15,0
2812,60420,5hts9kMf50L6rxwk0MtgECu1e5TGRRGY,7GRhBDsirIGkRZBtSMEzNTyDr2JQm4xx,29,52,14,33,8,7,15,0,129,18.428571428571427,2,0.0,30,14,30,8,22,7,3,15,0,82,47,1
2813,60528,MvqSmpyUgimv8LaGxWMIruwa3ijANQg7,7GRhBDsirIGkRZBtSMEzNTyDr2JQm4xx,65,86,31,14,37,7,5,0,180,25.714285714285715,1,0.0,51,31,11,37,35,7,3,5,0,130,50,0
2814,60546,uQUPzFXltLm3Yz8qgEvw1fMPbbS4q4MZ,7GRhBDsirIGkRZBtSMEzNTyDr2JQm4xx,18,13,9,0,7,1,6,0,36,5.142857142857143,2,0.0,1,9,0,7,12,1,0,6,0,17,19,1
2815,60582,rxoO7csZGXeNzFVWfGDQB1CjrR87Fi1E,7GRhBDsirIGkRZBtSMEzNTyDr2JQm4xx,1,0,0,0,0,0,1,0,1,0.14285714285714285,1,0.0,0,0,0,0,0,0,0,1,0,0,1,1
2816,60704,yNvoGEAldEGg40wBXPaEulBPVW5wyRH0,7GRhBDsirIGkRZBtSMEzNTyDr2JQm4xx,22,49,9,34,1,0,15,0,108,15.428571428571429,2,0.0,16,9,24,1,33,0,10,15,0,50,58,1
2817,60718,Y7IgoRAqVJfNlsulCSI4HObujHPSzoLA,7GRhBDsirIGkRZBtSMEzNTyDr2JQm4xx,1,0,0,0,0,0,1,0,1,0.14285714285714285,1,0.0,0,0,0,0,0,0,0,1,0,0,1,1
2818,60723,QgvoRraMo579WBSQvu2KL1PVI0ztp4eg,7GRhBDsirIGkRZBtSMEzNTyDr2JQm4xx,23,52,16,0,19,1,2,0,90,12.857142857142858,2,0.0,12,16,0,19,40,1,0,2,0,47,43,0
2819,60741,D8UARtO8PEJDGRGb02jImyINnyDXbx45,7GRhBDsirIGkRZBtSMEzNTyDr2JQm4xx,2,0,0,0,0,0,2,0,2,0.2857142857142857,1,0.0,0,0,0,0,0,0,0,2,0,0,2,1
2820,60955,M3my6svOw1PavchA0YdMglvZWFkBWiG6,7GRhBDsirIGkRZBtSMEzNTyDr2JQm4xx,11,13,4,6,4,3,4,0,34,4.857142857142857,2,0.0,8,4,4,4,5,3,2,4,0,20,14,1
2821,60999,0mQOSUffcJjPsamqb6puS0gzn5BcFgYT,7GRhBDsirIGkRZBtSMEzNTyDr2JQm4xx,7,0,0,0,0,0,12,1,13,1.8571428571428572,2,0.0,0,0,0,0,0,0,0,12,1,0,13,1
2822,61017,fqE9fKOVWr7QYvXsbQOki5x99YlGSz4q,7GRhBDsirIGkRZBtSMEzNTyDr2JQm4xx,1,0,0,0,0,0,2,0,2,0.2857142857142857,1,0.0,0,0,0,0,0,0,0,2,0,0,2,1
2823,61032,2YrfQZgyUPdiZGXhplgKBSkvHochAfw6,7GRhBDsirIGkRZBtSMEzNTyDr2JQm4xx,7,6,4,0,0,0,2,0,12,1.7142857142857142,1,0.0,1,4,0,0,5,0,0,2,0,5,7,1
2824,61034,2Jljmu9EbGTkE1rTEOxUuOimOJr4EGWY,7GRhBDsirIGkRZBtSMEzNTyDr2JQm4xx,37,43,1,39,10,14,5,0,112,16.0,2,0.0,27,1,24,10,16,14,15,5,0,62,50,1
2825,61046,T06O7WnBCRWoH9e9v0RWmUTKobJEYFfL,7GRhBDsirIGkRZBtSMEzNTyDr2JQm4xx,1,0,0,0,0,0,1,0,1,0.14285714285714285,1,0.0,0,0,0,0,0,0,0,1,0,0,1,1
2826,61085,AG6iKV2oiQPN8wTOXQgZ5wPRMFQuNd0H,7GRhBDsirIGkRZBtSMEzNTyDr2JQm4xx,2,0,0,0,0,0,2,0,2,0.2857142857142857,1,0.0,0,0,0,0,0,0,0,2,0,0,2,1
2827,61116,9JKtUaJcAEBh7CYVmXIhRY2O1dODpq4M,7GRhBDsirIGkRZBtSMEzNTyDr2JQm4xx,14,20,7,0,5,0,1,0,33,4.714285714285714,1,0.0,2,7,0,5,18,0,0,1,0,14,19,1
2828,61118,pGlV0XYWRjXFSIdN56x9p6AvQyXwsZVS,7GRhBDsirIGkRZBtSMEzNTyDr2JQm4xx,51,68,32,119,10,22,8,0,259,37.0,5,0.0,26,32,98,10,42,22,21,8,0,166,93,0
2829,61157,ZgFCLkDPzcdiy0sIzPjvfQAgjdD1TUt9,7GRhBDsirIGkRZBtSMEzNTyDr2JQm4xx,37,88,34,33,33,0,9,0,197,28.142857142857142,2,0.0,42,34,20,33,46,0,13,9,0,129,68,0
2830,61191,3aCvKfVcHo3o7tH4s5PG9YBIGdvHDxQN,7GRhBDsirIGkRZBtSMEzNTyDr2JQm4xx,5,2,1,0,1,1,4,0,9,1.2857142857142858,1,0.0,0,1,0,1,2,1,0,4,0,2,7,1
2831,61231,KkdnagFJtwwq5n9Iuy7rnQaTqa2llFa9,7GRhBDsirIGkRZBtSMEzNTyDr2JQm4xx,1,0,0,0,0,0,1,0,1,0.14285714285714285,1,0.0,0,0,0,0,0,0,0,1,0,0,1,1
2832,61249,4BrxxQsWWJwGRocTSsfalu4whQ4Xfcpc,7GRhBDsirIGkRZBtSMEzNTyDr2JQm4xx,5,2,1,0,1,0,3,0,7,1.0,2,0.0,0,1,0,1,2,0,0,3,0,2,5,1
2833,61255,pZf9C3kBoPRYrDIubyGYbLZN4CZgU7xr,7GRhBDsirIGkRZBtSMEzNTyDr2JQm4xx,6,4,2,0,1,0,2,0,9,1.2857142857142858,1,0.0,2,2,0,1,2,0,0,2,0,5,4,1
2834,61260,cKCzrCCCXe9nkBgWepq9AEXje7SITRTz,7GRhBDsirIGkRZBtSMEzNTyDr2JQm4xx,1,0,0,0,0,0,1,0,1,0.14285714285714285,1,0.0,0,0,0,0,0,0,0,1,0,0,1,1
2835,61594,gAvRDaA2RH7LeyEqnpEQ7DzPuz3btZqk,SpATywNh6bZuzm8s1ceuBUnMUAeoAHHw,22,28,13,14,0,7,7,1,70,10.0,4,0.0,13,13,13,0,15,7,1,7,1,39,31,0
2836,61595,3rZRyyAqQR0LHT7iXSTyhR4wZI7IzOpN,SpATywNh6bZuzm8s1ceuBUnMUAeoAHHw,22,28,1,27,1,0,6,0,63,9.0,3,0.0,8,1,25,1,20,0,2,6,0,35,28,0
2837,61601,gLjUrp9o3bBy4JIhHE7DImScxZdU76o3,bWdj2GDclj5ofokWjzoa5jAwMkxCykd6,36,30,16,108,9,0,2,0,165,23.571428571428573,7,0.0,8,16,96,9,22,0,12,2,0,129,36,0
2838,61613,gF4BAuOIIfmyUL9KgVWqdIaoDpcXFfvU,SpATywNh6bZuzm8s1ceuBUnMUAeoAHHw,19,63,19,18,5,0,9,0,114,16.285714285714285,3,0.0,9,19,16,5,54,0,2,9,0,49,65,1
2839,61633,nAYvdcBZT3LBrha8JRPtv9HcsoTpFg23,SpATywNh6bZuzm8s1ceuBUnMUAeoAHHw,7,5,1,16,0,0,2,0,24,3.4285714285714284,1,0.0,2,1,14,0,3,0,2,2,0,17,7,0
2840,61645,SFn8cPDrlBEOeUqlExt2aQA0JeO7ehU8,7GRhBDsirIGkRZBtSMEzNTyDr2JQm4xx,7,3,2,0,2,0,3,0,10,1.4285714285714286,1,0.0,0,2,0,2,3,0,0,3,0,4,6,1
2841,61783,9y6ouBDNmbaFfULhDrj0DUptWL9j98bK,A3fsA9Zfv1X2fVEQhTw51lKENdNrEqT3,9,4,2,0,2,0,5,0,13,1.8571428571428572,1,0.0,0,2,0,2,4,0,0,5,0,4,9,1
2842,61786,CE534SSZ9CscDvjbZWQWNUmxhQozf8Uw,SpATywNh6bZuzm8s1ceuBUnMUAeoAHHw,16,35,20,22,6,0,4,0,87,12.428571428571429,3,0.0,11,20,17,6,24,0,5,4,0,54,33,0
2843,61798,C912XMR2YQ2SiCcqNj7moioYbFr61u4G,SpATywNh6bZuzm8s1ceuBUnMUAeoAHHw,29,45,25,26,9,20,7,0,132,18.857142857142858,2,0.0,9,25,20,9,36,20,6,7,0,63,69,0
2844,61807,6ewbhsgJh7NTFUpGTc6v0or3nCOYP5Dz,7GRhBDsirIGkRZBtSMEzNTyDr2JQm4xx,1,0,0,0,0,0,1,0,1,0.14285714285714285,1,0.0,0,0,0,0,0,0,0,1,0,0,1,1
2845,61841,Oqve774ifHTeH2UMCaBdRSrpGoboQSMz,7GRhBDsirIGkRZBtSMEzNTyDr2JQm4xx,2,0,0,0,0,0,2,0,2,0.2857142857142857,1,0.0,0,0,0,0,0,0,0,2,0,0,2,1
2846,61871,P3kOv3cSNYdczGGa8D095f64NMPEAkCq,7GRhBDsirIGkRZBtSMEzNTyDr2JQm4xx,13,17,1,10,0,2,10,2,42,6.0,1,0.0,6,1,8,0,11,2,2,10,2,15,27,0
2847,61873,GjYrFH6x4o6vyLHEw4EuuSJvAfuLPk1y,SpATywNh6bZuzm8s1ceuBUnMUAeoAHHw,29,44,22,30,11,0,9,0,116,16.571428571428573,4,0.0,17,22,24,11,27,0,6,9,0,74,42,0
2848,61901,kMbNfi6zi59dGBz5Mew0yipwDJ0jO4S2,7GRhBDsirIGkRZBtSMEzNTyDr2JQm4xx,34,72,31,34,32,6,15,2,192,27.428571428571427,3,0.0,31,31,29,32,41,6,5,15,2,123,69,1
2849,61902,q2vdNmhZGOp0NF57Oy2lI01Qgjw4Vdei,SpATywNh6bZuzm8s1ceuBUnMUAeoAHHw,8,17,12,0,7,0,4,0,40,5.714285714285714,3,0.0,1,12,0,7,16,0,0,4,0,20,20,1
2850,61904,zt8D4cN45BQ8WOokF7iya4FQJ1n05JY2,SpATywNh6bZuzm8s1ceuBUnMUAeoAHHw,7,8,6,0,0,0,2,0,16,2.2857142857142856,1,0.0,0,6,0,0,8,0,0,2,0,6,10,0
2851,61940,gaDguOzhGUiRAlt47AbgfmnftuQ8EhI2,SpATywNh6bZuzm8s1ceuBUnMUAeoAHHw,27,49,20,39,8,44,10,1,171,24.428571428571427,1,0.0,15,20,33,8,34,44,6,10,1,76,95,1
2852,62017,2YGBvXv59qjJLs5KOOScSmZh8Ujmphvd,7GRhBDsirIGkRZBtSMEzNTyDr2JQm4xx,7,12,5,0,1,1,2,0,21,3.0,2,0.0,4,5,0,1,8,1,0,2,0,10,11,1
2853,62025,PDbQl9kvVSEqhb3jM3LOTLEyGnuh6urj,SpATywNh6bZuzm8s1ceuBUnMUAeoAHHw,21,32,19,3,9,0,10,0,73,10.428571428571429,2,0.0,3,19,3,9,29,0,0,10,0,34,39,0
2854,62027,NcracMTfiaTPMbO6SSDnt9CDc4SnvBs9,bWdj2GDclj5ofokWjzoa5jAwMkxCykd6,53,38,19,122,10,11,20,2,222,31.714285714285715,5,0.0,10,19,115,10,28,11,7,20,2,154,68,0
2855,62042,ml2yAwYHzufxZ6xJCtzUFr2eNYyPECGG,SpATywNh6bZuzm8s1ceuBUnMUAeoAHHw,22,36,19,27,8,0,3,0,93,13.285714285714286,1,0.0,14,19,24,8,22,0,3,3,0,65,28,1
2856,62069,2Hz2Bz07sxK2sow8U4zT67rsa0lMVzzp,7GRhBDsirIGkRZBtSMEzNTyDr2JQm4xx,1,0,0,0,0,0,1,0,1,0.14285714285714285,1,0.0,0,0,0,0,0,0,0,1,0,0,1,1
2857,62071,gRHI1NeWW3c6BFrZIrJSlWu9NHDjRltm,7GRhBDsirIGkRZBtSMEzNTyDr2JQm4xx,1,0,0,0,0,0,1,0,1,0.14285714285714285,1,0.0,0,0,0,0,0,0,0,1,0,0,1,1
2858,62101,uJIh67cllxQLgAhipzdDZMEunDbuBxvF,SpATywNh6bZuzm8s1ceuBUnMUAeoAHHw,25,22,16,4,7,5,8,1,63,9.0,2,0.0,3,16,4,7,19,5,0,8,1,30,33,0
2859,62128,R2cga9JVVM2tXEVs2saYswslfxAU4nMk,A3fsA9Zfv1X2fVEQhTw51lKENdNrEqT3,14,15,11,2,3,0,10,0,41,5.857142857142857,7,0.0,1,11,2,3,14,0,0,10,0,17,24,1
2860,62140,WmzYkzlMNuHgERGSMthySa2d3K7cWcp2,7GRhBDsirIGkRZBtSMEzNTyDr2JQm4xx,12,7,5,0,4,0,4,0,20,2.857142857142857,1,0.0,0,5,0,4,7,0,0,4,0,9,11,1
2861,62169,9t1Jq485XoOlmuEU542k0g35doAqmykj,SpATywNh6bZuzm8s1ceuBUnMUAeoAHHw,7,8,5,0,2,0,2,0,17,2.4285714285714284,1,0.0,0,5,0,2,8,0,0,2,0,7,10,0
2862,62213,QbN1rcT6X70kGcCCu9qHO2zQXGCyhPMc,SpATywNh6bZuzm8s1ceuBUnMUAeoAHHw,20,29,16,12,8,0,8,0,73,10.428571428571429,3,0.0,3,16,9,8,26,0,3,8,0,36,37,1
2863,62214,P9ocaJAKrVY3fEwlpYkQdiICF2x4gV0B,7GRhBDsirIGkRZBtSMEzNTyDr2JQm4xx,5,6,3,0,2,1,1,0,13,1.8571428571428572,1,0.0,1,3,0,2,5,1,0,1,0,6,7,0
2864,62254,X4KSPkBIdPEeXdEy4Fa5NvixCQZdfNj3,SpATywNh6bZuzm8s1ceuBUnMUAeoAHHw,23,19,11,24,4,5,3,0,66,9.428571428571429,2,0.0,5,11,19,4,14,5,5,3,0,39,27,1
2865,62312,l4QykzFcC41mVGOdUpTYCbuYnqmkZCXe,SpATywNh6bZuzm8s1ceuBUnMUAeoAHHw,18,35,1,36,0,0,1,0,73,10.428571428571429,1,0.0,21,1,33,0,14,0,3,1,0,55,18,0
2866,62334,mxPD6RdGoMu7JHsQZE9N0YGZHXBsDKre,7GRhBDsirIGkRZBtSMEzNTyDr2JQm4xx,6,1,1,0,1,0,4,0,7,1.0,1,0.0,0,1,0,1,1,0,0,4,0,2,5,1
2867,62335,o4bCCaWBA9uHbyXIM2IOJcgIkEya6ZFa,SpATywNh6bZuzm8s1ceuBUnMUAeoAHHw,4,2,0,0,0,0,3,0,5,0.7142857142857143,1,0.0,0,0,0,0,2,0,0,3,0,0,5,0
2868,62349,YBtKAFQt6fk6EIukc4Ut5J2kdzYxomaP,SpATywNh6bZuzm8s1ceuBUnMUAeoAHHw,18,40,26,15,18,0,13,0,112,16.0,4,0.0,6,26,12,18,34,0,3,13,0,62,50,1
2869,62356,wjS8ie6ACTxewSCQo7zpBy0tu4z4RYPD,SpATywNh6bZuzm8s1ceuBUnMUAeoAHHw,23,38,1,36,0,1,30,1,107,15.285714285714286,7,0.0,8,1,30,0,30,1,6,30,1,39,68,0
2870,62360,g1maG24WsPdpEOMuZUsxQc7SlEYHJjT4,bWdj2GDclj5ofokWjzoa5jAwMkxCykd6,6,9,4,0,2,0,4,0,19,2.7142857142857144,2,0.0,2,4,0,2,7,0,0,4,0,8,11,0
2871,62368,4ct6kljhf27XSdXxxeVXKJL0lQ4aKOK7,7GRhBDsirIGkRZBtSMEzNTyDr2JQm4xx,20,43,4,10,1,0,15,0,73,10.428571428571429,3,0.0,5,4,8,1,38,0,2,15,0,18,55,1
2872,62381,m2GM5nfba5AfGmEJzump9yjCc3h5OBqL,SpATywNh6bZuzm8s1ceuBUnMUAeoAHHw,4,3,1,0,1,0,1,0,6,0.8571428571428571,1,0.0,0,1,0,1,3,0,0,1,0,2,4,1
2873,62396,jGKZSsHerE5dciVNZBuJOf3EyWVEldkX,7GRhBDsirIGkRZBtSMEzNTyDr2JQm4xx,1,0,0,0,0,0,1,0,1,0.14285714285714285,1,0.0,0,0,0,0,0,0,0,1,0,0,1,1
2874,62410,rORIPSFi0Cq6NYeD2hhC73kNxeeqmFyP,7GRhBDsirIGkRZBtSMEzNTyDr2JQm4xx,3,2,0,0,0,0,1,0,3,0.42857142857142855,1,0.0,0,0,0,0,2,0,0,1,0,0,3,1
2875,62428,Y5CSlxjOPHMFV7ik3pSpx6t0PJdYKnrH,SpATywNh6bZuzm8s1ceuBUnMUAeoAHHw,27,26,16,14,8,5,8,0,77,11.0,5,0.0,7,16,12,8,19,5,2,8,0,43,34,0
2876,62437,vhnbHBui7nCh3pAshTJ2BoFD1CEurx5q,SpATywNh6bZuzm8s1ceuBUnMUAeoAHHw,24,47,9,19,6,1,17,5,104,14.857142857142858,9,0.0,5,9,16,6,42,1,3,17,5,36,68,0
2877,62443,ogzXep3azQvjQ2uIPIxw4TZLNiUXYlgD,A3fsA9Zfv1X2fVEQhTw51lKENdNrEqT3,9,15,11,0,2,0,3,0,31,4.428571428571429,2,0.0,0,11,0,2,15,0,0,3,0,13,18,0
2878,62457,k3z8wjqNUcBUtJc11ZY5CI3syE6W1pg9,SpATywNh6bZuzm8s1ceuBUnMUAeoAHHw,8,3,2,0,2,0,4,0,11,1.5714285714285714,1,0.0,0,2,0,2,3,0,0,4,0,4,7,0
2879,62458,j8vYdYwa9gvt7hkF8dykZR2D4h75QsII,SpATywNh6bZuzm8s1ceuBUnMUAeoAHHw,24,41,17,42,4,10,12,1,127,18.142857142857142,4,0.0,19,17,36,4,22,10,6,12,1,76,51,1
2880,62484,l0WeYpTymokLlVEEJTixsYdgJaxPgZqy,7GRhBDsirIGkRZBtSMEzNTyDr2JQm4xx,2,0,0,0,0,0,2,0,2,0.2857142857142857,2,0.0,0,0,0,0,0,0,0,2,0,0,2,1
2881,62490,GWSq56qmQUucFgSgP2raEZeoKP7Athee,SpATywNh6bZuzm8s1ceuBUnMUAeoAHHw,21,80,0,30,0,9,14,1,134,19.142857142857142,5,0.0,6,0,29,0,74,9,1,14,1,35,99,0
2882,62514,ggEr2STKTwtSSUdtGCmiPr3DBu3TJ34B,A3fsA9Zfv1X2fVEQhTw51lKENdNrEqT3,10,7,1,8,0,0,2,0,18,2.5714285714285716,2,0.0,0,1,8,0,7,0,0,2,0,9,9,1
2883,62530,l7f4vHvlZkxCYoU9qM63V45bmndBSeZQ,SpATywNh6bZuzm8s1ceuBUnMUAeoAHHw,13,12,4,28,0,0,4,0,48,6.857142857142857,2,0.0,4,4,24,0,8,0,4,4,0,32,16,0
2884,62557,7FBwqoodmzhvrGGLuwBjRrxsykocUv8u,bWdj2GDclj5ofokWjzoa5jAwMkxCykd6,14,8,3,22,3,2,9,1,48,6.857142857142857,1,0.0,4,3,21,3,4,2,1,9,1,31,17,1
2885,62576,ogmMRCX7tMP9zl6WROraIuGWloPIZQ3P,SpATywNh6bZuzm8s1ceuBUnMUAeoAHHw,31,42,25,17,12,27,11,3,137,19.571428571428573,3,0.0,13,25,16,12,29,27,1,11,3,66,71,1
2886,62593,fBjkk55LEjUXpgvkPNjyZGCtR2am4TcN,SpATywNh6bZuzm8s1ceuBUnMUAeoAHHw,25,37,21,16,12,0,7,0,93,13.285714285714286,5,0.0,3,21,15,12,34,0,1,7,0,51,42,0
2887,62611,i2NIot2usiDyEsWQY7zT18X1uj2FHoWH,7GRhBDsirIGkRZBtSMEzNTyDr2JQm4xx,31,38,8,71,12,0,2,0,131,18.714285714285715,1,0.0,30,8,62,12,8,0,9,2,0,112,19,1
2888,62642,uoDWDjctsplt3HhO40cJ31SItxonwlgR,SpATywNh6bZuzm8s1ceuBUnMUAeoAHHw,8,8,3,0,2,1,3,0,17,2.4285714285714284,2,0.0,1,3,0,2,7,1,0,3,0,6,11,1
2889,62648,tUrqZSUN7RW61T1PpyF2X9YW8Ok3vUek,A3fsA9Zfv1X2fVEQhTw51lKENdNrEqT3,4,2,1,0,1,0,1,0,5,0.7142857142857143,1,0.0,0,1,0,1,2,0,0,1,0,2,3,1
2890,62655,8qABUnBBHxxZkfUhEQNUn5NNMSRrqvPC,SpATywNh6bZuzm8s1ceuBUnMUAeoAHHw,12,38,16,23,0,0,6,0,83,11.857142857142858,4,0.0,16,16,20,0,22,0,3,6,0,52,31,1
2891,62664,6rvhZ1qSfYtmyLXdh13xI1z8Ly1xy1X7,A3fsA9Zfv1X2fVEQhTw51lKENdNrEqT3,2,0,0,0,0,0,2,0,2,0.2857142857142857,1,0.0,0,0,0,0,0,0,0,2,0,0,2,1
2892,62695,N0Sos51WanCzoSGKDmMPzQtMlLxY3bFb,A3fsA9Zfv1X2fVEQhTw51lKENdNrEqT3,101,98,55,214,23,83,70,5,548,78.28571428571429,10,0.0,8,55,178,23,90,83,36,70,5,264,284,0
2893,62751,RjUWkdPtbuKazr3SZ8iaujuOx2ne7ey1,7GRhBDsirIGkRZBtSMEzNTyDr2JQm4xx,30,54,23,26,17,23,7,1,151,21.571428571428573,3,0.0,24,23,26,17,30,23,0,7,1,90,61,0
2894,62780,7lWGgkVC73zkYVnYZAzOXyCIO3N3M6br,SpATywNh6bZuzm8s1ceuBUnMUAeoAHHw,25,38,13,20,6,1,9,0,87,12.428571428571429,6,0.0,11,13,17,6,27,1,3,9,0,47,40,0
2895,62788,N24rIsVu8N2zgaIu1cFWHYg7IEXvRm7B,SpATywNh6bZuzm8s1ceuBUnMUAeoAHHw,6,3,1,0,1,0,2,0,7,1.0,1,0.0,0,1,0,1,3,0,0,2,0,2,5,0
2896,62790,wLyViiqrdSPB3KP8OihPcsmMpcPB2yFu,7GRhBDsirIGkRZBtSMEzNTyDr2JQm4xx,6,3,1,0,1,0,2,0,7,1.0,1,0.0,0,1,0,1,3,0,0,2,0,2,5,1
2897,62810,jkLf5s9Tdb22fUhtxgRjd7TDlKmc2OGK,A3fsA9Zfv1X2fVEQhTw51lKENdNrEqT3,7,3,2,0,2,0,2,0,9,1.2857142857142858,2,0.0,0,2,0,2,3,0,0,2,0,4,5,1
2898,62822,LJYBef7iIBiSZz8D7KTtMTsdkyd91gnR,7GRhBDsirIGkRZBtSMEzNTyDr2JQm4xx,1,0,0,0,0,0,1,0,1,0.14285714285714285,1,0.0,0,0,0,0,0,0,0,1,0,0,1,1
2899,62834,TfNQptQajWTQqzlzDAn72SRQxELYzNd4,SpATywNh6bZuzm8s1ceuBUnMUAeoAHHw,14,35,2,21,1,31,9,1,100,14.285714285714286,4,0.0,12,2,18,1,23,31,3,9,1,33,67,0
2900,62835,Wx4OW1b1MfVESAexiltid2V2dN7xsH1D,SpATywNh6bZuzm8s1ceuBUnMUAeoAHHw,5,17,1,0,0,2,1,0,21,3.0,2,0.0,1,1,0,0,16,2,0,1,0,2,19,0
2901,62888,mne1Bu1F2f0U7iravmS4eQYQtLTkVvPe,7GRhBDsirIGkRZBtSMEzNTyDr2JQm4xx,1,0,0,0,0,0,1,0,1,0.14285714285714285,1,0.0,0,0,0,0,0,0,0,1,0,0,1,1
2902,62900,eS5XywA64oauZkENyWLpeVNsSbZFhj1k,7GRhBDsirIGkRZBtSMEzNTyDr2JQm4xx,4,2,1,0,1,0,1,0,5,0.7142857142857143,1,0.0,0,1,0,1,2,0,0,1,0,2,3,0
2903,62902,ukCIrv5h45nbdIEPPmMlvipT87B8fFE7,7GRhBDsirIGkRZBtSMEzNTyDr2JQm4xx,1,0,0,0,0,0,1,0,1,0.14285714285714285,1,0.0,0,0,0,0,0,0,0,1,0,0,1,1
2904,62936,l6huwkyakLvA9G4ixwxpAcJxBdbbcmJP,SpATywNh6bZuzm8s1ceuBUnMUAeoAHHw,30,51,21,35,10,4,16,1,138,19.714285714285715,6,0.0,23,21,29,10,28,4,6,16,1,83,55,0
2905,62938,eLqag6twmL6nT6SLVrpY07QGG3bytKwe,SpATywNh6bZuzm8s1ceuBUnMUAeoAHHw,10,22,3,0,2,1,12,1,41,5.857142857142857,6,0.0,0,3,0,2,22,1,0,12,1,5,36,0
2906,62970,RS564zscXajJOiW9woDtEu4M9LDaNEPd,7GRhBDsirIGkRZBtSMEzNTyDr2JQm4xx,28,32,15,0,11,0,5,0,63,9.0,4,0.0,0,15,0,11,32,0,0,5,0,26,37,1
2907,62985,SDq3f6KWdckVLJCSJxIwedwz5gfJhoTJ,SpATywNh6bZuzm8s1ceuBUnMUAeoAHHw,20,41,18,18,3,12,15,1,108,15.428571428571429,5,0.0,15,18,15,3,26,12,3,15,1,51,57,1
2908,63008,MjjHVlUuOHpErRpbxsSv5C4Ujl4db690,bWdj2GDclj5ofokWjzoa5jAwMkxCykd6,24,16,0,126,0,7,1,0,150,21.428571428571427,1,0.0,4,0,119,0,12,7,7,1,0,123,27,1
2909,63072,TvDWPoJyTprTu0vxto5NxLIJOfQBmxVE,7GRhBDsirIGkRZBtSMEzNTyDr2JQm4xx,38,107,3,38,6,7,18,1,180,25.714285714285715,6,0.0,23,3,30,6,84,7,8,18,1,62,118,0
2910,63124,8nlNDsWSaxHCvsMKtqhBs81sknEiTCeb,A3fsA9Zfv1X2fVEQhTw51lKENdNrEqT3,32,21,17,0,12,0,6,0,56,8.0,3,0.0,0,17,0,12,21,0,0,6,0,29,27,0
2911,63161,CcZ2EQGxkq4lhEIujCU8FZkit7DT7C79,7GRhBDsirIGkRZBtSMEzNTyDr2JQm4xx,5,0,0,0,0,0,5,1,6,0.8571428571428571,2,0.0,0,0,0,0,0,0,0,5,1,0,6,0
2912,63187,CTfjOlWW4k8IhTEXOJYJ7bo74K8z07kZ,A3fsA9Zfv1X2fVEQhTw51lKENdNrEqT3,2,0,0,0,0,0,3,0,3,0.42857142857142855,1,0.0,0,0,0,0,0,0,0,3,0,0,3,0
2913,63242,jzQypdHgDGImzo6sjFmv4z8itS7CTk6P,7GRhBDsirIGkRZBtSMEzNTyDr2JQm4xx,33,105,2,88,9,9,26,2,241,34.42857142857143,4,0.0,47,2,75,9,58,9,13,26,2,133,108,1
2914,63271,DHenWrxVzReZszxo1qw3Im0Zj99tiAII,A3fsA9Zfv1X2fVEQhTw51lKENdNrEqT3,46,37,23,56,12,32,17,1,178,25.428571428571427,6,0.0,3,23,49,12,34,32,7,17,1,87,91,0
2915,63299,HvCZ1bV9L7D0erySzp1UH1mW8tuWfYPw,7GRhBDsirIGkRZBtSMEzNTyDr2JQm4xx,32,68,21,43,12,18,10,0,172,24.571428571428573,3,0.0,24,21,34,12,44,18,9,10,0,91,81,1
2916,63317,cCSfok1u0ViZa45fCaFvMzY0bswyqxIC,7GRhBDsirIGkRZBtSMEzNTyDr2JQm4xx,1,0,0,0,0,0,1,0,1,0.14285714285714285,1,0.0,0,0,0,0,0,0,0,1,0,0,1,1
2917,63322,Q7wqVDqz10tk4xe6QnkzI1dJqMLzdK4Z,7GRhBDsirIGkRZBtSMEzNTyDr2JQm4xx,18,52,14,8,6,1,12,0,93,13.285714285714286,6,0.0,34,14,5,6,18,1,3,12,0,59,34,0
2918,63368,UkY8GL1wnGxl65A7vEeGH2v9yDS6ABDQ,7GRhBDsirIGkRZBtSMEzNTyDr2JQm4xx,1,0,0,0,0,0,1,0,1,0.14285714285714285,1,0.0,0,0,0,0,0,0,0,1,0,0,1,1
2919,63379,jSPgiXDCISXGmLFuOlDszBfMRRboKynI,7GRhBDsirIGkRZBtSMEzNTyDr2JQm4xx,7,6,3,0,2,0,2,0,13,1.8571428571428572,2,0.0,0,3,0,2,6,0,0,2,0,5,8,1
2920,63427,OcEwAP7KVM22YlzUoPdivyTSWtkZ4qVM,7GRhBDsirIGkRZBtSMEzNTyDr2JQm4xx,2,0,0,0,0,0,5,0,5,0.7142857142857143,2,0.0,0,0,0,0,0,0,0,5,0,0,5,1
2921,63439,YPxQmDfYnmHgiT7CBa1xK3KUyMZAnQfd,7GRhBDsirIGkRZBtSMEzNTyDr2JQm4xx,10,5,3,4,3,0,2,0,17,2.4285714285714284,1,0.0,1,3,4,3,4,0,0,2,0,11,6,1
2922,63461,4TtGjmtd4ISORDD5okRgx7kXAcGUW8IN,7GRhBDsirIGkRZBtSMEzNTyDr2JQm4xx,67,132,53,118,39,27,44,0,413,59.0,10,0.0,69,53,98,39,63,27,20,44,0,259,154,0
2923,63529,DPNeCmHDELHrss8mkRKEcvkApu8OfWuh,7GRhBDsirIGkRZBtSMEzNTyDr2JQm4xx,6,3,2,0,2,0,1,0,8,1.1428571428571428,1,0.0,0,2,0,2,3,0,0,1,0,4,4,1
2924,63565,AumBArZbFsuZrJ22dCd66gJYrxhP9K8S,7GRhBDsirIGkRZBtSMEzNTyDr2JQm4xx,6,2,1,0,1,0,4,0,8,1.1428571428571428,1,0.0,0,1,0,1,2,0,0,4,0,2,6,1
2925,63568,ibHntt3xSwry6DyouiN0fYSmzCgepI7L,7GRhBDsirIGkRZBtSMEzNTyDr2JQm4xx,5,2,1,0,1,0,2,0,6,0.8571428571428571,1,0.0,0,1,0,1,2,0,0,2,0,2,4,1
2926,63569,oioEx16Qafdl8cwDYVMh95PwtEgk5wrw,7GRhBDsirIGkRZBtSMEzNTyDr2JQm4xx,6,7,0,7,0,0,2,0,16,2.2857142857142856,1,0.0,1,0,6,0,6,0,1,2,0,7,9,1
2927,63576,7MQqMUzAoBFEcqTatVu5Epa9H5xTJ6XT,A3fsA9Zfv1X2fVEQhTw51lKENdNrEqT3,97,49,36,164,23,3,15,1,291,41.57142857142857,5,0.0,4,36,147,23,45,3,17,15,1,210,81,0
2928,63602,d0OQm2fl37nUvfl8Q7XxAwON3v0i0KHs,7GRhBDsirIGkRZBtSMEzNTyDr2JQm4xx,1,0,0,0,0,0,1,0,1,0.14285714285714285,1,0.0,0,0,0,0,0,0,0,1,0,0,1,1
2929,63687,dtbXtMjPqeEvzoZBFe2y9uSDcjL0lnx2,A3fsA9Zfv1X2fVEQhTw51lKENdNrEqT3,71,138,37,147,24,30,38,1,415,59.285714285714285,8,0.0,9,37,120,24,129,30,27,38,1,190,225,0
2930,63698,uA8SH3KKGTykRcaxzO63OBZZtTvabLlI,7GRhBDsirIGkRZBtSMEzNTyDr2JQm4xx,7,3,1,0,1,0,3,0,8,1.1428571428571428,1,0.0,0,1,0,1,3,0,0,3,0,2,6,1
2931,63703,GulRMWFcPY5JE8HNbJPRyRdVqJqL2eEA,A3fsA9Zfv1X2fVEQhTw51lKENdNrEqT3,6,2,0,0,0,0,5,0,7,1.0,1,0.0,0,0,0,0,2,0,0,5,0,0,7,0
2932,63880,4RiemE5r88jWq9gaL0lVYzjeUhWq3sNP,7GRhBDsirIGkRZBtSMEzNTyDr2JQm4xx,2,0,0,0,0,0,3,0,3,0.42857142857142855,1,0.0,0,0,0,0,0,0,0,3,0,0,3,1
2933,63903,4RiemE5r88jWq9gaL0lVYzjeUhWq3sNP,A3fsA9Zfv1X2fVEQhTw51lKENdNrEqT3,9,4,3,0,3,0,2,0,12,1.7142857142857142,1,0.0,0,3,0,3,4,0,0,2,0,6,6,1
2934,63975,vSoHqjlgOX9Gp12iQzdBUtqEoI4dyxq9,7GRhBDsirIGkRZBtSMEzNTyDr2JQm4xx,1,0,0,0,0,0,1,0,1,0.14285714285714285,1,0.0,0,0,0,0,0,0,0,1,0,0,1,1
2935,63986,kYf958xQgpYsrp0Tv3pEoO2XCYRj674R,7GRhBDsirIGkRZBtSMEzNTyDr2JQm4xx,7,3,2,0,0,1,6,1,13,1.8571428571428572,1,0.0,0,2,0,0,3,1,0,6,1,2,11,1
2936,64056,dpaGOQqV12WO7eNeCUpu7DUPmdhwuEC5,7GRhBDsirIGkRZBtSMEzNTyDr2JQm4xx,1,0,0,0,0,0,1,0,1,0.14285714285714285,1,0.0,0,0,0,0,0,0,0,1,0,0,1,1
2937,64152,e6qJWnBH5Aakpza4HlA3Q0irc2hEFZ0M,7GRhBDsirIGkRZBtSMEzNTyDr2JQm4xx,9,9,1,0,1,0,4,0,15,2.142857142857143,2,0.0,0,1,0,1,9,0,0,4,0,2,13,1
2938,65669,YXA6PyHIufuhVR6DkHMJ9uQ5pDJwufmy,7GRhBDsirIGkRZBtSMEzNTyDr2JQm4xx,4,3,0,0,0,0,2,0,5,0.7142857142857143,1,0.0,0,0,0,0,3,0,0,2,0,0,5,1
2939,65718,aPDsc8X2fcDutxzM0D9vmuKFKeVLb7iC,7GRhBDsirIGkRZBtSMEzNTyDr2JQm4xx,9,19,5,6,5,1,5,0,41,5.857142857142857,2,0.0,9,5,5,5,10,1,1,5,0,24,17,1
2940,65754,d7lqWAJ8cu1e9f8Lb1eNhG3YSdhF0Qy7,7GRhBDsirIGkRZBtSMEzNTyDr2JQm4xx,34,105,40,46,21,30,41,3,286,40.857142857142854,5,0.0,54,40,39,21,51,30,7,41,3,154,132,1
2941,65760,Eq2fj8YhTifRHDOTFGHgDmpANxyMLkTX,7GRhBDsirIGkRZBtSMEzNTyDr2JQm4xx,2,0,0,0,0,0,2,0,2,0.2857142857142857,1,0.0,0,0,0,0,0,0,0,2,0,0,2,1
2942,65803,frLOkZRmi3O7wD4LykXjaoVn2dsJFYHr,7GRhBDsirIGkRZBtSMEzNTyDr2JQm4xx,2,0,0,0,0,0,2,0,2,0.2857142857142857,1,0.0,0,0,0,0,0,0,0,2,0,0,2,1
2943,65811,eGQZZVxmcbNonF0wFWctXG5fJptHLiDM,7GRhBDsirIGkRZBtSMEzNTyDr2JQm4xx,13,6,4,0,3,0,7,2,22,3.142857142857143,1,0.0,0,4,0,3,6,0,0,7,2,7,15,0
2944,65862,FWTjpNOuI4RsBkDu0yW01kwOX7KPfCTS,7GRhBDsirIGkRZBtSMEzNTyDr2JQm4xx,1,0,0,0,0,0,1,0,1,0.14285714285714285,1,0.0,0,0,0,0,0,0,0,1,0,0,1,1
2945,65872,dr13KuqOo10EJH5V4oOgMy17ewEUhD7o,7GRhBDsirIGkRZBtSMEzNTyDr2JQm4xx,1,0,0,0,0,0,1,0,1,0.14285714285714285,1,0.0,0,0,0,0,0,0,0,1,0,0,1,1
2946,65947,qREvGviufJ3VVxNkA2MjB1npr7InnyIq,7GRhBDsirIGkRZBtSMEzNTyDr2JQm4xx,1,0,0,0,0,0,1,0,1,0.14285714285714285,1,0.0,0,0,0,0,0,0,0,1,0,0,1,1
2947,65951,OiCP77rDGj7m0OeIgoy8NyAC1iklb2Wq,7GRhBDsirIGkRZBtSMEzNTyDr2JQm4xx,1,0,0,0,0,0,1,0,1,0.14285714285714285,1,0.0,0,0,0,0,0,0,0,1,0,0,1,1
2948,66544,GsuSgvyvG4oCfnW3UaGKEeHZUImW7ybU,SpATywNh6bZuzm8s1ceuBUnMUAeoAHHw,12,30,4,13,3,1,6,0,57,8.142857142857142,4,0.0,9,4,12,3,21,1,1,6,0,28,29,1
2949,66553,X1KDcg6FJGcjALhOEz460JY2SzJ27Ewm,RXDvfPUBYFlVdlueBFbLW0mhhAyGEqpt,18,24,9,16,4,0,28,0,81,11.571428571428571,3,0.0,6,9,16,4,18,0,0,28,0,35,46,1
2950,66554,alnogGpZqhBWQHh6ZLeZUIXk896ksLOu,bWdj2GDclj5ofokWjzoa5jAwMkxCykd6,17,33,3,108,2,2,20,1,169,24.142857142857142,3,0.0,9,3,105,2,24,2,3,20,1,119,50,1
2951,66562,RbUxQb46RHLKt8MRdcRI6KFNQeGEWd4E,bWdj2GDclj5ofokWjzoa5jAwMkxCykd6,12,4,3,0,3,10,7,1,28,4.0,2,0.0,0,3,0,3,4,10,0,7,1,6,22,1
2952,66566,6PpQXjJomANl40NJZt5It7FhFUddOBZF,SpATywNh6bZuzm8s1ceuBUnMUAeoAHHw,16,19,8,12,3,23,7,1,73,10.428571428571429,2,0.0,6,8,9,3,13,23,3,7,1,26,47,1
2953,66567,Z5BNOGX3uaOaDJtXljja6tBV5seZD36x,SpATywNh6bZuzm8s1ceuBUnMUAeoAHHw,6,4,3,0,2,0,2,0,11,1.5714285714285714,1,0.0,0,3,0,2,4,0,0,2,0,5,6,1
2954,66572,IaHdA1JSOZlnXxW2Ea0M59RXapC6MjXI,SpATywNh6bZuzm8s1ceuBUnMUAeoAHHw,12,70,9,23,1,37,16,3,159,22.714285714285715,3,0.0,56,9,21,1,14,37,2,16,3,87,72,0
2955,66573,ES3MJj3KCIAnVbhhUwdNjoq2AG6ouBZT,SpATywNh6bZuzm8s1ceuBUnMUAeoAHHw,10,11,5,0,3,8,4,0,31,4.428571428571429,3,0.0,0,5,0,3,11,8,0,4,0,8,23,1
2956,66574,PizUKf6mRUas66X3VMYXf9aygnN1CUCf,RXDvfPUBYFlVdlueBFbLW0mhhAyGEqpt,27,31,22,0,10,11,8,3,85,12.142857142857142,1,0.0,3,22,0,10,28,11,0,8,3,35,50,1
2957,66583,L3sYIZrtCe33arrsIgJGTKImw4yL48kj,G8EPVSXsOYB5YQWZGiz1aVq5Pgr2GrQu,13,10,6,0,4,0,5,0,25,3.5714285714285716,2,0.0,0,6,0,4,10,0,0,5,0,10,15,0
2958,66584,ZRcEnEYSSBQbkjzMu7sidjbxasfrmw8l,RXDvfPUBYFlVdlueBFbLW0mhhAyGEqpt,27,61,30,31,2,2,12,0,138,19.714285714285715,6,0.0,6,30,29,2,55,2,2,12,0,67,71,1
2959,66587,Jag1EXQWfAuTRiCgcVLyhRRkdOL9RtSD,bWdj2GDclj5ofokWjzoa5jAwMkxCykd6,13,13,9,68,6,2,8,0,106,15.142857142857142,2,0.0,1,9,67,6,12,2,1,8,0,83,23,1
2960,66591,9EN3Z35raOUcrGDeovMj0gdxUNnPCeKU,SpATywNh6bZuzm8s1ceuBUnMUAeoAHHw,3,2,0,0,0,0,2,0,4,0.5714285714285714,1,0.0,0,0,0,0,2,0,0,2,0,0,4,1
2961,66598,nLUyFOoii85Kc6SiGICnU7SPdHRw1h9a,SpATywNh6bZuzm8s1ceuBUnMUAeoAHHw,9,5,2,0,1,15,5,3,31,4.428571428571429,1,0.0,2,2,0,1,3,15,0,5,3,5,26,1
2962,66605,XUPBJ1mitGxAzzRukKqjQOzBGJw166yc,G8EPVSXsOYB5YQWZGiz1aVq5Pgr2GrQu,10,6,5,0,4,0,3,0,18,2.5714285714285716,2,0.0,0,5,0,4,6,0,0,3,0,9,9,1
2963,66615,fxrAFCrsLimQV1XJURgnMX9KS4WUkexG,G8EPVSXsOYB5YQWZGiz1aVq5Pgr2GrQu,14,5,4,28,3,0,3,0,43,6.142857142857143,1,0.0,0,4,25,3,5,0,3,3,0,32,11,1
2964,66616,aQkZtyhfWM4x1GodnKorBxGkYsdqjpct,G8EPVSXsOYB5YQWZGiz1aVq5Pgr2GrQu,26,26,17,0,12,1,7,0,63,9.0,4,0.0,0,17,0,12,26,1,0,7,0,29,34,1
2965,66617,bXR5OQsnMadJ3r7Y5b33xdbV7KcP5Zyw,bWdj2GDclj5ofokWjzoa5jAwMkxCykd6,8,9,6,0,5,0,3,0,23,3.2857142857142856,2,0.0,1,6,0,5,8,0,0,3,0,12,11,1
2966,66618,wyLapvNSkzqLsQoXZV3N6mjrWCECacth,RXDvfPUBYFlVdlueBFbLW0mhhAyGEqpt,49,44,24,101,16,8,8,0,201,28.714285714285715,3,0.0,13,24,95,16,31,8,6,8,0,148,53,1
2967,66621,5TeLMYHqzQAKUmQpWnvEv2hxOy9X1UKJ,SpATywNh6bZuzm8s1ceuBUnMUAeoAHHw,18,36,19,22,5,7,15,3,107,15.285714285714286,3,0.0,11,19,17,5,25,7,5,15,3,52,55,1
2968,66635,8fOucDZ8PgruKfhbtaGML7zYng8oMl2j,SpATywNh6bZuzm8s1ceuBUnMUAeoAHHw,5,2,1,0,1,0,3,0,7,1.0,1,0.0,0,1,0,1,2,0,0,3,0,2,5,1
2969,66637,ddHByaCLR2ByNnOPbXOAqZ6eqJzLVO7n,bWdj2GDclj5ofokWjzoa5jAwMkxCykd6,5,3,1,0,1,0,4,0,9,1.2857142857142858,1,0.0,0,1,0,1,3,0,0,4,0,2,7,1
2970,66644,102hMvC6gN7rty2ashlvDMHaB3ep6GZh,SpATywNh6bZuzm8s1ceuBUnMUAeoAHHw,15,46,2,27,1,12,14,2,104,14.857142857142858,2,0.0,18,2,21,1,28,12,6,14,2,42,62,1
2971,66646,qZhmmNUvkNXdf3u04DTUQOFEBxxO10p4,G8EPVSXsOYB5YQWZGiz1aVq5Pgr2GrQu,120,143,49,256,29,0,17,1,495,70.71428571428571,7,0.0,49,49,203,29,94,0,53,17,1,330,165,1
2972,66650,j8DEcgUENzfnfHONFl2IMtBsrYZzGv40,bWdj2GDclj5ofokWjzoa5jAwMkxCykd6,8,4,2,42,1,0,2,0,51,7.285714285714286,1,0.0,2,2,41,1,2,0,1,2,0,46,5,1
2973,66654,AA7aVbrpQJ2zUau6VJLFiC8rutvLHi1m,bWdj2GDclj5ofokWjzoa5jAwMkxCykd6,7,17,4,0,0,1,6,0,28,4.0,1,0.0,0,4,0,0,17,1,0,6,0,4,24,1
2974,66657,bpLyNpLNqZrg4X6eObo787HrocrHo6XF,RXDvfPUBYFlVdlueBFbLW0mhhAyGEqpt,7,4,1,0,1,0,2,0,8,1.1428571428571428,1,0.0,0,1,0,1,4,0,0,2,0,2,6,1
2975,66658,NiYgf1FsQGPvHpxeTQuDCV5yUQ8cmKec,SpATywNh6bZuzm8s1ceuBUnMUAeoAHHw,1,0,0,0,0,0,1,0,1,0.14285714285714285,1,0.0,0,0,0,0,0,0,0,1,0,0,1,1
2976,66662,GHjtRW2SWnsNCYGrWfNWjwqhAcWXggqC,G8EPVSXsOYB5YQWZGiz1aVq5Pgr2GrQu,31,37,3,70,1,5,4,0,120,17.142857142857142,1,0.0,16,3,52,1,21,5,18,4,0,72,48,1
2977,66664,WpYtemwKZQxcuLGpndx0lQojfh6o5GOv,RXDvfPUBYFlVdlueBFbLW0mhhAyGEqpt,11,7,1,0,1,3,7,1,20,2.857142857142857,2,0.0,0,1,0,1,7,3,0,7,1,2,18,1
2978,66677,O65XWOLgEMKBGdUDD3HXTmDvI5lmhsk8,SpATywNh6bZuzm8s1ceuBUnMUAeoAHHw,8,7,4,0,1,0,6,0,18,2.5714285714285716,2,0.0,0,4,0,1,7,0,0,6,0,5,13,1
2979,66688,ehuVxu7A35eDUFqKYYT7us9o7kymvupC,SpATywNh6bZuzm8s1ceuBUnMUAeoAHHw,8,6,4,0,4,0,6,1,21,3.0,2,0.0,1,4,0,4,5,0,0,6,1,9,12,1
2980,66691,4X8SsO11KgTMY23mHrkIQxUJcM5ft92O,SpATywNh6bZuzm8s1ceuBUnMUAeoAHHw,6,3,2,0,2,0,2,0,9,1.2857142857142858,1,0.0,0,2,0,2,3,0,0,2,0,4,5,1
2981,66695,9hMYmYnY4O2N6jg4p4MNxwDczZbVqp3T,RXDvfPUBYFlVdlueBFbLW0mhhAyGEqpt,24,29,21,0,14,0,7,1,72,10.285714285714286,4,0.0,2,21,0,14,27,0,0,7,1,37,35,1
2982,66703,pdhviBPVRpP6jkLxXzSmGnBMX5GRwslr,SpATywNh6bZuzm8s1ceuBUnMUAeoAHHw,9,24,13,0,0,1,12,0,50,7.142857142857143,1,0.0,0,13,0,0,24,1,0,12,0,13,37,1
2983,66704,DAjbimE4V5oFXI5ZD4kyBHNztDPF7CGC,G8EPVSXsOYB5YQWZGiz1aVq5Pgr2GrQu,5,4,1,0,2,0,3,0,10,1.4285714285714286,2,0.0,2,1,0,2,2,0,0,3,0,5,5,1
2984,66711,VS8f8oTxWcbwLqrK393hBZWMoBFa1gFJ,SpATywNh6bZuzm8s1ceuBUnMUAeoAHHw,23,34,17,20,6,2,22,1,102,14.571428571428571,6,0.0,8,17,16,6,26,2,4,22,1,47,55,0
2985,66713,LMGbvXS3ZBgtTcKCRLMcqBHrfADBxwXe,G8EPVSXsOYB5YQWZGiz1aVq5Pgr2GrQu,87,115,17,136,6,58,32,0,364,52.0,9,0.0,47,17,94,6,68,58,42,32,0,164,200,0
2986,66730,BaoCwxmOrD7InrgOrpoiCi2VVkCIKJfh,SpATywNh6bZuzm8s1ceuBUnMUAeoAHHw,17,24,6,20,3,3,12,1,69,9.857142857142858,2,0.0,16,6,17,3,8,3,3,12,1,42,27,1
2987,66732,e4qTXKc7Qs1Hoa2gaTnt5MCSxqsevbSQ,SpATywNh6bZuzm8s1ceuBUnMUAeoAHHw,1,0,0,0,0,0,1,0,1,0.14285714285714285,1,0.0,0,0,0,0,0,0,0,1,0,0,1,1
2988,66745,qt9pojYUdSU9dxSioMDEso1f0UH6has1,SpATywNh6bZuzm8s1ceuBUnMUAeoAHHw,23,55,21,26,5,1,10,0,118,16.857142857142858,5,0.0,10,21,22,5,45,1,4,10,0,58,60,1
2989,66747,p2gF3LN3ZgatpYPMj263kKzwr7f9hjKm,SpATywNh6bZuzm8s1ceuBUnMUAeoAHHw,4,1,0,0,0,0,6,0,7,1.0,1,0.0,0,0,0,0,1,0,0,6,0,0,7,0
2990,66756,aR3fk0CNwd9ygarvr0BOVu5p8WeU32I1,SpATywNh6bZuzm8s1ceuBUnMUAeoAHHw,17,21,7,10,4,9,8,1,60,8.571428571428571,2,0.0,11,7,9,4,10,9,1,8,1,31,29,1
2991,66776,1bINdBCm1VS5Qjqh6m0QvNj7bfNPAIxT,bWdj2GDclj5ofokWjzoa5jAwMkxCykd6,2,0,0,0,0,0,2,0,2,0.2857142857142857,2,0.0,0,0,0,0,0,0,0,2,0,0,2,1
2992,66778,c7cZPwJhMtLXXFSxYHM0ztf18Qe267SR,SpATywNh6bZuzm8s1ceuBUnMUAeoAHHw,11,16,9,0,7,0,3,0,35,5.0,2,0.0,1,9,0,7,15,0,0,3,0,17,18,1
2993,66779,r8TxqoZCuxs9o8OQbbHm8IWDrVmolNmN,SpATywNh6bZuzm8s1ceuBUnMUAeoAHHw,1,0,0,0,0,0,1,0,1,0.14285714285714285,1,0.0,0,0,0,0,0,0,0,1,0,0,1,1
2994,66780,OnyZH4F3oW4crdu4EYjgcCg5L4Cq5yIA,bWdj2GDclj5ofokWjzoa5jAwMkxCykd6,5,9,1,0,0,0,4,0,14,2.0,1,0.0,0,1,0,0,9,0,0,4,0,1,13,1
2995,66789,5ZyvCd3AP7a8azCiLN5JfLAP53iZpAyD,SpATywNh6bZuzm8s1ceuBUnMUAeoAHHw,3,0,0,0,0,0,8,0,8,1.1428571428571428,4,0.0,0,0,0,0,0,0,0,8,0,0,8,0
2996,66804,AlgEd5IzXHm0JGTUI9jbrnVeF8FATpV3,bWdj2GDclj5ofokWjzoa5jAwMkxCykd6,13,12,7,48,3,4,5,0,79,11.285714285714286,1,0.0,4,7,48,3,8,4,0,5,0,62,17,1
2997,66806,Qo1OAp8GglCOhKICbcJQhmG7Ih2RNYzD,SpATywNh6bZuzm8s1ceuBUnMUAeoAHHw,12,14,5,0,3,0,24,0,46,6.571428571428571,2,0.0,4,5,0,3,10,0,0,24,0,12,34,1
2998,66808,WMHcQA8MVYUjJWAMAB6fugsBuCZpVoIb,SpATywNh6bZuzm8s1ceuBUnMUAeoAHHw,14,22,6,13,2,9,14,4,70,10.0,1,0.0,16,6,12,2,6,9,1,14,4,36,34,1
2999,66810,nNPKgGT2Dns3AcXj6vzeFxTea7ZZLJPg,G8EPVSXsOYB5YQWZGiz1aVq5Pgr2GrQu,27,12,11,0,10,12,6,1,52,7.428571428571429,1,0.0,0,11,0,10,12,12,0,6,1,21,31,1
3000,66813,jtvqYfTt0YMo9BknX2A672jXhl21ashI,SpATywNh6bZuzm8s1ceuBUnMUAeoAHHw,7,5,1,0,1,0,1,0,8,1.1428571428571428,1,0.0,0,1,0,1,5,0,0,1,0,2,6,1
3001,66820,MvNnLQma2eBM9bCcMIR159XYSNp8VREs,bWdj2GDclj5ofokWjzoa5jAwMkxCykd6,38,30,17,162,7,23,11,0,250,35.714285714285715,5,0.0,6,17,135,7,24,23,27,11,0,165,85,1
3002,66828,U0qAQ57V9wygm6bDtrNRCaS95QeQ2J6g,G8EPVSXsOYB5YQWZGiz1aVq5Pgr2GrQu,31,56,30,0,17,4,18,2,127,18.142857142857142,3,0.0,13,30,0,17,43,4,0,18,2,60,67,1
3003,66844,zPWIhn8QAXkwvZr0vXSWUOjtKdeOxnx0,SpATywNh6bZuzm8s1ceuBUnMUAeoAHHw,4,4,0,0,0,0,2,0,6,0.8571428571428571,1,0.0,0,0,0,0,4,0,0,2,0,0,6,1
3004,66854,9uGUU0TH4lqYEkuGLK9jp9MwW0oSvGiG,SpATywNh6bZuzm8s1ceuBUnMUAeoAHHw,1,0,0,0,0,0,1,0,1,0.14285714285714285,1,0.0,0,0,0,0,0,0,0,1,0,0,1,1
3005,66859,YD54LiXoRcgp9TgUQFqtUoAuCL64ULEG,RXDvfPUBYFlVdlueBFbLW0mhhAyGEqpt,1,0,0,0,0,0,1,0,1,0.14285714285714285,1,0.0,0,0,0,0,0,0,0,1,0,0,1,1
3006,66862,grxgFxuiaSTlMIk1kWcHwbLAYZVnIvkA,RXDvfPUBYFlVdlueBFbLW0mhhAyGEqpt,7,5,1,0,1,0,3,0,10,1.4285714285714286,1,0.0,0,1,0,1,5,0,0,3,0,2,8,1
3007,66871,TkGLgRow1Lh4XUIZJk3PPt8KzHEZuW9e,SpATywNh6bZuzm8s1ceuBUnMUAeoAHHw,12,12,8,1,7,0,4,0,32,4.571428571428571,2,0.0,2,8,1,7,10,0,0,4,0,18,14,1
3008,66878,9uGUU0TH4lqYEkuGLK9jp9MwW0oSvGiG,bWdj2GDclj5ofokWjzoa5jAwMkxCykd6,1,0,0,0,0,0,1,0,1,0.14285714285714285,1,0.0,0,0,0,0,0,0,0,1,0,0,1,1
3009,66880,tBWD1VTj6Jcj3AQ0AXY8eZtUzkjmoiNH,bWdj2GDclj5ofokWjzoa5jAwMkxCykd6,9,12,5,14,1,8,10,0,50,7.142857142857143,2,0.0,1,5,13,1,11,8,1,10,0,20,30,1
3010,66893,HBNOGDmQrCA8ZCNHwMOm4mGR9448iscJ,SpATywNh6bZuzm8s1ceuBUnMUAeoAHHw,9,5,2,0,1,0,15,0,23,3.2857142857142856,4,0.0,0,2,0,1,5,0,0,15,0,3,20,0
3011,66900,SOap4GRyA4qmYvVJbfGh1nFSvLnlIhQw,SpATywNh6bZuzm8s1ceuBUnMUAeoAHHw,13,13,8,0,6,2,9,1,39,5.571428571428571,2,0.0,1,8,0,6,12,2,0,9,1,15,24,1
3012,66911,n0HFF3TwqKuBMzzkdLCbvb8Mji5ZUnVX,RXDvfPUBYFlVdlueBFbLW0mhhAyGEqpt,7,6,3,0,2,0,2,0,13,1.8571428571428572,2,0.0,0,3,0,2,6,0,0,2,0,5,8,1
3013,66922,wEaTyOJwwvOCk7eUttQISK5WPXL7ANNV,RXDvfPUBYFlVdlueBFbLW0mhhAyGEqpt,10,39,7,0,2,0,6,0,54,7.714285714285714,7,0.0,5,7,0,2,34,0,0,6,0,14,40,0
3014,66928,UnlpBoCCKa1g59dweQPJmefdPMpfSVLe,G8EPVSXsOYB5YQWZGiz1aVq5Pgr2GrQu,62,114,46,120,30,21,13,1,345,49.285714285714285,8,0.0,45,46,70,30,69,21,50,13,1,191,154,1
3015,66937,LYK1SCUULDZfFbUf8SQuy4cGJ6KDov7Z,G8EPVSXsOYB5YQWZGiz1aVq5Pgr2GrQu,13,8,4,0,2,2,15,2,33,4.714285714285714,3,0.0,0,4,0,2,8,2,0,15,2,6,27,1
3016,66938,mLUKkahZJn2S9K7hZVXpun7HflxZlNfK,RXDvfPUBYFlVdlueBFbLW0mhhAyGEqpt,38,52,4,98,4,0,4,0,162,23.142857142857142,3,0.0,15,4,91,4,37,0,7,4,0,114,48,1
3017,66947,8OfBrECVDzmqJABpw3ayApk0DiWDa3gF,SpATywNh6bZuzm8s1ceuBUnMUAeoAHHw,1,0,0,0,0,0,1,0,1,0.14285714285714285,1,0.0,0,0,0,0,0,0,0,1,0,0,1,1
3018,66948,ylHVd8NK0xyUeGJijtfFcdu7sSX07hsS,SpATywNh6bZuzm8s1ceuBUnMUAeoAHHw,16,15,2,8,1,1,11,3,41,5.857142857142857,3,0.0,2,2,8,1,13,1,0,11,3,13,28,1
3019,66959,wpRLL3XDggpsn9xMAH6hM6LGULXpz3ki,SpATywNh6bZuzm8s1ceuBUnMUAeoAHHw,3,2,0,0,0,0,2,0,4,0.5714285714285714,1,0.0,0,0,0,0,2,0,0,2,0,0,4,1
3020,66965,FXFJNl5vYMfodb6wUkei0GFkJtJALVJo,SpATywNh6bZuzm8s1ceuBUnMUAeoAHHw,1,0,0,0,0,0,2,0,2,0.2857142857142857,1,0.0,0,0,0,0,0,0,0,2,0,0,2,1
3021,66967,TZMHSuVEUzvE9F9oFUPDubVVCOh0OUwA,SpATywNh6bZuzm8s1ceuBUnMUAeoAHHw,6,9,4,0,2,0,5,0,20,2.857142857142857,3,0.0,0,4,0,2,9,0,0,5,0,6,14,1
3022,66972,4mxqWsjuug2blsnsk9e2hDH5ZKMeIfme,SpATywNh6bZuzm8s1ceuBUnMUAeoAHHw,19,33,12,24,5,1,13,2,90,12.857142857142858,3,0.0,17,12,20,5,16,1,4,13,2,54,36,1
3023,66981,ApSfmGvydhCGgdp1GU2OyiUFr43yEuYJ,RXDvfPUBYFlVdlueBFbLW0mhhAyGEqpt,9,11,6,0,2,0,5,3,27,3.857142857142857,1,0.0,1,6,0,2,10,0,0,5,3,9,18,1
3024,66983,e7lti3fBvO8XZNtS4I7hMo5JFh6PqMCH,SpATywNh6bZuzm8s1ceuBUnMUAeoAHHw,9,6,0,0,0,1,8,1,16,2.2857142857142856,2,0.0,0,0,0,0,6,1,0,8,1,0,16,1
3025,66991,c5MkJ205AcjWsm07YpOktUEc4lrC6DvN,bWdj2GDclj5ofokWjzoa5jAwMkxCykd6,4,3,0,0,0,0,4,0,7,1.0,2,0.0,0,0,0,0,3,0,0,4,0,0,7,1
3026,66995,RE0yxLQPG2DsKP2fVObFsaZxTyIGWyd9,SpATywNh6bZuzm8s1ceuBUnMUAeoAHHw,1,0,0,0,0,0,1,0,1,0.14285714285714285,1,0.0,0,0,0,0,0,0,0,1,0,0,1,1
3027,67003,jK7giBjce5DH7ZDYgKKwuLGFjg8bBMY3,SpATywNh6bZuzm8s1ceuBUnMUAeoAHHw,1,0,0,0,0,0,1,0,1,0.14285714285714285,1,0.0,0,0,0,0,0,0,0,1,0,0,1,1
3028,67017,R8e7xg0PB3WHpeFUd7XjboUcUmtjBoqn,G8EPVSXsOYB5YQWZGiz1aVq5Pgr2GrQu,57,50,12,162,10,2,3,0,239,34.142857142857146,3,0.0,35,12,123,10,15,2,39,3,0,180,59,1
3029,67020,jWJjb2ULtCbg7TxaVgejXvNjReg1rWMJ,SpATywNh6bZuzm8s1ceuBUnMUAeoAHHw,7,5,0,0,0,0,15,0,20,2.857142857142857,3,0.0,0,0,0,0,5,0,0,15,0,0,20,1
3030,67027,a1PUZwDv53lPTEF9hvk5ypoKBKNjAetJ,SpATywNh6bZuzm8s1ceuBUnMUAeoAHHw,1,0,0,0,0,0,1,0,1,0.14285714285714285,1,0.0,0,0,0,0,0,0,0,1,0,0,1,1
3031,67028,Up0SfqXbbz6NGY2S4ku6GM2FOwYrzCdN,G8EPVSXsOYB5YQWZGiz1aVq5Pgr2GrQu,17,25,9,56,5,5,6,1,107,15.285714285714286,1,0.0,15,9,44,5,10,5,12,6,1,73,34,1
3032,67031,bhM1l0w4WfwmiUZ8JL3hioN6rh1txoNY,G8EPVSXsOYB5YQWZGiz1aVq5Pgr2GrQu,1,0,0,0,0,0,1,0,1,0.14285714285714285,1,0.0,0,0,0,0,0,0,0,1,0,0,1,1
3033,67032,YLfjSoU2JNGG7f9SEbr83b8mp8z1n7i3,SpATywNh6bZuzm8s1ceuBUnMUAeoAHHw,5,3,2,0,1,0,2,0,8,1.1428571428571428,1,0.0,0,2,0,1,3,0,0,2,0,3,5,1
3034,67057,YGm3RWWdh53qv43WofC48V9ZiIjgJjMn,bWdj2GDclj5ofokWjzoa5jAwMkxCykd6,7,13,6,6,2,0,5,0,32,4.571428571428571,1,0.0,1,6,5,2,12,0,1,5,0,14,18,0
3035,67062,lsez2NExtDzqmHTj1WxlkldAKydbGpGz,SpATywNh6bZuzm8s1ceuBUnMUAeoAHHw,25,31,9,20,4,0,8,0,72,10.285714285714286,6,0.0,6,9,19,4,25,0,1,8,0,38,34,0
3036,67064,rgWDWnR8cl7dIVcqtFoTnaVoLEy1VLxc,SpATywNh6bZuzm8s1ceuBUnMUAeoAHHw,8,12,4,0,2,0,3,0,21,3.0,3,0.0,0,4,0,2,12,0,0,3,0,6,15,1
3037,67084,t2CefH6ir3GuQXTz3Lok7bxtMew2Evw7,RXDvfPUBYFlVdlueBFbLW0mhhAyGEqpt,19,19,15,0,10,0,10,4,58,8.285714285714286,3,0.0,0,15,0,10,19,0,0,10,4,25,33,1
3038,67088,k6QLpQDqSxoScgN883dLN4OsoeXNCHXO,RXDvfPUBYFlVdlueBFbLW0mhhAyGEqpt,47,56,29,123,15,2,4,0,229,32.714285714285715,2,0.0,18,29,115,15,38,2,8,4,0,177,52,0
3039,67089,JrNueBhmifdFgGWHM8aWG8EzCwr3tqQr,SpATywNh6bZuzm8s1ceuBUnMUAeoAHHw,14,33,11,21,5,0,2,0,72,10.285714285714286,1,0.0,18,11,18,5,15,0,3,2,0,52,20,1
3040,67100,zpsnILpURwXmIVlozwqgT5YIvGr5WOxX,bWdj2GDclj5ofokWjzoa5jAwMkxCykd6,13,18,1,58,1,0,13,0,91,13.0,4,0.0,6,1,54,1,12,0,4,13,0,62,29,1
3041,67101,a3HtyjZsIXy0rlfdz7IVbfqFoPB13M3i,SpATywNh6bZuzm8s1ceuBUnMUAeoAHHw,10,24,1,11,0,0,2,0,38,5.428571428571429,2,0.0,2,1,11,0,22,0,0,2,0,14,24,1
3042,67108,37B6M9S02XwjLkdM8Uyceavdi8PgXeFK,SpATywNh6bZuzm8s1ceuBUnMUAeoAHHw,7,6,0,0,0,3,4,1,14,2.0,1,0.0,1,0,0,0,5,3,0,4,1,1,13,1
3043,67109,MoirjNgz2xCcf95deN6TNEo1dg7pa7Td,RXDvfPUBYFlVdlueBFbLW0mhhAyGEqpt,5,3,0,0,0,0,2,0,5,0.7142857142857143,1,0.0,0,0,0,0,3,0,0,2,0,0,5,1
3044,67113,3WF0lrMOUTt8kHZhSzrGOICZhAfsfzhb,SpATywNh6bZuzm8s1ceuBUnMUAeoAHHw,28,71,31,36,14,10,23,0,185,26.428571428571427,5,0.0,19,31,33,14,52,10,3,23,0,97,88,0
3045,67124,LFivYoM8eQkzo9oGvIWHE5E2ixWSM4Zt,SpATywNh6bZuzm8s1ceuBUnMUAeoAHHw,8,9,3,6,2,0,1,0,21,3.0,1,0.0,1,3,5,2,8,0,1,1,0,11,10,1
3046,67125,NEAc7vMacEwIBrIHn90danMCNJSj65mj,SpATywNh6bZuzm8s1ceuBUnMUAeoAHHw,5,2,1,0,1,0,3,0,7,1.0,1,0.0,0,1,0,1,2,0,0,3,0,2,5,1
3047,67135,HeVeuuFVpMfNb8W01LL9Sl7iyoZqremo,SpATywNh6bZuzm8s1ceuBUnMUAeoAHHw,6,2,1,0,0,0,5,1,9,1.2857142857142858,1,0.0,0,1,0,0,2,0,0,5,1,1,8,1
3048,67146,cAjVoc8wOYDE8lScDAhEgvHdzkmg6Oh2,SpATywNh6bZuzm8s1ceuBUnMUAeoAHHw,7,13,6,0,3,0,4,0,26,3.7142857142857144,4,0.0,0,6,0,3,13,0,0,4,0,9,17,1
3049,67147,4O78nHzzZKRW7OphkkAmy8uaIoFo0RWM,bWdj2GDclj5ofokWjzoa5jAwMkxCykd6,1,0,0,0,0,0,1,0,1,0.14285714285714285,1,0.0,0,0,0,0,0,0,0,1,0,0,1,1
3050,67148,zBl0JzlLEJg6YrWwxVeTxU6A3wSwUgq8,SpATywNh6bZuzm8s1ceuBUnMUAeoAHHw,7,19,0,0,0,1,2,0,22,3.142857142857143,1,0.0,0,0,0,0,19,1,0,2,0,0,22,1
3051,67162,G2vTTAEhPpy1uiGVOSc3WfzCmuUhZyw6,G8EPVSXsOYB5YQWZGiz1aVq5Pgr2GrQu,8,2,2,0,2,0,6,0,12,1.7142857142857142,2,0.0,0,2,0,2,2,0,0,6,0,4,8,1
3052,67172,IdbptVxItEcsF1HvcM0Mmm9AW3Imyhv4,SpATywNh6bZuzm8s1ceuBUnMUAeoAHHw,4,3,0,0,0,0,2,0,5,0.7142857142857143,1,0.0,0,0,0,0,3,0,0,2,0,0,5,1
3053,67179,5Zxu05K7VSTA0XR5o51TQgeWQSwtutqu,SpATywNh6bZuzm8s1ceuBUnMUAeoAHHw,18,33,16,6,6,2,10,1,74,10.571428571428571,5,0.0,2,16,6,6,31,2,0,10,1,30,44,1
3054,67186,2mFdcZdKuSUvueHyZE3zvpjXpyVcJptR,bWdj2GDclj5ofokWjzoa5jAwMkxCykd6,25,50,3,79,1,9,18,3,163,23.285714285714285,5,0.0,16,3,72,1,34,9,7,18,3,92,71,1
3055,67197,OvFsbGXgDD3DXdRTUFBoMvrSVsi4VT3x,SpATywNh6bZuzm8s1ceuBUnMUAeoAHHw,26,29,13,36,6,20,16,1,121,17.285714285714285,3,0.0,8,13,30,6,21,20,6,16,1,57,64,0
3056,67201,oYST4cfTE5cxIGh0kVtzNelTkJwqpSI4,bWdj2GDclj5ofokWjzoa5jAwMkxCykd6,2,0,0,0,0,0,2,0,2,0.2857142857142857,1,0.0,0,0,0,0,0,0,0,2,0,0,2,1
3057,67204,IJDnP8nIf6GZvQ8vvewi9Kan2f5aO9mE,SpATywNh6bZuzm8s1ceuBUnMUAeoAHHw,8,3,1,0,1,1,5,1,12,1.7142857142857142,1,0.0,0,1,0,1,3,1,0,5,1,2,10,1
3058,67208,urQLwPNeBD6YiDmQkO3zzeclg8J0Lcqs,SpATywNh6bZuzm8s1ceuBUnMUAeoAHHw,9,10,1,0,0,19,14,3,47,6.714285714285714,1,0.0,2,1,0,0,8,19,0,14,3,3,44,1
3059,67210,Mw3CgUU6IvX32BhuujNu75RHWA7Tzf9A,bWdj2GDclj5ofokWjzoa5jAwMkxCykd6,2,0,0,0,0,0,4,0,4,0.5714285714285714,1,0.0,0,0,0,0,0,0,0,4,0,0,4,1
3060,67216,fxBTxCWQMcuL1ujf7SabjHZ1ZIFJ9pkF,SpATywNh6bZuzm8s1ceuBUnMUAeoAHHw,10,4,3,0,2,10,12,1,32,4.571428571428571,1,0.0,0,3,0,2,4,10,0,12,1,5,27,1
3061,67218,2XkiS6Di6usC8n7ND637MKllSt6TChsJ,SpATywNh6bZuzm8s1ceuBUnMUAeoAHHw,14,25,9,12,2,1,9,0,58,8.285714285714286,4,0.0,10,9,10,2,15,1,2,9,0,31,27,1
3062,67225,i2lUV72IHqqXWYqLFMWv3y4XGmlq2lXa,G8EPVSXsOYB5YQWZGiz1aVq5Pgr2GrQu,2,0,0,0,0,0,2,0,2,0.2857142857142857,1,0.0,0,0,0,0,0,0,0,2,0,0,2,1
3063,67227,8QIwRllpGKgpURtcmS5hWJ0AInSKESf0,SpATywNh6bZuzm8s1ceuBUnMUAeoAHHw,7,6,2,0,2,0,5,0,15,2.142857142857143,2,0.0,0,2,0,2,6,0,0,5,0,4,11,1
3064,67233,sIyBSBxCvJj2SnsLY9k322Y8X6bvKHy5,bWdj2GDclj5ofokWjzoa5jAwMkxCykd6,2,0,0,0,0,0,2,0,2,0.2857142857142857,1,0.0,0,0,0,0,0,0,0,2,0,0,2,1
3065,67242,vy0D7u7Ahtj15h3nmn3LQzZAhD31JIs2,G8EPVSXsOYB5YQWZGiz1aVq5Pgr2GrQu,37,53,22,62,9,2,8,1,157,22.428571428571427,2,0.0,26,22,44,9,27,2,18,8,1,101,56,1
3066,67251,hfSXPDFaR2dzrQsij0JMBqqFRCNkzN0i,bWdj2GDclj5ofokWjzoa5jAwMkxCykd6,8,8,1,0,1,0,5,0,15,2.142857142857143,1,0.0,1,1,0,1,7,0,0,5,0,3,12,1
3067,67252,ZTdgLXHyPcHYh3Bqv5Ymq9ISFbVAj0an,SpATywNh6bZuzm8s1ceuBUnMUAeoAHHw,14,7,4,14,3,0,5,0,33,4.714285714285714,2,0.0,2,4,12,3,5,0,2,5,0,21,12,1
3068,67256,FZEwaAUaiR6zemazrUHMMvDLCgHez3sb,RXDvfPUBYFlVdlueBFbLW0mhhAyGEqpt,36,25,5,67,1,29,6,0,133,19.0,3,0.0,7,5,66,1,18,29,1,6,0,79,54,1
3069,67268,hZupBIfJ4ZGjbfVSNHt4j151AWxFYbOy,SpATywNh6bZuzm8s1ceuBUnMUAeoAHHw,15,20,9,7,6,1,5,0,48,6.857142857142857,2,0.0,8,9,7,6,12,1,0,5,0,30,18,1
3070,67271,1SJmhRDD4Bzcm6S9X3GSNxkp9PjEl8e5,G8EPVSXsOYB5YQWZGiz1aVq5Pgr2GrQu,25,27,12,34,8,4,2,0,87,12.428571428571429,1,0.0,11,12,24,8,16,4,10,2,0,55,32,0
3071,67274,ywsBc3bK8Vte1Tvgz902Tgp2J7M95FMX,RXDvfPUBYFlVdlueBFbLW0mhhAyGEqpt,19,20,13,0,4,12,18,5,72,10.285714285714286,2,0.0,0,13,0,4,20,12,0,18,5,17,55,1
3072,67292,grxgFxuiaSTlMIk1kWcHwbLAYZVnIvkA,SpATywNh6bZuzm8s1ceuBUnMUAeoAHHw,6,3,1,0,1,0,2,0,7,1.0,1,0.0,0,1,0,1,3,0,0,2,0,2,5,0
3073,67301,5ZZ7ac02MMtLItQmBAzvselJyRLR3oem,G8EPVSXsOYB5YQWZGiz1aVq5Pgr2GrQu,23,25,7,20,6,0,2,0,60,8.571428571428571,2,0.0,15,7,13,6,10,0,7,2,0,41,19,1
3074,67304,WYUvDmjrCchGW5prlJ6BZEDjHOYsgZsG,G8EPVSXsOYB5YQWZGiz1aVq5Pgr2GrQu,51,73,28,86,16,5,14,0,222,31.714285714285715,5,0.0,39,28,55,16,34,5,31,14,0,138,84,1
3075,67311,rRP9Jqic5Mwtv2NanjU01SwWXGZ8kuBu,SpATywNh6bZuzm8s1ceuBUnMUAeoAHHw,7,7,2,0,1,0,6,0,16,2.2857142857142856,3,0.0,0,2,0,1,7,0,0,6,0,3,13,1
3076,67315,gc2449Ag0boGNd6nrwcfyjhFar24UaYH,RXDvfPUBYFlVdlueBFbLW0mhhAyGEqpt,35,64,55,0,26,0,5,0,150,21.428571428571427,6,0.0,2,55,0,26,62,0,0,5,0,83,67,1
3077,67317,F5h4PBXJhKNor6Y20FkKW5ER39HKkW7z,SpATywNh6bZuzm8s1ceuBUnMUAeoAHHw,16,16,6,19,3,0,6,0,50,7.142857142857143,1,0.0,6,6,16,3,10,0,3,6,0,31,19,1
3078,67320,CJYyYE64ZjIblJNrc9qIS4a8OLIz3Slp,SpATywNh6bZuzm8s1ceuBUnMUAeoAHHw,1,0,0,0,0,0,1,0,1,0.14285714285714285,1,0.0,0,0,0,0,0,0,0,1,0,0,1,1
3079,67330,CXuXsLGeGwubGiU0pZVYOuy4zs49HMdw,SpATywNh6bZuzm8s1ceuBUnMUAeoAHHw,5,4,0,0,0,1,2,0,7,1.0,1,0.0,0,0,0,0,4,1,0,2,0,0,7,1
3080,67337,6JTisM1m4JxBhgrxr4NqMSmvvRfyxGKO,bWdj2GDclj5ofokWjzoa5jAwMkxCykd6,3,5,2,0,0,0,1,0,8,1.1428571428571428,1,0.0,2,2,0,0,3,0,0,1,0,4,4,1
3081,67339,3w3NoRuE9idoCLL2jfurkkC3vZE468Ey,G8EPVSXsOYB5YQWZGiz1aVq5Pgr2GrQu,7,8,3,0,3,0,4,0,18,2.5714285714285716,1,0.0,3,3,0,3,5,0,0,4,0,9,9,1
3082,67342,S8ozQPoki5gs21RwfromQBp1WzImlYaZ,SpATywNh6bZuzm8s1ceuBUnMUAeoAHHw,16,19,1,16,2,6,14,2,60,8.571428571428571,2,0.0,4,1,14,2,15,6,2,14,2,21,39,1
3083,67344,dWJvaQw3sMX6buidtTfwYxdEvR1DZxlK,bWdj2GDclj5ofokWjzoa5jAwMkxCykd6,7,6,1,0,1,0,7,0,15,2.142857142857143,2,0.0,0,1,0,1,6,0,0,7,0,2,13,1
3084,67356,T6lJMwNIVHZiShXC2FiLzuiG8wkuUByo,SpATywNh6bZuzm8s1ceuBUnMUAeoAHHw,7,2,0,0,0,1,8,1,12,1.7142857142857142,3,0.0,0,0,0,0,2,1,0,8,1,0,12,1
3085,67369,gNMjI69u5dKUTa6c5HKwijZOxWQK60Ms,RXDvfPUBYFlVdlueBFbLW0mhhAyGEqpt,9,5,0,0,0,1,6,1,13,1.8571428571428572,1,0.0,0,0,0,0,5,1,0,6,1,0,13,1
3086,67370,xutmfomAAAlPAVNt9XPAtdu3rEswaJtg,G8EPVSXsOYB5YQWZGiz1aVq5Pgr2GrQu,12,16,7,28,4,0,5,0,60,8.571428571428571,1,0.0,8,7,23,4,8,0,5,5,0,42,18,1
3087,67378,ICAkQ3nKBh6NBvMxfnhNNqVJis2pQKso,SpATywNh6bZuzm8s1ceuBUnMUAeoAHHw,8,1,1,0,1,1,12,1,17,2.4285714285714284,1,0.0,0,1,0,1,1,1,0,12,1,2,15,1
3088,67379,YkDfLiDseHtCR7dJh5rdSPT60rVAbQA9,bWdj2GDclj5ofokWjzoa5jAwMkxCykd6,5,10,7,0,0,0,4,0,21,3.0,2,0.0,0,7,0,0,10,0,0,4,0,7,14,1
3089,67390,aQ6WrdDe9pTNwVW3vmaMOs1pxy5r3Dxa,RXDvfPUBYFlVdlueBFbLW0mhhAyGEqpt,39,58,34,38,18,44,13,3,208,29.714285714285715,6,0.0,8,34,31,18,50,44,7,13,3,91,117,1
3090,67398,gYz3DXiXiB2ygQdrSqkvFFqa3NbdbDQD,SpATywNh6bZuzm8s1ceuBUnMUAeoAHHw,1,0,0,0,0,0,1,0,1,0.14285714285714285,1,0.0,0,0,0,0,0,0,0,1,0,0,1,1
3091,67399,dX8G0MwLqG7R1v0a5bVLBBEO2QeJVwW8,SpATywNh6bZuzm8s1ceuBUnMUAeoAHHw,13,7,4,13,3,0,2,0,29,4.142857142857143,1,0.0,2,4,11,3,5,0,2,2,0,20,9,1
3092,67403,s42YRljOqExiv71QhA2soTLfn9kHZdPI,bWdj2GDclj5ofokWjzoa5jAwMkxCykd6,6,6,4,0,0,0,4,0,14,2.0,2,0.0,0,4,0,0,6,0,0,4,0,4,10,1
3093,67407,s42YRljOqExiv71QhA2soTLfn9kHZdPI,G8EPVSXsOYB5YQWZGiz1aVq5Pgr2GrQu,11,19,13,0,0,0,6,0,38,5.428571428571429,4,0.0,0,13,0,0,19,0,0,6,0,13,25,1
3094,67410,SUuO92fg900YcWp4Zs3wbFF13otrTK0v,SpATywNh6bZuzm8s1ceuBUnMUAeoAHHw,9,10,0,11,0,0,4,0,25,3.5714285714285716,1,0.0,4,0,11,0,6,0,0,4,0,15,10,0
3095,67411,tvf3NtE6iYQ6D7C3fM47X9eIcuZU3rZg,SpATywNh6bZuzm8s1ceuBUnMUAeoAHHw,1,0,0,0,0,0,1,0,1,0.14285714285714285,1,0.0,0,0,0,0,0,0,0,1,0,0,1,1
3096,67415,JBvV2euLTmN1KOC1bV6ujBU9dbXkql5n,SpATywNh6bZuzm8s1ceuBUnMUAeoAHHw,7,3,1,0,2,0,3,0,9,1.2857142857142858,1,0.0,0,1,0,2,3,0,0,3,0,3,6,1
3097,67420,IQ0KwwSF7jAVaA1XdkRcnXVwTeEvf1Lv,G8EPVSXsOYB5YQWZGiz1aVq5Pgr2GrQu,8,8,2,0,1,0,7,0,18,2.5714285714285716,2,0.0,3,2,0,1,5,0,0,7,0,6,12,1
3098,67426,VFYk1GyeJyGqK1t09cLe0E5m7KsULmvc,G8EPVSXsOYB5YQWZGiz1aVq5Pgr2GrQu,58,127,62,100,43,47,23,1,403,57.57142857142857,8,0.0,8,62,86,43,119,47,14,23,1,199,204,1
3099,67428,oKLMQAZTIOtP37CLM9yXiFLXKHfYljGQ,SpATywNh6bZuzm8s1ceuBUnMUAeoAHHw,6,10,3,0,1,0,2,0,16,2.2857142857142856,2,0.0,0,3,0,1,10,0,0,2,0,4,12,1
3100,67430,RQJ9jLgqxRIRHJ3Dya9dRIuO3dlScgvn,SpATywNh6bZuzm8s1ceuBUnMUAeoAHHw,13,18,0,16,0,10,6,1,51,7.285714285714286,2,0.0,10,0,13,0,8,10,3,6,1,23,28,1
3101,67432,FdsEBC0mHy1vT6x3hjK3QpB4Q1Uhf4Gh,SpATywNh6bZuzm8s1ceuBUnMUAeoAHHw,23,36,0,24,0,1,17,1,79,11.285714285714286,5,0.0,4,0,20,0,32,1,4,17,1,24,55,0
3102,67453,BuFcLJJOy4ywnCaR2obicsAMubCpPv8W,G8EPVSXsOYB5YQWZGiz1aVq5Pgr2GrQu,14,34,8,0,6,1,14,1,64,9.142857142857142,1,0.0,3,8,0,6,31,1,0,14,1,17,47,1
3103,67459,Gb2kkDHyDR8EKKTcjBRaUmubTYuyJhiK,G8EPVSXsOYB5YQWZGiz1aVq5Pgr2GrQu,27,34,15,18,11,0,8,0,86,12.285714285714286,3,0.0,7,15,13,11,27,0,5,8,0,46,40,1
3104,67471,a6W98SSI7NFdfjtHnUJXqYQ7M2ljRDYt,SpATywNh6bZuzm8s1ceuBUnMUAeoAHHw,13,33,11,23,1,4,15,2,89,12.714285714285714,5,0.0,13,11,20,1,20,4,3,15,2,45,44,0
3105,67477,SivEvgGr7pG5rlJGO3LDvmVfpVlkOk9l,SpATywNh6bZuzm8s1ceuBUnMUAeoAHHw,11,17,3,0,1,0,7,1,29,4.142857142857143,3,0.0,1,3,0,1,16,0,0,7,1,5,24,1
3106,67502,aqNbKvnpDmE6ISe0Qz8K64tYcLrFHQcz,SpATywNh6bZuzm8s1ceuBUnMUAeoAHHw,6,3,2,0,2,0,1,0,8,1.1428571428571428,1,0.0,0,2,0,2,3,0,0,1,0,4,4,1
3107,67524,VaOhD86uWnK2TjloSi50DgiXbw9C3K0T,bWdj2GDclj5ofokWjzoa5jAwMkxCykd6,8,32,2,0,1,0,13,0,48,6.857142857142857,1,0.0,0,2,0,1,32,0,0,13,0,3,45,1
3108,67525,UwnKbl2ARSQ7IikE1xisJoI3ICSxWK5v,SpATywNh6bZuzm8s1ceuBUnMUAeoAHHw,3,2,1,0,0,0,2,0,5,0.7142857142857143,2,0.0,0,1,0,0,2,0,0,2,0,1,4,1
3109,67531,HXqJJTXStUqZG7I7cVStlMobVqz7irG0,SpATywNh6bZuzm8s1ceuBUnMUAeoAHHw,8,6,4,0,2,0,2,0,14,2.0,1,0.0,0,4,0,2,6,0,0,2,0,6,8,1
3110,67538,6IcVTIvgSxxMCCqvswEKCMSbCJJ6BHWS,RXDvfPUBYFlVdlueBFbLW0mhhAyGEqpt,25,33,19,28,11,3,4,0,98,14.0,2,0.0,7,19,25,11,26,3,3,4,0,62,36,1
3111,67541,wb1auupOEOByBWLVmCpIzBal9pmTApTW,bWdj2GDclj5ofokWjzoa5jAwMkxCykd6,16,19,8,78,8,18,5,2,138,19.714285714285715,2,0.0,7,8,75,8,12,18,3,5,2,98,40,1
3112,67544,gSzwbDlzeyvDrdHnrWsBTEKJeSjOW5Jb,RXDvfPUBYFlVdlueBFbLW0mhhAyGEqpt,17,23,10,0,6,0,20,0,59,8.428571428571429,3,0.0,5,10,0,6,18,0,0,20,0,21,38,1
3113,67552,Bfvp2pdOjaKzYdBNQKGPqSn1IHYZcfBw,SpATywNh6bZuzm8s1ceuBUnMUAeoAHHw,4,2,1,0,1,0,1,0,5,0.7142857142857143,1,0.0,0,1,0,1,2,0,0,1,0,2,3,1
3114,67553,YGhHDAwBdNiyL9eKoJUrnR1s8ObHumpL,SpATywNh6bZuzm8s1ceuBUnMUAeoAHHw,5,3,1,0,1,0,1,0,6,0.8571428571428571,1,0.0,0,1,0,1,3,0,0,1,0,2,4,1
3115,67559,q2OeaRVSMsymXTCsCZPucygIuEsf22CD,SpATywNh6bZuzm8s1ceuBUnMUAeoAHHw,1,0,0,0,0,0,1,0,1,0.14285714285714285,1,0.0,0,0,0,0,0,0,0,1,0,0,1,1
3116,67567,2famc4S1vDEuGFyXiIN218hXpJ7I8XBG,SpATywNh6bZuzm8s1ceuBUnMUAeoAHHw,5,2,1,0,1,2,2,0,8,1.1428571428571428,1,0.0,0,1,0,1,2,2,0,2,0,2,6,1
3117,67570,I1340YsGXK2BIG96XRWppOvFniqpKDu7,RXDvfPUBYFlVdlueBFbLW0mhhAyGEqpt,47,69,25,147,13,7,11,0,272,38.857142857142854,2,0.0,22,25,131,13,47,7,16,11,0,191,81,0
3118,67574,3bThVr1RhSpIoI7gmUCoVwEy4UIBaasx,RXDvfPUBYFlVdlueBFbLW0mhhAyGEqpt,5,2,1,0,1,9,3,0,16,2.2857142857142856,2,0.0,0,1,0,1,2,9,0,3,0,2,14,1
3119,67600,nSn0VSHBRSmwKbK0c8WkxsGEmgkNhPeq,SpATywNh6bZuzm8s1ceuBUnMUAeoAHHw,1,0,0,0,0,0,1,0,1,0.14285714285714285,1,0.0,0,0,0,0,0,0,0,1,0,0,1,1
3120,67609,VaOhD86uWnK2TjloSi50DgiXbw9C3K0T,SpATywNh6bZuzm8s1ceuBUnMUAeoAHHw,6,9,3,0,1,0,6,0,19,2.7142857142857144,2,0.0,0,3,0,1,9,0,0,6,0,4,15,1
3121,67623,Sqd3Eviij3ahMVLlwINw4LiDCg7rwrfy,RXDvfPUBYFlVdlueBFbLW0mhhAyGEqpt,10,9,5,0,3,0,4,1,22,3.142857142857143,2,0.0,0,5,0,3,9,0,0,4,1,8,14,1
3122,67629,BMgk3lhp6DaLc2hrRyAZS5f3pfgtil58,RXDvfPUBYFlVdlueBFbLW0mhhAyGEqpt,14,14,5,24,0,1,3,0,47,6.714285714285714,1,0.0,2,5,24,0,12,1,0,3,0,31,16,1
3123,67632,rztgByxlqb0NHiCkVNMSLs4z23c2EnGy,RXDvfPUBYFlVdlueBFbLW0mhhAyGEqpt,7,8,5,0,2,0,3,0,18,2.5714285714285716,3,0.0,1,5,0,2,7,0,0,3,0,8,10,1
3124,67641,8QtgTaOo9DCjgt6kc4Db1wXfaWgbOe0I,SpATywNh6bZuzm8s1ceuBUnMUAeoAHHw,16,22,9,15,3,0,16,0,65,9.285714285714286,3,0.0,7,9,13,3,15,0,2,16,0,32,33,1
3125,67642,BwXR7IzUtCAN8pzY1XJl6dbItwnWn8P1,SpATywNh6bZuzm8s1ceuBUnMUAeoAHHw,24,67,32,23,4,3,24,1,154,22.0,8,0.0,17,32,23,4,50,3,0,24,1,76,78,0
3126,67645,7qacCXNHfhtV3QzmLTTx2G76bXaJZKdF,SpATywNh6bZuzm8s1ceuBUnMUAeoAHHw,16,35,10,26,4,2,8,1,86,12.285714285714286,3,0.0,7,10,21,4,28,2,5,8,1,42,44,1
3127,67658,h5afPVcogbI1QW4dfwFBz4UIlWjjM3RW,SpATywNh6bZuzm8s1ceuBUnMUAeoAHHw,27,34,11,26,5,10,24,5,115,16.428571428571427,3,0.0,10,11,24,5,24,10,2,24,5,50,65,0
3128,67667,6uiFMn8grVARFSiZJzUXdXUiSRmDc7wn,SpATywNh6bZuzm8s1ceuBUnMUAeoAHHw,5,2,1,0,1,0,2,0,6,0.8571428571428571,1,0.0,0,1,0,1,2,0,0,2,0,2,4,1
3129,67673,kXJgNJrJLFK7Wt9KanP6QLSHH0toxORn,bWdj2GDclj5ofokWjzoa5jAwMkxCykd6,8,5,1,16,2,0,4,0,28,4.0,1,0.0,3,1,15,2,2,0,1,4,0,21,7,1
3130,67698,3T1Ajx8AzLKpkWsqnzq5ndyNCwXcvT6Q,G8EPVSXsOYB5YQWZGiz1aVq5Pgr2GrQu,9,10,3,4,2,0,1,0,20,2.857142857142857,1,0.0,6,3,2,2,4,0,2,1,0,13,7,1
3131,67700,Rj8CRmBx55LfZEmX69tsiuIQYQCOEvVu,bWdj2GDclj5ofokWjzoa5jAwMkxCykd6,4,6,1,0,1,0,2,0,10,1.4285714285714286,2,0.0,2,1,0,1,4,0,0,2,0,4,6,1
3132,67705,3cEo76QwJwldypMfZu21btn9IT8f6eL0,SpATywNh6bZuzm8s1ceuBUnMUAeoAHHw,15,34,3,22,2,5,10,4,80,11.428571428571429,2,0.0,17,3,19,2,17,5,3,10,4,41,39,1
3133,67729,KY9QavBrusW9AVV6DEyZrJ3FCnXy59JE,SpATywNh6bZuzm8s1ceuBUnMUAeoAHHw,9,19,10,0,3,0,12,0,44,6.285714285714286,3,0.0,0,10,0,3,19,0,0,12,0,13,31,1
3134,67732,2gXHY5qLgY96Nt3kImmboPawcy43EQXt,bWdj2GDclj5ofokWjzoa5jAwMkxCykd6,7,14,13,0,11,0,7,1,46,6.571428571428571,2,0.0,0,13,0,11,14,0,0,7,1,24,22,1
3135,67740,uCpSmjtsmbP6Tx3GZFwKoiUihKYXvJaM,SpATywNh6bZuzm8s1ceuBUnMUAeoAHHw,12,21,0,20,0,0,3,0,44,6.285714285714286,1,0.0,12,0,17,0,9,0,3,3,0,29,15,1
3136,67750,myyvmwvFjycfP5QErbd6tsUl0M6ndOJg,bWdj2GDclj5ofokWjzoa5jAwMkxCykd6,1,0,0,0,0,0,1,0,1,0.14285714285714285,1,0.0,0,0,0,0,0,0,0,1,0,0,1,1
3137,67751,myyvmwvFjycfP5QErbd6tsUl0M6ndOJg,SpATywNh6bZuzm8s1ceuBUnMUAeoAHHw,17,28,7,21,3,14,17,1,91,13.0,2,0.0,14,7,18,3,14,14,3,17,1,42,49,1
3138,67753,KY9QavBrusW9AVV6DEyZrJ3FCnXy59JE,bWdj2GDclj5ofokWjzoa5jAwMkxCykd6,5,2,1,0,1,0,2,0,6,0.8571428571428571,1,0.0,0,1,0,1,2,0,0,2,0,2,4,1
3139,67780,GlNbCQHDc8z8JZPiUwkPuJYi1fBEr1Uj,SpATywNh6bZuzm8s1ceuBUnMUAeoAHHw,8,27,9,0,0,0,5,0,41,5.857142857142857,2,0.0,8,9,0,0,19,0,0,5,0,17,24,1
3140,67782,0hRwE5vbowYRJTF6rcWCTgSh4yHA34bg,bWdj2GDclj5ofokWjzoa5jAwMkxCykd6,15,19,1,28,1,5,10,3,67,9.571428571428571,2,0.0,3,1,24,1,16,5,4,10,3,29,38,1
3141,67785,rqqNQl0bghaqvkPV1u2C08foWzi8FdRA,SpATywNh6bZuzm8s1ceuBUnMUAeoAHHw,12,13,5,11,3,0,2,0,34,4.857142857142857,2,0.0,4,5,10,3,9,0,1,2,0,22,12,1
3142,67791,knXx0VSX34ZZdw5j0pCDnRFFDbxG6IJ6,G8EPVSXsOYB5YQWZGiz1aVq5Pgr2GrQu,12,9,5,8,3,0,2,0,27,3.857142857142857,1,0.0,3,5,5,3,6,0,3,2,0,16,11,1
3143,67792,nhiUGENuXs75W6QlSu5vemDE5ZazLnGr,SpATywNh6bZuzm8s1ceuBUnMUAeoAHHw,11,13,5,13,2,0,4,0,37,5.285714285714286,2,0.0,6,5,11,2,7,0,2,4,0,24,13,1
3144,67795,ryJpL5sHkbmvdjizu6MIIT96L8Kj1MfG,SpATywNh6bZuzm8s1ceuBUnMUAeoAHHw,13,16,8,13,4,1,2,0,44,6.285714285714286,2,0.0,5,8,10,4,11,1,3,2,0,27,17,1
3145,67802,IEfUasRNK7F4OXmh9ZRgY5RLlk7j6VcY,bWdj2GDclj5ofokWjzoa5jAwMkxCykd6,9,11,6,6,3,0,4,0,30,4.285714285714286,2,0.0,1,6,6,3,10,0,0,4,0,16,14,1
3146,67805,3g0CiljEiblxCvXeNEcFARnThDq8TtPt,SpATywNh6bZuzm8s1ceuBUnMUAeoAHHw,21,46,19,13,11,15,10,1,115,16.428571428571427,6,0.0,12,19,12,11,34,15,1,10,1,54,61,0
3147,67814,7YAyDVo7GNQL9jwTCNlUB5NS22KP2Dmb,bWdj2GDclj5ofokWjzoa5jAwMkxCykd6,1,0,0,0,0,0,1,0,1,0.14285714285714285,1,0.0,0,0,0,0,0,0,0,1,0,0,1,1
3148,67826,arUYdy6tAdeT8uL5IVe1ucPvbGcQUSs0,RXDvfPUBYFlVdlueBFbLW0mhhAyGEqpt,45,32,19,89,14,2,8,1,165,23.571428571428573,3,0.0,10,19,82,14,22,2,7,8,1,125,40,0
3149,67828,8MQx62NrM26CEa5RRkhFUh36AiGGNx6S,SpATywNh6bZuzm8s1ceuBUnMUAeoAHHw,1,0,0,0,0,0,1,0,1,0.14285714285714285,1,0.0,0,0,0,0,0,0,0,1,0,0,1,1
3150,67840,liGkK11lmEt5l6sf4BenFBe3u0IYqC3Z,bWdj2GDclj5ofokWjzoa5jAwMkxCykd6,1,0,0,0,0,0,1,0,1,0.14285714285714285,1,0.0,0,0,0,0,0,0,0,1,0,0,1,1
3151,67844,e2v0YuUkw7VpGwXO9DL86A4Bv6MP4mEu,SpATywNh6bZuzm8s1ceuBUnMUAeoAHHw,6,3,1,0,1,0,3,0,8,1.1428571428571428,1,0.0,0,1,0,1,3,0,0,3,0,2,6,1
3152,67852,3Aezv8lgcVyIW4Uwgi3KMiL4RZSkwke5,SpATywNh6bZuzm8s1ceuBUnMUAeoAHHw,21,29,13,26,4,29,14,0,115,16.428571428571427,6,0.0,12,13,22,4,17,29,4,14,0,51,64,1
3153,67860,zILXfIGJjWXm6dA2MrEQWr2XeEUry8lN,G8EPVSXsOYB5YQWZGiz1aVq5Pgr2GrQu,7,2,1,0,1,0,4,0,8,1.1428571428571428,1,0.0,0,1,0,1,2,0,0,4,0,2,6,1
3154,67870,w3ElIgawNC8WwURVJSAJ04McneT8QIvi,G8EPVSXsOYB5YQWZGiz1aVq5Pgr2GrQu,22,22,19,48,10,3,4,0,106,15.142857142857142,2,0.0,0,19,38,10,22,3,10,4,0,67,39,1
3155,67877,3kPbFQO63O023TRazY2t5V1M3b8brUv8,SpATywNh6bZuzm8s1ceuBUnMUAeoAHHw,7,10,0,0,0,1,3,0,14,2.0,2,0.0,0,0,0,0,10,1,0,3,0,0,14,1
3156,67879,bRwq2z1Yz5KS0MW4CkmNDI34p59fmbas,RXDvfPUBYFlVdlueBFbLW0mhhAyGEqpt,6,5,1,0,0,0,3,0,9,1.2857142857142858,2,0.0,0,1,0,0,5,0,0,3,0,1,8,1
3157,67909,sFJi6moEGD2T3AyA8nWt11YDR7GEvwod,bWdj2GDclj5ofokWjzoa5jAwMkxCykd6,8,7,4,0,2,2,10,1,26,3.7142857142857144,2,0.0,0,4,0,2,7,2,0,10,1,6,20,1
3158,67912,P0LyrpZzGdWXSuU2oQCFUf1LzUdIEooV,SpATywNh6bZuzm8s1ceuBUnMUAeoAHHw,5,2,1,0,1,0,2,0,6,0.8571428571428571,1,0.0,0,1,0,1,2,0,0,2,0,2,4,1
3159,67916,kbnRP5v2Cp1hRovzbBsM6Gb1jKCIVIhL,bWdj2GDclj5ofokWjzoa5jAwMkxCykd6,5,8,2,0,2,0,5,0,17,2.4285714285714284,3,0.0,0,2,0,2,8,0,0,5,0,4,13,1
3160,67918,pzHaWUcmzb5LgLjIjpaBYBq7daMNFpyk,SpATywNh6bZuzm8s1ceuBUnMUAeoAHHw,23,41,2,35,0,0,25,0,103,14.714285714285714,5,0.0,11,2,31,0,30,0,4,25,0,44,59,1
3161,67921,QqqCImBc1OlgaSz0c9g0FVsZigKUtiqT,SpATywNh6bZuzm8s1ceuBUnMUAeoAHHw,6,1,1,0,1,0,3,0,6,0.8571428571428571,1,0.0,0,1,0,1,1,0,0,3,0,2,4,1
3162,67923,GDzMP0flkQ2hBX32d5dxAzabEDzF5Okt,SpATywNh6bZuzm8s1ceuBUnMUAeoAHHw,8,21,9,0,7,0,1,0,38,5.428571428571429,1,0.0,0,9,0,7,21,0,0,1,0,16,22,1
3163,67930,x6K6gEN1bi7EtUHqEXEFGztPxJcTq3NW,SpATywNh6bZuzm8s1ceuBUnMUAeoAHHw,29,38,19,34,8,0,10,0,109,15.571428571428571,4,0.0,6,19,29,8,32,0,5,10,0,62,47,1
3164,67931,OYfteiWNoHqPLaPu97Z12Qs0dcDVEU6S,SpATywNh6bZuzm8s1ceuBUnMUAeoAHHw,10,5,4,0,3,0,2,0,14,2.0,1,0.0,0,4,0,3,5,0,0,2,0,7,7,1
3165,67933,f517pkeTgS2hq8EkZsCwn6jk8FMpBlHa,bWdj2GDclj5ofokWjzoa5jAwMkxCykd6,5,5,3,0,2,0,2,0,12,1.7142857142857142,2,0.0,0,3,0,2,5,0,0,2,0,5,7,1
3166,67939,96BILLwhKLX5Hn5XJ4XGCvMlo8QDhAAj,bWdj2GDclj5ofokWjzoa5jAwMkxCykd6,1,0,0,0,0,0,1,0,1,0.14285714285714285,1,0.0,0,0,0,0,0,0,0,1,0,0,1,1
3167,67951,p9mlVtqvvgTSd0U238vycamcjMBfubit,SpATywNh6bZuzm8s1ceuBUnMUAeoAHHw,8,9,7,0,4,0,5,0,25,3.5714285714285716,1,0.0,0,7,0,4,9,0,0,5,0,11,14,1
3168,67956,laZtrdxzAU1QbcDNiYt367rO7zb5NT6r,SpATywNh6bZuzm8s1ceuBUnMUAeoAHHw,1,0,0,0,0,0,1,0,1,0.14285714285714285,1,0.0,0,0,0,0,0,0,0,1,0,0,1,1
3169,67974,5RgoX61rBJXf0CtdNHC5FjUHV0bRPnZt,SpATywNh6bZuzm8s1ceuBUnMUAeoAHHw,10,3,3,0,2,1,4,1,14,2.0,1,0.0,0,3,0,2,3,1,0,4,1,5,9,1
3170,67989,hSX8yZ4n5gfrq8om8peGXZoF496tHdJ6,SpATywNh6bZuzm8s1ceuBUnMUAeoAHHw,1,0,0,0,0,0,1,0,1,0.14285714285714285,1,0.0,0,0,0,0,0,0,0,1,0,0,1,1
3171,67995,LHXRg7L7kOMUaNixGAIsvmtlbCTLBkt1,G8EPVSXsOYB5YQWZGiz1aVq5Pgr2GrQu,12,10,1,26,0,0,5,0,42,6.0,1,0.0,1,1,23,0,9,0,3,5,0,25,17,1
3172,68000,zP7Uswh6CHfnx5kLYcdPpqokCtUDEMqC,SpATywNh6bZuzm8s1ceuBUnMUAeoAHHw,9,6,4,0,2,0,5,0,17,2.4285714285714284,1,0.0,0,4,0,2,6,0,0,5,0,6,11,1
3173,68003,hc3dSrci35Dy3FgQbfVD88Ol0CqYSCR2,RXDvfPUBYFlVdlueBFbLW0mhhAyGEqpt,39,34,20,56,13,5,1,0,129,18.428571428571427,1,0.0,12,20,53,13,22,5,3,1,0,98,31,1
3174,68011,Y0dtU5bUn0PrrnfgvOUCPfb1rktwn4CX,SpATywNh6bZuzm8s1ceuBUnMUAeoAHHw,4,2,1,0,1,0,1,0,5,0.7142857142857143,1,0.0,0,1,0,1,2,0,0,1,0,2,3,1
3175,68014,eSHpbUzZvfLR4whtzGnR3u58hC1o1DTb,SpATywNh6bZuzm8s1ceuBUnMUAeoAHHw,19,29,10,17,7,1,7,0,71,10.142857142857142,3,0.0,16,10,14,7,13,1,3,7,0,47,24,1
3176,68031,bez5lZ7uTfbzlLF7Tc3pJJ6gxAYK8BMg,RXDvfPUBYFlVdlueBFbLW0mhhAyGEqpt,1,0,0,0,0,0,1,0,1,0.14285714285714285,1,0.0,0,0,0,0,0,0,0,1,0,0,1,1
3177,68033,g3VeqRwacliKE1TZTgZHIE5PL7TPQV85,SpATywNh6bZuzm8s1ceuBUnMUAeoAHHw,3,2,0,0,0,0,1,0,3,0.42857142857142855,1,0.0,0,0,0,0,2,0,0,1,0,0,3,1
3178,68043,mHfTvd1CfaCURBT44fgL7AymprwCoavs,SpATywNh6bZuzm8s1ceuBUnMUAeoAHHw,17,36,6,20,3,3,20,1,89,12.714285714285714,4,0.0,5,6,16,3,31,3,4,20,1,30,59,1
3179,68045,Qxy5KsClrN9vr6xM8xy9xnCXA2MaJ6Yo,SpATywNh6bZuzm8s1ceuBUnMUAeoAHHw,4,4,0,0,0,0,4,0,8,1.1428571428571428,2,0.0,0,0,0,0,4,0,0,4,0,0,8,1
3180,68057,zmlL73g2U1Ek37ZDQ2H6P7dwK1MBsxuX,SpATywNh6bZuzm8s1ceuBUnMUAeoAHHw,12,32,19,0,13,6,7,1,78,11.142857142857142,3,0.0,0,19,0,13,32,6,0,7,1,32,46,1
3181,68059,V87r8ov3AJYZnaKsWbASGu8Ya7b0fguH,SpATywNh6bZuzm8s1ceuBUnMUAeoAHHw,9,11,5,2,1,0,4,0,23,3.2857142857142856,3,0.0,3,5,2,1,8,0,0,4,0,11,12,1
3182,68070,1VCQvdBqSLamldHF1ZwYh2NF4ESIqek2,bWdj2GDclj5ofokWjzoa5jAwMkxCykd6,13,5,2,46,2,1,9,0,65,9.285714285714286,3,0.0,2,2,41,2,3,1,5,9,0,47,18,1
3183,68073,Q3zfa1BaaSk3KZquv3yDWk8LnczxvujV,SpATywNh6bZuzm8s1ceuBUnMUAeoAHHw,13,8,5,0,4,1,10,1,29,4.142857142857143,1,0.0,2,5,0,4,6,1,0,10,1,11,18,1
3184,68080,PwGj8ON4yrWpMaoZE0ES8sG2eAqFQNfN,bWdj2GDclj5ofokWjzoa5jAwMkxCykd6,12,17,11,0,7,17,8,2,62,8.857142857142858,4,0.0,0,11,0,7,17,17,0,8,2,18,44,1
3185,68106,13DcuqcvvZMyCe7b78EqeBeeWiXw335e,G8EPVSXsOYB5YQWZGiz1aVq5Pgr2GrQu,28,119,5,0,35,0,20,2,181,25.857142857142858,4,0.0,73,5,0,35,46,0,0,20,2,113,68,1
3186,68109,uFrJImuWBoPsyUWzay10wbSOjd0eMaSI,SpATywNh6bZuzm8s1ceuBUnMUAeoAHHw,15,15,5,18,3,1,10,0,52,7.428571428571429,2,0.0,10,5,15,3,5,1,3,10,0,33,19,1
3187,68117,MDJGW12z1ZhMFT2gTIbEYAqP2tu7pkDh,SpATywNh6bZuzm8s1ceuBUnMUAeoAHHw,32,55,28,29,9,60,35,3,219,31.285714285714285,8,0.0,14,28,27,9,41,60,2,35,3,78,141,0
3188,68119,Wigd4PnyDnjfDcFOxsTBcEnXo7kl9GSg,RXDvfPUBYFlVdlueBFbLW0mhhAyGEqpt,15,37,5,29,1,0,8,4,84,12.0,3,0.0,5,5,22,1,32,0,7,8,4,33,51,1
3189,68122,q1MlrkW0KNfJjOXajII1Q1GZBULc6aNj,SpATywNh6bZuzm8s1ceuBUnMUAeoAHHw,22,29,2,38,2,11,16,3,101,14.428571428571429,3,0.0,8,2,33,2,21,11,5,16,3,45,56,1
3190,68135,HStxcO1eYnD7c9LphwK9HrPR7VO3IHfm,SpATywNh6bZuzm8s1ceuBUnMUAeoAHHw,12,11,0,13,0,7,5,1,37,5.285714285714286,1,0.0,3,0,11,0,8,7,2,5,1,14,23,1
3191,68153,EY0G0vEEEoCokHenoT1cdgE4rcGAf4FL,G8EPVSXsOYB5YQWZGiz1aVq5Pgr2GrQu,4,2,1,0,1,0,1,0,5,0.7142857142857143,1,0.0,0,1,0,1,2,0,0,1,0,2,3,0
3192,68154,APkKPEpve0ecRJut2qy8IYwsafYtrJRq,bWdj2GDclj5ofokWjzoa5jAwMkxCykd6,3,2,0,0,0,0,3,0,5,0.7142857142857143,2,0.0,0,0,0,0,2,0,0,3,0,0,5,1
3193,68160,DYC2TKuAWipp9UNJIdqFLJgrkLj9mdOD,bWdj2GDclj5ofokWjzoa5jAwMkxCykd6,15,22,7,36,2,0,10,1,78,11.142857142857142,3,0.0,5,7,32,2,17,0,4,10,1,46,32,0
3194,68169,U8vo2wOZC3Q8EW1kIl6iwoIzgmQUZ4u1,bWdj2GDclj5ofokWjzoa5jAwMkxCykd6,1,0,0,0,0,0,1,0,1,0.14285714285714285,1,0.0,0,0,0,0,0,0,0,1,0,0,1,1
3195,68170,bpxaFadaQixJuWRVtAAq5miKiBM3zC6u,bWdj2GDclj5ofokWjzoa5jAwMkxCykd6,17,70,10,32,3,0,27,0,142,20.285714285714285,7,0.0,13,10,31,3,57,0,1,27,0,57,85,1
3196,68171,XNe46LXabpvEI4s4Cxqc45erOVco8nzW,RXDvfPUBYFlVdlueBFbLW0mhhAyGEqpt,38,30,18,42,7,16,11,3,127,18.142857142857142,3,0.0,7,18,35,7,23,16,7,11,3,67,60,0
3197,68177,y6oK2aw09rZ1km46IcOJlYdWLv4Nbbgi,G8EPVSXsOYB5YQWZGiz1aVq5Pgr2GrQu,10,11,6,0,5,0,8,1,31,4.428571428571429,3,0.0,3,6,0,5,8,0,0,8,1,14,17,1
3198,68185,LGH5sOmtpw8WtitJ1dxQtTEBLQHqJEi1,SpATywNh6bZuzm8s1ceuBUnMUAeoAHHw,8,5,4,0,3,1,8,0,21,3.0,1,0.0,0,4,0,3,5,1,0,8,0,7,14,1
3199,68190,hWdLPP6trGxWYA1TuFBESlsN42OdBR5S,G8EPVSXsOYB5YQWZGiz1aVq5Pgr2GrQu,6,4,1,0,1,0,2,0,8,1.1428571428571428,1,0.0,0,1,0,1,4,0,0,2,0,2,6,1
3200,68192,TWLIxoyQjwriLBEzpRamZWHBF7mx1bZa,SpATywNh6bZuzm8s1ceuBUnMUAeoAHHw,6,11,0,0,0,0,4,0,15,2.142857142857143,2,0.0,1,0,0,0,10,0,0,4,0,1,14,1
3201,68199,rcnv42t7RT4fLoWqKHgTKDC8e00KMJQL,G8EPVSXsOYB5YQWZGiz1aVq5Pgr2GrQu,43,52,20,134,1,7,20,2,236,33.714285714285715,2,0.0,15,20,107,1,37,7,27,20,2,143,93,1
3202,68216,PiwCisYixMxmp8HVjRmlBlqNy6QSUUjE,SpATywNh6bZuzm8s1ceuBUnMUAeoAHHw,11,19,8,0,3,13,9,1,53,7.571428571428571,3,0.0,0,8,0,3,19,13,0,9,1,11,42,1
3203,68218,Lbpr3xWnQcIYr1qRkqlNlsrYRpIeuPh8,SpATywNh6bZuzm8s1ceuBUnMUAeoAHHw,9,31,7,0,4,2,12,0,56,8.0,6,0.0,2,7,0,4,29,2,0,12,0,13,43,1
3204,68219,PLTytqL5kLJdDGm9MvAFVaFDS2S7nPDO,SpATywNh6bZuzm8s1ceuBUnMUAeoAHHw,24,26,14,10,7,0,8,0,65,9.285714285714286,7,0.0,3,14,10,7,23,0,0,8,0,34,31,1
3205,68231,c21M8vKZ0MTakbncwKdeoIofnrY81cjv,SpATywNh6bZuzm8s1ceuBUnMUAeoAHHw,1,0,0,0,0,0,1,0,1,0.14285714285714285,1,0.0,0,0,0,0,0,0,0,1,0,0,1,1
3206,68232,afcoJmZ0nAGqrhElRzMbfqW6LhEtEJYc,bWdj2GDclj5ofokWjzoa5jAwMkxCykd6,7,8,4,0,3,0,4,0,19,2.7142857142857144,1,0.0,2,4,0,3,6,0,0,4,0,9,10,1
3207,68233,MulztkDP8i6NO9fvTruczDhNDdweXQmA,SpATywNh6bZuzm8s1ceuBUnMUAeoAHHw,7,6,5,0,1,0,1,0,13,1.8571428571428572,1,0.0,0,5,0,1,6,0,0,1,0,6,7,0
3208,68255,KkwBRsW7iwfoq3LjJ8XmEzXVsYBRv2GT,RXDvfPUBYFlVdlueBFbLW0mhhAyGEqpt,8,5,0,0,0,8,7,1,21,3.0,2,0.0,0,0,0,0,5,8,0,7,1,0,21,1
3209,68284,AffDAPGfOBWNdcJAjvPAA03wTtMubBsN,SpATywNh6bZuzm8s1ceuBUnMUAeoAHHw,14,7,4,9,3,0,3,0,26,3.7142857142857144,1,0.0,2,4,9,3,5,0,0,3,0,18,8,1
3210,68291,uuLKbFK5mMvYPMLqDF2i3zslYpeZQmHn,SpATywNh6bZuzm8s1ceuBUnMUAeoAHHw,3,0,0,0,0,1,3,0,4,0.5714285714285714,1,0.0,0,0,0,0,0,1,0,3,0,0,4,1
3211,68297,KGm62I3mVkjiGl4NGvCWbKWuafRNbMyV,SpATywNh6bZuzm8s1ceuBUnMUAeoAHHw,8,9,4,0,2,0,4,0,19,2.7142857142857144,2,0.0,1,4,0,2,8,0,0,4,0,7,12,0
3212,68301,NRKadp4j4jPDuLDbaa9Nm62h1VN187qT,SpATywNh6bZuzm8s1ceuBUnMUAeoAHHw,30,54,22,34,9,71,28,2,220,31.428571428571427,3,0.0,23,22,30,9,31,71,4,28,2,84,136,1
3213,68311,HbZIH6bmQW1HcPZo94YfjT1UBGLpCJBJ,SpATywNh6bZuzm8s1ceuBUnMUAeoAHHw,5,2,1,0,1,0,2,0,6,0.8571428571428571,1,0.0,0,1,0,1,2,0,0,2,0,2,4,1
3214,68315,egnijdxL4Cz1CfzoCQSNIgWry6KIzA7P,G8EPVSXsOYB5YQWZGiz1aVq5Pgr2GrQu,11,15,6,2,4,0,2,0,29,4.142857142857143,2,0.0,2,6,2,4,13,0,0,2,0,14,15,1
3215,68322,FfFp5bobRPRps1SNXZNMmjBhJWfjO7gk,RXDvfPUBYFlVdlueBFbLW0mhhAyGEqpt,5,2,1,0,1,0,2,0,6,0.8571428571428571,1,0.0,0,1,0,1,2,0,0,2,0,2,4,1
3216,68328,y9yy4SYGgNo4YF8eQGlTVidGNj2rzbsP,G8EPVSXsOYB5YQWZGiz1aVq5Pgr2GrQu,5,3,2,0,1,0,1,0,7,1.0,1,0.0,0,2,0,1,3,0,0,1,0,3,4,1
3217,68354,ojZgxZ6gEjMazXpFaRfu4Ae98N9ZNMRK,bWdj2GDclj5ofokWjzoa5jAwMkxCykd6,7,3,1,0,1,0,5,0,10,1.4285714285714286,2,0.0,1,1,0,1,2,0,0,5,0,3,7,1
3218,68355,Su5k7DFmddHd0lx2vnzPJZVUiGwHL7uO,SpATywNh6bZuzm8s1ceuBUnMUAeoAHHw,1,0,0,0,0,0,1,0,1,0.14285714285714285,1,0.0,0,0,0,0,0,0,0,1,0,0,1,1
3219,68358,MKeSX2kzyiQphau2C7yhMMzLx4acc2Cv,SpATywNh6bZuzm8s1ceuBUnMUAeoAHHw,9,11,6,0,3,0,2,0,22,3.142857142857143,1,0.0,0,6,0,3,11,0,0,2,0,9,13,1
3220,68366,KWreIfKGdz3TT4Efo15YH7GPido1RPFL,RXDvfPUBYFlVdlueBFbLW0mhhAyGEqpt,7,8,5,0,2,0,7,0,22,3.142857142857143,3,0.0,0,5,0,2,8,0,0,7,0,7,15,1
3221,68367,sU7Jp2ENUb9Oqtzi9ZG3CKbDOgPtBcP1,SpATywNh6bZuzm8s1ceuBUnMUAeoAHHw,11,22,11,0,6,19,13,1,72,10.285714285714286,1,0.0,6,11,0,6,16,19,0,13,1,23,49,1
3222,68368,jzWvwaTexkgbyBrPkQbXDb98Viqx6cSS,bWdj2GDclj5ofokWjzoa5jAwMkxCykd6,11,7,3,22,2,0,1,0,35,5.0,1,0.0,3,3,21,2,4,0,1,1,0,29,6,1
3223,68381,tx4grxmlQgEoy6eADYfJTj1STA6T1B91,RXDvfPUBYFlVdlueBFbLW0mhhAyGEqpt,4,2,1,0,1,0,1,0,5,0.7142857142857143,2,0.0,0,1,0,1,2,0,0,1,0,2,3,1
3224,68391,GVe9EjZzf7ESYXvbkluFC1UhcDJcs9er,bWdj2GDclj5ofokWjzoa5jAwMkxCykd6,9,26,12,40,5,10,7,0,100,14.285714285714286,3,0.0,5,12,37,5,21,10,3,7,0,59,41,1
3225,68431,lrklBeCwIZ4DDBQy8VTt6d0eH3oNMMDo,G8EPVSXsOYB5YQWZGiz1aVq5Pgr2GrQu,10,12,8,0,4,0,6,0,30,4.285714285714286,2,0.0,0,8,0,4,12,0,0,6,0,12,18,1
3226,68434,Ebz4oSsfYjG2sZnxJFfxROe10fAGS03Z,bWdj2GDclj5ofokWjzoa5jAwMkxCykd6,8,3,2,0,1,3,6,1,16,2.2857142857142856,1,0.0,0,2,0,1,3,3,0,6,1,3,13,1
3227,68452,BmDa42DEGdvrNnigHMvPc7GGH9qDy89v,bWdj2GDclj5ofokWjzoa5jAwMkxCykd6,3,0,0,0,0,0,3,0,3,0.42857142857142855,1,0.0,0,0,0,0,0,0,0,3,0,0,3,1
3228,68460,dxAA51K7owVPQlCgekrtAuSBHXcBEsAY,SpATywNh6bZuzm8s1ceuBUnMUAeoAHHw,8,5,3,0,3,0,1,0,12,1.7142857142857142,2,0.0,0,3,0,3,5,0,0,1,0,6,6,0
3229,68466,ZDEv7xdHlbONQGNdkwzMgbMsJFIzjdrJ,bWdj2GDclj5ofokWjzoa5jAwMkxCykd6,5,3,2,0,1,0,2,0,8,1.1428571428571428,1,0.0,0,2,0,1,3,0,0,2,0,3,5,1
3230,68469,Xa3jTMZEURd4gE5fwojMlxo2QtjAxwez,bWdj2GDclj5ofokWjzoa5jAwMkxCykd6,2,0,0,0,0,0,4,0,4,0.5714285714285714,3,0.0,0,0,0,0,0,0,0,4,0,0,4,1
3231,68481,pXqbqKhLN9u2vMm4aIB5JwL5PRPhZDCp,SpATywNh6bZuzm8s1ceuBUnMUAeoAHHw,14,20,2,13,1,8,7,2,53,7.571428571428571,3,0.0,9,2,11,1,11,8,2,7,2,23,30,0
3232,68486,DudAvEFW2YcxyABZugZo1M6Olvw9DyeE,SpATywNh6bZuzm8s1ceuBUnMUAeoAHHw,6,1,1,0,1,0,3,0,6,0.8571428571428571,1,0.0,0,1,0,1,1,0,0,3,0,2,4,1
3233,68490,hjbzzLF0uZqUL22zLBiQhzq51chcw6mb,SpATywNh6bZuzm8s1ceuBUnMUAeoAHHw,14,29,14,15,6,1,4,0,69,9.857142857142858,1,0.0,9,14,11,6,20,1,4,4,0,40,29,1
3234,68495,MT2eJtF59AVNdUs7mwFqputROb2HgEm3,bWdj2GDclj5ofokWjzoa5jAwMkxCykd6,6,8,4,0,4,0,3,0,19,2.7142857142857144,2,0.0,2,4,0,4,6,0,0,3,0,10,9,0
3235,68504,nB3KwulRK6CdNkJMXAR7thY3WeV5E2Rs,bWdj2GDclj5ofokWjzoa5jAwMkxCykd6,5,2,1,0,1,1,4,0,9,1.2857142857142858,1,0.0,0,1,0,1,2,1,0,4,0,2,7,1
3236,68506,FjEPRVEQHV2jJGjIE0BfvDTSFq9OoqAS,SpATywNh6bZuzm8s1ceuBUnMUAeoAHHw,15,18,11,4,7,0,11,2,53,7.571428571428571,3,0.0,5,11,4,7,13,0,0,11,2,27,26,1
3237,68512,hg5y95p09bcGVElNVwoGOakcfzg7TGFk,bWdj2GDclj5ofokWjzoa5jAwMkxCykd6,6,5,3,0,2,0,6,0,16,2.2857142857142856,1,0.0,0,3,0,2,5,0,0,6,0,5,11,1
3238,68518,FwweMXtSQjX7f97OVLsz3BQNG8M83X1n,SpATywNh6bZuzm8s1ceuBUnMUAeoAHHw,7,2,1,0,1,0,4,0,8,1.1428571428571428,1,0.0,0,1,0,1,2,0,0,4,0,2,6,1
3239,68522,iSIDy53M1GeZpXt46JkUT1CVMnifiRBT,G8EPVSXsOYB5YQWZGiz1aVq5Pgr2GrQu,40,76,45,52,20,89,41,21,344,49.142857142857146,6,0.0,8,45,44,20,68,89,8,41,21,117,227,1
3240,68525,y0PkAopIdLmRFrkWC9eBHvWT77KfVWMh,RXDvfPUBYFlVdlueBFbLW0mhhAyGEqpt,1,0,0,0,0,0,1,0,1,0.14285714285714285,1,0.0,0,0,0,0,0,0,0,1,0,0,1,1
3241,68530,roxYJjIM3BSzWIDsW2TPAjzeyToX557n,SpATywNh6bZuzm8s1ceuBUnMUAeoAHHw,1,0,0,0,0,0,1,0,1,0.14285714285714285,1,0.0,0,0,0,0,0,0,0,1,0,0,1,1
3242,68531,hZR4MwcYec4g0GoOyJFngJGEyWOySpv2,RXDvfPUBYFlVdlueBFbLW0mhhAyGEqpt,17,14,9,8,5,8,15,0,59,8.428571428571429,3,0.0,1,9,6,5,13,8,2,15,0,21,38,0
3243,68546,op92WqXlATrimvc1hvYZEQwtjHkoChge,RXDvfPUBYFlVdlueBFbLW0mhhAyGEqpt,13,11,2,0,2,7,11,0,33,4.714285714285714,3,0.0,5,2,0,2,6,7,0,11,0,9,24,1
3244,68557,5yc0fnnf6Ve0yL1SBLUJVE35F9aXHffP,bWdj2GDclj5ofokWjzoa5jAwMkxCykd6,1,0,0,0,0,0,2,0,2,0.2857142857142857,1,0.0,0,0,0,0,0,0,0,2,0,0,2,1
3245,68570,w66Ys32IF7bg4QEY48rFtd8o9lijcjC3,SpATywNh6bZuzm8s1ceuBUnMUAeoAHHw,7,5,2,0,2,0,5,0,14,2.0,2,0.0,0,2,0,2,5,0,0,5,0,4,10,1
3246,68576,eC5OrlIfDx9Fw0Jh12C4RyvK1vDrMSLj,SpATywNh6bZuzm8s1ceuBUnMUAeoAHHw,11,12,1,0,0,2,9,1,25,3.5714285714285716,2,0.0,0,1,0,0,12,2,0,9,1,1,24,1
3247,68579,forPgRyluFqH5fyMZfnKJctNYjPII95b,SpATywNh6bZuzm8s1ceuBUnMUAeoAHHw,1,0,0,0,0,0,1,0,1,0.14285714285714285,1,0.0,0,0,0,0,0,0,0,1,0,0,1,1
3248,68583,forPgRyluFqH5fyMZfnKJctNYjPII95b,RXDvfPUBYFlVdlueBFbLW0mhhAyGEqpt,15,17,2,0,1,23,18,6,67,9.571428571428571,2,0.0,0,2,0,1,17,23,0,18,6,3,64,1
3249,68588,yIoYmR4ll93f7EHu29moXjbx4kT37xAM,bWdj2GDclj5ofokWjzoa5jAwMkxCykd6,18,27,4,70,7,7,16,2,133,19.0,2,0.0,10,4,64,7,17,7,6,16,2,85,48,1
3250,68591,b8js5e6thEnzYItgffCHQwfAl1iYfizN,SpATywNh6bZuzm8s1ceuBUnMUAeoAHHw,9,9,6,0,4,1,12,2,34,4.857142857142857,1,0.0,0,6,0,4,9,1,0,12,2,10,24,1
3251,68605,SZOXOmDilP1KR3OJXHpIlLf61tEoqX1S,G8EPVSXsOYB5YQWZGiz1aVq5Pgr2GrQu,4,2,1,0,1,0,1,0,5,0.7142857142857143,1,0.0,0,1,0,1,2,0,0,1,0,2,3,1
3252,68625,4QX0UVH2mWoWEvrk1Om8ECy2pBWoKhcm,SpATywNh6bZuzm8s1ceuBUnMUAeoAHHw,6,5,1,0,1,0,1,0,8,1.1428571428571428,1,0.0,1,1,0,1,4,0,0,1,0,3,5,1
3253,68629,M2AmcvqhvMtUlyRV6vMvvoM2IhrMmAwT,bWdj2GDclj5ofokWjzoa5jAwMkxCykd6,9,10,5,0,2,0,5,0,22,3.142857142857143,4,0.0,0,5,0,2,10,0,0,5,0,7,15,1
3254,68637,M4sV24yJlA7UYO36nFDbwFj49msCFYqO,SpATywNh6bZuzm8s1ceuBUnMUAeoAHHw,1,0,0,0,0,0,1,0,1,0.14285714285714285,1,0.0,0,0,0,0,0,0,0,1,0,0,1,1
3255,68650,3blAUsZiu4FW1Jp6vOBSuHfrNCEPv1lZ,RXDvfPUBYFlVdlueBFbLW0mhhAyGEqpt,11,10,3,0,2,0,6,0,21,3.0,2,0.0,0,3,0,2,10,0,0,6,0,5,16,0
3256,68657,kouVFmC9KYKK6YQi2WuQuIKCuxGX5ljt,RXDvfPUBYFlVdlueBFbLW0mhhAyGEqpt,39,39,5,79,4,3,9,1,140,20.0,6,0.0,10,5,75,4,29,3,4,9,1,94,46,0
3257,68662,JZ0cPuTVmC70maYF6NIorZr3bOTKKvsS,SpATywNh6bZuzm8s1ceuBUnMUAeoAHHw,1,0,0,0,0,0,1,0,1,0.14285714285714285,1,0.0,0,0,0,0,0,0,0,1,0,0,1,1
3258,68664,DfCrd6VP4inLGSvbDnl7Xl7qOqvm6UpO,SpATywNh6bZuzm8s1ceuBUnMUAeoAHHw,4,2,1,0,1,0,1,0,5,0.7142857142857143,1,0.0,0,1,0,1,2,0,0,1,0,2,3,1
3259,68665,9LD2dY2JJUiq4N2gerCXLTVCO162xgQP,G8EPVSXsOYB5YQWZGiz1aVq5Pgr2GrQu,7,3,0,0,0,1,5,1,10,1.4285714285714286,1,0.0,0,0,0,0,3,1,0,5,1,0,10,1
3260,68667,13fzVwLJSsgGzTLwjEHCuvf0Ks8dgxYZ,RXDvfPUBYFlVdlueBFbLW0mhhAyGEqpt,1,0,0,0,0,0,1,0,1,0.14285714285714285,1,0.0,0,0,0,0,0,0,0,1,0,0,1,1
3261,68676,OvG0QIZOPiV3oa4UqFgxzNEprO7pKVmV,SpATywNh6bZuzm8s1ceuBUnMUAeoAHHw,30,31,14,16,7,7,19,1,95,13.571428571428571,6,0.0,4,14,16,7,27,7,0,19,1,41,54,0
3262,68687,lPU0lJqSA3OSdb8bK1yzncqCybAP9bUO,SpATywNh6bZuzm8s1ceuBUnMUAeoAHHw,16,59,31,18,7,29,18,0,162,23.142857142857142,2,0.0,9,31,16,7,50,29,2,18,0,63,99,1
3263,68688,s4immbICvRMkMxvZyJBqO325qtK1yhVk,G8EPVSXsOYB5YQWZGiz1aVq5Pgr2GrQu,3,3,0,0,0,0,1,0,4,0.5714285714285714,1,0.0,1,0,0,0,2,0,0,1,0,1,3,1
3264,68699,lyCFhIpUX9eBaODrOlziE1wpuE5i2FcV,bWdj2GDclj5ofokWjzoa5jAwMkxCykd6,2,0,0,0,0,0,2,0,2,0.2857142857142857,1,0.0,0,0,0,0,0,0,0,2,0,0,2,1
3265,68703,Th6GGIKucyCokdQsUn3aOeloTzqx0Qbo,SpATywNh6bZuzm8s1ceuBUnMUAeoAHHw,1,0,0,0,0,0,1,0,1,0.14285714285714285,1,0.0,0,0,0,0,0,0,0,1,0,0,1,1
3266,68704,5MOHfgPntZIsRWkQebauzpUgUSaHvhFJ,SpATywNh6bZuzm8s1ceuBUnMUAeoAHHw,15,45,25,9,2,9,13,0,103,14.714285714285714,7,0.0,6,25,7,2,39,9,2,13,0,40,63,0
3267,68705,yZYTsrvrgsLaQebVaD5W80s8tJxpcy3t,SpATywNh6bZuzm8s1ceuBUnMUAeoAHHw,7,8,4,0,3,0,3,0,18,2.5714285714285716,1,0.0,0,4,0,3,8,0,0,3,0,7,11,1
3268,68711,fFCTtQQCOOjijvFKvRDQiA777EKDq9kt,RXDvfPUBYFlVdlueBFbLW0mhhAyGEqpt,33,29,19,52,0,0,9,7,116,16.571428571428573,4,0.0,7,19,49,0,22,0,3,9,7,75,41,1
3269,68717,XB4WTxkP3vNmHXjALkkfZII5POid4TAu,SpATywNh6bZuzm8s1ceuBUnMUAeoAHHw,3,2,0,0,0,0,1,0,3,0.42857142857142855,1,0.0,0,0,0,0,2,0,0,1,0,0,3,1
3270,68720,XJxfWg6ep0iC8D7yOZX3PZy18MtrFPsI,SpATywNh6bZuzm8s1ceuBUnMUAeoAHHw,9,13,10,0,5,0,2,0,30,4.285714285714286,2,0.0,0,10,0,5,13,0,0,2,0,15,15,1
3271,68731,KgATxoqrB3vgLjFK8Jvt9HJ7S86x88Nt,SpATywNh6bZuzm8s1ceuBUnMUAeoAHHw,1,0,0,0,0,0,1,0,1,0.14285714285714285,1,0.0,0,0,0,0,0,0,0,1,0,0,1,1
3272,68732,pyElpGpHSNzEpZ3jrGlcGeNI8YUApbgQ,bWdj2GDclj5ofokWjzoa5jAwMkxCykd6,19,45,19,38,8,20,7,4,141,20.142857142857142,3,0.0,6,19,35,8,39,20,3,7,4,68,73,1
3273,68739,kNijCkWRNCwIOtL9mKx9mB8Vau6ujWr3,SpATywNh6bZuzm8s1ceuBUnMUAeoAHHw,31,50,16,29,8,20,8,3,134,19.142857142857142,3,0.0,29,16,28,8,21,20,1,8,3,81,53,1
3274,68750,gf8nHDqKPX2j100RHCT9dT19AZw0vESt,bWdj2GDclj5ofokWjzoa5jAwMkxCykd6,4,2,1,0,1,0,1,0,5,0.7142857142857143,1,0.0,0,1,0,1,2,0,0,1,0,2,3,1
3275,68771,2DRl1D33z6i9gsgW5IB0KBdkJJ1Zsu7a,RXDvfPUBYFlVdlueBFbLW0mhhAyGEqpt,1,0,0,0,0,0,1,0,1,0.14285714285714285,1,0.0,0,0,0,0,0,0,0,1,0,0,1,1
3276,68776,n5lHa6MzF6UuuHLbdbmhitfwFFej0cUG,bWdj2GDclj5ofokWjzoa5jAwMkxCykd6,1,0,0,0,0,0,1,0,1,0.14285714285714285,1,0.0,0,0,0,0,0,0,0,1,0,0,1,1
3277,68785,g2zZYnTJ1Pk3cSjsVP5SH4UjJdsbDJv7,SpATywNh6bZuzm8s1ceuBUnMUAeoAHHw,14,19,7,16,4,23,4,0,73,10.428571428571429,2,0.0,9,7,14,4,10,23,2,4,0,34,39,1
3278,68794,xqGP5lHPgGUPDIL6gt03S8kze9HpOEIL,SpATywNh6bZuzm8s1ceuBUnMUAeoAHHw,4,2,1,0,1,0,1,0,5,0.7142857142857143,1,0.0,0,1,0,1,2,0,0,1,0,2,3,1
3279,68799,8uISS2OyAivNghskvH7qzmmtfHvBWiyo,SpATywNh6bZuzm8s1ceuBUnMUAeoAHHw,8,13,5,0,3,1,7,1,30,4.285714285714286,2,0.0,5,5,0,3,8,1,0,7,1,13,17,1
3280,68803,8DvAxou540FD0LKoQccPN3Xyo1nrtg8U,bWdj2GDclj5ofokWjzoa5jAwMkxCykd6,6,3,0,0,1,0,2,0,6,0.8571428571428571,2,0.0,0,0,0,1,3,0,0,2,0,1,5,1
3281,68804,3o4QanEzrLxU7IR8E0SkDLt6uwLmz5BV,G8EPVSXsOYB5YQWZGiz1aVq5Pgr2GrQu,57,85,31,88,11,0,13,0,228,32.57142857142857,5,0.0,32,31,58,11,53,0,30,13,0,132,96,1
3282,68806,J4cKirSbcBOsAeFSIp9ObJYWVvlxjPLO,SpATywNh6bZuzm8s1ceuBUnMUAeoAHHw,8,17,4,0,4,0,7,0,32,4.571428571428571,2,0.0,0,4,0,4,17,0,0,7,0,8,24,1
3283,68811,JXT9wmO8lGZMBaQQK0U8pHKQIW1oOnDo,RXDvfPUBYFlVdlueBFbLW0mhhAyGEqpt,14,12,12,0,6,0,6,0,36,5.142857142857143,2,0.0,0,12,0,6,12,0,0,6,0,18,18,1
3284,68815,jEfIANn9M5UCRbhWqJtJFlsF2uyG4fk6,A3fsA9Zfv1X2fVEQhTw51lKENdNrEqT3,4,5,1,0,0,0,3,0,9,1.2857142857142858,1,0.0,0,1,0,0,5,0,0,3,0,1,8,1
3285,68822,T3xcwszBjaOdB7YgVcZfsRhjJ9lfkEVZ,SpATywNh6bZuzm8s1ceuBUnMUAeoAHHw,1,0,0,0,0,0,1,0,1,0.14285714285714285,1,0.0,0,0,0,0,0,0,0,1,0,0,1,1
3286,68833,tn5nSlJLNdxx4Uni5Dn3S8nwDR8GJibq,SpATywNh6bZuzm8s1ceuBUnMUAeoAHHw,30,32,19,29,10,6,8,1,105,15.0,2,0.0,8,19,26,10,24,6,3,8,1,63,42,0
3287,68839,ci6w9FxXwoWvsu2Aw9ojvjfPhjaGgaxN,SpATywNh6bZuzm8s1ceuBUnMUAeoAHHw,16,36,17,21,1,21,19,0,115,16.428571428571427,6,0.0,7,17,17,1,29,21,4,19,0,42,73,1
3288,68849,l21tCwOolR7RD0CZyqRiNHHeEZC1D67K,bWdj2GDclj5ofokWjzoa5jAwMkxCykd6,5,6,3,0,2,0,2,0,13,1.8571428571428572,2,0.0,1,3,0,2,5,0,0,2,0,6,7,1
3289,68852,IC3lGAGjjevFNisK97Sg5rNNaiFl6GUf,SpATywNh6bZuzm8s1ceuBUnMUAeoAHHw,8,9,1,0,0,0,7,2,19,2.7142857142857144,1,0.0,0,1,0,0,9,0,0,7,2,1,18,1
3290,68855,QfnbskMOJDzclneyUxl9CDLAwpjYY8bi,SpATywNh6bZuzm8s1ceuBUnMUAeoAHHw,5,3,1,0,1,0,1,0,6,0.8571428571428571,1,0.0,0,1,0,1,3,0,0,1,0,2,4,1
3291,68858,nrnVeosxoYxlthTbtXiJng8EyjNCisBw,SpATywNh6bZuzm8s1ceuBUnMUAeoAHHw,22,28,2,35,1,1,16,5,88,12.571428571428571,3,0.0,8,2,27,1,20,1,8,16,5,38,50,1
3292,68867,mJAgtJKHxy28GsPIeuAEUCIOXmHzCywF,A3fsA9Zfv1X2fVEQhTw51lKENdNrEqT3,52,72,51,78,31,16,22,0,270,38.57142857142857,6,0.0,3,51,65,31,69,16,13,22,0,150,120,0
3293,68876,5IM8g7YMOYo5qH7Yu3x31T3JkVOH9iqe,SpATywNh6bZuzm8s1ceuBUnMUAeoAHHw,13,13,6,0,5,0,2,0,26,3.7142857142857144,2,0.0,0,6,0,5,13,0,0,2,0,11,15,0
3294,68889,jagu0OJDhWTGFhfCMk0ghqluLpW3kzdC,A3fsA9Zfv1X2fVEQhTw51lKENdNrEqT3,20,14,11,0,9,0,12,0,46,6.571428571428571,5,0.0,0,11,0,9,14,0,0,12,0,20,26,1
3295,68891,AyMpxTtI93rQBcmn1hZDJ5NB66ddrTt8,bWdj2GDclj5ofokWjzoa5jAwMkxCykd6,15,16,7,62,5,20,3,0,113,16.142857142857142,1,0.0,7,7,59,5,9,20,3,3,0,78,35,1
3296,68894,SG7N8DhpCuhIu06IIzLX0CSolbyIDsIx,SpATywNh6bZuzm8s1ceuBUnMUAeoAHHw,31,59,27,27,9,4,16,0,142,20.285714285714285,9,0.0,17,27,26,9,42,4,1,16,0,79,63,1
3297,68925,ObpezNQRvm77jf0ubZxdLKEQMiNil6VQ,bWdj2GDclj5ofokWjzoa5jAwMkxCykd6,7,9,2,0,1,0,10,0,22,3.142857142857143,1,0.0,0,2,0,1,9,0,0,10,0,3,19,1
3298,68941,g5OpPhveV3tEyIL9sXOQK1bIZWgyqgNP,SpATywNh6bZuzm8s1ceuBUnMUAeoAHHw,1,0,0,0,0,0,1,0,1,0.14285714285714285,1,0.0,0,0,0,0,0,0,0,1,0,0,1,1
3299,68966,GiA8pWWKZYTUi7chN7ntBN35fCWU2nBu,SpATywNh6bZuzm8s1ceuBUnMUAeoAHHw,8,1,1,0,1,0,6,1,10,1.4285714285714286,1,0.0,0,1,0,1,1,0,0,6,1,2,8,1
3300,68969,koujvnfMBhMkCgSrbEaysh2AE5Gpg2YT,G8EPVSXsOYB5YQWZGiz1aVq5Pgr2GrQu,15,7,5,0,5,0,7,0,24,3.4285714285714284,1,0.0,0,5,0,5,7,0,0,7,0,10,14,0
3301,68970,TxEB3EFyNbwMBYmqmAZljhKEWyORCpLb,SpATywNh6bZuzm8s1ceuBUnMUAeoAHHw,1,0,0,0,0,0,1,0,1,0.14285714285714285,1,0.0,0,0,0,0,0,0,0,1,0,0,1,1
3302,68979,ugU2OsTm2YN2IbGmjW7DHhMX6BMMKbiK,G8EPVSXsOYB5YQWZGiz1aVq5Pgr2GrQu,8,7,4,6,0,0,2,0,19,2.7142857142857144,1,0.0,2,4,4,0,5,0,2,2,0,10,9,1
3303,68986,c7CZsOAhREk5r7i8Wn5QXe6C7ebs3xYP,A3fsA9Zfv1X2fVEQhTw51lKENdNrEqT3,8,7,4,0,2,2,7,0,22,3.142857142857143,3,0.0,0,4,0,2,7,2,0,7,0,6,16,1
3304,68994,Xl37kHv8hz1ETmkFgpIsXpoKOIdQzB5H,SpATywNh6bZuzm8s1ceuBUnMUAeoAHHw,5,2,1,0,1,0,2,0,6,0.8571428571428571,1,0.0,0,1,0,1,2,0,0,2,0,2,4,1
3305,68996,xC7QA3lJWLoIMEwPvqIxcLnCt0KwsxwT,SpATywNh6bZuzm8s1ceuBUnMUAeoAHHw,2,0,0,0,0,0,2,0,2,0.2857142857142857,1,0.0,0,0,0,0,0,0,0,2,0,0,2,1
3306,68998,sNC7XF6Nlmfza5mofBS4sZLhOb44U4Ts,G8EPVSXsOYB5YQWZGiz1aVq5Pgr2GrQu,1,0,0,0,0,0,1,0,1,0.14285714285714285,1,0.0,0,0,0,0,0,0,0,1,0,0,1,1
3307,69007,wYGhiFjdBLkU2x7JJ3K1n2UAh76fIcQi,SpATywNh6bZuzm8s1ceuBUnMUAeoAHHw,10,11,9,0,7,1,2,0,30,4.285714285714286,2,0.0,0,9,0,7,11,1,0,2,0,16,14,1
3308,69014,souC6CA0wrFXemJ5RC2IcVOFZKY3Ud6D,A3fsA9Zfv1X2fVEQhTw51lKENdNrEqT3,66,83,22,128,11,11,27,1,283,40.42857142857143,4,0.0,4,22,116,11,79,11,12,27,1,153,130,0
3309,69031,8lWVuB48GCoDnvIn7Nn1tDxRI6ibKTRq,SpATywNh6bZuzm8s1ceuBUnMUAeoAHHw,5,2,1,0,1,0,2,0,6,0.8571428571428571,1,0.0,0,1,0,1,2,0,0,2,0,2,4,1
3310,69043,YVCPApRVJS0XKKCEpBt52bsseKQk9Woy,SpATywNh6bZuzm8s1ceuBUnMUAeoAHHw,1,0,0,0,0,0,1,0,1,0.14285714285714285,1,0.0,0,0,0,0,0,0,0,1,0,0,1,1
3311,69054,CJYdZ6F1UmkUhSW1DIBQ5YjVYvVCeBEf,A3fsA9Zfv1X2fVEQhTw51lKENdNrEqT3,6,3,1,0,1,0,2,0,7,1.0,1,0.0,0,1,0,1,3,0,0,2,0,2,5,1
3312,69065,57ya2ykgKZwUUOXe4VfUt0HWtgZeemvj,SpATywNh6bZuzm8s1ceuBUnMUAeoAHHw,1,0,0,0,0,0,1,0,1,0.14285714285714285,1,0.0,0,0,0,0,0,0,0,1,0,0,1,1
3313,69080,WgYQBUzSJJLcj6PwA0d8MdNri6k7nN4s,A3fsA9Zfv1X2fVEQhTw51lKENdNrEqT3,2,0,0,0,0,0,2,0,2,0.2857142857142857,1,0.0,0,0,0,0,0,0,0,2,0,0,2,1
3314,69082,lt7x7W9L5dc1lSFEc965LhUn5shsg0v8,SpATywNh6bZuzm8s1ceuBUnMUAeoAHHw,4,3,0,0,0,0,2,0,5,0.7142857142857143,1,0.0,0,0,0,0,3,0,0,2,0,0,5,1
3315,69095,dK22lzU3sHpxa7kQiSzhTpdq8w2wdIKM,G8EPVSXsOYB5YQWZGiz1aVq5Pgr2GrQu,5,3,0,0,0,0,6,1,10,1.4285714285714286,2,0.0,1,0,0,0,2,0,0,6,1,1,9,0
3316,69103,ZwACmcXP1dFceMUleNJ3flkTstESRohK,SpATywNh6bZuzm8s1ceuBUnMUAeoAHHw,29,35,16,39,6,0,9,0,105,15.0,2,0.0,14,16,36,6,21,0,3,9,0,72,33,1
3317,69115,Vd6ebRuiLfwgqB5waj4eS9hJ1uyBDxCf,A3fsA9Zfv1X2fVEQhTw51lKENdNrEqT3,15,20,2,0,1,0,17,1,41,5.857142857142857,3,0.0,0,2,0,1,20,0,0,17,1,3,38,1
3318,69116,8RAttpsmVeGyWHWVdhomVf58WbsxdKtJ,SpATywNh6bZuzm8s1ceuBUnMUAeoAHHw,9,7,6,0,6,0,2,0,21,3.0,4,0.0,0,6,0,6,7,0,0,2,0,12,9,1
3319,69131,8Ir6rIjO15kuvM3s5xrQH1rB1m97Mcy9,SpATywNh6bZuzm8s1ceuBUnMUAeoAHHw,15,35,1,20,1,18,14,2,91,13.0,4,0.0,14,1,18,1,21,18,2,14,2,34,57,0
3320,69147,cRQPwEYCK3Iw8dKAOD2ODiUgaKZ6yPed,SpATywNh6bZuzm8s1ceuBUnMUAeoAHHw,23,49,1,18,0,3,16,1,88,12.571428571428571,4,0.0,15,1,16,0,34,3,2,16,1,32,56,1
3321,69154,oBZQGNxV159KYVTxhJiCHURpoG2050SJ,SpATywNh6bZuzm8s1ceuBUnMUAeoAHHw,2,0,0,0,0,0,2,0,2,0.2857142857142857,1,0.0,0,0,0,0,0,0,0,2,0,0,2,1
3322,69155,K0iCXE1mno7izlBrkQAs4SEkYDRU9qXa,SpATywNh6bZuzm8s1ceuBUnMUAeoAHHw,5,3,1,0,1,0,2,0,7,1.0,1,0.0,2,1,0,1,1,0,0,2,0,4,3,1
3323,69161,3X0JLX6UvJnnRb5GkwbFJgAokE5g69D0,SpATywNh6bZuzm8s1ceuBUnMUAeoAHHw,26,57,17,14,7,1,12,0,108,15.428571428571429,8,0.0,15,17,14,7,42,1,0,12,0,53,55,0
3324,69165,4DUZBFD9Fwl71r8i0SB6pVZCzmNoxKnn,A3fsA9Zfv1X2fVEQhTw51lKENdNrEqT3,8,11,6,0,1,1,3,0,22,3.142857142857143,2,0.0,0,6,0,1,11,1,0,3,0,7,15,1
3325,69192,agX8fi6SsMsbGjpTUuXM1FgToYG9zbAn,SpATywNh6bZuzm8s1ceuBUnMUAeoAHHw,11,20,12,0,7,4,6,0,49,7.0,6,0.0,0,12,0,7,20,4,0,6,0,19,30,0
3326,69200,udnRYxurswpE4GUZcnc80kafg0hn3fpz,A3fsA9Zfv1X2fVEQhTw51lKENdNrEqT3,4,7,3,0,0,0,3,0,13,1.8571428571428572,2,0.0,0,3,0,0,7,0,0,3,0,3,10,0
3327,69231,yRvmuoOlApBAgoa9MY5Qvy0RDYuNtlAF,G8EPVSXsOYB5YQWZGiz1aVq5Pgr2GrQu,7,5,0,0,0,0,5,0,10,1.4285714285714286,1,0.0,0,0,0,0,5,0,0,5,0,0,10,1
3328,69237,xG3AmboF4HBUiYwQZV4JGVdvJNCIXdwN,SpATywNh6bZuzm8s1ceuBUnMUAeoAHHw,10,26,13,1,7,0,4,0,51,7.285714285714286,2,0.0,9,13,1,7,17,0,0,4,0,30,21,1
3329,69240,IXJE6OTajH0Geh8I1ZW7ljkRPJ4pkmfl,SpATywNh6bZuzm8s1ceuBUnMUAeoAHHw,10,9,6,4,0,0,1,0,20,2.857142857142857,1,0.0,1,6,3,0,8,0,1,1,0,10,10,1
3330,69259,7bRPtq6P8Xywkbl391z1cfKif2lsM9WW,SpATywNh6bZuzm8s1ceuBUnMUAeoAHHw,29,26,16,40,7,0,4,0,93,13.285714285714286,2,0.0,7,16,36,7,19,0,4,4,0,66,27,1
3331,69268,Eq98WSTQOt9fRmYbHT449FU0RWdVZ5zB,SpATywNh6bZuzm8s1ceuBUnMUAeoAHHw,5,2,1,0,1,0,2,0,6,0.8571428571428571,1,0.0,0,1,0,1,2,0,0,2,0,2,4,1
3332,69276,FSJWTYbpEABu1Che9CXJ2jTRzNOHiIPA,SpATywNh6bZuzm8s1ceuBUnMUAeoAHHw,9,6,2,0,2,0,7,0,17,2.4285714285714284,1,0.0,0,2,0,2,6,0,0,7,0,4,13,1
3333,69284,UhXyunBodgS5DssUOIaVTTsNfgvZZxEV,bWdj2GDclj5ofokWjzoa5jAwMkxCykd6,4,3,1,0,0,0,2,0,6,0.8571428571428571,1,0.0,0,1,0,0,3,0,0,2,0,1,5,1
3334,69285,3bqMPd7dmQ6bVwYt9AjfxpDPMW8ppczj,RXDvfPUBYFlVdlueBFbLW0mhhAyGEqpt,1,0,0,0,0,0,1,0,1,0.14285714285714285,1,0.0,0,0,0,0,0,0,0,1,0,0,1,1
3335,69293,ovvuiEhj0QBv4xi11GVjXr8JhlCgaPmd,A3fsA9Zfv1X2fVEQhTw51lKENdNrEqT3,9,3,3,0,3,0,5,0,14,2.0,2,0.0,0,3,0,3,3,0,0,5,0,6,8,1
3336,69297,X9IKf8GgqS6dvoKX3VBo51mIr8yb4uFC,bWdj2GDclj5ofokWjzoa5jAwMkxCykd6,25,55,18,13,14,4,10,0,114,16.285714285714285,3,0.0,15,18,12,14,40,4,1,10,0,59,55,1
3337,69308,YtPY6V9gKVYBGYaBakDnRKgXM0SCPhH8,RXDvfPUBYFlVdlueBFbLW0mhhAyGEqpt,69,74,45,95,27,2,18,0,261,37.285714285714285,8,0.0,21,45,91,27,53,2,4,18,0,184,77,0
3338,69322,WfiWheCcfnYrlo1ljQjtyFUB6mwR6CMB,SpATywNh6bZuzm8s1ceuBUnMUAeoAHHw,13,12,8,0,4,0,12,1,37,5.285714285714286,2,0.0,0,8,0,4,12,0,0,12,1,12,25,1
3339,69324,byxGWUJV72XqYw0RcV5v8EuZ9oh6gief,G8EPVSXsOYB5YQWZGiz1aVq5Pgr2GrQu,14,12,7,0,4,0,9,0,32,4.571428571428571,2,0.0,0,7,0,4,12,0,0,9,0,11,21,1
3340,69337,wMBHEwMS1ke1XCIE6pdAhfvU7lKPIoig,A3fsA9Zfv1X2fVEQhTw51lKENdNrEqT3,6,5,4,0,0,0,2,0,11,1.5714285714285714,1,0.0,0,4,0,0,5,0,0,2,0,4,7,1
3341,69345,pNeNjRs1mK0wHcAzJFxLXdAPA9xgPVV6,bWdj2GDclj5ofokWjzoa5jAwMkxCykd6,5,2,1,0,1,0,2,0,6,0.8571428571428571,1,0.0,0,1,0,1,2,0,0,2,0,2,4,1
3342,69360,VtYfYYb8PipDmwJ9fAnXpdTb4dF89SFx,SpATywNh6bZuzm8s1ceuBUnMUAeoAHHw,11,5,4,0,4,0,2,0,15,2.142857142857143,1,0.0,0,4,0,4,5,0,0,2,0,8,7,1
3343,69367,UeHaetwViLI5gC5HiwzWUg3JwpoZmRrG,A3fsA9Zfv1X2fVEQhTw51lKENdNrEqT3,1,0,0,0,0,0,1,0,1,0.14285714285714285,1,0.0,0,0,0,0,0,0,0,1,0,0,1,1
3344,69371,YaUoJwJr3oO9HJ6WDm7V4UT5kFsGziL7,bWdj2GDclj5ofokWjzoa5jAwMkxCykd6,1,0,0,0,0,0,1,0,1,0.14285714285714285,1,0.0,0,0,0,0,0,0,0,1,0,0,1,1
3345,69382,7jncvDKBN22Fxg064o0NyimMY6U2A5Li,SpATywNh6bZuzm8s1ceuBUnMUAeoAHHw,5,2,1,0,1,0,2,0,6,0.8571428571428571,1,0.0,0,1,0,1,2,0,0,2,0,2,4,1
3346,69387,hPdb7IzvQK13aLXEDwxSH4zOMfPRUsSC,SpATywNh6bZuzm8s1ceuBUnMUAeoAHHw,1,0,0,0,0,0,1,0,1,0.14285714285714285,1,0.0,0,0,0,0,0,0,0,1,0,0,1,1
3347,69391,d5euO6JYPz1tRdmilapWDL1Th3AQudPQ,SpATywNh6bZuzm8s1ceuBUnMUAeoAHHw,6,3,1,0,1,0,2,0,7,1.0,1,0.0,0,1,0,1,3,0,0,2,0,2,5,1
3348,69393,sQMQGXUKDLttJ8ntfMuRvWEcncBHKCzb,G8EPVSXsOYB5YQWZGiz1aVq5Pgr2GrQu,5,4,0,0,0,0,2,0,6,0.8571428571428571,1,0.0,0,0,0,0,4,0,0,2,0,0,6,1
3349,69394,9fEcx2YdFV830apuhCo8G8R1veKyhCNk,G8EPVSXsOYB5YQWZGiz1aVq5Pgr2GrQu,1,0,0,0,0,0,1,0,1,0.14285714285714285,1,0.0,0,0,0,0,0,0,0,1,0,0,1,1
3350,69396,x87E9Qmbnh2qCEUiaevhSD7rp8sUrupo,SpATywNh6bZuzm8s1ceuBUnMUAeoAHHw,6,4,3,0,2,0,3,0,12,1.7142857142857142,2,0.0,0,3,0,2,4,0,0,3,0,5,7,1
3351,69397,egpXv13dykaiU64GCgTaQGg1ErRD7Rsb,SpATywNh6bZuzm8s1ceuBUnMUAeoAHHw,24,19,16,8,10,15,7,1,76,10.857142857142858,4,0.0,0,16,7,10,19,15,1,7,1,33,43,0
3352,69400,FlAkKX6ow9SvOzk0dTWPWgnX5766zY29,SpATywNh6bZuzm8s1ceuBUnMUAeoAHHw,22,27,10,12,7,1,3,0,60,8.571428571428571,2,0.0,6,10,12,7,21,1,0,3,0,35,25,1
3353,69420,aI2WbSCktVyijPTHCbgAdpzpfdnFGcq9,bWdj2GDclj5ofokWjzoa5jAwMkxCykd6,1,0,0,0,0,0,1,0,1,0.14285714285714285,1,0.0,0,0,0,0,0,0,0,1,0,0,1,1
3354,69421,wj8cbMyESeAf93mp00EllV31jkPIrA6z,SpATywNh6bZuzm8s1ceuBUnMUAeoAHHw,7,4,2,0,0,0,7,3,16,2.2857142857142856,1,0.0,0,2,0,0,4,0,0,7,3,2,14,1
3355,69436,vEfGT3eaoianaMgM5zzcNn9WTzHGX3lJ,bWdj2GDclj5ofokWjzoa5jAwMkxCykd6,12,5,4,0,4,0,3,0,16,2.2857142857142856,1,0.0,0,4,0,4,5,0,0,3,0,8,8,1
3356,69445,raxo74HBCa6UxUGfmq3EGBBeCoVCmLfg,SpATywNh6bZuzm8s1ceuBUnMUAeoAHHw,20,41,4,38,1,9,16,1,110,15.714285714285714,3,0.0,17,4,33,1,24,9,5,16,1,55,55,1
3357,69462,SzqR1lIvSkqy1yQXOqGRgT5uhu7VR5Jw,SpATywNh6bZuzm8s1ceuBUnMUAeoAHHw,32,56,36,24,18,12,18,2,166,23.714285714285715,6,0.0,5,36,23,18,51,12,1,18,2,82,84,0
3358,69484,RbewLSSgBXbMSLEvzESHw0b6pdUZ0dT1,SpATywNh6bZuzm8s1ceuBUnMUAeoAHHw,15,17,7,0,5,0,2,0,31,4.428571428571429,1,0.0,0,7,0,5,17,0,0,2,0,12,19,1
3359,69488,0n2rFsphNy9JVeuypULNewx4jCGSFGND,bWdj2GDclj5ofokWjzoa5jAwMkxCykd6,5,2,1,0,1,0,2,0,6,0.8571428571428571,1,0.0,0,1,0,1,2,0,0,2,0,2,4,1
3360,69489,pAlH2DhoFB2i4Ut8T7hcWTIp67bJvsYn,SpATywNh6bZuzm8s1ceuBUnMUAeoAHHw,5,2,1,0,1,0,3,0,7,1.0,2,0.0,0,1,0,1,2,0,0,3,0,2,5,1
3361,69512,3MwBdkgOXpVBf89tXLybMhGjxxsiq8lW,SpATywNh6bZuzm8s1ceuBUnMUAeoAHHw,5,7,3,0,2,0,2,0,14,2.0,1,0.0,0,3,0,2,7,0,0,2,0,5,9,1
3362,69522,ujYI83byKXzx4VeC0hyxjCKBGRrqMCEx,SpATywNh6bZuzm8s1ceuBUnMUAeoAHHw,6,7,3,0,1,0,2,0,13,1.8571428571428572,2,0.0,0,3,0,1,7,0,0,2,0,4,9,1
3363,69525,wRAgiRhqkN35cIVBbnaU2eOM8fyImml7,SpATywNh6bZuzm8s1ceuBUnMUAeoAHHw,5,2,1,0,1,0,2,0,6,0.8571428571428571,1,0.0,0,1,0,1,2,0,0,2,0,2,4,1
3364,69528,ujAdSwtAMW0jWhrnzge1oByew4uYe5CY,SpATywNh6bZuzm8s1ceuBUnMUAeoAHHw,5,2,1,0,1,0,2,0,6,0.8571428571428571,1,0.0,0,1,0,1,2,0,0,2,0,2,4,1
3365,69550,rY4HuopoXNauFhpb4SYxSCmQkbvhS34C,SpATywNh6bZuzm8s1ceuBUnMUAeoAHHw,17,32,12,18,6,8,7,1,84,12.0,3,0.0,18,12,15,6,14,8,3,7,1,51,33,0
3366,69552,ZAi0jAKRdwQEtga2Yygb9adNtNc26TKH,A3fsA9Zfv1X2fVEQhTw51lKENdNrEqT3,1,0,0,0,0,0,1,0,1,0.14285714285714285,1,0.0,0,0,0,0,0,0,0,1,0,0,1,1
3367,69575,HnVGC3qJM46V1b2wdd4Z0HoEFuWu57RL,A3fsA9Zfv1X2fVEQhTw51lKENdNrEqT3,7,7,1,0,0,0,4,0,12,1.7142857142857142,3,0.0,0,1,0,0,7,0,0,4,0,1,11,1
3368,69598,KYXtOFYh9POr4cq75pjZ8a127l5uxf5U,SpATywNh6bZuzm8s1ceuBUnMUAeoAHHw,23,42,22,20,14,0,5,0,103,14.714285714285714,4,0.0,10,22,17,14,32,0,3,5,0,63,40,1
3369,69600,ebvWYER6Bde0EUcNXXIX0vyTB9ur6Kqi,A3fsA9Zfv1X2fVEQhTw51lKENdNrEqT3,6,7,0,0,0,0,2,0,9,1.2857142857142858,2,0.0,0,0,0,0,7,0,0,2,0,0,9,1
3370,69612,kgME9COu6f9ljQ8FhJeUQLVyeGDbkeLG,A3fsA9Zfv1X2fVEQhTw51lKENdNrEqT3,6,14,2,0,0,0,12,1,29,4.142857142857143,5,0.0,0,2,0,0,14,0,0,12,1,2,27,0
3371,69634,jnvcTpUtga8frGP2ONxrK4VjvbZCmOcF,A3fsA9Zfv1X2fVEQhTw51lKENdNrEqT3,7,10,0,0,0,0,4,0,14,2.0,2,0.0,3,0,0,0,7,0,0,4,0,3,11,1
3372,69636,xZLWfpPSNmIdAksyQxOWlrAmgCyQKxwi,A3fsA9Zfv1X2fVEQhTw51lKENdNrEqT3,3,2,0,0,0,0,2,0,4,0.5714285714285714,1,0.0,0,0,0,0,2,0,0,2,0,0,4,1
3373,69640,C78Rc70fLP1AFI7RwOL8R7Vch3jy9civ,bWdj2GDclj5ofokWjzoa5jAwMkxCykd6,7,8,1,4,4,0,2,0,19,2.7142857142857144,1,0.0,6,1,4,4,2,0,0,2,0,15,4,1
3374,69642,V5AS4ngknDMHs5ddf49SxlAoYguZsiN3,A3fsA9Zfv1X2fVEQhTw51lKENdNrEqT3,56,25,15,98,7,2,12,1,160,22.857142857142858,3,0.0,2,15,89,7,23,2,9,12,1,113,47,0
3375,69678,zprnKj46wnzt21jHYpriZ9OaUlDuPgz5,SpATywNh6bZuzm8s1ceuBUnMUAeoAHHw,8,6,4,0,3,3,4,0,20,2.857142857142857,1,0.0,0,4,0,3,6,3,0,4,0,7,13,1
3376,69691,C8X9Lf56reSC06tYvkcDbAXogOIv2aQH,SpATywNh6bZuzm8s1ceuBUnMUAeoAHHw,6,3,1,0,1,0,2,0,7,1.0,1,0.0,0,1,0,1,3,0,0,2,0,2,5,1
3377,69711,I8DzhVfDWUcYhRFQ0yqaOgzpzxPiQBKk,bWdj2GDclj5ofokWjzoa5jAwMkxCykd6,6,5,2,0,1,0,3,0,11,1.5714285714285714,1,0.0,0,2,0,1,5,0,0,3,0,3,8,1
3378,69731,mQNenLPD3Qc7tSPYw2VwygE2NmpBhKsk,A3fsA9Zfv1X2fVEQhTw51lKENdNrEqT3,10,3,2,0,2,1,5,3,16,2.2857142857142856,1,0.0,0,2,0,2,3,1,0,5,3,4,12,1
3379,69764,BLvQXA2YaaLZxMBjVQ5Po1TXbL69VEdH,SpATywNh6bZuzm8s1ceuBUnMUAeoAHHw,5,2,1,0,1,0,2,0,6,0.8571428571428571,1,0.0,0,1,0,1,2,0,0,2,0,2,4,1
3380,69770,JgN8P3Oh101qfcWX1dxprWYo04K2OTYg,bWdj2GDclj5ofokWjzoa5jAwMkxCykd6,4,2,1,0,1,0,1,0,5,0.7142857142857143,1,0.0,0,1,0,1,2,0,0,1,0,2,3,1
3381,69778,Lcc8QujJbkTuweBtBrKCB15IfiVLUIVq,A3fsA9Zfv1X2fVEQhTw51lKENdNrEqT3,20,21,15,0,10,0,3,0,49,7.0,2,0.0,1,15,0,10,20,0,0,3,0,26,23,1
3382,69786,231vKE9Ghn3hPwkNFyzJyi0Car52cYe1,bWdj2GDclj5ofokWjzoa5jAwMkxCykd6,1,0,0,0,0,0,1,0,1,0.14285714285714285,1,0.0,0,0,0,0,0,0,0,1,0,0,1,1
3383,69804,RBKGxYBfWpgkY9AF7ooiIKdEMpAJTvzp,bWdj2GDclj5ofokWjzoa5jAwMkxCykd6,1,0,0,0,0,0,1,0,1,0.14285714285714285,1,0.0,0,0,0,0,0,0,0,1,0,0,1,1
3384,69813,UOpfm9RdmrM2DaZfYaiUthWSvj5wRhpf,A3fsA9Zfv1X2fVEQhTw51lKENdNrEqT3,9,4,2,0,1,1,12,0,20,2.857142857142857,2,0.0,0,2,0,1,4,1,0,12,0,3,17,1
3385,69823,pD1s3J2DAVHqxnTOsnHBHGIq9d5lcpqD,SpATywNh6bZuzm8s1ceuBUnMUAeoAHHw,29,48,16,24,7,8,14,1,118,16.857142857142858,5,0.0,17,16,22,7,31,8,2,14,1,62,56,0
3386,69828,RI0oJHr7vWXzPLP3ybfgZBQolmA0lbjl,SpATywNh6bZuzm8s1ceuBUnMUAeoAHHw,25,26,11,30,7,0,3,0,77,11.0,2,0.0,4,11,24,7,22,0,6,3,0,46,31,0
3387,69868,gV1Y6A8RpgDuAD47r6UGF54v9TD2f7uU,SpATywNh6bZuzm8s1ceuBUnMUAeoAHHw,22,26,16,27,9,0,6,0,84,12.0,2,0.0,6,16,24,9,20,0,3,6,0,55,29,0
3388,69870,JosNAk0Jss8nuybl3t8YWavpQFNL43lY,A3fsA9Zfv1X2fVEQhTw51lKENdNrEqT3,13,8,6,0,5,0,7,0,26,3.7142857142857144,2,0.0,0,6,0,5,8,0,0,7,0,11,15,1
3389,69880,wJ6pUrPXT2xprnVlaCeorPmn4kCAli3G,A3fsA9Zfv1X2fVEQhTw51lKENdNrEqT3,51,55,39,72,24,120,16,1,327,46.714285714285715,7,0.0,2,39,56,24,53,120,16,16,1,121,206,1
3390,69900,KXHDxoyacxCXhUbcgqweNNZf38mVEmJs,SpATywNh6bZuzm8s1ceuBUnMUAeoAHHw,14,11,7,16,4,0,2,0,40,5.714285714285714,1,0.0,3,7,14,4,8,0,2,2,0,28,12,1
3391,69902,ZLrfFX2a65pmAVGtiIPK4faxDMnbmzh2,SpATywNh6bZuzm8s1ceuBUnMUAeoAHHw,4,5,2,0,0,0,3,0,10,1.4285714285714286,1,0.0,0,2,0,0,5,0,0,3,0,2,8,1
3392,69906,qowpjfcpUK1iU9rrtJ9U3WvarOVtt4V0,SpATywNh6bZuzm8s1ceuBUnMUAeoAHHw,30,51,29,24,14,18,11,1,148,21.142857142857142,3,0.0,9,29,21,14,42,18,3,11,1,73,75,0
3393,69916,V80I9ihOq6qwBn52j4Qxq5UKfYpTJipj,A3fsA9Zfv1X2fVEQhTw51lKENdNrEqT3,1,0,0,0,0,0,1,0,1,0.14285714285714285,1,0.0,0,0,0,0,0,0,0,1,0,0,1,1
3394,69970,dYC6Q6IXtOHRHCawBvKivQeuFVOWFZ5M,SpATywNh6bZuzm8s1ceuBUnMUAeoAHHw,14,10,7,6,5,1,5,1,35,5.0,2,0.0,1,7,5,5,9,1,1,5,1,18,17,1
3395,69972,6AqVXM3NzhPR7CIRltoRCDhzdk8YVusO,SpATywNh6bZuzm8s1ceuBUnMUAeoAHHw,31,46,27,32,7,9,21,4,146,20.857142857142858,5,0.0,11,27,28,7,35,9,4,21,4,73,73,0
3396,69983,CabsQjb2Sd2I3ynTdtsErAG67rLex08f,SpATywNh6bZuzm8s1ceuBUnMUAeoAHHw,7,3,0,0,0,1,4,1,9,1.2857142857142858,1,0.0,0,0,0,0,3,1,0,4,1,0,9,1
3397,69984,979PHlsnLj7fGUBEOVls6yVfgExSRWl0,SpATywNh6bZuzm8s1ceuBUnMUAeoAHHw,26,19,15,9,8,12,12,0,75,10.714285714285714,3,0.0,0,15,7,8,19,12,2,12,0,30,45,0
3398,70011,gfov2YfhzgUzN6Vbd3DOhS3J4f6Zpsmw,SpATywNh6bZuzm8s1ceuBUnMUAeoAHHw,17,19,14,19,12,0,2,0,66,9.428571428571429,4,0.0,2,14,16,12,17,0,3,2,0,44,22,1
3399,70019,mRVxG27OAHo6TDwz5EATZqlFWV3ONpTz,SpATywNh6bZuzm8s1ceuBUnMUAeoAHHw,2,0,0,0,0,0,2,0,2,0.2857142857142857,1,0.0,0,0,0,0,0,0,0,2,0,0,2,1
3400,70021,J782awhmjhWAohIOvWifbZTNvhSxGcmf,SpATywNh6bZuzm8s1ceuBUnMUAeoAHHw,14,21,11,0,7,0,9,0,48,6.857142857142857,2,0.0,0,11,0,7,21,0,0,9,0,18,30,1
3401,70042,7VdMdsntecIH9xdStqUN45Z6l4PdR7Lf,SpATywNh6bZuzm8s1ceuBUnMUAeoAHHw,4,4,1,0,0,0,3,0,8,1.1428571428571428,1,0.0,0,1,0,0,4,0,0,3,0,1,7,1
3402,70054,DyupaV8BmUavHjvovvxyDg1D0z37S8dm,SpATywNh6bZuzm8s1ceuBUnMUAeoAHHw,10,9,7,0,5,0,4,0,25,3.5714285714285716,2,0.0,0,7,0,5,9,0,0,4,0,12,13,1
3403,70060,nXqrD0yeRarrFPn56WxkuqRZ3ny2kh9R,SpATywNh6bZuzm8s1ceuBUnMUAeoAHHw,2,0,0,0,0,0,2,0,2,0.2857142857142857,1,0.0,0,0,0,0,0,0,0,2,0,0,2,1
3404,70066,wKNO0Jje7WXvAVQ9yfigFflnCrR4q8AL,A3fsA9Zfv1X2fVEQhTw51lKENdNrEqT3,9,7,4,0,2,0,8,0,21,3.0,2,0.0,0,4,0,2,7,0,0,8,0,6,15,1
3405,70080,lhSfCfPZnDk6mpF0h6gOX9NA2ZuZUrvg,SpATywNh6bZuzm8s1ceuBUnMUAeoAHHw,15,38,5,19,4,1,17,3,87,12.428571428571429,3,0.0,6,5,16,4,32,1,3,17,3,31,56,0
3406,70081,S0YS2NCKuZXB21pPEkAadXWVZsUyQWb2,SpATywNh6bZuzm8s1ceuBUnMUAeoAHHw,9,19,6,0,4,0,6,0,35,5.0,3,0.0,0,6,0,4,19,0,0,6,0,10,25,1
3407,70084,0uULbxMYxykuellS4DES6XbGTfaCngOW,SpATywNh6bZuzm8s1ceuBUnMUAeoAHHw,4,2,0,0,0,0,3,0,5,0.7142857142857143,2,0.0,0,0,0,0,2,0,0,3,0,0,5,1
3408,70086,05tZSn1VpjmBZfEP79jJJrxZA1bk8Ov5,SpATywNh6bZuzm8s1ceuBUnMUAeoAHHw,5,15,5,0,0,0,1,0,21,3.0,4,0.0,3,5,0,0,12,0,0,1,0,8,13,0
3409,70094,vjGeuAzCU9VuvJBAkOsbOGPQ1dhGyEOw,SpATywNh6bZuzm8s1ceuBUnMUAeoAHHw,10,11,1,0,0,0,6,2,20,2.857142857142857,1,0.0,3,1,0,0,8,0,0,6,2,4,16,1
3410,70097,0uULbxMYxykuellS4DES6XbGTfaCngOW,bWdj2GDclj5ofokWjzoa5jAwMkxCykd6,6,4,0,10,1,0,2,0,17,2.4285714285714284,1,0.0,2,0,10,1,2,0,0,2,0,13,4,1
3411,70112,CNg7OyU6zWgKAN5K0oJtHsglhaU3oGQ9,SpATywNh6bZuzm8s1ceuBUnMUAeoAHHw,5,4,1,0,1,0,1,0,7,1.0,1,0.0,0,1,0,1,4,0,0,1,0,2,5,1
3412,70113,xPyi5tVWLdzwESKbVSwWQTZrKjlUSal4,bWdj2GDclj5ofokWjzoa5jAwMkxCykd6,2,0,0,0,0,0,2,0,2,0.2857142857142857,1,0.0,0,0,0,0,0,0,0,2,0,0,2,1
3413,70117,Unmtjjmp5vQtsUKiq2OfCGrdrro6CfzN,SpATywNh6bZuzm8s1ceuBUnMUAeoAHHw,31,148,77,34,14,177,44,1,495,70.71428571428571,9,0.0,42,77,30,14,106,177,4,44,1,163,332,0
3414,70118,ynRrL3n4SK143BrBaMe5mVlDwKfYLlFe,SpATywNh6bZuzm8s1ceuBUnMUAeoAHHw,5,2,1,0,1,0,2,0,6,0.8571428571428571,1,0.0,0,1,0,1,2,0,0,2,0,2,4,1
3415,70130,r9R01U9QisCDxxLmorZFQ60ReGG1wPEx,SpATywNh6bZuzm8s1ceuBUnMUAeoAHHw,23,19,17,0,13,0,7,0,56,8.0,2,0.0,0,17,0,13,19,0,0,7,0,30,26,1
3416,70141,j4hecXKY3USBQpRwMuzKA9d9SPzBKhRY,SpATywNh6bZuzm8s1ceuBUnMUAeoAHHw,9,9,1,0,0,1,7,1,19,2.7142857142857144,2,0.0,3,1,0,0,6,1,0,7,1,4,15,1
3417,70362,zp9CVU4G1wbuvD6zHeghytszv1OWHRbH,fbPkOYLVPtPgIt0MxizjfFJov3JbHyAi,5,2,1,0,1,0,5,0,9,1.2857142857142858,1,0.0,0,1,0,1,2,0,0,5,0,2,7,1
3418,70364,d11XQPw4CaDnMkkvSEo4JqU6avErSb1R,fbPkOYLVPtPgIt0MxizjfFJov3JbHyAi,12,15,3,7,5,9,13,1,53,7.571428571428571,2,0.0,10,3,6,5,5,9,1,13,1,24,29,1
3419,70366,PpnPvK9DbTHdgRWHJHXOlINRXSc8Npmg,fbPkOYLVPtPgIt0MxizjfFJov3JbHyAi,7,3,2,0,2,0,4,0,11,1.5714285714285714,1,0.0,0,2,0,2,3,0,0,4,0,4,7,1
3420,70367,mJZNVvZltlGUOWmItS7lca1ZZKMYLgfv,fbPkOYLVPtPgIt0MxizjfFJov3JbHyAi,4,2,1,0,1,0,1,0,5,0.7142857142857143,1,0.0,0,1,0,1,2,0,0,1,0,2,3,1
3421,70369,QCF16jxhtQhmTizksY0agEWgfjSL0OQi,fbPkOYLVPtPgIt0MxizjfFJov3JbHyAi,6,1,1,0,1,0,3,0,6,0.8571428571428571,1,0.0,0,1,0,1,1,0,0,3,0,2,4,1
3422,70370,aM5KMfNvJMZXpckhWVfcYsB4JIRgyTpb,fbPkOYLVPtPgIt0MxizjfFJov3JbHyAi,3,0,0,0,0,0,5,0,5,0.7142857142857143,1,0.0,0,0,0,0,0,0,0,5,0,0,5,1
3423,70374,i7IcrBPDb6j5yESxBfBh5UcQNbAuMnQu,fbPkOYLVPtPgIt0MxizjfFJov3JbHyAi,1,0,0,0,0,0,1,0,1,0.14285714285714285,1,0.0,0,0,0,0,0,0,0,1,0,0,1,1
3424,70380,kI6ffxnrSLteZt1Y2KV2Lxy8Xwr4FbXB,fbPkOYLVPtPgIt0MxizjfFJov3JbHyAi,18,16,7,6,10,0,2,0,41,5.857142857142857,1,0.0,6,7,6,10,10,0,0,2,0,29,12,1
3425,70382,elPwHt777Sck2SbnBg6Zjs34W93VBNVZ,fbPkOYLVPtPgIt0MxizjfFJov3JbHyAi,8,6,4,0,3,0,4,0,17,2.4285714285714284,1,0.0,0,4,0,3,6,0,0,4,0,7,10,1
3426,70383,Op31ey1e8ia2T8lQ6kca7MllnthYRRtp,fbPkOYLVPtPgIt0MxizjfFJov3JbHyAi,19,32,19,8,8,11,21,5,104,14.857142857142858,5,0.0,6,19,8,8,26,11,0,21,5,41,63,1
3427,70386,SP7hg1EWo2mZkHuxZFtI4Vbcyr5vcP4h,fbPkOYLVPtPgIt0MxizjfFJov3JbHyAi,16,26,6,11,8,2,17,1,71,10.142857142857142,2,0.0,11,6,10,8,15,2,1,17,1,35,36,1
3428,70387,gTEZJ29F2arwuZ50nMHedjyXqssA1HaK,fbPkOYLVPtPgIt0MxizjfFJov3JbHyAi,8,6,3,0,4,0,1,0,14,2.0,1,0.0,2,3,0,4,4,0,0,1,0,9,5,1
3429,70402,b8GqJ93lAZFVpg9Mwv9wl7tS2AylqN7M,fbPkOYLVPtPgIt0MxizjfFJov3JbHyAi,7,7,4,0,2,0,4,0,17,2.4285714285714284,1,0.0,0,4,0,2,7,0,0,4,0,6,11,1
3430,70403,n0BoTjy9bHkXIWArHniej1rGvdJMGwHf,fbPkOYLVPtPgIt0MxizjfFJov3JbHyAi,8,5,2,0,2,6,4,1,20,2.857142857142857,1,0.0,0,2,0,2,5,6,0,4,1,4,16,1
3431,70405,0mn9lI6rmOQgtsjwJJCZKT5aBtKrZOEC,fbPkOYLVPtPgIt0MxizjfFJov3JbHyAi,1,0,0,0,0,0,1,0,1,0.14285714285714285,1,0.0,0,0,0,0,0,0,0,1,0,0,1,1
3432,70408,rPtP72DMEyNlpUomeqVVqrg44j30SIpW,fbPkOYLVPtPgIt0MxizjfFJov3JbHyAi,11,20,14,0,4,16,11,3,68,9.714285714285714,3,0.0,0,14,0,4,20,16,0,11,3,18,50,1
3433,70411,84PbfOPlGI9IjAK4ghphRdENNw1iTjGO,fbPkOYLVPtPgIt0MxizjfFJov3JbHyAi,1,0,0,0,0,0,1,0,1,0.14285714285714285,1,0.0,0,0,0,0,0,0,0,1,0,0,1,1
3434,70413,kMAOJzCNXdlJhsuMcIBGlBO8JULKbUln,fbPkOYLVPtPgIt0MxizjfFJov3JbHyAi,9,12,7,0,4,0,6,0,29,4.142857142857143,2,0.0,0,7,0,4,12,0,0,6,0,11,18,1
3435,70415,dRkGRhgEz0P6Cj2gSWKZ3jwm6LAB5sTl,fbPkOYLVPtPgIt0MxizjfFJov3JbHyAi,1,0,0,0,0,0,1,0,1,0.14285714285714285,1,0.0,0,0,0,0,0,0,0,1,0,0,1,1
3436,70416,TkGkraxFZeISMMLd87fcbklBTVTLGOhm,fbPkOYLVPtPgIt0MxizjfFJov3JbHyAi,46,53,32,28,18,8,14,1,154,22.0,3,0.0,15,32,27,18,38,8,1,14,1,92,62,1
3437,70417,U3vRWJ9ZlxOl62be4tXpqiQTVZSIgIE3,fbPkOYLVPtPgIt0MxizjfFJov3JbHyAi,1,0,0,0,0,0,1,0,1,0.14285714285714285,1,0.0,0,0,0,0,0,0,0,1,0,0,1,1
3438,70418,TgD7HTL6BBYi1V76wOsbmKwneDk5GeY1,fbPkOYLVPtPgIt0MxizjfFJov3JbHyAi,11,9,4,0,3,0,3,0,19,2.7142857142857144,1,0.0,4,4,0,3,5,0,0,3,0,11,8,1
3439,70420,nb4zZ4thsaPUV3M4XPmI0s66LlJvQ5KS,fbPkOYLVPtPgIt0MxizjfFJov3JbHyAi,12,7,5,0,3,0,5,0,20,2.857142857142857,1,0.0,0,5,0,3,7,0,0,5,0,8,12,1
3440,70421,JRVFRZlL9O1Hg2XIIgM1SU6gF5ZFwBDs,fbPkOYLVPtPgIt0MxizjfFJov3JbHyAi,1,0,0,0,0,0,1,0,1,0.14285714285714285,1,0.0,0,0,0,0,0,0,0,1,0,0,1,1
3441,70422,BaBxjEn3TWZ4ftqH98jukKacUK8Z3SVk,fbPkOYLVPtPgIt0MxizjfFJov3JbHyAi,5,2,1,0,1,0,2,0,6,0.8571428571428571,1,0.0,0,1,0,1,2,0,0,2,0,2,4,1
3442,70425,Cko24A4msOu0ocJWLZJpsB3dmU1FdwtS,fbPkOYLVPtPgIt0MxizjfFJov3JbHyAi,1,0,0,0,0,0,1,0,1,0.14285714285714285,1,0.0,0,0,0,0,0,0,0,1,0,0,1,1
3443,70426,y2pJnc0KPSLQND52yd5rcX8VRJR3QNZU,fbPkOYLVPtPgIt0MxizjfFJov3JbHyAi,5,2,1,0,1,2,2,0,8,1.1428571428571428,1,0.0,0,1,0,1,2,2,0,2,0,2,6,1
3444,70430,wEobeJ4f0gBmMcwQxjxFZn1OCeOPZzYY,fbPkOYLVPtPgIt0MxizjfFJov3JbHyAi,9,4,3,0,3,1,5,1,17,2.4285714285714284,1,0.0,0,3,0,3,4,1,0,5,1,6,11,1
3445,70432,TINvhk9VLXQ3D49XU1y8baDw0NlbVtwm,fbPkOYLVPtPgIt0MxizjfFJov3JbHyAi,1,0,0,0,0,0,1,0,1,0.14285714285714285,1,0.0,0,0,0,0,0,0,0,1,0,0,1,1
3446,70440,s8W8cdIMLI0wttTxhl9oTzo8KNby6TlB,fbPkOYLVPtPgIt0MxizjfFJov3JbHyAi,5,2,1,0,1,0,2,0,6,0.8571428571428571,1,0.0,0,1,0,1,2,0,0,2,0,2,4,1
3447,70442,wMrBLf0Bj3KcyXZhbv1Gc8JYaCbLqMxI,fbPkOYLVPtPgIt0MxizjfFJov3JbHyAi,1,0,0,0,0,0,1,0,1,0.14285714285714285,1,0.0,0,0,0,0,0,0,0,1,0,0,1,1
3448,70443,KU2ZvHkEQEb3JAaLolzvBVJ54ROyNU4O,fbPkOYLVPtPgIt0MxizjfFJov3JbHyAi,8,3,2,0,2,1,3,0,11,1.5714285714285714,1,0.0,0,2,0,2,3,1,0,3,0,4,7,1
3449,70444,9DnTA9cJdXk1sLNPfwadV56caZuYgPFA,fbPkOYLVPtPgIt0MxizjfFJov3JbHyAi,7,6,4,0,4,0,2,0,16,2.2857142857142856,1,0.0,1,4,0,4,5,0,0,2,0,9,7,1
3450,70447,e1JkrjLmoNWMhYF8oakgy1uiYBC2tSp7,fbPkOYLVPtPgIt0MxizjfFJov3JbHyAi,7,7,3,0,2,3,3,0,18,2.5714285714285716,1,0.0,0,3,0,2,7,3,0,3,0,5,13,1
3451,70448,Tnqp8RxwOeUuCC7Qp8CqF6vKQxL9Cimc,fbPkOYLVPtPgIt0MxizjfFJov3JbHyAi,7,7,1,0,1,0,8,0,17,2.4285714285714284,1,0.0,0,1,0,1,7,0,0,8,0,2,15,1
3452,70450,B9Ey1tIo6ANxVa0IvzoinvUWj4cenbLl,fbPkOYLVPtPgIt0MxizjfFJov3JbHyAi,30,69,1,29,4,0,2,0,105,15.0,2,0.0,24,1,24,4,45,0,5,2,0,53,52,1
3453,70451,5n43m0O6jMd9u06uLjQWfLgplW2Mj8WG,fbPkOYLVPtPgIt0MxizjfFJov3JbHyAi,7,3,2,0,2,0,3,0,10,1.4285714285714286,2,0.0,0,2,0,2,3,0,0,3,0,4,6,1
3454,70453,j5jJTM3hFoonQXLPD4VBAk3sLP9YQf22,fbPkOYLVPtPgIt0MxizjfFJov3JbHyAi,6,1,1,0,1,0,5,0,8,1.1428571428571428,1,0.0,0,1,0,1,1,0,0,5,0,2,6,1
3455,70454,6GqrPcO4oJU2rSJnj2GMOg35aldNMAg2,fbPkOYLVPtPgIt0MxizjfFJov3JbHyAi,1,0,0,0,0,0,1,0,1,0.14285714285714285,1,0.0,0,0,0,0,0,0,0,1,0,0,1,1
3456,70460,uIBAKDJwWewmJzOoAu8wXcXt7IZWFCLk,fbPkOYLVPtPgIt0MxizjfFJov3JbHyAi,4,0,0,0,0,0,4,0,4,0.5714285714285714,1,0.0,0,0,0,0,0,0,0,4,0,0,4,1
3457,70464,5pNBiCcrjVf8w8PgJKHP647T7U9arPze,fbPkOYLVPtPgIt0MxizjfFJov3JbHyAi,2,0,0,0,0,0,2,0,2,0.2857142857142857,1,0.0,0,0,0,0,0,0,0,2,0,0,2,1
3458,70465,5CrBlR6zrkauTaeaZtpYKwSZbYlbmRp4,fbPkOYLVPtPgIt0MxizjfFJov3JbHyAi,7,3,2,0,2,0,2,0,9,1.2857142857142858,1,0.0,0,2,0,2,3,0,0,2,0,4,5,1
3459,70466,peaGEeAVqM29YYBxjRmiLTEtcrDX5FwI,fbPkOYLVPtPgIt0MxizjfFJov3JbHyAi,1,0,0,0,0,0,1,0,1,0.14285714285714285,1,0.0,0,0,0,0,0,0,0,1,0,0,1,1
3460,70467,AF2WqhAeg8UXHquisOTxLVKHXh1OOPd5,fbPkOYLVPtPgIt0MxizjfFJov3JbHyAi,11,4,2,6,2,3,6,1,24,3.4285714285714284,1,0.0,1,2,5,2,3,3,1,6,1,10,14,1
3461,70468,ETCPUMqyU09gcKrtaCRQ42i068JLqy26,fbPkOYLVPtPgIt0MxizjfFJov3JbHyAi,13,7,4,7,5,4,7,1,35,5.0,1,0.0,2,4,5,5,5,4,2,7,1,16,19,1
3462,70475,r5QBoGyTGzPPNMXpOkVWAVSD4WtheLjK,fbPkOYLVPtPgIt0MxizjfFJov3JbHyAi,1,0,0,0,0,0,1,0,1,0.14285714285714285,1,0.0,0,0,0,0,0,0,0,1,0,0,1,1
3463,70479,IeJFnRP45F5IqEsCwWOVkYId1qIootxH,fbPkOYLVPtPgIt0MxizjfFJov3JbHyAi,8,5,3,0,3,0,2,0,13,1.8571428571428572,2,0.0,0,3,0,3,5,0,0,2,0,6,7,1
3464,70480,ZnZUpsAwhsKxOeo88uKWqXms7Hr6vGQ0,fbPkOYLVPtPgIt0MxizjfFJov3JbHyAi,1,0,0,0,0,0,1,0,1,0.14285714285714285,1,0.0,0,0,0,0,0,0,0,1,0,0,1,1
3465,70483,F8PplJ0MdSBFJMkvQSa7z6RMAQvcxOkt,fbPkOYLVPtPgIt0MxizjfFJov3JbHyAi,13,31,0,8,0,4,7,0,50,7.142857142857143,5,0.0,3,0,7,0,28,4,1,7,0,10,40,0
3466,70489,1KY2xQE7nTlowha0qhSxoa3VZ8IEtTuU,fbPkOYLVPtPgIt0MxizjfFJov3JbHyAi,4,2,1,0,1,0,1,0,5,0.7142857142857143,1,0.0,0,1,0,1,2,0,0,1,0,2,3,1
3467,70491,o72e1M3GwrvLzNPjTViCBNsXT3sIbItE,fbPkOYLVPtPgIt0MxizjfFJov3JbHyAi,8,5,2,0,2,0,4,0,13,1.8571428571428572,1,0.0,0,2,0,2,5,0,0,4,0,4,9,1
3468,70493,PQN68zvQWtqLWovgQi2j4ZPXjsSbybWb,fbPkOYLVPtPgIt0MxizjfFJov3JbHyAi,1,0,0,0,0,0,1,0,1,0.14285714285714285,1,0.0,0,0,0,0,0,0,0,1,0,0,1,1
3469,70494,lgip049r6Eu24ga2SPdixKHu4ShoVkOP,fbPkOYLVPtPgIt0MxizjfFJov3JbHyAi,1,0,0,0,0,0,1,0,1,0.14285714285714285,1,0.0,0,0,0,0,0,0,0,1,0,0,1,1
3470,70497,vGQJgu8tmA9kQpG8GdauGWSuqyqtNE3M,fbPkOYLVPtPgIt0MxizjfFJov3JbHyAi,1,0,0,0,0,0,1,0,1,0.14285714285714285,1,0.0,0,0,0,0,0,0,0,1,0,0,1,1
3471,70498,LK1fNSP3UpGaGwYkuo0BQyI3g1s3ODJ4,fbPkOYLVPtPgIt0MxizjfFJov3JbHyAi,7,3,2,0,2,0,4,0,11,1.5714285714285714,1,0.0,0,2,0,2,3,0,0,4,0,4,7,1
3472,70499,R0fqJCKSDdlape9O3QiJvxhX8OJnijdc,fbPkOYLVPtPgIt0MxizjfFJov3JbHyAi,14,27,15,19,11,3,12,0,87,12.428571428571429,3,0.0,9,15,13,11,18,3,6,12,0,48,39,1
3473,70500,wuj7kbmCy3JkqjSYqFBD6rEwetA5ny2r,fbPkOYLVPtPgIt0MxizjfFJov3JbHyAi,8,3,2,0,2,2,6,0,15,2.142857142857143,1,0.0,0,2,0,2,3,2,0,6,0,4,11,1
3474,70505,0uebMpTrpNYgDgvdKb7MmNThyYHd0W5n,fbPkOYLVPtPgIt0MxizjfFJov3JbHyAi,8,6,3,0,2,1,6,0,18,2.5714285714285716,1,0.0,0,3,0,2,6,1,0,6,0,5,13,1
3475,70507,edTxzupkEcnjoBMEEWcWCMVwXX7Jf82i,fbPkOYLVPtPgIt0MxizjfFJov3JbHyAi,9,8,3,2,2,0,2,0,17,2.4285714285714284,1,0.0,1,3,2,2,7,0,0,2,0,8,9,1
3476,70508,gJS3lYqFTHr060G9WKP0FBIIOt76kylk,fbPkOYLVPtPgIt0MxizjfFJov3JbHyAi,7,5,2,0,2,0,2,0,11,1.5714285714285714,1,0.0,0,2,0,2,5,0,0,2,0,4,7,1
3477,70619,EUbYS528SLpUvydqHGhniNAZDkRxQSUM,fbPkOYLVPtPgIt0MxizjfFJov3JbHyAi,1,0,0,0,0,0,1,0,1,0.14285714285714285,1,0.0,0,0,0,0,0,0,0,1,0,0,1,1
3478,70621,w0u223fmMcj8R0XYvkRYTxBWPO2H34gs,fbPkOYLVPtPgIt0MxizjfFJov3JbHyAi,10,8,6,9,5,0,3,0,31,4.428571428571429,2,0.0,1,6,6,5,7,0,3,3,0,18,13,0
3479,70628,cDndPN0bU03X7W27vQCXFKmVpa2a5fXn,fbPkOYLVPtPgIt0MxizjfFJov3JbHyAi,6,3,2,0,0,1,4,1,11,1.5714285714285714,1,0.0,0,2,0,0,3,1,0,4,1,2,9,1
3480,70630,6BV3xjXq9ekiRfYm3O3pN6jZMMACVAnm,fbPkOYLVPtPgIt0MxizjfFJov3JbHyAi,1,0,0,0,0,0,1,0,1,0.14285714285714285,1,0.0,0,0,0,0,0,0,0,1,0,0,1,0
3481,70631,zhUkf3kMMzWlXsKEezEHBm9LsgVJDdTP,fbPkOYLVPtPgIt0MxizjfFJov3JbHyAi,5,2,1,0,1,0,10,0,14,2.0,2,0.0,0,1,0,1,2,0,0,10,0,2,12,1
3482,70633,PnTAr4JQ7W1gITYEASL2GPQdvilj2Kny,fbPkOYLVPtPgIt0MxizjfFJov3JbHyAi,3,2,0,0,0,0,1,0,3,0.42857142857142855,1,0.0,0,0,0,0,2,0,0,1,0,0,3,1
3483,70634,HU8ThwxdRuW919irq38IcjLXhEvT4bai,fbPkOYLVPtPgIt0MxizjfFJov3JbHyAi,9,9,6,0,4,1,12,0,32,4.571428571428571,2,0.0,0,6,0,4,9,1,0,12,0,10,22,1
3484,70639,NjNUHcUgwvm9xYQvil0yjwq6PWKHWHr6,fbPkOYLVPtPgIt0MxizjfFJov3JbHyAi,7,3,2,0,1,4,13,0,23,3.2857142857142856,2,0.0,0,2,0,1,3,4,0,13,0,3,20,1
3485,70640,KqGhfmSqWtSa4SJELlmAXcwsyTwdeOL4,fbPkOYLVPtPgIt0MxizjfFJov3JbHyAi,7,6,4,0,4,0,2,0,16,2.2857142857142856,1,0.0,1,4,0,4,5,0,0,2,0,9,7,1
3486,70643,cdEsk1qpGnOY8M8xILMNOVhPCtmvS3gr,fbPkOYLVPtPgIt0MxizjfFJov3JbHyAi,7,3,2,0,2,0,4,0,11,1.5714285714285714,1,0.0,0,2,0,2,3,0,0,4,0,4,7,1
3487,70645,sikVclrYgcpS3p4V6eW44EtX4b5SsNLE,fbPkOYLVPtPgIt0MxizjfFJov3JbHyAi,11,30,1,3,8,4,3,0,49,7.0,1,0.0,20,1,3,8,10,4,0,3,0,32,17,1
3488,70650,kbSUu2Z40fu4lSlgv22Wu70hAt5BnJoC,fbPkOYLVPtPgIt0MxizjfFJov3JbHyAi,22,45,0,12,6,52,16,1,132,18.857142857142858,4,0.0,21,0,10,6,24,52,2,16,1,37,95,1
3489,70654,LAVkRDyEDRYFfA0FMc6U4JnWPWsDLjhi,fbPkOYLVPtPgIt0MxizjfFJov3JbHyAi,7,12,1,0,2,0,3,0,18,2.5714285714285716,1,0.0,2,1,0,2,10,0,0,3,0,5,13,1
3490,70660,J1bBTxr7xQhu6wEykZt3Bd9gSlmRIWmq,fbPkOYLVPtPgIt0MxizjfFJov3JbHyAi,2,0,0,0,0,0,3,0,3,0.42857142857142855,1,0.0,0,0,0,0,0,0,0,3,0,0,3,1
3491,70662,u3wB3K0Js3pmFsJGQpe7V7v42hnAvDay,fbPkOYLVPtPgIt0MxizjfFJov3JbHyAi,5,2,1,0,1,0,4,0,8,1.1428571428571428,2,0.0,0,1,0,1,2,0,0,4,0,2,6,1
3492,70663,EpLshGb6fxFM19N1QN5M0uUEP2YQoz65,fbPkOYLVPtPgIt0MxizjfFJov3JbHyAi,6,6,2,0,2,0,5,0,15,2.142857142857143,1,0.0,2,2,0,2,4,0,0,5,0,6,9,1
3493,70665,jWXtvduhcSeQYRX8KBGNnUGlWXZhf8j7,fbPkOYLVPtPgIt0MxizjfFJov3JbHyAi,7,4,2,0,1,0,9,0,16,2.2857142857142856,1,0.0,0,2,0,1,4,0,0,9,0,3,13,1
3494,70667,m6MSFO9wulR4Nf5CljOSKizOwoCC2JYl,fbPkOYLVPtPgIt0MxizjfFJov3JbHyAi,21,44,19,21,14,25,6,0,129,18.428571428571427,4,0.0,20,19,15,14,24,25,6,6,0,68,61,1
3495,70668,6Bdl0MkwJ5lZUJnVsPp6IjSTHrXnqeTx,fbPkOYLVPtPgIt0MxizjfFJov3JbHyAi,2,0,0,0,0,0,9,0,9,1.2857142857142858,1,0.0,0,0,0,0,0,0,0,9,0,0,9,1
3496,70671,RMxcBkJoAGieBk6NcKXJqusraN8qxLZ7,fbPkOYLVPtPgIt0MxizjfFJov3JbHyAi,1,0,0,0,0,0,1,0,1,0.14285714285714285,1,0.0,0,0,0,0,0,0,0,1,0,0,1,1
3497,70673,RyoftXJlSPPQnlnD7mk7JNhtKBWRLRWG,fbPkOYLVPtPgIt0MxizjfFJov3JbHyAi,2,0,0,0,0,0,5,0,5,0.7142857142857143,1,0.0,0,0,0,0,0,0,0,5,0,0,5,1
3498,70679,YXIqJ6spT3Ja1ygrmNWuBLibK013t0q5,fbPkOYLVPtPgIt0MxizjfFJov3JbHyAi,1,0,0,0,0,0,1,0,1,0.14285714285714285,1,0.0,0,0,0,0,0,0,0,1,0,0,1,1
3499,70680,I2YlhnUPXZKF2nHJmVrtwRFgGB2nHSiZ,fbPkOYLVPtPgIt0MxizjfFJov3JbHyAi,9,12,3,0,3,1,8,1,28,4.0,1,0.0,6,3,0,3,6,1,0,8,1,12,16,1
3500,70681,XSTWk85DGQnV3ClLFIpSnGKTu2dEFPYv,fbPkOYLVPtPgIt0MxizjfFJov3JbHyAi,6,1,1,0,1,0,8,0,11,1.5714285714285714,1,0.0,0,1,0,1,1,0,0,8,0,2,9,1
3501,70683,hkJbQtfl1ac72y2vr8c3dGSqgpUqSDf1,fbPkOYLVPtPgIt0MxizjfFJov3JbHyAi,1,0,0,0,0,0,1,0,1,0.14285714285714285,1,0.0,0,0,0,0,0,0,0,1,0,0,1,1
3502,70684,Cd9ft0A4qlmf8URzSzFBOzoArPR6PTDL,fbPkOYLVPtPgIt0MxizjfFJov3JbHyAi,44,62,24,67,23,16,8,1,201,28.714285714285715,3,0.0,33,24,59,23,29,16,8,8,1,139,62,1
3503,70686,NUUrfkmQ6PTn8vYLlenz4k9BmiPCmi7I,fbPkOYLVPtPgIt0MxizjfFJov3JbHyAi,7,6,4,0,1,0,3,0,14,2.0,2,0.0,0,4,0,1,6,0,0,3,0,5,9,0
3504,70689,WFLWEfQrQsuFMQB4h1DfinKxHOxaJgRw,fbPkOYLVPtPgIt0MxizjfFJov3JbHyAi,9,9,5,0,2,5,3,0,24,3.4285714285714284,1,0.0,0,5,0,2,9,5,0,3,0,7,17,1
3505,70692,6qrT2bYbFD0verDQZWOnrOjhEccqo56g,fbPkOYLVPtPgIt0MxizjfFJov3JbHyAi,59,197,82,41,52,148,52,2,574,82.0,17,0.0,82,82,39,52,115,148,2,52,2,255,319,0
3506,70694,a0K0pCjTVYvmpJhsgniZUHaxogtZRZu6,fbPkOYLVPtPgIt0MxizjfFJov3JbHyAi,1,0,0,0,0,0,1,0,1,0.14285714285714285,1,0.0,0,0,0,0,0,0,0,1,0,0,1,1
3507,70696,Pt9EMdXHAJoREYsz9PnQvEKtrmRTWsTp,fbPkOYLVPtPgIt0MxizjfFJov3JbHyAi,2,0,0,0,0,0,2,0,2,0.2857142857142857,1,0.0,0,0,0,0,0,0,0,2,0,0,2,1
3508,70698,FN0V2FJ9PwsmZe2ZdtFoTzNeftwa8lew,fbPkOYLVPtPgIt0MxizjfFJov3JbHyAi,4,2,1,0,1,0,1,0,5,0.7142857142857143,1,0.0,0,1,0,1,2,0,0,1,0,2,3,1
3509,70707,KIkxhCvZoGl3wo3zfjbQsMpSQMiIEEXM,fbPkOYLVPtPgIt0MxizjfFJov3JbHyAi,6,7,4,0,2,0,5,0,18,2.5714285714285716,1,0.0,0,4,0,2,7,0,0,5,0,6,12,1
3510,70714,NPIHq6nnRF0fUledjFKG5ROeHLCshlez,fbPkOYLVPtPgIt0MxizjfFJov3JbHyAi,13,12,8,0,6,0,9,0,35,5.0,2,0.0,0,8,0,6,12,0,0,9,0,14,21,1
3511,70716,7aQ84DnQTSRkdmQzmLpA6ZuenMv0j2zy,fbPkOYLVPtPgIt0MxizjfFJov3JbHyAi,1,0,0,0,0,0,1,0,1,0.14285714285714285,1,0.0,0,0,0,0,0,0,0,1,0,0,1,1
3512,70718,Zh4ywqGGZpnusw56NY7i4goj5JrNtqvq,fbPkOYLVPtPgIt0MxizjfFJov3JbHyAi,13,9,5,0,6,0,2,0,22,3.142857142857143,1,0.0,3,5,0,6,6,0,0,2,0,14,8,1
3513,70719,mCG9v0HfdST0gIHQ17sgmmDB5sK4zRUH,fbPkOYLVPtPgIt0MxizjfFJov3JbHyAi,4,2,0,0,0,0,4,0,6,0.8571428571428571,1,0.0,0,0,0,0,2,0,0,4,0,0,6,1
3514,70720,1sdBeDtu3vvbkIr8j4KgcWPZ5NNqSuy1,fbPkOYLVPtPgIt0MxizjfFJov3JbHyAi,2,0,0,0,0,0,2,0,2,0.2857142857142857,1,0.0,0,0,0,0,0,0,0,2,0,0,2,1
3515,70724,Tp7YlU9FicEPdF8OYctnhCNGsZgZyAsQ,fbPkOYLVPtPgIt0MxizjfFJov3JbHyAi,1,0,0,0,0,0,1,0,1,0.14285714285714285,1,0.0,0,0,0,0,0,0,0,1,0,0,1,1
3516,70725,GKYvnmyIP1jWi6afQrMmOmjTFVpSxJct,fbPkOYLVPtPgIt0MxizjfFJov3JbHyAi,11,8,6,0,6,3,19,1,43,6.142857142857143,1,0.0,2,6,0,6,6,3,0,19,1,14,29,1
3517,70726,yz3oOBelfOSc6Zj3ARcY1Ttj6774hRYk,fbPkOYLVPtPgIt0MxizjfFJov3JbHyAi,13,15,8,0,5,3,10,1,42,6.0,2,0.0,0,8,0,5,15,3,0,10,1,13,29,1
3518,70731,baDb9SDqFGaUm6SQ1U1wIZZwVOEGfEyo,fbPkOYLVPtPgIt0MxizjfFJov3JbHyAi,5,2,1,0,1,0,4,0,8,1.1428571428571428,1,0.0,0,1,0,1,2,0,0,4,0,2,6,1
3519,70733,ZmL8VQqDEMaFfRIwjy7tQi9WkUzCCBLM,fbPkOYLVPtPgIt0MxizjfFJov3JbHyAi,10,9,6,0,2,0,9,2,28,4.0,1,0.0,0,6,0,2,9,0,0,9,2,8,20,1
3520,70735,p9NcQP74LARrulF6JzGeab5yk6ciJM9V,fbPkOYLVPtPgIt0MxizjfFJov3JbHyAi,5,6,2,0,2,0,2,0,12,1.7142857142857142,1,0.0,0,2,0,2,6,0,0,2,0,4,8,0
3521,70738,6dbTbyd09itvDaSueIGFOrLEXchCwk95,fbPkOYLVPtPgIt0MxizjfFJov3JbHyAi,1,0,0,0,0,0,1,0,1,0.14285714285714285,1,0.0,0,0,0,0,0,0,0,1,0,0,1,1
3522,70739,UpVcxzqMkt11Nj9X8RwveSuqRLLT8jcK,fbPkOYLVPtPgIt0MxizjfFJov3JbHyAi,1,0,0,0,0,0,2,0,2,0.2857142857142857,1,0.0,0,0,0,0,0,0,0,2,0,0,2,1
3523,70740,dfuGl47rq6fydJ1Iu9G64MAVsec4tYLw,fbPkOYLVPtPgIt0MxizjfFJov3JbHyAi,8,4,3,0,2,0,4,0,13,1.8571428571428572,1,0.0,0,3,0,2,4,0,0,4,0,5,8,1
3524,70741,UkIsdTaWagDppaZDW5tymVOWOun6ZaQI,fbPkOYLVPtPgIt0MxizjfFJov3JbHyAi,2,0,0,0,0,0,2,0,2,0.2857142857142857,1,0.0,0,0,0,0,0,0,0,2,0,0,2,1
3525,70745,p6AFdMGSdHZgjyt65ZYRzektbK0I84xl,fbPkOYLVPtPgIt0MxizjfFJov3JbHyAi,6,2,1,0,1,0,3,0,7,1.0,1,0.0,0,1,0,1,2,0,0,3,0,2,5,1
3526,70746,LQmyF5rgACOl1PlQazAUIkQQzPowi62e,fbPkOYLVPtPgIt0MxizjfFJov3JbHyAi,6,1,1,0,1,0,5,0,8,1.1428571428571428,1,0.0,0,1,0,1,1,0,0,5,0,2,6,1
3527,70748,Ym6TvHrxnwJdfewbwqJsshYwGQqwpbLU,fbPkOYLVPtPgIt0MxizjfFJov3JbHyAi,1,0,0,0,0,0,1,0,1,0.14285714285714285,1,0.0,0,0,0,0,0,0,0,1,0,0,1,1
3528,70751,ENyodDgJyA2wd97NHYIDwdpe1Vs11mPZ,fbPkOYLVPtPgIt0MxizjfFJov3JbHyAi,1,0,0,0,0,0,1,0,1,0.14285714285714285,1,0.0,0,0,0,0,0,0,0,1,0,0,1,1
3529,70754,nFgkSMwO2ng2Retk5DgcNAqWaKFo0gCU,fbPkOYLVPtPgIt0MxizjfFJov3JbHyAi,8,8,3,0,3,0,3,0,17,2.4285714285714284,1,0.0,0,3,0,3,8,0,0,3,0,6,11,1
3530,70755,3HpxfMDfQbW9g9Tin4Z0gZM45TYocput,fbPkOYLVPtPgIt0MxizjfFJov3JbHyAi,5,2,1,0,1,0,2,0,6,0.8571428571428571,1,0.0,0,1,0,1,2,0,0,2,0,2,4,1
3531,70756,vBhHgjMP9zQ8a4hHaJHnj26pjx8bQlTJ,fbPkOYLVPtPgIt0MxizjfFJov3JbHyAi,1,0,0,0,0,0,2,0,2,0.2857142857142857,1,0.0,0,0,0,0,0,0,0,2,0,0,2,1
3532,70758,RwU7Y7lavLbhtCQP0Z40qchKwKbkXpWv,fbPkOYLVPtPgIt0MxizjfFJov3JbHyAi,2,0,0,0,0,0,2,0,2,0.2857142857142857,1,0.0,0,0,0,0,0,0,0,2,0,0,2,1
3533,70759,9yy85NagPiS34NJ87i7KYeHGwZcaY5RV,fbPkOYLVPtPgIt0MxizjfFJov3JbHyAi,1,0,0,0,0,0,1,0,1,0.14285714285714285,1,0.0,0,0,0,0,0,0,0,1,0,0,1,1
3534,70763,Dcb7ijWo8pQsf9LOueamq5fOrw00PG6q,fbPkOYLVPtPgIt0MxizjfFJov3JbHyAi,6,5,3,0,2,2,3,0,15,2.142857142857143,1,0.0,0,3,0,2,5,2,0,3,0,5,10,1
3535,70766,GjiH1IkIccjLrYuqfEsVjmx7CFuQL57X,fbPkOYLVPtPgIt0MxizjfFJov3JbHyAi,6,6,1,0,2,0,2,0,11,1.5714285714285714,1,0.0,3,1,0,2,3,0,0,2,0,6,5,1
3536,70767,NdQp2i50zLfip7hkQMmu9RAwjvzQx8Ro,fbPkOYLVPtPgIt0MxizjfFJov3JbHyAi,1,0,0,0,0,0,1,0,1,0.14285714285714285,1,0.0,0,0,0,0,0,0,0,1,0,0,1,1
3537,70768,k5ImVzQqedaNbB81c2Hwkrfmv9j8DVBf,fbPkOYLVPtPgIt0MxizjfFJov3JbHyAi,7,3,2,0,2,0,4,0,11,1.5714285714285714,1,0.0,0,2,0,2,3,0,0,4,0,4,7,1
3538,70777,WyyKrch61UrttdMbjuQKzg4QBmDCrCBH,fbPkOYLVPtPgIt0MxizjfFJov3JbHyAi,5,2,1,0,1,0,2,0,6,0.8571428571428571,1,0.0,0,1,0,1,2,0,0,2,0,2,4,1
3539,70778,MIqfP3VsJ9nH7bZE9ekfrlzlbcWQcCFl,fbPkOYLVPtPgIt0MxizjfFJov3JbHyAi,1,0,0,0,0,0,1,0,1,0.14285714285714285,1,0.0,0,0,0,0,0,0,0,1,0,0,1,1
3540,70782,rdl2Dm3C3i0ppIthR1Qn4oaBGTeiNx1U,fbPkOYLVPtPgIt0MxizjfFJov3JbHyAi,7,3,2,0,2,0,2,0,9,1.2857142857142858,1,0.0,0,2,0,2,3,0,0,2,0,4,5,1
3541,70785,hW0YVXPA152YM5ruixi6vg4sBZmIyH6B,fbPkOYLVPtPgIt0MxizjfFJov3JbHyAi,2,0,0,0,0,0,5,0,5,0.7142857142857143,1,0.0,0,0,0,0,0,0,0,5,0,0,5,1
3542,70786,jqG9CfpKiNNgI1mgrk9KW86K86stS6Mi,fbPkOYLVPtPgIt0MxizjfFJov3JbHyAi,9,9,0,0,1,1,13,1,25,3.5714285714285716,1,0.0,3,0,0,1,6,1,0,13,1,4,21,1
3543,70788,ekWb02aBPJno00ztvjZNAv3AR4LI6ZAw,fbPkOYLVPtPgIt0MxizjfFJov3JbHyAi,5,2,0,0,1,0,2,0,5,0.7142857142857143,1,0.0,0,0,0,1,2,0,0,2,0,1,4,1
3544,70790,TmPyC7E4NTBA6YmjfcP4ojkHVXONYmBN,fbPkOYLVPtPgIt0MxizjfFJov3JbHyAi,5,2,1,0,1,0,2,0,6,0.8571428571428571,1,0.0,0,1,0,1,2,0,0,2,0,2,4,1
3545,70791,3qcRHdffVLa2D7HfTn4z6WZ2lXzvrhpG,fbPkOYLVPtPgIt0MxizjfFJov3JbHyAi,6,3,1,0,1,0,2,0,7,1.0,1,0.0,0,1,0,1,3,0,0,2,0,2,5,1
3546,70792,JkroiUnjq2uHCiIMgFI03fh765OIWPrR,fbPkOYLVPtPgIt0MxizjfFJov3JbHyAi,1,0,0,0,0,0,1,0,1,0.14285714285714285,1,0.0,0,0,0,0,0,0,0,1,0,0,1,1
3547,70795,jjlr08B8z0coeMcgDdnBVJKSEYA9jwu6,fbPkOYLVPtPgIt0MxizjfFJov3JbHyAi,1,0,0,0,0,0,1,0,1,0.14285714285714285,1,0.0,0,0,0,0,0,0,0,1,0,0,1,1
3548,70798,boC2S8uyvVowlqLg3Y1XsVwiDCwAmln4,fbPkOYLVPtPgIt0MxizjfFJov3JbHyAi,5,2,1,0,1,0,4,0,8,1.1428571428571428,1,0.0,0,1,0,1,2,0,0,4,0,2,6,1
3549,70800,2mpeAdpOL3tGWTeEe4ZWOPVvXPu3FJnP,fbPkOYLVPtPgIt0MxizjfFJov3JbHyAi,6,2,0,0,0,0,6,1,9,1.2857142857142858,1,0.0,0,0,0,0,2,0,0,6,1,0,9,1
3550,70801,a5niF0PQgSShvkt9NB1sc4s6iuS0oVal,fbPkOYLVPtPgIt0MxizjfFJov3JbHyAi,5,2,1,0,1,0,2,0,6,0.8571428571428571,1,0.0,0,1,0,1,2,0,0,2,0,2,4,1
3551,70802,KSimnpWBH0drMHTMBZ6ujLNrpiHo2Ats,fbPkOYLVPtPgIt0MxizjfFJov3JbHyAi,6,0,0,0,0,1,13,3,17,2.4285714285714284,1,0.0,0,0,0,0,0,1,0,13,3,0,17,1
3552,70805,X5eROzQX7rhyrxBey0oqBe6jtRxHyD2A,fbPkOYLVPtPgIt0MxizjfFJov3JbHyAi,6,1,1,0,1,0,3,0,6,0.8571428571428571,1,0.0,0,1,0,1,1,0,0,3,0,2,4,1
3553,70806,BVznem1ellaAs8tYskTZaTrvHXJyT2Zb,fbPkOYLVPtPgIt0MxizjfFJov3JbHyAi,5,2,1,0,1,0,2,0,6,0.8571428571428571,1,0.0,0,1,0,1,2,0,0,2,0,2,4,1
3554,70807,lcguF24eJLLJpEr3dB9FY8rhbtdiFvGC,fbPkOYLVPtPgIt0MxizjfFJov3JbHyAi,1,0,0,0,0,0,1,0,1,0.14285714285714285,1,0.0,0,0,0,0,0,0,0,1,0,0,1,1
3555,70810,CBBhqECPTNqAKZUrRWMmwFKMWNkqEZn0,fbPkOYLVPtPgIt0MxizjfFJov3JbHyAi,7,3,2,0,2,0,2,0,9,1.2857142857142858,1,0.0,0,2,0,2,3,0,0,2,0,4,5,1
3556,70811,m78E7vltQhJgZgrROuk3QTJpjWRjCXpP,fbPkOYLVPtPgIt0MxizjfFJov3JbHyAi,5,3,1,0,1,0,2,0,7,1.0,1,0.0,1,1,0,1,2,0,0,2,0,3,4,1
3557,70815,w5jq4cUGCLiYNuQqjhzyyIK1nCXtEQY7,fbPkOYLVPtPgIt0MxizjfFJov3JbHyAi,2,0,0,0,0,0,2,0,2,0.2857142857142857,1,0.0,0,0,0,0,0,0,0,2,0,0,2,1
3558,70816,5CB4swFPweP7kpiIuMEez08nNIJxrTCU,fbPkOYLVPtPgIt0MxizjfFJov3JbHyAi,7,3,2,0,2,0,2,0,9,1.2857142857142858,1,0.0,0,2,0,2,3,0,0,2,0,4,5,1
3559,70818,VYp7s59UUnQczX0IlO39VEvKPQphb7ko,fbPkOYLVPtPgIt0MxizjfFJov3JbHyAi,1,0,0,0,0,0,1,0,1,0.14285714285714285,1,0.0,0,0,0,0,0,0,0,1,0,0,1,1
3560,70819,vjFBv13y086gggICV62EHu0yBgOzNutV,fbPkOYLVPtPgIt0MxizjfFJov3JbHyAi,7,7,2,0,2,0,5,0,16,2.2857142857142856,2,0.0,0,2,0,2,7,0,0,5,0,4,12,1
3561,70827,ldVvKkl14x8Ir8UvT4LavBfHwbFTWxfX,fbPkOYLVPtPgIt0MxizjfFJov3JbHyAi,2,0,0,0,0,0,3,0,3,0.42857142857142855,1,0.0,0,0,0,0,0,0,0,3,0,0,3,1
3562,70834,KVX7Y5dqohnBCFqFu0UMGdbJ0FKj1RGE,fbPkOYLVPtPgIt0MxizjfFJov3JbHyAi,7,2,1,0,1,0,4,0,8,1.1428571428571428,1,0.0,0,1,0,1,2,0,0,4,0,2,6,1
3563,70835,yEUx5EDkSQZ0AERWiDLd07Yf3D0jNmra,fbPkOYLVPtPgIt0MxizjfFJov3JbHyAi,5,2,1,0,1,0,2,0,6,0.8571428571428571,1,0.0,0,1,0,1,2,0,0,2,0,2,4,0
3564,70838,V2oXO5MUVbmMLpm49RH7wP2e7GBuZQIG,fbPkOYLVPtPgIt0MxizjfFJov3JbHyAi,6,5,1,0,1,0,3,0,10,1.4285714285714286,1,0.0,0,1,0,1,5,0,0,3,0,2,8,1
3565,70841,pzZeaYxzJXbuhi5KTdAt0eeAxzLlFc60,fbPkOYLVPtPgIt0MxizjfFJov3JbHyAi,8,17,0,4,1,0,6,0,28,4.0,1,0.0,5,0,3,1,12,0,1,6,0,9,19,1
3566,70843,4Ofl2Ny0Hi8mgxaGCrkktZk3mHl8PQkx,fbPkOYLVPtPgIt0MxizjfFJov3JbHyAi,1,0,0,0,0,0,2,0,2,0.2857142857142857,1,0.0,0,0,0,0,0,0,0,2,0,0,2,1
3567,70844,JKI9pSyEwU7yqpCLpxIR9F4XQMHCp20K,fbPkOYLVPtPgIt0MxizjfFJov3JbHyAi,5,2,1,0,1,0,2,0,6,0.8571428571428571,1,0.0,0,1,0,1,2,0,0,2,0,2,4,1
3568,70848,dizRBkb9QQnO5lOZ4qzzgmJWVuYvCZWl,fbPkOYLVPtPgIt0MxizjfFJov3JbHyAi,1,0,0,0,0,0,1,0,1,0.14285714285714285,1,0.0,0,0,0,0,0,0,0,1,0,0,1,1
3569,70849,rvGeJBDthuxogYD9iVgKqZ9WWdzkhnrb,fbPkOYLVPtPgIt0MxizjfFJov3JbHyAi,1,0,0,0,0,0,1,0,1,0.14285714285714285,1,0.0,0,0,0,0,0,0,0,1,0,0,1,1
3570,70851,aMumXCd09eIRYN1LbGM5nVYZFHRtNPDe,fbPkOYLVPtPgIt0MxizjfFJov3JbHyAi,6,2,1,0,1,0,4,0,8,1.1428571428571428,1,0.0,0,1,0,1,2,0,0,4,0,2,6,1
3571,70852,hgNqBAseHohc9BKsFOMM49J0ufMjGDL5,fbPkOYLVPtPgIt0MxizjfFJov3JbHyAi,4,2,1,0,0,0,2,0,5,0.7142857142857143,1,0.0,0,1,0,0,2,0,0,2,0,1,4,1
3572,70853,t6NWwU4qK3YyLYX7t7fzZJQHw55QhxpE,fbPkOYLVPtPgIt0MxizjfFJov3JbHyAi,10,13,4,7,4,0,4,0,32,4.571428571428571,1,0.0,5,4,5,4,8,0,2,4,0,18,14,1
3573,70856,2ZrkcHnwnE6Pn0A4sJYSZoI8FSiFAo2R,fbPkOYLVPtPgIt0MxizjfFJov3JbHyAi,7,1,1,0,1,1,4,1,9,1.2857142857142858,1,0.0,0,1,0,1,1,1,0,4,1,2,7,1
3574,70857,P4rYy4VFFS1aWSnIl4t3iCnhdV1GUZUL,fbPkOYLVPtPgIt0MxizjfFJov3JbHyAi,5,2,1,0,1,1,3,0,8,1.1428571428571428,1,0.0,0,1,0,1,2,1,0,3,0,2,6,1
3575,70860,gDi6f8yecAtULPjPfuTZCDylLlh4kFrA,fbPkOYLVPtPgIt0MxizjfFJov3JbHyAi,5,2,1,0,1,0,2,0,6,0.8571428571428571,1,0.0,0,1,0,1,2,0,0,2,0,2,4,1
3576,70863,xDc1xgzFSFoS6IiGjf8r0vplCBQSLEw0,fbPkOYLVPtPgIt0MxizjfFJov3JbHyAi,11,9,4,2,4,0,4,0,23,3.2857142857142856,1,0.0,3,4,2,4,6,0,0,4,0,13,10,1
3577,70865,scS3D2DWLKsKrvVVvWQWPPqVUehrWkS1,fbPkOYLVPtPgIt0MxizjfFJov3JbHyAi,1,0,0,0,0,0,1,0,1,0.14285714285714285,1,0.0,0,0,0,0,0,0,0,1,0,0,1,1
3578,70868,9t6TphVDPn8QCqkJMSSSD8suJg54nDg1,fbPkOYLVPtPgIt0MxizjfFJov3JbHyAi,7,3,2,0,2,0,3,0,10,1.4285714285714286,1,0.0,0,2,0,2,3,0,0,3,0,4,6,1
3579,70871,EVZzKo71oTynD4qvlIqI8WHFpHDNDZTk,fbPkOYLVPtPgIt0MxizjfFJov3JbHyAi,8,6,3,0,1,1,4,0,15,2.142857142857143,1,0.0,1,3,0,1,5,1,0,4,0,5,10,0
3580,70873,p9vt4gNfihsixdGiLCuufIHsmW3jvD7a,fbPkOYLVPtPgIt0MxizjfFJov3JbHyAi,1,0,0,0,0,0,1,0,1,0.14285714285714285,1,0.0,0,0,0,0,0,0,0,1,0,0,1,1
3581,70874,0bySEAm2oYtQ2Tleetx3OtzbFfR26iOs,fbPkOYLVPtPgIt0MxizjfFJov3JbHyAi,9,7,5,0,5,0,2,0,19,2.7142857142857144,1,0.0,0,5,0,5,7,0,0,2,0,10,9,1
3582,70878,JJ6wlXEIablDydF4jOHDhv4TjKDeXQan,fbPkOYLVPtPgIt0MxizjfFJov3JbHyAi,7,7,2,0,3,0,2,0,14,2.0,1,0.0,4,2,0,3,3,0,0,2,0,9,5,1
3583,70879,4OTqFMCZxx7r7u5a2qYtSI5NaNF7PvO8,fbPkOYLVPtPgIt0MxizjfFJov3JbHyAi,8,4,3,0,3,0,1,0,11,1.5714285714285714,1,0.0,0,3,0,3,4,0,0,1,0,6,5,1
3584,70880,K8EiUmRs9Nq0Qj4O9mjSk5qQn6E6D5cj,fbPkOYLVPtPgIt0MxizjfFJov3JbHyAi,5,2,1,0,1,0,2,0,6,0.8571428571428571,1,0.0,0,1,0,1,2,0,0,2,0,2,4,1
3585,70881,sOSUJ9Hzn8EsMXvSoMXyqd2CJLKFDkw3,fbPkOYLVPtPgIt0MxizjfFJov3JbHyAi,1,0,0,0,0,0,1,0,1,0.14285714285714285,1,0.0,0,0,0,0,0,0,0,1,0,0,1,1
3586,70882,XluaP5TPFhLRlajx7bmLwFy9eBFAVswr,fbPkOYLVPtPgIt0MxizjfFJov3JbHyAi,1,0,0,0,0,0,1,0,1,0.14285714285714285,1,0.0,0,0,0,0,0,0,0,1,0,0,1,1
3587,70883,NeDoKNVSKD8Aiq0pOti0J4aVmpnS5aEL,fbPkOYLVPtPgIt0MxizjfFJov3JbHyAi,7,7,2,0,3,0,7,0,19,2.7142857142857144,1,0.0,2,2,0,3,5,0,0,7,0,7,12,1
3588,70886,8p7u7RxFna6sXuG4TtD3bPfcMY9zmEQb,fbPkOYLVPtPgIt0MxizjfFJov3JbHyAi,5,2,1,0,1,0,4,0,8,1.1428571428571428,1,0.0,0,1,0,1,2,0,0,4,0,2,6,1
3589,70887,JROXjwvC9rxe26lrQwNHzIbtlVSWvibf,fbPkOYLVPtPgIt0MxizjfFJov3JbHyAi,5,3,1,0,1,0,2,0,7,1.0,1,0.0,0,1,0,1,3,0,0,2,0,2,5,1
3590,70890,4G4NYV5HdrqJgMd8tHZhlgK9Wwk62py3,fbPkOYLVPtPgIt0MxizjfFJov3JbHyAi,1,0,0,0,0,0,1,0,1,0.14285714285714285,1,0.0,0,0,0,0,0,0,0,1,0,0,1,1
3591,70892,kITorNxbn0jKRrU5oeVoAkoKxKssAebK,fbPkOYLVPtPgIt0MxizjfFJov3JbHyAi,7,5,2,0,3,0,2,0,12,1.7142857142857142,1,0.0,2,2,0,3,3,0,0,2,0,7,5,1
3592,70893,RMMuFeZ2nCFjdFF7Br5oAsh68xDnP2Kt,fbPkOYLVPtPgIt0MxizjfFJov3JbHyAi,2,0,0,0,0,0,2,0,2,0.2857142857142857,1,0.0,0,0,0,0,0,0,0,2,0,0,2,1
3593,70895,iAXqLonwJtIlRlvnGYLtu7A6G32sN6pK,fbPkOYLVPtPgIt0MxizjfFJov3JbHyAi,2,0,0,0,0,0,2,0,2,0.2857142857142857,1,0.0,0,0,0,0,0,0,0,2,0,0,2,1
3594,70900,w5Nz5FF2iacISxkk1j18hYO33XJu5f6u,fbPkOYLVPtPgIt0MxizjfFJov3JbHyAi,2,0,0,0,0,0,2,0,2,0.2857142857142857,1,0.0,0,0,0,0,0,0,0,2,0,0,2,1
3595,70901,5Sdd90y9f6G1O01oh8dNylP38h97ZkQP,fbPkOYLVPtPgIt0MxizjfFJov3JbHyAi,5,2,1,0,1,0,2,0,6,0.8571428571428571,1,0.0,0,1,0,1,2,0,0,2,0,2,4,1
3596,70928,iem7aobLjfwmsInz2aJm33FyllmcOoxM,SpATywNh6bZuzm8s1ceuBUnMUAeoAHHw,11,22,4,0,0,6,18,2,52,7.428571428571429,4,0.0,1,4,0,0,21,6,0,18,2,5,47,1
3597,70935,JiFgudQA4nZtHR8rdanNuKW7boGcferp,SpATywNh6bZuzm8s1ceuBUnMUAeoAHHw,15,22,10,17,7,0,4,0,60,8.571428571428571,2,0.0,8,10,16,7,14,0,1,4,0,41,19,1
3598,70936,u2D7DEFYPnV7TgAwmWCf915LuQlPziwx,SpATywNh6bZuzm8s1ceuBUnMUAeoAHHw,1,0,0,0,0,0,1,0,1,0.14285714285714285,1,0.0,0,0,0,0,0,0,0,1,0,0,1,1
3599,70966,USLTnsAwagwK2c83KXd1SNEeENnzkTTo,SpATywNh6bZuzm8s1ceuBUnMUAeoAHHw,1,0,0,0,0,0,2,0,2,0.2857142857142857,1,0.0,0,0,0,0,0,0,0,2,0,0,2,1
3600,70971,1GwCcPnawuwjaFyAi38hoJxQ9NHTHcHa,A3fsA9Zfv1X2fVEQhTw51lKENdNrEqT3,6,2,1,0,0,0,8,0,11,1.5714285714285714,1,0.0,0,1,0,0,2,0,0,8,0,1,10,1
3601,71007,ah7dn7oeJ2Zo8NzKmljnoEEVEzPzQawZ,A3fsA9Zfv1X2fVEQhTw51lKENdNrEqT3,10,13,5,0,2,1,7,0,28,4.0,2,0.0,0,5,0,2,13,1,0,7,0,7,21,1
3602,71008,l5FaUWasiv60gSjMCgxRDYxpxpwnBW6p,SpATywNh6bZuzm8s1ceuBUnMUAeoAHHw,13,10,5,2,3,0,3,0,23,3.2857142857142856,1,0.0,0,5,2,3,10,0,0,3,0,10,13,1
3603,71009,CKlApvgsp3P7WP3VG5px4QWIpk803niH,A3fsA9Zfv1X2fVEQhTw51lKENdNrEqT3,5,0,0,0,0,0,6,3,9,1.2857142857142858,1,0.0,0,0,0,0,0,0,0,6,3,0,9,1
3604,71012,2UIdqPRKpgTkXkubY12P5suWz65Jis6l,SpATywNh6bZuzm8s1ceuBUnMUAeoAHHw,9,18,10,0,2,0,7,1,38,5.428571428571429,2,0.0,2,10,0,2,16,0,0,7,1,14,24,1
3605,71017,QjbLQSoFVavd6LHLH5XtUy4x4q9nhmtF,SpATywNh6bZuzm8s1ceuBUnMUAeoAHHw,15,9,8,0,7,0,1,0,25,3.5714285714285716,1,0.0,0,8,0,7,9,0,0,1,0,15,10,0
3606,71084,PehZ8w7lhwueNJQVLn4O4a5DjlM7RVHJ,A3fsA9Zfv1X2fVEQhTw51lKENdNrEqT3,77,39,18,204,13,0,5,0,279,39.857142857142854,2,0.0,3,18,177,13,36,0,27,5,0,211,68,1
3607,71089,bOlBfDLwRlFztzXeRI7M3tpbHNy8C56c,SpATywNh6bZuzm8s1ceuBUnMUAeoAHHw,16,25,0,23,0,14,5,0,67,9.571428571428571,1,0.0,5,0,19,0,20,14,4,5,0,24,43,1
3608,71104,zxmge3ZElgX2vkJ2cCOzkeMQCnk45k6Y,G8EPVSXsOYB5YQWZGiz1aVq5Pgr2GrQu,4,7,4,0,0,0,3,0,14,2.0,3,0.0,0,4,0,0,7,0,0,3,0,4,10,1
3609,71106,8IMVGvB09WRKHeXEjWGkZOVu6CXmlVXA,A3fsA9Zfv1X2fVEQhTw51lKENdNrEqT3,1,0,0,0,0,0,1,0,1,0.14285714285714285,1,0.0,0,0,0,0,0,0,0,1,0,0,1,1
3610,71110,D5E2Qt7jBeIZBIFcDabwhaaXeayXbs8U,bWdj2GDclj5ofokWjzoa5jAwMkxCykd6,4,5,2,0,0,0,4,0,11,1.5714285714285714,2,0.0,0,2,0,0,5,0,0,4,0,2,9,1
3611,71116,gMihFFRgCbvgH3cTGh2cgQ4GULLM91Yq,SpATywNh6bZuzm8s1ceuBUnMUAeoAHHw,20,29,3,6,2,4,8,1,53,7.571428571428571,2,0.0,5,3,6,2,24,4,0,8,1,16,37,0
3612,71139,loLM1q927UBCE6cjZ1Vielkh2VBpufUl,A3fsA9Zfv1X2fVEQhTw51lKENdNrEqT3,39,27,25,0,21,0,4,0,77,11.0,1,0.0,0,25,0,21,27,0,0,4,0,46,31,1
3613,71140,loLM1q927UBCE6cjZ1Vielkh2VBpufUl,SpATywNh6bZuzm8s1ceuBUnMUAeoAHHw,19,12,11,0,9,0,3,0,35,5.0,1,0.0,0,11,0,9,12,0,0,3,0,20,15,1
3614,71162,FixP7IuJ80KsWtzMzcQsJZKOjLxDKZgC,G8EPVSXsOYB5YQWZGiz1aVq5Pgr2GrQu,1,0,0,0,0,0,1,0,1,0.14285714285714285,1,0.0,0,0,0,0,0,0,0,1,0,0,1,1
3615,71180,6zXGZtvwHnFZCYFcS3Xzk5yrVH7CXdoJ,bWdj2GDclj5ofokWjzoa5jAwMkxCykd6,7,4,2,4,0,0,2,0,12,1.7142857142857142,1,0.0,1,2,4,0,3,0,0,2,0,7,5,0
3616,71197,5PZBmKEXGmnHhrok7M9vaGB06CAzFVOO,A3fsA9Zfv1X2fVEQhTw51lKENdNrEqT3,68,35,16,126,14,0,4,0,195,27.857142857142858,2,0.0,4,16,109,14,31,0,17,4,0,143,52,0
3617,71204,SEiRJIrKqIUXJc6AKB5rH8Do4LEjJRIR,SpATywNh6bZuzm8s1ceuBUnMUAeoAHHw,8,4,3,0,2,0,2,0,11,1.5714285714285714,1,0.0,0,3,0,2,4,0,0,2,0,5,6,1
3618,71227,HieJch2LMldZteUgpMFf3KIoNYB4ohUW,RXDvfPUBYFlVdlueBFbLW0mhhAyGEqpt,5,2,1,0,1,0,2,0,6,0.8571428571428571,1,0.0,0,1,0,1,2,0,0,2,0,2,4,0
3619,71233,OYKjrPxX9BZcmbpGQNe0saEMxsDF2LNu,SpATywNh6bZuzm8s1ceuBUnMUAeoAHHw,1,0,0,0,0,0,1,0,1,0.14285714285714285,1,0.0,0,0,0,0,0,0,0,1,0,0,1,1
3620,71277,ZzEeIm98vbP9lRunZYePLW46UyhiVxbR,bWdj2GDclj5ofokWjzoa5jAwMkxCykd6,5,8,3,0,1,0,3,0,15,2.142857142857143,2,0.0,0,3,0,1,8,0,0,3,0,4,11,1
3621,71279,YYCI1ivPCDRa3x25VBUTnS1EqXk51k7P,A3fsA9Zfv1X2fVEQhTw51lKENdNrEqT3,44,29,21,70,11,11,10,1,153,21.857142857142858,3,0.0,2,21,60,11,27,11,10,10,1,94,59,1
3622,71280,YUT6CW7iSh1xoUpF2nfmR8w0ThlxeIYe,SpATywNh6bZuzm8s1ceuBUnMUAeoAHHw,14,15,0,26,0,0,5,0,46,6.571428571428571,3,0.0,6,0,21,0,9,0,5,5,0,27,19,0
3623,71288,ynZwxbnEbKW0W9hd646CFEVp0hOxydow,SpATywNh6bZuzm8s1ceuBUnMUAeoAHHw,24,25,11,30,6,0,4,0,76,10.857142857142858,2,0.0,13,11,27,6,12,0,3,4,0,57,19,0
3624,71302,xNhIay3NLh7QqL0JWfWBdzb4B9nitBX9,G8EPVSXsOYB5YQWZGiz1aVq5Pgr2GrQu,5,2,1,0,1,0,2,0,6,0.8571428571428571,1,0.0,0,1,0,1,2,0,0,2,0,2,4,0
3625,71309,04MTc9DP7u70zt8WMvntZYPfTFQUHhtX,SpATywNh6bZuzm8s1ceuBUnMUAeoAHHw,2,0,0,0,0,0,3,0,3,0.42857142857142855,2,0.0,0,0,0,0,0,0,0,3,0,0,3,0
3626,71318,bOlBfDLwRlFztzXeRI7M3tpbHNy8C56c,bWdj2GDclj5ofokWjzoa5jAwMkxCykd6,5,2,1,0,1,0,2,0,6,0.8571428571428571,1,0.0,0,1,0,1,2,0,0,2,0,2,4,1
3627,71358,WfFzDu02yVQhznDpti9qz88KkaHNMAz5,SpATywNh6bZuzm8s1ceuBUnMUAeoAHHw,14,9,7,0,7,0,16,0,39,5.571428571428571,6,0.0,0,7,0,7,9,0,0,16,0,14,25,1
3628,71361,fnAQHOrM0aOC0GQVDcBG5sVn1wNxVUAt,SpATywNh6bZuzm8s1ceuBUnMUAeoAHHw,29,24,15,12,7,1,4,0,63,9.0,2,0.0,5,15,12,7,19,1,0,4,0,39,24,0
3629,71373,oNf6qoW6E6dhoPJKSUjvElFlUKN9drLY,G8EPVSXsOYB5YQWZGiz1aVq5Pgr2GrQu,5,12,3,0,4,0,3,0,22,3.142857142857143,2,0.0,7,3,0,4,5,0,0,3,0,14,8,1
3630,71404,hKHtoNLNdXjroo5MBUJPMKLH6p5UkRTG,SpATywNh6bZuzm8s1ceuBUnMUAeoAHHw,8,5,1,0,0,1,6,1,14,2.0,1,0.0,0,1,0,0,5,1,0,6,1,1,13,1
3631,71421,5Ls9Y8mfUb8JgZfSWkF8kDMEq3gGISZD,G8EPVSXsOYB5YQWZGiz1aVq5Pgr2GrQu,6,5,1,0,1,0,4,0,11,1.5714285714285714,1,0.0,0,1,0,1,5,0,0,4,0,2,9,1
3632,71426,onsmNYIoPFEi185f5ZLsQXD70I3K25Cb,bWdj2GDclj5ofokWjzoa5jAwMkxCykd6,7,14,2,16,1,0,3,0,36,5.142857142857143,2,0.0,6,2,15,1,8,0,1,3,0,24,12,1
3633,71558,nqvxWBh8RMlOMSpTtlC0WlRIvQffkk6Q,SpATywNh6bZuzm8s1ceuBUnMUAeoAHHw,26,22,15,16,12,1,7,0,73,10.428571428571429,1,0.0,5,15,16,12,17,1,0,7,0,48,25,0
3634,71562,6yNhQyEbKEsWZJAOZYhGdgOd9YcNxjUf,G8EPVSXsOYB5YQWZGiz1aVq5Pgr2GrQu,1,0,0,0,0,0,1,0,1,0.14285714285714285,1,0.0,0,0,0,0,0,0,0,1,0,0,1,1
3635,71579,01fFtDlb7q6YVhWJvhsOvwQMPs8xw65f,A3fsA9Zfv1X2fVEQhTw51lKENdNrEqT3,1,0,0,0,0,0,1,0,1,0.14285714285714285,1,0.0,0,0,0,0,0,0,0,1,0,0,1,1
3636,71586,DgIUsdyZ2bZRmyXrVqC2xYLKsZlQY2uf,SpATywNh6bZuzm8s1ceuBUnMUAeoAHHw,11,10,1,3,1,0,3,0,18,2.5714285714285716,2,0.0,0,1,3,1,10,0,0,3,0,5,13,1
3637,71593,EU6hvCkOpmY7eHAp1iULlNAf6vTYfvA3,G8EPVSXsOYB5YQWZGiz1aVq5Pgr2GrQu,1,0,0,0,0,0,1,0,1,0.14285714285714285,1,0.0,0,0,0,0,0,0,0,1,0,0,1,1
3638,71594,gIXV45WkMOjKV6SvlgkVrQlYJRphcrVX,A3fsA9Zfv1X2fVEQhTw51lKENdNrEqT3,8,4,3,0,3,0,1,0,11,1.5714285714285714,1,0.0,0,3,0,3,4,0,0,1,0,6,5,1
3639,71601,jsJkZlRrCs7XDDe36sdBTD1SNVw3QiEY,SpATywNh6bZuzm8s1ceuBUnMUAeoAHHw,4,0,0,0,0,0,4,0,4,0.5714285714285714,2,0.0,0,0,0,0,0,0,0,4,0,0,4,0
3640,71611,KWdhtnEkrke9rgi3l1csNclNjZVhn1s4,SpATywNh6bZuzm8s1ceuBUnMUAeoAHHw,20,133,5,17,0,58,42,15,270,38.57142857142857,9,0.0,4,5,14,0,129,58,3,42,15,23,247,1
3641,71634,ojqn4pgOfPG4Pc3ke3CSjZ4IF82Cz5Gt,SpATywNh6bZuzm8s1ceuBUnMUAeoAHHw,3,2,0,0,0,0,1,0,3,0.42857142857142855,1,0.0,0,0,0,0,2,0,0,1,0,0,3,1
3642,71670,AqzJls3OFl2nFap48g5Tia0Yo0Y7Cer3,G8EPVSXsOYB5YQWZGiz1aVq5Pgr2GrQu,7,8,2,0,3,0,3,0,16,2.2857142857142856,1,0.0,2,2,0,3,6,0,0,3,0,7,9,1
3643,71711,NwQCoUHJKyAdqdG7U0utXO1oyZsmr8V3,bWdj2GDclj5ofokWjzoa5jAwMkxCykd6,1,0,0,0,0,0,1,0,1,0.14285714285714285,1,0.0,0,0,0,0,0,0,0,1,0,0,1,1
3644,71754,MwsjD881hF2KUCEG3rXUPSq3GKMfMo2d,A3fsA9Zfv1X2fVEQhTw51lKENdNrEqT3,7,4,2,0,1,0,5,0,12,1.7142857142857142,1,0.0,0,2,0,1,4,0,0,5,0,3,9,0
3645,71759,foGsrANktd6dCLnplglYgW0LYGi2yeuV,bWdj2GDclj5ofokWjzoa5jAwMkxCykd6,8,6,3,8,1,0,5,0,23,3.2857142857142856,2,0.0,0,3,7,1,6,0,1,5,0,11,12,1
3646,71809,3VdXvjSQZjkmaMxk7jVlpKzQwHK0VW6h,RXDvfPUBYFlVdlueBFbLW0mhhAyGEqpt,1,0,0,0,0,0,1,0,1,0.14285714285714285,1,0.0,0,0,0,0,0,0,0,1,0,0,1,0
3647,71829,n1JdH8HPXOUoCHQIEd4YCo0nlAshsKdG,SpATywNh6bZuzm8s1ceuBUnMUAeoAHHw,31,32,19,33,8,4,17,2,115,16.428571428571427,5,0.0,6,19,29,8,26,4,4,17,2,62,53,0
3648,71836,BVpzzXeXh42vyU3wE9rUQpEUs8P1ZpSo,SpATywNh6bZuzm8s1ceuBUnMUAeoAHHw,6,6,4,4,0,0,2,0,16,2.2857142857142856,1,0.0,1,4,3,0,5,0,1,2,0,8,8,0
3649,71843,TtktJZVgpwig0r3gUw8lQnr2rEFBADhH,G8EPVSXsOYB5YQWZGiz1aVq5Pgr2GrQu,6,9,3,0,2,0,2,0,16,2.2857142857142856,1,0.0,5,3,0,2,4,0,0,2,0,10,6,1
3650,71860,kTJIJds7bRsw0KFlLhCoB2PivF66Tf3q,A3fsA9Zfv1X2fVEQhTw51lKENdNrEqT3,39,25,20,50,14,0,8,1,118,16.857142857142858,3,0.0,0,20,44,14,25,0,6,8,1,78,40,1
3651,71865,nvXkSuJjNwPy4x4PN83PXogIa9iXtJsm,A3fsA9Zfv1X2fVEQhTw51lKENdNrEqT3,27,20,15,0,12,6,10,0,63,9.0,3,0.0,1,15,0,12,19,6,0,10,0,28,35,1
3652,71871,xyDv5uzKguLKwuLAtjs5magaAGWqhgm8,A3fsA9Zfv1X2fVEQhTw51lKENdNrEqT3,5,4,0,0,0,0,4,0,8,1.1428571428571428,1,0.0,0,0,0,0,4,0,0,4,0,0,8,0
3653,71872,pxwAvlbOFGjXMz981vvB3RuwcS56iZNF,SpATywNh6bZuzm8s1ceuBUnMUAeoAHHw,1,0,0,0,0,0,1,0,1,0.14285714285714285,1,0.0,0,0,0,0,0,0,0,1,0,0,1,1
3654,71892,AimQk6bFhhGPpMH9HY88V7PvSxxOwe07,SpATywNh6bZuzm8s1ceuBUnMUAeoAHHw,7,3,1,0,1,0,4,0,9,1.2857142857142858,2,0.0,0,1,0,1,3,0,0,4,0,2,7,1
3655,71928,z9s7UAFfwXliVd2GScbNHLyqLTBO7649,SpATywNh6bZuzm8s1ceuBUnMUAeoAHHw,6,3,1,0,1,0,2,0,7,1.0,1,0.0,0,1,0,1,3,0,0,2,0,2,5,1
3656,71961,LyDM0yrwn8zKtQsuxEGqFMxdhffaZNVY,A3fsA9Zfv1X2fVEQhTw51lKENdNrEqT3,11,19,2,0,2,0,8,1,32,4.571428571428571,2,0.0,1,2,0,2,18,0,0,8,1,5,27,1
3657,71962,Gq7C34w2v5h08r5B2E14BoawNOpfmfl0,SpATywNh6bZuzm8s1ceuBUnMUAeoAHHw,4,2,1,0,1,0,1,0,5,0.7142857142857143,1,0.0,0,1,0,1,2,0,0,1,0,2,3,1
3658,71999,Pe5WMotTf5HMq3hNpICq7pbnjQeqT1z5,SpATywNh6bZuzm8s1ceuBUnMUAeoAHHw,28,40,22,18,11,15,10,0,116,16.571428571428573,6,0.0,11,22,15,11,29,15,3,10,0,59,57,0
3659,72014,KL9U9geosSonjO9r5P2YyGdv6jdUGAmi,SpATywNh6bZuzm8s1ceuBUnMUAeoAHHw,5,2,1,0,1,0,2,0,6,0.8571428571428571,1,0.0,0,1,0,1,2,0,0,2,0,2,4,1
3660,72071,7gwAY8GKvsU7xwUilNpzEOAvbLd2D9r9,A3fsA9Zfv1X2fVEQhTw51lKENdNrEqT3,1,0,0,0,0,0,1,0,1,0.14285714285714285,1,0.0,0,0,0,0,0,0,0,1,0,0,1,1
3661,72086,0LMHRy44jwjr4gUThAzfzfGCUeg2Lm1J,SpATywNh6bZuzm8s1ceuBUnMUAeoAHHw,19,50,28,17,10,67,17,0,189,27.0,4,0.0,11,28,14,10,39,67,3,17,0,63,126,1
3662,72092,bLIF0ETNcg7fjkutu8YBWJptM3zxtu2Z,bWdj2GDclj5ofokWjzoa5jAwMkxCykd6,12,10,8,0,7,0,7,0,32,4.571428571428571,2,0.0,2,8,0,7,8,0,0,7,0,17,15,0
3663,72114,UuK4SgZkmPrFxeH0ZPCRQ63pVXUSe96N,bWdj2GDclj5ofokWjzoa5jAwMkxCykd6,1,0,0,0,0,0,1,0,1,0.14285714285714285,1,0.0,0,0,0,0,0,0,0,1,0,0,1,1
3664,72116,QeJMYd11is6DqiF8uVkla2ZwnHb26tuu,RXDvfPUBYFlVdlueBFbLW0mhhAyGEqpt,13,15,1,0,1,0,5,0,22,3.142857142857143,3,0.0,3,1,0,1,12,0,0,5,0,5,17,0
3665,72120,a8HvMkBRr1QnoDxivZVIhrkeiZFWplka,A3fsA9Zfv1X2fVEQhTw51lKENdNrEqT3,32,28,15,72,8,0,9,0,132,18.857142857142858,4,0.0,5,15,56,8,23,0,16,9,0,84,48,1
3666,72128,6oNhI3z3lPtYcSpGC1lnWpyyeDMBUOtK,SpATywNh6bZuzm8s1ceuBUnMUAeoAHHw,6,8,4,0,1,0,8,0,21,3.0,3,0.0,0,4,0,1,8,0,0,8,0,5,16,1
3667,72133,2qQuu2Qhkw7hRYngnGfnNzXYklrDkMwy,SpATywNh6bZuzm8s1ceuBUnMUAeoAHHw,17,31,6,20,4,0,9,0,70,10.0,6,0.0,5,6,17,4,26,0,3,9,0,32,38,1
3668,72150,dDLv4oouOmVB45Y4hnRyV7IUqT7tMKiq,A3fsA9Zfv1X2fVEQhTw51lKENdNrEqT3,63,54,36,100,21,12,20,2,245,35.0,4,0.0,6,36,81,21,48,12,19,20,2,144,101,0
3669,72158,kiNfuRpgeROReVuBtap1KwDDZc9hG55i,A3fsA9Zfv1X2fVEQhTw51lKENdNrEqT3,10,6,2,0,1,0,7,1,17,2.4285714285714284,2,0.0,0,2,0,1,6,0,0,7,1,3,14,1
3670,72169,Lb7wmhbhC16FSS5Xq3dqazq7PwTHyvZu,bWdj2GDclj5ofokWjzoa5jAwMkxCykd6,6,7,4,0,2,0,3,0,16,2.2857142857142856,2,0.0,0,4,0,2,7,0,0,3,0,6,10,1
3671,72173,yS4hKsLzPsdj6M1qMcvQzXXEbCXgtzUx,bWdj2GDclj5ofokWjzoa5jAwMkxCykd6,2,0,0,0,0,0,2,0,2,0.2857142857142857,1,0.0,0,0,0,0,0,0,0,2,0,0,2,1
3672,72222,Fdt86Xu5OLPdaOgl6M1XDpiJ3zar7SU6,RXDvfPUBYFlVdlueBFbLW0mhhAyGEqpt,23,17,11,38,7,1,6,1,81,11.571428571428571,2,0.0,3,11,30,7,14,1,8,6,1,51,30,1
3673,72255,H9uyY7qx5i6ZDOUonFHaANKxCA5aZsQi,G8EPVSXsOYB5YQWZGiz1aVq5Pgr2GrQu,27,31,3,52,4,0,9,0,99,14.142857142857142,3,0.0,12,3,42,4,19,0,10,9,0,61,38,1
3674,72259,tzUG2qRl7N6mPYRCQUU2RS3J3hIQZLrD,A3fsA9Zfv1X2fVEQhTw51lKENdNrEqT3,4,2,1,0,1,0,1,0,5,0.7142857142857143,1,0.0,0,1,0,1,2,0,0,1,0,2,3,1
3675,72271,VCY6PHshXOjPWWfmo1l8Uf1lH1o7rZ3R,A3fsA9Zfv1X2fVEQhTw51lKENdNrEqT3,17,13,9,0,5,0,6,0,33,4.714285714285714,2,0.0,0,9,0,5,13,0,0,6,0,14,19,1
3676,72280,Daw06K1PSOXldo19kBgHP5sewulb7Vu5,RXDvfPUBYFlVdlueBFbLW0mhhAyGEqpt,59,119,4,172,6,86,9,2,398,56.857142857142854,3,0.0,16,4,160,6,103,86,12,9,2,186,212,1
3677,72303,hrPjKcL9rUfM1fnC8qta4lu2HmlsBLv6,RXDvfPUBYFlVdlueBFbLW0mhhAyGEqpt,28,49,13,24,7,0,22,0,115,16.428571428571427,3,0.0,14,13,22,7,35,0,2,22,0,56,59,0
3678,72333,uqA5Smdw6BACOcL0f2tmxwTTxZXBpZpE,bWdj2GDclj5ofokWjzoa5jAwMkxCykd6,5,5,3,0,2,0,2,0,12,1.7142857142857142,2,0.0,0,3,0,2,5,0,0,2,0,5,7,1
3679,72350,axVh7TT3ftc0JLvNMlUvTGTAABKlThNj,A3fsA9Zfv1X2fVEQhTw51lKENdNrEqT3,17,24,4,0,3,0,8,0,39,5.571428571428571,2,0.0,0,4,0,3,24,0,0,8,0,7,32,1
3680,72378,dQa6sgmVY94byuB0fCTjymlGLIKJnAZ4,RXDvfPUBYFlVdlueBFbLW0mhhAyGEqpt,11,10,6,0,5,0,3,0,24,3.4285714285714284,1,0.0,1,6,0,5,9,0,0,3,0,12,12,1
3681,72389,1WzAMExdp2DcGRBAFaFF5ZvQSa9V2NEI,SpATywNh6bZuzm8s1ceuBUnMUAeoAHHw,5,2,1,0,1,0,2,0,6,0.8571428571428571,1,0.0,0,1,0,1,2,0,0,2,0,2,4,1
3682,72390,L6W8jpUrnYiTQTQzsQIQrX6pgKIdMfa4,SpATywNh6bZuzm8s1ceuBUnMUAeoAHHw,13,18,10,4,3,0,7,0,42,6.0,3,0.0,0,10,4,3,18,0,0,7,0,17,25,1
3683,72392,dQQ8UnfzoKHmhQlZOaaW0cB14DhE2hvY,A3fsA9Zfv1X2fVEQhTw51lKENdNrEqT3,41,56,1,68,0,6,9,0,140,20.0,4,0.0,6,1,59,0,50,6,9,9,0,66,74,0
3684,72455,tAelht5FQdpcbtZQoKgvZA90XQy6zeRb,RXDvfPUBYFlVdlueBFbLW0mhhAyGEqpt,12,17,1,0,1,4,3,4,30,4.285714285714286,2,0.0,3,1,0,1,14,4,0,3,4,5,25,1
3685,72456,IP3TW53lg1ZMqNldZdGWMD6MaLDRhhOf,SpATywNh6bZuzm8s1ceuBUnMUAeoAHHw,16,13,8,15,4,0,4,0,44,6.285714285714286,3,0.0,2,8,14,4,11,0,1,4,0,28,16,1
3686,72476,gpgk1aIkjyvlgo7OYZtMXPlVgE39gvnr,SpATywNh6bZuzm8s1ceuBUnMUAeoAHHw,31,66,31,26,13,4,17,1,158,22.571428571428573,5,0.0,23,31,23,13,43,4,3,17,1,90,68,0
3687,72500,yYXy4lOleg47AQUxi7o5Lu77Hx9q6unU,bWdj2GDclj5ofokWjzoa5jAwMkxCykd6,5,3,2,0,1,1,2,0,9,1.2857142857142858,1,0.0,0,2,0,1,3,1,0,2,0,3,6,1
3688,72533,kPw5nR6GIfIGfnUDhfrz9sq3P6l2CmOK,RXDvfPUBYFlVdlueBFbLW0mhhAyGEqpt,21,42,26,16,12,14,9,0,119,17.0,6,0.0,5,26,14,12,37,14,2,9,0,57,62,1
3689,72536,j8vYdYwa9gvt7hkF8dykZR2D4h75QsII,G8EPVSXsOYB5YQWZGiz1aVq5Pgr2GrQu,9,7,5,0,3,0,4,0,19,2.7142857142857144,1,0.0,0,5,0,3,7,0,0,4,0,8,11,1
3690,72537,jjKgBLfKr1bgWBjonayzbZy5XgTBUiEC,G8EPVSXsOYB5YQWZGiz1aVq5Pgr2GrQu,5,2,1,0,1,0,3,0,7,1.0,1,0.0,0,1,0,1,2,0,0,3,0,2,5,1
3691,72560,9czpFwHJ3FpE9rgLseKKVivLeSQjwoKI,SpATywNh6bZuzm8s1ceuBUnMUAeoAHHw,5,5,2,0,2,0,1,0,10,1.4285714285714286,1,0.0,0,2,0,2,5,0,0,1,0,4,6,1
3692,72564,R5b7anZZznZcISIbyICZwboB1D1ac57s,SpATywNh6bZuzm8s1ceuBUnMUAeoAHHw,6,3,1,0,0,0,4,0,8,1.1428571428571428,2,0.0,0,1,0,0,3,0,0,4,0,1,7,1
3693,72572,2QSRX6tWhC0oLYllnKUwIH2KIoHl3tDb,SpATywNh6bZuzm8s1ceuBUnMUAeoAHHw,22,33,0,23,0,0,4,0,60,8.571428571428571,2,0.0,13,0,18,0,20,0,5,4,0,31,29,1
3694,72592,yYXy4lOleg47AQUxi7o5Lu77Hx9q6unU,G8EPVSXsOYB5YQWZGiz1aVq5Pgr2GrQu,1,0,0,0,0,0,1,0,1,0.14285714285714285,1,0.0,0,0,0,0,0,0,0,1,0,0,1,1
3695,72621,RDShgnILA5yAnXM7kXsfq5adI49HPdeC,A3fsA9Zfv1X2fVEQhTw51lKENdNrEqT3,5,4,0,0,0,0,3,0,7,1.0,2,0.0,0,0,0,0,4,0,0,3,0,0,7,1
3696,72649,rPY59o3LLmGBPTPMGcA5vX57KVfmywv5,A3fsA9Zfv1X2fVEQhTw51lKENdNrEqT3,7,8,1,0,0,2,8,1,20,2.857142857142857,2,0.0,0,1,0,0,8,2,0,8,1,1,19,1
3697,72667,9FaPBbsYKn0C9myyRYf9vYNhns2eJDpD,A3fsA9Zfv1X2fVEQhTw51lKENdNrEqT3,16,35,16,0,13,0,6,0,70,10.0,4,0.0,0,16,0,13,35,0,0,6,0,29,41,1
3698,72686,JoqAGqbao71wc04PyVzx7SVvlZZ0knbI,A3fsA9Zfv1X2fVEQhTw51lKENdNrEqT3,51,39,17,116,3,40,13,0,228,32.57142857142857,7,0.0,4,17,115,3,35,40,1,13,0,139,89,0
3699,72758,IU4mzAYv3AON3EBKGRzZhQZqrR0hM5uu,SpATywNh6bZuzm8s1ceuBUnMUAeoAHHw,16,19,11,14,8,22,7,0,81,11.571428571428571,4,0.0,4,11,13,8,15,22,1,7,0,36,45,1
3700,72762,Sn4V2T6RAiQ47UvRCtMkFCdxnmF36LZI,SpATywNh6bZuzm8s1ceuBUnMUAeoAHHw,1,0,0,0,0,0,1,0,1,0.14285714285714285,1,0.0,0,0,0,0,0,0,0,1,0,0,1,1
3701,72765,pHhp9CI7VmM6wgR3zr0LKfyfj9hb4ctX,SpATywNh6bZuzm8s1ceuBUnMUAeoAHHw,5,2,0,0,0,1,4,0,7,1.0,1,0.0,0,0,0,0,2,1,0,4,0,0,7,1
3702,72780,DLQjQ8KI2pm8VfJepKRqQrT7eYq3mD8r,RXDvfPUBYFlVdlueBFbLW0mhhAyGEqpt,30,38,27,0,16,2,10,1,94,13.428571428571429,3,0.0,7,27,0,16,31,2,0,10,1,50,44,0
3703,72812,xgPoMcAyqtOnl7aMAll1Vnr6k8ioz2It,SpATywNh6bZuzm8s1ceuBUnMUAeoAHHw,1,0,0,0,0,0,2,0,2,0.2857142857142857,1,0.0,0,0,0,0,0,0,0,2,0,0,2,1
3704,72815,OvxL2ijquKYfjNqaOR5I9ilNOVFLo0dG,A3fsA9Zfv1X2fVEQhTw51lKENdNrEqT3,2,0,0,0,0,0,4,0,4,0.5714285714285714,1,0.0,0,0,0,0,0,0,0,4,0,0,4,1
3705,72838,JLIulwgtbPcmpwL3Ibb9AniYS6ncpOrp,A3fsA9Zfv1X2fVEQhTw51lKENdNrEqT3,5,0,0,0,0,1,7,0,8,1.1428571428571428,1,0.0,0,0,0,0,0,1,0,7,0,0,8,1
3706,72848,pQdSl7i5ZuZeH9uPILgdHrvwskp4vc4V,bWdj2GDclj5ofokWjzoa5jAwMkxCykd6,8,6,4,0,3,4,4,0,21,3.0,3,0.0,0,4,0,3,6,4,0,4,0,7,14,1
3707,72871,3z37iBp19kh1LYVfVTprpt7Nc7WFUSh9,A3fsA9Zfv1X2fVEQhTw51lKENdNrEqT3,23,21,19,0,2,0,4,0,46,6.571428571428571,2,0.0,0,19,0,2,21,0,0,4,0,21,25,1
3708,72904,BaoTOxDWhvejgHTi1F9XwMHc0M9R5At7,SpATywNh6bZuzm8s1ceuBUnMUAeoAHHw,6,1,1,0,1,0,3,0,6,0.8571428571428571,1,0.0,0,1,0,1,1,0,0,3,0,2,4,1
3709,72936,oIV4CHUFSVzLmdvea6ZMZ3tpsiIb8a2U,RXDvfPUBYFlVdlueBFbLW0mhhAyGEqpt,23,49,3,16,4,14,11,10,107,15.285714285714286,3,0.0,10,3,14,4,39,14,2,11,10,31,76,0
3710,72944,lv2TJU2QSmR6ZpD7FaidN3ql3NuYRcZ1,A3fsA9Zfv1X2fVEQhTw51lKENdNrEqT3,8,9,1,0,1,0,5,0,16,2.2857142857142856,1,0.0,0,1,0,1,9,0,0,5,0,2,14,1
3711,72948,DEGiuzhB04pwSFBxNndJCumCtMNBwFrd,A3fsA9Zfv1X2fVEQhTw51lKENdNrEqT3,10,8,4,0,3,0,4,0,19,2.7142857142857144,1,0.0,0,4,0,3,8,0,0,4,0,7,12,1
3712,72966,5bg7aQCg1xT3BNwuorGcguCUDl8W5Lwl,SpATywNh6bZuzm8s1ceuBUnMUAeoAHHw,23,47,1,27,0,6,9,1,91,13.0,2,0.0,16,1,21,0,31,6,6,9,1,38,53,0
3713,72979,6BV17cQBS0vMXReFAexYd9wW7Rs6YIDr,RXDvfPUBYFlVdlueBFbLW0mhhAyGEqpt,2,0,0,0,0,0,2,0,2,0.2857142857142857,1,0.0,0,0,0,0,0,0,0,2,0,0,2,1
3714,72993,N8pR87BNJJZF5Ez15Nl4SeXnB2JbgnGF,SpATywNh6bZuzm8s1ceuBUnMUAeoAHHw,3,2,0,0,0,0,1,0,3,0.42857142857142855,1,0.0,0,0,0,0,2,0,0,1,0,0,3,1
3715,73001,NlHO5hXiy7TmVTHiRgExH6y7p9gJG1YF,A3fsA9Zfv1X2fVEQhTw51lKENdNrEqT3,40,30,25,0,22,0,5,1,83,11.857142857142858,3,0.0,0,25,0,22,30,0,0,5,1,47,36,1
3716,73019,Sle0t5zy0VbRjUdpojBY9wV6zuG12LCM,RXDvfPUBYFlVdlueBFbLW0mhhAyGEqpt,1,0,0,0,0,0,1,0,1,0.14285714285714285,1,0.0,0,0,0,0,0,0,0,1,0,0,1,1
3717,73050,Hj6wuu6IJzCenxWAs1sLyWNMm32YIpDq,SpATywNh6bZuzm8s1ceuBUnMUAeoAHHw,5,2,0,0,0,0,4,0,6,0.8571428571428571,1,0.0,0,0,0,0,2,0,0,4,0,0,6,1
3718,73078,pQJkPXwRF9VuLrQomaax9ecDhBYo49Wz,bWdj2GDclj5ofokWjzoa5jAwMkxCykd6,1,0,0,0,0,0,1,0,1,0.14285714285714285,1,0.0,0,0,0,0,0,0,0,1,0,0,1,0
3719,73079,Oe7zyPdqUKEu4xpqbiVxJiAwdUxxeOQv,bWdj2GDclj5ofokWjzoa5jAwMkxCykd6,7,7,4,0,3,0,4,0,18,2.5714285714285716,2,0.0,0,4,0,3,7,0,0,4,0,7,11,1
3720,73101,AeXY5V6bNirN94d0GfQQQX1fFim1uqSr,SpATywNh6bZuzm8s1ceuBUnMUAeoAHHw,8,20,2,0,0,0,9,0,31,4.428571428571429,5,0.0,2,2,0,0,18,0,0,9,0,4,27,0
3721,73110,TOybu3VTl57Gwz61jxLAAYZF2xYkGB5M,SpATywNh6bZuzm8s1ceuBUnMUAeoAHHw,25,19,14,12,7,7,7,0,66,9.428571428571429,3,0.0,0,14,10,7,19,7,2,7,0,31,35,1
3722,73115,Zx0bFLnVRMy9krgKUk9lItbN7v3mJCyu,SpATywNh6bZuzm8s1ceuBUnMUAeoAHHw,1,0,0,0,0,0,1,0,1,0.14285714285714285,1,0.0,0,0,0,0,0,0,0,1,0,0,1,1
3723,73116,ikZ5e1jXRpMQVOcFqH67Ve7tNtXOJxoc,bWdj2GDclj5ofokWjzoa5jAwMkxCykd6,3,2,1,0,0,0,2,0,5,0.7142857142857143,1,0.0,0,1,0,0,2,0,0,2,0,1,4,1
3724,73126,ikZ5e1jXRpMQVOcFqH67Ve7tNtXOJxoc,SpATywNh6bZuzm8s1ceuBUnMUAeoAHHw,1,0,0,0,0,0,1,0,1,0.14285714285714285,1,0.0,0,0,0,0,0,0,0,1,0,0,1,1
3725,73144,rSEfJyHxNlxmmbC9ORIbqcFKKq08QDrh,bWdj2GDclj5ofokWjzoa5jAwMkxCykd6,13,41,17,40,8,43,13,0,162,23.142857142857142,4,0.0,5,17,39,8,36,43,1,13,0,69,93,0
3726,73159,wZbfkDTJEKLN8i3q2vyR2D63BVy1yfzP,RXDvfPUBYFlVdlueBFbLW0mhhAyGEqpt,1,0,0,0,0,0,1,0,1,0.14285714285714285,1,0.0,0,0,0,0,0,0,0,1,0,0,1,1
3727,73160,bQyVE18uOQgosEkzDxCae8JLEu2KcOfx,bWdj2GDclj5ofokWjzoa5jAwMkxCykd6,16,26,14,26,10,2,5,1,84,12.0,2,0.0,9,14,23,10,17,2,3,5,1,56,28,1
3728,73165,QeAOpQzyLu4fxeYb4rnli0YrGwCr0z5U,RXDvfPUBYFlVdlueBFbLW0mhhAyGEqpt,1,0,0,0,0,0,1,0,1,0.14285714285714285,1,0.0,0,0,0,0,0,0,0,1,0,0,1,1
3729,73170,afdo7sttc7aaNvz9ca7YCfhlkfRUdKCm,A3fsA9Zfv1X2fVEQhTw51lKENdNrEqT3,1,0,0,0,0,0,1,0,1,0.14285714285714285,1,0.0,0,0,0,0,0,0,0,1,0,0,1,1
3730,73502,UGYGSfRkJhOkgkdlCI6YSCshpNvwBF31,fbPkOYLVPtPgIt0MxizjfFJov3JbHyAi,6,6,4,0,1,0,6,0,17,2.4285714285714284,1,0.0,0,4,0,1,6,0,0,6,0,5,12,1
3731,73504,50aSuabL02e7lLNBHTRXsMQnBChV2lSX,fbPkOYLVPtPgIt0MxizjfFJov3JbHyAi,8,8,3,0,2,0,5,0,18,2.5714285714285716,2,0.0,0,3,0,2,8,0,0,5,0,5,13,1
3732,73508,YNIWjVVReCMnb4p25EmH6YanIJI1UWGe,fbPkOYLVPtPgIt0MxizjfFJov3JbHyAi,4,2,0,0,0,0,4,0,6,0.8571428571428571,1,0.0,0,0,0,0,2,0,0,4,0,0,6,1
3733,73518,mEXms676UX2nEtOWi785T3a9YDRXn6eo,fbPkOYLVPtPgIt0MxizjfFJov3JbHyAi,7,6,1,0,1,3,4,1,16,2.2857142857142856,2,0.0,0,1,0,1,6,3,0,4,1,2,14,1
3734,73519,BjBet1XrpmufRo3nJSBrADvKxDiooNdd,fbPkOYLVPtPgIt0MxizjfFJov3JbHyAi,1,0,0,0,0,0,1,0,1,0.14285714285714285,1,0.0,0,0,0,0,0,0,0,1,0,0,1,1
3735,73543,qCHnpaFMgw6f0BW7hG9Qa9zJ3b9yr9G8,fbPkOYLVPtPgIt0MxizjfFJov3JbHyAi,5,0,0,0,0,1,10,4,15,2.142857142857143,1,0.0,0,0,0,0,0,1,0,10,4,0,15,1
3736,73546,ffYbnIyANDjzLf3ELTXl50wDF2eVsyNm,fbPkOYLVPtPgIt0MxizjfFJov3JbHyAi,2,0,0,0,0,0,2,0,2,0.2857142857142857,1,0.0,0,0,0,0,0,0,0,2,0,0,2,1
3737,73906,oXeIIZJhS8XqLTW0ryKumqV3ZtrZlFuh,7GRhBDsirIGkRZBtSMEzNTyDr2JQm4xx,42,71,18,55,20,3,14,0,181,25.857142857142858,4,0.0,27,18,47,20,44,3,8,14,0,112,69,1
3738,73908,4sCPuVlkq4rBRlBYNyTR5EDg94co1oy4,7GRhBDsirIGkRZBtSMEzNTyDr2JQm4xx,28,49,18,34,12,0,4,0,117,16.714285714285715,3,0.0,27,18,28,12,22,0,6,4,0,85,32,1
3739,73928,VBP5PzVQEKJYFH0y5ffEek5WfP9EW7uc,7GRhBDsirIGkRZBtSMEzNTyDr2JQm4xx,17,16,10,10,8,0,4,0,48,6.857142857142857,2,0.0,3,10,9,8,13,0,1,4,0,30,18,1
3740,73935,ZjAnj7LejyrDjdytaW8xiEftNjkACZgi,7GRhBDsirIGkRZBtSMEzNTyDr2JQm4xx,31,48,22,43,16,0,10,2,141,20.142857142857142,2,0.0,19,22,40,16,29,0,3,10,2,97,44,1
3741,73953,7VDn6ntyPpx1GsPLNVgZQF03WDWTuKJo,bWdj2GDclj5ofokWjzoa5jAwMkxCykd6,38,98,60,126,15,24,29,0,352,50.285714285714285,6,0.0,11,60,107,15,87,24,19,29,0,193,159,0
3742,73956,ks4Bg3QCnzBSrFPW18QfINyVAhl01iQP,7GRhBDsirIGkRZBtSMEzNTyDr2JQm4xx,1,0,0,0,0,0,1,0,1,0.14285714285714285,1,0.0,0,0,0,0,0,0,0,1,0,0,1,1
3743,73959,UNKWHkTsZ3RudPGKkhB4ao4XLNWXegZ9,7GRhBDsirIGkRZBtSMEzNTyDr2JQm4xx,30,60,2,84,10,7,10,1,174,24.857142857142858,4,0.0,36,2,72,10,24,7,12,10,1,120,54,1
3744,73967,31aB1n1dsQQ1ksrWlX8ZehnLm4yKoPC4,7GRhBDsirIGkRZBtSMEzNTyDr2JQm4xx,1,0,0,0,0,0,2,0,2,0.2857142857142857,2,0.0,0,0,0,0,0,0,0,2,0,0,2,1
3745,73968,fwlGH5gehdOA0f9hZd0xb19Diqa5Heyh,7GRhBDsirIGkRZBtSMEzNTyDr2JQm4xx,4,2,1,0,0,0,3,0,6,0.8571428571428571,1,0.0,0,1,0,0,2,0,0,3,0,1,5,1
3746,73980,4sSRGcSDSLzxYWcglxw7d9PzYXxgOT88,7GRhBDsirIGkRZBtSMEzNTyDr2JQm4xx,5,4,1,0,0,1,2,0,8,1.1428571428571428,2,0.0,0,1,0,0,4,1,0,2,0,1,7,1
3747,73985,58MUEzrczRikT4gXBjyXknuMU1aGIyQK,7GRhBDsirIGkRZBtSMEzNTyDr2JQm4xx,1,0,0,0,0,0,1,0,1,0.14285714285714285,1,0.0,0,0,0,0,0,0,0,1,0,0,1,1
3748,73998,ej4gQoO7wYuk4hf1qDoakX8UCNofUE33,SpATywNh6bZuzm8s1ceuBUnMUAeoAHHw,4,2,1,0,0,0,3,0,6,0.8571428571428571,1,0.0,0,1,0,0,2,0,0,3,0,1,5,1
3749,74021,EPmLjBxeWpwhjwoRgtmLV8RkhFOu2zzj,A3fsA9Zfv1X2fVEQhTw51lKENdNrEqT3,2,0,0,0,0,0,2,0,2,0.2857142857142857,1,0.0,0,0,0,0,0,0,0,2,0,0,2,1
3750,74035,79Eh0WdhadJNiwxQWsLXR8INp63Y21nq,7GRhBDsirIGkRZBtSMEzNTyDr2JQm4xx,9,19,5,6,3,2,7,0,42,6.0,1,0.0,7,5,5,3,12,2,1,7,0,20,22,1
3751,74062,1cBYtB7KOC3ODHrTHPWmdxuvdPQZ4YhT,SpATywNh6bZuzm8s1ceuBUnMUAeoAHHw,4,2,1,0,1,0,1,0,5,0.7142857142857143,1,0.0,0,1,0,1,2,0,0,1,0,2,3,0
3752,74067,ve7Ft3pn5zWGBanwhSnSQvIFg9ZaO7O3,7GRhBDsirIGkRZBtSMEzNTyDr2JQm4xx,1,0,0,0,0,0,1,0,1,0.14285714285714285,1,0.0,0,0,0,0,0,0,0,1,0,0,1,1
3753,74101,Uvr135kFC9KlMOM943bFXvTUT71uSm4O,G8EPVSXsOYB5YQWZGiz1aVq5Pgr2GrQu,17,19,9,8,7,2,9,1,55,7.857142857142857,1,0.0,7,9,6,7,12,2,2,9,1,29,26,0
3754,74104,7TkkuA0EEQqi6jLSaHSvDaS7U5kNSv36,SpATywNh6bZuzm8s1ceuBUnMUAeoAHHw,28,74,29,35,7,15,31,6,197,28.142857142857142,6,0.0,18,29,32,7,56,15,3,31,6,86,111,0
3755,74107,0oxo9rZM5dGgpN8rq6aFGU3IpbIKGlK0,7GRhBDsirIGkRZBtSMEzNTyDr2JQm4xx,7,6,4,0,2,0,2,0,14,2.0,1,0.0,0,4,0,2,6,0,0,2,0,6,8,1
3756,74125,FxNNtpAKePULpDZjsrs8zCvX1MSFauHF,7GRhBDsirIGkRZBtSMEzNTyDr2JQm4xx,29,32,11,45,13,1,2,0,104,14.857142857142858,1,0.0,20,11,42,13,12,1,3,2,0,86,18,1
3757,74139,gVHbwM9IOrk1olFEuw0FAfVujUgJm8AG,7GRhBDsirIGkRZBtSMEzNTyDr2JQm4xx,37,101,27,62,14,14,21,2,241,34.42857142857143,4,0.0,67,27,56,14,34,14,6,21,2,164,77,0
3758,74149,mWao7cvXlyZJViXXeBzOOV4p4AC8rvCX,7GRhBDsirIGkRZBtSMEzNTyDr2JQm4xx,35,53,19,38,20,1,18,1,150,21.428571428571427,2,0.0,33,19,32,20,20,1,6,18,1,104,46,1
3759,74167,qEQGNCv0DTznAP1gMwDRVGTAjB8ymoH3,7GRhBDsirIGkRZBtSMEzNTyDr2JQm4xx,1,0,0,0,0,0,1,0,1,0.14285714285714285,1,0.0,0,0,0,0,0,0,0,1,0,0,1,1
3760,74213,Hzo5Ctg10ZQey5IjMeCvl0CH7lPNTM5X,7GRhBDsirIGkRZBtSMEzNTyDr2JQm4xx,2,0,0,0,0,0,4,0,4,0.5714285714285714,2,0.0,0,0,0,0,0,0,0,4,0,0,4,1
3761,74244,ipQCHpy6wiUwlX5KYwBvpzBdqgm7xLba,7GRhBDsirIGkRZBtSMEzNTyDr2JQm4xx,5,2,1,0,1,0,2,0,6,0.8571428571428571,1,0.0,0,1,0,1,2,0,0,2,0,2,4,1
3762,74300,MgS6WK9esRya9QyP2ZOjbNdLSIL7NuM9,SpATywNh6bZuzm8s1ceuBUnMUAeoAHHw,19,33,17,26,3,0,6,0,85,12.142857142857142,2,0.0,12,17,22,3,21,0,4,6,0,54,31,0
3763,74301,WCAIb19YcAzAlp07XtATiiwpdzMqbAbp,7GRhBDsirIGkRZBtSMEzNTyDr2JQm4xx,45,49,22,79,11,0,3,0,164,23.428571428571427,2,0.0,25,22,71,11,24,0,8,3,0,129,35,0
3764,74334,ovvuiEhj0QBv4xi11GVjXr8JhlCgaPmd,SpATywNh6bZuzm8s1ceuBUnMUAeoAHHw,26,42,22,22,16,0,23,0,125,17.857142857142858,3,0.0,8,22,19,16,34,0,3,23,0,65,60,0
3765,74386,QlvFciinGDGt7csjDmjYPPZqFlKAzfUP,SpATywNh6bZuzm8s1ceuBUnMUAeoAHHw,23,33,6,13,5,2,7,1,67,9.571428571428571,2,0.0,9,6,12,5,24,2,1,7,1,32,35,0
3766,74408,Ra9AxcPuu5j5vTOkoJFrcEzyHUcLxhn0,7GRhBDsirIGkRZBtSMEzNTyDr2JQm4xx,6,2,1,0,1,0,4,0,8,1.1428571428571428,1,0.0,0,1,0,1,2,0,0,4,0,2,6,1
3767,74468,rgJ7j684KtaDcmKD94RFdpwPnoKFUmIV,7GRhBDsirIGkRZBtSMEzNTyDr2JQm4xx,22,23,16,30,9,9,4,0,91,13.0,3,0.0,2,16,26,9,21,9,4,4,0,53,38,1
3768,74473,GVRJN4wkoooaXJUVmwnX983A87KsrZPK,7GRhBDsirIGkRZBtSMEzNTyDr2JQm4xx,4,2,1,0,1,0,1,0,5,0.7142857142857143,1,0.0,0,1,0,1,2,0,0,1,0,2,3,1
3769,74509,QfBD8mMClwgY0rD8w1rSnRjdXKLH7oSP,7GRhBDsirIGkRZBtSMEzNTyDr2JQm4xx,2,0,0,0,0,0,3,0,3,0.42857142857142855,1,0.0,0,0,0,0,0,0,0,3,0,0,3,1
3770,74529,YfLkHn3sP8pusiYlKK6o5F2jXKBNkL8d,SpATywNh6bZuzm8s1ceuBUnMUAeoAHHw,31,78,32,14,12,9,26,3,174,24.857142857142858,12,0.0,13,32,14,12,65,9,0,26,3,71,103,0
3771,74555,Q8RGPBI5Ez4dcsYeaCg7LkbJmto9C3oj,SpATywNh6bZuzm8s1ceuBUnMUAeoAHHw,17,29,17,23,5,15,27,4,120,17.142857142857142,3,0.0,8,17,20,5,21,15,3,27,4,50,70,0
3772,74608,U3R4m4eLMm2lirgI7HLueBKsNpxhFpn9,7GRhBDsirIGkRZBtSMEzNTyDr2JQm4xx,51,61,32,56,9,0,8,0,166,23.714285714285715,5,0.0,24,32,56,9,37,0,0,8,0,121,45,1
3773,74611,oulkc1tf0Kd1NPyUx3LDpZLt1fzzxHYa,SpATywNh6bZuzm8s1ceuBUnMUAeoAHHw,5,5,0,0,0,0,2,0,7,1.0,1,0.0,0,0,0,0,5,0,0,2,0,0,7,1
3774,74618,RtmYmukzSU8h3Uq6suOYxJKRcISOQfvL,RXDvfPUBYFlVdlueBFbLW0mhhAyGEqpt,47,32,20,94,9,1,9,0,165,23.571428571428573,4,0.0,8,20,90,9,24,1,4,9,0,127,38,0
3775,74653,HL0jm7zWkHTTtUFklIJxsfljBDgcIEre,SpATywNh6bZuzm8s1ceuBUnMUAeoAHHw,16,43,4,32,1,5,7,0,92,13.142857142857142,4,0.0,15,4,28,1,28,5,4,7,0,48,44,1
3776,74669,QYUKXD6RJtSdizcdlNjQSBFOXbEQl1FA,SpATywNh6bZuzm8s1ceuBUnMUAeoAHHw,6,2,0,0,0,8,5,0,15,2.142857142857143,1,0.0,0,0,0,0,2,8,0,5,0,0,15,1
3777,74703,vSL0kRsKOWBMpC6pqEAxri0eLNug5E20,RXDvfPUBYFlVdlueBFbLW0mhhAyGEqpt,39,58,5,65,2,9,11,0,150,21.428571428571427,4,0.0,12,5,63,2,46,9,2,11,0,82,68,0
3778,74717,tBy7E7qZZZ98Oih5sTNUdDZRIpZZM98z,SpATywNh6bZuzm8s1ceuBUnMUAeoAHHw,15,45,14,22,0,14,12,0,107,15.285714285714286,6,0.0,20,14,19,0,25,14,3,12,0,53,54,0
3779,74733,nd2ZHSI1Tvo1sLaItC7AKiAwHujqev1a,SpATywNh6bZuzm8s1ceuBUnMUAeoAHHw,10,7,1,2,1,0,4,0,15,2.142857142857143,1,0.0,0,1,2,1,7,0,0,4,0,4,11,1
3780,74736,sgWvC8NRvYtrmKjALzTvn9SNvnbzDMjJ,SpATywNh6bZuzm8s1ceuBUnMUAeoAHHw,6,5,3,0,1,0,2,0,11,1.5714285714285714,1,0.0,0,3,0,1,5,0,0,2,0,4,7,1
3781,74755,MLEFHCMFllWu55FD5Lk76TFNbtPRpP0W,7GRhBDsirIGkRZBtSMEzNTyDr2JQm4xx,21,27,2,16,1,0,12,2,60,8.571428571428571,1,0.0,8,2,13,1,19,0,3,12,2,24,36,0
3782,74792,DSoedfH3iEqkDSoEfnR9hPK9fGA03nvE,A3fsA9Zfv1X2fVEQhTw51lKENdNrEqT3,50,19,15,114,10,8,5,0,171,24.428571428571427,2,0.0,1,15,94,10,18,8,20,5,0,120,51,1
3783,74801,L0e1YP7bRzjNsIzxzTyXlM0Ldh6xltNG,SpATywNh6bZuzm8s1ceuBUnMUAeoAHHw,32,44,21,38,10,2,8,1,124,17.714285714285715,1,0.0,9,21,35,10,35,2,3,8,1,75,49,0
3784,74809,0UD2r7gmc85Ip6GdTUss7ocdGASnZDTz,7GRhBDsirIGkRZBtSMEzNTyDr2JQm4xx,14,15,8,8,6,0,7,0,44,6.285714285714286,2,0.0,2,8,6,6,13,0,2,7,0,22,22,1
3785,74818,knxAJpSFDgjN8jBmnCV7BB7s4fbgoTt1,7GRhBDsirIGkRZBtSMEzNTyDr2JQm4xx,7,3,2,4,0,1,6,0,16,2.2857142857142856,2,0.0,1,2,3,0,2,1,1,6,0,6,10,1
3786,74836,lFMbkCaY0FKfyGbh1VOL30jTZ1USVgB2,G8EPVSXsOYB5YQWZGiz1aVq5Pgr2GrQu,2,1,0,0,0,0,1,0,2,0.2857142857142857,1,0.0,0,0,0,0,1,0,0,1,0,0,2,1
3787,74841,lFMbkCaY0FKfyGbh1VOL30jTZ1USVgB2,RXDvfPUBYFlVdlueBFbLW0mhhAyGEqpt,25,25,15,16,13,6,3,0,78,11.142857142857142,3,0.0,8,15,16,13,17,6,0,3,0,52,26,0
3788,74881,user4NErzgNZOQPby0IMjoZc4clvyOrp,7GRhBDsirIGkRZBtSMEzNTyDr2JQm4xx,6,4,2,0,1,0,2,0,9,1.2857142857142858,1,0.0,1,2,0,1,3,0,0,2,0,4,5,1
3789,74882,uFxbwM61ZWFC5xnxVOlmiGXCTyHmK3HX,RXDvfPUBYFlVdlueBFbLW0mhhAyGEqpt,8,8,5,0,2,2,7,3,27,3.857142857142857,1,0.0,0,5,0,2,8,2,0,7,3,7,20,1
3790,74915,1f1vpzICnoH8kVwL3WpPvvH9Fnzvagoq,7GRhBDsirIGkRZBtSMEzNTyDr2JQm4xx,5,3,1,0,0,0,3,0,7,1.0,1,0.0,0,1,0,0,3,0,0,3,0,1,6,1
3791,74918,Y0dbTriNAgSzbrnkzFHfTSZPt5kDzGfo,SpATywNh6bZuzm8s1ceuBUnMUAeoAHHw,13,17,1,10,1,0,1,0,30,4.285714285714286,1,0.0,5,1,9,1,12,0,1,1,0,16,14,0
3792,74935,7n6VTEPIznuedo1nynk3WFAbvlKYIs72,SpATywNh6bZuzm8s1ceuBUnMUAeoAHHw,6,4,3,0,3,0,1,0,11,1.5714285714285714,1,0.0,0,3,0,3,4,0,0,1,0,6,5,0
3793,75011,CDVTgNquYdsNoldLURSKppemY0oOGcjg,SpATywNh6bZuzm8s1ceuBUnMUAeoAHHw,14,24,1,9,1,3,6,2,46,6.571428571428571,1,0.0,7,1,9,1,17,3,0,6,2,18,28,0
3794,75046,JxLtKAnMek98G5fWpyeTaKlh0zheuNnU,A3fsA9Zfv1X2fVEQhTw51lKENdNrEqT3,8,7,2,0,1,1,4,1,16,2.2857142857142856,1,0.0,1,2,0,1,6,1,0,4,1,4,12,1
3795,75054,dtbXtMjPqeEvzoZBFe2y9uSDcjL0lnx2,RXDvfPUBYFlVdlueBFbLW0mhhAyGEqpt,32,76,15,0,8,46,12,0,157,22.428571428571427,6,0.0,13,15,0,8,63,46,0,12,0,36,121,0
3796,75113,5EOGhyHOLLtbW0eEa8Dnfl5My4kdYkdc,SpATywNh6bZuzm8s1ceuBUnMUAeoAHHw,29,41,19,18,10,1,13,2,104,14.857142857142858,6,0.0,12,19,18,10,29,1,0,13,2,59,45,0
3797,75143,KKE8q8DWecTGi2Mp6eRnxhZGGD7eG4J3,SpATywNh6bZuzm8s1ceuBUnMUAeoAHHw,6,3,1,0,1,0,2,0,7,1.0,1,0.0,0,1,0,1,3,0,0,2,0,2,5,1
3798,75195,9zNI4EpVujSV8TU9o7NY46vrkl8qX3Ys,G8EPVSXsOYB5YQWZGiz1aVq5Pgr2GrQu,8,6,1,0,2,0,3,0,12,1.7142857142857142,1,0.0,2,1,0,2,4,0,0,3,0,5,7,0
3799,75206,ZXWRS3Ah3Q3TKxtUJXxAAlsPTxzCg1Vz,SpATywNh6bZuzm8s1ceuBUnMUAeoAHHw,17,24,11,23,1,4,9,1,73,10.428571428571429,3,0.0,8,11,21,1,16,4,2,9,1,41,32,0
3800,75350,mFNGHC6aCmhHmhRXFCDO0uvnGnNYaro0,7GRhBDsirIGkRZBtSMEzNTyDr2JQm4xx,4,2,1,0,1,0,1,0,5,0.7142857142857143,1,0.0,0,1,0,1,2,0,0,1,0,2,3,1
3801,75382,O0pFwh56sT4vz63TrFMWxlTyZHTENk1t,SpATywNh6bZuzm8s1ceuBUnMUAeoAHHw,20,27,0,17,0,1,2,0,47,6.714285714285714,1,0.0,15,0,16,0,12,1,1,2,0,31,16,0
3802,75440,0wpIasMdCfOA3dQLJWO9ecakBEpIFnbg,7GRhBDsirIGkRZBtSMEzNTyDr2JQm4xx,38,70,33,53,14,29,13,0,212,30.285714285714285,3,0.0,33,33,45,14,37,29,8,13,0,125,87,1
3803,75486,l7cIWSn2QdqLoOKMFO8yNQGKfk999nJh,7GRhBDsirIGkRZBtSMEzNTyDr2JQm4xx,13,18,7,0,3,3,8,1,40,5.714285714285714,2,0.0,8,7,0,3,10,3,0,8,1,18,22,0
3804,75508,RHl3DsvAX7TisJ7qBptmgrrtDAQvH7mr,bWdj2GDclj5ofokWjzoa5jAwMkxCykd6,13,21,15,0,4,5,6,0,51,7.285714285714286,1,0.0,1,15,0,4,20,5,0,6,0,20,31,1
3805,75557,514TWhkGGUhLu2MdvTnb8eiBH3DCFHzg,SpATywNh6bZuzm8s1ceuBUnMUAeoAHHw,26,40,15,31,3,3,13,1,106,15.142857142857142,3,0.0,12,15,29,3,28,3,2,13,1,59,47,0
3806,75565,A8uNxAeXRi6PUyfK3nbO106vNrsfyDAv,SpATywNh6bZuzm8s1ceuBUnMUAeoAHHw,30,38,20,32,11,12,20,0,133,19.0,4,0.0,14,20,29,11,24,12,3,20,0,74,59,0
3807,75599,yBKc8UQ3yoU6nYnfaJz62fH80CgKFtOX,SpATywNh6bZuzm8s1ceuBUnMUAeoAHHw,30,35,17,39,9,0,13,1,114,16.285714285714285,3,0.0,12,17,32,9,23,0,7,13,1,70,44,0
3808,75619,qwKwEhJ5oWm5TB1Q6emluPsrjHPCR2z1,SpATywNh6bZuzm8s1ceuBUnMUAeoAHHw,22,21,13,20,6,0,7,0,67,9.571428571428571,1,0.0,4,13,17,6,17,0,3,7,0,40,27,1
3809,75673,I6LvRAT5lrglfRc7HjtOiHjECPtrYMcD,SpATywNh6bZuzm8s1ceuBUnMUAeoAHHw,5,3,2,0,2,0,2,0,9,1.2857142857142858,1,0.0,0,2,0,2,3,0,0,2,0,4,5,1
3810,75699,88AD1l4wNMBju3FfWmP2xvwRYAECtTFg,A3fsA9Zfv1X2fVEQhTw51lKENdNrEqT3,4,2,1,0,1,0,3,0,7,1.0,1,0.0,0,1,0,1,2,0,0,3,0,2,5,1
3811,75724,39HyRvZGGM2Q03BAuIzlN9IBewYhVnfo,7GRhBDsirIGkRZBtSMEzNTyDr2JQm4xx,9,8,2,2,4,0,5,0,21,3.0,1,0.0,6,2,2,4,2,0,0,5,0,14,7,0
3812,75741,3x63reHnPUEpxvneROppT18TTVHKvgH3,bWdj2GDclj5ofokWjzoa5jAwMkxCykd6,8,9,2,22,3,0,1,0,37,5.285714285714286,1,0.0,3,2,20,3,6,0,2,1,0,28,9,1
3813,75759,8wgkhDh9t3XtyzQtRpizifGx20DUK4F9,7GRhBDsirIGkRZBtSMEzNTyDr2JQm4xx,2,0,0,0,0,0,2,0,2,0.2857142857142857,1,0.0,0,0,0,0,0,0,0,2,0,0,2,1
3814,75770,FGD2s7sTUqsP3QU1o8nPIzNgmxXe4CYW,7GRhBDsirIGkRZBtSMEzNTyDr2JQm4xx,25,53,23,12,13,3,19,0,123,17.571428571428573,2,0.0,22,23,9,13,31,3,3,19,0,67,56,1
3815,75792,dhPF0MOUpHT5OZTFAONgRdkH1ZwnZtFz,SpATywNh6bZuzm8s1ceuBUnMUAeoAHHw,17,17,8,12,6,0,5,0,48,6.857142857142857,2,0.0,8,8,12,6,9,0,0,5,0,34,14,0
3816,75890,Y89GJdSZUpoYFMgx00SCe6qFoYoXIpUj,7GRhBDsirIGkRZBtSMEzNTyDr2JQm4xx,1,0,0,0,0,0,1,0,1,0.14285714285714285,1,0.0,0,0,0,0,0,0,0,1,0,0,1,1
3817,75950,vRfp4R3Ka5ikFbaOY5bQDke3cTfTq6Oz,RXDvfPUBYFlVdlueBFbLW0mhhAyGEqpt,14,11,1,0,1,9,7,2,31,4.428571428571429,2,0.0,0,1,0,1,11,9,0,7,2,2,29,0
3818,75955,m1ZHf0Vy9SZyKEONoAW39ljflZCTH7Li,bWdj2GDclj5ofokWjzoa5jAwMkxCykd6,7,1,1,0,1,1,6,1,11,1.5714285714285714,1,0.0,0,1,0,1,1,1,0,6,1,2,9,1
3819,75964,kiVzCvDoEqSB7iO0TU3ERoanC9pEAYCs,7GRhBDsirIGkRZBtSMEzNTyDr2JQm4xx,4,2,1,0,1,0,2,0,6,0.8571428571428571,1,0.0,0,1,0,1,2,0,0,2,0,2,4,1
3820,75969,8Dno8ERd119JayTOKlG7uDmGtkfLJOke,SpATywNh6bZuzm8s1ceuBUnMUAeoAHHw,6,3,2,0,2,0,2,0,9,1.2857142857142858,2,0.0,0,2,0,2,3,0,0,2,0,4,5,0
3821,75980,mDHr8WvVVX9KSvXMqxtLvZ6vP4uuNF6E,A3fsA9Zfv1X2fVEQhTw51lKENdNrEqT3,7,11,1,0,0,1,5,0,18,2.5714285714285716,3,0.0,2,1,0,0,9,1,0,5,0,3,15,1
3822,75992,YvdTgocCzBmHhfLuAH349Li5za8uToFU,7GRhBDsirIGkRZBtSMEzNTyDr2JQm4xx,9,5,0,0,0,2,5,1,13,1.8571428571428572,1,0.0,0,0,0,0,5,2,0,5,1,0,13,1
3823,76038,6RuWsSvS3Ngnjl37PzNAaaGn8Jd9a1lW,bWdj2GDclj5ofokWjzoa5jAwMkxCykd6,15,66,14,0,13,1,25,0,119,17.0,7,0.0,2,14,0,13,64,1,0,25,0,29,90,0
3824,76070,4rBJgH2pAgasw5ZtgiBnBNfRcNJLZp5J,7GRhBDsirIGkRZBtSMEzNTyDr2JQm4xx,9,2,1,0,1,4,7,1,16,2.2857142857142856,1,0.0,0,1,0,1,2,4,0,7,1,2,14,1
3825,76119,FXen1VSms29mqypmBsJLgiCW5lwzRuUO,7GRhBDsirIGkRZBtSMEzNTyDr2JQm4xx,21,22,10,8,8,5,11,0,64,9.142857142857142,4,0.0,7,10,6,8,15,5,2,11,0,31,33,1
3826,76193,yhuEFjYPx53KuMNRSkVNQIkCv2xuEbeq,7GRhBDsirIGkRZBtSMEzNTyDr2JQm4xx,1,0,0,0,0,0,2,0,2,0.2857142857142857,1,0.0,0,0,0,0,0,0,0,2,0,0,2,1
3827,76245,FYdTGqTHtRATfo802agJiucYRW9Mfn1L,7GRhBDsirIGkRZBtSMEzNTyDr2JQm4xx,1,0,0,0,0,0,1,0,1,0.14285714285714285,1,0.0,0,0,0,0,0,0,0,1,0,0,1,1
3828,76252,BCPhbcVTukJPsOtUJJbyOWvpso8GiEV1,A3fsA9Zfv1X2fVEQhTw51lKENdNrEqT3,7,3,2,0,2,0,2,0,9,1.2857142857142858,1,0.0,0,2,0,2,3,0,0,2,0,4,5,1
3829,76261,wzJUcvl4LpGNAis186Xl9ztjI1WNWkac,bWdj2GDclj5ofokWjzoa5jAwMkxCykd6,8,10,1,0,2,1,19,1,34,4.857142857142857,4,0.0,5,1,0,2,5,1,0,19,1,8,26,1
3830,76314,0htS0wNp12VQ7YgJ628sRK5TB1tJHlRO,7GRhBDsirIGkRZBtSMEzNTyDr2JQm4xx,8,5,3,0,3,0,1,0,12,1.7142857142857142,1,0.0,1,3,0,3,4,0,0,1,0,7,5,1
3831,76370,LjHLegep3fnzz3EMIdyj4iJ3mzoK4FmA,7GRhBDsirIGkRZBtSMEzNTyDr2JQm4xx,2,0,0,0,0,0,2,0,2,0.2857142857142857,1,0.0,0,0,0,0,0,0,0,2,0,0,2,1
3832,76965,RVwSAHxCpXjdqkEsoVeRRSWT7FKnXTih,7GRhBDsirIGkRZBtSMEzNTyDr2JQm4xx,5,2,1,0,1,0,3,0,7,1.0,1,0.0,0,1,0,1,2,0,0,3,0,2,5,1
3833,76990,OdMr7dE5UlAme9Tp979vREBvY5CV50po,7GRhBDsirIGkRZBtSMEzNTyDr2JQm4xx,34,27,21,2,21,0,4,0,75,10.714285714285714,2,0.0,3,21,2,21,24,0,0,4,0,47,28,1
3834,77027,BCR9Csw9e3gBBos2x8J4HYYW5Gara6WV,7GRhBDsirIGkRZBtSMEzNTyDr2JQm4xx,1,0,0,0,0,0,1,0,1,0.14285714285714285,1,0.0,0,0,0,0,0,0,0,1,0,0,1,1
3835,77032,KPMkMHpUZOSbFRkwKqywhwm1W34kGRsr,7GRhBDsirIGkRZBtSMEzNTyDr2JQm4xx,5,2,1,0,1,0,2,0,6,0.8571428571428571,1,0.0,0,1,0,1,2,0,0,2,0,2,4,1
3836,77044,bikkCYRyUxervPNSkXQBtcADPD3aMEN1,7GRhBDsirIGkRZBtSMEzNTyDr2JQm4xx,2,0,0,0,0,0,3,0,3,0.42857142857142855,2,0.0,0,0,0,0,0,0,0,3,0,0,3,1
3837,77126,qg6GOCuPcDwehPMMAEed7GZuAdyiaV9B,7GRhBDsirIGkRZBtSMEzNTyDr2JQm4xx,54,148,9,87,16,61,29,1,351,50.142857142857146,14,0.0,65,9,72,16,83,61,15,29,1,162,189,1
3838,77170,jOMPEpDTypAwtZP0adzz5Y6TGIr0Cgak,fbPkOYLVPtPgIt0MxizjfFJov3JbHyAi,6,10,1,1,4,0,1,0,17,2.4285714285714284,1,0.0,7,1,1,4,3,0,0,1,0,13,4,1
3839,77172,mI1vyeEbuUIxkGVi9aK5r9kjcaPF7SVi,fbPkOYLVPtPgIt0MxizjfFJov3JbHyAi,8,11,7,0,4,0,2,0,24,3.4285714285714284,1,0.0,0,7,0,4,11,0,0,2,0,11,13,1
3840,77173,GkJR3TNQR5bDjgiA7ByPHRWSb3vgtDKO,fbPkOYLVPtPgIt0MxizjfFJov3JbHyAi,9,10,5,0,3,6,4,1,29,4.142857142857143,1,0.0,1,5,0,3,9,6,0,4,1,9,20,1
3841,77176,hNJz0qbOhrUgajUkzqSdDbybHkuRglfs,fbPkOYLVPtPgIt0MxizjfFJov3JbHyAi,6,5,2,0,2,0,1,0,10,1.4285714285714286,1,0.0,0,2,0,2,5,0,0,1,0,4,6,1
3842,77177,NHGmMinB9WoQusKCx50F4M4nJF124Ms4,fbPkOYLVPtPgIt0MxizjfFJov3JbHyAi,4,2,1,0,1,0,1,0,5,0.7142857142857143,1,0.0,0,1,0,1,2,0,0,1,0,2,3,1
3843,77181,SFygdEesOWeEamKu8iZBsgHneiDiai0R,fbPkOYLVPtPgIt0MxizjfFJov3JbHyAi,4,5,0,0,0,0,2,0,7,1.0,2,0.0,0,0,0,0,5,0,0,2,0,0,7,1
3844,77182,kmeB6Kxx4KEk3yK7YODyZKeWU8kJfyJH,fbPkOYLVPtPgIt0MxizjfFJov3JbHyAi,4,2,1,0,1,0,1,0,5,0.7142857142857143,1,0.0,0,1,0,1,2,0,0,1,0,2,3,1
3845,77184,wf4sRCFbvakokDkU4vw1lmU1y8DrYHz0,fbPkOYLVPtPgIt0MxizjfFJov3JbHyAi,15,42,14,15,10,23,13,0,117,16.714285714285715,3,0.0,13,14,12,10,29,23,3,13,0,49,68,1
3846,77185,QQjzUMnFih1Op25f6SGBPhOGRMF8l0bA,fbPkOYLVPtPgIt0MxizjfFJov3JbHyAi,24,49,20,13,15,6,5,0,108,15.428571428571429,3,0.0,14,20,11,15,35,6,2,5,0,60,48,1
3847,77187,JGkH5G6iVBgcA8nzn9agd5N20Wo6tva5,fbPkOYLVPtPgIt0MxizjfFJov3JbHyAi,21,17,14,0,9,0,6,0,46,6.571428571428571,2,0.0,0,14,0,9,17,0,0,6,0,23,23,1
3848,77188,DiP7fLvMTHut4vp8IPCEmth5BO8Y3xyZ,fbPkOYLVPtPgIt0MxizjfFJov3JbHyAi,9,10,5,0,4,13,7,3,42,6.0,1,0.0,2,5,0,4,8,13,0,7,3,11,31,1
3849,77189,Qj3OHkTzcEQwSk4fOQ3gLUAEOg61tV0J,fbPkOYLVPtPgIt0MxizjfFJov3JbHyAi,6,4,2,0,2,0,2,0,10,1.4285714285714286,1,0.0,0,2,0,2,4,0,0,2,0,4,6,1
3850,77190,YK4AUh2swGXXiib7M9ur8qjJXCBGfumK,fbPkOYLVPtPgIt0MxizjfFJov3JbHyAi,1,0,0,0,0,0,1,0,1,0.14285714285714285,1,0.0,0,0,0,0,0,0,0,1,0,0,1,1
3851,77191,E4C4yZPrf8ephwcq1p7RUy4dbVmvF86s,fbPkOYLVPtPgIt0MxizjfFJov3JbHyAi,1,0,0,0,0,0,2,0,2,0.2857142857142857,1,0.0,0,0,0,0,0,0,0,2,0,0,2,1
3852,77194,uOfATV0WsL0BPHDdVyS70rl0sYjdudpd,fbPkOYLVPtPgIt0MxizjfFJov3JbHyAi,10,18,8,4,3,0,7,0,40,5.714285714285714,1,0.0,4,8,3,3,14,0,1,7,0,18,22,1
3853,77197,4UvxElQD05jrzT8uj3rOHyCF67vFPUKP,fbPkOYLVPtPgIt0MxizjfFJov3JbHyAi,16,36,21,7,14,5,4,0,87,12.428571428571429,5,0.0,9,21,6,14,27,5,1,4,0,50,37,1
3854,77198,nctrJ6DXEbLac5Q8LCtyQd0IItjuRIih,fbPkOYLVPtPgIt0MxizjfFJov3JbHyAi,10,21,4,0,4,3,27,3,62,8.857142857142858,2,0.0,3,4,0,4,18,3,0,27,3,11,51,1
3855,77200,rwyVxnMY0KdYFbt5Rt6BKFYkmT4l68h9,fbPkOYLVPtPgIt0MxizjfFJov3JbHyAi,5,2,1,0,1,0,2,0,6,0.8571428571428571,1,0.0,0,1,0,1,2,0,0,2,0,2,4,1
3856,77206,OE8YoNemuZxKuixEPGeEQM6Dw53MRjvX,fbPkOYLVPtPgIt0MxizjfFJov3JbHyAi,1,0,0,0,0,0,1,0,1,0.14285714285714285,1,0.0,0,0,0,0,0,0,0,1,0,0,1,1
3857,77208,H47G4l8xfadoi35VSQjLwEe5Da3Pfkds,fbPkOYLVPtPgIt0MxizjfFJov3JbHyAi,4,2,1,0,1,0,1,0,5,0.7142857142857143,1,0.0,0,1,0,1,2,0,0,1,0,2,3,1
3858,77278,y7yLjFt2yMwjL5qqPUFP5MHo49CCR80j,fbPkOYLVPtPgIt0MxizjfFJov3JbHyAi,6,1,0,0,0,1,6,1,9,1.2857142857142858,1,0.0,0,0,0,0,1,1,0,6,1,0,9,0
3859,77291,lQduia23vRF72bXB1H9gO7pdoAy9qGnz,fbPkOYLVPtPgIt0MxizjfFJov3JbHyAi,1,0,0,0,0,0,1,0,1,0.14285714285714285,1,0.0,0,0,0,0,0,0,0,1,0,0,1,1
3860,77302,KRi80h1uK84snC5HvtQKWlsjwt9i3oa5,fbPkOYLVPtPgIt0MxizjfFJov3JbHyAi,10,5,3,0,2,0,5,1,16,2.2857142857142856,2,0.0,0,3,0,2,5,0,0,5,1,5,11,1
3861,77850,embp7e5rTedl4SQPXvv0NKkthNGlazF4,SpATywNh6bZuzm8s1ceuBUnMUAeoAHHw,31,42,16,44,8,8,12,1,131,18.714285714285715,5,0.0,14,16,34,8,28,8,10,12,1,72,59,0
3862,77861,j6kVkVGKYZT7ozL2NE5rOIexD3a1ewYn,SpATywNh6bZuzm8s1ceuBUnMUAeoAHHw,23,40,16,23,3,68,14,3,167,23.857142857142858,7,0.0,11,16,23,3,29,68,0,14,3,53,114,1
3863,77887,H6fuaLg1W7r0yBwU0d54zcjFYdRqOb7F,G8EPVSXsOYB5YQWZGiz1aVq5Pgr2GrQu,3,0,0,0,0,2,3,0,5,0.7142857142857143,1,0.0,0,0,0,0,0,2,0,3,0,0,5,1
3864,77899,hzFAznB2sXwDzCFipnygLE0hHHIOs6xS,SpATywNh6bZuzm8s1ceuBUnMUAeoAHHw,5,4,2,0,1,0,2,0,9,1.2857142857142858,1,0.0,0,2,0,1,4,0,0,2,0,3,6,1
3865,77902,k6QLpQDqSxoScgN883dLN4OsoeXNCHXO,A3fsA9Zfv1X2fVEQhTw51lKENdNrEqT3,42,24,20,42,15,0,4,0,105,15.0,3,0.0,1,20,40,15,23,0,2,4,0,76,29,1
3866,77929,0RJFDjD2CVBIyw0gHM4auA9R2PVZlVls,A3fsA9Zfv1X2fVEQhTw51lKENdNrEqT3,1,0,0,0,0,0,2,0,2,0.2857142857142857,1,0.0,0,0,0,0,0,0,0,2,0,0,2,1
3867,77930,I0nVBKgpf6bHOhRUWavCqORVydlrPxcM,SpATywNh6bZuzm8s1ceuBUnMUAeoAHHw,30,52,26,50,12,67,30,3,240,34.285714285714285,4,0.0,19,26,38,12,33,67,12,30,3,95,145,1
3868,77938,OzLs7gFwYfouUVXwjEfaGoBWiTah7ale,SpATywNh6bZuzm8s1ceuBUnMUAeoAHHw,5,2,0,0,0,0,3,0,5,0.7142857142857143,1,0.0,0,0,0,0,2,0,0,3,0,0,5,1
3869,77948,HAqiq102XDB03bRDdmGODD1MUBTXSItL,G8EPVSXsOYB5YQWZGiz1aVq5Pgr2GrQu,13,11,5,8,5,0,6,0,35,5.0,2,0.0,5,5,4,5,6,0,4,6,0,19,16,1
3870,77985,2F24CPGRVpuuQV8bvAX6eV5uD1OH1Kpn,G8EPVSXsOYB5YQWZGiz1aVq5Pgr2GrQu,56,80,29,112,17,23,16,2,279,39.857142857142854,2,0.0,42,29,74,17,38,23,38,16,2,162,117,0
3871,78018,fy5xZE2F1NUrBRDmEbdeJaWR2l3rL5ig,SpATywNh6bZuzm8s1ceuBUnMUAeoAHHw,1,0,0,0,0,0,1,0,1,0.14285714285714285,1,0.0,0,0,0,0,0,0,0,1,0,0,1,1
3872,78064,SfR30NvxnwHQ5GQOQOoN6OMoANxaB8dS,SpATywNh6bZuzm8s1ceuBUnMUAeoAHHw,15,20,11,18,4,0,6,0,59,8.428571428571429,3,0.0,5,11,15,4,15,0,3,6,0,35,24,0
3873,78070,QohXbMcmvW7RNSJxfmP5GzKeuaXyUolt,A3fsA9Zfv1X2fVEQhTw51lKENdNrEqT3,2,0,0,0,0,0,2,0,2,0.2857142857142857,1,0.0,0,0,0,0,0,0,0,2,0,0,2,1
3874,78073,ccbXVA4l2WmbAoIr2ZeJIfHBbUkKPKY8,SpATywNh6bZuzm8s1ceuBUnMUAeoAHHw,5,3,2,0,0,0,2,0,7,1.0,1,0.0,0,2,0,0,3,0,0,2,0,2,5,1
3875,78076,QohXbMcmvW7RNSJxfmP5GzKeuaXyUolt,bWdj2GDclj5ofokWjzoa5jAwMkxCykd6,2,0,0,0,0,0,2,0,2,0.2857142857142857,1,0.0,0,0,0,0,0,0,0,2,0,0,2,1
3876,78085,EBk1CmtgbTvc4xbs4Wf7K9jFvWEzLY93,SpATywNh6bZuzm8s1ceuBUnMUAeoAHHw,4,2,0,0,0,0,2,0,4,0.5714285714285714,1,0.0,0,0,0,0,2,0,0,2,0,0,4,1
3877,78106,hu8eak1Xmf8voE8pnxPzkSD2dZP9Sipf,bWdj2GDclj5ofokWjzoa5jAwMkxCykd6,8,9,0,20,0,4,16,0,49,7.0,6,0.0,2,0,18,0,7,4,2,16,0,20,29,0
3878,78107,UuDjs68Ty88iPLGMXsqZ9bEqUXmWG3bB,RXDvfPUBYFlVdlueBFbLW0mhhAyGEqpt,5,2,1,0,1,0,2,0,6,0.8571428571428571,1,0.0,0,1,0,1,2,0,0,2,0,2,4,1
3879,78131,TCKPmzjJvJ3IQnj25q0Ug4x7iyC4opM1,G8EPVSXsOYB5YQWZGiz1aVq5Pgr2GrQu,10,39,6,10,7,0,2,0,64,9.142857142857142,1,0.0,31,6,7,7,8,0,3,2,0,51,13,1
3880,78134,CNb0Sul2DOkX3VhMOeM6DWqvlrGgHagf,SpATywNh6bZuzm8s1ceuBUnMUAeoAHHw,27,39,17,45,9,1,9,1,121,17.285714285714285,4,0.0,13,17,39,9,26,1,6,9,1,78,43,1
3881,78144,GcwFf1WfRMSdZDYsPn5itkdYlvMUCmT9,SpATywNh6bZuzm8s1ceuBUnMUAeoAHHw,25,44,8,23,4,1,9,2,91,13.0,5,0.0,7,8,21,4,37,1,2,9,2,40,51,0
3882,78146,sFLCac725cSrEUin5pNRyKxt7gjQ6A4F,SpATywNh6bZuzm8s1ceuBUnMUAeoAHHw,1,0,0,0,0,0,1,0,1,0.14285714285714285,1,0.0,0,0,0,0,0,0,0,1,0,0,1,1
3883,78150,fohEc7UwYR3csB1Bpgdq1GKT1TmpT3GW,RXDvfPUBYFlVdlueBFbLW0mhhAyGEqpt,6,3,1,0,0,1,7,0,12,1.7142857142857142,1,0.0,0,1,0,0,3,1,0,7,0,1,11,1
3884,78188,CNb0Sul2DOkX3VhMOeM6DWqvlrGgHagf,bWdj2GDclj5ofokWjzoa5jAwMkxCykd6,7,8,4,0,2,0,6,1,21,3.0,3,0.0,0,4,0,2,8,0,0,6,1,6,15,1
3885,78247,BLoa1RvSOgexbSH4hGzCihmBc8pXd0Db,A3fsA9Zfv1X2fVEQhTw51lKENdNrEqT3,52,73,13,66,10,6,15,5,188,26.857142857142858,4,0.0,1,13,56,10,72,6,10,15,5,80,108,1
3886,78252,CWfEuozBd4liyBTvOMVgNSWJo0S8l1jG,bWdj2GDclj5ofokWjzoa5jAwMkxCykd6,5,2,1,0,1,0,2,0,6,0.8571428571428571,1,0.0,0,1,0,1,2,0,0,2,0,2,4,1
3887,78259,qrEmM3cwwlnfXom63xX0BSDx8s5nHv9K,bWdj2GDclj5ofokWjzoa5jAwMkxCykd6,2,0,0,0,0,0,2,0,2,0.2857142857142857,1,0.0,0,0,0,0,0,0,0,2,0,0,2,1
3888,78275,FVKs2RoZnz9qxmMnghcMqKWH7KjgxJV1,RXDvfPUBYFlVdlueBFbLW0mhhAyGEqpt,7,4,3,0,2,0,1,0,10,1.4285714285714286,1,0.0,0,3,0,2,4,0,0,1,0,5,5,1
3889,78278,VtX4hhecWicdXYhNKnhWUU7LwsYiud5S,bWdj2GDclj5ofokWjzoa5jAwMkxCykd6,1,0,0,0,0,0,1,0,1,0.14285714285714285,1,0.0,0,0,0,0,0,0,0,1,0,0,1,1
3890,78291,eIz1QdRrhcYteukRLgOlTi2GZdnEpdtj,A3fsA9Zfv1X2fVEQhTw51lKENdNrEqT3,4,2,0,0,0,0,2,0,4,0.5714285714285714,1,0.0,0,0,0,0,2,0,0,2,0,0,4,1
3891,78294,kj5o7wMZl1s4q0cggcmipnm7O7L6g4Ps,bWdj2GDclj5ofokWjzoa5jAwMkxCykd6,25,34,17,122,12,7,10,0,202,28.857142857142858,4,0.0,10,17,117,12,24,7,5,10,0,156,46,0
3892,78328,VhJqWY1s8NggIUb1uIcah3mgkAeL4PFu,G8EPVSXsOYB5YQWZGiz1aVq5Pgr2GrQu,1,0,0,0,0,0,1,0,1,0.14285714285714285,1,0.0,0,0,0,0,0,0,0,1,0,0,1,1
3893,78356,l8Cml1vejHI8GVsgohdNxJJsxeTOpjUQ,SpATywNh6bZuzm8s1ceuBUnMUAeoAHHw,18,16,11,5,5,1,6,1,45,6.428571428571429,2,0.0,3,11,4,5,13,1,1,6,1,23,22,1
3894,78364,v6o58htBZfIjF729xn3THeVFCKiQP2tT,G8EPVSXsOYB5YQWZGiz1aVq5Pgr2GrQu,14,14,2,0,2,2,4,1,25,3.5714285714285716,2,0.0,1,2,0,2,13,2,0,4,1,5,20,1
3895,78367,DC7ZPAOAq4kNVVbfZX7lyJLqoL2DWXgr,SpATywNh6bZuzm8s1ceuBUnMUAeoAHHw,7,9,5,0,4,0,2,0,20,2.857142857142857,1,0.0,0,5,0,4,9,0,0,2,0,9,11,1
3896,78379,J4Fo8v0uo0dR8AKSqg2SMkO8YLPwA09H,G8EPVSXsOYB5YQWZGiz1aVq5Pgr2GrQu,1,0,0,0,0,0,4,0,4,0.5714285714285714,1,0.0,0,0,0,0,0,0,0,4,0,0,4,1
3897,78385,dovSPYooNHmzLLH97Ddy4FG7Uxhw5XJl,SpATywNh6bZuzm8s1ceuBUnMUAeoAHHw,4,4,0,0,0,0,2,0,6,0.8571428571428571,1,0.0,0,0,0,0,4,0,0,2,0,0,6,1
3898,78406,fsn9YvLK8wuINxunCG4BkE8FOh4c3KxI,SpATywNh6bZuzm8s1ceuBUnMUAeoAHHw,7,8,0,0,0,0,1,0,9,1.2857142857142858,1,0.0,2,0,0,0,6,0,0,1,0,2,7,1
3899,78429,HLfj9ZxtIK3gYbcHFCAqaNCGqWLq7h1g,SpATywNh6bZuzm8s1ceuBUnMUAeoAHHw,24,28,1,32,0,4,10,2,77,11.0,1,0.0,9,1,29,0,19,4,3,10,2,39,38,0
3900,78452,ukfWsseqqJzHHxAFnLMKYh1SZzExeQ1z,SpATywNh6bZuzm8s1ceuBUnMUAeoAHHw,5,5,1,0,0,0,2,0,8,1.1428571428571428,2,0.0,0,1,0,0,5,0,0,2,0,1,7,1
3901,78454,4N9xQarXAZMYyOjOJvMQmOHnVfoe0iL0,bWdj2GDclj5ofokWjzoa5jAwMkxCykd6,5,2,1,0,1,0,2,0,6,0.8571428571428571,1,0.0,0,1,0,1,2,0,0,2,0,2,4,1
3902,78462,4N9xQarXAZMYyOjOJvMQmOHnVfoe0iL0,A3fsA9Zfv1X2fVEQhTw51lKENdNrEqT3,2,0,0,0,0,0,4,0,4,0.5714285714285714,2,0.0,0,0,0,0,0,0,0,4,0,0,4,1
3903,78478,CVkN7W2203PPB4rzsX0i8SBpQ0bSRkaq,SpATywNh6bZuzm8s1ceuBUnMUAeoAHHw,13,14,9,0,5,0,5,0,33,4.714285714285714,3,0.0,2,9,0,5,12,0,0,5,0,16,17,1
3904,78546,Ckb71Ev9RlsIUvVDfkFS0AumQJilppvB,G8EPVSXsOYB5YQWZGiz1aVq5Pgr2GrQu,6,5,3,0,2,0,4,0,14,2.0,2,0.0,0,3,0,2,5,0,0,4,0,5,9,1
3905,78552,J3O8yjXr4pvdR3n8Y9AW4odHeMijwVD2,bWdj2GDclj5ofokWjzoa5jAwMkxCykd6,1,0,0,0,0,0,1,0,1,0.14285714285714285,1,0.0,0,0,0,0,0,0,0,1,0,0,1,1
3906,78554,byxGWUJV72XqYw0RcV5v8EuZ9oh6gief,A3fsA9Zfv1X2fVEQhTw51lKENdNrEqT3,5,2,1,0,1,0,2,0,6,0.8571428571428571,1,0.0,0,1,0,1,2,0,0,2,0,2,4,1
3907,78563,Q0vBzPj4VWPVd7xoAbS8zktOTeProdeI,SpATywNh6bZuzm8s1ceuBUnMUAeoAHHw,3,0,0,0,0,0,3,0,3,0.42857142857142855,1,0.0,0,0,0,0,0,0,0,3,0,0,3,1
3908,78566,5maEerTJ8LtZeFZwRiLIZfXoq0lcubLt,SpATywNh6bZuzm8s1ceuBUnMUAeoAHHw,6,1,0,0,0,1,5,1,8,1.1428571428571428,1,0.0,0,0,0,0,1,1,0,5,1,0,8,1
3909,78591,W7aaCFsYNegloRh1IlKOwq22jdh9r52p,bWdj2GDclj5ofokWjzoa5jAwMkxCykd6,6,3,2,0,2,0,1,0,8,1.1428571428571428,1,0.0,0,2,0,2,3,0,0,1,0,4,4,1
3910,78603,7u0QfTKQg4itZK9m8foLXkIGwUxxHMsT,SpATywNh6bZuzm8s1ceuBUnMUAeoAHHw,29,29,14,14,8,0,6,0,71,10.142857142857142,3,0.0,12,14,13,8,17,0,1,6,0,47,24,0
3911,78614,nMd49DSNNePu4Cd3bHT7FsqsTOmZl63t,SpATywNh6bZuzm8s1ceuBUnMUAeoAHHw,6,4,1,0,1,0,3,0,9,1.2857142857142858,1,0.0,0,1,0,1,4,0,0,3,0,2,7,1
3912,78624,QVaNdoLdCHk4HcXO8MB1JKVhy7nw6JiC,SpATywNh6bZuzm8s1ceuBUnMUAeoAHHw,6,4,2,0,2,0,2,0,10,1.4285714285714286,1,0.0,0,2,0,2,4,0,0,2,0,4,6,1
3913,78643,9QoP6HvypJsXUxtVuM29FbJymaoWAuTM,G8EPVSXsOYB5YQWZGiz1aVq5Pgr2GrQu,1,0,0,0,0,0,1,0,1,0.14285714285714285,1,0.0,0,0,0,0,0,0,0,1,0,0,1,1
3914,78648,fjIKsKO6rizBomnPFn2db56S1nui3RlN,A3fsA9Zfv1X2fVEQhTw51lKENdNrEqT3,50,29,21,68,13,9,11,1,152,21.714285714285715,2,0.0,3,21,58,13,26,9,10,11,1,95,57,1
3915,78671,9keXBjwmh66adK5DT8X8J8K1A8xi7IUl,RXDvfPUBYFlVdlueBFbLW0mhhAyGEqpt,2,0,0,0,0,0,2,0,2,0.2857142857142857,1,0.0,0,0,0,0,0,0,0,2,0,0,2,1
3916,78673,Ufo4AkS2vTW82q9Kpcrkrp0gG0Us5zu9,A3fsA9Zfv1X2fVEQhTw51lKENdNrEqT3,6,3,1,0,1,0,2,0,7,1.0,1,0.0,0,1,0,1,3,0,0,2,0,2,5,1
3917,78682,nVXGW3QRysmVp7bseFXpH5xogt6vyuOe,SpATywNh6bZuzm8s1ceuBUnMUAeoAHHw,4,5,2,0,2,0,1,0,10,1.4285714285714286,1,0.0,0,2,0,2,5,0,0,1,0,4,6,1
3918,78705,xXEgWJZrqICodDuxWm4svOQTBLDSu5hO,SpATywNh6bZuzm8s1ceuBUnMUAeoAHHw,7,7,4,0,2,1,4,0,18,2.5714285714285716,1,0.0,1,4,0,2,6,1,0,4,0,7,11,1
3919,78715,5Zgwu2mRcsc21AmNDehMpm5vDwlgKfhs,SpATywNh6bZuzm8s1ceuBUnMUAeoAHHw,17,19,8,19,4,1,11,2,64,9.142857142857142,2,0.0,8,8,18,4,11,1,1,11,2,38,26,1
3920,78742,rcukprbmUUwwNHHsW6YmnM6VwI4ca3R8,A3fsA9Zfv1X2fVEQhTw51lKENdNrEqT3,14,10,7,0,4,0,6,0,27,3.857142857142857,1,0.0,0,7,0,4,10,0,0,6,0,11,16,0
3921,78786,r62e9eSPsszv1Iv2O1V4lcMcbaHlq1ob,SpATywNh6bZuzm8s1ceuBUnMUAeoAHHw,18,22,2,25,0,0,3,0,52,7.428571428571429,2,0.0,6,2,21,0,16,0,4,3,0,29,23,0
3922,78791,Jio2hP66Psjw6H7dqS3rSmz5gymQvwGj,SpATywNh6bZuzm8s1ceuBUnMUAeoAHHw,7,6,0,1,0,0,2,0,9,1.2857142857142858,1,0.0,1,0,1,0,5,0,0,2,0,2,7,1
3923,78797,5NRnaGcpNIGEuH61FLOcxB7Rjs6WPiNk,SpATywNh6bZuzm8s1ceuBUnMUAeoAHHw,30,47,27,14,10,1,14,0,113,16.142857142857142,4,0.0,9,27,13,10,38,1,1,14,0,59,54,0
3924,78801,jaHWKFBvrvFfPb0Pq50zaMZ2xpeRooXu,A3fsA9Zfv1X2fVEQhTw51lKENdNrEqT3,1,0,0,0,0,0,1,0,1,0.14285714285714285,1,0.0,0,0,0,0,0,0,0,1,0,0,1,0
3925,78827,BfP8PslkevtFenf019uAk6GhN9zhCFdJ,bWdj2GDclj5ofokWjzoa5jAwMkxCykd6,15,26,11,0,7,1,12,1,58,8.285714285714286,1,0.0,6,11,0,7,20,1,0,12,1,24,34,1
3926,78845,900ZMEgjiXT78JdNbM02wL3ugTz6vLs2,G8EPVSXsOYB5YQWZGiz1aVq5Pgr2GrQu,7,6,1,0,0,0,10,0,17,2.4285714285714284,2,0.0,0,1,0,0,6,0,0,10,0,1,16,1
3927,78848,oZKhsAromYlsN9MhR64yAv55dJDSDM8L,G8EPVSXsOYB5YQWZGiz1aVq5Pgr2GrQu,32,34,16,46,8,0,11,1,116,16.571428571428573,5,0.0,10,16,37,8,24,0,9,11,1,71,45,1
3928,78886,pgMwb3FHEjNb1xNpBTJ5ysmRdBbuUNFr,bWdj2GDclj5ofokWjzoa5jAwMkxCykd6,12,11,2,14,2,0,3,0,32,4.571428571428571,3,0.0,1,2,14,2,10,0,0,3,0,19,13,1
3929,78899,XKfrMCVtqlIZ8enVJyGd7DD1q7PXaYx0,RXDvfPUBYFlVdlueBFbLW0mhhAyGEqpt,12,7,1,0,1,1,8,2,20,2.857142857142857,1,0.0,0,1,0,1,7,1,0,8,2,2,18,1
3930,78910,R6RINUtJNooptLfHmBRIBRqFOknkjv0Y,A3fsA9Zfv1X2fVEQhTw51lKENdNrEqT3,32,79,32,0,34,6,31,0,182,26.0,7,0.0,0,32,0,34,79,6,0,31,0,66,116,1
3931,78918,8Sqo9fjyeTTkNJlQMuecsmvzSyQTiwcU,bWdj2GDclj5ofokWjzoa5jAwMkxCykd6,4,2,0,0,0,0,6,0,8,1.1428571428571428,1,0.0,0,0,0,0,2,0,0,6,0,0,8,1
3932,78924,E96VmAw6m1AOHRckdqiq2ASKbnHBlpAb,bWdj2GDclj5ofokWjzoa5jAwMkxCykd6,1,0,0,0,0,0,3,0,3,0.42857142857142855,3,0.0,0,0,0,0,0,0,0,3,0,0,3,1
3933,78930,E96VmAw6m1AOHRckdqiq2ASKbnHBlpAb,G8EPVSXsOYB5YQWZGiz1aVq5Pgr2GrQu,5,3,1,0,1,0,3,0,8,1.1428571428571428,2,0.0,0,1,0,1,3,0,0,3,0,2,6,0
3934,78943,9V8VFOZzrHxUcwRnnOPkl8rtMgpamwhU,SpATywNh6bZuzm8s1ceuBUnMUAeoAHHw,21,12,9,10,6,0,2,0,39,5.571428571428571,2,0.0,2,9,9,6,10,0,1,2,0,26,13,1
3935,78953,AZZvRPcRkLSa6vwofzfwsEULTUhiKy0E,SpATywNh6bZuzm8s1ceuBUnMUAeoAHHw,30,101,38,27,10,83,58,3,320,45.714285714285715,11,0.0,26,38,24,10,75,83,3,58,3,98,222,0
3936,78954,NTiEDRwIJDqquqeFtNjQXUg4Zc46ytbZ,A3fsA9Zfv1X2fVEQhTw51lKENdNrEqT3,6,3,1,0,1,0,2,0,7,1.0,1,0.0,0,1,0,1,3,0,0,2,0,2,5,1
3937,78971,d1mccaMvv72HL0M2QdKzu9aosPAbZ4Jm,SpATywNh6bZuzm8s1ceuBUnMUAeoAHHw,23,32,4,15,3,7,3,1,65,9.285714285714286,3,0.0,5,4,15,3,27,7,0,3,1,27,38,0
3938,78976,lcVqjHqBHtoTMy2BSyBnlkYx5IiPAsSb,bWdj2GDclj5ofokWjzoa5jAwMkxCykd6,7,3,2,0,2,0,2,0,9,1.2857142857142858,1,0.0,0,2,0,2,3,0,0,2,0,4,5,1
3939,79024,PK7vOojKKM8ZMg0GtBGDF9d0jIW1oXVZ,RXDvfPUBYFlVdlueBFbLW0mhhAyGEqpt,28,35,23,41,11,4,7,2,123,17.571428571428573,2,0.0,6,23,36,11,29,4,5,7,2,76,47,1
3940,79034,BvXEJOM5AeibxeBR17cOLsAehRuv6EQw,SpATywNh6bZuzm8s1ceuBUnMUAeoAHHw,6,3,2,0,2,0,1,0,8,1.1428571428571428,1,0.0,0,2,0,2,3,0,0,1,0,4,4,1
3941,79037,RMjCtTkNaNDIV51mcacmsIEv4W4wGcOW,RXDvfPUBYFlVdlueBFbLW0mhhAyGEqpt,5,2,1,0,1,0,2,0,6,0.8571428571428571,1,0.0,0,1,0,1,2,0,0,2,0,2,4,1
3942,79065,0baA6sMZRRooPzlc3eqoVKOLHs7oBMf1,SpATywNh6bZuzm8s1ceuBUnMUAeoAHHw,1,0,0,0,0,0,1,0,1,0.14285714285714285,1,0.0,0,0,0,0,0,0,0,1,0,0,1,1
3943,79085,jByBG50ghoSer5UP92qpkAfDGFpraaH7,RXDvfPUBYFlVdlueBFbLW0mhhAyGEqpt,3,0,0,0,0,0,3,0,3,0.42857142857142855,2,0.0,0,0,0,0,0,0,0,3,0,0,3,1
3944,79088,oA5bEHkRJtiDJKnesmAjUtrhTVSOkHe2,SpATywNh6bZuzm8s1ceuBUnMUAeoAHHw,18,30,19,14,11,0,7,0,81,11.571428571428571,3,0.0,6,19,13,11,24,0,1,7,0,49,32,1
3945,79114,oBHfkEBZPsjUqPWXyw1yW9Gipn9KMPDQ,SpATywNh6bZuzm8s1ceuBUnMUAeoAHHw,10,19,8,0,4,0,5,0,36,5.142857142857143,3,0.0,0,8,0,4,19,0,0,5,0,12,24,1
3946,79115,DGHGkVhiaZ33J21HoxaqqxRbqavzVFGk,A3fsA9Zfv1X2fVEQhTw51lKENdNrEqT3,10,16,1,0,1,0,5,0,23,3.2857142857142856,1,0.0,0,1,0,1,16,0,0,5,0,2,21,1
3947,79116,oeEXBADlWmjYmDN9P4tzDfKaayj6OdaD,G8EPVSXsOYB5YQWZGiz1aVq5Pgr2GrQu,31,53,20,62,7,3,10,3,158,22.571428571428573,2,0.0,28,20,40,7,25,3,22,10,3,95,63,1
3948,79128,Ph6B1QAiUfnOFxg1hNL5nD7wXbSCaM6i,G8EPVSXsOYB5YQWZGiz1aVq5Pgr2GrQu,30,28,23,44,11,0,16,2,124,17.714285714285715,2,0.0,0,23,38,11,28,0,6,16,2,72,52,1
3949,79150,1anSA7G3nrsDO0JSarewPnqCvjcLjtpi,SpATywNh6bZuzm8s1ceuBUnMUAeoAHHw,10,21,8,4,2,0,6,0,41,5.857142857142857,3,0.0,0,8,4,2,21,0,0,6,0,14,27,0
3950,79164,wGfXRYqHkdAo1fVEEY9NvW8qy6M9m0mI,A3fsA9Zfv1X2fVEQhTw51lKENdNrEqT3,51,69,32,62,18,52,25,6,264,37.714285714285715,7,0.0,3,32,59,18,66,52,3,25,6,112,152,1
3951,79191,xjuSmklePl6doFxX117CjHgupR8gIiqr,G8EPVSXsOYB5YQWZGiz1aVq5Pgr2GrQu,6,5,1,0,1,0,3,0,10,1.4285714285714286,1,0.0,0,1,0,1,5,0,0,3,0,2,8,1
3952,79208,88xoeZRrDqjjjrf57zHp7JPU0EIVMG6O,SpATywNh6bZuzm8s1ceuBUnMUAeoAHHw,9,11,0,14,0,0,3,0,28,4.0,2,0.0,5,0,14,0,6,0,0,3,0,19,9,1
3953,79213,kuV0mzlgGFUIK4wXcwcPFRatONM4P10L,SpATywNh6bZuzm8s1ceuBUnMUAeoAHHw,15,24,10,23,1,0,7,0,65,9.285714285714286,3,0.0,9,10,18,1,15,0,5,7,0,38,27,0
3954,79232,SSC60v48DtGYrHD9najK5BurQrkLKWXS,SpATywNh6bZuzm8s1ceuBUnMUAeoAHHw,1,0,0,0,0,0,1,0,1,0.14285714285714285,1,0.0,0,0,0,0,0,0,0,1,0,0,1,1
3955,79265,V1B34PKYcESnicIbQVUA4gpuU2uOqNWz,bWdj2GDclj5ofokWjzoa5jAwMkxCykd6,10,27,10,0,4,0,8,0,49,7.0,2,0.0,7,10,0,4,20,0,0,8,0,21,28,1
3956,79268,V1B34PKYcESnicIbQVUA4gpuU2uOqNWz,SpATywNh6bZuzm8s1ceuBUnMUAeoAHHw,10,12,11,0,5,4,9,1,42,6.0,2,0.0,0,11,0,5,12,4,0,9,1,16,26,1
3957,79269,1bKMONcV6Mq58szdlIajPdFyqaw4BvrA,bWdj2GDclj5ofokWjzoa5jAwMkxCykd6,5,2,1,0,1,0,2,0,6,0.8571428571428571,1,0.0,0,1,0,1,2,0,0,2,0,2,4,1
3958,79274,aS1MRv3e3cFJbWfbj7uedfCUW4ml1QfE,SpATywNh6bZuzm8s1ceuBUnMUAeoAHHw,18,29,20,6,8,0,8,0,71,10.142857142857142,3,0.0,2,20,5,8,27,0,1,8,0,35,36,0
3959,79296,q84ghl694GzSAMHfGeDgZUVdIow6vpJO,SpATywNh6bZuzm8s1ceuBUnMUAeoAHHw,13,19,9,4,6,0,1,0,39,5.571428571428571,2,0.0,8,9,4,6,11,0,0,1,0,27,12,1
3960,79317,9L22i5qdoV8PU8pyjQgR5HeuxRCoRVpK,SpATywNh6bZuzm8s1ceuBUnMUAeoAHHw,24,44,25,15,14,0,7,0,105,15.0,3,0.0,0,25,13,14,44,0,2,7,0,52,53,1
3961,79322,b9hN1tjIpM67gB8PuwPQ3u561lqo1V2f,RXDvfPUBYFlVdlueBFbLW0mhhAyGEqpt,12,11,9,0,6,0,11,3,40,5.714285714285714,3,0.0,0,9,0,6,11,0,0,11,3,15,25,0
3962,79339,PNuCKnyPWCRVxphTjJ1pIquyKu0dURK7,A3fsA9Zfv1X2fVEQhTw51lKENdNrEqT3,4,3,1,0,0,0,2,0,6,0.8571428571428571,1,0.0,0,1,0,0,3,0,0,2,0,1,5,1
3963,79353,SHRanMph56qnHJKMofxrIA8VyLg99gvL,bWdj2GDclj5ofokWjzoa5jAwMkxCykd6,4,4,0,0,0,0,2,0,6,0.8571428571428571,2,0.0,0,0,0,0,4,0,0,2,0,0,6,0
3964,79354,gBZ3DHDU78LvTtx2wVh6bkCOt1eL771m,A3fsA9Zfv1X2fVEQhTw51lKENdNrEqT3,11,11,1,0,1,0,5,0,18,2.5714285714285716,2,0.0,0,1,0,1,11,0,0,5,0,2,16,1
3965,79387,GCu64KhvD3k4ysmsfT3aBU2fTrWS3rtB,SpATywNh6bZuzm8s1ceuBUnMUAeoAHHw,5,5,0,0,0,0,2,0,7,1.0,1,0.0,0,0,0,0,5,0,0,2,0,0,7,1
3966,79391,Q3913BpDariYbEj8ZlFy9MQJV1rZlZAJ,SpATywNh6bZuzm8s1ceuBUnMUAeoAHHw,6,10,1,2,0,0,3,0,16,2.2857142857142856,3,0.0,1,1,2,0,9,0,0,3,0,4,12,1
3967,79403,xWXhCGrW03YluuceUyewYdqXryhbgrdd,SpATywNh6bZuzm8s1ceuBUnMUAeoAHHw,9,4,1,0,1,5,6,1,18,2.5714285714285716,1,0.0,0,1,0,1,4,5,0,6,1,2,16,1
3968,79433,1WrKf0VE4OvwmI8ZMK9zpJFtYHCCItqb,SpATywNh6bZuzm8s1ceuBUnMUAeoAHHw,1,0,0,0,0,0,1,0,1,0.14285714285714285,1,0.0,0,0,0,0,0,0,0,1,0,0,1,1
3969,79439,crl3o7sxyMWLnKWiaz3BBw0rhIdF3cXr,bWdj2GDclj5ofokWjzoa5jAwMkxCykd6,19,26,1,54,2,12,17,1,113,16.142857142857142,2,0.0,13,1,53,2,13,12,1,17,1,69,44,1
3970,79442,mCWUqPjCgQQazWm9jyDsH7XslBjGoVeA,SpATywNh6bZuzm8s1ceuBUnMUAeoAHHw,18,12,9,0,7,0,5,0,33,4.714285714285714,1,0.0,0,9,0,7,12,0,0,5,0,16,17,1
3971,79449,qwFDXKt0M8f2bQWHQ9IwMnRpFGf93NNf,SpATywNh6bZuzm8s1ceuBUnMUAeoAHHw,16,20,11,23,4,1,12,1,72,10.285714285714286,6,0.0,2,11,18,4,18,1,5,12,1,35,37,1
3972,79450,IKVKcza5vT9JehCbhoro1CRnVpL575lj,SpATywNh6bZuzm8s1ceuBUnMUAeoAHHw,15,9,5,3,3,0,5,0,25,3.5714285714285716,2,0.0,3,5,3,3,6,0,0,5,0,14,11,1
3973,79466,fu60FMGFqAwgUp8glfVKZNcdqYonSFb4,A3fsA9Zfv1X2fVEQhTw51lKENdNrEqT3,12,11,3,0,2,0,7,0,23,3.2857142857142856,1,0.0,0,3,0,2,11,0,0,7,0,5,18,1
3974,79481,IHB272IdBeuDM3MeGjnOfHr8AhA89HNb,RXDvfPUBYFlVdlueBFbLW0mhhAyGEqpt,43,48,33,63,11,25,9,0,189,27.0,3,0.0,9,33,55,11,39,25,8,9,0,108,81,1
3975,79483,i39wrwOFUT4cBFVx9tMMQ3lQ2qJwZK9W,A3fsA9Zfv1X2fVEQhTw51lKENdNrEqT3,18,21,11,0,6,4,6,2,50,7.142857142857143,3,0.0,0,11,0,6,21,4,0,6,2,17,33,1
3976,79509,G0i0hCTwH2K62ld1aO6Hf5Ntp0ahokSh,SpATywNh6bZuzm8s1ceuBUnMUAeoAHHw,30,62,29,19,11,16,43,4,184,26.285714285714285,5,0.0,14,29,19,11,48,16,0,43,4,73,111,0
3977,79519,NUQJxbePNRtXQQBXCQFchv4ww5sWUrml,SpATywNh6bZuzm8s1ceuBUnMUAeoAHHw,26,46,0,41,1,3,25,1,117,16.714285714285715,5,0.0,15,0,35,1,31,3,6,25,1,51,66,0
3978,79538,68aPv7D3ZE4JVkIRm8IjOcsEwxcFlwFO,A3fsA9Zfv1X2fVEQhTw51lKENdNrEqT3,3,3,0,0,0,0,1,0,4,0.5714285714285714,1,0.0,0,0,0,0,3,0,0,1,0,0,4,1
3979,79548,xt59FC0u82DgUh4CRpEaJwaXZlH1aLO1,SpATywNh6bZuzm8s1ceuBUnMUAeoAHHw,26,45,29,12,20,0,15,1,122,17.428571428571427,4,0.0,9,29,11,20,36,0,1,15,1,69,53,0
3980,79555,ygHFzUOzEqkLxFm5OclfxvG9i48BUAuT,SpATywNh6bZuzm8s1ceuBUnMUAeoAHHw,17,37,3,0,1,10,11,3,65,9.285714285714286,4,0.0,3,3,0,1,34,10,0,11,3,7,58,0
3981,79576,w1E1CWgFfuFOCR0VzQkihC3ia5yrssmV,RXDvfPUBYFlVdlueBFbLW0mhhAyGEqpt,1,0,0,0,0,0,1,0,1,0.14285714285714285,1,0.0,0,0,0,0,0,0,0,1,0,0,1,1
3982,79592,D6jwUujWuVnAZzyPLog7cSVfWJ6qOkhT,SpATywNh6bZuzm8s1ceuBUnMUAeoAHHw,22,33,0,31,0,11,17,4,96,13.714285714285714,1,0.0,15,0,28,0,18,11,3,17,4,43,53,1
3983,79604,ZbdgVvxsxyG1aqBQ8n6eLVu27gWAZvhX,bWdj2GDclj5ofokWjzoa5jAwMkxCykd6,1,0,0,0,0,0,1,0,1,0.14285714285714285,1,0.0,0,0,0,0,0,0,0,1,0,0,1,1
3984,79619,Z21gQGlXtQP1JO0odoLDtH3q2Pa791DY,bWdj2GDclj5ofokWjzoa5jAwMkxCykd6,8,25,12,0,6,3,9,3,58,8.285714285714286,3,0.0,7,12,0,6,18,3,0,9,3,25,33,1
3985,79633,om6ZOCO8LNIrRrNbdISrPEP9oSUDMJl3,SpATywNh6bZuzm8s1ceuBUnMUAeoAHHw,21,15,11,18,8,1,8,1,62,8.857142857142858,1,0.0,2,11,16,8,13,1,2,8,1,37,25,1
3986,79634,rScZ8wYdCfayAwidHm4E5aYRTim0GnWj,bWdj2GDclj5ofokWjzoa5jAwMkxCykd6,6,11,3,0,5,0,5,0,24,3.4285714285714284,1,0.0,6,3,0,5,5,0,0,5,0,14,10,1
3987,79647,y8iVrI2EkMZTkanlXaBHyxYcB0wN7UeI,SpATywNh6bZuzm8s1ceuBUnMUAeoAHHw,4,3,1,0,1,0,1,0,6,0.8571428571428571,1,0.0,0,1,0,1,3,0,0,1,0,2,4,1
3988,79661,yh14zaFitCUTgvBPqRXiaZ6cUijtktL4,bWdj2GDclj5ofokWjzoa5jAwMkxCykd6,5,2,1,0,1,0,2,0,6,0.8571428571428571,1,0.0,0,1,0,1,2,0,0,2,0,2,4,1
3989,79668,7nUtazUwwSnnXJpIKdQBJGpXV6Po42DQ,bWdj2GDclj5ofokWjzoa5jAwMkxCykd6,21,34,3,127,6,0,19,0,189,27.0,3,0.0,9,3,121,6,25,0,6,19,0,139,50,1
3990,79671,3njhidxBzYHOjpYDGROQcUAReorseJK1,RXDvfPUBYFlVdlueBFbLW0mhhAyGEqpt,1,0,0,0,0,0,1,0,1,0.14285714285714285,1,0.0,0,0,0,0,0,0,0,1,0,0,1,1
3991,79675,a8972vl53XxyEoK7iq5Ba0NkWofUNUyo,SpATywNh6bZuzm8s1ceuBUnMUAeoAHHw,5,3,0,0,0,0,2,0,5,0.7142857142857143,2,0.0,0,0,0,0,3,0,0,2,0,0,5,1
3992,79711,SUK7J6JSzTvdTuqtYmCn1wzdta5Gs77Z,SpATywNh6bZuzm8s1ceuBUnMUAeoAHHw,1,0,0,0,0,0,1,0,1,0.14285714285714285,1,0.0,0,0,0,0,0,0,0,1,0,0,1,1
3993,79712,840TvauCMn8hUpsV90vm3IXVVzLXLwLs,bWdj2GDclj5ofokWjzoa5jAwMkxCykd6,4,7,2,0,1,0,1,0,11,1.5714285714285714,1,0.0,0,2,0,1,7,0,0,1,0,3,8,1
3994,79735,e9EeV5SqA2AUMzzKRuYh9383pOYfTL5t,A3fsA9Zfv1X2fVEQhTw51lKENdNrEqT3,7,7,0,0,0,0,5,0,12,1.7142857142857142,2,0.0,0,0,0,0,7,0,0,5,0,0,12,1
3995,79743,uDLWNQEFPK65POXXo6bGzcLJ0lsyHLLH,SpATywNh6bZuzm8s1ceuBUnMUAeoAHHw,21,15,8,18,6,0,2,0,49,7.0,1,0.0,5,8,15,6,10,0,3,2,0,34,15,1
3996,79755,rfBYCgJ4870BiJSVIuZN0gKGiTat9rVl,SpATywNh6bZuzm8s1ceuBUnMUAeoAHHw,2,0,0,0,0,0,2,0,2,0.2857142857142857,1,0.0,0,0,0,0,0,0,0,2,0,0,2,1
3997,79761,ffg9VbmMkFKj2DfO61ClA5PDHr5Xa6gN,SpATywNh6bZuzm8s1ceuBUnMUAeoAHHw,11,22,14,2,7,0,7,0,52,7.428571428571429,5,0.0,0,14,2,7,22,0,0,7,0,23,29,0
3998,79768,WdB4AHM5Haltuxu4ztk7CYoMHww58fwR,SpATywNh6bZuzm8s1ceuBUnMUAeoAHHw,1,0,0,0,0,0,1,0,1,0.14285714285714285,1,0.0,0,0,0,0,0,0,0,1,0,0,1,1
3999,79801,Tdve80vJG7bg0NAfZoErDkCePh9ZdZtG,SpATywNh6bZuzm8s1ceuBUnMUAeoAHHw,9,10,6,0,3,0,5,1,25,3.5714285714285716,2,0.0,1,6,0,3,9,0,0,5,1,10,15,1
4000,79802,nVaguRnMzumbu6IYJqT40xfdj6StQFDm,bWdj2GDclj5ofokWjzoa5jAwMkxCykd6,4,4,1,0,1,0,2,0,8,1.1428571428571428,1,0.0,2,1,0,1,2,0,0,2,0,4,4,1
4001,79809,5tD3trtPQ6jzqFRimP1PMPhgvFtRmfA4,SpATywNh6bZuzm8s1ceuBUnMUAeoAHHw,15,27,6,9,1,3,12,0,58,8.285714285714286,3,0.0,7,6,9,1,20,3,0,12,0,23,35,1
4002,79818,dCAqk9uHiS99GMTcJQtThG8XWnwwbp5Q,SpATywNh6bZuzm8s1ceuBUnMUAeoAHHw,27,46,10,29,4,3,9,1,102,14.571428571428571,3,0.0,21,10,26,4,25,3,3,9,1,61,41,1
4003,79822,WUz9eKwwTabZi4dE6GkJ03kYfBXiol2h,A3fsA9Zfv1X2fVEQhTw51lKENdNrEqT3,2,0,0,0,0,9,6,0,15,2.142857142857143,3,0.0,0,0,0,0,0,9,0,6,0,0,15,1
4004,79831,7kTdvih7UMOiFKC9aXRp88JppGP4qSKH,SpATywNh6bZuzm8s1ceuBUnMUAeoAHHw,23,26,13,16,6,0,4,0,65,9.285714285714286,3,0.0,4,13,15,6,22,0,1,4,0,38,27,1
4005,79838,s5zDvm6xFFkPgy4oe8OGNGVHxFpWHGBV,SpATywNh6bZuzm8s1ceuBUnMUAeoAHHw,17,14,6,20,4,2,5,1,52,7.428571428571429,1,0.0,7,6,16,4,7,2,4,5,1,33,19,1
4006,79869,f3vfjinjwis5qk6FJAP4uRDxySTgo1bo,G8EPVSXsOYB5YQWZGiz1aVq5Pgr2GrQu,7,3,2,0,2,0,2,0,9,1.2857142857142858,1,0.0,0,2,0,2,3,0,0,2,0,4,5,1
4007,79878,ccvSRrE3qWZJWxhZblz5YcekpwGotPgS,SpATywNh6bZuzm8s1ceuBUnMUAeoAHHw,14,16,4,1,2,1,14,0,38,5.428571428571429,3,0.0,2,4,1,2,14,1,0,14,0,9,29,1
4008,79894,x3bTgsr7QSCiaq6OJXRLOfvMZYUxrJaI,bWdj2GDclj5ofokWjzoa5jAwMkxCykd6,10,5,4,0,4,0,1,0,14,2.0,1,0.0,0,4,0,4,5,0,0,1,0,8,6,1
4009,79907,Q2dKqJgalCRkN8Z90Lq1SNPa32DtEIlR,bWdj2GDclj5ofokWjzoa5jAwMkxCykd6,1,0,0,0,0,0,1,0,1,0.14285714285714285,1,0.0,0,0,0,0,0,0,0,1,0,0,1,1
4010,79942,og3zNDLl7XmMMAhbJtxTc4Nj33wztyot,SpATywNh6bZuzm8s1ceuBUnMUAeoAHHw,6,3,1,0,0,0,4,1,9,1.2857142857142858,1,0.0,0,1,0,0,3,0,0,4,1,1,8,1
4011,79956,hcKYo6bLhlANvHE0FxLuR4YY8jocfBwJ,A3fsA9Zfv1X2fVEQhTw51lKENdNrEqT3,9,14,0,0,0,28,3,0,45,6.428571428571429,2,0.0,0,0,0,0,14,28,0,3,0,0,45,1
4012,79975,Z3TCNncfxAFUErtBz9OqcQV0lBb4yIuz,SpATywNh6bZuzm8s1ceuBUnMUAeoAHHw,13,20,0,10,0,1,8,0,39,5.571428571428571,1,0.0,10,0,10,0,10,1,0,8,0,20,19,1
4013,79984,oKZwUGrYHqdyevQMbQx5wJjMj1yq2zA6,A3fsA9Zfv1X2fVEQhTw51lKENdNrEqT3,5,5,2,0,0,0,3,0,10,1.4285714285714286,2,0.0,0,2,0,0,5,0,0,3,0,2,8,1
4014,79995,vkOVdQ2Pc6HLkOn2fNIG8JE1qzNLpnwN,RXDvfPUBYFlVdlueBFbLW0mhhAyGEqpt,5,4,0,0,0,0,2,0,6,0.8571428571428571,1,0.0,0,0,0,0,4,0,0,2,0,0,6,1
4015,79998,q3XMARasETEzJyvJUxEAfFYsH6Z5s8Zv,bWdj2GDclj5ofokWjzoa5jAwMkxCykd6,8,13,5,0,1,6,11,0,36,5.142857142857143,4,0.0,0,5,0,1,13,6,0,11,0,6,30,0
4016,80019,YOBshYgk5gyR7XdL7ay26cecY2tdQtWp,SpATywNh6bZuzm8s1ceuBUnMUAeoAHHw,22,42,23,22,0,3,14,4,108,15.428571428571429,3,0.0,9,23,18,0,33,3,4,14,4,50,58,0
4017,80040,4AJWWnsd8QGDSRF4HLmdDQcz8kiBAcGz,SpATywNh6bZuzm8s1ceuBUnMUAeoAHHw,10,16,11,0,6,0,7,0,40,5.714285714285714,3,0.0,1,11,0,6,15,0,0,7,0,18,22,1
4018,80092,IAOTVxG7e06ArppQIZcVBCeppiZS52Zi,G8EPVSXsOYB5YQWZGiz1aVq5Pgr2GrQu,1,0,0,0,0,0,1,0,1,0.14285714285714285,1,0.0,0,0,0,0,0,0,0,1,0,0,1,1
4019,80093,IAOTVxG7e06ArppQIZcVBCeppiZS52Zi,RXDvfPUBYFlVdlueBFbLW0mhhAyGEqpt,1,0,0,0,0,0,1,0,1,0.14285714285714285,1,0.0,0,0,0,0,0,0,0,1,0,0,1,1
4020,80138,TcTuC5hiyHRmVc5qZWpzVJY3ugVLXB30,SpATywNh6bZuzm8s1ceuBUnMUAeoAHHw,4,2,0,0,0,0,5,0,7,1.0,2,0.0,0,0,0,0,2,0,0,5,0,0,7,1
4021,80163,qepVwgjKQRsdgtfeDxtXZatdyxHVESv4,SpATywNh6bZuzm8s1ceuBUnMUAeoAHHw,11,17,1,0,0,4,9,1,32,4.571428571428571,2,0.0,0,1,0,0,17,4,0,9,1,1,31,1
4022,80164,6iOLSqRTRABETCaDgzA6NufDV3dLbSSl,A3fsA9Zfv1X2fVEQhTw51lKENdNrEqT3,2,0,0,0,0,0,2,0,2,0.2857142857142857,1,0.0,0,0,0,0,0,0,0,2,0,0,2,1
4023,80177,BHKXnEVm5p8zUlT49NSc8LjGWmHUvROs,SpATywNh6bZuzm8s1ceuBUnMUAeoAHHw,7,2,1,0,1,0,6,0,10,1.4285714285714286,1,0.0,0,1,0,1,2,0,0,6,0,2,8,1
4024,80185,BHKXnEVm5p8zUlT49NSc8LjGWmHUvROs,RXDvfPUBYFlVdlueBFbLW0mhhAyGEqpt,1,0,0,0,0,0,1,0,1,0.14285714285714285,1,0.0,0,0,0,0,0,0,0,1,0,0,1,1
4025,80195,aZzurUzXBMxrnGRFBA3YxJsNpq6Cyxbm,SpATywNh6bZuzm8s1ceuBUnMUAeoAHHw,7,6,5,0,0,0,1,0,12,1.7142857142857142,1,0.0,0,5,0,0,6,0,0,1,0,5,7,0
4026,80216,GkgOdr5534YC0rxEW6eOGTvUI1TnqsRC,SpATywNh6bZuzm8s1ceuBUnMUAeoAHHw,5,2,1,0,1,0,2,0,6,0.8571428571428571,1,0.0,0,1,0,1,2,0,0,2,0,2,4,1
4027,80236,V9sr2zgjH2joKkLVi0Sqvx5Qp7qYhjJ9,A3fsA9Zfv1X2fVEQhTw51lKENdNrEqT3,9,9,1,0,1,0,2,0,13,1.8571428571428572,2,0.0,0,1,0,1,9,0,0,2,0,2,11,1
4028,80247,eYRBHvvJOtQ80CX15zmkpE9dCWbRpi7K,SpATywNh6bZuzm8s1ceuBUnMUAeoAHHw,5,2,1,0,1,0,2,0,6,0.8571428571428571,1,0.0,0,1,0,1,2,0,0,2,0,2,4,0
4029,80251,P6CjwZWiHeS0SJlPQAf4bN1TR1u7fnyP,A3fsA9Zfv1X2fVEQhTw51lKENdNrEqT3,14,13,10,0,7,2,9,2,43,6.142857142857143,2,0.0,0,10,0,7,13,2,0,9,2,17,26,0
4030,80300,GUw906kJ57cW8NGG6UWBrUmH3fuOQE9A,SpATywNh6bZuzm8s1ceuBUnMUAeoAHHw,1,0,0,0,0,0,1,0,1,0.14285714285714285,1,0.0,0,0,0,0,0,0,0,1,0,0,1,1
4031,80319,4cRZxyVNjv13lU3nu2aK2rwyndExVCGa,SpATywNh6bZuzm8s1ceuBUnMUAeoAHHw,5,4,1,0,1,0,3,0,9,1.2857142857142858,2,0.0,0,1,0,1,4,0,0,3,0,2,7,0
4032,80320,pz6FqQOVyf4J4lzlAfhLNtZDyqwAxEPh,A3fsA9Zfv1X2fVEQhTw51lKENdNrEqT3,12,9,6,0,5,0,3,0,23,3.2857142857142856,1,0.0,0,6,0,5,9,0,0,3,0,11,12,1
4033,80326,Y3w6vYVJTXZRYwblrdBFP6YHJ2PSSEq2,RXDvfPUBYFlVdlueBFbLW0mhhAyGEqpt,21,30,21,0,0,0,4,0,55,7.857142857142857,1,0.0,3,21,0,0,27,0,0,4,0,24,31,0
4034,80342,eq0DfIOiXorIpuNIOqxe4ooh3gnV5qKw,A3fsA9Zfv1X2fVEQhTw51lKENdNrEqT3,7,3,2,0,2,0,3,0,10,1.4285714285714286,1,0.0,0,2,0,2,3,0,0,3,0,4,6,1
4035,80366,0wJhtCWK60WPCeRF62m8T80DtNpWhRrg,bWdj2GDclj5ofokWjzoa5jAwMkxCykd6,1,0,0,0,0,0,1,0,1,0.14285714285714285,1,0.0,0,0,0,0,0,0,0,1,0,0,1,1
4036,80372,qrXtlHZ3b3drLfwVarPNRUa07Lp9hqJh,SpATywNh6bZuzm8s1ceuBUnMUAeoAHHw,2,0,0,0,0,0,2,0,2,0.2857142857142857,1,0.0,0,0,0,0,0,0,0,2,0,0,2,1
4037,80386,RXKLhNquRsGdvYtQGHp0VVbeAvXlNqmn,SpATywNh6bZuzm8s1ceuBUnMUAeoAHHw,2,0,0,0,0,0,3,0,3,0.42857142857142855,1,0.0,0,0,0,0,0,0,0,3,0,0,3,1
4038,80393,S8OVDYMWVqlXct5SL79m7HIG5CpKKYZc,SpATywNh6bZuzm8s1ceuBUnMUAeoAHHw,12,15,8,1,4,0,9,0,37,5.285714285714286,3,0.0,4,8,1,4,11,0,0,9,0,17,20,0
4039,80411,GC4OF9yGz21AkcWehLa95SfLGyYuVKMP,SpATywNh6bZuzm8s1ceuBUnMUAeoAHHw,17,36,13,35,0,41,17,3,145,20.714285714285715,6,0.0,14,13,31,0,22,41,4,17,3,58,87,0
4040,80463,G4gv3psLUg6DraQbf90HcUcwjZl74koo,SpATywNh6bZuzm8s1ceuBUnMUAeoAHHw,3,2,1,0,0,0,1,0,4,0.5714285714285714,1,0.0,0,1,0,0,2,0,0,1,0,1,3,1
4041,80471,AZ8hE11Dcjz74P3tHeZJFdS8MoworAxL,G8EPVSXsOYB5YQWZGiz1aVq5Pgr2GrQu,49,140,0,51,3,21,20,6,241,34.42857142857143,4,0.0,13,0,43,3,127,21,8,20,6,59,182,0
4042,80472,2tSCGGcBbyusCnHqpGiQkgQi3re0uZxB,G8EPVSXsOYB5YQWZGiz1aVq5Pgr2GrQu,33,71,33,37,23,3,24,2,193,27.571428571428573,6,0.0,0,33,30,23,71,3,7,24,2,86,107,1
4043,80476,xIixYS0PTebuXuOSaEZKc4qh4BFu0Dqa,bWdj2GDclj5ofokWjzoa5jAwMkxCykd6,1,0,0,0,0,0,2,0,2,0.2857142857142857,1,0.0,0,0,0,0,0,0,0,2,0,0,2,1
4044,80490,SQsqundSwoyc0WsLMzMDq40PcZstmoDl,SpATywNh6bZuzm8s1ceuBUnMUAeoAHHw,7,4,3,0,3,0,2,0,12,1.7142857142857142,1,0.0,0,3,0,3,4,0,0,2,0,6,6,1
4045,80497,YotAwxbRJChtPJRmqiR2vpTmWxO7oSJ0,A3fsA9Zfv1X2fVEQhTw51lKENdNrEqT3,1,0,0,0,0,0,1,0,1,0.14285714285714285,1,0.0,0,0,0,0,0,0,0,1,0,0,1,1
4046,80499,YotAwxbRJChtPJRmqiR2vpTmWxO7oSJ0,bWdj2GDclj5ofokWjzoa5jAwMkxCykd6,1,0,0,0,0,0,2,0,2,0.2857142857142857,1,0.0,0,0,0,0,0,0,0,2,0,0,2,1
4047,80514,DdUTtw4QPNiBxHI38HgtVDIMn8onRmHc,A3fsA9Zfv1X2fVEQhTw51lKENdNrEqT3,10,12,5,0,3,0,4,0,24,3.4285714285714284,3,0.0,0,5,0,3,12,0,0,4,0,8,16,0
4048,80543,SJGYusQ5bKHgmVHB9ZU6VNixBNlg7610,SpATywNh6bZuzm8s1ceuBUnMUAeoAHHw,5,2,1,0,1,0,2,0,6,0.8571428571428571,1,0.0,0,1,0,1,2,0,0,2,0,2,4,1
4049,80577,LeM9PaeUEt6YxtDTcxg2tcMBc03CKGpH,G8EPVSXsOYB5YQWZGiz1aVq5Pgr2GrQu,1,0,0,0,0,0,1,0,1,0.14285714285714285,1,0.0,0,0,0,0,0,0,0,1,0,0,1,1
4050,80578,WCnGcaqoXPOoj0smksJ3AG2zfJ5bQ6q1,A3fsA9Zfv1X2fVEQhTw51lKENdNrEqT3,6,1,1,0,1,0,3,0,6,0.8571428571428571,1,0.0,0,1,0,1,1,0,0,3,0,2,4,1
4051,80593,z9sj5HIJml1DMOMfRKKBQ7IvS2IoE424,A3fsA9Zfv1X2fVEQhTw51lKENdNrEqT3,1,0,0,0,0,0,5,0,5,0.7142857142857143,3,0.0,0,0,0,0,0,0,0,5,0,0,5,1
4052,80603,iWBeIhxgRjHKtzWSQwKS5OP5OzUjqRhH,bWdj2GDclj5ofokWjzoa5jAwMkxCykd6,4,4,1,10,1,0,1,0,17,2.4285714285714284,1,0.0,2,1,9,1,2,0,1,1,0,13,4,1
4053,80606,2cQfWhwRUGUv48S47s2aDWYzSM5LRy6r,RXDvfPUBYFlVdlueBFbLW0mhhAyGEqpt,17,15,0,0,0,0,6,0,21,3.0,2,0.0,0,0,0,0,15,0,0,6,0,0,21,1
4054,80610,XIynS55sKEeUm9UamMF9V3hYXLI7Q5XZ,bWdj2GDclj5ofokWjzoa5jAwMkxCykd6,6,1,1,0,1,0,3,0,6,0.8571428571428571,1,0.0,0,1,0,1,1,0,0,3,0,2,4,1
4055,80614,srJeJbIuD6nlvLtYdUFiQcvh7X1ghk8m,SpATywNh6bZuzm8s1ceuBUnMUAeoAHHw,1,0,0,0,0,0,1,0,1,0.14285714285714285,1,0.0,0,0,0,0,0,0,0,1,0,0,1,1
4056,80621,L5BsWcgN6IMgchaeVR0q3PWadEiOivUf,A3fsA9Zfv1X2fVEQhTw51lKENdNrEqT3,6,2,1,0,1,1,3,1,9,1.2857142857142858,1,0.0,0,1,0,1,2,1,0,3,1,2,7,1
4057,80646,1XuOICh6QrUFIc1MJAW7XRUBUSTY0RN7,SpATywNh6bZuzm8s1ceuBUnMUAeoAHHw,11,17,9,0,3,3,14,2,48,6.857142857142857,3,0.0,0,9,0,3,17,3,0,14,2,12,36,1
4058,80650,CViRSkXaB71kW0MpqfES8A240EKnhiKp,A3fsA9Zfv1X2fVEQhTw51lKENdNrEqT3,5,5,3,0,2,0,2,0,12,1.7142857142857142,1,0.0,0,3,0,2,5,0,0,2,0,5,7,1
4059,80685,SyrTnLXKpH34dNmIyW3n9ptk8gbsqg3F,bWdj2GDclj5ofokWjzoa5jAwMkxCykd6,1,0,0,0,0,0,1,0,1,0.14285714285714285,1,0.0,0,0,0,0,0,0,0,1,0,0,1,1
4060,80686,SyrTnLXKpH34dNmIyW3n9ptk8gbsqg3F,G8EPVSXsOYB5YQWZGiz1aVq5Pgr2GrQu,1,0,0,0,0,0,1,0,1,0.14285714285714285,1,0.0,0,0,0,0,0,0,0,1,0,0,1,1
4061,80718,a5enjFKHyOqV9BlzZwj7DoNQQjSWFxve,SpATywNh6bZuzm8s1ceuBUnMUAeoAHHw,6,7,3,0,1,0,2,0,13,1.8571428571428572,2,0.0,2,3,0,1,5,0,0,2,0,6,7,1
4062,80721,9pnVOC0WBepjoyI2qcaWMzrSP0RPnX7J,A3fsA9Zfv1X2fVEQhTw51lKENdNrEqT3,4,2,0,0,0,0,2,0,4,0.5714285714285714,1,0.0,0,0,0,0,2,0,0,2,0,0,4,1
4063,80725,eVZffGeL4uoEevrNNMdcmW6f0YwT8plW,bWdj2GDclj5ofokWjzoa5jAwMkxCykd6,5,5,3,0,2,0,3,0,13,1.8571428571428572,3,0.0,0,3,0,2,5,0,0,3,0,5,8,1
4064,80744,EGvZuk2o6udfOjbP1e9MeD8Ju07DscTY,A3fsA9Zfv1X2fVEQhTw51lKENdNrEqT3,1,0,0,0,0,0,3,0,3,0.42857142857142855,1,0.0,0,0,0,0,0,0,0,3,0,0,3,1
4065,80748,H6iwP0B7nHcYZaQbDpLJEx2H7FXYxL7S,RXDvfPUBYFlVdlueBFbLW0mhhAyGEqpt,24,25,9,38,4,0,9,2,87,12.428571428571429,4,0.0,7,9,31,4,18,0,7,9,2,51,36,0
4066,80761,xyhTJkgGghEribeWkvfmDO529PeI6BOD,bWdj2GDclj5ofokWjzoa5jAwMkxCykd6,19,17,15,0,16,0,5,0,53,7.571428571428571,1,0.0,2,15,0,16,15,0,0,5,0,33,20,1
4067,80777,Nn60hlJlXHP7n7M6lOuhaSQUkd1WY1lX,bWdj2GDclj5ofokWjzoa5jAwMkxCykd6,2,0,0,0,0,0,2,0,2,0.2857142857142857,1,0.0,0,0,0,0,0,0,0,2,0,0,2,1
4068,80797,OmF4aFe06TkjIpsTgGpQ4vBzMWi2jjQV,SpATywNh6bZuzm8s1ceuBUnMUAeoAHHw,7,6,3,0,2,0,3,0,14,2.0,1,0.0,0,3,0,2,6,0,0,3,0,5,9,1
4069,80800,a98Mt6r9LLCkAEPo2R3JVMN20OhIPoaG,SpATywNh6bZuzm8s1ceuBUnMUAeoAHHw,24,32,21,4,15,1,9,1,83,11.857142857142858,6,0.0,1,21,4,15,31,1,0,9,1,41,42,1
4070,80820,auTfNrVnLCOPJ3vRg0BBNLuEGlk6Jhzf,A3fsA9Zfv1X2fVEQhTw51lKENdNrEqT3,1,0,0,0,0,0,1,0,1,0.14285714285714285,1,0.0,0,0,0,0,0,0,0,1,0,0,1,1
4071,80828,7cqcexGmNTOg3kBfOTQxhsQAuLbRP0aP,SpATywNh6bZuzm8s1ceuBUnMUAeoAHHw,4,2,1,0,1,0,1,0,5,0.7142857142857143,1,0.0,0,1,0,1,2,0,0,1,0,2,3,1
4072,80862,JPgtg8QJos7Rq7D0ICcp60lZ9MEetv8V,RXDvfPUBYFlVdlueBFbLW0mhhAyGEqpt,5,2,1,0,1,0,2,0,6,0.8571428571428571,1,0.0,0,1,0,1,2,0,0,2,0,2,4,1
4073,80865,detHMtXeNBDLl1yfq61M11qScSHezCTa,fbPkOYLVPtPgIt0MxizjfFJov3JbHyAi,7,5,3,0,3,0,5,0,16,2.2857142857142856,1,0.0,1,3,0,3,4,0,0,5,0,7,9,1
4074,80866,lPCl89OkL3ywqPQ9tkoc7yQfPt2jOe8J,fbPkOYLVPtPgIt0MxizjfFJov3JbHyAi,11,22,8,6,9,27,15,4,91,13.0,1,0.0,12,8,4,9,10,27,2,15,4,33,58,1
4075,80872,pGAbpSQSqm8kO5KHqj1P91gbLxgxqLMR,fbPkOYLVPtPgIt0MxizjfFJov3JbHyAi,1,0,0,0,0,0,1,0,1,0.14285714285714285,1,0.0,0,0,0,0,0,0,0,1,0,0,1,1
4076,80874,tH916xRbn4bSZXJ6Z57PlnTAPQfz04PX,fbPkOYLVPtPgIt0MxizjfFJov3JbHyAi,13,10,5,3,4,0,3,0,25,3.5714285714285716,1,0.0,2,5,3,4,8,0,0,3,0,14,11,1
4077,80875,zgLhc8F17sS6o8GPDEBAA43SRssMOYHD,fbPkOYLVPtPgIt0MxizjfFJov3JbHyAi,8,7,3,0,1,1,7,1,20,2.857142857142857,3,0.0,0,3,0,1,7,1,0,7,1,4,16,1
4078,80876,yoqZagpPshUzxT5y74jKK6qgFqUHTRAQ,fbPkOYLVPtPgIt0MxizjfFJov3JbHyAi,7,4,2,0,2,0,3,0,11,1.5714285714285714,1,0.0,1,2,0,2,3,0,0,3,0,5,6,1
4079,80879,QRBHeXWoh4Eq5qFFGeXnL66X034DcN82,fbPkOYLVPtPgIt0MxizjfFJov3JbHyAi,7,5,4,0,3,0,2,0,14,2.0,1,0.0,0,4,0,3,5,0,0,2,0,7,7,1
4080,80880,nwSsR1adl0WQZ5D0MOHLkrBumdQn65bS,fbPkOYLVPtPgIt0MxizjfFJov3JbHyAi,1,0,0,0,0,0,1,0,1,0.14285714285714285,1,0.0,0,0,0,0,0,0,0,1,0,0,1,1
4081,80883,dl3uJviN00Na5GELdMJFr7DikNXKgldw,fbPkOYLVPtPgIt0MxizjfFJov3JbHyAi,12,13,4,8,4,0,11,1,41,5.857142857142857,1,0.0,5,4,6,4,8,0,2,11,1,19,22,1
4082,80885,OJ0LoXMYeoupgtCsqXPKoTXc19jkOfHU,fbPkOYLVPtPgIt0MxizjfFJov3JbHyAi,6,13,0,2,2,0,3,0,20,2.857142857142857,1,0.0,7,0,2,2,6,0,0,3,0,11,9,1
4083,80890,9iv095QjZS4Q7X9b663JhI4Y5VIooOZJ,fbPkOYLVPtPgIt0MxizjfFJov3JbHyAi,7,4,3,0,2,0,8,0,17,2.4285714285714284,1,0.0,0,3,0,2,4,0,0,8,0,5,12,1
4084,80891,1IMOvf9v1bRH0tUTRkiIkzGe833lnAgf,fbPkOYLVPtPgIt0MxizjfFJov3JbHyAi,5,2,1,0,1,0,4,0,8,1.1428571428571428,3,0.0,0,1,0,1,2,0,0,4,0,2,6,0
4085,80892,OqzJYk2L0XqYLfMs4LljNI8HpBsCF1TU,fbPkOYLVPtPgIt0MxizjfFJov3JbHyAi,27,36,18,17,12,10,8,1,102,14.571428571428571,6,0.0,8,18,14,12,28,10,3,8,1,52,50,1
4086,80894,wa9yiDToqQTrEAjEFYLZvJZ6yii3aZEK,fbPkOYLVPtPgIt0MxizjfFJov3JbHyAi,9,3,3,0,3,3,9,2,23,3.2857142857142856,1,0.0,0,3,0,3,3,3,0,9,2,6,17,1
4087,80896,F7beo1Qs8FACPdfc8t0SncgEfDkdNWKi,fbPkOYLVPtPgIt0MxizjfFJov3JbHyAi,12,28,18,0,9,35,29,4,123,17.571428571428573,4,0.0,3,18,0,9,25,35,0,29,4,30,93,1
4088,82293,h7Gk9Pr4tHraGHEA4N989G6mMEttrQ7F,fbPkOYLVPtPgIt0MxizjfFJov3JbHyAi,4,2,1,0,1,0,1,0,5,0.7142857142857143,1,0.0,0,1,0,1,2,0,0,1,0,2,3,1
4089,82296,cRhYOWmRYGzfmTeQOfNoa47hIiXDh8uB,fbPkOYLVPtPgIt0MxizjfFJov3JbHyAi,8,7,3,0,2,3,4,0,19,2.7142857142857144,1,0.0,0,3,0,2,7,3,0,4,0,5,14,1
4090,82298,L39ZdOzVu52b5Nu8u3TuFdomCuDfGlbZ,fbPkOYLVPtPgIt0MxizjfFJov3JbHyAi,7,3,2,0,2,0,2,0,9,1.2857142857142858,1,0.0,0,2,0,2,3,0,0,2,0,4,5,1
4091,82300,W0m8271d1PwWD9jcR5ad8muDNmmDz2n0,fbPkOYLVPtPgIt0MxizjfFJov3JbHyAi,6,2,1,0,1,0,3,0,7,1.0,1,0.0,0,1,0,1,2,0,0,3,0,2,5,1
4092,82306,SMcFR1tzrGAErGanrAOTaiQacFJ5UscL,fbPkOYLVPtPgIt0MxizjfFJov3JbHyAi,1,0,0,0,0,0,1,0,1,0.14285714285714285,1,0.0,0,0,0,0,0,0,0,1,0,0,1,1
4093,82320,PZsNp0sdZSh88V88314df0SFpq2hITu9,7GRhBDsirIGkRZBtSMEzNTyDr2JQm4xx,35,54,22,18,14,4,12,0,124,17.714285714285715,3,0.0,25,22,11,14,29,4,7,12,0,72,52,1
4094,82384,43E2rt302JULLcYiauLjUubEtMqnfHMM,7GRhBDsirIGkRZBtSMEzNTyDr2JQm4xx,1,0,0,0,0,0,1,0,1,0.14285714285714285,1,0.0,0,0,0,0,0,0,0,1,0,0,1,1
4095,82393,LEErhOa5boiziYl0X6XgUtaE9oegOl2r,7GRhBDsirIGkRZBtSMEzNTyDr2JQm4xx,1,0,0,0,0,0,1,0,1,0.14285714285714285,1,0.0,0,0,0,0,0,0,0,1,0,0,1,1
4096,82399,viuKt4GgrX0rYL5EpHoxJbsiC9TblSuk,7GRhBDsirIGkRZBtSMEzNTyDr2JQm4xx,13,27,9,0,1,8,6,1,52,7.428571428571429,2,0.0,16,9,0,1,11,8,0,6,1,26,26,1
4097,82405,TciQEzJA4hKxeo0Ve5JLByGDZHpNx3uy,7GRhBDsirIGkRZBtSMEzNTyDr2JQm4xx,7,6,2,0,0,10,12,0,30,4.285714285714286,2,0.0,0,2,0,0,6,10,0,12,0,2,28,1
4098,82417,cYrWUXTiBgGjy3hGqmm3n1c0yjpEqf1w,7GRhBDsirIGkRZBtSMEzNTyDr2JQm4xx,11,6,3,0,4,1,6,0,20,2.857142857142857,1,0.0,2,3,0,4,4,1,0,6,0,9,11,1
4099,82418,uJax5vCFklO8HHpSUYT3Fz3R0owwtr35,7GRhBDsirIGkRZBtSMEzNTyDr2JQm4xx,1,0,0,0,0,0,1,0,1,0.14285714285714285,1,0.0,0,0,0,0,0,0,0,1,0,0,1,1
4100,82437,XivfOnvugBk6XlGIM6kdwKfGcR3nQxRm,7GRhBDsirIGkRZBtSMEzNTyDr2JQm4xx,7,3,2,0,2,0,2,0,9,1.2857142857142858,1,0.0,0,2,0,2,3,0,0,2,0,4,5,1
4101,82453,vUKsMiJwv2QfsgGCTNCgcgyS6zvBvgBp,7GRhBDsirIGkRZBtSMEzNTyDr2JQm4xx,13,9,7,0,4,6,11,1,38,5.428571428571429,1,0.0,0,7,0,4,9,6,0,11,1,11,27,1
4102,82511,uGqq5Gc0yuBAXiGPLk4UFpV86PfbPpKt,7GRhBDsirIGkRZBtSMEzNTyDr2JQm4xx,23,52,11,14,10,0,1,0,88,12.571428571428571,1,0.0,8,11,7,10,44,0,7,1,0,36,52,1
4103,82519,RhKR05rzUu0u9Tu4D52krXN6Zpp20wSB,7GRhBDsirIGkRZBtSMEzNTyDr2JQm4xx,1,0,0,0,0,0,1,0,1,0.14285714285714285,1,0.0,0,0,0,0,0,0,0,1,0,0,1,1
4104,82549,LzZbSzxCF6j5IK4opjLkxGirHE6VTy2b,7GRhBDsirIGkRZBtSMEzNTyDr2JQm4xx,27,44,3,28,2,1,3,0,81,11.571428571428571,3,0.0,19,3,22,2,25,1,6,3,0,46,35,0
4105,82606,ieYbeKnQ9Q6nxVAutigoFXyNAyGepcVf,SpATywNh6bZuzm8s1ceuBUnMUAeoAHHw,30,29,18,37,9,1,5,1,100,14.285714285714286,1,0.0,7,18,33,9,22,1,4,5,1,67,33,0
4106,82645,CSh5hGbaSFu2yCb31iVMOVwKocrH471Q,RXDvfPUBYFlVdlueBFbLW0mhhAyGEqpt,17,41,25,8,5,1,12,1,93,13.285714285714286,6,0.0,1,25,8,5,40,1,0,12,1,39,54,0
4107,82718,0ToFygcG0ie7U9Wejy2h2RyDoLh56OuH,SpATywNh6bZuzm8s1ceuBUnMUAeoAHHw,1,0,0,0,0,0,1,0,1,0.14285714285714285,1,0.0,0,0,0,0,0,0,0,1,0,0,1,1
4108,82797,BzvzyDIHLe9MZwFkiZf5BNkVkHrFZ1uP,SpATywNh6bZuzm8s1ceuBUnMUAeoAHHw,16,21,10,12,6,0,4,0,53,7.571428571428571,3,0.0,2,10,10,6,19,0,2,4,0,28,25,1
4109,82809,CSh5hGbaSFu2yCb31iVMOVwKocrH471Q,bWdj2GDclj5ofokWjzoa5jAwMkxCykd6,9,12,7,0,4,0,9,0,32,4.571428571428571,3,0.0,0,7,0,4,12,0,0,9,0,11,21,1
4110,82815,IYjgMeQycDQkXIpTAZqsKVDfOfuGTmr6,G8EPVSXsOYB5YQWZGiz1aVq5Pgr2GrQu,19,33,4,34,2,2,6,0,81,11.571428571428571,4,0.0,9,4,30,2,24,2,4,6,0,45,36,1
4111,82825,PCDzowxElNLixXyfAFPkQqlbkMlIrEa9,bWdj2GDclj5ofokWjzoa5jAwMkxCykd6,1,0,0,0,0,0,1,0,1,0.14285714285714285,1,0.0,0,0,0,0,0,0,0,1,0,0,1,1
4112,82826,6PLrCNmfEwPk8NveiZ2kjz8b6TJ4tdFy,SpATywNh6bZuzm8s1ceuBUnMUAeoAHHw,26,50,1,34,1,9,26,6,127,18.142857142857142,5,0.0,18,1,28,1,32,9,6,26,6,48,79,1
4113,82839,0eZxP7v4dLkYnlOrNv9f440B7CYLqmGw,A3fsA9Zfv1X2fVEQhTw51lKENdNrEqT3,8,4,0,0,0,3,8,1,16,2.2857142857142856,1,0.0,0,0,0,0,4,3,0,8,1,0,16,0
4114,82935,VZy08QiJfjzIhB9oyZbfkS8kOqdqXxGQ,SpATywNh6bZuzm8s1ceuBUnMUAeoAHHw,20,42,23,6,5,1,26,0,103,14.714285714285714,4,0.0,2,23,6,5,40,1,0,26,0,36,67,0
4115,82945,jMzDAkDrCqzTj207GrZXDfLQXbYc8WXP,SpATywNh6bZuzm8s1ceuBUnMUAeoAHHw,4,5,0,0,0,0,1,0,6,0.8571428571428571,1,0.0,0,0,0,0,5,0,0,1,0,0,6,1
4116,82980,KJHVgwvyEGSqeXuZ6P7l6YnOOdmnECg0,G8EPVSXsOYB5YQWZGiz1aVq5Pgr2GrQu,8,13,0,0,0,13,6,0,32,4.571428571428571,3,0.0,0,0,0,0,13,13,0,6,0,0,32,1
4117,83008,OifsLGRBGBgFFNsSrNDnK5W8Vbn9qLGX,bWdj2GDclj5ofokWjzoa5jAwMkxCykd6,6,9,0,0,0,0,1,0,10,1.4285714285714286,2,0.0,0,0,0,0,9,0,0,1,0,0,10,1
4118,83011,7IO6p4687fQRowFKh8aP2BRrTBz96sXF,SpATywNh6bZuzm8s1ceuBUnMUAeoAHHw,15,7,6,0,6,0,2,0,21,3.0,1,0.0,0,6,0,6,7,0,0,2,0,12,9,1
4119,83016,6nEFiLob034lX78wkreIicrVXormSdsR,SpATywNh6bZuzm8s1ceuBUnMUAeoAHHw,7,2,0,0,0,9,6,2,19,2.7142857142857144,1,0.0,0,0,0,0,2,9,0,6,2,0,19,1
4120,83024,xhSNxzAdJZ3UvqN1HWRUi586YbiFg3gP,SpATywNh6bZuzm8s1ceuBUnMUAeoAHHw,7,3,2,0,2,0,2,0,9,1.2857142857142858,1,0.0,0,2,0,2,3,0,0,2,0,4,5,1
4121,83034,JfftjOGdDbpgbrupi0Gwr899R0jzXikJ,RXDvfPUBYFlVdlueBFbLW0mhhAyGEqpt,28,39,25,0,12,0,12,0,88,12.571428571428571,8,0.0,0,25,0,12,39,0,0,12,0,37,51,1
4122,83050,8N1dftZZEH60qM7KC0I3DLQjIoLpq8rg,bWdj2GDclj5ofokWjzoa5jAwMkxCykd6,8,5,4,0,2,0,4,1,16,2.2857142857142856,1,0.0,0,4,0,2,5,0,0,4,1,6,10,1
4123,83051,5txttxupjDZ5RVkKM8mUX5AwlfTmH5yF,SpATywNh6bZuzm8s1ceuBUnMUAeoAHHw,9,3,2,0,2,1,4,0,12,1.7142857142857142,1,0.0,0,2,0,2,3,1,0,4,0,4,8,1
4124,83086,HDl6obmuly5u871WtIy4bB83rJ9ydWpb,SpATywNh6bZuzm8s1ceuBUnMUAeoAHHw,24,20,12,32,6,1,4,0,75,10.714285714285714,1,0.0,5,12,27,6,15,1,5,4,0,50,25,1
4125,83156,wSQurJctKIVWroKFEwLtZd7EI4FKyqnr,G8EPVSXsOYB5YQWZGiz1aVq5Pgr2GrQu,25,45,12,74,8,0,2,0,141,20.142857142857142,1,0.0,19,12,57,8,26,0,17,2,0,96,45,0
4126,83165,jqU1D59XEYqlC5xpuvwRL444Dk2gM9HE,bWdj2GDclj5ofokWjzoa5jAwMkxCykd6,1,0,0,0,0,0,1,0,1,0.14285714285714285,1,0.0,0,0,0,0,0,0,0,1,0,0,1,1
4127,83170,TOdJr6wpv1Do14qMOudEcAu5ZtPnzG5P,G8EPVSXsOYB5YQWZGiz1aVq5Pgr2GrQu,50,18,18,213,9,0,6,0,264,37.714285714285715,2,0.0,0,18,187,9,18,0,26,6,0,214,50,0
4128,83174,5A8qgesuumI82DPHv10fhG2s0pO5oVZR,A3fsA9Zfv1X2fVEQhTw51lKENdNrEqT3,6,4,0,0,0,0,5,0,9,1.2857142857142858,3,0.0,0,0,0,0,4,0,0,5,0,0,9,1
4129,83211,Wr4SmSlfffOCt9SGCoEYbe3u98RIz0dN,A3fsA9Zfv1X2fVEQhTw51lKENdNrEqT3,59,56,44,42,31,0,11,0,184,26.285714285714285,4,0.0,3,44,42,31,53,0,0,11,0,120,64,1
4130,83227,EUmZ5qzjwgko2PIWEnctkvYh7APnUrX9,bWdj2GDclj5ofokWjzoa5jAwMkxCykd6,12,32,3,0,2,0,12,0,49,7.0,4,0.0,0,3,0,2,32,0,0,12,0,5,44,0
4131,83270,nLSuRa1Xl0BD98Gi62KN22iPrqq32BXg,A3fsA9Zfv1X2fVEQhTw51lKENdNrEqT3,2,0,0,0,0,0,2,0,2,0.2857142857142857,1,0.0,0,0,0,0,0,0,0,2,0,0,2,1
4132,83277,dT92IjRcuruPiAlpqVUTtu3wNL9IIegT,SpATywNh6bZuzm8s1ceuBUnMUAeoAHHw,2,0,0,0,0,0,2,0,2,0.2857142857142857,2,0.0,0,0,0,0,0,0,0,2,0,0,2,1
4133,83283,PBR461hkZjzKwEmSOTgV69v6hIW4qt59,RXDvfPUBYFlVdlueBFbLW0mhhAyGEqpt,3,0,0,0,0,0,4,0,4,0.5714285714285714,1,0.0,0,0,0,0,0,0,0,4,0,0,4,1
4134,83284,3CjVt7bXLLNxAWX8paG8Hg5eS8UkaYeH,A3fsA9Zfv1X2fVEQhTw51lKENdNrEqT3,9,6,0,0,0,2,5,1,14,2.0,1,0.0,0,0,0,0,6,2,0,5,1,0,14,1
4135,83290,V5AS4ngknDMHs5ddf49SxlAoYguZsiN3,SpATywNh6bZuzm8s1ceuBUnMUAeoAHHw,28,32,14,16,6,3,8,0,79,11.285714285714286,3,0.0,7,14,15,6,25,3,1,8,0,42,37,1
4136,83304,BQi6o3YIDMuHZg7pBKL2EQvhTIhuaxJ1,SpATywNh6bZuzm8s1ceuBUnMUAeoAHHw,1,0,0,0,0,0,1,0,1,0.14285714285714285,1,0.0,0,0,0,0,0,0,0,1,0,0,1,1
4137,83310,4NR9J7NrWx9P8bFiOFbZEGtYIezzdGum,A3fsA9Zfv1X2fVEQhTw51lKENdNrEqT3,11,5,4,0,4,0,2,0,15,2.142857142857143,1,0.0,0,4,0,4,5,0,0,2,0,8,7,0
4138,83336,gFQthJ0fgeQ9ZBHD40PszFOUEAsK6l6q,SpATywNh6bZuzm8s1ceuBUnMUAeoAHHw,2,0,0,0,0,0,2,0,2,0.2857142857142857,1,0.0,0,0,0,0,0,0,0,2,0,0,2,1
4139,83380,cxfyjhDPSpiPao628A4EolvaTnOncviL,A3fsA9Zfv1X2fVEQhTw51lKENdNrEqT3,7,3,2,0,2,0,3,0,10,1.4285714285714286,1,0.0,0,2,0,2,3,0,0,3,0,4,6,1
4140,83382,yBjxhcDDJKIAjEmiiiesRzMTh8bRt1ah,A3fsA9Zfv1X2fVEQhTw51lKENdNrEqT3,2,0,0,0,0,0,2,0,2,0.2857142857142857,1,0.0,0,0,0,0,0,0,0,2,0,0,2,0
4141,83390,GRkdPFTbm7uYMggKfYKpZacMj3qggIR1,bWdj2GDclj5ofokWjzoa5jAwMkxCykd6,7,5,3,0,1,0,5,0,14,2.0,1,0.0,0,3,0,1,5,0,0,5,0,4,10,1
4142,83391,5lnG922UFflYKbVHck7tAuI1NLtyYgBb,A3fsA9Zfv1X2fVEQhTw51lKENdNrEqT3,2,0,0,0,0,0,2,0,2,0.2857142857142857,1,0.0,0,0,0,0,0,0,0,2,0,0,2,1
4143,83411,sw7EOsxnjfyxD0QxJsjO2WXRMXBWJD2E,bWdj2GDclj5ofokWjzoa5jAwMkxCykd6,12,15,5,0,4,0,3,0,27,3.857142857142857,4,0.0,0,5,0,4,15,0,0,3,0,9,18,1
4144,83466,QuvCYikodbdRYaQkbLfEjRfwbs69qsbc,SpATywNh6bZuzm8s1ceuBUnMUAeoAHHw,1,0,0,0,0,0,1,0,1,0.14285714285714285,1,0.0,0,0,0,0,0,0,0,1,0,0,1,1
4145,83513,FN4Q8gUJQiuKtRiPQS3gBMUWwSnDptW4,SpATywNh6bZuzm8s1ceuBUnMUAeoAHHw,29,45,21,30,9,0,5,0,110,15.714285714285714,3,0.0,17,21,24,9,28,0,6,5,0,71,39,1
4146,83521,OmeHT0PntcI0ieBORzxyW3ukuMNHL2Uw,SpATywNh6bZuzm8s1ceuBUnMUAeoAHHw,1,0,0,0,0,0,1,0,1,0.14285714285714285,1,0.0,0,0,0,0,0,0,0,1,0,0,1,1
4147,83527,zAxSsEdPeUZGGnFIWSFOZ9V5E0hHlR0L,SpATywNh6bZuzm8s1ceuBUnMUAeoAHHw,5,4,1,0,1,0,1,0,7,1.0,1,0.0,1,1,0,1,3,0,0,1,0,3,4,1
4148,83528,HH0bgFZJUfJrK8yCEOD0HA8raoSrd2bR,SpATywNh6bZuzm8s1ceuBUnMUAeoAHHw,11,14,4,12,0,35,8,0,73,10.428571428571429,2,0.0,5,4,9,0,9,35,3,8,0,18,55,0
4149,83531,g1LVeBlQiVCOcKiTDDTy4PafQkGd4pbr,SpATywNh6bZuzm8s1ceuBUnMUAeoAHHw,6,4,1,0,1,0,2,0,8,1.1428571428571428,1,0.0,0,1,0,1,4,0,0,2,0,2,6,1
4150,83557,VcIkh3vonmMTX4dPSjJiYVRsVaKRhYaU,SpATywNh6bZuzm8s1ceuBUnMUAeoAHHw,2,0,0,0,0,0,2,0,2,0.2857142857142857,1,0.0,0,0,0,0,0,0,0,2,0,0,2,1
4151,83577,ew5XZC7WSosl0QdXH45kYD3syMSGbOj6,A3fsA9Zfv1X2fVEQhTw51lKENdNrEqT3,42,51,24,64,20,0,4,0,163,23.285714285714285,3,0.0,5,24,54,20,46,0,10,4,0,103,60,1
4152,83602,Z1uIScALT37BtyCtbFy33E9DuvHO2hks,SpATywNh6bZuzm8s1ceuBUnMUAeoAHHw,1,0,0,0,0,0,1,0,1,0.14285714285714285,1,0.0,0,0,0,0,0,0,0,1,0,0,1,1
4153,83613,puN480TO3qbGXrXmM5qoOdmstQ51OC6E,bWdj2GDclj5ofokWjzoa5jAwMkxCykd6,26,47,23,50,10,31,52,5,218,31.142857142857142,4,0.0,6,23,47,10,41,31,3,52,5,86,132,0
4154,83623,H6I6nkJ6DtlIXdQ1opNRFdSYIFjksvYQ,SpATywNh6bZuzm8s1ceuBUnMUAeoAHHw,27,35,19,19,7,34,15,1,130,18.571428571428573,7,0.0,6,19,16,7,29,34,3,15,1,48,82,1
4155,83684,MO75JAKfd03NfkJH3IgG154Ck5oA1Wzt,SpATywNh6bZuzm8s1ceuBUnMUAeoAHHw,12,15,8,0,4,1,11,1,40,5.714285714285714,1,0.0,2,8,0,4,13,1,0,11,1,14,26,0
4156,83717,O3LrBOriu4LFn5iIVlnw3bx3Q9TUIlm3,SpATywNh6bZuzm8s1ceuBUnMUAeoAHHw,1,0,0,0,0,0,1,0,1,0.14285714285714285,1,0.0,0,0,0,0,0,0,0,1,0,0,1,1
4157,83753,WxaYTMCI7yD8mE0osZVkZT9Orbo545LC,A3fsA9Zfv1X2fVEQhTw51lKENdNrEqT3,6,6,2,0,1,0,2,0,11,1.5714285714285714,1,0.0,0,2,0,1,6,0,0,2,0,3,8,1
4158,83765,YInPZ2NvQ1CvXlUb40X1VRvv4vqAWNKy,A3fsA9Zfv1X2fVEQhTw51lKENdNrEqT3,1,0,0,0,0,0,2,0,2,0.2857142857142857,1,0.0,0,0,0,0,0,0,0,2,0,0,2,1
4159,83776,1K0aEYcUjU3Omy9tzQvSoGMqsCiOBzQn,SpATywNh6bZuzm8s1ceuBUnMUAeoAHHw,5,2,1,0,1,0,2,0,6,0.8571428571428571,1,0.0,0,1,0,1,2,0,0,2,0,2,4,1
4160,83777,GYVy4Kw2IYTFaIZeLaixuEy0D5OoDjTn,A3fsA9Zfv1X2fVEQhTw51lKENdNrEqT3,1,0,0,0,0,0,1,0,1,0.14285714285714285,1,0.0,0,0,0,0,0,0,0,1,0,0,1,1
4161,83780,LUGJNGKKEXef9vp90U0uf3eBnGjvPHqY,bWdj2GDclj5ofokWjzoa5jAwMkxCykd6,5,1,0,0,1,0,3,0,5,0.7142857142857143,1,0.0,0,0,0,1,1,0,0,3,0,1,4,1
4162,83781,rwRg5VLLMifE3rBQ9ovBdMe754UeHyD2,SpATywNh6bZuzm8s1ceuBUnMUAeoAHHw,8,9,0,0,0,0,7,0,16,2.2857142857142856,1,0.0,5,0,0,0,4,0,0,7,0,5,11,1
4163,83783,VgSuhdH7aYuXsDcf74CEOycHQbwhkHBq,A3fsA9Zfv1X2fVEQhTw51lKENdNrEqT3,2,0,0,0,0,0,2,0,2,0.2857142857142857,1,0.0,0,0,0,0,0,0,0,2,0,0,2,1
4164,83811,svi8vAETiYnBPEWWZIRd4gAyZTcaxP58,bWdj2GDclj5ofokWjzoa5jAwMkxCykd6,1,0,0,0,0,0,1,0,1,0.14285714285714285,1,0.0,0,0,0,0,0,0,0,1,0,0,1,1
4165,83868,X4KSPkBIdPEeXdEy4Fa5NvixCQZdfNj3,bWdj2GDclj5ofokWjzoa5jAwMkxCykd6,1,0,0,0,0,0,1,0,1,0.14285714285714285,1,0.0,0,0,0,0,0,0,0,1,0,0,1,1
4166,83880,ZQE4YlSay0qfyoMsVO9k7S4IfrHuRzoo,A3fsA9Zfv1X2fVEQhTw51lKENdNrEqT3,1,0,0,0,0,0,1,0,1,0.14285714285714285,1,0.0,0,0,0,0,0,0,0,1,0,0,1,1
4167,83890,hkZJZMuEk3eRSgWhjH7jPcJrlgv2RTNl,bWdj2GDclj5ofokWjzoa5jAwMkxCykd6,15,15,7,40,3,5,3,0,73,10.428571428571429,2,0.0,5,7,39,3,10,5,1,3,0,54,19,1
4168,83899,TB2wDsOo3kDLa90fD8fPr19ZM5ZS7ZAB,A3fsA9Zfv1X2fVEQhTw51lKENdNrEqT3,2,0,0,0,0,0,2,0,2,0.2857142857142857,1,0.0,0,0,0,0,0,0,0,2,0,0,2,1
4169,83902,9fqjCwCWiE2ZIs1HrK3mm4R5MSyOKac5,A3fsA9Zfv1X2fVEQhTw51lKENdNrEqT3,15,27,13,0,8,0,8,0,56,8.0,2,0.0,0,13,0,8,27,0,0,8,0,21,35,1
4170,83909,lQbf9gXsN1R7oTfmD8ApJzd1F5wN4xv1,RXDvfPUBYFlVdlueBFbLW0mhhAyGEqpt,6,1,1,0,1,1,4,0,8,1.1428571428571428,1,0.0,0,1,0,1,1,1,0,4,0,2,6,1
4171,83919,mFpiELMd2y5tbkdxs4m8pKS7gXHb7bIO,RXDvfPUBYFlVdlueBFbLW0mhhAyGEqpt,15,9,7,0,6,0,2,0,24,3.4285714285714284,2,0.0,0,7,0,6,9,0,0,2,0,13,11,1
4172,83928,wQsOYND6Uk5mviOI6mS6ntmifQ69LbeV,A3fsA9Zfv1X2fVEQhTw51lKENdNrEqT3,8,4,2,0,2,0,3,0,11,1.5714285714285714,1,0.0,0,2,0,2,4,0,0,3,0,4,7,1
4173,83951,I6oJUzF1kneNCI5HLEngmj8oOrT8LAPo,A3fsA9Zfv1X2fVEQhTw51lKENdNrEqT3,1,0,0,0,0,0,1,0,1,0.14285714285714285,1,0.0,0,0,0,0,0,0,0,1,0,0,1,1
4174,83979,sTq9v868sPUgTaUUmCiFRadbl8t0UoCG,SpATywNh6bZuzm8s1ceuBUnMUAeoAHHw,11,15,4,14,2,2,3,0,40,5.714285714285714,1,0.0,10,4,11,2,5,2,3,3,0,27,13,1
4175,84010,Slef5w11bVkmRsTBBwhS62k507EfhwU6,SpATywNh6bZuzm8s1ceuBUnMUAeoAHHw,7,5,3,0,2,0,2,0,12,1.7142857142857142,1,0.0,1,3,0,2,4,0,0,2,0,6,6,1
4176,84033,mFKbFysEV5gGAbHL9fgzkpXci6xFiaFe,bWdj2GDclj5ofokWjzoa5jAwMkxCykd6,3,3,1,0,0,0,2,0,6,0.8571428571428571,1,0.0,0,1,0,0,3,0,0,2,0,1,5,1
4177,84034,lDJqver3AFFUyXISNdqvZpmq6OeWVl0r,A3fsA9Zfv1X2fVEQhTw51lKENdNrEqT3,21,16,12,0,8,0,7,0,43,6.142857142857143,3,0.0,0,12,0,8,16,0,0,7,0,20,23,0
4178,84048,dhO2y8sIijAlPYlXxsHK1aEk6O7FL2Q2,A3fsA9Zfv1X2fVEQhTw51lKENdNrEqT3,1,0,0,0,0,0,1,0,1,0.14285714285714285,1,0.0,0,0,0,0,0,0,0,1,0,0,1,1
4179,84050,dhO2y8sIijAlPYlXxsHK1aEk6O7FL2Q2,bWdj2GDclj5ofokWjzoa5jAwMkxCykd6,1,0,0,0,0,0,1,0,1,0.14285714285714285,1,0.0,0,0,0,0,0,0,0,1,0,0,1,1
4180,84058,mMS5utPEE0kau31EdquwgaN1e0nxF2V4,SpATywNh6bZuzm8s1ceuBUnMUAeoAHHw,11,17,10,8,6,0,3,0,44,6.285714285714286,3,0.0,0,10,8,6,17,0,0,3,0,24,20,1
4181,84067,JA3GjaqmpFLtt1yojsnNXLqhMexKQ8aw,A3fsA9Zfv1X2fVEQhTw51lKENdNrEqT3,2,0,0,0,0,0,2,0,2,0.2857142857142857,1,0.0,0,0,0,0,0,0,0,2,0,0,2,1
4182,84083,bl8YOhounxXowMizQE2ibaM5H4dVfT77,SpATywNh6bZuzm8s1ceuBUnMUAeoAHHw,1,0,0,0,0,0,1,0,1,0.14285714285714285,1,0.0,0,0,0,0,0,0,0,1,0,0,1,1
4183,84112,m94Ln6mKwrTlZEJamxaNSzUQ9VRwHEQK,SpATywNh6bZuzm8s1ceuBUnMUAeoAHHw,5,1,1,0,1,0,2,0,5,0.7142857142857143,1,0.0,0,1,0,1,1,0,0,2,0,2,3,1
4184,84128,ZCUEihNB1w88UL2EoTplrSA9QYdknyaF,SpATywNh6bZuzm8s1ceuBUnMUAeoAHHw,7,4,1,0,1,1,4,2,13,1.8571428571428572,1,0.0,0,1,0,1,4,1,0,4,2,2,11,1
4185,84132,bVLtn3iBc4ibW8xWVzLLM3Hs9gCB0qb7,bWdj2GDclj5ofokWjzoa5jAwMkxCykd6,1,0,0,0,0,0,1,0,1,0.14285714285714285,1,0.0,0,0,0,0,0,0,0,1,0,0,1,1
4186,84134,KVl6nnI1zsPf8ekwqnmOATbcWkWGBTQA,SpATywNh6bZuzm8s1ceuBUnMUAeoAHHw,5,3,1,0,1,0,1,0,6,0.8571428571428571,1,0.0,0,1,0,1,3,0,0,1,0,2,4,1
4187,84144,XSeWDgxGevybVHeILVqIcSB7rPdA6Gvi,SpATywNh6bZuzm8s1ceuBUnMUAeoAHHw,1,0,0,0,0,0,1,0,1,0.14285714285714285,1,0.0,0,0,0,0,0,0,0,1,0,0,1,1
4188,84159,n51reZ5FTJkHLnQwBqURrmxGDzwEsEjy,SpATywNh6bZuzm8s1ceuBUnMUAeoAHHw,31,50,28,31,8,0,10,0,127,18.142857142857142,2,0.0,8,28,26,8,42,0,5,10,0,70,57,0
4189,84169,YTpSaD5WvcxnMj244x9U8tK7ZjCb9sw0,bWdj2GDclj5ofokWjzoa5jAwMkxCykd6,1,0,0,0,0,0,1,0,1,0.14285714285714285,1,0.0,0,0,0,0,0,0,0,1,0,0,1,1
4190,84176,Xv4cOEYZEExzsBdbjc8lrCLUZHXLo5uk,SpATywNh6bZuzm8s1ceuBUnMUAeoAHHw,28,46,16,39,8,20,14,1,144,20.571428571428573,3,0.0,21,16,32,8,25,20,7,14,1,77,67,0
4191,84180,tZMtcgGsCq7JvLpFL4lhYMv0agvGaZe2,bWdj2GDclj5ofokWjzoa5jAwMkxCykd6,5,2,1,0,1,0,2,0,6,0.8571428571428571,1,0.0,0,1,0,1,2,0,0,2,0,2,4,1
4192,84183,xXxqqh9yVGi9oZiE57nohuMrqKDnoyIS,A3fsA9Zfv1X2fVEQhTw51lKENdNrEqT3,9,8,5,0,1,0,8,0,22,3.142857142857143,2,0.0,0,5,0,1,8,0,0,8,0,6,16,1
4193,84184,OsngIQPLVNsvztjbyMTR3Q1awEr69xBU,SpATywNh6bZuzm8s1ceuBUnMUAeoAHHw,3,2,0,0,0,0,1,0,3,0.42857142857142855,1,0.0,0,0,0,0,2,0,0,1,0,0,3,1
4194,84258,HOl7cCI0BgZTJ7INtqfMX4dKD4xHl51U,fbPkOYLVPtPgIt0MxizjfFJov3JbHyAi,14,29,6,12,7,0,1,0,55,7.857142857142857,1,0.0,15,6,9,7,14,0,3,1,0,37,18,1
4195,84259,xi2KO7WcXIB6LKlzLxLjQ5IcXn6cZQFV,fbPkOYLVPtPgIt0MxizjfFJov3JbHyAi,7,3,2,0,2,0,4,0,11,1.5714285714285714,1,0.0,0,2,0,2,3,0,0,4,0,4,7,1
4196,84261,lBljSQvIVCpw7S5SELQHg4JfMSTvCBRe,fbPkOYLVPtPgIt0MxizjfFJov3JbHyAi,10,13,1,0,1,0,3,0,18,2.5714285714285716,1,0.0,0,1,0,1,13,0,0,3,0,2,16,0
4197,84264,MSLYJeLT8SYZ3UpCzbTuM5WBLAn4P9C0,fbPkOYLVPtPgIt0MxizjfFJov3JbHyAi,5,2,1,0,1,0,2,0,6,0.8571428571428571,1,0.0,0,1,0,1,2,0,0,2,0,2,4,0
4198,84268,MaxCNnPaLK24RRWF9HKJTqddyOCcvhNc,fbPkOYLVPtPgIt0MxizjfFJov3JbHyAi,8,7,4,0,2,0,4,0,17,2.4285714285714284,1,0.0,0,4,0,2,7,0,0,4,0,6,11,1
4199,84270,HRxHszLswfw468mOCwAnOXdKGRZhTUPo,fbPkOYLVPtPgIt0MxizjfFJov3JbHyAi,9,9,1,0,2,0,2,0,14,2.0,1,0.0,2,1,0,2,7,0,0,2,0,5,9,1
4200,84273,Mbzz4hCvkXsTjBUMTZvnUnOUU5DkeepD,fbPkOYLVPtPgIt0MxizjfFJov3JbHyAi,18,30,18,0,9,16,18,0,91,13.0,2,0.0,0,18,0,9,30,16,0,18,0,27,64,1
4201,84274,KSAnx8l7GLibIHVjfaVpoMytCY29O5jV,fbPkOYLVPtPgIt0MxizjfFJov3JbHyAi,14,10,7,0,6,0,6,0,29,4.142857142857143,1,0.0,0,7,0,6,10,0,0,6,0,13,16,1
4202,84276,FHZxLNKuH41dzVdZ6xZP53e1ChodL4Nf,fbPkOYLVPtPgIt0MxizjfFJov3JbHyAi,2,0,0,0,0,0,2,0,2,0.2857142857142857,1,0.0,0,0,0,0,0,0,0,2,0,0,2,1
4203,84277,2j1tzVxn26ffq0mMvPPBIt1027gHtJr2,fbPkOYLVPtPgIt0MxizjfFJov3JbHyAi,3,0,0,0,0,0,4,0,4,0.5714285714285714,1,0.0,0,0,0,0,0,0,0,4,0,0,4,1
4204,84278,sW5iKRsVcoKx4Fgip5uKQwojFhK3kh4H,fbPkOYLVPtPgIt0MxizjfFJov3JbHyAi,7,8,3,0,2,0,4,0,17,2.4285714285714284,1,0.0,3,3,0,2,5,0,0,4,0,8,9,1
4205,84279,IKnWhfStgn6HzF4rCtxpMA6vaE95bkoN,fbPkOYLVPtPgIt0MxizjfFJov3JbHyAi,41,56,31,28,21,7,6,0,149,21.285714285714285,1,0.0,18,31,23,21,38,7,5,6,0,93,56,1
4206,84281,E6x1c22fqqwc9Xq0TREOCZPgn8h5NZRY,fbPkOYLVPtPgIt0MxizjfFJov3JbHyAi,2,0,0,0,0,0,2,0,2,0.2857142857142857,1,0.0,0,0,0,0,0,0,0,2,0,0,2,1
4207,84282,oyKcbflIhFWjfv9zJsn9ws83l2i6sd8B,fbPkOYLVPtPgIt0MxizjfFJov3JbHyAi,5,0,0,0,0,0,4,1,5,0.7142857142857143,1,0.0,0,0,0,0,0,0,0,4,1,0,5,1
4208,84284,SfvT6FHCLeajKH96s2LkoIO8YQ9sAqIE,fbPkOYLVPtPgIt0MxizjfFJov3JbHyAi,1,0,0,0,0,0,1,0,1,0.14285714285714285,1,0.0,0,0,0,0,0,0,0,1,0,0,1,1
4209,84285,6dxWIDqaYjsp7lwDHFYen9IBERKYGMUl,fbPkOYLVPtPgIt0MxizjfFJov3JbHyAi,11,13,9,0,7,1,9,1,40,5.714285714285714,4,0.0,0,9,0,7,13,1,0,9,1,16,24,1
4210,84289,8a6lcOY5tqRSg2M4LEQLAhRHX2NBy9qe,fbPkOYLVPtPgIt0MxizjfFJov3JbHyAi,1,0,0,0,0,0,1,0,1,0.14285714285714285,1,0.0,0,0,0,0,0,0,0,1,0,0,1,1
4211,84291,8V79kzOnHwVk0Szz0Nr0pjOSCgEaC0bl,fbPkOYLVPtPgIt0MxizjfFJov3JbHyAi,1,0,0,0,0,0,1,0,1,0.14285714285714285,1,0.0,0,0,0,0,0,0,0,1,0,0,1,0
4212,84433,Vu8rN942EwDIOj6iE8IDqvSFXpvGHO9R,A3fsA9Zfv1X2fVEQhTw51lKENdNrEqT3,49,28,21,72,12,0,10,0,143,20.428571428571427,2,0.0,4,21,57,12,24,0,15,10,0,94,49,1
4213,84438,zo3To03Q5Rdok3x4Zu1wNdsKqNDBlzyd,SpATywNh6bZuzm8s1ceuBUnMUAeoAHHw,3,2,1,0,0,2,1,0,6,0.8571428571428571,2,0.0,0,1,0,0,2,2,0,1,0,1,5,1
4214,84439,lmCPiW6l0WNp9Ttn0lhwFDs7FfVubtvY,SpATywNh6bZuzm8s1ceuBUnMUAeoAHHw,27,63,7,48,3,0,9,2,132,18.857142857142858,5,0.0,33,7,43,3,30,0,5,9,2,86,46,0
4215,84443,d27sJazbqmVDzx5twhACbiEBxUXvQf2a,SpATywNh6bZuzm8s1ceuBUnMUAeoAHHw,8,4,1,0,1,0,6,0,12,1.7142857142857142,1,0.0,0,1,0,1,4,0,0,6,0,2,10,1
4216,84463,ROXnyv16zBgjdP3dwdWTQaFrI7qQfgov,bWdj2GDclj5ofokWjzoa5jAwMkxCykd6,3,0,0,0,0,0,3,0,3,0.42857142857142855,1,0.0,0,0,0,0,0,0,0,3,0,0,3,1
4217,84487,dlcs3mIk1dQaLsNVv2V1gEVdgllvLwJb,SpATywNh6bZuzm8s1ceuBUnMUAeoAHHw,8,10,4,0,1,1,5,0,21,3.0,2,0.0,2,4,0,1,8,1,0,5,0,7,14,1
4218,84488,Hb1qgsgjtdXdXqLzZUND7Apyl9dV7sNn,SpATywNh6bZuzm8s1ceuBUnMUAeoAHHw,15,26,1,18,1,0,2,0,48,6.857142857142857,1,0.0,6,1,15,1,20,0,3,2,0,23,25,1
4219,84493,yEniPsoZW8Rgn4eOpAbvQhjj6pD8iwKc,bWdj2GDclj5ofokWjzoa5jAwMkxCykd6,3,2,0,0,0,0,1,0,3,0.42857142857142855,1,0.0,0,0,0,0,2,0,0,1,0,0,3,1
4220,84511,IDZ1AkiRXaR9yEtXb4Bo4nmlcF9ha0Jw,A3fsA9Zfv1X2fVEQhTw51lKENdNrEqT3,11,10,1,0,1,0,2,0,14,2.0,1,0.0,0,1,0,1,10,0,0,2,0,2,12,1
4221,84515,7zovZ3nFJhhuFND78aqDkmZfLWj3rVkx,bWdj2GDclj5ofokWjzoa5jAwMkxCykd6,8,11,3,0,4,1,5,1,25,3.5714285714285716,1,0.0,5,3,0,4,6,1,0,5,1,12,13,1
4222,84531,UwNh19bGTGX7YEBtcKZFqxDpmh2gUs3A,SpATywNh6bZuzm8s1ceuBUnMUAeoAHHw,26,42,19,30,11,1,5,0,108,15.428571428571429,3,0.0,11,19,27,11,31,1,3,5,0,68,40,0
4223,84533,KYp9UMy6aThBgyjsQnGoWdfiTDRtgnUO,A3fsA9Zfv1X2fVEQhTw51lKENdNrEqT3,4,3,1,0,0,0,1,0,5,0.7142857142857143,1,0.0,0,1,0,0,3,0,0,1,0,1,4,1
4224,84562,k6RJ44LpfDefc4BqSfb5Ks3bqRLzpbPs,SpATywNh6bZuzm8s1ceuBUnMUAeoAHHw,3,2,0,0,0,0,1,0,3,0.42857142857142855,1,0.0,0,0,0,0,2,0,0,1,0,0,3,1
4225,84570,3ROVLcXTo6OjIxmsQ13CBJ7pM5RMLVRs,SpATywNh6bZuzm8s1ceuBUnMUAeoAHHw,1,0,0,0,0,0,1,0,1,0.14285714285714285,1,0.0,0,0,0,0,0,0,0,1,0,0,1,1
4226,84617,7QvV3hsa8puVP6u6wQJmusW3X0nL3GiJ,RXDvfPUBYFlVdlueBFbLW0mhhAyGEqpt,6,4,2,0,1,0,2,0,9,1.2857142857142858,1,0.0,0,2,0,1,4,0,0,2,0,3,6,1
4227,84622,UkZfNxIrXEzpCVrNVYStVn9ei74ROLV5,SpATywNh6bZuzm8s1ceuBUnMUAeoAHHw,9,4,3,0,3,0,2,0,12,1.7142857142857142,1,0.0,0,3,0,3,4,0,0,2,0,6,6,1
4228,84637,uqV3t3wNYphdy7WkOt07V9fSIpdy9v7v,SpATywNh6bZuzm8s1ceuBUnMUAeoAHHw,1,0,0,0,0,0,1,0,1,0.14285714285714285,1,0.0,0,0,0,0,0,0,0,1,0,0,1,1
4229,84650,rM6lHK7hiIUNX1NSrJxSbqLCGaqN5u1S,bWdj2GDclj5ofokWjzoa5jAwMkxCykd6,1,0,0,0,0,0,1,0,1,0.14285714285714285,1,0.0,0,0,0,0,0,0,0,1,0,0,1,1
4230,84655,fuprfcX49r5QcUYvMQnvvzEf76cx4sRp,A3fsA9Zfv1X2fVEQhTw51lKENdNrEqT3,1,0,0,0,0,0,1,0,1,0.14285714285714285,1,0.0,0,0,0,0,0,0,0,1,0,0,1,1
4231,84656,DA41CWRarbj2LaaLGDHgoyCQ99QpXH1z,SpATywNh6bZuzm8s1ceuBUnMUAeoAHHw,1,0,0,0,0,0,1,0,1,0.14285714285714285,1,0.0,0,0,0,0,0,0,0,1,0,0,1,1
4232,84687,LuY5FiD3zLZEjwGtpCcfkhMm5sUdJ1VF,RXDvfPUBYFlVdlueBFbLW0mhhAyGEqpt,1,0,0,0,0,0,1,0,1,0.14285714285714285,1,0.0,0,0,0,0,0,0,0,1,0,0,1,1
4233,84696,HDx7XT9cwQtHtGFe0Ylk6QLaCz2f0GRa,bWdj2GDclj5ofokWjzoa5jAwMkxCykd6,11,17,11,0,2,11,7,0,48,6.857142857142857,3,0.0,1,11,0,2,16,11,0,7,0,14,34,1
4234,84697,aaRUd5jlFUSCfSYwox8KYccyK9uFgesK,G8EPVSXsOYB5YQWZGiz1aVq5Pgr2GrQu,5,2,1,0,1,0,2,0,6,0.8571428571428571,1,0.0,0,1,0,1,2,0,0,2,0,2,4,1
4235,84712,rK4055OdlTymOWiwkxW7eIve09mowPhX,bWdj2GDclj5ofokWjzoa5jAwMkxCykd6,17,25,13,40,8,5,9,1,101,14.428571428571429,2,0.0,7,13,35,8,18,5,5,9,1,63,38,1
4236,84733,9WmzxyamLAgd2LnrO6zydiN7WV3MNZZt,SpATywNh6bZuzm8s1ceuBUnMUAeoAHHw,30,57,41,26,13,45,20,3,205,29.285714285714285,4,0.0,11,41,26,13,46,45,0,20,3,91,114,1
4237,84746,KyernIkPskZZLcEZuqJdIALK35DoR4YD,SpATywNh6bZuzm8s1ceuBUnMUAeoAHHw,9,7,4,7,3,0,1,0,22,3.142857142857143,1,0.0,1,4,6,3,6,0,1,1,0,14,8,0
4238,84764,l0LgYDne2SMH172pM6WtwTolJro40hEN,bWdj2GDclj5ofokWjzoa5jAwMkxCykd6,8,8,5,0,2,0,2,0,17,2.4285714285714284,1,0.0,0,5,0,2,8,0,0,2,0,7,10,1
4239,84768,DsHgWZRTJ1y1l15smwhB78ZQq3d8dyKP,bWdj2GDclj5ofokWjzoa5jAwMkxCykd6,12,73,5,24,7,2,17,0,128,18.285714285714285,8,0.0,8,5,23,7,65,2,1,17,0,43,85,1
4240,84773,pQdSl7i5ZuZeH9uPILgdHrvwskp4vc4V,RXDvfPUBYFlVdlueBFbLW0mhhAyGEqpt,2,0,0,0,0,0,2,0,2,0.2857142857142857,1,0.0,0,0,0,0,0,0,0,2,0,0,2,1
4241,84803,RijiZcjqs3Sau2onXuynGNDorKgFFeFF,A3fsA9Zfv1X2fVEQhTw51lKENdNrEqT3,1,0,0,0,0,0,1,0,1,0.14285714285714285,1,0.0,0,0,0,0,0,0,0,1,0,0,1,1
4242,84807,lBDP0bEGdpXmY1IAvAuALKqFWFlEuPft,A3fsA9Zfv1X2fVEQhTw51lKENdNrEqT3,1,0,0,0,0,0,1,0,1,0.14285714285714285,1,0.0,0,0,0,0,0,0,0,1,0,0,1,1
4243,84823,Wefj86tFjwJZnMq6IAWMjbzJgYWyoGE5,A3fsA9Zfv1X2fVEQhTw51lKENdNrEqT3,7,4,1,0,1,0,2,0,8,1.1428571428571428,1,0.0,0,1,0,1,4,0,0,2,0,2,6,1
4244,84824,CCr7XJJW4dK2W5QL9m4z2ZC42b4ulnok,SpATywNh6bZuzm8s1ceuBUnMUAeoAHHw,23,25,15,0,7,2,13,2,64,9.142857142857142,4,0.0,5,15,0,7,20,2,0,13,2,27,37,0
4245,84837,yv537v6H4lKuJBGFGcy0VRT6imwv3rrr,SpATywNh6bZuzm8s1ceuBUnMUAeoAHHw,1,0,0,0,0,0,2,0,2,0.2857142857142857,1,0.0,0,0,0,0,0,0,0,2,0,0,2,1
4246,84840,nMDev1avOgY53G2oqsCYhN7adTYqimPz,SpATywNh6bZuzm8s1ceuBUnMUAeoAHHw,20,20,10,13,7,0,4,0,54,7.714285714285714,3,0.0,6,10,12,7,14,0,1,4,0,35,19,1
4247,84856,IKpNQ2VJXcBrssoIsB3X4wtY2qE1YTKj,bWdj2GDclj5ofokWjzoa5jAwMkxCykd6,8,18,10,0,6,3,6,0,43,6.142857142857143,4,0.0,0,10,0,6,18,3,0,6,0,16,27,1
4248,84879,Wq9v1J863GLs0FXJcY6870pE4xwQWj9c,SpATywNh6bZuzm8s1ceuBUnMUAeoAHHw,7,6,3,0,2,1,5,0,17,2.4285714285714284,1,0.0,0,3,0,2,6,1,0,5,0,5,12,1
4249,84893,aXizpBfL2fbBc8SAHrmAdMBwyiDoIJ3v,SpATywNh6bZuzm8s1ceuBUnMUAeoAHHw,3,2,0,0,0,0,2,0,4,0.5714285714285714,1,0.0,0,0,0,0,2,0,0,2,0,0,4,1
4250,84898,BNaKyL5AxH5r8ATMyUD5dD2w9iqh31Mt,SpATywNh6bZuzm8s1ceuBUnMUAeoAHHw,8,6,4,0,3,0,4,0,17,2.4285714285714284,1,0.0,0,4,0,3,6,0,0,4,0,7,10,1
4251,84899,AMjnZTCZ82BDNCUbVBOLwJQKlTsIjteg,bWdj2GDclj5ofokWjzoa5jAwMkxCykd6,1,0,0,0,0,0,1,0,1,0.14285714285714285,1,0.0,0,0,0,0,0,0,0,1,0,0,1,1
4252,84914,CAJCBn0iJNYHHRrNYpaEyoUpQFaCqopf,SpATywNh6bZuzm8s1ceuBUnMUAeoAHHw,3,0,0,0,0,11,2,0,13,1.8571428571428572,1,0.0,0,0,0,0,0,11,0,2,0,0,13,1
4253,84920,P8HECw7bHyNqGqPTlWbv24tTg1SG6bAf,A3fsA9Zfv1X2fVEQhTw51lKENdNrEqT3,12,7,5,0,4,0,4,0,20,2.857142857142857,2,0.0,0,5,0,4,7,0,0,4,0,9,11,1
4254,84924,bkuP1EtN8mdTFJXvfsUwoFetipNOKV1x,A3fsA9Zfv1X2fVEQhTw51lKENdNrEqT3,6,4,0,0,0,2,3,0,9,1.2857142857142858,2,0.0,0,0,0,0,4,2,0,3,0,0,9,0
4255,84932,fpXwVrOW9HYGTHXhtLxKXSs2JRhI6VdQ,G8EPVSXsOYB5YQWZGiz1aVq5Pgr2GrQu,2,0,0,0,0,0,2,0,2,0.2857142857142857,1,0.0,0,0,0,0,0,0,0,2,0,0,2,1
4256,84933,u0SrW65Zdf0RG2PPgt52qf6MWWYZDmbZ,A3fsA9Zfv1X2fVEQhTw51lKENdNrEqT3,4,2,1,0,1,0,2,0,6,0.8571428571428571,1,0.0,0,1,0,1,2,0,0,2,0,2,4,0
4257,84941,wdyLBUXnKZHWy3hjP9iEUMTvoZlBkTI1,A3fsA9Zfv1X2fVEQhTw51lKENdNrEqT3,73,22,16,216,11,2,5,0,272,38.857142857142854,2,0.0,4,16,172,11,18,2,44,5,0,203,69,1
4258,84943,tqYPV9KH0m40QH4HM703oTrUL5BNNo84,bWdj2GDclj5ofokWjzoa5jAwMkxCykd6,3,3,0,0,0,0,2,0,5,0.7142857142857143,1,0.0,0,0,0,0,3,0,0,2,0,0,5,1
4259,84959,hkI32MAgHvJ4T3I3Up79daEJ8l4sKHaC,A3fsA9Zfv1X2fVEQhTw51lKENdNrEqT3,19,11,10,16,9,0,1,0,47,6.714285714285714,1,0.0,0,10,15,9,11,0,1,1,0,34,13,1
4260,84967,cnF5YfjX3CQt7JMSCL8P4leqdmCPbBni,A3fsA9Zfv1X2fVEQhTw51lKENdNrEqT3,8,8,1,0,1,0,2,0,12,1.7142857142857142,2,0.0,1,1,0,1,7,0,0,2,0,3,9,1
4261,84969,AhGz4Es1bWdEWhXy7JGcFI2vY1lHgQNv,A3fsA9Zfv1X2fVEQhTw51lKENdNrEqT3,11,14,7,0,4,0,9,0,34,4.857142857142857,1,0.0,0,7,0,4,14,0,0,9,0,11,23,1
4262,84982,KogrHROquIJLSXIZqzhYU9Hcb9zVebwT,A3fsA9Zfv1X2fVEQhTw51lKENdNrEqT3,68,28,21,134,13,39,12,1,248,35.42857142857143,3,0.0,3,21,108,13,25,39,26,12,1,145,103,1
4263,85000,7ZT5u11YEDTZhD4NZDPzOcLz6uLhq9Bd,RXDvfPUBYFlVdlueBFbLW0mhhAyGEqpt,14,12,8,8,3,0,3,0,34,4.857142857142857,2,0.0,1,8,7,3,11,0,1,3,0,19,15,1
4264,85006,tj54X35V4FNci4Kh3LQpxJqVKMwouLiV,SpATywNh6bZuzm8s1ceuBUnMUAeoAHHw,1,0,0,0,0,0,1,0,1,0.14285714285714285,1,0.0,0,0,0,0,0,0,0,1,0,0,1,1
4265,85036,Dieqd8f4UcwVzwl01TlWitYgH9I2P4ID,SpATywNh6bZuzm8s1ceuBUnMUAeoAHHw,14,16,5,15,3,0,2,0,41,5.857142857142857,1,0.0,10,5,12,3,6,0,3,2,0,30,11,1
4266,85058,aIIHBjdeRcv9jhajcTkxD39vpVMqF1ri,SpATywNh6bZuzm8s1ceuBUnMUAeoAHHw,1,0,0,0,0,0,1,0,1,0.14285714285714285,1,0.0,0,0,0,0,0,0,0,1,0,0,1,1
4267,85071,aO0LEwjTmeNegVPIDdxnfGASlS2PDBPM,bWdj2GDclj5ofokWjzoa5jAwMkxCykd6,4,2,0,0,0,0,2,0,4,0.5714285714285714,1,0.0,0,0,0,0,2,0,0,2,0,0,4,1
4268,85074,DxH75iZ2vwK7RWdx8JWNqysBZPhRedJP,SpATywNh6bZuzm8s1ceuBUnMUAeoAHHw,14,9,7,0,6,0,4,0,26,3.7142857142857144,1,0.0,0,7,0,6,9,0,0,4,0,13,13,1
4269,85101,eUiPnt4yNOhbT6A4YKzKQWtxymmKMqK8,SpATywNh6bZuzm8s1ceuBUnMUAeoAHHw,5,2,1,0,1,0,2,0,6,0.8571428571428571,1,0.0,0,1,0,1,2,0,0,2,0,2,4,0
4270,85143,cnF5YfjX3CQt7JMSCL8P4leqdmCPbBni,SpATywNh6bZuzm8s1ceuBUnMUAeoAHHw,19,28,5,19,3,1,11,2,69,9.857142857142858,4,0.0,2,5,17,3,26,1,2,11,2,27,42,1
4271,85147,Yce7TA6zcxabzTyAHw2EdJ3TEisyjXyi,G8EPVSXsOYB5YQWZGiz1aVq5Pgr2GrQu,1,0,0,0,0,0,1,0,1,0.14285714285714285,1,0.0,0,0,0,0,0,0,0,1,0,0,1,1
4272,85159,t5GAapz2qu7QW3ZA52Mo1qG5gvWMLT4H,G8EPVSXsOYB5YQWZGiz1aVq5Pgr2GrQu,11,23,9,0,8,0,1,0,41,5.857142857142857,1,0.0,13,9,0,8,10,0,0,1,0,30,11,1
4273,85161,bjM6n8DVZxyRbCs3zMbeKGW5iCOjCuf2,SpATywNh6bZuzm8s1ceuBUnMUAeoAHHw,30,32,17,38,7,20,9,1,124,17.714285714285715,3,0.0,12,17,31,7,20,20,7,9,1,67,57,0
4274,85163,W8y6AnXsJBrDnPij0rvHOisz3iKgMu0I,A3fsA9Zfv1X2fVEQhTw51lKENdNrEqT3,1,0,0,0,0,0,1,0,1,0.14285714285714285,1,0.0,0,0,0,0,0,0,0,1,0,0,1,1
4275,85203,9WmzxyamLAgd2LnrO6zydiN7WV3MNZZt,A3fsA9Zfv1X2fVEQhTw51lKENdNrEqT3,20,40,37,0,19,4,6,1,107,15.285714285714286,1,0.0,0,37,0,19,40,4,0,6,1,56,51,1
4276,85211,aCaozGkyCsn54GVTA7Zc8fb6f5Q5mLe0,G8EPVSXsOYB5YQWZGiz1aVq5Pgr2GrQu,2,0,0,0,0,0,2,0,2,0.2857142857142857,1,0.0,0,0,0,0,0,0,0,2,0,0,2,1
4277,85214,t5GAapz2qu7QW3ZA52Mo1qG5gvWMLT4H,SpATywNh6bZuzm8s1ceuBUnMUAeoAHHw,20,25,12,0,8,0,3,0,48,6.857142857142857,2,0.0,12,12,0,8,13,0,0,3,0,32,16,0
4278,85217,LgWCkAUxSRrYwIgyk3EiLrbm8VtT63oN,SpATywNh6bZuzm8s1ceuBUnMUAeoAHHw,5,3,0,0,0,0,2,0,5,0.7142857142857143,1,0.0,0,0,0,0,3,0,0,2,0,0,5,1
4279,85224,1DHzwL80UljY6lJVpTYvYIaqwxFV4OAM,A3fsA9Zfv1X2fVEQhTw51lKENdNrEqT3,4,4,0,0,0,0,2,0,6,0.8571428571428571,1,0.0,0,0,0,0,4,0,0,2,0,0,6,1
4280,85249,p6TgFJdLQMaMzbR16kycIPcRPnBj3paK,A3fsA9Zfv1X2fVEQhTw51lKENdNrEqT3,4,2,1,0,1,0,1,0,5,0.7142857142857143,1,0.0,0,1,0,1,2,0,0,1,0,2,3,1
4281,85253,XJf8gYhDJm1hrkVJvLQ4HKEnvPd3mIMq,G8EPVSXsOYB5YQWZGiz1aVq5Pgr2GrQu,22,41,2,50,0,3,5,0,101,14.428571428571429,3,0.0,19,2,33,0,22,3,17,5,0,54,47,1
4282,85262,F2owRK2SDPW5FCDK4TxmBVHsTtJ44Nxq,A3fsA9Zfv1X2fVEQhTw51lKENdNrEqT3,12,19,2,0,2,0,3,0,26,3.7142857142857144,2,0.0,0,2,0,2,19,0,0,3,0,4,22,1
4283,85271,pMl3OskiuqgHNgKCqbUXUq2PDmPkrU2r,bWdj2GDclj5ofokWjzoa5jAwMkxCykd6,5,2,1,0,1,0,2,0,6,0.8571428571428571,1,0.0,0,1,0,1,2,0,0,2,0,2,4,1
4284,85283,9WmzxyamLAgd2LnrO6zydiN7WV3MNZZt,RXDvfPUBYFlVdlueBFbLW0mhhAyGEqpt,9,12,10,0,5,0,6,0,33,4.714285714285714,3,0.0,0,10,0,5,12,0,0,6,0,15,18,1
4285,85284,Ws4jgichwsX0H8doBZ8nJsfB9pxtw9wh,SpATywNh6bZuzm8s1ceuBUnMUAeoAHHw,1,0,0,0,0,0,1,0,1,0.14285714285714285,1,0.0,0,0,0,0,0,0,0,1,0,0,1,1
4286,85286,pMl3OskiuqgHNgKCqbUXUq2PDmPkrU2r,A3fsA9Zfv1X2fVEQhTw51lKENdNrEqT3,2,0,0,0,0,0,2,0,2,0.2857142857142857,1,0.0,0,0,0,0,0,0,0,2,0,0,2,1
4287,85295,Zp1ZZPWn2kKT7nmilqO0Enc4rubJRG8n,SpATywNh6bZuzm8s1ceuBUnMUAeoAHHw,13,39,2,0,1,1,42,0,85,12.142857142857142,6,0.0,0,2,0,1,39,1,0,42,0,3,82,0
4288,85297,4VgoVQWGOr2mBZAQVNzDshzPrpqcYbQA,SpATywNh6bZuzm8s1ceuBUnMUAeoAHHw,5,4,0,0,0,0,3,0,7,1.0,2,0.0,0,0,0,0,4,0,0,3,0,0,7,1
4289,85328,VZ5o45Yr5Bm8WANLZeoMpkPB24du6vYe,SpATywNh6bZuzm8s1ceuBUnMUAeoAHHw,1,0,0,0,0,0,1,0,1,0.14285714285714285,1,0.0,0,0,0,0,0,0,0,1,0,0,1,1
4290,85331,RZI7KROUR7i2T6MB71TuoKGbXE5WXiwO,SpATywNh6bZuzm8s1ceuBUnMUAeoAHHw,5,10,0,0,0,0,5,0,15,2.142857142857143,2,0.0,0,0,0,0,10,0,0,5,0,0,15,1
4291,85337,176ILS8J1NMmZsoc0RxEg8JQJcz6ksLo,SpATywNh6bZuzm8s1ceuBUnMUAeoAHHw,1,0,0,0,0,0,1,0,1,0.14285714285714285,1,0.0,0,0,0,0,0,0,0,1,0,0,1,1
4292,85351,4E7spFhBfl0gEqkMBOstVjR5pQXkTXaF,SpATywNh6bZuzm8s1ceuBUnMUAeoAHHw,1,0,0,0,0,0,1,0,1,0.14285714285714285,1,0.0,0,0,0,0,0,0,0,1,0,0,1,1
4293,85376,tO135VWcqma21HvgPTdpgoHPq5kDsz9m,SpATywNh6bZuzm8s1ceuBUnMUAeoAHHw,4,2,1,0,1,0,2,0,6,0.8571428571428571,1,0.0,0,1,0,1,2,0,0,2,0,2,4,1
4294,85377,tO135VWcqma21HvgPTdpgoHPq5kDsz9m,A3fsA9Zfv1X2fVEQhTw51lKENdNrEqT3,4,2,1,0,1,0,1,0,5,0.7142857142857143,1,0.0,0,1,0,1,2,0,0,1,0,2,3,1
4295,86978,w4c5I9GnSWI6sLkTNrP2S1NFytPszceZ,SpATywNh6bZuzm8s1ceuBUnMUAeoAHHw,7,6,4,0,3,0,2,0,15,2.142857142857143,2,0.0,0,4,0,3,6,0,0,2,0,7,8,1
4296,87018,puN480TO3qbGXrXmM5qoOdmstQ51OC6E,A3fsA9Zfv1X2fVEQhTw51lKENdNrEqT3,27,30,21,0,14,3,25,1,94,13.428571428571429,4,0.0,1,21,0,14,29,3,0,25,1,36,58,0
4297,87033,zvew9uiEAc86Yp9YluqFrNFVBMozMu7i,A3fsA9Zfv1X2fVEQhTw51lKENdNrEqT3,1,0,0,0,0,0,1,0,1,0.14285714285714285,1,0.0,0,0,0,0,0,0,0,1,0,0,1,1
4298,87044,BcU9hDrDz2F2xEd3tqF67ZptaAdextzP,SpATywNh6bZuzm8s1ceuBUnMUAeoAHHw,6,3,1,0,1,0,2,0,7,1.0,1,0.0,0,1,0,1,3,0,0,2,0,2,5,1
4299,87057,SWjmkEB4DVctTeY4CrwF2QrGDf4olJAZ,RXDvfPUBYFlVdlueBFbLW0mhhAyGEqpt,72,117,58,99,30,34,16,2,356,50.857142857142854,2,0.0,39,58,93,30,78,34,6,16,2,220,136,0
4300,87111,fDs5TBVrvPHEIMLkBACIVQ2YkCdHCFLD,SpATywNh6bZuzm8s1ceuBUnMUAeoAHHw,10,11,8,0,5,0,3,0,27,3.857142857142857,2,0.0,0,8,0,5,11,0,0,3,0,13,14,1
4301,87127,dNFEIzn0depAU4oAUIlHxTqSNcin3JsM,SpATywNh6bZuzm8s1ceuBUnMUAeoAHHw,26,80,25,37,4,18,29,4,197,28.142857142857142,7,0.0,9,25,33,4,71,18,4,29,4,71,126,0
4302,87133,O6WL6sxvoPCZnvTLyTPxdXbnpOz3wcJ4,A3fsA9Zfv1X2fVEQhTw51lKENdNrEqT3,10,7,2,0,2,0,2,0,13,1.8571428571428572,1,0.0,0,2,0,2,7,0,0,2,0,4,9,0
4303,87198,BPhS68WnBhNHxaKVrJj2k4cMtvSG9MHx,A3fsA9Zfv1X2fVEQhTw51lKENdNrEqT3,1,0,0,0,0,0,1,0,1,0.14285714285714285,1,0.0,0,0,0,0,0,0,0,1,0,0,1,1
4304,87268,D8OsqlH4HwBA4SgJzaxGlNrfcU5wwsM1,A3fsA9Zfv1X2fVEQhTw51lKENdNrEqT3,8,4,1,0,1,0,5,0,11,1.5714285714285714,1,0.0,0,1,0,1,4,0,0,5,0,2,9,1
4305,87281,8fWrC0LYUq5E0gzy0gw2GD73h6o6q5AG,SpATywNh6bZuzm8s1ceuBUnMUAeoAHHw,14,56,5,16,3,1,7,0,88,12.571428571428571,5,0.0,25,5,14,3,31,1,2,7,0,47,41,0
4306,87290,VMnSHKgiFqLTglPUaPUtMkU91MLAPOwr,A3fsA9Zfv1X2fVEQhTw51lKENdNrEqT3,1,0,0,0,0,0,1,0,1,0.14285714285714285,1,0.0,0,0,0,0,0,0,0,1,0,0,1,1
4307,87349,FrSJpsrFHBf3i9duciIn6pd6hWdG8OCf,SpATywNh6bZuzm8s1ceuBUnMUAeoAHHw,12,8,6,0,5,0,4,0,23,3.2857142857142856,2,0.0,0,6,0,5,8,0,0,4,0,11,12,1
4308,87383,7zKNYNlQe19MsOrdmzXSTtaqDWKHEPlA,SpATywNh6bZuzm8s1ceuBUnMUAeoAHHw,3,2,1,0,0,0,1,0,4,0.5714285714285714,1,0.0,0,1,0,0,2,0,0,1,0,1,3,0
4309,87440,MvkQjmVQSq3aFQKnqlTw1GsAe1sz0UUt,RXDvfPUBYFlVdlueBFbLW0mhhAyGEqpt,14,9,8,0,6,0,1,0,24,3.4285714285714284,1,0.0,0,8,0,6,9,0,0,1,0,14,10,1
4310,87491,FlceAJAIuFEY4b8DElr16vmZGD1aqVDJ,A3fsA9Zfv1X2fVEQhTw51lKENdNrEqT3,2,0,0,0,0,0,2,0,2,0.2857142857142857,1,0.0,0,0,0,0,0,0,0,2,0,0,2,1
4311,87584,NtOBKvqn4kjpyBFY5EbWAhwnHWFAQxgf,A3fsA9Zfv1X2fVEQhTw51lKENdNrEqT3,2,0,0,0,0,0,5,0,5,0.7142857142857143,3,0.0,0,0,0,0,0,0,0,5,0,0,5,1
4312,87596,omogDjehriHed7WOB06lowOCzWJT5HFG,SpATywNh6bZuzm8s1ceuBUnMUAeoAHHw,1,0,0,0,0,0,1,0,1,0.14285714285714285,1,0.0,0,0,0,0,0,0,0,1,0,0,1,1
4313,87630,IUn6MADAjAYkGlJisA1WiDvCeNlJd5Xd,A3fsA9Zfv1X2fVEQhTw51lKENdNrEqT3,6,3,1,0,1,0,5,0,10,1.4285714285714286,2,0.0,0,1,0,1,3,0,0,5,0,2,8,1
4314,87652,CeA39yEXem4lTmymvIZvr20kWcsmIjJE,SpATywNh6bZuzm8s1ceuBUnMUAeoAHHw,13,15,7,14,3,0,2,0,41,5.857142857142857,1,0.0,6,7,13,3,9,0,1,2,0,29,12,0
4315,87691,9vlKLLRVHTgTa2OMtndxw1oJeJABVSGY,RXDvfPUBYFlVdlueBFbLW0mhhAyGEqpt,48,77,33,144,16,15,7,2,294,42.0,2,0.0,14,33,123,16,63,15,21,7,2,186,108,0
4316,87695,oL1G89Phk4nduULmJ17br7A4xddcHdc4,A3fsA9Zfv1X2fVEQhTw51lKENdNrEqT3,8,6,4,0,3,0,6,0,19,2.7142857142857144,4,0.0,0,4,0,3,6,0,0,6,0,7,12,0
4317,87724,LC5o73xONnaYfCUJGUgN0IxEKcRaag3p,SpATywNh6bZuzm8s1ceuBUnMUAeoAHHw,7,5,1,0,1,0,3,0,10,1.4285714285714286,1,0.0,0,1,0,1,5,0,0,3,0,2,8,1
4318,87775,Tk65NSEWZoGK32sB9eYUeC558zBlLPIW,RXDvfPUBYFlVdlueBFbLW0mhhAyGEqpt,8,8,5,0,3,0,1,0,17,2.4285714285714284,1,0.0,2,5,0,3,6,0,0,1,0,10,7,0
4319,87802,3JEt0I9b0JhZhM0RD2D5jI5S8zjjeHFo,SpATywNh6bZuzm8s1ceuBUnMUAeoAHHw,10,6,2,0,1,1,6,1,17,2.4285714285714284,2,0.0,0,2,0,1,6,1,0,6,1,3,14,0
4320,87845,px7NQdp7hj15LfG8wdonX24QornqR4Mh,A3fsA9Zfv1X2fVEQhTw51lKENdNrEqT3,4,5,1,0,0,0,1,0,7,1.0,1,0.0,0,1,0,0,5,0,0,1,0,1,6,1
4321,87858,0LERVBlr0s6pvZPTHfS8Y74dmJWxJhcj,A3fsA9Zfv1X2fVEQhTw51lKENdNrEqT3,101,55,36,230,21,3,42,7,394,56.285714285714285,4,0.0,5,36,223,21,50,3,7,42,7,285,109,0
4322,87860,Uggn85R7OMhc9c2ThQoRc9ji4ASPnsWa,SpATywNh6bZuzm8s1ceuBUnMUAeoAHHw,17,51,19,20,8,15,17,2,132,18.857142857142858,4,0.0,19,19,17,8,32,15,3,17,2,63,69,0
4323,87885,6pqyTvtsNsVOIJ2FRrlzuEgPKDTZeNek,A3fsA9Zfv1X2fVEQhTw51lKENdNrEqT3,2,0,0,0,0,0,2,0,2,0.2857142857142857,1,0.0,0,0,0,0,0,0,0,2,0,0,2,1
4324,87896,sUisvEEUk43TysdqdEKz0DR2Te843pgb,A3fsA9Zfv1X2fVEQhTw51lKENdNrEqT3,4,7,1,0,0,0,2,0,10,1.4285714285714286,1,0.0,0,1,0,0,7,0,0,2,0,1,9,1
4325,87912,j9L0wsMRR1iguKEo2FSLNGEw5WM5csHy,SpATywNh6bZuzm8s1ceuBUnMUAeoAHHw,5,0,0,0,0,3,6,1,10,1.4285714285714286,1,0.0,0,0,0,0,0,3,0,6,1,0,10,0
4326,88076,qBuydljzKIRip5ZglverOwggslbNziA6,A3fsA9Zfv1X2fVEQhTw51lKENdNrEqT3,1,0,0,0,0,0,5,0,5,0.7142857142857143,1,0.0,0,0,0,0,0,0,0,5,0,0,5,1
4327,88097,dCAqk9uHiS99GMTcJQtThG8XWnwwbp5Q,A3fsA9Zfv1X2fVEQhTw51lKENdNrEqT3,11,26,0,0,0,0,6,0,32,4.571428571428571,2,0.0,0,0,0,0,26,0,0,6,0,0,32,1
4328,88166,fVHUMs4z7aTjXofyWNn8EBPM3SN6fL56,A3fsA9Zfv1X2fVEQhTw51lKENdNrEqT3,1,0,0,0,0,0,1,0,1,0.14285714285714285,1,0.0,0,0,0,0,0,0,0,1,0,0,1,1
4329,88172,mB36rXDIKgGQROGEKlrDrvsLRYA6xyWr,A3fsA9Zfv1X2fVEQhTw51lKENdNrEqT3,47,28,17,88,10,2,23,4,172,24.571428571428573,3,0.0,4,17,76,10,24,2,12,23,4,107,65,0
4330,88193,aQvvfNyOjWznHFpUuaLIM1cVrgSp2dSp,SpATywNh6bZuzm8s1ceuBUnMUAeoAHHw,9,14,0,9,0,0,6,2,31,4.428571428571429,1,0.0,3,0,7,0,11,0,2,6,2,10,21,0
4331,88197,Gvc7BFl5Q4FP2VRb1ZvRJI4nuqv9yacP,SpATywNh6bZuzm8s1ceuBUnMUAeoAHHw,16,19,7,13,4,0,6,0,49,7.0,2,0.0,10,7,11,4,9,0,2,6,0,32,17,0
4332,88213,6mJ65eKOiDJ0B2UMjBjMI3Dy4vxZcYQe,A3fsA9Zfv1X2fVEQhTw51lKENdNrEqT3,18,20,13,0,6,4,3,0,46,6.571428571428571,3,0.0,0,13,0,6,20,4,0,3,0,19,27,0
4333,88216,M8C9BDFICk4ida59GU0jjp556zazDEi1,RXDvfPUBYFlVdlueBFbLW0mhhAyGEqpt,18,33,21,21,11,0,6,0,92,13.142857142857142,3,0.0,8,21,21,11,25,0,0,6,0,61,31,1
4334,88254,1YjqOVdQNZSxHR5EL885UCWZImOftZfX,A3fsA9Zfv1X2fVEQhTw51lKENdNrEqT3,1,0,0,0,0,0,1,0,1,0.14285714285714285,1,0.0,0,0,0,0,0,0,0,1,0,0,1,1
4335,88378,Re4UOQXOMU2zm8GKuNadx9755IwHNGSX,7GRhBDsirIGkRZBtSMEzNTyDr2JQm4xx,2,0,0,0,0,0,4,0,4,0.5714285714285714,1,0.0,0,0,0,0,0,0,0,4,0,0,4,1
4336,88379,uXRfDeihF0hkAkJm7sgGsGBDRqSDq177,7GRhBDsirIGkRZBtSMEzNTyDr2JQm4xx,9,15,6,0,3,1,5,0,30,4.285714285714286,1,0.0,1,6,0,3,14,1,0,5,0,10,20,1
4337,88421,QOc3KAKkR4oB1aPHWnnoHskpc1gxhWoJ,7GRhBDsirIGkRZBtSMEzNTyDr2JQm4xx,5,2,1,0,0,0,6,2,11,1.5714285714285714,2,0.0,0,1,0,0,2,0,0,6,2,1,10,0
4338,88481,N2FuIOQxHi4oGMJNbbYINfgS8eLaVkEY,7GRhBDsirIGkRZBtSMEzNTyDr2JQm4xx,2,0,0,0,0,0,2,0,2,0.2857142857142857,1,0.0,0,0,0,0,0,0,0,2,0,0,2,1
4339,88527,VwAQN5jl3pwsYKyGQTMhCoHGJ3YHi87f,7GRhBDsirIGkRZBtSMEzNTyDr2JQm4xx,2,0,0,0,0,0,2,0,2,0.2857142857142857,1,0.0,0,0,0,0,0,0,0,2,0,0,2,1
4340,88536,8gfCGxZ6lFjZr89RwPF8oXZs1Qn6Pq6X,7GRhBDsirIGkRZBtSMEzNTyDr2JQm4xx,5,1,1,0,0,0,4,0,6,0.8571428571428571,1,0.0,0,1,0,0,1,0,0,4,0,1,5,1
4341,88562,LLVsvExZGFAkPOPauc0mDK88Em0n3cCC,7GRhBDsirIGkRZBtSMEzNTyDr2JQm4xx,6,8,4,0,0,0,7,0,19,2.7142857142857144,1,0.0,0,4,0,0,8,0,0,7,0,4,15,1
4342,88585,I45Q3yivyiRN2kHVhbV8bUCfrXvtpUvU,7GRhBDsirIGkRZBtSMEzNTyDr2JQm4xx,6,4,2,0,2,0,2,0,10,1.4285714285714286,1,0.0,0,2,0,2,4,0,0,2,0,4,6,1
4343,88625,tWlnNsUcyPPaUr4wTjyNOcGM9Bihy4wT,7GRhBDsirIGkRZBtSMEzNTyDr2JQm4xx,1,0,0,0,0,0,1,0,1,0.14285714285714285,1,0.0,0,0,0,0,0,0,0,1,0,0,1,1
4344,88656,dehhpoRrM4rg7t676Y7qCiumWRV2WOzS,7GRhBDsirIGkRZBtSMEzNTyDr2JQm4xx,32,42,18,79,13,12,2,0,166,23.714285714285715,1,0.0,22,18,76,13,20,12,3,2,0,129,37,1
4345,88774,bu1uIofAEXp6y759RqllOrvBV32SRihX,fbPkOYLVPtPgIt0MxizjfFJov3JbHyAi,6,7,2,0,3,0,1,0,13,1.8571428571428572,1,0.0,2,2,0,3,5,0,0,1,0,7,6,1
4346,88776,vYczGhgY6hRrqG3zxTp11QHECk2atn6B,fbPkOYLVPtPgIt0MxizjfFJov3JbHyAi,1,0,0,0,0,0,1,0,1,0.14285714285714285,1,0.0,0,0,0,0,0,0,0,1,0,0,1,1
4347,88779,iNn3GY2iMNNtDv4o6NBexjhb9hKLROis,fbPkOYLVPtPgIt0MxizjfFJov3JbHyAi,8,3,2,0,2,1,7,0,15,2.142857142857143,1,0.0,0,2,0,2,3,1,0,7,0,4,11,1
4348,88781,qWMwjLnEJjczF5VTHIYJc2IYsIWCauLR,fbPkOYLVPtPgIt0MxizjfFJov3JbHyAi,1,0,0,0,0,0,1,0,1,0.14285714285714285,1,0.0,0,0,0,0,0,0,0,1,0,0,1,1
4349,88786,vSChBkDKZDj0rGwM1GtwFmYGnjiDkIOW,fbPkOYLVPtPgIt0MxizjfFJov3JbHyAi,7,3,2,0,2,0,3,0,10,1.4285714285714286,1,0.0,0,2,0,2,3,0,0,3,0,4,6,1
4350,88792,iSqOqP6glvJYYgjvVVmRA8ZoUSLDsK6d,fbPkOYLVPtPgIt0MxizjfFJov3JbHyAi,10,17,0,0,0,4,4,0,25,3.5714285714285716,1,0.0,0,0,0,0,17,4,0,4,0,0,25,1
4351,88794,kkbu1cG9inVmqEkdKJKJuXBK4YtOWY9c,fbPkOYLVPtPgIt0MxizjfFJov3JbHyAi,12,17,11,0,7,31,18,2,86,12.285714285714286,2,0.0,0,11,0,7,17,31,0,18,2,18,68,1
4352,88795,0Ak7DRLBwBUTJguUJwEJj8xSRI6vwPPn,fbPkOYLVPtPgIt0MxizjfFJov3JbHyAi,1,0,0,0,0,0,1,0,1,0.14285714285714285,1,0.0,0,0,0,0,0,0,0,1,0,0,1,1
4353,88796,UiiOcn6NP18L6Qa9IVzPK487RvBT0lsx,fbPkOYLVPtPgIt0MxizjfFJov3JbHyAi,9,7,2,2,3,0,6,0,20,2.857142857142857,2,0.0,3,2,2,3,4,0,0,6,0,10,10,1
4354,88798,ve5RU3FKgJWxFE29I7niN6ycQVJrJFg4,fbPkOYLVPtPgIt0MxizjfFJov3JbHyAi,1,0,0,0,0,0,1,0,1,0.14285714285714285,1,0.0,0,0,0,0,0,0,0,1,0,0,1,0
4355,88801,o7nB1nybhMcFgLy31X3R6RDOK94b1Iaa,fbPkOYLVPtPgIt0MxizjfFJov3JbHyAi,1,0,0,0,0,0,1,0,1,0.14285714285714285,1,0.0,0,0,0,0,0,0,0,1,0,0,1,1
4356,88807,7NFw5LeL3eVsvkPDcb0VUxu8lVItKrJ1,fbPkOYLVPtPgIt0MxizjfFJov3JbHyAi,6,1,1,0,1,0,3,0,6,0.8571428571428571,1,0.0,0,1,0,1,1,0,0,3,0,2,4,1
4357,88812,PeUQJJiLjuIkI3TtwdkKlVprakOI9tf7,fbPkOYLVPtPgIt0MxizjfFJov3JbHyAi,11,14,9,2,5,12,5,0,47,6.714285714285714,3,0.0,1,9,2,5,13,12,0,5,0,17,30,1
4358,88816,X6obkU5FlEZFIiOk6MXrjhBqZaDGxW04,fbPkOYLVPtPgIt0MxizjfFJov3JbHyAi,5,5,2,0,0,0,4,0,11,1.5714285714285714,1,0.0,2,2,0,0,3,0,0,4,0,4,7,1
4359,88817,8fvsCrC8dcOje6DxrGntnTxmufYXJCrq,fbPkOYLVPtPgIt0MxizjfFJov3JbHyAi,5,3,2,0,2,3,0,0,10,1.4285714285714286,1,0.0,0,2,0,2,3,3,0,0,0,4,6,1
4360,88819,b0RJDCT6ztjQgqXKC4k3XnnVgTiN1Yo8,fbPkOYLVPtPgIt0MxizjfFJov3JbHyAi,7,4,2,0,2,0,3,0,11,1.5714285714285714,1,0.0,1,2,0,2,3,0,0,3,0,5,6,1
4361,88827,HRqYDSGbWA4dSXQsJ8hpWgRfS7ylZUt3,fbPkOYLVPtPgIt0MxizjfFJov3JbHyAi,1,0,0,0,0,0,1,0,1,0.14285714285714285,1,0.0,0,0,0,0,0,0,0,1,0,0,1,1
4362,88829,Wz7BSBOI9rzgAwf2xVcld90BewMcWv25,fbPkOYLVPtPgIt0MxizjfFJov3JbHyAi,2,0,0,0,0,0,3,0,3,0.42857142857142855,2,0.0,0,0,0,0,0,0,0,3,0,0,3,1
4363,88830,OH8WnAV2MBaaFDQHpnLQPXNjc3Qpxqk2,fbPkOYLVPtPgIt0MxizjfFJov3JbHyAi,5,2,1,0,1,0,2,0,6,0.8571428571428571,1,0.0,0,1,0,1,2,0,0,2,0,2,4,1
4364,88831,54BZa2PEVowNqI6EO6NzeCnkR49ry3oS,fbPkOYLVPtPgIt0MxizjfFJov3JbHyAi,15,11,7,0,6,0,3,1,28,4.0,2,0.0,0,7,0,6,11,0,0,3,1,13,15,0
4365,88836,Q5WIg2xkKAnXbT25kMzwfPcqhoeXQ6O6,fbPkOYLVPtPgIt0MxizjfFJov3JbHyAi,5,4,1,0,0,0,6,0,11,1.5714285714285714,1,0.0,0,1,0,0,4,0,0,6,0,1,10,1
4366,88842,gqL1AoJbIkLDCmEi1SGH37fAu1Zdec1f,fbPkOYLVPtPgIt0MxizjfFJov3JbHyAi,4,2,1,0,1,1,2,0,7,1.0,1,0.0,0,1,0,1,2,1,0,2,0,2,5,1
4367,88844,ZDHeqiQjfEk7rIDSgnURnMSZOtUwJ10H,fbPkOYLVPtPgIt0MxizjfFJov3JbHyAi,2,0,0,0,0,0,5,0,5,0.7142857142857143,1,0.0,0,0,0,0,0,0,0,5,0,0,5,1
4368,88845,eIlDqSEsjE2VA3vAbhP1Z42JoYB6Ak2T,fbPkOYLVPtPgIt0MxizjfFJov3JbHyAi,5,2,1,0,1,0,6,0,10,1.4285714285714286,1,0.0,0,1,0,1,2,0,0,6,0,2,8,1
4369,88848,QNLtuhI0bPryV8RMsGGTDcbcPdbX4kMs,fbPkOYLVPtPgIt0MxizjfFJov3JbHyAi,2,0,0,0,0,0,3,0,3,0.42857142857142855,1,0.0,0,0,0,0,0,0,0,3,0,0,3,1
4370,88849,LSAqQ9qRJ6IA5mDIPLRj3aw5O17rNapz,fbPkOYLVPtPgIt0MxizjfFJov3JbHyAi,9,15,8,0,3,12,6,1,45,6.428571428571429,3,0.0,0,8,0,3,15,12,0,6,1,11,34,1
4371,88854,1kjyC7ahZCsVlNSBwjZNyonjDeeXb2jh,fbPkOYLVPtPgIt0MxizjfFJov3JbHyAi,9,16,7,0,5,103,9,3,143,20.428571428571427,4,0.0,4,7,0,5,12,103,0,9,3,16,127,0
4372,88857,bw9UxZPjqLSacLegO6BK4IbuCk1Em4xv,fbPkOYLVPtPgIt0MxizjfFJov3JbHyAi,8,5,2,0,3,3,4,1,18,2.5714285714285716,1,0.0,2,2,0,3,3,3,0,4,1,7,11,1
4373,89192,qdtUflOgjNtEwAQs5kfj08fBL21x3VNU,SpATywNh6bZuzm8s1ceuBUnMUAeoAHHw,1,0,0,0,0,0,2,0,2,0.2857142857142857,1,0.0,0,0,0,0,0,0,0,2,0,0,2,1
4374,89200,KgPlJUOxzo6K50clHm6VhLAZdTWxAeXA,bWdj2GDclj5ofokWjzoa5jAwMkxCykd6,9,10,4,0,4,0,6,0,24,3.4285714285714284,1,0.0,4,4,0,4,6,0,0,6,0,12,12,1
4375,89203,Uu9HJTuPU1AJpa1Ej1uv2nh5k9DxfLwn,SpATywNh6bZuzm8s1ceuBUnMUAeoAHHw,1,0,0,0,0,0,1,0,1,0.14285714285714285,1,0.0,0,0,0,0,0,0,0,1,0,0,1,1
4376,89218,7LucM9vSYQRj5WElUEHVyxCSXUCCbwlX,SpATywNh6bZuzm8s1ceuBUnMUAeoAHHw,10,12,0,0,0,0,12,1,25,3.5714285714285716,2,0.0,0,0,0,0,12,0,0,12,1,0,25,1
4377,89223,BWy2motGgrgIUCZ4P1YohdMfi2tPp47Y,RXDvfPUBYFlVdlueBFbLW0mhhAyGEqpt,5,5,2,0,1,0,1,0,9,1.2857142857142858,1,0.0,0,2,0,1,5,0,0,1,0,3,6,1
4378,89228,1ZTeBIrbRrFVlBGh19J78zN1bkBytKqn,SpATywNh6bZuzm8s1ceuBUnMUAeoAHHw,2,0,0,0,0,0,2,0,2,0.2857142857142857,1,0.0,0,0,0,0,0,0,0,2,0,0,2,1
4379,89233,8eAdemzlZoqb3LPXg3UGAyOaCroYfZmg,RXDvfPUBYFlVdlueBFbLW0mhhAyGEqpt,20,21,12,11,8,0,4,0,56,8.0,4,0.0,1,12,10,8,20,0,1,4,0,31,25,1
4380,89236,QM2pO4xP1MmCGymVeJBe4Ub355o8EWcr,bWdj2GDclj5ofokWjzoa5jAwMkxCykd6,5,3,1,0,1,0,2,0,7,1.0,1,0.0,0,1,0,1,3,0,0,2,0,2,5,1
4381,89237,h9qmMnJv0qklBUNKS7VMrlLJy4CMBo05,SpATywNh6bZuzm8s1ceuBUnMUAeoAHHw,5,4,2,0,0,0,3,0,9,1.2857142857142858,1,0.0,0,2,0,0,4,0,0,3,0,2,7,1
4382,89239,UGMWl4hUVp9QjwcWkjjH1sbPQBgn5xrQ,SpATywNh6bZuzm8s1ceuBUnMUAeoAHHw,3,1,0,0,0,0,2,0,3,0.42857142857142855,1,0.0,0,0,0,0,1,0,0,2,0,0,3,1
4383,89241,wegnaf6UPYTo0llSdU8mAv6LbtaJoiyd,SpATywNh6bZuzm8s1ceuBUnMUAeoAHHw,2,1,0,0,0,0,2,0,3,0.42857142857142855,1,0.0,0,0,0,0,1,0,0,2,0,0,3,1
4384,89250,RKKZYIeeZxcb4bVVzfjEMLxVYtQktlhB,G8EPVSXsOYB5YQWZGiz1aVq5Pgr2GrQu,1,0,0,0,0,0,1,0,1,0.14285714285714285,1,0.0,0,0,0,0,0,0,0,1,0,0,1,1
4385,89251,gleoXCfE3tA6f5uM3pUTeqQbfFckrfVd,RXDvfPUBYFlVdlueBFbLW0mhhAyGEqpt,1,0,0,0,0,0,1,0,1,0.14285714285714285,1,0.0,0,0,0,0,0,0,0,1,0,0,1,1
4386,89256,ChYzFAABctmbTCcKox1jjUslr0LvrjbV,SpATywNh6bZuzm8s1ceuBUnMUAeoAHHw,4,1,0,0,0,1,5,0,7,1.0,1,0.0,0,0,0,0,1,1,0,5,0,0,7,1
4387,89270,gEfSYt3WBpt849T4WTB0FbXbrRt5CLQv,SpATywNh6bZuzm8s1ceuBUnMUAeoAHHw,11,21,8,0,0,15,19,3,66,9.428571428571429,1,0.0,4,8,0,0,17,15,0,19,3,12,54,1
4388,89281,yKv3mdAWukUWum1t61vTABExIrvKJ0AU,SpATywNh6bZuzm8s1ceuBUnMUAeoAHHw,7,3,1,0,1,1,8,1,15,2.142857142857143,1,0.0,0,1,0,1,3,1,0,8,1,2,13,1
4389,89299,jBvTFD7LxuGGBRz8wehp1f9k2WItIuV7,SpATywNh6bZuzm8s1ceuBUnMUAeoAHHw,8,3,1,0,1,10,6,1,22,3.142857142857143,1,0.0,0,1,0,1,3,10,0,6,1,2,20,1
4390,89306,5NHJ5bwX3OLzU7LroLiUkr7DhCqHm7Yd,G8EPVSXsOYB5YQWZGiz1aVq5Pgr2GrQu,1,0,0,0,0,0,1,0,1,0.14285714285714285,1,0.0,0,0,0,0,0,0,0,1,0,0,1,1
4391,89318,gBSqr7imZMe4VvRAJjAvzXdfEDgvP8wY,SpATywNh6bZuzm8s1ceuBUnMUAeoAHHw,5,2,1,0,1,0,2,0,6,0.8571428571428571,1,0.0,0,1,0,1,2,0,0,2,0,2,4,1
4392,89324,BOna3ORacJGhjt4FcGMkKNwkDYsEjcvt,SpATywNh6bZuzm8s1ceuBUnMUAeoAHHw,14,22,12,0,6,0,7,0,47,6.714285714285714,3,0.0,0,12,0,6,22,0,0,7,0,18,29,1
4393,89326,wNXelOaGj6HkY91hCddHRdOCiLagph7q,SpATywNh6bZuzm8s1ceuBUnMUAeoAHHw,15,10,5,18,4,0,5,0,42,6.0,2,0.0,5,5,15,4,5,0,3,5,0,29,13,0
4394,89332,orWLR4UhuJawyT3Ov1vj8DpKoW3alfLI,SpATywNh6bZuzm8s1ceuBUnMUAeoAHHw,7,5,1,0,1,1,4,0,12,1.7142857142857142,1,0.0,0,1,0,1,5,1,0,4,0,2,10,1
4395,89333,NkHKHGQ1t9WfF0WY6b3ThoMuQiXODoZm,SpATywNh6bZuzm8s1ceuBUnMUAeoAHHw,27,52,14,30,8,0,39,2,145,20.714285714285715,3,0.0,8,14,27,8,44,0,3,39,2,57,88,1
4396,89336,Pmww0SJUHaKN8gulRmzkCa5ajmPTXJLo,SpATywNh6bZuzm8s1ceuBUnMUAeoAHHw,15,14,5,10,4,1,5,0,39,5.571428571428571,1,0.0,5,5,9,4,9,1,1,5,0,23,16,1
4397,89342,HkLybTJ0rEPGE4JvzzYK050V4PCx14xg,SpATywNh6bZuzm8s1ceuBUnMUAeoAHHw,12,18,10,4,4,0,9,0,45,6.428571428571429,2,0.0,0,10,4,4,18,0,0,9,0,18,27,1
4398,89366,DswbrMY6sPJD5b1m5ODFx580irKlb07k,SpATywNh6bZuzm8s1ceuBUnMUAeoAHHw,3,2,0,0,0,0,1,0,3,0.42857142857142855,1,0.0,0,0,0,0,2,0,0,1,0,0,3,1
4399,89369,aulAQhL9pTbme70JKMz61j88uhAKeUZs,SpATywNh6bZuzm8s1ceuBUnMUAeoAHHw,1,0,0,0,0,0,1,0,1,0.14285714285714285,1,0.0,0,0,0,0,0,0,0,1,0,0,1,1
4400,89373,PqxW0fs8xtO0oqw8MXcVBsN6WdOuPEkP,SpATywNh6bZuzm8s1ceuBUnMUAeoAHHw,16,15,8,8,5,1,9,1,47,6.714285714285714,1,0.0,6,8,7,5,9,1,1,9,1,26,21,1
4401,89380,5rjYFuFo5D0yRo1dV2LjaXf9wIi8Axa0,SpATywNh6bZuzm8s1ceuBUnMUAeoAHHw,3,2,0,0,0,2,5,0,9,1.2857142857142858,1,0.0,0,0,0,0,2,2,0,5,0,0,9,1
4402,89381,Ryr7edEzpzXZS735AEqOzJJJwXWQPdd0,SpATywNh6bZuzm8s1ceuBUnMUAeoAHHw,4,2,1,0,0,0,2,0,5,0.7142857142857143,1,0.0,0,1,0,0,2,0,0,2,0,1,4,1
4403,89383,bEdF35UbCc85Bz4pUhhoEkUONzXdnpDg,SpATywNh6bZuzm8s1ceuBUnMUAeoAHHw,11,6,0,14,0,8,5,1,34,4.857142857142857,1,0.0,2,0,11,0,4,8,3,5,1,13,21,1
4404,89390,3Ks5QZGHTPRjC7k0qconLYz2L7E6QNo7,SpATywNh6bZuzm8s1ceuBUnMUAeoAHHw,7,2,1,0,1,0,9,0,13,1.8571428571428572,1,0.0,0,1,0,1,2,0,0,9,0,2,11,1
4405,89393,ishZb4e9jFXg2QviC2ko889EaUZeTZU9,SpATywNh6bZuzm8s1ceuBUnMUAeoAHHw,15,40,15,28,8,19,21,1,132,18.857142857142858,4,0.0,20,15,23,8,20,19,5,21,1,66,66,1
4406,89395,3bFfBpBuKdxav891YoVnpf8j830LveoM,SpATywNh6bZuzm8s1ceuBUnMUAeoAHHw,8,10,8,0,7,0,3,0,28,4.0,1,0.0,0,8,0,7,10,0,0,3,0,15,13,1
4407,89407,5dwj8tU2wkUoDpYyu0cC8IGAIxW1A4P6,SpATywNh6bZuzm8s1ceuBUnMUAeoAHHw,13,7,4,15,3,0,2,0,31,4.428571428571429,1,0.0,2,4,13,3,5,0,2,2,0,22,9,1
4408,89411,xSMp0r4oxogHBl1WzBSO421fVgDtvwXN,SpATywNh6bZuzm8s1ceuBUnMUAeoAHHw,16,11,6,12,3,12,9,1,54,7.714285714285714,3,0.0,2,6,9,3,9,12,3,9,1,20,34,1
4409,89415,mzOGsK1l4jUAAFEU0Ebe2O2EryG7sXnC,SpATywNh6bZuzm8s1ceuBUnMUAeoAHHw,9,5,1,0,0,4,17,1,28,4.0,3,0.0,0,1,0,0,5,4,0,17,1,1,27,1
4410,89424,QwfRZLEwZGuNcU9jWD0umpLbrwVdhurg,bWdj2GDclj5ofokWjzoa5jAwMkxCykd6,2,0,0,0,0,0,2,0,2,0.2857142857142857,1,0.0,0,0,0,0,0,0,0,2,0,0,2,1
4411,89425,pp1wOcFtHNfcc3zqTz1uxK4VRHQ4zZyX,SpATywNh6bZuzm8s1ceuBUnMUAeoAHHw,6,6,4,0,3,0,3,0,16,2.2857142857142856,1,0.0,0,4,0,3,6,0,0,3,0,7,9,1
4412,89444,KxE6jjAaHiS10lURgTs1mFbTR6SMOswm,SpATywNh6bZuzm8s1ceuBUnMUAeoAHHw,9,11,5,0,4,0,5,0,25,3.5714285714285716,1,0.0,0,5,0,4,11,0,0,5,0,9,16,1
4413,89452,uqXaJBjlB2fR1jGFPXdDLi7hSsdUaco6,bWdj2GDclj5ofokWjzoa5jAwMkxCykd6,5,2,1,0,1,0,3,0,7,1.0,2,0.0,0,1,0,1,2,0,0,3,0,2,5,1
4414,89453,13KVd5Q0kPTyZsaU7eMkcHJocQWxd1Ax,SpATywNh6bZuzm8s1ceuBUnMUAeoAHHw,6,3,1,0,1,0,2,0,7,1.0,1,0.0,0,1,0,1,3,0,0,2,0,2,5,1
4415,89458,iIWDWKAN8CRJ0yZ5zDSccFCRQRwFgxP8,SpATywNh6bZuzm8s1ceuBUnMUAeoAHHw,10,18,4,0,2,0,5,0,29,4.142857142857143,4,0.0,0,4,0,2,18,0,0,5,0,6,23,1
4416,89462,bX1EJ8H8O7LvPaK2JoRVQC0BaLpmhHE6,SpATywNh6bZuzm8s1ceuBUnMUAeoAHHw,11,18,5,0,1,14,16,2,56,8.0,5,0.0,4,5,0,1,14,14,0,16,2,10,46,0
4417,89463,lV4ifbsehEXWBwQOY9bU762jcRSMFY5M,G8EPVSXsOYB5YQWZGiz1aVq5Pgr2GrQu,4,3,1,0,1,0,1,0,6,0.8571428571428571,1,0.0,0,1,0,1,3,0,0,1,0,2,4,1
4418,89466,IQDJ7vNX3TboLO3MBJIrKiI8pMYx3UfV,SpATywNh6bZuzm8s1ceuBUnMUAeoAHHw,3,0,0,0,0,2,3,0,5,0.7142857142857143,2,0.0,0,0,0,0,0,2,0,3,0,0,5,1
4419,89468,mqlH8gZPP9MOgmB9cgrLKBfSrQuIKKN0,SpATywNh6bZuzm8s1ceuBUnMUAeoAHHw,11,9,6,0,4,1,12,2,34,4.857142857142857,1,0.0,0,6,0,4,9,1,0,12,2,10,24,1
4420,89473,1xcKG4Eeqo6PRlQtqz4lRNBDzvKhe7qL,RXDvfPUBYFlVdlueBFbLW0mhhAyGEqpt,1,0,0,0,0,0,1,0,1,0.14285714285714285,1,0.0,0,0,0,0,0,0,0,1,0,0,1,1
4421,89474,4d7nO3w6797t7DH3QeDnTWHOfNO2pqQC,bWdj2GDclj5ofokWjzoa5jAwMkxCykd6,6,3,1,0,1,3,4,0,12,1.7142857142857142,1,0.0,0,1,0,1,3,3,0,4,0,2,10,1
4422,89476,rX7gdFv8DKFX0CCz7kGKG6ViXpNH34BO,SpATywNh6bZuzm8s1ceuBUnMUAeoAHHw,3,2,0,0,0,0,1,0,3,0.42857142857142855,1,0.0,0,0,0,0,2,0,0,1,0,0,3,0
4423,89489,yxJSlYQPHVk2OJMV54ToOtJy9WMHex3A,SpATywNh6bZuzm8s1ceuBUnMUAeoAHHw,9,8,6,0,5,0,3,0,22,3.142857142857143,1,0.0,0,6,0,5,8,0,0,3,0,11,11,1
4424,89495,5pjAdY5K4FfgQPLSzQKwXaKF78ph9a0y,SpATywNh6bZuzm8s1ceuBUnMUAeoAHHw,5,12,6,0,4,0,4,0,26,3.7142857142857144,2,0.0,0,6,0,4,12,0,0,4,0,10,16,1
4425,89507,mR9Awu9GGhq6cpZDsN1vhsOMBBjHJTwu,RXDvfPUBYFlVdlueBFbLW0mhhAyGEqpt,5,2,1,0,1,0,2,0,6,0.8571428571428571,1,0.0,0,1,0,1,2,0,0,2,0,2,4,1
4426,89516,EzpgLqOBulY4ZVl8QROIPzKxMW9zpKpw,RXDvfPUBYFlVdlueBFbLW0mhhAyGEqpt,1,0,0,0,0,0,1,0,1,0.14285714285714285,1,0.0,0,0,0,0,0,0,0,1,0,0,1,1
4427,89532,8irCUZa4UAKsYYFeHrY9ttb5xgcL2ou7,SpATywNh6bZuzm8s1ceuBUnMUAeoAHHw,8,4,3,0,3,0,1,0,11,1.5714285714285714,1,0.0,0,3,0,3,4,0,0,1,0,6,5,1
4428,89534,k9cA91Q0OJFR9AY1JvRoKP3p8rLkgPCD,bWdj2GDclj5ofokWjzoa5jAwMkxCykd6,18,33,2,82,5,0,16,1,139,19.857142857142858,1,0.0,12,2,73,5,21,0,9,16,1,92,47,1
4429,89540,rHj6Vmp3P9JbmX7QWrSBu45DuiDb8koF,SpATywNh6bZuzm8s1ceuBUnMUAeoAHHw,10,17,2,0,1,1,11,0,32,4.571428571428571,3,0.0,0,2,0,1,17,1,0,11,0,3,29,1
4430,89560,fUNdgzfWSE4HzsYQQ7FDu5pyDUIMQ40m,G8EPVSXsOYB5YQWZGiz1aVq5Pgr2GrQu,38,113,46,72,25,4,6,0,266,38.0,3,0.0,32,46,53,25,81,4,19,6,0,156,110,1
4431,89561,4t1KNzzepvalCibuzOk5JUX041jKqU9v,SpATywNh6bZuzm8s1ceuBUnMUAeoAHHw,6,3,1,0,1,0,2,0,7,1.0,1,0.0,0,1,0,1,3,0,0,2,0,2,5,1
4432,89566,EDtcftLQ1x638xVsHSB1SBOPZ3SKRCar,G8EPVSXsOYB5YQWZGiz1aVq5Pgr2GrQu,18,69,0,42,8,0,4,0,123,17.571428571428573,2,0.0,33,0,30,8,36,0,12,4,0,71,52,1
4433,89571,YuqMJYvTgiTQGQOAOb2fKJpGas8AG3Wr,SpATywNh6bZuzm8s1ceuBUnMUAeoAHHw,10,11,1,0,2,0,4,0,18,2.5714285714285716,3,0.0,0,1,0,2,11,0,0,4,0,3,15,0
4434,89574,EJIkk1z1GAyTxouBU8smmsjhIBwzBhn1,G8EPVSXsOYB5YQWZGiz1aVq5Pgr2GrQu,1,0,0,0,0,0,1,0,1,0.14285714285714285,1,0.0,0,0,0,0,0,0,0,1,0,0,1,1
4435,89578,2fyY2ZIcA0PnrwGuxHsgvHzUiuyeQCT0,bWdj2GDclj5ofokWjzoa5jAwMkxCykd6,5,9,1,0,0,0,7,0,17,2.4285714285714284,2,0.0,0,1,0,0,9,0,0,7,0,1,16,1
4436,89579,Jeu98URtKOymkXqWZxWi1Dpseg2MOPzv,SpATywNh6bZuzm8s1ceuBUnMUAeoAHHw,8,3,2,0,2,1,4,0,12,1.7142857142857142,1,0.0,0,2,0,2,3,1,0,4,0,4,8,1
4437,89580,UhOcaLqs0mKdRyLwomBmAslkjoePthdJ,SpATywNh6bZuzm8s1ceuBUnMUAeoAHHw,6,0,0,0,0,1,5,1,7,1.0,1,0.0,0,0,0,0,0,1,0,5,1,0,7,1
4438,89584,oiThQK6e6zf4TZYBDNHB9rtiG2PNPeXO,SpATywNh6bZuzm8s1ceuBUnMUAeoAHHw,19,49,23,7,10,1,25,1,116,16.571428571428573,6,0.0,15,23,7,10,34,1,0,25,1,55,61,1
4439,89588,kbrfSPxlM4KkcRw6pTtSThBRf28etAVC,SpATywNh6bZuzm8s1ceuBUnMUAeoAHHw,11,7,1,0,1,2,7,1,19,2.7142857142857144,1,0.0,0,1,0,1,7,2,0,7,1,2,17,1
4440,89591,O6XTfrmBXPHHKFN07CLCPWqyMP9NsQuf,bWdj2GDclj5ofokWjzoa5jAwMkxCykd6,10,10,7,0,4,1,13,0,35,5.0,1,0.0,0,7,0,4,10,1,0,13,0,11,24,1
4441,89592,IkodCQwdqpqIcCcUv2ohgHFT9sJ1SLin,SpATywNh6bZuzm8s1ceuBUnMUAeoAHHw,5,2,1,0,1,0,2,0,6,0.8571428571428571,1,0.0,0,1,0,1,2,0,0,2,0,2,4,1
4442,89593,D8IYaZZCq2kwCopNPookpH1TvQs8o6b0,SpATywNh6bZuzm8s1ceuBUnMUAeoAHHw,11,8,3,0,2,4,8,1,26,3.7142857142857144,1,0.0,0,3,0,2,8,4,0,8,1,5,21,1
4443,89595,6OfXNoCI7Waq7DTFUWFiUcQXC3Cg0WKC,SpATywNh6bZuzm8s1ceuBUnMUAeoAHHw,12,7,4,18,3,0,1,0,33,4.714285714285714,1,0.0,2,4,15,3,5,0,3,1,0,24,9,1
4444,89598,ApFdQQBcLqTLoA4wIvtlnnwFs4FrlVS1,bWdj2GDclj5ofokWjzoa5jAwMkxCykd6,7,4,2,0,0,1,8,1,16,2.2857142857142856,3,0.0,0,2,0,0,4,1,0,8,1,2,14,1
4445,89602,a2CgRiICJuj7paJToANbolKFuh4xahGM,SpATywNh6bZuzm8s1ceuBUnMUAeoAHHw,1,0,0,0,0,0,1,0,1,0.14285714285714285,1,0.0,0,0,0,0,0,0,0,1,0,0,1,1
4446,89612,tYV9adHfuBbrO1GuvSyU9WLWt5LNmPTX,SpATywNh6bZuzm8s1ceuBUnMUAeoAHHw,11,11,4,0,2,8,7,1,33,4.714285714285714,2,0.0,1,4,0,2,10,8,0,7,1,7,26,1
4447,89618,q1qea15PiUc6DOfucwnleCxcnYIfvxHK,SpATywNh6bZuzm8s1ceuBUnMUAeoAHHw,5,6,0,0,0,0,4,1,11,1.5714285714285714,1,0.0,0,0,0,0,6,0,0,4,1,0,11,1
4448,89619,s6NTLcoRryN4aDfvO1qsCQXhze6kEfOl,G8EPVSXsOYB5YQWZGiz1aVq5Pgr2GrQu,6,0,0,0,0,0,7,1,8,1.1428571428571428,1,0.0,0,0,0,0,0,0,0,7,1,0,8,1
4449,89625,LUfJKoRDjcYKUaxb5bwr7doPqmv3K3xe,SpATywNh6bZuzm8s1ceuBUnMUAeoAHHw,31,33,18,39,9,0,9,0,108,15.428571428571429,3,0.0,11,18,33,9,22,0,6,9,0,71,37,1
4450,89628,K34V3e7xSbcwBnfPQw1X6hTJl6udnY0r,RXDvfPUBYFlVdlueBFbLW0mhhAyGEqpt,6,6,3,0,2,1,2,0,14,2.0,1,0.0,0,3,0,2,6,1,0,2,0,5,9,1
4451,89630,Z86ZMxsvWnnyZOKQGNVOWlv60hWLfFNN,G8EPVSXsOYB5YQWZGiz1aVq5Pgr2GrQu,8,10,1,0,1,1,4,0,17,2.4285714285714284,1,0.0,0,1,0,1,10,1,0,4,0,2,15,1
4452,89643,162MrslUTKGd3KlPrbeWS5Qw6KVPvj8q,SpATywNh6bZuzm8s1ceuBUnMUAeoAHHw,5,7,3,0,2,0,3,0,15,2.142857142857143,2,0.0,0,3,0,2,7,0,0,3,0,5,10,1
4453,89645,162MrslUTKGd3KlPrbeWS5Qw6KVPvj8q,bWdj2GDclj5ofokWjzoa5jAwMkxCykd6,6,7,3,0,2,1,2,0,15,2.142857142857143,1,0.0,0,3,0,2,7,1,0,2,0,5,10,1
4454,89655,Ev3g9egQXLhml9mOEMZMdMQN5Z5Fjc5k,G8EPVSXsOYB5YQWZGiz1aVq5Pgr2GrQu,6,3,2,0,2,0,2,0,9,1.2857142857142858,1,0.0,0,2,0,2,3,0,0,2,0,4,5,1
4455,89662,g8m22R7W0Wo8v9RXY0TMbj5qf5RFgvht,bWdj2GDclj5ofokWjzoa5jAwMkxCykd6,7,4,2,0,1,0,6,0,13,1.8571428571428572,2,0.0,0,2,0,1,4,0,0,6,0,3,10,1
4456,89668,EDtcftLQ1x638xVsHSB1SBOPZ3SKRCar,bWdj2GDclj5ofokWjzoa5jAwMkxCykd6,3,4,0,0,1,0,1,0,6,0.8571428571428571,1,0.0,2,0,0,1,2,0,0,1,0,3,3,1
4457,89671,wJC86gc3viBGM4vTuYg8647vhYAtlLLc,G8EPVSXsOYB5YQWZGiz1aVq5Pgr2GrQu,6,3,2,0,2,0,2,0,9,1.2857142857142858,1,0.0,0,2,0,2,3,0,0,2,0,4,5,1
4458,89673,I3y8UhgjOmrKX2NiYCp9q6amv1bHjqBJ,SpATywNh6bZuzm8s1ceuBUnMUAeoAHHw,2,0,0,0,0,0,2,0,2,0.2857142857142857,1,0.0,0,0,0,0,0,0,0,2,0,0,2,1
4459,89674,X1EwqmDy4MdORdVb79oGgVGVtNlVZgX3,SpATywNh6bZuzm8s1ceuBUnMUAeoAHHw,11,11,7,0,3,4,13,3,41,5.857142857142857,1,0.0,0,7,0,3,11,4,0,13,3,10,31,0
4460,89679,8MQx62NrM26CEa5RRkhFUh36AiGGNx6S,bWdj2GDclj5ofokWjzoa5jAwMkxCykd6,1,0,0,0,0,0,1,0,1,0.14285714285714285,1,0.0,0,0,0,0,0,0,0,1,0,0,1,1
4461,89680,xOGjXyyeq87fCMSZ9z7Yuds9sMvR7Ohh,bWdj2GDclj5ofokWjzoa5jAwMkxCykd6,7,5,1,0,2,1,4,2,15,2.142857142857143,1,0.0,3,1,0,2,2,1,0,4,2,6,9,1
4462,89683,JGkH5G6iVBgcA8nzn9agd5N20Wo6tva5,SpATywNh6bZuzm8s1ceuBUnMUAeoAHHw,7,7,4,0,2,0,4,0,17,2.4285714285714284,2,0.0,0,4,0,2,7,0,0,4,0,6,11,1
4463,89701,BawZLFtQaV6cG6ZH5ggA2jwB1HVUhop0,SpATywNh6bZuzm8s1ceuBUnMUAeoAHHw,4,3,1,0,1,0,1,0,6,0.8571428571428571,1,0.0,1,1,0,1,2,0,0,1,0,3,3,1
4464,89702,jsOwPYXTKA5LkdsyLdqfrvO6hpqy63Mk,SpATywNh6bZuzm8s1ceuBUnMUAeoAHHw,6,2,1,0,0,0,4,1,8,1.1428571428571428,1,0.0,0,1,0,0,2,0,0,4,1,1,7,1
4465,89711,Jm4nQ05ndX10jbofbWx6S0r9VXrqia6S,RXDvfPUBYFlVdlueBFbLW0mhhAyGEqpt,19,17,12,23,4,0,5,0,61,8.714285714285714,3,0.0,2,12,20,4,15,0,3,5,0,38,23,0
4466,89717,oyvbie49Qmum2sCNKvrecvOzGpEvkIP4,SpATywNh6bZuzm8s1ceuBUnMUAeoAHHw,16,52,13,16,4,6,8,1,100,14.285714285714286,2,0.0,19,13,13,4,33,6,3,8,1,49,51,1
4467,89722,TvtAHA9SMsJXnMoIbE5m05sk6M63p1ir,SpATywNh6bZuzm8s1ceuBUnMUAeoAHHw,16,14,5,22,3,44,7,1,96,13.714285714285714,1,0.0,8,5,19,3,6,44,3,7,1,35,61,1
4468,89732,pdAqVvKgeCIaihAcxhTXOYjPQxxjaa8K,RXDvfPUBYFlVdlueBFbLW0mhhAyGEqpt,16,29,15,0,8,0,4,0,56,8.0,1,0.0,0,15,0,8,29,0,0,4,0,23,33,1
4469,89751,CFwBanDE4eguHX9lcM62Yx5Bex6437kC,G8EPVSXsOYB5YQWZGiz1aVq5Pgr2GrQu,8,8,3,0,1,0,6,0,18,2.5714285714285716,2,0.0,1,3,0,1,7,0,0,6,0,5,13,0
4470,89756,5NinyROX9yWmUO2bbNeT57UVFrKKhh1e,bWdj2GDclj5ofokWjzoa5jAwMkxCykd6,8,3,2,0,2,7,7,1,22,3.142857142857143,1,0.0,0,2,0,2,3,7,0,7,1,4,18,1
4471,89761,z7RFKPeiml5DwwuxMd7W3zDeb96W3IO0,RXDvfPUBYFlVdlueBFbLW0mhhAyGEqpt,10,6,1,0,0,4,6,1,18,2.5714285714285716,1,0.0,0,1,0,0,6,4,0,6,1,1,17,1
4472,89768,F9x8grjHwXdHsc7U2XmuUJNLu8xnTwnR,bWdj2GDclj5ofokWjzoa5jAwMkxCykd6,6,2,1,0,1,0,3,0,7,1.0,2,0.0,0,1,0,1,2,0,0,3,0,2,5,1
4473,89769,CSJLoVtcCokkcrypV6hcHsBSCZUBCpjE,bWdj2GDclj5ofokWjzoa5jAwMkxCykd6,1,0,0,0,0,0,1,0,1,0.14285714285714285,1,0.0,0,0,0,0,0,0,0,1,0,0,1,1
4474,89790,TY6sQZiKCIo3eegNCTkjQ3fisPy9bRK1,SpATywNh6bZuzm8s1ceuBUnMUAeoAHHw,14,14,6,13,4,0,4,0,41,5.857142857142857,1,0.0,6,6,10,4,8,0,3,4,0,26,15,1
4475,89794,4Veu3UF7DzwSpX1OH30ULcMtQdVZ7ynq,SpATywNh6bZuzm8s1ceuBUnMUAeoAHHw,2,0,0,0,0,0,2,0,2,0.2857142857142857,1,0.0,0,0,0,0,0,0,0,2,0,0,2,1
4476,89803,md5EYhUly1ZvdBwm1DSKfst7q3ukcqZb,G8EPVSXsOYB5YQWZGiz1aVq5Pgr2GrQu,13,5,4,26,1,0,7,0,43,6.142857142857143,1,0.0,0,4,21,1,5,0,5,7,0,26,17,1
4477,89805,aLRP3ahB5SIcOn5vpM1VPEh9ib2QIioX,RXDvfPUBYFlVdlueBFbLW0mhhAyGEqpt,7,7,0,0,0,0,3,0,10,1.4285714285714286,1,0.0,0,0,0,0,7,0,0,3,0,0,10,1
4478,89815,hAvRuLAx7AEDY4wHRae0fvokMiSUSODR,SpATywNh6bZuzm8s1ceuBUnMUAeoAHHw,12,9,5,0,3,1,7,1,26,3.7142857142857144,1,0.0,0,5,0,3,9,1,0,7,1,8,18,1
4479,89820,9q1YIqGYM9tyKLlkxbnN8O6FbjsGmlHe,SpATywNh6bZuzm8s1ceuBUnMUAeoAHHw,12,10,0,6,0,0,4,2,22,3.142857142857143,1,0.0,4,0,6,0,6,0,0,4,2,10,12,1
4480,89821,hOSvBRM2cv2WmjSd4f7WDA9Dp5KsacO1,RXDvfPUBYFlVdlueBFbLW0mhhAyGEqpt,2,0,0,0,0,0,2,0,2,0.2857142857142857,1,0.0,0,0,0,0,0,0,0,2,0,0,2,1
4481,89834,lt4iWOuay8QhJ4JJzXkh1WtUiAfTTub9,G8EPVSXsOYB5YQWZGiz1aVq5Pgr2GrQu,30,42,9,10,8,2,18,2,91,13.0,3,0.0,12,9,9,8,30,2,1,18,2,38,53,0
4482,89848,aM0OXe9fMQycCDgfZRBso2FFVWDCpMzh,SpATywNh6bZuzm8s1ceuBUnMUAeoAHHw,6,3,2,0,2,0,1,0,8,1.1428571428571428,1,0.0,0,2,0,2,3,0,0,1,0,4,4,1
4483,89860,Hie5jI1V7aqUGyRciLGioIx6C3WNaVxM,SpATywNh6bZuzm8s1ceuBUnMUAeoAHHw,3,2,0,0,0,0,3,0,5,0.7142857142857143,1,0.0,0,0,0,0,2,0,0,3,0,0,5,1
4484,89862,0K4xNLo4N99mMtk7G0MOnorF2w7z0D9v,SpATywNh6bZuzm8s1ceuBUnMUAeoAHHw,7,4,0,0,0,4,4,1,13,1.8571428571428572,1,0.0,0,0,0,0,4,4,0,4,1,0,13,1
4485,89879,MfeGN5negD9kI6SBc6Puji7S43aQKdkb,SpATywNh6bZuzm8s1ceuBUnMUAeoAHHw,12,13,4,11,3,0,1,0,32,4.571428571428571,1,0.0,8,4,10,3,5,0,1,1,0,25,7,1
4486,89882,eCrgnRWcbj9qFyB1Y7Sof16QQaB01Zyn,SpATywNh6bZuzm8s1ceuBUnMUAeoAHHw,5,2,0,0,0,1,6,2,11,1.5714285714285714,1,0.0,0,0,0,0,2,1,0,6,2,0,11,1
4487,89884,V8mzud5EnZ6pyyl8PZ8V5xSQioudW4lS,SpATywNh6bZuzm8s1ceuBUnMUAeoAHHw,17,21,10,28,5,12,17,5,98,14.0,1,0.0,7,10,20,5,14,12,8,17,5,42,56,1
4488,89888,RFyhyx4ydAt8kwrNtnUfQ8908pWCv8M5,SpATywNh6bZuzm8s1ceuBUnMUAeoAHHw,5,2,1,0,1,4,2,0,10,1.4285714285714286,1,0.0,0,1,0,1,2,4,0,2,0,2,8,1
4489,89891,MrptC6k13DRD7ZeJDHvlsVV8mT19fxZF,SpATywNh6bZuzm8s1ceuBUnMUAeoAHHw,29,42,10,36,7,2,16,3,116,16.571428571428573,3,0.0,21,10,29,7,21,2,7,16,3,67,49,1
4490,89894,0aBA3ELzBRvBOUi1HyR68fXgk8gRhEIU,SpATywNh6bZuzm8s1ceuBUnMUAeoAHHw,10,7,4,0,1,1,8,5,26,3.7142857142857144,1,0.0,0,4,0,1,7,1,0,8,5,5,21,1
4491,89904,zOr0niRplBKfkwpPHNykN96u1FhzegfK,RXDvfPUBYFlVdlueBFbLW0mhhAyGEqpt,7,5,4,0,2,0,1,0,12,1.7142857142857142,1,0.0,0,4,0,2,5,0,0,1,0,6,6,1
4492,89905,5a50T7ZMXA2vPYLquN0RqbmeQaCoB8BF,SpATywNh6bZuzm8s1ceuBUnMUAeoAHHw,9,15,3,0,1,1,8,1,29,4.142857142857143,1,0.0,0,3,0,1,15,1,0,8,1,4,25,1
4493,89915,5JgomgwKuM4fVZ9Q4k6YVCtNM8AozehT,G8EPVSXsOYB5YQWZGiz1aVq5Pgr2GrQu,1,0,0,0,0,0,4,0,4,0.5714285714285714,1,0.0,0,0,0,0,0,0,0,4,0,0,4,1
4494,89924,W3ZCbN2PXgpguBAgrApub7dxzAkot7du,G8EPVSXsOYB5YQWZGiz1aVq5Pgr2GrQu,5,2,1,0,1,0,2,0,6,0.8571428571428571,1,0.0,0,1,0,1,2,0,0,2,0,2,4,1
4495,89934,SHyeADEp9dBkknD932WIgfilEMsUK5Yp,SpATywNh6bZuzm8s1ceuBUnMUAeoAHHw,12,18,1,10,0,15,22,2,68,9.714285714285714,3,0.0,0,1,7,0,18,15,3,22,2,8,60,0
4496,89936,PmZJAFj6wJkOD163WkhaJjRHdYOMjBZW,G8EPVSXsOYB5YQWZGiz1aVq5Pgr2GrQu,6,1,1,0,1,0,3,0,6,0.8571428571428571,1,0.0,0,1,0,1,1,0,0,3,0,2,4,1
4497,89949,dumOcYgAwS6Z3oz3fspRWkVIy9xvyAHF,RXDvfPUBYFlVdlueBFbLW0mhhAyGEqpt,18,21,17,0,2,2,5,4,51,7.285714285714286,1,0.0,0,17,0,2,21,2,0,5,4,19,32,0
4498,89958,3nOS3JEH08BgwunQqioyEFfja4qIND4p,RXDvfPUBYFlVdlueBFbLW0mhhAyGEqpt,13,12,10,0,4,2,1,0,29,4.142857142857143,1,0.0,0,10,0,4,12,2,0,1,0,14,15,1
4499,89974,NrKjQ2TY0jNxjlxFQqBMk613jEN7v6dJ,G8EPVSXsOYB5YQWZGiz1aVq5Pgr2GrQu,28,21,1,50,0,7,5,8,92,13.142857142857142,1,0.0,1,1,45,0,20,7,5,5,8,47,45,1
4500,89981,bjtjAbfCAjoDC0dQv8FIuhfAxmQlWFXq,SpATywNh6bZuzm8s1ceuBUnMUAeoAHHw,1,0,0,0,0,0,1,0,1,0.14285714285714285,1,0.0,0,0,0,0,0,0,0,1,0,0,1,1
4501,89989,SkGcRN6XF7Ju1v3VtnK0PLpmtvUvO3VU,SpATywNh6bZuzm8s1ceuBUnMUAeoAHHw,12,10,5,0,4,0,6,1,26,3.7142857142857144,1,0.0,0,5,0,4,10,0,0,6,1,9,17,1
4502,90001,7slcWSRDm7z3xCcURvkPzfUA6HpEf1rv,SpATywNh6bZuzm8s1ceuBUnMUAeoAHHw,13,8,6,0,4,1,11,3,33,4.714285714285714,1,0.0,0,6,0,4,8,1,0,11,3,10,23,1
4503,90007,LSvU72CFq1TrHd9SCZOiKQ0qcV2oa2Ok,bWdj2GDclj5ofokWjzoa5jAwMkxCykd6,8,10,1,0,1,0,5,0,17,2.4285714285714284,3,0.0,0,1,0,1,10,0,0,5,0,2,15,1
4504,90018,bjoQsxzy5xWbIlWJOK88FLxI1KzCehRN,bWdj2GDclj5ofokWjzoa5jAwMkxCykd6,1,0,0,0,0,0,1,0,1,0.14285714285714285,1,0.0,0,0,0,0,0,0,0,1,0,0,1,1
4505,90026,RyilkQdPLBJZ4lFr5oZI0Ei4sfkfiESh,SpATywNh6bZuzm8s1ceuBUnMUAeoAHHw,16,34,23,20,18,0,3,0,98,14.0,2,0.0,8,23,17,18,26,0,3,3,0,66,32,0
4506,90031,4dfnEKxHCmGabkBCiKHt5nKr3H7Bwo1x,SpATywNh6bZuzm8s1ceuBUnMUAeoAHHw,7,18,8,0,0,0,5,0,31,4.428571428571429,4,0.0,3,8,0,0,15,0,0,5,0,11,20,0
4507,90036,FSLbHGHYGlPWdXBDC9WjMUDDSGRCqhaq,SpATywNh6bZuzm8s1ceuBUnMUAeoAHHw,5,6,1,0,0,0,1,0,8,1.1428571428571428,1,0.0,0,1,0,0,6,0,0,1,0,1,7,0
4508,90037,vXbuazCIyAq6baj5We5wdO94RIfbomSS,SpATywNh6bZuzm8s1ceuBUnMUAeoAHHw,11,11,7,0,4,0,5,1,28,4.0,1,0.0,0,7,0,4,11,0,0,5,1,11,17,1
4509,90038,fxZYes73ffCsV30TZKy38cwDGRpz9rUn,RXDvfPUBYFlVdlueBFbLW0mhhAyGEqpt,9,9,5,0,0,0,8,1,23,3.2857142857142856,1,0.0,2,5,0,0,7,0,0,8,1,7,16,0
4510,90043,lm5ZaZLPfaDrtGky2mMb4F6wcz9jTJq6,SpATywNh6bZuzm8s1ceuBUnMUAeoAHHw,5,3,1,0,1,0,1,0,6,0.8571428571428571,1,0.0,0,1,0,1,3,0,0,1,0,2,4,1
4511,90046,xAsW6FY0K65CydYHAmfVcUYiwrdudkde,RXDvfPUBYFlVdlueBFbLW0mhhAyGEqpt,12,11,9,0,7,0,1,0,28,4.0,1,0.0,1,9,0,7,10,0,0,1,0,17,11,1
4512,90048,Vn131dD12fh0kapodbBhio0q4dV4IYmG,G8EPVSXsOYB5YQWZGiz1aVq5Pgr2GrQu,4,2,1,0,1,0,1,0,5,0.7142857142857143,1,0.0,0,1,0,1,2,0,0,1,0,2,3,1
4513,90050,zKJi4lYCojHniGlUzfyvIjevdGsHA6Tj,RXDvfPUBYFlVdlueBFbLW0mhhAyGEqpt,1,0,0,0,0,0,1,0,1,0.14285714285714285,1,0.0,0,0,0,0,0,0,0,1,0,0,1,1
4514,90053,Fz2fUb8uF4DthRTOepts8mTN1u7KYtSZ,SpATywNh6bZuzm8s1ceuBUnMUAeoAHHw,10,7,3,0,3,0,5,0,18,2.5714285714285716,1,0.0,0,3,0,3,7,0,0,5,0,6,12,1
4515,90056,JaIi02fnjAZfoUxjYtpyJ7uZYWKdC5yF,bWdj2GDclj5ofokWjzoa5jAwMkxCykd6,10,32,1,52,4,1,6,1,97,13.857142857142858,1,0.0,10,1,50,4,22,1,2,6,1,65,32,1
4516,90058,OFJM9gLiEJFta7GOEBOgZlB17rEajfDQ,G8EPVSXsOYB5YQWZGiz1aVq5Pgr2GrQu,11,4,1,26,1,0,5,0,37,5.285714285714286,1,0.0,1,1,23,1,3,0,3,5,0,26,11,0
4517,90075,K9KQOSU4fRa8yZTo6p3wgevh5IisB83T,RXDvfPUBYFlVdlueBFbLW0mhhAyGEqpt,2,0,0,0,0,0,2,0,2,0.2857142857142857,1,0.0,0,0,0,0,0,0,0,2,0,0,2,1
4518,90095,pplAmbuLk2c8g7K4eYBlhKFfYSpZgbNo,G8EPVSXsOYB5YQWZGiz1aVq5Pgr2GrQu,1,0,0,0,0,0,1,0,1,0.14285714285714285,1,0.0,0,0,0,0,0,0,0,1,0,0,1,1
4519,90102,GN70rVGXob8SU4MUwDOnczNAPbVNEJYJ,SpATywNh6bZuzm8s1ceuBUnMUAeoAHHw,14,17,2,9,1,1,11,2,43,6.142857142857143,2,0.0,0,2,7,1,17,1,2,11,2,10,33,1
4520,90116,T7izEMyckZ14Dpb0HXCCbCEgRCtemG2v,RXDvfPUBYFlVdlueBFbLW0mhhAyGEqpt,26,43,2,0,1,24,12,14,96,13.714285714285714,6,0.0,2,2,0,1,41,24,0,12,14,5,91,1
4521,90121,PD0QXI0Ip2PVwJ6kJaKkkINkj7BvGZMC,bWdj2GDclj5ofokWjzoa5jAwMkxCykd6,43,33,2,302,3,6,20,1,367,52.42857142857143,2,0.0,15,2,274,3,18,6,28,20,1,294,73,1
4522,90124,NlgFEWO87VQbCzq3S6FQjH7bzvdUhuql,bWdj2GDclj5ofokWjzoa5jAwMkxCykd6,10,12,5,44,3,0,6,0,70,10.0,1,0.0,4,5,43,3,8,0,1,6,0,55,15,1
4523,90126,Q1m0mfQJyZWS3bGl8oxr6Sp3MEPl2r6y,RXDvfPUBYFlVdlueBFbLW0mhhAyGEqpt,10,7,5,0,2,2,9,2,27,3.857142857142857,2,0.0,0,5,0,2,7,2,0,9,2,7,20,1
4524,90127,8inbpMs7MgzODmQl3BpmuUuKMVmeoVgB,RXDvfPUBYFlVdlueBFbLW0mhhAyGEqpt,4,0,0,0,0,0,9,0,9,1.2857142857142858,1,0.0,0,0,0,0,0,0,0,9,0,0,9,1
4525,90129,ErRtUnOkAfZfIgzAYrZFJqhMiEZstwA2,G8EPVSXsOYB5YQWZGiz1aVq5Pgr2GrQu,1,0,0,0,0,0,1,0,1,0.14285714285714285,1,0.0,0,0,0,0,0,0,0,1,0,0,1,1
4526,90133,s1Khmx0UXmesPVY2G1JDbBc7N2AstlLy,bWdj2GDclj5ofokWjzoa5jAwMkxCykd6,1,0,0,0,0,0,1,0,1,0.14285714285714285,1,0.0,0,0,0,0,0,0,0,1,0,0,1,1
4527,90140,jNfz1HF8kGQzQgXHBSG4Wy17SyrpVswM,RXDvfPUBYFlVdlueBFbLW0mhhAyGEqpt,19,30,18,0,12,1,11,1,73,10.428571428571429,1,0.0,0,18,0,12,30,1,0,11,1,30,43,1
4528,90144,clUDzV1xLWOCz6yJz1NXsCWqgZVFuU6d,SpATywNh6bZuzm8s1ceuBUnMUAeoAHHw,16,26,9,0,6,0,6,0,47,6.714285714285714,3,0.0,0,9,0,6,26,0,0,6,0,15,32,0
4529,90145,vFTyJ5TiVtOMNTDle7WFtHDAgvur1Shs,RXDvfPUBYFlVdlueBFbLW0mhhAyGEqpt,70,89,60,105,34,10,11,0,309,44.142857142857146,5,0.0,17,60,95,34,72,10,10,11,0,206,103,1
4530,90154,pBNN08SB8Xk0wCmBzmhWqayfqNGQdsD0,G8EPVSXsOYB5YQWZGiz1aVq5Pgr2GrQu,5,2,1,0,1,0,3,0,7,1.0,1,0.0,0,1,0,1,2,0,0,3,0,2,5,1
4531,90159,uhbUne0Zqx7l0LKNWrxxR44WistJmxKI,G8EPVSXsOYB5YQWZGiz1aVq5Pgr2GrQu,6,9,1,0,0,0,7,0,17,2.4285714285714284,3,0.0,0,1,0,0,9,0,0,7,0,1,16,1
4532,90163,oSabIe7L5topw6hwV4H4ZV0Ug7ZVNxfV,SpATywNh6bZuzm8s1ceuBUnMUAeoAHHw,7,16,1,0,1,0,6,0,24,3.4285714285714284,3,0.0,2,1,0,1,14,0,0,6,0,4,20,0
4533,90164,EJkZzukbCIAgIlh7QDQUWfa1bYDEcyN6,SpATywNh6bZuzm8s1ceuBUnMUAeoAHHw,9,5,3,0,2,0,6,0,16,2.2857142857142856,2,0.0,0,3,0,2,5,0,0,6,0,5,11,1
4534,90171,5rZEwm9dIq2r0OGFOO4xuxIdyDM4ihsM,G8EPVSXsOYB5YQWZGiz1aVq5Pgr2GrQu,4,3,0,0,0,0,4,0,7,1.0,1,0.0,0,0,0,0,3,0,0,4,0,0,7,1
4535,90181,dtnFILXxHCPYki6VgARxaWrGiWunvtDQ,bWdj2GDclj5ofokWjzoa5jAwMkxCykd6,3,3,0,0,0,0,1,0,4,0.5714285714285714,1,0.0,0,0,0,0,3,0,0,1,0,0,4,1
4536,90186,BizISzUat4hEvOv57S0DwyJf8vib0NUf,G8EPVSXsOYB5YQWZGiz1aVq5Pgr2GrQu,17,25,13,22,9,0,6,0,75,10.714285714285714,2,0.0,10,13,15,9,15,0,7,6,0,47,28,1
4537,90191,rb0bCeAP0PjUKM6QZmb5eDbdcmhSPRHl,bWdj2GDclj5ofokWjzoa5jAwMkxCykd6,1,0,0,0,0,0,1,0,1,0.14285714285714285,1,0.0,0,0,0,0,0,0,0,1,0,0,1,1
4538,90193,8DMqMykxY7va5LQM1D9Brc3KIasQ5uaX,SpATywNh6bZuzm8s1ceuBUnMUAeoAHHw,9,5,2,0,1,1,5,1,15,2.142857142857143,1,0.0,2,2,0,1,3,1,0,5,1,5,10,1
4539,90195,kS1KejA8lXABafXOlB6Mjw2acU9s1o0J,G8EPVSXsOYB5YQWZGiz1aVq5Pgr2GrQu,9,5,4,0,3,0,1,0,13,1.8571428571428572,2,0.0,0,4,0,3,5,0,0,1,0,7,6,1
4540,90197,W0qiE6YA9tIRl3nKsDWz4QDyI0fyNkAl,G8EPVSXsOYB5YQWZGiz1aVq5Pgr2GrQu,5,7,1,2,2,0,1,0,13,1.8571428571428572,1,0.0,5,1,1,2,2,0,1,1,0,9,4,1
4541,90198,EfKEF8uyLDaJrFfOiyHDnHogAmFLFMEz,SpATywNh6bZuzm8s1ceuBUnMUAeoAHHw,16,18,8,21,5,4,6,0,62,8.857142857142858,1,0.0,8,8,17,5,10,4,4,6,0,38,24,1
4542,90202,mb1hbQ7DEVC7kPqNe1ZOaERjsdGO9KG6,SpATywNh6bZuzm8s1ceuBUnMUAeoAHHw,6,1,1,0,1,0,3,0,6,0.8571428571428571,1,0.0,0,1,0,1,1,0,0,3,0,2,4,1
4543,90204,iwXjEgqbyIO3u8ruP2aohYqr4OGu36oj,bWdj2GDclj5ofokWjzoa5jAwMkxCykd6,1,0,0,0,0,0,1,0,1,0.14285714285714285,1,0.0,0,0,0,0,0,0,0,1,0,0,1,1
4544,90205,CDMI3gQZrAOAZ9Cf4jB5NzA4daPYwjjn,RXDvfPUBYFlVdlueBFbLW0mhhAyGEqpt,45,20,12,77,8,2,6,12,137,19.571428571428573,1,0.0,7,12,70,8,13,2,7,6,12,97,40,1
4545,90208,1oBn81XXDSWJtnCZIRPmhZcBWe7qP0iB,bWdj2GDclj5ofokWjzoa5jAwMkxCykd6,15,19,9,30,4,0,5,0,67,9.571428571428571,1,0.0,5,9,28,4,14,0,2,5,0,46,21,1
4546,90210,J3voZmUSvdysAYoBmB8pkqxDgJNK9RLm,SpATywNh6bZuzm8s1ceuBUnMUAeoAHHw,10,8,4,0,3,0,5,0,20,2.857142857142857,1,0.0,1,4,0,3,7,0,0,5,0,8,12,1
4547,90212,Kc2ZLOGfjK9xNvMUO1HfN3eAcuOUNA78,bWdj2GDclj5ofokWjzoa5jAwMkxCykd6,4,2,1,0,1,0,1,0,5,0.7142857142857143,1,0.0,0,1,0,1,2,0,0,1,0,2,3,0
4548,90213,flscvDNEOPPNPzScLBbNDP0ZzEaAlrV7,SpATywNh6bZuzm8s1ceuBUnMUAeoAHHw,3,2,1,0,0,0,1,0,4,0.5714285714285714,1,0.0,0,1,0,0,2,0,0,1,0,1,3,1
4549,90216,2YneJEOhCqieo20wPFwWEVhM7PP0cUkK,SpATywNh6bZuzm8s1ceuBUnMUAeoAHHw,6,5,2,0,1,0,3,0,11,1.5714285714285714,1,0.0,0,2,0,1,5,0,0,3,0,3,8,1
4550,90231,5rZEwm9dIq2r0OGFOO4xuxIdyDM4ihsM,SpATywNh6bZuzm8s1ceuBUnMUAeoAHHw,6,3,1,0,1,0,4,0,9,1.2857142857142858,1,0.0,0,1,0,1,3,0,0,4,0,2,7,1
4551,90234,TWBh4mQwoOKN7YTAA8WBkn32Y1dNu7yV,SpATywNh6bZuzm8s1ceuBUnMUAeoAHHw,3,3,1,0,0,0,1,0,5,0.7142857142857143,1,0.0,0,1,0,0,3,0,0,1,0,1,4,1
4552,90236,MqKzIfAUNs7agMDut61Vb2gr4UeXiv4L,SpATywNh6bZuzm8s1ceuBUnMUAeoAHHw,14,13,4,18,3,4,4,0,46,6.571428571428571,1,0.0,8,4,16,3,5,4,2,4,0,31,15,1
4553,90237,RkMMgfrDoCy0k6xciXBqfQqum2o9XEow,bWdj2GDclj5ofokWjzoa5jAwMkxCykd6,8,9,5,0,1,2,10,0,27,3.857142857142857,2,0.0,0,5,0,1,9,2,0,10,0,6,21,0
4554,90243,ufAesqkQpYzEnUzTTmFCVE5lhPwgEzNz,bWdj2GDclj5ofokWjzoa5jAwMkxCykd6,7,4,1,0,1,2,4,1,13,1.8571428571428572,1,0.0,1,1,0,1,3,2,0,4,1,3,10,1
4555,90257,ZPbUovw1YoDeaWUVrbGEj5A5WdIXTYjf,bWdj2GDclj5ofokWjzoa5jAwMkxCykd6,5,2,1,0,1,0,2,0,6,0.8571428571428571,1,0.0,0,1,0,1,2,0,0,2,0,2,4,1
4556,90264,SFTx34tVIUz5DNNfU98ofZLPwnaVsmDt,bWdj2GDclj5ofokWjzoa5jAwMkxCykd6,2,0,0,0,0,0,4,0,4,0.5714285714285714,1,0.0,0,0,0,0,0,0,0,4,0,0,4,1
4557,90265,BjHFvQWQadfUNfwyKUemgxPvpTYl6Oeu,SpATywNh6bZuzm8s1ceuBUnMUAeoAHHw,16,25,9,16,4,0,11,0,65,9.285714285714286,2,0.0,7,9,15,4,18,0,1,11,0,35,30,1
4558,90273,1A7feF5h8rReJF4PIjze7GoTvueVZhno,bWdj2GDclj5ofokWjzoa5jAwMkxCykd6,2,0,0,0,0,0,3,0,3,0.42857142857142855,1,0.0,0,0,0,0,0,0,0,3,0,0,3,1
4559,90281,0nJUVE3hT3v1fqbd9NpHDszm9KS6NNTn,SpATywNh6bZuzm8s1ceuBUnMUAeoAHHw,13,21,14,0,4,2,11,0,52,7.428571428571429,4,0.0,2,14,0,4,19,2,0,11,0,20,32,1
4560,90284,fhq6eq9rBvb40aWEwDCQV6m3MUswh0wF,SpATywNh6bZuzm8s1ceuBUnMUAeoAHHw,6,4,2,1,1,0,2,0,10,1.4285714285714286,1,0.0,1,2,1,1,3,0,0,2,0,5,5,1
4561,90299,iysEaAaeQU9ULnAIVWQxyonskhHfsgrB,bWdj2GDclj5ofokWjzoa5jAwMkxCykd6,1,0,0,0,0,0,1,0,1,0.14285714285714285,1,0.0,0,0,0,0,0,0,0,1,0,0,1,1
4562,90300,5w7iVX59M3R4nFK1Ak0et8WYZIQEnE4r,SpATywNh6bZuzm8s1ceuBUnMUAeoAHHw,5,4,1,0,1,1,8,0,15,2.142857142857143,3,0.0,2,1,0,1,2,1,0,8,0,4,11,1
4563,90301,nNRUhTxrQUyQlj0B4LUbcGCoMBsVhXak,SpATywNh6bZuzm8s1ceuBUnMUAeoAHHw,19,55,19,21,5,2,12,3,117,16.714285714285715,3,0.0,21,19,18,5,34,2,3,12,3,63,54,1
4564,90307,YSoWzxWxgklu4RCnOacbfcJC3S3J8kdF,bWdj2GDclj5ofokWjzoa5jAwMkxCykd6,4,2,1,0,0,0,2,0,5,0.7142857142857143,1,0.0,0,1,0,0,2,0,0,2,0,1,4,1
4565,90308,mf7XL5Qu5rUTCHBZ2HgPEiHdci32GQxj,SpATywNh6bZuzm8s1ceuBUnMUAeoAHHw,5,2,1,0,1,0,2,0,6,0.8571428571428571,1,0.0,0,1,0,1,2,0,0,2,0,2,4,1
4566,90319,BnT6Uo8UffnhlvQEwsGCaHRftIbYh6of,SpATywNh6bZuzm8s1ceuBUnMUAeoAHHw,9,13,5,0,3,0,2,0,23,3.2857142857142856,1,0.0,2,5,0,3,11,0,0,2,0,10,13,1
4567,90322,xnhot3CAENInz6vjTxOmSNIIldllQEtz,bWdj2GDclj5ofokWjzoa5jAwMkxCykd6,4,2,1,0,1,0,1,0,5,0.7142857142857143,1,0.0,0,1,0,1,2,0,0,1,0,2,3,1
4568,90328,ytG2DdLhfkfx34dUnTrzjRTBamVwR6Tt,G8EPVSXsOYB5YQWZGiz1aVq5Pgr2GrQu,4,2,0,0,0,0,2,0,4,0.5714285714285714,1,0.0,0,0,0,0,2,0,0,2,0,0,4,1
4569,90331,gSg4PIaWl0hBhOgVlpN9o8YrQn4pTOeq,RXDvfPUBYFlVdlueBFbLW0mhhAyGEqpt,3,0,0,0,0,9,2,0,11,1.5714285714285714,2,0.0,0,0,0,0,0,9,0,2,0,0,11,0
4570,90334,gSg4PIaWl0hBhOgVlpN9o8YrQn4pTOeq,bWdj2GDclj5ofokWjzoa5jAwMkxCykd6,5,2,1,0,1,0,2,0,6,0.8571428571428571,2,0.0,0,1,0,1,2,0,0,2,0,2,4,0
4571,90338,FniFp3wFmWOPWRnBcExVHfzUs5yEbBTd,G8EPVSXsOYB5YQWZGiz1aVq5Pgr2GrQu,1,0,0,0,0,0,1,0,1,0.14285714285714285,1,0.0,0,0,0,0,0,0,0,1,0,0,1,1
4572,90341,MSmZzIC0hTqFynGLQ4hbcd9aVVVROmvE,RXDvfPUBYFlVdlueBFbLW0mhhAyGEqpt,43,22,14,95,7,22,3,4,167,23.857142857142858,1,0.0,7,14,88,7,15,22,7,3,4,116,51,1
4573,90363,4GMbKnTV7f2uA3paM09GNAdyVnypDTbs,bWdj2GDclj5ofokWjzoa5jAwMkxCykd6,7,1,1,0,1,0,10,0,13,1.8571428571428572,1,0.0,0,1,0,1,1,0,0,10,0,2,11,1
4574,90365,XnbCTPxDHPmE6f3SM7gG3S4zRIik2pF4,SpATywNh6bZuzm8s1ceuBUnMUAeoAHHw,1,0,0,0,0,0,1,0,1,0.14285714285714285,1,0.0,0,0,0,0,0,0,0,1,0,0,1,1
4575,90368,aVj2n54Hek70fJUdNTLLf71YkfuWdwdm,bWdj2GDclj5ofokWjzoa5jAwMkxCykd6,10,18,8,0,6,0,6,0,38,5.428571428571429,3,0.0,2,8,0,6,16,0,0,6,0,16,22,1
4576,90370,1cbn6mbdbvkgaRHmtNkyztYkaJcKUMeq,bWdj2GDclj5ofokWjzoa5jAwMkxCykd6,15,20,8,50,6,0,11,0,95,13.571428571428571,3,0.0,7,8,44,6,13,0,6,11,0,65,30,0
4577,90384,HOZheAyAGMSpb5Rm4jAeFCDd0CkpsnTU,SpATywNh6bZuzm8s1ceuBUnMUAeoAHHw,24,58,0,43,0,141,25,1,268,38.285714285714285,6,0.0,24,0,39,0,34,141,4,25,1,63,205,1
4578,90388,af1GfUKSTAzLFQRgO3DNnNJQEXmJbieP,SpATywNh6bZuzm8s1ceuBUnMUAeoAHHw,15,16,4,13,3,0,6,0,42,6.0,1,0.0,10,4,12,3,6,0,1,6,0,29,13,0
4579,90390,gZ5Dz1At6qO7ZUvRyINA6LQ2UEYea4Ji,SpATywNh6bZuzm8s1ceuBUnMUAeoAHHw,4,2,1,0,0,0,2,0,5,0.7142857142857143,1,0.0,0,1,0,0,2,0,0,2,0,1,4,0
4580,90398,U4FGCuNkJ0sAAh4fnj0EDvRbz5l6NaeB,RXDvfPUBYFlVdlueBFbLW0mhhAyGEqpt,5,4,1,0,1,0,1,0,7,1.0,1,0.0,0,1,0,1,4,0,0,1,0,2,5,1
4581,90401,U8woUOpngQnqlgGzBG9Q1wRVWIkAfJH5,bWdj2GDclj5ofokWjzoa5jAwMkxCykd6,7,15,0,0,0,0,7,0,22,3.142857142857143,3,0.0,0,0,0,0,15,0,0,7,0,0,22,0
4582,90406,eAZCjo0LfDvIGTflBEZPo5MmANUFycim,G8EPVSXsOYB5YQWZGiz1aVq5Pgr2GrQu,1,0,0,0,0,0,1,0,1,0.14285714285714285,1,0.0,0,0,0,0,0,0,0,1,0,0,1,1
4583,90415,ZYv52Mbq7iLq8T3oy7c5ln6ts5h7dtMY,bWdj2GDclj5ofokWjzoa5jAwMkxCykd6,2,0,0,0,0,0,2,0,2,0.2857142857142857,1,0.0,0,0,0,0,0,0,0,2,0,0,2,1
4584,90424,DtwqebReG8Q4J8W1z8GMg58bM2jjZyjN,SpATywNh6bZuzm8s1ceuBUnMUAeoAHHw,5,2,0,0,0,0,3,0,5,0.7142857142857143,1,0.0,0,0,0,0,2,0,0,3,0,0,5,1
4585,90427,MffUlJKjo94UllFioq799jfMhgBUKfBS,RXDvfPUBYFlVdlueBFbLW0mhhAyGEqpt,22,18,11,29,8,0,2,0,68,9.714285714285714,1,0.0,5,11,27,8,13,0,2,2,0,51,17,1
4586,90434,ajSnZNRHXRc8Lp3Apzl9jhBHJ93vaNPi,SpATywNh6bZuzm8s1ceuBUnMUAeoAHHw,8,6,1,0,1,14,5,0,27,3.857142857142857,1,0.0,0,1,0,1,6,14,0,5,0,2,25,1
4587,90438,h70SV9keTNnvlQQ1p9K83AbbtQXt9ALt,SpATywNh6bZuzm8s1ceuBUnMUAeoAHHw,11,18,12,0,9,0,7,0,46,6.571428571428571,1,0.0,4,12,0,9,14,0,0,7,0,25,21,1
4588,90441,QJPLyO9GsNSTHpL4UletoFcKnrwBbT1T,SpATywNh6bZuzm8s1ceuBUnMUAeoAHHw,15,27,13,23,6,0,3,0,72,10.285714285714286,2,0.0,10,13,18,6,17,0,5,3,0,47,25,1
4589,90447,SF4fH5sh7kP5eYY1hHp8Un6FMFdPAYUn,RXDvfPUBYFlVdlueBFbLW0mhhAyGEqpt,15,14,11,0,3,4,6,2,40,5.714285714285714,1,0.0,0,11,0,3,14,4,0,6,2,14,26,1
4590,90465,ZJZvmc4yPSLW7LhJST5KGAXq34PSa4bN,SpATywNh6bZuzm8s1ceuBUnMUAeoAHHw,9,6,4,0,2,1,5,1,19,2.7142857142857144,1,0.0,1,4,0,2,5,1,0,5,1,7,12,1
4591,90475,nA22SpKv9tvgwIZ0mm2k7ziqx1NGMQHb,SpATywNh6bZuzm8s1ceuBUnMUAeoAHHw,4,1,0,0,0,0,5,0,6,0.8571428571428571,1,0.0,0,0,0,0,1,0,0,5,0,0,6,1
4592,90476,Pr9ourxtng5DzY47on8h7xABMdbE3A0L,SpATywNh6bZuzm8s1ceuBUnMUAeoAHHw,2,0,0,0,0,0,2,0,2,0.2857142857142857,1,0.0,0,0,0,0,0,0,0,2,0,0,2,1
4593,90481,8cTpnP5XMC7urAa32DMaQfZt2CABz0xm,SpATywNh6bZuzm8s1ceuBUnMUAeoAHHw,2,0,0,0,0,0,2,0,2,0.2857142857142857,1,0.0,0,0,0,0,0,0,0,2,0,0,2,1
4594,90496,Xs5JYGOD3p8qnunCvDbRtmUT4YrLSZAt,G8EPVSXsOYB5YQWZGiz1aVq5Pgr2GrQu,2,0,0,0,0,0,2,0,2,0.2857142857142857,1,0.0,0,0,0,0,0,0,0,2,0,0,2,1
4595,90505,GQ6O8zYgypKOWgEHgpHaUgffzhyPlA4a,SpATywNh6bZuzm8s1ceuBUnMUAeoAHHw,11,23,9,0,5,0,10,0,47,6.714285714285714,2,0.0,0,9,0,5,23,0,0,10,0,14,33,1
4596,90509,6DhqODqzoN3QpHDTGOfm1J0Z2tXsvw8Q,RXDvfPUBYFlVdlueBFbLW0mhhAyGEqpt,11,9,5,0,1,1,6,1,23,3.2857142857142856,1,0.0,2,5,0,1,7,1,0,6,1,8,15,1
4597,90510,RI0pRWsSeNWCFuNbvYcUkrnZSxgLkzXM,G8EPVSXsOYB5YQWZGiz1aVq5Pgr2GrQu,4,2,1,0,1,0,1,0,5,0.7142857142857143,1,0.0,0,1,0,1,2,0,0,1,0,2,3,1
4598,90512,v5nYdsvl6GCjyW7kGrOo9PXd3XM536ac,bWdj2GDclj5ofokWjzoa5jAwMkxCykd6,8,7,3,36,3,0,1,0,50,7.142857142857143,1,0.0,3,3,36,3,4,0,0,1,0,45,5,1
4599,90522,SrT5cEoKhuuDcaYDitYZtr8rudf3aNHn,RXDvfPUBYFlVdlueBFbLW0mhhAyGEqpt,5,3,0,0,0,1,2,0,6,0.8571428571428571,1,0.0,0,0,0,0,3,1,0,2,0,0,6,1
4600,90533,979T9akr0rVByN7anKgrxGgT1cwuQ4G0,bWdj2GDclj5ofokWjzoa5jAwMkxCykd6,1,0,0,0,0,0,2,0,2,0.2857142857142857,1,0.0,0,0,0,0,0,0,0,2,0,0,2,1
4601,90536,87BoPwsFRJc93Ed9Le7qjm6Wu8pcwGb4,SpATywNh6bZuzm8s1ceuBUnMUAeoAHHw,14,13,8,15,5,0,7,0,48,6.857142857142857,1,0.0,4,8,12,5,9,0,3,7,0,29,19,1
4602,90541,f3Or6Lei7Xsh5kVuWwAXKtVQvHetVASw,SpATywNh6bZuzm8s1ceuBUnMUAeoAHHw,7,2,1,0,1,0,7,1,12,1.7142857142857142,1,0.0,0,1,0,1,2,0,0,7,1,2,10,1
4603,90542,oBmksukoqTKiKpWhco7hv7dHpVNhiTm0,RXDvfPUBYFlVdlueBFbLW0mhhAyGEqpt,2,0,0,0,0,0,2,0,2,0.2857142857142857,1,0.0,0,0,0,0,0,0,0,2,0,0,2,1
4604,90544,Wn0YHSgI2frE5VS0ME4PMnw7OIRxxODE,bWdj2GDclj5ofokWjzoa5jAwMkxCykd6,14,12,6,32,5,0,4,0,59,8.428571428571429,1,0.0,4,6,32,5,8,0,0,4,0,47,12,1
4605,90552,isJvm2sBgrZmIVBqIVzAr4eLhAZMDuWI,SpATywNh6bZuzm8s1ceuBUnMUAeoAHHw,2,0,0,0,0,4,1,0,5,0.7142857142857143,1,0.0,0,0,0,0,0,4,0,1,0,0,5,1
4606,90555,tn5nSlJLNdxx4Uni5Dn3S8nwDR8GJibq,bWdj2GDclj5ofokWjzoa5jAwMkxCykd6,20,41,21,114,10,16,15,2,219,31.285714285714285,3,0.0,7,21,109,10,34,16,5,15,2,147,72,1
4607,90557,86vaLs6Psnmr3RZvUAsRR8mS9F0SSYDy,RXDvfPUBYFlVdlueBFbLW0mhhAyGEqpt,1,0,0,0,0,0,1,0,1,0.14285714285714285,1,0.0,0,0,0,0,0,0,0,1,0,0,1,1
4608,90561,zoNJrqU9R3rbwqXOfdPMHYJWQ1mfYn8B,SpATywNh6bZuzm8s1ceuBUnMUAeoAHHw,9,6,3,0,3,0,4,0,16,2.2857142857142856,1,0.0,0,3,0,3,6,0,0,4,0,6,10,1
4609,90573,mnrOB2joseu3XXqZgB40ASUizDwax7xs,SpATywNh6bZuzm8s1ceuBUnMUAeoAHHw,16,23,7,22,4,1,9,0,66,9.428571428571429,1,0.0,12,7,18,4,11,1,4,9,0,41,25,1
4610,90574,SaJRa20OXDY1LCrTPWwAL4qw1OJoFlxd,SpATywNh6bZuzm8s1ceuBUnMUAeoAHHw,2,0,0,0,0,0,2,0,2,0.2857142857142857,1,0.0,0,0,0,0,0,0,0,2,0,0,2,1
4611,90580,lk8VGt0yosXmu7XbHzsqLBKwzzzp9GK0,SpATywNh6bZuzm8s1ceuBUnMUAeoAHHw,5,3,1,0,0,5,6,0,15,2.142857142857143,1,0.0,0,1,0,0,3,5,0,6,0,1,14,1
4612,90587,LdmiXWzPIjxgi3vXfrG7UNuf9aR1t25A,G8EPVSXsOYB5YQWZGiz1aVq5Pgr2GrQu,2,0,0,0,0,1,1,0,2,0.2857142857142857,1,0.0,0,0,0,0,0,1,0,1,0,0,2,1
4613,90591,dVnTQl9ANUhHsXIPIWBdmTgLVkOgcfeV,SpATywNh6bZuzm8s1ceuBUnMUAeoAHHw,8,5,0,0,0,1,6,1,13,1.8571428571428572,1,0.0,0,0,0,0,5,1,0,6,1,0,13,1
4614,90601,OA2ppL3NBxQQN7UDC41vrrAGRoypzEU8,SpATywNh6bZuzm8s1ceuBUnMUAeoAHHw,6,2,1,0,1,0,4,0,8,1.1428571428571428,1,0.0,0,1,0,1,2,0,0,4,0,2,6,1
4615,90602,OCAzb1VfLGBRFoguhxZLxVaO4EgntnGi,bWdj2GDclj5ofokWjzoa5jAwMkxCykd6,1,0,0,0,0,0,1,0,1,0.14285714285714285,1,0.0,0,0,0,0,0,0,0,1,0,0,1,1
4616,90606,k0hnEE00KysC1NJbTPcs2Jo2pXfE8XJY,RXDvfPUBYFlVdlueBFbLW0mhhAyGEqpt,8,6,1,0,1,0,3,0,11,1.5714285714285714,1,0.0,0,1,0,1,6,0,0,3,0,2,9,1
4617,90615,YfZkWYeVjjwTERIBF4VpFk8mjgVdzlCM,SpATywNh6bZuzm8s1ceuBUnMUAeoAHHw,9,7,4,0,1,5,14,1,32,4.571428571428571,1,0.0,0,4,0,1,7,5,0,14,1,5,27,1
4618,90621,RX2I20RYdT3gZCbZOCxQyWjgnFxuLLo0,SpATywNh6bZuzm8s1ceuBUnMUAeoAHHw,6,3,2,0,2,0,1,0,8,1.1428571428571428,1,0.0,0,2,0,2,3,0,0,1,0,4,4,1
4619,90623,yZoviGGxgr5NFf9klHeC5PfXfdVd14QP,bWdj2GDclj5ofokWjzoa5jAwMkxCykd6,11,9,6,0,4,0,9,0,28,4.0,3,0.0,0,6,0,4,9,0,0,9,0,10,18,1
4620,90626,mYdiJuyvQQSE4J489nl9NbGaNmN8t5fJ,SpATywNh6bZuzm8s1ceuBUnMUAeoAHHw,5,3,1,0,1,0,1,0,6,0.8571428571428571,1,0.0,0,1,0,1,3,0,0,1,0,2,4,1
4621,90629,7y90Jaoh9A6ecz0W5HFrSOzo0GUJhND0,bWdj2GDclj5ofokWjzoa5jAwMkxCykd6,5,3,1,0,0,1,4,0,9,1.2857142857142858,1,0.0,0,1,0,0,3,1,0,4,0,1,8,1
4622,90633,gIghghMxU1G3VEKF49uuB975s41nqI8g,SpATywNh6bZuzm8s1ceuBUnMUAeoAHHw,16,20,11,14,5,13,7,0,70,10.0,2,0.0,6,11,13,5,14,13,1,7,0,35,35,0
4623,90646,yZoviGGxgr5NFf9klHeC5PfXfdVd14QP,RXDvfPUBYFlVdlueBFbLW0mhhAyGEqpt,13,7,6,0,4,0,2,0,19,2.7142857142857144,1,0.0,0,6,0,4,7,0,0,2,0,10,9,1
4624,90648,Ct4CYJV4ldK3GNAcCiI1V5iy769QQWR5,RXDvfPUBYFlVdlueBFbLW0mhhAyGEqpt,8,16,0,0,0,0,5,0,21,3.0,1,0.0,3,0,0,0,13,0,0,5,0,3,18,1
4625,90651,4vJSIQ5zmHwvN98SbnaURZ3kwY3XSM5D,SpATywNh6bZuzm8s1ceuBUnMUAeoAHHw,1,0,0,0,0,0,1,0,1,0.14285714285714285,1,0.0,0,0,0,0,0,0,0,1,0,0,1,1
4626,90654,bA5X6ch4ADNfhanzi2mM69bwbihODbQ4,G8EPVSXsOYB5YQWZGiz1aVq5Pgr2GrQu,81,109,36,234,11,8,12,2,412,58.857142857142854,2,0.0,66,36,185,11,43,8,49,12,2,298,114,0
4627,90659,07a6x7KN30qug4fofBdEl2HySgB5YdgR,bWdj2GDclj5ofokWjzoa5jAwMkxCykd6,5,5,2,0,1,0,2,0,10,1.4285714285714286,2,0.0,0,2,0,1,5,0,0,2,0,3,7,1
4628,90660,YUNLPiSOifGnuGgTqdDXRMjnI0RJBa0e,bWdj2GDclj5ofokWjzoa5jAwMkxCykd6,10,11,6,0,4,3,9,0,33,4.714285714285714,1,0.0,2,6,0,4,9,3,0,9,0,12,21,1
4629,90667,XFmrH2WQYMYLXRE1Jm7VValFt236PUJr,G8EPVSXsOYB5YQWZGiz1aVq5Pgr2GrQu,10,13,1,10,1,0,1,0,26,3.7142857142857144,1,0.0,8,1,6,1,5,0,4,1,0,16,10,1
4630,90684,gBZJD6jZRMZdZxyaZgCjGPROu8WcWTne,G8EPVSXsOYB5YQWZGiz1aVq5Pgr2GrQu,13,25,10,8,8,17,6,2,76,10.857142857142858,1,0.0,12,10,6,8,13,17,2,6,2,36,40,0
4631,90686,tKsi1lDahv8YDRhfKnuEFzTSYneTazEo,RXDvfPUBYFlVdlueBFbLW0mhhAyGEqpt,10,9,5,0,5,3,4,0,26,3.7142857142857144,1,0.0,0,5,0,5,9,3,0,4,0,10,16,1
4632,90688,j8vYdYwa9gvt7hkF8dykZR2D4h75QsII,RXDvfPUBYFlVdlueBFbLW0mhhAyGEqpt,30,31,25,0,10,5,14,3,88,12.571428571428571,5,0.0,0,25,0,10,31,5,0,14,3,35,53,1
4633,90699,tKsi1lDahv8YDRhfKnuEFzTSYneTazEo,SpATywNh6bZuzm8s1ceuBUnMUAeoAHHw,4,1,1,0,1,0,1,0,4,0.5714285714285714,1,0.0,0,1,0,1,1,0,0,1,0,2,2,1
4634,90704,84Ouo0RSw7BvmNUER147KiTqxaHgRaR6,SpATywNh6bZuzm8s1ceuBUnMUAeoAHHw,7,5,3,0,2,0,6,0,16,2.2857142857142856,2,0.0,0,3,0,2,5,0,0,6,0,5,11,1
4635,90710,7fC3V6ivG07wUIMOmiYFzSlyjWvbYnYf,RXDvfPUBYFlVdlueBFbLW0mhhAyGEqpt,11,10,0,0,0,4,5,0,19,2.7142857142857144,1,0.0,0,0,0,0,10,4,0,5,0,0,19,0
4636,90715,BJT6wOznqaiCipmbeEqX4tC1TuhKxC7c,SpATywNh6bZuzm8s1ceuBUnMUAeoAHHw,14,34,14,0,6,3,13,1,71,10.142857142857142,3,0.0,3,14,0,6,31,3,0,13,1,23,48,1
4637,90717,Vmvdv9k8S1ONPkUHSdXPEenyx7UNVISW,bWdj2GDclj5ofokWjzoa5jAwMkxCykd6,19,35,4,68,2,50,18,2,179,25.571428571428573,4,0.0,8,4,61,2,27,50,7,18,2,75,104,1
4638,90719,5KhUU1d5DOX9YzVEFt1mBdZffexByyEY,SpATywNh6bZuzm8s1ceuBUnMUAeoAHHw,13,8,6,0,4,0,6,2,26,3.7142857142857144,1,0.0,0,6,0,4,8,0,0,6,2,10,16,1
4639,90724,5vkNIYp2bYY1LtZU7tLxethQegJYgNo1,bWdj2GDclj5ofokWjzoa5jAwMkxCykd6,16,13,7,84,3,0,8,0,115,16.428571428571427,3,0.0,3,7,77,3,10,0,7,8,0,90,25,1
4640,90731,Kq1HFxeACwjg0zmXbvWkQZ7IB9SIFprl,G8EPVSXsOYB5YQWZGiz1aVq5Pgr2GrQu,14,9,7,0,4,1,7,1,29,4.142857142857143,1,0.0,0,7,0,4,9,1,0,7,1,11,18,1
4641,90734,lHTZAvBbd0zcUoZ0ZCqy0WxYTp3sveXN,RXDvfPUBYFlVdlueBFbLW0mhhAyGEqpt,23,44,17,1,12,3,12,1,90,12.857142857142858,3,0.0,10,17,1,12,34,3,0,12,1,40,50,1
4642,90738,GvWa7qIm5RkYdVcaG192SG5MlRfjDYSk,SpATywNh6bZuzm8s1ceuBUnMUAeoAHHw,5,1,1,0,1,0,2,0,5,0.7142857142857143,1,0.0,0,1,0,1,1,0,0,2,0,2,3,1
4643,90744,2viub6InFwMLthqb8hJjmGF9NgF8w6Xs,bWdj2GDclj5ofokWjzoa5jAwMkxCykd6,4,9,3,0,2,0,1,0,15,2.142857142857143,3,0.0,0,3,0,2,9,0,0,1,0,5,10,1
4644,90745,3VPAWlfwG5nkf9ioSIdd0yq9SoYaPOsq,bWdj2GDclj5ofokWjzoa5jAwMkxCykd6,3,2,0,0,0,0,1,0,3,0.42857142857142855,1,0.0,0,0,0,0,2,0,0,1,0,0,3,1
4645,90751,LrnqEdfBj0D0yEwqlIwYFq7gG4yeMv2F,SpATywNh6bZuzm8s1ceuBUnMUAeoAHHw,12,26,9,19,3,1,5,0,63,9.0,1,0.0,15,9,17,3,11,1,2,5,0,44,19,1
4646,90759,ap9egrEAtqnjEf8GN2Q0V7LnZMXCwsuh,RXDvfPUBYFlVdlueBFbLW0mhhAyGEqpt,9,8,5,0,2,9,4,0,28,4.0,2,0.0,0,5,0,2,8,9,0,4,0,7,21,1
4647,90763,KLWMzt2lbmi8onKYKX9eWLl5lpM0wx0M,SpATywNh6bZuzm8s1ceuBUnMUAeoAHHw,3,2,1,0,0,0,2,0,5,0.7142857142857143,1,0.0,0,1,0,0,2,0,0,2,0,1,4,1
4648,90766,ypPkmbHBKQqVHaDjkpbJ8CKEoLgDbQlR,SpATywNh6bZuzm8s1ceuBUnMUAeoAHHw,6,3,1,0,1,0,3,0,8,1.1428571428571428,1,0.0,0,1,0,1,3,0,0,3,0,2,6,1
4649,90783,bpxaFadaQixJuWRVtAAq5miKiBM3zC6u,RXDvfPUBYFlVdlueBFbLW0mhhAyGEqpt,1,0,0,0,0,0,2,0,2,0.2857142857142857,2,0.0,0,0,0,0,0,0,0,2,0,0,2,1
4650,90793,5yUesVpQg6VbfIA01sOzitb9Qf8no8xc,bWdj2GDclj5ofokWjzoa5jAwMkxCykd6,4,2,1,0,1,0,1,0,5,0.7142857142857143,1,0.0,0,1,0,1,2,0,0,1,0,2,3,1
4651,90797,xkhW0o7SPQFIOs4D7mnb6RH3kX3k2QhW,SpATywNh6bZuzm8s1ceuBUnMUAeoAHHw,6,2,0,0,0,0,5,0,7,1.0,1,0.0,0,0,0,0,2,0,0,5,0,0,7,1
4652,90798,V95Tt6b4Z06nKuvQsXC9kpbsyH3YIGk4,SpATywNh6bZuzm8s1ceuBUnMUAeoAHHw,3,2,0,0,0,6,1,0,9,1.2857142857142858,1,0.0,0,0,0,0,2,6,0,1,0,0,9,1
4653,90807,DYC2TKuAWipp9UNJIdqFLJgrkLj9mdOD,SpATywNh6bZuzm8s1ceuBUnMUAeoAHHw,17,36,12,16,4,7,23,6,104,14.857142857142858,3,0.0,12,12,13,4,24,7,3,23,6,41,63,0
4654,90814,EzH5vTFvKXPmDbmZZs9qDP4fhOA2tS8t,SpATywNh6bZuzm8s1ceuBUnMUAeoAHHw,15,29,5,12,5,7,7,2,67,9.571428571428571,1,0.0,18,5,11,5,11,7,1,7,2,39,28,1
4655,90827,Nu895EVx5N8YMgmc6Rsn4OVZESOkiczT,bWdj2GDclj5ofokWjzoa5jAwMkxCykd6,4,3,1,0,1,0,1,0,6,0.8571428571428571,1,0.0,0,1,0,1,3,0,0,1,0,2,4,1
4656,90829,r1uzabdEU8Xrw9e89SInzZPTwxnUupS6,SpATywNh6bZuzm8s1ceuBUnMUAeoAHHw,19,18,11,22,8,2,15,1,77,11.0,2,0.0,4,11,17,8,14,2,5,15,1,40,37,1
4657,90834,FajLS6BmkKgqb4XY9XPhCU4sFK1uRQ8Y,SpATywNh6bZuzm8s1ceuBUnMUAeoAHHw,6,2,1,0,1,0,3,0,7,1.0,1,0.0,1,1,0,1,1,0,0,3,0,3,4,1
4658,90838,J5zz2fAd7wtYMISsvWzFdYy7sZtBfDuG,SpATywNh6bZuzm8s1ceuBUnMUAeoAHHw,11,17,7,0,3,7,9,1,44,6.285714285714286,1,0.0,8,7,0,3,9,7,0,9,1,18,26,1
4659,90840,b1jxzfFtNrlmaMGoYNWOYfEAHOoLdx2j,bWdj2GDclj5ofokWjzoa5jAwMkxCykd6,7,6,2,4,1,0,7,0,20,2.857142857142857,1,0.0,2,2,4,1,4,0,0,7,0,9,11,1
4660,90860,JNtIRj6hnKiaMOhcBlcWRjLc0QwYKSxo,RXDvfPUBYFlVdlueBFbLW0mhhAyGEqpt,5,2,1,0,1,0,2,0,6,0.8571428571428571,1,0.0,0,1,0,1,2,0,0,2,0,2,4,1
4661,90871,pS71kwyejWdfiaeMEH40zntKPU95klQC,SpATywNh6bZuzm8s1ceuBUnMUAeoAHHw,6,3,0,0,0,0,3,1,7,1.0,1,0.0,0,0,0,0,3,0,0,3,1,0,7,1
4662,90873,LoEfaid2dOKAK1Vb6WcaGJbgN3PRNGde,SpATywNh6bZuzm8s1ceuBUnMUAeoAHHw,4,2,1,0,1,0,2,0,6,0.8571428571428571,1,0.0,0,1,0,1,2,0,0,2,0,2,4,1
4663,90886,U6j39msbwkx5j8wcgHIrrZSEw6jir138,SpATywNh6bZuzm8s1ceuBUnMUAeoAHHw,5,4,2,0,2,0,2,0,10,1.4285714285714286,1,0.0,1,2,0,2,3,0,0,2,0,5,5,1
4664,90895,TRCrdidmG6eXWyA1xpJbOiCViWff58Ia,bWdj2GDclj5ofokWjzoa5jAwMkxCykd6,5,2,1,0,1,0,2,0,6,0.8571428571428571,1,0.0,0,1,0,1,2,0,0,2,0,2,4,1
4665,90898,KuNFtG4l08F89uoxUeo0jGAYIKWrBRbs,SpATywNh6bZuzm8s1ceuBUnMUAeoAHHw,11,8,4,5,3,0,2,0,22,3.142857142857143,2,0.0,1,4,4,3,7,0,1,2,0,12,10,1
4666,90900,ZlJV9a7edMx2HyEVyPzwwfS7y67dq8Ki,SpATywNh6bZuzm8s1ceuBUnMUAeoAHHw,7,6,4,0,4,0,2,0,16,2.2857142857142856,1,0.0,1,4,0,4,5,0,0,2,0,9,7,1
4667,90917,nazeZS8BdRMOGGuVriyb5M21Pn5Qng36,bWdj2GDclj5ofokWjzoa5jAwMkxCykd6,7,18,9,0,17,0,9,0,53,7.571428571428571,3,0.0,0,9,0,17,18,0,0,9,0,26,27,1
4668,90924,8dce3jvQILzvCt2gqdxC1GXJeAlwT2XG,SpATywNh6bZuzm8s1ceuBUnMUAeoAHHw,5,2,1,0,1,0,3,0,7,1.0,1,0.0,0,1,0,1,2,0,0,3,0,2,5,1
4669,90931,MhTSP1UwQzeoqedkBfla3LYw7KA6P5RM,bWdj2GDclj5ofokWjzoa5jAwMkxCykd6,3,2,0,0,0,0,2,0,4,0.5714285714285714,1,0.0,0,0,0,0,2,0,0,2,0,0,4,1
4670,90935,T6uKBu9byfRvxDh9TTWa54gKMCltkicT,G8EPVSXsOYB5YQWZGiz1aVq5Pgr2GrQu,4,4,3,0,3,0,1,0,11,1.5714285714285714,2,0.0,0,3,0,3,4,0,0,1,0,6,5,1
4671,90936,ElLz2aBJCCMb80RAglralkX1EvljkdsQ,SpATywNh6bZuzm8s1ceuBUnMUAeoAHHw,5,3,1,0,1,0,2,0,7,1.0,1,0.0,0,1,0,1,3,0,0,2,0,2,5,1
4672,90941,XTcsDe1fuCzXOnCFHuWkz7K8gAjPZJM4,bWdj2GDclj5ofokWjzoa5jAwMkxCykd6,2,0,0,0,0,0,5,0,5,0.7142857142857143,1,0.0,0,0,0,0,0,0,0,5,0,0,5,1
4673,90942,oh70wjHZNiJm6YMEO2zTeIrDQMUiqmDd,bWdj2GDclj5ofokWjzoa5jAwMkxCykd6,8,14,2,0,2,0,3,0,21,3.0,2,0.0,4,2,0,2,10,0,0,3,0,8,13,1
4674,90943,iz51PdaMdn80ICs5ffsXdIXAEkxQQqv2,SpATywNh6bZuzm8s1ceuBUnMUAeoAHHw,17,9,5,16,3,2,9,1,45,6.428571428571429,1,0.0,3,5,15,3,6,2,1,9,1,26,19,1
4675,90944,Sz8jNgPmKJ1IbqEEVQqTtQlVUDGarqh2,bWdj2GDclj5ofokWjzoa5jAwMkxCykd6,11,8,3,0,4,0,11,1,27,3.857142857142857,1,0.0,3,3,0,4,5,0,0,11,1,10,17,1
4676,90950,FwoYWsRBSR2prQ90dYeOBoYOgqUPkA0R,G8EPVSXsOYB5YQWZGiz1aVq5Pgr2GrQu,2,0,0,0,0,0,3,0,3,0.42857142857142855,2,0.0,0,0,0,0,0,0,0,3,0,0,3,1
4677,90952,YQuE8HipF2FTxF6yilCc6Hjt2hO1hf9q,bWdj2GDclj5ofokWjzoa5jAwMkxCykd6,7,5,1,0,2,2,6,2,18,2.5714285714285716,1,0.0,3,1,0,2,2,2,0,6,2,6,12,1
4678,90965,1YzhwwWLdVM4bzJMYH49O7nplNitMAxK,bWdj2GDclj5ofokWjzoa5jAwMkxCykd6,4,2,1,0,1,0,2,0,6,0.8571428571428571,1,0.0,0,1,0,1,2,0,0,2,0,2,4,1
4679,90971,0Any9bve5RgMfxHre7giBaaR9aLeQ2Lh,G8EPVSXsOYB5YQWZGiz1aVq5Pgr2GrQu,31,27,9,48,5,1,6,1,97,13.857142857142858,2,0.0,10,9,36,5,17,1,12,6,1,60,37,1
4680,90972,zZsHSLX7Hk1sqhZYCfBgGlYJnqetGIKf,RXDvfPUBYFlVdlueBFbLW0mhhAyGEqpt,7,6,2,0,2,4,2,0,16,2.2857142857142856,2,0.0,0,2,0,2,6,4,0,2,0,4,12,1
4681,90977,54WxhKjSN8T9wal7LR6RLgJ4OJYZ4MI7,SpATywNh6bZuzm8s1ceuBUnMUAeoAHHw,7,2,1,0,1,0,4,2,10,1.4285714285714286,1,0.0,0,1,0,1,2,0,0,4,2,2,8,1
4682,90981,WaDGEoZt5VlIPyIkYuUem7AfSknoei62,SpATywNh6bZuzm8s1ceuBUnMUAeoAHHw,5,3,2,0,2,0,2,0,9,1.2857142857142858,1,0.0,0,2,0,2,3,0,0,2,0,4,5,1
4683,90983,6bHj9PZ0VE3b8eSJI8u4oP72tokPXLXO,G8EPVSXsOYB5YQWZGiz1aVq5Pgr2GrQu,1,0,0,0,0,0,1,0,1,0.14285714285714285,1,0.0,0,0,0,0,0,0,0,1,0,0,1,1
4684,90985,1fUklgl0Md6ScDLqDSo4HCeoLeD6eKIu,SpATywNh6bZuzm8s1ceuBUnMUAeoAHHw,4,2,1,0,1,0,1,0,5,0.7142857142857143,1,0.0,0,1,0,1,2,0,0,1,0,2,3,1
4685,90988,088SASUPOVYUGhoEly8vlrkGvRBJoNwp,bWdj2GDclj5ofokWjzoa5jAwMkxCykd6,1,0,0,0,0,0,1,0,1,0.14285714285714285,1,0.0,0,0,0,0,0,0,0,1,0,0,1,1
4686,90993,o9jg8F69R1QHiPj2Cseo8eHEbgUVa0SI,SpATywNh6bZuzm8s1ceuBUnMUAeoAHHw,14,12,7,8,3,0,4,0,34,4.857142857142857,1,0.0,3,7,8,3,9,0,0,4,0,21,13,1
4687,90994,aRm0bLcx1zhfrL1xTMfT090YII1zkLc3,SpATywNh6bZuzm8s1ceuBUnMUAeoAHHw,9,7,3,0,0,9,7,1,27,3.857142857142857,1,0.0,0,3,0,0,7,9,0,7,1,3,24,1
4688,90999,CwyOL3RMOVLomxrxyN9D4jPa9R0iWrS5,G8EPVSXsOYB5YQWZGiz1aVq5Pgr2GrQu,9,8,5,0,5,0,5,0,23,3.2857142857142856,4,0.0,0,5,0,5,8,0,0,5,0,10,13,0
4689,91026,MjeqDLbJZr4I90t51p6C9NVAFWnc6WKs,SpATywNh6bZuzm8s1ceuBUnMUAeoAHHw,4,2,1,0,1,0,1,0,5,0.7142857142857143,1,0.0,0,1,0,1,2,0,0,1,0,2,3,1
4690,91034,QFBztpG3zDUpKNEaUDnlRETY3MvJRJAi,SpATywNh6bZuzm8s1ceuBUnMUAeoAHHw,5,2,1,0,1,0,2,0,6,0.8571428571428571,1,0.0,0,1,0,1,2,0,0,2,0,2,4,1
4691,91042,NkVQGteS9t3nbfagAzHcxD3mnVkb9mPC,bWdj2GDclj5ofokWjzoa5jAwMkxCykd6,18,22,12,54,6,10,13,0,117,16.714285714285715,4,0.0,4,12,46,6,18,10,8,13,0,68,49,1
4692,91048,niLMw8MCObO7SSR2V1jNg9WQt5oSjDFJ,bWdj2GDclj5ofokWjzoa5jAwMkxCykd6,6,5,3,0,2,0,3,0,13,1.8571428571428572,2,0.0,0,3,0,2,5,0,0,3,0,5,8,1
4693,91051,xl5sOWFbG0Tv8T4ljEfZxFv4R7vezkE6,SpATywNh6bZuzm8s1ceuBUnMUAeoAHHw,7,1,1,0,1,0,5,1,9,1.2857142857142858,1,0.0,0,1,0,1,1,0,0,5,1,2,7,1
4694,91052,OoFskl7apYDC7BHDdb3sEQXj1CchwYwD,bWdj2GDclj5ofokWjzoa5jAwMkxCykd6,2,0,0,0,0,0,2,0,2,0.2857142857142857,1,0.0,0,0,0,0,0,0,0,2,0,0,2,1
4695,91056,Iji9dmQW7A2gOcEtvLASbynNxhfIM21F,bWdj2GDclj5ofokWjzoa5jAwMkxCykd6,6,5,2,0,1,0,4,0,12,1.7142857142857142,2,0.0,0,2,0,1,5,0,0,4,0,3,9,1
4696,91069,YYUyHWUcinXU8cifTlXoJnuPjgxGAJi5,SpATywNh6bZuzm8s1ceuBUnMUAeoAHHw,1,0,0,0,0,0,1,0,1,0.14285714285714285,1,0.0,0,0,0,0,0,0,0,1,0,0,1,1
4697,91074,JpAMTeX7S86zOjUKZJzvXPct8ySEHYBj,G8EPVSXsOYB5YQWZGiz1aVq5Pgr2GrQu,6,3,1,0,1,0,4,0,9,1.2857142857142858,1,0.0,0,1,0,1,3,0,0,4,0,2,7,1
4698,91077,6LSxEzHekfBjzdBuVJRrkvGn3CBVWXBO,SpATywNh6bZuzm8s1ceuBUnMUAeoAHHw,12,14,6,0,4,1,5,1,31,4.428571428571429,1,0.0,2,6,0,4,12,1,0,5,1,12,19,1
4699,91085,WzyxlFqmZtRh9gdD2KRH7ykffyZqisUy,SpATywNh6bZuzm8s1ceuBUnMUAeoAHHw,13,26,2,17,1,2,9,0,57,8.142857142857142,1,0.0,9,2,15,1,17,2,2,9,0,27,30,1
4700,91091,UlE0oj4kFfHwymOFgqOZSWzrZZdGbIRC,SpATywNh6bZuzm8s1ceuBUnMUAeoAHHw,9,5,1,0,1,1,6,1,15,2.142857142857143,1,0.0,0,1,0,1,5,1,0,6,1,2,13,1
4701,91092,mXfwwTIVjHMqoVKAh2iEQbinKUCJHwTp,SpATywNh6bZuzm8s1ceuBUnMUAeoAHHw,10,30,15,0,10,6,13,0,74,10.571428571428571,3,0.0,0,15,0,10,30,6,0,13,0,25,49,1
4702,91113,LDDV5GLR4T4AoJ4swm7PTuKciMVwXQ01,G8EPVSXsOYB5YQWZGiz1aVq5Pgr2GrQu,32,41,9,22,8,7,23,1,111,15.857142857142858,6,0.0,8,9,19,8,33,7,3,23,1,44,67,0
4703,91123,b49trtJTjAjBwZY0yqpUQlVmAVV99Apg,SpATywNh6bZuzm8s1ceuBUnMUAeoAHHw,12,14,7,4,5,1,5,0,36,5.142857142857143,1,0.0,2,7,4,5,12,1,0,5,0,18,18,1
4704,91133,eYnqJ330oueH4EH7KeCLJxm6knixAbKs,SpATywNh6bZuzm8s1ceuBUnMUAeoAHHw,10,7,5,0,4,0,4,0,20,2.857142857142857,2,0.0,0,5,0,4,7,0,0,4,0,9,11,1
4705,91136,IVuLX03K95bXWOSaQ9TjOxhrrnD2P8LK,SpATywNh6bZuzm8s1ceuBUnMUAeoAHHw,16,14,7,11,4,0,6,1,43,6.142857142857143,1,0.0,4,7,11,4,10,0,0,6,1,26,17,1
4706,91139,Dw8R0agU0UT0CHCyap3lEB834WRdn2Bl,G8EPVSXsOYB5YQWZGiz1aVq5Pgr2GrQu,9,5,3,0,3,0,2,0,13,1.8571428571428572,1,0.0,1,3,0,3,4,0,0,2,0,7,6,1
4707,91149,SOPkGQWWnRmFTO7wOQhPDwNSzqEUHcJN,RXDvfPUBYFlVdlueBFbLW0mhhAyGEqpt,9,6,5,0,3,0,1,0,15,2.142857142857143,1,0.0,0,5,0,3,6,0,0,1,0,8,7,1
4708,91152,ogzXep3azQvjQ2uIPIxw4TZLNiUXYlgD,RXDvfPUBYFlVdlueBFbLW0mhhAyGEqpt,21,12,8,16,4,16,8,6,70,10.0,2,0.0,2,8,15,4,10,16,1,8,6,29,41,1
4709,91175,5q13Swk6MXZ4N9xLOgcxgjrrx1DdXb4Y,G8EPVSXsOYB5YQWZGiz1aVq5Pgr2GrQu,2,0,0,0,0,0,2,0,2,0.2857142857142857,1,0.0,0,0,0,0,0,0,0,2,0,0,2,1
4710,91177,CwCqnH1O0RObsR0eBW9cv5anjwotHyXi,SpATywNh6bZuzm8s1ceuBUnMUAeoAHHw,8,4,3,0,3,0,1,0,11,1.5714285714285714,1,0.0,0,3,0,3,4,0,0,1,0,6,5,1
4711,91180,MBIWth5fpiCntqhZOrmXyFENe8IPo1si,G8EPVSXsOYB5YQWZGiz1aVq5Pgr2GrQu,5,2,1,0,1,0,3,0,7,1.0,1,0.0,0,1,0,1,2,0,0,3,0,2,5,1
4712,91185,bUI06hErQBLCI8IpvZBPVsO5ApTPyNZ8,bWdj2GDclj5ofokWjzoa5jAwMkxCykd6,6,3,1,0,1,0,2,0,7,1.0,2,0.0,0,1,0,1,3,0,0,2,0,2,5,1
4713,91186,N3cFMZkDkwJjlqfThZ0MJktu3s2FDQhu,SpATywNh6bZuzm8s1ceuBUnMUAeoAHHw,14,12,6,10,4,0,5,0,37,5.285714285714286,1,0.0,2,6,10,4,10,0,0,5,0,22,15,1
4714,91195,sD1p5VuSw3mE3A3cEGdX778feL3umtle,G8EPVSXsOYB5YQWZGiz1aVq5Pgr2GrQu,1,0,0,0,0,0,2,0,2,0.2857142857142857,1,0.0,0,0,0,0,0,0,0,2,0,0,2,1
4715,91197,MfRaHJKkD3QtNBNxriSuNn50bOkDWFU2,G8EPVSXsOYB5YQWZGiz1aVq5Pgr2GrQu,4,4,1,0,2,0,1,0,8,1.1428571428571428,1,0.0,2,1,0,2,2,0,0,1,0,5,3,0
4716,91200,Zw1bdKbgaMzUzlqlieQSaucEQ8wggZlx,RXDvfPUBYFlVdlueBFbLW0mhhAyGEqpt,7,6,4,0,2,0,2,0,14,2.0,1,0.0,0,4,0,2,6,0,0,2,0,6,8,1
4717,91211,YlWJRLkP5QIlBcoTrKDrquHDRSLUHmOs,SpATywNh6bZuzm8s1ceuBUnMUAeoAHHw,14,21,0,17,0,24,8,1,71,10.142857142857142,4,0.0,10,0,15,0,11,24,2,8,1,25,46,0
4718,91224,0b8coo9JZwKqcLwikgVi0uCa0HK4ngVT,SpATywNh6bZuzm8s1ceuBUnMUAeoAHHw,7,7,3,0,3,0,2,0,15,2.142857142857143,1,0.0,2,3,0,3,5,0,0,2,0,8,7,1
4719,91227,wrG2kznqDzNLV2b2BDLa9oNAZZomHWM1,bWdj2GDclj5ofokWjzoa5jAwMkxCykd6,5,3,0,0,0,0,2,0,5,0.7142857142857143,1,0.0,0,0,0,0,3,0,0,2,0,0,5,1
4720,91234,Zw1bdKbgaMzUzlqlieQSaucEQ8wggZlx,SpATywNh6bZuzm8s1ceuBUnMUAeoAHHw,8,10,7,0,5,0,4,0,26,3.7142857142857144,2,0.0,0,7,0,5,10,0,0,4,0,12,14,1
4721,91237,JLChl7mOWMB1KaATZ4zO6thYfhhSEMFx,bWdj2GDclj5ofokWjzoa5jAwMkxCykd6,4,2,0,0,0,2,3,0,7,1.0,1,0.0,0,0,0,0,2,2,0,3,0,0,7,1
4722,91248,20Kk6BKHam3XYBZHLn3cb7mbeQ3wjB0A,SpATywNh6bZuzm8s1ceuBUnMUAeoAHHw,5,3,1,0,1,0,2,0,7,1.0,1,0.0,0,1,0,1,3,0,0,2,0,2,5,1
4723,91288,il7MvONte06QnYiXs4eT4KVZhcQaTvCn,bWdj2GDclj5ofokWjzoa5jAwMkxCykd6,2,0,0,0,0,0,2,0,2,0.2857142857142857,1,0.0,0,0,0,0,0,0,0,2,0,0,2,1
4724,91290,4BCWVZMgSyk2ZEk4MHhm6b7lpgXWTd1k,SpATywNh6bZuzm8s1ceuBUnMUAeoAHHw,16,27,21,10,11,12,13,1,95,13.571428571428571,3,0.0,0,21,7,11,27,12,3,13,1,39,56,0
4725,91292,f6cpMj2XDptMqY9BMDiLiCW1lYt1B5HJ,bWdj2GDclj5ofokWjzoa5jAwMkxCykd6,2,0,0,0,0,2,2,0,4,0.5714285714285714,1,0.0,0,0,0,0,0,2,0,2,0,0,4,1
4726,91295,R0mUc8n4TzKl7Gj3gQcARJOPoEK9YWes,SpATywNh6bZuzm8s1ceuBUnMUAeoAHHw,9,10,4,0,2,0,9,1,26,3.7142857142857144,1,0.0,0,4,0,2,10,0,0,9,1,6,20,1
4727,91298,q4LihsiR4OZ2DrDNHviQwvJKphS7fKLx,SpATywNh6bZuzm8s1ceuBUnMUAeoAHHw,5,3,1,0,1,0,3,0,8,1.1428571428571428,1,0.0,0,1,0,1,3,0,0,3,0,2,6,1
4728,91308,aUncRjNtcPfHDYIbstir1RL5J34mNVnM,SpATywNh6bZuzm8s1ceuBUnMUAeoAHHw,1,0,0,0,0,0,1,0,1,0.14285714285714285,1,0.0,0,0,0,0,0,0,0,1,0,0,1,1
4729,91309,i0UAMwrjj2eXydsjRtQeHBmAMB3Ngwx3,SpATywNh6bZuzm8s1ceuBUnMUAeoAHHw,3,3,1,0,0,0,1,0,5,0.7142857142857143,1,0.0,0,1,0,0,3,0,0,1,0,1,4,1
4730,91311,StzJzmbhGW7cEyMLQz7mJx8nKnB6WL4m,bWdj2GDclj5ofokWjzoa5jAwMkxCykd6,1,0,0,0,0,0,1,0,1,0.14285714285714285,1,0.0,0,0,0,0,0,0,0,1,0,0,1,1
4731,91313,SHYKz4VRgTlESEEhjzd6VibUsZchMKQH,G8EPVSXsOYB5YQWZGiz1aVq5Pgr2GrQu,6,5,2,0,2,0,3,0,12,1.7142857142857142,2,0.0,0,2,0,2,5,0,0,3,0,4,8,0
4732,91318,p1lN44XlRZ80wopUQc4ZNciWVb9r8nPI,RXDvfPUBYFlVdlueBFbLW0mhhAyGEqpt,18,26,10,26,3,0,4,0,69,9.857142857142858,2,0.0,4,10,22,3,22,0,4,4,0,39,30,1
4733,91321,qRCFXu9SKQXvPlpvjvNkgxm9VD5k2SNq,SpATywNh6bZuzm8s1ceuBUnMUAeoAHHw,15,19,8,17,3,1,9,0,57,8.142857142857142,3,0.0,8,8,15,3,11,1,2,9,0,34,23,1
4734,91342,za2dBkPPLD9IPRBjooK7GJit2ulI5UgN,bWdj2GDclj5ofokWjzoa5jAwMkxCykd6,1,0,0,0,0,0,1,0,1,0.14285714285714285,1,0.0,0,0,0,0,0,0,0,1,0,0,1,1
4735,91366,fE7crtUj4hDSQo6ITE7OJYFi4AN2F95M,RXDvfPUBYFlVdlueBFbLW0mhhAyGEqpt,9,7,0,9,1,0,1,0,18,2.5714285714285716,1,0.0,2,0,9,1,5,0,0,1,0,12,6,1
4736,91383,BcJnhjzA1hw0WNze9uWUZQ49uBAiBHyH,SpATywNh6bZuzm8s1ceuBUnMUAeoAHHw,12,21,3,6,4,2,6,0,42,6.0,3,0.0,5,3,6,4,16,2,0,6,0,18,24,0
4737,91385,2GLZl96ZIgoKdw26t6xniq9LngPm9HvA,SpATywNh6bZuzm8s1ceuBUnMUAeoAHHw,8,3,2,0,2,0,3,0,10,1.4285714285714286,1,0.0,0,2,0,2,3,0,0,3,0,4,6,1
4738,91386,Id4UmIRRQiLXHoJYSjh5OCO1CRaFgQ2K,bWdj2GDclj5ofokWjzoa5jAwMkxCykd6,4,2,1,0,1,0,1,0,5,0.7142857142857143,1,0.0,0,1,0,1,2,0,0,1,0,2,3,1
4739,91389,j6Gbqu7tKtq8czp36zzxzHhI2ZEexibX,RXDvfPUBYFlVdlueBFbLW0mhhAyGEqpt,5,5,3,0,0,0,4,0,12,1.7142857142857142,2,0.0,0,3,0,0,5,0,0,4,0,3,9,1
4740,91393,pIUtN3HLfZAw0y37LPvuW9XkUHMVBvrO,bWdj2GDclj5ofokWjzoa5jAwMkxCykd6,1,0,0,0,0,0,1,0,1,0.14285714285714285,1,0.0,0,0,0,0,0,0,0,1,0,0,1,1
4741,91394,E7lyNwGYkG4o0UtCNjPSm6tmdy5hs4Mj,SpATywNh6bZuzm8s1ceuBUnMUAeoAHHw,7,1,1,0,1,0,5,0,8,1.1428571428571428,1,0.0,0,1,0,1,1,0,0,5,0,2,6,1
4742,91395,NzJuOfalEsOT54AavPrqSe3rsSE0cQkZ,bWdj2GDclj5ofokWjzoa5jAwMkxCykd6,1,0,0,0,0,0,1,0,1,0.14285714285714285,1,0.0,0,0,0,0,0,0,0,1,0,0,1,1
4743,91401,iM4WoC15lD8jmFLbUdaT8GwiDe76pgOg,G8EPVSXsOYB5YQWZGiz1aVq5Pgr2GrQu,2,0,0,0,0,0,2,0,2,0.2857142857142857,2,0.0,0,0,0,0,0,0,0,2,0,0,2,1
4744,91404,pSX4Dt8N2zVP05X1Tx0KEKzwWiZKDmer,SpATywNh6bZuzm8s1ceuBUnMUAeoAHHw,6,4,1,0,0,0,4,0,9,1.2857142857142858,2,0.0,0,1,0,0,4,0,0,4,0,1,8,1
4745,91405,piFN5eqEaJK1fUd2Yaiy8tquOTQSgzuN,RXDvfPUBYFlVdlueBFbLW0mhhAyGEqpt,2,0,0,0,0,0,3,0,3,0.42857142857142855,1,0.0,0,0,0,0,0,0,0,3,0,0,3,1
4746,91408,ov4pd0r7G3aHxyRJ3zd0jj3VwbkwbsuS,SpATywNh6bZuzm8s1ceuBUnMUAeoAHHw,8,2,1,0,1,2,11,1,18,2.5714285714285716,1,0.0,0,1,0,1,2,2,0,11,1,2,16,1
4747,91410,sEqMP3dTCfBAru35lgG6C0VuJq3LG5mE,SpATywNh6bZuzm8s1ceuBUnMUAeoAHHw,6,4,1,0,1,3,5,0,14,2.0,3,0.0,0,1,0,1,4,3,0,5,0,2,12,1
4748,91414,HSyljcmKCDSksgg7xJb6gUib0wBvYjVv,G8EPVSXsOYB5YQWZGiz1aVq5Pgr2GrQu,32,44,26,46,10,13,12,1,152,21.714285714285715,3,0.0,12,26,32,10,32,13,14,12,1,80,72,1
4749,91423,g6UH67YbvJtewLNXQNVZTYui0XC1Hxpo,bWdj2GDclj5ofokWjzoa5jAwMkxCykd6,7,12,7,0,1,5,6,0,31,4.428571428571429,1,0.0,1,7,0,1,11,5,0,6,0,9,22,1
4750,91429,Ocd58hpNcygqCXglTTmZd1ZSNvH3SCps,RXDvfPUBYFlVdlueBFbLW0mhhAyGEqpt,6,6,4,0,1,0,1,0,12,1.7142857142857142,1,0.0,0,4,0,1,6,0,0,1,0,5,7,1
4751,91430,vrpzudIR4dEiVdhwxbfDnInMv3JRRfJv,SpATywNh6bZuzm8s1ceuBUnMUAeoAHHw,5,3,1,0,1,0,1,0,6,0.8571428571428571,1,0.0,0,1,0,1,3,0,0,1,0,2,4,1
4752,91434,0CSUGuJXm53wz281T7wy30wWcjmP6Jhd,bWdj2GDclj5ofokWjzoa5jAwMkxCykd6,1,0,0,0,0,0,1,0,1,0.14285714285714285,1,0.0,0,0,0,0,0,0,0,1,0,0,1,1
4753,91438,FUkw8gvbqykqbH4tdSuG6VwP03f4pQvB,RXDvfPUBYFlVdlueBFbLW0mhhAyGEqpt,1,0,0,0,0,0,1,0,1,0.14285714285714285,1,0.0,0,0,0,0,0,0,0,1,0,0,1,1
4754,91442,XR5Z5kfmQ9E4GIPtNaMkJo2oa530uh94,SpATywNh6bZuzm8s1ceuBUnMUAeoAHHw,11,6,4,0,3,0,5,1,19,2.7142857142857144,1,0.0,0,4,0,3,6,0,0,5,1,7,12,1
4755,91456,pIUtN3HLfZAw0y37LPvuW9XkUHMVBvrO,SpATywNh6bZuzm8s1ceuBUnMUAeoAHHw,5,2,1,0,1,0,2,0,6,0.8571428571428571,1,0.0,0,1,0,1,2,0,0,2,0,2,4,1
4756,91460,qzjZHUzfivuSEB3h2CxO69AUVaBX51Ki,bWdj2GDclj5ofokWjzoa5jAwMkxCykd6,3,0,0,0,0,1,7,0,8,1.1428571428571428,2,0.0,0,0,0,0,0,1,0,7,0,0,8,1
4757,91474,XDng1mliVGDk6IontbBqBdoGZnODrUp1,SpATywNh6bZuzm8s1ceuBUnMUAeoAHHw,1,0,0,0,0,0,1,0,1,0.14285714285714285,1,0.0,0,0,0,0,0,0,0,1,0,0,1,0
4758,91477,Rhpf6lbWeFbBg91LchhBc713YgETI2ib,SpATywNh6bZuzm8s1ceuBUnMUAeoAHHw,11,10,0,14,0,2,6,2,34,4.857142857142857,1,0.0,4,0,13,0,6,2,1,6,2,17,17,1
4759,91478,mB7kFNAvy0IlvYKinAyQDJ9wbSStqolr,SpATywNh6bZuzm8s1ceuBUnMUAeoAHHw,9,3,1,0,1,15,7,6,33,4.714285714285714,1,0.0,0,1,0,1,3,15,0,7,6,2,31,1
4760,91480,3NG42RQfrkx04BX4rgjNYVd7JioduuEW,SpATywNh6bZuzm8s1ceuBUnMUAeoAHHw,30,93,45,23,14,12,26,1,214,30.571428571428573,8,0.0,22,45,22,14,71,12,1,26,1,103,111,0
4761,91484,Ja9aSTrbcYBJIk0knND32MhX73YVzDja,SpATywNh6bZuzm8s1ceuBUnMUAeoAHHw,15,33,7,19,3,5,8,1,76,10.857142857142858,2,0.0,23,7,17,3,10,5,2,8,1,50,26,1
4762,91498,Hh0poBt7neEeproKcOr3UwYd1l0mAkdY,SpATywNh6bZuzm8s1ceuBUnMUAeoAHHw,3,2,0,0,0,0,1,0,3,0.42857142857142855,1,0.0,0,0,0,0,2,0,0,1,0,0,3,1
4763,91499,MpyJrzGdf4KkfpgI13J4Ob9OCNumnSCn,G8EPVSXsOYB5YQWZGiz1aVq5Pgr2GrQu,19,22,8,38,8,0,4,1,81,11.571428571428571,3,0.0,1,8,34,8,21,0,4,4,1,51,30,1
4764,91503,Zx58r1nZicPZKjfYD5NgFYMSoAobbtxC,SpATywNh6bZuzm8s1ceuBUnMUAeoAHHw,12,11,7,0,5,0,5,0,28,4.0,1,0.0,1,7,0,5,10,0,0,5,0,13,15,1
4765,91510,NjgQeSBBMWIwQySsR5ymtqiugkMaOyYh,RXDvfPUBYFlVdlueBFbLW0mhhAyGEqpt,1,0,0,0,0,0,1,0,1,0.14285714285714285,1,0.0,0,0,0,0,0,0,0,1,0,0,1,1
4766,91512,IOj0PjWZoY0P8vGiPElep0GUuIa0VzfB,SpATywNh6bZuzm8s1ceuBUnMUAeoAHHw,8,2,1,0,1,0,5,1,10,1.4285714285714286,2,0.0,0,1,0,1,2,0,0,5,1,2,8,1
4767,91513,mlU6Sa4kvQqDwrJTiTVy3DXIlsysw3Tt,bWdj2GDclj5ofokWjzoa5jAwMkxCykd6,7,2,1,0,1,2,6,1,13,1.8571428571428572,1,0.0,0,1,0,1,2,2,0,6,1,2,11,0
4768,91521,1wUGa0IVsURQxQCvq0df7PLHs6Y2zNr7,bWdj2GDclj5ofokWjzoa5jAwMkxCykd6,5,5,0,0,0,0,7,0,12,1.7142857142857142,1,0.0,0,0,0,0,5,0,0,7,0,0,12,1
4769,91534,QM4BAIMqANq73zFQSTCtWv7Gn7ptHHhB,SpATywNh6bZuzm8s1ceuBUnMUAeoAHHw,7,3,2,0,1,0,6,0,12,1.7142857142857142,1,0.0,0,2,0,1,3,0,0,6,0,3,9,1
4770,91537,OiZVspQp0F9iJRMGMp4WIKFfxCHFzZhd,SpATywNh6bZuzm8s1ceuBUnMUAeoAHHw,1,0,0,0,0,0,1,0,1,0.14285714285714285,1,0.0,0,0,0,0,0,0,0,1,0,0,1,1
4771,91542,gpepovLBdtRKFzmC4QxqUbBL1lSM59qa,G8EPVSXsOYB5YQWZGiz1aVq5Pgr2GrQu,6,5,2,0,1,0,2,0,10,1.4285714285714286,1,0.0,0,2,0,1,5,0,0,2,0,3,7,1
4772,91555,nQTEVD6AAIYz8tW67vxXg9EsDxe19v25,SpATywNh6bZuzm8s1ceuBUnMUAeoAHHw,1,0,0,0,0,0,1,0,1,0.14285714285714285,1,0.0,0,0,0,0,0,0,0,1,0,0,1,1
4773,91558,JaxQCd7UV5o1rvWxAibMy6iOMU3fCV5H,SpATywNh6bZuzm8s1ceuBUnMUAeoAHHw,5,2,1,0,1,0,2,0,6,0.8571428571428571,1,0.0,0,1,0,1,2,0,0,2,0,2,4,1
4774,91574,Utp3WJ8WUPD5DMyG8PNbE11goCMql2Z7,SpATywNh6bZuzm8s1ceuBUnMUAeoAHHw,7,3,2,0,2,0,3,0,10,1.4285714285714286,2,0.0,0,2,0,2,3,0,0,3,0,4,6,1
4775,91587,gGccjvdbrNrajnyHrtaox144rWbV1SPy,SpATywNh6bZuzm8s1ceuBUnMUAeoAHHw,14,31,15,21,7,3,6,0,83,11.857142857142858,3,0.0,4,15,18,7,27,3,3,6,0,44,39,0
4776,91598,7T9YIDVeH18g5BhUfy7opy4UBmEqkepp,bWdj2GDclj5ofokWjzoa5jAwMkxCykd6,2,0,0,0,0,0,3,0,3,0.42857142857142855,1,0.0,0,0,0,0,0,0,0,3,0,0,3,1
4777,92831,B2UTUKN3bAFFBRPjVt44lFW6bWnjSKKh,G8EPVSXsOYB5YQWZGiz1aVq5Pgr2GrQu,10,10,1,0,1,0,3,0,15,2.142857142857143,1,0.0,0,1,0,1,10,0,0,3,0,2,13,1
4778,92837,bUI06hErQBLCI8IpvZBPVsO5ApTPyNZ8,A3fsA9Zfv1X2fVEQhTw51lKENdNrEqT3,7,0,0,0,0,10,7,1,18,2.5714285714285716,1,0.0,0,0,0,0,0,10,0,7,1,0,18,1
4779,92842,5fh1jlCU7jXB4QIW6qiZqp3idmC7zGIG,SpATywNh6bZuzm8s1ceuBUnMUAeoAHHw,9,5,3,0,2,1,7,1,19,2.7142857142857144,2,0.0,0,3,0,2,5,1,0,7,1,5,14,1
4780,92850,Q2m4p3E1xU5tjACIAMpsbnVuTeuD9Zj8,bWdj2GDclj5ofokWjzoa5jAwMkxCykd6,17,32,2,78,4,11,14,1,142,20.285714285714285,2,0.0,3,2,75,4,29,11,3,14,1,84,58,1
4781,92858,PO9UqxqUlWjKdLcKUuvXjpBUsCJBV13h,SpATywNh6bZuzm8s1ceuBUnMUAeoAHHw,23,45,6,8,3,6,9,1,78,11.142857142857142,6,0.0,18,6,8,3,27,6,0,9,1,35,43,0
4782,92869,1WP7C2GzJDZRslYYccdoHTPh8lrMzeDB,G8EPVSXsOYB5YQWZGiz1aVq5Pgr2GrQu,22,25,14,26,10,4,15,3,97,13.857142857142858,3,0.0,7,14,25,10,18,4,1,15,3,56,41,1
4783,92883,TY1XSpzUxZYHUqU0tQYtstvuwKCsGYpR,G8EPVSXsOYB5YQWZGiz1aVq5Pgr2GrQu,55,52,35,6,25,22,20,2,162,23.142857142857142,4,0.0,8,35,3,25,44,22,3,20,2,71,91,1
4784,92918,k8Gwazobmq79kvZvGEmSVe54OgHin1Sn,bWdj2GDclj5ofokWjzoa5jAwMkxCykd6,1,0,0,0,0,0,1,0,1,0.14285714285714285,1,0.0,0,0,0,0,0,0,0,1,0,0,1,1
4785,92920,k8Gwazobmq79kvZvGEmSVe54OgHin1Sn,RXDvfPUBYFlVdlueBFbLW0mhhAyGEqpt,1,0,0,0,0,0,1,0,1,0.14285714285714285,1,0.0,0,0,0,0,0,0,0,1,0,0,1,1
4786,92927,xKVU4KxHH7yw4gLTDP7X9Lm3WXZQ3SDL,SpATywNh6bZuzm8s1ceuBUnMUAeoAHHw,7,6,1,0,1,0,1,0,9,1.2857142857142858,1,0.0,0,1,0,1,6,0,0,1,0,2,7,1
4787,92929,0Rhh8KlMvGRxFbePsrW63o0GE8JJ4ZBr,bWdj2GDclj5ofokWjzoa5jAwMkxCykd6,3,0,0,0,0,0,4,0,4,0.5714285714285714,2,0.0,0,0,0,0,0,0,0,4,0,0,4,1
4788,92942,erkNYBqLpKRElyeL8GeAgO43CMazg6Rt,SpATywNh6bZuzm8s1ceuBUnMUAeoAHHw,8,8,6,0,1,0,9,0,24,3.4285714285714284,2,0.0,0,6,0,1,8,0,0,9,0,7,17,1
4789,92943,9HqwJ8d4m6K7QOSGhF3dVzXYAYpOl0vj,RXDvfPUBYFlVdlueBFbLW0mhhAyGEqpt,20,27,11,0,8,0,4,0,50,7.142857142857143,2,0.0,0,11,0,8,27,0,0,4,0,19,31,1
4790,92946,bab14MPTgN4CshxZkY1kRnkvwuN9o8mj,SpATywNh6bZuzm8s1ceuBUnMUAeoAHHw,7,6,3,0,0,0,4,0,13,1.8571428571428572,1,0.0,0,3,0,0,6,0,0,4,0,3,10,1
4791,92994,NOoY36GVhU97rerOUVOIRgnbHjJMMwCG,G8EPVSXsOYB5YQWZGiz1aVq5Pgr2GrQu,4,3,0,0,0,0,2,0,5,0.7142857142857143,1,0.0,0,0,0,0,3,0,0,2,0,0,5,1
4792,93001,0lnyhqsWvNqdzPtTAPrrtxMTUBGxwge7,bWdj2GDclj5ofokWjzoa5jAwMkxCykd6,19,26,16,60,4,21,13,1,141,20.142857142857142,2,0.0,3,16,54,4,23,21,6,13,1,77,64,1
4793,93003,jX688Ad4bKlzkVM1SgNhwbdpN9xeTtmq,SpATywNh6bZuzm8s1ceuBUnMUAeoAHHw,7,3,2,0,2,0,2,0,9,1.2857142857142858,1,0.0,0,2,0,2,3,0,0,2,0,4,5,1
4794,93008,OdMr7dE5UlAme9Tp979vREBvY5CV50po,SpATywNh6bZuzm8s1ceuBUnMUAeoAHHw,28,35,17,21,7,0,12,0,92,13.142857142857142,7,0.0,5,17,19,7,30,0,2,12,0,48,44,0
4795,93018,bvvXbZgPtHbMGEZyEKJpOMNTPWYUJwvY,SpATywNh6bZuzm8s1ceuBUnMUAeoAHHw,1,0,0,0,0,0,1,0,1,0.14285714285714285,1,0.0,0,0,0,0,0,0,0,1,0,0,1,1
4796,93021,O2zNu3OLMNHq2ZjC3tlYs2TX12EEuIAG,bWdj2GDclj5ofokWjzoa5jAwMkxCykd6,13,39,21,60,15,18,14,1,168,24.0,4,0.0,8,21,58,15,31,18,2,14,1,102,66,0
4797,93031,4ihKyViABUcTrutAyMvzpqSavA9xsDnC,SpATywNh6bZuzm8s1ceuBUnMUAeoAHHw,14,13,10,0,7,0,2,0,32,4.571428571428571,2,0.0,1,10,0,7,12,0,0,2,0,18,14,1
4798,93036,m9qgZNgP3Zn0sGVjbTdK1WyVxg0SzTDj,SpATywNh6bZuzm8s1ceuBUnMUAeoAHHw,2,0,0,0,0,0,2,0,2,0.2857142857142857,1,0.0,0,0,0,0,0,0,0,2,0,0,2,1
4799,93045,WDD9a1qNUJX21r5OnYzYbe9snqA1PiYA,SpATywNh6bZuzm8s1ceuBUnMUAeoAHHw,10,11,9,0,5,0,5,0,30,4.285714285714286,2,0.0,0,9,0,5,11,0,0,5,0,14,16,1
4800,93046,0hRwE5vbowYRJTF6rcWCTgSh4yHA34bg,A3fsA9Zfv1X2fVEQhTw51lKENdNrEqT3,36,31,2,70,0,8,20,1,132,18.857142857142858,3,0.0,1,2,57,0,30,8,13,20,1,60,72,1
4801,93051,35QP8hkG1fMgJT5B2mWO7L1K5UDzKccP,RXDvfPUBYFlVdlueBFbLW0mhhAyGEqpt,1,0,0,0,0,0,1,0,1,0.14285714285714285,1,0.0,0,0,0,0,0,0,0,1,0,0,1,1
4802,93079,nVktdU2hPjrulp1NoJo2DLy3TGZQ0Uld,A3fsA9Zfv1X2fVEQhTw51lKENdNrEqT3,7,6,0,0,0,0,2,0,8,1.1428571428571428,1,0.0,0,0,0,0,6,0,0,2,0,0,8,0
4803,93100,FOMKrwD1FP5IWZmKryOBAWZkzJtszFo9,SpATywNh6bZuzm8s1ceuBUnMUAeoAHHw,6,3,2,0,1,0,4,0,10,1.4285714285714286,1,0.0,0,2,0,1,3,0,0,4,0,3,7,1
4804,93122,YYCI1ivPCDRa3x25VBUTnS1EqXk51k7P,SpATywNh6bZuzm8s1ceuBUnMUAeoAHHw,7,12,4,4,1,0,1,0,22,3.142857142857143,1,0.0,6,4,3,1,6,0,1,1,0,14,8,0
4805,93134,dtoXBrWvzofUQqyHToiF0PcYE9x06cjk,SpATywNh6bZuzm8s1ceuBUnMUAeoAHHw,13,16,7,0,3,1,9,1,37,5.285714285714286,2,0.0,2,7,0,3,14,1,0,9,1,12,25,1
4806,93138,qS74cvHEfXf7yNOdjRQHxs4K6Mb0fkmB,SpATywNh6bZuzm8s1ceuBUnMUAeoAHHw,5,5,3,0,0,0,7,0,15,2.142857142857143,1,0.0,0,3,0,0,5,0,0,7,0,3,12,1
4807,93146,ZBPGXZQPhYZwTG0U8gbjH8byD6eXCds5,SpATywNh6bZuzm8s1ceuBUnMUAeoAHHw,6,5,2,0,1,0,2,0,10,1.4285714285714286,1,0.0,0,2,0,1,5,0,0,2,0,3,7,1
4808,93155,nSGQJTGjP40uh7YNQd2M7oeyj4wFgY5k,SpATywNh6bZuzm8s1ceuBUnMUAeoAHHw,2,0,0,0,0,0,2,0,2,0.2857142857142857,1,0.0,0,0,0,0,0,0,0,2,0,0,2,1
4809,93172,9IDnKSSeA9OzPUrVvzlwiLBkpPo3uKJE,SpATywNh6bZuzm8s1ceuBUnMUAeoAHHw,11,14,9,0,6,0,12,2,43,6.142857142857143,1,0.0,0,9,0,6,14,0,0,12,2,15,28,1
4810,93195,ky5OAnymGB6zQeiaZNCLcaybyAjfTGVL,SpATywNh6bZuzm8s1ceuBUnMUAeoAHHw,15,22,8,11,2,12,9,0,64,9.142857142857142,1,0.0,11,8,10,2,11,12,1,9,0,31,33,1
4811,93201,tT3q39TssUZPXoxVdRzgRUu1SUheNubE,RXDvfPUBYFlVdlueBFbLW0mhhAyGEqpt,45,36,16,55,11,6,7,4,135,19.285714285714285,1,0.0,13,16,54,11,23,6,1,7,4,94,41,1
4812,93211,CANUVyVkYrlpItUerZN2eMCH6gNsEzSe,SpATywNh6bZuzm8s1ceuBUnMUAeoAHHw,12,16,2,0,1,0,10,3,32,4.571428571428571,3,0.0,0,2,0,1,16,0,0,10,3,3,29,1
4813,93219,fFsk9opmVFrs9gVmzPsOgmxgpsHLQliL,RXDvfPUBYFlVdlueBFbLW0mhhAyGEqpt,5,2,1,0,1,0,2,0,6,0.8571428571428571,1,0.0,0,1,0,1,2,0,0,2,0,2,4,1
4814,93227,ZBHFsE2c9ve1GkdeoBpHdlFbQkWYYfYc,A3fsA9Zfv1X2fVEQhTw51lKENdNrEqT3,4,5,1,0,0,0,2,0,8,1.1428571428571428,1,0.0,0,1,0,0,5,0,0,2,0,1,7,1
4815,93232,PoEjlZTjKWZ6BdoswaJwpEc5iphj2X1w,SpATywNh6bZuzm8s1ceuBUnMUAeoAHHw,1,0,0,0,0,0,1,0,1,0.14285714285714285,1,0.0,0,0,0,0,0,0,0,1,0,0,1,1
4816,93243,IsU1RKSKxT8SmvRzyXcC6emxRwMddmTJ,G8EPVSXsOYB5YQWZGiz1aVq5Pgr2GrQu,40,39,30,0,25,11,15,3,123,17.571428571428573,4,0.0,0,30,0,25,39,11,0,15,3,55,68,0
4817,93246,IAOTVxG7e06ArppQIZcVBCeppiZS52Zi,SpATywNh6bZuzm8s1ceuBUnMUAeoAHHw,10,7,2,0,2,1,7,1,20,2.857142857142857,2,0.0,0,2,0,2,7,1,0,7,1,4,16,1
4818,93271,RU7DM4q1MiWySLBD1tZoVnYmW4ZnJ0DL,RXDvfPUBYFlVdlueBFbLW0mhhAyGEqpt,1,0,0,0,0,0,1,0,1,0.14285714285714285,1,0.0,0,0,0,0,0,0,0,1,0,0,1,1
4819,93276,0e7xKBaDw3RmIMJpdHntjD8WC2jIp95k,SpATywNh6bZuzm8s1ceuBUnMUAeoAHHw,8,21,0,0,0,0,1,0,22,3.142857142857143,1,0.0,6,0,0,0,15,0,0,1,0,6,16,1
4820,93303,bHLTcAQFvIQJ6YaYh6r99cb370HZ5sPT,SpATywNh6bZuzm8s1ceuBUnMUAeoAHHw,1,0,0,0,0,0,1,0,1,0.14285714285714285,1,0.0,0,0,0,0,0,0,0,1,0,0,1,1
4821,93323,tyChfLhRWgtuzBYIo0LShbD6knUykDjv,G8EPVSXsOYB5YQWZGiz1aVq5Pgr2GrQu,23,14,10,66,6,11,8,1,116,16.571428571428573,1,0.0,4,10,56,6,10,11,10,8,1,76,40,1
4822,93330,HkYdxX3voGkfjdg703KviJnQhukKhxOh,G8EPVSXsOYB5YQWZGiz1aVq5Pgr2GrQu,1,0,0,0,0,0,2,0,2,0.2857142857142857,1,0.0,0,0,0,0,0,0,0,2,0,0,2,1
4823,93334,KFG6G55toGAeaWBt5UmyioW5n1NVxSjT,bWdj2GDclj5ofokWjzoa5jAwMkxCykd6,29,95,55,109,25,2,43,1,330,47.142857142857146,9,0.0,13,55,103,25,82,2,6,43,1,196,134,0
4824,93344,05Pe1SQ9Q2cBjcEFXjoLImyNIG21bK6A,RXDvfPUBYFlVdlueBFbLW0mhhAyGEqpt,2,0,0,0,0,0,2,0,2,0.2857142857142857,1,0.0,0,0,0,0,0,0,0,2,0,0,2,1
4825,93352,PR6nGGqGE6eMvOu04QC9agInMN1u3Vt7,A3fsA9Zfv1X2fVEQhTw51lKENdNrEqT3,23,16,14,0,13,0,3,0,46,6.571428571428571,1,0.0,0,14,0,13,16,0,0,3,0,27,19,1
4826,93367,hQNy1TJdPWXJGnnjdyetV1l4iHaSeol4,A3fsA9Zfv1X2fVEQhTw51lKENdNrEqT3,35,33,10,34,7,2,12,1,99,14.142857142857142,3,0.0,2,10,32,7,31,2,2,12,1,51,48,1
4827,93371,2XEzBTMWqAbDwimqhpYNFpmeQsMJgIYu,G8EPVSXsOYB5YQWZGiz1aVq5Pgr2GrQu,10,25,13,0,2,0,10,0,50,7.142857142857143,2,0.0,0,13,0,2,25,0,0,10,0,15,35,1
4828,93372,rdlkz4QUHd85FYWQkxx9tuSVm08spAcj,bWdj2GDclj5ofokWjzoa5jAwMkxCykd6,1,0,0,0,0,0,1,0,1,0.14285714285714285,1,0.0,0,0,0,0,0,0,0,1,0,0,1,1
4829,93389,CgiSBY8umD4OFxzPTCRENtvLfSjhJE4Q,A3fsA9Zfv1X2fVEQhTw51lKENdNrEqT3,1,0,0,0,0,0,1,0,1,0.14285714285714285,1,0.0,0,0,0,0,0,0,0,1,0,0,1,1
4830,93391,zFhrdwHMxq2geDsJ6rOF9PjKHNvVI11p,A3fsA9Zfv1X2fVEQhTw51lKENdNrEqT3,12,6,5,0,5,0,1,0,17,2.4285714285714284,1,0.0,0,5,0,5,6,0,0,1,0,10,7,1
4831,93394,grc1pAXqdUQaBlZrZyROqjuEtg08nen2,A3fsA9Zfv1X2fVEQhTw51lKENdNrEqT3,6,4,1,0,0,0,3,0,8,1.1428571428571428,1,0.0,0,1,0,0,4,0,0,3,0,1,7,0
4832,93398,EjONyt33Kb19bd7xhGUM8lVieVH4ABMt,SpATywNh6bZuzm8s1ceuBUnMUAeoAHHw,5,2,1,0,1,0,2,0,6,0.8571428571428571,1,0.0,0,1,0,1,2,0,0,2,0,2,4,1
4833,93406,wCSstPXY2jshjpNaBAQvMm9l3Kvl06VT,bWdj2GDclj5ofokWjzoa5jAwMkxCykd6,12,89,25,0,15,0,24,0,153,21.857142857142858,11,0.0,2,25,0,15,87,0,0,24,0,42,111,1
4834,93430,ThGblU6q4nWmu3ORXgM7eQc8q9vcBP4r,bWdj2GDclj5ofokWjzoa5jAwMkxCykd6,11,48,13,20,9,24,31,0,145,20.714285714285715,7,0.0,6,13,19,9,42,24,1,31,0,47,98,1
4835,93443,urLIpfHBZDaCypO84XCYKp0hFEe7SU3u,SpATywNh6bZuzm8s1ceuBUnMUAeoAHHw,1,0,0,0,0,0,1,0,1,0.14285714285714285,1,0.0,0,0,0,0,0,0,0,1,0,0,1,1
4836,93469,rBjcfaRB4ipdhdlaYne0HS9fWNfJaL2z,A3fsA9Zfv1X2fVEQhTw51lKENdNrEqT3,2,0,0,0,0,1,4,0,5,0.7142857142857143,1,0.0,0,0,0,0,0,1,0,4,0,0,5,1
4837,93474,lsFZ5c3HC6SK6E53cEs8WDQLHZpNYjV8,A3fsA9Zfv1X2fVEQhTw51lKENdNrEqT3,1,0,0,0,0,0,1,0,1,0.14285714285714285,1,0.0,0,0,0,0,0,0,0,1,0,0,1,1
4838,93502,rukBWzj11e0XTZm12B6q1NVFBvhUpKcw,A3fsA9Zfv1X2fVEQhTw51lKENdNrEqT3,34,22,0,44,0,1,5,0,72,10.285714285714286,1,0.0,2,0,41,0,20,1,3,5,0,43,29,1
4839,93508,ESEu5Ebb0Dwu6eqKhLWhzsorI0PztGwh,bWdj2GDclj5ofokWjzoa5jAwMkxCykd6,7,10,0,0,0,0,7,0,17,2.4285714285714284,1,0.0,0,0,0,0,10,0,0,7,0,0,17,1
4840,93516,dkuQt2AJ3psLoe6oAyOQ02agP8eEbROK,A3fsA9Zfv1X2fVEQhTw51lKENdNrEqT3,1,0,0,0,0,0,1,0,1,0.14285714285714285,1,0.0,0,0,0,0,0,0,0,1,0,0,1,1
4841,93532,d78tyy5GbLAmAIYTt0zQeNafrfAUEUnp,SpATywNh6bZuzm8s1ceuBUnMUAeoAHHw,1,0,0,0,0,0,1,0,1,0.14285714285714285,1,0.0,0,0,0,0,0,0,0,1,0,0,1,1
4842,93539,hZR4MwcYec4g0GoOyJFngJGEyWOySpv2,SpATywNh6bZuzm8s1ceuBUnMUAeoAHHw,23,56,37,10,23,23,31,0,180,25.714285714285715,6,0.0,7,37,8,23,49,23,2,31,0,75,105,0
4843,93540,uSL2RaFO9pFGmE8bYQrfyJmRnbBOdoyU,SpATywNh6bZuzm8s1ceuBUnMUAeoAHHw,15,19,0,17,0,31,6,1,74,10.571428571428571,1,0.0,2,0,15,0,17,31,2,6,1,17,57,1
4844,93541,ThGblU6q4nWmu3ORXgM7eQc8q9vcBP4r,SpATywNh6bZuzm8s1ceuBUnMUAeoAHHw,29,79,25,22,8,77,37,1,249,35.57142857142857,7,0.0,13,25,20,8,66,77,2,37,1,66,183,1
4845,93555,mG2KwufBG46hwF0tMEUG2jvsfUa3PSHf,SpATywNh6bZuzm8s1ceuBUnMUAeoAHHw,15,17,7,0,4,0,3,0,31,4.428571428571429,2,0.0,1,7,0,4,16,0,0,3,0,12,19,0
4846,93571,XqasR5GIfOx9ytwr0b8Q6Z12NNCt5pqh,bWdj2GDclj5ofokWjzoa5jAwMkxCykd6,6,4,2,0,2,0,3,0,11,1.5714285714285714,2,0.0,0,2,0,2,4,0,0,3,0,4,7,0
4847,93574,we9tWnySpl1G7k7FqyXPj8wmC2gUYK0W,bWdj2GDclj5ofokWjzoa5jAwMkxCykd6,1,0,0,0,0,0,1,0,1,0.14285714285714285,1,0.0,0,0,0,0,0,0,0,1,0,0,1,1
4848,93575,kRwbDFbRADlNU7lsdYCaasRGNiEpQeeP,SpATywNh6bZuzm8s1ceuBUnMUAeoAHHw,8,7,3,0,3,0,1,0,14,2.0,1,0.0,0,3,0,3,7,0,0,1,0,6,8,1
4849,93597,i0nkxYulaHR9i5zqaHNFQeOz0iG2pS8U,A3fsA9Zfv1X2fVEQhTw51lKENdNrEqT3,9,13,6,0,2,0,4,0,25,3.5714285714285716,2,0.0,0,6,0,2,13,0,0,4,0,8,17,0
4850,93611,mG2KwufBG46hwF0tMEUG2jvsfUa3PSHf,RXDvfPUBYFlVdlueBFbLW0mhhAyGEqpt,29,26,14,0,9,0,2,0,51,7.285714285714286,2,0.0,1,14,0,9,25,0,0,2,0,24,27,0
4851,93620,HJ2Te0AnFOdWtPQ1mbU0gvcfD3BsPlu2,SpATywNh6bZuzm8s1ceuBUnMUAeoAHHw,23,40,24,8,6,13,19,1,111,15.857142857142858,5,0.0,6,24,8,6,34,13,0,19,1,44,67,0
4852,93625,MrZt24U8nbuIX2mCMw4lqKt5FUFOZURE,SpATywNh6bZuzm8s1ceuBUnMUAeoAHHw,1,0,0,0,0,0,1,0,1,0.14285714285714285,1,0.0,0,0,0,0,0,0,0,1,0,0,1,1
4853,93626,ae9lMjY6PaxC3JKoLUmKZvfdwEZiOBPx,G8EPVSXsOYB5YQWZGiz1aVq5Pgr2GrQu,5,2,1,0,1,0,2,0,6,0.8571428571428571,1,0.0,0,1,0,1,2,0,0,2,0,2,4,1
4854,93639,Pd0CZHVPAay5ceQzChjGxlgmgiQ8cqjG,G8EPVSXsOYB5YQWZGiz1aVq5Pgr2GrQu,5,2,1,0,1,0,4,0,8,1.1428571428571428,1,0.0,0,1,0,1,2,0,0,4,0,2,6,1
4855,93645,Qbhh4psghTMTs2MbZkpJwwkpxbM26vfP,SpATywNh6bZuzm8s1ceuBUnMUAeoAHHw,4,0,0,0,0,0,3,2,5,0.7142857142857143,1,0.0,0,0,0,0,0,0,0,3,2,0,5,1
4856,93657,QO30UexmdD88uyPYe6YK3wSk3JLKQBe3,A3fsA9Zfv1X2fVEQhTw51lKENdNrEqT3,8,2,1,0,1,1,10,1,16,2.2857142857142856,2,0.0,0,1,0,1,2,1,0,10,1,2,14,1
4857,93659,F731sqjciH519ML4GCaVvNQuuR5Oaq9t,A3fsA9Zfv1X2fVEQhTw51lKENdNrEqT3,4,2,1,0,1,0,2,0,6,0.8571428571428571,1,0.0,0,1,0,1,2,0,0,2,0,2,4,1
4858,93679,ju4nY4FL2KNi1hifJCQn8sVUqJICxh4O,SpATywNh6bZuzm8s1ceuBUnMUAeoAHHw,23,24,11,34,5,0,8,0,82,11.714285714285714,3,0.0,4,11,29,5,20,0,5,8,0,49,33,1
4859,93686,pXBkDxIpO7cvN4HkForKspl0UN1aLwbn,A3fsA9Zfv1X2fVEQhTw51lKENdNrEqT3,1,0,0,0,0,0,1,0,1,0.14285714285714285,1,0.0,0,0,0,0,0,0,0,1,0,0,1,1
4860,93689,KXi2lu4GlKmrO1lJTLg3t4l701rvNXNZ,A3fsA9Zfv1X2fVEQhTw51lKENdNrEqT3,71,46,29,102,17,9,24,3,230,32.857142857142854,10,0.0,7,29,93,17,39,9,9,24,3,146,84,0
4861,93702,5JlWaFjebQSvyUeyQLJ4C0BlriWkf8Hy,SpATywNh6bZuzm8s1ceuBUnMUAeoAHHw,17,27,2,17,3,0,5,0,54,7.714285714285714,3,0.0,15,2,15,3,12,0,2,5,0,35,19,1
4862,93706,OCOZunZP01no4Zh4NYF1FDXoOWZrc1Yv,G8EPVSXsOYB5YQWZGiz1aVq5Pgr2GrQu,16,14,4,0,5,1,8,1,33,4.714285714285714,1,0.0,6,4,0,5,8,1,0,8,1,15,18,1
4863,93724,VvbZjK8y9aernnsSHvAW377h2uAEkOuF,SpATywNh6bZuzm8s1ceuBUnMUAeoAHHw,6,0,0,0,0,1,5,1,7,1.0,1,0.0,0,0,0,0,0,1,0,5,1,0,7,1
4864,93748,qYBrztNE2m7Kv5jO5Me3GoAEoNnGgBEu,G8EPVSXsOYB5YQWZGiz1aVq5Pgr2GrQu,10,13,3,0,2,5,13,2,38,5.428571428571429,1,0.0,3,3,0,2,10,5,0,13,2,8,30,1
4865,93749,jqfntS6RKR0gZFQrp9eaCMToaEgoc2Xi,SpATywNh6bZuzm8s1ceuBUnMUAeoAHHw,1,0,0,0,0,0,1,0,1,0.14285714285714285,1,0.0,0,0,0,0,0,0,0,1,0,0,1,1
4866,93753,fCj90D5XHmebJ0IrbbuHaVfcb7tqMxkl,bWdj2GDclj5ofokWjzoa5jAwMkxCykd6,28,153,48,46,28,2,27,1,305,43.57142857142857,6,0.0,36,48,38,28,117,2,8,27,1,150,155,1
4867,93815,F7cOObRHTu5td8ezD8oRze1BhvyOKDSk,SpATywNh6bZuzm8s1ceuBUnMUAeoAHHw,8,6,3,0,1,0,2,0,12,1.7142857142857142,1,0.0,2,3,0,1,4,0,0,2,0,6,6,1
4868,93825,mEXFRacWKZUZ0ZrkucFcb0mHAIpc1jKZ,G8EPVSXsOYB5YQWZGiz1aVq5Pgr2GrQu,6,3,0,0,1,1,2,0,7,1.0,1,0.0,0,0,0,1,3,1,0,2,0,1,6,1
4869,93827,qKm0x9dl3CcMx4vyQxKmKiMsD63vzUte,bWdj2GDclj5ofokWjzoa5jAwMkxCykd6,1,0,0,0,0,0,1,0,1,0.14285714285714285,1,0.0,0,0,0,0,0,0,0,1,0,0,1,1
4870,93829,O9HNCpYyjeUf5Yv9cKak2CowRvtq7CSH,SpATywNh6bZuzm8s1ceuBUnMUAeoAHHw,12,16,9,0,4,0,12,1,42,6.0,3,0.0,1,9,0,4,15,0,0,12,1,14,28,1
4871,93832,60ov46MOFnBiXMZrd5NKEQiqC0SiurVf,A3fsA9Zfv1X2fVEQhTw51lKENdNrEqT3,9,9,1,0,1,0,7,0,18,2.5714285714285716,2,0.0,0,1,0,1,9,0,0,7,0,2,16,1
4872,93836,b3eTIICIpBOeQwbL52WcSz5BKSnmXD5x,SpATywNh6bZuzm8s1ceuBUnMUAeoAHHw,10,6,4,0,2,0,6,1,19,2.7142857142857144,1,0.0,0,4,0,2,6,0,0,6,1,6,13,1
4873,93838,fkbxkXpN20umRnEu1JAMVCW41OYjb7dl,A3fsA9Zfv1X2fVEQhTw51lKENdNrEqT3,6,3,1,0,0,1,5,0,10,1.4285714285714286,1,0.0,0,1,0,0,3,1,0,5,0,1,9,1
4874,93874,mSs5bB1Rxg3xYWjWjJY9pVTt7WAiMgyu,SpATywNh6bZuzm8s1ceuBUnMUAeoAHHw,9,19,10,0,3,34,24,0,90,12.857142857142858,4,0.0,0,10,0,3,19,34,0,24,0,13,77,0
4875,93877,SjBgrEi81Cf6wmEgkI03BQFCuncsAECU,SpATywNh6bZuzm8s1ceuBUnMUAeoAHHw,4,0,0,0,0,0,4,0,4,0.5714285714285714,1,0.0,0,0,0,0,0,0,0,4,0,0,4,0
4876,93909,5Ikem26Scse18GVLkwyf1cheWsOPE25C,SpATywNh6bZuzm8s1ceuBUnMUAeoAHHw,8,5,3,0,2,0,3,0,13,1.8571428571428572,2,0.0,0,3,0,2,5,0,0,3,0,5,8,1
4877,93912,EicwSyKru5cUE8FbnBvU3nlCh4zs6SDU,SpATywNh6bZuzm8s1ceuBUnMUAeoAHHw,1,0,0,0,0,0,1,0,1,0.14285714285714285,1,0.0,0,0,0,0,0,0,0,1,0,0,1,1
4878,93943,oNQaCuO2rlrLriXUbP7yibkLZ8kZEP0A,SpATywNh6bZuzm8s1ceuBUnMUAeoAHHw,13,11,5,12,3,0,2,0,33,4.714285714285714,2,0.0,2,5,12,3,9,0,0,2,0,22,11,1
4879,93964,0bPKxjIIw0GaiIYeAS2yIr8ZqMELBNL4,RXDvfPUBYFlVdlueBFbLW0mhhAyGEqpt,5,6,4,0,0,0,2,0,12,1.7142857142857142,2,0.0,0,4,0,0,6,0,0,2,0,4,8,0
4880,93996,xV4buLLcPPEcE2C8BKOwlQiGdSlriMdM,RXDvfPUBYFlVdlueBFbLW0mhhAyGEqpt,1,0,0,0,0,0,3,0,3,0.42857142857142855,2,0.0,0,0,0,0,0,0,0,3,0,0,3,1
4881,94003,aj6uF4XWV3XUUfOpWCk3NuntI2wXym6n,A3fsA9Zfv1X2fVEQhTw51lKENdNrEqT3,9,10,0,0,0,0,18,1,29,4.142857142857143,2,0.0,1,0,0,0,9,0,0,18,1,1,28,1
4882,94042,75ii7mb7d3VTc7Qrw6mG6DwTa15X98oH,SpATywNh6bZuzm8s1ceuBUnMUAeoAHHw,4,5,2,0,0,0,2,0,9,1.2857142857142858,1,0.0,0,2,0,0,5,0,0,2,0,2,7,0
4883,94044,t88wfrSqhn6m3ghlAqrTBAHAFrsZ2sxt,bWdj2GDclj5ofokWjzoa5jAwMkxCykd6,10,8,4,0,2,15,12,0,41,5.857142857142857,2,0.0,0,4,0,2,8,15,0,12,0,6,35,1
4884,94053,x5ZyS8ChPKTwgxrKWhGeApVsRxKYNf86,bWdj2GDclj5ofokWjzoa5jAwMkxCykd6,1,0,0,0,0,0,1,0,1,0.14285714285714285,1,0.0,0,0,0,0,0,0,0,1,0,0,1,1
4885,94054,nNPe0gYBpuLKMy034NoRKs4SMhD1YQxV,G8EPVSXsOYB5YQWZGiz1aVq5Pgr2GrQu,12,7,6,0,5,0,2,0,20,2.857142857142857,1,0.0,0,6,0,5,7,0,0,2,0,11,9,1
4886,94055,OK36i7c8u9GmSfG9DXL0YN94pRFkcmzE,SpATywNh6bZuzm8s1ceuBUnMUAeoAHHw,16,19,10,12,3,1,6,0,51,7.285714285714286,2,0.0,4,10,11,3,15,1,1,6,0,28,23,1
4887,94073,60AYcG1Aqq07FBEqNwevaiEWsxsSm68V,SpATywNh6bZuzm8s1ceuBUnMUAeoAHHw,18,31,12,6,4,39,15,1,108,15.428571428571429,3,0.0,8,12,6,4,23,39,0,15,1,30,78,1
4888,94075,8msGv7I17o9HQpLUg1Ukk6N7MNl4HPMn,A3fsA9Zfv1X2fVEQhTw51lKENdNrEqT3,5,3,0,0,0,0,5,0,8,1.1428571428571428,1,0.0,1,0,0,0,2,0,0,5,0,1,7,1
4889,94105,Crjc5H6MpWbzy0UxdiisUjbxslQAKkU9,SpATywNh6bZuzm8s1ceuBUnMUAeoAHHw,16,24,9,10,4,2,8,1,58,8.285714285714286,2,0.0,9,9,9,4,15,2,1,8,1,31,27,0
4890,94112,DHDCrD1ELgYhngP3vqwv1nXGZcmsEo8S,G8EPVSXsOYB5YQWZGiz1aVq5Pgr2GrQu,1,0,0,0,0,0,1,0,1,0.14285714285714285,1,0.0,0,0,0,0,0,0,0,1,0,0,1,1
4891,94115,uCjPUqEQP5ztmFjHYApjKLEWGDYVXats,bWdj2GDclj5ofokWjzoa5jAwMkxCykd6,4,2,1,0,0,0,3,0,6,0.8571428571428571,1,0.0,0,1,0,0,2,0,0,3,0,1,5,1
4892,94117,dW2So4dhz8sFwZQzndBoTpsFa69MFo0q,SpATywNh6bZuzm8s1ceuBUnMUAeoAHHw,15,16,9,12,2,1,5,1,46,6.571428571428571,1,0.0,5,9,11,2,11,1,1,5,1,27,19,1
4893,94123,u3SPm1HFwlhJpJKaAvQIjwvJr5QcuOph,SpATywNh6bZuzm8s1ceuBUnMUAeoAHHw,5,2,1,0,1,0,2,0,6,0.8571428571428571,1,0.0,0,1,0,1,2,0,0,2,0,2,4,1
4894,94137,DHDCrD1ELgYhngP3vqwv1nXGZcmsEo8S,SpATywNh6bZuzm8s1ceuBUnMUAeoAHHw,1,0,0,0,0,0,2,0,2,0.2857142857142857,1,0.0,0,0,0,0,0,0,0,2,0,0,2,1
4895,94144,uJQbjSAUKl9mATLkoLUgrR5h8oVXq5wA,bWdj2GDclj5ofokWjzoa5jAwMkxCykd6,7,2,1,0,1,0,5,2,11,1.5714285714285714,1,0.0,0,1,0,1,2,0,0,5,2,2,9,1
4896,94146,kvf1WFygeLGKOFkoertca6J9TDxV9fcY,bWdj2GDclj5ofokWjzoa5jAwMkxCykd6,8,9,6,10,6,0,1,0,32,4.571428571428571,2,0.0,1,6,8,6,8,0,2,1,0,21,11,1
4897,94147,kvf1WFygeLGKOFkoertca6J9TDxV9fcY,A3fsA9Zfv1X2fVEQhTw51lKENdNrEqT3,10,7,6,0,6,0,1,0,20,2.857142857142857,2,0.0,0,6,0,6,7,0,0,1,0,12,8,1
4898,94165,SoWAM0SsQFATkJWX6mveBwbG0XzudUfF,RXDvfPUBYFlVdlueBFbLW0mhhAyGEqpt,6,3,2,0,1,0,3,0,9,1.2857142857142858,1,0.0,0,2,0,1,3,0,0,3,0,3,6,1
4899,94182,iFoaVRNiF8fcNT1I1ii4FKoAviHvnVwj,SpATywNh6bZuzm8s1ceuBUnMUAeoAHHw,1,0,0,0,0,0,1,0,1,0.14285714285714285,1,0.0,0,0,0,0,0,0,0,1,0,0,1,1
4900,94188,OFXXpJjmXQdJCa3neipnRUGCkhEYKOcL,SpATywNh6bZuzm8s1ceuBUnMUAeoAHHw,7,6,1,0,0,0,3,0,10,1.4285714285714286,1,0.0,0,1,0,0,6,0,0,3,0,1,9,0
4901,94196,BZpQDGkWvmHTN4poCEi9fdZmAWn1G3Rj,RXDvfPUBYFlVdlueBFbLW0mhhAyGEqpt,11,8,7,0,7,0,5,0,27,3.857142857142857,1,0.0,0,7,0,7,8,0,0,5,0,14,13,1
4902,94201,68BjCXfBFqeZ01fFx1csrFmvef5xs0w2,A3fsA9Zfv1X2fVEQhTw51lKENdNrEqT3,5,2,1,0,1,0,3,0,7,1.0,1,0.0,0,1,0,1,2,0,0,3,0,2,5,1
4903,94216,4cB4y17zVi4jfdrlreMIHGN1aQJHMMST,A3fsA9Zfv1X2fVEQhTw51lKENdNrEqT3,4,2,0,0,0,0,2,0,4,0.5714285714285714,1,0.0,0,0,0,0,2,0,0,2,0,0,4,1
4904,94230,dW2So4dhz8sFwZQzndBoTpsFa69MFo0q,A3fsA9Zfv1X2fVEQhTw51lKENdNrEqT3,1,0,0,0,0,0,1,0,1,0.14285714285714285,1,0.0,0,0,0,0,0,0,0,1,0,0,1,1
4905,94238,Zy1VvDhL0b8E5oL4KNZb2wbF72hVCk4q,bWdj2GDclj5ofokWjzoa5jAwMkxCykd6,1,0,0,0,0,0,1,0,1,0.14285714285714285,1,0.0,0,0,0,0,0,0,0,1,0,0,1,1
4906,94250,hhHp518gAY3TOdaw37KX2gsPHN1LkpFC,G8EPVSXsOYB5YQWZGiz1aVq5Pgr2GrQu,7,6,1,0,2,0,2,0,11,1.5714285714285714,1,0.0,2,1,0,2,4,0,0,2,0,5,6,1
4907,94252,jKLLTSaN1oSiVcsyuWIwr9NVnuZSs3oX,A3fsA9Zfv1X2fVEQhTw51lKENdNrEqT3,5,4,2,0,1,0,3,0,10,1.4285714285714286,1,0.0,0,2,0,1,4,0,0,3,0,3,7,1
4908,94254,r9IhUgJi3OB3rtBncFGHCU1M0fOjKF1s,SpATywNh6bZuzm8s1ceuBUnMUAeoAHHw,14,20,8,17,4,0,2,0,51,7.285714285714286,2,0.0,10,8,15,4,10,0,2,2,0,37,14,1
4909,94263,9BiLYY350hgtHO5tL7nbMfcZU0JcfZbs,A3fsA9Zfv1X2fVEQhTw51lKENdNrEqT3,7,7,2,0,1,0,6,0,16,2.2857142857142856,2,0.0,2,2,0,1,5,0,0,6,0,5,11,1
4910,94275,gxKNGjI9pNbjjsMSjrRysbX0ykCNYwqn,bWdj2GDclj5ofokWjzoa5jAwMkxCykd6,4,3,1,0,1,0,1,0,6,0.8571428571428571,1,0.0,0,1,0,1,3,0,0,1,0,2,4,1
4911,94283,PSQvTxj1y3we6BHzfg47qDUvmFQLocrD,A3fsA9Zfv1X2fVEQhTw51lKENdNrEqT3,1,0,0,0,0,0,1,0,1,0.14285714285714285,1,0.0,0,0,0,0,0,0,0,1,0,0,1,1
4912,94300,5Lcwdb3Myw57AK6P9mHbDDRptSFCTb8f,A3fsA9Zfv1X2fVEQhTw51lKENdNrEqT3,11,5,4,0,4,0,5,0,18,2.5714285714285716,1,0.0,0,4,0,4,5,0,0,5,0,8,10,1
4913,94311,Gl03eSeNtb7juYcfyy4T6xQkEEhQalIx,SpATywNh6bZuzm8s1ceuBUnMUAeoAHHw,10,10,3,14,2,0,1,0,30,4.285714285714286,3,0.0,2,3,10,2,8,0,4,1,0,17,13,1
4914,94322,7CHeHg2oDOu9Zq2LKINtBF6E413tCv88,SpATywNh6bZuzm8s1ceuBUnMUAeoAHHw,9,8,3,0,3,0,6,0,20,2.857142857142857,2,0.0,0,3,0,3,8,0,0,6,0,6,14,1
4915,94328,plAreEiDkQpc8zc9xmMhqujDBy2S6jmC,SpATywNh6bZuzm8s1ceuBUnMUAeoAHHw,13,59,12,9,2,0,20,0,102,14.571428571428571,3,0.0,0,12,7,2,59,0,2,20,0,21,81,1
4916,94331,MreMBBpkQsLa4FQRsMj3EyXahyuFtEaB,SpATywNh6bZuzm8s1ceuBUnMUAeoAHHw,1,0,0,0,0,0,1,0,1,0.14285714285714285,1,0.0,0,0,0,0,0,0,0,1,0,0,1,1
4917,94358,9aS1NSJb2Hj0xHbbuoyhLmktYrjypxsy,G8EPVSXsOYB5YQWZGiz1aVq5Pgr2GrQu,38,31,12,96,7,0,8,1,155,22.142857142857142,2,0.0,18,12,70,7,13,0,26,8,1,107,48,1
4918,94376,uJRuDDw60tHrnuGJQZHSpoPAWASu6Wpf,SpATywNh6bZuzm8s1ceuBUnMUAeoAHHw,1,0,0,0,0,0,1,0,1,0.14285714285714285,1,0.0,0,0,0,0,0,0,0,1,0,0,1,0
4919,94382,au8A4X0QHQjQtIJwXFEgDKJdutxB5gYJ,SpATywNh6bZuzm8s1ceuBUnMUAeoAHHw,1,0,0,0,0,0,1,0,1,0.14285714285714285,1,0.0,0,0,0,0,0,0,0,1,0,0,1,1
4920,94383,OEUelCFKE8Wek74t5oKIe6H8MCi9M5Fi,RXDvfPUBYFlVdlueBFbLW0mhhAyGEqpt,1,0,0,0,0,0,1,0,1,0.14285714285714285,1,0.0,0,0,0,0,0,0,0,1,0,0,1,1
4921,94407,vCP75aDcEh5tNmLpxZodjHI02YfPV1g7,SpATywNh6bZuzm8s1ceuBUnMUAeoAHHw,2,0,0,0,0,0,8,0,8,1.1428571428571428,3,0.0,0,0,0,0,0,0,0,8,0,0,8,1
4922,94408,kdTkyJM1xm4AQ2tXVSlZpNtOhQ8qhZ4V,SpATywNh6bZuzm8s1ceuBUnMUAeoAHHw,7,11,6,0,3,0,5,0,25,3.5714285714285716,4,0.0,0,6,0,3,11,0,0,5,0,9,16,0
4923,94410,nTOZ6H8wygvPupRg4OwxXR9Zcu1XdDxE,RXDvfPUBYFlVdlueBFbLW0mhhAyGEqpt,1,0,0,0,0,0,1,0,1,0.14285714285714285,1,0.0,0,0,0,0,0,0,0,1,0,0,1,1
4924,94435,ZYJOgN8hxER8FBZMxsFqu3ZMgr4hrlRX,A3fsA9Zfv1X2fVEQhTw51lKENdNrEqT3,8,8,1,0,1,0,6,0,16,2.2857142857142856,1,0.0,0,1,0,1,8,0,0,6,0,2,14,1
4925,94443,FZWt1vapJFvo3kXFvlr3Pcq5dqSsXIdl,SpATywNh6bZuzm8s1ceuBUnMUAeoAHHw,29,41,24,31,11,8,11,5,131,18.714285714285715,4,0.0,9,24,28,11,32,8,3,11,5,72,59,1
4926,94449,YxWG3o8ByCvMoGHw8Fk45RhqzVf3tFyr,A3fsA9Zfv1X2fVEQhTw51lKENdNrEqT3,6,1,1,0,1,0,3,0,6,0.8571428571428571,1,0.0,0,1,0,1,1,0,0,3,0,2,4,1
4927,94454,HH9Roah3kzSupaHq1oHsqsjNMJy1K6WP,SpATywNh6bZuzm8s1ceuBUnMUAeoAHHw,6,8,1,0,1,0,2,0,12,1.7142857142857142,1,0.0,0,1,0,1,8,0,0,2,0,2,10,1
4928,94456,Yanv54bl6PB6cYN02rxbrTLlDFz7wAgw,A3fsA9Zfv1X2fVEQhTw51lKENdNrEqT3,2,0,0,0,0,0,2,0,2,0.2857142857142857,1,0.0,0,0,0,0,0,0,0,2,0,0,2,1
4929,94463,1dYxxqjVQ41eWA49zU6M54bp0RizbhKR,SpATywNh6bZuzm8s1ceuBUnMUAeoAHHw,6,5,3,0,1,0,3,0,12,1.7142857142857142,1,0.0,0,3,0,1,5,0,0,3,0,4,8,1
4930,94464,VvCLt24WQ5JOcwPfT9E7uWcGIgf1BHix,SpATywNh6bZuzm8s1ceuBUnMUAeoAHHw,14,15,10,14,5,2,3,0,49,7.0,1,0.0,3,10,11,5,12,2,3,3,0,29,20,1
4931,94486,gl2YVlebVAvCcxsYaIoTwLj5l1IGqntH,SpATywNh6bZuzm8s1ceuBUnMUAeoAHHw,20,40,20,27,0,0,6,0,93,13.285714285714286,4,0.0,14,20,26,0,26,0,1,6,0,60,33,0
4932,94496,We4HBkPE9Li2HHwmAADy328h9IORRs2l,G8EPVSXsOYB5YQWZGiz1aVq5Pgr2GrQu,1,0,0,0,0,0,1,0,1,0.14285714285714285,1,0.0,0,0,0,0,0,0,0,1,0,0,1,1
4933,94914,JdoyFe3ty0dkGc2UNdH7TaneDWe8Wbb5,fbPkOYLVPtPgIt0MxizjfFJov3JbHyAi,4,2,1,0,1,0,2,0,6,0.8571428571428571,2,0.0,0,1,0,1,2,0,0,2,0,2,4,1
4934,94917,GGhAGkRWD8jJVxrhUk5siJ00MzWLACx9,fbPkOYLVPtPgIt0MxizjfFJov3JbHyAi,2,0,0,0,0,0,3,0,3,0.42857142857142855,1,0.0,0,0,0,0,0,0,0,3,0,0,3,1
4935,94918,kWBY2KD53mjK2UMWhmo4HB3TIG4iJtfA,fbPkOYLVPtPgIt0MxizjfFJov3JbHyAi,11,7,4,6,4,0,3,0,24,3.4285714285714284,1,0.0,2,4,5,4,5,0,1,3,0,15,9,1
4936,94919,nLVkMUicIATb5XjlrKkVLbPcf3PrrUv6,fbPkOYLVPtPgIt0MxizjfFJov3JbHyAi,6,3,2,0,1,0,2,0,8,1.1428571428571428,1,0.0,0,2,0,1,3,0,0,2,0,3,5,1
4937,94920,AP8Ylu2Hp0YwQapv0VHVFwlhcyAdQlKm,fbPkOYLVPtPgIt0MxizjfFJov3JbHyAi,5,2,1,0,1,2,2,0,8,1.1428571428571428,1,0.0,0,1,0,1,2,2,0,2,0,2,6,1
4938,94921,1befQ3fLzEOh8IrvCOjGmYb6nrbCw6Ba,fbPkOYLVPtPgIt0MxizjfFJov3JbHyAi,3,0,0,0,0,0,5,0,5,0.7142857142857143,1,0.0,0,0,0,0,0,0,0,5,0,0,5,1
4939,94922,21C2qWSN1ubnQXVLo4VQ89cKYqN6OnV0,fbPkOYLVPtPgIt0MxizjfFJov3JbHyAi,5,2,1,0,1,0,3,0,7,1.0,1,0.0,0,1,0,1,2,0,0,3,0,2,5,1
4940,94923,ZSOqN2ncEDCf8kkfE2fTiwunpGip3a3v,fbPkOYLVPtPgIt0MxizjfFJov3JbHyAi,6,3,2,0,2,0,2,0,9,1.2857142857142858,1,0.0,0,2,0,2,3,0,0,2,0,4,5,1
4941,94924,iPQOLnMFMpAtiKO2f4vUT5fNNyluHmyN,fbPkOYLVPtPgIt0MxizjfFJov3JbHyAi,1,0,0,0,0,0,1,0,1,0.14285714285714285,1,0.0,0,0,0,0,0,0,0,1,0,0,1,1
4942,94928,rrKLV6p6Omqho3GHHSoh0noB8Eyb4dBf,fbPkOYLVPtPgIt0MxizjfFJov3JbHyAi,8,3,2,0,2,3,6,1,17,2.4285714285714284,1,0.0,0,2,0,2,3,3,0,6,1,4,13,1
4943,94929,rrZSZFoEgH3bOKdkZ0UyNzOq7Pdyx5G0,fbPkOYLVPtPgIt0MxizjfFJov3JbHyAi,2,0,0,0,0,0,2,0,2,0.2857142857142857,1,0.0,0,0,0,0,0,0,0,2,0,0,2,1
4944,94930,m81QFtDkjk8PmvblUhrkX50T3OfNUlpC,fbPkOYLVPtPgIt0MxizjfFJov3JbHyAi,1,0,0,0,0,0,1,0,1,0.14285714285714285,1,0.0,0,0,0,0,0,0,0,1,0,0,1,1
4945,94931,YLWMEkP67YDwtagmvU5WKcZzKqdf99Vy,fbPkOYLVPtPgIt0MxizjfFJov3JbHyAi,7,5,2,0,1,0,4,0,12,1.7142857142857142,1,0.0,0,2,0,1,5,0,0,4,0,3,9,1
4946,94934,53AX9rmI3k6LH6bFgA3smsUSiak9PiH8,fbPkOYLVPtPgIt0MxizjfFJov3JbHyAi,9,15,5,5,2,1,3,0,31,4.428571428571429,1,0.0,3,5,5,2,12,1,0,3,0,15,16,1
4947,94938,ATZ830ERUxX8pXsrEHiyTC9qIj0J3xKL,fbPkOYLVPtPgIt0MxizjfFJov3JbHyAi,1,0,0,0,0,0,1,0,1,0.14285714285714285,1,0.0,0,0,0,0,0,0,0,1,0,0,1,1
4948,94941,PksTe80EnSZRP5IgVxGPpb2S7NuUyS61,fbPkOYLVPtPgIt0MxizjfFJov3JbHyAi,8,8,6,0,5,0,5,0,24,3.4285714285714284,1,0.0,0,6,0,5,8,0,0,5,0,11,13,1
4949,94943,2slXWNniikORlDrKt6rdY1XwdvOyFwgH,fbPkOYLVPtPgIt0MxizjfFJov3JbHyAi,6,3,2,0,2,0,1,0,8,1.1428571428571428,1,0.0,0,2,0,2,3,0,0,1,0,4,4,1
4950,94946,7uAP6PCGaUrEF1zOYcYy8DKDCb9pFsmY,fbPkOYLVPtPgIt0MxizjfFJov3JbHyAi,26,82,17,36,23,31,17,3,209,29.857142857142858,3,0.0,34,17,30,23,48,31,6,17,3,104,105,1
4951,94950,uf9uxJ0q9fqnk8v2mIZk18f6DfpdKvW8,fbPkOYLVPtPgIt0MxizjfFJov3JbHyAi,8,5,3,0,2,0,3,0,13,1.8571428571428572,1,0.0,0,3,0,2,5,0,0,3,0,5,8,1
4952,95305,NzceHZYafdRYNlSM9Nht2IC1aPdIvfsS,G8EPVSXsOYB5YQWZGiz1aVq5Pgr2GrQu,7,6,4,2,0,0,1,0,13,1.8571428571428572,1,0.0,1,4,1,0,5,0,1,1,0,6,7,1
4953,95313,qosnWICleDjB0mAqFG1weKjFjwPkMIbX,SpATywNh6bZuzm8s1ceuBUnMUAeoAHHw,12,9,7,0,4,0,4,0,24,3.4285714285714284,1,0.0,0,7,0,4,9,0,0,4,0,11,13,1
4954,95361,Djs1zlGGz9CjaytXVMiGNIbCd4ODEdqG,A3fsA9Zfv1X2fVEQhTw51lKENdNrEqT3,3,0,0,0,0,0,3,0,3,0.42857142857142855,1,0.0,0,0,0,0,0,0,0,3,0,0,3,1
4955,95383,ZHBg1MltX3XrB2nTtco0amjezusVv1FZ,bWdj2GDclj5ofokWjzoa5jAwMkxCykd6,4,3,1,0,1,0,1,0,6,0.8571428571428571,1,0.0,0,1,0,1,3,0,0,1,0,2,4,1
4956,95384,9vMfKHFzhvmzdCBc05dqw5icnEdTUd5x,bWdj2GDclj5ofokWjzoa5jAwMkxCykd6,38,95,43,89,13,4,27,0,271,38.714285714285715,5,0.0,16,43,80,13,79,4,9,27,0,152,119,1
4957,95386,lVwgv61cg8fkhW9rg5b1PIPnuUWxb0Vk,A3fsA9Zfv1X2fVEQhTw51lKENdNrEqT3,53,52,36,76,18,276,59,11,528,75.42857142857143,13,0.0,4,36,58,18,48,276,18,59,11,116,412,0
4958,95388,WVU6lNV4yCEYBx8BfYMKeJgO2PfYQmk7,bWdj2GDclj5ofokWjzoa5jAwMkxCykd6,25,13,0,40,0,0,6,1,60,8.571428571428571,1,0.0,7,0,37,0,6,0,3,6,1,44,16,1
4959,95397,aFMNRUeRxFSXjv2yTdRuJu4lTCyXCFDD,bWdj2GDclj5ofokWjzoa5jAwMkxCykd6,4,2,1,0,1,1,3,0,8,1.1428571428571428,1,0.0,0,1,0,1,2,1,0,3,0,2,6,1
4960,95398,SM6SmE3aMr36NQr3MbQQW1aFlehpkSNf,bWdj2GDclj5ofokWjzoa5jAwMkxCykd6,2,0,0,0,0,0,4,0,4,0.5714285714285714,2,0.0,0,0,0,0,0,0,0,4,0,0,4,1
4961,95399,Id4UmIRRQiLXHoJYSjh5OCO1CRaFgQ2K,A3fsA9Zfv1X2fVEQhTw51lKENdNrEqT3,41,43,20,76,17,2,4,0,162,23.142857142857142,1,0.0,1,20,59,17,42,2,17,4,0,97,65,1
4962,95408,OdsEBh425XZxll0hTUv04OAotDf6aGtE,RXDvfPUBYFlVdlueBFbLW0mhhAyGEqpt,7,13,7,0,3,0,1,0,24,3.4285714285714284,1,0.0,0,7,0,3,13,0,0,1,0,10,14,1
4963,95425,79rw5BhFSnhvdIaVsXl3jeEXJRviIjGz,A3fsA9Zfv1X2fVEQhTw51lKENdNrEqT3,69,36,23,150,11,4,16,1,241,34.42857142857143,3,0.0,9,23,129,11,27,4,21,16,1,172,69,0
4964,95427,GdhgDlZa5ZJ9AzwBGC942HC991fsxvHr,G8EPVSXsOYB5YQWZGiz1aVq5Pgr2GrQu,18,19,2,16,2,0,9,6,54,7.714285714285714,1,0.0,0,2,13,2,19,0,3,9,6,17,37,1
4965,95440,NT7bBO2hHEg05ci9UTFOwIHaUZMIdh9x,SpATywNh6bZuzm8s1ceuBUnMUAeoAHHw,21,26,10,32,3,2,6,2,81,11.571428571428571,3,0.0,10,10,27,3,16,2,5,6,2,50,31,1
4966,95461,M507IlBQp64NkSWnSkchjsahApLaE1kJ,A3fsA9Zfv1X2fVEQhTw51lKENdNrEqT3,50,48,35,80,21,7,19,1,211,30.142857142857142,3,0.0,3,35,61,21,45,7,19,19,1,120,91,1
4967,95472,Dsiw0jpMBHHLbjdF7l3UeGKLOlfgXUpd,SpATywNh6bZuzm8s1ceuBUnMUAeoAHHw,29,25,15,31,7,1,5,0,84,12.0,1,0.0,5,15,28,7,20,1,3,5,0,55,29,1
4968,95490,pJLSeQHIu4aZZbYoyPq22AsdfE0vwv53,bWdj2GDclj5ofokWjzoa5jAwMkxCykd6,2,0,0,0,0,0,2,0,2,0.2857142857142857,1,0.0,0,0,0,0,0,0,0,2,0,0,2,0
4969,95493,N0D8gfv74t8uM2LFiOg2xy8nVL0vO7Kx,SpATywNh6bZuzm8s1ceuBUnMUAeoAHHw,7,3,2,0,2,0,2,0,9,1.2857142857142858,1,0.0,0,2,0,2,3,0,0,2,0,4,5,1
4970,95507,YLfjSoU2JNGG7f9SEbr83b8mp8z1n7i3,A3fsA9Zfv1X2fVEQhTw51lKENdNrEqT3,1,0,0,0,0,0,1,0,1,0.14285714285714285,1,0.0,0,0,0,0,0,0,0,1,0,0,1,1
4971,95517,WzkRGtR4EenxksGL0ftvaO4vHssxZDFt,A3fsA9Zfv1X2fVEQhTw51lKENdNrEqT3,3,0,0,0,0,0,3,0,3,0.42857142857142855,1,0.0,0,0,0,0,0,0,0,3,0,0,3,1
4972,95521,OF90Hu2g8vPUjKHCP4ULPYNMvRFKxBj6,SpATywNh6bZuzm8s1ceuBUnMUAeoAHHw,32,49,25,36,10,11,17,2,150,21.428571428571427,4,0.0,15,25,28,10,34,11,8,17,2,78,72,0
4973,95561,BILNjgDM4z6ewRYZ6qt3YLHpB6O5FFua,SpATywNh6bZuzm8s1ceuBUnMUAeoAHHw,7,4,3,0,3,0,2,0,12,1.7142857142857142,1,0.0,0,3,0,3,4,0,0,2,0,6,6,1
4974,95583,YaP2AuckukEZITP3IVvIt6Z8ci6RHew7,bWdj2GDclj5ofokWjzoa5jAwMkxCykd6,12,8,5,0,3,0,4,0,20,2.857142857142857,2,0.0,0,5,0,3,8,0,0,4,0,8,12,1
4975,95588,DxGyu8XXv7e8wbVx0mvEABKcoqoolLlv,bWdj2GDclj5ofokWjzoa5jAwMkxCykd6,4,0,0,0,0,0,11,0,11,1.5714285714285714,1,0.0,0,0,0,0,0,0,0,11,0,0,11,1
4976,95590,XfiCSk5eLAbq9rzQtnLkX2OQTd6M8xFG,A3fsA9Zfv1X2fVEQhTw51lKENdNrEqT3,1,0,0,0,0,0,1,0,1,0.14285714285714285,1,0.0,0,0,0,0,0,0,0,1,0,0,1,1
4977,95593,DHUv7XpIZcPp2QYGNmTXjhgg7Zq4BpJ7,A3fsA9Zfv1X2fVEQhTw51lKENdNrEqT3,18,10,8,12,6,0,2,0,38,5.428571428571429,2,0.0,0,8,10,6,10,0,2,2,0,24,14,1
4978,95595,ZBEHpTfGoLiomhe8zt7rkm2uZVd9b9kk,SpATywNh6bZuzm8s1ceuBUnMUAeoAHHw,5,7,0,0,1,0,1,0,9,1.2857142857142858,1,0.0,0,0,0,1,7,0,0,1,0,1,8,1
4979,95605,UaSh8dwx8gnofYbXlmpqj9uYDbpJ89pX,A3fsA9Zfv1X2fVEQhTw51lKENdNrEqT3,13,21,0,0,0,22,18,3,64,9.142857142857142,5,0.0,1,0,0,0,20,22,0,18,3,1,63,1
4980,95617,Daw06K1PSOXldo19kBgHP5sewulb7Vu5,A3fsA9Zfv1X2fVEQhTw51lKENdNrEqT3,4,2,1,0,1,0,3,0,7,1.0,2,0.0,0,1,0,1,2,0,0,3,0,2,5,0
4981,95620,Daw06K1PSOXldo19kBgHP5sewulb7Vu5,G8EPVSXsOYB5YQWZGiz1aVq5Pgr2GrQu,1,0,0,0,0,0,1,0,1,0.14285714285714285,1,0.0,0,0,0,0,0,0,0,1,0,0,1,1
4982,95622,DGrwRqi3z3Y9GhMsPFPJjWU0FULJtTwp,A3fsA9Zfv1X2fVEQhTw51lKENdNrEqT3,5,0,0,0,0,0,5,1,6,0.8571428571428571,2,0.0,0,0,0,0,0,0,0,5,1,0,6,1
4983,95624,YLJN09Je7GNR4wBomW2iH8q4HAK5TPdc,RXDvfPUBYFlVdlueBFbLW0mhhAyGEqpt,29,29,8,20,6,23,5,0,91,13.0,1,0.0,3,8,20,6,26,23,0,5,0,37,54,1
4984,95627,fxfoo3EegutxQePINTymJFzExTdNcKVI,SpATywNh6bZuzm8s1ceuBUnMUAeoAHHw,28,20,9,32,7,1,12,1,82,11.714285714285714,3,0.0,6,9,29,7,14,1,3,12,1,51,31,1
4985,95631,cW2QGOVqGX1ONxdDTXMiDqmocWqOnU5N,A3fsA9Zfv1X2fVEQhTw51lKENdNrEqT3,4,3,1,0,0,0,2,0,6,0.8571428571428571,1,0.0,0,1,0,0,3,0,0,2,0,1,5,1
4986,95633,ZtofBugo33Zo9FroLN9tXtgl9O0zgDWY,SpATywNh6bZuzm8s1ceuBUnMUAeoAHHw,20,18,6,27,2,0,3,0,56,8.0,3,0.0,4,6,24,2,14,0,3,3,0,36,20,0
4987,95646,kHWuc10C4T4imgPGXw1iL9DdxxMDyloj,RXDvfPUBYFlVdlueBFbLW0mhhAyGEqpt,1,0,0,0,0,0,1,0,1,0.14285714285714285,1,0.0,0,0,0,0,0,0,0,1,0,0,1,1
4988,95653,fn3RgMp4JCABnOK3IDXz6cUAXpmeuiYQ,G8EPVSXsOYB5YQWZGiz1aVq5Pgr2GrQu,9,6,3,0,4,0,2,0,15,2.142857142857143,1,0.0,2,3,0,4,4,0,0,2,0,9,6,1
4989,95659,y8wihgxEdHfGcxMV16au6pgiPnSQwx23,RXDvfPUBYFlVdlueBFbLW0mhhAyGEqpt,7,1,1,0,1,0,6,0,9,1.2857142857142858,1,0.0,0,1,0,1,1,0,0,6,0,2,7,1
4990,95662,4NPDuZC5Eo397A2ZzeMAm6BBPfedAt7V,SpATywNh6bZuzm8s1ceuBUnMUAeoAHHw,9,3,2,0,2,0,9,2,18,2.5714285714285716,1,0.0,0,2,0,2,3,0,0,9,2,4,14,1
4991,95669,k24Ps3wdaeoSwT1eSTFmxgPUJ0moWYPO,SpATywNh6bZuzm8s1ceuBUnMUAeoAHHw,6,4,1,0,1,0,3,0,9,1.2857142857142858,1,0.0,0,1,0,1,4,0,0,3,0,2,7,1
4992,95684,Nsz2zYB7CSRbOtMFEx5HNBJ0rxH2o1F7,A3fsA9Zfv1X2fVEQhTw51lKENdNrEqT3,4,0,0,0,0,0,8,0,8,1.1428571428571428,1,0.0,0,0,0,0,0,0,0,8,0,0,8,1
4993,95690,4NPDuZC5Eo397A2ZzeMAm6BBPfedAt7V,G8EPVSXsOYB5YQWZGiz1aVq5Pgr2GrQu,1,0,0,0,0,0,1,0,1,0.14285714285714285,1,0.0,0,0,0,0,0,0,0,1,0,0,1,1
4994,95694,m1Erwr4qiZRddhtJBwtwyQxEqeaRgIgi,SpATywNh6bZuzm8s1ceuBUnMUAeoAHHw,7,3,1,0,1,0,3,1,9,1.2857142857142858,1,0.0,0,1,0,1,3,0,0,3,1,2,7,1
4995,95699,zPbUIdTRPjnN9GVjy7Vs8SVwjdhRAaUM,SpATywNh6bZuzm8s1ceuBUnMUAeoAHHw,4,3,1,0,1,0,2,0,7,1.0,1,0.0,0,1,0,1,3,0,0,2,0,2,5,1
4996,95726,9yvWwncWvyjvEU2gkB98t6ra5ZlqpOOe,SpATywNh6bZuzm8s1ceuBUnMUAeoAHHw,31,31,15,16,8,0,10,1,81,11.571428571428571,2,0.0,6,15,15,8,25,0,1,10,1,44,37,1
4997,95737,CLsYy7g1hYWHJyj1aROfKK9oTeo5yxJx,bWdj2GDclj5ofokWjzoa5jAwMkxCykd6,1,0,0,0,0,0,1,0,1,0.14285714285714285,1,0.0,0,0,0,0,0,0,0,1,0,0,1,1
4998,95744,FXy6zIwT4trAO2Fwnqm3Ehrt0HqoYcIs,SpATywNh6bZuzm8s1ceuBUnMUAeoAHHw,6,5,1,0,1,0,2,0,9,1.2857142857142858,1,0.0,0,1,0,1,5,0,0,2,0,2,7,1
4999,95751,nMyFoPqXKsdnuE6mgxy1XpE5LPKy9GOa,G8EPVSXsOYB5YQWZGiz1aVq5Pgr2GrQu,1,0,0,0,0,0,1,0,1,0.14285714285714285,1,0.0,0,0,0,0,0,0,0,1,0,0,1,1
5000,95768,tKaMjS6KWA4OmqzSfTJZDMyzIRtISbIo,SpATywNh6bZuzm8s1ceuBUnMUAeoAHHw,1,0,0,0,0,0,1,0,1,0.14285714285714285,1,0.0,0,0,0,0,0,0,0,1,0,0,1,0
5001,95785,1SCPwRp6zs8beWzgpgsNRS1NXyUeSOy8,bWdj2GDclj5ofokWjzoa5jAwMkxCykd6,8,13,5,58,2,9,3,0,90,12.857142857142858,1,0.0,5,5,56,2,8,9,2,3,0,68,22,1
5002,95809,gMeKwVdV7xHR9zrsQTTuP5xOz4aKMsCh,RXDvfPUBYFlVdlueBFbLW0mhhAyGEqpt,10,4,4,0,2,0,4,0,14,2.0,1,0.0,0,4,0,2,4,0,0,4,0,6,8,1
5003,95814,pK3w2ljSu5UCiWTsVPCK8fUfSVn5X9S6,SpATywNh6bZuzm8s1ceuBUnMUAeoAHHw,28,43,21,23,13,0,5,0,105,15.0,1,0.0,13,21,23,13,30,0,0,5,0,70,35,1
5004,95815,forPgRyluFqH5fyMZfnKJctNYjPII95b,A3fsA9Zfv1X2fVEQhTw51lKENdNrEqT3,15,5,1,30,0,0,3,0,39,5.571428571428571,1,0.0,0,1,27,0,5,0,3,3,0,28,11,1
5005,95850,NvdQzMD14NnCAS0YAW6YP4m31ATjV5UA,SpATywNh6bZuzm8s1ceuBUnMUAeoAHHw,12,12,6,0,8,1,2,0,29,4.142857142857143,1,0.0,0,6,0,8,12,1,0,2,0,14,15,1
5006,95852,nB9RnfPmq1WfPeBn5EUZt5ffKcXJEdE4,A3fsA9Zfv1X2fVEQhTw51lKENdNrEqT3,2,0,0,0,0,0,4,0,4,0.5714285714285714,3,0.0,0,0,0,0,0,0,0,4,0,0,4,1
5007,95860,JcocKAtlN5pNw3B6wmg6BZFKdvxcJRHw,bWdj2GDclj5ofokWjzoa5jAwMkxCykd6,14,16,8,36,7,0,2,0,69,9.857142857142858,1,0.0,5,8,29,7,11,0,7,2,0,49,20,1
5008,95880,XNJvqr2ia2XRTEmLeguLZckH2aLyvBMM,SpATywNh6bZuzm8s1ceuBUnMUAeoAHHw,6,6,3,0,0,0,3,0,12,1.7142857142857142,2,0.0,0,3,0,0,6,0,0,3,0,3,9,1
5009,95899,qwWysWdLmrwh0JmjPYNGVFqdat8Jy8Lb,bWdj2GDclj5ofokWjzoa5jAwMkxCykd6,8,12,2,0,3,0,8,0,25,3.5714285714285716,3,0.0,2,2,0,3,10,0,0,8,0,7,18,0
5010,95901,jzWvwaTexkgbyBrPkQbXDb98Viqx6cSS,A3fsA9Zfv1X2fVEQhTw51lKENdNrEqT3,42,7,3,114,0,0,5,0,129,18.428571428571427,2,0.0,3,3,100,0,4,0,14,5,0,106,23,1
5011,95908,b80Lkn7xNHauWWmN3QIwsLauRSXsSHrY,SpATywNh6bZuzm8s1ceuBUnMUAeoAHHw,6,6,0,0,1,0,2,0,9,1.2857142857142858,1,0.0,2,0,0,1,4,0,0,2,0,3,6,1
5012,95913,m7hBmfvQj5nDU6vEGQuVMa4fkSxlliz4,G8EPVSXsOYB5YQWZGiz1aVq5Pgr2GrQu,4,2,0,0,0,0,2,0,4,0.5714285714285714,1,0.0,0,0,0,0,2,0,0,2,0,0,4,1
5013,95933,pwoJhGEuCXUAzWggYD0Vpr6rlqs95MdC,SpATywNh6bZuzm8s1ceuBUnMUAeoAHHw,6,3,2,0,2,0,1,0,8,1.1428571428571428,1,0.0,0,2,0,2,3,0,0,1,0,4,4,1
5014,95939,q7ixHJ98uI7DV9nBYxjXxbopCkuH6DX6,SpATywNh6bZuzm8s1ceuBUnMUAeoAHHw,3,0,0,0,0,0,3,0,3,0.42857142857142855,1,0.0,0,0,0,0,0,0,0,3,0,0,3,1
5015,95941,5FCCqL18D5yTiqyAg5N299Ugwsv8CI3G,SpATywNh6bZuzm8s1ceuBUnMUAeoAHHw,6,3,1,0,1,0,2,0,7,1.0,1,0.0,0,1,0,1,3,0,0,2,0,2,5,0
5016,95951,Uvg7ZsdO3eZ12twQcai6zLQJvqq6H5qj,G8EPVSXsOYB5YQWZGiz1aVq5Pgr2GrQu,9,5,1,0,1,0,5,0,12,1.7142857142857142,2,0.0,0,1,0,1,5,0,0,5,0,2,10,0
5017,95958,Ar7wri6od2sIMOfx95hPmMwDttR4wtOC,A3fsA9Zfv1X2fVEQhTw51lKENdNrEqT3,43,11,6,100,2,0,8,1,128,18.285714285714285,2,0.0,1,6,87,2,10,0,13,8,1,96,32,0
5018,95978,wfyGhtXQXfiz6Xnx0YIucq6EMEmHdLu2,SpATywNh6bZuzm8s1ceuBUnMUAeoAHHw,1,0,0,0,0,0,1,0,1,0.14285714285714285,1,0.0,0,0,0,0,0,0,0,1,0,0,1,1
5019,95993,pcy81jlx7huLaDPvWWRXTEiJTAUolrbh,A3fsA9Zfv1X2fVEQhTw51lKENdNrEqT3,8,4,3,0,3,0,1,0,11,1.5714285714285714,1,0.0,0,3,0,3,4,0,0,1,0,6,5,1
5020,96003,Hxd16O3nQG6ddXQCBbAu8BGBmmZmiixl,G8EPVSXsOYB5YQWZGiz1aVq5Pgr2GrQu,1,0,0,0,0,0,1,0,1,0.14285714285714285,1,0.0,0,0,0,0,0,0,0,1,0,0,1,1
5021,96011,XtXVGX6xZjaXboxbRFBRNJiE8mlrJ6RY,SpATywNh6bZuzm8s1ceuBUnMUAeoAHHw,1,0,0,0,0,0,2,0,2,0.2857142857142857,1,0.0,0,0,0,0,0,0,0,2,0,0,2,1
5022,96035,NGxVJQppNBMfgJiFwD3Ox6xl5bHm79ig,SpATywNh6bZuzm8s1ceuBUnMUAeoAHHw,7,3,2,0,2,0,2,0,9,1.2857142857142858,1,0.0,0,2,0,2,3,0,0,2,0,4,5,1
5023,96036,zwqhxdboQszkcKvPN5pyN1nGDFR4ub3y,A3fsA9Zfv1X2fVEQhTw51lKENdNrEqT3,6,2,1,0,1,0,4,0,8,1.1428571428571428,1,0.0,0,1,0,1,2,0,0,4,0,2,6,1
5024,96054,G9ja1Sell6i4GCvRpZMszshIwT0u0uoK,SpATywNh6bZuzm8s1ceuBUnMUAeoAHHw,4,3,1,0,1,0,1,0,6,0.8571428571428571,1,0.0,0,1,0,1,3,0,0,1,0,2,4,0
5025,96073,FZWt1vapJFvo3kXFvlr3Pcq5dqSsXIdl,G8EPVSXsOYB5YQWZGiz1aVq5Pgr2GrQu,4,2,0,0,0,0,4,0,6,0.8571428571428571,2,0.0,0,0,0,0,2,0,0,4,0,0,6,1
5026,96099,ps5VcFUapZM31sy4VNJWOTFBzN98932v,RXDvfPUBYFlVdlueBFbLW0mhhAyGEqpt,1,0,0,0,0,0,1,0,1,0.14285714285714285,1,0.0,0,0,0,0,0,0,0,1,0,0,1,0
5027,96116,liXvDig5u9dxIPwxTVIf3BkkLMQ16JFo,SpATywNh6bZuzm8s1ceuBUnMUAeoAHHw,2,0,0,0,0,0,2,0,2,0.2857142857142857,1,0.0,0,0,0,0,0,0,0,2,0,0,2,1
5028,96129,8n73BBd3mvRJq2a0KZ4WJWTYj65s8f61,A3fsA9Zfv1X2fVEQhTw51lKENdNrEqT3,1,0,0,0,0,0,1,0,1,0.14285714285714285,1,0.0,0,0,0,0,0,0,0,1,0,0,1,1
5029,96134,VeFENcSXAiXgJQaSjlXiodtIBxgSrzaH,bWdj2GDclj5ofokWjzoa5jAwMkxCykd6,6,5,0,0,0,0,3,0,8,1.1428571428571428,1,0.0,1,0,0,0,4,0,0,3,0,1,7,0
5030,96677,xOjhmcafCtLT2q16oVNZpjeZh4FUCy6U,A3fsA9Zfv1X2fVEQhTw51lKENdNrEqT3,1,0,0,0,0,0,1,0,1,0.14285714285714285,1,0.0,0,0,0,0,0,0,0,1,0,0,1,1
5031,96695,plWW2jbmbdQAaG18LPwZIwpV7ZE0ypXp,SpATywNh6bZuzm8s1ceuBUnMUAeoAHHw,7,1,1,0,1,0,4,1,8,1.1428571428571428,1,0.0,0,1,0,1,1,0,0,4,1,2,6,0
5032,96724,Vqh7IxciNu3w4ryq9DwYRMQWb1h8f16V,SpATywNh6bZuzm8s1ceuBUnMUAeoAHHw,15,18,6,22,4,23,9,3,85,12.142857142857142,1,0.0,6,6,19,4,12,23,3,9,3,35,50,1
5033,96732,RHsk3gHUm8VEfb9FwEFf8vBDNKZZ0LWe,A3fsA9Zfv1X2fVEQhTw51lKENdNrEqT3,70,30,23,142,16,5,10,2,228,32.57142857142857,2,0.0,2,23,108,16,28,5,34,10,2,149,79,1
5034,96893,UAyWvSjTLiO8ve7HkUm43OX3XFSgIZD0,7GRhBDsirIGkRZBtSMEzNTyDr2JQm4xx,1,0,0,0,0,0,1,0,1,0.14285714285714285,1,0.0,0,0,0,0,0,0,0,1,0,0,1,1
5035,96895,Ip3irZsxFvOeGg8WSppVhJArbPhoH3qm,A3fsA9Zfv1X2fVEQhTw51lKENdNrEqT3,10,7,6,0,6,0,1,0,20,2.857142857142857,1,0.0,0,6,0,6,7,0,0,1,0,12,8,1
5036,96929,uaGHWOyiH6GRJNYQ5wYQgdGgJiyGijb7,SpATywNh6bZuzm8s1ceuBUnMUAeoAHHw,13,16,11,4,5,0,11,0,47,6.714285714285714,4,0.0,0,11,3,5,16,0,1,11,0,19,28,0
5037,96933,mgC2SKl3BkBHgSzUjS94KW5V0rxosMWt,SpATywNh6bZuzm8s1ceuBUnMUAeoAHHw,13,12,7,13,4,5,3,0,44,6.285714285714286,1,0.0,3,7,11,4,9,5,2,3,0,25,19,0
5038,96976,7pD3XwJqYTfsh0zZ4M07qj3DJAHtjtGm,7GRhBDsirIGkRZBtSMEzNTyDr2JQm4xx,1,0,0,0,0,0,1,0,1,0.14285714285714285,1,0.0,0,0,0,0,0,0,0,1,0,0,1,1
5039,96978,XoAmaAEiCQyqxGtldGa1yHbrXfsnSjbj,7GRhBDsirIGkRZBtSMEzNTyDr2JQm4xx,1,0,0,0,0,0,1,0,1,0.14285714285714285,1,0.0,0,0,0,0,0,0,0,1,0,0,1,1
5040,97014,MSXFOc30HZVbYZtATkSJwT5euFO05BA1,7GRhBDsirIGkRZBtSMEzNTyDr2JQm4xx,6,5,1,0,2,0,3,0,11,1.5714285714285714,1,0.0,3,1,0,2,2,0,0,3,0,6,5,1
5041,97068,XlT7X7Rn0fLTh36Iz42hC1Epd5u3ukUS,7GRhBDsirIGkRZBtSMEzNTyDr2JQm4xx,2,0,0,0,0,0,4,0,4,0.5714285714285714,1,0.0,0,0,0,0,0,0,0,4,0,0,4,1
5042,97102,RJ2AN96oZxuBCR52LgUmQpj4g9Y4mcD4,A3fsA9Zfv1X2fVEQhTw51lKENdNrEqT3,1,0,0,0,0,0,1,0,1,0.14285714285714285,1,0.0,0,0,0,0,0,0,0,1,0,0,1,1
5043,97104,pSX00XUyCx7VlmgWGN0d39OwC9BZ8bRV,7GRhBDsirIGkRZBtSMEzNTyDr2JQm4xx,1,0,0,0,0,0,1,0,1,0.14285714285714285,1,0.0,0,0,0,0,0,0,0,1,0,0,1,0
5044,97143,vcLosQzAVwhadotVELXCMAgXnlN9Qppp,7GRhBDsirIGkRZBtSMEzNTyDr2JQm4xx,12,4,3,0,1,8,7,1,24,3.4285714285714284,1,0.0,0,3,0,1,4,8,0,7,1,4,20,1
5045,97152,JGnVyZ53gH9wjqC3YYjpGEbabkw7ZVhR,A3fsA9Zfv1X2fVEQhTw51lKENdNrEqT3,1,0,0,0,0,0,1,0,1,0.14285714285714285,1,0.0,0,0,0,0,0,0,0,1,0,0,1,1
5046,97165,YE22fRNdaFtk3nhWfjSOMHWERX5O7Ymi,7GRhBDsirIGkRZBtSMEzNTyDr2JQm4xx,28,77,6,42,9,0,12,0,146,20.857142857142858,4,0.0,20,6,38,9,57,0,4,12,0,73,73,1
5047,97184,5DIcniD9kRbDupVPBNugV5by0SZHtD2e,7GRhBDsirIGkRZBtSMEzNTyDr2JQm4xx,1,0,0,0,0,0,1,0,1,0.14285714285714285,1,0.0,0,0,0,0,0,0,0,1,0,0,1,1
5048,97224,PKH12j56WyhhHbwNNO7EjzMEo1oeOneA,A3fsA9Zfv1X2fVEQhTw51lKENdNrEqT3,4,4,1,0,0,0,1,0,6,0.8571428571428571,1,0.0,0,1,0,0,4,0,0,1,0,1,5,1
5049,97255,Ds7Ql2Fzh0y89y9XQaeLbThJFJ8LYIlx,7GRhBDsirIGkRZBtSMEzNTyDr2JQm4xx,1,0,0,0,0,0,1,0,1,0.14285714285714285,1,0.0,0,0,0,0,0,0,0,1,0,0,1,1
5050,97295,yrlVnbrSR0LAW13A08wi2wUW5yoGSw1G,7GRhBDsirIGkRZBtSMEzNTyDr2JQm4xx,5,6,3,0,0,0,1,0,10,1.4285714285714286,1,0.0,2,3,0,0,4,0,0,1,0,5,5,1
5051,97390,wHh7IyZg69gls07QnvzBvWbwxDpKJO6L,7GRhBDsirIGkRZBtSMEzNTyDr2JQm4xx,4,2,1,0,1,0,1,0,5,0.7142857142857143,1,0.0,0,1,0,1,2,0,0,1,0,2,3,1
5052,97410,TzuMwfaAW66vzYCJbLJUrM2CQWUNVBwC,A3fsA9Zfv1X2fVEQhTw51lKENdNrEqT3,2,0,0,0,0,0,4,0,4,0.5714285714285714,1,0.0,0,0,0,0,0,0,0,4,0,0,4,1
5053,97437,YcAjMEQHzjEkIappgCA5LKxL8wrCHqZx,7GRhBDsirIGkRZBtSMEzNTyDr2JQm4xx,6,3,2,0,2,0,1,0,8,1.1428571428571428,1,0.0,0,2,0,2,3,0,0,1,0,4,4,1
5054,97447,DK4tMY4hv5jCEWYRZnAyqsGRGzDp2xfD,7GRhBDsirIGkRZBtSMEzNTyDr2JQm4xx,7,3,2,0,1,0,4,1,11,1.5714285714285714,1,0.0,0,2,0,1,3,0,0,4,1,3,8,1
5055,97459,gtKTzkXHwS41ljYVmjlLLf4WyQSkK02q,A3fsA9Zfv1X2fVEQhTw51lKENdNrEqT3,1,0,0,0,0,0,1,0,1,0.14285714285714285,1,0.0,0,0,0,0,0,0,0,1,0,0,1,0
5056,97468,LhMGo1H458StfoGsiIJMkiDJEIOqqbKe,7GRhBDsirIGkRZBtSMEzNTyDr2JQm4xx,1,0,0,0,0,0,1,0,1,0.14285714285714285,1,0.0,0,0,0,0,0,0,0,1,0,0,1,1
5057,97476,LDoKVa67JbCj3bIYTGTgWGEVPIBUkRDs,7GRhBDsirIGkRZBtSMEzNTyDr2JQm4xx,1,0,0,0,0,0,1,0,1,0.14285714285714285,1,0.0,0,0,0,0,0,0,0,1,0,0,1,1
5058,97478,9yD6wRS2N3SNxMC2ibpNMzfizxpTbLsY,7GRhBDsirIGkRZBtSMEzNTyDr2JQm4xx,4,2,1,0,1,0,1,0,5,0.7142857142857143,1,0.0,0,1,0,1,2,0,0,1,0,2,3,1
5059,97502,BVpzzXeXh42vyU3wE9rUQpEUs8P1ZpSo,7GRhBDsirIGkRZBtSMEzNTyDr2JQm4xx,33,43,15,96,8,2,12,0,176,25.142857142857142,4,0.0,23,15,88,8,20,2,8,12,0,134,42,1
5060,97533,LzIeScVJDrRe6pKpJZPOE5digO2qGiFj,A3fsA9Zfv1X2fVEQhTw51lKENdNrEqT3,31,16,14,60,12,0,2,0,104,14.857142857142858,1,0.0,1,14,55,12,15,0,5,2,0,82,22,0
5061,97578,tJSuuWZXDdoXjZXIctAWwDLD7oHTWJ9T,7GRhBDsirIGkRZBtSMEzNTyDr2JQm4xx,1,0,0,0,0,0,2,0,2,0.2857142857142857,2,0.0,0,0,0,0,0,0,0,2,0,0,2,1
5062,97701,PlRR5bewxY5s5UPrV9qsB2qkDqRzxPQw,7GRhBDsirIGkRZBtSMEzNTyDr2JQm4xx,20,14,7,19,5,0,3,0,48,6.857142857142857,2,0.0,5,7,16,5,9,0,3,3,0,33,15,1
5063,97805,tPYh43YRHAzuf09xESxSKtWvST0aCsjn,7GRhBDsirIGkRZBtSMEzNTyDr2JQm4xx,30,31,10,40,7,0,3,0,91,13.0,2,0.0,19,10,39,7,12,0,1,3,0,75,16,1
5064,97840,Ffohn9JNnGJQD2IavzMTS00ubnVtcb2T,A3fsA9Zfv1X2fVEQhTw51lKENdNrEqT3,99,55,36,230,20,0,18,0,359,51.285714285714285,10,0.0,6,36,193,20,49,0,37,18,0,255,104,0
5065,97846,DwUuHlykLcu2QOJPkMlSk4MpGYyYCYXn,7GRhBDsirIGkRZBtSMEzNTyDr2JQm4xx,4,0,0,0,0,0,4,1,5,0.7142857142857143,1,0.0,0,0,0,0,0,0,0,4,1,0,5,1
5066,98953,lcykm3uj0WkC2rJwnpw8jWVXHYstRrPs,bWdj2GDclj5ofokWjzoa5jAwMkxCykd6,2,0,0,0,0,0,2,0,2,0.2857142857142857,1,0.0,0,0,0,0,0,0,0,2,0,0,2,1
5067,98956,O2hEYcKpW3bz7TyhhkMeHOTvhvdMjulM,bWdj2GDclj5ofokWjzoa5jAwMkxCykd6,5,6,1,0,1,0,1,0,9,1.2857142857142858,1,0.0,0,1,0,1,6,0,0,1,0,2,7,1
5068,98966,oy7Pg8T5wy30VY5zamAkBAwv1iuWjap6,RXDvfPUBYFlVdlueBFbLW0mhhAyGEqpt,11,9,5,0,3,0,3,0,20,2.857142857142857,1,0.0,0,5,0,3,9,0,0,3,0,8,12,1
5069,98978,RbFI9SCNoIyFjKexw9cTU5NZ0thYBnL5,bWdj2GDclj5ofokWjzoa5jAwMkxCykd6,6,2,1,0,1,0,3,0,7,1.0,1,0.0,0,1,0,1,2,0,0,3,0,2,5,1
5070,98994,m30r8XAusN1tKwuw4RNeOZUufFJ19O18,RXDvfPUBYFlVdlueBFbLW0mhhAyGEqpt,1,0,0,0,0,0,1,0,1,0.14285714285714285,1,0.0,0,0,0,0,0,0,0,1,0,0,1,1
5071,98997,514TWhkGGUhLu2MdvTnb8eiBH3DCFHzg,A3fsA9Zfv1X2fVEQhTw51lKENdNrEqT3,10,11,6,0,3,1,3,0,24,3.4285714285714284,3,0.0,0,6,0,3,11,1,0,3,0,9,15,1
5072,99000,JqdbZyx8jQDjvl0RCDBDldcliaXwceyv,bWdj2GDclj5ofokWjzoa5jAwMkxCykd6,8,8,2,0,2,0,2,0,14,2.0,1,0.0,0,2,0,2,8,0,0,2,0,4,10,1
5073,99004,nqSx2YqVg8XBgQNFVkp5HECPuoyoztFf,SpATywNh6bZuzm8s1ceuBUnMUAeoAHHw,1,0,0,0,0,0,1,0,1,0.14285714285714285,1,0.0,0,0,0,0,0,0,0,1,0,0,1,1
5074,99008,udqxlb4h6NzlXvNGaijkJTXRrNX6DSPh,SpATywNh6bZuzm8s1ceuBUnMUAeoAHHw,1,0,0,0,0,0,1,0,1,0.14285714285714285,1,0.0,0,0,0,0,0,0,0,1,0,0,1,1
5075,99015,fe6JA2o6NTgNBdf1OgbAshmKUEnJCT1r,bWdj2GDclj5ofokWjzoa5jAwMkxCykd6,8,20,3,0,2,6,5,1,37,5.285714285714286,3,0.0,8,3,0,2,12,6,0,5,1,13,24,1
5076,99032,Ya8dmcUSDz09ym2vaNemTt41Djt01YaN,SpATywNh6bZuzm8s1ceuBUnMUAeoAHHw,5,5,1,0,1,0,2,0,9,1.2857142857142858,1,0.0,0,1,0,1,5,0,0,2,0,2,7,1
5077,99052,XzLXD7FWHRTDP7XVgC5p2Do9UmUukeQz,SpATywNh6bZuzm8s1ceuBUnMUAeoAHHw,3,3,0,0,0,0,1,0,4,0.5714285714285714,1,0.0,0,0,0,0,3,0,0,1,0,0,4,1
5078,99055,cR6ka5k7tAsfYo9cLOUPkpzWO6OItcGJ,SpATywNh6bZuzm8s1ceuBUnMUAeoAHHw,32,45,28,36,10,23,27,1,170,24.285714285714285,6,0.0,5,28,33,10,40,23,3,27,1,76,94,1
5079,99062,jP3AB3LItmtaoVvn4CaCoqw1w2QWhLKQ,G8EPVSXsOYB5YQWZGiz1aVq5Pgr2GrQu,27,41,0,106,2,1,14,1,165,23.571428571428573,1,0.0,20,0,84,2,21,1,22,14,1,106,59,1
5080,99068,T3sGbyIt0UjiteEMsVXGzcCDHseJZwlW,A3fsA9Zfv1X2fVEQhTw51lKENdNrEqT3,1,0,0,0,0,0,1,0,1,0.14285714285714285,1,0.0,0,0,0,0,0,0,0,1,0,0,1,1
5081,99071,Ein91FWFv0A9qDhWUbZlH2368EmphQmt,SpATywNh6bZuzm8s1ceuBUnMUAeoAHHw,11,10,1,15,0,0,3,0,29,4.142857142857143,1,0.0,5,1,12,0,5,0,3,3,0,18,11,1
5082,99093,XZ82RV9AD9npmDtj5hyoVvxIFU4kzejE,SpATywNh6bZuzm8s1ceuBUnMUAeoAHHw,5,3,1,0,1,0,1,0,6,0.8571428571428571,1,0.0,0,1,0,1,3,0,0,1,0,2,4,1
5083,99105,hCxVGafW6uZuzswuD2GRzZf6ODUAaVFJ,bWdj2GDclj5ofokWjzoa5jAwMkxCykd6,2,0,0,0,0,0,4,0,4,0.5714285714285714,1,0.0,0,0,0,0,0,0,0,4,0,0,4,0
5084,99124,DVOHqEW2vUL1QpZynG6huVjAWwl1vI6M,G8EPVSXsOYB5YQWZGiz1aVq5Pgr2GrQu,27,26,21,56,9,0,6,0,118,16.857142857142858,3,0.0,0,21,42,9,26,0,14,6,0,72,46,1
5085,99128,vGk4gKtQutULkRGPcSts7AdXqOR6DK2Z,RXDvfPUBYFlVdlueBFbLW0mhhAyGEqpt,10,9,7,0,4,0,3,0,23,3.2857142857142856,1,0.0,0,7,0,4,9,0,0,3,0,11,12,1
5086,99131,jVKznnDuZGyXtBgvnWMRtPXsgImk4qlt,SpATywNh6bZuzm8s1ceuBUnMUAeoAHHw,7,4,1,0,1,0,4,0,10,1.4285714285714286,1,0.0,0,1,0,1,4,0,0,4,0,2,8,1
5087,99138,eww5R49fPAYUK2L57nGKDp5FexxMvqZv,bWdj2GDclj5ofokWjzoa5jAwMkxCykd6,7,6,3,0,3,1,10,1,24,3.4285714285714284,1,0.0,2,3,0,3,4,1,0,10,1,8,16,1
5088,99147,1j3W4Jw1KafoLSgTmOItRSa20eh1CtOK,SpATywNh6bZuzm8s1ceuBUnMUAeoAHHw,1,0,0,0,0,0,1,0,1,0.14285714285714285,1,0.0,0,0,0,0,0,0,0,1,0,0,1,1
5089,99165,NojuWwUw3FQaTJhIEuVtN6uUtxeXYBaz,A3fsA9Zfv1X2fVEQhTw51lKENdNrEqT3,1,0,0,0,0,0,1,0,1,0.14285714285714285,1,0.0,0,0,0,0,0,0,0,1,0,0,1,1
5090,99182,N0P6Yrg1zRuUPyVufFpM0ZExnJnGTKKG,bWdj2GDclj5ofokWjzoa5jAwMkxCykd6,16,18,1,52,3,0,5,0,79,11.285714285714286,1,0.0,7,1,45,3,11,0,7,5,0,56,23,1
5091,99193,mS4KVP7r7MB15ORyOGtOcG2IZUAuYo4F,SpATywNh6bZuzm8s1ceuBUnMUAeoAHHw,4,3,1,0,0,0,2,0,6,0.8571428571428571,1,0.0,0,1,0,0,3,0,0,2,0,1,5,1
5092,99198,KUppVPuFnFs0vLCUrPJOIfquMy1mUooq,bWdj2GDclj5ofokWjzoa5jAwMkxCykd6,12,7,4,26,0,0,3,0,40,5.714285714285714,1,0.0,3,4,25,0,4,0,1,3,0,32,8,1
5093,99204,cKCzrCCCXe9nkBgWepq9AEXje7SITRTz,bWdj2GDclj5ofokWjzoa5jAwMkxCykd6,1,0,0,0,0,0,2,0,2,0.2857142857142857,2,0.0,0,0,0,0,0,0,0,2,0,0,2,1
5094,99206,cKCzrCCCXe9nkBgWepq9AEXje7SITRTz,G8EPVSXsOYB5YQWZGiz1aVq5Pgr2GrQu,1,0,0,0,0,0,2,0,2,0.2857142857142857,2,0.0,0,0,0,0,0,0,0,2,0,0,2,1
5095,99214,cKCzrCCCXe9nkBgWepq9AEXje7SITRTz,A3fsA9Zfv1X2fVEQhTw51lKENdNrEqT3,1,0,0,0,0,0,2,0,2,0.2857142857142857,2,0.0,0,0,0,0,0,0,0,2,0,0,2,1
5096,99221,wMqCiRTcG9DrOFV3mIQWVG2TWCqZLDsf,G8EPVSXsOYB5YQWZGiz1aVq5Pgr2GrQu,10,8,5,0,2,44,9,1,69,9.857142857142858,3,0.0,0,5,0,2,8,44,0,9,1,7,62,1
5097,99223,TBKTMcAi6pddCN8hy5SiGUXjC5YxeY5H,SpATywNh6bZuzm8s1ceuBUnMUAeoAHHw,8,2,1,0,1,0,6,0,10,1.4285714285714286,1,0.0,0,1,0,1,2,0,0,6,0,2,8,1
5098,99232,cdtMETRRUGW6e2sQh5Xd2C69HmYkARZ5,SpATywNh6bZuzm8s1ceuBUnMUAeoAHHw,7,6,0,0,0,1,3,0,10,1.4285714285714286,1,0.0,0,0,0,0,6,1,0,3,0,0,10,1
5099,99237,LHfLvP0G4hEksRdVPdjxg85LuBgQzx3S,bWdj2GDclj5ofokWjzoa5jAwMkxCykd6,3,4,1,0,0,0,2,0,7,1.0,1,0.0,2,1,0,0,2,0,0,2,0,3,4,0
5100,99243,T0WYTVwYJgFl0x8drZ3acqWyc5rt9vgS,A3fsA9Zfv1X2fVEQhTw51lKENdNrEqT3,1,0,0,0,0,0,1,0,1,0.14285714285714285,1,0.0,0,0,0,0,0,0,0,1,0,0,1,1
5101,99269,Ft3L9H2tidLSHsWi4FR179aCWB2oFssD,SpATywNh6bZuzm8s1ceuBUnMUAeoAHHw,9,3,2,0,2,0,6,0,13,1.8571428571428572,2,0.0,0,2,0,2,3,0,0,6,0,4,9,1
5102,99280,Zm35PP1kxKgQnBdrsL9FDU6gwqPBncBy,A3fsA9Zfv1X2fVEQhTw51lKENdNrEqT3,1,0,0,0,0,0,2,0,2,0.2857142857142857,1,0.0,0,0,0,0,0,0,0,2,0,0,2,1
5103,99292,KQNAn65G00s1hNhpNIZbIlQjdMIvn0te,G8EPVSXsOYB5YQWZGiz1aVq5Pgr2GrQu,2,0,0,0,0,2,1,0,3,0.42857142857142855,1,0.0,0,0,0,0,0,2,0,1,0,0,3,1
5104,99336,3gXjYz3VFr0TvsDYUgKtksPt5WrPBmEo,SpATywNh6bZuzm8s1ceuBUnMUAeoAHHw,28,58,30,22,9,0,17,0,136,19.428571428571427,9,0.0,12,30,21,9,46,0,1,17,0,72,64,0
5105,99371,7M1gTpajHgYWFRBJBTE3YPlAjNYb9gfx,G8EPVSXsOYB5YQWZGiz1aVq5Pgr2GrQu,1,0,0,0,0,0,1,0,1,0.14285714285714285,1,0.0,0,0,0,0,0,0,0,1,0,0,1,1
5106,99373,hJa6EP3vokxemW59iPrCWIQh0FEzTU7g,SpATywNh6bZuzm8s1ceuBUnMUAeoAHHw,10,11,1,17,1,0,2,0,32,4.571428571428571,1,0.0,6,1,15,1,5,0,2,2,0,23,9,1
5107,99376,aj90O66SXOM5h12FqdZrbSHiEhNvI2bA,SpATywNh6bZuzm8s1ceuBUnMUAeoAHHw,7,3,1,0,1,0,4,0,9,1.2857142857142858,1,0.0,1,1,0,1,2,0,0,4,0,3,6,1
5108,99400,q7MIcgFTiHmr8BKHm7XlaHNh6w8Fx7eG,A3fsA9Zfv1X2fVEQhTw51lKENdNrEqT3,1,0,0,0,0,0,1,0,1,0.14285714285714285,1,0.0,0,0,0,0,0,0,0,1,0,0,1,1
5109,99403,BSIRDTutz8KkNQ3VOx9kKk09R8urb0Ri,A3fsA9Zfv1X2fVEQhTw51lKENdNrEqT3,16,23,10,0,9,2,4,0,48,6.857142857142857,2,0.0,1,10,0,9,22,2,0,4,0,20,28,1
5110,99407,pC4iK2nDWej1Ecj7cZAC5BA8XCgOmZJi,bWdj2GDclj5ofokWjzoa5jAwMkxCykd6,3,0,0,0,0,1,2,0,3,0.42857142857142855,1,0.0,0,0,0,0,0,1,0,2,0,0,3,1
5111,99414,FbLnPRUJ3cO7BepRzJ4PsDHt79T7vpl0,SpATywNh6bZuzm8s1ceuBUnMUAeoAHHw,13,31,10,16,4,10,4,0,75,10.714285714285714,3,0.0,12,10,14,4,19,10,2,4,0,40,35,1
5112,99417,rAtBVPfi6wGHmo9go039lvWtKolaTQH4,SpATywNh6bZuzm8s1ceuBUnMUAeoAHHw,9,15,2,6,0,1,3,0,27,3.857142857142857,2,0.0,2,2,5,0,13,1,1,3,0,9,18,1
5113,99426,Uij5k6d5krJ4mWqsJUOAHKJ3rKlnctQu,A3fsA9Zfv1X2fVEQhTw51lKENdNrEqT3,1,0,0,0,0,0,1,0,1,0.14285714285714285,1,0.0,0,0,0,0,0,0,0,1,0,0,1,1
5114,99448,OLHje3sy9oD0UuSdVmOH9aE7DHL6V9Rf,G8EPVSXsOYB5YQWZGiz1aVq5Pgr2GrQu,2,0,0,0,0,0,3,0,3,0.42857142857142855,1,0.0,0,0,0,0,0,0,0,3,0,0,3,1
5115,99455,FBwWi8qV5T9PVUUQgTFb6EjAi12CMavu,SpATywNh6bZuzm8s1ceuBUnMUAeoAHHw,1,0,0,0,0,0,1,0,1,0.14285714285714285,1,0.0,0,0,0,0,0,0,0,1,0,0,1,1
5116,99464,VFYk1GyeJyGqK1t09cLe0E5m7KsULmvc,SpATywNh6bZuzm8s1ceuBUnMUAeoAHHw,24,46,25,4,14,6,10,1,106,15.142857142857142,6,0.0,0,25,3,14,46,6,1,10,1,42,64,1
5117,99470,H1SXscwZbeBIGdJtjznbLlFWKEefKgS4,A3fsA9Zfv1X2fVEQhTw51lKENdNrEqT3,9,7,3,0,3,0,4,0,17,2.4285714285714284,2,0.0,0,3,0,3,7,0,0,4,0,6,11,1
5118,99505,dDLv4oouOmVB45Y4hnRyV7IUqT7tMKiq,bWdj2GDclj5ofokWjzoa5jAwMkxCykd6,5,2,1,0,1,1,3,0,8,1.1428571428571428,1,0.0,0,1,0,1,2,1,0,3,0,2,6,1
5119,99527,4wk7mOQJdY2Tc4re4huOqsVY4BWqzpwG,SpATywNh6bZuzm8s1ceuBUnMUAeoAHHw,6,4,1,0,1,0,2,0,8,1.1428571428571428,1,0.0,0,1,0,1,4,0,0,2,0,2,6,1
5120,99558,qxVdjGWmrHaAXtxLFdUqWOB5LTvLLOy9,SpATywNh6bZuzm8s1ceuBUnMUAeoAHHw,13,15,1,3,0,8,7,0,34,4.857142857142857,1,0.0,6,1,3,0,9,8,0,7,0,10,24,1
5121,99566,WpcBrbawQCY5l6KXuhzbDIXB3ksftawE,SpATywNh6bZuzm8s1ceuBUnMUAeoAHHw,9,15,0,8,0,0,1,0,24,3.4285714285714284,1,0.0,10,0,8,0,5,0,0,1,0,18,6,1
5122,99568,oRL4hbvIrWhhsMx6uS8zWxFrJBWT9qS8,SpATywNh6bZuzm8s1ceuBUnMUAeoAHHw,8,2,1,0,1,1,6,1,12,1.7142857142857142,1,0.0,0,1,0,1,2,1,0,6,1,2,10,1
5123,99583,qe1lbudcDc26TUDIjWwsWCMadyJdvBEX,G8EPVSXsOYB5YQWZGiz1aVq5Pgr2GrQu,4,2,1,0,1,0,1,0,5,0.7142857142857143,1,0.0,0,1,0,1,2,0,0,1,0,2,3,1
5124,99663,9jzVaD1WPdcDwGhb2eIEjRQirdvM6f1C,bWdj2GDclj5ofokWjzoa5jAwMkxCykd6,1,0,0,0,0,0,1,0,1,0.14285714285714285,1,0.0,0,0,0,0,0,0,0,1,0,0,1,1
5125,99677,IL1F6pxCqZ5QZxZqthAXWrxFzw6RlKfD,SpATywNh6bZuzm8s1ceuBUnMUAeoAHHw,4,2,1,0,1,0,1,0,5,0.7142857142857143,1,0.0,0,1,0,1,2,0,0,1,0,2,3,1
5126,99682,MKYE6pEwq1YWgBTN9g77yl7jNJ14fFVC,SpATywNh6bZuzm8s1ceuBUnMUAeoAHHw,13,9,0,15,0,4,7,1,36,5.142857142857143,2,0.0,2,0,13,0,7,4,2,7,1,15,21,1
5127,99697,nGESIoGySD5XO5mI6jFhqZA6YIAniYb4,SpATywNh6bZuzm8s1ceuBUnMUAeoAHHw,5,2,0,0,0,0,3,1,6,0.8571428571428571,1,0.0,0,0,0,0,2,0,0,3,1,0,6,1
5128,99707,xg8dkQPzve0MzcpgxvEsbKyY4VwKrxAC,bWdj2GDclj5ofokWjzoa5jAwMkxCykd6,2,0,0,0,0,0,2,0,2,0.2857142857142857,1,0.0,0,0,0,0,0,0,0,2,0,0,2,1
5129,99721,i4u0VWs6ASAfOx6UbgpWUmxBkJHoZ0lf,SpATywNh6bZuzm8s1ceuBUnMUAeoAHHw,11,29,1,8,0,6,7,0,51,7.285714285714286,2,0.0,2,1,7,0,27,6,1,7,0,10,41,1
5130,99722,F5WXvUA8z1Vfdvlva1pujweut7tGE04r,A3fsA9Zfv1X2fVEQhTw51lKENdNrEqT3,6,3,1,0,0,2,5,1,12,1.7142857142857142,3,0.0,0,1,0,0,3,2,0,5,1,1,11,1
5131,99746,wfbRnjTCW6bqPFwlexPPeehj3HWJM2LV,SpATywNh6bZuzm8s1ceuBUnMUAeoAHHw,6,5,1,0,0,2,3,1,12,1.7142857142857142,1,0.0,0,1,0,0,5,2,0,3,1,1,11,1
5132,99776,s1C9M00kZ3td5Y1QHJpo6evzlHG7Bu17,A3fsA9Zfv1X2fVEQhTw51lKENdNrEqT3,1,0,0,0,0,0,1,0,1,0.14285714285714285,1,0.0,0,0,0,0,0,0,0,1,0,0,1,1
5133,99777,1umo7etGwkx7NcpFxVialzDD37NdyqRT,SpATywNh6bZuzm8s1ceuBUnMUAeoAHHw,14,23,9,12,4,1,4,0,53,7.571428571428571,3,0.0,11,9,12,4,12,1,0,4,0,36,17,0
5134,99801,Z4v9dtdXvLGvBdUbEHKilzESZFJ5MomJ,A3fsA9Zfv1X2fVEQhTw51lKENdNrEqT3,1,0,0,0,0,0,1,0,1,0.14285714285714285,1,0.0,0,0,0,0,0,0,0,1,0,0,1,1
5135,99803,wRn9VzYdznEJJbl33573ksufDlNbloBs,SpATywNh6bZuzm8s1ceuBUnMUAeoAHHw,1,0,0,0,0,0,1,0,1,0.14285714285714285,1,0.0,0,0,0,0,0,0,0,1,0,0,1,1
5136,99820,FW9yCFN4uGknAcdu3E5QkbxhIgnspzES,bWdj2GDclj5ofokWjzoa5jAwMkxCykd6,1,0,0,0,0,0,1,0,1,0.14285714285714285,1,0.0,0,0,0,0,0,0,0,1,0,0,1,1
5137,99830,l0hVKXTPSdIHJhYbRQF17YM8eZTkWoXS,SpATywNh6bZuzm8s1ceuBUnMUAeoAHHw,3,2,0,0,0,0,2,0,4,0.5714285714285714,1,0.0,0,0,0,0,2,0,0,2,0,0,4,1
5138,99841,l0hVKXTPSdIHJhYbRQF17YM8eZTkWoXS,bWdj2GDclj5ofokWjzoa5jAwMkxCykd6,1,0,0,0,0,0,1,0,1,0.14285714285714285,1,0.0,0,0,0,0,0,0,0,1,0,0,1,1
5139,99845,neKK2ykNimyF7kqeZQOYIIEzgIv0MPcH,RXDvfPUBYFlVdlueBFbLW0mhhAyGEqpt,5,2,1,0,1,0,2,0,6,0.8571428571428571,1,0.0,0,1,0,1,2,0,0,2,0,2,4,1
5140,99854,FQLZyFqiWjNudHf8Xwrwvb0mFmqAZa3g,SpATywNh6bZuzm8s1ceuBUnMUAeoAHHw,1,0,0,0,0,0,1,0,1,0.14285714285714285,1,0.0,0,0,0,0,0,0,0,1,0,0,1,1
5141,99860,Q8SrRVeWzJizOf34g4fWFcHi3GfFJHUN,SpATywNh6bZuzm8s1ceuBUnMUAeoAHHw,23,37,19,20,8,2,10,1,97,13.857142857142858,3,0.0,8,19,17,8,29,2,3,10,1,52,45,1
5142,99868,Qu1AvUJr7Rf2PLTyoAjhLhIJ5dIRQjGn,SpATywNh6bZuzm8s1ceuBUnMUAeoAHHw,8,7,6,0,2,0,2,0,17,2.4285714285714284,1,0.0,0,6,0,2,7,0,0,2,0,8,9,1
5143,99897,Qd7FMxYi2RP0CzetZmwspMbrYY8Z7160,G8EPVSXsOYB5YQWZGiz1aVq5Pgr2GrQu,2,0,0,0,0,0,2,0,2,0.2857142857142857,1,0.0,0,0,0,0,0,0,0,2,0,0,2,1
5144,99912,MW4oBOQoe8OTcAvm3yfi1VDCozBvyTdm,G8EPVSXsOYB5YQWZGiz1aVq5Pgr2GrQu,1,0,0,0,0,0,1,0,1,0.14285714285714285,1,0.0,0,0,0,0,0,0,0,1,0,0,1,1
5145,99931,T0V1MC6bsX3mZxJfTJfqpva6BwB6iZOI,RXDvfPUBYFlVdlueBFbLW0mhhAyGEqpt,4,0,0,0,0,0,3,1,4,0.5714285714285714,1,0.0,0,0,0,0,0,0,0,3,1,0,4,1
5146,99966,cUJIvx4QB7gYkEkbk184VKn3Y3N8dBd7,RXDvfPUBYFlVdlueBFbLW0mhhAyGEqpt,1,0,0,0,0,0,1,0,1,0.14285714285714285,1,0.0,0,0,0,0,0,0,0,1,0,0,1,1
5147,99979,oUNptzxKR6Tg3LMdUCW3RAFgD2fbf3ju,G8EPVSXsOYB5YQWZGiz1aVq5Pgr2GrQu,1,0,0,0,0,0,1,0,1,0.14285714285714285,1,0.0,0,0,0,0,0,0,0,1,0,0,1,1
5148,99981,irIVLRvkXyea4TMdg5wZQ17APoQLOStn,bWdj2GDclj5ofokWjzoa5jAwMkxCykd6,3,2,0,0,0,0,1,0,3,0.42857142857142855,1,0.0,0,0,0,0,2,0,0,1,0,0,3,1
5149,100046,uqIn0vdfJ1SDJCOeCVEAQPRFBBKQA2eB,RXDvfPUBYFlVdlueBFbLW0mhhAyGEqpt,1,0,0,0,0,0,1,0,1,0.14285714285714285,1,0.0,0,0,0,0,0,0,0,1,0,0,1,1
5150,100048,ZmILkESSKwaUf7dlv2MYezsPM9kEgn0g,SpATywNh6bZuzm8s1ceuBUnMUAeoAHHw,1,0,0,0,0,0,1,0,1,0.14285714285714285,1,0.0,0,0,0,0,0,0,0,1,0,0,1,1
5151,100065,C79HFTpOf1aC6aMRuXhus1qHumhqEAFk,SpATywNh6bZuzm8s1ceuBUnMUAeoAHHw,18,24,2,20,2,5,14,1,68,9.714285714285714,3,0.0,6,2,16,2,18,5,4,14,1,26,42,0
5152,100089,9MPGQ80LKMiZcqzI4e7ZT4LxgluBoFal,SpATywNh6bZuzm8s1ceuBUnMUAeoAHHw,12,14,2,0,1,0,6,2,25,3.5714285714285716,1,0.0,4,2,0,1,10,0,0,6,2,7,18,1
5153,100105,MKNBl3hhuuRZuBxyPOWBVV1OHzyXBuxg,SpATywNh6bZuzm8s1ceuBUnMUAeoAHHw,28,54,27,24,11,2,7,0,125,17.857142857142858,3,0.0,10,27,22,11,44,2,2,7,0,70,55,0
5154,100136,zhtf7EZUjW6s3Guz5lXD8KDXJ4lw9cuB,RXDvfPUBYFlVdlueBFbLW0mhhAyGEqpt,18,11,6,31,6,0,4,0,58,8.285714285714286,2,0.0,4,6,29,6,7,0,2,4,0,45,13,1
5155,100176,pfwNUWwL0srYZTJGvtMmP5xqlr01qeDv,bWdj2GDclj5ofokWjzoa5jAwMkxCykd6,4,2,0,0,0,0,9,0,11,1.5714285714285714,2,0.0,0,0,0,0,2,0,0,9,0,0,11,1
5156,100177,CD5yEeFA8Zn4o0HC0sLfKl1HGxKwer5w,A3fsA9Zfv1X2fVEQhTw51lKENdNrEqT3,1,0,0,0,0,0,2,0,2,0.2857142857142857,1,0.0,0,0,0,0,0,0,0,2,0,0,2,1
5157,100200,walE7JsvJqHl8yLz0PR8Oim32Lz4OIQ0,SpATywNh6bZuzm8s1ceuBUnMUAeoAHHw,18,36,6,14,1,20,23,1,101,14.428571428571429,3,0.0,19,6,13,1,17,20,1,23,1,39,62,1
5158,100208,oakvvUa4BMx0VOuNxMNhZr6bo8hbB626,SpATywNh6bZuzm8s1ceuBUnMUAeoAHHw,4,0,0,0,0,0,4,0,4,0.5714285714285714,1,0.0,0,0,0,0,0,0,0,4,0,0,4,1
5159,100216,iukICc3JPXkGjh0WhluWsphhopQF3KWw,SpATywNh6bZuzm8s1ceuBUnMUAeoAHHw,8,8,4,0,0,0,6,0,18,2.5714285714285716,2,0.0,0,4,0,0,8,0,0,6,0,4,14,1
5160,100243,CyLrnwOuvkEKQhwjogaYhZvzxTeqKBge,A3fsA9Zfv1X2fVEQhTw51lKENdNrEqT3,1,0,0,0,0,0,1,0,1,0.14285714285714285,1,0.0,0,0,0,0,0,0,0,1,0,0,1,1
5161,100244,3jzy20tHqZfBlzIZRWQh7hEsGbNNyC02,SpATywNh6bZuzm8s1ceuBUnMUAeoAHHw,5,2,1,0,1,0,2,0,6,0.8571428571428571,1,0.0,0,1,0,1,2,0,0,2,0,2,4,1
5162,100249,XyoP35cBUiKk44G72mbtEXCBjk8FmHfo,SpATywNh6bZuzm8s1ceuBUnMUAeoAHHw,15,12,6,18,3,3,5,0,47,6.714285714285714,2,0.0,2,6,14,3,10,3,4,5,0,25,22,1
5163,100257,8IdCnPo0KQab6PkHRu5Y6zvRlgGVQPUd,RXDvfPUBYFlVdlueBFbLW0mhhAyGEqpt,21,100,22,0,17,0,8,0,147,21.0,3,0.0,7,22,0,17,93,0,0,8,0,46,101,1
5164,100265,McYATdhZDDMDpni6a4GbjI06ustMpvdV,SpATywNh6bZuzm8s1ceuBUnMUAeoAHHw,3,0,0,0,0,1,2,0,3,0.42857142857142855,2,0.0,0,0,0,0,0,1,0,2,0,0,3,1
5165,100266,n2r6kyDnsWpbtliBFHcr0YWSTfVt0HhQ,G8EPVSXsOYB5YQWZGiz1aVq5Pgr2GrQu,17,18,1,12,1,1,5,1,39,5.571428571428571,2,0.0,8,1,6,1,10,1,6,5,1,16,23,1
5166,100294,G7KJV0aUuu9N2GhQ0BQmtfVIkYBSsISM,SpATywNh6bZuzm8s1ceuBUnMUAeoAHHw,15,70,32,16,16,2,8,0,144,20.571428571428573,3,0.0,9,32,15,16,61,2,1,8,0,72,72,1
5167,100360,09033btLbIofAoxmgr9GoACTYHCpwfe7,SpATywNh6bZuzm8s1ceuBUnMUAeoAHHw,5,3,1,0,1,0,1,0,6,0.8571428571428571,1,0.0,0,1,0,1,3,0,0,1,0,2,4,1
5168,100375,FMxvsapRPXXXNxGG3GDsHR7zl4E2ofKu,A3fsA9Zfv1X2fVEQhTw51lKENdNrEqT3,1,0,0,0,0,0,2,0,2,0.2857142857142857,1,0.0,0,0,0,0,0,0,0,2,0,0,2,1
5169,100382,dDpqWlhYBkdNBy4JfnDE71OkEoQKGKDx,bWdj2GDclj5ofokWjzoa5jAwMkxCykd6,10,6,3,4,3,0,4,0,20,2.857142857142857,1,0.0,2,3,4,3,4,0,0,4,0,12,8,0
5170,100389,Q9YOU7BuWjkOYwh9pr1oIgYKYXPPRz5K,RXDvfPUBYFlVdlueBFbLW0mhhAyGEqpt,49,47,26,109,16,2,7,0,207,29.571428571428573,7,0.0,13,26,101,16,34,2,8,7,0,156,51,0
5171,100462,MRV5bQ8CaXcdaRHJL4krm33UMDJEAYUq,SpATywNh6bZuzm8s1ceuBUnMUAeoAHHw,1,0,0,0,0,0,1,0,1,0.14285714285714285,1,0.0,0,0,0,0,0,0,0,1,0,0,1,1
5172,100518,6DFg8IrvITdyV3FmRQrzgnl2oAgir5Pb,SpATywNh6bZuzm8s1ceuBUnMUAeoAHHw,28,43,12,24,6,13,20,1,119,17.0,4,0.0,8,12,21,6,35,13,3,20,1,47,72,0
5173,100563,IVE4TocWI6FDY4RoOKamDYCfOcH2PbRL,SpATywNh6bZuzm8s1ceuBUnMUAeoAHHw,12,26,0,15,0,25,5,0,71,10.142857142857142,1,0.0,18,0,15,0,8,25,0,5,0,33,38,1
5174,100566,O9Ff0eipZjXCZhuBVdpYtN4eMe1OZ5wo,SpATywNh6bZuzm8s1ceuBUnMUAeoAHHw,5,3,1,0,1,0,2,0,7,1.0,1,0.0,0,1,0,1,3,0,0,2,0,2,5,1
5175,100567,Is7lqncTs1EDN9QmzrTbcU6KnB0BCGNX,SpATywNh6bZuzm8s1ceuBUnMUAeoAHHw,11,11,5,0,3,1,9,1,30,4.285714285714286,2,0.0,3,5,0,3,8,1,0,9,1,11,19,1
5176,100592,1W42KMSdpCt6ldPd7y6qVJ23jr8xz7L8,SpATywNh6bZuzm8s1ceuBUnMUAeoAHHw,5,3,1,0,1,0,2,0,7,1.0,1,0.0,1,1,0,1,2,0,0,2,0,3,4,1
5177,100595,MdGTO2svRwIj7bz3FYKLlYB5eW0NcpSb,SpATywNh6bZuzm8s1ceuBUnMUAeoAHHw,16,17,7,20,4,0,5,1,54,7.714285714285714,1,0.0,5,7,16,4,12,0,4,5,1,32,22,0
5178,100611,qrBxOx4xvfJbTRNtYXFo4mMHRch3LE9R,A3fsA9Zfv1X2fVEQhTw51lKENdNrEqT3,1,0,0,0,0,0,1,0,1,0.14285714285714285,1,0.0,0,0,0,0,0,0,0,1,0,0,1,1
5179,100640,NfAbLg5OeUTUtF15GhHCETvzoFPtTDPd,SpATywNh6bZuzm8s1ceuBUnMUAeoAHHw,20,29,3,30,0,25,20,0,107,15.285714285714286,5,0.0,7,3,28,0,22,25,2,20,0,38,69,1
5180,100662,DfabbQQ3v42eWYnRYIQLMUYykm14gtcZ,A3fsA9Zfv1X2fVEQhTw51lKENdNrEqT3,1,0,0,0,0,0,1,0,1,0.14285714285714285,1,0.0,0,0,0,0,0,0,0,1,0,0,1,1
5181,100670,RApdsmrncG4ay8F6bpKxBswTJBXZ7CEo,SpATywNh6bZuzm8s1ceuBUnMUAeoAHHw,11,7,6,0,9,0,27,0,49,7.0,3,0.0,0,6,0,9,7,0,0,27,0,15,34,1
5182,100686,sFr2RCMewYMYiXOoTtSwzbAYMNnrzmY5,SpATywNh6bZuzm8s1ceuBUnMUAeoAHHw,9,3,3,0,2,0,3,0,11,1.5714285714285714,1,0.0,0,3,0,2,3,0,0,3,0,5,6,1
5183,100711,dGI6yveNenjFfT8c0PjNzk1ugu0VsvkU,SpATywNh6bZuzm8s1ceuBUnMUAeoAHHw,10,6,3,0,3,0,4,1,17,2.4285714285714284,1,0.0,1,3,0,3,5,0,0,4,1,7,10,1
5184,100731,vt827MYpYgT0JKXBC62SZ24Gxa8OJ87k,SpATywNh6bZuzm8s1ceuBUnMUAeoAHHw,4,3,0,0,0,0,2,0,5,0.7142857142857143,1,0.0,0,0,0,0,3,0,0,2,0,0,5,1
5185,100736,uJVJyY1XUciqhggpcXtgNPSVAHeYLBGB,G8EPVSXsOYB5YQWZGiz1aVq5Pgr2GrQu,9,14,4,0,0,0,4,0,22,3.142857142857143,2,0.0,0,4,0,0,14,0,0,4,0,4,18,1
5186,100740,MFMS4D6VcY65iaLs08cZFKnb6UYd2dkX,SpATywNh6bZuzm8s1ceuBUnMUAeoAHHw,1,0,0,0,0,0,1,0,1,0.14285714285714285,1,0.0,0,0,0,0,0,0,0,1,0,0,1,1
5187,100744,tMihxLso3qJJt2vQUNT2SznMjAGohiuT,SpATywNh6bZuzm8s1ceuBUnMUAeoAHHw,7,3,1,0,1,1,5,1,12,1.7142857142857142,1,0.0,0,1,0,1,3,1,0,5,1,2,10,1
5188,100749,1AsQo0zAkltKFUhbJK8sQo8EMtQlw4Zw,A3fsA9Zfv1X2fVEQhTw51lKENdNrEqT3,10,10,6,0,2,2,8,0,28,4.0,5,0.0,0,6,0,2,10,2,0,8,0,8,20,1
5189,100754,UOjfyFlJmFc3i5kjWKRuDpWzrJIEqMHc,SpATywNh6bZuzm8s1ceuBUnMUAeoAHHw,2,0,0,0,0,0,2,0,2,0.2857142857142857,1,0.0,0,0,0,0,0,0,0,2,0,0,2,1
5190,100769,pjSCT01VrN3yLmICdcrZWQnnyzvIOi9x,SpATywNh6bZuzm8s1ceuBUnMUAeoAHHw,1,0,0,0,0,0,1,0,1,0.14285714285714285,1,0.0,0,0,0,0,0,0,0,1,0,0,1,1
5191,100794,Qj3zkBoKOajqBdArgJNrQ3sw89X3j0VX,SpATywNh6bZuzm8s1ceuBUnMUAeoAHHw,6,2,1,0,1,0,4,0,8,1.1428571428571428,1,0.0,0,1,0,1,2,0,0,4,0,2,6,1
5192,100859,xRb4cp7PVGLqlqc7BJgnld2XsE0F6wB3,SpATywNh6bZuzm8s1ceuBUnMUAeoAHHw,20,36,12,13,1,0,7,1,70,10.0,4,0.0,9,12,12,1,27,0,1,7,1,34,36,0
5193,100860,KFG6G55toGAeaWBt5UmyioW5n1NVxSjT,A3fsA9Zfv1X2fVEQhTw51lKENdNrEqT3,1,0,0,0,0,0,1,0,1,0.14285714285714285,1,0.0,0,0,0,0,0,0,0,1,0,0,1,1
5194,100863,VOKNou0BOm9l4CocxGjdRfkeAbtz86uT,SpATywNh6bZuzm8s1ceuBUnMUAeoAHHw,7,7,2,0,0,10,12,3,34,4.857142857142857,2,0.0,1,2,0,0,6,10,0,12,3,3,31,1
5195,100872,ES4n41HdZ3mzmajBMbCDY4C23oBD6LSY,RXDvfPUBYFlVdlueBFbLW0mhhAyGEqpt,9,7,5,0,2,0,3,0,17,2.4285714285714284,1,0.0,0,5,0,2,7,0,0,3,0,7,10,1
5196,100885,GpdW10m4i4o8zebocaIwKcYTi9ALrnVK,SpATywNh6bZuzm8s1ceuBUnMUAeoAHHw,1,0,0,0,0,0,2,0,2,0.2857142857142857,1,0.0,0,0,0,0,0,0,0,2,0,0,2,1
5197,100901,3ZkHeNhSscgbNC1k9L8lbe6SROwSZPLx,SpATywNh6bZuzm8s1ceuBUnMUAeoAHHw,4,0,0,0,0,1,8,0,9,1.2857142857142858,1,0.0,0,0,0,0,0,1,0,8,0,0,9,1
5198,100936,QAQOQC9orxaSCK47wTUjk6OT4uXNA4IV,RXDvfPUBYFlVdlueBFbLW0mhhAyGEqpt,1,0,0,0,0,0,1,0,1,0.14285714285714285,1,0.0,0,0,0,0,0,0,0,1,0,0,1,1
5199,100939,QJcScxtP8sOhNP5cvZ8cp3A76mQqjuPz,SpATywNh6bZuzm8s1ceuBUnMUAeoAHHw,5,2,1,0,1,0,2,0,6,0.8571428571428571,1,0.0,0,1,0,1,2,0,0,2,0,2,4,1
5200,100951,dpzYaESA6MCFHXGYe2bLHvSr1kNOP50p,SpATywNh6bZuzm8s1ceuBUnMUAeoAHHw,1,0,0,0,0,0,1,0,1,0.14285714285714285,1,0.0,0,0,0,0,0,0,0,1,0,0,1,1
5201,100967,pdDWSL0qqW5lqoVLDvyIeqmUWuTqLvQ6,bWdj2GDclj5ofokWjzoa5jAwMkxCykd6,2,0,0,0,0,0,2,0,2,0.2857142857142857,1,0.0,0,0,0,0,0,0,0,2,0,0,2,1
5202,100982,1QJEJ5a9sT1rwzf5IhaKshE565OOWiB4,G8EPVSXsOYB5YQWZGiz1aVq5Pgr2GrQu,6,5,2,0,2,0,1,0,10,1.4285714285714286,1,0.0,0,2,0,2,5,0,0,1,0,4,6,1
5203,100989,MaNbEqxyOcaRJ63ZfC9DudJtV0A5y3yK,SpATywNh6bZuzm8s1ceuBUnMUAeoAHHw,26,33,14,46,3,13,11,2,122,17.428571428571427,2,0.0,12,14,38,3,21,13,8,11,2,67,55,0
5204,100992,pdDWSL0qqW5lqoVLDvyIeqmUWuTqLvQ6,A3fsA9Zfv1X2fVEQhTw51lKENdNrEqT3,1,0,0,0,0,0,1,0,1,0.14285714285714285,1,0.0,0,0,0,0,0,0,0,1,0,0,1,1
5205,101003,XPA1Jv5NXHfUcU7CMUA4EKvCqSxl1bO3,RXDvfPUBYFlVdlueBFbLW0mhhAyGEqpt,1,0,0,0,0,0,1,0,1,0.14285714285714285,1,0.0,0,0,0,0,0,0,0,1,0,0,1,1
5206,101033,eWW5LWmp2L4jfpnZTKTrpHZw2NPytGoT,G8EPVSXsOYB5YQWZGiz1aVq5Pgr2GrQu,2,0,0,0,0,0,2,0,2,0.2857142857142857,1,0.0,0,0,0,0,0,0,0,2,0,0,2,1
5207,101041,R5b8KqsMsDfKAxdLfUK6LRx0WUFDD5Xb,bWdj2GDclj5ofokWjzoa5jAwMkxCykd6,10,19,0,10,0,3,4,1,37,5.285714285714286,2,0.0,5,0,9,0,14,3,1,4,1,14,23,1
5208,101044,0MInlyhRLhTct7ctvAmGIMuZ2WCCEQOJ,bWdj2GDclj5ofokWjzoa5jAwMkxCykd6,1,0,0,0,0,0,1,0,1,0.14285714285714285,1,0.0,0,0,0,0,0,0,0,1,0,0,1,1
5209,101045,PCtqctDcjJHl3GW7yk0aug87eqbAmlqT,SpATywNh6bZuzm8s1ceuBUnMUAeoAHHw,22,26,3,32,1,0,9,0,71,10.142857142857142,3,0.0,4,3,28,1,22,0,4,9,0,36,35,1
5210,101047,MhrFHIexWYn2dilUXh03cpnfpoe9tMBe,bWdj2GDclj5ofokWjzoa5jAwMkxCykd6,1,0,0,0,0,0,1,0,1,0.14285714285714285,1,0.0,0,0,0,0,0,0,0,1,0,0,1,1
5211,101059,H4F1BzGEbgWgPoxlFORCSmUf8fAP6V7l,RXDvfPUBYFlVdlueBFbLW0mhhAyGEqpt,13,12,4,6,1,0,7,0,30,4.285714285714286,2,0.0,2,4,6,1,10,0,0,7,0,13,17,1
5212,101074,D9nQsPz9172rPurdQOY1oS88oPJMaAUd,bWdj2GDclj5ofokWjzoa5jAwMkxCykd6,13,40,1,26,2,19,14,0,102,14.571428571428571,3,0.0,7,1,21,2,33,19,5,14,0,31,71,1
5213,101091,NbOkuaMYNn1DiAgigOMCG3fDUQt3bFUa,SpATywNh6bZuzm8s1ceuBUnMUAeoAHHw,13,42,14,13,0,33,13,1,116,16.571428571428573,3,0.0,21,14,13,0,21,33,0,13,1,48,68,1
5214,101098,Jxd0Gyi2eFjuuzujg1eSA5QBX1QonMfb,bWdj2GDclj5ofokWjzoa5jAwMkxCykd6,11,12,10,0,7,0,8,3,40,5.714285714285714,2,0.0,0,10,0,7,12,0,0,8,3,17,23,1
5215,101103,KxUegLpOtUB19LVwgBAOjYKSbicZaJLZ,SpATywNh6bZuzm8s1ceuBUnMUAeoAHHw,5,15,1,0,0,0,4,0,20,2.857142857142857,4,0.0,0,1,0,0,15,0,0,4,0,1,19,0
5216,101112,wnkgyfR4roxhmJZsqCCxH9EfyI2qd5YM,SpATywNh6bZuzm8s1ceuBUnMUAeoAHHw,5,3,2,0,2,0,3,0,10,1.4285714285714286,2,0.0,0,2,0,2,3,0,0,3,0,4,6,1
5217,101122,B0jVKFlvXfKwVR9pXnhJZcf2VbxqeEJP,RXDvfPUBYFlVdlueBFbLW0mhhAyGEqpt,7,3,2,0,2,0,2,0,9,1.2857142857142858,2,0.0,0,2,0,2,3,0,0,2,0,4,5,1
5218,101125,B0jVKFlvXfKwVR9pXnhJZcf2VbxqeEJP,A3fsA9Zfv1X2fVEQhTw51lKENdNrEqT3,1,0,0,0,0,0,1,0,1,0.14285714285714285,1,0.0,0,0,0,0,0,0,0,1,0,0,1,1
5219,101130,4TBbHxtdM6KlXwrDZvHlXfXL45mqy6bL,SpATywNh6bZuzm8s1ceuBUnMUAeoAHHw,13,38,10,0,2,0,12,0,62,8.857142857142858,5,0.0,1,10,0,2,37,0,0,12,0,13,49,1
5220,101137,nnpMilWm5u9YfSzlEw0i8QiLM3F4GePR,G8EPVSXsOYB5YQWZGiz1aVq5Pgr2GrQu,7,1,1,0,1,2,5,1,11,1.5714285714285714,1,0.0,0,1,0,1,1,2,0,5,1,2,9,1
5221,101141,2qEZpMTxWlr35xXuNBb8vvZZiY1soKKq,SpATywNh6bZuzm8s1ceuBUnMUAeoAHHw,5,5,0,0,0,0,4,0,9,1.2857142857142858,1,0.0,0,0,0,0,5,0,0,4,0,0,9,1
5222,101154,fnJf5uFFfrA3RuutRVGe8qQuGwat3ZCQ,SpATywNh6bZuzm8s1ceuBUnMUAeoAHHw,1,0,0,0,0,0,1,0,1,0.14285714285714285,1,0.0,0,0,0,0,0,0,0,1,0,0,1,1
5223,101186,gtKTzkXHwS41ljYVmjlLLf4WyQSkK02q,bWdj2GDclj5ofokWjzoa5jAwMkxCykd6,2,0,0,0,0,0,2,0,2,0.2857142857142857,1,0.0,0,0,0,0,0,0,0,2,0,0,2,1
5224,101189,yrhXE3OyNatOr3jElQ1DJhAKv2cy7Hqx,SpATywNh6bZuzm8s1ceuBUnMUAeoAHHw,1,0,0,0,0,0,1,0,1,0.14285714285714285,1,0.0,0,0,0,0,0,0,0,1,0,0,1,1
5225,101191,yrlVnbrSR0LAW13A08wi2wUW5yoGSw1G,bWdj2GDclj5ofokWjzoa5jAwMkxCykd6,1,0,0,0,0,0,1,0,1,0.14285714285714285,1,0.0,0,0,0,0,0,0,0,1,0,0,1,1
5226,101198,OCAzb1VfLGBRFoguhxZLxVaO4EgntnGi,A3fsA9Zfv1X2fVEQhTw51lKENdNrEqT3,15,11,8,0,6,4,14,1,44,6.285714285714286,2,0.0,0,8,0,6,11,4,0,14,1,14,30,1
5227,101201,YewrI0crAA2lhm09K28QZKb66KLxgFIr,SpATywNh6bZuzm8s1ceuBUnMUAeoAHHw,5,2,1,0,1,0,2,0,6,0.8571428571428571,1,0.0,0,1,0,1,2,0,0,2,0,2,4,1
5228,101219,NIlxh2g7VTAquieuVc9RGErPkOzbSh2Z,A3fsA9Zfv1X2fVEQhTw51lKENdNrEqT3,1,0,0,0,0,0,1,0,1,0.14285714285714285,1,0.0,0,0,0,0,0,0,0,1,0,0,1,1
5229,101223,MwRVXLIjs7ObnboXYRMgXHQa3UWpN5i5,SpATywNh6bZuzm8s1ceuBUnMUAeoAHHw,16,18,13,0,5,0,4,0,40,5.714285714285714,3,0.0,0,13,0,5,18,0,0,4,0,18,22,1
5230,101248,9FCTgAxdOH7TtkaWvHpzLeDt6G1gJ5Bo,bWdj2GDclj5ofokWjzoa5jAwMkxCykd6,14,8,4,20,4,0,8,0,44,6.285714285714286,1,0.0,3,4,19,4,5,0,1,8,0,30,14,1
5231,101259,lgjOCnqMh3jm1TNv306EqOQLtLVGnS97,SpATywNh6bZuzm8s1ceuBUnMUAeoAHHw,4,2,0,0,0,2,2,0,6,0.8571428571428571,1,0.0,0,0,0,0,2,2,0,2,0,0,6,1
5232,102824,WmG8kTcU8MK2hNkFFl9oxdCyXNm8K8Ej,7GRhBDsirIGkRZBtSMEzNTyDr2JQm4xx,1,0,0,0,0,0,1,0,1,0.14285714285714285,1,0.0,0,0,0,0,0,0,0,1,0,0,1,1
5233,102867,jSPgiXDCISXGmLFuOlDszBfMRRboKynI,A3fsA9Zfv1X2fVEQhTw51lKENdNrEqT3,1,0,0,0,0,0,1,0,1,0.14285714285714285,1,0.0,0,0,0,0,0,0,0,1,0,0,1,1
5234,102875,ovOrxCTVGxQyC9labPGJ3gKHEzv9s9aZ,bWdj2GDclj5ofokWjzoa5jAwMkxCykd6,1,0,0,0,0,0,1,0,1,0.14285714285714285,1,0.0,0,0,0,0,0,0,0,1,0,0,1,1
5235,102900,xwcqyIIcIUCDL9lZCj9OZxM9SjcoYp0H,SpATywNh6bZuzm8s1ceuBUnMUAeoAHHw,1,0,0,0,0,0,1,0,1,0.14285714285714285,1,0.0,0,0,0,0,0,0,0,1,0,0,1,1
5236,102920,e4IPxveF8RO3es6V6Od4YTjwU9tdhLXH,SpATywNh6bZuzm8s1ceuBUnMUAeoAHHw,1,0,0,0,0,0,1,0,1,0.14285714285714285,1,0.0,0,0,0,0,0,0,0,1,0,0,1,1
5237,102926,qoU1vhHFDDec5VkeyGO4XQ5CxMj2dkga,SpATywNh6bZuzm8s1ceuBUnMUAeoAHHw,1,0,0,0,0,0,1,0,1,0.14285714285714285,1,0.0,0,0,0,0,0,0,0,1,0,0,1,1
5238,102932,0zaZMwzUlPvudODMBJsoUQT9Stnqz6b0,SpATywNh6bZuzm8s1ceuBUnMUAeoAHHw,5,4,2,0,1,2,5,0,14,2.0,2,0.0,0,2,0,1,4,2,0,5,0,3,11,1
5239,102935,44A0UDfpSdZoyeaVNyFZyzOHFRBDzohf,A3fsA9Zfv1X2fVEQhTw51lKENdNrEqT3,2,0,0,0,0,0,3,0,3,0.42857142857142855,1,0.0,0,0,0,0,0,0,0,3,0,0,3,1
5240,102962,hQlXSGkScEDJBAZj2lP5Zs9i72B5KYMn,bWdj2GDclj5ofokWjzoa5jAwMkxCykd6,15,9,5,8,6,78,7,1,114,16.285714285714285,2,0.0,3,5,7,6,6,78,1,7,1,21,93,1
5241,102986,mLfiafLgtlHk6mFhbivnwgftpNV0VfBx,A3fsA9Zfv1X2fVEQhTw51lKENdNrEqT3,5,5,1,0,0,0,1,0,7,1.0,1,0.0,0,1,0,0,5,0,0,1,0,1,6,1
5242,103003,vkX2gJv5gCZeM2YeKQWeGJdzNJhrpKeU,SpATywNh6bZuzm8s1ceuBUnMUAeoAHHw,3,0,0,0,0,1,2,0,3,0.42857142857142855,1,0.0,0,0,0,0,0,1,0,2,0,0,3,0
5243,103004,9tN6QbOi425qNnZ8oxcgeFVfUtI2koh7,RXDvfPUBYFlVdlueBFbLW0mhhAyGEqpt,3,3,1,0,0,0,2,0,6,0.8571428571428571,1,0.0,0,1,0,0,3,0,0,2,0,1,5,0
5244,103011,A3hbg0sRzJCuZelHR2utUpF4kEQMHGoX,A3fsA9Zfv1X2fVEQhTw51lKENdNrEqT3,6,4,2,0,1,0,8,0,15,2.142857142857143,3,0.0,0,2,0,1,4,0,0,8,0,3,12,1
5245,103046,4dcb5500hUVpclJ4asFWqYt7G3CBRrnY,SpATywNh6bZuzm8s1ceuBUnMUAeoAHHw,1,0,0,0,0,0,1,0,1,0.14285714285714285,1,0.0,0,0,0,0,0,0,0,1,0,0,1,1
5246,103066,gLAW4GOuyz8JKg5RO5Sf2rzir65isCiq,SpATywNh6bZuzm8s1ceuBUnMUAeoAHHw,1,0,0,0,0,0,1,0,1,0.14285714285714285,1,0.0,0,0,0,0,0,0,0,1,0,0,1,1
5247,103131,KKoJVU8RPVKYX0YtUEw7IyEbFA7WdrnE,SpATywNh6bZuzm8s1ceuBUnMUAeoAHHw,28,31,11,40,6,0,7,0,95,13.571428571428571,3,0.0,10,11,34,6,21,0,6,7,0,61,34,0
5248,103133,pmbdGuMJDBIMvlssCxECy27GzvD3oiIB,SpATywNh6bZuzm8s1ceuBUnMUAeoAHHw,7,9,7,0,6,0,2,0,24,3.4285714285714284,2,0.0,0,7,0,6,9,0,0,2,0,13,11,1
5249,103138,EFMEoi5W4mceo8rjft5LKrYvvT3E2eat,RXDvfPUBYFlVdlueBFbLW0mhhAyGEqpt,2,0,0,0,0,0,2,0,2,0.2857142857142857,1,0.0,0,0,0,0,0,0,0,2,0,0,2,1
5250,103212,3GMOahsvICu1XQltlxIUR4GKvebsHIVx,SpATywNh6bZuzm8s1ceuBUnMUAeoAHHw,7,5,2,0,2,0,2,0,11,1.5714285714285714,1,0.0,0,2,0,2,5,0,0,2,0,4,7,1
5251,103220,8c2gk77rfHeG4kEZpifVHT547X2ayTNE,A3fsA9Zfv1X2fVEQhTw51lKENdNrEqT3,90,53,38,180,22,25,23,2,343,49.0,8,0.0,2,38,157,22,51,25,23,23,2,219,124,1
5252,103228,1xVduM1Mt4TlM51sUaZjO9TKdOfcUOIw,RXDvfPUBYFlVdlueBFbLW0mhhAyGEqpt,1,0,0,0,0,0,1,0,1,0.14285714285714285,1,0.0,0,0,0,0,0,0,0,1,0,0,1,1
5253,103272,tm8lPw8iVlVgbaJMBVyV1VDYMbk4uQOB,bWdj2GDclj5ofokWjzoa5jAwMkxCykd6,7,7,2,0,2,0,4,0,15,2.142857142857143,1,0.0,0,2,0,2,7,0,0,4,0,4,11,1
5254,103284,KmIlNo2pbRKBzhZUiCgI2YhiW6w8iosj,SpATywNh6bZuzm8s1ceuBUnMUAeoAHHw,1,0,0,0,0,0,1,0,1,0.14285714285714285,1,0.0,0,0,0,0,0,0,0,1,0,0,1,1
5255,103290,HFGNcmUXULevazeUTNEcAY9fpoL4pzVP,SpATywNh6bZuzm8s1ceuBUnMUAeoAHHw,4,2,1,0,1,0,1,0,5,0.7142857142857143,1,0.0,0,1,0,1,2,0,0,1,0,2,3,1
5256,103291,3xICsH6EXuYyV8kexin75XnVadi3rENN,SpATywNh6bZuzm8s1ceuBUnMUAeoAHHw,20,20,10,37,3,1,6,0,77,11.0,2,0.0,6,10,32,3,14,1,5,6,0,51,26,1
5257,103310,9LpHZ4FqcvjHyiN7Brp9qNNIFri6dqhc,SpATywNh6bZuzm8s1ceuBUnMUAeoAHHw,1,0,0,0,0,0,1,0,1,0.14285714285714285,1,0.0,0,0,0,0,0,0,0,1,0,0,1,1
5258,103321,nWOH01aZ04H6r4egoMRiiMsuUse9lbQb,SpATywNh6bZuzm8s1ceuBUnMUAeoAHHw,4,3,0,0,0,0,1,0,4,0.5714285714285714,1,0.0,0,0,0,0,3,0,0,1,0,0,4,1
5259,103349,hNJz0qbOhrUgajUkzqSdDbybHkuRglfs,bWdj2GDclj5ofokWjzoa5jAwMkxCykd6,28,31,18,108,6,1,10,1,175,25.0,4,0.0,7,18,99,6,24,1,9,10,1,130,45,1
5260,103368,RqBHYGZ0TJ0og1l3UKsrEDKJTiEi7UGH,bWdj2GDclj5ofokWjzoa5jAwMkxCykd6,1,0,0,0,0,0,1,0,1,0.14285714285714285,1,0.0,0,0,0,0,0,0,0,1,0,0,1,1
5261,103401,BfcoBJeBA5nEQ2BMwBPOzhifSeHVOPF7,A3fsA9Zfv1X2fVEQhTw51lKENdNrEqT3,15,17,2,0,1,4,11,4,39,5.571428571428571,3,0.0,0,2,0,1,17,4,0,11,4,3,36,1
5262,103403,kSmNmb8pAXQzQwcesy0KCmn8So8gUF15,RXDvfPUBYFlVdlueBFbLW0mhhAyGEqpt,11,7,1,18,1,0,2,0,29,4.142857142857143,1,0.0,1,1,17,1,6,0,1,2,0,20,9,1
5263,103416,VQlGEIRUzXNT6foVsTH49rZlcPgJT0yF,RXDvfPUBYFlVdlueBFbLW0mhhAyGEqpt,5,2,1,0,1,0,2,0,6,0.8571428571428571,1,0.0,0,1,0,1,2,0,0,2,0,2,4,1
5264,103540,gEnHreVcQ3mWSHejulW9Wh8JYbtvdJff,G8EPVSXsOYB5YQWZGiz1aVq5Pgr2GrQu,6,3,1,0,1,0,2,0,7,1.0,1,0.0,0,1,0,1,3,0,0,2,0,2,5,1
5265,103542,3kqAYaZkgzFfJM9JvWI5IyiYihK9SbF2,SpATywNh6bZuzm8s1ceuBUnMUAeoAHHw,1,0,0,0,0,0,1,0,1,0.14285714285714285,1,0.0,0,0,0,0,0,0,0,1,0,0,1,1
5266,103556,uckssqvWyUYWLFOLUxtXhLnqEepVbBJ2,A3fsA9Zfv1X2fVEQhTw51lKENdNrEqT3,6,4,0,0,0,3,5,0,12,1.7142857142857142,1,0.0,0,0,0,0,4,3,0,5,0,0,12,1
5267,103579,DYy3OcZHNqaAwRPZTK5mmyz2pajxcVFG,SpATywNh6bZuzm8s1ceuBUnMUAeoAHHw,18,14,9,0,7,0,2,0,32,4.571428571428571,1,0.0,4,9,0,7,10,0,0,2,0,20,12,1
5268,103582,dQsgkNAYSmg3HfiJLo9hIHon4zbbBGlt,SpATywNh6bZuzm8s1ceuBUnMUAeoAHHw,1,0,0,0,0,0,1,0,1,0.14285714285714285,1,0.0,0,0,0,0,0,0,0,1,0,0,1,1
5269,103598,5ZyvCd3AP7a8azCiLN5JfLAP53iZpAyD,bWdj2GDclj5ofokWjzoa5jAwMkxCykd6,1,0,0,0,0,0,1,0,1,0.14285714285714285,1,0.0,0,0,0,0,0,0,0,1,0,0,1,1
5270,103599,5ZyvCd3AP7a8azCiLN5JfLAP53iZpAyD,G8EPVSXsOYB5YQWZGiz1aVq5Pgr2GrQu,1,0,0,0,0,0,1,0,1,0.14285714285714285,1,0.0,0,0,0,0,0,0,0,1,0,0,1,1
5271,103615,MoPVKWdkHBgBJN1rFoQXD7HKqTLuGX5j,SpATywNh6bZuzm8s1ceuBUnMUAeoAHHw,1,0,0,0,0,0,1,0,1,0.14285714285714285,1,0.0,0,0,0,0,0,0,0,1,0,0,1,1
5272,103621,rVswAzjMLz5uIPbCwAU1SliCQFpiAqey,G8EPVSXsOYB5YQWZGiz1aVq5Pgr2GrQu,20,27,15,12,14,0,1,0,69,9.857142857142858,1,0.0,11,15,9,14,16,0,3,1,0,49,20,1
5273,103631,KYNdfogmKCD7SA1muZkW9WEyjcJ7qGwm,A3fsA9Zfv1X2fVEQhTw51lKENdNrEqT3,1,0,0,0,0,0,2,0,2,0.2857142857142857,1,0.0,0,0,0,0,0,0,0,2,0,0,2,1
5274,103688,C14ut6PDfZPN3lsINMru6CQXJOaUeNzg,SpATywNh6bZuzm8s1ceuBUnMUAeoAHHw,2,0,0,0,0,0,3,0,3,0.42857142857142855,1,0.0,0,0,0,0,0,0,0,3,0,0,3,1
5275,103708,rpRCEhtlHGcZRNaEFyNtzZ3h0JQuYrgr,A3fsA9Zfv1X2fVEQhTw51lKENdNrEqT3,1,0,0,0,0,0,1,0,1,0.14285714285714285,1,0.0,0,0,0,0,0,0,0,1,0,0,1,1
5276,103717,DKs1wVuJxi1MManiJftFpHeYNStTfS5A,G8EPVSXsOYB5YQWZGiz1aVq5Pgr2GrQu,2,0,0,0,0,0,4,0,4,0.5714285714285714,1,0.0,0,0,0,0,0,0,0,4,0,0,4,1
5277,103736,SAZRKAldhv9NmeRo6l8G7XnPsnj9TVyU,SpATywNh6bZuzm8s1ceuBUnMUAeoAHHw,1,0,0,0,0,0,1,0,1,0.14285714285714285,1,0.0,0,0,0,0,0,0,0,1,0,0,1,1
5278,103751,C8XrXSQZNN8RR6xEeSRWbKA5jTxVTtPT,RXDvfPUBYFlVdlueBFbLW0mhhAyGEqpt,1,0,0,0,0,0,1,0,1,0.14285714285714285,1,0.0,0,0,0,0,0,0,0,1,0,0,1,1
5279,103769,KyO1xM8jR0HMi7DDZ6rJYV6HufMfhFF3,SpATywNh6bZuzm8s1ceuBUnMUAeoAHHw,5,4,0,0,0,0,4,0,8,1.1428571428571428,1,0.0,0,0,0,0,4,0,0,4,0,0,8,1
5280,103770,EReWp6ilgaQY61GGX2jAkIc5IQisheJq,A3fsA9Zfv1X2fVEQhTw51lKENdNrEqT3,1,0,0,0,0,0,1,0,1,0.14285714285714285,1,0.0,0,0,0,0,0,0,0,1,0,0,1,1
5281,103771,SozLQk8695JG7fvj1Enp26s5ACJQjjq5,A3fsA9Zfv1X2fVEQhTw51lKENdNrEqT3,1,0,0,0,0,0,1,0,1,0.14285714285714285,1,0.0,0,0,0,0,0,0,0,1,0,0,1,1
5282,103772,ZeGQYJuhuvawQN9a4lM0EAzsC8fPW88J,SpATywNh6bZuzm8s1ceuBUnMUAeoAHHw,5,2,1,0,1,0,2,0,6,0.8571428571428571,1,0.0,0,1,0,1,2,0,0,2,0,2,4,1
5283,103780,8E8MlkBOuzGaVSvo1UqdWtwoQrTmYFYq,A3fsA9Zfv1X2fVEQhTw51lKENdNrEqT3,4,2,0,0,0,0,3,0,5,0.7142857142857143,1,0.0,0,0,0,0,2,0,0,3,0,0,5,1
5284,103781,DT8AqUhZw7EK0K7nTcFJ3ScDyeNUfkdW,SpATywNh6bZuzm8s1ceuBUnMUAeoAHHw,1,0,0,0,0,0,1,0,1,0.14285714285714285,1,0.0,0,0,0,0,0,0,0,1,0,0,1,1
5285,103787,g5LcibasYPSrvvKLR0Yho0cbKscCPTQe,A3fsA9Zfv1X2fVEQhTw51lKENdNrEqT3,2,0,0,0,0,0,4,0,4,0.5714285714285714,1,0.0,0,0,0,0,0,0,0,4,0,0,4,1
5286,103793,FllaTGiiKjVXL8ZyJAcKfQZYECjbYHzz,SpATywNh6bZuzm8s1ceuBUnMUAeoAHHw,1,0,0,0,0,0,1,0,1,0.14285714285714285,1,0.0,0,0,0,0,0,0,0,1,0,0,1,1
5287,103795,2ONNcB0Lk7y2f17JTT6X0dSaCbLlHzeP,A3fsA9Zfv1X2fVEQhTw51lKENdNrEqT3,24,13,11,0,10,4,4,0,42,6.0,1,0.0,0,11,0,10,13,4,0,4,0,21,21,1
5288,103796,sRe9Dv91RM9tcMLN8FfoFlx7APGbmbBC,SpATywNh6bZuzm8s1ceuBUnMUAeoAHHw,1,0,0,0,0,0,1,0,1,0.14285714285714285,1,0.0,0,0,0,0,0,0,0,1,0,0,1,1
5289,103813,CbIcKD0jazBhPd3ibnu0zTtemqpWb0KP,A3fsA9Zfv1X2fVEQhTw51lKENdNrEqT3,44,27,18,78,10,6,7,0,146,20.857142857142858,2,0.0,3,18,67,10,24,6,11,7,0,98,48,1
5290,103823,yc5B41HNSQqUbPLwIoeXaaIoBMGyXjZi,A3fsA9Zfv1X2fVEQhTw51lKENdNrEqT3,6,6,3,0,2,0,2,0,13,1.8571428571428572,1,0.0,0,3,0,2,6,0,0,2,0,5,8,1
5291,103828,z9EFyZFox24cBI6falpy1wiVcAxDOJLn,A3fsA9Zfv1X2fVEQhTw51lKENdNrEqT3,2,0,0,0,0,0,2,0,2,0.2857142857142857,1,0.0,0,0,0,0,0,0,0,2,0,0,2,1
5292,103842,At5CmMT40Lj8XDlMUQSu8tvnJD3w6cR2,SpATywNh6bZuzm8s1ceuBUnMUAeoAHHw,15,23,2,12,2,3,10,3,55,7.857142857142857,2,0.0,3,2,11,2,20,3,1,10,3,18,37,0
5293,103846,QvVe60KGKvAk40HokMNHSxHXG9LVzuVG,SpATywNh6bZuzm8s1ceuBUnMUAeoAHHw,1,0,0,0,0,0,1,0,1,0.14285714285714285,1,0.0,0,0,0,0,0,0,0,1,0,0,1,1
5294,103852,VJiHrUKuVkG2Wd7Jui04ER4qa9ZGvV1t,SpATywNh6bZuzm8s1ceuBUnMUAeoAHHw,27,39,18,14,5,5,10,2,93,13.285714285714286,4,0.0,8,18,13,5,31,5,1,10,2,44,49,1
5295,103870,EvnHBVsAsAQbfQWtAPpt54pufnNRU5R4,bWdj2GDclj5ofokWjzoa5jAwMkxCykd6,7,12,0,0,0,0,4,0,16,2.2857142857142856,1,0.0,0,0,0,0,12,0,0,4,0,0,16,1
5296,103886,wNLjey13wdSjq72WLYu2h7JxRXlqFXV6,SpATywNh6bZuzm8s1ceuBUnMUAeoAHHw,21,19,8,15,5,2,10,1,60,8.571428571428571,1,0.0,9,8,13,5,10,2,2,10,1,35,25,0
5297,103890,AwuND473CGsGJtyEL3enVuAsVwEKK9kF,G8EPVSXsOYB5YQWZGiz1aVq5Pgr2GrQu,5,2,1,0,1,0,2,0,6,0.8571428571428571,1,0.0,0,1,0,1,2,0,0,2,0,2,4,1
5298,103903,0w9tP8TINgzfbBeYFJprB82ry0PjYiWn,SpATywNh6bZuzm8s1ceuBUnMUAeoAHHw,11,28,4,2,1,0,5,0,40,5.714285714285714,2,0.0,2,4,2,1,26,0,0,5,0,9,31,0
5299,103908,KKVIEI2lseDGpdoOhUIkkmAMhzuJw0y5,SpATywNh6bZuzm8s1ceuBUnMUAeoAHHw,1,0,0,0,0,0,1,0,1,0.14285714285714285,1,0.0,0,0,0,0,0,0,0,1,0,0,1,1
5300,103915,Bt9uonGNpSTNQAZJ5XpbRJvBeauLMg6y,SpATywNh6bZuzm8s1ceuBUnMUAeoAHHw,5,2,1,0,1,0,2,0,6,0.8571428571428571,1,0.0,0,1,0,1,2,0,0,2,0,2,4,1
5301,103920,ixGKuRwAIkkpbDBbmpHTQFbowyxzIwFP,A3fsA9Zfv1X2fVEQhTw51lKENdNrEqT3,2,0,0,0,0,0,2,0,2,0.2857142857142857,1,0.0,0,0,0,0,0,0,0,2,0,0,2,1
5302,103921,illxSnHmbH86MI7oeDlx7PoAaCvI0459,SpATywNh6bZuzm8s1ceuBUnMUAeoAHHw,4,2,0,0,0,0,4,0,6,0.8571428571428571,1,0.0,0,0,0,0,2,0,0,4,0,0,6,1
5303,103923,ixGKuRwAIkkpbDBbmpHTQFbowyxzIwFP,bWdj2GDclj5ofokWjzoa5jAwMkxCykd6,2,0,0,0,0,0,2,0,2,0.2857142857142857,1,0.0,0,0,0,0,0,0,0,2,0,0,2,1
5304,103932,nMJrb50Z6QbaFrpJMS3h5YwSiL2VcT7z,bWdj2GDclj5ofokWjzoa5jAwMkxCykd6,2,0,0,0,0,0,3,0,3,0.42857142857142855,2,0.0,0,0,0,0,0,0,0,3,0,0,3,1
5305,103950,JNia6gKvSZOSZQHrR3Kro8PKF3m40Fop,RXDvfPUBYFlVdlueBFbLW0mhhAyGEqpt,34,23,9,59,9,0,1,0,101,14.428571428571429,1,0.0,13,9,55,9,10,0,4,1,0,86,15,1
5306,103967,kjoYyxOsZaiCA9S8PMK5B69QLaH15SYn,SpATywNh6bZuzm8s1ceuBUnMUAeoAHHw,15,23,7,18,3,17,6,1,75,10.714285714285714,2,0.0,14,7,15,3,9,17,3,6,1,39,36,0
5307,103983,c7BA0CHOGHUb6Zvl8EDChyZRMoY8mJ72,bWdj2GDclj5ofokWjzoa5jAwMkxCykd6,6,7,1,0,1,0,3,0,12,1.7142857142857142,1,0.0,1,1,0,1,6,0,0,3,0,3,9,1
5308,104024,fCVSDkZ4pJqiysBxp6DwZw9KkCTFdKeE,SpATywNh6bZuzm8s1ceuBUnMUAeoAHHw,1,0,0,0,0,0,1,0,1,0.14285714285714285,1,0.0,0,0,0,0,0,0,0,1,0,0,1,1
5309,104032,s6g3JP590BuuXwlDJeFKSGLH2Uubd3rm,SpATywNh6bZuzm8s1ceuBUnMUAeoAHHw,2,0,0,0,0,0,3,0,3,0.42857142857142855,1,0.0,0,0,0,0,0,0,0,3,0,0,3,1
5310,104052,xdSWJOkklt1feMPe59TTfCkpvZpm9Xg2,A3fsA9Zfv1X2fVEQhTw51lKENdNrEqT3,1,0,0,0,0,0,1,0,1,0.14285714285714285,1,0.0,0,0,0,0,0,0,0,1,0,0,1,1
5311,104081,eGnXUl0T4jiT9b8r6xuMUjzOt9Gv7xEL,A3fsA9Zfv1X2fVEQhTw51lKENdNrEqT3,49,45,31,92,18,1,15,2,204,29.142857142857142,5,0.0,1,31,74,18,44,1,18,15,2,124,80,1
5312,104084,axVh7TT3ftc0JLvNMlUvTGTAABKlThNj,SpATywNh6bZuzm8s1ceuBUnMUAeoAHHw,2,0,0,0,0,0,3,0,3,0.42857142857142855,1,0.0,0,0,0,0,0,0,0,3,0,0,3,1
5313,104090,fGDhAQY2WhkQYcL5XaYeDMBiOUQEoTnX,A3fsA9Zfv1X2fVEQhTw51lKENdNrEqT3,46,19,14,110,12,0,3,0,158,22.571428571428573,2,0.0,2,14,92,12,17,0,18,3,0,120,38,1
5314,104110,qwWysWdLmrwh0JmjPYNGVFqdat8Jy8Lb,A3fsA9Zfv1X2fVEQhTw51lKENdNrEqT3,3,2,0,0,0,0,2,0,4,0.5714285714285714,1,0.0,0,0,0,0,2,0,0,2,0,0,4,1
5315,104112,1nvi4T1tSgoWvIN9EbUwnTy7YI8AhzKg,SpATywNh6bZuzm8s1ceuBUnMUAeoAHHw,6,2,1,0,1,0,3,1,8,1.1428571428571428,1,0.0,0,1,0,1,2,0,0,3,1,2,6,1
5316,104128,Whrc7O8OYrwQtVL43oMCOWkRLnJ5RAnq,bWdj2GDclj5ofokWjzoa5jAwMkxCykd6,6,2,1,0,1,0,3,0,7,1.0,1,0.0,0,1,0,1,2,0,0,3,0,2,5,1
5317,104155,eHoa4dnAqoZqw72CCle00GlHxpp5Lihg,bWdj2GDclj5ofokWjzoa5jAwMkxCykd6,3,2,0,0,0,0,1,0,3,0.42857142857142855,1,0.0,0,0,0,0,2,0,0,1,0,0,3,1
5318,104174,fq6GCepmmh2YUfaUpWUiL4vGs9AXZLYY,SpATywNh6bZuzm8s1ceuBUnMUAeoAHHw,1,0,0,0,0,0,1,0,1,0.14285714285714285,1,0.0,0,0,0,0,0,0,0,1,0,0,1,1
5319,104214,j3WvRsPrA16gNidaQCOf3oXIUr2Xe5Lw,bWdj2GDclj5ofokWjzoa5jAwMkxCykd6,6,6,2,0,1,0,2,0,11,1.5714285714285714,1,0.0,2,2,0,1,4,0,0,2,0,5,6,1
5320,104237,JUwnpYDokyUXTC7SfWpuPqShDK4ZEqmX,bWdj2GDclj5ofokWjzoa5jAwMkxCykd6,1,0,0,0,0,0,1,0,1,0.14285714285714285,1,0.0,0,0,0,0,0,0,0,1,0,0,1,1
5321,104248,ixafWGJcoRhCM5cJdtULfcNp2InCr2Sa,bWdj2GDclj5ofokWjzoa5jAwMkxCykd6,1,0,0,0,0,0,1,0,1,0.14285714285714285,1,0.0,0,0,0,0,0,0,0,1,0,0,1,1
5322,104257,JnJdiqdl8G12l0bbDCbx68wMLkGjKDPl,bWdj2GDclj5ofokWjzoa5jAwMkxCykd6,5,4,2,0,0,0,5,0,11,1.5714285714285714,2,0.0,0,2,0,0,4,0,0,5,0,2,9,1
5323,104281,nQnbQ4USuQPKS5dsskLpLD6Vp5PD3y57,SpATywNh6bZuzm8s1ceuBUnMUAeoAHHw,5,2,1,0,1,1,3,0,8,1.1428571428571428,1,0.0,0,1,0,1,2,1,0,3,0,2,6,0
5324,104285,eYFN65l456TZjqLokXcupn8BpQg7vecw,G8EPVSXsOYB5YQWZGiz1aVq5Pgr2GrQu,9,7,0,0,1,0,11,0,19,2.7142857142857144,1,0.0,0,0,0,1,7,0,0,11,0,1,18,1
5325,104287,E4KzNEU3ybRlAOiHqHHsGQEXiaxyHgoT,SpATywNh6bZuzm8s1ceuBUnMUAeoAHHw,32,38,21,24,10,14,15,1,123,17.571428571428573,4,0.0,10,21,24,10,28,14,0,15,1,65,58,0
5326,104293,mKHQM9iW9olu6z2WamdxK7ySH3UwX3JX,RXDvfPUBYFlVdlueBFbLW0mhhAyGEqpt,16,16,9,21,6,1,9,1,63,9.0,3,0.0,5,9,18,6,11,1,3,9,1,38,25,1
5327,104312,Q5TmTVdy8nnH2vTL73s67ZseaCMO3k91,bWdj2GDclj5ofokWjzoa5jAwMkxCykd6,1,0,0,0,0,0,1,0,1,0.14285714285714285,1,0.0,0,0,0,0,0,0,0,1,0,0,1,1
5328,104316,FdqXptfn5rlMpIwU40MbDz6o7uZKXv6A,SpATywNh6bZuzm8s1ceuBUnMUAeoAHHw,2,0,0,0,0,0,2,0,2,0.2857142857142857,1,0.0,0,0,0,0,0,0,0,2,0,0,2,1
5329,104331,sC7fymsB6mbxhnSeg6NeWpGdnl2lVglT,SpATywNh6bZuzm8s1ceuBUnMUAeoAHHw,17,27,11,19,5,0,8,3,73,10.428571428571429,1,0.0,12,11,17,5,15,0,2,8,3,45,28,0
5330,104338,rB9PPwxIRyt27C89H153o2lH09tVr1nK,G8EPVSXsOYB5YQWZGiz1aVq5Pgr2GrQu,6,11,3,0,4,0,2,0,20,2.857142857142857,1,0.0,7,3,0,4,4,0,0,2,0,14,6,1
5331,104345,2XkaIutgoPZ3laInMFqUtqSwL8hEETLH,SpATywNh6bZuzm8s1ceuBUnMUAeoAHHw,4,3,1,0,1,0,1,0,6,0.8571428571428571,1,0.0,0,1,0,1,3,0,0,1,0,2,4,1
5332,104346,wGfXRYqHkdAo1fVEEY9NvW8qy6M9m0mI,SpATywNh6bZuzm8s1ceuBUnMUAeoAHHw,7,5,2,0,2,0,2,0,11,1.5714285714285714,1,0.0,0,2,0,2,5,0,0,2,0,4,7,1
5333,104353,Nvx1FqKYM0wMKIIRgD0fWbHs2ulluJLe,SpATywNh6bZuzm8s1ceuBUnMUAeoAHHw,1,0,0,0,0,0,1,0,1,0.14285714285714285,1,0.0,0,0,0,0,0,0,0,1,0,0,1,0
5334,104362,QVxxpDseuNfbakex6vp7iIpmgTn9LMT8,G8EPVSXsOYB5YQWZGiz1aVq5Pgr2GrQu,7,4,0,0,0,0,3,1,8,1.1428571428571428,1,0.0,0,0,0,0,4,0,0,3,1,0,8,1
5335,104388,hGNdlaqDmXk6lg7T5WbaNaGNDHY5myAS,SpATywNh6bZuzm8s1ceuBUnMUAeoAHHw,7,7,3,0,2,0,3,0,15,2.142857142857143,1,0.0,3,3,0,2,4,0,0,3,0,8,7,1
5336,104394,dlHDytKql5TohtYHxgnGbeQGgJYZWDGJ,A3fsA9Zfv1X2fVEQhTw51lKENdNrEqT3,1,0,0,0,0,0,1,0,1,0.14285714285714285,1,0.0,0,0,0,0,0,0,0,1,0,0,1,1
5337,104407,8XstJLDa8agdHppUFVVZbvtgkIjc1hSo,SpATywNh6bZuzm8s1ceuBUnMUAeoAHHw,6,4,2,0,1,1,3,0,11,1.5714285714285714,2,0.0,0,2,0,1,4,1,0,3,0,3,8,1
5338,104418,pcsiSS3QOPo0n8yKp6skJyBWeonG4c8P,bWdj2GDclj5ofokWjzoa5jAwMkxCykd6,4,5,3,0,2,6,1,0,17,2.4285714285714284,1,0.0,0,3,0,2,5,6,0,1,0,5,12,1
5339,104435,GEHMGUKZ7lJGT0NAhukMXCgY3uHGI1vW,SpATywNh6bZuzm8s1ceuBUnMUAeoAHHw,7,3,2,0,2,0,2,0,9,1.2857142857142858,1,0.0,0,2,0,2,3,0,0,2,0,4,5,1
5340,104438,KJtTFVCUZxFPCdrcl94b8VUY3eA2PtX6,SpATywNh6bZuzm8s1ceuBUnMUAeoAHHw,26,37,9,26,3,22,12,4,113,16.142857142857142,3,0.0,16,9,22,3,21,22,4,12,4,50,63,0
5341,104450,fa5L7BR4QPdW8LaRhyZa9SLAtcvpLQse,SpATywNh6bZuzm8s1ceuBUnMUAeoAHHw,9,3,2,0,2,0,5,1,13,1.8571428571428572,1,0.0,0,2,0,2,3,0,0,5,1,4,9,1
5342,104454,S6zuEdHkGvIDnx9FvNNHc7xwyevTBNEw,G8EPVSXsOYB5YQWZGiz1aVq5Pgr2GrQu,80,63,26,225,22,0,7,0,343,49.0,5,0.0,23,26,190,22,40,0,35,7,0,261,82,0
5343,104471,1MR6SIEh8IgMKrYcKoTYc2JC43hmTJbZ,A3fsA9Zfv1X2fVEQhTw51lKENdNrEqT3,6,3,0,0,0,2,5,0,10,1.4285714285714286,1,0.0,0,0,0,0,3,2,0,5,0,0,10,1
5344,104488,IYFrqEdSROOp3Z1UK2YOma0RYGRatAQT,A3fsA9Zfv1X2fVEQhTw51lKENdNrEqT3,4,2,1,0,1,0,1,0,5,0.7142857142857143,1,0.0,0,1,0,1,2,0,0,1,0,2,3,1
5345,104491,yEc0qGRUsnGavj0JPbk8pVtWktClrURk,A3fsA9Zfv1X2fVEQhTw51lKENdNrEqT3,1,0,0,0,0,0,1,0,1,0.14285714285714285,1,0.0,0,0,0,0,0,0,0,1,0,0,1,1
5346,104497,jKfEyfk0HFbzE5vAszOX5qLRWBhzLYt2,SpATywNh6bZuzm8s1ceuBUnMUAeoAHHw,1,0,0,0,0,0,1,0,1,0.14285714285714285,1,0.0,0,0,0,0,0,0,0,1,0,0,1,1
5347,104501,vZWQs3w0XkSs89Ucm6ojt59ZxMUAhe1V,A3fsA9Zfv1X2fVEQhTw51lKENdNrEqT3,11,7,3,0,1,2,16,1,30,4.285714285714286,1,0.0,0,3,0,1,7,2,0,16,1,4,26,1
5348,104510,1fqT0899kRcDDGHbdo7SAtzTiZ0jb6Gw,SpATywNh6bZuzm8s1ceuBUnMUAeoAHHw,5,4,1,0,1,0,4,0,10,1.4285714285714286,1,0.0,0,1,0,1,4,0,0,4,0,2,8,1
5349,104519,4BEj7gptNyb11PfZw5Zij4k5rhZkomv9,SpATywNh6bZuzm8s1ceuBUnMUAeoAHHw,16,25,7,15,3,0,4,0,54,7.714285714285714,1,0.0,16,7,14,3,9,0,1,4,0,40,14,1
5350,104520,AXWWqNDiRDejTjo5V7yUaMbjtzXKhlP0,A3fsA9Zfv1X2fVEQhTw51lKENdNrEqT3,9,5,4,0,3,0,2,0,14,2.0,1,0.0,0,4,0,3,5,0,0,2,0,7,7,1
5351,104529,pRsdTtgRf3HNRCFBVE8ZUsyswXD2QiAk,SpATywNh6bZuzm8s1ceuBUnMUAeoAHHw,9,6,3,0,3,0,2,0,14,2.0,2,0.0,2,3,0,3,4,0,0,2,0,8,6,1
5352,104541,WrS9TB9uT4oSW7UbFINDhj14Cq6LHmEj,G8EPVSXsOYB5YQWZGiz1aVq5Pgr2GrQu,21,20,7,12,5,3,12,1,60,8.571428571428571,1,0.0,5,7,9,5,15,3,3,12,1,26,34,0
5353,104544,gUXmx34tXzFZkM4gYbNbIwLhuZfANkS1,A3fsA9Zfv1X2fVEQhTw51lKENdNrEqT3,4,3,1,0,0,0,1,0,5,0.7142857142857143,1,0.0,0,1,0,0,3,0,0,1,0,1,4,1
5354,104549,XVzLVlcu5Oyf6iAJpPwexFxr52kUVMk6,SpATywNh6bZuzm8s1ceuBUnMUAeoAHHw,1,0,0,0,0,0,1,0,1,0.14285714285714285,1,0.0,0,0,0,0,0,0,0,1,0,0,1,1
5355,104552,nR9dAgKzSlgvrJWELbwHBtX83ee7HVxY,SpATywNh6bZuzm8s1ceuBUnMUAeoAHHw,7,4,3,0,3,0,2,0,12,1.7142857142857142,1,0.0,0,3,0,3,4,0,0,2,0,6,6,1
5356,104559,efXmiwkTuBoeL7S5luYeU6sYtxURlop6,G8EPVSXsOYB5YQWZGiz1aVq5Pgr2GrQu,2,0,0,0,0,0,2,0,2,0.2857142857142857,1,0.0,0,0,0,0,0,0,0,2,0,0,2,1
5357,104583,hd3AGD7h3p4wKWEGL7m8RwayFKIA3oY6,SpATywNh6bZuzm8s1ceuBUnMUAeoAHHw,9,10,5,0,5,1,1,0,22,3.142857142857143,1,0.0,2,5,0,5,8,1,0,1,0,12,10,1
5358,104638,pVcyz42RqwGdgjmvwllHMEUwVR1vdXWF,SpATywNh6bZuzm8s1ceuBUnMUAeoAHHw,9,13,5,0,3,0,2,0,23,3.2857142857142856,1,0.0,4,5,0,3,9,0,0,2,0,12,11,0
5359,104643,OUOJlObKrXM0JmEUq0o8KzZHzr8jy9dn,SpATywNh6bZuzm8s1ceuBUnMUAeoAHHw,1,0,0,0,0,0,1,0,1,0.14285714285714285,1,0.0,0,0,0,0,0,0,0,1,0,0,1,1
5360,104660,T118Cf7QnojriLhCFYL99xCQBHodaMMt,A3fsA9Zfv1X2fVEQhTw51lKENdNrEqT3,12,12,8,0,5,0,3,0,28,4.0,2,0.0,0,8,0,5,12,0,0,3,0,13,15,1
5361,104679,b7OkWz3nq7Lb9oLoadHyvvkdfFcSwihz,bWdj2GDclj5ofokWjzoa5jAwMkxCykd6,1,0,0,0,0,0,1,0,1,0.14285714285714285,1,0.0,0,0,0,0,0,0,0,1,0,0,1,1
5362,104695,pFPFJKqqsl7E3HmJN66ulC7SsHL61zY0,G8EPVSXsOYB5YQWZGiz1aVq5Pgr2GrQu,7,1,1,0,1,0,4,1,8,1.1428571428571428,1,0.0,0,1,0,1,1,0,0,4,1,2,6,1
5363,104700,HTW0MXRsyGWqdNcPrMPEaXwWOjVd82Bo,SpATywNh6bZuzm8s1ceuBUnMUAeoAHHw,13,34,12,12,5,0,5,0,68,9.714285714285714,2,0.0,10,12,10,5,24,0,2,5,0,37,31,1
5364,104725,kOUbZbVS3Tp5fnMvFRgXRDdwa2qwOZPQ,SpATywNh6bZuzm8s1ceuBUnMUAeoAHHw,10,11,9,0,5,0,1,0,26,3.7142857142857144,1,0.0,1,9,0,5,10,0,0,1,0,15,11,1
5365,104729,EJ7udUHYDMabOR6DK8F5Y2Y2wljl56Yz,SpATywNh6bZuzm8s1ceuBUnMUAeoAHHw,19,31,9,17,1,5,8,1,72,10.285714285714286,2,0.0,16,9,16,1,15,5,1,8,1,42,30,1
5366,104732,Xp3hqJUxQ1JyPcuVR21XzaJTaS6J32IL,SpATywNh6bZuzm8s1ceuBUnMUAeoAHHw,5,2,1,0,1,0,2,0,6,0.8571428571428571,1,0.0,0,1,0,1,2,0,0,2,0,2,4,1
5367,104752,howLdYpe9Zal9CPA1BP3DgH0uhVpiT5i,SpATywNh6bZuzm8s1ceuBUnMUAeoAHHw,18,13,6,14,4,3,6,2,48,6.857142857142857,1,0.0,4,6,13,4,9,3,1,6,2,27,21,1
5368,104772,AaS8GsfaaiK26oA6b0QdGhs8opVCkjvV,A3fsA9Zfv1X2fVEQhTw51lKENdNrEqT3,31,17,12,54,0,7,6,0,96,13.714285714285714,1,0.0,2,12,47,0,15,7,7,6,0,61,35,1
5369,104790,EPmLjBxeWpwhjwoRgtmLV8RkhFOu2zzj,SpATywNh6bZuzm8s1ceuBUnMUAeoAHHw,2,0,0,0,0,0,2,0,2,0.2857142857142857,1,0.0,0,0,0,0,0,0,0,2,0,0,2,1
5370,104791,Xv7W8Uu75U6tMRhwrAaphCnFwKom9DXj,SpATywNh6bZuzm8s1ceuBUnMUAeoAHHw,2,0,0,0,0,0,2,0,2,0.2857142857142857,1,0.0,0,0,0,0,0,0,0,2,0,0,2,1
5371,104798,705a1tvxnZT7omctMx7Fjakho000VDxN,SpATywNh6bZuzm8s1ceuBUnMUAeoAHHw,3,2,0,0,0,0,1,0,3,0.42857142857142855,1,0.0,0,0,0,0,2,0,0,1,0,0,3,1
5372,104803,GHw9ck750jm0mkRym0HeCGrJelDoub5a,SpATywNh6bZuzm8s1ceuBUnMUAeoAHHw,15,20,12,0,5,2,8,0,47,6.714285714285714,3,0.0,5,12,0,5,15,2,0,8,0,22,25,0
5373,104805,O5Xv4tBkDAfcRTJRImpaIMgi7dTTYJal,SpATywNh6bZuzm8s1ceuBUnMUAeoAHHw,17,20,8,19,3,12,7,1,70,10.0,2,0.0,8,8,15,3,12,12,4,7,1,34,36,1
5374,104818,6i24nlUBlDMs5njijO1qqAg2zNti0ug9,SpATywNh6bZuzm8s1ceuBUnMUAeoAHHw,8,6,4,0,3,0,5,0,18,2.5714285714285716,1,0.0,0,4,0,3,6,0,0,5,0,7,11,1
5375,104826,1EoPeAPt0rQExpDMUB0Oh9LRcg1yhFWa,SpATywNh6bZuzm8s1ceuBUnMUAeoAHHw,1,0,0,0,0,0,1,0,1,0.14285714285714285,1,0.0,0,0,0,0,0,0,0,1,0,0,1,1
5376,104838,PzXoGwLC1Wc9fp2FSg9WCVxYfOKqR6tz,SpATywNh6bZuzm8s1ceuBUnMUAeoAHHw,9,14,9,0,0,0,5,0,28,4.0,2,0.0,0,9,0,0,14,0,0,5,0,9,19,1
5377,104840,wBcELLuAHs6lwDaecxC5fVgtQ5lnLu3S,RXDvfPUBYFlVdlueBFbLW0mhhAyGEqpt,5,3,0,0,0,0,2,0,5,0.7142857142857143,1,0.0,0,0,0,0,3,0,0,2,0,0,5,1
5378,104843,8NRsKZ3hMeinWXhN3qtntd7OTP25jyWY,SpATywNh6bZuzm8s1ceuBUnMUAeoAHHw,4,3,1,0,1,0,2,0,7,1.0,1,0.0,0,1,0,1,3,0,0,2,0,2,5,1
5379,104847,gPygmoGilNQtwbFXETY0FWnDTdZxsr6L,bWdj2GDclj5ofokWjzoa5jAwMkxCykd6,5,4,1,0,2,0,2,0,9,1.2857142857142858,1,0.0,2,1,0,2,2,0,0,2,0,5,4,1
5380,104870,vO07VFd2DYWPdrvNiSqsqXFTXPKE00c4,SpATywNh6bZuzm8s1ceuBUnMUAeoAHHw,1,0,0,0,0,0,1,0,1,0.14285714285714285,1,0.0,0,0,0,0,0,0,0,1,0,0,1,1
5381,104888,7UoJlZNmkXe9KUxED9211lah5PpgHmBQ,A3fsA9Zfv1X2fVEQhTw51lKENdNrEqT3,8,4,2,0,2,0,3,0,11,1.5714285714285714,2,0.0,0,2,0,2,4,0,0,3,0,4,7,1
5382,104899,fYcx29YG0OyhjbzerOxQ4rwr3ES74fln,bWdj2GDclj5ofokWjzoa5jAwMkxCykd6,7,9,6,0,0,0,6,0,21,3.0,2,0.0,0,6,0,0,9,0,0,6,0,6,15,1
5383,104911,0lHtTzCCkTGgpl3mL2eT9kPoN3ydIlHv,bWdj2GDclj5ofokWjzoa5jAwMkxCykd6,10,8,6,0,5,0,3,0,22,3.142857142857143,2,0.0,0,6,0,5,8,0,0,3,0,11,11,1
5384,104921,xBMlDE0EhLrV6UTu12C10f1Ev99CwT31,SpATywNh6bZuzm8s1ceuBUnMUAeoAHHw,10,18,9,0,3,0,4,0,34,4.857142857142857,2,0.0,0,9,0,3,18,0,0,4,0,12,22,1
5385,104937,nyhARUyj7ejuonDDMRnWtxhqKty5CGUe,A3fsA9Zfv1X2fVEQhTw51lKENdNrEqT3,1,0,0,0,0,0,1,0,1,0.14285714285714285,1,0.0,0,0,0,0,0,0,0,1,0,0,1,1
5386,104940,8yrIKDtnkYcLfERwrXrvcRGxHxbt2Jd3,A3fsA9Zfv1X2fVEQhTw51lKENdNrEqT3,2,0,0,0,0,0,2,0,2,0.2857142857142857,1,0.0,0,0,0,0,0,0,0,2,0,0,2,1
5387,104950,0NdMcTtal4BOZ1xlXUgTc3KVGUjBSUot,SpATywNh6bZuzm8s1ceuBUnMUAeoAHHw,16,15,10,21,3,13,10,6,78,11.142857142857142,1,0.0,4,10,18,3,11,13,3,10,6,35,43,1
5388,104951,0FkQyM0LbhhmKgkelCOZLJl6X4aMe6Y7,bWdj2GDclj5ofokWjzoa5jAwMkxCykd6,6,3,1,0,1,0,2,0,7,1.0,1,0.0,0,1,0,1,3,0,0,2,0,2,5,1
5389,104963,Gp514eONX8HiKW2kWtPnfdmsO2W1ys65,SpATywNh6bZuzm8s1ceuBUnMUAeoAHHw,7,8,0,0,0,1,5,0,14,2.0,1,0.0,0,0,0,0,8,1,0,5,0,0,14,1
5390,104973,r6HTx0usTVh2rZ8xnqG9NraBW5uoCbAW,G8EPVSXsOYB5YQWZGiz1aVq5Pgr2GrQu,3,2,0,0,0,0,1,0,3,0.42857142857142855,1,0.0,0,0,0,0,2,0,0,1,0,0,3,1
5391,104983,as0OGPaqUNY2AJHdTO1ghRp7pegJOTda,A3fsA9Zfv1X2fVEQhTw51lKENdNrEqT3,13,7,5,0,4,0,7,0,23,3.2857142857142856,1,0.0,0,5,0,4,7,0,0,7,0,9,14,1
5392,105000,pRiGzDKgwOgFTBnFOQaqzu3UaMPe8uNF,SpATywNh6bZuzm8s1ceuBUnMUAeoAHHw,16,15,6,10,3,2,5,0,41,5.857142857142857,1,0.0,6,6,9,3,9,2,1,5,0,24,17,0
5393,105006,0fpX00EX1TEQvQDvfUOFFIekoZBhUJ55,SpATywNh6bZuzm8s1ceuBUnMUAeoAHHw,13,22,1,20,1,3,5,0,52,7.428571428571429,2,0.0,9,1,16,1,13,3,4,5,0,27,25,1
5394,105009,MoIyInVwEhZdoyGdxNDzoAKuJ4ab4usf,G8EPVSXsOYB5YQWZGiz1aVq5Pgr2GrQu,44,19,7,140,3,0,8,1,178,25.428571428571427,2,0.0,9,7,111,3,10,0,29,8,1,130,48,1
5395,105045,AsBtR21xGFKZ6c2LKvPTdlawgiUBcaPL,A3fsA9Zfv1X2fVEQhTw51lKENdNrEqT3,7,6,3,0,2,0,1,0,12,1.7142857142857142,1,0.0,0,3,0,2,6,0,0,1,0,5,7,1
5396,105048,skA6GV4QKGFVtxye7Nlz906gXUD3qCvf,SpATywNh6bZuzm8s1ceuBUnMUAeoAHHw,18,49,6,20,0,4,8,1,88,12.571428571428571,4,0.0,22,6,18,0,27,4,2,8,1,46,42,1
5397,105077,0V54aOwQrSAMewtMntBBMI7Ks56rZdIS,SpATywNh6bZuzm8s1ceuBUnMUAeoAHHw,8,3,2,0,2,0,3,0,10,1.4285714285714286,1,0.0,0,2,0,2,3,0,0,3,0,4,6,1
5398,105087,il5WSyfV8t3AlDaoTevF0gOGZQXdoXsc,SpATywNh6bZuzm8s1ceuBUnMUAeoAHHw,10,3,3,0,3,0,5,0,14,2.0,2,0.0,0,3,0,3,3,0,0,5,0,6,8,1
5399,105102,Oh8nsiPPTE9TLZe9wGx8wAMkvZwDEBik,SpATywNh6bZuzm8s1ceuBUnMUAeoAHHw,7,6,3,0,3,0,2,0,14,2.0,2,0.0,0,3,0,3,6,0,0,2,0,6,8,1
5400,105108,HJsFc87NFCDg5yRkkakXIT7nSH8XGxhF,RXDvfPUBYFlVdlueBFbLW0mhhAyGEqpt,2,0,0,0,0,0,3,0,3,0.42857142857142855,2,0.0,0,0,0,0,0,0,0,3,0,0,3,0
5401,105118,Qs7Gy3lEvMM83esFdoZ1zZvUeRYTAxxM,bWdj2GDclj5ofokWjzoa5jAwMkxCykd6,4,2,1,0,1,0,3,0,7,1.0,2,0.0,0,1,0,1,2,0,0,3,0,2,5,1
5402,105126,5THwHjTl3CwrsU1mIg0WeedsGDfvyUMr,G8EPVSXsOYB5YQWZGiz1aVq5Pgr2GrQu,16,17,9,0,6,1,13,0,46,6.571428571428571,3,0.0,0,9,0,6,17,1,0,13,0,15,31,1
5403,105127,Vr52BPz4QZ36FT4KFVQoT6q0kUFkYRGt,A3fsA9Zfv1X2fVEQhTw51lKENdNrEqT3,2,0,0,0,0,0,4,0,4,0.5714285714285714,1,0.0,0,0,0,0,0,0,0,4,0,0,4,1
5404,105140,BAa1TxCsHWVGWhK6xiubabaADa3eqEud,A3fsA9Zfv1X2fVEQhTw51lKENdNrEqT3,2,0,0,0,0,0,2,0,2,0.2857142857142857,1,0.0,0,0,0,0,0,0,0,2,0,0,2,1
5405,105147,B5KRIhKjqiTl7SsQUviM99Uk4X6GH6qt,SpATywNh6bZuzm8s1ceuBUnMUAeoAHHw,4,2,1,0,0,0,2,0,5,0.7142857142857143,1,0.0,0,1,0,0,2,0,0,2,0,1,4,1
5406,105169,Ruj4G7IwBWWMNjdkNO62PMD51YZNkIvC,SpATywNh6bZuzm8s1ceuBUnMUAeoAHHw,6,1,1,0,1,0,3,0,6,0.8571428571428571,1,0.0,0,1,0,1,1,0,0,3,0,2,4,1
5407,105174,ek3MzKxIa2dEtIB8F3GcpuahHmTwWTB6,SpATywNh6bZuzm8s1ceuBUnMUAeoAHHw,7,14,2,0,1,0,3,0,20,2.857142857142857,2,0.0,5,2,0,1,9,0,0,3,0,8,12,1
5408,105179,3ZE4TsW4kNV4MayVbDMw5du6BBHsJQ28,bWdj2GDclj5ofokWjzoa5jAwMkxCykd6,4,2,0,0,0,1,3,0,6,0.8571428571428571,1,0.0,0,0,0,0,2,1,0,3,0,0,6,1
5409,105183,vIlcyxyCAnrnNirD1pT1JNHi1Wuqkh6N,G8EPVSXsOYB5YQWZGiz1aVq5Pgr2GrQu,1,0,0,0,0,0,1,0,1,0.14285714285714285,1,0.0,0,0,0,0,0,0,0,1,0,0,1,1
5410,105193,3KmURJPHsPOw8V9aGbkBVqZ8GfDwNzjb,SpATywNh6bZuzm8s1ceuBUnMUAeoAHHw,7,3,2,0,2,0,2,0,9,1.2857142857142858,1,0.0,0,2,0,2,3,0,0,2,0,4,5,1
5411,105213,f6fUoSUJslaShApLLQ3C3hAE39t0Ewco,A3fsA9Zfv1X2fVEQhTw51lKENdNrEqT3,1,0,0,0,0,0,1,0,1,0.14285714285714285,1,0.0,0,0,0,0,0,0,0,1,0,0,1,1
5412,105215,XqjUxB8l2EDnNsPmb4GmXeJWVp4D1ShM,SpATywNh6bZuzm8s1ceuBUnMUAeoAHHw,5,4,0,0,0,1,3,0,8,1.1428571428571428,1,0.0,0,0,0,0,4,1,0,3,0,0,8,1
5413,105238,D49L08bhYMDNZcjv8FPy2UNVru9gYK6t,bWdj2GDclj5ofokWjzoa5jAwMkxCykd6,5,1,1,0,1,0,2,0,5,0.7142857142857143,1,0.0,0,1,0,1,1,0,0,2,0,2,3,1
5414,105258,iaVYLE1BI86xpC2ERUpI1xclzmGmTOg0,SpATywNh6bZuzm8s1ceuBUnMUAeoAHHw,4,2,0,0,0,0,2,0,4,0.5714285714285714,1,0.0,0,0,0,0,2,0,0,2,0,0,4,1
5415,105265,yvMe4l8GZJNWinwQEogjzWQJd9z0H33J,SpATywNh6bZuzm8s1ceuBUnMUAeoAHHw,8,7,5,0,1,2,3,1,19,2.7142857142857144,1,0.0,0,5,0,1,7,2,0,3,1,6,13,1
5416,105277,KUZLnWk3DnESTDfMbkIGdOBiU12ntmts,A3fsA9Zfv1X2fVEQhTw51lKENdNrEqT3,7,4,2,0,1,0,8,0,15,2.142857142857143,1,0.0,1,2,0,1,3,0,0,8,0,4,11,1
5417,105309,8yGhHOYnj9M6W9ULBEe6c9dxuWlFPuyX,SpATywNh6bZuzm8s1ceuBUnMUAeoAHHw,5,3,2,0,1,0,2,0,8,1.1428571428571428,1,0.0,0,2,0,1,3,0,0,2,0,3,5,1
5418,105310,drUu3tyovHqnF7EAaPHayHDYbWMe2Od6,G8EPVSXsOYB5YQWZGiz1aVq5Pgr2GrQu,1,0,0,0,0,0,1,0,1,0.14285714285714285,1,0.0,0,0,0,0,0,0,0,1,0,0,1,1
5419,105311,drUu3tyovHqnF7EAaPHayHDYbWMe2Od6,RXDvfPUBYFlVdlueBFbLW0mhhAyGEqpt,1,0,0,0,0,0,1,0,1,0.14285714285714285,1,0.0,0,0,0,0,0,0,0,1,0,0,1,1
5420,105313,drUu3tyovHqnF7EAaPHayHDYbWMe2Od6,A3fsA9Zfv1X2fVEQhTw51lKENdNrEqT3,1,0,0,0,0,0,1,0,1,0.14285714285714285,1,0.0,0,0,0,0,0,0,0,1,0,0,1,1
5421,105323,yiX0lNiEyuJnsK7G0Hy1jjUqzZwKTcF0,SpATywNh6bZuzm8s1ceuBUnMUAeoAHHw,24,41,2,20,1,15,17,2,98,14.0,6,0.0,5,2,19,1,36,15,1,17,2,27,71,1
5422,105325,afcoJmZ0nAGqrhElRzMbfqW6LhEtEJYc,A3fsA9Zfv1X2fVEQhTw51lKENdNrEqT3,10,5,4,0,4,0,2,0,15,2.142857142857143,1,0.0,0,4,0,4,5,0,0,2,0,8,7,1
5423,105329,e7lti3fBvO8XZNtS4I7hMo5JFh6PqMCH,A3fsA9Zfv1X2fVEQhTw51lKENdNrEqT3,3,2,0,0,0,0,2,0,4,0.5714285714285714,1,0.0,0,0,0,0,2,0,0,2,0,0,4,1
5424,105330,l1I3uQILh7eNNq6Rwc2qZc5y0kyUy4xt,SpATywNh6bZuzm8s1ceuBUnMUAeoAHHw,1,0,0,0,0,0,1,0,1,0.14285714285714285,1,0.0,0,0,0,0,0,0,0,1,0,0,1,1
5425,105337,DI0mr4BQNoklidHTIy9m8FuU69db5M3W,SpATywNh6bZuzm8s1ceuBUnMUAeoAHHw,6,6,2,0,1,0,2,0,11,1.5714285714285714,2,0.0,0,2,0,1,6,0,0,2,0,3,8,1
5426,105339,fa4GjkZRgCxI5T2nX0B0SnNvYjPJTUJZ,bWdj2GDclj5ofokWjzoa5jAwMkxCykd6,2,0,0,0,0,0,3,0,3,0.42857142857142855,1,0.0,0,0,0,0,0,0,0,3,0,0,3,1
5427,105346,8cxCnT3STAEth9x4HzjOcerWufkhGlX3,SpATywNh6bZuzm8s1ceuBUnMUAeoAHHw,10,3,2,0,2,4,7,1,19,2.7142857142857144,1,0.0,0,2,0,2,3,4,0,7,1,4,15,1
5428,105348,jyuEVmbrPcyGnV7pufxSb0rPrKJZItsk,SpATywNh6bZuzm8s1ceuBUnMUAeoAHHw,16,40,20,19,7,2,8,0,96,13.714285714285714,4,0.0,14,20,16,7,26,2,3,8,0,57,39,1
5429,105354,yPqVjRtl1ZeCcEk7haS4nj4BOuHk3MT1,A3fsA9Zfv1X2fVEQhTw51lKENdNrEqT3,1,0,0,0,0,0,2,0,2,0.2857142857142857,1,0.0,0,0,0,0,0,0,0,2,0,0,2,1
5430,105357,Q9q5caNwjGe6Mi6I72wyiS18BJTL4KH1,SpATywNh6bZuzm8s1ceuBUnMUAeoAHHw,11,15,4,16,0,0,4,0,39,5.571428571428571,1,0.0,8,4,14,0,7,0,2,4,0,26,13,1
5431,105362,IqTYyD7L0euRgN3diEzqrprrc2W9uyF6,A3fsA9Zfv1X2fVEQhTw51lKENdNrEqT3,14,8,6,0,5,4,5,1,29,4.142857142857143,2,0.0,0,6,0,5,8,4,0,5,1,11,18,1
5432,105369,ATdd6t2UWonXImy5O3tzf7AEJJ0cHqzx,SpATywNh6bZuzm8s1ceuBUnMUAeoAHHw,3,0,0,0,0,0,3,0,3,0.42857142857142855,1,0.0,0,0,0,0,0,0,0,3,0,0,3,1
5433,105392,m52MhXMTVGYF4Y9Pc8zOC6jKXo973eSz,SpATywNh6bZuzm8s1ceuBUnMUAeoAHHw,1,0,0,0,0,0,1,0,1,0.14285714285714285,1,0.0,0,0,0,0,0,0,0,1,0,0,1,1
5434,105410,vqSgORDp5PsEpveQVJoPh4dnJvR6AQkK,A3fsA9Zfv1X2fVEQhTw51lKENdNrEqT3,1,0,0,0,0,0,1,0,1,0.14285714285714285,1,0.0,0,0,0,0,0,0,0,1,0,0,1,1
5435,105420,biOEnvJNbNmJmtnLohBToN5g3ppQrMj4,SpATywNh6bZuzm8s1ceuBUnMUAeoAHHw,5,8,4,0,1,0,3,0,16,2.2857142857142856,2,0.0,0,4,0,1,8,0,0,3,0,5,11,1
5436,105421,DgZ8el6keJUnUjxjYHQCrfhij2kpBixa,bWdj2GDclj5ofokWjzoa5jAwMkxCykd6,7,9,3,0,1,0,1,0,14,2.0,1,0.0,0,3,0,1,9,0,0,1,0,4,10,0
5437,105425,EBjWbzPkmDW0GuiUkHj889OvqfrdDhI2,SpATywNh6bZuzm8s1ceuBUnMUAeoAHHw,9,8,5,4,0,0,3,0,20,2.857142857142857,1,0.0,1,5,4,0,7,0,0,3,0,10,10,1
5438,105428,h3LsKXMnT4HqL0yI33YFdQ7c6aiA632R,SpATywNh6bZuzm8s1ceuBUnMUAeoAHHw,15,24,7,9,3,10,3,2,58,8.285714285714286,1,0.0,15,7,9,3,9,10,0,3,2,34,24,1
5439,105434,3n6ajKAkQu8rgtUnNpdWOfMF8VSNsMVs,A3fsA9Zfv1X2fVEQhTw51lKENdNrEqT3,4,2,1,0,0,0,3,0,6,0.8571428571428571,2,0.0,0,1,0,0,2,0,0,3,0,1,5,1
5440,105436,wbX1noywm1bmZy8t47H8TCRwxZP7RsKK,bWdj2GDclj5ofokWjzoa5jAwMkxCykd6,1,0,0,0,0,0,1,0,1,0.14285714285714285,1,0.0,0,0,0,0,0,0,0,1,0,0,1,1
5441,105438,4bmL6hoAF72J4V8IxCYpOyypEujwyDUs,A3fsA9Zfv1X2fVEQhTw51lKENdNrEqT3,6,2,0,0,0,1,5,0,8,1.1428571428571428,1,0.0,0,0,0,0,2,1,0,5,0,0,8,1
5442,105442,1YSmilr2ajm5pFk4iAawwfB3mRapy4GR,A3fsA9Zfv1X2fVEQhTw51lKENdNrEqT3,4,2,1,0,1,0,1,0,5,0.7142857142857143,1,0.0,0,1,0,1,2,0,0,1,0,2,3,1
5443,105467,dEPUxcdyZTnKUVP0o2JXv6VWX3ETnwmr,bWdj2GDclj5ofokWjzoa5jAwMkxCykd6,6,2,1,0,0,0,4,0,7,1.0,1,0.0,1,1,0,0,1,0,0,4,0,2,5,1
5444,105476,pMxyBMX7n5deuUC9YyUONEJJAyoPl0BG,SpATywNh6bZuzm8s1ceuBUnMUAeoAHHw,7,5,0,0,0,0,2,0,7,1.0,1,0.0,0,0,0,0,5,0,0,2,0,0,7,1
5445,105477,uMcognJuP2U8fvNcuj2o9G4hdrHlzffM,SpATywNh6bZuzm8s1ceuBUnMUAeoAHHw,8,13,6,0,0,1,11,1,32,4.571428571428571,1,0.0,2,6,0,0,11,1,0,11,1,8,24,1
5446,105482,sVA3jWGeZiIVEsBLKNyDfSGu7oUE3Uyc,A3fsA9Zfv1X2fVEQhTw51lKENdNrEqT3,2,0,0,0,0,0,5,0,5,0.7142857142857143,3,0.0,0,0,0,0,0,0,0,5,0,0,5,1
5447,105494,RS3yqsxA8GMaO1hS4uSnfa6jOPVVMGWD,bWdj2GDclj5ofokWjzoa5jAwMkxCykd6,6,3,1,0,1,0,2,0,7,1.0,1,0.0,0,1,0,1,3,0,0,2,0,2,5,1
5448,105522,Sj6pTyY9d8gvsSx1FCIqF3bTiiQB5ISO,RXDvfPUBYFlVdlueBFbLW0mhhAyGEqpt,1,0,0,0,0,0,1,0,1,0.14285714285714285,1,0.0,0,0,0,0,0,0,0,1,0,0,1,1
5449,105531,E9EKlY1j2c1T8yweLd0nuHvfVuBiMa1Z,SpATywNh6bZuzm8s1ceuBUnMUAeoAHHw,1,0,0,0,0,0,1,0,1,0.14285714285714285,1,0.0,0,0,0,0,0,0,0,1,0,0,1,1
5450,105536,JiGlqAbyZaZegus8dku8k8Xk9BHhTCdV,SpATywNh6bZuzm8s1ceuBUnMUAeoAHHw,8,2,1,0,1,5,7,1,17,2.4285714285714284,1,0.0,0,1,0,1,2,5,0,7,1,2,15,1
5451,105547,x3ZcCHvytIJQEMLj5E05tgfA0i9bCC3E,SpATywNh6bZuzm8s1ceuBUnMUAeoAHHw,1,0,0,0,0,0,1,0,1,0.14285714285714285,1,0.0,0,0,0,0,0,0,0,1,0,0,1,1
5452,105556,aa0arothpvvvORCnYecBgFktA9Cuu0Tk,SpATywNh6bZuzm8s1ceuBUnMUAeoAHHw,12,10,7,4,5,0,2,0,28,4.0,1,0.0,0,7,4,5,10,0,0,2,0,16,12,1
5453,105558,GbO46rd9u4nTIYKWQ4uqsc2u6MxCvlf3,A3fsA9Zfv1X2fVEQhTw51lKENdNrEqT3,7,8,5,0,0,0,5,0,18,2.5714285714285716,3,0.0,0,5,0,0,8,0,0,5,0,5,13,1
5454,105566,QsEau4BvaT6rjAper2QSXSr2L9nKgnZa,SpATywNh6bZuzm8s1ceuBUnMUAeoAHHw,1,0,0,0,0,0,1,0,1,0.14285714285714285,1,0.0,0,0,0,0,0,0,0,1,0,0,1,0
5455,105583,Cb1oMMLwTjTacmho2xz7pvU7NsoZgScq,A3fsA9Zfv1X2fVEQhTw51lKENdNrEqT3,6,3,2,0,2,0,1,0,8,1.1428571428571428,1,0.0,0,2,0,2,3,0,0,1,0,4,4,1
5456,105593,CVNZnTiRds77aV88t7oO5JnyjLjE4gZ5,A3fsA9Zfv1X2fVEQhTw51lKENdNrEqT3,8,6,3,0,3,0,1,0,13,1.8571428571428572,1,0.0,0,3,0,3,6,0,0,1,0,6,7,1
5457,105607,Z91ylcCa0QBPuZRAZnN7Bi8KMhEMk84I,SpATywNh6bZuzm8s1ceuBUnMUAeoAHHw,1,0,0,0,0,0,1,0,1,0.14285714285714285,1,0.0,0,0,0,0,0,0,0,1,0,0,1,1
5458,105612,kTfeD1yVO5Jc7Nzx4cKtELWtok3ws4tr,bWdj2GDclj5ofokWjzoa5jAwMkxCykd6,8,10,0,0,0,36,8,1,55,7.857142857142857,2,0.0,2,0,0,0,8,36,0,8,1,2,53,1
5459,105613,Z91ylcCa0QBPuZRAZnN7Bi8KMhEMk84I,RXDvfPUBYFlVdlueBFbLW0mhhAyGEqpt,1,0,0,0,0,0,1,0,1,0.14285714285714285,1,0.0,0,0,0,0,0,0,0,1,0,0,1,1
5460,105617,6ZG1BmPHf4xACRz5Wb0XhmecfqdoDBrw,SpATywNh6bZuzm8s1ceuBUnMUAeoAHHw,9,10,2,0,0,1,7,1,21,3.0,1,0.0,0,2,0,0,10,1,0,7,1,2,19,1
5461,105619,XDUz0oVcNwke0CqAlFlmwOWSA32SgeFl,RXDvfPUBYFlVdlueBFbLW0mhhAyGEqpt,1,0,0,0,0,0,1,0,1,0.14285714285714285,1,0.0,0,0,0,0,0,0,0,1,0,0,1,1
5462,105621,Z2LpxeyN5IUym4huJGBt4liqsVm2EQ7Q,SpATywNh6bZuzm8s1ceuBUnMUAeoAHHw,24,42,13,33,3,35,30,1,157,22.428571428571427,8,0.0,8,13,27,3,34,35,6,30,1,51,106,0
5463,105630,UU4MEikmCGklRVK3djHNSk7yxxkesa3p,bWdj2GDclj5ofokWjzoa5jAwMkxCykd6,12,15,10,0,4,4,15,0,48,6.857142857142857,2,0.0,0,10,0,4,15,4,0,15,0,14,34,1
5464,105631,RWrD2aL8EikwNOiemk8w8nKZlf66LQBh,SpATywNh6bZuzm8s1ceuBUnMUAeoAHHw,4,5,3,0,3,0,2,0,13,1.8571428571428572,2,0.0,1,3,0,3,4,0,0,2,0,7,6,1
5465,105635,6UsHFnhiB8wUPOMCvGQlekDt4oV3KUX3,A3fsA9Zfv1X2fVEQhTw51lKENdNrEqT3,5,3,2,0,0,0,7,1,13,1.8571428571428572,2,0.0,0,2,0,0,3,0,0,7,1,2,11,1
5466,105657,GRVPWiEvNASyREwGmbaFNHUClZD26ajQ,A3fsA9Zfv1X2fVEQhTw51lKENdNrEqT3,9,3,3,0,3,0,3,0,12,1.7142857142857142,1,0.0,0,3,0,3,3,0,0,3,0,6,6,1
5467,105659,HDn8BqQviq3qzBRDiLH1seTa1wZLl2Fv,SpATywNh6bZuzm8s1ceuBUnMUAeoAHHw,2,0,0,0,0,0,2,0,2,0.2857142857142857,1,0.0,0,0,0,0,0,0,0,2,0,0,2,1
5468,105674,pPG4IhCdtFDb0ApVQ8Cw5mvhtg1pBVlc,A3fsA9Zfv1X2fVEQhTw51lKENdNrEqT3,1,0,0,0,0,0,1,0,1,0.14285714285714285,1,0.0,0,0,0,0,0,0,0,1,0,0,1,1
5469,105683,RyhsCovpAO4Tu33MEtD28G55TyhpodT7,bWdj2GDclj5ofokWjzoa5jAwMkxCykd6,1,0,0,0,0,0,2,0,2,0.2857142857142857,1,0.0,0,0,0,0,0,0,0,2,0,0,2,1
5470,105686,ZMYniXzfaHfNUK3JevOZjrK1dOWNKOE7,A3fsA9Zfv1X2fVEQhTw51lKENdNrEqT3,2,0,0,0,0,0,2,0,2,0.2857142857142857,1,0.0,0,0,0,0,0,0,0,2,0,0,2,1
5471,105692,vP4adNJVoKfOfC59LI5B3RjnV290gjOc,SpATywNh6bZuzm8s1ceuBUnMUAeoAHHw,4,2,0,0,0,0,2,0,4,0.5714285714285714,1,0.0,0,0,0,0,2,0,0,2,0,0,4,1
5472,105705,Higp7tL2evAdDfwxJ7Fv3MD5xI1FILhG,bWdj2GDclj5ofokWjzoa5jAwMkxCykd6,1,0,0,0,0,0,1,0,1,0.14285714285714285,1,0.0,0,0,0,0,0,0,0,1,0,0,1,1
5473,105717,YGd4irzc5KMR1PH2KdOtbCkghLMZ2dPk,SpATywNh6bZuzm8s1ceuBUnMUAeoAHHw,9,6,4,10,0,0,2,0,22,3.142857142857143,1,0.0,2,4,9,0,4,0,1,2,0,15,7,1
5474,105773,40Xea2YMOWW1uT2M8t7POlJQUIkhUdnJ,7GRhBDsirIGkRZBtSMEzNTyDr2JQm4xx,7,4,3,0,2,0,3,0,12,1.7142857142857142,1,0.0,0,3,0,2,4,0,0,3,0,5,7,1
5475,105862,QcbB4zGNvIA8Hos1EmgULZPHy4JycNs5,7GRhBDsirIGkRZBtSMEzNTyDr2JQm4xx,1,0,0,0,0,0,2,0,2,0.2857142857142857,1,0.0,0,0,0,0,0,0,0,2,0,0,2,1
5476,105928,T8ZgVxZ1KcbbwwKauSYOnW28FLVyPTlj,7GRhBDsirIGkRZBtSMEzNTyDr2JQm4xx,2,0,0,0,0,0,2,0,2,0.2857142857142857,1,0.0,0,0,0,0,0,0,0,2,0,0,2,1
5477,105967,FxPyq8YtKk0yw3NNE8ZksN1yqg6GsuE4,7GRhBDsirIGkRZBtSMEzNTyDr2JQm4xx,2,0,0,0,0,0,6,0,6,0.8571428571428571,1,0.0,0,0,0,0,0,0,0,6,0,0,6,1
5478,105969,ikVmCxeXCKQtR8OPUUdHoGQCjATpEVdj,7GRhBDsirIGkRZBtSMEzNTyDr2JQm4xx,9,6,2,6,2,1,5,0,22,3.142857142857143,1,0.0,2,2,5,2,4,1,1,5,0,11,11,1
5479,105978,Z0RxOk6qXdCVEUwgYNFnCN7QFecq61SF,7GRhBDsirIGkRZBtSMEzNTyDr2JQm4xx,1,0,0,0,0,0,1,0,1,0.14285714285714285,1,0.0,0,0,0,0,0,0,0,1,0,0,1,1
5480,106017,UTdeWmi6AePo1O6hg6pDbCCeGok0eGfZ,7GRhBDsirIGkRZBtSMEzNTyDr2JQm4xx,1,0,0,0,0,0,1,0,1,0.14285714285714285,1,0.0,0,0,0,0,0,0,0,1,0,0,1,1
5481,106440,FiDLmZS7SZoCB8c2FPrLrdnRZi9p4XPX,bWdj2GDclj5ofokWjzoa5jAwMkxCykd6,4,2,1,0,1,0,1,0,5,0.7142857142857143,1,0.0,0,1,0,1,2,0,0,1,0,2,3,0
5482,106860,6lERIt9LK72b4gBh1gc6JqDmon4igZIH,A3fsA9Zfv1X2fVEQhTw51lKENdNrEqT3,4,2,1,0,1,0,1,0,5,0.7142857142857143,1,0.0,0,1,0,1,2,0,0,1,0,2,3,0
5483,106897,yrxUCbkwiU0Qgu0wZMF5MylHBneN7zri,SpATywNh6bZuzm8s1ceuBUnMUAeoAHHw,25,35,18,16,9,0,4,0,82,11.714285714285714,3,0.0,3,18,16,9,32,0,0,4,0,46,36,0
5484,107984,ZvjGFQSLt8Pf81ZTzV1faPXh7hwFiT2P,bWdj2GDclj5ofokWjzoa5jAwMkxCykd6,5,2,1,0,1,0,2,0,6,0.8571428571428571,1,0.0,0,1,0,1,2,0,0,2,0,2,4,1
5485,108010,Yw9EoSKbruOuBH6aQRkV9fYbTLRt0cv4,RXDvfPUBYFlVdlueBFbLW0mhhAyGEqpt,17,26,14,0,4,33,8,11,96,13.714285714285714,2,0.0,3,14,0,4,23,33,0,8,11,21,75,0
5486,108016,oqv7kZUhC1l3nFsgavJo476khlgSwYid,SpATywNh6bZuzm8s1ceuBUnMUAeoAHHw,1,0,0,0,0,0,1,0,1,0.14285714285714285,1,0.0,0,0,0,0,0,0,0,1,0,0,1,1
5487,108020,0vxEa23unQMrxuymP5mTGCJs9sE8CeTU,SpATywNh6bZuzm8s1ceuBUnMUAeoAHHw,1,0,0,0,0,0,2,0,2,0.2857142857142857,1,0.0,0,0,0,0,0,0,0,2,0,0,2,1
5488,108024,0twK7rhgKGqeqt1sYkdUHMDWvjIusJRc,SpATywNh6bZuzm8s1ceuBUnMUAeoAHHw,7,3,2,0,2,0,2,0,9,1.2857142857142858,1,0.0,0,2,0,2,3,0,0,2,0,4,5,1
5489,108034,2jvZGTQOv5HI5u69PvJ98o1zG3YXhtLw,G8EPVSXsOYB5YQWZGiz1aVq5Pgr2GrQu,14,12,1,38,0,0,3,0,54,7.714285714285714,1,0.0,5,1,34,0,7,0,4,3,0,40,14,1
5490,108042,aF4i8JIBNexmNiVkNsVLybq4ZcEaP7YR,SpATywNh6bZuzm8s1ceuBUnMUAeoAHHw,6,2,1,0,1,0,3,0,7,1.0,1,0.0,0,1,0,1,2,0,0,3,0,2,5,1
5491,108050,eJGGi2xDKgvawXthli4R4Tq9NtEOUzLF,SpATywNh6bZuzm8s1ceuBUnMUAeoAHHw,1,0,0,0,0,0,1,0,1,0.14285714285714285,1,0.0,0,0,0,0,0,0,0,1,0,0,1,1
5492,108052,wBGtqMIqfQE0VLJPhcCJAUkBOhFNa6qW,SpATywNh6bZuzm8s1ceuBUnMUAeoAHHw,8,3,2,0,2,1,6,1,15,2.142857142857143,1,0.0,0,2,0,2,3,1,0,6,1,4,11,1
5493,108071,EboqTOLce3Kcnbr13rePsINEM3noHrcD,G8EPVSXsOYB5YQWZGiz1aVq5Pgr2GrQu,18,13,7,16,4,2,13,6,61,8.714285714285714,3,0.0,1,7,13,4,12,2,3,13,6,25,36,0
5494,108073,RMWokNypcdQUZgRk5KLBAzdNAXoaWUZf,G8EPVSXsOYB5YQWZGiz1aVq5Pgr2GrQu,6,6,1,0,0,1,4,0,12,1.7142857142857142,2,0.0,0,1,0,0,6,1,0,4,0,1,11,1
5495,108131,IBlECzoX8mSOCzZYc1uWUiXexIzVTXM2,SpATywNh6bZuzm8s1ceuBUnMUAeoAHHw,8,5,3,0,2,1,5,0,16,2.2857142857142856,1,0.0,0,3,0,2,5,1,0,5,0,5,11,1
5496,108136,JtMmp5BCDQnYE7CMI3NvnX4aRCZsQW9K,SpATywNh6bZuzm8s1ceuBUnMUAeoAHHw,1,0,0,0,0,0,1,0,1,0.14285714285714285,1,0.0,0,0,0,0,0,0,0,1,0,0,1,1
5497,108150,JtMmp5BCDQnYE7CMI3NvnX4aRCZsQW9K,G8EPVSXsOYB5YQWZGiz1aVq5Pgr2GrQu,1,0,0,0,0,0,1,0,1,0.14285714285714285,1,0.0,0,0,0,0,0,0,0,1,0,0,1,1
5498,108157,qkSLpyUXo3wNVtHKY2foszTLsaaG0zFf,SpATywNh6bZuzm8s1ceuBUnMUAeoAHHw,7,9,5,0,1,0,6,0,21,3.0,1,0.0,0,5,0,1,9,0,0,6,0,6,15,1
5499,108159,7wwnUxCzQI2wyfpl5OyzTa3WTS3Ri45e,A3fsA9Zfv1X2fVEQhTw51lKENdNrEqT3,6,3,1,0,1,0,5,0,10,1.4285714285714286,1,0.0,0,1,0,1,3,0,0,5,0,2,8,1
5500,108176,3uS5WA36Sj3PVBnvxWDx1MwVkWDCgzsS,SpATywNh6bZuzm8s1ceuBUnMUAeoAHHw,2,0,0,0,0,0,2,0,2,0.2857142857142857,1,0.0,0,0,0,0,0,0,0,2,0,0,2,1
5501,108194,BUjI8VQSt0tGyIQBRIK2BBh4HRC6a57H,SpATywNh6bZuzm8s1ceuBUnMUAeoAHHw,7,11,5,0,2,0,4,0,22,3.142857142857143,2,0.0,0,5,0,2,11,0,0,4,0,7,15,1
5502,108212,dbPMzxs1MK4eXxSu7capyuymr7qmuT7h,SpATywNh6bZuzm8s1ceuBUnMUAeoAHHw,13,13,4,12,3,0,3,0,35,5.0,1,0.0,7,4,11,3,6,0,1,3,0,25,10,1
5503,108216,vpqIMSPa2wuLU7jLHJxpKglWXRMFM5XG,G8EPVSXsOYB5YQWZGiz1aVq5Pgr2GrQu,10,6,3,0,3,0,3,0,15,2.142857142857143,1,0.0,1,3,0,3,5,0,0,3,0,7,8,1
5504,108224,Q5TmTVdy8nnH2vTL73s67ZseaCMO3k91,A3fsA9Zfv1X2fVEQhTw51lKENdNrEqT3,22,16,14,22,3,0,15,0,70,10.0,1,0.0,0,14,17,3,16,0,5,15,0,34,36,1
5505,108232,Vuj7KEezi5cbt5TkGTsUazylLOCSeSWW,G8EPVSXsOYB5YQWZGiz1aVq5Pgr2GrQu,6,7,1,0,1,1,5,0,15,2.142857142857143,1,0.0,4,1,0,1,3,1,0,5,0,6,9,1
5506,108238,kacdt9t6znrlEBdAnqrcK2PQA5VKsmyU,bWdj2GDclj5ofokWjzoa5jAwMkxCykd6,1,0,0,0,0,0,1,0,1,0.14285714285714285,1,0.0,0,0,0,0,0,0,0,1,0,0,1,1
5507,108248,GfEp1fhW8V7ekci3T3EdNbH3NBJ6ewC2,bWdj2GDclj5ofokWjzoa5jAwMkxCykd6,10,14,9,0,4,0,6,0,33,4.714285714285714,2,0.0,0,9,0,4,14,0,0,6,0,13,20,1
5508,108249,U86H0D53uFDssNj4hNXQwNhRzNF9WB0g,SpATywNh6bZuzm8s1ceuBUnMUAeoAHHw,10,3,2,0,2,0,5,0,12,1.7142857142857142,2,0.0,0,2,0,2,3,0,0,5,0,4,8,1
5509,108253,ZBWbhIaLqDYBcX3S1kBM4TsAR4PCNgfw,SpATywNh6bZuzm8s1ceuBUnMUAeoAHHw,1,0,0,0,0,0,1,0,1,0.14285714285714285,1,0.0,0,0,0,0,0,0,0,1,0,0,1,1
5510,108260,BKTGezJoHjleu4tXARXtOL0EOZtL4wb9,A3fsA9Zfv1X2fVEQhTw51lKENdNrEqT3,5,6,3,0,0,0,2,0,11,1.5714285714285714,1,0.0,0,3,0,0,6,0,0,2,0,3,8,1
5511,108287,vD0of5WrmeM0o4WJQ1K1mROO3xI4vaqL,A3fsA9Zfv1X2fVEQhTw51lKENdNrEqT3,8,11,9,0,0,0,3,0,23,3.2857142857142856,1,0.0,0,9,0,0,11,0,0,3,0,9,14,1
5512,108322,fDs5TBVrvPHEIMLkBACIVQ2YkCdHCFLD,G8EPVSXsOYB5YQWZGiz1aVq5Pgr2GrQu,1,0,0,0,0,0,1,0,1,0.14285714285714285,1,0.0,0,0,0,0,0,0,0,1,0,0,1,1
5513,108332,t3IeBt0q2KGXGh8PROvXa3GntwInvrsf,SpATywNh6bZuzm8s1ceuBUnMUAeoAHHw,12,19,5,15,3,5,6,0,53,7.571428571428571,1,0.0,14,5,14,3,5,5,1,6,0,36,17,1
5514,108334,OTVmyM3oMOEh3RPUJ9JvZ1cqJuClk9Op,bWdj2GDclj5ofokWjzoa5jAwMkxCykd6,6,5,2,0,1,0,3,0,11,1.5714285714285714,1,0.0,1,2,0,1,4,0,0,3,0,4,7,1
5515,108352,iqv1ZLT0r4OWnPHIoXugw2YP50zRTQ28,SpATywNh6bZuzm8s1ceuBUnMUAeoAHHw,8,4,3,0,2,0,2,0,11,1.5714285714285714,1,0.0,0,3,0,2,4,0,0,2,0,5,6,1
5516,108405,uyomj5PLSD8MuBnIm3UXNOM2zJB1f3kv,A3fsA9Zfv1X2fVEQhTw51lKENdNrEqT3,13,11,1,22,0,0,4,0,38,5.428571428571429,1,0.0,0,1,18,0,11,0,4,4,0,19,19,1
5517,108406,bQyZ6DmGQSg1Dv1lCa5q9TEfeZ36WEXr,SpATywNh6bZuzm8s1ceuBUnMUAeoAHHw,5,2,1,0,1,0,2,0,6,0.8571428571428571,1,0.0,0,1,0,1,2,0,0,2,0,2,4,1
5518,108412,SEiKj37VG0PEpKDpAqYMYNdcODsfurcu,SpATywNh6bZuzm8s1ceuBUnMUAeoAHHw,1,0,0,0,0,0,1,0,1,0.14285714285714285,1,0.0,0,0,0,0,0,0,0,1,0,0,1,1
5519,108421,Z8VFKUoySr9L7FZfGeoeDWQqxwnJbTos,SpATywNh6bZuzm8s1ceuBUnMUAeoAHHw,21,46,1,25,1,8,10,0,91,13.0,4,0.0,11,1,25,1,35,8,0,10,0,38,53,0
5520,108427,xVeg2852GnVdRuLPSlBP0iZfvv9oAoyC,SpATywNh6bZuzm8s1ceuBUnMUAeoAHHw,9,3,2,0,2,1,4,1,13,1.8571428571428572,1,0.0,0,2,0,2,3,1,0,4,1,4,9,1
5521,108446,d08ApNp1WFaPBGXKvD3xbJPFNLpPIfS7,A3fsA9Zfv1X2fVEQhTw51lKENdNrEqT3,1,0,0,0,0,0,1,0,1,0.14285714285714285,1,0.0,0,0,0,0,0,0,0,1,0,0,1,1
5522,108449,dclSFP3hreeLXdhyb5AYWKpQgF9cKZB8,A3fsA9Zfv1X2fVEQhTw51lKENdNrEqT3,1,0,0,0,0,0,2,0,2,0.2857142857142857,1,0.0,0,0,0,0,0,0,0,2,0,0,2,1
5523,108452,Da1XsE2lZHBZahEFVPSmxclehQ2xZK1j,RXDvfPUBYFlVdlueBFbLW0mhhAyGEqpt,1,0,0,0,0,0,2,0,2,0.2857142857142857,2,0.0,0,0,0,0,0,0,0,2,0,0,2,1
5524,108457,AeCrxYByugIwu4XUBpI0LhoTguBozLAa,A3fsA9Zfv1X2fVEQhTw51lKENdNrEqT3,41,26,13,74,10,0,4,0,127,18.142857142857142,2,0.0,1,13,66,10,25,0,8,4,0,90,37,1
5525,108519,Wz77TRcICZ17h9qFLsblYtkOSc4ixQ6c,G8EPVSXsOYB5YQWZGiz1aVq5Pgr2GrQu,11,8,3,0,3,1,6,1,22,3.142857142857143,1,0.0,3,3,0,3,5,1,0,6,1,9,13,1
5526,108541,vZzTgGwK0cR24BSm1xzdfANP52hj4iMk,bWdj2GDclj5ofokWjzoa5jAwMkxCykd6,2,0,0,0,0,0,2,0,2,0.2857142857142857,1,0.0,0,0,0,0,0,0,0,2,0,0,2,1
5527,108543,vZzTgGwK0cR24BSm1xzdfANP52hj4iMk,A3fsA9Zfv1X2fVEQhTw51lKENdNrEqT3,6,4,1,0,0,0,7,0,12,1.7142857142857142,2,0.0,0,1,0,0,4,0,0,7,0,1,11,1
5528,108545,RzzALWvRctgoyhkcvSWQNXbBdfBwiqD5,A3fsA9Zfv1X2fVEQhTw51lKENdNrEqT3,26,11,10,24,8,0,1,0,54,7.714285714285714,1,0.0,0,10,23,8,11,0,1,1,0,41,13,1
5529,108563,cJebZdZYNfcRFrDILULKtUjsVZucvQNZ,A3fsA9Zfv1X2fVEQhTw51lKENdNrEqT3,1,0,0,0,0,0,2,0,2,0.2857142857142857,1,0.0,0,0,0,0,0,0,0,2,0,0,2,1
5530,108568,nMLZADizXQkPbs7I128RAOQN3Z54bNq5,G8EPVSXsOYB5YQWZGiz1aVq5Pgr2GrQu,1,0,0,0,0,0,1,0,1,0.14285714285714285,1,0.0,0,0,0,0,0,0,0,1,0,0,1,1
5531,108580,T96tu0kAAtO9h4UaJoJi1p0l5O91f75g,SpATywNh6bZuzm8s1ceuBUnMUAeoAHHw,1,0,0,0,0,0,1,0,1,0.14285714285714285,1,0.0,0,0,0,0,0,0,0,1,0,0,1,1
5532,108593,b5A378d0kY1phoH7ZEYLGeRu5gSN3Jom,bWdj2GDclj5ofokWjzoa5jAwMkxCykd6,3,3,0,0,0,0,1,0,4,0.5714285714285714,1,0.0,0,0,0,0,3,0,0,1,0,0,4,1
5533,108610,fwSe9M4wVBk21yhnHfi9Elq0Dtd4QFmB,A3fsA9Zfv1X2fVEQhTw51lKENdNrEqT3,1,0,0,0,0,0,1,0,1,0.14285714285714285,1,0.0,0,0,0,0,0,0,0,1,0,0,1,1
5534,108613,8QplB1koC0Z3ESwyMSDlYtTT9MlUMn1q,SpATywNh6bZuzm8s1ceuBUnMUAeoAHHw,15,23,8,17,3,4,3,1,59,8.428571428571429,1,0.0,6,8,15,3,17,4,2,3,1,32,27,1
5535,108618,6pZAnEuoA7RiYeKYKN3oDQwjOWGfm51A,A3fsA9Zfv1X2fVEQhTw51lKENdNrEqT3,6,7,3,0,1,0,3,0,14,2.0,2,0.0,0,3,0,1,7,0,0,3,0,4,10,1
5536,108642,kjQDeVPqENR6xvjjKnsVoxY8hUaoqktw,A3fsA9Zfv1X2fVEQhTw51lKENdNrEqT3,1,0,0,0,0,0,1,0,1,0.14285714285714285,1,0.0,0,0,0,0,0,0,0,1,0,0,1,1
5537,108643,hkTx4XunczsnVq4H9eVYRZURkkofvB6I,A3fsA9Zfv1X2fVEQhTw51lKENdNrEqT3,39,22,11,60,8,0,4,0,105,15.0,1,0.0,1,11,48,8,21,0,12,4,0,68,37,1
5538,108645,GC5D689aLkJhzPWQtqYm81ojaLgS2Wpz,A3fsA9Zfv1X2fVEQhTw51lKENdNrEqT3,6,1,0,0,0,0,4,1,6,0.8571428571428571,1,0.0,0,0,0,0,1,0,0,4,1,0,6,1
5539,108650,9RsO9nEnlOjxAtY8xl5lBuOHOGbVMyeg,A3fsA9Zfv1X2fVEQhTw51lKENdNrEqT3,11,9,5,0,4,0,3,0,21,3.0,1,0.0,0,5,0,4,9,0,0,3,0,9,12,1
5540,108658,FAjTaGnsfZLBQS9slQbYMPpuh5mcYxue,SpATywNh6bZuzm8s1ceuBUnMUAeoAHHw,16,16,7,20,0,12,12,1,68,9.714285714285714,4,0.0,4,7,17,0,12,12,3,12,1,28,40,0
5541,108675,EQrILQPubl10Uf5lVjVEtCpelMBJDysL,A3fsA9Zfv1X2fVEQhTw51lKENdNrEqT3,4,2,1,0,1,0,1,0,5,0.7142857142857143,1,0.0,0,1,0,1,2,0,0,1,0,2,3,1
5542,108685,vUg72yuNvNQBasGeqPwQue3GKgSAK3Os,A3fsA9Zfv1X2fVEQhTw51lKENdNrEqT3,43,13,11,70,10,6,5,1,116,16.571428571428573,1,0.0,1,11,61,10,12,6,9,5,1,83,33,1
5543,108690,Ofc6ixmmoavYN92PkloL7C1g0H36jbU2,bWdj2GDclj5ofokWjzoa5jAwMkxCykd6,5,2,1,0,1,0,2,0,6,0.8571428571428571,1,0.0,0,1,0,1,2,0,0,2,0,2,4,1
5544,108691,ETnDIYS5Ij7vrZAmbXEAqG1htLhXjsuH,SpATywNh6bZuzm8s1ceuBUnMUAeoAHHw,2,0,0,0,0,0,3,0,3,0.42857142857142855,1,0.0,0,0,0,0,0,0,0,3,0,0,3,1
5545,108692,Ofc6ixmmoavYN92PkloL7C1g0H36jbU2,RXDvfPUBYFlVdlueBFbLW0mhhAyGEqpt,5,3,1,0,1,0,2,0,7,1.0,1,0.0,0,1,0,1,3,0,0,2,0,2,5,1
5546,108709,WVlATpkkXvQVe3Tvai8IoxKvCeKjRiIw,A3fsA9Zfv1X2fVEQhTw51lKENdNrEqT3,4,2,1,0,1,0,1,0,5,0.7142857142857143,1,0.0,0,1,0,1,2,0,0,1,0,2,3,1
5547,108716,vEKYOhRdGZ59kfXY6wTO63YZY4EqPYqX,A3fsA9Zfv1X2fVEQhTw51lKENdNrEqT3,1,0,0,0,0,0,2,0,2,0.2857142857142857,1,0.0,0,0,0,0,0,0,0,2,0,0,2,1
5548,108726,SjPvBG8Fb7d7fOOQdZd3mlZyesFaFzzS,SpATywNh6bZuzm8s1ceuBUnMUAeoAHHw,12,16,4,9,3,8,1,0,41,5.857142857142857,1,0.0,11,4,9,3,5,8,0,1,0,27,14,1
5549,108730,APkKPEpve0ecRJut2qy8IYwsafYtrJRq,A3fsA9Zfv1X2fVEQhTw51lKENdNrEqT3,1,0,0,0,0,0,1,0,1,0.14285714285714285,1,0.0,0,0,0,0,0,0,0,1,0,0,1,1
5550,108759,bhb17IwRClCqRNHE7gBYbr4QuZbINJH7,SpATywNh6bZuzm8s1ceuBUnMUAeoAHHw,8,2,1,0,1,0,4,1,9,1.2857142857142858,1,0.0,0,1,0,1,2,0,0,4,1,2,7,1
5551,108770,i91HA7YyZRSQdFHabHG3p2UNPo1UnEE9,SpATywNh6bZuzm8s1ceuBUnMUAeoAHHw,6,0,0,0,0,1,5,1,7,1.0,1,0.0,0,0,0,0,0,1,0,5,1,0,7,1
5552,108777,jqvna1BzHcNX8F2L51mHo8iTsRvtrp5h,G8EPVSXsOYB5YQWZGiz1aVq5Pgr2GrQu,5,2,0,0,0,0,3,1,6,0.8571428571428571,1,0.0,0,0,0,0,2,0,0,3,1,0,6,1
5553,108783,XJEGQFjl8bj0TlozEJx10miZtxUTAzR8,G8EPVSXsOYB5YQWZGiz1aVq5Pgr2GrQu,6,5,2,0,0,0,2,0,9,1.2857142857142858,1,0.0,0,2,0,0,5,0,0,2,0,2,7,1
5554,108788,lE2eUyNgAborZHVo0d0toAQgs9JY0elm,bWdj2GDclj5ofokWjzoa5jAwMkxCykd6,1,0,0,0,0,0,1,0,1,0.14285714285714285,1,0.0,0,0,0,0,0,0,0,1,0,0,1,1
5555,108794,YpN0FUGuAT4i4OgsV1AMvBTJ03FCi4h4,SpATywNh6bZuzm8s1ceuBUnMUAeoAHHw,13,19,6,19,3,0,1,0,48,6.857142857142857,1,0.0,11,6,18,3,8,0,1,1,0,38,10,1
5556,108802,G6Ra4LKWBFlkpiQLwJKXdjsFL1NYBNU7,SpATywNh6bZuzm8s1ceuBUnMUAeoAHHw,8,10,7,0,4,0,8,1,30,4.285714285714286,1,0.0,0,7,0,4,10,0,0,8,1,11,19,1
5557,108816,7tzKJch94HYBj1yvg1gEwizifcqZuqol,SpATywNh6bZuzm8s1ceuBUnMUAeoAHHw,14,16,8,9,5,11,6,2,57,8.142857142857142,1,0.0,7,8,9,5,9,11,0,6,2,29,28,1
5558,108817,JJML5NgT9kE9CQ1mkNivVNVP1TfRNDmZ,G8EPVSXsOYB5YQWZGiz1aVq5Pgr2GrQu,10,11,3,0,3,0,3,0,20,2.857142857142857,2,0.0,5,3,0,3,6,0,0,3,0,11,9,1
5559,108819,y2DmmWW7ijkXHglZV8tDd3ydHBY1lyEP,SpATywNh6bZuzm8s1ceuBUnMUAeoAHHw,11,7,2,12,1,6,5,1,34,4.857142857142857,1,0.0,4,2,12,1,3,6,0,5,1,19,15,1
5560,108823,ToFnQfVVYpsgtNup5oaVFrzJEXqZqLe7,SpATywNh6bZuzm8s1ceuBUnMUAeoAHHw,4,3,1,0,1,0,1,0,6,0.8571428571428571,1,0.0,0,1,0,1,3,0,0,1,0,2,4,1
5561,108832,fZ0FA06F54ZxAJdajcaJsw9dO9sZFuoy,SpATywNh6bZuzm8s1ceuBUnMUAeoAHHw,8,3,2,0,2,2,4,1,14,2.0,1,0.0,0,2,0,2,3,2,0,4,1,4,10,1
5562,108836,S2vZm8iaot7LbfQexObVqVFppwpxyTJj,RXDvfPUBYFlVdlueBFbLW0mhhAyGEqpt,13,9,1,0,1,2,7,2,22,3.142857142857143,1,0.0,0,1,0,1,9,2,0,7,2,2,20,1
5563,108840,Gmz5iMjiwcyTx4KusyWM0rOecmUutZaf,bWdj2GDclj5ofokWjzoa5jAwMkxCykd6,7,4,2,0,1,0,3,0,10,1.4285714285714286,1,0.0,0,2,0,1,4,0,0,3,0,3,7,1
5564,108848,Aj8S98OGNNNrJMemSZdPdZipwwjNd5vE,A3fsA9Zfv1X2fVEQhTw51lKENdNrEqT3,8,7,3,0,3,0,1,0,14,2.0,1,0.0,0,3,0,3,7,0,0,1,0,6,8,0
5565,108863,rFLx9fxaxLoqhUJucYhN0TS80ql3o0el,G8EPVSXsOYB5YQWZGiz1aVq5Pgr2GrQu,6,3,2,0,2,4,1,0,12,1.7142857142857142,1,0.0,0,2,0,2,3,4,0,1,0,4,8,1
5566,108870,EyBRRLQ9lC714P9pZPb13KmtdxaOzX2x,A3fsA9Zfv1X2fVEQhTw51lKENdNrEqT3,5,2,1,0,1,0,2,0,6,0.8571428571428571,1,0.0,0,1,0,1,2,0,0,2,0,2,4,1
5567,108881,wKWD0CLruBoVWyxPKWZ61pmQ3HoT2Bog,SpATywNh6bZuzm8s1ceuBUnMUAeoAHHw,4,2,0,0,0,0,2,0,4,0.5714285714285714,1,0.0,0,0,0,0,2,0,0,2,0,0,4,1
5568,108896,rFLx9fxaxLoqhUJucYhN0TS80ql3o0el,SpATywNh6bZuzm8s1ceuBUnMUAeoAHHw,6,3,2,0,2,14,1,0,22,3.142857142857143,1,0.0,0,2,0,2,3,14,0,1,0,4,18,1
5569,108911,IcSi6sLfpSlHjHhdlf5rd2h3NSptZDO1,A3fsA9Zfv1X2fVEQhTw51lKENdNrEqT3,1,0,0,0,0,0,2,0,2,0.2857142857142857,1,0.0,0,0,0,0,0,0,0,2,0,0,2,1
5570,108918,vSo169SOn6AJKRTPbSllZALjmnCkOElL,G8EPVSXsOYB5YQWZGiz1aVq5Pgr2GrQu,12,28,4,0,3,1,23,1,60,8.571428571428571,3,0.0,0,4,0,3,28,1,0,23,1,7,53,1
5571,108937,GrD7pvZobVcyydLOoZLt2XOTjKEE4rVN,A3fsA9Zfv1X2fVEQhTw51lKENdNrEqT3,1,0,0,0,0,0,1,0,1,0.14285714285714285,1,0.0,0,0,0,0,0,0,0,1,0,0,1,1
5572,108940,4JgrlxTTs75mHh4mrh8qrfNDEELryL3p,A3fsA9Zfv1X2fVEQhTw51lKENdNrEqT3,22,30,13,0,10,0,5,0,58,8.285714285714286,1,0.0,0,13,0,10,30,0,0,5,0,23,35,1
5573,108943,tBILMisvPJumSCkGoqvXZmjsWBPsAhcx,RXDvfPUBYFlVdlueBFbLW0mhhAyGEqpt,1,0,0,0,0,0,1,0,1,0.14285714285714285,1,0.0,0,0,0,0,0,0,0,1,0,0,1,1
5574,108949,jcbtaVIpxYLzIPm0BM5PQEVvcUjaS5Wk,SpATywNh6bZuzm8s1ceuBUnMUAeoAHHw,5,2,1,0,1,0,4,0,8,1.1428571428571428,2,0.0,0,1,0,1,2,0,0,4,0,2,6,1
5575,108954,kLrl7hvNIzvhv6K321CFhgLYEgDfA62M,A3fsA9Zfv1X2fVEQhTw51lKENdNrEqT3,3,3,1,0,0,0,1,0,5,0.7142857142857143,1,0.0,0,1,0,0,3,0,0,1,0,1,4,1
5576,108956,cQImh85eb0T3yUp3SL5f7uBssRRbM6Re,A3fsA9Zfv1X2fVEQhTw51lKENdNrEqT3,9,9,1,0,1,0,3,0,14,2.0,1,0.0,0,1,0,1,9,0,0,3,0,2,12,1
5577,108964,a5FYs3qIaiIKIJ0gF2U8byHoJI2aZV3O,SpATywNh6bZuzm8s1ceuBUnMUAeoAHHw,2,0,0,0,0,0,2,0,2,0.2857142857142857,1,0.0,0,0,0,0,0,0,0,2,0,0,2,1
5578,108986,YCpaFH59BZea33ilZmurVIrcGKs7kkSW,A3fsA9Zfv1X2fVEQhTw51lKENdNrEqT3,8,7,5,0,0,1,4,2,19,2.7142857142857144,1,0.0,0,5,0,0,7,1,0,4,2,5,14,1
5579,109051,QzYbn86ruFNwqcTxxFURk0zGhEatBUQQ,RXDvfPUBYFlVdlueBFbLW0mhhAyGEqpt,1,0,0,0,0,0,1,0,1,0.14285714285714285,1,0.0,0,0,0,0,0,0,0,1,0,0,1,1
5580,109052,YQuE8HipF2FTxF6yilCc6Hjt2hO1hf9q,A3fsA9Zfv1X2fVEQhTw51lKENdNrEqT3,14,6,4,0,3,3,9,2,27,3.857142857142857,1,0.0,0,4,0,3,6,3,0,9,2,7,20,1
5581,109053,L7J2caDjAzkqOGAjsx5a9Dl5Aldyaum1,G8EPVSXsOYB5YQWZGiz1aVq5Pgr2GrQu,20,15,10,40,5,0,6,0,76,10.857142857142858,1,0.0,5,10,35,5,10,0,5,6,0,55,21,1
5582,109068,XkjQH424HqtaqeKw3sfi1hEAdISSsUfo,SpATywNh6bZuzm8s1ceuBUnMUAeoAHHw,5,2,1,0,1,0,2,0,6,0.8571428571428571,1,0.0,0,1,0,1,2,0,0,2,0,2,4,1
5583,109076,rqibqLTSyQMTu8RtpalbPrVfa4YBNses,A3fsA9Zfv1X2fVEQhTw51lKENdNrEqT3,1,0,0,0,0,0,1,0,1,0.14285714285714285,1,0.0,0,0,0,0,0,0,0,1,0,0,1,1
5584,109083,eRuuxh46RK1wEtA4qinnmcAexePgrgfl,A3fsA9Zfv1X2fVEQhTw51lKENdNrEqT3,2,0,0,0,0,0,4,0,4,0.5714285714285714,1,0.0,0,0,0,0,0,0,0,4,0,0,4,1
5585,109094,W72vMFAqWF3rx04XbAdkI4z1Q7B2JuRi,A3fsA9Zfv1X2fVEQhTw51lKENdNrEqT3,6,2,1,0,1,1,3,0,8,1.1428571428571428,1,0.0,0,1,0,1,2,1,0,3,0,2,6,1
5586,109103,MZomFQTbHAKaDGd0B9fv7KQ9MRsZJ7m6,A3fsA9Zfv1X2fVEQhTw51lKENdNrEqT3,7,7,2,0,1,0,4,0,14,2.0,2,0.0,0,2,0,1,7,0,0,4,0,3,11,1
5587,109113,PsjDYcq0jr7p5zzKT5Q6GyQwL0TaEGxZ,SpATywNh6bZuzm8s1ceuBUnMUAeoAHHw,1,0,0,0,0,0,1,0,1,0.14285714285714285,1,0.0,0,0,0,0,0,0,0,1,0,0,1,1
5588,109133,ktJXKKINyOPjiCF3mohYZXSugYepgG15,bWdj2GDclj5ofokWjzoa5jAwMkxCykd6,6,2,0,0,0,2,4,2,10,1.4285714285714286,1,0.0,0,0,0,0,2,2,0,4,2,0,10,1
5589,109134,V9A9B2T9pRTU3AqvpqzuKs4MfRcAEte2,A3fsA9Zfv1X2fVEQhTw51lKENdNrEqT3,10,21,13,0,10,0,9,0,53,7.571428571428571,2,0.0,0,13,0,10,21,0,0,9,0,23,30,1
5590,109141,cj6ogEjauZu0hDMlOaFW3lBaL32xGBVV,A3fsA9Zfv1X2fVEQhTw51lKENdNrEqT3,33,18,0,44,0,1,5,0,68,9.714285714285714,1,0.0,1,0,44,0,17,1,0,5,0,45,23,1
5591,109159,qflx2gEpsoPySBX8xNwFSgJhYyLnWK68,SpATywNh6bZuzm8s1ceuBUnMUAeoAHHw,5,2,1,0,1,0,2,0,6,0.8571428571428571,1,0.0,0,1,0,1,2,0,0,2,0,2,4,1
5592,109160,BjBet1XrpmufRo3nJSBrADvKxDiooNdd,SpATywNh6bZuzm8s1ceuBUnMUAeoAHHw,17,19,9,10,6,4,6,2,56,8.0,1,0.0,8,9,9,6,11,4,1,6,2,32,24,0
5593,109168,75JIeVMZStYpkimfm5Z5dMpV25aOohZB,A3fsA9Zfv1X2fVEQhTw51lKENdNrEqT3,1,0,0,0,0,0,1,0,1,0.14285714285714285,1,0.0,0,0,0,0,0,0,0,1,0,0,1,1
5594,109175,3HlwwUK8TRPXkUKapLyYM8Mklh9O7Jts,SpATywNh6bZuzm8s1ceuBUnMUAeoAHHw,1,0,0,0,0,0,1,0,1,0.14285714285714285,1,0.0,0,0,0,0,0,0,0,1,0,0,1,1
5595,109197,JWGtW72K75u0pLec4sms8rsOXm4SeKAG,SpATywNh6bZuzm8s1ceuBUnMUAeoAHHw,15,27,10,15,2,8,11,1,74,10.571428571428571,3,0.0,12,10,12,2,15,8,3,11,1,36,38,1
5596,109229,txSjWYX3TEWx5QLOiaADcbFdCZMHt7yE,A3fsA9Zfv1X2fVEQhTw51lKENdNrEqT3,8,5,0,0,0,0,4,3,12,1.7142857142857142,1,0.0,0,0,0,0,5,0,0,4,3,0,12,0
5597,109249,xHkJ6XK0y35MSFhta6m6oK3R3vwlFDsX,SpATywNh6bZuzm8s1ceuBUnMUAeoAHHw,6,3,1,0,1,0,2,0,7,1.0,1,0.0,0,1,0,1,3,0,0,2,0,2,5,1
5598,109255,N8EIkrIEEI0tSrQnptuBZRzWsVxCnAJ9,bWdj2GDclj5ofokWjzoa5jAwMkxCykd6,1,0,0,0,0,0,1,0,1,0.14285714285714285,1,0.0,0,0,0,0,0,0,0,1,0,0,1,1
5599,109285,PTDwgRsRPDT7EScAgKe30PHvW2ZEf3hf,SpATywNh6bZuzm8s1ceuBUnMUAeoAHHw,1,0,0,0,0,0,1,0,1,0.14285714285714285,1,0.0,0,0,0,0,0,0,0,1,0,0,1,1
5600,109288,J2q8zoWRny7YrAZZQIJQYIKpfAnrsg3t,SpATywNh6bZuzm8s1ceuBUnMUAeoAHHw,18,26,10,19,5,11,10,1,82,11.714285714285714,2,0.0,12,10,16,5,14,11,3,10,1,43,39,1
5601,109294,Qs7Gy3lEvMM83esFdoZ1zZvUeRYTAxxM,A3fsA9Zfv1X2fVEQhTw51lKENdNrEqT3,1,0,0,0,0,0,2,0,2,0.2857142857142857,1,0.0,0,0,0,0,0,0,0,2,0,0,2,1
5602,109308,giXuT5U1RtMqgo8IXt5j9x4mrlpr0AWq,bWdj2GDclj5ofokWjzoa5jAwMkxCykd6,10,22,2,28,3,0,17,0,72,10.285714285714286,4,0.0,6,2,26,3,16,0,2,17,0,37,35,1
5603,109309,WAUVjfvcVVKr4l1eRzgNNfyqoF4mUwKn,SpATywNh6bZuzm8s1ceuBUnMUAeoAHHw,20,27,18,17,5,0,8,0,75,10.714285714285714,2,0.0,4,18,15,5,23,0,2,8,0,42,33,1
5604,109323,h7wsu0U7FXIgaCVLolzif2WMIHfC12Bp,RXDvfPUBYFlVdlueBFbLW0mhhAyGEqpt,9,6,0,0,0,0,4,0,10,1.4285714285714286,2,0.0,0,0,0,0,6,0,0,4,0,0,10,1
5605,109342,obFxfGLSP12hWUYqYGw1SR5lINNLUPlg,SpATywNh6bZuzm8s1ceuBUnMUAeoAHHw,28,85,21,21,9,2,11,1,150,21.428571428571427,4,0.0,35,21,19,9,50,2,2,11,1,84,66,1
5606,109357,E3qy0Aw6hJTYQ75juho52GdWukHpC8PO,A3fsA9Zfv1X2fVEQhTw51lKENdNrEqT3,38,32,15,70,9,0,1,0,127,18.142857142857142,1,0.0,3,15,58,9,29,0,12,1,0,85,42,1
5607,109362,GzwlErGyP5vVrMuPju1CoSG91uAwN5Ll,A3fsA9Zfv1X2fVEQhTw51lKENdNrEqT3,1,0,0,0,0,0,1,0,1,0.14285714285714285,1,0.0,0,0,0,0,0,0,0,1,0,0,1,1
5608,109370,PgyyNRYpQtA302ymgWhOo3FWJ5ZVr14a,A3fsA9Zfv1X2fVEQhTw51lKENdNrEqT3,9,2,1,0,1,1,9,1,15,2.142857142857143,1,0.0,0,1,0,1,2,1,0,9,1,2,13,1
5609,109386,wRfMgDoh08sOJ1iN7xQ6xWeUhnvT3LS5,SpATywNh6bZuzm8s1ceuBUnMUAeoAHHw,5,2,1,0,1,0,4,0,8,1.1428571428571428,1,0.0,1,1,0,1,1,0,0,4,0,3,5,1
5610,109397,fwSe9M4wVBk21yhnHfi9Elq0Dtd4QFmB,bWdj2GDclj5ofokWjzoa5jAwMkxCykd6,5,3,1,0,1,0,2,0,7,1.0,1,0.0,0,1,0,1,3,0,0,2,0,2,5,1
5611,109399,r9Iw8qv5Gd0slmKCVr3aUz7TALROG0cf,bWdj2GDclj5ofokWjzoa5jAwMkxCykd6,1,0,0,0,0,0,1,0,1,0.14285714285714285,1,0.0,0,0,0,0,0,0,0,1,0,0,1,1
5612,109400,9uGUU0TH4lqYEkuGLK9jp9MwW0oSvGiG,A3fsA9Zfv1X2fVEQhTw51lKENdNrEqT3,9,4,1,0,1,10,11,2,29,4.142857142857143,4,0.0,0,1,0,1,4,10,0,11,2,2,27,1
5613,109426,Sq3omHTGoSF2f0DuMM8gp5rI7SBr6tWj,A3fsA9Zfv1X2fVEQhTw51lKENdNrEqT3,20,8,8,0,8,0,4,0,28,4.0,2,0.0,0,8,0,8,8,0,0,4,0,16,12,1
5614,109429,HoFYxRSokx9ZKuDwytJP5rWsXC8CIKJC,A3fsA9Zfv1X2fVEQhTw51lKENdNrEqT3,30,7,4,44,2,3,9,1,70,10.0,1,0.0,1,4,42,2,6,3,2,9,1,49,21,1
5615,109431,1UiNR1aBQTbqc6GjmZAuykRrYIV3jOJO,SpATywNh6bZuzm8s1ceuBUnMUAeoAHHw,7,3,1,0,1,2,4,1,12,1.7142857142857142,1,0.0,1,1,0,1,2,2,0,4,1,3,9,1
5616,109442,uMcGJbFLkrWwli3FYGfWHtIVPBjXGyBh,SpATywNh6bZuzm8s1ceuBUnMUAeoAHHw,1,0,0,0,0,0,1,0,1,0.14285714285714285,1,0.0,0,0,0,0,0,0,0,1,0,0,1,1
5617,109459,AFA8ekqoAZiNztO6KW91x6d2D9lFcQ7X,RXDvfPUBYFlVdlueBFbLW0mhhAyGEqpt,5,1,0,0,1,0,5,0,7,1.0,1,0.0,0,0,0,1,1,0,0,5,0,1,6,1
5618,109468,An4Cs2oUOz8lYcIplHFLdygweoh5kMIV,A3fsA9Zfv1X2fVEQhTw51lKENdNrEqT3,8,5,1,0,1,0,2,0,9,1.2857142857142858,1,0.0,0,1,0,1,5,0,0,2,0,2,7,1
5619,109494,dvvW9sSxW5mjEruYpucTZ2qRrmMv8qM8,SpATywNh6bZuzm8s1ceuBUnMUAeoAHHw,4,2,1,0,0,1,2,0,6,0.8571428571428571,1,0.0,0,1,0,0,2,1,0,2,0,1,5,1
5620,109497,CB1M4aW1J3aRGdW8HkF8tezfCYyk7Eoq,RXDvfPUBYFlVdlueBFbLW0mhhAyGEqpt,12,8,6,0,5,0,4,0,23,3.2857142857142856,3,0.0,0,6,0,5,8,0,0,4,0,11,12,1
5621,109501,eAowQ45OiNPPsLkfxUtBSZ5lhWPhAgzz,SpATywNh6bZuzm8s1ceuBUnMUAeoAHHw,5,2,0,0,0,1,5,0,8,1.1428571428571428,1,0.0,0,0,0,0,2,1,0,5,0,0,8,1
5622,109507,IgPmhYztZgoutItcrcEcsnhrRrb2KvYs,A3fsA9Zfv1X2fVEQhTw51lKENdNrEqT3,9,17,3,0,1,0,6,0,27,3.857142857142857,1,0.0,0,3,0,1,17,0,0,6,0,4,23,1
5623,109508,pKS0bXWim4kclZTTgr34KULrUojenqdP,SpATywNh6bZuzm8s1ceuBUnMUAeoAHHw,1,0,0,0,0,0,1,0,1,0.14285714285714285,1,0.0,0,0,0,0,0,0,0,1,0,0,1,1
5624,109526,wZ6yWCylvqNezqFzx20ftEJc7jYDipih,A3fsA9Zfv1X2fVEQhTw51lKENdNrEqT3,16,9,7,0,5,0,8,0,29,4.142857142857143,2,0.0,1,7,0,5,8,0,0,8,0,13,16,1
5625,109536,Cv1aavObJnuABKfipF6OGePzg0BnGPFs,SpATywNh6bZuzm8s1ceuBUnMUAeoAHHw,11,11,4,14,0,1,18,0,48,6.857142857142857,6,0.0,7,4,14,0,4,1,0,18,0,25,23,1
5626,109538,Cv1aavObJnuABKfipF6OGePzg0BnGPFs,A3fsA9Zfv1X2fVEQhTw51lKENdNrEqT3,42,9,7,156,0,0,12,0,184,26.285714285714285,5,0.0,2,7,156,0,7,0,0,12,0,165,19,1
5627,109542,UzfhQlNSIoLM6AVYNl7JKilqEEtlOXJC,bWdj2GDclj5ofokWjzoa5jAwMkxCykd6,13,17,7,26,3,0,8,0,61,8.714285714285714,4,0.0,2,7,23,3,15,0,3,8,0,35,26,1
5628,109543,Cv1aavObJnuABKfipF6OGePzg0BnGPFs,bWdj2GDclj5ofokWjzoa5jAwMkxCykd6,21,13,7,96,0,0,10,0,126,18.0,4,0.0,6,7,93,0,7,0,3,10,0,106,20,1
5629,109586,tnFgBBhxwl3ThYwRfbs1nBP0c5GsC0Nt,G8EPVSXsOYB5YQWZGiz1aVq5Pgr2GrQu,6,2,1,0,1,0,3,0,7,1.0,1,0.0,0,1,0,1,2,0,0,3,0,2,5,1
5630,109588,4QzNBqELMiYit65uUaxWvkflyE9kKEti,RXDvfPUBYFlVdlueBFbLW0mhhAyGEqpt,45,39,24,58,11,0,4,0,136,19.428571428571427,2,0.0,7,24,57,11,32,0,1,4,0,99,37,1
5631,109596,yH5UPr6OYjoduVn8gG4Lqcccv4nGJLGC,A3fsA9Zfv1X2fVEQhTw51lKENdNrEqT3,5,3,2,0,0,0,2,0,7,1.0,1,0.0,0,2,0,0,3,0,0,2,0,2,5,1
5632,109617,47U1Ft55cUwsb6d6kZ6WNRfAgXy0966b,A3fsA9Zfv1X2fVEQhTw51lKENdNrEqT3,20,12,8,18,5,0,3,0,46,6.571428571428571,1,0.0,0,8,16,5,12,0,2,3,0,29,17,1
5633,109630,OnyZH4F3oW4crdu4EYjgcCg5L4Cq5yIA,A3fsA9Zfv1X2fVEQhTw51lKENdNrEqT3,6,11,1,0,1,0,1,0,14,2.0,1,0.0,0,1,0,1,11,0,0,1,0,2,12,1
5634,109633,CxbJpiz9m1eHAB0gIyTtLs7Pvx86qvPB,A3fsA9Zfv1X2fVEQhTw51lKENdNrEqT3,15,26,15,0,7,4,9,0,61,8.714285714285714,2,0.0,0,15,0,7,26,4,0,9,0,22,39,1
5635,109635,S7YgWZv0zfBDCXesrYQobA6r2Ns5N7Tq,A3fsA9Zfv1X2fVEQhTw51lKENdNrEqT3,2,0,0,0,0,0,4,0,4,0.5714285714285714,1,0.0,0,0,0,0,0,0,0,4,0,0,4,1
5636,109645,t36cT9Msm4Hh3sPjMIr6iaOAbn6g4BQN,bWdj2GDclj5ofokWjzoa5jAwMkxCykd6,7,8,3,2,0,0,7,0,20,2.857142857142857,2,0.0,4,3,2,0,4,0,0,7,0,9,11,1
5637,109661,vlxKYuyoAuMqS1coFL9iKQUv0EZG5cjH,RXDvfPUBYFlVdlueBFbLW0mhhAyGEqpt,13,16,10,0,3,13,10,2,54,7.714285714285714,2,0.0,2,10,0,3,14,13,0,10,2,15,39,1
5638,109662,tVIaEH9O89RTqDCRllWVA85ShLX4ujE7,SpATywNh6bZuzm8s1ceuBUnMUAeoAHHw,7,12,6,0,1,0,6,0,25,3.5714285714285716,1,0.0,3,6,0,1,9,0,0,6,0,10,15,1
5639,109663,yNBmodc8EXXXXDprMuN3jSh3qPXFcpn8,SpATywNh6bZuzm8s1ceuBUnMUAeoAHHw,10,11,6,0,3,1,3,0,24,3.4285714285714284,1,0.0,0,6,0,3,11,1,0,3,0,9,15,1
5640,109677,Wq5vw9D8EzxIbQ18OklpNCvzPZVsfETA,G8EPVSXsOYB5YQWZGiz1aVq5Pgr2GrQu,6,2,1,0,1,0,2,0,6,0.8571428571428571,1,0.0,0,1,0,1,2,0,0,2,0,2,4,1
5641,109688,TQrIrIwuSwem0ov7co8TUDqNlQcIvB5k,SpATywNh6bZuzm8s1ceuBUnMUAeoAHHw,15,28,11,6,3,8,3,0,59,8.428571428571429,1,0.0,4,11,6,3,24,8,0,3,0,24,35,1
5642,109696,1IVW102tL25hf5DslCWoTGf8umKhKStK,A3fsA9Zfv1X2fVEQhTw51lKENdNrEqT3,9,4,3,0,3,0,2,0,12,1.7142857142857142,1,0.0,1,3,0,3,3,0,0,2,0,7,5,1
5643,109697,pGYP47am2d3xk9zOKdaE6fuoOc52iQiA,A3fsA9Zfv1X2fVEQhTw51lKENdNrEqT3,58,40,0,150,0,0,11,0,201,28.714285714285715,4,0.0,6,0,130,0,34,0,20,11,0,136,65,1
5644,109726,YsCj2vq22thtrABlGTiHQmd1Rq7WC2yD,G8EPVSXsOYB5YQWZGiz1aVq5Pgr2GrQu,1,0,0,0,0,0,1,0,1,0.14285714285714285,1,0.0,0,0,0,0,0,0,0,1,0,0,1,1
5645,109736,Pw5qvLGpB0h5kMFVFGpEeHaRx9RXaDPK,A3fsA9Zfv1X2fVEQhTw51lKENdNrEqT3,14,8,6,0,5,0,4,0,23,3.2857142857142856,2,0.0,0,6,0,5,8,0,0,4,0,11,12,1
5646,109762,Ag1hVTrJxORxsKul36O8LJkzu7JsNNWP,SpATywNh6bZuzm8s1ceuBUnMUAeoAHHw,14,21,9,10,7,0,6,2,55,7.857142857142857,2,0.0,7,9,9,7,14,0,1,6,2,32,23,1
5647,109765,MJcUUCn8PV6c1s6azIezqfn8QYa8QKmD,SpATywNh6bZuzm8s1ceuBUnMUAeoAHHw,1,0,0,0,0,0,1,0,1,0.14285714285714285,1,0.0,0,0,0,0,0,0,0,1,0,0,1,1
5648,109788,YK9goZgoN0rvofZU4YE46jMvnter3goc,G8EPVSXsOYB5YQWZGiz1aVq5Pgr2GrQu,8,7,3,0,2,1,3,0,16,2.2857142857142856,1,0.0,2,3,0,2,5,1,0,3,0,7,9,1
5649,109790,p7ttFbRCERCwhTg2CGSQKJTx8BwPrv0X,SpATywNh6bZuzm8s1ceuBUnMUAeoAHHw,16,15,7,12,3,0,5,0,42,6.0,1,0.0,8,7,12,3,7,0,0,5,0,30,12,1
5650,109797,BvGZp7WaxxtjkCv9TCLYGxFTwKxW9SN6,SpATywNh6bZuzm8s1ceuBUnMUAeoAHHw,1,0,0,0,0,0,1,0,1,0.14285714285714285,1,0.0,0,0,0,0,0,0,0,1,0,0,1,1
5651,109798,K1BSnyoMMyobTomJrER9oQIG5DUTaz3Q,SpATywNh6bZuzm8s1ceuBUnMUAeoAHHw,4,2,1,0,0,0,2,0,5,0.7142857142857143,1,0.0,0,1,0,0,2,0,0,2,0,1,4,1
5652,109817,S9Szq6g9ved8FvqRXhj5wFkk1JBdWVxm,SpATywNh6bZuzm8s1ceuBUnMUAeoAHHw,16,33,14,4,7,2,16,7,83,11.857142857142858,2,0.0,13,14,4,7,20,2,0,16,7,38,45,1
5653,109822,kNz6Otgr0OzNKmI1vQVj8WSVh9NxP9ty,A3fsA9Zfv1X2fVEQhTw51lKENdNrEqT3,13,5,3,0,3,7,10,3,31,4.428571428571429,2,0.0,1,3,0,3,4,7,0,10,3,7,24,1
5654,109838,5G14OqJhAMEtcEWhkGrUvPjxVR4dIAwN,SpATywNh6bZuzm8s1ceuBUnMUAeoAHHw,9,17,1,0,1,1,5,1,26,3.7142857142857144,1,0.0,12,1,0,1,5,1,0,5,1,14,12,1
5655,109844,hvsRGWJp5579jHaZrBOzJk6TUYpgGqDO,A3fsA9Zfv1X2fVEQhTw51lKENdNrEqT3,10,5,4,0,4,0,1,0,14,2.0,1,0.0,0,4,0,4,5,0,0,1,0,8,6,1
5656,109892,mbcohNJJNHml8jzBeHm74GmBbBH9udey,bWdj2GDclj5ofokWjzoa5jAwMkxCykd6,1,0,0,0,0,0,1,0,1,0.14285714285714285,1,0.0,0,0,0,0,0,0,0,1,0,0,1,1
5657,109897,YQYuuodMZUFMR21jPqGx2gjrHZSeRDRA,A3fsA9Zfv1X2fVEQhTw51lKENdNrEqT3,18,17,7,0,6,0,10,0,40,5.714285714285714,4,0.0,0,7,0,6,17,0,0,10,0,13,27,1
5658,109901,mbcohNJJNHml8jzBeHm74GmBbBH9udey,A3fsA9Zfv1X2fVEQhTw51lKENdNrEqT3,1,0,0,0,0,0,1,0,1,0.14285714285714285,1,0.0,0,0,0,0,0,0,0,1,0,0,1,1
5659,109908,HCwGALsXdQRvdnW9Y1SicRkbFYJcehRz,G8EPVSXsOYB5YQWZGiz1aVq5Pgr2GrQu,41,60,18,58,8,14,13,1,172,24.571428571428573,3,0.0,27,18,43,8,33,14,15,13,1,96,76,0
5660,109914,y8NaQIDe3D7l0VzaS1fuEDzV6bcaTY0g,bWdj2GDclj5ofokWjzoa5jAwMkxCykd6,4,2,1,0,1,0,1,0,5,0.7142857142857143,1,0.0,0,1,0,1,2,0,0,1,0,2,3,1
5661,109927,CwyOL3RMOVLomxrxyN9D4jPa9R0iWrS5,bWdj2GDclj5ofokWjzoa5jAwMkxCykd6,12,14,9,16,5,0,9,0,53,7.571428571428571,1,0.0,2,9,16,5,12,0,0,9,0,32,21,1
5662,109942,69mjZoNGtUdd47OHaI2iQubsVwSBE5CT,A3fsA9Zfv1X2fVEQhTw51lKENdNrEqT3,7,9,4,0,2,0,4,0,19,2.7142857142857144,1,0.0,0,4,0,2,9,0,0,4,0,6,13,1
5663,109946,mdF4VSOHdhU4Fo37q40c5lLreOU7ezPS,A3fsA9Zfv1X2fVEQhTw51lKENdNrEqT3,8,5,3,0,0,1,8,1,18,2.5714285714285716,1,0.0,0,3,0,0,5,1,0,8,1,3,15,1
5664,109955,c5FmvWqHimPY3en4KzYtEePuWbXPcm4V,bWdj2GDclj5ofokWjzoa5jAwMkxCykd6,4,2,1,0,0,1,4,0,8,1.1428571428571428,1,0.0,0,1,0,0,2,1,0,4,0,1,7,1
5665,109956,HNOGJwV4rdRhqUou8hYUuOI1xR3yp1lD,SpATywNh6bZuzm8s1ceuBUnMUAeoAHHw,2,0,0,0,0,0,2,0,2,0.2857142857142857,1,0.0,0,0,0,0,0,0,0,2,0,0,2,1
5666,109982,DmULS2tEq0maGheqJ8Xg7VkvUxmleIug,SpATywNh6bZuzm8s1ceuBUnMUAeoAHHw,12,40,1,0,1,0,4,0,46,6.571428571428571,3,0.0,1,1,0,1,39,0,0,4,0,3,43,0
5667,109983,5Dqq361dkHzqa5S9GQLfoF5pBVvOZxtV,SpATywNh6bZuzm8s1ceuBUnMUAeoAHHw,1,0,0,0,0,0,1,0,1,0.14285714285714285,1,0.0,0,0,0,0,0,0,0,1,0,0,1,1
5668,110026,KC30Cns1M10UV49aokZvWIXO8ZPauHoR,bWdj2GDclj5ofokWjzoa5jAwMkxCykd6,2,0,0,0,0,0,2,0,2,0.2857142857142857,1,0.0,0,0,0,0,0,0,0,2,0,0,2,1
5669,110029,KC30Cns1M10UV49aokZvWIXO8ZPauHoR,RXDvfPUBYFlVdlueBFbLW0mhhAyGEqpt,2,0,0,0,0,0,2,0,2,0.2857142857142857,1,0.0,0,0,0,0,0,0,0,2,0,0,2,1
5670,113224,YnryKMU5NBkS3Ubsyb9gjAcDZ6iJfgwC,7GRhBDsirIGkRZBtSMEzNTyDr2JQm4xx,1,0,0,0,0,0,1,0,1,0.14285714285714285,1,0.0,0,0,0,0,0,0,0,1,0,0,1,1
5671,113276,eswvbpHhxCUZC3kUIoEHkNpn6ukXHFpo,7GRhBDsirIGkRZBtSMEzNTyDr2JQm4xx,5,2,1,0,1,0,5,0,9,1.2857142857142858,2,0.0,0,1,0,1,2,0,0,5,0,2,7,0
5672,113891,9d8tCYKPfh5NHPKNlwRKmrZh3Cuf1Ls2,7GRhBDsirIGkRZBtSMEzNTyDr2JQm4xx,32,99,39,4,14,0,18,0,174,24.857142857142858,7,0.0,12,39,4,14,87,0,0,18,0,69,105,0
5673,113892,YvqXtgBNC43WLi1Y1OHrc4YV5wJZj5BZ,7GRhBDsirIGkRZBtSMEzNTyDr2JQm4xx,36,105,2,59,10,0,4,0,180,25.714285714285715,1,0.0,20,2,50,10,85,0,9,4,0,82,98,1
5674,113921,cQJEH4N9NA86ElT2x4zkE6ToN6rVT4MQ,7GRhBDsirIGkRZBtSMEzNTyDr2JQm4xx,35,45,18,40,14,2,7,0,126,18.0,2,0.0,21,18,34,14,24,2,6,7,0,87,39,1
5675,113977,AnqzEiR7s4CfuKEZI3xmlDjhp0SJ9rWN,7GRhBDsirIGkRZBtSMEzNTyDr2JQm4xx,39,88,32,65,21,53,15,1,275,39.285714285714285,2,0.0,22,32,54,21,66,53,11,15,1,129,146,0
5676,113978,pi6uVUUcWdM15szjsg09SfyhPrGkMugT,7GRhBDsirIGkRZBtSMEzNTyDr2JQm4xx,7,5,1,0,0,0,5,0,11,1.5714285714285714,2,0.0,0,1,0,0,5,0,0,5,0,1,10,1
5677,113991,z7I1QeH8tOlWf6s0Xi8QGEEG8QaCPAno,7GRhBDsirIGkRZBtSMEzNTyDr2JQm4xx,66,127,44,97,24,74,29,9,404,57.714285714285715,7,0.0,73,44,88,24,54,74,9,29,9,229,175,1
5678,114084,HolfiiRMNIE2y1ufEDM4W3kjJIHyUraM,7GRhBDsirIGkRZBtSMEzNTyDr2JQm4xx,1,0,0,0,0,0,1,0,1,0.14285714285714285,1,0.0,0,0,0,0,0,0,0,1,0,0,1,1
5679,114122,4Pd3e254V1ylErxapJL6FJZ2vSaLD95s,7GRhBDsirIGkRZBtSMEzNTyDr2JQm4xx,56,203,9,77,17,43,30,3,382,54.57142857142857,9,0.0,64,9,71,17,139,43,6,30,3,161,221,0
5680,114193,w43NdaSTOQbbSDTdI0RJiLpdaaUTMsHa,7GRhBDsirIGkRZBtSMEzNTyDr2JQm4xx,1,0,0,0,0,0,1,0,1,0.14285714285714285,1,0.0,0,0,0,0,0,0,0,1,0,0,1,1
5681,114299,uuzc81RWrrz7iGcyTE1vS0JQYD0lJgbY,7GRhBDsirIGkRZBtSMEzNTyDr2JQm4xx,26,66,2,44,3,11,12,1,139,19.857142857142858,3,0.0,45,2,37,3,21,11,7,12,1,87,52,1
5682,114411,2jRIZMWHA5rH4ew2UCv2iZrYBWoFczyG,7GRhBDsirIGkRZBtSMEzNTyDr2JQm4xx,33,47,2,36,6,1,8,0,100,14.285714285714286,5,0.0,19,2,26,6,28,1,10,8,0,53,47,0
5683,114496,rqwp0DRxlrzViX8K4jHTHKpfYZPPmBwb,7GRhBDsirIGkRZBtSMEzNTyDr2JQm4xx,1,0,0,0,0,0,1,0,1,0.14285714285714285,1,0.0,0,0,0,0,0,0,0,1,0,0,1,1
5684,114497,3RcsrMTbPrb8ZHYXLlgwoRK7zrqTGSuq,7GRhBDsirIGkRZBtSMEzNTyDr2JQm4xx,11,19,6,0,0,7,4,0,36,5.142857142857143,1,0.0,8,6,0,0,11,7,0,4,0,14,22,1
5685,114543,aEgt3dXm9v9Y3bAdN5dHXVwqStuJSLzy,7GRhBDsirIGkRZBtSMEzNTyDr2JQm4xx,1,0,0,0,0,0,1,0,1,0.14285714285714285,1,0.0,0,0,0,0,0,0,0,1,0,0,1,1
5686,114559,KkSinTdG2PbGrJIRATMZos8HES46UawO,7GRhBDsirIGkRZBtSMEzNTyDr2JQm4xx,34,104,30,10,21,0,14,0,179,25.571428571428573,10,0.0,34,30,10,21,70,0,0,14,0,95,84,0
5687,114568,39kDK9y6rUMxkyJQwaOrfTRJDkq1CpVh,7GRhBDsirIGkRZBtSMEzNTyDr2JQm4xx,4,2,0,0,1,0,2,0,5,0.7142857142857143,2,0.0,0,0,0,1,2,0,0,2,0,1,4,1
5688,114615,dADOrE6FAWkIPcnZuLBj5KGmzjdxSunH,fbPkOYLVPtPgIt0MxizjfFJov3JbHyAi,48,118,61,64,41,13,10,0,307,43.857142857142854,11,0.0,44,61,60,41,74,13,4,10,0,206,101,0
5689,114620,6T8cBNKGNp544PxJriaeroN36khQqLPz,fbPkOYLVPtPgIt0MxizjfFJov3JbHyAi,9,6,4,0,2,11,6,0,29,4.142857142857143,2,0.0,0,4,0,2,6,11,0,6,0,6,23,1
5690,114648,aqQTf2fLQrJTXefctm75awHMgV3chcLI,fbPkOYLVPtPgIt0MxizjfFJov3JbHyAi,4,2,1,0,1,0,1,0,5,0.7142857142857143,1,0.0,0,1,0,1,2,0,0,1,0,2,3,1
5691,117367,z9oiQyplHlMmhFVKenfY0OjMOlRO24Ty,fbPkOYLVPtPgIt0MxizjfFJov3JbHyAi,6,6,2,0,2,0,1,0,11,1.5714285714285714,1,0.0,0,2,0,2,6,0,0,1,0,4,7,1
5692,117368,6AwbnbZTB5s1lrnTdEnSshjUPytTPXpI,fbPkOYLVPtPgIt0MxizjfFJov3JbHyAi,1,0,0,0,0,0,1,0,1,0.14285714285714285,1,0.0,0,0,0,0,0,0,0,1,0,0,1,1
5693,117370,3JEt0I9b0JhZhM0RD2D5jI5S8zjjeHFo,fbPkOYLVPtPgIt0MxizjfFJov3JbHyAi,8,10,6,0,4,3,5,0,28,4.0,3,0.0,1,6,0,4,9,3,0,5,0,11,17,0
5694,117377,ED2RRaLgnPevoSmZx4Qg8rLBDplQ4qIA,fbPkOYLVPtPgIt0MxizjfFJov3JbHyAi,5,2,1,0,1,0,2,0,6,0.8571428571428571,1,0.0,0,1,0,1,2,0,0,2,0,2,4,1
5695,117379,h77jUHQjzYddHbYwLAoFxVw2uSIfwhBs,fbPkOYLVPtPgIt0MxizjfFJov3JbHyAi,4,2,0,0,0,1,6,0,9,1.2857142857142858,1,0.0,0,0,0,0,2,1,0,6,0,0,9,1
5696,117380,RArjmmV02rd6h9pGPjgt5onR6MwVvvt1,fbPkOYLVPtPgIt0MxizjfFJov3JbHyAi,8,5,3,0,2,6,5,0,21,3.0,1,0.0,0,3,0,2,5,6,0,5,0,5,16,1
5697,117382,W4YcttFAI3GezJalLYSgr5LsB9fMfJw6,fbPkOYLVPtPgIt0MxizjfFJov3JbHyAi,5,2,1,0,1,0,2,0,6,0.8571428571428571,1,0.0,0,1,0,1,2,0,0,2,0,2,4,1
5698,117385,AuMjwLeYBChETH8L0EPQQLBqdJg4wXaV,fbPkOYLVPtPgIt0MxizjfFJov3JbHyAi,14,14,7,0,8,22,6,0,57,8.142857142857142,1,0.0,5,7,0,8,9,22,0,6,0,20,37,1
5699,117386,i0ksX07HnsV5rQlWqOr1uKEuc7yNU24c,fbPkOYLVPtPgIt0MxizjfFJov3JbHyAi,7,2,1,0,1,4,8,1,17,2.4285714285714284,2,0.0,0,1,0,1,2,4,0,8,1,2,15,1
5700,117389,mXfwwTIVjHMqoVKAh2iEQbinKUCJHwTp,fbPkOYLVPtPgIt0MxizjfFJov3JbHyAi,1,0,0,0,0,0,9,0,9,1.2857142857142858,1,0.0,0,0,0,0,0,0,0,9,0,0,9,0
5701,117396,pNEyURvIjTiESJT2evjPVs5QcamqwYsg,fbPkOYLVPtPgIt0MxizjfFJov3JbHyAi,1,0,0,0,0,0,1,0,1,0.14285714285714285,1,0.0,0,0,0,0,0,0,0,1,0,0,1,1
5702,117397,2XVXsblIDsQNrX8upAtO1F8OiAwOV3sC,fbPkOYLVPtPgIt0MxizjfFJov3JbHyAi,1,0,0,0,0,0,1,0,1,0.14285714285714285,1,0.0,0,0,0,0,0,0,0,1,0,0,1,1
5703,117399,bPCJkP9ZTzzi0I9DbpQGe5iKBkWKaKhH,fbPkOYLVPtPgIt0MxizjfFJov3JbHyAi,10,8,6,0,3,2,4,1,24,3.4285714285714284,1,0.0,0,6,0,3,8,2,0,4,1,9,15,1
5704,117405,fu0f20KU28Bd4xE03nYnaxnydSL4s6JV,fbPkOYLVPtPgIt0MxizjfFJov3JbHyAi,3,3,1,0,0,0,3,0,7,1.0,1,0.0,0,1,0,0,3,0,0,3,0,1,6,1
5705,117407,u3ha5zP0wtMcDDWbo2YVGmhJ5EihdJ7B,fbPkOYLVPtPgIt0MxizjfFJov3JbHyAi,1,0,0,0,0,0,1,0,1,0.14285714285714285,1,0.0,0,0,0,0,0,0,0,1,0,0,1,1
5706,117408,T7YlTqIDVTZFYEYihxD1Zij5IkDsmVZP,fbPkOYLVPtPgIt0MxizjfFJov3JbHyAi,8,11,3,0,3,6,3,0,26,3.7142857142857144,1,0.0,3,3,0,3,8,6,0,3,0,9,17,1
5707,117409,oZFc1qOsYmuXaa2y9yuDE2JOyaJ6tpRo,fbPkOYLVPtPgIt0MxizjfFJov3JbHyAi,12,19,11,0,6,0,6,0,42,6.0,4,0.0,0,11,0,6,19,0,0,6,0,17,25,1
5708,117410,Lpjd1s2Qa852YWnveC5CAHyEzqzKjCKM,fbPkOYLVPtPgIt0MxizjfFJov3JbHyAi,8,4,1,0,1,4,6,1,17,2.4285714285714284,2,0.0,0,1,0,1,4,4,0,6,1,2,15,1
5709,117420,sATu1yjmTMxfV1UwbY34TM5sGL4dFyhU,fbPkOYLVPtPgIt0MxizjfFJov3JbHyAi,4,6,1,0,0,0,3,0,10,1.4285714285714286,2,0.0,0,1,0,0,6,0,0,3,0,1,9,1
5710,117421,6o1ZSS0MBiJ4i90ElFoAvCZGSxQxxLtD,fbPkOYLVPtPgIt0MxizjfFJov3JbHyAi,1,0,0,0,0,0,1,0,1,0.14285714285714285,1,0.0,0,0,0,0,0,0,0,1,0,0,1,1
5711,117425,YjySOKJ8Qhep1ksiy3pkGK8hyQnj63Bg,fbPkOYLVPtPgIt0MxizjfFJov3JbHyAi,2,0,0,0,0,0,4,0,4,0.5714285714285714,1,0.0,0,0,0,0,0,0,0,4,0,0,4,1
5712,117426,1I29v8UmoBuouK5thDbwjYUDiAkrMElJ,fbPkOYLVPtPgIt0MxizjfFJov3JbHyAi,2,0,0,0,0,0,6,0,6,0.8571428571428571,1,0.0,0,0,0,0,0,0,0,6,0,0,6,1
5713,117429,pbZR4GJe7P6eoTNcArXxFSrGW6cVA8YU,fbPkOYLVPtPgIt0MxizjfFJov3JbHyAi,15,15,11,0,8,0,8,0,42,6.0,3,0.0,0,11,0,8,15,0,0,8,0,19,23,1
5714,117430,MmozMzpVuu7lJ9WhybOg7LnFJamucwNf,fbPkOYLVPtPgIt0MxizjfFJov3JbHyAi,5,3,1,0,1,0,2,0,7,1.0,1,0.0,0,1,0,1,3,0,0,2,0,2,5,1
5715,117432,CN6hYLtHy52UqiF5PRGtJEkOeeMIm2un,fbPkOYLVPtPgIt0MxizjfFJov3JbHyAi,7,3,2,0,2,0,4,0,11,1.5714285714285714,1,0.0,0,2,0,2,3,0,0,4,0,4,7,1
5716,117434,T6F7StAhzA9Nt1gx3xcfSamiwd1hA4kb,fbPkOYLVPtPgIt0MxizjfFJov3JbHyAi,2,0,0,0,0,0,2,0,2,0.2857142857142857,1,0.0,0,0,0,0,0,0,0,2,0,0,2,1
5717,117437,HOh9uzKRHmixUSVl017qRO1fRhTakF2v,fbPkOYLVPtPgIt0MxizjfFJov3JbHyAi,17,39,17,6,10,5,12,1,90,12.857142857142858,7,0.0,8,17,4,10,31,5,2,12,1,39,51,1
5718,117442,kyRDtUassKyWkKwd2NxuRMWbNGMmYQuD,fbPkOYLVPtPgIt0MxizjfFJov3JbHyAi,54,115,58,41,29,26,38,2,309,44.142857142857146,13,0.0,28,58,34,29,87,26,7,38,2,149,160,1
5719,117443,V44Q36yyz0HxZhlrCwrLJjYwv8UzqoCn,fbPkOYLVPtPgIt0MxizjfFJov3JbHyAi,6,3,2,0,2,0,2,0,9,1.2857142857142858,1,0.0,0,2,0,2,3,0,0,2,0,4,5,1
5720,117444,oWOfoMSwxFJkBlwLG8XI3GNMHdlBBaGM,fbPkOYLVPtPgIt0MxizjfFJov3JbHyAi,17,39,24,4,5,4,15,1,92,13.142857142857142,10,0.0,6,24,3,5,33,4,1,15,1,38,54,1
5721,117445,gkiUIfN50TiqMc6ruS3MmgF2p099c98R,fbPkOYLVPtPgIt0MxizjfFJov3JbHyAi,7,8,5,0,3,0,3,0,19,2.7142857142857144,1,0.0,0,5,0,3,8,0,0,3,0,8,11,1
5722,117446,Q3CFFFFeztddQPg34HzeWJOUWopSHXqI,fbPkOYLVPtPgIt0MxizjfFJov3JbHyAi,5,2,1,0,1,0,3,0,7,1.0,1,0.0,0,1,0,1,2,0,0,3,0,2,5,1
5723,117447,OvHFca8fZMJjxNBJonj6ZM9Jmu5uZHn1,fbPkOYLVPtPgIt0MxizjfFJov3JbHyAi,5,3,1,0,0,0,3,0,7,1.0,1,0.0,0,1,0,0,3,0,0,3,0,1,6,1
5724,117452,XD3SfNDDSMmRivtrECVvGAm4sTgAQhtN,fbPkOYLVPtPgIt0MxizjfFJov3JbHyAi,11,6,3,6,3,0,4,0,22,3.142857142857143,1,0.0,1,3,5,3,5,0,1,4,0,12,10,1
5725,117454,m6lnook0RtQLOadkyTjepku2EsfPQUkf,fbPkOYLVPtPgIt0MxizjfFJov3JbHyAi,1,0,0,0,0,0,1,0,1,0.14285714285714285,1,0.0,0,0,0,0,0,0,0,1,0,0,1,1
5726,117460,ZCWIo0rlDJYX4bFrxwqUtfFzcyFGtbPC,fbPkOYLVPtPgIt0MxizjfFJov3JbHyAi,7,5,1,0,1,0,1,0,8,1.1428571428571428,1,0.0,0,1,0,1,5,0,0,1,0,2,6,1
5727,117467,hDNiOFPvRB9cUydss5Qxpv78aI19HlnV,fbPkOYLVPtPgIt0MxizjfFJov3JbHyAi,15,10,7,0,7,0,5,0,29,4.142857142857143,2,0.0,2,7,0,7,8,0,0,5,0,16,13,1
5728,117470,mT6waBgPTnOBUmAiQrY4keGZNquTpjJI,fbPkOYLVPtPgIt0MxizjfFJov3JbHyAi,7,5,0,0,0,1,6,1,13,1.8571428571428572,1,0.0,0,0,0,0,5,1,0,6,1,0,13,1
5729,117472,GaQzOXFZJNvUueucyW3BfG1sfbLN7TqZ,fbPkOYLVPtPgIt0MxizjfFJov3JbHyAi,6,2,1,0,1,0,3,0,7,1.0,1,0.0,0,1,0,1,2,0,0,3,0,2,5,1
5730,117476,RwvuGEh3euIR11rktJrGBhzDqcQMkhOC,fbPkOYLVPtPgIt0MxizjfFJov3JbHyAi,11,24,14,4,7,1,7,0,57,8.142857142857142,4,0.0,3,14,3,7,21,1,1,7,0,27,30,1
5731,117477,0VSuyC2fbUM3VIvEXql75XtNw7kg5Izm,fbPkOYLVPtPgIt0MxizjfFJov3JbHyAi,16,15,7,8,6,0,3,0,39,5.571428571428571,3,0.0,5,7,7,6,10,0,1,3,0,25,14,1
5732,117478,W7oz4HopNsS4RPNw2s87918URq124P2s,fbPkOYLVPtPgIt0MxizjfFJov3JbHyAi,4,2,0,0,0,1,5,0,8,1.1428571428571428,1,0.0,0,0,0,0,2,1,0,5,0,0,8,1
5733,117483,ckU7S9iTSheBHJPYCUZtMgrhgDvQPsUY,fbPkOYLVPtPgIt0MxizjfFJov3JbHyAi,6,3,2,0,2,0,1,0,8,1.1428571428571428,1,0.0,0,2,0,2,3,0,0,1,0,4,4,1
5734,117484,5bnbtuO3BHv5NYIfEbfBpvStPzGdNjte,fbPkOYLVPtPgIt0MxizjfFJov3JbHyAi,5,2,1,0,1,0,2,0,6,0.8571428571428571,1,0.0,0,1,0,1,2,0,0,2,0,2,4,1
5735,117485,V1BKbINyQwKyububdNQHUPGcGTvoZmLt,fbPkOYLVPtPgIt0MxizjfFJov3JbHyAi,7,3,2,0,2,0,5,0,12,1.7142857142857142,1,0.0,0,2,0,2,3,0,0,5,0,4,8,1
5736,117497,TZ8M7GqMqYnKB1lP0bgNhFJYSqdTmbQI,fbPkOYLVPtPgIt0MxizjfFJov3JbHyAi,7,13,6,0,3,0,3,0,25,3.5714285714285716,2,0.0,0,6,0,3,13,0,0,3,0,9,16,1
5737,117498,aRBsP3RNC28m05qU4AuLdcShaMIKbk0T,fbPkOYLVPtPgIt0MxizjfFJov3JbHyAi,5,2,1,0,1,0,2,0,6,0.8571428571428571,1,0.0,0,1,0,1,2,0,0,2,0,2,4,1
5738,117504,7nfwj1I7hYBfuxm4jUuStM2n17LzzRmj,SpATywNh6bZuzm8s1ceuBUnMUAeoAHHw,28,26,18,26,12,127,51,2,262,37.42857142857143,12,0.0,6,18,23,12,20,127,3,51,2,59,203,0
5739,117532,qX3w4IgztgXyu9swieirFObama3kJyza,G8EPVSXsOYB5YQWZGiz1aVq5Pgr2GrQu,66,79,4,204,2,2,23,6,320,45.714285714285715,6,0.0,6,4,164,2,73,2,40,23,6,176,144,1
5740,117567,KlEAwfTXNSli6vdNdYlm5CYknLkxK1Br,SpATywNh6bZuzm8s1ceuBUnMUAeoAHHw,23,66,35,18,18,10,10,0,157,22.428571428571427,6,0.0,17,35,15,18,49,10,3,10,0,85,72,0
5741,117568,VK6VYsFJEy8hhWdKq52KmrJkO3b6jNbn,A3fsA9Zfv1X2fVEQhTw51lKENdNrEqT3,36,25,16,36,14,1,18,1,111,15.857142857142858,5,0.0,2,16,30,14,23,1,6,18,1,62,49,0
5742,117572,xH5f8nfW6oTIgHjXoQgEUKIx6qvDN8rk,RXDvfPUBYFlVdlueBFbLW0mhhAyGEqpt,9,4,2,6,1,0,3,0,16,2.2857142857142856,1,0.0,1,2,6,1,3,0,0,3,0,10,6,1
5743,117609,hyhyxhn6qO7nii28PZygBx2DF5Qsnp6b,SpATywNh6bZuzm8s1ceuBUnMUAeoAHHw,11,10,6,0,5,0,1,0,22,3.142857142857143,2,0.0,0,6,0,5,10,0,0,1,0,11,11,1
5744,117610,ByImt5XiYRVr6hSHRVc9HRcRiIYkoT5Y,SpATywNh6bZuzm8s1ceuBUnMUAeoAHHw,10,13,3,0,1,0,10,3,30,4.285714285714286,4,0.0,2,3,0,1,11,0,0,10,3,6,24,0
5745,117612,Kd69M9W1nim0woqVm1QxfVaSebsYtFIh,SpATywNh6bZuzm8s1ceuBUnMUAeoAHHw,28,35,15,32,8,0,4,0,94,13.428571428571429,3,0.0,9,15,28,8,26,0,4,4,0,60,34,1
5746,117613,VEmnuZOsoHSPcS4ojGYL7wyh1ioGqsGt,SpATywNh6bZuzm8s1ceuBUnMUAeoAHHw,29,29,19,22,11,0,8,0,89,12.714285714285714,6,0.0,4,19,22,11,25,0,0,8,0,56,33,0
5747,117615,NdhfP9LezOw47EKstFkVNQYaCX8DmoQI,SpATywNh6bZuzm8s1ceuBUnMUAeoAHHw,25,51,3,39,2,0,15,0,110,15.714285714285714,8,0.0,9,3,32,2,42,0,7,15,0,46,64,0
5748,117655,MkluYfJDefHhcRPY3QsRGiWxg2BDcm18,SpATywNh6bZuzm8s1ceuBUnMUAeoAHHw,27,86,2,24,2,8,39,5,166,23.714285714285715,5,0.0,35,2,22,2,51,8,2,39,5,61,105,0
5749,117666,GGjg9S36MZkhfOc2c4FtP7oUCiriIkzW,A3fsA9Zfv1X2fVEQhTw51lKENdNrEqT3,1,0,0,0,0,0,1,0,1,0.14285714285714285,1,0.0,0,0,0,0,0,0,0,1,0,0,1,1
5750,117671,LvmRr9NACuniPuboiWpXG15NCOEyIfpb,SpATywNh6bZuzm8s1ceuBUnMUAeoAHHw,23,29,20,13,8,0,14,0,84,12.0,6,0.0,0,20,11,8,29,0,2,14,0,39,45,0
5751,117672,NdhfP9LezOw47EKstFkVNQYaCX8DmoQI,RXDvfPUBYFlVdlueBFbLW0mhhAyGEqpt,46,89,2,134,6,23,15,0,269,38.42857142857143,8,0.0,29,2,119,6,60,23,15,15,0,156,113,0
5752,117673,nC8ZC7ZEZFxQ1fyXozb96bBtFUPG3sJG,RXDvfPUBYFlVdlueBFbLW0mhhAyGEqpt,24,16,12,0,8,2,7,1,46,6.571428571428571,1,0.0,0,12,0,8,16,2,0,7,1,20,26,1
5753,117675,l64zD2DC6Q6fZRqMhhM1r4HOjVM4BOX7,SpATywNh6bZuzm8s1ceuBUnMUAeoAHHw,25,60,4,38,3,1,19,1,126,18.0,5,0.0,13,4,32,3,47,1,6,19,1,52,74,0
5754,117679,VE9HD5yzeCmqc2pNGfTQWsVbRdaqJBIV,SpATywNh6bZuzm8s1ceuBUnMUAeoAHHw,29,42,19,12,9,0,10,1,93,13.285714285714286,7,0.0,8,19,12,9,34,0,0,10,1,48,45,0
5755,117680,qnnOX2tUCPlICAK14wMKzZel5x1shlyc,SpATywNh6bZuzm8s1ceuBUnMUAeoAHHw,1,0,0,0,0,0,1,0,1,0.14285714285714285,1,0.0,0,0,0,0,0,0,0,1,0,0,1,1
5756,117682,TwVX3mHoGy0nFKENpqHSy2JVaUgsNzW0,SpATywNh6bZuzm8s1ceuBUnMUAeoAHHw,1,0,0,0,0,0,1,0,1,0.14285714285714285,1,0.0,0,0,0,0,0,0,0,1,0,0,1,1
5757,117700,hKd0tEZKHss60gUM0z43MBrDD3KnSpLX,bWdj2GDclj5ofokWjzoa5jAwMkxCykd6,12,23,4,0,3,2,10,1,43,6.142857142857143,4,0.0,0,4,0,3,23,2,0,10,1,7,36,1
5758,117701,VgmFAu9L9uoZcxRAsErY5yMnCkdw48U0,SpATywNh6bZuzm8s1ceuBUnMUAeoAHHw,22,18,12,36,8,0,18,0,92,13.142857142857142,5,0.0,4,12,33,8,14,0,3,18,0,57,35,0
5759,117704,imCqSahSQFbp2MKSKmbn03XNPhpj1Zgr,bWdj2GDclj5ofokWjzoa5jAwMkxCykd6,19,25,11,61,4,5,4,0,110,15.714285714285714,2,0.0,3,11,56,4,22,5,5,4,0,74,36,1
5760,117705,KM2jhllffvH7le7smUIPpeiXHGu50JUy,G8EPVSXsOYB5YQWZGiz1aVq5Pgr2GrQu,28,77,1,53,6,4,9,1,151,21.571428571428573,3,0.0,43,1,41,6,34,4,12,9,1,91,60,1
5761,117713,BdtTUaUgpTqIzhF2tLHXM8NXK8k0XF8q,bWdj2GDclj5ofokWjzoa5jAwMkxCykd6,45,124,62,68,19,27,24,0,324,46.285714285714285,8,0.0,20,62,62,19,104,27,6,24,0,163,161,0
5762,117723,B1Gq6e77yv7kkDqJ7SH2TygdPDzPBwQh,RXDvfPUBYFlVdlueBFbLW0mhhAyGEqpt,74,138,92,115,26,166,37,12,586,83.71428571428571,12,0.0,15,92,101,26,123,166,14,37,12,234,352,0
5763,117725,HPir8NcsI5RSXTzlx3oC2YqcMhZG1iu7,bWdj2GDclj5ofokWjzoa5jAwMkxCykd6,9,7,3,0,3,0,21,1,35,5.0,5,0.0,2,3,0,3,5,0,0,21,1,8,27,0
5764,117726,IspEVPShBbjx8d4IihOvyrT9DEmhjxUS,RXDvfPUBYFlVdlueBFbLW0mhhAyGEqpt,4,2,1,0,1,0,1,0,5,0.7142857142857143,1,0.0,0,1,0,1,2,0,0,1,0,2,3,1
5765,117734,cQJEH4N9NA86ElT2x4zkE6ToN6rVT4MQ,bWdj2GDclj5ofokWjzoa5jAwMkxCykd6,11,8,5,18,3,0,2,0,36,5.142857142857143,3,0.0,2,5,17,3,6,0,1,2,0,27,9,0
5766,117742,FhtwGNNoWtYYBXhYRu77jAPRU1UPxpBL,SpATywNh6bZuzm8s1ceuBUnMUAeoAHHw,30,27,16,12,8,5,12,0,80,11.428571428571429,5,0.0,6,16,12,8,21,5,0,12,0,42,38,0
5767,117774,jFYWygr5nLqLhHkXltZRkT0S1zQoLEVR,A3fsA9Zfv1X2fVEQhTw51lKENdNrEqT3,95,63,39,266,20,11,40,1,440,62.857142857142854,7,0.0,5,39,228,20,58,11,38,40,1,292,148,0
5768,117784,CFQksue0mvvarj6k4PvTddPXnYjnyZ25,SpATywNh6bZuzm8s1ceuBUnMUAeoAHHw,19,23,1,18,0,19,6,1,68,9.714285714285714,2,0.0,0,1,14,0,23,19,4,6,1,15,53,1
5769,117791,efPQEaUnbKTGcoOM9khi0sSrVhfE9TxE,bWdj2GDclj5ofokWjzoa5jAwMkxCykd6,11,50,22,4,2,0,11,0,89,12.714285714285714,5,0.0,2,22,3,2,48,0,1,11,0,29,60,1
5770,117800,RJv5TI20pjqK3VtKSctdVBLm65ceGNPu,SpATywNh6bZuzm8s1ceuBUnMUAeoAHHw,29,82,38,25,8,38,24,3,218,31.142857142857142,11,0.0,18,38,24,8,64,38,1,24,3,88,130,0
5771,117893,Bos3zEEnAcYzPXQktMkJJ0ak5mhGWCAf,SpATywNh6bZuzm8s1ceuBUnMUAeoAHHw,22,34,12,26,6,0,2,0,80,11.428571428571429,2,0.0,13,12,25,6,21,0,1,2,0,56,24,0
5772,117897,uww7NsJbMYsrx0EthqYUSLQnuRAcw7nQ,A3fsA9Zfv1X2fVEQhTw51lKENdNrEqT3,5,1,1,0,1,0,5,0,8,1.1428571428571428,1,0.0,0,1,0,1,1,0,0,5,0,2,6,1
5773,117935,1R1zO9aMB7Mx1Lw84JzsChVEV5JpwmZv,SpATywNh6bZuzm8s1ceuBUnMUAeoAHHw,27,83,6,18,2,40,52,5,206,29.428571428571427,18,0.0,22,6,18,2,61,40,0,52,5,48,158,0
5774,117989,4dfnEKxHCmGabkBCiKHt5nKr3H7Bwo1x,G8EPVSXsOYB5YQWZGiz1aVq5Pgr2GrQu,4,2,1,0,1,0,1,0,5,0.7142857142857143,2,0.0,0,1,0,1,2,0,0,1,0,2,3,0
5775,118027,LKippngJk3cGSHQFQuBifcn7F1qfi1gi,SpATywNh6bZuzm8s1ceuBUnMUAeoAHHw,6,3,2,0,2,0,1,0,8,1.1428571428571428,1,0.0,0,2,0,2,3,0,0,1,0,4,4,1
5776,118040,Eemq3hk1Q3P1Pw1UumR7jNQlYsAdhi76,SpATywNh6bZuzm8s1ceuBUnMUAeoAHHw,11,16,4,19,1,2,6,1,49,7.0,3,0.0,11,4,17,1,5,2,2,6,1,33,16,1
5777,118052,lQKPFBdAwC9d5aFjgrzYc27szNyJlIOi,bWdj2GDclj5ofokWjzoa5jAwMkxCykd6,1,0,0,0,0,0,2,0,2,0.2857142857142857,1,0.0,0,0,0,0,0,0,0,2,0,0,2,1
5778,118056,skJn7dtfSekFrPHRHs9swZ9AtSUKi36u,bWdj2GDclj5ofokWjzoa5jAwMkxCykd6,4,5,3,0,0,0,2,0,10,1.4285714285714286,2,0.0,0,3,0,0,5,0,0,2,0,3,7,1
5779,118084,hJwtwnOzJaTrAeP4eXJAEwz2xbKsgc4M,A3fsA9Zfv1X2fVEQhTw51lKENdNrEqT3,9,3,2,0,1,1,30,1,38,5.428571428571429,13,0.0,0,2,0,1,3,1,0,30,1,3,35,0
5780,118085,hJwtwnOzJaTrAeP4eXJAEwz2xbKsgc4M,bWdj2GDclj5ofokWjzoa5jAwMkxCykd6,2,0,0,0,0,0,21,0,21,3.0,12,0.0,0,0,0,0,0,0,0,21,0,0,21,0
5781,118091,hJwtwnOzJaTrAeP4eXJAEwz2xbKsgc4M,RXDvfPUBYFlVdlueBFbLW0mhhAyGEqpt,7,2,1,0,1,1,22,4,31,4.428571428571429,13,0.0,0,1,0,1,2,1,0,22,4,2,29,1
5782,118100,qceTeoelxto8cUOivqTuxvNZNnsHQRN6,SpATywNh6bZuzm8s1ceuBUnMUAeoAHHw,28,31,17,19,11,1,6,0,85,12.142857142857142,4,0.0,5,17,18,11,26,1,1,6,0,51,34,0
5783,118110,n97hqxU6pa0pyrYxofJJX3kbArZF9Hya,SpATywNh6bZuzm8s1ceuBUnMUAeoAHHw,5,2,1,0,1,0,2,0,6,0.8571428571428571,1,0.0,0,1,0,1,2,0,0,2,0,2,4,1
5784,118111,vlcrE6RvFFuyjHZx9sgpQaFTegXr4wza,bWdj2GDclj5ofokWjzoa5jAwMkxCykd6,8,8,5,0,2,0,6,0,21,3.0,2,0.0,0,5,0,2,8,0,0,6,0,7,14,1
5785,118115,QXyZtQTzdxqnHSXK4hpAwUSj9MimJfEp,SpATywNh6bZuzm8s1ceuBUnMUAeoAHHw,20,19,9,33,3,13,3,1,81,11.571428571428571,1,0.0,9,9,30,3,10,13,3,3,1,51,30,0
5786,118118,l3b9HlsGDQW9AY17jLNuKVLgfuE5tsF4,SpATywNh6bZuzm8s1ceuBUnMUAeoAHHw,27,66,18,35,4,2,15,0,140,20.0,11,0.0,21,18,32,4,45,2,3,15,0,75,65,0
5787,118119,5rIDDYg0Y0BALcyb0c2BGIVHn1eXoPjW,SpATywNh6bZuzm8s1ceuBUnMUAeoAHHw,17,16,8,6,4,0,4,0,38,5.428571428571429,2,0.0,4,8,6,4,12,0,0,4,0,22,16,1
5788,118127,h4Ts0QZ9Axnf77ZfOuF03oUEp9wmSbSp,SpATywNh6bZuzm8s1ceuBUnMUAeoAHHw,22,19,11,7,6,1,10,1,55,7.857142857142857,3,0.0,3,11,7,6,16,1,0,10,1,27,28,1
5789,118130,0sa6kP9h4ahNr7Hzfeaa1Mssp5M7IVmw,SpATywNh6bZuzm8s1ceuBUnMUAeoAHHw,20,33,11,18,6,15,13,1,97,13.857142857142858,4,0.0,4,11,15,6,29,15,3,13,1,36,61,1
5790,118174,FeFq7ZGqpMZdGp1e1neypp6dkWmjw2YJ,SpATywNh6bZuzm8s1ceuBUnMUAeoAHHw,3,3,0,0,0,0,1,0,4,0.5714285714285714,1,0.0,0,0,0,0,3,0,0,1,0,0,4,1
5791,118203,HX0eOrMEwIw9JyfkWs6Tn0Lny06N2ZVO,SpATywNh6bZuzm8s1ceuBUnMUAeoAHHw,29,66,26,36,11,23,18,0,180,25.714285714285715,5,0.0,27,26,30,11,39,23,6,18,0,94,86,0
5792,118208,iPn4eHBBcGh91aOsj9d5XOb4QbfUGe6N,bWdj2GDclj5ofokWjzoa5jAwMkxCykd6,14,21,7,16,8,2,20,1,75,10.714285714285714,3,0.0,9,7,14,8,12,2,2,20,1,38,37,1
5793,118218,66rxtelZjlVaBERuinHZ5AhHu9R6Idp5,SpATywNh6bZuzm8s1ceuBUnMUAeoAHHw,7,5,1,0,1,0,4,0,11,1.5714285714285714,2,0.0,0,1,0,1,5,0,0,4,0,2,9,1
5794,118230,2HbabEHSEnqM0bBaiJs30PG9549v5yOk,A3fsA9Zfv1X2fVEQhTw51lKENdNrEqT3,2,0,0,0,0,0,2,0,2,0.2857142857142857,1,0.0,0,0,0,0,0,0,0,2,0,0,2,1
5795,118232,TANF2ueHbJbwPsuSCbh96NH4X4PT1TeC,SpATywNh6bZuzm8s1ceuBUnMUAeoAHHw,21,26,1,22,1,0,3,0,53,7.571428571428571,2,0.0,8,1,21,1,18,0,1,3,0,31,22,1
5796,118239,4uAdkCJ4XUaD1NQGV93nNifOuyurJNKS,SpATywNh6bZuzm8s1ceuBUnMUAeoAHHw,21,37,1,7,1,5,13,2,66,9.428571428571429,3,0.0,17,1,7,1,20,5,0,13,2,26,40,0
5797,118258,5rpYxIaCTDb4PhszkJWpACOx5VMpNGcQ,SpATywNh6bZuzm8s1ceuBUnMUAeoAHHw,30,40,20,20,8,10,19,0,117,16.714285714285715,7,0.0,12,20,19,8,28,10,1,19,0,59,58,0
5798,118279,JGr8n6jajfkXDK9cWT8ogx09tHg0xA1G,SpATywNh6bZuzm8s1ceuBUnMUAeoAHHw,5,2,1,0,1,0,2,0,6,0.8571428571428571,1,0.0,0,1,0,1,2,0,0,2,0,2,4,1
5799,118318,7hhGe4WcGEHypOzIVz3DLRx9GS52ozkE,RXDvfPUBYFlVdlueBFbLW0mhhAyGEqpt,69,101,65,103,40,28,24,0,361,51.57142857142857,8,0.0,24,65,96,40,77,28,7,24,0,225,136,0
5800,118326,yKuiBw79vz6YoDe6ZvtlnOfjIuGqFl4A,A3fsA9Zfv1X2fVEQhTw51lKENdNrEqT3,5,4,1,0,0,0,1,0,6,0.8571428571428571,1,0.0,0,1,0,0,4,0,0,1,0,1,5,1
5801,118332,5ZiEBByu9KqLLuVXJILf5031ejtxPgIX,A3fsA9Zfv1X2fVEQhTw51lKENdNrEqT3,1,0,0,0,0,0,1,0,1,0.14285714285714285,1,0.0,0,0,0,0,0,0,0,1,0,0,1,1
5802,118339,cu2czfUbk8fdWWzCcDvTVYWH50Wg3XUq,SpATywNh6bZuzm8s1ceuBUnMUAeoAHHw,24,41,1,35,0,20,17,4,118,16.857142857142858,9,0.0,9,1,31,0,32,20,4,17,4,41,77,0
5803,118354,go2ODVnHLUhmZxhceJfs22CCaN5tZ78H,SpATywNh6bZuzm8s1ceuBUnMUAeoAHHw,5,2,1,0,1,0,2,0,6,0.8571428571428571,1,0.0,0,1,0,1,2,0,0,2,0,2,4,1
5804,118368,Tsd6J3Xles5MCEcWektA7d5EB7cldkxK,bWdj2GDclj5ofokWjzoa5jAwMkxCykd6,1,0,0,0,0,0,1,0,1,0.14285714285714285,1,0.0,0,0,0,0,0,0,0,1,0,0,1,1
5805,118369,httl8KJFJiDMZk4tgEQADrIoYysynrAv,SpATywNh6bZuzm8s1ceuBUnMUAeoAHHw,16,18,2,17,1,0,4,0,42,6.0,2,0.0,7,2,16,1,11,0,1,4,0,26,16,1
5806,118371,hZtYMC0K38gXqBKrTDOxWf2kSwG06wA4,RXDvfPUBYFlVdlueBFbLW0mhhAyGEqpt,72,114,56,100,18,66,30,4,388,55.42857142857143,8,0.0,15,56,93,18,99,66,7,30,4,182,206,0
5807,118393,LVTU4qA4F3wWkxH81iGfu4ZuIt77nyhh,SpATywNh6bZuzm8s1ceuBUnMUAeoAHHw,32,50,30,43,9,17,19,1,169,24.142857142857142,5,0.0,5,30,37,9,45,17,6,19,1,81,88,0
5808,118422,ZNBGAlJve4TYJ3FcDlTLBdyuklADldDZ,bWdj2GDclj5ofokWjzoa5jAwMkxCykd6,11,9,3,12,3,0,9,1,37,5.285714285714286,4,0.0,4,3,12,3,5,0,0,9,1,22,15,1
5809,118435,U4egSBuIz4Tp2aExbhUIhaem6H1lHi4I,bWdj2GDclj5ofokWjzoa5jAwMkxCykd6,3,3,1,0,0,0,2,0,6,0.8571428571428571,1,0.0,0,1,0,0,3,0,0,2,0,1,5,1
5810,118467,Lu93o5GXoxd6qTdHk7BshqxRhX67SrrE,SpATywNh6bZuzm8s1ceuBUnMUAeoAHHw,25,58,11,16,7,0,5,0,97,13.857142857142858,4,0.0,20,11,15,7,38,0,1,5,0,53,44,0
5811,118468,s18XVhMq5o50489RseclkjZSQF8K6sqD,G8EPVSXsOYB5YQWZGiz1aVq5Pgr2GrQu,33,68,15,38,9,9,11,0,150,21.428571428571427,5,0.0,17,15,26,9,51,9,12,11,0,67,83,1
5812,118500,37JCabFNpj6A5aUwdVeB55bOPV42TLJp,RXDvfPUBYFlVdlueBFbLW0mhhAyGEqpt,5,2,1,0,1,0,3,0,7,1.0,2,0.0,0,1,0,1,2,0,0,3,0,2,5,1
5813,118501,dhPPBp8unV3f13L4xkPHpVmkrnYAmORu,SpATywNh6bZuzm8s1ceuBUnMUAeoAHHw,7,4,3,0,3,0,2,0,12,1.7142857142857142,1,0.0,0,3,0,3,4,0,0,2,0,6,6,1
5814,118506,GrjEbVPh1uYw8afH98AN7VXn6UMAVnC8,A3fsA9Zfv1X2fVEQhTw51lKENdNrEqT3,6,8,0,0,0,0,9,0,17,2.4285714285714284,2,0.0,0,0,0,0,8,0,0,9,0,0,17,1
5815,118508,TnL4ialg6Pf5M7cIMrmaVmE9VMhEtv14,RXDvfPUBYFlVdlueBFbLW0mhhAyGEqpt,18,22,3,16,4,2,8,1,56,8.0,3,0.0,4,3,15,4,18,2,1,8,1,26,30,1
5816,118514,W3axEfDtpWFQrOsjh1ju6UWJlt7DtE7b,SpATywNh6bZuzm8s1ceuBUnMUAeoAHHw,18,30,3,8,0,9,26,5,81,11.571428571428571,8,0.0,1,3,6,0,29,9,2,26,5,10,71,1
5817,118535,Xd9kUiTgAJSeI24Pf6yPClc38pebYRoH,SpATywNh6bZuzm8s1ceuBUnMUAeoAHHw,5,4,2,0,0,0,2,0,8,1.1428571428571428,1,0.0,0,2,0,0,4,0,0,2,0,2,6,1
5818,118548,2i4UZQIumoYMpXAy2hMZiboq0bmSvHzQ,RXDvfPUBYFlVdlueBFbLW0mhhAyGEqpt,9,26,1,0,0,0,4,0,31,4.428571428571429,2,0.0,0,1,0,0,26,0,0,4,0,1,30,1
5819,118554,YBwTM3Bv2witVJ0Ed4zAbHn1UCLHLsEN,G8EPVSXsOYB5YQWZGiz1aVq5Pgr2GrQu,42,62,31,64,16,1,10,1,185,26.428571428571427,5,0.0,23,31,42,16,39,1,22,10,1,112,73,0
5820,118577,fjx9OtTbfeYJcewn1ZUVP1qyFT70WiAr,SpATywNh6bZuzm8s1ceuBUnMUAeoAHHw,1,0,0,0,0,0,1,0,1,0.14285714285714285,1,0.0,0,0,0,0,0,0,0,1,0,0,1,1
5821,118590,7GOzqt1OWuRQhmoyI6QcRiOEY3qIt0kS,SpATywNh6bZuzm8s1ceuBUnMUAeoAHHw,4,2,0,0,0,0,2,0,4,0.5714285714285714,1,0.0,0,0,0,0,2,0,0,2,0,0,4,1
5822,118620,tKs772tHpR5tE8Ceee9VXQcqKPNhx6zt,SpATywNh6bZuzm8s1ceuBUnMUAeoAHHw,23,25,3,12,2,3,11,2,58,8.285714285714286,5,0.0,3,3,10,2,22,3,2,11,2,18,40,1
5823,118642,PpZEAa1Mdati01h1lf363alLOjmVtvBB,A3fsA9Zfv1X2fVEQhTw51lKENdNrEqT3,7,8,4,0,2,0,2,0,16,2.2857142857142856,1,0.0,1,4,0,2,7,0,0,2,0,7,9,1
5824,118650,ANtHTaCISHkEW6ENLanE6G1HEnRFLZdw,A3fsA9Zfv1X2fVEQhTw51lKENdNrEqT3,3,2,1,0,0,0,1,0,4,0.5714285714285714,1,0.0,0,1,0,0,2,0,0,1,0,1,3,0
5825,118652,eNgDL8k9xOLyBlZ3UNlseJHly8SfPZZu,bWdj2GDclj5ofokWjzoa5jAwMkxCykd6,28,129,73,128,7,114,46,1,498,71.14285714285714,14,0.0,25,73,117,7,104,114,11,46,1,222,276,0
5826,118658,eJLeV7Xq2bhq90HDU7vo6Tpmzbd63FDZ,SpATywNh6bZuzm8s1ceuBUnMUAeoAHHw,15,20,13,0,7,0,7,0,47,6.714285714285714,6,0.0,0,13,0,7,20,0,0,7,0,20,27,0
5827,118687,c1BXmJNemroOPh6WUefTBD28s2WzSNwi,A3fsA9Zfv1X2fVEQhTw51lKENdNrEqT3,51,45,4,92,4,1,16,2,164,23.428571428571427,8,0.0,2,4,87,4,43,1,5,16,2,97,67,1
5828,118688,c1BXmJNemroOPh6WUefTBD28s2WzSNwi,SpATywNh6bZuzm8s1ceuBUnMUAeoAHHw,16,28,1,12,1,2,7,1,52,7.428571428571429,2,0.0,12,1,12,1,16,2,0,7,1,26,26,0
5829,118704,ZfIQYurnR6gJbWxLJ81cU3ZqzX4mpHm0,bWdj2GDclj5ofokWjzoa5jAwMkxCykd6,9,18,8,0,1,0,11,0,38,5.428571428571429,5,0.0,1,8,0,1,17,0,0,11,0,10,28,0
5830,118714,MdZgTLmSGHkFWwMHVbVxaIOd0RHUp1Ya,G8EPVSXsOYB5YQWZGiz1aVq5Pgr2GrQu,8,2,2,0,2,1,3,0,10,1.4285714285714286,1,0.0,0,2,0,2,2,1,0,3,0,4,6,1
5831,118716,fomJrwdlOVBB27jkNMuLttmiA1XIZPzf,SpATywNh6bZuzm8s1ceuBUnMUAeoAHHw,15,22,4,4,4,1,3,0,38,5.428571428571429,4,0.0,4,4,3,4,18,1,1,3,0,15,23,1
5832,118723,9Gk0qMwFPQMSYtSGwJwjevbzKboXiTpg,SpATywNh6bZuzm8s1ceuBUnMUAeoAHHw,27,49,3,36,2,10,11,1,112,16.0,3,0.0,13,3,30,2,36,10,6,11,1,48,64,1
5833,118727,uFAwXIcuVZUrzooQS3i05Ojiq5CkITl5,G8EPVSXsOYB5YQWZGiz1aVq5Pgr2GrQu,5,2,1,0,1,0,2,0,6,0.8571428571428571,1,0.0,0,1,0,1,2,0,0,2,0,2,4,1
5834,118735,f6FNE8vNtrL6TKWAyYNA5KZvLoAoDp49,SpATywNh6bZuzm8s1ceuBUnMUAeoAHHw,19,25,4,23,6,2,24,0,84,12.0,3,0.0,8,4,20,6,17,2,3,24,0,38,46,1
5835,118740,7pYjVdOmbPwcRdb5BQqrv1P4hFEqv8iv,A3fsA9Zfv1X2fVEQhTw51lKENdNrEqT3,7,4,1,0,1,0,2,0,8,1.1428571428571428,1,0.0,0,1,0,1,4,0,0,2,0,2,6,1
5836,118748,grNuFIQJF1sOOkw8RJjaExhlwTJt52uU,G8EPVSXsOYB5YQWZGiz1aVq5Pgr2GrQu,48,102,49,112,31,19,22,1,336,48.0,11,0.0,5,49,104,31,97,19,8,22,1,189,147,0
5837,118753,5ccVO0DXIbSzn48qO0PlyxYK6uXvmUBC,SpATywNh6bZuzm8s1ceuBUnMUAeoAHHw,12,11,9,0,6,0,3,0,29,4.142857142857143,2,0.0,0,9,0,6,11,0,0,3,0,15,14,1
5838,118757,8x72g1EnsW8bYBL6HWtA15C4pKj2sPjA,G8EPVSXsOYB5YQWZGiz1aVq5Pgr2GrQu,7,8,1,0,1,0,4,0,14,2.0,3,0.0,0,1,0,1,8,0,0,4,0,2,12,1
5839,118770,JMRIHPxvEm8exxpzKPAmRrEIUgoG5Mrh,SpATywNh6bZuzm8s1ceuBUnMUAeoAHHw,7,10,4,0,1,1,5,0,21,3.0,3,0.0,0,4,0,1,10,1,0,5,0,5,16,0
5840,118779,xH5f8nfW6oTIgHjXoQgEUKIx6qvDN8rk,bWdj2GDclj5ofokWjzoa5jAwMkxCykd6,1,0,0,0,0,0,1,0,1,0.14285714285714285,1,0.0,0,0,0,0,0,0,0,1,0,0,1,0
5841,118787,bKVslXuzEQ1pv4c6iV5mVjs6X6avUbmL,A3fsA9Zfv1X2fVEQhTw51lKENdNrEqT3,40,14,11,56,10,0,3,0,94,13.428571428571429,2,0.0,1,11,53,10,13,0,3,3,0,75,19,1
5842,118792,bKVslXuzEQ1pv4c6iV5mVjs6X6avUbmL,SpATywNh6bZuzm8s1ceuBUnMUAeoAHHw,8,3,2,0,2,2,4,0,13,1.8571428571428572,3,0.0,0,2,0,2,3,2,0,4,0,4,9,1
5843,118793,lrp5AGJUh69hKuCI5IYUEU19E2beipwd,bWdj2GDclj5ofokWjzoa5jAwMkxCykd6,17,40,3,0,5,13,15,0,76,10.857142857142858,8,0.0,0,3,0,5,40,13,0,15,0,8,68,1
5844,118797,Lk947zUxODvAz9uAzr7LhEhqya4oVnNV,SpATywNh6bZuzm8s1ceuBUnMUAeoAHHw,5,4,2,0,0,0,2,0,8,1.1428571428571428,1,0.0,1,2,0,0,3,0,0,2,0,3,5,0
5845,118803,AXOBQLaknxwaGBasKpj34YfhU436HR6z,A3fsA9Zfv1X2fVEQhTw51lKENdNrEqT3,1,0,0,0,0,0,1,0,1,0.14285714285714285,1,0.0,0,0,0,0,0,0,0,1,0,0,1,1
5846,118805,c9mIdDAhRczXEb5UJiDqrnVR2zYNOBwR,A3fsA9Zfv1X2fVEQhTw51lKENdNrEqT3,1,0,0,0,0,0,2,0,2,0.2857142857142857,2,0.0,0,0,0,0,0,0,0,2,0,0,2,1
5847,118806,NbUyHCtjlZY38KWhmKKrrw2eE1rI3XlV,SpATywNh6bZuzm8s1ceuBUnMUAeoAHHw,5,2,1,0,1,0,2,0,6,0.8571428571428571,2,0.0,0,1,0,1,2,0,0,2,0,2,4,0
5848,118864,uvmnuTMWO7CUJMGmbknJbfcrAcbdWpqR,A3fsA9Zfv1X2fVEQhTw51lKENdNrEqT3,1,0,0,0,0,0,1,0,1,0.14285714285714285,1,0.0,0,0,0,0,0,0,0,1,0,0,1,1
5849,118869,5J6qme6tgFximxgH6JaagcgP0HlXsQ9E,SpATywNh6bZuzm8s1ceuBUnMUAeoAHHw,1,0,0,0,0,0,1,0,1,0.14285714285714285,1,0.0,0,0,0,0,0,0,0,1,0,0,1,1
5850,118870,5J6qme6tgFximxgH6JaagcgP0HlXsQ9E,G8EPVSXsOYB5YQWZGiz1aVq5Pgr2GrQu,2,0,0,0,0,0,2,0,2,0.2857142857142857,1,0.0,0,0,0,0,0,0,0,2,0,0,2,1
5851,118873,xKEKXJFa8iwv6Ll5IrcgpUyxzmqp78kE,G8EPVSXsOYB5YQWZGiz1aVq5Pgr2GrQu,4,2,1,0,1,0,2,0,6,0.8571428571428571,1,0.0,0,1,0,1,2,0,0,2,0,2,4,1
5852,118880,bqWpav7ocOhCfb3xc4QgAvBDK5g8BmiZ,RXDvfPUBYFlVdlueBFbLW0mhhAyGEqpt,14,26,16,0,5,0,11,0,58,8.285714285714286,5,0.0,2,16,0,5,24,0,0,11,0,23,35,0
5853,118884,c8WJAdYLV71mOx4ZXSglpCNd0dBUR3Om,SpATywNh6bZuzm8s1ceuBUnMUAeoAHHw,27,32,18,26,9,0,12,0,97,13.857142857142858,8,0.0,4,18,22,9,28,0,4,12,0,53,44,0
5854,118894,5ESBYT4YXwThMhRWcyNvUGRmyEr1sxDg,bWdj2GDclj5ofokWjzoa5jAwMkxCykd6,8,12,5,58,1,0,2,0,78,11.142857142857142,2,0.0,1,5,56,1,11,0,2,2,0,63,15,0
5855,118896,Jp4TJ4yNuhjTEvrsxd0CarZSf22aa7u6,bWdj2GDclj5ofokWjzoa5jAwMkxCykd6,1,0,0,0,0,0,1,0,1,0.14285714285714285,1,0.0,0,0,0,0,0,0,0,1,0,0,1,1
5856,118899,4TYIBYUjGx5Az0xYJI94tEHK7klSyatr,SpATywNh6bZuzm8s1ceuBUnMUAeoAHHw,1,0,0,0,0,0,1,0,1,0.14285714285714285,1,0.0,0,0,0,0,0,0,0,1,0,0,1,1
5857,118902,fhqx50pW0TcVQ59FT0II7MmWoAXcWiY8,RXDvfPUBYFlVdlueBFbLW0mhhAyGEqpt,1,0,0,0,0,0,2,0,2,0.2857142857142857,1,0.0,0,0,0,0,0,0,0,2,0,0,2,1
5858,118934,9Nk7mnk1e8KYLiEHu7uBQQPnqWiwScVk,RXDvfPUBYFlVdlueBFbLW0mhhAyGEqpt,47,77,29,93,16,11,25,2,253,36.142857142857146,4,0.0,16,29,83,16,61,11,10,25,2,144,109,1
5859,118936,0PuPhUY9SiHUBSSrbkLAmF5o2IPgOmxV,SpATywNh6bZuzm8s1ceuBUnMUAeoAHHw,9,14,12,0,11,1,2,0,40,5.714285714285714,3,0.0,0,12,0,11,14,1,0,2,0,23,17,1
5860,118948,59I5in7ieFGusS8qxVtrv60LZ3ifOtyr,bWdj2GDclj5ofokWjzoa5jAwMkxCykd6,19,52,23,128,10,0,8,0,221,31.571428571428573,5,0.0,15,23,128,10,37,0,0,8,0,176,45,1
5861,118949,ELJa8A81VOfiqD4Bg0Px962sx2WBYvb0,SpATywNh6bZuzm8s1ceuBUnMUAeoAHHw,12,7,4,0,3,9,5,1,29,4.142857142857143,2,0.0,2,4,0,3,5,9,0,5,1,9,20,0
5862,118951,TBPsTKQ0wiJelelFqXJF9QW001tGl6zy,A3fsA9Zfv1X2fVEQhTw51lKENdNrEqT3,35,28,1,50,0,0,25,1,105,15.0,3,0.0,3,1,45,0,25,0,5,25,1,49,56,1
5863,118960,TzZdxcOoymQCIG3dwqgzf7xbUV8iLHy5,SpATywNh6bZuzm8s1ceuBUnMUAeoAHHw,5,5,0,0,0,1,6,0,12,1.7142857142857142,3,0.0,0,0,0,0,5,1,0,6,0,0,12,1
5864,118971,u2BXxIc4z9dAiJXDpFgnfPpgZoYcSTcc,bWdj2GDclj5ofokWjzoa5jAwMkxCykd6,6,19,12,0,4,0,12,0,47,6.714285714285714,6,0.0,0,12,0,4,19,0,0,12,0,16,31,1
5865,118997,mlU6Sa4kvQqDwrJTiTVy3DXIlsysw3Tt,A3fsA9Zfv1X2fVEQhTw51lKENdNrEqT3,35,22,0,92,0,12,9,1,136,19.428571428571427,2,0.0,2,0,75,0,20,12,17,9,1,77,59,1
5866,118998,Xi5jJx0Z2MOBm1fPpYwlvuzwElYhyszd,G8EPVSXsOYB5YQWZGiz1aVq5Pgr2GrQu,7,9,3,0,2,0,1,0,15,2.142857142857143,1,0.0,0,3,0,2,9,0,0,1,0,5,10,1
5867,119004,3eP3vquJMvO37pCrMFuVqCWmbxwqBlGj,A3fsA9Zfv1X2fVEQhTw51lKENdNrEqT3,16,13,9,2,7,0,4,0,35,5.0,3,0.0,0,9,2,7,13,0,0,4,0,18,17,1
5868,119006,4dfnEKxHCmGabkBCiKHt5nKr3H7Bwo1x,bWdj2GDclj5ofokWjzoa5jAwMkxCykd6,4,3,1,0,1,0,1,0,6,0.8571428571428571,1,0.0,1,1,0,1,2,0,0,1,0,3,3,1
5869,119018,YlBjTpSiRd0E60X9iyws01NkNrRpj13s,SpATywNh6bZuzm8s1ceuBUnMUAeoAHHw,27,30,13,22,8,0,3,0,76,10.857142857142858,2,0.0,11,13,21,8,19,0,1,3,0,53,23,1
5870,119032,1Y8zyxJNFqsbAxngaSR4MBCJMYy7aumA,bWdj2GDclj5ofokWjzoa5jAwMkxCykd6,1,0,0,0,0,0,1,0,1,0.14285714285714285,1,0.0,0,0,0,0,0,0,0,1,0,0,1,1
5871,119045,VXXH6vGXZQbtzT48oIYSMTaYkPq1TVm5,SpATywNh6bZuzm8s1ceuBUnMUAeoAHHw,31,31,18,24,11,6,12,1,103,14.714285714285714,3,0.0,5,18,22,11,26,6,2,12,1,56,47,0
5872,119053,fS72R3kjN9mNNeiYurwm3Uc8w1dF6aYm,SpATywNh6bZuzm8s1ceuBUnMUAeoAHHw,17,55,23,12,7,16,15,1,129,18.428571428571427,7,0.0,22,23,9,7,33,16,3,15,1,61,68,0
5873,119078,JMeqbYMJuCTPv5oP8GGGEcVIzkVIeo33,G8EPVSXsOYB5YQWZGiz1aVq5Pgr2GrQu,5,2,1,0,1,0,4,0,8,1.1428571428571428,1,0.0,0,1,0,1,2,0,0,4,0,2,6,1
5874,119081,GXJYNcNV7uKT2JtMLlsgpwRjSgogNoCV,SpATywNh6bZuzm8s1ceuBUnMUAeoAHHw,16,23,11,24,0,7,9,1,75,10.714285714285714,6,0.0,7,11,18,0,16,7,6,9,1,36,39,1
5875,119083,gqAkLU7vUDjTRzHCYv88c6gFo2DAkAbW,G8EPVSXsOYB5YQWZGiz1aVq5Pgr2GrQu,8,4,2,0,2,0,5,0,13,1.8571428571428572,2,0.0,1,2,0,2,3,0,0,5,0,5,8,1
5876,119099,AcUSYBssFtIXtGaa6RbLXgLyfwfDcCt8,SpATywNh6bZuzm8s1ceuBUnMUAeoAHHw,8,2,1,0,1,0,5,1,10,1.4285714285714286,1,0.0,0,1,0,1,2,0,0,5,1,2,8,1
5877,119114,99Z3XYkjkHbSSUTlX3TBtdd4he2ej5Yp,SpATywNh6bZuzm8s1ceuBUnMUAeoAHHw,6,3,1,0,1,0,2,0,7,1.0,2,0.0,0,1,0,1,3,0,0,2,0,2,5,1
5878,119116,syYCTgfx3QIfokZD3KllJs2hnCVUuN4D,G8EPVSXsOYB5YQWZGiz1aVq5Pgr2GrQu,24,40,22,0,17,0,6,0,85,12.142857142857142,4,0.0,0,22,0,17,40,0,0,6,0,39,46,1
5879,119118,oxh7qXSiU691JDzseRI3suXHok8L6Fau,SpATywNh6bZuzm8s1ceuBUnMUAeoAHHw,1,0,0,0,0,0,1,0,1,0.14285714285714285,1,0.0,0,0,0,0,0,0,0,1,0,0,1,1
5880,119119,t1xspb1k3lEGBshWKCwAoW44MsPqXHk5,SpATywNh6bZuzm8s1ceuBUnMUAeoAHHw,1,0,0,0,0,0,1,0,1,0.14285714285714285,1,0.0,0,0,0,0,0,0,0,1,0,0,1,1
5881,119122,2GmODuvdJOOWe3lnyYMmKWQOHBH828Cm,SpATywNh6bZuzm8s1ceuBUnMUAeoAHHw,21,21,9,18,7,0,3,0,58,8.285714285714286,2,0.0,10,9,17,7,11,0,1,3,0,43,15,1
5882,119128,OUbrW18OgibVb4I41eHFiFhkobpgjEP2,bWdj2GDclj5ofokWjzoa5jAwMkxCykd6,23,22,16,0,12,0,11,0,61,8.714285714285714,3,0.0,0,16,0,12,22,0,0,11,0,28,33,0
5883,119135,LU9kxt8aKnlOn8SnA2EuX2MLajf5Sg2a,RXDvfPUBYFlVdlueBFbLW0mhhAyGEqpt,10,7,4,0,3,0,5,0,19,2.7142857142857144,2,0.0,0,4,0,3,7,0,0,5,0,7,12,1
5884,119144,ppepyuI84wHcCSvA9T6Tm0AI9MVxK9O7,SpATywNh6bZuzm8s1ceuBUnMUAeoAHHw,31,56,24,30,12,23,19,5,169,24.142857142857142,5,0.0,24,24,25,12,32,23,5,19,5,85,84,0
5885,119156,M2R4IY0V8T0jxOaASirvYDTUV5jV2Rus,bWdj2GDclj5ofokWjzoa5jAwMkxCykd6,4,2,0,0,0,0,2,0,4,0.5714285714285714,1,0.0,0,0,0,0,2,0,0,2,0,0,4,1
5886,119158,y71lRBqIdu5iPiLn9Yi5PQm6GFIvgLwB,SpATywNh6bZuzm8s1ceuBUnMUAeoAHHw,17,43,21,22,2,0,12,0,100,14.285714285714286,4,0.0,11,21,20,2,32,0,2,12,0,54,46,0
5887,119168,ekf83KLNEhO9pLixPeJLFRG8dewqTHZv,A3fsA9Zfv1X2fVEQhTw51lKENdNrEqT3,41,39,16,72,7,1,17,2,154,22.0,1,0.0,4,16,57,7,35,1,15,17,2,84,70,1
5888,119181,mu7Zdr1ChN6xNMWE8Otd7Si7TQhm7pEQ,A3fsA9Zfv1X2fVEQhTw51lKENdNrEqT3,15,33,17,0,7,0,27,0,84,12.0,6,0.0,2,17,0,7,31,0,0,27,0,26,58,1
5889,119186,3RNLJ31M9nSB8CG0xpg62lnc8uIPaM9a,A3fsA9Zfv1X2fVEQhTw51lKENdNrEqT3,1,0,0,0,0,0,1,0,1,0.14285714285714285,1,0.0,0,0,0,0,0,0,0,1,0,0,1,1
5890,119189,OXg5CDewbDZIhWJ50yEsGOqULuWAjfkH,SpATywNh6bZuzm8s1ceuBUnMUAeoAHHw,29,48,17,33,8,0,11,1,118,16.857142857142858,4,0.0,27,17,32,8,21,0,1,11,1,84,34,0
5891,119210,MgBJbfRXH0QNEJmIiGY28SpmFvbhxSoF,SpATywNh6bZuzm8s1ceuBUnMUAeoAHHw,28,64,25,25,7,10,20,0,151,21.571428571428573,7,0.0,6,25,23,7,58,10,2,20,0,61,90,0
5892,119216,jFlacyEy6lTVCBjW1JtG8q0M3te6pg5n,SpATywNh6bZuzm8s1ceuBUnMUAeoAHHw,8,8,7,0,4,0,1,0,20,2.857142857142857,1,0.0,0,7,0,4,8,0,0,1,0,11,9,1
5893,119226,62W3eQBI1VOzt0BqCcwSBPoLO4GuQy3m,SpATywNh6bZuzm8s1ceuBUnMUAeoAHHw,2,0,0,0,0,0,2,0,2,0.2857142857142857,1,0.0,0,0,0,0,0,0,0,2,0,0,2,1
5894,119227,xxkjaaKQsdSI27nMseGDTa7U8FtH9OJW,SpATywNh6bZuzm8s1ceuBUnMUAeoAHHw,1,0,0,0,0,0,2,0,2,0.2857142857142857,2,0.0,0,0,0,0,0,0,0,2,0,0,2,0
5895,119231,eZgbWFMeI0otfUV1lMfDbtMKCRIv32Fs,bWdj2GDclj5ofokWjzoa5jAwMkxCykd6,4,2,1,0,1,0,1,0,5,0.7142857142857143,1,0.0,0,1,0,1,2,0,0,1,0,2,3,1
5896,119244,l5XRpi9H4fQ2XUHeEPRXRHL6Y4BckIOB,SpATywNh6bZuzm8s1ceuBUnMUAeoAHHw,5,2,1,0,1,0,2,0,6,0.8571428571428571,1,0.0,0,1,0,1,2,0,0,2,0,2,4,1
5897,119254,i0ksX07HnsV5rQlWqOr1uKEuc7yNU24c,SpATywNh6bZuzm8s1ceuBUnMUAeoAHHw,24,41,20,10,7,26,20,2,126,18.0,9,0.0,8,20,8,7,33,26,2,20,2,43,83,0
5898,119269,NLv4FgxnCzxez4sx4x5czDhMA2RThzip,bWdj2GDclj5ofokWjzoa5jAwMkxCykd6,5,2,1,0,1,0,2,0,6,0.8571428571428571,1,0.0,0,1,0,1,2,0,0,2,0,2,4,1
5899,119277,sBmxTL0paOf5h6iJST2iiGwB52qodqPr,bWdj2GDclj5ofokWjzoa5jAwMkxCykd6,22,38,19,78,4,36,32,3,210,30.0,7,0.0,7,19,76,4,31,36,2,32,3,106,104,0
5900,119279,FOCwtnRC84DvGRNwirqX2TIHG72pPbnw,SpATywNh6bZuzm8s1ceuBUnMUAeoAHHw,24,36,18,15,0,4,10,2,85,12.142857142857142,3,0.0,5,18,15,0,31,4,0,10,2,38,47,0
5901,119282,YoVBBM37O51IO7pPJxiQFT0wqXwSlTU1,SpATywNh6bZuzm8s1ceuBUnMUAeoAHHw,1,0,0,0,0,0,2,0,2,0.2857142857142857,1,0.0,0,0,0,0,0,0,0,2,0,0,2,1
5902,119302,YRQYtB97mu5D5o5X26cOj03m1GAHWWGU,A3fsA9Zfv1X2fVEQhTw51lKENdNrEqT3,1,0,0,0,0,0,1,0,1,0.14285714285714285,1,0.0,0,0,0,0,0,0,0,1,0,0,1,1
5903,119311,o5C13ZWWgtJ11zB44EfcDF5SUBXAMxu8,SpATywNh6bZuzm8s1ceuBUnMUAeoAHHw,20,25,5,10,4,2,17,2,65,9.285714285714286,5,0.0,2,5,8,4,23,2,2,17,2,19,46,0
5904,119315,ektlnuTUH55osIRyBZ2zIfPZcGRkwXyX,SpATywNh6bZuzm8s1ceuBUnMUAeoAHHw,6,2,1,0,1,0,2,0,6,0.8571428571428571,1,0.0,0,1,0,1,2,0,0,2,0,2,4,1
5905,119318,LKEJY5MvP0gj7M4NL5iRnXDBazXBKsOA,A3fsA9Zfv1X2fVEQhTw51lKENdNrEqT3,11,14,4,0,3,0,2,0,23,3.2857142857142856,1,0.0,0,4,0,3,14,0,0,2,0,7,16,1
5906,119333,om0KjvovtBK0gZUSboAPRv5A6Jkm00Ei,SpATywNh6bZuzm8s1ceuBUnMUAeoAHHw,2,0,0,0,0,0,2,0,2,0.2857142857142857,2,0.0,0,0,0,0,0,0,0,2,0,0,2,1
5907,119347,hpQLTEd5unsxchTVftQsLrZknN9z8sq4,bWdj2GDclj5ofokWjzoa5jAwMkxCykd6,6,4,1,0,1,0,2,0,8,1.1428571428571428,1,0.0,0,1,0,1,4,0,0,2,0,2,6,1
5908,119352,8EUVcR3i03tV4r6XHeEe98sUtzrKJPIp,SpATywNh6bZuzm8s1ceuBUnMUAeoAHHw,25,25,15,12,6,2,9,0,69,9.857142857142858,6,0.0,5,15,12,6,20,2,0,9,0,38,31,0
5909,119354,dTKURyZ9dyqGbe4l7wsUGgSU85JHBAFq,SpATywNh6bZuzm8s1ceuBUnMUAeoAHHw,14,12,4,0,3,0,3,0,22,3.142857142857143,3,0.0,0,4,0,3,12,0,0,3,0,7,15,0
5910,119356,a7ZVMpb0c7CARO4liNTBsp4hgkFIkG4C,bWdj2GDclj5ofokWjzoa5jAwMkxCykd6,1,0,0,0,0,0,2,0,2,0.2857142857142857,1,0.0,0,0,0,0,0,0,0,2,0,0,2,1
5911,119380,6CE4R3S7kL46D5t23wqANpKa4VUqa9S2,SpATywNh6bZuzm8s1ceuBUnMUAeoAHHw,8,10,1,0,1,0,4,0,16,2.2857142857142856,2,0.0,0,1,0,1,10,0,0,4,0,2,14,1
5912,119386,nIvIddlMAmTQagaACOulbZ6PInxlyOy2,SpATywNh6bZuzm8s1ceuBUnMUAeoAHHw,24,41,22,24,8,5,7,1,108,15.428571428571429,2,0.0,14,22,24,8,27,5,0,7,1,68,40,1
5913,119390,hZR4MwcYec4g0GoOyJFngJGEyWOySpv2,A3fsA9Zfv1X2fVEQhTw51lKENdNrEqT3,10,14,9,0,6,5,16,0,50,7.142857142857143,6,0.0,0,9,0,6,14,5,0,16,0,15,35,0
5914,119391,mxHDkP66knN7zmdYEUQKDHYwEophbx3W,SpATywNh6bZuzm8s1ceuBUnMUAeoAHHw,30,54,27,18,16,135,20,4,274,39.142857142857146,7,0.0,11,27,16,16,43,135,2,20,4,70,204,0
5915,119429,OTXI4wiLpFntQK2eNytsM7PA1sOBHBSJ,G8EPVSXsOYB5YQWZGiz1aVq5Pgr2GrQu,14,39,3,40,6,7,2,0,97,13.857142857142858,2,0.0,23,3,32,6,16,7,8,2,0,64,33,0
5916,119430,dHUuZjpItF11lyBzOZmo46k7ssSyfCST,SpATywNh6bZuzm8s1ceuBUnMUAeoAHHw,7,5,3,0,2,0,2,0,12,1.7142857142857142,1,0.0,0,3,0,2,5,0,0,2,0,5,7,1
5917,119439,lzAfN1BunM1OtPEKsFi16ad7rFshkF39,A3fsA9Zfv1X2fVEQhTw51lKENdNrEqT3,10,5,3,0,2,0,7,0,17,2.4285714285714284,1,0.0,0,3,0,2,5,0,0,7,0,5,12,1
5918,119467,HTcH1TxkMChxNxwRHZ3kkRRHs5Azwnka,SpATywNh6bZuzm8s1ceuBUnMUAeoAHHw,14,47,7,24,1,10,19,0,108,15.428571428571429,3,0.0,14,7,20,1,33,10,4,19,0,42,66,0
5919,119487,pPq1reHOvROgjdMRqZ7zZoFjsUW0sHcE,SpATywNh6bZuzm8s1ceuBUnMUAeoAHHw,8,21,12,0,6,0,7,0,46,6.571428571428571,2,0.0,0,12,0,6,21,0,0,7,0,18,28,1
5920,119490,83cBV2IXkwoW1nUaa1kxaJ98L3bxFsPn,RXDvfPUBYFlVdlueBFbLW0mhhAyGEqpt,27,71,51,16,2,31,17,0,188,26.857142857142858,8,0.0,7,51,15,2,64,31,1,17,0,75,113,1
5921,119494,4SbF4DhXcYorYYyJ4XmwwPJZFVh1ZUhY,bWdj2GDclj5ofokWjzoa5jAwMkxCykd6,2,0,0,0,0,0,2,0,2,0.2857142857142857,1,0.0,0,0,0,0,0,0,0,2,0,0,2,1
5922,119495,QXg7RHDSlJliIBbIO3xqJ8cmekKDZLIJ,RXDvfPUBYFlVdlueBFbLW0mhhAyGEqpt,1,0,0,0,0,0,1,0,1,0.14285714285714285,1,0.0,0,0,0,0,0,0,0,1,0,0,1,1
5923,119499,j55CnsxXtuPHDTIgqOvx7oExU3RRtQ4I,bWdj2GDclj5ofokWjzoa5jAwMkxCykd6,1,0,0,0,0,0,1,0,1,0.14285714285714285,1,0.0,0,0,0,0,0,0,0,1,0,0,1,1
5924,119506,KouA4JUz2i1n0FC6Xu2JucWPd7vnGUb0,SpATywNh6bZuzm8s1ceuBUnMUAeoAHHw,28,87,17,18,7,1,32,0,162,23.142857142857142,11,0.0,6,17,18,7,81,1,0,32,0,48,114,0
5925,119509,8MuGb55gUM18pukCITXgZoTSobqXs9G4,SpATywNh6bZuzm8s1ceuBUnMUAeoAHHw,10,7,0,14,0,2,4,0,27,3.857142857142857,3,0.0,2,0,13,0,5,2,1,4,0,15,12,1
5926,119522,VC4hf15u71ct6dl0hPNvhbtubU19kXe5,RXDvfPUBYFlVdlueBFbLW0mhhAyGEqpt,8,17,2,0,3,0,4,0,26,3.7142857142857144,2,0.0,4,2,0,3,13,0,0,4,0,9,17,1
5927,119524,RRKT0H2BFDE1dQIQFr3IpZgVIVSJVg71,SpATywNh6bZuzm8s1ceuBUnMUAeoAHHw,29,73,28,27,8,2,20,0,158,22.571428571428573,9,0.0,26,28,23,8,47,2,4,20,0,85,73,0
5928,119543,Cf7GCeUZzG7WjvUIyGfwv9hfcwXPVq5G,G8EPVSXsOYB5YQWZGiz1aVq5Pgr2GrQu,85,193,6,185,9,0,22,1,416,59.42857142857143,9,0.0,51,6,144,9,142,0,41,22,1,210,206,0
5929,119566,TeehsynnhYxXCw31hnpNtyZisOmQoW1M,A3fsA9Zfv1X2fVEQhTw51lKENdNrEqT3,12,11,9,0,7,0,5,0,32,4.571428571428571,1,0.0,0,9,0,7,11,0,0,5,0,16,16,1
5930,119567,Dl433WBzpFXMdRxwA66dmtxmpsyN7fkX,SpATywNh6bZuzm8s1ceuBUnMUAeoAHHw,13,25,6,0,2,0,10,0,43,6.142857142857143,8,0.0,0,6,0,2,25,0,0,10,0,8,35,0
5931,119571,sZV7O4QepCcao3DEyr879t5mUWopWkVJ,SpATywNh6bZuzm8s1ceuBUnMUAeoAHHw,8,10,2,14,0,0,1,0,27,3.857142857142857,1,0.0,6,2,14,0,4,0,0,1,0,22,5,0
5932,119594,LKtddpPnbyASKztptrkj08yJIKu8wvyQ,SpATywNh6bZuzm8s1ceuBUnMUAeoAHHw,7,10,2,0,2,0,3,0,17,2.4285714285714284,2,0.0,0,2,0,2,10,0,0,3,0,4,13,1
5933,119600,SSpeewBDHUNKkvUJM5ASinNHvMXIOEwr,G8EPVSXsOYB5YQWZGiz1aVq5Pgr2GrQu,2,0,0,0,0,2,1,0,3,0.42857142857142855,1,0.0,0,0,0,0,0,2,0,1,0,0,3,1
5934,119618,nIvIddlMAmTQagaACOulbZ6PInxlyOy2,A3fsA9Zfv1X2fVEQhTw51lKENdNrEqT3,9,10,6,0,3,0,2,0,21,3.0,2,0.0,3,6,0,3,7,0,0,2,0,12,9,1
5935,119619,nIvIddlMAmTQagaACOulbZ6PInxlyOy2,bWdj2GDclj5ofokWjzoa5jAwMkxCykd6,5,2,1,0,1,0,3,0,7,1.0,2,0.0,0,1,0,1,2,0,0,3,0,2,5,1
5936,119631,ltVEinCK1OZ9CXJhcqdDg6iZlAvKKTwQ,SpATywNh6bZuzm8s1ceuBUnMUAeoAHHw,20,24,12,16,5,8,15,3,83,11.857142857142858,2,0.0,8,12,13,5,16,8,3,15,3,38,45,0
5937,119652,Zu9dYhL9acZhCeqBcc9hWzPmaWR78jEQ,SpATywNh6bZuzm8s1ceuBUnMUAeoAHHw,27,31,16,28,8,23,23,4,133,19.0,4,0.0,8,16,26,8,23,23,2,23,4,58,75,1
5938,119657,3uRdpkkFK8afBf0m3EhgoX6LxrN8Pbes,SpATywNh6bZuzm8s1ceuBUnMUAeoAHHw,7,4,2,0,1,0,2,0,9,1.2857142857142858,1,0.0,0,2,0,1,4,0,0,2,0,3,6,1
5939,119664,8pu9JNwVnUBnBwmPCcdXCPyTfkNF9IyH,SpATywNh6bZuzm8s1ceuBUnMUAeoAHHw,1,0,0,0,0,0,1,0,1,0.14285714285714285,1,0.0,0,0,0,0,0,0,0,1,0,0,1,1
5940,119695,EGp6xRzNCnsCPDRg0mfvtfy8t2jZt4I9,SpATywNh6bZuzm8s1ceuBUnMUAeoAHHw,29,81,18,44,7,11,12,0,173,24.714285714285715,5,0.0,58,18,38,7,23,11,6,12,0,121,52,0
5941,119701,dkqBzIxmPMIDvZ06VSkMjfODuMzZmTP8,A3fsA9Zfv1X2fVEQhTw51lKENdNrEqT3,17,33,21,0,12,0,5,0,71,10.142857142857142,5,0.0,0,21,0,12,33,0,0,5,0,33,38,1
5942,119717,uNXbTIc96Uw6O7qA5DEUx7vv6h22TWxF,SpATywNh6bZuzm8s1ceuBUnMUAeoAHHw,5,2,1,0,1,0,2,0,6,0.8571428571428571,1,0.0,0,1,0,1,2,0,0,2,0,2,4,1
5943,119722,xdLtxzmqjHKGxCxWUtaHyGHCjlQjqauy,SpATywNh6bZuzm8s1ceuBUnMUAeoAHHw,5,2,1,0,1,0,2,0,6,0.8571428571428571,1,0.0,0,1,0,1,2,0,0,2,0,2,4,1
5944,119745,UvgRbw5a5wuG6YWcUt1dwOeNyn0b7Smd,SpATywNh6bZuzm8s1ceuBUnMUAeoAHHw,12,19,3,4,3,0,6,0,35,5.0,6,0.0,3,3,4,3,16,0,0,6,0,13,22,1
5945,119756,xdLtxzmqjHKGxCxWUtaHyGHCjlQjqauy,RXDvfPUBYFlVdlueBFbLW0mhhAyGEqpt,6,1,1,0,1,0,3,0,6,0.8571428571428571,1,0.0,0,1,0,1,1,0,0,3,0,2,4,1
5946,119780,6r9w9XrCXpAInFHxfDIxOD9m18cX5jcd,bWdj2GDclj5ofokWjzoa5jAwMkxCykd6,1,0,0,0,0,0,1,0,1,0.14285714285714285,1,0.0,0,0,0,0,0,0,0,1,0,0,1,1
5947,119787,lWx0TIRF08ECAhAH5cUKSzERq6JEXGBg,A3fsA9Zfv1X2fVEQhTw51lKENdNrEqT3,1,0,0,0,0,0,1,0,1,0.14285714285714285,1,0.0,0,0,0,0,0,0,0,1,0,0,1,1
5948,119829,evMifCtMisukBDxvYkui0DyIUgVf4aQM,SpATywNh6bZuzm8s1ceuBUnMUAeoAHHw,1,0,0,0,0,0,1,0,1,0.14285714285714285,1,0.0,0,0,0,0,0,0,0,1,0,0,1,1
5949,119831,xrGttsK9FjNRictE1FckUAFqkfpHfKEh,bWdj2GDclj5ofokWjzoa5jAwMkxCykd6,13,14,8,64,3,2,4,2,97,13.857142857142858,1,0.0,1,8,63,3,13,2,1,4,2,75,22,1
5950,119853,uF2Lhc31StnMPtUmgamWrmnuCJ4n9iAe,bWdj2GDclj5ofokWjzoa5jAwMkxCykd6,7,2,1,0,1,1,5,1,11,1.5714285714285714,1,0.0,0,1,0,1,2,1,0,5,1,2,9,0
5951,119860,zvwdGnH0aGIXM4GZVb8XpCl4QdIDbhPS,G8EPVSXsOYB5YQWZGiz1aVq5Pgr2GrQu,60,102,45,67,26,34,37,4,315,45.0,7,0.0,26,45,59,26,76,34,8,37,4,156,159,1
5952,119863,C8zDhaG0vPsQegBtS55u3JZHiYuueFnE,A3fsA9Zfv1X2fVEQhTw51lKENdNrEqT3,22,26,3,14,1,3,25,3,75,10.714285714285714,7,0.0,0,3,12,1,26,3,2,25,3,16,59,0
5953,119864,i9tnH9kRJ3DOJJRtKKsLYacNrvT4eUwS,SpATywNh6bZuzm8s1ceuBUnMUAeoAHHw,1,0,0,0,0,0,1,0,1,0.14285714285714285,1,0.0,0,0,0,0,0,0,0,1,0,0,1,1
5954,119865,fl8sEptrcl2JvFWXejFcnsM7BqWtKl9w,SpATywNh6bZuzm8s1ceuBUnMUAeoAHHw,30,61,25,32,12,0,9,2,141,20.142857142857142,4,0.0,20,25,22,12,41,0,10,9,2,79,62,1
5955,119866,VLCI0RtMsYSrwlXRiyKxAF4TijVOF7sG,SpATywNh6bZuzm8s1ceuBUnMUAeoAHHw,23,83,14,18,2,15,11,2,145,20.714285714285715,6,0.0,34,14,18,2,49,15,0,11,2,68,77,0
5956,119941,5rpYxIaCTDb4PhszkJWpACOx5VMpNGcQ,RXDvfPUBYFlVdlueBFbLW0mhhAyGEqpt,1,0,0,0,0,0,1,0,1,0.14285714285714285,1,0.0,0,0,0,0,0,0,0,1,0,0,1,1
5957,119944,ico4mWfX6sj6OUii1pav0Sth51UYo7la,SpATywNh6bZuzm8s1ceuBUnMUAeoAHHw,26,27,17,17,11,0,3,0,75,10.714285714285714,2,0.0,8,17,16,11,19,0,1,3,0,52,23,1
5958,119957,u08BFRXkclhXgm6zX4b6QASKB5vRi3vI,G8EPVSXsOYB5YQWZGiz1aVq5Pgr2GrQu,84,140,83,539,31,28,30,2,853,121.85714285714286,7,0.0,42,83,510,31,98,28,29,30,2,666,187,1
5959,119963,CjBVUSApACPW9BPUvs2DTjIpAnotUs5g,SpATywNh6bZuzm8s1ceuBUnMUAeoAHHw,14,18,1,19,1,1,9,1,50,7.142857142857143,1,0.0,11,1,16,1,7,1,3,9,1,29,21,1
5960,119979,SplRKhPt7Yggv7MXNRiesXXwYzrLK9vJ,G8EPVSXsOYB5YQWZGiz1aVq5Pgr2GrQu,4,3,1,0,1,0,1,0,6,0.8571428571428571,3,0.0,0,1,0,1,3,0,0,1,0,2,4,1
5961,119986,EjqS3A2Iv9J8JTjinbKy3gdtrrXaSQyJ,A3fsA9Zfv1X2fVEQhTw51lKENdNrEqT3,3,2,1,0,0,0,1,0,4,0.5714285714285714,1,0.0,0,1,0,0,2,0,0,1,0,1,3,1
5962,120002,12gMTBWTVUlnqCedZPd5qmMR4GGhf0zr,SpATywNh6bZuzm8s1ceuBUnMUAeoAHHw,5,4,2,0,0,0,2,1,9,1.2857142857142858,1,0.0,0,2,0,0,4,0,0,2,1,2,7,1
5963,120012,i2raPzmlvNePAOSFdEUwI0BA2bKyQ3vM,G8EPVSXsOYB5YQWZGiz1aVq5Pgr2GrQu,1,0,0,0,0,0,1,0,1,0.14285714285714285,1,0.0,0,0,0,0,0,0,0,1,0,0,1,1
5964,120030,OCy6YOUNXmqhix568ujBGQdiiP42aDkJ,A3fsA9Zfv1X2fVEQhTw51lKENdNrEqT3,2,0,0,0,0,0,2,0,2,0.2857142857142857,1,0.0,0,0,0,0,0,0,0,2,0,0,2,1
5965,120034,ZdyJOuWyQCEC2K6zkBmHBJ8KuSKqmluL,SpATywNh6bZuzm8s1ceuBUnMUAeoAHHw,1,0,0,0,0,0,1,0,1,0.14285714285714285,1,0.0,0,0,0,0,0,0,0,1,0,0,1,1
5966,120045,sUwmc6V8FwsEYMDv4tIg9OLo8ph5JoxU,SpATywNh6bZuzm8s1ceuBUnMUAeoAHHw,21,21,13,25,11,1,4,1,76,10.857142857142858,1,0.0,6,13,20,11,15,1,5,4,1,50,26,1
5967,120047,YeW4hKsNTCNPhFuRao1EDcfgQ0cnIKSL,SpATywNh6bZuzm8s1ceuBUnMUAeoAHHw,30,42,20,37,9,2,8,0,118,16.857142857142858,4,0.0,11,20,31,9,31,2,6,8,0,71,47,0
5968,120057,UUY3BPLR7A3Xa6FGsztMCn6xCbxtdCYu,RXDvfPUBYFlVdlueBFbLW0mhhAyGEqpt,1,0,0,0,0,0,1,0,1,0.14285714285714285,1,0.0,0,0,0,0,0,0,0,1,0,0,1,0
5969,120065,fFuKiCeoQQwOgD8VAud2ta198Mbq05KK,A3fsA9Zfv1X2fVEQhTw51lKENdNrEqT3,19,27,12,0,8,4,10,1,62,8.857142857142858,3,0.0,0,12,0,8,27,4,0,10,1,20,42,1
5970,120079,L8OTKfJAxDSZZQ12fQtkWrcZUlsGAJb9,RXDvfPUBYFlVdlueBFbLW0mhhAyGEqpt,18,29,9,24,5,4,15,0,86,12.285714285714286,3,0.0,8,9,24,5,21,4,0,15,0,46,40,1
5971,120090,ZOVfvlm206voHlGJ4V6McNGjtxTxB7JQ,bWdj2GDclj5ofokWjzoa5jAwMkxCykd6,5,4,2,0,1,0,3,0,10,1.4285714285714286,2,0.0,0,2,0,1,4,0,0,3,0,3,7,1
5972,120094,rn4nO5004kgupfgjaXh0qv5wJPGuOGCi,RXDvfPUBYFlVdlueBFbLW0mhhAyGEqpt,45,123,2,107,33,0,11,1,277,39.57142857142857,3,0.0,74,2,85,33,49,0,22,11,1,194,83,1
5973,120112,1mkiIDsUp1k3i5MLWwlZyMuhsxinTdaD,SpATywNh6bZuzm8s1ceuBUnMUAeoAHHw,2,0,0,0,0,0,2,0,2,0.2857142857142857,1,0.0,0,0,0,0,0,0,0,2,0,0,2,0
5974,120117,rZEWlNSgKDNaTi3a1r581EGtpdBLkfvY,bWdj2GDclj5ofokWjzoa5jAwMkxCykd6,4,2,1,0,1,6,1,0,11,1.5714285714285714,1,0.0,0,1,0,1,2,6,0,1,0,2,9,1
5975,120128,5cb6e9jDwVr8l5vkAvM3VmmyddxE34Qz,SpATywNh6bZuzm8s1ceuBUnMUAeoAHHw,13,8,5,13,3,0,1,0,30,4.285714285714286,1,0.0,2,5,13,3,6,0,0,1,0,23,7,1
5976,120139,n82RJkzFXSSDMIdkMmtipPuRNBWDUBXQ,SpATywNh6bZuzm8s1ceuBUnMUAeoAHHw,16,33,16,14,5,0,10,3,81,11.571428571428571,3,0.0,5,16,12,5,28,0,2,10,3,38,43,1
5977,120168,oXcCXnNaPGvzw5MpNzQ49lDnTqlhdcyO,A3fsA9Zfv1X2fVEQhTw51lKENdNrEqT3,8,5,3,0,2,0,3,0,13,1.8571428571428572,2,0.0,0,3,0,2,5,0,0,3,0,5,8,1
5978,120195,1LkX4t7QGG0LPbqqJvnwJmrweFNAYkvm,A3fsA9Zfv1X2fVEQhTw51lKENdNrEqT3,11,9,1,0,0,0,9,2,21,3.0,2,0.0,0,1,0,0,9,0,0,9,2,1,20,1
5979,120215,UnBwSmlOPbYUmVq2fUKodPbT52jzjDn0,A3fsA9Zfv1X2fVEQhTw51lKENdNrEqT3,23,18,16,0,12,0,3,0,49,7.0,2,0.0,0,16,0,12,18,0,0,3,0,28,21,0
5980,120223,nrDkIZH2wqEVh6i4pBxcbRBJIMc9s20b,G8EPVSXsOYB5YQWZGiz1aVq5Pgr2GrQu,73,123,6,230,8,0,30,0,397,56.714285714285715,8,0.0,38,6,203,8,85,0,27,30,0,255,142,0
5981,120226,Y9zzxa8aT5mj3vCCOFRszZ8rRbH90TaX,SpATywNh6bZuzm8s1ceuBUnMUAeoAHHw,5,2,1,0,1,0,2,0,6,0.8571428571428571,1,0.0,0,1,0,1,2,0,0,2,0,2,4,1
5982,120232,RYd1k9DojojPZwrkV3NjsTI5OdZnPV9W,SpATywNh6bZuzm8s1ceuBUnMUAeoAHHw,12,21,0,12,2,0,5,0,40,5.714285714285714,2,0.0,2,0,12,2,19,0,0,5,0,16,24,0
5983,120235,RYd1k9DojojPZwrkV3NjsTI5OdZnPV9W,RXDvfPUBYFlVdlueBFbLW0mhhAyGEqpt,8,13,0,0,0,0,4,0,17,2.4285714285714284,3,0.0,0,0,0,0,13,0,0,4,0,0,17,1
5984,120239,80Av2RXrFoxNOdv7EQUM2TDOM0gyNH0J,SpATywNh6bZuzm8s1ceuBUnMUAeoAHHw,27,33,18,27,9,15,7,0,109,15.571428571428571,3,0.0,4,18,23,9,29,15,4,7,0,54,55,1
5985,120266,kV6dnmPo3GuG7esOG3uZN9iddNOehLbM,SpATywNh6bZuzm8s1ceuBUnMUAeoAHHw,18,30,2,7,1,4,14,2,60,8.571428571428571,3,0.0,5,2,7,1,25,4,0,14,2,15,45,1
5986,120275,wx3mAGKFM6cge9w8piWfsYKppmWVhkYO,A3fsA9Zfv1X2fVEQhTw51lKENdNrEqT3,20,25,13,0,9,0,5,0,52,7.428571428571429,4,0.0,0,13,0,9,25,0,0,5,0,22,30,1
5987,120282,nWkYRwHsKkKnBVjIvOv2LYBdEyL0lZTL,A3fsA9Zfv1X2fVEQhTw51lKENdNrEqT3,6,9,1,0,1,0,2,0,13,1.8571428571428572,1,0.0,0,1,0,1,9,0,0,2,0,2,11,1
5988,120288,MWFzxiL4ehMt7chFh9qPkkqOh2NLyxIv,bWdj2GDclj5ofokWjzoa5jAwMkxCykd6,2,0,0,0,0,0,2,0,2,0.2857142857142857,1,0.0,0,0,0,0,0,0,0,2,0,0,2,1
5989,120297,7xobbz91DmuqnSowtdCPvlArDkv1wvpY,bWdj2GDclj5ofokWjzoa5jAwMkxCykd6,8,5,1,0,1,1,10,1,19,2.7142857142857144,4,0.0,0,1,0,1,5,1,0,10,1,2,17,0
5990,120300,8ZCGZdwxBMJVwPZ7vVYEdVzHcXfqVToG,SpATywNh6bZuzm8s1ceuBUnMUAeoAHHw,26,29,7,39,4,24,14,3,120,17.142857142857142,2,0.0,9,7,34,4,20,24,5,14,3,54,66,1
5991,120301,R65nId6muEQL5ltvz9x70wBSJAG43Ylw,SpATywNh6bZuzm8s1ceuBUnMUAeoAHHw,1,0,0,0,0,0,1,0,1,0.14285714285714285,1,0.0,0,0,0,0,0,0,0,1,0,0,1,1
5992,120312,1cbn6mbdbvkgaRHmtNkyztYkaJcKUMeq,A3fsA9Zfv1X2fVEQhTw51lKENdNrEqT3,26,6,4,88,1,0,9,0,108,15.428571428571429,2,0.0,2,4,73,1,4,0,15,9,0,80,28,1
5993,120319,SslryCWQFxjgJq7Qzkpxu4WYyOvHjfIA,SpATywNh6bZuzm8s1ceuBUnMUAeoAHHw,12,19,0,10,0,0,5,0,34,4.857142857142857,2,0.0,2,0,9,0,17,0,1,5,0,11,23,1
5994,120324,BFpj8Vxul230N4kCbxR9rjWJ12ZQLtAV,RXDvfPUBYFlVdlueBFbLW0mhhAyGEqpt,12,30,1,0,2,0,7,1,41,5.857142857142857,3,0.0,2,1,0,2,28,0,0,7,1,5,36,0
5995,120327,gxxdbeVvaQEKyOVBSC4fF8ei2zEnQClv,SpATywNh6bZuzm8s1ceuBUnMUAeoAHHw,7,3,3,0,2,0,3,0,11,1.5714285714285714,1,0.0,0,3,0,2,3,0,0,3,0,5,6,1
5996,120357,v5FeWqSlnditqY6z5ibAMUPKlbcY2Zcg,bWdj2GDclj5ofokWjzoa5jAwMkxCykd6,1,0,0,0,0,0,1,0,1,0.14285714285714285,1,0.0,0,0,0,0,0,0,0,1,0,0,1,1
5997,120395,jFlacyEy6lTVCBjW1JtG8q0M3te6pg5n,RXDvfPUBYFlVdlueBFbLW0mhhAyGEqpt,4,3,2,0,1,0,1,0,7,1.0,1,0.0,0,2,0,1,3,0,0,1,0,3,4,1
5998,120424,PazYalgu71qbC99y9FrRjNpcniWiR2x1,RXDvfPUBYFlVdlueBFbLW0mhhAyGEqpt,11,5,4,0,2,0,4,1,16,2.2857142857142856,1,0.0,0,4,0,2,5,0,0,4,1,6,10,1
5999,120452,5PCeecJ7dPIRTUfiwjNNMWT45OJxiKsA,SpATywNh6bZuzm8s1ceuBUnMUAeoAHHw,24,37,19,43,7,0,5,0,111,15.857142857142858,3,0.0,13,19,34,7,24,0,9,5,0,73,38,1
6000,120497,pb5Jjq3Ash9pKloUfJAc3dsHOjXwUSUN,SpATywNh6bZuzm8s1ceuBUnMUAeoAHHw,4,8,0,0,0,0,5,0,13,1.8571428571428572,3,0.0,0,0,0,0,8,0,0,5,0,0,13,1
6001,120499,5scsz5bGh8T1roTXhO7UpMXlEDKIsK9l,SpATywNh6bZuzm8s1ceuBUnMUAeoAHHw,19,28,10,17,5,7,7,1,75,10.714285714285714,3,0.0,10,10,15,5,18,7,2,7,1,40,35,1
6002,120528,QHRLeTLFcpDFqErTvT3KvB62zPnO9tRZ,SpATywNh6bZuzm8s1ceuBUnMUAeoAHHw,4,4,0,0,0,0,1,0,5,0.7142857142857143,1,0.0,0,0,0,0,4,0,0,1,0,0,5,1
6003,120544,OektSQ9TNN3cEy3ZKuUs35c7BdSOqtaQ,bWdj2GDclj5ofokWjzoa5jAwMkxCykd6,7,11,6,0,1,0,9,0,27,3.857142857142857,2,0.0,0,6,0,1,11,0,0,9,0,7,20,1
6004,120579,s7QoBInBc5uVUNfTUCWn8dY2DMQUeNQJ,SpATywNh6bZuzm8s1ceuBUnMUAeoAHHw,6,1,1,0,1,1,3,1,8,1.1428571428571428,1,0.0,0,1,0,1,1,1,0,3,1,2,6,1
6005,120583,cOTtp4pVPpt9GEFdMZaLCIG1IBXouqo8,SpATywNh6bZuzm8s1ceuBUnMUAeoAHHw,2,0,0,0,0,0,2,0,2,0.2857142857142857,1,0.0,0,0,0,0,0,0,0,2,0,0,2,1
6006,120613,o5eh9IEuVj6wwGOFQd5A60hJwFcyh5aW,SpATywNh6bZuzm8s1ceuBUnMUAeoAHHw,2,0,0,0,0,0,2,0,2,0.2857142857142857,1,0.0,0,0,0,0,0,0,0,2,0,0,2,1
6007,120641,bVdTa6NU9Mptus5JV6dyU7pKOHw1EO1M,bWdj2GDclj5ofokWjzoa5jAwMkxCykd6,1,0,0,0,0,0,1,0,1,0.14285714285714285,1,0.0,0,0,0,0,0,0,0,1,0,0,1,1
6008,120666,NTsLMBrSdSgh32E5eAwn0TyewK2E1eGS,A3fsA9Zfv1X2fVEQhTw51lKENdNrEqT3,1,0,0,0,0,0,1,0,1,0.14285714285714285,1,0.0,0,0,0,0,0,0,0,1,0,0,1,1
6009,120674,cR6ka5k7tAsfYo9cLOUPkpzWO6OItcGJ,G8EPVSXsOYB5YQWZGiz1aVq5Pgr2GrQu,29,30,24,6,17,0,7,0,84,12.0,3,0.0,0,24,5,17,30,0,1,7,0,46,38,1
6010,120675,CaJSrSiICAfSlo2FFV44vmQh9prPvDrE,A3fsA9Zfv1X2fVEQhTw51lKENdNrEqT3,12,12,5,0,3,0,6,0,26,3.7142857142857144,1,0.0,0,5,0,3,12,0,0,6,0,8,18,1
6011,120686,u5ObOMoHUcvVsOQTGkiv0BRKKcn8v2w8,bWdj2GDclj5ofokWjzoa5jAwMkxCykd6,4,2,1,0,1,0,1,0,5,0.7142857142857143,1,0.0,0,1,0,1,2,0,0,1,0,2,3,1
6012,120697,FJyrOX14z7chWU6pIsUghN5yUhlIZ5Lj,SpATywNh6bZuzm8s1ceuBUnMUAeoAHHw,3,2,0,0,0,0,2,0,4,0.5714285714285714,1,0.0,0,0,0,0,2,0,0,2,0,0,4,0
6013,120703,4dodDlxC4kpDOhgavFhn4UZKBioEfZ2a,SpATywNh6bZuzm8s1ceuBUnMUAeoAHHw,17,46,2,20,2,18,37,5,130,18.571428571428573,4,0.0,25,2,17,2,21,18,3,37,5,46,84,1
6014,120716,RhtPF62U20vYvwTeCimLFb40aCkmO2cH,SpATywNh6bZuzm8s1ceuBUnMUAeoAHHw,5,2,1,0,1,0,2,0,6,0.8571428571428571,1,0.0,0,1,0,1,2,0,0,2,0,2,4,1
6015,120722,1R1zO9aMB7Mx1Lw84JzsChVEV5JpwmZv,G8EPVSXsOYB5YQWZGiz1aVq5Pgr2GrQu,75,113,21,166,17,12,26,0,355,50.714285714285715,10,0.0,37,21,121,17,76,12,45,26,0,196,159,1
6016,120751,fTZGf1uwMtb2LTyvoTILgCp8LRW0SKIe,RXDvfPUBYFlVdlueBFbLW0mhhAyGEqpt,11,21,9,18,8,0,1,0,57,8.142857142857142,4,0.0,9,9,15,8,12,0,3,1,0,41,16,1
6017,120759,yTPVosjRFgkyQAyVowXjYrsQYKByzY4B,A3fsA9Zfv1X2fVEQhTw51lKENdNrEqT3,20,19,1,56,0,29,7,1,113,16.142857142857142,3,0.0,4,1,44,0,15,29,12,7,1,49,64,1
6018,120771,IvdoAzckjyWWCkzCy6V0BjWvOwMyZEwg,bWdj2GDclj5ofokWjzoa5jAwMkxCykd6,30,36,20,63,8,14,22,2,165,23.571428571428573,7,0.0,7,20,62,8,29,14,1,22,2,97,68,1
6019,120774,7hx1Kw9WXBMDyaoF5WfFzTdCBmNZ2uMk,SpATywNh6bZuzm8s1ceuBUnMUAeoAHHw,26,66,12,18,6,20,39,4,165,23.571428571428573,7,0.0,18,12,15,6,48,20,3,39,4,51,114,1
6020,120788,qwhxcjW9iIMBAQoGSWDtst34AFkcFQoV,G8EPVSXsOYB5YQWZGiz1aVq5Pgr2GrQu,6,6,3,0,0,0,4,0,13,1.8571428571428572,2,0.0,0,3,0,0,6,0,0,4,0,3,10,0
6021,120808,OTAUIgoWBEWsq2kd8lnvB0dKpj3SXEdR,SpATywNh6bZuzm8s1ceuBUnMUAeoAHHw,22,31,16,16,7,22,12,2,106,15.142857142857142,4,0.0,12,16,15,7,19,22,1,12,2,50,56,1
6022,120815,qwhxcjW9iIMBAQoGSWDtst34AFkcFQoV,A3fsA9Zfv1X2fVEQhTw51lKENdNrEqT3,10,19,9,0,1,1,6,0,36,5.142857142857143,3,0.0,0,9,0,1,19,1,0,6,0,10,26,0
6023,120818,hn9Zjyg7I7mBsVCg91jyZTDh6RPM5yRT,G8EPVSXsOYB5YQWZGiz1aVq5Pgr2GrQu,2,0,0,0,0,0,3,0,3,0.42857142857142855,3,0.0,0,0,0,0,0,0,0,3,0,0,3,0
6024,120824,tCQ9JALurTpI0v0jgUfmOoOzw21YvN4S,SpATywNh6bZuzm8s1ceuBUnMUAeoAHHw,1,0,0,0,0,0,1,0,1,0.14285714285714285,1,0.0,0,0,0,0,0,0,0,1,0,0,1,1
6025,120835,EaFWRMbtKR52j7nbPydGVwuzgPsml9aN,A3fsA9Zfv1X2fVEQhTw51lKENdNrEqT3,12,13,7,2,0,7,19,1,49,7.0,4,0.0,0,7,2,0,13,7,0,19,1,9,40,1
6026,120839,A1aBNAF3YIuzOOCwNaMQAGMwKE189BXm,bWdj2GDclj5ofokWjzoa5jAwMkxCykd6,6,5,1,38,2,0,2,0,48,6.857142857142857,1,0.0,3,1,36,2,2,0,2,2,0,42,6,1
6027,120845,W8fFTJpe1dBAUeFKonCjFttbIjzEdynN,bWdj2GDclj5ofokWjzoa5jAwMkxCykd6,1,0,0,0,0,0,1,0,1,0.14285714285714285,1,0.0,0,0,0,0,0,0,0,1,0,0,1,1
6028,120853,DPc69RrqfbFv98j4qSzKI4WCbxWESHfA,SpATywNh6bZuzm8s1ceuBUnMUAeoAHHw,5,2,1,0,1,0,2,0,6,0.8571428571428571,1,0.0,0,1,0,1,2,0,0,2,0,2,4,1
6029,120854,fl8sEptrcl2JvFWXejFcnsM7BqWtKl9w,A3fsA9Zfv1X2fVEQhTw51lKENdNrEqT3,7,5,1,0,1,0,4,0,11,1.5714285714285714,2,0.0,0,1,0,1,5,0,0,4,0,2,9,1
6030,120861,bRG3KNKPz8MtEb5G1Duc4i5IiNMa8ZLU,G8EPVSXsOYB5YQWZGiz1aVq5Pgr2GrQu,5,4,1,0,0,0,1,0,6,0.8571428571428571,1,0.0,0,1,0,0,4,0,0,1,0,1,5,1
6031,120866,mVNF27p0nlEqUBMpiQFD5RxVmxKtsSbe,bWdj2GDclj5ofokWjzoa5jAwMkxCykd6,1,0,0,0,0,0,1,0,1,0.14285714285714285,1,0.0,0,0,0,0,0,0,0,1,0,0,1,1
6032,120891,ABAPRQWSFErhHUFQsJmCoj4Rpg4DtQ8w,A3fsA9Zfv1X2fVEQhTw51lKENdNrEqT3,13,44,20,0,13,0,10,0,87,12.428571428571429,2,0.0,1,20,0,13,43,0,0,10,0,34,53,1
6033,120892,pAkhnLI0s5vboktZycO7Tobv6jbspULh,SpATywNh6bZuzm8s1ceuBUnMUAeoAHHw,19,26,15,0,9,0,11,0,61,8.714285714285714,9,0.0,0,15,0,9,26,0,0,11,0,24,37,1
6034,120894,dQweEcdBCmNmUPOeO7X4TTmH8zuMq2aJ,A3fsA9Zfv1X2fVEQhTw51lKENdNrEqT3,13,19,9,0,2,7,13,0,50,7.142857142857143,4,0.0,1,9,0,2,18,7,0,13,0,12,38,1
6035,120906,Z9nbZek76s4RBuA56w1WtME3e9ClZkaP,A3fsA9Zfv1X2fVEQhTw51lKENdNrEqT3,41,28,21,58,11,16,5,1,140,20.0,3,0.0,1,21,50,11,27,16,8,5,1,83,57,0
6036,120907,m83RtezfCwMfEmG0rXtpbc1svhl7ugt0,SpATywNh6bZuzm8s1ceuBUnMUAeoAHHw,4,3,1,0,1,0,1,0,6,0.8571428571428571,1,0.0,0,1,0,1,3,0,0,1,0,2,4,1
6037,120909,aldLXGpzmiip2CUSDhqN8A5UpGMVUHxY,A3fsA9Zfv1X2fVEQhTw51lKENdNrEqT3,68,49,36,116,11,0,16,0,228,32.57142857142857,10,0.0,4,36,110,11,45,0,6,16,0,161,67,0
6038,120915,i8nJS6rmQ6UIbavrvT6pTvkCZLUx9z01,SpATywNh6bZuzm8s1ceuBUnMUAeoAHHw,3,4,0,0,0,0,1,0,5,0.7142857142857143,1,0.0,0,0,0,0,4,0,0,1,0,0,5,1
6039,120928,sApH95kwlTdIi3RvuRD74A0dFhVPKais,SpATywNh6bZuzm8s1ceuBUnMUAeoAHHw,9,14,4,0,3,2,8,0,31,4.428571428571429,2,0.0,0,4,0,3,14,2,0,8,0,7,24,1
6040,120930,fHz7VQRoJHHTDfRPDpvJLuPlruuvrNnm,SpATywNh6bZuzm8s1ceuBUnMUAeoAHHw,23,30,1,29,1,0,12,0,73,10.428571428571429,2,0.0,11,1,26,1,19,0,3,12,0,39,34,1
6041,120937,qVkkNycc5Psi9bXy8jDUR44I6IjXsj9g,bWdj2GDclj5ofokWjzoa5jAwMkxCykd6,2,0,0,0,0,0,2,0,2,0.2857142857142857,1,0.0,0,0,0,0,0,0,0,2,0,0,2,1
6042,120944,jcYhugRahKquP2fynVIQQrbdtwxaAHse,G8EPVSXsOYB5YQWZGiz1aVq5Pgr2GrQu,1,0,0,0,0,0,1,0,1,0.14285714285714285,1,0.0,0,0,0,0,0,0,0,1,0,0,1,1
6043,120949,ONK0Esb7fhLc69POI06k3Sj1alNC6Fij,SpATywNh6bZuzm8s1ceuBUnMUAeoAHHw,16,17,7,14,5,8,17,0,68,9.714285714285714,7,0.0,9,7,13,5,8,8,1,17,0,34,34,0
6044,120966,JCDOEMgsanA2Wd8RJtg9ctpT52Gae7ak,bWdj2GDclj5ofokWjzoa5jAwMkxCykd6,7,8,2,0,1,0,5,0,16,2.2857142857142856,2,0.0,0,2,0,1,8,0,0,5,0,3,13,0
6045,120973,VsZvGrXbL1e6v6hmpJQH8MldIkCBO9P7,RXDvfPUBYFlVdlueBFbLW0mhhAyGEqpt,73,120,38,192,23,12,27,15,427,61.0,5,0.0,27,38,181,23,93,12,11,27,15,269,158,0
6046,120975,KjHOE07fI9pBFKqiwhrvCwjITj7tyFWN,G8EPVSXsOYB5YQWZGiz1aVq5Pgr2GrQu,34,37,18,12,14,0,20,1,102,14.571428571428571,4,0.0,9,18,10,14,28,0,2,20,1,51,51,1
6047,120979,VsZvGrXbL1e6v6hmpJQH8MldIkCBO9P7,A3fsA9Zfv1X2fVEQhTw51lKENdNrEqT3,63,52,25,132,14,4,22,1,250,35.714285714285715,4,0.0,1,25,119,14,51,4,13,22,1,159,91,1
6048,120982,JBjDnQZVwVLGdsvKJqTw57nrx9uYY0vn,A3fsA9Zfv1X2fVEQhTw51lKENdNrEqT3,9,30,1,0,1,0,6,0,38,5.428571428571429,3,0.0,0,1,0,1,30,0,0,6,0,2,36,0
6049,120999,evts3oSRq3OSuFymJPKdix8vzAStq0uA,G8EPVSXsOYB5YQWZGiz1aVq5Pgr2GrQu,2,0,0,0,0,0,2,0,2,0.2857142857142857,1,0.0,0,0,0,0,0,0,0,2,0,0,2,1
6050,121006,fiuPlQpFhdwy7ZB3d9YZTvFtxVmpTcZ2,SpATywNh6bZuzm8s1ceuBUnMUAeoAHHw,8,10,1,0,1,0,6,0,18,2.5714285714285716,2,0.0,0,1,0,1,10,0,0,6,0,2,16,1
6051,121019,bA4tnPZD0UU4XAL3OkL7nUjtkAzbgj9d,A3fsA9Zfv1X2fVEQhTw51lKENdNrEqT3,6,8,5,0,1,0,2,0,16,2.2857142857142856,2,0.0,1,5,0,1,7,0,0,2,0,7,9,1
6052,121023,TzRDOFjVsHxcJLvrJENTAv7iaJPhFHB5,SpATywNh6bZuzm8s1ceuBUnMUAeoAHHw,10,5,4,0,3,0,2,0,14,2.0,2,0.0,0,4,0,3,5,0,0,2,0,7,7,1
6053,121044,KkBPwixR7onoXlZ2HnK8cYokgUE3P396,A3fsA9Zfv1X2fVEQhTw51lKENdNrEqT3,1,0,0,0,0,0,1,0,1,0.14285714285714285,1,0.0,0,0,0,0,0,0,0,1,0,0,1,1
6054,121048,nwFT4lnmg30fCvHRB6tbALo9FpcanuLx,bWdj2GDclj5ofokWjzoa5jAwMkxCykd6,7,6,2,0,2,0,4,0,14,2.0,3,0.0,0,2,0,2,6,0,0,4,0,4,10,0
6055,121066,gV1Y6A8RpgDuAD47r6UGF54v9TD2f7uU,bWdj2GDclj5ofokWjzoa5jAwMkxCykd6,6,3,1,0,1,0,2,0,7,1.0,1,0.0,0,1,0,1,3,0,0,2,0,2,5,1
6056,121100,8mYFryxeRH8GSnHog9hmhUPRk60LCyFI,SpATywNh6bZuzm8s1ceuBUnMUAeoAHHw,14,18,15,0,7,0,10,0,50,7.142857142857143,3,0.0,0,15,0,7,18,0,0,10,0,22,28,1
6057,121105,M8ur292SdHouJ1LnQyJMDkHJM5sUPxnX,SpATywNh6bZuzm8s1ceuBUnMUAeoAHHw,19,38,3,3,4,0,8,0,56,8.0,5,0.0,6,3,3,4,32,0,0,8,0,16,40,0
6058,121134,4IxaKtzWvkfFEFZ43UhJQOyIahcBxrF2,SpATywNh6bZuzm8s1ceuBUnMUAeoAHHw,23,43,3,26,1,0,9,0,82,11.714285714285714,5,0.0,4,3,23,1,39,0,3,9,0,31,51,1
6059,121136,kHp5QZURLzbWn4koqFYZnQmO0kliz5hb,SpATywNh6bZuzm8s1ceuBUnMUAeoAHHw,28,37,18,20,11,3,4,0,93,13.285714285714286,5,0.0,11,18,17,11,26,3,3,4,0,57,36,1
6060,121174,BK9rzOWePcPYHbJ23OB9suKImXFOyhRl,bWdj2GDclj5ofokWjzoa5jAwMkxCykd6,10,8,1,0,1,5,9,4,28,4.0,1,0.0,0,1,0,1,8,5,0,9,4,2,26,1
6061,121191,MbmumbK7FHZlEn2oNe4YMQEQzBas1u6w,bWdj2GDclj5ofokWjzoa5jAwMkxCykd6,15,27,13,6,7,6,12,2,73,10.428571428571429,3,0.0,4,13,5,7,23,6,1,12,2,29,44,0
6062,121196,VdaBmv5ItdWz4RwMA62FKAWjG3bRe1Fn,SpATywNh6bZuzm8s1ceuBUnMUAeoAHHw,4,3,1,0,1,0,1,0,6,0.8571428571428571,1,0.0,0,1,0,1,3,0,0,1,0,2,4,1
6063,121216,kepzW866hAW80jPanDRXCDYAup0gf1qr,bWdj2GDclj5ofokWjzoa5jAwMkxCykd6,4,2,1,0,1,0,1,0,5,0.7142857142857143,1,0.0,0,1,0,1,2,0,0,1,0,2,3,0
6064,121220,XOhs3C3hEbYCXLCkazKW0gKNbUWn1jg2,SpATywNh6bZuzm8s1ceuBUnMUAeoAHHw,8,6,3,0,3,0,4,0,16,2.2857142857142856,1,0.0,0,3,0,3,6,0,0,4,0,6,10,1
6065,121271,GAKCidUQ8hdeh0WMwEYlK9cUZXNPRN5R,SpATywNh6bZuzm8s1ceuBUnMUAeoAHHw,7,2,1,0,1,0,7,1,12,1.7142857142857142,2,0.0,0,1,0,1,2,0,0,7,1,2,10,1
6066,121284,Sb4VRiha9yR6Zwo717x7pWDjO7cnV2Bc,A3fsA9Zfv1X2fVEQhTw51lKENdNrEqT3,2,0,0,0,0,0,2,0,2,0.2857142857142857,1,0.0,0,0,0,0,0,0,0,2,0,0,2,1
6067,121303,33pzyjn4blqUcVq0e7rGSyVoVXsnplTp,SpATywNh6bZuzm8s1ceuBUnMUAeoAHHw,5,1,1,0,1,0,3,0,6,0.8571428571428571,1,0.0,0,1,0,1,1,0,0,3,0,2,4,1
6068,121304,WOGsOMHGMnkSlS91ohBsyVdWGOJVOnT1,G8EPVSXsOYB5YQWZGiz1aVq5Pgr2GrQu,2,0,0,0,0,0,2,0,2,0.2857142857142857,1,0.0,0,0,0,0,0,0,0,2,0,0,2,1
6069,121313,VrcAU2QLiPqVHHKHjhnkgJoQe1xmnYFr,SpATywNh6bZuzm8s1ceuBUnMUAeoAHHw,4,2,1,0,1,0,1,0,5,0.7142857142857143,1,0.0,0,1,0,1,2,0,0,1,0,2,3,1
6070,121328,o1wU0MfzmEznHSZOZDS8DejIhVczhoMt,A3fsA9Zfv1X2fVEQhTw51lKENdNrEqT3,1,0,0,0,0,0,3,0,3,0.42857142857142855,2,0.0,0,0,0,0,0,0,0,3,0,0,3,1
6071,121330,o1wU0MfzmEznHSZOZDS8DejIhVczhoMt,bWdj2GDclj5ofokWjzoa5jAwMkxCykd6,1,0,0,0,0,0,4,0,4,0.5714285714285714,2,0.0,0,0,0,0,0,0,0,4,0,0,4,1
6072,121339,oKz0rKWQtHW8DkPwxTgdemWb21NvE4BO,SpATywNh6bZuzm8s1ceuBUnMUAeoAHHw,24,35,1,35,0,10,9,0,90,12.857142857142858,4,0.0,17,1,33,0,18,10,2,9,0,51,39,1
6073,121345,ePaTLgBKhclwas3ClxzVVmTCgYzhx4go,SpATywNh6bZuzm8s1ceuBUnMUAeoAHHw,26,50,3,46,0,37,20,0,156,22.285714285714285,5,0.0,14,3,37,0,36,37,9,20,0,54,102,0
6074,121373,HSjT6fK4xHlufEG141acXPeMw5gqxgnK,G8EPVSXsOYB5YQWZGiz1aVq5Pgr2GrQu,6,1,1,0,1,0,3,1,7,1.0,1,0.0,0,1,0,1,1,0,0,3,1,2,5,1
6075,121391,7af3IyECXIPSWoeM4guaEGHMHNE9EYdr,A3fsA9Zfv1X2fVEQhTw51lKENdNrEqT3,1,0,0,0,0,0,1,0,1,0.14285714285714285,1,0.0,0,0,0,0,0,0,0,1,0,0,1,1
6076,121405,H8Mro2560yUzikYuATdEg57a9V5oxWPK,bWdj2GDclj5ofokWjzoa5jAwMkxCykd6,1,0,0,0,0,0,2,0,2,0.2857142857142857,1,0.0,0,0,0,0,0,0,0,2,0,0,2,1
6077,121415,5tRF7MIiw9rvKGI9GzHJVDzIS50Mqb8o,RXDvfPUBYFlVdlueBFbLW0mhhAyGEqpt,32,43,3,50,3,0,7,0,106,15.142857142857142,3,0.0,9,3,46,3,34,0,4,7,0,61,45,1
6078,121424,vthDe5chpuGwbDUyc90EI2Y8jHRBb15H,bWdj2GDclj5ofokWjzoa5jAwMkxCykd6,4,2,1,0,1,0,1,0,5,0.7142857142857143,1,0.0,0,1,0,1,2,0,0,1,0,2,3,1
6079,121438,3w2Xuq08gulsgNUr7oA3MOaceNv4Akte,bWdj2GDclj5ofokWjzoa5jAwMkxCykd6,15,27,11,50,7,5,7,0,107,15.285714285714286,3,0.0,8,11,46,7,19,5,4,7,0,72,35,1
6080,121446,Haz3G1DnETqwzmdUg5ALbCZo1Lv5wDs9,SpATywNh6bZuzm8s1ceuBUnMUAeoAHHw,28,30,19,30,10,3,8,0,100,14.285714285714286,5,0.0,6,19,27,10,24,3,3,8,0,62,38,1
6081,121452,NoyfNn91CGqIll5CyV3XCcTClgT3U7jT,A3fsA9Zfv1X2fVEQhTw51lKENdNrEqT3,2,0,0,0,0,0,2,0,2,0.2857142857142857,1,0.0,0,0,0,0,0,0,0,2,0,0,2,1
6082,121455,I8yPwCESlVyB1LCVpuWYAkN68pAAeUAB,G8EPVSXsOYB5YQWZGiz1aVq5Pgr2GrQu,4,3,2,0,2,0,1,0,8,1.1428571428571428,1,0.0,0,2,0,2,3,0,0,1,0,4,4,1
6083,121473,kEe7j5p6NF8FFSn6q8Y544hGSIcyGGey,G8EPVSXsOYB5YQWZGiz1aVq5Pgr2GrQu,1,0,0,0,0,0,1,0,1,0.14285714285714285,1,0.0,0,0,0,0,0,0,0,1,0,0,1,1
6084,121532,OUbh6hvaOJDp9RK7kgTBzzPmjzmkYhZF,A3fsA9Zfv1X2fVEQhTw51lKENdNrEqT3,57,33,0,190,0,2,11,1,237,33.857142857142854,2,0.0,2,0,171,0,31,2,19,11,1,173,64,1
6085,121540,Ys7L3fRt7UujHv4RzbntGwrrv6Omn2bm,A3fsA9Zfv1X2fVEQhTw51lKENdNrEqT3,11,3,2,0,2,0,7,1,15,2.142857142857143,1,0.0,0,2,0,2,3,0,0,7,1,4,11,1
6086,121576,RPsysYLHG9V8ibC4agPmUkz49odzJ61i,SpATywNh6bZuzm8s1ceuBUnMUAeoAHHw,25,22,6,20,4,11,4,0,67,9.571428571428571,2,0.0,5,6,18,4,17,11,2,4,0,33,34,0
6087,121625,ZULomXsITwM6vNxcJN8imzU1pyfKn8Cw,A3fsA9Zfv1X2fVEQhTw51lKENdNrEqT3,14,10,8,0,6,0,3,0,27,3.857142857142857,1,0.0,0,8,0,6,10,0,0,3,0,14,13,1
6088,121656,aVeyGdrz6Ir4LmiLkJqBoRjG1lQ7MsV8,bWdj2GDclj5ofokWjzoa5jAwMkxCykd6,37,83,35,84,5,2,22,1,232,33.142857142857146,11,0.0,17,35,72,5,66,2,12,22,1,129,103,0
6089,121711,5U79KRZxDDBIetuxjK0KXphUhzbxTzjr,A3fsA9Zfv1X2fVEQhTw51lKENdNrEqT3,12,7,5,0,1,0,9,1,23,3.2857142857142856,2,0.0,0,5,0,1,7,0,0,9,1,6,17,1
6090,121712,zdC6SE3iIVhpYTGT1Ftflp0F2V48NqFq,SpATywNh6bZuzm8s1ceuBUnMUAeoAHHw,32,71,26,24,9,3,18,1,152,21.714285714285715,5,0.0,29,26,23,9,42,3,1,18,1,87,65,1
6091,121721,RNEuStAlTxZHIZFwvfCfasMOM5Hny2Pn,SpATywNh6bZuzm8s1ceuBUnMUAeoAHHw,7,12,4,0,4,0,7,0,27,3.857142857142857,3,0.0,0,4,0,4,12,0,0,7,0,8,19,1
6092,121728,VeR8jO0l4tKfTebOc6UlIMBBM4qQ6Yxm,bWdj2GDclj5ofokWjzoa5jAwMkxCykd6,4,2,0,0,0,0,3,0,5,0.7142857142857143,1,0.0,0,0,0,0,2,0,0,3,0,0,5,1
6093,121730,qCS1MIh1oAUEDPfrxnKYyGX5hZIJFt3C,bWdj2GDclj5ofokWjzoa5jAwMkxCykd6,1,0,0,0,0,0,1,0,1,0.14285714285714285,1,0.0,0,0,0,0,0,0,0,1,0,0,1,1
6094,121731,wBp63rzsgy2LzOR2gkxDj87VT9Ja70XK,SpATywNh6bZuzm8s1ceuBUnMUAeoAHHw,30,37,18,42,8,18,18,3,144,20.571428571428573,2,0.0,11,18,35,8,26,18,7,18,3,72,72,1
6095,121738,V6LNlp0n6EiMGFhm98i6D7Pk9T5LWptM,SpATywNh6bZuzm8s1ceuBUnMUAeoAHHw,7,12,6,0,3,0,3,0,24,3.4285714285714284,2,0.0,0,6,0,3,12,0,0,3,0,9,15,1
6096,121743,bFBipIvg3ynAbrvo3mXNRP6i8NWVQRYx,A3fsA9Zfv1X2fVEQhTw51lKENdNrEqT3,16,13,9,0,5,2,17,3,49,7.0,2,0.0,1,9,0,5,12,2,0,17,3,15,34,1
6097,121746,bFBipIvg3ynAbrvo3mXNRP6i8NWVQRYx,bWdj2GDclj5ofokWjzoa5jAwMkxCykd6,10,13,5,46,4,5,7,1,81,11.571428571428571,1,0.0,5,5,45,4,8,5,1,7,1,59,22,1
6098,121766,EbdsJCzME79IdKcgnIKOnAggJJmkpV77,G8EPVSXsOYB5YQWZGiz1aVq5Pgr2GrQu,30,31,24,34,18,0,8,0,115,16.428571428571427,4,0.0,3,24,25,18,28,0,9,8,0,70,45,0
6099,121768,Zt3P4JGoAgyqFxw766ynWY30ef3EfJ1u,SpATywNh6bZuzm8s1ceuBUnMUAeoAHHw,20,31,11,26,4,10,14,2,98,14.0,2,0.0,15,11,23,4,16,10,3,14,2,53,45,0
6100,121771,mfnQ4udtiPturvDlSRmiBQpHTrOVoPze,G8EPVSXsOYB5YQWZGiz1aVq5Pgr2GrQu,5,2,1,0,1,0,2,0,6,0.8571428571428571,1,0.0,0,1,0,1,2,0,0,2,0,2,4,1
6101,121772,rwS7FTXVRFYQBGZ8fdPbUhnEsoTUJSWr,SpATywNh6bZuzm8s1ceuBUnMUAeoAHHw,6,3,2,0,1,0,3,0,9,1.2857142857142858,1,0.0,0,2,0,1,3,0,0,3,0,3,6,1
6102,121776,sOhMuZ2KPBl6wLWzfGcWvrQoSfIarVJv,SpATywNh6bZuzm8s1ceuBUnMUAeoAHHw,5,2,1,0,1,0,3,0,7,1.0,2,0.0,0,1,0,1,2,0,0,3,0,2,5,1
6103,121780,0P5PalAjTetGhnhGgd58OrrRVeAS6i1x,A3fsA9Zfv1X2fVEQhTw51lKENdNrEqT3,13,8,7,0,5,0,2,0,22,3.142857142857143,1,0.0,0,7,0,5,8,0,0,2,0,12,10,1
6104,121789,XC5tRBKME8ONyczymYjZjR1MyrCYegPM,G8EPVSXsOYB5YQWZGiz1aVq5Pgr2GrQu,27,50,16,56,7,1,3,0,133,19.0,2,0.0,31,16,44,7,19,1,12,3,0,98,35,0
6105,121824,VmpOwZ3zs5p6NuGKzo8TbAiFkD0EdD5q,SpATywNh6bZuzm8s1ceuBUnMUAeoAHHw,1,0,0,0,0,0,1,0,1,0.14285714285714285,1,0.0,0,0,0,0,0,0,0,1,0,0,1,1
6106,121827,LPuVvdpKRDBdr0DGqQ4yh9fw0WfNvnkW,SpATywNh6bZuzm8s1ceuBUnMUAeoAHHw,6,9,0,0,0,0,5,0,14,2.0,2,0.0,0,0,0,0,9,0,0,5,0,0,14,1
6107,121829,gOODBz9FfXPZcnKA2RT49UqbScA5gVkT,SpATywNh6bZuzm8s1ceuBUnMUAeoAHHw,14,16,10,0,6,0,4,0,36,5.142857142857143,2,0.0,0,10,0,6,16,0,0,4,0,16,20,1
6108,121870,iY0UWsKzM76w2sBfvkSz2A0A6313cEPM,SpATywNh6bZuzm8s1ceuBUnMUAeoAHHw,25,31,9,13,4,0,3,0,60,8.571428571428571,3,0.0,7,9,12,4,24,0,1,3,0,32,28,1
6109,121881,PUdcV8hfT4fAKFK5ZdHY1Ahxf6WKmDC8,bWdj2GDclj5ofokWjzoa5jAwMkxCykd6,5,3,1,0,1,0,2,0,7,1.0,1,0.0,0,1,0,1,3,0,0,2,0,2,5,1
6110,121915,QQOQ1mBFT0hbDG4vhxUnw8WQ7hq3XsN0,SpATywNh6bZuzm8s1ceuBUnMUAeoAHHw,19,19,13,3,10,0,2,0,47,6.714285714285714,2,0.0,3,13,3,10,16,0,0,2,0,29,18,1
6111,121927,7HtfIn2KlQH9UsbhFgGhveKOzfNOg6MC,SpATywNh6bZuzm8s1ceuBUnMUAeoAHHw,5,3,2,0,1,0,1,0,7,1.0,1,0.0,0,2,0,1,3,0,0,1,0,3,4,1
6112,121945,sTlxlEkJ3MbMUAeSajnaHOGfpyW9hgq1,RXDvfPUBYFlVdlueBFbLW0mhhAyGEqpt,5,3,1,0,1,0,2,0,7,1.0,1,0.0,0,1,0,1,3,0,0,2,0,2,5,1
6113,121953,ahM4WE7sAySvmZ0R8lWqo09z8fOCvKFZ,SpATywNh6bZuzm8s1ceuBUnMUAeoAHHw,11,10,4,0,2,1,12,1,30,4.285714285714286,3,0.0,3,4,0,2,7,1,0,12,1,9,21,1
6114,121987,8FfbeT2vcqiuyS9VPg4k7f5KonVLWvGH,A3fsA9Zfv1X2fVEQhTw51lKENdNrEqT3,14,5,0,12,0,1,8,1,27,3.857142857142857,1,0.0,0,0,12,0,5,1,0,8,1,12,15,1
6115,121994,u5RnzaYe9alTOldsdopsRhwom5jR9n5h,SpATywNh6bZuzm8s1ceuBUnMUAeoAHHw,5,2,1,0,1,0,3,0,7,1.0,1,0.0,0,1,0,1,2,0,0,3,0,2,5,1
6116,121997,qkTj1KHhnruIpJto1LtBmn4usHKfmPXZ,G8EPVSXsOYB5YQWZGiz1aVq5Pgr2GrQu,16,9,9,32,5,0,2,0,57,8.142857142857142,1,0.0,0,9,29,5,9,0,3,2,0,43,14,1
6117,122003,s25WPHgkqnodCLzw3vLGSH1CPEjHMBJ5,A3fsA9Zfv1X2fVEQhTw51lKENdNrEqT3,6,5,1,0,1,0,2,0,9,1.2857142857142858,2,0.0,0,1,0,1,5,0,0,2,0,2,7,1
6118,122051,PFXaSbylT2XRWmnFTzI7TT06KKEcrU02,SpATywNh6bZuzm8s1ceuBUnMUAeoAHHw,1,0,0,0,0,0,1,0,1,0.14285714285714285,1,0.0,0,0,0,0,0,0,0,1,0,0,1,1
6119,122058,zBcT1Z0xXooVqe1Y23Zi33CckLeXOFNF,A3fsA9Zfv1X2fVEQhTw51lKENdNrEqT3,2,0,0,0,0,0,2,0,2,0.2857142857142857,1,0.0,0,0,0,0,0,0,0,2,0,0,2,1
6120,122069,Cyazs2KNzeLH7rwO0YD9wLQWGHR2SXrB,RXDvfPUBYFlVdlueBFbLW0mhhAyGEqpt,5,8,4,0,1,0,4,0,17,2.4285714285714284,3,0.0,0,4,0,1,8,0,0,4,0,5,12,1
6121,124667,15vqe2Z6zLmyPR70QAa8Kn2V8zhvh9Uk,7GRhBDsirIGkRZBtSMEzNTyDr2JQm4xx,11,6,3,0,1,2,19,1,32,4.571428571428571,4,0.0,0,3,0,1,6,2,0,19,1,4,28,1
6122,124685,qwhxcjW9iIMBAQoGSWDtst34AFkcFQoV,7GRhBDsirIGkRZBtSMEzNTyDr2JQm4xx,9,23,10,4,2,0,7,0,46,6.571428571428571,5,0.0,1,10,3,2,22,0,1,7,0,16,30,0
6123,124687,eQeAZJfAlQDBFNhBayGkUGtYxXtMJqJ1,7GRhBDsirIGkRZBtSMEzNTyDr2JQm4xx,50,172,61,57,39,26,20,0,375,53.57142857142857,3,0.0,88,61,45,39,84,26,12,20,0,233,142,1
6124,124688,MTBFJm3bIEaE6OQdIPJiDEIIoJhDDIeA,7GRhBDsirIGkRZBtSMEzNTyDr2JQm4xx,33,36,12,33,19,3,14,0,117,16.714285714285715,4,0.0,16,12,31,19,20,3,2,14,0,78,39,0
6125,124719,s1zoJG6TsTv8LP9PRWCYbeiv4OLIivpy,7GRhBDsirIGkRZBtSMEzNTyDr2JQm4xx,6,2,1,0,1,0,4,0,8,1.1428571428571428,2,0.0,0,1,0,1,2,0,0,4,0,2,6,1
6126,124723,pyk8IpgYoJC2oe3kCohOVZ3WNjOmgeaA,7GRhBDsirIGkRZBtSMEzNTyDr2JQm4xx,53,78,24,84,31,2,8,0,227,32.42857142857143,5,0.0,48,24,72,31,30,2,12,8,0,175,52,1
6127,124848,LsB37SHCi56YIWKTwUYRQPUU0IwClcqd,7GRhBDsirIGkRZBtSMEzNTyDr2JQm4xx,32,47,14,88,9,0,4,0,162,23.142857142857142,4,0.0,13,14,76,9,34,0,12,4,0,112,50,1
6128,124904,x2sgXnRqpzo0sPEyNVV2LCKHGLD7HPOD,7GRhBDsirIGkRZBtSMEzNTyDr2JQm4xx,4,0,0,0,0,0,4,0,4,0.5714285714285714,1,0.0,0,0,0,0,0,0,0,4,0,0,4,0
6129,124923,O4ePTyZvjwNQI9EDfljqO5u6UAawTsHN,7GRhBDsirIGkRZBtSMEzNTyDr2JQm4xx,1,0,0,0,0,0,1,0,1,0.14285714285714285,1,0.0,0,0,0,0,0,0,0,1,0,0,1,1
6130,124975,Z4Ol2MWosmvKrLpBOUDzuhHb0EYhkqtT,7GRhBDsirIGkRZBtSMEzNTyDr2JQm4xx,39,97,36,87,35,4,24,0,283,40.42857142857143,8,0.0,47,36,75,35,50,4,12,24,0,193,90,1
6131,125017,xVQ88VrIuIA75ygDlevnROobNkwcFnsc,7GRhBDsirIGkRZBtSMEzNTyDr2JQm4xx,4,4,1,0,0,0,2,0,7,1.0,2,0.0,0,1,0,0,4,0,0,2,0,1,6,1
6132,125036,CUg5atNUld0AFLgUdvlLcFARmcmAn91I,7GRhBDsirIGkRZBtSMEzNTyDr2JQm4xx,1,0,0,0,0,0,1,0,1,0.14285714285714285,1,0.0,0,0,0,0,0,0,0,1,0,0,1,1
6133,125068,clB9MUAuqkslRUltlqk0A6RGOlCJEK6u,7GRhBDsirIGkRZBtSMEzNTyDr2JQm4xx,2,0,0,0,0,0,2,0,2,0.2857142857142857,1,0.0,0,0,0,0,0,0,0,2,0,0,2,1
6134,125071,PUBGBOFNCd7rxLxHUMk2Fsee5aukfpD6,7GRhBDsirIGkRZBtSMEzNTyDr2JQm4xx,15,17,8,18,3,0,5,1,52,7.428571428571429,2,0.0,3,8,14,3,14,0,4,5,1,28,24,1
6135,125316,zQuOUrw5AhGHdFoJTVTDSPmJiftbKo67,7GRhBDsirIGkRZBtSMEzNTyDr2JQm4xx,2,0,0,0,0,0,2,0,2,0.2857142857142857,1,0.0,0,0,0,0,0,0,0,2,0,0,2,1
6136,125330,qCvAPTsWorFEreRKcqadivyOxQ7Qqyf8,7GRhBDsirIGkRZBtSMEzNTyDr2JQm4xx,2,0,0,0,0,0,2,0,2,0.2857142857142857,1,0.0,0,0,0,0,0,0,0,2,0,0,2,1
6137,125477,rEGrLtnwjrNQJxABPiEg16R7c6zG1e99,7GRhBDsirIGkRZBtSMEzNTyDr2JQm4xx,1,0,0,0,0,0,1,0,1,0.14285714285714285,1,0.0,0,0,0,0,0,0,0,1,0,0,1,1
6138,125569,E4FyPOdTetglhG27zHn1AaZVeKlotKQC,7GRhBDsirIGkRZBtSMEzNTyDr2JQm4xx,1,0,0,0,0,0,1,0,1,0.14285714285714285,1,0.0,0,0,0,0,0,0,0,1,0,0,1,1
6139,125664,RFEAx8yelAgvfPsQekcPEQ1kwjrp5Mon,7GRhBDsirIGkRZBtSMEzNTyDr2JQm4xx,7,3,2,0,2,0,2,0,9,1.2857142857142858,1,0.0,0,2,0,2,3,0,0,2,0,4,5,1
6140,125668,bZtNzDzO2qmGZ75gSzCr8t2M40vhOtlI,7GRhBDsirIGkRZBtSMEzNTyDr2JQm4xx,5,4,2,0,1,0,2,0,9,1.2857142857142858,2,0.0,0,2,0,1,4,0,0,2,0,3,6,1
6141,125913,rPGMKO3AhLxN6LWflYbraX7SC5U9X2nK,7GRhBDsirIGkRZBtSMEzNTyDr2JQm4xx,10,4,1,4,2,12,13,2,38,5.428571428571429,3,0.0,2,1,3,2,2,12,1,13,2,8,30,1
6142,125976,okxt3sY9reE4jjoKn2yrA6i7c1T3ZGZn,7GRhBDsirIGkRZBtSMEzNTyDr2JQm4xx,4,0,0,0,0,6,4,0,10,1.4285714285714286,1,0.0,0,0,0,0,0,6,0,4,0,0,10,1
6143,126611,AoOeu50PBcRJGzXnTeyvy2HLmQU50HHC,fbPkOYLVPtPgIt0MxizjfFJov3JbHyAi,4,2,1,0,1,0,1,0,5,0.7142857142857143,1,0.0,0,1,0,1,2,0,0,1,0,2,3,1
6144,126619,ITwd7xpRvyZSfkB4lL2L6OmpyXYVHZGs,fbPkOYLVPtPgIt0MxizjfFJov3JbHyAi,7,9,6,0,0,7,8,1,31,4.428571428571429,1,0.0,0,6,0,0,9,7,0,8,1,6,25,1
6145,126622,27Xik6MkaFL4yWSO9zEEJwVQHW9Np8S6,fbPkOYLVPtPgIt0MxizjfFJov3JbHyAi,17,9,8,0,8,2,6,0,33,4.714285714285714,2,0.0,0,8,0,8,9,2,0,6,0,16,17,1
6146,126623,TiN4z0dSpp09iMKqN066qAoKwqCoLlNB,fbPkOYLVPtPgIt0MxizjfFJov3JbHyAi,6,3,2,0,2,2,1,0,10,1.4285714285714286,1,0.0,0,2,0,2,3,2,0,1,0,4,6,1
6147,126624,YRDulTOgIWgR8cFwTAVhhuxX46WtWav7,fbPkOYLVPtPgIt0MxizjfFJov3JbHyAi,9,9,5,0,3,0,7,1,25,3.5714285714285716,1,0.0,1,5,0,3,8,0,0,7,1,9,16,1
6148,126630,EDMSGPNYA9U08P3iZyDo7po9ZIKNfhJJ,fbPkOYLVPtPgIt0MxizjfFJov3JbHyAi,8,9,2,6,5,0,5,0,27,3.857142857142857,1,0.0,6,2,4,5,3,0,2,5,0,17,10,1
6149,126632,yjkClXSb67ZKWAEvHxmMMyNPfAsPBpjl,fbPkOYLVPtPgIt0MxizjfFJov3JbHyAi,8,6,3,0,3,0,7,0,19,2.7142857142857144,1,0.0,2,3,0,3,4,0,0,7,0,8,11,1
6150,126633,KmIlNo2pbRKBzhZUiCgI2YhiW6w8iosj,fbPkOYLVPtPgIt0MxizjfFJov3JbHyAi,4,2,1,0,1,0,3,0,7,1.0,1,0.0,0,1,0,1,2,0,0,3,0,2,5,1
6151,126641,z8UfBjDXGrDWc9AMM6dseoK9YyEoRq02,fbPkOYLVPtPgIt0MxizjfFJov3JbHyAi,6,3,2,0,2,0,1,0,8,1.1428571428571428,1,0.0,0,2,0,2,3,0,0,1,0,4,4,1
6152,126645,sUFqKFuTqKGNKIqwb0vqeiIMtCX1CVCE,fbPkOYLVPtPgIt0MxizjfFJov3JbHyAi,10,3,3,0,3,0,3,1,13,1.8571428571428572,1,0.0,0,3,0,3,3,0,0,3,1,6,7,1
6153,126648,j9gdcEQiWF4hz17rFxv9vKJSxkrv7Ewo,fbPkOYLVPtPgIt0MxizjfFJov3JbHyAi,14,31,18,1,12,18,17,0,97,13.857142857142858,6,0.0,5,18,1,12,26,18,0,17,0,36,61,1
6154,126652,pSX00XUyCx7VlmgWGN0d39OwC9BZ8bRV,fbPkOYLVPtPgIt0MxizjfFJov3JbHyAi,5,2,1,0,1,3,2,1,10,1.4285714285714286,1,0.0,0,1,0,1,2,3,0,2,1,2,8,1
6155,126653,gGWMG6Gfcgv0VgsqH5vhbRzqRTXFEicG,fbPkOYLVPtPgIt0MxizjfFJov3JbHyAi,14,5,5,0,5,1,3,0,19,2.7142857142857144,1,0.0,0,5,0,5,5,1,0,3,0,10,9,1
6156,126655,qoqukLLERBRiJBIq9ZPYNUr2ljNWoAkB,fbPkOYLVPtPgIt0MxizjfFJov3JbHyAi,1,0,0,0,0,0,1,0,1,0.14285714285714285,1,0.0,0,0,0,0,0,0,0,1,0,0,1,1
6157,126664,BX9KMh9DUbDRkGw8SYAs3wHv0hHJ990Z,fbPkOYLVPtPgIt0MxizjfFJov3JbHyAi,4,2,1,0,1,0,1,0,5,0.7142857142857143,1,0.0,0,1,0,1,2,0,0,1,0,2,3,1
6158,126666,VD3NZWF3TQVEEWjdXtLLn0PBfH2lUBVv,fbPkOYLVPtPgIt0MxizjfFJov3JbHyAi,4,2,1,0,1,0,1,0,5,0.7142857142857143,1,0.0,0,1,0,1,2,0,0,1,0,2,3,1
6159,126667,CRnzue1RDSVRfMQMEjwDVoUKh1AdXpZz,fbPkOYLVPtPgIt0MxizjfFJov3JbHyAi,10,7,5,0,4,1,8,0,25,3.5714285714285716,2,0.0,0,5,0,4,7,1,0,8,0,9,16,1
6160,126671,XirdNKPxR3QK6AqsS5xwiQuah55CHklz,fbPkOYLVPtPgIt0MxizjfFJov3JbHyAi,5,3,2,0,1,0,1,0,7,1.0,1,0.0,0,2,0,1,3,0,0,1,0,3,4,1
6161,126677,cjIjalOkynRvNiMkIirdnL3eRD5dBGGC,fbPkOYLVPtPgIt0MxizjfFJov3JbHyAi,18,26,11,18,8,0,7,0,70,10.0,2,0.0,11,11,13,8,15,0,5,7,0,43,27,1
6162,126678,txSjWYX3TEWx5QLOiaADcbFdCZMHt7yE,fbPkOYLVPtPgIt0MxizjfFJov3JbHyAi,1,0,0,0,0,0,1,0,1,0.14285714285714285,1,0.0,0,0,0,0,0,0,0,1,0,0,1,1
6163,126679,GQHwUvP1dMnkB7BOvyel6l6pMIROCScP,fbPkOYLVPtPgIt0MxizjfFJov3JbHyAi,9,5,3,0,3,1,7,1,20,2.857142857142857,1,0.0,1,3,0,3,4,1,0,7,1,7,13,1
6164,126680,xnRmrsH4zMsCSnzjnexftwj0rbTRSH4o,fbPkOYLVPtPgIt0MxizjfFJov3JbHyAi,2,0,0,0,0,0,5,0,5,0.7142857142857143,1,0.0,0,0,0,0,0,0,0,5,0,0,5,1
6165,126681,Ed4keAaeu2f9Adr8MAUlkgc9PEPDZ5XH,fbPkOYLVPtPgIt0MxizjfFJov3JbHyAi,10,7,3,0,4,4,5,0,23,3.2857142857142856,1,0.0,3,3,0,4,4,4,0,5,0,10,13,1
6166,126683,1aQRKQfEUKBCXZxsytzFHSfkOMz94sSd,fbPkOYLVPtPgIt0MxizjfFJov3JbHyAi,5,2,1,0,1,0,3,0,7,1.0,1,0.0,0,1,0,1,2,0,0,3,0,2,5,1
6167,126685,kv9R1giIEQZwW9B0426lejYI0Lidtzlp,fbPkOYLVPtPgIt0MxizjfFJov3JbHyAi,1,0,0,0,0,0,1,0,1,0.14285714285714285,1,0.0,0,0,0,0,0,0,0,1,0,0,1,1
6168,126688,Ot1qGo61IYwNj80zMpFrqao7vUDTpF4u,fbPkOYLVPtPgIt0MxizjfFJov3JbHyAi,11,9,5,0,3,7,5,1,30,4.285714285714286,1,0.0,0,5,0,3,9,7,0,5,1,8,22,1
6169,126689,JYjqQWzRkQGlz0fASDON6Nnhdq6VSXiT,fbPkOYLVPtPgIt0MxizjfFJov3JbHyAi,1,0,0,0,0,0,1,0,1,0.14285714285714285,1,0.0,0,0,0,0,0,0,0,1,0,0,1,0
6170,126691,PUmV9uRuFVROTlnbrxJwOENyVx54i3f7,fbPkOYLVPtPgIt0MxizjfFJov3JbHyAi,4,2,1,0,1,0,1,0,5,0.7142857142857143,1,0.0,0,1,0,1,2,0,0,1,0,2,3,1
6171,126692,Sfke50zBDjAoEapgUNGacTteD024syFJ,fbPkOYLVPtPgIt0MxizjfFJov3JbHyAi,4,2,0,0,0,0,7,0,9,1.2857142857142858,1,0.0,0,0,0,0,2,0,0,7,0,0,9,1
6172,126697,ER1xz0N5sLgbnEZoIss9jV4E4vyRYggy,fbPkOYLVPtPgIt0MxizjfFJov3JbHyAi,11,25,9,0,7,18,4,0,63,9.0,2,0.0,2,9,0,7,23,18,0,4,0,18,45,1
6173,126699,AGXZupnvuozaRzZmgdrKKyAy6oGdUdjZ,fbPkOYLVPtPgIt0MxizjfFJov3JbHyAi,20,27,13,0,9,3,14,0,66,9.428571428571429,2,0.0,5,13,0,9,22,3,0,14,0,27,39,1
6174,126701,ZflTj2bpwRqbD9BtY63IMMYDj3wgOSNe,fbPkOYLVPtPgIt0MxizjfFJov3JbHyAi,7,6,2,0,2,6,11,0,27,3.857142857142857,2,0.0,0,2,0,2,6,6,0,11,0,4,23,1
6175,126703,6HmdNYWkOfKPcsSkwkqnh7uY2Gqe1cX7,fbPkOYLVPtPgIt0MxizjfFJov3JbHyAi,5,7,4,0,2,3,2,0,18,2.5714285714285716,2,0.0,0,4,0,2,7,3,0,2,0,6,12,0
6176,126705,gVGEUb9jfMmddRlcGqXsnz4ZV26w6q4e,fbPkOYLVPtPgIt0MxizjfFJov3JbHyAi,1,0,0,0,0,0,1,0,1,0.14285714285714285,1,0.0,0,0,0,0,0,0,0,1,0,0,1,1
6177,126708,1i94xoT1OVM1lTP3R294JlD5odSrEcP5,fbPkOYLVPtPgIt0MxizjfFJov3JbHyAi,28,67,37,12,27,1,15,1,160,22.857142857142858,6,0.0,13,37,10,27,54,1,2,15,1,87,73,1
6178,126711,dTyb50y12ITIbvAI5f6oE5PPvIq2Oszo,fbPkOYLVPtPgIt0MxizjfFJov3JbHyAi,7,3,2,0,2,0,2,0,9,1.2857142857142858,1,0.0,0,2,0,2,3,0,0,2,0,4,5,1
6179,126712,0Au7FrQGJI1dB5PAH0C5RtkL9GE7xsrQ,fbPkOYLVPtPgIt0MxizjfFJov3JbHyAi,27,25,16,0,13,0,6,0,60,8.571428571428571,4,0.0,1,16,0,13,24,0,0,6,0,30,30,1
6180,126713,hIFTaIv0NzQ1m69V2AIINZ2J51nUdfKB,fbPkOYLVPtPgIt0MxizjfFJov3JbHyAi,5,2,1,0,1,0,3,0,7,1.0,1,0.0,0,1,0,1,2,0,0,3,0,2,5,1
6181,126714,E3YF9AxDXKzlOoePQC9jwZYlzCkx0nRD,fbPkOYLVPtPgIt0MxizjfFJov3JbHyAi,1,0,0,0,0,0,1,0,1,0.14285714285714285,1,0.0,0,0,0,0,0,0,0,1,0,0,1,1
6182,126715,Z7UOgoOv3zZwU9zvjSxLYTFWLOhyMpWi,fbPkOYLVPtPgIt0MxizjfFJov3JbHyAi,12,33,15,6,8,0,11,0,73,10.428571428571429,3,0.0,10,15,6,8,23,0,0,11,0,39,34,1
6183,126717,k0sYEKzK3c3rv35gACdjIcc2Y8cPzQsK,fbPkOYLVPtPgIt0MxizjfFJov3JbHyAi,10,6,5,0,4,0,2,0,17,2.4285714285714284,1,0.0,0,5,0,4,6,0,0,2,0,9,8,1
6184,126718,H3ilxL6ewH8ns8mJBuSJ1FZhvBCjmjMc,fbPkOYLVPtPgIt0MxizjfFJov3JbHyAi,8,2,1,0,1,1,5,1,11,1.5714285714285714,1,0.0,0,1,0,1,2,1,0,5,1,2,9,1
6185,126722,tzAUOAeBXYCK0qh741cOA4XmhuNpOqLn,fbPkOYLVPtPgIt0MxizjfFJov3JbHyAi,7,6,3,0,3,0,2,0,14,2.0,1,0.0,2,3,0,3,4,0,0,2,0,8,6,1
6186,126724,SuzQYmo3OPVDT9qC8VJnnRm1Cxq00x1u,fbPkOYLVPtPgIt0MxizjfFJov3JbHyAi,6,6,5,0,5,0,1,0,17,2.4285714285714284,1,0.0,0,5,0,5,6,0,0,1,0,10,7,1
6187,126728,REzwc4szUdXMxC6Nuk8XTJfPS15NQoOL,fbPkOYLVPtPgIt0MxizjfFJov3JbHyAi,8,6,4,0,3,0,7,0,20,2.857142857142857,1,0.0,0,4,0,3,6,0,0,7,0,7,13,1
6188,126729,eNsbOW0YP21FZLJqRprbqTldsfqGKDug,fbPkOYLVPtPgIt0MxizjfFJov3JbHyAi,4,2,0,0,0,0,3,0,5,0.7142857142857143,1,0.0,0,0,0,0,2,0,0,3,0,0,5,1
6189,126730,K5koBmqwsfMijOIDdKHMgmXnCecYfcPf,fbPkOYLVPtPgIt0MxizjfFJov3JbHyAi,9,3,2,0,2,2,8,2,19,2.7142857142857144,1,0.0,0,2,0,2,3,2,0,8,2,4,15,1
6190,126731,DFFDn6kzjxm3QeQyKXF89GDFKDcalqmY,fbPkOYLVPtPgIt0MxizjfFJov3JbHyAi,1,0,0,0,0,0,2,0,2,0.2857142857142857,1,0.0,0,0,0,0,0,0,0,2,0,0,2,1
6191,126737,vaWLVKWyrsUzDV0qs20ZUq8M3VNW01Uk,fbPkOYLVPtPgIt0MxizjfFJov3JbHyAi,1,0,0,0,0,0,1,0,1,0.14285714285714285,1,0.0,0,0,0,0,0,0,0,1,0,0,1,1
6192,126739,8LFa90D8AIcBXO1V4uhC5TnOcq5mvsUm,fbPkOYLVPtPgIt0MxizjfFJov3JbHyAi,8,3,2,0,2,0,3,0,10,1.4285714285714286,2,0.0,0,2,0,2,3,0,0,3,0,4,6,1
6193,126742,B1Gq6e77yv7kkDqJ7SH2TygdPDzPBwQh,fbPkOYLVPtPgIt0MxizjfFJov3JbHyAi,63,111,61,37,35,13,35,3,295,42.142857142857146,11,0.0,32,61,30,35,79,13,7,35,3,158,137,1
6194,126746,waB7QF553HzTXuwTUim6Y0QTXghcJvpK,fbPkOYLVPtPgIt0MxizjfFJov3JbHyAi,5,2,1,0,1,0,2,0,6,0.8571428571428571,1,0.0,0,1,0,1,2,0,0,2,0,2,4,1
6195,126748,NDe8spAMYp0FsctHBGO44DCP0jh5ivtW,fbPkOYLVPtPgIt0MxizjfFJov3JbHyAi,7,5,2,0,1,15,3,0,26,3.7142857142857144,2,0.0,0,2,0,1,5,15,0,3,0,3,23,1
6196,126750,bpsYUsj9C1SHgZpkPYxDXsRDOrg2cbuw,fbPkOYLVPtPgIt0MxizjfFJov3JbHyAi,20,36,19,1,15,2,9,0,82,11.714285714285714,4,0.0,10,19,1,15,26,2,0,9,0,45,37,1
6197,126751,XYrC5UYcATLlP8wN3KwZIBFYvNYdBJrS,fbPkOYLVPtPgIt0MxizjfFJov3JbHyAi,4,3,1,0,0,0,3,0,7,1.0,1,0.0,0,1,0,0,3,0,0,3,0,1,6,1
6198,126753,bo2onan1tteC9PtOvOwWhHvlR04pcJEI,fbPkOYLVPtPgIt0MxizjfFJov3JbHyAi,1,0,0,0,0,0,1,0,1,0.14285714285714285,1,0.0,0,0,0,0,0,0,0,1,0,0,1,1
6199,126756,UQ2ITfvqEyrVlMsMiud1odTDb3yeUeeN,fbPkOYLVPtPgIt0MxizjfFJov3JbHyAi,10,11,5,0,5,0,3,0,24,3.4285714285714284,2,0.0,4,5,0,5,7,0,0,3,0,14,10,1
6200,126759,J0Jr0TKZ0YD8uJCfONhkS8KssytjG3hc,fbPkOYLVPtPgIt0MxizjfFJov3JbHyAi,2,0,0,0,0,0,2,0,2,0.2857142857142857,1,0.0,0,0,0,0,0,0,0,2,0,0,2,1
6201,126761,hqsJGd5HdE81psGb4B1N1K2xygUelqqn,fbPkOYLVPtPgIt0MxizjfFJov3JbHyAi,6,4,1,0,1,0,2,0,8,1.1428571428571428,1,0.0,0,1,0,1,4,0,0,2,0,2,6,1
6202,126765,yPVm3gMP0Ua9286Fd70ELAKAMFUpJIch,fbPkOYLVPtPgIt0MxizjfFJov3JbHyAi,1,0,0,0,0,0,1,0,1,0.14285714285714285,1,0.0,0,0,0,0,0,0,0,1,0,0,1,1
6203,126769,woczpAN6oIjjbcNjAQmIX9goIrlwr2g9,fbPkOYLVPtPgIt0MxizjfFJov3JbHyAi,10,13,1,0,1,5,7,2,29,4.142857142857143,1,0.0,0,1,0,1,13,5,0,7,2,2,27,1
6204,126770,QFN96cQBPcYAoDio3PD3qLU8mHPVFQ0T,fbPkOYLVPtPgIt0MxizjfFJov3JbHyAi,6,4,2,0,1,0,5,0,12,1.7142857142857142,3,0.0,0,2,0,1,4,0,0,5,0,3,9,1
6205,126772,uyZkiVvKwTUQeuXVbvnxcY0xXv0uj7Ou,fbPkOYLVPtPgIt0MxizjfFJov3JbHyAi,1,0,0,0,0,0,1,0,1,0.14285714285714285,1,0.0,0,0,0,0,0,0,0,1,0,0,1,1
6206,126775,MAbW0tb6J6Ti6Kh8CYUUbPwQNXH2uKzn,fbPkOYLVPtPgIt0MxizjfFJov3JbHyAi,11,6,4,0,2,0,6,0,18,2.5714285714285716,1,0.0,0,4,0,2,6,0,0,6,0,6,12,1
6207,126776,TEQ7zDYP3udNYg4MKBEvplriqU11dJpm,fbPkOYLVPtPgIt0MxizjfFJov3JbHyAi,1,0,0,0,0,0,1,0,1,0.14285714285714285,1,0.0,0,0,0,0,0,0,0,1,0,0,1,1
6208,126777,8KYOYZWZbeVcKwsAhVG92wVYE0ZslgMQ,fbPkOYLVPtPgIt0MxizjfFJov3JbHyAi,5,2,1,0,1,0,2,0,6,0.8571428571428571,1,0.0,0,1,0,1,2,0,0,2,0,2,4,1
6209,126779,eyG4WSrJfjS4SfFmzFCbTyf0yLzdGMxZ,fbPkOYLVPtPgIt0MxizjfFJov3JbHyAi,1,0,0,0,0,0,1,0,1,0.14285714285714285,1,0.0,0,0,0,0,0,0,0,1,0,0,1,1
6210,126781,u3SPm1HFwlhJpJKaAvQIjwvJr5QcuOph,fbPkOYLVPtPgIt0MxizjfFJov3JbHyAi,5,4,0,0,0,0,3,0,7,1.0,1,0.0,0,0,0,0,4,0,0,3,0,0,7,0
6211,126782,TbkRfFxVYcq9Rq8GnS46iBuAWkShuGej,fbPkOYLVPtPgIt0MxizjfFJov3JbHyAi,7,5,1,0,0,1,5,0,12,1.7142857142857142,3,0.0,0,1,0,0,5,1,0,5,0,1,11,0
6212,126784,jQGozXgCDEtih8n0QNDjwOxHGubLTjEt,fbPkOYLVPtPgIt0MxizjfFJov3JbHyAi,1,0,0,0,0,0,1,0,1,0.14285714285714285,1,0.0,0,0,0,0,0,0,0,1,0,0,1,1
6213,126785,bBtpKgA1DDqVgPxBOPJD6FyVYlM8yP8k,fbPkOYLVPtPgIt0MxizjfFJov3JbHyAi,7,5,4,0,4,0,2,0,15,2.142857142857143,1,0.0,0,4,0,4,5,0,0,2,0,8,7,1
6214,126797,vGSY3dMMulNZBhg7BC3Q8zuYArSKaMtG,fbPkOYLVPtPgIt0MxizjfFJov3JbHyAi,7,3,2,0,2,0,2,0,9,1.2857142857142858,1,0.0,0,2,0,2,3,0,0,2,0,4,5,1
6215,126798,YHm4iQLswg3Pw6HtKnjyefCEQG0rl9m6,fbPkOYLVPtPgIt0MxizjfFJov3JbHyAi,10,6,4,0,3,0,5,1,19,2.7142857142857144,2,0.0,0,4,0,3,6,0,0,5,1,7,12,1
6216,126801,Fa7tOqP1WKllvNDMgvUWmTzPr8J8vhy8,fbPkOYLVPtPgIt0MxizjfFJov3JbHyAi,1,0,0,0,0,0,1,0,1,0.14285714285714285,1,0.0,0,0,0,0,0,0,0,1,0,0,1,1
6217,126806,XnwSWp6D0m9yaPyTk2anmJeLluFnRetD,fbPkOYLVPtPgIt0MxizjfFJov3JbHyAi,6,3,1,0,1,0,2,0,7,1.0,1,0.0,0,1,0,1,3,0,0,2,0,2,5,0
6218,126810,YJTfq6mzE4rimmKGzMEkvlYd7pAv6QtE,fbPkOYLVPtPgIt0MxizjfFJov3JbHyAi,14,19,7,4,8,0,7,0,45,6.428571428571429,1,0.0,8,7,4,8,11,0,0,7,0,27,18,1
6219,126811,xwDnH1SlgpccyWc0HLXDPtkJbN2m4BgP,fbPkOYLVPtPgIt0MxizjfFJov3JbHyAi,10,5,4,0,3,3,5,1,21,3.0,1,0.0,0,4,0,3,5,3,0,5,1,7,14,1
6220,126813,sGprTXM41u2VOQkjfWkUju8jW985WAIG,fbPkOYLVPtPgIt0MxizjfFJov3JbHyAi,5,2,1,0,1,0,2,0,6,0.8571428571428571,1,0.0,0,1,0,1,2,0,0,2,0,2,4,1
6221,126814,8ecFqxBT7B9wx9rsVeuCI9d8eEGRfTVR,fbPkOYLVPtPgIt0MxizjfFJov3JbHyAi,1,0,0,0,0,0,1,0,1,0.14285714285714285,1,0.0,0,0,0,0,0,0,0,1,0,0,1,1
6222,126815,TjWuVHmc0AB9gfvtbCmyYG1vTFdPfyIz,fbPkOYLVPtPgIt0MxizjfFJov3JbHyAi,8,3,2,0,2,0,3,0,10,1.4285714285714286,1,0.0,0,2,0,2,3,0,0,3,0,4,6,1
6223,126816,QlvFciinGDGt7csjDmjYPPZqFlKAzfUP,fbPkOYLVPtPgIt0MxizjfFJov3JbHyAi,9,5,2,0,2,0,5,0,14,2.0,1,0.0,0,2,0,2,5,0,0,5,0,4,10,1
6224,126817,8n73BBd3mvRJq2a0KZ4WJWTYj65s8f61,fbPkOYLVPtPgIt0MxizjfFJov3JbHyAi,1,0,0,0,0,0,1,0,1,0.14285714285714285,1,0.0,0,0,0,0,0,0,0,1,0,0,1,1
6225,130073,IGWRz8xQdPwjKqBNKTjONoXgcj0XdulM,7GRhBDsirIGkRZBtSMEzNTyDr2JQm4xx,36,74,2,88,7,6,34,1,212,30.285714285714285,10,0.0,42,2,77,7,32,6,11,34,1,128,84,0
6226,130079,HePRyod5aTSIcFeoVudB8huyR12d5o5i,7GRhBDsirIGkRZBtSMEzNTyDr2JQm4xx,23,22,0,14,5,0,2,0,43,6.142857142857143,1,0.0,12,0,7,5,10,0,7,2,0,24,19,1
6227,130151,oaoj9be4jW2Hot8wYgYrzLRvB0RU4KYy,7GRhBDsirIGkRZBtSMEzNTyDr2JQm4xx,4,2,1,0,1,0,1,0,5,0.7142857142857143,1,0.0,0,1,0,1,2,0,0,1,0,2,3,0
6228,134911,6ne76rFv6J6TLXUe0mStK4MXCR4J8Kt5,bWdj2GDclj5ofokWjzoa5jAwMkxCykd6,5,1,1,0,1,0,2,0,5,0.7142857142857143,1,0.0,0,1,0,1,1,0,0,2,0,2,3,1
6229,134914,yNC8T7gdWO96Y2q3tzTQeJUMY0F51xnO,SpATywNh6bZuzm8s1ceuBUnMUAeoAHHw,18,32,17,18,5,0,12,0,84,12.0,6,0.0,7,17,17,5,25,0,1,12,0,46,38,0
6230,134937,9CJfWVOWO2uvtgL9sMlN6s46G91IqAvr,A3fsA9Zfv1X2fVEQhTw51lKENdNrEqT3,4,2,1,0,1,2,2,0,8,1.1428571428571428,1,0.0,0,1,0,1,2,2,0,2,0,2,6,1
6231,134938,1ryg7vHF3PEsYEqZENe5bXv9yZs2dA3V,SpATywNh6bZuzm8s1ceuBUnMUAeoAHHw,4,1,0,0,0,0,4,0,5,0.7142857142857143,1,0.0,0,0,0,0,1,0,0,4,0,0,5,1
6232,134943,YfHmALaAUVJkTXPVPoa3sijNQuWgYS7R,G8EPVSXsOYB5YQWZGiz1aVq5Pgr2GrQu,15,20,9,12,7,0,1,0,49,7.0,1,0.0,9,9,6,7,11,0,6,1,0,31,18,1
6233,134957,oaNAVS5nMmZPkgC88QZyCkxZpo6GIFQk,G8EPVSXsOYB5YQWZGiz1aVq5Pgr2GrQu,16,34,27,14,12,0,6,0,93,13.285714285714286,4,0.0,0,27,13,12,34,0,1,6,0,52,41,1
6234,134996,mr6SHndrMUFTgJeI3Xsa4qtu794cguyo,bWdj2GDclj5ofokWjzoa5jAwMkxCykd6,14,15,3,40,6,0,1,0,65,9.285714285714286,1,0.0,11,3,39,6,4,0,1,1,0,59,6,1
6235,135000,nToY9YbKok17BpaPlTxZF9mLZdFu0iiS,SpATywNh6bZuzm8s1ceuBUnMUAeoAHHw,5,2,1,0,1,0,2,0,6,0.8571428571428571,1,0.0,0,1,0,1,2,0,0,2,0,2,4,1
6236,135012,BTEY71NgAZGYnRCsSAITWHUZps70gyN4,A3fsA9Zfv1X2fVEQhTw51lKENdNrEqT3,3,0,0,0,0,2,4,2,8,1.1428571428571428,1,0.0,0,0,0,0,0,2,0,4,2,0,8,1
6237,135013,BTEY71NgAZGYnRCsSAITWHUZps70gyN4,bWdj2GDclj5ofokWjzoa5jAwMkxCykd6,1,0,0,0,0,0,1,0,1,0.14285714285714285,1,0.0,0,0,0,0,0,0,0,1,0,0,1,1
6238,135029,aLOGAfDRvmZG085q2HFFKLaRHVWlMbeZ,A3fsA9Zfv1X2fVEQhTw51lKENdNrEqT3,11,5,4,0,3,3,10,2,27,3.857142857142857,1,0.0,0,4,0,3,5,3,0,10,2,7,20,1
6239,135036,wFvodFqghxL7iISMFbYXkYNq6P6eK5gH,A3fsA9Zfv1X2fVEQhTw51lKENdNrEqT3,1,0,0,0,0,0,1,0,1,0.14285714285714285,1,0.0,0,0,0,0,0,0,0,1,0,0,1,1
6240,135043,XoKIP4RGpnZk163890vUyWhLOIUSaapU,A3fsA9Zfv1X2fVEQhTw51lKENdNrEqT3,68,61,31,174,12,0,14,0,292,41.714285714285715,3,0.0,8,31,138,12,53,0,36,14,0,189,103,1
6241,135068,L0MAfJMwT0DciI5hH53QWdE0NS8GzvBn,A3fsA9Zfv1X2fVEQhTw51lKENdNrEqT3,6,3,2,0,2,0,1,0,8,1.1428571428571428,1,0.0,0,2,0,2,3,0,0,1,0,4,4,1
6242,135069,bgBLWArC7sr7mZdIi75AaJrBI0yN4gRx,SpATywNh6bZuzm8s1ceuBUnMUAeoAHHw,28,78,9,26,7,26,54,5,205,29.285714285714285,8,0.0,19,9,23,7,59,26,3,54,5,58,147,0
6243,135071,5OhdzLluLI4b0UetZ6QtwaKcHtelD4GM,A3fsA9Zfv1X2fVEQhTw51lKENdNrEqT3,25,11,11,0,11,0,3,0,36,5.142857142857143,1,0.0,0,11,0,11,11,0,0,3,0,22,14,1
6244,135077,ml2yAwYHzufxZ6xJCtzUFr2eNYyPECGG,bWdj2GDclj5ofokWjzoa5jAwMkxCykd6,7,5,3,0,1,2,3,0,14,2.0,1,0.0,0,3,0,1,5,2,0,3,0,4,10,1
6245,135103,gZWf27ETcHz4bBmwZPjiPumw55JZ4IOR,RXDvfPUBYFlVdlueBFbLW0mhhAyGEqpt,2,0,0,0,0,0,2,0,2,0.2857142857142857,2,0.0,0,0,0,0,0,0,0,2,0,0,2,1
6246,135109,EJXR6GjvUW4ftcdNw7M6s3AjFADQ5nWH,G8EPVSXsOYB5YQWZGiz1aVq5Pgr2GrQu,20,36,0,46,0,4,12,1,99,14.142857142857142,2,0.0,6,0,42,0,30,4,4,12,1,48,51,1
6247,135110,czraR8jl3tjb5vvHKbMcAmZkpcCxXmtq,SpATywNh6bZuzm8s1ceuBUnMUAeoAHHw,6,4,2,0,1,0,2,0,9,1.2857142857142858,1,0.0,0,2,0,1,4,0,0,2,0,3,6,1
6248,135114,lPsprPvnz2KazNU0HiuebkPap36Sy8nd,A3fsA9Zfv1X2fVEQhTw51lKENdNrEqT3,7,3,2,0,2,0,2,0,9,1.2857142857142858,1,0.0,0,2,0,2,3,0,0,2,0,4,5,1
6249,135124,NOmOOlAJE5nKLDW211ZOVqBtRY1AgNoT,A3fsA9Zfv1X2fVEQhTw51lKENdNrEqT3,21,24,2,0,2,1,8,1,38,5.428571428571429,1,0.0,0,2,0,2,24,1,0,8,1,4,34,1
6250,135142,XoKIP4RGpnZk163890vUyWhLOIUSaapU,bWdj2GDclj5ofokWjzoa5jAwMkxCykd6,10,10,2,28,0,0,1,0,41,5.857142857142857,1,0.0,3,2,23,0,7,0,5,1,0,28,13,1
6251,135159,yAxjMvvPF3HDitgCGIcnFlXrbnOszGcQ,bWdj2GDclj5ofokWjzoa5jAwMkxCykd6,9,16,5,114,1,0,4,0,140,20.0,3,0.0,3,5,112,1,13,0,2,4,0,121,19,1
6252,135164,jRV8IFAqLHlnm6Yo5f3lbOm8y9FKnSQS,SpATywNh6bZuzm8s1ceuBUnMUAeoAHHw,32,32,18,31,9,2,8,1,101,14.428571428571429,3,0.0,10,18,27,9,22,2,4,8,1,64,37,1
6253,135165,72z519PMt8GGBXLvF1FG0oMJuciCSWYJ,G8EPVSXsOYB5YQWZGiz1aVq5Pgr2GrQu,7,7,3,0,1,0,9,0,20,2.857142857142857,5,0.0,0,3,0,1,7,0,0,9,0,4,16,1
6254,135210,XPNYQB8BXxVJKoqXsnIXNkzgmqWM9Jf1,A3fsA9Zfv1X2fVEQhTw51lKENdNrEqT3,1,0,0,0,0,0,1,0,1,0.14285714285714285,1,0.0,0,0,0,0,0,0,0,1,0,0,1,1
6255,135236,8JTz84ZDdJm6tvsd7hgyCl1RB6wU6r2e,bWdj2GDclj5ofokWjzoa5jAwMkxCykd6,10,8,4,2,3,5,7,1,30,4.285714285714286,2,0.0,2,4,2,3,6,5,0,7,1,11,19,0
6256,135266,orkLWN7Jw88UrSJVImY9WyAA9wO3axVi,SpATywNh6bZuzm8s1ceuBUnMUAeoAHHw,29,28,17,24,9,3,8,1,90,12.857142857142858,1,0.0,4,17,19,9,24,3,5,8,1,49,41,1
6257,135270,orkLWN7Jw88UrSJVImY9WyAA9wO3axVi,bWdj2GDclj5ofokWjzoa5jAwMkxCykd6,1,0,0,0,0,0,1,0,1,0.14285714285714285,1,0.0,0,0,0,0,0,0,0,1,0,0,1,1
6258,135274,FJJqBn1iTJmAbav7Ov5Y4ycyF65fvY1E,SpATywNh6bZuzm8s1ceuBUnMUAeoAHHw,13,9,7,0,3,2,7,2,30,4.285714285714286,2,0.0,0,7,0,3,9,2,0,7,2,10,20,0
6259,135285,ORZA67vQIOSB05DsIbFIoGl0EWiKz8Mx,RXDvfPUBYFlVdlueBFbLW0mhhAyGEqpt,22,34,5,0,3,13,2,0,57,8.142857142857142,4,0.0,2,5,0,3,32,13,0,2,0,10,47,1
6260,135289,eXv6ACzt62C4hMSoDSIQMvmz4LEnGBtm,A3fsA9Zfv1X2fVEQhTw51lKENdNrEqT3,13,7,5,0,3,0,7,0,22,3.142857142857143,2,0.0,0,5,0,3,7,0,0,7,0,8,14,1
6261,135321,x6BtQH70uuLHaxqzHA21U9wmfT0SxzD9,G8EPVSXsOYB5YQWZGiz1aVq5Pgr2GrQu,10,8,0,14,0,0,10,0,32,4.571428571428571,3,0.0,4,0,10,0,4,0,4,10,0,14,18,1
6262,135333,Hmy7IERSuMBFx0LPTwulENadvjRMvkqo,SpATywNh6bZuzm8s1ceuBUnMUAeoAHHw,24,29,7,33,4,10,3,0,86,12.285714285714286,3,0.0,6,7,32,4,23,10,1,3,0,49,37,1
6263,135370,DpB3NoJLarAGiHUaBV6zvSP8bR0qw4yk,bWdj2GDclj5ofokWjzoa5jAwMkxCykd6,11,7,6,0,5,0,1,0,19,2.7142857142857144,2,0.0,0,6,0,5,7,0,0,1,0,11,8,1
6264,135376,lg9ClFc1WU5afD4IeCy9GllsKX7cYoEB,A3fsA9Zfv1X2fVEQhTw51lKENdNrEqT3,5,2,0,0,0,0,6,0,8,1.1428571428571428,1,0.0,0,0,0,0,2,0,0,6,0,0,8,1
6265,135378,0G28t6RwNA6XV451Zq3Rvj4OEqQwVjgc,SpATywNh6bZuzm8s1ceuBUnMUAeoAHHw,4,3,1,0,0,0,2,0,6,0.8571428571428571,1,0.0,1,1,0,0,2,0,0,2,0,2,4,1
6266,135405,1R1zO9aMB7Mx1Lw84JzsChVEV5JpwmZv,bWdj2GDclj5ofokWjzoa5jAwMkxCykd6,6,15,4,0,3,0,6,0,28,4.0,6,0.0,4,4,0,3,11,0,0,6,0,11,17,1
6267,135422,GR5uAqC8TkTRctStVcrTSN6GkRpM0Sgw,bWdj2GDclj5ofokWjzoa5jAwMkxCykd6,20,23,14,20,11,8,8,0,84,12.0,3,0.0,4,14,19,11,19,8,1,8,0,48,36,1
6268,135435,WK0Fgs86cA55qEjGdACCPsAyup9yYjBW,SpATywNh6bZuzm8s1ceuBUnMUAeoAHHw,3,2,0,0,0,0,1,0,3,0.42857142857142855,1,0.0,0,0,0,0,2,0,0,1,0,0,3,1
6269,135449,MzVpgt6eIu33aOAUbbblQyleNNMrWM7t,SpATywNh6bZuzm8s1ceuBUnMUAeoAHHw,6,5,3,0,1,0,1,0,10,1.4285714285714286,1,0.0,0,3,0,1,5,0,0,1,0,4,6,1
6270,135466,JX7kh5ZfjpOmdoUQ8rczM8ziszP4alom,SpATywNh6bZuzm8s1ceuBUnMUAeoAHHw,14,18,7,0,4,0,6,1,36,5.142857142857143,1,0.0,4,7,0,4,14,0,0,6,1,15,21,1
6271,135498,hnr1SrvwKs73pIl4Y8iA8BBWZr0Bh6Qj,SpATywNh6bZuzm8s1ceuBUnMUAeoAHHw,16,19,0,14,0,1,7,1,42,6.0,1,0.0,6,0,12,0,13,1,2,7,1,18,24,1
6272,135509,cVCoN7HidGGECgrwLZ0Mg4plpA9ST0kb,A3fsA9Zfv1X2fVEQhTw51lKENdNrEqT3,1,0,0,0,0,0,1,0,1,0.14285714285714285,1,0.0,0,0,0,0,0,0,0,1,0,0,1,1
6273,135519,0oRPUvEsJVbkR952hI1neMgRcrJImgj3,A3fsA9Zfv1X2fVEQhTw51lKENdNrEqT3,16,9,8,0,7,0,2,0,26,3.7142857142857144,1,0.0,0,8,0,7,9,0,0,2,0,15,11,1
6274,135527,kF53IpFKMxCV7VctlhpV2lrkHuEbgiU3,RXDvfPUBYFlVdlueBFbLW0mhhAyGEqpt,18,12,0,46,0,3,7,2,70,10.0,1,0.0,8,0,41,0,4,3,5,7,2,49,21,0
6275,135549,N1UAN9F5SFtgblynTSPZlPcIrBcrhldq,A3fsA9Zfv1X2fVEQhTw51lKENdNrEqT3,17,12,11,0,11,5,4,1,44,6.285714285714286,1,0.0,0,11,0,11,12,5,0,4,1,22,22,1
6276,135559,LPkDtPFF5RxOnDnsqEeKxwZe2JS0rusW,SpATywNh6bZuzm8s1ceuBUnMUAeoAHHw,29,37,18,32,11,0,4,0,102,14.571428571428571,2,0.0,13,18,28,11,24,0,4,4,0,70,32,1
6277,135574,KNNMSW3oLxGqEqv2czanNkhQgdUkOWgY,A3fsA9Zfv1X2fVEQhTw51lKENdNrEqT3,8,5,4,0,4,0,1,0,14,2.0,1,0.0,0,4,0,4,5,0,0,1,0,8,6,1
6278,135578,WAeA3Wxi4ox0P2eDgiY2JLtPyMIFhfp0,bWdj2GDclj5ofokWjzoa5jAwMkxCykd6,18,35,15,16,15,2,15,2,100,14.285714285714286,2,0.0,14,15,13,15,21,2,3,15,2,57,43,1
6279,135583,ix15aF6FOEF1waZCSZt01VrPOuPGJ3yM,bWdj2GDclj5ofokWjzoa5jAwMkxCykd6,1,0,0,0,0,0,1,0,1,0.14285714285714285,1,0.0,0,0,0,0,0,0,0,1,0,0,1,1
6280,135586,dH1fJFd4EUa9cDGkzaH97LNe2YTOAGRI,SpATywNh6bZuzm8s1ceuBUnMUAeoAHHw,5,4,0,0,0,0,3,0,7,1.0,1,0.0,0,0,0,0,4,0,0,3,0,0,7,1
6281,135592,pO9i2Ab1by3uoxklbewkfKRXc2dQyl5M,SpATywNh6bZuzm8s1ceuBUnMUAeoAHHw,5,3,2,0,2,0,2,0,9,1.2857142857142858,1,0.0,0,2,0,2,3,0,0,2,0,4,5,1
6282,135593,rFiKT35F4vi8a7NpfY1bEgz4HT50lSZd,SpATywNh6bZuzm8s1ceuBUnMUAeoAHHw,8,9,2,0,2,0,4,0,17,2.4285714285714284,3,0.0,0,2,0,2,9,0,0,4,0,4,13,1
6283,135594,gikp9GqTKNuof6stdLjZVJv1OHEXFMyZ,G8EPVSXsOYB5YQWZGiz1aVq5Pgr2GrQu,68,112,46,190,0,0,4,0,352,50.285714285714285,6,0.0,63,46,128,0,49,0,62,4,0,237,115,0
6284,135604,MFpshextOJLHhySF4C6u9eWxWZPDeRiA,G8EPVSXsOYB5YQWZGiz1aVq5Pgr2GrQu,1,0,0,0,0,0,1,0,1,0.14285714285714285,1,0.0,0,0,0,0,0,0,0,1,0,0,1,1
6285,135605,Ql4EosuzRo0tVj3lvTLhkLOyEsWZly6m,A3fsA9Zfv1X2fVEQhTw51lKENdNrEqT3,1,0,0,0,0,0,1,0,1,0.14285714285714285,1,0.0,0,0,0,0,0,0,0,1,0,0,1,1
6286,135618,8vBpgDrBoNVwqQQYIlW93nRYlEk72d2F,A3fsA9Zfv1X2fVEQhTw51lKENdNrEqT3,2,0,0,0,0,0,3,0,3,0.42857142857142855,1,0.0,0,0,0,0,0,0,0,3,0,0,3,1
6287,135620,xe0pnwtsOXCGbwfmaX74fYK9PfsU6JPN,SpATywNh6bZuzm8s1ceuBUnMUAeoAHHw,1,0,0,0,0,0,1,0,1,0.14285714285714285,1,0.0,0,0,0,0,0,0,0,1,0,0,1,1
6288,135625,OQFJERUfDkJREmuh848c2NVEfKc13k0Z,SpATywNh6bZuzm8s1ceuBUnMUAeoAHHw,13,8,7,0,6,0,1,0,22,3.142857142857143,1,0.0,0,7,0,6,8,0,0,1,0,13,9,1
6289,135636,Or5tbal17XyYWYBFOcz5Axiks4gsj2rC,SpATywNh6bZuzm8s1ceuBUnMUAeoAHHw,27,27,12,39,7,0,3,0,88,12.571428571428571,3,0.0,14,12,33,7,13,0,6,3,0,66,22,1
6290,135644,9w2MJQeZHeyFkqwhaftUSXLuvPN6lDkw,SpATywNh6bZuzm8s1ceuBUnMUAeoAHHw,11,33,11,0,3,0,2,0,49,7.0,2,0.0,20,11,0,3,13,0,0,2,0,34,15,1
6291,135671,rmx82oLaycREVuiUJS5poc97xd1UWvXB,SpATywNh6bZuzm8s1ceuBUnMUAeoAHHw,5,2,1,0,1,0,2,0,6,0.8571428571428571,1,0.0,0,1,0,1,2,0,0,2,0,2,4,1
6292,135673,5ZrPblaWYg1V0nkRfCyVA4ssWqd4pnQb,SpATywNh6bZuzm8s1ceuBUnMUAeoAHHw,11,5,2,4,2,0,16,1,30,4.285714285714286,3,0.0,0,2,4,2,5,0,0,16,1,8,22,0
6293,135674,zILXfIGJjWXm6dA2MrEQWr2XeEUry8lN,A3fsA9Zfv1X2fVEQhTw51lKENdNrEqT3,11,12,7,0,3,0,8,0,30,4.285714285714286,3,0.0,0,7,0,3,12,0,0,8,0,10,20,1
6294,135676,f8veUZRhdgLfRgcJyscv3SPrRGXUYeUM,bWdj2GDclj5ofokWjzoa5jAwMkxCykd6,1,0,0,0,0,0,4,0,4,0.5714285714285714,1,0.0,0,0,0,0,0,0,0,4,0,0,4,1
6295,135688,dXV6CXhMuL2MovsaBcVnWuwVAfDnBy3D,bWdj2GDclj5ofokWjzoa5jAwMkxCykd6,1,0,0,0,0,0,1,0,1,0.14285714285714285,1,0.0,0,0,0,0,0,0,0,1,0,0,1,1
6296,135691,ZtI7VkDL2OGaTLjYGXUs2OJh9j1CJRBG,bWdj2GDclj5ofokWjzoa5jAwMkxCykd6,1,0,0,0,0,0,3,0,3,0.42857142857142855,1,0.0,0,0,0,0,0,0,0,3,0,0,3,1
6297,135705,HHLCfoI58dWnfKs7QJD7m07PMcmUWFLH,bWdj2GDclj5ofokWjzoa5jAwMkxCykd6,1,0,0,0,0,0,1,0,1,0.14285714285714285,1,0.0,0,0,0,0,0,0,0,1,0,0,1,1
6298,135715,Gur5FuhE9EyV9K1F0qLPk7AenhoY8PBS,RXDvfPUBYFlVdlueBFbLW0mhhAyGEqpt,1,0,0,0,0,0,1,0,1,0.14285714285714285,1,0.0,0,0,0,0,0,0,0,1,0,0,1,1
6299,135719,bkOkn0C7FOzFPypI63kak65ajOi43hAv,SpATywNh6bZuzm8s1ceuBUnMUAeoAHHw,4,3,2,0,2,0,1,0,8,1.1428571428571428,1,0.0,0,2,0,2,3,0,0,1,0,4,4,1
6300,135721,pvAe37z1FjLTGYdwlJFjXex25zlpyHtu,G8EPVSXsOYB5YQWZGiz1aVq5Pgr2GrQu,5,2,1,0,1,0,4,0,8,1.1428571428571428,2,0.0,0,1,0,1,2,0,0,4,0,2,6,1
6301,135723,AQfzx8ZlEOE2Pwd3sng1DQ0krIzvYrKM,RXDvfPUBYFlVdlueBFbLW0mhhAyGEqpt,2,0,0,0,0,0,2,0,2,0.2857142857142857,1,0.0,0,0,0,0,0,0,0,2,0,0,2,1
6302,135757,oj8ZT8gny2t1bI3zTIIqiwK9yqWuzw78,SpATywNh6bZuzm8s1ceuBUnMUAeoAHHw,3,2,0,0,0,0,2,0,4,0.5714285714285714,1,0.0,0,0,0,0,2,0,0,2,0,0,4,1
6303,135766,lOkl9iaUDyjk0zbwJLRgFqBRBNNBSRwr,SpATywNh6bZuzm8s1ceuBUnMUAeoAHHw,27,61,10,26,3,21,22,3,146,20.857142857142858,9,0.0,15,10,23,3,46,21,3,22,3,51,95,0
6304,135784,UsP8UHahXGHaChNTAHL4dZh6OmvP94L7,A3fsA9Zfv1X2fVEQhTw51lKENdNrEqT3,1,0,0,0,0,0,1,0,1,0.14285714285714285,1,0.0,0,0,0,0,0,0,0,1,0,0,1,1
6305,135807,mgLL2TOXKEK8di2v3UUyM4FMUqEuj4kl,SpATywNh6bZuzm8s1ceuBUnMUAeoAHHw,25,34,25,21,14,0,6,0,100,14.285714285714286,4,0.0,4,25,18,14,30,0,3,6,0,61,39,0
6306,135811,5sps38f5Y5pZOFcONQeuy3Uw9461fahZ,SpATywNh6bZuzm8s1ceuBUnMUAeoAHHw,18,41,17,12,7,1,11,1,90,12.857142857142858,4,0.0,8,17,10,7,33,1,2,11,1,42,48,1
6307,135817,E47JGU8OIEWEHQErVOIbVuBKL7eug9kL,SpATywNh6bZuzm8s1ceuBUnMUAeoAHHw,1,0,0,0,0,0,1,0,1,0.14285714285714285,1,0.0,0,0,0,0,0,0,0,1,0,0,1,1
6308,135825,ETvKJXrBLwN7msxC91B5PIQrzaf0kAW1,bWdj2GDclj5ofokWjzoa5jAwMkxCykd6,1,0,0,0,0,0,1,0,1,0.14285714285714285,1,0.0,0,0,0,0,0,0,0,1,0,0,1,1
6309,135854,up6Dm3KbNQ1ouTMs5v0fwblubVxwKJMi,7GRhBDsirIGkRZBtSMEzNTyDr2JQm4xx,16,9,9,0,9,0,6,0,33,4.714285714285714,2,0.0,0,9,0,9,9,0,0,6,0,18,15,1
6310,135858,mTOoYxpCIgV1V8PFGNgwuxdFg8JU7kb9,7GRhBDsirIGkRZBtSMEzNTyDr2JQm4xx,12,3,2,0,2,1,7,1,16,2.2857142857142856,1,0.0,0,2,0,2,3,1,0,7,1,4,12,1
6311,136038,P38VxMH253jjoDZHRNefTKyEAydphpb2,SpATywNh6bZuzm8s1ceuBUnMUAeoAHHw,22,38,16,32,5,18,19,3,131,18.714285714285715,4,0.0,15,16,27,5,23,18,5,19,3,63,68,1
6312,136064,o3T0K8ec78cQHSHsSLzMA1PbvYi8mwTI,7GRhBDsirIGkRZBtSMEzNTyDr2JQm4xx,16,44,10,30,0,31,13,2,130,18.571428571428573,3,0.0,20,10,26,0,24,31,4,13,2,56,74,1
6313,136096,msM56OM0TrhCVyicpbYafJdknfubqkzk,7GRhBDsirIGkRZBtSMEzNTyDr2JQm4xx,8,9,2,6,2,1,3,1,24,3.4285714285714284,1,0.0,3,2,5,2,6,1,1,3,1,12,12,1
6314,136098,YQZ85qW2KiDmX9GD2Tq3oRYH6ucmQmKe,7GRhBDsirIGkRZBtSMEzNTyDr2JQm4xx,16,42,0,22,4,1,2,0,71,10.142857142857142,1,0.0,24,0,19,4,18,1,3,2,0,47,24,1
6315,136143,hnr1SrvwKs73pIl4Y8iA8BBWZr0Bh6Qj,G8EPVSXsOYB5YQWZGiz1aVq5Pgr2GrQu,9,16,1,8,3,0,5,0,33,4.714285714285714,1,0.0,6,1,5,3,10,0,3,5,0,15,18,0
6316,136149,St6usTSSgX5U9v7wchuMWqmBKoCcDwN2,SpATywNh6bZuzm8s1ceuBUnMUAeoAHHw,15,26,1,14,1,0,8,0,50,7.142857142857143,4,0.0,13,1,13,1,13,0,1,8,0,28,22,0
6317,136152,FmYyMdFUePtcDBVgDdhDyxnbGBctrwZJ,SpATywNh6bZuzm8s1ceuBUnMUAeoAHHw,7,2,1,0,1,0,4,1,9,1.2857142857142858,1,0.0,1,1,0,1,1,0,0,4,1,3,6,0
6318,136209,oGK3c8nk6Ftl3V2u1zOvslszD4LDLr3w,G8EPVSXsOYB5YQWZGiz1aVq5Pgr2GrQu,9,10,6,0,4,0,2,0,22,3.142857142857143,2,0.0,0,6,0,4,10,0,0,2,0,10,12,1
6319,136210,bIjd8KK4L7j9O8VoOs8qHKzlQRCxHLCH,SpATywNh6bZuzm8s1ceuBUnMUAeoAHHw,14,18,1,16,1,6,5,0,47,6.714285714285714,2,0.0,9,1,15,1,9,6,1,5,0,26,21,0
6320,136230,FZEwaAUaiR6zemazrUHMMvDLCgHez3sb,SpATywNh6bZuzm8s1ceuBUnMUAeoAHHw,12,24,11,19,1,21,10,1,87,12.428571428571429,2,0.0,6,11,16,1,18,21,3,10,1,34,53,1
6321,136247,8FGs2DlahZoB3KBpV3eIicZF3v5DtTbf,SpATywNh6bZuzm8s1ceuBUnMUAeoAHHw,16,10,7,5,3,2,9,1,37,5.285714285714286,2,0.0,2,7,5,3,8,2,0,9,1,17,20,0
6322,136265,7fwVXF5ctPhb8pPmrNYDi2ycSDGABklq,SpATywNh6bZuzm8s1ceuBUnMUAeoAHHw,5,5,0,0,0,0,1,0,6,0.8571428571428571,1,0.0,0,0,0,0,5,0,0,1,0,0,6,1
6323,136312,DysXuoUoTtoCjfxHxEQdZhXHC6tNfwru,7GRhBDsirIGkRZBtSMEzNTyDr2JQm4xx,34,37,18,44,20,0,12,0,131,18.714285714285715,4,0.0,19,18,36,20,18,0,8,12,0,93,38,1
6324,136317,PSnfBRJFzUH9xyPpWKLqfkQbVy7w07sO,SpATywNh6bZuzm8s1ceuBUnMUAeoAHHw,25,29,3,25,1,1,16,1,76,10.857142857142858,3,0.0,11,3,21,1,18,1,4,16,1,36,40,1
6325,136327,xFOMKgrHGqKyL5uPk9RcNRWczzZxvoeN,7GRhBDsirIGkRZBtSMEzNTyDr2JQm4xx,1,0,0,0,0,0,1,0,1,0.14285714285714285,1,0.0,0,0,0,0,0,0,0,1,0,0,1,1
6326,136375,QzQWYrrIVOUqhShDM2t03rN3byjq3J7w,SpATywNh6bZuzm8s1ceuBUnMUAeoAHHw,15,28,3,18,1,4,8,0,62,8.857142857142858,1,0.0,11,3,15,1,17,4,3,8,0,30,32,0
6327,136398,gtKTzkXHwS41ljYVmjlLLf4WyQSkK02q,7GRhBDsirIGkRZBtSMEzNTyDr2JQm4xx,25,42,14,64,0,0,5,0,125,17.857142857142858,2,0.0,23,14,54,0,19,0,10,5,0,91,34,1
6328,136413,SAZKFz2NUOxVKdkBgcAx84BjxoboQOlS,SpATywNh6bZuzm8s1ceuBUnMUAeoAHHw,20,25,3,16,1,10,12,0,67,9.571428571428571,4,0.0,3,3,16,1,22,10,0,12,0,23,44,0
6329,136445,qtck8S6SMYpkxbIZosuQoFSB26vuEbBy,7GRhBDsirIGkRZBtSMEzNTyDr2JQm4xx,2,0,0,0,0,0,2,0,2,0.2857142857142857,1,0.0,0,0,0,0,0,0,0,2,0,0,2,1
6330,136468,YVboeUnAYRezL6JF0VMVpiapYahgjIwn,SpATywNh6bZuzm8s1ceuBUnMUAeoAHHw,17,34,12,21,5,22,16,2,112,16.0,4,0.0,11,12,18,5,23,22,3,16,2,46,66,0
6331,136500,AAAvWauitKfXD0xRpNsfpOKQu223kCXG,bWdj2GDclj5ofokWjzoa5jAwMkxCykd6,7,7,5,0,3,0,4,0,19,2.7142857142857144,2,0.0,0,5,0,3,7,0,0,4,0,8,11,1
6332,136540,hZR4MwcYec4g0GoOyJFngJGEyWOySpv2,7GRhBDsirIGkRZBtSMEzNTyDr2JQm4xx,7,4,2,0,0,19,18,1,44,6.285714285714286,6,0.0,0,2,0,0,4,19,0,18,1,2,42,0
6333,136547,LkEFlCqQYkjvIKgJmv3NaW67JKbg7cls,SpATywNh6bZuzm8s1ceuBUnMUAeoAHHw,1,0,0,0,0,0,1,0,1,0.14285714285714285,1,0.0,0,0,0,0,0,0,0,1,0,0,1,0
6334,136564,JHhY30IKFzw4LWcyrHuTEglWNqRkqdDU,SpATywNh6bZuzm8s1ceuBUnMUAeoAHHw,12,6,2,16,0,0,9,0,33,4.714285714285714,3,0.0,4,2,16,0,2,0,0,9,0,22,11,1
6335,136592,JHhY30IKFzw4LWcyrHuTEglWNqRkqdDU,RXDvfPUBYFlVdlueBFbLW0mhhAyGEqpt,55,28,16,180,3,1,8,0,236,33.714285714285715,2,0.0,11,16,159,3,17,1,21,8,0,189,47,1
6336,136596,YqY5WPa8kwIoLBKGaVnXfSZOMvkSrEdU,SpATywNh6bZuzm8s1ceuBUnMUAeoAHHw,29,37,21,18,11,35,15,0,137,19.571428571428573,5,0.0,10,21,17,11,27,35,1,15,0,59,78,0
6337,136602,YqY5WPa8kwIoLBKGaVnXfSZOMvkSrEdU,A3fsA9Zfv1X2fVEQhTw51lKENdNrEqT3,8,7,4,0,1,0,4,0,16,2.2857142857142856,3,0.0,0,4,0,1,7,0,0,4,0,5,11,1
6338,136635,jedE3nTKdlUnNjeeZxONdSIgUVRjrOri,7GRhBDsirIGkRZBtSMEzNTyDr2JQm4xx,8,4,2,4,2,2,2,0,16,2.2857142857142856,2,0.0,1,2,3,2,3,2,1,2,0,8,8,1
6339,136652,qU5mfkjhD9M0R49RmBMaCeXLeTqIOyhm,7GRhBDsirIGkRZBtSMEzNTyDr2JQm4xx,4,4,0,0,0,0,1,0,5,0.7142857142857143,1,0.0,0,0,0,0,4,0,0,1,0,0,5,1
6340,136673,St6usTSSgX5U9v7wchuMWqmBKoCcDwN2,A3fsA9Zfv1X2fVEQhTw51lKENdNrEqT3,14,8,1,20,1,3,4,0,37,5.285714285714286,3,0.0,0,1,19,1,8,3,1,4,0,21,16,1
6341,136743,PV4ahNYgW8Lcd9nNe0xrpkqG7Ws3zMb1,SpATywNh6bZuzm8s1ceuBUnMUAeoAHHw,31,42,26,22,11,19,50,6,176,25.142857142857142,5,0.0,6,26,19,11,36,19,3,50,6,62,114,0
6342,136752,YUPaOsEEFOH7xpyMBcCkViDpUqkz1A5I,7GRhBDsirIGkRZBtSMEzNTyDr2JQm4xx,1,0,0,0,0,0,1,0,1,0.14285714285714285,1,0.0,0,0,0,0,0,0,0,1,0,0,1,1
6343,136785,nsbeAj5BI7VK72NYmPa0cGgkMq0PU2h6,SpATywNh6bZuzm8s1ceuBUnMUAeoAHHw,15,15,4,0,4,0,4,0,27,3.857142857142857,3,0.0,0,4,0,4,15,0,0,4,0,8,19,0
6344,136797,uXoi7oqvj5HXbvnVGMMeQOqZvw3BW3QM,G8EPVSXsOYB5YQWZGiz1aVq5Pgr2GrQu,23,54,1,32,4,3,8,3,105,15.0,2,0.0,42,1,18,4,12,3,14,8,3,65,40,0
6345,136799,HycevJIm7cBjf1oJ5QCBMMXEBTG8jyRF,G8EPVSXsOYB5YQWZGiz1aVq5Pgr2GrQu,4,2,1,0,0,0,2,0,5,0.7142857142857143,1,0.0,0,1,0,0,2,0,0,2,0,1,4,1
6346,136822,LKQx76DscP8cMaadDZLCOsushv3ygeRX,bWdj2GDclj5ofokWjzoa5jAwMkxCykd6,1,0,0,0,0,0,3,0,3,0.42857142857142855,1,0.0,0,0,0,0,0,0,0,3,0,0,3,1
6347,136860,5NKHIcFKbvZvjnI6x0vdD0R4rE65640c,SpATywNh6bZuzm8s1ceuBUnMUAeoAHHw,17,32,3,26,1,4,26,2,94,13.428571428571429,4,0.0,10,3,21,1,22,4,5,26,2,35,59,0
6348,136874,P6rNkkuxGZS8wdNcuNCJoPQNsegCUIqx,7GRhBDsirIGkRZBtSMEzNTyDr2JQm4xx,2,0,0,0,0,0,2,0,2,0.2857142857142857,1,0.0,0,0,0,0,0,0,0,2,0,0,2,1
6349,136897,xNcMMIyB0y99dNaEOIqDnvCMrU2SAEOP,G8EPVSXsOYB5YQWZGiz1aVq5Pgr2GrQu,41,44,20,64,13,1,15,1,158,22.571428571428573,5,0.0,15,20,45,13,29,1,19,15,1,93,65,0
6350,136920,HjlZu5CgYZQVUJqRZv1KCIOR0lFMSkiS,7GRhBDsirIGkRZBtSMEzNTyDr2JQm4xx,10,9,0,10,0,0,7,0,26,3.7142857142857144,2,0.0,2,0,8,0,7,0,2,7,0,10,16,1
6351,136942,BJcIgaOnWdAOKf7jzUg9DKOlERmjwn2s,7GRhBDsirIGkRZBtSMEzNTyDr2JQm4xx,1,0,0,0,0,0,2,0,2,0.2857142857142857,1,0.0,0,0,0,0,0,0,0,2,0,0,2,1
6352,137016,00bDiL0A6W9npxn52kzhmAfK2Yag1Gik,bWdj2GDclj5ofokWjzoa5jAwMkxCykd6,9,6,3,0,0,19,7,1,36,5.142857142857143,1,0.0,2,3,0,0,4,19,0,7,1,5,31,0
6353,137077,xIsNJgqYQ4WcvbQ1A0Us7q1c1NYtR1tF,bWdj2GDclj5ofokWjzoa5jAwMkxCykd6,5,2,0,0,1,0,2,0,5,0.7142857142857143,1,0.0,0,0,0,1,2,0,0,2,0,1,4,0
6354,137214,nmlYjXdaqWSjPWm2kQhmjZqjjBKhkQAm,A3fsA9Zfv1X2fVEQhTw51lKENdNrEqT3,2,0,0,0,0,0,2,0,2,0.2857142857142857,1,0.0,0,0,0,0,0,0,0,2,0,0,2,1
6355,137290,RmlLLXW8yVeVv6IlxP4h82on7YcnLjlC,fbPkOYLVPtPgIt0MxizjfFJov3JbHyAi,5,2,0,0,0,0,19,1,22,3.142857142857143,1,0.0,0,0,0,0,2,0,0,19,1,0,22,1
6356,137292,1nw5LJsxTSlYBcpPAO0FPean8WSWknnT,fbPkOYLVPtPgIt0MxizjfFJov3JbHyAi,5,2,0,0,0,4,6,0,12,1.7142857142857142,1,0.0,0,0,0,0,2,4,0,6,0,0,12,1
6357,137296,bJ8AAxZ3JuvigCWd3VGvoJ2Ns2zJszXZ,fbPkOYLVPtPgIt0MxizjfFJov3JbHyAi,10,28,14,1,9,0,3,0,55,7.857142857142857,2,0.0,10,14,1,9,18,0,0,3,0,34,21,1
6358,137299,fQ2qYe5HNta8P0G8uXdGrvFPejbwucPN,fbPkOYLVPtPgIt0MxizjfFJov3JbHyAi,18,25,11,0,7,14,9,0,66,9.428571428571429,1,0.0,0,11,0,7,25,14,0,9,0,18,48,1
6359,137300,O5osNpvARQ134oncM7N5QGhst9sMjRtB,fbPkOYLVPtPgIt0MxizjfFJov3JbHyAi,4,2,1,0,1,7,1,0,12,1.7142857142857142,1,0.0,0,1,0,1,2,7,0,1,0,2,10,1
6360,137301,h774wdF6vIIcl50Js74gckwUtlv9SBGH,fbPkOYLVPtPgIt0MxizjfFJov3JbHyAi,26,83,40,13,24,8,10,0,178,25.428571428571427,4,0.0,21,40,11,24,62,8,2,10,0,96,82,1
6361,137304,fV9PFchRO9NFkeyKqjI60ieBb4YfIgSO,fbPkOYLVPtPgIt0MxizjfFJov3JbHyAi,4,3,0,0,0,16,4,0,23,3.2857142857142856,1,0.0,0,0,0,0,3,16,0,4,0,0,23,1
6362,137306,CTPK2LGRvMaPvlFasZdjTmXOqyM1Lmi8,fbPkOYLVPtPgIt0MxizjfFJov3JbHyAi,23,25,14,14,15,7,3,0,78,11.142857142857142,1,0.0,10,14,13,15,15,7,1,3,0,52,26,1
6363,137308,UAggpZPNL1hZ0kLwEDSUplsT3ghk1d6y,fbPkOYLVPtPgIt0MxizjfFJov3JbHyAi,9,5,3,0,1,2,6,1,18,2.5714285714285716,2,0.0,0,3,0,1,5,2,0,6,1,4,14,1
6364,137309,gL1o6jsIwD6Ip8uBaHnoUMfUbsYcrCmr,fbPkOYLVPtPgIt0MxizjfFJov3JbHyAi,7,3,2,0,2,3,3,1,14,2.0,1,0.0,0,2,0,2,3,3,0,3,1,4,10,1
6365,137313,n1ESpvyobZkFsfrWJhKOuY4URaa1sUc5,fbPkOYLVPtPgIt0MxizjfFJov3JbHyAi,5,2,1,0,1,0,4,0,8,1.1428571428571428,1,0.0,0,1,0,1,2,0,0,4,0,2,6,1
6366,137315,f0jKRSnLVIejbfFzT0M2iiXUyVwMVp4e,fbPkOYLVPtPgIt0MxizjfFJov3JbHyAi,5,3,2,0,2,0,2,0,9,1.2857142857142858,1,0.0,0,2,0,2,3,0,0,2,0,4,5,1
6367,137319,glXXkvEu5VWOG069hJZn4a1ogKzxsZqy,fbPkOYLVPtPgIt0MxizjfFJov3JbHyAi,2,0,0,0,0,0,6,0,6,0.8571428571428571,1,0.0,0,0,0,0,0,0,0,6,0,0,6,1
6368,137321,owHNspB8DrsecsPRNmUB7UBdqXOlW955,fbPkOYLVPtPgIt0MxizjfFJov3JbHyAi,7,8,3,0,2,0,1,0,14,2.0,1,0.0,0,3,0,2,8,0,0,1,0,5,9,1
6369,137323,iTjfGmkhI7qYgG8rBAfSzNVyjUvKbeUV,fbPkOYLVPtPgIt0MxizjfFJov3JbHyAi,4,2,1,0,1,0,1,0,5,0.7142857142857143,1,0.0,0,1,0,1,2,0,0,1,0,2,3,1
6370,137324,nyH7Jx4kN1AdDJdwkZQoUDqYoovHgbk5,fbPkOYLVPtPgIt0MxizjfFJov3JbHyAi,13,14,8,2,6,11,8,1,50,7.142857142857143,3,0.0,2,8,2,6,12,11,0,8,1,18,32,0
6371,137325,8WSLblwPqv9lrYeGgJiG7aFvD2e5FjPW,fbPkOYLVPtPgIt0MxizjfFJov3JbHyAi,2,0,0,0,0,0,2,0,2,0.2857142857142857,1,0.0,0,0,0,0,0,0,0,2,0,0,2,1
6372,137326,3cVj7hdkALbjY726IM3M6Ud07m4las2t,fbPkOYLVPtPgIt0MxizjfFJov3JbHyAi,9,3,2,0,2,4,6,1,18,2.5714285714285716,1,0.0,0,2,0,2,3,4,0,6,1,4,14,1
6373,137329,LnsTOCnKQwSd834VWj8Se5P6LDNk8RHo,fbPkOYLVPtPgIt0MxizjfFJov3JbHyAi,5,7,0,0,0,0,1,0,8,1.1428571428571428,1,0.0,0,0,0,0,7,0,0,1,0,0,8,1
6374,137331,5fdjSFb0UnHfjLD83iptHyG30XcBntML,fbPkOYLVPtPgIt0MxizjfFJov3JbHyAi,8,6,2,0,3,0,3,0,14,2.0,1,0.0,2,2,0,3,4,0,0,3,0,7,7,1
6375,137332,V5n4KmrCt6qTaNCHvn8AZsixldOhtrqM,fbPkOYLVPtPgIt0MxizjfFJov3JbHyAi,8,5,3,0,2,5,4,0,19,2.7142857142857144,2,0.0,0,3,0,2,5,5,0,4,0,5,14,1
6376,137335,b2ohpFiEgZaZsBBPqUMnfjpywCAbNR88,fbPkOYLVPtPgIt0MxizjfFJov3JbHyAi,11,11,4,0,4,0,4,0,23,3.2857142857142856,2,0.0,0,4,0,4,11,0,0,4,0,8,15,1
6377,137336,D35Hr8NmMeH1abGin8hsVg1eeYI1rkMx,fbPkOYLVPtPgIt0MxizjfFJov3JbHyAi,19,15,11,0,9,0,5,2,42,6.0,1,0.0,0,11,0,9,15,0,0,5,2,20,22,1
6378,137339,Q4RfMohp0VyMzzF8aoHnH7xFgkQEGrSz,fbPkOYLVPtPgIt0MxizjfFJov3JbHyAi,5,2,1,0,1,0,3,0,7,1.0,1,0.0,0,1,0,1,2,0,0,3,0,2,5,1
6379,137340,7RIgMHzHpMzY7qBXHPj6WiDKK3U9H2Wz,fbPkOYLVPtPgIt0MxizjfFJov3JbHyAi,7,8,5,0,3,2,4,0,22,3.142857142857143,2,0.0,0,5,0,3,8,2,0,4,0,8,14,1
6380,137341,EVRzOGDcK6HIoRC4TyM175kAEkfMvm8k,fbPkOYLVPtPgIt0MxizjfFJov3JbHyAi,6,5,2,0,3,0,3,0,13,1.8571428571428572,1,0.0,2,2,0,3,3,0,0,3,0,7,6,1
6381,137342,G3uUdYmcbUGjsucepMY504O6KIKoDegj,fbPkOYLVPtPgIt0MxizjfFJov3JbHyAi,2,0,0,0,0,0,7,0,7,1.0,1,0.0,0,0,0,0,0,0,0,7,0,0,7,1
6382,137343,cquObqcJUxOFEWJ4OzhgFktpn4MuuvGh,fbPkOYLVPtPgIt0MxizjfFJov3JbHyAi,2,0,0,0,0,0,2,0,2,0.2857142857142857,1,0.0,0,0,0,0,0,0,0,2,0,0,2,1
6383,137345,MCZHS6CBpJ75tmAXNSc4ArD5vu4UQMmf,fbPkOYLVPtPgIt0MxizjfFJov3JbHyAi,2,0,0,0,0,0,6,0,6,0.8571428571428571,1,0.0,0,0,0,0,0,0,0,6,0,0,6,1
6384,137348,T5moiKfoqYwkBJrrQj3QEFYZxN8QkHfc,fbPkOYLVPtPgIt0MxizjfFJov3JbHyAi,8,5,2,0,1,9,6,1,24,3.4285714285714284,1,0.0,0,2,0,1,5,9,0,6,1,3,21,1
6385,137353,0yZD4fjReiCp5h9L5wxeZCsj4C8snJgU,fbPkOYLVPtPgIt0MxizjfFJov3JbHyAi,2,0,0,0,0,0,3,0,3,0.42857142857142855,1,0.0,0,0,0,0,0,0,0,3,0,0,3,1
6386,137355,UaIcSFKSsXMkLJoEB18mPucIS2F5HMZt,fbPkOYLVPtPgIt0MxizjfFJov3JbHyAi,4,2,1,0,0,0,2,0,5,0.7142857142857143,1,0.0,0,1,0,0,2,0,0,2,0,1,4,1
6387,137357,Dxumuu0iESds4rdkin6IFLqksHFKYmBa,fbPkOYLVPtPgIt0MxizjfFJov3JbHyAi,2,0,0,0,0,0,3,0,3,0.42857142857142855,1,0.0,0,0,0,0,0,0,0,3,0,0,3,1
6388,137358,htmCxkgAOIvbjO4xq8D0LMRC4XX4uXb4,fbPkOYLVPtPgIt0MxizjfFJov3JbHyAi,7,3,2,0,2,0,3,0,10,1.4285714285714286,1,0.0,0,2,0,2,3,0,0,3,0,4,6,1
6389,137361,c3Q7zBkcz9A9C9axYIiO1QysEG1V4UAO,fbPkOYLVPtPgIt0MxizjfFJov3JbHyAi,9,5,4,0,3,0,5,0,17,2.4285714285714284,1,0.0,0,4,0,3,5,0,0,5,0,7,10,1
6390,137370,qNDvS5AGNuAWPmsY8v3e0mmJNktcZlln,fbPkOYLVPtPgIt0MxizjfFJov3JbHyAi,7,8,2,0,2,0,7,0,19,2.7142857142857144,1,0.0,4,2,0,2,4,0,0,7,0,8,11,1
6391,137372,lOBLdw8F0Df8BSa1UipMpaST2r1WwJcV,fbPkOYLVPtPgIt0MxizjfFJov3JbHyAi,9,4,3,0,3,6,6,1,23,3.2857142857142856,1,0.0,0,3,0,3,4,6,0,6,1,6,17,1
6392,137373,sndae06qc0KQXBA5AxxztXDWy4HQwsmF,fbPkOYLVPtPgIt0MxizjfFJov3JbHyAi,10,15,6,10,7,0,5,0,43,6.142857142857143,1,0.0,6,6,6,7,9,0,4,5,0,25,18,1
6393,137375,CKl647uBpzhaV8Bs4OjoA2KfJg2713it,fbPkOYLVPtPgIt0MxizjfFJov3JbHyAi,9,11,4,4,5,0,3,0,27,3.857142857142857,1,0.0,6,4,3,5,5,0,1,3,0,18,9,1
6394,137377,Ep4Q95tKnG1eQgBqFXbKyAx3i4zRNHfc,fbPkOYLVPtPgIt0MxizjfFJov3JbHyAi,1,0,0,0,0,0,1,0,1,0.14285714285714285,1,0.0,0,0,0,0,0,0,0,1,0,0,1,1
6395,137379,QuG2234wZAOXxXJpYa4PWsH3trXo84qK,fbPkOYLVPtPgIt0MxizjfFJov3JbHyAi,8,4,3,0,3,0,1,0,11,1.5714285714285714,1,0.0,0,3,0,3,4,0,0,1,0,6,5,1
6396,137383,yukNWaYJAZyHIfSpFgr2lENAGZdY7HBJ,fbPkOYLVPtPgIt0MxizjfFJov3JbHyAi,7,5,3,0,2,8,1,0,19,2.7142857142857144,1,0.0,0,3,0,2,5,8,0,1,0,5,14,1
6397,137384,EKfl5y1NkN1Xn8ASWOcqUOIlKCaC7Rgd,fbPkOYLVPtPgIt0MxizjfFJov3JbHyAi,1,0,0,0,0,0,1,0,1,0.14285714285714285,1,0.0,0,0,0,0,0,0,0,1,0,0,1,1
6398,137386,5XQirr9i0TWpiYbsECZzYQuaZyvNkBXn,fbPkOYLVPtPgIt0MxizjfFJov3JbHyAi,8,11,2,0,1,0,8,0,22,3.142857142857143,3,0.0,0,2,0,1,11,0,0,8,0,3,19,1
6399,137388,5FX74tSsqVOdvsPJFln5AHRuURmp41HT,fbPkOYLVPtPgIt0MxizjfFJov3JbHyAi,8,6,3,0,2,0,4,0,15,2.142857142857143,2,0.0,1,3,0,2,5,0,0,4,0,6,9,0
6400,137391,m6Zwht6K5r3XL6tnCyfbnnByGD7T5f2R,fbPkOYLVPtPgIt0MxizjfFJov3JbHyAi,5,2,1,0,1,0,2,0,6,0.8571428571428571,1,0.0,0,1,0,1,2,0,0,2,0,2,4,1
6401,137397,Qv1iNPNlhVNOmWMs92FkzrrHMbJaVyPk,fbPkOYLVPtPgIt0MxizjfFJov3JbHyAi,8,4,2,0,1,1,11,1,20,2.857142857142857,1,0.0,0,2,0,1,4,1,0,11,1,3,17,1
6402,137399,mqVpGUWCMkNcDZMRD2pJxKGV8oQAE2Qj,fbPkOYLVPtPgIt0MxizjfFJov3JbHyAi,8,4,3,0,2,0,4,0,13,1.8571428571428572,1,0.0,1,3,0,2,3,0,0,4,0,6,7,1
6403,137405,yLjINTUbScao5ufShTGxxbbMK1JbRcNK,fbPkOYLVPtPgIt0MxizjfFJov3JbHyAi,7,6,2,0,3,0,3,0,14,2.0,1,0.0,2,2,0,3,4,0,0,3,0,7,7,1
6404,137406,e4YalnUrFKcUfgQELCwKNGRSXvIfj3rn,fbPkOYLVPtPgIt0MxizjfFJov3JbHyAi,2,0,0,0,0,0,3,0,3,0.42857142857142855,1,0.0,0,0,0,0,0,0,0,3,0,0,3,1
6405,137407,xeJgmT2GlcKPs7xiwWbHClhY602CtyUx,fbPkOYLVPtPgIt0MxizjfFJov3JbHyAi,5,1,1,0,1,0,2,0,5,0.7142857142857143,1,0.0,0,1,0,1,1,0,0,2,0,2,3,1
6406,137408,7ZpK2Qdkfg6qjiDNvxUiqNClV9f1rdSE,fbPkOYLVPtPgIt0MxizjfFJov3JbHyAi,27,24,18,0,14,26,10,2,94,13.428571428571429,3,0.0,0,18,0,14,24,26,0,10,2,32,62,1
6407,137410,cp3YBtv3LBPQsC9KSWwASci6TDzE2JIe,fbPkOYLVPtPgIt0MxizjfFJov3JbHyAi,1,0,0,0,0,0,1,0,1,0.14285714285714285,1,0.0,0,0,0,0,0,0,0,1,0,0,1,1
6408,137411,RDChRApYRv6Sfe9dw6iFymmd1hK0JhGY,fbPkOYLVPtPgIt0MxizjfFJov3JbHyAi,1,0,0,0,0,0,1,0,1,0.14285714285714285,1,0.0,0,0,0,0,0,0,0,1,0,0,1,1
6409,137412,qZpXWzENd8vPQkANcwupj0acfmacGtsr,fbPkOYLVPtPgIt0MxizjfFJov3JbHyAi,16,9,8,0,8,0,1,0,26,3.7142857142857144,1,0.0,0,8,0,8,9,0,0,1,0,16,10,1
6410,137414,DTvfa3fS3ROp7pjogLjRtY4RzKRlF9Cy,fbPkOYLVPtPgIt0MxizjfFJov3JbHyAi,6,8,1,0,2,0,5,0,16,2.2857142857142856,1,0.0,3,1,0,2,5,0,0,5,0,6,10,1
6411,137415,zs8AbWxu3oihhi0RdSLs1xmLXXgmhkzY,fbPkOYLVPtPgIt0MxizjfFJov3JbHyAi,23,47,2,20,6,20,9,2,106,15.142857142857142,2,0.0,29,2,18,6,18,20,2,9,2,55,51,1
6412,137417,bCFz6hqpGZgCTv9FmzDlmLq86tdtyvtb,fbPkOYLVPtPgIt0MxizjfFJov3JbHyAi,6,4,1,0,1,2,3,0,11,1.5714285714285714,1,0.0,0,1,0,1,4,2,0,3,0,2,9,1
6413,137418,y71lRBqIdu5iPiLn9Yi5PQm6GFIvgLwB,fbPkOYLVPtPgIt0MxizjfFJov3JbHyAi,5,4,2,0,1,4,2,0,13,1.8571428571428572,1,0.0,0,2,0,1,4,4,0,2,0,3,10,1
6414,137420,vuqFPhnjwQKBPhmOAdfWdPVUnftTeBnB,fbPkOYLVPtPgIt0MxizjfFJov3JbHyAi,5,2,1,0,1,0,3,0,7,1.0,1,0.0,0,1,0,1,2,0,0,3,0,2,5,1
6415,137421,3y3fLWnaqy4gjWzUuftSoOxerFuYM9Ss,fbPkOYLVPtPgIt0MxizjfFJov3JbHyAi,7,4,2,0,2,0,2,0,10,1.4285714285714286,1,0.0,0,2,0,2,4,0,0,2,0,4,6,1
6416,137427,g5cfvDvYqz1BC4LMGanzPaVPPBmwbapa,fbPkOYLVPtPgIt0MxizjfFJov3JbHyAi,35,28,22,0,17,4,10,0,81,11.571428571428571,4,0.0,2,22,0,17,26,4,0,10,0,41,40,0
6417,137429,JdJ1SwT93OWgPbpS5GdJzD3RLASaE4SR,fbPkOYLVPtPgIt0MxizjfFJov3JbHyAi,6,6,2,0,2,1,1,0,12,1.7142857142857142,1,0.0,1,2,0,2,5,1,0,1,0,5,7,1
6418,137431,c9KdNBnieysx6xfzwOvt0c21meENYGDu,fbPkOYLVPtPgIt0MxizjfFJov3JbHyAi,1,0,0,0,0,0,4,0,4,0.5714285714285714,1,0.0,0,0,0,0,0,0,0,4,0,0,4,1
6419,137434,ibNm0O3c3f87o7PAtnGdJbl2Dgr9gb8M,fbPkOYLVPtPgIt0MxizjfFJov3JbHyAi,13,9,4,0,4,1,7,1,26,3.7142857142857144,1,0.0,0,4,0,4,9,1,0,7,1,8,18,1
6420,137438,fE8AsLCA0TCwN2lFIpEAgt949Oz2zi2M,fbPkOYLVPtPgIt0MxizjfFJov3JbHyAi,5,6,1,0,1,0,2,0,10,1.4285714285714286,1,0.0,4,1,0,1,2,0,0,2,0,6,4,1
6421,137440,zHooznrj1lbipo0SwGxaARgac1BP3h4H,fbPkOYLVPtPgIt0MxizjfFJov3JbHyAi,37,75,32,48,15,5,13,0,188,26.857142857142858,3,0.0,19,32,42,15,56,5,6,13,0,108,80,1
6422,137443,HHjw6PARN0UbkiffbOwvG4RULtVIyY0R,fbPkOYLVPtPgIt0MxizjfFJov3JbHyAi,9,7,5,0,4,14,3,0,33,4.714285714285714,1,0.0,0,5,0,4,7,14,0,3,0,9,24,1
6423,137446,qqhQVv0ytFz6QcrUJzKAl8hETJ9ZzkHe,fbPkOYLVPtPgIt0MxizjfFJov3JbHyAi,6,3,2,0,2,0,1,0,8,1.1428571428571428,1,0.0,0,2,0,2,3,0,0,1,0,4,4,1
6424,137449,NRHQ3tSUEv4DHf8jZg8RV7YWaKkLB0Yk,fbPkOYLVPtPgIt0MxizjfFJov3JbHyAi,7,3,1,0,1,0,9,0,14,2.0,1,0.0,0,1,0,1,3,0,0,9,0,2,12,1
6425,137451,aIezEPAtj2Pok0cm2TtbLS3CmQjoEYqT,fbPkOYLVPtPgIt0MxizjfFJov3JbHyAi,2,0,0,0,0,0,4,0,4,0.5714285714285714,1,0.0,0,0,0,0,0,0,0,4,0,0,4,1
6426,137453,gSg4PIaWl0hBhOgVlpN9o8YrQn4pTOeq,fbPkOYLVPtPgIt0MxizjfFJov3JbHyAi,9,12,7,0,2,1,4,0,26,3.7142857142857144,1,0.0,1,7,0,2,11,1,0,4,0,10,16,1
6427,138176,dFJ5slXqGymdZnNlAUvtsyJDritH7dGq,7GRhBDsirIGkRZBtSMEzNTyDr2JQm4xx,9,24,1,14,0,2,1,0,42,6.0,1,0.0,18,1,14,0,6,2,0,1,0,33,9,1
6428,138202,JvCyyatgxKHz9VFtDJVVBL31IMYHuDOZ,7GRhBDsirIGkRZBtSMEzNTyDr2JQm4xx,4,2,0,0,0,0,3,0,5,0.7142857142857143,1,0.0,0,0,0,0,2,0,0,3,0,0,5,1
6429,138204,oanYJczRVsQsFyE3TEwPYW17rzmwBQIL,7GRhBDsirIGkRZBtSMEzNTyDr2JQm4xx,5,4,1,0,1,0,1,0,7,1.0,1,0.0,0,1,0,1,4,0,0,1,0,2,5,1
6430,138214,adfbW7xBPY784GRXAIq3fInFogIbD6ro,7GRhBDsirIGkRZBtSMEzNTyDr2JQm4xx,24,34,13,32,0,0,2,0,81,11.571428571428571,2,0.0,19,13,29,0,15,0,3,2,0,61,20,0
6431,138226,xBRGHAvkTfDDok4cH7N9aC7OMTMv6n3O,7GRhBDsirIGkRZBtSMEzNTyDr2JQm4xx,9,4,3,0,3,0,3,0,13,1.8571428571428572,1,0.0,0,3,0,3,4,0,0,3,0,6,7,1
6432,138239,JEJrnVrKGVjrX2yiet4Z0AOP8Myw4oGI,7GRhBDsirIGkRZBtSMEzNTyDr2JQm4xx,1,0,0,0,0,0,1,0,1,0.14285714285714285,1,0.0,0,0,0,0,0,0,0,1,0,0,1,1
6433,138243,DKNUSy56RJeSuYO3Dp6WYMwUBdoAcQ0a,7GRhBDsirIGkRZBtSMEzNTyDr2JQm4xx,5,2,1,0,1,0,3,0,7,1.0,2,0.0,0,1,0,1,2,0,0,3,0,2,5,1
6434,138250,szmVnhPypUPoSdN8Z8D02a6M8Gjrnwmf,A3fsA9Zfv1X2fVEQhTw51lKENdNrEqT3,65,42,29,162,19,0,7,0,259,37.0,5,0.0,4,29,136,19,38,0,26,7,0,188,71,1
6435,138261,JL9rcevmVnCXKLKkXE87B1mrZmlYAcd1,SpATywNh6bZuzm8s1ceuBUnMUAeoAHHw,32,59,28,28,11,48,21,1,196,28.0,7,0.0,19,28,25,11,40,48,3,21,1,83,113,0
6436,138287,UJP97i2EJO4yjxI3DoA9AGA9qgzPRSeL,SpATywNh6bZuzm8s1ceuBUnMUAeoAHHw,13,20,4,5,1,0,11,8,49,7.0,4,0.0,0,4,5,1,20,0,0,11,8,10,39,0
6437,138343,ekYJdZlodJJPGitBh9pJscwF42WGcv9J,SpATywNh6bZuzm8s1ceuBUnMUAeoAHHw,4,2,1,0,0,0,2,0,5,0.7142857142857143,1,0.0,0,1,0,0,2,0,0,2,0,1,4,1
6438,138357,NWaycxyjC99lvvlBzZhN9tb7U8fdoRvb,SpATywNh6bZuzm8s1ceuBUnMUAeoAHHw,17,31,11,16,3,32,16,0,109,15.571428571428571,2,0.0,17,11,14,3,14,32,2,16,0,45,64,0
6439,138385,R6r85AVni0tNGUvDSXb5ztmJaVo4FSr1,G8EPVSXsOYB5YQWZGiz1aVq5Pgr2GrQu,14,10,1,12,2,0,3,0,28,4.0,1,0.0,7,1,6,2,3,0,6,3,0,16,12,0
6440,138392,U1Nl2HcAAPdRP1Sw1krEueSkSr1F7plD,7GRhBDsirIGkRZBtSMEzNTyDr2JQm4xx,21,28,17,0,12,1,10,1,69,9.857142857142858,2,0.0,1,17,0,12,27,1,0,10,1,30,39,1
6441,138411,MF5edVvM6lCZDxnMdHelos9TUh3KERjn,G8EPVSXsOYB5YQWZGiz1aVq5Pgr2GrQu,5,2,1,0,1,0,3,0,7,1.0,2,0.0,0,1,0,1,2,0,0,3,0,2,5,1
6442,138422,PBT0xI17u81InQO08yLXpu6kSLQPC6l6,SpATywNh6bZuzm8s1ceuBUnMUAeoAHHw,25,39,4,36,2,2,16,0,99,14.142857142857142,7,0.0,7,4,29,2,32,2,7,16,0,42,57,0
6443,138491,NXEwBXbU6vvce77sujWgRB6LivhFJvRb,7GRhBDsirIGkRZBtSMEzNTyDr2JQm4xx,6,6,3,0,1,0,4,0,14,2.0,3,0.0,0,3,0,1,6,0,0,4,0,4,10,1
6444,138496,mSXZKJ9e3RCTXopgrFUphpxYgeKp7tlG,SpATywNh6bZuzm8s1ceuBUnMUAeoAHHw,19,40,16,8,3,1,11,1,80,11.428571428571429,4,0.0,14,16,8,3,26,1,0,11,1,41,39,0
6445,138518,SVfMOf78rQIhc5bUdZbaTCmOKKmn1NJW,7GRhBDsirIGkRZBtSMEzNTyDr2JQm4xx,1,0,0,0,0,0,1,0,1,0.14285714285714285,1,0.0,0,0,0,0,0,0,0,1,0,0,1,1
6446,138554,Px8gWLqn4P0S59C09B0pkBi24hj9iKEG,7GRhBDsirIGkRZBtSMEzNTyDr2JQm4xx,14,17,6,7,3,0,19,0,52,7.428571428571429,5,0.0,5,6,4,3,12,0,3,19,0,18,34,1
6447,138602,TlFcqTzRzzK0wdjPXKgY6Grw7xbgRspB,7GRhBDsirIGkRZBtSMEzNTyDr2JQm4xx,1,0,0,0,0,0,1,0,1,0.14285714285714285,1,0.0,0,0,0,0,0,0,0,1,0,0,1,1
6448,138613,ONe4iInwtHkZ5gtlbWN831JopVHbaD8L,G8EPVSXsOYB5YQWZGiz1aVq5Pgr2GrQu,2,0,0,0,0,0,2,0,2,0.2857142857142857,1,0.0,0,0,0,0,0,0,0,2,0,0,2,1
6449,138643,QiZHycbjNbbRnz73j2CxBu0cfmT0MxFq,7GRhBDsirIGkRZBtSMEzNTyDr2JQm4xx,2,0,0,0,0,0,2,0,2,0.2857142857142857,1,0.0,0,0,0,0,0,0,0,2,0,0,2,1
6450,138644,klFfeIWt13kJyzZ8QBX8igiJe3NNykgD,SpATywNh6bZuzm8s1ceuBUnMUAeoAHHw,11,22,11,18,3,9,3,0,66,9.428571428571429,3,0.0,7,11,15,3,15,9,3,3,0,36,30,1
6451,138785,O1Ztz9KIKs4JpSImKRRrzfUM0dpj0hIe,SpATywNh6bZuzm8s1ceuBUnMUAeoAHHw,17,30,1,41,0,49,10,0,131,18.714285714285715,2,0.0,11,1,33,0,19,49,8,10,0,45,86,0
6452,138800,OhEerYX6jubgMlujry1FJzH6tFAkAkV2,7GRhBDsirIGkRZBtSMEzNTyDr2JQm4xx,7,4,1,0,0,3,4,1,13,1.8571428571428572,1,0.0,0,1,0,0,4,3,0,4,1,1,12,1
6453,138818,okqN4nBVKRYYrkYonKicKGOmPqVGYjZh,RXDvfPUBYFlVdlueBFbLW0mhhAyGEqpt,7,11,4,0,0,0,13,0,28,4.0,3,0.0,0,4,0,0,11,0,0,13,0,4,24,0
6454,138839,AYb0mQx5aj7cvHvgDba3CV4jlkuCTKMg,7GRhBDsirIGkRZBtSMEzNTyDr2JQm4xx,4,2,0,0,0,0,2,0,4,0.5714285714285714,1,0.0,0,0,0,0,2,0,0,2,0,0,4,1
6455,138865,AYiGvgKDaGiBpYEcJ7Espvi6dQy2aiFd,SpATywNh6bZuzm8s1ceuBUnMUAeoAHHw,22,71,7,20,0,2,8,1,109,15.571428571428571,5,0.0,29,7,20,0,42,2,0,8,1,56,53,0
6456,138900,bHqXWqN9pt89j5bH9fnt5jMZVOQZImRj,7GRhBDsirIGkRZBtSMEzNTyDr2JQm4xx,1,0,0,0,0,0,1,0,1,0.14285714285714285,1,0.0,0,0,0,0,0,0,0,1,0,0,1,1
6457,138947,2Ueq99WOxFkvLjKvdAbi1TRY9isnfhGR,SpATywNh6bZuzm8s1ceuBUnMUAeoAHHw,8,6,4,0,3,2,3,0,18,2.5714285714285716,2,0.0,2,4,0,3,4,2,0,3,0,9,9,1
6458,138957,LDYjWqhrIxv22jlLe9In731UT9Ne6fvw,SpATywNh6bZuzm8s1ceuBUnMUAeoAHHw,26,17,9,15,7,3,24,0,75,10.714285714285714,9,0.0,5,9,15,7,12,3,0,24,0,36,39,1
6459,138974,ouL32O71NoAWgx7epnnVebKIsbBDnj9P,SpATywNh6bZuzm8s1ceuBUnMUAeoAHHw,17,34,14,19,9,50,18,4,148,21.142857142857142,2,0.0,9,14,15,9,25,50,4,18,4,47,101,0
6460,139004,aKtqxPEfMnVhEPAMX3aHrnYTfbYN9i8f,A3fsA9Zfv1X2fVEQhTw51lKENdNrEqT3,6,3,0,0,0,3,5,0,11,1.5714285714285714,1,0.0,0,0,0,0,3,3,0,5,0,0,11,1
6461,139006,3wXMZkXBm1ATxVfwmh0YqzBsBRzhFw8P,SpATywNh6bZuzm8s1ceuBUnMUAeoAHHw,18,20,11,16,4,0,12,1,64,9.142857142857142,2,0.0,6,11,14,4,14,0,2,12,1,35,29,0
6462,139071,a7ZVMpb0c7CARO4liNTBsp4hgkFIkG4C,A3fsA9Zfv1X2fVEQhTw51lKENdNrEqT3,10,8,6,0,3,10,5,0,32,4.571428571428571,2,0.0,0,6,0,3,8,10,0,5,0,9,23,1
6463,139081,AUQbcN6sP8jOc3r7pDcomR6R8baoxLvG,RXDvfPUBYFlVdlueBFbLW0mhhAyGEqpt,73,151,93,200,28,10,29,2,513,73.28571428571429,8,0.0,37,93,175,28,114,10,25,29,2,333,180,0
6464,139085,heVJWbQBtCN8obfXQBAbcR0I5MnOvCPs,G8EPVSXsOYB5YQWZGiz1aVq5Pgr2GrQu,84,141,52,173,29,13,40,10,458,65.42857142857143,8,0.0,48,52,133,29,93,13,40,40,10,262,196,0
6465,139134,tS8frxV0M3TGWaoIiOl49ThYexkN4UpR,7GRhBDsirIGkRZBtSMEzNTyDr2JQm4xx,8,14,5,0,3,0,7,0,29,4.142857142857143,3,0.0,0,5,0,3,14,0,0,7,0,8,21,1
6466,139241,mR38LOzPkDgy4Z7CZO92yHt4TSlNwfzC,A3fsA9Zfv1X2fVEQhTw51lKENdNrEqT3,1,0,0,0,0,0,2,0,2,0.2857142857142857,1,0.0,0,0,0,0,0,0,0,2,0,0,2,1
6467,139243,St6usTSSgX5U9v7wchuMWqmBKoCcDwN2,7GRhBDsirIGkRZBtSMEzNTyDr2JQm4xx,2,0,0,0,0,0,2,0,2,0.2857142857142857,1,0.0,0,0,0,0,0,0,0,2,0,0,2,1
6468,139302,mFcnZc9xJHpcsnNSqrnt1TraJ39cAeOG,SpATywNh6bZuzm8s1ceuBUnMUAeoAHHw,19,30,5,6,2,5,14,1,63,9.0,2,0.0,2,5,5,2,28,5,1,14,1,14,49,0
6469,139312,vlarE7zCdES78rsfbZ9s0PTdwVr1rAk4,A3fsA9Zfv1X2fVEQhTw51lKENdNrEqT3,16,44,5,0,4,1,10,3,67,9.571428571428571,4,0.0,1,5,0,4,43,1,0,10,3,10,57,1
6470,139354,QXg7RHDSlJliIBbIO3xqJ8cmekKDZLIJ,7GRhBDsirIGkRZBtSMEzNTyDr2JQm4xx,8,9,5,0,0,0,4,0,18,2.5714285714285716,1,0.0,1,5,0,0,8,0,0,4,0,6,12,1
6471,139391,iLtON4OdzeG1y617iqhiryM9G4xoGAr5,SpATywNh6bZuzm8s1ceuBUnMUAeoAHHw,21,59,18,75,3,33,27,4,219,31.285714285714285,3,0.0,32,18,66,3,27,33,9,27,4,119,100,0
6472,139479,cDV3uv01OqR28HAw8WapmztMslx9jbkZ,A3fsA9Zfv1X2fVEQhTw51lKENdNrEqT3,9,12,5,0,0,1,8,1,27,3.857142857142857,3,0.0,1,5,0,0,11,1,0,8,1,6,21,1
6473,139497,CQdAGcIvDdIBklDWFKtch5fpBdl4NTjN,SpATywNh6bZuzm8s1ceuBUnMUAeoAHHw,17,27,13,18,4,0,6,1,69,9.857142857142858,2,0.0,10,13,14,4,17,0,4,6,1,41,28,1
6474,139502,hLHRmItIrBAAjPponbejbmcuRqVRIxcd,G8EPVSXsOYB5YQWZGiz1aVq5Pgr2GrQu,30,44,10,62,8,1,7,1,133,19.0,1,0.0,32,10,42,8,12,1,20,7,1,92,41,1
6475,139575,j4fKJGSFGeDK8KfTLiburPdJXY2cNIyf,7GRhBDsirIGkRZBtSMEzNTyDr2JQm4xx,5,2,1,0,1,0,2,0,6,0.8571428571428571,1,0.0,0,1,0,1,2,0,0,2,0,2,4,1
6476,139625,NHjxa47feJ9sWQnmg6HoO6L78eHIRwnl,7GRhBDsirIGkRZBtSMEzNTyDr2JQm4xx,1,0,0,0,0,0,4,0,4,0.5714285714285714,2,0.0,0,0,0,0,0,0,0,4,0,0,4,0
6477,139640,S33lH053HmB7Cz0IWipiL27cwx1QXBWr,7GRhBDsirIGkRZBtSMEzNTyDr2JQm4xx,3,2,0,0,0,0,1,0,3,0.42857142857142855,1,0.0,0,0,0,0,2,0,0,1,0,0,3,1
6478,139657,eC4StSuQwImpW962lXYQQlRlP4Dxmsjm,7GRhBDsirIGkRZBtSMEzNTyDr2JQm4xx,2,0,0,0,0,0,2,0,2,0.2857142857142857,1,0.0,0,0,0,0,0,0,0,2,0,0,2,1
6479,139701,bDbKEMrZzcFQTQT7Qrji0QYF25s6ADsY,7GRhBDsirIGkRZBtSMEzNTyDr2JQm4xx,1,0,0,0,0,0,1,0,1,0.14285714285714285,1,0.0,0,0,0,0,0,0,0,1,0,0,1,1
6480,139721,YI82gOPk3osjTxu9r38iyjq6I3W2WIaD,RXDvfPUBYFlVdlueBFbLW0mhhAyGEqpt,13,11,8,0,5,0,4,0,28,4.0,2,0.0,0,8,0,5,11,0,0,4,0,13,15,0
6481,140092,Kj9Et9zogxYDw98nFXPSMQhkkCBlhXs5,7GRhBDsirIGkRZBtSMEzNTyDr2JQm4xx,2,0,0,0,0,0,3,0,3,0.42857142857142855,2,0.0,0,0,0,0,0,0,0,3,0,0,3,1
6482,140220,D0DS3PcqkWtMhWmrWYDI3H9xnPeFgKco,7GRhBDsirIGkRZBtSMEzNTyDr2JQm4xx,6,8,3,0,0,0,4,0,15,2.142857142857143,2,0.0,2,3,0,0,6,0,0,4,0,5,10,1
6483,140241,Un3EzEE4Sz8i5Z84q9e50URbIAEkkVSB,7GRhBDsirIGkRZBtSMEzNTyDr2JQm4xx,2,0,0,0,0,0,3,0,3,0.42857142857142855,1,0.0,0,0,0,0,0,0,0,3,0,0,3,1
6484,140247,R9YTqKiRQtfCswOmsq4jluMVxY0uToJG,7GRhBDsirIGkRZBtSMEzNTyDr2JQm4xx,40,43,18,20,9,3,10,1,104,14.857142857142858,2,0.0,23,18,18,9,20,3,2,10,1,68,36,0
6485,140274,fb2hdXt8pnk8ljm4Tpi5PWJyJ7R8YxLU,7GRhBDsirIGkRZBtSMEzNTyDr2JQm4xx,11,9,3,0,3,0,3,0,18,2.5714285714285716,1,0.0,0,3,0,3,9,0,0,3,0,6,12,1
6486,140288,MdVSD7oG0mERo7XaQwvRtC5hdVN6DJiQ,7GRhBDsirIGkRZBtSMEzNTyDr2JQm4xx,11,9,1,0,3,0,2,0,15,2.142857142857143,1,0.0,3,1,0,3,6,0,0,2,0,7,8,0
6487,140333,bqWpav7ocOhCfb3xc4QgAvBDK5g8BmiZ,7GRhBDsirIGkRZBtSMEzNTyDr2JQm4xx,52,77,33,45,25,0,13,0,193,27.571428571428573,7,0.0,32,33,39,25,45,0,6,13,0,129,64,1
6488,140338,vixag6bpwzwtdrSKIAHFpP8XohE3IVGO,7GRhBDsirIGkRZBtSMEzNTyDr2JQm4xx,66,127,43,158,25,52,25,0,430,61.42857142857143,5,0.0,38,43,133,25,89,52,25,25,0,239,191,0
6489,140362,DpqUZKEZpIFvZzvEXk8oaJMRAbEfypNN,7GRhBDsirIGkRZBtSMEzNTyDr2JQm4xx,18,11,8,0,9,0,8,0,36,5.142857142857143,3,0.0,3,8,0,9,8,0,0,8,0,20,16,1
6490,140518,PMkZTQovf4dyR4mK2UbNwrhFIlkDMtO5,7GRhBDsirIGkRZBtSMEzNTyDr2JQm4xx,3,2,0,0,0,0,1,0,3,0.42857142857142855,1,0.0,0,0,0,0,2,0,0,1,0,0,3,1
6491,140555,TfgVRC9skFsGu3qq14caEQmfjmrp7rot,7GRhBDsirIGkRZBtSMEzNTyDr2JQm4xx,1,0,0,0,0,0,1,0,1,0.14285714285714285,1,0.0,0,0,0,0,0,0,0,1,0,0,1,1
6492,140571,PQkWevD3d0oRYo5mywsIaSsfEsqdcqoj,7GRhBDsirIGkRZBtSMEzNTyDr2JQm4xx,6,2,1,0,1,0,3,0,7,1.0,1,0.0,0,1,0,1,2,0,0,3,0,2,5,1
6493,140586,H7wQq68VgsnXYKOgXKXD2z0yXvbrWDzD,7GRhBDsirIGkRZBtSMEzNTyDr2JQm4xx,2,0,0,0,0,0,2,0,2,0.2857142857142857,1,0.0,0,0,0,0,0,0,0,2,0,0,2,1
6494,140606,RthO8kTkOrnZ3vUDn574hHyfG3vroBt1,7GRhBDsirIGkRZBtSMEzNTyDr2JQm4xx,10,15,9,0,4,0,8,0,36,5.142857142857143,1,0.0,2,9,0,4,13,0,0,8,0,15,21,0
6495,140625,4f8jLRXqSCdB2uiZvxNaCELloSkIP9xi,7GRhBDsirIGkRZBtSMEzNTyDr2JQm4xx,1,0,0,0,0,0,1,0,1,0.14285714285714285,1,0.0,0,0,0,0,0,0,0,1,0,0,1,1
6496,140631,ah26WailHR7EV3M12BWTgtjGcr75lRFT,7GRhBDsirIGkRZBtSMEzNTyDr2JQm4xx,7,4,1,18,0,0,2,0,25,3.5714285714285716,1,0.0,1,1,16,0,3,0,2,2,0,18,7,1
6497,140709,98UEGByxiN7tned6NDQeKfQDq4HCSGvQ,7GRhBDsirIGkRZBtSMEzNTyDr2JQm4xx,5,2,1,0,1,0,2,0,6,0.8571428571428571,1,0.0,0,1,0,1,2,0,0,2,0,2,4,1
6498,143586,o2z1lYhmt3dNuWADVCZXyE0sw3eHFzWq,G8EPVSXsOYB5YQWZGiz1aVq5Pgr2GrQu,12,3,2,6,1,1,6,1,20,2.857142857142857,1,0.0,0,2,5,1,3,1,1,6,1,8,12,1
6499,143589,z7uFh58nBoces7c1gc4iOr2l4NXGSjok,SpATywNh6bZuzm8s1ceuBUnMUAeoAHHw,19,25,11,27,1,0,12,0,76,10.857142857142858,2,0.0,7,11,27,1,18,0,0,12,0,46,30,0
6500,143599,43nq30xhRsgmZVAWkH8Zjb7IyZDGRDeY,A3fsA9Zfv1X2fVEQhTw51lKENdNrEqT3,6,4,1,0,0,0,3,0,8,1.1428571428571428,1,0.0,0,1,0,0,4,0,0,3,0,1,7,1
6501,143601,tXegIvrCsh9OUalSxRPl6DBhe0HWN5J1,bWdj2GDclj5ofokWjzoa5jAwMkxCykd6,4,2,0,0,0,0,4,0,6,0.8571428571428571,1,0.0,0,0,0,0,2,0,0,4,0,0,6,1
6502,143612,MKvKDEIiF4MpIyn9vn0Yw7gT3feDOAo3,bWdj2GDclj5ofokWjzoa5jAwMkxCykd6,3,2,0,0,0,0,1,0,3,0.42857142857142855,1,0.0,0,0,0,0,2,0,0,1,0,0,3,1
6503,143618,SAdK4BrTbltHilVBy10zBoad8iM8mXa4,G8EPVSXsOYB5YQWZGiz1aVq5Pgr2GrQu,12,19,10,0,10,12,9,0,60,8.571428571428571,1,0.0,2,10,0,10,17,12,0,9,0,22,38,0
6504,143632,BFi14w12zqsNleSplrknYhvmJy8GL2FY,bWdj2GDclj5ofokWjzoa5jAwMkxCykd6,18,27,8,44,5,0,5,0,89,12.714285714285714,2,0.0,9,8,37,5,18,0,7,5,0,59,30,1
6505,143636,HwdB7Xtsh4qUznoQGIINfFO0z6SlgPWN,G8EPVSXsOYB5YQWZGiz1aVq5Pgr2GrQu,7,3,2,0,1,0,4,0,10,1.4285714285714286,1,0.0,0,2,0,1,3,0,0,4,0,3,7,1
6506,143646,BQAHxDKbPTX2OmvOEbIJrtNWABd3lWzF,G8EPVSXsOYB5YQWZGiz1aVq5Pgr2GrQu,84,107,30,203,18,9,22,2,391,55.857142857142854,4,0.0,58,30,152,18,49,9,51,22,2,258,133,1
6507,143658,qCIGCxbEF5IZjc2KbYsE1TkH5yxiGth5,SpATywNh6bZuzm8s1ceuBUnMUAeoAHHw,17,32,2,12,1,1,13,0,61,8.714285714285714,6,0.0,8,2,11,1,24,1,1,13,0,22,39,1
6508,143662,rZhamd6VgzDuUbGwNlJUwteIExfrDmL0,SpATywNh6bZuzm8s1ceuBUnMUAeoAHHw,27,35,23,12,15,0,4,0,89,12.714285714285714,2,0.0,8,23,12,15,27,0,0,4,0,58,31,1
6509,143663,DtdInjZr4k2oFve3KkbkHNxJxR1ugIKn,SpATywNh6bZuzm8s1ceuBUnMUAeoAHHw,9,5,1,0,1,2,8,2,19,2.7142857142857144,2,0.0,1,1,0,1,4,2,0,8,2,3,16,1
6510,143674,7lzEjeizq2WryXPCFV63iiJ0sRC0XsD5,A3fsA9Zfv1X2fVEQhTw51lKENdNrEqT3,3,2,0,0,0,0,1,0,3,0.42857142857142855,1,0.0,0,0,0,0,2,0,0,1,0,0,3,1
6511,143678,P1PW7aZzx8NF90gRnrYjkf5ZxxKRlBng,SpATywNh6bZuzm8s1ceuBUnMUAeoAHHw,30,97,53,37,12,78,58,14,349,49.857142857142854,5,0.0,13,53,30,12,84,78,7,58,14,108,241,1
6512,143685,s2CLgeYgKwvHdG0n6HyjEsmd9rHYgz53,RXDvfPUBYFlVdlueBFbLW0mhhAyGEqpt,45,42,17,109,9,10,9,2,198,28.285714285714285,3,0.0,11,17,102,9,31,10,7,9,2,139,59,1
6513,143686,xhoMHYDn0DYj6NEexX867ukahPmWhSwf,bWdj2GDclj5ofokWjzoa5jAwMkxCykd6,14,16,8,0,7,0,6,0,37,5.285714285714286,2,0.0,5,8,0,7,11,0,0,6,0,20,17,1
6514,143701,BCr2GOpOyeEKOuzlRV7PJCL1CEnRyr6Q,G8EPVSXsOYB5YQWZGiz1aVq5Pgr2GrQu,19,18,12,0,9,0,8,1,48,6.857142857142857,3,0.0,3,12,0,9,15,0,0,8,1,24,24,1
6515,143729,YITGGXKhxzNHdElox232lzcaZdJ61YFn,G8EPVSXsOYB5YQWZGiz1aVq5Pgr2GrQu,9,10,2,0,2,0,5,0,19,2.7142857142857144,3,0.0,0,2,0,2,10,0,0,5,0,4,15,1
6516,143753,BFi14w12zqsNleSplrknYhvmJy8GL2FY,SpATywNh6bZuzm8s1ceuBUnMUAeoAHHw,6,10,3,0,1,0,2,0,16,2.2857142857142856,2,0.0,4,3,0,1,6,0,0,2,0,8,8,1
6517,143757,CNd98TtnFYCKW8sIKXbo0EVDlFn0r29F,SpATywNh6bZuzm8s1ceuBUnMUAeoAHHw,14,14,7,12,3,1,5,0,42,6.0,2,0.0,2,7,10,3,12,1,2,5,0,22,20,1
6518,143759,qjm8uLcDpLtNxtPMuyI6LdPbp6n70fuZ,bWdj2GDclj5ofokWjzoa5jAwMkxCykd6,6,2,1,0,0,0,4,1,8,1.1428571428571428,1,0.0,0,1,0,0,2,0,0,4,1,1,7,1
6519,143765,UI53aostODbFE1SZneA6yZKpOYnaewLS,G8EPVSXsOYB5YQWZGiz1aVq5Pgr2GrQu,19,8,7,20,6,0,2,0,43,6.142857142857143,1,0.0,0,7,15,6,8,0,5,2,0,28,15,1
6520,143775,kJR7SORW78mX9yl9TvMAdIrYcwnnZz4r,RXDvfPUBYFlVdlueBFbLW0mhhAyGEqpt,2,0,0,0,0,0,2,0,2,0.2857142857142857,1,0.0,0,0,0,0,0,0,0,2,0,0,2,1
6521,143785,OStdVLf6yEEZ6snmnFowdmcaKWpdnJbL,RXDvfPUBYFlVdlueBFbLW0mhhAyGEqpt,1,0,0,0,0,0,1,0,1,0.14285714285714285,1,0.0,0,0,0,0,0,0,0,1,0,0,1,1
6522,143812,ee58foeX64HQVEJT3urOlMI7BjSHbs8j,SpATywNh6bZuzm8s1ceuBUnMUAeoAHHw,15,20,1,12,0,0,14,3,50,7.142857142857143,4,0.0,5,1,11,0,15,0,1,14,3,17,33,1
6523,143813,GJGZOa9ckBlFcfojmDXHYkGGywyzKOaN,SpATywNh6bZuzm8s1ceuBUnMUAeoAHHw,23,33,1,36,1,70,28,6,175,25.0,6,0.0,15,1,33,1,18,70,3,28,6,50,125,1
6524,143822,kfS0nefl4PODD2Wbg3xDtahejAoyK8Co,RXDvfPUBYFlVdlueBFbLW0mhhAyGEqpt,73,68,45,133,23,69,12,1,351,50.142857142857146,5,0.0,13,45,123,23,55,69,10,12,1,204,147,0
6525,143829,wBxOvXavxcvDHQtsCbkdt1VRzmB8Qh9E,A3fsA9Zfv1X2fVEQhTw51lKENdNrEqT3,1,0,0,0,0,0,1,0,1,0.14285714285714285,1,0.0,0,0,0,0,0,0,0,1,0,0,1,1
6526,143836,GmLQtlg8yrQT4o49Mau9FkoR2KxlaFCK,A3fsA9Zfv1X2fVEQhTw51lKENdNrEqT3,3,0,0,0,0,1,5,0,6,0.8571428571428571,1,0.0,0,0,0,0,0,1,0,5,0,0,6,1
6527,143845,JlEwtKnXvqCWlVkvWLsPOkSZfN8DgLlO,SpATywNh6bZuzm8s1ceuBUnMUAeoAHHw,8,9,3,0,1,0,3,0,16,2.2857142857142856,1,0.0,1,3,0,1,8,0,0,3,0,5,11,1
6528,143846,i0sekElajxS5N9A9gI4ciPHJzCFHyEzA,SpATywNh6bZuzm8s1ceuBUnMUAeoAHHw,7,4,2,0,2,0,1,0,9,1.2857142857142858,1,0.0,0,2,0,2,4,0,0,1,0,4,5,1
6529,143852,6pc1PztS8sMKmk9TBeVVlDzbAlFBojkU,bWdj2GDclj5ofokWjzoa5jAwMkxCykd6,4,2,1,0,1,0,1,0,5,0.7142857142857143,1,0.0,0,1,0,1,2,0,0,1,0,2,3,1
6530,143871,i0Fe8GkgETgJLYZf4oG1MMDT0SsDr0Jw,bWdj2GDclj5ofokWjzoa5jAwMkxCykd6,8,8,4,0,2,0,3,0,17,2.4285714285714284,3,0.0,0,4,0,2,8,0,0,3,0,6,11,1
6531,143878,OMrkn9SYYoJHeW009nGi3tN8klhPSmaY,G8EPVSXsOYB5YQWZGiz1aVq5Pgr2GrQu,1,0,0,0,0,0,1,0,1,0.14285714285714285,1,0.0,0,0,0,0,0,0,0,1,0,0,1,1
6532,143885,ix15aF6FOEF1waZCSZt01VrPOuPGJ3yM,A3fsA9Zfv1X2fVEQhTw51lKENdNrEqT3,17,21,1,10,1,1,2,0,36,5.142857142857143,2,0.0,0,1,10,1,21,1,0,2,0,12,24,1
6533,143903,Vd6Fw7jRvBeu91l91UPCADQJMohO1ulC,SpATywNh6bZuzm8s1ceuBUnMUAeoAHHw,13,18,1,16,1,5,7,0,48,6.857142857142857,4,0.0,5,1,13,1,13,5,3,7,0,20,28,0
6534,143914,qDW8D89X9oTRJFDDcQZTLb3PUIxnDi04,A3fsA9Zfv1X2fVEQhTw51lKENdNrEqT3,7,4,1,0,1,0,2,0,8,1.1428571428571428,1,0.0,0,1,0,1,4,0,0,2,0,2,6,1
6535,143916,YGuMlMRO0oSJvGD54x9bLYiGJQjDsQL5,G8EPVSXsOYB5YQWZGiz1aVq5Pgr2GrQu,7,8,1,6,0,3,3,0,21,3.0,1,0.0,6,1,3,0,2,3,3,3,0,10,11,1
6536,143919,0Wa2kEuzurHwd29qlJEDljKGNBFtcml7,G8EPVSXsOYB5YQWZGiz1aVq5Pgr2GrQu,6,1,1,0,1,0,3,0,6,0.8571428571428571,1,0.0,0,1,0,1,1,0,0,3,0,2,4,1
6537,143922,kjGwgryJuZFnPYPKqBQ3NNskwkNfGn3d,A3fsA9Zfv1X2fVEQhTw51lKENdNrEqT3,1,0,0,0,0,0,2,0,2,0.2857142857142857,1,0.0,0,0,0,0,0,0,0,2,0,0,2,1
6538,143926,kjGwgryJuZFnPYPKqBQ3NNskwkNfGn3d,bWdj2GDclj5ofokWjzoa5jAwMkxCykd6,7,2,0,0,0,7,6,1,16,2.2857142857142856,1,0.0,0,0,0,0,2,7,0,6,1,0,16,1
6539,143942,kS57PN5w4M8SePVOR15O2soQi4RHoCPq,SpATywNh6bZuzm8s1ceuBUnMUAeoAHHw,27,35,13,25,7,0,6,1,87,12.428571428571429,4,0.0,7,13,24,7,28,0,1,6,1,51,36,0
6540,143954,8jktIbkTyfsrxSTzXB9djfwFIqhVk9sD,G8EPVSXsOYB5YQWZGiz1aVq5Pgr2GrQu,11,8,1,0,1,0,6,0,16,2.2857142857142856,2,0.0,0,1,0,1,8,0,0,6,0,2,14,1
6541,143962,xqtF7kz0ECRMGC9cksHZcAo5S9h7Xs8O,A3fsA9Zfv1X2fVEQhTw51lKENdNrEqT3,3,3,2,0,0,0,1,0,6,0.8571428571428571,2,0.0,0,2,0,0,3,0,0,1,0,2,4,1
6542,143978,Bj8ATra8VoYTzA097NzbEns3tHpy9inW,SpATywNh6bZuzm8s1ceuBUnMUAeoAHHw,3,1,0,0,0,0,4,0,5,0.7142857142857143,2,0.0,0,0,0,0,1,0,0,4,0,0,5,1
6543,143985,VYyLsKD1rNE6IEMOVHtWy3gAcazZXSjf,SpATywNh6bZuzm8s1ceuBUnMUAeoAHHw,10,8,6,0,0,1,7,1,23,3.2857142857142856,1,0.0,0,6,0,0,8,1,0,7,1,6,17,1
6544,144002,ldTDPaSBa3R7vzg6xAgzmxomfcP7FtgG,G8EPVSXsOYB5YQWZGiz1aVq5Pgr2GrQu,7,3,0,0,0,0,4,1,8,1.1428571428571428,1,0.0,1,0,0,0,2,0,0,4,1,1,7,1
6545,144004,U62bUOUAMvRVibRWhVYvsfcC0FytLRv5,A3fsA9Zfv1X2fVEQhTw51lKENdNrEqT3,12,7,5,0,5,0,2,0,19,2.7142857142857144,2,0.0,0,5,0,5,7,0,0,2,0,10,9,1
6546,144031,LAQONTh6B8YO6fNJXryzQnYCV0hkbp2b,SpATywNh6bZuzm8s1ceuBUnMUAeoAHHw,15,21,12,8,4,0,7,0,52,7.428571428571429,3,0.0,5,12,7,4,16,0,1,7,0,28,24,1
6547,144074,JHhY30IKFzw4LWcyrHuTEglWNqRkqdDU,A3fsA9Zfv1X2fVEQhTw51lKENdNrEqT3,1,0,0,0,0,0,5,0,5,0.7142857142857143,1,0.0,0,0,0,0,0,0,0,5,0,0,5,1
6548,144077,0gS5Q732yxgOQo1BReYmVwLNG0PEmJtw,bWdj2GDclj5ofokWjzoa5jAwMkxCykd6,11,37,13,12,3,7,8,2,82,11.714285714285714,4,0.0,2,13,11,3,35,7,1,8,2,29,53,1
6549,144080,M8cV3FHZsXmaSmJz43zOWXbhj6ecftQ6,bWdj2GDclj5ofokWjzoa5jAwMkxCykd6,9,7,1,0,1,1,9,2,21,3.0,2,0.0,0,1,0,1,7,1,0,9,2,2,19,1
6550,144083,jVbyR2K2eRZglkuIyxRotkq1vJB87WuF,A3fsA9Zfv1X2fVEQhTw51lKENdNrEqT3,15,19,15,0,11,0,4,0,49,7.0,3,0.0,0,15,0,11,19,0,0,4,0,26,23,0
6551,144085,jVbyR2K2eRZglkuIyxRotkq1vJB87WuF,bWdj2GDclj5ofokWjzoa5jAwMkxCykd6,4,3,2,0,2,0,2,0,9,1.2857142857142858,2,0.0,0,2,0,2,3,0,0,2,0,4,5,1
6552,144106,Kky2aVSeER09Ccbe6jHNmsRuAd2julij,A3fsA9Zfv1X2fVEQhTw51lKENdNrEqT3,4,2,1,0,1,0,1,0,5,0.7142857142857143,1,0.0,0,1,0,1,2,0,0,1,0,2,3,1
6553,144110,ZkodedaetKv5naAeRDAkOlSxAXe0IboP,A3fsA9Zfv1X2fVEQhTw51lKENdNrEqT3,9,5,4,0,2,2,5,0,18,2.5714285714285716,1,0.0,0,4,0,2,5,2,0,5,0,6,12,1
6554,144123,VbTtM6XJ2ULINXtlzPV5CdmpUQ96Z4m1,A3fsA9Zfv1X2fVEQhTw51lKENdNrEqT3,2,0,0,0,0,0,2,0,2,0.2857142857142857,1,0.0,0,0,0,0,0,0,0,2,0,0,2,1
6555,144125,9T6sJuPiEkwFHn4VyREnKyR6Ni1hFol4,A3fsA9Zfv1X2fVEQhTw51lKENdNrEqT3,43,23,15,76,11,0,8,0,133,19.0,2,0.0,1,15,61,11,22,0,15,8,0,88,45,0
6556,144128,XFHjgUTOXGdMfDJPVsJ9fIgVszICPgyz,SpATywNh6bZuzm8s1ceuBUnMUAeoAHHw,4,2,0,0,0,0,2,0,4,0.5714285714285714,1,0.0,0,0,0,0,2,0,0,2,0,0,4,1
6557,144149,Q0aJXENLM8Ba7eSfqdpvheSc04S1CuaH,SpATywNh6bZuzm8s1ceuBUnMUAeoAHHw,2,0,0,0,0,0,2,0,2,0.2857142857142857,1,0.0,0,0,0,0,0,0,0,2,0,0,2,1
6558,144160,rukMFkuKsi65w6w0x0BTdkn9Ums9NFFL,RXDvfPUBYFlVdlueBFbLW0mhhAyGEqpt,8,3,2,0,1,1,6,1,14,2.0,2,0.0,0,2,0,1,3,1,0,6,1,3,11,1
6559,144164,OD1pqN8En0iNd52vQpaf4DwGLH3W4dof,SpATywNh6bZuzm8s1ceuBUnMUAeoAHHw,5,2,1,0,1,0,3,0,7,1.0,2,0.0,0,1,0,1,2,0,0,3,0,2,5,1
6560,144179,L1IQ56wH1SqkL7PACuNGk2Nkhk5s11JQ,SpATywNh6bZuzm8s1ceuBUnMUAeoAHHw,7,3,2,0,2,0,2,0,9,1.2857142857142858,1,0.0,0,2,0,2,3,0,0,2,0,4,5,1
6561,144183,ZG0u2uQ1GPj4pTtPSRFTX9ZynYPgcWTk,G8EPVSXsOYB5YQWZGiz1aVq5Pgr2GrQu,14,26,3,22,2,0,3,0,56,8.0,3,0.0,12,3,15,2,14,0,7,3,0,32,24,1
6562,144192,soXc1elBesZE0RSRAIRToGxlZRocKEhG,G8EPVSXsOYB5YQWZGiz1aVq5Pgr2GrQu,18,12,7,22,2,1,8,1,53,7.571428571428571,2,0.0,0,7,17,2,12,1,5,8,1,26,27,1
6563,144193,vSPx0Rg8IfOWpaATb7kkPj0mZPaLkdwk,RXDvfPUBYFlVdlueBFbLW0mhhAyGEqpt,3,2,0,0,0,0,1,0,3,0.42857142857142855,1,0.0,0,0,0,0,2,0,0,1,0,0,3,1
6564,144197,8eAVRzls7MGQwc3WaPP7ONmygmpXQE3K,A3fsA9Zfv1X2fVEQhTw51lKENdNrEqT3,7,5,3,0,2,0,1,0,11,1.5714285714285714,1,0.0,0,3,0,2,5,0,0,1,0,5,6,1
6565,144202,CLjs31mL2a4HrNzVlnTt15ZnHVg4guKy,bWdj2GDclj5ofokWjzoa5jAwMkxCykd6,5,3,1,0,1,0,3,0,8,1.1428571428571428,2,0.0,1,1,0,1,2,0,0,3,0,3,5,1
6566,144207,q8Ghyemwk98Z0FJ5i93VufZPwN70TN9G,G8EPVSXsOYB5YQWZGiz1aVq5Pgr2GrQu,2,0,0,0,0,0,2,0,2,0.2857142857142857,1,0.0,0,0,0,0,0,0,0,2,0,0,2,1
6567,144221,KkSinTdG2PbGrJIRATMZos8HES46UawO,bWdj2GDclj5ofokWjzoa5jAwMkxCykd6,9,43,10,0,8,0,6,0,67,9.571428571428571,3,0.0,13,10,0,8,30,0,0,6,0,31,36,0
6568,144226,KkSinTdG2PbGrJIRATMZos8HES46UawO,A3fsA9Zfv1X2fVEQhTw51lKENdNrEqT3,21,33,15,0,12,2,4,1,67,9.571428571428571,2,0.0,0,15,0,12,33,2,0,4,1,27,40,0
6569,144228,tLK4qfNEt0O7kdBEQmDtMwddSX278qz9,SpATywNh6bZuzm8s1ceuBUnMUAeoAHHw,2,0,0,0,0,0,2,0,2,0.2857142857142857,1,0.0,0,0,0,0,0,0,0,2,0,0,2,1
6570,144239,YCrhaujUJb2ysdJEAlnTFggfP634EwtZ,A3fsA9Zfv1X2fVEQhTw51lKENdNrEqT3,1,0,0,0,0,0,1,0,1,0.14285714285714285,1,0.0,0,0,0,0,0,0,0,1,0,0,1,1
6571,144242,asiNuyAOWs6SCiRYMsJjoOdnVeDfmCWA,A3fsA9Zfv1X2fVEQhTw51lKENdNrEqT3,7,3,0,0,0,1,8,0,12,1.7142857142857142,1,0.0,0,0,0,0,3,1,0,8,0,0,12,1
6572,144264,1La5rp9ZSz9cfpqCRJiC01Rwvuq5VVrf,A3fsA9Zfv1X2fVEQhTw51lKENdNrEqT3,13,7,4,6,3,0,4,0,24,3.4285714285714284,1,0.0,2,4,5,3,5,0,1,4,0,14,10,0
6573,144273,myIIBocNFelldmuN47bMrRiORGKDSj7S,A3fsA9Zfv1X2fVEQhTw51lKENdNrEqT3,8,4,3,0,3,0,1,0,11,1.5714285714285714,1,0.0,0,3,0,3,4,0,0,1,0,6,5,1
6574,144279,QGuKTIBC2KLaYpPdOnB4nXCWgxMM1Dog,A3fsA9Zfv1X2fVEQhTw51lKENdNrEqT3,8,4,3,0,3,0,1,0,11,1.5714285714285714,1,0.0,0,3,0,3,4,0,0,1,0,6,5,0
6575,144307,xzsDRI5lJyx0VDWOgYiu4gtqXBQyCAlZ,SpATywNh6bZuzm8s1ceuBUnMUAeoAHHw,5,2,1,0,1,0,2,0,6,0.8571428571428571,1,0.0,0,1,0,1,2,0,0,2,0,2,4,1
6576,144321,l9yVkoh4OzNZS3boMvfvu1qkbaccG6pv,SpATywNh6bZuzm8s1ceuBUnMUAeoAHHw,29,74,37,14,14,21,16,4,180,25.714285714285715,6,0.0,25,37,11,14,49,21,3,16,4,87,93,0
6577,144328,1z8xVGdONRHgttCsFcaiTYfHNmdRXPsG,SpATywNh6bZuzm8s1ceuBUnMUAeoAHHw,8,8,3,0,2,0,2,0,15,2.142857142857143,1,0.0,2,3,0,2,6,0,0,2,0,7,8,1
6578,144352,15iBXbgbmcpqKkeTya1vwlvLo9VSZF3Q,G8EPVSXsOYB5YQWZGiz1aVq5Pgr2GrQu,14,7,6,34,4,0,3,0,54,7.714285714285714,1,0.0,1,6,29,4,6,0,5,3,0,40,14,1
6579,144367,j6kVkVGKYZT7ozL2NE5rOIexD3a1ewYn,bWdj2GDclj5ofokWjzoa5jAwMkxCykd6,8,6,2,18,3,0,1,0,30,4.285714285714286,1,0.0,3,2,16,3,3,0,2,1,0,24,6,1
6580,144376,rTLMEQB78zn1g6bt6KRypanGZ8QWPbQv,bWdj2GDclj5ofokWjzoa5jAwMkxCykd6,1,0,0,0,0,0,1,0,1,0.14285714285714285,1,0.0,0,0,0,0,0,0,0,1,0,0,1,1
6581,144389,BeS19JPMXzXPGfXk6YRJuHRmyxH0T7Wj,A3fsA9Zfv1X2fVEQhTw51lKENdNrEqT3,2,0,0,0,0,0,4,0,4,0.5714285714285714,1,0.0,0,0,0,0,0,0,0,4,0,0,4,1
6582,144393,15iBXbgbmcpqKkeTya1vwlvLo9VSZF3Q,SpATywNh6bZuzm8s1ceuBUnMUAeoAHHw,2,0,0,0,0,0,2,0,2,0.2857142857142857,1,0.0,0,0,0,0,0,0,0,2,0,0,2,1
6583,144406,Y4L4Q01m86olYens1XXjwQSIKQK0VXY8,SpATywNh6bZuzm8s1ceuBUnMUAeoAHHw,11,6,5,4,3,0,1,0,19,2.7142857142857144,1,0.0,0,5,3,3,6,0,1,1,0,11,8,1
6584,144421,IH3Fpf227mcEx04r510MqQHERjzGveWM,A3fsA9Zfv1X2fVEQhTw51lKENdNrEqT3,21,31,24,0,14,1,12,0,82,11.714285714285714,4,0.0,0,24,0,14,31,1,0,12,0,38,44,1
6585,144422,6ElmeAobgOVWMQKbfyTe96fhVbG33C2X,G8EPVSXsOYB5YQWZGiz1aVq5Pgr2GrQu,1,0,0,0,0,0,1,0,1,0.14285714285714285,1,0.0,0,0,0,0,0,0,0,1,0,0,1,1
6586,144429,tVItbLut2hv4GIKzxM0DVZ7s3PzDPaT6,RXDvfPUBYFlVdlueBFbLW0mhhAyGEqpt,1,0,0,0,0,0,1,0,1,0.14285714285714285,1,0.0,0,0,0,0,0,0,0,1,0,0,1,1
6587,144439,7WYyQ5o657nnaDs90V9cVaz7JKBLQO6T,bWdj2GDclj5ofokWjzoa5jAwMkxCykd6,12,10,4,34,4,0,6,0,58,8.285714285714286,1,0.0,4,4,33,4,6,0,1,6,0,45,13,1
6588,144443,OocLfrCOBb0PIIRDKMfTM554g3aeKj99,A3fsA9Zfv1X2fVEQhTw51lKENdNrEqT3,9,4,3,0,3,0,2,0,12,1.7142857142857142,1,0.0,0,3,0,3,4,0,0,2,0,6,6,1
6589,144455,uzKo5XybDLGWG8pNxiIda7r0TfSQ9SeA,A3fsA9Zfv1X2fVEQhTw51lKENdNrEqT3,10,7,6,0,6,0,1,0,20,2.857142857142857,1,0.0,0,6,0,6,7,0,0,1,0,12,8,1
6590,144460,QhamLDlsBIMrNG9NsQtpJBjMOuVLF7Tg,SpATywNh6bZuzm8s1ceuBUnMUAeoAHHw,1,0,0,0,0,0,1,0,1,0.14285714285714285,1,0.0,0,0,0,0,0,0,0,1,0,0,1,1
6591,144462,98Rmjqd0huhIhiHJIK65vNiEBdUVwDLb,bWdj2GDclj5ofokWjzoa5jAwMkxCykd6,1,0,0,0,0,0,1,0,1,0.14285714285714285,1,0.0,0,0,0,0,0,0,0,1,0,0,1,1
6592,144505,XYAJcmpULCxF9eHnylLtZOUd3WBca1G2,SpATywNh6bZuzm8s1ceuBUnMUAeoAHHw,6,4,1,0,1,0,4,0,10,1.4285714285714286,1,0.0,0,1,0,1,4,0,0,4,0,2,8,1
6593,144510,M8d3qfut8VxaqPRwVms9OlOmOpQg63xG,SpATywNh6bZuzm8s1ceuBUnMUAeoAHHw,18,56,11,18,4,29,21,4,143,20.428571428571427,2,0.0,23,11,15,4,33,29,3,21,4,53,90,1
6594,144511,XqxXHlwlYxd9RSTeUV9pBamG1DPgHOIg,G8EPVSXsOYB5YQWZGiz1aVq5Pgr2GrQu,7,9,3,4,2,0,2,0,20,2.857142857142857,1,0.0,4,3,3,2,5,0,1,2,0,12,8,1
6595,144515,g3liImBcMScJKznyarQ0IVXqD3a9da64,bWdj2GDclj5ofokWjzoa5jAwMkxCykd6,2,0,0,0,0,0,2,0,2,0.2857142857142857,1,0.0,0,0,0,0,0,0,0,2,0,0,2,1
6596,144523,a47rhYVhWUpsdxtGQACB0YgDJVPXyOje,G8EPVSXsOYB5YQWZGiz1aVq5Pgr2GrQu,15,10,0,18,0,1,5,1,35,5.0,1,0.0,6,0,14,0,4,1,4,5,1,20,15,1
6597,144538,E030rU1LpxP75gCwLYOV4Fo0HxMZiV04,bWdj2GDclj5ofokWjzoa5jAwMkxCykd6,4,2,1,0,1,0,1,0,5,0.7142857142857143,1,0.0,0,1,0,1,2,0,0,1,0,2,3,1
6598,144543,3myCXWasasCDpepMqlfZ17VF0Gt1zPNm,SpATywNh6bZuzm8s1ceuBUnMUAeoAHHw,9,31,5,0,4,0,9,0,49,7.0,2,0.0,0,5,0,4,31,0,0,9,0,9,40,1
6599,144550,dRD1DS5DuggVygcG59W7832HdVYwtgOn,SpATywNh6bZuzm8s1ceuBUnMUAeoAHHw,11,12,3,0,3,1,8,1,28,4.0,3,0.0,0,3,0,3,12,1,0,8,1,6,22,0
6600,144554,a98Mt6r9LLCkAEPo2R3JVMN20OhIPoaG,G8EPVSXsOYB5YQWZGiz1aVq5Pgr2GrQu,12,9,8,0,8,1,13,3,42,6.0,1,0.0,0,8,0,8,9,1,0,13,3,16,26,1
6601,144565,aGxe7bEAMBiGMI7BWz3muh2QIgH75sEQ,SpATywNh6bZuzm8s1ceuBUnMUAeoAHHw,7,9,4,0,3,1,5,1,23,3.2857142857142856,2,0.0,0,4,0,3,9,1,0,5,1,7,16,1
6602,144576,K938KGiMd2B4Ec49syEZjpINF1qucFfC,RXDvfPUBYFlVdlueBFbLW0mhhAyGEqpt,8,6,5,0,3,0,1,0,15,2.142857142857143,1,0.0,0,5,0,3,6,0,0,1,0,8,7,1
6603,144588,TfgVRC9skFsGu3qq14caEQmfjmrp7rot,A3fsA9Zfv1X2fVEQhTw51lKENdNrEqT3,7,15,4,2,0,47,11,0,79,11.285714285714286,5,0.0,2,4,2,0,13,47,0,11,0,8,71,1
6604,144595,ILvCdOvVnKq9RshqMB5c6cdDGIsepuiz,SpATywNh6bZuzm8s1ceuBUnMUAeoAHHw,15,26,10,16,7,1,4,0,64,9.142857142857142,2,0.0,10,10,14,7,16,1,2,4,0,41,23,0
6605,144597,8sZcaktUJCX4PaAufyDgY0i3vpLY8cZl,SpATywNh6bZuzm8s1ceuBUnMUAeoAHHw,21,58,25,26,10,11,16,0,146,20.857142857142858,8,0.0,13,25,23,10,45,11,3,16,0,71,75,1
6606,144603,FKroAYBvJIjpEDPtuLwEtwENqpzITIVV,G8EPVSXsOYB5YQWZGiz1aVq5Pgr2GrQu,2,0,0,0,0,0,2,0,2,0.2857142857142857,1,0.0,0,0,0,0,0,0,0,2,0,0,2,1
6607,144617,pU8vRE1UHTj9vg59DuOCQhz7JoOflgLu,A3fsA9Zfv1X2fVEQhTw51lKENdNrEqT3,7,3,2,0,2,0,2,0,9,1.2857142857142858,1,0.0,0,2,0,2,3,0,0,2,0,4,5,1
6608,144618,MXpZg6Y3WvwOURUS1VvgXTxhk1pXKVY7,A3fsA9Zfv1X2fVEQhTw51lKENdNrEqT3,1,0,0,0,0,0,1,0,1,0.14285714285714285,1,0.0,0,0,0,0,0,0,0,1,0,0,1,1
6609,144629,BP5bWGw3QHuTeDApT0DMqwZyLZFJNObH,bWdj2GDclj5ofokWjzoa5jAwMkxCykd6,2,0,0,0,0,0,4,0,4,0.5714285714285714,2,0.0,0,0,0,0,0,0,0,4,0,0,4,1
6610,144631,HOzFChSOtA5eaxaGdVcuMk1vnx6fpMBO,A3fsA9Zfv1X2fVEQhTw51lKENdNrEqT3,8,6,5,0,5,0,1,0,17,2.4285714285714284,1,0.0,0,5,0,5,6,0,0,1,0,10,7,1
6611,144636,JUXaUT76xGfe9CQCOTjnER9kYb6QPZYj,SpATywNh6bZuzm8s1ceuBUnMUAeoAHHw,1,0,0,0,0,0,1,0,1,0.14285714285714285,1,0.0,0,0,0,0,0,0,0,1,0,0,1,1
6612,144640,BP5bWGw3QHuTeDApT0DMqwZyLZFJNObH,G8EPVSXsOYB5YQWZGiz1aVq5Pgr2GrQu,1,0,0,0,0,0,1,0,1,0.14285714285714285,1,0.0,0,0,0,0,0,0,0,1,0,0,1,1
6613,144641,BP5bWGw3QHuTeDApT0DMqwZyLZFJNObH,RXDvfPUBYFlVdlueBFbLW0mhhAyGEqpt,1,0,0,0,0,0,1,0,1,0.14285714285714285,1,0.0,0,0,0,0,0,0,0,1,0,0,1,1
6614,144643,BP5bWGw3QHuTeDApT0DMqwZyLZFJNObH,A3fsA9Zfv1X2fVEQhTw51lKENdNrEqT3,1,0,0,0,0,0,1,0,1,0.14285714285714285,1,0.0,0,0,0,0,0,0,0,1,0,0,1,0
6615,144649,uKGXhzbiDEpxCHjVlf9dmkGcQbxLosVe,A3fsA9Zfv1X2fVEQhTw51lKENdNrEqT3,64,30,8,182,2,0,6,0,228,32.57142857142857,2,0.0,18,8,182,2,12,0,0,6,0,210,18,1
6616,144672,0CSUGuJXm53wz281T7wy30wWcjmP6Jhd,A3fsA9Zfv1X2fVEQhTw51lKENdNrEqT3,1,0,0,0,0,0,1,0,1,0.14285714285714285,1,0.0,0,0,0,0,0,0,0,1,0,0,1,1
6617,144675,R6EtBVYzIOtYw5JSZPuQBl0alOVcbr6I,A3fsA9Zfv1X2fVEQhTw51lKENdNrEqT3,12,7,4,0,2,0,10,1,24,3.4285714285714284,3,0.0,0,4,0,2,7,0,0,10,1,6,18,1
6618,144681,ZbpLZuhcPXDt8MCBlzIEU31Qmn57Ldle,SpATywNh6bZuzm8s1ceuBUnMUAeoAHHw,5,10,5,0,1,0,7,0,23,3.2857142857142856,5,0.0,0,5,0,1,10,0,0,7,0,6,17,0
6619,144684,3URMlJ8WFfbFx3SvBMPqUCA5oJqCky66,SpATywNh6bZuzm8s1ceuBUnMUAeoAHHw,1,0,0,0,0,0,1,0,1,0.14285714285714285,1,0.0,0,0,0,0,0,0,0,1,0,0,1,1
6620,144685,3URMlJ8WFfbFx3SvBMPqUCA5oJqCky66,A3fsA9Zfv1X2fVEQhTw51lKENdNrEqT3,1,0,0,0,0,0,1,0,1,0.14285714285714285,1,0.0,0,0,0,0,0,0,0,1,0,0,1,1
6621,144715,xQxCv7HVGUZGKsbGAuM07smPdylb1xSw,SpATywNh6bZuzm8s1ceuBUnMUAeoAHHw,30,31,18,27,7,4,16,4,107,15.285714285714286,3,0.0,8,18,25,7,23,4,2,16,4,58,49,1
6622,144717,dSEPqlVIJhcDJWr692RG1EpaZWCLqDyG,SpATywNh6bZuzm8s1ceuBUnMUAeoAHHw,18,23,15,17,8,0,10,1,74,10.571428571428571,2,0.0,3,15,14,8,20,0,3,10,1,40,34,1
6623,144718,4ZrtrSJyUYRfKbXFhTQGaeeh25vDmius,A3fsA9Zfv1X2fVEQhTw51lKENdNrEqT3,1,0,0,0,0,0,1,0,1,0.14285714285714285,1,0.0,0,0,0,0,0,0,0,1,0,0,1,1
6624,144719,xQxCv7HVGUZGKsbGAuM07smPdylb1xSw,A3fsA9Zfv1X2fVEQhTw51lKENdNrEqT3,69,28,18,148,12,3,10,1,220,31.428571428571427,4,0.0,4,18,136,12,24,3,12,10,1,170,50,1
6625,144725,AIfINm6P1sC5sVX3hdv80PZXLkhHXqk1,G8EPVSXsOYB5YQWZGiz1aVq5Pgr2GrQu,12,23,8,14,6,1,6,0,58,8.285714285714286,1,0.0,12,8,11,6,11,1,3,6,0,37,21,1
6626,144738,WQgX9jQZlUNhL3E2Z5eSuSFzKxNFacOF,SpATywNh6bZuzm8s1ceuBUnMUAeoAHHw,7,3,1,0,2,0,2,0,8,1.1428571428571428,1,0.0,0,1,0,2,3,0,0,2,0,3,5,1
6627,144767,D4wnvxE0dpHZJOcudMfhDCLWhQhwv6kG,RXDvfPUBYFlVdlueBFbLW0mhhAyGEqpt,5,2,1,0,1,0,3,0,7,1.0,1,0.0,0,1,0,1,2,0,0,3,0,2,5,1
6628,144783,tLtF2xuv7ODjuOISevnoALqvBz99SIrS,A3fsA9Zfv1X2fVEQhTw51lKENdNrEqT3,11,14,0,0,0,0,3,0,17,2.4285714285714284,2,0.0,0,0,0,0,14,0,0,3,0,0,17,1
6629,144786,pOHHE099KbMGj1W8GOyTSnGwPkWGlTwN,SpATywNh6bZuzm8s1ceuBUnMUAeoAHHw,6,3,2,0,2,0,1,0,8,1.1428571428571428,1,0.0,0,2,0,2,3,0,0,1,0,4,4,1
6630,144794,NSeMeg6h5JDvAoSbt1mktNuQe2nQivm2,SpATywNh6bZuzm8s1ceuBUnMUAeoAHHw,7,7,4,0,3,0,2,0,16,2.2857142857142856,3,0.0,0,4,0,3,7,0,0,2,0,7,9,1
6631,144796,kVjEgLBjlwxZOZHT9ChhdKAcv24WA2AK,A3fsA9Zfv1X2fVEQhTw51lKENdNrEqT3,5,4,0,0,0,0,3,0,7,1.0,1,0.0,0,0,0,0,4,0,0,3,0,0,7,1
6632,144799,mJTYU2VNehzj4vso65R9VtV3DFyktCio,A3fsA9Zfv1X2fVEQhTw51lKENdNrEqT3,1,0,0,0,0,0,1,0,1,0.14285714285714285,1,0.0,0,0,0,0,0,0,0,1,0,0,1,1
6633,144806,7vmy4dx8h1nmyk40XB1bVEo0ZK716pcj,SpATywNh6bZuzm8s1ceuBUnMUAeoAHHw,19,63,15,9,10,7,14,0,118,16.857142857142858,7,0.0,13,15,9,10,50,7,0,14,0,47,71,0
6634,144811,EORWbUeiO6FyoVtc0SbozxGi0vBVCOhI,RXDvfPUBYFlVdlueBFbLW0mhhAyGEqpt,7,6,0,0,0,1,9,0,16,2.2857142857142856,1,0.0,0,0,0,0,6,1,0,9,0,0,16,0
6635,144815,YB7yB7CNt6VhEWaKJG02XZ1X013EpWWP,SpATywNh6bZuzm8s1ceuBUnMUAeoAHHw,10,6,3,6,2,0,2,0,19,2.7142857142857144,1,0.0,0,3,6,2,6,0,0,2,0,11,8,1
6636,144837,w1HLpf01ff60tSyrkRwOPpdSlz3uqa1C,G8EPVSXsOYB5YQWZGiz1aVq5Pgr2GrQu,8,29,8,2,4,0,11,0,54,7.714285714285714,1,0.0,16,8,2,4,13,0,0,11,0,30,24,1
6637,144840,8EW2D448XGSlxAI534l0xtNnCA9hxB1o,SpATywNh6bZuzm8s1ceuBUnMUAeoAHHw,18,36,21,17,6,21,18,2,121,17.285714285714285,3,0.0,9,21,15,6,27,21,2,18,2,51,70,0
6638,144848,lWrAH12K4dJ1TRkFPwboUyykF2mRtmZq,SpATywNh6bZuzm8s1ceuBUnMUAeoAHHw,13,24,0,23,0,13,6,1,67,9.571428571428571,1,0.0,9,0,18,0,15,13,5,6,1,27,40,0
6639,144849,3Szk0pKijWd9ul5APNqiXkIk1r9cxADp,SpATywNh6bZuzm8s1ceuBUnMUAeoAHHw,14,21,2,5,1,3,13,5,50,7.142857142857143,3,0.0,3,2,4,1,18,3,1,13,5,10,40,1
6640,144857,nN9pe51IpLVxUmywITIZON7RGbeNZPas,SpATywNh6bZuzm8s1ceuBUnMUAeoAHHw,1,0,0,0,0,0,1,0,1,0.14285714285714285,1,0.0,0,0,0,0,0,0,0,1,0,0,1,1
6641,144869,wdtTKNG0uA9GskMOgg4nh6i8cQYwrWBl,A3fsA9Zfv1X2fVEQhTw51lKENdNrEqT3,2,0,0,0,0,0,2,0,2,0.2857142857142857,1,0.0,0,0,0,0,0,0,0,2,0,0,2,1
6642,144871,1R1zO9aMB7Mx1Lw84JzsChVEV5JpwmZv,A3fsA9Zfv1X2fVEQhTw51lKENdNrEqT3,12,13,3,0,2,0,7,0,25,3.5714285714285716,3,0.0,0,3,0,2,13,0,0,7,0,5,20,1
6643,144880,DPiNWGgyN27xfAyZbYcImdtWAWiA8G6T,A3fsA9Zfv1X2fVEQhTw51lKENdNrEqT3,2,0,0,0,0,0,6,0,6,0.8571428571428571,1,0.0,0,0,0,0,0,0,0,6,0,0,6,1
6644,144888,Fa0j89udkjEUrIyHxCII6V32n0NpiqGO,SpATywNh6bZuzm8s1ceuBUnMUAeoAHHw,4,5,0,0,0,0,2,0,7,1.0,1,0.0,1,0,0,0,4,0,0,2,0,1,6,1
6645,144889,y9hyyqGNd76OPDqzcsRztJJMWbz6UZny,bWdj2GDclj5ofokWjzoa5jAwMkxCykd6,5,2,1,0,1,0,2,0,6,0.8571428571428571,1,0.0,0,1,0,1,2,0,0,2,0,2,4,1
6646,144892,TBXYAxwexaNd47Tj9eT3p3QhXiwNSKj3,A3fsA9Zfv1X2fVEQhTw51lKENdNrEqT3,5,2,1,0,1,0,2,0,6,0.8571428571428571,1,0.0,0,1,0,1,2,0,0,2,0,2,4,1
6647,144900,k0mvvZulPoyJiICbYxKkU42hG2G5I80n,G8EPVSXsOYB5YQWZGiz1aVq5Pgr2GrQu,15,5,5,0,4,5,8,1,28,4.0,1,0.0,0,5,0,4,5,5,0,8,1,9,19,0
6648,144902,xbjVL5LPvdMl78h4grzGu4EO36e7wFtJ,G8EPVSXsOYB5YQWZGiz1aVq5Pgr2GrQu,17,24,14,14,9,0,4,0,65,9.285714285714286,1,0.0,7,14,13,9,17,0,1,4,0,43,22,1
6649,144906,ltWU63DD5GSM3zr2uNJoqVqAhziwXNdd,A3fsA9Zfv1X2fVEQhTw51lKENdNrEqT3,1,0,0,0,0,0,1,0,1,0.14285714285714285,1,0.0,0,0,0,0,0,0,0,1,0,0,1,1
6650,144910,3QwYnxvK4cR8IsGQGOLRPbhjjuJL7iw4,bWdj2GDclj5ofokWjzoa5jAwMkxCykd6,1,0,0,0,0,0,1,0,1,0.14285714285714285,1,0.0,0,0,0,0,0,0,0,1,0,0,1,1
6651,144913,xbjVL5LPvdMl78h4grzGu4EO36e7wFtJ,SpATywNh6bZuzm8s1ceuBUnMUAeoAHHw,16,14,5,18,2,5,6,1,51,7.285714285714286,1,0.0,7,5,15,2,7,5,3,6,1,29,22,1
6652,144917,qIeFceRzEPXi4DRrMYWrvBiuDgAZSOfu,SpATywNh6bZuzm8s1ceuBUnMUAeoAHHw,6,4,3,0,2,0,2,0,11,1.5714285714285714,1,0.0,0,3,0,2,4,0,0,2,0,5,6,1
6653,144929,j32U9Y949ZW1nXMwG0aPWZXCmluBzel9,A3fsA9Zfv1X2fVEQhTw51lKENdNrEqT3,2,0,0,0,0,0,2,0,2,0.2857142857142857,1,0.0,0,0,0,0,0,0,0,2,0,0,2,1
6654,144953,FDUH5NLrpwAq9aLqLXeux2jUy8LXyyH1,SpATywNh6bZuzm8s1ceuBUnMUAeoAHHw,4,2,0,0,0,0,2,0,4,0.5714285714285714,1,0.0,0,0,0,0,2,0,0,2,0,0,4,0
6655,144955,eE1Ts31Y4vQL30WuFQSepkqre5sjHOf7,A3fsA9Zfv1X2fVEQhTw51lKENdNrEqT3,1,0,0,0,0,0,1,0,1,0.14285714285714285,1,0.0,0,0,0,0,0,0,0,1,0,0,1,1
6656,144957,spFI1Ow5BGpTh0oHb0EunsXhby1WBBGm,A3fsA9Zfv1X2fVEQhTw51lKENdNrEqT3,2,0,0,0,0,0,2,0,2,0.2857142857142857,1,0.0,0,0,0,0,0,0,0,2,0,0,2,1
6657,144963,BohRHH2vBIgnEZGZjM3WnHwJbVFmITRG,A3fsA9Zfv1X2fVEQhTw51lKENdNrEqT3,1,0,0,0,0,0,4,0,4,0.5714285714285714,1,0.0,0,0,0,0,0,0,0,4,0,0,4,1
6658,144970,9fBHqnUYCnvcFTWqd4TwpElPXxWTxMR8,G8EPVSXsOYB5YQWZGiz1aVq5Pgr2GrQu,7,4,1,0,1,0,3,0,9,1.2857142857142858,2,0.0,0,1,0,1,4,0,0,3,0,2,7,1
6659,144985,UdRvlfQEjfzv2meiEECQoQ6VdSnYEWcK,RXDvfPUBYFlVdlueBFbLW0mhhAyGEqpt,17,21,12,30,10,6,5,0,84,12.0,2,0.0,6,12,22,10,15,6,8,5,0,50,34,1
6660,145015,MOcMwRKo0dtFqZ5xWBgRzquuZGKtQyf4,A3fsA9Zfv1X2fVEQhTw51lKENdNrEqT3,6,3,2,0,2,0,1,0,8,1.1428571428571428,1,0.0,0,2,0,2,3,0,0,1,0,4,4,1
6661,145021,qwhxcjW9iIMBAQoGSWDtst34AFkcFQoV,bWdj2GDclj5ofokWjzoa5jAwMkxCykd6,5,7,3,0,0,1,5,0,16,2.2857142857142856,2,0.0,0,3,0,0,7,1,0,5,0,3,13,0
6662,145032,9KLyc4q5evm7m8P2TqAkjsYxwe72QOQ1,bWdj2GDclj5ofokWjzoa5jAwMkxCykd6,7,6,2,0,3,0,2,0,13,1.8571428571428572,1,0.0,2,2,0,3,4,0,0,2,0,7,6,1
6663,145045,fAwXW6DQAyNHjMN17jlyBSVcZRO4da21,bWdj2GDclj5ofokWjzoa5jAwMkxCykd6,3,2,0,0,0,0,1,0,3,0.42857142857142855,1,0.0,0,0,0,0,2,0,0,1,0,0,3,1
6664,145049,OoYnFZVZGncVBxTvo4CMvSktXlZzaVm6,SpATywNh6bZuzm8s1ceuBUnMUAeoAHHw,1,0,0,0,0,0,1,0,1,0.14285714285714285,1,0.0,0,0,0,0,0,0,0,1,0,0,1,1
6665,145054,aRdmmgSzM3Ga3svQ0ZT0DvTgw1R0bnD6,SpATywNh6bZuzm8s1ceuBUnMUAeoAHHw,13,18,2,11,0,7,12,0,50,7.142857142857143,4,0.0,4,2,10,0,14,7,1,12,0,16,34,0
6666,145066,YOvd9uht0tZm889aIFQH8jd68xtH7inE,A3fsA9Zfv1X2fVEQhTw51lKENdNrEqT3,42,40,18,62,7,0,15,0,142,20.285714285714285,5,0.0,3,18,55,7,37,0,7,15,0,83,59,0
6667,145068,sytW49I21SJ70ElOkXGU5SHeeHl1E3fL,SpATywNh6bZuzm8s1ceuBUnMUAeoAHHw,5,4,2,0,1,0,2,0,9,1.2857142857142858,2,0.0,0,2,0,1,4,0,0,2,0,3,6,1
6668,145074,zKArdfpgac7e9qM8jxPrRvIXOkmrDk9Z,SpATywNh6bZuzm8s1ceuBUnMUAeoAHHw,6,2,1,0,1,0,3,0,7,1.0,1,0.0,0,1,0,1,2,0,0,3,0,2,5,1
6669,145075,aVjhXoDZEpZewbee7kboIyQDdDGbqzp9,G8EPVSXsOYB5YQWZGiz1aVq5Pgr2GrQu,2,0,0,0,0,0,2,0,2,0.2857142857142857,1,0.0,0,0,0,0,0,0,0,2,0,0,2,1
6670,145091,ung1DnQyYgd0tfz7mAKTwJrrm5UPHWt1,SpATywNh6bZuzm8s1ceuBUnMUAeoAHHw,1,0,0,0,0,0,2,0,2,0.2857142857142857,1,0.0,0,0,0,0,0,0,0,2,0,0,2,1
6671,145095,tXsXr7pk3kL9xbg1D57dnKxY4YjIc1Gu,SpATywNh6bZuzm8s1ceuBUnMUAeoAHHw,1,0,0,0,0,0,1,0,1,0.14285714285714285,1,0.0,0,0,0,0,0,0,0,1,0,0,1,1
6672,145097,oQl0xDZ6pRPXU9L7MUpc2rUtjHufKB7J,RXDvfPUBYFlVdlueBFbLW0mhhAyGEqpt,4,3,2,0,0,0,1,0,6,0.8571428571428571,1,0.0,0,2,0,0,3,0,0,1,0,2,4,1
6673,145103,DSKmSALREyqQ6TTRJZ71cZdSUivRfs4F,A3fsA9Zfv1X2fVEQhTw51lKENdNrEqT3,8,6,3,0,2,0,3,0,14,2.0,1,0.0,0,3,0,2,6,0,0,3,0,5,9,1
6674,145104,GIGWJmYKqXl2NDr50MFNWHRPBdEAyP24,SpATywNh6bZuzm8s1ceuBUnMUAeoAHHw,6,2,1,0,1,0,7,1,12,1.7142857142857142,2,0.0,0,1,0,1,2,0,0,7,1,2,10,1
6675,145105,RjP92xCHXSUOtRBYjOBBQtIX0x4y84M8,SpATywNh6bZuzm8s1ceuBUnMUAeoAHHw,5,2,1,0,1,0,3,0,7,1.0,1,0.0,0,1,0,1,2,0,0,3,0,2,5,1
6676,145131,y7ML2j3yhLTXFlpVgDfbFQ7iV1QJE8KN,A3fsA9Zfv1X2fVEQhTw51lKENdNrEqT3,8,4,0,0,0,0,8,1,13,1.8571428571428572,2,0.0,0,0,0,0,4,0,0,8,1,0,13,1
6677,145132,VtMJYS2BOcqNwb9vhCBVs8m6rwGm1W7t,A3fsA9Zfv1X2fVEQhTw51lKENdNrEqT3,9,4,3,0,3,0,2,0,12,1.7142857142857142,1,0.0,0,3,0,3,4,0,0,2,0,6,6,1
6678,145133,gcAX0pXem59fO2vK8c72MGTEEeEu58YB,SpATywNh6bZuzm8s1ceuBUnMUAeoAHHw,9,8,4,0,2,0,10,1,25,3.5714285714285716,5,0.0,0,4,0,2,8,0,0,10,1,6,19,1
6679,145138,RiLBe5rsNsQ05e1l2H5DyOu2jxJ20lju,SpATywNh6bZuzm8s1ceuBUnMUAeoAHHw,5,6,0,0,0,0,2,0,8,1.1428571428571428,1,0.0,0,0,0,0,6,0,0,2,0,0,8,1
6680,145141,sytW49I21SJ70ElOkXGU5SHeeHl1E3fL,G8EPVSXsOYB5YQWZGiz1aVq5Pgr2GrQu,1,0,0,0,0,0,1,0,1,0.14285714285714285,1,0.0,0,0,0,0,0,0,0,1,0,0,1,1
6681,145177,2HllbOBswZcfya5rDzlXYMHVB93oWjxb,SpATywNh6bZuzm8s1ceuBUnMUAeoAHHw,20,78,26,22,6,21,17,0,170,24.285714285714285,6,0.0,15,26,19,6,63,21,3,17,0,66,104,1
6682,145209,VDfyMtI3GxFkSIKeQUI9WFdkBVMRRXiz,SpATywNh6bZuzm8s1ceuBUnMUAeoAHHw,5,3,0,0,0,0,4,0,7,1.0,1,0.0,0,0,0,0,3,0,0,4,0,0,7,1
6683,145213,paYCysIECekGmZR2IMHuvcxiMIpmnCQ8,SpATywNh6bZuzm8s1ceuBUnMUAeoAHHw,7,5,0,0,0,1,2,0,8,1.1428571428571428,1,0.0,0,0,0,0,5,1,0,2,0,0,8,1
6684,145218,gBdCgqP4ofpM7Vyy2N6nMT9XqzCjM1Oh,SpATywNh6bZuzm8s1ceuBUnMUAeoAHHw,7,3,2,0,2,0,2,0,9,1.2857142857142858,1,0.0,0,2,0,2,3,0,0,2,0,4,5,1
6685,145221,twJpEV6sOcVGisdKOs7bOfiwkX5tFRQS,SpATywNh6bZuzm8s1ceuBUnMUAeoAHHw,10,12,1,0,1,3,6,1,24,3.4285714285714284,1,0.0,0,1,0,1,12,3,0,6,1,2,22,1
6686,145265,OpGwtUbMGweipJr0vMybah9tM3IHgiea,bWdj2GDclj5ofokWjzoa5jAwMkxCykd6,12,24,2,60,4,0,3,0,93,13.285714285714286,3,0.0,11,2,57,4,13,0,3,3,0,74,19,1
6687,145278,TxcS8XkQULHRvLzAPNlWKiWhaRYPoBRt,G8EPVSXsOYB5YQWZGiz1aVq5Pgr2GrQu,6,2,1,0,1,0,4,0,8,1.1428571428571428,1,0.0,0,1,0,1,2,0,0,4,0,2,6,1
6688,145288,qJfYTCfAKzghj5i0hFgmRNbo2RAMR1vj,A3fsA9Zfv1X2fVEQhTw51lKENdNrEqT3,1,0,0,0,0,0,1,0,1,0.14285714285714285,1,0.0,0,0,0,0,0,0,0,1,0,0,1,1
6689,145291,hnuoUj2kTW5DzBnYNuL5k21Q4R9tMedy,G8EPVSXsOYB5YQWZGiz1aVq5Pgr2GrQu,1,0,0,0,0,0,1,0,1,0.14285714285714285,1,0.0,0,0,0,0,0,0,0,1,0,0,1,1
6690,145292,rwtLVsXV0McQpa98tIZ3wTZOVSCGNjDc,A3fsA9Zfv1X2fVEQhTw51lKENdNrEqT3,2,0,0,0,0,0,2,0,2,0.2857142857142857,1,0.0,0,0,0,0,0,0,0,2,0,0,2,1
6691,145295,vBbCzoxWi1xTyTmmDeTUsTbUY4qjPd8y,G8EPVSXsOYB5YQWZGiz1aVq5Pgr2GrQu,21,26,8,36,7,7,5,1,90,12.857142857142858,2,0.0,16,8,26,7,10,7,10,5,1,57,33,1
6692,145299,Msbm8ecHOfoRqpOAXpgLpOJMSb42Fh1S,bWdj2GDclj5ofokWjzoa5jAwMkxCykd6,1,0,0,0,0,0,2,0,2,0.2857142857142857,2,0.0,0,0,0,0,0,0,0,2,0,0,2,1
6693,145317,xXaLTSrOfjZMoecs1p8kChNEzFzZxcjE,bWdj2GDclj5ofokWjzoa5jAwMkxCykd6,2,0,0,0,0,0,2,0,2,0.2857142857142857,1,0.0,0,0,0,0,0,0,0,2,0,0,2,1
6694,145341,Cgu1GLWn7izWpBdNFknarDBOnLjP2HFo,SpATywNh6bZuzm8s1ceuBUnMUAeoAHHw,1,0,0,0,0,0,1,0,1,0.14285714285714285,1,0.0,0,0,0,0,0,0,0,1,0,0,1,1
6695,145345,RjNr7pqr5wdbMZIOQUnJioAJdhoV1M2t,A3fsA9Zfv1X2fVEQhTw51lKENdNrEqT3,2,0,0,0,0,0,2,0,2,0.2857142857142857,1,0.0,0,0,0,0,0,0,0,2,0,0,2,1
6696,145356,yODUqFZFhl66c3de8GWk0KnGzndelUJ3,SpATywNh6bZuzm8s1ceuBUnMUAeoAHHw,5,4,0,0,0,0,2,0,6,0.8571428571428571,1,0.0,0,0,0,0,4,0,0,2,0,0,6,1
6697,145357,vBbCzoxWi1xTyTmmDeTUsTbUY4qjPd8y,bWdj2GDclj5ofokWjzoa5jAwMkxCykd6,12,11,5,18,4,0,5,0,43,6.142857142857143,2,0.0,3,5,18,4,8,0,0,5,0,30,13,1
6698,145372,N7bFFbLK2teqNFII1ql8vn5jRsylN8ml,A3fsA9Zfv1X2fVEQhTw51lKENdNrEqT3,2,0,0,0,0,0,3,0,3,0.42857142857142855,1,0.0,0,0,0,0,0,0,0,3,0,0,3,1
6699,145379,7DPRFpgqZz2tLX453UgkvNfatiWrVLIi,bWdj2GDclj5ofokWjzoa5jAwMkxCykd6,1,0,0,0,0,0,1,0,1,0.14285714285714285,1,0.0,0,0,0,0,0,0,0,1,0,0,1,1
6700,145406,DaYS7gf8DVgCD84ya5YqgMFFiGYw1ps2,SpATywNh6bZuzm8s1ceuBUnMUAeoAHHw,5,2,1,0,1,0,2,0,6,0.8571428571428571,1,0.0,0,1,0,1,2,0,0,2,0,2,4,1
6701,145432,KMY78k4PWHNGUKa8SpxqTI7uzFKhJIDC,bWdj2GDclj5ofokWjzoa5jAwMkxCykd6,1,0,0,0,0,0,1,0,1,0.14285714285714285,1,0.0,0,0,0,0,0,0,0,1,0,0,1,1
6702,145434,r0Dep3QHNNWSPLkR08tICGVj5Fu7r77t,A3fsA9Zfv1X2fVEQhTw51lKENdNrEqT3,4,2,0,0,0,0,3,0,5,0.7142857142857143,2,0.0,0,0,0,0,2,0,0,3,0,0,5,1
6703,145436,uO6I869Gu09HIUH9g2koYFrRZOQcNS34,SpATywNh6bZuzm8s1ceuBUnMUAeoAHHw,1,0,0,0,0,0,1,0,1,0.14285714285714285,1,0.0,0,0,0,0,0,0,0,1,0,0,1,1
6704,145438,sETZmDR5b3CheYe2K5IvWb1lrRsZmOT8,A3fsA9Zfv1X2fVEQhTw51lKENdNrEqT3,4,2,1,0,1,0,2,0,6,0.8571428571428571,1,0.0,0,1,0,1,2,0,0,2,0,2,4,1
6705,145443,YjyR7WtUqlaMl5G5DWaaUx9XfYg7ssrK,G8EPVSXsOYB5YQWZGiz1aVq5Pgr2GrQu,1,0,0,0,0,0,1,0,1,0.14285714285714285,1,0.0,0,0,0,0,0,0,0,1,0,0,1,1
6706,145450,YAsCREgt5tIqJEvOtaek3jtgsLn87nEr,SpATywNh6bZuzm8s1ceuBUnMUAeoAHHw,4,2,0,0,0,2,2,0,6,0.8571428571428571,1,0.0,0,0,0,0,2,2,0,2,0,0,6,1
6707,145454,kjrJbHri2dhD9BduhqLwj0qNbqxkh9F5,G8EPVSXsOYB5YQWZGiz1aVq5Pgr2GrQu,3,3,0,0,0,0,1,0,4,0.5714285714285714,1,0.0,0,0,0,0,3,0,0,1,0,0,4,1
6708,145465,IvdoAzckjyWWCkzCy6V0BjWvOwMyZEwg,A3fsA9Zfv1X2fVEQhTw51lKENdNrEqT3,35,27,17,84,1,1,17,1,148,21.142857142857142,6,0.0,3,17,74,1,24,1,10,17,1,95,53,1
6709,145469,cRlXLJdkIX4KH74JKLBjP86zQb3lppxR,bWdj2GDclj5ofokWjzoa5jAwMkxCykd6,5,2,1,0,1,0,2,0,6,0.8571428571428571,1,0.0,0,1,0,1,2,0,0,2,0,2,4,1
6710,145472,vUg72yuNvNQBasGeqPwQue3GKgSAK3Os,bWdj2GDclj5ofokWjzoa5jAwMkxCykd6,7,3,2,0,2,0,2,0,9,1.2857142857142858,2,0.0,0,2,0,2,3,0,0,2,0,4,5,1
6711,145526,SxwYiL0K8imHewBqHVzk62D1lCszL0BN,SpATywNh6bZuzm8s1ceuBUnMUAeoAHHw,1,0,0,0,0,0,1,0,1,0.14285714285714285,1,0.0,0,0,0,0,0,0,0,1,0,0,1,1
6712,145527,lmlSe7ne5kLVEzM7wObkzo8bsMDoN8xr,SpATywNh6bZuzm8s1ceuBUnMUAeoAHHw,10,5,4,0,3,0,3,0,15,2.142857142857143,1,0.0,0,4,0,3,5,0,0,3,0,7,8,1
6713,145556,W7jA7ye7B2WHwijEGRwBOnLy8XlzJD6d,7GRhBDsirIGkRZBtSMEzNTyDr2JQm4xx,9,13,6,3,6,0,3,0,31,4.428571428571429,2,0.0,5,6,3,6,8,0,0,3,0,20,11,1
6714,145573,azsfvKoTKLQ8ipwpPOtqZMAvWCpOjcns,7GRhBDsirIGkRZBtSMEzNTyDr2JQm4xx,11,4,3,0,3,0,5,0,15,2.142857142857143,2,0.0,0,3,0,3,4,0,0,5,0,6,9,1
6715,145591,zUUxzMGQmBZk6tO8vnbhkaGffbYWZvas,7GRhBDsirIGkRZBtSMEzNTyDr2JQm4xx,1,0,0,0,0,0,1,0,1,0.14285714285714285,1,0.0,0,0,0,0,0,0,0,1,0,0,1,1
6716,145734,hzecatREssedFdFCykKMURt84PE7MA6q,7GRhBDsirIGkRZBtSMEzNTyDr2JQm4xx,1,0,0,0,0,0,1,0,1,0.14285714285714285,1,0.0,0,0,0,0,0,0,0,1,0,0,1,1
6717,145746,qWYBo2adrtMVzANonhELRQVrWKW8T9T5,7GRhBDsirIGkRZBtSMEzNTyDr2JQm4xx,1,0,0,0,0,0,1,0,1,0.14285714285714285,1,0.0,0,0,0,0,0,0,0,1,0,0,1,1
6718,145767,PUvUSLbNhJCmhl8hY6hN43xWGmaNTEJm,7GRhBDsirIGkRZBtSMEzNTyDr2JQm4xx,3,2,1,0,0,0,1,0,4,0.5714285714285714,1,0.0,0,1,0,0,2,0,0,1,0,1,3,1
6719,145806,oIeIfwhQt9r1G6uZ62W7p7DLvDQ1KzcN,7GRhBDsirIGkRZBtSMEzNTyDr2JQm4xx,1,0,0,0,0,0,1,0,1,0.14285714285714285,1,0.0,0,0,0,0,0,0,0,1,0,0,1,1
6720,145824,iOFL9rLCMe8MjMlK3933AhOhA0dxbzTJ,7GRhBDsirIGkRZBtSMEzNTyDr2JQm4xx,2,0,0,0,0,0,2,0,2,0.2857142857142857,1,0.0,0,0,0,0,0,0,0,2,0,0,2,1
6721,145865,YYoTz5aT6oXhrDferhw1rplLYmNDgFub,7GRhBDsirIGkRZBtSMEzNTyDr2JQm4xx,40,91,2,0,15,0,2,0,110,15.714285714285714,2,0.0,60,2,0,15,31,0,0,2,0,77,33,0
6722,145878,vkI2g6NMz3qUYtvneHWPmtBdkC0OUJ1I,7GRhBDsirIGkRZBtSMEzNTyDr2JQm4xx,10,6,3,0,1,1,10,1,22,3.142857142857143,2,0.0,0,3,0,1,6,1,0,10,1,4,18,1
6723,145953,TUdJl2punKYQuyj7cqcfXJ5p7FVAGa9A,7GRhBDsirIGkRZBtSMEzNTyDr2JQm4xx,12,30,13,0,4,1,3,0,51,7.285714285714286,2,0.0,8,13,0,4,22,1,0,3,0,25,26,1
6724,145989,ULvgH0dn9cMQ7RqvqnSWbMcAlKJJQ0Fk,7GRhBDsirIGkRZBtSMEzNTyDr2JQm4xx,2,0,0,0,0,0,2,0,2,0.2857142857142857,1,0.0,0,0,0,0,0,0,0,2,0,0,2,1
6725,146589,cmPAv0G01upQaGYeDqwQ4S5qXOhzhpzv,7GRhBDsirIGkRZBtSMEzNTyDr2JQm4xx,26,22,8,22,8,0,6,0,66,9.428571428571429,1,0.0,13,8,11,8,9,0,11,6,0,40,26,1
6726,146936,c5MkJ205AcjWsm07YpOktUEc4lrC6DvN,RXDvfPUBYFlVdlueBFbLW0mhhAyGEqpt,1,0,0,0,0,0,1,0,1,0.14285714285714285,1,0.0,0,0,0,0,0,0,0,1,0,0,1,1
6727,146953,TkwNaNrSLynIgxaNvilfhFA70R9L2fY3,RXDvfPUBYFlVdlueBFbLW0mhhAyGEqpt,28,32,2,21,2,0,11,0,68,9.714285714285714,3,0.0,3,2,19,2,29,0,2,11,0,26,42,0
6728,147072,8yNyyy8aPKd19nuqwaynaLkU67KuROpn,G8EPVSXsOYB5YQWZGiz1aVq5Pgr2GrQu,9,7,3,0,3,0,3,0,16,2.2857142857142856,2,0.0,0,3,0,3,7,0,0,3,0,6,10,1
6729,147073,aFc1dZRXyhduGfLgWKifgShSyZKIHAn2,G8EPVSXsOYB5YQWZGiz1aVq5Pgr2GrQu,1,0,0,0,0,0,1,0,1,0.14285714285714285,1,0.0,0,0,0,0,0,0,0,1,0,0,1,1
6730,147106,114X1vLT3OTzchhxfRGg24FTsgrs6Boi,G8EPVSXsOYB5YQWZGiz1aVq5Pgr2GrQu,1,0,0,0,0,0,1,0,1,0.14285714285714285,1,0.0,0,0,0,0,0,0,0,1,0,0,1,1
6731,147113,sL5jw3pLWZoRI7avI17oM60mfF67Acgz,RXDvfPUBYFlVdlueBFbLW0mhhAyGEqpt,1,0,0,0,0,0,2,0,2,0.2857142857142857,2,0.0,0,0,0,0,0,0,0,2,0,0,2,0
6732,147134,FmbW6BMW2tvli3L6T9qC97SAIzFg6ww1,G8EPVSXsOYB5YQWZGiz1aVq5Pgr2GrQu,1,0,0,0,0,0,1,0,1,0.14285714285714285,1,0.0,0,0,0,0,0,0,0,1,0,0,1,1
6733,147182,Z8r3kWGF2ZuWSy5TZGg00SEG4qfRh2Ag,RXDvfPUBYFlVdlueBFbLW0mhhAyGEqpt,1,0,0,0,0,0,1,0,1,0.14285714285714285,1,0.0,0,0,0,0,0,0,0,1,0,0,1,1
6734,147195,CabsQjb2Sd2I3ynTdtsErAG67rLex08f,RXDvfPUBYFlVdlueBFbLW0mhhAyGEqpt,1,0,0,0,0,0,1,0,1,0.14285714285714285,1,0.0,0,0,0,0,0,0,0,1,0,0,1,1
6735,147226,G6cW0d2bzLHgB0vreFbhNx3GSiMBKbtv,RXDvfPUBYFlVdlueBFbLW0mhhAyGEqpt,1,0,0,0,0,0,1,0,1,0.14285714285714285,1,0.0,0,0,0,0,0,0,0,1,0,0,1,1
6736,147256,mKHQM9iW9olu6z2WamdxK7ySH3UwX3JX,G8EPVSXsOYB5YQWZGiz1aVq5Pgr2GrQu,1,0,0,0,0,0,1,0,1,0.14285714285714285,1,0.0,0,0,0,0,0,0,0,1,0,0,1,1
6737,147302,yYdEa9txfr33mPdKZaxK9a9x3sCFYrvO,RXDvfPUBYFlVdlueBFbLW0mhhAyGEqpt,1,0,0,0,0,0,1,0,1,0.14285714285714285,1,0.0,0,0,0,0,0,0,0,1,0,0,1,1
6738,147396,fr3LtKJIFGCsR1nz5ebBpapeX9CBJz4r,RXDvfPUBYFlVdlueBFbLW0mhhAyGEqpt,1,0,0,0,0,0,1,0,1,0.14285714285714285,1,0.0,0,0,0,0,0,0,0,1,0,0,1,1
6739,147400,W0jA3kW6UFNLExCUVwSYpHHYwJL1vqo8,G8EPVSXsOYB5YQWZGiz1aVq5Pgr2GrQu,1,0,0,0,0,0,1,0,1,0.14285714285714285,1,0.0,0,0,0,0,0,0,0,1,0,0,1,1
6740,147402,hlub8IQ6xr3M5qQPn6YnEFWROpuhMcwL,RXDvfPUBYFlVdlueBFbLW0mhhAyGEqpt,1,0,0,0,0,0,1,0,1,0.14285714285714285,1,0.0,0,0,0,0,0,0,0,1,0,0,1,1
6741,147419,T7YlTqIDVTZFYEYihxD1Zij5IkDsmVZP,RXDvfPUBYFlVdlueBFbLW0mhhAyGEqpt,1,0,0,0,0,0,1,0,1,0.14285714285714285,1,0.0,0,0,0,0,0,0,0,1,0,0,1,1
6742,147428,qyJkLuZ2kSoWLr9To4rUoAUCy3t2DtqK,RXDvfPUBYFlVdlueBFbLW0mhhAyGEqpt,22,23,1,23,2,1,6,1,57,8.142857142857142,2,0.0,4,1,23,2,19,1,0,6,1,30,27,1
6743,147484,ly5oRv8hiewZ1JUIP5AGbwWRi69QKnfA,G8EPVSXsOYB5YQWZGiz1aVq5Pgr2GrQu,1,0,0,0,0,0,1,0,1,0.14285714285714285,1,0.0,0,0,0,0,0,0,0,1,0,0,1,1
6744,147496,fJRilHVpgCFPzgCMD6Xh8rgK6259Z6TQ,RXDvfPUBYFlVdlueBFbLW0mhhAyGEqpt,1,0,0,0,0,0,1,0,1,0.14285714285714285,1,0.0,0,0,0,0,0,0,0,1,0,0,1,1
6745,147511,GXuacM1G2BzxiXouSVLnDv1V97NGwCCe,G8EPVSXsOYB5YQWZGiz1aVq5Pgr2GrQu,1,0,0,0,0,0,1,0,1,0.14285714285714285,1,0.0,0,0,0,0,0,0,0,1,0,0,1,1
6746,147512,WnXohtCVTjGmg2VYZ7QMusUaSQiMqg1z,G8EPVSXsOYB5YQWZGiz1aVq5Pgr2GrQu,1,0,0,0,0,0,1,0,1,0.14285714285714285,1,0.0,0,0,0,0,0,0,0,1,0,0,1,1
6747,147519,nYcDj7802ShzcCKfMPZblsaYoLQlLfFa,RXDvfPUBYFlVdlueBFbLW0mhhAyGEqpt,1,0,0,0,0,0,2,0,2,0.2857142857142857,1,0.0,0,0,0,0,0,0,0,2,0,0,2,1
6748,147558,FgDDMWCPhLKDQm2tOcaDRFOiW3MmNhxn,RXDvfPUBYFlVdlueBFbLW0mhhAyGEqpt,1,0,0,0,0,0,1,0,1,0.14285714285714285,1,0.0,0,0,0,0,0,0,0,1,0,0,1,1
6749,147627,qtx0N6lbHC7rLYVDABZMZjBHS66niL8J,RXDvfPUBYFlVdlueBFbLW0mhhAyGEqpt,1,0,0,0,0,0,1,0,1,0.14285714285714285,1,0.0,0,0,0,0,0,0,0,1,0,0,1,1
6750,147631,V1B34PKYcESnicIbQVUA4gpuU2uOqNWz,G8EPVSXsOYB5YQWZGiz1aVq5Pgr2GrQu,1,0,0,0,0,0,1,0,1,0.14285714285714285,1,0.0,0,0,0,0,0,0,0,1,0,0,1,1
6751,147661,8Eqf4bSicFmRziRU1kFgF89C5yGB8WDX,RXDvfPUBYFlVdlueBFbLW0mhhAyGEqpt,1,0,0,0,0,0,2,0,2,0.2857142857142857,2,0.0,0,0,0,0,0,0,0,2,0,0,2,1
6752,147668,RXybWoyBfxb1StD4gTX3cQ7Ir2hHF7eD,G8EPVSXsOYB5YQWZGiz1aVq5Pgr2GrQu,1,0,0,0,0,0,1,0,1,0.14285714285714285,1,0.0,0,0,0,0,0,0,0,1,0,0,1,1
6753,147692,97s9Gq3v1SpdnbcXTUeP0PbnntkfF2Gl,G8EPVSXsOYB5YQWZGiz1aVq5Pgr2GrQu,1,0,0,0,0,0,1,0,1,0.14285714285714285,1,0.0,0,0,0,0,0,0,0,1,0,0,1,1
6754,147731,y25cTP8mHUkaHLXFWhaRvqNBGzTMte3f,RXDvfPUBYFlVdlueBFbLW0mhhAyGEqpt,1,0,0,0,0,0,1,0,1,0.14285714285714285,1,0.0,0,0,0,0,0,0,0,1,0,0,1,1
6755,147756,kjYtN2fLOM5h2d7NgR39VaAB4M2wF6SJ,fbPkOYLVPtPgIt0MxizjfFJov3JbHyAi,3,0,0,0,0,0,4,0,4,0.5714285714285714,1,0.0,0,0,0,0,0,0,0,4,0,0,4,0
6756,147757,PR1Ko3tMvIqClzd4kShPXdxxynmXc5v2,fbPkOYLVPtPgIt0MxizjfFJov3JbHyAi,3,2,0,0,0,0,1,0,3,0.42857142857142855,1,0.0,0,0,0,0,2,0,0,1,0,0,3,1
6757,147760,Ie773JkkSDQvIHXsBZsmS2dO9aRzKpSr,fbPkOYLVPtPgIt0MxizjfFJov3JbHyAi,5,2,1,0,1,0,2,0,6,0.8571428571428571,1,0.0,0,1,0,1,2,0,0,2,0,2,4,0
6758,147765,FTc6jHk7ojdVaEQtsGdTEiSOrQxUe2mX,fbPkOYLVPtPgIt0MxizjfFJov3JbHyAi,5,2,1,0,1,0,2,0,6,0.8571428571428571,1,0.0,0,1,0,1,2,0,0,2,0,2,4,1
6759,147766,V7i4XepTGJkVDBndf2aQyywvfMxZi1VZ,fbPkOYLVPtPgIt0MxizjfFJov3JbHyAi,5,3,1,0,1,0,3,0,8,1.1428571428571428,1,0.0,0,1,0,1,3,0,0,3,0,2,6,1
6760,147767,pfujrhh6IFsgpvQm0YrnHZDUVmO3MMCt,fbPkOYLVPtPgIt0MxizjfFJov3JbHyAi,2,0,0,0,0,0,3,0,3,0.42857142857142855,1,0.0,0,0,0,0,0,0,0,3,0,0,3,1
6761,147777,ADt4SeNSXIM0T3FNDJeQ4CFmAhPZqDNW,fbPkOYLVPtPgIt0MxizjfFJov3JbHyAi,7,3,2,0,2,0,2,0,9,1.2857142857142858,1,0.0,0,2,0,2,3,0,0,2,0,4,5,1
6762,147779,BucCzwL2XP7gPTz7VVXQ2NN15VleWmxc,fbPkOYLVPtPgIt0MxizjfFJov3JbHyAi,7,3,2,0,2,0,2,0,9,1.2857142857142858,1,0.0,0,2,0,2,3,0,0,2,0,4,5,1
6763,147788,v80xARhw6o0qWoZhV3Z6c6dVXIF7GAis,fbPkOYLVPtPgIt0MxizjfFJov3JbHyAi,8,5,2,0,2,2,5,0,16,2.2857142857142856,1,0.0,0,2,0,2,5,2,0,5,0,4,12,1
6764,147792,rT1OrFQC18rdvYkTGYqwRgC7eDvihHsc,fbPkOYLVPtPgIt0MxizjfFJov3JbHyAi,1,0,0,0,0,2,0,0,2,0.2857142857142857,1,0.0,0,0,0,0,0,2,0,0,0,0,2,1
6765,148297,mSs5bB1Rxg3xYWjWjJY9pVTt7WAiMgyu,7GRhBDsirIGkRZBtSMEzNTyDr2JQm4xx,1,0,0,0,0,0,2,0,2,0.2857142857142857,1,0.0,0,0,0,0,0,0,0,2,0,0,2,0
6766,148308,AgkxRkUEeKaWJWeFdUfFP1oidzDmX3wN,7GRhBDsirIGkRZBtSMEzNTyDr2JQm4xx,2,0,0,0,0,0,2,0,2,0.2857142857142857,1,0.0,0,0,0,0,0,0,0,2,0,0,2,1
6767,148349,9ygD0mCVCT1xftgjX9ZtkVBAEBAxmXMV,fbPkOYLVPtPgIt0MxizjfFJov3JbHyAi,4,3,2,0,2,0,1,0,8,1.1428571428571428,1,0.0,0,2,0,2,3,0,0,1,0,4,4,1
6768,148350,c9Dj079MYKUiWTTvAk5TtHXcSaCd3TDw,fbPkOYLVPtPgIt0MxizjfFJov3JbHyAi,5,3,2,0,0,0,8,0,13,1.8571428571428572,1,0.0,0,2,0,0,3,0,0,8,0,2,11,1
6769,148353,kxG2Ez4bVR5aERCBG6xs61rr9emGwqKo,fbPkOYLVPtPgIt0MxizjfFJov3JbHyAi,6,3,2,0,2,0,4,0,11,1.5714285714285714,3,0.0,0,2,0,2,3,0,0,4,0,4,7,1
6770,148358,bgLrRcnTjnOSlAj1yyvNbcR2GZlKU2gU,fbPkOYLVPtPgIt0MxizjfFJov3JbHyAi,25,30,13,12,10,15,2,0,82,11.714285714285714,1,0.0,12,13,10,10,18,15,2,2,0,45,37,1
6771,148366,fi4TXeoZ9lfPojTLqkoAXZWQgcUwi3WY,fbPkOYLVPtPgIt0MxizjfFJov3JbHyAi,9,5,5,0,5,4,7,1,27,3.857142857142857,2,0.0,0,5,0,5,5,4,0,7,1,10,17,1
6772,148367,CUHsvexAAfaCEMKsM3644JTxXL5DgSss,fbPkOYLVPtPgIt0MxizjfFJov3JbHyAi,5,3,2,0,2,0,2,0,9,1.2857142857142858,1,0.0,0,2,0,2,3,0,0,2,0,4,5,1
6773,148368,0oCNqxLZfnQykzt9jEtrYeCAvyN5aMiK,fbPkOYLVPtPgIt0MxizjfFJov3JbHyAi,2,0,0,0,0,0,5,0,5,0.7142857142857143,1,0.0,0,0,0,0,0,0,0,5,0,0,5,1
6774,148371,ULdF32fTmMpV957Ngz6P80D0kuxYFb2A,fbPkOYLVPtPgIt0MxizjfFJov3JbHyAi,1,0,0,0,0,0,1,0,1,0.14285714285714285,1,0.0,0,0,0,0,0,0,0,1,0,0,1,1
6775,148375,9LHCfUuBRybCFmCd7bbV3yZ92Mp8tv7j,fbPkOYLVPtPgIt0MxizjfFJov3JbHyAi,1,0,0,0,0,0,1,0,1,0.14285714285714285,1,0.0,0,0,0,0,0,0,0,1,0,0,1,1
6776,148378,KalDXAC9uFbnu9AKEx3pGk1aVT7IBvd6,fbPkOYLVPtPgIt0MxizjfFJov3JbHyAi,2,0,0,0,0,0,3,0,3,0.42857142857142855,1,0.0,0,0,0,0,0,0,0,3,0,0,3,1
6777,148379,MKj9RE36KMaNQttYmK1FP436E01YmNeZ,fbPkOYLVPtPgIt0MxizjfFJov3JbHyAi,2,0,0,0,0,0,2,0,2,0.2857142857142857,1,0.0,0,0,0,0,0,0,0,2,0,0,2,1
6778,148381,WYlT48XIScuGFSR7mYrH3M5CfjOCOMTP,fbPkOYLVPtPgIt0MxizjfFJov3JbHyAi,13,12,1,0,1,0,3,0,17,2.4285714285714284,1,0.0,0,1,0,1,12,0,0,3,0,2,15,1
6779,148382,qJEf5DGSDkSxZ1JIhipEbBFRbrhnAj1a,fbPkOYLVPtPgIt0MxizjfFJov3JbHyAi,6,8,2,0,1,0,2,0,13,1.8571428571428572,1,0.0,0,2,0,1,8,0,0,2,0,3,10,1
6780,148383,9TLjVfAVQirUv9D0iCSnjtMLWmZOKr0C,fbPkOYLVPtPgIt0MxizjfFJov3JbHyAi,7,3,2,0,2,0,4,0,11,1.5714285714285714,1,0.0,0,2,0,2,3,0,0,4,0,4,7,1
6781,148384,EQVGtOGC6NrveIndUoSckLgaBol5CW91,fbPkOYLVPtPgIt0MxizjfFJov3JbHyAi,1,0,0,0,0,0,1,0,1,0.14285714285714285,1,0.0,0,0,0,0,0,0,0,1,0,0,1,1
6782,148385,ciDinbfum1guAgZtUPEyI6UQ7y3ahoVh,fbPkOYLVPtPgIt0MxizjfFJov3JbHyAi,6,3,2,0,2,0,1,0,8,1.1428571428571428,1,0.0,0,2,0,2,3,0,0,1,0,4,4,1
6783,148388,idmrxuEoIjSYuzZhdG66vR2sh6aBS2ui,fbPkOYLVPtPgIt0MxizjfFJov3JbHyAi,2,0,0,0,0,0,2,0,2,0.2857142857142857,1,0.0,0,0,0,0,0,0,0,2,0,0,2,1
6784,148441,C5JjdaA2TpnbGFuMIjvBUyS5u6COBRuh,A3fsA9Zfv1X2fVEQhTw51lKENdNrEqT3,47,35,20,180,7,0,5,0,247,35.285714285714285,3,0.0,3,20,178,7,32,0,2,5,0,208,39,1
6785,148465,aISyThuiw10fsCPPUtqVz2ccwIDIESls,G8EPVSXsOYB5YQWZGiz1aVq5Pgr2GrQu,92,171,101,247,0,97,42,6,664,94.85714285714286,10,0.0,20,101,213,0,151,97,34,42,6,334,330,0
6786,148503,9CQfIvDiQz4gDArSnTXOgxNKUwJW75pD,SpATywNh6bZuzm8s1ceuBUnMUAeoAHHw,31,51,29,35,10,2,32,3,162,23.142857142857142,5,0.0,7,29,30,10,44,2,5,32,3,76,86,0
6787,148577,1TDqryriD1i68B6PFn9vcGOnlC4cHux8,A3fsA9Zfv1X2fVEQhTw51lKENdNrEqT3,13,14,7,0,7,0,2,0,30,4.285714285714286,1,0.0,0,7,0,7,14,0,0,2,0,14,16,1
6788,148598,sg4VVv9cgk6nt80dZvUKhL5H7RMgLm0l,SpATywNh6bZuzm8s1ceuBUnMUAeoAHHw,5,3,1,0,0,0,2,0,6,0.8571428571428571,1,0.0,0,1,0,0,3,0,0,2,0,1,5,1
6789,148611,oGTSG0bYZEKmqMQUI2QOgfbr6I1mZJJh,SpATywNh6bZuzm8s1ceuBUnMUAeoAHHw,20,44,5,18,2,0,35,1,105,15.0,4,0.0,7,5,15,2,37,0,3,35,1,29,76,1
6790,148612,ZdOBK87GOMIn8wzMbSvbPLgG549sCOY6,A3fsA9Zfv1X2fVEQhTw51lKENdNrEqT3,6,3,2,0,2,0,1,0,8,1.1428571428571428,1,0.0,0,2,0,2,3,0,0,1,0,4,4,1
6791,148627,eK6us9hOnBMXSFhvwgioyiPARpsZ94KW,A3fsA9Zfv1X2fVEQhTw51lKENdNrEqT3,2,0,0,0,0,0,3,0,3,0.42857142857142855,1,0.0,0,0,0,0,0,0,0,3,0,0,3,1
6792,148654,sTxEoxueQ2iNvcjPH8BgpVT2Uz1KyXvb,A3fsA9Zfv1X2fVEQhTw51lKENdNrEqT3,12,14,10,0,4,8,7,0,43,6.142857142857143,2,0.0,1,10,0,4,13,8,0,7,0,15,28,1
6793,148666,cAYlx5bxU4cY2ACDTf2EB19Cf6nnrW4p,A3fsA9Zfv1X2fVEQhTw51lKENdNrEqT3,2,0,0,0,0,0,2,0,2,0.2857142857142857,1,0.0,0,0,0,0,0,0,0,2,0,0,2,1
6794,148668,qaT3OJRfY4kTUsuWIZdgTvNFyRsoPB48,A3fsA9Zfv1X2fVEQhTw51lKENdNrEqT3,16,19,2,20,1,0,9,0,51,7.285714285714286,2,0.0,0,2,15,1,19,0,5,9,0,18,33,1
6795,148708,QffrhmaCXbaB9XOhV3NLOmPuRvGWA3G5,SpATywNh6bZuzm8s1ceuBUnMUAeoAHHw,16,7,4,9,3,0,5,1,29,4.142857142857143,1,0.0,2,4,9,3,5,0,0,5,1,18,11,1
6796,148724,4YDp1nxKf6ZgyVxOrG2MY3nyG30jIlTN,SpATywNh6bZuzm8s1ceuBUnMUAeoAHHw,19,30,12,10,7,0,10,0,69,9.857142857142858,4,0.0,3,12,9,7,27,0,1,10,0,31,38,1
6797,148741,lcf8IA11Zd7V2ZBaDLUO5BNWLkJI60Zh,A3fsA9Zfv1X2fVEQhTw51lKENdNrEqT3,6,5,1,0,1,0,2,0,9,1.2857142857142858,2,0.0,0,1,0,1,5,0,0,2,0,2,7,1
6798,148773,f2RxaLdYf2Tr0XIXAiBwlA7VXVA1XDPz,SpATywNh6bZuzm8s1ceuBUnMUAeoAHHw,17,39,16,20,6,4,12,1,98,14.0,1,0.0,17,16,16,6,22,4,4,12,1,55,43,1
6799,148776,6EaK0gHFiSwbLJpDVBHv9ZNNoyIiEert,SpATywNh6bZuzm8s1ceuBUnMUAeoAHHw,13,36,7,17,0,0,4,0,64,9.142857142857142,2,0.0,23,7,17,0,13,0,0,4,0,47,17,0
6800,148992,4OV0W0nOUO05rXo3pxbmiSLc9O458KIT,SpATywNh6bZuzm8s1ceuBUnMUAeoAHHw,3,1,0,0,0,0,2,0,3,0.42857142857142855,1,0.0,0,0,0,0,1,0,0,2,0,0,3,0
6801,149014,5UJZmEar1AX3gQXOzkh3MnQcYdErI17M,bWdj2GDclj5ofokWjzoa5jAwMkxCykd6,6,5,3,0,2,7,2,0,19,2.7142857142857144,1,0.0,0,3,0,2,5,7,0,2,0,5,14,0
6802,149135,HDeZBhNQKtgQRWJ96cSCNvruJhAhiBb4,SpATywNh6bZuzm8s1ceuBUnMUAeoAHHw,1,0,0,0,0,0,2,0,2,0.2857142857142857,1,0.0,0,0,0,0,0,0,0,2,0,0,2,1
6803,149175,fxLa2btVt7GxkzfoIMOfvQ33z85P1T4A,A3fsA9Zfv1X2fVEQhTw51lKENdNrEqT3,1,0,0,0,0,0,1,0,1,0.14285714285714285,1,0.0,0,0,0,0,0,0,0,1,0,0,1,1
6804,149400,ne1lWju9UTXOBd1dA2M5rJRVVshMCIYz,A3fsA9Zfv1X2fVEQhTw51lKENdNrEqT3,2,0,0,0,0,0,2,0,2,0.2857142857142857,1,0.0,0,0,0,0,0,0,0,2,0,0,2,1
6805,149420,vVmrtbXOR8LaWp48hajdNZIlFCL7http,SpATywNh6bZuzm8s1ceuBUnMUAeoAHHw,7,4,3,0,3,0,2,0,12,1.7142857142857142,1,0.0,0,3,0,3,4,0,0,2,0,6,6,1
6806,149421,RAAQLpPenoCljHENtpqjvSXS8Gfv0T1E,A3fsA9Zfv1X2fVEQhTw51lKENdNrEqT3,13,6,4,0,3,1,5,1,20,2.857142857142857,1,0.0,0,4,0,3,6,1,0,5,1,7,13,1
6807,149440,HhHFHVl0FdyFAQQ7F70xD2HQyGMqv85Q,A3fsA9Zfv1X2fVEQhTw51lKENdNrEqT3,15,18,2,0,1,0,5,0,26,3.7142857142857144,3,0.0,0,2,0,1,18,0,0,5,0,3,23,1
6808,149505,TgcCH3erWiZRHJcY2HABDtNaJwPoDafv,SpATywNh6bZuzm8s1ceuBUnMUAeoAHHw,3,0,0,0,0,0,3,0,3,0.42857142857142855,1,0.0,0,0,0,0,0,0,0,3,0,0,3,1
6809,149569,KR5RKdabOCnxR33wIN39OavKAg4R47ZU,A3fsA9Zfv1X2fVEQhTw51lKENdNrEqT3,9,4,1,0,1,1,6,0,13,1.8571428571428572,1,0.0,0,1,0,1,4,1,0,6,0,2,11,1
6810,149570,8958pt2z4OHwTl32JK0k9CAPziEN4Bzu,SpATywNh6bZuzm8s1ceuBUnMUAeoAHHw,6,5,1,0,0,11,5,0,22,3.142857142857143,2,0.0,0,1,0,0,5,11,0,5,0,1,21,1
6811,149573,0aomsNaDMmIRvMUNvKVIFXzFDfLWKysB,A3fsA9Zfv1X2fVEQhTw51lKENdNrEqT3,2,0,0,0,0,0,2,0,2,0.2857142857142857,1,0.0,0,0,0,0,0,0,0,2,0,0,2,1
6812,149575,MDp7DOIvKcLxQwYa7iYETsW6UM7XLKe9,SpATywNh6bZuzm8s1ceuBUnMUAeoAHHw,3,2,0,0,0,0,1,0,3,0.42857142857142855,1,0.0,0,0,0,0,2,0,0,1,0,0,3,1
6813,149586,SdSbeWd4oEnIQjEokLws1yqSOv3sXqaR,A3fsA9Zfv1X2fVEQhTw51lKENdNrEqT3,2,0,0,0,0,0,2,0,2,0.2857142857142857,1,0.0,0,0,0,0,0,0,0,2,0,0,2,1
6814,149617,8aV4yRTVM0HzdlWjuQKHgiNXm0RErk1U,bWdj2GDclj5ofokWjzoa5jAwMkxCykd6,4,2,0,0,0,0,5,0,7,1.0,1,0.0,0,0,0,0,2,0,0,5,0,0,7,0
6815,149633,tmwYxPndf0bBoBktnRObtCNzTZcFIFQq,SpATywNh6bZuzm8s1ceuBUnMUAeoAHHw,9,13,0,2,0,0,4,0,19,2.7142857142857144,2,0.0,6,0,2,0,7,0,0,4,0,8,11,1
6816,149655,BvI5CiGNtYcKpjVG9fTMezMQs6vWmHfH,bWdj2GDclj5ofokWjzoa5jAwMkxCykd6,4,4,3,0,3,0,1,0,11,1.5714285714285714,1,0.0,0,3,0,3,4,0,0,1,0,6,5,1
6817,149682,cQ0KD7lyMK06WYdfiZiDvkcnrB91X6dF,RXDvfPUBYFlVdlueBFbLW0mhhAyGEqpt,1,0,0,0,0,0,1,0,1,0.14285714285714285,1,0.0,0,0,0,0,0,0,0,1,0,0,1,0
6818,149692,7AAdXAGWvappN7B38jOB9fzxLSuIXADG,RXDvfPUBYFlVdlueBFbLW0mhhAyGEqpt,5,2,1,0,1,0,2,0,6,0.8571428571428571,1,0.0,0,1,0,1,2,0,0,2,0,2,4,0
6819,149724,p5nLTT7lxlGHa4qmyYsgcjTpAWKheo2V,A3fsA9Zfv1X2fVEQhTw51lKENdNrEqT3,17,8,6,0,5,0,21,2,42,6.0,2,0.0,0,6,0,5,8,0,0,21,2,11,31,1
6820,149734,364UhjscaMOKYjf1pPgmVT64NkpJR1Jx,A3fsA9Zfv1X2fVEQhTw51lKENdNrEqT3,1,0,0,0,0,0,1,0,1,0.14285714285714285,1,0.0,0,0,0,0,0,0,0,1,0,0,1,1
6821,149814,OUOJlObKrXM0JmEUq0o8KzZHzr8jy9dn,A3fsA9Zfv1X2fVEQhTw51lKENdNrEqT3,8,4,3,0,3,0,1,0,11,1.5714285714285714,1,0.0,0,3,0,3,4,0,0,1,0,6,5,0
6822,149816,U8u2oofRYkvAFc5S0d9MPpENNm076FZl,G8EPVSXsOYB5YQWZGiz1aVq5Pgr2GrQu,16,17,1,28,1,3,8,0,58,8.285714285714286,1,0.0,2,1,24,1,15,3,4,8,0,28,30,0
6823,149853,EGrooJVAAIUP6U4I2p0rt4nL3Y713JTJ,bWdj2GDclj5ofokWjzoa5jAwMkxCykd6,12,17,12,0,7,0,8,0,44,6.285714285714286,2,0.0,0,12,0,7,17,0,0,8,0,19,25,1
6824,149861,s1avI0XWB1DlJJFaBkTxVlC3TXo4qwtF,A3fsA9Zfv1X2fVEQhTw51lKENdNrEqT3,2,0,0,0,0,0,2,0,2,0.2857142857142857,1,0.0,0,0,0,0,0,0,0,2,0,0,2,1
6825,149869,DV9cmKY91lk8lKsMUmLIMP1KsHFcyZMK,bWdj2GDclj5ofokWjzoa5jAwMkxCykd6,5,10,6,0,0,0,1,0,17,2.4285714285714284,1,0.0,0,6,0,0,10,0,0,1,0,6,11,1
6826,149877,SANLEmv2xqr9UbPUpTzbFGNJfLVXFrzf,SpATywNh6bZuzm8s1ceuBUnMUAeoAHHw,15,21,1,21,0,38,9,1,91,13.0,1,0.0,7,1,17,0,14,38,4,9,1,25,66,1
6827,149950,byUmCtzRLWWrWRajFZnozMEalaeEKWAr,RXDvfPUBYFlVdlueBFbLW0mhhAyGEqpt,24,16,10,28,7,0,2,0,63,9.0,2,0.0,3,10,26,7,13,0,2,2,0,46,17,1
6828,150014,iyF9qVPSlqT1UqIz618IudxC9zNsOV1h,A3fsA9Zfv1X2fVEQhTw51lKENdNrEqT3,1,0,0,0,0,0,1,0,1,0.14285714285714285,1,0.0,0,0,0,0,0,0,0,1,0,0,1,1
6829,150075,FWX9YkLyj47mhurdCZuuv2217ViDfzCr,A3fsA9Zfv1X2fVEQhTw51lKENdNrEqT3,2,0,0,0,0,0,2,0,2,0.2857142857142857,1,0.0,0,0,0,0,0,0,0,2,0,0,2,1
6830,152852,8eAVRzls7MGQwc3WaPP7ONmygmpXQE3K,7GRhBDsirIGkRZBtSMEzNTyDr2JQm4xx,29,32,12,33,9,1,2,0,89,12.714285714285714,1,0.0,18,12,30,9,14,1,3,2,0,69,20,1
6831,152889,4BpRE14XuCFERPNFltqE4ojcMHw6pKyT,7GRhBDsirIGkRZBtSMEzNTyDr2JQm4xx,6,2,1,0,1,0,3,0,7,1.0,1,0.0,0,1,0,1,2,0,0,3,0,2,5,1
6832,152924,1UDHQI8imw8nweB1TYtOC79yWWeAk6dI,7GRhBDsirIGkRZBtSMEzNTyDr2JQm4xx,1,0,0,0,0,0,1,0,1,0.14285714285714285,1,0.0,0,0,0,0,0,0,0,1,0,0,1,1
6833,152950,2bFnB4uI8l4fyqIbUzJ6PgGAsqDupazk,7GRhBDsirIGkRZBtSMEzNTyDr2JQm4xx,5,2,0,0,0,2,4,0,8,1.1428571428571428,1,0.0,0,0,0,0,2,2,0,4,0,0,8,1
6834,153021,dcAfcDe1XQG4OPzTBHUeq4qqwRgLRIBM,7GRhBDsirIGkRZBtSMEzNTyDr2JQm4xx,33,36,18,42,20,3,3,0,122,17.428571428571427,1,0.0,16,18,40,20,20,3,2,3,0,94,28,1
6835,153052,UfBZxbp3dHdvs4dmjpPF1a599SiVHfq9,7GRhBDsirIGkRZBtSMEzNTyDr2JQm4xx,13,14,7,0,4,0,3,0,28,4.0,1,0.0,0,7,0,4,14,0,0,3,0,11,17,1
6836,153070,nNeSwHjoP91mmln5SrcL87TOEBs15zTk,7GRhBDsirIGkRZBtSMEzNTyDr2JQm4xx,2,0,0,0,0,0,2,0,2,0.2857142857142857,1,0.0,0,0,0,0,0,0,0,2,0,0,2,1
6837,153072,IOcEoixO9HVhIQeLNHKaS3iQynrmSTmV,7GRhBDsirIGkRZBtSMEzNTyDr2JQm4xx,40,148,34,63,6,37,29,3,320,45.714285714285715,4,0.0,87,34,49,6,61,37,14,29,3,176,144,0
6838,153082,pc8Cijkar16XHq3iOS71C2O61xVOM7hS,7GRhBDsirIGkRZBtSMEzNTyDr2JQm4xx,1,0,0,0,0,0,1,0,1,0.14285714285714285,1,0.0,0,0,0,0,0,0,0,1,0,0,1,1
6839,153106,4dWOmHqqlMb2FlRY2mDnSBR6FrPBKxXO,7GRhBDsirIGkRZBtSMEzNTyDr2JQm4xx,2,0,0,0,0,0,5,0,5,0.7142857142857143,1,0.0,0,0,0,0,0,0,0,5,0,0,5,1
6840,153205,pvxjw4szSuluDWQ3DWPes9Mzs1MCvxjI,SpATywNh6bZuzm8s1ceuBUnMUAeoAHHw,30,36,21,36,10,11,25,5,144,20.571428571428573,6,0.0,6,21,30,10,30,11,6,25,5,67,77,1
6841,153209,5ZHw0M7FTk5cO1fK8KsZKsofS7GANtcz,SpATywNh6bZuzm8s1ceuBUnMUAeoAHHw,14,22,2,10,0,17,7,1,59,8.428571428571429,1,0.0,5,2,9,0,17,17,1,7,1,16,43,1
6842,153222,qGeBgOr7St26ZmQVIT5NibjBEisNw9ln,SpATywNh6bZuzm8s1ceuBUnMUAeoAHHw,23,34,21,11,5,2,11,1,85,12.142857142857142,5,0.0,2,21,10,5,32,2,1,11,1,38,47,1
6843,153223,4iqKNHeZS5JSEDCOEGY9iVAlANRyx0Hy,bWdj2GDclj5ofokWjzoa5jAwMkxCykd6,1,0,0,0,0,0,1,0,1,0.14285714285714285,1,0.0,0,0,0,0,0,0,0,1,0,0,1,1
6844,153230,9pfskqYp4pvR53OXPIHxfdcjDCQolJRR,SpATywNh6bZuzm8s1ceuBUnMUAeoAHHw,25,14,9,19,5,4,8,0,59,8.428571428571429,2,0.0,4,9,17,5,10,4,2,8,0,35,24,1
6845,153240,HKDSRzc7MQzCfJsk49D6xFQK4oFHHvy7,G8EPVSXsOYB5YQWZGiz1aVq5Pgr2GrQu,11,7,1,6,2,0,7,0,23,3.2857142857142856,2,0.0,5,1,3,2,2,0,3,7,0,11,12,1
6846,153250,b9mxLoVADmerKv5HkkvTTWu7wHJ0K2g8,RXDvfPUBYFlVdlueBFbLW0mhhAyGEqpt,5,3,1,0,1,0,1,0,6,0.8571428571428571,1,0.0,0,1,0,1,3,0,0,1,0,2,4,1
6847,153254,CxT0CHLq6J1c8Jut4aoI3ctVaIuJrmZd,SpATywNh6bZuzm8s1ceuBUnMUAeoAHHw,6,2,1,0,1,0,4,0,8,1.1428571428571428,1,0.0,0,1,0,1,2,0,0,4,0,2,6,1
6848,153304,AxjnggPTKyT2aYQCBpgnjenDZZbNsOpc,SpATywNh6bZuzm8s1ceuBUnMUAeoAHHw,15,13,2,4,0,0,2,0,21,3.0,2,0.0,0,2,4,0,13,0,0,2,0,6,15,0
6849,153320,17nF9FTjTWCsbOCjXVTb0OZUIQSKIDV1,SpATywNh6bZuzm8s1ceuBUnMUAeoAHHw,5,3,1,0,1,0,1,0,6,0.8571428571428571,1,0.0,0,1,0,1,3,0,0,1,0,2,4,1
6850,153335,OgqpjGMMInWS9PhYsy4mlMX0fhVM7tcA,SpATywNh6bZuzm8s1ceuBUnMUAeoAHHw,27,51,24,30,17,4,3,0,129,18.428571428571427,3,0.0,14,24,27,17,37,4,3,3,0,82,47,1
6851,153344,zFxBEkWmbKmgcm9gb8oYLXK8dhxOMTgG,bWdj2GDclj5ofokWjzoa5jAwMkxCykd6,4,2,1,0,1,0,1,0,5,0.7142857142857143,1,0.0,0,1,0,1,2,0,0,1,0,2,3,1
6852,153359,OsZOOHLTzswhvwcqovfIZ4d3mMdzbQV4,bWdj2GDclj5ofokWjzoa5jAwMkxCykd6,4,2,0,0,0,0,2,0,4,0.5714285714285714,1,0.0,0,0,0,0,2,0,0,2,0,0,4,1
6853,153377,pShr7F4fdPHy76vFAX1gnyjDQNfbMT7w,SpATywNh6bZuzm8s1ceuBUnMUAeoAHHw,9,6,4,0,3,0,5,0,18,2.5714285714285716,1,0.0,0,4,0,3,6,0,0,5,0,7,11,1
6854,153381,mgLL2TOXKEK8di2v3UUyM4FMUqEuj4kl,bWdj2GDclj5ofokWjzoa5jAwMkxCykd6,1,0,0,0,0,0,1,0,1,0.14285714285714285,1,0.0,0,0,0,0,0,0,0,1,0,0,1,1
6855,153388,afQkAxUvdLu532EqkP2BO2E822Re7HYk,A3fsA9Zfv1X2fVEQhTw51lKENdNrEqT3,1,0,0,0,0,0,1,0,1,0.14285714285714285,1,0.0,0,0,0,0,0,0,0,1,0,0,1,1
6856,153389,afQkAxUvdLu532EqkP2BO2E822Re7HYk,bWdj2GDclj5ofokWjzoa5jAwMkxCykd6,1,0,0,0,0,0,1,0,1,0.14285714285714285,1,0.0,0,0,0,0,0,0,0,1,0,0,1,1
6857,153404,ZoDpWjHIWpxSzHmkG8xPsIIgTQq9K5uN,SpATywNh6bZuzm8s1ceuBUnMUAeoAHHw,15,20,7,15,1,2,6,1,52,7.428571428571429,3,0.0,9,7,14,1,11,2,1,6,1,31,21,1
6858,153443,ngup3fucB3JZQIAGeEk4g3OEqzwFokS0,A3fsA9Zfv1X2fVEQhTw51lKENdNrEqT3,15,7,6,0,6,3,6,0,28,4.0,1,0.0,0,6,0,6,7,3,0,6,0,12,16,1
6859,153457,cYe4n4c9KPDfBEWjGIRj6ImLxtmj3FnE,SpATywNh6bZuzm8s1ceuBUnMUAeoAHHw,24,35,17,4,8,1,10,2,77,11.0,4,0.0,0,17,4,8,35,1,0,10,2,29,48,0
6860,153527,7abxlkdMiNWAIk78NzVnHWo2fZI6eMvl,G8EPVSXsOYB5YQWZGiz1aVq5Pgr2GrQu,1,0,0,0,0,0,1,0,1,0.14285714285714285,1,0.0,0,0,0,0,0,0,0,1,0,0,1,1
6861,153528,Xbyo7HUsTZeFyBz3S4UH7TOjaOcOatNR,G8EPVSXsOYB5YQWZGiz1aVq5Pgr2GrQu,14,9,4,10,2,1,7,0,33,4.714285714285714,1,0.0,3,4,7,2,6,1,3,7,0,16,17,1
6862,153554,5ESBYT4YXwThMhRWcyNvUGRmyEr1sxDg,A3fsA9Zfv1X2fVEQhTw51lKENdNrEqT3,8,9,4,0,2,0,2,0,17,2.4285714285714284,2,0.0,0,4,0,2,9,0,0,2,0,6,11,0
6863,153591,wnrnl9khoFP1InwfVTZawT3pFxBvI7k9,SpATywNh6bZuzm8s1ceuBUnMUAeoAHHw,16,15,2,10,3,0,4,0,34,4.857142857142857,1,0.0,4,2,8,3,11,0,2,4,0,17,17,1
6864,153593,UBlBWZ3qSNiPpjfNB2f0HBLc8JT09fQp,bWdj2GDclj5ofokWjzoa5jAwMkxCykd6,1,0,0,0,0,0,1,0,1,0.14285714285714285,1,0.0,0,0,0,0,0,0,0,1,0,0,1,1
6865,153600,f1mXA42Iut2h3an7dNcb6e25YzQPcYho,SpATywNh6bZuzm8s1ceuBUnMUAeoAHHw,28,47,20,27,11,0,6,0,111,15.857142857142858,3,0.0,10,20,25,11,37,0,2,6,0,66,45,1
6866,153603,bGlyGIDBiTQ9cORO6s00PigGAgG0feOe,bWdj2GDclj5ofokWjzoa5jAwMkxCykd6,12,14,0,48,2,6,3,1,74,10.571428571428571,1,0.0,6,0,47,2,8,6,1,3,1,55,19,1
6867,153638,npggYhQDuWIBT1CD0vElHVM5v5VjjGlP,SpATywNh6bZuzm8s1ceuBUnMUAeoAHHw,12,9,5,0,4,0,3,0,21,3.0,2,0.0,0,5,0,4,9,0,0,3,0,9,12,1
6868,153642,y0PkAopIdLmRFrkWC9eBHvWT77KfVWMh,SpATywNh6bZuzm8s1ceuBUnMUAeoAHHw,13,24,11,0,7,0,3,0,45,6.428571428571429,2,0.0,0,11,0,7,24,0,0,3,0,18,27,1
6869,153643,1pusTPLSLF5m0UuZqZkNpGlAq8VrQ1KA,G8EPVSXsOYB5YQWZGiz1aVq5Pgr2GrQu,1,0,0,0,0,0,1,0,1,0.14285714285714285,1,0.0,0,0,0,0,0,0,0,1,0,0,1,1
6870,153651,4arExpTK1wIuXqxD9mjuWbelMebzEsNU,SpATywNh6bZuzm8s1ceuBUnMUAeoAHHw,5,2,1,0,1,0,2,0,6,0.8571428571428571,1,0.0,0,1,0,1,2,0,0,2,0,2,4,1
6871,153665,2mwblOfAIlWCnOpKEy9s0V1Ag6iOs76e,SpATywNh6bZuzm8s1ceuBUnMUAeoAHHw,1,0,0,0,0,0,1,0,1,0.14285714285714285,1,0.0,0,0,0,0,0,0,0,1,0,0,1,1
6872,153668,0ORnjZDNtR58wRPjDahIQtI1SSJa0QxJ,SpATywNh6bZuzm8s1ceuBUnMUAeoAHHw,14,13,7,15,5,0,4,0,44,6.285714285714286,1,0.0,5,7,14,5,8,0,1,4,0,31,13,1
6873,153684,htua1xywlnpsMMY7EJSOsurL86GI912X,A3fsA9Zfv1X2fVEQhTw51lKENdNrEqT3,28,8,4,96,1,0,7,0,116,16.571428571428573,1,0.0,2,4,80,1,6,0,16,7,0,87,29,1
6874,153697,JVadOLmYm00UY6RpVFCz6oCIzPWjF9Xb,bWdj2GDclj5ofokWjzoa5jAwMkxCykd6,4,4,1,0,2,0,1,0,8,1.1428571428571428,1,0.0,2,1,0,2,2,0,0,1,0,5,3,1
6875,153698,imNhKIaFauvST7J9xfEWryq9BWP5AbNf,SpATywNh6bZuzm8s1ceuBUnMUAeoAHHw,1,0,0,0,0,0,1,0,1,0.14285714285714285,1,0.0,0,0,0,0,0,0,0,1,0,0,1,1
6876,153705,imNhKIaFauvST7J9xfEWryq9BWP5AbNf,RXDvfPUBYFlVdlueBFbLW0mhhAyGEqpt,1,0,0,0,0,0,1,0,1,0.14285714285714285,1,0.0,0,0,0,0,0,0,0,1,0,0,1,1
6877,153708,cX96KcLUG7eWbqHO7enIWngg59YqtKEY,SpATywNh6bZuzm8s1ceuBUnMUAeoAHHw,13,32,14,14,1,4,10,2,77,11.0,4,0.0,13,14,13,1,19,4,1,10,2,41,36,1
6878,153744,ttb5iuebPMlcVHZPAjxVbJ8njCe9OqDr,SpATywNh6bZuzm8s1ceuBUnMUAeoAHHw,15,17,3,18,3,0,7,0,48,6.857142857142857,3,0.0,2,3,15,3,15,0,3,7,0,23,25,1
6879,153745,lBUrinPM7S9o6yK6K8JSMwJaVRnBcZFO,bWdj2GDclj5ofokWjzoa5jAwMkxCykd6,4,2,0,0,0,0,3,0,5,0.7142857142857143,1,0.0,0,0,0,0,2,0,0,3,0,0,5,1
6880,153761,VEn1n8siGoYMgQvsRJOH6Mt6C0Cu6W64,SpATywNh6bZuzm8s1ceuBUnMUAeoAHHw,28,23,17,24,11,0,3,0,78,11.142857142857142,3,0.0,4,17,23,11,19,0,1,3,0,55,23,1
6881,153775,NDTWRDiLyYPUSKAzpsOEnrkggSOfO91T,SpATywNh6bZuzm8s1ceuBUnMUAeoAHHw,28,64,37,36,17,0,7,0,161,23.0,4,0.0,17,37,32,17,47,0,4,7,0,103,58,1
6882,153790,IA8IlgrjDUbf5IQm26Ve5t8QQHZhw82k,SpATywNh6bZuzm8s1ceuBUnMUAeoAHHw,1,0,0,0,0,0,1,0,1,0.14285714285714285,1,0.0,0,0,0,0,0,0,0,1,0,0,1,1
6883,153802,JrfTo5GNjMn6EHzlMiG1fSQLURYPPGKs,bWdj2GDclj5ofokWjzoa5jAwMkxCykd6,2,0,0,0,0,0,4,0,4,0.5714285714285714,1,0.0,0,0,0,0,0,0,0,4,0,0,4,1
6884,153806,VhpXVmuePjSLeMVIlElMMladDGd0odWC,bWdj2GDclj5ofokWjzoa5jAwMkxCykd6,17,17,6,24,0,3,4,0,54,7.714285714285714,1,0.0,6,6,23,0,11,3,1,4,0,35,19,0
6885,153810,pGNIRV05CYiaTTY4zIoziuGcEcxqXgio,A3fsA9Zfv1X2fVEQhTw51lKENdNrEqT3,5,1,0,0,0,0,3,2,6,0.8571428571428571,1,0.0,0,0,0,0,1,0,0,3,2,0,6,1
6886,153815,ocmyq6MXRULfgpYdGM8QGfWnP2Queprt,RXDvfPUBYFlVdlueBFbLW0mhhAyGEqpt,1,0,0,0,0,0,1,0,1,0.14285714285714285,1,0.0,0,0,0,0,0,0,0,1,0,0,1,1
6887,153857,BsO4gYCEUXQGKYLyHXV4q0f2CE6gKQPc,bWdj2GDclj5ofokWjzoa5jAwMkxCykd6,2,0,0,0,0,0,2,0,2,0.2857142857142857,1,0.0,0,0,0,0,0,0,0,2,0,0,2,1
6888,153860,ZNBGAlJve4TYJ3FcDlTLBdyuklADldDZ,A3fsA9Zfv1X2fVEQhTw51lKENdNrEqT3,6,5,3,0,1,0,2,0,11,1.5714285714285714,2,0.0,0,3,0,1,5,0,0,2,0,4,7,1
6889,153882,WY9Kk93NuRsoZvVUYcqVREh3xtBHbvAb,SpATywNh6bZuzm8s1ceuBUnMUAeoAHHw,1,0,0,0,0,0,2,0,2,0.2857142857142857,1,0.0,0,0,0,0,0,0,0,2,0,0,2,1
6890,153883,5hosZ8hQASGCVLdW9XYMecTXS9o9Kexh,G8EPVSXsOYB5YQWZGiz1aVq5Pgr2GrQu,7,3,2,0,2,0,2,0,9,1.2857142857142858,1,0.0,0,2,0,2,3,0,0,2,0,4,5,1
6891,153898,q9ayVwEoKiDDsIKc3IAHGSTn37C2BcId,SpATywNh6bZuzm8s1ceuBUnMUAeoAHHw,1,0,0,0,0,0,4,0,4,0.5714285714285714,1,0.0,0,0,0,0,0,0,0,4,0,0,4,1
6892,153916,fg9xG7J3hLazBdFakHteLNxtYgOMtOn7,SpATywNh6bZuzm8s1ceuBUnMUAeoAHHw,5,5,1,0,1,0,3,0,10,1.4285714285714286,1,0.0,2,1,0,1,3,0,0,3,0,4,6,1
6893,153925,LH8Ugxvjxhypkt5v1imhfncDCGMVYvOX,SpATywNh6bZuzm8s1ceuBUnMUAeoAHHw,7,46,3,0,1,1,15,0,66,9.428571428571429,1,0.0,0,3,0,1,46,1,0,15,0,4,62,1
6894,153930,a7HqL5rVaBWdmJJ0LA7o4pdEGfF0vFCf,SpATywNh6bZuzm8s1ceuBUnMUAeoAHHw,24,18,11,29,6,0,3,0,67,9.571428571428571,1,0.0,6,11,28,6,12,0,1,3,0,51,16,1
6895,153939,ECkqmAuIkv3ncN9wNJby8oOn15qTd9kR,bWdj2GDclj5ofokWjzoa5jAwMkxCykd6,2,0,0,0,0,0,3,0,3,0.42857142857142855,3,0.0,0,0,0,0,0,0,0,3,0,0,3,1
6896,153960,lHqG7UT3evpRhAVEeXMKWozC3OBfRB6b,bWdj2GDclj5ofokWjzoa5jAwMkxCykd6,4,1,1,0,0,0,2,0,4,0.5714285714285714,1,0.0,0,1,0,0,1,0,0,2,0,1,3,1
6897,153970,rK6GKHeyjKWUALwDzkIRQ6keCnDOngXi,SpATywNh6bZuzm8s1ceuBUnMUAeoAHHw,9,10,3,8,0,0,6,0,27,3.857142857142857,3,0.0,6,3,8,0,4,0,0,6,0,17,10,1
6898,153980,RuTxY8DaJW8mZYxEAeQrQJD3l4wbq41Q,A3fsA9Zfv1X2fVEQhTw51lKENdNrEqT3,9,5,1,0,1,0,5,0,12,1.7142857142857142,1,0.0,0,1,0,1,5,0,0,5,0,2,10,1
6899,153981,PWSenA2xTFV9h2dRBUmJc6Dd5CU49Bfk,SpATywNh6bZuzm8s1ceuBUnMUAeoAHHw,8,3,3,0,2,0,6,0,14,2.0,3,0.0,0,3,0,2,3,0,0,6,0,5,9,1
6900,153987,tWEnJYIhXMJ03Foo959mubaAJUHZPTw0,bWdj2GDclj5ofokWjzoa5jAwMkxCykd6,1,0,0,0,0,0,1,0,1,0.14285714285714285,1,0.0,0,0,0,0,0,0,0,1,0,0,1,1
6901,153994,y0CnonzJAddQ4oYr5LBSP0Y6KP3RgPGg,bWdj2GDclj5ofokWjzoa5jAwMkxCykd6,3,2,1,0,0,0,1,0,4,0.5714285714285714,1,0.0,0,1,0,0,2,0,0,1,0,1,3,1
6902,154004,Cf7GCeUZzG7WjvUIyGfwv9hfcwXPVq5G,SpATywNh6bZuzm8s1ceuBUnMUAeoAHHw,24,54,2,32,1,20,16,0,125,17.857142857142858,9,0.0,8,2,29,1,46,20,3,16,0,40,85,0
6903,154030,ijmzTkXDQO41J49xgIf8BYjGtAGyN9zu,SpATywNh6bZuzm8s1ceuBUnMUAeoAHHw,1,0,0,0,0,0,1,0,1,0.14285714285714285,1,0.0,0,0,0,0,0,0,0,1,0,0,1,1
6904,154035,DHCzWncH94ErnybHPppeaE2nTRJmmMhY,SpATywNh6bZuzm8s1ceuBUnMUAeoAHHw,32,95,37,41,13,44,17,6,253,36.142857142857146,2,0.0,45,37,33,13,50,44,8,17,6,128,125,1
6905,154042,2K1Z8MHkxSfa3IoXQMOOkvPRYry0VFvS,A3fsA9Zfv1X2fVEQhTw51lKENdNrEqT3,6,3,2,0,2,0,1,0,8,1.1428571428571428,1,0.0,0,2,0,2,3,0,0,1,0,4,4,1
6906,154089,HiNePj7VyLNET123cNCa7VjP10PYv5CS,SpATywNh6bZuzm8s1ceuBUnMUAeoAHHw,9,9,4,0,2,0,2,0,17,2.4285714285714284,1,0.0,4,4,0,2,5,0,0,2,0,10,7,1
6907,154117,BdPEjrNeRWORvoAvmySSATaD7FpfgjJ7,bWdj2GDclj5ofokWjzoa5jAwMkxCykd6,1,0,0,0,0,0,1,0,1,0.14285714285714285,1,0.0,0,0,0,0,0,0,0,1,0,0,1,1
6908,154119,BdPEjrNeRWORvoAvmySSATaD7FpfgjJ7,A3fsA9Zfv1X2fVEQhTw51lKENdNrEqT3,4,0,0,0,0,0,3,1,4,0.5714285714285714,1,0.0,0,0,0,0,0,0,0,3,1,0,4,1
6909,154123,vljlAhHGhHZt2ciFpy2bQxMoEL2SUwdk,SpATywNh6bZuzm8s1ceuBUnMUAeoAHHw,7,4,1,0,1,0,2,0,8,1.1428571428571428,1,0.0,0,1,0,1,4,0,0,2,0,2,6,1
6910,154133,zUPpTYisLLzFG12BVDvWrty0j8q1G6Si,SpATywNh6bZuzm8s1ceuBUnMUAeoAHHw,26,43,1,29,3,7,15,1,99,14.142857142857142,8,0.0,17,1,27,3,26,7,2,15,1,48,51,0
6911,154181,BXV7sGq2IrRSqCFuLKgoxpKYDPSPpUSj,A3fsA9Zfv1X2fVEQhTw51lKENdNrEqT3,2,0,0,0,0,0,2,0,2,0.2857142857142857,2,0.0,0,0,0,0,0,0,0,2,0,0,2,1
6912,154194,fZpfLVVUEp7GXISLcNFyxWveiOP0dldp,G8EPVSXsOYB5YQWZGiz1aVq5Pgr2GrQu,10,10,0,0,1,0,2,0,13,1.8571428571428572,1,0.0,0,0,0,1,10,0,0,2,0,1,12,0
6913,154222,Csfk45aTs4wr0LJ69dzlrUlkEXjL89zd,bWdj2GDclj5ofokWjzoa5jAwMkxCykd6,4,2,1,0,1,3,2,0,9,1.2857142857142858,1,0.0,0,1,0,1,2,3,0,2,0,2,7,0
6914,154302,6MMO6p1gWBmDJN4eS7QrAi6Zg4mTPljX,SpATywNh6bZuzm8s1ceuBUnMUAeoAHHw,6,7,1,0,0,0,3,0,11,1.5714285714285714,1,0.0,0,1,0,0,7,0,0,3,0,1,10,1
6915,154303,UsP8UHahXGHaChNTAHL4dZh6OmvP94L7,7GRhBDsirIGkRZBtSMEzNTyDr2JQm4xx,15,12,6,0,5,13,9,1,46,6.571428571428571,2,0.0,0,6,0,5,12,13,0,9,1,11,35,1
6916,154318,27pUZlupG1aVjIY0f9PLE1OvbJSBVMXw,SpATywNh6bZuzm8s1ceuBUnMUAeoAHHw,30,29,17,33,9,2,6,1,97,13.857142857142858,1,0.0,8,17,27,9,21,2,6,6,1,61,36,1
6917,154341,zHI8MHuExufwDJ1uuBe75QQrzwho6OSZ,RXDvfPUBYFlVdlueBFbLW0mhhAyGEqpt,49,127,41,133,33,31,42,1,408,58.285714285714285,1,0.0,68,41,114,33,59,31,19,42,1,256,152,0
6918,154415,sL5jw3pLWZoRI7avI17oM60mfF67Acgz,bWdj2GDclj5ofokWjzoa5jAwMkxCykd6,1,0,0,0,0,0,1,0,1,0.14285714285714285,1,0.0,0,0,0,0,0,0,0,1,0,0,1,0
6919,154436,VgwfEqq4zzESU4PqjsdqDnf6ZuDvfVVs,A3fsA9Zfv1X2fVEQhTw51lKENdNrEqT3,1,0,0,0,0,0,1,0,1,0.14285714285714285,1,0.0,0,0,0,0,0,0,0,1,0,0,1,1
6920,154532,y4jCbRq0ZMCabQVeAWisCVju9AF82joj,bWdj2GDclj5ofokWjzoa5jAwMkxCykd6,1,0,0,0,0,0,1,0,1,0.14285714285714285,1,0.0,0,0,0,0,0,0,0,1,0,0,1,1
6921,154555,hUoOQP103jtoSjE8huNXPy5FlXS050j3,7GRhBDsirIGkRZBtSMEzNTyDr2JQm4xx,4,2,1,0,0,0,2,0,5,0.7142857142857143,1,0.0,0,1,0,0,2,0,0,2,0,1,4,1
6922,154570,EXZ81qqSldwR1xdBEwBZ7wmgbTHF86sl,A3fsA9Zfv1X2fVEQhTw51lKENdNrEqT3,69,51,42,186,33,7,7,1,327,46.714285714285715,3,0.0,2,42,149,33,49,7,37,7,1,226,101,0
6923,154572,IZjvzkwq6mW6mk7nIYbEArtjalxzWdW9,SpATywNh6bZuzm8s1ceuBUnMUAeoAHHw,4,2,1,0,1,0,1,0,5,0.7142857142857143,1,0.0,0,1,0,1,2,0,0,1,0,2,3,1
6924,154617,Z9nbZek76s4RBuA56w1WtME3e9ClZkaP,7GRhBDsirIGkRZBtSMEzNTyDr2JQm4xx,4,2,0,0,0,0,2,0,4,0.5714285714285714,1,0.0,0,0,0,0,2,0,0,2,0,0,4,1
6925,154630,PE4KBwh4ltl7dienGR8pJbew7yjFv3Vz,RXDvfPUBYFlVdlueBFbLW0mhhAyGEqpt,73,105,51,108,29,16,23,1,333,47.57142857142857,2,0.0,37,51,100,29,68,16,8,23,1,217,116,0
6926,154662,5U79KRZxDDBIetuxjK0KXphUhzbxTzjr,SpATywNh6bZuzm8s1ceuBUnMUAeoAHHw,7,6,3,0,2,0,3,0,14,2.0,2,0.0,0,3,0,2,6,0,0,3,0,5,9,0
6927,154691,ZnPDiA6jmqQOIbODvVYNoIgZSaO1dso9,7GRhBDsirIGkRZBtSMEzNTyDr2JQm4xx,5,2,1,0,1,0,2,0,6,0.8571428571428571,1,0.0,0,1,0,1,2,0,0,2,0,2,4,1
6928,154722,wEtddkCnDW67OGRvoryp7gzDvLpg5XYx,7GRhBDsirIGkRZBtSMEzNTyDr2JQm4xx,2,0,0,0,0,0,2,0,2,0.2857142857142857,1,0.0,0,0,0,0,0,0,0,2,0,0,2,1
6929,154784,Hz0LP3au6HFJJqiLBqYxNiliqJ4HLt82,7GRhBDsirIGkRZBtSMEzNTyDr2JQm4xx,2,0,0,0,0,0,2,0,2,0.2857142857142857,1,0.0,0,0,0,0,0,0,0,2,0,0,2,1
6930,154795,X7yAkPsl5rqRM0rJWJ1Nk7IUSPBbdZXP,7GRhBDsirIGkRZBtSMEzNTyDr2JQm4xx,2,0,0,0,0,0,3,0,3,0.42857142857142855,2,0.0,0,0,0,0,0,0,0,3,0,0,3,1
6931,154819,9bv4TssyKs6woXSaEFvigyhEyIkdO1mQ,SpATywNh6bZuzm8s1ceuBUnMUAeoAHHw,7,5,4,0,3,0,1,0,13,1.8571428571428572,1,0.0,0,4,0,3,5,0,0,1,0,7,6,1
6932,154867,GnGb3MjVBgYFavJRehOmmU05ktvVgJLM,SpATywNh6bZuzm8s1ceuBUnMUAeoAHHw,12,22,3,9,0,2,14,0,50,7.142857142857143,6,0.0,2,3,9,0,20,2,0,14,0,14,36,0
6933,154879,eLVxEJXOj5JCDBaPnfFyMxorDIkKR9kF,7GRhBDsirIGkRZBtSMEzNTyDr2JQm4xx,5,4,0,0,0,0,2,0,6,0.8571428571428571,1,0.0,0,0,0,0,4,0,0,2,0,0,6,1
6934,154900,MQZ83qOJRka3gcNvl5FCRvHenmiUnsd9,7GRhBDsirIGkRZBtSMEzNTyDr2JQm4xx,7,5,0,0,0,4,4,0,13,1.8571428571428572,1,0.0,1,0,0,0,4,4,0,4,0,1,12,1
6935,154958,uCkUGoRSr1o0e7C3DgvaHjtZmuIVbEoc,7GRhBDsirIGkRZBtSMEzNTyDr2JQm4xx,16,19,4,16,7,0,4,0,50,7.142857142857143,1,0.0,14,4,14,7,5,0,2,4,0,39,11,1
6936,154969,zWDepCfjbS7ISrpw6SZrVfUm7fvpWJYm,RXDvfPUBYFlVdlueBFbLW0mhhAyGEqpt,44,33,19,56,20,0,4,0,132,18.857142857142858,1,0.0,11,19,54,20,22,0,2,4,0,104,28,1
6937,154971,T6EWQ7jVP89JlHzj41KN1gEtGYevpSQM,7GRhBDsirIGkRZBtSMEzNTyDr2JQm4xx,22,29,16,5,10,1,3,0,64,9.142857142857142,2,0.0,10,16,5,10,19,1,0,3,0,41,23,1
6938,155081,erkNYBqLpKRElyeL8GeAgO43CMazg6Rt,7GRhBDsirIGkRZBtSMEzNTyDr2JQm4xx,4,0,0,0,0,0,4,0,4,0.5714285714285714,1,0.0,0,0,0,0,0,0,0,4,0,0,4,1
6939,155201,Yg9hgHRSCdpITsjHOmkyqEwp1aNMC9ra,7GRhBDsirIGkRZBtSMEzNTyDr2JQm4xx,4,2,0,0,0,0,4,0,6,0.8571428571428571,2,0.0,0,0,0,0,2,0,0,4,0,0,6,1
6940,155228,QZIRHdwFgibI2SBehTrmLAZxED1F4JL7,SpATywNh6bZuzm8s1ceuBUnMUAeoAHHw,7,8,3,0,1,0,2,0,14,2.0,2,0.0,0,3,0,1,8,0,0,2,0,4,10,0
6941,155249,6T4qq3cdISFF5pyvVKMrcmEINY6BysCY,7GRhBDsirIGkRZBtSMEzNTyDr2JQm4xx,1,0,0,0,0,0,1,0,1,0.14285714285714285,1,0.0,0,0,0,0,0,0,0,1,0,0,1,1
6942,155260,RYxlkEfybScjuURHdWSAT0EfdWxxzl53,G8EPVSXsOYB5YQWZGiz1aVq5Pgr2GrQu,12,10,3,8,3,0,2,0,26,3.7142857142857144,1,0.0,6,3,5,3,4,0,3,2,0,17,9,1
6943,155270,xcsswfe3yez02HFG13qFCOZgHBl5zUGi,SpATywNh6bZuzm8s1ceuBUnMUAeoAHHw,15,13,5,37,1,3,2,1,62,8.857142857142858,1,0.0,7,5,31,1,6,3,6,2,1,44,18,0
6944,155367,LSvU72CFq1TrHd9SCZOiKQ0qcV2oa2Ok,SpATywNh6bZuzm8s1ceuBUnMUAeoAHHw,4,4,0,0,0,0,2,0,6,0.8571428571428571,2,0.0,0,0,0,0,4,0,0,2,0,0,6,1
6945,155391,mV4YsIiA8Oc8PxZhA2HzdmyhI1ZXRUSS,SpATywNh6bZuzm8s1ceuBUnMUAeoAHHw,16,28,12,10,5,0,7,0,62,8.857142857142858,1,0.0,6,12,10,5,22,0,0,7,0,33,29,1
6946,155432,LkEFlCqQYkjvIKgJmv3NaW67JKbg7cls,bWdj2GDclj5ofokWjzoa5jAwMkxCykd6,9,11,2,14,1,0,15,1,44,6.285714285714286,2,0.0,2,2,13,1,9,0,1,15,1,18,26,1
6947,155453,lmCPiW6l0WNp9Ttn0lhwFDs7FfVubtvY,bWdj2GDclj5ofokWjzoa5jAwMkxCykd6,5,8,0,0,0,0,2,0,10,1.4285714285714286,2,0.0,0,0,0,0,8,0,0,2,0,0,10,1
6948,155459,cuPQwSytidcCUilblyO4K9ALDT0iH8XK,SpATywNh6bZuzm8s1ceuBUnMUAeoAHHw,9,33,6,0,5,0,8,0,52,7.428571428571429,3,0.0,2,6,0,5,31,0,0,8,0,13,39,0
6949,155473,vIGrumQhxED6ggjqRtDJTWjYD26BFXvf,SpATywNh6bZuzm8s1ceuBUnMUAeoAHHw,4,2,1,0,1,0,1,0,5,0.7142857142857143,1,0.0,0,1,0,1,2,0,0,1,0,2,3,1
6950,155477,6QvLuupNiStrzgd1XTxuVafPKhPqbm1k,SpATywNh6bZuzm8s1ceuBUnMUAeoAHHw,1,0,0,0,0,0,2,0,2,0.2857142857142857,1,0.0,0,0,0,0,0,0,0,2,0,0,2,1
6951,155505,anKy5XeCNcJg717tYlt4WP7NvJptZoH3,SpATywNh6bZuzm8s1ceuBUnMUAeoAHHw,6,3,2,0,1,0,2,0,8,1.1428571428571428,1,0.0,0,2,0,1,3,0,0,2,0,3,5,1
6952,155507,SgOZJSP28EVOKcdy4QUHKj5FTNBlaKTy,bWdj2GDclj5ofokWjzoa5jAwMkxCykd6,4,3,2,0,0,0,1,0,6,0.8571428571428571,1,0.0,0,2,0,0,3,0,0,1,0,2,4,1
6953,155515,RWIpGfxvEVJcZlPnYrpOXKnv6jNCgDMr,G8EPVSXsOYB5YQWZGiz1aVq5Pgr2GrQu,5,2,1,0,1,0,2,0,6,0.8571428571428571,1,0.0,0,1,0,1,2,0,0,2,0,2,4,1
6954,155519,LPuI0zsA5TBOFE9XpHozb9j9tJuwGxCb,RXDvfPUBYFlVdlueBFbLW0mhhAyGEqpt,9,8,5,0,1,0,5,0,19,2.7142857142857144,2,0.0,0,5,0,1,8,0,0,5,0,6,13,0
6955,155553,bpGV6fnSXAO5YTgsxVkdmYC0rSgonD8Y,SpATywNh6bZuzm8s1ceuBUnMUAeoAHHw,7,11,2,0,2,0,2,0,17,2.4285714285714284,2,0.0,0,2,0,2,11,0,0,2,0,4,13,1
6956,155560,I0VfBqvM8JyWCrBNLkrKH3hPvb4CxoQx,SpATywNh6bZuzm8s1ceuBUnMUAeoAHHw,23,30,1,26,1,1,5,0,64,9.142857142857142,2,0.0,7,1,24,1,23,1,2,5,0,33,31,1
6957,155575,LigXW35gPDwdC5qVp0UrC4fmHQ8ox9Rk,bWdj2GDclj5ofokWjzoa5jAwMkxCykd6,7,6,3,0,2,0,1,0,12,1.7142857142857142,1,0.0,0,3,0,2,6,0,0,1,0,5,7,1
6958,155580,RRM0TElcCY25pdcWRkMGxwCn30ehvK5c,SpATywNh6bZuzm8s1ceuBUnMUAeoAHHw,26,37,18,22,6,0,5,0,88,12.571428571428571,3,0.0,15,18,18,6,22,0,4,5,0,57,31,0
6959,155610,UK0wMwBzvN90sgDmKYl9zi5a5BuEJyvZ,RXDvfPUBYFlVdlueBFbLW0mhhAyGEqpt,29,20,9,35,7,19,4,0,94,13.428571428571429,3,0.0,7,9,34,7,13,19,1,4,0,57,37,1
6960,155611,dd7Jtt1fMMutX1RG7iWTpWNKUpGu8Lqf,A3fsA9Zfv1X2fVEQhTw51lKENdNrEqT3,35,50,29,62,0,3,24,1,169,24.142857142857142,3,0.0,6,29,49,0,44,3,13,24,1,84,85,1
6961,155637,qjvq1sHqAcfKswM6blXTqWOneUd9IwNB,SpATywNh6bZuzm8s1ceuBUnMUAeoAHHw,5,2,1,0,1,0,2,0,6,0.8571428571428571,1,0.0,0,1,0,1,2,0,0,2,0,2,4,1
6962,155650,qsqwu8COYqhvRbnpZxaxzFgLRXRrEQUY,SpATywNh6bZuzm8s1ceuBUnMUAeoAHHw,5,3,2,0,1,0,1,0,7,1.0,1,0.0,0,2,0,1,3,0,0,1,0,3,4,1
6963,155705,CFhLEVkKrtcBJJ6gRh8HSuSfw1jMfUb7,SpATywNh6bZuzm8s1ceuBUnMUAeoAHHw,2,0,0,0,0,0,2,0,2,0.2857142857142857,1,0.0,0,0,0,0,0,0,0,2,0,0,2,1
6964,155719,US9otMg797RbX2BsleYBFadMSrBjJXZF,SpATywNh6bZuzm8s1ceuBUnMUAeoAHHw,2,0,0,0,0,0,2,0,2,0.2857142857142857,1,0.0,0,0,0,0,0,0,0,2,0,0,2,1
6965,155741,1fhx237jT4Kg2Hfne9D1cZg9DXyWHZEN,bWdj2GDclj5ofokWjzoa5jAwMkxCykd6,6,5,3,0,2,0,5,0,15,2.142857142857143,2,0.0,0,3,0,2,5,0,0,5,0,5,10,0
6966,155745,bcDgsH6ZU4RUVLG7I2fsAvcl6B7ySYCd,RXDvfPUBYFlVdlueBFbLW0mhhAyGEqpt,5,5,0,0,0,0,3,0,8,1.1428571428571428,3,0.0,0,0,0,0,5,0,0,3,0,0,8,1
6967,155782,I19aG6zmdTntoy0T8VxEogbN4WVEZZNa,G8EPVSXsOYB5YQWZGiz1aVq5Pgr2GrQu,11,9,1,10,1,0,3,0,24,3.4285714285714284,2,0.0,3,1,7,1,6,0,3,3,0,12,12,1
6968,155787,IkURdjJHTtVaMfzGLDY0ow22hHa6VKoA,G8EPVSXsOYB5YQWZGiz1aVq5Pgr2GrQu,1,0,0,0,0,0,1,0,1,0.14285714285714285,1,0.0,0,0,0,0,0,0,0,1,0,0,1,1
6969,155816,088SASUPOVYUGhoEly8vlrkGvRBJoNwp,SpATywNh6bZuzm8s1ceuBUnMUAeoAHHw,5,2,1,0,1,0,3,0,7,1.0,1,0.0,0,1,0,1,2,0,0,3,0,2,5,1
6970,155821,jaQSY9BdnD0HM1u5vJYwNWQnUzzZzI8e,SpATywNh6bZuzm8s1ceuBUnMUAeoAHHw,1,0,0,0,0,0,1,0,1,0.14285714285714285,1,0.0,0,0,0,0,0,0,0,1,0,0,1,1
6971,155826,VFaDw1WYcOtIcsxfLW3x5fsJ2JkUIOUZ,G8EPVSXsOYB5YQWZGiz1aVq5Pgr2GrQu,57,67,31,132,20,9,17,1,277,39.57142857142857,5,0.0,23,31,112,20,44,9,20,17,1,186,91,0
6972,155845,kAH6V7JzDoLq5AdXMqvLO78igpFvmPcb,SpATywNh6bZuzm8s1ceuBUnMUAeoAHHw,3,2,0,0,0,0,1,0,3,0.42857142857142855,1,0.0,0,0,0,0,2,0,0,1,0,0,3,1
6973,155885,4G4cusC28dHeOh2Typ91i1q3Okbvvqth,bWdj2GDclj5ofokWjzoa5jAwMkxCykd6,7,6,2,4,2,0,3,0,17,2.4285714285714284,2,0.0,2,2,3,2,4,0,1,3,0,9,8,1
6974,155915,tJ3sl9o76r3EHByeMBO5S5Oajse8uEcy,SpATywNh6bZuzm8s1ceuBUnMUAeoAHHw,12,7,1,4,1,0,3,0,16,2.2857142857142856,1,0.0,0,1,4,1,7,0,0,3,0,6,10,0
6975,155927,5zF3LAGlpXwVChANKN0umOaI1kNrk73h,SpATywNh6bZuzm8s1ceuBUnMUAeoAHHw,1,0,0,0,0,0,1,0,1,0.14285714285714285,1,0.0,0,0,0,0,0,0,0,1,0,0,1,1
6976,155964,nVB1o73xluQXZjoI2dUYHGxbCDG8qiCL,RXDvfPUBYFlVdlueBFbLW0mhhAyGEqpt,1,0,0,0,0,0,1,0,1,0.14285714285714285,1,0.0,0,0,0,0,0,0,0,1,0,0,1,0
6977,155976,7xpmz6LF4dl35fFKZgRU70OZyF8UO4PL,SpATywNh6bZuzm8s1ceuBUnMUAeoAHHw,7,5,2,0,2,0,2,0,11,1.5714285714285714,1,0.0,0,2,0,2,5,0,0,2,0,4,7,0
6978,155978,8Q914g366DdD8SM59Cwv8CGJVdCfYrAr,SpATywNh6bZuzm8s1ceuBUnMUAeoAHHw,20,15,12,4,8,0,2,0,41,5.857142857142857,2,0.0,0,12,3,8,15,0,1,2,0,23,18,1
6979,156011,V6bmtFqzrgy6dG2nlcL1Nh8X9EOeOyrE,SpATywNh6bZuzm8s1ceuBUnMUAeoAHHw,5,3,1,0,1,0,1,0,6,0.8571428571428571,1,0.0,0,1,0,1,3,0,0,1,0,2,4,1
6980,156064,xSvCHzbSKemMKYEdGEAC5YZv1OdVf9nN,bWdj2GDclj5ofokWjzoa5jAwMkxCykd6,3,0,0,0,0,0,3,0,3,0.42857142857142855,1,0.0,0,0,0,0,0,0,0,3,0,0,3,1
6981,156067,3JnJF2wvxZ8RWlVFjIL8g8mywZiR6k1T,G8EPVSXsOYB5YQWZGiz1aVq5Pgr2GrQu,18,23,16,26,9,0,4,1,79,11.285714285714286,1,0.0,5,16,22,9,18,0,4,4,1,52,27,1
6982,156123,iMSX1uHcSxcasOlc9agP5kI5TmyEQeiD,G8EPVSXsOYB5YQWZGiz1aVq5Pgr2GrQu,1,0,0,0,0,0,1,0,1,0.14285714285714285,1,0.0,0,0,0,0,0,0,0,1,0,0,1,1
6983,156130,i6hU5SR8XgkqdPxlmxtV7dYt9PZfaBTn,SpATywNh6bZuzm8s1ceuBUnMUAeoAHHw,5,2,1,0,1,0,2,0,6,0.8571428571428571,1,0.0,0,1,0,1,2,0,0,2,0,2,4,1
6984,156133,i6hU5SR8XgkqdPxlmxtV7dYt9PZfaBTn,bWdj2GDclj5ofokWjzoa5jAwMkxCykd6,6,8,3,0,2,0,2,0,15,2.142857142857143,1,0.0,3,3,0,2,5,0,0,2,0,8,7,1
6985,156141,i6hU5SR8XgkqdPxlmxtV7dYt9PZfaBTn,RXDvfPUBYFlVdlueBFbLW0mhhAyGEqpt,10,9,3,0,2,0,4,0,18,2.5714285714285716,1,0.0,0,3,0,2,9,0,0,4,0,5,13,1
6986,156174,xWDzyWVfwaNblicJcu1jEcVTvovEMjsP,SpATywNh6bZuzm8s1ceuBUnMUAeoAHHw,14,46,0,21,0,6,7,1,81,11.571428571428571,1,0.0,31,0,18,0,15,6,3,7,1,49,32,1
6987,156203,TJJeYBVqqJqVT0UpmMwKMknr7rLf2JfH,G8EPVSXsOYB5YQWZGiz1aVq5Pgr2GrQu,1,0,0,0,0,0,1,0,1,0.14285714285714285,1,0.0,0,0,0,0,0,0,0,1,0,0,1,1
6988,156210,QJa7950JZ1G1IXjh9PFTLBwHz50g7cPs,RXDvfPUBYFlVdlueBFbLW0mhhAyGEqpt,6,3,1,0,1,0,2,0,7,1.0,1,0.0,0,1,0,1,3,0,0,2,0,2,5,1
6989,156215,craou3bPovoGYp07wkpPUHi7pTV19nnS,SpATywNh6bZuzm8s1ceuBUnMUAeoAHHw,1,0,0,0,0,0,1,0,1,0.14285714285714285,1,0.0,0,0,0,0,0,0,0,1,0,0,1,1
6990,156218,lOpYzxjzA9vRip7edGAzRT31tzjhDFRT,SpATywNh6bZuzm8s1ceuBUnMUAeoAHHw,14,15,1,20,0,1,7,1,45,6.428571428571429,1,0.0,2,1,17,0,13,1,3,7,1,20,25,1
6991,156249,NOCI3alBOLdcP6U9772QoJvMxwy9UAN6,SpATywNh6bZuzm8s1ceuBUnMUAeoAHHw,7,12,5,0,1,0,3,0,21,3.0,2,0.0,3,5,0,1,9,0,0,3,0,9,12,1
6992,156274,0sjXk2kwvvV16YH049lNSti4Pj1sg16S,bWdj2GDclj5ofokWjzoa5jAwMkxCykd6,8,9,4,12,0,1,5,0,31,4.428571428571429,1,0.0,3,4,11,0,6,1,1,5,0,18,13,1
6993,156295,BMNiq5EV6A8TNZJcxF7Tx1slpqQ99u0q,SpATywNh6bZuzm8s1ceuBUnMUAeoAHHw,1,0,0,0,0,0,1,0,1,0.14285714285714285,1,0.0,0,0,0,0,0,0,0,1,0,0,1,1
6994,156308,ifnHK7elzUrx6FoT7eceCrEZMhAwQ98l,A3fsA9Zfv1X2fVEQhTw51lKENdNrEqT3,28,13,11,18,9,0,5,0,56,8.0,1,0.0,0,11,16,9,13,0,2,5,0,36,20,1
6995,156323,WN48iLnvvEk85bn1Ax5lHk0fUlDw6OCg,SpATywNh6bZuzm8s1ceuBUnMUAeoAHHw,13,15,0,12,0,2,7,1,37,5.285714285714286,1,0.0,0,0,10,0,15,2,2,7,1,10,27,1
6996,156325,OpLX96TX0mzsRYhDl2C02nVgjI6j9XrW,RXDvfPUBYFlVdlueBFbLW0mhhAyGEqpt,1,0,0,0,0,0,1,0,1,0.14285714285714285,1,0.0,0,0,0,0,0,0,0,1,0,0,1,1
6997,156435,45E6hpwDMHp9Q3Pt1xT8q04bbowKk87g,bWdj2GDclj5ofokWjzoa5jAwMkxCykd6,40,64,30,74,25,6,29,2,230,32.857142857142854,5,0.0,23,30,71,25,41,6,3,29,2,149,81,1
6998,156506,WsrGHMpJC5JoJNy1qcc46gvaDlt9pDn6,SpATywNh6bZuzm8s1ceuBUnMUAeoAHHw,9,4,3,0,3,0,2,0,12,1.7142857142857142,1,0.0,0,3,0,3,4,0,0,2,0,6,6,1
6999,156510,Atic9bcAYez6iPYGWH9qjmSkP3PGX2jq,bWdj2GDclj5ofokWjzoa5jAwMkxCykd6,3,3,1,0,0,0,2,0,6,0.8571428571428571,1,0.0,0,1,0,0,3,0,0,2,0,1,5,1
7000,156518,Atic9bcAYez6iPYGWH9qjmSkP3PGX2jq,RXDvfPUBYFlVdlueBFbLW0mhhAyGEqpt,23,40,15,29,12,0,12,1,109,15.571428571428571,1,0.0,7,15,23,12,33,0,6,12,1,57,52,1
7001,156529,JS5kXpYeMxOghDu5iWEChapuWqXPxCs4,RXDvfPUBYFlVdlueBFbLW0mhhAyGEqpt,2,0,0,0,0,0,2,0,2,0.2857142857142857,1,0.0,0,0,0,0,0,0,0,2,0,0,2,1
7002,156543,HoNj5dKRTM00OCznK2rkvjainbjOBy0O,bWdj2GDclj5ofokWjzoa5jAwMkxCykd6,11,5,3,0,2,1,10,1,22,3.142857142857143,1,0.0,0,3,0,2,5,1,0,10,1,5,17,1
7003,156560,wiTUeXradyIJk2N3XHfmkjuyGIQHziQH,SpATywNh6bZuzm8s1ceuBUnMUAeoAHHw,13,12,7,11,2,0,3,0,35,5.0,2,0.0,0,7,10,2,12,0,1,3,0,19,16,0
7004,156562,Un3EzEE4Sz8i5Z84q9e50URbIAEkkVSB,A3fsA9Zfv1X2fVEQhTw51lKENdNrEqT3,5,2,1,0,1,0,7,0,11,1.5714285714285714,4,0.0,0,1,0,1,2,0,0,7,0,2,9,1
7005,156569,OLSxCkluLildKVrVnzRIsj47tt9tVHj9,A3fsA9Zfv1X2fVEQhTw51lKENdNrEqT3,2,0,0,0,0,0,4,0,4,0.5714285714285714,2,0.0,0,0,0,0,0,0,0,4,0,0,4,1
7006,156579,TqZSbKLYcFD5gfQ0wHk9V7SVlkqO9WOv,A3fsA9Zfv1X2fVEQhTw51lKENdNrEqT3,2,0,0,0,0,0,3,0,3,0.42857142857142855,1,0.0,0,0,0,0,0,0,0,3,0,0,3,1
7007,156615,1l4J4YNslNweqVYZ9PIiphpLsWKaZHE7,SpATywNh6bZuzm8s1ceuBUnMUAeoAHHw,14,21,9,14,3,4,3,0,54,7.714285714285714,1,0.0,9,9,11,3,12,4,3,3,0,32,22,0
7008,156656,7IdpyRf57AcKqRM0ayoEIjOEGtDFURim,SpATywNh6bZuzm8s1ceuBUnMUAeoAHHw,17,43,24,4,7,0,10,0,88,12.571428571428571,3,0.0,0,24,3,7,43,0,1,10,0,34,54,0
7009,156682,dgVkbE4MU9DJV1tctk0wRyOO49V94n6e,SpATywNh6bZuzm8s1ceuBUnMUAeoAHHw,7,15,0,0,0,0,6,0,21,3.0,3,0.0,0,0,0,0,15,0,0,6,0,0,21,1
7010,156689,t59SBB5EkGAnAVQuchgekkDDOWF5xR9g,bWdj2GDclj5ofokWjzoa5jAwMkxCykd6,4,1,0,0,0,0,3,0,4,0.5714285714285714,1,0.0,0,0,0,0,1,0,0,3,0,0,4,1
7011,156713,OIIVm7SlB1MihSMHP9mqOAQU5V2HwVOP,A3fsA9Zfv1X2fVEQhTw51lKENdNrEqT3,2,0,0,0,0,0,2,0,2,0.2857142857142857,1,0.0,0,0,0,0,0,0,0,2,0,0,2,1
7012,156717,X535Iu5jdKv0ppLqkwhIGZajlbhLXvmn,bWdj2GDclj5ofokWjzoa5jAwMkxCykd6,8,4,2,0,2,0,11,0,19,2.7142857142857144,2,0.0,0,2,0,2,4,0,0,11,0,4,15,1
7013,156761,gK3XDdBxJJXAYJgDo42Lu6DpWYFShLP7,SpATywNh6bZuzm8s1ceuBUnMUAeoAHHw,5,13,0,0,0,0,1,0,14,2.0,1,0.0,4,0,0,0,9,0,0,1,0,4,10,1
7014,156794,O8fsI8cLbZAXSgU5jDWyt6O1zSRxLyqW,SpATywNh6bZuzm8s1ceuBUnMUAeoAHHw,4,0,0,0,0,1,3,4,8,1.1428571428571428,1,0.0,0,0,0,0,0,1,0,3,4,0,8,1
7015,156801,HoH1joiBpbDlKqg5IXGbrLHAYskumoZ0,A3fsA9Zfv1X2fVEQhTw51lKENdNrEqT3,6,2,1,0,1,0,3,0,7,1.0,1,0.0,0,1,0,1,2,0,0,3,0,2,5,1
7016,156805,GtIbKUKASYfKNPKGxbljpDBTth0Im6QW,A3fsA9Zfv1X2fVEQhTw51lKENdNrEqT3,2,0,0,0,0,0,2,0,2,0.2857142857142857,1,0.0,0,0,0,0,0,0,0,2,0,0,2,1
7017,156828,WRiHtWJX61VUGyAGQFSHJ3czdrgqxeQW,SpATywNh6bZuzm8s1ceuBUnMUAeoAHHw,1,0,0,0,0,0,1,0,1,0.14285714285714285,1,0.0,0,0,0,0,0,0,0,1,0,0,1,1
7018,157189,uo7YhZ0OnoXU4DzC6rBENt0NolKURdsm,7GRhBDsirIGkRZBtSMEzNTyDr2JQm4xx,10,10,6,0,2,0,5,0,23,3.2857142857142856,1,0.0,1,6,0,2,9,0,0,5,0,9,14,1
7019,157198,C9PYulDhlCOnLsyEzeELLLcPxqCNkZMm,7GRhBDsirIGkRZBtSMEzNTyDr2JQm4xx,4,2,0,0,0,0,6,0,8,1.1428571428571428,1,0.0,0,0,0,0,2,0,0,6,0,0,8,1
7020,157202,GXOvdzrIyLHGb3WpOAU0L7zoSw672i7L,7GRhBDsirIGkRZBtSMEzNTyDr2JQm4xx,2,0,0,0,0,0,2,0,2,0.2857142857142857,1,0.0,0,0,0,0,0,0,0,2,0,0,2,1
7021,157234,YsQh8U8uW7iK5N2UDcWrxeNI3UNG6b7j,7GRhBDsirIGkRZBtSMEzNTyDr2JQm4xx,1,0,0,0,0,0,2,0,2,0.2857142857142857,1,0.0,0,0,0,0,0,0,0,2,0,0,2,1
7022,157259,hED50EZVrg4iRW4iqOekbQhqnICw3N8M,7GRhBDsirIGkRZBtSMEzNTyDr2JQm4xx,5,3,2,0,2,0,2,0,9,1.2857142857142858,1,0.0,0,2,0,2,3,0,0,2,0,4,5,1
7023,157286,2GvFS2RdNGmAeuBW2TvolO9O5aFFmxNB,7GRhBDsirIGkRZBtSMEzNTyDr2JQm4xx,1,0,0,0,0,0,1,0,1,0.14285714285714285,1,0.0,0,0,0,0,0,0,0,1,0,0,1,1
7024,157347,5ehf4EFN8WhDbvmb2WvfZwpaBD0cj1oj,7GRhBDsirIGkRZBtSMEzNTyDr2JQm4xx,14,13,1,0,1,0,5,0,20,2.857142857142857,3,0.0,0,1,0,1,13,0,0,5,0,2,18,1
7025,157377,DJXmR0KXC00UhtfnxnB0CPGhSlDcn5wL,7GRhBDsirIGkRZBtSMEzNTyDr2JQm4xx,1,0,0,0,0,0,1,0,1,0.14285714285714285,1,0.0,0,0,0,0,0,0,0,1,0,0,1,1
7026,157488,abZjyy6CkJwLuRnRyGB2GrxhAkPifaxi,7GRhBDsirIGkRZBtSMEzNTyDr2JQm4xx,8,7,0,0,0,1,9,0,17,2.4285714285714284,2,0.0,0,0,0,0,7,1,0,9,0,0,17,1
7027,157627,xHfGdYj0sYZXXCzkQp0eF5wBXW7C2C6R,7GRhBDsirIGkRZBtSMEzNTyDr2JQm4xx,1,0,0,0,0,0,1,0,1,0.14285714285714285,1,0.0,0,0,0,0,0,0,0,1,0,0,1,1
7028,160309,m1fBxfdP24tbh5rWoiFGny0cd2DQDU7n,7GRhBDsirIGkRZBtSMEzNTyDr2JQm4xx,2,0,0,0,0,0,2,0,2,0.2857142857142857,1,0.0,0,0,0,0,0,0,0,2,0,0,2,1
7029,160343,oCUO9XlUIOh3Ij7ThU6V6i4UFCJQT7mf,7GRhBDsirIGkRZBtSMEzNTyDr2JQm4xx,1,0,0,0,0,0,1,0,1,0.14285714285714285,1,0.0,0,0,0,0,0,0,0,1,0,0,1,1
7030,160370,SWQaeOMzpLQ0O6BdWhgpESQIJJfRIjcf,7GRhBDsirIGkRZBtSMEzNTyDr2JQm4xx,1,0,0,0,0,0,1,0,1,0.14285714285714285,1,0.0,0,0,0,0,0,0,0,1,0,0,1,1
7031,160374,YxPma1Wq13D1SO5XQzSvHgBwRYOIrVRk,7GRhBDsirIGkRZBtSMEzNTyDr2JQm4xx,1,0,0,0,0,0,1,0,1,0.14285714285714285,1,0.0,0,0,0,0,0,0,0,1,0,0,1,1
7032,160404,5va1sV2BwXc5BtIB3Klat9ON2fDXMGdg,7GRhBDsirIGkRZBtSMEzNTyDr2JQm4xx,1,0,0,0,0,0,1,0,1,0.14285714285714285,1,0.0,0,0,0,0,0,0,0,1,0,0,1,1
7033,160417,nrol5VxiNERghlxTlRYzcM0aTVUVOtUp,7GRhBDsirIGkRZBtSMEzNTyDr2JQm4xx,1,0,0,0,0,0,1,0,1,0.14285714285714285,1,0.0,0,0,0,0,0,0,0,1,0,0,1,1
7034,160447,VaYYfZ3JVOT6bOWghdrqK1SOwK0gM5y2,7GRhBDsirIGkRZBtSMEzNTyDr2JQm4xx,1,0,0,0,0,0,1,0,1,0.14285714285714285,1,0.0,0,0,0,0,0,0,0,1,0,0,1,1
7035,160487,PRfZLzeSQB5SIGo2mbBK9MaxsrpewgA0,7GRhBDsirIGkRZBtSMEzNTyDr2JQm4xx,10,6,2,0,2,3,11,0,24,3.4285714285714284,1,0.0,2,2,0,2,4,3,0,11,0,6,18,1
7036,160693,0bGwsopOrJy9wTuBbyPfl2hvYAxstsYA,7GRhBDsirIGkRZBtSMEzNTyDr2JQm4xx,1,0,0,0,0,0,1,0,1,0.14285714285714285,1,0.0,0,0,0,0,0,0,0,1,0,0,1,1
7037,160716,Jov3UvG5K4pASWh5oCQTME29q3GomczT,7GRhBDsirIGkRZBtSMEzNTyDr2JQm4xx,1,0,0,0,0,0,1,0,1,0.14285714285714285,1,0.0,0,0,0,0,0,0,0,1,0,0,1,1
7038,160726,8E88mVxxHiSEV3ReMbiLkIuYAxJ6YXeO,bWdj2GDclj5ofokWjzoa5jAwMkxCykd6,5,12,7,0,0,0,7,0,26,3.7142857142857144,3,0.0,0,7,0,0,12,0,0,7,0,7,19,1
7039,160766,WpwD79l1tHxSYGvzddD5jkm0kQD6YzUK,SpATywNh6bZuzm8s1ceuBUnMUAeoAHHw,8,4,0,0,0,1,6,1,12,1.7142857142857142,1,0.0,0,0,0,0,4,1,0,6,1,0,12,0
7040,160802,vaWLVKWyrsUzDV0qs20ZUq8M3VNW01Uk,SpATywNh6bZuzm8s1ceuBUnMUAeoAHHw,1,0,0,0,0,0,2,0,2,0.2857142857142857,1,0.0,0,0,0,0,0,0,0,2,0,0,2,1
7041,161011,1b3NSfxfxI6DroelosS7m4rEEtzhJZdR,7GRhBDsirIGkRZBtSMEzNTyDr2JQm4xx,1,0,0,0,0,0,1,0,1,0.14285714285714285,1,0.0,0,0,0,0,0,0,0,1,0,0,1,1
7042,161065,2JYViuOLvusjF5jXM0OPt6GS91aIip1x,SpATywNh6bZuzm8s1ceuBUnMUAeoAHHw,1,0,0,0,0,0,1,0,1,0.14285714285714285,1,0.0,0,0,0,0,0,0,0,1,0,0,1,1
7043,161171,rhgA2X0g2BW5I3tYIXFENYW4L8ORdfpR,7GRhBDsirIGkRZBtSMEzNTyDr2JQm4xx,14,11,2,28,3,0,2,0,46,6.571428571428571,1,0.0,6,2,25,3,5,0,3,2,0,36,10,1
7044,161218,IoUEv205kL70u2MwbYRNexNGlv0hD8vn,SpATywNh6bZuzm8s1ceuBUnMUAeoAHHw,13,17,10,18,0,1,2,0,48,6.857142857142857,1,0.0,6,10,18,0,11,1,0,2,0,34,14,1
7045,161244,F5WXvUA8z1Vfdvlva1pujweut7tGE04r,7GRhBDsirIGkRZBtSMEzNTyDr2JQm4xx,2,0,0,0,0,0,2,0,2,0.2857142857142857,1,0.0,0,0,0,0,0,0,0,2,0,0,2,1
7046,161310,B5jlZpEDxUNGCe4UQsaYbJ99Z8y5d2lN,7GRhBDsirIGkRZBtSMEzNTyDr2JQm4xx,9,4,3,0,3,0,2,0,12,1.7142857142857142,1,0.0,0,3,0,3,4,0,0,2,0,6,6,1
7047,161369,NMciPbdIeB9uIZwCMcw6mXU2i3BtnB5v,7GRhBDsirIGkRZBtSMEzNTyDr2JQm4xx,7,5,4,0,4,0,2,0,15,2.142857142857143,1,0.0,0,4,0,4,5,0,0,2,0,8,7,1
7048,161424,vVoYtG2vzUhg3qXoaTM1GNiznwKfFexh,A3fsA9Zfv1X2fVEQhTw51lKENdNrEqT3,1,0,0,0,0,0,1,0,1,0.14285714285714285,1,0.0,0,0,0,0,0,0,0,1,0,0,1,1
7049,161526,6HIBebNSnNEoSeekVShzxF3x0IcbgohT,7GRhBDsirIGkRZBtSMEzNTyDr2JQm4xx,1,0,0,0,0,0,1,0,1,0.14285714285714285,1,0.0,0,0,0,0,0,0,0,1,0,0,1,1
7050,161578,Xo1RSitSiG1YTKsWiGb48lb1j1pDp5LC,7GRhBDsirIGkRZBtSMEzNTyDr2JQm4xx,1,0,0,0,0,0,1,0,1,0.14285714285714285,1,0.0,0,0,0,0,0,0,0,1,0,0,1,1
7051,161642,zT5Abo7SNHsAkCFKMvhJJJDWNu2sl4mh,bWdj2GDclj5ofokWjzoa5jAwMkxCykd6,5,0,0,0,0,1,4,3,8,1.1428571428571428,1,0.0,0,0,0,0,0,1,0,4,3,0,8,1
7052,161670,IFqWOl32JJm0W3Ap2jxVCpJeXeLJlYDp,7GRhBDsirIGkRZBtSMEzNTyDr2JQm4xx,1,0,0,0,0,0,1,0,1,0.14285714285714285,1,0.0,0,0,0,0,0,0,0,1,0,0,1,1
7053,161671,Rlp934Hm4YHO5gcLihEiFevqZ5FBvHF8,SpATywNh6bZuzm8s1ceuBUnMUAeoAHHw,8,6,3,0,3,0,2,0,14,2.0,1,0.0,0,3,0,3,6,0,0,2,0,6,8,0
7054,161682,HE0yFYNeyW3jGh5EhXv7uoc6O18ATk5R,7GRhBDsirIGkRZBtSMEzNTyDr2JQm4xx,16,15,10,6,8,0,1,0,40,5.714285714285714,1,0.0,3,10,6,8,12,0,0,1,0,27,13,1
7055,161695,5UJZmEar1AX3gQXOzkh3MnQcYdErI17M,7GRhBDsirIGkRZBtSMEzNTyDr2JQm4xx,5,3,1,4,1,0,1,0,10,1.4285714285714286,1,0.0,1,1,3,1,2,0,1,1,0,6,4,1
7056,161723,SKx8r8WhDZSzytfk5iQ25ROJsaDkrIXF,7GRhBDsirIGkRZBtSMEzNTyDr2JQm4xx,11,7,4,0,0,0,22,1,34,4.857142857142857,2,0.0,0,4,0,0,7,0,0,22,1,4,30,1
7057,161805,UCk78TeP5wO91gE0mNeB2p1adOEwLGvE,7GRhBDsirIGkRZBtSMEzNTyDr2JQm4xx,1,0,0,0,0,0,1,0,1,0.14285714285714285,1,0.0,0,0,0,0,0,0,0,1,0,0,1,1
7058,161809,IW1yqY6AJLLD0UdkPHoBC5FNys4RF3Rc,A3fsA9Zfv1X2fVEQhTw51lKENdNrEqT3,10,5,1,0,0,1,12,1,20,2.857142857142857,1,0.0,0,1,0,0,5,1,0,12,1,1,19,0
7059,161860,XWulLs8vbnA3SFvatYUqLQya4PNZCGWN,7GRhBDsirIGkRZBtSMEzNTyDr2JQm4xx,2,0,0,0,0,0,2,0,2,0.2857142857142857,1,0.0,0,0,0,0,0,0,0,2,0,0,2,1
7060,161918,SYWOoChsgDN3vqDh0zFb5J4GFaNN5CHm,7GRhBDsirIGkRZBtSMEzNTyDr2JQm4xx,2,0,0,0,0,0,2,0,2,0.2857142857142857,1,0.0,0,0,0,0,0,0,0,2,0,0,2,1
7061,161927,OhL5zrdNWQNDdkrpoCKKJc0ohGhIkdNF,7GRhBDsirIGkRZBtSMEzNTyDr2JQm4xx,7,3,1,0,1,0,6,0,11,1.5714285714285714,1,0.0,0,1,0,1,3,0,0,6,0,2,9,1
7062,161959,AZZvRPcRkLSa6vwofzfwsEULTUhiKy0E,7GRhBDsirIGkRZBtSMEzNTyDr2JQm4xx,1,0,0,0,0,0,1,0,1,0.14285714285714285,1,0.0,0,0,0,0,0,0,0,1,0,0,1,1
7063,161969,MaC2my4u05k7bh5sqzN5aBA80G2sJbiN,7GRhBDsirIGkRZBtSMEzNTyDr2JQm4xx,2,0,0,0,0,0,2,0,2,0.2857142857142857,1,0.0,0,0,0,0,0,0,0,2,0,0,2,1
7064,161977,1eR532KvihOWCrlFgRH6WOHtkLSsyMIL,7GRhBDsirIGkRZBtSMEzNTyDr2JQm4xx,1,0,0,0,0,0,1,0,1,0.14285714285714285,1,0.0,0,0,0,0,0,0,0,1,0,0,1,1
7065,162021,zEeoIZORCHI2d73VPIkIvoJfr8OXEKux,7GRhBDsirIGkRZBtSMEzNTyDr2JQm4xx,2,0,0,0,0,0,4,0,4,0.5714285714285714,1,0.0,0,0,0,0,0,0,0,4,0,0,4,1
7066,162029,OUbrW18OgibVb4I41eHFiFhkobpgjEP2,A3fsA9Zfv1X2fVEQhTw51lKENdNrEqT3,42,33,24,0,19,0,13,0,89,12.714285714285714,4,0.0,0,24,0,19,33,0,0,13,0,43,46,0
7067,162051,EPVEir3f8DxjouE65Q4kYI9YaQMxGE89,7GRhBDsirIGkRZBtSMEzNTyDr2JQm4xx,1,0,0,0,0,0,1,0,1,0.14285714285714285,1,0.0,0,0,0,0,0,0,0,1,0,0,1,1
7068,162089,KN2cc8h9ZKfIgxIX3NczsQQI5NEtrUt5,7GRhBDsirIGkRZBtSMEzNTyDr2JQm4xx,1,0,0,0,0,0,1,0,1,0.14285714285714285,1,0.0,0,0,0,0,0,0,0,1,0,0,1,1
7069,162174,WUH5fKgyK0ITY5YtWCIxwze8XvwwESM5,7GRhBDsirIGkRZBtSMEzNTyDr2JQm4xx,5,4,1,0,1,1,1,0,8,1.1428571428571428,1,0.0,0,1,0,1,4,1,0,1,0,2,6,1
7070,162177,1K0DpvOOuk8vTEPD17uO46UmxJ6dP2I7,7GRhBDsirIGkRZBtSMEzNTyDr2JQm4xx,23,41,14,8,7,0,4,0,74,10.571428571428571,1,0.0,21,14,8,7,20,0,0,4,0,50,24,1
7071,162182,o69BaNn8nNwkn0WRwXTNaYgGrUvOyxv9,7GRhBDsirIGkRZBtSMEzNTyDr2JQm4xx,1,0,0,0,0,0,1,0,1,0.14285714285714285,1,0.0,0,0,0,0,0,0,0,1,0,0,1,1
7072,162210,DtMnsqy6X2aMCS8gI4UYHBMONV1kA6dl,7GRhBDsirIGkRZBtSMEzNTyDr2JQm4xx,6,2,1,0,1,0,3,0,7,1.0,1,0.0,0,1,0,1,2,0,0,3,0,2,5,1
7073,162227,uuKeKkPXlaVWeKPj7Eoyh2mpLD36WFad,7GRhBDsirIGkRZBtSMEzNTyDr2JQm4xx,4,2,1,0,0,0,3,0,6,0.8571428571428571,1,0.0,1,1,0,0,1,0,0,3,0,2,4,1
7074,162252,pUVYMZKME7oxYlcseSFG7zGaoCPbxz6o,7GRhBDsirIGkRZBtSMEzNTyDr2JQm4xx,1,0,0,0,0,0,1,0,1,0.14285714285714285,1,0.0,0,0,0,0,0,0,0,1,0,0,1,1
7075,162347,d0EMfPN6PawhWgPDlCBNVjvE3wPPt43m,7GRhBDsirIGkRZBtSMEzNTyDr2JQm4xx,6,4,2,0,1,1,3,0,11,1.5714285714285714,1,0.0,0,2,0,1,4,1,0,3,0,3,8,1
7076,162653,6yKvwDs84lm1ZlLZzY92MDe16cYzJo5V,fbPkOYLVPtPgIt0MxizjfFJov3JbHyAi,7,6,3,0,4,0,2,0,15,2.142857142857143,1,0.0,2,3,0,4,4,0,0,2,0,9,6,1
7077,162654,8sS5OxFNiGXZ5DUb7jXq3k5CIC9MaMcF,fbPkOYLVPtPgIt0MxizjfFJov3JbHyAi,11,5,2,0,2,10,5,1,25,3.5714285714285716,1,0.0,0,2,0,2,5,10,0,5,1,4,21,1
7078,162655,G8NfWWfRwceCubJJsygDkNdWqvz6p8r7,fbPkOYLVPtPgIt0MxizjfFJov3JbHyAi,4,3,0,0,0,0,3,0,6,0.8571428571428571,1,0.0,0,0,0,0,3,0,0,3,0,0,6,1
7079,162662,7SOATalw6HkrZim2p905lRKSzVKbYoeJ,fbPkOYLVPtPgIt0MxizjfFJov3JbHyAi,1,0,0,0,0,0,1,0,1,0.14285714285714285,1,0.0,0,0,0,0,0,0,0,1,0,0,1,1
7080,162663,HDuNX4LLsLDTkuyYIBGkGV7jAGXEtOuc,fbPkOYLVPtPgIt0MxizjfFJov3JbHyAi,2,0,0,0,0,0,3,0,3,0.42857142857142855,1,0.0,0,0,0,0,0,0,0,3,0,0,3,1
7081,162664,92eKrHML8uFDQVHOmZmmhaJ4gTyx9NDt,fbPkOYLVPtPgIt0MxizjfFJov3JbHyAi,8,4,2,0,2,0,5,0,13,1.8571428571428572,1,0.0,1,2,0,2,3,0,0,5,0,5,8,1
7082,162665,1jbzhg6dAhJ3AT5rxEEXSMGEXTVvHdIx,fbPkOYLVPtPgIt0MxizjfFJov3JbHyAi,2,0,0,0,0,0,3,0,3,0.42857142857142855,1,0.0,0,0,0,0,0,0,0,3,0,0,3,1
7083,162667,ftYE47yTOAFIMqTQk12eUimylWQiUH5C,fbPkOYLVPtPgIt0MxizjfFJov3JbHyAi,5,2,1,0,1,0,3,0,7,1.0,1,0.0,0,1,0,1,2,0,0,3,0,2,5,1
7084,162668,UVZ0046mDQtSPXatD3KanD1N0mcrpfEe,fbPkOYLVPtPgIt0MxizjfFJov3JbHyAi,1,0,0,0,0,0,1,0,1,0.14285714285714285,1,0.0,0,0,0,0,0,0,0,1,0,0,1,1
7085,162669,MEiWJmtZSdxLL8HEGVkX5lxXxAUsGu0A,fbPkOYLVPtPgIt0MxizjfFJov3JbHyAi,1,0,0,0,0,0,1,0,1,0.14285714285714285,1,0.0,0,0,0,0,0,0,0,1,0,0,1,1
7086,162670,0FtVS7ZBI4rrErVUUUqJzFuZedQkaBu3,fbPkOYLVPtPgIt0MxizjfFJov3JbHyAi,1,0,0,0,0,0,1,0,1,0.14285714285714285,1,0.0,0,0,0,0,0,0,0,1,0,0,1,1
7087,162672,tBbrCdeCzTMG76NlqGynFt4AvfyJdikM,fbPkOYLVPtPgIt0MxizjfFJov3JbHyAi,43,32,15,48,13,1,5,1,115,16.428571428571427,1,0.0,14,15,42,13,18,1,6,5,1,84,31,1
7088,162674,Kz3qhdfTJukDJF9DtNWUYj5BtfRsMvnw,fbPkOYLVPtPgIt0MxizjfFJov3JbHyAi,2,0,0,0,0,0,2,0,2,0.2857142857142857,1,0.0,0,0,0,0,0,0,0,2,0,0,2,1
7089,162675,rde4SOUWKvk9DJZt1L0gZmVDXeNYiqdM,fbPkOYLVPtPgIt0MxizjfFJov3JbHyAi,11,6,4,0,3,0,7,1,21,3.0,1,0.0,1,4,0,3,5,0,0,7,1,8,13,1
7090,162677,JJDWSR5T5OI58OQCJ2rXYW6lv04IiDvD,fbPkOYLVPtPgIt0MxizjfFJov3JbHyAi,12,6,3,0,3,15,7,1,35,5.0,2,0.0,0,3,0,3,6,15,0,7,1,6,29,1
7091,162683,8zAtOSKV7R70cZuke03f42P9Tj2cyqBy,fbPkOYLVPtPgIt0MxizjfFJov3JbHyAi,5,3,1,0,1,0,2,0,7,1.0,1,0.0,0,1,0,1,3,0,0,2,0,2,5,1
7092,162684,EehddsodITByQl4qGuajkHZ7QOdMQQgV,fbPkOYLVPtPgIt0MxizjfFJov3JbHyAi,7,7,2,0,4,0,2,0,15,2.142857142857143,1,0.0,4,2,0,4,3,0,0,2,0,10,5,1
7093,162686,HIfBwadqUOHP4H0miQANqcPd7btb1kCW,fbPkOYLVPtPgIt0MxizjfFJov3JbHyAi,1,0,0,0,0,0,1,0,1,0.14285714285714285,1,0.0,0,0,0,0,0,0,0,1,0,0,1,1
7094,162688,TfMiuu9vyAM0w8qFqC2lCZDreJEc3tGS,fbPkOYLVPtPgIt0MxizjfFJov3JbHyAi,6,0,0,0,0,1,15,1,17,2.4285714285714284,1,0.0,0,0,0,0,0,1,0,15,1,0,17,1
7095,162700,M9qzbHqIRAsNV3bD2hj1DPeNp2k6AjqO,fbPkOYLVPtPgIt0MxizjfFJov3JbHyAi,6,2,1,0,1,0,4,0,8,1.1428571428571428,1,0.0,0,1,0,1,2,0,0,4,0,2,6,1
7096,162702,hS70rXH0G94qmb9N1eBGrleH41NX9STz,fbPkOYLVPtPgIt0MxizjfFJov3JbHyAi,2,0,0,0,0,0,5,0,5,0.7142857142857143,1,0.0,0,0,0,0,0,0,0,5,0,0,5,1
7097,162704,fX40yNA4s3myhUDdO7ujIUD2VjxgqD1R,fbPkOYLVPtPgIt0MxizjfFJov3JbHyAi,1,0,0,0,0,0,1,0,1,0.14285714285714285,1,0.0,0,0,0,0,0,0,0,1,0,0,1,1
7098,162706,4D3Mr9GTnnSeHqe4k4RduVTIffzivKXV,fbPkOYLVPtPgIt0MxizjfFJov3JbHyAi,10,16,5,0,3,2,11,0,37,5.285714285714286,2,0.0,0,5,0,3,16,2,0,11,0,8,29,1
7099,162708,C9lLMTQ4ry2uksEvYVANv0oVpPhZMbc2,fbPkOYLVPtPgIt0MxizjfFJov3JbHyAi,8,5,3,0,2,0,4,0,14,2.0,1,0.0,0,3,0,2,5,0,0,4,0,5,9,1
7100,162710,724Z1dFlMACAt3kWIjNXL2F7EImzegCP,fbPkOYLVPtPgIt0MxizjfFJov3JbHyAi,1,0,0,0,0,0,1,0,1,0.14285714285714285,1,0.0,0,0,0,0,0,0,0,1,0,0,1,1
7101,162711,xIi7bi5lsr2kQs0Ruk7tQjf4xYRaSVFg,fbPkOYLVPtPgIt0MxizjfFJov3JbHyAi,9,6,4,0,3,0,2,0,15,2.142857142857143,1,0.0,0,4,0,3,6,0,0,2,0,7,8,1
7102,162713,FEsfreZNllfO9KbF7SZ3ITs14Rmiz03Y,fbPkOYLVPtPgIt0MxizjfFJov3JbHyAi,1,0,0,0,0,0,1,0,1,0.14285714285714285,1,0.0,0,0,0,0,0,0,0,1,0,0,1,1
7103,163208,afMatYBEskDEx2mzVDW2B6YoXRt9RGEu,7GRhBDsirIGkRZBtSMEzNTyDr2JQm4xx,1,0,0,0,0,0,1,0,1,0.14285714285714285,1,0.0,0,0,0,0,0,0,0,1,0,0,1,1
7104,163263,4i5hqm1gfzAWGRB4svclJb7LMO8qbrVL,7GRhBDsirIGkRZBtSMEzNTyDr2JQm4xx,4,3,1,0,0,0,2,0,6,0.8571428571428571,1,0.0,0,1,0,0,3,0,0,2,0,1,5,1
7105,163295,kgapU06uO2FTgFvaWXJYj3aeIVCjcJ3p,7GRhBDsirIGkRZBtSMEzNTyDr2JQm4xx,1,0,0,0,0,0,1,0,1,0.14285714285714285,1,0.0,0,0,0,0,0,0,0,1,0,0,1,1
7106,163305,sPLn9Z0P7AWvSFd67DQFXqDRTnVlsDDq,7GRhBDsirIGkRZBtSMEzNTyDr2JQm4xx,7,4,3,0,3,0,2,0,12,1.7142857142857142,1,0.0,0,3,0,3,4,0,0,2,0,6,6,1
7107,163310,TpVcNSSZgwZ6DE3d1K8SPrDWLNQ6MrgR,7GRhBDsirIGkRZBtSMEzNTyDr2JQm4xx,1,0,0,0,0,0,1,0,1,0.14285714285714285,1,0.0,0,0,0,0,0,0,0,1,0,0,1,1
7108,163446,vYZLFtHzbRZEyiuRAYkPU2TurFaRRb3e,bWdj2GDclj5ofokWjzoa5jAwMkxCykd6,7,7,4,0,3,0,3,0,17,2.4285714285714284,3,0.0,1,4,0,3,6,0,0,3,0,8,9,1
7109,163447,CR6hbwvXPZHEYYcI4AAX4civM4Pp6Aex,bWdj2GDclj5ofokWjzoa5jAwMkxCykd6,7,2,1,0,1,0,4,0,8,1.1428571428571428,2,0.0,0,1,0,1,2,0,0,4,0,2,6,1
7110,163451,rUr3hxt1niPeDbjT1dWASqAoHDERYMHJ,bWdj2GDclj5ofokWjzoa5jAwMkxCykd6,26,15,6,100,2,5,3,0,131,18.714285714285715,3,0.0,4,6,90,2,11,5,10,3,0,102,29,0
7111,163452,CLgDvHjU8d0JuEtHgdUcLQg1OZ6hE3A8,RXDvfPUBYFlVdlueBFbLW0mhhAyGEqpt,21,24,15,22,8,2,6,0,77,11.0,3,0.0,4,15,22,8,20,2,0,6,0,49,28,1
7112,163456,QW07WKWuMa47F3DVH5YhQbGmBNCRc0FZ,SpATywNh6bZuzm8s1ceuBUnMUAeoAHHw,9,5,1,16,1,2,4,1,30,4.285714285714286,1,0.0,2,1,13,1,3,2,3,4,1,17,13,1
7113,163459,eq3avF6QxxFlcD9gaMIYsKSt5Td1igiD,SpATywNh6bZuzm8s1ceuBUnMUAeoAHHw,12,16,2,18,0,0,5,0,41,5.857142857142857,1,0.0,5,2,15,0,11,0,3,5,0,22,19,1
7114,163463,hFpufo5lTiocFSjp5de4hLz459xEY6dx,G8EPVSXsOYB5YQWZGiz1aVq5Pgr2GrQu,12,5,3,0,2,4,8,1,23,3.2857142857142856,1,0.0,0,3,0,2,5,4,0,8,1,5,18,1
7115,163468,GGdBzvTskjxKAvNdibnhPPkGKFTKpZaL,SpATywNh6bZuzm8s1ceuBUnMUAeoAHHw,4,3,0,0,0,0,3,0,6,0.8571428571428571,1,0.0,0,0,0,0,3,0,0,3,0,0,6,1
7116,163473,m580K62zl9ih2EBTcM6Y53ygfq7rAv69,RXDvfPUBYFlVdlueBFbLW0mhhAyGEqpt,1,0,0,0,0,0,1,0,1,0.14285714285714285,1,0.0,0,0,0,0,0,0,0,1,0,0,1,1
7117,163474,2sDQ5DmJB14fdhYiHWrjTNImvS7e7hHg,RXDvfPUBYFlVdlueBFbLW0mhhAyGEqpt,9,6,5,0,4,1,5,1,22,3.142857142857143,2,0.0,0,5,0,4,6,1,0,5,1,9,13,1
7118,163489,5IM8g7YMOYo5qH7Yu3x31T3JkVOH9iqe,RXDvfPUBYFlVdlueBFbLW0mhhAyGEqpt,8,12,4,0,2,0,1,0,19,2.7142857142857144,2,0.0,1,4,0,2,11,0,0,1,0,7,12,1
7119,163492,ni5dUdHYqNJ6ClZBex2HryO1vDE1ZkoU,SpATywNh6bZuzm8s1ceuBUnMUAeoAHHw,4,1,0,0,0,0,3,0,4,0.5714285714285714,1,0.0,0,0,0,0,1,0,0,3,0,0,4,1
7120,163495,ww05exVvqmTpHRLpMlcyyiyf25IJQarF,bWdj2GDclj5ofokWjzoa5jAwMkxCykd6,4,2,1,0,1,0,2,0,6,0.8571428571428571,1,0.0,0,1,0,1,2,0,0,2,0,2,4,1
7121,163498,KemVogD4rWuutYcMfAZRpTjVQNkGCf1a,bWdj2GDclj5ofokWjzoa5jAwMkxCykd6,6,6,2,0,2,0,1,0,11,1.5714285714285714,1,0.0,2,2,0,2,4,0,0,1,0,6,5,1
7122,163503,q1KcO9Dg3vZiLgj3uBWo2HFsUXBuH0Hl,RXDvfPUBYFlVdlueBFbLW0mhhAyGEqpt,12,8,1,21,1,0,2,0,33,4.714285714285714,1,0.0,2,1,17,1,6,0,4,2,0,21,12,1
7123,163511,i0ksX07HnsV5rQlWqOr1uKEuc7yNU24c,bWdj2GDclj5ofokWjzoa5jAwMkxCykd6,13,23,10,0,6,48,13,1,101,14.428571428571429,2,0.0,7,10,0,6,16,48,0,13,1,23,78,1
7124,163517,RAAFt7jgkqGMpy4rUVomxkKt5lfbto8C,SpATywNh6bZuzm8s1ceuBUnMUAeoAHHw,5,1,0,0,0,1,7,1,10,1.4285714285714286,2,0.0,0,0,0,0,1,1,0,7,1,0,10,1
7125,163520,gFwcy6HlQMHgKm8VCXe5qQxUXfgM5CMM,RXDvfPUBYFlVdlueBFbLW0mhhAyGEqpt,18,31,11,2,5,0,3,0,52,7.428571428571429,2,0.0,1,11,2,5,30,0,0,3,0,19,33,1
7126,163521,vvZAdi1giBsqNJd2MIMUF2BeNIuSYzIL,bWdj2GDclj5ofokWjzoa5jAwMkxCykd6,5,2,1,0,1,0,2,0,6,0.8571428571428571,1,0.0,0,1,0,1,2,0,0,2,0,2,4,1
7127,163522,0z2VYcRtlKJQ1Og2a3In5C7pwhw0mXLE,SpATywNh6bZuzm8s1ceuBUnMUAeoAHHw,30,68,35,29,15,203,28,4,382,54.57142857142857,6,0.0,19,35,27,15,49,203,2,28,4,96,286,1
7128,163524,Qp6nTYSBUXdSPjEoOGaLaIU4K702QdpX,SpATywNh6bZuzm8s1ceuBUnMUAeoAHHw,9,3,2,0,2,0,6,1,14,2.0,1,0.0,0,2,0,2,3,0,0,6,1,4,10,1
7129,163545,aNuWWNOgxdbqnpWne8VHd2WyMrEEuUHw,SpATywNh6bZuzm8s1ceuBUnMUAeoAHHw,13,13,0,24,0,3,5,6,51,7.285714285714286,1,0.0,6,0,19,0,7,3,5,5,6,25,26,1
7130,163548,MYL9KYDmBF9vDici6Dv3saVcxgkvpmKP,SpATywNh6bZuzm8s1ceuBUnMUAeoAHHw,8,2,2,0,2,0,3,0,9,1.2857142857142858,2,0.0,0,2,0,2,2,0,0,3,0,4,5,1
7131,163553,RfHHoRL5TB9R1ardH3KUBDMoKbTvmS64,G8EPVSXsOYB5YQWZGiz1aVq5Pgr2GrQu,9,2,1,0,1,2,8,1,15,2.142857142857143,1,0.0,0,1,0,1,2,2,0,8,1,2,13,1
7132,163556,x1RDUiG4hzdFvWaarIV1g7s3ecNKiDPi,bWdj2GDclj5ofokWjzoa5jAwMkxCykd6,6,5,1,0,1,6,3,0,16,2.2857142857142856,1,0.0,2,1,0,1,3,6,0,3,0,4,12,1
7133,163561,0QwOyzDB4SU53NQhq9XNeT5ngIq83qZV,SpATywNh6bZuzm8s1ceuBUnMUAeoAHHw,14,20,6,18,4,4,5,0,57,8.142857142857142,1,0.0,12,6,16,4,8,4,2,5,0,38,19,1
7134,163566,7OkCZWJW1Ow4wpTBUq53amL13pV2vy2v,bWdj2GDclj5ofokWjzoa5jAwMkxCykd6,1,0,0,0,0,0,1,0,1,0.14285714285714285,1,0.0,0,0,0,0,0,0,0,1,0,0,1,1
7135,163575,pUCG45Dx4PCk37xolhUilbrK2zyzqYUw,SpATywNh6bZuzm8s1ceuBUnMUAeoAHHw,5,2,1,0,1,0,2,0,6,0.8571428571428571,1,0.0,0,1,0,1,2,0,0,2,0,2,4,1
7136,163584,pUCG45Dx4PCk37xolhUilbrK2zyzqYUw,RXDvfPUBYFlVdlueBFbLW0mhhAyGEqpt,5,2,1,0,1,0,2,0,6,0.8571428571428571,1,0.0,0,1,0,1,2,0,0,2,0,2,4,1
7137,163587,LOW2vjVehrf0M1x4W4dAc3vEUlAV2GoS,SpATywNh6bZuzm8s1ceuBUnMUAeoAHHw,1,0,0,0,0,0,1,0,1,0.14285714285714285,1,0.0,0,0,0,0,0,0,0,1,0,0,1,1
7138,163591,pvAe37z1FjLTGYdwlJFjXex25zlpyHtu,SpATywNh6bZuzm8s1ceuBUnMUAeoAHHw,1,0,0,0,0,0,1,0,1,0.14285714285714285,1,0.0,0,0,0,0,0,0,0,1,0,0,1,1
7139,163594,cJ2sQIvcbMYmAtm7wZLrjdPU3A4J8Vmy,RXDvfPUBYFlVdlueBFbLW0mhhAyGEqpt,1,0,0,0,0,0,1,0,1,0.14285714285714285,1,0.0,0,0,0,0,0,0,0,1,0,0,1,1
7140,163602,1n5nYyRZ2V4rGDvhlysxQQrSnQWtjpF0,SpATywNh6bZuzm8s1ceuBUnMUAeoAHHw,5,2,0,0,0,0,4,0,6,0.8571428571428571,1,0.0,0,0,0,0,2,0,0,4,0,0,6,1
7141,163606,muDFJRueLAzQJIObWxRY78oBQLrrl8ME,RXDvfPUBYFlVdlueBFbLW0mhhAyGEqpt,5,1,1,0,1,0,2,0,5,0.7142857142857143,1,0.0,0,1,0,1,1,0,0,2,0,2,3,1
7142,163608,zgldUj8PQLoCMFvq4CFx27ajGTiUzuNA,SpATywNh6bZuzm8s1ceuBUnMUAeoAHHw,8,3,1,0,1,0,5,1,11,1.5714285714285714,1,0.0,0,1,0,1,3,0,0,5,1,2,9,1
7143,163610,shpNJBWz5XXztT7QSTTkv5TBZhc2j7a5,bWdj2GDclj5ofokWjzoa5jAwMkxCykd6,5,2,1,0,1,0,2,0,6,0.8571428571428571,1,0.0,0,1,0,1,2,0,0,2,0,2,4,1
7144,163620,BRQa1dSoPdGgh4T8YhbATcVtUAwS3CTv,G8EPVSXsOYB5YQWZGiz1aVq5Pgr2GrQu,1,0,0,0,0,0,1,0,1,0.14285714285714285,1,0.0,0,0,0,0,0,0,0,1,0,0,1,1
7145,163624,J4pjYRUS78455k3x6FlgE0qLyKCkWPB4,SpATywNh6bZuzm8s1ceuBUnMUAeoAHHw,5,5,2,0,1,0,6,0,14,2.0,2,0.0,0,2,0,1,5,0,0,6,0,3,11,1
7146,163626,h1vKdFPTvdJ38bRqZwCXLGITqLqjjxQ8,bWdj2GDclj5ofokWjzoa5jAwMkxCykd6,2,0,0,0,0,0,5,0,5,0.7142857142857143,4,0.0,0,0,0,0,0,0,0,5,0,0,5,1
7147,163633,loY20pnf7suv2LWREXjC0h3XNawzaj7l,SpATywNh6bZuzm8s1ceuBUnMUAeoAHHw,15,13,4,13,3,0,5,0,38,5.428571428571429,1,0.0,5,4,11,3,8,0,2,5,0,23,15,1
7148,163657,3NITGQuylcrTi63aoWqnzXuF5Rtf7QVq,bWdj2GDclj5ofokWjzoa5jAwMkxCykd6,15,24,12,52,8,0,4,0,100,14.285714285714286,2,0.0,9,12,51,8,15,0,1,4,0,80,20,1
7149,163661,TC06DZHDGaAT9UQHd1v4hOYj6DcF04C0,SpATywNh6bZuzm8s1ceuBUnMUAeoAHHw,1,0,0,0,0,0,1,0,1,0.14285714285714285,1,0.0,0,0,0,0,0,0,0,1,0,0,1,1
7150,163664,75QwID9vkHNyAC3jIqeF9fNTGOKWDCMd,SpATywNh6bZuzm8s1ceuBUnMUAeoAHHw,24,53,1,42,1,11,22,5,135,19.285714285714285,4,0.0,18,1,30,1,35,11,12,22,5,50,85,0
7151,163665,mSLVZlcG3d9P9nR1btPulwDUjqta6d8Y,RXDvfPUBYFlVdlueBFbLW0mhhAyGEqpt,2,0,0,0,0,0,2,0,2,0.2857142857142857,1,0.0,0,0,0,0,0,0,0,2,0,0,2,1
7152,163668,BB5Nl9ZKGNNXpCTY1I2k14qOsWmBwuLj,SpATywNh6bZuzm8s1ceuBUnMUAeoAHHw,5,2,1,0,1,0,2,0,6,0.8571428571428571,1,0.0,0,1,0,1,2,0,0,2,0,2,4,1
7153,163670,zBcT1Z0xXooVqe1Y23Zi33CckLeXOFNF,RXDvfPUBYFlVdlueBFbLW0mhhAyGEqpt,1,0,0,0,0,0,1,0,1,0.14285714285714285,1,0.0,0,0,0,0,0,0,0,1,0,0,1,1
7154,163671,jMDxIZZpgmR8gnZ9CfiXAFFCthv2NGRW,SpATywNh6bZuzm8s1ceuBUnMUAeoAHHw,15,13,8,14,3,6,7,0,51,7.285714285714286,2,0.0,2,8,12,3,11,6,2,7,0,25,26,1
7155,163672,Xdw2Hwx0RPjHhvzIV1hR51APAU4mGupY,SpATywNh6bZuzm8s1ceuBUnMUAeoAHHw,5,5,2,0,2,0,1,0,10,1.4285714285714286,1,0.0,1,2,0,2,4,0,0,1,0,5,5,1
7156,163676,JoqAGqbao71wc04PyVzx7SVvlZZ0knbI,bWdj2GDclj5ofokWjzoa5jAwMkxCykd6,11,15,7,24,4,13,5,0,68,9.714285714285714,2,0.0,3,7,22,4,12,13,2,5,0,36,32,1
7157,163677,HcOpBFh3ZPBJu7PjBFffM3Zedw54RSXN,bWdj2GDclj5ofokWjzoa5jAwMkxCykd6,4,3,1,0,1,0,2,0,7,1.0,2,0.0,0,1,0,1,3,0,0,2,0,2,5,1
7158,163682,vqdEPdTaMaLXqSh5cxznXuMHlVEqT6bt,SpATywNh6bZuzm8s1ceuBUnMUAeoAHHw,12,29,22,0,8,0,9,1,69,9.857142857142858,2,0.0,0,22,0,8,29,0,0,9,1,30,39,0
7159,163688,cENALtdHRJFXtEKpdDktmgl2ZGC3sBgO,SpATywNh6bZuzm8s1ceuBUnMUAeoAHHw,12,9,1,17,0,0,4,0,31,4.428571428571429,1,0.0,4,1,15,0,5,0,2,4,0,20,11,1
7160,163690,komVuIpJ79AnXgdOwFqR0q8Eqk6fTXb3,SpATywNh6bZuzm8s1ceuBUnMUAeoAHHw,1,0,0,0,0,0,1,0,1,0.14285714285714285,1,0.0,0,0,0,0,0,0,0,1,0,0,1,1
7161,163694,sEHJPtMDHp3vOEZBdXoH3aRuuTFrugcC,G8EPVSXsOYB5YQWZGiz1aVq5Pgr2GrQu,10,22,13,0,8,2,5,0,50,7.142857142857143,2,0.0,4,13,0,8,18,2,0,5,0,25,25,1
7162,163698,pDVnQJMhWdSLNejm9F2A6uzPWohSMQmu,G8EPVSXsOYB5YQWZGiz1aVq5Pgr2GrQu,16,12,0,18,0,15,4,1,50,7.142857142857143,1,0.0,7,0,10,0,5,15,8,4,1,17,33,1
7163,163700,zUFpvfPNIssMYrypcxpRp9lQfW6g2Sf6,SpATywNh6bZuzm8s1ceuBUnMUAeoAHHw,7,7,0,0,0,6,11,0,24,3.4285714285714284,1,0.0,2,0,0,0,5,6,0,11,0,2,22,1
7164,163706,CrPF9cMk7uOWPFKqLXtVzkBmR606gvwU,SpATywNh6bZuzm8s1ceuBUnMUAeoAHHw,13,8,4,15,3,2,4,0,36,5.142857142857143,1,0.0,3,4,14,3,5,2,1,4,0,24,12,1
7165,163720,2nKcL79UGpRMTprt0KTar2VFqD9nuGkh,SpATywNh6bZuzm8s1ceuBUnMUAeoAHHw,2,0,0,0,0,0,2,0,2,0.2857142857142857,1,0.0,0,0,0,0,0,0,0,2,0,0,2,1
7166,163724,0YUJjVhFBVhA8wNUqY2rEXkCnd7riq8C,G8EPVSXsOYB5YQWZGiz1aVq5Pgr2GrQu,26,83,20,58,13,13,7,0,194,27.714285714285715,2,0.0,21,20,37,13,62,13,21,7,0,91,103,1
7167,163729,S6XUZDRPe3B3jFFcpBw3sZVQuamNJyiN,SpATywNh6bZuzm8s1ceuBUnMUAeoAHHw,10,6,2,0,2,0,11,1,22,3.142857142857143,1,0.0,0,2,0,2,6,0,0,11,1,4,18,1
7168,163741,D9KO1ppIRpnoCoycPkHQYcH9KJWpl4W7,bWdj2GDclj5ofokWjzoa5jAwMkxCykd6,4,3,1,0,1,0,1,0,6,0.8571428571428571,1,0.0,0,1,0,1,3,0,0,1,0,2,4,1
7169,163745,etVgnbIdb29nIYhfw4jRXWTSVqDVpgA6,bWdj2GDclj5ofokWjzoa5jAwMkxCykd6,5,2,1,0,1,0,2,0,6,0.8571428571428571,1,0.0,0,1,0,1,2,0,0,2,0,2,4,1
7170,163750,Cyn71axG1s2H4lOUgGzQPfwHEpQH7ztK,SpATywNh6bZuzm8s1ceuBUnMUAeoAHHw,15,19,8,12,4,12,3,0,58,8.285714285714286,2,0.0,8,8,12,4,11,12,0,3,0,32,26,1
7171,163768,RqamfvIhC4c7Es8bljx9jvwLrjWv2ac0,RXDvfPUBYFlVdlueBFbLW0mhhAyGEqpt,2,0,0,0,0,0,4,0,4,0.5714285714285714,1,0.0,0,0,0,0,0,0,0,4,0,0,4,1
7172,163778,btnHCoy9MQOM6yfSVhDpkIBjedtnrWxU,RXDvfPUBYFlVdlueBFbLW0mhhAyGEqpt,8,5,4,0,2,0,1,0,12,1.7142857142857142,1,0.0,0,4,0,2,5,0,0,1,0,6,6,1
7173,163779,NerpsmnngCHcZrL9Hd5ZneLeL3p095KD,SpATywNh6bZuzm8s1ceuBUnMUAeoAHHw,6,5,3,0,1,0,4,0,13,1.8571428571428572,1,0.0,0,3,0,1,5,0,0,4,0,4,9,1
7174,163786,SkZlhcjqZI4qlpvHtuOmZh7bgPo5Ar9M,bWdj2GDclj5ofokWjzoa5jAwMkxCykd6,2,0,0,0,0,0,2,0,2,0.2857142857142857,1,0.0,0,0,0,0,0,0,0,2,0,0,2,1
7175,163788,n3c2ApJ73TKxIh3DdiEwlTAkgOAhKXpG,SpATywNh6bZuzm8s1ceuBUnMUAeoAHHw,17,21,12,25,4,16,16,2,96,13.714285714285714,1,0.0,5,12,19,4,16,16,6,16,2,40,56,1
7176,163792,l2L8xysJvlmTPvgXglY4OYbhmyGaWoEy,RXDvfPUBYFlVdlueBFbLW0mhhAyGEqpt,16,8,6,42,3,0,11,1,71,10.142857142857142,1,0.0,2,6,34,3,6,0,8,11,1,45,26,1
7177,163795,YgSP6VTXTaMFsmPeWIUxWWzafDI82Gyz,SpATywNh6bZuzm8s1ceuBUnMUAeoAHHw,5,4,1,0,0,0,5,0,10,1.4285714285714286,3,0.0,0,1,0,0,4,0,0,5,0,1,9,1
7178,163797,Cmo75ZUENQku9o2Ve6I8FB5t9KDDKDgA,SpATywNh6bZuzm8s1ceuBUnMUAeoAHHw,4,4,1,0,1,0,2,0,8,1.1428571428571428,1,0.0,2,1,0,1,2,0,0,2,0,4,4,1
7179,163807,ejqIFmdt0kSod99aitO8eyB1a9BPL17H,SpATywNh6bZuzm8s1ceuBUnMUAeoAHHw,1,0,0,0,0,0,1,0,1,0.14285714285714285,1,0.0,0,0,0,0,0,0,0,1,0,0,1,1
7180,163815,Kp1vLJAjI5XcavfLMkR7KVaehYzBATxU,bWdj2GDclj5ofokWjzoa5jAwMkxCykd6,8,2,1,0,1,1,8,1,14,2.0,1,0.0,0,1,0,1,2,1,0,8,1,2,12,1
7181,163818,Jk2x4OpxMPaHdO7EMry509YRkCM2Yc2p,SpATywNh6bZuzm8s1ceuBUnMUAeoAHHw,12,10,4,16,0,8,7,1,46,6.571428571428571,1,0.0,6,4,14,0,4,8,2,7,1,24,22,1
7182,163843,6ifSGyv1OJBX59YUfupEGQzaFg12QLcw,RXDvfPUBYFlVdlueBFbLW0mhhAyGEqpt,31,36,29,0,7,0,13,2,87,12.428571428571429,4,0.0,0,29,0,7,36,0,0,13,2,36,51,1
7183,163848,KL1kUzCOuvYfkjBJ6sFRxEo1isQ1OD4Z,bWdj2GDclj5ofokWjzoa5jAwMkxCykd6,4,3,0,0,0,0,2,0,5,0.7142857142857143,1,0.0,0,0,0,0,3,0,0,2,0,0,5,1
7184,163856,xKB2JQIJ9xKYEvQWCbLYsbszDegqqoDj,bWdj2GDclj5ofokWjzoa5jAwMkxCykd6,4,3,1,0,1,0,1,0,6,0.8571428571428571,1,0.0,1,1,0,1,2,0,0,1,0,3,3,1
7185,163861,dIc7Ag2KIstBuuBNcnhZG1Qo98HOHtHH,SpATywNh6bZuzm8s1ceuBUnMUAeoAHHw,1,0,0,0,0,0,1,0,1,0.14285714285714285,1,0.0,0,0,0,0,0,0,0,1,0,0,1,1
7186,163872,bUOsk5wGaEvBO4I3alFT753psxzUkzse,RXDvfPUBYFlVdlueBFbLW0mhhAyGEqpt,5,2,1,0,1,0,2,0,6,0.8571428571428571,1,0.0,0,1,0,1,2,0,0,2,0,2,4,1
7187,163876,SSpeewBDHUNKkvUJM5ASinNHvMXIOEwr,SpATywNh6bZuzm8s1ceuBUnMUAeoAHHw,7,7,3,0,1,6,4,0,21,3.0,3,0.0,0,3,0,1,7,6,0,4,0,4,17,1
7188,163878,jX1wtG8uym7vm2Ny85W79HCXnEeqhUm4,SpATywNh6bZuzm8s1ceuBUnMUAeoAHHw,1,0,0,0,0,0,1,0,1,0.14285714285714285,1,0.0,0,0,0,0,0,0,0,1,0,0,1,1
7189,163891,GyWTABuPpZEqO585EnNTIpM2B2faPYN3,bWdj2GDclj5ofokWjzoa5jAwMkxCykd6,4,2,1,0,1,0,1,0,5,0.7142857142857143,1,0.0,0,1,0,1,2,0,0,1,0,2,3,1
7190,163897,HPHciqd0NAfLXfMlyuoYEVDWJNUonGj0,bWdj2GDclj5ofokWjzoa5jAwMkxCykd6,7,59,6,0,4,0,5,0,74,10.571428571428571,2,0.0,3,6,0,4,56,0,0,5,0,13,61,1
7191,163912,KAW52VBDXCvurEAry0tITiLWjcxVkV8S,RXDvfPUBYFlVdlueBFbLW0mhhAyGEqpt,41,34,20,96,13,2,4,0,169,24.142857142857142,1,0.0,9,20,86,13,25,2,10,4,0,128,41,1
7192,163913,aKmGG28IIMsmRYbcnkO5kp7ipo4I9wj0,SpATywNh6bZuzm8s1ceuBUnMUAeoAHHw,9,7,1,6,0,1,5,1,21,3.0,2,0.0,0,1,5,0,7,1,1,5,1,6,15,1
7193,163921,MSZ49Aqf4KMvK8xA9amgTCzlSE1z7F0F,bWdj2GDclj5ofokWjzoa5jAwMkxCykd6,2,0,0,0,0,0,2,0,2,0.2857142857142857,1,0.0,0,0,0,0,0,0,0,2,0,0,2,1
7194,163926,2K1Z8MHkxSfa3IoXQMOOkvPRYry0VFvS,bWdj2GDclj5ofokWjzoa5jAwMkxCykd6,10,9,4,0,1,1,8,1,24,3.4285714285714284,2,0.0,0,4,0,1,9,1,0,8,1,5,19,0
7195,163933,caAQbOI1NkkZKVF3oGPK3OdsY0lbDlYb,RXDvfPUBYFlVdlueBFbLW0mhhAyGEqpt,1,0,0,0,0,0,2,0,2,0.2857142857142857,1,0.0,0,0,0,0,0,0,0,2,0,0,2,1
7196,163943,MIuMzVdl8gwQZWh4ux7IRLhRo5aprHQC,SpATywNh6bZuzm8s1ceuBUnMUAeoAHHw,1,0,0,0,0,0,1,0,1,0.14285714285714285,1,0.0,0,0,0,0,0,0,0,1,0,0,1,1
7197,163953,YgxPec9PZk03SxcMpde0DWwnbgHU13wT,SpATywNh6bZuzm8s1ceuBUnMUAeoAHHw,1,0,0,0,0,0,1,0,1,0.14285714285714285,1,0.0,0,0,0,0,0,0,0,1,0,0,1,1
7198,163958,0bsBNQsCMEE2O55Mpr8lzwhfGggHG2nb,SpATywNh6bZuzm8s1ceuBUnMUAeoAHHw,5,2,1,0,1,0,2,0,6,0.8571428571428571,1,0.0,0,1,0,1,2,0,0,2,0,2,4,1
7199,163964,ncIBIt1kRS23NRG3HklaOrwS2ep1UY7z,SpATywNh6bZuzm8s1ceuBUnMUAeoAHHw,2,0,0,0,0,0,2,0,2,0.2857142857142857,1,0.0,0,0,0,0,0,0,0,2,0,0,2,1
7200,163969,0bsBNQsCMEE2O55Mpr8lzwhfGggHG2nb,G8EPVSXsOYB5YQWZGiz1aVq5Pgr2GrQu,5,2,1,0,1,0,2,0,6,0.8571428571428571,1,0.0,0,1,0,1,2,0,0,2,0,2,4,1
7201,163989,u4a9xsMW9UMqx1X32x8LQI0FlTLRy0KL,SpATywNh6bZuzm8s1ceuBUnMUAeoAHHw,2,0,0,0,0,9,1,0,10,1.4285714285714286,1,0.0,0,0,0,0,0,9,0,1,0,0,10,0
7202,163991,anEiPiaERCYvJFKhHPaXaVlQmETZOxzh,SpATywNh6bZuzm8s1ceuBUnMUAeoAHHw,1,0,0,0,0,0,2,0,2,0.2857142857142857,1,0.0,0,0,0,0,0,0,0,2,0,0,2,1
7203,163992,RiuaU3j9glvJbW4ph026KXgBcE6tugPM,RXDvfPUBYFlVdlueBFbLW0mhhAyGEqpt,1,0,0,0,0,0,1,0,1,0.14285714285714285,1,0.0,0,0,0,0,0,0,0,1,0,0,1,1
7204,164011,JRm4q27yt4AaEMn6KL3V0UaldpldX8N9,SpATywNh6bZuzm8s1ceuBUnMUAeoAHHw,6,1,1,0,1,0,4,0,7,1.0,2,0.0,0,1,0,1,1,0,0,4,0,2,5,1
7205,164016,2CKOPbc4gInQJsnnTPuzmf6nPJ7m7X0V,bWdj2GDclj5ofokWjzoa5jAwMkxCykd6,1,0,0,0,0,0,1,0,1,0.14285714285714285,1,0.0,0,0,0,0,0,0,0,1,0,0,1,1
7206,164019,zDzmXMYgrAR2y36omcEUWoshe9A93Rqa,G8EPVSXsOYB5YQWZGiz1aVq5Pgr2GrQu,3,2,0,0,0,0,4,0,6,0.8571428571428571,1,0.0,0,0,0,0,2,0,0,4,0,0,6,1
7207,164042,HmNDAe5361OzVlrz8LBClXTWLyGOsfB7,SpATywNh6bZuzm8s1ceuBUnMUAeoAHHw,11,12,3,0,2,9,14,0,40,5.714285714285714,2,0.0,0,3,0,2,12,9,0,14,0,5,35,1
7208,164055,eeroiGZDLkmy8hYlMjhf0wHZNeoAekbw,SpATywNh6bZuzm8s1ceuBUnMUAeoAHHw,9,19,7,0,2,1,7,0,36,5.142857142857143,4,0.0,0,7,0,2,19,1,0,7,0,9,27,1
7209,164057,YKkBpxb8WAuGDSQU1z7LvNmikgJLWtZj,SpATywNh6bZuzm8s1ceuBUnMUAeoAHHw,11,18,1,6,1,0,8,0,34,4.857142857142857,3,0.0,1,1,5,1,17,0,1,8,0,8,26,1
7210,164069,NoDqq3WQEPxb31LrvCuk6iDV8wGhNbVA,G8EPVSXsOYB5YQWZGiz1aVq5Pgr2GrQu,17,25,12,24,8,0,3,0,72,10.285714285714286,3,0.0,9,12,18,8,16,0,6,3,0,47,25,1
7211,164070,Rv6gVo5TL2yRLbTriDaWEPebl1P4Qs2d,SpATywNh6bZuzm8s1ceuBUnMUAeoAHHw,15,39,17,13,7,27,11,0,114,16.285714285714285,3,0.0,3,17,12,7,36,27,1,11,0,39,75,1
7212,164080,om0kp3yKpxrkFaqYJciQiQMcbCOWwtTu,SpATywNh6bZuzm8s1ceuBUnMUAeoAHHw,7,6,3,0,2,1,3,1,16,2.2857142857142856,1,0.0,1,3,0,2,5,1,0,3,1,6,10,1
7213,164082,p3rNyoksJ9TEfFEu0f5KZsbSwUZIEvsu,SpATywNh6bZuzm8s1ceuBUnMUAeoAHHw,15,11,4,10,3,2,5,3,38,5.428571428571429,1,0.0,3,4,8,3,8,2,2,5,3,18,20,1
7214,164084,sjjMSkWB5IXcRcDmE2j3kfDFuBFIoN8k,bWdj2GDclj5ofokWjzoa5jAwMkxCykd6,12,21,9,26,6,1,9,1,73,10.428571428571429,1,0.0,6,9,25,6,15,1,1,9,1,46,27,1
7215,164085,EstzqNEYeufsEWzgLWtGlb7e6FUCscoH,SpATywNh6bZuzm8s1ceuBUnMUAeoAHHw,1,0,0,0,0,0,1,0,1,0.14285714285714285,1,0.0,0,0,0,0,0,0,0,1,0,0,1,1
7216,164096,WZJCLDDXV5Wl4Svb3H2g8hACnctxCrNZ,G8EPVSXsOYB5YQWZGiz1aVq5Pgr2GrQu,9,6,2,8,1,0,4,1,22,3.142857142857143,1,0.0,4,2,6,1,2,0,2,4,1,13,9,1
7217,164099,T0RArQ3lSZeSD0MbnDejlzkMufYho8lt,bWdj2GDclj5ofokWjzoa5jAwMkxCykd6,12,11,8,0,8,0,7,2,36,5.142857142857143,2,0.0,0,8,0,8,11,0,0,7,2,16,20,1
7218,164103,LuPgMCIdX2ugHzDAngaEsA394qOat0id,bWdj2GDclj5ofokWjzoa5jAwMkxCykd6,6,9,4,0,0,0,8,0,21,3.0,2,0.0,0,4,0,0,9,0,0,8,0,4,17,1
7219,164104,e6HjcHFSQL7s0bn6pVFAYgFBkk1qs0K8,SpATywNh6bZuzm8s1ceuBUnMUAeoAHHw,4,4,0,0,0,0,2,0,6,0.8571428571428571,1,0.0,1,0,0,0,3,0,0,2,0,1,5,1
7220,164133,C800geUBh3GYBhoh4cW6ReKUGj5LAMGi,RXDvfPUBYFlVdlueBFbLW0mhhAyGEqpt,1,0,0,0,0,0,1,0,1,0.14285714285714285,1,0.0,0,0,0,0,0,0,0,1,0,0,1,1
7221,164145,sG64hLkOLC3BnIsKXDBdltBd6B2Qop5m,SpATywNh6bZuzm8s1ceuBUnMUAeoAHHw,16,23,19,0,13,2,5,0,62,8.857142857142858,3,0.0,0,19,0,13,23,2,0,5,0,32,30,1
7222,164147,jSIHGu9DhhauxAb5p4KNEdGcYL30YLp5,SpATywNh6bZuzm8s1ceuBUnMUAeoAHHw,13,10,1,26,1,0,15,1,54,7.714285714285714,2,0.0,4,1,21,1,6,0,5,15,1,27,27,1
7223,164151,qxuL6lm7O1L6ePIrQ7pAlpyCErX7NoG2,G8EPVSXsOYB5YQWZGiz1aVq5Pgr2GrQu,2,0,0,0,0,0,2,0,2,0.2857142857142857,1,0.0,0,0,0,0,0,0,0,2,0,0,2,0
7224,164161,hf4d4QAFiVVt3bxQ1i3sb92NQtXr4NWg,RXDvfPUBYFlVdlueBFbLW0mhhAyGEqpt,7,5,3,0,1,0,3,0,12,1.7142857142857142,1,0.0,0,3,0,1,5,0,0,3,0,4,8,1
7225,164166,VNMcZCNkGFRxehwmtxH5s6s6Jm24lIUf,G8EPVSXsOYB5YQWZGiz1aVq5Pgr2GrQu,6,8,3,0,2,0,2,0,15,2.142857142857143,1,0.0,3,3,0,2,5,0,0,2,0,8,7,1
7226,164169,g8GaCwXJUf6SPnVxk3h41vOpn1g2rMNj,G8EPVSXsOYB5YQWZGiz1aVq5Pgr2GrQu,25,19,13,20,5,5,11,1,74,10.571428571428571,2,0.0,0,13,18,5,19,5,2,11,1,36,38,1
7227,164174,CVy4kNAaUGvRYYQgXmKQWG6L2OSWreYS,SpATywNh6bZuzm8s1ceuBUnMUAeoAHHw,10,12,1,0,2,1,6,1,23,3.2857142857142856,2,0.0,3,1,0,2,9,1,0,6,1,6,17,1
7228,164183,w4DmyCRPmcVeeul1i1ztSEkbof1km1Nb,bWdj2GDclj5ofokWjzoa5jAwMkxCykd6,5,2,1,0,1,0,2,0,6,0.8571428571428571,1,0.0,0,1,0,1,2,0,0,2,0,2,4,1
7229,164193,ciqNol40it2TXmTV6HAJsQTHc113ipRy,bWdj2GDclj5ofokWjzoa5jAwMkxCykd6,10,24,7,56,5,0,10,0,102,14.571428571428571,2,0.0,11,7,56,5,13,0,0,10,0,79,23,1
7230,164194,nGALou9220OOdyTmGQUn7ZDRMR4UkSXJ,SpATywNh6bZuzm8s1ceuBUnMUAeoAHHw,13,5,4,0,3,0,6,1,19,2.7142857142857144,1,0.0,0,4,0,3,5,0,0,6,1,7,12,1
7231,164206,2YuUQch1UOdzblixrhGJqRyfiL57cYEN,RXDvfPUBYFlVdlueBFbLW0mhhAyGEqpt,2,0,0,0,0,0,2,0,2,0.2857142857142857,1,0.0,0,0,0,0,0,0,0,2,0,0,2,1
7232,164227,DSUKhhpRDohNouwSJME8rOv0HnE7IUjD,G8EPVSXsOYB5YQWZGiz1aVq5Pgr2GrQu,5,1,1,0,1,1,2,0,6,0.8571428571428571,1,0.0,0,1,0,1,1,1,0,2,0,2,4,1
7233,164233,kuZwBvEdgeUtKZ495C2FptBbxEtLtmVH,G8EPVSXsOYB5YQWZGiz1aVq5Pgr2GrQu,9,6,3,0,0,0,7,0,16,2.2857142857142856,2,0.0,0,3,0,0,6,0,0,7,0,3,13,1
7234,164239,puEuN6Xf1uW7cjSgYlTKI73OSHVfNsuZ,SpATywNh6bZuzm8s1ceuBUnMUAeoAHHw,13,12,6,0,4,8,5,1,36,5.142857142857143,1,0.0,5,6,0,4,7,8,0,5,1,15,21,1
7235,164242,wFvodFqghxL7iISMFbYXkYNq6P6eK5gH,bWdj2GDclj5ofokWjzoa5jAwMkxCykd6,1,0,0,0,0,0,2,0,2,0.2857142857142857,1,0.0,0,0,0,0,0,0,0,2,0,0,2,1
7236,164251,vBJL7coMRkaE4FxkSvahGksjBaWY15De,bWdj2GDclj5ofokWjzoa5jAwMkxCykd6,5,2,1,0,1,2,2,0,8,1.1428571428571428,1,0.0,0,1,0,1,2,2,0,2,0,2,6,1
7237,164258,Or6EoLeKHgxe5lrewrc5kj5wcFrtEOsX,G8EPVSXsOYB5YQWZGiz1aVq5Pgr2GrQu,16,20,5,34,2,0,3,0,64,9.142857142857142,4,0.0,2,5,29,2,18,0,5,3,0,38,26,1
7238,164264,Kch5WBTMofTOaqsqvrCwdJnTOQRJP2KH,RXDvfPUBYFlVdlueBFbLW0mhhAyGEqpt,8,5,4,0,2,0,1,0,12,1.7142857142857142,1,0.0,0,4,0,2,5,0,0,1,0,6,6,1
7239,164274,oTNjNy2VCNhMEHkpw5RoIwGj6ModXkSd,SpATywNh6bZuzm8s1ceuBUnMUAeoAHHw,8,2,2,0,2,0,5,0,11,1.5714285714285714,1,0.0,0,2,0,2,2,0,0,5,0,4,7,1
7240,164282,wBacPbVnOV4SRh0JUUHmWhDIds03R7aM,bWdj2GDclj5ofokWjzoa5jAwMkxCykd6,15,23,14,66,5,0,11,0,119,17.0,5,0.0,3,14,63,5,20,0,3,11,0,85,34,1
7241,164286,kargVzTieknsOD52RwWWxzR3bhPo7xCn,bWdj2GDclj5ofokWjzoa5jAwMkxCykd6,2,0,0,0,0,0,2,0,2,0.2857142857142857,1,0.0,0,0,0,0,0,0,0,2,0,0,2,1
7242,164289,OimNh540xAgKAtol4nYQSyjwRKBWvHjV,bWdj2GDclj5ofokWjzoa5jAwMkxCykd6,9,23,8,0,4,1,9,2,47,6.714285714285714,2,0.0,0,8,0,4,23,1,0,9,2,12,35,1
7243,164305,wm5eo4PFQKBWWCDwO21MewWgtJRcPge6,SpATywNh6bZuzm8s1ceuBUnMUAeoAHHw,9,8,5,0,3,1,8,2,27,3.857142857142857,2,0.0,0,5,0,3,8,1,0,8,2,8,19,1
7244,164309,kIQJn1ZGNZIZ21dizjiWH4EHSNMGXOiq,SpATywNh6bZuzm8s1ceuBUnMUAeoAHHw,6,2,1,0,1,0,3,0,7,1.0,1,0.0,0,1,0,1,2,0,0,3,0,2,5,1
7245,164315,cYibpCaMUGq0WjgUWfTv0iIvJ7QbFj5E,bWdj2GDclj5ofokWjzoa5jAwMkxCykd6,1,0,0,0,0,0,1,0,1,0.14285714285714285,1,0.0,0,0,0,0,0,0,0,1,0,0,1,0
7246,164330,5JojY8Vvgh7rjfcAS5764ZRMTC8fo9QP,G8EPVSXsOYB5YQWZGiz1aVq5Pgr2GrQu,21,31,0,36,1,0,4,0,72,10.285714285714286,1,0.0,15,0,28,1,16,0,8,4,0,44,28,1
7247,164370,K6SnVyYj4JLYSaBAXjv9gYLyrrnyqRP0,SpATywNh6bZuzm8s1ceuBUnMUAeoAHHw,4,0,0,0,0,1,5,0,6,0.8571428571428571,1,0.0,0,0,0,0,0,1,0,5,0,0,6,1
7248,164371,5fUv2a4WMEi2Bc60cQo0Uzo1I7SufPfI,RXDvfPUBYFlVdlueBFbLW0mhhAyGEqpt,21,26,0,52,1,15,9,6,109,15.571428571428571,2,0.0,6,0,48,1,20,15,4,9,6,55,54,1
7249,164373,HIaaOq9UrLvo3UC4FIJStVsYhdTvdkJ9,SpATywNh6bZuzm8s1ceuBUnMUAeoAHHw,10,12,0,10,0,0,5,0,27,3.857142857142857,1,0.0,3,0,8,0,9,0,2,5,0,11,16,1
7250,164374,ocTIjxG8zBs0mQRpUtpuAKc7MDpzU7Sd,bWdj2GDclj5ofokWjzoa5jAwMkxCykd6,19,19,8,34,6,19,14,0,100,14.285714285714286,2,0.0,8,8,30,6,11,19,4,14,0,52,48,0
7251,164380,V3KgKcJl8bgXAGMp5c8bz9HnZzQfd0IE,SpATywNh6bZuzm8s1ceuBUnMUAeoAHHw,22,35,17,6,9,9,4,0,80,11.428571428571429,2,0.0,0,17,5,9,35,9,1,4,0,31,49,1
7252,164385,zhF9aamFaaPbw8uvKpkg1m1HOa3rg91T,RXDvfPUBYFlVdlueBFbLW0mhhAyGEqpt,34,25,19,0,13,0,7,0,64,9.142857142857142,3,0.0,0,19,0,13,25,0,0,7,0,32,32,1
7253,164389,9XEvRIJ3KorQF4OT61u2doOr3f5pwaHZ,bWdj2GDclj5ofokWjzoa5jAwMkxCykd6,3,3,1,0,0,0,1,0,5,0.7142857142857143,1,0.0,0,1,0,0,3,0,0,1,0,1,4,1
7254,164392,vfnNYDz3ao0khQiXn6s0MRVTGqDcFM0x,bWdj2GDclj5ofokWjzoa5jAwMkxCykd6,5,5,0,0,1,0,3,1,10,1.4285714285714286,1,0.0,3,0,0,1,2,0,0,3,1,4,6,1
7255,164393,gh8ZFa6DAiOnR8V5MntcWerJGzv2wFJI,SpATywNh6bZuzm8s1ceuBUnMUAeoAHHw,15,24,9,4,5,3,5,0,50,7.142857142857143,2,0.0,10,9,4,5,14,3,0,5,0,28,22,1
7256,164397,xmv8WUz0fQb7fJNMHkcUN733RgAFZjFP,bWdj2GDclj5ofokWjzoa5jAwMkxCykd6,5,10,1,0,1,0,6,0,18,2.5714285714285716,1,0.0,2,1,0,1,8,0,0,6,0,4,14,1
7257,164398,0dNy0sRvDF0sROrAnnVZV2SWJaZTZV2q,SpATywNh6bZuzm8s1ceuBUnMUAeoAHHw,3,2,0,0,0,0,1,0,3,0.42857142857142855,1,0.0,0,0,0,0,2,0,0,1,0,0,3,1
7258,164408,O7I8HNg1rvyItYLfAtm0x1WuepktYnst,SpATywNh6bZuzm8s1ceuBUnMUAeoAHHw,8,11,4,0,4,1,1,0,21,3.0,1,0.0,0,4,0,4,11,1,0,1,0,8,13,1
7259,164422,svMXR8fHg4TBhSD6JDFH6qsNGvdxTr0h,RXDvfPUBYFlVdlueBFbLW0mhhAyGEqpt,11,7,0,0,0,2,8,1,18,2.5714285714285716,1,0.0,0,0,0,0,7,2,0,8,1,0,18,1
7260,164439,g61tiKR5XFhd8PF4WUyM648Aa5Kvlcf3,G8EPVSXsOYB5YQWZGiz1aVq5Pgr2GrQu,6,1,1,0,1,4,4,0,11,1.5714285714285714,2,0.0,0,1,0,1,1,4,0,4,0,2,9,1
7261,164459,viXqqg0vx2jNkZn6Nty7fAz4j4zmpVoE,SpATywNh6bZuzm8s1ceuBUnMUAeoAHHw,20,48,19,23,4,30,21,2,147,21.0,8,0.0,10,19,18,4,38,30,5,21,2,51,96,0
7262,164462,gD7dR7qYBA1tFY5jHEs9UR01plTA8iId,SpATywNh6bZuzm8s1ceuBUnMUAeoAHHw,15,28,12,11,5,2,3,0,61,8.714285714285714,2,0.0,5,12,10,5,23,2,1,3,0,32,29,0
7263,164463,aczUQgOO0ASt0xksHzYEHmyu3n5i1eK4,SpATywNh6bZuzm8s1ceuBUnMUAeoAHHw,10,14,8,0,4,0,8,0,34,4.857142857142857,1,0.0,3,8,0,4,11,0,0,8,0,15,19,1
7264,164464,Xg16SpIo3MJ3Q7kbAScLhtP5JZXXJDfv,SpATywNh6bZuzm8s1ceuBUnMUAeoAHHw,8,6,4,0,3,0,3,0,16,2.2857142857142856,1,0.0,0,4,0,3,6,0,0,3,0,7,9,1
7265,164465,viXqqg0vx2jNkZn6Nty7fAz4j4zmpVoE,G8EPVSXsOYB5YQWZGiz1aVq5Pgr2GrQu,13,14,6,0,5,0,2,0,27,3.857142857142857,1,0.0,0,6,0,5,14,0,0,2,0,11,16,1
7266,164466,4IAsFbl3b7m8BHNHwE02AfsOFCbBUG0L,SpATywNh6bZuzm8s1ceuBUnMUAeoAHHw,6,4,2,0,2,0,1,0,9,1.2857142857142858,1,0.0,1,2,0,2,3,0,0,1,0,5,4,1
7267,164470,XF7WFiRmBAV2t6CIl4aiymZi2mf5tiFp,SpATywNh6bZuzm8s1ceuBUnMUAeoAHHw,9,3,2,0,2,0,6,0,13,1.8571428571428572,1,0.0,0,2,0,2,3,0,0,6,0,4,9,1
7268,164490,c6KChK06Rh7fb4zwLQYLlfB5pAi9XDtG,bWdj2GDclj5ofokWjzoa5jAwMkxCykd6,8,4,4,0,4,0,3,0,15,2.142857142857143,1,0.0,0,4,0,4,4,0,0,3,0,8,7,1
7269,164493,hjoHxSgIY6b9g4BQWlz8arItNzc0bPJL,G8EPVSXsOYB5YQWZGiz1aVq5Pgr2GrQu,5,2,1,0,1,0,2,0,6,0.8571428571428571,1,0.0,0,1,0,1,2,0,0,2,0,2,4,1
7270,164502,gjOO3qwnQCAatqMKu7gZIW5sztiBAppS,SpATywNh6bZuzm8s1ceuBUnMUAeoAHHw,1,0,0,0,0,0,2,0,2,0.2857142857142857,2,0.0,0,0,0,0,0,0,0,2,0,0,2,1
7271,164506,uydIb4MWCn95KWcEhKwj3VRfjvxXo8Nj,RXDvfPUBYFlVdlueBFbLW0mhhAyGEqpt,6,4,3,0,0,0,2,0,9,1.2857142857142858,1,0.0,0,3,0,0,4,0,0,2,0,3,6,1
7272,164510,mMPoHvW2FNyPz9OBdiCmgMl0cCEFfarc,SpATywNh6bZuzm8s1ceuBUnMUAeoAHHw,10,19,6,0,4,5,3,0,37,5.285714285714286,1,0.0,5,6,0,4,14,5,0,3,0,15,22,1
7273,164511,uydIb4MWCn95KWcEhKwj3VRfjvxXo8Nj,G8EPVSXsOYB5YQWZGiz1aVq5Pgr2GrQu,5,3,2,0,0,0,2,0,7,1.0,1,0.0,0,2,0,0,3,0,0,2,0,2,5,1
7274,164512,Pkfxv8tlzjsegGEz3Xh7AUnCzKYEVDxE,bWdj2GDclj5ofokWjzoa5jAwMkxCykd6,6,4,2,0,1,0,3,0,10,1.4285714285714286,1,0.0,0,2,0,1,4,0,0,3,0,3,7,1
7275,164521,VKk9JpwG9p3VFd3uL9koumwFrK1tXoky,RXDvfPUBYFlVdlueBFbLW0mhhAyGEqpt,10,5,4,0,3,0,2,0,14,2.0,1,0.0,0,4,0,3,5,0,0,2,0,7,7,1
7276,164540,jPMuHTmaLyG60VmyNtfExbwyn5kE5j3d,bWdj2GDclj5ofokWjzoa5jAwMkxCykd6,1,0,0,0,0,0,1,0,1,0.14285714285714285,1,0.0,0,0,0,0,0,0,0,1,0,0,1,1
7277,164543,SFDSK6D3ITcq2gCqSV4NXsxobQMiKjKb,bWdj2GDclj5ofokWjzoa5jAwMkxCykd6,5,2,1,0,1,0,3,0,7,1.0,1,0.0,0,1,0,1,2,0,0,3,0,2,5,1
7278,164548,w7L1HWyOfKnPicf69CWEIAgi9ciJCz91,SpATywNh6bZuzm8s1ceuBUnMUAeoAHHw,11,12,1,12,0,0,3,1,29,4.142857142857143,1,0.0,7,1,10,0,5,0,2,3,1,18,11,1
7279,164549,uDLEkuBy3ymjXkWGDerrVKjWfVpjtLcy,SpATywNh6bZuzm8s1ceuBUnMUAeoAHHw,13,18,4,10,3,0,3,2,40,5.714285714285714,1,0.0,10,4,9,3,8,0,1,3,2,26,14,1
7280,164551,Cs1l7tXWhg4bHVkjgKntjzb2IwXtRhyR,RXDvfPUBYFlVdlueBFbLW0mhhAyGEqpt,5,2,1,0,1,0,3,0,7,1.0,1,0.0,0,1,0,1,2,0,0,3,0,2,5,1
7281,164563,PFKfwO5QSawWdwaylbr1GRPNNNfcQLNj,SpATywNh6bZuzm8s1ceuBUnMUAeoAHHw,23,31,13,22,9,6,16,1,98,14.0,3,0.0,13,13,17,9,18,6,5,16,1,52,46,1
7282,164564,ldTrxeIYDfkDUNaJhbVmYcQDlmvbdP2w,bWdj2GDclj5ofokWjzoa5jAwMkxCykd6,10,3,2,0,2,0,6,0,13,1.8571428571428572,1,0.0,0,2,0,2,3,0,0,6,0,4,9,1
7283,164569,p5rebimhkI0boSbnQg3KGGgWIQAEeFXU,SpATywNh6bZuzm8s1ceuBUnMUAeoAHHw,5,4,2,0,1,2,2,0,11,1.5714285714285714,1,0.0,0,2,0,1,4,2,0,2,0,3,8,1
7284,164572,Vlk2b9egCmW1kemn8Fl1v1olMRLDZnR0,SpATywNh6bZuzm8s1ceuBUnMUAeoAHHw,7,4,3,0,2,0,3,0,12,1.7142857142857142,1,0.0,0,3,0,2,4,0,0,3,0,5,7,1
7285,164577,LzbTNpWVn6fl2StGvYLxuW4MppuRwiQH,G8EPVSXsOYB5YQWZGiz1aVq5Pgr2GrQu,13,10,1,28,0,0,1,0,40,5.714285714285714,1,0.0,0,1,24,0,10,0,4,1,0,25,15,1
7286,164579,qo9UDSPYx7cYCq1gHLr348Aal9eXzAVb,SpATywNh6bZuzm8s1ceuBUnMUAeoAHHw,5,2,1,0,1,0,2,0,6,0.8571428571428571,1,0.0,0,1,0,1,2,0,0,2,0,2,4,1
7287,164584,cd5M4uWjG6TOaf0Pz31O3hIF99iIERs5,RXDvfPUBYFlVdlueBFbLW0mhhAyGEqpt,5,6,1,0,0,1,2,0,10,1.4285714285714286,2,0.0,2,1,0,0,4,1,0,2,0,3,7,1
7288,164589,sXsn7NeZRfEp7S6T00dl609YN1DnViK8,bWdj2GDclj5ofokWjzoa5jAwMkxCykd6,5,2,1,0,1,0,2,0,6,0.8571428571428571,1,0.0,0,1,0,1,2,0,0,2,0,2,4,1
7289,164590,JHnOuSquWHAEnk5XcKmxcm446qLMalAz,SpATywNh6bZuzm8s1ceuBUnMUAeoAHHw,13,32,12,15,9,1,7,0,76,10.857142857142858,1,0.0,9,12,14,9,23,1,1,7,0,44,32,0
7290,164593,SufYsQHcxz6kvXSXszQU44Defcxsd4P8,RXDvfPUBYFlVdlueBFbLW0mhhAyGEqpt,20,30,20,14,8,2,11,6,91,13.0,5,0.0,3,20,14,8,27,2,0,11,6,45,46,1
7291,164595,Mjc1uhwVJSwBIY7NCmz9HAIqxkVGiNWp,SpATywNh6bZuzm8s1ceuBUnMUAeoAHHw,1,0,0,0,0,0,1,0,1,0.14285714285714285,1,0.0,0,0,0,0,0,0,0,1,0,0,1,1
7292,164597,WI9rk8aS11tBAJzjcX0JSIgomYYRQVjW,G8EPVSXsOYB5YQWZGiz1aVq5Pgr2GrQu,4,3,1,0,1,0,1,0,6,0.8571428571428571,1,0.0,0,1,0,1,3,0,0,1,0,2,4,1
7293,164607,2TfX1z2kNH0aJpmX3zI7D0BaWO1JZh1N,G8EPVSXsOYB5YQWZGiz1aVq5Pgr2GrQu,7,2,1,0,1,2,3,0,9,1.2857142857142858,1,0.0,0,1,0,1,2,2,0,3,0,2,7,1
7294,164613,EBMQHva9lsULDK4s7iJrovR7inTeu6Ks,SpATywNh6bZuzm8s1ceuBUnMUAeoAHHw,14,20,8,11,5,0,2,0,46,6.571428571428571,2,0.0,7,8,9,5,13,0,2,2,0,29,17,1
7295,164627,rCsU9p98QKUXEKegYmRuzzYV8BmhIRdS,SpATywNh6bZuzm8s1ceuBUnMUAeoAHHw,1,0,0,0,0,0,1,0,1,0.14285714285714285,1,0.0,0,0,0,0,0,0,0,1,0,0,1,1
7296,164640,Oi8ENv1r0fh4xZfmyvx6AY0XCiLDaP57,SpATywNh6bZuzm8s1ceuBUnMUAeoAHHw,5,2,1,0,1,0,2,0,6,0.8571428571428571,1,0.0,0,1,0,1,2,0,0,2,0,2,4,1
7297,164641,mneYPOl2fXbFIQgZuY7V0tw2SDw7ktpW,SpATywNh6bZuzm8s1ceuBUnMUAeoAHHw,8,11,2,0,0,0,5,0,18,2.5714285714285716,3,0.0,0,2,0,0,11,0,0,5,0,2,16,1
7298,164643,YxEAEqB4R6GTRBWDvga1GWE0URAxGc6U,bWdj2GDclj5ofokWjzoa5jAwMkxCykd6,3,2,1,0,0,0,1,0,4,0.5714285714285714,1,0.0,0,1,0,0,2,0,0,1,0,1,3,1
7299,164646,iMWyVW74QNpkzwAJujvmKOU3siri8Fgn,RXDvfPUBYFlVdlueBFbLW0mhhAyGEqpt,21,22,9,15,9,0,3,0,58,8.285714285714286,2,0.0,11,9,15,9,11,0,0,3,0,44,14,1
7300,164653,NzAcUY76dhfwRLfnT8WUtgPXMkNyrCBL,SpATywNh6bZuzm8s1ceuBUnMUAeoAHHw,5,2,1,0,1,0,2,0,6,0.8571428571428571,1,0.0,0,1,0,1,2,0,0,2,0,2,4,1
7301,164659,xs8FwmyIICdFtTqViprbjnWxSS7J89Al,G8EPVSXsOYB5YQWZGiz1aVq5Pgr2GrQu,4,7,0,0,0,0,1,0,8,1.1428571428571428,1,0.0,3,0,0,0,4,0,0,1,0,3,5,1
7302,164660,yqw7ro5WJlrZH88vsKBmg60OfoWnl19q,SpATywNh6bZuzm8s1ceuBUnMUAeoAHHw,6,6,2,0,2,0,2,0,12,1.7142857142857142,2,0.0,0,2,0,2,6,0,0,2,0,4,8,1
7303,164673,5HX4czL6Sp8ee3UX2kWAHqmFW5CMMTjE,SpATywNh6bZuzm8s1ceuBUnMUAeoAHHw,1,0,0,0,0,0,1,0,1,0.14285714285714285,1,0.0,0,0,0,0,0,0,0,1,0,0,1,1
7304,164676,3SCBHiEI4HvwPrOQDNTIAqp1rZOAx5IK,SpATywNh6bZuzm8s1ceuBUnMUAeoAHHw,13,11,6,16,3,0,3,0,39,5.571428571428571,2,0.0,3,6,14,3,8,0,2,3,0,26,13,1
7305,164679,3SCBHiEI4HvwPrOQDNTIAqp1rZOAx5IK,G8EPVSXsOYB5YQWZGiz1aVq5Pgr2GrQu,27,9,5,142,0,0,5,0,161,23.0,3,0.0,0,5,124,0,9,0,18,5,0,129,32,1
7306,164683,RLJL0sLgyeMOTE7yAIublGPUVoAHuvDx,G8EPVSXsOYB5YQWZGiz1aVq5Pgr2GrQu,18,17,16,20,10,0,2,0,65,9.285714285714286,1,0.0,0,16,16,10,17,0,4,2,0,42,23,1
7307,164692,yc3vj6DBU7J8xD482LnMAUcmHp7gOl84,SpATywNh6bZuzm8s1ceuBUnMUAeoAHHw,1,0,0,0,0,0,3,0,3,0.42857142857142855,2,0.0,0,0,0,0,0,0,0,3,0,0,3,1
7308,164727,caSt06ZROuiH9pArEzpLM7jwlm2pIP8u,SpATywNh6bZuzm8s1ceuBUnMUAeoAHHw,1,0,0,0,0,0,3,0,3,0.42857142857142855,1,0.0,0,0,0,0,0,0,0,3,0,0,3,1
7309,164748,m5oXLk5fStXUe1mP1ujV3P2Gk727qBkB,SpATywNh6bZuzm8s1ceuBUnMUAeoAHHw,1,0,0,0,0,0,1,0,1,0.14285714285714285,1,0.0,0,0,0,0,0,0,0,1,0,0,1,1
7310,164756,tedGThhHMqVARfBh6zyzyocTKbTJYJpB,RXDvfPUBYFlVdlueBFbLW0mhhAyGEqpt,5,3,2,0,0,0,2,0,7,1.0,1,0.0,0,2,0,0,3,0,0,2,0,2,5,1
7311,164761,DhCQzcFGsfZK6cdFiI5FQU3kb44TMCVX,SpATywNh6bZuzm8s1ceuBUnMUAeoAHHw,3,0,0,0,0,1,2,0,3,0.42857142857142855,1,0.0,0,0,0,0,0,1,0,2,0,0,3,1
7312,164774,ztw81mUsVcWqQkxlUbURYmOFyO40Z11S,SpATywNh6bZuzm8s1ceuBUnMUAeoAHHw,1,0,0,0,0,0,1,0,1,0.14285714285714285,1,0.0,0,0,0,0,0,0,0,1,0,0,1,1
7313,164777,VGDu6m0Ea8YNSzlZeUPCdOS7FC8K56j0,SpATywNh6bZuzm8s1ceuBUnMUAeoAHHw,12,23,10,19,4,0,6,0,62,8.857142857142858,4,0.0,2,10,16,4,21,0,3,6,0,32,30,1
7314,164782,AZ1a6e6HDgHh4sN10TmubQgIG7lRhvX7,bWdj2GDclj5ofokWjzoa5jAwMkxCykd6,3,3,1,0,0,1,1,0,6,0.8571428571428571,1,0.0,0,1,0,0,3,1,0,1,0,1,5,1
7315,164783,HNOiqLBLlemqEjDq99MX1KCbGHtf7sfC,SpATywNh6bZuzm8s1ceuBUnMUAeoAHHw,6,4,2,0,1,1,5,0,13,1.8571428571428572,2,0.0,0,2,0,1,4,1,0,5,0,3,10,1
7316,164784,vuyiZXIHubBxUI6I8fEoaPJZI5irtStd,SpATywNh6bZuzm8s1ceuBUnMUAeoAHHw,12,22,16,0,10,1,7,2,58,8.285714285714286,2,0.0,2,16,0,10,20,1,0,7,2,28,30,1
7317,164789,0drSvAjmQGn3JsM9rLj67sU9ycFdNRi4,SpATywNh6bZuzm8s1ceuBUnMUAeoAHHw,5,13,0,0,1,0,1,0,15,2.142857142857143,2,0.0,3,0,0,1,10,0,0,1,0,4,11,1
7318,164810,j9RRCN4Cgg3M5ymRYEPqwWpJ0OwCWsXl,G8EPVSXsOYB5YQWZGiz1aVq5Pgr2GrQu,1,0,0,0,0,0,1,0,1,0.14285714285714285,1,0.0,0,0,0,0,0,0,0,1,0,0,1,1
7319,164876,jqdafBVztOaU7B8oBuajiXxvz1FDItGv,SpATywNh6bZuzm8s1ceuBUnMUAeoAHHw,1,0,0,0,0,0,1,0,1,0.14285714285714285,1,0.0,0,0,0,0,0,0,0,1,0,0,1,1
7320,164881,R7ptDQN35cKkqrWYU1EoWDk89h01yGje,RXDvfPUBYFlVdlueBFbLW0mhhAyGEqpt,1,0,0,0,0,0,1,0,1,0.14285714285714285,1,0.0,0,0,0,0,0,0,0,1,0,0,1,1
7321,164889,DivG3ogmCJeK3pKkDuguqXmAxv3265HB,bWdj2GDclj5ofokWjzoa5jAwMkxCykd6,8,11,1,0,2,0,10,0,24,3.4285714285714284,2,0.0,2,1,0,2,9,0,0,10,0,5,19,1
7322,164895,fr5elk998a9p9TdUbECrRSQ9rGDS8c9D,SpATywNh6bZuzm8s1ceuBUnMUAeoAHHw,3,0,0,0,0,1,2,0,3,0.42857142857142855,1,0.0,0,0,0,0,0,1,0,2,0,0,3,1
7323,164900,vqI4nA1oYdvinhdwhAimFfTLZs6qGSC5,G8EPVSXsOYB5YQWZGiz1aVq5Pgr2GrQu,8,6,2,4,2,0,2,0,16,2.2857142857142856,1,0.0,3,2,3,2,3,0,1,2,0,10,6,1
7324,164909,DttwjifTB7tngrOzE4lsIB8DzMDnSPZc,SpATywNh6bZuzm8s1ceuBUnMUAeoAHHw,8,2,1,0,1,1,6,1,12,1.7142857142857142,1,0.0,0,1,0,1,2,1,0,6,1,2,10,0
7325,164914,VAF0Nhm4Uogjf17s6SveryaIcEEMWJow,SpATywNh6bZuzm8s1ceuBUnMUAeoAHHw,6,7,2,0,2,0,2,0,13,1.8571428571428572,2,0.0,0,2,0,2,7,0,0,2,0,4,9,1
7326,164918,R7wdnz7rd7yU47Qq2pD3NnafkKkL5gzl,bWdj2GDclj5ofokWjzoa5jAwMkxCykd6,3,2,0,0,0,0,1,0,3,0.42857142857142855,1,0.0,0,0,0,0,2,0,0,1,0,0,3,1
7327,164919,re5aCokPT0KNmuJHbgQvisAT0CcTxib5,SpATywNh6bZuzm8s1ceuBUnMUAeoAHHw,7,5,1,0,1,0,3,0,10,1.4285714285714286,2,0.0,0,1,0,1,5,0,0,3,0,2,8,1
7328,164922,JYJhzhhLcfWnYO62UZR1KbHHs0q9wRVk,bWdj2GDclj5ofokWjzoa5jAwMkxCykd6,13,18,12,0,11,5,14,3,63,9.0,3,0.0,0,12,0,11,18,5,0,14,3,23,40,1
7329,164923,Zoez9P6Io2KASPtKsQZfhyeC8nEU9r7r,SpATywNh6bZuzm8s1ceuBUnMUAeoAHHw,9,3,2,0,2,1,6,0,14,2.0,1,0.0,0,2,0,2,3,1,0,6,0,4,10,1
7330,164927,qr1Y8xuPrcpdzScNHYsirGXqasfUdOVa,bWdj2GDclj5ofokWjzoa5jAwMkxCykd6,8,10,6,0,3,1,8,0,28,4.0,2,0.0,0,6,0,3,10,1,0,8,0,9,19,1
7331,164937,i39wrwOFUT4cBFVx9tMMQ3lQ2qJwZK9W,G8EPVSXsOYB5YQWZGiz1aVq5Pgr2GrQu,4,7,1,0,0,0,2,0,10,1.4285714285714286,1,0.0,0,1,0,0,7,0,0,2,0,1,9,1
7332,164942,OOJh2Yrr6RQf9QAHFBo7EBzeZ2OAmLfw,bWdj2GDclj5ofokWjzoa5jAwMkxCykd6,5,5,2,0,1,0,2,0,10,1.4285714285714286,2,0.0,0,2,0,1,5,0,0,2,0,3,7,1
7333,164944,stWyUqkAGnjcutkepILPjL3dk2mkjbHM,SpATywNh6bZuzm8s1ceuBUnMUAeoAHHw,1,0,0,0,0,0,1,0,1,0.14285714285714285,1,0.0,0,0,0,0,0,0,0,1,0,0,1,1
7334,164953,8lCrBaMkcXk8KsL7M8AYgjnsyFuSP4yK,RXDvfPUBYFlVdlueBFbLW0mhhAyGEqpt,9,10,7,0,3,0,3,0,23,3.2857142857142856,2,0.0,0,7,0,3,10,0,0,3,0,10,13,1
7335,164975,QWhWii7LiCaC2aGmlsc9abDahkygX2yj,RXDvfPUBYFlVdlueBFbLW0mhhAyGEqpt,35,54,1,52,16,6,15,2,146,20.857142857142858,3,0.0,39,1,52,16,15,6,0,15,2,108,38,1
7336,164977,PEXlBba7AOVIBit4NUGVqaiGwqnJFccE,SpATywNh6bZuzm8s1ceuBUnMUAeoAHHw,7,2,1,0,1,1,6,7,18,2.5714285714285716,1,0.0,0,1,0,1,2,1,0,6,7,2,16,1
7337,164986,lOmRRXGlwgiYmSj7mCzKIIlzTAddACO4,G8EPVSXsOYB5YQWZGiz1aVq5Pgr2GrQu,5,3,0,0,0,0,2,0,5,0.7142857142857143,1,0.0,0,0,0,0,3,0,0,2,0,0,5,1
7338,164996,jXdIWOuPNFgWCy1owZ0YCDgHmNjNpxj3,A3fsA9Zfv1X2fVEQhTw51lKENdNrEqT3,1,0,0,0,0,0,1,0,1,0.14285714285714285,1,0.0,0,0,0,0,0,0,0,1,0,0,1,1
7339,165010,vl5hKvQ1HbHB8mWdynets5dYianhkkEw,SpATywNh6bZuzm8s1ceuBUnMUAeoAHHw,23,26,2,41,1,2,8,0,80,11.428571428571429,1,0.0,9,2,34,1,17,2,7,8,0,46,34,1
7340,165032,KAsAnmW0W2sAx9iOumNKdePG23m5o5NZ,G8EPVSXsOYB5YQWZGiz1aVq5Pgr2GrQu,5,2,1,0,1,0,2,0,6,0.8571428571428571,1,0.0,0,1,0,1,2,0,0,2,0,2,4,1
7341,165033,YtmzH8LgN5OvtPELquH1F749iO0gQ3Tb,A3fsA9Zfv1X2fVEQhTw51lKENdNrEqT3,2,0,0,0,0,0,2,0,2,0.2857142857142857,1,0.0,0,0,0,0,0,0,0,2,0,0,2,1
7342,165036,qLiLNfiu26gzDxiYwA4Ap7WJgGvbO54T,G8EPVSXsOYB5YQWZGiz1aVq5Pgr2GrQu,18,11,10,18,9,0,1,0,49,7.0,1,0.0,0,10,14,9,11,0,4,1,0,33,16,1
7343,165060,YroV7xThop5SUet6C6S1SEBaTvc7XX29,bWdj2GDclj5ofokWjzoa5jAwMkxCykd6,4,2,1,0,1,0,1,0,5,0.7142857142857143,1,0.0,0,1,0,1,2,0,0,1,0,2,3,1
7344,165071,gW23nkmgj3NMln4Q9bQA0x4tJhRu8aiU,SpATywNh6bZuzm8s1ceuBUnMUAeoAHHw,16,25,11,16,6,0,10,1,69,9.857142857142858,1,0.0,6,11,15,6,19,0,1,10,1,38,31,1
7345,165081,L0W17t6QNDHcTTYTnmTQY5Vw4L806sfw,SpATywNh6bZuzm8s1ceuBUnMUAeoAHHw,9,7,5,0,3,0,3,0,18,2.5714285714285716,2,0.0,0,5,0,3,7,0,0,3,0,8,10,1
7346,165092,HA5bOUyNRCHCSCRIajqqX7k2ZeKuADcF,A3fsA9Zfv1X2fVEQhTw51lKENdNrEqT3,1,0,0,0,0,0,1,0,1,0.14285714285714285,1,0.0,0,0,0,0,0,0,0,1,0,0,1,1
7347,165093,S58o7T8J2JcEBTi3bdMATXeMdhJbXqYq,A3fsA9Zfv1X2fVEQhTw51lKENdNrEqT3,3,0,0,0,0,0,4,0,4,0.5714285714285714,1,0.0,0,0,0,0,0,0,0,4,0,0,4,1
7348,165099,eSLdnCsz2kfsBjZ0LZmqHuo4kYNor6E7,SpATywNh6bZuzm8s1ceuBUnMUAeoAHHw,20,22,1,17,0,7,3,0,50,7.142857142857143,1,0.0,6,1,17,0,16,7,0,3,0,24,26,1
7349,165101,RdxIloCKNwZUjAJCbmYybZmkq8rwh2UY,bWdj2GDclj5ofokWjzoa5jAwMkxCykd6,4,2,1,0,1,0,1,0,5,0.7142857142857143,1,0.0,0,1,0,1,2,0,0,1,0,2,3,1
7350,165138,iqnxkAIvXEPq7LutRrGOzst5meEvTsYz,SpATywNh6bZuzm8s1ceuBUnMUAeoAHHw,15,13,5,1,4,0,8,0,31,4.428571428571429,3,0.0,5,5,1,4,8,0,0,8,0,15,16,1
7351,165145,DSvps80WgA0EgfU877YLgHsnaYGMmkvB,SpATywNh6bZuzm8s1ceuBUnMUAeoAHHw,8,3,2,0,2,7,3,1,18,2.5714285714285716,1,0.0,0,2,0,2,3,7,0,3,1,4,14,1
7352,165151,CXDFvBGg10x2RDdl5BC09Fv76dN9FJm7,G8EPVSXsOYB5YQWZGiz1aVq5Pgr2GrQu,18,25,11,16,3,2,2,0,59,8.428571428571429,2,0.0,7,11,9,3,18,2,7,2,0,30,29,1
7353,165162,5VFQZe1xiEoGXldz0K3uPFcNAeVpHehR,SpATywNh6bZuzm8s1ceuBUnMUAeoAHHw,10,4,4,0,3,0,4,0,15,2.142857142857143,1,0.0,0,4,0,3,4,0,0,4,0,7,8,1
7354,165188,3G9snyduwX0rdXWU1KviPhf7GghlChs3,RXDvfPUBYFlVdlueBFbLW0mhhAyGEqpt,10,12,7,0,1,4,11,0,35,5.0,1,0.0,0,7,0,1,12,4,0,11,0,8,27,1
7355,165191,gR8vpBOtEmg1p0U3mlFoyPZ2gKmD8M8k,A3fsA9Zfv1X2fVEQhTw51lKENdNrEqT3,1,0,0,0,0,0,1,0,1,0.14285714285714285,1,0.0,0,0,0,0,0,0,0,1,0,0,1,1
7356,165219,wxXN8RNX3CwZNnolATAAIEVSki3SPiEo,SpATywNh6bZuzm8s1ceuBUnMUAeoAHHw,2,0,0,0,0,0,2,0,2,0.2857142857142857,1,0.0,0,0,0,0,0,0,0,2,0,0,2,1
7357,165237,gKv0B6A68Wpl10k5COv8OtVYBXqYOYRH,SpATywNh6bZuzm8s1ceuBUnMUAeoAHHw,1,0,0,0,0,0,1,0,1,0.14285714285714285,1,0.0,0,0,0,0,0,0,0,1,0,0,1,1
7358,165253,muJ6MIRhOdDL6SrbHsZ7Ks5a50Iz9AeC,bWdj2GDclj5ofokWjzoa5jAwMkxCykd6,5,2,1,0,1,0,2,0,6,0.8571428571428571,1,0.0,0,1,0,1,2,0,0,2,0,2,4,0
7359,165271,jcO499WyDjlHOvUgk4ks7QVYWjH4e9LQ,SpATywNh6bZuzm8s1ceuBUnMUAeoAHHw,1,0,0,0,0,0,1,0,1,0.14285714285714285,1,0.0,0,0,0,0,0,0,0,1,0,0,1,1
7360,165281,GFb1F59UyYIHTp4jDg01zdNYbr3jH9yn,SpATywNh6bZuzm8s1ceuBUnMUAeoAHHw,11,5,3,0,2,3,8,2,23,3.2857142857142856,1,0.0,0,3,0,2,5,3,0,8,2,5,18,1
7361,165285,GFb1F59UyYIHTp4jDg01zdNYbr3jH9yn,A3fsA9Zfv1X2fVEQhTw51lKENdNrEqT3,1,0,0,0,0,0,1,0,1,0.14285714285714285,1,0.0,0,0,0,0,0,0,0,1,0,0,1,1
7362,165290,ACy24Kiib1ICxyQzhy0EUbYqbqlHiujI,bWdj2GDclj5ofokWjzoa5jAwMkxCykd6,10,8,3,0,2,1,4,1,19,2.7142857142857144,1,0.0,0,3,0,2,8,1,0,4,1,5,14,1
7363,165308,FGZPr41giRou6aZ5USTD1C0RRSJGXFKn,G8EPVSXsOYB5YQWZGiz1aVq5Pgr2GrQu,8,7,3,0,2,0,2,0,14,2.0,1,0.0,0,3,0,2,7,0,0,2,0,5,9,1
7364,165339,LOR1iUTDul78F0nRew73RCh87CQAgj7q,SpATywNh6bZuzm8s1ceuBUnMUAeoAHHw,1,0,0,0,0,0,1,0,1,0.14285714285714285,1,0.0,0,0,0,0,0,0,0,1,0,0,1,1
7365,165347,oaoj9be4jW2Hot8wYgYrzLRvB0RU4KYy,RXDvfPUBYFlVdlueBFbLW0mhhAyGEqpt,5,6,3,0,1,0,3,0,13,1.8571428571428572,3,0.0,0,3,0,1,6,0,0,3,0,4,9,1
7366,165351,5NsbP59FWlyl4NFONUzt3drLLr5EFRFj,SpATywNh6bZuzm8s1ceuBUnMUAeoAHHw,2,0,0,0,0,0,2,0,2,0.2857142857142857,1,0.0,0,0,0,0,0,0,0,2,0,0,2,1
7367,165355,gmPDrqW0AqIaoYWNfDXV8E4PTJ0tnkbT,SpATywNh6bZuzm8s1ceuBUnMUAeoAHHw,10,4,3,0,1,5,8,1,22,3.142857142857143,1,0.0,0,3,0,1,4,5,0,8,1,4,18,1
7368,165387,eXv6ACzt62C4hMSoDSIQMvmz4LEnGBtm,bWdj2GDclj5ofokWjzoa5jAwMkxCykd6,6,4,3,0,2,0,2,0,11,1.5714285714285714,1,0.0,0,3,0,2,4,0,0,2,0,5,6,1
7369,165391,4BWY4WoZwowebQpACrizuzaSUpqFUPYV,SpATywNh6bZuzm8s1ceuBUnMUAeoAHHw,7,2,0,0,0,1,8,2,13,1.8571428571428572,1,0.0,0,0,0,0,2,1,0,8,2,0,13,1
7370,165395,wJflvpFe05Aoyiv7JkqhQs7iDcvnIpoZ,SpATywNh6bZuzm8s1ceuBUnMUAeoAHHw,3,0,0,0,0,0,4,0,4,0.5714285714285714,1,0.0,0,0,0,0,0,0,0,4,0,0,4,1
7371,165397,4BWY4WoZwowebQpACrizuzaSUpqFUPYV,RXDvfPUBYFlVdlueBFbLW0mhhAyGEqpt,1,0,0,0,0,0,2,0,2,0.2857142857142857,1,0.0,0,0,0,0,0,0,0,2,0,0,2,1
7372,165408,PpFcLwYNJUnxth5yje9ruR1epB1qasdR,G8EPVSXsOYB5YQWZGiz1aVq5Pgr2GrQu,1,0,0,0,0,0,1,0,1,0.14285714285714285,1,0.0,0,0,0,0,0,0,0,1,0,0,1,1
7373,165416,7gfKKxmAEuUaewGGeFJgV5nEPJNQy1ri,bWdj2GDclj5ofokWjzoa5jAwMkxCykd6,6,3,1,0,1,0,2,0,7,1.0,1,0.0,0,1,0,1,3,0,0,2,0,2,5,1
7374,165421,MuPHXkwjCSwz1RoycqAjYJvCwPC5fRHQ,SpATywNh6bZuzm8s1ceuBUnMUAeoAHHw,4,2,0,0,0,0,3,0,5,0.7142857142857143,1,0.0,0,0,0,0,2,0,0,3,0,0,5,0
7375,165424,unnmDTt6VikDSSld76xj3NnZu4moxEml,SpATywNh6bZuzm8s1ceuBUnMUAeoAHHw,4,2,1,0,1,0,1,0,5,0.7142857142857143,1,0.0,0,1,0,1,2,0,0,1,0,2,3,1
7376,165443,Q9be6Sv8ddFyvZit7vIIJ8yY710RxCDU,A3fsA9Zfv1X2fVEQhTw51lKENdNrEqT3,2,0,0,0,0,0,3,0,3,0.42857142857142855,1,0.0,0,0,0,0,0,0,0,3,0,0,3,1
7377,165466,mURbRAHPKPnW9MwIb0RLcTIXqQNH7qbA,G8EPVSXsOYB5YQWZGiz1aVq5Pgr2GrQu,8,4,3,4,2,0,1,0,14,2.0,1,0.0,0,3,3,2,4,0,1,1,0,8,6,1
7378,165471,zrTXSfdUWbNWByIycayXKhWX2nhPdOah,SpATywNh6bZuzm8s1ceuBUnMUAeoAHHw,5,3,2,0,2,0,2,0,9,1.2857142857142858,1,0.0,0,2,0,2,3,0,0,2,0,4,5,1
7379,165474,ef55znmweQJrijlI0fO1Ekc271nZnV0m,bWdj2GDclj5ofokWjzoa5jAwMkxCykd6,4,0,0,0,0,0,3,1,4,0.5714285714285714,1,0.0,0,0,0,0,0,0,0,3,1,0,4,1
7380,165476,wg9kzusa79hS4fFC5hU9Laht66GWJcDA,SpATywNh6bZuzm8s1ceuBUnMUAeoAHHw,2,0,0,0,0,0,2,0,2,0.2857142857142857,1,0.0,0,0,0,0,0,0,0,2,0,0,2,1
7381,165480,u8gc5TatjVTaxEyEUtNlqAAFJuTBFyST,SpATywNh6bZuzm8s1ceuBUnMUAeoAHHw,1,0,0,0,0,0,1,0,1,0.14285714285714285,1,0.0,0,0,0,0,0,0,0,1,0,0,1,1
7382,165494,kVwgJQqzaO15lvZkwwinpycbi4tCASRL,G8EPVSXsOYB5YQWZGiz1aVq5Pgr2GrQu,17,23,3,18,4,13,2,1,64,9.142857142857142,1,0.0,15,3,10,4,8,13,8,2,1,32,32,1
7383,165498,khqyesGKZx6MpifmBhKg4XXFdITB5Rat,bWdj2GDclj5ofokWjzoa5jAwMkxCykd6,2,0,0,0,0,0,2,0,2,0.2857142857142857,1,0.0,0,0,0,0,0,0,0,2,0,0,2,1
7384,165517,K96pKWxanyeEDM8caXTjQInVlZNIUXf3,SpATywNh6bZuzm8s1ceuBUnMUAeoAHHw,25,19,9,19,6,15,11,2,81,11.571428571428571,2,0.0,7,9,16,6,12,15,3,11,2,38,43,1
7385,165533,CTzsOL49UPUArAP2sAfnnQhe79FdliFF,A3fsA9Zfv1X2fVEQhTw51lKENdNrEqT3,7,8,1,0,1,0,2,0,12,1.7142857142857142,1,0.0,2,1,0,1,6,0,0,2,0,4,8,1
7386,165544,cLRv4oHsLxWfkE6gs4eN6fO5y0RK8Odw,SpATywNh6bZuzm8s1ceuBUnMUAeoAHHw,21,22,3,23,1,0,5,0,54,7.714285714285714,2,0.0,7,3,22,1,15,0,1,5,0,33,21,1
7387,165551,8HRO39ObdbulUBajMG3YAwK0YHdJtgkL,SpATywNh6bZuzm8s1ceuBUnMUAeoAHHw,13,19,5,20,2,0,1,0,47,6.714285714285714,1,0.0,10,5,17,2,9,0,3,1,0,34,13,1
7388,165561,31ac9IJz27HinkIEt0yrmmYrar7i8NEX,SpATywNh6bZuzm8s1ceuBUnMUAeoAHHw,1,0,0,0,0,0,1,0,1,0.14285714285714285,1,0.0,0,0,0,0,0,0,0,1,0,0,1,1
7389,165574,JfftjOGdDbpgbrupi0Gwr899R0jzXikJ,G8EPVSXsOYB5YQWZGiz1aVq5Pgr2GrQu,17,18,10,0,5,2,9,1,45,6.428571428571429,4,0.0,0,10,0,5,18,2,0,9,1,15,30,1
7390,165575,8aKlO5cCI4yOnqtrz5S83gXv1equhodS,G8EPVSXsOYB5YQWZGiz1aVq5Pgr2GrQu,8,8,2,0,3,0,3,0,16,2.2857142857142856,1,0.0,6,2,0,3,2,0,0,3,0,11,5,1
7391,165579,L1KQaJmsFUgy5JpGUsnj3yIIihvD4WWY,SpATywNh6bZuzm8s1ceuBUnMUAeoAHHw,7,10,5,0,2,0,2,0,19,2.7142857142857144,1,0.0,3,5,0,2,7,0,0,2,0,10,9,1
7392,165580,qoIGs6RP8XMC5yN9VowJtSVp77FsPrRk,bWdj2GDclj5ofokWjzoa5jAwMkxCykd6,16,16,8,4,6,1,6,4,45,6.428571428571429,2,0.0,1,8,4,6,15,1,0,6,4,19,26,1
7393,165594,JlrarspOUiM43Q1LxxzJX6UJ5zQZ4pa3,G8EPVSXsOYB5YQWZGiz1aVq5Pgr2GrQu,4,2,1,0,1,0,1,0,5,0.7142857142857143,1,0.0,0,1,0,1,2,0,0,1,0,2,3,1
7394,165631,GEZRjwL8K0Izm01jtEreajWlGeO5rHqg,SpATywNh6bZuzm8s1ceuBUnMUAeoAHHw,10,9,3,22,1,0,5,0,40,5.714285714285714,2,0.0,3,3,18,1,6,0,4,5,0,25,15,1
7395,165637,OLNUzQUHvlNsi2WFlH5eEyaieqKXrEz7,G8EPVSXsOYB5YQWZGiz1aVq5Pgr2GrQu,1,0,0,0,0,0,1,0,1,0.14285714285714285,1,0.0,0,0,0,0,0,0,0,1,0,0,1,1
7396,165660,Jxd0Gyi2eFjuuzujg1eSA5QBX1QonMfb,A3fsA9Zfv1X2fVEQhTw51lKENdNrEqT3,8,8,7,0,7,0,4,0,26,3.7142857142857144,1,0.0,0,7,0,7,8,0,0,4,0,14,12,1
7397,165668,e4SJlWpUdMlW0LkwuTE29pgj3noS6rgx,SpATywNh6bZuzm8s1ceuBUnMUAeoAHHw,1,0,0,0,0,0,2,0,2,0.2857142857142857,2,0.0,0,0,0,0,0,0,0,2,0,0,2,1
7398,165670,ec1LcdXAjzvm4pz4UlXIURCzEb68OOjY,SpATywNh6bZuzm8s1ceuBUnMUAeoAHHw,1,0,0,0,0,0,1,0,1,0.14285714285714285,1,0.0,0,0,0,0,0,0,0,1,0,0,1,0
7399,165671,ldzbIC4VdNsM8t2O505cyUmYK0rWwYfY,bWdj2GDclj5ofokWjzoa5jAwMkxCykd6,5,0,0,0,0,0,4,1,5,0.7142857142857143,1,0.0,0,0,0,0,0,0,0,4,1,0,5,1
7400,165674,q8fKbbyHDwglzqbsTcqtDnNuKFFWoakG,SpATywNh6bZuzm8s1ceuBUnMUAeoAHHw,5,2,1,0,1,0,2,0,6,0.8571428571428571,1,0.0,0,1,0,1,2,0,0,2,0,2,4,1
7401,165687,rzRsiRIy5S5PJ3F6R6iAFiLgtXERTKGk,SpATywNh6bZuzm8s1ceuBUnMUAeoAHHw,12,16,9,0,2,1,5,1,34,4.857142857142857,1,0.0,0,9,0,2,16,1,0,5,1,11,23,1
7402,165704,aBWIo3Zb0x1GrHxSSFQ0sr4ViufznfA6,bWdj2GDclj5ofokWjzoa5jAwMkxCykd6,2,0,0,0,0,0,5,0,5,0.7142857142857143,2,0.0,0,0,0,0,0,0,0,5,0,0,5,0
7403,165720,EelpZh5xWl6mtPCPTTMGh3oiYl9f9eIu,SpATywNh6bZuzm8s1ceuBUnMUAeoAHHw,4,3,2,0,0,0,1,0,6,0.8571428571428571,1,0.0,0,2,0,0,3,0,0,1,0,2,4,1
7404,165753,K7gxH2H2bYXoDZcS1lp3t0a4OCfbOLwQ,bWdj2GDclj5ofokWjzoa5jAwMkxCykd6,6,1,1,0,1,0,5,0,8,1.1428571428571428,1,0.0,0,1,0,1,1,0,0,5,0,2,6,1
7405,165754,K6ObBSwI3jvthL8D7fF5vG4yQ857Kh2f,SpATywNh6bZuzm8s1ceuBUnMUAeoAHHw,1,0,0,0,0,0,1,0,1,0.14285714285714285,1,0.0,0,0,0,0,0,0,0,1,0,0,1,1
7406,165767,hbzbE3YW3TFJZGn3KQWHVTTu9qGbrE8v,bWdj2GDclj5ofokWjzoa5jAwMkxCykd6,5,2,1,0,1,0,2,0,6,0.8571428571428571,1,0.0,0,1,0,1,2,0,0,2,0,2,4,1
7407,165772,HpI5z92WE9TCj3JyfZi0b0yrE9hT84vs,A3fsA9Zfv1X2fVEQhTw51lKENdNrEqT3,1,0,0,0,0,0,1,0,1,0.14285714285714285,1,0.0,0,0,0,0,0,0,0,1,0,0,1,1
7408,165774,OOTqWE5x0MzBGyALni92jmdLSQIdjajZ,G8EPVSXsOYB5YQWZGiz1aVq5Pgr2GrQu,5,4,1,0,0,0,3,0,8,1.1428571428571428,1,0.0,0,1,0,0,4,0,0,3,0,1,7,1
7409,165784,rh0SgumcqbNnCp7Kv0VptrPMVPtrWDm8,RXDvfPUBYFlVdlueBFbLW0mhhAyGEqpt,1,0,0,0,0,0,1,0,1,0.14285714285714285,1,0.0,0,0,0,0,0,0,0,1,0,0,1,1
7410,165796,0Au7FrQGJI1dB5PAH0C5RtkL9GE7xsrQ,G8EPVSXsOYB5YQWZGiz1aVq5Pgr2GrQu,2,0,0,0,0,0,2,0,2,0.2857142857142857,1,0.0,0,0,0,0,0,0,0,2,0,0,2,1
7411,165809,Be8IM2i8TFABf4hrPs9xmqBicVH2EMoi,SpATywNh6bZuzm8s1ceuBUnMUAeoAHHw,5,2,1,0,1,0,2,0,6,0.8571428571428571,1,0.0,0,1,0,1,2,0,0,2,0,2,4,1
7412,165923,Ae22hvALqv0MxUz0BtfyFRCZH8Unzasl,fbPkOYLVPtPgIt0MxizjfFJov3JbHyAi,9,6,2,0,1,0,4,0,13,1.8571428571428572,1,0.0,0,2,0,1,6,0,0,4,0,3,10,1
7413,165924,g4PsrTaWbf4PyAkwCyr7KPRrkKd1GQUF,fbPkOYLVPtPgIt0MxizjfFJov3JbHyAi,47,85,55,27,42,0,7,0,216,30.857142857142858,1,0.0,22,55,19,42,63,0,8,7,0,138,78,1
7414,165929,N0ztuAsLjfbstbT2QmcILqqvk7xyZRdK,fbPkOYLVPtPgIt0MxizjfFJov3JbHyAi,4,2,0,0,0,4,5,0,11,1.5714285714285714,1,0.0,0,0,0,0,2,4,0,5,0,0,11,1
7415,165932,2DzEePfp8vI6Xs0JiVvwLEBMcAhSfVlO,fbPkOYLVPtPgIt0MxizjfFJov3JbHyAi,27,15,13,0,11,0,2,0,41,5.857142857142857,1,0.0,0,13,0,11,15,0,0,2,0,24,17,1
7416,165933,AFquoviJC5pTQRr2e6rOoJKhtZPD68e6,fbPkOYLVPtPgIt0MxizjfFJov3JbHyAi,1,0,0,0,0,0,1,0,1,0.14285714285714285,1,0.0,0,0,0,0,0,0,0,1,0,0,1,1
7417,165935,n1KDgjl33Pixp3I97r6srvTiO5SuF7Nz,fbPkOYLVPtPgIt0MxizjfFJov3JbHyAi,2,0,0,0,0,0,3,0,3,0.42857142857142855,1,0.0,0,0,0,0,0,0,0,3,0,0,3,1
7418,165936,dEMaD0MQ8e6kvzK6uTaTqEapXiabfWOZ,fbPkOYLVPtPgIt0MxizjfFJov3JbHyAi,1,0,0,0,0,0,1,0,1,0.14285714285714285,1,0.0,0,0,0,0,0,0,0,1,0,0,1,1
7419,165937,Tinpz4fjOCtpep3uA5BTGuPzKNOjU7rZ,fbPkOYLVPtPgIt0MxizjfFJov3JbHyAi,8,2,1,0,1,0,6,1,11,1.5714285714285714,1,0.0,0,1,0,1,2,0,0,6,1,2,9,1
7420,165938,0KJ4hMwNKcU4u0kRo24XysZZkRQaIxT8,fbPkOYLVPtPgIt0MxizjfFJov3JbHyAi,11,6,4,0,3,1,5,0,19,2.7142857142857144,1,0.0,0,4,0,3,6,1,0,5,0,7,12,1
7421,165940,xQ2BABxu01BWouoal36eufzFXJFj8740,fbPkOYLVPtPgIt0MxizjfFJov3JbHyAi,5,2,1,0,1,0,4,0,8,1.1428571428571428,1,0.0,0,1,0,1,2,0,0,4,0,2,6,1
7422,165941,sYY4KU9duRm2WvtJaAqFW3lrzMYM9YTK,fbPkOYLVPtPgIt0MxizjfFJov3JbHyAi,1,0,0,0,0,0,1,0,1,0.14285714285714285,1,0.0,0,0,0,0,0,0,0,1,0,0,1,1
7423,165945,L4G4vKN8ytBRvs68XcSQcEruocF5VrXF,fbPkOYLVPtPgIt0MxizjfFJov3JbHyAi,11,12,4,1,7,0,5,0,29,4.142857142857143,1,0.0,7,4,1,7,5,0,0,5,0,19,10,1
7424,165946,PkAoACuemSFXbpeGyaVjPpfHQnZGDRZj,fbPkOYLVPtPgIt0MxizjfFJov3JbHyAi,1,0,0,0,0,0,1,0,1,0.14285714285714285,1,0.0,0,0,0,0,0,0,0,1,0,0,1,1
7425,165948,hkJlttz5bDZp3UAkxISJCqbBUU7zCJGE,fbPkOYLVPtPgIt0MxizjfFJov3JbHyAi,6,5,1,0,2,0,2,0,10,1.4285714285714286,1,0.0,2,1,0,2,3,0,0,2,0,5,5,1
7426,165950,nD4vzUC5IhneshAQmhqAnl7GVhvdL4Oa,fbPkOYLVPtPgIt0MxizjfFJov3JbHyAi,6,5,4,0,3,0,2,0,14,2.0,1,0.0,0,4,0,3,5,0,0,2,0,7,7,1
7427,165952,9qEU7W2Isd4L4gGJxLIjYzA3Il6E8bpq,fbPkOYLVPtPgIt0MxizjfFJov3JbHyAi,1,0,0,0,0,0,1,0,1,0.14285714285714285,1,0.0,0,0,0,0,0,0,0,1,0,0,1,1
7428,165953,Xi5jJx0Z2MOBm1fPpYwlvuzwElYhyszd,fbPkOYLVPtPgIt0MxizjfFJov3JbHyAi,8,6,3,0,1,0,3,1,14,2.0,1,0.0,0,3,0,1,6,0,0,3,1,4,10,1
7429,165959,nDEAbdtySU0D9dF3CpKEHZFDA8qmxdYa,fbPkOYLVPtPgIt0MxizjfFJov3JbHyAi,4,2,0,0,0,0,2,0,4,0.5714285714285714,1,0.0,0,0,0,0,2,0,0,2,0,0,4,1
7430,165960,7vIvISS7ijOom6TvJIkwXN5GvDUAFRxR,fbPkOYLVPtPgIt0MxizjfFJov3JbHyAi,1,0,0,0,0,0,1,0,1,0.14285714285714285,1,0.0,0,0,0,0,0,0,0,1,0,0,1,1
7431,165962,XVAhFtuqfyjnzPVdjpwB4j2TwuAUpbEa,fbPkOYLVPtPgIt0MxizjfFJov3JbHyAi,5,2,1,0,1,0,2,0,6,0.8571428571428571,1,0.0,0,1,0,1,2,0,0,2,0,2,4,1
7432,165966,ClOkOu5t4KsYmmlGT8TtbSp6RHO1dS7b,fbPkOYLVPtPgIt0MxizjfFJov3JbHyAi,15,25,11,10,14,0,6,0,66,9.428571428571429,2,0.0,12,11,9,14,13,0,1,6,0,46,20,1
7433,165968,m2dEISaBvHWrLGQEI5zibEiH1nbUMDmE,fbPkOYLVPtPgIt0MxizjfFJov3JbHyAi,10,7,5,0,4,0,4,0,20,2.857142857142857,2,0.0,0,5,0,4,7,0,0,4,0,9,11,1
7434,165971,No3uaZVX8QfUWi2WuoYFYrVrLQNiuZit,fbPkOYLVPtPgIt0MxizjfFJov3JbHyAi,14,24,13,0,2,6,6,0,51,7.285714285714286,3,0.0,7,13,0,2,17,6,0,6,0,22,29,0
7435,165972,1FTDLU0hMqcHLpAYkeifJZgSteMYLeP4,fbPkOYLVPtPgIt0MxizjfFJov3JbHyAi,9,7,4,0,3,0,2,0,16,2.2857142857142856,1,0.0,1,4,0,3,6,0,0,2,0,8,8,1
7436,165973,hJvv1gUOmLiHeeVGHBEcsZYIwyTiE5ff,fbPkOYLVPtPgIt0MxizjfFJov3JbHyAi,9,3,2,0,2,0,4,0,11,1.5714285714285714,1,0.0,0,2,0,2,3,0,0,4,0,4,7,1
7437,165980,toJoC2Dz4pkE4Zg9u6dfUofCepqbYSQk,fbPkOYLVPtPgIt0MxizjfFJov3JbHyAi,4,2,0,0,0,0,4,0,6,0.8571428571428571,1,0.0,0,0,0,0,2,0,0,4,0,0,6,1
7438,165981,LbU1jyqO2EUpiuLYtgaX21ombTqyoZWL,fbPkOYLVPtPgIt0MxizjfFJov3JbHyAi,5,4,0,0,0,0,6,0,10,1.4285714285714286,1,0.0,0,0,0,0,4,0,0,6,0,0,10,1
7439,165984,UQfv7o9p9lV4lRkL1vVMlZTP2dPtcdzG,fbPkOYLVPtPgIt0MxizjfFJov3JbHyAi,5,3,1,0,1,0,2,0,7,1.0,1,0.0,0,1,0,1,3,0,0,2,0,2,5,1
7440,165985,UAzjSo4qDf1pkQceftDVLCKsvfzQ6NyU,fbPkOYLVPtPgIt0MxizjfFJov3JbHyAi,18,16,8,0,7,1,2,0,34,4.857142857142857,1,0.0,0,8,0,7,16,1,0,2,0,15,19,1
7441,165988,GE48LtSsMWryASGs1FlnEw40AwktRNOT,fbPkOYLVPtPgIt0MxizjfFJov3JbHyAi,7,3,2,0,2,8,4,0,19,2.7142857142857144,1,0.0,0,2,0,2,3,8,0,4,0,4,15,1
7442,165989,b5WncJSLsMNsvTtUX4GOshLjrNYBfS0U,fbPkOYLVPtPgIt0MxizjfFJov3JbHyAi,1,0,0,0,0,0,1,0,1,0.14285714285714285,1,0.0,0,0,0,0,0,0,0,1,0,0,1,1
7443,165992,Wt8lglrVLSreEoovOJIO0VXJgpwg81lv,fbPkOYLVPtPgIt0MxizjfFJov3JbHyAi,9,6,3,0,2,0,5,1,17,2.4285714285714284,1,0.0,0,3,0,2,6,0,0,5,1,5,12,1
7444,165993,8yNyyy8aPKd19nuqwaynaLkU67KuROpn,fbPkOYLVPtPgIt0MxizjfFJov3JbHyAi,17,10,9,0,9,0,2,0,30,4.285714285714286,1,0.0,0,9,0,9,10,0,0,2,0,18,12,1
7445,165994,O5kAlgXfdKVePlq806YxmEVko0qCkZzG,fbPkOYLVPtPgIt0MxizjfFJov3JbHyAi,1,0,0,0,0,0,2,0,2,0.2857142857142857,1,0.0,0,0,0,0,0,0,0,2,0,0,2,1
7446,165995,zDgM2vvltn6gXNx1hUBDd8fFebbnmmWo,fbPkOYLVPtPgIt0MxizjfFJov3JbHyAi,1,0,0,0,0,0,1,0,1,0.14285714285714285,1,0.0,0,0,0,0,0,0,0,1,0,0,1,1
7447,165996,LXj1WYMapfbcZixGvlzo4y3R5Bt3m0Vn,fbPkOYLVPtPgIt0MxizjfFJov3JbHyAi,1,0,0,0,0,0,1,0,1,0.14285714285714285,1,0.0,0,0,0,0,0,0,0,1,0,0,1,1
7448,166000,PMOSmRt4fRUG27WzPyEHqHKXX14Xi4NX,fbPkOYLVPtPgIt0MxizjfFJov3JbHyAi,1,0,0,0,0,0,1,0,1,0.14285714285714285,1,0.0,0,0,0,0,0,0,0,1,0,0,1,1
7449,166001,Hc6XZmx7ZQQRjy23848JYEBkgJsujUuY,fbPkOYLVPtPgIt0MxizjfFJov3JbHyAi,5,2,1,0,1,0,3,0,7,1.0,1,0.0,0,1,0,1,2,0,0,3,0,2,5,1
7450,166004,r5jinF0G0Atp0uUdWzFeA9Dxz6JBtOHv,fbPkOYLVPtPgIt0MxizjfFJov3JbHyAi,8,3,2,0,2,0,3,0,10,1.4285714285714286,1,0.0,0,2,0,2,3,0,0,3,0,4,6,1
7451,166007,ffImGRf9pvFQSBFckBEzUfl1PucCkATq,fbPkOYLVPtPgIt0MxizjfFJov3JbHyAi,1,0,0,0,0,0,1,0,1,0.14285714285714285,1,0.0,0,0,0,0,0,0,0,1,0,0,1,1
7452,166008,q4qRNKt6T9G0qxbDK4nh8fPY4HlIZJpN,fbPkOYLVPtPgIt0MxizjfFJov3JbHyAi,1,0,0,0,0,0,1,0,1,0.14285714285714285,1,0.0,0,0,0,0,0,0,0,1,0,0,1,1
7453,166010,jTd3OCBirsXRXozKADIUhKrXCVzIgRme,fbPkOYLVPtPgIt0MxizjfFJov3JbHyAi,11,21,6,0,8,0,3,0,38,5.428571428571429,1,0.0,14,6,0,8,7,0,0,3,0,28,10,1
7454,166011,T2B2X3gb5fdopiXu62Tu4E2DMy7sMSD1,fbPkOYLVPtPgIt0MxizjfFJov3JbHyAi,1,0,0,0,0,0,1,0,1,0.14285714285714285,1,0.0,0,0,0,0,0,0,0,1,0,0,1,1
7455,166016,vpmKK2fvh0wwuItw5yJ4YzfFSwaX4K1i,fbPkOYLVPtPgIt0MxizjfFJov3JbHyAi,1,0,0,0,0,0,1,0,1,0.14285714285714285,1,0.0,0,0,0,0,0,0,0,1,0,0,1,1
7456,166017,ImymTAbHJfMMMPKBwnuXmdPedLhaLLQ4,fbPkOYLVPtPgIt0MxizjfFJov3JbHyAi,1,0,0,0,0,0,1,0,1,0.14285714285714285,1,0.0,0,0,0,0,0,0,0,1,0,0,1,1
7457,166041,LShHu6uYlRN5bIHuJkopPqEfnHxBTC8i,fbPkOYLVPtPgIt0MxizjfFJov3JbHyAi,2,0,0,0,0,0,5,0,5,0.7142857142857143,1,0.0,0,0,0,0,0,0,0,5,0,0,5,1
7458,166043,N9J0YMMUvYV85FVJ0qX5eo6FonnNSF85,fbPkOYLVPtPgIt0MxizjfFJov3JbHyAi,2,0,0,0,0,0,2,0,2,0.2857142857142857,1,0.0,0,0,0,0,0,0,0,2,0,0,2,1
7459,166046,r0yZNwEG828V0TMkCl61Reya5Y5HO5aR,fbPkOYLVPtPgIt0MxizjfFJov3JbHyAi,4,3,1,0,1,0,1,0,6,0.8571428571428571,1,0.0,0,1,0,1,3,0,0,1,0,2,4,0
7460,166050,dTKURyZ9dyqGbe4l7wsUGgSU85JHBAFq,fbPkOYLVPtPgIt0MxizjfFJov3JbHyAi,4,2,1,0,1,0,1,0,5,0.7142857142857143,1,0.0,0,1,0,1,2,0,0,1,0,2,3,0
7461,166051,zys4H0zoKgEwqaSlxuoMh0ylzZsMRp6B,fbPkOYLVPtPgIt0MxizjfFJov3JbHyAi,8,2,2,0,2,0,3,0,9,1.2857142857142858,1,0.0,0,2,0,2,2,0,0,3,0,4,5,1
7462,166052,zRVD6VEUKDrryOP1TvtbSCWZetILcTFA,fbPkOYLVPtPgIt0MxizjfFJov3JbHyAi,5,3,1,0,1,0,2,0,7,1.0,1,0.0,1,1,0,1,2,0,0,2,0,3,4,1
7463,166054,aCi7yBADL9TO8ilUuxPHdQalGIRg3aJr,fbPkOYLVPtPgIt0MxizjfFJov3JbHyAi,6,1,1,0,1,3,4,0,10,1.4285714285714286,1,0.0,0,1,0,1,1,3,0,4,0,2,8,1
7464,166055,dMp1KIJnUk3pJLRma1sY50MtqbX92XeU,fbPkOYLVPtPgIt0MxizjfFJov3JbHyAi,4,2,1,0,0,0,2,0,5,0.7142857142857143,1,0.0,0,1,0,0,2,0,0,2,0,1,4,1
7465,166056,RXpyLiihGXUCA8h1EctnHTjiraMHD0a4,fbPkOYLVPtPgIt0MxizjfFJov3JbHyAi,7,5,3,0,2,4,2,0,16,2.2857142857142856,1,0.0,0,3,0,2,5,4,0,2,0,5,11,1
7466,166061,8gVI3RCzdwrb0srHH9NO7stO8AUu1uCR,fbPkOYLVPtPgIt0MxizjfFJov3JbHyAi,3,0,0,0,0,34,2,0,36,5.142857142857143,1,0.0,0,0,0,0,0,34,0,2,0,0,36,1
7467,166063,tJFzrDg5BaUKwBS7uJ8wgIWbLiKiPTve,fbPkOYLVPtPgIt0MxizjfFJov3JbHyAi,2,0,0,0,0,0,3,0,3,0.42857142857142855,1,0.0,0,0,0,0,0,0,0,3,0,0,3,1
7468,166064,lxeXZ87M0UdQbm9QL7lTn6YACn14X0PC,fbPkOYLVPtPgIt0MxizjfFJov3JbHyAi,11,6,5,0,4,0,2,0,17,2.4285714285714284,1,0.0,0,5,0,4,6,0,0,2,0,9,8,1
7469,166065,ijyyGxSCkTNXshxGrWCb96rdtgSJNssR,fbPkOYLVPtPgIt0MxizjfFJov3JbHyAi,7,3,2,0,2,0,2,0,9,1.2857142857142858,1,0.0,0,2,0,2,3,0,0,2,0,4,5,1
7470,166067,7fC3V6ivG07wUIMOmiYFzSlyjWvbYnYf,fbPkOYLVPtPgIt0MxizjfFJov3JbHyAi,1,0,0,0,0,0,1,0,1,0.14285714285714285,1,0.0,0,0,0,0,0,0,0,1,0,0,1,1
7471,166068,uUEAEHuEOlAvsHurjyTj6J9XqJZTLr4r,fbPkOYLVPtPgIt0MxizjfFJov3JbHyAi,10,10,5,3,7,0,2,0,27,3.857142857142857,1,0.0,4,5,2,7,6,0,1,2,0,18,9,1
7472,166069,icJiAKjBBiURMzSKaDbpsCD4jk8ynifx,fbPkOYLVPtPgIt0MxizjfFJov3JbHyAi,3,0,0,0,0,0,7,0,7,1.0,1,0.0,0,0,0,0,0,0,0,7,0,0,7,1
7473,166070,lUDEsCpeeCxZyURyjEd7RvRXvuIDJHXc,fbPkOYLVPtPgIt0MxizjfFJov3JbHyAi,8,6,4,0,3,0,3,0,16,2.2857142857142856,1,0.0,0,4,0,3,6,0,0,3,0,7,9,1
7474,166073,Sy0IBVghIdDN5uhsYaAtE4EZP4lbDR6C,fbPkOYLVPtPgIt0MxizjfFJov3JbHyAi,10,7,5,0,4,0,7,0,23,3.2857142857142856,3,0.0,0,5,0,4,7,0,0,7,0,9,14,1
7475,166076,tlV5mNtKN8OpE3fnEW9HsMaTsOyR1fSl,fbPkOYLVPtPgIt0MxizjfFJov3JbHyAi,2,0,0,0,0,0,2,0,2,0.2857142857142857,1,0.0,0,0,0,0,0,0,0,2,0,0,2,1
7476,166096,d2dMin38z1mvwoR5boGKYx3URnEXiseW,fbPkOYLVPtPgIt0MxizjfFJov3JbHyAi,7,5,2,0,2,23,4,0,36,5.142857142857143,1,0.0,2,2,0,2,3,23,0,4,0,6,30,1
7477,166136,yl1czWTsEc25eyLba69IHArFJ1AESbkB,fbPkOYLVPtPgIt0MxizjfFJov3JbHyAi,11,7,4,0,2,0,10,1,24,3.4285714285714284,2,0.0,0,4,0,2,7,0,0,10,1,6,18,1
7478,166137,BZAa5FHuzEdX48cxIhsFBf8tlybpBCLx,fbPkOYLVPtPgIt0MxizjfFJov3JbHyAi,1,0,0,0,0,0,1,0,1,0.14285714285714285,1,0.0,0,0,0,0,0,0,0,1,0,0,1,1
7479,166145,1drLxoSaZXWb9UC1qR0hH1CkYJWXeTKQ,fbPkOYLVPtPgIt0MxizjfFJov3JbHyAi,1,0,0,0,0,0,1,0,1,0.14285714285714285,1,0.0,0,0,0,0,0,0,0,1,0,0,1,1
7480,166146,RFGMjZRXt4tuFIbx8DYfxpBzyQc4B9QK,fbPkOYLVPtPgIt0MxizjfFJov3JbHyAi,2,0,0,0,0,0,7,0,7,1.0,1,0.0,0,0,0,0,0,0,0,7,0,0,7,1
7481,166147,uDXojcZmAjRrYpbHg6OiLrdKtE8isYPI,fbPkOYLVPtPgIt0MxizjfFJov3JbHyAi,1,0,0,0,0,0,1,0,1,0.14285714285714285,1,0.0,0,0,0,0,0,0,0,1,0,0,1,1
7482,166148,gEfA8oSIHqbidc8ueZMiKg0wULpPs9EE,fbPkOYLVPtPgIt0MxizjfFJov3JbHyAi,3,1,0,0,0,0,6,0,7,1.0,1,0.0,0,0,0,0,1,0,0,6,0,0,7,1
7483,166149,jz0z8WtMaF1l7Nd9g9Ta3D63c4ohIzb2,fbPkOYLVPtPgIt0MxizjfFJov3JbHyAi,5,2,1,0,1,0,2,0,6,0.8571428571428571,1,0.0,0,1,0,1,2,0,0,2,0,2,4,1
7484,166153,zXvDUt3LgrB0KNQc9FoWhJ1W2pAiQJPd,fbPkOYLVPtPgIt0MxizjfFJov3JbHyAi,1,0,0,0,0,0,1,0,1,0.14285714285714285,1,0.0,0,0,0,0,0,0,0,1,0,0,1,1
7485,166154,lSZoAh0N0Lt8L3rqDq2pbnhpzHs4jrDI,fbPkOYLVPtPgIt0MxizjfFJov3JbHyAi,5,2,1,0,1,0,4,0,8,1.1428571428571428,1,0.0,0,1,0,1,2,0,0,4,0,2,6,1
7486,166155,ef55znmweQJrijlI0fO1Ekc271nZnV0m,fbPkOYLVPtPgIt0MxizjfFJov3JbHyAi,5,2,1,0,1,0,2,0,6,0.8571428571428571,1,0.0,0,1,0,1,2,0,0,2,0,2,4,1
7487,166156,Gc9FbbmaGQGlnmnRUjTL7bYNyXYRT1nJ,fbPkOYLVPtPgIt0MxizjfFJov3JbHyAi,2,0,0,0,0,0,2,0,2,0.2857142857142857,1,0.0,0,0,0,0,0,0,0,2,0,0,2,1
7488,166157,tfQHC1cUfGIbjxrAzAZrBm9HnB72SzwU,fbPkOYLVPtPgIt0MxizjfFJov3JbHyAi,20,20,14,0,10,7,12,7,70,10.0,1,0.0,2,14,0,10,18,7,0,12,7,26,44,1
7489,166158,HMNOnIW6u5dbPy0UCu54RGHmZvKhZGzf,fbPkOYLVPtPgIt0MxizjfFJov3JbHyAi,5,11,1,0,1,0,4,0,17,2.4285714285714284,1,0.0,9,1,0,1,2,0,0,4,0,11,6,1
7490,166160,qQOsZomAFoKDKPSRrF5FYWs1Zz9uDJVk,fbPkOYLVPtPgIt0MxizjfFJov3JbHyAi,2,0,0,0,0,0,4,0,4,0.5714285714285714,1,0.0,0,0,0,0,0,0,0,4,0,0,4,1
7491,166163,vvtmzsrkptNlFQlQRiEFe3TANujrEqYp,fbPkOYLVPtPgIt0MxizjfFJov3JbHyAi,1,0,0,0,0,0,1,0,1,0.14285714285714285,1,0.0,0,0,0,0,0,0,0,1,0,0,1,1
7492,166164,5RdGNDILnjdvCJ7HdlzpCtXsdeo7gaMF,fbPkOYLVPtPgIt0MxizjfFJov3JbHyAi,1,0,0,0,0,0,1,0,1,0.14285714285714285,1,0.0,0,0,0,0,0,0,0,1,0,0,1,1
7493,166168,rqjy9MBaTbrPcPapKqAdlw4agDXaSEfE,fbPkOYLVPtPgIt0MxizjfFJov3JbHyAi,1,0,0,0,0,0,1,0,1,0.14285714285714285,1,0.0,0,0,0,0,0,0,0,1,0,0,1,1
7494,166170,kmvJp6nzoFXW8Oc5kR5gMGOAAX5QexyP,fbPkOYLVPtPgIt0MxizjfFJov3JbHyAi,1,0,0,0,0,0,1,0,1,0.14285714285714285,1,0.0,0,0,0,0,0,0,0,1,0,0,1,1
7495,166175,R3cwyGYX3VZeygFsQJH9jlsc69OIabHp,fbPkOYLVPtPgIt0MxizjfFJov3JbHyAi,4,3,0,0,0,0,2,0,5,0.7142857142857143,1,0.0,0,0,0,0,3,0,0,2,0,0,5,1
7496,166177,1GJwPJw465ARTw6DCRQ9CrmILllIR9bx,fbPkOYLVPtPgIt0MxizjfFJov3JbHyAi,2,0,0,0,0,0,2,0,2,0.2857142857142857,1,0.0,0,0,0,0,0,0,0,2,0,0,2,1
7497,166182,QuVyCkZrDonWxKYO9hgDhn6YwJRZulhs,fbPkOYLVPtPgIt0MxizjfFJov3JbHyAi,8,2,1,0,1,5,16,1,26,3.7142857142857144,1,0.0,0,1,0,1,2,5,0,16,1,2,24,1
7498,166186,HdUhc4G7VRJcbtjXjCH13w2JqJd1SSbb,fbPkOYLVPtPgIt0MxizjfFJov3JbHyAi,5,2,1,0,1,0,2,0,6,0.8571428571428571,1,0.0,0,1,0,1,2,0,0,2,0,2,4,1
7499,166187,zoMCPyYhAfGWkHGBJFERTWZdMBzykaRB,fbPkOYLVPtPgIt0MxizjfFJov3JbHyAi,4,4,2,0,0,0,1,0,7,1.0,1,0.0,0,2,0,0,4,0,0,1,0,2,5,1
7500,166188,6Lis3QiZL3noC9wlW2RHCrUdD9IiBvZi,fbPkOYLVPtPgIt0MxizjfFJov3JbHyAi,5,2,1,0,1,0,3,0,7,1.0,1,0.0,0,1,0,1,2,0,0,3,0,2,5,1
7501,166189,nEQJ6jbTp4ska93bUrSmQZHx5JprZiSY,fbPkOYLVPtPgIt0MxizjfFJov3JbHyAi,2,0,0,0,0,0,2,0,2,0.2857142857142857,1,0.0,0,0,0,0,0,0,0,2,0,0,2,1
7502,166194,YTGf8IW1bAvGMGrrIZgbZY9E8w2ZKJg9,fbPkOYLVPtPgIt0MxizjfFJov3JbHyAi,5,2,1,0,1,0,2,0,6,0.8571428571428571,1,0.0,0,1,0,1,2,0,0,2,0,2,4,1
7503,166198,ljbA5yUe3ZigWWTZVZHvaZzlcQ3OUJib,fbPkOYLVPtPgIt0MxizjfFJov3JbHyAi,8,5,1,0,1,0,8,1,16,2.2857142857142856,1,0.0,0,1,0,1,5,0,0,8,1,2,14,1
7504,166203,28rpiJDQpdq3215vdwQ3rsZ0mFqWnJQZ,fbPkOYLVPtPgIt0MxizjfFJov3JbHyAi,6,2,1,0,1,0,3,0,7,1.0,1,0.0,0,1,0,1,2,0,0,3,0,2,5,1
7505,166204,vAIC6rsvgV7HbKGkew8JoXcaRFgXoors,fbPkOYLVPtPgIt0MxizjfFJov3JbHyAi,5,2,1,0,0,0,5,0,8,1.1428571428571428,1,0.0,0,1,0,0,2,0,0,5,0,1,7,1
7506,166207,8y2thNQcTL5saoD2DkzYwLVOul0NGb55,fbPkOYLVPtPgIt0MxizjfFJov3JbHyAi,1,0,0,0,0,0,1,0,1,0.14285714285714285,1,0.0,0,0,0,0,0,0,0,1,0,0,1,1
7507,166210,KLos613TyBDKjmDfE1975SNolozt8fEs,fbPkOYLVPtPgIt0MxizjfFJov3JbHyAi,3,0,0,0,0,0,3,0,3,0.42857142857142855,1,0.0,0,0,0,0,0,0,0,3,0,0,3,1
7508,166213,qIz5uvx21yY3zTPvMFcPXhap84pBzDvR,fbPkOYLVPtPgIt0MxizjfFJov3JbHyAi,6,4,0,0,0,3,5,0,12,1.7142857142857142,1,0.0,0,0,0,0,4,3,0,5,0,0,12,1
7509,166215,0sg2jGIMVa15FUIKUaYVkaVNV1yVl35B,fbPkOYLVPtPgIt0MxizjfFJov3JbHyAi,7,3,2,0,2,0,2,0,9,1.2857142857142858,1,0.0,0,2,0,2,3,0,0,2,0,4,5,1
7510,166217,G8RQSDElGQvlM3p8kKR2TUxzTka4oOJb,fbPkOYLVPtPgIt0MxizjfFJov3JbHyAi,7,7,2,0,3,0,2,0,14,2.0,1,0.0,2,2,0,3,5,0,0,2,0,7,7,1
7511,166220,gJIxI0ytF6J0PbE93GpuuDnUUCLDIzYX,fbPkOYLVPtPgIt0MxizjfFJov3JbHyAi,1,0,0,0,0,0,2,0,2,0.2857142857142857,1,0.0,0,0,0,0,0,0,0,2,0,0,2,1
7512,166222,tEG8YJMefgmQpIrlmBvHrR6glsVPJZ6p,fbPkOYLVPtPgIt0MxizjfFJov3JbHyAi,1,0,0,0,0,0,2,0,2,0.2857142857142857,1,0.0,0,0,0,0,0,0,0,2,0,0,2,1
7513,166225,HJ92FBrq5yG61EaDVcrZGDa4ZRxYv0Cx,fbPkOYLVPtPgIt0MxizjfFJov3JbHyAi,10,8,6,0,5,3,3,0,25,3.5714285714285716,1,0.0,0,6,0,5,8,3,0,3,0,11,14,1
7514,166227,aM04j8B80UycNpLiy2mFNdgBiaLCgDBx,fbPkOYLVPtPgIt0MxizjfFJov3JbHyAi,7,5,0,0,0,0,3,1,9,1.2857142857142858,1,0.0,0,0,0,0,5,0,0,3,1,0,9,1
7515,166229,QjbLQSoFVavd6LHLH5XtUy4x4q9nhmtF,fbPkOYLVPtPgIt0MxizjfFJov3JbHyAi,1,0,0,0,0,0,1,0,1,0.14285714285714285,1,0.0,0,0,0,0,0,0,0,1,0,0,1,1
7516,166230,6V2GrQFILHPsB0ekNjtLouAcbsjILF5g,fbPkOYLVPtPgIt0MxizjfFJov3JbHyAi,6,3,1,0,1,0,3,0,8,1.1428571428571428,1,0.0,0,1,0,1,3,0,0,3,0,2,6,1
7517,166231,YClUw7DFcczmQH6YbCWf4FT5MXeix8uw,fbPkOYLVPtPgIt0MxizjfFJov3JbHyAi,2,0,0,0,0,0,2,0,2,0.2857142857142857,1,0.0,0,0,0,0,0,0,0,2,0,0,2,1
7518,166232,sjjdkFlcuWgdDM2N9WBHJl0FJpmG07bZ,fbPkOYLVPtPgIt0MxizjfFJov3JbHyAi,5,2,1,0,1,0,2,0,6,0.8571428571428571,1,0.0,0,1,0,1,2,0,0,2,0,2,4,1
7519,166233,nig5RNhFSqFXsyMzwiBEQh8ryEN4ZIW3,fbPkOYLVPtPgIt0MxizjfFJov3JbHyAi,5,2,1,0,1,0,2,0,6,0.8571428571428571,1,0.0,0,1,0,1,2,0,0,2,0,2,4,1
7520,166237,2wxemnlILR4SFHmJ1CKeBLLcblIV9xQc,fbPkOYLVPtPgIt0MxizjfFJov3JbHyAi,25,20,11,27,9,0,4,0,71,10.142857142857142,2,0.0,6,11,21,9,14,0,6,4,0,47,24,1
7521,166239,GOEtSHSk6DV4bxigVVOBhrHtzfU5WaJO,fbPkOYLVPtPgIt0MxizjfFJov3JbHyAi,1,0,0,0,0,0,1,0,1,0.14285714285714285,1,0.0,0,0,0,0,0,0,0,1,0,0,1,1
7522,166241,sMpDCfadCgwh9MAo1W5K6Ik5Xg8rzern,fbPkOYLVPtPgIt0MxizjfFJov3JbHyAi,5,2,1,0,1,0,2,0,6,0.8571428571428571,1,0.0,0,1,0,1,2,0,0,2,0,2,4,1
7523,166242,2ZLHuYdEPLeyzuC7GNPXNtQbYDCmU9Z1,fbPkOYLVPtPgIt0MxizjfFJov3JbHyAi,6,8,1,0,0,0,2,0,11,1.5714285714285714,1,0.0,0,1,0,0,8,0,0,2,0,1,10,1
7524,166244,Zr7j8ccseRGaMTB9CSbtk2OoktQLUUwZ,fbPkOYLVPtPgIt0MxizjfFJov3JbHyAi,6,3,2,0,2,0,2,0,9,1.2857142857142858,1,0.0,0,2,0,2,3,0,0,2,0,4,5,1
7525,166251,zVoLjf7Wywq3t0MyK9V8JzWR92KniZeU,fbPkOYLVPtPgIt0MxizjfFJov3JbHyAi,8,5,4,0,3,0,2,0,14,2.0,1,0.0,0,4,0,3,5,0,0,2,0,7,7,1
7526,166254,wngLvF30yMtlqza2OIUSM8afhkLgGdV8,fbPkOYLVPtPgIt0MxizjfFJov3JbHyAi,9,5,3,0,2,0,5,0,15,2.142857142857143,1,0.0,0,3,0,2,5,0,0,5,0,5,10,1
7527,166256,uV3c7rC8Ip9ENwSIvLcI3iDJv4HC7nU6,fbPkOYLVPtPgIt0MxizjfFJov3JbHyAi,2,0,0,0,0,0,2,0,2,0.2857142857142857,1,0.0,0,0,0,0,0,0,0,2,0,0,2,1
7528,166265,JiE41HEDLoDarEll7cozPc0WO4mcLeH6,fbPkOYLVPtPgIt0MxizjfFJov3JbHyAi,1,0,0,0,0,0,1,0,1,0.14285714285714285,1,0.0,0,0,0,0,0,0,0,1,0,0,1,1
7529,166266,hyVguxdlO834U7lJnfhtMwTqeljzE8To,fbPkOYLVPtPgIt0MxizjfFJov3JbHyAi,1,0,0,0,0,0,1,0,1,0.14285714285714285,1,0.0,0,0,0,0,0,0,0,1,0,0,1,1
7530,166268,VfDy4viU8b0DxX44uijydrR8w1btSfvR,fbPkOYLVPtPgIt0MxizjfFJov3JbHyAi,9,5,2,0,3,0,4,1,15,2.142857142857143,1,0.0,3,2,0,3,2,0,0,4,1,8,7,1
7531,166269,qAwHClVR46j65q8IKTsxQetmapBK6gNC,fbPkOYLVPtPgIt0MxizjfFJov3JbHyAi,7,3,2,0,2,0,2,0,9,1.2857142857142858,1,0.0,0,2,0,2,3,0,0,2,0,4,5,1
7532,166270,iKJVI2OnWgKnPrc0Q2cfGD7sAkCQTWo1,fbPkOYLVPtPgIt0MxizjfFJov3JbHyAi,3,0,0,0,0,0,3,0,3,0.42857142857142855,1,0.0,0,0,0,0,0,0,0,3,0,0,3,1
7533,166271,lG1PrdMGbnNZVltQvWyOn6wGH1s1gk5W,fbPkOYLVPtPgIt0MxizjfFJov3JbHyAi,1,0,0,0,0,0,1,0,1,0.14285714285714285,1,0.0,0,0,0,0,0,0,0,1,0,0,1,1
7534,166272,HYufVGFQGrizf7sdp2S51f0QPp8O4VIP,fbPkOYLVPtPgIt0MxizjfFJov3JbHyAi,7,3,2,0,2,0,2,0,9,1.2857142857142858,1,0.0,0,2,0,2,3,0,0,2,0,4,5,1
7535,166273,vwF9cLvOjQPJg8J8Y2uNLf6gHvdxzL30,SpATywNh6bZuzm8s1ceuBUnMUAeoAHHw,4,2,1,0,1,0,2,0,6,0.8571428571428571,2,0.0,0,1,0,1,2,0,0,2,0,2,4,1
7536,166289,GQO5pvF9fB0ke4HvwJNUQnKPfOMPwhu0,G8EPVSXsOYB5YQWZGiz1aVq5Pgr2GrQu,36,29,10,68,6,0,1,0,114,16.285714285714285,3,0.0,17,10,45,6,12,0,23,1,0,78,36,1
7537,166295,A9LNHFYBxavFsnHS2U7qtB3ibz5wKw5b,bWdj2GDclj5ofokWjzoa5jAwMkxCykd6,1,0,0,0,0,0,1,0,1,0.14285714285714285,1,0.0,0,0,0,0,0,0,0,1,0,0,1,1
7538,166298,OOJh2Yrr6RQf9QAHFBo7EBzeZ2OAmLfw,A3fsA9Zfv1X2fVEQhTw51lKENdNrEqT3,6,3,2,4,0,0,1,0,10,1.4285714285714286,1,0.0,0,2,4,0,3,0,0,1,0,6,4,1
7539,166311,LFPiiJVIeEKgwmiuE09C3QlUZFR5rtPM,RXDvfPUBYFlVdlueBFbLW0mhhAyGEqpt,14,11,10,0,6,5,4,0,36,5.142857142857143,1,0.0,0,10,0,6,11,5,0,4,0,16,20,1
7540,166339,NkHKP7XmU89AhYrwGvkJ0gX5lfpDGkiJ,SpATywNh6bZuzm8s1ceuBUnMUAeoAHHw,2,0,0,0,0,0,2,0,2,0.2857142857142857,1,0.0,0,0,0,0,0,0,0,2,0,0,2,1
7541,166361,QWw1s7G2LDYzdw5hFh2RBbUqb52YVk7z,G8EPVSXsOYB5YQWZGiz1aVq5Pgr2GrQu,23,36,1,48,2,1,7,0,95,13.571428571428571,1,0.0,19,1,34,2,17,1,14,7,0,56,39,0
7542,166369,s5BonLZqcYCYjyVoBrmolAFZYQqEpVbb,G8EPVSXsOYB5YQWZGiz1aVq5Pgr2GrQu,1,0,0,0,0,0,1,0,1,0.14285714285714285,1,0.0,0,0,0,0,0,0,0,1,0,0,1,0
7543,166379,LWaNb4rILMf9lRML9VmyknZzkoxWoxSQ,A3fsA9Zfv1X2fVEQhTw51lKENdNrEqT3,1,0,0,0,0,0,1,0,1,0.14285714285714285,1,0.0,0,0,0,0,0,0,0,1,0,0,1,1
7544,166384,rmly0YU7hFQRO8wpDGfNQC1vAS0Xq6hn,SpATywNh6bZuzm8s1ceuBUnMUAeoAHHw,14,9,5,7,3,0,2,0,26,3.7142857142857144,1,0.0,3,5,7,3,6,0,0,2,0,18,8,1
7545,166443,FCpDPyaXXEn58dtFe3pQEjUaayUuOg53,SpATywNh6bZuzm8s1ceuBUnMUAeoAHHw,6,4,0,0,0,0,13,0,17,2.4285714285714284,2,0.0,0,0,0,0,4,0,0,13,0,0,17,1
7546,166518,4kW33d8ryobHswayOAbGxV1Ajm5odAVu,A3fsA9Zfv1X2fVEQhTw51lKENdNrEqT3,2,0,0,0,0,0,2,0,2,0.2857142857142857,1,0.0,0,0,0,0,0,0,0,2,0,0,2,1
7547,166524,IOrrTEnPwrStZyNOLFQoK4fs0RpiYPV1,G8EPVSXsOYB5YQWZGiz1aVq5Pgr2GrQu,10,5,2,0,2,8,7,0,24,3.4285714285714284,1,0.0,0,2,0,2,5,8,0,7,0,4,20,1
7548,166548,uMeAc1BFeZrPyaawT7Nx4cOMjZQcepML,RXDvfPUBYFlVdlueBFbLW0mhhAyGEqpt,2,0,0,0,0,0,2,0,2,0.2857142857142857,1,0.0,0,0,0,0,0,0,0,2,0,0,2,1
7549,166552,9NLsBRyvwuJAnXVvkV43elEklDfakfqV,SpATywNh6bZuzm8s1ceuBUnMUAeoAHHw,2,0,0,0,0,0,2,0,2,0.2857142857142857,1,0.0,0,0,0,0,0,0,0,2,0,0,2,1
7550,166568,FkoJ32PRPnjEOGAz921mfwOw4fAtGvO0,SpATywNh6bZuzm8s1ceuBUnMUAeoAHHw,14,17,5,26,3,0,1,0,52,7.428571428571429,1,0.0,10,5,22,3,7,0,4,1,0,40,12,1
7551,166606,uZlOX0cgouu0bXrLq6YA6PRMU30ZaiaI,bWdj2GDclj5ofokWjzoa5jAwMkxCykd6,4,2,1,0,1,0,1,0,5,0.7142857142857143,1,0.0,0,1,0,1,2,0,0,1,0,2,3,1
7552,166633,BiNLDHg34tW2DztH304CnM3NbDxCatLY,bWdj2GDclj5ofokWjzoa5jAwMkxCykd6,7,7,0,26,3,1,6,0,43,6.142857142857143,1,0.0,6,0,24,3,1,1,2,6,0,33,10,1
7553,166639,9Ad0EBsep3vN2c8xQobr7UDwfMqhMFKU,SpATywNh6bZuzm8s1ceuBUnMUAeoAHHw,9,6,5,0,3,0,3,0,17,2.4285714285714284,2,0.0,0,5,0,3,6,0,0,3,0,8,9,0
7554,166748,F4CmkpkMtWFLCelouIUJgiRRRgpQv809,A3fsA9Zfv1X2fVEQhTw51lKENdNrEqT3,1,0,0,0,0,0,1,0,1,0.14285714285714285,1,0.0,0,0,0,0,0,0,0,1,0,0,1,1
7555,166776,mFcnZc9xJHpcsnNSqrnt1TraJ39cAeOG,RXDvfPUBYFlVdlueBFbLW0mhhAyGEqpt,1,0,0,0,0,0,1,0,1,0.14285714285714285,1,0.0,0,0,0,0,0,0,0,1,0,0,1,1
7556,166795,AjRTjBqF69K8qynYqEW0T141KyGuqhS2,A3fsA9Zfv1X2fVEQhTw51lKENdNrEqT3,1,0,0,0,0,0,1,0,1,0.14285714285714285,1,0.0,0,0,0,0,0,0,0,1,0,0,1,1
7557,166823,zhM73YZZY0lktyVnZ4AxEL9UuCvFGPVE,A3fsA9Zfv1X2fVEQhTw51lKENdNrEqT3,9,7,0,0,0,1,9,1,18,2.5714285714285716,1,0.0,0,0,0,0,7,1,0,9,1,0,18,1
7558,166849,MdggzNQQNxgbc1AXVjikoAJPUP3VWCUi,A3fsA9Zfv1X2fVEQhTw51lKENdNrEqT3,5,2,1,0,1,0,2,0,6,0.8571428571428571,1,0.0,0,1,0,1,2,0,0,2,0,2,4,1
7559,166852,WOjJXPk6hpVRJhHaF4hHfePlOcQhWUPY,SpATywNh6bZuzm8s1ceuBUnMUAeoAHHw,8,10,7,0,5,0,2,0,24,3.4285714285714284,2,0.0,0,7,0,5,10,0,0,2,0,12,12,1
7560,166909,bp0wAoMxu88KWfIqaBPqEsMxSHSKb7rw,A3fsA9Zfv1X2fVEQhTw51lKENdNrEqT3,1,0,0,0,0,0,1,0,1,0.14285714285714285,1,0.0,0,0,0,0,0,0,0,1,0,0,1,1
7561,166926,bp0wAoMxu88KWfIqaBPqEsMxSHSKb7rw,RXDvfPUBYFlVdlueBFbLW0mhhAyGEqpt,1,0,0,0,0,0,1,0,1,0.14285714285714285,1,0.0,0,0,0,0,0,0,0,1,0,0,1,1
7562,166933,Uaf2oDHJ8L0D42K5PrmMB0KrT5Tv0JEb,bWdj2GDclj5ofokWjzoa5jAwMkxCykd6,2,0,0,0,0,0,2,0,2,0.2857142857142857,1,0.0,0,0,0,0,0,0,0,2,0,0,2,1
7563,166945,Crt3eVh2fZmwU8n336w6v5vI95DwJSl7,SpATywNh6bZuzm8s1ceuBUnMUAeoAHHw,9,4,3,0,2,2,4,2,17,2.4285714285714284,1,0.0,0,3,0,2,4,2,0,4,2,5,12,1
7564,166952,V52G1wHOq5zd0Up8zjShFJCn7Er4GImu,SpATywNh6bZuzm8s1ceuBUnMUAeoAHHw,4,7,1,0,0,0,3,0,11,1.5714285714285714,2,0.0,0,1,0,0,7,0,0,3,0,1,10,1
7565,166954,diqtTQE3aIn9EfLQeyH3g1mHmhR3kGFy,SpATywNh6bZuzm8s1ceuBUnMUAeoAHHw,5,3,1,0,1,0,2,0,7,1.0,1,0.0,0,1,0,1,3,0,0,2,0,2,5,1
7566,166982,KsUm63CS66fccBaGn2XmCwaaNmurTIUr,SpATywNh6bZuzm8s1ceuBUnMUAeoAHHw,6,3,1,0,1,0,2,0,7,1.0,1,0.0,0,1,0,1,3,0,0,2,0,2,5,1
7567,166985,KVFLGfkLjESnixIuWE2enCugNN1bDzvq,A3fsA9Zfv1X2fVEQhTw51lKENdNrEqT3,11,11,1,0,0,0,1,0,13,1.8571428571428572,1,0.0,0,1,0,0,11,0,0,1,0,1,12,1
7568,166998,lzb8kR5dRzqO59ncQoQqbKNH1bW2854J,bWdj2GDclj5ofokWjzoa5jAwMkxCykd6,1,0,0,0,0,0,1,0,1,0.14285714285714285,1,0.0,0,0,0,0,0,0,0,1,0,0,1,1
7569,166999,dUop8tAAPSP400w8c2tq4wG1pwOMUqYS,A3fsA9Zfv1X2fVEQhTw51lKENdNrEqT3,7,3,2,0,2,0,6,0,13,1.8571428571428572,1,0.0,0,2,0,2,3,0,0,6,0,4,9,0
7570,167023,JpMQoarOn6JQcf557ZUmfYqpeHPAEtez,A3fsA9Zfv1X2fVEQhTw51lKENdNrEqT3,5,6,2,0,0,0,2,0,10,1.4285714285714286,2,0.0,0,2,0,0,6,0,0,2,0,2,8,1
7571,167056,STjQHRvW81iYlnhczfhr8jnAyuOyD8VG,bWdj2GDclj5ofokWjzoa5jAwMkxCykd6,3,2,0,0,0,0,1,0,3,0.42857142857142855,1,0.0,0,0,0,0,2,0,0,1,0,0,3,1
7572,167063,jWFFw5rdEwwLuLnKwYIpyv4HO3N0mTOS,G8EPVSXsOYB5YQWZGiz1aVq5Pgr2GrQu,7,9,5,0,2,0,3,0,19,2.7142857142857144,1,0.0,0,5,0,2,9,0,0,3,0,7,12,1
7573,167071,eip5MMGOVDSg5Q7RWXlSlAH5Sizgq4mr,G8EPVSXsOYB5YQWZGiz1aVq5Pgr2GrQu,17,14,1,24,1,4,5,1,50,7.142857142857143,1,0.0,3,1,21,1,11,4,3,5,1,26,24,1
7574,167076,OWbwbOuhTRx8Sll5Avvz5AZRO647LCJ4,SpATywNh6bZuzm8s1ceuBUnMUAeoAHHw,1,0,0,0,0,0,1,0,1,0.14285714285714285,1,0.0,0,0,0,0,0,0,0,1,0,0,1,1
7575,167080,OWbwbOuhTRx8Sll5Avvz5AZRO647LCJ4,bWdj2GDclj5ofokWjzoa5jAwMkxCykd6,1,0,0,0,0,0,1,0,1,0.14285714285714285,1,0.0,0,0,0,0,0,0,0,1,0,0,1,1
7576,167094,SoREPWdOHEFnyEXb3M5qgLwqpLSv5EJy,SpATywNh6bZuzm8s1ceuBUnMUAeoAHHw,1,0,0,0,0,0,1,0,1,0.14285714285714285,1,0.0,0,0,0,0,0,0,0,1,0,0,1,1
7577,167098,NuaG3GppxhXVOLv5fu633RlMWR7B08SC,SpATywNh6bZuzm8s1ceuBUnMUAeoAHHw,11,12,8,0,6,3,3,0,32,4.571428571428571,2,0.0,2,8,0,6,10,3,0,3,0,16,16,1
7578,167101,1Z0JbSMoZNTapARGDhipa6UEe1xrZepu,G8EPVSXsOYB5YQWZGiz1aVq5Pgr2GrQu,2,0,0,0,0,0,2,0,2,0.2857142857142857,1,0.0,0,0,0,0,0,0,0,2,0,0,2,1
7579,167115,WAC7RGZ1uYeT92igfYiLgTnHWPEtN2IA,A3fsA9Zfv1X2fVEQhTw51lKENdNrEqT3,9,8,6,0,3,0,4,0,21,3.0,3,0.0,0,6,0,3,8,0,0,4,0,9,12,1
7580,167120,woVLVXPiC8hhTnKZW3Z7hk3owLtphTuf,RXDvfPUBYFlVdlueBFbLW0mhhAyGEqpt,16,29,5,0,4,1,5,0,44,6.285714285714286,2,0.0,1,5,0,4,28,1,0,5,0,10,34,1
7581,167137,yxFacYGK53644aEjhoi40V3IIQttQjtF,SpATywNh6bZuzm8s1ceuBUnMUAeoAHHw,10,7,5,0,4,0,4,0,20,2.857142857142857,1,0.0,0,5,0,4,7,0,0,4,0,9,11,1
7582,167157,udF4jwSYeJ58QSIxsDPfAqb9mSqSCjuB,SpATywNh6bZuzm8s1ceuBUnMUAeoAHHw,19,60,3,16,1,6,17,1,104,14.857142857142858,1,0.0,16,3,14,1,44,6,2,17,1,34,70,1
7583,167166,4Mf2EKSJhzPrUZBvK6JSHuGanRWOAS1S,SpATywNh6bZuzm8s1ceuBUnMUAeoAHHw,10,13,8,0,0,0,6,0,27,3.857142857142857,2,0.0,2,8,0,0,11,0,0,6,0,10,17,0
7584,167180,jQg5UakMQRKmdDEXjxxf2nAUZSauWzhl,A3fsA9Zfv1X2fVEQhTw51lKENdNrEqT3,1,0,0,0,0,0,1,0,1,0.14285714285714285,1,0.0,0,0,0,0,0,0,0,1,0,0,1,1
7585,167185,8RHWOUyn5mqf53McvuS18SiueTk2U6y2,bWdj2GDclj5ofokWjzoa5jAwMkxCykd6,1,0,0,0,0,0,1,0,1,0.14285714285714285,1,0.0,0,0,0,0,0,0,0,1,0,0,1,1
7586,167186,8RHWOUyn5mqf53McvuS18SiueTk2U6y2,G8EPVSXsOYB5YQWZGiz1aVq5Pgr2GrQu,1,0,0,0,0,0,1,0,1,0.14285714285714285,1,0.0,0,0,0,0,0,0,0,1,0,0,1,1
7587,167217,j0gxXks7DZitzyeEGG2agLKFp30HqXVu,A3fsA9Zfv1X2fVEQhTw51lKENdNrEqT3,3,3,1,0,0,0,2,0,6,0.8571428571428571,1,0.0,0,1,0,0,3,0,0,2,0,1,5,1
7588,167234,Me95BqnMi7W18LuJ9CGsC9vdXTLZ2e0Y,A3fsA9Zfv1X2fVEQhTw51lKENdNrEqT3,5,2,1,0,1,0,2,0,6,0.8571428571428571,1,0.0,0,1,0,1,2,0,0,2,0,2,4,1
7589,167236,yjqa4N4fhl3Uv2C3tR6TSWjlxDfm3vvM,SpATywNh6bZuzm8s1ceuBUnMUAeoAHHw,1,0,0,0,0,0,1,0,1,0.14285714285714285,1,0.0,0,0,0,0,0,0,0,1,0,0,1,1
7590,167244,Cie8MgBDvC4HVRvuqtFzP8SkWOhgrE8X,SpATywNh6bZuzm8s1ceuBUnMUAeoAHHw,12,30,21,0,9,0,10,0,70,10.0,2,0.0,3,21,0,9,27,0,0,10,0,33,37,1
7591,167251,5B2bGhS2BSsBKATjNqdTQPUYoxJcc0Mm,SpATywNh6bZuzm8s1ceuBUnMUAeoAHHw,4,2,0,0,0,0,2,0,4,0.5714285714285714,1,0.0,0,0,0,0,2,0,0,2,0,0,4,1
7592,167256,8BBrs2YJZdMAa1GwaqwG4BfeZccyZZAj,SpATywNh6bZuzm8s1ceuBUnMUAeoAHHw,6,3,1,0,1,0,2,0,7,1.0,1,0.0,0,1,0,1,3,0,0,2,0,2,5,1
7593,167261,Uylyq7LmmNSvSWdWZxt9uRF9NmGdfp0A,bWdj2GDclj5ofokWjzoa5jAwMkxCykd6,1,0,0,0,0,0,1,0,1,0.14285714285714285,1,0.0,0,0,0,0,0,0,0,1,0,0,1,1
7594,167268,srnnzUkIJr2Uisav8LfnV4SnpbNw9CLp,A3fsA9Zfv1X2fVEQhTw51lKENdNrEqT3,36,18,14,50,12,0,4,0,98,14.0,1,0.0,0,14,40,12,18,0,10,4,0,66,32,1
7595,167291,T1pFbYP74kktq7cBESkP625j6elO7EQ5,RXDvfPUBYFlVdlueBFbLW0mhhAyGEqpt,1,0,0,0,0,0,2,0,2,0.2857142857142857,1,0.0,0,0,0,0,0,0,0,2,0,0,2,1
7596,167301,AW6dihJ9WRBecrtuIS74toM8othH6GFu,A3fsA9Zfv1X2fVEQhTw51lKENdNrEqT3,1,0,0,0,0,0,1,0,1,0.14285714285714285,1,0.0,0,0,0,0,0,0,0,1,0,0,1,1
7597,167334,0gocHINf7b8BcvWaTrMFBEJhugD8UJOT,bWdj2GDclj5ofokWjzoa5jAwMkxCykd6,9,9,4,14,3,0,2,0,32,4.571428571428571,1,0.0,1,4,14,3,8,0,0,2,0,22,10,1
7598,167353,mtxEm66XLaiLgrwQ9kSbmVMuiNAGb6i1,G8EPVSXsOYB5YQWZGiz1aVq5Pgr2GrQu,7,4,3,0,1,0,2,0,10,1.4285714285714286,1,0.0,0,3,0,1,4,0,0,2,0,4,6,1
7599,167370,XF1lbfsr5ID8AfWQ0nphBhI7tZhRqdpu,SpATywNh6bZuzm8s1ceuBUnMUAeoAHHw,1,0,0,0,0,0,1,0,1,0.14285714285714285,1,0.0,0,0,0,0,0,0,0,1,0,0,1,1
7600,167371,khelYX1bk51SSadsVaUzKR0zRRNCX0tK,G8EPVSXsOYB5YQWZGiz1aVq5Pgr2GrQu,1,0,0,0,0,0,1,0,1,0.14285714285714285,1,0.0,0,0,0,0,0,0,0,1,0,0,1,1
7601,167376,PYjcXVq1OKher1f36I3CGAnm6VaLRVjt,SpATywNh6bZuzm8s1ceuBUnMUAeoAHHw,8,6,2,0,2,0,10,0,20,2.857142857142857,1,0.0,0,2,0,2,6,0,0,10,0,4,16,1
7602,167393,6HV2PEjNIKCVMQQpYRQLuV1rrZqqecaV,A3fsA9Zfv1X2fVEQhTw51lKENdNrEqT3,4,2,1,0,1,0,1,0,5,0.7142857142857143,1,0.0,0,1,0,1,2,0,0,1,0,2,3,1
7603,167418,IJukBY2O39rtRouJ47sBmIN9gUZZjnWA,G8EPVSXsOYB5YQWZGiz1aVq5Pgr2GrQu,10,8,0,2,0,3,5,1,19,2.7142857142857144,1,0.0,1,0,1,0,7,3,1,5,1,2,17,1
7604,167434,itD4TUoq2Q3TVeq59M2vmGREnVktdivl,SpATywNh6bZuzm8s1ceuBUnMUAeoAHHw,27,63,22,6,10,1,8,0,110,15.714285714285714,1,0.0,17,22,6,10,46,1,0,8,0,55,55,1
7605,167466,DnweC9zfy9ur38RHmjIuaW6oqiFXCgkS,bWdj2GDclj5ofokWjzoa5jAwMkxCykd6,7,8,1,0,0,0,11,1,21,3.0,1,0.0,0,1,0,0,8,0,0,11,1,1,20,1
7606,167472,CetRT5zy2dJHyaPU2zMnW0reXnT8Dv2y,A3fsA9Zfv1X2fVEQhTw51lKENdNrEqT3,2,0,0,0,0,0,2,0,2,0.2857142857142857,1,0.0,0,0,0,0,0,0,0,2,0,0,2,1
7607,167488,vVoYtG2vzUhg3qXoaTM1GNiznwKfFexh,bWdj2GDclj5ofokWjzoa5jAwMkxCykd6,1,0,0,0,0,0,1,0,1,0.14285714285714285,1,0.0,0,0,0,0,0,0,0,1,0,0,1,1
7608,167489,mSYAcGhYeeC24f8F6IWiUOGlXEIiXJkh,SpATywNh6bZuzm8s1ceuBUnMUAeoAHHw,6,4,1,0,1,0,2,0,8,1.1428571428571428,1,0.0,0,1,0,1,4,0,0,2,0,2,6,1
7609,167531,umctuhbIVZDh6EHjPhWargzhNqVIeFMx,A3fsA9Zfv1X2fVEQhTw51lKENdNrEqT3,6,2,1,0,0,0,4,0,7,1.0,1,0.0,0,1,0,0,2,0,0,4,0,1,6,0
7610,167541,Vhkg4eDJgn0Rp70JPNuOdQoUbRDAoXSb,A3fsA9Zfv1X2fVEQhTw51lKENdNrEqT3,1,0,0,0,0,0,1,0,1,0.14285714285714285,1,0.0,0,0,0,0,0,0,0,1,0,0,1,0
7611,167552,E8lMjkJcqZcrPtGwbo8pVkzTRx8M7QkS,bWdj2GDclj5ofokWjzoa5jAwMkxCykd6,1,0,0,0,0,0,1,0,1,0.14285714285714285,1,0.0,0,0,0,0,0,0,0,1,0,0,1,1
7612,167577,eHoAPmcAKzybBYPqIBAsLFgjVfVlCiap,SpATywNh6bZuzm8s1ceuBUnMUAeoAHHw,2,0,0,0,0,0,3,0,3,0.42857142857142855,1,0.0,0,0,0,0,0,0,0,3,0,0,3,1
7613,167624,9qQce5SZ6DqKQeFsRsFiD6wzPO21moby,A3fsA9Zfv1X2fVEQhTw51lKENdNrEqT3,2,0,0,0,0,0,2,0,2,0.2857142857142857,1,0.0,0,0,0,0,0,0,0,2,0,0,2,1
7614,167635,VR79xuyJ7PSmMj6conPf0NxNjdhA8iEp,G8EPVSXsOYB5YQWZGiz1aVq5Pgr2GrQu,7,6,1,0,0,0,2,0,9,1.2857142857142858,1,0.0,0,1,0,0,6,0,0,2,0,1,8,1
7615,167641,JRUKMEmBZ3p5F0JpSVHv1lQEiMQUvro3,A3fsA9Zfv1X2fVEQhTw51lKENdNrEqT3,1,0,0,0,0,0,1,0,1,0.14285714285714285,1,0.0,0,0,0,0,0,0,0,1,0,0,1,1
7616,167655,NLi2kjhCXYFKfB8CCoscLBzBlekXHhro,SpATywNh6bZuzm8s1ceuBUnMUAeoAHHw,8,2,2,0,2,0,3,0,9,1.2857142857142858,1,0.0,0,2,0,2,2,0,0,3,0,4,5,1
7617,167690,ksWipsarCZTS7QX1xkzW3yKB8j25yNgG,bWdj2GDclj5ofokWjzoa5jAwMkxCykd6,4,1,0,0,0,0,3,0,4,0.5714285714285714,1,0.0,0,0,0,0,1,0,0,3,0,0,4,0
7618,167731,wXw48gUOB5BEkScgUyQMzs63eq0ygNDQ,A3fsA9Zfv1X2fVEQhTw51lKENdNrEqT3,2,0,0,0,0,0,2,0,2,0.2857142857142857,1,0.0,0,0,0,0,0,0,0,2,0,0,2,1
7619,167756,9oZb5hKpZvxzCcQaYVLX0TsS9OdCbI4H,bWdj2GDclj5ofokWjzoa5jAwMkxCykd6,8,10,6,0,3,0,6,0,25,3.5714285714285716,2,0.0,0,6,0,3,10,0,0,6,0,9,16,1
7620,167773,dv5Xzy3RizPqbGvGIMXlJIDl0kMrBVlb,A3fsA9Zfv1X2fVEQhTw51lKENdNrEqT3,5,2,1,0,1,0,2,0,6,0.8571428571428571,1,0.0,0,1,0,1,2,0,0,2,0,2,4,1
7621,167779,BWZyBrJDBbkcDEXyE3CSVFoVlT2CRRku,A3fsA9Zfv1X2fVEQhTw51lKENdNrEqT3,7,3,1,0,1,0,8,0,13,1.8571428571428572,2,0.0,0,1,0,1,3,0,0,8,0,2,11,1
7622,167790,qLSi3XQmUN8iJosa2X5FwVvEhgucVA2x,SpATywNh6bZuzm8s1ceuBUnMUAeoAHHw,10,13,3,0,1,0,8,0,25,3.5714285714285716,2,0.0,4,3,0,1,9,0,0,8,0,8,17,0
7623,167796,oxdAxF8oDPK7RK5K5ZEWwiPiTwAbAz6a,A3fsA9Zfv1X2fVEQhTw51lKENdNrEqT3,2,0,0,0,0,0,5,0,5,0.7142857142857143,1,0.0,0,0,0,0,0,0,0,5,0,0,5,1
7624,167797,oxdAxF8oDPK7RK5K5ZEWwiPiTwAbAz6a,bWdj2GDclj5ofokWjzoa5jAwMkxCykd6,1,0,0,0,0,0,1,0,1,0.14285714285714285,1,0.0,0,0,0,0,0,0,0,1,0,0,1,1
7625,169711,gzmN8VLkF6QCaC4IobudOv6PTgb6exUk,fbPkOYLVPtPgIt0MxizjfFJov3JbHyAi,4,2,1,0,1,0,1,0,5,0.7142857142857143,1,0.0,0,1,0,1,2,0,0,1,0,2,3,1
7626,169715,Uk2Y8qj9Cf6T7k2O1cxM5Fue4zKTF1K8,fbPkOYLVPtPgIt0MxizjfFJov3JbHyAi,1,0,0,0,0,0,1,0,1,0.14285714285714285,1,0.0,0,0,0,0,0,0,0,1,0,0,1,1
7627,169764,O8pydf8wdA8EjOBMj6o80eWX7PkIMpuy,7GRhBDsirIGkRZBtSMEzNTyDr2JQm4xx,7,1,1,0,1,1,4,1,9,1.2857142857142858,1,0.0,0,1,0,1,1,1,0,4,1,2,7,1
7628,169767,l1rg3D8Gp1lv7dbBBYKvzTS3OZ5DRjWH,7GRhBDsirIGkRZBtSMEzNTyDr2JQm4xx,11,15,6,0,3,0,2,0,26,3.7142857142857144,2,0.0,0,6,0,3,15,0,0,2,0,9,17,1
7629,169814,w7UkLHeAPhvA1M8odbbK7J9zzLA0KhPR,7GRhBDsirIGkRZBtSMEzNTyDr2JQm4xx,10,12,0,10,0,2,5,0,29,4.142857142857143,1,0.0,5,0,9,0,7,2,1,5,0,14,15,1
7630,169845,QFfUN9yxUlsMNYgpicOpe1up7xBAfW6Y,7GRhBDsirIGkRZBtSMEzNTyDr2JQm4xx,4,2,1,0,1,0,1,0,5,0.7142857142857143,1,0.0,0,1,0,1,2,0,0,1,0,2,3,1
7631,169853,Qi3PLuC7w2Yo9hFgq37MObjY8icnRdc6,7GRhBDsirIGkRZBtSMEzNTyDr2JQm4xx,14,25,9,14,1,2,4,0,55,7.857142857142857,1,0.0,6,9,12,1,19,2,2,4,0,28,27,1
7632,169893,S6HlGgJHN4fE4VtlVBKQWpgIrEWuiqMi,SpATywNh6bZuzm8s1ceuBUnMUAeoAHHw,10,9,5,0,1,6,6,1,28,4.0,1,0.0,2,5,0,1,7,6,0,6,1,8,20,1
7633,169963,i0ksX07HnsV5rQlWqOr1uKEuc7yNU24c,7GRhBDsirIGkRZBtSMEzNTyDr2JQm4xx,14,7,5,0,4,1,7,0,24,3.4285714285714284,1,0.0,1,5,0,4,6,1,0,7,0,10,14,1
7634,169984,f6KJlC1ScrQZtGOzsyUMpOtZeSqtR8rB,7GRhBDsirIGkRZBtSMEzNTyDr2JQm4xx,1,0,0,0,0,0,1,0,1,0.14285714285714285,1,0.0,0,0,0,0,0,0,0,1,0,0,1,1
7635,170023,c1BXmJNemroOPh6WUefTBD28s2WzSNwi,7GRhBDsirIGkRZBtSMEzNTyDr2JQm4xx,5,4,0,0,0,0,2,0,6,0.8571428571428571,1,0.0,1,0,0,0,3,0,0,2,0,1,5,1
7636,170043,n0HFF3TwqKuBMzzkdLCbvb8Mji5ZUnVX,7GRhBDsirIGkRZBtSMEzNTyDr2JQm4xx,5,2,1,0,1,0,2,0,6,0.8571428571428571,1,0.0,0,1,0,1,2,0,0,2,0,2,4,1
7637,170078,S6Mv1aKyTUf7xcwwDYCs3vpkSwBRaGU9,SpATywNh6bZuzm8s1ceuBUnMUAeoAHHw,3,2,0,0,0,0,1,0,3,0.42857142857142855,1,0.0,0,0,0,0,2,0,0,1,0,0,3,0
7638,170102,3v1JFL0HMqiuFdQBduyDYGcupFiSmqdG,7GRhBDsirIGkRZBtSMEzNTyDr2JQm4xx,21,26,7,14,7,0,4,0,58,8.285714285714286,2,0.0,18,7,12,7,8,0,2,4,0,44,14,1
7639,170184,JXFir7EgTVcRLR36C3eOl6MVr5FCwAGN,A3fsA9Zfv1X2fVEQhTw51lKENdNrEqT3,15,10,10,0,8,0,3,0,31,4.428571428571429,1,0.0,0,10,0,8,10,0,0,3,0,18,13,1
7640,170198,W8psMt8K6E7obsinwdemXzpwbpxCP9R1,7GRhBDsirIGkRZBtSMEzNTyDr2JQm4xx,5,10,5,0,0,0,2,0,17,2.4285714285714284,1,0.0,1,5,0,0,9,0,0,2,0,6,11,1
7641,170248,9b2fchNyVZPjqpmxjleqzL9edi9EOH23,7GRhBDsirIGkRZBtSMEzNTyDr2JQm4xx,1,0,0,0,0,0,1,0,1,0.14285714285714285,1,0.0,0,0,0,0,0,0,0,1,0,0,1,1
7642,170268,9IP5FYaoy3mLJ0e4bLrHDIO94Xx0pbLk,SpATywNh6bZuzm8s1ceuBUnMUAeoAHHw,9,15,6,0,0,0,1,0,22,3.142857142857143,1,0.0,0,6,0,0,15,0,0,1,0,6,16,1
7643,170272,CvkCRHPN9Kdm6u8tUG5peGiWArNJEfk8,7GRhBDsirIGkRZBtSMEzNTyDr2JQm4xx,22,27,7,33,14,3,7,1,92,13.142857142857142,1,0.0,19,7,28,14,8,3,5,7,1,68,24,1
7644,170436,68jxA2PUjT1NQfZbUcdmPfGR0u6r2zeM,7GRhBDsirIGkRZBtSMEzNTyDr2JQm4xx,1,0,0,0,0,0,3,0,3,0.42857142857142855,1,0.0,0,0,0,0,0,0,0,3,0,0,3,1
7645,170454,68jxA2PUjT1NQfZbUcdmPfGR0u6r2zeM,A3fsA9Zfv1X2fVEQhTw51lKENdNrEqT3,1,0,0,0,0,0,1,0,1,0.14285714285714285,1,0.0,0,0,0,0,0,0,0,1,0,0,1,1
7646,170543,Z4MdM7wvbK2oPoLlwXYYW0r3PZvWrL6Z,7GRhBDsirIGkRZBtSMEzNTyDr2JQm4xx,5,2,1,0,1,0,2,0,6,0.8571428571428571,1,0.0,0,1,0,1,2,0,0,2,0,2,4,1
7647,170558,40L77km5z19sJEVeJ6u4qpa9SAG2ZSIF,G8EPVSXsOYB5YQWZGiz1aVq5Pgr2GrQu,6,7,2,0,0,0,3,0,12,1.7142857142857142,1,0.0,4,2,0,0,3,0,0,3,0,6,6,1
7648,170604,npbzydZfydGneeM7kdEFvQEFfvT3OFkh,SpATywNh6bZuzm8s1ceuBUnMUAeoAHHw,1,0,0,0,0,0,1,0,1,0.14285714285714285,1,0.0,0,0,0,0,0,0,0,1,0,0,1,1
7649,170628,1FJgNHNZRyIkv3hAgs29ZaCmWBTNZtcq,7GRhBDsirIGkRZBtSMEzNTyDr2JQm4xx,1,0,0,0,0,0,1,0,1,0.14285714285714285,1,0.0,0,0,0,0,0,0,0,1,0,0,1,1
7650,170635,dcCbaqbKHCs7CPRffWThbopWB8akROlP,7GRhBDsirIGkRZBtSMEzNTyDr2JQm4xx,8,3,1,0,1,0,5,3,13,1.8571428571428572,1,0.0,0,1,0,1,3,0,0,5,3,2,11,1
7651,170680,xfIXdIbpI0XdgPBSDtKqxzOIzP21Dq8x,7GRhBDsirIGkRZBtSMEzNTyDr2JQm4xx,1,0,0,0,0,0,1,0,1,0.14285714285714285,1,0.0,0,0,0,0,0,0,0,1,0,0,1,1
7652,170682,K3RmvehnU0yLuzkdfShsHIJB4RyDPmXO,bWdj2GDclj5ofokWjzoa5jAwMkxCykd6,4,3,1,0,1,0,1,0,6,0.8571428571428571,1,0.0,1,1,0,1,2,0,0,1,0,3,3,1
7653,172580,WIulMAW8PLfyLvnliYk0w4Xs9IJHKZPS,7GRhBDsirIGkRZBtSMEzNTyDr2JQm4xx,1,0,0,0,0,0,1,0,1,0.14285714285714285,1,0.0,0,0,0,0,0,0,0,1,0,0,1,1
7654,172586,QSTrkUuhSEg0x9wjoRozsXEqzcdQePNj,7GRhBDsirIGkRZBtSMEzNTyDr2JQm4xx,1,0,0,0,0,0,1,0,1,0.14285714285714285,1,0.0,0,0,0,0,0,0,0,1,0,0,1,1
7655,172637,7fwVXF5ctPhb8pPmrNYDi2ycSDGABklq,7GRhBDsirIGkRZBtSMEzNTyDr2JQm4xx,1,0,0,0,0,0,2,0,2,0.2857142857142857,1,0.0,0,0,0,0,0,0,0,2,0,0,2,1
7656,172639,ZkfFwyK1OgVihBxVb6PuDCZttx0mY0GH,7GRhBDsirIGkRZBtSMEzNTyDr2JQm4xx,81,98,1,137,26,9,2,0,273,39.0,2,0.0,57,1,107,26,41,9,30,2,0,191,82,1
7657,172652,BQrTVd5AOKxfCXQ15n97ruZoGw3X3oOg,7GRhBDsirIGkRZBtSMEzNTyDr2JQm4xx,5,0,0,0,0,0,4,1,5,0.7142857142857143,1,0.0,0,0,0,0,0,0,0,4,1,0,5,1
7658,172653,GXhnYeLJGU7thFAyP76FesLSBQZtYEFj,7GRhBDsirIGkRZBtSMEzNTyDr2JQm4xx,1,0,0,0,0,0,1,0,1,0.14285714285714285,1,0.0,0,0,0,0,0,0,0,1,0,0,1,1
7659,172656,AWe1OrHic5QgI67j2F2SMPIoWgknbRTT,7GRhBDsirIGkRZBtSMEzNTyDr2JQm4xx,1,0,0,0,0,0,1,0,1,0.14285714285714285,1,0.0,0,0,0,0,0,0,0,1,0,0,1,1
7660,172680,bZ3XRxia6UScLuWULOu3ewlnF0TkayUX,7GRhBDsirIGkRZBtSMEzNTyDr2JQm4xx,4,3,1,0,0,0,2,0,6,0.8571428571428571,1,0.0,0,1,0,0,3,0,0,2,0,1,5,1
7661,172686,2umGjyQGiFi0nRyyzYdQU4YlPFMXEUMJ,7GRhBDsirIGkRZBtSMEzNTyDr2JQm4xx,5,2,0,0,0,0,3,0,5,0.7142857142857143,1,0.0,0,0,0,0,2,0,0,3,0,0,5,1
7662,172687,Hofgj6U6Hb3QZslFyBygVjWjwrzFRzS4,7GRhBDsirIGkRZBtSMEzNTyDr2JQm4xx,5,2,1,0,1,0,2,0,6,0.8571428571428571,1,0.0,0,1,0,1,2,0,0,2,0,2,4,1
7663,172698,4K9c4s8wbYa5MpdlPvKSdwuXWOFTVcAh,7GRhBDsirIGkRZBtSMEzNTyDr2JQm4xx,2,0,0,0,0,0,2,0,2,0.2857142857142857,1,0.0,0,0,0,0,0,0,0,2,0,0,2,1
7664,172735,Uxd7sramSgOYbTkMuTemo7Lms4lBJja0,7GRhBDsirIGkRZBtSMEzNTyDr2JQm4xx,33,31,17,0,13,0,6,0,67,9.571428571428571,2,0.0,0,17,0,13,31,0,0,6,0,30,37,1
7665,172741,Y51MqWhaiGyWdNickwBkKEZ7LC7se5uV,7GRhBDsirIGkRZBtSMEzNTyDr2JQm4xx,1,0,0,0,0,0,1,0,1,0.14285714285714285,1,0.0,0,0,0,0,0,0,0,1,0,0,1,1
7666,172746,0dwnge5EOc1G7OI2GIE4cTm6v44kkXQF,7GRhBDsirIGkRZBtSMEzNTyDr2JQm4xx,1,0,0,0,0,0,1,0,1,0.14285714285714285,1,0.0,0,0,0,0,0,0,0,1,0,0,1,1
7667,172787,YY7yHizDn0UpGHVq4qoTfbulP3ev5TkC,fbPkOYLVPtPgIt0MxizjfFJov3JbHyAi,6,3,2,0,2,0,1,0,8,1.1428571428571428,1,0.0,0,2,0,2,3,0,0,1,0,4,4,1
7668,173107,4Uyhf3xkbmSb7blGg2niZUhegHNb0hzL,RXDvfPUBYFlVdlueBFbLW0mhhAyGEqpt,4,3,1,0,0,0,2,0,6,0.8571428571428571,1,0.0,0,1,0,0,3,0,0,2,0,1,5,1
7669,173132,IiVLoMJOOO6WIlHpWZzTbrIoLgzhhi73,A3fsA9Zfv1X2fVEQhTw51lKENdNrEqT3,22,11,8,16,7,0,5,0,47,6.714285714285714,1,0.0,2,8,13,7,9,0,3,5,0,30,17,1
7670,173146,p9UNvuDUoGgEq49Fv2ZMxggXXq1CzTMu,SpATywNh6bZuzm8s1ceuBUnMUAeoAHHw,13,43,11,10,2,6,15,1,88,12.571428571428571,2,0.0,20,11,10,2,23,6,0,15,1,43,45,1
7671,173161,3OBHdoV61de7ICMrnWAXr689Eb2AyuN0,bWdj2GDclj5ofokWjzoa5jAwMkxCykd6,7,9,4,0,3,0,6,0,22,3.142857142857143,2,0.0,0,4,0,3,9,0,0,6,0,7,15,1
7672,173169,Q99tY6BQBfoYxTWMIDBzu9lKtLusDydm,SpATywNh6bZuzm8s1ceuBUnMUAeoAHHw,6,0,0,0,0,2,16,4,22,3.142857142857143,2,0.0,0,0,0,0,0,2,0,16,4,0,22,1
7673,173175,hg0Y9I3uepRleBrpQgMC0flFaJC1a5b5,SpATywNh6bZuzm8s1ceuBUnMUAeoAHHw,1,0,0,0,0,0,1,0,1,0.14285714285714285,1,0.0,0,0,0,0,0,0,0,1,0,0,1,1
7674,173216,55qFOvzjFp79P87tCKKcDPlhphK7gh3v,bWdj2GDclj5ofokWjzoa5jAwMkxCykd6,1,0,0,0,0,0,1,0,1,0.14285714285714285,1,0.0,0,0,0,0,0,0,0,1,0,0,1,1
7675,173230,G0Iaa3Ru4yPHix0W4Oym2wsHGEPhwa0d,bWdj2GDclj5ofokWjzoa5jAwMkxCykd6,7,6,1,0,1,0,5,1,14,2.0,1,0.0,2,1,0,1,4,0,0,5,1,4,10,1
7676,173235,eAe5usC174Ujb9GhpQmntkASbUTyc3ZW,SpATywNh6bZuzm8s1ceuBUnMUAeoAHHw,11,9,6,0,4,0,9,0,28,4.0,1,0.0,0,6,0,4,9,0,0,9,0,10,18,1
7677,173249,qggUO4B0NhIPqMhJwgIAZM8ZaIbpr9nE,bWdj2GDclj5ofokWjzoa5jAwMkxCykd6,9,16,10,0,5,0,5,0,36,5.142857142857143,1,0.0,1,10,0,5,15,0,0,5,0,16,20,1
7678,173267,8uSQsFhnhoJeSVZylwMfyqKR37MO9Qyr,RXDvfPUBYFlVdlueBFbLW0mhhAyGEqpt,4,2,1,0,1,0,1,0,5,0.7142857142857143,1,0.0,0,1,0,1,2,0,0,1,0,2,3,1
7679,173269,CVWG6F2iwkhpH91rOg9zh1AtSbOQkfbH,A3fsA9Zfv1X2fVEQhTw51lKENdNrEqT3,2,0,0,0,0,0,4,0,4,0.5714285714285714,1,0.0,0,0,0,0,0,0,0,4,0,0,4,1
7680,173330,l1rg3D8Gp1lv7dbBBYKvzTS3OZ5DRjWH,SpATywNh6bZuzm8s1ceuBUnMUAeoAHHw,1,0,0,0,0,0,1,0,1,0.14285714285714285,1,0.0,0,0,0,0,0,0,0,1,0,0,1,1
7681,173343,b7SUdO6QxE15XMARzgNrelIPh5ZxATAg,SpATywNh6bZuzm8s1ceuBUnMUAeoAHHw,16,20,9,23,4,2,3,1,62,8.857142857142858,1,0.0,7,9,19,4,13,2,4,3,1,39,23,1
7682,173373,1ZxIq2EElt84sjQ7d0VZrg3vpxtlpcZe,A3fsA9Zfv1X2fVEQhTw51lKENdNrEqT3,10,8,4,0,3,0,1,0,16,2.2857142857142856,1,0.0,0,4,0,3,8,0,0,1,0,7,9,0
7683,173395,1rAx2MzCP3OdnS9l4ZxlmSEx7YN3W0Gb,SpATywNh6bZuzm8s1ceuBUnMUAeoAHHw,7,7,1,0,1,0,4,0,13,1.8571428571428572,1,0.0,0,1,0,1,7,0,0,4,0,2,11,1
7684,173427,pZclLMasmWwcOV7UoObjB05HxqI7cJ5M,RXDvfPUBYFlVdlueBFbLW0mhhAyGEqpt,1,0,0,0,0,0,1,0,1,0.14285714285714285,1,0.0,0,0,0,0,0,0,0,1,0,0,1,1
7685,173429,pZclLMasmWwcOV7UoObjB05HxqI7cJ5M,A3fsA9Zfv1X2fVEQhTw51lKENdNrEqT3,1,0,0,0,0,0,1,0,1,0.14285714285714285,1,0.0,0,0,0,0,0,0,0,1,0,0,1,1
7686,173441,jQV5ACK38puVA98RZWJrb2Gyr0Mic373,SpATywNh6bZuzm8s1ceuBUnMUAeoAHHw,20,24,10,0,8,4,5,1,52,7.428571428571429,1,0.0,12,10,0,8,12,4,0,5,1,30,22,1
7687,173462,l1rg3D8Gp1lv7dbBBYKvzTS3OZ5DRjWH,RXDvfPUBYFlVdlueBFbLW0mhhAyGEqpt,1,0,0,0,0,0,1,0,1,0.14285714285714285,1,0.0,0,0,0,0,0,0,0,1,0,0,1,1
7688,173471,zvLkVcjFtCYyIxQ5AgxEHNEKFJjc1e0w,SpATywNh6bZuzm8s1ceuBUnMUAeoAHHw,17,11,8,12,5,3,8,1,48,6.857142857142857,2,0.0,2,8,9,5,9,3,3,8,1,24,24,1
7689,173480,z3ey1NJRJhuGG3iwCXYitfKXJ1Ty9TFL,bWdj2GDclj5ofokWjzoa5jAwMkxCykd6,6,4,1,0,0,0,5,0,10,1.4285714285714286,2,0.0,1,1,0,0,3,0,0,5,0,2,8,1
7690,173551,VfzK5aO28OrAOvVXtOq353z79D2I5ZHx,SpATywNh6bZuzm8s1ceuBUnMUAeoAHHw,22,27,15,0,9,9,11,0,71,10.142857142857142,2,0.0,8,15,0,9,19,9,0,11,0,32,39,0
7691,173569,pPWrFxlyBbGTjAYm5iDIHfNugNgnbATN,G8EPVSXsOYB5YQWZGiz1aVq5Pgr2GrQu,32,34,18,74,9,12,10,1,158,22.571428571428573,1,0.0,12,18,62,9,22,12,12,10,1,101,57,1
7692,173570,5tgxttwTGvGdqr8cj2QgTLRxUmP4TAY4,SpATywNh6bZuzm8s1ceuBUnMUAeoAHHw,8,10,5,0,2,0,6,1,24,3.4285714285714284,1,0.0,2,5,0,2,8,0,0,6,1,9,15,1
7693,173576,5s2QZF0oRCYI8h2ElmgC6T7pH2gEDZ5h,SpATywNh6bZuzm8s1ceuBUnMUAeoAHHw,1,0,0,0,0,0,1,0,1,0.14285714285714285,1,0.0,0,0,0,0,0,0,0,1,0,0,1,1
7694,173606,5uCuxLE5XjM4y4nmjuWckCuNM8tm7Xz4,SpATywNh6bZuzm8s1ceuBUnMUAeoAHHw,3,2,0,0,0,0,1,0,3,0.42857142857142855,1,0.0,0,0,0,0,2,0,0,1,0,0,3,1
7695,173625,InWzQofmWk3UUIO2mLGTDK9j8XVQqQav,SpATywNh6bZuzm8s1ceuBUnMUAeoAHHw,1,0,0,0,0,0,1,0,1,0.14285714285714285,1,0.0,0,0,0,0,0,0,0,1,0,0,1,1
7696,173652,dzkU7a9rkvja83jr7hi3MLZJCXGqFq8k,bWdj2GDclj5ofokWjzoa5jAwMkxCykd6,4,2,0,0,0,0,2,0,4,0.5714285714285714,1,0.0,0,0,0,0,2,0,0,2,0,0,4,1
7697,173655,QfXTKSibNslqH18MyW3petQKWGiJxDlu,SpATywNh6bZuzm8s1ceuBUnMUAeoAHHw,5,10,4,0,0,0,2,0,16,2.2857142857142856,1,0.0,5,4,0,0,5,0,0,2,0,9,7,1
7698,173659,Lip64fuGzBG9bHRLCDw8nCt2gpYw3z1x,SpATywNh6bZuzm8s1ceuBUnMUAeoAHHw,4,2,1,0,1,0,1,0,5,0.7142857142857143,1,0.0,0,1,0,1,2,0,0,1,0,2,3,1
7699,173670,QqiwZUOB51djz0tMukIyFdlQb4Z6iwAX,SpATywNh6bZuzm8s1ceuBUnMUAeoAHHw,7,2,1,0,1,0,4,0,8,1.1428571428571428,1,0.0,0,1,0,1,2,0,0,4,0,2,6,1
7700,173672,vJ4UKNeuK5ggw4DX9ClwnqNtdiFYCRPF,G8EPVSXsOYB5YQWZGiz1aVq5Pgr2GrQu,1,0,0,0,0,0,1,0,1,0.14285714285714285,1,0.0,0,0,0,0,0,0,0,1,0,0,1,1
7701,173679,NN4GiQISIB9GdLTS8U7HRzfPuCQVrfY9,SpATywNh6bZuzm8s1ceuBUnMUAeoAHHw,16,15,5,34,2,2,7,0,65,9.285714285714286,1,0.0,9,5,31,2,6,2,3,7,0,47,18,1
7702,173694,g2VgGARpgGy9rA8aDCffqfXvItMu95Qi,SpATywNh6bZuzm8s1ceuBUnMUAeoAHHw,1,0,0,0,0,0,1,0,1,0.14285714285714285,1,0.0,0,0,0,0,0,0,0,1,0,0,1,1
7703,173748,wymqx0ld7yvIDGrfVTrgZliVZU4YCmE4,G8EPVSXsOYB5YQWZGiz1aVq5Pgr2GrQu,6,5,0,0,0,0,2,0,7,1.0,1,0.0,0,0,0,0,5,0,0,2,0,0,7,1
7704,173803,rZWsxN7JeP5OFYbUn0RS9NxjY5ZERM0R,bWdj2GDclj5ofokWjzoa5jAwMkxCykd6,5,2,1,0,1,0,3,0,7,1.0,2,0.0,0,1,0,1,2,0,0,3,0,2,5,1
7705,173854,quIYM1jY47tlZKkC1EmJRDFcBV4a3Pzy,A3fsA9Zfv1X2fVEQhTw51lKENdNrEqT3,1,0,0,0,0,0,1,0,1,0.14285714285714285,1,0.0,0,0,0,0,0,0,0,1,0,0,1,1
7706,173859,pPZkiQmDPKqQ9IZ0jTf8ExIfHdZSz9Tp,bWdj2GDclj5ofokWjzoa5jAwMkxCykd6,1,0,0,0,0,0,1,0,1,0.14285714285714285,1,0.0,0,0,0,0,0,0,0,1,0,0,1,1
7707,173869,oc7rYZFgg4c4rgCWuUOquFZJ5FqnUHSF,bWdj2GDclj5ofokWjzoa5jAwMkxCykd6,6,7,1,0,1,0,3,0,12,1.7142857142857142,1,0.0,1,1,0,1,6,0,0,3,0,3,9,1
7708,173872,Wx0PLmR8YQAVeoFy76pJe5bN12QOsMrr,A3fsA9Zfv1X2fVEQhTw51lKENdNrEqT3,3,5,0,0,0,0,1,0,6,0.8571428571428571,1,0.0,0,0,0,0,5,0,0,1,0,0,6,1
7709,173880,worFKZrD9eECXAuz5EQKtbbV0K7MG3Jl,A3fsA9Zfv1X2fVEQhTw51lKENdNrEqT3,5,2,1,0,1,0,2,0,6,0.8571428571428571,1,0.0,0,1,0,1,2,0,0,2,0,2,4,1
7710,173918,dr13KuqOo10EJH5V4oOgMy17ewEUhD7o,SpATywNh6bZuzm8s1ceuBUnMUAeoAHHw,3,2,1,0,0,0,1,0,4,0.5714285714285714,1,0.0,0,1,0,0,2,0,0,1,0,1,3,1
7711,173934,WI9rk8aS11tBAJzjcX0JSIgomYYRQVjW,RXDvfPUBYFlVdlueBFbLW0mhhAyGEqpt,20,20,1,0,1,2,11,3,38,5.428571428571429,2,0.0,0,1,0,1,20,2,0,11,3,2,36,0
7712,173958,wLc4w0avBex1xIgZCkms6IVr5BNBkA7D,bWdj2GDclj5ofokWjzoa5jAwMkxCykd6,1,0,0,0,0,0,1,0,1,0.14285714285714285,1,0.0,0,0,0,0,0,0,0,1,0,0,1,1
7713,173959,wLc4w0avBex1xIgZCkms6IVr5BNBkA7D,G8EPVSXsOYB5YQWZGiz1aVq5Pgr2GrQu,1,0,0,0,0,0,1,0,1,0.14285714285714285,1,0.0,0,0,0,0,0,0,0,1,0,0,1,1
7714,174032,WLXtV9xU02TWrBcV5JQ79YomKzdOBWBA,RXDvfPUBYFlVdlueBFbLW0mhhAyGEqpt,4,4,2,0,0,0,1,0,7,1.0,1,0.0,0,2,0,0,4,0,0,1,0,2,5,1
7715,174046,DXGwefPqbHu4FBeaKolUD6Ln1C2rCmyf,G8EPVSXsOYB5YQWZGiz1aVq5Pgr2GrQu,25,31,11,40,6,1,10,4,103,14.714285714285714,1,0.0,9,11,30,6,22,1,10,10,4,56,47,0
7716,174049,8X2IzVay8QcdAEdyXNzTeeH0ARyTPIC0,SpATywNh6bZuzm8s1ceuBUnMUAeoAHHw,6,8,3,0,4,0,1,0,16,2.2857142857142856,1,0.0,0,3,0,4,8,0,0,1,0,7,9,0
7717,174052,WXV25nLp7cw3t4qC0Fe3ygibuK55tgf8,G8EPVSXsOYB5YQWZGiz1aVq5Pgr2GrQu,2,0,0,0,0,0,2,0,2,0.2857142857142857,1,0.0,0,0,0,0,0,0,0,2,0,0,2,1
7718,174082,Q3T5Pj9Os86NEqSmgUZNRoi8BUkSoDlj,A3fsA9Zfv1X2fVEQhTw51lKENdNrEqT3,1,0,0,0,0,0,3,0,3,0.42857142857142855,1,0.0,0,0,0,0,0,0,0,3,0,0,3,1
7719,174116,89IraAtUfhoGAQgzdMP1844g2s2iN4Ox,SpATywNh6bZuzm8s1ceuBUnMUAeoAHHw,12,9,3,13,3,0,3,0,31,4.428571428571429,2,0.0,4,3,13,3,5,0,0,3,0,23,8,1
7720,174121,y0CnonzJAddQ4oYr5LBSP0Y6KP3RgPGg,A3fsA9Zfv1X2fVEQhTw51lKENdNrEqT3,4,2,1,0,1,0,2,0,6,0.8571428571428571,1,0.0,0,1,0,1,2,0,0,2,0,2,4,1
7721,174126,TmcXoxCT48jZhYzJE3XlHytbzJ2TbpDY,A3fsA9Zfv1X2fVEQhTw51lKENdNrEqT3,7,4,2,6,0,0,3,0,15,2.142857142857143,1,0.0,0,2,5,0,4,0,1,3,0,7,8,1
7722,174151,CYfp5XD3W4sJRVjPRPe04xpN1AZbw9Yo,A3fsA9Zfv1X2fVEQhTw51lKENdNrEqT3,2,0,0,0,0,0,3,0,3,0.42857142857142855,1,0.0,0,0,0,0,0,0,0,3,0,0,3,1
7723,174168,y4jCbRq0ZMCabQVeAWisCVju9AF82joj,SpATywNh6bZuzm8s1ceuBUnMUAeoAHHw,11,24,1,21,0,3,6,0,55,7.857142857142857,2,0.0,16,1,20,0,8,3,1,6,0,37,18,1
7724,174181,lfpXyXNaegoXeiZXYzm52nn3ZFsKBMvI,SpATywNh6bZuzm8s1ceuBUnMUAeoAHHw,10,12,8,0,5,0,5,0,30,4.285714285714286,2,0.0,1,8,0,5,11,0,0,5,0,14,16,1
7725,174187,j7bASIUMnf4CT11rRWorZg0FZhBTc03O,A3fsA9Zfv1X2fVEQhTw51lKENdNrEqT3,14,8,6,0,6,1,5,1,27,3.857142857142857,1,0.0,0,6,0,6,8,1,0,5,1,12,15,1
7726,174206,8MuGb55gUM18pukCITXgZoTSobqXs9G4,RXDvfPUBYFlVdlueBFbLW0mhhAyGEqpt,1,0,0,0,0,0,2,0,2,0.2857142857142857,2,0.0,0,0,0,0,0,0,0,2,0,0,2,1
7727,174234,Dl6PswZ2ZYiCfnhIcCRn4UIAM0nQUpoC,G8EPVSXsOYB5YQWZGiz1aVq5Pgr2GrQu,3,2,0,0,0,0,1,0,3,0.42857142857142855,1,0.0,0,0,0,0,2,0,0,1,0,0,3,1
7728,174256,lb2vEQsRSFOUOLUPsaKbebc6S33mhh7Z,SpATywNh6bZuzm8s1ceuBUnMUAeoAHHw,2,0,0,0,0,0,2,0,2,0.2857142857142857,1,0.0,0,0,0,0,0,0,0,2,0,0,2,0
7729,174274,xzqF2LiZ7Zp1COlqOBger1kuvNL9t5JK,SpATywNh6bZuzm8s1ceuBUnMUAeoAHHw,1,0,0,0,0,0,1,0,1,0.14285714285714285,1,0.0,0,0,0,0,0,0,0,1,0,0,1,1
7730,174277,GQaFlkVp1r2Jb2YbiuWBbDDwc8QpDAHv,SpATywNh6bZuzm8s1ceuBUnMUAeoAHHw,9,8,6,0,3,2,1,0,20,2.857142857142857,1,0.0,0,6,0,3,8,2,0,1,0,9,11,1
7731,174290,m2ZLzpDl6tgvDR1yy6DPvftlSHnPZA0w,SpATywNh6bZuzm8s1ceuBUnMUAeoAHHw,1,0,0,0,0,0,1,0,1,0.14285714285714285,1,0.0,0,0,0,0,0,0,0,1,0,0,1,1
7732,174293,ZikrDKT0jI7fYxhfVuJrd7XXP7MsQajU,RXDvfPUBYFlVdlueBFbLW0mhhAyGEqpt,7,2,1,0,1,0,4,0,8,1.1428571428571428,1,0.0,0,1,0,1,2,0,0,4,0,2,6,1
7733,174301,m03K9KziYA4aijvIDRK7t2E4lIAdgRz2,RXDvfPUBYFlVdlueBFbLW0mhhAyGEqpt,4,2,1,0,1,0,1,0,5,0.7142857142857143,2,0.0,0,1,0,1,2,0,0,1,0,2,3,1
7734,174365,TDTdTCIURzk1Bl0eZfd6udEe9QlGGMaa,SpATywNh6bZuzm8s1ceuBUnMUAeoAHHw,1,0,0,0,0,0,1,0,1,0.14285714285714285,1,0.0,0,0,0,0,0,0,0,1,0,0,1,1
7735,174377,BeoWdDFNsVFqWVq3B4qjYh8vNjNTgwSB,bWdj2GDclj5ofokWjzoa5jAwMkxCykd6,12,12,8,0,4,0,22,0,46,6.571428571428571,2,0.0,0,8,0,4,12,0,0,22,0,12,34,1
7736,174421,mSZYyfRNnqnDs7qyuaQEMEvx5vC2JS4M,A3fsA9Zfv1X2fVEQhTw51lKENdNrEqT3,24,16,11,34,9,0,3,0,73,10.428571428571429,2,0.0,2,11,26,9,14,0,8,3,0,48,25,0
7737,174440,0t4jRqsyu2b51z09AohkTBv9a8OIUmuF,SpATywNh6bZuzm8s1ceuBUnMUAeoAHHw,2,0,0,0,0,0,2,0,2,0.2857142857142857,1,0.0,0,0,0,0,0,0,0,2,0,0,2,1
7738,174455,SjtyUL4RbrEJ36TmtDDzIzVYsveRIJ1b,bWdj2GDclj5ofokWjzoa5jAwMkxCykd6,4,2,0,0,0,0,2,0,4,0.5714285714285714,1,0.0,0,0,0,0,2,0,0,2,0,0,4,1
7739,174467,vnBONRqvzvm1KY9GmYXYArKs5stTyMmI,SpATywNh6bZuzm8s1ceuBUnMUAeoAHHw,20,13,7,16,4,2,9,5,56,8.0,1,0.0,4,7,13,4,9,2,3,9,5,28,28,0
7740,174478,EhHrinjt1AkEWC09AFZwBuP61S5NJgjn,SpATywNh6bZuzm8s1ceuBUnMUAeoAHHw,16,15,5,36,0,9,6,0,71,10.142857142857142,2,0.0,7,5,30,0,8,9,6,6,0,42,29,0
7741,174493,4G31JkuuWxQoMwYLKWmTZsOhrqR0raRg,SpATywNh6bZuzm8s1ceuBUnMUAeoAHHw,6,3,1,0,1,0,2,0,7,1.0,1,0.0,0,1,0,1,3,0,0,2,0,2,5,1
7742,174498,ZKJhytrxdXS5RaM2M9yN55tRum5T67Xk,SpATywNh6bZuzm8s1ceuBUnMUAeoAHHw,14,12,2,15,1,1,2,0,33,4.714285714285714,1,0.0,2,2,14,1,10,1,1,2,0,19,14,1
7743,174499,mBTzaYN6U4cNwjdbd3oK6uaVLfiAM7NK,G8EPVSXsOYB5YQWZGiz1aVq5Pgr2GrQu,7,4,1,0,2,0,2,0,9,1.2857142857142858,1,0.0,0,1,0,2,4,0,0,2,0,3,6,1
7744,174502,4G31JkuuWxQoMwYLKWmTZsOhrqR0raRg,A3fsA9Zfv1X2fVEQhTw51lKENdNrEqT3,10,7,1,0,1,0,2,0,11,1.5714285714285714,1,0.0,0,1,0,1,7,0,0,2,0,2,9,1
7745,174506,uHZhFUoOlSaoYs0uE4nLbnPxUYbY0Yrk,SpATywNh6bZuzm8s1ceuBUnMUAeoAHHw,4,2,1,0,1,0,1,0,5,0.7142857142857143,1,0.0,0,1,0,1,2,0,0,1,0,2,3,1
7746,174510,1JwhB7sCpqQuMWgVLCoQdnUSus34sW5p,SpATywNh6bZuzm8s1ceuBUnMUAeoAHHw,16,36,14,12,8,1,8,2,81,11.571428571428571,2,0.0,12,14,9,8,24,1,3,8,2,43,38,1
7747,174513,1JwhB7sCpqQuMWgVLCoQdnUSus34sW5p,A3fsA9Zfv1X2fVEQhTw51lKENdNrEqT3,8,12,1,0,0,0,5,0,18,2.5714285714285716,2,0.0,0,1,0,0,12,0,0,5,0,1,17,1
7748,174541,FOCCuGaJ7zYTl7CCCo7T3PqrLtxGVeiU,A3fsA9Zfv1X2fVEQhTw51lKENdNrEqT3,36,25,0,50,0,6,7,0,88,12.571428571428571,1,0.0,2,0,45,0,23,6,5,7,0,47,41,1
7749,174545,ghkFruWSKEsLlDR9iiyligX2yJuxgpBc,bWdj2GDclj5ofokWjzoa5jAwMkxCykd6,2,0,0,0,0,0,3,0,3,0.42857142857142855,1,0.0,0,0,0,0,0,0,0,3,0,0,3,1
7750,174563,m98O4dP1opmo7o2tpUGDqrUnbkirc7sM,A3fsA9Zfv1X2fVEQhTw51lKENdNrEqT3,12,17,0,0,0,1,2,0,20,2.857142857142857,1,0.0,1,0,0,0,16,1,0,2,0,1,19,1
7751,174581,SKmQOLoApKRqa0N0zki38NHNgkClkW5s,SpATywNh6bZuzm8s1ceuBUnMUAeoAHHw,1,0,0,0,0,0,1,0,1,0.14285714285714285,1,0.0,0,0,0,0,0,0,0,1,0,0,1,1
7752,174607,zbOrtc172Sp0ZiF8CTU6kMNb51nYxkNM,SpATywNh6bZuzm8s1ceuBUnMUAeoAHHw,7,3,2,0,2,0,2,0,9,1.2857142857142858,1,0.0,0,2,0,2,3,0,0,2,0,4,5,1
7753,174618,364stkhSwXjUJtELSEaOhKFcZM4gOjC8,SpATywNh6bZuzm8s1ceuBUnMUAeoAHHw,1,0,0,0,0,0,1,0,1,0.14285714285714285,1,0.0,0,0,0,0,0,0,0,1,0,0,1,1
7754,174665,6WpUAvOn0104PVGU1qRupfdkikcVBl8O,bWdj2GDclj5ofokWjzoa5jAwMkxCykd6,5,6,3,0,1,0,2,0,12,1.7142857142857142,2,0.0,0,3,0,1,6,0,0,2,0,4,8,1
7755,174692,xMCJ7gcgv1mN5rb4Qh9dpQVUc9zQ1NLX,SpATywNh6bZuzm8s1ceuBUnMUAeoAHHw,11,18,4,2,0,16,16,3,59,8.428571428571429,4,0.0,0,4,2,0,18,16,0,16,3,6,53,1
7756,174699,Qn3OccgDXQpcut9yLA9jXfau6FPbS72n,G8EPVSXsOYB5YQWZGiz1aVq5Pgr2GrQu,1,0,0,0,0,0,2,0,2,0.2857142857142857,1,0.0,0,0,0,0,0,0,0,2,0,0,2,1
7757,174703,Nu3CWEbOlEVCvqetIYQvBCpTSFLSYvQK,SpATywNh6bZuzm8s1ceuBUnMUAeoAHHw,23,54,3,17,3,10,20,2,109,15.571428571428571,3,0.0,6,3,14,3,48,10,3,20,2,26,83,1
7758,174704,ExNrdfeKsdYl3xmpiJlCBa13JPKyssuX,bWdj2GDclj5ofokWjzoa5jAwMkxCykd6,1,0,0,0,0,0,2,0,2,0.2857142857142857,2,0.0,0,0,0,0,0,0,0,2,0,0,2,1
7759,174718,Bos3zEEnAcYzPXQktMkJJ0ak5mhGWCAf,RXDvfPUBYFlVdlueBFbLW0mhhAyGEqpt,6,7,3,0,0,0,2,0,12,1.7142857142857142,1,0.0,1,3,0,0,6,0,0,2,0,4,8,1
7760,174776,Cx0tee2LW48hN6gexDH5QIypELm3snyx,SpATywNh6bZuzm8s1ceuBUnMUAeoAHHw,10,8,5,0,2,3,8,2,28,4.0,1,0.0,0,5,0,2,8,3,0,8,2,7,21,1
7761,174782,lJdTg9WUYwumFfeQmhmLXhBEAFP0NsAi,bWdj2GDclj5ofokWjzoa5jAwMkxCykd6,5,2,1,0,1,0,2,0,6,0.8571428571428571,1,0.0,0,1,0,1,2,0,0,2,0,2,4,1
7762,174791,KOAZzInqWpDIVXEW7JyQaWggITRPncK9,SpATywNh6bZuzm8s1ceuBUnMUAeoAHHw,1,0,0,0,0,0,1,0,1,0.14285714285714285,1,0.0,0,0,0,0,0,0,0,1,0,0,1,1
7763,174810,f3LuhvFBRGY0JOGlDxTNaj2JOJbt7lLA,SpATywNh6bZuzm8s1ceuBUnMUAeoAHHw,6,2,1,0,1,0,3,0,7,1.0,1,0.0,0,1,0,1,2,0,0,3,0,2,5,0
7764,174813,Bau8Ni7vPFHL0Lb3hYTZjsOuiN8oYfUJ,A3fsA9Zfv1X2fVEQhTw51lKENdNrEqT3,1,0,0,0,0,0,1,0,1,0.14285714285714285,1,0.0,0,0,0,0,0,0,0,1,0,0,1,1
7765,174820,JIZNiH5rUr2fGUoXZgKLocS74nHb5Kfe,SpATywNh6bZuzm8s1ceuBUnMUAeoAHHw,7,2,1,0,1,2,5,0,11,1.5714285714285714,1,0.0,0,1,0,1,2,2,0,5,0,2,9,1
7766,174878,fUQHFT4QEMRSPqJAQlXlvlyNwca9Q0dU,RXDvfPUBYFlVdlueBFbLW0mhhAyGEqpt,18,29,2,22,2,0,2,0,57,8.142857142857142,2,0.0,2,2,21,2,27,0,1,2,0,27,30,1
7767,174885,wRvAUuJF3e8pqF4oxebNspXV7iBtMI7e,SpATywNh6bZuzm8s1ceuBUnMUAeoAHHw,1,0,0,0,0,0,1,0,1,0.14285714285714285,1,0.0,0,0,0,0,0,0,0,1,0,0,1,1
7768,174900,5zea5vrXS7Bt1LjTuEN0slFtYiNlymMO,A3fsA9Zfv1X2fVEQhTw51lKENdNrEqT3,7,5,0,0,0,0,3,0,8,1.1428571428571428,1,0.0,0,0,0,0,5,0,0,3,0,0,8,1
7769,174927,A6qBZik0VBfWjUh1l97ldNrUQvZV7VDA,A3fsA9Zfv1X2fVEQhTw51lKENdNrEqT3,1,0,0,0,0,0,1,0,1,0.14285714285714285,1,0.0,0,0,0,0,0,0,0,1,0,0,1,1
7770,174949,YXkiTHpE2a6E2kDFUh3HT5sKHSlA7gXq,bWdj2GDclj5ofokWjzoa5jAwMkxCykd6,16,16,7,0,7,0,2,0,32,4.571428571428571,1,0.0,8,7,0,7,8,0,0,2,0,22,10,1
7771,174969,KNwOU3S87AmXfVT27bvvRv8ipePthXCY,SpATywNh6bZuzm8s1ceuBUnMUAeoAHHw,11,21,1,13,0,1,2,0,38,5.428571428571429,1,0.0,15,1,10,0,6,1,3,2,0,26,12,1
7772,174982,0MmlbOf0DHxRZhBoMcyjh2941ezon8FA,SpATywNh6bZuzm8s1ceuBUnMUAeoAHHw,7,6,3,0,2,0,1,0,12,1.7142857142857142,1,0.0,0,3,0,2,6,0,0,1,0,5,7,1
7773,174991,UGNnaAmmHc9OFVaFlHMVxlDwTqvJ9WLn,bWdj2GDclj5ofokWjzoa5jAwMkxCykd6,1,0,0,0,0,0,1,0,1,0.14285714285714285,1,0.0,0,0,0,0,0,0,0,1,0,0,1,1
7774,175009,bd7vHnljHgvVUg5G5sT2JbyZM9wuH2wF,SpATywNh6bZuzm8s1ceuBUnMUAeoAHHw,4,10,0,0,0,0,1,0,11,1.5714285714285714,1,0.0,2,0,0,0,8,0,0,1,0,2,9,1
7775,175021,cpZrl3oP8x5CfyDGz9KAwfLq9wo2kZMm,RXDvfPUBYFlVdlueBFbLW0mhhAyGEqpt,27,37,12,44,8,0,10,0,111,15.857142857142858,2,0.0,12,12,39,8,25,0,5,10,0,71,40,1
7776,175028,RHEMdhoy3TVz84IqO3CiO0ZVmx7sjl4N,bWdj2GDclj5ofokWjzoa5jAwMkxCykd6,4,2,1,0,1,0,2,0,6,0.8571428571428571,1,0.0,0,1,0,1,2,0,0,2,0,2,4,1
7777,175037,Y3qAwvAkfEroY8Y6AzBfazMCosAJgRZ3,SpATywNh6bZuzm8s1ceuBUnMUAeoAHHw,6,2,1,0,1,0,3,0,7,1.0,1,0.0,0,1,0,1,2,0,0,3,0,2,5,1
7778,175057,WoXtpP4H4ghgkRBv3UuiyrHP7GFAl55y,bWdj2GDclj5ofokWjzoa5jAwMkxCykd6,1,0,0,0,0,0,1,0,1,0.14285714285714285,1,0.0,0,0,0,0,0,0,0,1,0,0,1,1
7779,175069,4TvXiLQVsUU0sQ96NFZAreKy5tMXycWg,SpATywNh6bZuzm8s1ceuBUnMUAeoAHHw,4,2,0,0,0,0,2,0,4,0.5714285714285714,1,0.0,0,0,0,0,2,0,0,2,0,0,4,1
7780,175071,SP5kRtjsDOoGpzdvGCfZdzeWgxpoSNBK,G8EPVSXsOYB5YQWZGiz1aVq5Pgr2GrQu,1,0,0,0,0,0,2,0,2,0.2857142857142857,1,0.0,0,0,0,0,0,0,0,2,0,0,2,1
7781,175118,azb7CJ1Bmhkt4qbwHzuZGxEpJ1dCkFJu,G8EPVSXsOYB5YQWZGiz1aVq5Pgr2GrQu,5,2,1,0,1,0,3,0,7,1.0,1,0.0,0,1,0,1,2,0,0,3,0,2,5,1
7782,175132,0Vpaa5lAyqNTaFltvCAV7J9K7ZDbZPNf,SpATywNh6bZuzm8s1ceuBUnMUAeoAHHw,2,0,0,0,0,0,2,0,2,0.2857142857142857,1,0.0,0,0,0,0,0,0,0,2,0,0,2,1
7783,175152,WAC7RGZ1uYeT92igfYiLgTnHWPEtN2IA,bWdj2GDclj5ofokWjzoa5jAwMkxCykd6,4,2,1,0,1,0,1,0,5,0.7142857142857143,1,0.0,0,1,0,1,2,0,0,1,0,2,3,1
7784,175194,8RK6HQkv51lSsSE1n9EptQjyHrkMwfO0,A3fsA9Zfv1X2fVEQhTw51lKENdNrEqT3,1,0,0,0,0,0,1,0,1,0.14285714285714285,1,0.0,0,0,0,0,0,0,0,1,0,0,1,1
7785,175196,rtg3Ki4vk14kI9MkEBE0pkOCAO2AnCnU,bWdj2GDclj5ofokWjzoa5jAwMkxCykd6,19,31,19,106,4,6,13,1,180,25.714285714285715,3,0.0,4,19,103,4,27,6,3,13,1,130,50,1
7786,175206,cl2EKvvSJRHCOKFRMNWxvwP24f0kGb0G,SpATywNh6bZuzm8s1ceuBUnMUAeoAHHw,1,0,0,0,0,0,1,0,1,0.14285714285714285,1,0.0,0,0,0,0,0,0,0,1,0,0,1,1
7787,175238,lPm1TSKMUQ7eGKQEhVdTw2Bwzsvcola7,SpATywNh6bZuzm8s1ceuBUnMUAeoAHHw,1,0,0,0,0,0,1,0,1,0.14285714285714285,1,0.0,0,0,0,0,0,0,0,1,0,0,1,1
7788,175240,xCHQAq5m2mtyQES4gfg6MjCHDUVD1J71,A3fsA9Zfv1X2fVEQhTw51lKENdNrEqT3,5,6,0,0,0,0,2,0,8,1.1428571428571428,1,0.0,0,0,0,0,6,0,0,2,0,0,8,1
7789,175245,ltkP6i2vq0mcbwSjcj4Xv8kSZr3VUqSC,A3fsA9Zfv1X2fVEQhTw51lKENdNrEqT3,8,3,1,0,1,1,4,0,10,1.4285714285714286,1,0.0,0,1,0,1,3,1,0,4,0,2,8,1
7790,175246,kaNpWuIxNLxZkDfmjMzrYRVzuOgwIf0o,SpATywNh6bZuzm8s1ceuBUnMUAeoAHHw,1,0,0,0,0,0,2,0,2,0.2857142857142857,2,0.0,0,0,0,0,0,0,0,2,0,0,2,1
7791,175260,w2E5tS0N7MCQaF7A3ASAFp8VmrqDhyey,SpATywNh6bZuzm8s1ceuBUnMUAeoAHHw,14,8,6,0,5,0,3,0,22,3.142857142857143,2,0.0,0,6,0,5,8,0,0,3,0,11,11,1
7792,175267,gkFOg5eTAnAUv8n8zVKmC9VjpOwrpc30,SpATywNh6bZuzm8s1ceuBUnMUAeoAHHw,9,6,2,0,1,1,15,1,26,3.7142857142857144,2,0.0,0,2,0,1,6,1,0,15,1,3,23,1
7793,175284,Fl2rv0GIrb1pZGPCAVV4X3WnsKhjbfP2,A3fsA9Zfv1X2fVEQhTw51lKENdNrEqT3,8,3,1,0,1,0,5,0,10,1.4285714285714286,1,0.0,0,1,0,1,3,0,0,5,0,2,8,1
7794,175297,cZy6FfSysDXCciyaQBXiY1ElSSQnaYdy,A3fsA9Zfv1X2fVEQhTw51lKENdNrEqT3,1,0,0,0,0,0,1,0,1,0.14285714285714285,1,0.0,0,0,0,0,0,0,0,1,0,0,1,1
7795,175301,QHPjxy7GRZxkE11G18jf1qUIPRoUJGTA,A3fsA9Zfv1X2fVEQhTw51lKENdNrEqT3,2,0,0,0,0,0,2,0,2,0.2857142857142857,1,0.0,0,0,0,0,0,0,0,2,0,0,2,1
7796,175308,SZHxM16r0lTBVocJi0Li5OQAgxZ4K7jz,A3fsA9Zfv1X2fVEQhTw51lKENdNrEqT3,1,0,0,0,0,0,1,0,1,0.14285714285714285,1,0.0,0,0,0,0,0,0,0,1,0,0,1,1
7797,175312,RdEm3Fs8S0aOIDZ4Rs9JfR67o5xMZbr0,G8EPVSXsOYB5YQWZGiz1aVq5Pgr2GrQu,5,3,1,0,1,0,4,0,9,1.2857142857142858,1,0.0,0,1,0,1,3,0,0,4,0,2,7,1
7798,175343,GBFE5Y91W0Tc0xOvCqFBzxsDNroDv8Is,SpATywNh6bZuzm8s1ceuBUnMUAeoAHHw,2,0,0,0,0,0,2,0,2,0.2857142857142857,1,0.0,0,0,0,0,0,0,0,2,0,0,2,1
7799,175368,gs6GqCtB6XgQ6UWjy1alecSfvRxFU0T2,SpATywNh6bZuzm8s1ceuBUnMUAeoAHHw,2,0,0,0,0,0,2,0,2,0.2857142857142857,1,0.0,0,0,0,0,0,0,0,2,0,0,2,1
7800,175379,9WmzxyamLAgd2LnrO6zydiN7WV3MNZZt,bWdj2GDclj5ofokWjzoa5jAwMkxCykd6,8,8,6,0,2,4,6,1,27,3.857142857142857,2,0.0,0,6,0,2,8,4,0,6,1,8,19,1
7801,175402,Sy0IBVghIdDN5uhsYaAtE4EZP4lbDR6C,A3fsA9Zfv1X2fVEQhTw51lKENdNrEqT3,2,0,0,0,0,0,2,0,2,0.2857142857142857,1,0.0,0,0,0,0,0,0,0,2,0,0,2,1
7802,175405,VpSqFaUAI6VHKIVES1nyHNkouDYoubbm,SpATywNh6bZuzm8s1ceuBUnMUAeoAHHw,9,6,1,0,1,0,3,0,11,1.5714285714285714,1,0.0,1,1,0,1,5,0,0,3,0,3,8,1
7803,175407,wcdy3oa7dAkP6qisbcdJvc8HycOW6ePt,SpATywNh6bZuzm8s1ceuBUnMUAeoAHHw,3,0,0,0,0,0,3,0,3,0.42857142857142855,1,0.0,0,0,0,0,0,0,0,3,0,0,3,1
7804,175423,JLpYHpRsamf04qcVxCPYwLYYhT8v6H5r,bWdj2GDclj5ofokWjzoa5jAwMkxCykd6,8,6,4,0,3,0,4,0,17,2.4285714285714284,1,0.0,0,4,0,3,6,0,0,4,0,7,10,1
7805,175439,GYW6F4RrALjPRMj1o3hg6mOIhsonMLzv,fbPkOYLVPtPgIt0MxizjfFJov3JbHyAi,8,6,4,0,2,1,6,1,20,2.857142857142857,1,0.0,0,4,0,2,6,1,0,6,1,6,14,1
7806,175440,nNNmD0vjq4euECk9TASJLqcY7Yh4uOs7,fbPkOYLVPtPgIt0MxizjfFJov3JbHyAi,1,0,0,0,0,0,1,0,1,0.14285714285714285,1,0.0,0,0,0,0,0,0,0,1,0,0,1,1
7807,175444,m7igssBCJoYXk9iLEbegzoIoWBibQRze,fbPkOYLVPtPgIt0MxizjfFJov3JbHyAi,7,3,2,0,2,0,4,0,11,1.5714285714285714,1,0.0,0,2,0,2,3,0,0,4,0,4,7,1
7808,175445,G6eTAhE9AzVlPFZeS2VRSwDOXtmFA3PX,fbPkOYLVPtPgIt0MxizjfFJov3JbHyAi,4,2,1,0,1,0,1,0,5,0.7142857142857143,1,0.0,0,1,0,1,2,0,0,1,0,2,3,1
7809,175446,juzfwxHXCKii6ul7funGUBQbDVPCyrBB,fbPkOYLVPtPgIt0MxizjfFJov3JbHyAi,8,5,3,0,2,0,3,0,13,1.8571428571428572,1,0.0,0,3,0,2,5,0,0,3,0,5,8,1
7810,175447,S9lWYm9a6FVZ2ODtiJC49kgBYS9VqhGG,fbPkOYLVPtPgIt0MxizjfFJov3JbHyAi,1,0,0,0,0,0,1,0,1,0.14285714285714285,1,0.0,0,0,0,0,0,0,0,1,0,0,1,1
7811,175450,iM7LGMV4VAjVfcFaZFGWFvZYzMBFfU3L,fbPkOYLVPtPgIt0MxizjfFJov3JbHyAi,4,2,1,0,0,0,2,0,5,0.7142857142857143,1,0.0,0,1,0,0,2,0,0,2,0,1,4,1
7812,175451,CH7rIEiCYJderq7iXskzAGjPNDy8sGGS,fbPkOYLVPtPgIt0MxizjfFJov3JbHyAi,6,4,2,0,2,0,1,0,9,1.2857142857142858,1,0.0,0,2,0,2,4,0,0,1,0,4,5,1
7813,175453,BbTCRpsgAELmbNInOYYMcpD2adqJUxaz,fbPkOYLVPtPgIt0MxizjfFJov3JbHyAi,9,9,6,0,2,0,1,0,18,2.5714285714285716,1,0.0,0,6,0,2,9,0,0,1,0,8,10,1
7814,175458,QtQR4oqQYT2ypg7Ijhn9emxLfIBM3Int,fbPkOYLVPtPgIt0MxizjfFJov3JbHyAi,5,3,0,0,0,0,3,0,6,0.8571428571428571,1,0.0,0,0,0,0,3,0,0,3,0,0,6,1
7815,175459,DwjBo7B8hqv5XCU5nIWsl6HyuOZ8ub9E,fbPkOYLVPtPgIt0MxizjfFJov3JbHyAi,8,3,2,0,2,7,5,1,20,2.857142857142857,1,0.0,0,2,0,2,3,7,0,5,1,4,16,1
7816,175460,XCvldc0Z25dIQokzzDRNDq71ULXBAM8F,fbPkOYLVPtPgIt0MxizjfFJov3JbHyAi,1,0,0,0,0,0,1,0,1,0.14285714285714285,1,0.0,0,0,0,0,0,0,0,1,0,0,1,1
7817,175462,IxfgoqdA7w5aqdySNUMg1lSOzs1KfDTQ,fbPkOYLVPtPgIt0MxizjfFJov3JbHyAi,1,0,0,0,0,0,1,0,1,0.14285714285714285,1,0.0,0,0,0,0,0,0,0,1,0,0,1,1
7818,175463,X9Zz94IfisZgL8IIKroVo2fOO5DotKd5,fbPkOYLVPtPgIt0MxizjfFJov3JbHyAi,5,2,1,0,1,0,4,0,8,1.1428571428571428,1,0.0,0,1,0,1,2,0,0,4,0,2,6,1
7819,175464,lo7UFRSxvdl5IBJpBfFiWaG1K4lSvIph,fbPkOYLVPtPgIt0MxizjfFJov3JbHyAi,8,20,1,0,1,3,6,1,32,4.571428571428571,1,0.0,2,1,0,1,18,3,0,6,1,4,28,1
7820,175466,WOZ2OKb8udE0dHnoi6x9XrHwhNGFHraB,fbPkOYLVPtPgIt0MxizjfFJov3JbHyAi,9,5,4,0,4,0,6,0,19,2.7142857142857144,1,0.0,0,4,0,4,5,0,0,6,0,8,11,1
7821,175470,JVXyLCa1OOjkw5FBCNd333Deiv79lmst,fbPkOYLVPtPgIt0MxizjfFJov3JbHyAi,8,4,1,0,1,0,4,1,11,1.5714285714285714,1,0.0,0,1,0,1,4,0,0,4,1,2,9,1
7822,175472,h6X7uJXHEtMGd13bXyyZ1xP1ebsu9X0Q,fbPkOYLVPtPgIt0MxizjfFJov3JbHyAi,1,0,0,0,0,0,1,0,1,0.14285714285714285,1,0.0,0,0,0,0,0,0,0,1,0,0,1,1
7823,175473,DLoC6wyjO8HZpRQISW7NxAXHzLyIHStZ,fbPkOYLVPtPgIt0MxizjfFJov3JbHyAi,11,11,7,0,5,5,9,2,39,5.571428571428571,1,0.0,2,7,0,5,9,5,0,9,2,14,25,1
7824,175482,ifbjnZ4tXcK4dpvbMG3JmLnAWvMTSG5S,fbPkOYLVPtPgIt0MxizjfFJov3JbHyAi,10,6,4,0,3,1,5,1,20,2.857142857142857,1,0.0,0,4,0,3,6,1,0,5,1,7,13,1
7825,175483,1mlsGNriImtvI5bJf0wHc3mOCBScmLWj,fbPkOYLVPtPgIt0MxizjfFJov3JbHyAi,9,9,6,0,2,0,4,0,21,3.0,1,0.0,0,6,0,2,9,0,0,4,0,8,13,1
7826,175488,nQ8zyPaxuBVV0E4EnN5ZsvrgPzjbJntO,fbPkOYLVPtPgIt0MxizjfFJov3JbHyAi,1,0,0,0,0,0,1,0,1,0.14285714285714285,1,0.0,0,0,0,0,0,0,0,1,0,0,1,1
7827,175491,TSm2R7cUPaXhbTrj1LddmwVL7dduRSSa,fbPkOYLVPtPgIt0MxizjfFJov3JbHyAi,1,0,0,0,0,0,1,0,1,0.14285714285714285,1,0.0,0,0,0,0,0,0,0,1,0,0,1,1
7828,175495,zfwGGWHtlXaIDlcPdgrN93eHfeWgyv8l,fbPkOYLVPtPgIt0MxizjfFJov3JbHyAi,1,0,0,0,0,0,1,0,1,0.14285714285714285,1,0.0,0,0,0,0,0,0,0,1,0,0,1,1
7829,175498,1hpNOEDtPnezHqQbgrwjtuMuvCrx4S8A,fbPkOYLVPtPgIt0MxizjfFJov3JbHyAi,13,8,5,0,5,0,2,0,20,2.857142857142857,1,0.0,0,5,0,5,8,0,0,2,0,10,10,1
7830,175509,Nqm1BU7DDwtz5J6sAMZajfpCtdyka8BU,fbPkOYLVPtPgIt0MxizjfFJov3JbHyAi,6,2,0,0,0,1,5,1,9,1.2857142857142858,1,0.0,0,0,0,0,2,1,0,5,1,0,9,1
7831,175511,lFbeWg5shoMMNqLk9Vsb1yCv5tI9us0k,fbPkOYLVPtPgIt0MxizjfFJov3JbHyAi,10,7,3,1,4,0,2,0,17,2.4285714285714284,1,0.0,3,3,1,4,4,0,0,2,0,11,6,1
7832,175512,IybfLDxPgLkzxuWcMtBTeSNmrb96OWvv,fbPkOYLVPtPgIt0MxizjfFJov3JbHyAi,7,3,2,0,2,0,5,0,12,1.7142857142857142,1,0.0,0,2,0,2,3,0,0,5,0,4,8,1
7833,175513,PtpNjyWIZGFluToFVMnoVp1uIp4PTNlV,fbPkOYLVPtPgIt0MxizjfFJov3JbHyAi,4,2,1,0,1,0,1,0,5,0.7142857142857143,1,0.0,0,1,0,1,2,0,0,1,0,2,3,1
7834,175514,lreXxc1V0mKbQc1Fk3HBAHJga7i3ZlPb,fbPkOYLVPtPgIt0MxizjfFJov3JbHyAi,4,0,0,0,0,2,3,1,6,0.8571428571428571,1,0.0,0,0,0,0,0,2,0,3,1,0,6,1
7835,175517,vM4VSeTdZPRUwUiCQKf2BuawElru5sNo,fbPkOYLVPtPgIt0MxizjfFJov3JbHyAi,5,2,1,0,1,0,4,0,8,1.1428571428571428,1,0.0,0,1,0,1,2,0,0,4,0,2,6,1
7836,175519,zZcLo3UhXrAelR5FTKmHlxSZl0wW5YNH,fbPkOYLVPtPgIt0MxizjfFJov3JbHyAi,2,0,0,0,0,0,2,0,2,0.2857142857142857,1,0.0,0,0,0,0,0,0,0,2,0,0,2,1
7837,175521,Z6WF7UnPSWhERdL5zMrsQHVgRqZ42S1n,fbPkOYLVPtPgIt0MxizjfFJov3JbHyAi,2,0,0,0,0,0,2,0,2,0.2857142857142857,1,0.0,0,0,0,0,0,0,0,2,0,0,2,1
7838,175522,wmNYHs69T6CHydhCxfzhydbjA79LMuTD,fbPkOYLVPtPgIt0MxizjfFJov3JbHyAi,7,3,2,0,2,0,2,0,9,1.2857142857142858,1,0.0,0,2,0,2,3,0,0,2,0,4,5,1
7839,175525,QYaJtD7z5M6YcGNpdHV2JTsxqV4tXm9a,fbPkOYLVPtPgIt0MxizjfFJov3JbHyAi,1,0,0,0,0,0,1,0,1,0.14285714285714285,1,0.0,0,0,0,0,0,0,0,1,0,0,1,1
7840,175527,nWRrumnCgp6om94YmjE4CGN8JbKK91s6,fbPkOYLVPtPgIt0MxizjfFJov3JbHyAi,5,2,1,0,1,0,2,0,6,0.8571428571428571,1,0.0,0,1,0,1,2,0,0,2,0,2,4,1
7841,175529,vZY5RTyvAOyjF1AYeCntOYrEo9bIz6lQ,fbPkOYLVPtPgIt0MxizjfFJov3JbHyAi,4,2,1,0,1,0,1,0,5,0.7142857142857143,1,0.0,0,1,0,1,2,0,0,1,0,2,3,1
7842,175530,pmVmbJyOmxphdEXp0eyLXWB51e0e00i9,fbPkOYLVPtPgIt0MxizjfFJov3JbHyAi,7,4,2,0,2,0,3,0,11,1.5714285714285714,1,0.0,0,2,0,2,4,0,0,3,0,4,7,1
7843,175532,Fov1WBMQ9iK40YBqm6CCLgYUxW79OKx1,fbPkOYLVPtPgIt0MxizjfFJov3JbHyAi,10,10,4,0,3,2,9,2,30,4.285714285714286,1,0.0,4,4,0,3,6,2,0,9,2,11,19,1
7844,175538,8DjKcd2LJZN4ior4lkPdphxSMFfQLRGu,fbPkOYLVPtPgIt0MxizjfFJov3JbHyAi,3,0,0,0,0,4,2,0,6,0.8571428571428571,1,0.0,0,0,0,0,0,4,0,2,0,0,6,1
7845,175541,GrlLrE19mhpGaNnXMSNrKxn7KnB7PvUl,fbPkOYLVPtPgIt0MxizjfFJov3JbHyAi,7,4,3,0,3,0,2,0,12,1.7142857142857142,1,0.0,0,3,0,3,4,0,0,2,0,6,6,1
7846,175546,uCYmXbV69zfGcUg2j8bzRMpMZlMnqjT7,fbPkOYLVPtPgIt0MxizjfFJov3JbHyAi,1,0,0,0,0,0,1,0,1,0.14285714285714285,1,0.0,0,0,0,0,0,0,0,1,0,0,1,0
7847,176353,4bOUwTkieqMfvbCbKosegaSfDeZ15GKM,fbPkOYLVPtPgIt0MxizjfFJov3JbHyAi,1,0,0,0,0,0,1,0,1,0.14285714285714285,1,0.0,0,0,0,0,0,0,0,1,0,0,1,1
7848,176354,3dMiR0LoABiSpQX4JYFVOM3r1eOr65HJ,fbPkOYLVPtPgIt0MxizjfFJov3JbHyAi,5,3,1,0,1,0,2,0,7,1.0,1,0.0,0,1,0,1,3,0,0,2,0,2,5,1
7849,176356,LKippngJk3cGSHQFQuBifcn7F1qfi1gi,fbPkOYLVPtPgIt0MxizjfFJov3JbHyAi,5,2,1,0,1,0,2,0,6,0.8571428571428571,1,0.0,0,1,0,1,2,0,0,2,0,2,4,1
7850,176357,8fBfbIuoUTzFONbekOgtlFtpKC5U6cNy,fbPkOYLVPtPgIt0MxizjfFJov3JbHyAi,10,8,3,3,3,1,4,0,22,3.142857142857143,1,0.0,3,3,3,3,5,1,0,4,0,12,10,1
7851,176358,cRpYMDSjBvEWIbn0U0hppujot5LNLTzW,fbPkOYLVPtPgIt0MxizjfFJov3JbHyAi,1,0,0,0,0,0,1,0,1,0.14285714285714285,1,0.0,0,0,0,0,0,0,0,1,0,0,1,1
7852,176359,38evuz11qT1yopNFOWEFJXqo6AKQdprx,fbPkOYLVPtPgIt0MxizjfFJov3JbHyAi,2,0,0,0,0,0,2,0,2,0.2857142857142857,1,0.0,0,0,0,0,0,0,0,2,0,0,2,1
7853,176362,tvD1wy5qLV5qKtu0LjnfHhQiwEJLQsKc,fbPkOYLVPtPgIt0MxizjfFJov3JbHyAi,7,5,3,4,3,0,1,0,16,2.2857142857142856,1,0.0,1,3,4,3,4,0,0,1,0,11,5,1
7854,176363,XpETIOce5NnU4qKIbkLob1tMSekzlpRK,fbPkOYLVPtPgIt0MxizjfFJov3JbHyAi,1,0,0,0,0,0,1,0,1,0.14285714285714285,1,0.0,0,0,0,0,0,0,0,1,0,0,1,1
7855,176364,zCHrzoFCDvrZWbgn6xqNjq29YrwinxJ6,fbPkOYLVPtPgIt0MxizjfFJov3JbHyAi,1,0,0,0,0,0,1,0,1,0.14285714285714285,1,0.0,0,0,0,0,0,0,0,1,0,0,1,1
7856,176366,ffNDXW73vFMgnRNtFmP91F2Fk6GpIDWe,fbPkOYLVPtPgIt0MxizjfFJov3JbHyAi,1,0,0,0,0,0,1,0,1,0.14285714285714285,1,0.0,0,0,0,0,0,0,0,1,0,0,1,1
7857,176367,QY2qA0MFHIqq0CtvZf3SzdZ2ea7Q99KG,fbPkOYLVPtPgIt0MxizjfFJov3JbHyAi,9,3,2,0,2,1,4,1,13,1.8571428571428572,1,0.0,0,2,0,2,3,1,0,4,1,4,9,1
7858,176369,3T6lo0hNKqGF8AeLHQEHxxeYIjJqOuY5,fbPkOYLVPtPgIt0MxizjfFJov3JbHyAi,2,0,0,0,0,0,2,0,2,0.2857142857142857,1,0.0,0,0,0,0,0,0,0,2,0,0,2,1
7859,176371,TKArhe0MXX8UInue0tvcz8uoMFUDLTjv,fbPkOYLVPtPgIt0MxizjfFJov3JbHyAi,1,0,0,0,0,0,1,0,1,0.14285714285714285,1,0.0,0,0,0,0,0,0,0,1,0,0,1,1
7860,176377,BnytRM0DS11v1j8Y5GXtdZweLuyRzpWa,7GRhBDsirIGkRZBtSMEzNTyDr2JQm4xx,11,8,5,4,4,0,2,0,23,3.2857142857142856,1,0.0,2,5,3,4,6,0,1,2,0,14,9,1
7861,176382,V5AS4ngknDMHs5ddf49SxlAoYguZsiN3,7GRhBDsirIGkRZBtSMEzNTyDr2JQm4xx,3,2,0,0,0,0,1,0,3,0.42857142857142855,1,0.0,0,0,0,0,2,0,0,1,0,0,3,1
7862,176397,L1FTG9TM6RI5TBCTexQgshQhXhu2oZpJ,7GRhBDsirIGkRZBtSMEzNTyDr2JQm4xx,6,8,6,0,6,0,1,0,21,3.0,1,0.0,0,6,0,6,8,0,0,1,0,12,9,1
7863,176468,rGRFKIkiXYdsTLVzdgfkfhoHp29YmFvI,7GRhBDsirIGkRZBtSMEzNTyDr2JQm4xx,1,0,0,0,0,0,1,0,1,0.14285714285714285,1,0.0,0,0,0,0,0,0,0,1,0,0,1,1
7864,176515,NYt3HW4iIDKFfkoDHUmE2GfhEi6C8Rqu,7GRhBDsirIGkRZBtSMEzNTyDr2JQm4xx,8,12,6,0,1,4,3,0,26,3.7142857142857144,1,0.0,4,6,0,1,8,4,0,3,0,11,15,1
7865,176520,BGZaaH5HDVuGvqaegp5MyJblPEuJpcXP,7GRhBDsirIGkRZBtSMEzNTyDr2JQm4xx,1,0,0,0,0,0,1,0,1,0.14285714285714285,1,0.0,0,0,0,0,0,0,0,1,0,0,1,1
7866,176521,bwHNoPHxbyrlfAktOsYn5l9pphqY7rqI,7GRhBDsirIGkRZBtSMEzNTyDr2JQm4xx,1,0,0,0,0,0,1,0,1,0.14285714285714285,1,0.0,0,0,0,0,0,0,0,1,0,0,1,1
7867,176528,7HpnoaIGu4hhAe6wQLzGOmmP3DNYMvrt,7GRhBDsirIGkRZBtSMEzNTyDr2JQm4xx,4,2,0,0,0,0,2,0,4,0.5714285714285714,1,0.0,0,0,0,0,2,0,0,2,0,0,4,1
7868,176555,zFJuKZAKTq12e9QE2ZEqSrQuW0gQ7ZSR,bWdj2GDclj5ofokWjzoa5jAwMkxCykd6,11,34,14,48,5,10,12,0,123,17.571428571428573,1,0.0,12,14,46,5,22,10,2,12,0,77,46,1
7869,176561,XPil0z3F5cAc6rFPjolit1u4hGh3bLog,bWdj2GDclj5ofokWjzoa5jAwMkxCykd6,2,0,0,0,0,0,3,0,3,0.42857142857142855,1,0.0,0,0,0,0,0,0,0,3,0,0,3,1
7870,176562,QgWb5bq53lHXqabN0HBji70t8pNuQpJI,A3fsA9Zfv1X2fVEQhTw51lKENdNrEqT3,6,3,2,0,1,0,3,0,9,1.2857142857142858,1,0.0,0,2,0,1,3,0,0,3,0,3,6,1
7871,176576,1ZnERDT2WSNZGJeanMnjXX2EswCJEUwX,SpATywNh6bZuzm8s1ceuBUnMUAeoAHHw,6,7,3,0,2,0,5,0,17,2.4285714285714284,2,0.0,0,3,0,2,7,0,0,5,0,5,12,1
7872,176625,NMToinRYtSSoVCXpJZRcRohg7dcw6Du0,SpATywNh6bZuzm8s1ceuBUnMUAeoAHHw,1,0,0,0,0,0,1,0,1,0.14285714285714285,1,0.0,0,0,0,0,0,0,0,1,0,0,1,1
7873,176635,TYUe9cujyrCsl9vgAyeTTK1SiwFBDVY7,A3fsA9Zfv1X2fVEQhTw51lKENdNrEqT3,2,0,0,0,0,0,2,0,2,0.2857142857142857,1,0.0,0,0,0,0,0,0,0,2,0,0,2,1
7874,176657,KGNZfzsWKEpndUg4ZWkpY4ThWCsiKpiv,A3fsA9Zfv1X2fVEQhTw51lKENdNrEqT3,1,0,0,0,0,0,1,0,1,0.14285714285714285,1,0.0,0,0,0,0,0,0,0,1,0,0,1,1
7875,176705,MED58Yjp1Lb99iMEyvwZJoRdEHymCjSn,SpATywNh6bZuzm8s1ceuBUnMUAeoAHHw,9,5,1,0,1,3,11,1,22,3.142857142857143,1,0.0,0,1,0,1,5,3,0,11,1,2,20,1
7876,176706,RPNytg6jKosKSPSkg7bLhh3BAXDjaY9a,RXDvfPUBYFlVdlueBFbLW0mhhAyGEqpt,11,7,3,6,2,0,2,0,20,2.857142857142857,1,0.0,1,3,6,2,6,0,0,2,0,12,8,1
7877,176714,mP0oq4UFI55XwGbomuLjnKyaYZ9Irhl8,RXDvfPUBYFlVdlueBFbLW0mhhAyGEqpt,1,0,0,0,0,0,1,0,1,0.14285714285714285,1,0.0,0,0,0,0,0,0,0,1,0,0,1,1
7878,176735,44GafVKSjOefcGtCUMS1SAXmrzlFFSGG,A3fsA9Zfv1X2fVEQhTw51lKENdNrEqT3,8,6,0,0,0,1,4,0,11,1.5714285714285714,1,0.0,0,0,0,0,6,1,0,4,0,0,11,1
7879,176736,GHfo4pUmbP0HyeQVp8PPz8kn0kTFo6yb,SpATywNh6bZuzm8s1ceuBUnMUAeoAHHw,16,18,0,33,0,0,1,0,52,7.428571428571429,1,0.0,6,0,28,0,12,0,5,1,0,34,18,0
7880,176753,nSViyQ7vSn8aF5YHjw7hmNhhRklO9laV,SpATywNh6bZuzm8s1ceuBUnMUAeoAHHw,5,2,1,0,1,0,3,0,7,1.0,1,0.0,0,1,0,1,2,0,0,3,0,2,5,1
7881,176757,1BR9RQvHYYkyWaPC2GRTHswQs8AyO4gg,SpATywNh6bZuzm8s1ceuBUnMUAeoAHHw,15,35,2,21,3,0,3,0,64,9.142857142857142,1,0.0,20,2,18,3,15,0,3,3,0,43,21,1
7882,176774,kvxGydllm6BLbdP0nm9jaxgMVk1FHTYp,SpATywNh6bZuzm8s1ceuBUnMUAeoAHHw,20,46,25,25,0,3,9,2,110,15.714285714285714,1,0.0,16,25,19,0,30,3,6,9,2,60,50,1
7883,176776,wvaRW3X5tOUHanl7PiOdxpXKHWAXL5Dm,SpATywNh6bZuzm8s1ceuBUnMUAeoAHHw,1,0,0,0,0,0,1,0,1,0.14285714285714285,1,0.0,0,0,0,0,0,0,0,1,0,0,1,1
7884,176822,BEwpQuUn0betGBYfWGax81LgeoTlg8LE,SpATywNh6bZuzm8s1ceuBUnMUAeoAHHw,17,14,2,15,2,5,5,1,44,6.285714285714286,1,0.0,5,2,12,2,9,5,3,5,1,21,23,0
7885,176823,frevGWOFyf2Wo6uQjpFNvZnyWeFbKP0E,A3fsA9Zfv1X2fVEQhTw51lKENdNrEqT3,8,9,0,6,0,0,3,0,18,2.5714285714285716,2,0.0,0,0,6,0,9,0,0,3,0,6,12,1
7886,176831,vt6yAFP86tVXKBFMjBeWFksicr6ADIhP,SpATywNh6bZuzm8s1ceuBUnMUAeoAHHw,5,2,1,0,1,0,2,0,6,0.8571428571428571,1,0.0,0,1,0,1,2,0,0,2,0,2,4,1
7887,176836,nfdmRSIeQ1UeHw7VkGM3TXlNpKXW3emB,bWdj2GDclj5ofokWjzoa5jAwMkxCykd6,1,0,0,0,0,0,1,0,1,0.14285714285714285,1,0.0,0,0,0,0,0,0,0,1,0,0,1,1
7888,176873,tD2t0ZHpAx0YjQwAL8UEB0neif6SIb4V,bWdj2GDclj5ofokWjzoa5jAwMkxCykd6,1,0,0,0,0,0,1,0,1,0.14285714285714285,1,0.0,0,0,0,0,0,0,0,1,0,0,1,1
7889,176877,tD2t0ZHpAx0YjQwAL8UEB0neif6SIb4V,A3fsA9Zfv1X2fVEQhTw51lKENdNrEqT3,1,0,0,0,0,0,1,0,1,0.14285714285714285,1,0.0,0,0,0,0,0,0,0,1,0,0,1,1
7890,176884,2bO6MisGrRWNEa1nUMHMWWTQVeKS23eS,SpATywNh6bZuzm8s1ceuBUnMUAeoAHHw,11,6,6,0,6,0,2,0,20,2.857142857142857,1,0.0,0,6,0,6,6,0,0,2,0,12,8,1
7891,176909,wjicnAF12JyAapuh15sdon1diUWswaFA,bWdj2GDclj5ofokWjzoa5jAwMkxCykd6,6,3,1,0,1,0,2,0,7,1.0,1,0.0,0,1,0,1,3,0,0,2,0,2,5,1
7892,176910,hlLJjac8psTxnrEYNcjoWRSyE9PLM0jF,A3fsA9Zfv1X2fVEQhTw51lKENdNrEqT3,6,3,2,0,2,0,2,0,9,1.2857142857142858,1,0.0,0,2,0,2,3,0,0,2,0,4,5,1
7893,176941,YmECTGgjL6NRIrd1m4lXekfVt4GlrSQ1,bWdj2GDclj5ofokWjzoa5jAwMkxCykd6,10,14,7,4,5,10,6,1,47,6.714285714285714,2,0.0,1,7,3,5,13,10,1,6,1,16,31,1
7894,176959,IxN0oMkJdKmNRarUB8mq0kSQRx8qnGax,bWdj2GDclj5ofokWjzoa5jAwMkxCykd6,3,0,0,0,0,0,3,0,3,0.42857142857142855,1,0.0,0,0,0,0,0,0,0,3,0,0,3,1
7895,177010,CxhwRDRCARhFka2Q3podETDsye29rlXb,SpATywNh6bZuzm8s1ceuBUnMUAeoAHHw,5,4,2,0,1,0,2,0,9,1.2857142857142858,1,0.0,0,2,0,1,4,0,0,2,0,3,6,1
7896,177060,Et66VbQRwkFnF42twZ8Z4ErFWQLehmwC,A3fsA9Zfv1X2fVEQhTw51lKENdNrEqT3,8,5,1,0,1,0,3,0,10,1.4285714285714286,2,0.0,0,1,0,1,5,0,0,3,0,2,8,0
7897,177101,2G9uV9MMhfw3z7a992GuBzgkXLp94apO,A3fsA9Zfv1X2fVEQhTw51lKENdNrEqT3,6,3,1,0,1,0,5,0,10,1.4285714285714286,1,0.0,0,1,0,1,3,0,0,5,0,2,8,1
7898,177105,niznzPsNcmf0qkvKVIABVzsBAFOWmMfr,A3fsA9Zfv1X2fVEQhTw51lKENdNrEqT3,6,6,0,0,0,0,6,0,12,1.7142857142857142,2,0.0,0,0,0,0,6,0,0,6,0,0,12,1
7899,177113,66JqxLLiEx06fBDzS4MuyYNc7nIpYGk9,A3fsA9Zfv1X2fVEQhTw51lKENdNrEqT3,53,43,31,56,18,0,4,0,152,21.714285714285715,3,0.0,1,31,50,18,42,0,6,4,0,100,52,0
7900,177123,cuPQwSytidcCUilblyO4K9ALDT0iH8XK,A3fsA9Zfv1X2fVEQhTw51lKENdNrEqT3,1,0,0,0,0,0,1,0,1,0.14285714285714285,1,0.0,0,0,0,0,0,0,0,1,0,0,1,1
7901,177167,DkBEQyIekQixrRUA1DCrhgBXxcYJJXln,SpATywNh6bZuzm8s1ceuBUnMUAeoAHHw,1,0,0,0,0,0,1,0,1,0.14285714285714285,1,0.0,0,0,0,0,0,0,0,1,0,0,1,1
7902,177177,nURvxLXCCRcUx0rr21CCKt2pPqq3RcJ7,SpATywNh6bZuzm8s1ceuBUnMUAeoAHHw,6,5,1,0,1,0,2,0,9,1.2857142857142858,1,0.0,0,1,0,1,5,0,0,2,0,2,7,1
7903,177185,eT9OhUahWhAeZfHPEbxGN9qGHwvkkQvs,SpATywNh6bZuzm8s1ceuBUnMUAeoAHHw,1,0,0,0,0,0,1,0,1,0.14285714285714285,1,0.0,0,0,0,0,0,0,0,1,0,0,1,1
7904,177190,LfqjHStsZ12hVtRAj2u8KdIMPVFnabmD,bWdj2GDclj5ofokWjzoa5jAwMkxCykd6,1,0,0,0,0,0,1,0,1,0.14285714285714285,1,0.0,0,0,0,0,0,0,0,1,0,0,1,1
7905,177192,mBNdEgFmgGVvgyDWBgZluXCXQS1DNZxP,bWdj2GDclj5ofokWjzoa5jAwMkxCykd6,6,4,2,0,2,0,1,0,9,1.2857142857142858,1,0.0,0,2,0,2,4,0,0,1,0,4,5,1
7906,177210,xmv8WUz0fQb7fJNMHkcUN733RgAFZjFP,SpATywNh6bZuzm8s1ceuBUnMUAeoAHHw,5,5,1,0,1,0,2,0,9,1.2857142857142858,1,0.0,0,1,0,1,5,0,0,2,0,2,7,1
7907,177225,jGkFsr85Pqt6G74Ct0j5bqEqPLMt7wa3,bWdj2GDclj5ofokWjzoa5jAwMkxCykd6,2,0,0,0,0,0,2,0,2,0.2857142857142857,1,0.0,0,0,0,0,0,0,0,2,0,0,2,1
7908,177226,jGkFsr85Pqt6G74Ct0j5bqEqPLMt7wa3,A3fsA9Zfv1X2fVEQhTw51lKENdNrEqT3,2,0,0,0,0,0,2,0,2,0.2857142857142857,1,0.0,0,0,0,0,0,0,0,2,0,0,2,1
7909,177266,QiYah6MaRTZX43IYRVARS0cRIO6IdBSv,bWdj2GDclj5ofokWjzoa5jAwMkxCykd6,2,0,0,0,0,0,2,0,2,0.2857142857142857,1,0.0,0,0,0,0,0,0,0,2,0,0,2,1
7910,177308,g1C9Sv2GzsuaWdnKXvZB1yWKiZN0Fg91,bWdj2GDclj5ofokWjzoa5jAwMkxCykd6,1,0,0,0,0,0,1,0,1,0.14285714285714285,1,0.0,0,0,0,0,0,0,0,1,0,0,1,1
7911,177320,qiPgVnk4J2KtMigrE44RvNt4xKpRJnr3,SpATywNh6bZuzm8s1ceuBUnMUAeoAHHw,1,0,0,0,0,0,1,0,1,0.14285714285714285,1,0.0,0,0,0,0,0,0,0,1,0,0,1,1
7912,177325,LchclclKlrYHOcXtmhi0Eqhs9daD9eJz,RXDvfPUBYFlVdlueBFbLW0mhhAyGEqpt,46,56,24,124,20,2,2,0,228,32.57142857142857,1,0.0,31,24,115,20,25,2,9,2,0,190,38,1
7913,177347,fGIeAB7IRJCHxzCo8u4GLaPKxQfHeCdi,bWdj2GDclj5ofokWjzoa5jAwMkxCykd6,19,52,24,14,13,0,5,0,108,15.428571428571429,3,0.0,8,24,13,13,44,0,1,5,0,58,50,1
7914,177377,9NDg9VwFVuCbATto5EGvC6PrvN5Y88Xw,bWdj2GDclj5ofokWjzoa5jAwMkxCykd6,1,0,0,0,0,0,1,0,1,0.14285714285714285,1,0.0,0,0,0,0,0,0,0,1,0,0,1,1
7915,177380,g9JwaoBhrenD3JLPIF4Rgp3VFIAz66kP,bWdj2GDclj5ofokWjzoa5jAwMkxCykd6,10,20,1,60,1,10,12,2,106,15.142857142857142,1,0.0,8,1,59,1,12,10,1,12,2,69,37,1
7916,177405,IOvPoNN8l7pPy4G3bKTENwwaE7wXUaKr,A3fsA9Zfv1X2fVEQhTw51lKENdNrEqT3,7,2,1,0,1,0,7,0,11,1.5714285714285714,1,0.0,0,1,0,1,2,0,0,7,0,2,9,1
7917,177430,zF9V63zn5gsiipqbdXutnSHDmKKLyPTo,SpATywNh6bZuzm8s1ceuBUnMUAeoAHHw,5,4,1,0,1,0,3,0,9,1.2857142857142858,1,0.0,1,1,0,1,3,0,0,3,0,3,6,1
7918,177432,J3Fq3KF0FVOYO5SL2II3p94rxzVjXgko,SpATywNh6bZuzm8s1ceuBUnMUAeoAHHw,6,1,1,0,1,0,3,0,6,0.8571428571428571,1,0.0,0,1,0,1,1,0,0,3,0,2,4,0
7919,177436,RVgC7pWiS5TIqo11u8gn0FiACXxbMvEV,SpATywNh6bZuzm8s1ceuBUnMUAeoAHHw,4,3,0,0,0,0,2,0,5,0.7142857142857143,1,0.0,0,0,0,0,3,0,0,2,0,0,5,1
7920,177442,SWQUdK85RnayLE3toQQorQRoqxtUEkUa,bWdj2GDclj5ofokWjzoa5jAwMkxCykd6,13,6,2,44,0,0,2,0,54,7.714285714285714,1,0.0,0,2,38,0,6,0,6,2,0,40,14,0
7921,177460,NXEwBXbU6vvce77sujWgRB6LivhFJvRb,A3fsA9Zfv1X2fVEQhTw51lKENdNrEqT3,9,8,4,0,3,0,3,0,18,2.5714285714285716,2,0.0,0,4,0,3,8,0,0,3,0,7,11,1
7922,177461,TLRNemgJ2qb9k6dqDLHmoeJOx0QEylHX,SpATywNh6bZuzm8s1ceuBUnMUAeoAHHw,11,8,5,0,3,5,6,1,28,4.0,1,0.0,1,5,0,3,7,5,0,6,1,9,19,1
7923,177501,K3eaSd5rYP9Gkimldqt40pigYQrGeLsH,bWdj2GDclj5ofokWjzoa5jAwMkxCykd6,10,10,5,14,3,0,4,0,36,5.142857142857143,2,0.0,2,5,13,3,8,0,1,4,0,23,13,1
7924,177522,UtuMMiTcYdEIPqLGUrTySvaHfGG20tSq,SpATywNh6bZuzm8s1ceuBUnMUAeoAHHw,5,2,1,0,1,0,2,0,6,0.8571428571428571,1,0.0,0,1,0,1,2,0,0,2,0,2,4,1
7925,177667,ipVvzWInHV8LAm6qVHoFaV0nnfOGT5ry,SpATywNh6bZuzm8s1ceuBUnMUAeoAHHw,1,0,0,0,0,0,1,0,1,0.14285714285714285,1,0.0,0,0,0,0,0,0,0,1,0,0,1,1
7926,177668,p54dVByd9epbS397rAmrAwTW19iwa3UI,bWdj2GDclj5ofokWjzoa5jAwMkxCykd6,15,12,1,40,4,1,11,1,70,10.0,2,0.0,7,1,35,4,5,1,5,11,1,47,23,1
7927,177691,A6oLHbyuoChPN0ROQ5fG10dHGRIiYTTe,SpATywNh6bZuzm8s1ceuBUnMUAeoAHHw,28,29,15,29,10,3,4,0,90,12.857142857142858,1,0.0,11,15,23,10,18,3,6,4,0,59,31,1
7928,177727,G4leME9fPSQLSwsbbKKP6ouczXxo1Wlw,SpATywNh6bZuzm8s1ceuBUnMUAeoAHHw,27,30,12,22,7,0,6,0,77,11.0,2,0.0,9,12,21,7,21,0,1,6,0,49,28,1
7929,177730,Mvi2iSl7G6NCzuzRtyT9FnCVUPePQVy1,bWdj2GDclj5ofokWjzoa5jAwMkxCykd6,9,18,6,34,5,0,4,0,67,9.571428571428571,1,0.0,9,6,33,5,9,0,1,4,0,53,14,1
7930,177736,3kQ25Y1n5ZQOWjLlVHwcdpzmvrmbPTL3,SpATywNh6bZuzm8s1ceuBUnMUAeoAHHw,14,13,0,0,0,0,4,0,17,2.4285714285714284,1,0.0,0,0,0,0,13,0,0,4,0,0,17,1
7931,177750,QjqGEc1MUmw3VEVWGhyD00LM60lNtKPh,SpATywNh6bZuzm8s1ceuBUnMUAeoAHHw,16,9,5,8,3,7,13,2,47,6.714285714285714,2,0.0,3,5,8,3,6,7,0,13,2,19,28,1
7932,177755,JHMFz2Gy459G1ldyhA75ALSO8YlPxA4n,A3fsA9Zfv1X2fVEQhTw51lKENdNrEqT3,6,5,2,0,1,0,3,0,11,1.5714285714285714,2,0.0,0,2,0,1,5,0,0,3,0,3,8,1
7933,177766,zmIcVKuNFZm39Xd0zSmSfRofuInASrOB,A3fsA9Zfv1X2fVEQhTw51lKENdNrEqT3,5,2,1,0,1,0,2,0,6,0.8571428571428571,1,0.0,0,1,0,1,2,0,0,2,0,2,4,1
7934,177770,AsCRvwtleeGS6D6WD7MD0zpcijqiUpJg,SpATywNh6bZuzm8s1ceuBUnMUAeoAHHw,1,0,0,0,0,0,1,0,1,0.14285714285714285,1,0.0,0,0,0,0,0,0,0,1,0,0,1,1
7935,177792,Xrjgmm5mgiySWho5SEzdacBLSLkDfygK,SpATywNh6bZuzm8s1ceuBUnMUAeoAHHw,19,9,8,0,7,0,4,0,28,4.0,1,0.0,0,8,0,7,9,0,0,4,0,15,13,1
7936,177799,Yyccad96I3hbgqqNLycAhyGOxNsdJzLL,SpATywNh6bZuzm8s1ceuBUnMUAeoAHHw,15,19,2,0,1,1,9,1,33,4.714285714285714,1,0.0,2,2,0,1,17,1,0,9,1,5,28,1
7937,177809,h1QswJ31uhxfyhfP3OhNVJBUvcTub6pW,bWdj2GDclj5ofokWjzoa5jAwMkxCykd6,2,0,0,0,0,0,2,0,2,0.2857142857142857,1,0.0,0,0,0,0,0,0,0,2,0,0,2,1
7938,177811,KVNNbfG6UQEmke4Oy3hBc7o3aqspqwkG,bWdj2GDclj5ofokWjzoa5jAwMkxCykd6,4,0,0,0,0,0,6,0,6,0.8571428571428571,1,0.0,0,0,0,0,0,0,0,6,0,0,6,1
7939,177817,1lCKn2N8CWNZFqkAXfsrQhctsw90ZkSX,bWdj2GDclj5ofokWjzoa5jAwMkxCykd6,5,2,1,0,1,0,3,0,7,1.0,1,0.0,0,1,0,1,2,0,0,3,0,2,5,1
7940,177822,IfuP3wsHPcoufqx0FyqFKUytwStvSPv8,G8EPVSXsOYB5YQWZGiz1aVq5Pgr2GrQu,8,5,1,0,1,0,2,0,9,1.2857142857142858,1,0.0,0,1,0,1,5,0,0,2,0,2,7,1
7941,177827,ryn67VWPQk6LcF6yj0ExcHQJuf0D8gOm,G8EPVSXsOYB5YQWZGiz1aVq5Pgr2GrQu,7,11,0,0,2,0,3,0,16,2.2857142857142856,1,0.0,8,0,0,2,3,0,0,3,0,10,6,1
7942,177866,Pk6H5V6IGPh6QxXblrwO7oI0RG2f9ujy,A3fsA9Zfv1X2fVEQhTw51lKENdNrEqT3,18,17,13,10,9,0,5,0,54,7.714285714285714,2,0.0,1,13,9,9,16,0,1,5,0,32,22,1
7943,177883,3KDcn3HvW3CpzWtc78PKWcm3CxgBERCi,SpATywNh6bZuzm8s1ceuBUnMUAeoAHHw,1,0,0,0,0,0,1,0,1,0.14285714285714285,1,0.0,0,0,0,0,0,0,0,1,0,0,1,1
7944,177898,qKod71hGHVj3I0edUan3ZmfswQIOaBhk,SpATywNh6bZuzm8s1ceuBUnMUAeoAHHw,4,2,0,0,0,0,2,0,4,0.5714285714285714,1,0.0,0,0,0,0,2,0,0,2,0,0,4,0
7945,177913,vMJQI9w07ZiISGIPIFnaaxiyY7O127F5,bWdj2GDclj5ofokWjzoa5jAwMkxCykd6,1,0,0,0,0,0,1,0,1,0.14285714285714285,1,0.0,0,0,0,0,0,0,0,1,0,0,1,1
7946,177917,0Rhh8KlMvGRxFbePsrW63o0GE8JJ4ZBr,A3fsA9Zfv1X2fVEQhTw51lKENdNrEqT3,4,0,0,0,0,0,5,0,5,0.7142857142857143,1,0.0,0,0,0,0,0,0,0,5,0,0,5,1
7947,177935,fCHhd4TOkyXDtd95SIvxpoNr5KiduXIc,bWdj2GDclj5ofokWjzoa5jAwMkxCykd6,7,3,2,0,2,0,2,0,9,1.2857142857142858,1,0.0,0,2,0,2,3,0,0,2,0,4,5,1
7948,177958,kvoUslzLG0mKlFKuSPgqASK2op5HSx76,A3fsA9Zfv1X2fVEQhTw51lKENdNrEqT3,6,5,2,0,1,0,2,0,10,1.4285714285714286,1,0.0,0,2,0,1,5,0,0,2,0,3,7,1
7949,177964,DHUv7XpIZcPp2QYGNmTXjhgg7Zq4BpJ7,bWdj2GDclj5ofokWjzoa5jAwMkxCykd6,1,0,0,0,0,0,1,0,1,0.14285714285714285,1,0.0,0,0,0,0,0,0,0,1,0,0,1,1
7950,177966,IuR34QWilyKtRzmb7qMgvf0gIZLKgowR,SpATywNh6bZuzm8s1ceuBUnMUAeoAHHw,1,0,0,0,0,0,1,0,1,0.14285714285714285,1,0.0,0,0,0,0,0,0,0,1,0,0,1,1
7951,177970,YeBJe2tNupEMDdAag9Wv20aFIU63DOgj,SpATywNh6bZuzm8s1ceuBUnMUAeoAHHw,1,0,0,0,0,0,1,0,1,0.14285714285714285,1,0.0,0,0,0,0,0,0,0,1,0,0,1,1
7952,178000,PhLYSq5B07iE4fjll2EKADOqnDhqPRc7,A3fsA9Zfv1X2fVEQhTw51lKENdNrEqT3,1,0,0,0,0,0,1,0,1,0.14285714285714285,1,0.0,0,0,0,0,0,0,0,1,0,0,1,1
7953,178016,IC7EvxrdI6aK6zztlqGy7t8EMIkvsLWH,SpATywNh6bZuzm8s1ceuBUnMUAeoAHHw,2,2,0,0,0,0,0,0,2,0.2857142857142857,1,0.0,0,0,0,0,2,0,0,0,0,0,2,1
7954,178022,LiD14ALXLddUqpdQnujGFxQiBSoJOZGF,A3fsA9Zfv1X2fVEQhTw51lKENdNrEqT3,3,3,1,0,0,0,1,0,5,0.7142857142857143,1,0.0,0,1,0,0,3,0,0,1,0,1,4,1
7955,178047,g5hqByjT71l7XQpoHooh42h6aYalEjyF,RXDvfPUBYFlVdlueBFbLW0mhhAyGEqpt,6,5,3,0,1,16,4,0,29,4.142857142857143,2,0.0,0,3,0,1,5,16,0,4,0,4,25,1
7956,178054,HyVNcqbXwwt4x7Lh0NDvZJuGvdEMSlMz,bWdj2GDclj5ofokWjzoa5jAwMkxCykd6,1,0,0,0,0,0,1,0,1,0.14285714285714285,1,0.0,0,0,0,0,0,0,0,1,0,0,1,1
7957,178056,xk56WEVJEAYlfTe18KDPHjwyCpm6eESo,RXDvfPUBYFlVdlueBFbLW0mhhAyGEqpt,4,0,0,0,0,2,5,1,8,1.1428571428571428,2,0.0,0,0,0,0,0,2,0,5,1,0,8,1
7958,178067,SM0peUZSWYQguXepyPBRDLnLmqFvDaRW,A3fsA9Zfv1X2fVEQhTw51lKENdNrEqT3,16,16,9,0,5,0,5,0,35,5.0,1,0.0,0,9,0,5,16,0,0,5,0,14,21,1
7959,178076,ctPyLd013hzE9dQTFFYRA7Z6fW1VhLt5,SpATywNh6bZuzm8s1ceuBUnMUAeoAHHw,11,14,4,10,2,0,1,0,31,4.428571428571429,1,0.0,9,4,10,2,5,0,0,1,0,25,6,1
7960,178096,YRvoydpc37Vpysmtw8O9rzowfgsZu7lO,bWdj2GDclj5ofokWjzoa5jAwMkxCykd6,3,4,0,0,0,0,1,0,5,0.7142857142857143,1,0.0,1,0,0,0,3,0,0,1,0,1,4,1
7961,178120,yiEYYQaKbyzpwJWElvWXAXdPO93zfPgh,A3fsA9Zfv1X2fVEQhTw51lKENdNrEqT3,1,0,0,0,0,0,1,0,1,0.14285714285714285,1,0.0,0,0,0,0,0,0,0,1,0,0,1,1
7962,178123,jpxpIqdWMtlxqJfj67lnudhyEHl6x8Bm,RXDvfPUBYFlVdlueBFbLW0mhhAyGEqpt,16,13,10,0,7,0,3,0,33,4.714285714285714,2,0.0,2,10,0,7,11,0,0,3,0,19,14,1
7963,178135,7vNqxUIgpaCj3NnoU9xg00b9Tp3tF5Ri,SpATywNh6bZuzm8s1ceuBUnMUAeoAHHw,9,8,4,0,3,1,5,1,22,3.142857142857143,3,0.0,0,4,0,3,8,1,0,5,1,7,15,1
7964,178140,m5gaSzexRDWD05xetdfM0AEyRBJhEUro,G8EPVSXsOYB5YQWZGiz1aVq5Pgr2GrQu,8,3,0,0,0,1,7,1,12,1.7142857142857142,1,0.0,0,0,0,0,3,1,0,7,1,0,12,1
7965,178152,oRBxd78DtsQ3mEkDyjGaQEGbdrTlmw6j,bWdj2GDclj5ofokWjzoa5jAwMkxCykd6,10,6,2,0,2,0,5,0,15,2.142857142857143,1,0.0,0,2,0,2,6,0,0,5,0,4,11,1
7966,178159,aXJa1zRW8xrdcYprvRlDR2amMkiONMef,SpATywNh6bZuzm8s1ceuBUnMUAeoAHHw,1,0,0,0,0,0,1,0,1,0.14285714285714285,1,0.0,0,0,0,0,0,0,0,1,0,0,1,1
7967,178161,PJ1wLAp2McpPLRMTf6gnqm4Wj7JimEv0,A3fsA9Zfv1X2fVEQhTw51lKENdNrEqT3,5,7,1,0,1,0,1,0,10,1.4285714285714286,1,0.0,0,1,0,1,7,0,0,1,0,2,8,1
7968,178164,dqE1PGrWExsbP4JkEoKdSn4p50FzqbEb,SpATywNh6bZuzm8s1ceuBUnMUAeoAHHw,8,75,41,0,25,7,13,0,161,23.0,1,0.0,6,41,0,25,69,7,0,13,0,72,89,1
7969,178177,bovRkt8OOEauRqwvmsqsFz6hCg8Axl1M,SpATywNh6bZuzm8s1ceuBUnMUAeoAHHw,1,0,0,0,0,0,1,0,1,0.14285714285714285,1,0.0,0,0,0,0,0,0,0,1,0,0,1,1
7970,178204,wMH9y8Ndp4UrZ98WukfHH3BPMXWwQMTj,A3fsA9Zfv1X2fVEQhTw51lKENdNrEqT3,8,6,4,0,1,0,3,0,14,2.0,1,0.0,0,4,0,1,6,0,0,3,0,5,9,1
7971,179212,R23hQIkxpjGDipcAUB8Dm9M15B8oN1UL,A3fsA9Zfv1X2fVEQhTw51lKENdNrEqT3,1,0,0,0,0,0,1,0,1,0.14285714285714285,1,0.0,0,0,0,0,0,0,0,1,0,0,1,0
7972,179254,scd3kJGQZMfO9m14NZd9uOrxe7XoIWpn,SpATywNh6bZuzm8s1ceuBUnMUAeoAHHw,16,13,6,17,1,1,6,0,44,6.285714285714286,1,0.0,6,6,15,1,7,1,2,6,0,28,16,0
7973,179269,4ML4Rs54jY3fM6KAvqncawhNmnqaKs8R,A3fsA9Zfv1X2fVEQhTw51lKENdNrEqT3,2,0,0,0,0,0,3,0,3,0.42857142857142855,1,0.0,0,0,0,0,0,0,0,3,0,0,3,1
7974,179362,RNNuxsM5xlYyyu9stwQmqEuw1Q1FUKuB,A3fsA9Zfv1X2fVEQhTw51lKENdNrEqT3,2,0,0,0,0,0,4,0,4,0.5714285714285714,1,0.0,0,0,0,0,0,0,0,4,0,0,4,1
7975,179568,hcWxPPFXJZEtM1yKNtZ1ZD1nYFNlYmMq,A3fsA9Zfv1X2fVEQhTw51lKENdNrEqT3,4,4,1,0,0,0,2,0,7,1.0,2,0.0,0,1,0,0,4,0,0,2,0,1,6,1
7976,179588,Xi3RoGAOjHAkUXOmQAg8CMkVWfFCkb7n,A3fsA9Zfv1X2fVEQhTw51lKENdNrEqT3,1,0,0,0,0,0,1,0,1,0.14285714285714285,1,0.0,0,0,0,0,0,0,0,1,0,0,1,1
7977,179601,TGiJnSEfOlHtpx1NmAAE5E7Ka91RcY3D,A3fsA9Zfv1X2fVEQhTw51lKENdNrEqT3,1,0,0,0,0,0,1,0,1,0.14285714285714285,1,0.0,0,0,0,0,0,0,0,1,0,0,1,1
7978,179630,KNNMSW3oLxGqEqv2czanNkhQgdUkOWgY,G8EPVSXsOYB5YQWZGiz1aVq5Pgr2GrQu,4,2,1,0,1,0,1,0,5,0.7142857142857143,1,0.0,0,1,0,1,2,0,0,1,0,2,3,1
7979,179667,KT45H8qrJu79sTHkCPHSA9sUb3RNHJTY,A3fsA9Zfv1X2fVEQhTw51lKENdNrEqT3,1,0,0,0,0,0,1,0,1,0.14285714285714285,1,0.0,0,0,0,0,0,0,0,1,0,0,1,1
7980,179809,FrcNdFNfLYMOg5fdBzjs15qKbgtHEYZH,bWdj2GDclj5ofokWjzoa5jAwMkxCykd6,12,8,5,0,3,0,6,1,23,3.2857142857142856,2,0.0,1,5,0,3,7,0,0,6,1,9,14,1
7981,179860,SL3jxjEQk6v82n0aWfLP80T9svpvrAxv,A3fsA9Zfv1X2fVEQhTw51lKENdNrEqT3,7,3,2,0,2,0,2,0,9,1.2857142857142858,1,0.0,0,2,0,2,3,0,0,2,0,4,5,0
7982,179969,nCZrnJjbpsSoXVwiEhCJqTYAOI3F94p9,A3fsA9Zfv1X2fVEQhTw51lKENdNrEqT3,10,5,4,0,4,0,1,0,14,2.0,1,0.0,0,4,0,4,5,0,0,1,0,8,6,1
7983,180007,d61Mq2WOkbOPuslLwPbE2HIvs5VJCHXC,A3fsA9Zfv1X2fVEQhTw51lKENdNrEqT3,2,0,0,0,0,0,2,0,2,0.2857142857142857,1,0.0,0,0,0,0,0,0,0,2,0,0,2,1
7984,180085,faKL2n0gPoXoql4sSWDfZo6er3NptGIb,7GRhBDsirIGkRZBtSMEzNTyDr2JQm4xx,2,0,0,0,0,0,2,0,2,0.2857142857142857,1,0.0,0,0,0,0,0,0,0,2,0,0,2,1
7985,180112,tqvV2MwKeLemDHIUsPAVAoV4nZW7CEvr,7GRhBDsirIGkRZBtSMEzNTyDr2JQm4xx,22,18,12,15,10,0,3,0,58,8.285714285714286,1,0.0,4,12,15,10,14,0,0,3,0,41,17,1
7986,180113,gQlwXyK2UfJePDb32xo4quF0aS1cebFG,7GRhBDsirIGkRZBtSMEzNTyDr2JQm4xx,2,0,0,0,0,0,2,0,2,0.2857142857142857,1,0.0,0,0,0,0,0,0,0,2,0,0,2,1
7987,180217,RtFjOHQ78yo3bQ6aRAVmoLevb4Ve3GxB,7GRhBDsirIGkRZBtSMEzNTyDr2JQm4xx,5,2,1,0,0,0,5,0,8,1.1428571428571428,1,0.0,0,1,0,0,2,0,0,5,0,1,7,1
7988,180225,5p1pugPSQA7ekfeoqop7HHA1WjATAX83,7GRhBDsirIGkRZBtSMEzNTyDr2JQm4xx,1,0,0,0,0,0,1,0,1,0.14285714285714285,1,0.0,0,0,0,0,0,0,0,1,0,0,1,1
7989,180244,A6zX6I2GfUhXHkfxx6hY7fkYNihUgWzR,7GRhBDsirIGkRZBtSMEzNTyDr2JQm4xx,1,0,0,0,0,0,1,0,1,0.14285714285714285,1,0.0,0,0,0,0,0,0,0,1,0,0,1,1
7990,180312,hYTVG5ANDBem3sg8QIDjen4BqqV0JGFL,7GRhBDsirIGkRZBtSMEzNTyDr2JQm4xx,1,0,0,0,0,0,1,0,1,0.14285714285714285,1,0.0,0,0,0,0,0,0,0,1,0,0,1,1
7991,182110,74kxele4p3nZqMdSzyWOOH2cXxk0mF2n,fbPkOYLVPtPgIt0MxizjfFJov3JbHyAi,7,5,2,0,3,0,5,0,15,2.142857142857143,1,0.0,2,2,0,3,3,0,0,5,0,7,8,1
7992,182111,1RfSO2DiyVK1bsd1s7TaxenvqJaPeVpp,fbPkOYLVPtPgIt0MxizjfFJov3JbHyAi,5,2,1,0,1,0,3,0,7,1.0,1,0.0,0,1,0,1,2,0,0,3,0,2,5,1
7993,182114,FIhbLaUliLEAJsxsc7jKlH4XCeC9DPXv,fbPkOYLVPtPgIt0MxizjfFJov3JbHyAi,10,5,4,0,3,0,7,1,20,2.857142857142857,1,0.0,0,4,0,3,5,0,0,7,1,7,13,1
7994,182115,5O3cQgHyrDFUqJDA7J5HOtUVaVPsBSzt,fbPkOYLVPtPgIt0MxizjfFJov3JbHyAi,6,5,2,0,2,0,1,0,10,1.4285714285714286,1,0.0,0,2,0,2,5,0,0,1,0,4,6,1
7995,182117,17rg9STHXDHiRzS91SaQJyD9M8yu2605,fbPkOYLVPtPgIt0MxizjfFJov3JbHyAi,14,10,5,7,6,0,6,0,34,4.857142857142857,1,0.0,4,5,6,6,6,0,1,6,0,21,13,1
7996,182118,ytQygmlMNZc9yKIahmW7Nv1t8JgEizoV,fbPkOYLVPtPgIt0MxizjfFJov3JbHyAi,2,0,0,0,0,0,2,0,2,0.2857142857142857,1,0.0,0,0,0,0,0,0,0,2,0,0,2,1
7997,182124,sIANk8CDDpmYWYdg4Th4BflYvOf56CEK,fbPkOYLVPtPgIt0MxizjfFJov3JbHyAi,6,5,1,0,2,0,2,0,10,1.4285714285714286,1,0.0,2,1,0,2,3,0,0,2,0,5,5,1
7998,182125,aDT6m9laxK2gk5mLuphqqVgMaj2Iqzzo,fbPkOYLVPtPgIt0MxizjfFJov3JbHyAi,1,0,0,0,0,0,1,0,1,0.14285714285714285,1,0.0,0,0,0,0,0,0,0,1,0,0,1,1
7999,182128,FgihPmscVblrwMVdNFApI0UuOBmm5ZAb,fbPkOYLVPtPgIt0MxizjfFJov3JbHyAi,1,0,0,0,0,0,1,0,1,0.14285714285714285,1,0.0,0,0,0,0,0,0,0,1,0,0,1,1
8000,182134,NZSWYEaOe1aGzYbLbh5XgSdJLgnj2k8M,fbPkOYLVPtPgIt0MxizjfFJov3JbHyAi,7,3,2,0,2,0,10,0,17,2.4285714285714284,1,0.0,0,2,0,2,3,0,0,10,0,4,13,1
8001,182135,iejOj5OrmiAxzthyfxCU4HfOTTqB4wPz,fbPkOYLVPtPgIt0MxizjfFJov3JbHyAi,6,3,2,0,1,0,3,0,9,1.2857142857142858,1,0.0,0,2,0,1,3,0,0,3,0,3,6,1
8002,182138,QLWeBu2uxsDdky4Sdm2eq1MPlPyoR8PH,fbPkOYLVPtPgIt0MxizjfFJov3JbHyAi,2,0,0,0,0,0,8,0,8,1.1428571428571428,1,0.0,0,0,0,0,0,0,0,8,0,0,8,1
8003,182139,zlBC6rRu9jlWaXBFQagY5lGC2179zznK,fbPkOYLVPtPgIt0MxizjfFJov3JbHyAi,9,4,3,0,3,8,13,0,31,4.428571428571429,1,0.0,0,3,0,3,4,8,0,13,0,6,25,1
8004,182143,dX17jSABXDRMoXQfnDhuEq3sAW2GzYho,fbPkOYLVPtPgIt0MxizjfFJov3JbHyAi,6,1,1,0,1,0,5,0,8,1.1428571428571428,1,0.0,0,1,0,1,1,0,0,5,0,2,6,1
8005,182144,65phBvShfMs4BgpXceOfsAexAndxdKUb,fbPkOYLVPtPgIt0MxizjfFJov3JbHyAi,8,5,3,0,2,0,3,0,13,1.8571428571428572,1,0.0,0,3,0,2,5,0,0,3,0,5,8,1
8006,182145,s9ikAKfIHizdIit72lZmNDpOCL8RyNmr,fbPkOYLVPtPgIt0MxizjfFJov3JbHyAi,1,0,0,0,0,0,1,0,1,0.14285714285714285,1,0.0,0,0,0,0,0,0,0,1,0,0,1,1
8007,182146,je4a6LCViJiZST1Qe1r42SwknRjAiEHX,fbPkOYLVPtPgIt0MxizjfFJov3JbHyAi,9,6,4,0,3,2,7,0,22,3.142857142857143,1,0.0,0,4,0,3,6,2,0,7,0,7,15,1
8008,182147,w6ZOM4xdCTA9pBKt304kiLQIHLSshQf0,fbPkOYLVPtPgIt0MxizjfFJov3JbHyAi,9,4,3,0,3,0,5,0,15,2.142857142857143,1,0.0,0,3,0,3,4,0,0,5,0,6,9,1
8009,182152,eXbUPJJ8vgGBYCYeE2hEC0aNbKdSDbEs,fbPkOYLVPtPgIt0MxizjfFJov3JbHyAi,1,0,0,0,0,0,1,0,1,0.14285714285714285,1,0.0,0,0,0,0,0,0,0,1,0,0,1,1
8010,182154,0TrmohedmafnRfHAroMKgKRtGWbbpH4N,fbPkOYLVPtPgIt0MxizjfFJov3JbHyAi,2,0,0,0,0,0,6,0,6,0.8571428571428571,1,0.0,0,0,0,0,0,0,0,6,0,0,6,1
8011,182155,BoBgrmtQAbGEQdCkYjgMVVWzk508tw3x,fbPkOYLVPtPgIt0MxizjfFJov3JbHyAi,4,2,1,0,1,0,1,0,5,0.7142857142857143,1,0.0,0,1,0,1,2,0,0,1,0,2,3,1
8012,182156,DLmLcsmmZc2iMAWHNtxeaYm4TYub9M4W,fbPkOYLVPtPgIt0MxizjfFJov3JbHyAi,1,0,0,0,0,0,1,0,1,0.14285714285714285,1,0.0,0,0,0,0,0,0,0,1,0,0,1,1
8013,182159,ntaJKTMgiTQfD5Tbv9HcsBpNugCaYi0b,fbPkOYLVPtPgIt0MxizjfFJov3JbHyAi,1,0,0,0,0,0,2,0,2,0.2857142857142857,1,0.0,0,0,0,0,0,0,0,2,0,0,2,1
8014,182160,wKSiPD3ccCI47tDYWhx56Wd2BJP8ki2L,fbPkOYLVPtPgIt0MxizjfFJov3JbHyAi,9,7,3,0,3,5,4,1,23,3.2857142857142856,1,0.0,2,3,0,3,5,5,0,4,1,8,15,1
8015,182162,itIzAmwxr6fy2yhmRnAPbRxBE6DJmsTD,fbPkOYLVPtPgIt0MxizjfFJov3JbHyAi,23,27,14,17,15,0,2,0,75,10.714285714285714,1,0.0,12,14,14,15,15,0,3,2,0,55,20,1
8016,182318,dVj05AozpSMnDp2rhv4XKLX2a6Zq0Qtw,SpATywNh6bZuzm8s1ceuBUnMUAeoAHHw,2,0,0,0,0,0,2,0,2,0.2857142857142857,1,0.0,0,0,0,0,0,0,0,2,0,0,2,1
8017,182332,ssNBIPbMZoiJEHlxM1JuEFEFm67Micu2,SpATywNh6bZuzm8s1ceuBUnMUAeoAHHw,6,2,0,0,0,4,14,6,26,3.7142857142857144,1,0.0,0,0,0,0,2,4,0,14,6,0,26,1
8018,182346,yuwVVMBtTYqYgFk8HBT2CeCSsbPznS4I,SpATywNh6bZuzm8s1ceuBUnMUAeoAHHw,6,8,1,0,1,4,6,0,20,2.857142857142857,2,0.0,0,1,0,1,8,4,0,6,0,2,18,1
8019,182375,L7M3Ksh9UBx3xOMl31gqtqz6gfclvqlN,SpATywNh6bZuzm8s1ceuBUnMUAeoAHHw,7,11,4,0,1,1,6,0,23,3.2857142857142856,3,0.0,0,4,0,1,11,1,0,6,0,5,18,1
8020,182376,QlyEMMfomXdFJCE0WvpazQe9ZaXY0FQw,SpATywNh6bZuzm8s1ceuBUnMUAeoAHHw,1,0,0,0,0,0,2,0,2,0.2857142857142857,1,0.0,0,0,0,0,0,0,0,2,0,0,2,1
8021,182379,JdJ1SwT93OWgPbpS5GdJzD3RLASaE4SR,RXDvfPUBYFlVdlueBFbLW0mhhAyGEqpt,22,14,10,44,7,0,1,0,76,10.857142857142858,1,0.0,3,10,40,7,11,0,4,1,0,60,16,1
8022,182384,ORzIK1DF1vIanXrZDWEgyHCiC4GvvfBc,SpATywNh6bZuzm8s1ceuBUnMUAeoAHHw,4,3,1,0,1,0,3,0,8,1.1428571428571428,1,0.0,0,1,0,1,3,0,0,3,0,2,6,1
8023,182391,UoSDdKW8bXtB0Kuj20V0r0Rw6UViB6yh,SpATywNh6bZuzm8s1ceuBUnMUAeoAHHw,5,1,0,0,0,2,7,1,11,1.5714285714285714,1,0.0,0,0,0,0,1,2,0,7,1,0,11,1
8024,182394,0f1EqzZzcXc3MSIWeoaoeCrrqcxrvxwo,bWdj2GDclj5ofokWjzoa5jAwMkxCykd6,2,0,0,0,0,0,2,0,2,0.2857142857142857,1,0.0,0,0,0,0,0,0,0,2,0,0,2,1
8025,182395,pvxjw4szSuluDWQ3DWPes9Mzs1MCvxjI,G8EPVSXsOYB5YQWZGiz1aVq5Pgr2GrQu,6,3,2,0,2,0,1,0,8,1.1428571428571428,1,0.0,0,2,0,2,3,0,0,1,0,4,4,1
8026,182399,vheHPiBs6HjJGbv3Snt0SQIKMYHc5UaU,SpATywNh6bZuzm8s1ceuBUnMUAeoAHHw,3,2,1,0,0,0,1,0,4,0.5714285714285714,1,0.0,0,1,0,0,2,0,0,1,0,1,3,1
8027,182402,UdmIlH1y5ROywT4Ry6jaou64JO5vWiAz,RXDvfPUBYFlVdlueBFbLW0mhhAyGEqpt,1,0,0,0,0,0,1,0,1,0.14285714285714285,1,0.0,0,0,0,0,0,0,0,1,0,0,1,1
8028,182403,ED2sXONkBYI0OZyQYOJ9ygAn9aUKK1Wk,SpATywNh6bZuzm8s1ceuBUnMUAeoAHHw,11,11,6,0,3,4,4,1,29,4.142857142857143,1,0.0,3,6,0,3,8,4,0,4,1,12,17,1
8029,182404,zfXJRVQB9jP4gtyolibVkLvC6I4sMq4Z,SpATywNh6bZuzm8s1ceuBUnMUAeoAHHw,13,9,7,0,3,1,6,1,27,3.857142857142857,1,0.0,0,7,0,3,9,1,0,6,1,10,17,1
8030,182416,Efp2zT9GZ53ahT7m5PosJWOFPjhn8JqA,SpATywNh6bZuzm8s1ceuBUnMUAeoAHHw,1,0,0,0,0,0,1,0,1,0.14285714285714285,1,0.0,0,0,0,0,0,0,0,1,0,0,1,1
8031,182417,4PtDSHhkS4yeMTirE5mvkBBwP3dmM9Qp,SpATywNh6bZuzm8s1ceuBUnMUAeoAHHw,9,8,1,8,0,0,1,0,18,2.5714285714285716,1,0.0,3,1,8,0,5,0,0,1,0,12,6,1
8032,182419,x22fjNSFy0R926MDZKZwS7I3gfP8Gm84,SpATywNh6bZuzm8s1ceuBUnMUAeoAHHw,7,3,2,0,2,0,4,0,11,1.5714285714285714,1,0.0,0,2,0,2,3,0,0,4,0,4,7,1
8033,182420,pYlHnfVkpsPzITBRcvdTXUYMyNXMgg3O,SpATywNh6bZuzm8s1ceuBUnMUAeoAHHw,1,0,0,0,0,0,1,0,1,0.14285714285714285,1,0.0,0,0,0,0,0,0,0,1,0,0,1,1
8034,182427,cZXuWsaeYW0DT1jWDe6bxRqc9qfzrr3C,SpATywNh6bZuzm8s1ceuBUnMUAeoAHHw,5,3,1,0,1,4,3,0,12,1.7142857142857142,1,0.0,0,1,0,1,3,4,0,3,0,2,10,1
8035,182430,3Gc9QM94u4cd0Dw8TEKRCkl8s35hHWXM,SpATywNh6bZuzm8s1ceuBUnMUAeoAHHw,9,4,3,0,3,0,2,0,12,1.7142857142857142,1,0.0,0,3,0,3,4,0,0,2,0,6,6,1
8036,182436,UvIGBO3KU0rWCndAPFCCP6wfS7NUy3B1,SpATywNh6bZuzm8s1ceuBUnMUAeoAHHw,2,0,0,0,0,0,3,0,3,0.42857142857142855,1,0.0,0,0,0,0,0,0,0,3,0,0,3,1
8037,182439,Ilz4MVKb2TGAxWTIiq19EE5elYfPlhdl,SpATywNh6bZuzm8s1ceuBUnMUAeoAHHw,9,6,4,0,3,0,5,0,18,2.5714285714285716,1,0.0,0,4,0,3,6,0,0,5,0,7,11,1
8038,182441,vaWLVKWyrsUzDV0qs20ZUq8M3VNW01Uk,RXDvfPUBYFlVdlueBFbLW0mhhAyGEqpt,1,0,0,0,0,0,1,0,1,0.14285714285714285,1,0.0,0,0,0,0,0,0,0,1,0,0,1,1
8039,182444,SPRinDndbzCEO5Ph1nH3gJGoP1uaeA7R,G8EPVSXsOYB5YQWZGiz1aVq5Pgr2GrQu,1,0,0,0,0,0,1,0,1,0.14285714285714285,1,0.0,0,0,0,0,0,0,0,1,0,0,1,1
8040,182445,Ww3MvCXkT8tDnrpdz1E1wBxJBjpXj1Rq,SpATywNh6bZuzm8s1ceuBUnMUAeoAHHw,5,2,1,0,1,0,2,0,6,0.8571428571428571,1,0.0,0,1,0,1,2,0,0,2,0,2,4,1
8041,182448,hFzrRa1GPtD5a7H30wae91F5SOZlRQO1,SpATywNh6bZuzm8s1ceuBUnMUAeoAHHw,9,8,1,0,0,2,6,1,18,2.5714285714285716,1,0.0,0,1,0,0,8,2,0,6,1,1,17,1
8042,182450,8NJMmSdWvECNT7Pwfk6FLAypMClX0z5v,SpATywNh6bZuzm8s1ceuBUnMUAeoAHHw,4,2,1,0,0,0,2,0,5,0.7142857142857143,1,0.0,0,1,0,0,2,0,0,2,0,1,4,1
8043,182453,8ZePp5sXciCV5oXPjTIQbWFxt1SxfcLl,SpATywNh6bZuzm8s1ceuBUnMUAeoAHHw,10,3,2,0,2,2,5,1,15,2.142857142857143,1,0.0,0,2,0,2,3,2,0,5,1,4,11,1
8044,182466,FYh1ETHUxyunx6o3SR9eAC4QbrxXPzoc,RXDvfPUBYFlVdlueBFbLW0mhhAyGEqpt,8,7,3,0,2,0,3,0,15,2.142857142857143,1,0.0,0,3,0,2,7,0,0,3,0,5,10,1
8045,182470,YITGGXKhxzNHdElox232lzcaZdJ61YFn,bWdj2GDclj5ofokWjzoa5jAwMkxCykd6,5,2,1,0,1,3,3,0,10,1.4285714285714286,1,0.0,0,1,0,1,2,3,0,3,0,2,8,1
8046,182472,BeFe1KokGOrbanlGLijG18LEqInxi9W4,RXDvfPUBYFlVdlueBFbLW0mhhAyGEqpt,1,0,0,0,0,0,1,0,1,0.14285714285714285,1,0.0,0,0,0,0,0,0,0,1,0,0,1,1
8047,182476,ryyeh5DB53zHNKeo2vkO5VPfDAHRLLxK,SpATywNh6bZuzm8s1ceuBUnMUAeoAHHw,5,4,0,0,0,0,2,0,6,0.8571428571428571,1,0.0,0,0,0,0,4,0,0,2,0,0,6,1
8048,182478,ywCBITW2Nk5KrEWUjIfEEyRW364OA7v3,SpATywNh6bZuzm8s1ceuBUnMUAeoAHHw,7,4,2,0,0,0,4,0,10,1.4285714285714286,1,0.0,0,2,0,0,4,0,0,4,0,2,8,1
8049,182483,Wm4boeiuAufaIeI7PkgbnseZNqzvwXoA,RXDvfPUBYFlVdlueBFbLW0mhhAyGEqpt,1,0,0,0,0,0,1,0,1,0.14285714285714285,1,0.0,0,0,0,0,0,0,0,1,0,0,1,1
8050,182484,nJFL4ZgVlk8vsvSCMEvmMvfyFCPNkQbb,bWdj2GDclj5ofokWjzoa5jAwMkxCykd6,2,0,0,0,0,0,2,0,2,0.2857142857142857,1,0.0,0,0,0,0,0,0,0,2,0,0,2,1
8051,182490,5kux74rVeqoEvbABYMpdIOO6ta3zLim7,bWdj2GDclj5ofokWjzoa5jAwMkxCykd6,3,2,1,0,0,0,1,0,4,0.5714285714285714,1,0.0,0,1,0,0,2,0,0,1,0,1,3,1
8052,182491,HxeyM7hnjqqrHkT4PVJnwDZtWwoxUMiy,RXDvfPUBYFlVdlueBFbLW0mhhAyGEqpt,1,0,0,0,0,0,1,0,1,0.14285714285714285,1,0.0,0,0,0,0,0,0,0,1,0,0,1,1
8053,182496,FWAi9SzUY3hC5pRVyJkleZ3oNtaFNi6V,SpATywNh6bZuzm8s1ceuBUnMUAeoAHHw,2,0,0,0,0,0,2,0,2,0.2857142857142857,1,0.0,0,0,0,0,0,0,0,2,0,0,2,1
8054,182497,zsHSwvXoubMUxhT2AYVzfcvRGMppEBUX,G8EPVSXsOYB5YQWZGiz1aVq5Pgr2GrQu,1,0,0,0,0,0,1,0,1,0.14285714285714285,1,0.0,0,0,0,0,0,0,0,1,0,0,1,1
8055,182499,9bY2ODFG0JcDRpzNxe1p1poGx2Xx1OUa,SpATywNh6bZuzm8s1ceuBUnMUAeoAHHw,6,6,0,0,0,0,4,0,10,1.4285714285714286,1,0.0,0,0,0,0,6,0,0,4,0,0,10,1
8056,182508,e3jS2U1BhNpArENK983B1rVL1JoqwREV,SpATywNh6bZuzm8s1ceuBUnMUAeoAHHw,8,6,3,0,3,0,1,0,13,1.8571428571428572,1,0.0,0,3,0,3,6,0,0,1,0,6,7,1
8057,182515,oElQ0NJpFnzZRtGV3YErd6rr4i8DxzbB,SpATywNh6bZuzm8s1ceuBUnMUAeoAHHw,6,4,2,0,1,0,2,0,9,1.2857142857142858,1,0.0,0,2,0,1,4,0,0,2,0,3,6,1
8058,182524,IKXwL3bDtlAxjRP4WWhZczJlcbIhG3ib,G8EPVSXsOYB5YQWZGiz1aVq5Pgr2GrQu,9,7,5,0,4,1,6,1,24,3.4285714285714284,1,0.0,0,5,0,4,7,1,0,6,1,9,15,1
8059,182527,QoLZveDbZCrcOypIzCYKhgphRVMR37f0,SpATywNh6bZuzm8s1ceuBUnMUAeoAHHw,7,11,5,0,3,0,5,0,24,3.4285714285714284,1,0.0,2,5,0,3,9,0,0,5,0,10,14,1
8060,182540,68zow3PIETzGkbgKSgGqp4cft1zzT0Wg,SpATywNh6bZuzm8s1ceuBUnMUAeoAHHw,15,29,13,18,5,23,11,0,99,14.142857142857142,2,0.0,6,13,15,5,23,23,3,11,0,39,60,1
8061,182548,1wTTPpSWNZRGQY72YsG9M4kDyp3wXVIX,SpATywNh6bZuzm8s1ceuBUnMUAeoAHHw,9,4,0,3,0,0,5,2,14,2.0,1,0.0,1,0,3,0,3,0,0,5,2,4,10,1
8062,182552,ykEW9evpDPHZbB36kn5ppyB9XHnMY2SE,bWdj2GDclj5ofokWjzoa5jAwMkxCykd6,4,2,1,0,0,0,2,0,5,0.7142857142857143,1,0.0,0,1,0,0,2,0,0,2,0,1,4,1
8063,182556,0dYUj8IzWWp9WKVei3srYo9Z7019GkyS,SpATywNh6bZuzm8s1ceuBUnMUAeoAHHw,6,2,1,0,1,0,3,0,7,1.0,1,0.0,0,1,0,1,2,0,0,3,0,2,5,1
8064,182565,BtOoPJiqJpi7FXEZFIq8NLvECwNXeaZ8,SpATywNh6bZuzm8s1ceuBUnMUAeoAHHw,6,1,1,0,1,0,3,0,6,0.8571428571428571,1,0.0,0,1,0,1,1,0,0,3,0,2,4,1
8065,182572,L3vH8w9MBmyNbE6zYIQcQAgtUd2AVGJ2,bWdj2GDclj5ofokWjzoa5jAwMkxCykd6,2,0,0,0,0,0,2,0,2,0.2857142857142857,1,0.0,0,0,0,0,0,0,0,2,0,0,2,1
8066,182574,9HtqmGFwW9nlaXQoPiq8Q0exBzv6okJA,SpATywNh6bZuzm8s1ceuBUnMUAeoAHHw,6,2,1,0,1,0,10,0,14,2.0,1,0.0,0,1,0,1,2,0,0,10,0,2,12,1
8067,182583,67xpG0g0SaNRrqSFMK3Slz5FQV4uaOHQ,SpATywNh6bZuzm8s1ceuBUnMUAeoAHHw,7,2,1,0,1,0,4,2,10,1.4285714285714286,1,0.0,0,1,0,1,2,0,0,4,2,2,8,1
8068,182590,AgVRfkL9ddoBcgWiMEqgB28oDseRQMfR,G8EPVSXsOYB5YQWZGiz1aVq5Pgr2GrQu,7,10,0,0,0,0,2,0,12,1.7142857142857142,1,0.0,1,0,0,0,9,0,0,2,0,1,11,1
8069,182592,o8FE9F7Hj949CAE87fPDQyCYZ9zgH4qv,SpATywNh6bZuzm8s1ceuBUnMUAeoAHHw,1,0,0,0,0,0,1,0,1,0.14285714285714285,1,0.0,0,0,0,0,0,0,0,1,0,0,1,1
8070,182593,MV8XdB3h6ePuBNN3BGaZCvIfimFFX0Mk,SpATywNh6bZuzm8s1ceuBUnMUAeoAHHw,1,0,0,0,0,0,1,0,1,0.14285714285714285,1,0.0,0,0,0,0,0,0,0,1,0,0,1,1
8071,182595,iQCW6W4nBE7M3nPE1JFW3uJTussgN79A,SpATywNh6bZuzm8s1ceuBUnMUAeoAHHw,7,2,1,0,1,0,5,1,10,1.4285714285714286,1,0.0,0,1,0,1,2,0,0,5,1,2,8,1
8072,182596,i1weaEaafaiWi31Ms4bwoF6JM4IRf714,G8EPVSXsOYB5YQWZGiz1aVq5Pgr2GrQu,14,27,11,20,7,0,2,0,67,9.571428571428571,1,0.0,14,11,11,7,13,0,9,2,0,43,24,1
8073,182599,C82stxYBdobab5s8FnzuMHxgMBwKu2tD,SpATywNh6bZuzm8s1ceuBUnMUAeoAHHw,3,2,0,0,0,0,2,0,4,0.5714285714285714,1,0.0,0,0,0,0,2,0,0,2,0,0,4,1
8074,182602,pC6FwYDHxh9swUa6nvJYcLLtE0AYC1Cg,bWdj2GDclj5ofokWjzoa5jAwMkxCykd6,1,0,0,0,0,0,1,0,1,0.14285714285714285,1,0.0,0,0,0,0,0,0,0,1,0,0,1,1
8075,182604,YYm9SLmjJQnTtFQLnNCxEK5OKVRWWeS9,SpATywNh6bZuzm8s1ceuBUnMUAeoAHHw,7,7,3,0,3,1,2,0,16,2.2857142857142856,1,0.0,0,3,0,3,7,1,0,2,0,6,10,1
8076,182610,VR4kpCHjSnr2YglEgcuTrivL0Gg47pGL,SpATywNh6bZuzm8s1ceuBUnMUAeoAHHw,13,15,7,18,5,0,2,0,47,6.714285714285714,1,0.0,6,7,15,5,9,0,3,2,0,33,14,1
8077,182611,WtbenHJvVPK6SiW3psJUnjqNlshJ00ku,SpATywNh6bZuzm8s1ceuBUnMUAeoAHHw,9,5,0,0,0,1,5,1,12,1.7142857142857142,1,0.0,0,0,0,0,5,1,0,5,1,0,12,1
8078,182614,UuSIoFbtQOfzMmWUxokidkbXgJFaHXwx,bWdj2GDclj5ofokWjzoa5jAwMkxCykd6,1,0,0,0,0,0,1,0,1,0.14285714285714285,1,0.0,0,0,0,0,0,0,0,1,0,0,1,1
8079,182623,Vqh7IxciNu3w4ryq9DwYRMQWb1h8f16V,G8EPVSXsOYB5YQWZGiz1aVq5Pgr2GrQu,11,13,7,0,4,19,5,0,48,6.857142857142857,1,0.0,0,7,0,4,13,19,0,5,0,11,37,1
8080,182626,1P2LChndrUiRCjj6mVB5w5hmLH8bp8jB,SpATywNh6bZuzm8s1ceuBUnMUAeoAHHw,7,6,1,0,1,0,3,0,11,1.5714285714285714,1,0.0,0,1,0,1,6,0,0,3,0,2,9,1
8081,182629,x5W7px1blVgXPSeduQeF8luvK0oCFfzJ,RXDvfPUBYFlVdlueBFbLW0mhhAyGEqpt,1,0,0,0,0,0,1,0,1,0.14285714285714285,1,0.0,0,0,0,0,0,0,0,1,0,0,1,1
8082,182633,XO0d4deCWOy3mmgL5fsAr1MAAwghPAkB,RXDvfPUBYFlVdlueBFbLW0mhhAyGEqpt,38,50,3,86,5,1,11,0,156,22.285714285714285,1,0.0,16,3,80,5,34,1,6,11,0,104,52,1
8083,182639,COhPD73W4lvIiazL2vbp3j5FVs5HQ601,SpATywNh6bZuzm8s1ceuBUnMUAeoAHHw,5,2,1,0,1,0,2,0,6,0.8571428571428571,1,0.0,0,1,0,1,2,0,0,2,0,2,4,1
8084,182640,2Wz9ixAR47Et860ivxArFAVvspY1IqDz,bWdj2GDclj5ofokWjzoa5jAwMkxCykd6,6,3,0,24,0,1,2,0,30,4.285714285714286,1,0.0,1,0,23,0,2,1,1,2,0,24,6,1
8085,182643,1IgVs7QdLHhnPG0jFRERCqu2Y9FlWiVF,G8EPVSXsOYB5YQWZGiz1aVq5Pgr2GrQu,3,0,0,0,0,3,2,0,5,0.7142857142857143,1,0.0,0,0,0,0,0,3,0,2,0,0,5,1
8086,182647,8P2IV2kWoU5ZCAhZNesFZXBCmVIcwHGV,SpATywNh6bZuzm8s1ceuBUnMUAeoAHHw,15,33,2,18,0,5,15,2,75,10.714285714285714,2,0.0,7,2,15,0,26,5,3,15,2,24,51,1
8087,182664,VHKy90msZ6s6PWErEswELl083Xh3kNC6,SpATywNh6bZuzm8s1ceuBUnMUAeoAHHw,10,7,1,14,1,9,5,0,37,5.285714285714286,2,0.0,2,1,13,1,5,9,1,5,0,17,20,1
8088,182669,PhL2ZyLw1V28vd4DfOVSi8FZIcPFQkVx,bWdj2GDclj5ofokWjzoa5jAwMkxCykd6,4,2,1,0,1,1,1,0,6,0.8571428571428571,1,0.0,0,1,0,1,2,1,0,1,0,2,4,1
8089,182671,GANbW2mfChK4bd2m73sodc3ItJtDn1ba,SpATywNh6bZuzm8s1ceuBUnMUAeoAHHw,4,0,0,0,0,0,3,1,4,0.5714285714285714,1,0.0,0,0,0,0,0,0,0,3,1,0,4,1
8090,182672,L8GepxGnZH9aQkkBlOp07iXjAUHLfNwr,SpATywNh6bZuzm8s1ceuBUnMUAeoAHHw,3,5,0,0,0,0,1,0,6,0.8571428571428571,1,0.0,2,0,0,0,3,0,0,1,0,2,4,1
8091,182675,XYKEbaRABcMuBHmMB2I3YkBepzCp0swB,bWdj2GDclj5ofokWjzoa5jAwMkxCykd6,5,14,2,0,1,0,4,0,21,3.0,2,0.0,2,2,0,1,12,0,0,4,0,5,16,1
8092,182696,GcJFzpyOdnnoWwg3V1INu4JCOvQXcJgJ,SpATywNh6bZuzm8s1ceuBUnMUAeoAHHw,1,0,0,0,0,0,1,0,1,0.14285714285714285,1,0.0,0,0,0,0,0,0,0,1,0,0,1,1
8093,182699,RAGQmaCMG2kfcGeGG7CgUDmUq1d4kIyn,G8EPVSXsOYB5YQWZGiz1aVq5Pgr2GrQu,2,0,0,0,0,0,4,0,4,0.5714285714285714,1,0.0,0,0,0,0,0,0,0,4,0,0,4,1
8094,182702,3QS27JowcKsai44171i1lf7TLJ6jrzZW,SpATywNh6bZuzm8s1ceuBUnMUAeoAHHw,6,5,2,0,1,0,2,0,10,1.4285714285714286,1,0.0,2,2,0,1,3,0,0,2,0,5,5,1
8095,182705,vgiQpvSAFn3WqqXXyEm42CrUfpctzUEX,SpATywNh6bZuzm8s1ceuBUnMUAeoAHHw,5,2,1,0,1,0,2,0,6,0.8571428571428571,1,0.0,0,1,0,1,2,0,0,2,0,2,4,1
8096,182714,SDvatKCgfdtv12UzJLxR0GYxgD4pUkgT,bWdj2GDclj5ofokWjzoa5jAwMkxCykd6,3,3,1,0,0,0,2,0,6,0.8571428571428571,1,0.0,0,1,0,0,3,0,0,2,0,1,5,1
8097,182718,e9IMJZnDOQwZUgVPoYAYW4meXQnaglvw,SpATywNh6bZuzm8s1ceuBUnMUAeoAHHw,10,2,2,0,2,0,8,3,17,2.4285714285714284,1,0.0,0,2,0,2,2,0,0,8,3,4,13,1
8098,182724,TV8zrBdNM1adKaAPI8D2c3PyvuLKkNEi,SpATywNh6bZuzm8s1ceuBUnMUAeoAHHw,8,2,1,0,1,3,7,1,15,2.142857142857143,1,0.0,0,1,0,1,2,3,0,7,1,2,13,1
8099,182742,YMU8P29wy18QfGxug1svcdE5aeLt8eef,SpATywNh6bZuzm8s1ceuBUnMUAeoAHHw,13,14,5,0,2,5,10,1,37,5.285714285714286,1,0.0,2,5,0,2,12,5,0,10,1,9,28,1
8100,182744,AXhSW785x6j50916e34SRK9faB9FqLBm,SpATywNh6bZuzm8s1ceuBUnMUAeoAHHw,2,0,0,0,0,0,2,0,2,0.2857142857142857,1,0.0,0,0,0,0,0,0,0,2,0,0,2,1
8101,182746,ADL0cXowUMs4wyiAOHKMOrtTHu5tmUqi,SpATywNh6bZuzm8s1ceuBUnMUAeoAHHw,5,5,3,0,2,0,2,0,12,1.7142857142857142,1,0.0,0,3,0,2,5,0,0,2,0,5,7,1
8102,182751,s4TEJX3ZSvr4kBLGdjg6CpTOCIceK5wi,SpATywNh6bZuzm8s1ceuBUnMUAeoAHHw,1,0,0,0,0,0,1,0,1,0.14285714285714285,1,0.0,0,0,0,0,0,0,0,1,0,0,1,1
8103,182755,CwJSAfmXBIxjg0tYJaLcAWBrHja9U2kJ,SpATywNh6bZuzm8s1ceuBUnMUAeoAHHw,5,3,0,0,0,0,5,0,8,1.1428571428571428,1,0.0,0,0,0,0,3,0,0,5,0,0,8,1
8104,182766,ywNFtohqWrdbrhEW62rPnGjVYfzTZ181,SpATywNh6bZuzm8s1ceuBUnMUAeoAHHw,1,0,0,0,0,0,1,0,1,0.14285714285714285,1,0.0,0,0,0,0,0,0,0,1,0,0,1,1
8105,182768,wVdlJl1TkeMQ7fPs3s7SDiFZ9EQoXXFL,RXDvfPUBYFlVdlueBFbLW0mhhAyGEqpt,1,0,0,0,0,0,1,0,1,0.14285714285714285,1,0.0,0,0,0,0,0,0,0,1,0,0,1,1
8106,182781,myIIBocNFelldmuN47bMrRiORGKDSj7S,RXDvfPUBYFlVdlueBFbLW0mhhAyGEqpt,1,0,0,0,0,0,1,0,1,0.14285714285714285,1,0.0,0,0,0,0,0,0,0,1,0,0,1,1
8107,182783,H5XDLEjPVO5GyYRwYkINM9ORsYQG2YvW,SpATywNh6bZuzm8s1ceuBUnMUAeoAHHw,13,12,4,14,3,0,1,0,34,4.857142857142857,1,0.0,5,4,13,3,7,0,1,1,0,25,9,1
8108,182796,G1LkA451FC6E6IOfdWKqpy8y2lc8YSzz,SpATywNh6bZuzm8s1ceuBUnMUAeoAHHw,6,5,2,0,0,0,4,0,11,1.5714285714285714,1,0.0,0,2,0,0,5,0,0,4,0,2,9,1
8109,182815,JfAsemHlarA2F9Qw0stOCWfmH1qVmt8W,SpATywNh6bZuzm8s1ceuBUnMUAeoAHHw,1,0,0,0,0,0,1,0,1,0.14285714285714285,1,0.0,0,0,0,0,0,0,0,1,0,0,1,1
8110,182831,ZNcLOAJ2r3H5DqhbGk1CiPtwI7ixaCeK,RXDvfPUBYFlVdlueBFbLW0mhhAyGEqpt,5,7,4,0,1,0,4,0,16,2.2857142857142856,2,0.0,0,4,0,1,7,0,0,4,0,5,11,1
8111,182833,7cuOR7XN3OKWyCY4rmOlBcFyB6vgzoQs,bWdj2GDclj5ofokWjzoa5jAwMkxCykd6,9,13,3,34,3,0,4,0,57,8.142857142857142,1,0.0,5,3,33,3,8,0,1,4,0,44,13,1
8112,182849,2CWwtE86TUtrUhYms4GqpHHdjjzejIiw,RXDvfPUBYFlVdlueBFbLW0mhhAyGEqpt,10,9,0,0,0,0,1,0,10,1.4285714285714286,1,0.0,0,0,0,0,9,0,0,1,0,0,10,1
8113,182851,dJrIkntdHmFqt2nNdHl0WRj6RFfeHhWR,G8EPVSXsOYB5YQWZGiz1aVq5Pgr2GrQu,3,0,0,0,0,1,2,0,3,0.42857142857142855,1,0.0,0,0,0,0,0,1,0,2,0,0,3,1
8114,182860,foTg5qEPNfrsoDSNAhj65g7lMuh2VdSR,SpATywNh6bZuzm8s1ceuBUnMUAeoAHHw,1,0,0,0,0,0,1,0,1,0.14285714285714285,1,0.0,0,0,0,0,0,0,0,1,0,0,1,1
8115,182872,Klt9qoufCaIWdba44x7MkMWwmjaj9rrO,G8EPVSXsOYB5YQWZGiz1aVq5Pgr2GrQu,8,5,3,0,2,0,4,0,14,2.0,1,0.0,0,3,0,2,5,0,0,4,0,5,9,1
8116,182876,73K789g4e0jr9RbqLOh1RUOvDP0ZYtaO,SpATywNh6bZuzm8s1ceuBUnMUAeoAHHw,1,0,0,0,0,0,1,0,1,0.14285714285714285,1,0.0,0,0,0,0,0,0,0,1,0,0,1,1
8117,182884,q1zfV7JQnPHYBA4GkSf8RBmBmzIBSPXp,SpATywNh6bZuzm8s1ceuBUnMUAeoAHHw,1,0,0,0,0,0,2,0,2,0.2857142857142857,1,0.0,0,0,0,0,0,0,0,2,0,0,2,1
8118,182901,ROcCBAUDWCCmSmJWa8UkAc38NUTaJmvd,SpATywNh6bZuzm8s1ceuBUnMUAeoAHHw,7,7,6,0,4,0,1,0,18,2.5714285714285716,1,0.0,0,6,0,4,7,0,0,1,0,10,8,1
8119,182902,Gj3pHpaNgZrapEPZYhvbfuaS2aMS6tgO,SpATywNh6bZuzm8s1ceuBUnMUAeoAHHw,1,0,0,0,0,0,1,0,1,0.14285714285714285,1,0.0,0,0,0,0,0,0,0,1,0,0,1,1
8120,182909,kZLA3umCB77AeK17F9sH7z1Ojbpf7TLv,RXDvfPUBYFlVdlueBFbLW0mhhAyGEqpt,11,9,6,0,3,0,2,0,20,2.857142857142857,1,0.0,3,6,0,3,6,0,0,2,0,12,8,1
8121,182910,woTsCvW1lUQJlNZPTxvW6TWDeSBjlE3x,SpATywNh6bZuzm8s1ceuBUnMUAeoAHHw,15,45,2,21,2,4,7,1,82,11.714285714285714,1,0.0,32,2,16,2,13,4,5,7,1,52,30,1
8122,182923,7kYJ9SFEtYe6Heh67x8Vp6BF2X3NW60w,SpATywNh6bZuzm8s1ceuBUnMUAeoAHHw,5,2,1,0,0,0,5,0,8,1.1428571428571428,1,0.0,0,1,0,0,2,0,0,5,0,1,7,1
8123,182928,hOv5RKQK1RGRxpJJGcW0k2cA3RwQ8Rk5,SpATywNh6bZuzm8s1ceuBUnMUAeoAHHw,8,9,5,0,3,0,3,0,20,2.857142857142857,2,0.0,2,5,0,3,7,0,0,3,0,10,10,1
8124,182929,czJlHgmBYIN2fkWm8DMCxTMvIB7CPSjD,SpATywNh6bZuzm8s1ceuBUnMUAeoAHHw,1,0,0,0,0,0,1,0,1,0.14285714285714285,1,0.0,0,0,0,0,0,0,0,1,0,0,1,1
8125,182953,tmP3hiAxOmIcth7vkvpHKk2OIqOO5u37,bWdj2GDclj5ofokWjzoa5jAwMkxCykd6,4,5,1,0,0,0,1,0,7,1.0,1,0.0,0,1,0,0,5,0,0,1,0,1,6,1
8126,182959,4uRRd3ZIFdyKPTDLtcF8p2hJfez66l8b,bWdj2GDclj5ofokWjzoa5jAwMkxCykd6,4,2,1,0,1,0,1,0,5,0.7142857142857143,1,0.0,0,1,0,1,2,0,0,1,0,2,3,1
8127,182961,XNpvXjwLvaeOlYFUhwJmIuJfOHxWLTUx,SpATywNh6bZuzm8s1ceuBUnMUAeoAHHw,8,11,5,3,0,0,2,0,21,3.0,1,0.0,5,5,3,0,6,0,0,2,0,13,8,1
8128,182971,LslskpvRu2kdJKdLBrkhLUwON3Gy18Vo,bWdj2GDclj5ofokWjzoa5jAwMkxCykd6,10,3,2,12,2,0,3,0,22,3.142857142857143,1,0.0,1,2,12,2,2,0,0,3,0,17,5,0
8129,182975,TVBdP57RgHmXdzDOQxhhxrruZniECnNa,SpATywNh6bZuzm8s1ceuBUnMUAeoAHHw,10,11,7,0,3,10,10,2,43,6.142857142857143,2,0.0,0,7,0,3,11,10,0,10,2,10,33,1
8130,182978,WRGP3RiE3PgQD7N1Gw3XyQmMvgPUNX5x,SpATywNh6bZuzm8s1ceuBUnMUAeoAHHw,10,15,9,0,5,1,13,2,45,6.428571428571429,1,0.0,0,9,0,5,15,1,0,13,2,14,31,1
8131,182990,LHjZbHCdMckrMwOq7c5kO6EdbIUV0ZXr,SpATywNh6bZuzm8s1ceuBUnMUAeoAHHw,1,0,0,0,0,0,1,0,1,0.14285714285714285,1,0.0,0,0,0,0,0,0,0,1,0,0,1,1
8132,182992,p0pdpDYYJlDvrp00zDzLRGjYUqDxuGfa,SpATywNh6bZuzm8s1ceuBUnMUAeoAHHw,8,3,1,0,1,1,5,1,12,1.7142857142857142,1,0.0,0,1,0,1,3,1,0,5,1,2,10,1
8133,182994,64m0Q8jwm0bupg7LuUgGhNi3maBhbH3Y,SpATywNh6bZuzm8s1ceuBUnMUAeoAHHw,5,1,1,0,1,0,2,0,5,0.7142857142857143,1,0.0,0,1,0,1,1,0,0,2,0,2,3,1
8134,182998,aliLWjsmDZq4LP4uTi2kUntAc8WQqjiN,SpATywNh6bZuzm8s1ceuBUnMUAeoAHHw,6,3,2,0,2,0,1,0,8,1.1428571428571428,1,0.0,0,2,0,2,3,0,0,1,0,4,4,1
8135,183000,mjiGg0j06CInyeszEq1InPQHaMEdBBQC,SpATywNh6bZuzm8s1ceuBUnMUAeoAHHw,1,0,0,0,0,0,1,0,1,0.14285714285714285,1,0.0,0,0,0,0,0,0,0,1,0,0,1,1
8136,183015,Klt9qoufCaIWdba44x7MkMWwmjaj9rrO,RXDvfPUBYFlVdlueBFbLW0mhhAyGEqpt,5,2,1,0,1,0,2,0,6,0.8571428571428571,1,0.0,0,1,0,1,2,0,0,2,0,2,4,1
8137,183020,ktn21iQNCuR3oHHXVI0NrarzymknVPKy,bWdj2GDclj5ofokWjzoa5jAwMkxCykd6,14,17,6,60,3,0,4,0,90,12.857142857142858,1,0.0,4,6,59,3,13,0,1,4,0,72,18,1
8138,183023,iVDV62MoJzFeSGfSaOdA9lfvHL2Xprv8,bWdj2GDclj5ofokWjzoa5jAwMkxCykd6,1,0,0,0,0,0,1,0,1,0.14285714285714285,1,0.0,0,0,0,0,0,0,0,1,0,0,1,1
8139,183035,A23dnlnLlkfS4Hk14geJvIKVXuW282iT,SpATywNh6bZuzm8s1ceuBUnMUAeoAHHw,7,2,1,0,1,0,4,0,8,1.1428571428571428,1,0.0,0,1,0,1,2,0,0,4,0,2,6,1
8140,183046,wgSBRoX5zgs9VU58GuULiQecnpPq9Lqh,RXDvfPUBYFlVdlueBFbLW0mhhAyGEqpt,6,3,2,0,2,0,1,0,8,1.1428571428571428,1,0.0,0,2,0,2,3,0,0,1,0,4,4,1
8141,183051,rlQIqtgsDfEVihltHvVH3EnaOkFIJWY2,bWdj2GDclj5ofokWjzoa5jAwMkxCykd6,2,0,0,0,0,0,2,0,2,0.2857142857142857,1,0.0,0,0,0,0,0,0,0,2,0,0,2,1
8142,183053,lmeMhWa8hXVoeC6vmJbPTxkNCUltvvzl,bWdj2GDclj5ofokWjzoa5jAwMkxCykd6,1,0,0,0,0,0,1,0,1,0.14285714285714285,1,0.0,0,0,0,0,0,0,0,1,0,0,1,0
8143,183074,hDvxnDgro87cypkqHin6LwVYFrNPTTLE,RXDvfPUBYFlVdlueBFbLW0mhhAyGEqpt,11,5,3,0,2,0,8,1,19,2.7142857142857144,1,0.0,0,3,0,2,5,0,0,8,1,5,14,0
8144,183099,VerLbwiPxmF2ThOpDXTyChlnDHBPqkR9,SpATywNh6bZuzm8s1ceuBUnMUAeoAHHw,1,0,0,0,0,0,1,0,1,0.14285714285714285,1,0.0,0,0,0,0,0,0,0,1,0,0,1,1
8145,183102,Kl5tK7ooc00n8wf3ct9g9Ke76aOxJvfm,RXDvfPUBYFlVdlueBFbLW0mhhAyGEqpt,2,0,0,0,0,0,3,0,3,0.42857142857142855,1,0.0,0,0,0,0,0,0,0,3,0,0,3,1
8146,183108,jVeR6Ygg8woHLAlxijrDAiyFqfotJXuz,SpATywNh6bZuzm8s1ceuBUnMUAeoAHHw,1,0,0,0,0,0,1,0,1,0.14285714285714285,1,0.0,0,0,0,0,0,0,0,1,0,0,1,1
8147,183109,AildxiB1DfzGkzpFkUFcF6xLBoz939kN,SpATywNh6bZuzm8s1ceuBUnMUAeoAHHw,4,2,1,0,1,0,1,0,5,0.7142857142857143,1,0.0,0,1,0,1,2,0,0,1,0,2,3,1
8148,183115,lKZ6PIEzVkW9yjCyAe8hsmBYDIXs5abt,RXDvfPUBYFlVdlueBFbLW0mhhAyGEqpt,4,3,0,0,0,0,4,0,7,1.0,1,0.0,0,0,0,0,3,0,0,4,0,0,7,1
8149,183119,BoPqpHAIR2FQ1yjN5I6jPiYn67RLyUD3,bWdj2GDclj5ofokWjzoa5jAwMkxCykd6,1,0,0,0,0,0,2,0,2,0.2857142857142857,1,0.0,0,0,0,0,0,0,0,2,0,0,2,1
8150,183123,CkLUnVGhbMVv40VnwKxHWwmtgjnmo4A6,G8EPVSXsOYB5YQWZGiz1aVq5Pgr2GrQu,77,101,41,204,25,34,16,5,426,60.857142857142854,2,0.0,55,41,158,25,46,34,46,16,5,279,147,0
8151,183129,eOxm8XEI11Xs6eiBi1Nu5QzIagZXwEm9,RXDvfPUBYFlVdlueBFbLW0mhhAyGEqpt,12,13,8,0,1,8,2,0,32,4.571428571428571,1,0.0,4,8,0,1,9,8,0,2,0,13,19,0
8152,183130,w2Erm8d51TR8x1zaznDbwXn8kjSZE4Bu,G8EPVSXsOYB5YQWZGiz1aVq5Pgr2GrQu,8,8,5,0,3,0,8,0,24,3.4285714285714284,1,0.0,0,5,0,3,8,0,0,8,0,8,16,1
8153,183131,xWIW5AMIa14HXXQklcDbkiec2fixez0X,SpATywNh6bZuzm8s1ceuBUnMUAeoAHHw,2,0,0,0,0,0,2,0,2,0.2857142857142857,1,0.0,0,0,0,0,0,0,0,2,0,0,2,1
8154,183144,NFQYK3FjmQHQ82RJihsHHyxDsiLlEhiy,G8EPVSXsOYB5YQWZGiz1aVq5Pgr2GrQu,6,3,2,0,2,0,1,0,8,1.1428571428571428,1,0.0,0,2,0,2,3,0,0,1,0,4,4,1
8155,183150,RDDLwVBt5GubTYBjjqKExEAvJzlxgV07,G8EPVSXsOYB5YQWZGiz1aVq5Pgr2GrQu,4,2,1,0,1,0,1,0,5,0.7142857142857143,1,0.0,0,1,0,1,2,0,0,1,0,2,3,1
8156,183151,mXfwwTIVjHMqoVKAh2iEQbinKUCJHwTp,RXDvfPUBYFlVdlueBFbLW0mhhAyGEqpt,1,0,0,0,0,0,1,0,1,0.14285714285714285,1,0.0,0,0,0,0,0,0,0,1,0,0,1,1
8157,183153,meaga1KCWxPmzsqVBplIkGxQedzxaUD2,bWdj2GDclj5ofokWjzoa5jAwMkxCykd6,7,3,2,0,2,0,2,0,9,1.2857142857142858,1,0.0,0,2,0,2,3,0,0,2,0,4,5,1
8158,183156,BWYYcHsqCzhUpDFvLBDv5oyoAjPbY2ao,G8EPVSXsOYB5YQWZGiz1aVq5Pgr2GrQu,6,1,1,0,1,0,3,0,6,0.8571428571428571,1,0.0,0,1,0,1,1,0,0,3,0,2,4,1
8159,183166,1vUHALYrvSKjWqmr07cdKDwJ3ETsWONf,G8EPVSXsOYB5YQWZGiz1aVq5Pgr2GrQu,8,12,6,0,0,0,4,0,22,3.142857142857143,1,0.0,0,6,0,0,12,0,0,4,0,6,16,1
8160,183167,98I0uRRrxrvjOLcZ6vxnPf4VwE1fUSbw,SpATywNh6bZuzm8s1ceuBUnMUAeoAHHw,10,7,5,0,3,1,4,0,20,2.857142857142857,1,0.0,0,5,0,3,7,1,0,4,0,8,12,1
8161,183169,Ha83qom95SRdPZQ3GDUlHj6Txt7HaICx,RXDvfPUBYFlVdlueBFbLW0mhhAyGEqpt,5,1,0,0,0,0,3,1,5,0.7142857142857143,1,0.0,0,0,0,0,1,0,0,3,1,0,5,1
8162,183171,uWoWmi6BUckUwLrnQ5aAr8mNZ3FhCJCq,bWdj2GDclj5ofokWjzoa5jAwMkxCykd6,6,6,1,6,2,0,3,0,18,2.5714285714285716,1,0.0,4,1,6,2,2,0,0,3,0,13,5,1
8163,183175,uWoWmi6BUckUwLrnQ5aAr8mNZ3FhCJCq,SpATywNh6bZuzm8s1ceuBUnMUAeoAHHw,13,19,6,17,3,0,1,0,46,6.571428571428571,1,0.0,11,6,15,3,8,0,2,1,0,35,11,1
8164,183176,vmxFgUyErGGqygNyLIYogRrMCWwWAOsK,SpATywNh6bZuzm8s1ceuBUnMUAeoAHHw,3,0,0,0,0,0,2,1,3,0.42857142857142855,1,0.0,0,0,0,0,0,0,0,2,1,0,3,1
8165,183179,cBEtpnUSjx0dg8glJzii42d18FEs4ecN,bWdj2GDclj5ofokWjzoa5jAwMkxCykd6,4,2,1,0,1,0,1,0,5,0.7142857142857143,1,0.0,0,1,0,1,2,0,0,1,0,2,3,1
8166,183185,6UfIu5SKHPYfwZxBxJpGSqhLHKhbdsl0,RXDvfPUBYFlVdlueBFbLW0mhhAyGEqpt,6,4,3,0,0,0,3,0,10,1.4285714285714286,1,0.0,0,3,0,0,4,0,0,3,0,3,7,1
8167,183195,ZUG5m2QmH8RqkCO5a89mIgt4zubZUyS0,SpATywNh6bZuzm8s1ceuBUnMUAeoAHHw,6,0,0,0,0,6,6,1,13,1.8571428571428572,1,0.0,0,0,0,0,0,6,0,6,1,0,13,1
8168,183205,rtxwCWIEQDwTZ37mLeJaxSUkUCTNLEOP,SpATywNh6bZuzm8s1ceuBUnMUAeoAHHw,9,6,3,0,1,0,5,2,17,2.4285714285714284,1,0.0,0,3,0,1,6,0,0,5,2,4,13,1
8169,183228,EnOE2zcU3adIQka8zXE5uaDcwrIceQaF,SpATywNh6bZuzm8s1ceuBUnMUAeoAHHw,15,8,5,16,4,11,5,1,50,7.142857142857143,1,0.0,2,5,14,4,6,11,2,5,1,25,25,1
8170,183230,RYd1k9DojojPZwrkV3NjsTI5OdZnPV9W,bWdj2GDclj5ofokWjzoa5jAwMkxCykd6,6,12,0,0,1,0,4,0,17,2.4285714285714284,1,0.0,0,0,0,1,12,0,0,4,0,1,16,1
8171,183232,7RSTSE7CX0EZRW2RDRnKS7CJkHtK7gJx,SpATywNh6bZuzm8s1ceuBUnMUAeoAHHw,5,3,2,0,1,0,2,0,8,1.1428571428571428,1,0.0,0,2,0,1,3,0,0,2,0,3,5,1
8172,183236,DIfj5Ba2axfDE4LFDWqKjVBCgesW8XXW,bWdj2GDclj5ofokWjzoa5jAwMkxCykd6,1,0,0,0,0,0,2,0,2,0.2857142857142857,1,0.0,0,0,0,0,0,0,0,2,0,0,2,1
8173,183238,L44FpqBwTo2JSXh1jKpzwO4TUp5s63E0,SpATywNh6bZuzm8s1ceuBUnMUAeoAHHw,5,2,1,0,1,0,2,0,6,0.8571428571428571,1,0.0,0,1,0,1,2,0,0,2,0,2,4,1
8174,183250,zvOHbaUWjxRZ9zCYxYPMcUH4Ef5dE8Ae,SpATywNh6bZuzm8s1ceuBUnMUAeoAHHw,6,3,1,0,1,0,2,0,7,1.0,1,0.0,0,1,0,1,3,0,0,2,0,2,5,1
8175,183254,1EtDFoshTxvFPxLRYfA4KzHCN6a1sUab,RXDvfPUBYFlVdlueBFbLW0mhhAyGEqpt,8,8,5,0,2,2,2,0,19,2.7142857142857144,1,0.0,0,5,0,2,8,2,0,2,0,7,12,1
8176,183258,cwjdhzGq04zCTXyAv16dQv37UeRHYh5B,G8EPVSXsOYB5YQWZGiz1aVq5Pgr2GrQu,6,3,2,0,2,0,1,0,8,1.1428571428571428,1,0.0,0,2,0,2,3,0,0,1,0,4,4,1
8177,183260,5nq8zs9A2tdQgPir7vYvctaqXkR3aFiH,SpATywNh6bZuzm8s1ceuBUnMUAeoAHHw,12,17,2,15,1,0,5,0,40,5.714285714285714,1,0.0,6,2,13,1,11,0,2,5,0,22,18,1
8178,183265,QT9CjDkbeQDwB2YMvS9MmI6T8kS9zKHi,RXDvfPUBYFlVdlueBFbLW0mhhAyGEqpt,5,1,1,0,1,0,2,0,5,0.7142857142857143,1,0.0,0,1,0,1,1,0,0,2,0,2,3,1
8179,183267,9nmSiMdYrhU2xelQs2wN4VWDOzZHLs5V,G8EPVSXsOYB5YQWZGiz1aVq5Pgr2GrQu,1,0,0,0,0,0,1,0,1,0.14285714285714285,1,0.0,0,0,0,0,0,0,0,1,0,0,1,1
8180,183291,KA8RyaMJzO49U5Bg2GbjpW1mpD8UFvq1,bWdj2GDclj5ofokWjzoa5jAwMkxCykd6,1,0,0,0,0,0,1,0,1,0.14285714285714285,1,0.0,0,0,0,0,0,0,0,1,0,0,1,1
8181,183294,x0GEvwkvyx0g8nTyKguqj2gMY7vcYmyU,SpATywNh6bZuzm8s1ceuBUnMUAeoAHHw,6,3,1,0,1,0,2,0,7,1.0,1,0.0,0,1,0,1,3,0,0,2,0,2,5,1
8182,183297,11kDA8TSGRrd2fZeDsp1CDJVYBIctE55,RXDvfPUBYFlVdlueBFbLW0mhhAyGEqpt,6,6,4,0,1,0,1,0,12,1.7142857142857142,1,0.0,0,4,0,1,6,0,0,1,0,5,7,1
8183,183300,K6sgJjXLg94pFHcJsnQvREqPhcrsQGLq,SpATywNh6bZuzm8s1ceuBUnMUAeoAHHw,2,0,0,0,0,0,3,0,3,0.42857142857142855,1,0.0,0,0,0,0,0,0,0,3,0,0,3,1
8184,183306,uufXnXOfmStAymRAiMYAROVtj5hPlDvd,bWdj2GDclj5ofokWjzoa5jAwMkxCykd6,5,2,1,0,1,0,3,0,7,1.0,1,0.0,0,1,0,1,2,0,0,3,0,2,5,1
8185,183315,G77tKik9NyptRJFC9Rot5qsRZiF0D6mk,SpATywNh6bZuzm8s1ceuBUnMUAeoAHHw,6,6,3,0,2,0,2,0,13,1.8571428571428572,1,0.0,2,3,0,2,4,0,0,2,0,7,6,1
8186,183316,Dm8rUUBDQqhrTm6PWZMMnJPt5PSDMko0,G8EPVSXsOYB5YQWZGiz1aVq5Pgr2GrQu,3,2,0,0,0,1,2,0,5,0.7142857142857143,1,0.0,0,0,0,0,2,1,0,2,0,0,5,1
8187,183317,jTtPdqNIV0C6SwNZGMhf4DTx667U70VG,SpATywNh6bZuzm8s1ceuBUnMUAeoAHHw,12,21,0,18,0,13,5,2,59,8.428571428571429,1,0.0,4,0,15,0,17,13,3,5,2,19,40,1
8188,183319,olHirIGJLYzj8TwhRxe1Dm9DLgoQbNvO,SpATywNh6bZuzm8s1ceuBUnMUAeoAHHw,9,7,6,0,5,0,5,0,23,3.2857142857142856,1,0.0,0,6,0,5,7,0,0,5,0,11,12,1
8189,183340,0Vj24SN7QK68fxZGEj9b6pGHh8nTXfGG,bWdj2GDclj5ofokWjzoa5jAwMkxCykd6,1,0,0,0,0,0,1,0,1,0.14285714285714285,1,0.0,0,0,0,0,0,0,0,1,0,0,1,1
8190,183345,7QIKpGgitmD7tk807kQNY8RClDv3488Y,SpATywNh6bZuzm8s1ceuBUnMUAeoAHHw,5,2,1,0,1,1,2,1,8,1.1428571428571428,1,0.0,0,1,0,1,2,1,0,2,1,2,6,1
8191,183350,89IraAtUfhoGAQgzdMP1844g2s2iN4Ox,RXDvfPUBYFlVdlueBFbLW0mhhAyGEqpt,16,18,6,15,6,4,6,10,65,9.285714285714286,1,0.0,5,6,15,6,13,4,0,6,10,32,33,1
8192,183353,geebTbOsD2liuGCoIF7cu53Xft014LYQ,bWdj2GDclj5ofokWjzoa5jAwMkxCykd6,5,2,1,0,1,0,2,1,7,1.0,1,0.0,0,1,0,1,2,0,0,2,1,2,5,1
8193,183399,5e8eBFhY8m9197wxmtpeMKTT5Js0t5oX,SpATywNh6bZuzm8s1ceuBUnMUAeoAHHw,1,0,0,0,0,0,1,0,1,0.14285714285714285,1,0.0,0,0,0,0,0,0,0,1,0,0,1,1
8194,183400,dWLPd7W4XxJuKssPJAJlISLlvxj9YqGO,G8EPVSXsOYB5YQWZGiz1aVq5Pgr2GrQu,14,14,6,10,3,0,6,1,40,5.714285714285714,1,0.0,3,6,7,3,11,0,3,6,1,19,21,1
8195,183411,GO3MGrx4XteeFiOXpQf53F1doJGXYUJh,G8EPVSXsOYB5YQWZGiz1aVq5Pgr2GrQu,11,14,10,0,5,1,9,3,42,6.0,2,0.0,0,10,0,5,14,1,0,9,3,15,27,1
8196,183413,qvBe3rKX4kTO2XRpAwHefqsXVjGwcgVZ,SpATywNh6bZuzm8s1ceuBUnMUAeoAHHw,6,7,0,0,0,2,2,0,11,1.5714285714285714,1,0.0,3,0,0,0,4,2,0,2,0,3,8,1
8197,183416,orkcYdEVQqlH9SJjCRUiZ5P3bFy172XW,bWdj2GDclj5ofokWjzoa5jAwMkxCykd6,2,0,0,0,0,0,5,0,5,0.7142857142857143,2,0.0,0,0,0,0,0,0,0,5,0,0,5,1
8198,183434,OocLfrCOBb0PIIRDKMfTM554g3aeKj99,bWdj2GDclj5ofokWjzoa5jAwMkxCykd6,5,2,1,0,1,0,2,0,6,0.8571428571428571,1,0.0,0,1,0,1,2,0,0,2,0,2,4,1
8199,183441,AGnMVhenXKmXw34icDYbSubheSiHLlFC,bWdj2GDclj5ofokWjzoa5jAwMkxCykd6,1,0,0,0,0,0,1,0,1,0.14285714285714285,1,0.0,0,0,0,0,0,0,0,1,0,0,1,1
8200,183444,7OyOaefKbOX5xGdSnzdHd0CL6VXfEf8T,G8EPVSXsOYB5YQWZGiz1aVq5Pgr2GrQu,2,0,0,0,0,0,2,0,2,0.2857142857142857,1,0.0,0,0,0,0,0,0,0,2,0,0,2,1
8201,183447,IGdK3d2q4pwzeowbu1fnlncF2G0mIESt,SpATywNh6bZuzm8s1ceuBUnMUAeoAHHw,6,12,0,0,0,0,2,0,14,2.0,1,0.0,1,0,0,0,11,0,0,2,0,1,13,1
8202,183449,NhOj8NHtxbWRVl1n7CiUbpZQHLOfubek,RXDvfPUBYFlVdlueBFbLW0mhhAyGEqpt,13,16,2,0,1,21,12,1,53,7.571428571428571,1,0.0,0,2,0,1,16,21,0,12,1,3,50,1
8203,183460,zsosD9YlCDywhEUV3Vphbp3IXW8MeBYM,bWdj2GDclj5ofokWjzoa5jAwMkxCykd6,1,0,0,0,0,0,1,0,1,0.14285714285714285,1,0.0,0,0,0,0,0,0,0,1,0,0,1,1
8204,183476,069ftOw6ldZ1V3ipXwZemwIwoCreCmPS,G8EPVSXsOYB5YQWZGiz1aVq5Pgr2GrQu,16,15,5,36,3,0,1,0,60,8.571428571428571,1,0.0,9,5,27,3,6,0,9,1,0,44,16,1
8205,183481,zpoCbNcTK6iqE6Hm4JrK6lHIZV2VXvYX,SpATywNh6bZuzm8s1ceuBUnMUAeoAHHw,1,0,0,0,0,0,3,0,3,0.42857142857142855,1,0.0,0,0,0,0,0,0,0,3,0,0,3,1
8206,183488,kUJcgErkiF8AsEDKHMMLmp1H5MenUsXw,G8EPVSXsOYB5YQWZGiz1aVq5Pgr2GrQu,2,0,0,0,0,0,3,0,3,0.42857142857142855,1,0.0,0,0,0,0,0,0,0,3,0,0,3,1
8207,183500,fsFbJ8UrfADOZi56VOg1TSjQKQnG4WLk,RXDvfPUBYFlVdlueBFbLW0mhhAyGEqpt,8,5,0,0,0,0,3,0,8,1.1428571428571428,1,0.0,0,0,0,0,5,0,0,3,0,0,8,1
8208,183502,VtCUQBk0TlN0AJOAq0bEC4tTAH6HVrBA,SpATywNh6bZuzm8s1ceuBUnMUAeoAHHw,3,2,0,0,0,0,1,0,3,0.42857142857142855,1,0.0,0,0,0,0,2,0,0,1,0,0,3,1
8209,183514,f2GMLkjrqGdN19ysxF64zEiQj9fxR4cG,G8EPVSXsOYB5YQWZGiz1aVq5Pgr2GrQu,5,2,1,0,1,0,2,0,6,0.8571428571428571,1,0.0,0,1,0,1,2,0,0,2,0,2,4,1
8210,183527,66KnlNHw8D8zXFB0ktOwarKa6xDfCRsA,SpATywNh6bZuzm8s1ceuBUnMUAeoAHHw,2,0,0,0,0,0,2,0,2,0.2857142857142857,1,0.0,0,0,0,0,0,0,0,2,0,0,2,1
8211,183534,joi2hmNEoOCl0stUXbrsaehVDAdpUejn,SpATywNh6bZuzm8s1ceuBUnMUAeoAHHw,1,0,0,0,0,0,1,0,1,0.14285714285714285,1,0.0,0,0,0,0,0,0,0,1,0,0,1,1
8212,183537,GNsGzjFSidI9fBCvT9fI5F8kfuYTc1I2,RXDvfPUBYFlVdlueBFbLW0mhhAyGEqpt,13,16,9,0,3,0,7,1,36,5.142857142857143,2,0.0,2,9,0,3,14,0,0,7,1,14,22,0
8213,183541,gqy9Iq3u49oICISghrOoeZuPt4tAVyjr,SpATywNh6bZuzm8s1ceuBUnMUAeoAHHw,5,2,1,0,1,0,2,0,6,0.8571428571428571,1,0.0,0,1,0,1,2,0,0,2,0,2,4,1
8214,183543,RrZIh1Er4YeabEoYA6SJyDj40LWgHTn5,SpATywNh6bZuzm8s1ceuBUnMUAeoAHHw,6,2,0,0,0,0,5,0,7,1.0,1,0.0,0,0,0,0,2,0,0,5,0,0,7,1
8215,183549,oAjXymbDbd4Rt4XO0pdep7ez7kmoJtvA,bWdj2GDclj5ofokWjzoa5jAwMkxCykd6,2,0,0,0,0,0,2,0,2,0.2857142857142857,1,0.0,0,0,0,0,0,0,0,2,0,0,2,1
8216,183550,JaYbgvhgx43SysY9J8DaCR3IcdUzCcUf,bWdj2GDclj5ofokWjzoa5jAwMkxCykd6,4,4,1,0,0,0,2,0,7,1.0,2,0.0,0,1,0,0,4,0,0,2,0,1,6,1
8217,183552,tCPCenWlAqHKYLuxwQ692ECgp8ponIEe,SpATywNh6bZuzm8s1ceuBUnMUAeoAHHw,2,0,0,0,0,0,2,0,2,0.2857142857142857,1,0.0,0,0,0,0,0,0,0,2,0,0,2,1
8218,183560,539icBw2nmvBmBkzeMPm9mMNpWONyi1a,bWdj2GDclj5ofokWjzoa5jAwMkxCykd6,2,0,0,0,0,0,2,0,2,0.2857142857142857,1,0.0,0,0,0,0,0,0,0,2,0,0,2,1
8219,183569,iJJNhRwyvCNK6HRXY0B7B0PcxR090Rv4,SpATywNh6bZuzm8s1ceuBUnMUAeoAHHw,1,0,0,0,0,0,1,0,1,0.14285714285714285,1,0.0,0,0,0,0,0,0,0,1,0,0,1,1
8220,183570,mORy2uEWeq5FPaYREt08zxVhXzxOvG5x,SpATywNh6bZuzm8s1ceuBUnMUAeoAHHw,4,2,1,0,1,18,1,0,23,3.2857142857142856,1,0.0,0,1,0,1,2,18,0,1,0,2,21,1
8221,183579,hKd0tEZKHss60gUM0z43MBrDD3KnSpLX,SpATywNh6bZuzm8s1ceuBUnMUAeoAHHw,6,3,1,0,1,0,3,0,8,1.1428571428571428,1,0.0,0,1,0,1,3,0,0,3,0,2,6,1
8222,183585,bGVVh5mMYkn1gHW6CnpRuYzXwIcX6sC6,SpATywNh6bZuzm8s1ceuBUnMUAeoAHHw,6,1,1,0,1,1,3,1,8,1.1428571428571428,1,0.0,0,1,0,1,1,1,0,3,1,2,6,1
8223,183590,iwLRjFCEFjJtmNgQnRk4kXqxuLSCzbLr,SpATywNh6bZuzm8s1ceuBUnMUAeoAHHw,7,4,2,0,2,0,4,1,13,1.8571428571428572,1,0.0,1,2,0,2,3,0,0,4,1,5,8,1
8224,183603,yMScB1KMRz60XZtblJXZ7cOwpx8nYT9h,G8EPVSXsOYB5YQWZGiz1aVq5Pgr2GrQu,9,9,1,18,2,0,2,0,32,4.571428571428571,1,0.0,7,1,12,2,2,0,6,2,0,22,10,1
8225,183613,7jDyNmBRkEY6fNon9RWGerv8blE7YVJd,bWdj2GDclj5ofokWjzoa5jAwMkxCykd6,4,2,0,0,0,0,2,0,4,0.5714285714285714,1,0.0,0,0,0,0,2,0,0,2,0,0,4,1
8226,183614,x967IREOKVWVVneKjnOdD8ZruuMl1VE7,SpATywNh6bZuzm8s1ceuBUnMUAeoAHHw,9,21,9,0,7,0,3,0,40,5.714285714285714,1,0.0,1,9,0,7,20,0,0,3,0,17,23,1
8227,183624,Tfb5kzD9uzk4IFFKiGmgMSkZRj1tZ0K9,bWdj2GDclj5ofokWjzoa5jAwMkxCykd6,8,22,5,26,8,0,4,0,65,9.285714285714286,2,0.0,16,5,26,8,6,0,0,4,0,55,10,0
8228,183631,FbdmHwhDtQoDvNNbH5NO4UO0Yhp01nUq,SpATywNh6bZuzm8s1ceuBUnMUAeoAHHw,5,2,1,0,1,0,2,0,6,0.8571428571428571,1,0.0,0,1,0,1,2,0,0,2,0,2,4,1
8229,183634,R4jzs50fuf1JavV9xGEb7vRBguxW8cYa,SpATywNh6bZuzm8s1ceuBUnMUAeoAHHw,8,13,6,0,2,1,4,0,26,3.7142857142857144,1,0.0,0,6,0,2,13,1,0,4,0,8,18,1
8230,183641,CAXYMnI26CJKVZLm27KWhrQ5wZxlWBLx,SpATywNh6bZuzm8s1ceuBUnMUAeoAHHw,5,6,1,0,1,0,1,0,9,1.2857142857142858,1,0.0,0,1,0,1,6,0,0,1,0,2,7,1
8231,183645,rzux1UjWNNs1GqyksFiTFp3NDiKcqZIA,SpATywNh6bZuzm8s1ceuBUnMUAeoAHHw,5,2,1,0,1,0,2,0,6,0.8571428571428571,1,0.0,0,1,0,1,2,0,0,2,0,2,4,1
8232,183649,tHouYbJheFPQJDK2n6XJK9jRREGEheXi,G8EPVSXsOYB5YQWZGiz1aVq5Pgr2GrQu,36,43,12,44,10,2,6,1,118,16.857142857142858,1,0.0,25,12,29,10,18,2,15,6,1,76,42,1
8233,183651,QP3bOKPbx70fYEywL9MXgcXTnFgBdqPj,SpATywNh6bZuzm8s1ceuBUnMUAeoAHHw,6,3,1,0,1,0,3,0,8,1.1428571428571428,1,0.0,0,1,0,1,3,0,0,3,0,2,6,1
8234,183655,Mbj5txvZRTAvPuGny65LvJcTeJZzO2Xr,SpATywNh6bZuzm8s1ceuBUnMUAeoAHHw,5,4,3,0,1,0,1,0,9,1.2857142857142858,1,0.0,0,3,0,1,4,0,0,1,0,4,5,1
8235,183664,o19vb57bgfx9sNjmUMNmIakP5nctIJ3O,bWdj2GDclj5ofokWjzoa5jAwMkxCykd6,5,4,0,0,0,0,2,0,6,0.8571428571428571,1,0.0,0,0,0,0,4,0,0,2,0,0,6,1
8236,183675,cpH6ushFbRO23LBN96kMSHMHQ5CDuqWx,SpATywNh6bZuzm8s1ceuBUnMUAeoAHHw,10,8,4,0,3,0,2,0,17,2.4285714285714284,1,0.0,3,4,0,3,5,0,0,2,0,10,7,1
8237,183689,tVDSRebDM9kj4eZBXWEp0omzaKHFumrl,SpATywNh6bZuzm8s1ceuBUnMUAeoAHHw,4,2,1,0,1,0,1,0,5,0.7142857142857143,1,0.0,0,1,0,1,2,0,0,1,0,2,3,1
8238,183698,o19vb57bgfx9sNjmUMNmIakP5nctIJ3O,G8EPVSXsOYB5YQWZGiz1aVq5Pgr2GrQu,1,0,0,0,0,0,1,0,1,0.14285714285714285,1,0.0,0,0,0,0,0,0,0,1,0,0,1,1
8239,183699,qjQ6GiU7sehnY7qaKKajZBfA0GV2t1bA,SpATywNh6bZuzm8s1ceuBUnMUAeoAHHw,5,2,0,0,1,0,2,0,5,0.7142857142857143,1,0.0,0,0,0,1,2,0,0,2,0,1,4,1
8240,183716,2hMeaUc14fgUG8b3kgXxN1xDYogexPXy,bWdj2GDclj5ofokWjzoa5jAwMkxCykd6,5,9,0,0,1,0,1,0,11,1.5714285714285714,1,0.0,3,0,0,1,6,0,0,1,0,4,7,1
8241,183718,Lf0mThPYOrtlCzgRGBCVTPy1hiGUII8h,bWdj2GDclj5ofokWjzoa5jAwMkxCykd6,7,2,1,0,1,0,4,0,8,1.1428571428571428,1,0.0,0,1,0,1,2,0,0,4,0,2,6,1
8242,183726,hB6lALXH4sMaj6Hr4qOJgZbelF7wY5ML,SpATywNh6bZuzm8s1ceuBUnMUAeoAHHw,5,2,1,0,1,0,2,0,6,0.8571428571428571,1,0.0,0,1,0,1,2,0,0,2,0,2,4,1
8243,183734,bUWUvqWKJBmYgRNIoWQO6VIVyvpJs3GG,bWdj2GDclj5ofokWjzoa5jAwMkxCykd6,14,16,6,16,2,0,3,0,43,6.142857142857143,1,0.0,3,6,14,2,13,0,2,3,0,25,18,1
8244,183736,CJjWj5QSoyqJ23EMwHZtEX525JWA2E7K,SpATywNh6bZuzm8s1ceuBUnMUAeoAHHw,5,2,1,0,1,0,2,0,6,0.8571428571428571,1,0.0,0,1,0,1,2,0,0,2,0,2,4,1
8245,183737,EEKM5fD1OwESnar1FjU8hxj0L9tVWx44,RXDvfPUBYFlVdlueBFbLW0mhhAyGEqpt,10,9,1,0,1,5,2,0,18,2.5714285714285716,1,0.0,0,1,0,1,9,5,0,2,0,2,16,1
8246,183740,e1dzN81UKTvb4PNCErZLbC2uYa0wPNos,SpATywNh6bZuzm8s1ceuBUnMUAeoAHHw,6,5,2,0,2,0,1,0,10,1.4285714285714286,1,0.0,0,2,0,2,5,0,0,1,0,4,6,1
8247,183743,Tkxf1Z89UY3ofefoIUKYhYMqhRZ3ElpY,SpATywNh6bZuzm8s1ceuBUnMUAeoAHHw,1,0,0,0,0,0,1,0,1,0.14285714285714285,1,0.0,0,0,0,0,0,0,0,1,0,0,1,1
8248,183755,5UWxjYJaVNtau37O89p9sB7M5HwhMo3z,bWdj2GDclj5ofokWjzoa5jAwMkxCykd6,1,0,0,0,0,0,1,0,1,0.14285714285714285,1,0.0,0,0,0,0,0,0,0,1,0,0,1,1
8249,183759,NplT7OhnAZOp9hCAdGLFNwSMTc3LAhF2,G8EPVSXsOYB5YQWZGiz1aVq5Pgr2GrQu,23,32,6,38,4,0,2,0,82,11.714285714285714,1,0.0,23,6,23,4,9,0,15,2,0,56,26,1
8250,183766,bY2gh2mIojoS37RuKr0mq0gh4QBiW0z8,G8EPVSXsOYB5YQWZGiz1aVq5Pgr2GrQu,11,18,5,16,2,3,2,0,46,6.571428571428571,1,0.0,10,5,14,2,8,3,2,2,0,31,15,1
8251,183781,HL5HEUPq5k60nwiHmjiz48idVIW7iDWP,SpATywNh6bZuzm8s1ceuBUnMUAeoAHHw,5,2,1,0,1,0,2,0,6,0.8571428571428571,1,0.0,0,1,0,1,2,0,0,2,0,2,4,1
8252,183784,QzFNcWcdt9jKMCztuclgA8fbidhRkaqv,SpATywNh6bZuzm8s1ceuBUnMUAeoAHHw,7,6,0,0,0,0,13,1,20,2.857142857142857,1,0.0,0,0,0,0,6,0,0,13,1,0,20,1
8253,183796,MhvviuZNTmfoceElB9BVHo0GzJkIAz9b,G8EPVSXsOYB5YQWZGiz1aVq5Pgr2GrQu,7,6,2,0,2,0,1,0,11,1.5714285714285714,1,0.0,0,2,0,2,6,0,0,1,0,4,7,1
8254,183800,4T6e9tf501hupPEmmZRZG7Lv5vYmRX6i,SpATywNh6bZuzm8s1ceuBUnMUAeoAHHw,6,4,3,0,3,0,1,0,11,1.5714285714285714,1,0.0,0,3,0,3,4,0,0,1,0,6,5,1
8255,183802,4Y8z1fVuk8HPWGVOteuQwAFNrdo0CBpu,SpATywNh6bZuzm8s1ceuBUnMUAeoAHHw,1,0,0,0,0,0,2,0,2,0.2857142857142857,1,0.0,0,0,0,0,0,0,0,2,0,0,2,1
8256,183805,6Ysh3EXeoiNCd1uXxsjEQronkryNKRU5,RXDvfPUBYFlVdlueBFbLW0mhhAyGEqpt,1,0,0,0,0,0,1,0,1,0.14285714285714285,1,0.0,0,0,0,0,0,0,0,1,0,0,1,1
8257,183808,cLRv4oHsLxWfkE6gs4eN6fO5y0RK8Odw,G8EPVSXsOYB5YQWZGiz1aVq5Pgr2GrQu,6,4,2,0,1,0,4,0,11,1.5714285714285714,1,0.0,0,2,0,1,4,0,0,4,0,3,8,1
8258,183822,OuPUar7X5BJymhikUDnyE5tFiUVuL09j,bWdj2GDclj5ofokWjzoa5jAwMkxCykd6,4,2,1,0,1,0,1,0,5,0.7142857142857143,1,0.0,0,1,0,1,2,0,0,1,0,2,3,1
8259,183839,yzbVurZnZZ3LzSESEDTD8mBP09kqyBBh,G8EPVSXsOYB5YQWZGiz1aVq5Pgr2GrQu,5,2,1,0,0,0,4,0,7,1.0,1,0.0,0,1,0,0,2,0,0,4,0,1,6,1
8260,183842,e3vAZGPddv8GG7o51Df54H5d3GJcihRZ,G8EPVSXsOYB5YQWZGiz1aVq5Pgr2GrQu,5,2,1,0,1,0,2,0,6,0.8571428571428571,1,0.0,0,1,0,1,2,0,0,2,0,2,4,1
8261,183843,KqeR1ihSDa1Ej9nVqHYeUS5y6oETFEfM,bWdj2GDclj5ofokWjzoa5jAwMkxCykd6,4,2,0,0,1,0,1,0,4,0.5714285714285714,1,0.0,0,0,0,1,2,0,0,1,0,1,3,1
8262,183850,N9VYkIRf4aydaM9gnOlftZxNGDW8I3Zp,SpATywNh6bZuzm8s1ceuBUnMUAeoAHHw,5,6,3,0,1,1,3,0,14,2.0,3,0.0,0,3,0,1,6,1,0,3,0,4,10,1
8263,183851,ls613vLH6fBQyqRMeuiCg3ot5Tyb4DDz,RXDvfPUBYFlVdlueBFbLW0mhhAyGEqpt,1,0,0,0,0,0,1,0,1,0.14285714285714285,1,0.0,0,0,0,0,0,0,0,1,0,0,1,1
8264,183852,NyPL3YppErvC9cRYCzI4gxKdO7060UB2,SpATywNh6bZuzm8s1ceuBUnMUAeoAHHw,4,2,1,0,0,0,2,0,5,0.7142857142857143,1,0.0,0,1,0,0,2,0,0,2,0,1,4,1
8265,183854,3aJcxnpBDknIFELx5q7A1ed9nLB6csNj,bWdj2GDclj5ofokWjzoa5jAwMkxCykd6,3,3,0,0,0,0,1,0,4,0.5714285714285714,1,0.0,0,0,0,0,3,0,0,1,0,0,4,1
8266,183856,PN6HDAlC1c0mDwWmACSk2v8uGfyNjwaH,SpATywNh6bZuzm8s1ceuBUnMUAeoAHHw,5,1,1,0,1,0,2,0,5,0.7142857142857143,1,0.0,0,1,0,1,1,0,0,2,0,2,3,1
8267,183857,xaz3R9QEFJxcfadxPNec99QMlGTDEIiY,SpATywNh6bZuzm8s1ceuBUnMUAeoAHHw,16,20,6,24,5,7,5,1,68,9.714285714285714,1,0.0,12,6,21,5,8,7,3,5,1,44,24,1
8268,183870,56VZldyBA7sJdFNsW4uyCbKalKBMfJny,SpATywNh6bZuzm8s1ceuBUnMUAeoAHHw,5,3,0,0,0,0,4,0,7,1.0,1,0.0,0,0,0,0,3,0,0,4,0,0,7,1
8269,183872,KLhUlREKq0O2xglSDOcFfaFp54qACtHM,SpATywNh6bZuzm8s1ceuBUnMUAeoAHHw,1,0,0,0,0,0,1,0,1,0.14285714285714285,1,0.0,0,0,0,0,0,0,0,1,0,0,1,1
8270,183875,fgQYCS5dRFsryAHcjDowcgqd9vNhjm9J,SpATywNh6bZuzm8s1ceuBUnMUAeoAHHw,6,7,0,0,0,0,2,0,9,1.2857142857142858,1,0.0,0,0,0,0,7,0,0,2,0,0,9,1
8271,183886,jhJPaGwU7dqU4ZwAVfiDn0qBdh771kri,G8EPVSXsOYB5YQWZGiz1aVq5Pgr2GrQu,15,66,32,50,17,0,2,0,167,23.857142857142858,1,0.0,0,32,47,17,66,0,3,2,0,96,71,1
8272,183895,HdOvDLzexKNSAsc0DtnaPUszT8VuZf1r,SpATywNh6bZuzm8s1ceuBUnMUAeoAHHw,7,3,2,0,2,0,3,0,10,1.4285714285714286,1,0.0,0,2,0,2,3,0,0,3,0,4,6,1
8273,183899,BDTbCzD1BP0Zvh6WPG7fuO5jLB3vSWaq,SpATywNh6bZuzm8s1ceuBUnMUAeoAHHw,4,2,1,0,1,0,1,0,5,0.7142857142857143,1,0.0,0,1,0,1,2,0,0,1,0,2,3,1
8274,183909,hpKSHIi4bRo1DEIvbfvzcRke2iP1vwgF,RXDvfPUBYFlVdlueBFbLW0mhhAyGEqpt,5,6,4,0,1,0,2,0,13,1.8571428571428572,1,0.0,0,4,0,1,6,0,0,2,0,5,8,1
8275,183910,52QsTv4Uo7nj5fP154PK0QEBA8xMFRXc,G8EPVSXsOYB5YQWZGiz1aVq5Pgr2GrQu,10,15,1,10,1,0,3,0,30,4.285714285714286,2,0.0,9,1,7,1,6,0,3,3,0,18,12,1
8276,183919,5BY2554FQkXzWEII8U25cUr1TyLfBPj6,RXDvfPUBYFlVdlueBFbLW0mhhAyGEqpt,5,2,1,0,0,0,3,0,6,0.8571428571428571,1,0.0,0,1,0,0,2,0,0,3,0,1,5,1
8277,183923,2HllbOBswZcfya5rDzlXYMHVB93oWjxb,bWdj2GDclj5ofokWjzoa5jAwMkxCykd6,1,0,0,0,0,0,1,0,1,0.14285714285714285,1,0.0,0,0,0,0,0,0,0,1,0,0,1,1
8278,183926,DiwcwcqzaE6lFsZWpJEHbAW7aioGreHg,SpATywNh6bZuzm8s1ceuBUnMUAeoAHHw,8,3,2,0,2,0,4,0,11,1.5714285714285714,1,0.0,0,2,0,2,3,0,0,4,0,4,7,1
8279,183935,oFr2hzwQRg7T6VDIxFir4OUQxI2WAOox,SpATywNh6bZuzm8s1ceuBUnMUAeoAHHw,6,5,1,0,0,0,2,0,8,1.1428571428571428,1,0.0,0,1,0,0,5,0,0,2,0,1,7,1
8280,183947,3SCBHiEI4HvwPrOQDNTIAqp1rZOAx5IK,RXDvfPUBYFlVdlueBFbLW0mhhAyGEqpt,4,2,1,0,1,0,1,0,5,0.7142857142857143,1,0.0,0,1,0,1,2,0,0,1,0,2,3,1
8281,183950,9ihleSS6gtfYUO7B3tfCDZConGdOxWz6,SpATywNh6bZuzm8s1ceuBUnMUAeoAHHw,7,3,0,0,0,0,4,0,7,1.0,1,0.0,0,0,0,0,3,0,0,4,0,0,7,1
8282,183952,ojd6JmvYlEsNwy0j8rsyD9P7isML33mP,SpATywNh6bZuzm8s1ceuBUnMUAeoAHHw,7,3,2,0,2,0,3,0,10,1.4285714285714286,1,0.0,0,2,0,2,3,0,0,3,0,4,6,1
8283,183958,5cpP5I4qy02g5JK1VuduuXdg8Frcarq0,SpATywNh6bZuzm8s1ceuBUnMUAeoAHHw,5,2,1,0,1,0,3,0,7,1.0,1,0.0,0,1,0,1,2,0,0,3,0,2,5,1
8284,183969,xZnb7uXmxIWQ7sisovgxwTXG7X7Be4Tl,bWdj2GDclj5ofokWjzoa5jAwMkxCykd6,11,15,7,8,2,10,8,1,51,7.285714285714286,1,0.0,2,7,6,2,13,10,2,8,1,17,34,1
8285,183973,qQ4S9PtUViLcUYCg7MK0igZg7IO7I0HK,SpATywNh6bZuzm8s1ceuBUnMUAeoAHHw,4,3,0,0,0,0,2,0,5,0.7142857142857143,1,0.0,0,0,0,0,3,0,0,2,0,0,5,1
8286,183988,qgG4OU0HRuoi21bBKmy9fO5g8h7KcP6E,RXDvfPUBYFlVdlueBFbLW0mhhAyGEqpt,20,16,7,18,7,0,8,0,56,8.0,1,0.0,8,7,16,7,8,0,2,8,0,38,18,1
8287,183997,FZXhILo2dZIp84xBqa5ZKNF9O2Wx35MO,SpATywNh6bZuzm8s1ceuBUnMUAeoAHHw,2,0,0,0,0,0,2,0,2,0.2857142857142857,1,0.0,0,0,0,0,0,0,0,2,0,0,2,1
8288,184003,ZqhWTPWWREP1gJARqRhQXMYloraIQQwo,SpATywNh6bZuzm8s1ceuBUnMUAeoAHHw,5,5,3,0,0,0,2,0,10,1.4285714285714286,2,0.0,0,3,0,0,5,0,0,2,0,3,7,1
8289,184008,UJHNe0sYjldvLe2oh1mb1WNNcWhYLg5J,SpATywNh6bZuzm8s1ceuBUnMUAeoAHHw,1,0,0,0,0,0,1,0,1,0.14285714285714285,1,0.0,0,0,0,0,0,0,0,1,0,0,1,1
8290,184017,m4zdr76CpU472F6wsJffFbslI27LpI4g,bWdj2GDclj5ofokWjzoa5jAwMkxCykd6,4,2,1,0,1,0,5,0,9,1.2857142857142858,2,0.0,0,1,0,1,2,0,0,5,0,2,7,1
8291,184024,h774wdF6vIIcl50Js74gckwUtlv9SBGH,G8EPVSXsOYB5YQWZGiz1aVq5Pgr2GrQu,8,14,5,0,4,0,3,0,26,3.7142857142857144,1,0.0,6,5,0,4,8,0,0,3,0,15,11,1
8292,184025,rXd7sBSm51uTyzv9MhrGYApbktwAzsFy,SpATywNh6bZuzm8s1ceuBUnMUAeoAHHw,3,3,1,0,0,0,1,0,5,0.7142857142857143,1,0.0,0,1,0,0,3,0,0,1,0,1,4,1
8293,184027,iu7Na8oZcPlYaVeI8FJk9aKFI4xc19c4,G8EPVSXsOYB5YQWZGiz1aVq5Pgr2GrQu,4,0,0,0,0,1,3,0,4,0.5714285714285714,1,0.0,0,0,0,0,0,1,0,3,0,0,4,1
8294,184029,CrwOvQpdA842UJZ7DoCSM957jMvz9EeO,SpATywNh6bZuzm8s1ceuBUnMUAeoAHHw,6,3,2,0,2,0,1,0,8,1.1428571428571428,1,0.0,0,2,0,2,3,0,0,1,0,4,4,1
8295,184046,5kCR1wjWWz9eEHdizA4crFyxKTH4mIdl,SpATywNh6bZuzm8s1ceuBUnMUAeoAHHw,7,7,2,0,1,0,4,0,14,2.0,1,0.0,2,2,0,1,5,0,0,4,0,5,9,1
8296,184054,dcJH2SRBlozVvsUdEPFKC47IdUh8xpq7,SpATywNh6bZuzm8s1ceuBUnMUAeoAHHw,16,20,9,12,5,4,13,1,64,9.142857142857142,1,0.0,8,9,9,5,12,4,3,13,1,31,33,1
8297,184080,Q0ABMzqV4ZKePGWKS9YO1g6VONZhZLgg,RXDvfPUBYFlVdlueBFbLW0mhhAyGEqpt,13,12,6,25,0,0,2,0,45,6.428571428571429,2,0.0,4,6,21,0,8,0,4,2,0,31,14,0
8298,184093,NslicJCNMxB9cZhzoMFtRxmqPnqyw5Ii,RXDvfPUBYFlVdlueBFbLW0mhhAyGEqpt,5,2,1,0,1,0,2,0,6,0.8571428571428571,1,0.0,0,1,0,1,2,0,0,2,0,2,4,1
8299,184099,jb1WJE68F4yEoD652bth3JuHIrLPIvo8,SpATywNh6bZuzm8s1ceuBUnMUAeoAHHw,8,7,2,0,1,0,5,0,15,2.142857142857143,1,0.0,0,2,0,1,7,0,0,5,0,3,12,1
8300,184108,Jr0wwW2Pnso55z8kcFx2vv1KjdLnz1KD,bWdj2GDclj5ofokWjzoa5jAwMkxCykd6,2,0,0,0,0,0,2,0,2,0.2857142857142857,1,0.0,0,0,0,0,0,0,0,2,0,0,2,1
8301,184121,fqQqpuKLzyQIMrl6XKL3tfcygq4Er6K5,bWdj2GDclj5ofokWjzoa5jAwMkxCykd6,1,0,0,0,0,0,1,0,1,0.14285714285714285,1,0.0,0,0,0,0,0,0,0,1,0,0,1,1
8302,184128,vQs4K4jFbbnMTWF8mXp4DI5eKN8aBPM9,SpATywNh6bZuzm8s1ceuBUnMUAeoAHHw,9,6,3,0,2,0,4,1,16,2.2857142857142856,2,0.0,0,3,0,2,6,0,0,4,1,5,11,1
8303,184130,hHVyNQkfLcybgeO1W2xMmju5SBV0vBkh,SpATywNh6bZuzm8s1ceuBUnMUAeoAHHw,7,6,3,0,2,0,3,0,14,2.0,1,0.0,0,3,0,2,6,0,0,3,0,5,9,1
8304,184135,01vp16vMBdfdzNflK84lEgGXfBDKyb7S,bWdj2GDclj5ofokWjzoa5jAwMkxCykd6,8,6,4,0,2,0,5,0,17,2.4285714285714284,2,0.0,0,4,0,2,6,0,0,5,0,6,11,1
8305,184139,87SYGQjFYUtEWda0pG12bcNker0JGBy3,bWdj2GDclj5ofokWjzoa5jAwMkxCykd6,10,10,0,12,0,2,5,1,30,4.285714285714286,1,0.0,3,0,12,0,7,2,0,5,1,15,15,1
8306,184140,erOlfnGmmzlHYZTaWMuJdUpNjOjYMpjJ,G8EPVSXsOYB5YQWZGiz1aVq5Pgr2GrQu,16,15,15,0,0,0,3,0,33,4.714285714285714,1,0.0,0,15,0,0,15,0,0,3,0,15,18,1
8307,184141,rhwYpyX6KgM0VDKsxgisgjFhLGxmCQNh,SpATywNh6bZuzm8s1ceuBUnMUAeoAHHw,10,5,3,0,3,0,3,0,14,2.0,1,0.0,0,3,0,3,5,0,0,3,0,6,8,1
8308,184159,grKJZKhbDMTJWn0gJUYvmKRwIdpcuPd3,SpATywNh6bZuzm8s1ceuBUnMUAeoAHHw,1,0,0,0,0,0,1,0,1,0.14285714285714285,1,0.0,0,0,0,0,0,0,0,1,0,0,1,1
8309,184162,wrzzafNhG6GCvwxPDE3fRWCo6aRW8DwL,SpATywNh6bZuzm8s1ceuBUnMUAeoAHHw,7,3,2,0,2,0,3,0,10,1.4285714285714286,1,0.0,0,2,0,2,3,0,0,3,0,4,6,1
8310,184177,OOKe107tRCXEu4JY5tmAfF1YLRgWymlM,SpATywNh6bZuzm8s1ceuBUnMUAeoAHHw,7,2,1,0,1,0,4,1,9,1.2857142857142858,1,0.0,0,1,0,1,2,0,0,4,1,2,7,1
8311,184186,VVnP6JrqXx0kcUSjOpF3nGJjlaJ7pttn,RXDvfPUBYFlVdlueBFbLW0mhhAyGEqpt,6,3,2,0,2,4,2,0,13,1.8571428571428572,1,0.0,0,2,0,2,3,4,0,2,0,4,9,1
8312,184196,fz9iMau4c5Sc5pf7Ev3deQnz7r6jSD21,bWdj2GDclj5ofokWjzoa5jAwMkxCykd6,7,4,2,0,1,3,4,0,14,2.0,1,0.0,0,2,0,1,4,3,0,4,0,3,11,1
8313,184198,T5b4rlcXzzOiQabsmSU227C710oPv1q6,SpATywNh6bZuzm8s1ceuBUnMUAeoAHHw,1,0,0,0,0,0,1,0,1,0.14285714285714285,1,0.0,0,0,0,0,0,0,0,1,0,0,1,1
8314,184200,fgbY9PHcmr11G1IYkEJJMMaayPBzrdUL,bWdj2GDclj5ofokWjzoa5jAwMkxCykd6,1,0,0,0,0,0,1,0,1,0.14285714285714285,1,0.0,0,0,0,0,0,0,0,1,0,0,1,1
8315,184206,6YsryIPZKCMdT9rBoswcMetX0bA1SxAS,G8EPVSXsOYB5YQWZGiz1aVq5Pgr2GrQu,1,0,0,0,0,0,1,0,1,0.14285714285714285,1,0.0,0,0,0,0,0,0,0,1,0,0,1,1
8316,185695,GeBQuszwSQRCopSsB1wYZb4YBk7b0Cp6,SpATywNh6bZuzm8s1ceuBUnMUAeoAHHw,5,4,3,0,0,0,2,0,9,1.2857142857142858,1,0.0,0,3,0,0,4,0,0,2,0,3,6,1
8317,185708,XKXeDYTx8c3NYYfheBcuxoUZV0qXomPt,RXDvfPUBYFlVdlueBFbLW0mhhAyGEqpt,7,2,1,0,1,0,4,0,8,1.1428571428571428,1,0.0,0,1,0,1,2,0,0,4,0,2,6,1
8318,185744,Az4YfhTihzekQWxQtUyhZcCNXF1QoO5A,A3fsA9Zfv1X2fVEQhTw51lKENdNrEqT3,2,0,0,0,0,0,2,0,2,0.2857142857142857,1,0.0,0,0,0,0,0,0,0,2,0,0,2,1
8319,185750,sJThH3sI3ghUBWEkkF5jl318HrGCcG4Q,SpATywNh6bZuzm8s1ceuBUnMUAeoAHHw,8,14,0,10,0,0,6,0,30,4.285714285714286,1,0.0,11,0,9,0,3,0,1,6,0,20,10,1
8320,185765,EcTOYzny90oltpyqEhmLnMxAbahxVt33,A3fsA9Zfv1X2fVEQhTw51lKENdNrEqT3,16,8,7,0,6,6,4,1,32,4.571428571428571,2,0.0,0,7,0,6,8,6,0,4,1,13,19,1
8321,185777,VDLlgOqW7FFpT6uHqFXXlnnZR1JOz0x8,G8EPVSXsOYB5YQWZGiz1aVq5Pgr2GrQu,2,0,0,0,0,0,2,0,2,0.2857142857142857,1,0.0,0,0,0,0,0,0,0,2,0,0,2,1
8322,185787,pX5xieCfpPW4jfU74i0ayJdMShXi7ShL,A3fsA9Zfv1X2fVEQhTw51lKENdNrEqT3,2,0,0,0,0,0,2,0,2,0.2857142857142857,1,0.0,0,0,0,0,0,0,0,2,0,0,2,1
8323,185791,OLSxCkluLildKVrVnzRIsj47tt9tVHj9,SpATywNh6bZuzm8s1ceuBUnMUAeoAHHw,1,0,0,0,0,0,1,0,1,0.14285714285714285,1,0.0,0,0,0,0,0,0,0,1,0,0,1,1
8324,185804,YxKCslAege9DFmBzH0U7gCkLRow3CW1P,SpATywNh6bZuzm8s1ceuBUnMUAeoAHHw,9,9,7,0,6,0,1,0,23,3.2857142857142856,1,0.0,1,7,0,6,8,0,0,1,0,14,9,1
8325,185828,IlZMDuyHlB01hS9oHYhp77XsI0vMQkwN,bWdj2GDclj5ofokWjzoa5jAwMkxCykd6,7,9,2,0,1,0,5,0,17,2.4285714285714284,2,0.0,0,2,0,1,9,0,0,5,0,3,14,1
8326,185840,9UxAqNYuBtvS2ppV37y5D8wZyoNAl3Em,bWdj2GDclj5ofokWjzoa5jAwMkxCykd6,9,22,7,0,6,0,7,12,54,7.714285714285714,1,0.0,7,7,0,6,15,0,0,7,12,20,34,1
8327,185842,gQqEJZs7B37MmzRexP5otRszUHd2KLYy,SpATywNh6bZuzm8s1ceuBUnMUAeoAHHw,27,22,15,20,8,0,3,0,68,9.714285714285714,2,0.0,4,15,18,8,18,0,2,3,0,45,23,1
8328,185845,nSUHoNpp8PQSdMavNp5bhwMOhBRAUKca,bWdj2GDclj5ofokWjzoa5jAwMkxCykd6,1,0,0,0,0,0,1,0,1,0.14285714285714285,1,0.0,0,0,0,0,0,0,0,1,0,0,1,1
8329,185855,mIK1AsuZnsKqFebwZwvDET5yr9oF0NY2,bWdj2GDclj5ofokWjzoa5jAwMkxCykd6,1,0,0,0,0,0,1,0,1,0.14285714285714285,1,0.0,0,0,0,0,0,0,0,1,0,0,1,1
8330,185864,eQeAZJfAlQDBFNhBayGkUGtYxXtMJqJ1,SpATywNh6bZuzm8s1ceuBUnMUAeoAHHw,11,6,5,0,3,0,6,0,20,2.857142857142857,1,0.0,0,5,0,3,6,0,0,6,0,8,12,1
8331,185868,KZ6GY3fLdtMBq5t6dJwyKZUQ4aE5PB3r,SpATywNh6bZuzm8s1ceuBUnMUAeoAHHw,11,16,1,18,0,0,5,0,40,5.714285714285714,1,0.0,10,1,17,0,6,0,1,5,0,28,12,1
8332,185871,TOGjSTNLmP1U3WLV68xOjR9qYmcLTX2F,bWdj2GDclj5ofokWjzoa5jAwMkxCykd6,4,2,1,0,1,0,1,0,5,0.7142857142857143,1,0.0,0,1,0,1,2,0,0,1,0,2,3,1
8333,185874,U6w2qwGH0WBMPRrilbl2Pu4q8r7wV2i5,RXDvfPUBYFlVdlueBFbLW0mhhAyGEqpt,4,2,1,0,1,0,2,0,6,0.8571428571428571,1,0.0,0,1,0,1,2,0,0,2,0,2,4,0
8334,185878,BCr2GOpOyeEKOuzlRV7PJCL1CEnRyr6Q,A3fsA9Zfv1X2fVEQhTw51lKENdNrEqT3,1,0,0,0,0,0,1,0,1,0.14285714285714285,1,0.0,0,0,0,0,0,0,0,1,0,0,1,1
8335,185900,mP0oq4UFI55XwGbomuLjnKyaYZ9Irhl8,SpATywNh6bZuzm8s1ceuBUnMUAeoAHHw,1,0,0,0,0,0,1,0,1,0.14285714285714285,1,0.0,0,0,0,0,0,0,0,1,0,0,1,1
8336,185906,3RLcNHh9pobwm6kdbgPM3yL4oOSbkTV7,bWdj2GDclj5ofokWjzoa5jAwMkxCykd6,11,8,3,12,2,1,10,3,39,5.571428571428571,1,0.0,1,3,11,2,7,1,1,10,3,17,22,1
8337,185913,JNo2rLqKe6aBGDwGzu8tXd13uOC5tEnq,A3fsA9Zfv1X2fVEQhTw51lKENdNrEqT3,11,8,7,0,0,0,7,0,22,3.142857142857143,1,0.0,0,7,0,0,8,0,0,7,0,7,15,0
8338,185916,AZzjcou5vNOE04RAMAJi2EeLUqqymRTr,SpATywNh6bZuzm8s1ceuBUnMUAeoAHHw,5,2,1,0,1,0,2,0,6,0.8571428571428571,1,0.0,0,1,0,1,2,0,0,2,0,2,4,1
8339,185958,brnRegHqgNF4oAtC7Z92Gvb6wNpNm0iX,SpATywNh6bZuzm8s1ceuBUnMUAeoAHHw,5,2,1,0,1,1,2,0,7,1.0,1,0.0,0,1,0,1,2,1,0,2,0,2,5,1
8340,185973,xpLT6AJby37iITmsTgKzOCviwStat3HT,RXDvfPUBYFlVdlueBFbLW0mhhAyGEqpt,23,38,26,42,16,0,7,0,129,18.428571428571427,3,0.0,3,26,36,16,35,0,6,7,0,81,48,1
8341,186015,IZAsMmFtzA3Z4w092UEvwBTSkmDLpELL,bWdj2GDclj5ofokWjzoa5jAwMkxCykd6,1,0,0,0,0,0,1,0,1,0.14285714285714285,1,0.0,0,0,0,0,0,0,0,1,0,0,1,1
8342,186026,CQWretzMoQOL7mDTUjZusG4cd4L6wPQK,G8EPVSXsOYB5YQWZGiz1aVq5Pgr2GrQu,8,7,5,0,4,0,3,0,19,2.7142857142857144,2,0.0,0,5,0,4,7,0,0,3,0,9,10,1
8343,186031,OrXQ89uxDLDCGqiuZJDaLKhVuW8wRjFm,SpATywNh6bZuzm8s1ceuBUnMUAeoAHHw,1,0,0,0,0,0,1,0,1,0.14285714285714285,1,0.0,0,0,0,0,0,0,0,1,0,0,1,1
8344,186032,q8cwoymgEO62c2PjNUcCMU666aFjaHHf,RXDvfPUBYFlVdlueBFbLW0mhhAyGEqpt,9,4,3,0,3,0,2,0,12,1.7142857142857142,1,0.0,0,3,0,3,4,0,0,2,0,6,6,0
8345,186036,3CK0J1tusVtSvx6F6S9RQr6rj3f2luQC,A3fsA9Zfv1X2fVEQhTw51lKENdNrEqT3,4,1,0,0,0,0,5,0,6,0.8571428571428571,2,0.0,0,0,0,0,1,0,0,5,0,0,6,1
8346,186037,l2J6DNpa2tfvVIbHf48MlgRXXDizR7ZU,RXDvfPUBYFlVdlueBFbLW0mhhAyGEqpt,21,21,2,26,1,0,1,0,51,7.285714285714286,1,0.0,4,2,24,1,17,0,2,1,0,31,20,1
8347,186043,pwdsR2guw7jGBDVAdaksGODr7uJoy6bJ,SpATywNh6bZuzm8s1ceuBUnMUAeoAHHw,1,0,0,0,0,0,1,0,1,0.14285714285714285,1,0.0,0,0,0,0,0,0,0,1,0,0,1,1
8348,186051,pwdsR2guw7jGBDVAdaksGODr7uJoy6bJ,bWdj2GDclj5ofokWjzoa5jAwMkxCykd6,1,0,0,0,0,0,1,0,1,0.14285714285714285,1,0.0,0,0,0,0,0,0,0,1,0,0,1,1
8349,186083,vbZxM4TDv9mGZl0HuTBLAdzQ0iLXNnWT,SpATywNh6bZuzm8s1ceuBUnMUAeoAHHw,7,4,2,0,2,0,2,0,10,1.4285714285714286,2,0.0,0,2,0,2,4,0,0,2,0,4,6,1
8350,186122,tzFDwEYPmJ3KvE5ftnVNKM2NcL054uAX,G8EPVSXsOYB5YQWZGiz1aVq5Pgr2GrQu,6,3,1,0,0,1,4,1,10,1.4285714285714286,1,0.0,0,1,0,0,3,1,0,4,1,1,9,1
8351,186142,JozaCp1AeR7tr4bIEFDuRD5emwNjHpcL,SpATywNh6bZuzm8s1ceuBUnMUAeoAHHw,7,4,0,0,0,10,3,0,17,2.4285714285714284,1,0.0,0,0,0,0,4,10,0,3,0,0,17,1
8352,186154,UY0l6TfHASkV3r4lAYBX1Kuh54Mk5Xfi,RXDvfPUBYFlVdlueBFbLW0mhhAyGEqpt,23,33,2,28,5,0,4,0,72,10.285714285714286,2,0.0,10,2,25,5,23,0,3,4,0,42,30,1
8353,186155,Xl8Tem8G8sPah3KAWnbWgv7GNqLZqPFw,RXDvfPUBYFlVdlueBFbLW0mhhAyGEqpt,1,0,0,0,0,0,1,0,1,0.14285714285714285,1,0.0,0,0,0,0,0,0,0,1,0,0,1,1
8354,186156,ujpnoFj9Sccm69HUxcPfoVG6MkkjyaiE,G8EPVSXsOYB5YQWZGiz1aVq5Pgr2GrQu,10,4,1,0,1,14,10,1,31,4.428571428571429,2,0.0,0,1,0,1,4,14,0,10,1,2,29,0
8355,186158,gHhm2qXabgimtxCoVqwGNu3GtN0RfHoU,G8EPVSXsOYB5YQWZGiz1aVq5Pgr2GrQu,6,2,1,0,1,0,4,0,8,1.1428571428571428,1,0.0,0,1,0,1,2,0,0,4,0,2,6,1
8356,186170,3ULN82Jhvo9A1lCK71PqFv86yozEWjuj,SpATywNh6bZuzm8s1ceuBUnMUAeoAHHw,10,8,5,0,3,0,2,0,18,2.5714285714285716,1,0.0,0,5,0,3,8,0,0,2,0,8,10,1
8357,186194,kQWd08MJREYjLYHoBUU4DknlUSMQ7cCV,SpATywNh6bZuzm8s1ceuBUnMUAeoAHHw,6,4,2,0,2,3,2,0,13,1.8571428571428572,1,0.0,0,2,0,2,4,3,0,2,0,4,9,1
8358,186196,POFpLFsQBaugY3YnnocJIKLsXXkLzRDf,SpATywNh6bZuzm8s1ceuBUnMUAeoAHHw,1,0,0,0,0,0,1,0,1,0.14285714285714285,1,0.0,0,0,0,0,0,0,0,1,0,0,1,1
8359,186198,v6v1hayEEXofBruMyo9TZ2ggXeu5UD3T,A3fsA9Zfv1X2fVEQhTw51lKENdNrEqT3,5,3,1,0,1,0,3,0,8,1.1428571428571428,1,0.0,0,1,0,1,3,0,0,3,0,2,6,1
8360,186211,Zc1PnahT9ISh4c9DBr5jGFkTq2VN1Ayy,G8EPVSXsOYB5YQWZGiz1aVq5Pgr2GrQu,11,14,8,10,3,2,1,0,38,5.428571428571429,1,0.0,5,8,7,3,9,2,3,1,0,23,15,1
8361,186222,vlarE7zCdES78rsfbZ9s0PTdwVr1rAk4,bWdj2GDclj5ofokWjzoa5jAwMkxCykd6,3,3,0,0,0,0,1,0,4,0.5714285714285714,1,0.0,0,0,0,0,3,0,0,1,0,0,4,1
8362,186224,MSWIy7wC5VROeIgPqQIhPQ6v5vOa7TXY,G8EPVSXsOYB5YQWZGiz1aVq5Pgr2GrQu,6,0,0,0,0,1,13,3,17,2.4285714285714284,1,0.0,0,0,0,0,0,1,0,13,3,0,17,1
8363,186246,UY0l6TfHASkV3r4lAYBX1Kuh54Mk5Xfi,A3fsA9Zfv1X2fVEQhTw51lKENdNrEqT3,35,32,1,62,1,0,14,5,115,16.428571428571427,2,0.0,7,1,56,1,25,0,6,14,5,65,50,1
8364,186252,6HmdNYWkOfKPcsSkwkqnh7uY2Gqe1cX7,SpATywNh6bZuzm8s1ceuBUnMUAeoAHHw,5,4,3,0,3,0,2,0,12,1.7142857142857142,2,0.0,0,3,0,3,4,0,0,2,0,6,6,1
8365,186255,vbQsfStPUAntkNJPXL2TWQHB0509Qjr7,A3fsA9Zfv1X2fVEQhTw51lKENdNrEqT3,3,0,0,0,0,0,4,0,4,0.5714285714285714,1,0.0,0,0,0,0,0,0,0,4,0,0,4,1
8366,186266,dehhpoRrM4rg7t676Y7qCiumWRV2WOzS,SpATywNh6bZuzm8s1ceuBUnMUAeoAHHw,1,0,0,0,0,0,1,0,1,0.14285714285714285,1,0.0,0,0,0,0,0,0,0,1,0,0,1,1
8367,186271,XAjd05OrffFBimg6dLsDVkG5Gjsx6XlT,A3fsA9Zfv1X2fVEQhTw51lKENdNrEqT3,1,0,0,0,0,0,1,0,1,0.14285714285714285,1,0.0,0,0,0,0,0,0,0,1,0,0,1,1
8368,186289,rkWpVW2n5cp9IeLZVRLQUrt1dID41LRY,SpATywNh6bZuzm8s1ceuBUnMUAeoAHHw,7,10,6,0,3,0,1,0,20,2.857142857142857,1,0.0,3,6,0,3,7,0,0,1,0,12,8,1
8369,186292,tWw75YIFgGadaRnkyPeGlfSVpk3ysa4L,A3fsA9Zfv1X2fVEQhTw51lKENdNrEqT3,5,3,1,0,1,0,1,0,6,0.8571428571428571,1,0.0,0,1,0,1,3,0,0,1,0,2,4,1
8370,186318,OSHDYiz33FI0tkAswcTI5uxK5gdfibj6,A3fsA9Zfv1X2fVEQhTw51lKENdNrEqT3,3,0,0,0,0,0,3,0,3,0.42857142857142855,1,0.0,0,0,0,0,0,0,0,3,0,0,3,1
8371,186319,8UDPY0GORYpQM3S1dtt5YkG0CDkJUfAi,SpATywNh6bZuzm8s1ceuBUnMUAeoAHHw,8,7,5,0,2,0,2,0,16,2.2857142857142856,1,0.0,0,5,0,2,7,0,0,2,0,7,9,1
8372,186332,SdUI7MFv1cY1lGHTqsLRYstBYRI0xIIR,SpATywNh6bZuzm8s1ceuBUnMUAeoAHHw,13,10,0,18,0,0,5,2,35,5.0,1,0.0,2,0,15,0,8,0,3,5,2,17,18,1
8373,186359,GMzSpgZQ6jzVsfHn8W8i83JsYNxnP00b,RXDvfPUBYFlVdlueBFbLW0mhhAyGEqpt,4,2,1,0,1,0,1,0,5,0.7142857142857143,1,0.0,0,1,0,1,2,0,0,1,0,2,3,1
8374,186375,uQzrox8H38SjXEhLoth5A55QRUWPEK46,G8EPVSXsOYB5YQWZGiz1aVq5Pgr2GrQu,7,4,1,0,1,0,3,0,9,1.2857142857142858,1,0.0,0,1,0,1,4,0,0,3,0,2,7,1
8375,186378,4lhCwJo7yYXKFlssNpVO8DZHuYKFBvLp,A3fsA9Zfv1X2fVEQhTw51lKENdNrEqT3,7,3,2,0,2,6,3,0,16,2.2857142857142856,1,0.0,0,2,0,2,3,6,0,3,0,4,12,1
8376,186398,59oEIRULxWLaLldaaHbqaw4nucIn93k4,G8EPVSXsOYB5YQWZGiz1aVq5Pgr2GrQu,5,2,1,0,1,0,2,0,6,0.8571428571428571,1,0.0,0,1,0,1,2,0,0,2,0,2,4,1
8377,186433,KZqJQBCdtksPSQ3TutEdK8fy0LKI4eut,RXDvfPUBYFlVdlueBFbLW0mhhAyGEqpt,1,0,0,0,0,0,1,0,1,0.14285714285714285,1,0.0,0,0,0,0,0,0,0,1,0,0,1,1
8378,186446,bIezVonf0N1LpjwByS1ltzDSkDe7OlG8,SpATywNh6bZuzm8s1ceuBUnMUAeoAHHw,12,19,10,0,3,1,9,2,44,6.285714285714286,1,0.0,0,10,0,3,19,1,0,9,2,13,31,1
8379,186457,LjhFDdYhdfVWWRFvrc4aNHUi5SD6clAR,bWdj2GDclj5ofokWjzoa5jAwMkxCykd6,4,2,1,0,1,0,1,0,5,0.7142857142857143,1,0.0,0,1,0,1,2,0,0,1,0,2,3,1
8380,186461,qIinMseAcQ8q8AFqNGAlgGp8FqmURvdC,bWdj2GDclj5ofokWjzoa5jAwMkxCykd6,6,3,0,0,0,0,4,0,7,1.0,1,0.0,0,0,0,0,3,0,0,4,0,0,7,1
8381,186471,T7YlTqIDVTZFYEYihxD1Zij5IkDsmVZP,SpATywNh6bZuzm8s1ceuBUnMUAeoAHHw,5,6,3,0,1,0,1,0,11,1.5714285714285714,1,0.0,2,3,0,1,4,0,0,1,0,6,5,1
8382,186475,qsPGhZXTxPpaTY2qxQgCzRxNrBA26TIJ,A3fsA9Zfv1X2fVEQhTw51lKENdNrEqT3,3,1,0,0,0,0,4,0,5,0.7142857142857143,1,0.0,0,0,0,0,1,0,0,4,0,0,5,1
8383,186479,FtIGPSLlLHlXJuNP4CbCwrQzSedZBL0g,SpATywNh6bZuzm8s1ceuBUnMUAeoAHHw,9,9,5,0,3,0,2,0,19,2.7142857142857144,1,0.0,3,5,0,3,6,0,0,2,0,11,8,1
8384,186490,V7rVXKT1jqsQDinfnUz1gk0ep5LdnCQz,SpATywNh6bZuzm8s1ceuBUnMUAeoAHHw,8,2,1,0,1,1,5,1,11,1.5714285714285714,1,0.0,0,1,0,1,2,1,0,5,1,2,9,1
8385,186493,htua1xywlnpsMMY7EJSOsurL86GI912X,bWdj2GDclj5ofokWjzoa5jAwMkxCykd6,3,3,1,0,0,0,1,0,5,0.7142857142857143,1,0.0,0,1,0,0,3,0,0,1,0,1,4,1
8386,186521,4BrXOKatej2Wdv61aLL3SraA7e0yYTLh,SpATywNh6bZuzm8s1ceuBUnMUAeoAHHw,2,0,0,0,0,0,2,0,2,0.2857142857142857,1,0.0,0,0,0,0,0,0,0,2,0,0,2,1
8387,186524,5pfeeYLWSB4wCSWnPZbrmiSBS3yXgMsk,SpATywNh6bZuzm8s1ceuBUnMUAeoAHHw,5,4,0,0,0,0,3,0,7,1.0,1,0.0,0,0,0,0,4,0,0,3,0,0,7,1
8388,186543,bJDihmOTOP8tzchQo3EmXDlLmnZksGMI,SpATywNh6bZuzm8s1ceuBUnMUAeoAHHw,1,0,0,0,0,0,1,0,1,0.14285714285714285,1,0.0,0,0,0,0,0,0,0,1,0,0,1,1
8389,186551,ITnBh4AcTaOdkBvoDVqj5ARkv2J54QTG,SpATywNh6bZuzm8s1ceuBUnMUAeoAHHw,7,2,1,0,1,0,6,1,11,1.5714285714285714,1,0.0,0,1,0,1,2,0,0,6,1,2,9,1
8390,186556,VIptmPegATK5qvvl8OyUabYRGHZdqxvU,SpATywNh6bZuzm8s1ceuBUnMUAeoAHHw,9,4,2,0,2,0,4,1,13,1.8571428571428572,1,0.0,1,2,0,2,3,0,0,4,1,5,8,1
8391,186563,itb7buqF5mtGNemnlGyYA2pmGWssLWjE,SpATywNh6bZuzm8s1ceuBUnMUAeoAHHw,10,6,4,0,3,0,3,0,16,2.2857142857142856,2,0.0,0,4,0,3,6,0,0,3,0,7,9,1
8392,186570,QZIRHdwFgibI2SBehTrmLAZxED1F4JL7,A3fsA9Zfv1X2fVEQhTw51lKENdNrEqT3,14,15,7,0,7,0,1,0,30,4.285714285714286,1,0.0,0,7,0,7,15,0,0,1,0,14,16,1
8393,186572,MYsCU1zkMrWxPhV1b7wSL5LZIo1zGyhU,SpATywNh6bZuzm8s1ceuBUnMUAeoAHHw,1,0,0,0,0,0,1,0,1,0.14285714285714285,1,0.0,0,0,0,0,0,0,0,1,0,0,1,1
8394,186585,4GCFGR3S6zyUaFCN0ANuEVdNqsmLUl3s,SpATywNh6bZuzm8s1ceuBUnMUAeoAHHw,14,43,2,16,0,17,25,3,106,15.142857142857142,2,0.0,14,2,14,0,29,17,2,25,3,30,76,1
8395,186591,ZUogtQULz2GfCq4cni0kVmwpD4O6JuwY,SpATywNh6bZuzm8s1ceuBUnMUAeoAHHw,8,6,1,6,0,0,2,0,15,2.142857142857143,1,0.0,1,1,5,0,5,0,1,2,0,7,8,1
8396,186592,UDgUCnq3QLzgpXlB51yXFWzxVoQqQtdJ,G8EPVSXsOYB5YQWZGiz1aVq5Pgr2GrQu,29,18,15,0,10,0,9,3,55,7.857142857142857,1,0.0,0,15,0,10,18,0,0,9,3,25,30,0
8397,186593,dFhW5phJnKOqlVjNkJknZ8QVATFpUOzD,bWdj2GDclj5ofokWjzoa5jAwMkxCykd6,2,0,0,0,0,0,3,0,3,0.42857142857142855,1,0.0,0,0,0,0,0,0,0,3,0,0,3,1
8398,186596,KZqJQBCdtksPSQ3TutEdK8fy0LKI4eut,bWdj2GDclj5ofokWjzoa5jAwMkxCykd6,1,0,0,0,0,0,1,0,1,0.14285714285714285,1,0.0,0,0,0,0,0,0,0,1,0,0,1,1
8399,186597,KZqJQBCdtksPSQ3TutEdK8fy0LKI4eut,A3fsA9Zfv1X2fVEQhTw51lKENdNrEqT3,1,0,0,0,0,0,1,0,1,0.14285714285714285,1,0.0,0,0,0,0,0,0,0,1,0,0,1,1
8400,186600,RCImAeGNpwksr5OoLexzhMJb9tVjxo1e,SpATywNh6bZuzm8s1ceuBUnMUAeoAHHw,1,0,0,0,0,0,1,0,1,0.14285714285714285,1,0.0,0,0,0,0,0,0,0,1,0,0,1,1
8401,186602,vavfgCcT5IuD68jWJDk0XbOVSfTIDT0M,G8EPVSXsOYB5YQWZGiz1aVq5Pgr2GrQu,7,11,0,0,0,0,6,1,18,2.5714285714285716,1,0.0,0,0,0,0,11,0,0,6,1,0,18,1
8402,186610,BOiGxHn3raRj9eGIKlFjQQHhXEBtSDbh,SpATywNh6bZuzm8s1ceuBUnMUAeoAHHw,2,0,0,0,0,0,2,0,2,0.2857142857142857,1,0.0,0,0,0,0,0,0,0,2,0,0,2,1
8403,186623,OyDMa8JOXSYbsE31qL3fL6emrgq0mwJU,SpATywNh6bZuzm8s1ceuBUnMUAeoAHHw,1,0,0,0,0,0,1,0,1,0.14285714285714285,1,0.0,0,0,0,0,0,0,0,1,0,0,1,1
8404,186635,MZdlzL4gO74etRlgkUDa9eGtQZo9ovTN,SpATywNh6bZuzm8s1ceuBUnMUAeoAHHw,1,0,0,0,0,0,1,0,1,0.14285714285714285,1,0.0,0,0,0,0,0,0,0,1,0,0,1,1
8405,186644,Rv6gVo5TL2yRLbTriDaWEPebl1P4Qs2d,A3fsA9Zfv1X2fVEQhTw51lKENdNrEqT3,1,0,0,0,0,0,1,0,1,0.14285714285714285,1,0.0,0,0,0,0,0,0,0,1,0,0,1,1
8406,186646,EXWNkRXjkZOc8AsQnQXXGYq4K74jND3i,SpATywNh6bZuzm8s1ceuBUnMUAeoAHHw,5,2,1,0,1,0,2,0,6,0.8571428571428571,1,0.0,0,1,0,1,2,0,0,2,0,2,4,1
8407,186650,Rv6gVo5TL2yRLbTriDaWEPebl1P4Qs2d,bWdj2GDclj5ofokWjzoa5jAwMkxCykd6,16,23,9,124,9,0,2,0,167,23.857142857142858,1,0.0,12,9,119,9,11,0,5,2,0,149,18,1
8408,186657,cEMxPdpNr0sg7WlHPqAdbLiWdfHH1ZVi,RXDvfPUBYFlVdlueBFbLW0mhhAyGEqpt,8,5,4,0,2,0,1,0,12,1.7142857142857142,1,0.0,0,4,0,2,5,0,0,1,0,6,6,1
8409,186663,w67bG97cTw7otOM2uWqK71mG1zCn2Z71,RXDvfPUBYFlVdlueBFbLW0mhhAyGEqpt,6,2,1,0,1,0,3,0,7,1.0,1,0.0,1,1,0,1,1,0,0,3,0,3,4,1
8410,186685,NkVQGteS9t3nbfagAzHcxD3mnVkb9mPC,A3fsA9Zfv1X2fVEQhTw51lKENdNrEqT3,35,28,21,64,12,0,7,0,132,18.857142857142858,2,0.0,3,21,56,12,25,0,8,7,0,92,40,1
8411,186707,mnhLxfC9FQKYouYyd3LS1enEfHJfDKsX,G8EPVSXsOYB5YQWZGiz1aVq5Pgr2GrQu,17,18,1,0,1,1,6,0,27,3.857142857142857,2,0.0,0,1,0,1,18,1,0,6,0,2,25,0
8412,186721,XO4yOVP7eCwBTi6pYIgtRmMh0ft7YdHb,bWdj2GDclj5ofokWjzoa5jAwMkxCykd6,6,4,0,0,0,2,8,0,14,2.0,1,0.0,0,0,0,0,4,2,0,8,0,0,14,1
8413,186759,hHVyNQkfLcybgeO1W2xMmju5SBV0vBkh,A3fsA9Zfv1X2fVEQhTw51lKENdNrEqT3,3,2,0,0,0,0,1,0,3,0.42857142857142855,1,0.0,0,0,0,0,2,0,0,1,0,0,3,1
8414,186789,zaUwSB02aOgiyf49lPt6UjZNYDYC7fjT,A3fsA9Zfv1X2fVEQhTw51lKENdNrEqT3,4,2,0,0,0,0,3,0,5,0.7142857142857143,1,0.0,0,0,0,0,2,0,0,3,0,0,5,1
8415,186792,eREFizdpriB0dfyYOU7lPptHy7Cm4d3g,SpATywNh6bZuzm8s1ceuBUnMUAeoAHHw,4,2,0,0,0,0,2,0,4,0.5714285714285714,1,0.0,0,0,0,0,2,0,0,2,0,0,4,1
8416,186797,Eh8pkmowXyhtJAd3Rq2bSawvaaJrouRd,RXDvfPUBYFlVdlueBFbLW0mhhAyGEqpt,6,5,2,0,1,0,4,0,12,1.7142857142857142,2,0.0,0,2,0,1,5,0,0,4,0,3,9,1
8417,186819,vAnLr8TMB4xrFCa1bt8zTG1qXKp0tpM2,SpATywNh6bZuzm8s1ceuBUnMUAeoAHHw,8,2,2,0,1,0,8,0,13,1.8571428571428572,1,0.0,0,2,0,1,2,0,0,8,0,3,10,1
8418,186845,rztgByxlqb0NHiCkVNMSLs4z23c2EnGy,SpATywNh6bZuzm8s1ceuBUnMUAeoAHHw,6,3,2,0,2,0,1,0,8,1.1428571428571428,1,0.0,0,2,0,2,3,0,0,1,0,4,4,1
8419,186852,h8UWLevhpVfEbcVzC3XxVtErwnEzlHV5,RXDvfPUBYFlVdlueBFbLW0mhhAyGEqpt,1,0,0,0,0,0,3,0,3,0.42857142857142855,2,0.0,0,0,0,0,0,0,0,3,0,0,3,0
8420,186879,f5d2qvzqNcWdC1ycnE8TG7hK2snW07TA,SpATywNh6bZuzm8s1ceuBUnMUAeoAHHw,6,8,5,0,4,0,7,0,24,3.4285714285714284,2,0.0,0,5,0,4,8,0,0,7,0,9,15,1
8421,186886,1Che5WZp8JOnI2bMKJvtmSYY66gIbE1b,SpATywNh6bZuzm8s1ceuBUnMUAeoAHHw,8,6,0,0,0,0,3,0,9,1.2857142857142858,1,0.0,0,0,0,0,6,0,0,3,0,0,9,1
8422,188096,w8S7oPNGWahl5gDDyBTLSciA1VA7haw4,A3fsA9Zfv1X2fVEQhTw51lKENdNrEqT3,19,17,11,0,8,0,2,0,38,5.428571428571429,1,0.0,3,11,0,8,14,0,0,2,0,22,16,1
8423,188103,O8GYzagsTrclNZXR3HZD1CBdMlg7RUB6,SpATywNh6bZuzm8s1ceuBUnMUAeoAHHw,4,2,0,0,0,0,2,0,4,0.5714285714285714,1,0.0,0,0,0,0,2,0,0,2,0,0,4,1
8424,188113,Q8i7XHeUD92Ae2WeCoNsZYF9vQYf3HPz,SpATywNh6bZuzm8s1ceuBUnMUAeoAHHw,1,0,0,0,0,0,1,0,1,0.14285714285714285,1,0.0,0,0,0,0,0,0,0,1,0,0,1,1
8425,188129,bA4tnPZD0UU4XAL3OkL7nUjtkAzbgj9d,SpATywNh6bZuzm8s1ceuBUnMUAeoAHHw,13,26,11,0,6,0,3,0,46,6.571428571428571,1,0.0,7,11,0,6,19,0,0,3,0,24,22,1
8426,188157,2hMeaUc14fgUG8b3kgXxN1xDYogexPXy,A3fsA9Zfv1X2fVEQhTw51lKENdNrEqT3,8,5,4,0,3,0,1,0,13,1.8571428571428572,1,0.0,0,4,0,3,5,0,0,1,0,7,6,1
8427,188168,Q2xVgvnqNYVNG5kOgvnpJvY9QuBN0RbG,bWdj2GDclj5ofokWjzoa5jAwMkxCykd6,6,3,1,0,1,0,2,0,7,1.0,1,0.0,0,1,0,1,3,0,0,2,0,2,5,1
8428,188176,wwrhZcbbsWF5UNfVZIIcfrs0NelO6L0J,bWdj2GDclj5ofokWjzoa5jAwMkxCykd6,5,2,1,0,1,0,2,0,6,0.8571428571428571,1,0.0,0,1,0,1,2,0,0,2,0,2,4,1
8429,188188,Vhmq36VBivLuLEONnhTEAZGyc0lOW8HG,SpATywNh6bZuzm8s1ceuBUnMUAeoAHHw,1,0,0,0,0,0,1,0,1,0.14285714285714285,1,0.0,0,0,0,0,0,0,0,1,0,0,1,1
8430,188191,K6d2j7PmZmtKVENKrnd412mUvCD6G0Iq,A3fsA9Zfv1X2fVEQhTw51lKENdNrEqT3,36,21,10,52,8,0,9,1,101,14.428571428571429,1,0.0,3,10,47,8,18,0,5,9,1,68,33,1
8431,188218,ycZck16llBAZloBk10bwfMcnaMnaXQWK,RXDvfPUBYFlVdlueBFbLW0mhhAyGEqpt,6,5,0,0,0,0,5,0,10,1.4285714285714286,1,0.0,0,0,0,0,5,0,0,5,0,0,10,1
8432,188241,UQu58ECfm706pzTxKdZuMBkLVofX5BYJ,bWdj2GDclj5ofokWjzoa5jAwMkxCykd6,7,3,2,0,2,0,2,0,9,1.2857142857142858,1,0.0,0,2,0,2,3,0,0,2,0,4,5,1
8433,188249,55wiWWDY37Jvz4XRR5WZBukpONx2E6zf,bWdj2GDclj5ofokWjzoa5jAwMkxCykd6,5,5,3,0,2,0,2,0,12,1.7142857142857142,1,0.0,0,3,0,2,5,0,0,2,0,5,7,1
8434,188256,QycCZ3StVS9Q0gqdzH8YDRcbrA6KQPic,SpATywNh6bZuzm8s1ceuBUnMUAeoAHHw,22,35,11,15,6,0,2,0,69,9.857142857142858,1,0.0,21,11,15,6,14,0,0,2,0,53,16,1
8435,188301,CwrmTUMTRx5M6yQJpPEbrBRyJawjn4Ps,SpATywNh6bZuzm8s1ceuBUnMUAeoAHHw,1,0,0,0,0,0,1,0,1,0.14285714285714285,1,0.0,0,0,0,0,0,0,0,1,0,0,1,1
8436,188323,08FXiN9E2j1PM7CMfj415B4erdhymv4G,SpATywNh6bZuzm8s1ceuBUnMUAeoAHHw,9,2,2,0,2,0,7,1,14,2.0,1,0.0,0,2,0,2,2,0,0,7,1,4,10,1
8437,188332,WxVM9kOqNmenlQy1YKMo3yVYKYKkewCz,bWdj2GDclj5ofokWjzoa5jAwMkxCykd6,1,0,0,0,0,0,1,0,1,0.14285714285714285,1,0.0,0,0,0,0,0,0,0,1,0,0,1,1
8438,188338,7xGbu9oc4JWGY9fgiUO3Qqm473RvS2PB,SpATywNh6bZuzm8s1ceuBUnMUAeoAHHw,7,3,2,0,2,0,2,0,9,1.2857142857142858,1,0.0,0,2,0,2,3,0,0,2,0,4,5,1
8439,188348,4ly9tFjgsKJLiMP1XUHFz2i27nHiXdvU,A3fsA9Zfv1X2fVEQhTw51lKENdNrEqT3,8,3,2,0,0,5,6,1,17,2.4285714285714284,1,0.0,0,2,0,0,3,5,0,6,1,2,15,1
8440,188374,U30BvMtyZpL38NHSSIWCu0FHJgAKw4Fr,A3fsA9Zfv1X2fVEQhTw51lKENdNrEqT3,2,0,0,0,0,0,3,0,3,0.42857142857142855,1,0.0,0,0,0,0,0,0,0,3,0,0,3,0
8441,188386,q3NLZCkaVgPCeFUby9MsDXbo2vYw2wOB,SpATywNh6bZuzm8s1ceuBUnMUAeoAHHw,1,0,0,0,0,0,1,0,1,0.14285714285714285,1,0.0,0,0,0,0,0,0,0,1,0,0,1,1
8442,188415,GAKCidUQ8hdeh0WMwEYlK9cUZXNPRN5R,RXDvfPUBYFlVdlueBFbLW0mhhAyGEqpt,1,0,0,0,0,0,1,0,1,0.14285714285714285,1,0.0,0,0,0,0,0,0,0,1,0,0,1,1
8443,188427,btK3RdfuvWrDzNhOkrOpUgTbQUI2vrLY,SpATywNh6bZuzm8s1ceuBUnMUAeoAHHw,6,7,1,0,1,0,1,0,10,1.4285714285714286,1,0.0,3,1,0,1,4,0,0,1,0,5,5,1
8444,188446,3tkincdjsTSFt3awGPKGfVv9zR1YRwuC,SpATywNh6bZuzm8s1ceuBUnMUAeoAHHw,1,0,0,0,0,0,1,0,1,0.14285714285714285,1,0.0,0,0,0,0,0,0,0,1,0,0,1,1
8445,188447,DUw85TcNpxyZaZKIM1HlHxvgtSm7uwxY,G8EPVSXsOYB5YQWZGiz1aVq5Pgr2GrQu,5,2,1,0,1,0,2,0,6,0.8571428571428571,1,0.0,0,1,0,1,2,0,0,2,0,2,4,0
8446,188458,jFwDcIl1Tm6UHlfb8PtOob6kZkOEjdQr,RXDvfPUBYFlVdlueBFbLW0mhhAyGEqpt,1,0,0,0,0,0,1,0,1,0.14285714285714285,1,0.0,0,0,0,0,0,0,0,1,0,0,1,1
8447,188461,blQKCpClzsxilnQtKRruTVl5WFjEiUZ7,SpATywNh6bZuzm8s1ceuBUnMUAeoAHHw,5,4,3,0,2,0,1,0,10,1.4285714285714286,1,0.0,0,3,0,2,4,0,0,1,0,5,5,1
8448,188475,Onp8u1IlkiXCdEq7Tg9xltw0KEKQAxrs,SpATywNh6bZuzm8s1ceuBUnMUAeoAHHw,6,3,2,0,2,0,1,0,8,1.1428571428571428,1,0.0,0,2,0,2,3,0,0,1,0,4,4,1
8449,188481,gkv9GP4XDvDQ4me5aOnbcgCOOilwq0mr,SpATywNh6bZuzm8s1ceuBUnMUAeoAHHw,1,0,0,0,0,0,1,0,1,0.14285714285714285,1,0.0,0,0,0,0,0,0,0,1,0,0,1,1
8450,188487,yQM2e0pQ43tZ4WbvgNqCdUjXo9r9zUpY,bWdj2GDclj5ofokWjzoa5jAwMkxCykd6,1,0,0,0,0,0,1,0,1,0.14285714285714285,1,0.0,0,0,0,0,0,0,0,1,0,0,1,1
8451,188509,NhmfopX2bIkd9yTnVyho2Qq41VTy8NFx,SpATywNh6bZuzm8s1ceuBUnMUAeoAHHw,6,1,1,0,1,0,3,0,6,0.8571428571428571,1,0.0,0,1,0,1,1,0,0,3,0,2,4,1
8452,188511,g6p03sN0Mi0uDRMoaBI65emUrtGFnpP4,RXDvfPUBYFlVdlueBFbLW0mhhAyGEqpt,20,13,9,14,7,0,7,1,51,7.285714285714286,1,0.0,2,9,14,7,11,0,0,7,1,32,19,1
8453,188522,VZRd1DrilkNeD7Ya8MVZCNtIczH3eEMz,G8EPVSXsOYB5YQWZGiz1aVq5Pgr2GrQu,21,42,24,26,6,0,15,1,114,16.285714285714285,2,0.0,9,24,17,6,33,0,9,15,1,56,58,1
8454,188544,wiVLWKqdbOlotFq1ag8KwC6Hw3JbpdNh,SpATywNh6bZuzm8s1ceuBUnMUAeoAHHw,6,3,1,0,1,0,2,0,7,1.0,1,0.0,0,1,0,1,3,0,0,2,0,2,5,1
8455,188555,uo8XRoO08TmpTH4gap159tNYVx3xop3U,G8EPVSXsOYB5YQWZGiz1aVq5Pgr2GrQu,1,0,0,0,0,0,1,0,1,0.14285714285714285,1,0.0,0,0,0,0,0,0,0,1,0,0,1,1
8456,188558,xqboiFlp42vyY93nDStsbVWBCL5sgIRH,A3fsA9Zfv1X2fVEQhTw51lKENdNrEqT3,24,23,1,16,1,0,7,0,48,6.857142857142857,1,0.0,0,1,13,1,23,0,3,7,0,15,33,1
8457,188561,6mdM8AvYlfditnue2TYJQLFDiBvxSUej,G8EPVSXsOYB5YQWZGiz1aVq5Pgr2GrQu,7,3,0,0,0,0,4,0,7,1.0,1,0.0,0,0,0,0,3,0,0,4,0,0,7,1
8458,188563,SiYxfRymwR9ZXmdv7LpkIYvuHNblUn46,bWdj2GDclj5ofokWjzoa5jAwMkxCykd6,2,0,0,0,0,0,2,0,2,0.2857142857142857,1,0.0,0,0,0,0,0,0,0,2,0,0,2,1
8459,188568,SiYxfRymwR9ZXmdv7LpkIYvuHNblUn46,RXDvfPUBYFlVdlueBFbLW0mhhAyGEqpt,1,0,0,0,0,0,1,0,1,0.14285714285714285,1,0.0,0,0,0,0,0,0,0,1,0,0,1,1
8460,188587,giGUAF5TXBP4oix75tUgV16Pg3alJM4Y,SpATywNh6bZuzm8s1ceuBUnMUAeoAHHw,1,0,0,0,0,0,1,0,1,0.14285714285714285,1,0.0,0,0,0,0,0,0,0,1,0,0,1,1
8461,188602,faupOzOQrYnrhUP3CZcXERH5hL8Q3xd2,bWdj2GDclj5ofokWjzoa5jAwMkxCykd6,8,6,2,32,1,3,3,0,47,6.714285714285714,2,0.0,1,2,31,1,5,3,1,3,0,35,12,1
8462,188639,sKKYS1ogqmOcjeYfYtZMxdkgoIt3cEVK,SpATywNh6bZuzm8s1ceuBUnMUAeoAHHw,18,15,7,0,7,0,4,0,33,4.714285714285714,1,0.0,0,7,0,7,15,0,0,4,0,14,19,1
8463,188952,tuXkXzLKLtIRrgeepCbs4ws8aCl66h43,7GRhBDsirIGkRZBtSMEzNTyDr2JQm4xx,34,119,36,50,30,53,17,1,306,43.714285714285715,1,0.0,69,36,39,30,50,53,11,17,1,174,132,1
8464,188957,UcAhBIdVZpMELDlnTcMm9mzDJ1F9Jhg3,7GRhBDsirIGkRZBtSMEzNTyDr2JQm4xx,1,0,0,0,0,0,1,0,1,0.14285714285714285,1,0.0,0,0,0,0,0,0,0,1,0,0,1,1
8465,188980,b9SN0Via9Qc1lw25HlIBgqllvaoVGqZR,7GRhBDsirIGkRZBtSMEzNTyDr2JQm4xx,1,0,0,0,0,0,1,0,1,0.14285714285714285,1,0.0,0,0,0,0,0,0,0,1,0,0,1,1
8466,188988,ljmWZCzWPqv1RXsn1q2wpsQtrnA1zct2,7GRhBDsirIGkRZBtSMEzNTyDr2JQm4xx,6,3,2,0,2,0,1,0,8,1.1428571428571428,1,0.0,0,2,0,2,3,0,0,1,0,4,4,1
8467,188998,kGchkvQPmF7DV3eBhLNc2GVWP2dYDeVK,7GRhBDsirIGkRZBtSMEzNTyDr2JQm4xx,4,2,1,0,1,0,1,0,5,0.7142857142857143,1,0.0,0,1,0,1,2,0,0,1,0,2,3,1
8468,189006,fOtwdZktYnpxoylqFRzXhWQ4IRQZkjMB,7GRhBDsirIGkRZBtSMEzNTyDr2JQm4xx,5,7,2,0,1,0,1,0,11,1.5714285714285714,1,0.0,0,2,0,1,7,0,0,1,0,3,8,1
8469,189008,6sr5fFi7rfC2NnnMJfyjbVZzoXpjJRhH,7GRhBDsirIGkRZBtSMEzNTyDr2JQm4xx,4,1,1,0,0,3,3,0,8,1.1428571428571428,1,0.0,0,1,0,0,1,3,0,3,0,1,7,1
8470,189027,Tb3iSIl4j6IIWQqGXGjvVBDqMgnRJLyl,7GRhBDsirIGkRZBtSMEzNTyDr2JQm4xx,5,7,1,0,2,0,1,0,11,1.5714285714285714,1,0.0,3,1,0,2,4,0,0,1,0,6,5,1
8471,189098,YX2r5oewraL6wIQ6yI9Js4hkHPlQTVjj,7GRhBDsirIGkRZBtSMEzNTyDr2JQm4xx,9,2,1,0,1,1,7,1,13,1.8571428571428572,1,0.0,0,1,0,1,2,1,0,7,1,2,11,1
8472,189104,NumNFW5RaIHDi6n0KLy5Cf1kLDxHgZZ0,G8EPVSXsOYB5YQWZGiz1aVq5Pgr2GrQu,6,4,1,0,0,0,2,0,7,1.0,1,0.0,0,1,0,0,4,0,0,2,0,1,6,1
8473,189107,krtZQqbvUpNsJjcNARYP8JsIRTz2QIeg,7GRhBDsirIGkRZBtSMEzNTyDr2JQm4xx,8,5,2,0,0,3,7,1,18,2.5714285714285716,1,0.0,0,2,0,0,5,3,0,7,1,2,16,1
8474,189109,ejIJpZTu0P4rcWcZmBKl6OiURGceVpiA,7GRhBDsirIGkRZBtSMEzNTyDr2JQm4xx,1,0,0,0,0,0,1,0,1,0.14285714285714285,1,0.0,0,0,0,0,0,0,0,1,0,0,1,1
8475,189110,sYKWdML3lybCcfZ8QzVXzUviXjVArLUH,7GRhBDsirIGkRZBtSMEzNTyDr2JQm4xx,2,0,0,0,0,0,2,0,2,0.2857142857142857,1,0.0,0,0,0,0,0,0,0,2,0,0,2,1
8476,189128,2wo3X72grgQzEbc3L58KSbNxJ33Bf4SU,7GRhBDsirIGkRZBtSMEzNTyDr2JQm4xx,4,2,1,0,1,0,1,0,5,0.7142857142857143,1,0.0,0,1,0,1,2,0,0,1,0,2,3,1
8477,189136,zNtPMkFrc8ewnZZhVeVhVYVOPd8vhwG9,7GRhBDsirIGkRZBtSMEzNTyDr2JQm4xx,13,15,3,34,1,10,6,0,69,9.857142857142858,1,0.0,8,3,26,1,7,10,8,6,0,38,31,1
8478,189162,o1LtNqe9OsdaahKJ5pz4qvaOsnGwGQzD,7GRhBDsirIGkRZBtSMEzNTyDr2JQm4xx,1,0,0,0,0,0,1,0,1,0.14285714285714285,1,0.0,0,0,0,0,0,0,0,1,0,0,1,1
8479,189203,ae9f7NnRGKtEuH4u37koNvJrDj4cou5c,7GRhBDsirIGkRZBtSMEzNTyDr2JQm4xx,13,24,0,0,3,0,9,0,36,5.142857142857143,1,0.0,10,0,0,3,14,0,0,9,0,13,23,1
8480,189221,8BLT2rbjNDvBkr2B6AQHpQ2yNooLf1CU,SpATywNh6bZuzm8s1ceuBUnMUAeoAHHw,12,22,13,18,0,2,3,0,58,8.285714285714286,1,0.0,5,13,15,0,17,2,3,3,0,33,25,1
8481,189324,RHO2J6AKDheXb2vKjeepgmCGgMG6BTYE,7GRhBDsirIGkRZBtSMEzNTyDr2JQm4xx,5,4,1,0,2,0,2,0,9,1.2857142857142858,1,0.0,2,1,0,2,2,0,0,2,0,5,4,1
8482,189353,iNXUknYcsccIKS8GgjuItiXxtSErv2BI,7GRhBDsirIGkRZBtSMEzNTyDr2JQm4xx,1,0,0,0,0,0,1,0,1,0.14285714285714285,1,0.0,0,0,0,0,0,0,0,1,0,0,1,1
8483,189395,aJzfntQTIfp35A305talVl9pd4o3Uf8u,7GRhBDsirIGkRZBtSMEzNTyDr2JQm4xx,1,0,0,0,0,0,1,0,1,0.14285714285714285,1,0.0,0,0,0,0,0,0,0,1,0,0,1,1
8484,189423,XE68NKSR0NgsUmxAP8OC135kqBLzzb9D,7GRhBDsirIGkRZBtSMEzNTyDr2JQm4xx,5,3,2,0,2,0,2,0,9,1.2857142857142858,1,0.0,0,2,0,2,3,0,0,2,0,4,5,1
8485,189429,UqksMVZ1lLvn2u7s6dT9SU5OFeNJnaAy,7GRhBDsirIGkRZBtSMEzNTyDr2JQm4xx,5,3,1,0,1,0,4,0,9,1.2857142857142858,1,0.0,0,1,0,1,3,0,0,4,0,2,7,1
8486,189463,8YAsQsQu6K1gQ9X3j9OO3pg6TTWyhygc,7GRhBDsirIGkRZBtSMEzNTyDr2JQm4xx,5,3,1,0,1,0,2,0,7,1.0,1,0.0,0,1,0,1,3,0,0,2,0,2,5,1
8487,189495,5O6gO2IHLbVMXXDwdapXEnrWY7rrDpQl,7GRhBDsirIGkRZBtSMEzNTyDr2JQm4xx,1,0,0,0,0,0,1,0,1,0.14285714285714285,1,0.0,0,0,0,0,0,0,0,1,0,0,1,1
8488,189513,W44EUSPSAj1fZWLor5hD25joUoQF1Axq,A3fsA9Zfv1X2fVEQhTw51lKENdNrEqT3,9,4,1,0,1,2,8,1,17,2.4285714285714284,1,0.0,0,1,0,1,4,2,0,8,1,2,15,1
8489,189554,7ZT5u11YEDTZhD4NZDPzOcLz6uLhq9Bd,7GRhBDsirIGkRZBtSMEzNTyDr2JQm4xx,1,0,0,0,0,0,1,0,1,0.14285714285714285,1,0.0,0,0,0,0,0,0,0,1,0,0,1,1
8490,189566,UIWPjpONY8VKQTSxeNrHquVi8SXHJ9tU,7GRhBDsirIGkRZBtSMEzNTyDr2JQm4xx,16,20,8,0,6,0,1,0,35,5.0,1,0.0,0,8,0,6,20,0,0,1,0,14,21,1
8491,189570,BRlaUe6oMRYCNox0BajKnWHes3A3ujyM,A3fsA9Zfv1X2fVEQhTw51lKENdNrEqT3,6,4,0,0,0,0,3,0,7,1.0,1,0.0,0,0,0,0,4,0,0,3,0,0,7,1
8492,189597,0vAWgNGUpLVRA2RW70tZzBBxiCN36t8Y,7GRhBDsirIGkRZBtSMEzNTyDr2JQm4xx,8,4,3,0,3,0,1,0,11,1.5714285714285714,1,0.0,0,3,0,3,4,0,0,1,0,6,5,1
8493,189636,JBk9P3H9SpNENMmKz8O8B3au3Kj5XKWF,7GRhBDsirIGkRZBtSMEzNTyDr2JQm4xx,1,0,0,0,0,0,1,0,1,0.14285714285714285,1,0.0,0,0,0,0,0,0,0,1,0,0,1,1
8494,189647,0a9LRwLYq2zam4NcdU9Yh5C7IQvHBC1m,A3fsA9Zfv1X2fVEQhTw51lKENdNrEqT3,1,0,0,0,0,0,1,0,1,0.14285714285714285,1,0.0,0,0,0,0,0,0,0,1,0,0,1,1
8495,189662,AykjJday1wTguij5gx88Emm7vsRmhjsn,7GRhBDsirIGkRZBtSMEzNTyDr2JQm4xx,1,0,0,0,0,0,1,0,1,0.14285714285714285,1,0.0,0,0,0,0,0,0,0,1,0,0,1,1
8496,189702,OyEvoRilpzFxIY7Xkwhpuz3t7yWiHYAD,7GRhBDsirIGkRZBtSMEzNTyDr2JQm4xx,1,0,0,0,0,0,1,0,1,0.14285714285714285,1,0.0,0,0,0,0,0,0,0,1,0,0,1,1
8497,189742,XtbEYUqZcMVM0EiUYCXC2IEORNMWz2mD,7GRhBDsirIGkRZBtSMEzNTyDr2JQm4xx,1,0,0,0,0,0,1,0,1,0.14285714285714285,1,0.0,0,0,0,0,0,0,0,1,0,0,1,1
8498,189788,DFDnEvNaTkvfy3RohV4MJVwGUkEZrUrx,7GRhBDsirIGkRZBtSMEzNTyDr2JQm4xx,2,0,0,0,0,0,2,0,2,0.2857142857142857,1,0.0,0,0,0,0,0,0,0,2,0,0,2,1
8499,189818,Y65j88wkyz5DKML6XOG6DUVrzLQhWfST,7GRhBDsirIGkRZBtSMEzNTyDr2JQm4xx,1,0,0,0,0,0,1,0,1,0.14285714285714285,1,0.0,0,0,0,0,0,0,0,1,0,0,1,1
8500,189830,cfto4CbYTItqNRa3py5uJG0bkzsfzUco,7GRhBDsirIGkRZBtSMEzNTyDr2JQm4xx,1,0,0,0,0,0,1,0,1,0.14285714285714285,1,0.0,0,0,0,0,0,0,0,1,0,0,1,1
8501,189869,mG2HKIW4KvK5MNtCekVvEvxXHT51PCPq,7GRhBDsirIGkRZBtSMEzNTyDr2JQm4xx,6,3,1,0,1,0,2,0,7,1.0,1,0.0,0,1,0,1,3,0,0,2,0,2,5,1
8502,190011,flCkd2hO7iQUUhaB3sp4v9WlXmzkKaLL,7GRhBDsirIGkRZBtSMEzNTyDr2JQm4xx,4,2,1,0,0,6,2,0,11,1.5714285714285714,1,0.0,0,1,0,0,2,6,0,2,0,1,10,1
8503,190081,iNidvGpmnGwj0TQ5PtdizeiguG8bztuW,7GRhBDsirIGkRZBtSMEzNTyDr2JQm4xx,10,10,6,0,5,0,3,0,24,3.4285714285714284,1,0.0,0,6,0,5,10,0,0,3,0,11,13,1
8504,190088,3SVVs5mG0aNsXrE6M2lNU1XqYm152qHm,7GRhBDsirIGkRZBtSMEzNTyDr2JQm4xx,3,2,1,0,0,0,1,0,4,0.5714285714285714,1,0.0,0,1,0,0,2,0,0,1,0,1,3,1
8505,190110,BohRHH2vBIgnEZGZjM3WnHwJbVFmITRG,7GRhBDsirIGkRZBtSMEzNTyDr2JQm4xx,1,0,0,0,0,0,1,0,1,0.14285714285714285,1,0.0,0,0,0,0,0,0,0,1,0,0,1,1
8506,190169,FaHW93yZCBwugzWZBbJAJZvMZt2lRMiJ,7GRhBDsirIGkRZBtSMEzNTyDr2JQm4xx,6,3,0,0,0,0,4,1,8,1.1428571428571428,1,0.0,1,0,0,0,2,0,0,4,1,1,7,1
8507,190190,p7LK5YIYyaPhnePVXdi7X5HGSzcJjL2r,7GRhBDsirIGkRZBtSMEzNTyDr2JQm4xx,1,0,0,0,0,0,1,0,1,0.14285714285714285,1,0.0,0,0,0,0,0,0,0,1,0,0,1,0
8508,190234,snhKj7MALyM2LCqV5sSwFpjNBeCB9QMT,7GRhBDsirIGkRZBtSMEzNTyDr2JQm4xx,4,1,0,0,1,0,2,0,4,0.5714285714285714,1,0.0,0,0,0,1,1,0,0,2,0,1,3,1
8509,190254,AA7aVbrpQJ2zUau6VJLFiC8rutvLHi1m,A3fsA9Zfv1X2fVEQhTw51lKENdNrEqT3,12,20,9,0,0,0,1,0,30,4.285714285714286,1,0.0,0,9,0,0,20,0,0,1,0,9,21,1
8510,190717,bKF5MosBqVKnYq47osSfpVQVg6H93E3y,SpATywNh6bZuzm8s1ceuBUnMUAeoAHHw,11,6,4,0,3,7,10,3,33,4.714285714285714,1,0.0,0,4,0,3,6,7,0,10,3,7,26,0
8511,190734,clv7wTDLUGVcdBnHuGK5igxvVYbUFhfO,A3fsA9Zfv1X2fVEQhTw51lKENdNrEqT3,1,0,0,0,0,0,1,0,1,0.14285714285714285,1,0.0,0,0,0,0,0,0,0,1,0,0,1,1
8512,190737,SqKmRlxZATrsBxFcgKwGzFSyWis0fRul,SpATywNh6bZuzm8s1ceuBUnMUAeoAHHw,12,8,5,0,3,2,6,1,25,3.5714285714285716,1,0.0,2,5,0,3,6,2,0,6,1,10,15,1
8513,190739,FFNnY7di7du4c5wFNDNV6nMH5bqqpuVS,G8EPVSXsOYB5YQWZGiz1aVq5Pgr2GrQu,16,5,5,28,3,1,4,0,46,6.571428571428571,1,0.0,0,5,24,3,5,1,4,4,0,32,14,1
8514,190747,cTeA1f2AYHCTzaLCFeSZpEjefvjGhNJD,G8EPVSXsOYB5YQWZGiz1aVq5Pgr2GrQu,8,8,3,0,2,0,2,0,15,2.142857142857143,1,0.0,3,3,0,2,5,0,0,2,0,8,7,1
8515,190756,wIcAqiIkhVke6PQk1FQ10LQjFUOa268K,bWdj2GDclj5ofokWjzoa5jAwMkxCykd6,1,0,0,0,0,0,1,0,1,0.14285714285714285,1,0.0,0,0,0,0,0,0,0,1,0,0,1,1
8516,190767,ErHRXoQE3PAKpLvIUT0gh504hJR8YxvQ,SpATywNh6bZuzm8s1ceuBUnMUAeoAHHw,1,0,0,0,0,0,1,0,1,0.14285714285714285,1,0.0,0,0,0,0,0,0,0,1,0,0,1,1
8517,190769,FZEwaAUaiR6zemazrUHMMvDLCgHez3sb,A3fsA9Zfv1X2fVEQhTw51lKENdNrEqT3,1,0,0,0,0,0,2,0,2,0.2857142857142857,1,0.0,0,0,0,0,0,0,0,2,0,0,2,1
8518,190774,xClBQDVnnmCO9u08LGuvxGj9xJyOTeqG,SpATywNh6bZuzm8s1ceuBUnMUAeoAHHw,6,3,1,0,1,0,2,0,7,1.0,1,0.0,0,1,0,1,3,0,0,2,0,2,5,1
8519,190775,uf9uxJ0q9fqnk8v2mIZk18f6DfpdKvW8,bWdj2GDclj5ofokWjzoa5jAwMkxCykd6,9,13,5,44,5,0,5,1,73,10.428571428571429,1,0.0,4,5,42,5,9,0,2,5,1,56,17,1
8520,190781,WgwvOVLxVR0cLBIPFfdMgIZsyrXu2dEM,RXDvfPUBYFlVdlueBFbLW0mhhAyGEqpt,10,6,1,0,1,1,11,7,27,3.857142857142857,1,0.0,0,1,0,1,6,1,0,11,7,2,25,1
8521,190794,jImHfNEIObE674KdIbKVj7cCJ4ufqzHJ,A3fsA9Zfv1X2fVEQhTw51lKENdNrEqT3,1,0,0,0,0,0,1,0,1,0.14285714285714285,1,0.0,0,0,0,0,0,0,0,1,0,0,1,1
8522,190795,cHDpTfio4QPhERzYfGBXzFYjVYPP50Cv,SpATywNh6bZuzm8s1ceuBUnMUAeoAHHw,7,5,3,0,2,0,4,0,14,2.0,1,0.0,0,3,0,2,5,0,0,4,0,5,9,1
8523,190797,pHifOW1icP08PuJhI8vGjqOw0aKfYcAe,bWdj2GDclj5ofokWjzoa5jAwMkxCykd6,15,11,6,60,4,6,8,1,96,13.714285714285714,1,0.0,2,6,53,4,9,6,7,8,1,65,31,1
8524,190807,UuSIoFbtQOfzMmWUxokidkbXgJFaHXwx,A3fsA9Zfv1X2fVEQhTw51lKENdNrEqT3,1,0,0,0,0,0,1,0,1,0.14285714285714285,1,0.0,0,0,0,0,0,0,0,1,0,0,1,0
8525,190808,wU9dwS3WWOQY9ZgttcIaOxUTFKpzQrwI,bWdj2GDclj5ofokWjzoa5jAwMkxCykd6,1,0,0,0,0,0,1,0,1,0.14285714285714285,1,0.0,0,0,0,0,0,0,0,1,0,0,1,0
8526,190809,hHLItJoAM7XEkMep3WUdcTboIWoYySm9,SpATywNh6bZuzm8s1ceuBUnMUAeoAHHw,7,5,0,0,0,4,6,1,16,2.2857142857142856,1,0.0,0,0,0,0,5,4,0,6,1,0,16,1
8527,190815,xnAaa3WYxuN7DFkNBugIG5RWGpSS1yS8,bWdj2GDclj5ofokWjzoa5jAwMkxCykd6,1,0,0,0,0,0,1,0,1,0.14285714285714285,1,0.0,0,0,0,0,0,0,0,1,0,0,1,1
8528,190818,uDXojcZmAjRrYpbHg6OiLrdKtE8isYPI,G8EPVSXsOYB5YQWZGiz1aVq5Pgr2GrQu,1,0,0,0,0,0,1,0,1,0.14285714285714285,1,0.0,0,0,0,0,0,0,0,1,0,0,1,1
8529,190822,8pF3cyLxq0AckySwkuwDRCVUkL6fkRLY,SpATywNh6bZuzm8s1ceuBUnMUAeoAHHw,6,2,0,0,0,0,9,0,11,1.5714285714285714,1,0.0,0,0,0,0,2,0,0,9,0,0,11,1
8530,190826,5ae8aSisBHmEo0mgVwdFagGGHfcfDsIo,G8EPVSXsOYB5YQWZGiz1aVq5Pgr2GrQu,1,0,0,0,0,0,1,0,1,0.14285714285714285,1,0.0,0,0,0,0,0,0,0,1,0,0,1,1
8531,190834,PUW0i4IuafllkJEtV0GCqmTDeLHkDmH3,SpATywNh6bZuzm8s1ceuBUnMUAeoAHHw,1,0,0,0,0,0,1,0,1,0.14285714285714285,1,0.0,0,0,0,0,0,0,0,1,0,0,1,1
8532,190852,5FKNtYsTkByroijTHxSZ2wThgqvXV2F5,SpATywNh6bZuzm8s1ceuBUnMUAeoAHHw,4,2,1,0,1,0,1,0,5,0.7142857142857143,1,0.0,0,1,0,1,2,0,0,1,0,2,3,1
8533,190861,HkcPmWCSdk3INCYsquWGQGZKijdTCD0w,A3fsA9Zfv1X2fVEQhTw51lKENdNrEqT3,1,0,0,0,0,0,1,0,1,0.14285714285714285,1,0.0,0,0,0,0,0,0,0,1,0,0,1,1
8534,190883,NtWIu4J0HPOWOANC7ZYns4tsHx1TBJoi,bWdj2GDclj5ofokWjzoa5jAwMkxCykd6,1,0,0,0,0,0,1,0,1,0.14285714285714285,1,0.0,0,0,0,0,0,0,0,1,0,0,1,1
8535,190889,9Yh9BGNzlB70iEC7VABYNXfepXjXz9Ik,RXDvfPUBYFlVdlueBFbLW0mhhAyGEqpt,1,0,0,0,0,0,1,0,1,0.14285714285714285,1,0.0,0,0,0,0,0,0,0,1,0,0,1,1
8536,190895,RJe7xu782OWYH4oamOQryIYQy1schp1L,SpATywNh6bZuzm8s1ceuBUnMUAeoAHHw,14,29,12,16,0,7,6,1,71,10.142857142857142,1,0.0,6,12,14,0,23,7,2,6,1,32,39,1
8537,190903,x71DJUx1l6jseHCehLwk4aITn2PbPyqZ,SpATywNh6bZuzm8s1ceuBUnMUAeoAHHw,5,2,1,0,1,0,2,0,6,0.8571428571428571,1,0.0,0,1,0,1,2,0,0,2,0,2,4,1
8538,190904,vyEmNT9CTTZs1s1eotM7mTmxUqBkMZB7,A3fsA9Zfv1X2fVEQhTw51lKENdNrEqT3,1,0,0,0,0,0,1,0,1,0.14285714285714285,1,0.0,0,0,0,0,0,0,0,1,0,0,1,1
8539,190917,KK8c9Dmj5I63bhg4LxlQHTWu5jCGLVNt,G8EPVSXsOYB5YQWZGiz1aVq5Pgr2GrQu,1,0,0,0,0,0,1,0,1,0.14285714285714285,1,0.0,0,0,0,0,0,0,0,1,0,0,1,1
8540,190947,ok4VFpKhZuAEe6hS0zrBXKoNseBmFZze,SpATywNh6bZuzm8s1ceuBUnMUAeoAHHw,14,22,2,25,0,2,9,1,61,8.714285714285714,2,0.0,4,2,22,0,18,2,3,9,1,28,33,1
8541,190954,WsLtEmeFmoC69MkLWoUcJ9ig36NGyKM9,SpATywNh6bZuzm8s1ceuBUnMUAeoAHHw,6,3,1,0,1,0,2,0,7,1.0,1,0.0,0,1,0,1,3,0,0,2,0,2,5,1
8542,190958,2xUoAPKuvFamkqgtuAisQsHAYFznYGmc,RXDvfPUBYFlVdlueBFbLW0mhhAyGEqpt,21,22,5,31,10,0,4,0,72,10.285714285714286,2,0.0,15,5,28,10,7,0,3,4,0,58,14,0
8543,190967,FENPBJBmeLAdvUkUsPg7akiTSdA52zTP,SpATywNh6bZuzm8s1ceuBUnMUAeoAHHw,7,6,2,0,1,0,3,0,12,1.7142857142857142,1,0.0,1,2,0,1,5,0,0,3,0,4,8,1
8544,190972,iACYFngARHwRlBD1uz8Bwi5b1szxFkra,SpATywNh6bZuzm8s1ceuBUnMUAeoAHHw,8,29,1,0,1,0,5,0,36,5.142857142857143,1,0.0,2,1,0,1,27,0,0,5,0,4,32,1
8545,190977,oaoj9be4jW2Hot8wYgYrzLRvB0RU4KYy,bWdj2GDclj5ofokWjzoa5jAwMkxCykd6,3,2,1,0,0,0,1,0,4,0.5714285714285714,1,0.0,0,1,0,0,2,0,0,1,0,1,3,1
8546,190991,M7fcRt21bsAgtvsrrzEizQkpE9mFW4i5,G8EPVSXsOYB5YQWZGiz1aVq5Pgr2GrQu,1,0,0,0,0,0,2,0,2,0.2857142857142857,1,0.0,0,0,0,0,0,0,0,2,0,0,2,1
8547,191001,nT8w17cJcdO2lsrz7cGSY123lCPnSOcs,SpATywNh6bZuzm8s1ceuBUnMUAeoAHHw,11,11,0,19,0,2,5,2,39,5.571428571428571,1,0.0,4,0,17,0,7,2,2,5,2,21,18,1
8548,191008,HQaEPrkmOsZZRI0w0Zd2GpWW5QsOPUNb,RXDvfPUBYFlVdlueBFbLW0mhhAyGEqpt,7,7,1,0,1,0,5,0,14,2.0,1,0.0,0,1,0,1,7,0,0,5,0,2,12,1
8549,191076,kLjseYEqrk7qJRpdsFaZefvj0uwqDQlm,SpATywNh6bZuzm8s1ceuBUnMUAeoAHHw,1,0,0,0,0,0,1,0,1,0.14285714285714285,1,0.0,0,0,0,0,0,0,0,1,0,0,1,1
8550,191092,arrrU4WiLIpECIetBxOM4AIL8R5yPrJI,SpATywNh6bZuzm8s1ceuBUnMUAeoAHHw,3,0,0,0,0,0,3,0,3,0.42857142857142855,1,0.0,0,0,0,0,0,0,0,3,0,0,3,1
8551,191108,geEAXwfPbJ0MhEZG0COad1UptHNAilTd,A3fsA9Zfv1X2fVEQhTw51lKENdNrEqT3,1,0,0,0,0,0,1,0,1,0.14285714285714285,1,0.0,0,0,0,0,0,0,0,1,0,0,1,1
8552,191177,cd5GtUhUnzyOzoyRaUudZZpk7s0Fqqr1,SpATywNh6bZuzm8s1ceuBUnMUAeoAHHw,2,0,0,0,0,0,2,0,2,0.2857142857142857,1,0.0,0,0,0,0,0,0,0,2,0,0,2,1
8553,191193,5isrCsGh9CKWlpcsbDYSNSmskNZ5RJjk,A3fsA9Zfv1X2fVEQhTw51lKENdNrEqT3,1,0,0,0,0,0,1,0,1,0.14285714285714285,1,0.0,0,0,0,0,0,0,0,1,0,0,1,1
8554,191204,p8HUn53OHQxlBbPvpqicSSSkhMnoLuUk,SpATywNh6bZuzm8s1ceuBUnMUAeoAHHw,1,0,0,0,0,0,1,0,1,0.14285714285714285,1,0.0,0,0,0,0,0,0,0,1,0,0,1,1
8555,191228,kMzMJEHy7fAHiNUZU0um3I2BsPC7gMll,RXDvfPUBYFlVdlueBFbLW0mhhAyGEqpt,1,0,0,0,0,0,1,0,1,0.14285714285714285,1,0.0,0,0,0,0,0,0,0,1,0,0,1,1
8556,191255,2WxDTXrRtDNHrqbb0X9iRKeiD9MDTDVK,SpATywNh6bZuzm8s1ceuBUnMUAeoAHHw,9,25,9,0,0,1,7,0,42,6.0,1,0.0,12,9,0,0,13,1,0,7,0,21,21,1
8557,191284,WgQR6nrfyl7yDpgHC595JSoog2R9VhVs,A3fsA9Zfv1X2fVEQhTw51lKENdNrEqT3,1,0,0,0,0,0,1,0,1,0.14285714285714285,1,0.0,0,0,0,0,0,0,0,1,0,0,1,1
8558,191309,V2MW5TTOl8erA9KB40i6ShoB0MXn3LUC,SpATywNh6bZuzm8s1ceuBUnMUAeoAHHw,5,2,1,0,1,0,4,0,8,1.1428571428571428,1,0.0,0,1,0,1,2,0,0,4,0,2,6,1
8559,191314,GRgjzx7VHY5z0cMezCfvrpSTKqpE3kNZ,SpATywNh6bZuzm8s1ceuBUnMUAeoAHHw,6,5,2,0,2,0,1,0,10,1.4285714285714286,1,0.0,0,2,0,2,5,0,0,1,0,4,6,1
8560,191320,SFvWBN0LUhWN6O8eK5tB1YryzhojhfkD,SpATywNh6bZuzm8s1ceuBUnMUAeoAHHw,1,0,0,0,0,0,1,0,1,0.14285714285714285,1,0.0,0,0,0,0,0,0,0,1,0,0,1,1
8561,191334,iwS4gRr8dUdengK5x37B93sG4oePIfDx,SpATywNh6bZuzm8s1ceuBUnMUAeoAHHw,1,0,0,0,0,0,1,0,1,0.14285714285714285,1,0.0,0,0,0,0,0,0,0,1,0,0,1,1
8562,191346,p6TgFJdLQMaMzbR16kycIPcRPnBj3paK,bWdj2GDclj5ofokWjzoa5jAwMkxCykd6,4,5,1,0,0,0,3,0,9,1.2857142857142858,1,0.0,0,1,0,0,5,0,0,3,0,1,8,1
8563,191365,v0iISMadlSfH1jVtRvOUuiYm96jA1BgF,SpATywNh6bZuzm8s1ceuBUnMUAeoAHHw,3,2,0,0,0,0,1,0,3,0.42857142857142855,1,0.0,0,0,0,0,2,0,0,1,0,0,3,1
8564,191390,T6EWQ7jVP89JlHzj41KN1gEtGYevpSQM,RXDvfPUBYFlVdlueBFbLW0mhhAyGEqpt,1,0,0,0,0,0,1,0,1,0.14285714285714285,1,0.0,0,0,0,0,0,0,0,1,0,0,1,1
8565,191396,kFbAoBQLoBy3cufqfKmpAxdN84jZuyGv,SpATywNh6bZuzm8s1ceuBUnMUAeoAHHw,1,0,0,0,0,0,1,0,1,0.14285714285714285,1,0.0,0,0,0,0,0,0,0,1,0,0,1,1
8566,191399,RknKWTR2QlcaofxNlEIJO86tIh9EMpGt,SpATywNh6bZuzm8s1ceuBUnMUAeoAHHw,6,8,3,0,2,0,2,0,15,2.142857142857143,1,0.0,0,3,0,2,8,0,0,2,0,5,10,1
8567,191400,oB66Su2y0fKCmlftIiys81THD7pT5Kwq,SpATywNh6bZuzm8s1ceuBUnMUAeoAHHw,3,2,0,0,0,0,2,0,4,0.5714285714285714,1,0.0,0,0,0,0,2,0,0,2,0,0,4,1
8568,191418,cBqC4wQ0uum34JxjmDvje145C1HEdpV7,A3fsA9Zfv1X2fVEQhTw51lKENdNrEqT3,1,0,0,0,0,0,1,0,1,0.14285714285714285,1,0.0,0,0,0,0,0,0,0,1,0,0,1,1
8569,191426,if3F5GyFS3tLy1wJ6MlpPAYmdoRWmS4a,G8EPVSXsOYB5YQWZGiz1aVq5Pgr2GrQu,15,9,8,24,6,0,2,0,49,7.0,1,0.0,0,8,19,6,9,0,5,2,0,33,16,1
8570,191428,0g874SF3SMbHGyq5A3NVcdw5ZagrIMLX,A3fsA9Zfv1X2fVEQhTw51lKENdNrEqT3,1,0,0,0,0,0,1,0,1,0.14285714285714285,1,0.0,0,0,0,0,0,0,0,1,0,0,1,1
8571,191439,7k95jHpTPudDL0r9ern1lqZsX7khTblO,SpATywNh6bZuzm8s1ceuBUnMUAeoAHHw,10,3,2,0,2,4,8,2,21,3.0,1,0.0,0,2,0,2,3,4,0,8,2,4,17,1
8572,191470,WmysxkCsgnQj3BaPOZ0U0HkLBTddwtEo,RXDvfPUBYFlVdlueBFbLW0mhhAyGEqpt,18,8,4,15,3,8,10,4,52,7.428571428571429,1,0.0,3,4,15,3,5,8,0,10,4,25,27,1
8573,191474,URsMDmBXxCzQPD8yy0pnaAiUOwpb4Aof,G8EPVSXsOYB5YQWZGiz1aVq5Pgr2GrQu,1,0,0,0,0,0,1,0,1,0.14285714285714285,1,0.0,0,0,0,0,0,0,0,1,0,0,1,1
8574,191485,XFJ68m78eqRR6RTXtGyyLhWYKyJpG8am,SpATywNh6bZuzm8s1ceuBUnMUAeoAHHw,13,20,7,28,3,3,6,0,67,9.571428571428571,1,0.0,7,7,24,3,13,3,4,6,0,41,26,1
8575,191503,wuaIkUodYTr49NZ7BbMPsEdpO0t0C8Nt,bWdj2GDclj5ofokWjzoa5jAwMkxCykd6,1,0,0,0,0,0,1,0,1,0.14285714285714285,1,0.0,0,0,0,0,0,0,0,1,0,0,1,0
8576,191513,8Hc0b25bgfH6lNfQjbdydA9Vr0ij1wAo,RXDvfPUBYFlVdlueBFbLW0mhhAyGEqpt,6,3,2,0,1,0,2,0,8,1.1428571428571428,1,0.0,0,2,0,1,3,0,0,2,0,3,5,1
8577,191520,aQZ3ue6sZAjGbF4xHc1nd423AeIpShr7,SpATywNh6bZuzm8s1ceuBUnMUAeoAHHw,6,1,1,0,0,7,7,2,18,2.5714285714285716,1,0.0,0,1,0,0,1,7,0,7,2,1,17,1
8578,191555,xJg5Rk4cV40ktI4XCqJwerPySa8KdDum,SpATywNh6bZuzm8s1ceuBUnMUAeoAHHw,4,2,0,0,0,0,5,0,7,1.0,1,0.0,0,0,0,0,2,0,0,5,0,0,7,1
8579,191557,H7bZ54NuzkB5Nw5q0ZI1nld9qDoHNngL,RXDvfPUBYFlVdlueBFbLW0mhhAyGEqpt,7,3,2,0,2,0,2,0,9,1.2857142857142858,1,0.0,0,2,0,2,3,0,0,2,0,4,5,0
8580,191558,bxybXAkYqJdxWDLSPlh74sjGoIJub8gI,A3fsA9Zfv1X2fVEQhTw51lKENdNrEqT3,1,0,0,0,0,0,1,0,1,0.14285714285714285,1,0.0,0,0,0,0,0,0,0,1,0,0,1,1
8581,191566,dPo2apv0Dzwh69Z1mYMogRvND7Zqb5Dp,SpATywNh6bZuzm8s1ceuBUnMUAeoAHHw,1,0,0,0,0,0,1,0,1,0.14285714285714285,1,0.0,0,0,0,0,0,0,0,1,0,0,1,1
8582,191595,6VqcRtEStIFn65gZeMiEFRDlkNKCPpuX,SpATywNh6bZuzm8s1ceuBUnMUAeoAHHw,1,0,0,0,0,0,1,0,1,0.14285714285714285,1,0.0,0,0,0,0,0,0,0,1,0,0,1,1
8583,191600,6hpnm3HPpj7kwmlYcJCdnCjcQP3bgA8P,SpATywNh6bZuzm8s1ceuBUnMUAeoAHHw,1,0,0,0,0,0,1,0,1,0.14285714285714285,1,0.0,0,0,0,0,0,0,0,1,0,0,1,1
8584,191609,VRZ45dbdEaezkrEYnjvv0A7uj4TRC509,RXDvfPUBYFlVdlueBFbLW0mhhAyGEqpt,1,0,0,0,0,0,2,0,2,0.2857142857142857,1,0.0,0,0,0,0,0,0,0,2,0,0,2,1
8585,191619,WlHV3frRLxQmTIY14HccRXj4N1zg8F2y,A3fsA9Zfv1X2fVEQhTw51lKENdNrEqT3,1,0,0,0,0,0,1,0,1,0.14285714285714285,1,0.0,0,0,0,0,0,0,0,1,0,0,1,1
8586,191625,WlHV3frRLxQmTIY14HccRXj4N1zg8F2y,SpATywNh6bZuzm8s1ceuBUnMUAeoAHHw,1,0,0,0,0,0,1,0,1,0.14285714285714285,1,0.0,0,0,0,0,0,0,0,1,0,0,1,1
8587,191629,XdXU1POVy8aDaqRsnREruSsMPvgxWetA,A3fsA9Zfv1X2fVEQhTw51lKENdNrEqT3,1,0,0,0,0,0,1,0,1,0.14285714285714285,1,0.0,0,0,0,0,0,0,0,1,0,0,1,0
8588,191655,p04QzukP32kpPk8EGoBhDUGJJQqJUoNz,G8EPVSXsOYB5YQWZGiz1aVq5Pgr2GrQu,1,0,0,0,0,0,2,0,2,0.2857142857142857,1,0.0,0,0,0,0,0,0,0,2,0,0,2,1
8589,191678,vWQfaR79jDjjXdq7DWLb4Yep3Hqk0KZU,SpATywNh6bZuzm8s1ceuBUnMUAeoAHHw,1,0,0,0,0,0,1,0,1,0.14285714285714285,1,0.0,0,0,0,0,0,0,0,1,0,0,1,1
8590,191692,KNNMSW3oLxGqEqv2czanNkhQgdUkOWgY,RXDvfPUBYFlVdlueBFbLW0mhhAyGEqpt,7,6,4,0,1,0,2,0,13,1.8571428571428572,1,0.0,0,4,0,1,6,0,0,2,0,5,8,0
8591,191725,OnbafhawH0rPSL0N5ij1JID10mYyXSki,RXDvfPUBYFlVdlueBFbLW0mhhAyGEqpt,15,23,1,14,1,1,4,0,44,6.285714285714286,1,0.0,3,1,12,1,20,1,2,4,0,17,27,1
8592,191729,N7U6b4ydC4LyBj5GQ1EeCbwlZ2DqZbJ6,bWdj2GDclj5ofokWjzoa5jAwMkxCykd6,5,4,1,0,1,0,4,0,10,1.4285714285714286,1,0.0,0,1,0,1,4,0,0,4,0,2,8,1
8593,191733,dZqFLbQhzRGv0XrnoR6Btyn7eZPLWNcs,G8EPVSXsOYB5YQWZGiz1aVq5Pgr2GrQu,5,3,1,0,1,0,1,0,6,0.8571428571428571,1,0.0,0,1,0,1,3,0,0,1,0,2,4,1
8594,191735,qwG1GCNkwhgE1heJRoYjfA2CYeRyFFBD,SpATywNh6bZuzm8s1ceuBUnMUAeoAHHw,5,2,1,0,1,0,2,0,6,0.8571428571428571,1,0.0,0,1,0,1,2,0,0,2,0,2,4,1
8595,191740,0A6FjHxqeczBpR079Zm0ynsuWpteOCkO,A3fsA9Zfv1X2fVEQhTw51lKENdNrEqT3,1,0,0,0,0,0,1,0,1,0.14285714285714285,1,0.0,0,0,0,0,0,0,0,1,0,0,1,1
8596,191744,ifBHT3U3Q2vZ9dQs2fpRYsiXqMAEWHBB,SpATywNh6bZuzm8s1ceuBUnMUAeoAHHw,1,0,0,0,0,0,1,0,1,0.14285714285714285,1,0.0,0,0,0,0,0,0,0,1,0,0,1,1
8597,191751,inFcOljKYTbAioEZelr7FOpytUh6Wwwm,A3fsA9Zfv1X2fVEQhTw51lKENdNrEqT3,1,0,0,0,0,0,2,0,2,0.2857142857142857,1,0.0,0,0,0,0,0,0,0,2,0,0,2,1
8598,191755,BgRqBvDqiEwBpSmGhgFl2BztVgNMTQzO,SpATywNh6bZuzm8s1ceuBUnMUAeoAHHw,5,5,1,2,0,0,1,0,9,1.2857142857142858,1,0.0,1,1,2,0,4,0,0,1,0,4,5,1
8599,191758,RpI9z3V0AgaYDbaVWpv7K8qBLot9xbZ1,SpATywNh6bZuzm8s1ceuBUnMUAeoAHHw,2,0,0,0,0,2,1,0,3,0.42857142857142855,1,0.0,0,0,0,0,0,2,0,1,0,0,3,1
8600,191784,yPgZKtTbqfPKTL2LU9Q3PsQCk4gWnK9n,bWdj2GDclj5ofokWjzoa5jAwMkxCykd6,2,0,0,0,0,0,2,0,2,0.2857142857142857,1,0.0,0,0,0,0,0,0,0,2,0,0,2,1
8601,191792,kmiB7WIX79F3dncKlftv8WHURaepCY2a,G8EPVSXsOYB5YQWZGiz1aVq5Pgr2GrQu,5,3,1,0,1,0,1,0,6,0.8571428571428571,1,0.0,0,1,0,1,3,0,0,1,0,2,4,1
8602,191795,I4TQ7Q1utfRs4sHagyenl8ox4pkFBHHE,bWdj2GDclj5ofokWjzoa5jAwMkxCykd6,2,0,0,0,0,0,2,0,2,0.2857142857142857,1,0.0,0,0,0,0,0,0,0,2,0,0,2,1
8603,191796,HsUrz2Tvq8sRzoPDsx1zZZFVKu21a9Fj,bWdj2GDclj5ofokWjzoa5jAwMkxCykd6,1,0,0,0,0,0,1,0,1,0.14285714285714285,1,0.0,0,0,0,0,0,0,0,1,0,0,1,1
8604,191809,RkMMgfrDoCy0k6xciXBqfQqum2o9XEow,A3fsA9Zfv1X2fVEQhTw51lKENdNrEqT3,1,0,0,0,0,0,1,0,1,0.14285714285714285,1,0.0,0,0,0,0,0,0,0,1,0,0,1,1
8605,191820,GPXoKOYBnmTprrhcUmupBdNFpJRyodal,G8EPVSXsOYB5YQWZGiz1aVq5Pgr2GrQu,8,7,2,0,2,0,4,0,15,2.142857142857143,1,0.0,4,2,0,2,3,0,0,4,0,8,7,1
8606,191826,apfvYM10NU1k5W582bvs0kUbUD2jx0Pf,SpATywNh6bZuzm8s1ceuBUnMUAeoAHHw,1,0,0,0,0,0,2,0,2,0.2857142857142857,1,0.0,0,0,0,0,0,0,0,2,0,0,2,1
8607,191827,hMmMWG2mCSPmBVJCfg0hTnXWgrWTXDtT,bWdj2GDclj5ofokWjzoa5jAwMkxCykd6,1,0,0,0,0,0,1,0,1,0.14285714285714285,1,0.0,0,0,0,0,0,0,0,1,0,0,1,1
8608,191837,Fq5B003Bt4YEeqhrth8SMHf096RbzYAO,SpATywNh6bZuzm8s1ceuBUnMUAeoAHHw,16,16,4,16,3,0,6,1,46,6.571428571428571,1,0.0,11,4,14,3,5,0,2,6,1,32,14,1
8609,191840,bR8wdPBdFHSsMQ5cBBQOeSecEHoEdU3R,SpATywNh6bZuzm8s1ceuBUnMUAeoAHHw,1,0,0,0,0,0,1,0,1,0.14285714285714285,1,0.0,0,0,0,0,0,0,0,1,0,0,1,1
8610,191850,eRPwUTqaIsUryY9jPBGa7k7RWRZnrrvU,A3fsA9Zfv1X2fVEQhTw51lKENdNrEqT3,1,0,0,0,0,0,1,0,1,0.14285714285714285,1,0.0,0,0,0,0,0,0,0,1,0,0,1,1
8611,191861,AdLAJ2czvUY9AyeUk5B4rn58TrqeeWxO,RXDvfPUBYFlVdlueBFbLW0mhhAyGEqpt,1,0,0,0,0,0,1,0,1,0.14285714285714285,1,0.0,0,0,0,0,0,0,0,1,0,0,1,1
8612,191865,XVfEU97madT1zlAJ4ceeVrr8RhA7IGa2,SpATywNh6bZuzm8s1ceuBUnMUAeoAHHw,5,3,1,0,1,0,1,0,6,0.8571428571428571,1,0.0,0,1,0,1,3,0,0,1,0,2,4,1
8613,191889,kvp7nv1Fk7hbG5ZfWGkJtc8xaumUx9u9,bWdj2GDclj5ofokWjzoa5jAwMkxCykd6,5,6,1,0,2,0,2,0,11,1.5714285714285714,1,0.0,2,1,0,2,4,0,0,2,0,5,6,1
8614,191891,lej2dE7o05DOz003uw82zCNwZA2EHApG,SpATywNh6bZuzm8s1ceuBUnMUAeoAHHw,6,0,0,0,0,1,12,1,14,2.0,1,0.0,0,0,0,0,0,1,0,12,1,0,14,1
8615,191926,3h1FKqVdnDmZ3yTfOEvfGnfVX1CtMfQe,SpATywNh6bZuzm8s1ceuBUnMUAeoAHHw,4,2,1,0,1,0,1,0,5,0.7142857142857143,1,0.0,0,1,0,1,2,0,0,1,0,2,3,1
8616,191941,P7vHBcOeIbOXFo3TPWP2lDcTM83EhGeU,bWdj2GDclj5ofokWjzoa5jAwMkxCykd6,1,0,0,0,0,0,4,0,4,0.5714285714285714,1,0.0,0,0,0,0,0,0,0,4,0,0,4,1
8617,191955,BoMnQ757r2rWyLplEG42Z5wOai4BClQl,SpATywNh6bZuzm8s1ceuBUnMUAeoAHHw,5,2,1,0,1,0,2,0,6,0.8571428571428571,1,0.0,0,1,0,1,2,0,0,2,0,2,4,1
8618,191956,Rb4RoMnOmkTH16vQxR6FJxXkteFqMsSl,SpATywNh6bZuzm8s1ceuBUnMUAeoAHHw,5,2,1,0,1,0,3,0,7,1.0,1,0.0,0,1,0,1,2,0,0,3,0,2,5,1
8619,191985,IN6qMq7COdhsPUWIeIwbfkPbP9c7KKGp,A3fsA9Zfv1X2fVEQhTw51lKENdNrEqT3,1,0,0,0,0,0,1,0,1,0.14285714285714285,1,0.0,0,0,0,0,0,0,0,1,0,0,1,1
8620,191989,WFLWEfQrQsuFMQB4h1DfinKxHOxaJgRw,SpATywNh6bZuzm8s1ceuBUnMUAeoAHHw,1,0,0,0,0,0,1,0,1,0.14285714285714285,1,0.0,0,0,0,0,0,0,0,1,0,0,1,1
8621,192026,Efh1AOucFRD20ZMCFA52VPOCblceahzE,SpATywNh6bZuzm8s1ceuBUnMUAeoAHHw,13,25,12,23,7,0,4,0,71,10.142857142857142,1,0.0,10,12,19,7,15,0,4,4,0,48,23,1
8622,192041,XMT1fxCKn20PfgVrzu92ZEp8ge6Hh1C8,SpATywNh6bZuzm8s1ceuBUnMUAeoAHHw,1,0,0,0,0,0,2,0,2,0.2857142857142857,1,0.0,0,0,0,0,0,0,0,2,0,0,2,1
8623,192045,dMRYTOUYlQ9p1SCjA1w6Lggb6GRAcl7F,SpATywNh6bZuzm8s1ceuBUnMUAeoAHHw,1,0,0,0,0,0,2,0,2,0.2857142857142857,1,0.0,0,0,0,0,0,0,0,2,0,0,2,1
8624,192054,AFTEQHbalt54u0CSOEb5Gff5gtuUeG8b,SpATywNh6bZuzm8s1ceuBUnMUAeoAHHw,6,2,1,0,1,0,3,0,7,1.0,1,0.0,0,1,0,1,2,0,0,3,0,2,5,1
8625,192061,uTVTksRdwbB07oR2uLGlNMnBpRxCQAXg,SpATywNh6bZuzm8s1ceuBUnMUAeoAHHw,3,5,1,0,0,0,1,0,7,1.0,1,0.0,0,1,0,0,5,0,0,1,0,1,6,1
8626,192077,vsDIa2pTzMsANsuFnkRlfs0CNdNFRShO,A3fsA9Zfv1X2fVEQhTw51lKENdNrEqT3,1,0,0,0,0,0,1,0,1,0.14285714285714285,1,0.0,0,0,0,0,0,0,0,1,0,0,1,1
8627,192094,1JKF7DnCOdaXTBELvpKByyY2uKECcREV,A3fsA9Zfv1X2fVEQhTw51lKENdNrEqT3,1,0,0,0,0,0,1,0,1,0.14285714285714285,1,0.0,0,0,0,0,0,0,0,1,0,0,1,1
8628,192104,Dk2p6h1MYjykCuVHQMak8GN098n0FvGH,SpATywNh6bZuzm8s1ceuBUnMUAeoAHHw,10,13,3,10,0,2,3,0,31,4.428571428571429,1,0.0,2,3,8,0,11,2,2,3,0,13,18,1
8629,192115,ROeS4r0zXNXDfvEicSssoPyhkNCzHO0O,SpATywNh6bZuzm8s1ceuBUnMUAeoAHHw,6,3,2,0,2,0,5,0,12,1.7142857142857142,1,0.0,0,2,0,2,3,0,0,5,0,4,8,1
8630,192133,ItSWWp12ZmgzUSMzIbnzpzxw5V6GCE6O,SpATywNh6bZuzm8s1ceuBUnMUAeoAHHw,8,2,1,0,1,2,4,2,12,1.7142857142857142,1,0.0,0,1,0,1,2,2,0,4,2,2,10,1
8631,192137,VYiSBPiiJFjQtdS8d7Gp4hibwyjeIeC0,G8EPVSXsOYB5YQWZGiz1aVq5Pgr2GrQu,9,2,0,0,0,1,14,2,19,2.7142857142857144,1,0.0,0,0,0,0,2,1,0,14,2,0,19,1
8632,192146,luNGlNTmJ26UVXohAPNf4yZNgIUDcpxK,G8EPVSXsOYB5YQWZGiz1aVq5Pgr2GrQu,1,0,0,0,0,0,1,0,1,0.14285714285714285,1,0.0,0,0,0,0,0,0,0,1,0,0,1,1
8633,192154,D0xF5k3pRFZOFsh7BuEa1nD61TTGPmxo,SpATywNh6bZuzm8s1ceuBUnMUAeoAHHw,6,4,2,0,1,2,4,0,13,1.8571428571428572,2,0.0,0,2,0,1,4,2,0,4,0,3,10,1
8634,192163,12jrpDfrACe14hfSyU7dlcaDb6lV0AX7,SpATywNh6bZuzm8s1ceuBUnMUAeoAHHw,6,3,1,0,1,0,2,0,7,1.0,1,0.0,0,1,0,1,3,0,0,2,0,2,5,1
8635,192173,ezgBG4pn9egd5PGuIQdeghPmBuYsQq9O,bWdj2GDclj5ofokWjzoa5jAwMkxCykd6,2,0,0,0,0,0,3,0,3,0.42857142857142855,1,0.0,0,0,0,0,0,0,0,3,0,0,3,1
8636,192174,gdWcAsoLOdR54U3HxoDgKlKnKUBV7xCX,G8EPVSXsOYB5YQWZGiz1aVq5Pgr2GrQu,5,7,2,0,2,0,2,0,13,1.8571428571428572,1,0.0,2,2,0,2,5,0,0,2,0,6,7,1
8637,192180,3bqYNHEttQnrSXCOjNHPi8cuvQEsNCSU,SpATywNh6bZuzm8s1ceuBUnMUAeoAHHw,16,17,9,17,7,4,6,1,61,8.714285714285714,2,0.0,4,9,14,7,13,4,3,6,1,34,27,1
8638,192182,Zn2WcWGw1Iq8LSMueWFynbJxp3D9ATzp,bWdj2GDclj5ofokWjzoa5jAwMkxCykd6,6,3,2,0,2,0,1,0,8,1.1428571428571428,1,0.0,0,2,0,2,3,0,0,1,0,4,4,1
8639,192202,4WRiJt7yDLRdAnLXyL07imUb9PD066er,G8EPVSXsOYB5YQWZGiz1aVq5Pgr2GrQu,10,3,2,0,2,0,8,2,17,2.4285714285714284,2,0.0,0,2,0,2,3,0,0,8,2,4,13,1
8640,192212,FCG6YWuKaaz2zD1Uj2uT7JnTQhXHO8IA,SpATywNh6bZuzm8s1ceuBUnMUAeoAHHw,7,12,1,0,1,0,3,0,17,2.4285714285714284,1,0.0,0,1,0,1,12,0,0,3,0,2,15,1
8641,192235,fB1Ln4rTpVlSNSwZArMTX9xX5MOVzyer,SpATywNh6bZuzm8s1ceuBUnMUAeoAHHw,7,3,2,0,2,0,3,0,10,1.4285714285714286,1,0.0,0,2,0,2,3,0,0,3,0,4,6,1
8642,192244,43uMTKmmKD0ZGUfjI6gHffJ1F3eBB7HV,SpATywNh6bZuzm8s1ceuBUnMUAeoAHHw,12,10,5,11,3,0,2,0,31,4.428571428571429,1,0.0,3,5,10,3,7,0,1,2,0,21,10,1
8643,192255,NqQoXS07qNtJAkIAmOpEhw2wLcRnmrrU,SpATywNh6bZuzm8s1ceuBUnMUAeoAHHw,4,3,1,0,0,0,1,0,5,0.7142857142857143,1,0.0,0,1,0,0,3,0,0,1,0,1,4,1
8644,192264,WnUfGeFilK9N1GtlbmsLVr7aEjsrhuHu,SpATywNh6bZuzm8s1ceuBUnMUAeoAHHw,5,3,1,0,1,0,2,0,7,1.0,1,0.0,0,1,0,1,3,0,0,2,0,2,5,1
8645,192277,MExPU9M982R5ikM7jDJpvEjyfJ2HFRXK,G8EPVSXsOYB5YQWZGiz1aVq5Pgr2GrQu,1,0,0,0,0,0,2,0,2,0.2857142857142857,1,0.0,0,0,0,0,0,0,0,2,0,0,2,1
8646,192288,8ZHyO9qRnMfYwp3tP7QulKpzu10sbQSr,A3fsA9Zfv1X2fVEQhTw51lKENdNrEqT3,1,0,0,0,0,0,1,0,1,0.14285714285714285,1,0.0,0,0,0,0,0,0,0,1,0,0,1,1
8647,192289,a7ccLvSmzFTDxQ153X5LPl9qw8dtjwJS,bWdj2GDclj5ofokWjzoa5jAwMkxCykd6,1,0,0,0,0,0,1,0,1,0.14285714285714285,1,0.0,0,0,0,0,0,0,0,1,0,0,1,1
8648,192291,u5ObOMoHUcvVsOQTGkiv0BRKKcn8v2w8,SpATywNh6bZuzm8s1ceuBUnMUAeoAHHw,5,5,4,0,2,0,1,0,12,1.7142857142857142,1,0.0,0,4,0,2,5,0,0,1,0,6,6,1
8649,192315,eGRaiLXqwboqQlaTTQYr1FB1cM61jV4I,A3fsA9Zfv1X2fVEQhTw51lKENdNrEqT3,1,0,0,0,0,0,1,0,1,0.14285714285714285,1,0.0,0,0,0,0,0,0,0,1,0,0,1,1
8650,192324,cHLNWYCLO1WUu673oiGBHY06ztWWlBMP,bWdj2GDclj5ofokWjzoa5jAwMkxCykd6,1,0,0,0,0,0,1,0,1,0.14285714285714285,1,0.0,0,0,0,0,0,0,0,1,0,0,1,1
8651,192327,ZW8MI4gpXd8J54W8a3uuPTjmv3mJCgoT,G8EPVSXsOYB5YQWZGiz1aVq5Pgr2GrQu,2,0,0,0,0,0,2,0,2,0.2857142857142857,1,0.0,0,0,0,0,0,0,0,2,0,0,2,1
8652,192367,cBgZxnbCWuxd2FofXugFoDh4OfmFe8dT,bWdj2GDclj5ofokWjzoa5jAwMkxCykd6,5,2,1,0,1,0,2,0,6,0.8571428571428571,1,0.0,0,1,0,1,2,0,0,2,0,2,4,1
8653,192372,shnL5ct8qob4HtqjYuzsqQN09ccan9RZ,bWdj2GDclj5ofokWjzoa5jAwMkxCykd6,4,5,1,0,2,0,4,0,12,1.7142857142857142,1,0.0,2,1,0,2,3,0,0,4,0,5,7,1
8654,192374,ooAUGXFOFAguQ9s1QlStBjM610gDeFBk,A3fsA9Zfv1X2fVEQhTw51lKENdNrEqT3,1,0,0,0,0,0,1,0,1,0.14285714285714285,1,0.0,0,0,0,0,0,0,0,1,0,0,1,1
8655,192378,0Tg2flbTUdD7fODqYIfpiJiK0IDdFiOP,G8EPVSXsOYB5YQWZGiz1aVq5Pgr2GrQu,7,6,1,0,0,0,9,2,18,2.5714285714285716,1,0.0,0,1,0,0,6,0,0,9,2,1,17,1
8656,192390,xWEkYGAfNptAwZnPYzVBCVMgcZk3qKaB,SpATywNh6bZuzm8s1ceuBUnMUAeoAHHw,9,15,0,0,0,0,4,0,19,2.7142857142857144,2,0.0,1,0,0,0,14,0,0,4,0,1,18,0
8657,192412,31BGhLl5fMPdcRk1AZsl6rdwMvdi9CfF,SpATywNh6bZuzm8s1ceuBUnMUAeoAHHw,7,6,5,0,5,0,2,0,18,2.5714285714285716,1,0.0,0,5,0,5,6,0,0,2,0,10,8,1
8658,192416,2aLPbnt4moA8gfuPTpLKAlOHQIQiYuAh,SpATywNh6bZuzm8s1ceuBUnMUAeoAHHw,9,4,3,0,3,0,2,0,12,1.7142857142857142,1,0.0,0,3,0,3,4,0,0,2,0,6,6,1
8659,192423,6ZFGnTjh94PbXkR7sbTLWokikXbcLQlV,SpATywNh6bZuzm8s1ceuBUnMUAeoAHHw,1,0,0,0,0,0,1,0,1,0.14285714285714285,1,0.0,0,0,0,0,0,0,0,1,0,0,1,1
8660,192429,9LhQI6E10btWpLjiUrRwj3MG72TIQ74Y,SpATywNh6bZuzm8s1ceuBUnMUAeoAHHw,7,2,0,0,0,1,5,2,10,1.4285714285714286,1,0.0,0,0,0,0,2,1,0,5,2,0,10,1
8661,192436,xHQ7Ypd5S1OzYjBAcoZTGl29nW3kI889,SpATywNh6bZuzm8s1ceuBUnMUAeoAHHw,9,15,9,0,4,4,7,1,40,5.714285714285714,1,0.0,2,9,0,4,13,4,0,7,1,15,25,1
8662,192454,2o2Mu0kizqtKfAG0EeAIvXT3SodGLvCM,A3fsA9Zfv1X2fVEQhTw51lKENdNrEqT3,1,0,0,0,0,0,2,0,2,0.2857142857142857,1,0.0,0,0,0,0,0,0,0,2,0,0,2,1
8663,192457,2o2Mu0kizqtKfAG0EeAIvXT3SodGLvCM,bWdj2GDclj5ofokWjzoa5jAwMkxCykd6,1,0,0,0,0,0,1,0,1,0.14285714285714285,1,0.0,0,0,0,0,0,0,0,1,0,0,1,1
8664,192458,3h1zqwMTeQWdhoWHPgvllPWyD6P0qFtr,A3fsA9Zfv1X2fVEQhTw51lKENdNrEqT3,2,0,0,0,0,0,2,0,2,0.2857142857142857,2,0.0,0,0,0,0,0,0,0,2,0,0,2,1
8665,193461,9GrY3tpi0hw7X0WFc7jJ7GdKfBSQDQX0,A3fsA9Zfv1X2fVEQhTw51lKENdNrEqT3,14,12,10,0,2,0,1,0,25,3.5714285714285716,1,0.0,0,10,0,2,12,0,0,1,0,12,13,1
8666,193529,Q3zkClKdiEJIkoKspwBuSNOwYXuxalAX,SpATywNh6bZuzm8s1ceuBUnMUAeoAHHw,7,5,3,0,3,0,2,0,13,1.8571428571428572,1,0.0,0,3,0,3,5,0,0,2,0,6,7,0
8667,193546,ut2Z39AHP6ZT6QUG6LjRTh7eJLhOH9rE,SpATywNh6bZuzm8s1ceuBUnMUAeoAHHw,1,0,0,0,0,0,1,0,1,0.14285714285714285,1,0.0,0,0,0,0,0,0,0,1,0,0,1,1
8668,193547,tomN9mWyg9iwVzF8UU8hmvw3PQ3xuR0k,G8EPVSXsOYB5YQWZGiz1aVq5Pgr2GrQu,5,5,0,0,0,0,1,0,6,0.8571428571428571,1,0.0,0,0,0,0,5,0,0,1,0,0,6,1
8669,193558,E5gNyf8gzkIFqEMMzFfX1babw0jRMtve,SpATywNh6bZuzm8s1ceuBUnMUAeoAHHw,1,0,0,0,0,0,1,0,1,0.14285714285714285,1,0.0,0,0,0,0,0,0,0,1,0,0,1,1
8670,193621,KHdvxdy2R5AbDwK3ZeYjgr8BjoNdfk08,SpATywNh6bZuzm8s1ceuBUnMUAeoAHHw,18,40,11,28,7,0,2,0,88,12.571428571428571,1,0.0,28,11,24,7,12,0,4,2,0,70,18,1
8671,193662,VgqneuQZQ3AncdWCqb9v0uAbatLD1T8K,SpATywNh6bZuzm8s1ceuBUnMUAeoAHHw,3,0,0,0,0,1,4,0,5,0.7142857142857143,1,0.0,0,0,0,0,0,1,0,4,0,0,5,1
8672,193670,DQNJ5C68L0zW9SqNuKPhfxZqhIFSYAAT,SpATywNh6bZuzm8s1ceuBUnMUAeoAHHw,7,1,1,0,1,1,4,1,9,1.2857142857142858,1,0.0,0,1,0,1,1,1,0,4,1,2,7,1
8673,193674,cNh6wy7Ir03u71mDLbzarbbzMgepTdGC,A3fsA9Zfv1X2fVEQhTw51lKENdNrEqT3,7,12,4,0,2,0,7,0,25,3.5714285714285716,1,0.0,0,4,0,2,12,0,0,7,0,6,19,1
8674,193692,VwBmQMjyoGFc84WCvHOjmFbeW8jbYRgl,bWdj2GDclj5ofokWjzoa5jAwMkxCykd6,1,0,0,0,0,0,1,0,1,0.14285714285714285,1,0.0,0,0,0,0,0,0,0,1,0,0,1,1
8675,193711,kEyzl5U0qNnr42pVaGkY13nZ2IWHqrcn,A3fsA9Zfv1X2fVEQhTw51lKENdNrEqT3,8,11,2,0,0,0,6,0,19,2.7142857142857144,1,0.0,0,2,0,0,11,0,0,6,0,2,17,1
8676,193740,QZU7ovSo60LPfLhEkMZQvJSmegKjwMYj,bWdj2GDclj5ofokWjzoa5jAwMkxCykd6,1,0,0,0,0,0,1,0,1,0.14285714285714285,1,0.0,0,0,0,0,0,0,0,1,0,0,1,1
8677,193755,nKyehpqCzFKe7AQ0H2jeEWUcUDLPIpGO,SpATywNh6bZuzm8s1ceuBUnMUAeoAHHw,5,4,2,0,1,0,2,0,9,1.2857142857142858,2,0.0,0,2,0,1,4,0,0,2,0,3,6,1
8678,193779,sxaa8Ea6Lo6kUM7O8EMurbYXKbm0hujM,A3fsA9Zfv1X2fVEQhTw51lKENdNrEqT3,4,2,1,0,0,0,2,0,5,0.7142857142857143,1,0.0,0,1,0,0,2,0,0,2,0,1,4,1
8679,193823,3vhCoT2dzeVdCpmcedhNzxK4VNLZ2l0r,A3fsA9Zfv1X2fVEQhTw51lKENdNrEqT3,2,0,0,0,0,0,2,0,2,0.2857142857142857,1,0.0,0,0,0,0,0,0,0,2,0,0,2,0
8680,193837,FMDDO6Y1UiugRDKpi0pVbHvW0zsQHjbn,A3fsA9Zfv1X2fVEQhTw51lKENdNrEqT3,1,0,0,0,0,0,2,0,2,0.2857142857142857,1,0.0,0,0,0,0,0,0,0,2,0,0,2,1
8681,193841,dfFEAUBIaQMqykMKdgVE6J8eiY6sOxye,SpATywNh6bZuzm8s1ceuBUnMUAeoAHHw,1,0,0,0,0,0,1,0,1,0.14285714285714285,1,0.0,0,0,0,0,0,0,0,1,0,0,1,1
8682,193849,hnA8kwZbTriWwmx5JyNt7w45L87YwoEF,G8EPVSXsOYB5YQWZGiz1aVq5Pgr2GrQu,6,3,1,0,1,1,2,0,8,1.1428571428571428,1,0.0,0,1,0,1,3,1,0,2,0,2,6,1
8683,193855,DC8hVUW5lzy6OHDhVmFS5qTdzgQgs5yo,G8EPVSXsOYB5YQWZGiz1aVq5Pgr2GrQu,10,5,4,0,3,0,2,0,14,2.0,1,0.0,0,4,0,3,5,0,0,2,0,7,7,1
8684,193873,aax9J1adQbt26SqiuCHMyd0MidU5QFDr,SpATywNh6bZuzm8s1ceuBUnMUAeoAHHw,18,20,8,20,3,2,9,1,63,9.0,1,0.0,5,8,16,3,15,2,4,9,1,32,31,1
8685,193875,XDysHi7lmceIm5Mq9k6RvheRnsYOet1p,SpATywNh6bZuzm8s1ceuBUnMUAeoAHHw,7,10,3,0,3,0,3,0,19,2.7142857142857144,1,0.0,0,3,0,3,10,0,0,3,0,6,13,1
8686,193876,t1OYI1zdmZ8QFHlNczrmBq9UprH9pvCH,SpATywNh6bZuzm8s1ceuBUnMUAeoAHHw,4,2,1,0,1,0,1,0,5,0.7142857142857143,1,0.0,0,1,0,1,2,0,0,1,0,2,3,1
8687,193886,glhFN9pJVRx23uQGYu0vpxeXZDAwQ2Ta,bWdj2GDclj5ofokWjzoa5jAwMkxCykd6,3,2,1,0,0,0,2,0,5,0.7142857142857143,1,0.0,0,1,0,0,2,0,0,2,0,1,4,1
8688,193898,CzuKHquS2mEQaelvyNFMdu8Hprmbh3VI,A3fsA9Zfv1X2fVEQhTw51lKENdNrEqT3,14,6,6,0,6,0,3,0,21,3.0,1,0.0,0,6,0,6,6,0,0,3,0,12,9,1
8689,193901,Qp3BNNi2PRh8N3k7qOPk9z3KeApis9gf,RXDvfPUBYFlVdlueBFbLW0mhhAyGEqpt,1,0,0,0,0,0,1,0,1,0.14285714285714285,1,0.0,0,0,0,0,0,0,0,1,0,0,1,1
8690,193923,TXo0CCOBoSUl3sGr1fGqVDX7GLiPHTPL,SpATywNh6bZuzm8s1ceuBUnMUAeoAHHw,13,27,8,0,4,0,1,0,40,5.714285714285714,1,0.0,0,8,0,4,27,0,0,1,0,12,28,1
8691,193971,B9OrY2GCm2nBIEwFkCzWGpeUovQjjQhl,SpATywNh6bZuzm8s1ceuBUnMUAeoAHHw,6,3,1,0,1,0,2,0,7,1.0,1,0.0,0,1,0,1,3,0,0,2,0,2,5,1
8692,193976,MdokNqUjzmrixfK2dFiZvz1LZ7rVu7Cj,SpATywNh6bZuzm8s1ceuBUnMUAeoAHHw,4,2,0,0,0,0,2,0,4,0.5714285714285714,1,0.0,0,0,0,0,2,0,0,2,0,0,4,1
8693,193989,kTjP7AQblBZanJKF3X14Zgingjm852XK,A3fsA9Zfv1X2fVEQhTw51lKENdNrEqT3,24,4,2,42,0,1,6,1,56,8.0,1,0.0,2,2,41,0,2,1,1,6,1,45,11,1
8694,194009,QnyEBvmb3eYd1kNyaAYx0F6xZuTb2DX9,SpATywNh6bZuzm8s1ceuBUnMUAeoAHHw,3,2,0,0,0,0,1,0,3,0.42857142857142855,1,0.0,0,0,0,0,2,0,0,1,0,0,3,1
8695,194016,0Gb2L45v3CzxlKP5WG7b6lBKOfgBuWF4,bWdj2GDclj5ofokWjzoa5jAwMkxCykd6,1,0,0,0,0,0,1,0,1,0.14285714285714285,1,0.0,0,0,0,0,0,0,0,1,0,0,1,1
8696,194049,mpIXHW5sILjjHOwn1u3NkBPJs6lkxDFU,A3fsA9Zfv1X2fVEQhTw51lKENdNrEqT3,1,0,0,0,0,0,1,0,1,0.14285714285714285,1,0.0,0,0,0,0,0,0,0,1,0,0,1,1
8697,194057,UasrjB6Lz57MSXiyP9hy734A5ulOXRm3,SpATywNh6bZuzm8s1ceuBUnMUAeoAHHw,8,2,2,0,2,0,6,0,12,1.7142857142857142,1,0.0,0,2,0,2,2,0,0,6,0,4,8,1
8698,194064,RGBg5OBpyocoeZ6vgulRvdHAe4GhCDz5,RXDvfPUBYFlVdlueBFbLW0mhhAyGEqpt,1,0,0,0,0,0,1,0,1,0.14285714285714285,1,0.0,0,0,0,0,0,0,0,1,0,0,1,1
8699,194106,RbyWsDK4wdT2As4ssmcjxiIXfIRi33se,RXDvfPUBYFlVdlueBFbLW0mhhAyGEqpt,1,0,0,0,0,0,1,0,1,0.14285714285714285,1,0.0,0,0,0,0,0,0,0,1,0,0,1,1
8700,194111,RbyWsDK4wdT2As4ssmcjxiIXfIRi33se,SpATywNh6bZuzm8s1ceuBUnMUAeoAHHw,1,0,0,0,0,0,1,0,1,0.14285714285714285,1,0.0,0,0,0,0,0,0,0,1,0,0,1,1
8701,194122,Jag1EXQWfAuTRiCgcVLyhRRkdOL9RtSD,SpATywNh6bZuzm8s1ceuBUnMUAeoAHHw,5,2,1,0,1,0,2,0,6,0.8571428571428571,1,0.0,0,1,0,1,2,0,0,2,0,2,4,1
8702,194149,r3BpteKZps4orgYHVV47mEy8Bf1f88sS,SpATywNh6bZuzm8s1ceuBUnMUAeoAHHw,1,0,0,0,0,0,1,0,1,0.14285714285714285,1,0.0,0,0,0,0,0,0,0,1,0,0,1,1
8703,194174,aPhG1FOMABaf6t82UGQZl3EdavvBRVEM,SpATywNh6bZuzm8s1ceuBUnMUAeoAHHw,8,5,3,0,2,0,4,0,14,2.0,1,0.0,0,3,0,2,5,0,0,4,0,5,9,1
8704,194202,BRI1NrrNzUCAkotknDhVlhYBChSBuaKT,A3fsA9Zfv1X2fVEQhTw51lKENdNrEqT3,5,2,1,0,1,0,5,0,9,1.2857142857142858,1,0.0,0,1,0,1,2,0,0,5,0,2,7,1
8705,194229,Utp3WJ8WUPD5DMyG8PNbE11goCMql2Z7,A3fsA9Zfv1X2fVEQhTw51lKENdNrEqT3,1,0,0,0,0,0,1,0,1,0.14285714285714285,1,0.0,0,0,0,0,0,0,0,1,0,0,1,1
8706,194249,pYpEHiiN5hrwCDFMKyLxLiOaj9mHQ7GD,SpATywNh6bZuzm8s1ceuBUnMUAeoAHHw,10,25,10,0,6,0,7,0,48,6.857142857142857,2,0.0,0,10,0,6,25,0,0,7,0,16,32,1
8707,194264,FLurI80IK98XkIDWszFSc1I4xJfHkDui,SpATywNh6bZuzm8s1ceuBUnMUAeoAHHw,12,9,4,22,2,0,3,0,40,5.714285714285714,1,0.0,2,4,18,2,7,0,4,3,0,26,14,1
8708,194271,KZl7dzvypdUdUZeB27FsOKIroCh34ZqE,A3fsA9Zfv1X2fVEQhTw51lKENdNrEqT3,1,0,0,0,0,0,1,0,1,0.14285714285714285,1,0.0,0,0,0,0,0,0,0,1,0,0,1,1
8709,194287,MAiX9Mv3NnsExv5ROawUklmLMW7Nn262,SpATywNh6bZuzm8s1ceuBUnMUAeoAHHw,15,11,9,17,6,0,8,0,51,7.285714285714286,1,0.0,2,9,14,6,9,0,3,8,0,31,20,1
8710,194317,90AfsCq5UXzZCbixYNCLPLgYyR0EOdy8,G8EPVSXsOYB5YQWZGiz1aVq5Pgr2GrQu,2,0,0,0,0,0,2,0,2,0.2857142857142857,1,0.0,0,0,0,0,0,0,0,2,0,0,2,0
8711,194320,DJXmR0KXC00UhtfnxnB0CPGhSlDcn5wL,A3fsA9Zfv1X2fVEQhTw51lKENdNrEqT3,1,0,0,0,0,0,1,0,1,0.14285714285714285,1,0.0,0,0,0,0,0,0,0,1,0,0,1,1
8712,194324,n2VuZ0fqJlR2ojRwATHr8Dfs9pdWlC2O,A3fsA9Zfv1X2fVEQhTw51lKENdNrEqT3,2,0,0,0,0,0,2,0,2,0.2857142857142857,1,0.0,0,0,0,0,0,0,0,2,0,0,2,1
8713,194327,M1VqvJkrHwdSwkXPdddYGz81xvnLA8HS,SpATywNh6bZuzm8s1ceuBUnMUAeoAHHw,1,0,0,0,0,0,1,0,1,0.14285714285714285,1,0.0,0,0,0,0,0,0,0,1,0,0,1,1
8714,194336,QrSRvY8A0BnQzetj7Na9CGZYc5c4hg6D,SpATywNh6bZuzm8s1ceuBUnMUAeoAHHw,1,0,0,0,0,0,1,0,1,0.14285714285714285,1,0.0,0,0,0,0,0,0,0,1,0,0,1,1
8715,194343,v3fCRqF4yjcmyXUAihELSrQ7bgYySQHE,SpATywNh6bZuzm8s1ceuBUnMUAeoAHHw,1,0,0,0,0,0,1,0,1,0.14285714285714285,1,0.0,0,0,0,0,0,0,0,1,0,0,1,0
8716,194366,MxupZhGQSwq1Hs7FHVKBBW3oeB56xups,SpATywNh6bZuzm8s1ceuBUnMUAeoAHHw,5,4,3,0,2,0,1,0,10,1.4285714285714286,1,0.0,0,3,0,2,4,0,0,1,0,5,5,1
8717,194382,Vnz3YQtaGP9Lud4eJsx4REuNf7a7Z6K7,SpATywNh6bZuzm8s1ceuBUnMUAeoAHHw,2,0,0,0,0,0,4,0,4,0.5714285714285714,1,0.0,0,0,0,0,0,0,0,4,0,0,4,1
8718,194391,bdUXVrhZKpaP1VpbMxVaAFkizIqnujVe,A3fsA9Zfv1X2fVEQhTw51lKENdNrEqT3,7,3,2,0,2,0,2,0,9,1.2857142857142858,1,0.0,0,2,0,2,3,0,0,2,0,4,5,1
8719,194402,HR018KR2tBP057NQs8ykDSVXzmSvDGhY,SpATywNh6bZuzm8s1ceuBUnMUAeoAHHw,1,0,0,0,0,0,1,0,1,0.14285714285714285,1,0.0,0,0,0,0,0,0,0,1,0,0,1,1
8720,194403,UF7B9M1202zm8vZITrztmSzM22WJBlYD,bWdj2GDclj5ofokWjzoa5jAwMkxCykd6,2,0,0,0,0,0,2,0,2,0.2857142857142857,1,0.0,0,0,0,0,0,0,0,2,0,0,2,1
8721,194443,InBEEGDWD99h4yXK2rL9tIFIqmzEV1Dr,SpATywNh6bZuzm8s1ceuBUnMUAeoAHHw,1,0,0,0,0,0,1,0,1,0.14285714285714285,1,0.0,0,0,0,0,0,0,0,1,0,0,1,1
8722,194464,kMcdY0ONNEzYAx15mWphYUVwn71ZDd1H,A3fsA9Zfv1X2fVEQhTw51lKENdNrEqT3,9,7,5,0,0,0,14,0,26,3.7142857142857144,1,0.0,0,5,0,0,7,0,0,14,0,5,21,1
8723,194468,3zCxXtKsxr4Va4aHW0QJdJglnVCQNojy,A3fsA9Zfv1X2fVEQhTw51lKENdNrEqT3,4,1,1,0,0,0,2,0,4,0.5714285714285714,1,0.0,0,1,0,0,1,0,0,2,0,1,3,1
8724,194505,j5jVj2bcu5kXIDJr17WzWDRjLxNGLUuO,SpATywNh6bZuzm8s1ceuBUnMUAeoAHHw,11,9,1,3,0,0,2,0,15,2.142857142857143,1,0.0,2,1,3,0,7,0,0,2,0,6,9,1
8725,194513,0SWFrShD2Nk1V8wWNIvbhD4Wg61qxonB,SpATywNh6bZuzm8s1ceuBUnMUAeoAHHw,4,2,0,0,1,0,2,0,5,0.7142857142857143,1,0.0,1,0,0,1,1,0,0,2,0,2,3,1
8726,194532,K5Sy6doI03r5uctdEcvObhW1bpzNGROt,SpATywNh6bZuzm8s1ceuBUnMUAeoAHHw,1,0,0,0,0,0,1,0,1,0.14285714285714285,1,0.0,0,0,0,0,0,0,0,1,0,0,1,1
8727,194535,fHK2jlK24YNeyNqHHz5jsgZSw0Zz3G3h,G8EPVSXsOYB5YQWZGiz1aVq5Pgr2GrQu,9,6,4,0,2,0,3,0,15,2.142857142857143,1,0.0,0,4,0,2,6,0,0,3,0,6,9,1
8728,194537,H3KvIatiAwzsCPQBVABALz431TkTR6tW,A3fsA9Zfv1X2fVEQhTw51lKENdNrEqT3,5,4,0,0,0,0,3,0,7,1.0,1,0.0,0,0,0,0,4,0,0,3,0,0,7,1
8729,194547,CBNFR2yvlMJ76Qf0H5A5aLcRXIsTpjTt,A3fsA9Zfv1X2fVEQhTw51lKENdNrEqT3,8,2,1,0,1,0,6,0,10,1.4285714285714286,1,0.0,0,1,0,1,2,0,0,6,0,2,8,1
8730,194552,VJiHrUKuVkG2Wd7Jui04ER4qa9ZGvV1t,RXDvfPUBYFlVdlueBFbLW0mhhAyGEqpt,1,0,0,0,0,0,1,0,1,0.14285714285714285,1,0.0,0,0,0,0,0,0,0,1,0,0,1,1
8731,194559,AZZvRPcRkLSa6vwofzfwsEULTUhiKy0E,bWdj2GDclj5ofokWjzoa5jAwMkxCykd6,1,0,0,0,0,0,1,0,1,0.14285714285714285,1,0.0,0,0,0,0,0,0,0,1,0,0,1,1
8732,194561,n5wUv34AuAx6Xa4DLYxEIV5L4Btui37s,SpATywNh6bZuzm8s1ceuBUnMUAeoAHHw,3,2,0,0,0,0,2,0,4,0.5714285714285714,1,0.0,0,0,0,0,2,0,0,2,0,0,4,1
8733,194575,0a9LRwLYq2zam4NcdU9Yh5C7IQvHBC1m,bWdj2GDclj5ofokWjzoa5jAwMkxCykd6,1,0,0,0,0,0,2,0,2,0.2857142857142857,1,0.0,0,0,0,0,0,0,0,2,0,0,2,0
8734,194594,GzXqA08hGJ8jcoopZQLhcubV2m4jl8LU,SpATywNh6bZuzm8s1ceuBUnMUAeoAHHw,8,7,3,0,0,1,8,1,20,2.857142857142857,1,0.0,0,3,0,0,7,1,0,8,1,3,17,1
8735,194598,fQCBMBoRMdmYhgrCFbeJRBZ7kML0GboZ,SpATywNh6bZuzm8s1ceuBUnMUAeoAHHw,10,6,5,0,4,0,2,0,17,2.4285714285714284,1,0.0,0,5,0,4,6,0,0,2,0,9,8,1
8736,194605,L7tS5WxhPVvFnR9bkUR4sVMKwjpwOVxP,bWdj2GDclj5ofokWjzoa5jAwMkxCykd6,6,11,1,0,1,0,5,0,18,2.5714285714285716,1,0.0,0,1,0,1,11,0,0,5,0,2,16,1
8737,194606,fQCBMBoRMdmYhgrCFbeJRBZ7kML0GboZ,RXDvfPUBYFlVdlueBFbLW0mhhAyGEqpt,1,0,0,0,0,0,1,0,1,0.14285714285714285,1,0.0,0,0,0,0,0,0,0,1,0,0,1,1
8738,194612,QbCiNdlMyqDCsAbTGmu0rgI2d2IPTQYV,SpATywNh6bZuzm8s1ceuBUnMUAeoAHHw,1,0,0,0,0,0,1,0,1,0.14285714285714285,1,0.0,0,0,0,0,0,0,0,1,0,0,1,1
8739,194616,0RzZnN2VlQfnUgC4UWcMDxWp2iZsqlCl,SpATywNh6bZuzm8s1ceuBUnMUAeoAHHw,9,6,3,0,1,2,7,1,20,2.857142857142857,1,0.0,0,3,0,1,6,2,0,7,1,4,16,1
8740,194620,aZ7bXLhm88jb64CpmaMPaGfxwPdIjnoI,SpATywNh6bZuzm8s1ceuBUnMUAeoAHHw,2,0,0,0,0,0,2,0,2,0.2857142857142857,1,0.0,0,0,0,0,0,0,0,2,0,0,2,1
8741,194660,6S42i3UQWxx5Vy8tElcT4nwPzZzrdR85,SpATywNh6bZuzm8s1ceuBUnMUAeoAHHw,2,0,0,0,0,0,2,0,2,0.2857142857142857,1,0.0,0,0,0,0,0,0,0,2,0,0,2,1
8742,194671,HPJrmwivOMEDkgdyN7JDkONun7b8CtmQ,SpATywNh6bZuzm8s1ceuBUnMUAeoAHHw,5,3,1,0,1,0,1,0,6,0.8571428571428571,1,0.0,0,1,0,1,3,0,0,1,0,2,4,1
8743,194673,4sHw1UrsiyaJNXlPeVCwFs89kPI7rFXb,SpATywNh6bZuzm8s1ceuBUnMUAeoAHHw,10,8,2,0,2,0,5,1,18,2.5714285714285716,1,0.0,5,2,0,2,3,0,0,5,1,9,9,1
8744,194682,fOtwdZktYnpxoylqFRzXhWQ4IRQZkjMB,A3fsA9Zfv1X2fVEQhTw51lKENdNrEqT3,7,3,2,0,2,0,2,0,9,1.2857142857142858,1,0.0,0,2,0,2,3,0,0,2,0,4,5,1
8745,194683,BoPqpHAIR2FQ1yjN5I6jPiYn67RLyUD3,A3fsA9Zfv1X2fVEQhTw51lKENdNrEqT3,3,2,0,0,0,0,1,0,3,0.42857142857142855,1,0.0,0,0,0,0,2,0,0,1,0,0,3,1
8746,194687,zeGNUT3jrsWIuoEonUpuQekYC6uAy3VD,SpATywNh6bZuzm8s1ceuBUnMUAeoAHHw,10,17,5,0,3,0,2,0,27,3.857142857142857,1,0.0,11,5,0,3,6,0,0,2,0,19,8,1
8747,194689,jWHZ4vPCIn46Q1yqOYKTzhu7yXXPh48K,SpATywNh6bZuzm8s1ceuBUnMUAeoAHHw,4,2,1,0,1,0,1,0,5,0.7142857142857143,1,0.0,0,1,0,1,2,0,0,1,0,2,3,1
8748,194700,UV3gRhbCQYEkFRwtzHQKR8Uz1PLcy3Cv,A3fsA9Zfv1X2fVEQhTw51lKENdNrEqT3,9,3,2,0,2,0,6,1,14,2.0,1,0.0,0,2,0,2,3,0,0,6,1,4,10,1
8749,194704,aBLoyZmvDn4bo6KaMYT6oQr1olyWZk2d,SpATywNh6bZuzm8s1ceuBUnMUAeoAHHw,6,3,1,0,1,0,2,0,7,1.0,1,0.0,0,1,0,1,3,0,0,2,0,2,5,1
8750,194707,JlZc44brK6lbQxfSfaJSAohGFJLWA41f,SpATywNh6bZuzm8s1ceuBUnMUAeoAHHw,1,0,0,0,0,0,1,0,1,0.14285714285714285,1,0.0,0,0,0,0,0,0,0,1,0,0,1,1
8751,194708,9T6sJuPiEkwFHn4VyREnKyR6Ni1hFol4,bWdj2GDclj5ofokWjzoa5jAwMkxCykd6,5,2,1,0,1,0,3,0,7,1.0,1,0.0,0,1,0,1,2,0,0,3,0,2,5,1
8752,194715,Ynti1kEVPZ88eymZgi4Ldsdb7WhG2uKG,SpATywNh6bZuzm8s1ceuBUnMUAeoAHHw,6,7,3,0,3,0,1,0,14,2.0,1,0.0,0,3,0,3,7,0,0,1,0,6,8,0
8753,194718,We3kejZMHXKEdbxhEAiN4oVd8fYmz3y9,A3fsA9Zfv1X2fVEQhTw51lKENdNrEqT3,2,0,0,0,0,0,3,0,3,0.42857142857142855,1,0.0,0,0,0,0,0,0,0,3,0,0,3,1
8754,194750,I2ghGumCKIaVsnJOGZA0xyJzTnEm5KtW,A3fsA9Zfv1X2fVEQhTw51lKENdNrEqT3,32,27,14,50,2,2,14,1,110,15.714285714285714,2,0.0,8,14,47,2,19,2,3,14,1,71,39,1
8755,194769,6bu6C39hyqa2rqkbngsN91OKjCxnxMLI,SpATywNh6bZuzm8s1ceuBUnMUAeoAHHw,10,12,4,16,0,0,2,0,34,4.857142857142857,1,0.0,7,4,14,0,5,0,2,2,0,25,9,1
8756,194770,L7M3Ksh9UBx3xOMl31gqtqz6gfclvqlN,G8EPVSXsOYB5YQWZGiz1aVq5Pgr2GrQu,4,3,1,0,1,0,1,0,6,0.8571428571428571,1,0.0,0,1,0,1,3,0,0,1,0,2,4,1
8757,194797,NFBFv8TG60SG6ScKXY2TuDjWLm29gAEO,G8EPVSXsOYB5YQWZGiz1aVq5Pgr2GrQu,21,19,10,18,4,2,7,1,61,8.714285714285714,1,0.0,5,10,15,4,14,2,3,7,1,34,27,0
8758,194812,U1JFUNAXc1AkReOZ8wdY4hTFUY2t5lXd,SpATywNh6bZuzm8s1ceuBUnMUAeoAHHw,4,3,1,0,1,0,1,0,6,0.8571428571428571,1,0.0,0,1,0,1,3,0,0,1,0,2,4,1
8759,194819,8mJzNtbbhYVCgZPRtpQ3nYyV12q5x7iP,SpATywNh6bZuzm8s1ceuBUnMUAeoAHHw,6,3,1,0,1,0,2,0,7,1.0,1,0.0,0,1,0,1,3,0,0,2,0,2,5,1
8760,194838,0Rc9QmalpGXvwxh2iIaT1Kf7aHCEMOJW,bWdj2GDclj5ofokWjzoa5jAwMkxCykd6,2,0,0,0,0,0,2,0,2,0.2857142857142857,1,0.0,0,0,0,0,0,0,0,2,0,0,2,1
8761,194840,9uetg4jrkfyr9l65M4782Ix4xyAceyAw,SpATywNh6bZuzm8s1ceuBUnMUAeoAHHw,4,2,1,0,0,0,2,0,5,0.7142857142857143,1,0.0,0,1,0,0,2,0,0,2,0,1,4,1
8762,194856,TfgVRC9skFsGu3qq14caEQmfjmrp7rot,SpATywNh6bZuzm8s1ceuBUnMUAeoAHHw,1,0,0,0,0,0,1,0,1,0.14285714285714285,1,0.0,0,0,0,0,0,0,0,1,0,0,1,1
8763,194884,hjZ9Xmjh9fy8zpJXBG9oc3s2Pno9M1Qj,G8EPVSXsOYB5YQWZGiz1aVq5Pgr2GrQu,16,14,5,12,5,0,9,1,46,6.571428571428571,1,0.0,8,5,10,5,6,0,2,9,1,28,18,1
8764,194894,KpYtE2oiCacGgvHDiOR9EPHvEG8K5VAH,A3fsA9Zfv1X2fVEQhTw51lKENdNrEqT3,14,4,3,42,1,0,1,0,51,7.285714285714286,1,0.0,0,3,37,1,4,0,5,1,0,41,10,1
8765,194898,EoYsxsuekHFOGMEOJolKStlPHqzqAJps,SpATywNh6bZuzm8s1ceuBUnMUAeoAHHw,1,0,0,0,0,0,1,0,1,0.14285714285714285,1,0.0,0,0,0,0,0,0,0,1,0,0,1,1
8766,194899,CJ8rz0JWIuI4wzHfaCoKLPdQC5hP7L8o,SpATywNh6bZuzm8s1ceuBUnMUAeoAHHw,2,0,0,0,0,0,2,0,2,0.2857142857142857,1,0.0,0,0,0,0,0,0,0,2,0,0,2,1
8767,194911,coZTr10eytnE55me2AxqRWq6qrVXEB7M,A3fsA9Zfv1X2fVEQhTw51lKENdNrEqT3,6,6,3,0,1,0,3,0,13,1.8571428571428572,1,0.0,0,3,0,1,6,0,0,3,0,4,9,1
8768,194920,nAKoJ3KJH4tNdKl2KzEFM3pKVZsfxNEo,SpATywNh6bZuzm8s1ceuBUnMUAeoAHHw,9,7,1,0,1,0,3,0,12,1.7142857142857142,1,0.0,0,1,0,1,7,0,0,3,0,2,10,1
8769,194938,iUqEEHE7KFlYvrJ9lttneq6sdDOxoE0o,A3fsA9Zfv1X2fVEQhTw51lKENdNrEqT3,1,0,0,0,0,0,1,0,1,0.14285714285714285,1,0.0,0,0,0,0,0,0,0,1,0,0,1,1
8770,194944,5yeJY3nTHKOfgXEh2NQejnxfnR8LFeFo,SpATywNh6bZuzm8s1ceuBUnMUAeoAHHw,6,5,2,0,2,0,1,0,10,1.4285714285714286,1,0.0,0,2,0,2,5,0,0,1,0,4,6,1
8771,194964,i0Fe8GkgETgJLYZf4oG1MMDT0SsDr0Jw,G8EPVSXsOYB5YQWZGiz1aVq5Pgr2GrQu,13,5,4,8,3,0,1,0,21,3.0,1,0.0,0,4,8,3,5,0,0,1,0,15,6,1
8772,194990,ULvgH0dn9cMQ7RqvqnSWbMcAlKJJQ0Fk,A3fsA9Zfv1X2fVEQhTw51lKENdNrEqT3,4,3,1,0,1,0,2,0,7,1.0,1,0.0,0,1,0,1,3,0,0,2,0,2,5,0
8773,194991,ULvgH0dn9cMQ7RqvqnSWbMcAlKJJQ0Fk,RXDvfPUBYFlVdlueBFbLW0mhhAyGEqpt,4,3,1,0,1,0,2,0,7,1.0,1,0.0,0,1,0,1,3,0,0,2,0,2,5,1
8774,195000,h2BiSzi5m6dXS3KusokZajeewmz5ASZK,SpATywNh6bZuzm8s1ceuBUnMUAeoAHHw,1,0,0,0,0,0,1,0,1,0.14285714285714285,1,0.0,0,0,0,0,0,0,0,1,0,0,1,1
8775,195011,NgAo8zTwzEL5kdUZa1oY4oYdY9RywdJx,bWdj2GDclj5ofokWjzoa5jAwMkxCykd6,1,0,0,0,0,0,1,0,1,0.14285714285714285,1,0.0,0,0,0,0,0,0,0,1,0,0,1,1
8776,195028,A7Dy7wBvIZYcTIZR94lL6Ks9jKNwU0Wy,bWdj2GDclj5ofokWjzoa5jAwMkxCykd6,6,2,1,0,1,0,3,0,7,1.0,1,0.0,0,1,0,1,2,0,0,3,0,2,5,1
8777,195048,KGzfXe849hKjIs0BHn7D33gnH3hOFhhi,A3fsA9Zfv1X2fVEQhTw51lKENdNrEqT3,1,0,0,0,0,0,1,0,1,0.14285714285714285,1,0.0,0,0,0,0,0,0,0,1,0,0,1,1
8778,195050,1qqlfnvXgcooPyZOwWYRIPDMSQDSWipF,A3fsA9Zfv1X2fVEQhTw51lKENdNrEqT3,8,4,3,0,2,0,2,0,11,1.5714285714285714,1,0.0,0,3,0,2,4,0,0,2,0,5,6,1
8779,195054,EboqTOLce3Kcnbr13rePsINEM3noHrcD,SpATywNh6bZuzm8s1ceuBUnMUAeoAHHw,1,0,0,0,0,0,3,0,3,0.42857142857142855,1,0.0,0,0,0,0,0,0,0,3,0,0,3,1
8780,195067,0hhH7SwEpwXhVryAlzllJZZoxMiaryTB,A3fsA9Zfv1X2fVEQhTw51lKENdNrEqT3,2,0,0,0,0,0,3,0,3,0.42857142857142855,1,0.0,0,0,0,0,0,0,0,3,0,0,3,1
8781,195070,LcDHI9VirEpxfDmLtYSK63dNG6QfI1o9,bWdj2GDclj5ofokWjzoa5jAwMkxCykd6,1,0,0,0,0,0,2,0,2,0.2857142857142857,1,0.0,0,0,0,0,0,0,0,2,0,0,2,1
8782,195096,VblkSmB0qnt2Sn7mKykILqjl5hQ7D7Rd,SpATywNh6bZuzm8s1ceuBUnMUAeoAHHw,8,3,0,0,0,4,5,1,13,1.8571428571428572,1,0.0,0,0,0,0,3,4,0,5,1,0,13,1
8783,195105,L8lHLh6Mth1S7I3sErP5oDZD885a1BOh,RXDvfPUBYFlVdlueBFbLW0mhhAyGEqpt,4,4,3,0,2,0,1,0,10,1.4285714285714286,1,0.0,0,3,0,2,4,0,0,1,0,5,5,1
8784,195123,9bRCoX5aFYQHE9DZm9jyLHKfMlQ7Zegu,A3fsA9Zfv1X2fVEQhTw51lKENdNrEqT3,15,10,8,0,6,0,19,1,44,6.285714285714286,1,0.0,0,8,0,6,10,0,0,19,1,14,30,1
8785,195133,0vh8eAAsIFnTSYCbme0HYH2GZabOpyjO,SpATywNh6bZuzm8s1ceuBUnMUAeoAHHw,6,4,3,0,0,0,2,0,9,1.2857142857142858,1,0.0,0,3,0,0,4,0,0,2,0,3,6,1
8786,195134,lIXwq3JER4SWrE0O7y1NzGhial9PDy2H,RXDvfPUBYFlVdlueBFbLW0mhhAyGEqpt,9,4,3,0,3,0,2,0,12,1.7142857142857142,1,0.0,0,3,0,3,4,0,0,2,0,6,6,1
8787,195138,zcYW5hQJaAne538I54YBHKKIHPYdcKzR,SpATywNh6bZuzm8s1ceuBUnMUAeoAHHw,3,0,0,0,0,0,3,0,3,0.42857142857142855,1,0.0,0,0,0,0,0,0,0,3,0,0,3,1
8788,195139,WKjm9NNrYTUj7AQwUBj4LGUEStoUuQbI,A3fsA9Zfv1X2fVEQhTw51lKENdNrEqT3,5,2,1,0,1,0,3,0,7,1.0,1,0.0,0,1,0,1,2,0,0,3,0,2,5,1
8789,195143,ZD6KzBJPXfWBkZLRMcl4p14dD6WWX4Ih,SpATywNh6bZuzm8s1ceuBUnMUAeoAHHw,10,14,0,2,0,0,4,0,20,2.857142857142857,1,0.0,2,0,2,0,12,0,0,4,0,4,16,1
8790,195148,AH5vrBLwc7s7uQQh3dO8uaZFfBQDcQxi,SpATywNh6bZuzm8s1ceuBUnMUAeoAHHw,1,0,0,0,0,0,1,0,1,0.14285714285714285,1,0.0,0,0,0,0,0,0,0,1,0,0,1,1
8791,195168,lk6sSo2mEoREiTaQjIlY6dKahZkFRKmP,A3fsA9Zfv1X2fVEQhTw51lKENdNrEqT3,1,0,0,0,0,0,1,0,1,0.14285714285714285,1,0.0,0,0,0,0,0,0,0,1,0,0,1,1
8792,195172,TzUoSJ3pyMjwCKLIHuVSKLad9h9hLr5U,A3fsA9Zfv1X2fVEQhTw51lKENdNrEqT3,4,4,0,0,0,0,1,0,5,0.7142857142857143,1,0.0,0,0,0,0,4,0,0,1,0,0,5,1
8793,195192,hT3gwKIRPmJxcgYf5liQovlZBdIJz1xq,SpATywNh6bZuzm8s1ceuBUnMUAeoAHHw,1,0,0,0,0,0,1,0,1,0.14285714285714285,1,0.0,0,0,0,0,0,0,0,1,0,0,1,1
8794,195202,FVkmb2ERZAYNUD3Q1ZAc0irCEUsLVQQz,SpATywNh6bZuzm8s1ceuBUnMUAeoAHHw,5,2,1,0,1,0,2,0,6,0.8571428571428571,1,0.0,0,1,0,1,2,0,0,2,0,2,4,1
8795,195215,MTAnkeTQnWs9GdHH6O5LRyYCh9iX5uP4,RXDvfPUBYFlVdlueBFbLW0mhhAyGEqpt,1,0,0,0,0,0,2,0,2,0.2857142857142857,1,0.0,0,0,0,0,0,0,0,2,0,0,2,1
8796,195218,abz0JUG7GWWef4jRyaayLqZkxtxXeHAT,SpATywNh6bZuzm8s1ceuBUnMUAeoAHHw,5,3,2,0,2,0,2,0,9,1.2857142857142858,1,0.0,0,2,0,2,3,0,0,2,0,4,5,1
8797,195226,xQ2ZtBKsHIRujsTwaOBWpiIEohBtlo5W,SpATywNh6bZuzm8s1ceuBUnMUAeoAHHw,7,10,5,0,1,0,2,0,18,2.5714285714285716,1,0.0,3,5,0,1,7,0,0,2,0,9,9,1
8798,195234,r0nvOJG3TaeLm69nhbeK6crtYznkTFB2,SpATywNh6bZuzm8s1ceuBUnMUAeoAHHw,7,5,2,0,2,0,4,0,13,1.8571428571428572,1,0.0,2,2,0,2,3,0,0,4,0,6,7,1
8799,195236,fIET0xNMcDIlnjd0AnC9TZEnn5s3AA6i,A3fsA9Zfv1X2fVEQhTw51lKENdNrEqT3,1,0,0,0,0,0,1,0,1,0.14285714285714285,1,0.0,0,0,0,0,0,0,0,1,0,0,1,1
8800,195239,bONRCO0uATZ9orvOXASjWia0swY9AaMZ,bWdj2GDclj5ofokWjzoa5jAwMkxCykd6,6,2,1,0,1,0,3,0,7,1.0,1,0.0,0,1,0,1,2,0,0,3,0,2,5,1
8801,195258,JIBg2bFQYc7ncSPQhvBWrAlcobShyiXA,G8EPVSXsOYB5YQWZGiz1aVq5Pgr2GrQu,5,2,0,0,0,0,3,1,6,0.8571428571428571,1,0.0,0,0,0,0,2,0,0,3,1,0,6,1
8802,195271,H9TBxem7IeyaJ30CPoPNOnkpc9xO2MQu,SpATywNh6bZuzm8s1ceuBUnMUAeoAHHw,1,0,0,0,0,0,1,0,1,0.14285714285714285,1,0.0,0,0,0,0,0,0,0,1,0,0,1,1
8803,195274,83JPfkin3GX4GLKqML2uaHSZ5KvsuJhM,G8EPVSXsOYB5YQWZGiz1aVq5Pgr2GrQu,2,0,0,0,0,3,1,0,4,0.5714285714285714,1,0.0,0,0,0,0,0,3,0,1,0,0,4,1
8804,195281,JHMFz2Gy459G1ldyhA75ALSO8YlPxA4n,bWdj2GDclj5ofokWjzoa5jAwMkxCykd6,9,7,3,0,3,0,2,0,15,2.142857142857143,1,0.0,0,3,0,3,7,0,0,2,0,6,9,1
8805,195287,ouhJVRUNWH7xFlD4xC7qUWcBbb5kOVSM,G8EPVSXsOYB5YQWZGiz1aVq5Pgr2GrQu,4,2,0,0,0,1,6,0,9,1.2857142857142858,1,0.0,0,0,0,0,2,1,0,6,0,0,9,1
8806,195305,jvZodiJQZU7RrA7XB4M3G0LE2sozlnz7,SpATywNh6bZuzm8s1ceuBUnMUAeoAHHw,10,22,2,0,2,1,10,0,37,5.285714285714286,1,0.0,9,2,0,2,13,1,0,10,0,13,24,1
8807,195310,a4n3ibeXbsub5EdlaCwB08x9krqRlEDa,A3fsA9Zfv1X2fVEQhTw51lKENdNrEqT3,1,0,0,0,0,0,1,0,1,0.14285714285714285,1,0.0,0,0,0,0,0,0,0,1,0,0,1,1
8808,195330,0htbMyPoZSLGh1Ogweb6zD7W8pfwScFx,SpATywNh6bZuzm8s1ceuBUnMUAeoAHHw,6,0,0,0,0,0,6,1,7,1.0,1,0.0,0,0,0,0,0,0,0,6,1,0,7,1
8809,195344,cA8asOLHRHcK3Kr0VMyGtrDdcfovAiM5,SpATywNh6bZuzm8s1ceuBUnMUAeoAHHw,10,4,4,0,4,0,3,0,15,2.142857142857143,1,0.0,0,4,0,4,4,0,0,3,0,8,7,1
8810,195347,P608wg2hLiaVE1CUhuKbnmhkIP7IEvsI,A3fsA9Zfv1X2fVEQhTw51lKENdNrEqT3,1,0,0,0,0,0,1,0,1,0.14285714285714285,1,0.0,0,0,0,0,0,0,0,1,0,0,1,1
8811,195366,EnaSTRqxkWjMR8pSWQe4ipdWniwPtGKE,SpATywNh6bZuzm8s1ceuBUnMUAeoAHHw,9,8,2,0,2,0,4,0,16,2.2857142857142856,1,0.0,0,2,0,2,8,0,0,4,0,4,12,1
8812,195370,OxLv0CDANbcaaaoNVUlIdXfqEbT45GpW,SpATywNh6bZuzm8s1ceuBUnMUAeoAHHw,1,0,0,0,0,0,3,0,3,0.42857142857142855,1,0.0,0,0,0,0,0,0,0,3,0,0,3,1
8813,195381,KMHV70a7rpZuAmNpI2Il8aVBDDazbOMO,A3fsA9Zfv1X2fVEQhTw51lKENdNrEqT3,5,2,1,0,1,1,2,0,7,1.0,1,0.0,0,1,0,1,2,1,0,2,0,2,5,1
8814,195383,NXEwBXbU6vvce77sujWgRB6LivhFJvRb,G8EPVSXsOYB5YQWZGiz1aVq5Pgr2GrQu,1,0,0,0,0,0,1,0,1,0.14285714285714285,1,0.0,0,0,0,0,0,0,0,1,0,0,1,1
8815,195392,e5lpY3trke6nXvypvGSIiUjB91TX04sJ,G8EPVSXsOYB5YQWZGiz1aVq5Pgr2GrQu,11,7,4,0,4,0,3,0,18,2.5714285714285716,1,0.0,2,4,0,4,5,0,0,3,0,10,8,1
8816,195405,GR3TNNEdaPxz3Wim5wCYlS1FUuZ9ygFu,SpATywNh6bZuzm8s1ceuBUnMUAeoAHHw,6,2,1,0,1,1,4,0,9,1.2857142857142858,1,0.0,0,1,0,1,2,1,0,4,0,2,7,1
8817,195420,c8hHWOR1LOb1dNnGiimGKTmT5f2lhdqf,G8EPVSXsOYB5YQWZGiz1aVq5Pgr2GrQu,2,1,0,0,0,0,1,0,2,0.2857142857142857,1,0.0,0,0,0,0,1,0,0,1,0,0,2,1
8818,195431,uo6XWLpCc9aLEsRInaYzNhRYRrPEd76a,A3fsA9Zfv1X2fVEQhTw51lKENdNrEqT3,13,6,5,0,5,0,3,0,19,2.7142857142857144,1,0.0,0,5,0,5,6,0,0,3,0,10,9,1
8819,195433,nJkkRmbTjzmjz5X8FxdffFf8Y1I78bGw,SpATywNh6bZuzm8s1ceuBUnMUAeoAHHw,6,4,2,0,2,0,2,0,10,1.4285714285714286,1,0.0,0,2,0,2,4,0,0,2,0,4,6,0
8820,195439,rwvZ7FfuNpbh9VhQHt7eVb6FQWLjKGy4,SpATywNh6bZuzm8s1ceuBUnMUAeoAHHw,1,0,0,0,0,0,1,0,1,0.14285714285714285,1,0.0,0,0,0,0,0,0,0,1,0,0,1,1
8821,195455,HIY4CHwa8u7VF0AwJglD4ImtKKzbU3gm,G8EPVSXsOYB5YQWZGiz1aVq5Pgr2GrQu,8,9,0,0,1,13,6,2,31,4.428571428571429,1,0.0,2,0,0,1,7,13,0,6,2,3,28,1
8822,195459,IyN6z4xrJLEbmfDFZipqdcIPNBoMNgik,SpATywNh6bZuzm8s1ceuBUnMUAeoAHHw,5,2,1,0,1,0,2,0,6,0.8571428571428571,1,0.0,0,1,0,1,2,0,0,2,0,2,4,1
8823,195462,x5Bs4lB8d8XfmyyIE5x0cYPvnoiorBpL,SpATywNh6bZuzm8s1ceuBUnMUAeoAHHw,5,3,2,0,1,0,1,0,7,1.0,1,0.0,0,2,0,1,3,0,0,1,0,3,4,1
8824,195485,WnSnDWbUpPwgyOqh9KapbEmhFpxGdgxn,SpATywNh6bZuzm8s1ceuBUnMUAeoAHHw,1,0,0,0,0,0,1,0,1,0.14285714285714285,1,0.0,0,0,0,0,0,0,0,1,0,0,1,1
8825,195504,dfSV6MVOjiUgDK7JKupNIc842GwgOkeF,A3fsA9Zfv1X2fVEQhTw51lKENdNrEqT3,1,0,0,0,0,0,1,0,1,0.14285714285714285,1,0.0,0,0,0,0,0,0,0,1,0,0,1,1
8826,195532,7ckF3LPSV13LgZ2Fg6VdSWg1opJZgrXH,SpATywNh6bZuzm8s1ceuBUnMUAeoAHHw,2,0,0,0,0,0,2,0,2,0.2857142857142857,1,0.0,0,0,0,0,0,0,0,2,0,0,2,1
8827,195537,EaFWRMbtKR52j7nbPydGVwuzgPsml9aN,RXDvfPUBYFlVdlueBFbLW0mhhAyGEqpt,1,0,0,0,0,0,1,0,1,0.14285714285714285,1,0.0,0,0,0,0,0,0,0,1,0,0,1,1
8828,195556,GmAgRxUlxl118Xo8rOFwbcuTp9uDnYde,SpATywNh6bZuzm8s1ceuBUnMUAeoAHHw,17,14,8,16,5,1,9,1,54,7.714285714285714,1,0.0,5,8,13,5,9,1,3,9,1,31,23,1
8829,195561,iZqC3Cf6t3CzqiiohlVddd9vHxMr4jyG,bWdj2GDclj5ofokWjzoa5jAwMkxCykd6,8,2,1,0,1,0,6,1,11,1.5714285714285714,1,0.0,0,1,0,1,2,0,0,6,1,2,9,1
8830,195564,augCFReFBQs2gO1ZsbARNIDALhMdNkTr,SpATywNh6bZuzm8s1ceuBUnMUAeoAHHw,1,0,0,0,0,0,2,0,2,0.2857142857142857,1,0.0,0,0,0,0,0,0,0,2,0,0,2,1
8831,195566,V7zoEtLfhU5rtj42pQGAui9L72mSu8fB,SpATywNh6bZuzm8s1ceuBUnMUAeoAHHw,5,3,1,0,1,0,1,0,6,0.8571428571428571,1,0.0,0,1,0,1,3,0,0,1,0,2,4,1
8832,195612,v5ZclElew7ejFho1P7oX3s4a7TxNLCyF,7GRhBDsirIGkRZBtSMEzNTyDr2JQm4xx,1,0,0,0,0,0,1,0,1,0.14285714285714285,1,0.0,0,0,0,0,0,0,0,1,0,0,1,1
8833,195629,wnskylPQEd73X69h6kGVzeSF3KYHcgop,7GRhBDsirIGkRZBtSMEzNTyDr2JQm4xx,1,0,0,0,0,0,1,0,1,0.14285714285714285,1,0.0,0,0,0,0,0,0,0,1,0,0,1,1
8834,195677,CnWkaEKTjMJzfUHjUWYYcuY1pest8HcE,7GRhBDsirIGkRZBtSMEzNTyDr2JQm4xx,2,0,0,0,0,0,2,0,2,0.2857142857142857,1,0.0,0,0,0,0,0,0,0,2,0,0,2,1
8835,195683,nT6QAy9LYRgx8ymnax3zVsoU2kI3RSib,7GRhBDsirIGkRZBtSMEzNTyDr2JQm4xx,4,0,0,0,0,0,3,1,4,0.5714285714285714,1,0.0,0,0,0,0,0,0,0,3,1,0,4,1
8836,195698,Wn6M5pDE1BQQohcN99ynI9TPsF44SXAJ,7GRhBDsirIGkRZBtSMEzNTyDr2JQm4xx,4,2,1,0,1,0,1,0,5,0.7142857142857143,1,0.0,0,1,0,1,2,0,0,1,0,2,3,1
8837,195703,C800geUBh3GYBhoh4cW6ReKUGj5LAMGi,7GRhBDsirIGkRZBtSMEzNTyDr2JQm4xx,1,0,0,0,0,0,1,0,1,0.14285714285714285,1,0.0,0,0,0,0,0,0,0,1,0,0,1,1
8838,195739,BBfiARXlf8DQ4mmAXStqrzMqGcJUzid6,7GRhBDsirIGkRZBtSMEzNTyDr2JQm4xx,5,2,1,0,1,1,2,0,7,1.0,1,0.0,0,1,0,1,2,1,0,2,0,2,5,1
8839,195747,LezrgeG2DMZV4p8bIqSrF4Mu5gNQ96cn,7GRhBDsirIGkRZBtSMEzNTyDr2JQm4xx,17,16,1,0,1,0,1,0,19,2.7142857142857144,1,0.0,0,1,0,1,16,0,0,1,0,2,17,1
8840,195799,cQIOkGZ64oWxmjLUWB6bjywMucqysG5O,7GRhBDsirIGkRZBtSMEzNTyDr2JQm4xx,2,0,0,0,0,0,2,0,2,0.2857142857142857,1,0.0,0,0,0,0,0,0,0,2,0,0,2,1
8841,196306,X6Lezij464ccKeng4uwKJTPF9kfTAT6Z,SpATywNh6bZuzm8s1ceuBUnMUAeoAHHw,1,0,0,0,0,0,1,0,1,0.14285714285714285,1,0.0,0,0,0,0,0,0,0,1,0,0,1,1
8842,196307,X6Lezij464ccKeng4uwKJTPF9kfTAT6Z,RXDvfPUBYFlVdlueBFbLW0mhhAyGEqpt,7,8,4,0,2,0,3,0,17,2.4285714285714284,1,0.0,0,4,0,2,8,0,0,3,0,6,11,1
8843,196705,bZa2cKnNlVdaH2zh1KBEDwy94lOurAbl,A3fsA9Zfv1X2fVEQhTw51lKENdNrEqT3,5,2,1,0,1,0,3,0,7,1.0,1,0.0,0,1,0,1,2,0,0,3,0,2,5,1
8844,197539,KgsFs481TCjQwvLPKxf7Q7ylhhpHCPhV,A3fsA9Zfv1X2fVEQhTw51lKENdNrEqT3,1,0,0,0,0,0,1,0,1,0.14285714285714285,1,0.0,0,0,0,0,0,0,0,1,0,0,1,1
8845,197555,mI8VCRBSYdxznLkfNYlx0gUNvZ04sNfj,SpATywNh6bZuzm8s1ceuBUnMUAeoAHHw,1,0,0,0,0,0,1,0,1,0.14285714285714285,1,0.0,0,0,0,0,0,0,0,1,0,0,1,1
8846,197567,zGQkx7I5R9FuZgfmXPXAegIJkfQnaSVg,SpATywNh6bZuzm8s1ceuBUnMUAeoAHHw,9,4,2,0,2,0,4,3,15,2.142857142857143,1,0.0,1,2,0,2,3,0,0,4,3,5,10,1
8847,197568,fBs8B9TyWeZ3NFnjocJnCJ1lDFqvyofp,SpATywNh6bZuzm8s1ceuBUnMUAeoAHHw,1,0,0,0,0,0,1,0,1,0.14285714285714285,1,0.0,0,0,0,0,0,0,0,1,0,0,1,1
8848,197590,sszCBt8cghX6qgFnXDzG8r5isZBGG9No,bWdj2GDclj5ofokWjzoa5jAwMkxCykd6,1,0,0,0,0,0,1,0,1,0.14285714285714285,1,0.0,0,0,0,0,0,0,0,1,0,0,1,1
8849,197605,xWQhq9RZKw08hANIa0LgFXN2DnwycQf4,A3fsA9Zfv1X2fVEQhTw51lKENdNrEqT3,1,0,0,0,0,0,1,0,1,0.14285714285714285,1,0.0,0,0,0,0,0,0,0,1,0,0,1,1
8850,197607,oarWFl12GJz5VOCw3d9cT9LuNMnlfaty,SpATywNh6bZuzm8s1ceuBUnMUAeoAHHw,9,11,1,8,0,5,7,0,32,4.571428571428571,1,0.0,0,1,6,0,11,5,2,7,0,7,25,1
8851,197610,PsqZXIXDMOG5Y38IYf7VtFHU6aWciJTC,A3fsA9Zfv1X2fVEQhTw51lKENdNrEqT3,4,2,0,0,0,0,3,0,5,0.7142857142857143,1,0.0,0,0,0,0,2,0,0,3,0,0,5,1
8852,197613,McYATdhZDDMDpni6a4GbjI06ustMpvdV,RXDvfPUBYFlVdlueBFbLW0mhhAyGEqpt,5,2,1,0,1,0,2,0,6,0.8571428571428571,1,0.0,0,1,0,1,2,0,0,2,0,2,4,1
8853,197630,GlVmjWGZ8XsOuLGdZvtzRw0xzELGNzxx,A3fsA9Zfv1X2fVEQhTw51lKENdNrEqT3,1,0,0,0,0,0,1,0,1,0.14285714285714285,1,0.0,0,0,0,0,0,0,0,1,0,0,1,1
8854,197637,y0PkAopIdLmRFrkWC9eBHvWT77KfVWMh,bWdj2GDclj5ofokWjzoa5jAwMkxCykd6,5,5,2,0,2,0,2,0,11,1.5714285714285714,1,0.0,0,2,0,2,5,0,0,2,0,4,7,1
8855,197647,yJyieqiQ74x4K1fGefSNl8T336TNyMah,G8EPVSXsOYB5YQWZGiz1aVq5Pgr2GrQu,7,5,3,0,1,0,3,0,12,1.7142857142857142,1,0.0,0,3,0,1,5,0,0,3,0,4,8,1
8856,197666,NXEwBXbU6vvce77sujWgRB6LivhFJvRb,bWdj2GDclj5ofokWjzoa5jAwMkxCykd6,4,2,1,0,1,0,2,0,6,0.8571428571428571,1,0.0,0,1,0,1,2,0,0,2,0,2,4,0
8857,197686,IlMRFFFNuG5w9EpYG3Dyt8Sj1nCtwb6Z,SpATywNh6bZuzm8s1ceuBUnMUAeoAHHw,6,8,4,0,0,0,1,0,13,1.8571428571428572,1,0.0,0,4,0,0,8,0,0,1,0,4,9,1
8858,197694,CLJmxLRlSw5V2HPI140IDE0f4EOszt4Y,SpATywNh6bZuzm8s1ceuBUnMUAeoAHHw,1,0,0,0,0,0,1,0,1,0.14285714285714285,1,0.0,0,0,0,0,0,0,0,1,0,0,1,1
8859,197701,irsB3oA9q2Yuz0rnZheRoFNJtkEWBPEv,SpATywNh6bZuzm8s1ceuBUnMUAeoAHHw,1,0,0,0,0,0,1,0,1,0.14285714285714285,1,0.0,0,0,0,0,0,0,0,1,0,0,1,1
8860,197705,Q2m4p3E1xU5tjACIAMpsbnVuTeuD9Zj8,RXDvfPUBYFlVdlueBFbLW0mhhAyGEqpt,1,0,0,0,0,0,1,0,1,0.14285714285714285,1,0.0,0,0,0,0,0,0,0,1,0,0,1,1
8861,197748,lvB2HAmzN6WpjnZWZKcaAAjy9p9VjGaG,SpATywNh6bZuzm8s1ceuBUnMUAeoAHHw,4,4,1,0,0,0,1,0,6,0.8571428571428571,1,0.0,1,1,0,0,3,0,0,1,0,2,4,1
8862,197754,DIr3Wrj5z4hYJwtDO9ijYT7A5ei5kcOt,SpATywNh6bZuzm8s1ceuBUnMUAeoAHHw,5,4,0,0,0,1,2,0,7,1.0,1,0.0,0,0,0,0,4,1,0,2,0,0,7,1
8863,197760,syyc0SZ7JGCYLXzo3H6grsNKbnA69vWI,SpATywNh6bZuzm8s1ceuBUnMUAeoAHHw,15,14,4,12,3,1,6,1,41,5.857142857142857,1,0.0,9,4,12,3,5,1,0,6,1,28,13,1
8864,197775,ate9cHga4fvGZQe84ZmaH3duYZ3g1R1F,G8EPVSXsOYB5YQWZGiz1aVq5Pgr2GrQu,9,5,4,0,3,2,4,0,18,2.5714285714285716,1,0.0,0,4,0,3,5,2,0,4,0,7,11,1
8865,197793,BxOnqjgkTpP6bgtURLXQygVvMj5N3Ti3,SpATywNh6bZuzm8s1ceuBUnMUAeoAHHw,7,4,0,0,0,0,5,1,10,1.4285714285714286,1,0.0,0,0,0,0,4,0,0,5,1,0,10,1
8866,197798,ZECsrQDWNf4nPUfo4HpZsLiXc2swEQ6q,SpATywNh6bZuzm8s1ceuBUnMUAeoAHHw,5,4,3,0,1,0,1,0,9,1.2857142857142858,1,0.0,0,3,0,1,4,0,0,1,0,4,5,1
8867,197810,doaL1TzO9FZY2ziOksLPhVRKrqvsMpej,SpATywNh6bZuzm8s1ceuBUnMUAeoAHHw,6,2,1,0,1,0,3,0,7,1.0,1,0.0,0,1,0,1,2,0,0,3,0,2,5,1
8868,197820,6WpUAvOn0104PVGU1qRupfdkikcVBl8O,SpATywNh6bZuzm8s1ceuBUnMUAeoAHHw,7,11,3,6,0,0,2,0,22,3.142857142857143,1,0.0,2,3,5,0,9,0,1,2,0,10,12,1
8869,197829,4ZyQJ5jYIytY6BbDJp7B3MYaAhi1NvbZ,SpATywNh6bZuzm8s1ceuBUnMUAeoAHHw,1,0,0,0,0,0,1,0,1,0.14285714285714285,1,0.0,0,0,0,0,0,0,0,1,0,0,1,1
8870,197846,qePcgnp7eGbGREyZzIMf7xZBiRdT6s9H,SpATywNh6bZuzm8s1ceuBUnMUAeoAHHw,5,2,1,0,1,0,2,0,6,0.8571428571428571,1,0.0,0,1,0,1,2,0,0,2,0,2,4,1
8871,197851,HwQlDqQYrfHrBUx2SSkCNQ3Dej1xgfkf,A3fsA9Zfv1X2fVEQhTw51lKENdNrEqT3,4,3,0,0,0,0,5,0,8,1.1428571428571428,1,0.0,0,0,0,0,3,0,0,5,0,0,8,1
8872,197889,bjP4zb5x0G9Cc1USSNLgNUtaJAQzeUAu,A3fsA9Zfv1X2fVEQhTw51lKENdNrEqT3,4,4,0,0,0,0,2,0,6,0.8571428571428571,1,0.0,0,0,0,0,4,0,0,2,0,0,6,1
8873,197898,QTE6XpirXhdZj0nCidu516iE2M5a9YWy,SpATywNh6bZuzm8s1ceuBUnMUAeoAHHw,4,3,2,0,2,0,1,0,8,1.1428571428571428,1,0.0,0,2,0,2,3,0,0,1,0,4,4,1
8874,197940,pXqF8hGJZiVQMekFKWzwpXptQULIbit3,A3fsA9Zfv1X2fVEQhTw51lKENdNrEqT3,1,0,0,0,0,0,1,0,1,0.14285714285714285,1,0.0,0,0,0,0,0,0,0,1,0,0,1,1
8875,197946,hICMvevjXddBWDZc80Udm3Jkv903MANA,A3fsA9Zfv1X2fVEQhTw51lKENdNrEqT3,7,4,2,0,2,0,1,0,9,1.2857142857142858,1,0.0,0,2,0,2,4,0,0,1,0,4,5,1
8876,197948,hw7IvcaYFJuJeZABsZjmbMK4OkcJdM6i,bWdj2GDclj5ofokWjzoa5jAwMkxCykd6,6,5,4,0,4,0,2,0,15,2.142857142857143,1,0.0,0,4,0,4,5,0,0,2,0,8,7,1
8877,197962,xp0PGlV4qhp60qYyxRe8xCxRmmPbM3Jj,A3fsA9Zfv1X2fVEQhTw51lKENdNrEqT3,2,0,0,0,0,0,4,0,4,0.5714285714285714,1,0.0,0,0,0,0,0,0,0,4,0,0,4,1
8878,197980,lQYiHkk4y0zDXyHNzb0tlv73qls5L2Vm,SpATywNh6bZuzm8s1ceuBUnMUAeoAHHw,5,4,0,0,0,0,4,0,8,1.1428571428571428,1,0.0,0,0,0,0,4,0,0,4,0,0,8,1
8879,198003,mJztKjO5nESo6T2c5pukm2m7KLliSS8S,A3fsA9Zfv1X2fVEQhTw51lKENdNrEqT3,10,5,3,0,3,4,3,0,18,2.5714285714285716,1,0.0,0,3,0,3,5,4,0,3,0,6,12,1
8880,198006,zkqKiyV6OvwyKPkyCN37KC4hTRCpZYCH,A3fsA9Zfv1X2fVEQhTw51lKENdNrEqT3,10,7,5,0,4,0,3,0,19,2.7142857142857144,1,0.0,0,5,0,4,7,0,0,3,0,9,10,1
8881,198018,XwJMK5oKK2pkH5F1a5Sx8BXHH3EqGmzs,A3fsA9Zfv1X2fVEQhTw51lKENdNrEqT3,25,3,1,56,1,0,4,0,65,9.285714285714286,1,0.0,1,1,55,1,2,0,1,4,0,58,7,1
8882,198022,Mv7lfepPwMiuMAg4tPzXsqZKJDYbRo5M,RXDvfPUBYFlVdlueBFbLW0mhhAyGEqpt,6,3,1,0,0,0,5,0,9,1.2857142857142858,1,0.0,0,1,0,0,3,0,0,5,0,1,8,1
8883,198026,NrHk4qmJXuD0TsjkQSnghKpk9ZjGAOyU,A3fsA9Zfv1X2fVEQhTw51lKENdNrEqT3,8,9,6,0,6,0,1,0,22,3.142857142857143,1,0.0,0,6,0,6,9,0,0,1,0,12,10,1
8884,198028,HePRyod5aTSIcFeoVudB8huyR12d5o5i,A3fsA9Zfv1X2fVEQhTw51lKENdNrEqT3,7,3,2,0,2,0,4,0,11,1.5714285714285714,1,0.0,0,2,0,2,3,0,0,4,0,4,7,0
8885,198029,4SbF4DhXcYorYYyJ4XmwwPJZFVh1ZUhY,A3fsA9Zfv1X2fVEQhTw51lKENdNrEqT3,6,3,2,0,1,0,5,0,11,1.5714285714285714,1,0.0,0,2,0,1,3,0,0,5,0,3,8,1
8886,198046,aDI9D7tn5adCCbKFB0sAA8QdbVuXFqVk,RXDvfPUBYFlVdlueBFbLW0mhhAyGEqpt,17,16,11,31,7,0,1,0,66,9.428571428571429,1,0.0,4,11,29,7,12,0,2,1,0,51,15,1
8887,198047,26YSBPGFrjIOM80TFQ5XwHijdAXAx6uk,bWdj2GDclj5ofokWjzoa5jAwMkxCykd6,12,5,3,0,3,0,5,2,18,2.5714285714285716,1,0.0,0,3,0,3,5,0,0,5,2,6,12,1
8888,198073,tBWD1VTj6Jcj3AQ0AXY8eZtUzkjmoiNH,A3fsA9Zfv1X2fVEQhTw51lKENdNrEqT3,34,31,1,62,1,0,10,1,106,15.142857142857142,1,0.0,3,1,54,1,28,0,8,10,1,59,47,1
8889,198086,xq1s7UZZ1wrCX5Lo1UzeFrdUUjRT403R,SpATywNh6bZuzm8s1ceuBUnMUAeoAHHw,11,12,1,12,0,0,3,1,29,4.142857142857143,1,0.0,6,1,12,0,6,0,0,3,1,19,10,1
8890,198098,AjlQRJzysjPIR7iVlK5KoW1nu66aTyed,SpATywNh6bZuzm8s1ceuBUnMUAeoAHHw,1,0,0,0,0,0,1,0,1,0.14285714285714285,1,0.0,0,0,0,0,0,0,0,1,0,0,1,0
8891,198105,gMfSnnrpIllvTRFx8lm7ezHNF6v0Kz0J,A3fsA9Zfv1X2fVEQhTw51lKENdNrEqT3,8,4,2,0,1,4,9,2,22,3.142857142857143,1,0.0,0,2,0,1,4,4,0,9,2,3,19,1
8892,198115,qB4NKZzfw5ku2R1El6nAmpvYSqoEp884,SpATywNh6bZuzm8s1ceuBUnMUAeoAHHw,4,3,1,0,0,0,2,0,6,0.8571428571428571,1,0.0,0,1,0,0,3,0,0,2,0,1,5,0
8893,198145,4GJSwwikGuUWXSajcKoSlvfsoiC8eEZq,bWdj2GDclj5ofokWjzoa5jAwMkxCykd6,13,17,7,0,3,3,7,1,38,5.428571428571429,1,0.0,1,7,0,3,16,3,0,7,1,11,27,1
8894,198154,S0gkXMGtXyRSx8zYg1gsCVaZEuGxgZkA,bWdj2GDclj5ofokWjzoa5jAwMkxCykd6,4,2,1,0,1,0,3,0,7,1.0,1,0.0,0,1,0,1,2,0,0,3,0,2,5,1
8895,198161,T6EWQ7jVP89JlHzj41KN1gEtGYevpSQM,A3fsA9Zfv1X2fVEQhTw51lKENdNrEqT3,12,8,6,0,4,0,2,0,20,2.857142857142857,1,0.0,0,6,0,4,8,0,0,2,0,10,10,1
8896,198163,plvcgi97Dmyn6KmfywjhqH2jaOdxU3cF,SpATywNh6bZuzm8s1ceuBUnMUAeoAHHw,8,5,3,0,0,1,5,1,15,2.142857142857143,1,0.0,0,3,0,0,5,1,0,5,1,3,12,1
8897,198180,gykRbA7iJUFygOkXv9mNdsHLTYvvd4jI,A3fsA9Zfv1X2fVEQhTw51lKENdNrEqT3,9,7,0,0,0,5,3,0,15,2.142857142857143,1,0.0,0,0,0,0,7,5,0,3,0,0,15,1
8898,198184,XeY97U0dths6K286UoEX2Zr2QUaKKAXx,SpATywNh6bZuzm8s1ceuBUnMUAeoAHHw,1,0,0,0,0,0,1,0,1,0.14285714285714285,1,0.0,0,0,0,0,0,0,0,1,0,0,1,1
8899,198186,73Lo5aiYTeasg8R5eGVwIsechNk0OHx6,G8EPVSXsOYB5YQWZGiz1aVq5Pgr2GrQu,9,4,3,0,3,0,2,0,12,1.7142857142857142,1,0.0,0,3,0,3,4,0,0,2,0,6,6,1
8900,198189,OtQITYEhL1ZwLf1P3GqZbaC4QV1QHl7a,A3fsA9Zfv1X2fVEQhTw51lKENdNrEqT3,9,15,7,0,0,0,2,0,24,3.4285714285714284,1,0.0,0,7,0,0,15,0,0,2,0,7,17,1
8901,198208,G2J62R4OLusX5hri0oMn1VajtiIn6i9q,bWdj2GDclj5ofokWjzoa5jAwMkxCykd6,6,1,1,0,1,0,3,0,6,0.8571428571428571,1,0.0,0,1,0,1,1,0,0,3,0,2,4,1
8902,198215,nrvDpyOlV5T6ZU5wiBAqPXpBwJOtawqO,A3fsA9Zfv1X2fVEQhTw51lKENdNrEqT3,20,17,9,0,7,8,8,0,49,7.0,1,0.0,1,9,0,7,16,8,0,8,0,17,32,1
8903,198221,9Mbi6CksSOlTvzJd1jV7pzorOP4mmF9E,A3fsA9Zfv1X2fVEQhTw51lKENdNrEqT3,5,2,1,0,1,0,2,0,6,0.8571428571428571,1,0.0,0,1,0,1,2,0,0,2,0,2,4,1
8904,198226,So8gZ8cXseEZ7lXf4idNMqcN46bXtlIA,A3fsA9Zfv1X2fVEQhTw51lKENdNrEqT3,8,8,5,0,1,0,6,0,20,2.857142857142857,1,0.0,1,5,0,1,7,0,0,6,0,7,13,1
8905,198241,qq2f8Akny1ajULPtgXYv9fMRWduKMr9q,bWdj2GDclj5ofokWjzoa5jAwMkxCykd6,1,0,0,0,0,0,1,0,1,0.14285714285714285,1,0.0,0,0,0,0,0,0,0,1,0,0,1,1
8906,198265,tblYMREbAeB7j9qmk5L4ctIeWrhD9ybH,bWdj2GDclj5ofokWjzoa5jAwMkxCykd6,3,2,1,0,0,0,2,0,5,0.7142857142857143,1,0.0,0,1,0,0,2,0,0,2,0,1,4,1
8907,198305,XMS4dHK4VF2mldxN8JQikVR6RXER8Fkw,bWdj2GDclj5ofokWjzoa5jAwMkxCykd6,5,3,1,0,1,0,2,0,7,1.0,1,0.0,0,1,0,1,3,0,0,2,0,2,5,1
8908,198318,6I2t4qPvSGFHgotoOOeNtMQj1MijCM5Q,A3fsA9Zfv1X2fVEQhTw51lKENdNrEqT3,10,7,5,0,5,0,2,0,19,2.7142857142857144,1,0.0,1,5,0,5,6,0,0,2,0,11,8,1
8909,198321,VLCI0RtMsYSrwlXRiyKxAF4TijVOF7sG,G8EPVSXsOYB5YQWZGiz1aVq5Pgr2GrQu,6,10,0,2,0,0,1,0,13,1.8571428571428572,1,0.0,1,0,2,0,9,0,0,1,0,3,10,1
8910,198326,Dq2cCGdJlkpRnI9Tq5kE4JyzjGIGvpDz,bWdj2GDclj5ofokWjzoa5jAwMkxCykd6,3,2,0,0,0,0,1,0,3,0.42857142857142855,1,0.0,0,0,0,0,2,0,0,1,0,0,3,1
8911,198371,LWF5YNBuaLmRzZBpMALW00OMClXmBQ67,SpATywNh6bZuzm8s1ceuBUnMUAeoAHHw,2,0,0,0,0,0,2,0,2,0.2857142857142857,1,0.0,0,0,0,0,0,0,0,2,0,0,2,1
8912,198409,ipd4iDlo57xlncm3PxcBpEpu3rjoDaW0,SpATywNh6bZuzm8s1ceuBUnMUAeoAHHw,7,4,2,0,0,3,5,2,16,2.2857142857142856,1,0.0,0,2,0,0,4,3,0,5,2,2,14,1
8913,198412,MW1CCUAVszgiBJBxxvrBhzMkhEDfscQF,SpATywNh6bZuzm8s1ceuBUnMUAeoAHHw,6,0,0,0,0,0,11,8,19,2.7142857142857144,1,0.0,0,0,0,0,0,0,0,11,8,0,19,1
8914,198425,Im7Gqlg4DTaApzafTWanJWaOLzYDgQ9W,A3fsA9Zfv1X2fVEQhTw51lKENdNrEqT3,3,2,0,0,0,0,1,0,3,0.42857142857142855,1,0.0,0,0,0,0,2,0,0,1,0,0,3,1
8915,198427,LUXdrYaxg0yAPMJIVFuGpyCbBaRkWcyF,G8EPVSXsOYB5YQWZGiz1aVq5Pgr2GrQu,1,0,0,0,0,0,1,0,1,0.14285714285714285,1,0.0,0,0,0,0,0,0,0,1,0,0,1,1
8916,198437,itsIv2TK9169ecmSXMRGqFj2himLJ6iM,A3fsA9Zfv1X2fVEQhTw51lKENdNrEqT3,6,2,1,0,1,0,3,0,7,1.0,1,0.0,0,1,0,1,2,0,0,3,0,2,5,1
8917,198439,ap1pnANC6OX2VWawEUL9RM8TJxJj0bNk,SpATywNh6bZuzm8s1ceuBUnMUAeoAHHw,5,2,1,0,1,0,2,0,6,0.8571428571428571,1,0.0,0,1,0,1,2,0,0,2,0,2,4,1
8918,198451,hB4kfP3FOz99INk6teFtXjDJ0tVrgCfz,A3fsA9Zfv1X2fVEQhTw51lKENdNrEqT3,7,4,1,0,1,0,3,1,10,1.4285714285714286,1,0.0,0,1,0,1,4,0,0,3,1,2,8,1
8919,198471,rVGqmbwIRU16AVLpkBRDBFOfZ4AeaSVo,G8EPVSXsOYB5YQWZGiz1aVq5Pgr2GrQu,8,2,0,0,0,4,6,1,13,1.8571428571428572,1,0.0,0,0,0,0,2,4,0,6,1,0,13,1
8920,198513,h4OSpklHSinT7B8HRJJ34ZVL6q4IdQwV,A3fsA9Zfv1X2fVEQhTw51lKENdNrEqT3,10,7,1,0,1,0,6,1,16,2.2857142857142856,1,0.0,0,1,0,1,7,0,0,6,1,2,14,1
8921,198521,I3IP7zznUTOp2SzpkCoD3Y916MRFIMEQ,G8EPVSXsOYB5YQWZGiz1aVq5Pgr2GrQu,17,18,1,24,3,0,2,0,48,6.857142857142857,1,0.0,12,1,14,3,6,0,10,2,0,30,18,1
8922,198524,3nkAYJy31glMu7RttArFOqU7gmkfxNPM,RXDvfPUBYFlVdlueBFbLW0mhhAyGEqpt,1,0,0,0,0,0,1,0,1,0.14285714285714285,1,0.0,0,0,0,0,0,0,0,1,0,0,1,1
8923,198527,7UnGK0lAfGMjUxMyS4n60DI4CBHlFUHS,SpATywNh6bZuzm8s1ceuBUnMUAeoAHHw,4,2,0,0,0,1,2,0,5,0.7142857142857143,1,0.0,0,0,0,0,2,1,0,2,0,0,5,1
8924,198540,PQpooRd3Dcd7MsTxOspuuB35YLvA2JZK,SpATywNh6bZuzm8s1ceuBUnMUAeoAHHw,5,5,4,0,2,0,2,0,13,1.8571428571428572,1,0.0,0,4,0,2,5,0,0,2,0,6,7,1
8925,198541,cIviUx1oarGZRWOqPuxscIM6aOUp7v5L,G8EPVSXsOYB5YQWZGiz1aVq5Pgr2GrQu,11,3,3,0,3,0,5,0,14,2.0,1,0.0,0,3,0,3,3,0,0,5,0,6,8,1
8926,198543,7UnGK0lAfGMjUxMyS4n60DI4CBHlFUHS,bWdj2GDclj5ofokWjzoa5jAwMkxCykd6,1,0,0,0,0,0,1,0,1,0.14285714285714285,1,0.0,0,0,0,0,0,0,0,1,0,0,1,1
8927,198563,IR9p9WuPGPaaA4f6RkgkUYRRmOTg8aPE,bWdj2GDclj5ofokWjzoa5jAwMkxCykd6,3,2,1,0,0,0,1,0,4,0.5714285714285714,1,0.0,0,1,0,0,2,0,0,1,0,1,3,1
8928,198573,0Rc9QmalpGXvwxh2iIaT1Kf7aHCEMOJW,A3fsA9Zfv1X2fVEQhTw51lKENdNrEqT3,1,0,0,0,0,0,1,0,1,0.14285714285714285,1,0.0,0,0,0,0,0,0,0,1,0,0,1,1
8929,198585,pHj2ScU15UNB28eYcbm9r11wq0WKivrS,bWdj2GDclj5ofokWjzoa5jAwMkxCykd6,4,5,2,0,2,0,1,0,10,1.4285714285714286,1,0.0,2,2,0,2,3,0,0,1,0,6,4,1
8930,198590,Zr4KLz2ZL4aSF5gVvs5p4LZP1ixAwF6u,SpATywNh6bZuzm8s1ceuBUnMUAeoAHHw,8,3,1,0,1,1,5,1,12,1.7142857142857142,1,0.0,0,1,0,1,3,1,0,5,1,2,10,1
8931,198592,CiLev4iw4aDKDkfbO8GSdlCCB3fQXQsY,A3fsA9Zfv1X2fVEQhTw51lKENdNrEqT3,10,4,3,0,2,0,4,0,13,1.8571428571428572,1,0.0,0,3,0,2,4,0,0,4,0,5,8,1
8932,198611,lMscwAq4rucD5Y2Dxs1NCZ0Ax6V2NgJ7,SpATywNh6bZuzm8s1ceuBUnMUAeoAHHw,5,3,2,0,1,0,1,0,7,1.0,1,0.0,0,2,0,1,3,0,0,1,0,3,4,1
8933,198616,odybwv6zTY9TMhO6yi1EIRr2WfIsx8N5,SpATywNh6bZuzm8s1ceuBUnMUAeoAHHw,1,0,0,0,0,0,1,0,1,0.14285714285714285,1,0.0,0,0,0,0,0,0,0,1,0,0,1,1
8934,198622,WV3YkTyrIBT24sYf1NcBchbLSWfuPseq,A3fsA9Zfv1X2fVEQhTw51lKENdNrEqT3,4,3,2,0,2,0,1,0,8,1.1428571428571428,1,0.0,0,2,0,2,3,0,0,1,0,4,4,1
8935,198623,Dzu6GQmc5vuwFq9gJBuCSSuvGPsIdsSj,SpATywNh6bZuzm8s1ceuBUnMUAeoAHHw,6,0,0,0,0,0,7,2,9,1.2857142857142858,1,0.0,0,0,0,0,0,0,0,7,2,0,9,1
8936,198631,Jvu0Hx9YHJ8mxetJAU2xMbziN16z8eDf,SpATywNh6bZuzm8s1ceuBUnMUAeoAHHw,12,7,5,0,4,1,5,1,23,3.2857142857142856,1,0.0,0,5,0,4,7,1,0,5,1,9,14,1
8937,198633,v8AEmfj5ScfNiqWSiB9twce4e05jQ9FQ,bWdj2GDclj5ofokWjzoa5jAwMkxCykd6,1,0,0,0,0,0,1,0,1,0.14285714285714285,1,0.0,0,0,0,0,0,0,0,1,0,0,1,1
8938,198639,9Nsgp7LQN84rKL9niMUlqjv8b2ci26i2,A3fsA9Zfv1X2fVEQhTw51lKENdNrEqT3,1,0,0,0,0,0,1,0,1,0.14285714285714285,1,0.0,0,0,0,0,0,0,0,1,0,0,1,1
8939,198641,boqZBuL5xdPgOX9TFr0s595aQRVHTZHS,SpATywNh6bZuzm8s1ceuBUnMUAeoAHHw,1,0,0,0,0,0,1,0,1,0.14285714285714285,1,0.0,0,0,0,0,0,0,0,1,0,0,1,1
8940,198648,pGAAxK6WZxbSHdtKKBvQSoYltPRqe43C,SpATywNh6bZuzm8s1ceuBUnMUAeoAHHw,6,3,1,0,1,0,2,0,7,1.0,1,0.0,0,1,0,1,3,0,0,2,0,2,5,1
8941,198672,GSkYUOcl4XzYMWSWhE6gXRGQ9kqPeXsi,bWdj2GDclj5ofokWjzoa5jAwMkxCykd6,9,5,3,28,3,0,2,0,41,5.857142857142857,1,0.0,1,3,27,3,4,0,1,2,0,34,7,1
8942,198675,34cVbMGyVO1SqQjOK9RNk00q4uKA3nIE,A3fsA9Zfv1X2fVEQhTw51lKENdNrEqT3,5,3,1,0,1,2,4,0,11,1.5714285714285714,1,0.0,1,1,0,1,2,2,0,4,0,3,8,1
8943,198714,MZXb9jchKEtLA37ZVUIxBtaUGdZhYeJT,G8EPVSXsOYB5YQWZGiz1aVq5Pgr2GrQu,4,2,1,0,1,0,1,0,5,0.7142857142857143,1,0.0,0,1,0,1,2,0,0,1,0,2,3,1
8944,198717,I2yihQ33CDsuDBZLIV6bzhSjVdIOvgGC,bWdj2GDclj5ofokWjzoa5jAwMkxCykd6,7,3,0,0,2,0,4,0,9,1.2857142857142858,1,0.0,2,0,0,2,1,0,0,4,0,4,5,1
8945,198720,GdwsSQDD3RD1ds1JuZBmFzmfEkBslekC,SpATywNh6bZuzm8s1ceuBUnMUAeoAHHw,4,3,0,0,0,0,2,0,5,0.7142857142857143,1,0.0,0,0,0,0,3,0,0,2,0,0,5,1
8946,198721,foGVhKIFjMIFQYicH2TLfLzHHE7pM4bi,A3fsA9Zfv1X2fVEQhTw51lKENdNrEqT3,7,2,1,0,0,1,6,1,11,1.5714285714285714,1,0.0,0,1,0,0,2,1,0,6,1,1,10,1
8947,198753,xX0iYdUwlCBlooAwOCU3ud9UtqInVGRm,A3fsA9Zfv1X2fVEQhTw51lKENdNrEqT3,12,8,6,0,3,7,6,1,31,4.428571428571429,1,0.0,0,6,0,3,8,7,0,6,1,9,22,1
8948,198758,7FTb8qcMeGic1m25RrAdw1gNnGsbUnQN,SpATywNh6bZuzm8s1ceuBUnMUAeoAHHw,13,17,7,0,3,0,8,1,36,5.142857142857143,1,0.0,4,7,0,3,13,0,0,8,1,14,22,1
8949,198767,rdXBX56hdm6MgOkqvDTZw84EG2v9Ij01,A3fsA9Zfv1X2fVEQhTw51lKENdNrEqT3,5,2,1,0,1,0,4,0,8,1.1428571428571428,1,0.0,0,1,0,1,2,0,0,4,0,2,6,1
8950,198777,bWklEyYoSpuuB2ZTCwBPrnaJDLkOGTMp,SpATywNh6bZuzm8s1ceuBUnMUAeoAHHw,1,0,0,0,0,0,1,0,1,0.14285714285714285,1,0.0,0,0,0,0,0,0,0,1,0,0,1,1
8951,198781,hkPW1meCvutegNytZP5zAHZkZdu7wM1N,G8EPVSXsOYB5YQWZGiz1aVq5Pgr2GrQu,6,7,5,0,4,0,4,0,20,2.857142857142857,1,0.0,0,5,0,4,7,0,0,4,0,9,11,1
8952,198795,v4qKKz4EWeiMbiMd1pppvrFEFDQHnpRJ,G8EPVSXsOYB5YQWZGiz1aVq5Pgr2GrQu,8,7,3,0,3,0,1,0,14,2.0,1,0.0,3,3,0,3,4,0,0,1,0,9,5,1
8953,198797,u601bf5LgTloUnzWrvF8VsEbNdAIplE1,A3fsA9Zfv1X2fVEQhTw51lKENdNrEqT3,1,0,0,0,0,0,2,0,2,0.2857142857142857,1,0.0,0,0,0,0,0,0,0,2,0,0,2,1
8954,198800,wnDMDigjN4PlQ0HWg6PwACxEoBUS4Gx4,A3fsA9Zfv1X2fVEQhTw51lKENdNrEqT3,4,2,0,0,0,0,2,0,4,0.5714285714285714,1,0.0,0,0,0,0,2,0,0,2,0,0,4,1
8955,198803,9N7TqBwx16hmfqT5WweyvUVrAeU2Gds6,SpATywNh6bZuzm8s1ceuBUnMUAeoAHHw,10,15,6,0,4,1,1,0,27,3.857142857142857,1,0.0,3,6,0,4,12,1,0,1,0,13,14,1
8956,198804,oOPW8b1yKsHdoM2CKb7DyH4zCUGTI2L7,G8EPVSXsOYB5YQWZGiz1aVq5Pgr2GrQu,7,3,2,0,2,0,4,0,11,1.5714285714285714,1,0.0,0,2,0,2,3,0,0,4,0,4,7,1
8957,198813,bu3K5v9qe8b55yPk6H1Kzu2kZgUnBQeS,bWdj2GDclj5ofokWjzoa5jAwMkxCykd6,1,0,0,0,0,0,1,0,1,0.14285714285714285,1,0.0,0,0,0,0,0,0,0,1,0,0,1,1
8958,198818,4JyZWYWxxqGCPr9dTz7bgpLcCXWs003A,G8EPVSXsOYB5YQWZGiz1aVq5Pgr2GrQu,7,1,1,0,1,0,5,0,8,1.1428571428571428,1,0.0,0,1,0,1,1,0,0,5,0,2,6,1
8959,198824,AG3Ywlgg0zeoJMMzx5kl7d9PzkM3xyjk,A3fsA9Zfv1X2fVEQhTw51lKENdNrEqT3,18,9,7,0,6,0,6,1,29,4.142857142857143,1,0.0,0,7,0,6,9,0,0,6,1,13,16,1
8960,198827,2ULjUBKcAnyQSi1NZFeDGBWEU4kETCtv,G8EPVSXsOYB5YQWZGiz1aVq5Pgr2GrQu,18,24,11,40,5,3,4,0,87,12.428571428571429,1,0.0,7,11,33,5,17,3,7,4,0,56,31,1
8961,198843,nhKo3n0QtoNri1dTW77ZJUsuajlfq52l,SpATywNh6bZuzm8s1ceuBUnMUAeoAHHw,6,4,3,0,3,0,1,0,11,1.5714285714285714,1,0.0,0,3,0,3,4,0,0,1,0,6,5,1
8962,198861,HhUNMDqxiy7U4QVsVWLmXLfoPctCDoGr,SpATywNh6bZuzm8s1ceuBUnMUAeoAHHw,3,0,0,0,0,1,2,0,3,0.42857142857142855,1,0.0,0,0,0,0,0,1,0,2,0,0,3,1
8963,198876,3FwKlBDtKGlNAYyQNzHL1qfkuXpNOPVW,bWdj2GDclj5ofokWjzoa5jAwMkxCykd6,1,0,0,0,0,0,1,0,1,0.14285714285714285,1,0.0,0,0,0,0,0,0,0,1,0,0,1,1
8964,198881,R2bf9dlDhtEUgfKzXR1GPBa12LhUfZ8W,A3fsA9Zfv1X2fVEQhTw51lKENdNrEqT3,6,4,3,0,2,0,1,0,10,1.4285714285714286,1,0.0,0,3,0,2,4,0,0,1,0,5,5,1
8965,198883,TwsuaxQpuQH4X71hofoKVQ1FXkHOyr0Z,bWdj2GDclj5ofokWjzoa5jAwMkxCykd6,8,2,1,0,1,0,5,1,10,1.4285714285714286,1,0.0,1,1,0,1,1,0,0,5,1,3,7,1
8966,198887,IGs2FsXHkQDnXVyqCPa0nawJqdQ0PAsD,SpATywNh6bZuzm8s1ceuBUnMUAeoAHHw,1,0,0,0,0,0,1,0,1,0.14285714285714285,1,0.0,0,0,0,0,0,0,0,1,0,0,1,1
8967,198897,Isy1saDmyEIfHHr1kPm1JUuUBknEItqI,SpATywNh6bZuzm8s1ceuBUnMUAeoAHHw,1,0,0,0,0,0,1,0,1,0.14285714285714285,1,0.0,0,0,0,0,0,0,0,1,0,0,1,1
8968,198900,r4qXpyLtUsV0WLMpP48wcQ1UcY1so2Nu,G8EPVSXsOYB5YQWZGiz1aVq5Pgr2GrQu,10,5,4,0,3,0,2,0,14,2.0,1,0.0,0,4,0,3,5,0,0,2,0,7,7,1
8969,198908,pSRqXJrhW3cpcIMqshrNJY13lAR5UPwX,bWdj2GDclj5ofokWjzoa5jAwMkxCykd6,1,0,0,0,0,0,1,0,1,0.14285714285714285,1,0.0,0,0,0,0,0,0,0,1,0,0,1,1
8970,198912,nKVAY2GHYnzf4BfG261ddlVdtqvsIA9B,bWdj2GDclj5ofokWjzoa5jAwMkxCykd6,4,2,1,0,1,0,2,0,6,0.8571428571428571,1,0.0,0,1,0,1,2,0,0,2,0,2,4,1
8971,198919,1j8gbclC0lfQw1ATQbildJE9fULo0ecU,A3fsA9Zfv1X2fVEQhTw51lKENdNrEqT3,5,2,1,0,1,0,2,0,6,0.8571428571428571,1,0.0,0,1,0,1,2,0,0,2,0,2,4,1
8972,198934,YQQ0U1ySGhxQGw2MpzkqAJru8VuefP0L,A3fsA9Zfv1X2fVEQhTw51lKENdNrEqT3,6,2,1,0,1,7,7,1,19,2.7142857142857144,1,0.0,0,1,0,1,2,7,0,7,1,2,17,1
8973,198949,sNbuAEBvvCL9s1FspvGXLJVjQkFzxwpw,bWdj2GDclj5ofokWjzoa5jAwMkxCykd6,4,2,0,0,0,0,2,0,4,0.5714285714285714,1,0.0,0,0,0,0,2,0,0,2,0,0,4,1
8974,198961,mJt5KMSSr7JvGBEQNnS7zxJqeuNThNSs,SpATywNh6bZuzm8s1ceuBUnMUAeoAHHw,7,5,4,0,4,0,2,0,15,2.142857142857143,1,0.0,0,4,0,4,5,0,0,2,0,8,7,1
8975,198967,2oTvbzieHn2y5oozeOgSnruqE6N0BtR5,SpATywNh6bZuzm8s1ceuBUnMUAeoAHHw,7,3,2,0,2,3,2,0,12,1.7142857142857142,1,0.0,0,2,0,2,3,3,0,2,0,4,8,1
8976,198990,2SHX7pefWKxAdle5f43dow0MyPOF6YGF,SpATywNh6bZuzm8s1ceuBUnMUAeoAHHw,6,3,0,0,0,1,4,0,8,1.1428571428571428,1,0.0,0,0,0,0,3,1,0,4,0,0,8,1
8977,198997,37OFfdd4jVDH9Wkzlzun8gwzZeYEoVZi,SpATywNh6bZuzm8s1ceuBUnMUAeoAHHw,7,3,2,0,2,0,2,0,9,1.2857142857142858,1,0.0,0,2,0,2,3,0,0,2,0,4,5,1
8978,198998,2oTvbzieHn2y5oozeOgSnruqE6N0BtR5,G8EPVSXsOYB5YQWZGiz1aVq5Pgr2GrQu,11,6,4,0,4,8,2,0,24,3.4285714285714284,1,0.0,1,4,0,4,5,8,0,2,0,9,15,1
8979,199003,z8AZNvy0mvqias2V5LoDHYpS46oKfDaS,RXDvfPUBYFlVdlueBFbLW0mhhAyGEqpt,2,0,0,0,0,0,2,0,2,0.2857142857142857,1,0.0,0,0,0,0,0,0,0,2,0,0,2,1
8980,199007,TqIBAk7ZVNx5vdURE7Yh8YGgkMcauYpn,A3fsA9Zfv1X2fVEQhTw51lKENdNrEqT3,5,4,3,0,0,0,2,0,9,1.2857142857142858,1,0.0,0,3,0,0,4,0,0,2,0,3,6,1
8981,199048,seGsWY5pHJdYc0dygxkfgWkiK3wzJxVH,A3fsA9Zfv1X2fVEQhTw51lKENdNrEqT3,5,3,1,0,1,0,2,0,7,1.0,1,0.0,1,1,0,1,2,0,0,2,0,3,4,1
8982,199063,ODCx2UO2z0ldelF48alKkiQzrvYMM8sJ,G8EPVSXsOYB5YQWZGiz1aVq5Pgr2GrQu,9,6,3,2,1,0,9,0,21,3.0,1,0.0,3,3,2,1,3,0,0,9,0,9,12,1
8983,199068,TTLR6K3ZlbSrGOfX2kjd2U4ChldGiopU,RXDvfPUBYFlVdlueBFbLW0mhhAyGEqpt,5,3,1,0,0,0,3,0,7,1.0,1,0.0,0,1,0,0,3,0,0,3,0,1,6,1
8984,199070,mne1Bu1F2f0U7iravmS4eQYQtLTkVvPe,A3fsA9Zfv1X2fVEQhTw51lKENdNrEqT3,9,4,3,0,3,0,3,0,13,1.8571428571428572,1,0.0,0,3,0,3,4,0,0,3,0,6,7,1
8985,199075,zmFq2MrnMqSFLtSy4w1SV24s7OiYosym,A3fsA9Zfv1X2fVEQhTw51lKENdNrEqT3,4,2,1,0,1,0,1,0,5,0.7142857142857143,1,0.0,0,1,0,1,2,0,0,1,0,2,3,1
8986,200156,VlDniFDr4BUyYYqSDi6VTSgVdE4PjFNm,fbPkOYLVPtPgIt0MxizjfFJov3JbHyAi,2,0,0,0,0,0,4,0,4,0.5714285714285714,1,0.0,0,0,0,0,0,0,0,4,0,0,4,1
8987,200158,OBrE671jmAa0zcKhOwZbsgknJEYhO9ZQ,fbPkOYLVPtPgIt0MxizjfFJov3JbHyAi,6,3,1,0,1,0,4,0,9,1.2857142857142858,1,0.0,0,1,0,1,3,0,0,4,0,2,7,1
8988,200160,WY8ZjTYNIGxqmEBUqyR8YNe7kour5nSN,fbPkOYLVPtPgIt0MxizjfFJov3JbHyAi,2,0,0,0,0,0,2,0,2,0.2857142857142857,1,0.0,0,0,0,0,0,0,0,2,0,0,2,1
8989,200161,3GyPhLgeVf6ayT8WwMOzrwG0vX3cMBOI,fbPkOYLVPtPgIt0MxizjfFJov3JbHyAi,14,14,7,8,6,1,14,2,52,7.428571428571429,1,0.0,4,7,6,6,10,1,2,14,2,23,29,1
8990,200164,SEHcNh1vMg4ZLYiSoUqvCFsKMsJ8CB2i,fbPkOYLVPtPgIt0MxizjfFJov3JbHyAi,1,0,0,0,0,0,1,0,1,0.14285714285714285,1,0.0,0,0,0,0,0,0,0,1,0,0,1,1
8991,200167,iwXVrgcqAKROauUa9mk2BApUHKtwoacr,fbPkOYLVPtPgIt0MxizjfFJov3JbHyAi,5,2,1,0,1,0,2,0,6,0.8571428571428571,1,0.0,0,1,0,1,2,0,0,2,0,2,4,1
8992,200168,AYthRqjUqxgBOMkMdZlsA0hn0RkYMhX1,fbPkOYLVPtPgIt0MxizjfFJov3JbHyAi,11,14,9,0,8,1,3,0,35,5.0,1,0.0,3,9,0,8,11,1,0,3,0,20,15,1
8993,200170,8uvIif4A5L5EPYASYSg4Tx0sVAF45af4,fbPkOYLVPtPgIt0MxizjfFJov3JbHyAi,2,2,0,0,0,0,0,0,2,0.2857142857142857,1,0.0,0,0,0,0,2,0,0,0,0,0,2,1
8994,200172,TNhUrfYcya3yxRpJxMcmjGjIL7iLVR1R,fbPkOYLVPtPgIt0MxizjfFJov3JbHyAi,1,0,0,0,0,0,1,0,1,0.14285714285714285,1,0.0,0,0,0,0,0,0,0,1,0,0,1,1
8995,200174,5OFiMxDgE4Mm8y2SD0A2gGR1Jne1kbKh,fbPkOYLVPtPgIt0MxizjfFJov3JbHyAi,4,2,1,0,0,0,2,0,5,0.7142857142857143,1,0.0,0,1,0,0,2,0,0,2,0,1,4,1
8996,200176,pzhB8LO3WWjbU215lU1c8Ly5btvgYfuP,fbPkOYLVPtPgIt0MxizjfFJov3JbHyAi,6,0,0,0,0,2,7,1,10,1.4285714285714286,1,0.0,0,0,0,0,0,2,0,7,1,0,10,1
