,enrollment_id,username,course_id,no_of_objects1,bno_access1,bno_pageclose1,bno_problem1,bno_video1,bno_discussion1,bno_navigate1,bno_wiki1,bno_total1,bno_avg1,no_of_active_days1,time_consumption1,browser_access1,browser_pageclose1,browser_problem1,browser_video1,server_access1,server_discussion1,server_problem1,server_navigate1,server_wiki1,bno_browser1,bno_server1,label
0,3,1qXC7Fjbwp66GPQc6pHLfEuO8WKozxG4,7GRhBDsirIGkRZBtSMEzNTyDr2JQm4xx,13,9,2,14,1,0,5,0,31,4.428571428571429,2,-1759501.0,4,2,14,1,5,0,0,5,0,21,10,0
1,5,p1Mp7WkVfzUijX0peVQKSHbgd5pXyl4c,7GRhBDsirIGkRZBtSMEzNTyDr2JQm4xx,34,53,20,45,13,5,11,0,147,21.0,2,0.0,28,20,37,13,25,5,8,11,0,98,49,0
2,7,I1KwJ6EdCZnEPLfC8Q7yWpIkLOHn7h02,7GRhBDsirIGkRZBtSMEzNTyDr2JQm4xx,30,59,20,34,22,0,10,0,145,20.714285714285715,2,0.0,33,20,31,22,26,0,3,10,0,106,39,1
3,45,5Tz6BGN7p1lkmdoopAY1Z5ufYTrUsi9E,7GRhBDsirIGkRZBtSMEzNTyDr2JQm4xx,3,2,1,0,0,0,1,0,4,0.5714285714285714,1,0.0,0,1,0,0,2,0,0,1,0,1,3,0
4,49,2oTvbzieHn2y5oozeOgSnruqE6N0BtR5,7GRhBDsirIGkRZBtSMEzNTyDr2JQm4xx,28,102,52,16,15,504,62,0,751,107.28571428571429,7,0.0,17,52,8,15,85,504,8,62,0,92,659,0
5,50,LnNj9zDI8D38ixGOYTIjTH2iF5m36v9S,7GRhBDsirIGkRZBtSMEzNTyDr2JQm4xx,9,11,3,6,0,0,3,0,23,3.2857142857142856,2,0.0,4,3,6,0,7,0,0,3,0,13,10,1
6,58,l9KseRU4xYtwOzoILYmGcicF0iiXQqxl,7GRhBDsirIGkRZBtSMEzNTyDr2JQm4xx,37,85,25,45,8,19,19,2,203,29.0,5,0.0,35,25,41,8,50,19,4,19,2,109,94,0
7,96,KXi2lu4GlKmrO1lJTLg3t4l701rvNXNZ,7GRhBDsirIGkRZBtSMEzNTyDr2JQm4xx,20,34,17,8,15,0,2,0,76,10.857142857142858,3,0.0,13,17,7,15,21,0,1,2,0,52,24,1
8,134,Q5TmTVdy8nnH2vTL73s67ZseaCMO3k91,7GRhBDsirIGkRZBtSMEzNTyDr2JQm4xx,8,4,3,2,3,0,2,0,14,2.0,1,0.0,1,3,2,3,3,0,0,2,0,9,5,1
9,192,hCxbmPBmjgsEuMY36HnZH4x3BwWFnCUn,7GRhBDsirIGkRZBtSMEzNTyDr2JQm4xx,41,67,23,24,23,0,8,0,145,20.714285714285715,3,0.0,44,23,21,23,23,0,3,8,0,111,34,0
10,199,OEQBiRbbo3yEBzKSHcNX9ESBTSUy08ze,7GRhBDsirIGkRZBtSMEzNTyDr2JQm4xx,34,56,15,54,10,21,21,4,181,25.857142857142858,2,0.0,40,15,46,10,16,21,8,21,4,111,70,0
11,219,088SASUPOVYUGhoEly8vlrkGvRBJoNwp,7GRhBDsirIGkRZBtSMEzNTyDr2JQm4xx,35,253,75,54,15,167,60,9,633,90.42857142857143,5,0.0,128,75,50,15,125,167,4,60,9,268,365,0
12,284,L9qMLlGWAeAI6zWAZIyJtn0wISNa3dxg,7GRhBDsirIGkRZBtSMEzNTyDr2JQm4xx,9,17,3,6,1,165,31,0,223,31.857142857142858,7,0.0,1,3,5,1,16,165,1,31,0,10,213,0
13,433,PEDnL2c66c2DN92O9BTVM9D6p19gGbT6,7GRhBDsirIGkRZBtSMEzNTyDr2JQm4xx,14,12,6,8,5,1,5,1,38,5.428571428571429,2,0.0,4,6,7,5,8,1,1,5,1,22,16,0
14,493,xNkIHhqS8GZXIqyoWwwS3ZeYfSmUsNJo,7GRhBDsirIGkRZBtSMEzNTyDr2JQm4xx,31,59,16,54,18,0,2,0,149,21.285714285714285,3,0.0,26,16,44,18,33,0,10,2,0,104,45,0
15,777,bLIF0ETNcg7fjkutu8YBWJptM3zxtu2Z,7GRhBDsirIGkRZBtSMEzNTyDr2JQm4xx,7,8,3,2,3,6,7,0,29,4.142857142857143,4,0.0,3,3,2,3,5,6,0,7,0,11,18,0
16,780,anqtRE1JbVfWjk9aVYgpNXBcTCoFe9WO,7GRhBDsirIGkRZBtSMEzNTyDr2JQm4xx,34,74,26,74,15,5,17,1,212,30.285714285714285,3,0.0,29,26,64,15,45,5,10,17,1,134,78,1
17,936,Z4uUjFPFbGNbmcg4E2opeBQCoO0nQyZe,7GRhBDsirIGkRZBtSMEzNTyDr2JQm4xx,17,41,19,0,6,4,9,0,79,11.285714285714286,3,0.0,16,19,0,6,25,4,0,9,0,41,38,1
18,937,uQjl8NGtIQkRfoe9edBiMgtYYmdkzVXR,7GRhBDsirIGkRZBtSMEzNTyDr2JQm4xx,3,3,1,0,0,0,2,0,6,0.8571428571428571,2,0.0,0,1,0,0,3,0,0,2,0,1,5,0
19,966,uVv1ioGVvP0A5CGQgSQhVTbH75lJRG4O,7GRhBDsirIGkRZBtSMEzNTyDr2JQm4xx,6,8,0,0,1,1,4,0,14,2.0,2,0.0,2,0,0,1,6,1,0,4,0,3,11,1
20,1030,uDdfaOyae5qLVYC8BQlj5xLhiV3is9wS,7GRhBDsirIGkRZBtSMEzNTyDr2JQm4xx,30,108,47,7,10,180,21,1,374,53.42857142857143,5,0.0,51,47,5,10,57,180,2,21,1,113,261,0
21,1090,9ct6Fth9rRpjZJrFIHs9xOnW9W5hBHw6,7GRhBDsirIGkRZBtSMEzNTyDr2JQm4xx,5,2,1,0,1,0,2,0,6,0.8571428571428571,1,0.0,0,1,0,1,2,0,0,2,0,2,4,1
22,1134,Q3zkClKdiEJIkoKspwBuSNOwYXuxalAX,7GRhBDsirIGkRZBtSMEzNTyDr2JQm4xx,5,2,1,0,1,0,2,0,6,0.8571428571428571,1,0.0,0,1,0,1,2,0,0,2,0,2,4,1
23,1206,ymJGsoe3Y9XwSfD9UhxMG8gRl87RdPUe,7GRhBDsirIGkRZBtSMEzNTyDr2JQm4xx,10,20,10,8,7,0,3,0,48,6.857142857142857,2,0.0,5,10,7,7,15,0,1,3,0,29,19,1
24,1223,o7MfiO1X5Ui1AYG08PXFhTcXSShcuNhK,7GRhBDsirIGkRZBtSMEzNTyDr2JQm4xx,5,2,1,0,1,0,2,0,6,0.8571428571428571,1,0.0,0,1,0,1,2,0,0,2,0,2,4,0
25,1227,RuOAeaUVW53IP9AqfP0jxaXbNkmd7lKN,7GRhBDsirIGkRZBtSMEzNTyDr2JQm4xx,2,0,0,0,0,0,2,0,2,0.2857142857142857,1,0.0,0,0,0,0,0,0,0,2,0,0,2,0
26,1252,mZIaM3Lmux7GERtSm258BKPOSUYFlwyy,7GRhBDsirIGkRZBtSMEzNTyDr2JQm4xx,24,69,1,50,4,24,11,0,159,22.714285714285715,4,0.0,36,1,42,4,33,24,8,11,0,83,76,0
27,1260,beV03mdN2n7VoZwDqBMCKGETqOChXWUx,7GRhBDsirIGkRZBtSMEzNTyDr2JQm4xx,35,208,71,67,22,59,25,1,453,64.71428571428571,3,0.0,69,71,62,22,139,59,5,25,1,224,229,0
28,1289,zlsPhArkUaQ0CCdgZTO1797WJjiciHBk,7GRhBDsirIGkRZBtSMEzNTyDr2JQm4xx,31,59,26,55,14,42,14,0,210,30.0,5,0.0,25,26,47,14,34,42,8,14,0,112,98,0
29,1450,q88579uTDrz7tsNTbZoL3mbWXAP4ClqK,7GRhBDsirIGkRZBtSMEzNTyDr2JQm4xx,23,58,23,4,17,12,17,2,133,19.0,4,0.0,27,23,3,17,31,12,1,17,2,70,63,0
30,1491,lCyf3TRKW0i3K1mBgKz23OONMdCWqNsI,7GRhBDsirIGkRZBtSMEzNTyDr2JQm4xx,31,109,7,88,8,36,48,8,304,43.42857142857143,5,0.0,64,7,75,8,45,36,13,48,8,154,150,0
31,1529,DT600yQDJaU6nnkoEQdVx5gZnWz5FfNY,7GRhBDsirIGkRZBtSMEzNTyDr2JQm4xx,26,104,1,72,3,8,21,1,210,30.0,2,0.0,29,1,62,3,75,8,10,21,1,95,115,0
32,1576,d9rEzZ3v1PmiMyudpVDJ4ystf1RU9dCH,7GRhBDsirIGkRZBtSMEzNTyDr2JQm4xx,16,28,5,8,2,1,18,2,64,9.142857142857142,4,0.0,8,5,7,2,20,1,1,18,2,22,42,1
33,1593,rLQXRKLwDTvBugA3fH8VUxASy31pAAsE,7GRhBDsirIGkRZBtSMEzNTyDr2JQm4xx,32,112,41,68,21,55,11,5,313,44.714285714285715,5,0.0,61,41,59,21,51,55,9,11,5,182,131,1
34,1594,argwyep7vMTLtgODtMQ0gxLXJNoq9csR,7GRhBDsirIGkRZBtSMEzNTyDr2JQm4xx,17,25,6,17,4,0,4,0,56,8.0,3,0.0,6,6,15,4,19,0,2,4,0,31,25,1
35,1616,Bi4hHmeTLwTbUCScu9tC6ZZN7frLUhVP,7GRhBDsirIGkRZBtSMEzNTyDr2JQm4xx,2,0,0,0,0,0,3,0,3,0.42857142857142855,1,0.0,0,0,0,0,0,0,0,3,0,0,3,0
36,1630,BN8wlDCfm46NLUt2P4jjdpJvase6IJc9,7GRhBDsirIGkRZBtSMEzNTyDr2JQm4xx,29,90,25,41,13,5,16,0,190,27.142857142857142,4,0.0,42,25,39,13,48,5,2,16,0,119,71,1
37,1697,LdIFMEp4Gma3xMuOQ2mpp1BJ3jFvB9c2,7GRhBDsirIGkRZBtSMEzNTyDr2JQm4xx,28,43,10,40,9,3,3,0,108,15.428571428571429,3,0.0,22,10,32,9,21,3,8,3,0,73,35,0
38,1756,wc32nzp9MMjroUa1gifXyCPIfYwLXy9J,7GRhBDsirIGkRZBtSMEzNTyDr2JQm4xx,36,50,21,39,15,10,27,2,164,23.428571428571427,4,0.0,22,21,34,15,28,10,5,27,2,92,72,1
39,1804,qRMvc4T53dkwmyfrgm76E5HygPUZo2vr,fbPkOYLVPtPgIt0MxizjfFJov3JbHyAi,26,74,28,14,11,100,28,5,260,37.142857142857146,5,0.0,25,28,12,11,49,100,2,28,5,76,184,0
40,1807,tvXgoUvFgvHT9SyDah6Ue0bK2mvIbZdy,fbPkOYLVPtPgIt0MxizjfFJov3JbHyAi,24,78,49,22,27,61,14,0,251,35.857142857142854,2,0.0,23,49,17,27,55,61,5,14,0,116,135,0
41,1811,466PN9Ek5iJamUCk5pZUwazAoeVcTj9e,fbPkOYLVPtPgIt0MxizjfFJov3JbHyAi,7,11,6,0,4,0,4,0,25,3.5714285714285716,2,0.0,2,6,0,4,9,0,0,4,0,12,13,1
42,1815,EZXku3HiM8iDGMBMsO2RMLHj3AEpHhBq,fbPkOYLVPtPgIt0MxizjfFJov3JbHyAi,6,7,0,0,0,0,1,0,8,1.1428571428571428,1,0.0,0,0,0,0,7,0,0,1,0,0,8,0
43,1818,pIBqJuNsqTHvkyItKwWF6wLVRjCC6EZu,fbPkOYLVPtPgIt0MxizjfFJov3JbHyAi,9,24,12,0,7,5,21,0,69,9.857142857142858,1,0.0,5,12,0,7,19,5,0,21,0,24,45,1
44,1822,v1Dw0XqubI6wLrO1l5puralkQ2Aofi2j,fbPkOYLVPtPgIt0MxizjfFJov3JbHyAi,26,71,27,24,23,98,22,5,270,38.57142857142857,5,0.0,31,27,17,23,40,98,7,22,5,98,172,0
45,1826,5BwluL2iwK0HgKhM8FgXFAWZQHsXkB8V,fbPkOYLVPtPgIt0MxizjfFJov3JbHyAi,10,15,5,3,9,0,2,0,34,4.857142857142857,1,0.0,9,5,3,9,6,0,0,2,0,26,8,0
46,1830,dtAiYXul2PNEQLlJvo6qGgg8Rx9ORbY3,fbPkOYLVPtPgIt0MxizjfFJov3JbHyAi,7,2,1,0,1,1,7,1,13,1.8571428571428572,1,0.0,0,1,0,1,2,1,0,7,1,2,11,1
47,1845,oaoj9be4jW2Hot8wYgYrzLRvB0RU4KYy,fbPkOYLVPtPgIt0MxizjfFJov3JbHyAi,5,7,2,0,1,0,3,0,13,1.8571428571428572,3,0.0,0,2,0,1,7,0,0,3,0,3,10,0
48,1852,srnnzUkIJr2Uisav8LfnV4SnpbNw9CLp,fbPkOYLVPtPgIt0MxizjfFJov3JbHyAi,8,10,5,0,3,1,4,0,23,3.2857142857142856,1,0.0,3,5,0,3,7,1,0,4,0,11,12,1
49,1856,ScOtpH9Zf7UmvFfXBxi9XtXFmhGO9CpS,fbPkOYLVPtPgIt0MxizjfFJov3JbHyAi,27,59,27,17,21,85,34,3,246,35.142857142857146,7,0.0,17,27,16,21,42,85,1,34,3,81,165,0
50,1859,renLevNnf6MkkqeGAoBcuGxp4Cuebb9X,fbPkOYLVPtPgIt0MxizjfFJov3JbHyAi,13,37,21,0,6,49,50,10,173,24.714285714285715,3,0.0,0,21,0,6,37,49,0,50,10,27,146,0
51,1861,wHW6M4zJx3WQvnkWxa8NK7bA13uSffjE,fbPkOYLVPtPgIt0MxizjfFJov3JbHyAi,19,61,29,28,16,5,10,0,149,21.285714285714285,3,0.0,19,29,20,16,42,5,8,10,0,84,65,0
52,1862,w85QVmINOIyrXRzegh8uuBeGTw3K4uG8,fbPkOYLVPtPgIt0MxizjfFJov3JbHyAi,27,61,27,8,18,33,13,2,162,23.142857142857142,4,0.0,24,27,8,18,37,33,0,13,2,77,85,0
53,1863,2HxHgYZUxjcTVAkRZXALZPpAKp12AIkW,fbPkOYLVPtPgIt0MxizjfFJov3JbHyAi,17,37,12,11,12,35,25,4,136,19.428571428571427,3,0.0,11,12,8,12,26,35,3,25,4,43,93,1
54,1875,NmOI6yuIgn0ShW8ps51AeOISH4CX20PY,fbPkOYLVPtPgIt0MxizjfFJov3JbHyAi,2,0,0,0,0,0,3,0,3,0.42857142857142855,1,0.0,0,0,0,0,0,0,0,3,0,0,3,1
55,1888,lbgTV2YMskSv2TX4EXpaazpMVWfsftEV,fbPkOYLVPtPgIt0MxizjfFJov3JbHyAi,9,14,9,0,4,0,8,0,35,5.0,1,0.0,0,9,0,4,14,0,0,8,0,13,22,0
56,1891,s6iksgptFmyh2vfiarKdJkiKnp6RLi3f,fbPkOYLVPtPgIt0MxizjfFJov3JbHyAi,18,45,16,0,7,115,16,1,200,28.571428571428573,5,0.0,3,16,0,7,42,115,0,16,1,26,174,0
57,1894,Vc4rFh1HQZiO6qLgOrealEeiZYYPbmOY,fbPkOYLVPtPgIt0MxizjfFJov3JbHyAi,13,22,10,12,5,16,6,0,71,10.142857142857142,3,0.0,2,10,10,5,20,16,2,6,0,27,44,0
58,1899,CXDFvBGg10x2RDdl5BC09Fv76dN9FJm7,fbPkOYLVPtPgIt0MxizjfFJov3JbHyAi,25,41,12,28,9,5,3,0,98,14.0,2,0.0,13,12,26,9,28,5,2,3,0,60,38,0
59,1903,TkQQvYTOoXkFjbJKIO2v3OeQa3imG4fA,fbPkOYLVPtPgIt0MxizjfFJov3JbHyAi,26,42,13,11,19,20,11,1,117,16.714285714285715,2,0.0,27,13,10,19,15,20,1,11,1,69,48,0
60,1910,CtgLRd04Cnda49EWlN19NulXjkuBNDXd,fbPkOYLVPtPgIt0MxizjfFJov3JbHyAi,24,26,10,16,9,22,2,0,85,12.142857142857142,2,0.0,8,10,14,9,18,22,2,2,0,41,44,0
61,1923,UgNr6maIjrTPAjpLAvEGxJ6P02hrpr0j,fbPkOYLVPtPgIt0MxizjfFJov3JbHyAi,25,73,27,27,16,11,21,1,176,25.142857142857142,6,0.0,18,27,25,16,55,11,2,21,1,86,90,0
62,1926,5ZyvCd3AP7a8azCiLN5JfLAP53iZpAyD,fbPkOYLVPtPgIt0MxizjfFJov3JbHyAi,1,0,0,0,0,0,1,0,1,0.14285714285714285,1,0.0,0,0,0,0,0,0,0,1,0,0,1,1
63,1929,v9mjKPlqj9n2M1xFKzFtpQVo3yi6HxGV,fbPkOYLVPtPgIt0MxizjfFJov3JbHyAi,5,3,2,0,1,0,2,0,8,1.1428571428571428,1,0.0,0,2,0,1,3,0,0,2,0,3,5,1
64,1931,gUUf0vmNg6gEFqYol91VXQX0Cn6Mly3v,fbPkOYLVPtPgIt0MxizjfFJov3JbHyAi,24,78,46,17,26,0,6,0,173,24.714285714285715,6,0.0,19,46,14,26,59,0,3,6,0,105,68,0
65,1933,mNLR1O6gqXF6Zqi4uIf130gITni9gN1A,fbPkOYLVPtPgIt0MxizjfFJov3JbHyAi,19,25,17,0,11,0,9,0,62,8.857142857142858,5,0.0,2,17,0,11,23,0,0,9,0,30,32,0
66,1943,S1MqxZA8wNnn30FSBfJ8uK4pTicj2Ko9,fbPkOYLVPtPgIt0MxizjfFJov3JbHyAi,26,43,29,18,21,6,18,3,138,19.714285714285715,4,0.0,6,29,15,21,37,6,3,18,3,71,67,0
67,1945,KM3IAf1A23ZYRH7BjTN3a6rzUKD52rd8,fbPkOYLVPtPgIt0MxizjfFJov3JbHyAi,9,10,6,0,3,0,13,0,32,4.571428571428571,2,0.0,0,6,0,3,10,0,0,13,0,9,23,1
68,1951,dq3iqibSI5OSwCbWRZv7tfgbiuLwOgjh,fbPkOYLVPtPgIt0MxizjfFJov3JbHyAi,19,26,16,0,11,6,7,3,69,9.857142857142858,2,0.0,2,16,0,11,24,6,0,7,3,29,40,0
69,3982,Dw289XdbVPARtBCp3XyIbEXKo6sChudi,fbPkOYLVPtPgIt0MxizjfFJov3JbHyAi,12,15,5,5,5,8,7,1,46,6.571428571428571,1,0.0,5,5,4,5,10,8,1,7,1,19,27,1
70,3986,lri3Bm6mGdJ1wEpJO4c8fcTdLtxpvXa6,fbPkOYLVPtPgIt0MxizjfFJov3JbHyAi,10,14,5,0,5,9,13,0,46,6.571428571428571,2,0.0,2,5,0,5,12,9,0,13,0,12,34,0
71,3987,RvRsXzYULX8CJPXHa5mzL8AcNhscf6wx,fbPkOYLVPtPgIt0MxizjfFJov3JbHyAi,5,7,3,0,2,8,5,0,25,3.5714285714285716,2,0.0,0,3,0,2,7,8,0,5,0,5,20,1
72,3988,n6g50uYKXPDZP0tI3HvDI3sQlgkEYQ9t,fbPkOYLVPtPgIt0MxizjfFJov3JbHyAi,2,0,0,0,0,0,5,0,5,0.7142857142857143,1,0.0,0,0,0,0,0,0,0,5,0,0,5,1
73,3989,WQvAdilRxsksKqQWzKEILUwddYnT927z,fbPkOYLVPtPgIt0MxizjfFJov3JbHyAi,8,9,4,0,3,4,8,0,28,4.0,2,0.0,0,4,0,3,9,4,0,8,0,7,21,1
74,3990,IjNUKB7dvHimeVQdJPcMV9GHh8X3ACi4,fbPkOYLVPtPgIt0MxizjfFJov3JbHyAi,9,3,2,0,2,0,7,1,15,2.142857142857143,1,0.0,0,2,0,2,3,0,0,7,1,4,11,1
75,3991,affppoxqvCZhtMd3A1khAMJ6PTtvZhf9,fbPkOYLVPtPgIt0MxizjfFJov3JbHyAi,22,57,17,13,26,85,5,0,203,29.0,4,0.0,33,17,11,26,24,85,2,5,0,87,116,1
76,3992,uzWBIpHNnLP0Ck2jFJb3dlQmKW50Edgg,fbPkOYLVPtPgIt0MxizjfFJov3JbHyAi,9,7,4,0,3,0,12,0,26,3.7142857142857144,1,0.0,0,4,0,3,7,0,0,12,0,7,19,1
77,3993,LBiRwhykvYlkPokFukwKE3pfXRl4e4Nw,fbPkOYLVPtPgIt0MxizjfFJov3JbHyAi,10,43,26,0,12,1,15,1,98,14.0,5,0.0,3,26,0,12,40,1,0,15,1,41,57,1
78,3994,CAJTHZgER1cUEaMoS6UrUkuHNZZbsU9M,fbPkOYLVPtPgIt0MxizjfFJov3JbHyAi,26,40,17,22,15,15,9,2,120,17.142857142857142,3,0.0,17,17,16,15,23,15,6,9,2,65,55,1
79,3995,TYu8VgV6TkJO1pWVABdfXnpa6VWQUK0O,fbPkOYLVPtPgIt0MxizjfFJov3JbHyAi,11,15,6,3,9,1,7,1,42,6.0,3,0.0,8,6,3,9,7,1,0,7,1,26,16,1
80,3999,4IkxYjTflPhoHxhEdrFyf3T4ZXNMTaKd,fbPkOYLVPtPgIt0MxizjfFJov3JbHyAi,12,28,13,2,8,17,6,0,74,10.571428571428571,4,0.0,7,13,2,8,21,17,0,6,0,30,44,0
81,4000,A8rz0vMThAU17OyS7TiHPCSZ088mScoQ,fbPkOYLVPtPgIt0MxizjfFJov3JbHyAi,7,6,2,0,3,0,3,0,14,2.0,1,0.0,3,2,0,3,3,0,0,3,0,8,6,1
82,4001,NKzNFHK6LaJqjMec69ZX5HfBigF4yyJV,fbPkOYLVPtPgIt0MxizjfFJov3JbHyAi,21,45,4,14,2,39,13,1,118,16.857142857142858,3,0.0,9,4,12,2,36,39,2,13,1,27,91,1
83,4002,MoOt0pLc6LPrRtSRaIbD7yJ5rRpkSxQh,fbPkOYLVPtPgIt0MxizjfFJov3JbHyAi,9,9,3,0,5,10,7,2,36,5.142857142857143,1,0.0,5,3,0,5,4,10,0,7,2,13,23,1
84,4003,DgaifwdXOeOWB23pZZjNIgSww1uVv3vI,fbPkOYLVPtPgIt0MxizjfFJov3JbHyAi,6,5,2,0,1,0,9,0,17,2.4285714285714284,1,0.0,0,2,0,1,5,0,0,9,0,3,14,1
85,4005,HAPPxnLUjIhcauBZnnWBFk3JE6gETTxa,fbPkOYLVPtPgIt0MxizjfFJov3JbHyAi,8,5,3,0,2,0,4,0,14,2.0,2,0.0,0,3,0,2,5,0,0,4,0,5,9,0
86,4006,McVFksjsd7gqjfpNdRYswxB6Ly7zMDUI,fbPkOYLVPtPgIt0MxizjfFJov3JbHyAi,10,17,6,18,5,4,12,0,62,8.857142857142858,1,0.0,7,6,11,5,10,4,7,12,0,29,33,1
87,4010,tCXUYAVw455MAJWBfBlKD9PaArTnum6K,fbPkOYLVPtPgIt0MxizjfFJov3JbHyAi,5,2,1,0,1,0,3,0,7,1.0,1,0.0,0,1,0,1,2,0,0,3,0,2,5,1
88,4013,mDG9Rxl75Wy9jJLHldZXeLQnqCWbJnNh,fbPkOYLVPtPgIt0MxizjfFJov3JbHyAi,9,10,6,0,4,0,7,0,27,3.857142857142857,1,0.0,0,6,0,4,10,0,0,7,0,10,17,1
89,4014,cDTJe7mzABgZuuhVrbXbLDlWeF860dTW,fbPkOYLVPtPgIt0MxizjfFJov3JbHyAi,5,4,2,0,1,2,2,0,11,1.5714285714285714,1,0.0,0,2,0,1,4,2,0,2,0,3,8,1
90,4015,Sqb9rCT9CzMY8ZiGPrmmTQHW8dIqJZBT,fbPkOYLVPtPgIt0MxizjfFJov3JbHyAi,1,0,0,0,0,0,1,0,1,0.14285714285714285,1,0.0,0,0,0,0,0,0,0,1,0,0,1,1
91,4016,0OQWZBG0W4kepi8nreWMZMMypwSc3KLe,fbPkOYLVPtPgIt0MxizjfFJov3JbHyAi,20,52,33,0,12,31,18,2,148,21.142857142857142,6,0.0,9,33,0,12,43,31,0,18,2,54,94,0
92,4017,R0BF3k8rl0hN1Xjq59ZjmegVjqcKX9oA,fbPkOYLVPtPgIt0MxizjfFJov3JbHyAi,12,25,8,9,3,6,4,0,55,7.857142857142857,4,0.0,6,8,7,3,19,6,2,4,0,24,31,1
93,4018,PueCTOZid1NIenGrGQNvEExDupERGR94,fbPkOYLVPtPgIt0MxizjfFJov3JbHyAi,6,13,1,0,0,21,4,0,39,5.571428571428571,2,0.0,1,1,0,0,12,21,0,4,0,2,37,1
94,4019,dFrBZuKOTxv7Ek84BAuACScgZVHLiPRz,fbPkOYLVPtPgIt0MxizjfFJov3JbHyAi,11,13,7,0,6,4,7,1,38,5.428571428571429,3,0.0,3,7,0,6,10,4,0,7,1,16,22,0
95,4021,2txyeJeVHewFPGKztIs7LVNsRtu62SIj,fbPkOYLVPtPgIt0MxizjfFJov3JbHyAi,10,16,12,0,10,0,7,0,45,6.428571428571429,3,0.0,1,12,0,10,15,0,0,7,0,23,22,0
96,4022,CNy8nHnus6ReY45d9zqNv8rRJDfMythS,fbPkOYLVPtPgIt0MxizjfFJov3JbHyAi,10,11,5,0,5,0,5,0,26,3.7142857142857144,2,0.0,2,5,0,5,9,0,0,5,0,12,14,1
97,4024,UInMBEH8f1h2vxXVslRsWyLOTv8ggYq3,fbPkOYLVPtPgIt0MxizjfFJov3JbHyAi,35,141,65,20,38,212,24,4,504,72.0,6,0.0,39,65,15,38,102,212,5,24,4,157,347,0
98,4025,0XUEmNa1QlvbJ6h0wBm0Vh8YELQW58i8,fbPkOYLVPtPgIt0MxizjfFJov3JbHyAi,2,0,0,0,0,0,3,0,3,0.42857142857142855,1,0.0,0,0,0,0,0,0,0,3,0,0,3,1
99,4026,OMzzJICpXQ12vN2QhxiLmWbQhc59H2Je,fbPkOYLVPtPgIt0MxizjfFJov3JbHyAi,19,30,13,0,10,118,13,0,184,26.285714285714285,3,0.0,8,13,0,10,22,118,0,13,0,31,153,1
100,4028,BJaK31XM4DCMgldXltRIhwlSVt79ImvN,fbPkOYLVPtPgIt0MxizjfFJov3JbHyAi,1,0,0,0,0,0,1,0,1,0.14285714285714285,1,0.0,0,0,0,0,0,0,0,1,0,0,1,1
101,4029,Wkp6iolUyaZoJ05flcS8uKmcM1K0sTAZ,fbPkOYLVPtPgIt0MxizjfFJov3JbHyAi,6,7,4,0,2,1,3,0,17,2.4285714285714284,1,0.0,0,4,0,2,7,1,0,3,0,6,11,1
102,4030,qdFvSvAu7YEiiOuRfROhUegKEcAw8WjI,fbPkOYLVPtPgIt0MxizjfFJov3JbHyAi,9,7,3,0,3,0,5,0,18,2.5714285714285716,2,0.0,0,3,0,3,7,0,0,5,0,6,12,1
103,4031,l5LfU8gApOG72AnBkdAbfOLQLwFH7Zo2,fbPkOYLVPtPgIt0MxizjfFJov3JbHyAi,17,34,5,9,3,7,9,0,67,9.571428571428571,6,0.0,5,5,7,3,29,7,2,9,0,20,47,0
104,4035,YJ5mxpUsuGnox6GEy3E35b75l1Yuk6TC,fbPkOYLVPtPgIt0MxizjfFJov3JbHyAi,1,0,0,0,0,0,1,0,1,0.14285714285714285,1,0.0,0,0,0,0,0,0,0,1,0,0,1,1
105,4036,Y75HPUfsmJFX2l4CIc47CvtaKqz7eTTH,fbPkOYLVPtPgIt0MxizjfFJov3JbHyAi,5,2,1,0,1,0,2,0,6,0.8571428571428571,1,0.0,0,1,0,1,2,0,0,2,0,2,4,1
106,4039,nPGsjt6sk2qCL2FY7YNDGlVui96j8qhd,fbPkOYLVPtPgIt0MxizjfFJov3JbHyAi,24,22,10,14,11,0,7,0,64,9.142857142857142,2,0.0,10,10,13,11,12,0,1,7,0,44,20,0
107,4040,tmmvczbZLiPw6t5Ru9DTWRYnvMI3hKxN,fbPkOYLVPtPgIt0MxizjfFJov3JbHyAi,7,28,11,0,7,5,9,1,61,8.714285714285714,2,0.0,0,11,0,7,28,5,0,9,1,18,43,1
108,4042,03I1lWZt67ECKkJOIVeqAmBCKjZopH4v,fbPkOYLVPtPgIt0MxizjfFJov3JbHyAi,13,22,12,7,8,11,11,0,71,10.142857142857142,6,0.0,4,12,5,8,18,11,2,11,0,29,42,1
109,4044,dQeQGMqD2AfjLt9WMqT1wjR4i8srmTVY,fbPkOYLVPtPgIt0MxizjfFJov3JbHyAi,7,6,4,0,3,0,2,0,15,2.142857142857143,2,0.0,0,4,0,3,6,0,0,2,0,7,8,1
110,4046,FUyt82uYcKeXe5a1uDqi5Za4PXy0kx7h,fbPkOYLVPtPgIt0MxizjfFJov3JbHyAi,9,8,2,3,4,0,6,0,23,3.2857142857142856,1,0.0,5,2,2,4,3,0,1,6,0,13,10,1
111,4048,pWZNevyPOl4ouTcnYPIT4PYWT7cW7Aq7,fbPkOYLVPtPgIt0MxizjfFJov3JbHyAi,12,29,13,1,11,7,9,1,71,10.142857142857142,4,0.0,10,13,1,11,19,7,0,9,1,35,36,1
112,4052,e1CSwKLgflGiW7QjzYRNEoHjbDEH3F2k,fbPkOYLVPtPgIt0MxizjfFJov3JbHyAi,6,9,0,0,0,0,4,1,14,2.0,3,0.0,0,0,0,0,9,0,0,4,1,0,14,1
113,4054,hOv5RKQK1RGRxpJJGcW0k2cA3RwQ8Rk5,fbPkOYLVPtPgIt0MxizjfFJov3JbHyAi,11,24,8,5,7,17,8,0,69,9.857142857142858,2,0.0,8,8,4,7,16,17,1,8,0,27,42,1
114,4056,jcyuD7rFE4XO7CpWU6qjqHSzjWdDLgUn,fbPkOYLVPtPgIt0MxizjfFJov3JbHyAi,12,19,9,4,6,7,13,0,58,8.285714285714286,2,0.0,7,9,3,6,12,7,1,13,0,25,33,1
115,4060,vag0mKRhWPXqyPdrs8UzxFb02sZFFg3Z,fbPkOYLVPtPgIt0MxizjfFJov3JbHyAi,6,1,1,0,1,1,3,1,8,1.1428571428571428,1,0.0,0,1,0,1,1,1,0,3,1,2,6,1
116,4061,A7tHWOZtAjCVDU6Pkr6MtHjmqydOP5Uv,fbPkOYLVPtPgIt0MxizjfFJov3JbHyAi,8,5,3,0,2,0,2,0,12,1.7142857142857142,1,0.0,1,3,0,2,4,0,0,2,0,6,6,1
117,4062,GfQva8AQrZlwGbvyDGDInKzkvq0dln6l,fbPkOYLVPtPgIt0MxizjfFJov3JbHyAi,9,6,4,0,2,0,4,0,16,2.2857142857142856,1,0.0,0,4,0,2,6,0,0,4,0,6,10,1
118,4064,IhporhjBpD87E7pLhYtc9YRC8PipZyt6,fbPkOYLVPtPgIt0MxizjfFJov3JbHyAi,20,52,32,3,18,15,30,4,154,22.0,6,0.0,5,32,3,18,47,15,0,30,4,58,96,1
119,4065,6khySUugasTypUZbIissXWV1lXFT1d5n,fbPkOYLVPtPgIt0MxizjfFJov3JbHyAi,8,5,3,0,2,8,8,1,27,3.857142857142857,1,0.0,0,3,0,2,5,8,0,8,1,5,22,1
120,4066,0m3zP8nDyi6TxYSAa3KOP4WzeZItFG3V,fbPkOYLVPtPgIt0MxizjfFJov3JbHyAi,5,2,1,0,1,0,11,0,15,2.142857142857143,1,0.0,0,1,0,1,2,0,0,11,0,2,13,1
121,4070,bUizg9a7xaQ9xo39EDPwubco3asipi0e,fbPkOYLVPtPgIt0MxizjfFJov3JbHyAi,8,10,7,0,4,4,6,1,32,4.571428571428571,3,0.0,0,7,0,4,10,4,0,6,1,11,21,1
122,4071,HH3HV5HDJ35z2ldQAEIDXBOSBTxLd6O9,fbPkOYLVPtPgIt0MxizjfFJov3JbHyAi,8,12,8,0,4,11,6,0,41,5.857142857142857,2,0.0,0,8,0,4,12,11,0,6,0,12,29,1
123,4072,kHp5QZURLzbWn4koqFYZnQmO0kliz5hb,fbPkOYLVPtPgIt0MxizjfFJov3JbHyAi,25,36,19,16,13,9,7,0,100,14.285714285714286,3,0.0,9,19,14,13,27,9,2,7,0,55,45,0
124,4077,reYWWuBxz5Nnxq3jAGjfGe1NyMEEto5R,fbPkOYLVPtPgIt0MxizjfFJov3JbHyAi,26,55,18,12,22,43,30,23,203,29.0,4,0.0,31,18,11,22,24,43,1,30,23,82,121,1
125,4081,GXuacM1G2BzxiXouSVLnDv1V97NGwCCe,fbPkOYLVPtPgIt0MxizjfFJov3JbHyAi,10,17,8,0,3,0,9,1,38,5.428571428571429,2,0.0,0,8,0,3,17,0,0,9,1,11,27,1
126,4083,5tD3trtPQ6jzqFRimP1PMPhgvFtRmfA4,fbPkOYLVPtPgIt0MxizjfFJov3JbHyAi,9,14,6,0,3,6,7,1,37,5.285714285714286,3,0.0,0,6,0,3,14,6,0,7,1,9,28,1
127,4084,a4RYqILKcnu8c617gYSbD0KQIm9DqZnc,fbPkOYLVPtPgIt0MxizjfFJov3JbHyAi,3,4,0,0,0,0,1,0,5,0.7142857142857143,1,0.0,0,0,0,0,4,0,0,1,0,0,5,1
128,4088,czTQ5ELSy91Dy79vk5MgxZdL9nunJtpb,fbPkOYLVPtPgIt0MxizjfFJov3JbHyAi,4,3,0,0,0,0,7,0,10,1.4285714285714286,1,0.0,0,0,0,0,3,0,0,7,0,0,10,1
129,4090,1nooHXMbJhGPsGTrHpT4esI4WCkiFA2H,fbPkOYLVPtPgIt0MxizjfFJov3JbHyAi,8,8,5,0,3,0,6,0,22,3.142857142857143,1,0.0,0,5,0,3,8,0,0,6,0,8,14,1
130,4091,BbZEGv8zMCuD8c0LXrenf9W1lGSlVd04,fbPkOYLVPtPgIt0MxizjfFJov3JbHyAi,18,22,9,8,10,0,3,0,52,7.428571428571429,2,0.0,4,9,5,10,18,0,3,3,0,28,24,1
131,4093,zLfLf7Y2Kf0HyKtBcK0c943FFMXMBiGO,fbPkOYLVPtPgIt0MxizjfFJov3JbHyAi,12,23,7,0,6,7,4,0,47,6.714285714285714,2,0.0,3,7,0,6,20,7,0,4,0,16,31,1
132,4095,ijFjDmHOLiyu54Ko0v4roRDWdDCIX5i1,fbPkOYLVPtPgIt0MxizjfFJov3JbHyAi,14,30,14,3,11,2,8,1,69,9.857142857142858,4,0.0,6,14,3,11,24,2,0,8,1,34,35,0
133,4097,CVQI4y90zNEQKnbziqeit6sPoxhPlPMP,fbPkOYLVPtPgIt0MxizjfFJov3JbHyAi,7,2,1,0,1,0,3,0,7,1.0,1,0.0,0,1,0,1,2,0,0,3,0,2,5,1
134,4101,pWkLIEFKVWp1dpRpiw46ybvs7QZ4nDA4,fbPkOYLVPtPgIt0MxizjfFJov3JbHyAi,7,5,2,0,0,0,7,0,14,2.0,2,0.0,0,2,0,0,5,0,0,7,0,2,12,1
135,4103,Y1ppxEgbx61jNTLCoOABIFXnW04QUYST,fbPkOYLVPtPgIt0MxizjfFJov3JbHyAi,7,3,2,0,2,0,4,0,11,1.5714285714285714,1,0.0,0,2,0,2,3,0,0,4,0,4,7,1
136,4105,VJ15PTmNAjfB6ipRCoKMs7aSjJuraSNv,fbPkOYLVPtPgIt0MxizjfFJov3JbHyAi,26,49,17,24,11,39,12,1,153,21.857142857142858,6,0.0,14,17,21,11,35,39,3,12,1,63,90,1
137,4106,TMVzoCHYEzB4dA3dJFO0jufgXr0xWoMt,fbPkOYLVPtPgIt0MxizjfFJov3JbHyAi,6,7,1,0,1,0,2,0,11,1.5714285714285714,1,0.0,3,1,0,1,4,0,0,2,0,5,6,1
138,4108,ILcXhWva6fUJAzRZSl16N8h2AK8Jjf9I,fbPkOYLVPtPgIt0MxizjfFJov3JbHyAi,7,8,2,0,2,0,3,0,15,2.142857142857143,1,0.0,0,2,0,2,8,0,0,3,0,4,11,1
139,4111,blTEANBNlwleHMZh60k5xSk9rNOJZKek,fbPkOYLVPtPgIt0MxizjfFJov3JbHyAi,2,0,0,0,0,0,6,0,6,0.8571428571428571,2,0.0,0,0,0,0,0,0,0,6,0,0,6,1
140,4112,FM7f8SmryrQv0xQWmeGBOm7E9JzAE7cF,fbPkOYLVPtPgIt0MxizjfFJov3JbHyAi,12,17,6,0,5,20,10,1,59,8.428571428571429,2,0.0,4,6,0,5,13,20,0,10,1,15,44,1
141,4113,uYnLLjFhtmRLfdb6UnGOhZKWKwE2Sz7S,fbPkOYLVPtPgIt0MxizjfFJov3JbHyAi,1,0,0,0,0,0,3,0,3,0.42857142857142855,1,0.0,0,0,0,0,0,0,0,3,0,0,3,1
142,4114,XqcIbo9pkzTiouZzC4CsMH0T57ZrJT7c,fbPkOYLVPtPgIt0MxizjfFJov3JbHyAi,11,14,5,0,3,8,6,1,37,5.285714285714286,2,0.0,0,5,0,3,14,8,0,6,1,8,29,1
143,4116,SbxWcDAQO1PnIdll82O1Qa8HqEHuIfT7,fbPkOYLVPtPgIt0MxizjfFJov3JbHyAi,5,5,1,0,1,0,1,0,8,1.1428571428571428,1,0.0,0,1,0,1,5,0,0,1,0,2,6,1
144,4117,DIqOhojonPjb3L0MafoRC4vbkm2ZgCPT,fbPkOYLVPtPgIt0MxizjfFJov3JbHyAi,15,13,4,13,5,7,6,2,50,7.142857142857143,2,0.0,6,4,9,5,7,7,4,6,2,24,26,1
145,4121,jcdJUvdxIg03VTKugjVUNiWSl6LwbiFS,fbPkOYLVPtPgIt0MxizjfFJov3JbHyAi,6,3,2,0,2,10,1,0,18,2.5714285714285716,1,0.0,0,2,0,2,3,10,0,1,0,4,14,1
146,4122,Uo5Is5U7melZAv7xg2Req57LK7O8TGT8,fbPkOYLVPtPgIt0MxizjfFJov3JbHyAi,18,27,16,0,12,1,10,2,68,9.714285714285714,2,0.0,2,16,0,12,25,1,0,10,2,30,38,1
147,4124,gml56PidNECJRV7FxBwKkFjPhRALq3yM,fbPkOYLVPtPgIt0MxizjfFJov3JbHyAi,8,5,3,0,3,0,4,0,15,2.142857142857143,1,0.0,0,3,0,3,5,0,0,4,0,6,9,1
148,4125,bGXe45VQE79P82jCvYbfBiOeISe1I8HL,fbPkOYLVPtPgIt0MxizjfFJov3JbHyAi,1,0,0,0,0,0,1,0,1,0.14285714285714285,1,0.0,0,0,0,0,0,0,0,1,0,0,1,1
149,4126,u4TNxfYOFL4kSz0gq3emLn9aOKma8Z0X,fbPkOYLVPtPgIt0MxizjfFJov3JbHyAi,5,4,2,0,2,0,0,0,8,1.1428571428571428,1,0.0,0,2,0,2,4,0,0,0,0,4,4,1
150,4127,iMXZvpdXIEwupZ3KLZs1wDk19TeUIZDi,fbPkOYLVPtPgIt0MxizjfFJov3JbHyAi,14,46,22,16,14,25,26,4,153,21.857142857142858,2,0.0,12,22,11,14,34,25,5,26,4,59,94,1
151,4129,Xl7O5Es6VpkB2PrTgzArkv7OwJ7XzlEg,fbPkOYLVPtPgIt0MxizjfFJov3JbHyAi,11,14,7,5,6,2,4,1,39,5.571428571428571,2,0.0,3,7,4,6,11,2,1,4,1,20,19,1
152,4130,8h1kpVFWyv776a7gZ8tw0jpXvK9G6pQ2,fbPkOYLVPtPgIt0MxizjfFJov3JbHyAi,10,9,4,0,3,0,7,0,23,3.2857142857142856,1,0.0,0,4,0,3,9,0,0,7,0,7,16,1
153,4133,sT9hGAnww95aeGvqwQpJlS3ORhWDT49F,fbPkOYLVPtPgIt0MxizjfFJov3JbHyAi,8,12,6,0,4,2,3,0,27,3.857142857142857,2,0.0,4,6,0,4,8,2,0,3,0,14,13,0
154,4134,bRG3KNKPz8MtEb5G1Duc4i5IiNMa8ZLU,fbPkOYLVPtPgIt0MxizjfFJov3JbHyAi,10,17,5,2,1,10,10,2,47,6.714285714285714,2,0.0,1,5,2,1,16,10,0,10,2,9,38,1
155,4135,Y9GqNI8HKN8AZelF8dSXK2b9zuzFq9b9,fbPkOYLVPtPgIt0MxizjfFJov3JbHyAi,4,2,1,0,1,0,1,0,5,0.7142857142857143,1,0.0,0,1,0,1,2,0,0,1,0,2,3,1
156,4136,WfTazznjeVMuts1c6fhfvqWuaprKs7C3,fbPkOYLVPtPgIt0MxizjfFJov3JbHyAi,20,27,16,0,10,43,17,2,115,16.428571428571427,4,0.0,0,16,0,10,27,43,0,17,2,26,89,1
157,4137,Z9qi5pq1C1bndfjP0mrTCfL8YAf6Qiv7,fbPkOYLVPtPgIt0MxizjfFJov3JbHyAi,7,4,4,0,4,11,8,0,31,4.428571428571429,2,0.0,0,4,0,4,4,11,0,8,0,8,23,0
158,4138,9tBhYjIXbTBZ0n8EA8LPV9H9GyKFjXEe,fbPkOYLVPtPgIt0MxizjfFJov3JbHyAi,9,4,3,0,3,0,2,0,12,1.7142857142857142,1,0.0,0,3,0,3,4,0,0,2,0,6,6,1
159,4140,JqdbZyx8jQDjvl0RCDBDldcliaXwceyv,fbPkOYLVPtPgIt0MxizjfFJov3JbHyAi,8,5,3,0,2,0,4,0,14,2.0,2,0.0,0,3,0,2,5,0,0,4,0,5,9,1
160,4141,3n39NQ5LzQS0QCcr9JZOE6aTUD48ZbAa,fbPkOYLVPtPgIt0MxizjfFJov3JbHyAi,7,3,2,0,2,0,6,0,13,1.8571428571428572,1,0.0,0,2,0,2,3,0,0,6,0,4,9,1
161,4143,9sFMHkQmozo76x80tFTC9ms1LtFpAvDD,fbPkOYLVPtPgIt0MxizjfFJov3JbHyAi,6,2,1,0,1,3,7,0,14,2.0,1,0.0,0,1,0,1,2,3,0,7,0,2,12,0
162,4145,AIdvsyhxoVQRPe3inEZOul3GszLWUII0,fbPkOYLVPtPgIt0MxizjfFJov3JbHyAi,7,3,2,0,2,0,5,0,12,1.7142857142857142,1,0.0,0,2,0,2,3,0,0,5,0,4,8,1
163,4146,UzWWq61d6vy3b9FQ0Zm3Qt9Ks0lmq3Qw,fbPkOYLVPtPgIt0MxizjfFJov3JbHyAi,9,4,3,0,3,0,5,0,15,2.142857142857143,1,0.0,0,3,0,3,4,0,0,5,0,6,9,1
164,4147,pUAX44GhkdnMgwkbpKeIXW1XZgu0a3SV,fbPkOYLVPtPgIt0MxizjfFJov3JbHyAi,5,2,1,0,1,0,4,0,8,1.1428571428571428,1,0.0,0,1,0,1,2,0,0,4,0,2,6,1
165,4148,V2KAeU5M9aZ71MSOJMPq9O99rHGzmKaR,fbPkOYLVPtPgIt0MxizjfFJov3JbHyAi,9,23,2,0,3,0,6,0,34,4.857142857142857,2,0.0,3,2,0,3,20,0,0,6,0,8,26,1
166,4149,dTHHrNH4JPIQjJnYjUmUZmHrgYHdCxcs,fbPkOYLVPtPgIt0MxizjfFJov3JbHyAi,6,5,2,0,3,0,1,0,11,1.5714285714285714,1,0.0,2,2,0,3,3,0,0,1,0,7,4,1
167,4150,mkfe4TuGJEOOkk4BSi5C0OnTlC842bEi,fbPkOYLVPtPgIt0MxizjfFJov3JbHyAi,26,51,15,13,22,0,8,1,110,15.714285714285714,3,0.0,33,15,11,22,18,0,2,8,1,81,29,1
168,4152,SBELepDdWchL6dd3B4yF17bQJZRyBGmW,fbPkOYLVPtPgIt0MxizjfFJov3JbHyAi,4,2,0,0,0,2,2,0,6,0.8571428571428571,1,0.0,0,0,0,0,2,2,0,2,0,0,6,1
169,4155,82WiuHoB3dVqYkf2UKsu9ogC0IsQQnqa,fbPkOYLVPtPgIt0MxizjfFJov3JbHyAi,10,16,11,0,6,3,3,0,39,5.571428571428571,2,0.0,1,11,0,6,15,3,0,3,0,18,21,1
170,4157,ZfaQRDpYRWxr1tKliyWhtiIkOEpZJsx1,fbPkOYLVPtPgIt0MxizjfFJov3JbHyAi,8,10,6,0,1,2,3,0,22,3.142857142857143,2,0.0,2,6,0,1,8,2,0,3,0,9,13,1
171,4160,nLSyDmuwtZ9VcSdeL7kW6FG97w0wmm94,fbPkOYLVPtPgIt0MxizjfFJov3JbHyAi,6,2,1,0,1,2,4,1,11,1.5714285714285714,1,0.0,0,1,0,1,2,2,0,4,1,2,9,1
172,4161,gT3kB48dwTiT117VlKJVDNNpHcWl18uZ,fbPkOYLVPtPgIt0MxizjfFJov3JbHyAi,5,0,0,0,0,1,5,1,7,1.0,1,0.0,0,0,0,0,0,1,0,5,1,0,7,1
173,4162,w9kAk351HcnpUdtlF40UgfJ8nmtrjk1M,fbPkOYLVPtPgIt0MxizjfFJov3JbHyAi,3,3,0,0,0,0,2,0,5,0.7142857142857143,1,0.0,0,0,0,0,3,0,0,2,0,0,5,1
174,4163,PBd2c59pI8ZCJwc4iQjHYNeQj4K3oGvT,fbPkOYLVPtPgIt0MxizjfFJov3JbHyAi,10,5,3,0,2,6,12,1,29,4.142857142857143,1,0.0,0,3,0,2,5,6,0,12,1,5,24,1
175,4164,6PFF6a3rTtp143lPxgdGFZZ0CCZBKH49,fbPkOYLVPtPgIt0MxizjfFJov3JbHyAi,10,10,5,0,5,4,9,3,36,5.142857142857143,1,0.0,3,5,0,5,7,4,0,9,3,13,23,1
176,4168,heWUPIsxtHSwXQGmJMsYqzGkbNQihssP,fbPkOYLVPtPgIt0MxizjfFJov3JbHyAi,4,2,1,0,1,0,1,0,5,0.7142857142857143,1,0.0,0,1,0,1,2,0,0,1,0,2,3,1
177,4169,z9oFzf9xIbCN4mhupPeK6qv2AnZTqp8G,fbPkOYLVPtPgIt0MxizjfFJov3JbHyAi,6,1,1,0,1,0,3,0,6,0.8571428571428571,1,0.0,0,1,0,1,1,0,0,3,0,2,4,1
178,4170,cJuR6mykFWWefoh4qiG9O6BBEr08qxSv,fbPkOYLVPtPgIt0MxizjfFJov3JbHyAi,8,13,4,0,4,18,6,3,48,6.857142857142857,2,0.0,4,4,0,4,9,18,0,6,3,12,36,1
179,4171,uHgH8m4GJET0eE5mE8JCyLZD7HEKwM4t,SpATywNh6bZuzm8s1ceuBUnMUAeoAHHw,17,29,17,17,2,26,27,3,121,17.285714285714285,6,0.0,5,17,15,2,24,26,2,27,3,39,82,0
180,4182,HgeZmyLysCZF827lPwLNCfqcskKVvNDd,SpATywNh6bZuzm8s1ceuBUnMUAeoAHHw,16,26,1,19,2,2,13,2,65,9.285714285714286,2,0.0,10,1,16,2,16,2,3,13,2,29,36,0
181,4219,Jm4nQ05ndX10jbofbWx6S0r9VXrqia6S,bWdj2GDclj5ofokWjzoa5jAwMkxCykd6,11,28,14,46,2,14,11,0,115,16.428571428571427,3,0.0,3,14,44,2,25,14,2,11,0,63,52,0
182,4237,SVFfJJhaWd2RlHPtvg5SWBRGj8N0paMQ,SpATywNh6bZuzm8s1ceuBUnMUAeoAHHw,14,32,3,14,1,2,13,0,65,9.285714285714286,3,0.0,12,3,13,1,20,2,1,13,0,29,36,0
183,4243,83p9ejSELsW1j5wNlAyUXF2YWFL8Z8tc,A3fsA9Zfv1X2fVEQhTw51lKENdNrEqT3,1,0,0,0,0,0,1,0,1,0.14285714285714285,1,0.0,0,0,0,0,0,0,0,1,0,0,1,0
184,4247,0NGZq9HZW5KOrSfzSGGipuN20pCRDMWu,G8EPVSXsOYB5YQWZGiz1aVq5Pgr2GrQu,17,23,3,14,3,31,21,2,97,13.857142857142858,4,0.0,9,3,10,3,14,31,4,21,2,25,72,0
185,4254,J5PQMceXoOVyN05md7NqKfAhSfcgJgVJ,SpATywNh6bZuzm8s1ceuBUnMUAeoAHHw,14,29,1,19,0,112,18,2,181,25.857142857142858,6,0.0,8,1,17,0,21,112,2,18,2,26,155,0
186,4268,nYFWhKbFKiXgZ193lmJEmg3xQ65UNrPv,SpATywNh6bZuzm8s1ceuBUnMUAeoAHHw,18,35,14,20,5,3,10,1,88,12.571428571428571,2,0.0,16,14,18,5,19,3,2,10,1,53,35,1
187,4278,iVNWfvqx80bYGUpxbD5kOVH2Fugs6QtQ,SpATywNh6bZuzm8s1ceuBUnMUAeoAHHw,13,14,8,8,5,1,3,0,39,5.571428571428571,1,0.0,3,8,8,5,11,1,0,3,0,24,15,0
188,4290,EVhDvNThWnvwe7HGJiMKoMo6EeAXDH9R,bWdj2GDclj5ofokWjzoa5jAwMkxCykd6,9,11,7,0,4,1,15,0,38,5.428571428571429,2,0.0,0,7,0,4,11,1,0,15,0,11,27,1
189,4292,5IOZn10arhSe83Sz47oGoyNxbAFXZkA2,SpATywNh6bZuzm8s1ceuBUnMUAeoAHHw,8,12,5,0,1,11,8,0,37,5.285714285714286,1,0.0,0,5,0,1,12,11,0,8,0,6,31,1
190,4301,QOK5LHvwN0A5g3JhxMPHBffh5Rh2wZF8,SpATywNh6bZuzm8s1ceuBUnMUAeoAHHw,12,15,4,0,2,1,10,1,33,4.714285714285714,2,0.0,1,4,0,2,14,1,0,10,1,7,26,1
191,4313,l80sDXQh6tFmRSRsJvWJgP55drvQUfT2,SpATywNh6bZuzm8s1ceuBUnMUAeoAHHw,11,12,5,0,3,0,5,0,25,3.5714285714285716,2,0.0,1,5,0,3,11,0,0,5,0,9,16,1
192,4327,glS180WZt8C6hB13WP6NUijid7zN96cg,SpATywNh6bZuzm8s1ceuBUnMUAeoAHHw,9,5,3,0,3,4,5,1,21,3.0,1,0.0,0,3,0,3,5,4,0,5,1,6,15,0
193,4365,ebO6e76NCFlMeek1yPjM9gz3mJBPl1yH,RXDvfPUBYFlVdlueBFbLW0mhhAyGEqpt,10,10,2,0,2,0,3,0,17,2.4285714285714284,1,0.0,0,2,0,2,10,0,0,3,0,4,13,1
194,4395,C6xrhZPOmVH2gCVNP26gSSPka2CcwgB5,SpATywNh6bZuzm8s1ceuBUnMUAeoAHHw,13,9,6,6,4,1,5,0,31,4.428571428571429,2,0.0,3,6,6,4,6,1,0,5,0,19,12,1
195,4406,U0MChqulsymiJYCtbj873TXGFuXiZDFk,SpATywNh6bZuzm8s1ceuBUnMUAeoAHHw,17,37,16,18,4,14,14,1,104,14.857142857142858,6,0.0,14,16,16,4,23,14,2,14,1,50,54,0
196,4432,kdQVQcPehC1WZyKhleQe5vDaCQv1dpj8,SpATywNh6bZuzm8s1ceuBUnMUAeoAHHw,17,21,12,21,6,4,12,3,79,11.285714285714286,4,0.0,4,12,19,6,17,4,2,12,3,41,38,0
197,4435,bN6JhUz4s97Xsh7eq2ZH1ilTMaKJDuUF,bWdj2GDclj5ofokWjzoa5jAwMkxCykd6,18,70,26,38,11,20,20,0,185,26.428571428571427,3,0.0,8,26,34,11,62,20,4,20,0,79,106,0
198,4440,ZhTCqX8GMUcn0a0betuEauHNuCk1aRhm,bWdj2GDclj5ofokWjzoa5jAwMkxCykd6,19,38,15,52,6,27,7,0,145,20.714285714285715,1,0.0,13,15,48,6,25,27,4,7,0,82,63,0
199,4453,4sZlPbPnBCwNHbrOUXcVAiPkTKHriJTV,SpATywNh6bZuzm8s1ceuBUnMUAeoAHHw,16,39,4,19,1,47,45,3,158,22.571428571428573,5,0.0,8,4,16,1,31,47,3,45,3,29,129,0
200,4454,lMy0A59BRo4770ALzvOjsBS5HJkCRV78,bWdj2GDclj5ofokWjzoa5jAwMkxCykd6,17,29,2,52,0,5,19,1,108,15.428571428571429,2,0.0,4,2,48,0,25,5,4,19,1,54,54,1
201,4481,XjrP1VAGwJCwkRm4KgImIkZYNjnvGQN9,RXDvfPUBYFlVdlueBFbLW0mhhAyGEqpt,51,125,68,124,32,45,52,8,454,64.85714285714286,7,0.0,26,68,113,32,99,45,11,52,8,239,215,0
202,4498,dxoTIhhPXBvqzWGLltH0slJdxsuyggjI,G8EPVSXsOYB5YQWZGiz1aVq5Pgr2GrQu,32,71,53,0,22,34,47,4,231,33.0,6,0.0,0,53,0,22,71,34,0,47,4,75,156,0
203,4499,2ZP4iw9joeRPfEuWLWQQFnKchFtuqx5l,SpATywNh6bZuzm8s1ceuBUnMUAeoAHHw,13,19,9,12,7,3,1,0,51,7.285714285714286,1,0.0,6,9,11,7,13,3,1,1,0,33,18,0
204,4506,j1jdy8OF5VQw4rqSYOkbK2pQplvvvz37,G8EPVSXsOYB5YQWZGiz1aVq5Pgr2GrQu,48,172,21,90,9,164,91,5,552,78.85714285714286,7,0.0,26,21,72,9,146,164,18,91,5,128,424,0
205,4507,HuDaXYBstQFpbEGg5tkyPhxLKzB3hVSB,SpATywNh6bZuzm8s1ceuBUnMUAeoAHHw,18,121,54,23,6,98,76,6,384,54.857142857142854,7,0.0,29,54,17,6,92,98,6,76,6,106,278,0
206,4524,j1jdy8OF5VQw4rqSYOkbK2pQplvvvz37,bWdj2GDclj5ofokWjzoa5jAwMkxCykd6,20,71,23,101,6,62,36,3,302,43.142857142857146,4,0.0,10,23,95,6,61,62,6,36,3,134,168,1
207,4547,fczke4UuC99kQHbLPBF9eDbT99FMycXd,SpATywNh6bZuzm8s1ceuBUnMUAeoAHHw,4,0,0,0,0,0,4,0,4,0.5714285714285714,1,0.0,0,0,0,0,0,0,0,4,0,0,4,0
208,4548,kla9cpzzaIqMfwRx5dULfeceoZisiJXJ,SpATywNh6bZuzm8s1ceuBUnMUAeoAHHw,18,67,23,19,5,16,38,6,174,24.857142857142858,3,0.0,29,23,18,5,38,16,1,38,6,75,99,0
209,4571,PUW0i4IuafllkJEtV0GCqmTDeLHkDmH3,bWdj2GDclj5ofokWjzoa5jAwMkxCykd6,20,62,1,50,4,351,61,5,534,76.28571428571429,7,0.0,11,1,45,4,51,351,5,61,5,61,473,0
210,4610,sZNhT3IqtfFMwMod3w0cGQK1HKvrIFwI,SpATywNh6bZuzm8s1ceuBUnMUAeoAHHw,1,0,0,0,0,0,1,0,1,0.14285714285714285,1,0.0,0,0,0,0,0,0,0,1,0,0,1,1
211,4613,aVE6FAaI67jjqObdfL3BkKQUvDsOp43M,SpATywNh6bZuzm8s1ceuBUnMUAeoAHHw,16,46,25,12,6,30,22,0,141,20.142857142857142,2,0.0,7,25,12,6,39,30,0,22,0,50,91,0
212,4641,8oxFWBumsNA4SJ0CIJujNkjFW8ZzMgtQ,SpATywNh6bZuzm8s1ceuBUnMUAeoAHHw,17,54,2,18,2,29,15,4,124,17.714285714285715,5,0.0,22,2,15,2,32,29,3,15,4,41,83,0
213,4647,MKlpymF14KtyI236a0RjVjNdDlFXwHJE,SpATywNh6bZuzm8s1ceuBUnMUAeoAHHw,15,29,3,10,1,2,9,2,56,8.0,1,0.0,11,3,9,1,18,2,1,9,2,24,32,0
214,4664,kMN5uYNaj23K9PVTrdyiL9iDB1lCye57,SpATywNh6bZuzm8s1ceuBUnMUAeoAHHw,17,58,18,17,6,43,18,1,161,23.0,6,0.0,18,18,15,6,40,43,2,18,1,57,104,0
215,4713,2d73pTPKGJeE59DtbgirchSdsN0c5ZX8,G8EPVSXsOYB5YQWZGiz1aVq5Pgr2GrQu,46,125,34,158,14,9,30,2,372,53.142857142857146,5,0.0,69,34,125,14,56,9,33,30,2,242,130,1
216,4717,pYVXRlnQ0YvWKNjc7FEDAmE4Ai0Z428V,SpATywNh6bZuzm8s1ceuBUnMUAeoAHHw,6,2,1,0,1,1,7,0,12,1.7142857142857142,1,0.0,1,1,0,1,1,1,0,7,0,3,9,1
217,4724,CjC2ROZAsG20pDynA7ZPw7kC7J3IUQLv,SpATywNh6bZuzm8s1ceuBUnMUAeoAHHw,17,32,17,16,6,19,19,1,110,15.714285714285714,3,0.0,4,17,14,6,28,19,2,19,1,41,69,0
218,4731,LgFsEu5TARkqPf6cgrTX0NqpOzewq5Lk,SpATywNh6bZuzm8s1ceuBUnMUAeoAHHw,6,4,1,0,1,1,3,1,11,1.5714285714285714,1,0.0,0,1,0,1,4,1,0,3,1,2,9,0
219,4747,2YrfQZgyUPdiZGXhplgKBSkvHochAfw6,SpATywNh6bZuzm8s1ceuBUnMUAeoAHHw,9,30,13,0,5,0,8,0,56,8.0,3,0.0,0,13,0,5,30,0,0,8,0,18,38,0
220,4767,OLNUzQUHvlNsi2WFlH5eEyaieqKXrEz7,SpATywNh6bZuzm8s1ceuBUnMUAeoAHHw,9,12,5,0,2,1,4,0,24,3.4285714285714284,2,0.0,2,5,0,2,10,1,0,4,0,9,15,1
221,4773,29ctmAiYEOKj7HqUZOWS8Kj1hgVEvKs8,bWdj2GDclj5ofokWjzoa5jAwMkxCykd6,6,6,0,0,0,0,5,0,11,1.5714285714285714,1,0.0,0,0,0,0,6,0,0,5,0,0,11,1
222,4774,urHq1UPtLFVLJW8r9uUffDflKlN7AYRL,SpATywNh6bZuzm8s1ceuBUnMUAeoAHHw,18,19,12,16,3,5,9,0,64,9.142857142857142,2,0.0,2,12,14,3,17,5,2,9,0,31,33,0
223,4802,aI2WbSCktVyijPTHCbgAdpzpfdnFGcq9,RXDvfPUBYFlVdlueBFbLW0mhhAyGEqpt,7,2,1,0,1,1,7,4,16,2.2857142857142856,2,0.0,0,1,0,1,2,1,0,7,4,2,14,0
224,4825,q3SjGV3d1qwn1q3ehoXsAmC01281iVQV,SpATywNh6bZuzm8s1ceuBUnMUAeoAHHw,16,23,9,14,8,8,16,1,79,11.285714285714286,2,0.0,8,9,13,8,15,8,1,16,1,38,41,0
225,4827,yNygMjDRQbsmQrkdzv6Ni3gEhrA9rC9T,SpATywNh6bZuzm8s1ceuBUnMUAeoAHHw,13,26,12,12,7,2,3,0,62,8.857142857142858,2,0.0,10,12,9,7,16,2,3,3,0,38,24,0
226,4852,bvRAS0uJ0Teq8mZcNb9rxcXigDj59DTa,RXDvfPUBYFlVdlueBFbLW0mhhAyGEqpt,9,12,9,0,0,0,4,0,25,3.5714285714285716,3,0.0,0,9,0,0,12,0,0,4,0,9,16,0
227,4903,jJEQAKDG1yT0OS9qRBZrNXlEJDxE8Etq,A3fsA9Zfv1X2fVEQhTw51lKENdNrEqT3,15,14,2,2,1,70,19,2,110,15.714285714285714,4,0.0,2,2,1,1,12,70,1,19,2,6,104,0
228,4907,24hyIKTWvGbDpRNiVA2hNdG9ApRuVKWS,SpATywNh6bZuzm8s1ceuBUnMUAeoAHHw,17,33,16,13,6,6,16,1,91,13.0,4,0.0,6,16,11,6,27,6,2,16,1,39,52,0
229,4910,FlH4hJdTFopI7d7C8aCFmJunlCxyAcSh,SpATywNh6bZuzm8s1ceuBUnMUAeoAHHw,6,3,2,0,2,0,1,0,8,1.1428571428571428,1,0.0,0,2,0,2,3,0,0,1,0,4,4,1
230,4931,eiL4sJzBUqNqEAwJXavGTHQchRgg0E9e,G8EPVSXsOYB5YQWZGiz1aVq5Pgr2GrQu,30,40,3,44,1,17,22,3,130,18.571428571428573,5,0.0,5,3,34,1,35,17,10,22,3,43,87,0
231,4934,RkupeBiDJM8eQAHegSIZXnYfypYMPCFs,SpATywNh6bZuzm8s1ceuBUnMUAeoAHHw,11,40,25,0,10,0,16,0,91,13.0,5,0.0,2,25,0,10,38,0,0,16,0,37,54,0
232,4937,aZcgamrUxwqX7Nt2qxeI2ZGGKhcvbWIt,SpATywNh6bZuzm8s1ceuBUnMUAeoAHHw,12,18,2,19,0,2,16,1,58,8.285714285714286,1,0.0,8,2,16,0,10,2,3,16,1,26,32,0
233,4979,dSloiolTuQA1YnIVrIEZb5m23cL24cRw,bWdj2GDclj5ofokWjzoa5jAwMkxCykd6,7,6,2,0,2,0,2,0,12,1.7142857142857142,2,0.0,0,2,0,2,6,0,0,2,0,4,8,1
234,4982,3ZzNkdWgGb47Go07PRKPf0XZ6jjhVCB4,A3fsA9Zfv1X2fVEQhTw51lKENdNrEqT3,15,16,11,2,6,15,8,0,58,8.285714285714286,1,0.0,0,11,2,6,16,15,0,8,0,19,39,0
235,4984,3h1zqwMTeQWdhoWHPgvllPWyD6P0qFtr,SpATywNh6bZuzm8s1ceuBUnMUAeoAHHw,7,13,7,0,4,0,3,0,27,3.857142857142857,4,0.0,1,7,0,4,12,0,0,3,0,12,15,0
236,4989,WxVM9kOqNmenlQy1YKMo3yVYKYKkewCz,A3fsA9Zfv1X2fVEQhTw51lKENdNrEqT3,4,2,1,0,1,0,2,0,6,0.8571428571428571,1,0.0,0,1,0,1,2,0,0,2,0,2,4,0
237,5009,lgip049r6Eu24ga2SPdixKHu4ShoVkOP,SpATywNh6bZuzm8s1ceuBUnMUAeoAHHw,15,11,7,11,5,0,3,0,37,5.285714285714286,1,0.0,2,7,10,5,9,0,1,3,0,24,13,0
238,5028,v1AqHfMoNhUox9GyIOrxftKibIp07zrt,RXDvfPUBYFlVdlueBFbLW0mhhAyGEqpt,18,15,13,0,9,0,2,0,39,5.571428571428571,1,0.0,0,13,0,9,15,0,0,2,0,22,17,1
239,5058,UJNew1tDOTKAwtlVI7Xin0dzgnQGk4oE,SpATywNh6bZuzm8s1ceuBUnMUAeoAHHw,12,34,12,1,3,2,13,0,65,9.285714285714286,5,0.0,12,12,1,3,22,2,0,13,0,28,37,0
240,5084,kMzMJEHy7fAHiNUZU0um3I2BsPC7gMll,bWdj2GDclj5ofokWjzoa5jAwMkxCykd6,20,64,46,68,36,20,30,2,266,38.0,6,0.0,9,46,63,36,55,20,5,30,2,154,112,0
241,5092,EiO5bky9R1Iqlpv4ItUpPBUgGb1eJItE,A3fsA9Zfv1X2fVEQhTw51lKENdNrEqT3,25,77,8,20,4,187,61,0,357,51.0,7,0.0,3,8,17,4,74,187,3,61,0,32,325,1
242,5112,eXHbDnPXGOepjGY8R1QdCMeSWp9NDZZc,SpATywNh6bZuzm8s1ceuBUnMUAeoAHHw,6,9,4,0,1,0,2,0,16,2.2857142857142856,1,0.0,0,4,0,1,9,0,0,2,0,5,11,0
243,5114,3SWDgl41jXPWPBCB5sVpNEwmW9L3MerS,SpATywNh6bZuzm8s1ceuBUnMUAeoAHHw,13,11,4,8,3,0,3,0,29,4.142857142857143,2,0.0,3,4,8,3,8,0,0,3,0,18,11,0
244,5136,35QP8hkG1fMgJT5B2mWO7L1K5UDzKccP,SpATywNh6bZuzm8s1ceuBUnMUAeoAHHw,10,14,0,0,0,0,9,1,24,3.4285714285714284,1,0.0,4,0,0,0,10,0,0,9,1,4,20,1
245,5148,uN992cfJ2NJqNQmns1XgyEcZyWUiJR0U,SpATywNh6bZuzm8s1ceuBUnMUAeoAHHw,15,38,3,11,0,9,15,1,77,11.0,3,0.0,17,3,11,0,21,9,0,15,1,31,46,0
246,5168,UWuyaaoLwLnyFDmtW8yT3lff7bHBBBqe,SpATywNh6bZuzm8s1ceuBUnMUAeoAHHw,14,29,4,20,3,0,10,0,66,9.428571428571429,3,0.0,4,4,17,3,25,0,3,10,0,28,38,0
247,5245,17IsanlXziT2tczTSDkapcsRHmSWuCWH,SpATywNh6bZuzm8s1ceuBUnMUAeoAHHw,11,37,6,0,8,0,9,0,60,8.571428571428571,4,0.0,10,6,0,8,27,0,0,9,0,24,36,0
248,5249,TCQ7j55cp3iQY2crxSrod75YneerL94o,SpATywNh6bZuzm8s1ceuBUnMUAeoAHHw,17,22,9,17,3,4,9,0,64,9.142857142857142,3,0.0,8,9,15,3,14,4,2,9,0,35,29,1
249,5255,0NbLYZNvmNdh82upKkBVVwJoa5b6RKVj,SpATywNh6bZuzm8s1ceuBUnMUAeoAHHw,17,20,9,18,4,17,13,6,87,12.428571428571429,2,0.0,2,9,15,4,18,17,3,13,6,30,57,0
250,5280,nsvq9MYt4IahoN4kXXFtAP2mFM9VmORm,SpATywNh6bZuzm8s1ceuBUnMUAeoAHHw,16,19,9,18,5,20,7,0,78,11.142857142857142,1,0.0,6,9,16,5,13,20,2,7,0,36,42,1
251,5284,QqE2Xjwy9gUzOvFdkDqAwAaNZLBZkxvd,RXDvfPUBYFlVdlueBFbLW0mhhAyGEqpt,40,96,7,89,3,40,22,0,257,36.714285714285715,7,0.0,9,7,83,3,87,40,6,22,0,102,155,0
252,5290,4xEpIgR9alQqM4xeSug69KmBmO9gpD69,A3fsA9Zfv1X2fVEQhTw51lKENdNrEqT3,44,80,46,42,26,56,41,5,296,42.285714285714285,5,0.0,6,46,41,26,74,56,1,41,5,119,177,0
253,5311,SFbTZDEo0JTOG7VHfxeJz2kz3qSzlHq4,SpATywNh6bZuzm8s1ceuBUnMUAeoAHHw,10,20,1,19,0,0,5,0,45,6.428571428571429,2,0.0,10,1,17,0,10,0,2,5,0,28,17,0
254,5316,0tT4cQq52T8bu4irQ9KewNXtlD33hVZo,SpATywNh6bZuzm8s1ceuBUnMUAeoAHHw,17,28,16,15,5,4,15,1,84,12.0,4,0.0,2,16,14,5,26,4,1,15,1,37,47,0
255,5337,a6f3gPi6axX0cfBnUGVliBDQrPx92l1r,bWdj2GDclj5ofokWjzoa5jAwMkxCykd6,19,106,37,62,34,42,15,2,298,42.57142857142857,4,0.0,43,37,55,34,63,42,7,15,2,169,129,1
256,5369,AcgDUm5SSEb0zgM8tYKiOFvTewc0KRAc,SpATywNh6bZuzm8s1ceuBUnMUAeoAHHw,14,13,7,8,4,0,6,0,38,5.428571428571429,2,0.0,5,7,8,4,8,0,0,6,0,24,14,0
257,5416,nds56JS5tgInTRshD1ZJkwXi4oW5Ln7a,RXDvfPUBYFlVdlueBFbLW0mhhAyGEqpt,35,36,19,73,10,46,16,1,201,28.714285714285715,2,0.0,5,19,61,10,31,46,12,16,1,95,106,0
258,5435,90Sn7UxaiRTmCSrIbSNevcUMokJI9XYS,A3fsA9Zfv1X2fVEQhTw51lKENdNrEqT3,10,11,1,0,1,0,2,0,15,2.142857142857143,1,0.0,0,1,0,1,11,0,0,2,0,2,13,1
259,5470,acVvGaaH1iVFQOYF94V9THpGPkF7EIj3,SpATywNh6bZuzm8s1ceuBUnMUAeoAHHw,17,35,18,22,10,10,20,3,118,16.857142857142858,2,0.0,11,18,19,10,24,10,3,20,3,58,60,0
260,5482,lfAQ0nsHdkBDoIcTW4jXyPy4wOsVYtMB,RXDvfPUBYFlVdlueBFbLW0mhhAyGEqpt,11,6,4,0,2,1,8,1,22,3.142857142857143,1,0.0,0,4,0,2,6,1,0,8,1,6,16,1
261,5484,DjQWiwlbqq88H7QziTtErXo3yBTqRc6U,A3fsA9Zfv1X2fVEQhTw51lKENdNrEqT3,8,5,1,0,0,1,5,1,13,1.8571428571428572,3,0.0,0,1,0,0,5,1,0,5,1,1,12,1
262,5495,xsW19PmjvHmfOgtSCjdxnkpzOWqbKfLn,SpATywNh6bZuzm8s1ceuBUnMUAeoAHHw,18,49,17,11,5,26,24,3,135,19.285714285714285,4,0.0,25,17,10,5,24,26,1,24,3,57,78,0
263,5546,sc5S8mzwcw7LbcetViv5Dahuhyet4uF1,SpATywNh6bZuzm8s1ceuBUnMUAeoAHHw,5,6,1,0,0,0,6,0,13,1.8571428571428572,2,0.0,0,1,0,0,6,0,0,6,0,1,12,0
264,5584,Qt99KRFUK6FY5ovJvB9yRLziSf5bEirX,SpATywNh6bZuzm8s1ceuBUnMUAeoAHHw,9,7,3,0,1,0,7,1,19,2.7142857142857144,1,0.0,0,3,0,1,7,0,0,7,1,4,15,1
265,5642,IAvuP4GGmvnNj3Zisz3jDfo3mSmXiJSb,A3fsA9Zfv1X2fVEQhTw51lKENdNrEqT3,25,26,1,56,0,0,3,0,86,12.285714285714286,2,0.0,0,1,44,0,26,0,12,3,0,45,41,1
266,5644,J388HMX5pYHjqXdA7jEUkFec6orRQtIq,A3fsA9Zfv1X2fVEQhTw51lKENdNrEqT3,21,30,15,0,5,0,13,0,63,9.0,2,0.0,0,15,0,5,30,0,0,13,0,20,43,0
267,5655,PztWYF4ZTLP8rvUvCUcN3hQiYuYJPY9t,bWdj2GDclj5ofokWjzoa5jAwMkxCykd6,7,12,4,0,1,0,5,0,22,3.142857142857143,2,0.0,0,4,0,1,12,0,0,5,0,5,17,1
268,5660,CZZkgDgsqVR6ftNFrTmx0jPpBHh2f3Zo,SpATywNh6bZuzm8s1ceuBUnMUAeoAHHw,15,78,2,19,2,60,30,2,193,27.571428571428573,4,0.0,24,2,18,2,54,60,1,30,2,46,147,0
269,5702,C6xrhZPOmVH2gCVNP26gSSPka2CcwgB5,bWdj2GDclj5ofokWjzoa5jAwMkxCykd6,17,17,11,62,9,13,9,0,121,17.285714285714285,2,0.0,6,11,59,9,11,13,3,9,0,85,36,1
270,5740,PizUKf6mRUas66X3VMYXf9aygnN1CUCf,SpATywNh6bZuzm8s1ceuBUnMUAeoAHHw,15,31,12,24,11,18,5,5,106,15.142857142857142,1,0.0,18,12,20,11,13,18,4,5,5,61,45,1
271,5746,seRgjh60dHSex83x3yaP07EkHkNZ3zq1,SpATywNh6bZuzm8s1ceuBUnMUAeoAHHw,11,9,7,0,4,0,2,0,22,3.142857142857143,2,0.0,0,7,0,4,9,0,0,2,0,11,11,0
272,5781,D2S5bjWjmtwLivqx7n7FZWso5Kd6We5x,bWdj2GDclj5ofokWjzoa5jAwMkxCykd6,16,41,9,32,2,1,9,0,94,13.428571428571429,3,0.0,12,9,31,2,29,1,1,9,0,54,40,0
273,5785,Llzpy0Dk1LPSE6nBLZ8vNVNgQXCzGpc1,SpATywNh6bZuzm8s1ceuBUnMUAeoAHHw,8,18,12,0,8,0,8,0,46,6.571428571428571,4,0.0,0,12,0,8,18,0,0,8,0,20,26,1
274,5788,zysr84QD6b78mLaezXoryEdhH6kH14EQ,SpATywNh6bZuzm8s1ceuBUnMUAeoAHHw,14,15,9,11,6,0,2,0,43,6.142857142857143,2,0.0,4,9,9,6,11,0,2,2,0,28,15,0
275,5792,GIb3glgYrsEfHWtEWPWpwONqwE7RMf6f,bWdj2GDclj5ofokWjzoa5jAwMkxCykd6,19,69,31,62,5,53,40,4,264,37.714285714285715,6,0.0,7,31,56,5,62,53,6,40,4,99,165,0
276,5803,sD3rDh1CtXsAdfDDyFRBf917K7ELQzHQ,SpATywNh6bZuzm8s1ceuBUnMUAeoAHHw,4,5,1,0,0,0,1,0,7,1.0,1,0.0,2,1,0,0,3,0,0,1,0,3,4,0
277,5805,VUYRWxIK25dyFla7xdkPw6qN6gZPPejU,SpATywNh6bZuzm8s1ceuBUnMUAeoAHHw,11,17,9,0,3,0,11,0,40,5.714285714285714,1,0.0,2,9,0,3,15,0,0,11,0,14,26,0
278,5826,zTf8XOQnwWWl1KDwh9NJmoY9QiDPt6oU,SpATywNh6bZuzm8s1ceuBUnMUAeoAHHw,17,39,22,16,8,0,13,1,99,14.142857142857142,5,0.0,10,22,15,8,29,0,1,13,1,55,44,0
279,5865,Ojf2FGMPjkgcQ8cOS7KSlXqYowZOsPoh,A3fsA9Zfv1X2fVEQhTw51lKENdNrEqT3,8,7,3,0,2,2,2,0,16,2.2857142857142856,1,0.0,0,3,0,2,7,2,0,2,0,5,11,0
280,5890,8c2gk77rfHeG4kEZpifVHT547X2ayTNE,RXDvfPUBYFlVdlueBFbLW0mhhAyGEqpt,48,79,48,101,21,28,25,1,303,43.285714285714285,4,0.0,18,48,98,21,61,28,3,25,1,185,118,0
281,5892,1YxknoiTrSwQgclDlSAh4oMYHRyARhLv,SpATywNh6bZuzm8s1ceuBUnMUAeoAHHw,7,8,0,4,0,0,2,0,14,2.0,1,0.0,5,0,4,0,3,0,0,2,0,9,5,0
282,5902,7o8xhk1rh0BQyK6zL1slDKappRA3D8Mk,SpATywNh6bZuzm8s1ceuBUnMUAeoAHHw,11,10,6,0,4,1,6,1,28,4.0,1,0.0,2,6,0,4,8,1,0,6,1,12,16,0
283,5927,vYyC3PI9WOfKd54xBrxSVvrhn62CQxzz,SpATywNh6bZuzm8s1ceuBUnMUAeoAHHw,13,9,6,6,3,0,1,0,25,3.5714285714285716,1,0.0,2,6,6,3,7,0,0,1,0,17,8,1
284,5934,hdKqkkWKrDzbKE9btGChBqiCfsTwp68E,A3fsA9Zfv1X2fVEQhTw51lKENdNrEqT3,32,17,12,28,9,3,18,2,89,12.714285714285714,3,0.0,2,12,23,9,15,3,5,18,2,46,43,0
285,6048,hf7YI3B1kTTuvmd2vS9DIoiPGXbrQyBH,SpATywNh6bZuzm8s1ceuBUnMUAeoAHHw,16,30,1,10,2,17,9,0,69,9.857142857142858,2,0.0,12,1,8,2,18,17,2,9,0,23,46,0
286,6058,KrIVcXIiCdwRGUI4WguKXHPsvZChbtIb,A3fsA9Zfv1X2fVEQhTw51lKENdNrEqT3,36,22,14,70,8,66,11,0,191,27.285714285714285,5,0.0,1,14,54,8,21,66,16,11,0,77,114,0
287,6084,egIcBO9xXh5XDAWBOR2C58eTHcHVaPTq,SpATywNh6bZuzm8s1ceuBUnMUAeoAHHw,4,2,1,0,0,31,4,0,38,5.428571428571429,3,0.0,0,1,0,0,2,31,0,4,0,1,37,1
288,6086,ZL7VsgZBlKFfi6BGNSyN1gGJros1L9ra,SpATywNh6bZuzm8s1ceuBUnMUAeoAHHw,18,40,13,11,3,22,21,1,111,15.857142857142858,2,0.0,14,13,10,3,26,22,1,21,1,40,71,1
289,6087,uUWoPLkJSFKbD6KppcebOwMXezopCcLj,SpATywNh6bZuzm8s1ceuBUnMUAeoAHHw,15,132,24,21,8,25,31,1,242,34.57142857142857,5,0.0,38,24,17,8,94,25,4,31,1,87,155,0
290,6090,Qsrx4kwwBFByqyYPAbCeTAurBzPDhOG4,SpATywNh6bZuzm8s1ceuBUnMUAeoAHHw,4,2,1,0,1,0,1,0,5,0.7142857142857143,1,0.0,0,1,0,1,2,0,0,1,0,2,3,1
291,6136,sF8Qur7NIXPGJG744QNBCJLJgM51K1cT,SpATywNh6bZuzm8s1ceuBUnMUAeoAHHw,9,10,4,0,2,1,4,0,21,3.0,1,0.0,3,4,0,2,7,1,0,4,0,9,12,1
292,6197,6A2JLpLWnCwUlo9pD1HHlgEwNLvzcllv,SpATywNh6bZuzm8s1ceuBUnMUAeoAHHw,14,14,8,12,5,0,2,0,41,5.857142857142857,3,0.0,4,8,9,5,10,0,3,2,0,26,15,1
293,6203,qwOn6svjZUr6PbEPbdgCynJcocJs2Tff,SpATywNh6bZuzm8s1ceuBUnMUAeoAHHw,17,28,14,10,6,14,15,0,87,12.428571428571429,3,0.0,6,14,10,6,22,14,0,15,0,36,51,0
294,6215,FgYPvBwLri7YiFI9og6clP9FuKJ08jX7,SpATywNh6bZuzm8s1ceuBUnMUAeoAHHw,14,28,12,14,5,1,4,0,64,9.142857142857142,3,0.0,9,12,13,5,19,1,1,4,0,39,25,1
295,6217,xVu6NAX59MOmpApYDfs9WPe7YPPVhsFD,A3fsA9Zfv1X2fVEQhTw51lKENdNrEqT3,15,9,7,12,6,0,2,0,36,5.142857142857143,1,0.0,0,7,10,6,9,0,2,2,0,23,13,1
296,6222,2CJPniJdzPQB2xVD7usFld4N6998DubA,SpATywNh6bZuzm8s1ceuBUnMUAeoAHHw,16,21,9,12,4,23,17,2,88,12.571428571428571,5,0.0,8,9,9,4,13,23,3,17,2,30,58,0
297,6235,ywdL3xkp7d2PSjbvnflAvIe7Wp6Q4SRe,A3fsA9Zfv1X2fVEQhTw51lKENdNrEqT3,39,25,10,92,6,0,6,0,139,19.857142857142858,3,0.0,1,10,75,6,24,0,17,6,0,92,47,0
298,6241,JOowoFboUWVsMh86KvKaqn28cyqJccLu,SpATywNh6bZuzm8s1ceuBUnMUAeoAHHw,15,40,4,19,1,32,14,1,111,15.857142857142858,6,0.0,20,4,16,1,20,32,3,14,1,41,70,1
299,6251,xHZbSROhwP4RRQerUVWvcNTfOGc2DHWf,A3fsA9Zfv1X2fVEQhTw51lKENdNrEqT3,39,29,9,64,5,9,15,0,131,18.714285714285715,2,0.0,3,9,51,5,26,9,13,15,0,68,63,0
300,6276,e05jFgKTpMKrOATktordZrOlXAadcmLm,bWdj2GDclj5ofokWjzoa5jAwMkxCykd6,4,2,1,0,1,0,1,0,5,0.7142857142857143,1,0.0,0,1,0,1,2,0,0,1,0,2,3,1
301,6297,IBlNXwDR3MmRt5PBvnP44ynAugPBAbiq,A3fsA9Zfv1X2fVEQhTw51lKENdNrEqT3,6,7,3,0,0,0,3,0,13,1.8571428571428572,2,0.0,0,3,0,0,7,0,0,3,0,3,10,1
302,6301,4NUGABfnQkRS9FoH90Vgnhdha4tRSmOB,A3fsA9Zfv1X2fVEQhTw51lKENdNrEqT3,23,28,18,0,12,0,10,0,68,9.714285714285714,5,0.0,0,18,0,12,28,0,0,10,0,30,38,0
303,6322,2IvFgMw0NfaiiFt35dmyYrQHt1TRMHZA,SpATywNh6bZuzm8s1ceuBUnMUAeoAHHw,18,47,17,14,6,84,63,6,237,33.857142857142854,3,0.0,16,17,13,6,31,84,1,63,6,52,185,0
304,6333,VRqncpDBm1hyq75gsrR3U5uyrx0nFI6D,G8EPVSXsOYB5YQWZGiz1aVq5Pgr2GrQu,8,10,6,0,3,0,3,0,22,3.142857142857143,1,0.0,0,6,0,3,10,0,0,3,0,9,13,0
305,6361,8nT76hrzyl8ZAUdI7W6kfrIzHxI3puKM,A3fsA9Zfv1X2fVEQhTw51lKENdNrEqT3,15,25,0,0,0,0,9,0,34,4.857142857142857,4,0.0,0,0,0,0,25,0,0,9,0,0,34,0
306,6386,sgU8bYbkNg27HLTOfRzwWIg1HmjCd9Xd,SpATywNh6bZuzm8s1ceuBUnMUAeoAHHw,15,19,1,21,1,1,7,1,51,7.285714285714286,1,0.0,8,1,18,1,11,1,3,7,1,28,23,0
307,6391,VWT0erf4AD2BzAGMlVwaBcrhUFyVXGW3,SpATywNh6bZuzm8s1ceuBUnMUAeoAHHw,14,28,1,16,0,48,18,2,113,16.142857142857142,3,0.0,12,1,14,0,16,48,2,18,2,27,86,0
308,6396,mXsmDArxUTe9rMFHp3cGPJEx5ACYKD90,SpATywNh6bZuzm8s1ceuBUnMUAeoAHHw,5,4,3,0,1,0,1,0,9,1.2857142857142858,1,0.0,0,3,0,1,4,0,0,1,0,4,5,0
309,6407,y7mamutAMELy79Bgdj0zOeVjiQ071oNX,SpATywNh6bZuzm8s1ceuBUnMUAeoAHHw,10,14,4,2,4,0,2,0,26,3.7142857142857144,1,0.0,3,4,2,4,11,0,0,2,0,13,13,0
310,6427,vuqnfFRpmwKE9RdxK6XJMNF9m6H6VyTM,RXDvfPUBYFlVdlueBFbLW0mhhAyGEqpt,48,63,40,113,20,17,18,12,283,40.42857142857143,3,0.0,13,40,100,20,50,17,13,18,12,173,110,0
311,6453,thQSVbeIiNRLplpbUVbYa004tKe0jz1z,SpATywNh6bZuzm8s1ceuBUnMUAeoAHHw,12,22,3,14,0,0,7,0,46,6.571428571428571,3,0.0,2,3,12,0,20,0,2,7,0,17,29,1
312,6473,QYNtwRXZGk0TiZU9fvvZmyYTg9wzmVe8,bWdj2GDclj5ofokWjzoa5jAwMkxCykd6,20,37,9,64,5,25,19,1,160,22.857142857142858,5,0.0,9,9,59,5,28,25,5,19,1,82,78,0
313,6475,4NUGABfnQkRS9FoH90Vgnhdha4tRSmOB,SpATywNh6bZuzm8s1ceuBUnMUAeoAHHw,18,40,16,12,3,7,29,1,108,15.428571428571429,6,0.0,12,16,9,3,28,7,3,29,1,40,68,0
314,6476,5l7JbkjmfBonHdF7CbCa3GMejToAwTQZ,SpATywNh6bZuzm8s1ceuBUnMUAeoAHHw,15,29,3,16,0,4,20,2,74,10.571428571428571,3,0.0,9,3,13,0,20,4,3,20,2,25,49,1
315,6494,w1o1S1rsKOagmFCmrSXvpPsO3fHW3lAq,A3fsA9Zfv1X2fVEQhTw51lKENdNrEqT3,42,26,16,76,11,12,18,4,163,23.285714285714285,2,0.0,4,16,61,11,22,12,15,18,4,92,71,1
316,6497,QYNtwRXZGk0TiZU9fvvZmyYTg9wzmVe8,A3fsA9Zfv1X2fVEQhTw51lKENdNrEqT3,39,81,3,80,2,151,39,2,358,51.142857142857146,5,0.0,6,3,63,2,75,151,17,39,2,74,284,0
317,6502,MFUbiMqXEmfaBzK7hirtX5aBXDvqfQ39,RXDvfPUBYFlVdlueBFbLW0mhhAyGEqpt,4,3,2,0,2,0,2,0,9,1.2857142857142858,2,0.0,0,2,0,2,3,0,0,2,0,4,5,0
318,6527,iYw8kPkvjn3xb3wtZEyAytTepRhqUlKj,SpATywNh6bZuzm8s1ceuBUnMUAeoAHHw,17,39,20,16,8,4,15,1,103,14.714285714285714,3,0.0,4,20,14,8,35,4,2,15,1,46,57,0
319,6542,wSw0H7eAN6dfAeYMaWU4nG5bgtRJyFlj,SpATywNh6bZuzm8s1ceuBUnMUAeoAHHw,11,40,0,0,0,20,9,1,70,10.0,5,0.0,2,0,0,0,38,20,0,9,1,2,68,0
320,6547,6U06x0rZdU2wXE04MeChX934BjpYCGYO,A3fsA9Zfv1X2fVEQhTw51lKENdNrEqT3,37,26,16,44,5,15,8,1,115,16.428571428571427,2,0.0,1,16,42,5,25,15,2,8,1,64,51,0
321,6551,uiGGvm5bzelA6YjURZYgSYljUTVOBIB1,A3fsA9Zfv1X2fVEQhTw51lKENdNrEqT3,1,0,0,0,0,0,1,0,1,0.14285714285714285,1,0.0,0,0,0,0,0,0,0,1,0,0,1,1
322,6556,xeRiyg2Y5ZgvqPGiWyjXk0hLMBeGkeoJ,RXDvfPUBYFlVdlueBFbLW0mhhAyGEqpt,4,2,1,0,1,0,1,0,5,0.7142857142857143,1,0.0,0,1,0,1,2,0,0,1,0,2,3,0
323,6563,5zX31TZPkBQ4nxGKP7lPYFABTGNW6PHa,A3fsA9Zfv1X2fVEQhTw51lKENdNrEqT3,15,18,2,0,2,0,3,0,25,3.5714285714285716,2,0.0,0,2,0,2,18,0,0,3,0,4,21,1
324,6576,X1EwqmDy4MdORdVb79oGgVGVtNlVZgX3,A3fsA9Zfv1X2fVEQhTw51lKENdNrEqT3,7,1,1,0,0,1,8,1,12,1.7142857142857142,1,0.0,0,1,0,0,1,1,0,8,1,1,11,1
325,6579,FxyjnTbjAUnINdJgNqjfUflUXLEYBAKC,SpATywNh6bZuzm8s1ceuBUnMUAeoAHHw,15,50,4,6,2,4,7,0,73,10.428571428571429,3,0.0,27,4,6,2,23,4,0,7,0,39,34,0
326,6619,TgtZeZ58ebuFniTgQX061K6ibFhvtBpU,SpATywNh6bZuzm8s1ceuBUnMUAeoAHHw,17,44,20,22,6,3,13,3,111,15.857142857142858,5,0.0,6,20,19,6,38,3,3,13,3,51,60,0
327,6635,xKsPjk1jm2BE3h1iJlr6XUhvP4lcDdRk,RXDvfPUBYFlVdlueBFbLW0mhhAyGEqpt,49,68,42,130,24,10,13,2,289,41.285714285714285,5,0.0,16,42,119,24,52,10,11,13,2,201,88,0
328,6646,JV1BgG1khCT6s4RU5oY7ZOSmwW31Qjbp,SpATywNh6bZuzm8s1ceuBUnMUAeoAHHw,15,28,14,15,5,11,13,2,88,12.571428571428571,5,0.0,3,14,12,5,25,11,3,13,2,34,54,0
329,6651,imazrFpyX68kLUAydat119Z5XKshja9y,G8EPVSXsOYB5YQWZGiz1aVq5Pgr2GrQu,22,28,24,50,13,0,3,0,118,16.857142857142858,3,0.0,0,24,45,13,28,0,5,3,0,82,36,1
330,6664,7nQB7cjVdr2HijR82OoX1oMRPa42JjfY,bWdj2GDclj5ofokWjzoa5jAwMkxCykd6,18,37,22,40,12,24,16,0,151,21.571428571428573,2,0.0,8,22,35,12,29,24,5,16,0,77,74,0
331,6682,hl9NS7ZQVsxPwew9lFoMcbw555xXfA7K,SpATywNh6bZuzm8s1ceuBUnMUAeoAHHw,6,4,2,0,1,0,4,0,11,1.5714285714285714,2,0.0,0,2,0,1,4,0,0,4,0,3,8,1
332,6721,5EbadEY64E8d6mWCOGPXe4HNciATivZW,SpATywNh6bZuzm8s1ceuBUnMUAeoAHHw,16,58,21,12,6,10,13,1,121,17.285714285714285,2,0.0,29,21,12,6,29,10,0,13,1,68,53,0
333,6722,r5hJNp3FkX6JOBVI5bSeTBPneDl7PaKl,A3fsA9Zfv1X2fVEQhTw51lKENdNrEqT3,8,4,1,0,1,0,10,1,17,2.4285714285714284,2,0.0,0,1,0,1,4,0,0,10,1,2,15,1
334,6723,e12uQn96OlYfknMdqSXCXdImglIj4IRR,A3fsA9Zfv1X2fVEQhTw51lKENdNrEqT3,26,86,47,0,14,230,104,9,490,70.0,6,0.0,9,47,0,14,77,230,0,104,9,70,420,0
335,6725,2LSIOP9EwUlEUMR84kNdXwxCTBof59AV,SpATywNh6bZuzm8s1ceuBUnMUAeoAHHw,17,15,7,20,4,1,11,1,59,8.428571428571429,2,0.0,2,7,16,4,13,1,4,11,1,29,30,0
336,6734,XxYK4zbyqtm9UELp1oR6gZVKRAER78zL,A3fsA9Zfv1X2fVEQhTw51lKENdNrEqT3,20,16,12,0,9,29,17,1,84,12.0,2,0.0,0,12,0,9,16,29,0,17,1,21,63,1
337,6739,D5mwgoAPtfwdsFrdNADBqEJQSy8E0CUi,SpATywNh6bZuzm8s1ceuBUnMUAeoAHHw,17,28,17,8,4,12,18,2,89,12.714285714285714,5,0.0,5,17,8,4,23,12,0,18,2,34,55,0
338,6741,uOAgQLQslSL4cABC9ZqhaeK1XrisqlGh,SpATywNh6bZuzm8s1ceuBUnMUAeoAHHw,14,15,5,14,4,0,2,0,40,5.714285714285714,1,0.0,9,5,11,4,6,0,3,2,0,29,11,0
339,6761,DTS3O3ZujmzMefQXzAvfnTTqItcbsW8A,SpATywNh6bZuzm8s1ceuBUnMUAeoAHHw,13,20,4,16,0,0,7,0,47,6.714285714285714,1,0.0,7,4,14,0,13,0,2,7,0,25,22,0
340,6778,lVgq3gYt1tDiZq5EPAUcQ3qHGrMei1Rm,SpATywNh6bZuzm8s1ceuBUnMUAeoAHHw,16,10,6,6,3,12,12,4,53,7.571428571428571,1,0.0,2,6,5,3,8,12,1,12,4,16,37,0
341,6785,ptoBkN66Bt2QtZB1aEXx1ZVYWGKSe4nx,SpATywNh6bZuzm8s1ceuBUnMUAeoAHHw,13,19,4,5,3,19,14,0,64,9.142857142857142,2,0.0,0,4,4,3,19,19,1,14,0,11,53,0
342,6794,Yh46fozwerObqlP4OOrKTS69VvjT8dK1,A3fsA9Zfv1X2fVEQhTw51lKENdNrEqT3,39,12,9,90,8,0,6,0,125,17.857142857142858,3,0.0,2,9,86,8,10,0,4,6,0,105,20,1
343,6823,DeZ9eduD0lM3aHUAAOCnUrOhgp8jUmje,SpATywNh6bZuzm8s1ceuBUnMUAeoAHHw,5,3,1,0,0,0,2,0,6,0.8571428571428571,1,0.0,1,1,0,0,2,0,0,2,0,2,4,0
344,6825,QwrR0O4UOobB3AXjFyYOVMeWzFnayzmx,SpATywNh6bZuzm8s1ceuBUnMUAeoAHHw,17,40,13,18,5,72,60,9,217,31.0,5,0.0,23,13,15,5,17,72,3,60,9,56,161,1
345,6862,JtMmp5BCDQnYE7CMI3NvnX4aRCZsQW9K,A3fsA9Zfv1X2fVEQhTw51lKENdNrEqT3,26,108,55,0,17,208,144,4,536,76.57142857142857,7,0.0,0,55,0,17,108,208,0,144,4,72,464,0
346,6878,7fC3V6ivG07wUIMOmiYFzSlyjWvbYnYf,SpATywNh6bZuzm8s1ceuBUnMUAeoAHHw,10,8,0,14,0,11,7,0,40,5.714285714285714,3,0.0,2,0,13,0,6,11,1,7,0,15,25,0
347,6895,z69L6knExrBf5gtr9B70Dgt3D9Xtp8CH,A3fsA9Zfv1X2fVEQhTw51lKENdNrEqT3,21,16,12,0,9,4,11,0,52,7.428571428571429,1,0.0,1,12,0,9,15,4,0,11,0,22,30,1
348,6896,WVOs4Pi3ll5FpomkXlRuIpcugHN3f0rV,SpATywNh6bZuzm8s1ceuBUnMUAeoAHHw,16,27,6,8,5,31,9,1,87,12.428571428571429,2,0.0,19,6,8,5,8,31,0,9,1,38,49,0
349,6907,CjvViMn5KClGeXFftICAvm8SWkvn3LHW,A3fsA9Zfv1X2fVEQhTw51lKENdNrEqT3,39,17,12,46,8,28,11,3,125,17.857142857142858,2,0.0,2,12,44,8,15,28,2,11,3,66,59,1
350,6915,V29AZJRcvBxCayax5I99yuRivRNPAZjj,SpATywNh6bZuzm8s1ceuBUnMUAeoAHHw,8,3,2,0,2,1,4,1,13,1.8571428571428572,1,0.0,0,2,0,2,3,1,0,4,1,4,9,0
351,6920,V29AZJRcvBxCayax5I99yuRivRNPAZjj,A3fsA9Zfv1X2fVEQhTw51lKENdNrEqT3,8,2,1,0,1,13,11,1,29,4.142857142857143,1,0.0,0,1,0,1,2,13,0,11,1,2,27,0
352,6923,FXwY1YS9Ue01cJBRQTifvzVPDx1ARw9E,SpATywNh6bZuzm8s1ceuBUnMUAeoAHHw,3,2,0,0,0,0,1,0,3,0.42857142857142855,1,0.0,0,0,0,0,2,0,0,1,0,0,3,1
353,6934,nsZMAREUaN1W79W768VHLU7EdYuf3Qrp,G8EPVSXsOYB5YQWZGiz1aVq5Pgr2GrQu,41,83,8,58,14,9,24,2,198,28.285714285714285,6,0.0,31,8,44,14,52,9,14,24,2,97,101,0
354,6935,JR1R4x5j4WkP10KgaKlpdN5JIGsgsmdk,SpATywNh6bZuzm8s1ceuBUnMUAeoAHHw,14,13,6,10,4,0,3,0,36,5.142857142857143,2,0.0,4,6,9,4,9,0,1,3,0,23,13,1
355,6972,ySy2zYThCkVZr5MjEXuKxq60wfOynxkJ,RXDvfPUBYFlVdlueBFbLW0mhhAyGEqpt,40,47,1,92,3,11,12,0,166,23.714285714285715,2,0.0,11,1,89,3,36,11,3,12,0,104,62,0
356,6977,EO1ssFp8oIj0TSE3bDdD8GeuhxRs5RVg,SpATywNh6bZuzm8s1ceuBUnMUAeoAHHw,16,70,6,25,4,32,45,3,185,26.428571428571427,4,0.0,21,6,21,4,49,32,4,45,3,52,133,0
357,6982,R0LbBsHoep5Au5A4mW7do32jHSfgQD8E,SpATywNh6bZuzm8s1ceuBUnMUAeoAHHw,18,67,21,20,5,45,26,1,185,26.428571428571427,4,0.0,34,21,16,5,33,45,4,26,1,76,109,1
358,6986,7fC3V6ivG07wUIMOmiYFzSlyjWvbYnYf,bWdj2GDclj5ofokWjzoa5jAwMkxCykd6,14,15,1,102,0,4,5,0,127,18.142857142857142,2,0.0,4,1,93,0,11,4,9,5,0,98,29,0
359,6996,Ah63NhKhS4EP98tjvGlVfvoLlBn6V6BJ,A3fsA9Zfv1X2fVEQhTw51lKENdNrEqT3,2,0,0,0,0,0,2,0,2,0.2857142857142857,1,0.0,0,0,0,0,0,0,0,2,0,0,2,1
360,7009,oBSB2zh7bYN4yELh7x5ItqnxR463BvKC,bWdj2GDclj5ofokWjzoa5jAwMkxCykd6,15,137,45,38,30,1,20,0,271,38.714285714285715,6,0.0,32,45,37,30,105,1,1,20,0,144,127,0
361,7025,EFMEoi5W4mceo8rjft5LKrYvvT3E2eat,bWdj2GDclj5ofokWjzoa5jAwMkxCykd6,11,16,6,10,3,61,3,4,103,14.714285714285714,2,0.0,3,6,9,3,13,61,1,3,4,21,82,1
362,7030,AntKijOf83pltCnII9LLX8PQYe0F20yO,G8EPVSXsOYB5YQWZGiz1aVq5Pgr2GrQu,7,2,1,0,1,0,5,0,9,1.2857142857142858,1,0.0,0,1,0,1,2,0,0,5,0,2,7,0
363,7045,Qo4EYwRduG0qocv3scjgK3zQnLtIvid1,SpATywNh6bZuzm8s1ceuBUnMUAeoAHHw,11,41,16,0,4,4,10,2,77,11.0,3,0.0,0,16,0,4,41,4,0,10,2,20,57,0
364,7060,dGqImSq9UHavQbhAMWmMoDizcuOefX1Y,SpATywNh6bZuzm8s1ceuBUnMUAeoAHHw,13,32,0,16,0,26,8,2,84,12.0,2,0.0,16,0,13,0,16,26,3,8,2,29,55,0
365,7080,KqUCRL8ws5CG5PQvlspSHJpgFexIO4Jl,SpATywNh6bZuzm8s1ceuBUnMUAeoAHHw,12,43,2,22,2,0,3,0,72,10.285714285714286,2,0.0,20,2,18,2,23,0,4,3,0,42,30,0
366,7083,k85NFhuORfuDcrrXLAFWOhl0dHDWmC1t,bWdj2GDclj5ofokWjzoa5jAwMkxCykd6,6,5,2,0,2,0,2,0,11,1.5714285714285714,2,0.0,2,2,0,2,3,0,0,2,0,6,5,1
367,7117,RHl3DsvAX7TisJ7qBptmgrrtDAQvH7mr,A3fsA9Zfv1X2fVEQhTw51lKENdNrEqT3,8,6,5,0,4,0,1,0,16,2.2857142857142856,1,0.0,0,5,0,4,6,0,0,1,0,9,7,0
368,7124,DRhlp1eJHQqsxjCL0bRD6kkHN20HbJ4w,SpATywNh6bZuzm8s1ceuBUnMUAeoAHHw,14,32,15,8,11,0,3,0,69,9.857142857142858,3,0.0,13,15,8,11,19,0,0,3,0,47,22,0
369,7137,rT1OrFQC18rdvYkTGYqwRgC7eDvihHsc,bWdj2GDclj5ofokWjzoa5jAwMkxCykd6,14,63,32,0,4,266,79,4,448,64.0,7,0.0,3,32,0,4,60,266,0,79,4,39,409,0
370,7181,29zlPnPFaHRpKhWmQq4cQrKoDn0GEyMA,SpATywNh6bZuzm8s1ceuBUnMUAeoAHHw,18,62,27,15,8,8,36,1,157,22.428571428571427,5,0.0,13,27,13,8,49,8,2,36,1,61,96,1
371,7197,yiOlNWWu3p4vJ73FHFCmMYCNgzMDTrne,A3fsA9Zfv1X2fVEQhTw51lKENdNrEqT3,43,12,10,60,9,0,9,1,101,14.428571428571429,1,0.0,1,10,50,9,11,0,10,9,1,70,31,1
372,7219,t0cRwLqt3PES7T3WXJUMfvNkz6DOAsQy,G8EPVSXsOYB5YQWZGiz1aVq5Pgr2GrQu,33,61,18,74,11,31,10,1,206,29.428571428571427,3,0.0,28,18,50,11,33,31,24,10,1,107,99,0
373,7240,HJ4qDtw6u2JHJE7qmEDgWJOzWUYAv4mG,A3fsA9Zfv1X2fVEQhTw51lKENdNrEqT3,44,22,18,72,13,0,13,0,138,19.714285714285715,4,0.0,1,18,66,13,21,0,6,13,0,98,40,0
374,7256,D1NRZnTG0gvNQpfa2XPRkdGhYZVx3Bz8,RXDvfPUBYFlVdlueBFbLW0mhhAyGEqpt,45,29,18,96,10,0,6,8,167,23.857142857142858,3,0.0,8,18,85,10,21,0,11,6,8,121,46,0
375,7296,ObMYjZj16p1bGCa8nmaBIv8cDUPUXE5o,SpATywNh6bZuzm8s1ceuBUnMUAeoAHHw,11,11,0,6,0,1,5,0,23,3.2857142857142856,1,0.0,4,0,5,0,7,1,1,5,0,9,14,0
376,7297,bAkMyE6uCR0gc04pERZmDJrGVqJ4Z2Yi,G8EPVSXsOYB5YQWZGiz1aVq5Pgr2GrQu,12,13,4,14,3,0,3,0,37,5.285714285714286,1,0.0,8,4,9,3,5,0,5,3,0,24,13,0
377,7298,VSEOcWZYpZiKC2PUmidzj4VqbBnc3GAo,bWdj2GDclj5ofokWjzoa5jAwMkxCykd6,19,36,16,38,10,77,53,3,233,33.285714285714285,5,0.0,12,16,34,10,24,77,4,53,3,72,161,0
378,7325,3jh7S7idreXg4tLgwxk2JirIFS2kxatr,SpATywNh6bZuzm8s1ceuBUnMUAeoAHHw,17,41,17,22,8,7,17,1,113,16.142857142857142,4,0.0,7,17,18,8,34,7,4,17,1,50,63,0
379,7328,83p9ejSELsW1j5wNlAyUXF2YWFL8Z8tc,bWdj2GDclj5ofokWjzoa5jAwMkxCykd6,8,5,3,0,2,9,9,1,29,4.142857142857143,2,0.0,0,3,0,2,5,9,0,9,1,5,24,0
380,7344,B9KqNNxXBxHFUsJnQKQysblL3f8zF7sg,A3fsA9Zfv1X2fVEQhTw51lKENdNrEqT3,34,37,0,69,0,0,8,0,114,16.285714285714285,4,0.0,3,0,55,0,34,0,14,8,0,58,56,0
381,7356,uXSmZuPz2xNXPk2qFBcPykAtedr98vP4,RXDvfPUBYFlVdlueBFbLW0mhhAyGEqpt,41,34,18,80,12,3,3,0,150,21.428571428571427,2,0.0,10,18,75,12,24,3,5,3,0,115,35,0
382,7372,32uJBAomTJQIXKZnCX4K7PYoVfESGbct,A3fsA9Zfv1X2fVEQhTw51lKENdNrEqT3,5,14,3,0,3,0,3,0,23,3.2857142857142856,5,0.0,0,3,0,3,14,0,0,3,0,6,17,1
383,7385,ErlOpSNxC1ZbmJguJSp3ZjxFq4nCmwgx,G8EPVSXsOYB5YQWZGiz1aVq5Pgr2GrQu,16,38,9,2,3,0,19,2,73,10.428571428571429,3,0.0,5,9,1,3,33,0,1,19,2,18,55,0
384,7422,WKdxdVcCk0v6q8w6qEVoDAEpoNH9nq1b,A3fsA9Zfv1X2fVEQhTw51lKENdNrEqT3,43,37,18,66,10,4,12,0,147,21.0,3,0.0,3,18,53,10,34,4,13,12,0,84,63,1
385,7440,5TRqp5WlxU778HZGbnj0S6xLTaRfUJxG,SpATywNh6bZuzm8s1ceuBUnMUAeoAHHw,12,23,2,4,2,15,13,1,60,8.571428571428571,5,0.0,0,2,3,2,23,15,1,13,1,7,53,0
386,7463,zdqliI4eCBGH6nGv4KKIRZFL1YFXBytK,SpATywNh6bZuzm8s1ceuBUnMUAeoAHHw,18,59,22,20,7,105,44,2,259,37.0,6,0.0,23,22,16,7,36,105,4,44,2,68,191,0
387,7464,lFMYqumkG36iLJm9YwVpbzadzxUvswUa,bWdj2GDclj5ofokWjzoa5jAwMkxCykd6,1,0,0,0,0,0,2,0,2,0.2857142857142857,1,0.0,0,0,0,0,0,0,0,2,0,0,2,1
388,7466,lFMYqumkG36iLJm9YwVpbzadzxUvswUa,SpATywNh6bZuzm8s1ceuBUnMUAeoAHHw,12,20,11,11,0,5,7,0,54,7.714285714285714,3,0.0,6,11,9,0,14,5,2,7,0,26,28,0
389,7475,vRHTfFGO3STxLwMRkIw1geBTPnARvg2o,SpATywNh6bZuzm8s1ceuBUnMUAeoAHHw,15,21,12,6,6,8,14,0,67,9.571428571428571,3,0.0,1,12,5,6,20,8,1,14,0,24,43,0
390,7488,uUSTKM8g1hIskJbYHh1UiIQ6epHTSTNR,A3fsA9Zfv1X2fVEQhTw51lKENdNrEqT3,30,28,13,78,2,0,11,0,132,18.857142857142858,6,0.0,4,13,64,2,24,0,14,11,0,83,49,1
391,7491,uUSTKM8g1hIskJbYHh1UiIQ6epHTSTNR,RXDvfPUBYFlVdlueBFbLW0mhhAyGEqpt,26,30,18,32,9,0,8,0,97,13.857142857142858,3,0.0,3,18,32,9,27,0,0,8,0,62,35,0
392,7496,6qVy3H4VOdeTnu4v49EIcz51mS5B3gWH,SpATywNh6bZuzm8s1ceuBUnMUAeoAHHw,15,42,23,9,0,105,46,7,232,33.142857142857146,5,0.0,8,23,8,0,34,105,1,46,7,39,193,0
393,7503,0PrF4PViZdaRQhbt6FYXwLbcetJ8RnwC,A3fsA9Zfv1X2fVEQhTw51lKENdNrEqT3,33,23,1,80,1,0,11,0,116,16.571428571428573,4,0.0,1,1,69,1,22,0,11,11,0,72,44,0
394,7504,NH2DAS5rCP8HjIcwHAZxDBAjUjjdHeyM,SpATywNh6bZuzm8s1ceuBUnMUAeoAHHw,1,0,0,0,0,0,2,0,2,0.2857142857142857,1,0.0,0,0,0,0,0,0,0,2,0,0,2,0
395,7521,a3StgABPgimfVHzW1FR4usG9kIA0tZV5,bWdj2GDclj5ofokWjzoa5jAwMkxCykd6,8,51,2,2,3,0,11,0,69,9.857142857142858,5,0.0,8,2,2,3,43,0,0,11,0,15,54,1
396,7525,xNkIHhqS8GZXIqyoWwwS3ZeYfSmUsNJo,A3fsA9Zfv1X2fVEQhTw51lKENdNrEqT3,42,35,14,80,9,8,9,1,156,22.285714285714285,3,0.0,1,14,62,9,34,8,18,9,1,86,70,0
397,7535,8a9f5zlAzg00IZpxpFpd0Yys1Z1UDN82,RXDvfPUBYFlVdlueBFbLW0mhhAyGEqpt,12,12,7,0,2,0,7,0,28,4.0,2,0.0,1,7,0,2,11,0,0,7,0,10,18,1
398,7540,oRVMh8MBvWswMrCZYZVSC4ANhRghr3SC,RXDvfPUBYFlVdlueBFbLW0mhhAyGEqpt,24,33,16,13,5,5,11,2,85,12.142857142857142,4,0.0,3,16,13,5,30,5,0,11,2,37,48,1
399,7550,EGswqlieknT0DkOMjaOEPr1kJjoddSSw,G8EPVSXsOYB5YQWZGiz1aVq5Pgr2GrQu,30,53,6,42,6,70,20,6,203,29.0,5,0.0,8,6,33,6,45,70,9,20,6,53,150,0
400,7552,ljmWZCzWPqv1RXsn1q2wpsQtrnA1zct2,SpATywNh6bZuzm8s1ceuBUnMUAeoAHHw,13,17,1,12,1,1,6,0,38,5.428571428571429,3,0.0,4,1,9,1,13,1,3,6,0,15,23,0
401,7571,hPtqAQmVA3C7MVQi98nPJLfZYLyZ86Qe,SpATywNh6bZuzm8s1ceuBUnMUAeoAHHw,3,2,0,0,0,0,1,0,3,0.42857142857142855,1,0.0,0,0,0,0,2,0,0,1,0,0,3,1
402,7579,7KQcIrOp3KoypOTvziMED7rHtDH1CXtE,SpATywNh6bZuzm8s1ceuBUnMUAeoAHHw,5,0,0,0,0,11,4,0,15,2.142857142857143,1,0.0,0,0,0,0,0,11,0,4,0,0,15,1
403,7581,QoKkWqCz9JSPf2G2l4XrJl2BfFSq9X9B,RXDvfPUBYFlVdlueBFbLW0mhhAyGEqpt,19,33,2,44,2,10,11,7,109,15.571428571428571,3,0.0,6,2,37,2,27,10,7,11,7,47,62,0
404,7589,ljmWZCzWPqv1RXsn1q2wpsQtrnA1zct2,A3fsA9Zfv1X2fVEQhTw51lKENdNrEqT3,42,16,13,68,9,1,4,0,111,15.857142857142858,2,0.0,1,13,56,9,15,1,12,4,0,79,32,1
405,7628,hRBUrY0Ipi1X9aVKI1Gcp4xJWynJPCa6,SpATywNh6bZuzm8s1ceuBUnMUAeoAHHw,14,13,6,12,3,0,2,0,36,5.142857142857143,1,0.0,6,6,12,3,7,0,0,2,0,27,9,0
406,7633,11ljuSLdnPtPyfemLE7b9qn6qXcmssv1,SpATywNh6bZuzm8s1ceuBUnMUAeoAHHw,12,27,9,18,2,1,9,0,66,9.428571428571429,2,0.0,13,9,15,2,14,1,3,9,0,39,27,1
407,7652,PQ7ibn4CoD7R92qj9CnBXvU4YpUOqVHi,SpATywNh6bZuzm8s1ceuBUnMUAeoAHHw,16,18,8,4,5,4,11,3,53,7.571428571428571,2,0.0,7,8,4,5,11,4,0,11,3,24,29,0
408,7653,v9Jp2iBPSFTVxP8FrUe1odwfz8Hd1wS3,RXDvfPUBYFlVdlueBFbLW0mhhAyGEqpt,49,36,24,62,13,4,13,2,154,22.0,3,0.0,8,24,61,13,28,4,1,13,2,106,48,0
409,7675,LiEDHNjd9tDT7NPtKiOjuDJtkaP8cSxY,bWdj2GDclj5ofokWjzoa5jAwMkxCykd6,20,79,43,32,13,46,22,5,240,34.285714285714285,5,0.0,12,43,27,13,67,46,5,22,5,95,145,0
410,7679,GjmRL85Fx59ASzosh0kQzycWTmRCzek4,SpATywNh6bZuzm8s1ceuBUnMUAeoAHHw,7,6,1,0,1,1,3,0,12,1.7142857142857142,2,0.0,1,1,0,1,5,1,0,3,0,3,9,1
411,7702,ulNRkVxxtx7SLWYKYYIDWhAGHHFqHWWG,SpATywNh6bZuzm8s1ceuBUnMUAeoAHHw,17,18,8,11,4,3,11,1,56,8.0,3,0.0,5,8,11,4,13,3,0,11,1,28,28,0
412,7711,U4GXlaQk4qQjr2K7P59OKvXX0vv1Pxee,SpATywNh6bZuzm8s1ceuBUnMUAeoAHHw,14,40,5,21,1,0,18,2,87,12.428571428571429,6,0.0,11,5,18,1,29,0,3,18,2,35,52,0
413,7713,0W4XScVx81tfxJ0Qr09mHB39FqA62JyS,SpATywNh6bZuzm8s1ceuBUnMUAeoAHHw,12,15,3,19,2,2,2,0,43,6.142857142857143,2,0.0,6,3,17,2,9,2,2,2,0,28,15,1
414,7716,yG9o9nU1hVydCMiwULHDO2ptGPwb3jNJ,SpATywNh6bZuzm8s1ceuBUnMUAeoAHHw,12,18,7,6,3,2,3,0,39,5.571428571428571,3,0.0,8,7,6,3,10,2,0,3,0,24,15,1
415,7721,MAlRgKpZXlP3WrMKjRw2YskqEALVtCKw,SpATywNh6bZuzm8s1ceuBUnMUAeoAHHw,13,23,0,6,0,5,10,0,44,6.285714285714286,5,0.0,5,0,6,0,18,5,0,10,0,11,33,0
416,7727,h5vEAVTb94xGNGjpn4Ohi5mNcXfM0rMl,RXDvfPUBYFlVdlueBFbLW0mhhAyGEqpt,14,19,2,0,1,1,7,5,35,5.0,1,0.0,2,2,0,1,17,1,0,7,5,5,30,1
417,7742,zu1WAijSG0F2wy5x45xxD1w2SrPWGtuK,RXDvfPUBYFlVdlueBFbLW0mhhAyGEqpt,45,34,19,54,13,7,25,5,157,22.428571428571427,1,0.0,8,19,50,13,26,7,4,25,5,90,67,0
418,7748,cXt4yzdeLQWJ2a8N3WCCOFlxmV6sHALc,bWdj2GDclj5ofokWjzoa5jAwMkxCykd6,5,2,1,0,1,0,5,0,9,1.2857142857142858,1,0.0,0,1,0,1,2,0,0,5,0,2,7,1
419,7752,nIJT2WzxvFmAAdv0mMRGLvQiPT819gU3,SpATywNh6bZuzm8s1ceuBUnMUAeoAHHw,16,81,15,20,4,126,52,1,299,42.714285714285715,6,0.0,14,15,15,4,67,126,5,52,1,48,251,0
420,7753,kzQ1HmHoPnIhyiOH3J5g0gxiDZh4kW6J,RXDvfPUBYFlVdlueBFbLW0mhhAyGEqpt,7,3,2,0,2,0,3,0,10,1.4285714285714286,2,0.0,0,2,0,2,3,0,0,3,0,4,6,1
421,7762,2Sqmg51RWZnvGf1B4BEysn1wJm7yLaQl,G8EPVSXsOYB5YQWZGiz1aVq5Pgr2GrQu,18,19,2,42,1,3,9,0,76,10.857142857142858,1,0.0,4,2,40,1,15,3,2,9,0,47,29,0
422,7769,QV7Z9LfpjzP9d797QCfKxmoOjdo08shd,SpATywNh6bZuzm8s1ceuBUnMUAeoAHHw,17,19,8,7,4,12,7,1,58,8.285714285714286,2,0.0,7,8,7,4,12,12,0,7,1,26,32,0
423,7770,4dVGo2nGpdhjYgYbTYmjlligu2kflHn7,RXDvfPUBYFlVdlueBFbLW0mhhAyGEqpt,28,49,14,24,8,4,10,3,112,16.0,1,0.0,19,14,23,8,30,4,1,10,3,64,48,1
424,7782,EJ52dc9s4CYydLeBR3nGlXxXka6Fltqj,A3fsA9Zfv1X2fVEQhTw51lKENdNrEqT3,6,2,1,0,1,0,5,0,9,1.2857142857142858,1,0.0,0,1,0,1,2,0,0,5,0,2,7,0
425,7784,Y96AzEZtgYGN39EPdmAzdYPvLhv1Tzsf,SpATywNh6bZuzm8s1ceuBUnMUAeoAHHw,18,20,12,18,6,8,14,1,79,11.285714285714286,1,0.0,6,12,15,6,14,8,3,14,1,39,40,0
426,7787,b87ksD29UBdF2YCxTtUOCsx5OJsZrMS6,SpATywNh6bZuzm8s1ceuBUnMUAeoAHHw,8,12,1,0,0,4,5,0,22,3.142857142857143,1,0.0,2,1,0,0,10,4,0,5,0,3,19,1
427,7816,rbxp4ygAJiuJravRmpeSgvTRbWslY8KE,G8EPVSXsOYB5YQWZGiz1aVq5Pgr2GrQu,10,5,4,0,3,1,4,1,18,2.5714285714285716,1,0.0,0,4,0,3,5,1,0,4,1,7,11,1
428,7817,KLERBlLR5to2IuMEV6VaweaoU18ID2Ks,SpATywNh6bZuzm8s1ceuBUnMUAeoAHHw,8,4,2,0,1,0,7,0,14,2.0,1,0.0,0,2,0,1,4,0,0,7,0,3,11,1
429,7818,LMGbvXS3ZBgtTcKCRLMcqBHrfADBxwXe,SpATywNh6bZuzm8s1ceuBUnMUAeoAHHw,15,31,17,10,8,2,17,0,85,12.142857142857142,5,0.0,6,17,8,8,25,2,2,17,0,39,46,0
430,7835,3iSbhZU0XFdJUgUA6Ry01TQ9T4nPzP7c,SpATywNh6bZuzm8s1ceuBUnMUAeoAHHw,10,20,5,0,1,0,9,0,35,5.0,2,0.0,0,5,0,1,20,0,0,9,0,6,29,1
431,7838,S10grfxrn0tXcuL6DSaVTf7wyvXspCvq,SpATywNh6bZuzm8s1ceuBUnMUAeoAHHw,7,9,1,0,0,13,3,0,26,3.7142857142857144,1,0.0,2,1,0,0,7,13,0,3,0,3,23,0
432,7839,WYNpj52NyIePFOfUouGRXkQmACPQnP2J,SpATywNh6bZuzm8s1ceuBUnMUAeoAHHw,18,203,99,21,6,1240,180,4,1753,250.42857142857142,7,0.0,33,99,17,6,170,1240,4,180,4,155,1598,0
433,7853,70BrIR23BcsI705EZj4LSyr7fHWI0Xjf,A3fsA9Zfv1X2fVEQhTw51lKENdNrEqT3,25,34,22,0,17,0,7,0,80,11.428571428571429,3,0.0,0,22,0,17,34,0,0,7,0,39,41,0
434,7857,Z6YQS36VdHJFF4DkVSTcUgmOIdlOITNE,SpATywNh6bZuzm8s1ceuBUnMUAeoAHHw,14,35,11,18,5,0,5,0,74,10.571428571428571,3,0.0,16,11,15,5,19,0,3,5,0,47,27,0
435,7860,rWA9BhwEXXwDdj5p5FXRqP1JA3HaX1US,SpATywNh6bZuzm8s1ceuBUnMUAeoAHHw,6,4,1,0,1,0,2,0,8,1.1428571428571428,1,0.0,0,1,0,1,4,0,0,2,0,2,6,1
436,7863,bDqqR2hng29QNjexgLbMGRH4AJBfyli8,SpATywNh6bZuzm8s1ceuBUnMUAeoAHHw,13,15,10,4,5,5,9,1,49,7.0,3,0.0,0,10,3,5,15,5,1,9,1,18,31,1
437,7868,ptvDGcVFI5vzF4lBwRLTADNrenNp2tF2,SpATywNh6bZuzm8s1ceuBUnMUAeoAHHw,15,25,9,15,2,4,14,0,69,9.857142857142858,2,0.0,7,9,13,2,18,4,2,14,0,31,38,0
438,7870,sj7wQJWVAxmId67LlkoaFzAmqWKmeC7I,SpATywNh6bZuzm8s1ceuBUnMUAeoAHHw,1,0,0,0,0,0,1,0,1,0.14285714285714285,1,0.0,0,0,0,0,0,0,0,1,0,0,1,0
439,7883,JiNN6rHoPfwH1fuAk6q9tmTGqAFVjob4,SpATywNh6bZuzm8s1ceuBUnMUAeoAHHw,12,12,7,12,5,2,1,0,39,5.571428571428571,1,0.0,4,7,10,5,8,2,2,1,0,26,13,0
440,7923,pJUI0Hs11rZxgXk3r1clZCyuDCtGsbvH,SpATywNh6bZuzm8s1ceuBUnMUAeoAHHw,15,16,6,15,3,0,4,0,44,6.285714285714286,1,0.0,8,6,15,3,8,0,0,4,0,32,12,1
441,7933,dEPUxcdyZTnKUVP0o2JXv6VWX3ETnwmr,SpATywNh6bZuzm8s1ceuBUnMUAeoAHHw,14,37,24,3,3,8,34,6,115,16.428571428571427,3,0.0,11,24,3,3,26,8,0,34,6,41,74,1
442,7937,ywdL3xkp7d2PSjbvnflAvIe7Wp6Q4SRe,SpATywNh6bZuzm8s1ceuBUnMUAeoAHHw,15,27,13,21,5,0,14,1,81,11.571428571428571,5,0.0,4,13,17,5,23,0,4,14,1,39,42,0
443,7942,JNo2rLqKe6aBGDwGzu8tXd13uOC5tEnq,bWdj2GDclj5ofokWjzoa5jAwMkxCykd6,12,19,9,52,0,18,31,2,131,18.714285714285715,2,0.0,6,9,51,0,13,18,1,31,2,66,65,0
444,7949,FnY3or5QaQRvUAAgyu53eYBfcMnduugT,SpATywNh6bZuzm8s1ceuBUnMUAeoAHHw,16,30,8,14,3,11,12,1,79,11.285714285714286,5,0.0,8,8,12,3,22,11,2,12,1,31,48,0
445,7952,CI12SZIYH2QOfgaDvq8F4VKXwDinb334,SpATywNh6bZuzm8s1ceuBUnMUAeoAHHw,13,12,9,4,6,0,3,0,34,4.857142857142857,2,0.0,2,9,3,6,10,0,1,3,0,20,14,0
446,7954,WzyWOzB7f8AVbQvaWeU3O4gxEwZ13sIC,RXDvfPUBYFlVdlueBFbLW0mhhAyGEqpt,47,62,32,113,24,3,10,2,246,35.142857142857146,5,0.0,18,32,107,24,44,3,6,10,2,181,65,0
447,7956,ljmWZCzWPqv1RXsn1q2wpsQtrnA1zct2,G8EPVSXsOYB5YQWZGiz1aVq5Pgr2GrQu,73,85,3,200,5,15,6,0,314,44.857142857142854,2,0.0,48,3,133,5,37,15,67,6,0,189,125,1
448,7962,mtW8rWxW2XwZIB5TM8b8gUVmE4UACp0R,SpATywNh6bZuzm8s1ceuBUnMUAeoAHHw,14,16,9,6,3,0,3,0,37,5.285714285714286,4,0.0,4,9,6,3,12,0,0,3,0,22,15,0
449,7964,z8zMi50azvRwAPUNW2f5Gt0F6WOr8PI9,A3fsA9Zfv1X2fVEQhTw51lKENdNrEqT3,11,7,6,0,4,0,2,0,19,2.7142857142857144,2,0.0,0,6,0,4,7,0,0,2,0,10,9,1
450,7967,Wyji6pvgj7unEJ4mD7FWwu0Sma8fUdv4,SpATywNh6bZuzm8s1ceuBUnMUAeoAHHw,8,4,2,0,1,1,9,0,17,2.4285714285714284,1,0.0,0,2,0,1,4,1,0,9,0,3,14,0
451,7973,SUqHrTqjE8jHVpASqCaMjjR6iZ17k2Gq,SpATywNh6bZuzm8s1ceuBUnMUAeoAHHw,16,23,12,12,4,1,16,1,69,9.857142857142858,5,0.0,2,12,10,4,21,1,2,16,1,28,41,0
452,7975,EwJz8sdPLnTPbvCqxQKV7YueKEdP0wYf,SpATywNh6bZuzm8s1ceuBUnMUAeoAHHw,16,26,15,15,8,4,8,0,76,10.857142857142858,3,0.0,6,15,13,8,20,4,2,8,0,42,34,0
453,8000,YiNeIrEOhZYEzsuuN5nQKcsVr5To2nDU,SpATywNh6bZuzm8s1ceuBUnMUAeoAHHw,14,15,9,12,5,2,8,0,51,7.285714285714286,3,0.0,5,9,12,5,10,2,0,8,0,31,20,0
454,8026,KtSnhyXFi6bevwD38L0oZAkqxHVX0Rkl,RXDvfPUBYFlVdlueBFbLW0mhhAyGEqpt,20,26,9,31,15,13,6,19,119,17.0,2,0.0,13,9,29,15,13,13,2,6,19,66,53,1
455,8029,cuDL2ISAKT9SiekAD9CQynXiu9fQTVyV,G8EPVSXsOYB5YQWZGiz1aVq5Pgr2GrQu,43,45,5,148,4,8,25,5,240,34.285714285714285,6,0.0,0,5,115,4,45,8,33,25,5,124,116,0
456,8031,Ra8GzsxOGVkAaMFXN2T6V1Y5fgtJJH5X,SpATywNh6bZuzm8s1ceuBUnMUAeoAHHw,13,29,1,22,1,4,11,0,68,9.714285714285714,4,0.0,4,1,20,1,25,4,2,11,0,26,42,0
457,8051,HZ6Si9PJ3YYyrZuVsVHlXbrETWWPILa2,SpATywNh6bZuzm8s1ceuBUnMUAeoAHHw,17,16,7,19,3,4,12,1,62,8.857142857142858,2,0.0,8,7,16,3,8,4,3,12,1,34,28,1
458,8059,W8K4VS8rPvnPTNUJrqgtS2FKH93KmR91,bWdj2GDclj5ofokWjzoa5jAwMkxCykd6,9,15,7,0,0,0,7,0,29,4.142857142857143,3,0.0,0,7,0,0,15,0,0,7,0,7,22,1
459,8061,eDdFtfGTTqvukOdpQCeNfhpEnZacRMyL,SpATywNh6bZuzm8s1ceuBUnMUAeoAHHw,16,20,12,12,4,0,14,0,62,8.857142857142858,3,0.0,3,12,12,4,17,0,0,14,0,31,31,0
460,8065,F4JRzQAurYVB0YRhdceJcfWH3R0QimyF,A3fsA9Zfv1X2fVEQhTw51lKENdNrEqT3,6,9,0,0,0,1,4,0,14,2.0,1,0.0,0,0,0,0,9,1,0,4,0,0,14,1
461,8078,nD2aR2lBTYEZ05tUWGjogkwgt2d7zeNx,bWdj2GDclj5ofokWjzoa5jAwMkxCykd6,19,34,2,100,3,25,18,1,183,26.142857142857142,2,0.0,8,2,94,3,26,25,6,18,1,107,76,1
462,8087,3nOS3JEH08BgwunQqioyEFfja4qIND4p,A3fsA9Zfv1X2fVEQhTw51lKENdNrEqT3,37,26,3,58,2,0,7,0,96,13.714285714285714,2,0.0,5,3,51,2,21,0,7,7,0,61,35,1
463,8120,9vfzrI57qoGmouqr760GeuDugjxYZgDg,A3fsA9Zfv1X2fVEQhTw51lKENdNrEqT3,2,0,0,0,0,0,2,0,2,0.2857142857142857,1,0.0,0,0,0,0,0,0,0,2,0,0,2,1
464,8124,aFQfsfvTRloUF4eJLXlE0V3FUzRLFNv8,RXDvfPUBYFlVdlueBFbLW0mhhAyGEqpt,8,6,3,0,2,0,2,0,13,1.8571428571428572,1,0.0,2,3,0,2,4,0,0,2,0,7,6,1
465,8131,0chnDCxU68X7ybwDimwVoWcTfCUDrb8j,SpATywNh6bZuzm8s1ceuBUnMUAeoAHHw,17,15,6,18,4,73,12,4,132,18.857142857142858,1,0.0,7,6,15,4,8,73,3,12,4,32,100,1
466,8150,0QzhB266MffxtP4NW9xGCK2aFIanQJEL,SpATywNh6bZuzm8s1ceuBUnMUAeoAHHw,17,45,19,16,6,188,35,6,315,45.0,5,0.0,18,19,13,6,27,188,3,35,6,56,259,1
467,8155,S6HVmLPlerZStE1FmYWcP13FOlr0Ldio,SpATywNh6bZuzm8s1ceuBUnMUAeoAHHw,12,22,0,11,0,4,5,0,42,6.0,1,0.0,13,0,10,0,9,4,1,5,0,23,19,1
468,8164,OvIrFDXnTf7lPGXHN37tKh2m9dXSHGJK,RXDvfPUBYFlVdlueBFbLW0mhhAyGEqpt,51,94,53,106,17,106,44,9,429,61.285714285714285,6,0.0,14,53,103,17,80,106,3,44,9,187,242,0
469,8167,4OFy9ZLb1svxpVgXkgI60wOGeiU4V4oA,SpATywNh6bZuzm8s1ceuBUnMUAeoAHHw,18,38,18,20,5,1,15,1,98,14.0,2,0.0,8,18,16,5,30,1,4,15,1,47,51,1
470,8171,Agc8I1aREEPfi2PqA7NK0aenTcuvE1HC,SpATywNh6bZuzm8s1ceuBUnMUAeoAHHw,16,25,14,16,5,18,6,2,86,12.285714285714286,3,0.0,6,14,13,5,19,18,3,6,2,38,48,0
471,8174,ZFeBOOLKgUUTF7XgzMMbqDAJmFSviC7K,SpATywNh6bZuzm8s1ceuBUnMUAeoAHHw,14,24,9,0,3,1,9,1,47,6.714285714285714,3,0.0,5,9,0,3,19,1,0,9,1,17,30,0
472,8182,LVZNwk74X0NnQqnGU1Um0MYH9C8V0Gpb,A3fsA9Zfv1X2fVEQhTw51lKENdNrEqT3,29,28,22,4,17,1,10,1,83,11.857142857142858,1,0.0,0,22,3,17,28,1,1,10,1,42,41,1
473,8183,FFyynYy7wGQKjNauntgybGuFHItz8juf,G8EPVSXsOYB5YQWZGiz1aVq5Pgr2GrQu,48,33,17,126,11,0,6,0,193,27.571428571428573,3,0.0,0,17,106,11,33,0,20,6,0,134,59,0
474,8189,vJz36xQo6TWpiQM1Na1nFu4lVJoSD2XQ,A3fsA9Zfv1X2fVEQhTw51lKENdNrEqT3,11,5,1,0,1,1,8,1,17,2.4285714285714284,2,0.0,0,1,0,1,5,1,0,8,1,2,15,1
475,8190,yFLanYq8p4sf6NFSB1Td9ag6632plY4t,bWdj2GDclj5ofokWjzoa5jAwMkxCykd6,14,20,12,12,7,0,10,0,61,8.714285714285714,3,0.0,3,12,11,7,17,0,1,10,0,33,28,1
476,8194,I2GJVZ7RHpZycmvh6r4mj8R0Y34OZpBl,SpATywNh6bZuzm8s1ceuBUnMUAeoAHHw,16,40,2,16,1,11,21,1,92,13.142857142857142,5,0.0,9,2,13,1,31,11,3,21,1,25,67,1
477,8200,myPDU4mr5TIDvQCh3WcoSxbhe6fCunPv,SpATywNh6bZuzm8s1ceuBUnMUAeoAHHw,15,14,3,3,2,1,6,1,30,4.285714285714286,1,0.0,2,3,3,2,12,1,0,6,1,10,20,0
478,8216,PR09vSIT2XyOVxXQjGmEX911FaSVIYTE,SpATywNh6bZuzm8s1ceuBUnMUAeoAHHw,17,18,7,14,4,3,9,1,56,8.0,3,0.0,6,7,13,4,12,3,1,9,1,30,26,1
479,8223,nx1z63DgmeEAxW8gQgEbpcNs34kbRne4,bWdj2GDclj5ofokWjzoa5jAwMkxCykd6,2,0,0,0,0,0,5,0,5,0.7142857142857143,3,0.0,0,0,0,0,0,0,0,5,0,0,5,1
480,8224,5u57vWlYBlYDQJhbIpJzLY4ZLMAv0Mtf,SpATywNh6bZuzm8s1ceuBUnMUAeoAHHw,16,25,7,15,6,34,9,5,101,14.428571428571429,2,0.0,12,7,14,6,13,34,1,9,5,39,62,1
481,8234,1IMOvf9v1bRH0tUTRkiIkzGe833lnAgf,SpATywNh6bZuzm8s1ceuBUnMUAeoAHHw,14,21,7,8,3,2,2,0,43,6.142857142857143,1,0.0,12,7,7,3,9,2,1,2,0,29,14,1
482,8242,3mL78JhEm154Hwp0XQW8ZVuzbvUw5uCk,SpATywNh6bZuzm8s1ceuBUnMUAeoAHHw,13,34,14,3,5,2,8,1,67,9.571428571428571,3,0.0,7,14,3,5,27,2,0,8,1,29,38,0
483,8259,DVIil2NM7ZWOtqe6rhlMzwEUAb2wuaeh,bWdj2GDclj5ofokWjzoa5jAwMkxCykd6,7,10,7,0,4,0,1,0,22,3.142857142857143,1,0.0,2,7,0,4,8,0,0,1,0,13,9,0
484,8260,DVIil2NM7ZWOtqe6rhlMzwEUAb2wuaeh,A3fsA9Zfv1X2fVEQhTw51lKENdNrEqT3,25,22,19,7,10,7,5,0,70,10.0,2,0.0,0,19,7,10,22,7,0,5,0,36,34,0
485,8271,Bf5XnSmEHpp62KAmmEq9Qh5nAQvits8I,SpATywNh6bZuzm8s1ceuBUnMUAeoAHHw,9,6,5,0,5,1,7,1,25,3.5714285714285716,2,0.0,0,5,0,5,6,1,0,7,1,10,15,1
486,8275,GHabqgRgi0KXSBTYXxIc3mcQESEOp0QM,SpATywNh6bZuzm8s1ceuBUnMUAeoAHHw,9,6,3,2,1,3,5,1,21,3.0,1,0.0,1,3,2,1,5,3,0,5,1,7,14,0
487,8276,V7y3ErWDx79HQwDxdGqBqCI3nEwG2a9C,SpATywNh6bZuzm8s1ceuBUnMUAeoAHHw,15,21,2,8,1,37,22,1,92,13.142857142857142,3,0.0,2,2,7,1,19,37,1,22,1,12,80,0
488,8280,41Lg2hcbw0N9iuSjhrPTYqB7aTnux5zG,SpATywNh6bZuzm8s1ceuBUnMUAeoAHHw,15,25,12,14,3,0,12,0,66,9.428571428571429,5,0.0,2,12,13,3,23,0,1,12,0,30,36,0
489,8299,SYTowVKdp8XatPrqrpe4A3JAMuYI5Sox,A3fsA9Zfv1X2fVEQhTw51lKENdNrEqT3,3,3,0,0,0,0,2,0,5,0.7142857142857143,1,0.0,0,0,0,0,3,0,0,2,0,0,5,1
490,8307,U091mKrbkiTDzf4rGIqu8muSeBSZhUjL,A3fsA9Zfv1X2fVEQhTw51lKENdNrEqT3,37,18,10,76,6,0,4,0,114,16.285714285714285,2,0.0,5,10,61,6,13,0,15,4,0,82,32,1
491,8327,Rxx8uEqY3FOt7Egy2EEEwihJJCyVsQKy,G8EPVSXsOYB5YQWZGiz1aVq5Pgr2GrQu,41,53,28,40,23,3,17,4,168,24.0,3,0.0,16,28,32,23,37,3,8,17,4,99,69,0
492,8330,RPoQoiLJoTfoUXTEomWL6iW4S8GRhX7J,SpATywNh6bZuzm8s1ceuBUnMUAeoAHHw,13,20,8,17,3,0,5,0,53,7.571428571428571,2,0.0,4,8,14,3,16,0,3,5,0,29,24,0
493,8335,2tvGCUYYinrGZmVDaUEHPItUSSMqiKmY,SpATywNh6bZuzm8s1ceuBUnMUAeoAHHw,15,15,10,15,7,0,4,0,51,7.285714285714286,2,0.0,3,10,14,7,12,0,1,4,0,34,17,0
494,8336,UgRvVqO3twMvJzAlD49rqrTbxTS8yLpX,A3fsA9Zfv1X2fVEQhTw51lKENdNrEqT3,23,18,14,0,9,0,7,0,48,6.857142857142857,3,0.0,0,14,0,9,18,0,0,7,0,23,25,1
495,8337,SP1OGXx7XA1zodabwHSZpThCzaY2Fjl2,SpATywNh6bZuzm8s1ceuBUnMUAeoAHHw,10,18,5,6,1,21,8,0,59,8.428571428571429,6,0.0,4,5,6,1,14,21,0,8,0,16,43,0
496,8359,xI8Nr9tpm5UYMfkPTEK7ZnHqHm9s1zwr,SpATywNh6bZuzm8s1ceuBUnMUAeoAHHw,13,23,0,19,0,2,6,1,51,7.285714285714286,3,0.0,6,0,16,0,17,2,3,6,1,22,29,1
497,8389,NngMZQTGAdrhmbSK51CUolNQSpFXDhiO,SpATywNh6bZuzm8s1ceuBUnMUAeoAHHw,18,50,21,11,5,6,30,1,124,17.714285714285715,5,0.0,10,21,9,5,40,6,2,30,1,45,79,0
498,8391,tF8i4h1a2Nm3JCN3xA7kONOWBOERcJ4Q,SpATywNh6bZuzm8s1ceuBUnMUAeoAHHw,17,27,11,23,4,2,9,0,76,10.857142857142858,3,0.0,12,11,19,4,15,2,4,9,0,46,30,0
499,8393,4sCPuVlkq4rBRlBYNyTR5EDg94co1oy4,bWdj2GDclj5ofokWjzoa5jAwMkxCykd6,4,2,1,0,1,0,2,0,6,0.8571428571428571,1,0.0,0,1,0,1,2,0,0,2,0,2,4,0
500,8400,LutlROyPHhGEkAfetUikskFihdvWMQNQ,SpATywNh6bZuzm8s1ceuBUnMUAeoAHHw,3,0,0,0,0,0,4,0,4,0.5714285714285714,1,0.0,0,0,0,0,0,0,0,4,0,0,4,1
501,8405,kWUbu8oK1dFJKpHhiF15MwcSzNzv8GaS,bWdj2GDclj5ofokWjzoa5jAwMkxCykd6,18,47,24,96,12,25,12,0,216,30.857142857142858,4,0.0,10,24,91,12,37,25,5,12,0,137,79,0
502,8416,mrUvSMVJRVrLlCOcTH6rs5HGHSxrWvwY,A3fsA9Zfv1X2fVEQhTw51lKENdNrEqT3,42,28,16,60,11,1,8,1,125,17.857142857142858,3,0.0,7,16,50,11,21,1,10,8,1,84,41,1
503,8435,j1jdy8OF5VQw4rqSYOkbK2pQplvvvz37,A3fsA9Zfv1X2fVEQhTw51lKENdNrEqT3,45,60,12,48,10,9,26,0,165,23.571428571428573,5,0.0,4,12,38,10,56,9,10,26,0,64,101,0
504,8437,12tfSRcVHU1LY6VYbYjnNdGrVUGUAhWB,SpATywNh6bZuzm8s1ceuBUnMUAeoAHHw,17,31,15,10,7,3,11,1,78,11.142857142857142,3,0.0,11,15,8,7,20,3,2,11,1,41,37,0
505,8446,oDnQYjxji4p3XVFJMOGI9NvIvASqoqC1,A3fsA9Zfv1X2fVEQhTw51lKENdNrEqT3,16,10,8,0,8,0,8,0,34,4.857142857142857,1,0.0,0,8,0,8,10,0,0,8,0,16,18,1
506,8447,gok0oMg5xY1pC9HgrOtGpZy6NUwXLxlf,SpATywNh6bZuzm8s1ceuBUnMUAeoAHHw,6,14,0,0,0,1,8,0,23,3.2857142857142856,2,0.0,0,0,0,0,14,1,0,8,0,0,23,1
507,8461,tH916xRbn4bSZXJ6Z57PlnTAPQfz04PX,SpATywNh6bZuzm8s1ceuBUnMUAeoAHHw,5,2,1,0,1,0,2,0,6,0.8571428571428571,1,0.0,0,1,0,1,2,0,0,2,0,2,4,0
508,8486,BeZnyZhcScrHr8WAPYtxUxDjMPiK7yK1,SpATywNh6bZuzm8s1ceuBUnMUAeoAHHw,10,21,10,0,4,0,5,0,40,5.714285714285714,3,0.0,4,10,0,4,17,0,0,5,0,18,22,0
509,8492,ttr9a170CwLt0wxJRJXz9h6pCGNxEiGM,SpATywNh6bZuzm8s1ceuBUnMUAeoAHHw,7,5,0,0,0,0,6,0,11,1.5714285714285714,1,0.0,0,0,0,0,5,0,0,6,0,0,11,1
510,8494,gir9E9ZUbwj6bCUNLD2kQmOx1nsVwG4J,SpATywNh6bZuzm8s1ceuBUnMUAeoAHHw,16,33,12,14,5,9,11,0,84,12.0,4,0.0,15,12,14,5,18,9,0,11,0,46,38,1
511,8503,PtXR7nBc6ugMebaEp6mKjp0TYO5kZtvE,SpATywNh6bZuzm8s1ceuBUnMUAeoAHHw,18,34,19,18,7,18,13,1,110,15.714285714285714,4,0.0,9,19,14,7,25,18,4,13,1,49,61,0
512,8511,FjbDR3UaxcNBkb6IH3GDQCUcWtWdh8Qq,A3fsA9Zfv1X2fVEQhTw51lKENdNrEqT3,13,3,2,40,1,0,2,0,48,6.857142857142857,1,0.0,0,2,33,1,3,0,7,2,0,36,12,1
513,8539,ApFdQQBcLqTLoA4wIvtlnnwFs4FrlVS1,A3fsA9Zfv1X2fVEQhTw51lKENdNrEqT3,26,20,17,0,12,1,10,1,61,8.714285714285714,3,0.0,1,17,0,12,19,1,0,10,1,30,31,0
514,8542,DALf49Q7nGCtSxipmkha0WYpWi5x67si,SpATywNh6bZuzm8s1ceuBUnMUAeoAHHw,15,32,2,13,2,9,28,4,90,12.857142857142858,2,0.0,9,2,13,2,23,9,0,28,4,26,64,1
515,8552,pSX00XUyCx7VlmgWGN0d39OwC9BZ8bRV,A3fsA9Zfv1X2fVEQhTw51lKENdNrEqT3,44,19,14,46,9,3,8,0,99,14.142857142857142,2,0.0,1,14,43,9,18,3,3,8,0,67,32,1
516,8562,2YohZ5UKGzy1qUgVAShosLdhgm3pfvsR,RXDvfPUBYFlVdlueBFbLW0mhhAyGEqpt,19,23,3,21,2,0,6,11,66,9.428571428571429,3,0.0,5,3,20,2,18,0,1,6,11,30,36,1
517,8576,HHsJECDPslzJS0fyoCEbSGrnL1evzSJb,SpATywNh6bZuzm8s1ceuBUnMUAeoAHHw,10,11,5,0,3,3,6,2,30,4.285714285714286,2,0.0,3,5,0,3,8,3,0,6,2,11,19,0
518,8578,ctoSfpAfvm3av2aqkT0D3Yq8icDxZKCx,SpATywNh6bZuzm8s1ceuBUnMUAeoAHHw,2,0,0,0,0,0,3,0,3,0.42857142857142855,2,0.0,0,0,0,0,0,0,0,3,0,0,3,1
519,8579,5SaN6rc1Jws1AbkuHmPyLN82qDTc23Xp,SpATywNh6bZuzm8s1ceuBUnMUAeoAHHw,7,3,0,10,0,1,6,0,20,2.857142857142857,1,0.0,0,0,7,0,3,1,3,6,0,7,13,1
520,8580,NbSKhx4CxJyTkjcYgC3wEU9PLylFddj5,SpATywNh6bZuzm8s1ceuBUnMUAeoAHHw,10,54,2,0,0,14,21,6,97,13.857142857142858,2,0.0,31,2,0,0,23,14,0,21,6,33,64,0
521,8589,QiGOPB8shOtQ5nbvOvvOxzT1SShMMuAf,SpATywNh6bZuzm8s1ceuBUnMUAeoAHHw,13,17,5,23,3,0,1,0,49,7.0,1,0.0,7,5,18,3,10,0,5,1,0,33,16,0
522,8603,NDWoO09mCIeS4HdBeNYH7dNkyhIv3eXv,SpATywNh6bZuzm8s1ceuBUnMUAeoAHHw,5,2,1,0,1,0,3,0,7,1.0,2,0.0,0,1,0,1,2,0,0,3,0,2,5,1
523,8617,ls4yyZ7MYyWiEmQ5nJV5QAmKdBgFaV8n,G8EPVSXsOYB5YQWZGiz1aVq5Pgr2GrQu,25,27,10,58,8,0,7,0,110,15.714285714285714,3,0.0,16,10,45,8,11,0,13,7,0,79,31,1
524,8622,Y7IgoRAqVJfNlsulCSI4HObujHPSzoLA,A3fsA9Zfv1X2fVEQhTw51lKENdNrEqT3,13,8,6,0,5,0,2,0,21,3.0,2,0.0,0,6,0,5,8,0,0,2,0,11,10,1
525,8626,yq8YyMugEpZrcWzhPtzidXoqQsPJ81ZJ,G8EPVSXsOYB5YQWZGiz1aVq5Pgr2GrQu,4,2,0,0,0,1,2,0,5,0.7142857142857143,1,0.0,0,0,0,0,2,1,0,2,0,0,5,1
526,8635,jH123vWnpYTVLfmuSyled9Oau0AYvcx6,G8EPVSXsOYB5YQWZGiz1aVq5Pgr2GrQu,37,15,0,118,0,0,4,0,137,19.571428571428573,1,0.0,0,0,103,0,15,0,15,4,0,103,34,1
527,8637,YeutUTPU1KeBL2Vd5ZhxL2fFNQ8D7NVG,SpATywNh6bZuzm8s1ceuBUnMUAeoAHHw,17,41,12,12,3,10,14,3,95,13.571428571428571,1,0.0,21,12,12,3,20,10,0,14,3,48,47,1
528,8638,kXndrjnvT5RUWACXG428KqXdIpBxsEit,A3fsA9Zfv1X2fVEQhTw51lKENdNrEqT3,12,22,0,0,0,2,10,1,35,5.0,2,0.0,1,0,0,0,21,2,0,10,1,1,34,1
529,8644,4PVAcJZJLiNhJa8rMcHaqBMuPaZIl5Nm,SpATywNh6bZuzm8s1ceuBUnMUAeoAHHw,15,20,11,14,6,0,11,0,62,8.857142857142858,3,0.0,5,11,11,6,15,0,3,11,0,33,29,1
530,8647,pZDK7WA5fQeGMPFsats2GLmFnZbZQ7ed,SpATywNh6bZuzm8s1ceuBUnMUAeoAHHw,18,23,10,22,3,15,9,1,83,11.857142857142858,2,0.0,11,10,19,3,12,15,3,9,1,43,40,1
531,8654,nquBmikiqPFYvs17N894M5iUc88scoVO,SpATywNh6bZuzm8s1ceuBUnMUAeoAHHw,14,49,3,20,1,27,24,2,126,18.0,3,0.0,6,3,16,1,43,27,4,24,2,26,100,0
532,8661,CxzZVyClE1BEgH3USSirqOtKD3HSH7vg,SpATywNh6bZuzm8s1ceuBUnMUAeoAHHw,6,4,1,0,1,0,4,2,12,1.7142857142857142,1,0.0,0,1,0,1,4,0,0,4,2,2,10,1
533,8679,kyUPY0MEVeZNvkmrQxOn0CHNXLZiD03b,A3fsA9Zfv1X2fVEQhTw51lKENdNrEqT3,6,3,1,0,1,0,3,0,8,1.1428571428571428,3,0.0,0,1,0,1,3,0,0,3,0,2,6,1
534,8691,ESjXyWS3x5wlkZHp5KISOO9gy5mDNyIG,SpATywNh6bZuzm8s1ceuBUnMUAeoAHHw,7,3,2,0,2,0,3,0,10,1.4285714285714286,2,0.0,0,2,0,2,3,0,0,3,0,4,6,1
535,8700,je9A6l6tP7wnbFhNJD7vbbHTYhqshuqB,G8EPVSXsOYB5YQWZGiz1aVq5Pgr2GrQu,42,86,28,68,13,5,9,0,209,29.857142857142858,3,0.0,32,28,51,13,54,5,17,9,0,124,85,0
536,8701,kxC3AAELak9RRmJoG2dzH7rfP0Xyo0FH,SpATywNh6bZuzm8s1ceuBUnMUAeoAHHw,12,16,10,4,3,0,5,0,38,5.428571428571429,2,0.0,0,10,4,3,16,0,0,5,0,17,21,1
537,8730,JoruyAOmEeM1qjcSEWRUjLvQUHpNPZGp,RXDvfPUBYFlVdlueBFbLW0mhhAyGEqpt,27,40,2,34,4,50,23,4,157,22.428571428571427,4,0.0,10,2,30,4,30,50,4,23,4,46,111,1
538,8735,WNT8mFhPmDPRuQT8JLsnindelSr1MnST,SpATywNh6bZuzm8s1ceuBUnMUAeoAHHw,17,29,14,13,4,28,18,3,109,15.571428571428571,3,0.0,10,14,12,4,19,28,1,18,3,40,69,1
539,8758,NCbFqYNTEfc5vPQvAyBwDtnbS3ENYJY7,bWdj2GDclj5ofokWjzoa5jAwMkxCykd6,11,19,0,37,2,3,13,2,76,10.857142857142858,1,0.0,7,0,35,2,12,3,2,13,2,44,32,1
540,8759,9SPQ1jfplQbke9byQIAxTVMFCooGS54y,A3fsA9Zfv1X2fVEQhTw51lKENdNrEqT3,16,10,5,0,4,4,8,1,32,4.571428571428571,1,0.0,2,5,0,4,8,4,0,8,1,11,21,1
541,8761,7ye3FQXc4XBmC7UwnNQWxsWGDnaNcvG6,SpATywNh6bZuzm8s1ceuBUnMUAeoAHHw,5,5,0,0,0,0,2,0,7,1.0,1,0.0,0,0,0,0,5,0,0,2,0,0,7,1
542,8780,l7cIWSn2QdqLoOKMFO8yNQGKfk999nJh,A3fsA9Zfv1X2fVEQhTw51lKENdNrEqT3,5,7,3,0,0,0,2,0,12,1.7142857142857142,2,0.0,2,3,0,0,5,0,0,2,0,5,7,1
543,8791,E2VKNfvaS8HbcvRZooqcq8161JUOvad2,RXDvfPUBYFlVdlueBFbLW0mhhAyGEqpt,14,21,11,0,4,0,4,0,40,5.714285714285714,2,0.0,1,11,0,4,20,0,0,4,0,16,24,1
544,8793,Ga4lr67F0RIjyUetWH1EgQ3xzSHDnViF,bWdj2GDclj5ofokWjzoa5jAwMkxCykd6,18,21,11,60,7,3,8,1,111,15.857142857142858,2,0.0,7,11,58,7,14,3,2,8,1,83,28,0
545,8794,br8lmEhz6IHlXV0QfsU4Spi9BczfMT8x,SpATywNh6bZuzm8s1ceuBUnMUAeoAHHw,11,14,5,17,0,0,3,0,39,5.571428571428571,1,0.0,8,5,15,0,6,0,2,3,0,28,11,0
546,8809,ivdkzhYPhrTUKnU1xY68Yfp2rdDhgD3h,SpATywNh6bZuzm8s1ceuBUnMUAeoAHHw,17,49,19,16,10,31,37,3,165,23.571428571428573,3,0.0,17,19,15,10,32,31,1,37,3,61,104,0
547,8814,8IuzZOXaXVUql9pLZtNuJIyLoDJ8ZL4V,SpATywNh6bZuzm8s1ceuBUnMUAeoAHHw,2,0,0,0,0,1,2,0,3,0.42857142857142855,1,0.0,0,0,0,0,0,1,0,2,0,0,3,0
548,8815,Ga4lr67F0RIjyUetWH1EgQ3xzSHDnViF,A3fsA9Zfv1X2fVEQhTw51lKENdNrEqT3,1,0,0,0,0,0,1,0,1,0.14285714285714285,1,0.0,0,0,0,0,0,0,0,1,0,0,1,1
549,8852,1sf1a7OMEvwky5hvLFD12TaOsmoNw2Qb,SpATywNh6bZuzm8s1ceuBUnMUAeoAHHw,14,30,12,12,6,0,3,0,63,9.0,2,0.0,8,12,12,6,22,0,0,3,0,38,25,0
550,8904,0QFADiD6IvsCiGKcRzsLQbDvaZGh6BVG,SpATywNh6bZuzm8s1ceuBUnMUAeoAHHw,4,2,1,0,1,0,2,0,6,0.8571428571428571,1,0.0,0,1,0,1,2,0,0,2,0,2,4,0
551,8917,5vUuq5ZeDCNce4LmvH0naoUjpb3qbNOp,SpATywNh6bZuzm8s1ceuBUnMUAeoAHHw,18,15,8,14,3,8,13,1,62,8.857142857142858,5,0.0,3,8,11,3,12,8,3,13,1,25,37,1
552,8925,PenDUeO0eoR8hyLVdfPN6H7q2FnTGMus,A3fsA9Zfv1X2fVEQhTw51lKENdNrEqT3,8,4,2,0,0,23,11,1,41,5.857142857142857,2,0.0,0,2,0,0,4,23,0,11,1,2,39,0
553,8929,1oBn81XXDSWJtnCZIRPmhZcBWe7qP0iB,RXDvfPUBYFlVdlueBFbLW0mhhAyGEqpt,50,78,45,129,20,2,21,0,295,42.142857142857146,5,0.0,17,45,118,20,61,2,11,21,0,200,95,1
554,8934,H3CmwGihecRb7lZltIA7orKjensSqIgF,RXDvfPUBYFlVdlueBFbLW0mhhAyGEqpt,16,20,2,0,3,12,2,0,39,5.571428571428571,2,0.0,2,2,0,3,18,12,0,2,0,7,32,1
555,8935,pYasYOOyUapjKdoqnDhFpArs52eNDPLb,SpATywNh6bZuzm8s1ceuBUnMUAeoAHHw,15,23,14,18,5,1,9,0,70,10.0,4,0.0,3,14,15,5,20,1,3,9,0,37,33,0
556,8956,JtMmp5BCDQnYE7CMI3NvnX4aRCZsQW9K,bWdj2GDclj5ofokWjzoa5jAwMkxCykd6,12,19,7,0,3,9,44,2,84,12.0,7,0.0,0,7,0,3,19,9,0,44,2,10,74,0
557,8966,qFpdcx3mtZSSE0KVCMsIlMdOIeoOzyoo,SpATywNh6bZuzm8s1ceuBUnMUAeoAHHw,15,40,9,19,0,2,22,2,94,13.428571428571429,6,0.0,11,9,15,0,29,2,4,22,2,35,59,0
558,8971,p04QzukP32kpPk8EGoBhDUGJJQqJUoNz,SpATywNh6bZuzm8s1ceuBUnMUAeoAHHw,14,25,6,2,4,6,15,1,59,8.428571428571429,5,0.0,2,6,2,4,23,6,0,15,1,14,45,0
559,9011,sNZ43ghPU2QwNk3cu7wYztVZWvmkGmKL,SpATywNh6bZuzm8s1ceuBUnMUAeoAHHw,12,18,7,3,4,1,2,0,35,5.0,2,0.0,3,7,3,4,15,1,0,2,0,17,18,0
560,9015,3BQ5hO2xolpwYa13L4VN9VBwShRsjOB9,A3fsA9Zfv1X2fVEQhTw51lKENdNrEqT3,17,9,7,0,6,0,4,0,26,3.7142857142857144,1,0.0,0,7,0,6,9,0,0,4,0,13,13,1
561,9047,bssQsmzoNxPtkllVsM0XyYElvtsPU1iO,A3fsA9Zfv1X2fVEQhTw51lKENdNrEqT3,6,10,1,0,1,0,1,0,13,1.8571428571428572,1,0.0,0,1,0,1,10,0,0,1,0,2,11,1
562,9048,8IYoAw78mc8ysNlcBgXt630ETnnEuaUM,SpATywNh6bZuzm8s1ceuBUnMUAeoAHHw,9,9,1,5,1,0,4,0,20,2.857142857142857,2,0.0,0,1,5,1,9,0,0,4,0,7,13,0
563,9064,J782awhmjhWAohIOvWifbZTNvhSxGcmf,RXDvfPUBYFlVdlueBFbLW0mhhAyGEqpt,23,22,11,0,8,0,4,0,45,6.428571428571429,2,0.0,0,11,0,8,22,0,0,4,0,19,26,1
564,9065,6Dq4LTGgUzJAJPwYkedRMadSEQwnkyG3,SpATywNh6bZuzm8s1ceuBUnMUAeoAHHw,7,17,10,0,1,0,8,0,36,5.142857142857143,1,0.0,0,10,0,1,17,0,0,8,0,11,25,1
565,9072,xBNDEDD7fMER9fNR4W15k6QiKRrdBf4x,G8EPVSXsOYB5YQWZGiz1aVq5Pgr2GrQu,7,15,6,0,0,0,5,0,26,3.7142857142857144,2,0.0,0,6,0,0,15,0,0,5,0,6,20,1
566,9079,Cb1aR5BeXGrDewkPGGzseNCh6yBNhS9Z,G8EPVSXsOYB5YQWZGiz1aVq5Pgr2GrQu,18,22,8,20,5,0,5,0,60,8.571428571428571,2,0.0,7,8,13,5,15,0,7,5,0,33,27,1
567,9100,0K6JPqiivQzicxY4EV4nqMLCL3a08A97,bWdj2GDclj5ofokWjzoa5jAwMkxCykd6,11,17,5,10,7,0,11,0,50,7.142857142857143,3,0.0,6,5,10,7,11,0,0,11,0,28,22,0
568,9118,ZPIRNChg4KaoHQC5y65LKyeBd78COsQH,A3fsA9Zfv1X2fVEQhTw51lKENdNrEqT3,8,4,3,0,3,0,1,0,11,1.5714285714285714,1,0.0,0,3,0,3,4,0,0,1,0,6,5,1
569,9125,8NRsKZ3hMeinWXhN3qtntd7OTP25jyWY,bWdj2GDclj5ofokWjzoa5jAwMkxCykd6,1,0,0,0,0,0,1,0,1,0.14285714285714285,1,0.0,0,0,0,0,0,0,0,1,0,0,1,1
570,9129,x8EozFE9amTkjsgRipu221C7Pejcw9dl,RXDvfPUBYFlVdlueBFbLW0mhhAyGEqpt,29,58,23,18,13,39,31,2,184,26.285714285714285,4,0.0,0,23,17,13,58,39,1,31,2,53,131,1
571,9132,AkJ8njZZaMlqYX3miC2oUBlMGg9ZSm2E,SpATywNh6bZuzm8s1ceuBUnMUAeoAHHw,14,21,0,15,0,9,12,1,58,8.285714285714286,2,0.0,7,0,14,0,14,9,1,12,1,21,37,1
572,9137,rD3x5Ovuza1MLiqkvaHksaL42hepSLSa,A3fsA9Zfv1X2fVEQhTw51lKENdNrEqT3,24,39,19,0,11,5,10,0,84,12.0,4,0.0,3,19,0,11,36,5,0,10,0,33,51,1
573,9145,RFW46IpEEo40HQZmVwQOMd3VcTSwzvKz,SpATywNh6bZuzm8s1ceuBUnMUAeoAHHw,13,42,2,8,0,0,8,0,60,8.571428571428571,4,0.0,14,2,7,0,28,0,1,8,0,23,37,0
574,9165,fnvAURpBgndjkYxbDVVMCKsNQuRUMiGS,SpATywNh6bZuzm8s1ceuBUnMUAeoAHHw,13,22,11,0,4,6,11,2,56,8.0,4,0.0,0,11,0,4,22,6,0,11,2,15,41,0
575,9182,aqcsR8SNbfax2wKqSkYdDU8hi71eVqW9,A3fsA9Zfv1X2fVEQhTw51lKENdNrEqT3,7,10,2,0,1,0,4,0,17,2.4285714285714284,1,0.0,1,2,0,1,9,0,0,4,0,4,13,0
576,9214,cw1zp7V2E9LtJgGgHmRoYt6oelCovAzM,bWdj2GDclj5ofokWjzoa5jAwMkxCykd6,19,34,18,118,4,36,16,2,228,32.57142857142857,2,0.0,8,18,112,4,26,36,6,16,2,142,86,1
577,9221,DHqQemLc6gAFLZmIcghnnHYSJ9DiwwJJ,A3fsA9Zfv1X2fVEQhTw51lKENdNrEqT3,13,6,2,14,2,1,7,1,33,4.714285714285714,2,0.0,0,2,12,2,6,1,2,7,1,16,17,1
578,9225,bBiJ7ASlGThY8sK9BrJtoHZicOYFZngs,SpATywNh6bZuzm8s1ceuBUnMUAeoAHHw,8,13,0,4,0,0,3,0,20,2.857142857142857,3,0.0,0,0,3,0,13,0,1,3,0,3,17,1
579,9256,tfcOvcMIVTpughZ66Us0P1WhX9cxijTo,SpATywNh6bZuzm8s1ceuBUnMUAeoAHHw,17,37,20,10,9,6,11,1,94,13.428571428571429,3,0.0,13,20,9,9,24,6,1,11,1,51,43,1
580,9261,QC8X6HHWWr8l8BhOv6dcxn8F38OGn4O4,bWdj2GDclj5ofokWjzoa5jAwMkxCykd6,19,24,10,48,11,8,12,0,113,16.142857142857142,2,0.0,11,10,43,11,13,8,5,12,0,75,38,1
581,9263,cgHFcM0rIMOzMpGf6lXZssDwXCb8l7YM,SpATywNh6bZuzm8s1ceuBUnMUAeoAHHw,13,21,10,6,5,4,13,0,59,8.428571428571429,6,0.0,4,10,5,5,17,4,1,13,0,24,35,0
582,9266,9Gijx5H37DPofktlpBMoMZTbguUDFGMv,SpATywNh6bZuzm8s1ceuBUnMUAeoAHHw,17,30,15,8,4,14,12,1,84,12.0,6,0.0,5,15,7,4,25,14,1,12,1,31,53,0
583,9284,nmePotX0raTb5EFn0d2G6sYKXgcl2u96,SpATywNh6bZuzm8s1ceuBUnMUAeoAHHw,17,23,8,14,3,21,13,1,83,11.857142857142858,3,0.0,10,8,12,3,13,21,2,13,1,33,50,1
584,9300,V2BC6P9m08ZwtWifNk1sABHW864l2OQe,SpATywNh6bZuzm8s1ceuBUnMUAeoAHHw,15,15,5,13,3,0,3,1,40,5.714285714285714,1,0.0,8,5,12,3,7,0,1,3,1,28,12,0
585,9319,7KQcIrOp3KoypOTvziMED7rHtDH1CXtE,bWdj2GDclj5ofokWjzoa5jAwMkxCykd6,6,3,1,0,2,0,3,0,9,1.2857142857142858,1,0.0,2,1,0,2,1,0,0,3,0,5,4,1
586,9326,cw1zp7V2E9LtJgGgHmRoYt6oelCovAzM,A3fsA9Zfv1X2fVEQhTw51lKENdNrEqT3,42,55,33,66,12,13,35,2,216,30.857142857142858,2,0.0,9,33,52,12,46,13,14,35,2,106,110,0
587,9331,U5AVDljh153RMBqEeJz3uJoBcMeMiYU5,RXDvfPUBYFlVdlueBFbLW0mhhAyGEqpt,17,22,14,6,7,0,6,0,55,7.857142857142857,3,0.0,2,14,6,7,20,0,0,6,0,29,26,0
588,9337,6W9L2N1NV5yWuM4zWKiNN7jncCdBZXs0,SpATywNh6bZuzm8s1ceuBUnMUAeoAHHw,9,9,0,19,0,0,1,0,29,4.142857142857143,1,0.0,3,0,16,0,6,0,3,1,0,19,10,1
589,9359,aR6DmUHNNFHdBeCRliKxXxLUoIhOd6AH,SpATywNh6bZuzm8s1ceuBUnMUAeoAHHw,15,32,11,14,3,39,12,1,112,16.0,3,0.0,9,11,13,3,23,39,1,12,1,36,76,1
590,9361,8Eqf4bSicFmRziRU1kFgF89C5yGB8WDX,A3fsA9Zfv1X2fVEQhTw51lKENdNrEqT3,38,59,6,54,2,4,41,4,170,24.285714285714285,6,0.0,7,6,49,2,52,4,5,41,4,64,106,0
591,9368,gGSMkNgPdXpBQgdZzyjzifomyCxFSNyt,RXDvfPUBYFlVdlueBFbLW0mhhAyGEqpt,13,27,13,0,6,8,16,1,71,10.142857142857142,4,0.0,2,13,0,6,25,8,0,16,1,21,50,1
592,9388,67TNJl3Pfj4UvDY0EpzZyKupN8wfhq1l,SpATywNh6bZuzm8s1ceuBUnMUAeoAHHw,18,24,14,14,5,1,20,7,85,12.142857142857142,2,0.0,5,14,13,5,19,1,1,20,7,37,48,1
593,9412,ZoicU1K1NYxoyDJQjMEMlarFqaZkNBQL,SpATywNh6bZuzm8s1ceuBUnMUAeoAHHw,14,22,3,17,1,0,17,0,60,8.571428571428571,4,0.0,3,3,16,1,19,0,1,17,0,23,37,0
594,9421,mVo6pZlclrtmbfR2GbQ4wq8gZuK7O36S,SpATywNh6bZuzm8s1ceuBUnMUAeoAHHw,14,14,5,15,2,3,3,1,43,6.142857142857143,1,0.0,6,5,12,2,8,3,3,3,1,25,18,0
595,9443,mt466qDcj0vZCLdMYFtb42Vnaf84dHao,SpATywNh6bZuzm8s1ceuBUnMUAeoAHHw,19,40,26,12,7,3,27,2,117,16.714285714285715,4,0.0,5,26,9,7,35,3,3,27,2,47,70,1
596,9451,3tkFTpynSNaQLF6kINch4bQXEK1IrheG,SpATywNh6bZuzm8s1ceuBUnMUAeoAHHw,15,28,12,12,3,2,10,0,67,9.571428571428571,5,0.0,9,12,9,3,19,2,3,10,0,33,34,0
597,9461,L22HEShRU3FqNfdzTYdzEWxS4vfndGJu,SpATywNh6bZuzm8s1ceuBUnMUAeoAHHw,12,15,1,17,0,10,13,1,57,8.142857142857142,5,0.0,6,1,15,0,9,10,2,13,1,22,35,0
598,9496,lzjn3SIRVbYq5ZVBPCRXRd4xV1z1jylE,SpATywNh6bZuzm8s1ceuBUnMUAeoAHHw,17,38,25,19,8,13,18,0,121,17.285714285714285,4,0.0,6,25,15,8,32,13,4,18,0,54,67,0
599,9498,tNcQJSYfIwP0RRLCMvpsyr5j06z8N8iO,G8EPVSXsOYB5YQWZGiz1aVq5Pgr2GrQu,67,127,6,154,7,15,23,6,338,48.285714285714285,5,0.0,53,6,112,7,74,15,42,23,6,178,160,0
600,9513,onGGlsMh4Ah4OxYC5tqGXHHp3fKlLcL2,RXDvfPUBYFlVdlueBFbLW0mhhAyGEqpt,7,8,6,0,2,0,2,0,18,2.5714285714285716,2,0.0,0,6,0,2,8,0,0,2,0,8,10,1
601,9515,FK87Mh9LEgwj1VU4pstPcNLLVrRCTWuM,SpATywNh6bZuzm8s1ceuBUnMUAeoAHHw,17,32,12,15,8,14,7,1,89,12.714285714285714,2,0.0,17,12,15,8,15,14,0,7,1,52,37,0
602,9524,qLAmicSwiz2res8NbViiztvss1lFMGpj,SpATywNh6bZuzm8s1ceuBUnMUAeoAHHw,13,26,5,15,2,1,12,1,62,8.857142857142858,5,0.0,8,5,13,2,18,1,2,12,1,28,34,1
603,9531,KwyWbYzWCyNQryHYqWYU5PuARebCENlh,SpATywNh6bZuzm8s1ceuBUnMUAeoAHHw,14,15,8,3,4,0,7,0,37,5.285714285714286,2,0.0,3,8,3,4,12,0,0,7,0,18,19,0
604,9589,oJ9j9ejTgKixczg3tSE8Sg8DPI7YQpJq,A3fsA9Zfv1X2fVEQhTw51lKENdNrEqT3,16,9,6,0,4,1,5,1,26,3.7142857142857144,1,0.0,1,6,0,4,8,1,0,5,1,11,15,0
605,9597,op6fYsDSJ7UTrHBvFtSBIo32ykj3vZlc,SpATywNh6bZuzm8s1ceuBUnMUAeoAHHw,13,29,1,19,0,35,11,1,96,13.714285714285714,3,0.0,15,1,16,0,14,35,3,11,1,32,64,0
606,9601,op6fYsDSJ7UTrHBvFtSBIo32ykj3vZlc,A3fsA9Zfv1X2fVEQhTw51lKENdNrEqT3,4,2,2,0,0,0,4,0,8,1.1428571428571428,2,0.0,0,2,0,0,2,0,0,4,0,2,6,1
607,9602,op6fYsDSJ7UTrHBvFtSBIo32ykj3vZlc,bWdj2GDclj5ofokWjzoa5jAwMkxCykd6,2,0,0,0,0,0,3,0,3,0.42857142857142855,2,0.0,0,0,0,0,0,0,0,3,0,0,3,1
608,9626,foCA7ZrrJkil1q7yKxvukoHCZEz5fz8N,bWdj2GDclj5ofokWjzoa5jAwMkxCykd6,11,17,1,14,0,0,4,0,36,5.142857142857143,1,0.0,7,1,12,0,10,0,2,4,0,20,16,0
609,9647,bPCZpicN2hhnN8uELNOuVf328EONwoA2,SpATywNh6bZuzm8s1ceuBUnMUAeoAHHw,5,1,1,0,0,0,7,0,9,1.2857142857142858,1,0.0,0,1,0,0,1,0,0,7,0,1,8,1
610,9654,EH4LxHwYpFQLq5kesgWPY21JUpYpymba,A3fsA9Zfv1X2fVEQhTw51lKENdNrEqT3,1,0,0,0,0,0,1,0,1,0.14285714285714285,1,0.0,0,0,0,0,0,0,0,1,0,0,1,1
611,9662,tRu7kc3B7i0xOP4FswhcDsdZx5KznD0T,SpATywNh6bZuzm8s1ceuBUnMUAeoAHHw,8,23,9,0,5,0,4,0,41,5.857142857142857,2,0.0,0,9,0,5,23,0,0,4,0,14,27,0
612,9673,Bi4hHmeTLwTbUCScu9tC6ZZN7frLUhVP,bWdj2GDclj5ofokWjzoa5jAwMkxCykd6,18,18,11,26,6,0,8,0,69,9.857142857142858,2,0.0,3,11,26,6,15,0,0,8,0,46,23,0
613,9684,LdhLlSD36AR268yKf0v6JE8vG5XYPHSF,RXDvfPUBYFlVdlueBFbLW0mhhAyGEqpt,41,64,0,66,11,9,9,0,159,22.714285714285715,3,0.0,29,0,62,11,35,9,4,9,0,102,57,0
614,9707,5GS5OD1cmKWecEPymf3UVauvWYXb9WHE,SpATywNh6bZuzm8s1ceuBUnMUAeoAHHw,8,10,2,0,1,0,3,0,16,2.2857142857142856,1,0.0,3,2,0,1,7,0,0,3,0,6,10,0
615,9718,0dBn4alo7QBTd62VD5XO0yNMbQ5QN2OQ,A3fsA9Zfv1X2fVEQhTw51lKENdNrEqT3,35,47,13,64,5,0,4,0,133,19.0,2,0.0,2,13,61,5,45,0,3,4,0,81,52,0
616,9735,gL9bGH4cIhlV7ZeZxNKPKl7YRjV9LvBk,bWdj2GDclj5ofokWjzoa5jAwMkxCykd6,4,2,0,0,0,0,2,0,4,0.5714285714285714,1,0.0,0,0,0,0,2,0,0,2,0,0,4,1
617,9745,ITkxDxE80MnM3R1P6Tny4qeXU1QIqBHa,bWdj2GDclj5ofokWjzoa5jAwMkxCykd6,20,29,15,38,10,69,20,2,183,26.142857142857142,5,0.0,8,15,34,10,21,69,4,20,2,67,116,1
618,9754,UhHoLs8knx0jlEPi8SMFvlBmI0lPgR6y,SpATywNh6bZuzm8s1ceuBUnMUAeoAHHw,14,40,0,12,1,15,17,2,87,12.428571428571429,5,0.0,14,0,11,1,26,15,1,17,2,26,61,1
619,9770,Z719Tc3zuVfTrBRe6VKkZp0coC11gNCc,SpATywNh6bZuzm8s1ceuBUnMUAeoAHHw,9,18,10,0,7,0,1,0,36,5.142857142857143,3,0.0,0,10,0,7,18,0,0,1,0,17,19,1
620,9785,gm1mCfFqKN0eTkg2YXDowzQf6xnuANVZ,SpATywNh6bZuzm8s1ceuBUnMUAeoAHHw,12,23,1,0,1,2,6,0,33,4.714285714285714,1,0.0,9,1,0,1,14,2,0,6,0,11,22,1
621,9786,LcO86mxxL8cZOPJBDybTSOoI4LZ5qE2M,SpATywNh6bZuzm8s1ceuBUnMUAeoAHHw,9,18,11,0,7,0,3,0,39,5.571428571428571,3,0.0,0,11,0,7,18,0,0,3,0,18,21,0
622,9787,EYniy2nQGNpFME0mRi8PdZNA2QjnXIxY,RXDvfPUBYFlVdlueBFbLW0mhhAyGEqpt,41,64,1,122,3,3,19,3,215,30.714285714285715,3,0.0,16,1,113,3,48,3,9,19,3,133,82,0
623,9833,31jhVyZsYwM3i4SgxR1MFYrhxZjgzlJ8,SpATywNh6bZuzm8s1ceuBUnMUAeoAHHw,14,12,6,20,4,2,5,0,49,7.0,2,0.0,2,6,16,4,10,2,4,5,0,28,21,0
624,9834,SVcpJb6gXZcQDuOEWDQYFqv2P86R1Xaj,A3fsA9Zfv1X2fVEQhTw51lKENdNrEqT3,6,1,1,0,1,0,4,0,7,1.0,1,0.0,0,1,0,1,1,0,0,4,0,2,5,1
625,9835,a9OOTcAZgZGDa68djsRaJXsHoRuNVOvz,SpATywNh6bZuzm8s1ceuBUnMUAeoAHHw,17,100,51,17,8,41,32,3,252,36.0,5,0.0,10,51,14,8,90,41,3,32,3,83,169,1
626,9836,nknXXbQsC6Q6nMDyRKc0MDJZg6KtAXBE,SpATywNh6bZuzm8s1ceuBUnMUAeoAHHw,14,36,12,10,4,9,4,0,75,10.714285714285714,3,0.0,17,12,8,4,19,9,2,4,0,41,34,0
627,9842,MVF65xcT9c1o85EvDPizEzpYwxjeii1v,SpATywNh6bZuzm8s1ceuBUnMUAeoAHHw,16,29,3,19,1,7,12,1,72,10.285714285714286,1,0.0,6,3,16,1,23,7,3,12,1,26,46,1
628,9857,qDhyxHmDfIFLWQlPUBxWy3YNuv335dWU,SpATywNh6bZuzm8s1ceuBUnMUAeoAHHw,15,40,16,8,8,15,8,0,95,13.571428571428571,5,0.0,8,16,8,8,32,15,0,8,0,40,55,0
629,9866,0KmXUOal7sGDR9cJbaeaj8aaBpdVW5sk,bWdj2GDclj5ofokWjzoa5jAwMkxCykd6,6,4,2,0,1,0,5,0,12,1.7142857142857142,1,0.0,0,2,0,1,4,0,0,5,0,3,9,1
630,9867,Cv6IwnmHzYzI7Znom4eT6Rs7brgvVn5U,SpATywNh6bZuzm8s1ceuBUnMUAeoAHHw,6,6,1,0,1,0,2,0,10,1.4285714285714286,1,0.0,0,1,0,1,6,0,0,2,0,2,8,1
631,9874,mZIaM3Lmux7GERtSm258BKPOSUYFlwyy,SpATywNh6bZuzm8s1ceuBUnMUAeoAHHw,17,40,10,18,3,12,16,1,100,14.285714285714286,4,0.0,15,10,17,3,25,12,1,16,1,45,55,0
632,9878,iw5QtMAk2wyMi9Kh4hTv1WAFOj2rnxVj,SpATywNh6bZuzm8s1ceuBUnMUAeoAHHw,15,13,1,17,0,0,7,2,40,5.714285714285714,1,0.0,3,1,16,0,10,0,1,7,2,20,20,0
633,9896,47Lhswr4ZfAxhCMxQ5kAgIIaZKdQ7ZYE,SpATywNh6bZuzm8s1ceuBUnMUAeoAHHw,16,41,17,20,6,94,21,1,200,28.571428571428573,4,0.0,10,17,17,6,31,94,3,21,1,50,150,0
634,9903,wHRp5VFhSRE1ez0DDg63jhbDbNE6ujgu,bWdj2GDclj5ofokWjzoa5jAwMkxCykd6,1,0,0,0,0,0,1,0,1,0.14285714285714285,1,0.0,0,0,0,0,0,0,0,1,0,0,1,1
635,9910,FUkw8gvbqykqbH4tdSuG6VwP03f4pQvB,SpATywNh6bZuzm8s1ceuBUnMUAeoAHHw,17,29,12,7,4,1,12,0,65,9.285714285714286,5,0.0,11,12,7,4,18,1,0,12,0,34,31,0
636,9911,Jd5OP6GIsguRdsq9k3eSYNENmzhPbdGe,bWdj2GDclj5ofokWjzoa5jAwMkxCykd6,6,9,3,0,2,0,3,0,17,2.4285714285714284,2,0.0,2,3,0,2,7,0,0,3,0,7,10,1
637,9916,CJe4pjtrcC0FOMy3krEkccqFJZO0Cqq4,RXDvfPUBYFlVdlueBFbLW0mhhAyGEqpt,30,47,9,46,3,48,32,14,199,28.428571428571427,3,0.0,14,9,42,3,33,48,4,32,14,68,131,1
638,9919,YwojqO58bCgaotjJoOTtpKH2oiEFOZyB,SpATywNh6bZuzm8s1ceuBUnMUAeoAHHw,14,12,5,21,3,0,5,0,46,6.571428571428571,1,0.0,6,5,18,3,6,0,3,5,0,32,14,1
639,9921,Mv7oSGs75OaCjYLhHCNmqqrqaAjjO5gs,RXDvfPUBYFlVdlueBFbLW0mhhAyGEqpt,27,49,9,46,9,2,10,9,134,19.142857142857142,5,0.0,11,9,41,9,38,2,5,10,9,70,64,1
640,9926,TgheOgj9khTgshxaHKtqDHWb3smGHeUA,SpATywNh6bZuzm8s1ceuBUnMUAeoAHHw,13,10,1,3,0,1,8,1,24,3.4285714285714284,1,0.0,3,1,3,0,7,1,0,8,1,7,17,1
641,9937,lZ58Ty5L7QhiK80QjmlI7dd3eLrrNLr0,A3fsA9Zfv1X2fVEQhTw51lKENdNrEqT3,7,3,2,0,2,0,3,0,10,1.4285714285714286,1,0.0,0,2,0,2,3,0,0,3,0,4,6,1
642,9944,IUn6MADAjAYkGlJisA1WiDvCeNlJd5Xd,G8EPVSXsOYB5YQWZGiz1aVq5Pgr2GrQu,79,72,22,128,13,0,6,0,241,34.42857142857143,6,0.0,45,22,82,13,27,0,46,6,0,162,79,1
643,9965,XL8OObjZsaGHAKex6gNHyGuTbyi42iwz,SpATywNh6bZuzm8s1ceuBUnMUAeoAHHw,14,32,0,13,0,23,9,1,78,11.142857142857142,1,0.0,19,0,12,0,13,23,1,9,1,31,47,1
644,9973,pqAmXCZ0vs0c5YNrZSPIZNZIkmuJCMBN,RXDvfPUBYFlVdlueBFbLW0mhhAyGEqpt,48,29,20,129,10,7,9,1,205,29.285714285714285,2,0.0,7,20,118,10,22,7,11,9,1,155,50,0
645,9986,hM3OejyZim6cDpiFQsjtqNuKMzh1dYaY,SpATywNh6bZuzm8s1ceuBUnMUAeoAHHw,8,7,0,18,0,0,2,0,27,3.857142857142857,1,0.0,2,0,15,0,5,0,3,2,0,17,10,1
646,9989,GVRJN4wkoooaXJUVmwnX983A87KsrZPK,A3fsA9Zfv1X2fVEQhTw51lKENdNrEqT3,27,15,8,46,1,0,8,0,78,11.142857142857142,5,0.0,3,8,42,1,12,0,4,8,0,54,24,0
647,10001,vsk33lNJbFXN2L68Y5R9TSkfONwNMOQ8,SpATywNh6bZuzm8s1ceuBUnMUAeoAHHw,16,29,10,18,4,80,14,6,161,23.0,2,0.0,12,10,15,4,17,80,3,14,6,41,120,0
648,10012,vqSgORDp5PsEpveQVJoPh4dnJvR6AQkK,RXDvfPUBYFlVdlueBFbLW0mhhAyGEqpt,47,68,42,80,17,9,21,1,238,34.0,6,0.0,14,42,74,17,54,9,6,21,1,147,91,0
649,10013,NYNmhRIaW3AmhvVQt7ReXvH6yAc7z73U,RXDvfPUBYFlVdlueBFbLW0mhhAyGEqpt,7,22,11,0,0,87,26,3,149,21.285714285714285,4,0.0,0,11,0,0,22,87,0,26,3,11,138,1
650,10021,oX8Y4icCGan10HVW1mtOWEP3pxrvK1WZ,RXDvfPUBYFlVdlueBFbLW0mhhAyGEqpt,22,34,22,21,2,90,12,5,186,26.571428571428573,3,0.0,4,22,20,2,30,90,1,12,5,48,138,0
651,10042,RCWIrGGQZDVLNIofIMbc1GdSrqA961jg,RXDvfPUBYFlVdlueBFbLW0mhhAyGEqpt,16,28,17,0,3,141,63,4,256,36.57142857142857,4,0.0,2,17,0,3,26,141,0,63,4,22,234,1
652,10044,Wigd4PnyDnjfDcFOxsTBcEnXo7kl9GSg,bWdj2GDclj5ofokWjzoa5jAwMkxCykd6,18,80,21,74,7,22,25,0,229,32.714285714285715,4,0.0,13,21,69,7,67,22,5,25,0,110,119,1
653,10048,X8GmwqDtWUFSMSOGWtivlDRmblWXusTi,SpATywNh6bZuzm8s1ceuBUnMUAeoAHHw,13,13,9,7,3,12,7,0,51,7.285714285714286,3,0.0,2,9,7,3,11,12,0,7,0,21,30,0
654,10065,GV5J9MUmZdHez5d6vsAQtSAbOI4jKQlj,bWdj2GDclj5ofokWjzoa5jAwMkxCykd6,20,26,14,68,9,6,6,1,130,18.571428571428573,1,0.0,8,14,58,9,18,6,10,6,1,89,41,0
655,10067,IkfMHDVbFGQIQxWjHsEqTwjNnrBCaA7O,SpATywNh6bZuzm8s1ceuBUnMUAeoAHHw,17,54,26,15,10,36,19,1,161,23.0,4,0.0,16,26,14,10,38,36,1,19,1,66,95,0
656,10068,GV5J9MUmZdHez5d6vsAQtSAbOI4jKQlj,A3fsA9Zfv1X2fVEQhTw51lKENdNrEqT3,9,6,4,0,2,0,3,0,15,2.142857142857143,2,0.0,0,4,0,2,6,0,0,3,0,6,9,1
657,10069,EdSyqy374rFTTRmoH6AfOLgRNsPjxdOm,A3fsA9Zfv1X2fVEQhTw51lKENdNrEqT3,19,14,10,0,6,0,6,0,36,5.142857142857143,2,0.0,0,10,0,6,14,0,0,6,0,16,20,1
658,10070,FkxhG6zHFqigfK7M5JQhv4MT6lPE3kxN,RXDvfPUBYFlVdlueBFbLW0mhhAyGEqpt,44,77,48,88,26,3,9,4,255,36.42857142857143,5,0.0,15,48,83,26,62,3,5,9,4,172,83,0
659,10073,3VQVtsFphnOA3h1KWYRcAEMgfViLsPnF,A3fsA9Zfv1X2fVEQhTw51lKENdNrEqT3,8,10,1,0,1,0,4,0,16,2.2857142857142856,2,0.0,0,1,0,1,10,0,0,4,0,2,14,1
660,10075,EdSyqy374rFTTRmoH6AfOLgRNsPjxdOm,bWdj2GDclj5ofokWjzoa5jAwMkxCykd6,8,8,5,0,3,0,3,0,19,2.7142857142857144,2,0.0,1,5,0,3,7,0,0,3,0,9,10,1
661,10081,2LiXT3Fppj80YAOl6K8p0HtAK0LHy6KG,SpATywNh6bZuzm8s1ceuBUnMUAeoAHHw,2,0,0,0,0,0,2,0,2,0.2857142857142857,1,0.0,0,0,0,0,0,0,0,2,0,0,2,0
662,10114,D1iAkJgGLDV90w339eOp4Bqd5z6wvBY6,A3fsA9Zfv1X2fVEQhTw51lKENdNrEqT3,1,0,0,0,0,0,1,0,1,0.14285714285714285,1,0.0,0,0,0,0,0,0,0,1,0,0,1,1
663,10119,8IVnhzyRJrPiaCjSSJli9bG8p44dgy3T,SpATywNh6bZuzm8s1ceuBUnMUAeoAHHw,11,13,5,0,3,0,3,0,24,3.4285714285714284,1,0.0,0,5,0,3,13,0,0,3,0,8,16,1
664,10120,9Dm5yt1s5sm1v7MbrzCfMpw138AkercO,RXDvfPUBYFlVdlueBFbLW0mhhAyGEqpt,44,38,24,105,18,41,13,5,244,34.857142857142854,2,0.0,13,24,98,18,25,41,7,13,5,153,91,0
665,10122,NiXPZUmEILmWUPwXexYxtHvaIL7QdjCQ,RXDvfPUBYFlVdlueBFbLW0mhhAyGEqpt,49,56,33,62,20,62,16,13,262,37.42857142857143,4,0.0,12,33,58,20,44,62,4,16,13,123,139,0
666,10129,7rP408Gy6dVEeyQ5Me3hr5GFRnqOotmL,A3fsA9Zfv1X2fVEQhTw51lKENdNrEqT3,12,10,6,0,5,0,9,1,31,4.428571428571429,1,0.0,2,6,0,5,8,0,0,9,1,13,18,1
667,10130,u3iTsADy3VjWLwiWIPabdGKGPi8ZLAbJ,SpATywNh6bZuzm8s1ceuBUnMUAeoAHHw,7,6,1,0,1,0,3,0,11,1.5714285714285714,2,0.0,0,1,0,1,6,0,0,3,0,2,9,0
668,10161,n4cJEUTWqAxTpul10x8ZDTmIRIbytL0a,SpATywNh6bZuzm8s1ceuBUnMUAeoAHHw,17,26,8,18,3,4,9,1,69,9.857142857142858,3,0.0,12,8,17,3,14,4,1,9,1,40,29,1
669,10164,w7s7CbDlE2P2RGY2w8kEYH9keSavEsec,A3fsA9Zfv1X2fVEQhTw51lKENdNrEqT3,8,6,3,0,2,0,4,0,15,2.142857142857143,3,0.0,0,3,0,2,6,0,0,4,0,5,10,1
670,10165,PzZ2nmySEoPT9qSsl3Z3wqf8hhgEC7RR,bWdj2GDclj5ofokWjzoa5jAwMkxCykd6,6,2,1,0,1,0,4,1,9,1.2857142857142858,1,0.0,1,1,0,1,1,0,0,4,1,3,6,1
671,10190,h81tMgwEiasc4dN2MBVSIam9UKAPfs93,A3fsA9Zfv1X2fVEQhTw51lKENdNrEqT3,34,56,6,74,1,0,7,0,144,20.571428571428573,5,0.0,9,6,59,1,47,0,15,7,0,75,69,0
672,10193,T6JL6sNT8M40gVvb059fgHfBQIftQwIF,SpATywNh6bZuzm8s1ceuBUnMUAeoAHHw,14,54,22,18,0,3,24,0,121,17.285714285714285,6,0.0,22,22,15,0,32,3,3,24,0,59,62,1
673,10200,Sb9hMB1NLdfMmS0ToFmgrY6MZEZ6TYgo,SpATywNh6bZuzm8s1ceuBUnMUAeoAHHw,16,23,7,10,4,3,5,1,53,7.571428571428571,2,0.0,7,7,9,4,16,3,1,5,1,27,26,0
674,10202,BiB7jdHiaAHugRlYDLxmiYyQzifAAliU,SpATywNh6bZuzm8s1ceuBUnMUAeoAHHw,9,17,7,0,1,1,12,1,39,5.571428571428571,1,0.0,2,7,0,1,15,1,0,12,1,10,29,1
675,10204,nJbKKV1iJX5hAlKTzoiNMNIkB5aNJcfW,G8EPVSXsOYB5YQWZGiz1aVq5Pgr2GrQu,22,25,19,28,9,1,9,0,91,13.0,4,0.0,0,19,26,9,25,1,2,9,0,54,37,0
676,10207,Qf6P6bxCyzplkdXIQa3YsHmpzfUnMGYL,SpATywNh6bZuzm8s1ceuBUnMUAeoAHHw,18,35,16,11,9,2,14,3,90,12.857142857142858,3,0.0,10,16,11,9,25,2,0,14,3,46,44,0
677,10210,qVH2miiWM8Lf3bY2iypzRXLuMojA4gKB,SpATywNh6bZuzm8s1ceuBUnMUAeoAHHw,16,15,8,15,4,0,5,0,47,6.714285714285714,2,0.0,5,8,12,4,10,0,3,5,0,29,18,1
678,10212,IKkLcanOfBFv8w6vw2fYzBwzbCJQZq5m,SpATywNh6bZuzm8s1ceuBUnMUAeoAHHw,14,18,7,12,4,3,5,0,49,7.0,1,0.0,4,7,12,4,14,3,0,5,0,27,22,0
679,10227,SnivjdMp3HL6G23yPscSnzZlAD2Rbyt6,A3fsA9Zfv1X2fVEQhTw51lKENdNrEqT3,1,0,0,0,0,0,1,0,1,0.14285714285714285,1,0.0,0,0,0,0,0,0,0,1,0,0,1,0
680,10230,X9IfBkBBoI1jhyhTI5cK6hEB3eMT1rI2,SpATywNh6bZuzm8s1ceuBUnMUAeoAHHw,12,22,12,14,0,80,6,0,134,19.142857142857142,2,0.0,7,12,12,0,15,80,2,6,0,31,103,0
681,10232,zXzBBpTV9epJ0NK0fVVhqGAiB4MQXdB4,SpATywNh6bZuzm8s1ceuBUnMUAeoAHHw,16,23,12,10,5,10,14,0,74,10.571428571428571,4,0.0,5,12,10,5,18,10,0,14,0,32,42,0
682,10236,zMsdFc2bNoJ6urVmU6g31AhzZMFpCEEM,SpATywNh6bZuzm8s1ceuBUnMUAeoAHHw,8,7,0,0,0,0,4,0,11,1.5714285714285714,2,0.0,0,0,0,0,7,0,0,4,0,0,11,1
683,10244,5gwirWhcaVB1Z2yy4RRslODx7MsCrRca,SpATywNh6bZuzm8s1ceuBUnMUAeoAHHw,16,27,13,24,6,16,11,1,98,14.0,3,0.0,7,13,21,6,20,16,3,11,1,47,51,0
684,10263,Gy6MuuTSUxAvObvL74Ev0uen9bQJO61p,SpATywNh6bZuzm8s1ceuBUnMUAeoAHHw,7,4,2,0,2,1,6,3,18,2.5714285714285716,1,0.0,0,2,0,2,4,1,0,6,3,4,14,1
685,10271,1kFTVSLESXiimtERcEyClh5CUMgpZbSa,SpATywNh6bZuzm8s1ceuBUnMUAeoAHHw,12,19,4,15,1,4,6,2,51,7.285714285714286,1,0.0,11,4,15,1,8,4,0,6,2,31,20,0
686,10280,dtlGqEkxytgl4rvxvygVAnxqgcqdYicp,SpATywNh6bZuzm8s1ceuBUnMUAeoAHHw,15,28,5,7,4,6,8,0,58,8.285714285714286,2,0.0,2,5,7,4,26,6,0,8,0,18,40,0
687,10289,83H2FVc0DUlyPpMlZsbpGsFQRMFc6fan,SpATywNh6bZuzm8s1ceuBUnMUAeoAHHw,1,0,0,0,0,0,1,0,1,0.14285714285714285,1,0.0,0,0,0,0,0,0,0,1,0,0,1,0
688,10310,nTUP3gEuwVy2Io3TzQXGmuh9VvJxgHk3,bWdj2GDclj5ofokWjzoa5jAwMkxCykd6,16,32,17,90,4,27,3,0,173,24.714285714285715,2,0.0,3,17,86,4,29,27,4,3,0,110,63,1
689,10328,GSkYUOcl4XzYMWSWhE6gXRGQ9kqPeXsi,SpATywNh6bZuzm8s1ceuBUnMUAeoAHHw,15,24,10,16,4,1,7,0,62,8.857142857142858,3,0.0,10,10,15,4,14,1,1,7,0,39,23,0
690,10358,Nzrw7pk0OZ13UV7zfdLy7gEMwvTA7qqG,SpATywNh6bZuzm8s1ceuBUnMUAeoAHHw,18,61,19,17,6,56,28,6,193,27.571428571428573,5,0.0,32,19,16,6,29,56,1,28,6,73,120,0
691,10365,xg8dkQPzve0MzcpgxvEsbKyY4VwKrxAC,SpATywNh6bZuzm8s1ceuBUnMUAeoAHHw,6,8,1,0,0,0,3,0,12,1.7142857142857142,2,0.0,2,1,0,0,6,0,0,3,0,3,9,1
692,10380,ziZWaDkSdnYYFQL9rVa6Bhv9eL7a9wWX,SpATywNh6bZuzm8s1ceuBUnMUAeoAHHw,12,33,4,0,2,25,12,1,77,11.0,2,0.0,4,4,0,2,29,25,0,12,1,10,67,0
693,10382,wONMmUHIYwPBmEB9lgpOY3KCldKiuZFl,SpATywNh6bZuzm8s1ceuBUnMUAeoAHHw,12,21,12,0,11,4,10,1,59,8.428571428571429,3,0.0,6,12,0,11,15,4,0,10,1,29,30,0
694,10388,SaHrUfZXnTghdXjrd2g1gBsj8aUTXhNX,SpATywNh6bZuzm8s1ceuBUnMUAeoAHHw,18,31,6,11,4,12,14,1,79,11.285714285714286,4,0.0,15,6,10,4,16,12,1,14,1,35,44,0
695,10407,xLsstPG4sh6BOKWjwGwQnQICDDoIsKTd,SpATywNh6bZuzm8s1ceuBUnMUAeoAHHw,15,39,16,3,7,20,10,8,103,14.714285714285714,4,0.0,12,16,3,7,27,20,0,10,8,38,65,0
696,10416,9jZsAxMdQXvLjxKIorcfAyZ7kTyyk2m3,bWdj2GDclj5ofokWjzoa5jAwMkxCykd6,19,39,14,22,10,3,13,2,103,14.714285714285714,5,0.0,9,14,21,10,30,3,1,13,2,54,49,1
697,10422,Eu9HoDt3WhECHgcXaERosbI6lMj7Hipb,RXDvfPUBYFlVdlueBFbLW0mhhAyGEqpt,45,48,22,103,15,22,9,6,225,32.142857142857146,4,0.0,18,22,94,15,30,22,9,9,6,149,76,0
698,10423,0bGsOnbsTfgtcrUHSL9Ba6RYBtQEiaAR,SpATywNh6bZuzm8s1ceuBUnMUAeoAHHw,1,0,0,0,0,0,2,0,2,0.2857142857142857,1,0.0,0,0,0,0,0,0,0,2,0,0,2,1
699,10427,Daw06K1PSOXldo19kBgHP5sewulb7Vu5,SpATywNh6bZuzm8s1ceuBUnMUAeoAHHw,14,18,0,9,0,8,6,1,42,6.0,3,0.0,7,0,9,0,11,8,0,6,1,16,26,1
700,10441,KRLjLXKoKEagD4g49Zuzvz0geq7JPqfn,bWdj2GDclj5ofokWjzoa5jAwMkxCykd6,8,22,10,0,6,1,9,1,49,7.0,2,0.0,6,10,0,6,16,1,0,9,1,22,27,0
701,10462,PERCKVrZOUZ9ZmdU3J0Mwd1TZrMvK8yc,RXDvfPUBYFlVdlueBFbLW0mhhAyGEqpt,25,54,28,0,28,5,8,1,124,17.714285714285715,2,0.0,19,28,0,28,35,5,0,8,1,75,49,0
702,10481,4baDuWDcygh3I7gf3DfgmuPMN0Tyoi19,SpATywNh6bZuzm8s1ceuBUnMUAeoAHHw,14,17,1,17,0,3,15,3,56,8.0,2,0.0,6,1,14,0,11,3,3,15,3,21,35,0
703,10489,VC1Fuf9dV49znO9PkMawj1ZQqMcKHAjm,SpATywNh6bZuzm8s1ceuBUnMUAeoAHHw,17,37,5,14,2,26,18,1,103,14.714285714285714,6,0.0,13,5,13,2,24,26,1,18,1,33,70,0
704,10502,vx1j5ZdbVcqMnaq8fewmENptts2XnB9X,SpATywNh6bZuzm8s1ceuBUnMUAeoAHHw,8,4,0,0,0,5,6,1,16,2.2857142857142856,1,0.0,0,0,0,0,4,5,0,6,1,0,16,0
705,10518,rzGwtyhvOohTorRAFSpekt9j8KJVn1Nq,SpATywNh6bZuzm8s1ceuBUnMUAeoAHHw,8,13,8,0,4,1,4,0,30,4.285714285714286,2,0.0,0,8,0,4,13,1,0,4,0,12,18,0
706,10527,VYMfm0tgVS6x4Eosz9NPpRPYpCrgFsMy,A3fsA9Zfv1X2fVEQhTw51lKENdNrEqT3,41,28,17,94,12,2,7,0,160,22.857142857142858,2,0.0,5,17,79,12,23,2,15,7,0,113,47,0
707,10528,WubsiWqf9HrcjL91VrCtUc1j3k8esFc2,G8EPVSXsOYB5YQWZGiz1aVq5Pgr2GrQu,12,8,4,4,3,7,3,0,29,4.142857142857143,1,0.0,0,4,3,3,8,7,1,3,0,10,19,1
708,10535,TyLciGh9B6yO4eY9EZiNs3MwXyb1sWVv,SpATywNh6bZuzm8s1ceuBUnMUAeoAHHw,14,16,1,21,1,2,4,0,45,6.428571428571429,2,0.0,8,1,17,1,8,2,4,4,0,27,18,1
709,10540,Cwlc0kvvLoKXxEuXNQkjFRo818TDMpZS,SpATywNh6bZuzm8s1ceuBUnMUAeoAHHw,14,35,9,9,5,0,4,0,62,8.857142857142858,2,0.0,19,9,9,5,16,0,0,4,0,42,20,0
710,10555,QqE2Xjwy9gUzOvFdkDqAwAaNZLBZkxvd,bWdj2GDclj5ofokWjzoa5jAwMkxCykd6,9,9,1,0,0,3,7,0,20,2.857142857142857,1,0.0,0,1,0,0,9,3,0,7,0,1,19,0
711,10580,m1V3ygdnufe369wleiOQ11JelGyARbAF,SpATywNh6bZuzm8s1ceuBUnMUAeoAHHw,15,23,13,18,6,1,13,0,74,10.571428571428571,1,0.0,6,13,15,6,17,1,3,13,0,40,34,1
712,10591,wbbNGhodAmSlYSg7ZSWYtWMdb0rjLgRw,G8EPVSXsOYB5YQWZGiz1aVq5Pgr2GrQu,46,29,17,112,9,43,21,1,232,33.142857142857146,4,0.0,3,17,104,9,26,43,8,21,1,133,99,0
713,10602,v86tUMPiBVyN5RvZX1ZNepQ3NEMTABtY,A3fsA9Zfv1X2fVEQhTw51lKENdNrEqT3,20,21,20,0,20,0,1,0,62,8.857142857142858,1,0.0,0,20,0,20,21,0,0,1,0,40,22,1
714,10604,UKrQdzHwNJRJK7ZoTzKsoWlrkEbsQk7X,G8EPVSXsOYB5YQWZGiz1aVq5Pgr2GrQu,8,5,3,0,2,0,2,0,12,1.7142857142857142,1,0.0,0,3,0,2,5,0,0,2,0,5,7,1
715,10606,BOBLP6pTmRtpQ8LtVgJyutFMDL3q6xno,SpATywNh6bZuzm8s1ceuBUnMUAeoAHHw,13,11,5,6,3,0,2,0,27,3.857142857142857,1,0.0,5,5,6,3,6,0,0,2,0,19,8,0
716,10608,a3StgABPgimfVHzW1FR4usG9kIA0tZV5,SpATywNh6bZuzm8s1ceuBUnMUAeoAHHw,12,42,0,12,0,2,14,0,70,10.0,3,0.0,2,0,10,0,40,2,2,14,0,12,58,0
717,10609,VYMfm0tgVS6x4Eosz9NPpRPYpCrgFsMy,bWdj2GDclj5ofokWjzoa5jAwMkxCykd6,4,2,2,0,1,0,1,0,6,0.8571428571428571,1,0.0,0,2,0,1,2,0,0,1,0,3,3,1
718,10619,CGB0PTeWY2VA2Nk2INJOsdD7IvpzgObV,G8EPVSXsOYB5YQWZGiz1aVq5Pgr2GrQu,9,8,5,0,2,0,10,0,25,3.5714285714285716,2,0.0,0,5,0,2,8,0,0,10,0,7,18,1
719,10623,dzaUNwKZy91BtYj96fOhuSgIlp9lXQDU,SpATywNh6bZuzm8s1ceuBUnMUAeoAHHw,9,11,6,0,1,2,6,0,26,3.7142857142857144,3,0.0,2,6,0,1,9,2,0,6,0,9,17,0
720,10634,OUOJlObKrXM0JmEUq0o8KzZHzr8jy9dn,bWdj2GDclj5ofokWjzoa5jAwMkxCykd6,9,8,3,0,3,8,11,1,34,4.857142857142857,3,0.0,3,3,0,3,5,8,0,11,1,9,25,0
721,10637,uzPUKUi7vVAcTKZXvlLeqjC4erxz8WBI,bWdj2GDclj5ofokWjzoa5jAwMkxCykd6,9,8,6,0,5,0,4,0,23,3.2857142857142856,2,0.0,0,6,0,5,8,0,0,4,0,11,12,0
722,10642,OnuqqUI42ulcOdv07J5FWiuL2V3DVzCo,RXDvfPUBYFlVdlueBFbLW0mhhAyGEqpt,7,11,5,0,1,0,4,0,21,3.0,3,0.0,0,5,0,1,11,0,0,4,0,6,15,1
723,10647,JqgIGUKaljto8rJQxV18FonxG0JqVkY4,SpATywNh6bZuzm8s1ceuBUnMUAeoAHHw,11,14,1,0,1,0,4,0,20,2.857142857142857,1,0.0,0,1,0,1,14,0,0,4,0,2,18,1
724,10655,39GYbZ8lJRbKZppnA1dQGPRJvzLTR46Q,SpATywNh6bZuzm8s1ceuBUnMUAeoAHHw,12,26,11,0,4,10,11,1,63,9.0,4,0.0,0,11,0,4,26,10,0,11,1,15,48,0
725,10658,teqJGecOr4a6oVYU1O9bgvPkX5ZSKA8N,A3fsA9Zfv1X2fVEQhTw51lKENdNrEqT3,3,2,0,0,0,0,1,0,3,0.42857142857142855,1,0.0,0,0,0,0,2,0,0,1,0,0,3,1
726,10667,gvBW2L5p7TFF6lkwpHMNMz6nt7oEVYk1,SpATywNh6bZuzm8s1ceuBUnMUAeoAHHw,14,12,4,14,2,0,7,0,39,5.571428571428571,1,0.0,7,4,14,2,5,0,0,7,0,27,12,0
727,10670,vUBx8sjBPXrETcrwHSfZ0pSQFIH0HPOl,SpATywNh6bZuzm8s1ceuBUnMUAeoAHHw,1,0,0,0,0,0,1,0,1,0.14285714285714285,1,0.0,0,0,0,0,0,0,0,1,0,0,1,1
728,10671,xg8dkQPzve0MzcpgxvEsbKyY4VwKrxAC,A3fsA9Zfv1X2fVEQhTw51lKENdNrEqT3,15,22,1,0,0,0,5,0,28,4.0,2,0.0,1,1,0,0,21,0,0,5,0,2,26,1
729,10676,Bv9FSXvHlE6wLC4E4yrAKqe3BQhrrtfx,SpATywNh6bZuzm8s1ceuBUnMUAeoAHHw,13,28,1,12,2,1,7,0,51,7.285714285714286,3,0.0,9,1,9,2,19,1,3,7,0,21,30,0
730,10677,e3VhXxfZ0vOxuCz75HZxH5mLRjbeafOC,A3fsA9Zfv1X2fVEQhTw51lKENdNrEqT3,44,16,13,66,10,3,10,3,121,17.285714285714285,2,0.0,1,13,57,10,15,3,9,10,3,81,40,1
731,10692,rTYF0meww41Jaf1ZhSKn71dF6UobIHyn,SpATywNh6bZuzm8s1ceuBUnMUAeoAHHw,16,27,2,12,2,6,11,1,61,8.714285714285714,2,0.0,6,2,12,2,21,6,0,11,1,22,39,0
732,10693,ZAehH9zLr3mvrD0qfr21tfeJdYtTkUHf,SpATywNh6bZuzm8s1ceuBUnMUAeoAHHw,14,15,0,10,0,11,8,1,45,6.428571428571429,2,0.0,4,0,9,0,11,11,1,8,1,13,32,1
733,10700,jX1wtG8uym7vm2Ny85W79HCXnEeqhUm4,bWdj2GDclj5ofokWjzoa5jAwMkxCykd6,18,29,15,60,4,36,19,2,165,23.571428571428573,4,0.0,7,15,57,4,22,36,3,19,2,83,82,0
734,10701,01A7cnd3gvCIwCcMkE5K8qeHnbk9l92w,SpATywNh6bZuzm8s1ceuBUnMUAeoAHHw,6,4,0,0,0,0,2,0,6,0.8571428571428571,1,0.0,0,0,0,0,4,0,0,2,0,0,6,1
735,10712,IaSb2U7ef1Fkefm60uQQgWhKloK1Rfe8,SpATywNh6bZuzm8s1ceuBUnMUAeoAHHw,12,7,5,4,3,0,3,0,22,3.142857142857143,2,0.0,1,5,3,3,6,0,1,3,0,12,10,0
736,10730,mJZNVvZltlGUOWmItS7lca1ZZKMYLgfv,A3fsA9Zfv1X2fVEQhTw51lKENdNrEqT3,25,7,0,54,0,0,4,0,65,9.285714285714286,2,0.0,2,0,54,0,5,0,0,4,0,56,9,1
737,10743,98UEGByxiN7tned6NDQeKfQDq4HCSGvQ,SpATywNh6bZuzm8s1ceuBUnMUAeoAHHw,16,33,9,18,2,19,11,1,93,13.285714285714286,2,0.0,10,9,14,2,23,19,4,11,1,35,58,0
738,10746,FQskTqGJU9GeC9XfemJd5Qp19XhmSu0D,SpATywNh6bZuzm8s1ceuBUnMUAeoAHHw,9,14,4,0,2,1,6,0,27,3.857142857142857,2,0.0,2,4,0,2,12,1,0,6,0,8,19,1
739,10758,JjZeMsAmsZa7SQS0vTrtExRB1lmjwAQ2,SpATywNh6bZuzm8s1ceuBUnMUAeoAHHw,15,44,4,7,4,0,16,0,75,10.714285714285714,4,0.0,5,4,7,4,39,0,0,16,0,20,55,0
740,10761,Grmueh4kYgLYo2kInw23ZHrSQJbjli7D,SpATywNh6bZuzm8s1ceuBUnMUAeoAHHw,16,19,8,26,5,1,6,2,67,9.571428571428571,2,0.0,9,8,20,5,10,1,6,6,2,42,25,0
741,10763,tby14fMJpDIjTBkK50rauZ0P5DHnQphs,SpATywNh6bZuzm8s1ceuBUnMUAeoAHHw,17,40,13,12,4,2,10,5,86,12.285714285714286,3,0.0,10,13,12,4,30,2,0,10,5,39,47,1
742,10774,QmKLhFuFtodx97KXUUkaok1RXKwJOs6p,SpATywNh6bZuzm8s1ceuBUnMUAeoAHHw,15,30,12,24,6,6,6,0,84,12.0,3,0.0,15,12,20,6,15,6,4,6,0,53,31,0
743,10799,4wGoSTuzJXBCojeNmaxk9GbR1KaCV7ql,G8EPVSXsOYB5YQWZGiz1aVq5Pgr2GrQu,50,97,9,116,8,2,15,3,250,35.714285714285715,4,0.0,42,9,87,8,55,2,29,15,3,146,104,0
744,10802,7jkKKf5Pb7FrtJ3WnuF11G7ePioUPJm3,SpATywNh6bZuzm8s1ceuBUnMUAeoAHHw,15,26,10,18,5,6,5,0,70,10.0,2,0.0,13,10,17,5,13,6,1,5,0,45,25,0
745,10805,mJAgtJKHxy28GsPIeuAEUCIOXmHzCywF,SpATywNh6bZuzm8s1ceuBUnMUAeoAHHw,18,63,27,8,6,42,41,1,188,26.857142857142858,5,0.0,18,27,8,6,45,42,0,41,1,59,129,0
746,10815,2MQR5LCqimp6aDvlkve2ALXoA292MToK,A3fsA9Zfv1X2fVEQhTw51lKENdNrEqT3,3,3,0,0,0,0,3,0,6,0.8571428571428571,1,0.0,0,0,0,0,3,0,0,3,0,0,6,1
747,10821,NXEwBXbU6vvce77sujWgRB6LivhFJvRb,SpATywNh6bZuzm8s1ceuBUnMUAeoAHHw,4,3,2,0,2,0,2,0,9,1.2857142857142858,2,0.0,0,2,0,2,3,0,0,2,0,4,5,0
748,10824,lMRWvZAvduvP2Pz46WY1VVjM0sCfB7T7,A3fsA9Zfv1X2fVEQhTw51lKENdNrEqT3,14,8,7,0,7,0,1,0,23,3.2857142857142856,1,0.0,0,7,0,7,8,0,0,1,0,14,9,1
749,10850,O4Go02y0WzYwbHIZc8uk50WjYKUP2Q4Y,G8EPVSXsOYB5YQWZGiz1aVq5Pgr2GrQu,7,4,1,0,1,2,5,0,13,1.8571428571428572,1,0.0,1,1,0,1,3,2,0,5,0,3,10,1
750,10863,SE8wOQdHqwRS7ESACXcTxQAuYFlgu1Py,SpATywNh6bZuzm8s1ceuBUnMUAeoAHHw,11,15,12,5,0,1,13,0,46,6.571428571428571,1,0.0,0,12,4,0,15,1,1,13,0,16,30,1
751,10867,n6zGNJI1hLWYjlMIVXYesa3jTXjLwizj,SpATywNh6bZuzm8s1ceuBUnMUAeoAHHw,17,29,22,13,5,0,11,1,81,11.571428571428571,4,0.0,2,22,12,5,27,0,1,11,1,41,40,0
752,10868,d9cbpiPwBULo3iFfJzjTidseoxKi3AEA,SpATywNh6bZuzm8s1ceuBUnMUAeoAHHw,18,45,12,25,5,55,29,7,178,25.428571428571427,5,0.0,6,12,20,5,39,55,5,29,7,43,135,0
753,10873,YLA48gUHn1Dc2R5xXAOe8bpBqZ5RWVW4,A3fsA9Zfv1X2fVEQhTw51lKENdNrEqT3,7,5,3,0,1,0,3,0,12,1.7142857142857142,1,0.0,0,3,0,1,5,0,0,3,0,4,8,1
754,10881,31ZWCwEsmLt26QDeYIg9aUSXrbkhFpxl,SpATywNh6bZuzm8s1ceuBUnMUAeoAHHw,9,5,3,12,1,7,3,0,31,4.428571428571429,1,0.0,2,3,10,1,3,7,2,3,0,16,15,0
755,10889,QYLtTejmIZrOzfj0rdDVGzAjECmBavYx,A3fsA9Zfv1X2fVEQhTw51lKENdNrEqT3,22,12,9,0,7,4,10,1,43,6.142857142857143,3,0.0,0,9,0,7,12,4,0,10,1,16,27,1
756,10902,wGtQdpTL13GOtTQAxkeOO6rmRR5kG8Nt,G8EPVSXsOYB5YQWZGiz1aVq5Pgr2GrQu,7,2,0,0,0,0,7,1,10,1.4285714285714286,1,0.0,0,0,0,0,2,0,0,7,1,0,10,1
757,10903,896KUUFdpc0Ig8weMXOkWbw7cjXtmIVV,SpATywNh6bZuzm8s1ceuBUnMUAeoAHHw,7,5,2,0,1,0,2,0,10,1.4285714285714286,1,0.0,0,2,0,1,5,0,0,2,0,3,7,0
758,10907,90tR2Jy52lv1kJ6TwJ9Jqo5P6u0CqT0E,SpATywNh6bZuzm8s1ceuBUnMUAeoAHHw,13,16,7,15,5,0,4,0,47,6.714285714285714,2,0.0,5,7,13,5,11,0,2,4,0,30,17,0
759,10959,DgZ8el6keJUnUjxjYHQCrfhij2kpBixa,SpATywNh6bZuzm8s1ceuBUnMUAeoAHHw,6,5,1,0,1,0,5,0,12,1.7142857142857142,2,0.0,0,1,0,1,5,0,0,5,0,2,10,1
760,10961,1N6nOsYXnkatuA8YMolfRAv0tQpjn2uG,SpATywNh6bZuzm8s1ceuBUnMUAeoAHHw,16,24,11,19,6,5,6,0,71,10.142857142857142,3,0.0,8,11,16,6,16,5,3,6,0,41,30,0
761,10965,Vc1baHxuYCOF9wXqOziB65UR0NyB8LSm,bWdj2GDclj5ofokWjzoa5jAwMkxCykd6,6,6,0,34,0,6,2,0,48,6.857142857142857,1,0.0,1,0,33,0,5,6,1,2,0,34,14,1
762,10981,gFIubR5L7uAqsUwFMmCtpUtAJn2LXJti,SpATywNh6bZuzm8s1ceuBUnMUAeoAHHw,12,29,11,0,8,0,15,2,65,9.285714285714286,2,0.0,0,11,0,8,29,0,0,15,2,19,46,1
763,10992,EaV63ns250Za7MNTuadlc0JeYoVcm5bM,SpATywNh6bZuzm8s1ceuBUnMUAeoAHHw,14,24,1,12,1,4,7,0,49,7.0,2,0.0,9,1,9,1,15,4,3,7,0,20,29,0
764,11000,zyIWmJjaz36PnMZpAzR2HEZCUbJWe8iQ,bWdj2GDclj5ofokWjzoa5jAwMkxCykd6,10,7,4,4,2,1,11,1,30,4.285714285714286,3,0.0,1,4,4,2,6,1,0,11,1,11,19,1
765,11005,o6ABKk2KTrZIkABXncviG8GWvJhMxPWI,A3fsA9Zfv1X2fVEQhTw51lKENdNrEqT3,23,10,5,60,0,0,5,0,80,11.428571428571429,2,0.0,4,5,55,0,6,0,5,5,0,64,16,1
766,11007,o6ABKk2KTrZIkABXncviG8GWvJhMxPWI,bWdj2GDclj5ofokWjzoa5jAwMkxCykd6,3,2,1,0,0,0,2,0,5,0.7142857142857143,1,0.0,0,1,0,0,2,0,0,2,0,1,4,1
767,11018,bjG4XBkL5oSJA9TxyrmgPKXKYOTfiWVp,bWdj2GDclj5ofokWjzoa5jAwMkxCykd6,18,36,19,56,12,11,12,1,147,21.0,2,0.0,9,19,49,12,27,11,7,12,1,89,58,0
768,11035,oOFCpO143ty3GSSLZVLh2o69NMEyxWhF,A3fsA9Zfv1X2fVEQhTw51lKENdNrEqT3,3,0,0,0,0,0,2,1,3,0.42857142857142855,1,0.0,0,0,0,0,0,0,0,2,1,0,3,1
769,11039,uukZZIB0DkTcJFX9Kfm5gzAJiaQWt3jq,SpATywNh6bZuzm8s1ceuBUnMUAeoAHHw,18,26,12,12,4,12,19,2,87,12.428571428571429,4,0.0,8,12,10,4,18,12,2,19,2,34,53,1
770,11063,RlHRJAiYu3Nfz7DEuzJcJRZJq4vbOfQu,SpATywNh6bZuzm8s1ceuBUnMUAeoAHHw,8,5,3,0,2,0,4,0,14,2.0,1,0.0,0,3,0,2,5,0,0,4,0,5,9,0
771,11072,48y8P1mBttkP3u0gtvk3ydvAiO35KU2g,SpATywNh6bZuzm8s1ceuBUnMUAeoAHHw,13,18,9,15,4,0,2,0,48,6.857142857142857,2,0.0,7,9,15,4,11,0,0,2,0,35,13,0
772,11095,ALXyvdc776DMhlVyaaoPo6cQhevpwTYD,SpATywNh6bZuzm8s1ceuBUnMUAeoAHHw,15,37,5,16,0,2,18,1,79,11.285714285714286,6,0.0,20,5,13,0,17,2,3,18,1,38,41,0
773,11096,vogj6DdqvLTkNOGuPksobO32JsQUkuqr,SpATywNh6bZuzm8s1ceuBUnMUAeoAHHw,13,37,1,19,0,24,19,1,101,14.428571428571429,4,0.0,15,1,15,0,22,24,4,19,1,31,70,0
774,11098,R5MIWOdfQPF58rt5zIICrbN58FLsYSLK,SpATywNh6bZuzm8s1ceuBUnMUAeoAHHw,13,18,14,9,8,8,10,0,67,9.571428571428571,3,0.0,0,14,7,8,18,8,2,10,0,29,38,0
775,11099,EfuhWoaB1h47xaBVO37JU7S7sIj3K77V,SpATywNh6bZuzm8s1ceuBUnMUAeoAHHw,13,16,1,21,0,0,7,0,45,6.428571428571429,2,0.0,5,1,18,0,11,0,3,7,0,24,21,0
776,11100,qRCFXu9SKQXvPlpvjvNkgxm9VD5k2SNq,G8EPVSXsOYB5YQWZGiz1aVq5Pgr2GrQu,6,5,2,0,1,0,4,0,12,1.7142857142857142,1,0.0,0,2,0,1,5,0,0,4,0,3,9,1
777,11117,yBKClM5or0v37bBK9shMFXqtoOJsEOKi,SpATywNh6bZuzm8s1ceuBUnMUAeoAHHw,17,33,11,16,5,9,9,2,85,12.142857142857142,3,0.0,14,11,13,5,19,9,3,9,2,43,42,0
778,11118,8G3TIfWeYnotKEBloHzMAvSj0jab6YCE,SpATywNh6bZuzm8s1ceuBUnMUAeoAHHw,16,25,7,23,4,1,6,0,66,9.428571428571429,2,0.0,11,7,22,4,14,1,1,6,0,44,22,0
779,11133,CdI8eHwhOFOmT1gRfkQHwobJyLn2OtRJ,SpATywNh6bZuzm8s1ceuBUnMUAeoAHHw,7,5,2,0,0,0,7,0,14,2.0,2,0.0,0,2,0,0,5,0,0,7,0,2,12,1
780,11140,kQ63n93d5CTXewyEhcoySFeLgYStuYpO,SpATywNh6bZuzm8s1ceuBUnMUAeoAHHw,14,23,11,21,4,3,6,0,68,9.714285714285714,4,0.0,7,11,17,4,16,3,4,6,0,39,29,0
781,11145,UnV0HDk59T6cuzi8hS829ZOjCdT0CRoB,SpATywNh6bZuzm8s1ceuBUnMUAeoAHHw,14,30,9,13,5,6,3,0,66,9.428571428571429,2,0.0,14,9,12,5,16,6,1,3,0,40,26,0
782,11152,SuK945tkxadINDtal1yRSiV9QKse6fnl,G8EPVSXsOYB5YQWZGiz1aVq5Pgr2GrQu,63,129,44,98,38,25,10,0,344,49.142857142857146,6,0.0,67,44,58,38,62,25,40,10,0,207,137,0
783,11153,h8eBexpHr95TQpIPdJzX4ggtrj3rthKs,SpATywNh6bZuzm8s1ceuBUnMUAeoAHHw,13,21,11,14,6,7,2,0,61,8.714285714285714,1,0.0,8,11,13,6,13,7,1,2,0,38,23,0
784,11156,HIC4ktOJbqbNeF2uNjLeMCsJ9XcoLJFS,SpATywNh6bZuzm8s1ceuBUnMUAeoAHHw,6,7,5,0,5,0,1,0,18,2.5714285714285716,1,0.0,0,5,0,5,7,0,0,1,0,10,8,1
785,11196,0K6JPqiivQzicxY4EV4nqMLCL3a08A97,A3fsA9Zfv1X2fVEQhTw51lKENdNrEqT3,6,1,1,0,1,0,5,0,8,1.1428571428571428,2,0.0,0,1,0,1,1,0,0,5,0,2,6,1
786,11199,G5krO16D3cyvAnQXVywA0e0QfvmDKyJE,SpATywNh6bZuzm8s1ceuBUnMUAeoAHHw,11,29,12,0,6,2,15,1,65,9.285714285714286,3,0.0,1,12,0,6,28,2,0,15,1,19,46,1
787,11218,ESIDCh7JUpjIHOXvPcQBcrSs3Att83qK,SpATywNh6bZuzm8s1ceuBUnMUAeoAHHw,12,46,2,21,0,0,13,0,82,11.714285714285714,4,0.0,8,2,18,0,38,0,3,13,0,28,54,0
788,11231,FpAFHYP26eZqx6Z5sDhKdTJPTBgbDKt4,SpATywNh6bZuzm8s1ceuBUnMUAeoAHHw,17,67,21,27,5,104,38,3,265,37.857142857142854,5,0.0,31,21,21,5,36,104,6,38,3,78,187,0
789,11267,Zp4vK4oqe1AwFnnOJdy7Uz1AWwNAcdOt,SpATywNh6bZuzm8s1ceuBUnMUAeoAHHw,8,6,3,0,2,0,3,0,14,2.0,1,0.0,0,3,0,2,6,0,0,3,0,5,9,1
790,11277,fOGAjxxxpsDuk08vAdjWtxgrvUhA2ic8,SpATywNh6bZuzm8s1ceuBUnMUAeoAHHw,3,2,0,0,0,0,1,0,3,0.42857142857142855,1,0.0,0,0,0,0,2,0,0,1,0,0,3,1
791,11298,gnjZOoI8BeitDTrO8bhWhoFLWjid4LeA,A3fsA9Zfv1X2fVEQhTw51lKENdNrEqT3,8,11,9,0,0,0,1,0,21,3.0,1,0.0,0,9,0,0,11,0,0,1,0,9,12,1
792,11325,urVw10ZOKTw1O1zHFnsutUzT6EcZdTal,SpATywNh6bZuzm8s1ceuBUnMUAeoAHHw,13,19,4,12,1,0,8,1,45,6.428571428571429,4,0.0,4,4,10,1,15,0,2,8,1,19,26,0
793,11341,mJAgtJKHxy28GsPIeuAEUCIOXmHzCywF,bWdj2GDclj5ofokWjzoa5jAwMkxCykd6,17,47,27,18,16,8,21,0,137,19.571428571428573,4,0.0,8,27,17,16,39,8,1,21,0,68,69,0
794,11351,1YxknoiTrSwQgclDlSAh4oMYHRyARhLv,A3fsA9Zfv1X2fVEQhTw51lKENdNrEqT3,16,9,6,2,4,0,7,0,28,4.0,4,0.0,0,6,2,4,9,0,0,7,0,12,16,1
795,11369,7KNecsubFdywoFPLyTu2kgv5VbQekjao,SpATywNh6bZuzm8s1ceuBUnMUAeoAHHw,11,12,0,18,0,0,3,0,33,4.714285714285714,1,0.0,6,0,15,0,6,0,3,3,0,21,12,1
796,11387,8xe55v4hJPUrl0YZIl8G73vP4j2l4PsW,SpATywNh6bZuzm8s1ceuBUnMUAeoAHHw,13,8,2,12,2,0,3,0,27,3.857142857142857,1,0.0,2,2,9,2,6,0,3,3,0,15,12,0
797,11423,WeFVkkJO52wtRMBMdihRXPPKstU7E9sn,A3fsA9Zfv1X2fVEQhTw51lKENdNrEqT3,2,0,0,0,0,0,2,0,2,0.2857142857142857,1,0.0,0,0,0,0,0,0,0,2,0,0,2,1
798,11430,7KNecsubFdywoFPLyTu2kgv5VbQekjao,RXDvfPUBYFlVdlueBFbLW0mhhAyGEqpt,12,13,1,0,1,0,2,0,17,2.4285714285714284,2,0.0,0,1,0,1,13,0,0,2,0,2,15,1
799,11442,Sz8jNgPmKJ1IbqEEVQqTtQlVUDGarqh2,A3fsA9Zfv1X2fVEQhTw51lKENdNrEqT3,25,17,12,0,9,0,17,0,55,7.857142857142857,3,0.0,0,12,0,9,17,0,0,17,0,21,34,0
800,11448,tLAxgBhXx0zpE8fWNnwggaJx5LeHI2h1,RXDvfPUBYFlVdlueBFbLW0mhhAyGEqpt,30,28,13,51,6,2,11,2,113,16.142857142857142,1,0.0,4,13,50,6,24,2,1,11,2,73,40,1
801,11450,HnptwVrdWLkMWuHezQcYS6A0pyVov5BG,SpATywNh6bZuzm8s1ceuBUnMUAeoAHHw,16,30,13,28,5,0,7,1,84,12.0,2,0.0,12,13,21,5,18,0,7,7,1,51,33,0
802,11454,G5viWFw6vjc0kZ7aRbev4NG1fp3ajLxi,A3fsA9Zfv1X2fVEQhTw51lKENdNrEqT3,8,4,3,0,3,0,1,0,11,1.5714285714285714,1,0.0,0,3,0,3,4,0,0,1,0,6,5,1
803,11455,5ObfmFiTeuGjRWtYuJy4iGiMBZ3jgU0e,SpATywNh6bZuzm8s1ceuBUnMUAeoAHHw,8,10,7,0,5,0,2,0,24,3.4285714285714284,2,0.0,0,7,0,5,10,0,0,2,0,12,12,1
804,11456,CWDKRVVm01sfgssULmzIPwx9dbULLbqB,A3fsA9Zfv1X2fVEQhTw51lKENdNrEqT3,35,25,14,104,9,7,6,0,165,23.571428571428573,2,0.0,1,14,88,9,24,7,16,6,0,112,53,0
805,11461,cW0TF0QgesgeR4yvyFNeSG2Tsy7pGtpm,A3fsA9Zfv1X2fVEQhTw51lKENdNrEqT3,20,27,17,0,11,0,7,0,62,8.857142857142858,3,0.0,0,17,0,11,27,0,0,7,0,28,34,1
806,11472,mN4qYBgpy4Qxh2rSlBkY5ZDyLEZtAHu9,RXDvfPUBYFlVdlueBFbLW0mhhAyGEqpt,50,37,22,72,13,30,10,10,194,27.714285714285715,4,0.0,10,22,71,13,27,30,1,10,10,116,78,1
807,11483,fG7nauhHd6Hp0Y6uPPSQifF45RcZ5wiO,SpATywNh6bZuzm8s1ceuBUnMUAeoAHHw,10,12,1,17,0,1,1,0,32,4.571428571428571,1,0.0,3,1,14,0,9,1,3,1,0,18,14,1
808,11490,mDEirND7nLzt2vy8e34SZhdfEbglxCWs,SpATywNh6bZuzm8s1ceuBUnMUAeoAHHw,15,28,12,16,5,20,14,1,96,13.714285714285714,1,0.0,4,12,13,5,24,20,3,14,1,34,62,0
809,11494,nBVpguvJeCUz3AWDoX9CCNT2qyeZb33T,G8EPVSXsOYB5YQWZGiz1aVq5Pgr2GrQu,41,61,43,84,1,8,9,0,206,29.428571428571427,3,0.0,10,43,67,1,51,8,17,9,0,121,85,0
810,11497,tfkukKUMRkePYIfP864uQoXVHWicLcZ3,A3fsA9Zfv1X2fVEQhTw51lKENdNrEqT3,13,23,12,0,5,0,9,0,49,7.0,2,0.0,1,12,0,5,22,0,0,9,0,18,31,1
811,11511,zNxhmmLWnSaIABuhKypYetmsDg2VcOK8,SpATywNh6bZuzm8s1ceuBUnMUAeoAHHw,5,1,1,0,1,1,3,0,7,1.0,1,0.0,0,1,0,1,1,1,0,3,0,2,5,1
812,11516,aSlIMkfly6xTMJCGTWDQcnFZjajcWM6y,RXDvfPUBYFlVdlueBFbLW0mhhAyGEqpt,16,21,2,0,2,4,7,0,36,5.142857142857143,3,0.0,4,2,0,2,17,4,0,7,0,8,28,0
813,11541,vIBcYbs1BLdmaaP30fcE2FS7kB7v7QRn,A3fsA9Zfv1X2fVEQhTw51lKENdNrEqT3,6,7,3,0,1,0,3,0,14,2.0,1,0.0,0,3,0,1,7,0,0,3,0,4,10,1
814,11546,9PS6Icub6VXkyVUcoskrzajETE7Qoarh,SpATywNh6bZuzm8s1ceuBUnMUAeoAHHw,16,35,9,24,3,6,5,0,82,11.714285714285714,3,0.0,21,9,20,3,14,6,4,5,0,53,29,0
815,11556,pplAmbuLk2c8g7K4eYBlhKFfYSpZgbNo,SpATywNh6bZuzm8s1ceuBUnMUAeoAHHw,16,31,4,10,1,0,17,1,64,9.142857142857142,5,0.0,4,4,8,1,27,0,2,17,1,17,47,0
816,11557,mtYhUCuiqvMc7E9n6ZRYWej43jynHbMu,SpATywNh6bZuzm8s1ceuBUnMUAeoAHHw,9,12,7,3,5,0,2,0,29,4.142857142857143,1,0.0,1,7,3,5,11,0,0,2,0,16,13,1
817,11568,l1IK9ZY8MbRv8UoeCkxEH7P4W2dtATGX,SpATywNh6bZuzm8s1ceuBUnMUAeoAHHw,16,21,2,8,1,1,7,1,41,5.857142857142857,3,0.0,4,2,8,1,17,1,0,7,1,15,26,0
818,11574,ypwDBeQLkxtWilMLhemtoXkZG88PSCik,SpATywNh6bZuzm8s1ceuBUnMUAeoAHHw,11,27,12,0,0,1,13,1,54,7.714285714285714,1,0.0,2,12,0,0,25,1,0,13,1,14,40,0
819,11576,GKKNtfrAHKD2xUEQBz7HLN3kKO9SrWyD,SpATywNh6bZuzm8s1ceuBUnMUAeoAHHw,17,74,41,12,11,42,44,3,227,32.42857142857143,5,0.0,8,41,9,11,66,42,3,44,3,69,158,0
820,11586,GIK69AVoFAXQo5stVHHEqOqo5xlrkSOx,SpATywNh6bZuzm8s1ceuBUnMUAeoAHHw,13,23,1,5,1,28,45,7,110,15.714285714285714,7,0.0,5,1,5,1,18,28,0,45,7,12,98,0
821,11591,nlq4r6xc3rTUqTwcYhL6wudXdN6RIE52,A3fsA9Zfv1X2fVEQhTw51lKENdNrEqT3,22,18,13,0,8,0,6,0,45,6.428571428571429,1,0.0,0,13,0,8,18,0,0,6,0,21,24,0
822,11593,wmwDf7eIRrKPL0l8cNmMygnEPd5vzoqs,SpATywNh6bZuzm8s1ceuBUnMUAeoAHHw,10,12,6,0,3,0,4,1,26,3.7142857142857144,1,0.0,3,6,0,3,9,0,0,4,1,12,14,0
823,11599,GD5KzWMBHDnHVJHzVFtf3u7bIC7XYtJH,SpATywNh6bZuzm8s1ceuBUnMUAeoAHHw,13,35,1,22,1,2,27,0,88,12.571428571428571,5,0.0,4,1,17,1,31,2,5,27,0,23,65,0
824,11600,IroEtJPlvjKfczRi5laeb2DQegyNKOWM,SpATywNh6bZuzm8s1ceuBUnMUAeoAHHw,7,3,2,0,2,1,3,0,11,1.5714285714285714,1,0.0,0,2,0,2,3,1,0,3,0,4,7,0
825,11603,wrdkNhe8GmpsjdZUr22H6zTi43mdouZW,SpATywNh6bZuzm8s1ceuBUnMUAeoAHHw,2,0,0,0,0,0,2,0,2,0.2857142857142857,1,0.0,0,0,0,0,0,0,0,2,0,0,2,1
826,11628,BHczT02DEALJmy7zbrGU6QbzLcOGM0Lz,SpATywNh6bZuzm8s1ceuBUnMUAeoAHHw,15,19,1,10,1,5,6,1,43,6.142857142857143,1,0.0,9,1,10,1,10,5,0,6,1,21,22,0
827,11650,ilWzYGLWBh9DSc1MV8g2C4Go5wDNgUHX,SpATywNh6bZuzm8s1ceuBUnMUAeoAHHw,13,10,6,6,3,6,4,0,35,5.0,2,0.0,2,6,6,3,8,6,0,4,0,17,18,0
828,11651,tnLfm9tutF6YoqDXNIONCmii1aynBy80,G8EPVSXsOYB5YQWZGiz1aVq5Pgr2GrQu,55,94,38,126,17,57,39,1,372,53.142857142857146,5,0.0,19,38,104,17,75,57,22,39,1,178,194,0
829,11699,fJdUKH8czX92V7yfMeG7e087z1xbQDMc,SpATywNh6bZuzm8s1ceuBUnMUAeoAHHw,13,11,5,8,4,1,1,0,30,4.285714285714286,1,0.0,5,5,8,4,6,1,0,1,0,22,8,0
830,11704,DVIil2NM7ZWOtqe6rhlMzwEUAb2wuaeh,SpATywNh6bZuzm8s1ceuBUnMUAeoAHHw,17,35,19,6,5,8,10,1,84,12.0,4,0.0,10,19,6,5,25,8,0,10,1,40,44,1
831,11719,cr12tMBqYKzLJbEmIsyFvFLKAg0DiCbM,SpATywNh6bZuzm8s1ceuBUnMUAeoAHHw,14,26,9,6,4,0,4,0,49,7.0,3,0.0,7,9,6,4,19,0,0,4,0,26,23,0
832,11732,6L205IIarnrBFjrCXSXMQhtSJJ5O5hiQ,SpATywNh6bZuzm8s1ceuBUnMUAeoAHHw,15,41,18,0,5,3,18,10,95,13.571428571428571,1,0.0,14,18,0,5,27,3,0,18,10,37,58,0
833,11737,vn3szbx80pQPfVJU7Et6YnUzTgKJ2evQ,A3fsA9Zfv1X2fVEQhTw51lKENdNrEqT3,7,3,1,0,1,0,5,0,10,1.4285714285714286,1,0.0,0,1,0,1,3,0,0,5,0,2,8,1
834,11773,gxkoHTlKe7FVuciB5TU7TNQLS1IuXLYY,SpATywNh6bZuzm8s1ceuBUnMUAeoAHHw,15,33,2,18,2,8,6,1,70,10.0,3,0.0,12,2,15,2,21,8,3,6,1,31,39,1
835,11782,twnWF0mfZYHjmoqBvUs9g7jWpDxNR6WV,SpATywNh6bZuzm8s1ceuBUnMUAeoAHHw,17,31,9,16,3,0,5,0,64,9.142857142857142,1,0.0,19,9,14,3,12,0,2,5,0,45,19,1
836,11797,ejIJpZTu0P4rcWcZmBKl6OiURGceVpiA,SpATywNh6bZuzm8s1ceuBUnMUAeoAHHw,6,7,4,0,0,0,2,0,13,1.8571428571428572,1,0.0,2,4,0,0,5,0,0,2,0,6,7,0
837,11803,jpgFrFPODuxdIxVKUbbelvbFMPtUp7jo,SpATywNh6bZuzm8s1ceuBUnMUAeoAHHw,14,19,7,13,4,4,3,0,50,7.142857142857143,1,0.0,11,7,11,4,8,4,2,3,0,33,17,0
838,11822,neCsLgPwvO3NM22QUF7ePoDh9jooDB1R,G8EPVSXsOYB5YQWZGiz1aVq5Pgr2GrQu,11,11,1,8,1,5,11,1,38,5.428571428571429,2,0.0,3,1,7,1,8,5,1,11,1,12,26,0
839,11873,CLsYy7g1hYWHJyj1aROfKK9oTeo5yxJx,SpATywNh6bZuzm8s1ceuBUnMUAeoAHHw,11,11,6,2,4,0,2,0,25,3.5714285714285716,2,0.0,2,6,2,4,9,0,0,2,0,14,11,0
840,11885,5Yc9dIv7921c7z5p5LW8t3x8iddn1yRC,SpATywNh6bZuzm8s1ceuBUnMUAeoAHHw,16,25,10,17,4,5,7,1,69,9.857142857142858,1,0.0,12,10,16,4,13,5,1,7,1,42,27,1
841,11891,BeyfLbwb8pdDQU6WTI5ee3FkxRPRP7B2,A3fsA9Zfv1X2fVEQhTw51lKENdNrEqT3,6,4,2,0,1,0,1,0,8,1.1428571428571428,1,0.0,0,2,0,1,4,0,0,1,0,3,5,1
842,11909,Hh6CQ9eQF89j5a5Oi2NUf2uAs2DZd4QT,A3fsA9Zfv1X2fVEQhTw51lKENdNrEqT3,24,50,36,0,14,67,24,3,194,27.714285714285715,6,0.0,0,36,0,14,50,67,0,24,3,50,144,1
843,11912,5FSqkpRO54sosmyXXDdXixBIUlxd8QNQ,SpATywNh6bZuzm8s1ceuBUnMUAeoAHHw,11,8,4,20,2,1,5,1,41,5.857142857142857,1,0.0,3,4,16,2,5,1,4,5,1,25,16,0
844,11928,syrttArug8Mpzs9L0IHsvBtATawYF9J2,A3fsA9Zfv1X2fVEQhTw51lKENdNrEqT3,2,0,0,0,0,0,2,0,2,0.2857142857142857,1,0.0,0,0,0,0,0,0,0,2,0,0,2,0
845,11933,OmF4aFe06TkjIpsTgGpQ4vBzMWi2jjQV,bWdj2GDclj5ofokWjzoa5jAwMkxCykd6,19,22,10,50,8,0,13,1,104,14.857142857142858,3,0.0,6,10,43,8,16,0,7,13,1,67,37,0
846,11955,oyFfPK6y9oPPwQR5mbsXW98FJaEnU88b,SpATywNh6bZuzm8s1ceuBUnMUAeoAHHw,14,21,7,16,5,2,2,0,53,7.571428571428571,1,0.0,10,7,15,5,11,2,1,2,0,37,16,1
847,11958,HG2MGN3erjLUr4zPCv4UJukzIqIJPVZ2,SpATywNh6bZuzm8s1ceuBUnMUAeoAHHw,17,19,11,19,4,42,10,1,106,15.142857142857142,2,0.0,4,11,16,4,15,42,3,10,1,35,71,1
848,11969,RhMByUF03fgdIuaHANL6m20mbMakGgJs,SpATywNh6bZuzm8s1ceuBUnMUAeoAHHw,10,24,12,0,7,0,5,0,48,6.857142857142857,3,0.0,0,12,0,7,24,0,0,5,0,19,29,0
849,11975,MAjx1xtQvL5ZiofHx4xuO3WtfmkLHjqM,SpATywNh6bZuzm8s1ceuBUnMUAeoAHHw,4,2,1,0,1,0,1,0,5,0.7142857142857143,1,0.0,0,1,0,1,2,0,0,1,0,2,3,1
850,11981,FZjjoikxEifQwEx2vf6LYlhg4yyTwbym,A3fsA9Zfv1X2fVEQhTw51lKENdNrEqT3,10,12,6,0,3,1,6,0,28,4.0,3,0.0,0,6,0,3,12,1,0,6,0,9,19,1
851,11982,BA5BMBRmhCtFQyjTLAMMLlVS5ABrW2hi,SpATywNh6bZuzm8s1ceuBUnMUAeoAHHw,4,2,1,0,1,0,1,0,5,0.7142857142857143,1,0.0,0,1,0,1,2,0,0,1,0,2,3,0
852,11998,NHPpKvbnrSpxM8e1DORBWJbRCpmrxZw8,SpATywNh6bZuzm8s1ceuBUnMUAeoAHHw,16,23,10,12,5,4,7,0,61,8.714285714285714,1,0.0,8,10,9,5,15,4,3,7,0,32,29,0
853,12000,tncBhgwJEnaybUdK2e3UQ2PdOl85hyHm,SpATywNh6bZuzm8s1ceuBUnMUAeoAHHw,15,23,9,19,5,7,6,2,71,10.142857142857142,1,0.0,10,9,16,5,13,7,3,6,2,40,31,0
854,12016,matrDCCbXVpxlcX50EwFfEaLRW1d7v0q,SpATywNh6bZuzm8s1ceuBUnMUAeoAHHw,7,9,0,0,0,1,4,0,14,2.0,1,0.0,0,0,0,0,9,1,0,4,0,0,14,1
855,12019,UaSh8dwx8gnofYbXlmpqj9uYDbpJ89pX,bWdj2GDclj5ofokWjzoa5jAwMkxCykd6,9,18,3,0,1,7,18,0,47,6.714285714285714,5,0.0,0,3,0,1,18,7,0,18,0,4,43,0
856,12028,TnWxqbrMUttPbRmFwVduGXC6tM50wXNs,G8EPVSXsOYB5YQWZGiz1aVq5Pgr2GrQu,5,2,1,0,1,0,2,0,6,0.8571428571428571,1,0.0,0,1,0,1,2,0,0,2,0,2,4,1
857,12052,g3902agYIRHzac78MKVZlvljLMXXNpQ7,SpATywNh6bZuzm8s1ceuBUnMUAeoAHHw,17,33,18,19,6,0,13,0,89,12.714285714285714,4,0.0,7,18,15,6,26,0,4,13,0,46,43,0
858,12097,LclkEDGY7WCR76zraNkzkcQywMJivp2l,SpATywNh6bZuzm8s1ceuBUnMUAeoAHHw,9,8,2,0,1,0,5,1,17,2.4285714285714284,1,0.0,1,2,0,1,7,0,0,5,1,4,13,1
859,12119,x0VzAeYdlywtGLqE1HF68qQMYZTLfsw9,A3fsA9Zfv1X2fVEQhTw51lKENdNrEqT3,16,25,20,0,6,0,4,0,55,7.857142857142857,3,0.0,0,20,0,6,25,0,0,4,0,26,29,1
860,12126,32uJBAomTJQIXKZnCX4K7PYoVfESGbct,RXDvfPUBYFlVdlueBFbLW0mhhAyGEqpt,20,36,23,26,18,0,6,0,109,15.571428571428571,4,0.0,8,23,26,18,28,0,0,6,0,75,34,1
861,12171,eAArxLyCThtu9N3Mv8rQculKbGSa66j9,SpATywNh6bZuzm8s1ceuBUnMUAeoAHHw,10,9,6,0,2,9,10,0,36,5.142857142857143,5,0.0,0,6,0,2,9,9,0,10,0,8,28,1
862,12197,RPansaKc9yPYyKahcqLAJO6a0GoBHglr,SpATywNh6bZuzm8s1ceuBUnMUAeoAHHw,18,38,18,8,9,5,17,1,96,13.714285714285714,6,0.0,9,18,7,9,29,5,1,17,1,43,53,0
863,12220,9b4Qm8eSvDuZev1N90TcJBdVRXi0Jx1k,SpATywNh6bZuzm8s1ceuBUnMUAeoAHHw,13,13,0,21,0,5,7,1,47,6.714285714285714,1,0.0,8,0,18,0,5,5,3,7,1,26,21,1
864,12270,mccn7oMsSoLGVTk06xkhM1ICp7gdLXuk,SpATywNh6bZuzm8s1ceuBUnMUAeoAHHw,18,31,14,19,5,2,12,1,84,12.0,3,0.0,12,14,16,5,19,2,3,12,1,47,37,1
865,12289,j3c6K94i9dgmcXc2NErAuVxnWFJZj8tT,bWdj2GDclj5ofokWjzoa5jAwMkxCykd6,1,0,0,0,0,0,1,0,1,0.14285714285714285,1,0.0,0,0,0,0,0,0,0,1,0,0,1,1
866,12308,CQOn4KWCA0duDCOSP1DQzvXZ3yAfq1zW,SpATywNh6bZuzm8s1ceuBUnMUAeoAHHw,17,29,17,27,5,8,21,1,108,15.428571428571429,3,0.0,6,17,21,5,23,8,6,21,1,49,59,0
867,12317,niLMw8MCObO7SSR2V1jNg9WQt5oSjDFJ,A3fsA9Zfv1X2fVEQhTw51lKENdNrEqT3,10,8,4,0,3,0,3,0,18,2.5714285714285716,2,0.0,0,4,0,3,8,0,0,3,0,7,11,1
868,12320,niLMw8MCObO7SSR2V1jNg9WQt5oSjDFJ,SpATywNh6bZuzm8s1ceuBUnMUAeoAHHw,9,10,5,0,3,0,5,0,23,3.2857142857142856,2,0.0,2,5,0,3,8,0,0,5,0,10,13,1
869,12321,g3902agYIRHzac78MKVZlvljLMXXNpQ7,A3fsA9Zfv1X2fVEQhTw51lKENdNrEqT3,24,14,11,0,8,1,13,1,48,6.857142857142857,3,0.0,0,11,0,8,14,1,0,13,1,19,29,1
870,12323,dceX0m9075YvlWaEabJwd03DyXl3MtL8,SpATywNh6bZuzm8s1ceuBUnMUAeoAHHw,16,31,9,14,3,1,9,3,70,10.0,2,0.0,14,9,11,3,17,1,3,9,3,37,33,0
871,12348,ZhTCqX8GMUcn0a0betuEauHNuCk1aRhm,A3fsA9Zfv1X2fVEQhTw51lKENdNrEqT3,37,42,20,48,7,45,13,0,175,25.0,3,0.0,4,20,43,7,38,45,5,13,0,74,101,0
872,12351,f5nUM7X4snZl1Dwk9DyOLQ7PstRe3yG1,SpATywNh6bZuzm8s1ceuBUnMUAeoAHHw,15,9,6,21,4,0,10,0,50,7.142857142857143,2,0.0,2,6,17,4,7,0,4,10,0,29,21,1
873,12371,Dx1ZzKpwFtwNhE9gdaLaohssqGyqrqjD,SpATywNh6bZuzm8s1ceuBUnMUAeoAHHw,17,37,16,12,6,48,12,1,132,18.857142857142858,4,0.0,16,16,9,6,21,48,3,12,1,47,85,0
874,12384,bKVslXuzEQ1pv4c6iV5mVjs6X6avUbmL,RXDvfPUBYFlVdlueBFbLW0mhhAyGEqpt,48,255,114,59,21,314,227,82,1072,153.14285714285714,7,0.0,12,114,52,21,243,314,7,227,82,199,873,0
875,12402,3z0hX7DEeFfsgBAb2GCqLtG7EloWzN4g,bWdj2GDclj5ofokWjzoa5jAwMkxCykd6,3,2,0,0,0,0,1,0,3,0.42857142857142855,1,0.0,0,0,0,0,2,0,0,1,0,0,3,1
876,12409,Io5gLr8QOxaBw8nFReloAXOpt3IlZ5WE,SpATywNh6bZuzm8s1ceuBUnMUAeoAHHw,6,4,1,0,0,0,5,0,10,1.4285714285714286,2,0.0,0,1,0,0,4,0,0,5,0,1,9,0
877,12431,dOkXreE5Co54rqG7YecVg356rhQtEiRH,SpATywNh6bZuzm8s1ceuBUnMUAeoAHHw,13,13,0,21,0,1,6,0,41,5.857142857142857,2,0.0,7,0,17,0,6,1,4,6,0,24,17,1
878,12488,UkVp32qxLqsEWmDdG99xhNvtg1mVGbkd,SpATywNh6bZuzm8s1ceuBUnMUAeoAHHw,12,22,6,20,2,5,3,0,58,8.285714285714286,1,0.0,12,6,16,2,10,5,4,3,0,36,22,1
879,12536,XKtSJUu70kLs3jRiKFAR2MlWI70CZUcv,G8EPVSXsOYB5YQWZGiz1aVq5Pgr2GrQu,17,35,2,2,4,3,13,2,61,8.714285714285714,2,0.0,8,2,1,4,27,3,1,13,2,15,46,0
880,12540,nlq4r6xc3rTUqTwcYhL6wudXdN6RIE52,bWdj2GDclj5ofokWjzoa5jAwMkxCykd6,2,0,0,0,0,6,4,0,10,1.4285714285714286,2,0.0,0,0,0,0,0,6,0,4,0,0,10,1
881,12546,LRHDYNgQAsG2UssS8TgaqkiYDbFlVrrj,A3fsA9Zfv1X2fVEQhTw51lKENdNrEqT3,18,28,18,0,5,2,14,1,68,9.714285714285714,3,0.0,1,18,0,5,27,2,0,14,1,24,44,1
882,12557,Vx74c4EnHqTcmxhMcO6kRvadcvYQC7Hl,SpATywNh6bZuzm8s1ceuBUnMUAeoAHHw,15,38,19,11,4,1,15,0,88,12.571428571428571,5,0.0,6,19,10,4,32,1,1,15,0,39,49,0
883,12564,D59LfxtLBEXUXJuXCGYTJcy2S1d5nPYE,SpATywNh6bZuzm8s1ceuBUnMUAeoAHHw,5,3,2,0,2,0,2,0,9,1.2857142857142858,2,0.0,0,2,0,2,3,0,0,2,0,4,5,0
884,12590,g8m22R7W0Wo8v9RXY0TMbj5qf5RFgvht,A3fsA9Zfv1X2fVEQhTw51lKENdNrEqT3,8,12,7,0,2,0,6,0,27,3.857142857142857,2,0.0,1,7,0,2,11,0,0,6,0,10,17,1
885,12602,8g5cBj0Gjzli28QiIdgpvFAz2836fyoV,A3fsA9Zfv1X2fVEQhTw51lKENdNrEqT3,12,17,11,0,6,1,11,1,47,6.714285714285714,2,0.0,0,11,0,6,17,1,0,11,1,17,30,1
886,12628,JaYbgvhgx43SysY9J8DaCR3IcdUzCcUf,SpATywNh6bZuzm8s1ceuBUnMUAeoAHHw,11,16,0,6,0,0,5,0,27,3.857142857142857,4,0.0,2,0,6,0,14,0,0,5,0,8,19,0
887,12665,2DNSh2UatQFpodq67CmKbjqpA6AJb7Oi,SpATywNh6bZuzm8s1ceuBUnMUAeoAHHw,16,16,8,10,4,0,12,0,50,7.142857142857143,3,0.0,5,8,9,4,11,0,1,12,0,26,24,0
888,12694,EelXsFqmLbbOgu7NMVlCz136fL2FTkZO,G8EPVSXsOYB5YQWZGiz1aVq5Pgr2GrQu,15,33,9,0,5,0,3,0,50,7.142857142857143,3,0.0,2,9,0,5,31,0,0,3,0,16,34,1
889,12717,pXqbqKhLN9u2vMm4aIB5JwL5PRPhZDCp,A3fsA9Zfv1X2fVEQhTw51lKENdNrEqT3,3,2,0,0,0,0,1,0,3,0.42857142857142855,1,0.0,0,0,0,0,2,0,0,1,0,0,3,0
890,12725,yXkO3eR7yt6I5YPt7SbP4lJC7f4DWsPi,SpATywNh6bZuzm8s1ceuBUnMUAeoAHHw,12,32,2,23,1,12,5,0,75,10.714285714285714,2,0.0,10,2,19,1,22,12,4,5,0,32,43,0
891,12741,yFLanYq8p4sf6NFSB1Td9ag6632plY4t,A3fsA9Zfv1X2fVEQhTw51lKENdNrEqT3,25,25,20,0,16,1,10,1,73,10.428571428571429,4,0.0,0,20,0,16,25,1,0,10,1,36,37,0
892,12762,u82lBhpDxJIwlZISEntCxj1zgVFdW0vT,A3fsA9Zfv1X2fVEQhTw51lKENdNrEqT3,1,0,0,0,0,0,1,0,1,0.14285714285714285,1,0.0,0,0,0,0,0,0,0,1,0,0,1,1
893,12781,xI2qMeJnp6aq2CKhFmXJQYegY0eBgJqh,SpATywNh6bZuzm8s1ceuBUnMUAeoAHHw,13,31,15,3,7,0,5,0,61,8.714285714285714,3,0.0,6,15,3,7,25,0,0,5,0,31,30,0
894,12797,0r0opwFyJ4N25MV6ZjVs69MBQP4LTfaz,RXDvfPUBYFlVdlueBFbLW0mhhAyGEqpt,49,50,32,113,14,10,8,4,231,33.0,2,0.0,14,32,107,14,36,10,6,8,4,167,64,0
895,12798,SZOXOmDilP1KR3OJXHpIlLf61tEoqX1S,SpATywNh6bZuzm8s1ceuBUnMUAeoAHHw,10,11,0,9,0,8,7,2,37,5.285714285714286,1,0.0,8,0,8,0,3,8,1,7,2,16,21,1
896,12801,N5iDERl36Pe29yDG8gDe9a99dYgqwB7y,bWdj2GDclj5ofokWjzoa5jAwMkxCykd6,11,8,2,28,2,0,6,0,46,6.571428571428571,2,0.0,4,2,26,2,4,0,2,6,0,34,12,1
897,12830,L0KQTTHes3X5LPSdqQrdBMVgea19D6tJ,SpATywNh6bZuzm8s1ceuBUnMUAeoAHHw,6,5,2,0,2,0,1,0,10,1.4285714285714286,1,0.0,0,2,0,2,5,0,0,1,0,4,6,1
898,12838,D1VQybdJv05b8bnQWlTwVLnxuzPr9TGg,SpATywNh6bZuzm8s1ceuBUnMUAeoAHHw,18,36,10,19,3,1,23,2,94,13.428571428571429,5,0.0,11,10,17,3,25,1,2,23,2,41,53,0
899,12878,nxXaLxK1WzKt8vz8gfQ7mw2jj0DmsYuz,SpATywNh6bZuzm8s1ceuBUnMUAeoAHHw,11,10,0,11,1,0,7,0,29,4.142857142857143,3,0.0,4,0,10,1,6,0,1,7,0,15,14,0
900,12919,UaSh8dwx8gnofYbXlmpqj9uYDbpJ89pX,SpATywNh6bZuzm8s1ceuBUnMUAeoAHHw,9,19,2,0,0,129,18,5,173,24.714285714285715,3,0.0,5,2,0,0,14,129,0,18,5,7,166,0
901,12920,C7qRsA5jr1OEmJhfxUyc4ekgHn4q4XXi,SpATywNh6bZuzm8s1ceuBUnMUAeoAHHw,10,39,13,0,0,3,8,0,63,9.0,2,0.0,1,13,0,0,38,3,0,8,0,14,49,1
902,12922,uqIn0vdfJ1SDJCOeCVEAQPRFBBKQA2eB,A3fsA9Zfv1X2fVEQhTw51lKENdNrEqT3,43,25,12,48,11,0,15,0,111,15.857142857142858,2,0.0,1,12,46,11,24,0,2,15,0,70,41,1
903,12941,agXxlcmOoEfRNuHGmntEOJrJqSCOihJk,SpATywNh6bZuzm8s1ceuBUnMUAeoAHHw,13,14,0,8,0,1,7,1,31,4.428571428571429,4,0.0,2,0,8,0,12,1,0,7,1,10,21,1
904,12960,QxcB9RiJu5tiHZOch1DPGex1fIsAotsI,SpATywNh6bZuzm8s1ceuBUnMUAeoAHHw,15,42,2,19,1,33,33,6,136,19.428571428571427,6,0.0,15,2,14,1,27,33,5,33,6,32,104,0
905,12973,7fFZLbLMI7Ucj1mdrBxpY9hCEcczhOLF,RXDvfPUBYFlVdlueBFbLW0mhhAyGEqpt,37,34,3,72,2,3,17,2,133,19.0,2,0.0,9,3,70,2,25,3,2,17,2,84,49,0
906,12987,d1JMD7qxfNKpLgzBvlpfaUYeKyTI6qbc,RXDvfPUBYFlVdlueBFbLW0mhhAyGEqpt,8,3,2,0,2,1,6,0,14,2.0,1,0.0,0,2,0,2,3,1,0,6,0,4,10,0
907,12998,MM2B2653YFHORo361rzambfOSuqgdvxU,SpATywNh6bZuzm8s1ceuBUnMUAeoAHHw,14,13,4,14,3,4,7,0,45,6.428571428571429,3,0.0,8,4,11,3,5,4,3,7,0,26,19,1
908,13024,gdBVlnD2M7V6ljn8vJvT9NnajpxXqL1v,SpATywNh6bZuzm8s1ceuBUnMUAeoAHHw,5,6,1,0,0,0,5,0,12,1.7142857142857142,2,0.0,0,1,0,0,6,0,0,5,0,1,11,1
909,13064,FH8uaUgDtH5I6cjMpNACS7MT4OVRdm6l,SpATywNh6bZuzm8s1ceuBUnMUAeoAHHw,14,17,1,8,0,3,9,1,39,5.571428571428571,2,0.0,5,1,8,0,12,3,0,9,1,14,25,0
910,13068,Oewk1cgUhxDAPgxI9Y8opSnbFrQ56lFp,G8EPVSXsOYB5YQWZGiz1aVq5Pgr2GrQu,4,2,1,0,1,0,1,0,5,0.7142857142857143,1,0.0,0,1,0,1,2,0,0,1,0,2,3,0
911,13084,iKiK6wMQ7FsUhBHmZmA4WSvuLlgoIAIT,SpATywNh6bZuzm8s1ceuBUnMUAeoAHHw,13,17,7,6,3,1,1,0,35,5.0,1,0.0,9,7,6,3,8,1,0,1,0,25,10,1
912,13087,JuiV77lwSiyunloCdIxpEqZLnyAIWuGF,SpATywNh6bZuzm8s1ceuBUnMUAeoAHHw,17,55,16,24,7,52,26,0,180,25.714285714285715,5,0.0,18,16,20,7,37,52,4,26,0,61,119,1
913,13097,jSElHDudYQXAurrUrZvr8PEvqza2483p,SpATywNh6bZuzm8s1ceuBUnMUAeoAHHw,17,33,4,15,3,25,35,5,120,17.142857142857142,4,0.0,6,4,13,3,27,25,2,35,5,26,94,0
914,13162,PLNAK5eO2jDldFb2P1VVgW3GLNYSW1XE,A3fsA9Zfv1X2fVEQhTw51lKENdNrEqT3,2,0,0,0,0,0,2,0,2,0.2857142857142857,1,0.0,0,0,0,0,0,0,0,2,0,0,2,1
915,13169,VD51DafWdYqPb9OUf4DGqW0cSE2mdG9x,RXDvfPUBYFlVdlueBFbLW0mhhAyGEqpt,8,7,5,0,3,0,1,0,16,2.2857142857142856,1,0.0,0,5,0,3,7,0,0,1,0,8,8,0
916,13171,Xz4KwNrqILWO256erDoEJKlZ22fLi17K,bWdj2GDclj5ofokWjzoa5jAwMkxCykd6,7,8,0,74,2,0,5,0,89,12.714285714285714,2,0.0,6,0,73,2,2,0,1,5,0,81,8,1
917,13182,Gur5FuhE9EyV9K1F0qLPk7AenhoY8PBS,A3fsA9Zfv1X2fVEQhTw51lKENdNrEqT3,24,27,12,0,9,0,9,0,57,8.142857142857142,1,0.0,0,12,0,9,27,0,0,9,0,21,36,0
918,13213,fvcf8Mss4D9M5Dkk5Dn5T9NiTapwZ9dB,A3fsA9Zfv1X2fVEQhTw51lKENdNrEqT3,2,0,0,0,0,0,2,0,2,0.2857142857142857,1,0.0,0,0,0,0,0,0,0,2,0,0,2,1
919,13231,CGCo1ulRSzYrFke9WXpheptgBfQxf2gK,SpATywNh6bZuzm8s1ceuBUnMUAeoAHHw,17,30,13,11,5,13,19,2,93,13.285714285714286,5,0.0,10,13,10,5,20,13,1,19,2,38,55,0
920,13268,eAArxLyCThtu9N3Mv8rQculKbGSa66j9,G8EPVSXsOYB5YQWZGiz1aVq5Pgr2GrQu,5,5,3,0,1,0,3,0,12,1.7142857142857142,3,0.0,0,3,0,1,5,0,0,3,0,4,8,0
921,13270,ffLXxfgMU4yir9uI5fIkKo2iZzEw2Lpz,SpATywNh6bZuzm8s1ceuBUnMUAeoAHHw,11,9,5,0,3,0,5,0,22,3.142857142857143,2,0.0,0,5,0,3,9,0,0,5,0,8,14,1
922,13284,HmCqvdVQxacevQymd3KKpvfG444InuCU,RXDvfPUBYFlVdlueBFbLW0mhhAyGEqpt,38,43,22,82,0,0,6,0,153,21.857142857142858,2,0.0,17,22,79,0,26,0,3,6,0,118,35,0
923,13294,kI6cheDOBy9s4ZYk6wZ8CKNoQdId12d9,SpATywNh6bZuzm8s1ceuBUnMUAeoAHHw,7,5,2,0,0,0,4,1,12,1.7142857142857142,1,0.0,0,2,0,0,5,0,0,4,1,2,10,1
924,13297,0b8UUNX7vDapSg0uCVOk0glpsbuPbDat,SpATywNh6bZuzm8s1ceuBUnMUAeoAHHw,17,49,16,18,7,55,13,1,159,22.714285714285715,5,0.0,26,16,15,7,23,55,3,13,1,64,95,0
925,13309,1dxQmK9WwlHWuIG7ZTn4PsJ2vflQBDH3,A3fsA9Zfv1X2fVEQhTw51lKENdNrEqT3,3,2,0,0,0,0,2,0,4,0.5714285714285714,1,0.0,0,0,0,0,2,0,0,2,0,0,4,0
926,13312,9aWGLeAVHncegHPXAP1qMMyzvcIDPZKu,A3fsA9Zfv1X2fVEQhTw51lKENdNrEqT3,7,2,1,0,0,1,5,1,10,1.4285714285714286,1,0.0,0,1,0,0,2,1,0,5,1,1,9,1
927,13324,NuZwpz0U4SxzLHddLsrKCkHdkj5yyqPt,A3fsA9Zfv1X2fVEQhTw51lKENdNrEqT3,24,32,1,38,0,0,2,0,73,10.428571428571429,1,0.0,1,1,35,0,31,0,3,2,0,37,36,1
928,13353,Aw7PeIkLW9CDHbPpPSjrFUdtBaUuHUXm,A3fsA9Zfv1X2fVEQhTw51lKENdNrEqT3,41,19,15,60,10,2,26,0,132,18.857142857142858,5,0.0,1,15,49,10,18,2,11,26,0,75,57,0
929,13389,suNtRVoL26o1uoSjCtTBYoEROkIKHNRV,SpATywNh6bZuzm8s1ceuBUnMUAeoAHHw,11,32,5,4,3,0,4,0,48,6.857142857142857,2,0.0,12,5,4,3,20,0,0,4,0,24,24,0
930,13392,Zp81uMflvqqrfEwxhUzFhFbNFp63e2qq,SpATywNh6bZuzm8s1ceuBUnMUAeoAHHw,15,52,1,15,0,6,11,1,86,12.285714285714286,2,0.0,21,1,15,0,31,6,0,11,1,37,49,0
931,13417,P6cCvRjvbpDjgLjSjFoCoaUi3J3jrMaV,bWdj2GDclj5ofokWjzoa5jAwMkxCykd6,10,25,1,52,3,2,16,1,100,14.285714285714286,1,0.0,7,1,51,3,18,2,1,16,1,62,38,1
932,13502,Zdseq1rQmkAi5wZl57d3RwjzOxlL3B5I,A3fsA9Zfv1X2fVEQhTw51lKENdNrEqT3,45,42,30,62,14,18,33,5,204,29.142857142857142,4,0.0,4,30,51,14,38,18,11,33,5,99,105,0
933,13503,2YfvPW4RjjB1wuYNlMfzfMUdSCE4Rwzu,SpATywNh6bZuzm8s1ceuBUnMUAeoAHHw,13,15,0,17,0,16,9,2,59,8.428571428571429,2,0.0,3,0,14,0,12,16,3,9,2,17,42,0
934,13529,Ge8ZKyoh7v3U8XFFvvntz8tE5dDD1txz,SpATywNh6bZuzm8s1ceuBUnMUAeoAHHw,16,32,11,15,5,11,22,4,100,14.285714285714286,2,0.0,14,11,12,5,18,11,3,22,4,42,58,1
935,13538,LjMEB9aIUIvEfq4JTf4C9ef9fHbbyj0M,SpATywNh6bZuzm8s1ceuBUnMUAeoAHHw,17,28,7,21,5,9,6,1,77,11.0,2,0.0,17,7,18,5,11,9,3,6,1,47,30,0
936,13541,dQ6ARJIxCHLlztvK37NHQ0C1ttipx0zg,SpATywNh6bZuzm8s1ceuBUnMUAeoAHHw,14,19,8,13,3,4,4,0,51,7.285714285714286,3,0.0,8,8,12,3,11,4,1,4,0,31,20,0
937,13562,Du4OhdznDw29gaWDeHXBUWRKyEVAbHaQ,SpATywNh6bZuzm8s1ceuBUnMUAeoAHHw,17,30,15,19,5,1,17,1,88,12.571428571428571,4,0.0,8,15,13,5,22,1,6,17,1,41,47,0
938,13574,BOWTvQlkFu3OONGPj2orMpzJbZOzBXuG,SpATywNh6bZuzm8s1ceuBUnMUAeoAHHw,15,26,1,8,0,50,23,4,112,16.0,4,0.0,7,1,8,0,19,50,0,23,4,16,96,0
939,13577,r9n2Z7iYkL5tKegLJwMIOxTHQqxopYp0,SpATywNh6bZuzm8s1ceuBUnMUAeoAHHw,12,21,15,8,6,0,7,0,57,8.142857142857142,6,0.0,0,15,6,6,21,0,2,7,0,27,30,1
940,13596,SuKlsA6xoxq9JGrANP30LMW7qjrc07fy,bWdj2GDclj5ofokWjzoa5jAwMkxCykd6,17,25,16,76,4,0,13,0,134,19.142857142857142,2,0.0,5,16,70,4,20,0,6,13,0,95,39,1
941,13611,taXwAmoyCNDGaXo8nVRGsDZwnk4if3bF,SpATywNh6bZuzm8s1ceuBUnMUAeoAHHw,14,44,13,6,6,2,12,1,84,12.0,4,0.0,7,13,6,6,37,2,0,12,1,32,52,0
942,13635,ePpfrPKFmuYE4CHcpunEZ73b0FxyOz0q,A3fsA9Zfv1X2fVEQhTw51lKENdNrEqT3,45,25,14,54,11,6,20,1,131,18.714285714285715,4,0.0,2,14,45,11,23,6,9,20,1,72,59,1
943,13639,6ZFGnTjh94PbXkR7sbTLWokikXbcLQlV,A3fsA9Zfv1X2fVEQhTw51lKENdNrEqT3,1,0,0,0,0,0,1,0,1,0.14285714285714285,1,0.0,0,0,0,0,0,0,0,1,0,0,1,0
944,13643,kF8fYPSPVuf77u2d6KdtH12htaNTxyrR,SpATywNh6bZuzm8s1ceuBUnMUAeoAHHw,3,4,0,0,0,0,1,0,5,0.7142857142857143,1,0.0,0,0,0,0,4,0,0,1,0,0,5,1
945,13646,2gMbFqhNbghdA4J5huVDcJIix3xmMqms,SpATywNh6bZuzm8s1ceuBUnMUAeoAHHw,15,36,2,22,0,20,12,1,93,13.285714285714286,3,0.0,14,2,18,0,22,20,4,12,1,34,59,1
946,13658,BRb6GOIqcgYg1e6c431h8FubF4jTJim3,SpATywNh6bZuzm8s1ceuBUnMUAeoAHHw,15,34,2,8,1,3,17,4,69,9.857142857142858,3,0.0,5,2,7,1,29,3,1,17,4,15,54,1
947,13666,Y0LHIPeN84CX2pJB37p6sblq4PhQo9k4,SpATywNh6bZuzm8s1ceuBUnMUAeoAHHw,4,2,1,0,1,1,2,0,7,1.0,1,0.0,0,1,0,1,2,1,0,2,0,2,5,1
948,13668,ZFgJH3XPKn6EjDuXV9VLOpKftzENCqEZ,G8EPVSXsOYB5YQWZGiz1aVq5Pgr2GrQu,19,21,15,20,4,0,4,0,64,9.142857142857142,2,0.0,0,15,18,4,21,0,2,4,0,37,27,0
949,13677,ZFgJH3XPKn6EjDuXV9VLOpKftzENCqEZ,RXDvfPUBYFlVdlueBFbLW0mhhAyGEqpt,6,8,3,0,1,1,2,0,15,2.142857142857143,1,0.0,0,3,0,1,8,1,0,2,0,4,11,0
950,13752,GUhU3sa7QMussHGi4kspdulqSqF9Ft42,SpATywNh6bZuzm8s1ceuBUnMUAeoAHHw,15,53,3,19,3,35,17,1,131,18.714285714285715,6,0.0,19,3,16,3,34,35,3,17,1,41,90,0
951,13756,zx92A3etlZOmjWi19IMDYlwaWCkvF08z,SpATywNh6bZuzm8s1ceuBUnMUAeoAHHw,6,13,1,0,1,0,2,0,17,2.4285714285714284,2,0.0,2,1,0,1,11,0,0,2,0,4,13,1
952,13770,73akjB4xSPosxH1enrEsMGxNVgbw9q8A,SpATywNh6bZuzm8s1ceuBUnMUAeoAHHw,7,16,4,0,2,0,4,0,26,3.7142857142857144,2,0.0,0,4,0,2,16,0,0,4,0,6,20,1
953,13771,I1KwJ6EdCZnEPLfC8Q7yWpIkLOHn7h02,A3fsA9Zfv1X2fVEQhTw51lKENdNrEqT3,44,28,19,82,14,0,13,1,157,22.428571428571427,3,0.0,1,19,64,14,27,0,18,13,1,98,59,1
954,13776,PUFh3BsQaDVIJMDvwsFTqkrgAzvjO9ME,A3fsA9Zfv1X2fVEQhTw51lKENdNrEqT3,22,34,23,0,9,7,16,1,90,12.857142857142858,3,0.0,1,23,0,9,33,7,0,16,1,33,57,0
955,14546,82UlWF6Fm1gkNum7nNbVw0yOV1BUdNoS,7GRhBDsirIGkRZBtSMEzNTyDr2JQm4xx,8,14,6,4,3,9,4,0,40,5.714285714285714,3,0.0,5,6,3,3,9,9,1,4,0,17,23,1
956,14552,gmqCuQTX0aljJXYwlMbQKWVNQXzJBU7z,7GRhBDsirIGkRZBtSMEzNTyDr2JQm4xx,10,4,3,0,2,1,7,1,18,2.5714285714285716,1,0.0,0,3,0,2,4,1,0,7,1,5,13,0
957,14609,Q9kdHcV1kbonm0KnIW9OSERwU5lfVZ8s,7GRhBDsirIGkRZBtSMEzNTyDr2JQm4xx,28,53,15,9,10,5,12,2,106,15.142857142857142,1,0.0,22,15,7,10,31,5,2,12,2,54,52,1
958,14654,StcQZMEDAMldF4GFQUzkrPFNVNZnPaeq,7GRhBDsirIGkRZBtSMEzNTyDr2JQm4xx,36,113,31,54,22,12,21,7,260,37.142857142857146,3,0.0,79,31,41,22,34,12,13,21,7,173,87,0
959,14744,fznl9GLBUcCuiLFhCkHOSxn8Xeb6YOkl,7GRhBDsirIGkRZBtSMEzNTyDr2JQm4xx,31,49,23,62,24,54,8,0,220,31.428571428571427,2,0.0,26,23,51,24,23,54,11,8,0,124,96,1
960,14778,SxA4qsG4oQiVsK58JS1BnBCuBa1rQRmi,7GRhBDsirIGkRZBtSMEzNTyDr2JQm4xx,29,35,13,56,9,4,2,0,119,17.0,1,0.0,18,13,47,9,17,4,9,2,0,87,32,1
961,14827,qxbESUsL0xgJYJDfjiKdrZA2VpHvSkr3,7GRhBDsirIGkRZBtSMEzNTyDr2JQm4xx,26,29,11,38,15,0,2,0,95,13.571428571428571,2,0.0,16,11,33,15,13,0,5,2,0,75,20,1
962,14847,1CUoIZB9t7SxaldyOLjOrt0HiuV3YmmT,7GRhBDsirIGkRZBtSMEzNTyDr2JQm4xx,11,20,8,0,5,0,6,0,39,5.571428571428571,2,0.0,1,8,0,5,19,0,0,6,0,14,25,0
963,15066,6vCR5MIMPnf9UWKZznVOJS5OTo4Gr7Hd,7GRhBDsirIGkRZBtSMEzNTyDr2JQm4xx,29,73,18,33,11,11,8,0,154,22.0,2,0.0,27,18,30,11,46,11,3,8,0,86,68,1
964,15083,AsBtR21xGFKZ6c2LKvPTdlawgiUBcaPL,7GRhBDsirIGkRZBtSMEzNTyDr2JQm4xx,37,61,24,69,20,10,17,1,202,28.857142857142858,3,0.0,30,24,55,20,31,10,14,17,1,129,73,0
965,15202,ePpfrPKFmuYE4CHcpunEZ73b0FxyOz0q,7GRhBDsirIGkRZBtSMEzNTyDr2JQm4xx,30,32,13,78,10,1,6,0,140,20.0,2,0.0,16,13,66,10,16,1,12,6,0,105,35,1
966,15240,9PiJFDewOyLmHT48JZWbbQ236haTndT7,7GRhBDsirIGkRZBtSMEzNTyDr2JQm4xx,32,87,21,49,15,6,17,1,196,28.0,4,0.0,39,21,45,15,48,6,4,17,1,120,76,1
967,15242,CYwEz0VhssUEnyi7GLISc2cCNlhTg5eu,7GRhBDsirIGkRZBtSMEzNTyDr2JQm4xx,25,58,1,50,4,2,7,0,122,17.428571428571427,3,0.0,37,1,44,4,21,2,6,7,0,86,36,1
968,15296,S0OJjF6aof0iTnIX6lUAxekoH3m4w7V0,7GRhBDsirIGkRZBtSMEzNTyDr2JQm4xx,31,91,39,64,11,64,11,0,280,40.0,3,0.0,39,39,55,11,52,64,9,11,0,144,136,0
969,15339,C6xrhZPOmVH2gCVNP26gSSPka2CcwgB5,7GRhBDsirIGkRZBtSMEzNTyDr2JQm4xx,19,13,7,14,7,0,3,1,45,6.428571428571429,1,0.0,6,7,13,7,7,0,1,3,1,33,12,1
970,15361,CrwYq2YvOe70PhTOuriN4QumcrUjBJDI,7GRhBDsirIGkRZBtSMEzNTyDr2JQm4xx,17,31,9,9,7,0,2,0,58,8.285714285714286,1,0.0,20,9,8,7,11,0,1,2,0,44,14,0
971,15367,nnTxxp3z9fcrPPkS4kzYDi6mu4P5bdue,7GRhBDsirIGkRZBtSMEzNTyDr2JQm4xx,31,36,15,58,9,2,11,0,131,18.714285714285715,5,0.0,16,15,49,9,20,2,9,11,0,89,42,0
972,15401,9iGaqBGS5kkoXjLd87hUL2eIJMVUVKfU,7GRhBDsirIGkRZBtSMEzNTyDr2JQm4xx,3,2,0,0,0,0,1,0,3,0.42857142857142855,1,0.0,0,0,0,0,2,0,0,1,0,0,3,0
973,15563,VVltscgfR96aweHb5nQdD1Q7dsOwuOJz,7GRhBDsirIGkRZBtSMEzNTyDr2JQm4xx,9,6,1,10,2,0,1,0,20,2.857142857142857,1,0.0,2,1,9,2,4,0,1,1,0,14,6,0
974,15641,xY5IUgrYconprXri0F5cssyTAsVeuYqD,7GRhBDsirIGkRZBtSMEzNTyDr2JQm4xx,5,9,2,0,0,0,2,0,13,1.8571428571428572,1,0.0,5,2,0,0,4,0,0,2,0,7,6,1
975,15694,ls88dNG7SGcb3wsgc3lZQCJwuuAQTKkF,7GRhBDsirIGkRZBtSMEzNTyDr2JQm4xx,8,12,1,0,2,0,4,0,19,2.7142857142857144,2,0.0,2,1,0,2,10,0,0,4,0,5,14,1
976,15700,p8pFuUg19xWGOlJygMvSlQjonA3l7FUn,7GRhBDsirIGkRZBtSMEzNTyDr2JQm4xx,4,2,1,0,1,0,2,0,6,0.8571428571428571,1,0.0,0,1,0,1,2,0,0,2,0,2,4,1
977,15713,UQMPqDnQtELOyig8xWMMs5ktcYwtyCzh,7GRhBDsirIGkRZBtSMEzNTyDr2JQm4xx,2,0,0,0,0,0,2,0,2,0.2857142857142857,1,0.0,0,0,0,0,0,0,0,2,0,0,2,0
978,15716,W2ohBuN5JfRDGloM0s99vkGQJHKKrtyK,7GRhBDsirIGkRZBtSMEzNTyDr2JQm4xx,20,34,16,8,11,1,3,0,73,10.428571428571429,4,0.0,15,16,6,11,19,1,2,3,0,48,25,1
979,15771,HbdIEiZ1jslj2pBp8czn7lhBbxLYjtpj,7GRhBDsirIGkRZBtSMEzNTyDr2JQm4xx,25,25,3,34,3,0,3,0,68,9.714285714285714,2,0.0,13,3,34,3,12,0,0,3,0,53,15,0
980,15810,WJLMraoon9e2y7OtDk9UrQjU4oqkoa0t,7GRhBDsirIGkRZBtSMEzNTyDr2JQm4xx,1,0,0,0,0,0,1,0,1,0.14285714285714285,1,0.0,0,0,0,0,0,0,0,1,0,0,1,0
981,15814,g7u6ac7DR9jMW4aOouB4W8Gur81b4cDe,7GRhBDsirIGkRZBtSMEzNTyDr2JQm4xx,4,2,1,0,1,0,1,0,5,0.7142857142857143,1,0.0,0,1,0,1,2,0,0,1,0,2,3,0
982,15876,rrw2WJkAL0R5jcfwKMTsm56jlh9a5ial,7GRhBDsirIGkRZBtSMEzNTyDr2JQm4xx,2,0,0,0,0,0,9,0,9,1.2857142857142858,2,0.0,0,0,0,0,0,0,0,9,0,0,9,1
983,15881,W8K4VS8rPvnPTNUJrqgtS2FKH93KmR91,7GRhBDsirIGkRZBtSMEzNTyDr2JQm4xx,6,5,2,0,0,0,4,0,11,1.5714285714285714,2,0.0,0,2,0,0,5,0,0,4,0,2,9,1
984,15900,MvkVXPKImqjQobZ7zCJXq4GfQ4IthLq9,7GRhBDsirIGkRZBtSMEzNTyDr2JQm4xx,29,47,12,30,9,22,8,0,128,18.285714285714285,4,0.0,21,12,28,9,26,22,2,8,0,70,58,0
985,15912,hJo1MgKiPZFXuH2ko6hqPTd9dbjMQKDO,7GRhBDsirIGkRZBtSMEzNTyDr2JQm4xx,4,4,2,0,0,0,1,0,7,1.0,1,0.0,0,2,0,0,4,0,0,1,0,2,5,1
986,15919,oho8eUx0qt2QgQUM9H4Puo64w9V5nVUl,7GRhBDsirIGkRZBtSMEzNTyDr2JQm4xx,32,44,16,29,12,1,14,2,118,16.857142857142858,3,0.0,24,16,29,12,20,1,0,14,2,81,37,1
987,15922,OHdLWfOkVYVSxh9avWbeG6oGLyuN9vvx,7GRhBDsirIGkRZBtSMEzNTyDr2JQm4xx,9,8,5,6,4,2,4,0,29,4.142857142857143,1,0.0,2,5,6,4,6,2,0,4,0,17,12,1
988,15944,i4Ja5POFcbWsTXzyspWne0P4gq0Sndm7,7GRhBDsirIGkRZBtSMEzNTyDr2JQm4xx,3,0,0,0,0,0,3,0,3,0.42857142857142855,1,0.0,0,0,0,0,0,0,0,3,0,0,3,1
989,15956,wg7c1wZNHnWuQEzOFg3X7UO4UvdvZ0Nl,7GRhBDsirIGkRZBtSMEzNTyDr2JQm4xx,6,5,2,14,0,0,2,0,23,3.2857142857142856,1,0.0,1,2,12,0,4,0,2,2,0,15,8,1
990,15959,KD5stEhIDxW0wB7Mr1YVPQQ5AGRkzqAA,7GRhBDsirIGkRZBtSMEzNTyDr2JQm4xx,33,78,29,50,14,21,14,0,206,29.428571428571427,3,0.0,42,29,46,14,36,21,4,14,0,131,75,1
991,15966,dWGIj0UEkV1WxMBYGHRsdtDhUsNSq5LC,7GRhBDsirIGkRZBtSMEzNTyDr2JQm4xx,36,66,24,24,21,5,12,1,153,21.857142857142858,4,0.0,29,24,23,21,37,5,1,12,1,97,56,0
992,16020,ywdL3xkp7d2PSjbvnflAvIe7Wp6Q4SRe,7GRhBDsirIGkRZBtSMEzNTyDr2JQm4xx,26,77,5,66,7,0,10,0,165,23.571428571428573,3,0.0,33,5,61,7,44,0,5,10,0,106,59,1
993,16029,aWq626ehQk5Iuuwzds6iAgtzgkimu1j2,7GRhBDsirIGkRZBtSMEzNTyDr2JQm4xx,33,49,19,65,15,1,13,0,162,23.142857142857142,4,0.0,23,19,56,15,26,1,9,13,0,113,49,1
994,16081,Z9zd5ft7NWbOfEUxKVShKB2Y1F3jXBm8,7GRhBDsirIGkRZBtSMEzNTyDr2JQm4xx,3,0,0,0,0,1,3,0,4,0.5714285714285714,1,0.0,0,0,0,0,0,1,0,3,0,0,4,1
995,16087,SIdEQEXoagJ5WwAcAkPtkVF6pipatiIa,7GRhBDsirIGkRZBtSMEzNTyDr2JQm4xx,30,52,12,56,9,4,7,0,140,20.0,2,0.0,26,12,49,9,26,4,7,7,0,96,44,0
996,16168,DLDhUvvvfnnYFJuV65Zt2yaS0jPJgvzq,7GRhBDsirIGkRZBtSMEzNTyDr2JQm4xx,3,2,0,0,0,0,1,0,3,0.42857142857142855,1,0.0,0,0,0,0,2,0,0,1,0,0,3,1
997,16289,moK1GdnqoYxhSRCf5a95lgXdVNdzYrjs,7GRhBDsirIGkRZBtSMEzNTyDr2JQm4xx,28,73,4,46,3,2,30,0,158,22.571428571428573,5,0.0,22,4,39,3,51,2,7,30,0,68,90,1
998,16303,2WHNpOBPMmOzdjUXQIDdX6w5Bhh6AyHU,7GRhBDsirIGkRZBtSMEzNTyDr2JQm4xx,28,67,2,41,5,0,14,0,129,18.428571428571427,3,0.0,33,2,35,5,34,0,6,14,0,75,54,0
999,16378,RjbxXw1YYmiUcedHIl1VrXvYXiS6wbOC,7GRhBDsirIGkRZBtSMEzNTyDr2JQm4xx,1,0,0,0,0,0,1,0,1,0.14285714285714285,1,0.0,0,0,0,0,0,0,0,1,0,0,1,0
1000,16415,096xYyhB9kL7G6lT7J9rVrXyGNwUToLF,7GRhBDsirIGkRZBtSMEzNTyDr2JQm4xx,19,15,12,0,3,0,2,0,32,4.571428571428571,1,0.0,0,12,0,3,15,0,0,2,0,15,17,0
1001,16460,KDzfaWgTSBqeMJLFLmFuh4CMLsva9aWu,7GRhBDsirIGkRZBtSMEzNTyDr2JQm4xx,6,7,0,0,0,0,3,0,10,1.4285714285714286,1,0.0,0,0,0,0,7,0,0,3,0,0,10,0
1002,16518,VFg2AN5zsuWpHyPwDEXIcAxQpNCPCOo7,7GRhBDsirIGkRZBtSMEzNTyDr2JQm4xx,53,101,36,63,32,35,25,2,294,42.0,2,0.0,45,36,56,32,56,35,7,25,2,169,125,1
1003,16541,tDBUBIMhJEJx4Pe5n9oY4eK5G81QRmVq,7GRhBDsirIGkRZBtSMEzNTyDr2JQm4xx,24,63,1,65,4,6,8,0,147,21.0,3,0.0,34,1,61,4,29,6,4,8,0,100,47,0
1004,16559,WbPhqfwmFYggW432ooC1iHmgUJBCP9Le,7GRhBDsirIGkRZBtSMEzNTyDr2JQm4xx,35,64,24,41,18,16,23,5,191,27.285714285714285,4,0.0,35,24,37,18,29,16,4,23,5,114,77,0
1005,16632,uPNpQwnvEtjDufLcIcScg8qVljQjes1y,7GRhBDsirIGkRZBtSMEzNTyDr2JQm4xx,25,28,12,29,10,0,4,0,83,11.857142857142858,4,0.0,9,12,27,10,19,0,2,4,0,58,25,1
1006,16696,EshSTNSaPVDLcPEwlm2e07DrZJhzPNHK,7GRhBDsirIGkRZBtSMEzNTyDr2JQm4xx,35,129,44,44,11,36,26,0,290,41.42857142857143,4,0.0,72,44,36,11,57,36,8,26,0,163,127,0
1007,16712,5nwrdJlhASYfMmSpU3deRRqUrd3ZpMIS,7GRhBDsirIGkRZBtSMEzNTyDr2JQm4xx,5,2,1,0,1,0,2,0,6,0.8571428571428571,1,0.0,0,1,0,1,2,0,0,2,0,2,4,1
1008,16828,FhnsJdRTpIANrPfAv3Fv2vn7QGHPfOsl,7GRhBDsirIGkRZBtSMEzNTyDr2JQm4xx,3,0,0,0,0,87,28,0,115,16.428571428571427,5,0.0,0,0,0,0,0,87,0,28,0,0,115,0
1009,16923,oSfAVLTcGEmcT7y7OMQrYnvkkm78yh0P,7GRhBDsirIGkRZBtSMEzNTyDr2JQm4xx,32,51,23,80,10,24,11,0,199,28.428571428571427,2,0.0,20,23,69,10,31,24,11,11,0,122,77,1
1010,16957,5fUv2a4WMEi2Bc60cQo0Uzo1I7SufPfI,7GRhBDsirIGkRZBtSMEzNTyDr2JQm4xx,25,44,1,62,4,39,6,0,156,22.285714285714285,2,0.0,19,1,51,4,25,39,11,6,0,75,81,1
1011,16978,9gZpfuq1OK1diJdWcNoIpwo7QJUSplIt,7GRhBDsirIGkRZBtSMEzNTyDr2JQm4xx,41,83,34,49,16,6,25,2,215,30.714285714285715,4,0.0,40,34,46,16,43,6,3,25,2,136,79,1
1012,16979,hdKqkkWKrDzbKE9btGChBqiCfsTwp68E,7GRhBDsirIGkRZBtSMEzNTyDr2JQm4xx,2,0,0,0,0,0,2,0,2,0.2857142857142857,1,0.0,0,0,0,0,0,0,0,2,0,0,2,1
1013,16999,Jb792VQeMGhUz59LQDa5JysSU082aNRs,7GRhBDsirIGkRZBtSMEzNTyDr2JQm4xx,25,51,21,28,11,1,3,0,115,16.428571428571427,5,0.0,25,21,25,11,26,1,3,3,0,82,33,0
1014,17028,HF98YPKzT8oi2j9flZW9kstZcvL3ZimG,7GRhBDsirIGkRZBtSMEzNTyDr2JQm4xx,28,66,20,62,10,0,1,0,159,22.714285714285715,1,0.0,23,20,53,10,43,0,9,1,0,106,53,0
1015,17049,4i80ssNqIa74pSBDzjYYryTbL6MBe9I9,7GRhBDsirIGkRZBtSMEzNTyDr2JQm4xx,27,36,13,56,12,36,33,0,186,26.571428571428573,4,0.0,17,13,47,12,19,36,9,33,0,89,97,1
1016,17055,CxUPOQRaQMGLmbOcfniIQOhh24PXLDR6,7GRhBDsirIGkRZBtSMEzNTyDr2JQm4xx,31,116,34,30,21,10,14,2,227,32.42857142857143,5,0.0,49,34,24,21,67,10,6,14,2,128,99,0
1017,17104,oxYTAYYaR98reRev5BqLPii4AFJGZbGZ,7GRhBDsirIGkRZBtSMEzNTyDr2JQm4xx,35,58,16,83,16,6,15,1,195,27.857142857142858,3,0.0,26,16,75,16,32,6,8,15,1,133,62,1
1018,17267,5nhjk1VnZY8a3OWnkRujRs0BorgiAKUm,7GRhBDsirIGkRZBtSMEzNTyDr2JQm4xx,33,64,2,128,5,24,24,2,249,35.57142857142857,6,0.0,28,2,117,5,36,24,11,24,2,152,97,1
1019,17303,yhSGXw7EnYX7J3WWxRb9piBAfJaOtRLJ,7GRhBDsirIGkRZBtSMEzNTyDr2JQm4xx,27,44,13,57,7,0,2,0,123,17.571428571428573,2,0.0,16,13,51,7,28,0,6,2,0,87,36,1
1020,17382,B9q7BVaj4oZ0WT5JELnStUq4yahYsvGS,7GRhBDsirIGkRZBtSMEzNTyDr2JQm4xx,29,78,16,42,17,9,6,0,168,24.0,4,0.0,39,16,39,17,39,9,3,6,0,111,57,1
1021,17388,QRh7ApSBJNbSH61R3OkAQmXanxVzZM0F,7GRhBDsirIGkRZBtSMEzNTyDr2JQm4xx,4,2,1,0,1,0,1,0,5,0.7142857142857143,1,0.0,0,1,0,1,2,0,0,1,0,2,3,0
1022,17389,Qj89AM8R8CzDfUmyoFjU0iKz1g513ZXt,7GRhBDsirIGkRZBtSMEzNTyDr2JQm4xx,38,109,49,60,15,134,33,2,402,57.42857142857143,5,0.0,19,49,51,15,90,134,9,33,2,134,268,1
1023,17586,TwDUv8vbemLEqdAHMCXeJ0dOJyZMBx6V,7GRhBDsirIGkRZBtSMEzNTyDr2JQm4xx,3,3,1,0,0,0,1,0,5,0.7142857142857143,1,0.0,0,1,0,0,3,0,0,1,0,1,4,0
1024,17597,dxt9lWTWbhPZn9mT70zVSi49oFElvqw6,7GRhBDsirIGkRZBtSMEzNTyDr2JQm4xx,28,53,5,68,7,1,6,0,140,20.0,3,0.0,25,5,60,7,28,1,8,6,0,97,43,1
1025,17620,5HX4czL6Sp8ee3UX2kWAHqmFW5CMMTjE,7GRhBDsirIGkRZBtSMEzNTyDr2JQm4xx,9,24,9,6,9,1,6,0,55,7.857142857142857,1,0.0,8,9,5,9,16,1,1,6,0,31,24,0
1026,17626,uol5rXltLKrhjm5SMrTU5qkZcMAMKTe6,7GRhBDsirIGkRZBtSMEzNTyDr2JQm4xx,15,16,6,10,4,1,12,1,50,7.142857142857143,2,0.0,6,6,8,4,10,1,2,12,1,24,26,1
1027,17660,UaSh8dwx8gnofYbXlmpqj9uYDbpJ89pX,7GRhBDsirIGkRZBtSMEzNTyDr2JQm4xx,8,19,0,0,0,6,5,0,30,4.285714285714286,2,0.0,10,0,0,0,9,6,0,5,0,10,20,0
1028,17677,7VmmzXV3A639hzlpZwrx655FqwOsl8uh,7GRhBDsirIGkRZBtSMEzNTyDr2JQm4xx,7,5,0,0,0,0,6,0,11,1.5714285714285714,3,0.0,0,0,0,0,5,0,0,6,0,0,11,1
1029,17706,WJVoKPfDDccrIbPzaP1iqdrTUwOdTQpf,7GRhBDsirIGkRZBtSMEzNTyDr2JQm4xx,24,60,11,4,12,6,11,2,106,15.142857142857142,1,0.0,28,11,4,12,32,6,0,11,2,55,51,1
1030,19577,udnRYxurswpE4GUZcnc80kafg0hn3fpz,fbPkOYLVPtPgIt0MxizjfFJov3JbHyAi,1,0,0,0,0,0,1,0,1,0.14285714285714285,1,0.0,0,0,0,0,0,0,0,1,0,0,1,1
1031,19578,8o4E9PO3r20M8IPbGHnn7ry81or8oVUd,fbPkOYLVPtPgIt0MxizjfFJov3JbHyAi,5,4,1,0,1,0,2,0,8,1.1428571428571428,1,0.0,0,1,0,1,4,0,0,2,0,2,6,1
1032,19579,mK2PenVNfwXeBJzi7mP3HzWchd5fxecA,fbPkOYLVPtPgIt0MxizjfFJov3JbHyAi,7,5,2,0,1,4,7,0,19,2.7142857142857144,2,0.0,0,2,0,1,5,4,0,7,0,3,16,1
1033,19580,3W09pasLSoDWuQqGyvECJ7WiykG165j2,fbPkOYLVPtPgIt0MxizjfFJov3JbHyAi,10,43,7,1,3,17,9,0,80,11.428571428571429,5,0.0,6,7,1,3,37,17,0,9,0,17,63,1
1034,19581,VHVVDsLJTPPR7rfPiJMrbsUMa6RdDEDz,fbPkOYLVPtPgIt0MxizjfFJov3JbHyAi,1,0,0,0,0,0,2,0,2,0.2857142857142857,1,0.0,0,0,0,0,0,0,0,2,0,0,2,1
1035,19582,0YyuZCZ9YG2n31hPJCi1E2GmCt5JQVnE,fbPkOYLVPtPgIt0MxizjfFJov3JbHyAi,7,3,2,0,2,2,3,0,12,1.7142857142857142,1,0.0,0,2,0,2,3,2,0,3,0,4,8,0
1036,19584,svaRJHaQGfUR34JQvStVpv5jX9kWWhlQ,fbPkOYLVPtPgIt0MxizjfFJov3JbHyAi,7,5,2,0,2,0,3,0,12,1.7142857142857142,1,0.0,0,2,0,2,5,0,0,3,0,4,8,1
1037,19586,z5Htt0utseDft2JjH8T5zYokNhpAiHNE,fbPkOYLVPtPgIt0MxizjfFJov3JbHyAi,1,0,0,0,0,0,1,0,1,0.14285714285714285,1,0.0,0,0,0,0,0,0,0,1,0,0,1,0
1038,19587,I45Q3yivyiRN2kHVhbV8bUCfrXvtpUvU,fbPkOYLVPtPgIt0MxizjfFJov3JbHyAi,9,7,5,0,4,0,7,0,23,3.2857142857142856,1,0.0,0,5,0,4,7,0,0,7,0,9,14,1
1039,19588,EFioWHTkYv074j9vSFY7qmw2MvFzZ0mo,fbPkOYLVPtPgIt0MxizjfFJov3JbHyAi,26,46,18,22,17,36,15,1,155,22.142857142857142,4,0.0,20,18,17,17,26,36,5,15,1,72,83,0
1040,19589,SgWqRh3XmeJpz6RfUb8yXu2ZkH0AleuJ,fbPkOYLVPtPgIt0MxizjfFJov3JbHyAi,6,4,0,0,0,10,5,1,20,2.857142857142857,1,0.0,0,0,0,0,4,10,0,5,1,0,20,1
1041,19591,I91CCtQfetYUPwkEXIvTFBP6tbrp1spN,fbPkOYLVPtPgIt0MxizjfFJov3JbHyAi,7,20,12,0,5,0,8,0,45,6.428571428571429,6,0.0,0,12,0,5,20,0,0,8,0,17,28,0
1042,19592,dl33BYrB63jF9H7InuQDxo3dQrVdjLGV,fbPkOYLVPtPgIt0MxizjfFJov3JbHyAi,7,3,2,0,2,0,4,0,11,1.5714285714285714,1,0.0,0,2,0,2,3,0,0,4,0,4,7,1
1043,19593,sYGG7Hl1IcaeWwJigpwVXXbQKD0HFEPn,fbPkOYLVPtPgIt0MxizjfFJov3JbHyAi,7,3,2,0,2,0,3,0,10,1.4285714285714286,1,0.0,0,2,0,2,3,0,0,3,0,4,6,1
1044,19595,b3ktGBnxedY4iAdFYIyjERgRCauTInkK,fbPkOYLVPtPgIt0MxizjfFJov3JbHyAi,12,30,13,2,8,48,17,2,120,17.142857142857142,3,0.0,10,13,2,8,20,48,0,17,2,33,87,1
1045,19597,wFWVvTUKN4Nj5vWrbX5PVi6EvLKq8sqa,fbPkOYLVPtPgIt0MxizjfFJov3JbHyAi,24,54,18,29,27,0,5,0,133,19.0,2,0.0,32,18,22,27,22,0,7,5,0,99,34,1
1046,19598,rUHwInfwrT2VCsoj7SngGENcoxIrK2aA,fbPkOYLVPtPgIt0MxizjfFJov3JbHyAi,26,83,24,40,23,97,28,7,302,43.142857142857146,5,0.0,48,24,31,23,35,97,9,28,7,126,176,1
1047,19599,QZNGHI9TocOuANx6bTOdMFrqzeb0fTw3,fbPkOYLVPtPgIt0MxizjfFJov3JbHyAi,1,0,0,0,0,0,1,0,1,0.14285714285714285,1,0.0,0,0,0,0,0,0,0,1,0,0,1,1
1048,19600,YCZ0HSNcZja1vuapbZTjyZlLagijA85V,fbPkOYLVPtPgIt0MxizjfFJov3JbHyAi,7,3,2,0,2,0,3,0,10,1.4285714285714286,1,0.0,0,2,0,2,3,0,0,3,0,4,6,1
1049,19601,gpUff0gJHSKcQDbNnT6UR6klN9yWn4B3,fbPkOYLVPtPgIt0MxizjfFJov3JbHyAi,17,27,12,12,10,1,7,0,69,9.857142857142858,2,0.0,8,12,9,10,19,1,3,7,0,39,30,1
1050,19602,cxXfR155NqvzoUrJxE0tct65N6OEUGW3,fbPkOYLVPtPgIt0MxizjfFJov3JbHyAi,2,0,0,0,0,0,3,0,3,0.42857142857142855,1,0.0,0,0,0,0,0,0,0,3,0,0,3,1
1051,19603,0VxsYnODhio1aXODkLqOGQB4NYdClGaT,fbPkOYLVPtPgIt0MxizjfFJov3JbHyAi,2,1,0,0,0,0,1,0,2,0.2857142857142857,1,0.0,0,0,0,0,1,0,0,1,0,0,2,1
1052,19604,1EQy9mKBCgbz8jG2K6f93LU9GKq65V9v,fbPkOYLVPtPgIt0MxizjfFJov3JbHyAi,7,3,1,0,2,0,3,0,9,1.2857142857142858,1,0.0,0,1,0,2,3,0,0,3,0,3,6,1
1053,19606,CLH6KVxeKfUu9lbHyFm5yc6Qf4HvLCyR,fbPkOYLVPtPgIt0MxizjfFJov3JbHyAi,2,0,0,0,0,0,8,0,8,1.1428571428571428,2,0.0,0,0,0,0,0,0,0,8,0,0,8,1
1054,19607,BCPOhUa2LrfH93ebCE15VbF0VEWEyi7T,fbPkOYLVPtPgIt0MxizjfFJov3JbHyAi,9,5,3,0,2,10,3,1,24,3.4285714285714284,1,0.0,0,3,0,2,5,10,0,3,1,5,19,1
1055,19609,hSrmLZQ0ouEuE46yYppuvpfSWmkaTAsV,fbPkOYLVPtPgIt0MxizjfFJov3JbHyAi,8,5,2,0,2,0,5,0,14,2.0,2,0.0,0,2,0,2,5,0,0,5,0,4,10,1
1056,19610,kLgTb4zs1DK0fasndFOTstbWViutnXRG,fbPkOYLVPtPgIt0MxizjfFJov3JbHyAi,17,37,18,11,12,3,17,2,100,14.285714285714286,3,0.0,11,18,9,12,26,3,2,17,2,50,50,1
1057,19611,jmpbNsd2zzToMH9HZWx8NTyZ25PfYydC,fbPkOYLVPtPgIt0MxizjfFJov3JbHyAi,10,8,5,0,4,7,5,0,29,4.142857142857143,2,0.0,0,5,0,4,8,7,0,5,0,9,20,1
1058,19612,XVNXZTDLYViPgXZBTcX5RWMvf5SNK18Y,fbPkOYLVPtPgIt0MxizjfFJov3JbHyAi,16,9,7,0,7,0,1,0,24,3.4285714285714284,1,0.0,0,7,0,7,9,0,0,1,0,14,10,1
1059,19615,y9ukbIQfB4L7zn5UoeGfcZjZUqTsQsJk,fbPkOYLVPtPgIt0MxizjfFJov3JbHyAi,6,3,2,0,2,3,1,0,11,1.5714285714285714,1,0.0,0,2,0,2,3,3,0,1,0,4,7,1
1060,19616,kyJzGSg3elXhPrIWM8rkZuAZv6RhnLQu,fbPkOYLVPtPgIt0MxizjfFJov3JbHyAi,19,49,32,0,15,69,11,2,178,25.428571428571427,5,0.0,0,32,0,15,49,69,0,11,2,47,131,1
1061,19617,FcPFK6OTsUF1j3uNGabdzGTvbY8kcO3D,fbPkOYLVPtPgIt0MxizjfFJov3JbHyAi,7,20,0,0,2,0,4,0,26,3.7142857142857144,2,0.0,4,0,0,2,16,0,0,4,0,6,20,1
1062,19620,wbbNGhodAmSlYSg7ZSWYtWMdb0rjLgRw,fbPkOYLVPtPgIt0MxizjfFJov3JbHyAi,13,13,7,2,5,8,6,0,41,5.857142857142857,2,0.0,1,7,2,5,12,8,0,6,0,15,26,1
1063,19621,P7cWTzqHbKs2w7IhW7Eb0IWuvmS7VHHm,fbPkOYLVPtPgIt0MxizjfFJov3JbHyAi,19,47,31,0,23,34,10,1,146,20.857142857142858,4,0.0,11,31,0,23,36,34,0,10,1,65,81,0
1064,19622,qGzhVjTxktnI3gvlHnV7uXSPz6cASHXn,fbPkOYLVPtPgIt0MxizjfFJov3JbHyAi,11,7,5,0,4,13,6,1,36,5.142857142857143,2,0.0,0,5,0,4,7,13,0,6,1,9,27,1
1065,19623,GDKy1KAMQHkxWaQDYOeRxnEA0ZpODsn0,fbPkOYLVPtPgIt0MxizjfFJov3JbHyAi,7,3,2,0,2,10,6,0,23,3.2857142857142856,2,0.0,0,2,0,2,3,10,0,6,0,4,19,1
1066,19624,2we3WxltFBT1dd0FjP3YZ8iHf2xpHEei,fbPkOYLVPtPgIt0MxizjfFJov3JbHyAi,6,8,3,0,4,7,2,0,24,3.4285714285714284,2,0.0,3,3,0,4,5,7,0,2,0,10,14,1
1067,19626,HnvxqugChFN5yjBU90JTvP996KYT36S0,fbPkOYLVPtPgIt0MxizjfFJov3JbHyAi,17,40,14,8,8,2,8,0,80,11.428571428571429,2,0.0,18,14,7,8,22,2,1,8,0,47,33,1
1068,19627,aNviqaUsa8tjM9b6nMwh7ketdx2tdX99,fbPkOYLVPtPgIt0MxizjfFJov3JbHyAi,1,0,0,0,0,0,1,0,1,0.14285714285714285,1,0.0,0,0,0,0,0,0,0,1,0,0,1,1
1069,19629,G0JgmTQ55TeK9aeblJVq6TYQNTXqJFIQ,fbPkOYLVPtPgIt0MxizjfFJov3JbHyAi,11,14,6,4,5,0,6,0,35,5.0,2,0.0,1,6,3,5,13,0,1,6,0,15,20,1
1070,19630,peOW1xVaKPULFrN5Gy7l1puUz8vUwyZz,fbPkOYLVPtPgIt0MxizjfFJov3JbHyAi,6,9,5,0,1,12,5,0,32,4.571428571428571,2,0.0,0,5,0,1,9,12,0,5,0,6,26,1
1071,19631,8skbDsuebvai4ARav7dTtpvek1eLVeds,fbPkOYLVPtPgIt0MxizjfFJov3JbHyAi,12,57,41,0,38,11,17,2,166,23.714285714285715,4,0.0,11,41,0,38,46,11,0,17,2,90,76,1
1072,19633,npX3FgekV8W61Z0uW836onGI4m2nQdnG,fbPkOYLVPtPgIt0MxizjfFJov3JbHyAi,4,2,1,0,1,3,1,0,8,1.1428571428571428,1,0.0,0,1,0,1,2,3,0,1,0,2,6,1
1073,19634,jX7tq2pnsDlar9WIdJmOwYa2kqXNP8p5,fbPkOYLVPtPgIt0MxizjfFJov3JbHyAi,26,36,15,23,16,22,18,6,136,19.428571428571427,2,0.0,17,15,19,16,19,22,4,18,6,67,69,1
1074,19636,cFawqBd5fJtkKlCTemtngl3kfpxBO2Oy,fbPkOYLVPtPgIt0MxizjfFJov3JbHyAi,9,15,7,0,6,12,6,1,47,6.714285714285714,3,0.0,4,7,0,6,11,12,0,6,1,17,30,1
1075,19638,VG5BsqnAudb2wrnNFKVoV7tORlRXExaE,fbPkOYLVPtPgIt0MxizjfFJov3JbHyAi,9,26,15,0,6,20,13,3,83,11.857142857142858,4,0.0,2,15,0,6,24,20,0,13,3,23,60,1
1076,19639,nHMKztqwQYqP5QiyWQSLf3rlpTKGeMZ7,fbPkOYLVPtPgIt0MxizjfFJov3JbHyAi,9,6,4,0,3,12,3,2,30,4.285714285714286,1,0.0,0,4,0,3,6,12,0,3,2,7,23,1
1077,19640,qvYnUocR0frsPd3kYwxIbvUGNPr9n1qt,fbPkOYLVPtPgIt0MxizjfFJov3JbHyAi,7,8,5,0,3,0,2,0,18,2.5714285714285716,2,0.0,0,5,0,3,8,0,0,2,0,8,10,1
1078,19641,GoCzFgZtKHP9v4b0WP4lIjCorcS7Jt3F,fbPkOYLVPtPgIt0MxizjfFJov3JbHyAi,23,52,25,15,17,4,7,0,120,17.142857142857142,4,0.0,18,25,12,17,34,4,3,7,0,72,48,1
1079,19642,kQ63n93d5CTXewyEhcoySFeLgYStuYpO,fbPkOYLVPtPgIt0MxizjfFJov3JbHyAi,7,6,4,0,3,0,2,0,15,2.142857142857143,2,0.0,0,4,0,3,6,0,0,2,0,7,8,1
1080,19643,7Wr2VTJWzRxZOKgdu9ZKFIXmTnCI9fnu,fbPkOYLVPtPgIt0MxizjfFJov3JbHyAi,23,72,21,20,16,0,7,0,136,19.428571428571427,2,0.0,35,21,16,16,37,0,4,7,0,88,48,1
1081,19644,No5ifG9v9VDpFVCY05CK70WSRGncERpv,fbPkOYLVPtPgIt0MxizjfFJov3JbHyAi,12,14,5,0,4,1,8,0,32,4.571428571428571,4,0.0,0,5,0,4,14,1,0,8,0,9,23,1
1082,19646,ggEr2STKTwtSSUdtGCmiPr3DBu3TJ34B,fbPkOYLVPtPgIt0MxizjfFJov3JbHyAi,12,14,10,0,7,21,2,0,54,7.714285714285714,1,0.0,0,10,0,7,14,21,0,2,0,17,37,1
1083,19648,wQAzZrNBkZu6TvNOv2yKxdbJtBBRTSuF,fbPkOYLVPtPgIt0MxizjfFJov3JbHyAi,6,6,1,0,1,11,5,0,24,3.4285714285714284,1,0.0,0,1,0,1,6,11,0,5,0,2,22,1
1084,19649,mbP9O9bSfibkETk00N09Osk4AH9tyOW9,fbPkOYLVPtPgIt0MxizjfFJov3JbHyAi,1,0,0,0,0,0,1,0,1,0.14285714285714285,1,0.0,0,0,0,0,0,0,0,1,0,0,1,1
1085,19650,9Q3q5ak3WAEiXRLChbacNd3Hje0Wa6sd,fbPkOYLVPtPgIt0MxizjfFJov3JbHyAi,16,57,22,18,17,49,15,1,179,25.571428571428573,3,0.0,15,22,12,17,42,49,6,15,1,66,113,1
1086,19654,5J6AhQDgqCTdGi4V2FLrPa1uynjLJqbR,fbPkOYLVPtPgIt0MxizjfFJov3JbHyAi,11,33,1,6,1,16,6,1,64,9.142857142857142,1,0.0,7,1,4,1,26,16,2,6,1,13,51,1
1087,19655,9e5dcfJQbPUU8sTcmzE9DWoDPOA9Nhu3,fbPkOYLVPtPgIt0MxizjfFJov3JbHyAi,5,4,1,0,1,0,1,0,7,1.0,1,0.0,0,1,0,1,4,0,0,1,0,2,5,1
1088,19656,gsUbcjiJXGVEzC0HsE7H7oNZQUP3vN7h,fbPkOYLVPtPgIt0MxizjfFJov3JbHyAi,14,27,19,0,11,30,14,2,103,14.714285714285714,3,0.0,0,19,0,11,27,30,0,14,2,30,73,1
1089,19657,RaBOiV7pbDCxFmg73km3gwoEkG637iTS,fbPkOYLVPtPgIt0MxizjfFJov3JbHyAi,7,3,2,0,2,0,3,0,10,1.4285714285714286,1,0.0,0,2,0,2,3,0,0,3,0,4,6,1
1090,19658,zTv4QKAduCCJ5yquHsz6UKPKumHF7znP,fbPkOYLVPtPgIt0MxizjfFJov3JbHyAi,10,14,9,0,4,0,4,0,31,4.428571428571429,2,0.0,1,9,0,4,13,0,0,4,0,14,17,1
1091,19659,p8vHkfo5SI0V6B4KROfqrnRCgCCEpojM,fbPkOYLVPtPgIt0MxizjfFJov3JbHyAi,16,35,8,14,10,18,8,0,93,13.285714285714286,2,0.0,21,8,10,10,14,18,4,8,0,49,44,1
1092,19660,Fdf5W8Lu9p3zXrwWlt1EPTxeAnJSyNEE,fbPkOYLVPtPgIt0MxizjfFJov3JbHyAi,8,3,2,0,2,2,4,0,13,1.8571428571428572,1,0.0,0,2,0,2,3,2,0,4,0,4,9,1
1093,19661,yJPR0OidzPKNg5Rj1FfQqqXJqCl4r5z8,fbPkOYLVPtPgIt0MxizjfFJov3JbHyAi,1,0,0,0,0,0,1,0,1,0.14285714285714285,1,0.0,0,0,0,0,0,0,0,1,0,0,1,1
1094,19665,NlHO5hXiy7TmVTHiRgExH6y7p9gJG1YF,fbPkOYLVPtPgIt0MxizjfFJov3JbHyAi,5,4,1,0,1,0,1,0,7,1.0,1,0.0,0,1,0,1,4,0,0,1,0,2,5,1
1095,19667,U04y5vFf0AfyJVGIOJHlryTyRQEOm5pT,fbPkOYLVPtPgIt0MxizjfFJov3JbHyAi,12,21,13,0,5,13,9,1,62,8.857142857142858,3,0.0,0,13,0,5,21,13,0,9,1,18,44,1
1096,19668,Xh98I3V3ah7C40wUQRlxQZnzp2hUFzZ9,fbPkOYLVPtPgIt0MxizjfFJov3JbHyAi,7,6,4,0,3,0,2,0,15,2.142857142857143,3,0.0,0,4,0,3,6,0,0,2,0,7,8,1
1097,19671,m38kM2O7Y9dS9qRyh326gVCH42EwGlbN,fbPkOYLVPtPgIt0MxizjfFJov3JbHyAi,6,5,2,0,3,12,2,0,24,3.4285714285714284,1,0.0,2,2,0,3,3,12,0,2,0,7,17,1
1098,19674,ohSArIWJFOjWcw1iipOBHaELVY4dEsuk,fbPkOYLVPtPgIt0MxizjfFJov3JbHyAi,14,15,6,0,4,4,5,0,34,4.857142857142857,1,0.0,0,6,0,4,15,4,0,5,0,10,24,1
1099,19675,2H6KbsPWrpdsyjI0g4q0nnMN85W6it1n,fbPkOYLVPtPgIt0MxizjfFJov3JbHyAi,1,0,0,0,0,0,1,0,1,0.14285714285714285,1,0.0,0,0,0,0,0,0,0,1,0,0,1,1
1100,19678,5zeXp1xbv4d96w4nRSFAsiN01xqmo82u,fbPkOYLVPtPgIt0MxizjfFJov3JbHyAi,2,0,0,0,0,0,7,0,7,1.0,1,0.0,0,0,0,0,0,0,0,7,0,0,7,1
1101,19679,onkD63zW36qWueM4FnIhDEFep4J6xaTB,fbPkOYLVPtPgIt0MxizjfFJov3JbHyAi,2,0,0,0,0,0,7,0,7,1.0,1,0.0,0,0,0,0,0,0,0,7,0,0,7,1
1102,19685,vh8VMxJwpHETuDx8mTcywtcFmJ5lOlZy,fbPkOYLVPtPgIt0MxizjfFJov3JbHyAi,4,3,2,0,2,0,1,0,8,1.1428571428571428,1,0.0,0,2,0,2,3,0,0,1,0,4,4,0
1103,19687,jh0D2keICXHjZlE8o0iWfTU4GtogK2iV,fbPkOYLVPtPgIt0MxizjfFJov3JbHyAi,11,13,6,0,6,10,3,0,38,5.428571428571429,2,0.0,2,6,0,6,11,10,0,3,0,14,24,1
1104,19689,PwY3L0IvWcNAAWE8QgIO3juuVesQg6xr,fbPkOYLVPtPgIt0MxizjfFJov3JbHyAi,6,5,3,0,1,7,4,0,20,2.857142857142857,2,0.0,0,3,0,1,5,7,0,4,0,4,16,1
1105,19690,YNemkS5dqknHOwehYprPYVkMaqYUO4yA,fbPkOYLVPtPgIt0MxizjfFJov3JbHyAi,5,3,1,0,1,1,1,0,7,1.0,1,0.0,0,1,0,1,3,1,0,1,0,2,5,1
1106,19692,KkdnagFJtwwq5n9Iuy7rnQaTqa2llFa9,fbPkOYLVPtPgIt0MxizjfFJov3JbHyAi,25,43,18,9,16,22,16,0,124,17.714285714285715,4,0.0,19,18,9,16,24,22,0,16,0,62,62,1
1107,19693,OWBUV30zEQH7Jt1VRLKmraf0vAFBacfv,fbPkOYLVPtPgIt0MxizjfFJov3JbHyAi,9,11,5,0,4,11,12,0,43,6.142857142857143,2,0.0,3,5,0,4,8,11,0,12,0,12,31,1
1108,19694,4GJSwwikGuUWXSajcKoSlvfsoiC8eEZq,fbPkOYLVPtPgIt0MxizjfFJov3JbHyAi,6,7,2,0,1,0,2,0,12,1.7142857142857142,1,0.0,0,2,0,1,7,0,0,2,0,3,9,1
1109,19695,3SP9iNDvUt8m67ZMqC5DpQRe6ekkTpsP,fbPkOYLVPtPgIt0MxizjfFJov3JbHyAi,10,7,4,0,2,5,7,1,26,3.7142857142857144,2,0.0,0,4,0,2,7,5,0,7,1,6,20,0
1110,19696,wE17RsVOxdHL75rwI5QafkkqcL3REji3,fbPkOYLVPtPgIt0MxizjfFJov3JbHyAi,4,2,1,0,1,0,1,0,5,0.7142857142857143,1,0.0,0,1,0,1,2,0,0,1,0,2,3,1
1111,19698,vTwbvGW3E1IdqF0HV32uMMc0gGolPCvf,fbPkOYLVPtPgIt0MxizjfFJov3JbHyAi,8,21,12,5,10,5,3,0,56,8.0,2,0.0,4,12,4,10,17,5,1,3,0,30,26,1
1112,19699,ZQS70X3Ksth8gmZtwesyaYzrxIBfpjcf,fbPkOYLVPtPgIt0MxizjfFJov3JbHyAi,10,24,9,2,4,17,6,0,62,8.857142857142858,2,0.0,10,9,2,4,14,17,0,6,0,25,37,1
1113,19701,Zw1bdKbgaMzUzlqlieQSaucEQ8wggZlx,fbPkOYLVPtPgIt0MxizjfFJov3JbHyAi,4,2,1,0,1,0,2,0,6,0.8571428571428571,1,0.0,0,1,0,1,2,0,0,2,0,2,4,0
1114,19702,p4yxCxiqzIMRoAwoOyGnN7P9RZxypnFm,fbPkOYLVPtPgIt0MxizjfFJov3JbHyAi,9,9,8,0,6,0,1,0,24,3.4285714285714284,3,0.0,0,8,0,6,9,0,0,1,0,14,10,1
1115,19705,nbIGolByJC5FPssjDvcKL2vGL3vYMGAq,fbPkOYLVPtPgIt0MxizjfFJov3JbHyAi,26,70,33,20,24,50,25,4,226,32.285714285714285,4,0.0,17,33,16,24,53,50,4,25,4,90,136,0
1116,19708,6U0gCtH3epdLuuj59LGYbTzqvsPQ3DiY,fbPkOYLVPtPgIt0MxizjfFJov3JbHyAi,6,5,3,0,2,0,3,0,13,1.8571428571428572,1,0.0,0,3,0,2,5,0,0,3,0,5,8,1
1117,19709,uMtCQ7Qbv3rm9GwFXfsL1kyH8D7nIalM,fbPkOYLVPtPgIt0MxizjfFJov3JbHyAi,6,19,1,0,0,8,5,0,33,4.714285714285714,2,0.0,2,1,0,0,17,8,0,5,0,3,30,0
1118,19713,IxqtjkNiph0SiGkmwfaH729SQtK50jPu,fbPkOYLVPtPgIt0MxizjfFJov3JbHyAi,7,3,0,0,0,14,7,1,25,3.5714285714285716,1,0.0,0,0,0,0,3,14,0,7,1,0,25,1
1119,19714,uuyAyzBNPZJSqNkYTwX3ItAQ7Xcq5lqK,fbPkOYLVPtPgIt0MxizjfFJov3JbHyAi,3,2,1,0,0,13,2,0,18,2.5714285714285716,2,0.0,0,1,0,0,2,13,0,2,0,1,17,1
1120,19715,bGUkoSiHaU85ol0k2itTO3o20n3CqprE,fbPkOYLVPtPgIt0MxizjfFJov3JbHyAi,6,3,2,0,2,0,1,0,8,1.1428571428571428,1,0.0,0,2,0,2,3,0,0,1,0,4,4,1
1121,19719,gl2YVlebVAvCcxsYaIoTwLj5l1IGqntH,fbPkOYLVPtPgIt0MxizjfFJov3JbHyAi,10,9,5,0,2,3,5,1,25,3.5714285714285716,2,0.0,1,5,0,2,8,3,0,5,1,8,17,1
1122,19720,VgTzrg40YN89iMQMYp8DL2dsBQiMtIfa,fbPkOYLVPtPgIt0MxizjfFJov3JbHyAi,1,0,0,0,0,0,1,0,1,0.14285714285714285,1,0.0,0,0,0,0,0,0,0,1,0,0,1,1
1123,19721,cAjVoc8wOYDE8lScDAhEgvHdzkmg6Oh2,fbPkOYLVPtPgIt0MxizjfFJov3JbHyAi,10,11,8,0,3,0,11,0,33,4.714285714285714,3,0.0,0,8,0,3,11,0,0,11,0,11,22,1
1124,19722,YchS7FPUUCrsbeC0RlrXHuAg4O0pgdnY,fbPkOYLVPtPgIt0MxizjfFJov3JbHyAi,7,12,8,0,5,0,3,0,28,4.0,3,0.0,0,8,0,5,12,0,0,3,0,13,15,1
1125,19723,jWMVSdUkBIApMFEIB4X88BTUfxnffWAx,fbPkOYLVPtPgIt0MxizjfFJov3JbHyAi,30,29,23,0,18,0,8,0,78,11.142857142857142,2,0.0,0,23,0,18,29,0,0,8,0,41,37,1
1126,19726,LhzU5apxkgFguqzaBs2la7gJhoIHnun9,fbPkOYLVPtPgIt0MxizjfFJov3JbHyAi,2,0,0,0,0,0,2,0,2,0.2857142857142857,1,0.0,0,0,0,0,0,0,0,2,0,0,2,1
1127,19730,nIvIddlMAmTQagaACOulbZ6PInxlyOy2,fbPkOYLVPtPgIt0MxizjfFJov3JbHyAi,24,24,7,20,10,0,3,1,65,9.285714285714286,2,0.0,14,7,19,10,10,0,1,3,1,50,15,0
1128,19731,RLvJ5u6m28hhUO44ztK3P01H4ZTIxGoD,fbPkOYLVPtPgIt0MxizjfFJov3JbHyAi,4,2,1,0,1,0,1,0,5,0.7142857142857143,1,0.0,0,1,0,1,2,0,0,1,0,2,3,1
1129,19732,z0Q6ONK9gZ6rOpbD6TitX6FkYPuixcug,fbPkOYLVPtPgIt0MxizjfFJov3JbHyAi,1,0,0,0,0,0,1,0,1,0.14285714285714285,1,0.0,0,0,0,0,0,0,0,1,0,0,1,1
1130,19742,c2xUxg7vuhPItQZr96ojei2FNm4xg1X0,fbPkOYLVPtPgIt0MxizjfFJov3JbHyAi,11,13,7,1,7,9,5,0,42,6.0,1,0.0,4,7,1,7,9,9,0,5,0,19,23,1
1131,19748,P9CRp0z2n5HfPA3EY25pk86UB1hpP0VE,fbPkOYLVPtPgIt0MxizjfFJov3JbHyAi,3,2,1,0,0,0,2,0,5,0.7142857142857143,1,0.0,0,1,0,0,2,0,0,2,0,1,4,1
1132,19753,4xhrCYKdzHUQrqW9iIr0KOeWujKeYIus,fbPkOYLVPtPgIt0MxizjfFJov3JbHyAi,6,5,1,0,1,0,4,0,11,1.5714285714285714,1,0.0,0,1,0,1,5,0,0,4,0,2,9,1
1133,19757,hbUthRcRktel8CTk5FJE2GFw0tsGaPJX,fbPkOYLVPtPgIt0MxizjfFJov3JbHyAi,9,4,3,0,3,0,3,0,13,1.8571428571428572,2,0.0,0,3,0,3,4,0,0,3,0,6,7,1
1134,19762,haOtWLq8R5iBRxrylu7qsQb4IXuRIQaN,fbPkOYLVPtPgIt0MxizjfFJov3JbHyAi,6,7,4,0,0,3,5,3,22,3.142857142857143,1,0.0,0,4,0,0,7,3,0,5,3,4,18,1
1135,19767,GKKNtfrAHKD2xUEQBz7HLN3kKO9SrWyD,fbPkOYLVPtPgIt0MxizjfFJov3JbHyAi,18,45,24,14,6,13,20,3,125,17.857142857142858,4,0.0,9,24,10,6,36,13,4,20,3,49,76,1
1136,19769,bgBhXSh8X6pD8mAGuk3zRCZBNqTSqnHJ,fbPkOYLVPtPgIt0MxizjfFJov3JbHyAi,6,7,5,0,4,5,2,0,23,3.2857142857142856,1,0.0,1,5,0,4,6,5,0,2,0,10,13,1
1137,19776,CfeENerIdAGepleePWSt0SV88ctt0Tmw,fbPkOYLVPtPgIt0MxizjfFJov3JbHyAi,7,4,2,0,2,0,2,0,10,1.4285714285714286,2,0.0,0,2,0,2,4,0,0,2,0,4,6,1
1138,19781,Jv08t8fpcawyaZCw9f0bMJgjS8SuUKfb,fbPkOYLVPtPgIt0MxizjfFJov3JbHyAi,5,3,2,0,1,0,2,0,8,1.1428571428571428,1,0.0,0,2,0,1,3,0,0,2,0,3,5,1
1139,19783,LzhmzME7EkyHXpFVu0EENS6JHqvsJLtH,fbPkOYLVPtPgIt0MxizjfFJov3JbHyAi,5,2,1,0,1,3,2,0,9,1.2857142857142858,1,0.0,0,1,0,1,2,3,0,2,0,2,7,1
1140,19790,9v5FBlkT08VgqPArpwPYDVOHzgkK8DmA,fbPkOYLVPtPgIt0MxizjfFJov3JbHyAi,4,5,3,0,0,0,2,0,10,1.4285714285714286,2,0.0,0,3,0,0,5,0,0,2,0,3,7,1
1141,19794,i2J6g1YHP6evnvsQatEoUV6Lz662N8Pt,fbPkOYLVPtPgIt0MxizjfFJov3JbHyAi,8,6,4,0,3,6,3,0,22,3.142857142857143,2,0.0,0,4,0,3,6,6,0,3,0,7,15,1
1142,19814,lxHUxupmVUuN6U299GOAnBvW4C4Ubp0H,fbPkOYLVPtPgIt0MxizjfFJov3JbHyAi,6,3,1,0,1,0,3,0,8,1.1428571428571428,2,0.0,0,1,0,1,3,0,0,3,0,2,6,1
1143,19842,bKIU4h5S6pxVBBvQYicGGZljVmGThQTZ,fbPkOYLVPtPgIt0MxizjfFJov3JbHyAi,10,12,5,0,4,5,9,1,36,5.142857142857143,2,0.0,3,5,0,4,9,5,0,9,1,12,24,1
1144,19852,4qaBwsaC0pfXg0219Ny01dop8gTlFMu6,fbPkOYLVPtPgIt0MxizjfFJov3JbHyAi,5,2,1,0,1,0,2,0,6,0.8571428571428571,1,0.0,0,1,0,1,2,0,0,2,0,2,4,1
1145,19855,hr3tXA8jmCXsxdUFfi43JuiRTUpoDlMt,fbPkOYLVPtPgIt0MxizjfFJov3JbHyAi,1,0,0,0,0,0,1,0,1,0.14285714285714285,1,0.0,0,0,0,0,0,0,0,1,0,0,1,0
1146,19857,oB66Su2y0fKCmlftIiys81THD7pT5Kwq,fbPkOYLVPtPgIt0MxizjfFJov3JbHyAi,4,2,1,0,1,0,1,0,5,0.7142857142857143,1,0.0,0,1,0,1,2,0,0,1,0,2,3,1
1147,19879,1foSXZwCCr5lR9Aws6pCnQ1ZUbu5TIHp,fbPkOYLVPtPgIt0MxizjfFJov3JbHyAi,4,3,1,0,1,0,1,0,6,0.8571428571428571,1,0.0,0,1,0,1,3,0,0,1,0,2,4,0
1148,19884,NqKjMSY6eOZQ1uSyzlPrquJVqzjvSO7O,fbPkOYLVPtPgIt0MxizjfFJov3JbHyAi,14,19,11,0,9,12,3,0,54,7.714285714285714,2,0.0,0,11,0,9,19,12,0,3,0,20,34,1
1149,19893,NAeglY8cYFpzQKpSfjAgfrtdD2qzmpB5,fbPkOYLVPtPgIt0MxizjfFJov3JbHyAi,10,12,3,0,4,14,8,0,41,5.857142857142857,2,0.0,2,3,0,4,10,14,0,8,0,9,32,0
1150,19926,1InE8cdjhx7tJRBfUjLOpNXVGiOXTrtd,fbPkOYLVPtPgIt0MxizjfFJov3JbHyAi,5,11,0,0,0,6,6,0,23,3.2857142857142856,2,0.0,0,0,0,0,11,6,0,6,0,0,23,1
1151,19933,wnXrCFQnu5K77E0TUKHPXLbEZiXu32Gt,fbPkOYLVPtPgIt0MxizjfFJov3JbHyAi,5,2,1,0,1,0,3,0,7,1.0,1,0.0,0,1,0,1,2,0,0,3,0,2,5,1
1152,19934,GyWTABuPpZEqO585EnNTIpM2B2faPYN3,fbPkOYLVPtPgIt0MxizjfFJov3JbHyAi,5,2,1,0,1,0,2,0,6,0.8571428571428571,2,0.0,0,1,0,1,2,0,0,2,0,2,4,1
1153,19935,wEajQeQse5CzhcFd5XXOtEsUUddZZAU5,fbPkOYLVPtPgIt0MxizjfFJov3JbHyAi,1,0,0,0,0,0,1,0,1,0.14285714285714285,1,0.0,0,0,0,0,0,0,0,1,0,0,1,0
1154,19936,viuKt4GgrX0rYL5EpHoxJbsiC9TblSuk,fbPkOYLVPtPgIt0MxizjfFJov3JbHyAi,21,56,30,1,18,48,30,0,183,26.142857142857142,4,0.0,10,30,1,18,46,48,0,30,0,59,124,0
1155,19942,je9A6l6tP7wnbFhNJD7vbbHTYhqshuqB,fbPkOYLVPtPgIt0MxizjfFJov3JbHyAi,13,27,9,5,10,4,7,0,62,8.857142857142858,2,0.0,9,9,3,10,18,4,2,7,0,31,31,1
1156,19949,lulY8D00ct0beDGYE4CRU9KsINnQRaV8,fbPkOYLVPtPgIt0MxizjfFJov3JbHyAi,12,20,10,0,3,0,6,1,40,5.714285714285714,2,0.0,1,10,0,3,19,0,0,6,1,14,26,0
1157,19955,Y7REnesylqzkGeCcXJqxiJ4B25LlDJnj,fbPkOYLVPtPgIt0MxizjfFJov3JbHyAi,1,0,0,0,0,0,2,0,2,0.2857142857142857,1,0.0,0,0,0,0,0,0,0,2,0,0,2,1
1158,21459,NH0hsgo5xcqAdosarQoW4RQUZxH32Gzl,7GRhBDsirIGkRZBtSMEzNTyDr2JQm4xx,10,23,11,2,3,1,7,0,47,6.714285714285714,2,0.0,1,11,2,3,22,1,0,7,0,17,30,0
1159,21468,Hj6wuu6IJzCenxWAs1sLyWNMm32YIpDq,7GRhBDsirIGkRZBtSMEzNTyDr2JQm4xx,26,81,42,33,17,15,18,0,206,29.428571428571427,5,0.0,13,42,27,17,68,15,6,18,0,99,107,0
1160,21473,fd2e5NJVnyVwHFHuiTOOM639ZY1uThtn,7GRhBDsirIGkRZBtSMEzNTyDr2JQm4xx,15,50,18,12,5,8,15,2,110,15.714285714285714,3,0.0,21,18,9,5,29,8,3,15,2,53,57,1
1161,21485,l3mz2aAslwaCLhkdMrM7sQ5OXLzl6A2r,7GRhBDsirIGkRZBtSMEzNTyDr2JQm4xx,17,12,1,41,1,8,8,1,72,10.285714285714286,1,0.0,6,1,37,1,6,8,4,8,1,45,27,0
1162,21497,NToJOpRtq67cszdyzl1RlLKqGwS5lZl5,7GRhBDsirIGkRZBtSMEzNTyDr2JQm4xx,29,32,8,62,11,0,3,0,116,16.571428571428573,1,0.0,23,8,52,11,9,0,10,3,0,94,22,1
1163,21514,ZhTCqX8GMUcn0a0betuEauHNuCk1aRhm,7GRhBDsirIGkRZBtSMEzNTyDr2JQm4xx,31,47,17,32,9,51,15,0,171,24.428571428571427,4,0.0,18,17,29,9,29,51,3,15,0,73,98,0
1164,21518,j5n34dhJSAsFAv6KAw4rsAZTfhL07lCD,7GRhBDsirIGkRZBtSMEzNTyDr2JQm4xx,2,0,0,0,0,0,2,0,2,0.2857142857142857,1,0.0,0,0,0,0,0,0,0,2,0,0,2,1
1165,21529,Lf0mThPYOrtlCzgRGBCVTPy1hiGUII8h,7GRhBDsirIGkRZBtSMEzNTyDr2JQm4xx,43,337,104,81,24,70,51,17,684,97.71428571428571,6,0.0,188,104,56,24,149,70,25,51,17,372,312,0
1166,21531,GvY4Z1NOjK4oYpeBStbrl7zpe2zlFqoT,7GRhBDsirIGkRZBtSMEzNTyDr2JQm4xx,21,20,9,28,9,3,2,0,71,10.142857142857142,2,0.0,9,9,23,9,11,3,5,2,0,50,21,0
1167,21545,be7952wawx5BhhJ4vIqX6Vxi48lNKbM1,7GRhBDsirIGkRZBtSMEzNTyDr2JQm4xx,5,9,6,0,6,2,5,0,28,4.0,5,0.0,0,6,0,6,9,2,0,5,0,12,16,1
1168,21558,dQBjOw3ZDQ2EPHOdT4W6pRAoF6sniGIc,7GRhBDsirIGkRZBtSMEzNTyDr2JQm4xx,10,6,4,0,3,2,7,0,22,3.142857142857143,2,0.0,0,4,0,3,6,2,0,7,0,7,15,1
1169,21561,OaI9ma7KxaY6DFxSwgYhrXCPXva2T3pp,7GRhBDsirIGkRZBtSMEzNTyDr2JQm4xx,4,5,1,0,0,1,5,0,12,1.7142857142857142,1,0.0,0,1,0,0,5,1,0,5,0,1,11,0
1170,21570,y9BxmAhm0ieCF6b0HaF7gMrGu5BDtZs5,7GRhBDsirIGkRZBtSMEzNTyDr2JQm4xx,10,9,3,0,3,0,14,0,29,4.142857142857143,1,0.0,2,3,0,3,7,0,0,14,0,8,21,0
1171,21618,TzODuX5kuf2iqGNG9vk0uMzeGNqx5LsA,7GRhBDsirIGkRZBtSMEzNTyDr2JQm4xx,4,2,0,0,0,0,2,0,4,0.5714285714285714,1,0.0,0,0,0,0,2,0,0,2,0,0,4,0
1172,21638,mwc0YjZS72xD4dO6Zk7KmFewdh7PWkAS,7GRhBDsirIGkRZBtSMEzNTyDr2JQm4xx,30,50,14,44,10,7,7,0,132,18.857142857142858,4,0.0,29,14,42,10,21,7,2,7,0,95,37,0
1173,21659,D5mwgoAPtfwdsFrdNADBqEJQSy8E0CUi,7GRhBDsirIGkRZBtSMEzNTyDr2JQm4xx,36,89,48,36,12,22,48,2,257,36.714285714285715,6,0.0,16,48,35,12,73,22,1,48,2,111,146,0
1174,21672,c9jABEJQla4i8vH29nKPFM4cx5bWdrLS,7GRhBDsirIGkRZBtSMEzNTyDr2JQm4xx,10,8,2,0,1,0,10,1,22,3.142857142857143,2,0.0,0,2,0,1,8,0,0,10,1,3,19,0
1175,21692,rf43ZHojMqXQ775bmX3nnHgQ62d9XvGK,7GRhBDsirIGkRZBtSMEzNTyDr2JQm4xx,9,7,2,11,2,0,12,0,34,4.857142857142857,5,0.0,2,2,9,2,5,0,2,12,0,15,19,1
1176,21708,aU6SEeOgxLKetBRDwfHMDunWavvfr54M,7GRhBDsirIGkRZBtSMEzNTyDr2JQm4xx,25,62,1,36,3,5,8,0,115,16.428571428571427,3,0.0,28,1,32,3,34,5,4,8,0,64,51,0
1177,21816,5M2ejSoYrgCHrezYAGX7ObuTLuLA6uzQ,7GRhBDsirIGkRZBtSMEzNTyDr2JQm4xx,4,2,1,0,1,0,1,0,5,0.7142857142857143,1,0.0,0,1,0,1,2,0,0,1,0,2,3,1
1178,21976,MYCZGZUUB6h2kR5SWwXC3erQhe8wj439,7GRhBDsirIGkRZBtSMEzNTyDr2JQm4xx,29,46,21,30,11,14,10,0,132,18.857142857142858,5,0.0,17,21,30,11,29,14,0,10,0,79,53,0
1179,22022,wXFfHtwd9smrvhh9NQW7SmEEo1001LDW,7GRhBDsirIGkRZBtSMEzNTyDr2JQm4xx,30,32,12,34,8,11,7,1,105,15.0,2,0.0,16,12,29,8,16,11,5,7,1,65,40,1
1180,22212,ezzV2inIlk654APZ7lOJdt6ubCpUxMCa,7GRhBDsirIGkRZBtSMEzNTyDr2JQm4xx,34,59,22,54,15,64,17,3,234,33.42857142857143,4,0.0,28,22,46,15,31,64,8,17,3,111,123,0
1181,22640,SXQudUQxotVyHX3jIj58IdonMUWj4z4L,RXDvfPUBYFlVdlueBFbLW0mhhAyGEqpt,9,5,3,0,2,0,2,0,12,1.7142857142857142,1,0.0,0,3,0,2,5,0,0,2,0,5,7,0
1182,22647,ytmo5vQStkDdkr7G8Cx66kM5tANiVYa8,G8EPVSXsOYB5YQWZGiz1aVq5Pgr2GrQu,13,16,10,0,6,0,7,0,39,5.571428571428571,2,0.0,2,10,0,6,14,0,0,7,0,18,21,1
1183,22651,bPMM8JJVMbo3dHwzrkYwNanOXVlVjIZM,SpATywNh6bZuzm8s1ceuBUnMUAeoAHHw,11,22,16,0,11,0,4,0,53,7.571428571428571,4,0.0,2,16,0,11,20,0,0,4,0,29,24,0
1184,22656,6r68uLeYBa0U5j97XGrLINpoFwwpiU0a,SpATywNh6bZuzm8s1ceuBUnMUAeoAHHw,11,34,5,0,3,1,8,0,51,7.285714285714286,3,0.0,2,5,0,3,32,1,0,8,0,10,41,0
1185,22658,3SER276qaao5TSZqnt0y9TkdmkGTUUcO,A3fsA9Zfv1X2fVEQhTw51lKENdNrEqT3,4,2,1,0,1,0,1,0,5,0.7142857142857143,1,0.0,0,1,0,1,2,0,0,1,0,2,3,1
1186,22699,f7tZxTkA0B7yOxMWeydGO2hW0y86mAhD,A3fsA9Zfv1X2fVEQhTw51lKENdNrEqT3,30,50,0,38,0,1,7,1,97,13.857142857142858,3,0.0,4,0,37,0,46,1,1,7,1,41,56,0
1187,22706,JoQg2qlyTB6aPyv163qnZSLUAy3J9zXZ,A3fsA9Zfv1X2fVEQhTw51lKENdNrEqT3,3,2,1,0,0,0,1,0,4,0.5714285714285714,1,0.0,0,1,0,0,2,0,0,1,0,1,3,1
1188,22733,IQ4ladQoM2x2909mlbY9xWKwXIcK6uEd,A3fsA9Zfv1X2fVEQhTw51lKENdNrEqT3,42,19,16,60,13,1,18,1,128,18.285714285714285,2,0.0,2,16,55,13,17,1,5,18,1,86,42,0
1189,22737,Os09VRrdiO6C7gqaf1B7u0gzmL7FIPJg,SpATywNh6bZuzm8s1ceuBUnMUAeoAHHw,13,32,7,17,0,17,9,1,83,11.857142857142858,2,0.0,23,7,14,0,9,17,3,9,1,44,39,1
1190,22760,xQ0oPcnoBqnptb23qNnWO05KL2jCqFC5,SpATywNh6bZuzm8s1ceuBUnMUAeoAHHw,2,0,0,0,0,1,4,0,5,0.7142857142857143,1,0.0,0,0,0,0,0,1,0,4,0,0,5,1
1191,22867,ec87BaRQsrP5IAuQEXYeAFWoVPURyRtj,SpATywNh6bZuzm8s1ceuBUnMUAeoAHHw,16,29,1,17,1,4,9,1,62,8.857142857142858,1,0.0,11,1,15,1,18,4,2,9,1,28,34,0
1192,22882,53VGMeycKD8ekdZB7srikqwK1dcTbnwu,bWdj2GDclj5ofokWjzoa5jAwMkxCykd6,15,29,8,42,10,0,6,0,95,13.571428571428571,3,0.0,17,8,36,10,12,0,6,6,0,71,24,1
1193,22889,VXeEmbu1PPBvvH7wFjnGFaE2yqIFKByx,G8EPVSXsOYB5YQWZGiz1aVq5Pgr2GrQu,13,11,1,0,1,1,8,0,22,3.142857142857143,2,0.0,0,1,0,1,11,1,0,8,0,2,20,1
1194,22891,tnLfm9tutF6YoqDXNIONCmii1aynBy80,SpATywNh6bZuzm8s1ceuBUnMUAeoAHHw,15,32,15,14,4,1,10,0,76,10.857142857142858,2,0.0,3,15,11,4,29,1,3,10,0,33,43,0
1195,22896,kwtDMW6kCF4Dj4cVANDmT2RtqpyiMQZT,A3fsA9Zfv1X2fVEQhTw51lKENdNrEqT3,43,34,20,51,14,0,11,0,130,18.571428571428573,3,0.0,1,20,45,14,33,0,6,11,0,80,50,0
1196,22909,za2dBkPPLD9IPRBjooK7GJit2ulI5UgN,SpATywNh6bZuzm8s1ceuBUnMUAeoAHHw,11,5,2,25,1,4,5,0,42,6.0,2,0.0,2,2,21,1,3,4,4,5,0,26,16,0
1197,22960,G7eyYYWDjRzjfvQepcwnefZtLIHlQINA,SpATywNh6bZuzm8s1ceuBUnMUAeoAHHw,15,31,10,23,0,11,16,1,92,13.142857142857142,5,0.0,14,10,19,0,17,11,4,16,1,43,49,1
1198,22962,M6VmJD8JYDR5w6GV5uzAgWpIXM5eanml,G8EPVSXsOYB5YQWZGiz1aVq5Pgr2GrQu,46,80,29,74,11,22,18,0,234,33.42857142857143,4,0.0,31,29,50,11,49,22,24,18,0,121,113,0
1199,22969,dT92IjRcuruPiAlpqVUTtu3wNL9IIegT,A3fsA9Zfv1X2fVEQhTw51lKENdNrEqT3,23,30,13,0,9,0,7,0,59,8.428571428571429,2,0.0,2,13,0,9,28,0,0,7,0,24,35,1
1200,22970,dT92IjRcuruPiAlpqVUTtu3wNL9IIegT,bWdj2GDclj5ofokWjzoa5jAwMkxCykd6,19,40,16,60,7,25,13,0,161,23.0,2,0.0,4,16,55,7,36,25,5,13,0,82,79,1
1201,22988,mYyzW7j4oHjgvbS0hfWvmpiecRMbZDgq,SpATywNh6bZuzm8s1ceuBUnMUAeoAHHw,8,8,5,0,2,4,6,0,25,3.5714285714285716,2,0.0,0,5,0,2,8,4,0,6,0,7,18,1
1202,22996,W9f8UmYzSEsFhECsZDg6FwyOA22yb0R3,SpATywNh6bZuzm8s1ceuBUnMUAeoAHHw,17,53,14,19,5,210,39,6,346,49.42857142857143,5,0.0,32,14,17,5,21,210,2,39,6,68,278,0
1203,23006,UInMBEH8f1h2vxXVslRsWyLOTv8ggYq3,A3fsA9Zfv1X2fVEQhTw51lKENdNrEqT3,44,61,30,82,9,58,17,1,258,36.857142857142854,3,0.0,6,30,64,9,55,58,18,17,1,109,149,1
1204,23014,UInMBEH8f1h2vxXVslRsWyLOTv8ggYq3,bWdj2GDclj5ofokWjzoa5jAwMkxCykd6,19,25,11,122,3,18,12,2,193,27.571428571428573,2,0.0,3,11,115,3,22,18,7,12,2,132,61,0
1205,23049,I2ghGumCKIaVsnJOGZA0xyJzTnEm5KtW,SpATywNh6bZuzm8s1ceuBUnMUAeoAHHw,14,11,7,5,3,19,3,0,48,6.857142857142857,2,0.0,2,7,4,3,9,19,1,3,0,16,32,1
1206,23054,aOK5wIKpKN9ikUy2a1FUGeQDEt1AAFa3,G8EPVSXsOYB5YQWZGiz1aVq5Pgr2GrQu,31,41,28,0,13,11,28,1,122,17.428571428571427,4,0.0,0,28,0,13,41,11,0,28,1,41,81,1
1207,23058,Dp9gZlmwGRMU0Crlqtgk7QHM4JW7fsY6,SpATywNh6bZuzm8s1ceuBUnMUAeoAHHw,14,22,6,16,5,0,5,0,54,7.714285714285714,1,0.0,5,6,13,5,17,0,3,5,0,29,25,0
1208,23084,mjoKY29bSBUSIg1iJCO4z3ZZIabGnClW,SpATywNh6bZuzm8s1ceuBUnMUAeoAHHw,14,26,13,15,4,14,15,0,87,12.428571428571429,4,0.0,4,13,12,4,22,14,3,15,0,33,54,0
1209,23091,aOhrgEBrLoAbudoZk6lY36jneHxQbWdO,G8EPVSXsOYB5YQWZGiz1aVq5Pgr2GrQu,27,22,16,0,11,0,14,2,65,9.285714285714286,2,0.0,0,16,0,11,22,0,0,14,2,27,38,0
1210,23118,2wKdgTom3CXBb3VapzvEijoKrYgkRC9s,SpATywNh6bZuzm8s1ceuBUnMUAeoAHHw,1,0,0,0,0,0,1,0,1,0.14285714285714285,1,0.0,0,0,0,0,0,0,0,1,0,0,1,0
1211,23140,0Tg2flbTUdD7fODqYIfpiJiK0IDdFiOP,RXDvfPUBYFlVdlueBFbLW0mhhAyGEqpt,9,9,6,0,1,0,9,0,25,3.5714285714285716,2,0.0,0,6,0,1,9,0,0,9,0,7,18,0
1212,23145,VO6tFMF3YqIQYaW8tkV9BLtheEJyKKQK,SpATywNh6bZuzm8s1ceuBUnMUAeoAHHw,16,22,9,12,3,0,8,0,54,7.714285714285714,2,0.0,8,9,12,3,14,0,0,8,0,32,22,0
1213,23174,dpHLF21uvMbokNNTJHdbSyHoiwNjC5Qc,RXDvfPUBYFlVdlueBFbLW0mhhAyGEqpt,16,10,8,0,3,5,4,4,34,4.857142857142857,1,0.0,0,8,0,3,10,5,0,4,4,11,23,1
1214,23186,jOKGDo32k5y1tQ1HBtDhmlq3GlvnMuW4,A3fsA9Zfv1X2fVEQhTw51lKENdNrEqT3,25,46,36,0,27,2,30,0,141,20.142857142857142,3,0.0,1,36,0,27,45,2,0,30,0,64,77,1
1215,23188,HycevJIm7cBjf1oJ5QCBMMXEBTG8jyRF,RXDvfPUBYFlVdlueBFbLW0mhhAyGEqpt,50,78,46,77,12,37,42,1,293,41.857142857142854,5,0.0,17,46,72,12,61,37,5,42,1,147,146,0
1216,23203,YBZJfjYuKfwb2VLWbDlKIMN1YSYXBGau,A3fsA9Zfv1X2fVEQhTw51lKENdNrEqT3,10,11,7,0,1,5,5,0,29,4.142857142857143,3,0.0,0,7,0,1,11,5,0,5,0,8,21,1
1217,23229,AjE14bAFpRvd1b44PmMUpBPn2loehR8N,SpATywNh6bZuzm8s1ceuBUnMUAeoAHHw,13,15,5,0,4,9,14,0,47,6.714285714285714,2,0.0,1,5,0,4,14,9,0,14,0,10,37,1
1218,23230,qJSVGIIBKQpzllCeTCwG3pgdEZIo3QRz,A3fsA9Zfv1X2fVEQhTw51lKENdNrEqT3,10,5,1,0,1,0,8,0,15,2.142857142857143,1,0.0,0,1,0,1,5,0,0,8,0,2,13,1
1219,23241,wmmgynPgGzw7ypLLU9vcdxog9SI7Juul,RXDvfPUBYFlVdlueBFbLW0mhhAyGEqpt,18,11,7,20,3,0,2,0,43,6.142857142857143,1,0.0,2,7,17,3,9,0,3,2,0,29,14,1
1220,23255,FfhVetKUzu5KpGrHLPHaynXPJghmm3It,SpATywNh6bZuzm8s1ceuBUnMUAeoAHHw,1,0,0,0,0,0,1,0,1,0.14285714285714285,1,0.0,0,0,0,0,0,0,0,1,0,0,1,0
1221,23259,xqwUV9iQK4erbWJ9fEZ3Fau5k4aAZ9DO,SpATywNh6bZuzm8s1ceuBUnMUAeoAHHw,16,46,21,28,7,10,9,2,123,17.571428571428573,3,0.0,18,21,21,7,28,10,7,9,2,67,56,0
1222,23263,tnLfm9tutF6YoqDXNIONCmii1aynBy80,A3fsA9Zfv1X2fVEQhTw51lKENdNrEqT3,9,6,3,0,0,3,11,1,24,3.4285714285714284,2,0.0,0,3,0,0,6,3,0,11,1,3,21,1
1223,23281,peL7W7HsPQXwJW8IfNPUpznrjT13FLeH,SpATywNh6bZuzm8s1ceuBUnMUAeoAHHw,12,22,0,13,0,0,8,0,43,6.142857142857143,1,0.0,8,0,12,0,14,0,1,8,0,20,23,1
1224,23297,3cB0rEpxJxC0jjqfQ9EPT6ntxFajOXrx,A3fsA9Zfv1X2fVEQhTw51lKENdNrEqT3,32,30,20,50,10,35,7,1,153,21.857142857142858,2,0.0,0,20,44,10,30,35,6,7,1,74,79,0
1225,23304,WEwbMamm1WQzZcIYKs7fv3KkFwrZAu4n,SpATywNh6bZuzm8s1ceuBUnMUAeoAHHw,14,18,5,12,3,2,3,0,43,6.142857142857143,3,0.0,12,5,12,3,6,2,0,3,0,32,11,0
1226,23307,S1PbXrIuvwc8AvxDGKhjkWzwRdM8cFN0,SpATywNh6bZuzm8s1ceuBUnMUAeoAHHw,11,18,9,6,0,0,5,0,38,5.428571428571429,4,0.0,3,9,6,0,15,0,0,5,0,18,20,0
1227,23311,fE7crtUj4hDSQo6ITE7OJYFi4AN2F95M,A3fsA9Zfv1X2fVEQhTw51lKENdNrEqT3,9,7,3,0,2,0,4,0,16,2.2857142857142856,1,0.0,0,3,0,2,7,0,0,4,0,5,11,1
1228,23313,TXBaUi0GpvXZWCDXsKlkFWTtfaT87UMz,bWdj2GDclj5ofokWjzoa5jAwMkxCykd6,11,31,4,32,1,1,8,2,79,11.285714285714286,4,0.0,3,4,30,1,28,1,2,8,2,38,41,1
1229,23358,dob27oJoC3Vd5K1oOuihpbNGBh5pIGaM,SpATywNh6bZuzm8s1ceuBUnMUAeoAHHw,13,26,15,1,7,1,5,0,55,7.857142857142857,2,0.0,6,15,1,7,20,1,0,5,0,29,26,1
1230,23388,HZWZtPkCTeK90eQ90MHe5cWcAqiVgkGk,bWdj2GDclj5ofokWjzoa5jAwMkxCykd6,9,7,2,0,2,20,12,1,44,6.285714285714286,2,0.0,2,2,0,2,5,20,0,12,1,6,38,0
1231,23390,lfrqXPATBesMooHpdCa9ZnxlXhb59rmp,SpATywNh6bZuzm8s1ceuBUnMUAeoAHHw,17,71,36,19,11,2,25,0,164,23.428571428571427,4,0.0,9,36,17,11,62,2,2,25,0,73,91,1
1232,23399,QUw5YB8tw6ArwfIF1vjOH2aXsMxDBB6n,SpATywNh6bZuzm8s1ceuBUnMUAeoAHHw,17,11,7,12,3,18,10,2,63,9.0,3,0.0,2,7,10,3,9,18,2,10,2,22,41,0
1233,23405,3AFvyqpOB7zyiycGY1NpbFOUZUj9K9Bb,SpATywNh6bZuzm8s1ceuBUnMUAeoAHHw,14,12,7,6,4,1,6,0,36,5.142857142857143,3,0.0,2,7,6,4,10,1,0,6,0,19,17,1
1234,23416,1ulA4jhwI0WhLE9MVLjWBxEEeOzdq7WL,SpATywNh6bZuzm8s1ceuBUnMUAeoAHHw,15,35,20,22,7,23,10,0,117,16.714285714285715,3,0.0,7,20,17,7,28,23,5,10,0,51,66,0
1235,23440,lHNqd6KTSO9CrJzRDAqosVITLVN3mMHR,bWdj2GDclj5ofokWjzoa5jAwMkxCykd6,8,11,5,0,1,0,8,0,25,3.5714285714285716,2,0.0,3,5,0,1,8,0,0,8,0,9,16,1
1236,23477,wctOEAfOfHjaIn2ukTVBg3NDDfP2Pt1c,SpATywNh6bZuzm8s1ceuBUnMUAeoAHHw,17,45,27,18,8,18,24,5,145,20.714285714285715,3,0.0,6,27,15,8,39,18,3,24,5,56,89,0
1237,23490,Id4UmIRRQiLXHoJYSjh5OCO1CRaFgQ2K,SpATywNh6bZuzm8s1ceuBUnMUAeoAHHw,16,27,10,12,4,4,7,1,65,9.285714285714286,2,0.0,8,10,10,4,19,4,2,7,1,32,33,1
1238,23510,GIb3glgYrsEfHWtEWPWpwONqwE7RMf6f,A3fsA9Zfv1X2fVEQhTw51lKENdNrEqT3,33,92,53,12,28,7,29,1,222,31.714285714285715,6,0.0,0,53,12,28,92,7,0,29,1,93,129,0
1239,23515,Oqfkhjg6t51PZcyyCwvjWtQ6bDHYceB1,SpATywNh6bZuzm8s1ceuBUnMUAeoAHHw,14,25,12,12,4,7,6,0,66,9.428571428571429,4,0.0,5,12,9,4,20,7,3,6,0,30,36,0
1240,23552,H0WeKsbXeLHWXz7EV7ygxgCQNCt5DOUD,SpATywNh6bZuzm8s1ceuBUnMUAeoAHHw,13,29,5,24,0,7,11,1,77,11.0,5,0.0,2,5,20,0,27,7,4,11,1,27,50,0
1241,23585,NRdQjU0MJFdxtbDqiTrBcJcd064egve1,SpATywNh6bZuzm8s1ceuBUnMUAeoAHHw,13,24,16,9,0,8,14,1,72,10.285714285714286,2,0.0,3,16,8,0,21,8,1,14,1,27,45,1
1242,23633,o6ILANWxUGmdLZhlBol9mZCEolnG5bhy,SpATywNh6bZuzm8s1ceuBUnMUAeoAHHw,17,21,10,3,3,31,13,1,82,11.714285714285714,4,0.0,2,10,3,3,19,31,0,13,1,18,64,1
1243,23639,tMPZYG0DCvDSDEuO4KsQAdk0iwwmXKYt,A3fsA9Zfv1X2fVEQhTw51lKENdNrEqT3,20,42,21,0,8,2,18,0,91,13.0,3,0.0,1,21,0,8,41,2,0,18,0,30,61,0
1244,23671,9sTtmQQAXG5XvwtZJPuuRKLnfgaYWfWO,SpATywNh6bZuzm8s1ceuBUnMUAeoAHHw,7,3,2,0,2,0,2,0,9,1.2857142857142858,1,0.0,0,2,0,2,3,0,0,2,0,4,5,1
1245,23674,l9KseRU4xYtwOzoILYmGcicF0iiXQqxl,SpATywNh6bZuzm8s1ceuBUnMUAeoAHHw,14,27,8,23,3,5,4,0,70,10.0,4,0.0,9,8,19,3,18,5,4,4,0,39,31,0
1246,23710,3iJrlZJEv2h7DgWBpz6wZtSXPXEy6IAY,A3fsA9Zfv1X2fVEQhTw51lKENdNrEqT3,8,9,3,0,2,0,5,0,19,2.7142857142857144,4,0.0,0,3,0,2,9,0,0,5,0,5,14,0
1247,23711,POOwrt9teJiwgIKzPgqwiwhGp5kUKv01,SpATywNh6bZuzm8s1ceuBUnMUAeoAHHw,17,22,12,15,4,5,11,1,70,10.0,1,0.0,7,12,13,4,15,5,2,11,1,36,34,0
1248,23740,oJ9j9ejTgKixczg3tSE8Sg8DPI7YQpJq,SpATywNh6bZuzm8s1ceuBUnMUAeoAHHw,14,23,12,12,4,14,6,0,71,10.142857142857142,4,0.0,6,12,9,4,17,14,3,6,0,31,40,0
1249,23754,atxTINx1wNa0Kz1uw7bW34Z47POxkGeq,SpATywNh6bZuzm8s1ceuBUnMUAeoAHHw,16,29,3,20,1,1,19,1,74,10.571428571428571,2,0.0,7,3,16,1,22,1,4,19,1,27,47,0
1250,23760,6uy0rYsVs6ntSHgwhJ1mwDkW5uKAQxi4,SpATywNh6bZuzm8s1ceuBUnMUAeoAHHw,13,38,22,16,11,10,2,0,99,14.142857142857142,3,0.0,12,22,14,11,26,10,2,2,0,59,40,1
1251,23773,35E85h2ExBPeTd1VmxNX0GKo8krIMsCP,SpATywNh6bZuzm8s1ceuBUnMUAeoAHHw,16,34,14,21,8,1,10,0,88,12.571428571428571,2,0.0,14,14,17,8,20,1,4,10,0,53,35,1
1252,23789,i1f7BljhTNgVMfGOHZ66OYaR3kNetCAs,SpATywNh6bZuzm8s1ceuBUnMUAeoAHHw,7,11,0,20,0,14,5,0,50,7.142857142857143,3,0.0,7,0,17,0,4,14,3,5,0,24,26,0
1253,23795,bHKiB8yjzvUwkeHE5fxnHNywx47ldJ6B,SpATywNh6bZuzm8s1ceuBUnMUAeoAHHw,13,25,2,19,0,2,9,0,57,8.142857142857142,4,0.0,10,2,17,0,15,2,2,9,0,29,28,1
1254,23798,GOPMGFz5xoFESgugOmv6JtNIOPfS0GCX,SpATywNh6bZuzm8s1ceuBUnMUAeoAHHw,14,31,0,17,0,13,9,1,71,10.142857142857142,3,0.0,10,0,16,0,21,13,1,9,1,26,45,0
1255,23852,dFrBZuKOTxv7Ek84BAuACScgZVHLiPRz,SpATywNh6bZuzm8s1ceuBUnMUAeoAHHw,3,2,0,0,0,0,1,0,3,0.42857142857142855,1,0.0,0,0,0,0,2,0,0,1,0,0,3,1
1256,23855,4okppsrdnKYxqs2gLNMiS6gb60QmM8WN,RXDvfPUBYFlVdlueBFbLW0mhhAyGEqpt,46,69,53,122,13,9,10,11,287,41.0,1,0.0,9,53,115,13,60,9,7,10,11,190,97,1
1257,23862,YxEAEqB4R6GTRBWDvga1GWE0URAxGc6U,A3fsA9Zfv1X2fVEQhTw51lKENdNrEqT3,4,3,1,0,0,0,1,0,5,0.7142857142857143,1,0.0,0,1,0,0,3,0,0,1,0,1,4,1
1258,23863,3Ta0rfBtrbiqFMIpcV3b3USyW2ELEZd2,bWdj2GDclj5ofokWjzoa5jAwMkxCykd6,7,2,1,0,1,0,4,0,8,1.1428571428571428,1,0.0,0,1,0,1,2,0,0,4,0,2,6,1
1259,23874,986WgoFI0AZSDPIvWwBI8MUZveW4E4Xu,RXDvfPUBYFlVdlueBFbLW0mhhAyGEqpt,14,33,17,0,8,0,5,0,63,9.0,2,0.0,0,17,0,8,33,0,0,5,0,25,38,0
1260,23891,FBu5R2eGEtl9EDw0VwXtH1t5i2ELpdqI,A3fsA9Zfv1X2fVEQhTw51lKENdNrEqT3,42,49,21,110,10,1,7,0,198,28.285714285714285,3,0.0,4,21,88,10,45,1,22,7,0,123,75,1
1261,23901,4dLqJDBbl4XgAFoagStv97aI3aHRciy5,SpATywNh6bZuzm8s1ceuBUnMUAeoAHHw,13,16,10,0,6,3,9,1,45,6.428571428571429,2,0.0,0,10,0,6,16,3,0,9,1,16,29,1
1262,23920,v5teTtQ61doFtyEryEU1FEZNTQeJUrxX,SpATywNh6bZuzm8s1ceuBUnMUAeoAHHw,15,40,3,14,0,13,26,2,98,14.0,4,0.0,18,3,13,0,22,13,1,26,2,34,64,0
1263,23942,yk8HuNxXIum8r8XDIOHqnAVeWfg9tYo1,A3fsA9Zfv1X2fVEQhTw51lKENdNrEqT3,14,11,8,0,5,2,14,2,42,6.0,1,0.0,0,8,0,5,11,2,0,14,2,13,29,1
1264,23944,ZKAk08L8Iriz8Uv5UOeqSbrNnzg1rlMz,RXDvfPUBYFlVdlueBFbLW0mhhAyGEqpt,24,24,14,27,7,17,12,1,102,14.571428571428571,3,0.0,5,14,27,7,19,17,0,12,1,53,49,0
1265,23955,5mJ1itg2cQYRNscuJuLNd4sNUrdim8JB,bWdj2GDclj5ofokWjzoa5jAwMkxCykd6,19,75,32,53,3,40,29,5,237,33.857142857142854,5,0.0,6,32,52,3,69,40,1,29,5,93,144,0
1266,23975,xCPsccPRbQTL93kwam6OPz5i1lU77hqE,SpATywNh6bZuzm8s1ceuBUnMUAeoAHHw,7,9,1,0,0,0,5,0,15,2.142857142857143,1,0.0,3,1,0,0,6,0,0,5,0,4,11,0
1267,23976,PSJftXZeDfoFySmsRqkLgFson1mEyJqX,SpATywNh6bZuzm8s1ceuBUnMUAeoAHHw,17,59,24,22,7,60,37,3,212,30.285714285714285,4,0.0,24,24,18,7,35,60,4,37,3,73,139,0
1268,23982,3W09pasLSoDWuQqGyvECJ7WiykG165j2,RXDvfPUBYFlVdlueBFbLW0mhhAyGEqpt,1,0,0,0,0,0,3,0,3,0.42857142857142855,2,0.0,0,0,0,0,0,0,0,3,0,0,3,1
1269,24019,tML4IQ8jFiP4YuH9NbvzKQFqAdof0qcO,G8EPVSXsOYB5YQWZGiz1aVq5Pgr2GrQu,22,27,0,16,0,13,15,2,73,10.428571428571429,3,0.0,1,0,13,0,26,13,3,15,2,14,59,0
1270,24035,j5UlwBty5MOwHf8rgRJk1hdlEvwivM1k,SpATywNh6bZuzm8s1ceuBUnMUAeoAHHw,11,21,3,14,0,32,11,0,81,11.571428571428571,4,0.0,10,3,14,0,11,32,0,11,0,27,54,0
1271,24046,5C3sCk6rXQc2OvYtSBZh5PoYxtIPWyJ2,SpATywNh6bZuzm8s1ceuBUnMUAeoAHHw,11,14,9,0,5,2,5,0,35,5.0,2,0.0,5,9,0,5,9,2,0,5,0,19,16,1
1272,24053,eosk3dY7502Pbg6Dsnx0qWKWUpRTliXK,A3fsA9Zfv1X2fVEQhTw51lKENdNrEqT3,30,17,3,62,0,0,8,0,90,12.857142857142858,3,0.0,2,3,53,0,15,0,9,8,0,58,32,1
1273,24068,lUdpqcwQn1Cq8H3mwfWcSvZsVHMY64gd,SpATywNh6bZuzm8s1ceuBUnMUAeoAHHw,14,35,1,15,0,0,19,6,76,10.857142857142858,1,0.0,16,1,13,0,19,0,2,19,6,30,46,1
1274,24077,1xg9Qkt1ODqUyNotraxCzvVYE0R3XRTq,SpATywNh6bZuzm8s1ceuBUnMUAeoAHHw,12,47,27,2,0,4,16,1,97,13.857142857142858,2,0.0,11,27,2,0,36,4,0,16,1,40,57,0
1275,24097,quAtav6r2isPETtEaXY0Zey5BbVDiT8E,bWdj2GDclj5ofokWjzoa5jAwMkxCykd6,5,0,0,0,0,1,4,1,6,0.8571428571428571,1,0.0,0,0,0,0,0,1,0,4,1,0,6,1
1276,24117,qQwIO2VZC7PFj9cTI7x2EoRtRcwJFk5y,A3fsA9Zfv1X2fVEQhTw51lKENdNrEqT3,12,3,1,24,0,0,4,0,32,4.571428571428571,1,0.0,0,1,19,0,3,0,5,4,0,20,12,1
1277,24130,PweHbRIHs8SwjKQfEtpqIQuZBXBDcuDm,SpATywNh6bZuzm8s1ceuBUnMUAeoAHHw,17,26,13,18,6,0,7,2,72,10.285714285714286,2,0.0,10,13,16,6,16,0,2,7,2,45,27,1
1278,24139,oz1karFupMeBQM5wp1X9Aheb4RKufic7,SpATywNh6bZuzm8s1ceuBUnMUAeoAHHw,14,18,11,19,5,14,5,0,72,10.285714285714286,3,0.0,2,11,17,5,16,14,2,5,0,35,37,0
1279,24140,68BjCXfBFqeZ01fFx1csrFmvef5xs0w2,SpATywNh6bZuzm8s1ceuBUnMUAeoAHHw,12,23,15,0,7,12,5,0,62,8.857142857142858,4,0.0,3,15,0,7,20,12,0,5,0,25,37,1
1280,24146,W41zjpcR5alpzNzSmbyy9bBZYrT6UXxL,RXDvfPUBYFlVdlueBFbLW0mhhAyGEqpt,1,0,0,0,0,0,8,0,8,1.1428571428571428,1,0.0,0,0,0,0,0,0,0,8,0,0,8,1
1281,24149,yEc0qGRUsnGavj0JPbk8pVtWktClrURk,SpATywNh6bZuzm8s1ceuBUnMUAeoAHHw,3,0,0,0,0,3,2,0,5,0.7142857142857143,1,0.0,0,0,0,0,0,3,0,2,0,0,5,0
1282,24150,7mxOgTUP9lSjAUBOPZ9fhNEhVSHMvF2J,bWdj2GDclj5ofokWjzoa5jAwMkxCykd6,17,46,7,58,6,17,16,2,152,21.714285714285715,3,0.0,15,7,52,6,31,17,6,16,2,80,72,0
1283,24154,WTCEOd5LeoB3M6qdd6wv5K0UJQNEdjBy,bWdj2GDclj5ofokWjzoa5jAwMkxCykd6,7,2,1,0,1,7,5,1,17,2.4285714285714284,1,0.0,0,1,0,1,2,7,0,5,1,2,15,1
1284,24161,ZRTZW05J88lidJZzll8LtXVXzVI1deNg,SpATywNh6bZuzm8s1ceuBUnMUAeoAHHw,6,2,0,0,0,1,7,0,10,1.4285714285714286,1,0.0,0,0,0,0,2,1,0,7,0,0,10,1
1285,24187,GlAlbUSi7bTkQeCE1bsVWDk5GBPq0ZBP,bWdj2GDclj5ofokWjzoa5jAwMkxCykd6,7,4,2,16,2,22,2,0,48,6.857142857142857,2,0.0,1,2,15,2,3,22,1,2,0,20,28,1
1286,24205,KjugBA6V5bkEA5fAIbJoGnSUlDhZoaIH,SpATywNh6bZuzm8s1ceuBUnMUAeoAHHw,6,3,1,0,0,2,6,0,12,1.7142857142857142,2,0.0,0,1,0,0,3,2,0,6,0,1,11,0
1287,24257,L8lHLh6Mth1S7I3sErP5oDZD885a1BOh,A3fsA9Zfv1X2fVEQhTw51lKENdNrEqT3,26,9,4,42,1,0,3,0,59,8.428571428571429,1,0.0,3,4,41,1,6,0,1,3,0,49,10,1
1288,24258,Ne25k1DU4nK81LWo7930HvBFWlFV2ZKt,SpATywNh6bZuzm8s1ceuBUnMUAeoAHHw,13,30,7,2,2,0,10,0,51,7.285714285714286,5,0.0,4,7,2,2,26,0,0,10,0,15,36,0
1289,24283,yZoviGGxgr5NFf9klHeC5PfXfdVd14QP,A3fsA9Zfv1X2fVEQhTw51lKENdNrEqT3,45,23,15,58,9,2,13,2,122,17.428571428571427,2,0.0,1,15,54,9,22,2,4,13,2,79,43,1
1290,24285,Kd69M9W1nim0woqVm1QxfVaSebsYtFIh,RXDvfPUBYFlVdlueBFbLW0mhhAyGEqpt,16,20,9,12,4,1,6,1,53,7.571428571428571,2,0.0,1,9,12,4,19,1,0,6,1,26,27,1
1291,24290,Ms0MC4W5moiGJLWP7iE3FImeH9CHN4KT,A3fsA9Zfv1X2fVEQhTw51lKENdNrEqT3,5,9,4,0,0,0,4,0,17,2.4285714285714284,2,0.0,0,4,0,0,9,0,0,4,0,4,13,0
1292,24351,iugl3Rn3u1ci3BiC2tfekDHOQsD5QVGj,A3fsA9Zfv1X2fVEQhTw51lKENdNrEqT3,8,7,3,0,1,1,7,0,19,2.7142857142857144,2,0.0,3,3,0,1,4,1,0,7,0,7,12,1
1293,24371,1RLhIao7wKT4YvgWBYzjLBBf7hozJmqb,SpATywNh6bZuzm8s1ceuBUnMUAeoAHHw,5,3,1,0,1,0,2,0,7,1.0,1,0.0,0,1,0,1,3,0,0,2,0,2,5,1
1294,24384,j1jdy8OF5VQw4rqSYOkbK2pQplvvvz37,SpATywNh6bZuzm8s1ceuBUnMUAeoAHHw,1,0,0,0,0,0,1,0,1,0.14285714285714285,1,0.0,0,0,0,0,0,0,0,1,0,0,1,1
1295,24391,5tGNQxzw9lFd1DSnmxNCdWwVZfTyj1IB,bWdj2GDclj5ofokWjzoa5jAwMkxCykd6,18,21,14,96,6,0,8,0,145,20.714285714285715,3,0.0,3,14,94,6,18,0,2,8,0,117,28,1
1296,24397,2ZTBzb1Y4dwuOwNiUUSWB6SyHlRXxNso,SpATywNh6bZuzm8s1ceuBUnMUAeoAHHw,17,38,7,13,4,2,7,1,72,10.285714285714286,2,0.0,28,7,13,4,10,2,0,7,1,52,20,1
1297,24456,AOtTiaeDNx4G2J0NpAHDjb596RxqAAI3,SpATywNh6bZuzm8s1ceuBUnMUAeoAHHw,16,23,6,14,4,0,7,1,55,7.857142857142857,1,0.0,15,6,11,4,8,0,3,7,1,36,19,1
1298,24503,VVgqDLLa7j66k9tQU3M7wVOF4BEse4lo,SpATywNh6bZuzm8s1ceuBUnMUAeoAHHw,14,45,13,13,5,1,6,0,83,11.857142857142858,2,0.0,9,13,13,5,36,1,0,6,0,40,43,0
1299,24550,qr1Y8xuPrcpdzScNHYsirGXqasfUdOVa,SpATywNh6bZuzm8s1ceuBUnMUAeoAHHw,6,10,3,0,1,0,5,0,19,2.7142857142857144,2,0.0,0,3,0,1,10,0,0,5,0,4,15,1
1300,24551,foJyfq5hSUj3jzVw8TG0nT1wv3hLMMNc,G8EPVSXsOYB5YQWZGiz1aVq5Pgr2GrQu,48,69,52,80,32,0,12,0,245,35.0,3,0.0,2,52,71,32,67,0,9,12,0,157,88,0
1301,24552,foJyfq5hSUj3jzVw8TG0nT1wv3hLMMNc,SpATywNh6bZuzm8s1ceuBUnMUAeoAHHw,16,19,12,12,4,5,9,0,61,8.714285714285714,3,0.0,2,12,12,4,17,5,0,9,0,30,31,0
1302,24587,f7pgA2Hp0s8DkqzKuvE0Kw8QRuoBh3Zv,RXDvfPUBYFlVdlueBFbLW0mhhAyGEqpt,27,23,13,44,2,6,6,0,94,13.428571428571429,2,0.0,4,13,42,2,19,6,2,6,0,61,33,0
1303,24601,rhJzZeMBkfw1Q75cLyvgh9HzDvUXe9cc,SpATywNh6bZuzm8s1ceuBUnMUAeoAHHw,2,0,0,0,0,0,2,0,2,0.2857142857142857,1,0.0,0,0,0,0,0,0,0,2,0,0,2,1
1304,24602,tBWD1VTj6Jcj3AQ0AXY8eZtUzkjmoiNH,SpATywNh6bZuzm8s1ceuBUnMUAeoAHHw,17,29,7,6,4,22,15,1,84,12.0,3,0.0,7,7,6,4,22,22,0,15,1,24,60,0
1305,24619,0JvlwMe8wRQNeLJu71UvJCaEJca2naUP,7GRhBDsirIGkRZBtSMEzNTyDr2JQm4xx,6,3,2,0,2,0,1,0,8,1.1428571428571428,2,0.0,0,2,0,2,3,0,0,1,0,4,4,1
1306,24661,ZgPDgY8Y43cADkyBad03WZKNqaM99vmp,7GRhBDsirIGkRZBtSMEzNTyDr2JQm4xx,25,49,0,45,4,1,17,1,117,16.714285714285715,3,0.0,23,0,36,4,26,1,9,17,1,63,54,0
1307,24680,1VsjBK2ROnIVYUeDYM5LmXmBSaC6415r,7GRhBDsirIGkRZBtSMEzNTyDr2JQm4xx,4,2,1,0,0,0,2,0,5,0.7142857142857143,1,0.0,0,1,0,0,2,0,0,2,0,1,4,1
1308,24770,JSUd2wnxbPhnPOoSIVdrMCxy8KhaLF4M,7GRhBDsirIGkRZBtSMEzNTyDr2JQm4xx,20,34,17,17,10,0,9,0,87,12.428571428571429,5,0.0,5,17,14,10,29,0,3,9,0,46,41,1
1309,24771,zOqvR5SeTZmNwN7GW7m4oZ7a32WZgEDz,RXDvfPUBYFlVdlueBFbLW0mhhAyGEqpt,10,9,2,0,2,0,4,0,17,2.4285714285714284,1,0.0,0,2,0,2,9,0,0,4,0,4,13,1
1310,24796,8tSKdZ8K9lE8Sg5tXOt7ENrj00lNonld,SpATywNh6bZuzm8s1ceuBUnMUAeoAHHw,14,16,0,18,0,15,9,2,60,8.571428571428571,2,0.0,5,0,15,0,11,15,3,9,2,20,40,0
1311,24805,KRi80h1uK84snC5HvtQKWlsjwt9i3oa5,SpATywNh6bZuzm8s1ceuBUnMUAeoAHHw,12,15,9,7,4,0,4,0,39,5.571428571428571,3,0.0,3,9,6,4,12,0,1,4,0,22,17,0
1312,24823,FCXkOVtASvwM4OqelAOjh7n6TzPCCzLb,7GRhBDsirIGkRZBtSMEzNTyDr2JQm4xx,7,5,3,0,3,0,2,0,13,1.8571428571428572,1,0.0,1,3,0,3,4,0,0,2,0,7,6,1
1313,24824,JEEkuD8nRyQdFWZOzS8kZ8mhHw8bPQH3,7GRhBDsirIGkRZBtSMEzNTyDr2JQm4xx,2,0,0,0,0,0,2,0,2,0.2857142857142857,1,0.0,0,0,0,0,0,0,0,2,0,0,2,1
1314,24834,NsnGWsRio9JsRS5X1oYgeBjF7tc8iDdA,7GRhBDsirIGkRZBtSMEzNTyDr2JQm4xx,33,81,32,77,21,28,15,1,255,36.42857142857143,2,0.0,42,32,67,21,39,28,10,15,1,162,93,1
1315,24836,wuaIkUodYTr49NZ7BbMPsEdpO0t0C8Nt,7GRhBDsirIGkRZBtSMEzNTyDr2JQm4xx,2,0,0,0,0,0,2,0,2,0.2857142857142857,1,0.0,0,0,0,0,0,0,0,2,0,0,2,1
1316,24901,paRtaUir7BROwVpnw69gcE7HkkiPuHFt,7GRhBDsirIGkRZBtSMEzNTyDr2JQm4xx,33,80,5,70,6,8,40,5,214,30.571428571428573,3,0.0,49,5,61,6,31,8,9,40,5,121,93,1
1317,24984,p8pFuUg19xWGOlJygMvSlQjonA3l7FUn,A3fsA9Zfv1X2fVEQhTw51lKENdNrEqT3,21,11,10,0,9,0,1,0,31,4.428571428571429,1,0.0,0,10,0,9,11,0,0,1,0,19,12,0
1318,24996,tLK32ryOHeiJecBcFzaTeN36vYEmQ8Nk,SpATywNh6bZuzm8s1ceuBUnMUAeoAHHw,14,12,5,18,3,1,4,2,45,6.428571428571429,1,0.0,6,5,17,3,6,1,1,4,2,31,14,1
1319,25033,BuZcYQWwWDSVZcqno1RGBiY1PDnVqtUZ,G8EPVSXsOYB5YQWZGiz1aVq5Pgr2GrQu,16,29,18,20,0,1,4,0,72,10.285714285714286,2,0.0,4,18,19,0,25,1,1,4,0,41,31,1
1320,25049,zkOr0wwuxAzYftPuxG6iQaCtbl1egkTS,A3fsA9Zfv1X2fVEQhTw51lKENdNrEqT3,35,44,30,40,13,12,21,2,162,23.142857142857142,1,0.0,8,30,38,13,36,12,2,21,2,89,73,0
1321,25067,aQ6WrdDe9pTNwVW3vmaMOs1pxy5r3Dxa,A3fsA9Zfv1X2fVEQhTw51lKENdNrEqT3,42,26,14,64,8,26,12,0,150,21.428571428571427,2,0.0,1,14,56,8,25,26,8,12,0,79,71,0
1322,25073,WQKoaWRi4j5EUCfZEZsK4LU6GIHATRae,SpATywNh6bZuzm8s1ceuBUnMUAeoAHHw,16,12,6,15,3,9,6,0,51,7.285714285714286,2,0.0,5,6,12,3,7,9,3,6,0,26,25,1
1323,25075,WQKoaWRi4j5EUCfZEZsK4LU6GIHATRae,7GRhBDsirIGkRZBtSMEzNTyDr2JQm4xx,32,48,17,50,14,10,5,0,144,20.571428571428573,2,0.0,29,17,39,14,19,10,11,5,0,99,45,1
1324,25096,i7qRP2nhuaIR2tcQnQvT86ViNtPopbnz,7GRhBDsirIGkRZBtSMEzNTyDr2JQm4xx,7,9,5,0,4,0,2,0,20,2.857142857142857,2,0.0,1,5,0,4,8,0,0,2,0,10,10,1
1325,25111,XQUx3MwVudtjeHmsju8PhHxsdXW0kluK,SpATywNh6bZuzm8s1ceuBUnMUAeoAHHw,15,24,12,12,4,1,5,0,58,8.285714285714286,3,0.0,9,12,12,4,15,1,0,5,0,37,21,0
1326,25118,mBkByOktWGTfbLjZh4oUEAyrYqB4PqkG,7GRhBDsirIGkRZBtSMEzNTyDr2JQm4xx,6,17,3,0,1,0,3,0,24,3.4285714285714284,6,0.0,0,3,0,1,17,0,0,3,0,4,20,1
1327,25198,w6Jq91nutnXM9db4LCqDd346NIYOr0ts,7GRhBDsirIGkRZBtSMEzNTyDr2JQm4xx,8,6,3,0,0,0,9,0,18,2.5714285714285716,1,0.0,1,3,0,0,5,0,0,9,0,4,14,1
1328,25212,95whmOrr6ttgAKmA8d5EYFggt87ONgHi,SpATywNh6bZuzm8s1ceuBUnMUAeoAHHw,14,22,2,22,2,3,6,0,57,8.142857142857142,2,0.0,14,2,19,2,8,3,3,6,0,37,20,1
1329,25235,BgFWtuiCvZoByaUpZ5qN1JDEWuWXlm2n,G8EPVSXsOYB5YQWZGiz1aVq5Pgr2GrQu,15,16,10,6,6,1,8,1,48,6.857142857142857,1,0.0,3,10,3,6,13,1,3,8,1,22,26,1
1330,25265,9va79rFsgW625mCi6PBHbhUMC5acSS5i,bWdj2GDclj5ofokWjzoa5jAwMkxCykd6,5,1,1,0,0,0,3,0,5,0.7142857142857143,1,0.0,0,1,0,0,1,0,0,3,0,1,4,0
1331,25269,E1ioRxhhohHY3rrHygts052gZKXoxwdE,7GRhBDsirIGkRZBtSMEzNTyDr2JQm4xx,7,3,2,0,2,0,2,0,9,1.2857142857142858,1,0.0,0,2,0,2,3,0,0,2,0,4,5,1
1332,25284,6DpgdlGoKRdZ3TeMwKLdUESj04TqApO6,7GRhBDsirIGkRZBtSMEzNTyDr2JQm4xx,29,39,10,61,14,0,3,0,127,18.142857142857142,1,0.0,28,10,52,14,11,0,9,3,0,104,23,1
1333,25371,tMJpDv6ZjEPz2ELzUVp4mZTT6G7u49T6,bWdj2GDclj5ofokWjzoa5jAwMkxCykd6,5,3,1,0,1,0,2,0,7,1.0,1,0.0,1,1,0,1,2,0,0,2,0,3,4,0
1334,25376,Evco2d15cNydZMimph5VWFT3j0HfgNP5,7GRhBDsirIGkRZBtSMEzNTyDr2JQm4xx,8,13,4,2,6,1,2,0,28,4.0,2,0.0,6,4,2,6,7,1,0,2,0,18,10,1
1335,25391,1aQoKDna73jstuOrupWa9Kq8V3FdvbRU,A3fsA9Zfv1X2fVEQhTw51lKENdNrEqT3,8,6,3,0,2,0,3,0,14,2.0,2,0.0,0,3,0,2,6,0,0,3,0,5,9,1
1336,25393,qfUwpJQAdesy8M2BZDMAUMfg4I7ObmXB,7GRhBDsirIGkRZBtSMEzNTyDr2JQm4xx,8,0,0,0,0,0,7,1,8,1.1428571428571428,1,0.0,0,0,0,0,0,0,0,7,1,0,8,1
1337,25406,Ua8t7GvEqkquREwn5gCoNVwYmIqhqGMw,G8EPVSXsOYB5YQWZGiz1aVq5Pgr2GrQu,47,53,27,64,17,32,21,3,217,31.0,2,0.0,18,27,49,17,35,32,15,21,3,111,106,0
1338,25410,eLRb35TMSz5mhOV1jFWfgFHXl5MBmODw,SpATywNh6bZuzm8s1ceuBUnMUAeoAHHw,4,10,0,0,0,0,3,0,13,1.8571428571428572,2,0.0,0,0,0,0,10,0,0,3,0,0,13,1
1339,25411,zTKXcgMSZF7JvFUNYP705peyaFADazmR,bWdj2GDclj5ofokWjzoa5jAwMkxCykd6,5,2,1,0,1,0,3,0,7,1.0,1,0.0,0,1,0,1,2,0,0,3,0,2,5,0
1340,25414,JGLccTidDHJDu8gDiATpQDW1eozc4icT,G8EPVSXsOYB5YQWZGiz1aVq5Pgr2GrQu,3,3,0,0,0,0,1,0,4,0.5714285714285714,1,0.0,0,0,0,0,3,0,0,1,0,0,4,1
1341,25442,QLGFenndIPaX8I2vSI7keErJ6m5JCAL7,7GRhBDsirIGkRZBtSMEzNTyDr2JQm4xx,9,5,2,2,3,1,5,0,18,2.5714285714285716,1,0.0,3,2,2,3,2,1,0,5,0,10,8,1
1342,25443,rpvfqHO7dPQYBUZWKnS2wc1t5Qy6pGj6,bWdj2GDclj5ofokWjzoa5jAwMkxCykd6,15,39,0,32,3,0,12,0,86,12.285714285714286,4,0.0,9,0,29,3,30,0,3,12,0,41,45,1
1343,25446,cUmqYT3vXiSNkNfCulTfjg26cA62ehB2,SpATywNh6bZuzm8s1ceuBUnMUAeoAHHw,6,2,0,0,0,1,7,1,11,1.5714285714285714,1,0.0,0,0,0,0,2,1,0,7,1,0,11,1
1344,25463,tCXa4pMsMXRuliZWNM9so3Odte6UmpYj,RXDvfPUBYFlVdlueBFbLW0mhhAyGEqpt,10,9,4,0,2,0,4,0,19,2.7142857142857144,1,0.0,2,4,0,2,7,0,0,4,0,8,11,1
1345,25482,M3Xa5IFPEZiaLK2rAjKqcPYFncjR6IsA,7GRhBDsirIGkRZBtSMEzNTyDr2JQm4xx,8,5,3,0,2,0,7,0,17,2.4285714285714284,2,0.0,0,3,0,2,5,0,0,7,0,5,12,1
1346,25503,XQUx3MwVudtjeHmsju8PhHxsdXW0kluK,G8EPVSXsOYB5YQWZGiz1aVq5Pgr2GrQu,6,6,3,0,2,0,4,0,15,2.142857142857143,1,0.0,0,3,0,2,6,0,0,4,0,5,10,1
1347,25527,qEjaWdK86bYd7lCS9YD68MsK6migCUpH,SpATywNh6bZuzm8s1ceuBUnMUAeoAHHw,14,9,4,10,3,0,6,0,32,4.571428571428571,2,0.0,2,4,9,3,7,0,1,6,0,18,14,0
1348,25546,rfOApTbQ4xF2665bHZIBhoJqQcTU6i9L,A3fsA9Zfv1X2fVEQhTw51lKENdNrEqT3,15,11,8,0,5,0,6,1,31,4.428571428571429,1,0.0,0,8,0,5,11,0,0,6,1,13,18,1
1349,25551,KArM7gUn52riH9ery2Pt8jVzh161mtd5,7GRhBDsirIGkRZBtSMEzNTyDr2JQm4xx,1,0,0,0,0,0,1,0,1,0.14285714285714285,1,0.0,0,0,0,0,0,0,0,1,0,0,1,1
1350,25552,OL3EuzPtZh7LsYXjzzPmtbrDH2VopR0Y,bWdj2GDclj5ofokWjzoa5jAwMkxCykd6,6,8,4,0,1,0,7,0,20,2.857142857142857,1,0.0,0,4,0,1,8,0,0,7,0,5,15,0
1351,25589,3Oka5GvBd9TakXRvr9D5vxoJEhxwuxJA,SpATywNh6bZuzm8s1ceuBUnMUAeoAHHw,9,18,6,14,0,0,8,0,46,6.571428571428571,2,0.0,8,6,14,0,10,0,0,8,0,28,18,0
1352,25599,tSfB7w0NRlNAlyBUvZCESn8JJeD8KUGH,7GRhBDsirIGkRZBtSMEzNTyDr2JQm4xx,6,2,1,0,0,0,3,0,6,0.8571428571428571,1,0.0,0,1,0,0,2,0,0,3,0,1,5,1
1353,25675,wgifE6A0kxnDEjw7myKTY39TRuCgYxaB,A3fsA9Zfv1X2fVEQhTw51lKENdNrEqT3,6,5,0,0,0,0,2,0,7,1.0,1,0.0,0,0,0,0,5,0,0,2,0,0,7,1
1354,25696,Ufo4AkS2vTW82q9Kpcrkrp0gG0Us5zu9,7GRhBDsirIGkRZBtSMEzNTyDr2JQm4xx,11,17,2,0,2,0,4,0,25,3.5714285714285716,2,0.0,0,2,0,2,17,0,0,4,0,4,21,1
1355,25706,udBjfCluZTte9l6GhqqG4v3kEGoKKcxC,SpATywNh6bZuzm8s1ceuBUnMUAeoAHHw,17,33,15,11,8,27,15,3,112,16.0,3,0.0,14,15,9,8,19,27,2,15,3,46,66,0
1356,25720,v0qndwa3TlbOqgdTUBH2afnl049VDWzU,SpATywNh6bZuzm8s1ceuBUnMUAeoAHHw,15,17,9,12,3,0,3,0,44,6.285714285714286,3,0.0,4,9,12,3,13,0,0,3,0,28,16,0
1357,25761,Y3GsHv1t2an649bMll1LdxvN2SIICjxG,SpATywNh6bZuzm8s1ceuBUnMUAeoAHHw,6,3,2,0,2,0,2,0,9,1.2857142857142858,2,0.0,0,2,0,2,3,0,0,2,0,4,5,0
1358,25773,xYLJB56SVkFUOdT5vN3Qq6OYNlnP0Fjc,7GRhBDsirIGkRZBtSMEzNTyDr2JQm4xx,16,40,24,0,5,0,4,0,73,10.428571428571429,3,0.0,3,24,0,5,37,0,0,4,0,32,41,1
1359,25804,E7Frt6tr6owhsgLSRkD2PqDaTSKmNLId,7GRhBDsirIGkRZBtSMEzNTyDr2JQm4xx,5,2,1,0,1,0,4,0,8,1.1428571428571428,2,0.0,0,1,0,1,2,0,0,4,0,2,6,1
1360,25816,lMefkcgNh5NMvOXiUOkNuemhw07vFq2i,SpATywNh6bZuzm8s1ceuBUnMUAeoAHHw,5,2,1,0,1,0,2,0,6,0.8571428571428571,1,0.0,0,1,0,1,2,0,0,2,0,2,4,0
1361,25826,mLf710wFmDQbZB0X7jv0DPpqMqjMZwPk,SpATywNh6bZuzm8s1ceuBUnMUAeoAHHw,16,31,19,20,9,22,19,6,126,18.0,1,0.0,4,19,18,9,27,22,2,19,6,50,76,1
1362,25882,N3h2N9w5PnUvhnv2E14KTv0J7vawpbdm,7GRhBDsirIGkRZBtSMEzNTyDr2JQm4xx,1,0,0,0,0,0,1,0,1,0.14285714285714285,1,0.0,0,0,0,0,0,0,0,1,0,0,1,1
1363,25900,NRMzH6tZyLT2qk2QIkwNRbUliCMPz2WK,A3fsA9Zfv1X2fVEQhTw51lKENdNrEqT3,17,10,9,0,8,0,2,0,29,4.142857142857143,1,0.0,0,9,0,8,10,0,0,2,0,17,12,0
1364,25927,OrVbBbY1FlOrLC1xq9uXlMrFdoBE11eg,SpATywNh6bZuzm8s1ceuBUnMUAeoAHHw,17,27,11,6,4,39,13,5,105,15.0,2,0.0,10,11,6,4,17,39,0,13,5,31,74,0
1365,25939,Krxyy23fZ28ymHlUM9cR68oteYOpMEoc,bWdj2GDclj5ofokWjzoa5jAwMkxCykd6,4,4,1,0,0,0,4,0,9,1.2857142857142858,1,0.0,2,1,0,0,2,0,0,4,0,3,6,0
1366,25944,Q0eCH09NIGOawcyrOKgsrxZbMJuOLuiw,7GRhBDsirIGkRZBtSMEzNTyDr2JQm4xx,1,0,0,0,0,0,3,0,3,0.42857142857142855,1,0.0,0,0,0,0,0,0,0,3,0,0,3,1
1367,25945,Xl7O5Es6VpkB2PrTgzArkv7OwJ7XzlEg,SpATywNh6bZuzm8s1ceuBUnMUAeoAHHw,18,46,17,12,7,24,14,1,121,17.285714285714285,3,0.0,21,17,12,7,25,24,0,14,1,57,64,0
1368,25956,iHFiZ9SvBVcIu7YGo4eFTUpkfFG44jX7,SpATywNh6bZuzm8s1ceuBUnMUAeoAHHw,16,37,13,17,4,4,28,2,105,15.0,4,0.0,11,13,14,4,26,4,3,28,2,42,63,0
1369,25959,E31WqWw5nCEWlSKgmhsOSj5j4T79ypCl,7GRhBDsirIGkRZBtSMEzNTyDr2JQm4xx,32,80,36,65,18,0,5,0,204,29.142857142857142,1,0.0,38,36,52,18,42,0,13,5,0,144,60,1
1370,26008,HPaJ9EDG8HjC5rpTdpwlfh4gznoH5Kdn,7GRhBDsirIGkRZBtSMEzNTyDr2JQm4xx,5,3,1,0,1,0,6,0,11,1.5714285714285714,1,0.0,0,1,0,1,3,0,0,6,0,2,9,1
1371,26020,Jag1EXQWfAuTRiCgcVLyhRRkdOL9RtSD,A3fsA9Zfv1X2fVEQhTw51lKENdNrEqT3,45,21,13,58,10,9,10,1,122,17.428571428571427,3,0.0,1,13,51,10,20,9,7,10,1,75,47,1
1372,26024,niLMw8MCObO7SSR2V1jNg9WQt5oSjDFJ,7GRhBDsirIGkRZBtSMEzNTyDr2JQm4xx,13,14,6,6,4,0,6,0,36,5.142857142857143,3,0.0,3,6,6,4,11,0,0,6,0,19,17,1
1373,26045,XDpGoHZOK8VrEEa7PvW4PqKqVXXJAMd4,7GRhBDsirIGkRZBtSMEzNTyDr2JQm4xx,19,22,11,0,10,0,6,0,49,7.0,1,0.0,8,11,0,10,14,0,0,6,0,29,20,1
1374,26064,bmnzCBeFMMY9XczD2LcVJyXeCKQk1fV4,bWdj2GDclj5ofokWjzoa5jAwMkxCykd6,4,0,0,0,0,4,5,0,9,1.2857142857142858,2,0.0,0,0,0,0,0,4,0,5,0,0,9,0
1375,26078,ByDjTuY0oLVzrle7JgW0XGlu5bLAo5Uj,SpATywNh6bZuzm8s1ceuBUnMUAeoAHHw,11,28,1,9,0,7,6,0,51,7.285714285714286,4,0.0,7,1,9,0,21,7,0,6,0,17,34,0
1376,26118,BoHg0aGtLUBHCRED1C89CbXgNAVI0w1o,7GRhBDsirIGkRZBtSMEzNTyDr2JQm4xx,7,5,1,0,0,0,4,0,10,1.4285714285714286,1,0.0,0,1,0,0,5,0,0,4,0,1,9,1
1377,26153,WDOhUt18DNMCYDEG35QkOfLroSJB0yOR,7GRhBDsirIGkRZBtSMEzNTyDr2JQm4xx,2,0,0,0,0,0,3,0,3,0.42857142857142855,1,0.0,0,0,0,0,0,0,0,3,0,0,3,0
1378,26214,SB3PBvXY4EEkcNDmtIOX6bpu8RFJOU8W,G8EPVSXsOYB5YQWZGiz1aVq5Pgr2GrQu,29,44,16,45,0,12,7,2,126,18.0,4,0.0,23,16,33,0,21,12,12,7,2,72,54,1
1379,26240,2EOw8IdpJR7gJqo77SwHRhwFw89UUu0T,7GRhBDsirIGkRZBtSMEzNTyDr2JQm4xx,1,0,0,0,0,0,1,0,1,0.14285714285714285,1,0.0,0,0,0,0,0,0,0,1,0,0,1,1
1380,26245,SrYdmWsdLgR34Xuoeb5msz3OavGm9rEt,SpATywNh6bZuzm8s1ceuBUnMUAeoAHHw,11,10,5,0,4,0,6,0,25,3.5714285714285716,2,0.0,0,5,0,4,10,0,0,6,0,9,16,0
1381,26268,tynbQ4TjTy74SqA5UqLPd55W0CYMmxkv,bWdj2GDclj5ofokWjzoa5jAwMkxCykd6,20,33,15,78,8,42,15,3,194,27.714285714285715,2,0.0,9,15,69,8,24,42,9,15,3,101,93,0
1382,26275,PSNpE96w64UzqJ7izDn4zKyoyc3uU8P4,SpATywNh6bZuzm8s1ceuBUnMUAeoAHHw,17,19,11,20,4,7,10,2,73,10.428571428571429,3,0.0,4,11,16,4,15,7,4,10,2,35,38,0
1383,26317,Ke04PwAVtaYumEPrCNIyUmIZgpnMElWJ,SpATywNh6bZuzm8s1ceuBUnMUAeoAHHw,12,27,12,5,6,0,6,0,56,8.0,3,0.0,0,12,4,6,27,0,1,6,0,22,34,1
1384,26327,WXFtCer94iMbYlxH69t15Pw03EngjneX,7GRhBDsirIGkRZBtSMEzNTyDr2JQm4xx,5,3,1,0,0,0,4,0,8,1.1428571428571428,2,0.0,0,1,0,0,3,0,0,4,0,1,7,1
1385,26340,nLSyDmuwtZ9VcSdeL7kW6FG97w0wmm94,SpATywNh6bZuzm8s1ceuBUnMUAeoAHHw,11,19,5,10,1,0,4,0,39,5.571428571428571,2,0.0,9,5,10,1,10,0,0,4,0,25,14,0
1386,26357,BNkiF9A7J88AJfBxuk7BTxSVookFJYSj,SpATywNh6bZuzm8s1ceuBUnMUAeoAHHw,13,19,0,17,0,25,14,2,77,11.0,2,0.0,5,0,15,0,14,25,2,14,2,20,57,0
1387,26398,x4ez09GGWUnioTSf6qckx5goNY5giLKq,7GRhBDsirIGkRZBtSMEzNTyDr2JQm4xx,28,72,35,87,6,11,16,1,228,32.57142857142857,4,0.0,26,35,76,6,46,11,11,16,1,143,85,0
1388,26399,Ke04PwAVtaYumEPrCNIyUmIZgpnMElWJ,A3fsA9Zfv1X2fVEQhTw51lKENdNrEqT3,7,6,4,0,3,0,3,0,16,2.2857142857142856,2,0.0,0,4,0,3,6,0,0,3,0,7,9,1
1389,26424,jDvQIlE5Sz6V9SpiJ3fC38kGJJ76UIjp,7GRhBDsirIGkRZBtSMEzNTyDr2JQm4xx,8,3,1,0,1,1,8,0,14,2.0,1,0.0,0,1,0,1,3,1,0,8,0,2,12,1
1390,26430,LqtuGUVCKWBEA86X4uy5b4ZjnXPoVVJt,SpATywNh6bZuzm8s1ceuBUnMUAeoAHHw,12,14,1,19,1,4,4,0,43,6.142857142857143,2,0.0,6,1,17,1,8,4,2,4,0,25,18,0
1391,26453,qIRkU6GTErqHGiePGqqQmQyg81Pc8mmk,SpATywNh6bZuzm8s1ceuBUnMUAeoAHHw,11,7,3,0,1,3,7,1,22,3.142857142857143,1,0.0,0,3,0,1,7,3,0,7,1,4,18,1
1392,26460,oNf6qoW6E6dhoPJKSUjvElFlUKN9drLY,SpATywNh6bZuzm8s1ceuBUnMUAeoAHHw,11,18,11,0,10,1,4,0,44,6.285714285714286,1,0.0,5,11,0,10,13,1,0,4,0,26,18,0
1393,26464,xioMf6frC9P8sc1cIrYLanKwZwDuxRiz,G8EPVSXsOYB5YQWZGiz1aVq5Pgr2GrQu,85,78,22,248,14,3,15,1,381,54.42857142857143,3,0.0,55,22,175,14,23,3,73,15,1,266,115,0
1394,26489,PD0QXI0Ip2PVwJ6kJaKkkINkj7BvGZMC,SpATywNh6bZuzm8s1ceuBUnMUAeoAHHw,6,6,0,0,0,0,3,0,9,1.2857142857142858,1,0.0,0,0,0,0,6,0,0,3,0,0,9,0
1395,26497,lHqsd1041AF6CV0C0CnR0FxJTQGWXgTK,SpATywNh6bZuzm8s1ceuBUnMUAeoAHHw,11,12,0,17,0,27,3,0,59,8.428571428571429,1,0.0,5,0,15,0,7,27,2,3,0,20,39,1
1396,26500,0jMOLkd6bX5LTqVnq5W50RF0alCjmWfd,SpATywNh6bZuzm8s1ceuBUnMUAeoAHHw,5,3,0,0,0,0,2,0,5,0.7142857142857143,1,0.0,0,0,0,0,3,0,0,2,0,0,5,0
1397,26514,IJmtizRHLdF3WotHNxwRcdFjzienWtJz,bWdj2GDclj5ofokWjzoa5jAwMkxCykd6,10,18,11,8,3,0,8,0,48,6.857142857142857,3,0.0,2,11,8,3,16,0,0,8,0,24,24,1
1398,26528,CiVcRubRqdt8MrzyUg75lzZmUZcaVQVo,SpATywNh6bZuzm8s1ceuBUnMUAeoAHHw,12,8,4,10,3,0,1,0,26,3.7142857142857144,1,0.0,3,4,10,3,5,0,0,1,0,20,6,0
1399,26561,kg6Avyi36lrn1xiUPv7mqR2okQaeNtUx,7GRhBDsirIGkRZBtSMEzNTyDr2JQm4xx,5,5,4,0,3,0,1,0,13,1.8571428571428572,1,0.0,0,4,0,3,5,0,0,1,0,7,6,1
1400,26574,kSTg1JLYdhltSJsPuKhUcTkKXIqnVUW2,SpATywNh6bZuzm8s1ceuBUnMUAeoAHHw,15,48,1,13,1,15,21,2,101,14.428571428571429,2,0.0,3,1,11,1,45,15,2,21,2,16,85,1
1401,26590,5pjAdY5K4FfgQPLSzQKwXaKF78ph9a0y,bWdj2GDclj5ofokWjzoa5jAwMkxCykd6,15,19,8,32,4,0,10,1,74,10.571428571428571,3,0.0,4,8,29,4,15,0,3,10,1,45,29,0
1402,26610,xzPjA6KrslcE6S6chFTjdwgsvoAelzjQ,G8EPVSXsOYB5YQWZGiz1aVq5Pgr2GrQu,66,66,15,112,9,3,15,1,221,31.571428571428573,4,0.0,46,15,65,9,20,3,47,15,1,135,86,0
1403,26624,bwFkbWIAdNVUMLQhE1w1MjvyFVabaAgW,SpATywNh6bZuzm8s1ceuBUnMUAeoAHHw,15,16,6,20,3,1,9,1,56,8.0,2,0.0,7,6,16,3,9,1,4,9,1,32,24,0
1404,26634,rrQbAPV4QBpP2BW10bzZtz96beXLch00,SpATywNh6bZuzm8s1ceuBUnMUAeoAHHw,14,19,14,6,12,17,6,0,74,10.571428571428571,1,0.0,4,14,6,12,15,17,0,6,0,36,38,1
1405,26640,RbUxQb46RHLKt8MRdcRI6KFNQeGEWd4E,7GRhBDsirIGkRZBtSMEzNTyDr2JQm4xx,34,72,23,36,11,11,17,3,173,24.714285714285715,5,0.0,42,23,32,11,30,11,4,17,3,108,65,1
1406,26655,hkI32MAgHvJ4T3I3Up79daEJ8l4sKHaC,7GRhBDsirIGkRZBtSMEzNTyDr2JQm4xx,7,4,2,2,2,0,1,0,11,1.5714285714285714,1,0.0,1,2,2,2,3,0,0,1,0,7,4,1
1407,26657,KPcfuz5VL4gtxrf9oXg3NuCUgo5lfp0J,7GRhBDsirIGkRZBtSMEzNTyDr2JQm4xx,16,26,3,19,0,1,9,1,59,8.428571428571429,3,0.0,8,3,18,0,18,1,1,9,1,29,30,1
1408,26763,6gAyvwJKSeHOrljTS7vTc1U71cPBh7nb,RXDvfPUBYFlVdlueBFbLW0mhhAyGEqpt,41,67,5,77,2,0,7,0,158,22.571428571428573,3,0.0,8,5,73,2,59,0,4,7,0,88,70,0
1409,26770,H7bZ54NuzkB5Nw5q0ZI1nld9qDoHNngL,7GRhBDsirIGkRZBtSMEzNTyDr2JQm4xx,4,2,1,0,0,0,2,0,5,0.7142857142857143,1,0.0,0,1,0,0,2,0,0,2,0,1,4,1
1410,26774,HQOz3dJ2hZ8qbl5l8pp7OKuPIeM9Xh55,G8EPVSXsOYB5YQWZGiz1aVq5Pgr2GrQu,32,50,25,56,10,4,7,3,155,22.142857142857142,1,0.0,19,25,43,10,31,4,13,7,3,97,58,0
1411,26801,q2xQCstASp96wpspi8iqsuaqJ7gzfsux,SpATywNh6bZuzm8s1ceuBUnMUAeoAHHw,11,11,6,12,0,0,3,0,32,4.571428571428571,2,0.0,3,6,9,0,8,0,3,3,0,18,14,0
1412,26812,8b4CSrjMjmc5Jmqnv833uCnAad4TIcFZ,A3fsA9Zfv1X2fVEQhTw51lKENdNrEqT3,39,16,14,92,13,3,6,0,144,20.571428571428573,2,0.0,1,14,78,13,15,3,14,6,0,106,38,0
1413,26816,HCwyZ32TalGxA6ZNHNOB04su4fWSeWBj,A3fsA9Zfv1X2fVEQhTw51lKENdNrEqT3,19,15,9,0,6,2,8,1,41,5.857142857142857,3,0.0,0,9,0,6,15,2,0,8,1,15,26,0
1414,26823,oidXTGaCUuuF1QPNvhmiPoqhWsTY245r,7GRhBDsirIGkRZBtSMEzNTyDr2JQm4xx,10,9,4,0,3,0,2,0,18,2.5714285714285716,3,0.0,0,4,0,3,9,0,0,2,0,7,11,1
1415,26877,nE23LYiQpabdXkj6YvKSja9sZnHRizmo,bWdj2GDclj5ofokWjzoa5jAwMkxCykd6,7,11,2,0,0,10,6,0,29,4.142857142857143,6,0.0,0,2,0,0,11,10,0,6,0,2,27,0
1416,26902,wlMzjZIA65JiQ9JE1VQhTzG17NZZPeo3,SpATywNh6bZuzm8s1ceuBUnMUAeoAHHw,18,98,15,38,5,4,36,1,197,28.142857142857142,7,0.0,36,15,28,5,62,4,10,36,1,84,113,0
1417,26903,1YVr5Tebgu8QXWBg3164QQg1YdmUcYYo,7GRhBDsirIGkRZBtSMEzNTyDr2JQm4xx,6,9,3,0,1,2,6,0,21,3.0,1,0.0,0,3,0,1,9,2,0,6,0,4,17,1
1418,26907,sTDzO3bjgLIIYNoWgHN2HiaPZw68DTyo,7GRhBDsirIGkRZBtSMEzNTyDr2JQm4xx,8,10,5,0,3,1,4,1,24,3.4285714285714284,2,0.0,0,5,0,3,10,1,0,4,1,8,16,0
1419,26928,0eeJP6MiDq1cOnP8cGxNMZEXCvgY0tHY,SpATywNh6bZuzm8s1ceuBUnMUAeoAHHw,13,24,8,18,3,1,1,0,55,7.857142857142857,1,0.0,13,8,15,3,11,1,3,1,0,39,16,0
1420,26931,luNGlNTmJ26UVXohAPNf4yZNgIUDcpxK,SpATywNh6bZuzm8s1ceuBUnMUAeoAHHw,12,16,9,2,3,0,6,0,36,5.142857142857143,5,0.0,1,9,2,3,15,0,0,6,0,15,21,0
1421,26955,V44Q36yyz0HxZhlrCwrLJjYwv8UzqoCn,A3fsA9Zfv1X2fVEQhTw51lKENdNrEqT3,4,3,1,0,0,0,1,0,5,0.7142857142857143,1,0.0,0,1,0,0,3,0,0,1,0,1,4,1
1422,27085,Y1uVq657IWCue4abNsh62IVHKtmwsQHQ,SpATywNh6bZuzm8s1ceuBUnMUAeoAHHw,12,6,4,0,3,2,6,1,22,3.142857142857143,1,0.0,0,4,0,3,6,2,0,6,1,7,15,0
1423,27087,1sf1a7OMEvwky5hvLFD12TaOsmoNw2Qb,G8EPVSXsOYB5YQWZGiz1aVq5Pgr2GrQu,23,50,27,54,12,0,11,0,154,22.0,4,0.0,2,27,45,12,48,0,9,11,0,86,68,0
1424,27114,aI6LGLI5TSvCsqcL1v38BDwXz2AdVe9U,7GRhBDsirIGkRZBtSMEzNTyDr2JQm4xx,1,0,0,0,0,0,1,0,1,0.14285714285714285,1,0.0,0,0,0,0,0,0,0,1,0,0,1,1
1425,27140,9zKzyrDc2ZLmZJn8iNzeeCTIcbRbidfo,A3fsA9Zfv1X2fVEQhTw51lKENdNrEqT3,6,6,2,0,1,0,2,0,11,1.5714285714285714,1,0.0,0,2,0,1,6,0,0,2,0,3,8,0
1426,27145,5pjAdY5K4FfgQPLSzQKwXaKF78ph9a0y,A3fsA9Zfv1X2fVEQhTw51lKENdNrEqT3,27,15,12,6,11,1,9,0,54,7.714285714285714,3,0.0,2,12,6,11,13,1,0,9,0,31,23,0
1427,27154,zi3yOAhUK1J3AbYoEq9VqjXWOhiWlKvY,SpATywNh6bZuzm8s1ceuBUnMUAeoAHHw,15,46,2,20,1,24,8,1,102,14.571428571428571,4,0.0,19,2,17,1,27,24,3,8,1,39,63,0
1428,27206,5pjAdY5K4FfgQPLSzQKwXaKF78ph9a0y,7GRhBDsirIGkRZBtSMEzNTyDr2JQm4xx,7,20,6,0,1,0,5,0,32,4.571428571428571,3,0.0,8,6,0,1,12,0,0,5,0,15,17,0
1429,27209,147kfUKOVzUnQEgEhu4oFkvvuFRbAg9Y,bWdj2GDclj5ofokWjzoa5jAwMkxCykd6,7,8,4,0,1,6,5,1,25,3.5714285714285716,3,0.0,0,4,0,1,8,6,0,5,1,5,20,1
1430,27213,S0nQm2eOAlSxKM1RfeGoUgB4GQEZsJ1U,SpATywNh6bZuzm8s1ceuBUnMUAeoAHHw,17,37,13,17,8,19,26,11,131,18.714285714285715,2,0.0,12,13,15,8,25,19,2,26,11,48,83,0
1431,27229,vvW1UkV9WqtfmPMhz7QIGvDdFqIvY2j3,7GRhBDsirIGkRZBtSMEzNTyDr2JQm4xx,1,0,0,0,0,0,1,0,1,0.14285714285714285,1,0.0,0,0,0,0,0,0,0,1,0,0,1,1
1432,27230,uciz4weP1kSziQB1Oe1Psu4CdK1uNqzl,SpATywNh6bZuzm8s1ceuBUnMUAeoAHHw,12,21,9,19,3,5,6,2,65,9.285714285714286,1,0.0,8,9,16,3,13,5,3,6,2,36,29,0
1433,27257,ilQqtG05VEreri5rVwRPOodDRvBSi2Yp,7GRhBDsirIGkRZBtSMEzNTyDr2JQm4xx,6,9,0,2,0,0,2,0,13,1.8571428571428572,1,0.0,1,0,2,0,8,0,0,2,0,3,10,1
1434,27261,xk5bwSTEAMNKyEU3iNkOO0oTip8zPc6K,7GRhBDsirIGkRZBtSMEzNTyDr2JQm4xx,3,0,0,0,0,3,3,0,6,0.8571428571428571,1,0.0,0,0,0,0,0,3,0,3,0,0,6,1
1435,27263,X5ugOWLhdmTxo3CYqfXWDVoDsvjcSnkc,SpATywNh6bZuzm8s1ceuBUnMUAeoAHHw,17,31,15,12,5,7,14,2,86,12.285714285714286,4,0.0,9,15,11,5,22,7,1,14,2,40,46,0
1436,27277,DTD40RjYwLBuwaHKa3c3iphTurXVm83S,7GRhBDsirIGkRZBtSMEzNTyDr2JQm4xx,2,0,0,0,0,0,3,0,3,0.42857142857142855,1,0.0,0,0,0,0,0,0,0,3,0,0,3,1
1437,27284,0vYe49xmwT3tPlTtY6ubPLznONbIxbXe,7GRhBDsirIGkRZBtSMEzNTyDr2JQm4xx,5,6,2,0,0,0,5,0,13,1.8571428571428572,1,0.0,0,2,0,0,6,0,0,5,0,2,11,1
1438,27306,tTMyaWTlizKdT72ief23Wjd2wqSzEHSk,bWdj2GDclj5ofokWjzoa5jAwMkxCykd6,2,0,0,0,0,0,3,0,3,0.42857142857142855,1,0.0,0,0,0,0,0,0,0,3,0,0,3,0
1439,27313,rUrD3vOZKxi004QKs8MuR2Ws6PqRB5Bd,SpATywNh6bZuzm8s1ceuBUnMUAeoAHHw,12,14,6,18,3,0,1,0,42,6.0,1,0.0,7,6,16,3,7,0,2,1,0,32,10,1
1440,27318,qOCeRyabO4TOWDJBtcnFq6ksxPSapJ0M,7GRhBDsirIGkRZBtSMEzNTyDr2JQm4xx,6,6,1,0,1,0,2,0,10,1.4285714285714286,1,0.0,0,1,0,1,6,0,0,2,0,2,8,1
1441,27386,jQaCxlcrIW3B0ti76HtzjtRZOLJHPbzy,RXDvfPUBYFlVdlueBFbLW0mhhAyGEqpt,18,38,22,0,1,106,28,16,211,30.142857142857142,5,0.0,0,22,0,1,38,106,0,28,16,23,188,0
1442,27387,FFlICu8a1PeaY8oKBFESJAT3q6I5h6Xu,SpATywNh6bZuzm8s1ceuBUnMUAeoAHHw,10,25,11,4,2,4,6,0,52,7.428571428571429,3,0.0,6,11,3,2,19,4,1,6,0,22,30,0
1443,27397,bdtPawZirEzy4zJwBHLye0XuKdBDsRNa,7GRhBDsirIGkRZBtSMEzNTyDr2JQm4xx,1,0,0,0,0,0,1,0,1,0.14285714285714285,1,0.0,0,0,0,0,0,0,0,1,0,0,1,1
1444,27401,BvCRPlMfMau2kDEBEjyV1l6RJMQy5B5l,7GRhBDsirIGkRZBtSMEzNTyDr2JQm4xx,14,24,7,42,0,0,4,0,77,11.0,1,0.0,9,7,34,0,15,0,8,4,0,50,27,1
1445,27402,GDOD5H0bl28RO8whBIu6B8qS2nGsRznY,A3fsA9Zfv1X2fVEQhTw51lKENdNrEqT3,4,2,1,0,1,0,1,0,5,0.7142857142857143,1,0.0,0,1,0,1,2,0,0,1,0,2,3,1
1446,27441,xaMkz5ExnwaMxZxilE1ZpVj0K68325xB,7GRhBDsirIGkRZBtSMEzNTyDr2JQm4xx,31,63,22,42,12,0,6,0,145,20.714285714285715,2,0.0,18,22,36,12,45,0,6,6,0,88,57,1
1447,27445,M5fmtGmpo2DUfH2kBcBzBwkDFjGnGDqf,7GRhBDsirIGkRZBtSMEzNTyDr2JQm4xx,12,19,1,0,0,17,4,0,41,5.857142857142857,1,0.0,1,1,0,0,18,17,0,4,0,2,39,1
1448,27448,h5vEAVTb94xGNGjpn4Ohi5mNcXfM0rMl,7GRhBDsirIGkRZBtSMEzNTyDr2JQm4xx,17,47,5,3,6,0,8,0,69,9.857142857142858,3,0.0,15,5,3,6,32,0,0,8,0,29,40,1
1449,27464,XLmXRx6QIJBEWZLK5otMq8wfQNXonT4D,SpATywNh6bZuzm8s1ceuBUnMUAeoAHHw,9,13,3,4,3,0,1,0,24,3.4285714285714284,1,0.0,2,3,4,3,11,0,0,1,0,12,12,0
1450,27466,rQQvHNajcjjfIyLOReFtjaD8d9v2FigP,7GRhBDsirIGkRZBtSMEzNTyDr2JQm4xx,3,0,0,0,0,0,5,0,5,0.7142857142857143,1,0.0,0,0,0,0,0,0,0,5,0,0,5,1
1451,27473,xYJiCXQflcZ5NTqhkCBqQygWsRlPt9ao,7GRhBDsirIGkRZBtSMEzNTyDr2JQm4xx,4,4,2,0,0,42,2,0,50,7.142857142857143,2,0.0,1,2,0,0,3,42,0,2,0,3,47,1
1452,27475,mEMC3mPRFcLDpf0MVM7Pji9FNHa590x9,SpATywNh6bZuzm8s1ceuBUnMUAeoAHHw,9,5,2,12,0,7,5,0,31,4.428571428571429,1,0.0,2,2,9,0,3,7,3,5,0,13,18,1
1453,27477,pz4WzmrapGULqEk99lfOZVzJbwiC2Cl1,SpATywNh6bZuzm8s1ceuBUnMUAeoAHHw,8,6,0,6,0,0,4,0,16,2.2857142857142856,2,0.0,2,0,6,0,4,0,0,4,0,8,8,0
1454,27478,dgp1qm7PjXoVV4MjyzuvWetQrJ3T9kos,7GRhBDsirIGkRZBtSMEzNTyDr2JQm4xx,35,93,42,48,19,51,28,6,287,41.0,3,0.0,41,42,45,19,52,51,3,28,6,147,140,1
1455,27491,9Nmjm4BvnbKTQ3ZZwECYdKy9zBNGmQNW,7GRhBDsirIGkRZBtSMEzNTyDr2JQm4xx,1,0,0,0,0,0,1,0,1,0.14285714285714285,1,0.0,0,0,0,0,0,0,0,1,0,0,1,1
1456,27523,8ga3z0NKN1WQ3YzAZr5NtUzbD9BjtY0C,G8EPVSXsOYB5YQWZGiz1aVq5Pgr2GrQu,5,2,1,0,1,0,6,0,10,1.4285714285714286,2,0.0,0,1,0,1,2,0,0,6,0,2,8,0
1457,27541,4LLdV2zTWS697dAsOgAPJZPFwfNnrjt6,A3fsA9Zfv1X2fVEQhTw51lKENdNrEqT3,3,2,0,0,0,0,2,0,4,0.5714285714285714,2,0.0,0,0,0,0,2,0,0,2,0,0,4,1
1458,30652,c0SE05tRjiEOaThvWcYxSYbAxboLNaZo,7GRhBDsirIGkRZBtSMEzNTyDr2JQm4xx,24,46,1,40,9,7,22,2,127,18.142857142857142,2,0.0,26,1,35,9,20,7,5,22,2,71,56,0
1459,30661,Da2YYkrh9YuRinihWxRQSQhXAdFeKqSb,7GRhBDsirIGkRZBtSMEzNTyDr2JQm4xx,10,7,3,8,4,0,2,0,24,3.4285714285714284,1,0.0,3,3,6,4,4,0,2,2,0,16,8,0
1460,30662,4Y6ySID5iQf80xGHEGKPq13tPSHHOAOF,7GRhBDsirIGkRZBtSMEzNTyDr2JQm4xx,7,10,5,0,0,0,4,0,19,2.7142857142857144,2,0.0,0,5,0,0,10,0,0,4,0,5,14,0
1461,30690,AcpmcKbkGL0wHG2z3MmcGuG9z6KsBEJe,7GRhBDsirIGkRZBtSMEzNTyDr2JQm4xx,26,41,21,32,12,3,7,0,116,16.571428571428573,4,0.0,13,21,26,12,28,3,6,7,0,72,44,0
1462,30717,Upqz62cwWKexlUMk4uvP9aosOnbcADgX,7GRhBDsirIGkRZBtSMEzNTyDr2JQm4xx,1,0,0,0,0,0,1,0,1,0.14285714285714285,1,0.0,0,0,0,0,0,0,0,1,0,0,1,0
1463,30722,N0Sos51WanCzoSGKDmMPzQtMlLxY3bFb,7GRhBDsirIGkRZBtSMEzNTyDr2JQm4xx,49,93,40,72,27,32,45,1,310,44.285714285714285,5,0.0,35,40,63,27,58,32,9,45,1,165,145,0
1464,30742,m7YQyhtMcEUVm4YEl0ls7E37ljO7KzRy,7GRhBDsirIGkRZBtSMEzNTyDr2JQm4xx,27,62,22,28,11,2,8,0,133,19.0,4,0.0,34,22,26,11,28,2,2,8,0,93,40,0
1465,30747,tLopTDeUShprCRgfwS3p7Zbir4u3Yxe8,7GRhBDsirIGkRZBtSMEzNTyDr2JQm4xx,10,13,7,6,4,0,1,0,31,4.428571428571429,1,0.0,5,7,5,4,8,0,1,1,0,21,10,1
1466,30750,yk7hISr9k5KlTllac6P28wE1wuN0cd27,7GRhBDsirIGkRZBtSMEzNTyDr2JQm4xx,30,61,0,79,15,6,14,1,176,25.142857142857142,2,0.0,39,0,67,15,22,6,12,14,1,121,55,0
1467,30776,YtymNq1ebo5JQ6VlWg3H52cMIU1je3tP,SpATywNh6bZuzm8s1ceuBUnMUAeoAHHw,14,14,8,16,6,3,3,0,50,7.142857142857143,2,0.0,4,8,14,6,10,3,2,3,0,32,18,0
1468,30797,S0OJjF6aof0iTnIX6lUAxekoH3m4w7V0,bWdj2GDclj5ofokWjzoa5jAwMkxCykd6,19,34,18,34,6,57,12,1,162,23.142857142857142,3,0.0,7,18,28,6,27,57,6,12,1,59,103,0
1469,30824,VpttOLX6WfGZBZLZt8acfk7430VwqHRi,RXDvfPUBYFlVdlueBFbLW0mhhAyGEqpt,42,54,1,110,3,3,13,1,185,26.428571428571427,2,0.0,17,1,98,3,37,3,12,13,1,119,66,1
1470,30830,Uj0YzcfvBcWRuM5ooqhtOKSU0RtOgHEO,SpATywNh6bZuzm8s1ceuBUnMUAeoAHHw,1,0,0,0,0,0,2,0,2,0.2857142857142857,1,0.0,0,0,0,0,0,0,0,2,0,0,2,0
1471,30842,aacyvESmAfP5D5oPQjdLdL2QR8GRVLet,SpATywNh6bZuzm8s1ceuBUnMUAeoAHHw,16,51,27,13,16,49,11,1,168,24.0,2,0.0,12,27,11,16,39,49,2,11,1,66,102,0
1472,30844,BzAEXi273boWm5fg8ZX5MfzoC5AJdE3M,SpATywNh6bZuzm8s1ceuBUnMUAeoAHHw,16,17,11,13,6,2,9,0,58,8.285714285714286,2,0.0,2,11,11,6,15,2,2,9,0,30,28,1
1473,30851,dEqFTu442IbDfPtop0GcM4lzz1lxVMo1,7GRhBDsirIGkRZBtSMEzNTyDr2JQm4xx,31,103,41,87,11,2,5,0,249,35.57142857142857,5,0.0,34,41,74,11,69,2,13,5,0,160,89,0
1474,30861,Ip3irZsxFvOeGg8WSppVhJArbPhoH3qm,SpATywNh6bZuzm8s1ceuBUnMUAeoAHHw,16,33,13,22,6,3,9,0,86,12.285714285714286,3,0.0,8,13,19,6,25,3,3,9,0,46,40,0
1475,30870,GpbDOMkrqaLXOPkd8jI4TxThJAZPGWSK,SpATywNh6bZuzm8s1ceuBUnMUAeoAHHw,17,31,13,19,6,17,10,1,97,13.857142857142858,4,0.0,8,13,16,6,23,17,3,10,1,43,54,0
1476,30871,3IgwuZBiVdgdYRQ9ySaEvpMizbjCJFS0,7GRhBDsirIGkRZBtSMEzNTyDr2JQm4xx,31,78,24,60,18,36,8,0,224,32.0,4,0.0,35,24,47,18,43,36,13,8,0,124,100,1
1477,30889,9MbsP03nqyzNF8ytIM40Tx9W50TUxwHO,SpATywNh6bZuzm8s1ceuBUnMUAeoAHHw,4,10,2,0,0,0,9,0,21,3.0,3,0.0,0,2,0,0,10,0,0,9,0,2,19,0
1478,30905,5GkxvaD11peDsZoT8jF1pQZKBzcvYxOV,G8EPVSXsOYB5YQWZGiz1aVq5Pgr2GrQu,15,17,5,24,0,8,11,1,66,9.428571428571429,3,0.0,9,5,19,0,8,8,5,11,1,33,33,0
1479,30907,LKEJY5MvP0gj7M4NL5iRnXDBazXBKsOA,SpATywNh6bZuzm8s1ceuBUnMUAeoAHHw,17,129,55,14,9,94,52,9,362,51.714285714285715,3,0.0,31,55,12,9,98,94,2,52,9,107,255,0
1480,30948,CfeENerIdAGepleePWSt0SV88ctt0Tmw,G8EPVSXsOYB5YQWZGiz1aVq5Pgr2GrQu,79,95,25,168,15,0,5,1,309,44.142857142857146,6,0.0,45,25,116,15,50,0,52,5,1,201,108,0
1481,30959,hjUSUM6roI2mLGkMAqBjE0uxFRBSMYHJ,SpATywNh6bZuzm8s1ceuBUnMUAeoAHHw,14,36,18,12,10,9,8,0,93,13.285714285714286,3,0.0,10,18,9,10,26,9,3,8,0,47,46,0
1482,30987,xVvNMYPAdkOMbR8cyTeqVHpVoO8wZQ2b,7GRhBDsirIGkRZBtSMEzNTyDr2JQm4xx,6,9,2,0,1,4,6,0,22,3.142857142857143,2,0.0,1,2,0,1,8,4,0,6,0,4,18,1
1483,31001,oTQ81PqeruuETb6SukxAp0sOazRUpE32,7GRhBDsirIGkRZBtSMEzNTyDr2JQm4xx,30,47,15,48,13,11,6,0,140,20.0,4,0.0,28,15,41,13,19,11,7,6,0,97,43,1
1484,31010,u8YPaORaz1zRBmx3Zp1zm30bQFzwDInM,SpATywNh6bZuzm8s1ceuBUnMUAeoAHHw,16,35,14,33,7,80,23,3,195,27.857142857142858,3,0.0,10,14,27,7,25,80,6,23,3,58,137,0
1485,31012,t069DROGMOy4O12B9Ty0yznUmNUBGFUp,7GRhBDsirIGkRZBtSMEzNTyDr2JQm4xx,4,2,1,0,1,0,1,0,5,0.7142857142857143,1,0.0,0,1,0,1,2,0,0,1,0,2,3,1
1486,31062,CfeENerIdAGepleePWSt0SV88ctt0Tmw,A3fsA9Zfv1X2fVEQhTw51lKENdNrEqT3,1,0,0,0,0,0,1,0,1,0.14285714285714285,1,0.0,0,0,0,0,0,0,0,1,0,0,1,1
1487,31080,6U2xPMo27MRkbrPflG5WrvgHD37CuMpR,7GRhBDsirIGkRZBtSMEzNTyDr2JQm4xx,6,4,1,0,1,0,2,0,8,1.1428571428571428,1,0.0,0,1,0,1,4,0,0,2,0,2,6,1
1488,31089,MxVVcAtMSnLQjlvLOx5XySlZblFVugTc,SpATywNh6bZuzm8s1ceuBUnMUAeoAHHw,10,31,0,5,0,0,12,0,48,6.857142857142857,3,0.0,0,0,4,0,31,0,1,12,0,4,44,0
1489,31137,JP79INNRcQzkUx6dZie4v1QvuMQ7OVUy,RXDvfPUBYFlVdlueBFbLW0mhhAyGEqpt,5,4,0,0,0,0,6,0,10,1.4285714285714286,2,0.0,0,0,0,0,4,0,0,6,0,0,10,0
1490,31162,tq5rSafpJQn5saVcMLWCPKYcu2G69rbK,7GRhBDsirIGkRZBtSMEzNTyDr2JQm4xx,9,5,3,0,2,0,7,0,17,2.4285714285714284,1,0.0,0,3,0,2,5,0,0,7,0,5,12,1
1491,31176,In25hAYYA32yjVT3Fete5XUoGWlQgd5t,G8EPVSXsOYB5YQWZGiz1aVq5Pgr2GrQu,5,2,1,0,1,0,3,0,7,1.0,1,0.0,0,1,0,1,2,0,0,3,0,2,5,0
1492,31187,s6iksgptFmyh2vfiarKdJkiKnp6RLi3f,G8EPVSXsOYB5YQWZGiz1aVq5Pgr2GrQu,10,6,3,0,1,6,6,0,22,3.142857142857143,1,0.0,0,3,0,1,6,6,0,6,0,4,18,0
1493,31214,s6iksgptFmyh2vfiarKdJkiKnp6RLi3f,bWdj2GDclj5ofokWjzoa5jAwMkxCykd6,6,5,1,0,1,6,3,0,16,2.2857142857142856,1,0.0,0,1,0,1,5,6,0,3,0,2,14,0
1494,31216,VvIsuXfKScxQtpB88WTGf8JMf9TTXDon,SpATywNh6bZuzm8s1ceuBUnMUAeoAHHw,4,2,1,0,1,0,1,0,5,0.7142857142857143,1,0.0,0,1,0,1,2,0,0,1,0,2,3,0
1495,31271,WL2pmxbGb1jmTh21fuUuAtLcak4ndNX3,SpATywNh6bZuzm8s1ceuBUnMUAeoAHHw,13,21,6,18,2,2,3,0,52,7.428571428571429,1,0.0,8,6,15,2,13,2,3,3,0,31,21,1
1496,31282,U04y5vFf0AfyJVGIOJHlryTyRQEOm5pT,SpATywNh6bZuzm8s1ceuBUnMUAeoAHHw,14,13,7,15,3,0,3,0,41,5.857142857142857,2,0.0,2,7,14,3,11,0,1,3,0,26,15,0
1497,31294,wAJGUOfaMNSu8fVs50XbquwP1qlCP18o,7GRhBDsirIGkRZBtSMEzNTyDr2JQm4xx,66,212,62,123,47,42,17,1,504,72.0,4,0.0,120,62,94,47,92,42,29,17,1,323,181,0
1498,31315,flpVPPsUWfhNx2m3NGTbdkxp57HITcVF,SpATywNh6bZuzm8s1ceuBUnMUAeoAHHw,18,56,20,15,8,6,18,1,124,17.714285714285715,3,0.0,25,20,12,8,31,6,3,18,1,65,59,0
1499,31322,HgQbl59wfMZ62eOeVscJctviZYi0GAnj,SpATywNh6bZuzm8s1ceuBUnMUAeoAHHw,12,15,8,18,4,3,1,0,49,7.0,1,0.0,6,8,16,4,9,3,2,1,0,34,15,0
1500,31327,MjVksKClEDbwKLDQ3ID6os0AiFzU5BN2,7GRhBDsirIGkRZBtSMEzNTyDr2JQm4xx,1,0,0,0,0,0,1,0,1,0.14285714285714285,1,0.0,0,0,0,0,0,0,0,1,0,0,1,1
1501,31329,ZuXB7SoEgVCDuS66pcJ2jF54Mdbn2Nuz,SpATywNh6bZuzm8s1ceuBUnMUAeoAHHw,4,5,1,0,0,0,1,0,7,1.0,3,0.0,0,1,0,0,5,0,0,1,0,1,6,0
1502,31335,XqfKw12BYBxvQyUszKCvSmcUn4H9qRJJ,7GRhBDsirIGkRZBtSMEzNTyDr2JQm4xx,19,50,13,40,8,5,13,0,129,18.428571428571427,4,0.0,30,13,33,8,20,5,7,13,0,84,45,1
1503,31349,RAFVAKoL6cQatcQ8rTN5mIwPhy02koDR,A3fsA9Zfv1X2fVEQhTw51lKENdNrEqT3,13,29,15,0,2,12,8,0,66,9.428571428571429,2,0.0,1,15,0,2,28,12,0,8,0,18,48,0
1504,31368,q15es4hix4DJR5zOH0N1aGsdTpjonWNC,SpATywNh6bZuzm8s1ceuBUnMUAeoAHHw,17,28,5,20,3,40,19,1,116,16.571428571428573,4,0.0,9,5,16,3,19,40,4,19,1,33,83,0
1505,31414,StcFIgK5T4YiiLiOpPHFjzohTVz9Jaf7,A3fsA9Zfv1X2fVEQhTw51lKENdNrEqT3,20,33,15,0,10,0,2,0,60,8.571428571428571,2,0.0,0,15,0,10,33,0,0,2,0,25,35,0
1506,31419,o7pzdRTO1dnxuhf9kxurH0oMz67aa1kw,SpATywNh6bZuzm8s1ceuBUnMUAeoAHHw,8,6,1,8,0,0,2,0,17,2.4285714285714284,1,0.0,2,1,8,0,4,0,0,2,0,11,6,1
1507,31446,Sg3DXxUJJ7e58r0b7OHd09yiv7acnFU0,SpATywNh6bZuzm8s1ceuBUnMUAeoAHHw,13,23,10,21,7,4,5,0,70,10.0,3,0.0,12,10,18,7,11,4,3,5,0,47,23,0
1508,31455,AX9Hte0A6zp61WUmhFkv1rU3P0cKffFQ,SpATywNh6bZuzm8s1ceuBUnMUAeoAHHw,12,18,5,16,1,0,5,0,45,6.428571428571429,3,0.0,5,5,15,1,13,0,1,5,0,26,19,0
1509,31479,8jqDD2phXiMGQf0XQi1kVRzLj3TILO0y,bWdj2GDclj5ofokWjzoa5jAwMkxCykd6,1,0,0,0,0,0,1,0,1,0.14285714285714285,1,0.0,0,0,0,0,0,0,0,1,0,0,1,1
1510,31493,iGNqI0WQkdTRPPMB99MG4DRoKjQuEfCJ,SpATywNh6bZuzm8s1ceuBUnMUAeoAHHw,10,14,5,0,3,0,5,0,27,3.857142857142857,5,0.0,0,5,0,3,14,0,0,5,0,8,19,0
1511,31509,oyStFfS7Y0XvpvDI8JwDIhnFdZZl3Ixl,SpATywNh6bZuzm8s1ceuBUnMUAeoAHHw,11,11,0,12,0,1,6,0,30,4.285714285714286,2,0.0,6,0,12,0,5,1,0,6,0,18,12,0
1512,31513,XBCkMYdRHaBwbyaKg5wVLPpzX1Jqu9p0,7GRhBDsirIGkRZBtSMEzNTyDr2JQm4xx,8,8,2,0,4,0,2,0,16,2.2857142857142856,1,0.0,4,2,0,4,4,0,0,2,0,10,6,1
1513,31521,SQBW44VzMb5zXQWTfzFzAP2RU7qxP2su,bWdj2GDclj5ofokWjzoa5jAwMkxCykd6,4,2,1,0,1,0,2,0,6,0.8571428571428571,1,0.0,0,1,0,1,2,0,0,2,0,2,4,1
1514,31532,oNX40hvUpCseO8BHKhGJvG2jyQpYKQyk,RXDvfPUBYFlVdlueBFbLW0mhhAyGEqpt,21,27,2,30,3,7,13,1,83,11.857142857142858,4,0.0,5,2,30,3,22,7,0,13,1,40,43,0
1515,31540,fenn4oQ5cZO7k0rG5qWqM8q00nrCNGWN,G8EPVSXsOYB5YQWZGiz1aVq5Pgr2GrQu,9,10,2,0,2,2,6,0,22,3.142857142857143,1,0.0,0,2,0,2,10,2,0,6,0,4,18,0
1516,31557,H3GbKrAtFVtLEXWNNdFaZDFbuKQIUVPU,SpATywNh6bZuzm8s1ceuBUnMUAeoAHHw,16,29,19,12,7,10,11,0,88,12.571428571428571,5,0.0,4,19,12,7,25,10,0,11,0,42,46,0
1517,31568,c49ANcMlFceMxZBmI2dFNiETx72UlFpt,SpATywNh6bZuzm8s1ceuBUnMUAeoAHHw,17,53,19,22,5,32,32,0,163,23.285714285714285,7,0.0,8,19,19,5,45,32,3,32,0,51,112,0
1518,31575,VYkkz2UClMIV09P0Xfa0EEIHkYXDA8gf,SpATywNh6bZuzm8s1ceuBUnMUAeoAHHw,15,33,2,25,2,34,6,1,103,14.714285714285714,2,0.0,13,2,21,2,20,34,4,6,1,38,65,1
1519,31630,uqaaAh63woEl1GEmEsDUSC0vwOZYZP0g,G8EPVSXsOYB5YQWZGiz1aVq5Pgr2GrQu,9,7,3,8,3,0,1,0,22,3.142857142857143,1,0.0,3,3,7,3,4,0,1,1,0,16,6,1
1520,31631,OcchkIht8b8QIrrapp5dUsDP9GE3Vfdw,SpATywNh6bZuzm8s1ceuBUnMUAeoAHHw,2,0,0,0,0,0,2,0,2,0.2857142857142857,1,0.0,0,0,0,0,0,0,0,2,0,0,2,0
1521,31636,8V9pnrkvwK33pI3AiYSlsgxV7TeKgfNZ,G8EPVSXsOYB5YQWZGiz1aVq5Pgr2GrQu,17,39,16,8,8,37,14,1,123,17.571428571428573,2,0.0,6,16,5,8,33,37,3,14,1,35,88,0
1522,31637,5vZRuON34JUuUxkGF08Mu94iTiQzZas4,RXDvfPUBYFlVdlueBFbLW0mhhAyGEqpt,48,55,31,116,13,2,15,12,244,34.857142857142854,2,0.0,14,31,103,13,41,2,13,15,12,161,83,0
1523,31683,YTga640T6i241jGBhxN7pUtNHHrQTFGS,7GRhBDsirIGkRZBtSMEzNTyDr2JQm4xx,10,12,3,14,1,1,1,0,32,4.571428571428571,1,0.0,8,3,12,1,4,1,2,1,0,24,8,1
1524,31695,yWhbSfRhq0GQaIid8lmuGTuOjD7iQVVR,SpATywNh6bZuzm8s1ceuBUnMUAeoAHHw,16,56,19,15,6,34,10,0,140,20.0,1,0.0,31,19,12,6,25,34,3,10,0,68,72,1
1525,31730,a4RYqILKcnu8c617gYSbD0KQIm9DqZnc,SpATywNh6bZuzm8s1ceuBUnMUAeoAHHw,16,13,7,9,4,1,8,0,42,6.0,4,0.0,4,7,9,4,9,1,0,8,0,24,18,0
1526,31780,DQDVulqp0h5DfSUqCcuRlUTAbYsaxOXV,7GRhBDsirIGkRZBtSMEzNTyDr2JQm4xx,3,0,0,0,0,4,4,0,8,1.1428571428571428,1,0.0,0,0,0,0,0,4,0,4,0,0,8,1
1527,31785,WMHp5hy6JREfQvjE2o6B3Iu0aAWFRyny,SpATywNh6bZuzm8s1ceuBUnMUAeoAHHw,15,18,9,12,6,0,5,0,50,7.142857142857143,2,0.0,5,9,10,6,13,0,2,5,0,30,20,0
1528,31792,ZNcLOAJ2r3H5DqhbGk1CiPtwI7ixaCeK,A3fsA9Zfv1X2fVEQhTw51lKENdNrEqT3,23,20,15,0,10,0,4,0,49,7.0,3,0.0,0,15,0,10,20,0,0,4,0,25,24,0
1529,31827,JOddnojV0OZrysgzYsnxzhRLS1r6GCxl,SpATywNh6bZuzm8s1ceuBUnMUAeoAHHw,10,14,6,0,4,1,2,0,27,3.857142857142857,1,0.0,4,6,0,4,10,1,0,2,0,14,13,1
1530,31829,861mcqUZ4WyFkrWdyYySCd1kJULdzhG3,SpATywNh6bZuzm8s1ceuBUnMUAeoAHHw,10,8,0,12,0,0,1,0,21,3.0,1,0.0,2,0,12,0,6,0,0,1,0,14,7,1
1531,31854,wLAgbiz3XWV6Nef8pQe1TlLxUN8CIoJ8,7GRhBDsirIGkRZBtSMEzNTyDr2JQm4xx,33,46,16,49,11,7,12,1,142,20.285714285714285,1,0.0,26,16,45,11,20,7,4,12,1,98,44,1
1532,31877,ioaeb7d1U29jI9wsI7DHJ7aiuWWVX3KB,RXDvfPUBYFlVdlueBFbLW0mhhAyGEqpt,21,31,11,0,7,6,15,2,72,10.285714285714286,1,0.0,1,11,0,7,30,6,0,15,2,19,53,0
1533,31898,PWcBu9Kt7uTK1WC32ssYHrspf5hPuUjQ,7GRhBDsirIGkRZBtSMEzNTyDr2JQm4xx,8,5,3,0,2,0,4,0,14,2.0,2,0.0,0,3,0,2,5,0,0,4,0,5,9,1
1534,31927,6tkBZTnNxRRRXGSFUHBd7kkZUgcJhsIy,7GRhBDsirIGkRZBtSMEzNTyDr2JQm4xx,2,0,0,0,0,0,2,0,2,0.2857142857142857,1,0.0,0,0,0,0,0,0,0,2,0,0,2,1
1535,31979,XYKAwX2Sl88KhgfkTOpg6K4pRdGN7Orp,7GRhBDsirIGkRZBtSMEzNTyDr2JQm4xx,2,0,0,0,0,0,3,0,3,0.42857142857142855,1,0.0,0,0,0,0,0,0,0,3,0,0,3,1
1536,31983,EwpbggvNdZkeSTjdG48aEltlJYavm02s,A3fsA9Zfv1X2fVEQhTw51lKENdNrEqT3,14,14,1,0,0,0,4,0,19,2.7142857142857144,2,0.0,0,1,0,0,14,0,0,4,0,1,18,0
1537,31996,TZQnDQD4c1wLJcg98vkGC4z0YxJAykwb,SpATywNh6bZuzm8s1ceuBUnMUAeoAHHw,18,56,22,26,9,4,15,1,133,19.0,5,0.0,24,22,21,9,32,4,5,15,1,76,57,0
1538,32123,xrDGwnLLNa6QlQOfL38MTY3529BaxYjK,RXDvfPUBYFlVdlueBFbLW0mhhAyGEqpt,14,9,7,17,3,0,2,0,38,5.428571428571429,1,0.0,1,7,16,3,8,0,1,2,0,27,11,0
1539,32130,4bLrsVDvLnrTqHqeIpcqQPyvl02eai7n,bWdj2GDclj5ofokWjzoa5jAwMkxCykd6,1,0,0,0,0,0,1,0,1,0.14285714285714285,1,0.0,0,0,0,0,0,0,0,1,0,0,1,1
1540,32135,610PtRFkaYif9s7nz1Kdra5qTHjPTrYT,SpATywNh6bZuzm8s1ceuBUnMUAeoAHHw,13,14,8,14,4,0,4,0,44,6.285714285714286,2,0.0,5,8,13,4,9,0,1,4,0,30,14,0
1541,32141,jagu0OJDhWTGFhfCMk0ghqluLpW3kzdC,bWdj2GDclj5ofokWjzoa5jAwMkxCykd6,6,2,1,0,1,0,3,0,7,1.0,1,0.0,0,1,0,1,2,0,0,3,0,2,5,1
1542,32154,JB5wgKgEAIwYsiifcpDf7iv2yPgMBOVA,SpATywNh6bZuzm8s1ceuBUnMUAeoAHHw,14,36,2,12,1,1,11,1,64,9.142857142857142,3,0.0,8,2,12,1,28,1,0,11,1,23,41,0
1543,32162,kAQFM0dEgOQIxOG9jTMe5puRtNxZZWMN,A3fsA9Zfv1X2fVEQhTw51lKENdNrEqT3,33,23,2,58,2,0,3,0,88,12.571428571428571,2,0.0,1,2,54,2,22,0,4,3,0,59,29,0
1544,32165,xVQ88VrIuIA75ygDlevnROobNkwcFnsc,SpATywNh6bZuzm8s1ceuBUnMUAeoAHHw,10,6,5,5,4,0,1,0,21,3.0,1,0.0,0,5,4,4,6,0,1,1,0,13,8,0
1545,32177,kvf1WFygeLGKOFkoertca6J9TDxV9fcY,7GRhBDsirIGkRZBtSMEzNTyDr2JQm4xx,6,6,2,0,3,0,1,0,12,1.7142857142857142,2,0.0,3,2,0,3,3,0,0,1,0,8,4,1
1546,32181,yz5W8rI4J1brvBsiH8Bk8UlG6rKQV6QY,SpATywNh6bZuzm8s1ceuBUnMUAeoAHHw,16,22,10,14,3,0,7,0,56,8.0,2,0.0,7,10,13,3,15,0,1,7,0,33,23,0
1547,32220,dpAJ54wEPUDHZcYRCRrxvDfIakq9pmaQ,SpATywNh6bZuzm8s1ceuBUnMUAeoAHHw,14,17,1,14,0,4,8,1,45,6.428571428571429,2,0.0,6,1,13,0,11,4,1,8,1,20,25,1
1548,32237,qh4tHm7Ijtk0rXK87a1UXx5JdnCnPyij,7GRhBDsirIGkRZBtSMEzNTyDr2JQm4xx,5,3,2,0,0,0,2,0,7,1.0,1,0.0,0,2,0,0,3,0,0,2,0,2,5,1
1549,32248,s54A0hFU7GzRUM0cq0hWJTDlnMIM1TAX,SpATywNh6bZuzm8s1ceuBUnMUAeoAHHw,13,22,9,18,7,0,2,0,58,8.285714285714286,1,0.0,5,9,17,7,17,0,1,2,0,38,20,1
1550,32277,TEmVdQ7zwLYXmbCXgKpcJL6SMosCkEk6,7GRhBDsirIGkRZBtSMEzNTyDr2JQm4xx,13,12,5,4,4,8,9,4,46,6.571428571428571,1,0.0,4,5,3,4,8,8,1,9,4,16,30,1
1551,32281,SSlieJULaqRb1C7jSzOwyPvbJnH3adQv,7GRhBDsirIGkRZBtSMEzNTyDr2JQm4xx,23,41,1,38,8,0,4,0,92,13.142857142857142,3,0.0,21,1,32,8,20,0,6,4,0,62,30,1
1552,32289,5getYNIZ2hnUwVH9nwJiD9At1XFs260U,RXDvfPUBYFlVdlueBFbLW0mhhAyGEqpt,40,38,3,137,5,6,6,0,195,27.857142857142858,3,0.0,14,3,123,5,24,6,14,6,0,145,50,0
1553,32350,4Z7KasuRx9CbJCcpGQot8eWIzFoK9Y6e,G8EPVSXsOYB5YQWZGiz1aVq5Pgr2GrQu,14,14,5,14,3,1,6,2,45,6.428571428571429,2,0.0,6,5,12,3,8,1,2,6,2,26,19,0
1554,32387,40BfkvCbbDiXljpQ7TxzzDakjMbYaL3S,SpATywNh6bZuzm8s1ceuBUnMUAeoAHHw,10,11,4,11,1,0,3,0,30,4.285714285714286,1,0.0,6,4,10,1,5,0,1,3,0,21,9,0
1555,32404,w7790lyNDi5biQPgaVfIpYKtROrGndED,SpATywNh6bZuzm8s1ceuBUnMUAeoAHHw,16,46,18,18,10,6,17,0,115,16.428571428571427,3,0.0,7,18,15,10,39,6,3,17,0,50,65,1
1556,32423,FW47VC0lzmys2S4k8Ky52JrXCSFDeyeP,A3fsA9Zfv1X2fVEQhTw51lKENdNrEqT3,9,7,5,0,3,0,2,0,17,2.4285714285714284,1,0.0,0,5,0,3,7,0,0,2,0,8,9,1
1557,32435,QqE2Xjwy9gUzOvFdkDqAwAaNZLBZkxvd,7GRhBDsirIGkRZBtSMEzNTyDr2JQm4xx,27,62,2,76,4,44,17,0,205,29.285714285714285,5,0.0,37,2,64,4,25,44,12,17,0,107,98,1
1558,32437,gGSMkNgPdXpBQgdZzyjzifomyCxFSNyt,A3fsA9Zfv1X2fVEQhTw51lKENdNrEqT3,22,20,13,0,8,24,31,1,97,13.857142857142858,5,0.0,0,13,0,8,20,24,0,31,1,21,76,0
1559,32439,sbafJyL5hxYHWbu0cbLBSCFDQh5Oe8Ww,RXDvfPUBYFlVdlueBFbLW0mhhAyGEqpt,8,10,1,0,1,5,5,0,22,3.142857142857143,1,0.0,1,1,0,1,9,5,0,5,0,3,19,0
1560,32466,JJro1amtaUogvd4Vkbdsh0DmnqfguR8P,SpATywNh6bZuzm8s1ceuBUnMUAeoAHHw,5,3,2,0,0,0,5,0,10,1.4285714285714286,1,0.0,0,2,0,0,3,0,0,5,0,2,8,1
1561,32471,1BEoeS35Ni9RflXqhdHAKpKpQ07oVqkG,SpATywNh6bZuzm8s1ceuBUnMUAeoAHHw,16,59,5,19,0,7,36,4,130,18.571428571428573,4,0.0,11,5,16,0,48,7,3,36,4,32,98,0
1562,32477,LPul7vNnoWP2lahy0vntgg039NwfmlYY,SpATywNh6bZuzm8s1ceuBUnMUAeoAHHw,14,30,3,14,0,11,18,1,77,11.0,4,0.0,6,3,10,0,24,11,4,18,1,19,58,0
1563,32483,MauXcYq2z30gm4QmDqcfc1IfWjnRlPwg,SpATywNh6bZuzm8s1ceuBUnMUAeoAHHw,8,13,2,0,1,0,6,2,24,3.4285714285714284,3,0.0,0,2,0,1,13,0,0,6,2,3,21,0
1564,32520,AFUJTbEqqgSsqCkUsNrjbPAjZvFwpzeW,G8EPVSXsOYB5YQWZGiz1aVq5Pgr2GrQu,32,42,11,56,10,0,4,0,123,17.571428571428573,2,0.0,17,11,36,10,25,0,20,4,0,74,49,0
1565,32530,KbfT30uvubax3lKEct6iblV8VhlPaIEn,G8EPVSXsOYB5YQWZGiz1aVq5Pgr2GrQu,22,22,11,22,7,0,2,0,64,9.142857142857142,1,0.0,0,11,20,7,22,0,2,2,0,38,26,0
1566,32536,13AvYdfA6LYkS80MstJgmNNdfNqd80ja,bWdj2GDclj5ofokWjzoa5jAwMkxCykd6,6,2,1,0,1,1,7,0,12,1.7142857142857142,3,0.0,0,1,0,1,2,1,0,7,0,2,10,0
1567,32547,wkfBzItw0JCH6ZUz2WUZn7ngJ5M4Oksy,SpATywNh6bZuzm8s1ceuBUnMUAeoAHHw,4,3,0,0,0,0,1,0,4,0.5714285714285714,1,0.0,0,0,0,0,3,0,0,1,0,0,4,0
1568,32555,g14jBWDuqUHRwpf4jHpBljeNVwCyjgqd,G8EPVSXsOYB5YQWZGiz1aVq5Pgr2GrQu,16,25,12,0,12,0,4,0,53,7.571428571428571,2,0.0,7,12,0,12,18,0,0,4,0,31,22,1
1569,32579,rQ8twu2Y4JlbZAVSeNSb6mmUSGGvpIAq,SpATywNh6bZuzm8s1ceuBUnMUAeoAHHw,12,26,0,16,0,2,7,0,51,7.285714285714286,2,0.0,4,0,14,0,22,2,2,7,0,18,33,0
1570,32587,dwKCRrq2cYlFl5YxmnjTpirr5PBMVnOq,RXDvfPUBYFlVdlueBFbLW0mhhAyGEqpt,23,38,18,0,11,0,4,0,71,10.142857142857142,2,0.0,5,18,0,11,33,0,0,4,0,34,37,0
1571,32600,jaDaYkvR41YbLhesvf9mW32i93zNzaSK,RXDvfPUBYFlVdlueBFbLW0mhhAyGEqpt,49,52,30,73,10,3,22,1,191,27.285714285714285,4,0.0,9,30,67,10,43,3,6,22,1,116,75,0
1572,32617,ncKGr6xR4Vhs3wPeU0aqO1sSEow8LN64,SpATywNh6bZuzm8s1ceuBUnMUAeoAHHw,17,24,9,13,3,117,35,5,206,29.428571428571427,6,0.0,6,9,11,3,18,117,2,35,5,29,177,0
1573,32633,KSfQPUyfWWfWDmmi6m3KXcKzxz89wkwt,SpATywNh6bZuzm8s1ceuBUnMUAeoAHHw,11,35,3,6,0,6,8,0,58,8.285714285714286,3,0.0,11,3,6,0,24,6,0,8,0,20,38,0
1574,32652,nqDX1tmEeTnbqCn9T8Crn5CYQgmIy9Eq,SpATywNh6bZuzm8s1ceuBUnMUAeoAHHw,17,30,13,13,4,10,13,3,86,12.285714285714286,1,0.0,14,13,11,4,16,10,2,13,3,42,44,0
1575,32654,zQwNebC3qLt6HHOuoG7oSsRj8l42sEdO,7GRhBDsirIGkRZBtSMEzNTyDr2JQm4xx,1,0,0,0,0,0,1,0,1,0.14285714285714285,1,0.0,0,0,0,0,0,0,0,1,0,0,1,1
1576,32661,qKc8EuUOlEzXysFMoXghKaieW3HIaePV,SpATywNh6bZuzm8s1ceuBUnMUAeoAHHw,5,2,1,0,0,0,3,0,6,0.8571428571428571,1,0.0,0,1,0,0,2,0,0,3,0,1,5,0
1577,32675,S65yhLgjTGwwuDt6C6cjI82AJbGfYIiK,SpATywNh6bZuzm8s1ceuBUnMUAeoAHHw,16,13,5,12,3,0,14,1,48,6.857142857142857,2,0.0,7,5,11,3,6,0,1,14,1,26,22,1
1578,32680,4m1Dg29Y9pbvJRrOBjNRbyWgB17yJl3U,G8EPVSXsOYB5YQWZGiz1aVq5Pgr2GrQu,2,0,0,0,0,0,2,0,2,0.2857142857142857,1,0.0,0,0,0,0,0,0,0,2,0,0,2,0
1579,32688,vsH3qB64VOSnSTFhrkJQnHqm8c83psRR,SpATywNh6bZuzm8s1ceuBUnMUAeoAHHw,13,18,12,24,5,49,2,0,110,15.714285714285714,1,0.0,2,12,18,5,16,49,6,2,0,37,73,0
1580,32691,zIxh0JW4JCwiox9jMtpfpkw3WRcYtUgv,SpATywNh6bZuzm8s1ceuBUnMUAeoAHHw,13,18,0,8,0,8,8,1,43,6.142857142857143,1,0.0,8,0,8,0,10,8,0,8,1,16,27,0
1581,32693,NrExtDPytZeckpp4FyIosvaEjFjzywmC,A3fsA9Zfv1X2fVEQhTw51lKENdNrEqT3,27,9,0,52,0,0,3,0,64,9.142857142857142,1,0.0,1,0,50,0,8,0,2,3,0,51,13,1
1582,32701,abaCPMr6xWMrCiOErEioyXWBSEERS1tE,7GRhBDsirIGkRZBtSMEzNTyDr2JQm4xx,12,6,3,0,2,1,8,1,21,3.0,1,0.0,0,3,0,2,6,1,0,8,1,5,16,1
1583,32710,HJ2gv3yF0WCJxGH8T6tjLTFYdM4sCizz,RXDvfPUBYFlVdlueBFbLW0mhhAyGEqpt,47,58,25,103,18,26,19,2,251,35.857142857142854,3,0.0,22,25,87,18,36,26,16,19,2,152,99,0
1584,32715,KvjMYuIyC1QuxskkhpxIY7MoDNSU5FMk,7GRhBDsirIGkRZBtSMEzNTyDr2JQm4xx,16,23,14,0,11,0,2,0,50,7.142857142857143,1,0.0,6,14,0,11,17,0,0,2,0,31,19,1
1585,32721,aLRP3ahB5SIcOn5vpM1VPEh9ib2QIioX,A3fsA9Zfv1X2fVEQhTw51lKENdNrEqT3,13,11,8,0,6,0,4,0,29,4.142857142857143,3,0.0,0,8,0,6,11,0,0,4,0,14,15,1
1586,32732,L74tKRZpBi1qsh0NM3EwE5D87acCLK8s,A3fsA9Zfv1X2fVEQhTw51lKENdNrEqT3,40,58,25,67,9,2,22,0,183,26.142857142857142,4,0.0,7,25,61,9,51,2,6,22,0,102,81,0
1587,32746,mXsmDArxUTe9rMFHp3cGPJEx5ACYKD90,7GRhBDsirIGkRZBtSMEzNTyDr2JQm4xx,12,18,7,10,3,1,4,0,43,6.142857142857143,3,0.0,6,7,8,3,12,1,2,4,0,24,19,1
1588,32753,Gn3GzN2xweKhiR4C9qIb4ocllZ2lANYz,SpATywNh6bZuzm8s1ceuBUnMUAeoAHHw,4,2,1,0,1,0,1,0,5,0.7142857142857143,1,0.0,0,1,0,1,2,0,0,1,0,2,3,1
1589,32769,vEKYOhRdGZ59kfXY6wTO63YZY4EqPYqX,SpATywNh6bZuzm8s1ceuBUnMUAeoAHHw,14,24,14,10,4,0,3,0,55,7.857142857142857,3,0.0,5,14,9,4,19,0,1,3,0,32,23,0
1590,32837,wZVSpaATIDuE7qW0svZJi84Cpi6PMqWg,SpATywNh6bZuzm8s1ceuBUnMUAeoAHHw,13,22,2,12,1,0,9,0,46,6.571428571428571,2,0.0,5,2,10,1,17,0,2,9,0,18,28,1
1591,32872,XEcLEoVa2SWvlFcbbhIECksb9a6XvMec,RXDvfPUBYFlVdlueBFbLW0mhhAyGEqpt,16,22,12,35,2,9,8,6,94,13.428571428571429,1,0.0,8,12,30,2,14,9,5,8,6,52,42,0
1592,32884,z2Zz9wVXxnQo0wOtqHQc06HPM9iWXDoN,SpATywNh6bZuzm8s1ceuBUnMUAeoAHHw,18,24,8,20,4,24,7,1,88,12.571428571428571,1,0.0,8,8,17,4,16,24,3,7,1,37,51,0
1593,32887,9WVTv7dWHzTCHwCGLSPAioAO2udyHWmu,SpATywNh6bZuzm8s1ceuBUnMUAeoAHHw,16,24,9,18,5,32,15,0,103,14.714285714285714,4,0.0,14,9,16,5,10,32,2,15,0,44,59,0
1594,32917,dwKCRrq2cYlFl5YxmnjTpirr5PBMVnOq,SpATywNh6bZuzm8s1ceuBUnMUAeoAHHw,10,29,14,0,6,5,4,0,58,8.285714285714286,2,0.0,9,14,0,6,20,5,0,4,0,29,29,0
1595,32923,NqKjMSY6eOZQ1uSyzlPrquJVqzjvSO7O,SpATywNh6bZuzm8s1ceuBUnMUAeoAHHw,17,24,12,12,5,23,11,4,91,13.0,4,0.0,5,12,12,5,19,23,0,11,4,34,57,0
1596,32929,OWN7QY4MoQINwciZKacEUOaJkqenbOMp,SpATywNh6bZuzm8s1ceuBUnMUAeoAHHw,5,0,0,0,0,0,4,1,5,0.7142857142857143,1,0.0,0,0,0,0,0,0,0,4,1,0,5,0
1597,32962,gi1cGXmBNmpbe6lA2hzKFh8EEd7gQMCM,7GRhBDsirIGkRZBtSMEzNTyDr2JQm4xx,1,0,0,0,0,0,1,0,1,0.14285714285714285,1,0.0,0,0,0,0,0,0,0,1,0,0,1,1
1598,32969,z4c8EBwIn89viFGIwasAjQhkMGV3BTQj,SpATywNh6bZuzm8s1ceuBUnMUAeoAHHw,5,6,1,0,2,0,2,0,11,1.5714285714285714,1,0.0,0,1,0,2,6,0,0,2,0,3,8,0
1599,32970,f9VMkfOoUWXzqEbeO2IX0YOVcNKnSKLo,7GRhBDsirIGkRZBtSMEzNTyDr2JQm4xx,1,0,0,0,0,0,1,0,1,0.14285714285714285,1,0.0,0,0,0,0,0,0,0,1,0,0,1,1
1600,32976,E7QFiJdCviuClYDIfnaKnxTdSk0i534L,7GRhBDsirIGkRZBtSMEzNTyDr2JQm4xx,1,0,0,0,0,0,1,0,1,0.14285714285714285,1,0.0,0,0,0,0,0,0,0,1,0,0,1,1
1601,32983,BtS3BvehCjq4QaGPbzrC7JIugP6OKoPy,7GRhBDsirIGkRZBtSMEzNTyDr2JQm4xx,40,78,32,67,22,24,27,2,252,36.0,3,0.0,36,32,56,22,42,24,11,27,2,146,106,1
1602,33024,P7HoHyQzVXLghYr6m3MYTEIsDQbHfDfp,SpATywNh6bZuzm8s1ceuBUnMUAeoAHHw,5,3,1,0,1,0,1,0,6,0.8571428571428571,1,0.0,0,1,0,1,3,0,0,1,0,2,4,0
1603,33071,S4x7F2zwGMymIPjPy7YGoWTUwlKzmNvg,7GRhBDsirIGkRZBtSMEzNTyDr2JQm4xx,6,0,0,0,0,1,9,0,10,1.4285714285714286,2,0.0,0,0,0,0,0,1,0,9,0,0,10,1
1604,33080,5ADMlR48WDr3F57JEz4JNbgGytxoga6J,SpATywNh6bZuzm8s1ceuBUnMUAeoAHHw,14,29,1,15,0,1,26,1,73,10.428571428571429,5,0.0,16,1,15,0,13,1,0,26,1,32,41,0
1605,33150,vU01Fxors0KlSd7gao1Z0nHesILTHNPI,SpATywNh6bZuzm8s1ceuBUnMUAeoAHHw,11,24,2,4,1,11,13,0,55,7.857142857142857,5,0.0,1,2,4,1,23,11,0,13,0,8,47,0
1606,33164,AJYnlahOLAGVXTJrzU8y7gkOQqLtYt6X,SpATywNh6bZuzm8s1ceuBUnMUAeoAHHw,13,14,6,19,4,3,1,0,47,6.714285714285714,1,0.0,3,6,16,4,11,3,3,1,0,29,18,0
1607,33169,FPQSXji4bDip0jB4obm0vWFPXClGuSyC,7GRhBDsirIGkRZBtSMEzNTyDr2JQm4xx,34,49,19,62,11,23,11,1,176,25.142857142857142,2,0.0,28,19,50,11,21,23,12,11,1,108,68,0
1608,33203,6oSvXBiE6hMQm6ur1TzQBxRkuWf4UJ1w,SpATywNh6bZuzm8s1ceuBUnMUAeoAHHw,18,57,18,15,3,15,30,2,140,20.0,2,0.0,22,18,12,3,35,15,3,30,2,55,85,0
1609,33251,9oofyIqQs4svoCsTL3Pyep7hA30rIFOe,SpATywNh6bZuzm8s1ceuBUnMUAeoAHHw,15,22,10,17,3,3,7,0,62,8.857142857142858,3,0.0,8,10,15,3,14,3,2,7,0,36,26,0
1610,33266,ANj8LPP4QCqsLHbhaQj263PWrIQ9dqGZ,SpATywNh6bZuzm8s1ceuBUnMUAeoAHHw,12,21,0,16,0,0,4,0,41,5.857142857142857,1,0.0,10,0,14,0,11,0,2,4,0,24,17,0
1611,33270,BFrfDseDfXCBvtTfCsJAy36Ogk6b0Rfx,SpATywNh6bZuzm8s1ceuBUnMUAeoAHHw,10,22,12,0,2,0,8,0,44,6.285714285714286,3,0.0,0,12,0,2,22,0,0,8,0,14,30,0
1612,33284,jRnFs6XBk6vGxxB24JG9v0Qh3pYfUtLh,RXDvfPUBYFlVdlueBFbLW0mhhAyGEqpt,41,87,30,59,9,8,25,15,233,33.285714285714285,6,0.0,10,30,54,9,77,8,5,25,15,103,130,0
1613,33290,0wm7bVyJC7jfhIoeylaV85sHOH5JOhtj,SpATywNh6bZuzm8s1ceuBUnMUAeoAHHw,12,23,2,11,0,6,10,0,52,7.428571428571429,4,0.0,5,2,10,0,18,6,1,10,0,17,35,0
1614,33298,wjqMTSqGRhad7XTyyuysYYbP0x4J6ulv,bWdj2GDclj5ofokWjzoa5jAwMkxCykd6,8,13,3,0,3,2,8,0,29,4.142857142857143,3,0.0,0,3,0,3,13,2,0,8,0,6,23,1
1615,33322,vIBcYbs1BLdmaaP30fcE2FS7kB7v7QRn,SpATywNh6bZuzm8s1ceuBUnMUAeoAHHw,2,0,0,0,0,0,2,0,2,0.2857142857142857,1,0.0,0,0,0,0,0,0,0,2,0,0,2,1
1616,33331,mJNmN9AbVBmhzBfxSlHeSff1yTyr8w50,SpATywNh6bZuzm8s1ceuBUnMUAeoAHHw,12,41,16,0,8,0,8,0,73,10.428571428571429,4,0.0,0,16,0,8,41,0,0,8,0,24,49,0
1617,33348,we9tWnySpl1G7k7FqyXPj8wmC2gUYK0W,SpATywNh6bZuzm8s1ceuBUnMUAeoAHHw,14,15,1,13,1,5,6,3,44,6.285714285714286,2,0.0,5,1,12,1,10,5,1,6,3,19,25,0
1618,33354,0LjNTZG6byvXe7xKDfNEXUTZjqaDOglx,G8EPVSXsOYB5YQWZGiz1aVq5Pgr2GrQu,17,19,9,6,4,0,10,1,49,7.0,3,0.0,3,9,5,4,16,0,1,10,1,21,28,1
1619,33368,hJo1MgKiPZFXuH2ko6hqPTd9dbjMQKDO,bWdj2GDclj5ofokWjzoa5jAwMkxCykd6,7,10,6,0,1,0,5,0,22,3.142857142857143,3,0.0,0,6,0,1,10,0,0,5,0,7,15,0
1620,33370,3EwUg208bV0DvnhKptmbGHdmCctMgvT5,SpATywNh6bZuzm8s1ceuBUnMUAeoAHHw,6,7,2,0,0,1,3,0,13,1.8571428571428572,1,0.0,0,2,0,0,7,1,0,3,0,2,11,1
1621,33431,viuKt4GgrX0rYL5EpHoxJbsiC9TblSuk,A3fsA9Zfv1X2fVEQhTw51lKENdNrEqT3,32,71,34,14,5,10,46,0,180,25.714285714285715,5,0.0,1,34,8,5,70,10,6,46,0,48,132,0
1622,33443,viuKt4GgrX0rYL5EpHoxJbsiC9TblSuk,bWdj2GDclj5ofokWjzoa5jAwMkxCykd6,12,20,13,0,7,27,21,0,88,12.571428571428571,6,0.0,0,13,0,7,20,27,0,21,0,20,68,0
1623,33469,viuKt4GgrX0rYL5EpHoxJbsiC9TblSuk,G8EPVSXsOYB5YQWZGiz1aVq5Pgr2GrQu,9,8,2,0,1,15,11,0,37,5.285714285714286,3,0.0,0,2,0,1,8,15,0,11,0,3,34,0
1624,33481,viuKt4GgrX0rYL5EpHoxJbsiC9TblSuk,RXDvfPUBYFlVdlueBFbLW0mhhAyGEqpt,14,38,1,0,1,87,26,0,153,21.857142857142858,4,0.0,5,1,0,1,33,87,0,26,0,7,146,0
1625,33500,VwUXTBGJaTv5xN1He6TwE1OKxII3IUB4,7GRhBDsirIGkRZBtSMEzNTyDr2JQm4xx,3,6,1,0,1,1,1,0,10,1.4285714285714286,1,0.0,2,1,0,1,4,1,0,1,0,4,6,1
1626,33506,R6mWJ0ZeHkZWWi0xlkZZqK7iozuGXemG,7GRhBDsirIGkRZBtSMEzNTyDr2JQm4xx,8,10,6,0,5,3,9,2,35,5.0,3,0.0,4,6,0,5,6,3,0,9,2,15,20,1
1627,33517,R6mWJ0ZeHkZWWi0xlkZZqK7iozuGXemG,SpATywNh6bZuzm8s1ceuBUnMUAeoAHHw,18,26,12,20,5,6,12,1,82,11.714285714285714,3,0.0,9,12,17,5,17,6,3,12,1,43,39,1
1628,33519,7yKH9idxIZZIHmSby2TlRwglHE2J4AOu,7GRhBDsirIGkRZBtSMEzNTyDr2JQm4xx,28,74,23,22,9,14,12,2,156,22.285714285714285,4,0.0,19,23,20,9,55,14,2,12,2,71,85,1
1629,33521,kOcsNetIsK9HFRaYNeKiWrndfQDPUf2b,7GRhBDsirIGkRZBtSMEzNTyDr2JQm4xx,32,51,25,42,24,3,5,0,150,21.428571428571427,3,0.0,21,25,36,24,30,3,6,5,0,106,44,1
1630,33589,orkcYdEVQqlH9SJjCRUiZ5P3bFy172XW,7GRhBDsirIGkRZBtSMEzNTyDr2JQm4xx,4,7,0,0,0,0,3,0,10,1.4285714285714286,2,0.0,0,0,0,0,7,0,0,3,0,0,10,1
1631,33638,kGNoIC9AxgB9nCs6frsN1R7EeU5BsStD,SpATywNh6bZuzm8s1ceuBUnMUAeoAHHw,10,21,5,16,1,0,2,0,45,6.428571428571429,1,0.0,15,5,13,1,6,0,3,2,0,34,11,1
1632,33644,eE4DAv5aHElS2DPaTad4VXPjk6A3xvPl,G8EPVSXsOYB5YQWZGiz1aVq5Pgr2GrQu,19,17,5,18,4,0,4,1,49,7.0,1,0.0,10,5,12,4,7,0,6,4,1,31,18,0
1633,33676,csMt1h4jwoK6sZ6rEkcutiAH8F6ocCR4,A3fsA9Zfv1X2fVEQhTw51lKENdNrEqT3,11,12,0,0,0,0,1,0,13,1.8571428571428572,1,0.0,0,0,0,0,12,0,0,1,0,0,13,1
1634,34771,1znu7Xzg4p1qA4YkunjQTwOhXoKFFWr0,7GRhBDsirIGkRZBtSMEzNTyDr2JQm4xx,7,3,1,0,1,0,3,0,8,1.1428571428571428,2,0.0,0,1,0,1,3,0,0,3,0,2,6,0
1635,34808,t6gbXbSU5L3FPpVibBhtf9ABrcXvjFov,7GRhBDsirIGkRZBtSMEzNTyDr2JQm4xx,5,9,6,0,5,0,2,0,22,3.142857142857143,1,0.0,0,6,0,5,9,0,0,2,0,11,11,0
1636,35152,VsfU7jeSb2K8k0CBzCZzXJjDlMye1sB1,7GRhBDsirIGkRZBtSMEzNTyDr2JQm4xx,26,40,22,24,18,3,6,0,113,16.142857142857142,3,0.0,13,22,21,18,27,3,3,6,0,74,39,1
1637,35159,dJJJLtI6F18pblO9KPkBPg9ZKTgQPaQc,7GRhBDsirIGkRZBtSMEzNTyDr2JQm4xx,22,57,0,26,5,0,5,0,93,13.285714285714286,4,0.0,30,0,26,5,27,0,0,5,0,61,32,0
1638,35167,eU4MPF9R01ru4sQN9giW756pdpNlnW4H,7GRhBDsirIGkRZBtSMEzNTyDr2JQm4xx,4,2,1,0,1,0,1,0,5,0.7142857142857143,1,0.0,0,1,0,1,2,0,0,1,0,2,3,0
1639,35583,O36QxtTrV6jSigC0QBjRMiqSpx0KHX6w,7GRhBDsirIGkRZBtSMEzNTyDr2JQm4xx,50,77,23,75,24,20,13,0,232,33.142857142857146,3,0.0,45,23,66,24,32,20,9,13,0,158,74,0
1640,35592,WgQR6nrfyl7yDpgHC595JSoog2R9VhVs,7GRhBDsirIGkRZBtSMEzNTyDr2JQm4xx,30,62,19,46,13,9,4,0,153,21.857142857142858,3,0.0,40,19,36,13,22,9,10,4,0,108,45,0
1641,35726,xHZbSROhwP4RRQerUVWvcNTfOGc2DHWf,7GRhBDsirIGkRZBtSMEzNTyDr2JQm4xx,36,59,27,59,13,50,21,1,230,32.857142857142854,4,0.0,21,27,47,13,38,50,12,21,1,108,122,1
1642,35753,aXYyJMDvVYwwKBbiO4CB25XlnDBfWYNg,7GRhBDsirIGkRZBtSMEzNTyDr2JQm4xx,9,10,4,0,1,8,6,0,29,4.142857142857143,2,0.0,3,4,0,1,7,8,0,6,0,8,21,0
1643,35817,Kneva8tRfI6BhvgFMe4i80mebf2hEQk0,7GRhBDsirIGkRZBtSMEzNTyDr2JQm4xx,9,4,3,0,1,0,5,0,13,1.8571428571428572,1,0.0,0,3,0,1,4,0,0,5,0,4,9,1
1644,37571,9jZsAxMdQXvLjxKIorcfAyZ7kTyyk2m3,A3fsA9Zfv1X2fVEQhTw51lKENdNrEqT3,19,25,13,14,2,3,11,0,68,9.714285714285714,4,0.0,0,13,14,2,25,3,0,11,0,29,39,1
1645,37590,ZHGbzWgnUfJJPdovMfpePS97QxPtktWe,SpATywNh6bZuzm8s1ceuBUnMUAeoAHHw,7,2,1,0,1,0,5,0,9,1.2857142857142858,1,0.0,0,1,0,1,2,0,0,5,0,2,7,1
1646,37593,ZmKF4tFBenzCeCXZcmDdE2tsuT4rzLPd,G8EPVSXsOYB5YQWZGiz1aVq5Pgr2GrQu,5,2,1,0,1,0,2,0,6,0.8571428571428571,1,0.0,0,1,0,1,2,0,0,2,0,2,4,1
1647,37599,yVtzjNm7Xgz14yjopuLvCh7VRZR9RBra,bWdj2GDclj5ofokWjzoa5jAwMkxCykd6,7,13,5,2,6,0,7,0,33,4.714285714285714,2,0.0,5,5,2,6,8,0,0,7,0,18,15,1
1648,37600,NHGmMinB9WoQusKCx50F4M4nJF124Ms4,A3fsA9Zfv1X2fVEQhTw51lKENdNrEqT3,19,25,16,0,7,17,32,5,102,14.571428571428571,3,0.0,0,16,0,7,25,17,0,32,5,23,79,1
1649,37607,NvmmlHTgNmxqyrQU3a9c6oM8kVrIYu3Q,SpATywNh6bZuzm8s1ceuBUnMUAeoAHHw,10,12,4,0,3,0,4,0,23,3.2857142857142856,1,0.0,0,4,0,3,12,0,0,4,0,7,16,1
1650,37613,deaOh1cCfPHHygo0HX3j8JDIzRZNPF7P,SpATywNh6bZuzm8s1ceuBUnMUAeoAHHw,10,6,3,13,2,0,1,0,25,3.5714285714285716,2,0.0,2,3,12,2,4,0,1,1,0,19,6,0
1651,37618,ABlVlNkPi30ZMlFLrcsAhP5jZW6rJhdZ,A3fsA9Zfv1X2fVEQhTw51lKENdNrEqT3,22,16,13,0,11,0,4,0,44,6.285714285714286,3,0.0,0,13,0,11,16,0,0,4,0,24,20,1
1652,37621,7ynsHGhJ1N4494Hez57ckblgtBNGbed9,A3fsA9Zfv1X2fVEQhTw51lKENdNrEqT3,1,0,0,0,0,0,1,0,1,0.14285714285714285,1,0.0,0,0,0,0,0,0,0,1,0,0,1,1
1653,37622,3hFWpwvaMZB4do5VrkI46WX7phUXE8q9,SpATywNh6bZuzm8s1ceuBUnMUAeoAHHw,1,0,0,0,0,0,2,0,2,0.2857142857142857,1,0.0,0,0,0,0,0,0,0,2,0,0,2,1
1654,37627,61Btwz5kWZaS3OIGnNTMXi3lqbtcLCB7,SpATywNh6bZuzm8s1ceuBUnMUAeoAHHw,15,81,12,6,3,0,40,0,142,20.285714285714285,6,0.0,8,12,6,3,73,0,0,40,0,29,113,1
1655,37628,9S5uoFAiVHVF4D2DNR23wCkbQZ8LhtES,RXDvfPUBYFlVdlueBFbLW0mhhAyGEqpt,17,17,5,12,3,0,3,0,40,5.714285714285714,2,0.0,3,5,12,3,14,0,0,3,0,23,17,0
1656,37655,W68HJCLMGaPDXLquuNsADTmn70KIcSIQ,G8EPVSXsOYB5YQWZGiz1aVq5Pgr2GrQu,2,0,0,0,0,0,4,0,4,0.5714285714285714,1,0.0,0,0,0,0,0,0,0,4,0,0,4,1
1657,37656,BGZaaH5HDVuGvqaegp5MyJblPEuJpcXP,bWdj2GDclj5ofokWjzoa5jAwMkxCykd6,2,0,0,0,0,0,2,0,2,0.2857142857142857,1,0.0,0,0,0,0,0,0,0,2,0,0,2,1
1658,37657,h93nu205LxG6yA79vswKf1FixgIn79rm,G8EPVSXsOYB5YQWZGiz1aVq5Pgr2GrQu,10,11,5,0,0,1,7,1,25,3.5714285714285716,1,0.0,4,5,0,0,7,1,0,7,1,9,16,1
1659,37658,k3sYdhuU0JisiJgPpOdae3U2CoUcaazJ,SpATywNh6bZuzm8s1ceuBUnMUAeoAHHw,16,24,7,12,3,23,7,1,77,11.0,2,0.0,10,7,12,3,14,23,0,7,1,32,45,1
1660,37661,BGZaaH5HDVuGvqaegp5MyJblPEuJpcXP,A3fsA9Zfv1X2fVEQhTw51lKENdNrEqT3,2,0,0,0,0,0,2,0,2,0.2857142857142857,1,0.0,0,0,0,0,0,0,0,2,0,0,2,0
1661,37675,4P8kDd8yuaZj29FYuMADbc9LGiIxpIwD,bWdj2GDclj5ofokWjzoa5jAwMkxCykd6,15,16,5,59,4,3,11,1,99,14.142857142857142,2,0.0,6,5,56,4,10,3,3,11,1,71,28,1
1662,37686,UkQJwGAwu2oSVR7bdUsiWWEqFzH2qHlf,SpATywNh6bZuzm8s1ceuBUnMUAeoAHHw,8,13,4,0,2,0,7,0,26,3.7142857142857144,2,0.0,0,4,0,2,13,0,0,7,0,6,20,0
1663,37694,umy7brIUz48bN1VUJsZEuHA9by5FINCa,A3fsA9Zfv1X2fVEQhTw51lKENdNrEqT3,23,27,21,0,13,3,16,0,80,11.428571428571429,2,0.0,0,21,0,13,27,3,0,16,0,34,46,1
1664,37695,KaDaT2PXnsmD67HkbCpFnRySFfo61Clp,A3fsA9Zfv1X2fVEQhTw51lKENdNrEqT3,19,20,15,0,13,0,3,0,51,7.285714285714286,2,0.0,0,15,0,13,20,0,0,3,0,28,23,1
1665,37700,bLIF0ETNcg7fjkutu8YBWJptM3zxtu2Z,A3fsA9Zfv1X2fVEQhTw51lKENdNrEqT3,9,11,11,0,11,1,11,0,45,6.428571428571429,2,0.0,0,11,0,11,11,1,0,11,0,22,23,1
1666,37712,K8l2u7bOqtMijaHas6Baa4xmjexwxyjr,G8EPVSXsOYB5YQWZGiz1aVq5Pgr2GrQu,7,3,2,0,2,0,6,0,13,1.8571428571428572,1,0.0,0,2,0,2,3,0,0,6,0,4,9,0
1667,37715,vfZ107RlnUxktrRHn8r9duLiSNHxQt59,SpATywNh6bZuzm8s1ceuBUnMUAeoAHHw,13,8,6,2,3,8,3,0,30,4.285714285714286,1,0.0,0,6,2,3,8,8,0,3,0,11,19,1
1668,37730,z3YnX73v2uoVHmuLGzQD2gKKBoJqIQxK,bWdj2GDclj5ofokWjzoa5jAwMkxCykd6,18,37,17,66,14,1,14,1,150,21.428571428571427,5,0.0,14,17,60,14,23,1,6,14,1,105,45,0
1669,37740,B1u0c5LDTPlzBAhbGuUr9zut2NBFb4ik,G8EPVSXsOYB5YQWZGiz1aVq5Pgr2GrQu,8,4,3,0,2,0,2,0,11,1.5714285714285714,1,0.0,0,3,0,2,4,0,0,2,0,5,6,1
1670,37743,5IM8g7YMOYo5qH7Yu3x31T3JkVOH9iqe,A3fsA9Zfv1X2fVEQhTw51lKENdNrEqT3,17,26,8,0,7,0,2,0,43,6.142857142857143,1,0.0,0,8,0,7,26,0,0,2,0,15,28,1
1671,37744,YGd4irzc5KMR1PH2KdOtbCkghLMZ2dPk,bWdj2GDclj5ofokWjzoa5jAwMkxCykd6,4,2,2,0,0,0,2,0,6,0.8571428571428571,1,0.0,0,2,0,0,2,0,0,2,0,2,4,1
1672,37750,GpHiOkm3UY3R1sigoD8RZsfbPyCjOvL2,bWdj2GDclj5ofokWjzoa5jAwMkxCykd6,11,20,13,0,10,0,7,0,50,7.142857142857143,5,0.0,0,13,0,10,20,0,0,7,0,23,27,1
1673,37754,qzjZHUzfivuSEB3h2CxO69AUVaBX51Ki,A3fsA9Zfv1X2fVEQhTw51lKENdNrEqT3,2,0,0,0,0,0,5,0,5,0.7142857142857143,2,0.0,0,0,0,0,0,0,0,5,0,0,5,1
1674,37767,b9kodEhA94IDSBT3ykY4QWiqr6rjyws0,G8EPVSXsOYB5YQWZGiz1aVq5Pgr2GrQu,1,0,0,0,0,0,1,0,1,0.14285714285714285,1,0.0,0,0,0,0,0,0,0,1,0,0,1,1
1675,37768,CeSP4PMtab0Lz3R25BXEghWPiV1yY5Ef,SpATywNh6bZuzm8s1ceuBUnMUAeoAHHw,15,22,3,17,0,9,17,2,70,10.0,3,0.0,9,3,15,0,13,9,2,17,2,27,43,1
1676,37778,MT2eJtF59AVNdUs7mwFqputROb2HgEm3,A3fsA9Zfv1X2fVEQhTw51lKENdNrEqT3,44,23,15,74,11,0,9,1,133,19.0,2,0.0,5,15,61,11,18,0,13,9,1,92,41,0
1677,37792,fXZ6GxDg4jr2jydxDfAmDq6HhmCcTKhM,bWdj2GDclj5ofokWjzoa5jAwMkxCykd6,6,1,1,0,1,0,3,1,7,1.0,1,0.0,0,1,0,1,1,0,0,3,1,2,5,1
1678,37794,uQjl8NGtIQkRfoe9edBiMgtYYmdkzVXR,A3fsA9Zfv1X2fVEQhTw51lKENdNrEqT3,44,52,32,82,13,0,18,0,197,28.142857142857142,5,0.0,9,32,65,13,43,0,17,18,0,119,78,0
1679,37795,AtIH4YI3eYIPCQxtOLtZgwyhSnXOdn2e,A3fsA9Zfv1X2fVEQhTw51lKENdNrEqT3,1,0,0,0,0,0,1,0,1,0.14285714285714285,1,0.0,0,0,0,0,0,0,0,1,0,0,1,1
1680,37796,Zl7A4QMlAs6IcbXcPt0cXmqZJLFzPwcf,SpATywNh6bZuzm8s1ceuBUnMUAeoAHHw,15,14,7,10,5,0,10,0,46,6.571428571428571,2,0.0,4,7,9,5,10,0,1,10,0,25,21,1
1681,37799,t7ddfllmrYfl93sdsVEbTfmmaWswoGkm,bWdj2GDclj5ofokWjzoa5jAwMkxCykd6,11,21,11,0,7,0,11,1,51,7.285714285714286,3,0.0,2,11,0,7,19,0,0,11,1,20,31,1
1682,37806,0FuB48Egjj7khWsNq1DtKTVsB7OEgidM,bWdj2GDclj5ofokWjzoa5jAwMkxCykd6,10,17,9,0,7,0,10,0,43,6.142857142857143,2,0.0,2,9,0,7,15,0,0,10,0,18,25,1
1683,37809,eEE69ZWSNrdmveqNEUHZYk60iG9wpaEc,SpATywNh6bZuzm8s1ceuBUnMUAeoAHHw,16,32,16,11,3,32,10,0,104,14.857142857142858,3,0.0,7,16,9,3,25,32,2,10,0,35,69,1
1684,37810,NcPdgwZnF0RkLUxC56tG83zG3V3KP94S,SpATywNh6bZuzm8s1ceuBUnMUAeoAHHw,14,18,10,17,4,4,10,1,64,9.142857142857142,4,0.0,6,10,14,4,12,4,3,10,1,34,30,1
1685,37820,VjekNiOqthnLG6rS8JBJtCSICch28JV9,SpATywNh6bZuzm8s1ceuBUnMUAeoAHHw,11,12,9,0,5,0,8,0,34,4.857142857142857,3,0.0,0,9,0,5,12,0,0,8,0,14,20,0
1686,37823,2Y3h62Lps0fU6B3C4MXM4YNVNDf25XBr,SpATywNh6bZuzm8s1ceuBUnMUAeoAHHw,10,13,10,0,7,0,3,0,33,4.714285714285714,3,0.0,0,10,0,7,13,0,0,3,0,17,16,0
1687,37825,C2tzR0PThnHl9xmZylE5Te8es3KNWViY,SpATywNh6bZuzm8s1ceuBUnMUAeoAHHw,1,0,0,0,0,0,1,0,1,0.14285714285714285,1,0.0,0,0,0,0,0,0,0,1,0,0,1,1
1688,37827,C2tzR0PThnHl9xmZylE5Te8es3KNWViY,bWdj2GDclj5ofokWjzoa5jAwMkxCykd6,4,3,0,0,0,0,3,0,6,0.8571428571428571,2,0.0,0,0,0,0,3,0,0,3,0,0,6,1
1689,37830,0FuB48Egjj7khWsNq1DtKTVsB7OEgidM,A3fsA9Zfv1X2fVEQhTw51lKENdNrEqT3,26,20,15,0,12,0,8,1,56,8.0,2,0.0,0,15,0,12,20,0,0,8,1,27,29,0
1690,37841,H4f84AflSuLjxZbar9MNvTHEIA8lIMO0,G8EPVSXsOYB5YQWZGiz1aVq5Pgr2GrQu,8,2,2,0,2,0,3,0,9,1.2857142857142858,1,0.0,0,2,0,2,2,0,0,3,0,4,5,1
1691,37842,QeQqhAEpCOGJwaPPp0lj3OsPiBcGFat2,SpATywNh6bZuzm8s1ceuBUnMUAeoAHHw,14,52,3,4,3,1,15,0,78,11.142857142857142,5,0.0,14,3,4,3,38,1,0,15,0,24,54,0
1692,37851,6ovqVSF3YZ6bnWJaJ7v2dHPROWXVVlFQ,SpATywNh6bZuzm8s1ceuBUnMUAeoAHHw,15,14,6,10,3,0,4,2,39,5.571428571428571,2,0.0,6,6,10,3,8,0,0,4,2,25,14,1
1693,37857,fhNT15VFhs3gsHOTo44snQYPYn9BDZ0e,A3fsA9Zfv1X2fVEQhTw51lKENdNrEqT3,5,6,3,0,0,3,4,0,16,2.2857142857142856,2,0.0,1,3,0,0,5,3,0,4,0,4,12,1
1694,37862,i454zkNvATiV1XJbjzVrf2ArWE1JYXx7,G8EPVSXsOYB5YQWZGiz1aVq5Pgr2GrQu,6,1,1,0,1,0,5,0,8,1.1428571428571428,1,0.0,0,1,0,1,1,0,0,5,0,2,6,1
1695,37879,xx9GC4KvGKaMlifXkbb8bDYUKB0PSURf,G8EPVSXsOYB5YQWZGiz1aVq5Pgr2GrQu,14,9,6,0,5,0,4,0,24,3.4285714285714284,1,0.0,0,6,0,5,9,0,0,4,0,11,13,1
1696,37900,qZhmmNUvkNXdf3u04DTUQOFEBxxO10p4,SpATywNh6bZuzm8s1ceuBUnMUAeoAHHw,15,42,19,10,3,4,20,0,98,14.0,6,0.0,5,19,8,3,37,4,2,20,0,35,63,0
1697,37901,blQFA8HzhNQeb8MMYJXyJW6sPMdvZQKn,bWdj2GDclj5ofokWjzoa5jAwMkxCykd6,7,4,2,0,1,0,8,0,15,2.142857142857143,2,0.0,0,2,0,1,4,0,0,8,0,3,12,1
1698,37902,fHWbyI7D8dlYSwaHNTLNlsq8suMt5t3C,SpATywNh6bZuzm8s1ceuBUnMUAeoAHHw,16,68,37,19,10,77,43,4,258,36.857142857142854,4,0.0,12,37,17,10,56,77,2,43,4,76,182,1
1699,37917,zov347eGa3QeB2nEEXWZhFIKLoCmgiMD,SpATywNh6bZuzm8s1ceuBUnMUAeoAHHw,10,28,4,0,2,2,4,0,40,5.714285714285714,3,0.0,0,4,0,2,28,2,0,4,0,6,34,0
1700,37922,j3dtYivg2u73ZbuSWbPPpSBQQec6vBYH,A3fsA9Zfv1X2fVEQhTw51lKENdNrEqT3,6,4,2,0,1,0,4,0,11,1.5714285714285714,3,0.0,0,2,0,1,4,0,0,4,0,3,8,0
1701,37923,EHdY3AEgr2nI6jaAM9bjHY2nqgEPned4,SpATywNh6bZuzm8s1ceuBUnMUAeoAHHw,11,12,4,5,2,0,4,0,27,3.857142857142857,2,0.0,2,4,4,2,10,0,1,4,0,12,15,1
1702,37925,v1W3YvgJ0IFCSGXyKmwZ2bb9TVfgDIwv,G8EPVSXsOYB5YQWZGiz1aVq5Pgr2GrQu,6,6,2,0,2,0,1,0,11,1.5714285714285714,1,0.0,3,2,0,2,3,0,0,1,0,7,4,0
1703,37935,OkJ0lKmMXuQ2MGftQ8Isfw1JciMpapRC,SpATywNh6bZuzm8s1ceuBUnMUAeoAHHw,15,32,17,7,9,2,9,0,76,10.857142857142858,5,0.0,3,17,7,9,29,2,0,9,0,36,40,0
1704,37940,QmHQ7ayFECnRsgCVpHpJI6yMYR4kf5re,bWdj2GDclj5ofokWjzoa5jAwMkxCykd6,11,14,7,14,0,7,6,0,48,6.857142857142857,2,0.0,1,7,14,0,13,7,0,6,0,22,26,0
1705,37960,bz2uqvuFRCLaJmY4vFLIXrs9g0cTBHJC,A3fsA9Zfv1X2fVEQhTw51lKENdNrEqT3,42,19,14,52,9,0,12,3,109,15.571428571428571,4,0.0,1,14,46,9,18,0,6,12,3,70,39,1
1706,37973,k0lvFNaTVHTtB1XHBZ8229ej4v1r4rPk,bWdj2GDclj5ofokWjzoa5jAwMkxCykd6,9,5,1,0,1,6,10,1,24,3.4285714285714284,2,0.0,0,1,0,1,5,6,0,10,1,2,22,0
1707,37982,OJtJM3YEXIy4oJKwRv1QkycNqhb8JLoi,SpATywNh6bZuzm8s1ceuBUnMUAeoAHHw,6,2,1,0,1,0,3,2,9,1.2857142857142858,1,0.0,0,1,0,1,2,0,0,3,2,2,7,1
1708,37983,YG3IIEQOezPClODg4SNvtFayndWcEJ7a,A3fsA9Zfv1X2fVEQhTw51lKENdNrEqT3,8,11,5,0,1,0,5,0,22,3.142857142857143,2,0.0,0,5,0,1,11,0,0,5,0,6,16,1
1709,37988,fUqxJqppQTNVXv13r4wKORaBU4L22bhx,SpATywNh6bZuzm8s1ceuBUnMUAeoAHHw,5,3,2,0,2,0,2,0,9,1.2857142857142858,1,0.0,0,2,0,2,3,0,0,2,0,4,5,1
1710,37989,jkwnVusgQrKbxfhd5nIkbaklULLOZT9D,A3fsA9Zfv1X2fVEQhTw51lKENdNrEqT3,1,0,0,0,0,0,2,0,2,0.2857142857142857,1,0.0,0,0,0,0,0,0,0,2,0,0,2,1
1711,38003,gxc60X8EJb2yIw8hE5NeguZan8o3YXLZ,SpATywNh6bZuzm8s1ceuBUnMUAeoAHHw,16,14,6,10,3,1,6,1,41,5.857142857142857,2,0.0,2,6,9,3,12,1,1,6,1,20,21,1
1712,38004,QEbMAkKsvpPGPL1XkTiHjXblquVwKrlD,A3fsA9Zfv1X2fVEQhTw51lKENdNrEqT3,17,19,3,0,1,0,12,1,36,5.142857142857143,3,0.0,1,3,0,1,18,0,0,12,1,5,31,1
1713,38006,KRzA1Kk4qiSF9draiukb1XAlRpMcb8Gh,SpATywNh6bZuzm8s1ceuBUnMUAeoAHHw,5,2,1,0,1,0,2,0,6,0.8571428571428571,1,0.0,0,1,0,1,2,0,0,2,0,2,4,1
1714,38016,i9wjeQMhaeiCRSFBW7M0FOy9yJ5VeZZF,SpATywNh6bZuzm8s1ceuBUnMUAeoAHHw,8,15,2,0,0,0,13,0,30,4.285714285714286,2,0.0,0,2,0,0,15,0,0,13,0,2,28,1
1715,38026,u82lBhpDxJIwlZISEntCxj1zgVFdW0vT,G8EPVSXsOYB5YQWZGiz1aVq5Pgr2GrQu,1,0,0,0,0,0,1,0,1,0.14285714285714285,1,0.0,0,0,0,0,0,0,0,1,0,0,1,1
1716,38033,KlQIh6CJiUFTrdMyk4Y8sFKMj5TT9ON4,A3fsA9Zfv1X2fVEQhTw51lKENdNrEqT3,26,20,15,0,10,1,8,1,55,7.857142857142857,2,0.0,2,15,0,10,18,1,0,8,1,27,28,1
1717,38047,KkXSOHPa8OPkVJQjN92ejg7MqYYerSuw,A3fsA9Zfv1X2fVEQhTw51lKENdNrEqT3,5,3,2,0,2,0,5,0,12,1.7142857142857142,2,0.0,0,2,0,2,3,0,0,5,0,4,8,1
1718,38068,PmZJAFj6wJkOD163WkhaJjRHdYOMjBZW,SpATywNh6bZuzm8s1ceuBUnMUAeoAHHw,18,18,6,18,3,59,6,1,111,15.857142857142858,4,0.0,9,6,15,3,9,59,3,6,1,33,78,1
1719,38070,sKmcegdtnOHdb8n0mSxwdw5R2hJqVxhV,SpATywNh6bZuzm8s1ceuBUnMUAeoAHHw,6,3,2,0,2,0,1,0,8,1.1428571428571428,1,0.0,0,2,0,2,3,0,0,1,0,4,4,1
1720,38087,QyvVrWztIgSCCViLyqSM2D5NbMV2fEBm,SpATywNh6bZuzm8s1ceuBUnMUAeoAHHw,1,0,0,0,0,0,1,0,1,0.14285714285714285,1,0.0,0,0,0,0,0,0,0,1,0,0,1,0
1721,38092,32tAPwhpK9bCQqIAiBE9WTs1sTNu9Vyf,A3fsA9Zfv1X2fVEQhTw51lKENdNrEqT3,1,0,0,0,0,0,1,0,1,0.14285714285714285,1,0.0,0,0,0,0,0,0,0,1,0,0,1,1
1722,38097,MkuttLQlAg2ibzg21YKyuq14uYFl6Q9Q,A3fsA9Zfv1X2fVEQhTw51lKENdNrEqT3,10,30,7,0,0,1,12,1,51,7.285714285714286,2,0.0,10,7,0,0,20,1,0,12,1,17,34,1
1723,38100,NsLNEhFZrusC9duqTXuavXuymnAo5QEg,SpATywNh6bZuzm8s1ceuBUnMUAeoAHHw,15,35,3,19,1,4,16,0,78,11.142857142857142,4,0.0,12,3,16,1,23,4,3,16,0,32,46,1
1724,38105,vrESC5Tu2ZaCb3FZy3EK8oGteg0Z9Ni5,SpATywNh6bZuzm8s1ceuBUnMUAeoAHHw,9,10,2,2,1,1,2,0,18,2.5714285714285716,2,0.0,0,2,2,1,10,1,0,2,0,5,13,1
1725,38106,ayqwdyDC23QUsfyE7IPhnu9xrtfBNG6f,A3fsA9Zfv1X2fVEQhTw51lKENdNrEqT3,8,3,2,0,2,0,7,0,14,2.0,1,0.0,0,2,0,2,3,0,0,7,0,4,10,1
1726,38107,LHHlrNsXCuatY288NK6FIa7kJtq4Rtqs,bWdj2GDclj5ofokWjzoa5jAwMkxCykd6,8,5,4,0,3,0,8,0,20,2.857142857142857,1,0.0,0,4,0,3,5,0,0,8,0,7,13,1
1727,38111,QRq9SneqdOEdNrPCbzGfNOJsUrpMzzSX,bWdj2GDclj5ofokWjzoa5jAwMkxCykd6,6,2,1,0,1,1,5,1,11,1.5714285714285714,2,0.0,0,1,0,1,2,1,0,5,1,2,9,1
1728,38123,c0naQwXHS50DG3yNNBzMC8iE3KoRWTjm,SpATywNh6bZuzm8s1ceuBUnMUAeoAHHw,7,1,1,0,1,0,4,1,8,1.1428571428571428,1,0.0,0,1,0,1,1,0,0,4,1,2,6,1
1729,38140,xGWjos5nKrn7rxQEQkV1V6pBI2rS4Q4S,SpATywNh6bZuzm8s1ceuBUnMUAeoAHHw,15,28,17,18,8,10,3,0,84,12.0,2,0.0,7,17,15,8,21,10,3,3,0,47,37,1
1730,38144,0Hl4WpPV6z0OC8rO0L3mZy6harAUBUs7,G8EPVSXsOYB5YQWZGiz1aVq5Pgr2GrQu,45,74,19,82,12,3,10,0,200,28.571428571428573,5,0.0,28,19,58,12,46,3,24,10,0,117,83,1
1731,38147,OHOHfGJUvl8C8rOynV86vKj0FrD2jzFO,SpATywNh6bZuzm8s1ceuBUnMUAeoAHHw,15,19,3,14,2,3,19,0,60,8.571428571428571,4,0.0,2,3,11,2,17,3,3,19,0,18,42,1
1732,38154,qazSXcMxbAaqtIZJoNDUrPRsgwDYZFDz,SpATywNh6bZuzm8s1ceuBUnMUAeoAHHw,1,0,0,0,0,0,1,0,1,0.14285714285714285,1,0.0,0,0,0,0,0,0,0,1,0,0,1,1
1733,38155,cqdnmjbJq0lDv2xgeKuzXqVr5xQytWr0,A3fsA9Zfv1X2fVEQhTw51lKENdNrEqT3,6,4,2,0,1,0,2,0,9,1.2857142857142858,1,0.0,0,2,0,1,4,0,0,2,0,3,6,1
1734,38157,tHNSnLtZK1vGs5MVrEoD7S1mcW3GtFm4,SpATywNh6bZuzm8s1ceuBUnMUAeoAHHw,13,16,8,14,3,2,1,0,44,6.285714285714286,1,0.0,3,8,13,3,13,2,1,1,0,27,17,0
1735,38170,vs0vqlNXzuHsqVxOsB15kGfpvGf2pUt3,SpATywNh6bZuzm8s1ceuBUnMUAeoAHHw,12,34,18,12,5,0,7,0,76,10.857142857142858,4,0.0,10,18,12,5,24,0,0,7,0,45,31,0
1736,38176,c59GF0I0pecGycS0yL4PRG9aMLNUIigo,bWdj2GDclj5ofokWjzoa5jAwMkxCykd6,5,2,1,0,1,0,3,0,7,1.0,2,0.0,0,1,0,1,2,0,0,3,0,2,5,1
1737,38187,SX4dmJ5a5AfJLGZkCiiWab293xeIyxbW,SpATywNh6bZuzm8s1ceuBUnMUAeoAHHw,18,67,9,19,8,9,37,3,152,21.714285714285715,4,0.0,8,9,16,8,59,9,3,37,3,41,111,0
1738,38192,PfM2UIipqAa1BYASMdmivESfQH5kpXct,RXDvfPUBYFlVdlueBFbLW0mhhAyGEqpt,8,5,4,0,2,0,1,0,12,1.7142857142857142,1,0.0,0,4,0,2,5,0,0,1,0,6,6,0
1739,38201,hUScWllYUJ1urcx9IQ6nI2SqodbYOaw3,SpATywNh6bZuzm8s1ceuBUnMUAeoAHHw,14,23,8,21,5,0,2,0,59,8.428571428571429,2,0.0,8,8,17,5,15,0,4,2,0,38,21,0
1740,38203,fZom2mtwZsSiSJuSBhugfgY0ABzNEmyV,G8EPVSXsOYB5YQWZGiz1aVq5Pgr2GrQu,13,25,13,0,9,2,4,0,53,7.571428571428571,3,0.0,9,13,0,9,16,2,0,4,0,31,22,1
1741,38206,kKH4olslIcMX5RimtmBANWk2T6CuD4cI,G8EPVSXsOYB5YQWZGiz1aVq5Pgr2GrQu,7,4,0,0,0,0,12,0,16,2.2857142857142856,1,0.0,0,0,0,0,4,0,0,12,0,0,16,1
1742,38219,EwpbggvNdZkeSTjdG48aEltlJYavm02s,bWdj2GDclj5ofokWjzoa5jAwMkxCykd6,7,14,1,0,0,0,3,0,18,2.5714285714285716,2,0.0,1,1,0,0,13,0,0,3,0,2,16,0
1743,38243,dwm6PFLf21BfXk9L9RgwIu033moNrMaZ,A3fsA9Zfv1X2fVEQhTw51lKENdNrEqT3,2,0,0,0,0,0,2,0,2,0.2857142857142857,1,0.0,0,0,0,0,0,0,0,2,0,0,2,1
1744,38245,9d3FbHjuwecHssUlcCF17pB1YrxPmjAd,SpATywNh6bZuzm8s1ceuBUnMUAeoAHHw,5,2,1,0,1,0,2,0,6,0.8571428571428571,1,0.0,0,1,0,1,2,0,0,2,0,2,4,1
1745,38252,S2i0VW7GN0ACeCnuAPN00XONM8w8kvsN,G8EPVSXsOYB5YQWZGiz1aVq5Pgr2GrQu,19,35,21,44,0,1,11,6,118,16.857142857142858,2,0.0,8,21,34,0,27,1,10,11,6,63,55,0
1746,38255,EwpbggvNdZkeSTjdG48aEltlJYavm02s,RXDvfPUBYFlVdlueBFbLW0mhhAyGEqpt,1,0,0,0,0,0,1,0,1,0.14285714285714285,1,0.0,0,0,0,0,0,0,0,1,0,0,1,1
1747,38261,h2cFTJnPj8CTdq0hhUdrEDtmsY30xXQA,G8EPVSXsOYB5YQWZGiz1aVq5Pgr2GrQu,10,20,5,2,1,0,5,0,33,4.714285714285714,3,0.0,6,5,1,1,14,0,1,5,0,13,20,1
1748,38264,DPr3Hy8387gfJi0Jc3ohxKBzY0mvhH1G,SpATywNh6bZuzm8s1ceuBUnMUAeoAHHw,8,6,3,3,1,10,4,2,29,4.142857142857143,2,0.0,0,3,3,1,6,10,0,4,2,7,22,0
1749,38267,xnr1pqResnWIFBWHoMthHT4GwMr3vBWt,SpATywNh6bZuzm8s1ceuBUnMUAeoAHHw,15,23,7,11,3,0,5,0,49,7.0,1,0.0,13,7,11,3,10,0,0,5,0,34,15,1
1750,38269,gzTBwYPoQwnODJJ2vedsUKp2EoGao5Fz,bWdj2GDclj5ofokWjzoa5jAwMkxCykd6,9,12,1,0,1,1,6,0,21,3.0,3,0.0,0,1,0,1,12,1,0,6,0,2,19,1
1751,38312,PzUJiLnP9HZJxQE6JmMTkx1KTzCMtAvI,A3fsA9Zfv1X2fVEQhTw51lKENdNrEqT3,1,0,0,0,0,0,1,0,1,0.14285714285714285,1,0.0,0,0,0,0,0,0,0,1,0,0,1,1
1752,38319,mGGeZkXtXipHfCgx75xnWUmx7JTil5yZ,SpATywNh6bZuzm8s1ceuBUnMUAeoAHHw,1,0,0,0,0,0,1,0,1,0.14285714285714285,1,0.0,0,0,0,0,0,0,0,1,0,0,1,1
1753,38330,ooLh9t6oSyJHSmVF4HH7sDMAh5QMFRua,bWdj2GDclj5ofokWjzoa5jAwMkxCykd6,7,10,1,0,0,2,15,2,30,4.285714285714286,3,0.0,1,1,0,0,9,2,0,15,2,2,28,1
1754,38342,C8IOBAC7DRHGJ1rz7pC1Kh8zvUK3Uruf,bWdj2GDclj5ofokWjzoa5jAwMkxCykd6,5,2,1,0,1,0,2,0,6,0.8571428571428571,1,0.0,0,1,0,1,2,0,0,2,0,2,4,1
1755,38345,skcEk7TV3jhSAknl5Kr7UawZFeqJNMzy,SpATywNh6bZuzm8s1ceuBUnMUAeoAHHw,9,10,6,0,5,0,3,0,24,3.4285714285714284,2,0.0,0,6,0,5,10,0,0,3,0,11,13,1
1756,38348,DTsOT0NTIRutfokoKq4yB8bQe3U1fEsD,SpATywNh6bZuzm8s1ceuBUnMUAeoAHHw,1,0,0,0,0,0,1,0,1,0.14285714285714285,1,0.0,0,0,0,0,0,0,0,1,0,0,1,0
1757,38362,ngiOS4CfHKeFfCKjGfQvFpxE4ckVZ4zO,A3fsA9Zfv1X2fVEQhTw51lKENdNrEqT3,9,4,3,0,3,0,2,0,12,1.7142857142857142,1,0.0,0,3,0,3,4,0,0,2,0,6,6,1
1758,38369,P4MCLwt6pxkkQ1f3WWeAp7xsGAazOtsm,SpATywNh6bZuzm8s1ceuBUnMUAeoAHHw,4,2,1,0,1,0,3,0,7,1.0,2,0.0,0,1,0,1,2,0,0,3,0,2,5,1
1759,38371,a3kUr1OVNVUUdkmJCjmwPQMV5PtCkdEz,SpATywNh6bZuzm8s1ceuBUnMUAeoAHHw,2,0,0,0,0,0,2,0,2,0.2857142857142857,1,0.0,0,0,0,0,0,0,0,2,0,0,2,1
1760,38377,qkZ3BaC1M1zrdLJXoQVUnE0RxlFverb8,A3fsA9Zfv1X2fVEQhTw51lKENdNrEqT3,1,0,0,0,0,0,1,0,1,0.14285714285714285,1,0.0,0,0,0,0,0,0,0,1,0,0,1,1
1761,38391,MAkHN0TS4uaTPgKLso4eQ3LTCDiU28De,bWdj2GDclj5ofokWjzoa5jAwMkxCykd6,12,30,16,0,10,1,15,0,72,10.285714285714286,2,0.0,2,16,0,10,28,1,0,15,0,28,44,1
1762,38393,NgT4xv3zS3UyiRdDnPLyxI49HQKeMn2D,G8EPVSXsOYB5YQWZGiz1aVq5Pgr2GrQu,59,111,5,116,8,2,24,2,268,38.285714285714285,5,0.0,56,5,85,8,55,2,31,24,2,154,114,1
1763,38407,JJYEr1YA7SClhqsLz61VElUYdghcCxlW,RXDvfPUBYFlVdlueBFbLW0mhhAyGEqpt,1,0,0,0,0,0,1,0,1,0.14285714285714285,1,0.0,0,0,0,0,0,0,0,1,0,0,1,1
1764,38420,YAaB5kbzMpno3yyQhEjSC43PC6r4FUut,bWdj2GDclj5ofokWjzoa5jAwMkxCykd6,3,2,1,0,0,1,4,0,8,1.1428571428571428,1,0.0,0,1,0,0,2,1,0,4,0,1,7,1
1765,38425,bIGq7A9r0Y0NLU65d3TOWeEFWRfABEv0,SpATywNh6bZuzm8s1ceuBUnMUAeoAHHw,17,18,9,14,3,0,13,1,58,8.285714285714286,1,0.0,7,9,12,3,11,0,2,13,1,31,27,1
1766,38431,gjPSUf8VbxmvyczDJCPomXU7IV6RTx1x,SpATywNh6bZuzm8s1ceuBUnMUAeoAHHw,17,28,7,10,3,23,25,4,100,14.285714285714286,2,0.0,10,7,9,3,18,23,1,25,4,29,71,1
1767,38447,dNx7yBBYuWpRM4BeMNLD1yOnUwcueGfB,bWdj2GDclj5ofokWjzoa5jAwMkxCykd6,11,25,5,40,4,5,13,1,93,13.285714285714286,2,0.0,5,5,39,4,20,5,1,13,1,53,40,0
1768,38453,oBHdxxTFsPNGTsDRAnTRpoi8FODO2mxr,SpATywNh6bZuzm8s1ceuBUnMUAeoAHHw,7,3,2,0,2,0,2,0,9,1.2857142857142858,1,0.0,0,2,0,2,3,0,0,2,0,4,5,1
1769,38454,dNx7yBBYuWpRM4BeMNLD1yOnUwcueGfB,SpATywNh6bZuzm8s1ceuBUnMUAeoAHHw,15,31,6,17,4,0,10,0,68,9.714285714285714,2,0.0,4,6,15,4,27,0,2,10,0,29,39,0
1770,38480,Y0R5Jnk5aIi2yBcZ9pxBzdem2y9Lpgok,SpATywNh6bZuzm8s1ceuBUnMUAeoAHHw,10,7,1,0,1,1,6,0,16,2.2857142857142856,1,0.0,0,1,0,1,7,1,0,6,0,2,14,1
1771,38494,nkWrffpo6kobU01lUWepcu6aQb60BdxH,SpATywNh6bZuzm8s1ceuBUnMUAeoAHHw,15,24,14,7,7,0,7,0,59,8.428571428571429,3,0.0,5,14,7,7,19,0,0,7,0,33,26,1
1772,38496,fd1NhQTFxl8TsBhiRc4F6bEwrFxQh7qC,SpATywNh6bZuzm8s1ceuBUnMUAeoAHHw,10,5,4,0,2,0,3,0,14,2.0,1,0.0,0,4,0,2,5,0,0,3,0,6,8,1
1773,38503,KGORZAfEVmjDZyD0eVVyErKdl89uylGc,G8EPVSXsOYB5YQWZGiz1aVq5Pgr2GrQu,5,4,0,0,0,0,1,0,5,0.7142857142857143,1,0.0,0,0,0,0,4,0,0,1,0,0,5,1
1774,38505,Dy0I4gbpbRtwh6YDRhpgGBLDEGUYJgO6,SpATywNh6bZuzm8s1ceuBUnMUAeoAHHw,9,13,5,0,0,2,5,1,26,3.7142857142857144,1,0.0,3,5,0,0,10,2,0,5,1,8,18,1
1775,38514,88mqKZu0uTbuMx2E6ZRqhvo4tmoL4qfn,SpATywNh6bZuzm8s1ceuBUnMUAeoAHHw,14,12,1,18,0,8,19,1,59,8.428571428571429,2,0.0,5,1,15,0,7,8,3,19,1,21,38,1
1776,38520,WRiHtWJX61VUGyAGQFSHJ3czdrgqxeQW,RXDvfPUBYFlVdlueBFbLW0mhhAyGEqpt,1,0,0,0,0,0,3,0,3,0.42857142857142855,3,0.0,0,0,0,0,0,0,0,3,0,0,3,1
1777,38525,859jT8mbwD5IkofIqzzz6ylJUi1ZwOt3,SpATywNh6bZuzm8s1ceuBUnMUAeoAHHw,18,31,14,10,9,21,12,1,98,14.0,3,0.0,9,14,9,9,22,21,1,12,1,41,57,1
1778,38532,8SZ4vKq1qHRfFJV3A51uH46l0c4FRvvR,SpATywNh6bZuzm8s1ceuBUnMUAeoAHHw,16,27,16,13,7,2,17,2,84,12.0,5,0.0,9,16,12,7,18,2,1,17,2,44,40,0
1779,38538,oBHdxxTFsPNGTsDRAnTRpoi8FODO2mxr,RXDvfPUBYFlVdlueBFbLW0mhhAyGEqpt,1,0,0,0,0,0,1,0,1,0.14285714285714285,1,0.0,0,0,0,0,0,0,0,1,0,0,1,1
1780,38541,uarVJhEs6XLW7Dw1D7iBgEK6zPe65WwX,bWdj2GDclj5ofokWjzoa5jAwMkxCykd6,1,0,0,0,0,0,1,0,1,0.14285714285714285,1,0.0,0,0,0,0,0,0,0,1,0,0,1,1
1781,38545,rarzYMzRoT8HAQOSSilddy5adopj22jf,A3fsA9Zfv1X2fVEQhTw51lKENdNrEqT3,8,7,0,0,0,0,1,0,8,1.1428571428571428,1,0.0,0,0,0,0,7,0,0,1,0,0,8,1
1782,38550,Xq1kPqflDNgXwQ2pEniNYUjMpkVzPp1m,A3fsA9Zfv1X2fVEQhTw51lKENdNrEqT3,17,25,13,0,12,2,2,0,54,7.714285714285714,2,0.0,2,13,0,12,23,2,0,2,0,27,27,1
1783,38551,UKG5GO5JWRjFVRMggOgvDIxPiEZzBxAO,bWdj2GDclj5ofokWjzoa5jAwMkxCykd6,5,7,2,0,1,0,2,0,12,1.7142857142857142,2,0.0,0,2,0,1,7,0,0,2,0,3,9,1
1784,38554,tajSblOKlQlXdpIXIOLLEJCHn56vIOfT,bWdj2GDclj5ofokWjzoa5jAwMkxCykd6,18,58,27,80,13,38,23,0,239,34.142857142857146,5,0.0,12,27,70,13,46,38,10,23,0,122,117,1
1785,38556,rajcXZ0kL5d9yXQIc9HHtBEyfRs8vn2R,G8EPVSXsOYB5YQWZGiz1aVq5Pgr2GrQu,5,2,1,0,1,0,2,0,6,0.8571428571428571,1,0.0,0,1,0,1,2,0,0,2,0,2,4,1
1786,38587,NeX0NKDgti39PYJeedkcSvEJfGuCFAhK,SpATywNh6bZuzm8s1ceuBUnMUAeoAHHw,11,5,3,0,3,0,5,0,16,2.2857142857142856,1,0.0,1,3,0,3,4,0,0,5,0,7,9,1
1787,38596,spd8M0wss3Tbv0YQ5WcIllIwTexcZnnW,SpATywNh6bZuzm8s1ceuBUnMUAeoAHHw,13,46,2,22,1,0,10,0,81,11.571428571428571,5,0.0,4,2,18,1,42,0,4,10,0,25,56,0
1788,38602,KbRlzY47exomwt4drbIiBF6s4vNevAUk,A3fsA9Zfv1X2fVEQhTw51lKENdNrEqT3,40,21,16,60,12,0,4,0,113,16.142857142857142,1,0.0,2,16,59,12,19,0,1,4,0,89,24,1
1789,38605,VPjMKah4KBMlWaK4uQInEcrWLVtwuYU3,SpATywNh6bZuzm8s1ceuBUnMUAeoAHHw,8,6,4,0,1,0,8,1,20,2.857142857142857,2,0.0,0,4,0,1,6,0,0,8,1,5,15,1
1790,38610,qatSZvztGH03ZmpAnP6syWYERxxmPTgm,SpATywNh6bZuzm8s1ceuBUnMUAeoAHHw,8,5,4,0,3,0,5,0,17,2.4285714285714284,1,0.0,0,4,0,3,5,0,0,5,0,7,10,1
1791,38618,6zUyeP7S7jGCTdu7QvSdhvgcWdRlZ9vk,A3fsA9Zfv1X2fVEQhTw51lKENdNrEqT3,11,14,5,0,3,0,13,0,35,5.0,2,0.0,0,5,0,3,14,0,0,13,0,8,27,1
1792,38621,C800geUBh3GYBhoh4cW6ReKUGj5LAMGi,SpATywNh6bZuzm8s1ceuBUnMUAeoAHHw,12,15,0,17,0,53,31,0,116,16.571428571428573,4,0.0,3,0,16,0,12,53,1,31,0,19,97,0
1793,38623,aKS3VkxSVtZSsON0tlb1uUJK6seiU1iY,SpATywNh6bZuzm8s1ceuBUnMUAeoAHHw,16,24,13,21,6,0,6,4,74,10.571428571428571,2,0.0,6,13,17,6,18,0,4,6,4,42,32,1
1794,38625,Na52PtAqm4VlTMUv1OPLGNjij0a5votC,A3fsA9Zfv1X2fVEQhTw51lKENdNrEqT3,18,23,11,0,6,15,11,0,66,9.428571428571429,2,0.0,0,11,0,6,23,15,0,11,0,17,49,1
1795,38636,xbw9nCFRWInH7KOVpMVJ0cKpswH8IEpv,SpATywNh6bZuzm8s1ceuBUnMUAeoAHHw,13,20,4,18,0,2,9,0,53,7.571428571428571,3,0.0,2,4,16,0,18,2,2,9,0,22,31,0
1796,38637,aYZOvavq8vAsMixc171e3LCkk7Ck4eQv,SpATywNh6bZuzm8s1ceuBUnMUAeoAHHw,2,0,0,0,0,0,2,0,2,0.2857142857142857,1,0.0,0,0,0,0,0,0,0,2,0,0,2,1
1797,38649,I6Zefk3suQV0ULhgPf2DN9gGAf2yKSKv,SpATywNh6bZuzm8s1ceuBUnMUAeoAHHw,10,17,6,0,0,2,6,0,31,4.428571428571429,2,0.0,0,6,0,0,17,2,0,6,0,6,25,1
1798,38668,NjnyUEkQdbuj3M7NhvY8iDqgWMA59DIH,SpATywNh6bZuzm8s1ceuBUnMUAeoAHHw,14,11,7,3,5,2,6,1,35,5.0,1,0.0,2,7,3,5,9,2,0,6,1,17,18,1
1799,38670,dg0Zm4MjeckxnEiOKa4Gh8nunN8SFI0L,SpATywNh6bZuzm8s1ceuBUnMUAeoAHHw,4,2,1,0,0,0,2,0,5,0.7142857142857143,1,0.0,0,1,0,0,2,0,0,2,0,1,4,1
1800,38676,aWfbena9lEo41V5W87oDDgjvcz4pLKtN,SpATywNh6bZuzm8s1ceuBUnMUAeoAHHw,18,24,10,14,5,1,17,2,73,10.428571428571429,3,0.0,6,10,11,5,18,1,3,17,2,32,41,0
1801,38679,5LOlerEFHf0UNcpvuhvEHGBh6ERlMDur,G8EPVSXsOYB5YQWZGiz1aVq5Pgr2GrQu,4,2,0,0,0,5,4,0,11,1.5714285714285714,2,0.0,0,0,0,0,2,5,0,4,0,0,11,0
1802,38685,FncubT1DgrtJxWo1YRhPHqwgNARiG5Jv,SpATywNh6bZuzm8s1ceuBUnMUAeoAHHw,14,26,3,14,1,0,8,0,52,7.428571428571429,3,0.0,9,3,13,1,17,0,1,8,0,26,26,0
1803,38687,RfCEa3pRuKLOxQiUZgZZMFg3JntXDg1m,SpATywNh6bZuzm8s1ceuBUnMUAeoAHHw,13,26,14,0,9,0,10,0,59,8.428571428571429,3,0.0,0,14,0,9,26,0,0,10,0,23,36,0
1804,38688,spd8M0wss3Tbv0YQ5WcIllIwTexcZnnW,A3fsA9Zfv1X2fVEQhTw51lKENdNrEqT3,6,11,0,0,0,0,2,0,13,1.8571428571428572,3,0.0,0,0,0,0,11,0,0,2,0,0,13,1
1805,38692,ktbF3sxXQk0MrToCOKFGvH2bCmfBVgYK,G8EPVSXsOYB5YQWZGiz1aVq5Pgr2GrQu,17,37,0,6,1,1,5,0,50,7.142857142857143,2,0.0,17,0,4,1,20,1,2,5,0,22,28,0
1806,38703,bDOMCQV7nFdKo0pDqOPr3ECLpgkdBCSt,bWdj2GDclj5ofokWjzoa5jAwMkxCykd6,10,9,2,0,1,1,6,1,20,2.857142857142857,2,0.0,0,2,0,1,9,1,0,6,1,3,17,1
1807,38704,LbhBqPcHsayzBPTM5h5jHXG3yJonlt5t,A3fsA9Zfv1X2fVEQhTw51lKENdNrEqT3,44,36,30,72,22,8,14,0,182,26.0,1,0.0,1,30,63,22,35,8,9,14,0,116,66,1
1808,38708,QWAnJ98MRtHXbl78XXr3UpScat4E7MnZ,SpATywNh6bZuzm8s1ceuBUnMUAeoAHHw,11,17,1,9,0,0,2,0,29,4.142857142857143,1,0.0,5,1,9,0,12,0,0,2,0,15,14,0
1809,38719,UIE935UirfemaybvWwRc5Sijo8VfPEYO,SpATywNh6bZuzm8s1ceuBUnMUAeoAHHw,7,6,4,0,2,0,5,0,17,2.4285714285714284,2,0.0,0,4,0,2,6,0,0,5,0,6,11,1
1810,38757,sEqqQzJgfFwEJ59pjhsH9YLQDd58mQLD,SpATywNh6bZuzm8s1ceuBUnMUAeoAHHw,7,13,1,0,0,0,5,0,19,2.7142857142857144,3,0.0,2,1,0,0,11,0,0,5,0,3,16,1
1811,38759,JBGQp737lLGmxKZ5ElVyvCkZ4zEqlLXt,SpATywNh6bZuzm8s1ceuBUnMUAeoAHHw,5,3,0,0,0,0,2,0,5,0.7142857142857143,1,0.0,0,0,0,0,3,0,0,2,0,0,5,1
1812,38769,OygU41dc8lyatpKc4JEBkP0ni21xzfvB,SpATywNh6bZuzm8s1ceuBUnMUAeoAHHw,15,9,5,9,3,0,6,0,32,4.571428571428571,2,0.0,2,5,9,3,7,0,0,6,0,19,13,0
1813,38785,QpfK7z5GdRL9KsohkHQ7AWpk99tKhwdp,SpATywNh6bZuzm8s1ceuBUnMUAeoAHHw,12,25,14,9,0,0,6,0,54,7.714285714285714,4,0.0,6,14,7,0,19,0,2,6,0,27,27,1
1814,38808,xy8Pu3m8OtRxFLhTfix6XvZn0H18zyZc,G8EPVSXsOYB5YQWZGiz1aVq5Pgr2GrQu,9,15,1,0,1,0,6,0,23,3.2857142857142856,3,0.0,0,1,0,1,15,0,0,6,0,2,21,0
1815,38811,T6EWQ7jVP89JlHzj41KN1gEtGYevpSQM,SpATywNh6bZuzm8s1ceuBUnMUAeoAHHw,9,18,8,1,1,0,8,0,36,5.142857142857143,5,0.0,3,8,1,1,15,0,0,8,0,13,23,0
1816,38815,RfVW0lNKrf9tzkgd827lLFW37SMuSXSa,SpATywNh6bZuzm8s1ceuBUnMUAeoAHHw,4,3,0,0,0,0,1,0,4,0.5714285714285714,1,0.0,0,0,0,0,3,0,0,1,0,0,4,1
1817,38825,t8zwYEwnyPi1IDBby2HgJ3IlSwhRkmGy,SpATywNh6bZuzm8s1ceuBUnMUAeoAHHw,15,30,1,21,0,25,12,1,90,12.857142857142858,4,0.0,10,1,18,0,20,25,3,12,1,29,61,0
1818,38826,RLA6GL5vSBJRKc1kwf2CaEaK6FOv9roZ,RXDvfPUBYFlVdlueBFbLW0mhhAyGEqpt,10,19,5,0,3,0,1,0,28,4.0,2,0.0,2,5,0,3,17,0,0,1,0,10,18,0
1819,38827,i5nCgFIHY6Zcmf0CbMZLC0bzGv6djmqm,G8EPVSXsOYB5YQWZGiz1aVq5Pgr2GrQu,7,6,1,0,1,1,7,0,16,2.2857142857142856,1,0.0,0,1,0,1,6,1,0,7,0,2,14,1
1820,38833,v4HIYrR0I8FWtTlaAHD463q83gEr8oUl,RXDvfPUBYFlVdlueBFbLW0mhhAyGEqpt,22,18,11,12,4,1,5,0,51,7.285714285714286,2,0.0,2,11,12,4,16,1,0,5,0,29,22,1
1821,38849,FnrvxXFGCqAMeXxoMCc55xlzH80Et8mi,SpATywNh6bZuzm8s1ceuBUnMUAeoAHHw,7,1,1,0,1,1,5,0,9,1.2857142857142858,1,0.0,0,1,0,1,1,1,0,5,0,2,7,1
1822,38860,aSq9IJ4ZfLUbnD7QSBT8oeA7EtoTrGal,bWdj2GDclj5ofokWjzoa5jAwMkxCykd6,8,18,0,0,0,23,6,1,48,6.857142857142857,2,0.0,0,0,0,0,18,23,0,6,1,0,48,1
1823,38906,U6b5ShGjMWYggq6FsoytPW1feWorMDiT,SpATywNh6bZuzm8s1ceuBUnMUAeoAHHw,1,0,0,0,0,0,1,0,1,0.14285714285714285,1,0.0,0,0,0,0,0,0,0,1,0,0,1,1
1824,38912,35Qckp7squ2ifhCEFcVeQZHmfUAJiaXc,SpATywNh6bZuzm8s1ceuBUnMUAeoAHHw,18,36,15,18,3,12,16,3,103,14.714285714285714,2,0.0,14,15,14,3,22,12,4,16,3,46,57,1
1825,38922,nV21XWIQ3aHCYYV7hPNmU8NbA6rAppIq,G8EPVSXsOYB5YQWZGiz1aVq5Pgr2GrQu,7,6,0,0,0,0,4,0,10,1.4285714285714286,1,0.0,0,0,0,0,6,0,0,4,0,0,10,1
1826,38923,MuiBmNrQSuFDjsexIRPrYiU9583FwFbE,SpATywNh6bZuzm8s1ceuBUnMUAeoAHHw,17,39,18,15,7,15,13,2,109,15.571428571428571,1,0.0,9,18,12,7,30,15,3,13,2,46,63,1
1827,38928,LKo3yUnM07K4Le8KPm2nARMox6nb3a03,SpATywNh6bZuzm8s1ceuBUnMUAeoAHHw,10,12,5,0,2,1,7,1,28,4.0,2,0.0,5,5,0,2,7,1,0,7,1,12,16,1
1828,38940,IXJChwgShKb71VXFYaM4KTehE3VXk7Kg,bWdj2GDclj5ofokWjzoa5jAwMkxCykd6,8,3,2,0,2,0,3,0,10,1.4285714285714286,1,0.0,1,2,0,2,2,0,0,3,0,5,5,1
1829,38942,VrBnKyI7RjgXozKQXJ2DSbj5Gvev22L0,SpATywNh6bZuzm8s1ceuBUnMUAeoAHHw,13,12,6,14,5,0,2,0,39,5.571428571428571,1,0.0,4,6,14,5,8,0,0,2,0,29,10,0
1830,38944,N1N2VoCQ3DCM7YknWLib5UEHyI2wyiAp,A3fsA9Zfv1X2fVEQhTw51lKENdNrEqT3,6,3,2,0,1,0,6,0,12,1.7142857142857142,1,0.0,0,2,0,1,3,0,0,6,0,3,9,1
1831,38954,hWagcbwGHP337RS0iBSta7Eh6v3OAnlN,SpATywNh6bZuzm8s1ceuBUnMUAeoAHHw,17,28,12,15,3,5,11,0,74,10.571428571428571,4,0.0,11,12,14,3,17,5,1,11,0,40,34,1
1832,38955,BE4JaFadHavW9r5xCXpj3M456eZAgaG6,SpATywNh6bZuzm8s1ceuBUnMUAeoAHHw,16,27,9,15,4,1,9,0,65,9.285714285714286,2,0.0,13,9,12,4,14,1,3,9,0,38,27,1
1833,38960,csUQD8kl5B2qOhCgBpUdVV3uOWaYGbyH,A3fsA9Zfv1X2fVEQhTw51lKENdNrEqT3,11,12,1,0,1,0,4,0,18,2.5714285714285716,2,0.0,0,1,0,1,12,0,0,4,0,2,16,1
1834,38969,qP7HUxoCtXsXPUg6TOciLBwLDEqZxGLw,SpATywNh6bZuzm8s1ceuBUnMUAeoAHHw,5,3,1,0,1,0,2,0,7,1.0,1,0.0,0,1,0,1,3,0,0,2,0,2,5,1
1835,38976,n7mMvLvnaxc6y3IIFJpmSNUncj3jx1Ev,RXDvfPUBYFlVdlueBFbLW0mhhAyGEqpt,7,2,2,0,2,1,4,2,13,1.8571428571428572,1,0.0,0,2,0,2,2,1,0,4,2,4,9,1
1836,38984,Np3UGgyqJRbdjHAs6eqMYNuWuEJ67rAv,bWdj2GDclj5ofokWjzoa5jAwMkxCykd6,16,20,10,34,4,0,7,0,75,10.714285714285714,3,0.0,2,10,30,4,18,0,4,7,0,46,29,1
1837,38995,7nUtazUwwSnnXJpIKdQBJGpXV6Po42DQ,A3fsA9Zfv1X2fVEQhTw51lKENdNrEqT3,15,17,1,0,0,0,11,1,30,4.285714285714286,2,0.0,0,1,0,0,17,0,0,11,1,1,29,1
1838,39016,79QvR9MowSFdJ7PRFtAx8omEmqdf2G66,A3fsA9Zfv1X2fVEQhTw51lKENdNrEqT3,8,5,1,0,1,0,6,0,13,1.8571428571428572,1,0.0,0,1,0,1,5,0,0,6,0,2,11,1
1839,39017,sUk3OLEiiNZtlo4krMYRLjkp5xwgbsPl,bWdj2GDclj5ofokWjzoa5jAwMkxCykd6,1,0,0,0,0,0,1,0,1,0.14285714285714285,1,0.0,0,0,0,0,0,0,0,1,0,0,1,1
1840,39020,sUk3OLEiiNZtlo4krMYRLjkp5xwgbsPl,A3fsA9Zfv1X2fVEQhTw51lKENdNrEqT3,1,0,0,0,0,0,2,0,2,0.2857142857142857,1,0.0,0,0,0,0,0,0,0,2,0,0,2,1
1841,39024,KbrQAfHN76lnV5ENpEesywqeBtzfyubO,SpATywNh6bZuzm8s1ceuBUnMUAeoAHHw,18,25,11,19,3,2,19,7,86,12.285714285714286,2,0.0,9,11,16,3,16,2,3,19,7,39,47,0
1842,39028,dNx7yBBYuWpRM4BeMNLD1yOnUwcueGfB,A3fsA9Zfv1X2fVEQhTw51lKENdNrEqT3,8,25,0,0,0,2,7,0,34,4.857142857142857,2,0.0,1,0,0,0,24,2,0,7,0,1,33,0
1843,39033,NfJMxVbS19N5X90YBDzzOQ6861Bhuidv,SpATywNh6bZuzm8s1ceuBUnMUAeoAHHw,11,6,4,0,3,0,4,1,18,2.5714285714285716,1,0.0,0,4,0,3,6,0,0,4,1,7,11,1
1844,39050,St7zx5CuqYmo3cCQEAdzvR5kNp3mDM9y,SpATywNh6bZuzm8s1ceuBUnMUAeoAHHw,18,28,14,18,5,15,19,1,100,14.285714285714286,4,0.0,9,14,15,5,19,15,3,19,1,43,57,0
1845,39051,PlXHYUUQO0ZfkxRdI3LzMqwSKR0cnJTo,bWdj2GDclj5ofokWjzoa5jAwMkxCykd6,1,0,0,0,0,0,1,0,1,0.14285714285714285,1,0.0,0,0,0,0,0,0,0,1,0,0,1,1
1846,39054,blGSSjmsnVQQQrRQxZJTHNQQUXxgUvBL,SpATywNh6bZuzm8s1ceuBUnMUAeoAHHw,8,17,7,0,2,0,4,0,30,4.285714285714286,2,0.0,3,7,0,2,14,0,0,4,0,12,18,0
1847,39057,l21tCwOolR7RD0CZyqRiNHHeEZC1D67K,SpATywNh6bZuzm8s1ceuBUnMUAeoAHHw,9,27,8,19,0,35,6,0,95,13.571428571428571,2,0.0,16,8,17,0,11,35,2,6,0,41,54,0
1848,39058,uGuE3FWo0NVfQumLjneHZr95vibdZhQe,SpATywNh6bZuzm8s1ceuBUnMUAeoAHHw,8,12,5,3,0,0,2,0,22,3.142857142857143,1,0.0,6,5,3,0,6,0,0,2,0,14,8,1
1849,39060,T4lMOZ9NGQ0RS4ue5IeZuDcW1ySIGZ9u,A3fsA9Zfv1X2fVEQhTw51lKENdNrEqT3,33,14,11,42,11,0,1,0,79,11.285714285714286,1,0.0,0,11,38,11,14,0,4,1,0,60,19,1
1850,39063,Zx1NMbt45yqUj8qZK11kDvFPzYX2jIZZ,SpATywNh6bZuzm8s1ceuBUnMUAeoAHHw,14,15,8,17,6,0,2,0,48,6.857142857142857,1,0.0,4,8,15,6,11,0,2,2,0,33,15,1
1851,39066,3SER276qaao5TSZqnt0y9TkdmkGTUUcO,SpATywNh6bZuzm8s1ceuBUnMUAeoAHHw,8,5,4,0,4,0,1,0,14,2.0,1,0.0,0,4,0,4,5,0,0,1,0,8,6,1
1852,39070,O3F8lLfHLYapLPkEvSdAfSwSBCUUJfWK,SpATywNh6bZuzm8s1ceuBUnMUAeoAHHw,4,0,0,0,0,1,4,1,6,0.8571428571428571,2,0.0,0,0,0,0,0,1,0,4,1,0,6,1
1853,39076,76j1Dib3EpIIxYpQXxI6VKhD3TOXoxhS,SpATywNh6bZuzm8s1ceuBUnMUAeoAHHw,14,28,2,12,0,4,14,0,60,8.571428571428571,1,0.0,9,2,12,0,19,4,0,14,0,23,37,1
1854,39090,fTfrYxb6cRWvjdEVjIZ7skF0s5uk6kd9,SpATywNh6bZuzm8s1ceuBUnMUAeoAHHw,19,23,13,19,4,1,17,1,78,11.142857142857142,6,0.0,3,13,16,4,20,1,3,17,1,36,42,0
1855,39094,tcrMObz5SSDCQNYpPsv4XWOxcLo3IPpN,SpATywNh6bZuzm8s1ceuBUnMUAeoAHHw,7,5,1,0,0,0,3,0,9,1.2857142857142858,2,0.0,0,1,0,0,5,0,0,3,0,1,8,1
1856,39102,7nUtazUwwSnnXJpIKdQBJGpXV6Po42DQ,SpATywNh6bZuzm8s1ceuBUnMUAeoAHHw,13,27,1,14,1,2,11,0,56,8.0,4,0.0,9,1,11,1,18,2,3,11,0,22,34,1
1857,39103,avH35RZc6PS7vBKogre4B3MKABAedNBF,bWdj2GDclj5ofokWjzoa5jAwMkxCykd6,7,22,12,0,2,0,13,0,49,7.0,5,0.0,1,12,0,2,21,0,0,13,0,15,34,1
1858,39107,Dzo4bt517HDNgh4yuxQj3WQVtnrvmG1A,SpATywNh6bZuzm8s1ceuBUnMUAeoAHHw,5,3,0,0,0,0,2,0,5,0.7142857142857143,1,0.0,0,0,0,0,3,0,0,2,0,0,5,1
1859,39109,zu1WAijSG0F2wy5x45xxD1w2SrPWGtuK,SpATywNh6bZuzm8s1ceuBUnMUAeoAHHw,6,1,1,0,1,0,3,0,6,0.8571428571428571,1,0.0,0,1,0,1,1,0,0,3,0,2,4,1
1860,39113,VvziK1FrzCcoikfRc0daxkE7fq3iFq0v,SpATywNh6bZuzm8s1ceuBUnMUAeoAHHw,17,27,12,17,4,2,16,0,78,11.142857142857142,2,0.0,8,12,14,4,19,2,3,16,0,38,40,0
1861,39125,BTjtyE8NjHRpreY21d7F2wNmadCPRKCQ,SpATywNh6bZuzm8s1ceuBUnMUAeoAHHw,7,8,5,0,2,0,4,0,19,2.7142857142857144,3,0.0,0,5,0,2,8,0,0,4,0,7,12,1
1862,39131,uJIh67cllxQLgAhipzdDZMEunDbuBxvF,RXDvfPUBYFlVdlueBFbLW0mhhAyGEqpt,49,54,38,124,22,17,37,20,312,44.57142857142857,4,0.0,14,38,116,22,40,17,8,37,20,190,122,0
1863,39136,srXgccav6ELo546oVIR7hwKdVqMPE3uB,SpATywNh6bZuzm8s1ceuBUnMUAeoAHHw,7,6,1,0,1,0,4,0,12,1.7142857142857142,2,0.0,0,1,0,1,6,0,0,4,0,2,10,1
1864,39139,sUk3OLEiiNZtlo4krMYRLjkp5xwgbsPl,G8EPVSXsOYB5YQWZGiz1aVq5Pgr2GrQu,1,0,0,0,0,0,1,0,1,0.14285714285714285,1,0.0,0,0,0,0,0,0,0,1,0,0,1,1
1865,39152,9LQKs2OgeSVzfrSEIBiyZg4jCEuAC01N,G8EPVSXsOYB5YQWZGiz1aVq5Pgr2GrQu,11,4,1,12,0,0,2,0,19,2.7142857142857144,1,0.0,1,1,11,0,3,0,1,2,0,13,6,1
1866,39158,V0auOwxD2tv59agygO0uPvKcU5ercMUa,SpATywNh6bZuzm8s1ceuBUnMUAeoAHHw,15,28,15,6,5,0,9,0,63,9.0,4,0.0,4,15,6,5,24,0,0,9,0,30,33,1
1867,39179,OGoPVjudSuGohkzHyvu7N6zC3RGML0mw,G8EPVSXsOYB5YQWZGiz1aVq5Pgr2GrQu,19,34,30,0,27,0,3,0,94,13.428571428571429,2,0.0,0,30,0,27,34,0,0,3,0,57,37,1
1868,39182,VIwJtaSOWWljnDL02ObzIxH4JeVU0QQ1,bWdj2GDclj5ofokWjzoa5jAwMkxCykd6,4,3,1,0,0,0,6,0,10,1.4285714285714286,2,0.0,0,1,0,0,3,0,0,6,0,1,9,1
1869,39201,45r4ENaVPqa3xBFTqWFkoJttz7HBM6Lb,SpATywNh6bZuzm8s1ceuBUnMUAeoAHHw,12,18,0,6,0,3,14,5,46,6.571428571428571,3,0.0,2,0,5,0,16,3,1,14,5,7,39,1
1870,39207,RmlyieNXfVrGM9LWnpgNxfz0WPjjsgcE,A3fsA9Zfv1X2fVEQhTw51lKENdNrEqT3,2,0,0,0,0,0,2,0,2,0.2857142857142857,1,0.0,0,0,0,0,0,0,0,2,0,0,2,1
1871,39216,qsBNE43NxZycap30DuQDyNDzs5hGI95w,SpATywNh6bZuzm8s1ceuBUnMUAeoAHHw,7,4,3,0,3,0,2,0,12,1.7142857142857142,2,0.0,0,3,0,3,4,0,0,2,0,6,6,1
1872,39229,rue9XaVrhPMV8jlzLPRPLBsY7dTh1epz,SpATywNh6bZuzm8s1ceuBUnMUAeoAHHw,14,52,3,24,0,8,29,6,122,17.428571428571427,5,0.0,19,3,17,0,33,8,7,29,6,39,83,1
1873,39237,PNuCKnyPWCRVxphTjJ1pIquyKu0dURK7,SpATywNh6bZuzm8s1ceuBUnMUAeoAHHw,5,3,1,0,1,0,2,0,7,1.0,1,0.0,0,1,0,1,3,0,0,2,0,2,5,1
1874,39239,xmz4ffo3Xzh257Ul94Vh1nR04juD6y1C,SpATywNh6bZuzm8s1ceuBUnMUAeoAHHw,1,0,0,0,0,0,1,0,1,0.14285714285714285,1,0.0,0,0,0,0,0,0,0,1,0,0,1,1
1875,39241,krVsPdgfe85VvAQ2rdfbpjD89zMbnkR0,SpATywNh6bZuzm8s1ceuBUnMUAeoAHHw,11,11,4,6,3,1,2,0,27,3.857142857142857,1,0.0,6,4,5,3,5,1,1,2,0,18,9,1
1876,39243,gpyXT5iZHN1onXoVstOXZoiFizXraIkU,SpATywNh6bZuzm8s1ceuBUnMUAeoAHHw,10,16,8,0,3,2,5,1,35,5.0,1,0.0,5,8,0,3,11,2,0,5,1,16,19,1
1877,39246,fv07Mlz09PBHitYybJt9eVrK276xe9YI,SpATywNh6bZuzm8s1ceuBUnMUAeoAHHw,14,9,6,12,4,0,6,0,37,5.285714285714286,3,0.0,2,6,11,4,7,0,1,6,0,23,14,0
1878,39247,Qr5qzmAxo2eU7JvBgyKuPQuH3YgkGzii,SpATywNh6bZuzm8s1ceuBUnMUAeoAHHw,6,3,1,0,1,0,2,0,7,1.0,1,0.0,0,1,0,1,3,0,0,2,0,2,5,1
1879,39248,Lc5TZPB93C58CDuO8VjF5g6g9boxDaHr,RXDvfPUBYFlVdlueBFbLW0mhhAyGEqpt,1,0,0,0,0,0,1,0,1,0.14285714285714285,1,0.0,0,0,0,0,0,0,0,1,0,0,1,1
1880,39254,PATQ2JDuYcR1iRnRPNzs82w3vSQnScOh,RXDvfPUBYFlVdlueBFbLW0mhhAyGEqpt,1,0,0,0,0,0,1,0,1,0.14285714285714285,1,0.0,0,0,0,0,0,0,0,1,0,0,1,1
1881,39264,7ddOasUgoSwmcHs4lJMhvhalD4IA2urH,SpATywNh6bZuzm8s1ceuBUnMUAeoAHHw,10,18,0,0,0,3,9,2,32,4.571428571428571,2,0.0,5,0,0,0,13,3,0,9,2,5,27,0
1882,39274,2nLjdaVfmxwWCLw5sEI1KKYk7UXViPES,SpATywNh6bZuzm8s1ceuBUnMUAeoAHHw,4,3,0,0,0,0,1,0,4,0.5714285714285714,1,0.0,0,0,0,0,3,0,0,1,0,0,4,0
1883,39277,G6iele4ho79nU5jQ1J8umZLq8jEFa9yN,A3fsA9Zfv1X2fVEQhTw51lKENdNrEqT3,12,5,3,0,3,10,5,1,27,3.857142857142857,2,0.0,0,3,0,3,5,10,0,5,1,6,21,1
1884,39293,59KrgCJlOEHQHzBNjsHoSd6BkQVArDrc,SpATywNh6bZuzm8s1ceuBUnMUAeoAHHw,5,4,2,0,1,0,1,0,8,1.1428571428571428,1,0.0,0,2,0,1,4,0,0,1,0,3,5,1
1885,39294,t43o0GKgntYeNvU3jSnPK3vOmS44e5N2,G8EPVSXsOYB5YQWZGiz1aVq5Pgr2GrQu,9,5,1,0,1,2,3,0,12,1.7142857142857142,1,0.0,0,1,0,1,5,2,0,3,0,2,10,1
1886,39296,R2cga9JVVM2tXEVs2saYswslfxAU4nMk,bWdj2GDclj5ofokWjzoa5jAwMkxCykd6,7,6,4,4,0,0,8,0,22,3.142857142857143,3,0.0,2,4,4,0,4,0,0,8,0,10,12,1
1887,39301,ezp80xTAgodAGV4fsnNivfTneJn97tLE,RXDvfPUBYFlVdlueBFbLW0mhhAyGEqpt,48,46,26,100,9,4,15,0,200,28.571428571428573,4,0.0,7,26,94,9,39,4,6,15,0,136,64,0
1888,39312,5taolCXbi4GnZeqgvcKlHbiPurs2tpgr,SpATywNh6bZuzm8s1ceuBUnMUAeoAHHw,15,14,8,4,3,0,8,2,39,5.571428571428571,2,0.0,3,8,4,3,11,0,0,8,2,18,21,0
1889,39327,CnuwKGLCLbXYnPgy82VEWYA1NOiOhvr0,A3fsA9Zfv1X2fVEQhTw51lKENdNrEqT3,8,9,0,0,0,0,5,0,14,2.0,2,0.0,1,0,0,0,8,0,0,5,0,1,13,1
1890,39330,YY7yHizDn0UpGHVq4qoTfbulP3ev5TkC,SpATywNh6bZuzm8s1ceuBUnMUAeoAHHw,11,12,6,2,3,0,4,0,27,3.857142857142857,2,0.0,0,6,2,3,12,0,0,4,0,11,16,0
1891,39339,0QbAHgL1bHqgkC1CgcznJ6rPBigpeoia,SpATywNh6bZuzm8s1ceuBUnMUAeoAHHw,13,9,7,4,3,0,3,0,26,3.7142857142857144,2,0.0,0,7,4,3,9,0,0,3,0,14,12,1
1892,39349,8eqcmJf66b25Hdf1a71yMHA6gdhfVvDC,G8EPVSXsOYB5YQWZGiz1aVq5Pgr2GrQu,47,58,28,108,13,31,39,2,279,39.857142857142854,2,0.0,9,28,99,13,49,31,9,39,2,149,130,0
1893,39360,aiSJXiTI4iLjZWytdZmE5zydDNEQzaHj,A3fsA9Zfv1X2fVEQhTw51lKENdNrEqT3,2,0,0,0,0,0,2,0,2,0.2857142857142857,1,0.0,0,0,0,0,0,0,0,2,0,0,2,1
1894,39367,SgAa84aajahM2sd2hvCdYRfO014ocPV5,SpATywNh6bZuzm8s1ceuBUnMUAeoAHHw,17,35,9,10,5,27,12,1,99,14.142857142857142,3,0.0,10,9,10,5,25,27,0,12,1,34,65,0
1895,39368,OTHiy7CJ3gPgZvtv97Ds8YkrZ0bgVlAw,G8EPVSXsOYB5YQWZGiz1aVq5Pgr2GrQu,4,4,0,0,2,0,1,0,7,1.0,1,0.0,2,0,0,2,2,0,0,1,0,4,3,0
1896,39371,194jqOV6jnj4prH3N2CqRtpc9qi9vfln,A3fsA9Zfv1X2fVEQhTw51lKENdNrEqT3,4,1,0,0,0,0,3,0,4,0.5714285714285714,1,0.0,0,0,0,0,1,0,0,3,0,0,4,1
1897,39372,aA47iNtja2lxoPqFPeHjI7xjYuTmvZjx,SpATywNh6bZuzm8s1ceuBUnMUAeoAHHw,15,20,8,18,3,1,5,0,55,7.857142857142857,4,0.0,8,8,15,3,12,1,3,5,0,34,21,1
1898,39377,M0xQooArrVMTCCgk3YkWTaBSUVldkFxi,SpATywNh6bZuzm8s1ceuBUnMUAeoAHHw,16,11,7,12,3,0,5,0,38,5.428571428571429,2,0.0,2,7,12,3,9,0,0,5,0,24,14,0
1899,39395,i2suUv0IuyNKOwhtAFmOMY1okBxszKdN,A3fsA9Zfv1X2fVEQhTw51lKENdNrEqT3,1,0,0,0,0,0,1,0,1,0.14285714285714285,1,0.0,0,0,0,0,0,0,0,1,0,0,1,1
1900,39397,dlNspelxxHXjwBoo8dpRx9m2ctqEqalr,G8EPVSXsOYB5YQWZGiz1aVq5Pgr2GrQu,7,5,2,0,2,0,3,0,12,1.7142857142857142,1,0.0,0,2,0,2,5,0,0,3,0,4,8,1
1901,39407,W7Pzvj7hPa3qVKdWluutDHqjcp3iIpAb,SpATywNh6bZuzm8s1ceuBUnMUAeoAHHw,18,32,16,18,10,0,7,1,84,12.0,4,0.0,13,16,16,10,19,0,2,7,1,55,29,0
1902,39418,nBG9NwFfkLReYPd7l4XLlLWLMjwV7w8K,A3fsA9Zfv1X2fVEQhTw51lKENdNrEqT3,5,4,1,0,1,0,2,0,8,1.1428571428571428,1,0.0,0,1,0,1,4,0,0,2,0,2,6,1
1903,39422,f6uLbTCHrR4TIVQHhrh2EEZiIDyLA7ZC,SpATywNh6bZuzm8s1ceuBUnMUAeoAHHw,1,0,0,0,0,0,1,0,1,0.14285714285714285,1,0.0,0,0,0,0,0,0,0,1,0,0,1,1
1904,39430,IAvuP4GGmvnNj3Zisz3jDfo3mSmXiJSb,bWdj2GDclj5ofokWjzoa5jAwMkxCykd6,4,6,0,0,0,0,5,0,11,1.5714285714285714,3,0.0,0,0,0,0,6,0,0,5,0,0,11,0
1905,39432,roGokqGBKtukTNGPdY1C2VEr66iWn5eT,G8EPVSXsOYB5YQWZGiz1aVq5Pgr2GrQu,5,2,1,0,1,0,3,0,7,1.0,2,0.0,0,1,0,1,2,0,0,3,0,2,5,1
1906,39441,VsLOJ7Xi4SI8kpOP7KF7SoJJkHTp6ASm,SpATywNh6bZuzm8s1ceuBUnMUAeoAHHw,18,17,8,14,4,8,6,1,58,8.285714285714286,1,0.0,7,8,13,4,10,8,1,6,1,32,26,0
1907,39443,WxaYTMCI7yD8mE0osZVkZT9Orbo545LC,G8EPVSXsOYB5YQWZGiz1aVq5Pgr2GrQu,25,20,17,36,12,0,5,1,91,13.0,2,0.0,2,17,30,12,18,0,6,5,1,61,30,1
1908,39464,e2VhgSHwCVj2IYcx6wF0yjNoIULwWBq8,A3fsA9Zfv1X2fVEQhTw51lKENdNrEqT3,17,15,11,0,7,0,3,0,36,5.142857142857143,2,0.0,1,11,0,7,14,0,0,3,0,19,17,1
1909,39485,O9c4mZKt6PM5RxUHcRjnRJOfvI41UF2p,SpATywNh6bZuzm8s1ceuBUnMUAeoAHHw,18,36,16,16,5,5,21,2,101,14.428571428571429,4,0.0,11,16,13,5,25,5,3,21,2,45,56,0
1910,39486,7UOiW6Ks9JGRUR75AHoSTuRNGYY2xnnm,A3fsA9Zfv1X2fVEQhTw51lKENdNrEqT3,10,10,5,0,2,0,3,0,20,2.857142857142857,1,0.0,0,5,0,2,10,0,0,3,0,7,13,0
1911,39488,fxwFHQhfnCCHU83SJwJLBtmbCrCDlv3i,G8EPVSXsOYB5YQWZGiz1aVq5Pgr2GrQu,17,24,17,0,10,1,4,0,56,8.0,4,0.0,0,17,0,10,24,1,0,4,0,27,29,1
1912,39494,L8U7mZiX5tfpfUV7mFpP0znonqPA6G6R,SpATywNh6bZuzm8s1ceuBUnMUAeoAHHw,12,16,2,14,0,0,5,0,37,5.285714285714286,2,0.0,11,2,13,0,5,0,1,5,0,26,11,1
1913,39496,D55KBHzjFX6XlkQnUeIgoK6OnycKiatp,SpATywNh6bZuzm8s1ceuBUnMUAeoAHHw,7,6,3,0,2,0,2,0,13,1.8571428571428572,2,0.0,0,3,0,2,6,0,0,2,0,5,8,1
1914,39499,nBZt0s4EJwoCi0gxserLJGtn0aLrx1yc,A3fsA9Zfv1X2fVEQhTw51lKENdNrEqT3,17,11,1,18,1,0,11,0,42,6.0,3,0.0,0,1,15,1,11,0,3,11,0,17,25,1
1915,39504,1BLAPxf3lDzwOBM6NeFyerOFp0vZobfY,SpATywNh6bZuzm8s1ceuBUnMUAeoAHHw,7,12,7,0,4,1,3,0,27,3.857142857142857,1,0.0,0,7,0,4,12,1,0,3,0,11,16,0
1916,39512,ivxBGUbA7UT7tzED0gKK31cJU8Lv97zd,SpATywNh6bZuzm8s1ceuBUnMUAeoAHHw,7,7,1,0,1,0,2,0,11,1.5714285714285714,1,0.0,0,1,0,1,7,0,0,2,0,2,9,1
1917,39526,3Aezv8lgcVyIW4Uwgi3KMiL4RZSkwke5,A3fsA9Zfv1X2fVEQhTw51lKENdNrEqT3,10,8,6,0,4,0,5,0,23,3.2857142857142856,2,0.0,0,6,0,4,8,0,0,5,0,10,13,1
1918,39527,BZSYb0PJXmPcTlknqBAAi8E9uLmy4IRE,SpATywNh6bZuzm8s1ceuBUnMUAeoAHHw,15,39,16,6,5,1,11,2,80,11.428571428571429,3,0.0,4,16,5,5,35,1,1,11,2,30,50,1
1919,39530,ZuUY5FCqqOqbgit08Gvv6v9cPTZXO9su,SpATywNh6bZuzm8s1ceuBUnMUAeoAHHw,9,9,4,0,2,0,6,1,22,3.142857142857143,1,0.0,1,4,0,2,8,0,0,6,1,7,15,1
1920,39534,cULoH8ZJIqrdeB8ADfKnnQ8THzmbMgQV,A3fsA9Zfv1X2fVEQhTw51lKENdNrEqT3,2,0,0,0,0,0,2,0,2,0.2857142857142857,1,0.0,0,0,0,0,0,0,0,2,0,0,2,1
1921,39537,xg8lJQFNYZJBLJxL1TK1I5KNSxuhMUEI,bWdj2GDclj5ofokWjzoa5jAwMkxCykd6,5,5,1,0,0,0,3,0,9,1.2857142857142858,2,0.0,0,1,0,0,5,0,0,3,0,1,8,1
1922,39540,xnObPmivHmj7phvTSVLNuvvFk898J2aO,SpATywNh6bZuzm8s1ceuBUnMUAeoAHHw,16,24,4,9,2,2,8,0,49,7.0,3,0.0,4,4,9,2,20,2,0,8,0,19,30,1
1923,39541,fnvAURpBgndjkYxbDVVMCKsNQuRUMiGS,RXDvfPUBYFlVdlueBFbLW0mhhAyGEqpt,1,0,0,0,0,0,1,0,1,0.14285714285714285,1,0.0,0,0,0,0,0,0,0,1,0,0,1,1
1924,39546,94sscb1tthVT0LkFotULcfURBxnTdgyP,A3fsA9Zfv1X2fVEQhTw51lKENdNrEqT3,5,2,1,0,1,0,2,0,6,0.8571428571428571,1,0.0,0,1,0,1,2,0,0,2,0,2,4,1
1925,39560,tfLWXkHQA3FBV54C2lvq1caDx4Pi6QwO,SpATywNh6bZuzm8s1ceuBUnMUAeoAHHw,14,35,14,14,5,0,9,0,77,11.0,5,0.0,11,14,14,5,24,0,0,9,0,44,33,0
1926,39565,lY81J0j7TM6V2dDMqV7lafTfl1uBUPgf,A3fsA9Zfv1X2fVEQhTw51lKENdNrEqT3,36,16,9,92,6,0,14,1,138,19.714285714285715,2,0.0,4,9,81,6,12,0,11,14,1,100,38,1
1927,39567,YC5UG6m05nI4uxDXYqrNEKgzKHSk4oSu,SpATywNh6bZuzm8s1ceuBUnMUAeoAHHw,17,47,23,19,10,6,14,2,121,17.285714285714285,4,0.0,14,23,16,10,33,6,3,14,2,63,58,0
1928,39568,veYIONVCJwpad8Khvzq7a5rgGQHvYo6S,G8EPVSXsOYB5YQWZGiz1aVq5Pgr2GrQu,28,30,21,20,15,1,4,0,91,13.0,2,0.0,5,21,15,15,25,1,5,4,0,56,35,0
1929,39587,X14gKVD1ZKu0qL0NchpqxwhoYSEpz9QI,SpATywNh6bZuzm8s1ceuBUnMUAeoAHHw,11,18,2,10,0,19,12,0,61,8.714285714285714,4,0.0,5,2,9,0,13,19,1,12,0,16,45,0
1930,39595,YFvrapJWr0AHUdxkctZzup6RNdDbndzC,SpATywNh6bZuzm8s1ceuBUnMUAeoAHHw,7,9,2,0,2,0,3,1,17,2.4285714285714284,2,0.0,0,2,0,2,9,0,0,3,1,4,13,0
1931,39608,Z75g2Nz4DcysTkbj3XO50UPDPTuBSclE,A3fsA9Zfv1X2fVEQhTw51lKENdNrEqT3,36,18,2,88,1,5,7,2,123,17.571428571428573,2,0.0,1,2,70,1,17,5,18,7,2,74,49,1
1932,39613,Kp4YCt5gbTMeLX4vxDVqvPhrGDdHDcEC,SpATywNh6bZuzm8s1ceuBUnMUAeoAHHw,8,6,4,0,3,0,1,0,14,2.0,1,0.0,0,4,0,3,6,0,0,1,0,7,7,1
1933,39620,RERMHDA2gNT2NdhpczhxOdgAsVrkLgnS,SpATywNh6bZuzm8s1ceuBUnMUAeoAHHw,5,2,1,0,1,0,2,0,6,0.8571428571428571,1,0.0,0,1,0,1,2,0,0,2,0,2,4,0
1934,39622,GqdYzH9IQjNV4Qw4poxGmkYlIXbhf40S,SpATywNh6bZuzm8s1ceuBUnMUAeoAHHw,11,6,4,8,3,0,1,0,22,3.142857142857143,1,0.0,1,4,7,3,5,0,1,1,0,15,7,1
1935,39623,nlj7VjLiwr4POHSdgtLvTaDUWFoae60t,SpATywNh6bZuzm8s1ceuBUnMUAeoAHHw,15,18,10,2,6,0,9,1,46,6.571428571428571,3,0.0,1,10,2,6,17,0,0,9,1,19,27,1
1936,39627,W5u0uO7QxoiOFkTJ8a7Iluj7qY01eSEK,SpATywNh6bZuzm8s1ceuBUnMUAeoAHHw,8,3,1,0,1,0,4,1,10,1.4285714285714286,1,0.0,0,1,0,1,3,0,0,4,1,2,8,1
1937,39629,vh69W01dADhjl8K2ZA2b9sRlprr5NXs0,SpATywNh6bZuzm8s1ceuBUnMUAeoAHHw,11,11,5,4,2,0,1,0,23,3.2857142857142856,1,0.0,3,5,4,2,8,0,0,1,0,14,9,1
1938,39630,3Aezv8lgcVyIW4Uwgi3KMiL4RZSkwke5,bWdj2GDclj5ofokWjzoa5jAwMkxCykd6,20,36,17,40,9,58,25,5,190,27.142857142857142,4,0.0,9,17,34,9,27,58,6,25,5,69,121,0
1939,39632,YHL8SFwBUtFpO36pvl6xAPsnC0mLXaOp,G8EPVSXsOYB5YQWZGiz1aVq5Pgr2GrQu,9,16,3,0,3,0,4,0,26,3.7142857142857144,3,0.0,0,3,0,3,16,0,0,4,0,6,20,1
1940,39649,BfV7UiYzJLw6WeEm3hlQsMK4WHcSosq4,A3fsA9Zfv1X2fVEQhTw51lKENdNrEqT3,2,0,0,0,0,0,2,0,2,0.2857142857142857,1,0.0,0,0,0,0,0,0,0,2,0,0,2,1
1941,39652,6FzXe5nPWUHRxntREHsQRnp7x1pxuhUz,bWdj2GDclj5ofokWjzoa5jAwMkxCykd6,5,6,2,0,1,0,2,0,11,1.5714285714285714,1,0.0,1,2,0,1,5,0,0,2,0,4,7,1
1942,39662,3uY3PXIjE4xYhALzqv9EDJ3LJju3f4Jc,A3fsA9Zfv1X2fVEQhTw51lKENdNrEqT3,1,0,0,0,0,0,1,0,1,0.14285714285714285,1,0.0,0,0,0,0,0,0,0,1,0,0,1,1
1943,39673,fCmdFT6vVaKttJ0wsJVd3YILMXjqgUpl,A3fsA9Zfv1X2fVEQhTw51lKENdNrEqT3,1,0,0,0,0,0,1,0,1,0.14285714285714285,1,0.0,0,0,0,0,0,0,0,1,0,0,1,1
1944,39676,jsiVqpEsXq0sluinZw5ff1hSi6FTnuod,SpATywNh6bZuzm8s1ceuBUnMUAeoAHHw,2,0,0,0,0,0,2,0,2,0.2857142857142857,1,0.0,0,0,0,0,0,0,0,2,0,0,2,1
1945,39697,CJISoHtkGNnkB0CRrvBDw2uUj4sPNv5j,SpATywNh6bZuzm8s1ceuBUnMUAeoAHHw,12,28,0,13,0,1,4,0,46,6.571428571428571,2,0.0,11,0,10,0,17,1,3,4,0,21,25,1
1946,39709,Nfn60tuwOzVop5pbBaYFyFMaifJoAIP6,bWdj2GDclj5ofokWjzoa5jAwMkxCykd6,16,27,12,56,7,0,4,0,106,15.142857142857142,2,0.0,12,12,48,7,15,0,8,4,0,79,27,1
1947,39723,wg81hfugF770xMHAXCLP7YJmOhdUJnHl,SpATywNh6bZuzm8s1ceuBUnMUAeoAHHw,15,33,10,10,5,7,5,0,70,10.0,3,0.0,11,10,8,5,22,7,2,5,0,34,36,0
1948,39733,rMXcpM1YL9uvJc9vPGaTEpRlMvl4lfsn,bWdj2GDclj5ofokWjzoa5jAwMkxCykd6,4,3,1,0,0,0,1,0,5,0.7142857142857143,1,0.0,0,1,0,0,3,0,0,1,0,1,4,1
1949,39741,aw5sNjg3Ll84wJrvKaca9hOr6No0sjrv,SpATywNh6bZuzm8s1ceuBUnMUAeoAHHw,13,16,2,13,1,0,4,0,36,5.142857142857143,2,0.0,9,2,11,1,7,0,2,4,0,23,13,1
1950,39756,0aMTCmDPG4aC91o1krmKQxgTxAagyKJp,bWdj2GDclj5ofokWjzoa5jAwMkxCykd6,17,31,17,86,12,0,18,1,165,23.571428571428573,4,0.0,11,17,77,12,20,0,9,18,1,117,48,1
1951,39760,s8yyjhcg4BVOip4HSP4txOTTHFJ4aWPU,SpATywNh6bZuzm8s1ceuBUnMUAeoAHHw,3,2,1,0,0,0,2,0,5,0.7142857142857143,2,0.0,0,1,0,0,2,0,0,2,0,1,4,1
1952,39765,Ea76prVlgHXbifiTXOy9yoJBa7oRFv41,RXDvfPUBYFlVdlueBFbLW0mhhAyGEqpt,1,0,0,0,0,0,1,0,1,0.14285714285714285,1,0.0,0,0,0,0,0,0,0,1,0,0,1,1
1953,39773,6QYAwv5e3xo1Sn1iZiEuGx1qJzd44Lj7,RXDvfPUBYFlVdlueBFbLW0mhhAyGEqpt,19,29,7,0,5,0,10,0,51,7.285714285714286,2,0.0,3,7,0,5,26,0,0,10,0,15,36,1
1954,39774,1aQoKDna73jstuOrupWa9Kq8V3FdvbRU,RXDvfPUBYFlVdlueBFbLW0mhhAyGEqpt,7,4,2,0,2,0,1,0,9,1.2857142857142858,1,0.0,0,2,0,2,4,0,0,1,0,4,5,1
1955,39776,OdMr7dE5UlAme9Tp979vREBvY5CV50po,bWdj2GDclj5ofokWjzoa5jAwMkxCykd6,17,13,4,54,5,0,4,0,80,11.428571428571429,3,0.0,7,4,50,5,6,0,4,4,0,66,14,0
1956,39808,Y1HbgiosdaMEUFcfxOopNbywAYIWyuQr,SpATywNh6bZuzm8s1ceuBUnMUAeoAHHw,10,16,1,0,1,8,5,0,31,4.428571428571429,3,0.0,0,1,0,1,16,8,0,5,0,2,29,1
1957,39817,vkw8WV6aYKsdxKvxTMS0euMnMdoDV8qN,bWdj2GDclj5ofokWjzoa5jAwMkxCykd6,5,7,3,0,2,3,1,0,16,2.2857142857142856,1,0.0,2,3,0,2,5,3,0,1,0,7,9,1
1958,39823,rEKGYBPmMNG2ptSViOUukUYctuPLpJ3c,A3fsA9Zfv1X2fVEQhTw51lKENdNrEqT3,8,10,1,0,0,1,11,3,26,3.7142857142857144,2,0.0,2,1,0,0,8,1,0,11,3,3,23,1
1959,39824,ZKL2WgbeR5PdyCIYfqDQ4XNCHZlCFLIz,bWdj2GDclj5ofokWjzoa5jAwMkxCykd6,4,2,1,0,1,0,4,0,8,1.1428571428571428,1,0.0,0,1,0,1,2,0,0,4,0,2,6,1
1960,39827,A6hS9pkzvwTNmFdD6HzIqa5y6YmtMrCe,A3fsA9Zfv1X2fVEQhTw51lKENdNrEqT3,7,7,1,0,1,0,1,0,10,1.4285714285714286,1,0.0,0,1,0,1,7,0,0,1,0,2,8,1
1961,39828,ke8J6J68PMmqZ8rK8FCDUgXlLZQpLLZW,A3fsA9Zfv1X2fVEQhTw51lKENdNrEqT3,44,36,16,102,9,0,7,1,171,24.428571428571427,1,0.0,1,16,84,9,35,0,18,7,1,110,61,1
1962,39837,HboM24Wk39YTBPWC8WzrZxRqA9rZpUU4,SpATywNh6bZuzm8s1ceuBUnMUAeoAHHw,7,8,2,0,1,1,7,1,20,2.857142857142857,2,0.0,0,2,0,1,8,1,0,7,1,3,17,1
1963,39838,dNIlKItJkU7JaK0shSCPHRrbzZCvxDbc,A3fsA9Zfv1X2fVEQhTw51lKENdNrEqT3,6,0,0,0,0,4,8,0,12,1.7142857142857142,1,0.0,0,0,0,0,0,4,0,8,0,0,12,1
1964,39858,efn1iuG0ajlfaHaXrPxReUu8GzdIHbZe,SpATywNh6bZuzm8s1ceuBUnMUAeoAHHw,12,18,10,0,5,1,12,1,47,6.714285714285714,2,0.0,1,10,0,5,17,1,0,12,1,16,31,0
1965,39861,wVfyl6WgFur5urtfx8TypP7osjiRs72N,A3fsA9Zfv1X2fVEQhTw51lKENdNrEqT3,2,0,0,0,0,0,3,0,3,0.42857142857142855,1,0.0,0,0,0,0,0,0,0,3,0,0,3,1
1966,39885,g6UH67YbvJtewLNXQNVZTYui0XC1Hxpo,G8EPVSXsOYB5YQWZGiz1aVq5Pgr2GrQu,33,61,28,66,9,0,12,1,177,25.285714285714285,3,0.0,27,28,50,9,34,0,16,12,1,114,63,0
1967,39886,Dd40k4eqowbb0BAmqLv8aP0MP2R1XA5P,SpATywNh6bZuzm8s1ceuBUnMUAeoAHHw,18,15,6,6,3,21,11,3,65,9.285714285714286,1,0.0,7,6,6,3,8,21,0,11,3,22,43,1
1968,39891,Dk2p6h1MYjykCuVHQMak8GN098n0FvGH,A3fsA9Zfv1X2fVEQhTw51lKENdNrEqT3,7,5,0,0,0,0,3,0,8,1.1428571428571428,2,0.0,0,0,0,0,5,0,0,3,0,0,8,1
1969,39906,xOGjXyyeq87fCMSZ9z7Yuds9sMvR7Ohh,RXDvfPUBYFlVdlueBFbLW0mhhAyGEqpt,5,3,2,0,1,0,1,0,7,1.0,1,0.0,0,2,0,1,3,0,0,1,0,3,4,0
1970,39919,C6gazwyl7EiFD8XZj9L3YaSfbatiTDEE,bWdj2GDclj5ofokWjzoa5jAwMkxCykd6,9,24,12,58,9,0,7,0,110,15.714285714285714,5,0.0,5,12,55,9,19,0,3,7,0,81,29,0
1971,39924,1Lhe3e5bki1E1AUNwq5SspoMJiU5aMmH,RXDvfPUBYFlVdlueBFbLW0mhhAyGEqpt,11,8,5,0,4,0,5,2,24,3.4285714285714284,1,0.0,0,5,0,4,8,0,0,5,2,9,15,0
1972,39925,muBWBBbWzkNF6Dzg57EIx35WmD2zp0yP,SpATywNh6bZuzm8s1ceuBUnMUAeoAHHw,14,26,3,16,2,1,10,0,58,8.285714285714286,4,0.0,7,3,14,2,19,1,2,10,0,26,32,0
1973,39928,ygXUYNlms6qOypCR1kXz9dAuLrVhdPds,SpATywNh6bZuzm8s1ceuBUnMUAeoAHHw,18,23,10,18,3,21,17,1,93,13.285714285714286,5,0.0,7,10,15,3,16,21,3,17,1,35,58,1
1974,39929,r3yTAtA27zn29k1K73ADGURrMlpR5nC7,RXDvfPUBYFlVdlueBFbLW0mhhAyGEqpt,12,19,15,0,12,0,5,0,51,7.285714285714286,1,0.0,0,15,0,12,19,0,0,5,0,27,24,0
1975,39932,ddMTOiTV5HSxEMNnjSDeiKLzuF1YmYcT,A3fsA9Zfv1X2fVEQhTw51lKENdNrEqT3,3,2,1,0,0,0,1,0,4,0.5714285714285714,1,0.0,0,1,0,0,2,0,0,1,0,1,3,1
1976,39938,RVwnUs0luG0pmL3ADXHeT8MpQNWgZj3Z,RXDvfPUBYFlVdlueBFbLW0mhhAyGEqpt,34,36,24,100,0,0,1,0,161,23.0,5,0.0,10,24,92,0,26,0,8,1,0,126,35,1
1977,39941,Z90b24vMiOddvA3R8cPrefim6f9EiVmz,SpATywNh6bZuzm8s1ceuBUnMUAeoAHHw,6,3,2,0,2,0,1,0,8,1.1428571428571428,2,0.0,0,2,0,2,3,0,0,1,0,4,4,0
1978,39943,P6hNwLATXTVCZjt7DoobnBSI1FyeLq01,A3fsA9Zfv1X2fVEQhTw51lKENdNrEqT3,8,15,2,0,2,0,6,0,25,3.5714285714285716,1,0.0,0,2,0,2,15,0,0,6,0,4,21,1
1979,39951,UXCeDIhL283LDr12VbAjFZUd7R6owJ9F,G8EPVSXsOYB5YQWZGiz1aVq5Pgr2GrQu,5,4,0,0,0,0,4,0,8,1.1428571428571428,1,0.0,1,0,0,0,3,0,0,4,0,1,7,0
1980,39956,CHAwTqWzS9gyj5Ro2Bvsw8FCNCA8dW6W,RXDvfPUBYFlVdlueBFbLW0mhhAyGEqpt,19,22,1,6,1,3,22,1,56,8.0,4,0.0,1,1,6,1,21,3,0,22,1,9,47,1
1981,39960,IyXR1neCOqlWiBnFK6SoolM6gOHf0cwa,A3fsA9Zfv1X2fVEQhTw51lKENdNrEqT3,12,4,3,0,3,1,7,0,18,2.5714285714285716,1,0.0,0,3,0,3,4,1,0,7,0,6,12,1
1982,39967,VFl026LXCSxME7l2ZLRhGKmh3R96duCq,SpATywNh6bZuzm8s1ceuBUnMUAeoAHHw,18,40,17,19,5,13,27,1,122,17.428571428571427,6,0.0,6,17,15,5,34,13,4,27,1,43,79,0
1983,39983,m4cy52txIJ3BHr73S3AvnUeiz4g3fpv8,A3fsA9Zfv1X2fVEQhTw51lKENdNrEqT3,8,4,3,0,3,0,1,0,11,1.5714285714285714,1,0.0,0,3,0,3,4,0,0,1,0,6,5,1
1984,39989,dhMm94sLRibUWA6YOpXlMLxyaR3sl4a9,A3fsA9Zfv1X2fVEQhTw51lKENdNrEqT3,13,15,1,0,1,5,9,0,31,4.428571428571429,3,0.0,0,1,0,1,15,5,0,9,0,2,29,0
1985,40010,XsIiMjBHDyB8SLEzKHAHcKIpWlAHXu34,RXDvfPUBYFlVdlueBFbLW0mhhAyGEqpt,29,77,22,45,13,4,9,0,170,24.285714285714285,2,0.0,9,22,43,13,68,4,2,9,0,87,83,0
1986,40013,p1fshV6UZeW7KZmzuxOc9ex10GYNTePc,RXDvfPUBYFlVdlueBFbLW0mhhAyGEqpt,48,41,23,85,12,42,8,2,213,30.428571428571427,3,0.0,15,23,77,12,26,42,8,8,2,127,86,1
1987,40019,wDbI53389OJRBH6MsGEj6dttayfVtGlQ,SpATywNh6bZuzm8s1ceuBUnMUAeoAHHw,1,0,0,0,0,0,1,0,1,0.14285714285714285,1,0.0,0,0,0,0,0,0,0,1,0,0,1,1
1988,40022,SP7CCOQc4gFs6CnOJ8vpnG2qG74ffSCZ,SpATywNh6bZuzm8s1ceuBUnMUAeoAHHw,12,15,0,14,0,0,9,0,38,5.428571428571429,3,0.0,5,0,13,0,10,0,1,9,0,18,20,0
1989,40027,vpdMGAwpHu1uhd9ckN957NDWXXLtiXYo,bWdj2GDclj5ofokWjzoa5jAwMkxCykd6,8,8,4,0,1,26,7,2,48,6.857142857142857,3,0.0,3,4,0,1,5,26,0,7,2,8,40,1
1990,40028,KaeCX7DoW5htn0YhXrWslGGGeoVPFyiJ,G8EPVSXsOYB5YQWZGiz1aVq5Pgr2GrQu,12,11,7,0,5,0,5,0,28,4.0,2,0.0,0,7,0,5,11,0,0,5,0,12,16,1
1991,40037,4wGoSTuzJXBCojeNmaxk9GbR1KaCV7ql,bWdj2GDclj5ofokWjzoa5jAwMkxCykd6,8,4,1,0,1,0,7,1,14,2.0,2,0.0,0,1,0,1,4,0,0,7,1,2,12,1
1992,40039,28PHU9suTM8EqUKsQwsvQ03DzFXi0yDl,A3fsA9Zfv1X2fVEQhTw51lKENdNrEqT3,1,0,0,0,0,0,1,0,1,0.14285714285714285,1,0.0,0,0,0,0,0,0,0,1,0,0,1,0
1993,40054,dlphjzS7Cck7yL7KPK4kXgmYSbBOCuFC,bWdj2GDclj5ofokWjzoa5jAwMkxCykd6,18,56,21,90,11,47,24,2,251,35.857142857142854,5,0.0,15,21,86,11,41,47,4,24,2,133,118,0
1994,40060,qDqnrpVee3l5HrPD2lnOTUKZmsC9F3UK,A3fsA9Zfv1X2fVEQhTw51lKENdNrEqT3,5,2,1,0,1,0,2,0,6,0.8571428571428571,1,0.0,0,1,0,1,2,0,0,2,0,2,4,1
1995,40063,l5LfU8gApOG72AnBkdAbfOLQLwFH7Zo2,bWdj2GDclj5ofokWjzoa5jAwMkxCykd6,16,33,2,128,5,3,5,0,176,25.142857142857142,3,0.0,14,2,123,5,19,3,5,5,0,144,32,1
1996,40074,gT1aUgmAT0anYSW9us4nwhFYETF9WL3j,A3fsA9Zfv1X2fVEQhTw51lKENdNrEqT3,5,2,1,0,1,0,2,0,6,0.8571428571428571,1,0.0,0,1,0,1,2,0,0,2,0,2,4,1
1997,40079,2A7IXlmbeljDbPAl1ZsZqwpJw9LPGGGX,SpATywNh6bZuzm8s1ceuBUnMUAeoAHHw,16,11,6,12,3,15,5,1,53,7.571428571428571,1,0.0,4,6,10,3,7,15,2,5,1,23,30,1
1998,40080,tw29YEXMOD494kfaqMSHK6i8NRmqKdtq,G8EPVSXsOYB5YQWZGiz1aVq5Pgr2GrQu,9,4,3,0,3,0,2,0,12,1.7142857142857142,1,0.0,0,3,0,3,4,0,0,2,0,6,6,1
1999,40081,zyMs55MEXcYV6llnecBHL4KGyjGwZwbR,SpATywNh6bZuzm8s1ceuBUnMUAeoAHHw,2,0,0,0,0,0,2,0,2,0.2857142857142857,1,0.0,0,0,0,0,0,0,0,2,0,0,2,0
2000,40084,J8UiKHYyR4z2Md44vzlhH8x9Cnerjpzr,G8EPVSXsOYB5YQWZGiz1aVq5Pgr2GrQu,2,0,0,0,0,0,2,0,2,0.2857142857142857,1,0.0,0,0,0,0,0,0,0,2,0,0,2,1
2001,40087,yoDT9q7GsYYKpWeoYGubo3V2RcRn4gQU,A3fsA9Zfv1X2fVEQhTw51lKENdNrEqT3,24,4,2,56,1,0,3,0,66,9.428571428571429,1,0.0,1,2,47,1,3,0,9,3,0,51,15,1
2002,40101,D2f4XnvAFD8ZIkDvhpGbd6yCstJua9ut,SpATywNh6bZuzm8s1ceuBUnMUAeoAHHw,8,8,3,0,2,0,2,0,15,2.142857142857143,1,0.0,0,3,0,2,8,0,0,2,0,5,10,1
2003,40104,FUMcFXXfXADMgcSzTyKSabMQ45EVJp0n,A3fsA9Zfv1X2fVEQhTw51lKENdNrEqT3,30,13,11,12,9,1,9,0,55,7.857142857142857,2,0.0,1,11,12,9,12,1,0,9,0,33,22,1
2004,40137,7Blw5DXu09ENSrwHZywqqUdODuz4CZi6,SpATywNh6bZuzm8s1ceuBUnMUAeoAHHw,17,17,9,18,5,0,6,1,56,8.0,1,0.0,7,9,15,5,10,0,3,6,1,36,20,0
2005,40139,5veZ6xRUiuZvoK7jObyhZU0X1eoLbhpg,SpATywNh6bZuzm8s1ceuBUnMUAeoAHHw,6,3,2,0,2,0,1,0,8,1.1428571428571428,1,0.0,0,2,0,2,3,0,0,1,0,4,4,1
2006,40140,LEeLDvxwrRnZu2qnrsr2uQ3TKN0DCY1A,SpATywNh6bZuzm8s1ceuBUnMUAeoAHHw,4,2,1,0,1,1,1,0,6,0.8571428571428571,1,0.0,0,1,0,1,2,1,0,1,0,2,4,0
2007,40149,iUzEPtD1F6CCo8jGkTMMkDMICh5ACqJB,SpATywNh6bZuzm8s1ceuBUnMUAeoAHHw,5,2,1,0,1,0,2,0,6,0.8571428571428571,1,0.0,0,1,0,1,2,0,0,2,0,2,4,1
2008,40154,grc1pAXqdUQaBlZrZyROqjuEtg08nen2,bWdj2GDclj5ofokWjzoa5jAwMkxCykd6,6,2,0,0,0,0,10,0,12,1.7142857142857142,1,0.0,0,0,0,0,2,0,0,10,0,0,12,0
2009,40156,BM23agkLBTvZTkItMt2GtI7Rt9Nmmgof,SpATywNh6bZuzm8s1ceuBUnMUAeoAHHw,11,34,16,0,6,71,6,0,133,19.0,2,0.0,6,16,0,6,28,71,0,6,0,28,105,0
2010,40164,Ml8yd2wTtJsMaa32cmbKtb7cTpIqIKz4,SpATywNh6bZuzm8s1ceuBUnMUAeoAHHw,17,47,30,26,14,0,7,0,124,17.714285714285715,2,0.0,13,30,20,14,34,0,6,7,0,77,47,1
2011,40175,m2y02R5W4wE10TMNO80PJL5IOUbHqLJ2,SpATywNh6bZuzm8s1ceuBUnMUAeoAHHw,16,15,8,9,3,0,6,0,41,5.857142857142857,2,0.0,4,8,9,3,11,0,0,6,0,24,17,0
2012,40182,gMD3QXq0NP11IqNCLAQviPDQUlnfIgHG,A3fsA9Zfv1X2fVEQhTw51lKENdNrEqT3,14,25,1,0,0,13,7,3,49,7.0,2,0.0,0,1,0,0,25,13,0,7,3,1,48,1
2013,40184,p2NSaI2ihMq1kpyPoZO7VVEhFNMs1UZl,bWdj2GDclj5ofokWjzoa5jAwMkxCykd6,15,19,3,94,4,9,4,2,135,19.285714285714285,2,0.0,7,3,88,4,12,9,6,4,2,102,33,1
2014,40188,su19QKj6MYt8IN4q4jbVFtyo4Ew7wkeA,RXDvfPUBYFlVdlueBFbLW0mhhAyGEqpt,12,11,9,0,3,1,4,0,28,4.0,1,0.0,0,9,0,3,11,1,0,4,0,12,16,1
2015,40190,PPWmWzLrUp96FN46Q0IBJuH09vUmH4P8,RXDvfPUBYFlVdlueBFbLW0mhhAyGEqpt,5,2,2,0,0,1,2,0,7,1.0,1,0.0,0,2,0,0,2,1,0,2,0,2,5,1
2016,40198,w1whp42bLIFDRZ3YUW58J4w8I7T8mTT8,SpATywNh6bZuzm8s1ceuBUnMUAeoAHHw,15,48,8,10,3,14,28,1,112,16.0,3,0.0,17,8,10,3,31,14,0,28,1,38,74,1
2017,40204,tYXSIW41vEc1ilow8iQ6smCJvAodHkNV,bWdj2GDclj5ofokWjzoa5jAwMkxCykd6,3,0,0,0,0,4,6,0,10,1.4285714285714286,3,0.0,0,0,0,0,0,4,0,6,0,0,10,1
2018,40221,eLZwBv2irk6SjmpfpnKpxtWIlq5cEmna,SpATywNh6bZuzm8s1ceuBUnMUAeoAHHw,1,0,0,0,0,0,1,0,1,0.14285714285714285,1,0.0,0,0,0,0,0,0,0,1,0,0,1,1
2019,40222,eLodedTH8LaOO46CeXCjKZbHSbVrNTIU,SpATywNh6bZuzm8s1ceuBUnMUAeoAHHw,14,9,4,12,3,0,2,0,30,4.285714285714286,1,0.0,3,4,10,3,6,0,2,2,0,20,10,1
2020,40241,9y5g4IgoufVMmdRflE8Vnup7J4tZ9eiA,SpATywNh6bZuzm8s1ceuBUnMUAeoAHHw,9,13,5,0,2,0,3,0,23,3.2857142857142856,2,0.0,0,5,0,2,13,0,0,3,0,7,16,1
2021,40247,CnndUXNaSJ8w2bb9DGxHOhqjHw4SEo1K,SpATywNh6bZuzm8s1ceuBUnMUAeoAHHw,18,55,18,24,7,39,16,1,160,22.857142857142858,6,0.0,20,18,21,7,35,39,3,16,1,66,94,0
2022,40257,IRfJ2J3e4oTjcMA6yNpRgLvZtLwyduUa,SpATywNh6bZuzm8s1ceuBUnMUAeoAHHw,12,10,4,14,2,0,2,0,32,4.571428571428571,1,0.0,4,4,13,2,6,0,1,2,0,23,9,0
2023,40277,w1whp42bLIFDRZ3YUW58J4w8I7T8mTT8,G8EPVSXsOYB5YQWZGiz1aVq5Pgr2GrQu,1,0,0,0,0,0,3,0,3,0.42857142857142855,2,0.0,0,0,0,0,0,0,0,3,0,0,3,1
2024,40278,mMBONcOMl6gC3uzknh0XJLJbk13L2x3D,SpATywNh6bZuzm8s1ceuBUnMUAeoAHHw,1,0,0,0,0,0,1,0,1,0.14285714285714285,1,0.0,0,0,0,0,0,0,0,1,0,0,1,1
2025,40282,CSh5hGbaSFu2yCb31iVMOVwKocrH471Q,A3fsA9Zfv1X2fVEQhTw51lKENdNrEqT3,9,11,7,0,5,0,3,0,26,3.7142857142857144,2,0.0,0,7,0,5,11,0,0,3,0,12,14,1
2026,40283,QrVCBnMblCvtcbL9oEOfx7eoMJ5VAhGg,A3fsA9Zfv1X2fVEQhTw51lKENdNrEqT3,5,3,0,0,0,1,4,0,8,1.1428571428571428,1,0.0,0,0,0,0,3,1,0,4,0,0,8,1
2027,40311,1Pk7jZ6bfmKYXcNnRyEd7kPSZWAEJN0N,RXDvfPUBYFlVdlueBFbLW0mhhAyGEqpt,4,0,0,0,0,1,3,4,8,1.1428571428571428,3,0.0,0,0,0,0,0,1,0,3,4,0,8,1
2028,40316,TDPVJF1yuusgDrAkAZKxkuuOK4BkswXA,RXDvfPUBYFlVdlueBFbLW0mhhAyGEqpt,1,0,0,0,0,0,1,0,1,0.14285714285714285,1,0.0,0,0,0,0,0,0,0,1,0,0,1,1
2029,40319,wg81hfugF770xMHAXCLP7YJmOhdUJnHl,A3fsA9Zfv1X2fVEQhTw51lKENdNrEqT3,10,13,4,0,3,12,6,0,38,5.428571428571429,2,0.0,0,4,0,3,13,12,0,6,0,7,31,0
2030,40327,5vUuq5ZeDCNce4LmvH0naoUjpb3qbNOp,A3fsA9Zfv1X2fVEQhTw51lKENdNrEqT3,4,3,1,0,0,0,3,0,7,1.0,2,0.0,0,1,0,0,3,0,0,3,0,1,6,1
2031,40332,JCQSo9f9Aey0YG4wslCCbhR6oOLB0oC6,SpATywNh6bZuzm8s1ceuBUnMUAeoAHHw,16,17,6,10,3,0,6,0,42,6.0,3,0.0,6,6,9,3,11,0,1,6,0,24,18,0
2032,40352,lkFGShqBa18inWINppsv8Kl48gyf85dR,A3fsA9Zfv1X2fVEQhTw51lKENdNrEqT3,27,18,13,0,11,4,8,1,55,7.857142857142857,1,0.0,1,13,0,11,17,4,0,8,1,25,30,0
2033,40354,GFHYWWeeAuj1pePvOmCpIpIQDTy4Q3Iv,RXDvfPUBYFlVdlueBFbLW0mhhAyGEqpt,5,4,3,0,0,0,3,0,10,1.4285714285714286,1,0.0,0,3,0,0,4,0,0,3,0,3,7,0
2034,40358,EEH4DLdmIdcQf1RzjjDafMrB5kVed71w,A3fsA9Zfv1X2fVEQhTw51lKENdNrEqT3,11,12,6,0,5,1,7,0,31,4.428571428571429,2,0.0,0,6,0,5,12,1,0,7,0,11,20,1
2035,40364,yzVmKfAEq3932HHrOfA6gQJmdnGWlxk3,bWdj2GDclj5ofokWjzoa5jAwMkxCykd6,1,0,0,0,0,0,1,0,1,0.14285714285714285,1,0.0,0,0,0,0,0,0,0,1,0,0,1,1
2036,40367,wg81hfugF770xMHAXCLP7YJmOhdUJnHl,bWdj2GDclj5ofokWjzoa5jAwMkxCykd6,7,10,3,4,1,0,3,0,21,3.0,2,0.0,1,3,3,1,9,0,1,3,0,8,13,0
2037,40368,12mZjkjOmjGXj1h45WoNLHZyHxNUfx7S,SpATywNh6bZuzm8s1ceuBUnMUAeoAHHw,8,10,1,0,0,0,4,0,15,2.142857142857143,2,0.0,0,1,0,0,10,0,0,4,0,1,14,1
2038,40379,ypimmfavTEjP3dtudBXAUUwNT9VgZavl,SpATywNh6bZuzm8s1ceuBUnMUAeoAHHw,6,3,2,0,1,0,3,0,9,1.2857142857142858,1,0.0,0,2,0,1,3,0,0,3,0,3,6,1
2039,40393,b3FNzt9bW0DYxGtrDwfKBHrmIKO1If8w,SpATywNh6bZuzm8s1ceuBUnMUAeoAHHw,8,10,3,0,3,0,2,0,18,2.5714285714285716,2,0.0,0,3,0,3,10,0,0,2,0,6,12,1
2040,40400,OEVp80aW59NsIt7NX2Io1skiDEX4Ksu0,RXDvfPUBYFlVdlueBFbLW0mhhAyGEqpt,9,5,5,0,1,2,6,2,21,3.0,2,0.0,0,5,0,1,5,2,0,6,2,6,15,1
2041,40402,O7GZYzgRa5tZbYrbtpqYuheFfdPZTjLl,bWdj2GDclj5ofokWjzoa5jAwMkxCykd6,13,21,9,30,6,52,12,2,132,18.857142857142858,3,0.0,5,9,28,6,16,52,2,12,2,48,84,1
2042,40407,oKgEB6oFYTWjl9uatjwv0rz1CsEob0nE,G8EPVSXsOYB5YQWZGiz1aVq5Pgr2GrQu,1,0,0,0,0,0,1,0,1,0.14285714285714285,1,0.0,0,0,0,0,0,0,0,1,0,0,1,1
2043,40413,0Cx8S0i9vAPm7jZ8jXLUkrYp9xGpIHIS,SpATywNh6bZuzm8s1ceuBUnMUAeoAHHw,1,0,0,0,0,0,1,0,1,0.14285714285714285,1,0.0,0,0,0,0,0,0,0,1,0,0,1,1
2044,40423,8jqDD2phXiMGQf0XQi1kVRzLj3TILO0y,RXDvfPUBYFlVdlueBFbLW0mhhAyGEqpt,20,21,13,44,6,0,4,0,88,12.571428571428571,2,0.0,6,13,36,6,15,0,8,4,0,61,27,1
2045,40426,gp5vtbG0la8PEmRrqmDatBiyjEv7PWrx,SpATywNh6bZuzm8s1ceuBUnMUAeoAHHw,9,12,5,20,0,0,3,0,40,5.714285714285714,3,0.0,3,5,16,0,9,0,4,3,0,24,16,1
2046,40427,7x51V9V9eIHFPqiYUnOLpACvWY55pqZF,G8EPVSXsOYB5YQWZGiz1aVq5Pgr2GrQu,6,4,2,0,2,0,2,0,10,1.4285714285714286,1,0.0,0,2,0,2,4,0,0,2,0,4,6,1
2047,40437,sV8Z2WoHSkq80AVgpDh4TBiipVVqEZ0U,A3fsA9Zfv1X2fVEQhTw51lKENdNrEqT3,6,2,1,0,1,0,4,0,8,1.1428571428571428,1,0.0,0,1,0,1,2,0,0,4,0,2,6,1
2048,40438,sV8Z2WoHSkq80AVgpDh4TBiipVVqEZ0U,bWdj2GDclj5ofokWjzoa5jAwMkxCykd6,4,2,1,0,1,0,1,0,5,0.7142857142857143,1,0.0,0,1,0,1,2,0,0,1,0,2,3,1
2049,40447,y6i20DJpIul6LihHwgZcWxbdAap5GcBP,bWdj2GDclj5ofokWjzoa5jAwMkxCykd6,6,4,0,0,0,1,5,0,10,1.4285714285714286,3,0.0,0,0,0,0,4,1,0,5,0,0,10,1
2050,40456,vGcLxIxx9hPQmjm92Kj3O9RHGwvxcHnD,RXDvfPUBYFlVdlueBFbLW0mhhAyGEqpt,18,13,8,6,4,7,8,1,47,6.714285714285714,2,0.0,1,8,6,4,12,7,0,8,1,19,28,1
2051,40467,bNBhDpviOcrLuVFG9Qda6S7fiYJ6jIvc,SpATywNh6bZuzm8s1ceuBUnMUAeoAHHw,15,28,10,14,4,0,4,0,60,8.571428571428571,3,0.0,9,10,13,4,19,0,1,4,0,36,24,1
2052,40469,zynLWMDwDGZGrMFdec4rl1UB2FSg8e8K,A3fsA9Zfv1X2fVEQhTw51lKENdNrEqT3,16,8,6,0,4,2,10,1,31,4.428571428571429,2,0.0,0,6,0,4,8,2,0,10,1,10,21,1
2053,40470,nc7wDS7f7s8kprAeqMfrtjmYyoRdpJ65,bWdj2GDclj5ofokWjzoa5jAwMkxCykd6,6,2,1,0,1,3,5,1,13,1.8571428571428572,1,0.0,0,1,0,1,2,3,0,5,1,2,11,1
2054,40476,EChSttZSil8pQFLm0qImYXOhSqXem2dj,SpATywNh6bZuzm8s1ceuBUnMUAeoAHHw,8,7,0,0,0,0,4,2,13,1.8571428571428572,1,0.0,1,0,0,0,6,0,0,4,2,1,12,1
2055,40478,i0LHbVo0MUWeo1slrPpQRlCoWzknlhLR,A3fsA9Zfv1X2fVEQhTw51lKENdNrEqT3,5,2,1,0,1,0,2,0,6,0.8571428571428571,1,0.0,0,1,0,1,2,0,0,2,0,2,4,1
2056,40483,qbRtu1q5PIx1qmhJ9lRn0S3Y5dNcEYWw,G8EPVSXsOYB5YQWZGiz1aVq5Pgr2GrQu,5,2,1,0,1,0,2,0,6,0.8571428571428571,1,0.0,0,1,0,1,2,0,0,2,0,2,4,1
2057,40486,JyWRLOWjORt63r48lT9LFGZBSOdXCttf,SpATywNh6bZuzm8s1ceuBUnMUAeoAHHw,6,3,2,0,2,0,1,0,8,1.1428571428571428,1,0.0,0,2,0,2,3,0,0,1,0,4,4,1
2058,40507,ZuoiR8ZSgQ4EIp0UPK1kvYAuneCl6lTF,SpATywNh6bZuzm8s1ceuBUnMUAeoAHHw,8,9,6,0,3,0,1,0,19,2.7142857142857144,1,0.0,1,6,0,3,8,0,0,1,0,10,9,1
2059,40512,l01aGQuAgd5VHAVuk21pZMIeJcDQOX6i,RXDvfPUBYFlVdlueBFbLW0mhhAyGEqpt,21,19,10,39,4,0,6,0,78,11.142857142857142,3,0.0,3,10,35,4,16,0,4,6,0,52,26,0
2060,40514,weKRMLBzfxs8ekS11Y9oGFXbhmcomWRF,A3fsA9Zfv1X2fVEQhTw51lKENdNrEqT3,44,30,20,44,12,0,18,0,124,17.714285714285715,3,0.0,2,20,44,12,28,0,0,18,0,78,46,0
2061,40515,zynLWMDwDGZGrMFdec4rl1UB2FSg8e8K,bWdj2GDclj5ofokWjzoa5jAwMkxCykd6,5,2,1,0,1,0,4,0,8,1.1428571428571428,1,0.0,0,1,0,1,2,0,0,4,0,2,6,1
2062,40525,Su94NLhpMEwzyTwfu3GGXYbQEbtpeLin,G8EPVSXsOYB5YQWZGiz1aVq5Pgr2GrQu,16,11,2,28,2,0,2,0,45,6.428571428571429,2,0.0,1,2,24,2,10,0,4,2,0,29,16,1
2063,40531,KUjjznPFpWdBg0GS5p0fa4zyp2j0nULG,SpATywNh6bZuzm8s1ceuBUnMUAeoAHHw,2,0,0,0,0,0,2,0,2,0.2857142857142857,1,0.0,0,0,0,0,0,0,0,2,0,0,2,1
2064,40541,55BMoXCnWKUmNoRDU7bcdmqWNuK9JpZ6,RXDvfPUBYFlVdlueBFbLW0mhhAyGEqpt,5,6,1,0,0,0,3,0,10,1.4285714285714286,1,0.0,2,1,0,0,4,0,0,3,0,3,7,1
2065,40554,vG6SgKMKhZDlcYDUDKC1NlbpiW2uFCxn,A3fsA9Zfv1X2fVEQhTw51lKENdNrEqT3,8,5,0,0,0,4,10,0,19,2.7142857142857144,2,0.0,0,0,0,0,5,4,0,10,0,0,19,1
2066,40565,jPMKgTfqS9zWr9zlMBzf8ARp4D8cnFWF,SpATywNh6bZuzm8s1ceuBUnMUAeoAHHw,7,7,3,0,2,0,2,0,14,2.0,1,0.0,0,3,0,2,7,0,0,2,0,5,9,1
2067,40576,V2LBVc8iZdDnuXsiI9Sw06zIg4OqT9B6,SpATywNh6bZuzm8s1ceuBUnMUAeoAHHw,18,42,18,7,9,7,19,1,103,14.714285714285714,4,0.0,14,18,7,9,28,7,0,19,1,48,55,1
2068,40583,EVKTxmdXvqH9f0V4XuFLHjVRnnUWi9xh,A3fsA9Zfv1X2fVEQhTw51lKENdNrEqT3,26,36,26,2,14,0,16,0,94,13.428571428571429,4,0.0,2,26,2,14,34,0,0,16,0,44,50,1
2069,40591,izEpfh69zQRV21ZbipmxXr7f4EKcykoG,bWdj2GDclj5ofokWjzoa5jAwMkxCykd6,11,10,2,0,2,1,10,1,26,3.7142857142857144,3,0.0,0,2,0,2,10,1,0,10,1,4,22,1
2070,40600,0ipS9A7VTQjzw25R8uCDpA963DAu7orq,SpATywNh6bZuzm8s1ceuBUnMUAeoAHHw,2,0,0,0,0,0,2,0,2,0.2857142857142857,1,0.0,0,0,0,0,0,0,0,2,0,0,2,1
2071,40608,nD2aR2lBTYEZ05tUWGjogkwgt2d7zeNx,A3fsA9Zfv1X2fVEQhTw51lKENdNrEqT3,26,24,1,36,1,0,3,0,65,9.285714285714286,2,0.0,0,1,33,1,24,0,3,3,0,35,30,1
2072,40611,hQ1i3lCFgZxFqzoAUMmIxeDISYlA8zCv,A3fsA9Zfv1X2fVEQhTw51lKENdNrEqT3,11,5,4,0,4,0,6,0,19,2.7142857142857144,1,0.0,0,4,0,4,5,0,0,6,0,8,11,1
2073,40622,FUMcFXXfXADMgcSzTyKSabMQ45EVJp0n,bWdj2GDclj5ofokWjzoa5jAwMkxCykd6,16,22,10,87,4,11,11,1,146,20.857142857142858,3,0.0,8,10,83,4,14,11,4,11,1,105,41,0
2074,40624,Tf1mjUo3ghY0Z5spwun4QIkEOaJmI2Lk,RXDvfPUBYFlVdlueBFbLW0mhhAyGEqpt,7,1,1,0,1,4,10,2,19,2.7142857142857144,1,0.0,0,1,0,1,1,4,0,10,2,2,17,1
2075,40635,BOna3ORacJGhjt4FcGMkKNwkDYsEjcvt,RXDvfPUBYFlVdlueBFbLW0mhhAyGEqpt,22,33,17,0,10,0,9,0,69,9.857142857142858,4,0.0,0,17,0,10,33,0,0,9,0,27,42,1
2076,40638,KLMwnbeiUPyAq67r6m0k1uM0yIHdmaWg,SpATywNh6bZuzm8s1ceuBUnMUAeoAHHw,6,2,0,0,0,0,5,0,7,1.0,1,0.0,0,0,0,0,2,0,0,5,0,0,7,1
2077,40646,uL0Po5J8HnBQPqSUKMNRTAvfe5A6cmqw,bWdj2GDclj5ofokWjzoa5jAwMkxCykd6,5,2,1,0,1,0,2,0,6,0.8571428571428571,1,0.0,0,1,0,1,2,0,0,2,0,2,4,1
2078,40670,AMHmOq5PY3K2Bq5bkWrg2Cz6hshdhVde,SpATywNh6bZuzm8s1ceuBUnMUAeoAHHw,7,5,1,0,1,4,5,0,16,2.2857142857142856,2,0.0,0,1,0,1,5,4,0,5,0,2,14,1
2079,40685,UIuYkrvUrLhMOE6NfUprrMfA4RCzuhOi,SpATywNh6bZuzm8s1ceuBUnMUAeoAHHw,8,3,2,0,2,0,5,1,13,1.8571428571428572,1,0.0,0,2,0,2,3,0,0,5,1,4,9,1
2080,40693,UGYGSfRkJhOkgkdlCI6YSCshpNvwBF31,SpATywNh6bZuzm8s1ceuBUnMUAeoAHHw,11,13,8,3,4,0,3,0,31,4.428571428571429,2,0.0,1,8,3,4,12,0,0,3,0,16,15,1
2081,40694,EY3QtJOWsoMIz6ZJR9ZEsrPPDsaYmN0t,SpATywNh6bZuzm8s1ceuBUnMUAeoAHHw,15,28,0,20,0,19,17,2,86,12.285714285714286,2,0.0,7,0,15,0,21,19,5,17,2,22,64,1
2082,40696,mWUHV4msWZXLdeYpWFdjuucQsrIdSFxH,SpATywNh6bZuzm8s1ceuBUnMUAeoAHHw,1,0,0,0,0,0,1,0,1,0.14285714285714285,1,0.0,0,0,0,0,0,0,0,1,0,0,1,1
2083,40697,B9Ey1tIo6ANxVa0IvzoinvUWj4cenbLl,SpATywNh6bZuzm8s1ceuBUnMUAeoAHHw,11,19,2,11,1,0,1,0,34,4.857142857142857,4,0.0,3,2,9,1,16,0,2,1,0,15,19,1
2084,40717,P11RKOPCDL5miqBQ5O3oznfREAcXF9hp,A3fsA9Zfv1X2fVEQhTw51lKENdNrEqT3,45,38,19,50,16,4,21,2,150,21.428571428571427,2,0.0,1,19,44,16,37,4,6,21,2,80,70,0
2085,40720,n0jV4ldO1halkYjljprJ6GkJFBgQehlW,bWdj2GDclj5ofokWjzoa5jAwMkxCykd6,5,5,0,0,0,0,3,0,8,1.1428571428571428,1,0.0,0,0,0,0,5,0,0,3,0,0,8,1
2086,40731,1UUWIp3PiN0CT0O96IXxrt6TRVFJmFUz,bWdj2GDclj5ofokWjzoa5jAwMkxCykd6,2,0,0,0,0,0,2,0,2,0.2857142857142857,1,0.0,0,0,0,0,0,0,0,2,0,0,2,1
2087,40755,1Pk7jZ6bfmKYXcNnRyEd7kPSZWAEJN0N,SpATywNh6bZuzm8s1ceuBUnMUAeoAHHw,2,0,0,0,0,0,2,0,2,0.2857142857142857,2,0.0,0,0,0,0,0,0,0,2,0,0,2,1
2088,40759,1Pk7jZ6bfmKYXcNnRyEd7kPSZWAEJN0N,bWdj2GDclj5ofokWjzoa5jAwMkxCykd6,10,12,0,2,1,3,13,2,33,4.714285714285714,4,0.0,1,0,2,1,11,3,0,13,2,4,29,1
2089,40760,n0jV4ldO1halkYjljprJ6GkJFBgQehlW,A3fsA9Zfv1X2fVEQhTw51lKENdNrEqT3,8,8,1,0,1,0,3,0,13,1.8571428571428572,2,0.0,0,1,0,1,8,0,0,3,0,2,11,1
2090,40762,FcIMQNoo2B9wNij30W0t3SsuF1pzZCFp,SpATywNh6bZuzm8s1ceuBUnMUAeoAHHw,14,42,0,21,0,19,33,8,123,17.571428571428573,6,0.0,19,0,18,0,23,19,3,33,8,37,86,0
2091,40771,bsalGAvHbAyi2zQkMdMuno7PqVBrE5qV,SpATywNh6bZuzm8s1ceuBUnMUAeoAHHw,11,14,7,2,4,1,1,0,29,4.142857142857143,1,0.0,6,7,2,4,8,1,0,1,0,19,10,1
2092,40784,H2Rgqo3kRDsNdbNVEDl0788s9SSdLM8P,A3fsA9Zfv1X2fVEQhTw51lKENdNrEqT3,10,8,1,0,0,0,4,0,13,1.8571428571428572,1,0.0,0,1,0,0,8,0,0,4,0,1,12,1
2093,40788,TXXodrsD3gpNuvLWnhSXeHO4v2Kp7PZ2,SpATywNh6bZuzm8s1ceuBUnMUAeoAHHw,16,18,8,13,3,0,6,0,48,6.857142857142857,3,0.0,3,8,11,3,15,0,2,6,0,25,23,1
2094,40790,c6KChK06Rh7fb4zwLQYLlfB5pAi9XDtG,A3fsA9Zfv1X2fVEQhTw51lKENdNrEqT3,15,14,2,2,2,0,6,0,26,3.7142857142857144,2,0.0,0,2,2,2,14,0,0,6,0,6,20,1
2095,40818,0wm7bVyJC7jfhIoeylaV85sHOH5JOhtj,RXDvfPUBYFlVdlueBFbLW0mhhAyGEqpt,1,0,0,0,0,0,2,0,2,0.2857142857142857,2,0.0,0,0,0,0,0,0,0,2,0,0,2,1
2096,40830,WVkWa16sSufUj4kk1L49kzGtRQMQkIJr,SpATywNh6bZuzm8s1ceuBUnMUAeoAHHw,12,23,1,17,0,0,3,0,44,6.285714285714286,2,0.0,6,1,14,0,17,0,3,3,0,21,23,1
2097,40833,LRHDYNgQAsG2UssS8TgaqkiYDbFlVrrj,bWdj2GDclj5ofokWjzoa5jAwMkxCykd6,5,2,1,0,1,0,2,0,6,0.8571428571428571,1,0.0,0,1,0,1,2,0,0,2,0,2,4,1
2098,40845,PiMa9t7XXgGIfYACepD9P8yHYFoha6X9,SpATywNh6bZuzm8s1ceuBUnMUAeoAHHw,7,3,2,0,2,0,2,0,9,1.2857142857142858,1,0.0,0,2,0,2,3,0,0,2,0,4,5,1
2099,40851,hkTx4XunczsnVq4H9eVYRZURkkofvB6I,bWdj2GDclj5ofokWjzoa5jAwMkxCykd6,15,19,7,20,3,29,6,0,84,12.0,2,0.0,4,7,16,3,15,29,4,6,0,30,54,1
2100,40858,dJJJLtI6F18pblO9KPkBPg9ZKTgQPaQc,SpATywNh6bZuzm8s1ceuBUnMUAeoAHHw,12,26,1,8,1,3,5,0,44,6.285714285714286,4,0.0,11,1,8,1,15,3,0,5,0,21,23,0
2101,40861,40L77km5z19sJEVeJ6u4qpa9SAG2ZSIF,SpATywNh6bZuzm8s1ceuBUnMUAeoAHHw,13,19,12,15,0,0,8,0,54,7.714285714285714,2,0.0,3,12,14,0,16,0,1,8,0,29,25,0
2102,40862,dNG5hDkS45m4C7FwHXebOEhyKKD4NWCM,SpATywNh6bZuzm8s1ceuBUnMUAeoAHHw,9,4,2,0,2,0,4,1,13,1.8571428571428572,1,0.0,1,2,0,2,3,0,0,4,1,5,8,1
2103,40870,8gfCGxZ6lFjZr89RwPF8oXZs1Qn6Pq6X,bWdj2GDclj5ofokWjzoa5jAwMkxCykd6,3,0,0,0,0,0,7,0,7,1.0,2,0.0,0,0,0,0,0,0,0,7,0,0,7,1
2104,40873,EjYujgGigN4Oo3US4ixRA3bL0nJn2PDZ,SpATywNh6bZuzm8s1ceuBUnMUAeoAHHw,16,16,5,20,3,4,9,0,57,8.142857142857142,3,0.0,2,5,17,3,14,4,3,9,0,27,30,1
2105,40875,2ekh2uQneNAGmhQ3c3UciXnUFmuOUWou,SpATywNh6bZuzm8s1ceuBUnMUAeoAHHw,14,25,10,15,4,2,8,1,65,9.285714285714286,3,0.0,8,10,14,4,17,2,1,8,1,36,29,1
2106,40877,EjYujgGigN4Oo3US4ixRA3bL0nJn2PDZ,G8EPVSXsOYB5YQWZGiz1aVq5Pgr2GrQu,5,6,1,0,1,0,3,0,11,1.5714285714285714,2,0.0,1,1,0,1,5,0,0,3,0,3,8,1
2107,40891,CuHXUjtagLOKelRrRvelBtnV2Gm8l97I,RXDvfPUBYFlVdlueBFbLW0mhhAyGEqpt,5,2,1,0,1,0,4,0,8,1.1428571428571428,1,0.0,0,1,0,1,2,0,0,4,0,2,6,1
2108,40905,aldLXGpzmiip2CUSDhqN8A5UpGMVUHxY,bWdj2GDclj5ofokWjzoa5jAwMkxCykd6,17,41,24,14,14,8,8,0,109,15.571428571428571,4,0.0,7,24,14,14,34,8,0,8,0,59,50,0
2109,40908,OXDIjQPBiuWpB7PdzfniEtiITaq40Kxq,RXDvfPUBYFlVdlueBFbLW0mhhAyGEqpt,2,0,0,0,0,0,2,0,2,0.2857142857142857,1,0.0,0,0,0,0,0,0,0,2,0,0,2,1
2110,40910,M2AmcvqhvMtUlyRV6vMvvoM2IhrMmAwT,A3fsA9Zfv1X2fVEQhTw51lKENdNrEqT3,11,5,3,0,3,1,7,1,20,2.857142857142857,1,0.0,0,3,0,3,5,1,0,7,1,6,14,1
2111,40911,CdB6oTxVZuxQJ7m61lQzyuJSIxL6zQLH,A3fsA9Zfv1X2fVEQhTw51lKENdNrEqT3,16,17,8,0,7,0,4,0,36,5.142857142857143,1,0.0,0,8,0,7,17,0,0,4,0,15,21,1
2112,40918,6tIWZMByN6VbFXOKgaTSsptqRovNe938,bWdj2GDclj5ofokWjzoa5jAwMkxCykd6,1,0,0,0,0,0,1,0,1,0.14285714285714285,1,0.0,0,0,0,0,0,0,0,1,0,0,1,1
2113,40920,6tIWZMByN6VbFXOKgaTSsptqRovNe938,A3fsA9Zfv1X2fVEQhTw51lKENdNrEqT3,8,4,2,0,0,1,7,1,15,2.142857142857143,2,0.0,0,2,0,0,4,1,0,7,1,2,13,1
2114,40928,qoIGs6RP8XMC5yN9VowJtSVp77FsPrRk,A3fsA9Zfv1X2fVEQhTw51lKENdNrEqT3,23,36,24,0,14,0,7,0,81,11.571428571428571,2,0.0,1,24,0,14,35,0,0,7,0,39,42,1
2115,40936,DJeWlgB4cP1RQ3JZLa1wZwd4zgAbYOxv,RXDvfPUBYFlVdlueBFbLW0mhhAyGEqpt,1,0,0,0,0,0,1,0,1,0.14285714285714285,1,0.0,0,0,0,0,0,0,0,1,0,0,1,1
2116,40946,G14xjTwMWbfsqTNiU3Ie1utHyPegqSvR,G8EPVSXsOYB5YQWZGiz1aVq5Pgr2GrQu,4,2,1,0,1,0,2,0,6,0.8571428571428571,2,0.0,0,1,0,1,2,0,0,2,0,2,4,1
2117,40947,G14xjTwMWbfsqTNiU3Ie1utHyPegqSvR,SpATywNh6bZuzm8s1ceuBUnMUAeoAHHw,12,16,1,14,0,0,3,0,34,4.857142857142857,2,0.0,5,1,13,0,11,0,1,3,0,19,15,1
2118,40959,kKw20KeSl1t7Pslb9OutpFfK6qbHmAq8,bWdj2GDclj5ofokWjzoa5jAwMkxCykd6,1,0,0,0,0,0,1,0,1,0.14285714285714285,1,0.0,0,0,0,0,0,0,0,1,0,0,1,1
2119,40965,dSPH9g8Ag2uZLcQxLXukxNXBLRvLY5xp,A3fsA9Zfv1X2fVEQhTw51lKENdNrEqT3,10,8,0,0,1,0,1,0,10,1.4285714285714286,2,0.0,0,0,0,1,8,0,0,1,0,1,9,1
2120,40994,WmqMKoevd5yMpzwxk3BDNFkg4y1FZjx5,G8EPVSXsOYB5YQWZGiz1aVq5Pgr2GrQu,24,28,4,18,6,2,9,1,68,9.714285714285714,7,0.0,0,4,15,6,28,2,3,9,1,25,43,1
2121,40998,syzcMhy375dEj89fdUtXti8MXg1a8bSN,7GRhBDsirIGkRZBtSMEzNTyDr2JQm4xx,10,20,11,0,5,1,15,0,52,7.428571428571429,1,0.0,2,11,0,5,18,1,0,15,0,18,34,1
2122,41023,8Ht2Zmfn81Gwb093X2QMQmBGW6qi8rRd,7GRhBDsirIGkRZBtSMEzNTyDr2JQm4xx,26,28,12,53,12,0,4,0,109,15.571428571428571,2,0.0,13,12,45,12,15,0,8,4,0,82,27,1
2123,41082,DVIil2NM7ZWOtqe6rhlMzwEUAb2wuaeh,7GRhBDsirIGkRZBtSMEzNTyDr2JQm4xx,31,82,25,32,16,15,7,0,177,25.285714285714285,3,0.0,49,25,32,16,33,15,0,7,0,122,55,0
2124,41300,qJQBhMSxZNb9FZGkj9PyIWzMqhMNvrJp,7GRhBDsirIGkRZBtSMEzNTyDr2JQm4xx,3,0,0,0,0,0,2,1,3,0.42857142857142855,1,0.0,0,0,0,0,0,0,0,2,1,0,3,0
2125,41514,TDsFMiW3NmfZzVauB4oMkOZiSJ5XLe6I,7GRhBDsirIGkRZBtSMEzNTyDr2JQm4xx,9,10,0,0,0,1,7,1,19,2.7142857142857144,1,0.0,0,0,0,0,10,1,0,7,1,0,19,1
2126,41582,CfUHqy5TfjBtRxjNztsGxyFua9jISd0Q,7GRhBDsirIGkRZBtSMEzNTyDr2JQm4xx,35,49,21,44,16,1,8,0,139,19.857142857142858,3,0.0,25,21,38,16,24,1,6,8,0,100,39,1
2127,41618,ZqebYSMW1RUIRSXJmMzKs77Liu7pj2zF,7GRhBDsirIGkRZBtSMEzNTyDr2JQm4xx,1,0,0,0,0,0,2,0,2,0.2857142857142857,1,0.0,0,0,0,0,0,0,0,2,0,0,2,1
2128,41762,FJJqBn1iTJmAbav7Ov5Y4ycyF65fvY1E,7GRhBDsirIGkRZBtSMEzNTyDr2JQm4xx,1,0,0,0,0,0,1,0,1,0.14285714285714285,1,0.0,0,0,0,0,0,0,0,1,0,0,1,0
2129,41807,txRaMeFRdTsCsziGBMMxzL5gSPIB7mbk,7GRhBDsirIGkRZBtSMEzNTyDr2JQm4xx,11,7,4,4,2,7,7,1,32,4.571428571428571,1,0.0,1,4,3,2,6,7,1,7,1,10,22,1
2130,43665,NrHk4qmJXuD0TsjkQSnghKpk9ZjGAOyU,7GRhBDsirIGkRZBtSMEzNTyDr2JQm4xx,5,2,1,0,1,0,2,0,6,0.8571428571428571,1,0.0,0,1,0,1,2,0,0,2,0,2,4,1
2131,43993,p0RuxkRTmLRS6ii3YN8z6W4Bqa7AYRuD,fbPkOYLVPtPgIt0MxizjfFJov3JbHyAi,7,3,2,0,2,1,4,0,12,1.7142857142857142,1,0.0,0,2,0,2,3,1,0,4,0,4,8,1
2132,43994,hWE8YlXrkle820sTOY1UXpm2QbX0rLTx,fbPkOYLVPtPgIt0MxizjfFJov3JbHyAi,21,23,13,1,12,12,8,1,70,10.0,1,0.0,6,13,1,12,17,12,0,8,1,32,38,1
2133,43995,diyFwrzJDqdxnswzs6l8ZdAq590WR6Is,fbPkOYLVPtPgIt0MxizjfFJov3JbHyAi,5,4,0,0,0,1,14,3,22,3.142857142857143,1,0.0,0,0,0,0,4,1,0,14,3,0,22,1
2134,43996,aNKQixLt1xurBtrkCE5j4vCWMytj94zC,fbPkOYLVPtPgIt0MxizjfFJov3JbHyAi,7,14,6,0,3,7,11,0,41,5.857142857142857,3,0.0,0,6,0,3,14,7,0,11,0,9,32,1
2135,43997,mtCGwN4OvCoCnbzMbutLT6Nf2wxkcaDu,fbPkOYLVPtPgIt0MxizjfFJov3JbHyAi,3,1,0,0,0,0,2,0,3,0.42857142857142855,1,0.0,0,0,0,0,1,0,0,2,0,0,3,1
2136,43999,sCVKWDTf6SABzbHNn99T0WibbkC7xg03,fbPkOYLVPtPgIt0MxizjfFJov3JbHyAi,1,0,0,0,0,0,1,0,1,0.14285714285714285,1,0.0,0,0,0,0,0,0,0,1,0,0,1,1
2137,44000,7iDvRXsYqjRdgImengAvKZVd91CAi3lD,fbPkOYLVPtPgIt0MxizjfFJov3JbHyAi,10,13,8,0,4,4,6,2,37,5.285714285714286,2,0.0,2,8,0,4,11,4,0,6,2,14,23,1
2138,44001,mJn5S64R5TbyphUPASOXDVT6KwPqgFqV,fbPkOYLVPtPgIt0MxizjfFJov3JbHyAi,26,25,14,13,11,22,10,1,96,13.714285714285714,2,0.0,8,14,12,11,17,22,1,10,1,45,51,1
2139,44002,u11lG1A4K1gIhpOqkswgAj4EhDI0xOZ0,fbPkOYLVPtPgIt0MxizjfFJov3JbHyAi,7,3,2,0,2,0,6,0,13,1.8571428571428572,1,0.0,0,2,0,2,3,0,0,6,0,4,9,1
2140,44003,DDTIWqk6JJRrEvr9d9O7DmY1OYVdzDEA,fbPkOYLVPtPgIt0MxizjfFJov3JbHyAi,10,7,4,0,3,2,8,1,25,3.5714285714285716,1,0.0,1,4,0,3,6,2,0,8,1,8,17,1
2141,44004,d8EMxzMifzqQKHyC0riOTQo2zuIYKTb1,fbPkOYLVPtPgIt0MxizjfFJov3JbHyAi,11,9,6,0,4,5,7,0,31,4.428571428571429,1,0.0,0,6,0,4,9,5,0,7,0,10,21,1
2142,44005,J8NkUmSvsrLHkKNXPhFg7o0pG3K7Aywh,fbPkOYLVPtPgIt0MxizjfFJov3JbHyAi,20,21,11,18,7,51,5,0,113,16.142857142857142,2,0.0,5,11,16,7,16,51,2,5,0,39,74,0
2143,44006,hjUSUM6roI2mLGkMAqBjE0uxFRBSMYHJ,fbPkOYLVPtPgIt0MxizjfFJov3JbHyAi,6,3,2,0,2,4,3,0,14,2.0,1,0.0,0,2,0,2,3,4,0,3,0,4,10,1
2144,44011,DBl87nF6WTgoCD6kgTHVE2oB45pDEn6y,fbPkOYLVPtPgIt0MxizjfFJov3JbHyAi,7,7,5,0,3,0,2,0,17,2.4285714285714284,2,0.0,0,5,0,3,7,0,0,2,0,8,9,1
2145,44013,p2au3FOExtiqsg1tYoyGj3KNDXCc91mB,fbPkOYLVPtPgIt0MxizjfFJov3JbHyAi,10,6,4,0,3,1,7,1,22,3.142857142857143,1,0.0,0,4,0,3,6,1,0,7,1,7,15,1
2146,44014,x7XiHrvKEMpxKuTFiRO880d5p07e6S97,fbPkOYLVPtPgIt0MxizjfFJov3JbHyAi,8,2,2,0,2,1,3,1,11,1.5714285714285714,1,0.0,0,2,0,2,2,1,0,3,1,4,7,1
2147,44016,FssYjkUANdoULgFGTzw1AQpi3Hr9RmSx,fbPkOYLVPtPgIt0MxizjfFJov3JbHyAi,7,4,2,0,2,2,4,0,14,2.0,1,0.0,0,2,0,2,4,2,0,4,0,4,10,1
2148,44018,qKfZusm0R8jxltESvgi15dswdw73Gjlp,fbPkOYLVPtPgIt0MxizjfFJov3JbHyAi,8,8,3,0,3,0,2,0,16,2.2857142857142856,1,0.0,0,3,0,3,8,0,0,2,0,6,10,1
2149,44020,Z2WYkCILkqUB8wo1t1Cu8aCpPedEwo19,fbPkOYLVPtPgIt0MxizjfFJov3JbHyAi,5,3,1,0,1,0,1,0,6,0.8571428571428571,1,0.0,0,1,0,1,3,0,0,1,0,2,4,1
2150,44022,PDXGFyBPYCflMZuvp1Ir4M4S3e0nyboZ,fbPkOYLVPtPgIt0MxizjfFJov3JbHyAi,25,45,22,13,11,18,11,0,120,17.142857142857142,5,0.0,10,22,10,11,35,18,3,11,0,53,67,1
2151,44023,YB6Mdw3HVis2k9yXIV8Bn5gVXQ6GVqTU,fbPkOYLVPtPgIt0MxizjfFJov3JbHyAi,5,5,0,0,0,4,4,0,13,1.8571428571428572,2,0.0,0,0,0,0,5,4,0,4,0,0,13,1
2152,44025,26PDrRJYSMH6uI6XnAwbn1s6xjvZitk1,fbPkOYLVPtPgIt0MxizjfFJov3JbHyAi,5,2,1,0,1,0,3,0,7,1.0,1,0.0,0,1,0,1,2,0,0,3,0,2,5,1
2153,44026,A1Bqk2hgKzNE6O0Jd3HBtI2AJixgnU9D,fbPkOYLVPtPgIt0MxizjfFJov3JbHyAi,8,3,2,0,2,2,5,0,14,2.0,1,0.0,0,2,0,2,3,2,0,5,0,4,10,1
2154,44029,cDtNKVgke675efaANxs81gywhUCG6Xvn,fbPkOYLVPtPgIt0MxizjfFJov3JbHyAi,2,0,0,0,0,0,2,0,2,0.2857142857142857,1,0.0,0,0,0,0,0,0,0,2,0,0,2,1
2155,44030,AqCPWoJ3Xqrj0YuS9VE2yr3qK1da6ZEL,fbPkOYLVPtPgIt0MxizjfFJov3JbHyAi,6,2,1,0,1,8,4,0,16,2.2857142857142856,2,0.0,0,1,0,1,2,8,0,4,0,2,14,1
2156,44031,wg3Aluyuv2BxZCQwpp08tOXwIGHtBXla,fbPkOYLVPtPgIt0MxizjfFJov3JbHyAi,9,4,2,0,3,0,12,1,22,3.142857142857143,2,0.0,2,2,0,3,2,0,0,12,1,7,15,1
2157,44033,jCGl2la0U6McatWubPbo3ygrfz4SQroM,fbPkOYLVPtPgIt0MxizjfFJov3JbHyAi,2,0,0,0,0,0,2,0,2,0.2857142857142857,1,0.0,0,0,0,0,0,0,0,2,0,0,2,1
2158,44035,AOTrlTWQ3Oa2ClznlEkXg5ypb6eqlCbx,fbPkOYLVPtPgIt0MxizjfFJov3JbHyAi,8,5,3,0,2,1,6,1,18,2.5714285714285716,1,0.0,0,3,0,2,5,1,0,6,1,5,13,1
2159,44037,R2NtjVNHKdme1jYGEGYDv7qM6g83uuPF,fbPkOYLVPtPgIt0MxizjfFJov3JbHyAi,10,9,6,0,3,1,6,0,25,3.5714285714285716,1,0.0,0,6,0,3,9,1,0,6,0,9,16,1
2160,44038,3JmWuBfNEBLNWjaLSdiSh8Z86NQq0lk7,fbPkOYLVPtPgIt0MxizjfFJov3JbHyAi,15,23,1,5,1,9,7,1,47,6.714285714285714,1,0.0,3,1,4,1,20,9,1,7,1,9,38,1
2161,44039,4yBRvdZ1Q3XWGsAQkRh6UnzQ7WibjAOe,fbPkOYLVPtPgIt0MxizjfFJov3JbHyAi,7,8,6,0,4,0,7,0,25,3.5714285714285716,1,0.0,0,6,0,4,8,0,0,7,0,10,15,1
2162,44042,4QPOXaQgHIrhjYrZ52sVeohXb5o3Oznm,fbPkOYLVPtPgIt0MxizjfFJov3JbHyAi,2,0,0,0,0,0,2,0,2,0.2857142857142857,1,0.0,0,0,0,0,0,0,0,2,0,0,2,1
2163,44043,s8VWFWImIYSA2JA5l16L3WRLI25ddNXq,fbPkOYLVPtPgIt0MxizjfFJov3JbHyAi,11,21,5,1,8,7,10,0,52,7.428571428571429,2,0.0,13,5,1,8,8,7,0,10,0,27,25,1
2164,44045,HfDg6ZshQIIsqHP26E57zcevXCtObxuT,fbPkOYLVPtPgIt0MxizjfFJov3JbHyAi,1,0,0,0,0,0,2,0,2,0.2857142857142857,1,0.0,0,0,0,0,0,0,0,2,0,0,2,1
2165,44047,SJEqwoHZ7xXB9jGS9EmfQals4M4vlWb2,fbPkOYLVPtPgIt0MxizjfFJov3JbHyAi,5,3,1,0,1,0,5,0,10,1.4285714285714286,1,0.0,0,1,0,1,3,0,0,5,0,2,8,1
2166,44048,YmdgsFslyipuqAvTNMUf5cKIo7lT9UI2,fbPkOYLVPtPgIt0MxizjfFJov3JbHyAi,9,12,4,0,2,0,3,0,21,3.0,1,0.0,2,4,0,2,10,0,0,3,0,8,13,1
2167,44050,VeCExJm9PxMsppGBNIELDYWjqzgCI8lp,fbPkOYLVPtPgIt0MxizjfFJov3JbHyAi,6,3,2,0,2,0,1,0,8,1.1428571428571428,1,0.0,0,2,0,2,3,0,0,1,0,4,4,1
2168,44051,AmoWrYr0vE5hXRkVUs4W3twtpkRI6UWn,fbPkOYLVPtPgIt0MxizjfFJov3JbHyAi,10,16,7,0,5,14,8,1,51,7.285714285714286,2,0.0,4,7,0,5,12,14,0,8,1,16,35,1
2169,44053,eoxsaFPg8O2Z1ERwXNqkhtxGChEAvpFr,fbPkOYLVPtPgIt0MxizjfFJov3JbHyAi,6,8,2,2,2,0,1,0,15,2.142857142857143,1,0.0,5,2,2,2,3,0,0,1,0,11,4,1
2170,44055,aosFpeLMqBiLLcyUKYcbUuWGCjQbFGiD,fbPkOYLVPtPgIt0MxizjfFJov3JbHyAi,11,5,4,0,4,1,3,0,17,2.4285714285714284,1,0.0,0,4,0,4,5,1,0,3,0,8,9,1
2171,44056,pdAqVvKgeCIaihAcxhTXOYjPQxxjaa8K,fbPkOYLVPtPgIt0MxizjfFJov3JbHyAi,5,3,2,0,0,0,2,0,7,1.0,1,0.0,0,2,0,0,3,0,0,2,0,2,5,1
2172,44059,VCAUk6CdtYtSQUkeIHqrUkYmOmbAoytN,fbPkOYLVPtPgIt0MxizjfFJov3JbHyAi,8,9,6,0,3,9,7,0,34,4.857142857142857,2,0.0,0,6,0,3,9,9,0,7,0,9,25,1
2173,44061,YnLmtd3JRb0zimQpfWrFNcrwemvknDW5,fbPkOYLVPtPgIt0MxizjfFJov3JbHyAi,2,0,0,0,0,0,4,0,4,0.5714285714285714,1,0.0,0,0,0,0,0,0,0,4,0,0,4,1
2174,44064,sclpC2Q9gGuchXaYOn9jBhR0HTWTR3aT,fbPkOYLVPtPgIt0MxizjfFJov3JbHyAi,2,0,0,0,0,0,2,0,2,0.2857142857142857,1,0.0,0,0,0,0,0,0,0,2,0,0,2,1
2175,44065,MdDhGnwj5ASXKbZjKBE4rTINrZJxZKmf,fbPkOYLVPtPgIt0MxizjfFJov3JbHyAi,5,3,1,0,1,0,1,0,6,0.8571428571428571,1,0.0,0,1,0,1,3,0,0,1,0,2,4,1
2176,44066,YRnTGuoAQA7UM3uV59YNXUYN4n1CR9jv,fbPkOYLVPtPgIt0MxizjfFJov3JbHyAi,5,2,1,0,1,2,3,0,9,1.2857142857142858,1,0.0,0,1,0,1,2,2,0,3,0,2,7,1
2177,44067,j8RhTJjYDyhhJwKuX9dEaH9i8I1ldsXI,fbPkOYLVPtPgIt0MxizjfFJov3JbHyAi,6,1,1,0,1,0,5,0,8,1.1428571428571428,1,0.0,0,1,0,1,1,0,0,5,0,2,6,1
2178,44068,L5YuT98afVAOrSauv1O87vabcuU5P3FK,fbPkOYLVPtPgIt0MxizjfFJov3JbHyAi,9,6,4,0,4,15,4,0,33,4.714285714285714,2,0.0,1,4,0,4,5,15,0,4,0,9,24,1
2179,44073,IvyZt31HCtjMQMuaWC4jdk1sB0Xv7ntN,fbPkOYLVPtPgIt0MxizjfFJov3JbHyAi,2,0,0,0,0,0,2,0,2,0.2857142857142857,1,0.0,0,0,0,0,0,0,0,2,0,0,2,1
2180,44074,2ZTBzb1Y4dwuOwNiUUSWB6SyHlRXxNso,fbPkOYLVPtPgIt0MxizjfFJov3JbHyAi,7,8,6,0,5,3,2,0,24,3.4285714285714284,2,0.0,0,6,0,5,8,3,0,2,0,11,13,1
2181,44075,igbWLwpgdT3vH8N8WUDj5bw0PNuf5yJu,fbPkOYLVPtPgIt0MxizjfFJov3JbHyAi,5,0,0,0,0,1,10,1,12,1.7142857142857142,1,0.0,0,0,0,0,0,1,0,10,1,0,12,1
2182,44077,O8WpIn8YZlC9fwaPz6HgwkG3VYK9Pnk2,fbPkOYLVPtPgIt0MxizjfFJov3JbHyAi,17,12,8,3,9,0,4,0,36,5.142857142857143,1,0.0,2,8,3,9,10,0,0,4,0,22,14,1
2183,44078,QR9tTgqPj604qYCY9eaTIBAzrFpNWrLy,fbPkOYLVPtPgIt0MxizjfFJov3JbHyAi,11,22,7,8,11,0,7,0,55,7.857142857142857,1,0.0,10,7,6,11,12,0,2,7,0,34,21,1
2184,44080,bheLkhWEWGgBqIkahX9VmPOuI7dx9l0C,fbPkOYLVPtPgIt0MxizjfFJov3JbHyAi,8,3,2,0,2,0,4,0,11,1.5714285714285714,1,0.0,0,2,0,2,3,0,0,4,0,4,7,1
2185,44082,YzWgrkJXzobheYWSTdIFQuZL9QRQEEwo,fbPkOYLVPtPgIt0MxizjfFJov3JbHyAi,14,16,8,0,7,7,16,2,56,8.0,3,0.0,0,8,0,7,16,7,0,16,2,15,41,1
2186,44085,k3g7vGyejcBHPAYTerpXAPXP3aDlXECc,fbPkOYLVPtPgIt0MxizjfFJov3JbHyAi,12,13,5,4,5,0,4,0,31,4.428571428571429,2,0.0,3,5,3,5,10,0,1,4,0,16,15,1
2187,44086,RdUl2sUA9mfz6RQdwlY0IjEO1TB3V6He,fbPkOYLVPtPgIt0MxizjfFJov3JbHyAi,5,3,1,0,1,6,5,0,16,2.2857142857142856,1,0.0,0,1,0,1,3,6,0,5,0,2,14,1
2188,44087,lFoBW5pwyNxgkXXOh07oCGiEJfc9EI9m,fbPkOYLVPtPgIt0MxizjfFJov3JbHyAi,12,4,4,0,4,0,14,0,26,3.7142857142857144,1,0.0,0,4,0,4,4,0,0,14,0,8,18,1
2189,44088,lROQAiXdM7cGoWUW60LyDcyoBjMP9r3o,fbPkOYLVPtPgIt0MxizjfFJov3JbHyAi,3,2,0,0,0,0,1,0,3,0.42857142857142855,1,0.0,0,0,0,0,2,0,0,1,0,0,3,1
2190,44089,No6TsyszmhFBqFzsKXtnzkYT0Jt4BFGw,fbPkOYLVPtPgIt0MxizjfFJov3JbHyAi,14,23,12,11,8,13,9,2,78,11.142857142857142,2,0.0,5,12,7,8,18,13,4,9,2,32,46,0
2191,44090,8nAPL0mPQAW1c0oKz3Cmzoe0fblYTaaz,fbPkOYLVPtPgIt0MxizjfFJov3JbHyAi,8,6,4,0,3,0,4,0,17,2.4285714285714284,2,0.0,0,4,0,3,6,0,0,4,0,7,10,1
2192,44091,UzZPsoX0fPCsbykjSOoJQOmAIToD9VOQ,fbPkOYLVPtPgIt0MxizjfFJov3JbHyAi,4,2,1,0,1,0,1,0,5,0.7142857142857143,1,0.0,0,1,0,1,2,0,0,1,0,2,3,1
2193,44092,sLiNYOqDfBlMo7O3bGWUzk1xVOtexeDN,fbPkOYLVPtPgIt0MxizjfFJov3JbHyAi,6,3,2,0,2,0,1,0,8,1.1428571428571428,1,0.0,0,2,0,2,3,0,0,1,0,4,4,1
2194,44094,Y5EybULOrY5dAmMMQWE7bK5wg4bsR2Lr,fbPkOYLVPtPgIt0MxizjfFJov3JbHyAi,19,23,13,2,7,0,6,0,51,7.285714285714286,2,0.0,2,13,2,7,21,0,0,6,0,24,27,1
2195,44096,MvkVXPKImqjQobZ7zCJXq4GfQ4IthLq9,fbPkOYLVPtPgIt0MxizjfFJov3JbHyAi,7,2,1,0,1,0,6,1,11,1.5714285714285714,1,0.0,0,1,0,1,2,0,0,6,1,2,9,1
2196,44098,XMrYl2ASKmtprKkSXb8ccJGHLdsrFHJk,fbPkOYLVPtPgIt0MxizjfFJov3JbHyAi,5,0,0,0,0,4,10,1,15,2.142857142857143,1,0.0,0,0,0,0,0,4,0,10,1,0,15,1
2197,44099,ZD3ToNRRIcmCEA8K3LVmNsFQ0Leu0MkF,fbPkOYLVPtPgIt0MxizjfFJov3JbHyAi,7,3,2,0,2,0,4,0,11,1.5714285714285714,1,0.0,0,2,0,2,3,0,0,4,0,4,7,1
2198,44100,ANJ7A7TrnpRJsv1mG7Zq08b8gsBzPJqI,fbPkOYLVPtPgIt0MxizjfFJov3JbHyAi,9,14,9,2,6,22,8,0,61,8.714285714285714,1,0.0,2,9,2,6,12,22,0,8,0,19,42,1
2199,44101,VwVgSiouEmdKXwssd2MCisWFwFtWB9Im,fbPkOYLVPtPgIt0MxizjfFJov3JbHyAi,1,0,0,0,0,0,1,0,1,0.14285714285714285,1,0.0,0,0,0,0,0,0,0,1,0,0,1,1
2200,44103,A7lXg14ZXc0SEgbl8pEzN5LJNLnibxLn,fbPkOYLVPtPgIt0MxizjfFJov3JbHyAi,4,0,0,0,0,1,9,0,10,1.4285714285714286,1,0.0,0,0,0,0,0,1,0,9,0,0,10,1
2201,44104,v6ULfJ1wWpantgoVZXel0J0DDCWEkouX,fbPkOYLVPtPgIt0MxizjfFJov3JbHyAi,7,2,1,0,1,0,5,0,9,1.2857142857142858,1,0.0,0,1,0,1,2,0,0,5,0,2,7,1
2202,44105,LmCwIRpUqSmmlWIBPK14fUA8Auzaletz,fbPkOYLVPtPgIt0MxizjfFJov3JbHyAi,8,10,5,0,4,5,7,0,31,4.428571428571429,2,0.0,2,5,0,4,8,5,0,7,0,11,20,1
2203,44106,futHw5ylJYoore6oNuefdx05Xc1Es6E8,fbPkOYLVPtPgIt0MxizjfFJov3JbHyAi,7,15,6,0,4,1,5,0,31,4.428571428571429,3,0.0,0,6,0,4,15,1,0,5,0,10,21,1
2204,44107,671RbTfA5jsL1XLdOXGDRlUV35MrYEo2,fbPkOYLVPtPgIt0MxizjfFJov3JbHyAi,2,0,0,0,0,0,5,0,5,0.7142857142857143,1,0.0,0,0,0,0,0,0,0,5,0,0,5,1
2205,44108,05K9eYg3CyRfEGjA2jN84Kisnns0xWMm,fbPkOYLVPtPgIt0MxizjfFJov3JbHyAi,9,6,3,0,4,0,4,0,17,2.4285714285714284,1,0.0,2,3,0,4,4,0,0,4,0,9,8,1
2206,44109,2yhMB5G7BP9mjaTBhgm2Ob8NSOmIWTch,fbPkOYLVPtPgIt0MxizjfFJov3JbHyAi,5,2,1,0,1,6,4,0,14,2.0,1,0.0,0,1,0,1,2,6,0,4,0,2,12,1
2207,44110,e4cZqrYucFu6WeO5quZuqBqXvsVJ1X82,fbPkOYLVPtPgIt0MxizjfFJov3JbHyAi,4,2,1,0,1,2,1,0,7,1.0,1,0.0,0,1,0,1,2,2,0,1,0,2,5,1
2208,44113,2X7VWDc6h4sEfr5aWwtNfHXgmbohmuZY,fbPkOYLVPtPgIt0MxizjfFJov3JbHyAi,8,3,2,0,2,0,5,0,12,1.7142857142857142,1,0.0,0,2,0,2,3,0,0,5,0,4,8,1
2209,44114,Hnsg2RdEy94EzQKO2WfhQn1bhDkIZpuP,fbPkOYLVPtPgIt0MxizjfFJov3JbHyAi,15,58,31,0,10,26,19,3,147,21.0,6,0.0,7,31,0,10,51,26,0,19,3,48,99,1
2210,44116,6A60zadtj8FKi84VaMeYcSvKWRtVJvs6,fbPkOYLVPtPgIt0MxizjfFJov3JbHyAi,6,9,0,0,0,12,6,0,27,3.857142857142857,1,0.0,2,0,0,0,7,12,0,6,0,2,25,1
2211,44117,0MmMvk8S1ad0tMPIPxO3E9ZWoQTH5ohX,fbPkOYLVPtPgIt0MxizjfFJov3JbHyAi,7,5,2,0,2,0,7,0,16,2.2857142857142856,1,0.0,2,2,0,2,3,0,0,7,0,6,10,1
2212,44120,FTBGY79AZl1FhUSv46TguNvaQwPqRnW0,fbPkOYLVPtPgIt0MxizjfFJov3JbHyAi,6,8,4,0,1,7,3,0,23,3.2857142857142856,2,0.0,0,4,0,1,8,7,0,3,0,5,18,1
2213,44121,6adUsSvPO0BlKLyJ63pGCXpdZbbHOrC1,fbPkOYLVPtPgIt0MxizjfFJov3JbHyAi,7,3,2,0,2,0,3,0,10,1.4285714285714286,1,0.0,0,2,0,2,3,0,0,3,0,4,6,1
2214,44124,YDpcKYv6zEDbgKCrCZaLRWDXdGnmbBrJ,fbPkOYLVPtPgIt0MxizjfFJov3JbHyAi,7,3,2,0,2,1,2,0,10,1.4285714285714286,1,0.0,0,2,0,2,3,1,0,2,0,4,6,1
2215,44125,S0Ddt9YO0WoRWUIwBGA5TdHpdcYScp4i,fbPkOYLVPtPgIt0MxizjfFJov3JbHyAi,2,0,0,0,0,0,4,0,4,0.5714285714285714,1,0.0,0,0,0,0,0,0,0,4,0,0,4,1
2216,44126,tp8q2FaFgEZoEyMd2w4a4ElJA60aVpjU,fbPkOYLVPtPgIt0MxizjfFJov3JbHyAi,8,4,2,0,2,1,5,0,14,2.0,1,0.0,1,2,0,2,3,1,0,5,0,5,9,1
2217,44127,uE45A9X1ub2amdi5pgtNBuPUXW1OngP4,fbPkOYLVPtPgIt0MxizjfFJov3JbHyAi,8,7,4,0,2,25,8,1,47,6.714285714285714,3,0.0,0,4,0,2,7,25,0,8,1,6,41,1
2218,44128,V1LvU1c7E3PIUZFRN6WpF3BM13fnjgNE,fbPkOYLVPtPgIt0MxizjfFJov3JbHyAi,1,0,0,0,0,0,1,0,1,0.14285714285714285,1,0.0,0,0,0,0,0,0,0,1,0,0,1,1
2219,44129,p1XbGfxeaI6DleJXE743W1CITQmkaVh6,fbPkOYLVPtPgIt0MxizjfFJov3JbHyAi,20,29,15,0,11,41,8,1,105,15.0,2,0.0,6,15,0,11,23,41,0,8,1,32,73,1
2220,44130,aldLXGpzmiip2CUSDhqN8A5UpGMVUHxY,fbPkOYLVPtPgIt0MxizjfFJov3JbHyAi,7,6,3,0,2,0,2,0,13,1.8571428571428572,2,0.0,1,3,0,2,5,0,0,2,0,6,7,1
2221,44132,zFnB514y0Q6xzKQdlkyv2Oz7aEiEsfcU,fbPkOYLVPtPgIt0MxizjfFJov3JbHyAi,11,3,3,0,3,0,10,1,20,2.857142857142857,1,0.0,0,3,0,3,3,0,0,10,1,6,14,1
2222,44136,BF0qnZaKn6rKWwFuVZZ6evM5Lwl2Cgas,fbPkOYLVPtPgIt0MxizjfFJov3JbHyAi,9,5,3,0,3,31,8,1,51,7.285714285714286,1,0.0,1,3,0,3,4,31,0,8,1,7,44,1
2223,44137,2UpfysYIIWrRQes9MePdZN0xiR2zRHJz,fbPkOYLVPtPgIt0MxizjfFJov3JbHyAi,8,6,3,0,2,0,2,0,13,1.8571428571428572,1,0.0,0,3,0,2,6,0,0,2,0,5,8,1
2224,44138,3xpaESbMVIacFbBBinGWFh7uTUaRebCC,fbPkOYLVPtPgIt0MxizjfFJov3JbHyAi,5,2,1,0,1,0,2,0,6,0.8571428571428571,1,0.0,0,1,0,1,2,0,0,2,0,2,4,1
2225,44140,MmriHcroMe075aYWrI4hc7SygXVasdbB,fbPkOYLVPtPgIt0MxizjfFJov3JbHyAi,7,7,5,0,4,2,2,0,20,2.857142857142857,1,0.0,0,5,0,4,7,2,0,2,0,9,11,1
2226,44142,VT4lg4rYLuaybdJw72lJCTs81gBgRRBg,fbPkOYLVPtPgIt0MxizjfFJov3JbHyAi,23,92,46,19,29,45,28,3,262,37.42857142857143,5,0.0,28,46,15,29,64,45,4,28,3,118,144,1
2227,44143,J9FSUo4laXGBW66T35Zr5CFe56ZdTJTQ,fbPkOYLVPtPgIt0MxizjfFJov3JbHyAi,9,6,3,0,4,3,4,0,20,2.857142857142857,1,0.0,2,3,0,4,4,3,0,4,0,9,11,1
2228,44145,niLMw8MCObO7SSR2V1jNg9WQt5oSjDFJ,fbPkOYLVPtPgIt0MxizjfFJov3JbHyAi,6,7,3,0,2,2,2,0,16,2.2857142857142856,1,0.0,2,3,0,2,5,2,0,2,0,7,9,1
2229,44146,NiOuJ51IxTtojHMts8OdX2AfCH09G7vK,fbPkOYLVPtPgIt0MxizjfFJov3JbHyAi,8,5,2,0,2,11,5,1,26,3.7142857142857144,1,0.0,0,2,0,2,5,11,0,5,1,4,22,1
2230,44147,zeUi2UnQZPPF6bRQXw2s8LZ41ZOdqRAa,fbPkOYLVPtPgIt0MxizjfFJov3JbHyAi,5,2,1,0,1,5,4,0,13,1.8571428571428572,1,0.0,0,1,0,1,2,5,0,4,0,2,11,1
2231,44149,W7N7he2GGE1A2J3fJvsUdwOZI9P4besV,fbPkOYLVPtPgIt0MxizjfFJov3JbHyAi,9,22,6,0,3,0,4,0,35,5.0,1,0.0,6,6,0,3,16,0,0,4,0,15,20,1
2232,44150,1OCnfEluJ5C06UYF5oIawyvraf5cATWk,fbPkOYLVPtPgIt0MxizjfFJov3JbHyAi,12,9,3,4,5,0,3,0,24,3.4285714285714284,1,0.0,4,3,3,5,5,0,1,3,0,15,9,1
2233,44153,mZ7ilucqUFwey1NwU92PRXQQ0HeHtWmh,fbPkOYLVPtPgIt0MxizjfFJov3JbHyAi,7,4,3,0,3,0,3,0,13,1.8571428571428572,1,0.0,0,3,0,3,4,0,0,3,0,6,7,1
2234,44154,wJViEDKJG9cycqokQxxOomq0g3hb2X0n,fbPkOYLVPtPgIt0MxizjfFJov3JbHyAi,1,0,0,0,0,0,1,0,1,0.14285714285714285,1,0.0,0,0,0,0,0,0,0,1,0,0,1,1
2235,44156,2fI4wWrvurl3ODzFoF1kViu5y8Lc1NgZ,fbPkOYLVPtPgIt0MxizjfFJov3JbHyAi,5,3,1,0,1,10,2,0,17,2.4285714285714284,1,0.0,0,1,0,1,3,10,0,2,0,2,15,1
2236,44157,ScslB7DNmqv4WEnDOYxGnluFKACqdrbs,fbPkOYLVPtPgIt0MxizjfFJov3JbHyAi,13,18,7,1,8,0,9,2,45,6.428571428571429,2,0.0,7,7,1,8,11,0,0,9,2,23,22,1
2237,44158,KBAguIZfF7JFxQgNwhhTOV2JtOxu7CHH,fbPkOYLVPtPgIt0MxizjfFJov3JbHyAi,5,4,1,0,1,0,1,0,7,1.0,1,0.0,1,1,0,1,3,0,0,1,0,3,4,1
2238,44160,gHeXtpmuyccgWbGT5QiAuKlFydUbHDzc,fbPkOYLVPtPgIt0MxizjfFJov3JbHyAi,5,4,2,0,1,0,2,0,9,1.2857142857142858,2,0.0,0,2,0,1,4,0,0,2,0,3,6,1
2239,44162,Lyagkt8Tl6Y9546SuIOdZylzB0VpBr47,fbPkOYLVPtPgIt0MxizjfFJov3JbHyAi,2,0,0,0,0,0,8,0,8,1.1428571428571428,1,0.0,0,0,0,0,0,0,0,8,0,0,8,1
2240,44164,WLc3nzeMA1m785zH4gOIVyKG8qieUOwG,fbPkOYLVPtPgIt0MxizjfFJov3JbHyAi,4,2,1,0,1,0,2,0,6,0.8571428571428571,1,0.0,0,1,0,1,2,0,0,2,0,2,4,1
2241,44166,zLQK4qXkDKq3GVHuvnA5ZgyIevHVQUHp,fbPkOYLVPtPgIt0MxizjfFJov3JbHyAi,14,17,8,0,5,0,4,1,35,5.0,1,0.0,0,8,0,5,17,0,0,4,1,13,22,1
2242,44167,aXGAxVHU5aDLZJJ1gHpvXefHkIbw92yB,fbPkOYLVPtPgIt0MxizjfFJov3JbHyAi,18,11,8,0,7,18,8,1,53,7.571428571428571,1,0.0,1,8,0,7,10,18,0,8,1,16,37,1
2243,44171,JhiJnBpiVfW8JCO4BrjAwx4ywoZHB71f,fbPkOYLVPtPgIt0MxizjfFJov3JbHyAi,7,8,3,0,2,0,3,0,16,2.2857142857142856,1,0.0,0,3,0,2,8,0,0,3,0,5,11,1
2244,44172,SvI7NjkOF6DOPWLRc1U4XOWjW6ht1V3M,fbPkOYLVPtPgIt0MxizjfFJov3JbHyAi,2,0,0,0,0,0,5,0,5,0.7142857142857143,1,0.0,0,0,0,0,0,0,0,5,0,0,5,1
2245,44174,kr9MhAzeae0UKmOp6QSbcSIPAfRDBwyS,fbPkOYLVPtPgIt0MxizjfFJov3JbHyAi,17,30,12,3,10,32,9,0,96,13.714285714285714,2,0.0,12,12,3,10,18,32,0,9,0,37,59,1
2246,44175,58HxGhVJCkPf0xNzljCqWpiXdfJMiEDw,fbPkOYLVPtPgIt0MxizjfFJov3JbHyAi,8,2,2,0,2,0,6,0,12,1.7142857142857142,1,0.0,0,2,0,2,2,0,0,6,0,4,8,1
2247,44178,ZUj8ciewoY1krerme1rA06bZgMQzwUwF,fbPkOYLVPtPgIt0MxizjfFJov3JbHyAi,9,13,6,0,3,10,5,1,38,5.428571428571429,2,0.0,1,6,0,3,12,10,0,5,1,10,28,0
2248,44179,KybJTS3fr0HyrDCaccrgyo0RzMzG0qom,fbPkOYLVPtPgIt0MxizjfFJov3JbHyAi,2,0,0,0,0,0,4,0,4,0.5714285714285714,1,0.0,0,0,0,0,0,0,0,4,0,0,4,1
2249,44181,ZPamISIdPsbqsq6aVqRDFzUi3IlRadjg,fbPkOYLVPtPgIt0MxizjfFJov3JbHyAi,12,9,6,0,4,12,6,1,38,5.428571428571429,1,0.0,0,6,0,4,9,12,0,6,1,10,28,1
2250,44182,sn2EpOZocGCK2n6oyJ74BVfoIYZKGwBK,fbPkOYLVPtPgIt0MxizjfFJov3JbHyAi,9,15,0,10,3,11,10,0,49,7.0,1,0.0,10,0,7,3,5,11,3,10,0,20,29,1
2251,44184,UsLFN9dzLo3sTXf5tfNoi18KyZHWYRsB,fbPkOYLVPtPgIt0MxizjfFJov3JbHyAi,6,3,2,0,2,0,1,0,8,1.1428571428571428,1,0.0,0,2,0,2,3,0,0,1,0,4,4,1
2252,44185,tcFBEkXakkuMK1VljJZtgKVBO9EsakN0,fbPkOYLVPtPgIt0MxizjfFJov3JbHyAi,1,0,0,0,0,0,1,0,1,0.14285714285714285,1,0.0,0,0,0,0,0,0,0,1,0,0,1,1
2253,44186,mJ5BZ6EJA3wLg8jbGMObtpjRK8yspzI5,fbPkOYLVPtPgIt0MxizjfFJov3JbHyAi,26,28,13,22,10,31,8,1,113,16.142857142857142,1,0.0,10,13,18,10,18,31,4,8,1,51,62,1
2254,44187,i7yYKzmNeDNpl7ZXyamysycDjJWbLntm,fbPkOYLVPtPgIt0MxizjfFJov3JbHyAi,11,19,4,7,9,4,5,0,48,6.857142857142857,1,0.0,14,4,6,9,5,4,1,5,0,33,15,1
2255,44188,yFk2LSMib4DE4CR8Gt7OigYN8UE5SERE,fbPkOYLVPtPgIt0MxizjfFJov3JbHyAi,6,5,3,0,1,0,4,0,13,1.8571428571428572,3,0.0,0,3,0,1,5,0,0,4,0,4,9,1
2256,44193,5olZBiEN7fREGvXjZsAPA34LD7TNv2Om,fbPkOYLVPtPgIt0MxizjfFJov3JbHyAi,9,12,3,0,3,11,7,0,36,5.142857142857143,1,0.0,0,3,0,3,12,11,0,7,0,6,30,1
2257,44194,nkWrffpo6kobU01lUWepcu6aQb60BdxH,fbPkOYLVPtPgIt0MxizjfFJov3JbHyAi,26,46,19,10,13,24,12,1,125,17.857142857142858,5,0.0,15,19,10,13,31,24,0,12,1,57,68,0
2258,44195,rQ7jrT4jqfVvIwV7TCyxKklrYfaXz5qx,fbPkOYLVPtPgIt0MxizjfFJov3JbHyAi,6,7,4,0,2,7,4,0,24,3.4285714285714284,1,0.0,0,4,0,2,7,7,0,4,0,6,18,1
2259,44196,cXbVpSHehoFAcD5jvifZg4hoGlmfKlx5,fbPkOYLVPtPgIt0MxizjfFJov3JbHyAi,3,3,1,0,0,0,1,0,5,0.7142857142857143,1,0.0,0,1,0,0,3,0,0,1,0,1,4,0
2260,44201,bGSf4Dv41LrPDFgbxGTmHZXMfhKccKJy,fbPkOYLVPtPgIt0MxizjfFJov3JbHyAi,8,4,3,0,3,0,2,0,12,1.7142857142857142,2,0.0,0,3,0,3,4,0,0,2,0,6,6,1
2261,44202,UvmsOyeKqNqdnoWuF67HYRoCd5vZCTT3,fbPkOYLVPtPgIt0MxizjfFJov3JbHyAi,2,0,0,0,0,0,5,0,5,0.7142857142857143,1,0.0,0,0,0,0,0,0,0,5,0,0,5,1
2262,44203,4cRZxyVNjv13lU3nu2aK2rwyndExVCGa,fbPkOYLVPtPgIt0MxizjfFJov3JbHyAi,24,36,22,23,11,10,7,0,109,15.571428571428571,5,0.0,6,22,17,11,30,10,6,7,0,56,53,1
2263,44208,9nBDwXR4PojGZeJgF10uxjH1va7sf1sb,fbPkOYLVPtPgIt0MxizjfFJov3JbHyAi,5,3,1,0,1,0,7,0,12,1.7142857142857142,1,0.0,0,1,0,1,3,0,0,7,0,2,10,1
2264,44209,XZNYPNX0OVSTYmnVJQK9QQliGDqh1neQ,fbPkOYLVPtPgIt0MxizjfFJov3JbHyAi,5,8,3,0,0,0,7,0,18,2.5714285714285716,1,0.0,3,3,0,0,5,0,0,7,0,6,12,1
2265,44212,lMefkcgNh5NMvOXiUOkNuemhw07vFq2i,fbPkOYLVPtPgIt0MxizjfFJov3JbHyAi,6,4,2,0,1,6,5,0,18,2.5714285714285716,1,0.0,0,2,0,1,4,6,0,5,0,3,15,1
2266,44213,lR39Ca78D0WrhfXRqUEM5XEFow5I5VmV,fbPkOYLVPtPgIt0MxizjfFJov3JbHyAi,10,11,4,0,4,0,3,0,22,3.142857142857143,1,0.0,5,4,0,4,6,0,0,3,0,13,9,1
2267,44215,zLhYaUkalf3cJa8yuQ4GA08EdlJo6KYR,fbPkOYLVPtPgIt0MxizjfFJov3JbHyAi,2,0,0,0,0,0,2,0,2,0.2857142857142857,1,0.0,0,0,0,0,0,0,0,2,0,0,2,1
2268,44216,398KUlAbQAJq86al7WBicOZ2ToPIvKyy,fbPkOYLVPtPgIt0MxizjfFJov3JbHyAi,5,2,1,0,1,0,3,0,7,1.0,1,0.0,0,1,0,1,2,0,0,3,0,2,5,1
2269,44217,DwhbrQEsdQ584Yt1VsJhxkmyn6wsMQlr,fbPkOYLVPtPgIt0MxizjfFJov3JbHyAi,9,5,3,4,3,0,1,0,16,2.2857142857142856,1,0.0,1,3,3,3,4,0,1,1,0,10,6,1
2270,44219,Ur8i7WXZlexxp5KjJw4MNXxBOiEFRmEq,fbPkOYLVPtPgIt0MxizjfFJov3JbHyAi,12,4,4,0,4,0,3,0,15,2.142857142857143,2,0.0,0,4,0,4,4,0,0,3,0,8,7,1
2271,44225,9asMsoidPaReetlZL7sWsBgxvGgFunIW,fbPkOYLVPtPgIt0MxizjfFJov3JbHyAi,7,7,2,0,3,0,5,0,17,2.4285714285714284,1,0.0,2,2,0,3,5,0,0,5,0,7,10,1
2272,44227,W3EB1elPrDjFWV4QIzuswTukmjxtHb6Z,fbPkOYLVPtPgIt0MxizjfFJov3JbHyAi,5,2,0,0,1,0,2,0,5,0.7142857142857143,1,0.0,0,0,0,1,2,0,0,2,0,1,4,1
2273,44228,R1FqqBKIoe5gb1Zm4cRd6C2dKym4oN3J,fbPkOYLVPtPgIt0MxizjfFJov3JbHyAi,4,3,1,0,1,0,1,0,6,0.8571428571428571,1,0.0,0,1,0,1,3,0,0,1,0,2,4,0
2274,44229,xDQR9jsrXbDdyr5ix2doPKar2TBbunBq,fbPkOYLVPtPgIt0MxizjfFJov3JbHyAi,8,8,4,0,3,19,4,1,39,5.571428571428571,1,0.0,0,4,0,3,8,19,0,4,1,7,32,1
2275,44230,Ijb9fKceIgYIt7UF8znubY4lpG9MvHfC,fbPkOYLVPtPgIt0MxizjfFJov3JbHyAi,4,2,1,0,1,0,1,0,5,0.7142857142857143,1,0.0,0,1,0,1,2,0,0,1,0,2,3,1
2276,44232,VvFmHqJuverkRg9SOJfO7EAhSTYwhk8R,fbPkOYLVPtPgIt0MxizjfFJov3JbHyAi,1,0,0,0,0,0,2,0,2,0.2857142857142857,1,0.0,0,0,0,0,0,0,0,2,0,0,2,1
2277,44233,wm9IrPuDWolACPuibTN3CpCrRGsa74ef,fbPkOYLVPtPgIt0MxizjfFJov3JbHyAi,19,8,7,0,7,0,19,1,42,6.0,1,0.0,0,7,0,7,8,0,0,19,1,14,28,1
2278,44236,jagu0OJDhWTGFhfCMk0ghqluLpW3kzdC,fbPkOYLVPtPgIt0MxizjfFJov3JbHyAi,26,28,13,16,13,29,13,5,117,16.714285714285715,2,0.0,12,13,12,13,16,29,4,13,5,50,67,0
2279,44237,5wfiCJMdbkN7MkoUGvo3cfz8jV3jCktA,fbPkOYLVPtPgIt0MxizjfFJov3JbHyAi,6,4,2,0,1,11,4,0,22,3.142857142857143,2,0.0,0,2,0,1,4,11,0,4,0,3,19,1
2280,44239,0rBpfipIkPUXXv4992tUqetb5IpoweSC,fbPkOYLVPtPgIt0MxizjfFJov3JbHyAi,7,3,2,0,2,0,2,0,9,1.2857142857142858,1,0.0,0,2,0,2,3,0,0,2,0,4,5,1
2281,44240,OrcJP9YaqKO2WfXtlTi3GWMyG2WCYDrA,fbPkOYLVPtPgIt0MxizjfFJov3JbHyAi,7,3,2,0,2,0,4,0,11,1.5714285714285714,1,0.0,0,2,0,2,3,0,0,4,0,4,7,1
2282,44242,QYVRHTpooyTkzSbIywJ7ri5o4t73Xwty,fbPkOYLVPtPgIt0MxizjfFJov3JbHyAi,7,11,5,0,2,6,6,3,33,4.714285714285714,2,0.0,0,5,0,2,11,6,0,6,3,7,26,1
2283,44243,RR8icbJjkYOdUrylwRxkzCL89mNBS1kQ,fbPkOYLVPtPgIt0MxizjfFJov3JbHyAi,7,5,2,0,2,0,6,0,15,2.142857142857143,1,0.0,2,2,0,2,3,0,0,6,0,6,9,1
2284,44244,g2zZYnTJ1Pk3cSjsVP5SH4UjJdsbDJv7,fbPkOYLVPtPgIt0MxizjfFJov3JbHyAi,6,4,2,0,2,2,1,0,11,1.5714285714285714,1,0.0,1,2,0,2,3,2,0,1,0,5,6,0
2285,44248,K1umGIzxZInQChRQpf7KLIJB3rfPL8P3,fbPkOYLVPtPgIt0MxizjfFJov3JbHyAi,7,6,4,0,2,2,1,0,15,2.142857142857143,1,0.0,0,4,0,2,6,2,0,1,0,6,9,1
2286,44251,vFF7Q9hHOJ6qa16cDuF7JSSiOD7EEEuA,fbPkOYLVPtPgIt0MxizjfFJov3JbHyAi,2,0,0,0,0,0,2,0,2,0.2857142857142857,1,0.0,0,0,0,0,0,0,0,2,0,0,2,1
2287,44252,ly2UupZqGwkAeluSmrnRPVaNBG5zI6oB,fbPkOYLVPtPgIt0MxizjfFJov3JbHyAi,10,3,3,0,3,0,3,0,12,1.7142857142857142,1,0.0,0,3,0,3,3,0,0,3,0,6,6,1
2288,44253,ZV7o5798W7XrprHpNhvS0Cr1EgwiSgHZ,fbPkOYLVPtPgIt0MxizjfFJov3JbHyAi,10,11,5,0,4,17,8,0,45,6.428571428571429,2,0.0,3,5,0,4,8,17,0,8,0,12,33,1
2289,44256,bJOkL9U6IOy2ICy3FtWSfPLY5BHrDaNn,fbPkOYLVPtPgIt0MxizjfFJov3JbHyAi,19,17,10,2,8,1,7,0,45,6.428571428571429,2,0.0,1,10,2,8,16,1,0,7,0,21,24,1
2290,44257,QyPU5c4UNqLLtktJRpwU2AioPifGtMTU,fbPkOYLVPtPgIt0MxizjfFJov3JbHyAi,5,3,1,0,1,0,5,0,10,1.4285714285714286,1,0.0,0,1,0,1,3,0,0,5,0,2,8,1
2291,44258,mV7oUFoQV8UaUytbbGy8dq3Lp45sMej3,fbPkOYLVPtPgIt0MxizjfFJov3JbHyAi,5,2,1,0,1,0,3,0,7,1.0,1,0.0,0,1,0,1,2,0,0,3,0,2,5,1
2292,44260,fTY7PbFNeV0B3b5XiSuBQtOgneGDS4iZ,fbPkOYLVPtPgIt0MxizjfFJov3JbHyAi,7,3,2,0,2,0,2,0,9,1.2857142857142858,1,0.0,0,2,0,2,3,0,0,2,0,4,5,1
2293,44263,w7sOZdeQBox0eO8DVqyUKzi8avIzaYn4,fbPkOYLVPtPgIt0MxizjfFJov3JbHyAi,11,9,4,0,3,2,8,1,27,3.857142857142857,1,0.0,3,4,0,3,6,2,0,8,1,10,17,1
2294,44264,cA8JP9WlrRgRowgBnuouyPdSEGVSdPoU,fbPkOYLVPtPgIt0MxizjfFJov3JbHyAi,7,3,2,0,2,0,2,0,9,1.2857142857142858,1,0.0,0,2,0,2,3,0,0,2,0,4,5,1
2295,44265,beJ7nfPQcUdFyj8P1C0Vl4K57I6wCKrL,fbPkOYLVPtPgIt0MxizjfFJov3JbHyAi,7,8,5,0,3,0,3,1,20,2.857142857142857,1,0.0,0,5,0,3,8,0,0,3,1,8,12,1
2296,44267,r9kprGnmV8vKXI1tErs4EvgHZZ8IRF8I,fbPkOYLVPtPgIt0MxizjfFJov3JbHyAi,4,2,0,0,0,4,4,0,10,1.4285714285714286,1,0.0,0,0,0,0,2,4,0,4,0,0,10,1
2297,44270,GMzSpgZQ6jzVsfHn8W8i83JsYNxnP00b,fbPkOYLVPtPgIt0MxizjfFJov3JbHyAi,14,15,8,6,7,0,4,0,40,5.714285714285714,2,0.0,5,8,5,7,10,0,1,4,0,25,15,1
2298,44272,J3rwPgcYHKst1mTrkHfz6lTuHZtWbhHS,fbPkOYLVPtPgIt0MxizjfFJov3JbHyAi,6,5,3,0,3,0,1,0,12,1.7142857142857142,1,0.0,0,3,0,3,5,0,0,1,0,6,6,1
2299,44274,2qxdbGcKrOShnqwnQiXgdDAFvYPhSM6o,fbPkOYLVPtPgIt0MxizjfFJov3JbHyAi,6,3,2,0,2,0,2,0,9,1.2857142857142858,1,0.0,0,2,0,2,3,0,0,2,0,4,5,1
2300,44275,KTCLrjyRw15OM6ZLS9kBfeLSSnS0pLeh,fbPkOYLVPtPgIt0MxizjfFJov3JbHyAi,10,11,8,0,4,3,15,2,43,6.142857142857143,2,0.0,0,8,0,4,11,3,0,15,2,12,31,1
2301,44277,chYWQx9p6mrqtOqnuZLINe1RPkFDRJYi,fbPkOYLVPtPgIt0MxizjfFJov3JbHyAi,10,11,5,0,4,1,15,1,37,5.285714285714286,1,0.0,2,5,0,4,9,1,0,15,1,11,26,1
2302,44279,tx4grxmlQgEoy6eADYfJTj1STA6T1B91,fbPkOYLVPtPgIt0MxizjfFJov3JbHyAi,4,2,1,0,1,0,1,0,5,0.7142857142857143,1,0.0,0,1,0,1,2,0,0,1,0,2,3,1
2303,44280,gIksIEwmEEV0Pn8wMtaqnzuIMor23skp,fbPkOYLVPtPgIt0MxizjfFJov3JbHyAi,5,9,0,0,0,0,13,0,22,3.142857142857143,2,0.0,0,0,0,0,9,0,0,13,0,0,22,1
2304,44282,bxc4zM194IAB8OgoL6kSDGRq4OX5TDtY,fbPkOYLVPtPgIt0MxizjfFJov3JbHyAi,10,12,7,0,3,10,6,1,39,5.571428571428571,2,0.0,2,7,0,3,10,10,0,6,1,12,27,1
2305,44283,57qzgJAwfROYPxzSOrsA3G5DLHP95ajU,fbPkOYLVPtPgIt0MxizjfFJov3JbHyAi,6,5,3,0,2,0,4,0,14,2.0,2,0.0,0,3,0,2,5,0,0,4,0,5,9,1
2306,44284,lAPXQuLP1yRNYGiTpu7dIeoZTMEKBA0b,fbPkOYLVPtPgIt0MxizjfFJov3JbHyAi,10,16,4,6,4,0,3,0,33,4.714285714285714,1,0.0,4,4,6,4,12,0,0,3,0,18,15,1
2307,44285,KMmrb4nTAt1m2OAaFtq8lztLT3NFO2Pb,fbPkOYLVPtPgIt0MxizjfFJov3JbHyAi,1,0,0,0,0,0,1,0,1,0.14285714285714285,1,0.0,0,0,0,0,0,0,0,1,0,0,1,1
2308,44286,Sw0laYN5mow6XiHfrWCJl4qnRcU0Nesb,fbPkOYLVPtPgIt0MxizjfFJov3JbHyAi,10,10,8,0,6,0,2,0,26,3.7142857142857144,2,0.0,0,8,0,6,10,0,0,2,0,14,12,1
2309,44287,DULOyOFZsLRkoNHg3me4lby4O9mlfTfP,fbPkOYLVPtPgIt0MxizjfFJov3JbHyAi,8,14,8,0,0,0,6,0,28,4.0,2,0.0,0,8,0,0,14,0,0,6,0,8,20,1
2310,44288,mSToVMacc08MhsUyEFn562K69bpANB3P,fbPkOYLVPtPgIt0MxizjfFJov3JbHyAi,6,3,1,0,1,0,2,0,7,1.0,2,0.0,0,1,0,1,3,0,0,2,0,2,5,1
2311,44289,Z8E1fWEz0b5y6BD6dlIVX2UJWlqxRpHR,fbPkOYLVPtPgIt0MxizjfFJov3JbHyAi,11,12,6,5,5,4,2,0,34,4.857142857142857,2,0.0,4,6,4,5,8,4,1,2,0,19,15,1
2312,44290,RdArNf6qPycx7nnXJK9MCRyymBwv75n3,fbPkOYLVPtPgIt0MxizjfFJov3JbHyAi,5,2,1,0,0,0,5,0,8,1.1428571428571428,1,0.0,0,1,0,0,2,0,0,5,0,1,7,1
2313,44291,wGwI5daC8SwOUE0hcVwwOwixSwocHFPs,fbPkOYLVPtPgIt0MxizjfFJov3JbHyAi,6,3,2,0,2,0,1,0,8,1.1428571428571428,1,0.0,0,2,0,2,3,0,0,1,0,4,4,1
2314,44295,ydIfB5lDuQMdwnqw1Trec6MMfLMb9KME,fbPkOYLVPtPgIt0MxizjfFJov3JbHyAi,5,9,0,0,1,2,2,0,14,2.0,1,0.0,3,0,0,1,6,2,0,2,0,4,10,1
2315,44296,SlxIPeu1dmMaJlW3478OT2sG7yUhXJL1,fbPkOYLVPtPgIt0MxizjfFJov3JbHyAi,2,0,0,0,0,0,5,0,5,0.7142857142857143,1,0.0,0,0,0,0,0,0,0,5,0,0,5,1
2316,44297,4LlDUfJVZRN4VGhz1cOPbu42ptFr0ItJ,fbPkOYLVPtPgIt0MxizjfFJov3JbHyAi,10,22,16,0,10,4,5,0,57,8.142857142857142,2,0.0,2,16,0,10,20,4,0,5,0,28,29,1
2317,44299,5uyWPVLiSthHYhSAJufLobkztuAqGghO,fbPkOYLVPtPgIt0MxizjfFJov3JbHyAi,12,39,13,8,14,10,6,0,90,12.857142857142858,4,0.0,15,13,5,14,24,10,3,6,0,47,43,1
2318,44302,OzkaXzIRl9kqXzCHMBKEBEDNw27l64vJ,fbPkOYLVPtPgIt0MxizjfFJov3JbHyAi,5,2,1,0,1,0,6,0,10,1.4285714285714286,1,0.0,0,1,0,1,2,0,0,6,0,2,8,1
2319,44303,6SFV3JbKdSV7hRZqshJPkaxQAde0a5lX,fbPkOYLVPtPgIt0MxizjfFJov3JbHyAi,6,2,1,0,1,2,5,1,12,1.7142857142857142,1,0.0,0,1,0,1,2,2,0,5,1,2,10,1
2320,44304,NqxqEj1F6iv4kBP9fZF1q6JwtPVhl0hk,fbPkOYLVPtPgIt0MxizjfFJov3JbHyAi,4,1,0,0,0,0,3,0,4,0.5714285714285714,1,0.0,0,0,0,0,1,0,0,3,0,0,4,1
2321,44306,GCwNBqpZSN8gReMgO4ZxJ7plXwWznnJn,fbPkOYLVPtPgIt0MxizjfFJov3JbHyAi,1,0,0,0,0,0,1,0,1,0.14285714285714285,1,0.0,0,0,0,0,0,0,0,1,0,0,1,1
2322,44308,hIXeM0yyb6wIxVNnB5ijRV2LpcYBbrLW,fbPkOYLVPtPgIt0MxizjfFJov3JbHyAi,5,8,1,0,1,0,2,0,12,1.7142857142857142,1,0.0,0,1,0,1,8,0,0,2,0,2,10,1
2323,45309,cvmNQvB8C9tzfr5JL4ScqNRXsUkWS0qq,RXDvfPUBYFlVdlueBFbLW0mhhAyGEqpt,33,128,81,27,10,108,48,5,407,58.142857142857146,2,0.0,12,81,20,10,116,108,7,48,5,123,284,0
2324,45312,JrU3mQXDsHM3JCMrGML8Gsd1f6KKBRz5,RXDvfPUBYFlVdlueBFbLW0mhhAyGEqpt,1,0,0,0,0,0,1,0,1,0.14285714285714285,1,0.0,0,0,0,0,0,0,0,1,0,0,1,1
2325,45316,KUdvYZYC6ZViW3z5eiAU2e6Me0VXEfY4,RXDvfPUBYFlVdlueBFbLW0mhhAyGEqpt,1,0,0,0,0,0,2,0,2,0.2857142857142857,1,0.0,0,0,0,0,0,0,0,2,0,0,2,1
2326,45327,oE1QbspE1VaPia0G9CbmnflG7dN6cZJM,G8EPVSXsOYB5YQWZGiz1aVq5Pgr2GrQu,8,7,4,0,0,0,4,1,16,2.2857142857142856,2,0.0,1,4,0,0,6,0,0,4,1,5,11,1
2327,45339,CladEfFLLomb4XABUtmNVPFfnjm4LhE2,RXDvfPUBYFlVdlueBFbLW0mhhAyGEqpt,44,86,2,135,10,6,13,0,252,36.0,2,0.0,37,2,122,10,49,6,13,13,0,171,81,0
2328,45340,Q57EC9WScoWjECRp7MT77bmBt9oZMVVG,RXDvfPUBYFlVdlueBFbLW0mhhAyGEqpt,51,106,59,64,12,306,142,26,715,102.14285714285714,7,0.0,18,59,51,12,88,306,13,142,26,140,575,0
2329,45366,4v506xwnN2gFG9XeSNIeiBlmXImooi1O,RXDvfPUBYFlVdlueBFbLW0mhhAyGEqpt,1,0,0,0,0,0,2,0,2,0.2857142857142857,1,0.0,0,0,0,0,0,0,0,2,0,0,2,0
2330,45384,zkzUmPQTrqnNy4aMEOpIupZNYtjTcR9O,G8EPVSXsOYB5YQWZGiz1aVq5Pgr2GrQu,1,0,0,0,0,0,1,0,1,0.14285714285714285,1,0.0,0,0,0,0,0,0,0,1,0,0,1,1
2331,45391,sUA9xXq2cjEIung0hBSUfP1uBxFNZSs5,G8EPVSXsOYB5YQWZGiz1aVq5Pgr2GrQu,17,11,5,24,3,3,8,1,55,7.857142857142857,3,0.0,1,5,20,3,10,3,4,8,1,29,26,1
2332,45402,1lu7qFlpJ7c77SdGrohS207VNZCEPQ2W,G8EPVSXsOYB5YQWZGiz1aVq5Pgr2GrQu,14,7,6,0,4,0,19,2,38,5.428571428571429,2,0.0,0,6,0,4,7,0,0,19,2,10,28,1
2333,45436,yX4GtBReTtJl8CLrRCBEP3vcJDxXoOOn,RXDvfPUBYFlVdlueBFbLW0mhhAyGEqpt,1,0,0,0,0,0,1,0,1,0.14285714285714285,1,0.0,0,0,0,0,0,0,0,1,0,0,1,1
2334,45466,E2SSacGkmDwMmCOVOXL29GviqMFLwc68,G8EPVSXsOYB5YQWZGiz1aVq5Pgr2GrQu,1,0,0,0,0,0,1,0,1,0.14285714285714285,1,0.0,0,0,0,0,0,0,0,1,0,0,1,1
2335,45483,5U9E0pnoyq8gJfR6llsPDT5KP7DSR7H8,G8EPVSXsOYB5YQWZGiz1aVq5Pgr2GrQu,1,0,0,0,0,0,1,0,1,0.14285714285714285,1,0.0,0,0,0,0,0,0,0,1,0,0,1,1
2336,45532,ZrIXM5h8t7QDXRvT8qPfGTwh0kjMYeoV,RXDvfPUBYFlVdlueBFbLW0mhhAyGEqpt,9,13,8,0,1,15,4,0,41,5.857142857142857,3,0.0,2,8,0,1,11,15,0,4,0,11,30,1
2337,45546,VMgv7OqkaBwITbfAg6B6mOmAS6m3C11w,G8EPVSXsOYB5YQWZGiz1aVq5Pgr2GrQu,18,21,1,60,0,0,2,0,84,12.0,2,0.0,10,1,44,0,11,0,16,2,0,55,29,1
2338,45611,f2dlkEjQnfiTH1JmGq8MzaHN9HyOSQno,RXDvfPUBYFlVdlueBFbLW0mhhAyGEqpt,1,0,0,0,0,0,1,0,1,0.14285714285714285,1,0.0,0,0,0,0,0,0,0,1,0,0,1,1
2339,45722,zUCFNdkDJjSNIqUVigI0Q3t79JnpwRq3,RXDvfPUBYFlVdlueBFbLW0mhhAyGEqpt,1,0,0,0,0,0,1,0,1,0.14285714285714285,1,0.0,0,0,0,0,0,0,0,1,0,0,1,1
2340,45849,CpJFUzNBBad8gxGQfFWcVCTdakqtlRdi,RXDvfPUBYFlVdlueBFbLW0mhhAyGEqpt,1,0,0,0,0,0,2,0,2,0.2857142857142857,1,0.0,0,0,0,0,0,0,0,2,0,0,2,1
2341,45854,0DHsJAElXb9hqHUPTXAQocHtOXvWXP78,RXDvfPUBYFlVdlueBFbLW0mhhAyGEqpt,1,0,0,0,0,0,1,0,1,0.14285714285714285,1,0.0,0,0,0,0,0,0,0,1,0,0,1,1
2342,45931,BTsn79qot898Mo4TTFaO7NRlDTnmwcCn,G8EPVSXsOYB5YQWZGiz1aVq5Pgr2GrQu,1,0,0,0,0,0,1,0,1,0.14285714285714285,1,0.0,0,0,0,0,0,0,0,1,0,0,1,1
2343,45958,QVJT76zcnp3BslGL7JUS10ZkHM5HFGSg,RXDvfPUBYFlVdlueBFbLW0mhhAyGEqpt,1,0,0,0,0,0,1,0,1,0.14285714285714285,1,0.0,0,0,0,0,0,0,0,1,0,0,1,1
2344,45969,chQJNd08oe4UgyVlUUX52CvD3Wla8eb7,G8EPVSXsOYB5YQWZGiz1aVq5Pgr2GrQu,1,0,0,0,0,0,1,0,1,0.14285714285714285,1,0.0,0,0,0,0,0,0,0,1,0,0,1,1
2345,45977,sGg2QuTzc9ZdW4JVwqEMxUhxNa3l9bLB,G8EPVSXsOYB5YQWZGiz1aVq5Pgr2GrQu,1,0,0,0,0,0,1,0,1,0.14285714285714285,1,0.0,0,0,0,0,0,0,0,1,0,0,1,1
2346,46013,PNXl2SBlhwK5mHxVh3FrbKdX9rl1VIVp,G8EPVSXsOYB5YQWZGiz1aVq5Pgr2GrQu,1,0,0,0,0,0,1,0,1,0.14285714285714285,1,0.0,0,0,0,0,0,0,0,1,0,0,1,1
2347,46015,fGEAQY13PDoFhSvPw6ar51lhcxcXekJz,RXDvfPUBYFlVdlueBFbLW0mhhAyGEqpt,1,0,0,0,0,0,2,0,2,0.2857142857142857,1,0.0,0,0,0,0,0,0,0,2,0,0,2,1
2348,46059,ffnHtZ1QN4qjciwC3Yy8mONo5ZYvivQf,G8EPVSXsOYB5YQWZGiz1aVq5Pgr2GrQu,1,0,0,0,0,0,1,0,1,0.14285714285714285,1,0.0,0,0,0,0,0,0,0,1,0,0,1,1
2349,46114,3YdfU7bhuCtVSPeVcn33KfVYPID77mmY,RXDvfPUBYFlVdlueBFbLW0mhhAyGEqpt,1,0,0,0,0,0,1,0,1,0.14285714285714285,1,0.0,0,0,0,0,0,0,0,1,0,0,1,1
2350,46173,jj6BKJzz2LfNkxpbRScKRBOb519d4fcM,G8EPVSXsOYB5YQWZGiz1aVq5Pgr2GrQu,1,0,0,0,0,0,1,0,1,0.14285714285714285,1,0.0,0,0,0,0,0,0,0,1,0,0,1,1
2351,46237,N7kM3jWM4eH8xNeIeU71MKRwK6kQucbk,G8EPVSXsOYB5YQWZGiz1aVq5Pgr2GrQu,4,2,0,0,0,0,2,0,4,0.5714285714285714,1,0.0,0,0,0,0,2,0,0,2,0,0,4,1
2352,46280,2kMQkfKYMlhaU4UM5pB8xmNc8uChRuw1,RXDvfPUBYFlVdlueBFbLW0mhhAyGEqpt,1,0,0,0,0,0,1,0,1,0.14285714285714285,1,0.0,0,0,0,0,0,0,0,1,0,0,1,1
2353,46284,5lTTIs9nhtO0O7RTM99nDh8BPtI6ScTe,G8EPVSXsOYB5YQWZGiz1aVq5Pgr2GrQu,1,0,0,0,0,0,1,0,1,0.14285714285714285,1,0.0,0,0,0,0,0,0,0,1,0,0,1,1
2354,46304,khyDqhFAo6DpK4tMIyensDnI5TCI4bvw,G8EPVSXsOYB5YQWZGiz1aVq5Pgr2GrQu,1,0,0,0,0,0,1,0,1,0.14285714285714285,1,0.0,0,0,0,0,0,0,0,1,0,0,1,1
2355,46338,ZqLzWImxdtQBdKkWQiADsQDooYoZ3q37,RXDvfPUBYFlVdlueBFbLW0mhhAyGEqpt,1,0,0,0,0,0,1,0,1,0.14285714285714285,1,0.0,0,0,0,0,0,0,0,1,0,0,1,1
2356,46355,kjTdi307uJdPG2dA0MRZXL0j1FvRWtkq,G8EPVSXsOYB5YQWZGiz1aVq5Pgr2GrQu,1,0,0,0,0,0,1,0,1,0.14285714285714285,1,0.0,0,0,0,0,0,0,0,1,0,0,1,1
2357,46366,KuNFtG4l08F89uoxUeo0jGAYIKWrBRbs,RXDvfPUBYFlVdlueBFbLW0mhhAyGEqpt,15,19,6,0,3,0,10,0,38,5.428571428571429,2,0.0,0,6,0,3,19,0,0,10,0,9,29,1
2358,46383,cxxLaXhgAon6KrRcUx12hLoqbuiALekd,RXDvfPUBYFlVdlueBFbLW0mhhAyGEqpt,1,0,0,0,0,0,1,0,1,0.14285714285714285,1,0.0,0,0,0,0,0,0,0,1,0,0,1,1
2359,46389,gGFmJyNMerYTj0kT96HuKIvL9JdTq2vY,RXDvfPUBYFlVdlueBFbLW0mhhAyGEqpt,32,45,23,87,15,8,12,0,190,27.142857142857142,4,0.0,17,23,73,15,28,8,14,12,0,128,62,0
2360,46393,2AW6aH0SqKYjpe5J2qxXqfKxHscq7JWf,G8EPVSXsOYB5YQWZGiz1aVq5Pgr2GrQu,1,0,0,0,0,0,1,0,1,0.14285714285714285,1,0.0,0,0,0,0,0,0,0,1,0,0,1,1
2361,46413,3eLagVEammG0JrQUYdbSaNysDt0g3zAb,RXDvfPUBYFlVdlueBFbLW0mhhAyGEqpt,1,0,0,0,0,0,1,0,1,0.14285714285714285,1,0.0,0,0,0,0,0,0,0,1,0,0,1,1
2362,46414,pxpbjivAFvcOKL2janpM89oHptiaHIsF,G8EPVSXsOYB5YQWZGiz1aVq5Pgr2GrQu,1,0,0,0,0,0,1,0,1,0.14285714285714285,1,0.0,0,0,0,0,0,0,0,1,0,0,1,1
2363,46440,jspM6ZD48llYyfw95wwrh04hh61lp4NC,RXDvfPUBYFlVdlueBFbLW0mhhAyGEqpt,7,6,3,0,1,0,2,0,12,1.7142857142857142,2,0.0,0,3,0,1,6,0,0,2,0,4,8,1
2364,46446,C7E8IpvmWl51PErSqNPx8JIZDHe2uLQP,RXDvfPUBYFlVdlueBFbLW0mhhAyGEqpt,24,47,22,0,17,0,13,0,99,14.142857142857142,3,0.0,6,22,0,17,41,0,0,13,0,45,54,1
2365,46485,n0aD0wlRo2epwn74jquTDUFpiwWF99mc,fbPkOYLVPtPgIt0MxizjfFJov3JbHyAi,11,14,5,2,6,4,2,0,33,4.714285714285714,1,0.0,7,5,2,6,7,4,0,2,0,20,13,0
2366,46513,EiO5bky9R1Iqlpv4ItUpPBUgGb1eJItE,fbPkOYLVPtPgIt0MxizjfFJov3JbHyAi,4,2,1,0,1,0,1,0,5,0.7142857142857143,1,0.0,0,1,0,1,2,0,0,1,0,2,3,1
2367,46518,zNp29QwJYW19LnSbsZ5BdQrNdzMHpz2F,fbPkOYLVPtPgIt0MxizjfFJov3JbHyAi,14,16,12,2,8,9,5,0,52,7.428571428571429,1,0.0,2,12,2,8,14,9,0,5,0,24,28,1
2368,46527,8JTz84ZDdJm6tvsd7hgyCl1RB6wU6r2e,fbPkOYLVPtPgIt0MxizjfFJov3JbHyAi,19,25,10,9,10,26,13,1,94,13.428571428571429,2,0.0,11,10,7,10,14,26,2,13,1,38,56,1
2369,46531,KbMG2R5hi7lV4ttClunSqF2UarKF8FNZ,fbPkOYLVPtPgIt0MxizjfFJov3JbHyAi,12,26,15,0,9,12,12,1,75,10.714285714285714,2,0.0,6,15,0,9,20,12,0,12,1,30,45,1
2370,46534,KvCAdo1odeI84idtqyQZyVEKdaH6IDdM,fbPkOYLVPtPgIt0MxizjfFJov3JbHyAi,17,45,20,7,6,40,22,1,141,20.142857142857142,3,0.0,5,20,7,6,40,40,0,22,1,38,103,1
2371,46549,4ApVgPYGz6bz2SJLoGELpZ6RPnXwOa88,fbPkOYLVPtPgIt0MxizjfFJov3JbHyAi,24,64,28,13,20,27,14,0,166,23.714285714285715,4,0.0,24,28,11,20,40,27,2,14,0,83,83,0
2372,46562,rCajReBu2KQJPlVlrrQZIZvrYAp8h9Yy,fbPkOYLVPtPgIt0MxizjfFJov3JbHyAi,1,0,0,0,0,0,1,0,1,0.14285714285714285,1,0.0,0,0,0,0,0,0,0,1,0,0,1,1
2373,46571,ZKAk08L8Iriz8Uv5UOeqSbrNnzg1rlMz,fbPkOYLVPtPgIt0MxizjfFJov3JbHyAi,8,4,2,0,2,0,7,0,15,2.142857142857143,1,0.0,1,2,0,2,3,0,0,7,0,5,10,1
2374,46573,IvhEQ40qNYap5nunxQhwiW2fnAok3TLS,fbPkOYLVPtPgIt0MxizjfFJov3JbHyAi,9,5,3,0,2,19,5,1,35,5.0,1,0.0,0,3,0,2,5,19,0,5,1,5,30,0
2375,46582,Ikjjxpfg5ascMIjhTuGW8BkxPihDwWmv,fbPkOYLVPtPgIt0MxizjfFJov3JbHyAi,21,28,10,15,10,2,5,0,70,10.0,1,0.0,13,10,12,10,15,2,3,5,0,45,25,1
2376,46588,yfppFvC7mTSlPuhod9GGDRPkzP1HmCAu,fbPkOYLVPtPgIt0MxizjfFJov3JbHyAi,5,2,1,0,1,0,2,0,6,0.8571428571428571,2,0.0,0,1,0,1,2,0,0,2,0,2,4,1
2377,47709,gSg4PIaWl0hBhOgVlpN9o8YrQn4pTOeq,7GRhBDsirIGkRZBtSMEzNTyDr2JQm4xx,2,0,0,0,0,0,3,0,3,0.42857142857142855,1,0.0,0,0,0,0,0,0,0,3,0,0,3,1
2378,47743,iiuR3N6D1WRXLO09fb3Myc2MlNCCDfce,fbPkOYLVPtPgIt0MxizjfFJov3JbHyAi,4,3,0,0,0,0,2,0,5,0.7142857142857143,1,0.0,0,0,0,0,3,0,0,2,0,0,5,1
2379,47744,vCEQKCbjX310wPLqLwTGRr7i4Nhg0wTp,fbPkOYLVPtPgIt0MxizjfFJov3JbHyAi,10,8,4,0,3,2,5,0,22,3.142857142857143,1,0.0,0,4,0,3,8,2,0,5,0,7,15,1
2380,47745,gHBHYv37TuKpRs5kVViSUWhCV5Lhiblh,fbPkOYLVPtPgIt0MxizjfFJov3JbHyAi,7,3,2,0,2,0,2,0,9,1.2857142857142858,1,0.0,0,2,0,2,3,0,0,2,0,4,5,1
2381,47746,8ZsblV6culyKvM3swAGhgvHIR3alJq9n,fbPkOYLVPtPgIt0MxizjfFJov3JbHyAi,6,4,2,0,1,4,2,0,13,1.8571428571428572,2,0.0,0,2,0,1,4,4,0,2,0,3,10,1
2382,47747,FmNtF0dqiST5GypmKkWanKtXqnTegJEy,fbPkOYLVPtPgIt0MxizjfFJov3JbHyAi,1,0,0,0,0,0,1,0,1,0.14285714285714285,1,0.0,0,0,0,0,0,0,0,1,0,0,1,1
2383,47749,kkpDZ77gSlUQ6KcLobLV9NQm1XnSLEFr,fbPkOYLVPtPgIt0MxizjfFJov3JbHyAi,1,0,0,0,0,0,1,0,1,0.14285714285714285,1,0.0,0,0,0,0,0,0,0,1,0,0,1,1
2384,47751,cNndd5chSMU3sSAeRXd6PJHkgPmrCB8z,fbPkOYLVPtPgIt0MxizjfFJov3JbHyAi,7,2,1,0,1,1,4,2,11,1.5714285714285714,1,0.0,0,1,0,1,2,1,0,4,2,2,9,1
2385,47754,Pp9LbsXIl32Hj8Wq17Qd9kc6BTy8YAGl,fbPkOYLVPtPgIt0MxizjfFJov3JbHyAi,8,2,1,0,1,0,6,1,11,1.5714285714285714,1,0.0,0,1,0,1,2,0,0,6,1,2,9,1
2386,47755,lz6lDEfdau9dm3sqop0RmJjc1H5uyps1,fbPkOYLVPtPgIt0MxizjfFJov3JbHyAi,8,2,2,0,2,0,3,0,9,1.2857142857142858,1,0.0,0,2,0,2,2,0,0,3,0,4,5,1
2387,47756,L0FSy0eDJB0vLjpSsrNVX0T1aJD3NXFR,fbPkOYLVPtPgIt0MxizjfFJov3JbHyAi,10,18,6,8,6,4,12,0,54,7.714285714285714,1,0.0,7,6,5,6,11,4,3,12,0,24,30,1
2388,47757,AVyLSaof0VtZQR2ODvUxATLv8wovFv6r,fbPkOYLVPtPgIt0MxizjfFJov3JbHyAi,5,1,1,0,1,0,5,0,8,1.1428571428571428,1,0.0,0,1,0,1,1,0,0,5,0,2,6,1
2389,47759,ihajxoAz8rtCLZp3NhTz4Dj4wyy7Ve6j,fbPkOYLVPtPgIt0MxizjfFJov3JbHyAi,16,26,13,13,12,5,11,3,83,11.857142857142858,2,0.0,9,13,9,12,17,5,4,11,3,43,40,1
2390,47761,wzqDZnt5ey5srxRDV6DOODvuoPbW2hmC,fbPkOYLVPtPgIt0MxizjfFJov3JbHyAi,3,0,0,0,0,0,3,0,3,0.42857142857142855,1,0.0,0,0,0,0,0,0,0,3,0,0,3,1
2391,47762,zcIKJMENggqIW9hSdKBxNE0nRwFUSouz,fbPkOYLVPtPgIt0MxizjfFJov3JbHyAi,7,5,2,0,2,0,2,0,11,1.5714285714285714,1,0.0,2,2,0,2,3,0,0,2,0,6,5,1
2392,47763,JVoHWX6804dBiuuywxHjLhyoqtZIkCFx,fbPkOYLVPtPgIt0MxizjfFJov3JbHyAi,1,0,0,0,0,0,1,0,1,0.14285714285714285,1,0.0,0,0,0,0,0,0,0,1,0,0,1,1
2393,47765,ri6NVluQbSKckezFilIjxRHtq5swKp7U,fbPkOYLVPtPgIt0MxizjfFJov3JbHyAi,7,4,3,0,2,2,1,0,12,1.7142857142857142,1,0.0,0,3,0,2,4,2,0,1,0,5,7,1
2394,47766,ag9HLImVQiPyL9rK7r26gIINFvgysNlx,fbPkOYLVPtPgIt0MxizjfFJov3JbHyAi,10,7,5,0,4,0,5,0,21,3.0,1,0.0,0,5,0,4,7,0,0,5,0,9,12,0
2395,47767,Y54KD3ZA4LZs5ByE3QveGSSA4lLE8N3J,fbPkOYLVPtPgIt0MxizjfFJov3JbHyAi,6,3,2,0,2,0,1,0,8,1.1428571428571428,1,0.0,0,2,0,2,3,0,0,1,0,4,4,1
2396,47768,Yjq3LhAjOWvN82KjjED7khdom1HyBA50,fbPkOYLVPtPgIt0MxizjfFJov3JbHyAi,4,2,1,0,0,0,2,0,5,0.7142857142857143,1,0.0,0,1,0,0,2,0,0,2,0,1,4,1
2397,47769,37QXIA2mA5HwR196s7DdMurvu7yccsaS,fbPkOYLVPtPgIt0MxizjfFJov3JbHyAi,5,2,1,0,1,0,4,0,8,1.1428571428571428,1,0.0,0,1,0,1,2,0,0,4,0,2,6,1
2398,47771,WEqUhplW7x1SpLabVjNcI5M4HsCYjumg,fbPkOYLVPtPgIt0MxizjfFJov3JbHyAi,7,3,2,0,2,0,2,0,9,1.2857142857142858,1,0.0,0,2,0,2,3,0,0,2,0,4,5,1
2399,47773,rPoI3YNCiMsaBvpMVe9YNNLovGBjXQL1,fbPkOYLVPtPgIt0MxizjfFJov3JbHyAi,5,2,1,0,1,0,2,0,6,0.8571428571428571,1,0.0,0,1,0,1,2,0,0,2,0,2,4,1
2400,47774,38RAlLJIctL7kclCvMfQ1cdfefa6tncU,fbPkOYLVPtPgIt0MxizjfFJov3JbHyAi,7,4,2,0,2,0,4,0,12,1.7142857142857142,1,0.0,0,2,0,2,4,0,0,4,0,4,8,1
2401,47775,NbFjLBlaokvKCRfsLwofmB9VjZfUQeXG,fbPkOYLVPtPgIt0MxizjfFJov3JbHyAi,6,6,4,0,4,0,2,0,16,2.2857142857142856,1,0.0,0,4,0,4,6,0,0,2,0,8,8,1
2402,47778,tF7Aut7t0G2GWI4HCraCbVOE9W7RdLCy,fbPkOYLVPtPgIt0MxizjfFJov3JbHyAi,2,0,0,0,0,0,6,0,6,0.8571428571428571,1,0.0,0,0,0,0,0,0,0,6,0,0,6,1
2403,47781,JelJmDAgdvYMwysu2S8khlhEiSoRMDm3,fbPkOYLVPtPgIt0MxizjfFJov3JbHyAi,25,37,17,18,14,15,8,0,109,15.571428571428571,2,0.0,18,17,17,14,19,15,1,8,0,66,43,0
2404,47782,TGulLRA4GuGoMcQ4GcDFWeudMqmFclIY,fbPkOYLVPtPgIt0MxizjfFJov3JbHyAi,4,2,1,0,1,0,1,0,5,0.7142857142857143,1,0.0,0,1,0,1,2,0,0,1,0,2,3,1
2405,47784,o9yvVrDdqWbWhDTxptqPNzcJYAQzSgqs,fbPkOYLVPtPgIt0MxizjfFJov3JbHyAi,7,5,2,0,3,1,5,0,16,2.2857142857142856,1,0.0,2,2,0,3,3,1,0,5,0,7,9,1
2406,47785,hIwxGIao0auqtzgWn2kttNbjIiHkmA5D,fbPkOYLVPtPgIt0MxizjfFJov3JbHyAi,5,2,1,0,1,0,2,0,6,0.8571428571428571,1,0.0,0,1,0,1,2,0,0,2,0,2,4,1
2407,47786,9BOxWH9bnbnBFLyov7eyKil4OAMIu6r8,fbPkOYLVPtPgIt0MxizjfFJov3JbHyAi,1,0,0,0,0,0,4,0,4,0.5714285714285714,1,0.0,0,0,0,0,0,0,0,4,0,0,4,1
2408,47788,ZQSZgZ79Y2BI2kLu43mIPc6ox1OLMn3i,fbPkOYLVPtPgIt0MxizjfFJov3JbHyAi,9,4,3,0,2,0,7,0,16,2.2857142857142856,2,0.0,0,3,0,2,4,0,0,7,0,5,11,1
2409,47791,Hw8jmGp4VI4tAz6cfKhHDOeLB2t7MJ9z,fbPkOYLVPtPgIt0MxizjfFJov3JbHyAi,8,12,7,0,4,21,3,0,47,6.714285714285714,3,0.0,0,7,0,4,12,21,0,3,0,11,36,1
2410,47792,D6PbpNnbT91V2mO50Yo6lGeWMgk4tx0G,fbPkOYLVPtPgIt0MxizjfFJov3JbHyAi,8,9,6,0,2,5,2,0,24,3.4285714285714284,1,0.0,0,6,0,2,9,5,0,2,0,8,16,1
2411,47795,Ve7ldJJUZUHFSKTyCbiFRbXYpCfgkMe0,fbPkOYLVPtPgIt0MxizjfFJov3JbHyAi,5,3,2,0,1,0,2,0,8,1.1428571428571428,1,0.0,0,2,0,1,3,0,0,2,0,3,5,1
2412,47796,To4tY3l3Iwdy23bNNN8VbGmgVWF3Gp06,fbPkOYLVPtPgIt0MxizjfFJov3JbHyAi,11,7,3,7,4,0,3,0,24,3.4285714285714284,1,0.0,3,3,5,4,4,0,2,3,0,15,9,1
2413,47797,tHjeVI3fd22SmNtfBSk3NBb4XLGkojbV,fbPkOYLVPtPgIt0MxizjfFJov3JbHyAi,1,0,0,0,0,0,1,0,1,0.14285714285714285,1,0.0,0,0,0,0,0,0,0,1,0,0,1,1
2414,47798,ZobeGMKyIBgjnUNms43CrtMrVHf6iI1r,fbPkOYLVPtPgIt0MxizjfFJov3JbHyAi,8,5,3,0,2,0,4,0,14,2.0,1,0.0,0,3,0,2,5,0,0,4,0,5,9,1
2415,47799,Iwfu4an5Skhugcqyo5SceYhoFf90uJBX,fbPkOYLVPtPgIt0MxizjfFJov3JbHyAi,9,5,2,0,2,3,5,1,18,2.5714285714285716,1,0.0,0,2,0,2,5,3,0,5,1,4,14,1
2416,47800,4TT2g7nLcTVtuILlZdgBu9rrz9KLLOMk,fbPkOYLVPtPgIt0MxizjfFJov3JbHyAi,6,8,2,0,3,0,6,0,19,2.7142857142857144,1,0.0,5,2,0,3,3,0,0,6,0,10,9,1
2417,47801,PmMFkd1Rzxa3QPI5maWIgc4heZgC88AX,fbPkOYLVPtPgIt0MxizjfFJov3JbHyAi,7,3,2,0,2,0,2,0,9,1.2857142857142858,1,0.0,0,2,0,2,3,0,0,2,0,4,5,1
2418,47803,93FWPuXY2azQQwZQWS80tdORRpOo60jj,fbPkOYLVPtPgIt0MxizjfFJov3JbHyAi,12,17,8,0,5,10,6,0,46,6.571428571428571,2,0.0,3,8,0,5,14,10,0,6,0,16,30,1
2419,47804,ZcgzdyII0xKmmApyb1MgVZBfYdWiemwd,fbPkOYLVPtPgIt0MxizjfFJov3JbHyAi,7,3,2,0,2,0,3,0,10,1.4285714285714286,2,0.0,0,2,0,2,3,0,0,3,0,4,6,1
2420,47807,JQWlZ9S0smBFDMGfgqcpt4ewgfL5yur6,fbPkOYLVPtPgIt0MxizjfFJov3JbHyAi,6,3,2,0,1,0,2,0,8,1.1428571428571428,1,0.0,0,2,0,1,3,0,0,2,0,3,5,1
2421,47808,FYmdcExkLD3hobz533EUh65L31LUqQ1Y,fbPkOYLVPtPgIt0MxizjfFJov3JbHyAi,2,0,0,0,0,0,3,0,3,0.42857142857142855,1,0.0,0,0,0,0,0,0,0,3,0,0,3,1
2422,47811,eIW9M0Trkt0EiuTzN2HuEtF6QnUOm4E9,fbPkOYLVPtPgIt0MxizjfFJov3JbHyAi,7,4,3,0,3,0,3,0,13,1.8571428571428572,1,0.0,0,3,0,3,4,0,0,3,0,6,7,1
2423,47813,pzBdNMI6l60tGyYDZDsD8a3IbqJH27O8,fbPkOYLVPtPgIt0MxizjfFJov3JbHyAi,20,26,4,11,4,6,9,1,61,8.714285714285714,4,0.0,7,4,10,4,19,6,1,9,1,25,36,0
2424,47836,SvayS3hRjiQUsZJZ3Z80XuRW7pnvNCGH,fbPkOYLVPtPgIt0MxizjfFJov3JbHyAi,13,18,8,1,5,5,7,1,45,6.428571428571429,1,0.0,6,8,1,5,12,5,0,7,1,20,25,1
2425,47843,IZ5pWpBLzW50MjCCGxCjTz4w6DVz2MU3,fbPkOYLVPtPgIt0MxizjfFJov3JbHyAi,4,2,1,0,1,0,1,0,5,0.7142857142857143,1,0.0,0,1,0,1,2,0,0,1,0,2,3,1
2426,47844,P4gIdHzF607L8e8VPH3Qb09lxgNZRJFa,fbPkOYLVPtPgIt0MxizjfFJov3JbHyAi,10,11,7,0,7,3,5,0,33,4.714285714285714,2,0.0,2,7,0,7,9,3,0,5,0,16,17,1
2427,47856,82BkQjqJpTLnL5kDgBNneTIQ8dLAyaMt,fbPkOYLVPtPgIt0MxizjfFJov3JbHyAi,6,4,2,0,0,0,4,0,10,1.4285714285714286,1,0.0,0,2,0,0,4,0,0,4,0,2,8,1
2428,47899,7x6GR5vcpLicOQJjWWlyJk5P5JNLZFuv,RXDvfPUBYFlVdlueBFbLW0mhhAyGEqpt,3,0,0,0,0,0,2,3,5,0.7142857142857143,1,0.0,0,0,0,0,0,0,0,2,3,0,5,1
2429,47931,ExNrdfeKsdYl3xmpiJlCBa13JPKyssuX,A3fsA9Zfv1X2fVEQhTw51lKENdNrEqT3,17,27,1,0,1,29,8,1,67,9.571428571428571,2,0.0,0,1,0,1,27,29,0,8,1,2,65,0
2430,47984,nC6UOgoIicf8pr79f2rdG7NgUQiopW9Q,bWdj2GDclj5ofokWjzoa5jAwMkxCykd6,6,11,7,0,3,2,2,0,25,3.5714285714285716,2,0.0,0,7,0,3,11,2,0,2,0,10,15,0
2431,47995,UjOHFBm02iem7rlbuAJcfFkUj4JVBikN,RXDvfPUBYFlVdlueBFbLW0mhhAyGEqpt,31,35,1,51,2,5,13,2,109,15.571428571428571,2,0.0,11,1,49,2,24,5,2,13,2,63,46,0
2432,48037,tK5QWvLAN98DDvHjcCO96Vrig3bCPcrd,RXDvfPUBYFlVdlueBFbLW0mhhAyGEqpt,44,75,2,148,15,2,8,1,251,35.857142857142854,2,0.0,37,2,129,15,38,2,19,8,1,183,68,0
2433,48066,waLyzusenGGt78OBjbfLuixQktneXMVQ,SpATywNh6bZuzm8s1ceuBUnMUAeoAHHw,14,27,1,17,1,21,9,1,77,11.0,1,0.0,16,1,14,1,11,21,3,9,1,32,45,0
2434,48069,S0OJjF6aof0iTnIX6lUAxekoH3m4w7V0,A3fsA9Zfv1X2fVEQhTw51lKENdNrEqT3,1,0,0,0,0,0,1,0,1,0.14285714285714285,1,0.0,0,0,0,0,0,0,0,1,0,0,1,0
2435,48082,s13Zj70iGaPJV2HiUyzOXf2g6dcMZpb3,RXDvfPUBYFlVdlueBFbLW0mhhAyGEqpt,10,24,9,0,3,14,5,0,55,7.857142857142857,1,0.0,5,9,0,3,19,14,0,5,0,17,38,0
2436,48100,MEAK3CtWNpeCicplOKHcDUkHm4e2Gnat,A3fsA9Zfv1X2fVEQhTw51lKENdNrEqT3,26,11,9,68,3,0,2,0,93,13.285714285714286,1,0.0,0,9,55,3,11,0,13,2,0,67,26,0
2437,48118,9pydrkItOvXReb7xWe6yqdMpXhFzfa5K,SpATywNh6bZuzm8s1ceuBUnMUAeoAHHw,17,37,14,16,4,23,11,0,105,15.0,4,0.0,13,14,14,4,24,23,2,11,0,45,60,0
2438,48135,gtGDHRUZ7LgMlMOjWieE5uKSYCgIoTZ0,G8EPVSXsOYB5YQWZGiz1aVq5Pgr2GrQu,45,59,4,138,4,17,8,1,231,33.0,4,0.0,14,4,110,4,45,17,28,8,1,132,99,0
2439,48138,f3FFKNKPDIkY4ZzespQ1tkojfbmyOtUb,SpATywNh6bZuzm8s1ceuBUnMUAeoAHHw,17,62,15,17,6,137,52,7,296,42.285714285714285,6,0.0,11,15,15,6,51,137,2,52,7,47,249,0
2440,48148,2zQQnqY1LiZ9lcEXTzcE3zimEdKe8CdV,SpATywNh6bZuzm8s1ceuBUnMUAeoAHHw,16,29,14,12,5,5,11,2,78,11.142857142857142,5,0.0,10,14,12,5,19,5,0,11,2,41,37,0
2441,48197,5KWnGsOw1ONkUhC7cQevc5FAKOxsvvUS,SpATywNh6bZuzm8s1ceuBUnMUAeoAHHw,13,16,2,14,1,0,4,0,37,5.285714285714286,1,0.0,7,2,13,1,9,0,1,4,0,23,14,1
2442,48218,VBP5PzVQEKJYFH0y5ffEek5WfP9EW7uc,A3fsA9Zfv1X2fVEQhTw51lKENdNrEqT3,16,10,7,0,4,2,15,2,40,5.714285714285714,3,0.0,0,7,0,4,10,2,0,15,2,11,29,1
2443,48255,gLAW4GOuyz8JKg5RO5Sf2rzir65isCiq,G8EPVSXsOYB5YQWZGiz1aVq5Pgr2GrQu,12,12,10,0,9,4,5,0,40,5.714285714285714,1,0.0,0,10,0,9,12,4,0,5,0,19,21,0
2444,48268,EhHrinjt1AkEWC09AFZwBuP61S5NJgjn,A3fsA9Zfv1X2fVEQhTw51lKENdNrEqT3,19,12,9,0,7,2,5,0,35,5.0,1,0.0,0,9,0,7,12,2,0,5,0,16,19,1
2445,48285,CQ3xdz8pT9zQNTAl7b68jJZVAWVF2aTL,SpATywNh6bZuzm8s1ceuBUnMUAeoAHHw,15,12,0,13,1,6,7,1,40,5.714285714285714,3,0.0,3,0,11,1,9,6,2,7,1,15,25,1
2446,48303,ibgC3AgPCiKxZzQtLwOtyIa6DJRV6K2p,SpATywNh6bZuzm8s1ceuBUnMUAeoAHHw,17,59,23,25,4,102,33,5,251,35.857142857142854,4,0.0,23,23,19,4,36,102,6,33,5,69,182,0
2447,48304,H5UEKpeYUS8ZwAU1o3ZTuTx8QVBIM5mj,SpATywNh6bZuzm8s1ceuBUnMUAeoAHHw,14,9,0,6,0,6,7,1,29,4.142857142857143,2,0.0,2,0,6,0,7,6,0,7,1,8,21,1
2448,48308,UqMl8IgLVIouo6TVWfUzDQbBX8JDKQrY,SpATywNh6bZuzm8s1ceuBUnMUAeoAHHw,1,0,0,0,0,0,1,0,1,0.14285714285714285,1,0.0,0,0,0,0,0,0,0,1,0,0,1,1
2449,48343,KJnvgR26H5LLeKdyvjJHjjqg4mjHEhgN,bWdj2GDclj5ofokWjzoa5jAwMkxCykd6,10,9,3,32,5,9,9,0,67,9.571428571428571,1,0.0,6,3,31,5,3,9,1,9,0,45,22,0
2450,48354,YUkia24kFQkJdU9Tc0bEfJWS5kFL3fnZ,SpATywNh6bZuzm8s1ceuBUnMUAeoAHHw,18,45,16,14,7,8,22,1,113,16.142857142857142,5,0.0,18,16,11,7,27,8,3,22,1,52,61,0
2451,48364,TMaAbfbbsUXbGWJIhu1feBQgRZO29am6,G8EPVSXsOYB5YQWZGiz1aVq5Pgr2GrQu,65,63,26,134,14,59,28,1,325,46.42857142857143,6,0.0,22,26,110,14,41,59,24,28,1,172,153,0
2452,48366,eQnxTOv5tF733HrH1v8IIfXTQQ20WB86,SpATywNh6bZuzm8s1ceuBUnMUAeoAHHw,17,12,9,6,5,6,22,1,61,8.714285714285714,4,0.0,2,9,6,5,10,6,0,22,1,22,39,0
2453,48450,oWaJx5przpU6lf15eldDAW9VD7f9UZbS,SpATywNh6bZuzm8s1ceuBUnMUAeoAHHw,17,14,8,6,4,18,10,2,62,8.857142857142858,2,0.0,3,8,6,4,11,18,0,10,2,21,41,0
2454,48466,zOGgv8cnkqEW7Y2l6fqZ3IzLqplNhsIx,SpATywNh6bZuzm8s1ceuBUnMUAeoAHHw,10,7,0,0,0,1,6,1,15,2.142857142857143,1,0.0,2,0,0,0,5,1,0,6,1,2,13,1
2455,48480,T2e7T1KVGbCZHkx82TLCiB6K2groJqnl,SpATywNh6bZuzm8s1ceuBUnMUAeoAHHw,13,33,1,21,0,18,10,1,84,12.0,1,0.0,14,1,18,0,19,18,3,10,1,33,51,1
2456,48498,VEdQQ1yOFNqPNBrecyFKsnw5QECT7x69,SpATywNh6bZuzm8s1ceuBUnMUAeoAHHw,3,3,0,0,0,0,2,0,5,0.7142857142857143,1,0.0,0,0,0,0,3,0,0,2,0,0,5,1
2457,48515,NCU9xqLhC281ErH7IwNmupIJSyhaNMZW,SpATywNh6bZuzm8s1ceuBUnMUAeoAHHw,13,14,8,12,5,0,9,0,48,6.857142857142857,2,0.0,6,8,11,5,8,0,1,9,0,30,18,0
2458,48572,RvDbqb1jf5bMQYeeBsAiuychmXlXMqZ3,SpATywNh6bZuzm8s1ceuBUnMUAeoAHHw,12,22,7,18,2,26,11,1,87,12.428571428571429,2,0.0,10,7,15,2,12,26,3,11,1,34,53,0
2459,48579,OmRwEqIcEcFH28h4LCCN9RZtwAWWiBmW,SpATywNh6bZuzm8s1ceuBUnMUAeoAHHw,9,44,1,8,0,0,4,0,57,8.142857142857142,2,0.0,0,1,7,0,44,0,1,4,0,8,49,1
2460,48590,Bm1ROY20Td8ahvL40ylWLEiakWpICc5q,SpATywNh6bZuzm8s1ceuBUnMUAeoAHHw,7,6,4,0,3,0,3,0,16,2.2857142857142856,2,0.0,0,4,0,3,6,0,0,3,0,7,9,0
2461,48629,1ERwpt9wMj2n5z0yrcDeOTKwiq17bpYL,SpATywNh6bZuzm8s1ceuBUnMUAeoAHHw,15,16,10,12,5,0,8,1,52,7.428571428571429,2,0.0,3,10,11,5,13,0,1,8,1,29,23,0
2462,48647,A5P9jrlzLqQKpA3sVBvwbPCf9CAYmtxw,SpATywNh6bZuzm8s1ceuBUnMUAeoAHHw,17,30,7,17,4,39,7,1,105,15.0,3,0.0,18,7,13,4,12,39,4,7,1,42,63,0
2463,48677,miskafWCgRGEerOwmFhGeXinZmiVq8Xq,SpATywNh6bZuzm8s1ceuBUnMUAeoAHHw,14,13,6,16,4,5,6,0,50,7.142857142857143,2,0.0,6,6,13,4,7,5,3,6,0,29,21,0
2464,48733,mitKAcO5Yq84LGwUL473CFioIDbwQfRi,SpATywNh6bZuzm8s1ceuBUnMUAeoAHHw,11,16,8,14,0,6,8,0,52,7.428571428571429,2,0.0,4,8,14,0,12,6,0,8,0,26,26,0
2465,48743,geHYnGH5sQ7aHnnwLKBvDRjabqJU8jWh,RXDvfPUBYFlVdlueBFbLW0mhhAyGEqpt,9,8,1,0,1,3,6,3,22,3.142857142857143,1,0.0,0,1,0,1,8,3,0,6,3,2,20,1
2466,48764,oWaJx5przpU6lf15eldDAW9VD7f9UZbS,RXDvfPUBYFlVdlueBFbLW0mhhAyGEqpt,50,48,29,61,14,34,13,5,204,29.142857142857142,3,0.0,8,29,61,14,40,34,0,13,5,112,92,0
2467,48766,xBzkSH4dgUCYZ5BDcyxU9YukAdw2snHB,RXDvfPUBYFlVdlueBFbLW0mhhAyGEqpt,5,2,1,0,1,0,2,0,6,0.8571428571428571,1,0.0,0,1,0,1,2,0,0,2,0,2,4,1
2468,48788,IN0xY05lGNY1Rxj5WWCYq1C0mF0lQ2fJ,SpATywNh6bZuzm8s1ceuBUnMUAeoAHHw,14,26,1,12,0,26,11,2,78,11.142857142857142,1,0.0,10,1,10,0,16,26,2,11,2,21,57,0
2469,48803,GkoB2VZz49YRew10AQsiKgGNbvbaRd2W,SpATywNh6bZuzm8s1ceuBUnMUAeoAHHw,13,28,10,0,4,1,16,3,62,8.857142857142858,3,0.0,0,10,0,4,28,1,0,16,3,14,48,0
2470,48816,Vn131dD12fh0kapodbBhio0q4dV4IYmG,SpATywNh6bZuzm8s1ceuBUnMUAeoAHHw,16,16,9,6,5,22,8,1,67,9.571428571428571,1,0.0,4,9,6,5,12,22,0,8,1,24,43,0
2471,48903,TdcZVkuHoNELu59WVF9f7EUYKiYIHP14,A3fsA9Zfv1X2fVEQhTw51lKENdNrEqT3,1,0,0,0,0,0,1,0,1,0.14285714285714285,1,0.0,0,0,0,0,0,0,0,1,0,0,1,0
2472,48954,7Lv6OVvu1nsvUexcKSRks3wnATE3pr1d,G8EPVSXsOYB5YQWZGiz1aVq5Pgr2GrQu,3,0,0,0,0,0,3,0,3,0.42857142857142855,1,0.0,0,0,0,0,0,0,0,3,0,0,3,1
2473,48972,4IxIKalU9kAsrSpHM9QUN57NRdKohmHA,SpATywNh6bZuzm8s1ceuBUnMUAeoAHHw,9,15,0,10,0,0,6,0,31,4.428571428571429,1,0.0,11,0,10,0,4,0,0,6,0,21,10,0
2474,49001,xLRXz6THj9rNHROqVgV4eCcKXyO03jXb,RXDvfPUBYFlVdlueBFbLW0mhhAyGEqpt,17,29,8,0,6,0,2,0,45,6.428571428571429,1,0.0,0,8,0,6,29,0,0,2,0,14,31,1
2475,49011,1fjO19pGLwHG3depgSJxIFrDpr07UqZK,SpATywNh6bZuzm8s1ceuBUnMUAeoAHHw,12,22,4,0,2,8,19,1,56,8.0,4,0.0,3,4,0,2,19,8,0,19,1,9,47,0
2476,49017,1fjO19pGLwHG3depgSJxIFrDpr07UqZK,bWdj2GDclj5ofokWjzoa5jAwMkxCykd6,5,3,0,0,1,0,3,0,7,1.0,1,0.0,0,0,0,1,3,0,0,3,0,1,6,1
2477,49076,WSyXGkhm7NDepRlMA3agJj8k8GLnavsP,SpATywNh6bZuzm8s1ceuBUnMUAeoAHHw,18,54,28,8,8,31,45,6,180,25.714285714285715,6,0.0,7,28,7,8,47,31,1,45,6,50,130,0
2478,49093,KcyotPC829BMj56l23keqhJ3VB5WV4xY,A3fsA9Zfv1X2fVEQhTw51lKENdNrEqT3,5,5,1,0,0,1,4,0,11,1.5714285714285714,1,0.0,0,1,0,0,5,1,0,4,0,1,10,1
2479,49096,etO9cGvtnbcyDOUow8PWemZvzpbkeWT2,SpATywNh6bZuzm8s1ceuBUnMUAeoAHHw,10,22,1,10,0,0,11,0,44,6.285714285714286,4,0.0,3,1,10,0,19,0,0,11,0,14,30,0
2480,49129,5VPsupm8AUE2ZBwqUxHjS8zxcSp1Mcls,SpATywNh6bZuzm8s1ceuBUnMUAeoAHHw,18,25,11,20,4,13,19,1,93,13.285714285714286,2,0.0,8,11,16,4,17,13,4,19,1,39,54,0
2481,49132,gSsRzqNvll8eqcaaEGmB933OlJpuGX1g,G8EPVSXsOYB5YQWZGiz1aVq5Pgr2GrQu,68,68,18,146,14,3,21,2,272,38.857142857142854,3,0.0,44,18,109,14,24,3,37,21,2,185,87,0
2482,49139,cszgTMCcWdEja3BpEwPP5MtLXTMUMJXE,G8EPVSXsOYB5YQWZGiz1aVq5Pgr2GrQu,28,42,18,54,6,3,6,1,130,18.571428571428573,1,0.0,17,18,39,6,25,3,15,6,1,80,50,1
2483,49143,Jt2ZVEP2fRpS6kT1yCei4p4So6yqdxLs,SpATywNh6bZuzm8s1ceuBUnMUAeoAHHw,10,8,4,0,3,0,6,0,21,3.0,2,0.0,0,4,0,3,8,0,0,6,0,7,14,0
2484,49204,KWhhYcngkyB7QbL1Y9080mTGvLlZLj2v,SpATywNh6bZuzm8s1ceuBUnMUAeoAHHw,18,56,18,20,4,4,19,1,122,17.428571428571427,3,0.0,27,18,16,4,29,4,4,19,1,65,57,1
2485,49212,l70wRZ2DS0s6LjbT7C4gRoGrF27x9p2H,SpATywNh6bZuzm8s1ceuBUnMUAeoAHHw,10,13,0,10,0,0,4,0,27,3.857142857142857,2,0.0,3,0,9,0,10,0,1,4,0,12,15,0
2486,49237,Et66VbQRwkFnF42twZ8Z4ErFWQLehmwC,G8EPVSXsOYB5YQWZGiz1aVq5Pgr2GrQu,8,5,2,0,2,0,5,0,14,2.0,2,0.0,0,2,0,2,5,0,0,5,0,4,10,1
2487,49357,oJ9j9ejTgKixczg3tSE8Sg8DPI7YQpJq,G8EPVSXsOYB5YQWZGiz1aVq5Pgr2GrQu,39,46,16,53,7,6,7,0,135,19.285714285714285,3,0.0,25,16,35,7,21,6,18,7,0,83,52,0
2488,49397,uZVvmJaNXb0GsvOW7SvWgzrpxZ3muXeW,SpATywNh6bZuzm8s1ceuBUnMUAeoAHHw,12,14,1,16,1,6,7,1,46,6.571428571428571,4,0.0,10,1,16,1,4,6,0,7,1,28,18,0
2489,49410,tzUG2qRl7N6mPYRCQUU2RS3J3hIQZLrD,bWdj2GDclj5ofokWjzoa5jAwMkxCykd6,1,0,0,0,0,0,1,0,1,0.14285714285714285,1,0.0,0,0,0,0,0,0,0,1,0,0,1,1
2490,49481,2uoMQOxqyRzmIYFGnyAflqy5t44QW2xE,G8EPVSXsOYB5YQWZGiz1aVq5Pgr2GrQu,23,59,25,6,18,0,13,0,121,17.285714285714285,4,0.0,21,25,3,18,38,0,3,13,0,67,54,0
2491,49492,8zWgVyFjldbfjgOVhyVSCY9hVHofzB37,SpATywNh6bZuzm8s1ceuBUnMUAeoAHHw,7,10,4,0,3,0,3,0,20,2.857142857142857,3,0.0,0,4,0,3,10,0,0,3,0,7,13,0
2492,49507,IFqWOl32JJm0W3Ap2jxVCpJeXeLJlYDp,bWdj2GDclj5ofokWjzoa5jAwMkxCykd6,6,7,4,0,2,0,3,0,16,2.2857142857142856,2,0.0,1,4,0,2,6,0,0,3,0,7,9,1
2493,49593,tLAxgBhXx0zpE8fWNnwggaJx5LeHI2h1,A3fsA9Zfv1X2fVEQhTw51lKENdNrEqT3,29,32,17,32,10,0,3,0,94,13.428571428571429,2,0.0,0,17,30,10,32,0,2,3,0,57,37,1
2494,49675,vEvuCci9jxTTRH9CGXFnMQL31rdrARkm,RXDvfPUBYFlVdlueBFbLW0mhhAyGEqpt,2,1,0,0,0,0,1,0,2,0.2857142857142857,1,0.0,0,0,0,0,1,0,0,1,0,0,2,1
2495,49713,3mhHS6HFiNSDTjK0MItggE081qDKfyqL,SpATywNh6bZuzm8s1ceuBUnMUAeoAHHw,15,23,9,14,3,14,9,0,72,10.285714285714286,4,0.0,9,9,11,3,14,14,3,9,0,32,40,0
2496,49733,YIbC1cuJA4PbBVwCZRQOVlAtofCW8hIn,A3fsA9Zfv1X2fVEQhTw51lKENdNrEqT3,42,14,11,56,9,0,4,0,94,13.428571428571429,3,0.0,1,11,48,9,13,0,8,4,0,69,25,1
2497,49779,W6MGFBQ1Tov9lOeRQ8QlzHUMCDNEGRDq,A3fsA9Zfv1X2fVEQhTw51lKENdNrEqT3,41,36,19,40,14,0,6,0,115,16.428571428571427,3,0.0,1,19,39,14,35,0,1,6,0,73,42,0
2498,49875,0Akk5gAtNLhWs93rvoK6BfZzftMu43VT,SpATywNh6bZuzm8s1ceuBUnMUAeoAHHw,1,0,0,0,0,0,1,0,1,0.14285714285714285,1,0.0,0,0,0,0,0,0,0,1,0,0,1,0
2499,49878,fvzGqz3wcA15cPFjEfZNgqzkQDubcDYj,SpATywNh6bZuzm8s1ceuBUnMUAeoAHHw,15,73,44,18,0,16,26,3,180,25.714285714285715,3,0.0,9,44,15,0,64,16,3,26,3,68,112,0
2500,49885,v8BycPX41vEGxhnmXhJJeiFe4eT4u7RK,SpATywNh6bZuzm8s1ceuBUnMUAeoAHHw,11,8,5,17,0,3,5,0,38,5.428571428571429,2,0.0,2,5,14,0,6,3,3,5,0,21,17,0
2501,49941,C4q4gNQYEpjKh7pq1qjN8i3L7uSpUX9d,RXDvfPUBYFlVdlueBFbLW0mhhAyGEqpt,8,5,2,0,2,0,1,0,10,1.4285714285714286,1,0.0,0,2,0,2,5,0,0,1,0,4,6,1
2502,49947,xXjBI1Nf4mgkfSUkf8YjQF9E0XahXwSr,SpATywNh6bZuzm8s1ceuBUnMUAeoAHHw,17,17,8,6,4,14,8,1,58,8.285714285714286,2,0.0,7,8,6,4,10,14,0,8,1,25,33,0
2503,49980,fFjj8aLqWVfTrDoDqL54VYBbLQmMY3Y1,G8EPVSXsOYB5YQWZGiz1aVq5Pgr2GrQu,25,58,1,40,4,0,14,2,119,17.0,3,0.0,40,1,32,4,18,0,8,14,2,77,42,1
2504,49981,Q0d1WItnRJvnzlnn5VcAU6GMGN4rfbYJ,A3fsA9Zfv1X2fVEQhTw51lKENdNrEqT3,2,0,0,0,0,0,3,0,3,0.42857142857142855,1,0.0,0,0,0,0,0,0,0,3,0,0,3,1
2505,49986,cT0XTodWylQtczhaeg1zuAXwbhCqeXWR,SpATywNh6bZuzm8s1ceuBUnMUAeoAHHw,11,16,2,4,2,0,6,0,30,4.285714285714286,2,0.0,0,2,3,2,16,0,1,6,0,7,23,0
2506,50023,Eu9HoDt3WhECHgcXaERosbI6lMj7Hipb,A3fsA9Zfv1X2fVEQhTw51lKENdNrEqT3,45,37,32,90,27,17,7,1,211,30.142857142857142,2,0.0,2,32,73,27,35,17,17,7,1,134,77,1
2507,50028,9e5dcfJQbPUU8sTcmzE9DWoDPOA9Nhu3,A3fsA9Zfv1X2fVEQhTw51lKENdNrEqT3,7,10,1,0,1,0,1,0,13,1.8571428571428572,1,0.0,0,1,0,1,10,0,0,1,0,2,11,0
2508,50032,aKjAC5UWlmbeTD1k9n3NGSA3VSvaAKtm,SpATywNh6bZuzm8s1ceuBUnMUAeoAHHw,16,23,10,16,5,7,9,1,71,10.142857142857142,2,0.0,9,10,13,5,14,7,3,9,1,37,34,0
2509,50084,1HlQxNM9nR1hj1jXFLyimiGxZiQUWT8w,RXDvfPUBYFlVdlueBFbLW0mhhAyGEqpt,5,0,0,0,0,8,6,2,16,2.2857142857142856,2,0.0,0,0,0,0,0,8,0,6,2,0,16,1
2510,50170,jJ6KwmQPdHVF9SNnawJ7zfgWoExKlRbO,SpATywNh6bZuzm8s1ceuBUnMUAeoAHHw,3,3,1,0,0,0,2,0,6,0.8571428571428571,1,0.0,0,1,0,0,3,0,0,2,0,1,5,1
2511,50173,lVM3D8yPmd62Fdb29hI2YI0VPwlNvI4t,bWdj2GDclj5ofokWjzoa5jAwMkxCykd6,5,2,1,0,1,0,4,0,8,1.1428571428571428,2,0.0,0,1,0,1,2,0,0,4,0,2,6,1
2512,50203,8ZgsKNDzCbgk8zoZndfYiYFsfvE0SQgi,SpATywNh6bZuzm8s1ceuBUnMUAeoAHHw,13,18,3,11,1,1,9,1,44,6.285714285714286,2,0.0,9,3,10,1,9,1,1,9,1,23,21,0
2513,50223,l5LfU8gApOG72AnBkdAbfOLQLwFH7Zo2,SpATywNh6bZuzm8s1ceuBUnMUAeoAHHw,14,29,4,12,3,8,5,0,61,8.714285714285714,5,0.0,9,4,9,3,20,8,3,5,0,25,36,0
2514,50352,BS7u1moD4G6tIsp3i8TsGiKk2duVqSQ0,G8EPVSXsOYB5YQWZGiz1aVq5Pgr2GrQu,1,0,0,0,0,0,1,0,1,0.14285714285714285,1,0.0,0,0,0,0,0,0,0,1,0,0,1,1
2515,50361,Gur5FuhE9EyV9K1F0qLPk7AenhoY8PBS,SpATywNh6bZuzm8s1ceuBUnMUAeoAHHw,9,5,0,12,0,2,6,0,25,3.5714285714285716,1,0.0,2,0,9,0,3,2,3,6,0,11,14,1
2516,50380,Xdag5jOmE7uWC3FmBvgPc5F7lO3QNcPW,bWdj2GDclj5ofokWjzoa5jAwMkxCykd6,18,55,23,48,7,45,26,5,209,29.857142857142858,3,0.0,7,23,42,7,48,45,6,26,5,79,130,0
2517,50422,SnivjdMp3HL6G23yPscSnzZlAD2Rbyt6,bWdj2GDclj5ofokWjzoa5jAwMkxCykd6,12,11,7,20,3,13,1,0,55,7.857142857142857,1,0.0,2,7,17,3,9,13,3,1,0,29,26,1
2518,50455,9jNN69RJsAFkkuYDPHWQVpfsVwA6mFxd,SpATywNh6bZuzm8s1ceuBUnMUAeoAHHw,8,11,6,0,0,0,4,0,21,3.0,2,0.0,0,6,0,0,11,0,0,4,0,6,15,0
2519,50460,DRhlp1eJHQqsxjCL0bRD6kkHN20HbJ4w,RXDvfPUBYFlVdlueBFbLW0mhhAyGEqpt,4,2,1,0,1,0,1,0,5,0.7142857142857143,1,0.0,0,1,0,1,2,0,0,1,0,2,3,1
2520,50485,bZVDIvmAMciYIQrrbhRx0jvH9Tiicfyn,SpATywNh6bZuzm8s1ceuBUnMUAeoAHHw,2,0,0,0,0,5,1,0,6,0.8571428571428571,1,0.0,0,0,0,0,0,5,0,1,0,0,6,0
2521,50526,SKzEklIJtB0H7qSb29ZCLXx6x8polS8t,G8EPVSXsOYB5YQWZGiz1aVq5Pgr2GrQu,10,5,3,0,0,2,7,2,19,2.7142857142857144,1,0.0,0,3,0,0,5,2,0,7,2,3,16,1
2522,50572,XIlz5QvnlEzidDqYGld3VSh8CaOyBXAa,RXDvfPUBYFlVdlueBFbLW0mhhAyGEqpt,13,13,8,0,6,0,10,0,37,5.285714285714286,3,0.0,1,8,0,6,12,0,0,10,0,15,22,1
2523,50632,DeyP5lAVv1H3yXRPzbyis5xLngeggxpO,RXDvfPUBYFlVdlueBFbLW0mhhAyGEqpt,11,13,7,0,3,1,8,1,33,4.714285714285714,1,0.0,0,7,0,3,13,1,0,8,1,10,23,1
2524,50670,IDqUeKOsakXfpJsNR0qoC3jJJuHYmkPd,SpATywNh6bZuzm8s1ceuBUnMUAeoAHHw,5,13,1,0,0,0,3,1,18,2.5714285714285716,2,0.0,0,1,0,0,13,0,0,3,1,1,17,0
2525,50703,AEOK3hwhmsMNDRL3o1uoaIUrWvSc7heg,SpATywNh6bZuzm8s1ceuBUnMUAeoAHHw,5,5,1,0,0,0,2,0,8,1.1428571428571428,1,0.0,2,1,0,0,3,0,0,2,0,3,5,1
2526,50738,9va47BxxunDTlRdlZXe6vZY5WX0faoXZ,G8EPVSXsOYB5YQWZGiz1aVq5Pgr2GrQu,30,12,0,110,0,0,8,1,131,18.714285714285715,1,0.0,3,0,93,0,9,0,17,8,1,96,35,1
2527,50777,se9ZVl8DNkiCW8i2nP0p3krrUcQqYC47,bWdj2GDclj5ofokWjzoa5jAwMkxCykd6,18,27,14,114,9,1,9,1,175,25.0,3,0.0,8,14,111,9,19,1,3,9,1,142,33,0
2528,50789,3URMlJ8WFfbFx3SvBMPqUCA5oJqCky66,RXDvfPUBYFlVdlueBFbLW0mhhAyGEqpt,1,0,0,0,0,0,1,0,1,0.14285714285714285,1,0.0,0,0,0,0,0,0,0,1,0,0,1,1
2529,50805,1HrXazG6mMhlQyrWzEYwtGHFWa0bXXko,SpATywNh6bZuzm8s1ceuBUnMUAeoAHHw,1,0,0,0,0,0,1,0,1,0.14285714285714285,1,0.0,0,0,0,0,0,0,0,1,0,0,1,0
2530,50808,xm9wUIf1J8EjTNxXT4ffEWzhuySk21YK,RXDvfPUBYFlVdlueBFbLW0mhhAyGEqpt,44,67,29,90,45,0,6,0,237,33.857142857142854,4,0.0,13,29,85,45,54,0,5,6,0,172,65,0
2531,50835,KH1qoBE3q99uPmQbxyBhuyXhrxNuFdJJ,A3fsA9Zfv1X2fVEQhTw51lKENdNrEqT3,1,0,0,0,0,0,1,0,1,0.14285714285714285,1,0.0,0,0,0,0,0,0,0,1,0,0,1,1
2532,50841,POGRFFRZzlPiBHiCHXnlCDCb459JTEzc,G8EPVSXsOYB5YQWZGiz1aVq5Pgr2GrQu,46,63,0,154,0,2,7,0,226,32.285714285714285,3,0.0,11,0,124,0,52,2,30,7,0,135,91,0
2533,52525,7tM0glf5iOjFrrOx11jEjeXPWGg1qnPf,7GRhBDsirIGkRZBtSMEzNTyDr2JQm4xx,27,50,18,125,9,7,10,0,219,31.285714285714285,2,0.0,22,18,124,9,28,7,1,10,0,173,46,1
2534,52527,3EXQpH44dmXe1KuNCn9IRB8zLxVzdC0Z,7GRhBDsirIGkRZBtSMEzNTyDr2JQm4xx,3,2,0,0,0,0,1,0,3,0.42857142857142855,1,0.0,0,0,0,0,2,0,0,1,0,0,3,1
2535,52648,PCT9UecTLFgHQMLESQLM3zo2VKyldhOq,7GRhBDsirIGkRZBtSMEzNTyDr2JQm4xx,26,91,2,71,10,26,10,2,212,30.285714285714285,3,0.0,52,2,63,10,39,26,8,10,2,127,85,0
2536,52708,qZCURwy8JtTyuwzOv8VNGZdlPKRFUQ4x,7GRhBDsirIGkRZBtSMEzNTyDr2JQm4xx,2,0,0,0,0,0,5,0,5,0.7142857142857143,1,0.0,0,0,0,0,0,0,0,5,0,0,5,1
2537,52730,8XaoEwTyWeXdGPkk69feFC4MnARlyEPY,7GRhBDsirIGkRZBtSMEzNTyDr2JQm4xx,4,2,1,0,1,0,1,0,5,0.7142857142857143,1,0.0,0,1,0,1,2,0,0,1,0,2,3,0
2538,52794,ZI5bmLXRjGY30yDOOtLk3SjipijnEDdH,7GRhBDsirIGkRZBtSMEzNTyDr2JQm4xx,8,9,2,4,3,0,3,0,21,3.0,1,0.0,3,2,3,3,6,0,1,3,0,11,10,1
2539,52863,3AQcLF4401vlSQmnRaDEtc72D2nXEfx6,7GRhBDsirIGkRZBtSMEzNTyDr2JQm4xx,2,0,0,0,0,0,2,0,2,0.2857142857142857,1,0.0,0,0,0,0,0,0,0,2,0,0,2,1
2540,53041,FW02PfU8vx3pzmS7oOXpJualmcvfngs4,SpATywNh6bZuzm8s1ceuBUnMUAeoAHHw,4,3,0,0,0,0,2,0,5,0.7142857142857143,1,0.0,0,0,0,0,3,0,0,2,0,0,5,0
2541,53043,4LLdV2zTWS697dAsOgAPJZPFwfNnrjt6,SpATywNh6bZuzm8s1ceuBUnMUAeoAHHw,5,6,4,0,3,2,3,0,18,2.5714285714285716,1,0.0,0,4,0,3,6,2,0,3,0,7,11,0
2542,53055,1EHzEIUJa67W0jqPggV7KDaLGgi5Qkxp,SpATywNh6bZuzm8s1ceuBUnMUAeoAHHw,7,8,3,0,2,0,4,0,17,2.4285714285714284,2,0.0,0,3,0,2,8,0,0,4,0,5,12,1
2543,53074,vwFaMtviPYvvdeDxiexQOh059O9Yefj1,SpATywNh6bZuzm8s1ceuBUnMUAeoAHHw,10,6,4,0,3,0,5,2,20,2.857142857142857,2,0.0,0,4,0,3,6,0,0,5,2,7,13,1
2544,53087,Bos3zEEnAcYzPXQktMkJJ0ak5mhGWCAf,A3fsA9Zfv1X2fVEQhTw51lKENdNrEqT3,41,27,12,62,10,0,3,0,114,16.285714285714285,1,0.0,3,12,62,10,24,0,0,3,0,87,27,1
2545,53099,l5zm2dyq1Lp4ch4ILKl8mqNj892nMhsW,A3fsA9Zfv1X2fVEQhTw51lKENdNrEqT3,3,3,1,0,0,0,1,0,5,0.7142857142857143,1,0.0,0,1,0,0,3,0,0,1,0,1,4,1
2546,53104,f3SUvLtMnVyEZPEDJVhRMSC5cEFasHSH,G8EPVSXsOYB5YQWZGiz1aVq5Pgr2GrQu,1,0,0,0,0,0,1,0,1,0.14285714285714285,1,0.0,0,0,0,0,0,0,0,1,0,0,1,1
2547,53109,fFw6uRnMpWU4RqpwQO2WZ8GCAi6hyn9t,SpATywNh6bZuzm8s1ceuBUnMUAeoAHHw,17,19,8,22,5,5,15,1,75,10.714285714285714,2,0.0,2,8,18,5,17,5,4,15,1,33,42,0
2548,53142,AjsS25Vcjgm2GGcNjE7GPEmmTU7snmJA,SpATywNh6bZuzm8s1ceuBUnMUAeoAHHw,16,30,11,16,7,2,7,1,74,10.571428571428571,3,0.0,13,11,15,7,17,2,1,7,1,46,28,0
2549,53157,H8hoxOy1VDjrCqtl8Y1RjEzCSImzfPb1,SpATywNh6bZuzm8s1ceuBUnMUAeoAHHw,16,13,6,19,4,6,5,2,55,7.857142857142857,1,0.0,6,6,16,4,7,6,3,5,2,32,23,1
2550,53160,PPZEwof9f8rZx0lcTpURHpbkLB2YY5hH,A3fsA9Zfv1X2fVEQhTw51lKENdNrEqT3,5,2,1,0,1,0,4,0,8,1.1428571428571428,2,0.0,0,1,0,1,2,0,0,4,0,2,6,1
2551,53162,4nHfdAZtp0niyFyrjm2L6LhTVPrJBlZM,A3fsA9Zfv1X2fVEQhTw51lKENdNrEqT3,44,29,14,62,10,4,14,1,134,19.142857142857142,4,0.0,4,14,54,10,25,4,8,14,1,82,52,1
2552,53233,nOWqKetxGFQ9o73UNfcoh0XyCt3ITawR,SpATywNh6bZuzm8s1ceuBUnMUAeoAHHw,13,25,10,14,4,0,4,0,57,8.142857142857142,3,0.0,8,10,13,4,17,0,1,4,0,35,22,0
2553,53245,2Bc3e8bWl6DTvfTPBZCyShFFG8OApkva,G8EPVSXsOYB5YQWZGiz1aVq5Pgr2GrQu,17,37,12,20,10,11,2,0,92,13.142857142857142,2,0.0,13,12,15,10,24,11,5,2,0,50,42,1
2554,53253,nsNOT1cU6IuLaV7JjnTNsqpFb1YDxqEb,SpATywNh6bZuzm8s1ceuBUnMUAeoAHHw,15,33,12,16,0,57,21,4,143,20.428571428571427,4,0.0,13,12,13,0,20,57,3,21,4,38,105,0
2555,53302,yo1PAd1hBwimD9OOoxvyi6mwQC5bfK9g,A3fsA9Zfv1X2fVEQhTw51lKENdNrEqT3,5,2,1,0,1,0,2,0,6,0.8571428571428571,2,0.0,0,1,0,1,2,0,0,2,0,2,4,1
2556,53311,aPkMT9tuTlJ66PtOLGr8kUMmFmOPUdkZ,SpATywNh6bZuzm8s1ceuBUnMUAeoAHHw,5,3,1,0,1,0,1,0,6,0.8571428571428571,1,0.0,0,1,0,1,3,0,0,1,0,2,4,1
2557,53378,5IoXxgwnl1RIJLxkp1FnmYezwVSXlFjr,SpATywNh6bZuzm8s1ceuBUnMUAeoAHHw,15,20,10,8,6,1,5,1,51,7.285714285714286,2,0.0,5,10,6,6,15,1,2,5,1,27,24,0
2558,53487,N3Kcp8HxIitle1dnmjMusLDj62CzfGvL,SpATywNh6bZuzm8s1ceuBUnMUAeoAHHw,12,29,4,6,4,1,8,0,52,7.428571428571429,4,0.0,4,4,6,4,25,1,0,8,0,18,34,0
2559,53488,OnFhgQq4yBEqO4X7tLyRDBVhde68jGdf,RXDvfPUBYFlVdlueBFbLW0mhhAyGEqpt,11,5,5,0,0,1,10,1,22,3.142857142857143,2,0.0,0,5,0,0,5,1,0,10,1,5,17,0
2560,53502,MrmZgmDV3fLNPBur1xb2HpNXhTz9Exkt,SpATywNh6bZuzm8s1ceuBUnMUAeoAHHw,9,13,0,18,0,0,8,0,39,5.571428571428571,2,0.0,7,0,15,0,6,0,3,8,0,22,17,0
2561,53520,MhrFHIexWYn2dilUXh03cpnfpoe9tMBe,SpATywNh6bZuzm8s1ceuBUnMUAeoAHHw,17,20,6,14,2,7,12,1,62,8.857142857142858,4,0.0,10,6,14,2,10,7,0,12,1,32,30,1
2562,53539,i2lUV72IHqqXWYqLFMWv3y4XGmlq2lXa,SpATywNh6bZuzm8s1ceuBUnMUAeoAHHw,15,18,8,6,3,3,4,0,42,6.0,2,0.0,3,8,6,3,15,3,0,4,0,20,22,0
2563,53555,gb9jOdGxS4Zwvh3LQboE7LmvRCw5TLz9,SpATywNh6bZuzm8s1ceuBUnMUAeoAHHw,10,11,2,0,1,0,10,1,25,3.5714285714285716,1,0.0,0,2,0,1,11,0,0,10,1,3,22,1
2564,53597,dL8suqa4DXYE6Q2rD72jJySCosptOAyu,SpATywNh6bZuzm8s1ceuBUnMUAeoAHHw,9,16,1,3,0,0,5,0,25,3.5714285714285716,2,0.0,3,1,3,0,13,0,0,5,0,7,18,0
2565,53603,4Eyygyv4Uek4GSzjnDMCkiuVf4JBrAxc,SpATywNh6bZuzm8s1ceuBUnMUAeoAHHw,9,17,1,18,0,19,6,0,61,8.714285714285714,2,0.0,11,1,15,0,6,19,3,6,0,27,34,1
2566,53651,TXNnbjY690dLjW2nCR7nDyfRxXhXZM7x,A3fsA9Zfv1X2fVEQhTw51lKENdNrEqT3,4,3,0,0,0,0,1,0,4,0.5714285714285714,1,0.0,0,0,0,0,3,0,0,1,0,0,4,1
2567,53678,uqIn0vdfJ1SDJCOeCVEAQPRFBBKQA2eB,bWdj2GDclj5ofokWjzoa5jAwMkxCykd6,18,15,5,70,3,0,10,0,103,14.714285714285714,2,0.0,3,5,70,3,12,0,0,10,0,81,22,1
2568,53706,xQeTj9CLDdVhlEixqachfO1hdSy3qexC,SpATywNh6bZuzm8s1ceuBUnMUAeoAHHw,13,23,4,16,0,4,11,4,62,8.857142857142858,5,0.0,8,4,15,0,15,4,1,11,4,27,35,1
2569,53713,RluI9XQtU4oZmhgM6DxuPP3K5fCr0lBq,SpATywNh6bZuzm8s1ceuBUnMUAeoAHHw,4,2,1,0,1,0,1,0,5,0.7142857142857143,1,0.0,0,1,0,1,2,0,0,1,0,2,3,1
2570,53714,Ar22lkOE5FvesxoMKtYhm8Cbv4MUQUYF,RXDvfPUBYFlVdlueBFbLW0mhhAyGEqpt,42,68,4,120,7,27,50,26,302,43.142857142857146,3,0.0,27,4,112,7,41,27,8,50,26,150,152,1
2571,53720,eeYgUeHIQERDYwF1mxwVIZYsVaVSgwlV,A3fsA9Zfv1X2fVEQhTw51lKENdNrEqT3,39,47,25,64,10,17,15,0,178,25.428571428571427,2,0.0,3,25,56,10,44,17,8,15,0,94,84,1
2572,53750,DHyGbluRYDb9YK4sD54nYIDtRwaCVU4f,SpATywNh6bZuzm8s1ceuBUnMUAeoAHHw,15,25,12,6,2,10,7,1,63,9.0,3,0.0,5,12,6,2,20,10,0,7,1,25,38,1
2573,53758,Hu906OsUOpYkLeeay2GUzLMtBtAH0201,SpATywNh6bZuzm8s1ceuBUnMUAeoAHHw,7,11,1,0,1,0,1,0,14,2.0,1,0.0,0,1,0,1,11,0,0,1,0,2,12,1
2574,53801,JVippbCdijsZvDTgzyPclP2OizOfI7bg,SpATywNh6bZuzm8s1ceuBUnMUAeoAHHw,13,18,8,14,3,4,2,0,49,7.0,1,0.0,3,8,11,3,15,4,3,2,0,25,24,1
2575,53813,JfKuoH41ocsNDmphdAQOIFuKNZWqJJwf,SpATywNh6bZuzm8s1ceuBUnMUAeoAHHw,13,17,8,8,1,153,17,0,204,29.142857142857142,2,0.0,2,8,7,1,15,153,1,17,0,18,186,1
2576,53858,6Upqh8KDtBiZuS1AWTucTCCkEJCPfX5m,SpATywNh6bZuzm8s1ceuBUnMUAeoAHHw,10,19,1,23,0,3,2,0,48,6.857142857142857,2,0.0,10,1,19,0,9,3,4,2,0,30,18,0
2577,53861,Su9COtUoYOdyYjAUoqvAULKdQODTHr7E,bWdj2GDclj5ofokWjzoa5jAwMkxCykd6,9,14,4,52,1,3,7,1,82,11.714285714285714,1,0.0,5,4,50,1,9,3,2,7,1,60,22,0
2578,53875,wgifE6A0kxnDEjw7myKTY39TRuCgYxaB,bWdj2GDclj5ofokWjzoa5jAwMkxCykd6,6,4,1,0,1,0,3,0,9,1.2857142857142858,2,0.0,0,1,0,1,4,0,0,3,0,2,7,1
2579,53881,nEyHrNWAhCJiBBDbSB6IHu4lz50w5Dy6,A3fsA9Zfv1X2fVEQhTw51lKENdNrEqT3,16,10,8,0,7,0,4,0,29,4.142857142857143,3,0.0,0,8,0,7,10,0,0,4,0,15,14,1
2580,53895,Y0j1i2gPpBKnJTyvOTxYtV3JtU8UpMcv,SpATywNh6bZuzm8s1ceuBUnMUAeoAHHw,13,20,7,14,3,0,8,1,53,7.571428571428571,2,0.0,12,7,13,3,8,0,1,8,1,35,18,1
2581,53906,nCx7ByTflBYRKyE0yen5MKylk9XOx9rV,A3fsA9Zfv1X2fVEQhTw51lKENdNrEqT3,1,0,0,0,0,0,2,0,2,0.2857142857142857,2,0.0,0,0,0,0,0,0,0,2,0,0,2,1
2582,53917,4S03noH7cjIbR4dHJ5qcypZRCrtfcYb6,bWdj2GDclj5ofokWjzoa5jAwMkxCykd6,16,27,3,10,2,11,8,2,63,9.0,4,0.0,3,3,10,2,24,11,0,8,2,18,45,1
2583,53923,hiq4p9Wpf1ENeqXLCQsPukhDTDL2bNA2,RXDvfPUBYFlVdlueBFbLW0mhhAyGEqpt,21,31,12,25,1,14,19,5,107,15.285714285714286,3,0.0,13,12,23,1,18,14,2,19,5,49,58,0
2584,53947,cL4725Y58Cl01IjeOv5CCdtpjNF0EqJp,SpATywNh6bZuzm8s1ceuBUnMUAeoAHHw,9,14,7,0,1,4,7,1,34,4.857142857142857,3,0.0,3,7,0,1,11,4,0,7,1,11,23,1
2585,53980,f50myi7Wnjd1BWfZdyqaXMcdfMAdeGX9,G8EPVSXsOYB5YQWZGiz1aVq5Pgr2GrQu,48,80,0,80,1,40,14,1,216,30.857142857142858,5,0.0,40,0,54,1,40,40,26,14,1,95,121,0
2586,54001,Gglvz7f1jVuISouyvTJRaLDdezGOZ6EL,SpATywNh6bZuzm8s1ceuBUnMUAeoAHHw,16,37,4,20,3,11,16,1,92,13.142857142857142,3,0.0,9,4,16,3,28,11,4,16,1,32,60,0
2587,54002,FHrj4N2SCEsxza13qmFjgJkCjs8BkrF3,bWdj2GDclj5ofokWjzoa5jAwMkxCykd6,1,0,0,0,0,0,2,0,2,0.2857142857142857,1,0.0,0,0,0,0,0,0,0,2,0,0,2,1
2588,54009,U2oiAxypJX3TTENRYPio3LHOtQ2XmXGS,SpATywNh6bZuzm8s1ceuBUnMUAeoAHHw,15,35,10,17,3,4,14,1,84,12.0,2,0.0,12,10,14,3,23,4,3,14,1,39,45,0
2589,54015,Uo49WNvktWkKOAhlqrqOXLXaeoQpAgrc,SpATywNh6bZuzm8s1ceuBUnMUAeoAHHw,1,0,0,0,0,0,1,0,1,0.14285714285714285,1,0.0,0,0,0,0,0,0,0,1,0,0,1,1
2590,54026,gw1ywpstRy3gY1kWojp1woauzVM2ZYVr,SpATywNh6bZuzm8s1ceuBUnMUAeoAHHw,15,22,15,12,4,0,9,0,62,8.857142857142858,2,0.0,2,15,9,4,20,0,3,9,0,30,32,0
2591,54029,So8gZ8cXseEZ7lXf4idNMqcN46bXtlIA,SpATywNh6bZuzm8s1ceuBUnMUAeoAHHw,13,22,9,15,7,1,3,0,57,8.142857142857142,2,0.0,11,9,12,7,11,1,3,3,0,39,18,0
2592,54062,1zcBOliKKVXK419jHsqjZGpz654bIAn5,RXDvfPUBYFlVdlueBFbLW0mhhAyGEqpt,22,35,19,34,11,8,5,1,113,16.142857142857142,2,0.0,8,19,32,11,27,8,2,5,1,70,43,1
2593,54071,vYeGcWGAJP4B8Lvbjdr2jkY9NnpHN8xb,SpATywNh6bZuzm8s1ceuBUnMUAeoAHHw,15,28,12,21,6,5,9,0,81,11.571428571428571,1,0.0,10,12,18,6,18,5,3,9,0,46,35,1
2594,54076,33fwsM5EFqk5KwLRS1Hdk3QGBr5jYWOs,SpATywNh6bZuzm8s1ceuBUnMUAeoAHHw,18,30,15,11,6,15,19,2,98,14.0,4,0.0,9,15,10,6,21,15,1,19,2,40,58,0
2595,54078,mzJ0trk582dssKvdbvvSr3OyxZiFuQ3P,bWdj2GDclj5ofokWjzoa5jAwMkxCykd6,8,9,0,0,0,1,5,1,16,2.2857142857142856,2,0.0,0,0,0,0,9,1,0,5,1,0,16,1
2596,54094,Fdt86Xu5OLPdaOgl6M1XDpiJ3zar7SU6,SpATywNh6bZuzm8s1ceuBUnMUAeoAHHw,17,25,10,46,3,1,6,2,93,13.285714285714286,1,0.0,12,10,42,3,13,1,4,6,2,67,26,0
2597,54113,Dpj1ute7yeokptEET2ZfYuubDiXNwLXm,A3fsA9Zfv1X2fVEQhTw51lKENdNrEqT3,6,9,4,0,2,0,1,0,16,2.2857142857142856,1,0.0,0,4,0,2,9,0,0,1,0,6,10,1
2598,54121,nVNeaHavpiSEFe567sT2ScRxObLjhEGL,G8EPVSXsOYB5YQWZGiz1aVq5Pgr2GrQu,23,18,14,36,8,5,2,0,83,11.857142857142858,2,0.0,0,14,31,8,18,5,5,2,0,53,30,1
2599,54123,b5xbU8SGcZEvpqzyP6Qk6welzZOUxOvx,A3fsA9Zfv1X2fVEQhTw51lKENdNrEqT3,5,2,1,0,1,0,4,0,8,1.1428571428571428,1,0.0,0,1,0,1,2,0,0,4,0,2,6,1
2600,54129,qKOvjGeHnXAGhScloNy1qhNnfc1xHZ3T,SpATywNh6bZuzm8s1ceuBUnMUAeoAHHw,13,78,0,24,0,106,43,5,256,36.57142857142857,5,0.0,26,0,19,0,52,106,5,43,5,45,211,0
2601,54132,PfTpx7WgTJY6IpNokJ2POml34GMs7LTI,bWdj2GDclj5ofokWjzoa5jAwMkxCykd6,15,13,6,42,3,8,2,0,74,10.571428571428571,1,0.0,4,6,42,3,9,8,0,2,0,55,19,0
2602,54133,jU9n6p1KRt3F2eM3pIcFgt7azc85bbxP,SpATywNh6bZuzm8s1ceuBUnMUAeoAHHw,11,38,22,0,14,6,21,1,102,14.571428571428571,2,0.0,3,22,0,14,35,6,0,21,1,39,63,1
2603,54134,BtB75B9l8XyH0uPaKeOkkRrm2NqBrtQe,A3fsA9Zfv1X2fVEQhTw51lKENdNrEqT3,20,14,10,0,9,0,5,0,38,5.428571428571429,4,0.0,0,10,0,9,14,0,0,5,0,19,19,1
2604,54138,cZ43eywkms9yBmvkdibtxlcZqrcdFmmE,SpATywNh6bZuzm8s1ceuBUnMUAeoAHHw,7,5,2,0,0,2,4,1,14,2.0,1,0.0,2,2,0,0,3,2,0,4,1,4,10,1
2605,54140,2Bc3e8bWl6DTvfTPBZCyShFFG8OApkva,A3fsA9Zfv1X2fVEQhTw51lKENdNrEqT3,6,5,2,0,2,0,1,0,10,1.4285714285714286,1,0.0,0,2,0,2,5,0,0,1,0,4,6,1
2606,54145,uL6960SAwN5kJgcsaw9m5ztApNeZFO95,A3fsA9Zfv1X2fVEQhTw51lKENdNrEqT3,9,9,7,0,4,0,2,0,22,3.142857142857143,1,0.0,0,7,0,4,9,0,0,2,0,11,11,1
2607,54153,1rAHmNrxrqnzHEQFMlydmQ968LsZW0oG,A3fsA9Zfv1X2fVEQhTw51lKENdNrEqT3,4,0,0,0,0,0,5,0,5,0.7142857142857143,1,0.0,0,0,0,0,0,0,0,5,0,0,5,1
2608,54176,i2jPckJdA9hhx8KLohXM0CrojRerYpdv,SpATywNh6bZuzm8s1ceuBUnMUAeoAHHw,18,102,41,25,15,66,38,12,299,42.714285714285715,6,0.0,44,41,21,15,58,66,4,38,12,121,178,0
2609,54226,l3sfUHhSnAdS6GAthlSM3lKuUCRdk9CZ,A3fsA9Zfv1X2fVEQhTw51lKENdNrEqT3,6,3,2,0,2,0,2,0,9,1.2857142857142858,2,0.0,0,2,0,2,3,0,0,2,0,4,5,1
2610,54287,kuiW3Le0WeMGiwxmKgXwp1GfHw3vKMeq,SpATywNh6bZuzm8s1ceuBUnMUAeoAHHw,11,6,3,4,3,0,2,0,18,2.5714285714285716,1,0.0,1,3,4,3,5,0,0,2,0,11,7,1
2611,54306,pQnR1td8vlxsKseVpfzZVvCBdR2iP4U6,A3fsA9Zfv1X2fVEQhTw51lKENdNrEqT3,5,3,0,0,0,0,2,0,5,0.7142857142857143,1,0.0,0,0,0,0,3,0,0,2,0,0,5,0
2612,54321,qgHNkIIeFGRC3Bav4KufUnqlMzkDetSU,bWdj2GDclj5ofokWjzoa5jAwMkxCykd6,18,27,11,54,10,8,11,1,122,17.428571428571427,3,0.0,8,11,51,10,19,8,3,11,1,80,42,0
2613,54389,Dpj1ute7yeokptEET2ZfYuubDiXNwLXm,SpATywNh6bZuzm8s1ceuBUnMUAeoAHHw,5,8,5,0,3,0,3,0,19,2.7142857142857144,3,0.0,0,5,0,3,8,0,0,3,0,8,11,1
2614,54398,lg3JWapmXZgNYOt38qBO2QsZMUBFS5SJ,G8EPVSXsOYB5YQWZGiz1aVq5Pgr2GrQu,15,20,12,0,9,10,13,1,65,9.285714285714286,2,0.0,6,12,0,9,14,10,0,13,1,27,38,0
2615,54411,UZrNs5yPvW1ZVC8d6wdut2Js7XUvysRH,SpATywNh6bZuzm8s1ceuBUnMUAeoAHHw,16,24,15,14,2,17,8,2,82,11.714285714285714,5,0.0,2,15,13,2,22,17,1,8,2,32,50,1
2616,54447,6A2JLpLWnCwUlo9pD1HHlgEwNLvzcllv,A3fsA9Zfv1X2fVEQhTw51lKENdNrEqT3,20,24,18,0,10,0,4,0,56,8.0,2,0.0,1,18,0,10,23,0,0,4,0,29,27,1
2617,54467,Ha2E1KX6VBrxAJ0Y64ONsTCt1RbrAdiK,SpATywNh6bZuzm8s1ceuBUnMUAeoAHHw,16,15,7,13,3,0,6,0,44,6.285714285714286,3,0.0,6,7,11,3,9,0,2,6,0,27,17,0
2618,54485,bbBKqbJ74sqbqRiQHsLpyapFJxr2Z728,SpATywNh6bZuzm8s1ceuBUnMUAeoAHHw,13,28,8,1,1,5,12,2,57,8.142857142857142,2,0.0,8,8,1,1,20,5,0,12,2,18,39,1
2619,54509,HPaDTzk2xymxbpoa0VdcxdHl3uFfOfZk,bWdj2GDclj5ofokWjzoa5jAwMkxCykd6,11,16,9,0,1,4,21,2,53,7.571428571428571,2,0.0,2,9,0,1,14,4,0,21,2,12,41,1
2620,54512,x6BtQH70uuLHaxqzHA21U9wmfT0SxzD9,SpATywNh6bZuzm8s1ceuBUnMUAeoAHHw,13,16,1,10,0,17,19,1,64,9.142857142857142,5,0.0,3,1,8,0,13,17,2,19,1,12,52,0
2621,54518,CE7hlTWnMpoldcHVRqlfbEgzp5iUVo4d,SpATywNh6bZuzm8s1ceuBUnMUAeoAHHw,7,2,1,0,1,1,5,1,11,1.5714285714285714,1,0.0,0,1,0,1,2,1,0,5,1,2,9,0
2622,54524,CxUPOQRaQMGLmbOcfniIQOhh24PXLDR6,bWdj2GDclj5ofokWjzoa5jAwMkxCykd6,12,20,5,30,2,0,4,0,61,8.714285714285714,3,0.0,5,5,26,2,15,0,4,4,0,38,23,0
2623,54558,jtxvuHBV8ZOgNnNCL1A1WerzR2TVfFNy,RXDvfPUBYFlVdlueBFbLW0mhhAyGEqpt,19,12,8,20,5,0,1,0,46,6.571428571428571,1,0.0,3,8,18,5,9,0,2,1,0,34,12,1
2624,54568,fUMqQuy71n3a3vBlGt3GhPdNsIerKaNG,SpATywNh6bZuzm8s1ceuBUnMUAeoAHHw,14,20,11,10,0,0,7,0,48,6.857142857142857,3,0.0,3,11,8,0,17,0,2,7,0,22,26,1
2625,54604,X3X3klM03RXeGUjty93sg2SlkZrg3xpQ,fbPkOYLVPtPgIt0MxizjfFJov3JbHyAi,6,3,2,0,2,0,1,0,8,1.1428571428571428,1,0.0,0,2,0,2,3,0,0,1,0,4,4,1
2626,54616,cgTRAnMuMn887xEhHTcg5rpmYHHPoyIP,fbPkOYLVPtPgIt0MxizjfFJov3JbHyAi,26,52,25,17,17,28,15,1,155,22.142857142857142,2,0.0,19,25,15,17,33,28,2,15,1,76,79,0
2627,54620,z4EDsyht0TzSAKAyhX4LHmg2BH9dRlQd,fbPkOYLVPtPgIt0MxizjfFJov3JbHyAi,11,5,4,0,3,5,5,1,23,3.2857142857142856,1,0.0,0,4,0,3,5,5,0,5,1,7,16,1
2628,54660,LG6VIza4JcQFFbXQ1PDBU7m3JeA6BbpC,fbPkOYLVPtPgIt0MxizjfFJov3JbHyAi,24,30,15,17,19,25,15,3,124,17.714285714285715,1,0.0,14,15,14,19,16,25,3,15,3,62,62,1
2629,54668,KEpGXvdRkmZf3PNthZY5jtIyu6Bw3Rlp,SpATywNh6bZuzm8s1ceuBUnMUAeoAHHw,18,29,13,10,3,7,24,1,87,12.428571428571429,3,0.0,8,13,9,3,21,7,1,24,1,33,54,1
2630,54721,5FY4ZrNjp3ms2uO9UJ9szCrbCrZUttRZ,7GRhBDsirIGkRZBtSMEzNTyDr2JQm4xx,5,3,1,0,1,0,1,0,6,0.8571428571428571,1,0.0,0,1,0,1,3,0,0,1,0,2,4,1
2631,54723,z5Ulo2w0cg5OjY2Cx9aYoywDQvm6hLIF,RXDvfPUBYFlVdlueBFbLW0mhhAyGEqpt,11,18,11,0,4,0,7,0,40,5.714285714285714,5,0.0,0,11,0,4,18,0,0,7,0,15,25,0
2632,54724,XfiCSk5eLAbq9rzQtnLkX2OQTd6M8xFG,bWdj2GDclj5ofokWjzoa5jAwMkxCykd6,2,0,0,0,0,0,3,0,3,0.42857142857142855,1,0.0,0,0,0,0,0,0,0,3,0,0,3,0
2633,54761,MfwWTipzPsRtzbyiOZCobMuGSNow3sHg,SpATywNh6bZuzm8s1ceuBUnMUAeoAHHw,11,11,7,5,6,0,2,0,31,4.428571428571429,1,0.0,0,7,4,6,11,0,1,2,0,17,14,0
2634,54800,OseLd0Vj4CawbZPfZRznLZH5tivxQP68,SpATywNh6bZuzm8s1ceuBUnMUAeoAHHw,7,2,2,0,2,0,2,0,8,1.1428571428571428,1,0.0,0,2,0,2,2,0,0,2,0,4,4,1
2635,54819,PkEcTe3rugNe3WrTlhHnV7MduvQXThEB,RXDvfPUBYFlVdlueBFbLW0mhhAyGEqpt,6,5,4,0,0,0,1,0,10,1.4285714285714286,1,0.0,0,4,0,0,5,0,0,1,0,4,6,1
2636,54837,2AWz8OiYqJqT0VYmevCkAuxaVCSl88oB,7GRhBDsirIGkRZBtSMEzNTyDr2JQm4xx,1,0,0,0,0,0,1,0,1,0.14285714285714285,1,0.0,0,0,0,0,0,0,0,1,0,0,1,1
2637,54879,bT6yH99PTuyz3a6ueCehCDHIMjMdNYHB,SpATywNh6bZuzm8s1ceuBUnMUAeoAHHw,12,12,5,18,3,7,1,0,46,6.571428571428571,1,0.0,6,5,15,3,6,7,3,1,0,29,17,1
2638,54910,L8A0UDBue4RuYlwBFsU412yruT49eHlP,7GRhBDsirIGkRZBtSMEzNTyDr2JQm4xx,6,4,1,0,0,0,8,0,13,1.8571428571428572,1,0.0,0,1,0,0,4,0,0,8,0,1,12,1
2639,54937,o076ufFxYjFcAtg8dPv0W5vwk5oKbSiz,SpATywNh6bZuzm8s1ceuBUnMUAeoAHHw,12,9,6,0,4,0,4,1,24,3.4285714285714284,2,0.0,0,6,0,4,9,0,0,4,1,10,14,1
2640,54942,ijpfz5cJPrusRBczJIwOiwlUzdR9aysy,SpATywNh6bZuzm8s1ceuBUnMUAeoAHHw,12,17,5,6,1,0,5,0,34,4.857142857142857,2,0.0,10,5,6,1,7,0,0,5,0,22,12,0
2641,54944,ak9H3u3GmnBMjkxaXtGHxcLDDF2zUXnS,7GRhBDsirIGkRZBtSMEzNTyDr2JQm4xx,2,0,0,0,0,0,3,0,3,0.42857142857142855,1,0.0,0,0,0,0,0,0,0,3,0,0,3,1
2642,54989,DUw85TcNpxyZaZKIM1HlHxvgtSm7uwxY,A3fsA9Zfv1X2fVEQhTw51lKENdNrEqT3,7,3,1,0,1,0,7,1,13,1.8571428571428572,1,0.0,0,1,0,1,3,0,0,7,1,2,11,1
2643,54999,4RUK0a6HkZbpdBgheC58rw27wDnlPa70,7GRhBDsirIGkRZBtSMEzNTyDr2JQm4xx,10,8,3,0,4,2,5,1,23,3.2857142857142856,1,0.0,4,3,0,4,4,2,0,5,1,11,12,1
2644,55026,7GuXtdTnAtax3FkfgWewqF5JrGz1oCyt,7GRhBDsirIGkRZBtSMEzNTyDr2JQm4xx,1,0,0,0,0,0,1,0,1,0.14285714285714285,1,0.0,0,0,0,0,0,0,0,1,0,0,1,1
2645,55082,UbxAJQUpM4nPUifCeu8NjmX0juFyLMFH,SpATywNh6bZuzm8s1ceuBUnMUAeoAHHw,11,11,0,12,0,0,3,0,26,3.7142857142857144,2,0.0,2,0,12,0,9,0,0,3,0,14,12,1
2646,55105,5ysSxswt94Gjj7n5OSEcRzDBWhgbKFUg,7GRhBDsirIGkRZBtSMEzNTyDr2JQm4xx,8,11,4,6,4,0,2,0,27,3.857142857142857,2,0.0,5,4,5,4,6,0,1,2,0,18,9,1
2647,55114,7U7MZiTthIrdSyitYp5jXYVRqrLWtNBu,7GRhBDsirIGkRZBtSMEzNTyDr2JQm4xx,11,10,0,0,0,0,4,0,14,2.0,1,0.0,0,0,0,0,10,0,0,4,0,0,14,1
2648,55135,GaaUSAn7OjFLzHXXBEBVyi3shjmvN0lH,A3fsA9Zfv1X2fVEQhTw51lKENdNrEqT3,4,4,3,0,2,0,2,0,11,1.5714285714285714,1,0.0,0,3,0,2,4,0,0,2,0,5,6,1
2649,55164,ELrr1JfnDsWjEvT48HXDtL9YqiQpfZmF,A3fsA9Zfv1X2fVEQhTw51lKENdNrEqT3,4,2,1,0,1,0,2,0,6,0.8571428571428571,1,0.0,0,1,0,1,2,0,0,2,0,2,4,1
2650,55182,VF14jDCwIzSb92Zq60K5zB8BaUbLT4fN,A3fsA9Zfv1X2fVEQhTw51lKENdNrEqT3,32,30,1,81,0,2,6,0,120,17.142857142857142,1,0.0,2,1,69,0,28,2,12,6,0,72,48,1
2651,55215,RHl3DsvAX7TisJ7qBptmgrrtDAQvH7mr,7GRhBDsirIGkRZBtSMEzNTyDr2JQm4xx,4,2,1,0,1,0,1,0,5,0.7142857142857143,1,0.0,0,1,0,1,2,0,0,1,0,2,3,1
2652,55220,nPRsjektHdbQkeAf1fIK4JbhrESPbPsA,RXDvfPUBYFlVdlueBFbLW0mhhAyGEqpt,8,6,1,0,0,2,5,1,15,2.142857142857143,1,0.0,0,1,0,0,6,2,0,5,1,1,14,1
2653,55295,XmfaTDISWF5comI3j0oigEszknbdPhWn,7GRhBDsirIGkRZBtSMEzNTyDr2JQm4xx,1,0,0,0,0,0,2,0,2,0.2857142857142857,1,0.0,0,0,0,0,0,0,0,2,0,0,2,1
2654,55343,YPEupTuOqSGieSSneZcv3AcUcSBCtbGY,7GRhBDsirIGkRZBtSMEzNTyDr2JQm4xx,6,6,1,6,1,1,2,0,17,2.4285714285714284,1,0.0,3,1,5,1,3,1,1,2,0,10,7,1
2655,55346,7bnGjPq4sg9VhmEEoEqqXHNgeEpEuUDV,SpATywNh6bZuzm8s1ceuBUnMUAeoAHHw,15,14,5,12,3,21,5,2,62,8.857142857142858,2,0.0,3,5,12,3,11,21,0,5,2,23,39,0
2656,55350,FbrKChJI6NE19RCUX3nZg6RKzVDriIZa,7GRhBDsirIGkRZBtSMEzNTyDr2JQm4xx,1,0,0,0,0,0,1,0,1,0.14285714285714285,1,0.0,0,0,0,0,0,0,0,1,0,0,1,1
2657,55409,LuPgMCIdX2ugHzDAngaEsA394qOat0id,7GRhBDsirIGkRZBtSMEzNTyDr2JQm4xx,4,6,1,0,1,0,1,0,9,1.2857142857142858,1,0.0,3,1,0,1,3,0,0,1,0,5,4,1
2658,55425,iDV5to1cYevkdTWvpbQHbqC1rLSJxp3m,SpATywNh6bZuzm8s1ceuBUnMUAeoAHHw,6,4,1,0,1,0,4,0,10,1.4285714285714286,1,0.0,0,1,0,1,4,0,0,4,0,2,8,0
2659,55427,n5fmXY7W3OsRId8yMehdsktfc1GCY6un,7GRhBDsirIGkRZBtSMEzNTyDr2JQm4xx,16,20,10,34,3,12,4,0,83,11.857142857142858,1,0.0,6,10,28,3,14,12,6,4,0,47,36,0
2660,55475,mDHr8WvVVX9KSvXMqxtLvZ6vP4uuNF6E,SpATywNh6bZuzm8s1ceuBUnMUAeoAHHw,13,25,1,23,0,7,5,1,62,8.857142857142858,1,0.0,17,1,19,0,8,7,4,5,1,37,25,1
2661,55483,C4q4gNQYEpjKh7pq1qjN8i3L7uSpUX9d,A3fsA9Zfv1X2fVEQhTw51lKENdNrEqT3,13,10,7,0,6,0,2,0,25,3.5714285714285716,1,0.0,0,7,0,6,10,0,0,2,0,13,12,0
2662,55489,vCm3LfZ9M6wOLWnqELTZFsk5hnCTaEbi,SpATywNh6bZuzm8s1ceuBUnMUAeoAHHw,9,18,3,0,1,0,7,1,30,4.285714285714286,2,0.0,6,3,0,1,12,0,0,7,1,10,20,0
2663,55531,icc28ggRdRmZu2r1UuNBMEMav6yv5QTB,7GRhBDsirIGkRZBtSMEzNTyDr2JQm4xx,1,0,0,0,0,0,1,0,1,0.14285714285714285,1,0.0,0,0,0,0,0,0,0,1,0,0,1,1
2664,55532,vrKNA3eEZxLntZreFchejbQ8UgnPaTUE,RXDvfPUBYFlVdlueBFbLW0mhhAyGEqpt,16,12,7,6,4,0,3,0,32,4.571428571428571,1,0.0,4,7,6,4,8,0,0,3,0,21,11,1
2665,55536,lVM3D8yPmd62Fdb29hI2YI0VPwlNvI4t,7GRhBDsirIGkRZBtSMEzNTyDr2JQm4xx,5,2,1,0,1,0,3,0,7,1.0,2,0.0,0,1,0,1,2,0,0,3,0,2,5,1
2666,55556,Pg0gXikYsatKV6C2YLhl2LUFEvJuK423,SpATywNh6bZuzm8s1ceuBUnMUAeoAHHw,1,0,0,0,0,0,1,0,1,0.14285714285714285,1,0.0,0,0,0,0,0,0,0,1,0,0,1,1
2667,55557,FELnhQR0c7GZZX82ioYJEZsqujOrfyf7,SpATywNh6bZuzm8s1ceuBUnMUAeoAHHw,6,2,1,0,1,3,3,0,10,1.4285714285714286,1,0.0,0,1,0,1,2,3,0,3,0,2,8,1
2668,55560,NGCjg1L5IFyOkl1pLM5r5gRwzJYb60Ux,7GRhBDsirIGkRZBtSMEzNTyDr2JQm4xx,1,0,0,0,0,0,2,0,2,0.2857142857142857,1,0.0,0,0,0,0,0,0,0,2,0,0,2,1
2669,55591,9t2KBUQ5GiAw5lDqGOd0BuKNW0LVvTVG,A3fsA9Zfv1X2fVEQhTw51lKENdNrEqT3,42,26,18,64,13,0,5,0,126,18.0,2,0.0,2,18,55,13,24,0,9,5,0,88,38,0
2670,55593,9t2KBUQ5GiAw5lDqGOd0BuKNW0LVvTVG,bWdj2GDclj5ofokWjzoa5jAwMkxCykd6,19,36,16,50,7,0,11,1,121,17.285714285714285,3,0.0,12,16,46,7,24,0,4,11,1,81,40,0
2671,55624,QOwpzKqFZ32bfGgNkKoMFA0kfbklA5vW,7GRhBDsirIGkRZBtSMEzNTyDr2JQm4xx,6,6,4,0,1,0,3,0,14,2.0,2,0.0,0,4,0,1,6,0,0,3,0,5,9,1
2672,55637,ykaUPJW4Nc9r2mv4b25QxgdHgIcQ63RQ,7GRhBDsirIGkRZBtSMEzNTyDr2JQm4xx,2,0,0,0,0,0,2,0,2,0.2857142857142857,1,0.0,0,0,0,0,0,0,0,2,0,0,2,1
2673,55661,KKjjlHFWeLSseHD90tBUbNiE7bxXsPHK,A3fsA9Zfv1X2fVEQhTw51lKENdNrEqT3,1,0,0,0,0,0,1,0,1,0.14285714285714285,1,0.0,0,0,0,0,0,0,0,1,0,0,1,1
2674,55667,8ZhpSkXuKXWxDMEbryu3zVTkh7o5swmt,SpATywNh6bZuzm8s1ceuBUnMUAeoAHHw,6,9,1,0,0,0,6,0,16,2.2857142857142856,1,0.0,5,1,0,0,4,0,0,6,0,6,10,1
2675,55692,y2EdvoA45jiUkTJcqU8mJ6KiT8yLZUjw,SpATywNh6bZuzm8s1ceuBUnMUAeoAHHw,5,3,1,0,0,3,3,0,10,1.4285714285714286,1,0.0,0,1,0,0,3,3,0,3,0,1,9,1
2676,55696,jaCcwHYnVHfV5mSQjy3wPbHHjpbiHJ5a,SpATywNh6bZuzm8s1ceuBUnMUAeoAHHw,15,29,3,16,2,0,20,0,70,10.0,2,0.0,6,3,15,2,23,0,1,20,0,26,44,0
2677,55699,HFO33lcsFKBDjSdg8KE5lGTCABOqytNM,RXDvfPUBYFlVdlueBFbLW0mhhAyGEqpt,10,8,4,0,3,1,3,1,20,2.857142857142857,1,0.0,3,4,0,3,5,1,0,3,1,10,10,0
2678,55738,rCrf0hc0QRrKoK9w9R5Z8IvJlhGyjTyy,bWdj2GDclj5ofokWjzoa5jAwMkxCykd6,17,22,5,70,3,15,8,1,124,17.714285714285715,2,0.0,4,5,64,3,18,15,6,8,1,76,48,1
2679,55761,gEZOnwjA41tJvFOifXsWWDx9ePmBM5Kk,7GRhBDsirIGkRZBtSMEzNTyDr2JQm4xx,2,0,0,0,0,0,2,0,2,0.2857142857142857,1,0.0,0,0,0,0,0,0,0,2,0,0,2,1
2680,55775,ZvdQafaVNGdhweIxI9FbVGKoGVxZDXFe,7GRhBDsirIGkRZBtSMEzNTyDr2JQm4xx,2,0,0,0,0,0,3,0,3,0.42857142857142855,2,0.0,0,0,0,0,0,0,0,3,0,0,3,1
2681,55777,aQ6WrdDe9pTNwVW3vmaMOs1pxy5r3Dxa,bWdj2GDclj5ofokWjzoa5jAwMkxCykd6,11,7,4,78,1,10,5,0,105,15.0,3,0.0,1,4,76,1,6,10,2,5,0,82,23,0
2682,55780,i5WDkhlf7rrVPmbQxsFTG1gowMYshvKj,bWdj2GDclj5ofokWjzoa5jAwMkxCykd6,8,7,3,8,3,0,1,0,22,3.142857142857143,1,0.0,3,3,8,3,4,0,0,1,0,17,5,1
2683,55820,LdhLlSD36AR268yKf0v6JE8vG5XYPHSF,SpATywNh6bZuzm8s1ceuBUnMUAeoAHHw,6,3,2,0,1,0,2,0,8,1.1428571428571428,1,0.0,0,2,0,1,3,0,0,2,0,3,5,1
2684,55846,q7ZtC6SevF8q9PKkXEaBMzUJ37xWhTDz,SpATywNh6bZuzm8s1ceuBUnMUAeoAHHw,17,22,8,19,3,16,12,0,80,11.428571428571429,4,0.0,6,8,16,3,16,16,3,12,0,33,47,1
2685,55865,ZEHkvN1JnR5aRFAd5UGefALeV7OHXWFP,7GRhBDsirIGkRZBtSMEzNTyDr2JQm4xx,34,68,16,30,13,14,15,2,158,22.571428571428573,3,0.0,34,16,29,13,34,14,1,15,2,92,66,1
2686,55877,GPe5tDvCMFa0yvoGbU7FbSxYbtu5eayz,SpATywNh6bZuzm8s1ceuBUnMUAeoAHHw,16,25,12,16,3,2,13,1,72,10.285714285714286,4,0.0,4,12,14,3,21,2,2,13,1,33,39,0
2687,55936,Uh4whLcptRuZuhdtjFruuYJY4YmOeYlV,SpATywNh6bZuzm8s1ceuBUnMUAeoAHHw,10,10,1,16,1,0,1,0,29,4.142857142857143,1,0.0,2,1,14,1,8,0,2,1,0,18,11,0
2688,55948,fOZTYKShrDEPywLsvnOq8r6y0esJP04d,G8EPVSXsOYB5YQWZGiz1aVq5Pgr2GrQu,22,73,26,26,17,1,10,1,154,22.0,2,0.0,37,26,20,17,36,1,6,10,1,100,54,0
2689,55969,Qs9VQJkriDZBH3FlG0bgTumvMa49MEaO,SpATywNh6bZuzm8s1ceuBUnMUAeoAHHw,2,0,0,0,0,2,1,0,3,0.42857142857142855,1,0.0,0,0,0,0,0,2,0,1,0,0,3,1
2690,56001,7EU7vMf2b4Xv6MdI3zbAqQNQTiRVSvYt,bWdj2GDclj5ofokWjzoa5jAwMkxCykd6,5,10,0,0,0,0,3,0,13,1.8571428571428572,2,0.0,0,0,0,0,10,0,0,3,0,0,13,0
2691,56010,hJo1MgKiPZFXuH2ko6hqPTd9dbjMQKDO,A3fsA9Zfv1X2fVEQhTw51lKENdNrEqT3,13,9,6,18,1,0,3,0,37,5.285714285714286,2,0.0,0,6,15,1,9,0,3,3,0,22,15,0
2692,56032,Y7LsqgQDUbWtXalaq4LkDEQKBlxOaCL3,A3fsA9Zfv1X2fVEQhTw51lKENdNrEqT3,7,8,3,0,2,0,1,0,14,2.0,1,0.0,1,3,0,2,7,0,0,1,0,6,8,1
2693,56040,420Gm2AWh0nImDTapBba1KojOp3noScY,SpATywNh6bZuzm8s1ceuBUnMUAeoAHHw,14,18,1,12,0,0,16,0,47,6.714285714285714,3,0.0,2,1,11,0,16,0,1,16,0,14,33,0
2694,56103,h7RW3AuXPtbIdr6MfEtTA3AoeBZHMuDe,SpATywNh6bZuzm8s1ceuBUnMUAeoAHHw,16,34,19,20,6,0,15,0,94,13.428571428571429,4,0.0,6,19,16,6,28,0,4,15,0,47,47,1
2695,56184,ndLSZuWw3bhlmRMZV7snp1VzVKaJfO1o,7GRhBDsirIGkRZBtSMEzNTyDr2JQm4xx,1,0,0,0,0,0,1,0,1,0.14285714285714285,1,0.0,0,0,0,0,0,0,0,1,0,0,1,1
2696,56202,xbYSqp0T7Uu69VoCNyfTCvQcS3HV3UeU,SpATywNh6bZuzm8s1ceuBUnMUAeoAHHw,15,52,21,20,1,54,34,6,188,26.857142857142858,6,0.0,12,21,16,1,40,54,4,34,6,50,138,1
2697,56223,7qDBI7pI0SQ1bfBBjf175GzJeqNA6CgO,7GRhBDsirIGkRZBtSMEzNTyDr2JQm4xx,5,2,1,0,1,0,2,0,6,0.8571428571428571,1,0.0,0,1,0,1,2,0,0,2,0,2,4,1
2698,56226,ok15ssTMon44FKUffK29mVEN6xTGU7F9,SpATywNh6bZuzm8s1ceuBUnMUAeoAHHw,10,6,4,6,3,0,1,0,20,2.857142857142857,1,0.0,1,4,5,3,5,0,1,1,0,13,7,1
2699,56244,XKteUTBXNdDfK3DTLCpAPdVFmdrv3Rx5,7GRhBDsirIGkRZBtSMEzNTyDr2JQm4xx,13,27,1,0,0,0,5,2,35,5.0,1,0.0,4,1,0,0,23,0,0,5,2,5,30,1
2700,56321,YQloiHp4EDEAnQ7UnBm1Re3dyFVVFj8Z,SpATywNh6bZuzm8s1ceuBUnMUAeoAHHw,12,70,2,30,0,23,5,0,130,18.571428571428573,2,0.0,34,2,23,0,36,23,7,5,0,59,71,0
2701,56333,CwAitLaYuWheNSIoTgEZfJ56lAJf0HG8,7GRhBDsirIGkRZBtSMEzNTyDr2JQm4xx,17,21,9,25,8,0,6,0,69,9.857142857142858,2,0.0,10,9,22,8,11,0,3,6,0,49,20,1
2702,56354,EKjzbhHjXWCVYpc4LH9ESzstcF131j56,7GRhBDsirIGkRZBtSMEzNTyDr2JQm4xx,1,0,0,0,0,0,1,0,1,0.14285714285714285,1,0.0,0,0,0,0,0,0,0,1,0,0,1,1
2703,56366,CQ9z29HXcNaQxMUuAJ5s2uvH0fLzGYjv,SpATywNh6bZuzm8s1ceuBUnMUAeoAHHw,11,16,7,18,0,1,5,1,48,6.857142857142857,1,0.0,4,7,15,0,12,1,3,5,1,26,22,1
2704,56398,aGbKep26uuguTzwAUYDcwjqS1RQNroF5,SpATywNh6bZuzm8s1ceuBUnMUAeoAHHw,15,22,7,22,3,0,5,1,60,8.571428571428571,1,0.0,8,7,19,3,14,0,3,5,1,37,23,1
2705,56418,1yk3ITtkCTeBgpvC46EyEEfYcyKWD7Qc,SpATywNh6bZuzm8s1ceuBUnMUAeoAHHw,13,10,5,15,3,2,2,0,37,5.285714285714286,1,0.0,4,5,13,3,6,2,2,2,0,25,12,0
2706,56423,ouOARkjMonPxhUKVUmTMgEZ4vGcTZcAk,7GRhBDsirIGkRZBtSMEzNTyDr2JQm4xx,23,18,0,68,0,0,2,0,88,12.571428571428571,1,0.0,9,0,67,0,9,0,1,2,0,76,12,1
2707,56444,bUYPIrKUhpdtG1KH0Y9GXp4xZk1AgdLJ,SpATywNh6bZuzm8s1ceuBUnMUAeoAHHw,4,1,1,0,0,2,2,0,6,0.8571428571428571,1,0.0,0,1,0,0,1,2,0,2,0,1,5,0
2708,56445,UalIk08w9p6VGqWfZ6drUaQL5GhjEzcw,SpATywNh6bZuzm8s1ceuBUnMUAeoAHHw,6,1,0,0,0,1,4,1,7,1.0,1,0.0,0,0,0,0,1,1,0,4,1,0,7,1
2709,56446,TVQrQzdOFJxL0otAPBsN1HXNpNNlOLWm,7GRhBDsirIGkRZBtSMEzNTyDr2JQm4xx,24,41,0,84,3,0,3,0,131,18.714285714285715,2,0.0,27,0,74,3,14,0,10,3,0,104,27,1
2710,56490,kqS8BwWN9R1093oeblGkvtCsQJ68Gh0G,SpATywNh6bZuzm8s1ceuBUnMUAeoAHHw,16,88,43,29,22,20,16,0,218,31.142857142857142,6,0.0,13,43,22,22,75,20,7,16,0,100,118,0
2711,56494,mSe1A4ptQkbf64uqFepueFInmdXgPhYy,SpATywNh6bZuzm8s1ceuBUnMUAeoAHHw,7,4,2,0,1,0,6,0,13,1.8571428571428572,1,0.0,0,2,0,1,4,0,0,6,0,3,10,1
2712,56495,LMrnY95OXOcKLbPJNFk6CNnUTJJC01Mr,7GRhBDsirIGkRZBtSMEzNTyDr2JQm4xx,1,0,0,0,0,0,1,0,1,0.14285714285714285,1,0.0,0,0,0,0,0,0,0,1,0,0,1,1
2713,56514,57DmCkxeT4CodU6tDrBCDXqGpXQ0D1sF,A3fsA9Zfv1X2fVEQhTw51lKENdNrEqT3,5,4,2,0,1,0,4,0,11,1.5714285714285714,2,0.0,0,2,0,1,4,0,0,4,0,3,8,0
2714,56536,v3Nj91qeWhwVYxgQExYL9jO1Rd2uR5bo,SpATywNh6bZuzm8s1ceuBUnMUAeoAHHw,5,2,1,0,1,0,2,0,6,0.8571428571428571,1,0.0,0,1,0,1,2,0,0,2,0,2,4,1
2715,56615,ktKfaRtFOnFJdZMcfSCqSP14OG6TxlMY,SpATywNh6bZuzm8s1ceuBUnMUAeoAHHw,15,16,4,16,3,0,6,0,45,6.428571428571429,1,0.0,2,4,16,3,14,0,0,6,0,25,20,0
2716,56621,ma8nscMCD0ftKjbxujos5nzHFFtaZMo4,A3fsA9Zfv1X2fVEQhTw51lKENdNrEqT3,7,6,2,0,1,0,4,0,13,1.8571428571428572,2,0.0,0,2,0,1,6,0,0,4,0,3,10,0
2717,56633,NGQ6HXbhxwBlJxikVxca5noX2u8xI9AV,A3fsA9Zfv1X2fVEQhTw51lKENdNrEqT3,40,31,14,76,10,0,6,0,137,19.571428571428573,2,0.0,2,14,61,10,29,0,15,6,0,87,50,0
2718,56683,MbewcgzgToNhp9B6eaNSolme5R0M2nkY,A3fsA9Zfv1X2fVEQhTw51lKENdNrEqT3,1,0,0,0,0,0,1,0,1,0.14285714285714285,1,0.0,0,0,0,0,0,0,0,1,0,0,1,1
2719,56696,ReIy3etnMmZBVQ3CosU4FbzEF29F9nHU,SpATywNh6bZuzm8s1ceuBUnMUAeoAHHw,12,16,0,10,0,0,6,0,32,4.571428571428571,4,0.0,6,0,10,0,10,0,0,6,0,16,16,0
2720,56715,6iyCCTAEdDUFtgP0yXcCVROgqrKuAsJY,SpATywNh6bZuzm8s1ceuBUnMUAeoAHHw,14,14,10,18,4,2,6,0,54,7.714285714285714,2,0.0,2,10,15,4,12,2,3,6,0,31,23,0
2721,56725,Bxz1zTHFCCx9o1kJA9B0Pzm3PnmqKxr5,SpATywNh6bZuzm8s1ceuBUnMUAeoAHHw,9,13,9,0,7,0,2,0,31,4.428571428571429,1,0.0,1,9,0,7,12,0,0,2,0,17,14,1
2722,56791,1G2HPMj7bCJEDZxxbF8ae2kPQCHvH8vB,bWdj2GDclj5ofokWjzoa5jAwMkxCykd6,5,5,1,0,1,0,1,0,8,1.1428571428571428,1,0.0,0,1,0,1,5,0,0,1,0,2,6,1
2723,56806,1ZeLZDjvvDkWWsoonk2q4KdJg9fzmSLS,SpATywNh6bZuzm8s1ceuBUnMUAeoAHHw,8,16,0,4,0,0,3,0,23,3.2857142857142856,2,0.0,1,0,3,0,15,0,1,3,0,4,19,1
2724,56817,qzripbhm6sAPdZP3rld8n0avyAjcFNv4,G8EPVSXsOYB5YQWZGiz1aVq5Pgr2GrQu,4,2,1,0,1,0,1,0,5,0.7142857142857143,1,0.0,0,1,0,1,2,0,0,1,0,2,3,0
2725,56834,i86rWeuy3cBtKeVeDiyieBp3ovKTOVnd,SpATywNh6bZuzm8s1ceuBUnMUAeoAHHw,13,16,8,0,5,0,8,1,38,5.428571428571429,2,0.0,1,8,0,5,15,0,0,8,1,14,24,1
2726,56864,y64BqR5f4fJBfwxF4aLt14ViHkvnjGLs,A3fsA9Zfv1X2fVEQhTw51lKENdNrEqT3,32,17,8,50,3,8,6,0,92,13.142857142857142,2,0.0,3,8,48,3,14,8,2,6,0,62,30,1
2727,56875,T8TKNQciNYxyZa02JNR1WAwQ2Y5qXjum,G8EPVSXsOYB5YQWZGiz1aVq5Pgr2GrQu,20,38,20,22,5,1,17,2,105,15.0,4,0.0,6,20,18,5,32,1,4,17,2,49,56,0
2728,56931,T6EWQ7jVP89JlHzj41KN1gEtGYevpSQM,bWdj2GDclj5ofokWjzoa5jAwMkxCykd6,15,18,10,10,4,9,16,2,69,9.857142857142858,4,0.0,3,10,9,4,15,9,1,16,2,26,43,1
2729,56963,GKzw24uGItaRbrNpOwWtTqnRbaZohHHZ,SpATywNh6bZuzm8s1ceuBUnMUAeoAHHw,17,50,23,20,8,38,26,3,168,24.0,3,0.0,18,23,17,8,32,38,3,26,3,66,102,0
2730,56974,ca0FiReQbSJ11H1fqXLWoWnOvLbBbR3V,SpATywNh6bZuzm8s1ceuBUnMUAeoAHHw,15,22,11,0,4,7,8,1,53,7.571428571428571,2,0.0,7,11,0,4,15,7,0,8,1,22,31,0
2731,57048,I7IIrHAh1LzzCf8lcvI92o8deFulzAh8,G8EPVSXsOYB5YQWZGiz1aVq5Pgr2GrQu,1,0,0,0,0,0,1,0,1,0.14285714285714285,1,0.0,0,0,0,0,0,0,0,1,0,0,1,1
2732,57049,I7IIrHAh1LzzCf8lcvI92o8deFulzAh8,RXDvfPUBYFlVdlueBFbLW0mhhAyGEqpt,1,0,0,0,0,0,1,0,1,0.14285714285714285,1,0.0,0,0,0,0,0,0,0,1,0,0,1,1
2733,57131,3CLlQYPJzaDqTsMDCyIWfYEpsKmi9sXD,G8EPVSXsOYB5YQWZGiz1aVq5Pgr2GrQu,17,33,9,10,7,3,8,1,71,10.142857142857142,2,0.0,18,9,6,7,15,3,4,8,1,40,31,0
2734,57193,v6sJocXlJFeoDG1nXrmoTeUih19304GZ,SpATywNh6bZuzm8s1ceuBUnMUAeoAHHw,10,14,0,9,0,0,4,0,27,3.857142857142857,2,0.0,2,0,8,0,12,0,1,4,0,10,17,1
2735,57225,Ct3eFzamQizfpV2I2rZSBKqavcN2kzGI,bWdj2GDclj5ofokWjzoa5jAwMkxCykd6,3,2,1,0,0,0,1,0,4,0.5714285714285714,1,0.0,0,1,0,0,2,0,0,1,0,1,3,1
2736,57274,a91ewPLjlp1X8KqwrnZISs7xgERRXuh7,SpATywNh6bZuzm8s1ceuBUnMUAeoAHHw,12,19,3,8,1,6,15,0,52,7.428571428571429,4,0.0,0,3,6,1,19,6,2,15,0,10,42,0
2737,57275,2Al3Sg2oc4NVlws5jTNzQZvd3PHAcnAl,SpATywNh6bZuzm8s1ceuBUnMUAeoAHHw,9,8,3,0,3,2,2,0,18,2.5714285714285716,1,0.0,1,3,0,3,7,2,0,2,0,7,11,1
2738,57289,JfftjOGdDbpgbrupi0Gwr899R0jzXikJ,SpATywNh6bZuzm8s1ceuBUnMUAeoAHHw,9,5,4,0,4,0,2,0,15,2.142857142857143,1,0.0,0,4,0,4,5,0,0,2,0,8,7,0
2739,57310,amNosdi6Uiilljdy8esSBA3F29NKPLUW,A3fsA9Zfv1X2fVEQhTw51lKENdNrEqT3,13,12,8,0,3,1,9,0,33,4.714285714285714,3,0.0,0,8,0,3,12,1,0,9,0,11,22,1
2740,57348,YPxQmDfYnmHgiT7CBa1xK3KUyMZAnQfd,SpATywNh6bZuzm8s1ceuBUnMUAeoAHHw,15,7,4,6,3,1,5,1,27,3.857142857142857,1,0.0,2,4,6,3,5,1,0,5,1,15,12,1
2741,57385,XJf8gYhDJm1hrkVJvLQ4HKEnvPd3mIMq,SpATywNh6bZuzm8s1ceuBUnMUAeoAHHw,12,13,0,9,0,1,4,0,27,3.857142857142857,2,0.0,2,0,9,0,11,1,0,4,0,11,16,0
2742,57421,xVSPiuldrfuaqB5x0wSqqh0RzPMsoNZK,SpATywNh6bZuzm8s1ceuBUnMUAeoAHHw,13,9,7,0,3,1,4,1,25,3.5714285714285716,3,0.0,0,7,0,3,9,1,0,4,1,10,15,0
2743,57477,5OgjW4RBhSCbfYx5XYwPp5mVp3N7l8JT,SpATywNh6bZuzm8s1ceuBUnMUAeoAHHw,14,25,17,7,0,11,41,3,104,14.857142857142858,5,0.0,2,17,7,0,23,11,0,41,3,26,78,1
2744,57497,h8ApK52PAIR0nuhXQv52hCsI8LxUHnXl,SpATywNh6bZuzm8s1ceuBUnMUAeoAHHw,13,18,0,15,0,0,4,1,38,5.428571428571429,1,0.0,6,0,12,0,12,0,3,4,1,18,20,1
2745,57540,q9BQrPVmTGVLXUZRKxvQUgkPlzz6bi8e,SpATywNh6bZuzm8s1ceuBUnMUAeoAHHw,7,8,4,0,4,0,2,0,18,2.5714285714285716,1,0.0,0,4,0,4,8,0,0,2,0,8,10,1
2746,57564,eAArxLyCThtu9N3Mv8rQculKbGSa66j9,bWdj2GDclj5ofokWjzoa5jAwMkxCykd6,7,7,2,22,1,0,5,0,37,5.285714285714286,2,0.0,3,2,20,1,4,0,2,5,0,26,11,1
2747,57568,73lhhrOcE2srJj5BkIzSweWSnQRZBT2o,SpATywNh6bZuzm8s1ceuBUnMUAeoAHHw,11,27,15,6,0,1,8,0,57,8.142857142857142,6,0.0,4,15,6,0,23,1,0,8,0,25,32,1
2748,57594,OOsRSTJd6U7cE43XHk99M9ofvrefufrh,A3fsA9Zfv1X2fVEQhTw51lKENdNrEqT3,3,3,1,0,0,0,1,0,5,0.7142857142857143,1,0.0,0,1,0,0,3,0,0,1,0,1,4,0
2749,57617,NVzsLV2hJQHxCBnLyaDpT9HrhRSWUOfa,RXDvfPUBYFlVdlueBFbLW0mhhAyGEqpt,32,65,28,34,11,2,16,3,159,22.714285714285715,2,0.0,14,28,33,11,51,2,1,16,3,86,73,1
2750,57636,D5gDQ8hFb4klemeBiodWmMPe9KIvqw9O,A3fsA9Zfv1X2fVEQhTw51lKENdNrEqT3,4,6,0,0,0,0,4,0,10,1.4285714285714286,1,0.0,0,0,0,0,6,0,0,4,0,0,10,1
2751,57712,p8eEbMqW5LefqN7qPq07exxdOPrIZY20,SpATywNh6bZuzm8s1ceuBUnMUAeoAHHw,14,17,7,14,5,0,4,0,47,6.714285714285714,2,0.0,4,7,14,5,13,0,0,4,0,30,17,1
2752,57731,VfWuQS8OTjJmyvWxq07hV2rzKtyu1LCX,SpATywNh6bZuzm8s1ceuBUnMUAeoAHHw,11,10,6,6,0,0,3,0,25,3.5714285714285716,1,0.0,2,6,6,0,8,0,0,3,0,14,11,0
2753,57735,uhbUne0Zqx7l0LKNWrxxR44WistJmxKI,SpATywNh6bZuzm8s1ceuBUnMUAeoAHHw,4,2,0,0,0,0,2,0,4,0.5714285714285714,1,0.0,0,0,0,0,2,0,0,2,0,0,4,1
2754,57770,TiyssQ1xBxRpSE8M84hoblpjLNawoMPM,A3fsA9Zfv1X2fVEQhTw51lKENdNrEqT3,12,7,5,0,4,0,5,0,21,3.0,1,0.0,0,5,0,4,7,0,0,5,0,9,12,1
2755,57797,bZSiNUbAIuydDBd77IMAJ15Hy6k2A1kT,A3fsA9Zfv1X2fVEQhTw51lKENdNrEqT3,2,0,0,0,0,0,2,0,2,0.2857142857142857,1,0.0,0,0,0,0,0,0,0,2,0,0,2,0
2756,57814,qdfZW2ffZy8gfDfLseVXmzjU3pjHztuR,SpATywNh6bZuzm8s1ceuBUnMUAeoAHHw,11,6,4,11,2,1,6,1,31,4.428571428571429,1,0.0,1,4,10,2,5,1,1,6,1,17,14,1
2757,57823,nTCOXKuQTHlcdJy5DLRFkg6Zh0x7ymZf,SpATywNh6bZuzm8s1ceuBUnMUAeoAHHw,12,20,0,18,0,3,4,0,45,6.428571428571429,1,0.0,9,0,15,0,11,3,3,4,0,24,21,0
2758,57865,6R0qSS2YfDD3HGMPKZeKRUJLbFOIEhNG,SpATywNh6bZuzm8s1ceuBUnMUAeoAHHw,6,13,1,0,0,0,2,0,16,2.2857142857142856,1,0.0,0,1,0,0,13,0,0,2,0,1,15,0
2759,57921,LJN1NW4KDrkfGUEkF9SJPSL4rdPIFcim,RXDvfPUBYFlVdlueBFbLW0mhhAyGEqpt,8,6,4,0,1,0,5,0,16,2.2857142857142856,2,0.0,0,4,0,1,6,0,0,5,0,5,11,1
2760,57923,g6dPr9Qj9PAMVLVyPAgx25XT3ANwjQos,A3fsA9Zfv1X2fVEQhTw51lKENdNrEqT3,33,11,9,48,8,0,2,0,78,11.142857142857142,1,0.0,1,9,46,8,10,0,2,2,0,64,14,1
2761,58064,rtg3Ki4vk14kI9MkEBE0pkOCAO2AnCnU,A3fsA9Zfv1X2fVEQhTw51lKENdNrEqT3,6,5,2,0,1,0,2,0,10,1.4285714285714286,2,0.0,0,2,0,1,5,0,0,2,0,3,7,0
2762,58067,pAWmot8vJjNkDuzTDPJSBxqvPejAjgVS,RXDvfPUBYFlVdlueBFbLW0mhhAyGEqpt,6,3,2,0,2,0,1,0,8,1.1428571428571428,1,0.0,0,2,0,2,3,0,0,1,0,4,4,1
2763,58072,QWCcSRplc8XLohtOnjfleuw3Kl55Wt2l,G8EPVSXsOYB5YQWZGiz1aVq5Pgr2GrQu,11,10,6,0,4,0,1,0,21,3.0,1,0.0,0,6,0,4,10,0,0,1,0,10,11,1
2764,58081,VdrjT29t1tCYeqV5Pjs9K79bb5dKTQSe,SpATywNh6bZuzm8s1ceuBUnMUAeoAHHw,8,4,2,0,2,0,4,0,12,1.7142857142857142,1,0.0,0,2,0,2,4,0,0,4,0,4,8,1
2765,58088,ohNbQfFfbGDEMVmhwhRAFtQhn1peVJYy,SpATywNh6bZuzm8s1ceuBUnMUAeoAHHw,14,9,5,16,3,3,2,0,38,5.428571428571429,1,0.0,3,5,14,3,6,3,2,2,0,25,13,1
2766,58102,RPQvIQfjeayIRS4PyDyrIytbJ9ZHNktA,SpATywNh6bZuzm8s1ceuBUnMUAeoAHHw,16,16,6,6,3,5,6,1,43,6.142857142857143,1,0.0,9,6,6,3,7,5,0,6,1,24,19,1
2767,58128,th3jtP88bHr6FB2R2HdadrOKTixMDxTi,SpATywNh6bZuzm8s1ceuBUnMUAeoAHHw,4,0,0,0,0,0,5,1,6,0.8571428571428571,1,0.0,0,0,0,0,0,0,0,5,1,0,6,1
2768,58242,JaIi02fnjAZfoUxjYtpyJ7uZYWKdC5yF,RXDvfPUBYFlVdlueBFbLW0mhhAyGEqpt,19,43,2,17,3,10,16,0,91,13.0,2,0.0,4,2,17,3,39,10,0,16,0,26,65,1
2769,58255,zzLagpOecSivjjn7PNG5qmEhwa4PmnNX,SpATywNh6bZuzm8s1ceuBUnMUAeoAHHw,13,20,8,14,4,0,5,0,51,7.285714285714286,2,0.0,9,8,12,4,11,0,2,5,0,33,18,1
2770,58286,y6i20DJpIul6LihHwgZcWxbdAap5GcBP,A3fsA9Zfv1X2fVEQhTw51lKENdNrEqT3,15,16,7,0,3,14,13,1,54,7.714285714285714,3,0.0,2,7,0,3,14,14,0,13,1,12,42,1
2771,58291,PCPmtsqEtkHe7GooXQswbqyH8cnukgFn,G8EPVSXsOYB5YQWZGiz1aVq5Pgr2GrQu,27,24,0,42,0,28,8,1,103,14.714285714285714,1,0.0,11,0,32,0,13,28,10,8,1,43,60,0
2772,58300,uQw9hBSE2Dk9ZRkbmlhR0YJ8RRLoEt0U,SpATywNh6bZuzm8s1ceuBUnMUAeoAHHw,11,8,1,10,0,0,2,0,21,3.0,1,0.0,2,1,10,0,6,0,0,2,0,13,8,1
2773,58316,GfppdBt6zqP8G2m8ukjaahHhJ4ewTb0w,SpATywNh6bZuzm8s1ceuBUnMUAeoAHHw,12,31,2,14,1,1,4,0,53,7.571428571428571,3,0.0,6,2,14,1,25,1,0,4,0,23,30,0
2774,58357,OdMr7dE5UlAme9Tp979vREBvY5CV50po,A3fsA9Zfv1X2fVEQhTw51lKENdNrEqT3,41,18,11,50,9,0,2,0,90,12.857142857142858,1,0.0,3,11,46,9,15,0,4,2,0,69,21,0
2775,58359,czKChsqaxfwVoznY2WnWYH2vLIXb6X34,bWdj2GDclj5ofokWjzoa5jAwMkxCykd6,4,4,0,0,0,0,2,0,6,0.8571428571428571,1,0.0,0,0,0,0,4,0,0,2,0,0,6,1
2776,58453,fgzbUfrTxXYCuiFYTG1cTemcEJUl36an,A3fsA9Zfv1X2fVEQhTw51lKENdNrEqT3,9,4,3,0,3,0,3,0,13,1.8571428571428572,2,0.0,0,3,0,3,4,0,0,3,0,6,7,1
2777,58524,T761UltC8HrAVgHTpcJuQFf7vNJ3Ud9J,A3fsA9Zfv1X2fVEQhTw51lKENdNrEqT3,8,8,4,0,2,0,2,0,16,2.2857142857142856,1,0.0,0,4,0,2,8,0,0,2,0,6,10,0
2778,58526,OgKWYLWF7k4jNyuIPtj4HfbaQ79kKNws,A3fsA9Zfv1X2fVEQhTw51lKENdNrEqT3,12,7,6,0,6,0,10,0,29,4.142857142857143,2,0.0,0,6,0,6,7,0,0,10,0,12,17,1
2779,58544,bpxaFadaQixJuWRVtAAq5miKiBM3zC6u,A3fsA9Zfv1X2fVEQhTw51lKENdNrEqT3,37,49,3,88,3,21,9,0,173,24.714285714285715,2,0.0,2,3,83,3,47,21,5,9,0,91,82,0
2780,58582,o0M6SOlciWGWtqkYLASaq6tS76D18V6N,SpATywNh6bZuzm8s1ceuBUnMUAeoAHHw,17,46,16,22,6,34,17,1,142,20.285714285714285,4,0.0,19,16,18,6,27,34,4,17,1,59,83,0
2781,58601,pIkx6nDAjTla5NYVEsjhMXOIu5zXDzmO,G8EPVSXsOYB5YQWZGiz1aVq5Pgr2GrQu,26,18,12,0,12,0,10,2,54,7.714285714285714,2,0.0,3,12,0,12,15,0,0,10,2,27,27,0
2782,58642,ALYZFAVviUOGzyN4znk46d3PmVgvtUAM,A3fsA9Zfv1X2fVEQhTw51lKENdNrEqT3,21,10,1,36,0,0,2,0,49,7.0,1,0.0,0,1,31,0,10,0,5,2,0,32,17,1
2783,58644,zWZdErlwOQ1yvd6vlyAltL2Balhdc8gj,G8EPVSXsOYB5YQWZGiz1aVq5Pgr2GrQu,53,72,43,172,19,45,17,1,369,52.714285714285715,4,0.0,13,43,145,19,59,45,27,17,1,220,149,0
2784,58675,jm31Z85lUKPglpGy76SHR0pRWJW0VhuU,SpATywNh6bZuzm8s1ceuBUnMUAeoAHHw,15,37,5,10,1,1,12,0,66,9.428571428571429,4,0.0,6,5,10,1,31,1,0,12,0,22,44,1
2785,58693,2AEx3J0dyYAsdnSPWbdrCmQApLqSYiKY,SpATywNh6bZuzm8s1ceuBUnMUAeoAHHw,18,32,17,10,3,12,13,2,89,12.714285714285714,2,0.0,10,17,8,3,22,12,2,13,2,38,51,0
2786,58800,irZDaKqT4KdxcZGgiOHoDpvTtZyUugWP,G8EPVSXsOYB5YQWZGiz1aVq5Pgr2GrQu,23,27,13,30,6,8,10,0,94,13.428571428571429,2,0.0,1,13,25,6,26,8,5,10,0,45,49,0
2787,58804,OUbh6hvaOJDp9RK7kgTBzzPmjzmkYhZF,SpATywNh6bZuzm8s1ceuBUnMUAeoAHHw,14,17,0,12,1,6,5,0,41,5.857142857142857,1,0.0,3,0,9,1,14,6,3,5,0,13,28,0
2788,58812,x2TXADDQJTDLVMnKDb6BhJyWEoYQjlQy,SpATywNh6bZuzm8s1ceuBUnMUAeoAHHw,14,25,0,14,1,6,5,0,51,7.285714285714286,2,0.0,11,0,11,1,14,6,3,5,0,23,28,1
2789,58849,9UxAqNYuBtvS2ppV37y5D8wZyoNAl3Em,SpATywNh6bZuzm8s1ceuBUnMUAeoAHHw,13,40,3,15,0,23,13,4,98,14.0,2,0.0,13,3,12,0,27,23,3,13,4,28,70,1
2790,58877,Hoitr98hXhrf7xDGgACEFamKhiarA3wg,SpATywNh6bZuzm8s1ceuBUnMUAeoAHHw,16,43,23,12,10,36,13,1,138,19.714285714285715,4,0.0,12,23,12,10,31,36,0,13,1,57,81,0
2791,58887,7wyfXvc1g99QNmXzEb4w8C1vE0Vi2bHm,RXDvfPUBYFlVdlueBFbLW0mhhAyGEqpt,15,27,12,0,6,1,6,0,52,7.428571428571429,3,0.0,0,12,0,6,27,1,0,6,0,18,34,0
2792,58937,BWQpUowEHGBDEzSf23lNUZVBPlEw3Sq1,SpATywNh6bZuzm8s1ceuBUnMUAeoAHHw,13,24,2,12,0,1,7,0,46,6.571428571428571,3,0.0,8,2,9,0,16,1,3,7,0,19,27,0
2793,59023,1zErz13s8fNQRVaEvkOtvw6bLhr23yB4,G8EPVSXsOYB5YQWZGiz1aVq5Pgr2GrQu,43,80,32,76,13,10,22,3,236,33.714285714285715,3,0.0,30,32,51,13,50,10,25,22,3,126,110,0
2794,59059,WyukafQHQxismOtYiPzoFkAc38hAOB09,SpATywNh6bZuzm8s1ceuBUnMUAeoAHHw,6,2,1,0,1,2,5,0,11,1.5714285714285714,2,0.0,0,1,0,1,2,2,0,5,0,2,9,0
2795,59112,SSR2C7GBXM7XyR67GN0wwOxiCuLYjW4G,SpATywNh6bZuzm8s1ceuBUnMUAeoAHHw,15,22,1,3,2,3,6,1,38,5.428571428571429,1,0.0,10,1,3,2,12,3,0,6,1,16,22,0
2796,59133,kqS8BwWN9R1093oeblGkvtCsQJ68Gh0G,A3fsA9Zfv1X2fVEQhTw51lKENdNrEqT3,4,3,1,0,1,0,2,0,7,1.0,1,0.0,0,1,0,1,3,0,0,2,0,2,5,1
2797,59172,jImHfNEIObE674KdIbKVj7cCJ4ufqzHJ,SpATywNh6bZuzm8s1ceuBUnMUAeoAHHw,9,21,10,0,3,59,8,0,101,14.428571428571429,3,0.0,2,10,0,3,19,59,0,8,0,15,86,0
2798,60074,Vve0UwhmiGWZN8bT2t4sC82sMWi2ZyY8,7GRhBDsirIGkRZBtSMEzNTyDr2JQm4xx,7,0,0,0,0,1,8,1,10,1.4285714285714286,1,0.0,0,0,0,0,0,1,0,8,1,0,10,1
2799,60210,wGqhUJlJ3fGYOW2r7IbwNL0CdAR0avoU,7GRhBDsirIGkRZBtSMEzNTyDr2JQm4xx,31,108,39,61,22,53,10,0,293,41.857142857142854,5,0.0,57,39,47,22,51,53,14,10,0,165,128,1
2800,60214,Y3uwxWCm13Ol5xozrT2GPjOPhBlC2kOq,7GRhBDsirIGkRZBtSMEzNTyDr2JQm4xx,16,25,6,2,9,0,2,0,44,6.285714285714286,1,0.0,4,6,2,9,21,0,0,2,0,21,23,1
2801,60229,4IJ56QlJSL8avuRQEkrBcEyhUIO3LIP3,7GRhBDsirIGkRZBtSMEzNTyDr2JQm4xx,30,75,26,58,18,5,6,0,188,26.857142857142858,2,0.0,42,26,45,18,33,5,13,6,0,131,57,1
2802,60241,n2vbSLePtnxy4AVvThroeNvlXpcTMINy,7GRhBDsirIGkRZBtSMEzNTyDr2JQm4xx,21,27,13,2,7,0,1,0,50,7.142857142857143,1,0.0,7,13,1,7,20,0,1,1,0,28,22,0
2803,60264,iSrdvAXagFyTWuVpDzl1vXqwXkCyI8Nx,7GRhBDsirIGkRZBtSMEzNTyDr2JQm4xx,2,0,0,0,0,0,3,0,3,0.42857142857142855,1,0.0,0,0,0,0,0,0,0,3,0,0,3,1
2804,60283,uRNJHauAxW10nQZrIpEU1nj0mhvBnDcR,7GRhBDsirIGkRZBtSMEzNTyDr2JQm4xx,5,3,1,0,1,1,3,0,9,1.2857142857142858,1,0.0,0,1,0,1,3,1,0,3,0,2,7,1
2805,60427,r3TtJNrYEPB9JfkbBp23luDTSVLZGHt2,7GRhBDsirIGkRZBtSMEzNTyDr2JQm4xx,37,89,4,38,10,32,14,1,188,26.857142857142858,5,0.0,37,4,34,10,52,32,4,14,1,85,103,0
2806,61087,GDHvw72iSHIz6VwsSteleP4praXBxk8h,7GRhBDsirIGkRZBtSMEzNTyDr2JQm4xx,18,15,0,18,2,9,11,5,60,8.571428571428571,2,0.0,8,0,15,2,7,9,3,11,5,25,35,1
2807,61604,X8nI71wgjvVnziT2GohIRTnyUeumIuGT,SpATywNh6bZuzm8s1ceuBUnMUAeoAHHw,17,21,12,18,6,38,12,2,109,15.571428571428571,3,0.0,2,12,15,6,19,38,3,12,2,35,74,0
2808,61609,0RRA0LeDh4nSJ7FMl9qY1fE7T0M4oANR,SpATywNh6bZuzm8s1ceuBUnMUAeoAHHw,13,17,2,13,0,2,7,1,42,6.0,1,0.0,6,2,13,0,11,2,0,7,1,21,21,0
2809,61634,PyaXrfJadEJJdtWYxd1SSz75aPVyhQhH,SpATywNh6bZuzm8s1ceuBUnMUAeoAHHw,13,15,0,13,0,3,6,0,37,5.285714285714286,2,0.0,5,0,12,0,10,3,1,6,0,17,20,0
2810,61638,lLutp8H3vKf6Z8olMEwVlKswK040AY6M,7GRhBDsirIGkRZBtSMEzNTyDr2JQm4xx,22,43,16,23,14,3,6,1,106,15.142857142857142,2,0.0,20,16,19,14,23,3,4,6,1,69,37,1
2811,61654,LYqZV37zE6nJxDsCo1hT04A5qKWsawBT,SpATywNh6bZuzm8s1ceuBUnMUAeoAHHw,17,30,16,17,6,13,35,1,118,16.857142857142858,4,0.0,5,16,14,6,25,13,3,35,1,41,77,0
2812,61703,1Ccev0ap5uQQlfggUCTp94lkg9qZetYO,SpATywNh6bZuzm8s1ceuBUnMUAeoAHHw,7,2,0,0,0,1,4,1,8,1.1428571428571428,1,0.0,0,0,0,0,2,1,0,4,1,0,8,1
2813,61713,MYsCU1zkMrWxPhV1b7wSL5LZIo1zGyhU,bWdj2GDclj5ofokWjzoa5jAwMkxCykd6,9,12,7,0,4,0,3,0,26,3.7142857142857144,3,0.0,2,7,0,4,10,0,0,3,0,13,13,0
2814,61732,NcracMTfiaTPMbO6SSDnt9CDc4SnvBs9,SpATywNh6bZuzm8s1ceuBUnMUAeoAHHw,5,2,1,0,1,0,2,0,6,0.8571428571428571,1,0.0,0,1,0,1,2,0,0,2,0,2,4,0
2815,61740,I9yi1jZjIznCPzP5fpMJEhPDMiUaetUu,SpATywNh6bZuzm8s1ceuBUnMUAeoAHHw,16,40,19,20,6,30,9,3,127,18.142857142857142,2,0.0,12,19,17,6,28,30,3,9,3,54,73,0
2816,61744,l30g3WB045lPyRkHzrw7l9v0SYLqOMWO,SpATywNh6bZuzm8s1ceuBUnMUAeoAHHw,17,39,14,28,3,7,10,2,103,14.714285714285714,4,0.0,12,14,23,3,27,7,5,10,2,52,51,0
2817,61759,fx9PEMItfmJUgx5YPFOnYPw9ZcUduuYm,SpATywNh6bZuzm8s1ceuBUnMUAeoAHHw,15,38,4,12,1,1,16,1,73,10.428571428571429,2,0.0,6,4,11,1,32,1,1,16,1,22,51,1
2818,61801,2we3WxltFBT1dd0FjP3YZ8iHf2xpHEei,SpATywNh6bZuzm8s1ceuBUnMUAeoAHHw,15,17,8,6,4,0,5,0,40,5.714285714285714,3,0.0,2,8,6,4,15,0,0,5,0,20,20,1
2819,61837,2yFrrfFKwmpyH7xPcC8i0UYFZJHtjntf,SpATywNh6bZuzm8s1ceuBUnMUAeoAHHw,16,29,14,22,7,45,14,1,132,18.857142857142858,4,0.0,7,14,18,7,22,45,4,14,1,46,86,0
2820,61890,bY3M6NxBAZjGeFa96h2br6AbSx8krpDK,SpATywNh6bZuzm8s1ceuBUnMUAeoAHHw,14,16,9,19,7,7,4,0,62,8.857142857142858,2,0.0,3,9,15,7,13,7,4,4,0,34,28,0
2821,61910,TNArortVQm3F09odJ2W3xdM27lVc5PiX,SpATywNh6bZuzm8s1ceuBUnMUAeoAHHw,2,0,0,0,0,0,3,0,3,0.42857142857142855,1,0.0,0,0,0,0,0,0,0,3,0,0,3,0
2822,61916,XDPvGyFLLEYwbNEQik2MM4yiADs5rrYJ,A3fsA9Zfv1X2fVEQhTw51lKENdNrEqT3,1,0,0,0,0,0,1,0,1,0.14285714285714285,1,0.0,0,0,0,0,0,0,0,1,0,0,1,0
2823,61934,8dPQDWD7NMlHSztQh4Fh3dqPVx6xptft,SpATywNh6bZuzm8s1ceuBUnMUAeoAHHw,17,39,18,12,7,2,13,0,91,13.0,5,0.0,5,18,9,7,34,2,3,13,0,39,52,0
2824,61948,MHUd30s3WtRLChM8IirlGkLsv26fGFJh,bWdj2GDclj5ofokWjzoa5jAwMkxCykd6,13,19,10,34,6,20,10,2,101,14.428571428571429,2,0.0,3,10,32,6,16,20,2,10,2,51,50,1
2825,61951,01vp16vMBdfdzNflK84lEgGXfBDKyb7S,SpATywNh6bZuzm8s1ceuBUnMUAeoAHHw,8,6,3,0,3,0,5,0,17,2.4285714285714284,1,0.0,2,3,0,3,4,0,0,5,0,8,9,1
2826,61959,0qbWIMzrwjcZydLWs8mxTmhu7QXiYFSP,7GRhBDsirIGkRZBtSMEzNTyDr2JQm4xx,11,8,5,0,6,0,3,0,22,3.142857142857143,1,0.0,2,5,0,6,6,0,0,3,0,13,9,1
2827,61968,oNcOLZOgRKuqVCWgf9VQFQ2ph82THXaV,7GRhBDsirIGkRZBtSMEzNTyDr2JQm4xx,17,58,22,0,13,0,7,0,100,14.285714285714286,3,0.0,4,22,0,13,54,0,0,7,0,39,61,1
2828,61970,rw1CeO1TCa8fgCdp1zXNf3dRKMz7g6nk,SpATywNh6bZuzm8s1ceuBUnMUAeoAHHw,5,5,3,0,1,0,2,0,11,1.5714285714285714,1,0.0,0,3,0,1,5,0,0,2,0,4,7,1
2829,61977,XupxNoKQxp2aAQkFy5RiZK4Yl6Wd1tRi,SpATywNh6bZuzm8s1ceuBUnMUAeoAHHw,15,21,0,18,0,25,19,3,86,12.285714285714286,4,0.0,5,0,15,0,16,25,3,19,3,20,66,0
2830,62001,9RakuKxD8WS6oi5xvzWI4nJK3Tjlrymz,7GRhBDsirIGkRZBtSMEzNTyDr2JQm4xx,5,2,1,0,1,0,2,0,6,0.8571428571428571,1,0.0,0,1,0,1,2,0,0,2,0,2,4,1
2831,62005,63waYBGRyitKxyJxVKV8NWeJFWacnPQr,7GRhBDsirIGkRZBtSMEzNTyDr2JQm4xx,8,5,4,0,4,0,1,0,14,2.0,1,0.0,0,4,0,4,5,0,0,1,0,8,6,1
2832,62032,xMkkyPamBlQnoa7jeVZTYr4avomD93Rr,7GRhBDsirIGkRZBtSMEzNTyDr2JQm4xx,2,0,0,0,0,0,3,0,3,0.42857142857142855,1,0.0,0,0,0,0,0,0,0,3,0,0,3,1
2833,62051,xFkd6TNWJ8qmIM4trYH57onQcjo5lnU0,SpATywNh6bZuzm8s1ceuBUnMUAeoAHHw,13,35,11,14,5,0,10,0,75,10.714285714285714,4,0.0,6,11,13,5,29,0,1,10,0,35,40,0
2834,62072,VWEcCKiwp28lQZuBYYNslDL0523gk0Z6,SpATywNh6bZuzm8s1ceuBUnMUAeoAHHw,17,20,7,23,4,1,7,2,64,9.142857142857142,1,0.0,9,7,18,4,11,1,5,7,2,38,26,0
2835,62091,6AOZlfpjI3ayLpXvguaWVv2FqhQMzw4M,SpATywNh6bZuzm8s1ceuBUnMUAeoAHHw,10,14,4,6,0,0,6,0,30,4.285714285714286,5,0.0,4,4,6,0,10,0,0,6,0,14,16,0
2836,62133,CsUkH6E2FiorKRYwpRBQQof16ywBIfF7,SpATywNh6bZuzm8s1ceuBUnMUAeoAHHw,15,26,6,23,4,1,7,1,68,9.714285714285714,2,0.0,12,6,20,4,14,1,3,7,1,42,26,0
2837,62146,y8Q2VwfVlqk1j3XET9GUUSulEAonzlDI,7GRhBDsirIGkRZBtSMEzNTyDr2JQm4xx,4,0,0,0,0,0,5,1,6,0.8571428571428571,1,0.0,0,0,0,0,0,0,0,5,1,0,6,1
2838,62156,W2whDchxLBc7jpJ4UAVUryN7DSrj5pnr,SpATywNh6bZuzm8s1ceuBUnMUAeoAHHw,6,2,0,0,0,10,22,2,36,5.142857142857143,1,0.0,0,0,0,0,2,10,0,22,2,0,36,0
2839,62160,Mm7Iv2bcZu7V7eMb3kbuiZ6iWSUOq5iS,7GRhBDsirIGkRZBtSMEzNTyDr2JQm4xx,7,6,2,0,1,0,3,0,12,1.7142857142857142,2,0.0,0,2,0,1,6,0,0,3,0,3,9,1
2840,62186,W0MWfR8rCQKyPPfo34tiE6MzA7EX1V3m,7GRhBDsirIGkRZBtSMEzNTyDr2JQm4xx,1,0,0,0,0,0,1,0,1,0.14285714285714285,1,0.0,0,0,0,0,0,0,0,1,0,0,1,1
2841,62208,mPSPvu82Gr17tV9GJ95bDC7exvsVnwDE,7GRhBDsirIGkRZBtSMEzNTyDr2JQm4xx,26,39,13,57,11,3,1,0,124,17.714285714285715,1,0.0,22,13,50,11,17,3,7,1,0,96,28,1
2842,62235,2cdJoONM7ugDmkPkQHwnxWZwEOIANTXn,SpATywNh6bZuzm8s1ceuBUnMUAeoAHHw,13,22,9,5,3,0,6,0,45,6.428571428571429,2,0.0,0,9,5,3,22,0,0,6,0,17,28,0
2843,62251,76Kz8DEQMUa3r549crPtcn99eC1czeI6,7GRhBDsirIGkRZBtSMEzNTyDr2JQm4xx,1,0,0,0,0,0,1,0,1,0.14285714285714285,1,0.0,0,0,0,0,0,0,0,1,0,0,1,1
2844,62290,FAyKTlOaLRLHiyLG5PXQhYddpdx56j0F,SpATywNh6bZuzm8s1ceuBUnMUAeoAHHw,18,35,14,19,9,6,10,1,94,13.428571428571429,2,0.0,13,14,16,9,22,6,3,10,1,52,42,0
2845,62305,jFuORSL1URM2oqg9zp9eOfHmKoYyUgBh,SpATywNh6bZuzm8s1ceuBUnMUAeoAHHw,13,27,1,16,0,1,9,1,55,7.857142857142857,2,0.0,13,1,14,0,14,1,2,9,1,28,27,1
2846,62321,4aUZNrEysB01BTDaMjEoJUWN7ca7RotB,SpATywNh6bZuzm8s1ceuBUnMUAeoAHHw,7,3,2,0,2,0,3,0,10,1.4285714285714286,1,0.0,0,2,0,2,3,0,0,3,0,4,6,1
2847,62331,FMwKUA8u0BzLarxpeAgKTtl6QSWIGKl8,SpATywNh6bZuzm8s1ceuBUnMUAeoAHHw,1,0,0,0,0,0,1,0,1,0.14285714285714285,1,0.0,0,0,0,0,0,0,0,1,0,0,1,0
2848,62371,sdgY41MIb6WYbIgC75Nfq2olF7e670eU,7GRhBDsirIGkRZBtSMEzNTyDr2JQm4xx,6,3,1,0,1,0,2,0,7,1.0,1,0.0,0,1,0,1,3,0,0,2,0,2,5,1
2849,62376,CqhdzHIILIe1pnO5H5MX1yWHcBaohaEB,7GRhBDsirIGkRZBtSMEzNTyDr2JQm4xx,8,2,2,0,2,0,3,0,9,1.2857142857142858,1,0.0,0,2,0,2,2,0,0,3,0,4,5,1
2850,62383,hIFgL0n5x61JjabCFOIHZgZxMVGzmHNh,SpATywNh6bZuzm8s1ceuBUnMUAeoAHHw,14,16,11,6,8,0,5,0,46,6.571428571428571,3,0.0,2,11,6,8,14,0,0,5,0,27,19,0
2851,62392,FLIojen7fff3GhtDNtEDgYWfLgv0g8w4,A3fsA9Zfv1X2fVEQhTw51lKENdNrEqT3,11,5,1,0,0,1,7,1,15,2.142857142857143,1,0.0,0,1,0,0,5,1,0,7,1,1,14,1
2852,62427,7FBwqoodmzhvrGGLuwBjRrxsykocUv8u,7GRhBDsirIGkRZBtSMEzNTyDr2JQm4xx,17,13,10,0,7,0,2,0,32,4.571428571428571,1,0.0,2,10,0,7,11,0,0,2,0,19,13,1
2853,62466,ggEr2STKTwtSSUdtGCmiPr3DBu3TJ34B,SpATywNh6bZuzm8s1ceuBUnMUAeoAHHw,7,5,2,6,0,0,1,0,14,2.0,1,0.0,2,2,6,0,3,0,0,1,0,10,4,1
2854,62481,ggEr2STKTwtSSUdtGCmiPr3DBu3TJ34B,7GRhBDsirIGkRZBtSMEzNTyDr2JQm4xx,1,0,0,0,0,0,1,0,1,0.14285714285714285,1,0.0,0,0,0,0,0,0,0,1,0,0,1,1
2855,62516,l7f4vHvlZkxCYoU9qM63V45bmndBSeZQ,A3fsA9Zfv1X2fVEQhTw51lKENdNrEqT3,11,5,1,30,0,0,2,0,38,5.428571428571429,1,0.0,0,1,28,0,5,0,2,2,0,29,9,1
2856,62533,UOssUZDJcaoIiaAH8nTbzjrXIWUHSQSA,7GRhBDsirIGkRZBtSMEzNTyDr2JQm4xx,3,2,1,0,0,0,1,0,4,0.5714285714285714,1,0.0,0,1,0,0,2,0,0,1,0,1,3,1
2857,62549,u82lBhpDxJIwlZISEntCxj1zgVFdW0vT,bWdj2GDclj5ofokWjzoa5jAwMkxCykd6,1,0,0,0,0,0,1,0,1,0.14285714285714285,1,0.0,0,0,0,0,0,0,0,1,0,0,1,1
2858,62554,bYD2u7vuN3G54awyDYPdRiZI3O4zw6kx,SpATywNh6bZuzm8s1ceuBUnMUAeoAHHw,15,14,7,12,3,4,4,0,44,6.285714285714286,2,0.0,4,7,12,3,10,4,0,4,0,26,18,0
2859,62571,E96VmAw6m1AOHRckdqiq2ASKbnHBlpAb,SpATywNh6bZuzm8s1ceuBUnMUAeoAHHw,5,4,2,0,1,0,2,0,9,1.2857142857142858,2,0.0,0,2,0,1,4,0,0,2,0,3,6,0
2860,62622,uU71zmfnwmq5Imjxap728hWGDmNRuuCF,SpATywNh6bZuzm8s1ceuBUnMUAeoAHHw,14,12,10,19,8,1,5,1,56,8.0,1,0.0,2,10,16,8,10,1,3,5,1,36,20,1
2861,62633,zlsPhArkUaQ0CCdgZTO1797WJjiciHBk,SpATywNh6bZuzm8s1ceuBUnMUAeoAHHw,6,2,1,0,1,0,4,1,9,1.2857142857142858,1,0.0,0,1,0,1,2,0,0,4,1,2,7,0
2862,62637,7PJjcgOQXwj0M6oz8Sxyd66Tvypm0TFY,SpATywNh6bZuzm8s1ceuBUnMUAeoAHHw,15,25,17,3,9,6,7,3,70,10.0,3,0.0,3,17,3,9,22,6,0,7,3,32,38,0
2863,62669,PMp3RxnsqELMI5BiCmteZ8iF2l5wlW7H,7GRhBDsirIGkRZBtSMEzNTyDr2JQm4xx,1,0,0,0,0,0,1,0,1,0.14285714285714285,1,0.0,0,0,0,0,0,0,0,1,0,0,1,1
2864,62685,xhufFs72rOwOGZDYtQtHTXdheNyqrUTX,SpATywNh6bZuzm8s1ceuBUnMUAeoAHHw,14,9,4,13,2,2,11,1,42,6.0,1,0.0,5,4,12,2,4,2,1,11,1,23,19,0
2865,62686,DpXkrIHIAIPNESKyvFah0WhpVT5PHFeL,bWdj2GDclj5ofokWjzoa5jAwMkxCykd6,10,28,16,16,0,3,7,0,70,10.0,2,0.0,3,16,16,0,25,3,0,7,0,35,35,1
2866,62739,CaM5OJ40UpPm5AoorpoNghXDZnct2Zfn,SpATywNh6bZuzm8s1ceuBUnMUAeoAHHw,13,19,1,18,0,15,7,1,61,8.714285714285714,2,0.0,5,1,15,0,14,15,3,7,1,21,40,1
2867,62752,GKJr5PPNFb6sbmwmK3Q19sOuk5TaY1oJ,SpATywNh6bZuzm8s1ceuBUnMUAeoAHHw,10,11,2,7,0,0,3,0,23,3.2857142857142856,3,0.0,1,2,6,0,10,0,1,3,0,9,14,1
2868,62764,XsK920toyXvpWwNS6lvZzDVJcrgCTFKd,SpATywNh6bZuzm8s1ceuBUnMUAeoAHHw,14,22,8,18,5,4,2,0,59,8.428571428571429,2,0.0,11,8,16,5,11,4,2,2,0,40,19,0
2869,62795,hf0GNWS6vfpKVHFBCaEpR8vnVjTeyl46,7GRhBDsirIGkRZBtSMEzNTyDr2JQm4xx,1,0,0,0,0,0,1,0,1,0.14285714285714285,1,0.0,0,0,0,0,0,0,0,1,0,0,1,1
2870,62809,EEgHvStGR7XKoMKoPOCBxkxFHcb7UdMh,SpATywNh6bZuzm8s1ceuBUnMUAeoAHHw,6,11,6,0,1,0,3,0,21,3.0,2,0.0,0,6,0,1,11,0,0,3,0,7,14,0
2871,62837,k4ieA0VLPLUG1GV8FhtBGpWAykZRhHXI,7GRhBDsirIGkRZBtSMEzNTyDr2JQm4xx,27,40,11,25,10,1,7,1,95,13.571428571428571,3,0.0,23,11,23,10,17,1,2,7,1,67,28,1
2872,62856,SMph1YQCIZlmphiUl0TLsRAe6lO4LFpT,7GRhBDsirIGkRZBtSMEzNTyDr2JQm4xx,1,0,0,0,0,0,1,0,1,0.14285714285714285,1,0.0,0,0,0,0,0,0,0,1,0,0,1,1
2873,62864,3LVlNsK7BHroChDOSCZ8wTJul8hRnncw,7GRhBDsirIGkRZBtSMEzNTyDr2JQm4xx,8,18,5,6,2,0,3,0,34,4.857142857142857,1,0.0,11,5,4,2,7,0,2,3,0,22,12,1
2874,62891,lo9vHqgfDG1UEcho8eZgahljlKaQ2l9G,7GRhBDsirIGkRZBtSMEzNTyDr2JQm4xx,1,0,0,0,0,0,1,0,1,0.14285714285714285,1,0.0,0,0,0,0,0,0,0,1,0,0,1,1
2875,62903,6WyBLtTebYxWs237cTFazhrWvguV9PiM,7GRhBDsirIGkRZBtSMEzNTyDr2JQm4xx,12,33,0,16,6,0,3,0,58,8.285714285714286,2,0.0,18,0,14,6,15,0,2,3,0,38,20,1
2876,62913,VnWhM3BeDRhDK8eiBuMGZHGyfJnGv0sM,SpATywNh6bZuzm8s1ceuBUnMUAeoAHHw,14,24,1,22,0,1,9,2,59,8.428571428571429,1,0.0,4,1,21,0,20,1,1,9,2,26,33,1
2877,62945,psUY0jMEvxZuoP9UKA82E9maLgW6I63x,SpATywNh6bZuzm8s1ceuBUnMUAeoAHHw,15,21,2,14,2,1,10,0,50,7.142857142857143,1,0.0,5,2,13,2,16,1,1,10,0,22,28,0
2878,62948,XjHYgZsrS0l8TkcDRDNv64IhD09kdX0g,7GRhBDsirIGkRZBtSMEzNTyDr2JQm4xx,4,2,1,0,1,0,1,0,5,0.7142857142857143,1,0.0,0,1,0,1,2,0,0,1,0,2,3,1
2879,62957,iugl3Rn3u1ci3BiC2tfekDHOQsD5QVGj,bWdj2GDclj5ofokWjzoa5jAwMkxCykd6,19,48,19,90,10,3,19,3,192,27.428571428571427,3,0.0,11,19,81,10,37,3,9,19,3,121,71,0
2880,62975,fV0W6675p3fpyY1tGNGM2NdIFpKgGWLW,SpATywNh6bZuzm8s1ceuBUnMUAeoAHHw,14,25,6,8,3,20,4,0,66,9.428571428571429,3,0.0,12,6,7,3,13,20,1,4,0,28,38,0
2881,62999,JFnonbrySwtMlSqTfY5pp3MQd3sPiIYz,bWdj2GDclj5ofokWjzoa5jAwMkxCykd6,6,6,3,0,1,0,7,0,17,2.4285714285714284,1,0.0,0,3,0,1,6,0,0,7,0,4,13,0
2882,63022,aGKf0W7DbO5pZNcjJ5sGrg9jyzAmLXkB,SpATywNh6bZuzm8s1ceuBUnMUAeoAHHw,7,12,7,0,5,0,4,0,28,4.0,1,0.0,0,7,0,5,12,0,0,4,0,12,16,0
2883,63048,OO2Ag6HEFKkZRtZuzzt1ya8SiL4BLCOC,bWdj2GDclj5ofokWjzoa5jAwMkxCykd6,9,9,2,0,2,1,7,1,22,3.142857142857143,1,0.0,3,2,0,2,6,1,0,7,1,7,15,0
2884,63053,2gXHY5qLgY96Nt3kImmboPawcy43EQXt,7GRhBDsirIGkRZBtSMEzNTyDr2JQm4xx,11,22,11,6,7,0,4,0,50,7.142857142857143,4,0.0,1,11,5,7,21,0,1,4,0,24,26,0
2885,63099,WYoMb9pjSPIkNMKnbh6vDtB0LRCn2aRR,bWdj2GDclj5ofokWjzoa5jAwMkxCykd6,9,4,3,0,3,0,3,0,13,1.8571428571428572,2,0.0,0,3,0,3,4,0,0,3,0,6,7,1
2886,63108,rtYqtRTnqUXb6diSp0MKjdA0eLt2BJ3X,7GRhBDsirIGkRZBtSMEzNTyDr2JQm4xx,23,17,9,8,6,0,4,0,44,6.285714285714286,1,0.0,6,9,8,6,11,0,0,4,0,29,15,1
2887,63119,HVSG66Eu1vmbossvKhmdJDOdo5jOHC1z,7GRhBDsirIGkRZBtSMEzNTyDr2JQm4xx,1,0,0,0,0,0,1,0,1,0.14285714285714285,1,0.0,0,0,0,0,0,0,0,1,0,0,1,1
2888,63126,8nlNDsWSaxHCvsMKtqhBs81sknEiTCeb,bWdj2GDclj5ofokWjzoa5jAwMkxCykd6,14,15,8,12,5,0,7,0,47,6.714285714285714,4,0.0,3,8,9,5,12,0,3,7,0,25,22,0
2889,63128,5uO2cAopKsWa3VCKCGDarnhTzdurYycs,SpATywNh6bZuzm8s1ceuBUnMUAeoAHHw,12,8,4,14,3,0,1,0,30,4.285714285714286,1,0.0,3,4,12,3,5,0,2,1,0,22,8,0
2890,63131,6soSIDwrJrHtOwhrrHwhMkHLJvUycuiD,SpATywNh6bZuzm8s1ceuBUnMUAeoAHHw,11,9,2,7,1,0,6,0,25,3.5714285714285716,3,0.0,0,2,6,1,9,0,1,6,0,9,16,1
2891,63143,oE1QbspE1VaPia0G9CbmnflG7dN6cZJM,bWdj2GDclj5ofokWjzoa5jAwMkxCykd6,1,0,0,0,0,0,1,0,1,0.14285714285714285,1,0.0,0,0,0,0,0,0,0,1,0,0,1,1
2892,63144,Uf8FY0gZoVytp6K7SsDRXVZeOCL2hDEX,A3fsA9Zfv1X2fVEQhTw51lKENdNrEqT3,17,8,7,0,7,2,2,0,26,3.7142857142857144,1,0.0,0,7,0,7,8,2,0,2,0,14,12,1
2893,63198,JUAvN6CchqwicZ9lfSkTbwue3bPu0qhC,7GRhBDsirIGkRZBtSMEzNTyDr2JQm4xx,1,0,0,0,0,0,1,0,1,0.14285714285714285,1,0.0,0,0,0,0,0,0,0,1,0,0,1,0
2894,63255,7u0QfTKQg4itZK9m8foLXkIGwUxxHMsT,7GRhBDsirIGkRZBtSMEzNTyDr2JQm4xx,27,31,11,26,11,1,4,0,84,12.0,2,0.0,18,11,26,11,13,1,0,4,0,66,18,0
2895,63296,qMFAmPw34z5IViYTtA1Kkpcn2uEg1WBM,7GRhBDsirIGkRZBtSMEzNTyDr2JQm4xx,1,0,0,0,0,0,1,0,1,0.14285714285714285,1,0.0,0,0,0,0,0,0,0,1,0,0,1,1
2896,63344,pxvZPop6eUfNSRIk3XGIXLwhqmGee9n7,A3fsA9Zfv1X2fVEQhTw51lKENdNrEqT3,6,2,1,0,1,0,8,3,15,2.142857142857143,1,0.0,0,1,0,1,2,0,0,8,3,2,13,1
2897,63493,NRZzsjM7f5dJSFvndgYyTX54NocUI1PS,7GRhBDsirIGkRZBtSMEzNTyDr2JQm4xx,12,29,6,18,1,12,2,0,68,9.714285714285714,2,0.0,21,6,14,1,8,12,4,2,0,42,26,1
2898,63571,EwaALzeaojV7pPZOsHFx7jzB7xjVDGvQ,A3fsA9Zfv1X2fVEQhTw51lKENdNrEqT3,29,13,0,54,0,0,2,0,69,9.857142857142858,1,0.0,1,0,48,0,12,0,6,2,0,49,20,1
2899,63583,CLsYy7g1hYWHJyj1aROfKK9oTeo5yxJx,7GRhBDsirIGkRZBtSMEzNTyDr2JQm4xx,8,6,4,4,4,3,2,0,23,3.2857142857142856,1,0.0,1,4,3,4,5,3,1,2,0,12,11,1
2900,63593,KNf8lqR4KQcQVf1nb3UW38BlYtlHOqrY,A3fsA9Zfv1X2fVEQhTw51lKENdNrEqT3,8,6,3,0,2,0,2,1,14,2.0,2,0.0,1,3,0,2,5,0,0,2,1,6,8,0
2901,63710,Ga4lr67F0RIjyUetWH1EgQ3xzSHDnViF,7GRhBDsirIGkRZBtSMEzNTyDr2JQm4xx,7,3,2,0,2,0,2,0,9,1.2857142857142858,1,0.0,0,2,0,2,3,0,0,2,0,4,5,1
2902,63713,DedOVhQ90meYxq6Misau3AEJ23SFBM8N,A3fsA9Zfv1X2fVEQhTw51lKENdNrEqT3,4,2,1,0,1,0,1,0,5,0.7142857142857143,1,0.0,0,1,0,1,2,0,0,1,0,2,3,1
2903,63719,RPsysYLHG9V8ibC4agPmUkz49odzJ61i,A3fsA9Zfv1X2fVEQhTw51lKENdNrEqT3,35,21,0,58,0,5,12,1,97,13.857142857142858,2,0.0,1,0,51,0,20,5,7,12,1,52,45,0
2904,63750,0wm7bVyJC7jfhIoeylaV85sHOH5JOhtj,7GRhBDsirIGkRZBtSMEzNTyDr2JQm4xx,1,0,0,0,0,0,1,0,1,0.14285714285714285,1,0.0,0,0,0,0,0,0,0,1,0,0,1,1
2905,63868,5Dk7QJtqh7ATnN1jDaFE4dN4E1GugvAr,A3fsA9Zfv1X2fVEQhTw51lKENdNrEqT3,12,8,6,0,4,0,2,0,20,2.857142857142857,1,0.0,0,6,0,4,8,0,0,2,0,10,10,1
2906,63914,Yt9n1K8qzV8RLiOcWgNVrYW5xiZerljd,7GRhBDsirIGkRZBtSMEzNTyDr2JQm4xx,27,32,1,48,5,2,10,2,100,14.285714285714286,1,0.0,21,1,41,5,11,2,7,10,2,68,32,1
2907,64025,VmlXkvuP00sXBlaPmnRadtsHqWz5E4fz,7GRhBDsirIGkRZBtSMEzNTyDr2JQm4xx,41,157,39,58,17,27,18,0,316,45.142857142857146,3,0.0,79,39,44,17,78,27,14,18,0,179,137,0
2908,64036,4dC723f2ZXGHBwWoh8xH8B5ftd5Zr0Rn,A3fsA9Zfv1X2fVEQhTw51lKENdNrEqT3,6,3,0,0,0,0,4,0,7,1.0,2,0.0,0,0,0,0,3,0,0,4,0,0,7,1
2909,64116,sQpA2SuskRigo277vTUjZ4C84cF8DuDE,7GRhBDsirIGkRZBtSMEzNTyDr2JQm4xx,18,41,9,22,6,7,10,1,96,13.714285714285714,2,0.0,16,9,18,6,25,7,4,10,1,49,47,0
2910,65788,aszS4GIQTgIfNXx5jr5Ct6AzWRVtVT5s,7GRhBDsirIGkRZBtSMEzNTyDr2JQm4xx,28,39,12,48,9,0,1,0,109,15.571428571428571,2,0.0,25,12,42,9,14,0,6,1,0,88,21,1
2911,66546,DTbJ7KB3uMFcpk8W3n4kvUeKqSYyolkW,SpATywNh6bZuzm8s1ceuBUnMUAeoAHHw,15,34,3,18,1,1,12,0,69,9.857142857142858,3,0.0,19,3,15,1,15,1,3,12,0,38,31,1
2912,66551,fkrSqTHnPEweVdPiAW6RgeMJZWZWaXQt,G8EPVSXsOYB5YQWZGiz1aVq5Pgr2GrQu,83,68,19,201,13,19,21,2,343,49.0,3,0.0,46,19,149,13,22,19,52,21,2,227,116,0
2913,66555,fdzq5tofwv4sAm3YqrsC6AMOnGl1oPA0,RXDvfPUBYFlVdlueBFbLW0mhhAyGEqpt,2,0,0,0,0,5,1,0,6,0.8571428571428571,1,0.0,0,0,0,0,0,5,0,1,0,0,6,1
2914,66558,z6Xzy59qUrOr9kg6qBkR4Bly4uQ6Qoy2,SpATywNh6bZuzm8s1ceuBUnMUAeoAHHw,17,38,14,23,5,11,24,4,119,17.0,4,0.0,12,14,19,5,26,11,4,24,4,50,69,1
2915,66563,rMO5SCPyMgH89I8wk1aP5Tz4xRCn17BB,SpATywNh6bZuzm8s1ceuBUnMUAeoAHHw,6,5,2,0,2,0,1,0,10,1.4285714285714286,1,0.0,0,2,0,2,5,0,0,1,0,4,6,1
2916,66564,pzsUx69X9Xid85hyecE8y9Ou9VDtnPhb,SpATywNh6bZuzm8s1ceuBUnMUAeoAHHw,1,0,0,0,0,0,1,0,1,0.14285714285714285,1,0.0,0,0,0,0,0,0,0,1,0,0,1,1
2917,66569,2daUzJgefGOj5dfl9u5sPO7QTYuS1O1e,SpATywNh6bZuzm8s1ceuBUnMUAeoAHHw,4,2,1,0,0,0,2,0,5,0.7142857142857143,1,0.0,0,1,0,0,2,0,0,2,0,1,4,1
2918,66570,MpNfjrXai4aLf7BfVSQwZSS0DPolU3oZ,RXDvfPUBYFlVdlueBFbLW0mhhAyGEqpt,43,44,27,69,16,0,9,2,167,23.857142857142858,2,0.0,13,27,66,16,31,0,3,9,2,122,45,0
2919,66571,2jofclRKNdmEGIMZjR1X3xlqQjjV6yF4,SpATywNh6bZuzm8s1ceuBUnMUAeoAHHw,17,32,13,29,5,6,18,1,104,14.857142857142858,3,0.0,9,13,22,5,23,6,7,18,1,49,55,0
2920,66577,s9OHCOR537Yr2UKR6DSCnB7grKBa5GVW,SpATywNh6bZuzm8s1ceuBUnMUAeoAHHw,5,2,1,0,1,0,2,0,6,0.8571428571428571,1,0.0,0,1,0,1,2,0,0,2,0,2,4,1
2921,66579,bDdEUq0MJvGkx68ulN38uXa8x4Oc6Mqn,SpATywNh6bZuzm8s1ceuBUnMUAeoAHHw,17,18,6,20,4,0,9,1,58,8.285714285714286,1,0.0,5,6,16,4,13,0,4,9,1,31,27,1
2922,66581,thNNhxxCA11oJLPqP35etO0M0nOY00HM,G8EPVSXsOYB5YQWZGiz1aVq5Pgr2GrQu,32,59,28,60,18,0,4,0,169,24.142857142857142,2,0.0,27,28,50,18,32,0,10,4,0,123,46,1
2923,66586,F2b4wQkSXPvl6LtgZJlfZ4TcFXgwDGKe,SpATywNh6bZuzm8s1ceuBUnMUAeoAHHw,7,4,3,0,3,0,2,0,12,1.7142857142857142,1,0.0,0,3,0,3,4,0,0,2,0,6,6,1
2924,66592,7mVgrKQULKrxGxLEFeqEhI8vLoHAKVjH,SpATywNh6bZuzm8s1ceuBUnMUAeoAHHw,5,2,1,0,1,0,2,0,6,0.8571428571428571,1,0.0,0,1,0,1,2,0,0,2,0,2,4,1
2925,66594,Jkvg2vrMG0bsI6gC4CJJwz6mYReBwqyD,bWdj2GDclj5ofokWjzoa5jAwMkxCykd6,14,27,13,8,6,0,22,2,78,11.142857142857142,3,0.0,2,13,8,6,25,0,0,22,2,29,49,1
2926,66599,FrnZkjOLuaGZ96dbbyAebpl6VdyOmBDE,RXDvfPUBYFlVdlueBFbLW0mhhAyGEqpt,6,2,1,0,1,0,4,0,8,1.1428571428571428,2,0.0,0,1,0,1,2,0,0,4,0,2,6,1
2927,66603,2zQQnqY1LiZ9lcEXTzcE3zimEdKe8CdV,G8EPVSXsOYB5YQWZGiz1aVq5Pgr2GrQu,28,25,12,62,8,0,5,0,112,16.0,3,0.0,12,12,51,8,13,0,11,5,0,83,29,1
2928,66606,yceNLUK4FCR6SZUYW0W0TAVYCfKl5jP6,SpATywNh6bZuzm8s1ceuBUnMUAeoAHHw,11,11,0,5,0,10,9,1,36,5.142857142857143,1,0.0,0,0,4,0,11,10,1,9,1,4,32,1
2929,66607,nvX3zuXPoMSUhlRzwAoQtF8bA4zlkXZY,G8EPVSXsOYB5YQWZGiz1aVq5Pgr2GrQu,21,40,31,20,2,20,32,3,148,21.142857142857142,3,0.0,0,31,18,2,40,20,2,32,3,51,97,1
2930,66614,RxKdUoY8VjcWLXSrUuB2O5rajs7dKtPo,SpATywNh6bZuzm8s1ceuBUnMUAeoAHHw,9,10,4,0,3,1,4,0,22,3.142857142857143,1,0.0,3,4,0,3,7,1,0,4,0,10,12,1
2931,66620,YSRj2LyghpGgbkTJyCc5CeAD7nnieGEa,SpATywNh6bZuzm8s1ceuBUnMUAeoAHHw,7,9,1,0,1,0,2,0,13,1.8571428571428572,1,0.0,0,1,0,1,9,0,0,2,0,2,11,1
2932,66622,3BM8P16Xlf6mH29LptGI3X2aHEFZEk4O,SpATywNh6bZuzm8s1ceuBUnMUAeoAHHw,11,10,6,0,3,8,12,2,41,5.857142857142857,2,0.0,0,6,0,3,10,8,0,12,2,9,32,1
2933,66625,WSyXGkhm7NDepRlMA3agJj8k8GLnavsP,bWdj2GDclj5ofokWjzoa5jAwMkxCykd6,5,2,1,0,1,0,2,0,6,0.8571428571428571,1,0.0,0,1,0,1,2,0,0,2,0,2,4,1
2934,66633,tuzr7UEFeueCuu7trKtH12YoCRZa4u3J,SpATywNh6bZuzm8s1ceuBUnMUAeoAHHw,17,42,15,11,5,101,19,2,195,27.857142857142858,5,0.0,8,15,9,5,34,101,2,19,2,37,158,1
2935,66642,7i6uHx2i3AcAV22o4Aq16TZJzUL7SbJ8,SpATywNh6bZuzm8s1ceuBUnMUAeoAHHw,18,29,8,19,3,9,13,4,85,12.142857142857142,3,0.0,9,8,16,3,20,9,3,13,4,36,49,0
2936,66643,YpwPSpfFUdYNa3VjazLGMwZAAiqtZEgp,SpATywNh6bZuzm8s1ceuBUnMUAeoAHHw,1,0,0,0,0,0,1,0,1,0.14285714285714285,1,0.0,0,0,0,0,0,0,0,1,0,0,1,1
2937,66648,Z5eVqB1AyrDAwIaFYca0z5tjEfS46LEV,SpATywNh6bZuzm8s1ceuBUnMUAeoAHHw,6,2,1,0,0,0,4,0,7,1.0,1,0.0,0,1,0,0,2,0,0,4,0,1,6,1
2938,66649,Gmz5iMjiwcyTx4KusyWM0rOecmUutZaf,RXDvfPUBYFlVdlueBFbLW0mhhAyGEqpt,47,69,42,66,28,10,10,5,230,32.857142857142854,3,0.0,16,42,65,28,53,10,1,10,5,151,79,0
2939,66661,uPc8X6Bm31kSZXvsGiF4cJMs1CphJwNI,RXDvfPUBYFlVdlueBFbLW0mhhAyGEqpt,7,4,3,0,1,0,2,0,10,1.4285714285714286,1,0.0,0,3,0,1,4,0,0,2,0,4,6,1
2940,66666,4QSKoi2COLIjISXuWMSgkhYU8OcqVVuy,SpATywNh6bZuzm8s1ceuBUnMUAeoAHHw,10,12,4,0,3,0,2,0,21,3.0,1,0.0,4,4,0,3,8,0,0,2,0,11,10,1
2941,66667,emzkGgKaVLaDWCW4bOLMsgyMV9eX3Ume,G8EPVSXsOYB5YQWZGiz1aVq5Pgr2GrQu,29,33,13,62,3,6,11,1,129,18.428571428571427,2,0.0,13,13,44,3,20,6,18,11,1,73,56,0
2942,66668,VKxATUtWUHvLpvjNhrujhWYm5cDOeljR,SpATywNh6bZuzm8s1ceuBUnMUAeoAHHw,3,3,0,0,0,0,1,0,4,0.5714285714285714,2,0.0,0,0,0,0,3,0,0,1,0,0,4,1
2943,66673,jdTzrZz0SYzgENOxdTEUzOnYtapHefGQ,SpATywNh6bZuzm8s1ceuBUnMUAeoAHHw,3,2,0,0,0,0,1,0,3,0.42857142857142855,1,0.0,0,0,0,0,2,0,0,1,0,0,3,1
2944,66686,N1N2VoCQ3DCM7YknWLib5UEHyI2wyiAp,SpATywNh6bZuzm8s1ceuBUnMUAeoAHHw,12,10,3,25,2,0,6,0,46,6.571428571428571,2,0.0,4,3,20,2,6,0,5,6,0,29,17,1
2945,66687,Lb2uKLbwD8GvR2CPQEYJA4oaJUHHccBI,G8EPVSXsOYB5YQWZGiz1aVq5Pgr2GrQu,9,9,0,0,0,0,4,0,13,1.8571428571428572,1,0.0,0,0,0,0,9,0,0,4,0,0,13,1
2946,66692,X2YAK6wLAh05M8slR10ibCM34PqZNEYp,G8EPVSXsOYB5YQWZGiz1aVq5Pgr2GrQu,21,24,2,24,1,1,4,0,56,8.0,2,0.0,1,2,19,1,23,1,5,4,0,23,33,1
2947,66693,Q0GCy8RLg4XnQiHX0oDTDootKu46YmWa,SpATywNh6bZuzm8s1ceuBUnMUAeoAHHw,4,2,0,0,0,0,2,0,4,0.5714285714285714,1,0.0,0,0,0,0,2,0,0,2,0,0,4,1
2948,66694,ZnCJUx9hjBAhb4k6sSnSHXC3G4doeeAn,SpATywNh6bZuzm8s1ceuBUnMUAeoAHHw,12,17,8,0,4,10,6,1,46,6.571428571428571,1,0.0,6,8,0,4,11,10,0,6,1,18,28,1
2949,66699,vYjevNGSZuPL0Me7nQ7eB69nuvnbZiuq,SpATywNh6bZuzm8s1ceuBUnMUAeoAHHw,13,17,0,16,0,0,6,1,40,5.714285714285714,3,0.0,8,0,14,0,9,0,2,6,1,22,18,1
2950,66700,xLfQrz0Mm3ryvcwRcTyZdkwlshtwNJHB,RXDvfPUBYFlVdlueBFbLW0mhhAyGEqpt,5,2,1,0,1,0,2,0,6,0.8571428571428571,1,0.0,0,1,0,1,2,0,0,2,0,2,4,1
2951,66708,bPMM8JJVMbo3dHwzrkYwNanOXVlVjIZM,bWdj2GDclj5ofokWjzoa5jAwMkxCykd6,6,2,1,0,1,0,3,0,7,1.0,1,0.0,0,1,0,1,2,0,0,3,0,2,5,1
2952,66710,fUNdgzfWSE4HzsYQQ7FDu5pyDUIMQ40m,bWdj2GDclj5ofokWjzoa5jAwMkxCykd6,1,0,0,0,0,0,1,0,1,0.14285714285714285,1,0.0,0,0,0,0,0,0,0,1,0,0,1,1
2953,66712,Ksg32KcGSJwlEbdLbDafCAI8P52qq3MX,SpATywNh6bZuzm8s1ceuBUnMUAeoAHHw,5,2,1,0,0,0,3,0,6,0.8571428571428571,1,0.0,0,1,0,0,2,0,0,3,0,1,5,1
2954,66716,m8pWjgRGGqizCnvKfqrgJiRn5L3s4aMf,SpATywNh6bZuzm8s1ceuBUnMUAeoAHHw,10,6,4,0,3,0,4,1,18,2.5714285714285716,1,0.0,1,4,0,3,5,0,0,4,1,8,10,1
2955,66717,PI4R0HcIedaRtD4i4AnoySGCINPF9uFD,SpATywNh6bZuzm8s1ceuBUnMUAeoAHHw,15,16,7,15,3,0,6,0,47,6.714285714285714,2,0.0,4,7,12,3,12,0,3,6,0,26,21,1
2956,66722,dwydM4WZn1EE9lbFO8uBMhGMVscnDmyy,G8EPVSXsOYB5YQWZGiz1aVq5Pgr2GrQu,18,26,15,2,10,18,11,1,83,11.857142857142858,2,0.0,5,15,1,10,21,18,1,11,1,31,52,0
2957,66723,o4fNZaSYX3UHutrkuKOAdzPPx4q40e5R,SpATywNh6bZuzm8s1ceuBUnMUAeoAHHw,17,31,13,6,7,14,8,1,80,11.428571428571429,3,0.0,2,13,6,7,29,14,0,8,1,28,52,1
2958,66724,cWGbfR2Lw2D62YH4zDUtSEtnjy8NlUpm,SpATywNh6bZuzm8s1ceuBUnMUAeoAHHw,14,26,6,15,5,1,11,1,65,9.285714285714286,3,0.0,10,6,12,5,16,1,3,11,1,33,32,1
2959,66727,1F8QRhMnvAcX05zajUIEw9khHJe9qgvr,SpATywNh6bZuzm8s1ceuBUnMUAeoAHHw,2,2,0,0,0,0,2,0,4,0.5714285714285714,1,0.0,0,0,0,0,2,0,0,2,0,0,4,1
2960,66729,YG3IIEQOezPClODg4SNvtFayndWcEJ7a,bWdj2GDclj5ofokWjzoa5jAwMkxCykd6,10,18,7,0,7,1,4,0,37,5.285714285714286,2,0.0,7,7,0,7,11,1,0,4,0,21,16,1
2961,66731,Sz4iN9vM7plSJObu2Kgng7aJijtNNsts,bWdj2GDclj5ofokWjzoa5jAwMkxCykd6,10,11,0,14,3,8,3,0,39,5.571428571428571,1,0.0,5,0,13,3,6,8,1,3,0,21,18,1
2962,66734,NMCQVQ1Cg6MS9ushYbZMMzLoDclKVOyZ,SpATywNh6bZuzm8s1ceuBUnMUAeoAHHw,9,13,5,0,1,2,10,0,31,4.428571428571429,1,0.0,0,5,0,1,13,2,0,10,0,6,25,1
2963,66735,BF8BUQGTWJSC3An0NoOdiFsCvGqN90lp,SpATywNh6bZuzm8s1ceuBUnMUAeoAHHw,10,12,3,0,3,0,2,0,20,2.857142857142857,2,0.0,0,3,0,3,12,0,0,2,0,6,14,1
2964,66739,ggntZRuHqDckUtFC9TYtfF8K09iXYWES,G8EPVSXsOYB5YQWZGiz1aVq5Pgr2GrQu,12,11,2,26,2,2,3,0,46,6.571428571428571,2,0.0,6,2,20,2,5,2,6,3,0,30,16,1
2965,66743,ilB3zN3UyBwxCz4uXPqvzE0bs5QUbmk2,SpATywNh6bZuzm8s1ceuBUnMUAeoAHHw,6,12,0,0,0,0,4,0,16,2.2857142857142856,3,0.0,0,0,0,0,12,0,0,4,0,0,16,1
2966,66746,S5gDAq7XL2B348BbNrSZrsxK2ihjbqjX,bWdj2GDclj5ofokWjzoa5jAwMkxCykd6,4,2,0,0,0,2,10,0,14,2.0,2,0.0,0,0,0,0,2,2,0,10,0,0,14,1
2967,66748,IGtuwcXa7Vvuptxp2yP0y7DMlNgXBbkF,SpATywNh6bZuzm8s1ceuBUnMUAeoAHHw,12,11,5,6,0,12,5,0,39,5.571428571428571,2,0.0,4,5,6,0,7,12,0,5,0,15,24,1
2968,66752,qdU5OfBLhmAdLS2yu5kAr5MPjmjgxaEx,SpATywNh6bZuzm8s1ceuBUnMUAeoAHHw,9,9,4,0,4,0,2,0,19,2.7142857142857144,1,0.0,0,4,0,4,9,0,0,2,0,8,11,1
2969,66759,IFoWLGmc3yYo3jvZy7brYExecFieUsPa,SpATywNh6bZuzm8s1ceuBUnMUAeoAHHw,17,18,7,21,4,3,6,1,60,8.571428571428571,2,0.0,9,7,18,4,9,3,3,6,1,38,22,1
2970,66761,jZW7RSw8d3NHdCMzGR4TAiNXCrcYo90E,SpATywNh6bZuzm8s1ceuBUnMUAeoAHHw,16,13,5,23,3,12,12,1,69,9.857142857142858,1,0.0,7,5,19,3,6,12,4,12,1,34,35,0
2971,66763,3LiDRA4eEhNTPRwhkLOl4Xef83bJtvN6,SpATywNh6bZuzm8s1ceuBUnMUAeoAHHw,16,12,5,14,3,0,7,0,41,5.857142857142857,1,0.0,2,5,13,3,10,0,1,7,0,23,18,1
2972,66767,hphlDgjkqVbyJnFgMbu9WAMmL2wONlSy,SpATywNh6bZuzm8s1ceuBUnMUAeoAHHw,13,20,0,28,2,4,6,1,61,8.714285714285714,1,0.0,14,0,21,2,6,4,7,6,1,37,24,0
2973,66769,j8UeSZFNUzzfzk2DFBytx4Rkr6FApV94,SpATywNh6bZuzm8s1ceuBUnMUAeoAHHw,4,4,3,0,0,0,1,0,8,1.1428571428571428,1,0.0,0,3,0,0,4,0,0,1,0,3,5,1
2974,66771,DSoedfH3iEqkDSoEfnR9hPK9fGA03nvE,SpATywNh6bZuzm8s1ceuBUnMUAeoAHHw,6,3,2,0,2,0,1,0,8,1.1428571428571428,1,0.0,0,2,0,2,3,0,0,1,0,4,4,1
2975,66772,3IQ5vbIjcGZGFJfWLKmxNcLXTnJQLHyr,SpATywNh6bZuzm8s1ceuBUnMUAeoAHHw,17,25,13,16,4,35,17,2,112,16.0,4,0.0,2,13,13,4,23,35,3,17,2,32,80,1
2976,66773,5KXpHHWqAiriAz89DseoECa9CF8nNmNg,G8EPVSXsOYB5YQWZGiz1aVq5Pgr2GrQu,2,0,0,0,0,0,2,0,2,0.2857142857142857,1,0.0,0,0,0,0,0,0,0,2,0,0,2,1
2977,66774,3imocgNxcBfwQHadpMof51TjC5xJp8PT,SpATywNh6bZuzm8s1ceuBUnMUAeoAHHw,9,9,6,0,4,0,8,0,27,3.857142857142857,2,0.0,1,6,0,4,8,0,0,8,0,11,16,1
2978,66777,FQiENNRH2NfeZWMamUs40Z7QmdDjNODH,SpATywNh6bZuzm8s1ceuBUnMUAeoAHHw,5,2,1,0,1,0,2,0,6,0.8571428571428571,1,0.0,0,1,0,1,2,0,0,2,0,2,4,1
2979,66786,qGRPIv5dAFSTdBTLUyG7n07ghfZFrtTR,SpATywNh6bZuzm8s1ceuBUnMUAeoAHHw,17,51,4,16,3,4,22,4,104,14.857142857142858,3,0.0,18,4,14,3,33,4,2,22,4,39,65,1
2980,66787,hphlDgjkqVbyJnFgMbu9WAMmL2wONlSy,G8EPVSXsOYB5YQWZGiz1aVq5Pgr2GrQu,9,10,1,0,0,1,8,0,20,2.857142857142857,1,0.0,3,1,0,0,7,1,0,8,0,4,16,1
2981,66791,YKDsG4vA9NLXfljPnrmnZIZC1s2Q0ugD,SpATywNh6bZuzm8s1ceuBUnMUAeoAHHw,5,2,1,0,1,0,4,0,8,1.1428571428571428,1,0.0,0,1,0,1,2,0,0,4,0,2,6,1
2982,66795,ee4pYUOGDieGavHZlg2HTSjfqraD5k7B,SpATywNh6bZuzm8s1ceuBUnMUAeoAHHw,13,10,0,18,0,0,6,1,35,5.0,1,0.0,5,0,15,0,5,0,3,6,1,20,15,1
2983,66814,x0EQgyUAdVGVXHM8VfLLFzp2FQY3yEsn,SpATywNh6bZuzm8s1ceuBUnMUAeoAHHw,8,6,3,0,3,0,3,0,15,2.142857142857143,1,0.0,2,3,0,3,4,0,0,3,0,8,7,0
2984,66817,to6uzLarCrneiGy62nJuyfDuz8bCYwik,G8EPVSXsOYB5YQWZGiz1aVq5Pgr2GrQu,54,71,22,98,13,9,19,2,234,33.42857142857143,4,0.0,39,22,64,13,32,9,34,19,2,138,96,1
2985,66819,j21aImOKDywGp9C5VIymBW05Q7mvVltH,SpATywNh6bZuzm8s1ceuBUnMUAeoAHHw,4,5,0,0,0,0,1,0,6,0.8571428571428571,1,0.0,0,0,0,0,5,0,0,1,0,0,6,1
2986,66821,JcMvDAHro8DuV6i3JIeUIujj4IscZiT7,G8EPVSXsOYB5YQWZGiz1aVq5Pgr2GrQu,13,10,3,22,0,1,4,0,40,5.714285714285714,1,0.0,7,3,16,0,3,1,6,4,0,26,14,0
2987,66831,grwjhoAI1dEZsOpkE7fbBAVHWaIfQbiU,SpATywNh6bZuzm8s1ceuBUnMUAeoAHHw,4,2,1,0,1,0,2,0,6,0.8571428571428571,1,0.0,0,1,0,1,2,0,0,2,0,2,4,1
2988,66836,GjmAjZkQ0i4VbB9kzslDSKYjTMxi0DJm,SpATywNh6bZuzm8s1ceuBUnMUAeoAHHw,10,14,8,0,6,1,2,0,31,4.428571428571429,1,0.0,3,8,0,6,11,1,0,2,0,17,14,1
2989,66840,jW6xo8o8ggQigxJzuOWpksdLscP0nmMK,RXDvfPUBYFlVdlueBFbLW0mhhAyGEqpt,9,11,9,0,7,0,2,0,29,4.142857142857143,1,0.0,1,9,0,7,10,0,0,2,0,17,12,1
2990,66842,KP9bG9uWRMGfX1tzS44KTvN8Cg66ynpe,SpATywNh6bZuzm8s1ceuBUnMUAeoAHHw,13,12,3,13,2,0,4,0,34,4.857142857142857,3,0.0,3,3,10,2,9,0,3,4,0,18,16,1
2991,66845,spo2AoBcB8z4JnQ75NfCsXxxs58G8kjU,SpATywNh6bZuzm8s1ceuBUnMUAeoAHHw,4,2,1,0,1,0,1,0,5,0.7142857142857143,1,0.0,0,1,0,1,2,0,0,1,0,2,3,0
2992,66849,Q089sE9VtgxkkGKk7SyD8fz5PShaeQQT,SpATywNh6bZuzm8s1ceuBUnMUAeoAHHw,6,2,0,0,0,14,5,3,24,3.4285714285714284,1,0.0,0,0,0,0,2,14,0,5,3,0,24,1
2993,66850,WREte9djoqLkGoMvPHsglYJ5ApOOE4Xa,SpATywNh6bZuzm8s1ceuBUnMUAeoAHHw,5,2,0,0,0,1,4,0,7,1.0,1,0.0,0,0,0,0,2,1,0,4,0,0,7,0
2994,66856,9Bmxb2kRkvmXtKdf1iC2KsdGSl1k4oD2,G8EPVSXsOYB5YQWZGiz1aVq5Pgr2GrQu,3,0,0,0,0,0,6,0,6,0.8571428571428571,4,0.0,0,0,0,0,0,0,0,6,0,0,6,1
2995,66863,xdClWt95AonMUbXmVncDz7pyQAF4u9BG,RXDvfPUBYFlVdlueBFbLW0mhhAyGEqpt,1,0,0,0,0,0,1,0,1,0.14285714285714285,1,0.0,0,0,0,0,0,0,0,1,0,0,1,1
2996,66867,t2MGYeUu0hRLKtqGYRo6b7Rz4YOZ5CAl,SpATywNh6bZuzm8s1ceuBUnMUAeoAHHw,8,3,1,0,1,1,8,0,14,2.0,2,0.0,0,1,0,1,3,1,0,8,0,2,12,1
2997,66876,lBWHzt16Kw5civcvlfzsyLbIMpskhKLb,SpATywNh6bZuzm8s1ceuBUnMUAeoAHHw,4,2,1,0,0,0,2,0,5,0.7142857142857143,1,0.0,0,1,0,0,2,0,0,2,0,1,4,1
2998,66882,RUyO8vGMdp7jhM6g17yji5ANjGox4I7a,G8EPVSXsOYB5YQWZGiz1aVq5Pgr2GrQu,14,38,13,6,9,1,2,7,76,10.857142857142858,1,0.0,16,13,4,9,22,1,2,2,7,42,34,1
2999,66901,jsqKkuSbErall5JnaWQXJQsGef5XwKOD,SpATywNh6bZuzm8s1ceuBUnMUAeoAHHw,9,13,6,0,1,4,9,1,34,4.857142857142857,2,0.0,0,6,0,1,13,4,0,9,1,7,27,1
3000,66902,SaCuUEx4yVWy7KEZ7c1LumXyYr79w4Rm,bWdj2GDclj5ofokWjzoa5jAwMkxCykd6,7,4,2,0,0,3,5,1,15,2.142857142857143,1,0.0,0,2,0,0,4,3,0,5,1,2,13,1
3001,66906,dEKCxHL9joqZNeQKkyzq4Y5b5GlTbyt0,SpATywNh6bZuzm8s1ceuBUnMUAeoAHHw,1,0,0,0,0,0,1,0,1,0.14285714285714285,1,0.0,0,0,0,0,0,0,0,1,0,0,1,1
3002,66912,i0LHbVo0MUWeo1slrPpQRlCoWzknlhLR,SpATywNh6bZuzm8s1ceuBUnMUAeoAHHw,6,6,1,0,0,0,3,0,10,1.4285714285714286,1,0.0,1,1,0,0,5,0,0,3,0,2,8,1
3003,66913,Pp6wRQkPti9Bk2fBcpI0VrxeT3AtZv4c,SpATywNh6bZuzm8s1ceuBUnMUAeoAHHw,13,42,7,16,3,4,10,0,82,11.714285714285714,3,0.0,7,7,14,3,35,4,2,10,0,31,51,1
3004,66919,4W9VDoom5TgPKJhY4YS0TxVzPBBhVmKe,SpATywNh6bZuzm8s1ceuBUnMUAeoAHHw,5,5,3,2,0,0,1,0,11,1.5714285714285714,1,0.0,1,3,2,0,4,0,0,1,0,6,5,1
3005,66921,HEyWCm29dAxf2gF6HX7SoCKEpp5xOaMH,SpATywNh6bZuzm8s1ceuBUnMUAeoAHHw,8,16,2,0,0,23,11,1,53,7.571428571428571,2,0.0,0,2,0,0,16,23,0,11,1,2,51,1
3006,66936,STtQLJYeEtdkd5hogRcAby24tBZrG3TQ,SpATywNh6bZuzm8s1ceuBUnMUAeoAHHw,1,0,0,0,0,0,1,0,1,0.14285714285714285,1,0.0,0,0,0,0,0,0,0,1,0,0,1,1
3007,66953,hgypFYGQkHCtSzjmFaIf3CToNAXniUea,bWdj2GDclj5ofokWjzoa5jAwMkxCykd6,4,4,0,0,2,0,3,0,9,1.2857142857142858,1,0.0,2,0,0,2,2,0,0,3,0,4,5,1
3008,66954,8Eqf4bSicFmRziRU1kFgF89C5yGB8WDX,bWdj2GDclj5ofokWjzoa5jAwMkxCykd6,7,26,7,0,6,16,20,0,75,10.714285714285714,3,0.0,0,7,0,6,26,16,0,20,0,13,62,1
3009,66957,19VrgqzLVY9ZBYQoB1uroAA02q94O1Zu,SpATywNh6bZuzm8s1ceuBUnMUAeoAHHw,11,8,0,21,0,1,4,1,35,5.0,1,0.0,2,0,17,0,6,1,4,4,1,19,16,1
3010,66958,VNn0ZSteI0TUWATSfv7oNQMdpP8UUblh,SpATywNh6bZuzm8s1ceuBUnMUAeoAHHw,17,33,14,8,5,9,18,1,88,12.571428571428571,2,0.0,6,14,8,5,27,9,0,18,1,33,55,1
3011,66963,HYIak5MajHEE4KscVQZXOCe1sQzZq7OB,G8EPVSXsOYB5YQWZGiz1aVq5Pgr2GrQu,7,7,1,0,0,0,3,0,11,1.5714285714285714,2,0.0,1,1,0,0,6,0,0,3,0,2,9,1
3012,66973,AtBEE9J055aDlITLvmg36iywfRw9ii2d,SpATywNh6bZuzm8s1ceuBUnMUAeoAHHw,16,13,6,15,3,0,11,0,48,6.857142857142857,2,0.0,2,6,12,3,11,0,3,11,0,23,25,1
3013,66977,vEpbzgzC6vVRH2ddUE3uoPla0NVwp3kL,SpATywNh6bZuzm8s1ceuBUnMUAeoAHHw,7,4,0,0,0,0,5,0,9,1.2857142857142858,1,0.0,0,0,0,0,4,0,0,5,0,0,9,1
3014,66996,vgJBdvzTqJ5MKR9sNPkrlU2Mvr3KdXZ3,SpATywNh6bZuzm8s1ceuBUnMUAeoAHHw,16,17,8,19,5,0,4,0,53,7.571428571428571,2,0.0,6,8,16,5,11,0,3,4,0,35,18,0
3015,66999,FfIijJSc7v6Gx20szDQGd4UKB6lngdbn,SpATywNh6bZuzm8s1ceuBUnMUAeoAHHw,4,2,1,0,1,0,1,0,5,0.7142857142857143,1,0.0,0,1,0,1,2,0,0,1,0,2,3,1
3016,67000,5TmlEBiIGuIt6aB6TwvG68U4RXEnGCj0,SpATywNh6bZuzm8s1ceuBUnMUAeoAHHw,4,2,1,0,1,0,1,0,5,0.7142857142857143,1,0.0,0,1,0,1,2,0,0,1,0,2,3,0
3017,67002,x0d0kPxQt2lqC4Ti0c8RfiJ0ufqJ2aAF,SpATywNh6bZuzm8s1ceuBUnMUAeoAHHw,4,2,1,0,0,1,2,0,6,0.8571428571428571,1,0.0,0,1,0,0,2,1,0,2,0,1,5,1
3018,67004,P2uvU61vWnBKPWmDU3fEsDqh9JFKsQoE,bWdj2GDclj5ofokWjzoa5jAwMkxCykd6,11,15,11,66,5,0,3,0,100,14.285714285714286,2,0.0,1,11,65,5,14,0,1,3,0,82,18,1
3019,67006,3KIB4La3IsOSQkcNKGmRWQWUPPUMWKbW,RXDvfPUBYFlVdlueBFbLW0mhhAyGEqpt,9,3,2,0,2,1,5,1,14,2.0,1,0.0,0,2,0,2,3,1,0,5,1,4,10,0
3020,67012,Id4UmIRRQiLXHoJYSjh5OCO1CRaFgQ2K,RXDvfPUBYFlVdlueBFbLW0mhhAyGEqpt,4,3,2,0,2,0,1,0,8,1.1428571428571428,1,0.0,0,2,0,2,3,0,0,1,0,4,4,1
3021,67014,1yJ7vGttwVZkfwO9DkOg0seBq4i9314Q,bWdj2GDclj5ofokWjzoa5jAwMkxCykd6,1,0,0,0,0,0,1,0,1,0.14285714285714285,1,0.0,0,0,0,0,0,0,0,1,0,0,1,1
3022,67015,knXx0VSX34ZZdw5j0pCDnRFFDbxG6IJ6,SpATywNh6bZuzm8s1ceuBUnMUAeoAHHw,13,15,8,3,5,0,6,0,37,5.285714285714286,2,0.0,4,8,3,5,11,0,0,6,0,20,17,0
3023,67022,qgATVDXI6hyNw5k2TylFI0Voj1oJ8GzP,RXDvfPUBYFlVdlueBFbLW0mhhAyGEqpt,4,2,1,0,1,0,1,0,5,0.7142857142857143,1,0.0,0,1,0,1,2,0,0,1,0,2,3,1
3024,67023,qgATVDXI6hyNw5k2TylFI0Voj1oJ8GzP,SpATywNh6bZuzm8s1ceuBUnMUAeoAHHw,2,0,0,0,0,0,2,0,2,0.2857142857142857,1,0.0,0,0,0,0,0,0,0,2,0,0,2,1
3025,67033,tPYh43YRHAzuf09xESxSKtWvST0aCsjn,SpATywNh6bZuzm8s1ceuBUnMUAeoAHHw,10,11,4,10,1,0,4,0,30,4.285714285714286,3,0.0,5,4,8,1,6,0,2,4,0,18,12,0
3026,67034,yZ9FndAKqVsKwZtO1B2JJJblefdbhZ02,SpATywNh6bZuzm8s1ceuBUnMUAeoAHHw,10,12,0,14,0,0,8,0,34,4.857142857142857,3,0.0,6,0,13,0,6,0,1,8,0,19,15,0
3027,67037,6RtjQ87TFCeYnCEQooYczzLrx8zugyat,SpATywNh6bZuzm8s1ceuBUnMUAeoAHHw,1,0,0,0,0,0,1,0,1,0.14285714285714285,1,0.0,0,0,0,0,0,0,0,1,0,0,1,1
3028,67040,Rf7b7AtnB3yMHMysfPwxe6fh0kofBsCX,G8EPVSXsOYB5YQWZGiz1aVq5Pgr2GrQu,6,7,3,0,2,0,6,0,18,2.5714285714285716,2,0.0,3,3,0,2,4,0,0,6,0,8,10,1
3029,67041,G2vTTAEhPpy1uiGVOSc3WfzCmuUhZyw6,SpATywNh6bZuzm8s1ceuBUnMUAeoAHHw,12,19,1,19,1,0,12,0,52,7.428571428571429,1,0.0,8,1,15,1,11,0,4,12,0,25,27,1
3030,67049,caAQbOI1NkkZKVF3oGPK3OdsY0lbDlYb,SpATywNh6bZuzm8s1ceuBUnMUAeoAHHw,10,14,6,0,3,0,8,3,34,4.857142857142857,2,0.0,0,6,0,3,14,0,0,8,3,9,25,1
3031,67051,fJHji2otGUDYDMFxwiigoqhPCAcWp4zZ,SpATywNh6bZuzm8s1ceuBUnMUAeoAHHw,5,2,1,0,1,0,2,0,6,0.8571428571428571,1,0.0,0,1,0,1,2,0,0,2,0,2,4,1
3032,67058,b5Gj1OyeYKLhLlGsleyNSSJpbJ2lneFj,RXDvfPUBYFlVdlueBFbLW0mhhAyGEqpt,19,9,6,24,4,0,3,0,46,6.571428571428571,1,0.0,2,6,24,4,7,0,0,3,0,36,10,1
3033,67059,3w7hN41KgzlGkT6XiQZqVbo1geJzchKr,G8EPVSXsOYB5YQWZGiz1aVq5Pgr2GrQu,5,1,1,0,1,0,4,0,7,1.0,2,0.0,0,1,0,1,1,0,0,4,0,2,5,1
3034,67061,OisrcH2Uqqf03TtDLM3YLpNZbhlSzcT1,SpATywNh6bZuzm8s1ceuBUnMUAeoAHHw,8,7,4,0,2,0,11,1,25,3.5714285714285716,1,0.0,0,4,0,2,7,0,0,11,1,6,19,1
3035,67076,llPRK5GJ1Fu42jqOdNFWOcUEenGG1vdv,SpATywNh6bZuzm8s1ceuBUnMUAeoAHHw,13,26,6,17,3,0,4,0,56,8.0,1,0.0,15,6,16,3,11,0,1,4,0,40,16,1
3036,67077,wDMKq3Xvq95ERd20zjEMEb0BtCbHx7BM,SpATywNh6bZuzm8s1ceuBUnMUAeoAHHw,15,26,10,22,2,6,11,1,78,11.142857142857142,4,0.0,8,10,20,2,18,6,2,11,1,40,38,0
3037,67080,CgsguvEs0KUN3Abw9Qjh5ZZT0chwXUSw,SpATywNh6bZuzm8s1ceuBUnMUAeoAHHw,17,35,10,18,3,105,13,1,185,26.428571428571427,4,0.0,10,10,17,3,25,105,1,13,1,40,145,0
3038,67087,CN11ovtPF8fJmUO54gCiYLygyrR54itQ,SpATywNh6bZuzm8s1ceuBUnMUAeoAHHw,8,11,6,0,2,0,2,0,21,3.0,2,0.0,0,6,0,2,11,0,0,2,0,8,13,0
3039,67096,N7x6rez9AavUVus2y33zQwbgvW9e4FwN,SpATywNh6bZuzm8s1ceuBUnMUAeoAHHw,14,18,6,17,3,0,2,0,46,6.571428571428571,1,0.0,10,6,16,3,8,0,1,2,0,35,11,1
3040,67099,rwVFzRApiQw3vAU5Rpa6do3mD0uc5CXG,SpATywNh6bZuzm8s1ceuBUnMUAeoAHHw,15,41,1,19,1,5,11,1,79,11.285714285714286,4,0.0,15,1,16,1,26,5,3,11,1,33,46,1
3041,67104,8IdT3BpziJuUIg1uIZIVpj0NWmeXuSS8,G8EPVSXsOYB5YQWZGiz1aVq5Pgr2GrQu,32,57,4,94,4,6,14,1,180,25.714285714285715,3,0.0,37,4,79,4,20,6,15,14,1,124,56,1
3042,67111,KOlp6BtLHFtxPjNN0KYQVjD6WvIwSYtA,SpATywNh6bZuzm8s1ceuBUnMUAeoAHHw,11,26,0,14,0,9,7,0,56,8.0,2,0.0,11,0,13,0,15,9,1,7,0,24,32,0
3043,67114,G7XB7BvktED5k0pfiNMFlIFMFGCreTGp,G8EPVSXsOYB5YQWZGiz1aVq5Pgr2GrQu,6,12,1,0,3,0,3,0,19,2.7142857142857144,1,0.0,10,1,0,3,2,0,0,3,0,14,5,1
3044,67116,KhEJGS2oZuX97oPJJp9Z5yTu0JSgEwNN,SpATywNh6bZuzm8s1ceuBUnMUAeoAHHw,11,26,2,11,0,1,5,0,45,6.428571428571429,1,0.0,10,2,10,0,16,1,1,5,0,22,23,1
3045,67122,TuRtla6uL7YMLA6vfJsBKtiNWjCxP0OZ,RXDvfPUBYFlVdlueBFbLW0mhhAyGEqpt,10,26,13,0,3,0,3,0,45,6.428571428571429,2,0.0,9,13,0,3,17,0,0,3,0,25,20,1
3046,67128,dL3mb41Bm8AhTujPtToBfgUCEqTQ4yms,G8EPVSXsOYB5YQWZGiz1aVq5Pgr2GrQu,7,18,3,0,1,0,3,0,25,3.5714285714285716,2,0.0,3,3,0,1,15,0,0,3,0,7,18,1
3047,67133,iU8sg5PBq7mTADvs0COG4jXH4nM6hq2B,SpATywNh6bZuzm8s1ceuBUnMUAeoAHHw,18,39,13,6,8,1,14,1,82,11.714285714285714,3,0.0,18,13,6,8,21,1,0,14,1,45,37,1
3048,67137,iZa1NC6aT0Npl7jBiTIydtSYeYsdEobQ,bWdj2GDclj5ofokWjzoa5jAwMkxCykd6,3,0,0,0,0,0,2,1,3,0.42857142857142855,1,0.0,0,0,0,0,0,0,0,2,1,0,3,1
3049,67152,gaiJtHdepYI8ZLS7HsizBoGVbYaMsssC,bWdj2GDclj5ofokWjzoa5jAwMkxCykd6,2,0,0,0,0,0,2,0,2,0.2857142857142857,1,0.0,0,0,0,0,0,0,0,2,0,0,2,1
3050,67156,3vhG5LSOA1YcHy71CJJOxAgCZ2y6XT8e,SpATywNh6bZuzm8s1ceuBUnMUAeoAHHw,15,31,11,23,4,0,9,0,78,11.142857142857142,2,0.0,15,11,20,4,16,0,3,9,0,50,28,1
3051,67158,07nBIjV5wvxeipK7Zz3uxWH8hv0V5VvH,SpATywNh6bZuzm8s1ceuBUnMUAeoAHHw,16,25,9,11,4,5,7,1,62,8.857142857142858,3,0.0,11,9,10,4,14,5,1,7,1,34,28,0
3052,67159,CQ3lDAshmWjO1E4GBV1wnteO6NqYgq2s,G8EPVSXsOYB5YQWZGiz1aVq5Pgr2GrQu,30,63,1,68,5,8,7,1,153,21.857142857142858,2,0.0,23,1,53,5,40,8,15,7,1,82,71,1
3053,67164,ztcM8oJ9cYwAQxtlfaWWEY7el55tNp3L,SpATywNh6bZuzm8s1ceuBUnMUAeoAHHw,13,60,15,0,13,12,17,2,119,17.0,3,0.0,2,15,0,13,58,12,0,17,2,30,89,1
3054,67171,ILwuNMaKW9cfodB9O42BE2MDGjshUqyt,SpATywNh6bZuzm8s1ceuBUnMUAeoAHHw,10,12,0,0,0,0,7,0,19,2.7142857142857144,2,0.0,0,0,0,0,12,0,0,7,0,0,19,1
3055,67175,U9sp7fhhso4I4hUMdZYxdb4jjkzhb9EZ,SpATywNh6bZuzm8s1ceuBUnMUAeoAHHw,16,16,8,20,6,6,20,8,84,12.0,2,0.0,3,8,17,6,13,6,3,20,8,34,50,1
3056,67178,29637v4JeTV4lmXkjMER9DNWcGaMyJ4v,G8EPVSXsOYB5YQWZGiz1aVq5Pgr2GrQu,3,2,1,0,0,0,1,0,4,0.5714285714285714,1,0.0,0,1,0,0,2,0,0,1,0,1,3,1
3057,67184,tYMYXyJdOChlQSPrkrVNlrHj5tCYzHnQ,bWdj2GDclj5ofokWjzoa5jAwMkxCykd6,11,15,3,50,4,0,1,0,73,10.428571428571429,2,0.0,8,3,47,4,7,0,3,1,0,62,11,1
3058,67185,yCubUbsDW6wXrTu9ngQq5pTghAOVDrjs,SpATywNh6bZuzm8s1ceuBUnMUAeoAHHw,1,0,0,0,0,0,1,0,1,0.14285714285714285,1,0.0,0,0,0,0,0,0,0,1,0,0,1,1
3059,67195,MPLO46zeqSAmGFkKKuWvnx6pcJItRavU,SpATywNh6bZuzm8s1ceuBUnMUAeoAHHw,16,31,13,21,3,6,17,4,95,13.571428571428571,2,0.0,11,13,18,3,20,6,3,17,4,45,50,0
3060,67198,MozrQftkFsk2HJMPpZe4xQGho83nBBbJ,SpATywNh6bZuzm8s1ceuBUnMUAeoAHHw,9,8,3,0,1,1,6,1,20,2.857142857142857,1,0.0,1,3,0,1,7,1,0,6,1,5,15,1
3061,67207,jn6VKgJPC4fyRRCl6zZirG5zLpU8fnC6,SpATywNh6bZuzm8s1ceuBUnMUAeoAHHw,2,0,0,0,0,0,2,0,2,0.2857142857142857,1,0.0,0,0,0,0,0,0,0,2,0,0,2,1
3062,67209,lXVULXqG43l726A9V3NFlFs9kvovJQx4,SpATywNh6bZuzm8s1ceuBUnMUAeoAHHw,10,7,5,0,4,0,4,0,20,2.857142857142857,2,0.0,0,5,0,4,7,0,0,4,0,9,11,1
3063,67213,IHjTTbtSKJcagLP8HZiMzotl9tnHf7ev,SpATywNh6bZuzm8s1ceuBUnMUAeoAHHw,13,5,2,12,2,7,7,2,37,5.285714285714286,2,0.0,2,2,9,2,3,7,3,7,2,15,22,0
3064,67220,5UJZmEar1AX3gQXOzkh3MnQcYdErI17M,SpATywNh6bZuzm8s1ceuBUnMUAeoAHHw,8,2,1,0,1,1,8,1,14,2.0,1,0.0,0,1,0,1,2,1,0,8,1,2,12,1
3065,67224,AszzZcQ3DzjVCWiO17ucpHFrMmRC8MRV,SpATywNh6bZuzm8s1ceuBUnMUAeoAHHw,15,61,2,31,1,74,34,4,207,29.571428571428573,2,0.0,15,2,25,1,46,74,6,34,4,43,164,0
3066,67231,DBWpurAvW8awkr3pqCDDF8bsim2D57Vj,G8EPVSXsOYB5YQWZGiz1aVq5Pgr2GrQu,14,7,5,0,6,0,8,1,27,3.857142857142857,1,0.0,2,5,0,6,5,0,0,8,1,13,14,1
3067,67246,kA48LgfRPY6vHgTrWK5pJnx3RsuxrRTH,SpATywNh6bZuzm8s1ceuBUnMUAeoAHHw,10,6,3,1,2,0,3,0,15,2.142857142857143,1,0.0,1,3,1,2,5,0,0,3,0,7,8,1
3068,67247,q2AJDoW2EuJlq2uo87Sn9QLp36IwXzSv,SpATywNh6bZuzm8s1ceuBUnMUAeoAHHw,8,3,1,0,2,0,5,0,11,1.5714285714285714,2,0.0,0,1,0,2,3,0,0,5,0,3,8,1
3069,67248,8R7wkJYHxnNXLQq4dxMbBtsEclGat3j9,bWdj2GDclj5ofokWjzoa5jAwMkxCykd6,1,0,0,0,0,0,1,0,1,0.14285714285714285,1,0.0,0,0,0,0,0,0,0,1,0,0,1,1
3070,67260,ZULZi8TAkwGNSYKMYJ57kBAZvrMte2xF,SpATywNh6bZuzm8s1ceuBUnMUAeoAHHw,15,28,13,16,7,0,5,0,69,9.857142857142858,1,0.0,4,13,14,7,24,0,2,5,0,38,31,1
3071,67262,4hqkXkyq5mjsuNE9t6Q3zzOu4OQAJfqm,SpATywNh6bZuzm8s1ceuBUnMUAeoAHHw,12,19,9,10,4,0,5,0,47,6.714285714285714,4,0.0,5,9,10,4,14,0,0,5,0,28,19,1
3072,67264,uxiQAPJTLsI808GQpb2cYmEtdBDdQ3cx,SpATywNh6bZuzm8s1ceuBUnMUAeoAHHw,14,15,6,9,3,0,5,0,38,5.428571428571429,2,0.0,8,6,9,3,7,0,0,5,0,26,12,1
3073,67265,hfSXPDFaR2dzrQsij0JMBqqFRCNkzN0i,SpATywNh6bZuzm8s1ceuBUnMUAeoAHHw,6,3,1,0,1,0,2,0,7,1.0,1,0.0,0,1,0,1,3,0,0,2,0,2,5,1
3074,67266,X0qiYFDfIWOz74gDCjJtjtlJKUHThKgm,SpATywNh6bZuzm8s1ceuBUnMUAeoAHHw,17,37,18,18,6,19,10,1,109,15.571428571428571,4,0.0,13,18,15,6,24,19,3,10,1,52,57,0
3075,67267,d4AhROqi4DjVmWKfbbbhi19n7hcGPkSg,RXDvfPUBYFlVdlueBFbLW0mhhAyGEqpt,22,29,1,44,2,6,10,4,96,13.714285714285714,5,0.0,5,1,44,2,24,6,0,10,4,52,44,0
3076,67272,28W5CJrYp73LQgjHivjzAixkCQuqTCh6,bWdj2GDclj5ofokWjzoa5jAwMkxCykd6,4,2,1,0,1,0,2,0,6,0.8571428571428571,2,0.0,0,1,0,1,2,0,0,2,0,2,4,1
3077,67275,d7AooNZI1FOSZnZfgBmuAUMu5eysX9mb,SpATywNh6bZuzm8s1ceuBUnMUAeoAHHw,12,13,8,14,6,0,2,0,43,6.142857142857143,1,0.0,4,8,11,6,9,0,3,2,0,29,14,1
3078,67278,frK0oim7qtvURbYrZJ5gIFPqgQt63IEt,G8EPVSXsOYB5YQWZGiz1aVq5Pgr2GrQu,9,3,2,0,0,7,9,1,22,3.142857142857143,2,0.0,0,2,0,0,3,7,0,9,1,2,20,0
3079,67287,r9n2Z7iYkL5tKegLJwMIOxTHQqxopYp0,G8EPVSXsOYB5YQWZGiz1aVq5Pgr2GrQu,7,5,3,0,2,0,2,0,12,1.7142857142857142,2,0.0,0,3,0,2,5,0,0,2,0,5,7,0
3080,67288,PXVYYQlV1TwZ9b9f7GhoFUXTgABGZcBY,SpATywNh6bZuzm8s1ceuBUnMUAeoAHHw,17,27,11,19,5,3,16,2,83,11.857142857142858,2,0.0,12,11,16,5,15,3,3,16,2,44,39,0
3081,67297,mZ0efv4ffU6kCJ0Ro6mv6OGSULVT9odf,SpATywNh6bZuzm8s1ceuBUnMUAeoAHHw,1,0,0,0,0,0,1,0,1,0.14285714285714285,1,0.0,0,0,0,0,0,0,0,1,0,0,1,1
3082,67300,3QGIXvN5AKtl5SyCz6EZh0jA8JPL5Nkx,bWdj2GDclj5ofokWjzoa5jAwMkxCykd6,6,9,1,0,0,0,3,0,13,1.8571428571428572,2,0.0,0,1,0,0,9,0,0,3,0,1,12,1
3083,67302,CrdUJ25e700hCpU6YbocYb3uKRMcCPjz,SpATywNh6bZuzm8s1ceuBUnMUAeoAHHw,9,15,0,4,0,0,2,0,21,3.0,3,0.0,0,0,3,0,15,0,1,2,0,3,18,1
3084,67303,xrGYbDqan6dLH2p778nfhYmmVfnrrpam,SpATywNh6bZuzm8s1ceuBUnMUAeoAHHw,2,0,0,0,0,0,2,0,2,0.2857142857142857,1,0.0,0,0,0,0,0,0,0,2,0,0,2,1
3085,67308,T73fWQC3H2PhmOiodFuHvvahENx7TmZo,SpATywNh6bZuzm8s1ceuBUnMUAeoAHHw,7,6,4,0,3,0,1,0,14,2.0,1,0.0,1,4,0,3,5,0,0,1,0,8,6,1
3086,67314,CVINZY0qqZyjVQC8d4yq3w0fqkMGJBVL,G8EPVSXsOYB5YQWZGiz1aVq5Pgr2GrQu,21,16,2,14,2,0,7,1,42,6.0,1,0.0,0,2,12,2,16,0,2,7,1,16,26,1
3087,67328,HurK028hfari9vlQzhAchljjKEaGMu7l,SpATywNh6bZuzm8s1ceuBUnMUAeoAHHw,5,9,4,0,2,0,4,0,19,2.7142857142857144,3,0.0,0,4,0,2,9,0,0,4,0,6,13,1
3088,67332,0xyoG1WvCKM42y6l9xPNGRXw8gklJB9a,G8EPVSXsOYB5YQWZGiz1aVq5Pgr2GrQu,14,34,7,8,5,9,5,0,68,9.714285714285714,2,0.0,2,7,6,5,32,9,2,5,0,20,48,1
3089,67345,WACfmqzUT9wOhkm3QdtpYOSdY2CeIJWa,RXDvfPUBYFlVdlueBFbLW0mhhAyGEqpt,44,42,25,57,14,3,13,3,157,22.428571428571427,2,0.0,10,25,52,14,32,3,5,13,3,101,56,1
3090,67346,DDhKDNB6fEAHv06PdV80Zz5GVaFianlg,SpATywNh6bZuzm8s1ceuBUnMUAeoAHHw,11,13,5,0,1,4,9,1,33,4.714285714285714,1,0.0,3,5,0,1,10,4,0,9,1,9,24,1
3091,67348,GQMirxB5y3FtUmix76KGcpTxWntGgKiV,RXDvfPUBYFlVdlueBFbLW0mhhAyGEqpt,44,29,18,50,12,8,5,0,122,17.428571428571427,1,0.0,9,18,48,12,20,8,2,5,0,87,35,1
3092,67353,VWEcCKiwp28lQZuBYYNslDL0523gk0Z6,G8EPVSXsOYB5YQWZGiz1aVq5Pgr2GrQu,16,19,7,8,7,0,4,1,46,6.571428571428571,1,0.0,10,7,5,7,9,0,3,4,1,29,17,1
3093,67354,ZdDSfnnRjfjHFmnDyPudXjLUHiOgLvKy,SpATywNh6bZuzm8s1ceuBUnMUAeoAHHw,4,2,0,0,0,0,2,0,4,0.5714285714285714,1,0.0,0,0,0,0,2,0,0,2,0,0,4,1
3094,67359,SODa9wZLHSXHCkQdc5G9XFSaZePE5xpY,bWdj2GDclj5ofokWjzoa5jAwMkxCykd6,1,0,0,0,0,0,1,0,1,0.14285714285714285,1,0.0,0,0,0,0,0,0,0,1,0,0,1,1
3095,67360,V5bKpsSihRb2F9h32bBQPUZX9j9nvFi3,SpATywNh6bZuzm8s1ceuBUnMUAeoAHHw,5,5,0,0,0,0,2,0,7,1.0,1,0.0,0,0,0,0,5,0,0,2,0,0,7,1
3096,67362,a5BZ9otCoBYjX9WVbUSqK2dp356IUlVP,bWdj2GDclj5ofokWjzoa5jAwMkxCykd6,2,0,0,0,0,0,2,0,2,0.2857142857142857,1,0.0,0,0,0,0,0,0,0,2,0,0,2,1
3097,67371,Ofc6ixmmoavYN92PkloL7C1g0H36jbU2,SpATywNh6bZuzm8s1ceuBUnMUAeoAHHw,10,11,5,0,3,0,8,1,28,4.0,3,0.0,0,5,0,3,11,0,0,8,1,8,20,1
3098,67377,w2OXuLJJs4MYqj6mF4JPNXoMIMuUu4d7,SpATywNh6bZuzm8s1ceuBUnMUAeoAHHw,6,5,2,0,1,2,3,0,13,1.8571428571428572,1,0.0,0,2,0,1,5,2,0,3,0,3,10,1
3099,67381,lPTnc5ZrBauZXbwYcDNNjt3Gvgvmp9Cq,SpATywNh6bZuzm8s1ceuBUnMUAeoAHHw,5,5,3,0,1,0,3,0,12,1.7142857142857142,2,0.0,0,3,0,1,5,0,0,3,0,4,8,1
3100,67382,ib1Tw9jwnFk22Zeb4pY0FX5aHNkeyMBZ,SpATywNh6bZuzm8s1ceuBUnMUAeoAHHw,3,3,1,0,0,0,1,0,5,0.7142857142857143,1,0.0,0,1,0,0,3,0,0,1,0,1,4,1
3101,67388,ALYZFAVviUOGzyN4znk46d3PmVgvtUAM,bWdj2GDclj5ofokWjzoa5jAwMkxCykd6,4,2,0,0,0,0,2,2,6,0.8571428571428571,1,0.0,0,0,0,0,2,0,0,2,2,0,6,1
3102,67389,k5fKzDcQyLOb8CsK2DtBEPxysEHaDdpC,RXDvfPUBYFlVdlueBFbLW0mhhAyGEqpt,6,12,3,0,1,3,4,1,24,3.4285714285714284,2,0.0,0,3,0,1,12,3,0,4,1,4,20,1
3103,67394,5fHLQXAfhzEdTjeeb4rbhkUBfbZKOD1P,SpATywNh6bZuzm8s1ceuBUnMUAeoAHHw,6,9,1,0,0,2,4,0,16,2.2857142857142856,1,0.0,0,1,0,0,9,2,0,4,0,1,15,1
3104,67405,5MnZ5TXikbZdya4aF9I9IoQXVWF4ujt6,SpATywNh6bZuzm8s1ceuBUnMUAeoAHHw,2,0,0,0,0,0,3,0,3,0.42857142857142855,1,0.0,0,0,0,0,0,0,0,3,0,0,3,1
3105,67406,KglHKNjP3QUQRobKP7GTczISSfhOt7DT,SpATywNh6bZuzm8s1ceuBUnMUAeoAHHw,1,0,0,0,0,0,1,0,1,0.14285714285714285,1,0.0,0,0,0,0,0,0,0,1,0,0,1,1
3106,67418,lCMgevd3r8NsQWpObW4O6eaYbm6xHejf,bWdj2GDclj5ofokWjzoa5jAwMkxCykd6,8,6,4,0,3,0,3,0,16,2.2857142857142856,2,0.0,0,4,0,3,6,0,0,3,0,7,9,1
3107,67421,DjTSUM8no03TdLiv7ibkGW8BkXCgFLYB,bWdj2GDclj5ofokWjzoa5jAwMkxCykd6,11,22,11,16,9,0,6,0,64,9.142857142857142,2,0.0,4,11,14,9,18,0,2,6,0,38,26,1
3108,67424,kuV8TXv5cFVPIWK37fDR8nnl0vrHyjjA,RXDvfPUBYFlVdlueBFbLW0mhhAyGEqpt,43,81,47,82,8,6,11,2,237,33.857142857142854,3,0.0,11,47,76,8,70,6,6,11,2,142,95,0
3109,67427,vS0PO2z5tTpDl1S200qdqNDkFjNmdjxd,G8EPVSXsOYB5YQWZGiz1aVq5Pgr2GrQu,12,9,1,30,0,0,3,0,43,6.142857142857143,1,0.0,1,1,26,0,8,0,4,3,0,28,15,1
3110,67429,JY3pL2MJnhOGuIufYZaXnkXrdE9eR9kZ,SpATywNh6bZuzm8s1ceuBUnMUAeoAHHw,7,3,2,0,2,0,2,0,9,1.2857142857142858,1,0.0,0,2,0,2,3,0,0,2,0,4,5,1
3111,67431,ic21uM8q7hG6lYEnCwOGpdZRk8GzB2Q4,bWdj2GDclj5ofokWjzoa5jAwMkxCykd6,4,3,1,0,1,0,1,0,6,0.8571428571428571,1,0.0,0,1,0,1,3,0,0,1,0,2,4,1
3112,67435,gK0C2Qn10uFCDrXyxIuukzeUErx51I1a,SpATywNh6bZuzm8s1ceuBUnMUAeoAHHw,13,34,1,20,2,2,7,0,66,9.428571428571429,3,0.0,16,1,18,2,18,2,2,7,0,37,29,0
3113,67437,H1gNXDemnE2i9lW82GrGfdWk3AATsmHy,SpATywNh6bZuzm8s1ceuBUnMUAeoAHHw,13,15,6,6,5,4,2,0,38,5.428571428571429,1,0.0,8,6,6,5,7,4,0,2,0,25,13,0
3114,67444,Cow0Edw3V8JD4s2oOxNrhyd18ZVv78TG,SpATywNh6bZuzm8s1ceuBUnMUAeoAHHw,6,7,3,0,2,0,1,0,13,1.8571428571428572,1,0.0,0,3,0,2,7,0,0,1,0,5,8,1
3115,67445,Q9jQ2QVFcDk6rCEN1ap0bZmI7VqzGuqs,SpATywNh6bZuzm8s1ceuBUnMUAeoAHHw,13,18,0,21,0,7,6,1,53,7.571428571428571,2,0.0,2,0,17,0,16,7,4,6,1,19,34,0
3116,67454,7KhKGJPxu4uQKYHNs7O3NjmuTH6NjrVY,bWdj2GDclj5ofokWjzoa5jAwMkxCykd6,9,42,25,4,7,18,28,2,126,18.0,3,0.0,2,25,3,7,40,18,1,28,2,37,89,0
3117,67458,gjY6BujcNO3C8usrnDcYxkNzXuI0fCEe,SpATywNh6bZuzm8s1ceuBUnMUAeoAHHw,8,6,4,0,3,0,4,0,17,2.4285714285714284,1,0.0,0,4,0,3,6,0,0,4,0,7,10,1
3118,67464,uBWT9p90Ea0JVvR5wbRV9EQLPt0ehYR1,SpATywNh6bZuzm8s1ceuBUnMUAeoAHHw,14,26,0,19,0,10,14,0,69,9.857142857142858,3,0.0,10,0,16,0,16,10,3,14,0,26,43,1
3119,67466,6yy5YFhebeCVEWPcZqK4jg9qO8ru1OT4,SpATywNh6bZuzm8s1ceuBUnMUAeoAHHw,13,14,2,23,1,1,6,0,47,6.714285714285714,3,0.0,3,2,19,1,11,1,4,6,0,25,22,1
3120,67467,ZLbvkY9GfOSzox7JCIcmWczltkUqxVjR,SpATywNh6bZuzm8s1ceuBUnMUAeoAHHw,7,6,4,0,2,0,4,0,16,2.2857142857142856,1,0.0,0,4,0,2,6,0,0,4,0,6,10,1
3121,67468,lHCmVtLnmElXqFcol1pTzGnaqp21GEs7,RXDvfPUBYFlVdlueBFbLW0mhhAyGEqpt,3,0,0,0,0,0,2,2,4,0.5714285714285714,1,0.0,0,0,0,0,0,0,0,2,2,0,4,1
3122,67469,7tCVHfGANSkwc2DzOsbidXgZOw6Q8q5f,G8EPVSXsOYB5YQWZGiz1aVq5Pgr2GrQu,9,4,3,0,3,0,2,0,12,1.7142857142857142,1,0.0,0,3,0,3,4,0,0,2,0,6,6,1
3123,67474,XQsLTRxBgT09jhwR2kw4g3k34p5O8kHV,bWdj2GDclj5ofokWjzoa5jAwMkxCykd6,10,16,9,0,7,0,5,0,37,5.285714285714286,3,0.0,3,9,0,7,13,0,0,5,0,19,18,1
3124,67483,vEVxgcd4BTOgXUZ4VmhnVVivaAZ5TwNb,bWdj2GDclj5ofokWjzoa5jAwMkxCykd6,8,19,9,0,1,0,14,0,43,6.142857142857143,2,0.0,2,9,0,1,17,0,0,14,0,12,31,1
3125,67486,Ey4V2u8lgXOqStmlXh5LfVpeA2fR57Ho,SpATywNh6bZuzm8s1ceuBUnMUAeoAHHw,1,0,0,0,0,0,1,0,1,0.14285714285714285,1,0.0,0,0,0,0,0,0,0,1,0,0,1,1
3126,67492,pUaHa5R2nATh2lieQIvoIQ34ofl1qMpg,RXDvfPUBYFlVdlueBFbLW0mhhAyGEqpt,41,40,2,102,4,1,10,1,160,22.857142857142858,2,0.0,15,2,91,4,25,1,11,10,1,112,48,1
3127,67510,9by6FuLW9p6hAe2x8b5HjrOAjJeqk2av,SpATywNh6bZuzm8s1ceuBUnMUAeoAHHw,17,20,12,8,6,5,6,1,58,8.285714285714286,2,0.0,5,12,8,6,15,5,0,6,1,31,27,0
3128,67511,XiaZKMFLZltgVmLipzSXdXFKLHeDtV4U,SpATywNh6bZuzm8s1ceuBUnMUAeoAHHw,6,7,3,0,1,0,4,0,15,2.142857142857143,2,0.0,0,3,0,1,7,0,0,4,0,4,11,1
3129,67513,XKOZTIyRECata3wyZZEEtiKIhGnxgB74,SpATywNh6bZuzm8s1ceuBUnMUAeoAHHw,5,2,1,0,1,0,3,0,7,1.0,1,0.0,0,1,0,1,2,0,0,3,0,2,5,1
3130,67514,cCePdsnJSYHqdiZSbXBQK6xp3gMbJSPB,SpATywNh6bZuzm8s1ceuBUnMUAeoAHHw,8,2,1,0,1,0,4,1,9,1.2857142857142858,1,0.0,0,1,0,1,2,0,0,4,1,2,7,1
3131,67518,hd2F6jShBoDgDRbyWyB2cglMktEJbDcH,SpATywNh6bZuzm8s1ceuBUnMUAeoAHHw,5,2,1,0,1,0,3,0,7,1.0,1,0.0,0,1,0,1,2,0,0,3,0,2,5,1
3132,67532,GnIRbc6SlMVQELxTtsBRscVXZT2NaPnc,bWdj2GDclj5ofokWjzoa5jAwMkxCykd6,6,10,1,0,0,0,7,0,18,2.5714285714285716,2,0.0,0,1,0,0,10,0,0,7,0,1,17,1
3133,67535,HMMCRStJmM0GACTX8KnkMjogoI7SHUjo,SpATywNh6bZuzm8s1ceuBUnMUAeoAHHw,7,3,1,0,1,0,4,1,10,1.4285714285714286,1,0.0,0,1,0,1,3,0,0,4,1,2,8,1
3134,67539,ZhvYiagkjSANqD9iooXU2LPvYt7TDBNe,G8EPVSXsOYB5YQWZGiz1aVq5Pgr2GrQu,4,3,1,0,1,0,1,0,6,0.8571428571428571,1,0.0,1,1,0,1,2,0,0,1,0,3,3,1
3135,67542,87BKS3OvioYx6sBWp6JvkL3oGnn9HR6v,SpATywNh6bZuzm8s1ceuBUnMUAeoAHHw,6,2,0,0,1,0,6,0,9,1.2857142857142858,1,0.0,0,0,0,1,2,0,0,6,0,1,8,1
3136,67550,ScQd2YUPQVjLNV28id8viiUK1faGo8Du,SpATywNh6bZuzm8s1ceuBUnMUAeoAHHw,16,33,13,5,6,15,16,0,88,12.571428571428571,2,0.0,10,13,5,6,23,15,0,16,0,34,54,1
3137,67560,KpidFAO2tkY7K2KKYbeq2b9OWhsW5M4B,SpATywNh6bZuzm8s1ceuBUnMUAeoAHHw,1,0,0,0,0,0,1,0,1,0.14285714285714285,1,0.0,0,0,0,0,0,0,0,1,0,0,1,1
3138,67564,TyrR2674qqrmqDfJA1ba19pBHw30wbZn,bWdj2GDclj5ofokWjzoa5jAwMkxCykd6,9,11,3,2,2,0,7,1,26,3.7142857142857144,2,0.0,4,3,2,2,7,0,0,7,1,11,15,1
3139,67566,tYJFbmbzeY9dNgPSZvFhNskxnqvhh3AK,SpATywNh6bZuzm8s1ceuBUnMUAeoAHHw,16,12,6,8,3,5,7,2,43,6.142857142857143,2,0.0,4,6,6,3,8,5,2,7,2,19,24,0
3140,67572,HMOOD0QNsPiJ6FSYOiE4GQjvcEPtEXiW,SpATywNh6bZuzm8s1ceuBUnMUAeoAHHw,15,17,5,12,3,0,5,0,42,6.0,2,0.0,7,5,9,3,10,0,3,5,0,24,18,0
3141,67579,JsUpucQyiTLV5gDB7KrgqzRdiUsoUyeZ,bWdj2GDclj5ofokWjzoa5jAwMkxCykd6,1,0,0,0,0,0,1,0,1,0.14285714285714285,1,0.0,0,0,0,0,0,0,0,1,0,0,1,1
3142,67588,KgPlJUOxzo6K50clHm6VhLAZdTWxAeXA,SpATywNh6bZuzm8s1ceuBUnMUAeoAHHw,10,20,11,4,6,2,17,0,60,8.571428571428571,3,0.0,0,11,4,6,20,2,0,17,0,21,39,1
3143,67589,PiJ3gX6gddDaZL8DcE6EIcui1JUSTcfU,SpATywNh6bZuzm8s1ceuBUnMUAeoAHHw,16,13,7,6,4,16,5,1,52,7.428571428571429,1,0.0,3,7,6,4,10,16,0,5,1,20,32,1
3144,67590,iNC1K3GLRLEbKnkKM9DRjQmgl0TV31hj,SpATywNh6bZuzm8s1ceuBUnMUAeoAHHw,8,6,3,0,2,0,3,0,14,2.0,1,0.0,0,3,0,2,6,0,0,3,0,5,9,1
3145,67594,MwsjD881hF2KUCEG3rXUPSq3GKMfMo2d,SpATywNh6bZuzm8s1ceuBUnMUAeoAHHw,5,7,2,0,2,0,1,0,12,1.7142857142857142,1,0.0,0,2,0,2,7,0,0,1,0,4,8,0
3146,67595,FMyTD79DpzQKrXEJ9281Xlgi6vC7oMRz,SpATywNh6bZuzm8s1ceuBUnMUAeoAHHw,17,17,7,17,5,8,10,2,66,9.428571428571429,1,0.0,8,7,16,5,9,8,1,10,2,36,30,1
3147,67596,HMOOD0QNsPiJ6FSYOiE4GQjvcEPtEXiW,bWdj2GDclj5ofokWjzoa5jAwMkxCykd6,5,7,3,0,2,0,2,0,14,2.0,2,0.0,0,3,0,2,7,0,0,2,0,5,9,1
3148,67604,L7L1tCD13b9bwYB3itcIQLsWY4ZOzl4s,bWdj2GDclj5ofokWjzoa5jAwMkxCykd6,6,5,1,0,1,0,2,0,9,1.2857142857142858,1,0.0,0,1,0,1,5,0,0,2,0,2,7,1
3149,67606,zZJSO6J2IdlSRtL9i78S9ARTcFOb9HLo,SpATywNh6bZuzm8s1ceuBUnMUAeoAHHw,14,17,9,17,7,0,3,0,53,7.571428571428571,2,0.0,6,9,16,7,11,0,1,3,0,38,15,1
3150,67616,GkpBYL5A7XxQyiiOJwD69PHsUVDvMfPz,SpATywNh6bZuzm8s1ceuBUnMUAeoAHHw,13,10,7,0,4,0,7,1,29,4.142857142857143,3,0.0,0,7,0,4,10,0,0,7,1,11,18,0
3151,67621,n288BYpWLuFVQQ2eIcifxwEJn9u582IB,G8EPVSXsOYB5YQWZGiz1aVq5Pgr2GrQu,25,45,18,0,10,0,13,1,87,12.428571428571429,2,0.0,21,18,0,10,24,0,0,13,1,49,38,1
3152,67622,Sl7LGszo87N2dywG99gPMorFDWvvcTbU,SpATywNh6bZuzm8s1ceuBUnMUAeoAHHw,17,30,15,12,4,2,8,1,72,10.285714285714286,2,0.0,11,15,11,4,19,2,1,8,1,41,31,1
3153,67627,8AVylVqrvC0I5BhB8uK5ffluG4JxIZF6,SpATywNh6bZuzm8s1ceuBUnMUAeoAHHw,1,0,0,0,0,0,1,0,1,0.14285714285714285,1,0.0,0,0,0,0,0,0,0,1,0,0,1,1
3154,67633,IDjwQPQrnszw6soIGbbAmOia0h5OBccp,SpATywNh6bZuzm8s1ceuBUnMUAeoAHHw,2,0,0,0,0,0,2,0,2,0.2857142857142857,1,0.0,0,0,0,0,0,0,0,2,0,0,2,1
3155,67648,is1YRTEVdAbYSlOww6gWdslOyhkcfPV2,SpATywNh6bZuzm8s1ceuBUnMUAeoAHHw,15,30,14,17,7,2,6,0,76,10.857142857142858,3,0.0,11,14,14,7,19,2,3,6,0,46,30,0
3156,67652,HFAIeLw8Y6ycDg9QeC8e64dlQREKJUgu,SpATywNh6bZuzm8s1ceuBUnMUAeoAHHw,11,15,11,2,6,3,2,0,39,5.571428571428571,1,0.0,2,11,2,6,13,3,0,2,0,21,18,1
3157,67655,tkE1JI2oJkZLA1XOzEZ3Jn8IFDQS4QJ9,G8EPVSXsOYB5YQWZGiz1aVq5Pgr2GrQu,32,80,23,67,13,23,12,2,220,31.428571428571427,2,0.0,49,23,46,13,31,23,21,12,2,131,89,0
3158,67663,nBG9NwFfkLReYPd7l4XLlLWLMjwV7w8K,SpATywNh6bZuzm8s1ceuBUnMUAeoAHHw,5,11,6,0,3,0,5,0,25,3.5714285714285716,1,0.0,0,6,0,3,11,0,0,5,0,9,16,1
3159,67664,4GEmQt0JA7IFOeI2xvDzq0AMU7AHzUAO,G8EPVSXsOYB5YQWZGiz1aVq5Pgr2GrQu,1,0,0,0,0,0,1,0,1,0.14285714285714285,1,0.0,0,0,0,0,0,0,0,1,0,0,1,1
3160,67665,4GEmQt0JA7IFOeI2xvDzq0AMU7AHzUAO,RXDvfPUBYFlVdlueBFbLW0mhhAyGEqpt,8,8,1,0,1,0,2,0,12,1.7142857142857142,1,0.0,0,1,0,1,8,0,0,2,0,2,10,1
3161,67671,0ghe43x8DU4ZKEP2rwt8HDtWNCmUsBMb,SpATywNh6bZuzm8s1ceuBUnMUAeoAHHw,3,2,1,0,0,0,1,0,4,0.5714285714285714,1,0.0,0,1,0,0,2,0,0,1,0,1,3,1
3162,67676,HYd5rlFFgGK0QJw1jPObfen7RGCCaTWr,SpATywNh6bZuzm8s1ceuBUnMUAeoAHHw,12,19,2,14,0,0,11,0,46,6.571428571428571,2,0.0,6,2,13,0,13,0,1,11,0,21,25,1
3163,67678,5QFY4jhno4lDKDZjex2aoyci3DX1zToG,SpATywNh6bZuzm8s1ceuBUnMUAeoAHHw,6,3,1,0,1,0,2,0,7,1.0,1,0.0,0,1,0,1,3,0,0,2,0,2,5,1
3164,67679,MSP7eDamCCVYhdl4Hb4ah8yrT6phuW5z,SpATywNh6bZuzm8s1ceuBUnMUAeoAHHw,1,0,0,0,0,0,1,0,1,0.14285714285714285,1,0.0,0,0,0,0,0,0,0,1,0,0,1,1
3165,67682,UgNxeSUTyiiwvKUEwlvxMdHu83PhXRUn,G8EPVSXsOYB5YQWZGiz1aVq5Pgr2GrQu,5,6,1,0,0,0,2,0,9,1.2857142857142858,1,0.0,0,1,0,0,6,0,0,2,0,1,8,1
3166,67684,dQggCBdg5KVSltApPCgVZB7TTUQzzzoI,bWdj2GDclj5ofokWjzoa5jAwMkxCykd6,1,0,0,0,0,0,3,0,3,0.42857142857142855,2,0.0,0,0,0,0,0,0,0,3,0,0,3,1
3167,67685,fZeg9HEKP8oNI2LkglD6L1BrnS7HGXVv,SpATywNh6bZuzm8s1ceuBUnMUAeoAHHw,1,0,0,0,0,0,1,0,1,0.14285714285714285,1,0.0,0,0,0,0,0,0,0,1,0,0,1,1
3168,67686,eWYR1r7NLXWhx2IMzSgNL5MgIoGDCoNF,G8EPVSXsOYB5YQWZGiz1aVq5Pgr2GrQu,8,3,2,0,2,0,7,0,14,2.0,2,0.0,1,2,0,2,2,0,0,7,0,5,9,1
3169,67688,Bi4hHmeTLwTbUCScu9tC6ZZN7frLUhVP,RXDvfPUBYFlVdlueBFbLW0mhhAyGEqpt,8,7,3,0,1,0,4,0,15,2.142857142857143,2,0.0,0,3,0,1,7,0,0,4,0,4,11,1
3170,67690,nPRsjektHdbQkeAf1fIK4JbhrESPbPsA,G8EPVSXsOYB5YQWZGiz1aVq5Pgr2GrQu,3,2,0,0,0,0,1,0,3,0.42857142857142855,1,0.0,0,0,0,0,2,0,0,1,0,0,3,0
3171,67692,EVc4qUhPkP7UL5sL9o4Nn0zqfNCNBtZE,SpATywNh6bZuzm8s1ceuBUnMUAeoAHHw,5,5,1,0,0,0,1,0,7,1.0,1,0.0,0,1,0,0,5,0,0,1,0,1,6,1
3172,67701,4TWfM9na19lYGzUwRed2aAXURJ78KWCP,RXDvfPUBYFlVdlueBFbLW0mhhAyGEqpt,12,13,10,0,4,0,8,11,46,6.571428571428571,1,0.0,0,10,0,4,13,0,0,8,11,14,32,1
3173,67710,zDAtaSKsAJQmmJ6xHQBbAGN68vDebyev,SpATywNh6bZuzm8s1ceuBUnMUAeoAHHw,13,11,6,12,2,0,2,0,33,4.714285714285714,1,0.0,3,6,12,2,8,0,0,2,0,23,10,0
3174,67716,wuUYknrhhK9A1rfWPXYwIaIGT1vO8QhA,SpATywNh6bZuzm8s1ceuBUnMUAeoAHHw,9,12,1,12,0,1,2,0,28,4.0,2,0.0,7,1,12,0,5,1,0,2,0,20,8,1
3175,67717,qO8ml6g9ZeMxls7C74RxeVjl6mVWAz7I,RXDvfPUBYFlVdlueBFbLW0mhhAyGEqpt,13,9,0,21,1,0,5,0,36,5.142857142857143,2,0.0,5,0,21,1,4,0,0,5,0,27,9,1
3176,67722,vVABuHEl55FNtayFertBjV9CA1b1uUqW,SpATywNh6bZuzm8s1ceuBUnMUAeoAHHw,14,44,10,23,3,9,4,0,93,13.285714285714286,3,0.0,29,10,18,3,15,9,5,4,0,60,33,1
3177,67726,R2bf9dlDhtEUgfKzXR1GPBa12LhUfZ8W,bWdj2GDclj5ofokWjzoa5jAwMkxCykd6,8,7,2,28,2,1,3,0,43,6.142857142857143,1,0.0,3,2,28,2,4,1,0,3,0,35,8,1
3178,67736,SBdAO3sKpqSlgeWybSBaDHqROjoMpn5T,SpATywNh6bZuzm8s1ceuBUnMUAeoAHHw,8,6,4,0,3,0,2,0,15,2.142857142857143,1,0.0,1,4,0,3,5,0,0,2,0,8,7,1
3179,67737,NcqjzYwttpnmK16DHJYLwVOs33NDqK5j,bWdj2GDclj5ofokWjzoa5jAwMkxCykd6,5,5,3,0,3,0,3,0,14,2.0,2,0.0,0,3,0,3,5,0,0,3,0,6,8,1
3180,67738,7MNV6BxCJmXmzQulnH88qjtXkhlV5cJV,SpATywNh6bZuzm8s1ceuBUnMUAeoAHHw,1,0,0,0,0,0,2,0,2,0.2857142857142857,1,0.0,0,0,0,0,0,0,0,2,0,0,2,1
3181,67747,tV7GilNH4qERxqQG9yXRbyo0vWdEfCmA,bWdj2GDclj5ofokWjzoa5jAwMkxCykd6,2,0,0,0,0,0,2,0,2,0.2857142857142857,1,0.0,0,0,0,0,0,0,0,2,0,0,2,1
3182,67759,51ihx2Bl0VB10raEriHBNStktgNYyJiR,bWdj2GDclj5ofokWjzoa5jAwMkxCykd6,5,0,0,0,0,1,4,1,6,0.8571428571428571,1,0.0,0,0,0,0,0,1,0,4,1,0,6,1
3183,67761,vLffmcT3S49L5a1tJO8Q4Q4dkiJJ7J44,RXDvfPUBYFlVdlueBFbLW0mhhAyGEqpt,6,7,2,0,1,0,2,0,12,1.7142857142857142,1,0.0,3,2,0,1,4,0,0,2,0,6,6,1
3184,67779,bYYoAejjFfWzrfKZwav40GCs4SuO1jAC,SpATywNh6bZuzm8s1ceuBUnMUAeoAHHw,7,2,1,0,1,2,10,1,17,2.4285714285714284,1,0.0,0,1,0,1,2,2,0,10,1,2,15,1
3185,67781,bavq9pAJWJ3ks5oNWHTGf2k9koDwXsAH,RXDvfPUBYFlVdlueBFbLW0mhhAyGEqpt,14,17,12,0,4,2,5,0,40,5.714285714285714,3,0.0,0,12,0,4,17,2,0,5,0,16,24,1
3186,67793,Q97rHk1i5w2LHTlLAzCat2tEB4ZGa9hz,SpATywNh6bZuzm8s1ceuBUnMUAeoAHHw,11,8,5,0,3,1,6,0,23,3.2857142857142856,1,0.0,0,5,0,3,8,1,0,6,0,8,15,1
3187,67796,X2XXZYuDF6JxTO2GjiNfzkEyj4FQesn5,SpATywNh6bZuzm8s1ceuBUnMUAeoAHHw,17,39,9,30,4,28,17,2,129,18.428571428571427,3,0.0,22,9,25,4,17,28,5,17,2,60,69,0
3188,67797,BDbaeDrifYAc4onT7CTIZiQyVNIb3LDx,SpATywNh6bZuzm8s1ceuBUnMUAeoAHHw,1,0,0,0,0,0,1,0,1,0.14285714285714285,1,0.0,0,0,0,0,0,0,0,1,0,0,1,1
3189,67798,Zz1hYW3bIv4cloYkUjUfNR6Tk0kO8ZBM,SpATywNh6bZuzm8s1ceuBUnMUAeoAHHw,13,19,0,12,0,3,19,1,54,7.714285714285714,2,0.0,7,0,12,0,12,3,0,19,1,19,35,1
3190,67803,MVA6iVb95DkbKsEBY1TwCJRFhaq9Spfs,SpATywNh6bZuzm8s1ceuBUnMUAeoAHHw,8,4,3,0,3,0,4,0,14,2.0,1,0.0,0,3,0,3,4,0,0,4,0,6,8,1
3191,67804,A0FFdH0xpvPEedjm7o52yYaFKsMLgpjw,SpATywNh6bZuzm8s1ceuBUnMUAeoAHHw,12,15,1,10,1,8,6,0,41,5.857142857142857,2,0.0,5,1,10,1,10,8,0,6,0,17,24,1
3192,67809,FlsqjVVrWyPYAwe3clQKMsya1OMo4po8,SpATywNh6bZuzm8s1ceuBUnMUAeoAHHw,4,5,1,0,0,0,1,0,7,1.0,1,0.0,2,1,0,0,3,0,0,1,0,3,4,1
3193,67817,CBLeEN4LtKF8I3pqDKXGm8PyJoErUnYX,bWdj2GDclj5ofokWjzoa5jAwMkxCykd6,7,16,6,0,3,6,6,0,37,5.285714285714286,2,0.0,0,6,0,3,16,6,0,6,0,9,28,0
3194,67818,Ve30VVfu3WOSJCl56SL7TQHGBM98BQ3E,bWdj2GDclj5ofokWjzoa5jAwMkxCykd6,2,0,0,0,0,0,2,0,2,0.2857142857142857,1,0.0,0,0,0,0,0,0,0,2,0,0,2,1
3195,67820,opdILbT2IBFIYJvyIT5NXM7ymKeuMTcM,SpATywNh6bZuzm8s1ceuBUnMUAeoAHHw,16,37,18,17,5,22,20,2,121,17.285714285714285,3,0.0,9,18,15,5,28,22,2,20,2,47,74,0
3196,67822,AQTVoGGpVGka0Kb0gVc0xEeMCYW0e1Aj,SpATywNh6bZuzm8s1ceuBUnMUAeoAHHw,12,10,6,0,4,1,3,0,24,3.4285714285714284,1,0.0,2,6,0,4,8,1,0,3,0,12,12,1
3197,67832,Kp7bCEP3w8tCAj2Zcsfolokp8CiYHRrL,SpATywNh6bZuzm8s1ceuBUnMUAeoAHHw,11,10,0,21,0,0,3,0,34,4.857142857142857,1,0.0,4,0,17,0,6,0,4,3,0,21,13,1
3198,67837,FSLduWx3U7kR3IEOy9TPL7q6u3uDMATy,SpATywNh6bZuzm8s1ceuBUnMUAeoAHHw,17,29,15,20,8,7,10,3,92,13.142857142857142,3,0.0,8,15,18,8,21,7,2,10,3,49,43,1
3199,67845,ndNZsN4dzAawDolPqzrjn2BmwgSJmFEf,bWdj2GDclj5ofokWjzoa5jAwMkxCykd6,15,39,4,130,3,23,17,4,220,31.428571428571427,3,0.0,11,4,125,3,28,23,5,17,4,143,77,1
3200,67853,oseHKim5ugRciFh8lXIQ174blllPPfFO,SpATywNh6bZuzm8s1ceuBUnMUAeoAHHw,11,13,5,13,2,2,3,0,38,5.428571428571429,1,0.0,4,5,12,2,9,2,1,3,0,23,15,0
3201,67855,RGHao356rd6STLU5i2lDxhCwgle1rNFw,SpATywNh6bZuzm8s1ceuBUnMUAeoAHHw,13,11,7,0,4,1,7,1,31,4.428571428571429,3,0.0,0,7,0,4,11,1,0,7,1,11,20,1
3202,67867,YJjGstHCH0jRUJlDUc92oNrPq0d0Zijd,SpATywNh6bZuzm8s1ceuBUnMUAeoAHHw,14,17,9,17,6,0,3,0,52,7.428571428571429,2,0.0,4,9,13,6,13,0,4,3,0,32,20,1
3203,67869,Tn3HlTIsOQNqv7r0Cv64haAgTvsZ6b4U,SpATywNh6bZuzm8s1ceuBUnMUAeoAHHw,1,0,0,0,0,0,6,0,6,0.8571428571428571,1,0.0,0,0,0,0,0,0,0,6,0,0,6,1
3204,67875,LacgvIbC5Mx6NWAbh5ZFbP873whAiOPf,SpATywNh6bZuzm8s1ceuBUnMUAeoAHHw,7,5,2,0,2,0,2,0,11,1.5714285714285714,2,0.0,0,2,0,2,5,0,0,2,0,4,7,1
3205,67876,yTPe4A1Cw5qKDjYpFW5H73VItf0UPFbm,SpATywNh6bZuzm8s1ceuBUnMUAeoAHHw,13,23,13,0,3,7,11,1,58,8.285714285714286,4,0.0,3,13,0,3,20,7,0,11,1,19,39,1
3206,67897,yKgKNljfs8EwbfiKqNgGPLaIDdrvaFSp,SpATywNh6bZuzm8s1ceuBUnMUAeoAHHw,14,22,10,17,5,0,8,0,62,8.857142857142858,3,0.0,2,10,15,5,20,0,2,8,0,32,30,0
3207,67898,hs0BkyfSJv3crs4cIvcxkt53zip5FMPg,bWdj2GDclj5ofokWjzoa5jAwMkxCykd6,5,2,1,0,1,0,2,0,6,0.8571428571428571,1,0.0,0,1,0,1,2,0,0,2,0,2,4,1
3208,67899,p3H39E0dwbDTbdLaprpRXUCSVCX0arUc,SpATywNh6bZuzm8s1ceuBUnMUAeoAHHw,8,5,1,0,1,0,3,3,13,1.8571428571428572,1,0.0,0,1,0,1,5,0,0,3,3,2,11,1
3209,67901,8qABUnBBHxxZkfUhEQNUn5NNMSRrqvPC,RXDvfPUBYFlVdlueBFbLW0mhhAyGEqpt,41,32,19,77,0,15,10,1,154,22.0,2,0.0,7,19,73,0,25,15,4,10,1,99,55,1
3210,67910,uegc4WtztZ9oPCp3WmAu2ymDghX5YdD7,SpATywNh6bZuzm8s1ceuBUnMUAeoAHHw,8,7,4,0,1,0,10,0,22,3.142857142857143,3,0.0,0,4,0,1,7,0,0,10,0,5,17,0
3211,67917,g7pbT2353K6nDyXKA1Zfrr1XqVe2dRBP,SpATywNh6bZuzm8s1ceuBUnMUAeoAHHw,17,57,28,18,16,27,16,2,164,23.428571428571427,3,0.0,10,28,15,16,47,27,3,16,2,69,95,1
3212,67920,gqL1AoJbIkLDCmEi1SGH37fAu1Zdec1f,SpATywNh6bZuzm8s1ceuBUnMUAeoAHHw,8,13,8,0,2,0,9,0,32,4.571428571428571,3,0.0,0,8,0,2,13,0,0,9,0,10,22,0
3213,67926,ndNZsN4dzAawDolPqzrjn2BmwgSJmFEf,SpATywNh6bZuzm8s1ceuBUnMUAeoAHHw,5,2,0,0,0,0,3,0,5,0.7142857142857143,1,0.0,0,0,0,0,2,0,0,3,0,0,5,1
3214,67942,PXSCTSolyT6nzbTsv2Nsca26yVAoeW5q,SpATywNh6bZuzm8s1ceuBUnMUAeoAHHw,15,22,11,8,5,0,11,1,58,8.285714285714286,2,0.0,5,11,8,5,17,0,0,11,1,29,29,0
3215,67943,jR4AfVlqsecU2OD2EAAPnmIP3mzjfI1q,bWdj2GDclj5ofokWjzoa5jAwMkxCykd6,1,0,0,0,0,0,2,0,2,0.2857142857142857,1,0.0,0,0,0,0,0,0,0,2,0,0,2,1
3216,67947,Ybrpv4FlyuZUoocuO2Icsv1UQ9DeHSQ3,RXDvfPUBYFlVdlueBFbLW0mhhAyGEqpt,17,27,4,6,1,0,6,0,44,6.285714285714286,4,0.0,0,4,5,1,27,0,1,6,0,10,34,1
3217,67952,S7PakAxNjFEw6AvrJnn5uzkFmL6Zaill,SpATywNh6bZuzm8s1ceuBUnMUAeoAHHw,5,2,1,0,1,0,3,0,7,1.0,1,0.0,0,1,0,1,2,0,0,3,0,2,5,1
3218,67955,8Kp5E2we1VVLiWHeVTgDcI33lkyZihaL,SpATywNh6bZuzm8s1ceuBUnMUAeoAHHw,3,2,0,0,0,0,1,0,3,0.42857142857142855,1,0.0,0,0,0,0,2,0,0,1,0,0,3,1
3219,67957,NFziKHIzOwiPmHVTsgIR3hdUWupUP7S5,SpATywNh6bZuzm8s1ceuBUnMUAeoAHHw,6,14,1,0,1,0,2,0,18,2.5714285714285716,3,0.0,0,1,0,1,14,0,0,2,0,2,16,1
3220,67960,up9RsivyokQDdIY9XjceWgPIaWSXiHeb,SpATywNh6bZuzm8s1ceuBUnMUAeoAHHw,9,8,1,12,0,0,1,0,22,3.142857142857143,1,0.0,2,1,10,0,6,0,2,1,0,13,9,1
3221,67961,TauShxFiSmmTBchoFAIoZD1cYw24SbpR,SpATywNh6bZuzm8s1ceuBUnMUAeoAHHw,14,71,3,27,0,11,51,2,165,23.571428571428573,3,0.0,14,3,21,0,57,11,6,51,2,38,127,1
3222,67971,tfoakS3EMOjWuYWNRSgWZTjBxe3Mf9Te,RXDvfPUBYFlVdlueBFbLW0mhhAyGEqpt,1,0,0,0,0,0,1,0,1,0.14285714285714285,1,0.0,0,0,0,0,0,0,0,1,0,0,1,1
3223,67972,6iHCxsm5tJiarmhUscvMMFN1oXgIYfGK,SpATywNh6bZuzm8s1ceuBUnMUAeoAHHw,12,18,1,14,1,14,11,0,59,8.428571428571429,2,0.0,4,1,11,1,14,14,3,11,0,17,42,1
3224,67977,tfoakS3EMOjWuYWNRSgWZTjBxe3Mf9Te,G8EPVSXsOYB5YQWZGiz1aVq5Pgr2GrQu,1,0,0,0,0,0,1,0,1,0.14285714285714285,1,0.0,0,0,0,0,0,0,0,1,0,0,1,1
3225,67978,nI7KHCeuUwYkf0rhfMBOC7e8vy7auq4l,SpATywNh6bZuzm8s1ceuBUnMUAeoAHHw,7,3,2,0,2,0,2,0,9,1.2857142857142858,1,0.0,0,2,0,2,3,0,0,2,0,4,5,1
3226,67982,ILI6Vf7i1QDo4pXG14Vgww7LNrHFRhLg,SpATywNh6bZuzm8s1ceuBUnMUAeoAHHw,7,5,0,4,0,0,6,0,15,2.142857142857143,2,0.0,1,0,3,0,4,0,1,6,0,4,11,1
3227,67988,Qy32fNQVMClwOlmUTHDbimblSTgM9GDa,SpATywNh6bZuzm8s1ceuBUnMUAeoAHHw,4,1,0,0,0,0,4,0,5,0.7142857142857143,1,0.0,0,0,0,0,1,0,0,4,0,0,5,1
3228,67993,HwikiMaD2SSDNPWrHLzCjZX0RDgnndHf,bWdj2GDclj5ofokWjzoa5jAwMkxCykd6,5,4,1,0,1,0,1,0,7,1.0,1,0.0,0,1,0,1,4,0,0,1,0,2,5,0
3229,68002,K0IGGULkNaDBoXYWwyrmeTaxQ3RLMvBE,SpATywNh6bZuzm8s1ceuBUnMUAeoAHHw,8,7,3,0,3,0,1,0,14,2.0,1,0.0,0,3,0,3,7,0,0,1,0,6,8,1
3230,68013,CDy3wblikhG2TGdNI3LhbAglknKqeMeq,RXDvfPUBYFlVdlueBFbLW0mhhAyGEqpt,1,0,0,0,0,0,1,0,1,0.14285714285714285,1,0.0,0,0,0,0,0,0,0,1,0,0,1,0
3231,68017,Ea76prVlgHXbifiTXOy9yoJBa7oRFv41,SpATywNh6bZuzm8s1ceuBUnMUAeoAHHw,13,32,1,17,0,8,7,1,66,9.428571428571429,3,0.0,11,1,14,0,21,8,3,7,1,26,40,1
3232,68019,c4Lb4MH2H2BBD2Eny5diwcURGPUNIr88,G8EPVSXsOYB5YQWZGiz1aVq5Pgr2GrQu,5,13,3,0,5,0,2,0,23,3.2857142857142856,2,0.0,9,3,0,5,4,0,0,2,0,17,6,1
3233,68021,YxdX3NPpzVJ59dpoBODWSD8Noi3lkajj,G8EPVSXsOYB5YQWZGiz1aVq5Pgr2GrQu,79,190,73,232,31,21,19,0,566,80.85714285714286,5,0.0,93,73,163,31,97,21,69,19,0,360,206,0
3234,68042,zHQwuuMF2E73UUayJX1hbmgxSuUBnwou,G8EPVSXsOYB5YQWZGiz1aVq5Pgr2GrQu,30,54,16,58,14,1,13,0,156,22.285714285714285,2,0.0,32,16,41,14,22,1,17,13,0,103,53,0
3235,68049,EBHdi8xR8rUEs7i0QRogmtFZNO8JeTy8,SpATywNh6bZuzm8s1ceuBUnMUAeoAHHw,16,16,7,5,3,2,6,1,40,5.714285714285714,2,0.0,3,7,5,3,13,2,0,6,1,18,22,1
3236,68051,CORJXNhWUR52sdjQNNf8qLspXXnCgswJ,SpATywNh6bZuzm8s1ceuBUnMUAeoAHHw,17,32,7,23,4,9,7,2,84,12.0,2,0.0,16,7,19,4,16,9,4,7,2,46,38,0
3237,68055,EBLsXyMzbHjWnC0OjjqcacEXrmUIJvTs,SpATywNh6bZuzm8s1ceuBUnMUAeoAHHw,5,2,1,0,1,0,2,0,6,0.8571428571428571,1,0.0,0,1,0,1,2,0,0,2,0,2,4,1
3238,68058,8qyr4gmatx7C6lBFbhpf1S75SesVpGhm,SpATywNh6bZuzm8s1ceuBUnMUAeoAHHw,16,28,9,17,5,11,9,1,80,11.428571428571429,2,0.0,13,9,15,5,15,11,2,9,1,42,38,0
3239,68061,Y0xpzPU1KVTtj1ZRV6oETnVQafrG6Rxw,G8EPVSXsOYB5YQWZGiz1aVq5Pgr2GrQu,15,17,10,18,4,0,3,0,52,7.428571428571429,1,0.0,3,10,15,4,14,0,3,3,0,32,20,1
3240,68074,C1sQeK9WfNApOsknFeDtbZSozuem8vKZ,SpATywNh6bZuzm8s1ceuBUnMUAeoAHHw,8,10,2,0,1,0,6,1,20,2.857142857142857,1,0.0,0,2,0,1,10,0,0,6,1,3,17,1
3241,68078,w9Zejjae59IiHj98CiIbluCo9JOahx2s,bWdj2GDclj5ofokWjzoa5jAwMkxCykd6,20,20,10,42,7,3,8,2,92,13.142857142857142,1,0.0,7,10,39,7,13,3,3,8,2,63,29,1
3242,68081,C1sQeK9WfNApOsknFeDtbZSozuem8vKZ,bWdj2GDclj5ofokWjzoa5jAwMkxCykd6,1,0,0,0,0,0,1,0,1,0.14285714285714285,1,0.0,0,0,0,0,0,0,0,1,0,0,1,1
3243,68082,C1sQeK9WfNApOsknFeDtbZSozuem8vKZ,G8EPVSXsOYB5YQWZGiz1aVq5Pgr2GrQu,1,0,0,0,0,0,1,0,1,0.14285714285714285,1,0.0,0,0,0,0,0,0,0,1,0,0,1,1
3244,68087,GlnhykNK42Hk2YDmiiI5XtZaM9QknLVN,SpATywNh6bZuzm8s1ceuBUnMUAeoAHHw,14,56,21,11,0,27,26,4,145,20.714285714285715,2,0.0,22,21,10,0,34,27,1,26,4,53,92,1
3245,68088,GIsRCDxWVYGm4So2chhYPzgj7oVxCsSB,RXDvfPUBYFlVdlueBFbLW0mhhAyGEqpt,12,11,1,0,2,0,3,0,17,2.4285714285714284,2,0.0,0,1,0,2,11,0,0,3,0,3,14,1
3246,68092,gmQzxzrGOrQhncsrBOMeYdsKsXhK53lF,bWdj2GDclj5ofokWjzoa5jAwMkxCykd6,11,10,4,34,3,0,9,0,60,8.571428571428571,1,0.0,1,4,34,3,9,0,0,9,0,42,18,1
3247,68093,GjzhHwDiXF2E87hVW0UoZGkmnIxus0Jb,G8EPVSXsOYB5YQWZGiz1aVq5Pgr2GrQu,2,0,0,0,0,0,2,0,2,0.2857142857142857,1,0.0,0,0,0,0,0,0,0,2,0,0,2,1
3248,68097,YtgrpGciY5emPU7tatGUnxp8LeEpuZ2R,G8EPVSXsOYB5YQWZGiz1aVq5Pgr2GrQu,1,0,0,0,0,0,1,0,1,0.14285714285714285,1,0.0,0,0,0,0,0,0,0,1,0,0,1,1
3249,68099,bf977a2Ekvsg0xEzQOrZjXRWnBKTxo2i,G8EPVSXsOYB5YQWZGiz1aVq5Pgr2GrQu,20,22,16,14,10,1,2,0,65,9.285714285714286,1,0.0,0,16,13,10,22,1,1,2,0,39,26,1
3250,68102,7rvGs1kznZu35xmEOruWRR3N50tl6czz,bWdj2GDclj5ofokWjzoa5jAwMkxCykd6,8,9,1,10,1,0,2,0,23,3.2857142857142856,1,0.0,1,1,9,1,8,0,1,2,0,12,11,1
3251,68104,6ybGGzfjXeEOFmc8PHowGPQhK4ir7keP,SpATywNh6bZuzm8s1ceuBUnMUAeoAHHw,9,5,1,0,1,4,7,1,19,2.7142857142857144,1,0.0,0,1,0,1,5,4,0,7,1,2,17,1
3252,68107,fJGnkdlpDXyGxGQQghKR3BhEMVARR2Lg,SpATywNh6bZuzm8s1ceuBUnMUAeoAHHw,1,0,0,0,0,0,1,0,1,0.14285714285714285,1,0.0,0,0,0,0,0,0,0,1,0,0,1,1
3253,68108,A0dHL3oOosmNf0Of1dLTB9JxNisZL1pv,SpATywNh6bZuzm8s1ceuBUnMUAeoAHHw,8,10,4,0,3,0,8,0,25,3.5714285714285716,2,0.0,1,4,0,3,9,0,0,8,0,8,17,1
3254,68110,aIu8QzWjQFPb4qaDfl0P1tztYuItpL4R,RXDvfPUBYFlVdlueBFbLW0mhhAyGEqpt,39,52,3,100,1,3,17,2,178,25.428571428571427,3,0.0,10,3,94,1,42,3,6,17,2,108,70,1
3255,68114,5PtI5arrhi7X94UIlnofTGsT9hPK6ewX,SpATywNh6bZuzm8s1ceuBUnMUAeoAHHw,5,4,3,0,0,0,1,0,8,1.1428571428571428,1,0.0,0,3,0,0,4,0,0,1,0,3,5,1
3256,68118,Z5b3QXG5aJtKMyvjqd5INn7f1wDhqIm4,SpATywNh6bZuzm8s1ceuBUnMUAeoAHHw,10,8,4,0,3,1,5,0,21,3.0,2,0.0,1,4,0,3,7,1,0,5,0,8,13,0
3257,68125,6akze6dlAjqRJRBQfIi4wuyuoFxmW6lS,SpATywNh6bZuzm8s1ceuBUnMUAeoAHHw,9,21,9,0,7,0,12,0,49,7.0,1,0.0,0,9,0,7,21,0,0,12,0,16,33,1
3258,68126,gLWYERddjD0e20XUR43WwbF7uNaF2Pgm,bWdj2GDclj5ofokWjzoa5jAwMkxCykd6,6,17,2,0,4,0,1,0,24,3.4285714285714284,1,0.0,0,2,0,4,17,0,0,1,0,6,18,1
3259,68130,gmQzxzrGOrQhncsrBOMeYdsKsXhK53lF,SpATywNh6bZuzm8s1ceuBUnMUAeoAHHw,1,0,0,0,0,0,1,0,1,0.14285714285714285,1,0.0,0,0,0,0,0,0,0,1,0,0,1,1
3260,68133,2NZH8U3WrlujDhhhOcDdw5QM9Su6Hvdq,SpATywNh6bZuzm8s1ceuBUnMUAeoAHHw,12,21,4,14,3,8,2,0,52,7.428571428571429,1,0.0,16,4,13,3,5,8,1,2,0,36,16,1
3261,68138,TnMuPtEYCG1UP1JnaDUM0auIBTc6VjvH,SpATywNh6bZuzm8s1ceuBUnMUAeoAHHw,4,2,0,0,0,0,5,0,7,1.0,1,0.0,0,0,0,0,2,0,0,5,0,0,7,0
3262,68142,78gf8prmiaXO1waYCeS1MI82L5gA5cph,SpATywNh6bZuzm8s1ceuBUnMUAeoAHHw,8,12,3,0,1,5,4,1,26,3.7142857142857144,1,0.0,0,3,0,1,12,5,0,4,1,4,22,1
3263,68155,GlnhykNK42Hk2YDmiiI5XtZaM9QknLVN,G8EPVSXsOYB5YQWZGiz1aVq5Pgr2GrQu,18,35,29,78,11,3,10,0,166,23.714285714285715,2,0.0,2,29,76,11,33,3,2,10,0,118,48,1
3264,68157,WHlJuYfhW4fQXvIRdAMxkZtYXebgfAZs,SpATywNh6bZuzm8s1ceuBUnMUAeoAHHw,7,4,3,0,3,0,2,0,12,1.7142857142857142,1,0.0,0,3,0,3,4,0,0,2,0,6,6,1
3265,68158,ZDEv7xdHlbONQGNdkwzMgbMsJFIzjdrJ,RXDvfPUBYFlVdlueBFbLW0mhhAyGEqpt,17,41,1,16,3,13,11,5,90,12.857142857142858,2,0.0,16,1,13,3,25,13,3,11,5,33,57,1
3266,68159,8PUTYY5GxR5hJrTB9VGuf6OwgmQYLlz6,SpATywNh6bZuzm8s1ceuBUnMUAeoAHHw,17,28,9,18,3,2,13,0,73,10.428571428571429,4,0.0,15,9,16,3,13,2,2,13,0,43,30,1
3267,68163,E7q8xgbm4JOITPhixAXraRklJYYNgqh3,SpATywNh6bZuzm8s1ceuBUnMUAeoAHHw,1,0,0,0,0,0,1,0,1,0.14285714285714285,1,0.0,0,0,0,0,0,0,0,1,0,0,1,1
3268,68165,c011xwxkscfGfFvLGjK44gLGvqvYHhED,SpATywNh6bZuzm8s1ceuBUnMUAeoAHHw,13,17,8,3,3,0,10,0,41,5.857142857142857,2,0.0,2,8,3,3,15,0,0,10,0,16,25,1
3269,68175,WAqLnSQyhRD0PYZmBqQYHPqSLjTTUH6O,SpATywNh6bZuzm8s1ceuBUnMUAeoAHHw,15,34,13,18,8,0,7,3,83,11.857142857142858,3,0.0,3,13,16,8,31,0,2,7,3,40,43,1
3270,68181,wCP7MM6FfvdZx8uOqp7AG8m1oFJcqLHB,SpATywNh6bZuzm8s1ceuBUnMUAeoAHHw,17,35,18,12,10,26,27,3,131,18.714285714285715,3,0.0,13,18,9,10,22,26,3,27,3,50,81,1
3271,68182,U8vo2wOZC3Q8EW1kIl6iwoIzgmQUZ4u1,SpATywNh6bZuzm8s1ceuBUnMUAeoAHHw,3,0,0,0,0,2,2,0,4,0.5714285714285714,1,0.0,0,0,0,0,0,2,0,2,0,0,4,1
3272,68191,hkTx4XunczsnVq4H9eVYRZURkkofvB6I,SpATywNh6bZuzm8s1ceuBUnMUAeoAHHw,8,6,3,2,2,0,1,0,14,2.0,1,0.0,0,3,2,2,6,0,0,1,0,7,7,1
3273,68194,3F9rh0xtO3MPjBfGcFPCm9PRbwYuY4I3,SpATywNh6bZuzm8s1ceuBUnMUAeoAHHw,13,21,2,21,0,2,11,1,58,8.285714285714286,5,0.0,7,2,17,0,14,2,4,11,1,26,32,1
3274,68195,PUFh3BsQaDVIJMDvwsFTqkrgAzvjO9ME,bWdj2GDclj5ofokWjzoa5jAwMkxCykd6,3,2,1,0,0,0,1,0,4,0.5714285714285714,1,0.0,0,1,0,0,2,0,0,1,0,1,3,1
3275,68203,6U8VFnPyZYhBRDbe5XdPXo17gTSrU7h6,bWdj2GDclj5ofokWjzoa5jAwMkxCykd6,10,11,7,0,2,10,8,1,39,5.571428571428571,3,0.0,0,7,0,2,11,10,0,8,1,9,30,1
3276,68205,XRUycqJgK6Teg1VieyLPSxgajklcF856,SpATywNh6bZuzm8s1ceuBUnMUAeoAHHw,8,7,1,0,0,5,4,1,18,2.5714285714285716,1,0.0,2,1,0,0,5,5,0,4,1,3,15,0
3277,68206,XZ83JcONkALUi8eW1z8sh8GNkNHnCecC,SpATywNh6bZuzm8s1ceuBUnMUAeoAHHw,17,26,11,25,3,11,11,3,90,12.857142857142858,2,0.0,12,11,19,3,14,11,6,11,3,45,45,1
3278,68208,j4u6F4qZpPKGLDItX0Q2HAWM10zHBR79,SpATywNh6bZuzm8s1ceuBUnMUAeoAHHw,13,19,8,11,3,0,2,0,43,6.142857142857143,1,0.0,7,8,11,3,12,0,0,2,0,29,14,1
3279,68210,6A7JcBAaCtlmyXJds1FDIeGlm0ezPnc3,SpATywNh6bZuzm8s1ceuBUnMUAeoAHHw,12,13,1,17,1,0,4,0,36,5.142857142857143,1,0.0,8,1,16,1,5,0,1,4,0,26,10,1
3280,68212,1fxFMFifV1rQ9EWjOwHxBWikLCyhcjXV,SpATywNh6bZuzm8s1ceuBUnMUAeoAHHw,7,15,1,8,0,0,1,0,25,3.5714285714285716,1,0.0,0,1,6,0,15,0,2,1,0,7,18,1
3281,68222,WnGoJ0X05nmmcr9OBuNGFmD5r4EVF1g6,bWdj2GDclj5ofokWjzoa5jAwMkxCykd6,12,24,13,0,5,34,20,4,100,14.285714285714286,4,0.0,0,13,0,5,24,34,0,20,4,18,82,1
3282,68230,82GMCFQFd0THTrsyKfVm7WvJIFvIx6zJ,bWdj2GDclj5ofokWjzoa5jAwMkxCykd6,1,0,0,0,0,0,1,0,1,0.14285714285714285,1,0.0,0,0,0,0,0,0,0,1,0,0,1,1
3283,68234,CR4gghlbM9RsvrMmN4aq9I8yiSZncbD8,SpATywNh6bZuzm8s1ceuBUnMUAeoAHHw,15,16,7,10,3,0,6,0,42,6.0,2,0.0,7,7,10,3,9,0,0,6,0,27,15,0
3284,68239,ZGeJlcog0o13nhqeKC2vRvkt6LFvOzyP,SpATywNh6bZuzm8s1ceuBUnMUAeoAHHw,1,0,0,0,0,0,1,0,1,0.14285714285714285,1,0.0,0,0,0,0,0,0,0,1,0,0,1,1
3285,68240,IZwgoYiQOwzeEoIsJbmj0ULJBVLQ8tDo,SpATywNh6bZuzm8s1ceuBUnMUAeoAHHw,6,3,2,0,2,0,1,0,8,1.1428571428571428,1,0.0,0,2,0,2,3,0,0,1,0,4,4,0
3286,68241,i2PPXz5Z5PB2ZfiVAI64TcWxYgJR1QQ1,RXDvfPUBYFlVdlueBFbLW0mhhAyGEqpt,16,14,9,0,5,1,5,0,34,4.857142857142857,2,0.0,0,9,0,5,14,1,0,5,0,14,20,1
3287,68242,zQ0WfWm1cz6xtKNF9R3KOD2OW4OSAkc1,SpATywNh6bZuzm8s1ceuBUnMUAeoAHHw,11,7,6,6,0,0,5,0,24,3.4285714285714284,2,0.0,0,6,5,0,7,0,1,5,0,11,13,1
3288,68248,difzQoAVFjIhhoeyJCnFHhQfdluM0dbZ,G8EPVSXsOYB5YQWZGiz1aVq5Pgr2GrQu,1,0,0,0,0,0,1,0,1,0.14285714285714285,1,0.0,0,0,0,0,0,0,0,1,0,0,1,1
3289,68250,bNThALRhT3LNXximO1paliuB0aPzkqk7,SpATywNh6bZuzm8s1ceuBUnMUAeoAHHw,17,15,7,25,4,47,15,3,116,16.571428571428573,2,0.0,6,7,21,4,9,47,4,15,3,38,78,1
3290,68251,Hy6j11K745hIL1HizKPEi5wjs7F2sOsG,SpATywNh6bZuzm8s1ceuBUnMUAeoAHHw,5,3,1,0,1,0,4,0,9,1.2857142857142858,1,0.0,0,1,0,1,3,0,0,4,0,2,7,1
3291,68252,5N9UtpTd0Iyfm1Amzky3t1R9JrMPidgw,SpATywNh6bZuzm8s1ceuBUnMUAeoAHHw,15,28,8,24,7,0,13,1,81,11.571428571428571,2,0.0,14,8,17,7,14,0,7,13,1,46,35,0
3292,68258,oL1G89Phk4nduULmJ17br7A4xddcHdc4,RXDvfPUBYFlVdlueBFbLW0mhhAyGEqpt,13,14,7,0,3,6,11,1,42,6.0,4,0.0,1,7,0,3,13,6,0,11,1,11,31,0
3293,68262,jwmMikqyMlJ3SzOUjqLjM22mCL5p25A7,SpATywNh6bZuzm8s1ceuBUnMUAeoAHHw,5,3,1,0,1,0,4,0,9,1.2857142857142858,1,0.0,1,1,0,1,2,0,0,4,0,3,6,1
3294,68263,pbaQcU38LWlEY15kC2Yb0jdLNtMAYhsA,SpATywNh6bZuzm8s1ceuBUnMUAeoAHHw,15,22,7,16,3,0,8,0,56,8.0,4,0.0,10,7,13,3,12,0,3,8,0,33,23,0
3295,68268,jwN9sgXwQLE8sD1F25K97DLtEDZ0gnxi,SpATywNh6bZuzm8s1ceuBUnMUAeoAHHw,1,0,0,0,0,0,1,0,1,0.14285714285714285,1,0.0,0,0,0,0,0,0,0,1,0,0,1,1
3296,68273,1qOWHE2SxHYAOzNCTuiHl1kSZUHL0gyU,SpATywNh6bZuzm8s1ceuBUnMUAeoAHHw,17,67,25,15,12,16,41,5,181,25.857142857142858,3,0.0,18,25,11,12,49,16,4,41,5,66,115,0
3297,68275,RWU4omSsfIhWMdUidy2dDc2hADqC6J7F,RXDvfPUBYFlVdlueBFbLW0mhhAyGEqpt,1,0,0,0,0,0,1,0,1,0.14285714285714285,1,0.0,0,0,0,0,0,0,0,1,0,0,1,1
3298,68279,S5r0CKOxIwwZ6o4r0E3DEfNq3HUydzP8,SpATywNh6bZuzm8s1ceuBUnMUAeoAHHw,10,11,9,0,7,0,2,0,29,4.142857142857143,1,0.0,0,9,0,7,11,0,0,2,0,16,13,1
3299,68280,0iBsrOe2KnLxk8TGZ7ugYIrItWDyZcX5,bWdj2GDclj5ofokWjzoa5jAwMkxCykd6,1,0,0,0,0,0,1,0,1,0.14285714285714285,1,0.0,0,0,0,0,0,0,0,1,0,0,1,1
3300,68296,b1g4AWG6A2zG5plnQY4paLSHRFnrgObC,G8EPVSXsOYB5YQWZGiz1aVq5Pgr2GrQu,6,15,5,0,2,0,23,0,45,6.428571428571429,3,0.0,0,5,0,2,15,0,0,23,0,7,38,1
3301,68299,MzTmeAugUJkvlIkD1VbUcP5NYDEco9Sz,bWdj2GDclj5ofokWjzoa5jAwMkxCykd6,12,9,3,54,3,0,1,0,70,10.0,1,0.0,5,3,51,3,4,0,3,1,0,62,8,1
3302,68305,1Z4DcQGB0iHwU6wAGYAE4UwCDJhJoWI1,SpATywNh6bZuzm8s1ceuBUnMUAeoAHHw,5,2,1,0,1,0,4,0,8,1.1428571428571428,1,0.0,0,1,0,1,2,0,0,4,0,2,6,0
3303,68312,FmmzXResih4xmTvS1USR90U6hsc9smA9,RXDvfPUBYFlVdlueBFbLW0mhhAyGEqpt,6,10,3,0,3,0,1,0,17,2.4285714285714284,2,0.0,0,3,0,3,10,0,0,1,0,6,11,1
3304,68316,FocgTK7ZKP5rXdprEvR0U5yJcvk72CbF,SpATywNh6bZuzm8s1ceuBUnMUAeoAHHw,11,14,6,10,0,9,7,0,46,6.571428571428571,2,0.0,7,6,8,0,7,9,2,7,0,21,25,1
3305,68318,g3PG76pcZjQr6VJ2OlBuhnEf9tLvgXf4,SpATywNh6bZuzm8s1ceuBUnMUAeoAHHw,4,2,1,0,1,0,1,0,5,0.7142857142857143,1,0.0,0,1,0,1,2,0,0,1,0,2,3,1
3306,68321,AOjgDe9pflTNYpkfyCGVCxzTomGLrXC9,G8EPVSXsOYB5YQWZGiz1aVq5Pgr2GrQu,9,7,3,0,2,3,15,1,31,4.428571428571429,1,0.0,2,3,0,2,5,3,0,15,1,7,24,1
3307,68324,VwIVGF64yzO60dfdnqn1D6KZSjw1xNvm,bWdj2GDclj5ofokWjzoa5jAwMkxCykd6,6,19,2,0,1,0,5,0,27,3.857142857142857,3,0.0,0,2,0,1,19,0,0,5,0,3,24,1
3308,68332,hJo1MgKiPZFXuH2ko6hqPTd9dbjMQKDO,SpATywNh6bZuzm8s1ceuBUnMUAeoAHHw,8,14,9,0,4,0,3,0,30,4.285714285714286,3,0.0,2,9,0,4,12,0,0,3,0,15,15,0
3309,68333,8DBF0kTYvtu7h0hsdxFO3EFrNNkmUkiM,SpATywNh6bZuzm8s1ceuBUnMUAeoAHHw,16,17,5,14,3,11,7,0,57,8.142857142857142,2,0.0,10,5,14,3,7,11,0,7,0,32,25,1
3310,68345,SnyeeNQTfkqzknIlQQLm06X1xA6g9a0l,SpATywNh6bZuzm8s1ceuBUnMUAeoAHHw,16,29,9,19,8,12,9,1,87,12.428571428571429,2,0.0,9,9,16,8,20,12,3,9,1,42,45,1
3311,68349,iADE6TgYebHG0th9GrbiEmbQ3Qc3Go8z,RXDvfPUBYFlVdlueBFbLW0mhhAyGEqpt,6,1,1,0,1,0,4,1,8,1.1428571428571428,2,0.0,0,1,0,1,1,0,0,4,1,2,6,1
3312,68351,QkN5nvBbZszJiSQ2f66kudMZ2eWWY8sa,RXDvfPUBYFlVdlueBFbLW0mhhAyGEqpt,6,4,3,0,1,0,1,0,9,1.2857142857142858,1,0.0,0,3,0,1,4,0,0,1,0,4,5,1
3313,68352,clbUGnOQsN7CuaV7idGJ2LVbYN3t8qC3,SpATywNh6bZuzm8s1ceuBUnMUAeoAHHw,15,29,13,10,5,17,7,1,82,11.714285714285714,3,0.0,3,13,9,5,26,17,1,7,1,30,52,0
3314,68357,uxWS9amhXxmjOvqXmZExJSg0LcMFBAvq,G8EPVSXsOYB5YQWZGiz1aVq5Pgr2GrQu,7,3,2,0,1,0,6,0,12,1.7142857142857142,2,0.0,0,2,0,1,3,0,0,6,0,3,9,1
3315,68360,4pJW5s4UUKXpxe6ChNDK23aeXIukgMH8,SpATywNh6bZuzm8s1ceuBUnMUAeoAHHw,16,17,6,17,4,17,10,1,72,10.285714285714286,1,0.0,3,6,14,4,14,17,3,10,1,27,45,1
3316,68362,tlaj4fnwxWl22MIDqzqpAu1L2vA1lQmh,bWdj2GDclj5ofokWjzoa5jAwMkxCykd6,12,23,14,16,7,10,8,1,79,11.285714285714286,4,0.0,3,14,15,7,20,10,1,8,1,39,40,1
3317,68363,0F1DhnfuH8hFtOjZ8dWmoNBQat6tI7Te,SpATywNh6bZuzm8s1ceuBUnMUAeoAHHw,5,2,1,0,1,0,2,1,7,1.0,1,0.0,0,1,0,1,2,0,0,2,1,2,5,1
3318,68364,2FyRSMemMx0WQNXDNdLObUL8ox2VWXod,SpATywNh6bZuzm8s1ceuBUnMUAeoAHHw,15,37,14,21,6,9,12,0,99,14.142857142857142,6,0.0,8,14,18,6,29,9,3,12,0,46,53,1
3319,68365,SG7hB83Yya2DA2E0NTjAVNa4uzxtdA6s,SpATywNh6bZuzm8s1ceuBUnMUAeoAHHw,9,9,2,0,0,2,6,1,20,2.857142857142857,1,0.0,0,2,0,0,9,2,0,6,1,2,18,1
3320,68371,xBU5Obte2st2JNuH81iN4TihJEa7jvrL,SpATywNh6bZuzm8s1ceuBUnMUAeoAHHw,1,0,0,0,0,0,2,0,2,0.2857142857142857,1,0.0,0,0,0,0,0,0,0,2,0,0,2,1
3321,68379,b4M5OphEGf9HhlcR04bazUL6wKV8uIkU,G8EPVSXsOYB5YQWZGiz1aVq5Pgr2GrQu,23,50,0,42,5,41,12,10,160,22.857142857142858,4,0.0,20,0,29,5,30,41,13,12,10,54,106,1
3322,68388,R2V0izPrSC9aiv4wxr7ZUbqHHqyQkLxw,bWdj2GDclj5ofokWjzoa5jAwMkxCykd6,4,2,1,0,1,0,1,0,5,0.7142857142857143,1,0.0,0,1,0,1,2,0,0,1,0,2,3,1
3323,68395,lTZusowYpBCkpVlkG3X20kNgU6aMOOBS,SpATywNh6bZuzm8s1ceuBUnMUAeoAHHw,17,18,7,18,3,3,15,1,65,9.285714285714286,3,0.0,8,7,15,3,10,3,3,15,1,33,32,1
3324,68397,td9JVyRGLfbXKWE7ys0aQ9IRUtJd97NP,bWdj2GDclj5ofokWjzoa5jAwMkxCykd6,5,2,1,0,1,0,3,0,7,1.0,1,0.0,0,1,0,1,2,0,0,3,0,2,5,1
3325,68398,LNdimqsJkOxQDP9dT4IGwewg9YvH7zfV,SpATywNh6bZuzm8s1ceuBUnMUAeoAHHw,15,30,16,6,5,8,4,0,69,9.857142857142858,3,0.0,9,16,6,5,21,8,0,4,0,36,33,1
3326,68399,TTmbjhCeX7YmnFUettVVam4HwYq17paa,SpATywNh6bZuzm8s1ceuBUnMUAeoAHHw,3,3,0,0,0,0,2,0,5,0.7142857142857143,1,0.0,0,0,0,0,3,0,0,2,0,0,5,0
3327,68406,fWzpIAl5AhTFdJeUPdzJHspdUzMjFUYM,bWdj2GDclj5ofokWjzoa5jAwMkxCykd6,5,3,2,0,1,0,5,0,11,1.5714285714285714,2,0.0,0,2,0,1,3,0,0,5,0,3,8,1
3328,68411,4vxCaGfGDr7qH4ipzhuoVimWrYG1kGYQ,bWdj2GDclj5ofokWjzoa5jAwMkxCykd6,17,47,22,58,6,52,43,4,232,33.142857142857146,4,0.0,3,22,49,6,44,52,9,43,4,80,152,1
3329,68412,0KxBv7TNEUj27dsp2zMGG4WpBswpgOyf,SpATywNh6bZuzm8s1ceuBUnMUAeoAHHw,9,12,7,5,2,0,5,0,31,4.428571428571429,3,0.0,0,7,5,2,12,0,0,5,0,14,17,0
3330,68423,bET2Moo4lPgmSBI2ZHgAloQD25b1Jinn,G8EPVSXsOYB5YQWZGiz1aVq5Pgr2GrQu,17,18,8,30,4,0,3,0,63,9.0,3,0.0,0,8,28,4,18,0,2,3,0,40,23,1
3331,68424,7XeEjaT7Rw76VaeBef1jnkEycygog40I,SpATywNh6bZuzm8s1ceuBUnMUAeoAHHw,9,16,8,0,7,0,2,0,33,4.714285714285714,1,0.0,2,8,0,7,14,0,0,2,0,17,16,1
3332,68426,4a1LmrNqPaRbQL0Q68aycdhtteXqXTMU,SpATywNh6bZuzm8s1ceuBUnMUAeoAHHw,5,2,1,0,1,0,2,0,6,0.8571428571428571,1,0.0,0,1,0,1,2,0,0,2,0,2,4,1
3333,68435,dYES117kkj3IhCPWFa9k6hhXgoc7YknJ,G8EPVSXsOYB5YQWZGiz1aVq5Pgr2GrQu,8,4,1,0,0,6,6,1,18,2.5714285714285716,1,0.0,0,1,0,0,4,6,0,6,1,1,17,1
3334,68438,nnZGKhMV6zkzSC8Qzeh7UPQIZVHpp5uX,bWdj2GDclj5ofokWjzoa5jAwMkxCykd6,1,0,0,0,0,0,1,0,1,0.14285714285714285,1,0.0,0,0,0,0,0,0,0,1,0,0,1,1
3335,68439,6H5tZYvQXUXA5x38gvAZ0WgqLjIkqn3b,SpATywNh6bZuzm8s1ceuBUnMUAeoAHHw,7,3,1,0,2,0,2,0,8,1.1428571428571428,1,0.0,0,1,0,2,3,0,0,2,0,3,5,1
3336,68442,v8CV9SymhVbpaH5nH9XVMeR4jjsMeKhG,G8EPVSXsOYB5YQWZGiz1aVq5Pgr2GrQu,15,5,4,20,3,0,2,0,34,4.857142857142857,1,0.0,0,4,17,3,5,0,3,2,0,24,10,1
3337,68455,HzaFh1I0rWfjYqs3kd2mhXywhDrDBNWZ,bWdj2GDclj5ofokWjzoa5jAwMkxCykd6,8,17,5,0,2,3,9,1,37,5.285714285714286,3,0.0,2,5,0,2,15,3,0,9,1,9,28,1
3338,68463,CJyFZrp4dFxNPWh98LYOwXSivShmskBg,SpATywNh6bZuzm8s1ceuBUnMUAeoAHHw,7,3,2,0,2,0,2,0,9,1.2857142857142858,1,0.0,0,2,0,2,3,0,0,2,0,4,5,1
3339,68467,4VUauTz2C9X4SCHk8ugs49B1paCitpmU,G8EPVSXsOYB5YQWZGiz1aVq5Pgr2GrQu,22,14,13,42,5,1,12,1,88,12.571428571428571,1,0.0,0,13,37,5,14,1,5,12,1,55,33,1
3340,68475,FCvIa0IivvqNa6modx0mbEXg1jcpQzBN,SpATywNh6bZuzm8s1ceuBUnMUAeoAHHw,1,0,0,0,0,0,1,0,1,0.14285714285714285,1,0.0,0,0,0,0,0,0,0,1,0,0,1,1
3341,68483,b3xaxczfVryBkeC1YPbXWEZUleYIZAnq,bWdj2GDclj5ofokWjzoa5jAwMkxCykd6,7,5,4,0,2,0,5,0,16,2.2857142857142856,2,0.0,1,4,0,2,4,0,0,5,0,7,9,1
3342,68485,v6euctfbzWthWyLBlYjaRzf7ryZssgjA,bWdj2GDclj5ofokWjzoa5jAwMkxCykd6,1,0,0,0,0,0,1,0,1,0.14285714285714285,1,0.0,0,0,0,0,0,0,0,1,0,0,1,1
3343,68494,yvCmfQ3z3fMLbjXX0h1AIIPVh4np9hhq,SpATywNh6bZuzm8s1ceuBUnMUAeoAHHw,13,26,12,21,5,6,10,1,81,11.571428571428571,3,0.0,8,12,18,5,18,6,3,10,1,43,38,0
3344,68496,SI82MK5h5zRoUuXAAtKY5ltobDSBBXh9,bWdj2GDclj5ofokWjzoa5jAwMkxCykd6,7,4,1,70,1,0,1,0,77,11.0,1,0.0,1,1,70,1,3,0,0,1,0,73,4,1
3345,68500,IhUEedXCjE6LoKReKNbXGS4Fqk4t4GUl,SpATywNh6bZuzm8s1ceuBUnMUAeoAHHw,7,5,1,0,1,0,3,0,10,1.4285714285714286,1,0.0,0,1,0,1,5,0,0,3,0,2,8,1
3346,68509,hkI32MAgHvJ4T3I3Up79daEJ8l4sKHaC,bWdj2GDclj5ofokWjzoa5jAwMkxCykd6,20,26,12,156,11,29,9,1,244,34.857142857142854,3,0.0,9,12,146,11,17,29,10,9,1,178,66,1
3347,68511,Q9VYSqOD2rxffT9mHJg8GtdPL5OsLSDn,G8EPVSXsOYB5YQWZGiz1aVq5Pgr2GrQu,5,2,1,0,1,0,3,0,7,1.0,1,0.0,0,1,0,1,2,0,0,3,0,2,5,1
3348,68513,PRgLfGkxJHP58QbJdXg5l5vWjuJI88nv,SpATywNh6bZuzm8s1ceuBUnMUAeoAHHw,16,15,7,12,4,15,7,0,60,8.571428571428571,3,0.0,5,7,9,4,10,15,3,7,0,25,35,1
3349,68516,6oCDtYWE1YbVTX7pVBS5Cflb4KyRNNI9,SpATywNh6bZuzm8s1ceuBUnMUAeoAHHw,1,0,0,0,0,0,1,0,1,0.14285714285714285,1,0.0,0,0,0,0,0,0,0,1,0,0,1,1
3350,68521,iSIDy53M1GeZpXt46JkUT1CVMnifiRBT,bWdj2GDclj5ofokWjzoa5jAwMkxCykd6,6,4,1,0,1,1,3,1,11,1.5714285714285714,2,0.0,0,1,0,1,4,1,0,3,1,2,9,1
3351,68543,kS5Tu2RHO9HzXMOZp3CUIdzW6Y8prRRh,SpATywNh6bZuzm8s1ceuBUnMUAeoAHHw,14,23,0,20,0,12,9,1,65,9.285714285714286,3,0.0,9,0,16,0,14,12,4,9,1,25,40,1
3352,68544,neZ18tPUzdX2s40f6yVBysxDUKCDyzmG,SpATywNh6bZuzm8s1ceuBUnMUAeoAHHw,10,14,1,13,1,0,2,0,31,4.428571428571429,1,0.0,10,1,12,1,4,0,1,2,0,24,7,0
3353,68551,NfUq1iJeG4DoVU66A3eQnbdSJYCM4IOC,SpATywNh6bZuzm8s1ceuBUnMUAeoAHHw,6,3,2,0,1,0,2,0,8,1.1428571428571428,1,0.0,0,2,0,1,3,0,0,2,0,3,5,1
3354,68555,vle68wJbpBxaKK8jTIIpU222057lhydD,bWdj2GDclj5ofokWjzoa5jAwMkxCykd6,4,3,1,0,1,0,2,0,7,1.0,1,0.0,0,1,0,1,3,0,0,2,0,2,5,1
3355,68561,Y3Qq9FqOVwUj6PrB3KNsrLngzeSzadt5,bWdj2GDclj5ofokWjzoa5jAwMkxCykd6,9,12,5,2,2,0,6,0,27,3.857142857142857,2,0.0,1,5,2,2,11,0,0,6,0,10,17,1
3356,68563,8fwUYmiU3p577nM1EutDr5QOZIKfzBRc,RXDvfPUBYFlVdlueBFbLW0mhhAyGEqpt,46,58,24,107,9,25,13,12,248,35.42857142857143,4,0.0,11,24,103,9,47,25,4,13,12,147,101,0
3357,68567,IFerpKRFijjTvFKVmnLPfRMMDF4cIZJF,SpATywNh6bZuzm8s1ceuBUnMUAeoAHHw,7,4,0,0,0,0,5,0,9,1.2857142857142858,1,0.0,0,0,0,0,4,0,0,5,0,0,9,1
3358,68585,Glxmm6OkKDEBHVvI7QqNEC5RvmqUE0HS,bWdj2GDclj5ofokWjzoa5jAwMkxCykd6,4,3,2,0,1,0,2,0,8,1.1428571428571428,1,0.0,0,2,0,1,3,0,0,2,0,3,5,1
3359,68590,E8oGkXDZccLFAlXi9bJFdyG7ZjuPGPVx,bWdj2GDclj5ofokWjzoa5jAwMkxCykd6,6,5,3,0,2,0,6,0,16,2.2857142857142856,1,0.0,0,3,0,2,5,0,0,6,0,5,11,1
3360,68593,ko8ha9Nr4wk6DeuPN4U2tszPncta4AJu,RXDvfPUBYFlVdlueBFbLW0mhhAyGEqpt,6,5,2,0,2,0,1,0,10,1.4285714285714286,1,0.0,0,2,0,2,5,0,0,1,0,4,6,1
3361,68594,rPL0mqKklpGJ7nKQwJfgLcDkUtLeeh8C,SpATywNh6bZuzm8s1ceuBUnMUAeoAHHw,1,0,0,0,0,0,1,0,1,0.14285714285714285,1,0.0,0,0,0,0,0,0,0,1,0,0,1,1
3362,68600,w4KVb9q7mwoVRgCyZI0dPAL72VxyapbO,SpATywNh6bZuzm8s1ceuBUnMUAeoAHHw,17,25,10,10,4,13,23,1,86,12.285714285714286,2,0.0,12,10,9,4,13,13,1,23,1,35,51,0
3363,68608,xKFuemwLTt1HbT05n0729C3MfJQfGzio,bWdj2GDclj5ofokWjzoa5jAwMkxCykd6,8,8,2,0,2,0,4,0,16,2.2857142857142856,2,0.0,0,2,0,2,8,0,0,4,0,4,12,1
3364,68614,oA0E9aMtllY5HCZuDmQFAhbdEUxnmzHK,SpATywNh6bZuzm8s1ceuBUnMUAeoAHHw,14,13,5,18,3,5,6,0,50,7.142857142857143,2,0.0,5,5,15,3,8,5,3,6,0,28,22,1
3365,68615,mPyp7jTeTZOoi8uKfW9n4yxp1m3yxLU6,SpATywNh6bZuzm8s1ceuBUnMUAeoAHHw,16,12,6,11,3,3,7,1,43,6.142857142857143,2,0.0,3,6,10,3,9,3,1,7,1,22,21,1
3366,68623,F5DvCuAufOHMNW6g3uuO7OUr15Bgdj9y,SpATywNh6bZuzm8s1ceuBUnMUAeoAHHw,14,30,15,15,5,18,10,0,93,13.285714285714286,2,0.0,4,15,13,5,26,18,2,10,0,37,56,0
3367,68633,EoHwSWSzaw8CNhaYKiwnwX4BUG0jVkiR,G8EPVSXsOYB5YQWZGiz1aVq5Pgr2GrQu,28,35,10,95,5,0,7,0,152,21.714285714285715,2,0.0,20,10,79,5,15,0,16,7,0,114,38,1
3368,68643,800D5qwHCt3Ko9pzEVC49paGCt6dYzm8,bWdj2GDclj5ofokWjzoa5jAwMkxCykd6,14,61,32,26,10,79,18,0,226,32.285714285714285,6,0.0,11,32,23,10,50,79,3,18,0,76,150,1
3369,68645,uSpti6Yw7qPzPT4S4dLtJ0lPSlE5C6Xf,RXDvfPUBYFlVdlueBFbLW0mhhAyGEqpt,1,0,0,0,0,0,1,0,1,0.14285714285714285,1,0.0,0,0,0,0,0,0,0,1,0,0,1,1
3370,68648,xHynkOdioqQyjpJfj8K7fiM1HqYlBJD7,SpATywNh6bZuzm8s1ceuBUnMUAeoAHHw,9,9,5,0,4,0,8,0,26,3.7142857142857144,2,0.0,0,5,0,4,9,0,0,8,0,9,17,1
3371,68652,HVM7cvH7tmJviHLVmU4moAWMBQcFDIXR,SpATywNh6bZuzm8s1ceuBUnMUAeoAHHw,1,0,0,0,0,0,1,0,1,0.14285714285714285,1,0.0,0,0,0,0,0,0,0,1,0,0,1,1
3372,68663,uWg9viAyRsUVYkVv3Yy7uJ56PNmRweOf,SpATywNh6bZuzm8s1ceuBUnMUAeoAHHw,7,3,1,0,1,1,3,0,9,1.2857142857142858,1,0.0,0,1,0,1,3,1,0,3,0,2,7,1
3373,68668,LJN1NW4KDrkfGUEkF9SJPSL4rdPIFcim,bWdj2GDclj5ofokWjzoa5jAwMkxCykd6,9,14,0,8,3,15,8,1,49,7.0,2,0.0,8,0,8,3,6,15,0,8,1,19,30,1
3374,68669,UpJrRBQ59x3Gn5L7s007cXh7Wi1pgqj5,G8EPVSXsOYB5YQWZGiz1aVq5Pgr2GrQu,1,0,0,0,0,0,1,0,1,0.14285714285714285,1,0.0,0,0,0,0,0,0,0,1,0,0,1,1
3375,68672,XlAtLUmCwQMJblZxz5Uj8YKvORzQq8sL,bWdj2GDclj5ofokWjzoa5jAwMkxCykd6,2,0,0,0,0,0,2,0,2,0.2857142857142857,1,0.0,0,0,0,0,0,0,0,2,0,0,2,1
3376,68673,LDvIjeK3BrrUiPE6HdHKfvDgiWdtz8gl,bWdj2GDclj5ofokWjzoa5jAwMkxCykd6,5,5,2,0,1,0,3,0,11,1.5714285714285714,2,0.0,0,2,0,1,5,0,0,3,0,3,8,1
3377,68675,ZBFATksKEZIW0yZpEc4DInpubrEeq3eS,SpATywNh6bZuzm8s1ceuBUnMUAeoAHHw,12,15,8,4,4,0,1,0,32,4.571428571428571,2,0.0,2,8,4,4,13,0,0,1,0,18,14,1
3378,68684,wL3zK87VyJEaxj3JDk5zLpiovNVlVgY0,SpATywNh6bZuzm8s1ceuBUnMUAeoAHHw,9,4,3,0,3,0,3,0,13,1.8571428571428572,1,0.0,0,3,0,3,4,0,0,3,0,6,7,1
3379,68685,0sGUIxoauZHFSZVR3Y4LtOM6Pq2DRxjU,SpATywNh6bZuzm8s1ceuBUnMUAeoAHHw,6,2,1,0,1,0,3,0,7,1.0,1,0.0,0,1,0,1,2,0,0,3,0,2,5,1
3380,68686,YRBA7GRiLrrlZjduaK8N9tfqRO36138H,SpATywNh6bZuzm8s1ceuBUnMUAeoAHHw,14,33,9,19,5,0,7,0,73,10.428571428571429,4,0.0,8,9,15,5,25,0,4,7,0,37,36,0
3381,68690,vsAcPV04LnM01WalbcA4jNxiuu2qNyeQ,SpATywNh6bZuzm8s1ceuBUnMUAeoAHHw,16,48,13,16,5,23,14,3,122,17.428571428571427,4,0.0,19,13,15,5,29,23,1,14,3,52,70,0
3382,68694,SPA2zjP6CEFeNMb3HCTy4jT9WpFTBDct,SpATywNh6bZuzm8s1ceuBUnMUAeoAHHw,15,17,6,11,3,1,7,1,46,6.571428571428571,2,0.0,2,6,10,3,15,1,1,7,1,21,25,1
3383,68698,L0kYOQ1jlQCXWFfUIC5KdixPfS0gzVfJ,SpATywNh6bZuzm8s1ceuBUnMUAeoAHHw,1,0,0,0,0,0,1,0,1,0.14285714285714285,1,0.0,0,0,0,0,0,0,0,1,0,0,1,1
3384,68702,vX3VPIJhPCYSA7dPeCf6CgdqKnk7djlz,SpATywNh6bZuzm8s1ceuBUnMUAeoAHHw,1,0,0,0,0,0,1,0,1,0.14285714285714285,1,0.0,0,0,0,0,0,0,0,1,0,0,1,1
3385,68706,i1TcNs7eTFFk7oCk5M8KreZU8FvcW9bN,SpATywNh6bZuzm8s1ceuBUnMUAeoAHHw,5,1,1,0,1,3,2,0,8,1.1428571428571428,1,0.0,0,1,0,1,1,3,0,2,0,2,6,1
3386,68714,AUQbcN6sP8jOc3r7pDcomR6R8baoxLvG,SpATywNh6bZuzm8s1ceuBUnMUAeoAHHw,9,9,4,0,3,0,5,0,21,3.0,1,0.0,1,4,0,3,8,0,0,5,0,8,13,1
3387,68715,naqtjO9tZgTvMaAs9wVFgT7OrPAljiOn,bWdj2GDclj5ofokWjzoa5jAwMkxCykd6,6,6,2,0,1,0,4,0,13,1.8571428571428572,2,0.0,1,2,0,1,5,0,0,4,0,4,9,1
3388,68725,v9XA8V9r9cuRk407xmjctqU28ZOWPjKH,SpATywNh6bZuzm8s1ceuBUnMUAeoAHHw,11,14,2,14,1,9,4,0,44,6.285714285714286,2,0.0,4,2,13,1,10,9,1,4,0,20,24,1
3389,68726,9DFLyn8rbv9Edwun9eQjrB5tgbqXjOr5,RXDvfPUBYFlVdlueBFbLW0mhhAyGEqpt,13,24,11,0,8,3,10,1,57,8.142857142857142,3,0.0,2,11,0,8,22,3,0,10,1,21,36,1
3390,68728,OPI0XMiYXF2KbjFje02yg2IsfXd4KQW0,G8EPVSXsOYB5YQWZGiz1aVq5Pgr2GrQu,1,0,0,0,0,0,1,0,1,0.14285714285714285,1,0.0,0,0,0,0,0,0,0,1,0,0,1,1
3391,68729,fgHXEx1kTgwNtn0duzRnGZnTM9G4nrHz,SpATywNh6bZuzm8s1ceuBUnMUAeoAHHw,7,6,4,0,3,0,2,0,15,2.142857142857143,2,0.0,0,4,0,3,6,0,0,2,0,7,8,1
3392,68734,U7RYhML9VmouEXOzi3jihOcHs1Odr6nQ,SpATywNh6bZuzm8s1ceuBUnMUAeoAHHw,4,2,1,0,1,2,2,0,8,1.1428571428571428,1,0.0,0,1,0,1,2,2,0,2,0,2,6,1
3393,68735,3JdonxNhNI9NQjhEwg0qbYv0wUomYvrC,SpATywNh6bZuzm8s1ceuBUnMUAeoAHHw,4,2,1,0,0,0,2,0,5,0.7142857142857143,1,0.0,0,1,0,0,2,0,0,2,0,1,4,1
3394,68738,8mpNTb2f22eIFQe95nOOySrTvXoHGtkW,SpATywNh6bZuzm8s1ceuBUnMUAeoAHHw,5,1,1,0,0,0,4,0,6,0.8571428571428571,1,0.0,0,1,0,0,1,0,0,4,0,1,5,1
3395,68742,kv6R7WjolUetaoWMs79hGLWsktu3yDdz,bWdj2GDclj5ofokWjzoa5jAwMkxCykd6,7,10,2,0,1,0,5,0,18,2.5714285714285716,1,0.0,0,2,0,1,10,0,0,5,0,3,15,1
3396,68744,Gt9BtVmn4m8oLlyiIlUegGAp2m9g8UFD,SpATywNh6bZuzm8s1ceuBUnMUAeoAHHw,9,10,4,0,2,0,6,1,23,3.2857142857142856,2,0.0,0,4,0,2,10,0,0,6,1,6,17,1
3397,68753,i3mc4Kbynj5lAgvXLfa16WvI77RFTi9E,SpATywNh6bZuzm8s1ceuBUnMUAeoAHHw,13,21,4,17,1,11,9,3,66,9.428571428571429,2,0.0,15,4,16,1,6,11,1,9,3,36,30,1
3398,68756,GbO46rd9u4nTIYKWQ4uqsc2u6MxCvlf3,bWdj2GDclj5ofokWjzoa5jAwMkxCykd6,8,17,10,0,0,0,10,0,37,5.285714285714286,4,0.0,2,10,0,0,15,0,0,10,0,12,25,1
3399,68766,o9OiuR1V9DDjBMFIfw7sS4DiqEBIQuP8,SpATywNh6bZuzm8s1ceuBUnMUAeoAHHw,1,0,0,0,0,0,1,0,1,0.14285714285714285,1,0.0,0,0,0,0,0,0,0,1,0,0,1,1
3400,68769,RtEFZWMpyIRlgcponU0BmtpKa8uVqiIS,bWdj2GDclj5ofokWjzoa5jAwMkxCykd6,8,8,2,0,1,19,9,1,40,5.714285714285714,3,0.0,2,2,0,1,6,19,0,9,1,5,35,1
3401,68770,yo49sG8PZONryMrR1vxvvUfG4Kw6dJSG,bWdj2GDclj5ofokWjzoa5jAwMkxCykd6,1,0,0,0,0,0,1,0,1,0.14285714285714285,1,0.0,0,0,0,0,0,0,0,1,0,0,1,1
3402,68773,G1AwzYA13F3hOahvKjBBoTuWWSrXyEmf,SpATywNh6bZuzm8s1ceuBUnMUAeoAHHw,8,20,1,0,1,1,18,0,41,5.857142857142857,4,0.0,1,1,0,1,19,1,0,18,0,3,38,1
3403,68774,b7XeenIAmbbWWMDukegOQ8zSwFKoA3Yg,SpATywNh6bZuzm8s1ceuBUnMUAeoAHHw,6,10,1,0,1,0,5,0,17,2.4285714285714284,2,0.0,0,1,0,1,10,0,0,5,0,2,15,1
3404,68779,r5IH8s4isWFYMIVZOSBCnIzOrNuqNLMt,RXDvfPUBYFlVdlueBFbLW0mhhAyGEqpt,2,0,0,0,0,0,3,0,3,0.42857142857142855,1,0.0,0,0,0,0,0,0,0,3,0,0,3,1
3405,68781,THXcc2NGn7OhkfHl1lLehmfkJwTtl0vs,SpATywNh6bZuzm8s1ceuBUnMUAeoAHHw,18,18,8,15,3,37,13,2,96,13.714285714285714,4,0.0,6,8,15,3,12,37,0,13,2,32,64,1
3406,68782,0txLoRwFKi6b3jBavBHeGS8Bc3NOwsVb,SpATywNh6bZuzm8s1ceuBUnMUAeoAHHw,6,2,1,0,1,1,4,0,9,1.2857142857142858,2,0.0,0,1,0,1,2,1,0,4,0,2,7,1
3407,68784,QhYcOEapN0nrffEwA6S7jQzZwToRePP8,SpATywNh6bZuzm8s1ceuBUnMUAeoAHHw,5,7,5,0,0,0,2,0,14,2.0,2,0.0,0,5,0,0,7,0,0,2,0,5,9,1
3408,68786,zikfbKKf6UwbalVzNX9BImZBlJFR20fk,bWdj2GDclj5ofokWjzoa5jAwMkxCykd6,5,0,0,0,0,2,7,0,9,1.2857142857142858,2,0.0,0,0,0,0,0,2,0,7,0,0,9,1
3409,68792,SmrYmgxL1AB7vaaR6Foc1c7Uyze9dDt7,RXDvfPUBYFlVdlueBFbLW0mhhAyGEqpt,1,0,0,0,0,0,1,0,1,0.14285714285714285,1,0.0,0,0,0,0,0,0,0,1,0,0,1,1
3410,68797,7BZDKYSiNttbGsEOSXAkMuiEhZ6QNT9G,bWdj2GDclj5ofokWjzoa5jAwMkxCykd6,16,27,15,46,2,38,5,1,134,19.142857142857142,2,0.0,10,15,42,2,17,38,4,5,1,69,65,1
3411,68805,xjDtTrSSXACX8VZBwSxlHbYQJ7eeUCIt,SpATywNh6bZuzm8s1ceuBUnMUAeoAHHw,5,2,1,0,1,0,2,0,6,0.8571428571428571,2,0.0,0,1,0,1,2,0,0,2,0,2,4,1
3412,68807,3vpFIgzmYroxEHJb2wiXr0H3xcuBXZTn,SpATywNh6bZuzm8s1ceuBUnMUAeoAHHw,1,0,0,0,0,0,1,0,1,0.14285714285714285,1,0.0,0,0,0,0,0,0,0,1,0,0,1,1
3413,68830,RqkVdaWIELGLgdM7036pqEWeMvYmKVEW,A3fsA9Zfv1X2fVEQhTw51lKENdNrEqT3,1,0,0,0,0,0,1,0,1,0.14285714285714285,1,0.0,0,0,0,0,0,0,0,1,0,0,1,1
3414,68844,EleMlloryvuXR0G9AOtui0gfdXfrUQfc,SpATywNh6bZuzm8s1ceuBUnMUAeoAHHw,10,14,0,0,0,1,12,0,27,3.857142857142857,2,0.0,2,0,0,0,12,1,0,12,0,2,25,1
3415,68888,de81RIzfVtIgQfKrUlwLBazhrka9zYFQ,RXDvfPUBYFlVdlueBFbLW0mhhAyGEqpt,19,14,10,30,8,4,5,0,71,10.142857142857142,1,0.0,4,10,28,8,10,4,2,5,0,50,21,1
3416,68914,KwglP5SNsu1REAmS7zGy1xBBD4v1B0TU,A3fsA9Zfv1X2fVEQhTw51lKENdNrEqT3,2,0,0,0,0,0,3,0,3,0.42857142857142855,1,0.0,0,0,0,0,0,0,0,3,0,0,3,1
3417,68924,ekbuMTLYQMuR0OvEI2LJUhDBg5Hzduc2,SpATywNh6bZuzm8s1ceuBUnMUAeoAHHw,3,2,1,0,0,0,3,0,6,0.8571428571428571,1,0.0,0,1,0,0,2,0,0,3,0,1,5,1
3418,68939,qUJHOEJOIUq6GHsEj06xYmT7rQa6YMuP,SpATywNh6bZuzm8s1ceuBUnMUAeoAHHw,5,2,1,0,1,0,2,0,6,0.8571428571428571,1,0.0,0,1,0,1,2,0,0,2,0,2,4,1
3419,68944,iLiEQfwv1SBVYie6f2UeSo0gjqwSPq60,SpATywNh6bZuzm8s1ceuBUnMUAeoAHHw,12,15,1,14,0,1,3,1,35,5.0,1,0.0,7,1,13,0,8,1,1,3,1,21,14,1
3420,68957,03OlEjthtH7bdIcwtrFwO8IymW2gZt4t,SpATywNh6bZuzm8s1ceuBUnMUAeoAHHw,14,45,0,20,0,47,23,8,143,20.428571428571427,2,0.0,15,0,16,0,30,47,4,23,8,31,112,0
3421,68965,wyjPcrAJWPhHnDHJIjk8dYEEg9jaoLeO,A3fsA9Zfv1X2fVEQhTw51lKENdNrEqT3,5,2,1,0,1,0,2,0,6,0.8571428571428571,1,0.0,0,1,0,1,2,0,0,2,0,2,4,1
3422,68983,drUu3tyovHqnF7EAaPHayHDYbWMe2Od6,SpATywNh6bZuzm8s1ceuBUnMUAeoAHHw,1,0,0,0,0,0,1,0,1,0.14285714285714285,1,0.0,0,0,0,0,0,0,0,1,0,0,1,1
3423,69017,fo11APiMDJF2DjuYtDFoBE2X6zRUvD0O,A3fsA9Zfv1X2fVEQhTw51lKENdNrEqT3,7,4,3,0,0,1,4,0,12,1.7142857142857142,1,0.0,0,3,0,0,4,1,0,4,0,3,9,1
3424,69038,DanoP5XpHODQZmwuFGZgNKBiu5nY9yH1,A3fsA9Zfv1X2fVEQhTw51lKENdNrEqT3,38,20,12,68,11,0,2,0,113,16.142857142857142,1,0.0,5,12,59,11,15,0,9,2,0,87,26,1
3425,69066,0a6HihupPBi4xpjolN637qOYG6WSN1Gx,SpATywNh6bZuzm8s1ceuBUnMUAeoAHHw,17,86,53,15,22,40,20,0,236,33.714285714285715,5,0.0,18,53,12,22,68,40,3,20,0,105,131,0
3426,69070,g5yKalRrHBvoyNkzpNTa67etQfVwykko,SpATywNh6bZuzm8s1ceuBUnMUAeoAHHw,16,22,6,23,3,5,7,1,67,9.571428571428571,1,0.0,12,6,18,3,10,5,5,7,1,39,28,0
3427,69076,cy1UxkAxcqJswFy9Syqm01bsE17PQcla,SpATywNh6bZuzm8s1ceuBUnMUAeoAHHw,18,28,14,30,6,11,15,2,106,15.142857142857142,3,0.0,9,14,21,6,19,11,9,15,2,50,56,0
3428,69081,BByvTH8isxSvKoMrLrxzWQ5eR0EYxeSe,SpATywNh6bZuzm8s1ceuBUnMUAeoAHHw,7,7,2,0,2,0,5,0,16,2.2857142857142856,2,0.0,0,2,0,2,7,0,0,5,0,4,12,1
3429,69087,sydTASQZF88RFtSW5G7BxBO6Hd5gV1Jf,A3fsA9Zfv1X2fVEQhTw51lKENdNrEqT3,13,17,8,0,6,0,2,0,33,4.714285714285714,1,0.0,0,8,0,6,17,0,0,2,0,14,19,1
3430,69098,EXVoxE3v0YCKVCUy0azISc65MiXBDpAw,SpATywNh6bZuzm8s1ceuBUnMUAeoAHHw,11,9,5,0,2,0,6,0,22,3.142857142857143,1,0.0,2,5,0,2,7,0,0,6,0,9,13,1
3431,69118,27R6lnSTl4HmEumP2huFCqg7wjTw1o6f,SpATywNh6bZuzm8s1ceuBUnMUAeoAHHw,10,9,3,0,1,2,10,2,27,3.857142857142857,2,0.0,0,3,0,1,9,2,0,10,2,4,23,1
3432,69122,JsUpucQyiTLV5gDB7KrgqzRdiUsoUyeZ,A3fsA9Zfv1X2fVEQhTw51lKENdNrEqT3,1,0,0,0,0,0,1,0,1,0.14285714285714285,1,0.0,0,0,0,0,0,0,0,1,0,0,1,1
3433,69127,y7mamutAMELy79Bgdj0zOeVjiQ071oNX,bWdj2GDclj5ofokWjzoa5jAwMkxCykd6,5,2,1,0,1,0,3,0,7,1.0,1,0.0,0,1,0,1,2,0,0,3,0,2,5,1
3434,69130,pGYLDmhkSj1iBp1YljlDSId0XSrjZNZR,SpATywNh6bZuzm8s1ceuBUnMUAeoAHHw,14,11,7,11,4,0,3,0,36,5.142857142857143,2,0.0,2,7,10,4,9,0,1,3,0,23,13,1
3435,69138,C5Rja3fyOmRxfpM2pXQmwA2G5rEfb320,SpATywNh6bZuzm8s1ceuBUnMUAeoAHHw,14,15,2,12,1,2,20,2,54,7.714285714285714,2,0.0,2,2,9,1,13,2,3,20,2,14,40,1
3436,69140,EJxY61pifGLoX5582yQzVg4H77fLkSml,A3fsA9Zfv1X2fVEQhTw51lKENdNrEqT3,5,2,1,0,1,0,5,0,9,1.2857142857142858,1,0.0,0,1,0,1,2,0,0,5,0,2,7,1
3437,69160,Vnhhp2QbBiDiUTTHmXkksXuO8NCNMbjj,A3fsA9Zfv1X2fVEQhTw51lKENdNrEqT3,3,0,0,0,0,0,3,0,3,0.42857142857142855,1,0.0,0,0,0,0,0,0,0,3,0,0,3,1
3438,69172,g2ieOC0GwkKqaZWeJNXowTArkXtXRKC6,SpATywNh6bZuzm8s1ceuBUnMUAeoAHHw,1,0,0,0,0,0,1,0,1,0.14285714285714285,1,0.0,0,0,0,0,0,0,0,1,0,0,1,0
3439,69179,WX5bge9EFbPypYuObEiSD1Gyvh8Z866G,A3fsA9Zfv1X2fVEQhTw51lKENdNrEqT3,5,2,1,0,1,0,2,0,6,0.8571428571428571,1,0.0,0,1,0,1,2,0,0,2,0,2,4,1
3440,69218,YZJnbvfbnhVRirLqDRHGzQv4606Wu6TO,bWdj2GDclj5ofokWjzoa5jAwMkxCykd6,8,4,2,0,2,2,3,1,14,2.0,1,0.0,1,2,0,2,3,2,0,3,1,5,9,1
3441,69233,W8K4VS8rPvnPTNUJrqgtS2FKH93KmR91,A3fsA9Zfv1X2fVEQhTw51lKENdNrEqT3,12,52,26,0,0,3,16,0,97,13.857142857142858,5,0.0,0,26,0,0,52,3,0,16,0,26,71,1
3442,69261,Y0yiSfPX9V0A8oNPfdzCuT5yHRuHvSj6,SpATywNh6bZuzm8s1ceuBUnMUAeoAHHw,7,3,2,0,2,0,2,0,9,1.2857142857142858,1,0.0,0,2,0,2,3,0,0,2,0,4,5,1
3443,69262,X9IKf8GgqS6dvoKX3VBo51mIr8yb4uFC,A3fsA9Zfv1X2fVEQhTw51lKENdNrEqT3,44,52,21,54,12,5,18,5,167,23.857142857142858,2,0.0,7,21,51,12,45,5,3,18,5,91,76,1
3444,69270,2XqSSCGvWuNVBTm3MCFePDMOSuloLKPQ,SpATywNh6bZuzm8s1ceuBUnMUAeoAHHw,1,0,0,0,0,0,1,0,1,0.14285714285714285,1,0.0,0,0,0,0,0,0,0,1,0,0,1,1
3445,69273,61kObDGseAVKKKJnoykLCdN2clfrzPTZ,SpATywNh6bZuzm8s1ceuBUnMUAeoAHHw,15,18,6,16,5,0,4,0,49,7.0,1,0.0,6,6,13,5,12,0,3,4,0,30,19,1
3446,69279,HKRHFribtFXCazZMADj8ySc6wcBJmS1L,A3fsA9Zfv1X2fVEQhTw51lKENdNrEqT3,10,4,3,0,2,1,6,0,16,2.2857142857142856,1,0.0,0,3,0,2,4,1,0,6,0,5,11,1
3447,69304,JR238GZjZ1ruNiJtwVaWypz6LFnrEv5m,A3fsA9Zfv1X2fVEQhTw51lKENdNrEqT3,9,7,4,0,0,0,12,0,23,3.2857142857142856,2,0.0,0,4,0,0,7,0,0,12,0,4,19,1
3448,69305,1RaxWRR42BzbDLa8H5HkFu4x9YPe7T0C,A3fsA9Zfv1X2fVEQhTw51lKENdNrEqT3,9,4,2,0,2,0,6,0,14,2.0,1,0.0,1,2,0,2,3,0,0,6,0,5,9,1
3449,69313,JZ8D07WpMQUIA2O2a3f2Q2gV7h70rqbC,SpATywNh6bZuzm8s1ceuBUnMUAeoAHHw,6,3,2,0,2,0,1,0,8,1.1428571428571428,1,0.0,0,2,0,2,3,0,0,1,0,4,4,1
3450,69344,mAEhdvjtLD2ESiLI6ko7GgTTKTJ1f5Tn,SpATywNh6bZuzm8s1ceuBUnMUAeoAHHw,11,37,11,15,1,5,5,1,75,10.714285714285714,1,0.0,23,11,13,1,14,5,2,5,1,48,27,1
3451,69364,4cOOYrtQdvpiZuIPnsoBt4lhRdbqEcsp,SpATywNh6bZuzm8s1ceuBUnMUAeoAHHw,2,0,0,0,0,0,2,0,2,0.2857142857142857,1,0.0,0,0,0,0,0,0,0,2,0,0,2,1
3452,69369,uMEUDlZ1tL8WoZ2EmL0CStSYwA0zOal8,bWdj2GDclj5ofokWjzoa5jAwMkxCykd6,9,4,2,8,2,0,4,0,20,2.857142857142857,1,0.0,1,2,8,2,3,0,0,4,0,13,7,1
3453,69404,EB2RCe088gjmT7cbJrt6urBwZOusH5vg,SpATywNh6bZuzm8s1ceuBUnMUAeoAHHw,16,22,12,18,6,0,8,0,66,9.428571428571429,2,0.0,7,12,15,6,15,0,3,8,0,40,26,1
3454,69422,1taO8BWZHffh7l7BaqgWcQJY3gQ1z1ac,A3fsA9Zfv1X2fVEQhTw51lKENdNrEqT3,5,0,0,0,0,0,5,1,6,0.8571428571428571,1,0.0,0,0,0,0,0,0,0,5,1,0,6,1
3455,69435,vPqhvdjrX3GgCAjq6K96tYCv7DiMTBkh,SpATywNh6bZuzm8s1ceuBUnMUAeoAHHw,12,18,1,10,1,0,6,0,36,5.142857142857143,2,0.0,6,1,9,1,12,0,1,6,0,17,19,0
3456,69437,tHPSGx00vsFzhzr0zwBlWWarqJT4wPHF,bWdj2GDclj5ofokWjzoa5jAwMkxCykd6,4,2,1,0,1,0,1,0,5,0.7142857142857143,1,0.0,0,1,0,1,2,0,0,1,0,2,3,1
3457,69439,WELjmgdsP962Pc1teJ96xvofKraKe6qa,A3fsA9Zfv1X2fVEQhTw51lKENdNrEqT3,29,29,20,30,12,32,25,4,152,21.714285714285715,4,0.0,0,20,28,12,29,32,2,25,4,60,92,1
3458,69444,sfdgnQL9ZJy8iQoJsTh6pz33V1sjsZlD,A3fsA9Zfv1X2fVEQhTw51lKENdNrEqT3,24,15,12,0,8,0,7,0,42,6.0,2,0.0,0,12,0,8,15,0,0,7,0,20,22,0
3459,69471,x9up4wvnaS79M9udGA7fqhv1sigb86bK,SpATywNh6bZuzm8s1ceuBUnMUAeoAHHw,6,4,2,0,1,3,2,0,12,1.7142857142857142,1,0.0,0,2,0,1,4,3,0,2,0,3,9,1
3460,69499,oG7qUH6PFRXdknLnOhOWneHPtBW8Ta2o,A3fsA9Zfv1X2fVEQhTw51lKENdNrEqT3,3,0,0,0,0,0,3,0,3,0.42857142857142855,1,0.0,0,0,0,0,0,0,0,3,0,0,3,0
3461,69540,a160ewxyRJdtN45GnX3uGxkLMyeZKvV7,bWdj2GDclj5ofokWjzoa5jAwMkxCykd6,9,12,5,84,4,7,5,1,118,16.857142857142858,1,0.0,4,5,82,4,8,7,2,5,1,95,23,1
3462,69551,WfPfJn9lrx0nGBfxPbzYzJSQElx0Vya0,A3fsA9Zfv1X2fVEQhTw51lKENdNrEqT3,7,7,6,0,1,0,1,0,15,2.142857142857143,3,0.0,0,6,0,1,7,0,0,1,0,7,8,1
3463,69567,q3DUInVVvDGT22ACyMKixODyUkgLOKmI,SpATywNh6bZuzm8s1ceuBUnMUAeoAHHw,7,5,2,0,2,0,2,0,11,1.5714285714285714,1,0.0,0,2,0,2,5,0,0,2,0,4,7,1
3464,69577,zdQpZzeZtdBJrKxe0kkh4zz1KUaEeB2I,G8EPVSXsOYB5YQWZGiz1aVq5Pgr2GrQu,5,5,3,0,2,2,1,0,13,1.8571428571428572,1,0.0,0,3,0,2,5,2,0,1,0,5,8,1
3465,69583,82WiuHoB3dVqYkf2UKsu9ogC0IsQQnqa,A3fsA9Zfv1X2fVEQhTw51lKENdNrEqT3,5,3,0,0,0,0,3,0,6,0.8571428571428571,1,0.0,0,0,0,0,3,0,0,3,0,0,6,1
3466,69602,ebvWYER6Bde0EUcNXXIX0vyTB9ur6Kqi,bWdj2GDclj5ofokWjzoa5jAwMkxCykd6,3,2,0,0,0,0,1,0,3,0.42857142857142855,1,0.0,0,0,0,0,2,0,0,1,0,0,3,1
3467,69604,ebvWYER6Bde0EUcNXXIX0vyTB9ur6Kqi,RXDvfPUBYFlVdlueBFbLW0mhhAyGEqpt,8,5,0,0,0,1,5,1,12,1.7142857142857142,1,0.0,0,0,0,0,5,1,0,5,1,0,12,1
3468,69608,luffaRyMH17lmf9lXIITCUvmvLstdhJF,SpATywNh6bZuzm8s1ceuBUnMUAeoAHHw,7,6,1,0,1,0,2,0,10,1.4285714285714286,1,0.0,2,1,0,1,4,0,0,2,0,4,6,1
3469,69616,faupOzOQrYnrhUP3CZcXERH5hL8Q3xd2,SpATywNh6bZuzm8s1ceuBUnMUAeoAHHw,14,17,10,10,5,23,6,0,71,10.142857142857142,4,0.0,4,10,10,5,13,23,0,6,0,29,42,1
3470,69650,tD4YaA9C1jzNLnr7tPBZ897xHEsnzm9F,A3fsA9Zfv1X2fVEQhTw51lKENdNrEqT3,1,0,0,0,0,0,1,0,1,0.14285714285714285,1,0.0,0,0,0,0,0,0,0,1,0,0,1,1
3471,69680,tes6smsqnnhtic7mel4he0HOVKxdsIk0,SpATywNh6bZuzm8s1ceuBUnMUAeoAHHw,4,2,1,0,1,0,2,0,6,0.8571428571428571,1,0.0,0,1,0,1,2,0,0,2,0,2,4,1
3472,69682,DpqUZKEZpIFvZzvEXk8oaJMRAbEfypNN,A3fsA9Zfv1X2fVEQhTw51lKENdNrEqT3,25,20,15,0,14,0,6,0,55,7.857142857142857,1,0.0,2,15,0,14,18,0,0,6,0,31,24,1
3473,69684,jKWIhuXmlYFBIapfd4E50TBTHed3oveP,SpATywNh6bZuzm8s1ceuBUnMUAeoAHHw,14,19,7,12,3,1,3,0,45,6.428571428571429,2,0.0,6,7,11,3,13,1,1,3,0,27,18,1
3474,69690,RsnXePogfsPEsPaBIDmu1zOlkZ0nGsJG,SpATywNh6bZuzm8s1ceuBUnMUAeoAHHw,8,10,4,0,5,0,14,0,33,4.714285714285714,2,0.0,2,4,0,5,8,0,0,14,0,11,22,1
3475,69693,Z3XF9lddm62bhylNbOc8gNaNENZtsGVQ,SpATywNh6bZuzm8s1ceuBUnMUAeoAHHw,5,3,1,0,0,0,3,0,7,1.0,1,0.0,0,1,0,0,3,0,0,3,0,1,6,1
3476,69702,V5MB02xz5am2kHfey21j0yueDNM7JiHU,A3fsA9Zfv1X2fVEQhTw51lKENdNrEqT3,6,3,2,0,2,0,4,0,11,1.5714285714285714,1,0.0,0,2,0,2,3,0,0,4,0,4,7,1
3477,69708,xcD6YWhnGA2xukGmX4eaYrm6VS9ffz1H,RXDvfPUBYFlVdlueBFbLW0mhhAyGEqpt,49,61,24,84,19,3,13,0,204,29.142857142857142,1,0.0,28,24,76,19,33,3,8,13,0,147,57,0
3478,69713,8gwjs0B0kUE7stjGZjvEBczr2cXGTwYJ,SpATywNh6bZuzm8s1ceuBUnMUAeoAHHw,1,0,0,0,0,0,1,0,1,0.14285714285714285,1,0.0,0,0,0,0,0,0,0,1,0,0,1,0
3479,69750,LITEXQWwZ0HwbfUIw2ZTJ1Nz80g3xPKl,RXDvfPUBYFlVdlueBFbLW0mhhAyGEqpt,1,0,0,0,0,0,1,0,1,0.14285714285714285,1,0.0,0,0,0,0,0,0,0,1,0,0,1,1
3480,69783,Nr4xgaqWlp3GY7Luca1HZwWSVTgxpORh,A3fsA9Zfv1X2fVEQhTw51lKENdNrEqT3,24,21,6,47,0,0,2,0,76,10.857142857142858,2,0.0,1,6,46,0,20,0,1,2,0,53,23,0
3481,69800,kzyt7hO7yEeJxQfXO5XM7Bawq3xoVkTz,SpATywNh6bZuzm8s1ceuBUnMUAeoAHHw,9,6,3,7,1,0,4,0,21,3.0,1,0.0,2,3,6,1,4,0,1,4,0,12,9,0
3482,69807,iysh9174eOcFH0suenSCLNsv1cqN2Oie,A3fsA9Zfv1X2fVEQhTw51lKENdNrEqT3,15,13,5,0,4,0,8,0,30,4.285714285714286,2,0.0,0,5,0,4,13,0,0,8,0,9,21,1
3483,69809,j7794Az14TTh7tEEmhTpADHq4ipGllnd,SpATywNh6bZuzm8s1ceuBUnMUAeoAHHw,18,46,17,44,4,19,14,1,145,20.714285714285715,4,0.0,22,17,38,4,24,19,6,14,1,81,64,0
3484,69831,LFBaIhK5031yuWJYVNd4qT9zLr1L16XD,A3fsA9Zfv1X2fVEQhTw51lKENdNrEqT3,9,5,3,0,3,0,4,0,15,2.142857142857143,2,0.0,1,3,0,3,4,0,0,4,0,7,8,1
3485,69841,AlFdkAawiX4QZgKaI0ukIeHoMMs579rt,A3fsA9Zfv1X2fVEQhTw51lKENdNrEqT3,1,0,0,0,0,0,1,0,1,0.14285714285714285,1,0.0,0,0,0,0,0,0,0,1,0,0,1,1
3486,69843,yIgziBEY1QeE2VunyvjKVApcpAZz6INk,bWdj2GDclj5ofokWjzoa5jAwMkxCykd6,9,16,5,20,2,4,7,0,54,7.714285714285714,1,0.0,6,5,18,2,10,4,2,7,0,31,23,1
3487,69849,jSFXNgNICT3cTdtFY1qrRx06ncJbHNIL,SpATywNh6bZuzm8s1ceuBUnMUAeoAHHw,5,2,1,0,1,0,2,0,6,0.8571428571428571,1,0.0,0,1,0,1,2,0,0,2,0,2,4,0
3488,69852,jGWjfQmpnKrCWFzIMxwjgnePo6w3vCLc,SpATywNh6bZuzm8s1ceuBUnMUAeoAHHw,14,31,13,2,8,4,10,3,71,10.142857142857142,3,0.0,16,13,2,8,15,4,0,10,3,39,32,1
3489,69854,vtTIluoXpRIe9zpqEiPikMWtGXSMpuiF,SpATywNh6bZuzm8s1ceuBUnMUAeoAHHw,15,26,8,18,3,1,7,0,63,9.0,3,0.0,8,8,15,3,18,1,3,7,0,34,29,1
3490,69856,SBz1G9CPNh7b1YKxwzjWQ2S8H7JkEfYW,SpATywNh6bZuzm8s1ceuBUnMUAeoAHHw,10,26,0,15,0,17,3,0,61,8.714285714285714,1,0.0,10,0,13,0,16,17,2,3,0,23,38,0
3491,69879,T7hyLHRci3AaSKtnxgzZP9PZimkugFag,SpATywNh6bZuzm8s1ceuBUnMUAeoAHHw,16,9,5,6,3,0,7,0,30,4.285714285714286,1,0.0,3,5,6,3,6,0,0,7,0,17,13,1
3492,69886,C89edYjc0egHm9DK0UhG6TICXc3cgfYt,SpATywNh6bZuzm8s1ceuBUnMUAeoAHHw,13,11,9,0,5,2,5,1,33,4.714285714285714,1,0.0,0,9,0,5,11,2,0,5,1,14,19,1
3493,69896,uxXbNZQzMKFVtvkoRDDVyoOZczad3AGk,A3fsA9Zfv1X2fVEQhTw51lKENdNrEqT3,1,0,0,0,0,0,1,0,1,0.14285714285714285,1,0.0,0,0,0,0,0,0,0,1,0,0,1,1
3494,69926,iC67OjDFbVlCchthNt40xrjNGlZz61fX,SpATywNh6bZuzm8s1ceuBUnMUAeoAHHw,2,0,0,0,0,0,3,0,3,0.42857142857142855,1,0.0,0,0,0,0,0,0,0,3,0,0,3,0
3495,69928,VzpntkFDzyOIiXtUxc8LkeciWhAJhdSD,SpATywNh6bZuzm8s1ceuBUnMUAeoAHHw,9,4,3,2,2,0,2,0,13,1.8571428571428572,1,0.0,0,3,2,2,4,0,0,2,0,7,6,1
3496,69933,GRXlFzfh4xOjZLiMJPGMcltQGlQAKqSw,A3fsA9Zfv1X2fVEQhTw51lKENdNrEqT3,3,2,0,0,0,0,1,0,3,0.42857142857142855,1,0.0,0,0,0,0,2,0,0,1,0,0,3,0
3497,69961,jcyADRcnQkvVHllsyVvCCi5Wcx40AoFW,A3fsA9Zfv1X2fVEQhTw51lKENdNrEqT3,1,0,0,0,0,0,1,0,1,0.14285714285714285,1,0.0,0,0,0,0,0,0,0,1,0,0,1,1
3498,69973,CabsQjb2Sd2I3ynTdtsErAG67rLex08f,A3fsA9Zfv1X2fVEQhTw51lKENdNrEqT3,2,0,0,0,0,0,2,0,2,0.2857142857142857,1,0.0,0,0,0,0,0,0,0,2,0,0,2,1
3499,69975,xL2GGqHxlfngRtz8ATMPQBFRBvX6HArr,SpATywNh6bZuzm8s1ceuBUnMUAeoAHHw,10,6,4,0,3,16,8,3,40,5.714285714285714,1,0.0,0,4,0,3,6,16,0,8,3,7,33,0
3500,70006,wBxOvXavxcvDHQtsCbkdt1VRzmB8Qh9E,bWdj2GDclj5ofokWjzoa5jAwMkxCykd6,2,0,0,0,0,0,4,0,4,0.5714285714285714,1,0.0,0,0,0,0,0,0,0,4,0,0,4,1
3501,70034,J1us9rPcxSTckBHItgnAQKi26DjcRbl6,A3fsA9Zfv1X2fVEQhTw51lKENdNrEqT3,7,3,2,0,2,0,9,0,16,2.2857142857142856,1,0.0,0,2,0,2,3,0,0,9,0,4,12,1
3502,70048,DbyuNNEIfQSCSjURAYhbFblaR63gfHlU,A3fsA9Zfv1X2fVEQhTw51lKENdNrEqT3,2,0,0,0,0,0,2,0,2,0.2857142857142857,1,0.0,0,0,0,0,0,0,0,2,0,0,2,1
3503,70050,hcNcs1eHZusVH4vyoLl8j9zdN7CZ6Lcy,SpATywNh6bZuzm8s1ceuBUnMUAeoAHHw,13,12,9,6,7,0,4,0,38,5.428571428571429,1,0.0,2,9,5,7,10,0,1,4,0,23,15,1
3504,70122,68BjCXfBFqeZ01fFx1csrFmvef5xs0w2,G8EPVSXsOYB5YQWZGiz1aVq5Pgr2GrQu,30,41,25,8,13,31,8,0,126,18.0,4,0.0,8,25,5,13,33,31,3,8,0,51,75,1
3505,70132,rSEfJyHxNlxmmbC9ORIbqcFKKq08QDrh,A3fsA9Zfv1X2fVEQhTw51lKENdNrEqT3,7,5,2,0,2,14,3,0,26,3.7142857142857144,2,0.0,0,2,0,2,5,14,0,3,0,4,22,1
3506,70147,YlInwW32qLdS6CieoVgP5nZzRZh7iEhb,A3fsA9Zfv1X2fVEQhTw51lKENdNrEqT3,11,16,8,0,5,0,4,0,33,4.714285714285714,2,0.0,0,8,0,5,16,0,0,4,0,13,20,1
3507,70368,4AzWdcwb3SG5chIViRUSkI6mbhUE2J75,fbPkOYLVPtPgIt0MxizjfFJov3JbHyAi,18,34,24,0,15,2,11,1,87,12.428571428571429,3,0.0,0,24,0,15,34,2,0,11,1,39,48,1
3508,70376,61PsrnqGMh19xjWowe2Lz8ELqYCTUUqE,fbPkOYLVPtPgIt0MxizjfFJov3JbHyAi,22,78,38,32,7,31,22,4,212,30.285714285714285,6,0.0,30,38,25,7,48,31,7,22,4,100,112,0
3509,70463,q5Mh1DiRxqFPerzFhySJn3OvdiZ2Qdjc,fbPkOYLVPtPgIt0MxizjfFJov3JbHyAi,6,3,2,0,2,0,1,0,8,1.1428571428571428,1,0.0,0,2,0,2,3,0,0,1,0,4,4,1
3510,70502,fd3M5GFuTNibIF234PDGuNuJ7TaPIle6,fbPkOYLVPtPgIt0MxizjfFJov3JbHyAi,9,5,2,0,2,0,8,0,17,2.4285714285714284,2,0.0,0,2,0,2,5,0,0,8,0,4,13,1
3511,70617,UNVbIrcEO0nclbN5f0xdIeSb61jrpRSX,fbPkOYLVPtPgIt0MxizjfFJov3JbHyAi,10,28,6,4,9,0,9,0,56,8.0,2,0.0,18,6,3,9,10,0,1,9,0,36,20,1
3512,70618,pE2pfmXY2JZ1ppA5N0APNqSGmVpRUVPY,fbPkOYLVPtPgIt0MxizjfFJov3JbHyAi,4,2,1,0,0,0,2,0,5,0.7142857142857143,1,0.0,0,1,0,0,2,0,0,2,0,1,4,1
3513,70620,szRdvMC9nJxtimPyvxBftIjBA99HXMVn,fbPkOYLVPtPgIt0MxizjfFJov3JbHyAi,5,2,1,0,1,0,2,0,6,0.8571428571428571,1,0.0,0,1,0,1,2,0,0,2,0,2,4,1
3514,70622,vL40lDIpwhva8z6IagRWvDtekT2W0mhZ,fbPkOYLVPtPgIt0MxizjfFJov3JbHyAi,5,2,1,0,1,2,2,0,8,1.1428571428571428,1,0.0,0,1,0,1,2,2,0,2,0,2,6,1
3515,70623,MIB3h4eZc4hBNhmh6kNQRNuuqfplV8jE,fbPkOYLVPtPgIt0MxizjfFJov3JbHyAi,2,0,0,0,0,0,3,0,3,0.42857142857142855,1,0.0,0,0,0,0,0,0,0,3,0,0,3,1
3516,70624,ig7R2lu2J2odRrDTiKZUVfTrsahUIcRt,fbPkOYLVPtPgIt0MxizjfFJov3JbHyAi,5,2,1,0,1,0,3,0,7,1.0,2,0.0,0,1,0,1,2,0,0,3,0,2,5,0
3517,70625,07qmQr7YUC93IIwpmr9s2O0n03vLXYHf,fbPkOYLVPtPgIt0MxizjfFJov3JbHyAi,5,4,1,0,1,0,2,0,8,1.1428571428571428,1,0.0,1,1,0,1,3,0,0,2,0,3,5,1
3518,70626,QhtGT2PDmxENzsHDxP88jgz9lWXkKr4b,fbPkOYLVPtPgIt0MxizjfFJov3JbHyAi,9,20,9,6,9,4,1,0,49,7.0,1,0.0,3,9,5,9,17,4,1,1,0,26,23,1
3519,70627,VJsbRtMXxy8aqyccEZDzV7pPAGBosBu1,fbPkOYLVPtPgIt0MxizjfFJov3JbHyAi,26,45,30,11,12,6,15,2,121,17.285714285714285,5,0.0,6,30,10,12,39,6,1,15,2,58,63,0
3520,70629,jsdFWuQZ9wDLCnnTt28t2BLCDeZlTxUM,fbPkOYLVPtPgIt0MxizjfFJov3JbHyAi,6,5,1,0,1,0,2,0,9,1.2857142857142858,1,0.0,0,1,0,1,5,0,0,2,0,2,7,1
3521,70632,sMynuMhoZTpmWI7JIgM7Zcgv9Nw77yWq,fbPkOYLVPtPgIt0MxizjfFJov3JbHyAi,5,2,1,0,1,0,2,0,6,0.8571428571428571,1,0.0,0,1,0,1,2,0,0,2,0,2,4,1
3522,70635,DIYlLDsIX3rRB00v33V6F050gdzNiYGy,fbPkOYLVPtPgIt0MxizjfFJov3JbHyAi,10,13,9,5,5,0,3,0,35,5.0,2,0.0,1,9,4,5,12,0,1,3,0,19,16,1
3523,70636,cWnlO9T3wiOdZzNrm52Q8On5YEPOag8t,fbPkOYLVPtPgIt0MxizjfFJov3JbHyAi,14,21,2,0,2,0,11,0,36,5.142857142857143,3,0.0,1,2,0,2,20,0,0,11,0,5,31,1
3524,70637,1fleh7lPd7aghMITlPRITTq0TKiljgoj,fbPkOYLVPtPgIt0MxizjfFJov3JbHyAi,7,3,2,0,2,0,3,0,10,1.4285714285714286,2,0.0,0,2,0,2,3,0,0,3,0,4,6,1
3525,70638,xM8lVcqU5uqtxPXKRkobTl3b50GvL7Y6,fbPkOYLVPtPgIt0MxizjfFJov3JbHyAi,5,2,1,0,1,0,2,0,6,0.8571428571428571,1,0.0,0,1,0,1,2,0,0,2,0,2,4,1
3526,70641,2uadn8x6eG3s1sEJofJgCr35bh3OHGLh,fbPkOYLVPtPgIt0MxizjfFJov3JbHyAi,27,38,19,11,16,18,9,1,112,16.0,3,0.0,16,19,11,16,22,18,0,9,1,62,50,1
3527,70642,FaGf4ZENvncNMeGerxuOLnibVyMwnEb7,fbPkOYLVPtPgIt0MxizjfFJov3JbHyAi,4,2,1,0,1,0,1,0,5,0.7142857142857143,1,0.0,0,1,0,1,2,0,0,1,0,2,3,1
3528,70644,6kW13L6OI2CXAgkzbQCGiGCWDPgPVNqL,fbPkOYLVPtPgIt0MxizjfFJov3JbHyAi,8,3,2,0,2,0,5,1,13,1.8571428571428572,1,0.0,0,2,0,2,3,0,0,5,1,4,9,1
3529,70646,tuBfe6WhJei1RdPAXwFNRJbSnuTMeD4l,fbPkOYLVPtPgIt0MxizjfFJov3JbHyAi,1,0,0,0,0,0,1,0,1,0.14285714285714285,1,0.0,0,0,0,0,0,0,0,1,0,0,1,1
3530,70647,5Hvfr1gz4w1l7NMxdNIG23Iybswr6a4X,fbPkOYLVPtPgIt0MxizjfFJov3JbHyAi,5,2,1,0,1,0,2,0,6,0.8571428571428571,1,0.0,0,1,0,1,2,0,0,2,0,2,4,1
3531,70648,fdJXQSSucuzaRljy096jXgInnW2TakHQ,fbPkOYLVPtPgIt0MxizjfFJov3JbHyAi,1,0,0,0,0,0,1,0,1,0.14285714285714285,1,0.0,0,0,0,0,0,0,0,1,0,0,1,1
3532,70649,TqM5lkEeW6odNqcCIpnB8ZfnKymScjxh,fbPkOYLVPtPgIt0MxizjfFJov3JbHyAi,9,10,7,0,6,0,8,0,31,4.428571428571429,1,0.0,0,7,0,6,10,0,0,8,0,13,18,1
3533,70651,zPbUIdTRPjnN9GVjy7Vs8SVwjdhRAaUM,fbPkOYLVPtPgIt0MxizjfFJov3JbHyAi,6,20,11,0,3,54,7,1,96,13.714285714285714,4,0.0,0,11,0,3,20,54,0,7,1,14,82,1
3534,70652,RUk1UgFf8pHkjYocajMr35nYXvyKvRsO,fbPkOYLVPtPgIt0MxizjfFJov3JbHyAi,6,2,1,0,1,8,5,1,18,2.5714285714285716,1,0.0,0,1,0,1,2,8,0,5,1,2,16,1
3535,70653,PNYL1Lh4wAAOtLwVLWtMerOLdRvGmWgc,fbPkOYLVPtPgIt0MxizjfFJov3JbHyAi,7,1,1,0,1,1,4,1,9,1.2857142857142858,1,0.0,0,1,0,1,1,1,0,4,1,2,7,1
3536,70655,NrraMyTwgTzYDPkTyoYsd0r0OJPy1sab,fbPkOYLVPtPgIt0MxizjfFJov3JbHyAi,7,3,2,0,2,0,6,0,13,1.8571428571428572,1,0.0,0,2,0,2,3,0,0,6,0,4,9,1
3537,70656,Nc9p0NDSJdMFoXyGCYKlMLXQtm4qOOTX,fbPkOYLVPtPgIt0MxizjfFJov3JbHyAi,7,3,2,0,2,6,6,0,19,2.7142857142857144,1,0.0,0,2,0,2,3,6,0,6,0,4,15,1
3538,70657,kF87tAiaM8moNftPhO4ia9AXwDDxrUtb,fbPkOYLVPtPgIt0MxizjfFJov3JbHyAi,11,9,5,0,2,14,13,4,47,6.714285714285714,1,0.0,0,5,0,2,9,14,0,13,4,7,40,1
3539,70658,7h3tDULs3BTNaDybaRAqNsIlSNoXgEZh,fbPkOYLVPtPgIt0MxizjfFJov3JbHyAi,7,4,2,0,2,0,5,0,13,1.8571428571428572,1,0.0,0,2,0,2,4,0,0,5,0,4,9,1
3540,70659,3w3oVzXQmE457clbfwy8fl67WyFwWeZX,fbPkOYLVPtPgIt0MxizjfFJov3JbHyAi,4,3,1,0,1,0,1,0,6,0.8571428571428571,1,0.0,0,1,0,1,3,0,0,1,0,2,4,1
3541,70661,eLqag6twmL6nT6SLVrpY07QGG3bytKwe,fbPkOYLVPtPgIt0MxizjfFJov3JbHyAi,4,3,2,0,2,0,2,0,9,1.2857142857142858,1,0.0,0,2,0,2,3,0,0,2,0,4,5,1
3542,70664,8djQJACWabqqdfUYlZxiiBK5fRdO0gWZ,fbPkOYLVPtPgIt0MxizjfFJov3JbHyAi,17,16,7,10,5,0,2,0,40,5.714285714285714,2,0.0,4,7,8,5,12,0,2,2,0,24,16,1
3543,70666,ThmrVFQiXEXdtbVq9OcHgxf5egZE7CCF,fbPkOYLVPtPgIt0MxizjfFJov3JbHyAi,1,0,0,0,0,0,1,0,1,0.14285714285714285,1,0.0,0,0,0,0,0,0,0,1,0,0,1,1
3544,70669,NrAjCwSdkokFEs2cMTtwLegWozRaakkE,fbPkOYLVPtPgIt0MxizjfFJov3JbHyAi,7,3,2,0,2,0,2,0,9,1.2857142857142858,1,0.0,0,2,0,2,3,0,0,2,0,4,5,1
3545,70670,mgRmoo6F9KYYizHMOajedFcuJHtEV6by,fbPkOYLVPtPgIt0MxizjfFJov3JbHyAi,22,21,7,14,8,0,2,0,52,7.428571428571429,1,0.0,6,7,14,8,15,0,0,2,0,35,17,1
3546,70672,XRCyFAenNfq06SRijoW2bL3eLeq7TTnH,fbPkOYLVPtPgIt0MxizjfFJov3JbHyAi,1,0,0,0,0,0,1,0,1,0.14285714285714285,1,0.0,0,0,0,0,0,0,0,1,0,0,1,1
3547,70674,tsQNS0TFi4T2OwDWxOZsXYloXeaBeZAv,fbPkOYLVPtPgIt0MxizjfFJov3JbHyAi,12,10,6,7,4,0,1,0,28,4.0,1,0.0,2,6,7,4,8,0,0,1,0,19,9,1
3548,70675,qgTFbAMyZczl8sJiC9JGSI0pTfFVEsq0,fbPkOYLVPtPgIt0MxizjfFJov3JbHyAi,2,0,0,0,0,0,3,0,3,0.42857142857142855,1,0.0,0,0,0,0,0,0,0,3,0,0,3,1
3549,70676,Pv9LrfjnRw1WO1VwPNHCu7aKxUz6zC8i,fbPkOYLVPtPgIt0MxizjfFJov3JbHyAi,4,2,1,0,1,0,2,0,6,0.8571428571428571,1,0.0,0,1,0,1,2,0,0,2,0,2,4,1
3550,70677,zmlL73g2U1Ek37ZDQ2H6P7dwK1MBsxuX,fbPkOYLVPtPgIt0MxizjfFJov3JbHyAi,8,6,4,0,3,11,5,0,29,4.142857142857143,1,0.0,0,4,0,3,6,11,0,5,0,7,22,1
3551,70678,o8iN3RNsKXCFYghfUgBvPvRXa514UVMy,fbPkOYLVPtPgIt0MxizjfFJov3JbHyAi,1,0,0,0,0,0,1,0,1,0.14285714285714285,1,0.0,0,0,0,0,0,0,0,1,0,0,1,1
3552,70682,KAxSek3GgKlkDfM652adYCX6zjbSz36L,fbPkOYLVPtPgIt0MxizjfFJov3JbHyAi,7,5,4,0,2,0,2,0,13,1.8571428571428572,1,0.0,0,4,0,2,5,0,0,2,0,6,7,1
3553,70820,ELhlMyuHt1scQfOhkxfCzXRENMteryFF,fbPkOYLVPtPgIt0MxizjfFJov3JbHyAi,1,0,0,0,0,0,1,0,1,0.14285714285714285,1,0.0,0,0,0,0,0,0,0,1,0,0,1,1
3554,70870,NaTkGN0OVzlcYhXnPctl6N7eYxY7z7gT,fbPkOYLVPtPgIt0MxizjfFJov3JbHyAi,5,2,1,0,1,0,4,0,8,1.1428571428571428,1,0.0,0,1,0,1,2,0,0,4,0,2,6,1
3555,70969,Ooaq1toVrKJC9KROMnT52Id1rqx2sDam,A3fsA9Zfv1X2fVEQhTw51lKENdNrEqT3,13,8,7,0,5,1,7,1,29,4.142857142857143,1,0.0,0,7,0,5,8,1,0,7,1,12,17,0
3556,71001,Qty87BeKrf3ZgzVA2PT9rBe28vADAPbJ,A3fsA9Zfv1X2fVEQhTw51lKENdNrEqT3,9,7,5,0,4,0,2,0,18,2.5714285714285716,2,0.0,0,5,0,4,7,0,0,2,0,9,9,0
3557,71078,dfEK3xvueeR9teWVma5VAaO4dthOOslM,bWdj2GDclj5ofokWjzoa5jAwMkxCykd6,9,4,4,0,4,0,11,2,25,3.5714285714285716,1,0.0,0,4,0,4,4,0,0,11,2,8,17,1
3558,71174,axaScF3P7Dmq9RVjqcR7oOXvuGJjIWKx,SpATywNh6bZuzm8s1ceuBUnMUAeoAHHw,17,34,18,24,9,9,16,2,112,16.0,4,0.0,5,18,19,9,29,9,5,16,2,51,61,0
3559,71212,VaOhD86uWnK2TjloSi50DgiXbw9C3K0T,A3fsA9Zfv1X2fVEQhTw51lKENdNrEqT3,7,9,1,0,1,0,4,0,15,2.142857142857143,1,0.0,0,1,0,1,9,0,0,4,0,2,13,1
3560,71222,mRThjjGON0zU0Y2plEdpqVN16fEiXwSr,bWdj2GDclj5ofokWjzoa5jAwMkxCykd6,9,9,5,0,3,0,7,0,24,3.4285714285714284,1,0.0,0,5,0,3,9,0,0,7,0,8,16,1
3561,71272,CeGIsWlT0KBVS1hQGCUY2KCY4J9xzr3t,SpATywNh6bZuzm8s1ceuBUnMUAeoAHHw,12,7,0,20,0,54,9,0,90,12.857142857142858,2,0.0,2,0,16,0,5,54,4,9,0,18,72,1
3562,71362,f6IvpzZQ4NKKZIUTkgWEi3BVq577qLnM,SpATywNh6bZuzm8s1ceuBUnMUAeoAHHw,16,16,5,19,3,8,7,0,58,8.285714285714286,1,0.0,8,5,17,3,8,8,2,7,0,33,25,0
3563,71393,bzlTCtIUcO5BfACSIQwT3PRYSdK0QGTr,SpATywNh6bZuzm8s1ceuBUnMUAeoAHHw,14,10,4,10,3,0,4,0,31,4.428571428571429,1,0.0,5,4,8,3,5,0,2,4,0,20,11,1
3564,71478,au4q0hHoeIchXXu4o0X9kRH2tLR2LkOi,SpATywNh6bZuzm8s1ceuBUnMUAeoAHHw,6,2,1,0,1,0,3,0,7,1.0,1,0.0,0,1,0,1,2,0,0,3,0,2,5,1
3565,71534,6kmRTTlm2tGjO1GkeO8yvcp6lmCvKO0m,A3fsA9Zfv1X2fVEQhTw51lKENdNrEqT3,5,2,1,0,1,0,3,0,7,1.0,2,0.0,0,1,0,1,2,0,0,3,0,2,5,1
3566,71700,qGPfY7GDQqrO1DPuPdsJnIrEGeJp1MpX,SpATywNh6bZuzm8s1ceuBUnMUAeoAHHw,13,36,3,18,2,14,9,0,82,11.714285714285714,2,0.0,8,3,15,2,28,14,3,9,0,28,54,1
3567,71712,TztthVt5KMop1hWx6wFArC8xg8H9VhnG,SpATywNh6bZuzm8s1ceuBUnMUAeoAHHw,12,7,5,4,3,5,7,0,31,4.428571428571429,3,0.0,0,5,3,3,7,5,1,7,0,11,20,1
3568,71802,YkfUrC2IjNSUcSjXepY6IHt6QpgdD85G,SpATywNh6bZuzm8s1ceuBUnMUAeoAHHw,17,25,11,7,5,10,9,0,67,9.571428571428571,2,0.0,9,11,7,5,16,10,0,9,0,32,35,1
3569,71842,ErXNe7efkRl64E8pJRc91VCcYddra1a4,SpATywNh6bZuzm8s1ceuBUnMUAeoAHHw,14,17,3,19,0,15,11,1,66,9.428571428571429,4,0.0,4,3,16,0,13,15,3,11,1,23,43,0
3570,71844,yjE4tqKQR2WC3DLToz6n1TUHIiH6cjX1,SpATywNh6bZuzm8s1ceuBUnMUAeoAHHw,4,2,0,0,0,0,2,0,4,0.5714285714285714,1,0.0,0,0,0,0,2,0,0,2,0,0,4,0
3571,71935,Cg7iNBAj8Tw36V9R4YA417eEEGy00kAz,SpATywNh6bZuzm8s1ceuBUnMUAeoAHHw,10,11,3,9,0,1,4,0,28,4.0,2,0.0,5,3,8,0,6,1,1,4,0,16,12,0
3572,71985,1LkX4t7QGG0LPbqqJvnwJmrweFNAYkvm,bWdj2GDclj5ofokWjzoa5jAwMkxCykd6,9,5,3,0,2,0,4,0,14,2.0,1,0.0,0,3,0,2,5,0,0,4,0,5,9,1
3573,72028,rGUcxYNOJhuu9K9SMgsP5W3xbSiphSwH,SpATywNh6bZuzm8s1ceuBUnMUAeoAHHw,16,22,8,14,3,12,8,1,68,9.714285714285714,3,0.0,9,8,14,3,13,12,0,8,1,34,34,1
3574,72034,4D3Mr9GTnnSeHqe4k4RduVTIffzivKXV,SpATywNh6bZuzm8s1ceuBUnMUAeoAHHw,12,12,5,14,2,1,2,0,36,5.142857142857143,1,0.0,6,5,13,2,6,1,1,2,0,26,10,1
3575,72123,a8HvMkBRr1QnoDxivZVIhrkeiZFWplka,bWdj2GDclj5ofokWjzoa5jAwMkxCykd6,16,28,16,28,10,1,10,0,93,13.285714285714286,3,0.0,5,16,21,10,23,1,7,10,0,52,41,1
3576,72200,ZRC032b6bAMTdyW8JO1vU2llk0mQNPce,SpATywNh6bZuzm8s1ceuBUnMUAeoAHHw,14,27,8,20,2,21,13,4,95,13.571428571428571,2,0.0,11,8,17,2,16,21,3,13,4,38,57,1
3577,72206,2t2mFcXnjCSGOBpya1wSPFZtPiud9I2F,SpATywNh6bZuzm8s1ceuBUnMUAeoAHHw,15,32,0,17,0,0,9,1,59,8.428571428571429,3,0.0,14,0,15,0,18,0,2,9,1,29,30,0
3578,72215,6ngga8jBuXKmnKYc00TBjXbVEmc0f4XL,SpATywNh6bZuzm8s1ceuBUnMUAeoAHHw,9,6,4,0,3,0,2,0,15,2.142857142857143,2,0.0,0,4,0,3,6,0,0,2,0,7,8,1
3579,72250,SozblGZP0jqptTVCGb8oKsTCWZZGfIvg,SpATywNh6bZuzm8s1ceuBUnMUAeoAHHw,7,3,2,0,2,0,2,0,9,1.2857142857142858,1,0.0,0,2,0,2,3,0,0,2,0,4,5,0
3580,72268,hluzPB1y7zkKLSSzVkJvXfWNLyDAuRho,RXDvfPUBYFlVdlueBFbLW0mhhAyGEqpt,13,14,9,0,5,0,5,4,37,5.285714285714286,2,0.0,0,9,0,5,14,0,0,5,4,14,23,1
3581,72327,vpU9FFM3siBSv5Tq74CkiYBZ5nbD9oub,SpATywNh6bZuzm8s1ceuBUnMUAeoAHHw,13,15,1,16,0,1,4,1,38,5.428571428571429,1,0.0,7,1,14,0,8,1,2,4,1,22,16,1
3582,72370,WI9rk8aS11tBAJzjcX0JSIgomYYRQVjW,SpATywNh6bZuzm8s1ceuBUnMUAeoAHHw,13,17,1,16,1,5,13,0,53,7.571428571428571,3,0.0,2,1,15,1,15,5,1,13,0,19,34,0
3583,72371,iahhmqoMx53j5nO5miK92n3wdWI8ut4z,RXDvfPUBYFlVdlueBFbLW0mhhAyGEqpt,5,2,1,0,1,0,4,0,8,1.1428571428571428,2,0.0,0,1,0,1,2,0,0,4,0,2,6,1
3584,72375,jpXIq3stqWScWG27acYJbNKpdTmc6kli,bWdj2GDclj5ofokWjzoa5jAwMkxCykd6,18,46,28,124,7,13,20,0,238,34.0,5,0.0,4,28,122,7,42,13,2,20,0,161,77,0
3585,72412,NIlxh2g7VTAquieuVc9RGErPkOzbSh2Z,SpATywNh6bZuzm8s1ceuBUnMUAeoAHHw,17,32,13,19,3,0,11,0,78,11.142857142857142,2,0.0,4,13,17,3,28,0,2,11,0,37,41,1
3586,72426,B9BCqbSn4dXX7PoOMPBly9mxS1ETXKHH,SpATywNh6bZuzm8s1ceuBUnMUAeoAHHw,7,14,6,0,2,0,2,0,24,3.4285714285714284,2,0.0,5,6,0,2,9,0,0,2,0,13,11,1
3587,72429,GwQix8XlCp4q9CmSxf5jg9NO42lfroib,SpATywNh6bZuzm8s1ceuBUnMUAeoAHHw,1,0,0,0,0,0,2,0,2,0.2857142857142857,2,0.0,0,0,0,0,0,0,0,2,0,0,2,1
3588,72442,LWfPQEZcfqcdY03cxPtuNt5LIUXK1J1h,bWdj2GDclj5ofokWjzoa5jAwMkxCykd6,15,19,0,80,4,25,19,1,148,21.142857142857142,2,0.0,9,0,75,4,10,25,5,19,1,88,60,1
3589,72448,Ln23tN1YAlBNEBT8tndbR9JhZVhVTsS7,SpATywNh6bZuzm8s1ceuBUnMUAeoAHHw,12,15,7,0,4,2,12,1,41,5.857142857142857,2,0.0,4,7,0,4,11,2,0,12,1,15,26,1
3590,72451,9FaPBbsYKn0C9myyRYf9vYNhns2eJDpD,bWdj2GDclj5ofokWjzoa5jAwMkxCykd6,12,14,5,0,4,0,14,1,38,5.428571428571429,4,0.0,2,5,0,4,12,0,0,14,1,11,27,0
3591,72452,MU4dVyJTD7iIRSTZIdJZ9VoLOxogfKQN,A3fsA9Zfv1X2fVEQhTw51lKENdNrEqT3,44,18,14,86,11,5,7,0,141,20.142857142857142,2,0.0,1,14,74,11,17,5,12,7,0,100,41,0
3592,72468,clbUGnOQsN7CuaV7idGJ2LVbYN3t8qC3,bWdj2GDclj5ofokWjzoa5jAwMkxCykd6,3,3,0,0,0,0,1,0,4,0.5714285714285714,1,0.0,1,0,0,0,2,0,0,1,0,1,3,0
3593,72485,H1nbdkC904EOh8jWeVVcV5piaqMVBsli,RXDvfPUBYFlVdlueBFbLW0mhhAyGEqpt,41,36,3,84,3,0,6,2,134,19.142857142857142,2,0.0,9,3,83,3,27,0,1,6,2,98,36,0
3594,72685,2IlOpdUgsPu5FVltj0flScFk4CeI7uHm,RXDvfPUBYFlVdlueBFbLW0mhhAyGEqpt,31,27,16,26,7,7,4,0,87,12.428571428571429,3,0.0,4,16,26,7,23,7,0,4,0,53,34,0
3595,72716,0VjAWG5aLQgXyXeTqTPnha195szz41mH,RXDvfPUBYFlVdlueBFbLW0mhhAyGEqpt,50,50,18,111,19,17,9,2,226,32.285714285714285,1,0.0,28,18,104,19,22,17,7,9,2,169,57,1
3596,72850,QqE2Xjwy9gUzOvFdkDqAwAaNZLBZkxvd,G8EPVSXsOYB5YQWZGiz1aVq5Pgr2GrQu,12,7,0,0,0,18,8,1,34,4.857142857142857,3,0.0,0,0,0,0,7,18,0,8,1,0,34,1
3597,72922,ria1rZm5v1iNiSZkl2at79lKlYWZvHeF,SpATywNh6bZuzm8s1ceuBUnMUAeoAHHw,13,27,0,12,0,28,10,2,79,11.285714285714286,1,0.0,6,0,12,0,21,28,0,10,2,18,61,0
3598,72951,Ou3iHiBDr7O5XF3iHhMwgAvySH9eHz42,RXDvfPUBYFlVdlueBFbLW0mhhAyGEqpt,6,7,1,0,0,0,2,0,10,1.4285714285714286,1,0.0,0,1,0,0,7,0,0,2,0,1,9,1
3599,73009,l569pvTkqA1hwU8mlPA8zjV2SyK4a7w2,SpATywNh6bZuzm8s1ceuBUnMUAeoAHHw,4,4,0,0,0,0,1,0,5,0.7142857142857143,1,0.0,0,0,0,0,4,0,0,1,0,0,5,0
3600,73036,zcVtFTrToAbXyBSFxcFkJCnMsb7Jt1Wc,SpATywNh6bZuzm8s1ceuBUnMUAeoAHHw,4,2,0,0,0,0,2,0,4,0.5714285714285714,1,0.0,0,0,0,0,2,0,0,2,0,0,4,1
3601,73514,eAreSTsX7Dih2J54vyrFl8ByPnikZNX4,fbPkOYLVPtPgIt0MxizjfFJov3JbHyAi,27,44,14,19,14,32,14,2,139,19.857142857142858,3,0.0,20,14,16,14,24,32,3,14,2,64,75,0
3602,73551,tpXvTahACNQY51r2DDxBjRZh56EvpTZe,fbPkOYLVPtPgIt0MxizjfFJov3JbHyAi,10,6,3,0,3,3,9,1,25,3.5714285714285716,1,0.0,2,3,0,3,4,3,0,9,1,8,17,1
3603,73885,zlC9nEdRrqLSPX386Mctiz9fIdlU29GI,7GRhBDsirIGkRZBtSMEzNTyDr2JQm4xx,23,38,11,24,10,0,1,0,84,12.0,1,0.0,25,11,21,10,13,0,3,1,0,67,17,1
3604,73899,4hEMELZWHLOm7hvjgIF8HpEdrI7mKYR9,7GRhBDsirIGkRZBtSMEzNTyDr2JQm4xx,1,0,0,0,0,0,4,0,4,0.5714285714285714,1,0.0,0,0,0,0,0,0,0,4,0,0,4,1
3605,73907,u40Wnz941IKPEKg6evh8MfJNEbnPlztD,7GRhBDsirIGkRZBtSMEzNTyDr2JQm4xx,1,0,0,0,0,0,1,0,1,0.14285714285714285,1,0.0,0,0,0,0,0,0,0,1,0,0,1,1
3606,73909,SQIuOWvxkt3YnLUzk8J5rhFP8qdbWUct,7GRhBDsirIGkRZBtSMEzNTyDr2JQm4xx,9,9,1,0,1,0,6,2,19,2.7142857142857144,1,0.0,4,1,0,1,5,0,0,6,2,6,13,1
3607,73914,nBvjxfottsOCrOycyCAN2ZrAK5pyyTJB,7GRhBDsirIGkRZBtSMEzNTyDr2JQm4xx,1,0,0,0,0,0,1,0,1,0.14285714285714285,1,0.0,0,0,0,0,0,0,0,1,0,0,1,1
3608,73925,QJJ8wBq7nom8t0h6F4ecboFqFhwa246L,7GRhBDsirIGkRZBtSMEzNTyDr2JQm4xx,1,0,0,0,0,0,2,0,2,0.2857142857142857,1,0.0,0,0,0,0,0,0,0,2,0,0,2,1
3609,73926,MrlzmdVJr5WOflJfAlRUbmdI8vfVUpTE,7GRhBDsirIGkRZBtSMEzNTyDr2JQm4xx,7,4,1,2,1,0,2,0,10,1.4285714285714286,1,0.0,1,1,2,1,3,0,0,2,0,5,5,1
3610,73937,28W5CJrYp73LQgjHivjzAixkCQuqTCh6,A3fsA9Zfv1X2fVEQhTw51lKENdNrEqT3,23,36,14,0,12,1,4,0,67,9.571428571428571,2,0.0,0,14,0,12,36,1,0,4,0,26,41,0
3611,73951,7nQB7cjVdr2HijR82OoX1oMRPa42JjfY,7GRhBDsirIGkRZBtSMEzNTyDr2JQm4xx,11,4,2,4,2,0,5,0,17,2.4285714285714284,1,0.0,1,2,3,2,3,0,1,5,0,8,9,1
3612,73970,j32U9Y949ZW1nXMwG0aPWZXCmluBzel9,7GRhBDsirIGkRZBtSMEzNTyDr2JQm4xx,3,4,1,0,0,0,1,0,6,0.8571428571428571,1,0.0,0,1,0,0,4,0,0,1,0,1,5,1
3613,73972,fK0ybxlrUhmgrAr6gFQPIfSHLrJ4RdyL,7GRhBDsirIGkRZBtSMEzNTyDr2JQm4xx,27,49,16,32,12,0,10,0,119,17.0,1,0.0,27,16,29,12,22,0,3,10,0,84,35,1
3614,73976,7mxOgTUP9lSjAUBOPZ9fhNEhVSHMvF2J,A3fsA9Zfv1X2fVEQhTw51lKENdNrEqT3,1,0,0,0,0,0,3,0,3,0.42857142857142855,2,0.0,0,0,0,0,0,0,0,3,0,0,3,0
3615,74004,obFplu8p0J5bdsesTSoaj6Bc4UGbTB6M,7GRhBDsirIGkRZBtSMEzNTyDr2JQm4xx,1,0,0,0,0,0,2,0,2,0.2857142857142857,1,0.0,0,0,0,0,0,0,0,2,0,0,2,1
3616,74017,2kb07SQlxjCbOTE1DAO38U9f5IsTds9o,7GRhBDsirIGkRZBtSMEzNTyDr2JQm4xx,10,6,4,0,4,0,2,0,16,2.2857142857142856,1,0.0,0,4,0,4,6,0,0,2,0,8,8,1
3617,74024,EPmLjBxeWpwhjwoRgtmLV8RkhFOu2zzj,7GRhBDsirIGkRZBtSMEzNTyDr2JQm4xx,2,0,0,0,0,0,2,0,2,0.2857142857142857,1,0.0,0,0,0,0,0,0,0,2,0,0,2,1
3618,74026,zQ1YX4nsnROAkBYQ0FJFP0QSnhVmUslT,7GRhBDsirIGkRZBtSMEzNTyDr2JQm4xx,1,0,0,0,0,0,1,0,1,0.14285714285714285,1,0.0,0,0,0,0,0,0,0,1,0,0,1,1
3619,74042,vQAS0obh0bWlfi2VaK7gKWVKUzPkWalY,7GRhBDsirIGkRZBtSMEzNTyDr2JQm4xx,7,2,1,0,1,0,4,0,8,1.1428571428571428,1,0.0,0,1,0,1,2,0,0,4,0,2,6,1
3620,74052,2TaYh8ycp9sh1x4LkBWnthNJDMCHE85T,7GRhBDsirIGkRZBtSMEzNTyDr2JQm4xx,29,59,20,46,16,1,8,0,150,21.428571428571427,2,0.0,31,20,37,16,28,1,9,8,0,104,46,1
3621,74059,TRGa3GfGhognO7jXiVPcSrWpnBuIeInO,7GRhBDsirIGkRZBtSMEzNTyDr2JQm4xx,7,7,5,0,0,0,3,0,15,2.142857142857143,1,0.0,0,5,0,0,7,0,0,3,0,5,10,1
3622,74075,DfnO2Gp0WpLIOOGCReKHPkH7dv25s88Q,7GRhBDsirIGkRZBtSMEzNTyDr2JQm4xx,1,0,0,0,0,0,1,0,1,0.14285714285714285,1,0.0,0,0,0,0,0,0,0,1,0,0,1,1
3623,74078,yqOOYx1jXUdpDzqGMMXJAQVE6fglCaFI,7GRhBDsirIGkRZBtSMEzNTyDr2JQm4xx,2,0,0,0,0,0,3,0,3,0.42857142857142855,1,0.0,0,0,0,0,0,0,0,3,0,0,3,1
3624,74086,a4naBAZCHNqdVKKeEiKQVvfTN6r4f6eG,bWdj2GDclj5ofokWjzoa5jAwMkxCykd6,9,12,6,42,4,4,6,1,75,10.714285714285714,1,0.0,3,6,41,4,9,4,1,6,1,54,21,1
3625,74095,f66qV2E6gvO4HMZXdbtN6yW4m9klwB2A,7GRhBDsirIGkRZBtSMEzNTyDr2JQm4xx,2,0,0,0,0,0,2,0,2,0.2857142857142857,1,0.0,0,0,0,0,0,0,0,2,0,0,2,1
3626,74115,NFrovzSNFaGOKX4ckxlOk5TIATwQWZDv,SpATywNh6bZuzm8s1ceuBUnMUAeoAHHw,17,20,13,24,5,11,10,1,84,12.0,1,0.0,3,13,18,5,17,11,6,10,1,39,45,0
3627,74117,ehQYO42YZfN9JqdFqKxgBFmu1fmVCsCo,7GRhBDsirIGkRZBtSMEzNTyDr2JQm4xx,8,1,1,0,1,3,9,0,15,2.142857142857143,1,0.0,0,1,0,1,1,3,0,9,0,2,13,1
3628,74121,Ym1ZTRs6QB0e3lMSh4qwLaB0p6ohf0Ak,RXDvfPUBYFlVdlueBFbLW0mhhAyGEqpt,9,9,6,0,4,0,2,0,21,3.0,1,0.0,2,6,0,4,7,0,0,2,0,12,9,0
3629,74122,MkhWkWrDBg7jFp3XklVC8uZQ46nAon3u,7GRhBDsirIGkRZBtSMEzNTyDr2JQm4xx,14,37,13,8,2,0,6,0,66,9.428571428571429,3,0.0,5,13,6,2,32,0,2,6,0,26,40,1
3630,74123,AisGNT34d6x1DicMgidteYUWukPQUQ7X,7GRhBDsirIGkRZBtSMEzNTyDr2JQm4xx,1,0,0,0,0,0,2,0,2,0.2857142857142857,2,0.0,0,0,0,0,0,0,0,2,0,0,2,1
3631,74136,ogJhjZ6JRse1i9Rm200W41y6knKdib4X,7GRhBDsirIGkRZBtSMEzNTyDr2JQm4xx,7,3,2,0,2,0,2,0,9,1.2857142857142858,1,0.0,0,2,0,2,3,0,0,2,0,4,5,1
3632,74160,fkpoiY9BcwTpPdjkd5ID0mAyCrJQOIvN,7GRhBDsirIGkRZBtSMEzNTyDr2JQm4xx,7,3,2,0,2,0,2,0,9,1.2857142857142858,1,0.0,0,2,0,2,3,0,0,2,0,4,5,1
3633,74224,s8rbNwiDb6Ued6nUvpbwuDl2s256fOiD,SpATywNh6bZuzm8s1ceuBUnMUAeoAHHw,10,7,0,12,0,0,3,0,22,3.142857142857143,1,0.0,2,0,9,0,5,0,3,3,0,11,11,1
3634,74245,2ZDZeGxlSkOYdQNOELblzmlZJh9Z3y1x,SpATywNh6bZuzm8s1ceuBUnMUAeoAHHw,13,17,14,6,8,0,3,0,48,6.857142857142857,2,0.0,0,14,5,8,17,0,1,3,0,27,21,0
3635,74262,USFNJQ0DS4O3ARJSYADvtg2Aw3GLb3J9,SpATywNh6bZuzm8s1ceuBUnMUAeoAHHw,10,8,2,7,2,0,2,0,21,3.0,2,0.0,0,2,6,2,8,0,1,2,0,10,11,1
3636,74268,NFrovzSNFaGOKX4ckxlOk5TIATwQWZDv,RXDvfPUBYFlVdlueBFbLW0mhhAyGEqpt,8,7,6,0,2,2,5,1,23,3.2857142857142856,1,0.0,0,6,0,2,7,2,0,5,1,8,15,1
3637,74275,Qr56xJpKpx3PDtASRPf6XQoHmcGp3CKT,7GRhBDsirIGkRZBtSMEzNTyDr2JQm4xx,1,0,0,0,0,0,3,0,3,0.42857142857142855,2,0.0,0,0,0,0,0,0,0,3,0,0,3,1
3638,74292,a4RYqILKcnu8c617gYSbD0KQIm9DqZnc,7GRhBDsirIGkRZBtSMEzNTyDr2JQm4xx,7,4,2,2,2,0,1,0,11,1.5714285714285714,1,0.0,1,2,2,2,3,0,0,1,0,7,4,1
3639,74293,1484VvY7Fi4yz6Sx6JQlO6okKw4a6Bw6,7GRhBDsirIGkRZBtSMEzNTyDr2JQm4xx,3,3,0,0,0,0,1,0,4,0.5714285714285714,1,0.0,0,0,0,0,3,0,0,1,0,0,4,1
3640,74302,Na52PtAqm4VlTMUv1OPLGNjij0a5votC,7GRhBDsirIGkRZBtSMEzNTyDr2JQm4xx,6,7,3,4,1,0,1,0,16,2.2857142857142856,1,0.0,1,3,3,1,6,0,1,1,0,8,8,1
3641,74323,fCmdFT6vVaKttJ0wsJVd3YILMXjqgUpl,7GRhBDsirIGkRZBtSMEzNTyDr2JQm4xx,8,8,4,0,3,0,4,0,19,2.7142857142857144,1,0.0,2,4,0,3,6,0,0,4,0,9,10,1
3642,74333,Dc9OIUGhQBh3pdZe3Ppn36a1Oo81Nm8J,RXDvfPUBYFlVdlueBFbLW0mhhAyGEqpt,5,3,0,0,0,0,2,0,5,0.7142857142857143,1,0.0,0,0,0,0,3,0,0,2,0,0,5,1
3643,74342,GCXdwkqD60eGG5W317sN3ZNf27MOQY4U,7GRhBDsirIGkRZBtSMEzNTyDr2JQm4xx,1,0,0,0,0,0,1,0,1,0.14285714285714285,1,0.0,0,0,0,0,0,0,0,1,0,0,1,1
3644,74361,TvtViclCsd2PmV5PrW2DKEwPmoLOSaRh,7GRhBDsirIGkRZBtSMEzNTyDr2JQm4xx,16,23,1,11,2,0,3,0,40,5.714285714285714,2,0.0,6,1,10,2,17,0,1,3,0,19,21,1
3645,74375,pOkvcIFcOLnKHqzWe7X68PwdTZWgfXNn,7GRhBDsirIGkRZBtSMEzNTyDr2JQm4xx,26,46,15,20,8,1,3,0,93,13.285714285714286,1,0.0,15,15,20,8,31,1,0,3,0,58,35,1
3646,74376,uhOpSMle6LWQUtiKJ61AGF4uUuGwyCQB,7GRhBDsirIGkRZBtSMEzNTyDr2JQm4xx,7,6,1,0,1,0,3,0,11,1.5714285714285714,2,0.0,0,1,0,1,6,0,0,3,0,2,9,1
3647,74385,PiugBYfME8MQpTzoS0G5QvEJsAm89oP5,7GRhBDsirIGkRZBtSMEzNTyDr2JQm4xx,9,5,1,4,2,3,9,1,25,3.5714285714285716,1,0.0,3,1,3,2,2,3,1,9,1,9,16,1
3648,74412,vX9PpvehRTgTkIr6tSKODV93gbmBGfye,7GRhBDsirIGkRZBtSMEzNTyDr2JQm4xx,1,0,0,0,0,0,3,0,3,0.42857142857142855,2,0.0,0,0,0,0,0,0,0,3,0,0,3,1
3649,74417,pZeZwcDZvDaUYfNrM0JBq16CcPqoVjAy,7GRhBDsirIGkRZBtSMEzNTyDr2JQm4xx,2,0,0,0,0,0,2,0,2,0.2857142857142857,1,0.0,0,0,0,0,0,0,0,2,0,0,2,1
3650,74432,iB2CzgEKP1k7rQZEzYQoAPIRp7dEItA4,7GRhBDsirIGkRZBtSMEzNTyDr2JQm4xx,14,16,8,12,8,0,2,0,46,6.571428571428571,1,0.0,6,8,11,8,10,0,1,2,0,33,13,1
3651,74441,grxgFxuiaSTlMIk1kWcHwbLAYZVnIvkA,7GRhBDsirIGkRZBtSMEzNTyDr2JQm4xx,10,9,3,0,3,0,3,0,18,2.5714285714285716,1,0.0,0,3,0,3,9,0,0,3,0,6,12,1
3652,74455,PRNejdeVNKfxLUk8kGMRZmgBIyh1R45g,7GRhBDsirIGkRZBtSMEzNTyDr2JQm4xx,5,2,1,0,1,0,2,0,6,0.8571428571428571,1,0.0,0,1,0,1,2,0,0,2,0,2,4,1
3653,74456,2ZaLqb29uQ5ksFfqfhamJxjvg9jGJ9Ay,7GRhBDsirIGkRZBtSMEzNTyDr2JQm4xx,5,3,0,0,0,0,3,0,6,0.8571428571428571,1,0.0,0,0,0,0,3,0,0,3,0,0,6,1
3654,74461,z2UutrDxctGBl3XhV09hNxXdsZmqDZvY,A3fsA9Zfv1X2fVEQhTw51lKENdNrEqT3,8,4,2,0,2,23,9,0,40,5.714285714285714,2,0.0,1,2,0,2,3,23,0,9,0,5,35,1
3655,74462,dT92IjRcuruPiAlpqVUTtu3wNL9IIegT,7GRhBDsirIGkRZBtSMEzNTyDr2JQm4xx,4,0,0,0,0,0,3,1,4,0.5714285714285714,1,0.0,0,0,0,0,0,0,0,3,1,0,4,1
3656,74483,SP7hg1EWo2mZkHuxZFtI4Vbcyr5vcP4h,SpATywNh6bZuzm8s1ceuBUnMUAeoAHHw,10,10,3,14,1,0,3,0,31,4.428571428571429,2,0.0,4,3,13,1,6,0,1,3,0,21,10,0
3657,74500,spNi8Q5WiDgxakh0uckmQbexani6DCOh,7GRhBDsirIGkRZBtSMEzNTyDr2JQm4xx,20,23,7,12,6,0,2,0,50,7.142857142857143,2,0.0,8,7,12,6,15,0,0,2,0,33,17,1
3658,74506,M3qc1xm79CLjiw98zxp89bImiVSCJcDh,7GRhBDsirIGkRZBtSMEzNTyDr2JQm4xx,1,0,0,0,0,0,1,0,1,0.14285714285714285,1,0.0,0,0,0,0,0,0,0,1,0,0,1,1
3659,74516,KaBv8PoJ8OVsLIkZYrjM1X6uYKyRrniG,7GRhBDsirIGkRZBtSMEzNTyDr2JQm4xx,8,8,2,0,3,0,3,0,16,2.2857142857142856,1,0.0,5,2,0,3,3,0,0,3,0,10,6,1
3660,74522,ZYGzPhdrKsCQft8z3gUrz2GR31kmqGY8,SpATywNh6bZuzm8s1ceuBUnMUAeoAHHw,16,23,10,16,3,31,6,1,90,12.857142857142858,2,0.0,10,10,13,3,13,31,3,6,1,36,54,0
3661,74526,qwopEmmu52GEF4KxBC26RpTkcwtY07S9,SpATywNh6bZuzm8s1ceuBUnMUAeoAHHw,16,28,11,17,5,1,10,0,72,10.285714285714286,2,0.0,13,11,15,5,15,1,2,10,0,44,28,0
3662,74537,p64MOtUXpLiy07h6B0dKNFYMkAVaqQ98,7GRhBDsirIGkRZBtSMEzNTyDr2JQm4xx,2,0,0,0,0,0,4,0,4,0.5714285714285714,1,0.0,0,0,0,0,0,0,0,4,0,0,4,1
3663,74541,HbmZzALzRW0CJmaD07o1oMpvJwGgfjK4,bWdj2GDclj5ofokWjzoa5jAwMkxCykd6,3,2,0,0,0,0,1,0,3,0.42857142857142855,1,0.0,0,0,0,0,2,0,0,1,0,0,3,1
3664,74548,HF98YPKzT8oi2j9flZW9kstZcvL3ZimG,A3fsA9Zfv1X2fVEQhTw51lKENdNrEqT3,36,38,16,74,6,0,3,0,137,19.571428571428573,3,0.0,1,16,63,6,37,0,11,3,0,86,51,1
3665,74560,Q0d1WItnRJvnzlnn5VcAU6GMGN4rfbYJ,7GRhBDsirIGkRZBtSMEzNTyDr2JQm4xx,1,0,0,0,0,0,1,0,1,0.14285714285714285,1,0.0,0,0,0,0,0,0,0,1,0,0,1,1
3666,74603,A5la8pvW0tLLXP6HSr61aMxUll9fPTHI,7GRhBDsirIGkRZBtSMEzNTyDr2JQm4xx,11,5,2,4,3,0,10,0,24,3.4285714285714284,1,0.0,3,2,3,3,2,0,1,10,0,11,13,1
3667,74612,T8yZ978Owo7xSmEVFbiCM8j5K4ntSTo2,7GRhBDsirIGkRZBtSMEzNTyDr2JQm4xx,1,0,0,0,0,0,1,0,1,0.14285714285714285,1,0.0,0,0,0,0,0,0,0,1,0,0,1,1
3668,74650,usRZSdDsUQfZaciTJTskV4NLSeP1lHRl,7GRhBDsirIGkRZBtSMEzNTyDr2JQm4xx,14,22,4,14,6,13,8,1,68,9.714285714285714,1,0.0,10,4,11,6,12,13,3,8,1,31,37,1
3669,74712,ZudgpcrDV2RrJQUR1YBw9q8iUT5VbCHi,RXDvfPUBYFlVdlueBFbLW0mhhAyGEqpt,19,16,8,32,8,0,3,0,67,9.571428571428571,2,0.0,6,8,28,8,10,0,4,3,0,50,17,0
3670,74723,bLurC9srutCM4k4gLSsbzYrz2ihcIC86,7GRhBDsirIGkRZBtSMEzNTyDr2JQm4xx,6,3,1,0,1,0,4,0,9,1.2857142857142858,1,0.0,0,1,0,1,3,0,0,4,0,2,7,1
3671,74725,dg1KWi5LRRms7lQMyP0ii5Pv3KonWqiG,7GRhBDsirIGkRZBtSMEzNTyDr2JQm4xx,28,30,18,40,11,1,19,1,120,17.142857142857142,3,0.0,4,18,35,11,26,1,5,19,1,68,52,1
3672,74737,xMjaHywxqKHoEbgcAEYnpZkLLGRuzCTC,SpATywNh6bZuzm8s1ceuBUnMUAeoAHHw,12,28,2,12,1,7,7,0,57,8.142857142857142,2,0.0,10,2,9,1,18,7,3,7,0,22,35,0
3673,74739,WnGoJ0X05nmmcr9OBuNGFmD5r4EVF1g6,A3fsA9Zfv1X2fVEQhTw51lKENdNrEqT3,9,5,3,0,2,16,6,1,33,4.714285714285714,1,0.0,0,3,0,2,5,16,0,6,1,5,28,0
3674,74778,bYD2u7vuN3G54awyDYPdRiZI3O4zw6kx,G8EPVSXsOYB5YQWZGiz1aVq5Pgr2GrQu,5,3,2,0,1,0,2,0,8,1.1428571428571428,1,0.0,0,2,0,1,3,0,0,2,0,3,5,1
3675,74815,LFkf4WR1XfFwr3RF5erdei3F4d3PlupD,7GRhBDsirIGkRZBtSMEzNTyDr2JQm4xx,2,0,0,0,0,0,2,0,2,0.2857142857142857,1,0.0,0,0,0,0,0,0,0,2,0,0,2,1
3676,74840,FvY4K2RN2da3T8MEGlPk2LmHUIxOyg0h,SpATywNh6bZuzm8s1ceuBUnMUAeoAHHw,15,19,10,14,7,18,4,0,72,10.285714285714286,2,0.0,7,10,13,7,12,18,1,4,0,37,35,0
3677,74852,0wpgF8T87E4lIPjqoh0AkxyomANfbalw,7GRhBDsirIGkRZBtSMEzNTyDr2JQm4xx,1,0,0,0,0,0,1,0,1,0.14285714285714285,1,0.0,0,0,0,0,0,0,0,1,0,0,1,1
3678,74862,iNVrCH89sJttoddUpv5O2bH5LrAKlFHk,SpATywNh6bZuzm8s1ceuBUnMUAeoAHHw,7,4,3,0,3,0,2,0,12,1.7142857142857142,1,0.0,0,3,0,3,4,0,0,2,0,6,6,1
3679,74865,WlLtmSTcQZkOIIH38SOYOKYSBYpp2ymS,7GRhBDsirIGkRZBtSMEzNTyDr2JQm4xx,1,0,0,0,0,0,1,0,1,0.14285714285714285,1,0.0,0,0,0,0,0,0,0,1,0,0,1,1
3680,74867,IePFEx0pR5xLGQlWWjU59zR6qxTHOeo0,7GRhBDsirIGkRZBtSMEzNTyDr2JQm4xx,1,0,0,0,0,0,2,0,2,0.2857142857142857,2,0.0,0,0,0,0,0,0,0,2,0,0,2,1
3681,74874,CjjbRPpHR9Bj7mz7vlCMGl56lBOfuzeG,7GRhBDsirIGkRZBtSMEzNTyDr2JQm4xx,1,0,0,0,0,0,1,0,1,0.14285714285714285,1,0.0,0,0,0,0,0,0,0,1,0,0,1,1
3682,74887,YnXdaRteqU5oS01NC3H96Vynlp7riJjN,7GRhBDsirIGkRZBtSMEzNTyDr2JQm4xx,5,2,1,0,1,0,2,0,6,0.8571428571428571,1,0.0,0,1,0,1,2,0,0,2,0,2,4,1
3683,74888,hB4yTUnQMne1LtjUUKgpcnhj6jq7S5Co,7GRhBDsirIGkRZBtSMEzNTyDr2JQm4xx,33,42,13,54,12,1,8,0,130,18.571428571428573,2,0.0,19,13,49,12,23,1,5,8,0,93,37,0
3684,74890,ZqjoiK6u3Oz9EZH4lOkXjinyTZauCj8B,7GRhBDsirIGkRZBtSMEzNTyDr2JQm4xx,4,3,1,0,0,0,2,0,6,0.8571428571428571,1,0.0,0,1,0,0,3,0,0,2,0,1,5,1
3685,74903,Y0dbTriNAgSzbrnkzFHfTSZPt5kDzGfo,7GRhBDsirIGkRZBtSMEzNTyDr2JQm4xx,27,62,2,52,4,11,9,0,140,20.0,3,0.0,28,2,47,4,34,11,5,9,0,81,59,1
3686,74911,KXR3u54SykbWYMuF2sF6lcMFs68otiQO,SpATywNh6bZuzm8s1ceuBUnMUAeoAHHw,17,44,19,23,6,9,12,0,113,16.142857142857142,3,0.0,17,19,20,6,27,9,3,12,0,62,51,0
3687,74913,uFxbwM61ZWFC5xnxVOlmiGXCTyHmK3HX,bWdj2GDclj5ofokWjzoa5jAwMkxCykd6,8,5,3,0,2,9,6,1,26,3.7142857142857144,1,0.0,0,3,0,2,5,9,0,6,1,5,21,1
3688,74917,iFkbfunFypPiiZAClHyDLR02ievAgqRo,7GRhBDsirIGkRZBtSMEzNTyDr2JQm4xx,8,5,3,2,3,0,2,0,15,2.142857142857143,1,0.0,1,3,2,3,4,0,0,2,0,9,6,1
3689,74921,S6vBzHKpSh31SFGGZmwgKaOH2RvW3RpH,7GRhBDsirIGkRZBtSMEzNTyDr2JQm4xx,10,10,6,3,6,2,10,0,37,5.285714285714286,1,0.0,3,6,3,6,7,2,0,10,0,18,19,1
3690,74932,zaNavQl8vjpykftGiklyCQVgYYsAGELI,7GRhBDsirIGkRZBtSMEzNTyDr2JQm4xx,9,4,3,0,3,0,2,0,12,1.7142857142857142,1,0.0,0,3,0,3,4,0,0,2,0,6,6,1
3691,74934,knxAJpSFDgjN8jBmnCV7BB7s4fbgoTt1,SpATywNh6bZuzm8s1ceuBUnMUAeoAHHw,9,6,2,0,1,13,7,1,30,4.285714285714286,1,0.0,0,2,0,1,6,13,0,7,1,3,27,0
3692,74963,jt6cAnJpqYCiS3Lj5wNBvifs8WZJznlF,7GRhBDsirIGkRZBtSMEzNTyDr2JQm4xx,5,2,1,0,1,0,2,0,6,0.8571428571428571,1,0.0,0,1,0,1,2,0,0,2,0,2,4,1
3693,74990,RbewLSSgBXbMSLEvzESHw0b6pdUZ0dT1,7GRhBDsirIGkRZBtSMEzNTyDr2JQm4xx,4,2,1,0,1,0,1,0,5,0.7142857142857143,1,0.0,0,1,0,1,2,0,0,1,0,2,3,1
3694,75008,s2svupUO1VMo8YfeGdH5qCtTY141gV4e,7GRhBDsirIGkRZBtSMEzNTyDr2JQm4xx,16,41,1,4,5,1,13,0,65,9.285714285714286,2,0.0,18,1,3,5,23,1,1,13,0,27,38,1
3695,75076,Oa5Z9qxxvzPY6Y4pD2DPDPqyzdKPou5A,7GRhBDsirIGkRZBtSMEzNTyDr2JQm4xx,5,7,2,0,1,0,1,0,11,1.5714285714285714,1,0.0,3,2,0,1,4,0,0,1,0,6,5,1
3696,75083,WFdKiZBTbeCiiw3YIeAU1XWn0P3M4cOn,7GRhBDsirIGkRZBtSMEzNTyDr2JQm4xx,1,0,0,0,0,0,1,0,1,0.14285714285714285,1,0.0,0,0,0,0,0,0,0,1,0,0,1,1
3697,75093,Wcbtj2ddFRjLWK9tTZ7uzCDmpegrAZ78,A3fsA9Zfv1X2fVEQhTw51lKENdNrEqT3,41,19,12,66,7,2,11,1,118,16.857142857142858,2,0.0,3,12,60,7,16,2,6,11,1,82,36,0
3698,75102,7PsSHlEYnB89Jan9VqppndjNHL90G8j5,7GRhBDsirIGkRZBtSMEzNTyDr2JQm4xx,1,0,0,0,0,0,1,0,1,0.14285714285714285,1,0.0,0,0,0,0,0,0,0,1,0,0,1,1
3699,75108,35ygmhgWZR3Rp3zgk5PM9pjJe8hJeFw2,G8EPVSXsOYB5YQWZGiz1aVq5Pgr2GrQu,20,18,12,20,9,6,6,1,72,10.285714285714286,1,0.0,4,12,19,9,14,6,1,6,1,44,28,0
3700,75120,H2nT05aeA6Q1zZKHa66kquyct5PT5SXn,SpATywNh6bZuzm8s1ceuBUnMUAeoAHHw,11,16,0,6,0,19,3,0,44,6.285714285714286,2,0.0,6,0,6,0,10,19,0,3,0,12,32,0
3701,75208,EsXr4Om7Vwi1sKSVuaosexmk6LU6FCZi,SpATywNh6bZuzm8s1ceuBUnMUAeoAHHw,12,13,8,0,6,2,8,0,37,5.285714285714286,1,0.0,0,8,0,6,13,2,0,8,0,14,23,0
3702,75218,loLM1q927UBCE6cjZ1Vielkh2VBpufUl,7GRhBDsirIGkRZBtSMEzNTyDr2JQm4xx,2,0,0,0,0,0,2,0,2,0.2857142857142857,1,0.0,0,0,0,0,0,0,0,2,0,0,2,1
3703,75237,RFr9TyIVEW42bBHoptkHxr0bo57RDi2m,7GRhBDsirIGkRZBtSMEzNTyDr2JQm4xx,34,68,19,55,18,30,14,2,206,29.428571428571427,1,0.0,49,19,48,18,19,30,7,14,2,134,72,1
3704,75244,pkcnSnJ3oMXJ1Rn021rYtsOpPmKbDGk6,7GRhBDsirIGkRZBtSMEzNTyDr2JQm4xx,17,34,13,3,7,0,7,0,64,9.142857142857142,1,0.0,12,13,3,7,22,0,0,7,0,35,29,1
3705,75288,ZuPH4O6ElHiBwlm11NvwWK4IBueWaJol,7GRhBDsirIGkRZBtSMEzNTyDr2JQm4xx,1,0,0,0,0,0,1,0,1,0.14285714285714285,1,0.0,0,0,0,0,0,0,0,1,0,0,1,1
3706,75314,2IlOpdUgsPu5FVltj0flScFk4CeI7uHm,A3fsA9Zfv1X2fVEQhTw51lKENdNrEqT3,44,16,12,38,9,6,7,1,89,12.714285714285714,2,0.0,1,12,38,9,15,6,0,7,1,60,29,1
3707,75323,1aZU0pZlvemw2X4WLr3aSR93nNOLRr5M,7GRhBDsirIGkRZBtSMEzNTyDr2JQm4xx,13,12,4,16,5,1,2,0,40,5.714285714285714,1,0.0,6,4,13,5,6,1,3,2,0,28,12,1
3708,75329,gmhCT21egJ120TaG89Xay0aaFTdFxysB,7GRhBDsirIGkRZBtSMEzNTyDr2JQm4xx,2,0,0,0,0,0,2,0,2,0.2857142857142857,1,0.0,0,0,0,0,0,0,0,2,0,0,2,1
3709,75347,iJftBP3zncmjUCwGWSZ77IUrDb3Dt8rz,7GRhBDsirIGkRZBtSMEzNTyDr2JQm4xx,9,10,5,4,3,0,3,0,25,3.5714285714285716,1,0.0,2,5,3,3,8,0,1,3,0,13,12,1
3710,75379,MYsCU1zkMrWxPhV1b7wSL5LZIo1zGyhU,A3fsA9Zfv1X2fVEQhTw51lKENdNrEqT3,23,20,16,2,11,0,4,0,53,7.571428571428571,2,0.0,0,16,2,11,20,0,0,4,0,29,24,0
3711,75425,Th6GGIKucyCokdQsUn3aOeloTzqx0Qbo,G8EPVSXsOYB5YQWZGiz1aVq5Pgr2GrQu,48,47,2,140,1,22,9,0,221,31.571428571428573,2,0.0,12,2,114,1,35,22,26,9,0,129,92,1
3712,75476,RJ8UDBA8MoIbU3vEiMeGJTOTXtH9PTgu,7GRhBDsirIGkRZBtSMEzNTyDr2JQm4xx,21,44,17,32,20,2,3,0,118,16.857142857142858,1,0.0,25,17,31,20,19,2,1,3,0,93,25,1
3713,75480,RsZjSLVxYbmsMcCyiGpXZKIPYOa4dUlN,7GRhBDsirIGkRZBtSMEzNTyDr2JQm4xx,1,0,0,0,0,0,2,0,2,0.2857142857142857,1,0.0,0,0,0,0,0,0,0,2,0,0,2,1
3714,75493,Y7Pi7uKjChwCBFftO7ZsD2oE8A4VzjzU,7GRhBDsirIGkRZBtSMEzNTyDr2JQm4xx,5,2,1,0,1,0,2,0,6,0.8571428571428571,1,0.0,0,1,0,1,2,0,0,2,0,2,4,1
3715,75511,MYsCU1zkMrWxPhV1b7wSL5LZIo1zGyhU,RXDvfPUBYFlVdlueBFbLW0mhhAyGEqpt,23,18,16,0,10,0,2,0,46,6.571428571428571,2,0.0,0,16,0,10,18,0,0,2,0,26,20,0
3716,75537,MYsCU1zkMrWxPhV1b7wSL5LZIo1zGyhU,7GRhBDsirIGkRZBtSMEzNTyDr2JQm4xx,11,6,5,0,3,0,2,0,16,2.2857142857142856,1,0.0,0,5,0,3,6,0,0,2,0,8,8,1
3717,75593,9aM24JWMSszlno8F5rXsYdVrvPAYQQTl,7GRhBDsirIGkRZBtSMEzNTyDr2JQm4xx,2,0,0,0,0,0,2,0,2,0.2857142857142857,1,0.0,0,0,0,0,0,0,0,2,0,0,2,1
3718,75601,Xt4h1KWJBlSDSafJvdbE69LJiRLDiihq,7GRhBDsirIGkRZBtSMEzNTyDr2JQm4xx,6,3,1,0,1,0,2,0,7,1.0,1,0.0,0,1,0,1,3,0,0,2,0,2,5,0
3719,75685,7glymc4Wt1TTt6LrLi78VQNF5GV1r6UY,7GRhBDsirIGkRZBtSMEzNTyDr2JQm4xx,6,1,0,0,0,1,6,1,9,1.2857142857142858,1,0.0,0,0,0,0,1,1,0,6,1,0,9,1
3720,75687,LFB2kImAJUILQTj3BlBgq5zjMlrHesod,7GRhBDsirIGkRZBtSMEzNTyDr2JQm4xx,1,0,0,0,0,0,2,0,2,0.2857142857142857,1,0.0,0,0,0,0,0,0,0,2,0,0,2,1
3721,75711,ONaGFOFSpTcGmGss3L3s1gXRn5LKjFn3,SpATywNh6bZuzm8s1ceuBUnMUAeoAHHw,5,1,1,0,1,0,2,0,5,0.7142857142857143,1,0.0,0,1,0,1,1,0,0,2,0,2,3,1
3722,75721,hkOcH5tOuxyPKzObCfNaFgGI6cTMtgMP,SpATywNh6bZuzm8s1ceuBUnMUAeoAHHw,11,10,7,0,2,0,8,0,27,3.857142857142857,1,0.0,0,7,0,2,10,0,0,8,0,9,18,0
3723,75751,AQki29spcihutk4byKfhdfiwIESO5QjE,7GRhBDsirIGkRZBtSMEzNTyDr2JQm4xx,4,3,1,0,0,0,3,0,7,1.0,1,0.0,0,1,0,0,3,0,0,3,0,1,6,1
3724,75752,0CuRIhBavvQKL5rTT1QWf2kztAfRXZug,A3fsA9Zfv1X2fVEQhTw51lKENdNrEqT3,1,0,0,0,0,0,1,0,1,0.14285714285714285,1,0.0,0,0,0,0,0,0,0,1,0,0,1,0
3725,75790,rT1OrFQC18rdvYkTGYqwRgC7eDvihHsc,A3fsA9Zfv1X2fVEQhTw51lKENdNrEqT3,25,14,11,0,9,2,10,1,47,6.714285714285714,3,0.0,1,11,0,9,13,2,0,10,1,21,26,1
3726,75879,Slk5JcZSYHmDLQZXaNVmcMDmjJ16kBhI,SpATywNh6bZuzm8s1ceuBUnMUAeoAHHw,14,34,0,8,0,8,14,1,65,9.285714285714286,4,0.0,9,0,8,0,25,8,0,14,1,17,48,0
3727,75888,PQscC5e4adjOlDXssQTF1miDsYNrTX1i,7GRhBDsirIGkRZBtSMEzNTyDr2JQm4xx,5,2,1,0,1,1,3,0,8,1.1428571428571428,1,0.0,0,1,0,1,2,1,0,3,0,2,6,1
3728,75965,v3CIUjxPH9xWB79tSDrtVHc9ShR8m6Ki,7GRhBDsirIGkRZBtSMEzNTyDr2JQm4xx,9,15,0,2,1,36,3,0,57,8.142857142857142,1,0.0,2,0,2,1,13,36,0,3,0,5,52,1
3729,75985,XJ0fPDPj1weE8n0B17PQ5bWqC1TTj821,7GRhBDsirIGkRZBtSMEzNTyDr2JQm4xx,4,2,0,0,0,0,2,0,4,0.5714285714285714,1,0.0,0,0,0,0,2,0,0,2,0,0,4,1
3730,76027,BlBPU32FQaOv4FFjXSkiNL1PvarqZtmh,7GRhBDsirIGkRZBtSMEzNTyDr2JQm4xx,1,0,0,0,0,0,1,0,1,0.14285714285714285,1,0.0,0,0,0,0,0,0,0,1,0,0,1,1
3731,76073,sxlaG4Fls4yl9crPN8VEZQ5WoWsunptZ,7GRhBDsirIGkRZBtSMEzNTyDr2JQm4xx,3,0,0,0,0,3,2,0,5,0.7142857142857143,1,0.0,0,0,0,0,0,3,0,2,0,0,5,1
3732,76091,UcMBbV5apyBn6US03aF0lorBUPxtfuSB,bWdj2GDclj5ofokWjzoa5jAwMkxCykd6,12,9,4,14,3,13,5,1,49,7.0,1,0.0,2,4,13,3,7,13,1,5,1,22,27,0
3733,76108,zKXJGJg9DMEB2RAxuThjb4UbLJ2XM2gW,RXDvfPUBYFlVdlueBFbLW0mhhAyGEqpt,14,16,11,9,4,0,3,0,43,6.142857142857143,1,0.0,3,11,9,4,13,0,0,3,0,27,16,1
3734,76121,UcMBbV5apyBn6US03aF0lorBUPxtfuSB,SpATywNh6bZuzm8s1ceuBUnMUAeoAHHw,18,14,7,12,4,47,8,1,93,13.285714285714286,2,0.0,5,7,11,4,9,47,1,8,1,27,66,0
3735,76169,6RuWsSvS3Ngnjl37PzNAaaGn8Jd9a1lW,A3fsA9Zfv1X2fVEQhTw51lKENdNrEqT3,7,10,2,0,2,0,5,0,19,2.7142857142857144,3,0.0,0,2,0,2,10,0,0,5,0,4,15,0
3736,76235,jByBG50ghoSer5UP92qpkAfDGFpraaH7,SpATywNh6bZuzm8s1ceuBUnMUAeoAHHw,15,35,1,15,1,5,26,1,84,12.0,3,0.0,10,1,14,1,25,5,1,26,1,26,58,0
3737,76295,Slk5JcZSYHmDLQZXaNVmcMDmjJ16kBhI,bWdj2GDclj5ofokWjzoa5jAwMkxCykd6,15,33,2,14,2,1,9,1,62,8.857142857142858,4,0.0,8,2,13,2,25,1,1,9,1,25,37,0
3738,76325,R5PVQLHQfRcyGqt0KVpTkwcmfBgB3rs1,7GRhBDsirIGkRZBtSMEzNTyDr2JQm4xx,4,7,4,0,0,0,3,0,14,2.0,2,0.0,0,4,0,0,7,0,0,3,0,4,10,0
3739,76368,Kcl98h3mNpyExmJuf2coZt58rSEztGxk,7GRhBDsirIGkRZBtSMEzNTyDr2JQm4xx,30,55,24,44,20,32,8,0,183,26.142857142857142,4,0.0,25,24,43,20,30,32,1,8,0,112,71,0
3740,77034,s6iksgptFmyh2vfiarKdJkiKnp6RLi3f,7GRhBDsirIGkRZBtSMEzNTyDr2JQm4xx,15,23,12,0,3,5,20,1,64,9.142857142857142,1,0.0,4,12,0,3,19,5,0,20,1,19,45,0
3741,77179,eoSLO9oJFq2ypi74bXNS4eHCMDLAFDL3,fbPkOYLVPtPgIt0MxizjfFJov3JbHyAi,10,16,8,0,5,0,23,1,53,7.571428571428571,2,0.0,4,8,0,5,12,0,0,23,1,17,36,0
3742,77201,syI09vfTHJXWHQvllYPBF5DBbMlFFVEK,fbPkOYLVPtPgIt0MxizjfFJov3JbHyAi,4,2,0,0,0,0,5,0,7,1.0,1,0.0,0,0,0,0,2,0,0,5,0,0,7,1
3743,77304,nknXXbQsC6Q6nMDyRKc0MDJZg6KtAXBE,fbPkOYLVPtPgIt0MxizjfFJov3JbHyAi,8,9,5,0,2,3,7,0,26,3.7142857142857144,2,0.0,0,5,0,2,9,3,0,7,0,7,19,1
3744,77848,4s6cwLPbdRkDxHfFtEkiNoQ9RLKrwhVv,A3fsA9Zfv1X2fVEQhTw51lKENdNrEqT3,1,0,0,0,0,0,1,0,1,0.14285714285714285,1,0.0,0,0,0,0,0,0,0,1,0,0,1,1
3745,77859,FbNQPrTC7bI79XxVFKHE9WIoUItnOpDj,SpATywNh6bZuzm8s1ceuBUnMUAeoAHHw,13,16,8,16,5,17,1,0,63,9.0,1,0.0,6,8,14,5,10,17,2,1,0,33,30,1
3746,77865,mqEWhrPz1lKF0rYKRYPaEdxo5F8aEixX,bWdj2GDclj5ofokWjzoa5jAwMkxCykd6,7,14,0,60,0,0,5,0,79,11.285714285714286,2,0.0,9,0,59,0,5,0,1,5,0,68,11,0
3747,77895,ywdL3xkp7d2PSjbvnflAvIe7Wp6Q4SRe,bWdj2GDclj5ofokWjzoa5jAwMkxCykd6,17,22,12,76,5,0,7,0,122,17.428571428571427,2,0.0,3,12,72,5,19,0,4,7,0,92,30,0
3748,77959,oL1G89Phk4nduULmJ17br7A4xddcHdc4,bWdj2GDclj5ofokWjzoa5jAwMkxCykd6,1,0,0,0,0,0,1,0,1,0.14285714285714285,1,0.0,0,0,0,0,0,0,0,1,0,0,1,1
3749,77993,c8WJAdYLV71mOx4ZXSglpCNd0dBUR3Om,A3fsA9Zfv1X2fVEQhTw51lKENdNrEqT3,44,14,11,62,9,1,8,1,106,15.142857142857142,2,0.0,1,11,62,9,13,1,0,8,1,83,23,0
3750,78000,fFuKiCeoQQwOgD8VAud2ta198Mbq05KK,bWdj2GDclj5ofokWjzoa5jAwMkxCykd6,18,48,21,28,4,198,22,0,321,45.857142857142854,2,0.0,6,21,25,4,42,198,3,22,0,56,265,0
3751,78061,CTzsOL49UPUArAP2sAfnnQhe79FdliFF,bWdj2GDclj5ofokWjzoa5jAwMkxCykd6,4,4,1,0,2,0,1,0,8,1.1428571428571428,1,0.0,2,1,0,2,2,0,0,1,0,5,3,1
3752,78074,69m94gHdGGbBNOXpX0bnvC61pSot80tW,SpATywNh6bZuzm8s1ceuBUnMUAeoAHHw,17,28,7,23,3,40,21,3,125,17.857142857142858,4,0.0,16,7,19,3,12,40,4,21,3,45,80,1
3753,78089,hL8JceSXib9VR5R33sNp2RkuLry7d4Yu,SpATywNh6bZuzm8s1ceuBUnMUAeoAHHw,8,10,0,24,0,0,4,0,38,5.428571428571429,1,0.0,2,0,21,0,8,0,3,4,0,23,15,1
3754,78095,pd8vtyQRUNRd6UqLQhDDx4sQEKhI3nO6,SpATywNh6bZuzm8s1ceuBUnMUAeoAHHw,14,25,2,30,0,3,9,1,70,10.0,4,0.0,9,2,26,0,16,3,4,9,1,37,33,1
3755,78101,ew5XZC7WSosl0QdXH45kYD3syMSGbOj6,SpATywNh6bZuzm8s1ceuBUnMUAeoAHHw,15,13,6,12,3,12,7,1,54,7.714285714285714,2,0.0,4,6,9,3,9,12,3,7,1,22,32,1
3756,78198,WnXohtCVTjGmg2VYZ7QMusUaSQiMqg1z,SpATywNh6bZuzm8s1ceuBUnMUAeoAHHw,15,21,9,6,3,0,7,0,46,6.571428571428571,3,0.0,8,9,6,3,13,0,0,7,0,26,20,1
3757,78207,KxuHPQOdlWxQw9hyxXdRrGHh12yzsPD2,SpATywNh6bZuzm8s1ceuBUnMUAeoAHHw,14,23,1,24,0,6,12,4,70,10.0,3,0.0,6,1,19,0,17,6,5,12,4,26,44,0
3758,78230,Q9vRNhatkLDJJU3tGkLQZvY6VPiyvyvp,SpATywNh6bZuzm8s1ceuBUnMUAeoAHHw,6,10,1,0,1,0,2,0,14,2.0,1,0.0,0,1,0,1,10,0,0,2,0,2,12,1
3759,78272,wnNKMl9xF7Ymo4g0NZCDRhkVYih1owQr,SpATywNh6bZuzm8s1ceuBUnMUAeoAHHw,15,25,18,21,11,0,6,0,81,11.571428571428571,2,0.0,4,18,17,11,21,0,4,6,0,50,31,1
3760,78273,XE05vZThEHf17O6FM08AySNf2qZFgNWa,SpATywNh6bZuzm8s1ceuBUnMUAeoAHHw,9,9,3,6,1,0,2,0,21,3.0,1,0.0,5,3,6,1,4,0,0,2,0,15,6,0
3761,78404,r83Hvy5kcw0EMVIlIEQofYLVkxqypRN2,A3fsA9Zfv1X2fVEQhTw51lKENdNrEqT3,10,10,7,0,0,0,9,0,26,3.7142857142857144,2,0.0,0,7,0,0,10,0,0,9,0,7,19,1
3762,78414,VzHARyOCXw9czoqgTkAm6CGUmYU7yDEA,A3fsA9Zfv1X2fVEQhTw51lKENdNrEqT3,5,0,0,0,0,0,10,1,11,1.5714285714285714,1,0.0,0,0,0,0,0,0,0,10,1,0,11,1
3763,78450,FKaIUzhQjfUDPqxWuQzJXyqHP4qLLgRX,SpATywNh6bZuzm8s1ceuBUnMUAeoAHHw,16,31,1,24,1,6,21,3,87,12.428571428571429,3,0.0,15,1,19,1,16,6,5,21,3,36,51,0
3764,78467,J2luenZYZZPbaRbefvLso2Jyw46qiM9q,G8EPVSXsOYB5YQWZGiz1aVq5Pgr2GrQu,1,0,0,0,0,0,1,0,1,0.14285714285714285,1,0.0,0,0,0,0,0,0,0,1,0,0,1,1
3765,78511,98Rmjqd0huhIhiHJIK65vNiEBdUVwDLb,A3fsA9Zfv1X2fVEQhTw51lKENdNrEqT3,16,14,11,0,6,0,4,0,35,5.0,3,0.0,0,11,0,6,14,0,0,4,0,17,18,1
3766,78545,Ckb71Ev9RlsIUvVDfkFS0AumQJilppvB,SpATywNh6bZuzm8s1ceuBUnMUAeoAHHw,5,3,1,0,1,0,1,0,6,0.8571428571428571,1,0.0,0,1,0,1,3,0,0,1,0,2,4,1
3767,78564,X8qfNjsHrwR5R67KkU9t7FXc6jQSGsyo,A3fsA9Zfv1X2fVEQhTw51lKENdNrEqT3,38,41,3,65,2,5,21,1,138,19.714285714285715,2,0.0,0,3,56,2,41,5,9,21,1,61,77,1
3768,78584,5bg7aQCg1xT3BNwuorGcguCUDl8W5Lwl,bWdj2GDclj5ofokWjzoa5jAwMkxCykd6,5,5,1,0,0,5,3,0,14,2.0,1,0.0,1,1,0,0,4,5,0,3,0,2,12,1
3769,78627,mJ6Ucc9SqO7RDdkh3xF9KLI6sTyfYc24,SpATywNh6bZuzm8s1ceuBUnMUAeoAHHw,10,13,3,21,1,5,6,0,49,7.0,1,0.0,10,3,18,1,3,5,3,6,0,32,17,1
3770,78660,uhbUne0Zqx7l0LKNWrxxR44WistJmxKI,RXDvfPUBYFlVdlueBFbLW0mhhAyGEqpt,4,4,0,0,0,0,2,0,6,0.8571428571428571,1,0.0,0,0,0,0,4,0,0,2,0,0,6,1
3771,78686,38U4yWxOl4oZXP5u7g0lCPmmavOa19Ln,A3fsA9Zfv1X2fVEQhTw51lKENdNrEqT3,7,4,1,0,1,0,2,0,8,1.1428571428571428,1,0.0,0,1,0,1,4,0,0,2,0,2,6,1
3772,78733,hiYWxbK79jotdVc0LNw6xFpPROtaee83,SpATywNh6bZuzm8s1ceuBUnMUAeoAHHw,15,18,1,18,0,10,10,1,58,8.285714285714286,3,0.0,8,1,15,0,10,10,3,10,1,24,34,0
3773,78776,eAArxLyCThtu9N3Mv8rQculKbGSa66j9,A3fsA9Zfv1X2fVEQhTw51lKENdNrEqT3,7,4,3,0,1,0,2,0,10,1.4285714285714286,1,0.0,0,3,0,1,4,0,0,2,0,4,6,1
3774,78834,Ffohn9JNnGJQD2IavzMTS00ubnVtcb2T,bWdj2GDclj5ofokWjzoa5jAwMkxCykd6,19,43,17,40,9,1,17,1,128,18.285714285714285,4,0.0,10,17,33,9,33,1,7,17,1,69,59,0
3775,78843,FSe393m4kqHOdsL9YDo8QralMIqcUHdZ,A3fsA9Zfv1X2fVEQhTw51lKENdNrEqT3,9,2,1,0,1,4,7,1,16,2.2857142857142856,1,0.0,0,1,0,1,2,4,0,7,1,2,14,1
3776,78880,b5FAs3DRd36MUCxhLKFjsHu3HN0mJvs6,SpATywNh6bZuzm8s1ceuBUnMUAeoAHHw,10,24,19,0,0,5,7,6,61,8.714285714285714,1,0.0,1,19,0,0,23,5,0,7,6,20,41,1
3777,78881,toLFcom7KFecBZf6qB124Knuopx8NQmy,SpATywNh6bZuzm8s1ceuBUnMUAeoAHHw,15,9,5,15,4,0,5,2,40,5.714285714285714,1,0.0,2,5,15,4,7,0,0,5,2,26,14,0
3778,78914,azVElWk7I3VwRJA3S907C5a9P0Jn3yCG,SpATywNh6bZuzm8s1ceuBUnMUAeoAHHw,5,4,2,0,1,0,2,0,9,1.2857142857142858,1,0.0,0,2,0,1,4,0,0,2,0,3,6,1
3779,78972,ef55znmweQJrijlI0fO1Ekc271nZnV0m,SpATywNh6bZuzm8s1ceuBUnMUAeoAHHw,14,15,6,7,5,1,7,0,41,5.857142857142857,2,0.0,8,6,7,5,7,1,0,7,0,26,15,0
3780,78981,NohnA6aI0IdpBmazHAgdTY50K8lYcWSq,A3fsA9Zfv1X2fVEQhTw51lKENdNrEqT3,8,4,3,0,3,0,1,0,11,1.5714285714285714,1,0.0,0,3,0,3,4,0,0,1,0,6,5,1
3781,78984,v6Va3YleqjOFxWX0C18ItZbiVgGPA6xX,RXDvfPUBYFlVdlueBFbLW0mhhAyGEqpt,14,24,8,0,3,22,18,2,77,11.0,4,0.0,2,8,0,3,22,22,0,18,2,13,64,1
3782,79004,xsisvuj6gK52B2ADQNofz9kAaPqANNhO,SpATywNh6bZuzm8s1ceuBUnMUAeoAHHw,10,8,2,0,1,1,5,1,18,2.5714285714285716,1,0.0,0,2,0,1,8,1,0,5,1,3,15,1
3783,79006,mP6z9RZ14UwkQFXdxH2YSItn6R2tzg1x,SpATywNh6bZuzm8s1ceuBUnMUAeoAHHw,17,24,12,16,4,81,12,3,152,21.714285714285715,5,0.0,7,12,15,4,17,81,1,12,3,38,114,1
3784,79007,THie45OT0ypeHdwObqe2tZANN0miCnWz,SpATywNh6bZuzm8s1ceuBUnMUAeoAHHw,9,25,1,18,0,2,1,0,47,6.714285714285714,1,0.0,17,1,15,0,8,2,3,1,0,33,14,1
3785,79022,twCpzhGO216Hze2mrl4NXCjfHuwTo4Bh,SpATywNh6bZuzm8s1ceuBUnMUAeoAHHw,14,25,13,9,3,0,6,0,56,8.0,3,0.0,3,13,9,3,22,0,0,6,0,28,28,0
3786,79055,zTHTtX2nKd2KBXQuLnlYdTrAwR5h128q,SpATywNh6bZuzm8s1ceuBUnMUAeoAHHw,10,19,1,14,0,0,2,0,36,5.142857142857143,1,0.0,12,1,13,0,7,0,1,2,0,26,10,1
3787,79061,MoBz0U3Ui9CRWte6snkIzBaarIFflstn,SpATywNh6bZuzm8s1ceuBUnMUAeoAHHw,15,18,8,18,3,2,11,3,63,9.0,2,0.0,4,8,18,3,14,2,0,11,3,33,30,1
3788,79163,LwwIfMdYfjJJxHB8Z4Fggv4xXuygh6dE,A3fsA9Zfv1X2fVEQhTw51lKENdNrEqT3,4,3,1,0,0,0,1,0,5,0.7142857142857143,1,0.0,0,1,0,0,3,0,0,1,0,1,4,1
3789,79167,Zz3pwLjAzfZui2iOxDBByv28nniL3g2U,SpATywNh6bZuzm8s1ceuBUnMUAeoAHHw,14,20,7,13,4,0,2,0,46,6.571428571428571,1,0.0,10,7,13,4,10,0,0,2,0,34,12,1
3790,79169,LwwIfMdYfjJJxHB8Z4Fggv4xXuygh6dE,bWdj2GDclj5ofokWjzoa5jAwMkxCykd6,6,8,2,0,3,1,4,0,18,2.5714285714285716,2,0.0,2,2,0,3,6,1,0,4,0,7,11,0
3791,79170,h774wdF6vIIcl50Js74gckwUtlv9SBGH,SpATywNh6bZuzm8s1ceuBUnMUAeoAHHw,14,35,21,6,5,2,8,0,77,11.0,3,0.0,7,21,6,5,28,2,0,8,0,39,38,0
3792,79172,layckrYedWZgFw7etRwkXZmJxZfLSCWL,RXDvfPUBYFlVdlueBFbLW0mhhAyGEqpt,1,0,0,0,0,0,1,0,1,0.14285714285714285,1,0.0,0,0,0,0,0,0,0,1,0,0,1,1
3793,79180,PT6UXcwKy3wc3VzHkqI3gbGZ6DxtjZzB,SpATywNh6bZuzm8s1ceuBUnMUAeoAHHw,5,4,1,0,0,0,2,0,7,1.0,1,0.0,0,1,0,0,4,0,0,2,0,1,6,0
3794,79273,DpXkrIHIAIPNESKyvFah0WhpVT5PHFeL,A3fsA9Zfv1X2fVEQhTw51lKENdNrEqT3,6,6,5,0,0,4,4,0,19,2.7142857142857144,2,0.0,0,5,0,0,6,4,0,4,0,5,14,1
3795,79290,vtrHNbtnxRGyZem1sSOdKIp109fZtSKY,SpATywNh6bZuzm8s1ceuBUnMUAeoAHHw,13,21,14,7,7,7,9,0,65,9.285714285714286,2,0.0,0,14,6,7,21,7,1,9,0,27,38,0
3796,79307,3MN9gqffGxZJqVwbda6Nr5mGlWwnaW7z,G8EPVSXsOYB5YQWZGiz1aVq5Pgr2GrQu,9,10,7,0,5,0,2,0,24,3.4285714285714284,1,0.0,1,7,0,5,9,0,0,2,0,13,11,0
3797,79315,b9hN1tjIpM67gB8PuwPQ3u561lqo1V2f,A3fsA9Zfv1X2fVEQhTw51lKENdNrEqT3,30,26,21,12,18,2,10,1,90,12.857142857142858,2,0.0,1,21,12,18,25,2,0,10,1,52,38,1
3798,79352,giXuT5U1RtMqgo8IXt5j9x4mrlpr0AWq,SpATywNh6bZuzm8s1ceuBUnMUAeoAHHw,14,25,2,12,0,1,11,0,51,7.285714285714286,3,0.0,10,2,10,0,15,1,2,11,0,22,29,0
3799,79374,2Z36vzEoy2AuTF2qkFNHld62ohkbaoik,G8EPVSXsOYB5YQWZGiz1aVq5Pgr2GrQu,5,4,2,0,1,0,6,0,13,1.8571428571428572,1,0.0,0,2,0,1,4,0,0,6,0,3,10,1
3800,79378,LgPlpopSU02baX8XsEJO6rWixplusEKm,SpATywNh6bZuzm8s1ceuBUnMUAeoAHHw,16,27,14,9,3,2,7,0,62,8.857142857142858,3,0.0,10,14,8,3,17,2,1,7,0,35,27,0
3801,79430,3MN9gqffGxZJqVwbda6Nr5mGlWwnaW7z,SpATywNh6bZuzm8s1ceuBUnMUAeoAHHw,10,13,10,0,6,0,5,0,34,4.857142857142857,1,0.0,0,10,0,6,13,0,0,5,0,16,18,0
3802,79498,GPbq86k98Rz9tUbijEEopIymy9u0Fcyf,RXDvfPUBYFlVdlueBFbLW0mhhAyGEqpt,24,22,18,38,5,1,4,4,92,13.142857142857142,1,0.0,3,18,30,5,19,1,8,4,4,56,36,1
3803,79568,rZUdPpi92l1qQIS8kuhajEO9kujkZRBg,SpATywNh6bZuzm8s1ceuBUnMUAeoAHHw,1,0,0,0,0,0,1,0,1,0.14285714285714285,1,0.0,0,0,0,0,0,0,0,1,0,0,1,1
3804,79606,ZOTpNZ0MPCzhXQVB7FrlPGVckR2bh01V,SpATywNh6bZuzm8s1ceuBUnMUAeoAHHw,4,0,0,0,0,4,5,0,9,1.2857142857142858,1,0.0,0,0,0,0,0,4,0,5,0,0,9,0
3805,79614,fIRimGrxWNqdzbEvkhoxiWFjGRhUXcWW,A3fsA9Zfv1X2fVEQhTw51lKENdNrEqT3,15,9,6,0,6,0,1,0,22,3.142857142857143,1,0.0,0,6,0,6,9,0,0,1,0,12,10,0
3806,79639,HHjw6PARN0UbkiffbOwvG4RULtVIyY0R,RXDvfPUBYFlVdlueBFbLW0mhhAyGEqpt,6,11,0,0,0,0,2,0,13,1.8571428571428572,1,0.0,1,0,0,0,10,0,0,2,0,1,12,0
3807,79767,ffg9VbmMkFKj2DfO61ClA5PDHr5Xa6gN,A3fsA9Zfv1X2fVEQhTw51lKENdNrEqT3,15,34,6,0,6,0,4,0,50,7.142857142857143,4,0.0,0,6,0,6,34,0,0,4,0,12,38,1
3808,79859,gEzMd6gbgpZIm67NWd6vqHpEEo3Eo4i8,SpATywNh6bZuzm8s1ceuBUnMUAeoAHHw,1,0,0,0,0,0,1,0,1,0.14285714285714285,1,0.0,0,0,0,0,0,0,0,1,0,0,1,1
3809,79887,yonwfYKGqRaxFqA59D8fadwOwcb5hmqL,SpATywNh6bZuzm8s1ceuBUnMUAeoAHHw,18,32,11,28,4,14,14,1,104,14.857142857142858,4,0.0,16,11,26,4,16,14,2,14,1,57,47,1
3810,79954,U0h9ZcOzwmSa5zXabz3gRq51gj9CVPUf,SpATywNh6bZuzm8s1ceuBUnMUAeoAHHw,1,0,0,0,0,0,1,0,1,0.14285714285714285,1,0.0,0,0,0,0,0,0,0,1,0,0,1,0
3811,79973,lxjW2IwfKKnK2DrRSZaIR9GsDl9lxdt8,A3fsA9Zfv1X2fVEQhTw51lKENdNrEqT3,9,4,2,0,1,1,6,1,15,2.142857142857143,1,0.0,0,2,0,1,4,1,0,6,1,3,12,0
3812,80047,QjwQzuiA6TAJjCb0ag4sYfZRjiTOPACp,SpATywNh6bZuzm8s1ceuBUnMUAeoAHHw,15,45,25,5,13,1,17,0,106,15.142857142857142,3,0.0,4,25,5,13,41,1,0,17,0,47,59,0
3813,80097,RPansaKc9yPYyKahcqLAJO6a0GoBHglr,bWdj2GDclj5ofokWjzoa5jAwMkxCykd6,10,13,4,32,6,7,5,0,67,9.571428571428571,3,0.0,7,4,30,6,6,7,2,5,0,47,20,1
3814,80136,XQFWhrsULMJrGiXoFieAPwx4Rm1ETQ8D,SpATywNh6bZuzm8s1ceuBUnMUAeoAHHw,14,21,13,13,5,2,8,0,62,8.857142857142858,3,0.0,2,13,13,5,19,2,0,8,0,33,29,0
3815,80226,IVH8kKmCoTvdDqBRydeePjJ8DeEc5nxo,G8EPVSXsOYB5YQWZGiz1aVq5Pgr2GrQu,11,6,0,8,1,2,9,1,27,3.857142857142857,1,0.0,4,0,5,1,2,2,3,9,1,10,17,1
3816,80231,v20UMppd3ocHkd49REEhfohYTaesL83r,SpATywNh6bZuzm8s1ceuBUnMUAeoAHHw,5,7,3,0,2,0,3,0,15,2.142857142857143,3,0.0,3,3,0,2,4,0,0,3,0,8,7,1
3817,80256,qbxr7nsJKbupU2nnOZ4AXSvMY5DklIDV,SpATywNh6bZuzm8s1ceuBUnMUAeoAHHw,12,16,6,1,3,0,4,0,30,4.285714285714286,1,0.0,6,6,1,3,10,0,0,4,0,16,14,0
3818,80258,AlLFcyRB5UwpN8dJK67Vqu0OFPpIDrGm,A3fsA9Zfv1X2fVEQhTw51lKENdNrEqT3,21,24,20,0,14,0,1,0,59,8.428571428571429,1,0.0,1,20,0,14,23,0,0,1,0,35,24,0
3819,80348,9D8Fr85Y0xJSTSvXENunTRQkQQzpKKhe,bWdj2GDclj5ofokWjzoa5jAwMkxCykd6,19,24,14,72,4,4,10,1,129,18.428571428571427,4,0.0,5,14,68,4,19,4,4,10,1,91,38,1
3820,80360,eShFyPGgCT65uThL7XGiKvmljTNciFAA,G8EPVSXsOYB5YQWZGiz1aVq5Pgr2GrQu,5,2,1,0,1,1,3,0,8,1.1428571428571428,1,0.0,0,1,0,1,2,1,0,3,0,2,6,1
3821,80373,YrgwsEFjLyT5SXSOyIIpFlTBfXK1acSP,bWdj2GDclj5ofokWjzoa5jAwMkxCykd6,7,8,1,10,3,1,2,1,26,3.7142857142857144,1,0.0,6,1,8,3,2,1,2,2,1,18,8,0
3822,80400,xH5f8nfW6oTIgHjXoQgEUKIx6qvDN8rk,A3fsA9Zfv1X2fVEQhTw51lKENdNrEqT3,1,0,0,0,0,0,1,0,1,0.14285714285714285,1,0.0,0,0,0,0,0,0,0,1,0,0,1,1
3823,80406,9d6HoNqzGbbCd66bGVck7uPSgkXTez3M,G8EPVSXsOYB5YQWZGiz1aVq5Pgr2GrQu,14,22,4,4,5,0,7,0,42,6.0,3,0.0,11,4,3,5,11,0,1,7,0,23,19,1
3824,80454,SicKtTdinGjYgkh3dK0y8UiEfELy0LiN,bWdj2GDclj5ofokWjzoa5jAwMkxCykd6,4,2,0,0,0,0,5,0,7,1.0,2,0.0,0,0,0,0,2,0,0,5,0,0,7,1
3825,80505,I7kUxTrFR4kUt4IUmZUgm3AQtDQNh7Pu,G8EPVSXsOYB5YQWZGiz1aVq5Pgr2GrQu,21,25,22,36,8,4,27,0,122,17.428571428571427,4,0.0,0,22,28,8,25,4,8,27,0,58,64,0
3826,80564,qWUac1M6H0GGCt2oRkcCo2PK0QcGvZVS,A3fsA9Zfv1X2fVEQhTw51lKENdNrEqT3,4,4,1,0,0,0,1,0,6,0.8571428571428571,1,0.0,0,1,0,0,4,0,0,1,0,1,5,1
3827,80632,4CBJi9FPwBtDwABbM6tdSqW9vKh1q7Z5,SpATywNh6bZuzm8s1ceuBUnMUAeoAHHw,17,27,10,16,3,27,14,2,99,14.142857142857142,2,0.0,13,10,13,3,14,27,3,14,2,39,60,1
3828,80660,TMS9M7AUlYgaEtdQAX29SchyEATrODFG,G8EPVSXsOYB5YQWZGiz1aVq5Pgr2GrQu,61,84,34,88,19,3,11,2,241,34.42857142857143,3,0.0,45,34,54,19,39,3,34,11,2,152,89,1
3829,80717,eVZffGeL4uoEevrNNMdcmW6f0YwT8plW,SpATywNh6bZuzm8s1ceuBUnMUAeoAHHw,16,20,9,13,4,2,10,2,60,8.571428571428571,3,0.0,6,9,13,4,14,2,0,10,2,32,28,1
3830,80728,EZ8RICWKm2CZHfClKFJxNtx1ItORs9so,SpATywNh6bZuzm8s1ceuBUnMUAeoAHHw,15,38,3,19,1,4,16,2,83,11.857142857142858,2,0.0,9,3,16,1,29,4,3,16,2,29,54,1
3831,80779,6qgQAmX6y5wh5nEPRINOiKrZNoTl5yfT,bWdj2GDclj5ofokWjzoa5jAwMkxCykd6,17,24,10,62,8,15,9,2,130,18.571428571428573,2,0.0,10,10,58,8,14,15,4,9,2,86,44,1
3832,80798,B0jVKFlvXfKwVR9pXnhJZcf2VbxqeEJP,SpATywNh6bZuzm8s1ceuBUnMUAeoAHHw,6,3,2,0,1,0,2,0,8,1.1428571428571428,1,0.0,0,2,0,1,3,0,0,2,0,3,5,1
3833,80799,cJ9a9VybEQZXRFqEMI78WQ8ukmEaaVlE,SpATywNh6bZuzm8s1ceuBUnMUAeoAHHw,15,20,7,19,3,4,5,0,58,8.285714285714286,2,0.0,10,7,16,3,10,4,3,5,0,36,22,0
3834,80825,IH2c5uYafZAMnz8GRu5q3bfkjqRBG0d4,bWdj2GDclj5ofokWjzoa5jAwMkxCykd6,4,3,1,0,1,0,3,0,8,1.1428571428571428,1,0.0,0,1,0,1,3,0,0,3,0,2,6,1
3835,80867,pXgjy4DXaOKMQD4LAgLui9VHE5CpkZu9,fbPkOYLVPtPgIt0MxizjfFJov3JbHyAi,20,29,17,0,13,26,6,1,92,13.142857142857142,1,0.0,6,17,0,13,23,26,0,6,1,36,56,1
3836,80877,9aS1NSJb2Hj0xHbbuoyhLmktYrjypxsy,fbPkOYLVPtPgIt0MxizjfFJov3JbHyAi,26,51,18,39,15,8,13,0,144,20.571428571428573,3,0.0,26,18,38,15,25,8,1,13,0,97,47,1
3837,80881,whV1nFYZoFkMMEitqUr4NmhBR8HyCOwO,fbPkOYLVPtPgIt0MxizjfFJov3JbHyAi,8,6,4,0,3,17,5,0,35,5.0,1,0.0,0,4,0,3,6,17,0,5,0,7,28,1
3838,80886,0DzldTHKdoH90kklIAjpWyAEe6XDDjyM,fbPkOYLVPtPgIt0MxizjfFJov3JbHyAi,8,9,6,0,4,13,6,0,38,5.428571428571429,3,0.0,0,6,0,4,9,13,0,6,0,10,28,1
3839,80888,koWvCadm1og0LpcFvcQlTqhBDNIm2AFz,fbPkOYLVPtPgIt0MxizjfFJov3JbHyAi,7,3,2,0,2,0,2,0,9,1.2857142857142858,1,0.0,0,2,0,2,3,0,0,2,0,4,5,1
3840,80899,LB9Y3hHJxXFKUivI2IDZO69UMgf1mHWd,fbPkOYLVPtPgIt0MxizjfFJov3JbHyAi,12,23,11,0,1,9,3,0,47,6.714285714285714,1,0.0,1,11,0,1,22,9,0,3,0,13,34,1
3841,82295,2vTiDJaUXObkB4MCSVV6b36fCzIFNmlO,fbPkOYLVPtPgIt0MxizjfFJov3JbHyAi,7,1,1,0,1,14,16,1,34,4.857142857142857,1,0.0,0,1,0,1,1,14,0,16,1,2,32,1
3842,82303,7cOxNQ9QY0kpQ3XCTHRP00ygFCzb9CpO,fbPkOYLVPtPgIt0MxizjfFJov3JbHyAi,6,3,1,0,0,2,4,1,11,1.5714285714285714,1,0.0,0,1,0,0,3,2,0,4,1,1,10,1
3843,82347,HMYpimZGFgj5IczDutkfjUfnxl45PoHW,7GRhBDsirIGkRZBtSMEzNTyDr2JQm4xx,1,0,0,0,0,0,1,0,1,0.14285714285714285,1,0.0,0,0,0,0,0,0,0,1,0,0,1,1
3844,82391,r6vCAWlYIzTyZ2tN64AHwtfHr1599fdG,7GRhBDsirIGkRZBtSMEzNTyDr2JQm4xx,15,22,0,0,1,1,17,1,42,6.0,4,0.0,9,0,0,1,13,1,0,17,1,10,32,0
3845,82633,xLA7fhjHBFsq0q4kxpkXfUkRljEs0TAd,SpATywNh6bZuzm8s1ceuBUnMUAeoAHHw,12,22,16,4,8,1,4,0,55,7.857142857142857,2,0.0,3,16,4,8,19,1,0,4,0,31,24,0
3846,82635,xLA7fhjHBFsq0q4kxpkXfUkRljEs0TAd,bWdj2GDclj5ofokWjzoa5jAwMkxCykd6,17,28,13,54,8,8,12,0,123,17.571428571428573,3,0.0,9,13,53,8,19,8,1,12,0,83,40,0
3847,82642,7IO6p4687fQRowFKh8aP2BRrTBz96sXF,G8EPVSXsOYB5YQWZGiz1aVq5Pgr2GrQu,15,7,3,10,3,0,8,1,32,4.571428571428571,2,0.0,1,3,8,3,6,0,2,8,1,15,17,0
3848,82722,i0k5iK0fS6RmfXLKfz70zhtGt8sKmdev,G8EPVSXsOYB5YQWZGiz1aVq5Pgr2GrQu,14,22,2,40,2,0,3,0,69,9.857142857142858,2,0.0,0,2,35,2,22,0,5,3,0,39,30,1
3849,82840,Jee7EGsn5XYP5oawysLFsO8VcnPFjYWM,SpATywNh6bZuzm8s1ceuBUnMUAeoAHHw,14,14,6,21,3,0,3,0,47,6.714285714285714,1,0.0,6,6,18,3,8,0,3,3,0,33,14,1
3850,82875,LSxdutAKHjruUktaLYDzR4TTFH4npHSj,SpATywNh6bZuzm8s1ceuBUnMUAeoAHHw,9,6,5,0,4,0,5,0,20,2.857142857142857,1,0.0,0,5,0,4,6,0,0,5,0,9,11,1
3851,82911,g1LVeBlQiVCOcKiTDDTy4PafQkGd4pbr,A3fsA9Zfv1X2fVEQhTw51lKENdNrEqT3,2,0,0,0,0,0,3,0,3,0.42857142857142855,2,0.0,0,0,0,0,0,0,0,3,0,0,3,0
3852,82912,dSKLyWRwDNYp6bnGVfES0oxRsg4F2fbZ,SpATywNh6bZuzm8s1ceuBUnMUAeoAHHw,6,5,0,0,0,0,3,0,8,1.1428571428571428,1,0.0,0,0,0,0,5,0,0,3,0,0,8,1
3853,82968,k3mZz4gOE5kxngWJdlg5ZkSuFCPjQxmM,A3fsA9Zfv1X2fVEQhTw51lKENdNrEqT3,9,5,3,0,3,0,3,0,14,2.0,1,0.0,0,3,0,3,5,0,0,3,0,6,8,1
3854,83123,ZNcLOAJ2r3H5DqhbGk1CiPtwI7ixaCeK,bWdj2GDclj5ofokWjzoa5jAwMkxCykd6,5,7,3,0,2,0,3,0,15,2.142857142857143,2,0.0,0,3,0,2,7,0,0,3,0,5,10,0
3855,83126,Lcn36O95deZy87mO20P7rqE00Sa7JkLZ,SpATywNh6bZuzm8s1ceuBUnMUAeoAHHw,7,8,3,14,0,6,3,0,34,4.857142857142857,2,0.0,3,3,11,0,5,6,3,3,0,17,17,1
3856,83161,pAklb1PvY7ruK0UegPVyIZm4Osf6iC9m,bWdj2GDclj5ofokWjzoa5jAwMkxCykd6,5,1,1,0,1,0,2,0,5,0.7142857142857143,1,0.0,0,1,0,1,1,0,0,2,0,2,3,1
3857,83305,4NR9J7NrWx9P8bFiOFbZEGtYIezzdGum,SpATywNh6bZuzm8s1ceuBUnMUAeoAHHw,1,0,0,0,0,0,1,0,1,0.14285714285714285,1,0.0,0,0,0,0,0,0,0,1,0,0,1,1
3858,83314,n49l3ufDNhve5wMzUe1UGnoLeZWomGLA,SpATywNh6bZuzm8s1ceuBUnMUAeoAHHw,7,4,3,0,2,0,1,0,10,1.4285714285714286,1,0.0,0,3,0,2,4,0,0,1,0,5,5,1
3859,83403,e7qNFJlKhMPlLeAG8swrUc3pRnnUCD82,SpATywNh6bZuzm8s1ceuBUnMUAeoAHHw,9,11,8,0,5,1,4,0,29,4.142857142857143,2,0.0,0,8,0,5,11,1,0,4,0,13,16,0
3860,83425,Lr6km982apCQSCgmC6f9GQFgHOEktsCy,G8EPVSXsOYB5YQWZGiz1aVq5Pgr2GrQu,12,7,2,14,1,1,5,0,30,4.285714285714286,2,0.0,0,2,12,1,7,1,2,5,0,15,15,1
3861,83578,t8qBiDTvOvYmrxcVIErRuEOf38tywm6t,A3fsA9Zfv1X2fVEQhTw51lKENdNrEqT3,42,21,17,92,8,7,6,0,151,21.571428571428573,2,0.0,1,17,73,8,20,7,19,6,0,99,52,1
3862,83610,LsCKaHxDojvW6mqkt4YixGtP1AxIvEcR,SpATywNh6bZuzm8s1ceuBUnMUAeoAHHw,11,15,0,7,0,2,8,1,33,4.714285714285714,2,0.0,0,0,6,0,15,2,1,8,1,6,27,0
3863,83614,f0G6xN4ok96NnHxUb12ID1EOiKvmCYmR,SpATywNh6bZuzm8s1ceuBUnMUAeoAHHw,5,10,7,0,0,0,3,0,20,2.857142857142857,2,0.0,0,7,0,0,10,0,0,3,0,7,13,1
3864,83795,P0VuZGgCaFPCBxKorH7bJdlMsmBgjIrL,bWdj2GDclj5ofokWjzoa5jAwMkxCykd6,6,2,1,0,1,2,4,5,15,2.142857142857143,1,0.0,0,1,0,1,2,2,0,4,5,2,13,1
3865,83851,hkZJZMuEk3eRSgWhjH7jPcJrlgv2RTNl,A3fsA9Zfv1X2fVEQhTw51lKENdNrEqT3,14,7,5,18,4,0,2,0,36,5.142857142857143,1,0.0,0,5,15,4,7,0,3,2,0,24,12,1
3866,83858,mSQuPHmd8TP05MnBFR4zut82tnd837yj,G8EPVSXsOYB5YQWZGiz1aVq5Pgr2GrQu,10,20,2,0,3,0,5,0,30,4.285714285714286,2,0.0,6,2,0,3,14,0,0,5,0,11,19,0
3867,83861,yfR3kQ7JpR4tbAAtg2uJogcbjyExFgIX,A3fsA9Zfv1X2fVEQhTw51lKENdNrEqT3,12,7,0,20,0,0,4,0,31,4.428571428571429,2,0.0,0,0,19,0,7,0,1,4,0,19,12,1
3868,83916,9gwK2SMO9RzFmbR3NVs20xNig2HGOi8l,A3fsA9Zfv1X2fVEQhTw51lKENdNrEqT3,2,0,0,0,0,0,2,0,2,0.2857142857142857,2,0.0,0,0,0,0,0,0,0,2,0,0,2,1
3869,83937,riM9GkB0ajSqpIPlVq4tRzOjk7wJ6NHE,SpATywNh6bZuzm8s1ceuBUnMUAeoAHHw,2,0,0,0,0,0,2,0,2,0.2857142857142857,1,0.0,0,0,0,0,0,0,0,2,0,0,2,1
3870,83949,Z89wynkx1rcXHYvlCNExAupGqq9VVjQV,G8EPVSXsOYB5YQWZGiz1aVq5Pgr2GrQu,23,5,4,56,1,0,9,1,76,10.857142857142858,2,0.0,0,4,48,1,5,0,8,9,1,53,23,1
3871,83978,19iVDfShKixZpg8xTJAbBZz9CTfyTS2H,A3fsA9Zfv1X2fVEQhTw51lKENdNrEqT3,5,3,1,0,1,0,2,0,7,1.0,1,0.0,0,1,0,1,3,0,0,2,0,2,5,1
3872,84001,rdlMbs5MAmZwKWZ5MP6d4JJy7danp2Mg,A3fsA9Zfv1X2fVEQhTw51lKENdNrEqT3,40,23,17,94,15,0,3,0,152,21.714285714285715,1,0.0,2,17,77,15,21,0,17,3,0,111,41,1
3873,84165,n1ESpvyobZkFsfrWJhKOuY4URaa1sUc5,SpATywNh6bZuzm8s1ceuBUnMUAeoAHHw,8,18,10,0,0,0,7,0,35,5.0,1,0.0,0,10,0,0,18,0,0,7,0,10,25,0
3874,84435,OOJh2Yrr6RQf9QAHFBo7EBzeZ2OAmLfw,SpATywNh6bZuzm8s1ceuBUnMUAeoAHHw,10,45,14,0,1,3,13,2,78,11.142857142857142,4,0.0,0,14,0,1,45,3,0,13,2,15,63,1
3875,84456,RGf4k3THi4AV4qsAjc1UEOWiIeDYcchf,RXDvfPUBYFlVdlueBFbLW0mhhAyGEqpt,1,0,0,0,0,0,4,0,4,0.5714285714285714,1,0.0,0,0,0,0,0,0,0,4,0,0,4,1
3876,84666,hBNiP82EasOgIR36wjHyg8vPIDQi3YO9,bWdj2GDclj5ofokWjzoa5jAwMkxCykd6,18,26,14,63,3,24,43,1,174,24.857142857142858,4,0.0,3,14,57,3,23,24,6,43,1,77,97,1
3877,84700,y6ntZnNLGo4HBLvhhvkQknL88GLC1lnO,A3fsA9Zfv1X2fVEQhTw51lKENdNrEqT3,9,7,5,0,4,1,4,1,22,3.142857142857143,1,0.0,0,5,0,4,7,1,0,4,1,9,13,1
3878,84830,Q9zNW7tUNygCfX90HmMYh3sp90BWwKOU,bWdj2GDclj5ofokWjzoa5jAwMkxCykd6,6,2,1,0,1,1,3,1,9,1.2857142857142858,1,0.0,0,1,0,1,2,1,0,3,1,2,7,1
3879,84839,VIwJtaSOWWljnDL02ObzIxH4JeVU0QQ1,A3fsA9Zfv1X2fVEQhTw51lKENdNrEqT3,25,23,16,0,10,1,12,0,62,8.857142857142858,3,0.0,0,16,0,10,23,1,0,12,0,26,36,1
3880,84843,SgKrscfCtmytbxsrqs57oYYzOpyIlSfF,A3fsA9Zfv1X2fVEQhTw51lKENdNrEqT3,43,24,15,70,8,10,16,1,144,20.571428571428573,3,0.0,4,15,60,8,20,10,10,16,1,87,57,0
3881,84847,FeSQQc9CIFMTYLlHcSRbUJqf0NNwxJ2K,A3fsA9Zfv1X2fVEQhTw51lKENdNrEqT3,42,49,19,44,11,0,8,0,131,18.714285714285715,2,0.0,3,19,43,11,46,0,1,8,0,76,55,0
3882,84900,kFEFWVRKxySg48KS2BQ5EGBj2Fy43YYR,SpATywNh6bZuzm8s1ceuBUnMUAeoAHHw,4,3,0,0,0,0,2,0,5,0.7142857142857143,1,0.0,1,0,0,0,2,0,0,2,0,1,4,0
3883,85012,DyupaV8BmUavHjvovvxyDg1D0z37S8dm,bWdj2GDclj5ofokWjzoa5jAwMkxCykd6,6,5,3,0,2,0,3,0,13,1.8571428571428572,1,0.0,0,3,0,2,5,0,0,3,0,5,8,1
3884,85019,aIIHBjdeRcv9jhajcTkxD39vpVMqF1ri,RXDvfPUBYFlVdlueBFbLW0mhhAyGEqpt,6,4,2,0,1,0,1,0,8,1.1428571428571428,1,0.0,0,2,0,1,4,0,0,1,0,3,5,1
3885,85046,kNdT4Mob6J1VkdvqbhmS4aPzbDLqNeYP,bWdj2GDclj5ofokWjzoa5jAwMkxCykd6,4,2,1,0,1,0,1,0,5,0.7142857142857143,1,0.0,0,1,0,1,2,0,0,1,0,2,3,1
3886,85191,YgaRsb5CJPElWQw5mvJ8Vl3IfLfYzm4F,SpATywNh6bZuzm8s1ceuBUnMUAeoAHHw,9,3,2,0,2,0,5,1,13,1.8571428571428572,1,0.0,0,2,0,2,3,0,0,5,1,4,9,1
3887,85307,HDadS1kWhA9nJbFHsRG6aT6o1pPlcFrf,SpATywNh6bZuzm8s1ceuBUnMUAeoAHHw,1,0,0,0,0,0,1,0,1,0.14285714285714285,1,0.0,0,0,0,0,0,0,0,1,0,0,1,1
3888,85347,qr1Y8xuPrcpdzScNHYsirGXqasfUdOVa,A3fsA9Zfv1X2fVEQhTw51lKENdNrEqT3,7,3,2,0,1,0,8,0,14,2.0,1,0.0,0,2,0,1,3,0,0,8,0,3,11,1
3889,85360,sT9hGAnww95aeGvqwQpJlS3ORhWDT49F,SpATywNh6bZuzm8s1ceuBUnMUAeoAHHw,9,11,3,8,1,0,2,0,25,3.5714285714285716,1,0.0,5,3,7,1,6,0,1,2,0,16,9,0
3890,85381,MaYaRLQWCfitDjLO89g6UksqHgmMxPRV,SpATywNh6bZuzm8s1ceuBUnMUAeoAHHw,7,2,1,0,1,4,5,1,14,2.0,1,0.0,0,1,0,1,2,4,0,5,1,2,12,0
3891,86912,GfqCozSB56b335uZLl5d2syEloMgMtnE,SpATywNh6bZuzm8s1ceuBUnMUAeoAHHw,8,22,10,0,5,5,25,3,70,10.0,1,0.0,1,10,0,5,21,5,0,25,3,16,54,0
3892,86916,m9APg30xFaPG98uje3arCJfO5W7zr48c,SpATywNh6bZuzm8s1ceuBUnMUAeoAHHw,1,0,0,0,0,0,1,0,1,0.14285714285714285,1,0.0,0,0,0,0,0,0,0,1,0,0,1,1
3893,86938,rJCRtFYOHadlaWolNt4hiGuOfo8UHBBK,SpATywNh6bZuzm8s1ceuBUnMUAeoAHHw,13,30,9,12,3,7,4,0,65,9.285714285714286,3,0.0,16,9,12,3,14,7,0,4,0,40,25,0
3894,86974,HB5xN5WvO63fyle8L9OU8KEV5tvW4m0R,SpATywNh6bZuzm8s1ceuBUnMUAeoAHHw,10,3,2,0,2,1,6,3,17,2.4285714285714284,1,0.0,0,2,0,2,3,1,0,6,3,4,13,0
3895,87087,ycZcyaRZkRmTmfTyJcaxWvg5l6N3L4CN,SpATywNh6bZuzm8s1ceuBUnMUAeoAHHw,12,13,7,0,4,3,4,1,32,4.571428571428571,1,0.0,3,7,0,4,10,3,0,4,1,14,18,1
3896,87109,xSRvBNCdhLUrfFyYzicxsnRRkZUYQ9tk,SpATywNh6bZuzm8s1ceuBUnMUAeoAHHw,11,10,1,0,0,0,9,1,21,3.0,2,0.0,2,1,0,0,8,0,0,9,1,3,18,1
3897,87120,Kpr6ISdqohTmchfzbxziZ98TNPreGKVa,SpATywNh6bZuzm8s1ceuBUnMUAeoAHHw,6,5,1,0,1,0,2,0,9,1.2857142857142858,1,0.0,2,1,0,1,3,0,0,2,0,4,5,1
3898,87147,PHBho9Sc0XQZt8wGEuns5tbDU5eoHa8g,A3fsA9Zfv1X2fVEQhTw51lKENdNrEqT3,5,2,1,0,1,0,3,0,7,1.0,1,0.0,0,1,0,1,2,0,0,3,0,2,5,0
3899,87169,BYoagvhtaQZvEdBOdm0fSGLXeMikTNAf,SpATywNh6bZuzm8s1ceuBUnMUAeoAHHw,8,5,0,0,0,0,3,0,8,1.1428571428571428,1,0.0,0,0,0,0,5,0,0,3,0,0,8,1
3900,87199,hO4ixki4cn72f2HXil7H5yfXyIpxdfFl,SpATywNh6bZuzm8s1ceuBUnMUAeoAHHw,14,20,1,18,1,0,7,0,47,6.714285714285714,2,0.0,9,1,15,1,11,0,3,7,0,26,21,0
3901,87514,UUyRymVa7K1uXcxu9NV7wrw7koSoKJkA,A3fsA9Zfv1X2fVEQhTw51lKENdNrEqT3,8,1,0,0,1,0,8,1,11,1.5714285714285714,1,0.0,0,0,0,1,1,0,0,8,1,1,10,1
3902,87520,pqsPOTJhOrzp1CuSM0L3m4JXPVXPbkqe,SpATywNh6bZuzm8s1ceuBUnMUAeoAHHw,16,27,13,6,2,5,9,1,63,9.0,1,0.0,4,13,6,2,23,5,0,9,1,25,38,1
3903,87544,HF98YPKzT8oi2j9flZW9kstZcvL3ZimG,SpATywNh6bZuzm8s1ceuBUnMUAeoAHHw,16,18,6,12,3,0,6,0,45,6.428571428571429,2,0.0,5,6,9,3,13,0,3,6,0,23,22,0
3904,87563,mLnrkBxCMzHzCOgxlcePLHngsSsyrmY0,SpATywNh6bZuzm8s1ceuBUnMUAeoAHHw,8,9,0,4,0,0,3,0,16,2.2857142857142856,1,0.0,0,0,3,0,9,0,1,3,0,3,13,0
3905,87607,Y1N757YBcw2pa0f5R2cGYXkdHdVAg7lL,RXDvfPUBYFlVdlueBFbLW0mhhAyGEqpt,22,29,16,0,9,0,1,0,55,7.857142857142857,1,0.0,0,16,0,9,29,0,0,1,0,25,30,1
3906,87645,or5tGmwIQtkxzns3Abayo6pKJnoHWcAG,A3fsA9Zfv1X2fVEQhTw51lKENdNrEqT3,8,2,2,0,2,0,3,0,9,1.2857142857142858,1,0.0,0,2,0,2,2,0,0,3,0,4,5,1
3907,87732,L1FTG9TM6RI5TBCTexQgshQhXhu2oZpJ,RXDvfPUBYFlVdlueBFbLW0mhhAyGEqpt,45,32,19,59,13,2,8,0,133,19.0,4,0.0,9,19,57,13,23,2,2,8,0,98,35,1
3908,87733,bwOsVB833e5tHrwHSqmXCzs0EZClNPpv,bWdj2GDclj5ofokWjzoa5jAwMkxCykd6,6,3,1,0,1,3,5,1,14,2.0,2,0.0,1,1,0,1,2,3,0,5,1,3,11,1
3909,87759,kbnbUyJ6SeYN8u39lgEBCBnZvcNekMlk,bWdj2GDclj5ofokWjzoa5jAwMkxCykd6,4,2,1,0,1,0,1,0,5,0.7142857142857143,1,0.0,0,1,0,1,2,0,0,1,0,2,3,1
3910,87864,nWedGV2Cyz7b86zoWjyUJZtraXV6YlYz,SpATywNh6bZuzm8s1ceuBUnMUAeoAHHw,12,12,0,7,0,1,5,0,25,3.5714285714285716,1,0.0,4,0,7,0,8,1,0,5,0,11,14,0
3911,87919,NtuSsCWxiM5cZ0UalS4e7aFbcsYH60Br,bWdj2GDclj5ofokWjzoa5jAwMkxCykd6,2,0,0,0,0,0,2,0,2,0.2857142857142857,1,0.0,0,0,0,0,0,0,0,2,0,0,2,0
3912,87920,1uj3lODORrX2PgjuF1fpWy9nhOirDGas,G8EPVSXsOYB5YQWZGiz1aVq5Pgr2GrQu,29,43,18,24,5,1,8,1,100,14.285714285714286,4,0.0,4,18,18,5,39,1,6,8,1,45,55,0
3913,87987,Ffohn9JNnGJQD2IavzMTS00ubnVtcb2T,SpATywNh6bZuzm8s1ceuBUnMUAeoAHHw,17,22,12,8,4,1,9,1,57,8.142857142857142,3,0.0,5,12,8,4,17,1,0,9,1,29,28,0
3914,88029,bSaZ1hYnI1zX06sBhHjW0JtYDEAqEuPp,SpATywNh6bZuzm8s1ceuBUnMUAeoAHHw,13,18,0,15,0,12,20,3,68,9.714285714285714,4,0.0,4,0,12,0,14,12,3,20,3,16,52,0
3915,88039,pAIEYSSXdgXA2O8eKo5gs0U3YOaGGkK5,SpATywNh6bZuzm8s1ceuBUnMUAeoAHHw,11,6,4,4,3,0,3,0,20,2.857142857142857,1,0.0,1,4,4,3,5,0,0,3,0,12,8,1
3916,88082,yiWok4eQ5hgdJ8eYi2O0qHhy67Y9EA3E,RXDvfPUBYFlVdlueBFbLW0mhhAyGEqpt,4,2,0,0,0,0,2,0,4,0.5714285714285714,1,0.0,0,0,0,0,2,0,0,2,0,0,4,1
3917,88095,dCAqk9uHiS99GMTcJQtThG8XWnwwbp5Q,bWdj2GDclj5ofokWjzoa5jAwMkxCykd6,1,0,0,0,0,0,1,0,1,0.14285714285714285,1,0.0,0,0,0,0,0,0,0,1,0,0,1,1
3918,88139,dclBqf1EWh3Ih224SoyQN0nAKWGjQR6I,SpATywNh6bZuzm8s1ceuBUnMUAeoAHHw,11,5,4,0,4,2,11,1,27,3.857142857142857,1,0.0,0,4,0,4,5,2,0,11,1,8,19,1
3919,88140,ci0TVQYsVR5jGo6uk57VSejmvHQzKbHq,SpATywNh6bZuzm8s1ceuBUnMUAeoAHHw,15,23,6,16,3,1,6,0,55,7.857142857142857,1,0.0,16,6,13,3,7,1,3,6,0,38,17,1
3920,88775,zNnqmF2sQm5pVrk4EjykARlvIbp0hTq0,fbPkOYLVPtPgIt0MxizjfFJov3JbHyAi,1,0,0,0,0,0,1,0,1,0.14285714285714285,1,0.0,0,0,0,0,0,0,0,1,0,0,1,1
3921,88777,Uf1qigQqXVxNALjpI0OUPGkslBlud9Ut,fbPkOYLVPtPgIt0MxizjfFJov3JbHyAi,6,3,2,0,2,0,1,0,8,1.1428571428571428,1,0.0,0,2,0,2,3,0,0,1,0,4,4,1
3922,88778,gfCaKEduRhBAyI1gNYKiZ3eGKbbM2Zzn,fbPkOYLVPtPgIt0MxizjfFJov3JbHyAi,2,0,0,0,0,0,2,0,2,0.2857142857142857,1,0.0,0,0,0,0,0,0,0,2,0,0,2,1
3923,88780,nxtpPsNzngYTsI1SZcZNPzXTwqY5qTmx,fbPkOYLVPtPgIt0MxizjfFJov3JbHyAi,5,2,1,0,1,0,2,0,6,0.8571428571428571,1,0.0,0,1,0,1,2,0,0,2,0,2,4,1
3924,88782,0Fj1MjrLeWw10VEjEhUtTscYzoHMiAaR,fbPkOYLVPtPgIt0MxizjfFJov3JbHyAi,2,0,0,0,0,0,6,0,6,0.8571428571428571,1,0.0,0,0,0,0,0,0,0,6,0,0,6,1
3925,88783,0osfGmMGm8jt9kb8kP5HcmQdyiR2KFbt,fbPkOYLVPtPgIt0MxizjfFJov3JbHyAi,9,5,3,0,2,6,4,1,21,3.0,1,0.0,0,3,0,2,5,6,0,4,1,5,16,1
3926,88784,la0M1c91h799fPQIw73JrRQfyaSu3lyA,fbPkOYLVPtPgIt0MxizjfFJov3JbHyAi,1,0,0,0,0,0,1,0,1,0.14285714285714285,1,0.0,0,0,0,0,0,0,0,1,0,0,1,1
3927,88785,76WTB850XyfRMUDEt6Hi4EqgOfT9IEtK,fbPkOYLVPtPgIt0MxizjfFJov3JbHyAi,9,12,1,0,1,1,5,1,21,3.0,1,0.0,1,1,0,1,11,1,0,5,1,3,18,1
3928,88787,9k2E0gibBkBETtLxegOSAXJ2stT7JIe8,fbPkOYLVPtPgIt0MxizjfFJov3JbHyAi,8,5,1,0,2,0,11,2,21,3.0,1,0.0,2,1,0,2,3,0,0,11,2,5,16,1
3929,88788,qT122hnKUhEIpv6ZsCDLoOTP7nHJSaNq,fbPkOYLVPtPgIt0MxizjfFJov3JbHyAi,7,4,2,0,2,0,7,0,15,2.142857142857143,1,0.0,1,2,0,2,3,0,0,7,0,5,10,1
3930,88789,fQyY3sWQeXkKYt8B4zLpW9naNVJ351r5,fbPkOYLVPtPgIt0MxizjfFJov3JbHyAi,11,7,3,0,4,0,8,2,24,3.4285714285714284,1,0.0,3,3,0,4,4,0,0,8,2,10,14,1
3931,88790,nZBEO25QEEdKJsNDjWc27BQlFlOJqVIP,fbPkOYLVPtPgIt0MxizjfFJov3JbHyAi,7,5,3,0,2,1,2,0,13,1.8571428571428572,1,0.0,0,3,0,2,5,1,0,2,0,5,8,1
3932,88791,iZvZwMImGAt7q4aUPPRIOXEQbHAYw3j9,fbPkOYLVPtPgIt0MxizjfFJov3JbHyAi,24,28,14,20,15,2,9,1,89,12.714285714285714,1,0.0,9,14,15,15,19,2,5,9,1,53,36,1
3933,88793,iUbyHXj7nnwsn3idID6iMxIxqlgprHQJ,fbPkOYLVPtPgIt0MxizjfFJov3JbHyAi,2,0,0,0,0,0,4,0,4,0.5714285714285714,1,0.0,0,0,0,0,0,0,0,4,0,0,4,1
3934,88797,SJbFjfL77hmrpjM2fDE61GEOGezGEGS2,fbPkOYLVPtPgIt0MxizjfFJov3JbHyAi,1,0,0,0,0,0,1,0,1,0.14285714285714285,1,0.0,0,0,0,0,0,0,0,1,0,0,1,1
3935,88799,sCKziRJTsOYc4lQfYxPq4wO4jIyYAbxE,fbPkOYLVPtPgIt0MxizjfFJov3JbHyAi,2,0,0,0,0,0,2,0,2,0.2857142857142857,1,0.0,0,0,0,0,0,0,0,2,0,0,2,1
3936,88800,NBVERkC2Sbv324jT0djpWcPmYUJcR4Oa,fbPkOYLVPtPgIt0MxizjfFJov3JbHyAi,3,2,0,0,0,0,1,0,3,0.42857142857142855,1,0.0,0,0,0,0,2,0,0,1,0,0,3,1
3937,88802,1qt3gH5lpss0VnR5LgXp1AGPTrEn5n0R,fbPkOYLVPtPgIt0MxizjfFJov3JbHyAi,2,0,0,0,0,0,2,0,2,0.2857142857142857,1,0.0,0,0,0,0,0,0,0,2,0,0,2,1
3938,88803,2zFsyHLRIVr61iaQkzpRvzQtauWJlCfW,fbPkOYLVPtPgIt0MxizjfFJov3JbHyAi,1,0,0,0,0,0,2,0,2,0.2857142857142857,1,0.0,0,0,0,0,0,0,0,2,0,0,2,1
3939,88804,u4s0SPiIkynucY7ReF58TL89R2q4zw1x,fbPkOYLVPtPgIt0MxizjfFJov3JbHyAi,4,2,1,0,1,0,1,0,5,0.7142857142857143,1,0.0,0,1,0,1,2,0,0,1,0,2,3,0
3940,88805,8YR0tcT3D8d0JlIytw4LxKfYYQekJyvj,fbPkOYLVPtPgIt0MxizjfFJov3JbHyAi,5,3,1,0,1,0,1,0,6,0.8571428571428571,1,0.0,0,1,0,1,3,0,0,1,0,2,4,1
3941,88806,emj3hNG2XZHsTTaF5Lr1CYx27lHx0rEZ,fbPkOYLVPtPgIt0MxizjfFJov3JbHyAi,8,9,4,0,4,0,1,0,18,2.5714285714285716,1,0.0,0,4,0,4,9,0,0,1,0,8,10,1
3942,88808,qvojdac7xUuog4FKjywIiWLo2CLniAnu,fbPkOYLVPtPgIt0MxizjfFJov3JbHyAi,9,5,3,0,3,0,2,0,13,1.8571428571428572,1,0.0,0,3,0,3,5,0,0,2,0,6,7,1
3943,88809,r7HcMNOT5LLOYH8hCtxY2qjQMqPnDz4Z,fbPkOYLVPtPgIt0MxizjfFJov3JbHyAi,11,13,7,2,5,4,4,0,35,5.0,1,0.0,1,7,2,5,12,4,0,4,0,15,20,1
3944,88810,Im5unyUxIwWC6gQuuhs0nm7hNG0B0uwk,fbPkOYLVPtPgIt0MxizjfFJov3JbHyAi,7,3,2,0,2,1,7,0,15,2.142857142857143,1,0.0,0,2,0,2,3,1,0,7,0,4,11,1
3945,88811,75sdjcSshG9zd9yqWMZjrix1dGre1kOU,fbPkOYLVPtPgIt0MxizjfFJov3JbHyAi,5,2,1,0,1,0,2,0,6,0.8571428571428571,1,0.0,0,1,0,1,2,0,0,2,0,2,4,1
3946,88813,KC3eAbHLPns12iVsS4LuLv4X7AErDIWY,fbPkOYLVPtPgIt0MxizjfFJov3JbHyAi,1,0,0,0,0,0,2,0,2,0.2857142857142857,1,0.0,0,0,0,0,0,0,0,2,0,0,2,1
3947,88814,qmemIVC5Iuvmt3EwAEmeheRArNgSE4sO,fbPkOYLVPtPgIt0MxizjfFJov3JbHyAi,1,0,0,0,0,0,1,0,1,0.14285714285714285,1,0.0,0,0,0,0,0,0,0,1,0,0,1,1
3948,88815,Ryj9SYlTY2129nyufOPixA9oPGYhqvjh,fbPkOYLVPtPgIt0MxizjfFJov3JbHyAi,4,3,1,0,1,0,3,0,8,1.1428571428571428,2,0.0,0,1,0,1,3,0,0,3,0,2,6,1
3949,88818,89WrqZK2Q73BIEUqNtaalkZbdJCLDFwZ,fbPkOYLVPtPgIt0MxizjfFJov3JbHyAi,8,4,2,0,1,3,6,1,17,2.4285714285714284,2,0.0,0,2,0,1,4,3,0,6,1,3,14,1
3950,88820,FwTErVkZ5KG64sGBwGPbKk9gM0cwQPh1,fbPkOYLVPtPgIt0MxizjfFJov3JbHyAi,10,7,5,0,4,8,6,1,31,4.428571428571429,1,0.0,0,5,0,4,7,8,0,6,1,9,22,1
3951,88821,p4bpHXDCH4ga8oV8ZqbH95nJI7VYCp8t,fbPkOYLVPtPgIt0MxizjfFJov3JbHyAi,1,0,0,0,0,0,1,0,1,0.14285714285714285,1,0.0,0,0,0,0,0,0,0,1,0,0,1,1
3952,88822,4hbcS1XH6kSybbsyz7K3CYFhB00MIUIr,fbPkOYLVPtPgIt0MxizjfFJov3JbHyAi,6,6,2,0,3,0,1,0,12,1.7142857142857142,1,0.0,3,2,0,3,3,0,0,1,0,8,4,1
3953,88823,AyhJARh0xhxObM9zhvUdDxlTCtu309eW,fbPkOYLVPtPgIt0MxizjfFJov3JbHyAi,8,7,4,0,3,27,5,0,46,6.571428571428571,3,0.0,0,4,0,3,7,27,0,5,0,7,39,1
3954,88824,mc7ReRohr0aHl54443zTpOlq1o12BqN6,fbPkOYLVPtPgIt0MxizjfFJov3JbHyAi,1,0,0,0,0,0,1,0,1,0.14285714285714285,1,0.0,0,0,0,0,0,0,0,1,0,0,1,1
3955,88825,SO7BGTzNf50pHLqWJC7Isbkuvs1iCvSw,fbPkOYLVPtPgIt0MxizjfFJov3JbHyAi,11,8,5,0,3,7,3,1,27,3.857142857142857,1,0.0,1,5,0,3,7,7,0,3,1,9,18,1
3956,88826,FHVGisAeAJdUWbqdfGOX1SqwMTNsn4Sl,fbPkOYLVPtPgIt0MxizjfFJov3JbHyAi,6,1,1,0,1,0,3,0,6,0.8571428571428571,1,0.0,0,1,0,1,1,0,0,3,0,2,4,1
3957,88828,D4QcA7podzZXBTfof4ESNtLtgPKFTty3,fbPkOYLVPtPgIt0MxizjfFJov3JbHyAi,7,2,1,0,1,8,6,1,19,2.7142857142857144,1,0.0,0,1,0,1,2,8,0,6,1,2,17,1
3958,88832,xLVZrHAd2rcd4gjL2AH8LHStjVOxoTXH,fbPkOYLVPtPgIt0MxizjfFJov3JbHyAi,6,3,2,0,2,0,1,0,8,1.1428571428571428,1,0.0,0,2,0,2,3,0,0,1,0,4,4,1
3959,88833,eOxm8XEI11Xs6eiBi1Nu5QzIagZXwEm9,fbPkOYLVPtPgIt0MxizjfFJov3JbHyAi,7,4,2,0,2,8,3,0,19,2.7142857142857144,2,0.0,1,2,0,2,3,8,0,3,0,5,14,1
3960,88834,UPCBTwptJrhgu4vesm7VG1r09OOWFZ8M,fbPkOYLVPtPgIt0MxizjfFJov3JbHyAi,2,0,0,0,0,0,3,0,3,0.42857142857142855,1,0.0,0,0,0,0,0,0,0,3,0,0,3,1
3961,88835,sR0gVqP9THtsGU0nXYxvlPsXuHuYggxR,fbPkOYLVPtPgIt0MxizjfFJov3JbHyAi,8,6,2,2,2,0,4,0,16,2.2857142857142856,1,0.0,2,2,2,2,4,0,0,4,0,8,8,1
3962,88837,QkdU1z3YFvdeUK9lKehYyofsDutrm196,fbPkOYLVPtPgIt0MxizjfFJov3JbHyAi,6,4,2,0,2,0,1,0,9,1.2857142857142858,1,0.0,0,2,0,2,4,0,0,1,0,4,5,1
3963,88838,gVqypDd1b5rP0VnVbrsZj4FDK81Xew1Y,fbPkOYLVPtPgIt0MxizjfFJov3JbHyAi,4,2,1,0,1,0,1,0,5,0.7142857142857143,1,0.0,0,1,0,1,2,0,0,1,0,2,3,1
3964,88839,iKVtXLZY6XC1Ozhvwt3XfCzLYHoRf4Le,fbPkOYLVPtPgIt0MxizjfFJov3JbHyAi,5,1,1,0,1,0,2,0,5,0.7142857142857143,1,0.0,0,1,0,1,1,0,0,2,0,2,3,1
3965,88840,Sbvsuo19O2SfThVQR8m11L1fIHdeUt20,fbPkOYLVPtPgIt0MxizjfFJov3JbHyAi,9,8,4,0,2,2,8,1,25,3.5714285714285716,2,0.0,0,4,0,2,8,2,0,8,1,6,19,1
3966,88841,sXHmxCYzWKnOBp4g0oDOkoNrOpYDpt1m,fbPkOYLVPtPgIt0MxizjfFJov3JbHyAi,1,0,0,0,0,0,1,0,1,0.14285714285714285,1,0.0,0,0,0,0,0,0,0,1,0,0,1,1
3967,88843,YkG4vF4KhqibrD50khtgskxo6iKIJC5w,fbPkOYLVPtPgIt0MxizjfFJov3JbHyAi,6,3,2,0,2,0,1,0,8,1.1428571428571428,1,0.0,0,2,0,2,3,0,0,1,0,4,4,1
3968,88846,AqzJls3OFl2nFap48g5Tia0Yo0Y7Cer3,fbPkOYLVPtPgIt0MxizjfFJov3JbHyAi,9,11,4,0,3,1,5,1,25,3.5714285714285716,1,0.0,0,4,0,3,11,1,0,5,1,7,18,1
3969,88847,6mNKW4qOUXPShTxM8cvfepjQFTLv3oOh,fbPkOYLVPtPgIt0MxizjfFJov3JbHyAi,20,20,16,0,16,18,15,1,86,12.285714285714286,1,0.0,2,16,0,16,18,18,0,15,1,34,52,1
3970,88850,d9MkkuCn04Toz7g1JpLdUJWD9xM5braA,fbPkOYLVPtPgIt0MxizjfFJov3JbHyAi,4,3,1,0,1,0,2,0,7,1.0,1,0.0,0,1,0,1,3,0,0,2,0,2,5,1
3971,88851,Gl03eSeNtb7juYcfyy4T6xQkEEhQalIx,fbPkOYLVPtPgIt0MxizjfFJov3JbHyAi,5,5,3,0,2,0,1,0,11,1.5714285714285714,1,0.0,0,3,0,2,5,0,0,1,0,5,6,0
3972,88852,SW8hZER4lRVJxocMEgvR4kXl1NsQnFzy,fbPkOYLVPtPgIt0MxizjfFJov3JbHyAi,6,3,2,0,2,0,1,0,8,1.1428571428571428,1,0.0,0,2,0,2,3,0,0,1,0,4,4,1
3973,88853,zvDqimtTzQDntzI9wqOWSebcIJKnGJ4a,fbPkOYLVPtPgIt0MxizjfFJov3JbHyAi,12,26,3,11,1,16,15,1,73,10.428571428571429,5,0.0,7,3,7,1,19,16,4,15,1,18,55,1
3974,88855,XQ3dYwdsUwJ24fnMOalUTaMPlpgBFmZW,fbPkOYLVPtPgIt0MxizjfFJov3JbHyAi,3,0,0,0,0,1,2,0,3,0.42857142857142855,1,0.0,0,0,0,0,0,1,0,2,0,0,3,1
3975,88856,hluzPB1y7zkKLSSzVkJvXfWNLyDAuRho,fbPkOYLVPtPgIt0MxizjfFJov3JbHyAi,6,4,3,0,3,0,1,0,11,1.5714285714285714,1,0.0,0,3,0,3,4,0,0,1,0,6,5,1
3976,88858,sfQpIAyh1Bl1FfOPcdLy9YBFhdo6RQbA,fbPkOYLVPtPgIt0MxizjfFJov3JbHyAi,2,0,0,0,0,0,4,0,4,0.5714285714285714,1,0.0,0,0,0,0,0,0,0,4,0,0,4,1
3977,88859,JF7rR3pF5cT0hx4XGqF6ShAdIIlqNFHc,fbPkOYLVPtPgIt0MxizjfFJov3JbHyAi,7,3,2,0,2,0,2,0,9,1.2857142857142858,1,0.0,0,2,0,2,3,0,0,2,0,4,5,1
3978,88860,V8o57SeARenbMywXqROBGV5CkdHJLIRM,fbPkOYLVPtPgIt0MxizjfFJov3JbHyAi,3,0,0,0,0,8,4,0,12,1.7142857142857142,1,0.0,0,0,0,0,0,8,0,4,0,0,12,1
3979,89156,vbW1KaPU4HdAU3ExlW7t2Z2lZknONBDo,SpATywNh6bZuzm8s1ceuBUnMUAeoAHHw,1,0,0,0,0,0,1,0,1,0.14285714285714285,1,0.0,0,0,0,0,0,0,0,1,0,0,1,1
3980,89158,4izQXcJwvwmvhdH2eayMFjLqLTND3JLq,SpATywNh6bZuzm8s1ceuBUnMUAeoAHHw,1,0,0,0,0,0,1,0,1,0.14285714285714285,1,0.0,0,0,0,0,0,0,0,1,0,0,1,1
3981,89160,ujTZ8itG5tOi9RBi81LVjGylcfmfscnv,SpATywNh6bZuzm8s1ceuBUnMUAeoAHHw,1,0,0,0,0,0,4,0,4,0.5714285714285714,1,0.0,0,0,0,0,0,0,0,4,0,0,4,1
3982,89176,xe8A48TmWAWrsrOrkKLLF9EL4o5xag4y,SpATywNh6bZuzm8s1ceuBUnMUAeoAHHw,1,0,0,0,0,0,1,0,1,0.14285714285714285,1,0.0,0,0,0,0,0,0,0,1,0,0,1,1
3983,89177,JfoqUtmque7wAjeDp4JXdK1NxfjlSlfN,SpATywNh6bZuzm8s1ceuBUnMUAeoAHHw,1,0,0,0,0,0,1,0,1,0.14285714285714285,1,0.0,0,0,0,0,0,0,0,1,0,0,1,1
3984,89178,mmrzdjNmPvFK53WAh9BwB5yGYUT5HqSe,G8EPVSXsOYB5YQWZGiz1aVq5Pgr2GrQu,1,0,0,0,0,0,1,0,1,0.14285714285714285,1,0.0,0,0,0,0,0,0,0,1,0,0,1,1
3985,89179,byKEl7rjAYN1zOFtYklTCb9GFeYuN4nO,SpATywNh6bZuzm8s1ceuBUnMUAeoAHHw,1,0,0,0,0,0,1,0,1,0.14285714285714285,1,0.0,0,0,0,0,0,0,0,1,0,0,1,1
3986,89180,GWkPEXh9DjC0IZThysIgNjSmYaI9dcS2,G8EPVSXsOYB5YQWZGiz1aVq5Pgr2GrQu,9,2,1,0,1,1,7,1,13,1.8571428571428572,2,0.0,0,1,0,1,2,1,0,7,1,2,11,1
3987,89187,rfOApTbQ4xF2665bHZIBhoJqQcTU6i9L,bWdj2GDclj5ofokWjzoa5jAwMkxCykd6,7,3,2,0,2,0,4,0,11,1.5714285714285714,1,0.0,0,2,0,2,3,0,0,4,0,4,7,1
3988,89189,bJL1sGEdg6Wyh9EeL6PIHUn7Crptl1QG,SpATywNh6bZuzm8s1ceuBUnMUAeoAHHw,2,0,0,0,0,0,2,0,2,0.2857142857142857,1,0.0,0,0,0,0,0,0,0,2,0,0,2,1
3989,89195,htC7O6KmzjLEAd92jccVhN4tDLN92YII,SpATywNh6bZuzm8s1ceuBUnMUAeoAHHw,5,5,0,0,0,0,3,0,8,1.1428571428571428,2,0.0,0,0,0,0,5,0,0,3,0,0,8,1
3990,89205,iHJGDLnoobtpsuLsojTJ7EMK5S6IfRa5,bWdj2GDclj5ofokWjzoa5jAwMkxCykd6,10,7,1,12,2,1,4,0,27,3.857142857142857,1,0.0,1,1,12,2,6,1,0,4,0,16,11,1
3991,89207,Wfpsd6cFXMtD0KyRvLKtWb4mn0MDgPtD,SpATywNh6bZuzm8s1ceuBUnMUAeoAHHw,6,2,0,0,0,2,21,6,31,4.428571428571429,1,0.0,0,0,0,0,2,2,0,21,6,0,31,1
3992,89211,W4anGZ3gUxihb7qbTalaixckN7io0pRJ,RXDvfPUBYFlVdlueBFbLW0mhhAyGEqpt,1,0,0,0,0,0,1,0,1,0.14285714285714285,1,0.0,0,0,0,0,0,0,0,1,0,0,1,1
3993,89213,7ORBOKUOYBR6pt3N4fl6iHTd7mMd3dtL,G8EPVSXsOYB5YQWZGiz1aVq5Pgr2GrQu,5,9,2,0,2,0,2,0,15,2.142857142857143,2,0.0,6,2,0,2,3,0,0,2,0,10,5,1
3994,89216,moK1GdnqoYxhSRCf5a95lgXdVNdzYrjs,bWdj2GDclj5ofokWjzoa5jAwMkxCykd6,6,5,0,0,0,0,9,0,14,2.0,1,0.0,0,0,0,0,5,0,0,9,0,0,14,1
3995,89217,PA2zIjexrl5X42bUhfLaCsans4YmH5zQ,SpATywNh6bZuzm8s1ceuBUnMUAeoAHHw,12,13,4,0,3,2,10,2,34,4.857142857142857,1,0.0,0,4,0,3,13,2,0,10,2,7,27,1
3996,89219,Mqke4gGiYdtmQuFOtXx8ilrWhvfHEVOG,SpATywNh6bZuzm8s1ceuBUnMUAeoAHHw,3,0,0,0,0,1,3,0,4,0.5714285714285714,1,0.0,0,0,0,0,0,1,0,3,0,0,4,1
3997,89222,JmoVlWZppOh9wSlYvcOL4ciU00D3apDg,SpATywNh6bZuzm8s1ceuBUnMUAeoAHHw,3,2,0,0,0,0,4,0,6,0.8571428571428571,1,0.0,0,0,0,0,2,0,0,4,0,0,6,1
3998,89235,d4cb9OZbLbDBqzuhcJemwCaulhBw3XcA,bWdj2GDclj5ofokWjzoa5jAwMkxCykd6,18,19,7,44,7,4,7,0,88,12.571428571428571,1,0.0,10,7,37,7,9,4,7,7,0,61,27,1
3999,89242,hjUSUM6roI2mLGkMAqBjE0uxFRBSMYHJ,bWdj2GDclj5ofokWjzoa5jAwMkxCykd6,6,3,2,0,2,0,1,0,8,1.1428571428571428,1,0.0,0,2,0,2,3,0,0,1,0,4,4,1
4000,89249,YjL44X3XqXhDvKRGkgBLHiV9slzcQZGJ,SpATywNh6bZuzm8s1ceuBUnMUAeoAHHw,3,1,0,0,0,0,2,0,3,0.42857142857142855,1,0.0,0,0,0,0,1,0,0,2,0,0,3,1
4001,89252,gleoXCfE3tA6f5uM3pUTeqQbfFckrfVd,bWdj2GDclj5ofokWjzoa5jAwMkxCykd6,1,0,0,0,0,0,1,0,1,0.14285714285714285,1,0.0,0,0,0,0,0,0,0,1,0,0,1,1
4002,89262,qxQtZuyIzQWGcD008dVh3c4jYjIPrn2L,SpATywNh6bZuzm8s1ceuBUnMUAeoAHHw,3,1,0,0,0,0,2,0,3,0.42857142857142855,1,0.0,0,0,0,0,1,0,0,2,0,0,3,1
4003,89265,Hh6CQ9eQF89j5a5Oi2NUf2uAs2DZd4QT,SpATywNh6bZuzm8s1ceuBUnMUAeoAHHw,11,7,4,0,3,0,6,1,21,3.0,1,0.0,0,4,0,3,7,0,0,6,1,7,14,1
4004,89274,gAYHJa3M8crEnYGtoK5ulJH4EjKveQ23,SpATywNh6bZuzm8s1ceuBUnMUAeoAHHw,6,2,0,0,0,0,5,1,8,1.1428571428571428,1,0.0,0,0,0,0,2,0,0,5,1,0,8,1
4005,89275,PEDczBqLWdyMeFUgqqnQ5UtJeB7qq12O,SpATywNh6bZuzm8s1ceuBUnMUAeoAHHw,5,7,4,0,3,0,3,0,17,2.4285714285714284,1,0.0,0,4,0,3,7,0,0,3,0,7,10,1
4006,89286,pMaElq6QfFkzEK9UpuWlI5Z36ojw0yzC,bWdj2GDclj5ofokWjzoa5jAwMkxCykd6,1,0,0,0,0,0,1,0,1,0.14285714285714285,1,0.0,0,0,0,0,0,0,0,1,0,0,1,1
4007,89289,2Rw9LEKgxnu10TYMueqqEJs507ou3OOr,SpATywNh6bZuzm8s1ceuBUnMUAeoAHHw,5,2,0,0,0,2,5,1,10,1.4285714285714286,1,0.0,0,0,0,0,2,2,0,5,1,0,10,1
4008,89297,JYyHN8axXgpHcSLeMA1wyxGi6GgnqXzc,bWdj2GDclj5ofokWjzoa5jAwMkxCykd6,7,2,1,0,0,3,7,2,15,2.142857142857143,1,0.0,0,1,0,0,2,3,0,7,2,1,14,1
4009,89300,ZKwoFbqxmjGUhMeAwrPlEcEnBfnKdvyQ,SpATywNh6bZuzm8s1ceuBUnMUAeoAHHw,3,2,0,0,0,2,2,0,6,0.8571428571428571,1,0.0,0,0,0,0,2,2,0,2,0,0,6,1
4010,89301,Uk2Y8qj9Cf6T7k2O1cxM5Fue4zKTF1K8,SpATywNh6bZuzm8s1ceuBUnMUAeoAHHw,10,16,6,0,3,3,5,1,34,4.857142857142857,2,0.0,1,6,0,3,15,3,0,5,1,10,24,1
4011,89310,bwyEPRDnWmgwxNZP823jR0R0w9PchQI0,bWdj2GDclj5ofokWjzoa5jAwMkxCykd6,11,12,1,16,3,2,5,1,40,5.714285714285714,1,0.0,7,1,16,3,5,2,0,5,1,27,13,1
4012,89315,z8zMi50azvRwAPUNW2f5Gt0F6WOr8PI9,bWdj2GDclj5ofokWjzoa5jAwMkxCykd6,15,9,3,52,2,1,3,1,71,10.142857142857142,1,0.0,5,3,49,2,4,1,3,3,1,59,12,1
4013,89316,VF14jDCwIzSb92Zq60K5zB8BaUbLT4fN,bWdj2GDclj5ofokWjzoa5jAwMkxCykd6,16,31,3,40,4,9,8,1,96,13.714285714285714,3,0.0,7,3,39,4,24,9,1,8,1,53,43,1
4014,89320,EUrAZ23hcKSgGkr8BcxsusY5VGcq8UzJ,G8EPVSXsOYB5YQWZGiz1aVq5Pgr2GrQu,26,35,0,24,3,11,9,0,82,11.714285714285714,1,0.0,17,0,13,3,18,11,11,9,0,33,49,1
4015,89321,hwob5cfANjyVXpPbIwjR9A4IpD8atc3c,SpATywNh6bZuzm8s1ceuBUnMUAeoAHHw,10,8,7,0,5,0,2,0,22,3.142857142857143,1,0.0,0,7,0,5,8,0,0,2,0,12,10,1
4016,89323,JNtIRj6hnKiaMOhcBlcWRjLc0QwYKSxo,SpATywNh6bZuzm8s1ceuBUnMUAeoAHHw,12,9,2,14,1,0,4,0,30,4.285714285714286,1,0.0,2,2,11,1,7,0,3,4,0,16,14,1
4017,89325,8nDAopmFCIj7DcwdoC4rkmpeCk1s8Zgz,SpATywNh6bZuzm8s1ceuBUnMUAeoAHHw,9,8,4,0,3,1,5,1,22,3.142857142857143,2,0.0,1,4,0,3,7,1,0,5,1,8,14,1
4018,89330,HhEzipYCSzqDHvfYzAIj6GLpNqmUDFFt,SpATywNh6bZuzm8s1ceuBUnMUAeoAHHw,1,0,0,0,0,0,11,0,11,1.5714285714285714,1,0.0,0,0,0,0,0,0,0,11,0,0,11,1
4019,89345,g6IxzfRtoY3ZngcwPaZoK8tEiW61b5Gm,SpATywNh6bZuzm8s1ceuBUnMUAeoAHHw,7,2,1,0,1,0,4,2,10,1.4285714285714286,1,0.0,0,1,0,1,2,0,0,4,2,2,8,1
4020,89347,nRVtG0QK38ehOZE61TsAumXFUUbgiwAK,SpATywNh6bZuzm8s1ceuBUnMUAeoAHHw,5,3,0,0,0,0,3,0,6,0.8571428571428571,1,0.0,0,0,0,0,3,0,0,3,0,0,6,1
4021,89353,RMJqhWaieV03GDbDCUCDtD33fHLxVV5K,SpATywNh6bZuzm8s1ceuBUnMUAeoAHHw,14,12,6,10,3,1,3,1,36,5.142857142857143,1,0.0,5,6,9,3,7,1,1,3,1,23,13,1
4022,89354,PmjzDmD1PFYqpmVaelKXEbwbYfZH0pBp,SpATywNh6bZuzm8s1ceuBUnMUAeoAHHw,5,7,4,0,3,0,1,0,15,2.142857142857143,1,0.0,2,4,0,3,5,0,0,1,0,9,6,1
4023,89356,NpZps0g6tawFjKVlcYqueUROYKEoKNaJ,SpATywNh6bZuzm8s1ceuBUnMUAeoAHHw,4,3,1,0,1,0,1,0,6,0.8571428571428571,1,0.0,0,1,0,1,3,0,0,1,0,2,4,1
4024,89360,ZufvgvpRY93M4np3YlRkSzwkfWq82En4,SpATywNh6bZuzm8s1ceuBUnMUAeoAHHw,6,6,2,0,2,1,4,0,15,2.142857142857143,1,0.0,0,2,0,2,6,1,0,4,0,4,11,1
4025,89363,7oeUnzeChzbfg8iPaEKhVywsWn9pqTw6,SpATywNh6bZuzm8s1ceuBUnMUAeoAHHw,5,2,1,0,1,1,2,0,7,1.0,1,0.0,0,1,0,1,2,1,0,2,0,2,5,1
4026,89364,lXYwudRP8Zl9Z938FMhDttVYfWWJ9atj,RXDvfPUBYFlVdlueBFbLW0mhhAyGEqpt,12,13,6,0,3,3,7,0,32,4.571428571428571,2,0.0,3,6,0,3,10,3,0,7,0,12,20,1
4027,89365,LslskpvRu2kdJKdLBrkhLUwON3Gy18Vo,SpATywNh6bZuzm8s1ceuBUnMUAeoAHHw,7,4,3,0,3,0,4,0,14,2.0,2,0.0,0,3,0,3,4,0,0,4,0,6,8,1
4028,89368,Hut1tgueSKPspzugaIR7MA7bHeQEJ3sN,SpATywNh6bZuzm8s1ceuBUnMUAeoAHHw,11,7,5,0,3,2,5,1,23,3.2857142857142856,1,0.0,0,5,0,3,7,2,0,5,1,8,15,1
4029,89374,WJOBtEN6MBmL5RAy18uZScmCw5QHqH7o,bWdj2GDclj5ofokWjzoa5jAwMkxCykd6,7,9,5,32,1,0,2,0,49,7.0,1,0.0,1,5,31,1,8,0,1,2,0,38,11,1
4030,89376,x7a8xZCwJM4RqKXg6G5neepAYFOs6m5d,SpATywNh6bZuzm8s1ceuBUnMUAeoAHHw,7,3,1,0,1,1,4,1,11,1.5714285714285714,1,0.0,0,1,0,1,3,1,0,4,1,2,9,1
4031,89378,z8zMi50azvRwAPUNW2f5Gt0F6WOr8PI9,SpATywNh6bZuzm8s1ceuBUnMUAeoAHHw,7,6,2,0,1,0,2,0,11,1.5714285714285714,2,0.0,0,2,0,1,6,0,0,2,0,3,8,1
4032,89382,tEjzvvLPWnUBzeg9eUEbSbUDxKXRjQIx,SpATywNh6bZuzm8s1ceuBUnMUAeoAHHw,8,6,1,0,1,3,4,1,16,2.2857142857142856,1,0.0,0,1,0,1,6,3,0,4,1,2,14,1
4033,89384,IE6kqz4SgQ2K5IXq1ddIKWqjAvkWjxXn,SpATywNh6bZuzm8s1ceuBUnMUAeoAHHw,3,0,0,0,0,1,3,0,4,0.5714285714285714,1,0.0,0,0,0,0,0,1,0,3,0,0,4,1
4034,89389,YcgF3ndOhv1gz5wV43GDFwEO3v9Db2WY,SpATywNh6bZuzm8s1ceuBUnMUAeoAHHw,1,0,0,0,0,0,1,0,1,0.14285714285714285,1,0.0,0,0,0,0,0,0,0,1,0,0,1,1
4035,89392,zHLtAdps4GmYQ36wgo6nLPWMewImtEPP,SpATywNh6bZuzm8s1ceuBUnMUAeoAHHw,5,3,1,0,1,0,2,0,7,1.0,1,0.0,0,1,0,1,3,0,0,2,0,2,5,1
4036,89396,6xizGBxRpzCQSAXaR3hwOv1SoAXsZCKh,SpATywNh6bZuzm8s1ceuBUnMUAeoAHHw,7,1,1,0,1,0,7,1,11,1.5714285714285714,1,0.0,0,1,0,1,1,0,0,7,1,2,9,1
4037,89400,21PiP1YhF59KyQpWQkFYKWspSiSWfrA7,SpATywNh6bZuzm8s1ceuBUnMUAeoAHHw,4,2,0,0,0,0,2,0,4,0.5714285714285714,1,0.0,0,0,0,0,2,0,0,2,0,0,4,1
4038,89402,HG2LtxlWFsBhMuK56mWZ91TjbhMLoylz,SpATywNh6bZuzm8s1ceuBUnMUAeoAHHw,12,18,4,15,3,0,2,0,42,6.0,1,0.0,13,4,12,3,5,0,3,2,0,32,10,0
4039,89409,4OTqFMCZxx7r7u5a2qYtSI5NaNF7PvO8,SpATywNh6bZuzm8s1ceuBUnMUAeoAHHw,16,17,5,14,3,3,6,1,49,7.0,2,0.0,8,5,14,3,9,3,0,6,1,30,19,1
4040,89416,X8YK3vveOwnCTAS3rpB58DG3aostwJaj,SpATywNh6bZuzm8s1ceuBUnMUAeoAHHw,5,2,1,0,1,0,2,0,6,0.8571428571428571,1,0.0,0,1,0,1,2,0,0,2,0,2,4,1
4041,89419,s6NTLcoRryN4aDfvO1qsCQXhze6kEfOl,RXDvfPUBYFlVdlueBFbLW0mhhAyGEqpt,5,0,0,0,0,1,4,2,7,1.0,1,0.0,0,0,0,0,0,1,0,4,2,0,7,1
4042,89422,YjEaFn5LTfYqjxB6JXUvw4Xb9oLhK631,SpATywNh6bZuzm8s1ceuBUnMUAeoAHHw,1,0,0,0,0,0,1,0,1,0.14285714285714285,1,0.0,0,0,0,0,0,0,0,1,0,0,1,1
4043,89427,tMCbE9iM7KBcWjBabYSS51NRc5mnYleA,SpATywNh6bZuzm8s1ceuBUnMUAeoAHHw,4,3,1,0,1,0,1,0,6,0.8571428571428571,1,0.0,0,1,0,1,3,0,0,1,0,2,4,1
4044,89428,7rCsWwNSyvtkrQ3mC6RRhvkE6QVhgAZs,bWdj2GDclj5ofokWjzoa5jAwMkxCykd6,2,0,0,0,0,0,2,0,2,0.2857142857142857,1,0.0,0,0,0,0,0,0,0,2,0,0,2,1
4045,89429,2lYbk0XOrmGdaeqlfLI5dUfAHuZ6yPBA,SpATywNh6bZuzm8s1ceuBUnMUAeoAHHw,2,0,0,0,0,0,2,0,2,0.2857142857142857,1,0.0,0,0,0,0,0,0,0,2,0,0,2,1
4046,89431,nYSFDE8RCbcZhD46fRSvPHUvA1ahfupi,RXDvfPUBYFlVdlueBFbLW0mhhAyGEqpt,7,6,5,0,3,0,2,0,16,2.2857142857142856,1,0.0,0,5,0,3,6,0,0,2,0,8,8,1
4047,89434,w60ThqGBllezQkIxCXQKmVVjrEAbCB3o,SpATywNh6bZuzm8s1ceuBUnMUAeoAHHw,13,12,8,0,4,1,11,1,37,5.285714285714286,1,0.0,1,8,0,4,11,1,0,11,1,13,24,1
4048,89435,mXql2iQ0u9MrfhDk3EyQfVgmOA6PfBP6,SpATywNh6bZuzm8s1ceuBUnMUAeoAHHw,9,5,4,0,3,0,3,1,16,2.2857142857142856,1,0.0,0,4,0,3,5,0,0,3,1,7,9,1
4049,89437,JaihKxZ9pTOfses6LZRLDOjCYawYvRFT,SpATywNh6bZuzm8s1ceuBUnMUAeoAHHw,15,14,2,6,1,1,6,1,31,4.428571428571429,1,0.0,6,2,6,1,8,1,0,6,1,15,16,1
4050,89438,KogrHROquIJLSXIZqzhYU9Hcb9zVebwT,bWdj2GDclj5ofokWjzoa5jAwMkxCykd6,12,15,8,38,2,7,8,1,79,11.285714285714286,1,0.0,1,8,37,2,14,7,1,8,1,48,31,1
4051,89439,GmpxJ8O1By2XxJiRtr729hGN3Vo5Le6z,SpATywNh6bZuzm8s1ceuBUnMUAeoAHHw,7,3,0,0,0,0,5,1,9,1.2857142857142858,1,0.0,1,0,0,0,2,0,0,5,1,1,8,1
4052,89445,QB10zfXuA41QjD5k4oKWFSxMld8hOlzr,SpATywNh6bZuzm8s1ceuBUnMUAeoAHHw,5,10,1,0,1,0,1,0,13,1.8571428571428572,1,0.0,0,1,0,1,10,0,0,1,0,2,11,1
4053,89447,reyLh94O0G9Sps1AWVf0MNOYDY3UabsF,bWdj2GDclj5ofokWjzoa5jAwMkxCykd6,1,0,0,0,0,0,1,0,1,0.14285714285714285,1,0.0,0,0,0,0,0,0,0,1,0,0,1,1
4054,89464,k7IDe0FSSJNcEAsxSZDCYYdSJ9TEDema,SpATywNh6bZuzm8s1ceuBUnMUAeoAHHw,5,2,1,0,1,0,2,0,6,0.8571428571428571,1,0.0,0,1,0,1,2,0,0,2,0,2,4,1
4055,89470,vEKYOhRdGZ59kfXY6wTO63YZY4EqPYqX,RXDvfPUBYFlVdlueBFbLW0mhhAyGEqpt,8,4,3,0,2,0,2,0,11,1.5714285714285714,1,0.0,0,3,0,2,4,0,0,2,0,5,6,1
4056,89472,hA0qeCFHNAYT25Zfkgax8xO422WWYXAI,SpATywNh6bZuzm8s1ceuBUnMUAeoAHHw,9,7,0,0,0,6,5,0,18,2.5714285714285716,1,0.0,1,0,0,0,6,6,0,5,0,1,17,1
4057,89481,KUppVPuFnFs0vLCUrPJOIfquMy1mUooq,SpATywNh6bZuzm8s1ceuBUnMUAeoAHHw,3,2,1,0,0,0,1,0,4,0.5714285714285714,1,0.0,0,1,0,0,2,0,0,1,0,1,3,1
4058,89484,tWsedvadboRaUvtnR4XHAbkrBvCaHSP7,SpATywNh6bZuzm8s1ceuBUnMUAeoAHHw,5,2,1,0,1,0,2,0,6,0.8571428571428571,1,0.0,0,1,0,1,2,0,0,2,0,2,4,1
4059,89486,ALqQPup1pnpnyRPY8Wn9arGTMiZcUqbO,SpATywNh6bZuzm8s1ceuBUnMUAeoAHHw,12,7,0,3,0,2,6,0,18,2.5714285714285716,1,0.0,2,0,3,0,5,2,0,6,0,5,13,1
4060,89487,C4jo9SMfYZ7U2XGeGdDn52kX4eeoqM99,bWdj2GDclj5ofokWjzoa5jAwMkxCykd6,13,17,0,36,0,1,7,0,61,8.714285714285714,3,0.0,4,0,30,0,13,1,6,7,0,34,27,1
4061,89493,KMupQNOY5AUo1OSHinupraqdnIAkZaUk,SpATywNh6bZuzm8s1ceuBUnMUAeoAHHw,11,8,5,0,3,2,3,0,21,3.0,1,0.0,2,5,0,3,6,2,0,3,0,10,11,0
4062,89496,9HuS6eeLBJKMWQs5fuvJufNrciBPiV4Z,SpATywNh6bZuzm8s1ceuBUnMUAeoAHHw,14,16,9,4,5,0,6,3,43,6.142857142857143,2,0.0,1,9,4,5,15,0,0,6,3,19,24,1
4063,89497,DoqTCfzI1BFXttxyeA3RWI5TOmYLp0hg,SpATywNh6bZuzm8s1ceuBUnMUAeoAHHw,6,5,0,0,0,1,6,1,13,1.8571428571428572,2,0.0,0,0,0,0,5,1,0,6,1,0,13,1
4064,89501,iIVb1PSNqRo7ycAAOFHU9Md1pZ0vCsoL,RXDvfPUBYFlVdlueBFbLW0mhhAyGEqpt,10,7,4,0,2,8,6,1,28,4.0,2,0.0,0,4,0,2,7,8,0,6,1,6,22,1
4065,89502,mR9Awu9GGhq6cpZDsN1vhsOMBBjHJTwu,SpATywNh6bZuzm8s1ceuBUnMUAeoAHHw,2,0,0,0,0,0,2,0,2,0.2857142857142857,1,0.0,0,0,0,0,0,0,0,2,0,0,2,1
4066,89504,g8m22R7W0Wo8v9RXY0TMbj5qf5RFgvht,SpATywNh6bZuzm8s1ceuBUnMUAeoAHHw,7,10,8,0,5,0,3,0,26,3.7142857142857144,2,0.0,0,8,0,5,10,0,0,3,0,13,13,1
4067,89508,IK3hKesiTuTek37MSwSLzKRB4SC1WHUB,RXDvfPUBYFlVdlueBFbLW0mhhAyGEqpt,8,2,2,0,2,12,6,0,24,3.4285714285714284,1,0.0,0,2,0,2,2,12,0,6,0,4,20,1
4068,89510,HlbAiahvOwKnLbpNJlRLXObPS8VUYp1d,SpATywNh6bZuzm8s1ceuBUnMUAeoAHHw,4,4,2,0,2,0,2,0,10,1.4285714285714286,1,0.0,0,2,0,2,4,0,0,2,0,4,6,1
4069,89523,uufMRz1rjLB5PHuvCFtrRWUteDYIyLB4,SpATywNh6bZuzm8s1ceuBUnMUAeoAHHw,7,10,4,0,4,0,8,0,26,3.7142857142857144,5,0.0,1,4,0,4,9,0,0,8,0,9,17,1
4070,89528,UUMX1CmSolRdRWNSlMStbZ6MtOKuPj1e,bWdj2GDclj5ofokWjzoa5jAwMkxCykd6,5,2,1,0,1,0,3,0,7,1.0,1,0.0,0,1,0,1,2,0,0,3,0,2,5,0
4071,89530,wIoFAWs9LgckZlTBThLS4htxmELqPsaS,SpATywNh6bZuzm8s1ceuBUnMUAeoAHHw,2,0,0,0,0,0,2,0,2,0.2857142857142857,1,0.0,0,0,0,0,0,0,0,2,0,0,2,1
4072,89537,KMupQNOY5AUo1OSHinupraqdnIAkZaUk,bWdj2GDclj5ofokWjzoa5jAwMkxCykd6,5,2,1,0,1,2,2,0,8,1.1428571428571428,1,0.0,0,1,0,1,2,2,0,2,0,2,6,1
4073,89545,gbYUHxxKDGWDbytDUcXlcbADJemufrHf,bWdj2GDclj5ofokWjzoa5jAwMkxCykd6,1,0,0,0,0,0,1,0,1,0.14285714285714285,1,0.0,0,0,0,0,0,0,0,1,0,0,1,1
4074,89547,yiyWtvIUUgzCTrQ1w4vh6W1sUUxvDdmd,G8EPVSXsOYB5YQWZGiz1aVq5Pgr2GrQu,16,22,8,6,4,0,6,1,47,6.714285714285714,2,0.0,7,8,3,4,15,0,3,6,1,22,25,1
4075,89554,ywVRX55s8qrIIZjyxsYaBHsGW40qS7zt,SpATywNh6bZuzm8s1ceuBUnMUAeoAHHw,8,5,2,5,1,0,2,0,15,2.142857142857143,1,0.0,1,2,4,1,4,0,1,2,0,8,7,1
4076,89558,s4xNNQ4RZ35amMfmvZawsu7u8CabnIey,bWdj2GDclj5ofokWjzoa5jAwMkxCykd6,13,14,8,0,7,1,8,1,39,5.571428571428571,1,0.0,2,8,0,7,12,1,0,8,1,17,22,1
4077,89559,0wpgF8T87E4lIPjqoh0AkxyomANfbalw,bWdj2GDclj5ofokWjzoa5jAwMkxCykd6,6,4,2,0,2,0,1,0,9,1.2857142857142858,1,0.0,1,2,0,2,3,0,0,1,0,5,4,1
4078,89564,CywE8FKIbY3F3QxzorcpvAYCApeOH4J5,SpATywNh6bZuzm8s1ceuBUnMUAeoAHHw,16,29,14,26,7,6,9,1,92,13.142857142857142,2,0.0,8,14,20,7,21,6,6,9,1,49,43,1
4079,89573,EJIkk1z1GAyTxouBU8smmsjhIBwzBhn1,bWdj2GDclj5ofokWjzoa5jAwMkxCykd6,5,2,0,0,0,1,6,0,9,1.2857142857142858,1,0.0,0,0,0,0,2,1,0,6,0,0,9,1
4080,89582,IVRKzAf1gWN5ButpaPiczzsxf6iD5MK8,SpATywNh6bZuzm8s1ceuBUnMUAeoAHHw,15,22,13,9,8,2,9,0,63,9.0,3,0.0,3,13,9,8,19,2,0,9,0,33,30,0
4081,89585,YyGQMZcaxlC6XILTwFAL9ZoWRvDQm7bN,SpATywNh6bZuzm8s1ceuBUnMUAeoAHHw,15,8,4,17,3,111,7,1,151,21.571428571428573,1,0.0,3,4,14,3,5,111,3,7,1,24,127,1
4082,89586,Ici19IlriqXgCDQhlI7Y7CIAQZwpQKlL,SpATywNh6bZuzm8s1ceuBUnMUAeoAHHw,6,2,1,0,1,0,3,0,7,1.0,1,0.0,0,1,0,1,2,0,0,3,0,2,5,1
4083,89594,8lejIyIXg2PoIErIyQIUo4voWGcEGVK1,SpATywNh6bZuzm8s1ceuBUnMUAeoAHHw,14,25,9,19,3,1,3,0,60,8.571428571428571,1,0.0,6,9,16,3,19,1,3,3,0,34,26,1
4084,89596,xfVSAJmUsFwMX0mM4lQFC1xlBJimN3Sw,SpATywNh6bZuzm8s1ceuBUnMUAeoAHHw,1,0,0,0,0,0,1,0,1,0.14285714285714285,1,0.0,0,0,0,0,0,0,0,1,0,0,1,1
4085,89600,JV9PrSM2vjuxfGaaWBES6jKK96YmYbtj,SpATywNh6bZuzm8s1ceuBUnMUAeoAHHw,13,11,4,16,3,1,2,0,37,5.285714285714286,1,0.0,6,4,16,3,5,1,0,2,0,29,8,1
4086,89605,f3LgSSewSBsudoWmIigH2aapqGCxH8CK,SpATywNh6bZuzm8s1ceuBUnMUAeoAHHw,8,6,2,8,0,0,3,0,19,2.7142857142857144,2,0.0,1,2,7,0,5,0,1,3,0,10,9,0
4087,89606,QUiyBd2SaZz1OhTujJnVJUzpOWStKB8O,SpATywNh6bZuzm8s1ceuBUnMUAeoAHHw,11,14,7,0,2,2,10,0,35,5.0,2,0.0,3,7,0,2,11,2,0,10,0,12,23,1
4088,89611,oD0FQQV2wqYt3501tltDa6pobGqWwl0U,SpATywNh6bZuzm8s1ceuBUnMUAeoAHHw,2,0,0,0,0,0,2,0,2,0.2857142857142857,1,0.0,0,0,0,0,0,0,0,2,0,0,2,1
4089,89613,TrrLeSGbjOK3szupk5Bxq1KXuDNAsaBR,RXDvfPUBYFlVdlueBFbLW0mhhAyGEqpt,4,0,0,0,0,4,5,0,9,1.2857142857142858,1,0.0,0,0,0,0,0,4,0,5,0,0,9,1
4090,89614,v2d7e1ThXhvKY81XABSzKd6OtFeJV4cC,bWdj2GDclj5ofokWjzoa5jAwMkxCykd6,16,23,8,44,6,0,5,0,86,12.285714285714286,2,0.0,10,8,38,6,13,0,6,5,0,62,24,1
4091,89615,0Dihh52qSGvY4VErU5EvQUZatVGQEN7V,G8EPVSXsOYB5YQWZGiz1aVq5Pgr2GrQu,2,0,0,0,0,0,2,0,2,0.2857142857142857,1,0.0,0,0,0,0,0,0,0,2,0,0,2,1
4092,89629,yd5TT5oOy4dFZZMQ0jlppRbBYPk2zugf,RXDvfPUBYFlVdlueBFbLW0mhhAyGEqpt,34,40,26,34,12,29,15,4,160,22.857142857142858,3,0.0,6,26,31,12,34,29,3,15,4,75,85,1
4093,89632,fGUxtqzvs60cjlG1FT6OPrGFHTQ3arMq,SpATywNh6bZuzm8s1ceuBUnMUAeoAHHw,9,9,4,0,2,0,3,0,18,2.5714285714285716,2,0.0,0,4,0,2,9,0,0,3,0,6,12,1
4094,89633,NecHXZoXWlSlvFR2HUgkuO9YtJstZDyP,SpATywNh6bZuzm8s1ceuBUnMUAeoAHHw,2,0,0,0,0,0,3,0,3,0.42857142857142855,1,0.0,0,0,0,0,0,0,0,3,0,0,3,1
4095,89635,q0VUQjNPG110NUbSYiiAeb8QmfsAGRIl,bWdj2GDclj5ofokWjzoa5jAwMkxCykd6,2,0,0,0,0,0,2,0,2,0.2857142857142857,1,0.0,0,0,0,0,0,0,0,2,0,0,2,1
4096,89637,9FULiZu6qUnuIs2MyDSoVO8NHl3dw8Ao,SpATywNh6bZuzm8s1ceuBUnMUAeoAHHw,16,28,2,12,1,16,12,3,74,10.571428571428571,2,0.0,6,2,12,1,22,16,0,12,3,21,53,1
4097,89639,NecHXZoXWlSlvFR2HUgkuO9YtJstZDyP,G8EPVSXsOYB5YQWZGiz1aVq5Pgr2GrQu,1,0,0,0,0,0,1,0,1,0.14285714285714285,1,0.0,0,0,0,0,0,0,0,1,0,0,1,1
4098,89640,4rTxfdVJbNfbAtIV373iaao2aWX8Xwpx,bWdj2GDclj5ofokWjzoa5jAwMkxCykd6,11,16,4,0,3,1,10,1,35,5.0,1,0.0,2,4,0,3,14,1,0,10,1,9,26,1
4099,89642,tZzxdl7066iNcnLGeU4cT9rDUqFLgEBx,SpATywNh6bZuzm8s1ceuBUnMUAeoAHHw,5,2,1,0,1,0,2,0,6,0.8571428571428571,1,0.0,0,1,0,1,2,0,0,2,0,2,4,0
4100,89646,JEelEWgHt6PkTjt88tREqKMfbXr9CA9f,SpATywNh6bZuzm8s1ceuBUnMUAeoAHHw,5,3,1,0,1,0,2,0,7,1.0,1,0.0,0,1,0,1,3,0,0,2,0,2,5,1
4101,89648,et0FwkFflO62QJKGJwzwDqACodcSRV2v,SpATywNh6bZuzm8s1ceuBUnMUAeoAHHw,15,42,18,7,10,0,6,0,83,11.857142857142858,3,0.0,11,18,7,10,31,0,0,6,0,46,37,1
4102,89651,4qM7n65VbCTp8lq3dbzhDmImmEZcwgn8,bWdj2GDclj5ofokWjzoa5jAwMkxCykd6,5,5,1,0,1,0,2,0,9,1.2857142857142858,2,0.0,0,1,0,1,5,0,0,2,0,2,7,1
4103,89652,g8m22R7W0Wo8v9RXY0TMbj5qf5RFgvht,G8EPVSXsOYB5YQWZGiz1aVq5Pgr2GrQu,7,3,2,0,2,0,3,0,10,1.4285714285714286,1,0.0,0,2,0,2,3,0,0,3,0,4,6,1
4104,89654,q0VUQjNPG110NUbSYiiAeb8QmfsAGRIl,SpATywNh6bZuzm8s1ceuBUnMUAeoAHHw,5,2,1,0,1,0,2,0,6,0.8571428571428571,1,0.0,0,1,0,1,2,0,0,2,0,2,4,1
4105,89657,d1q0By7DZyiPLgwuG8hyGXtu0NW1hfAc,SpATywNh6bZuzm8s1ceuBUnMUAeoAHHw,8,8,5,0,2,0,3,0,18,2.5714285714285716,1,0.0,0,5,0,2,8,0,0,3,0,7,11,1
4106,89660,gGywHgGU1Kdw7XJcqMzinsJnpz7uSgex,SpATywNh6bZuzm8s1ceuBUnMUAeoAHHw,3,2,0,0,0,0,2,0,4,0.5714285714285714,1,0.0,0,0,0,0,2,0,0,2,0,0,4,1
4107,89663,7plKTmv3RnLOGLbgKBn60EIAr1uLnnPW,SpATywNh6bZuzm8s1ceuBUnMUAeoAHHw,2,0,0,0,0,0,3,0,3,0.42857142857142855,1,0.0,0,0,0,0,0,0,0,3,0,0,3,1
4108,89665,7plKTmv3RnLOGLbgKBn60EIAr1uLnnPW,G8EPVSXsOYB5YQWZGiz1aVq5Pgr2GrQu,2,0,0,0,0,0,7,0,7,1.0,1,0.0,0,0,0,0,0,0,0,7,0,0,7,1
4109,89667,4ZJIc9fpxQVSj3UgQJHtkAvW8OVkOdgO,SpATywNh6bZuzm8s1ceuBUnMUAeoAHHw,1,0,0,0,0,0,1,0,1,0.14285714285714285,1,0.0,0,0,0,0,0,0,0,1,0,0,1,1
4110,89669,tmmvczbZLiPw6t5Ru9DTWRYnvMI3hKxN,G8EPVSXsOYB5YQWZGiz1aVq5Pgr2GrQu,7,6,4,0,3,0,2,0,15,2.142857142857143,1,0.0,0,4,0,3,6,0,0,2,0,7,8,1
4111,89672,Sqgk0iqdEQnGHvbbLSikGrUMP9U33RaR,SpATywNh6bZuzm8s1ceuBUnMUAeoAHHw,1,0,0,0,0,0,1,0,1,0.14285714285714285,1,0.0,0,0,0,0,0,0,0,1,0,0,1,1
4112,89682,VCrlTy1l4SI8aDl63osChvBColRWsjDv,bWdj2GDclj5ofokWjzoa5jAwMkxCykd6,4,2,1,0,1,6,2,0,12,1.7142857142857142,1,0.0,0,1,0,1,2,6,0,2,0,2,10,1
4113,89685,hAdLjCwSiW0mQdl44dFfRTVxdDqDmjKC,SpATywNh6bZuzm8s1ceuBUnMUAeoAHHw,7,4,3,0,1,0,2,0,10,1.4285714285714286,1,0.0,0,3,0,1,4,0,0,2,0,4,6,1
4114,89691,iADIVtxyoQg4RtIKmWkz3YbJ1msvN2b8,G8EPVSXsOYB5YQWZGiz1aVq5Pgr2GrQu,28,26,14,38,9,0,3,0,90,12.857142857142858,1,0.0,8,14,38,9,18,0,0,3,0,69,21,1
4115,89697,i4fgy4BVHlpEBMVrUkI9gWLihOonqgFN,SpATywNh6bZuzm8s1ceuBUnMUAeoAHHw,8,9,5,0,2,0,6,0,22,3.142857142857143,2,0.0,0,5,0,2,9,0,0,6,0,7,15,1
4116,89700,5c8lpFjwt7A1RG96ZJudxhytTaQ1Rdi3,SpATywNh6bZuzm8s1ceuBUnMUAeoAHHw,9,4,3,0,2,0,3,0,12,1.7142857142857142,1,0.0,0,3,0,2,4,0,0,3,0,5,7,1
4117,89704,EFvdBUP19hneCSDaGOnsFiBemnNxo1wC,SpATywNh6bZuzm8s1ceuBUnMUAeoAHHw,5,2,0,0,0,3,4,0,9,1.2857142857142858,1,0.0,0,0,0,0,2,3,0,4,0,0,9,1
4118,89716,34wvjhwjZXp59iVLK73uLxzWNB5SDXqZ,SpATywNh6bZuzm8s1ceuBUnMUAeoAHHw,1,0,0,0,0,0,1,0,1,0.14285714285714285,1,0.0,0,0,0,0,0,0,0,1,0,0,1,1
4119,89718,gJUEUQ7J006sORAArhI6J8FkT7xUEHkB,SpATywNh6bZuzm8s1ceuBUnMUAeoAHHw,12,23,0,18,0,6,4,1,52,7.428571428571429,1,0.0,8,0,16,0,15,6,2,4,1,24,28,1
4120,89721,Y1k7olzlKnbC2gLcfIeH2MYAVraORisd,SpATywNh6bZuzm8s1ceuBUnMUAeoAHHw,7,3,2,0,2,0,2,0,9,1.2857142857142858,1,0.0,0,2,0,2,3,0,0,2,0,4,5,1
4121,89727,8yrIKDtnkYcLfERwrXrvcRGxHxbt2Jd3,bWdj2GDclj5ofokWjzoa5jAwMkxCykd6,5,5,2,0,1,0,4,0,12,1.7142857142857142,1,0.0,0,2,0,1,5,0,0,4,0,3,9,1
4122,89728,XzytXRsbdOwF87AfAw5uPYzo1dbeIXdh,SpATywNh6bZuzm8s1ceuBUnMUAeoAHHw,11,10,8,0,2,1,6,1,28,4.0,1,0.0,0,8,0,2,10,1,0,6,1,10,18,1
4123,89730,lVnMpRF2pBRLkh9CfasNC1eZi18lrTad,G8EPVSXsOYB5YQWZGiz1aVq5Pgr2GrQu,7,4,3,0,3,0,2,0,12,1.7142857142857142,1,0.0,0,3,0,3,4,0,0,2,0,6,6,1
4124,89735,DBl87nF6WTgoCD6kgTHVE2oB45pDEn6y,RXDvfPUBYFlVdlueBFbLW0mhhAyGEqpt,10,8,4,0,2,0,2,0,16,2.2857142857142856,1,0.0,0,4,0,2,8,0,0,2,0,6,10,1
4125,89736,bRDMid9iRGcartTY4OAKAdQRbX2j8Y86,SpATywNh6bZuzm8s1ceuBUnMUAeoAHHw,5,2,1,0,1,0,2,0,6,0.8571428571428571,1,0.0,0,1,0,1,2,0,0,2,0,2,4,1
4126,89737,Fa7tOqP1WKllvNDMgvUWmTzPr8J8vhy8,bWdj2GDclj5ofokWjzoa5jAwMkxCykd6,4,2,1,0,0,0,3,0,6,0.8571428571428571,1,0.0,0,1,0,0,2,0,0,3,0,1,5,1
4127,89741,4TxI4qNPs1w5xlNJ8vKBNEb6bFI5MoVU,SpATywNh6bZuzm8s1ceuBUnMUAeoAHHw,3,2,0,0,0,0,1,0,3,0.42857142857142855,1,0.0,0,0,0,0,2,0,0,1,0,0,3,1
4128,89750,wpQN3hnHZvt8MtT7VRAs9ZQvlWkphaGS,SpATywNh6bZuzm8s1ceuBUnMUAeoAHHw,7,3,2,0,2,0,2,0,9,1.2857142857142858,1,0.0,0,2,0,2,3,0,0,2,0,4,5,1
4129,89752,bRDMid9iRGcartTY4OAKAdQRbX2j8Y86,G8EPVSXsOYB5YQWZGiz1aVq5Pgr2GrQu,2,0,0,0,0,0,2,0,2,0.2857142857142857,1,0.0,0,0,0,0,0,0,0,2,0,0,2,1
4130,89753,k3RqfBgQWTtiyEyw3fqGDGa48Oo6Lcuo,SpATywNh6bZuzm8s1ceuBUnMUAeoAHHw,2,0,0,0,0,0,3,0,3,0.42857142857142855,1,0.0,0,0,0,0,0,0,0,3,0,0,3,1
4131,89764,Ur5YqRaNsaD6KYfRfGA2p4Zmd8kpRITc,SpATywNh6bZuzm8s1ceuBUnMUAeoAHHw,16,24,10,10,4,3,7,0,58,8.285714285714286,2,0.0,10,10,10,4,14,3,0,7,0,34,24,0
4132,89766,36BAYEapI76Mtxquz6BRxAoc9Y27dWFZ,G8EPVSXsOYB5YQWZGiz1aVq5Pgr2GrQu,10,20,4,0,5,0,2,0,31,4.428571428571429,1,0.0,11,4,0,5,9,0,0,2,0,20,11,1
4133,89767,4geFTA2SGlVqwe93iNEDI1Zg55VMGaYi,SpATywNh6bZuzm8s1ceuBUnMUAeoAHHw,9,15,7,0,2,1,6,0,31,4.428571428571429,1,0.0,1,7,0,2,14,1,0,6,0,10,21,1
4134,89788,jH123vWnpYTVLfmuSyled9Oau0AYvcx6,SpATywNh6bZuzm8s1ceuBUnMUAeoAHHw,14,12,1,18,0,4,6,1,42,6.0,1,0.0,4,1,14,0,8,4,4,6,1,19,23,1
4135,89792,TvO9et6FKUYNWGTC0Lu8cSO0dysynadE,SpATywNh6bZuzm8s1ceuBUnMUAeoAHHw,13,21,1,18,0,2,10,0,52,7.428571428571429,1,0.0,6,1,15,0,15,2,3,10,0,22,30,1
4136,89796,TNaXEhaNWX9mct0CT7Pun5pZ6GW6ngCc,SpATywNh6bZuzm8s1ceuBUnMUAeoAHHw,1,0,0,0,0,0,1,0,1,0.14285714285714285,1,0.0,0,0,0,0,0,0,0,1,0,0,1,1
4137,89799,eaeORohb7wCQL9JM2uz3yah8DgLbswAx,SpATywNh6bZuzm8s1ceuBUnMUAeoAHHw,7,3,2,0,2,25,3,0,35,5.0,1,0.0,0,2,0,2,3,25,0,3,0,4,31,1
4138,89806,55eRUKhAgZ6jAG2QNlk8p8bxI8Mo1ci4,bWdj2GDclj5ofokWjzoa5jAwMkxCykd6,4,2,1,0,1,0,1,0,5,0.7142857142857143,1,0.0,0,1,0,1,2,0,0,1,0,2,3,1
4139,89810,ZGj94V0W2CVzOroBBKkby4OcuobYFXw5,SpATywNh6bZuzm8s1ceuBUnMUAeoAHHw,1,0,0,0,0,0,1,0,1,0.14285714285714285,1,0.0,0,0,0,0,0,0,0,1,0,0,1,1
4140,89814,HOOY7gv2DgQRhkoQeNGOHVNWen0BTC1i,SpATywNh6bZuzm8s1ceuBUnMUAeoAHHw,1,0,0,0,0,0,1,0,1,0.14285714285714285,1,0.0,0,0,0,0,0,0,0,1,0,0,1,1
4141,89816,KDx4Tzovot56yH25Hp8Dvz0vvUPU9kNc,RXDvfPUBYFlVdlueBFbLW0mhhAyGEqpt,13,8,0,0,0,3,7,1,19,2.7142857142857144,1,0.0,0,0,0,0,8,3,0,7,1,0,19,1
4142,89818,UD9YcWI16E6My1ERXiW1sP1n2okAaM6v,bWdj2GDclj5ofokWjzoa5jAwMkxCykd6,1,0,0,0,0,0,1,0,1,0.14285714285714285,1,0.0,0,0,0,0,0,0,0,1,0,0,1,1
4143,89822,9aAr0eFSVkxwTSV4wzEfwp33zeuW9SSs,bWdj2GDclj5ofokWjzoa5jAwMkxCykd6,17,20,5,44,4,0,5,0,78,11.142857142857142,2,0.0,4,5,42,4,16,0,2,5,0,55,23,1
4144,89824,JXDuo0HNKJSjtiXj27sPUY7beWRK43na,SpATywNh6bZuzm8s1ceuBUnMUAeoAHHw,9,3,1,0,2,1,11,2,20,2.857142857142857,1,0.0,0,1,0,2,3,1,0,11,2,3,17,1
4145,89829,sfmDw8Mu24TwJAISRGKb3tkGixPCex4a,SpATywNh6bZuzm8s1ceuBUnMUAeoAHHw,16,26,14,12,7,18,7,1,85,12.142857142857142,1,0.0,6,14,9,7,20,18,3,7,1,36,49,1
4146,89838,ZV56LNPqAGNtVEuE1uQTYk5rPuhQg5k4,bWdj2GDclj5ofokWjzoa5jAwMkxCykd6,2,0,0,0,0,0,3,0,3,0.42857142857142855,1,0.0,0,0,0,0,0,0,0,3,0,0,3,1
4147,89844,ijg95u2jQVjnyTNM7ClS8Oj92hwAA9nz,SpATywNh6bZuzm8s1ceuBUnMUAeoAHHw,8,2,1,0,1,0,5,1,10,1.4285714285714286,1,0.0,0,1,0,1,2,0,0,5,1,2,8,1
4148,89845,yirkVFAFnnxTIzPISxnqlF6vNcZ5Qb6v,SpATywNh6bZuzm8s1ceuBUnMUAeoAHHw,4,2,1,0,0,0,2,0,5,0.7142857142857143,1,0.0,0,1,0,0,2,0,0,2,0,1,4,1
4149,89865,3z5ETakafkt4JzUHVZc8EGa6ySJrNrZy,SpATywNh6bZuzm8s1ceuBUnMUAeoAHHw,5,2,1,0,1,0,2,0,6,0.8571428571428571,1,0.0,0,1,0,1,2,0,0,2,0,2,4,1
4150,89889,esqI93l6FZECayExObEEu4vBjC7wOeKE,SpATywNh6bZuzm8s1ceuBUnMUAeoAHHw,7,2,2,0,2,0,2,0,8,1.1428571428571428,1,0.0,0,2,0,2,2,0,0,2,0,4,4,1
4151,89890,IXH7oZyCKGgxdh9kwUS5VD9TLaoLggU5,SpATywNh6bZuzm8s1ceuBUnMUAeoAHHw,7,3,2,0,2,0,2,0,9,1.2857142857142858,1,0.0,0,2,0,2,3,0,0,2,0,4,5,1
4152,89893,HAAyQYNYY3ULmqhNC56bxv5FSwyMVoqP,SpATywNh6bZuzm8s1ceuBUnMUAeoAHHw,11,26,4,10,0,1,10,0,51,7.285714285714286,3,0.0,9,4,9,0,17,1,1,10,0,22,29,1
4153,89897,HAAyQYNYY3ULmqhNC56bxv5FSwyMVoqP,bWdj2GDclj5ofokWjzoa5jAwMkxCykd6,4,10,4,0,0,0,6,0,20,2.857142857142857,3,0.0,0,4,0,0,10,0,0,6,0,4,16,1
4154,89899,uI2C8kZvxXShkoacauA0S9izMW2oRB2R,RXDvfPUBYFlVdlueBFbLW0mhhAyGEqpt,48,23,14,94,8,5,11,1,156,22.285714285714285,2,0.0,7,14,90,8,16,5,4,11,1,119,37,1
4155,89901,YiHBZRMHXXOxz07e5dCrboCIm1oQ0OKy,RXDvfPUBYFlVdlueBFbLW0mhhAyGEqpt,16,17,12,0,6,7,10,0,52,7.428571428571429,1,0.0,0,12,0,6,17,7,0,10,0,18,34,1
4156,89906,mMv5ULasJWNphOEtfj5B5HTtZYfxsB3G,SpATywNh6bZuzm8s1ceuBUnMUAeoAHHw,2,0,0,0,0,0,2,0,2,0.2857142857142857,1,0.0,0,0,0,0,0,0,0,2,0,0,2,1
4157,89910,qngZFTemZ9VNe5bU9mST85frjoIJ7IAD,RXDvfPUBYFlVdlueBFbLW0mhhAyGEqpt,5,2,1,0,1,0,2,0,6,0.8571428571428571,1,0.0,0,1,0,1,2,0,0,2,0,2,4,1
4158,89913,zlNlEcmlViJgBUG0ywxJEPhI6SYvToC0,SpATywNh6bZuzm8s1ceuBUnMUAeoAHHw,1,0,0,0,0,0,1,0,1,0.14285714285714285,1,0.0,0,0,0,0,0,0,0,1,0,0,1,1
4159,89917,Jr0Xqt1ZmxzSzD15wla9BChmcIeBBK4Z,G8EPVSXsOYB5YQWZGiz1aVq5Pgr2GrQu,9,4,0,0,0,3,7,1,15,2.142857142857143,1,0.0,0,0,0,0,4,3,0,7,1,0,15,1
4160,89923,ysO1bg2EIYdeVFkxhwuOr9gves820gWk,RXDvfPUBYFlVdlueBFbLW0mhhAyGEqpt,6,4,1,0,0,0,3,1,9,1.2857142857142858,1,0.0,0,1,0,0,4,0,0,3,1,1,8,1
4161,89935,Cvsz0UZNQwRp1mBIzDah4d0DHCa0q2WK,SpATywNh6bZuzm8s1ceuBUnMUAeoAHHw,1,0,0,0,0,0,1,0,1,0.14285714285714285,1,0.0,0,0,0,0,0,0,0,1,0,0,1,1
4162,89937,Lb6PKJrTzwsQYsITlNu0wfDvL4DmKZCj,RXDvfPUBYFlVdlueBFbLW0mhhAyGEqpt,4,2,1,0,1,0,1,0,5,0.7142857142857143,1,0.0,0,1,0,1,2,0,0,1,0,2,3,1
4163,89948,TtmytGkYhNaL4UmbxQBMSixlcCRjb9lD,SpATywNh6bZuzm8s1ceuBUnMUAeoAHHw,7,8,1,0,0,6,5,0,20,2.857142857142857,1,0.0,0,1,0,0,8,6,0,5,0,1,19,1
4164,89956,myYQGnE7AuDkDAMs5wvSchGGtMiBR3qG,RXDvfPUBYFlVdlueBFbLW0mhhAyGEqpt,6,4,0,0,0,2,5,0,11,1.5714285714285714,1,0.0,0,0,0,0,4,2,0,5,0,0,11,0
4165,89957,0q9MKOQI6izUm7JGi2QEuKfgyApDxosK,SpATywNh6bZuzm8s1ceuBUnMUAeoAHHw,2,0,0,0,0,0,2,0,2,0.2857142857142857,1,0.0,0,0,0,0,0,0,0,2,0,0,2,1
4166,89967,db8Cy33Nc9oRQhsghT9mZ7YJUbZnnH0B,SpATywNh6bZuzm8s1ceuBUnMUAeoAHHw,5,2,1,0,1,0,2,0,6,0.8571428571428571,1,0.0,0,1,0,1,2,0,0,2,0,2,4,1
4167,89968,KjHvjBsSgp7lqvkYLAjrQHS8ZrdrlLzv,SpATywNh6bZuzm8s1ceuBUnMUAeoAHHw,11,9,7,7,5,1,2,0,31,4.428571428571429,1,0.0,1,7,6,5,8,1,1,2,0,19,12,1
4168,89969,frAGxLKbgrgCbr9YXoqzdmgtbJjUbBNJ,G8EPVSXsOYB5YQWZGiz1aVq5Pgr2GrQu,5,8,1,0,2,1,2,0,14,2.0,1,0.0,6,1,0,2,2,1,0,2,0,9,5,1
4169,89971,DpB3NoJLarAGiHUaBV6zvSP8bR0qw4yk,RXDvfPUBYFlVdlueBFbLW0mhhAyGEqpt,6,3,2,0,1,0,2,0,8,1.1428571428571428,1,0.0,0,2,0,1,3,0,0,2,0,3,5,1
4170,89984,HCLrpFC2S5L0Y8JmZewW8gsgYgpEkXeP,SpATywNh6bZuzm8s1ceuBUnMUAeoAHHw,14,12,5,24,3,0,6,0,50,7.142857142857143,2,0.0,4,5,19,3,8,0,5,6,0,31,19,1
4171,89987,8QIwRllpGKgpURtcmS5hWJ0AInSKESf0,RXDvfPUBYFlVdlueBFbLW0mhhAyGEqpt,6,2,1,0,1,0,3,0,7,1.0,1,0.0,0,1,0,1,2,0,0,3,0,2,5,1
4172,89994,zvOHbaUWjxRZ9zCYxYPMcUH4Ef5dE8Ae,G8EPVSXsOYB5YQWZGiz1aVq5Pgr2GrQu,5,2,1,0,1,0,2,0,6,0.8571428571428571,1,0.0,0,1,0,1,2,0,0,2,0,2,4,1
4173,90000,xFi8956jLKPkTqTiwrHbFAm2iOTFidYP,SpATywNh6bZuzm8s1ceuBUnMUAeoAHHw,1,0,0,0,0,0,2,0,2,0.2857142857142857,1,0.0,0,0,0,0,0,0,0,2,0,0,2,1
4174,90008,aM04j8B80UycNpLiy2mFNdgBiaLCgDBx,SpATywNh6bZuzm8s1ceuBUnMUAeoAHHw,5,2,1,0,1,0,4,0,8,1.1428571428571428,1,0.0,0,1,0,1,2,0,0,4,0,2,6,1
4175,90011,KbVIZwe7S3MOh9dlFVWDZwSpf3zNL2tv,SpATywNh6bZuzm8s1ceuBUnMUAeoAHHw,5,4,2,0,1,0,1,0,8,1.1428571428571428,1,0.0,0,2,0,1,4,0,0,1,0,3,5,1
4176,90014,ZDrt6zlGm4y4ur5AWVSG62RV3VJJ5cJS,SpATywNh6bZuzm8s1ceuBUnMUAeoAHHw,6,3,2,0,1,7,3,0,16,2.2857142857142856,1,0.0,0,2,0,1,3,7,0,3,0,3,13,1
4177,90021,bjoQsxzy5xWbIlWJOK88FLxI1KzCehRN,SpATywNh6bZuzm8s1ceuBUnMUAeoAHHw,3,2,0,0,0,0,1,0,3,0.42857142857142855,1,0.0,0,0,0,0,2,0,0,1,0,0,3,1
4178,90023,OMrBHOtDkdk4Zxba42NamuOWH8Ss9fWW,bWdj2GDclj5ofokWjzoa5jAwMkxCykd6,2,0,0,0,0,0,2,0,2,0.2857142857142857,1,0.0,0,0,0,0,0,0,0,2,0,0,2,1
4179,90030,rQT5JCDNn9UQwRKU1wpR7NGmcTvEHfxS,bWdj2GDclj5ofokWjzoa5jAwMkxCykd6,5,2,1,0,1,0,5,0,9,1.2857142857142858,1,0.0,0,1,0,1,2,0,0,5,0,2,7,1
4180,90034,YCpaFH59BZea33ilZmurVIrcGKs7kkSW,SpATywNh6bZuzm8s1ceuBUnMUAeoAHHw,1,0,0,0,0,0,1,0,1,0.14285714285714285,1,0.0,0,0,0,0,0,0,0,1,0,0,1,1
4181,90041,JaLvdj0QPGLA6QlwJ3N2oF66NiYZ7XSV,bWdj2GDclj5ofokWjzoa5jAwMkxCykd6,19,49,27,28,14,96,19,5,238,34.0,4,0.0,5,27,24,14,44,96,4,19,5,70,168,0
4182,90047,b31D3oEzHUylsy39VKOzq1naz39PNLwH,G8EPVSXsOYB5YQWZGiz1aVq5Pgr2GrQu,41,58,25,54,8,3,23,1,172,24.571428571428573,3,0.0,21,25,34,8,37,3,20,23,1,88,84,1
4183,90052,ggntZRuHqDckUtFC9TYtfF8K09iXYWES,SpATywNh6bZuzm8s1ceuBUnMUAeoAHHw,5,3,0,0,0,0,6,0,9,1.2857142857142858,2,0.0,0,0,0,0,3,0,0,6,0,0,9,1
4184,90055,kGkU7DU5zOC0IQHNRlo6r0rouCnUfi6R,RXDvfPUBYFlVdlueBFbLW0mhhAyGEqpt,22,25,13,17,8,3,14,1,81,11.571428571428571,2,0.0,5,13,16,8,20,3,1,14,1,42,39,1
4185,90063,Vn131dD12fh0kapodbBhio0q4dV4IYmG,bWdj2GDclj5ofokWjzoa5jAwMkxCykd6,4,2,1,0,1,0,1,0,5,0.7142857142857143,1,0.0,0,1,0,1,2,0,0,1,0,2,3,1
4186,90067,6e1wovvtDhnhxwqREzmRRei4eIEEGraW,bWdj2GDclj5ofokWjzoa5jAwMkxCykd6,8,6,4,0,3,0,7,1,21,3.0,1,0.0,0,4,0,3,6,0,0,7,1,7,14,1
4187,90076,QhIEGvYTYkDhEyimLONTXmJHONpcq43g,SpATywNh6bZuzm8s1ceuBUnMUAeoAHHw,1,0,0,0,0,0,1,0,1,0.14285714285714285,1,0.0,0,0,0,0,0,0,0,1,0,0,1,1
4188,90085,JYzVKgw0yfgKYwKodhquOfGRUiHh1739,SpATywNh6bZuzm8s1ceuBUnMUAeoAHHw,4,2,0,0,0,0,2,0,4,0.5714285714285714,1,0.0,0,0,0,0,2,0,0,2,0,0,4,1
4189,90087,6Xt9XL14E8rzUiRHbQmDyc0T0uWOhD5k,SpATywNh6bZuzm8s1ceuBUnMUAeoAHHw,5,4,1,0,1,0,2,0,8,1.1428571428571428,1,0.0,0,1,0,1,4,0,0,2,0,2,6,1
4190,90088,lzm9dP9Q32i0nrdz5KGk9vngMJk6H38J,SpATywNh6bZuzm8s1ceuBUnMUAeoAHHw,7,9,3,0,2,0,5,0,19,2.7142857142857144,2,0.0,1,3,0,2,8,0,0,5,0,6,13,1
4191,90090,srF76iHf3IXwkM0p0daLjk1LYx1sO9QO,bWdj2GDclj5ofokWjzoa5jAwMkxCykd6,1,0,0,0,0,0,1,0,1,0.14285714285714285,1,0.0,0,0,0,0,0,0,0,1,0,0,1,1
4192,90094,TYu8VgV6TkJO1pWVABdfXnpa6VWQUK0O,RXDvfPUBYFlVdlueBFbLW0mhhAyGEqpt,20,13,9,27,5,0,3,0,57,8.142857142857142,2,0.0,2,9,27,5,11,0,0,3,0,43,14,1
4193,90097,ilWzYGLWBh9DSc1MV8g2C4Go5wDNgUHX,bWdj2GDclj5ofokWjzoa5jAwMkxCykd6,8,4,2,6,1,7,2,0,22,3.142857142857143,1,0.0,1,2,6,1,3,7,0,2,0,10,12,1
4194,90103,faywX8b5OPf8lgTBqNfgsgut6a2kmqN4,SpATywNh6bZuzm8s1ceuBUnMUAeoAHHw,6,3,2,0,2,0,1,0,8,1.1428571428571428,1,0.0,0,2,0,2,3,0,0,1,0,4,4,1
4195,90117,MjWnBfKyq3bKCwHG0ZVIL5hXZR3ku4f4,SpATywNh6bZuzm8s1ceuBUnMUAeoAHHw,12,8,5,0,3,0,8,1,25,3.5714285714285716,1,0.0,0,5,0,3,8,0,0,8,1,8,17,1
4196,90120,jDBqOswp4ojFI0uystVaz1714DhGWBFe,SpATywNh6bZuzm8s1ceuBUnMUAeoAHHw,6,4,3,0,2,0,2,2,13,1.8571428571428572,1,0.0,0,3,0,2,4,0,0,2,2,5,8,1
4197,90131,bTJkfLPF7pQ1o12jyPBjkkHpxb8ACgm5,bWdj2GDclj5ofokWjzoa5jAwMkxCykd6,1,0,0,0,0,0,1,0,1,0.14285714285714285,1,0.0,0,0,0,0,0,0,0,1,0,0,1,1
4198,90135,bTJkfLPF7pQ1o12jyPBjkkHpxb8ACgm5,SpATywNh6bZuzm8s1ceuBUnMUAeoAHHw,4,2,1,0,1,0,1,0,5,0.7142857142857143,1,0.0,0,1,0,1,2,0,0,1,0,2,3,1
4199,90136,bMIS6W7sngWZiZpkuSg6XOmdfsq88CgB,bWdj2GDclj5ofokWjzoa5jAwMkxCykd6,9,13,6,126,7,0,2,0,154,22.0,1,0.0,6,6,125,7,7,0,1,2,0,144,10,1
4200,90138,Eg9TEdaEeaxICrLXGeMPzp6XOtJtw2iA,SpATywNh6bZuzm8s1ceuBUnMUAeoAHHw,6,1,1,0,1,0,5,0,8,1.1428571428571428,1,0.0,0,1,0,1,1,0,0,5,0,2,6,1
4201,90139,6ev6a6dpwen0GstMqDij5DO55YCNj8wV,SpATywNh6bZuzm8s1ceuBUnMUAeoAHHw,10,10,5,0,3,7,8,1,34,4.857142857142857,1,0.0,0,5,0,3,10,7,0,8,1,8,26,1
4202,90155,U7btMcQ825kheRskgLUndnBUWWFj60BC,G8EPVSXsOYB5YQWZGiz1aVq5Pgr2GrQu,2,0,0,0,0,0,3,0,3,0.42857142857142855,1,0.0,0,0,0,0,0,0,0,3,0,0,3,1
4203,90160,Q7rqeL75J4PJeAuNXiXhCR5dry9rPsv1,G8EPVSXsOYB5YQWZGiz1aVq5Pgr2GrQu,14,24,9,4,8,1,7,1,54,7.714285714285714,1,0.0,13,9,3,8,11,1,1,7,1,33,21,1
4204,90172,ktsGX0WguDDY6I5ilK51sxzTMtoxdwY2,G8EPVSXsOYB5YQWZGiz1aVq5Pgr2GrQu,5,2,1,0,1,0,4,0,8,1.1428571428571428,2,0.0,0,1,0,1,2,0,0,4,0,2,6,1
4205,90176,TM0zAsul1XLjJRFtspexc3sccxHTiW3v,SpATywNh6bZuzm8s1ceuBUnMUAeoAHHw,2,0,0,0,0,0,2,0,2,0.2857142857142857,1,0.0,0,0,0,0,0,0,0,2,0,0,2,0
4206,90177,ihuUuFaDeVBULP8Ogmzz18gVO9cBzlOD,RXDvfPUBYFlVdlueBFbLW0mhhAyGEqpt,3,0,0,0,0,2,2,0,4,0.5714285714285714,1,0.0,0,0,0,0,0,2,0,2,0,0,4,1
4207,90180,7ibtd0r1yxMhjpaNZCtEirkOcSqUBCGN,RXDvfPUBYFlVdlueBFbLW0mhhAyGEqpt,13,11,5,14,5,0,1,0,36,5.142857142857143,1,0.0,5,5,12,5,6,0,2,1,0,27,9,0
4208,90183,SYRx2sSX9LDLLUNNibf5r7JJQePy5BRh,G8EPVSXsOYB5YQWZGiz1aVq5Pgr2GrQu,26,41,1,46,0,1,11,1,101,14.428571428571429,1,0.0,17,1,34,0,24,1,12,11,1,52,49,1
4209,90184,7zAZJQJmdmR0Q9agHk9B0faabzdMeTDx,G8EPVSXsOYB5YQWZGiz1aVq5Pgr2GrQu,4,5,2,0,2,0,1,0,10,1.4285714285714286,1,0.0,2,2,0,2,3,0,0,1,0,6,4,1
4210,90189,64SFa5QYw3OYdZffw8ZxPKmPdz675qex,G8EPVSXsOYB5YQWZGiz1aVq5Pgr2GrQu,6,3,2,0,2,0,1,0,8,1.1428571428571428,1,0.0,0,2,0,2,3,0,0,1,0,4,4,1
4211,90192,uybm0Sdpts5PrhQW2nyBVnFfiT9zAmh4,G8EPVSXsOYB5YQWZGiz1aVq5Pgr2GrQu,8,9,1,8,1,0,3,0,22,3.142857142857143,1,0.0,2,1,6,1,7,0,2,3,0,10,12,0
4212,90199,loDNGhsCc1OXWM5CF3rme5wzdyMcOTJj,RXDvfPUBYFlVdlueBFbLW0mhhAyGEqpt,26,19,9,0,7,1,9,4,49,7.0,2,0.0,1,9,0,7,18,1,0,9,4,17,32,1
4213,90214,LfZmAYW4GITnFlauWgCvKzPoi1bCqPgK,bWdj2GDclj5ofokWjzoa5jAwMkxCykd6,12,13,4,4,5,0,6,0,32,4.571428571428571,2,0.0,4,4,4,5,9,0,0,6,0,17,15,1
4214,90215,GxfzvZIYYQ6Ai51iUnspJ06bhY10jacX,SpATywNh6bZuzm8s1ceuBUnMUAeoAHHw,17,20,9,18,5,0,8,1,61,8.714285714285714,2,0.0,3,9,15,5,17,0,3,8,1,32,29,1
4215,90219,feANl8pQvsJtkNIIOWO1qX8ND4VT9Cj4,G8EPVSXsOYB5YQWZGiz1aVq5Pgr2GrQu,4,2,1,0,1,0,1,0,5,0.7142857142857143,1,0.0,0,1,0,1,2,0,0,1,0,2,3,1
4216,90223,LRnQOt7NsdMcAvm0GOPse3zkFSQ0mVYI,SpATywNh6bZuzm8s1ceuBUnMUAeoAHHw,5,2,1,0,1,0,2,0,6,0.8571428571428571,1,0.0,0,1,0,1,2,0,0,2,0,2,4,1
4217,90224,S0OJjF6aof0iTnIX6lUAxekoH3m4w7V0,RXDvfPUBYFlVdlueBFbLW0mhhAyGEqpt,18,13,10,29,7,0,1,0,60,8.571428571428571,1,0.0,2,10,23,7,11,0,6,1,0,42,18,1
4218,90233,mXvtIKY9ZnAQyKjdLyySIxbvTtoP8Weq,G8EPVSXsOYB5YQWZGiz1aVq5Pgr2GrQu,5,2,1,0,1,0,3,0,7,1.0,1,0.0,0,1,0,1,2,0,0,3,0,2,5,1
4219,90235,pONYaLTf3U8GoaNpbS0j1PZ1GhOmkS7N,SpATywNh6bZuzm8s1ceuBUnMUAeoAHHw,14,17,6,14,4,1,3,0,45,6.428571428571429,1,0.0,10,6,14,4,7,1,0,3,0,34,11,1
4220,90244,DU0dRtEpZksA4ySXAez5UVn9g5rHoTAA,SpATywNh6bZuzm8s1ceuBUnMUAeoAHHw,8,22,11,0,3,0,3,0,39,5.571428571428571,2,0.0,8,11,0,3,14,0,0,3,0,22,17,1
4221,90248,b0xM3piMaIC7gCFYyxqHoITel9oKF6YW,bWdj2GDclj5ofokWjzoa5jAwMkxCykd6,9,5,1,26,1,2,4,1,40,5.714285714285714,1,0.0,2,1,25,1,3,2,1,4,1,29,11,1
4222,90249,RDTdhSHGbxVSFCWLWYH4XRafyz4IOkLm,SpATywNh6bZuzm8s1ceuBUnMUAeoAHHw,6,2,1,0,1,1,3,0,8,1.1428571428571428,1,0.0,0,1,0,1,2,1,0,3,0,2,6,1
4223,90250,Cb5KBNxKLciN7IuFLNM0hPSrkcjzkoDX,SpATywNh6bZuzm8s1ceuBUnMUAeoAHHw,7,2,1,0,1,0,3,0,7,1.0,1,0.0,0,1,0,1,2,0,0,3,0,2,5,1
4224,90251,GMTEjCyWbqfKfP4EXN5ReJJtqfdXmmTA,RXDvfPUBYFlVdlueBFbLW0mhhAyGEqpt,2,0,0,0,0,0,2,0,2,0.2857142857142857,1,0.0,0,0,0,0,0,0,0,2,0,0,2,1
4225,90253,5a7fehAo0Ol3kwHzhNqAYRGEzPLIE5FD,bWdj2GDclj5ofokWjzoa5jAwMkxCykd6,6,9,5,0,1,0,6,0,21,3.0,2,0.0,0,5,0,1,9,0,0,6,0,6,15,1
4226,90256,JHLmQKNX4G6HmeBY0Psd6kgnv0WEcPsm,SpATywNh6bZuzm8s1ceuBUnMUAeoAHHw,7,4,1,0,1,0,6,0,12,1.7142857142857142,1,0.0,0,1,0,1,4,0,0,6,0,2,10,1
4227,90258,tQrXZ3EDIEf1hKQdGJOaurgPvqncjvEA,bWdj2GDclj5ofokWjzoa5jAwMkxCykd6,3,2,0,0,0,0,2,0,4,0.5714285714285714,1,0.0,0,0,0,0,2,0,0,2,0,0,4,1
4228,90260,zykAfhTnSrdYpElmeo66SyCzw5nw6JVn,bWdj2GDclj5ofokWjzoa5jAwMkxCykd6,7,12,7,0,3,0,6,0,28,4.0,1,0.0,0,7,0,3,12,0,0,6,0,10,18,1
4229,90263,QmJXKs57BF6o936ZGaQIMEt20JYrSdAW,G8EPVSXsOYB5YQWZGiz1aVq5Pgr2GrQu,4,27,1,4,2,0,1,0,35,5.0,1,0.0,23,1,3,2,4,0,1,1,0,29,6,1
4230,90266,n0HFF3TwqKuBMzzkdLCbvb8Mji5ZUnVX,SpATywNh6bZuzm8s1ceuBUnMUAeoAHHw,7,6,4,0,3,0,2,0,15,2.142857142857143,2,0.0,0,4,0,3,6,0,0,2,0,7,8,1
4231,90270,521YJDVy6G9ul5QyLTUZAuztPLpe7gqW,G8EPVSXsOYB5YQWZGiz1aVq5Pgr2GrQu,11,14,4,0,2,1,10,1,32,4.571428571428571,1,0.0,2,4,0,2,12,1,0,10,1,8,24,1
4232,90272,s41hWh3vMIIfQQVEuM6UwEzfhfcM1JZA,SpATywNh6bZuzm8s1ceuBUnMUAeoAHHw,5,2,1,0,1,0,2,0,6,0.8571428571428571,1,0.0,0,1,0,1,2,0,0,2,0,2,4,1
4233,90278,bweLZE6WiefKMb8vrgzlIS50q4xPrbd3,G8EPVSXsOYB5YQWZGiz1aVq5Pgr2GrQu,7,8,1,2,1,0,2,0,14,2.0,1,0.0,3,1,2,1,5,0,0,2,0,7,7,1
4234,90279,Ewm3oAfqxDgJQMFbDpAkGPAjCut5zQSX,SpATywNh6bZuzm8s1ceuBUnMUAeoAHHw,1,0,0,0,0,0,1,0,1,0.14285714285714285,1,0.0,0,0,0,0,0,0,0,1,0,0,1,1
4235,90280,jwRuJMKgg5MQLF9v6u6v92ntnY2avB7X,SpATywNh6bZuzm8s1ceuBUnMUAeoAHHw,7,3,2,0,2,0,4,0,11,1.5714285714285714,1,0.0,0,2,0,2,3,0,0,4,0,4,7,1
4236,90285,v4laioBlEPXkN50wQCoVv0p0aRfPHa4S,G8EPVSXsOYB5YQWZGiz1aVq5Pgr2GrQu,1,0,0,0,0,0,1,0,1,0.14285714285714285,1,0.0,0,0,0,0,0,0,0,1,0,0,1,1
4237,90286,0nJUVE3hT3v1fqbd9NpHDszm9KS6NNTn,G8EPVSXsOYB5YQWZGiz1aVq5Pgr2GrQu,6,1,1,0,1,0,3,0,6,0.8571428571428571,1,0.0,0,1,0,1,1,0,0,3,0,2,4,1
4238,90289,n5gAmeJZl36AzaSKV2dfNY3RvYF0IYqr,SpATywNh6bZuzm8s1ceuBUnMUAeoAHHw,5,3,1,0,1,0,2,0,7,1.0,1,0.0,1,1,0,1,2,0,0,2,0,3,4,1
4239,90290,264OEiaYNcFYG5J7N6NDOp3G0CBJqdMF,SpATywNh6bZuzm8s1ceuBUnMUAeoAHHw,2,0,0,0,0,0,3,0,3,0.42857142857142855,1,0.0,0,0,0,0,0,0,0,3,0,0,3,1
4240,90294,juZ453F4cmwgObiaW1ClMKkoi0EGrafR,G8EPVSXsOYB5YQWZGiz1aVq5Pgr2GrQu,4,2,0,0,0,1,2,0,5,0.7142857142857143,1,0.0,0,0,0,0,2,1,0,2,0,0,5,1
4241,90305,Sy1NUS22p5IcvKggpod61sUWNUSyXtbs,G8EPVSXsOYB5YQWZGiz1aVq5Pgr2GrQu,19,29,11,0,8,0,7,0,55,7.857142857142857,4,0.0,8,11,0,8,21,0,0,7,0,27,28,0
4242,90306,cwnwk7sVo9oHpSkUPDdu8wUE4KBTJLBj,bWdj2GDclj5ofokWjzoa5jAwMkxCykd6,1,0,0,0,0,0,1,0,1,0.14285714285714285,1,0.0,0,0,0,0,0,0,0,1,0,0,1,1
4243,90321,NlgFEWO87VQbCzq3S6FQjH7bzvdUhuql,RXDvfPUBYFlVdlueBFbLW0mhhAyGEqpt,1,0,0,0,0,0,1,0,1,0.14285714285714285,1,0.0,0,0,0,0,0,0,0,1,0,0,1,1
4244,90326,J1iCM60eAwVKTPRoP9hdyFlEQf6db3YF,SpATywNh6bZuzm8s1ceuBUnMUAeoAHHw,13,10,6,6,4,4,3,0,33,4.714285714285714,1,0.0,2,6,6,4,8,4,0,3,0,18,15,1
4245,90337,AImQCDhN4bmgLgB3jm3FHzAq0G1rwIiv,SpATywNh6bZuzm8s1ceuBUnMUAeoAHHw,5,2,1,0,1,0,2,0,6,0.8571428571428571,1,0.0,0,1,0,1,2,0,0,2,0,2,4,1
4246,90343,jl79Z6TfXd4YLzsAQwSCeo1eMaF6Ha8d,bWdj2GDclj5ofokWjzoa5jAwMkxCykd6,10,8,1,0,2,7,6,1,25,3.5714285714285716,1,0.0,2,1,0,2,6,7,0,6,1,5,20,1
4247,90348,VDscv2ylkQ5hVjxSl7FzkFmJDmBcIaMr,bWdj2GDclj5ofokWjzoa5jAwMkxCykd6,11,8,3,18,1,0,14,1,45,6.428571428571429,4,0.0,1,3,18,1,7,0,0,14,1,23,22,1
4248,90349,F6I7OSqjE137AeaYIX9MEazl6a7Noplf,SpATywNh6bZuzm8s1ceuBUnMUAeoAHHw,7,4,0,0,0,0,4,0,8,1.1428571428571428,1,0.0,0,0,0,0,4,0,0,4,0,0,8,1
4249,90351,vSAp2k0hR5TAgTxUO6r2EVSaLCqePHP4,SpATywNh6bZuzm8s1ceuBUnMUAeoAHHw,4,2,1,0,1,0,1,0,5,0.7142857142857143,1,0.0,0,1,0,1,2,0,0,1,0,2,3,1
4250,90354,x3sZblYMoUvQJbk7l9GY688n7RQqaQct,bWdj2GDclj5ofokWjzoa5jAwMkxCykd6,5,5,1,0,1,0,2,0,9,1.2857142857142858,1,0.0,0,1,0,1,5,0,0,2,0,2,7,1
4251,90355,D7Evkt9LkM9awqCB4mL7Tk75xiGKRcNK,RXDvfPUBYFlVdlueBFbLW0mhhAyGEqpt,1,0,0,0,0,0,1,0,1,0.14285714285714285,1,0.0,0,0,0,0,0,0,0,1,0,0,1,1
4252,90356,ublyxWXAJoR0ltzxB8gmTQ7Y4SFlWnZM,G8EPVSXsOYB5YQWZGiz1aVq5Pgr2GrQu,10,23,0,6,1,0,5,1,36,5.142857142857143,2,0.0,14,0,5,1,9,0,1,5,1,20,16,1
4253,90358,JnnoDII6jIRoAG8myf8F5d0DS0vEB9se,bWdj2GDclj5ofokWjzoa5jAwMkxCykd6,3,0,0,0,0,4,2,0,6,0.8571428571428571,1,0.0,0,0,0,0,0,4,0,2,0,0,6,1
4254,90359,6ryFJ2ZF3YGC7hqGJv2IswdyAnxH8nhB,G8EPVSXsOYB5YQWZGiz1aVq5Pgr2GrQu,5,2,1,0,1,0,7,0,11,1.5714285714285714,1,0.0,0,1,0,1,2,0,0,7,0,2,9,1
4255,90369,BBJ3vKTyvStRa10Tpfc6k0oOhgY721Pq,bWdj2GDclj5ofokWjzoa5jAwMkxCykd6,7,5,3,0,2,0,5,1,16,2.2857142857142856,1,0.0,0,3,0,2,5,0,0,5,1,5,11,1
4256,90372,4GMbKnTV7f2uA3paM09GNAdyVnypDTbs,RXDvfPUBYFlVdlueBFbLW0mhhAyGEqpt,8,2,2,0,2,0,8,0,14,2.0,1,0.0,0,2,0,2,2,0,0,8,0,4,10,1
4257,90374,FGJeYJZQGTs7gi3lnr6EovN6yJTo7ibM,G8EPVSXsOYB5YQWZGiz1aVq5Pgr2GrQu,20,8,6,22,3,1,7,1,48,6.857142857142857,1,0.0,0,6,17,3,8,1,5,7,1,26,22,1
4258,90376,BBJ3vKTyvStRa10Tpfc6k0oOhgY721Pq,RXDvfPUBYFlVdlueBFbLW0mhhAyGEqpt,1,0,0,0,0,0,1,0,1,0.14285714285714285,1,0.0,0,0,0,0,0,0,0,1,0,0,1,1
4259,90377,2sT7ojsC1w02fAwhcaRLBrXcss5IOsOK,bWdj2GDclj5ofokWjzoa5jAwMkxCykd6,5,2,1,0,1,0,2,0,6,0.8571428571428571,1,0.0,0,1,0,1,2,0,0,2,0,2,4,1
4260,90381,JnnoDII6jIRoAG8myf8F5d0DS0vEB9se,RXDvfPUBYFlVdlueBFbLW0mhhAyGEqpt,1,0,0,0,0,0,1,0,1,0.14285714285714285,1,0.0,0,0,0,0,0,0,0,1,0,0,1,1
4261,90382,JnnoDII6jIRoAG8myf8F5d0DS0vEB9se,G8EPVSXsOYB5YQWZGiz1aVq5Pgr2GrQu,1,0,0,0,0,0,1,0,1,0.14285714285714285,1,0.0,0,0,0,0,0,0,0,1,0,0,1,1
4262,90389,UdVAw5urwjLmc9uIJ3uWZ6MzY9bq82FD,bWdj2GDclj5ofokWjzoa5jAwMkxCykd6,5,11,1,18,0,5,1,0,36,5.142857142857143,1,0.0,6,1,16,0,5,5,2,1,0,23,13,1
4263,90391,wyK0UoS83lDT8utSJzcLSlSEzOTr7cFo,SpATywNh6bZuzm8s1ceuBUnMUAeoAHHw,4,0,0,0,0,0,4,0,4,0.5714285714285714,1,0.0,0,0,0,0,0,0,0,4,0,0,4,1
4264,90399,Gq0WW1vBA55n1msrepMKrg3TKn8N6yfT,bWdj2GDclj5ofokWjzoa5jAwMkxCykd6,16,21,1,48,2,0,6,0,78,11.142857142857142,2,0.0,10,1,47,2,11,0,1,6,0,60,18,1
4265,90404,5o9h0u1MdREnKa1ru9UVL61wcNO9zJkv,bWdj2GDclj5ofokWjzoa5jAwMkxCykd6,6,15,3,0,1,0,9,0,28,4.0,1,0.0,0,3,0,1,15,0,0,9,0,4,24,1
4266,90408,C6mvlVLzmlNXh4kv8CeERDr2P2W5lqpV,SpATywNh6bZuzm8s1ceuBUnMUAeoAHHw,7,2,0,0,0,2,7,1,12,1.7142857142857142,1,0.0,0,0,0,0,2,2,0,7,1,0,12,1
4267,90416,4tsGZRMByIyec9WCveltaBAT6TVvi6KF,RXDvfPUBYFlVdlueBFbLW0mhhAyGEqpt,9,6,2,26,3,0,1,0,38,5.428571428571429,1,0.0,2,2,20,3,4,0,6,1,0,27,11,1
4268,90418,fBvSAwv6uc40UeqRCaejhOfI13E4tjda,SpATywNh6bZuzm8s1ceuBUnMUAeoAHHw,6,8,3,0,1,0,2,0,14,2.0,1,0.0,3,3,0,1,5,0,0,2,0,7,7,1
4269,90422,rwjIOQWge6ogv55EFnUadvoZ473wCxPF,SpATywNh6bZuzm8s1ceuBUnMUAeoAHHw,2,0,0,0,0,0,3,0,3,0.42857142857142855,1,0.0,0,0,0,0,0,0,0,3,0,0,3,1
4270,90425,lcgsmC4BQDYDnzCO5vs1TCdTPnBbRaGt,SpATywNh6bZuzm8s1ceuBUnMUAeoAHHw,13,31,0,22,0,9,10,2,74,10.571428571428571,1,0.0,10,0,18,0,21,9,4,10,2,28,46,1
4271,90429,NnJUzVJQXS15uc1WVncpFgpFT3Jtm38y,bWdj2GDclj5ofokWjzoa5jAwMkxCykd6,4,2,1,0,1,0,1,0,5,0.7142857142857143,1,0.0,0,1,0,1,2,0,0,1,0,2,3,1
4272,90432,PCdtFg5aq768xRAGHCfQQy2MLmWOvvld,bWdj2GDclj5ofokWjzoa5jAwMkxCykd6,5,5,3,0,0,0,3,0,11,1.5714285714285714,2,0.0,0,3,0,0,5,0,0,3,0,3,8,1
4273,90435,ohlMhSWqKWmqC7u03UQO1YoFekI6xVAy,RXDvfPUBYFlVdlueBFbLW0mhhAyGEqpt,9,4,1,0,1,2,11,1,20,2.857142857142857,1,0.0,0,1,0,1,4,2,0,11,1,2,18,1
4274,90445,NvpLHMRFxJk2eR30iYl189WOkyZeEnSd,RXDvfPUBYFlVdlueBFbLW0mhhAyGEqpt,4,3,0,0,0,0,1,0,4,0.5714285714285714,1,0.0,0,0,0,0,3,0,0,1,0,0,4,1
4275,90446,FcIMQNoo2B9wNij30W0t3SsuF1pzZCFp,G8EPVSXsOYB5YQWZGiz1aVq5Pgr2GrQu,6,2,1,0,0,0,6,0,9,1.2857142857142858,1,0.0,0,1,0,0,2,0,0,6,0,1,8,1
4276,90448,8spZJm18FAAt0jkb5fLlQ7lVR80rIhqU,SpATywNh6bZuzm8s1ceuBUnMUAeoAHHw,9,8,2,0,1,4,13,3,31,4.428571428571429,2,0.0,0,2,0,1,8,4,0,13,3,3,28,1
4277,90449,MoVymwbcHW0CbhTCwXgAq4UFuaXFCEM8,SpATywNh6bZuzm8s1ceuBUnMUAeoAHHw,5,3,0,0,0,0,2,0,5,0.7142857142857143,1,0.0,0,0,0,0,3,0,0,2,0,0,5,1
4278,90450,K0GvqkFX0mEPCK9WbHThj3iwTwuWgCZz,G8EPVSXsOYB5YQWZGiz1aVq5Pgr2GrQu,83,118,49,230,6,19,18,2,442,63.142857142857146,1,0.0,55,49,171,6,63,19,59,18,2,281,161,1
4279,90451,gbhKUd7BJXTZpVcoQvBpKT3bqB9VoWlp,SpATywNh6bZuzm8s1ceuBUnMUAeoAHHw,4,2,1,0,1,0,1,0,5,0.7142857142857143,1,0.0,0,1,0,1,2,0,0,1,0,2,3,1
4280,90455,loPn0Qajy87SoektWTbVxEkxp7hmTtzk,SpATywNh6bZuzm8s1ceuBUnMUAeoAHHw,1,0,0,0,0,0,1,0,1,0.14285714285714285,1,0.0,0,0,0,0,0,0,0,1,0,0,1,1
4281,90456,ejWSFSNW1jOTCFDROUQkAUS6uY6mX6CR,bWdj2GDclj5ofokWjzoa5jAwMkxCykd6,4,2,1,0,1,0,1,0,5,0.7142857142857143,1,0.0,0,1,0,1,2,0,0,1,0,2,3,1
4282,90468,D0SRTJhzsGGnKbIKtAcGeOVG46CDAXxq,bWdj2GDclj5ofokWjzoa5jAwMkxCykd6,6,11,6,0,3,0,5,0,25,3.5714285714285716,2,0.0,0,6,0,3,11,0,0,5,0,9,16,1
4283,90469,3v3FB5XsF44WUQOyhVB1K7TjhxipIjnJ,bWdj2GDclj5ofokWjzoa5jAwMkxCykd6,1,0,0,0,0,0,1,0,1,0.14285714285714285,1,0.0,0,0,0,0,0,0,0,1,0,0,1,1
4284,90471,AcoYRXM9MxEJpHYoq7SsbSwZ8unsRtq3,SpATywNh6bZuzm8s1ceuBUnMUAeoAHHw,6,3,1,0,1,0,2,0,7,1.0,1,0.0,0,1,0,1,3,0,0,2,0,2,5,0
4285,90474,AMP1VomhrLvq0oxaLMgCzayTJQ1U3Z03,SpATywNh6bZuzm8s1ceuBUnMUAeoAHHw,8,8,2,0,0,0,10,1,21,3.0,1,0.0,0,2,0,0,8,0,0,10,1,2,19,1
4286,90479,09hA70zHHsdFY99KewQn0t7W1Th1KuA4,RXDvfPUBYFlVdlueBFbLW0mhhAyGEqpt,21,15,10,22,9,2,8,14,80,11.428571428571429,1,0.0,5,10,18,9,10,2,4,8,14,42,38,1
4287,90480,jJhM7dfbmyu6QnNvOuNIHUQvXzylS9kq,bWdj2GDclj5ofokWjzoa5jAwMkxCykd6,1,0,0,0,0,0,1,0,1,0.14285714285714285,1,0.0,0,0,0,0,0,0,0,1,0,0,1,1
4288,90482,LfSoKi26BKEYZHPv7eOdEODBvG4bpVnt,SpATywNh6bZuzm8s1ceuBUnMUAeoAHHw,8,3,2,0,2,0,4,0,11,1.5714285714285714,1,0.0,0,2,0,2,3,0,0,4,0,4,7,1
4289,90486,4eRAU6q1j8xj2oZfSvPOcocekaK18w9w,RXDvfPUBYFlVdlueBFbLW0mhhAyGEqpt,16,21,3,0,0,2,11,1,38,5.428571428571429,1,0.0,2,3,0,0,19,2,0,11,1,5,33,1
4290,90487,swTV8FwIOGPvq6kDLTbN7KErbstwahnB,RXDvfPUBYFlVdlueBFbLW0mhhAyGEqpt,5,3,2,0,1,0,2,0,8,1.1428571428571428,1,0.0,0,2,0,1,3,0,0,2,0,3,5,1
4291,90491,0Gw9qsZWrsuN96zAJXr0m2eOAANOJE07,SpATywNh6bZuzm8s1ceuBUnMUAeoAHHw,1,0,0,0,0,0,1,0,1,0.14285714285714285,1,0.0,0,0,0,0,0,0,0,1,0,0,1,1
4292,90493,3yfQbyJ9pf1yrEL1gur3tzr8XAtUzfm8,bWdj2GDclj5ofokWjzoa5jAwMkxCykd6,4,2,0,0,0,0,2,0,4,0.5714285714285714,1,0.0,0,0,0,0,2,0,0,2,0,0,4,1
4293,90494,r3ymEDBeAtjd52LKkH7rXxWW6cBfLEDa,bWdj2GDclj5ofokWjzoa5jAwMkxCykd6,10,9,4,0,4,0,6,0,23,3.2857142857142856,1,0.0,2,4,0,4,7,0,0,6,0,10,13,1
4294,90495,IV2jyEJwnx9XuvLUnJBPSDEiQEmkULrq,SpATywNh6bZuzm8s1ceuBUnMUAeoAHHw,13,25,3,17,1,0,8,0,54,7.714285714285714,1,0.0,11,3,15,1,14,0,2,8,0,30,24,1
4295,90504,3uY3PXIjE4xYhALzqv9EDJ3LJju3f4Jc,SpATywNh6bZuzm8s1ceuBUnMUAeoAHHw,7,4,2,0,2,0,2,0,10,1.4285714285714286,1,0.0,0,2,0,2,4,0,0,2,0,4,6,1
4296,90513,rW9Fl0YODiCSMxzLAOKlzYxXd8TfgDcd,RXDvfPUBYFlVdlueBFbLW0mhhAyGEqpt,4,5,2,0,0,0,1,0,8,1.1428571428571428,1,0.0,0,2,0,0,5,0,0,1,0,2,6,1
4297,90518,9D8Fr85Y0xJSTSvXENunTRQkQQzpKKhe,RXDvfPUBYFlVdlueBFbLW0mhhAyGEqpt,41,32,22,48,10,24,7,0,143,20.428571428571427,1,0.0,7,22,46,10,25,24,2,7,0,85,58,1
4298,90519,Xs5JYGOD3p8qnunCvDbRtmUT4YrLSZAt,SpATywNh6bZuzm8s1ceuBUnMUAeoAHHw,5,1,1,0,1,0,2,0,5,0.7142857142857143,1,0.0,0,1,0,1,1,0,0,2,0,2,3,1
4299,90520,JoruyAOmEeM1qjcSEWRUjLvQUHpNPZGp,bWdj2GDclj5ofokWjzoa5jAwMkxCykd6,1,0,0,0,0,0,1,0,1,0.14285714285714285,1,0.0,0,0,0,0,0,0,0,1,0,0,1,1
4300,90523,3CsUz8mRFoFNKmkeENo8HuDQSH05lxmZ,SpATywNh6bZuzm8s1ceuBUnMUAeoAHHw,11,23,0,16,0,3,9,0,51,7.285714285714286,1,0.0,9,0,13,0,14,3,3,9,0,22,29,1
4301,90524,LowLlbmaDUppvngMtOhXYfyftobUC8Pz,SpATywNh6bZuzm8s1ceuBUnMUAeoAHHw,10,6,3,0,2,1,7,1,20,2.857142857142857,1,0.0,1,3,0,2,5,1,0,7,1,6,14,1
4302,90526,w2OxtzQI9blY6H8U919hOBWDDo1sEi62,SpATywNh6bZuzm8s1ceuBUnMUAeoAHHw,14,22,0,28,0,55,20,2,127,18.142857142857142,1,0.0,12,0,22,0,10,55,6,20,2,34,93,1
4303,90527,HtbY3zzP3Q7syMRtSIgdj2lkZgZynozO,bWdj2GDclj5ofokWjzoa5jAwMkxCykd6,8,13,0,24,1,27,7,0,72,10.285714285714286,1,0.0,5,0,22,1,8,27,2,7,0,28,44,1
4304,90528,3DMxdIMHShIiQg7VSSohBgQL1oCtuKe4,SpATywNh6bZuzm8s1ceuBUnMUAeoAHHw,4,3,1,0,1,0,0,0,5,0.7142857142857143,1,0.0,0,1,0,1,3,0,0,0,0,2,3,1
4305,90531,iEQKBpzbjZD62mKeYEyJG967oZGFzYX2,SpATywNh6bZuzm8s1ceuBUnMUAeoAHHw,1,0,0,0,0,0,1,0,1,0.14285714285714285,1,0.0,0,0,0,0,0,0,0,1,0,0,1,0
4306,90532,MBimBV1KD5WZIVxadl6ACFa9rEZi9InE,SpATywNh6bZuzm8s1ceuBUnMUAeoAHHw,6,2,1,0,1,0,4,0,8,1.1428571428571428,1,0.0,0,1,0,1,2,0,0,4,0,2,6,1
4307,90540,M8ZBCZwMuabH0ACZboTe8kVgLwQBa43E,bWdj2GDclj5ofokWjzoa5jAwMkxCykd6,7,5,2,0,2,1,5,1,16,2.2857142857142856,1,0.0,0,2,0,2,5,1,0,5,1,4,12,1
4308,90546,68BjCXfBFqeZ01fFx1csrFmvef5xs0w2,bWdj2GDclj5ofokWjzoa5jAwMkxCykd6,9,8,5,0,4,7,3,0,27,3.857142857142857,2,0.0,1,5,0,4,7,7,0,3,0,10,17,1
4309,90549,Z3cBuyK57dLpleXUvGj6emfcnGidOatN,SpATywNh6bZuzm8s1ceuBUnMUAeoAHHw,10,7,6,0,5,0,2,0,20,2.857142857142857,1,0.0,0,6,0,5,7,0,0,2,0,11,9,1
4310,90550,RNHJpl4xeeRwTYeul6H1SE3f8Bgn5J0c,SpATywNh6bZuzm8s1ceuBUnMUAeoAHHw,11,13,5,0,1,2,7,0,28,4.0,1,0.0,0,5,0,1,13,2,0,7,0,6,22,1
4311,90553,Urctwx56OvAe8Aa2Ler31rqDl5pjO2bG,G8EPVSXsOYB5YQWZGiz1aVq5Pgr2GrQu,20,10,2,24,1,9,16,1,63,9.0,2,0.0,3,2,18,1,7,9,6,16,1,24,39,1
4312,90560,QqAAFsY8kslizUQKd5uhHbFKpFbb6EW2,SpATywNh6bZuzm8s1ceuBUnMUAeoAHHw,14,26,8,17,2,15,5,1,74,10.571428571428571,1,0.0,10,8,14,2,16,15,3,5,1,34,40,0
4313,90564,gpn05NwMGqKm6lLZGRrnOmPlhHxlC7Wb,RXDvfPUBYFlVdlueBFbLW0mhhAyGEqpt,7,5,3,0,1,0,2,0,11,1.5714285714285714,1,0.0,0,3,0,1,5,0,0,2,0,4,7,1
4314,90569,vKmnCHrfJDutyArHoAT9SYM4ChEEDtjx,SpATywNh6bZuzm8s1ceuBUnMUAeoAHHw,3,5,0,0,0,0,1,0,6,0.8571428571428571,1,0.0,0,0,0,0,5,0,0,1,0,0,6,1
4315,90571,i6jKFDXXIDyjle2n9K5Y7L1CTASMdeNx,RXDvfPUBYFlVdlueBFbLW0mhhAyGEqpt,7,2,1,0,1,0,7,13,24,3.4285714285714284,1,0.0,0,1,0,1,2,0,0,7,13,2,22,0
4316,90572,T8mcyrbyEy4XKuvvM213HanZBW8dGO2d,G8EPVSXsOYB5YQWZGiz1aVq5Pgr2GrQu,7,5,1,0,1,0,1,0,8,1.1428571428571428,1,0.0,0,1,0,1,5,0,0,1,0,2,6,1
4317,90581,zH9I9L0RNBBTkWMoTXe4TRjHS1m1XHhV,G8EPVSXsOYB5YQWZGiz1aVq5Pgr2GrQu,10,22,3,12,5,0,3,0,45,6.428571428571429,2,0.0,17,3,9,5,5,0,3,3,0,34,11,1
4318,90583,bXejoPivba2ie50IiUpExTQGL9Tgmtcn,bWdj2GDclj5ofokWjzoa5jAwMkxCykd6,5,2,1,0,1,0,2,0,6,0.8571428571428571,1,0.0,0,1,0,1,2,0,0,2,0,2,4,1
4319,90589,eRKD4Ti4W635KvBhrrkbgHKvnvdw2Idz,SpATywNh6bZuzm8s1ceuBUnMUAeoAHHw,5,2,1,0,1,0,2,0,6,0.8571428571428571,1,0.0,0,1,0,1,2,0,0,2,0,2,4,1
4320,90590,jAHcjIKPY9dlDu300CKSWdNxocPzZC4f,G8EPVSXsOYB5YQWZGiz1aVq5Pgr2GrQu,8,7,3,4,2,0,1,0,17,2.4285714285714284,1,0.0,3,3,3,2,4,0,1,1,0,11,6,1
4321,90592,kYIFQ3xM3QnRCvimArGnWBFWWaGJijmw,RXDvfPUBYFlVdlueBFbLW0mhhAyGEqpt,5,2,1,0,1,0,2,0,6,0.8571428571428571,1,0.0,0,1,0,1,2,0,0,2,0,2,4,1
4322,90597,DFFDn6kzjxm3QeQyKXF89GDFKDcalqmY,bWdj2GDclj5ofokWjzoa5jAwMkxCykd6,4,2,1,0,1,1,1,0,6,0.8571428571428571,1,0.0,0,1,0,1,2,1,0,1,0,2,4,1
4323,90611,1e3hDoCmipyCoPSCkvgArsY66kXMIOjQ,SpATywNh6bZuzm8s1ceuBUnMUAeoAHHw,8,11,3,0,2,1,6,1,24,3.4285714285714284,1,0.0,0,3,0,2,11,1,0,6,1,5,19,1
4324,90612,JqFx1dnEaecJfkuX3GZ1Q8Br4IpDeS68,SpATywNh6bZuzm8s1ceuBUnMUAeoAHHw,5,5,4,0,0,0,1,0,10,1.4285714285714286,1,0.0,0,4,0,0,5,0,0,1,0,4,6,1
4325,90620,7QseuWlQx7k5rV1TFF4oSS2exFRRLKz7,SpATywNh6bZuzm8s1ceuBUnMUAeoAHHw,11,4,2,0,2,1,8,1,18,2.5714285714285716,1,0.0,0,2,0,2,4,1,0,8,1,4,14,1
4326,90627,vDq8yiqHZiGZE0VPuzr41C23TWmY1JqS,SpATywNh6bZuzm8s1ceuBUnMUAeoAHHw,5,4,3,0,1,0,1,0,9,1.2857142857142858,1,0.0,0,3,0,1,4,0,0,1,0,4,5,1
4327,90632,5Dk7QJtqh7ATnN1jDaFE4dN4E1GugvAr,bWdj2GDclj5ofokWjzoa5jAwMkxCykd6,16,31,17,140,6,19,5,0,218,31.142857142857142,2,0.0,6,17,137,6,25,19,3,5,0,166,52,1
4328,90640,3YR1C1jI56LrsXJAUkFoM0M9MuhHAioI,SpATywNh6bZuzm8s1ceuBUnMUAeoAHHw,8,4,1,0,1,0,4,0,10,1.4285714285714286,1,0.0,2,1,0,1,2,0,0,4,0,4,6,1
4329,90643,LvpKAlZO7ziKr9qX3nIahz2mFKsUbwWI,SpATywNh6bZuzm8s1ceuBUnMUAeoAHHw,5,2,1,0,1,0,4,0,8,1.1428571428571428,2,0.0,0,1,0,1,2,0,0,4,0,2,6,1
4330,90647,ATFpemxOxaCS0pUz9OSp5dq4w85WuWvd,SpATywNh6bZuzm8s1ceuBUnMUAeoAHHw,13,22,0,18,0,0,8,2,50,7.142857142857143,1,0.0,6,0,17,0,16,0,1,8,2,23,27,1
4331,90649,CfeENerIdAGepleePWSt0SV88ctt0Tmw,RXDvfPUBYFlVdlueBFbLW0mhhAyGEqpt,1,0,0,0,0,0,1,0,1,0.14285714285714285,1,0.0,0,0,0,0,0,0,0,1,0,0,1,1
4332,90650,cvuy8HaLnRoF5suMAoOqjooUG2AEFLC2,bWdj2GDclj5ofokWjzoa5jAwMkxCykd6,4,2,1,0,1,0,2,0,6,0.8571428571428571,1,0.0,0,1,0,1,2,0,0,2,0,2,4,1
4333,90655,w0NwX9gVv58q1LwNFajcpOhqIprh7BvB,G8EPVSXsOYB5YQWZGiz1aVq5Pgr2GrQu,10,17,2,6,3,0,5,0,33,4.714285714285714,2,0.0,8,2,5,3,9,0,1,5,0,18,15,1
4334,90671,PwGj8ON4yrWpMaoZE0ES8sG2eAqFQNfN,SpATywNh6bZuzm8s1ceuBUnMUAeoAHHw,16,17,10,16,6,11,7,1,68,9.714285714285714,2,0.0,4,10,14,6,13,11,2,7,1,34,34,1
4335,90673,yDc9ZpbUycr11xuvu88deR54WnL37yET,SpATywNh6bZuzm8s1ceuBUnMUAeoAHHw,15,15,7,17,4,2,5,1,51,7.285714285714286,1,0.0,5,7,15,4,10,2,2,5,1,31,20,0
4336,90674,bLDIg7orV5sh30oIBmQ342IswZTJ8Q5l,RXDvfPUBYFlVdlueBFbLW0mhhAyGEqpt,6,7,3,0,2,0,2,0,14,2.0,1,0.0,0,3,0,2,7,0,0,2,0,5,9,1
4337,90676,JrmmYCeYhJwPKrtI75WdL68kxmQcjGg8,SpATywNh6bZuzm8s1ceuBUnMUAeoAHHw,11,12,8,0,5,1,6,1,33,4.714285714285714,3,0.0,0,8,0,5,12,1,0,6,1,13,20,1
4338,90678,wQn1gyWkMsHmRn6FRBCpTkRxPyoDtHcK,G8EPVSXsOYB5YQWZGiz1aVq5Pgr2GrQu,5,12,0,0,1,0,4,0,17,2.4285714285714284,1,0.0,6,0,0,1,6,0,0,4,0,7,10,1
4339,90685,p1glD11J2O4xqRjpc7tPhfftojomVp8l,G8EPVSXsOYB5YQWZGiz1aVq5Pgr2GrQu,2,0,0,0,0,0,2,0,2,0.2857142857142857,1,0.0,0,0,0,0,0,0,0,2,0,0,2,1
4340,90696,H5UEKpeYUS8ZwAU1o3ZTuTx8QVBIM5mj,bWdj2GDclj5ofokWjzoa5jAwMkxCykd6,1,0,0,0,0,0,1,0,1,0.14285714285714285,1,0.0,0,0,0,0,0,0,0,1,0,0,1,1
4341,90700,63wWcpmf1i2NKSiQREiAJYYp7SpsRdNk,SpATywNh6bZuzm8s1ceuBUnMUAeoAHHw,6,4,3,0,2,0,2,0,11,1.5714285714285714,1,0.0,0,3,0,2,4,0,0,2,0,5,6,1
4342,90701,deIsi5BI37iNeLK3sFoXHW9756YDHzUX,SpATywNh6bZuzm8s1ceuBUnMUAeoAHHw,8,5,1,0,0,11,9,1,27,3.857142857142857,1,0.0,0,1,0,0,5,11,0,9,1,1,26,1
4343,90702,ORT6fH4QpWfdVApgOFbiZIUgnndzWNam,bWdj2GDclj5ofokWjzoa5jAwMkxCykd6,6,2,1,0,1,0,4,0,8,1.1428571428571428,1,0.0,0,1,0,1,2,0,0,4,0,2,6,1
4344,90707,oJ9j9ejTgKixczg3tSE8Sg8DPI7YQpJq,bWdj2GDclj5ofokWjzoa5jAwMkxCykd6,8,11,5,0,2,1,4,1,24,3.4285714285714284,1,0.0,3,5,0,2,8,1,0,4,1,10,14,1
4345,90708,rd6AxicG284gxewkDLzJ9mHqaB9eMpej,SpATywNh6bZuzm8s1ceuBUnMUAeoAHHw,5,2,1,0,1,0,2,0,6,0.8571428571428571,1,0.0,0,1,0,1,2,0,0,2,0,2,4,1
4346,90711,YwhJiJdY6sdupy0lRkNRU9p6H4rUPLhl,SpATywNh6bZuzm8s1ceuBUnMUAeoAHHw,2,0,0,0,0,0,3,0,3,0.42857142857142855,1,0.0,0,0,0,0,0,0,0,3,0,0,3,1
4347,90712,sKygNm7l33RvePXhMRKhT8eWlgq4D2Uu,G8EPVSXsOYB5YQWZGiz1aVq5Pgr2GrQu,7,2,1,0,1,0,8,1,13,1.8571428571428572,1,0.0,0,1,0,1,2,0,0,8,1,2,11,1
4348,90714,F56VIhO1QqwJ2EV8tGyI5l1mo3yf3Tk3,bWdj2GDclj5ofokWjzoa5jAwMkxCykd6,3,2,0,0,0,0,2,0,4,0.5714285714285714,1,0.0,0,0,0,0,2,0,0,2,0,0,4,1
4349,90716,D03u0gED7VbQRZXbOTEY3B3RSnOHMTwX,G8EPVSXsOYB5YQWZGiz1aVq5Pgr2GrQu,4,4,1,0,1,0,1,0,7,1.0,1,0.0,0,1,0,1,4,0,0,1,0,2,5,1
4350,90718,tOwol93HcvuFb5zloOErYW1pE3AivbGE,bWdj2GDclj5ofokWjzoa5jAwMkxCykd6,1,0,0,0,0,0,1,0,1,0.14285714285714285,1,0.0,0,0,0,0,0,0,0,1,0,0,1,1
4351,90720,tOwol93HcvuFb5zloOErYW1pE3AivbGE,RXDvfPUBYFlVdlueBFbLW0mhhAyGEqpt,6,2,1,0,1,0,3,0,7,1.0,1,0.0,0,1,0,1,2,0,0,3,0,2,5,1
4352,90722,1UXy9epSRpZ4kgvfm7ijkVKWuglHemTQ,SpATywNh6bZuzm8s1ceuBUnMUAeoAHHw,5,2,1,0,1,0,6,0,10,1.4285714285714286,1,0.0,0,1,0,1,2,0,0,6,0,2,8,0
4353,90729,4TzA065DYK6LuKsj03IdWmVVHtLP4pD7,SpATywNh6bZuzm8s1ceuBUnMUAeoAHHw,6,2,1,0,1,0,3,0,7,1.0,1,0.0,0,1,0,1,2,0,0,3,0,2,5,1
4354,90741,w5OdJoQZNGUVPiCQDXg0Vd0yo9ewUzmW,RXDvfPUBYFlVdlueBFbLW0mhhAyGEqpt,14,10,7,12,4,0,2,0,35,5.0,2,0.0,1,7,12,4,9,0,0,2,0,24,11,1
4355,90743,Y5C6JW9FcrJIhkFtmu7KcSC7Zibilzs4,RXDvfPUBYFlVdlueBFbLW0mhhAyGEqpt,14,15,10,0,4,2,11,2,44,6.285714285714286,2,0.0,0,10,0,4,15,2,0,11,2,14,30,1
4356,90746,ldckbcGV67YBoSN68pz7hDadzOTSpXE4,G8EPVSXsOYB5YQWZGiz1aVq5Pgr2GrQu,7,22,7,0,5,0,3,0,37,5.285714285714286,2,0.0,3,7,0,5,19,0,0,3,0,15,22,1
4357,90747,4f6gBunWwjsaAgYwinaGIAK95dQig1Sv,bWdj2GDclj5ofokWjzoa5jAwMkxCykd6,1,0,0,0,0,0,1,0,1,0.14285714285714285,1,0.0,0,0,0,0,0,0,0,1,0,0,1,1
4358,90749,Y5EybULOrY5dAmMMQWE7bK5wg4bsR2Lr,bWdj2GDclj5ofokWjzoa5jAwMkxCykd6,12,26,14,60,3,61,20,2,186,26.571428571428573,4,0.0,3,14,58,3,23,61,2,20,2,78,108,1
4359,90755,KQaABjEuQepl9FAcsVuUoYwnLleiOaUh,bWdj2GDclj5ofokWjzoa5jAwMkxCykd6,4,4,1,0,2,0,1,0,8,1.1428571428571428,1,0.0,2,1,0,2,2,0,0,1,0,5,3,1
4360,90757,wwEAB1ez2GqscQ96613pzqpcm4gmgk2z,bWdj2GDclj5ofokWjzoa5jAwMkxCykd6,9,13,3,0,5,0,2,0,23,3.2857142857142856,1,0.0,5,3,0,5,8,0,0,2,0,13,10,1
4361,90760,LknZf5R0kFesJr0Rm2KEqD235TVmngp0,SpATywNh6bZuzm8s1ceuBUnMUAeoAHHw,13,11,0,14,0,57,8,1,91,13.0,1,0.0,2,0,11,0,9,57,3,8,1,13,78,1
4362,90761,l4s4x0272kzhcEfgCvz1VNYYSzsAqk0d,G8EPVSXsOYB5YQWZGiz1aVq5Pgr2GrQu,11,8,4,0,3,3,6,0,24,3.4285714285714284,2,0.0,0,4,0,3,8,3,0,6,0,7,17,1
4363,90765,pGY1w8eP7I4lbateXReA0flFyTJRZgPr,G8EPVSXsOYB5YQWZGiz1aVq5Pgr2GrQu,6,1,1,0,1,0,3,0,6,0.8571428571428571,1,0.0,0,1,0,1,1,0,0,3,0,2,4,1
4364,90770,3CsUz8mRFoFNKmkeENo8HuDQSH05lxmZ,G8EPVSXsOYB5YQWZGiz1aVq5Pgr2GrQu,3,0,0,0,0,0,6,0,6,0.8571428571428571,2,0.0,0,0,0,0,0,0,0,6,0,0,6,1
4365,90773,D0SRTJhzsGGnKbIKtAcGeOVG46CDAXxq,SpATywNh6bZuzm8s1ceuBUnMUAeoAHHw,7,8,5,0,3,0,3,0,19,2.7142857142857144,2,0.0,0,5,0,3,8,0,0,3,0,8,11,1
4366,90782,LeyecjAY6mg5LvZFKVpB5z5Vy8PSThxU,SpATywNh6bZuzm8s1ceuBUnMUAeoAHHw,7,6,2,0,2,0,2,0,12,1.7142857142857142,1,0.0,0,2,0,2,6,0,0,2,0,4,8,1
4367,90788,AhMXiVok13ZjNF4gspHPwIDZecQgiWpM,RXDvfPUBYFlVdlueBFbLW0mhhAyGEqpt,1,0,0,0,0,0,1,0,1,0.14285714285714285,1,0.0,0,0,0,0,0,0,0,1,0,0,1,1
4368,90789,bEGwB6bxwamH303rlcp1dTooqcWaF93C,SpATywNh6bZuzm8s1ceuBUnMUAeoAHHw,14,25,1,20,1,14,10,1,72,10.285714285714286,3,0.0,15,1,17,1,10,14,3,10,1,34,38,0
4369,90790,CdOlESGB1DzB9C16eeGe1UhXPsjHWQGW,SpATywNh6bZuzm8s1ceuBUnMUAeoAHHw,13,9,5,13,3,10,3,0,43,6.142857142857143,1,0.0,3,5,12,3,6,10,1,3,0,23,20,1
4370,90794,J38SfNJhh0josFdljlBSrhXRogu9GoqX,G8EPVSXsOYB5YQWZGiz1aVq5Pgr2GrQu,23,56,25,30,7,0,8,0,126,18.0,1,0.0,17,25,23,7,39,0,7,8,0,72,54,1
4371,90799,4LhW0gpz7wD6EZALKqoopL1swej6F6kT,RXDvfPUBYFlVdlueBFbLW0mhhAyGEqpt,8,10,3,0,1,0,4,1,19,2.7142857142857144,2,0.0,0,3,0,1,10,0,0,4,1,4,15,1
4372,90800,HDDfG2CBGcAcxX3ycvOXstF4TGeBz4ZN,G8EPVSXsOYB5YQWZGiz1aVq5Pgr2GrQu,8,4,3,0,3,0,1,0,11,1.5714285714285714,1,0.0,0,3,0,3,4,0,0,1,0,6,5,1
4373,90801,D819UH6GjR554Q5KsACZVpoO8UDhricE,SpATywNh6bZuzm8s1ceuBUnMUAeoAHHw,7,3,2,0,2,0,2,0,9,1.2857142857142858,1,0.0,0,2,0,2,3,0,0,2,0,4,5,1
4374,90811,I2obse1Zq7Nau4sY1YPG5mgE6G3RFVMC,G8EPVSXsOYB5YQWZGiz1aVq5Pgr2GrQu,6,5,4,0,4,0,1,0,14,2.0,1,0.0,0,4,0,4,5,0,0,1,0,8,6,1
4375,90815,iXNm5ZN5LzdJniA2N9BJpNV8u0KUat63,SpATywNh6bZuzm8s1ceuBUnMUAeoAHHw,10,20,7,0,3,0,5,0,35,5.0,2,0.0,0,7,0,3,20,0,0,5,0,10,25,1
4376,90821,pNgGoRZfmUo4wkTYP23egMC3LUn4nA2d,SpATywNh6bZuzm8s1ceuBUnMUAeoAHHw,12,14,6,0,2,1,10,0,33,4.714285714285714,1,0.0,0,6,0,2,14,1,0,10,0,8,25,1
4377,90822,X6bWAuG7i4cSWjzWor8wb8Jqxiw7Y3fM,G8EPVSXsOYB5YQWZGiz1aVq5Pgr2GrQu,20,12,1,36,1,3,2,0,55,7.857142857142857,1,0.0,1,1,29,1,11,3,7,2,0,32,23,1
4378,90824,5vkNIYp2bYY1LtZU7tLxethQegJYgNo1,G8EPVSXsOYB5YQWZGiz1aVq5Pgr2GrQu,4,8,1,0,3,0,1,0,13,1.8571428571428572,1,0.0,6,1,0,3,2,0,0,1,0,10,3,1
4379,90825,06UqVup6ex1qeNp4vJ1m9FBAIaawxt3L,bWdj2GDclj5ofokWjzoa5jAwMkxCykd6,8,5,3,0,2,0,3,0,13,1.8571428571428572,1,0.0,0,3,0,2,5,0,0,3,0,5,8,1
4380,90828,l8KXVCEZbv28Mkels2ilOG7I8qSBHRqR,RXDvfPUBYFlVdlueBFbLW0mhhAyGEqpt,7,8,1,0,1,0,1,0,11,1.5714285714285714,1,0.0,2,1,0,1,6,0,0,1,0,4,7,1
4381,90832,Qsw20Q5PeTwiq1PxYe0LRVTTkwenKksO,SpATywNh6bZuzm8s1ceuBUnMUAeoAHHw,8,13,2,7,0,6,3,0,31,4.428571428571429,2,0.0,0,2,6,0,13,6,1,3,0,8,23,1
4382,90839,5ZwXPjJ7Hpe1sEszjUirFtHlC571EgXW,bWdj2GDclj5ofokWjzoa5jAwMkxCykd6,5,8,1,0,1,0,2,0,12,1.7142857142857142,1,0.0,1,1,0,1,7,0,0,2,0,3,9,1
4383,90848,KrsnHficdQyIsUU0OmJhlaIOPfA02mNz,bWdj2GDclj5ofokWjzoa5jAwMkxCykd6,1,0,0,0,0,0,2,0,2,0.2857142857142857,1,0.0,0,0,0,0,0,0,0,2,0,0,2,1
4384,90850,GWNKqanO7Bwv22F8soWqeHa4Wn2DiLGZ,RXDvfPUBYFlVdlueBFbLW0mhhAyGEqpt,36,32,10,61,8,0,1,0,112,16.0,1,0.0,6,10,59,8,26,0,2,1,0,83,29,1
4385,90855,KogrHROquIJLSXIZqzhYU9Hcb9zVebwT,SpATywNh6bZuzm8s1ceuBUnMUAeoAHHw,13,8,3,10,1,28,5,1,56,8.0,1,0.0,3,3,9,1,5,28,1,5,1,16,40,1
4386,90856,t4mBW06R5u34zTzy1YY0BqHR3HtrMlxW,bWdj2GDclj5ofokWjzoa5jAwMkxCykd6,17,18,9,20,3,11,15,2,78,11.142857142857142,3,0.0,3,9,19,3,15,11,1,15,2,34,44,1
4387,90861,sD4VJ3Pl6fUXDlwP0L4osteHu9UdT1hV,SpATywNh6bZuzm8s1ceuBUnMUAeoAHHw,6,3,1,0,1,0,4,0,9,1.2857142857142858,1,0.0,0,1,0,1,3,0,0,4,0,2,7,1
4388,90863,OuHC5cgkNZAxQ8FoVKCX7NbOcZdwtnqB,SpATywNh6bZuzm8s1ceuBUnMUAeoAHHw,8,11,7,0,4,0,5,0,27,3.857142857142857,1,0.0,0,7,0,4,11,0,0,5,0,11,16,1
4389,90872,nL9fwNKEZP1vFZxFJDQtGgReRFz5AlyD,SpATywNh6bZuzm8s1ceuBUnMUAeoAHHw,8,8,3,0,1,2,6,2,22,3.142857142857143,1,0.0,4,3,0,1,4,2,0,6,2,8,14,1
4390,90875,Qyq18jm4urtOwW9jbqpJJDMX3auyGXK1,SpATywNh6bZuzm8s1ceuBUnMUAeoAHHw,4,2,0,0,0,0,2,0,4,0.5714285714285714,1,0.0,0,0,0,0,2,0,0,2,0,0,4,1
4391,90877,C9Wh4VK0YDPz8OcZLvDPXEYgZvrO7fON,SpATywNh6bZuzm8s1ceuBUnMUAeoAHHw,4,2,1,0,1,0,1,0,5,0.7142857142857143,1,0.0,0,1,0,1,2,0,0,1,0,2,3,1
4392,90878,vIBcYbs1BLdmaaP30fcE2FS7kB7v7QRn,bWdj2GDclj5ofokWjzoa5jAwMkxCykd6,9,20,11,0,1,3,13,0,48,6.857142857142857,2,0.0,2,11,0,1,18,3,0,13,0,14,34,1
4393,90880,YAHRUvgTShfsjnOmO618HsecfyEFFriC,SpATywNh6bZuzm8s1ceuBUnMUAeoAHHw,5,15,3,0,2,0,2,0,22,3.142857142857143,1,0.0,0,3,0,2,15,0,0,2,0,5,17,1
4394,90885,kFMdrBn76woeFkLVMgIjnzYIkBkN2rjs,SpATywNh6bZuzm8s1ceuBUnMUAeoAHHw,5,5,3,0,2,0,1,0,11,1.5714285714285714,1,0.0,0,3,0,2,5,0,0,1,0,5,6,1
4395,90887,GVUw4u2UhYktwQlrJTo9fWmDS2qzWpQC,SpATywNh6bZuzm8s1ceuBUnMUAeoAHHw,16,19,1,22,1,23,10,1,77,11.0,2,0.0,11,1,18,1,8,23,4,10,1,31,46,0
4396,90905,R3vdKqOlKdhOGFVIJPoEGMoTbxTcB9bc,SpATywNh6bZuzm8s1ceuBUnMUAeoAHHw,14,9,6,5,5,1,15,1,42,6.0,2,0.0,0,6,4,5,9,1,1,15,1,15,27,1
4397,90910,8mVKxRgJ8A1rq04XffdKXYfatdM3yRYE,RXDvfPUBYFlVdlueBFbLW0mhhAyGEqpt,8,4,3,0,2,0,2,0,11,1.5714285714285714,1,0.0,0,3,0,2,4,0,0,2,0,5,6,1
4398,90915,HPaDTzk2xymxbpoa0VdcxdHl3uFfOfZk,G8EPVSXsOYB5YQWZGiz1aVq5Pgr2GrQu,1,0,0,0,0,0,1,0,1,0.14285714285714285,1,0.0,0,0,0,0,0,0,0,1,0,0,1,1
4399,90916,nMBGX3nqIipxPIzBJdOaTEwO6lPkrYAP,SpATywNh6bZuzm8s1ceuBUnMUAeoAHHw,9,12,8,0,2,2,8,0,32,4.571428571428571,1,0.0,0,8,0,2,12,2,0,8,0,10,22,1
4400,90918,P8T670PRvYsTF14RAy04Ypel9tVdSt4W,SpATywNh6bZuzm8s1ceuBUnMUAeoAHHw,14,16,3,14,2,1,7,1,44,6.285714285714286,1,0.0,11,3,13,2,5,1,1,7,1,29,15,1
4401,90926,mfSlhGs8TOW9c66xAJCzRN5uCUec3OQS,G8EPVSXsOYB5YQWZGiz1aVq5Pgr2GrQu,4,3,0,0,0,0,1,0,4,0.5714285714285714,1,0.0,0,0,0,0,3,0,0,1,0,0,4,1
4402,90938,qA7txaCsDINVj5jwLkjFxBdOEKcLbkUC,bWdj2GDclj5ofokWjzoa5jAwMkxCykd6,4,8,2,0,2,0,1,0,13,1.8571428571428572,1,0.0,4,2,0,2,4,0,0,1,0,8,5,1
4403,90939,hRiaJRtvIOFlbihdEsv906GxXONnrFfr,SpATywNh6bZuzm8s1ceuBUnMUAeoAHHw,6,11,2,0,1,0,7,0,21,3.0,1,0.0,1,2,0,1,10,0,0,7,0,4,17,1
4404,90951,bmpOpVuzweuue9KaoQwJh1soVS4PCMAj,RXDvfPUBYFlVdlueBFbLW0mhhAyGEqpt,16,7,4,15,5,1,4,0,36,5.142857142857143,1,0.0,2,4,14,5,5,1,1,4,0,25,11,1
4405,90953,hIjUruVScjiqfQ0ERHHhB6StdCOggvbB,RXDvfPUBYFlVdlueBFbLW0mhhAyGEqpt,18,14,5,29,3,0,5,1,57,8.142857142857142,1,0.0,2,5,29,3,12,0,0,5,1,39,18,1
4406,90959,bAPyDIJfdAxQ8AHvo3QeBgdKri2hlVLQ,G8EPVSXsOYB5YQWZGiz1aVq5Pgr2GrQu,1,0,0,0,0,0,1,0,1,0.14285714285714285,1,0.0,0,0,0,0,0,0,0,1,0,0,1,1
4407,90961,h3p30ndtRdIyBMRidOGn8LuOdbmfUl5i,bWdj2GDclj5ofokWjzoa5jAwMkxCykd6,4,2,1,0,0,0,2,0,5,0.7142857142857143,1,0.0,0,1,0,0,2,0,0,2,0,1,4,1
4408,90962,1x68B6ELAKzkC8Z87epaTU9JLE90xrom,SpATywNh6bZuzm8s1ceuBUnMUAeoAHHw,6,10,0,5,0,0,2,0,17,2.4285714285714284,1,0.0,7,0,5,0,3,0,0,2,0,12,5,1
4409,90964,UEGgGFOddxp081siu8g5s2awm2LAgg2C,G8EPVSXsOYB5YQWZGiz1aVq5Pgr2GrQu,5,3,0,0,0,0,2,0,5,0.7142857142857143,1,0.0,0,0,0,0,3,0,0,2,0,0,5,1
4410,90967,8nT76hrzyl8ZAUdI7W6kfrIzHxI3puKM,SpATywNh6bZuzm8s1ceuBUnMUAeoAHHw,1,0,0,0,0,0,1,0,1,0.14285714285714285,1,0.0,0,0,0,0,0,0,0,1,0,0,1,1
4411,90968,1YzhwwWLdVM4bzJMYH49O7nplNitMAxK,SpATywNh6bZuzm8s1ceuBUnMUAeoAHHw,1,0,0,0,0,0,1,0,1,0.14285714285714285,1,0.0,0,0,0,0,0,0,0,1,0,0,1,1
4412,90975,ABlVlNkPi30ZMlFLrcsAhP5jZW6rJhdZ,bWdj2GDclj5ofokWjzoa5jAwMkxCykd6,6,3,2,0,1,0,2,0,8,1.1428571428571428,2,0.0,0,2,0,1,3,0,0,2,0,3,5,1
4413,90976,JgACfbSPbgZxvcoTB7IZVAGzYc3ZbdQl,G8EPVSXsOYB5YQWZGiz1aVq5Pgr2GrQu,18,19,0,0,1,2,8,1,31,4.428571428571429,2,0.0,2,0,0,1,17,2,0,8,1,3,28,1
4414,90980,iKjkh1YrFzq5OB5DSHkFwl9ZdnaqKanG,SpATywNh6bZuzm8s1ceuBUnMUAeoAHHw,5,4,1,0,1,1,2,0,9,1.2857142857142858,1,0.0,1,1,0,1,3,1,0,2,0,3,6,1
4415,90982,P9uew3S2WCP2kqlooRwkV6WK6JXjnFW1,SpATywNh6bZuzm8s1ceuBUnMUAeoAHHw,7,4,1,0,0,1,4,1,11,1.5714285714285714,1,0.0,0,1,0,0,4,1,0,4,1,1,10,1
4416,90990,h3p30ndtRdIyBMRidOGn8LuOdbmfUl5i,SpATywNh6bZuzm8s1ceuBUnMUAeoAHHw,13,8,3,12,2,3,4,1,33,4.714285714285714,1,0.0,3,3,12,2,5,3,0,4,1,20,13,1
4417,90991,MSVIULFa47b8oOycWVWVcPhuMCdDd5NZ,SpATywNh6bZuzm8s1ceuBUnMUAeoAHHw,15,20,12,10,4,5,13,0,64,9.142857142857142,2,0.0,3,12,9,4,17,5,1,13,0,28,36,1
4418,90996,XjO6wB2Z4egz4mV0GhT9a1BmKnwX0iZQ,SpATywNh6bZuzm8s1ceuBUnMUAeoAHHw,7,7,1,0,1,0,2,0,11,1.5714285714285714,1,0.0,3,1,0,1,4,0,0,2,0,5,6,1
4419,91000,69mjZoNGtUdd47OHaI2iQubsVwSBE5CT,SpATywNh6bZuzm8s1ceuBUnMUAeoAHHw,5,3,0,0,0,0,5,0,8,1.1428571428571428,1,0.0,0,0,0,0,3,0,0,5,0,0,8,1
4420,91003,iJftBP3zncmjUCwGWSZ77IUrDb3Dt8rz,bWdj2GDclj5ofokWjzoa5jAwMkxCykd6,4,2,1,0,1,0,1,0,5,0.7142857142857143,1,0.0,0,1,0,1,2,0,0,1,0,2,3,1
4421,91005,h83s4W6wEAiVAQw1YsiHYJozxIiZHoSp,G8EPVSXsOYB5YQWZGiz1aVq5Pgr2GrQu,5,2,1,0,1,1,2,0,7,1.0,1,0.0,0,1,0,1,2,1,0,2,0,2,5,1
4422,91007,fnbOlL6zM0TdpgW3GvlsPHFVJnQSFTyA,SpATywNh6bZuzm8s1ceuBUnMUAeoAHHw,10,13,7,0,6,0,4,0,30,4.285714285714286,2,0.0,0,7,0,6,13,0,0,4,0,13,17,1
4423,91008,UB0nPfUwWgaRThrVeKik4SwdfP63TRHx,SpATywNh6bZuzm8s1ceuBUnMUAeoAHHw,11,25,1,18,0,4,5,0,53,7.571428571428571,1,0.0,5,1,15,0,20,4,3,5,0,21,32,1
4424,91011,UyjpsvsOggyMosfJEuRSeI96eHcBNf41,SpATywNh6bZuzm8s1ceuBUnMUAeoAHHw,6,4,2,3,1,0,1,0,11,1.5714285714285714,1,0.0,1,2,3,1,3,0,0,1,0,7,4,1
4425,91013,bqWpav7ocOhCfb3xc4QgAvBDK5g8BmiZ,bWdj2GDclj5ofokWjzoa5jAwMkxCykd6,5,3,2,0,0,0,3,0,8,1.1428571428571428,1,0.0,0,2,0,0,3,0,0,3,0,2,6,1
4426,91014,dLJ4i4UwjNqr5YPEuySq1h5THPMNjgjJ,SpATywNh6bZuzm8s1ceuBUnMUAeoAHHw,10,8,6,0,5,0,3,0,22,3.142857142857143,2,0.0,0,6,0,5,8,0,0,3,0,11,11,0
4427,91016,KyDM2Ub30UlLqAgwV3Kdja9FjS49F2cL,G8EPVSXsOYB5YQWZGiz1aVq5Pgr2GrQu,4,2,1,0,1,0,1,0,5,0.7142857142857143,1,0.0,0,1,0,1,2,0,0,1,0,2,3,1
4428,91017,zrZWN5ij2KPpDRaiyWWPqj2Z1YuwvTvt,SpATywNh6bZuzm8s1ceuBUnMUAeoAHHw,10,19,7,0,4,5,14,3,52,7.428571428571429,3,0.0,0,7,0,4,19,5,0,14,3,11,41,1
4429,91022,BvTUeUSX8ehdvYqgk6h69dy9HSlBWzXM,G8EPVSXsOYB5YQWZGiz1aVq5Pgr2GrQu,7,31,7,0,3,0,9,0,50,7.142857142857143,1,0.0,3,7,0,3,28,0,0,9,0,13,37,1
4430,91023,ZZzQCzIgfdjMh5GZMagmPbKqCFsmjzqD,SpATywNh6bZuzm8s1ceuBUnMUAeoAHHw,5,2,1,0,1,0,2,0,6,0.8571428571428571,1,0.0,0,1,0,1,2,0,0,2,0,2,4,1
4431,91025,nTeEg9IpivRmreYWiIjMvVlevTAaGMey,SpATywNh6bZuzm8s1ceuBUnMUAeoAHHw,7,5,3,0,2,0,2,0,12,1.7142857142857142,2,0.0,0,3,0,2,5,0,0,2,0,5,7,1
4432,91029,tvqXd520K684wy1KQ0GBsByYs78H3st9,RXDvfPUBYFlVdlueBFbLW0mhhAyGEqpt,1,0,0,0,0,0,1,0,1,0.14285714285714285,1,0.0,0,0,0,0,0,0,0,1,0,0,1,1
4433,91037,mJHwEQabAWgiuu06ZP8aR46SMutI8kEA,SpATywNh6bZuzm8s1ceuBUnMUAeoAHHw,5,2,1,0,1,0,3,0,7,1.0,1,0.0,0,1,0,1,2,0,0,3,0,2,5,1
4434,91045,dB4WDfiw60nGNNAG9g9zNz1Z102rMluZ,SpATywNh6bZuzm8s1ceuBUnMUAeoAHHw,17,9,5,12,3,2,6,1,38,5.428571428571429,1,0.0,2,5,11,3,7,2,1,6,1,21,17,1
4435,91050,Y5EybULOrY5dAmMMQWE7bK5wg4bsR2Lr,RXDvfPUBYFlVdlueBFbLW0mhhAyGEqpt,13,8,7,0,4,0,1,0,20,2.857142857142857,1,0.0,0,7,0,4,8,0,0,1,0,11,9,1
4436,91054,EjR7iUwsiJVzqJrC7t3D1JWVRCEYToml,bWdj2GDclj5ofokWjzoa5jAwMkxCykd6,8,7,1,0,2,24,5,1,40,5.714285714285714,1,0.0,2,1,0,2,5,24,0,5,1,5,35,1
4437,91058,JckOmRdQvE0R24dfuPeUe2DTKfe4tF0h,G8EPVSXsOYB5YQWZGiz1aVq5Pgr2GrQu,2,0,0,0,0,0,4,0,4,0.5714285714285714,1,0.0,0,0,0,0,0,0,0,4,0,0,4,0
4438,91059,YJQCaDByfjoOhBSQklKuzWe4YXgqBr84,SpATywNh6bZuzm8s1ceuBUnMUAeoAHHw,5,3,2,0,2,0,3,0,10,1.4285714285714286,2,0.0,0,2,0,2,3,0,0,3,0,4,6,1
4439,91061,4BM2X3vjiB0KMTdSgJPbb92aYDlCdKqm,SpATywNh6bZuzm8s1ceuBUnMUAeoAHHw,1,0,0,0,0,0,5,0,5,0.7142857142857143,1,0.0,0,0,0,0,0,0,0,5,0,0,5,1
4440,91063,gzBj4rBVIL1BI1dJCkBf6DnSNlOqQIwg,SpATywNh6bZuzm8s1ceuBUnMUAeoAHHw,7,8,0,0,0,4,4,0,16,2.2857142857142856,1,0.0,0,0,0,0,8,4,0,4,0,0,16,1
4441,91066,HvCZ1bV9L7D0erySzp1UH1mW8tuWfYPw,SpATywNh6bZuzm8s1ceuBUnMUAeoAHHw,7,11,5,0,3,3,2,0,24,3.4285714285714284,2,0.0,0,5,0,3,11,3,0,2,0,8,16,1
4442,91070,G1AtiTSNDONQwl0Hl81VRJCbBPxu3bhI,bWdj2GDclj5ofokWjzoa5jAwMkxCykd6,7,4,2,0,1,5,6,0,18,2.5714285714285716,1,0.0,0,2,0,1,4,5,0,6,0,3,15,0
4443,91078,KYLGj0LJWlbOKu0N6ntmca4SUIisJJd9,SpATywNh6bZuzm8s1ceuBUnMUAeoAHHw,1,0,0,0,0,0,4,0,4,0.5714285714285714,1,0.0,0,0,0,0,0,0,0,4,0,0,4,1
4444,91081,U04y5vFf0AfyJVGIOJHlryTyRQEOm5pT,RXDvfPUBYFlVdlueBFbLW0mhhAyGEqpt,6,2,1,0,1,0,4,0,8,1.1428571428571428,2,0.0,0,1,0,1,2,0,0,4,0,2,6,1
4445,91105,ZxvROepgS8uZpWYEjrhlsfyND4f2cw2o,SpATywNh6bZuzm8s1ceuBUnMUAeoAHHw,16,20,11,16,4,3,18,2,74,10.571428571428571,1,0.0,5,11,13,4,15,3,3,18,2,33,41,0
4446,91108,nJUQO0awidSkRki1FSo1rhLXdIxrzKfS,G8EPVSXsOYB5YQWZGiz1aVq5Pgr2GrQu,22,28,4,34,4,8,11,1,90,12.857142857142858,4,0.0,5,4,28,4,23,8,6,11,1,41,49,0
4447,91110,9jYO2Na9DSPgmUyIaCnH33KjtnbI2MPN,SpATywNh6bZuzm8s1ceuBUnMUAeoAHHw,8,4,3,0,3,0,1,0,11,1.5714285714285714,1,0.0,0,3,0,3,4,0,0,1,0,6,5,1
4448,91111,Bx6FqxWgsWymyOwxFcEQZn8BP7GPaoEm,G8EPVSXsOYB5YQWZGiz1aVq5Pgr2GrQu,8,5,3,0,1,0,12,0,21,3.0,1,0.0,0,3,0,1,5,0,0,12,0,4,17,1
4449,91115,fAwXW6DQAyNHjMN17jlyBSVcZRO4da21,SpATywNh6bZuzm8s1ceuBUnMUAeoAHHw,14,32,12,14,7,3,5,0,73,10.428571428571429,2,0.0,4,12,12,7,28,3,2,5,0,35,38,1
4450,91116,K1IqR71Sh84XFi6onZppsnD3thTHQIxV,SpATywNh6bZuzm8s1ceuBUnMUAeoAHHw,13,16,11,0,8,1,11,1,48,6.857142857142857,3,0.0,0,11,0,8,16,1,0,11,1,19,29,1
4451,91117,BbiSpjLUYXccDuntMMtC8mx0riONNKqb,bWdj2GDclj5ofokWjzoa5jAwMkxCykd6,5,2,1,0,1,0,2,0,6,0.8571428571428571,1,0.0,0,1,0,1,2,0,0,2,0,2,4,1
4452,91121,7LnOg1xHmRDTcvzCdFBumEhAPUujuxnu,SpATywNh6bZuzm8s1ceuBUnMUAeoAHHw,7,12,1,0,1,0,4,0,18,2.5714285714285716,1,0.0,0,1,0,1,12,0,0,4,0,2,16,1
4453,91124,EiO5bky9R1Iqlpv4ItUpPBUgGb1eJItE,RXDvfPUBYFlVdlueBFbLW0mhhAyGEqpt,1,0,0,0,0,0,1,0,1,0.14285714285714285,1,0.0,0,0,0,0,0,0,0,1,0,0,1,1
4454,91127,Dtyef0XPp5AB6qcxARHBVaIqOwKhnCJD,RXDvfPUBYFlVdlueBFbLW0mhhAyGEqpt,17,17,12,14,6,13,6,0,68,9.714285714285714,1,0.0,1,12,13,6,16,13,1,6,0,32,36,1
4455,91131,q5brbl1IUGTW0QCDlsOmPM8P083V7zR9,SpATywNh6bZuzm8s1ceuBUnMUAeoAHHw,1,0,0,0,0,0,1,0,1,0.14285714285714285,1,0.0,0,0,0,0,0,0,0,1,0,0,1,1
4456,91132,92Eer7xGYFDCorN4RAF4CYzwZt5RGCcT,SpATywNh6bZuzm8s1ceuBUnMUAeoAHHw,1,0,0,0,0,0,1,0,1,0.14285714285714285,1,0.0,0,0,0,0,0,0,0,1,0,0,1,1
4457,91143,hx5sJ7jwWSrYbv8AAwrwIYlkyA5lh0xw,SpATywNh6bZuzm8s1ceuBUnMUAeoAHHw,2,0,0,0,0,0,2,0,2,0.2857142857142857,1,0.0,0,0,0,0,0,0,0,2,0,0,2,1
4458,91145,im3SIH2rxe8iUb1VWEDrDsuvwOO0Qeuq,SpATywNh6bZuzm8s1ceuBUnMUAeoAHHw,1,0,0,0,0,0,1,0,1,0.14285714285714285,1,0.0,0,0,0,0,0,0,0,1,0,0,1,1
4459,91146,5kux74rVeqoEvbABYMpdIOO6ta3zLim7,SpATywNh6bZuzm8s1ceuBUnMUAeoAHHw,6,10,1,0,0,0,3,0,14,2.0,1,0.0,0,1,0,0,10,0,0,3,0,1,13,1
4460,91148,mirL98pOfRc0QA1dI8m4EOtFFog8KIsB,SpATywNh6bZuzm8s1ceuBUnMUAeoAHHw,6,11,2,0,0,0,3,0,16,2.2857142857142856,3,0.0,0,2,0,0,11,0,0,3,0,2,14,1
4461,91151,EpEDPL39pwbGw6HcHWJhf2GDqySvaN1h,SpATywNh6bZuzm8s1ceuBUnMUAeoAHHw,6,2,1,0,1,0,2,0,6,0.8571428571428571,1,0.0,0,1,0,1,2,0,0,2,0,2,4,1
4462,91158,B4jOMU8eQLApET1YBx1fXCzcdODxsgi8,bWdj2GDclj5ofokWjzoa5jAwMkxCykd6,7,9,1,0,2,0,2,0,14,2.0,1,0.0,2,1,0,2,7,0,0,2,0,5,9,1
4463,91159,O7hnrNbVuVSYYY4GiDlB8jr4kCwVIU3W,SpATywNh6bZuzm8s1ceuBUnMUAeoAHHw,1,0,0,0,0,0,7,0,7,1.0,1,0.0,0,0,0,0,0,0,0,7,0,0,7,1
4464,91160,urxyBMLwqPoccprp1W7NCQtPStGZDqxd,SpATywNh6bZuzm8s1ceuBUnMUAeoAHHw,5,2,1,0,1,0,2,0,6,0.8571428571428571,1,0.0,0,1,0,1,2,0,0,2,0,2,4,1
4465,91162,ORT6fH4QpWfdVApgOFbiZIUgnndzWNam,SpATywNh6bZuzm8s1ceuBUnMUAeoAHHw,15,23,14,14,7,3,5,0,66,9.428571428571429,2,0.0,6,14,11,7,17,3,3,5,0,38,28,0
4466,91167,XMtcnsDNasKCOMBWrsjCVH5NONQyEryR,bWdj2GDclj5ofokWjzoa5jAwMkxCykd6,18,26,12,122,6,0,10,0,176,25.142857142857142,2,0.0,9,12,118,6,17,0,4,10,0,145,31,0
4467,91171,XMIsZqrfw7qqk0EIVzNsPndKXVTScrCr,SpATywNh6bZuzm8s1ceuBUnMUAeoAHHw,16,22,10,17,4,5,7,1,66,9.428571428571429,1,0.0,6,10,15,4,16,5,2,7,1,35,31,1
4468,91172,EJfQNb5Mu8lcO1ocmk4PtmUhkW8FMGb9,RXDvfPUBYFlVdlueBFbLW0mhhAyGEqpt,5,7,2,0,1,0,2,0,12,1.7142857142857142,2,0.0,0,2,0,1,7,0,0,2,0,3,9,0
4469,91173,wdzOHZGShaydEKxmovJEzQ6EMiqynMte,SpATywNh6bZuzm8s1ceuBUnMUAeoAHHw,14,50,14,26,0,18,11,2,121,17.285714285714285,3,0.0,29,14,20,0,21,18,6,11,2,63,58,1
4470,91178,ogkoDosyBhbZAvybtPbmcuc4tjatNf2P,G8EPVSXsOYB5YQWZGiz1aVq5Pgr2GrQu,15,32,27,16,16,0,3,0,94,13.428571428571429,1,0.0,0,27,13,16,32,0,3,3,0,56,38,1
4471,91182,H1VDSbfLdFN8dYSqCsn4o54mYdltgayR,SpATywNh6bZuzm8s1ceuBUnMUAeoAHHw,1,0,0,0,0,0,1,0,1,0.14285714285714285,1,0.0,0,0,0,0,0,0,0,1,0,0,1,1
4472,91184,v5DL1tRN6AvAeQThFmEHNCo6sn5M6uIG,SpATywNh6bZuzm8s1ceuBUnMUAeoAHHw,12,14,6,19,4,0,1,0,44,6.285714285714286,1,0.0,5,6,17,4,9,0,2,1,0,32,12,1
4473,91190,HHjw6PARN0UbkiffbOwvG4RULtVIyY0R,bWdj2GDclj5ofokWjzoa5jAwMkxCykd6,1,0,0,0,0,0,1,0,1,0.14285714285714285,1,0.0,0,0,0,0,0,0,0,1,0,0,1,1
4474,91204,JwpnWAbXqqokshNbyxBH2QHaOUPb8wrj,G8EPVSXsOYB5YQWZGiz1aVq5Pgr2GrQu,8,14,0,0,0,1,8,1,24,3.4285714285714284,1,0.0,1,0,0,0,13,1,0,8,1,1,23,0
4475,91207,37tZi453KKWhJoY7icXXq6XTM7CZX5cD,SpATywNh6bZuzm8s1ceuBUnMUAeoAHHw,14,16,0,21,0,3,10,2,52,7.428571428571429,1,0.0,4,0,17,0,12,3,4,10,2,21,31,1
4476,91208,tPYh43YRHAzuf09xESxSKtWvST0aCsjn,RXDvfPUBYFlVdlueBFbLW0mhhAyGEqpt,1,0,0,0,0,0,1,0,1,0.14285714285714285,1,0.0,0,0,0,0,0,0,0,1,0,0,1,1
4477,91214,Rd7eeroPlO4BVZv0bnl0CqHm3u7jCGNe,SpATywNh6bZuzm8s1ceuBUnMUAeoAHHw,12,17,8,0,6,6,4,0,41,5.857142857142857,1,0.0,0,8,0,6,17,6,0,4,0,14,27,1
4478,91215,AXWWqNDiRDejTjo5V7yUaMbjtzXKhlP0,bWdj2GDclj5ofokWjzoa5jAwMkxCykd6,6,5,2,0,1,3,3,0,14,2.0,1,0.0,2,2,0,1,3,3,0,3,0,5,9,1
4479,91217,Zw1bdKbgaMzUzlqlieQSaucEQ8wggZlx,G8EPVSXsOYB5YQWZGiz1aVq5Pgr2GrQu,9,14,5,0,3,0,3,0,25,3.5714285714285716,1,0.0,0,5,0,3,14,0,0,3,0,8,17,1
4480,91220,TXdA343riqqgy7iMdaooNvyNV5wjOdTg,SpATywNh6bZuzm8s1ceuBUnMUAeoAHHw,1,0,0,0,0,0,3,0,3,0.42857142857142855,1,0.0,0,0,0,0,0,0,0,3,0,0,3,1
4481,91221,2FMy3BDMeRecSDtTTnOKB2d19YsmeIUm,SpATywNh6bZuzm8s1ceuBUnMUAeoAHHw,17,15,9,6,5,12,11,2,60,8.571428571428571,1,0.0,4,9,6,5,11,12,0,11,2,24,36,1
4482,91228,14pD3OA8ZEvWCgDfU1fYkv0M9pXxNW5u,SpATywNh6bZuzm8s1ceuBUnMUAeoAHHw,14,34,0,19,0,11,14,5,83,11.857142857142858,2,0.0,15,0,17,0,19,11,2,14,5,32,51,0
4483,91243,eds8bJvJ9xWp5J9qVgS3pSKJpcp9ssMO,RXDvfPUBYFlVdlueBFbLW0mhhAyGEqpt,18,22,11,20,5,0,5,0,63,9.0,1,0.0,4,11,20,5,18,0,0,5,0,40,23,1
4484,91250,XdYuk6m8JAApvXFcBONfmeC52I0301IJ,SpATywNh6bZuzm8s1ceuBUnMUAeoAHHw,3,2,0,0,0,0,1,0,3,0.42857142857142855,1,0.0,0,0,0,0,2,0,0,1,0,0,3,1
4485,91251,69mjZoNGtUdd47OHaI2iQubsVwSBE5CT,RXDvfPUBYFlVdlueBFbLW0mhhAyGEqpt,7,3,2,0,1,1,6,1,14,2.0,2,0.0,0,2,0,1,3,1,0,6,1,3,11,1
4486,91253,XdYuk6m8JAApvXFcBONfmeC52I0301IJ,G8EPVSXsOYB5YQWZGiz1aVq5Pgr2GrQu,3,2,0,0,0,0,1,0,3,0.42857142857142855,1,0.0,0,0,0,0,2,0,0,1,0,0,3,1
4487,91254,3BYgVMhPAaxlk6STVmLlShJjZEZk9Ygh,G8EPVSXsOYB5YQWZGiz1aVq5Pgr2GrQu,7,5,4,8,2,0,1,0,20,2.857142857142857,1,0.0,0,4,6,2,5,0,2,1,0,12,8,1
4488,91257,WCmDosmdgfMjDVmsfhMjruGatZmceBZ1,G8EPVSXsOYB5YQWZGiz1aVq5Pgr2GrQu,10,10,1,0,2,2,8,2,25,3.5714285714285716,1,0.0,4,1,0,2,6,2,0,8,2,7,18,1
4489,91263,mpFcyQQmc8dk989EyC0qjuZYiRIdPGUA,G8EPVSXsOYB5YQWZGiz1aVq5Pgr2GrQu,15,14,11,18,5,0,2,0,50,7.142857142857143,2,0.0,0,11,14,5,14,0,4,2,0,30,20,1
4490,91264,Ydgz8POU25ETYijca209j0OeGw9lAoWU,RXDvfPUBYFlVdlueBFbLW0mhhAyGEqpt,6,3,2,0,1,1,4,1,12,1.7142857142857142,1,0.0,0,2,0,1,3,1,0,4,1,3,9,1
4491,91270,1g8yBUc3cHuCmwlbkVdrck4LA6Kk4jp8,SpATywNh6bZuzm8s1ceuBUnMUAeoAHHw,1,0,0,0,0,0,1,0,1,0.14285714285714285,1,0.0,0,0,0,0,0,0,0,1,0,0,1,1
4492,91271,xsGCEWhbZlUdlgrI9YmAsQkfbCuoHlqr,SpATywNh6bZuzm8s1ceuBUnMUAeoAHHw,3,2,0,0,0,0,1,0,3,0.42857142857142855,1,0.0,0,0,0,0,2,0,0,1,0,0,3,1
4493,91272,Xl4Lzddy8Aw3656QCmyajshZUF8lGm25,G8EPVSXsOYB5YQWZGiz1aVq5Pgr2GrQu,8,5,3,0,1,4,3,1,17,2.4285714285714284,1,0.0,0,3,0,1,5,4,0,3,1,4,13,1
4494,91274,Ub05s2SQ9ZHQTwcGaeWGVwMVL3ugFxRh,SpATywNh6bZuzm8s1ceuBUnMUAeoAHHw,18,19,8,11,3,2,9,1,53,7.571428571428571,2,0.0,8,8,11,3,11,2,0,9,1,30,23,1
4495,91278,g5Cdwy5RdXfNsnVJb5dTAjZFbf2MEVG0,bWdj2GDclj5ofokWjzoa5jAwMkxCykd6,5,13,7,0,5,0,3,0,28,4.0,2,0.0,0,7,0,5,13,0,0,3,0,12,16,1
4496,91284,3a9jnl6D615xvyDPr3X72Qm6tyAqQDq6,SpATywNh6bZuzm8s1ceuBUnMUAeoAHHw,5,0,0,0,0,2,6,1,9,1.2857142857142858,1,0.0,0,0,0,0,0,2,0,6,1,0,9,1
4497,91287,Xl4Lzddy8Aw3656QCmyajshZUF8lGm25,SpATywNh6bZuzm8s1ceuBUnMUAeoAHHw,14,19,6,22,3,8,4,0,62,8.857142857142858,1,0.0,10,6,19,3,9,8,3,4,0,38,24,1
4498,91299,3lDn61j7LQx2ct2mXSyFAxE4I2joOjdi,SpATywNh6bZuzm8s1ceuBUnMUAeoAHHw,16,16,5,19,3,4,7,1,55,7.857142857142857,1,0.0,10,5,16,3,6,4,3,7,1,34,21,1
4499,91300,UZj9qZ6lkWkIz7HEEFyBh5LFRNaz4SI2,SpATywNh6bZuzm8s1ceuBUnMUAeoAHHw,11,15,1,6,1,0,4,0,27,3.857142857142857,3,0.0,0,1,5,1,15,0,1,4,0,7,20,1
4500,91302,CuRQgxEa02jfJLJUhEm7AKFBwc2Dt3PE,SpATywNh6bZuzm8s1ceuBUnMUAeoAHHw,10,15,7,7,0,0,4,0,33,4.714285714285714,1,0.0,0,7,6,0,15,0,1,4,0,13,20,1
4501,91304,VYmODogcHFHSX4vALahPhItYfFc245Hp,RXDvfPUBYFlVdlueBFbLW0mhhAyGEqpt,21,28,17,31,5,1,9,0,91,13.0,2,0.0,5,17,26,5,23,1,5,9,0,53,38,1
4502,91307,MHM1aXC71Dw383yBooXdYF1qDKYHoccv,bWdj2GDclj5ofokWjzoa5jAwMkxCykd6,1,0,0,0,0,0,1,0,1,0.14285714285714285,1,0.0,0,0,0,0,0,0,0,1,0,0,1,1
4503,91310,MHM1aXC71Dw383yBooXdYF1qDKYHoccv,SpATywNh6bZuzm8s1ceuBUnMUAeoAHHw,4,2,1,0,1,0,2,0,6,0.8571428571428571,1,0.0,0,1,0,1,2,0,0,2,0,2,4,1
4504,91312,LmrXz112hM3lsrkiQcTLgB1CQdX7OPmf,RXDvfPUBYFlVdlueBFbLW0mhhAyGEqpt,23,22,16,30,10,1,5,1,85,12.142857142857142,1,0.0,4,16,27,10,18,1,3,5,1,57,28,1
4505,91325,q5vo1hp0Q9QDxbtjHEkZyC7Vz9AYHKaw,G8EPVSXsOYB5YQWZGiz1aVq5Pgr2GrQu,1,0,0,0,0,0,1,0,1,0.14285714285714285,1,0.0,0,0,0,0,0,0,0,1,0,0,1,1
4506,91328,OZaq72DmJH6bReA6lKvO4XbWYjmwsu42,bWdj2GDclj5ofokWjzoa5jAwMkxCykd6,13,11,4,64,3,0,4,0,86,12.285714285714286,3,0.0,4,4,60,3,7,0,4,4,0,71,15,1
4507,91333,xRrdKDq0SR8avtZTCYAseO6HdCVb8m0M,bWdj2GDclj5ofokWjzoa5jAwMkxCykd6,9,13,5,43,2,13,8,6,90,12.857142857142858,1,0.0,5,5,42,2,8,13,1,8,6,54,36,1
4508,91337,OtHqAfAnlt18GaEWyak2S1YVbRKxCTZV,bWdj2GDclj5ofokWjzoa5jAwMkxCykd6,1,0,0,0,0,0,1,0,1,0.14285714285714285,1,0.0,0,0,0,0,0,0,0,1,0,0,1,1
4509,91346,b4VAhvG3MG7lVRCMYGT7EV06rJVZjoZJ,SpATywNh6bZuzm8s1ceuBUnMUAeoAHHw,6,5,1,0,1,0,2,0,9,1.2857142857142858,2,0.0,0,1,0,1,5,0,0,2,0,2,7,1
4510,91357,CqJyXqN2l3WOJQLqxchvfRFp3seiLXw6,bWdj2GDclj5ofokWjzoa5jAwMkxCykd6,6,8,3,0,2,0,2,1,16,2.2857142857142856,1,0.0,3,3,0,2,5,0,0,2,1,8,8,1
4511,91358,za2dBkPPLD9IPRBjooK7GJit2ulI5UgN,RXDvfPUBYFlVdlueBFbLW0mhhAyGEqpt,1,0,0,0,0,0,1,0,1,0.14285714285714285,1,0.0,0,0,0,0,0,0,0,1,0,0,1,1
4512,91359,qlATuCCqDpQGO38aosxnvWXoyFwzEQc6,SpATywNh6bZuzm8s1ceuBUnMUAeoAHHw,1,0,0,0,0,0,1,0,1,0.14285714285714285,1,0.0,0,0,0,0,0,0,0,1,0,0,1,1
4513,91360,Y7IgoRAqVJfNlsulCSI4HObujHPSzoLA,bWdj2GDclj5ofokWjzoa5jAwMkxCykd6,16,27,13,18,8,1,5,0,72,10.285714285714286,1,0.0,9,13,15,8,18,1,3,5,0,45,27,1
4514,91363,LrkrvySxDPWP0dPv0sy62S8XY8vaxevX,SpATywNh6bZuzm8s1ceuBUnMUAeoAHHw,1,0,0,0,0,0,1,0,1,0.14285714285714285,1,0.0,0,0,0,0,0,0,0,1,0,0,1,1
4515,91364,PERCKVrZOUZ9ZmdU3J0Mwd1TZrMvK8yc,bWdj2GDclj5ofokWjzoa5jAwMkxCykd6,1,0,0,0,0,0,1,0,1,0.14285714285714285,1,0.0,0,0,0,0,0,0,0,1,0,0,1,1
4516,91370,A8jyl8S1kU5U2ikqJ1w16Eh9QcSPe3kU,bWdj2GDclj5ofokWjzoa5jAwMkxCykd6,10,6,2,36,1,14,9,0,68,9.714285714285714,3,0.0,1,2,35,1,5,14,1,9,0,39,29,1
4517,91372,KdRLGDNkLtrOcdNI9HZrV8CuGZ4u276z,SpATywNh6bZuzm8s1ceuBUnMUAeoAHHw,6,3,2,0,2,0,1,0,8,1.1428571428571428,1,0.0,0,2,0,2,3,0,0,1,0,4,4,1
4518,91378,2GLZl96ZIgoKdw26t6xniq9LngPm9HvA,RXDvfPUBYFlVdlueBFbLW0mhhAyGEqpt,1,0,0,0,0,0,1,0,1,0.14285714285714285,1,0.0,0,0,0,0,0,0,0,1,0,0,1,1
4519,91382,UmS6fyVqoZGfOpZXm4pjngyByXpv5BZq,SpATywNh6bZuzm8s1ceuBUnMUAeoAHHw,2,0,0,0,0,0,2,0,2,0.2857142857142857,1,0.0,0,0,0,0,0,0,0,2,0,0,2,1
4520,91400,mP7T5RBRG5ILBmmKKL1ktjST3p6gGZyD,G8EPVSXsOYB5YQWZGiz1aVq5Pgr2GrQu,27,33,16,54,10,8,17,3,141,20.142857142857142,2,0.0,7,16,46,10,26,8,8,17,3,79,62,0
4521,91402,95hqHTSw1gz1emf3tVFfyk36gKJr0SpD,SpATywNh6bZuzm8s1ceuBUnMUAeoAHHw,5,2,1,0,1,0,3,0,7,1.0,1,0.0,0,1,0,1,2,0,0,3,0,2,5,1
4522,91403,poUZo66KaOJLyZ89MU32hotzwVV9BV0u,SpATywNh6bZuzm8s1ceuBUnMUAeoAHHw,11,9,0,10,0,4,6,2,31,4.428571428571429,1,0.0,2,0,8,0,7,4,2,6,2,10,21,1
4523,91412,WS43utSG33bYCMf9KzrbX5AdwBBQGbjp,G8EPVSXsOYB5YQWZGiz1aVq5Pgr2GrQu,7,2,1,0,1,0,4,1,9,1.2857142857142858,1,0.0,0,1,0,1,2,0,0,4,1,2,7,1
4524,91418,guY4SSn1fy4TWThod7s2lBFrUtiOX15g,SpATywNh6bZuzm8s1ceuBUnMUAeoAHHw,1,0,0,0,0,0,1,0,1,0.14285714285714285,1,0.0,0,0,0,0,0,0,0,1,0,0,1,1
4525,91425,Kp4YCt5gbTMeLX4vxDVqvPhrGDdHDcEC,bWdj2GDclj5ofokWjzoa5jAwMkxCykd6,1,0,0,0,0,0,1,0,1,0.14285714285714285,1,0.0,0,0,0,0,0,0,0,1,0,0,1,1
4526,91440,FiJs6t54TQx94XiEoXWiArjFjkJV5FwV,SpATywNh6bZuzm8s1ceuBUnMUAeoAHHw,5,2,1,0,1,0,2,0,6,0.8571428571428571,1,0.0,0,1,0,1,2,0,0,2,0,2,4,1
4527,91443,KUB7X44VbEjxMDVZF3W29K5D0UgPC6KH,SpATywNh6bZuzm8s1ceuBUnMUAeoAHHw,1,0,0,0,0,0,1,0,1,0.14285714285714285,1,0.0,0,0,0,0,0,0,0,1,0,0,1,1
4528,91447,tf4ZGAY33jZAuxFy4GuZb8bCcW9cJu8C,SpATywNh6bZuzm8s1ceuBUnMUAeoAHHw,1,0,0,0,0,0,3,0,3,0.42857142857142855,1,0.0,0,0,0,0,0,0,0,3,0,0,3,1
4529,91448,IRULN38M25Cl78bawBWQTQjcpwpaaNDt,SpATywNh6bZuzm8s1ceuBUnMUAeoAHHw,12,19,0,19,0,2,9,4,53,7.571428571428571,2,0.0,9,0,15,0,10,2,4,9,4,24,29,1
4530,91455,iXxs6D3heezRYy4j7tliC14ux3klsjwX,SpATywNh6bZuzm8s1ceuBUnMUAeoAHHw,9,7,0,10,0,0,4,0,21,3.0,2,0.0,2,0,8,0,5,0,2,4,0,10,11,1
4531,91470,QGuKTIBC2KLaYpPdOnB4nXCWgxMM1Dog,SpATywNh6bZuzm8s1ceuBUnMUAeoAHHw,7,4,3,0,2,0,1,0,10,1.4285714285714286,1,0.0,0,3,0,2,4,0,0,1,0,5,5,0
4532,91476,TRCrdidmG6eXWyA1xpJbOiCViWff58Ia,RXDvfPUBYFlVdlueBFbLW0mhhAyGEqpt,35,26,16,42,11,1,6,0,102,14.571428571428571,2,0.0,5,16,39,11,21,1,3,6,0,71,31,1
4533,91479,7wwnUxCzQI2wyfpl5OyzTa3WTS3Ri45e,bWdj2GDclj5ofokWjzoa5jAwMkxCykd6,8,9,5,0,2,1,13,1,31,4.428571428571429,4,0.0,0,5,0,2,9,1,0,13,1,7,24,1
4534,91482,LOVxi1n45DRmVnmmx6W7w15Zc3W4DL9Q,SpATywNh6bZuzm8s1ceuBUnMUAeoAHHw,5,2,1,0,1,0,2,0,6,0.8571428571428571,1,0.0,0,1,0,1,2,0,0,2,0,2,4,1
4535,91485,iEQmrsDBbeOrnopk2RwtHZMbNkoYEU8q,SpATywNh6bZuzm8s1ceuBUnMUAeoAHHw,13,12,5,0,3,1,7,1,29,4.142857142857143,1,0.0,2,5,0,3,10,1,0,7,1,10,19,0
4536,91491,CwyOL3RMOVLomxrxyN9D4jPa9R0iWrS5,SpATywNh6bZuzm8s1ceuBUnMUAeoAHHw,15,11,5,7,3,1,10,1,38,5.428571428571429,2,0.0,4,5,7,3,7,1,0,10,1,19,19,1
4537,91494,Zdseq1rQmkAi5wZl57d3RwjzOxlL3B5I,bWdj2GDclj5ofokWjzoa5jAwMkxCykd6,1,0,0,0,0,0,1,0,1,0.14285714285714285,1,0.0,0,0,0,0,0,0,0,1,0,0,1,1
4538,91496,iX8db0h4bK73Weo8AP1BXtlfn6xSOf6w,bWdj2GDclj5ofokWjzoa5jAwMkxCykd6,6,7,4,0,2,0,7,0,20,2.857142857142857,2,0.0,1,4,0,2,6,0,0,7,0,7,13,1
4539,91500,cGHoibSqVUbVlKoJgTJL9GQ2AhPLVzAA,SpATywNh6bZuzm8s1ceuBUnMUAeoAHHw,5,2,1,0,1,0,2,0,6,0.8571428571428571,1,0.0,0,1,0,1,2,0,0,2,0,2,4,1
4540,91505,NjgQeSBBMWIwQySsR5ymtqiugkMaOyYh,SpATywNh6bZuzm8s1ceuBUnMUAeoAHHw,6,10,4,0,0,0,3,0,17,2.4285714285714284,1,0.0,1,4,0,0,9,0,0,3,0,5,12,1
4541,91508,CoIppafSfTN9XDj22SO0MlvO24IGW3qc,SpATywNh6bZuzm8s1ceuBUnMUAeoAHHw,5,3,1,0,1,0,2,0,7,1.0,1,0.0,0,1,0,1,3,0,0,2,0,2,5,1
4542,91509,sytW49I21SJ70ElOkXGU5SHeeHl1E3fL,bWdj2GDclj5ofokWjzoa5jAwMkxCykd6,9,7,3,4,1,0,9,2,26,3.7142857142857144,2,0.0,1,3,3,1,6,0,1,9,2,8,18,1
4543,91515,HMYpimZGFgj5IczDutkfjUfnxl45PoHW,bWdj2GDclj5ofokWjzoa5jAwMkxCykd6,12,20,12,0,6,1,8,1,48,6.857142857142857,3,0.0,3,12,0,6,17,1,0,8,1,21,27,1
4544,91519,INi9R682jCcjSCeRDCpuPIJvFgA3WCPK,SpATywNh6bZuzm8s1ceuBUnMUAeoAHHw,4,4,0,0,0,0,3,0,7,1.0,1,0.0,0,0,0,0,4,0,0,3,0,0,7,1
4545,91523,zTDlJM8GToOfxmvivD5zWrgVHrXjTey0,SpATywNh6bZuzm8s1ceuBUnMUAeoAHHw,5,3,1,0,1,0,1,0,6,0.8571428571428571,1,0.0,0,1,0,1,3,0,0,1,0,2,4,1
4546,91527,8Juk29xSxX3yy5MeVUlmmq4TGH5jCyZl,bWdj2GDclj5ofokWjzoa5jAwMkxCykd6,1,0,0,0,0,0,1,0,1,0.14285714285714285,1,0.0,0,0,0,0,0,0,0,1,0,0,1,1
4547,91546,4ZKN4qjeNhliROr2sm8vB8zmpPTrlPXO,bWdj2GDclj5ofokWjzoa5jAwMkxCykd6,1,0,0,0,0,0,1,0,1,0.14285714285714285,1,0.0,0,0,0,0,0,0,0,1,0,0,1,1
4548,91551,HRDkxtbUq1mjWiCFLcR4tjQW2mCEHxu4,RXDvfPUBYFlVdlueBFbLW0mhhAyGEqpt,18,25,14,0,9,8,20,13,89,12.714285714285714,2,0.0,3,14,0,9,22,8,0,20,13,26,63,1
4549,91553,95ZATSYX39rVcaPDxHBCcw9smfWWWOJE,G8EPVSXsOYB5YQWZGiz1aVq5Pgr2GrQu,4,2,0,0,0,0,2,0,4,0.5714285714285714,1,0.0,0,0,0,0,2,0,0,2,0,0,4,1
4550,91561,JaxQCd7UV5o1rvWxAibMy6iOMU3fCV5H,G8EPVSXsOYB5YQWZGiz1aVq5Pgr2GrQu,2,0,0,0,0,0,2,0,2,0.2857142857142857,1,0.0,0,0,0,0,0,0,0,2,0,0,2,1
4551,91563,CV9JyLcIlYcf3I8rF9dkDEhChf1GM9os,G8EPVSXsOYB5YQWZGiz1aVq5Pgr2GrQu,5,5,1,0,1,0,2,0,9,1.2857142857142858,1,0.0,0,1,0,1,5,0,0,2,0,2,7,1
4552,91565,Yc7DWSMOX4qXPZYRvYXJRnfQO7mqesrH,SpATywNh6bZuzm8s1ceuBUnMUAeoAHHw,9,8,2,8,1,0,2,0,21,3.0,1,0.0,4,2,6,1,4,0,2,2,0,13,8,1
4553,91571,M3CWdGPorPClU70a2twe6L8itu10pmZS,SpATywNh6bZuzm8s1ceuBUnMUAeoAHHw,1,0,0,0,0,0,1,0,1,0.14285714285714285,1,0.0,0,0,0,0,0,0,0,1,0,0,1,1
4554,91572,tl6eW0ZllZHnwqWfi7Wfg5VpXnj5pUEg,SpATywNh6bZuzm8s1ceuBUnMUAeoAHHw,15,11,5,12,3,0,4,0,35,5.0,1,0.0,4,5,10,3,7,0,2,4,0,22,13,1
4555,91575,nzicLrGs2CkHsGEmCwyxF4pye3Bqo62U,G8EPVSXsOYB5YQWZGiz1aVq5Pgr2GrQu,10,6,4,0,3,0,2,0,15,2.142857142857143,1,0.0,1,4,0,3,5,0,0,2,0,8,7,1
4556,91578,Zh7CYVhvtUUFf70foMQSgpBF0IOlRY9B,SpATywNh6bZuzm8s1ceuBUnMUAeoAHHw,5,2,1,0,1,0,2,0,6,0.8571428571428571,1,0.0,0,1,0,1,2,0,0,2,0,2,4,1
4557,91584,JBjA243ZRIqgCsAm61lG2qOhZbNcozpv,G8EPVSXsOYB5YQWZGiz1aVq5Pgr2GrQu,12,16,3,0,2,1,7,1,30,4.285714285714286,3,0.0,1,3,0,2,15,1,0,7,1,6,24,1
4558,91586,vOpj8ur6jA13uE8NuDJFu1oyU88RJP1w,bWdj2GDclj5ofokWjzoa5jAwMkxCykd6,4,4,0,0,0,0,1,0,5,0.7142857142857143,1,0.0,0,0,0,0,4,0,0,1,0,0,5,1
4559,91589,JBjA243ZRIqgCsAm61lG2qOhZbNcozpv,SpATywNh6bZuzm8s1ceuBUnMUAeoAHHw,5,5,1,0,0,0,4,0,10,1.4285714285714286,1,0.0,0,1,0,0,5,0,0,4,0,1,9,1
4560,91591,Jp26ywpmjw8PCn9zJ6Emr3JwxCXz1vqU,SpATywNh6bZuzm8s1ceuBUnMUAeoAHHw,14,21,1,18,1,9,10,0,60,8.571428571428571,4,0.0,2,1,15,1,19,9,3,10,0,19,41,1
4561,91592,rzAa0SbIuqxRiUHWVTPJbitOwzhhOEdv,G8EPVSXsOYB5YQWZGiz1aVq5Pgr2GrQu,8,16,7,6,0,0,4,0,33,4.714285714285714,1,0.0,6,7,5,0,10,0,1,4,0,18,15,1
4562,91593,PizUKf6mRUas66X3VMYXf9aygnN1CUCf,bWdj2GDclj5ofokWjzoa5jAwMkxCykd6,8,12,5,0,6,0,3,0,26,3.7142857142857144,1,0.0,5,5,0,6,7,0,0,3,0,16,10,1
4563,91595,gDaSFJD4b80GGtFaPG7wjh3sxtnlKrIT,SpATywNh6bZuzm8s1ceuBUnMUAeoAHHw,15,28,8,11,3,4,8,2,64,9.142857142857142,5,0.0,11,8,10,3,17,4,1,8,2,32,32,0
4564,91597,GsuSgvyvG4oCfnW3UaGKEeHZUImW7ybU,RXDvfPUBYFlVdlueBFbLW0mhhAyGEqpt,6,3,1,0,1,0,2,0,7,1.0,1,0.0,0,1,0,1,3,0,0,2,0,2,5,1
4565,92825,DuFXvlMxtAdxfnPOoOZpxEKgHTS36vNK,A3fsA9Zfv1X2fVEQhTw51lKENdNrEqT3,32,15,13,56,9,0,6,0,99,14.142857142857142,2,0.0,0,13,46,9,15,0,10,6,0,68,31,1
4566,92827,ZEbdtmjZoFNJAd6x9CZyfsFMmBEwQpXv,SpATywNh6bZuzm8s1ceuBUnMUAeoAHHw,13,11,8,0,5,1,7,1,33,4.714285714285714,2,0.0,0,8,0,5,11,1,0,7,1,13,20,1
4567,92860,msWTEJiXPD0IrE0kyLI7rGT23zUS4bM8,A3fsA9Zfv1X2fVEQhTw51lKENdNrEqT3,1,0,0,0,0,0,1,0,1,0.14285714285714285,1,0.0,0,0,0,0,0,0,0,1,0,0,1,1
4568,92870,nCB7ViHcbXHrq91Tw7AsIMYmLiKIa5Jv,A3fsA9Zfv1X2fVEQhTw51lKENdNrEqT3,4,1,0,0,0,0,5,0,6,0.8571428571428571,1,0.0,0,0,0,0,1,0,0,5,0,0,6,1
4569,92890,HJ2gv3yF0WCJxGH8T6tjLTFYdM4sCizz,SpATywNh6bZuzm8s1ceuBUnMUAeoAHHw,16,16,10,12,6,6,7,0,57,8.142857142857142,2,0.0,4,10,9,6,12,6,3,7,0,29,28,1
4570,92931,09jqR7IfvazajqsgYnjd0mGOuTyUXJmR,A3fsA9Zfv1X2fVEQhTw51lKENdNrEqT3,2,0,0,0,0,0,2,0,2,0.2857142857142857,1,0.0,0,0,0,0,0,0,0,2,0,0,2,1
4571,92933,Mf0xp5vhxE4EpnovGXm23q0TRlnpal5a,SpATywNh6bZuzm8s1ceuBUnMUAeoAHHw,1,0,0,0,0,0,1,0,1,0.14285714285714285,1,0.0,0,0,0,0,0,0,0,1,0,0,1,1
4572,92944,9HqwJ8d4m6K7QOSGhF3dVzXYAYpOl0vj,A3fsA9Zfv1X2fVEQhTw51lKENdNrEqT3,2,0,0,0,0,0,2,0,2,0.2857142857142857,1,0.0,0,0,0,0,0,0,0,2,0,0,2,1
4573,92947,xVCW9o5KqxAPnPVb1aenUpUZ6QWvEQCo,A3fsA9Zfv1X2fVEQhTw51lKENdNrEqT3,6,7,6,0,0,0,1,0,14,2.0,1,0.0,0,6,0,0,7,0,0,1,0,6,8,1
4574,92954,erkNYBqLpKRElyeL8GeAgO43CMazg6Rt,bWdj2GDclj5ofokWjzoa5jAwMkxCykd6,2,0,0,0,0,0,4,0,4,0.5714285714285714,1,0.0,0,0,0,0,0,0,0,4,0,0,4,1
4575,92957,DsdpjqDmkf4bB9F4w67WvhR5rXeY4BvC,bWdj2GDclj5ofokWjzoa5jAwMkxCykd6,11,18,7,0,6,27,11,1,70,10.0,1,0.0,7,7,0,6,11,27,0,11,1,20,50,1
4576,92960,3aETBFRObq3YeSOCDzQSdXdbqZJSuHf3,A3fsA9Zfv1X2fVEQhTw51lKENdNrEqT3,5,4,0,0,0,0,1,0,5,0.7142857142857143,1,0.0,0,0,0,0,4,0,0,1,0,0,5,1
4577,92962,4JgrlxTTs75mHh4mrh8qrfNDEELryL3p,bWdj2GDclj5ofokWjzoa5jAwMkxCykd6,12,15,6,18,42,0,4,0,85,12.142857142857142,1,0.0,2,6,16,42,13,0,2,4,0,66,19,1
4578,92968,eD22YcO1SJ996J45uu5dqIqwhKfXceL1,SpATywNh6bZuzm8s1ceuBUnMUAeoAHHw,3,2,1,0,1,0,0,0,4,0.5714285714285714,1,0.0,0,1,0,1,2,0,0,0,0,2,2,1
4579,92972,NXRVwFyxLXtyRtxM7ojyAnaiZQnhtjWO,SpATywNh6bZuzm8s1ceuBUnMUAeoAHHw,3,3,1,0,0,0,1,0,5,0.7142857142857143,1,0.0,0,1,0,0,3,0,0,1,0,1,4,1
4580,92975,mblW3W0a9cnUCcAYuJVrRwCReLzIZfZq,A3fsA9Zfv1X2fVEQhTw51lKENdNrEqT3,27,11,1,60,0,6,12,1,91,13.0,2,0.0,4,1,54,0,7,6,6,12,1,59,32,0
4581,92986,QKIVpxTYRwxpGiT6VdCFipdI87gZtHRH,SpATywNh6bZuzm8s1ceuBUnMUAeoAHHw,6,1,1,0,1,0,5,0,8,1.1428571428571428,1,0.0,0,1,0,1,1,0,0,5,0,2,6,1
4582,92988,niqjW4BciMttbwWr8wY84QzUCSHN5RSJ,G8EPVSXsOYB5YQWZGiz1aVq5Pgr2GrQu,1,0,0,0,0,0,1,0,1,0.14285714285714285,1,0.0,0,0,0,0,0,0,0,1,0,0,1,1
4583,92997,83JPfkin3GX4GLKqML2uaHSZ5KvsuJhM,SpATywNh6bZuzm8s1ceuBUnMUAeoAHHw,13,16,8,8,5,0,1,0,38,5.428571428571429,1,0.0,7,8,7,5,9,0,1,1,0,27,11,1
4584,93010,TMOi85sLkuYVgzErcEPoJc0AevPqR04B,RXDvfPUBYFlVdlueBFbLW0mhhAyGEqpt,17,21,11,14,4,11,10,1,72,10.285714285714286,5,0.0,3,11,11,4,18,11,3,10,1,29,43,1
4585,93012,PLJp2RYA7RZnQtREb0F5oRb3E0g7Z0Hr,G8EPVSXsOYB5YQWZGiz1aVq5Pgr2GrQu,2,0,0,0,0,0,2,0,2,0.2857142857142857,1,0.0,0,0,0,0,0,0,0,2,0,0,2,1
4586,93015,m9qgZNgP3Zn0sGVjbTdK1WyVxg0SzTDj,bWdj2GDclj5ofokWjzoa5jAwMkxCykd6,4,0,0,0,0,1,4,2,7,1.0,1,0.0,0,0,0,0,0,1,0,4,2,0,7,1
4587,93020,1RtjVFUMnRaIGZgXyyq9YVsVqwZO71yi,A3fsA9Zfv1X2fVEQhTw51lKENdNrEqT3,27,11,3,58,1,0,5,0,78,11.142857142857142,1,0.0,5,3,54,1,6,0,4,5,0,63,15,1
4588,93026,faeF4I5p3gAJMB1p4LfYVeCLQZKervYV,RXDvfPUBYFlVdlueBFbLW0mhhAyGEqpt,18,32,3,12,3,0,4,0,54,7.714285714285714,2,0.0,5,3,12,3,27,0,0,4,0,23,31,1
4589,93034,BIzXD84TaTFgXPtPL9bMALD9s3bgn0u7,SpATywNh6bZuzm8s1ceuBUnMUAeoAHHw,7,2,1,0,1,0,3,0,7,1.0,1,0.0,0,1,0,1,2,0,0,3,0,2,5,1
4590,93040,FlkgbrtKorC1nj2J8Ggbje7DCDtg1huD,A3fsA9Zfv1X2fVEQhTw51lKENdNrEqT3,5,4,2,0,1,0,4,0,11,1.5714285714285714,2,0.0,0,2,0,1,4,0,0,4,0,3,8,1
4591,93043,E5602d0htkVZGQTnJE6WlrGSkrgiKfR6,SpATywNh6bZuzm8s1ceuBUnMUAeoAHHw,2,0,0,0,0,0,2,0,2,0.2857142857142857,1,0.0,0,0,0,0,0,0,0,2,0,0,2,1
4592,93059,y5aIEV04Hqe57KpGOGn83CrEmVkQlotT,SpATywNh6bZuzm8s1ceuBUnMUAeoAHHw,4,2,0,0,0,1,2,0,5,0.7142857142857143,1,0.0,0,0,0,0,2,1,0,2,0,0,5,1
4593,93069,wxDnmvTLHWGwCYYCjH3qEOtgLqGKeB8y,bWdj2GDclj5ofokWjzoa5jAwMkxCykd6,2,0,0,0,0,0,3,0,3,0.42857142857142855,1,0.0,0,0,0,0,0,0,0,3,0,0,3,1
4594,93071,va3cVfF38XAjn4LEh6VxTTEdlP5IupZ2,bWdj2GDclj5ofokWjzoa5jAwMkxCykd6,1,0,0,0,0,0,1,0,1,0.14285714285714285,1,0.0,0,0,0,0,0,0,0,1,0,0,1,1
4595,93073,15L69MXCYIH8txiwXfgte6Bdad1p8M7U,SpATywNh6bZuzm8s1ceuBUnMUAeoAHHw,11,20,7,0,4,0,2,0,33,4.714285714285714,1,0.0,0,7,0,4,20,0,0,2,0,11,22,1
4596,93077,cnJW6igbDk7mivnYsxVZcWD5COwXKpJj,A3fsA9Zfv1X2fVEQhTw51lKENdNrEqT3,23,13,5,68,0,0,9,0,95,13.571428571428571,1,0.0,7,5,60,0,6,0,8,9,0,72,23,1
4597,93082,dPAuRkHCuQhCcbVNP1uiDIdfcWFQHP2t,SpATywNh6bZuzm8s1ceuBUnMUAeoAHHw,2,0,0,0,0,0,2,0,2,0.2857142857142857,1,0.0,0,0,0,0,0,0,0,2,0,0,2,1
4598,93106,28Xs6RIGljkwGIhsVvWB0d4RartQZhIp,SpATywNh6bZuzm8s1ceuBUnMUAeoAHHw,14,13,8,3,4,0,5,0,33,4.714285714285714,2,0.0,2,8,3,4,11,0,0,5,0,17,16,0
4599,93108,dBPTjHGtowbPnTOm514Emm9Jz5rIzrSj,SpATywNh6bZuzm8s1ceuBUnMUAeoAHHw,10,7,1,0,1,3,7,1,20,2.857142857142857,2,0.0,0,1,0,1,7,3,0,7,1,2,18,1
4600,93113,QOWLFnVTxLvLint3QUq9XwfNiIwpTPjR,G8EPVSXsOYB5YQWZGiz1aVq5Pgr2GrQu,6,2,1,0,1,0,3,0,7,1.0,1,0.0,0,1,0,1,2,0,0,3,0,2,5,1
4601,93128,OTVmyM3oMOEh3RPUJ9JvZ1cqJuClk9Op,A3fsA9Zfv1X2fVEQhTw51lKENdNrEqT3,13,24,11,0,5,1,6,1,48,6.857142857142857,2,0.0,2,11,0,5,22,1,0,6,1,18,30,1
4602,93151,Co9dycRC3nnJN4rm3WsLzyk3Mwz3zosU,SpATywNh6bZuzm8s1ceuBUnMUAeoAHHw,10,26,0,15,0,9,6,0,56,8.0,3,0.0,5,0,14,0,21,9,1,6,0,19,37,1
4603,93166,wjcBLe1692KFPJUkCwcKQrXvoLbsDg0j,A3fsA9Zfv1X2fVEQhTw51lKENdNrEqT3,6,5,2,0,2,0,1,0,10,1.4285714285714286,1,0.0,0,2,0,2,5,0,0,1,0,4,6,1
4604,93206,JtMmp5BCDQnYE7CMI3NvnX4aRCZsQW9K,RXDvfPUBYFlVdlueBFbLW0mhhAyGEqpt,1,0,0,0,0,0,2,0,2,0.2857142857142857,2,0.0,0,0,0,0,0,0,0,2,0,0,2,1
4605,93207,E7aYibTjzxGSk6NL3yeJVWuk7dqVnncv,bWdj2GDclj5ofokWjzoa5jAwMkxCykd6,4,5,2,0,2,0,1,0,10,1.4285714285714286,1,0.0,0,2,0,2,5,0,0,1,0,4,6,1
4606,93210,O9DTMIbbKOPsa4B7k1STk0nNuSR3cdx2,SpATywNh6bZuzm8s1ceuBUnMUAeoAHHw,3,2,0,0,0,0,1,0,3,0.42857142857142855,1,0.0,0,0,0,0,2,0,0,1,0,0,3,1
4607,93215,iCEb35gaygczCVXBPDGlI3sXrSsDaVej,A3fsA9Zfv1X2fVEQhTw51lKENdNrEqT3,1,0,0,0,0,0,1,0,1,0.14285714285714285,1,0.0,0,0,0,0,0,0,0,1,0,0,1,1
4608,93221,BhaFO7Lx4Q4YbNxvEeo9nBTXjsmsEz6c,SpATywNh6bZuzm8s1ceuBUnMUAeoAHHw,10,9,6,0,4,0,4,0,23,3.2857142857142856,2,0.0,0,6,0,4,9,0,0,4,0,10,13,1
4609,93225,mWv2aD1lbqJSR5LQ8znxXgNEw4RCzno5,bWdj2GDclj5ofokWjzoa5jAwMkxCykd6,1,0,0,0,0,0,1,0,1,0.14285714285714285,1,0.0,0,0,0,0,0,0,0,1,0,0,1,1
4610,93235,epvD2Wcl45J2GdVoBHzahVMdghFLent2,A3fsA9Zfv1X2fVEQhTw51lKENdNrEqT3,8,6,5,0,5,0,2,0,18,2.5714285714285716,1,0.0,0,5,0,5,6,0,0,2,0,10,8,1
4611,93249,yqsIVJwLxHRAX79gd7ST37Kksa5nD2Lx,SpATywNh6bZuzm8s1ceuBUnMUAeoAHHw,4,8,0,0,0,0,2,0,10,1.4285714285714286,1,0.0,0,0,0,0,8,0,0,2,0,0,10,1
4612,93294,zGuA1mMLvM3gfcKciKtoyFo6318fINqG,SpATywNh6bZuzm8s1ceuBUnMUAeoAHHw,1,0,0,0,0,0,1,0,1,0.14285714285714285,1,0.0,0,0,0,0,0,0,0,1,0,0,1,1
4613,93313,MU7wboUY4X1pw35YtYq9QO37Sakj8O8C,SpATywNh6bZuzm8s1ceuBUnMUAeoAHHw,6,5,3,0,3,0,1,0,12,1.7142857142857142,1,0.0,0,3,0,3,5,0,0,1,0,6,6,1
4614,93326,x6oT9QqDd4S0kTW1QntTwdbJd7rGTsDd,G8EPVSXsOYB5YQWZGiz1aVq5Pgr2GrQu,40,38,26,44,14,8,9,1,140,20.0,1,0.0,7,26,40,14,31,8,4,9,1,87,53,1
4615,93335,6WDAV2K5JXtsN5Y7oVoYno0rdPlDVwAS,SpATywNh6bZuzm8s1ceuBUnMUAeoAHHw,12,33,10,1,8,0,22,0,74,10.571428571428571,3,0.0,1,10,1,8,32,0,0,22,0,20,54,1
4616,93336,J9IFZ6lJS0kAA8VxmLEtsSsATCVlFyib,A3fsA9Zfv1X2fVEQhTw51lKENdNrEqT3,9,5,0,0,0,0,8,1,14,2.0,1,0.0,0,0,0,0,5,0,0,8,1,0,14,1
4617,93338,J9IFZ6lJS0kAA8VxmLEtsSsATCVlFyib,G8EPVSXsOYB5YQWZGiz1aVq5Pgr2GrQu,3,0,0,0,0,0,4,0,4,0.5714285714285714,1,0.0,0,0,0,0,0,0,0,4,0,0,4,1
4618,93346,b3ww03gxsETlWqnhgdTKJu0odbTVWElw,SpATywNh6bZuzm8s1ceuBUnMUAeoAHHw,1,0,0,0,0,0,1,0,1,0.14285714285714285,1,0.0,0,0,0,0,0,0,0,1,0,0,1,1
4619,93347,xfIcqx8ftYruTYGt1LiJYX4e8qkp171D,A3fsA9Zfv1X2fVEQhTw51lKENdNrEqT3,6,5,0,0,0,0,2,0,7,1.0,1,0.0,0,0,0,0,5,0,0,2,0,0,7,1
4620,93351,cwBiyXmdgaiw26TEVXDuCjvVYFCLKOa1,SpATywNh6bZuzm8s1ceuBUnMUAeoAHHw,6,14,3,0,1,0,1,0,19,2.7142857142857144,1,0.0,10,3,0,1,4,0,0,1,0,14,5,1
4621,93356,QKPOTPLCFSSptakTWL9scYXAQmH9VPoV,A3fsA9Zfv1X2fVEQhTw51lKENdNrEqT3,4,2,1,0,1,0,1,0,5,0.7142857142857143,1,0.0,0,1,0,1,2,0,0,1,0,2,3,1
4622,93373,rdlkz4QUHd85FYWQkxx9tuSVm08spAcj,A3fsA9Zfv1X2fVEQhTw51lKENdNrEqT3,11,5,3,0,3,0,3,0,14,2.0,1,0.0,0,3,0,3,5,0,0,3,0,6,8,1
4623,93374,AN1pw84sOSfQ3KFcxuCbDy0hYOBni6dp,G8EPVSXsOYB5YQWZGiz1aVq5Pgr2GrQu,23,30,11,34,3,0,10,0,88,12.571428571428571,1,0.0,12,11,24,3,18,0,10,10,0,50,38,1
4624,93383,YyNcczfjJii4HexOcQkp0MHeatr8c5sB,bWdj2GDclj5ofokWjzoa5jAwMkxCykd6,4,3,0,0,0,0,2,0,5,0.7142857142857143,1,0.0,0,0,0,0,3,0,0,2,0,0,5,1
4625,93384,1M4xACtMIoM8zWBXmaYDVcE8Iy4RYZ8e,G8EPVSXsOYB5YQWZGiz1aVq5Pgr2GrQu,13,13,2,10,1,3,14,1,44,6.285714285714286,2,0.0,5,2,7,1,8,3,3,14,1,15,29,1
4626,93387,HWAJhvF3LR86qA3qhHJiqZmQp4teUKAm,G8EPVSXsOYB5YQWZGiz1aVq5Pgr2GrQu,31,53,0,94,5,2,2,0,156,22.285714285714285,1,0.0,40,0,66,5,13,2,28,2,0,111,45,1
4627,93399,8LtTXy2ZLwBwWwH4BENA0Wiv8pjMa9RP,SpATywNh6bZuzm8s1ceuBUnMUAeoAHHw,11,18,0,10,0,6,3,0,37,5.285714285714286,1,0.0,9,0,8,0,9,6,2,3,0,17,20,1
4628,93402,wRuDkiFKsIS1XayC3m2MgIyWR2x1W3i6,A3fsA9Zfv1X2fVEQhTw51lKENdNrEqT3,6,3,1,0,1,0,3,0,8,1.1428571428571428,1,0.0,0,1,0,1,3,0,0,3,0,2,6,1
4629,93404,eT5JmMMKMcNoJjMWrJaUqOJQSpR601jL,A3fsA9Zfv1X2fVEQhTw51lKENdNrEqT3,4,2,1,0,1,0,5,0,9,1.2857142857142858,2,0.0,0,1,0,1,2,0,0,5,0,2,7,1
4630,93414,LiD14ALXLddUqpdQnujGFxQiBSoJOZGF,bWdj2GDclj5ofokWjzoa5jAwMkxCykd6,15,34,3,106,1,0,15,0,159,22.714285714285715,4,0.0,9,3,100,1,25,0,6,15,0,113,46,0
4631,93415,CiJGHZYjg5XVOtN8y1aUHiZjaXvVvsf8,bWdj2GDclj5ofokWjzoa5jAwMkxCykd6,5,3,1,0,1,0,5,0,10,1.4285714285714286,3,0.0,0,1,0,1,3,0,0,5,0,2,8,1
4632,93416,NFwkvwlecWBzcgNCOvBMTCkkUA7P9cK8,bWdj2GDclj5ofokWjzoa5jAwMkxCykd6,6,7,3,0,1,0,4,0,15,2.142857142857143,2,0.0,0,3,0,1,7,0,0,4,0,4,11,1
4633,93417,C6OkpqYGxZDK55uJrTXLk64MO2W2kN6e,SpATywNh6bZuzm8s1ceuBUnMUAeoAHHw,1,0,0,0,0,0,1,0,1,0.14285714285714285,1,0.0,0,0,0,0,0,0,0,1,0,0,1,1
4634,93422,HcOpBFh3ZPBJu7PjBFffM3Zedw54RSXN,A3fsA9Zfv1X2fVEQhTw51lKENdNrEqT3,4,8,2,0,0,0,2,0,12,1.7142857142857142,3,0.0,0,2,0,0,8,0,0,2,0,2,10,1
4635,93426,Hc0D2UkydjyUi3vnnsfmiB8lOnMbIWKo,SpATywNh6bZuzm8s1ceuBUnMUAeoAHHw,4,2,1,0,1,0,1,0,5,0.7142857142857143,1,0.0,0,1,0,1,2,0,0,1,0,2,3,0
4636,93434,BCPOhUa2LrfH93ebCE15VbF0VEWEyi7T,SpATywNh6bZuzm8s1ceuBUnMUAeoAHHw,6,3,2,0,2,0,1,0,8,1.1428571428571428,1,0.0,0,2,0,2,3,0,0,1,0,4,4,0
4637,93437,lmx2t8WuCRr4yPlE96c0Hld3ah69yimY,SpATywNh6bZuzm8s1ceuBUnMUAeoAHHw,8,16,2,17,0,26,2,0,63,9.0,1,0.0,14,2,15,0,2,26,2,2,0,31,32,1
4638,93444,wfUVHBmDLe0V8vTm9YNAi5Eoe98kipNK,RXDvfPUBYFlVdlueBFbLW0mhhAyGEqpt,7,4,0,0,0,0,4,3,11,1.5714285714285714,1,0.0,2,0,0,0,2,0,0,4,3,2,9,1
4639,93454,IdPM07Tobfo8uXfAGdfrnlSPQUjcS5lw,SpATywNh6bZuzm8s1ceuBUnMUAeoAHHw,15,15,7,15,4,3,7,2,53,7.571428571428571,2,0.0,5,7,13,4,10,3,2,7,2,29,24,1
4640,93461,iNqMxLUew1d2DW8l74urvD3s2ojQNcOj,G8EPVSXsOYB5YQWZGiz1aVq5Pgr2GrQu,9,6,1,0,1,0,3,0,11,1.5714285714285714,2,0.0,0,1,0,1,6,0,0,3,0,2,9,1
4641,93463,KnjIylBxQGK5ybTZHRQCIOf6LVaiEDiE,SpATywNh6bZuzm8s1ceuBUnMUAeoAHHw,13,18,8,2,6,42,3,0,79,11.285714285714286,2,0.0,8,8,2,6,10,42,0,3,0,24,55,1
4642,93476,XiRokcstRgTAoxw5fli1EiomcYln51fR,bWdj2GDclj5ofokWjzoa5jAwMkxCykd6,4,3,0,0,0,0,5,0,8,1.1428571428571428,1,0.0,1,0,0,0,2,0,0,5,0,1,7,1
4643,93478,ouHHL7JxNnPJ7sZc8oGHgugCfHuyBFzn,bWdj2GDclj5ofokWjzoa5jAwMkxCykd6,8,10,6,0,4,0,2,0,22,3.142857142857143,3,0.0,0,6,0,4,10,0,0,2,0,10,12,1
4644,93497,QcZtDJ3gyfgBjK6fnA4Umq8WcjzDqlhe,A3fsA9Zfv1X2fVEQhTw51lKENdNrEqT3,1,0,0,0,0,0,1,0,1,0.14285714285714285,1,0.0,0,0,0,0,0,0,0,1,0,0,1,1
4645,93504,vaOIevkYLsk4A7wWmrPXcGrOKX6OgVbB,G8EPVSXsOYB5YQWZGiz1aVq5Pgr2GrQu,12,4,3,0,3,1,5,1,17,2.4285714285714284,1,0.0,0,3,0,3,4,1,0,5,1,6,11,1
4646,93513,yuqYkP52C7pQOIQ48GEgTRDqcNtFSeb3,bWdj2GDclj5ofokWjzoa5jAwMkxCykd6,19,23,9,38,6,35,16,1,128,18.285714285714285,3,0.0,8,9,35,6,15,35,3,16,1,58,70,1
4647,93517,1yALM9xjClF6jgXaABxhrYNC8eb8bQ9n,bWdj2GDclj5ofokWjzoa5jAwMkxCykd6,15,12,6,30,6,0,2,0,56,8.0,1,0.0,4,6,27,6,8,0,3,2,0,43,13,1
4648,93518,I3RIPLupgcaFBN4TZgx1kwE7cqUmhNGE,SpATywNh6bZuzm8s1ceuBUnMUAeoAHHw,5,2,1,0,1,0,2,0,6,0.8571428571428571,1,0.0,0,1,0,1,2,0,0,2,0,2,4,1
4649,93519,lUW6V1mqrGSz0okgfju4Oi2AssrcTWTN,bWdj2GDclj5ofokWjzoa5jAwMkxCykd6,12,6,4,0,3,1,8,0,22,3.142857142857143,2,0.0,0,4,0,3,6,1,0,8,0,7,15,1
4650,93520,caAQbOI1NkkZKVF3oGPK3OdsY0lbDlYb,bWdj2GDclj5ofokWjzoa5jAwMkxCykd6,6,2,1,0,1,1,5,2,12,1.7142857142857142,1,0.0,0,1,0,1,2,1,0,5,2,2,10,1
4651,93523,7KhKGJPxu4uQKYHNs7O3NjmuTH6NjrVY,A3fsA9Zfv1X2fVEQhTw51lKENdNrEqT3,10,6,4,0,3,0,6,0,19,2.7142857142857144,1,0.0,0,4,0,3,6,0,0,6,0,7,12,0
4652,93525,SI82rbAOql23YmOWiXWAc0dEkHYrXScg,SpATywNh6bZuzm8s1ceuBUnMUAeoAHHw,8,4,1,0,1,3,5,0,14,2.0,1,0.0,0,1,0,1,4,3,0,5,0,2,12,1
4653,93529,K5WcXRk24XKmzfaggLfniRGhO7RrNYwU,SpATywNh6bZuzm8s1ceuBUnMUAeoAHHw,13,15,8,12,6,0,1,0,42,6.0,1,0.0,6,8,12,6,9,0,0,1,0,32,10,0
4654,93531,RHEMdhoy3TVz84IqO3CiO0ZVmx7sjl4N,A3fsA9Zfv1X2fVEQhTw51lKENdNrEqT3,40,18,12,65,10,0,7,0,112,16.0,1,0.0,1,12,52,10,17,0,13,7,0,75,37,0
4655,93538,oUwdPVwTRYLcPpw0ARjn83xyQKxe2P4j,A3fsA9Zfv1X2fVEQhTw51lKENdNrEqT3,8,15,0,0,0,0,4,0,19,2.7142857142857144,1,0.0,0,0,0,0,15,0,0,4,0,0,19,1
4656,93558,wjcBLe1692KFPJUkCwcKQrXvoLbsDg0j,bWdj2GDclj5ofokWjzoa5jAwMkxCykd6,3,3,1,0,0,0,1,0,5,0.7142857142857143,1,0.0,0,1,0,0,3,0,0,1,0,1,4,1
4657,93559,kQHHmjfVeHdUMEjst4rHDTfMZ6Hq7zy6,G8EPVSXsOYB5YQWZGiz1aVq5Pgr2GrQu,21,36,13,56,5,0,11,1,122,17.428571428571427,3,0.0,15,13,49,5,21,0,7,11,1,82,40,1
4658,93567,GWCKXkmUMNA4NMWmbV0iY9p0NnvUAuFf,SpATywNh6bZuzm8s1ceuBUnMUAeoAHHw,2,0,0,0,0,0,2,0,2,0.2857142857142857,1,0.0,0,0,0,0,0,0,0,2,0,0,2,1
4659,93576,kWRi0bjTsOLXCT3B1x0edeUqfKik54ld,SpATywNh6bZuzm8s1ceuBUnMUAeoAHHw,7,3,2,0,2,0,2,0,9,1.2857142857142858,1,0.0,0,2,0,2,3,0,0,2,0,4,5,1
4660,93583,3RcsrMTbPrb8ZHYXLlgwoRK7zrqTGSuq,A3fsA9Zfv1X2fVEQhTw51lKENdNrEqT3,22,17,13,2,11,0,4,0,47,6.714285714285714,1,0.0,3,13,2,11,14,0,0,4,0,29,18,1
4661,93594,SI82rbAOql23YmOWiXWAc0dEkHYrXScg,G8EPVSXsOYB5YQWZGiz1aVq5Pgr2GrQu,6,1,1,0,1,0,3,0,6,0.8571428571428571,1,0.0,0,1,0,1,1,0,0,3,0,2,4,1
4662,93601,auyTDueRbJJVbSgkNfSzePWA0sXDjoDA,A3fsA9Zfv1X2fVEQhTw51lKENdNrEqT3,5,4,0,0,0,0,4,0,8,1.1428571428571428,1,0.0,0,0,0,0,4,0,0,4,0,0,8,1
4663,93608,XIhNBV2ngE6VH3B3rFCGmtxUmfBaQQAu,bWdj2GDclj5ofokWjzoa5jAwMkxCykd6,2,0,0,0,0,0,4,0,4,0.5714285714285714,1,0.0,0,0,0,0,0,0,0,4,0,0,4,1
4664,93612,iKQWUg85b7iQVNDnFW3yVIr4MRSX1OiM,SpATywNh6bZuzm8s1ceuBUnMUAeoAHHw,9,4,4,0,4,0,4,0,16,2.2857142857142856,2,0.0,0,4,0,4,4,0,0,4,0,8,8,1
4665,93613,5zmdkrLCsYposTlmADCtPSCtqJszOFSq,A3fsA9Zfv1X2fVEQhTw51lKENdNrEqT3,17,11,8,0,5,1,6,0,31,4.428571428571429,2,0.0,0,8,0,5,11,1,0,6,0,13,18,1
4666,93623,SetmDwaBCsbTdPHVqtt90lo6lvXmXkbh,RXDvfPUBYFlVdlueBFbLW0mhhAyGEqpt,2,0,0,0,0,0,2,0,2,0.2857142857142857,1,0.0,0,0,0,0,0,0,0,2,0,0,2,1
4667,93634,hjHWaXhruoFaGhRZCz2Vsvz3ABLehqZ4,bWdj2GDclj5ofokWjzoa5jAwMkxCykd6,5,2,1,0,1,0,3,0,7,1.0,1,0.0,0,1,0,1,2,0,0,3,0,2,5,1
4668,93641,3NITGQuylcrTi63aoWqnzXuF5Rtf7QVq,A3fsA9Zfv1X2fVEQhTw51lKENdNrEqT3,37,13,11,80,10,0,1,0,115,16.428571428571427,1,0.0,1,11,69,10,12,0,11,1,0,91,24,1
4669,93642,87SYGQjFYUtEWda0pG12bcNker0JGBy3,A3fsA9Zfv1X2fVEQhTw51lKENdNrEqT3,5,7,0,0,0,0,1,0,8,1.1428571428571428,1,0.0,0,0,0,0,7,0,0,1,0,0,8,1
4670,93647,GyNkIVOso2X6ndPFrPZ0dYdTkjhdba2Q,G8EPVSXsOYB5YQWZGiz1aVq5Pgr2GrQu,10,11,3,0,3,0,7,0,24,3.4285714285714284,2,0.0,2,3,0,3,9,0,0,7,0,8,16,1
4671,93654,FFnoMDhUnJZ86LrCRa50JPybQorDvh89,RXDvfPUBYFlVdlueBFbLW0mhhAyGEqpt,10,10,7,0,3,0,4,0,24,3.4285714285714284,3,0.0,1,7,0,3,9,0,0,4,0,11,13,1
4672,93664,wmwDf7eIRrKPL0l8cNmMygnEPd5vzoqs,A3fsA9Zfv1X2fVEQhTw51lKENdNrEqT3,10,7,0,0,0,2,9,2,20,2.857142857142857,2,0.0,1,0,0,0,6,2,0,9,2,1,19,1
4673,93665,OCOZunZP01no4Zh4NYF1FDXoOWZrc1Yv,SpATywNh6bZuzm8s1ceuBUnMUAeoAHHw,10,16,2,26,2,0,1,0,47,6.714285714285714,1,0.0,11,2,21,2,5,0,5,1,0,36,11,1
4674,93668,wmwDf7eIRrKPL0l8cNmMygnEPd5vzoqs,bWdj2GDclj5ofokWjzoa5jAwMkxCykd6,3,2,0,0,0,0,1,0,3,0.42857142857142855,1,0.0,0,0,0,0,2,0,0,1,0,0,3,1
4675,93698,F3pS3HhR6zAyElkIe1WFx5cvIXH3Mmjf,SpATywNh6bZuzm8s1ceuBUnMUAeoAHHw,1,0,0,0,0,0,1,0,1,0.14285714285714285,1,0.0,0,0,0,0,0,0,0,1,0,0,1,1
4676,93711,VvbZjK8y9aernnsSHvAW377h2uAEkOuF,RXDvfPUBYFlVdlueBFbLW0mhhAyGEqpt,2,0,0,0,0,0,2,0,2,0.2857142857142857,1,0.0,0,0,0,0,0,0,0,2,0,0,2,1
4677,93728,GZzbpBGluNcEXFZ9BEQgqFPzH6qJC8rT,SpATywNh6bZuzm8s1ceuBUnMUAeoAHHw,10,17,2,8,0,0,7,1,35,5.0,2,0.0,0,2,7,0,17,0,1,7,1,9,26,1
4678,93733,vSy2YWE0W8axNgPS8DBIlQoMQuLcT6wu,G8EPVSXsOYB5YQWZGiz1aVq5Pgr2GrQu,2,0,0,0,0,0,2,0,2,0.2857142857142857,1,0.0,0,0,0,0,0,0,0,2,0,0,2,1
4679,93734,J2Ryyq6g6TjnFue1VPNlM9zNmZVB3792,SpATywNh6bZuzm8s1ceuBUnMUAeoAHHw,6,3,1,0,1,0,2,0,7,1.0,1,0.0,0,1,0,1,3,0,0,2,0,2,5,1
4680,93744,ROmxIDt1Nv5jCVXIVh1nfk5f1b4KKNIR,bWdj2GDclj5ofokWjzoa5jAwMkxCykd6,8,6,3,0,2,0,5,0,16,2.2857142857142856,1,0.0,0,3,0,2,6,0,0,5,0,5,11,1
4681,93756,KO9zYaiac2CNagQLdx3aJ9c2fXXMgIJX,SpATywNh6bZuzm8s1ceuBUnMUAeoAHHw,13,17,9,11,5,0,4,0,46,6.571428571428571,3,0.0,4,9,11,5,13,0,0,4,0,29,17,1
4682,93774,2AXxkCmyE7acjKrdHA94DKX4eMigeF9j,A3fsA9Zfv1X2fVEQhTw51lKENdNrEqT3,1,0,0,0,0,0,2,0,2,0.2857142857142857,1,0.0,0,0,0,0,0,0,0,2,0,0,2,1
4683,93781,seYLwHio53k0mOFj19dZ5TEGXq5ADUux,SpATywNh6bZuzm8s1ceuBUnMUAeoAHHw,5,2,1,0,0,0,6,0,9,1.2857142857142858,1,0.0,0,1,0,0,2,0,0,6,0,1,8,1
4684,93787,QOHFX3G0atWVkV8bdUDLZP6MvVAU1bxE,A3fsA9Zfv1X2fVEQhTw51lKENdNrEqT3,7,5,0,0,0,0,7,0,12,1.7142857142857142,2,0.0,0,0,0,0,5,0,0,7,0,0,12,1
4685,93789,bFxkSwC4B7FuMDmZm2HkHgiHz8QC2hPC,A3fsA9Zfv1X2fVEQhTw51lKENdNrEqT3,9,11,5,0,3,0,2,0,21,3.0,1,0.0,0,5,0,3,11,0,0,2,0,8,13,1
4686,93799,SvayS3hRjiQUsZJZ3Z80XuRW7pnvNCGH,SpATywNh6bZuzm8s1ceuBUnMUAeoAHHw,15,32,3,10,2,11,17,4,79,11.285714285714286,2,0.0,6,3,9,2,26,11,1,17,4,20,59,1
4687,93814,uHLnVmnvVGRf9UQIVsgUkoIvLInqWS41,RXDvfPUBYFlVdlueBFbLW0mhhAyGEqpt,34,71,37,32,24,2,20,3,189,27.0,2,0.0,9,37,30,24,62,2,2,20,3,100,89,1
4688,93818,CYf5wdcurcSyhJdbx09KiN2Kzj9VLvNU,SpATywNh6bZuzm8s1ceuBUnMUAeoAHHw,1,0,0,0,0,0,1,0,1,0.14285714285714285,1,0.0,0,0,0,0,0,0,0,1,0,0,1,1
4689,93821,O2RP4lI2hqQTYW7uUxK7lTmJyXECBert,SpATywNh6bZuzm8s1ceuBUnMUAeoAHHw,4,2,1,0,1,0,1,0,5,0.7142857142857143,1,0.0,0,1,0,1,2,0,0,1,0,2,3,1
4690,93835,D98GkCb5yOnLtlLtWNWnUK2keXt1DRWI,A3fsA9Zfv1X2fVEQhTw51lKENdNrEqT3,2,0,0,0,0,0,2,0,2,0.2857142857142857,1,0.0,0,0,0,0,0,0,0,2,0,0,2,1
4691,93843,OMmdzdRtTLASG3chso9cdfg94JQDfZqt,SpATywNh6bZuzm8s1ceuBUnMUAeoAHHw,11,15,5,2,3,0,3,0,28,4.0,3,0.0,2,5,2,3,13,0,0,3,0,12,16,1
4692,93860,iDEg223wPLRjblw05XWiNlNB0XKXbAH3,SpATywNh6bZuzm8s1ceuBUnMUAeoAHHw,8,4,2,0,1,0,6,1,14,2.0,1,0.0,0,2,0,1,4,0,0,6,1,3,11,1
4693,93862,MdwJcKhWKSfBlz1JQsWSYPZY8VplWXai,SpATywNh6bZuzm8s1ceuBUnMUAeoAHHw,2,0,0,0,0,0,2,0,2,0.2857142857142857,1,0.0,0,0,0,0,0,0,0,2,0,0,2,1
4694,93863,Ac4OXBvc7WZ07azvF8LolPbeFPCXH5U0,SpATywNh6bZuzm8s1ceuBUnMUAeoAHHw,1,0,0,0,0,0,1,0,1,0.14285714285714285,1,0.0,0,0,0,0,0,0,0,1,0,0,1,1
4695,93879,qT6iwsUe27SkWCpThee9QunElnsrIqyP,SpATywNh6bZuzm8s1ceuBUnMUAeoAHHw,16,18,6,14,3,0,8,0,49,7.0,3,0.0,7,6,13,3,11,0,1,8,0,29,20,1
4696,93881,wKKdkZJ3MevUShYy00jn3yNZpY2kcdrV,A3fsA9Zfv1X2fVEQhTw51lKENdNrEqT3,4,1,0,0,0,0,3,0,4,0.5714285714285714,1,0.0,0,0,0,0,1,0,0,3,0,0,4,0
4697,93900,L1FTG9TM6RI5TBCTexQgshQhXhu2oZpJ,A3fsA9Zfv1X2fVEQhTw51lKENdNrEqT3,41,21,15,46,10,0,11,0,103,14.714285714285714,5,0.0,1,15,45,10,20,0,1,11,0,71,32,0
4698,93903,L1FTG9TM6RI5TBCTexQgshQhXhu2oZpJ,G8EPVSXsOYB5YQWZGiz1aVq5Pgr2GrQu,44,39,18,74,14,0,4,0,149,21.285714285714285,2,0.0,15,18,68,14,24,0,6,4,0,115,34,1
4699,93906,df9qJcc4auTr14t9gsIjmvQwAgkzyFuV,SpATywNh6bZuzm8s1ceuBUnMUAeoAHHw,6,2,1,0,1,0,3,0,7,1.0,1,0.0,0,1,0,1,2,0,0,3,0,2,5,1
4700,93917,MyQ8e9mBKn27AhY70WumCof36bw293Y4,SpATywNh6bZuzm8s1ceuBUnMUAeoAHHw,16,24,7,17,3,4,7,0,62,8.857142857142858,3,0.0,12,7,13,3,12,4,4,7,0,35,27,1
4701,93918,oW89eJD99A7pCOqqvTkgIt7CVSu0bGbe,SpATywNh6bZuzm8s1ceuBUnMUAeoAHHw,8,5,2,0,1,0,6,0,14,2.0,1,0.0,0,2,0,1,5,0,0,6,0,3,11,1
4702,93920,EJ6j1DQBzD1orM5Ltf8vXiAVi2YaVKj4,A3fsA9Zfv1X2fVEQhTw51lKENdNrEqT3,12,16,7,0,6,0,1,0,30,4.285714285714286,1,0.0,0,7,0,6,16,0,0,1,0,13,17,1
4703,93924,QrJQFROnKZICXeQTI0yD9R5uKCsOiaxB,bWdj2GDclj5ofokWjzoa5jAwMkxCykd6,5,3,1,0,1,0,2,0,7,1.0,1,0.0,0,1,0,1,3,0,0,2,0,2,5,1
4704,93928,grEUheAl7r2qUdLFFy9nEMsG9X5GQrvY,SpATywNh6bZuzm8s1ceuBUnMUAeoAHHw,17,16,7,7,5,1,6,1,43,6.142857142857143,1,0.0,7,7,7,5,9,1,0,6,1,26,17,1
4705,93937,2j0Susczy7BF2QnNLUm3dJdUMP10ntAU,SpATywNh6bZuzm8s1ceuBUnMUAeoAHHw,16,19,12,9,3,0,9,2,54,7.714285714285714,2,0.0,2,12,8,3,17,0,1,9,2,25,29,1
4706,93949,pQdqlOtxi2sBVu8vnQy738Mf4LOYprkG,SpATywNh6bZuzm8s1ceuBUnMUAeoAHHw,5,2,1,0,1,0,3,0,7,1.0,1,0.0,0,1,0,1,2,0,0,3,0,2,5,1
4707,93951,Ei65KRTqH4vAZu2hVbuPfr6ybTjVLWsx,SpATywNh6bZuzm8s1ceuBUnMUAeoAHHw,12,19,7,0,6,0,4,0,36,5.142857142857143,2,0.0,7,7,0,6,12,0,0,4,0,20,16,1
4708,93967,XyD01HhzMuHzP5ArHNJFexoSZMamD6Wh,SpATywNh6bZuzm8s1ceuBUnMUAeoAHHw,14,17,8,16,5,1,3,0,50,7.142857142857143,2,0.0,7,8,14,5,10,1,2,3,0,34,16,1
4709,93981,aoxjDsJ8sZvuPjSCqksrdXkImRMV7vgy,A3fsA9Zfv1X2fVEQhTw51lKENdNrEqT3,5,5,1,0,0,0,2,0,8,1.1428571428571428,1,0.0,0,1,0,0,5,0,0,2,0,1,7,1
4710,93999,M4LPRpz3NIxIAwFWtYdMyaFovwI23Hwi,SpATywNh6bZuzm8s1ceuBUnMUAeoAHHw,1,0,0,0,0,0,1,0,1,0.14285714285714285,1,0.0,0,0,0,0,0,0,0,1,0,0,1,1
4711,94009,E1EZDOz8phdW938KkZKGZCkkHanJOco1,bWdj2GDclj5ofokWjzoa5jAwMkxCykd6,5,2,1,0,1,0,2,0,6,0.8571428571428571,1,0.0,0,1,0,1,2,0,0,2,0,2,4,1
4712,94020,aj6uF4XWV3XUUfOpWCk3NuntI2wXym6n,bWdj2GDclj5ofokWjzoa5jAwMkxCykd6,3,0,0,0,0,0,9,0,9,1.2857142857142858,1,0.0,0,0,0,0,0,0,0,9,0,0,9,1
4713,94021,ZtP7ZrczBJoU0XUS4dUWlvI4t1uLf935,A3fsA9Zfv1X2fVEQhTw51lKENdNrEqT3,8,6,4,0,3,0,2,0,15,2.142857142857143,1,0.0,1,4,0,3,5,0,0,2,0,8,7,1
4714,94033,1j3EQYZpvzbHITrSXjRLOl0JrSGShjCW,SpATywNh6bZuzm8s1ceuBUnMUAeoAHHw,12,8,5,5,3,0,2,0,23,3.2857142857142856,1,0.0,2,5,4,3,6,0,1,2,0,14,9,1
4715,94041,gMeZHtHbmrRB8drlaFHRYNGQ6Z4lgho8,A3fsA9Zfv1X2fVEQhTw51lKENdNrEqT3,8,2,1,0,1,0,5,1,10,1.4285714285714286,1,0.0,0,1,0,1,2,0,0,5,1,2,8,1
4716,94050,5WAIxgqU8QRTpOrU8O3vmj4h4ZKof8jn,bWdj2GDclj5ofokWjzoa5jAwMkxCykd6,7,3,2,0,2,0,2,0,9,1.2857142857142858,1,0.0,0,2,0,2,3,0,0,2,0,4,5,1
4717,94059,WO12a2dRrxFwdlmt1PknzZCD2wf5mAFA,SpATywNh6bZuzm8s1ceuBUnMUAeoAHHw,4,3,0,0,0,0,2,0,5,0.7142857142857143,1,0.0,0,0,0,0,3,0,0,2,0,0,5,1
4718,94061,eEQqKnaUGHJzSnB7MrBGgZfDTYsV36xI,A3fsA9Zfv1X2fVEQhTw51lKENdNrEqT3,2,0,0,0,0,0,2,0,2,0.2857142857142857,1,0.0,0,0,0,0,0,0,0,2,0,0,2,1
4719,94083,sTlxlEkJ3MbMUAeSajnaHOGfpyW9hgq1,SpATywNh6bZuzm8s1ceuBUnMUAeoAHHw,7,5,2,0,2,0,2,0,11,1.5714285714285714,1,0.0,0,2,0,2,5,0,0,2,0,4,7,0
4720,94086,uKZ87zwhOlE6XjyVFr8vmJl9wOD1B9qQ,A3fsA9Zfv1X2fVEQhTw51lKENdNrEqT3,8,4,1,0,1,8,11,0,25,3.5714285714285716,2,0.0,0,1,0,1,4,8,0,11,0,2,23,1
4721,94097,uKZ87zwhOlE6XjyVFr8vmJl9wOD1B9qQ,bWdj2GDclj5ofokWjzoa5jAwMkxCykd6,1,0,0,0,0,0,1,0,1,0.14285714285714285,1,0.0,0,0,0,0,0,0,0,1,0,0,1,1
4722,94106,MRzfDn8Dt6xZQHTAuGEWQiuznoHxxpTX,SpATywNh6bZuzm8s1ceuBUnMUAeoAHHw,16,20,13,13,3,3,7,0,59,8.428571428571429,3,0.0,5,13,11,3,15,3,2,7,0,32,27,1
4723,94113,nVXGW3QRysmVp7bseFXpH5xogt6vyuOe,A3fsA9Zfv1X2fVEQhTw51lKENdNrEqT3,1,0,0,0,0,0,3,0,3,0.42857142857142855,2,0.0,0,0,0,0,0,0,0,3,0,0,3,1
4724,94124,XyD01HhzMuHzP5ArHNJFexoSZMamD6Wh,G8EPVSXsOYB5YQWZGiz1aVq5Pgr2GrQu,1,0,0,0,0,0,1,0,1,0.14285714285714285,1,0.0,0,0,0,0,0,0,0,1,0,0,1,1
4725,94128,sKWLe14EbvHw5vqAsPu64KkYjNDdUiTB,SpATywNh6bZuzm8s1ceuBUnMUAeoAHHw,6,5,0,8,0,0,4,0,17,2.4285714285714284,1,0.0,2,0,6,0,3,0,2,4,0,8,9,0
4726,94132,agX7ad5amneAPRCUHAMkIow0n3bNeaeT,SpATywNh6bZuzm8s1ceuBUnMUAeoAHHw,10,5,4,0,3,0,3,0,15,2.142857142857143,1,0.0,0,4,0,3,5,0,0,3,0,7,8,1
4727,94154,sEtktPcVAhFQ7PqkOK3agQy8gf3suIv1,SpATywNh6bZuzm8s1ceuBUnMUAeoAHHw,16,22,9,18,5,0,7,0,61,8.714285714285714,3,0.0,4,9,15,5,18,0,3,7,0,33,28,0
4728,94159,tT3q39TssUZPXoxVdRzgRUu1SUheNubE,A3fsA9Zfv1X2fVEQhTw51lKENdNrEqT3,9,5,3,0,3,1,2,0,14,2.0,1,0.0,0,3,0,3,5,1,0,2,0,6,8,1
4729,94168,ImT05r98NIKWlAcW1CpDyV3beLAyiPwI,A3fsA9Zfv1X2fVEQhTw51lKENdNrEqT3,39,20,10,72,7,0,4,0,113,16.142857142857142,2,0.0,1,10,62,7,19,0,10,4,0,80,33,1
4730,94173,ekbYWgnVFLMYoljaE2I4pYzmSROCPA7U,SpATywNh6bZuzm8s1ceuBUnMUAeoAHHw,17,21,7,11,3,15,11,1,69,9.857142857142858,3,0.0,11,7,10,3,10,15,1,11,1,31,38,1
4731,94185,uHQHB7VXsqIiN9QWww9HiRF0pTlZ4g4T,SpATywNh6bZuzm8s1ceuBUnMUAeoAHHw,12,14,1,23,0,0,2,0,40,5.714285714285714,1,0.0,4,1,20,0,10,0,3,2,0,25,15,1
4732,94191,aMoLa2myIR3XZbIIUknP0HHf77SQMaDf,A3fsA9Zfv1X2fVEQhTw51lKENdNrEqT3,1,0,0,0,0,0,1,0,1,0.14285714285714285,1,0.0,0,0,0,0,0,0,0,1,0,0,1,1
4733,94197,OOnLMU5i5dIEK7NKdoclKsBTE1KLFIfI,SpATywNh6bZuzm8s1ceuBUnMUAeoAHHw,6,7,2,0,1,0,2,0,12,1.7142857142857142,1,0.0,0,2,0,1,7,0,0,2,0,3,9,1
4734,94199,kbnRP5v2Cp1hRovzbBsM6Gb1jKCIVIhL,A3fsA9Zfv1X2fVEQhTw51lKENdNrEqT3,3,2,0,0,0,0,2,0,4,0.5714285714285714,1,0.0,0,0,0,0,2,0,0,2,0,0,4,1
4735,94203,6pBQz4v6AEbi1mr9tNTCug5y9Nmhc90r,A3fsA9Zfv1X2fVEQhTw51lKENdNrEqT3,9,8,5,0,3,0,3,0,19,2.7142857142857144,1,0.0,0,5,0,3,8,0,0,3,0,8,11,1
4736,94205,3KCb4A6amo38Fw6QE756HJn80s8Q1p3u,RXDvfPUBYFlVdlueBFbLW0mhhAyGEqpt,1,0,0,0,0,0,1,0,1,0.14285714285714285,1,0.0,0,0,0,0,0,0,0,1,0,0,1,1
4737,94208,NO1MJkdcGNcIxZKkf5qtzbhQeFobR0HR,SpATywNh6bZuzm8s1ceuBUnMUAeoAHHw,15,11,4,16,3,10,4,0,48,6.857142857142857,1,0.0,6,4,16,3,5,10,0,4,0,29,19,1
4738,94210,4cB4y17zVi4jfdrlreMIHGN1aQJHMMST,bWdj2GDclj5ofokWjzoa5jAwMkxCykd6,5,1,1,0,0,0,3,0,5,0.7142857142857143,1,0.0,0,1,0,0,1,0,0,3,0,1,4,1
4739,94213,6nUn5FL9ZAMjSGoB8M6FuLGMybzSihLy,SpATywNh6bZuzm8s1ceuBUnMUAeoAHHw,4,0,0,0,0,0,3,1,4,0.5714285714285714,1,0.0,0,0,0,0,0,0,0,3,1,0,4,1
4740,94229,dzvyuk189tsgDZIOFuacAzCgRiphRz5M,SpATywNh6bZuzm8s1ceuBUnMUAeoAHHw,2,0,0,0,0,0,2,0,2,0.2857142857142857,1,0.0,0,0,0,0,0,0,0,2,0,0,2,0
4741,94245,rFglXXD43LPWYWjk5nJFVhPJBw4btSRI,SpATywNh6bZuzm8s1ceuBUnMUAeoAHHw,11,9,2,0,1,3,8,1,24,3.4285714285714284,2,0.0,0,2,0,1,9,3,0,8,1,3,21,1
4742,94269,CyJflfaXZKlRhnAKYz3Gu6YETYpaZMel,SpATywNh6bZuzm8s1ceuBUnMUAeoAHHw,2,0,0,0,0,0,2,0,2,0.2857142857142857,1,0.0,0,0,0,0,0,0,0,2,0,0,2,1
4743,94274,0NICeN7b6gzNzu2kflLtEXCwdFBGs0NN,bWdj2GDclj5ofokWjzoa5jAwMkxCykd6,7,5,0,0,0,0,4,0,9,1.2857142857142858,1,0.0,0,0,0,0,5,0,0,4,0,0,9,1
4744,94286,M8C9BDFICk4ida59GU0jjp556zazDEi1,A3fsA9Zfv1X2fVEQhTw51lKENdNrEqT3,12,7,5,0,4,0,4,0,20,2.857142857142857,3,0.0,0,5,0,4,7,0,0,4,0,9,11,1
4745,94287,Ft2AG2HMzLmh2EcmDrFVFbinKvFMlb1G,A3fsA9Zfv1X2fVEQhTw51lKENdNrEqT3,2,0,0,0,0,0,2,0,2,0.2857142857142857,1,0.0,0,0,0,0,0,0,0,2,0,0,2,1
4746,94291,r2j4kmS3sSw2bBC6XtGVEzDG8uZSaMde,bWdj2GDclj5ofokWjzoa5jAwMkxCykd6,1,0,0,0,0,0,1,0,1,0.14285714285714285,1,0.0,0,0,0,0,0,0,0,1,0,0,1,1
4747,94294,M8C9BDFICk4ida59GU0jjp556zazDEi1,bWdj2GDclj5ofokWjzoa5jAwMkxCykd6,9,10,7,0,5,2,5,0,29,4.142857142857143,2,0.0,0,7,0,5,10,2,0,5,0,12,17,1
4748,94297,PSQvTxj1y3we6BHzfg47qDUvmFQLocrD,RXDvfPUBYFlVdlueBFbLW0mhhAyGEqpt,4,3,1,0,0,0,2,0,6,0.8571428571428571,1,0.0,0,1,0,0,3,0,0,2,0,1,5,1
4749,94303,OFXXpJjmXQdJCa3neipnRUGCkhEYKOcL,RXDvfPUBYFlVdlueBFbLW0mhhAyGEqpt,1,0,0,0,0,0,1,0,1,0.14285714285714285,1,0.0,0,0,0,0,0,0,0,1,0,0,1,1
4750,94318,VykAceZUulaqkCpokuW5Za4FHqwbjR1t,bWdj2GDclj5ofokWjzoa5jAwMkxCykd6,2,0,0,0,0,0,2,0,2,0.2857142857142857,1,0.0,0,0,0,0,0,0,0,2,0,0,2,1
4751,94327,nm4sJLNdobmK6nfqGoX1goxharKsSyKv,RXDvfPUBYFlVdlueBFbLW0mhhAyGEqpt,5,3,1,0,1,0,1,0,6,0.8571428571428571,1,0.0,0,1,0,1,3,0,0,1,0,2,4,1
4752,94336,vtU6JORjVkLaXrwFmZEhiuwgIFIb8D5d,bWdj2GDclj5ofokWjzoa5jAwMkxCykd6,4,2,0,0,0,0,2,0,4,0.5714285714285714,1,0.0,0,0,0,0,2,0,0,2,0,0,4,1
4753,94338,yk8HuNxXIum8r8XDIOHqnAVeWfg9tYo1,bWdj2GDclj5ofokWjzoa5jAwMkxCykd6,9,8,4,28,0,2,2,0,44,6.285714285714286,1,0.0,3,4,28,0,5,2,0,2,0,35,9,1
4754,94345,57fIWdKz3C3DE8VWT2c85KC8LovB1GJc,SpATywNh6bZuzm8s1ceuBUnMUAeoAHHw,8,3,0,0,0,0,6,1,10,1.4285714285714286,1,0.0,0,0,0,0,3,0,0,6,1,0,10,1
4755,94349,tkz0XqYzbemGJfGKDWj9gxriQAFTaODF,SpATywNh6bZuzm8s1ceuBUnMUAeoAHHw,5,9,4,0,0,0,3,0,16,2.2857142857142856,1,0.0,0,4,0,0,9,0,0,3,0,4,12,1
4756,94360,Wx74KNuo9MEhjxtzU2HbTG4AbGSUPoBd,SpATywNh6bZuzm8s1ceuBUnMUAeoAHHw,9,4,3,0,3,1,2,0,13,1.8571428571428572,1,0.0,0,3,0,3,4,1,0,2,0,6,7,1
4757,94369,f83h4yuqimgMGxVhGXHOS7nPCMRes6Qy,A3fsA9Zfv1X2fVEQhTw51lKENdNrEqT3,20,10,9,0,8,0,2,0,29,4.142857142857143,1,0.0,0,9,0,8,10,0,0,2,0,17,12,1
4758,94370,LfQeKYjXm6fIUOYzQcp1BnDj9xoPObW8,SpATywNh6bZuzm8s1ceuBUnMUAeoAHHw,8,7,3,0,1,0,6,0,17,2.4285714285714284,1,0.0,0,3,0,1,7,0,0,6,0,4,13,1
4759,94371,na1nn5UiTLqwc4QuFzUQCajZnMiZo4DY,SpATywNh6bZuzm8s1ceuBUnMUAeoAHHw,9,7,5,6,1,0,3,0,22,3.142857142857143,1,0.0,0,5,5,1,7,0,1,3,0,11,11,1
4760,94380,FX47GMrA7B8YjGPkDGCkONJuduXkgeGC,A3fsA9Zfv1X2fVEQhTw51lKENdNrEqT3,1,0,0,0,0,0,1,0,1,0.14285714285714285,1,0.0,0,0,0,0,0,0,0,1,0,0,1,1
4761,94381,NpKmXMDiovurtYgXEkcoE0sVWAxI8pB3,SpATywNh6bZuzm8s1ceuBUnMUAeoAHHw,2,0,0,0,0,0,3,0,3,0.42857142857142855,1,0.0,0,0,0,0,0,0,0,3,0,0,3,1
4762,94390,2ZmAuHOKUwpsOZtu09BcUrjIotbqiy3i,RXDvfPUBYFlVdlueBFbLW0mhhAyGEqpt,7,2,1,0,0,1,6,1,11,1.5714285714285714,1,0.0,0,1,0,0,2,1,0,6,1,1,10,1
4763,94412,mXYBTPDkJluI9G6T4seVU7hhFpBmZYUl,G8EPVSXsOYB5YQWZGiz1aVq5Pgr2GrQu,5,2,1,0,1,0,2,0,6,0.8571428571428571,1,0.0,0,1,0,1,2,0,0,2,0,2,4,1
4764,94434,D7ijm86N7h5o3w1fsSkZ0iVyhHtcIbis,SpATywNh6bZuzm8s1ceuBUnMUAeoAHHw,1,0,0,0,0,0,1,0,1,0.14285714285714285,1,0.0,0,0,0,0,0,0,0,1,0,0,1,0
4765,94436,dgp1qm7PjXoVV4MjyzuvWetQrJ3T9kos,A3fsA9Zfv1X2fVEQhTw51lKENdNrEqT3,10,6,4,0,2,2,18,2,34,4.857142857142857,2,0.0,0,4,0,2,6,2,0,18,2,6,28,1
4766,94440,Zp3KwB88qNkgRL7fOtXbXw8ohFvxUyg2,bWdj2GDclj5ofokWjzoa5jAwMkxCykd6,13,11,5,50,4,1,13,2,86,12.285714285714286,1,0.0,4,5,48,4,7,1,2,13,2,61,25,1
4767,94470,gTN0rkPeefB1hZOI5VW6CFWJwvhdBtBh,SpATywNh6bZuzm8s1ceuBUnMUAeoAHHw,5,2,1,0,1,0,4,0,8,1.1428571428571428,1,0.0,0,1,0,1,2,0,0,4,0,2,6,1
4768,94473,KkeLwwXyUiCfeVvKPcarXSSK8DrECkDe,A3fsA9Zfv1X2fVEQhTw51lKENdNrEqT3,4,4,1,0,0,0,2,0,7,1.0,2,0.0,0,1,0,0,4,0,0,2,0,1,6,1
4769,94480,LkgxCzljZyoH3VIdoXwdLt0OprbSc3sT,SpATywNh6bZuzm8s1ceuBUnMUAeoAHHw,13,17,10,0,3,0,9,0,39,5.571428571428571,2,0.0,0,10,0,3,17,0,0,9,0,13,26,1
4770,94491,a9Qi5jUo324IBdWO7mih7fiFScdu3QAb,SpATywNh6bZuzm8s1ceuBUnMUAeoAHHw,5,4,3,0,0,0,1,0,8,1.1428571428571428,1,0.0,0,3,0,0,4,0,0,1,0,3,5,1
4771,94493,OseLd0Vj4CawbZPfZRznLZH5tivxQP68,G8EPVSXsOYB5YQWZGiz1aVq5Pgr2GrQu,15,10,4,14,2,0,2,0,32,4.571428571428571,1,0.0,6,4,8,2,4,0,6,2,0,20,12,1
4772,94908,Y0dtU5bUn0PrrnfgvOUCPfb1rktwn4CX,fbPkOYLVPtPgIt0MxizjfFJov3JbHyAi,11,10,4,0,3,2,11,1,31,4.428571428571429,1,0.0,0,4,0,3,10,2,0,11,1,7,24,1
4773,94913,YPe9PkGt8zBUqd5BCkLiDVIWrxR3Ane8,fbPkOYLVPtPgIt0MxizjfFJov3JbHyAi,1,0,0,0,0,0,1,0,1,0.14285714285714285,1,0.0,0,0,0,0,0,0,0,1,0,0,1,1
4774,94915,CD136AEP3K4fUPxB0PiyL0uWFPHfdCLY,fbPkOYLVPtPgIt0MxizjfFJov3JbHyAi,5,2,1,0,1,0,2,0,6,0.8571428571428571,1,0.0,0,1,0,1,2,0,0,2,0,2,4,1
4775,94916,tN25USY6Yw7TL4DfXwjrjqK862rGOedD,fbPkOYLVPtPgIt0MxizjfFJov3JbHyAi,7,3,2,0,2,0,5,0,12,1.7142857142857142,1,0.0,0,2,0,2,3,0,0,5,0,4,8,1
4776,94925,PF30Vqy17JIy50CbxBzrrEB7UvSbzYk3,fbPkOYLVPtPgIt0MxizjfFJov3JbHyAi,7,3,2,0,2,0,2,0,9,1.2857142857142858,1,0.0,0,2,0,2,3,0,0,2,0,4,5,1
4777,94926,5MiwmAeXmS1fmC9lSNRxf7aBKSjN4L17,fbPkOYLVPtPgIt0MxizjfFJov3JbHyAi,1,0,0,0,0,0,1,0,1,0.14285714285714285,1,0.0,0,0,0,0,0,0,0,1,0,0,1,1
4778,94927,BMt1sMJKW8lUV5XsrUOWqq2qoU33TZEw,fbPkOYLVPtPgIt0MxizjfFJov3JbHyAi,12,9,4,0,3,12,7,3,38,5.428571428571429,2,0.0,1,4,0,3,8,12,0,7,3,8,30,0
4779,94932,Oyh3flf2wYtqmXZJ703xfAIo394jSx4Q,fbPkOYLVPtPgIt0MxizjfFJov3JbHyAi,7,2,2,0,2,1,18,3,28,4.0,1,0.0,0,2,0,2,2,1,0,18,3,4,24,1
4780,94933,oASR1hbK6DD6OJfTJCDKLW9l2vPgw7kR,fbPkOYLVPtPgIt0MxizjfFJov3JbHyAi,6,3,2,0,2,0,1,0,8,1.1428571428571428,1,0.0,0,2,0,2,3,0,0,1,0,4,4,1
4781,94935,KbVIZwe7S3MOh9dlFVWDZwSpf3zNL2tv,fbPkOYLVPtPgIt0MxizjfFJov3JbHyAi,1,0,0,0,0,0,1,0,1,0.14285714285714285,1,0.0,0,0,0,0,0,0,0,1,0,0,1,1
4782,94936,uarVJhEs6XLW7Dw1D7iBgEK6zPe65WwX,fbPkOYLVPtPgIt0MxizjfFJov3JbHyAi,6,3,2,0,1,0,3,0,9,1.2857142857142858,1,0.0,0,2,0,1,3,0,0,3,0,3,6,1
4783,94937,P6rUUMuGXrvMpG8WR8uzYUJPpfieJxTd,fbPkOYLVPtPgIt0MxizjfFJov3JbHyAi,1,0,0,0,0,0,1,0,1,0.14285714285714285,1,0.0,0,0,0,0,0,0,0,1,0,0,1,1
4784,94939,gpRi42UI7sWUeBhI8VeTEp7H6XwIGlNG,fbPkOYLVPtPgIt0MxizjfFJov3JbHyAi,2,0,0,0,0,0,9,0,9,1.2857142857142858,1,0.0,0,0,0,0,0,0,0,9,0,0,9,1
4785,94940,2gXHY5qLgY96Nt3kImmboPawcy43EQXt,fbPkOYLVPtPgIt0MxizjfFJov3JbHyAi,7,3,2,0,2,0,2,0,9,1.2857142857142858,1,0.0,0,2,0,2,3,0,0,2,0,4,5,1
4786,94942,6u1ZWprTe7uoVhqimJI2aVqsjH23ao5o,fbPkOYLVPtPgIt0MxizjfFJov3JbHyAi,7,3,2,0,2,0,4,0,11,1.5714285714285714,1,0.0,0,2,0,2,3,0,0,4,0,4,7,1
4787,94944,Z13gCiJciUykTdLRTsjNu2GwwR7Nbxp1,fbPkOYLVPtPgIt0MxizjfFJov3JbHyAi,6,3,2,0,2,0,1,0,8,1.1428571428571428,1,0.0,0,2,0,2,3,0,0,1,0,4,4,1
4788,94945,VtEfFHwCwR0CG3OZFyRUkRQlzB85HLcu,fbPkOYLVPtPgIt0MxizjfFJov3JbHyAi,4,2,1,0,1,0,1,0,5,0.7142857142857143,1,0.0,0,1,0,1,2,0,0,1,0,2,3,1
4789,94947,MDIYLIYQBWx9HiPTzYboxCieX8UYramh,fbPkOYLVPtPgIt0MxizjfFJov3JbHyAi,2,0,0,0,0,0,3,0,3,0.42857142857142855,2,0.0,0,0,0,0,0,0,0,3,0,0,3,1
4790,94948,wtEiMTsSGyqVYmzAUWtaJeXU5b3t5li0,fbPkOYLVPtPgIt0MxizjfFJov3JbHyAi,9,7,5,0,3,8,2,0,25,3.5714285714285716,1,0.0,1,5,0,3,6,8,0,2,0,9,16,1
4791,94949,6VGKONVpl1KgJ6EuaAzeKa8BNrxzEeZU,fbPkOYLVPtPgIt0MxizjfFJov3JbHyAi,5,3,1,0,1,0,1,0,6,0.8571428571428571,1,0.0,0,1,0,1,3,0,0,1,0,2,4,1
4792,94951,Th6GGIKucyCokdQsUn3aOeloTzqx0Qbo,fbPkOYLVPtPgIt0MxizjfFJov3JbHyAi,1,0,0,0,0,0,1,0,1,0.14285714285714285,1,0.0,0,0,0,0,0,0,0,1,0,0,1,1
4793,95501,XgCNwD2cEVKtD4WAVaPORGAj8LHTJr5e,A3fsA9Zfv1X2fVEQhTw51lKENdNrEqT3,1,0,0,0,0,0,1,0,1,0.14285714285714285,1,0.0,0,0,0,0,0,0,0,1,0,0,1,1
4794,95621,nH3NRDQLecB3hMbOpaitsdqKrlyEIXGh,SpATywNh6bZuzm8s1ceuBUnMUAeoAHHw,7,6,5,0,3,0,1,0,15,2.142857142857143,1,0.0,0,5,0,3,6,0,0,1,0,8,7,0
4795,95796,AfmdKPTL0IbcupndNMlY5c7PImPraChY,SpATywNh6bZuzm8s1ceuBUnMUAeoAHHw,16,9,5,9,3,0,5,1,32,4.571428571428571,1,0.0,2,5,8,3,7,0,1,5,1,18,14,1
4796,95841,AEeLy9n4nUl6UlG8WfSP7Q5sqAzFdtaD,A3fsA9Zfv1X2fVEQhTw51lKENdNrEqT3,14,16,12,0,8,13,8,1,58,8.285714285714286,4,0.0,0,12,0,8,16,13,0,8,1,20,38,0
4797,95866,wdK5DIKl9qd73hM1uOx3ufcKj0J9AcRr,A3fsA9Zfv1X2fVEQhTw51lKENdNrEqT3,4,2,1,0,1,0,1,0,5,0.7142857142857143,1,0.0,0,1,0,1,2,0,0,1,0,2,3,1
4798,95914,rTLMEQB78zn1g6bt6KRypanGZ8QWPbQv,A3fsA9Zfv1X2fVEQhTw51lKENdNrEqT3,14,21,0,0,0,20,21,1,63,9.0,3,0.0,0,0,0,0,21,20,0,21,1,0,63,0
4799,95946,VSxmvcFHrZIVtNnTaFw0qdfh1Zdl1LMy,SpATywNh6bZuzm8s1ceuBUnMUAeoAHHw,4,5,2,0,0,0,1,0,8,1.1428571428571428,1,0.0,2,2,0,0,3,0,0,1,0,4,4,0
4800,95979,kYCiC9sjJhVea0nSa72pTn7A2eOhjLmI,SpATywNh6bZuzm8s1ceuBUnMUAeoAHHw,10,6,4,0,3,1,7,1,22,3.142857142857143,1,0.0,0,4,0,3,6,1,0,7,1,7,15,1
4801,96021,ix15aF6FOEF1waZCSZt01VrPOuPGJ3yM,SpATywNh6bZuzm8s1ceuBUnMUAeoAHHw,10,6,0,6,0,4,7,1,24,3.4285714285714284,2,0.0,2,0,6,0,4,4,0,7,1,8,16,0
4802,96060,1FiRW6JL0h34vWqoZjG8ei2zujPF23NL,A3fsA9Zfv1X2fVEQhTw51lKENdNrEqT3,31,46,21,12,11,1,12,0,103,14.714285714285714,2,0.0,3,21,12,11,43,1,0,12,0,47,56,1
4803,96102,VLNGwZ1eoTZ1MrW64VolhWSmnDD0C1Ov,A3fsA9Zfv1X2fVEQhTw51lKENdNrEqT3,8,3,2,0,1,2,6,1,15,2.142857142857143,1,0.0,0,2,0,1,3,2,0,6,1,3,12,1
4804,96109,gnTcbZ4BOuQk0BfuzZDpGiEEYJSGOrYu,SpATywNh6bZuzm8s1ceuBUnMUAeoAHHw,12,12,8,16,7,5,2,0,50,7.142857142857143,1,0.0,3,8,14,7,9,5,2,2,0,32,18,1
4805,96114,XYKEbaRABcMuBHmMB2I3YkBepzCp0swB,A3fsA9Zfv1X2fVEQhTw51lKENdNrEqT3,3,2,0,0,0,0,1,0,3,0.42857142857142855,1,0.0,0,0,0,0,2,0,0,1,0,0,3,1
4806,96121,gnTcbZ4BOuQk0BfuzZDpGiEEYJSGOrYu,A3fsA9Zfv1X2fVEQhTw51lKENdNrEqT3,2,0,0,0,0,0,2,0,2,0.2857142857142857,1,0.0,0,0,0,0,0,0,0,2,0,0,2,1
4807,96133,gMMqUNqa2ZYLkCBhPE0t3hx9nA1CQadH,SpATywNh6bZuzm8s1ceuBUnMUAeoAHHw,16,28,13,20,7,11,8,1,88,12.571428571428571,2,0.0,10,13,17,7,18,11,3,8,1,47,41,0
4808,96720,nyH7Jx4kN1AdDJdwkZQoUDqYoovHgbk5,SpATywNh6bZuzm8s1ceuBUnMUAeoAHHw,7,21,11,0,10,0,2,0,44,6.285714285714286,2,0.0,0,11,0,10,21,0,0,2,0,21,23,1
4809,96733,tMJpDv6ZjEPz2ELzUVp4mZTT6G7u49T6,SpATywNh6bZuzm8s1ceuBUnMUAeoAHHw,2,0,0,0,0,0,2,0,2,0.2857142857142857,1,0.0,0,0,0,0,0,0,0,2,0,0,2,1
4810,96734,fAZJvvaqILemW9qqdyo0ZQidn1S9S3J8,RXDvfPUBYFlVdlueBFbLW0mhhAyGEqpt,42,119,2,106,4,16,22,5,274,39.142857142857146,5,0.0,14,2,91,4,105,16,15,22,5,111,163,1
4811,96776,Q2sM7xUZ5pftXbE3pDquUzMiyNyEc1IS,SpATywNh6bZuzm8s1ceuBUnMUAeoAHHw,5,6,0,0,0,1,5,0,12,1.7142857142857142,1,0.0,0,0,0,0,6,1,0,5,0,0,12,1
4812,96818,ULdF32fTmMpV957Ngz6P80D0kuxYFb2A,SpATywNh6bZuzm8s1ceuBUnMUAeoAHHw,16,14,5,8,2,0,8,1,38,5.428571428571429,2,0.0,9,5,8,2,5,0,0,8,1,24,14,0
4813,96873,cD5CJQRtTCG0McZYvErqx6oV3tTvutc8,RXDvfPUBYFlVdlueBFbLW0mhhAyGEqpt,46,50,22,73,9,19,7,3,183,26.142857142857142,1,0.0,11,22,70,9,39,19,3,7,3,112,71,1
4814,96901,umy7brIUz48bN1VUJsZEuHA9by5FINCa,7GRhBDsirIGkRZBtSMEzNTyDr2JQm4xx,4,2,1,0,1,0,1,0,5,0.7142857142857143,1,0.0,0,1,0,1,2,0,0,1,0,2,3,1
4815,96903,1pK61ylyaaC4hALoXRUV5dMzHILaBLST,7GRhBDsirIGkRZBtSMEzNTyDr2JQm4xx,10,6,4,0,3,3,5,0,21,3.0,1,0.0,0,4,0,3,6,3,0,5,0,7,14,1
4816,96909,cydJyLaLNn5DY7FvXVsvxCdKUpzLzSYa,7GRhBDsirIGkRZBtSMEzNTyDr2JQm4xx,1,0,0,0,0,0,1,0,1,0.14285714285714285,1,0.0,0,0,0,0,0,0,0,1,0,0,1,1
4817,96942,ddBSvwjxr0YTDDcnYkevrytFfJuV96PQ,7GRhBDsirIGkRZBtSMEzNTyDr2JQm4xx,6,2,2,0,1,4,3,0,12,1.7142857142857142,1,0.0,0,2,0,1,2,4,0,3,0,3,9,0
4818,96973,sDkPRIBG4BxIPEbrLzSh2qpuZHtht3Is,7GRhBDsirIGkRZBtSMEzNTyDr2JQm4xx,5,5,0,0,0,4,2,1,12,1.7142857142857142,1,0.0,0,0,0,0,5,4,0,2,1,0,12,1
4819,96985,JXYISIoy0xfDgxPuIXBBnerkjGt68Wii,7GRhBDsirIGkRZBtSMEzNTyDr2JQm4xx,2,0,0,0,0,0,2,0,2,0.2857142857142857,1,0.0,0,0,0,0,0,0,0,2,0,0,2,1
4820,96988,UpJhrUDqF2VjXGqQuraSx51MIPsKK7IC,7GRhBDsirIGkRZBtSMEzNTyDr2JQm4xx,1,0,0,0,0,0,1,0,1,0.14285714285714285,1,0.0,0,0,0,0,0,0,0,1,0,0,1,1
4821,96994,Pn5FZNl6VLJk6Snk5stzxPkp0wDMfahE,7GRhBDsirIGkRZBtSMEzNTyDr2JQm4xx,17,18,7,6,7,6,3,0,47,6.714285714285714,1,0.0,10,7,5,7,8,6,1,3,0,29,18,1
4822,97000,NTUe1XMr3a8PtjVuNaWc1ebEh7ejstpo,7GRhBDsirIGkRZBtSMEzNTyDr2JQm4xx,5,3,1,0,1,1,2,0,8,1.1428571428571428,1,0.0,0,1,0,1,3,1,0,2,0,2,6,1
4823,97002,uRoFRO1euFkfOgsqx7mXaWeoTuIR1DXQ,7GRhBDsirIGkRZBtSMEzNTyDr2JQm4xx,1,0,0,0,0,0,1,0,1,0.14285714285714285,1,0.0,0,0,0,0,0,0,0,1,0,0,1,1
4824,97009,nRHQUNRUIsIinoYx4tQlxNnAC0I3YYVk,7GRhBDsirIGkRZBtSMEzNTyDr2JQm4xx,4,2,1,0,1,0,1,0,5,0.7142857142857143,1,0.0,0,1,0,1,2,0,0,1,0,2,3,1
4825,97022,B5xWWXtq7QtEIXusjmb70Va0vI762ykg,7GRhBDsirIGkRZBtSMEzNTyDr2JQm4xx,1,0,0,0,0,0,1,0,1,0.14285714285714285,1,0.0,0,0,0,0,0,0,0,1,0,0,1,1
4826,97065,M2tv4JvKfiiNHzXtHrilXY5dpWpYAsaI,7GRhBDsirIGkRZBtSMEzNTyDr2JQm4xx,8,5,3,0,2,1,6,1,18,2.5714285714285716,1,0.0,0,3,0,2,5,1,0,6,1,5,13,1
4827,97117,c8WJAdYLV71mOx4ZXSglpCNd0dBUR3Om,7GRhBDsirIGkRZBtSMEzNTyDr2JQm4xx,52,38,15,53,9,0,6,0,121,17.285714285714285,2,0.0,19,15,53,9,19,0,0,6,0,96,25,0
4828,97118,4qkLaALORr1a036cib5fpJjiu97UEMIR,A3fsA9Zfv1X2fVEQhTw51lKENdNrEqT3,1,0,0,0,0,0,1,0,1,0.14285714285714285,1,0.0,0,0,0,0,0,0,0,1,0,0,1,0
4829,97187,QRq9SneqdOEdNrPCbzGfNOJsUrpMzzSX,7GRhBDsirIGkRZBtSMEzNTyDr2JQm4xx,6,2,1,0,0,0,4,1,8,1.1428571428571428,1,0.0,0,1,0,0,2,0,0,4,1,1,7,1
4830,97267,lDlatmKJdo0qBYapZcbWQLsUydBhY3xU,7GRhBDsirIGkRZBtSMEzNTyDr2JQm4xx,2,0,0,0,0,0,2,0,2,0.2857142857142857,1,0.0,0,0,0,0,0,0,0,2,0,0,2,1
4831,97280,K3hHnTNefmiCtc4XrTaWBBqlsZLO9w2Y,7GRhBDsirIGkRZBtSMEzNTyDr2JQm4xx,7,2,1,0,1,0,6,0,10,1.4285714285714286,1,0.0,0,1,0,1,2,0,0,6,0,2,8,1
4832,97284,pMJooPSuvdyxYlrVEgbsDyM57xOtG2AB,7GRhBDsirIGkRZBtSMEzNTyDr2JQm4xx,10,20,8,0,3,5,12,1,49,7.0,1,0.0,0,8,0,3,20,5,0,12,1,11,38,1
4833,97298,tp9GLoYyljDV6mILQxrtrv1Iw4qcPl5Z,7GRhBDsirIGkRZBtSMEzNTyDr2JQm4xx,6,4,2,0,1,0,2,0,9,1.2857142857142858,1,0.0,1,2,0,1,3,0,0,2,0,4,5,1
4834,97310,OQh4D4FzaoRB0CBhRcAfr9BP6p8j9VSR,7GRhBDsirIGkRZBtSMEzNTyDr2JQm4xx,46,108,41,63,28,22,14,1,277,39.57142857142857,2,0.0,59,41,55,28,49,22,8,14,1,183,94,1
4835,97320,l70wRZ2DS0s6LjbT7C4gRoGrF27x9p2H,7GRhBDsirIGkRZBtSMEzNTyDr2JQm4xx,5,4,1,0,1,0,2,0,8,1.1428571428571428,2,0.0,0,1,0,1,4,0,0,2,0,2,6,1
4836,97324,f90qLjbKhR4QYxfjw2iRpmn1h5TurGYb,7GRhBDsirIGkRZBtSMEzNTyDr2JQm4xx,1,0,0,0,0,0,1,0,1,0.14285714285714285,1,0.0,0,0,0,0,0,0,0,1,0,0,1,1
4837,97328,drUu3tyovHqnF7EAaPHayHDYbWMe2Od6,7GRhBDsirIGkRZBtSMEzNTyDr2JQm4xx,1,0,0,0,0,0,1,0,1,0.14285714285714285,1,0.0,0,0,0,0,0,0,0,1,0,0,1,1
4838,97345,PUW0i4IuafllkJEtV0GCqmTDeLHkDmH3,7GRhBDsirIGkRZBtSMEzNTyDr2JQm4xx,26,28,8,34,0,2,4,0,76,10.857142857142858,2,0.0,10,8,29,0,18,2,5,4,0,47,29,0
4839,97357,VnkZQ14wQqfipOllRb5zJLKqrvJ7kfcr,7GRhBDsirIGkRZBtSMEzNTyDr2JQm4xx,25,70,24,24,11,2,8,0,139,19.857142857142858,2,0.0,37,24,22,11,33,2,2,8,0,94,45,1
4840,97373,PkSfLYbj8bmlsWpi3b15gaXmhBJLMldT,7GRhBDsirIGkRZBtSMEzNTyDr2JQm4xx,4,0,0,0,0,0,5,0,5,0.7142857142857143,1,0.0,0,0,0,0,0,0,0,5,0,0,5,1
4841,97388,X4FMUX7NyjmKPKTTYvtQYUeaVHGTuyBO,7GRhBDsirIGkRZBtSMEzNTyDr2JQm4xx,1,0,0,0,0,0,1,0,1,0.14285714285714285,1,0.0,0,0,0,0,0,0,0,1,0,0,1,1
4842,97462,nCZrnJjbpsSoXVwiEhCJqTYAOI3F94p9,7GRhBDsirIGkRZBtSMEzNTyDr2JQm4xx,1,0,0,0,0,0,1,0,1,0.14285714285714285,1,0.0,0,0,0,0,0,0,0,1,0,0,1,1
4843,97464,rX6twqRSTJA5YELRg8HEcckmy1BY4CL4,7GRhBDsirIGkRZBtSMEzNTyDr2JQm4xx,2,0,0,0,0,0,4,0,4,0.5714285714285714,1,0.0,0,0,0,0,0,0,0,4,0,0,4,1
4844,97489,gSg4PIaWl0hBhOgVlpN9o8YrQn4pTOeq,A3fsA9Zfv1X2fVEQhTw51lKENdNrEqT3,36,27,23,42,16,4,8,0,120,17.142857142857142,1,0.0,2,23,36,16,25,4,6,8,0,77,43,1
4845,97503,kuZwBvEdgeUtKZ495C2FptBbxEtLtmVH,A3fsA9Zfv1X2fVEQhTw51lKENdNrEqT3,41,35,16,48,10,0,7,0,116,16.571428571428573,3,0.0,3,16,45,10,32,0,3,7,0,74,42,0
4846,97505,irC65kbKvoZeQoBjNpGJgeuitn3hVGmi,7GRhBDsirIGkRZBtSMEzNTyDr2JQm4xx,16,13,8,0,6,0,1,0,28,4.0,1,0.0,4,8,0,6,9,0,0,1,0,18,10,1
4847,97552,EO6xtvTLkHLCut4ifOiDl6xUZBrLObA6,7GRhBDsirIGkRZBtSMEzNTyDr2JQm4xx,1,0,0,0,0,0,1,0,1,0.14285714285714285,1,0.0,0,0,0,0,0,0,0,1,0,0,1,1
4848,97591,2B1Sa19tBbYgocD2xlB5fX7K09dmclmZ,7GRhBDsirIGkRZBtSMEzNTyDr2JQm4xx,5,5,1,0,1,0,1,0,8,1.1428571428571428,1,0.0,0,1,0,1,5,0,0,1,0,2,6,1
4849,97613,kz8Qaij4c30iDpbw4iAszcAM45hxcKwU,7GRhBDsirIGkRZBtSMEzNTyDr2JQm4xx,6,2,1,0,1,0,4,0,8,1.1428571428571428,2,0.0,0,1,0,1,2,0,0,4,0,2,6,1
4850,97636,xjgxPvzfyFRaUpAnYKBxqwH6viCz5kQQ,7GRhBDsirIGkRZBtSMEzNTyDr2JQm4xx,11,8,0,0,0,2,3,0,13,1.8571428571428572,1,0.0,0,0,0,0,8,2,0,3,0,0,13,1
4851,97740,pC1UDzWN2ohmqWVct0AFjGKW6gzUzWEQ,7GRhBDsirIGkRZBtSMEzNTyDr2JQm4xx,1,0,0,0,0,0,1,0,1,0.14285714285714285,1,0.0,0,0,0,0,0,0,0,1,0,0,1,1
4852,97741,WIkPVA3ZQexYqPa7aSal3hPiR2XYOXKW,7GRhBDsirIGkRZBtSMEzNTyDr2JQm4xx,7,5,3,4,1,4,2,0,19,2.7142857142857144,1,0.0,1,3,3,1,4,4,1,2,0,8,11,1
4853,97788,rUoEyfIkacNKFckMvyv3DLlxAp35p4TH,7GRhBDsirIGkRZBtSMEzNTyDr2JQm4xx,1,0,0,0,0,0,1,0,1,0.14285714285714285,1,0.0,0,0,0,0,0,0,0,1,0,0,1,1
4854,97823,ATQZndVeRd2FYpO1RdHKpCdTF73Knsgq,7GRhBDsirIGkRZBtSMEzNTyDr2JQm4xx,25,28,8,22,9,0,1,0,68,9.714285714285714,1,0.0,19,8,20,9,9,0,2,1,0,56,12,1
4855,97850,xRxxfDF9JUhs0UX7r4WnpuABa2UDKRlw,7GRhBDsirIGkRZBtSMEzNTyDr2JQm4xx,5,3,1,0,1,0,2,0,7,1.0,1,0.0,0,1,0,1,3,0,0,2,0,2,5,1
4856,97852,ZzaZO5citAcoeYBQ4xnco2bMgq0deP0c,7GRhBDsirIGkRZBtSMEzNTyDr2JQm4xx,5,2,1,0,1,0,2,0,6,0.8571428571428571,1,0.0,0,1,0,1,2,0,0,2,0,2,4,1
4857,97886,OCAzb1VfLGBRFoguhxZLxVaO4EgntnGi,7GRhBDsirIGkRZBtSMEzNTyDr2JQm4xx,11,5,4,0,3,2,9,1,24,3.4285714285714284,1,0.0,0,4,0,3,5,2,0,9,1,7,17,1
4858,97920,vWPEyRranfmzkX1ptXTrcH52A4pj7s7J,7GRhBDsirIGkRZBtSMEzNTyDr2JQm4xx,8,6,3,0,1,0,7,0,17,2.4285714285714284,1,0.0,0,3,0,1,6,0,0,7,0,4,13,1
4859,98950,ltaPWMahEaqTdpjQAeiBFxa5xewAQJDv,SpATywNh6bZuzm8s1ceuBUnMUAeoAHHw,1,0,0,0,0,0,1,0,1,0.14285714285714285,1,0.0,0,0,0,0,0,0,0,1,0,0,1,1
4860,98954,wBGtqMIqfQE0VLJPhcCJAUkBOhFNa6qW,G8EPVSXsOYB5YQWZGiz1aVq5Pgr2GrQu,7,4,0,0,0,0,10,1,15,2.142857142857143,3,0.0,0,0,0,0,4,0,0,10,1,0,15,1
4861,98963,y2GG0eXD492QyyIoYTZNCQnQCo2nl9OI,SpATywNh6bZuzm8s1ceuBUnMUAeoAHHw,4,6,0,0,0,1,2,0,9,1.2857142857142858,1,0.0,0,0,0,0,6,1,0,2,0,0,9,1
4862,98973,uxdJIidy36Grvd6xNfpUFUhDe4OC7W0I,SpATywNh6bZuzm8s1ceuBUnMUAeoAHHw,2,0,0,0,0,0,2,0,2,0.2857142857142857,1,0.0,0,0,0,0,0,0,0,2,0,0,2,1
4863,98979,fIRimGrxWNqdzbEvkhoxiWFjGRhUXcWW,bWdj2GDclj5ofokWjzoa5jAwMkxCykd6,9,12,9,0,7,0,3,0,31,4.428571428571429,3,0.0,0,9,0,7,12,0,0,3,0,16,15,1
4864,98990,m30r8XAusN1tKwuw4RNeOZUufFJ19O18,G8EPVSXsOYB5YQWZGiz1aVq5Pgr2GrQu,1,0,0,0,0,0,1,0,1,0.14285714285714285,1,0.0,0,0,0,0,0,0,0,1,0,0,1,1
4865,99018,ifcc4uHfz9c03WKs2R4honhWtRoNdK5d,SpATywNh6bZuzm8s1ceuBUnMUAeoAHHw,4,0,0,0,0,0,4,0,4,0.5714285714285714,1,0.0,0,0,0,0,0,0,0,4,0,0,4,1
4866,99029,qg6GOCuPcDwehPMMAEed7GZuAdyiaV9B,bWdj2GDclj5ofokWjzoa5jAwMkxCykd6,14,23,0,72,5,0,9,3,112,16.0,2,0.0,14,0,71,5,9,0,1,9,3,90,22,0
4867,99046,O7BkYKGPbSCKVITR1KG0UTtUy6cDdabs,SpATywNh6bZuzm8s1ceuBUnMUAeoAHHw,13,8,5,9,3,0,4,0,29,4.142857142857143,1,0.0,3,5,9,3,5,0,0,4,0,20,9,1
4868,99054,zzAZgy76SGFU6cR6cdB2SgVDsOtIFGEc,SpATywNh6bZuzm8s1ceuBUnMUAeoAHHw,14,28,15,16,3,10,2,0,74,10.571428571428571,1,0.0,7,15,14,3,21,10,2,2,0,39,35,1
4869,99058,84jM92o4oluSWHz68fjJdNU1O5aejzX8,G8EPVSXsOYB5YQWZGiz1aVq5Pgr2GrQu,17,33,3,0,3,2,11,1,53,7.571428571428571,3,0.0,6,3,0,3,27,2,0,11,1,12,41,0
4870,99066,T3sGbyIt0UjiteEMsVXGzcCDHseJZwlW,bWdj2GDclj5ofokWjzoa5jAwMkxCykd6,3,0,0,0,0,0,5,0,5,0.7142857142857143,1,0.0,0,0,0,0,0,0,0,5,0,0,5,1
4871,99069,88XDkNH6bI4ALBv7wIako8gqEashqdgA,bWdj2GDclj5ofokWjzoa5jAwMkxCykd6,4,2,0,0,0,0,2,0,4,0.5714285714285714,1,0.0,0,0,0,0,2,0,0,2,0,0,4,1
4872,99070,9e5dcfJQbPUU8sTcmzE9DWoDPOA9Nhu3,RXDvfPUBYFlVdlueBFbLW0mhhAyGEqpt,10,15,1,0,1,0,2,0,19,2.7142857142857144,1,0.0,0,1,0,1,15,0,0,2,0,2,17,0
4873,99081,ZC2nAMORm6ACPbodv0ZDapZ3ammrIH2s,G8EPVSXsOYB5YQWZGiz1aVq5Pgr2GrQu,6,1,1,0,1,0,3,0,6,0.8571428571428571,1,0.0,0,1,0,1,1,0,0,3,0,2,4,1
4874,99082,4DxKDIVHzjxY43c2DifDetzvvaumQ2x6,RXDvfPUBYFlVdlueBFbLW0mhhAyGEqpt,8,7,1,0,1,0,1,0,10,1.4285714285714286,1,0.0,0,1,0,1,7,0,0,1,0,2,8,0
4875,99098,obIiPpvlsnw7kahKveiA1IdOjIdBUlWR,bWdj2GDclj5ofokWjzoa5jAwMkxCykd6,4,3,1,0,0,0,3,0,7,1.0,1,0.0,0,1,0,0,3,0,0,3,0,1,6,1
4876,99100,ZMTgNYkbfDsBe4X8ZM8wJYJMTUYSz0bl,SpATywNh6bZuzm8s1ceuBUnMUAeoAHHw,13,13,0,11,0,37,8,4,73,10.428571428571429,2,0.0,3,0,10,0,10,37,1,8,4,13,60,1
4877,99107,r3OdfccxoUjSXp0sWnFk9IAbamqaQLkg,SpATywNh6bZuzm8s1ceuBUnMUAeoAHHw,6,14,0,0,0,0,4,0,18,2.5714285714285716,3,0.0,0,0,0,0,14,0,0,4,0,0,18,1
4878,99118,8P2tXYi4EZDZkbdP0MJKzxjbxyxdg79S,bWdj2GDclj5ofokWjzoa5jAwMkxCykd6,2,0,0,0,0,0,2,0,2,0.2857142857142857,1,0.0,0,0,0,0,0,0,0,2,0,0,2,1
4879,99132,euFeRK4WVq3xP7j8z58Hdv4WK0cZyZNI,RXDvfPUBYFlVdlueBFbLW0mhhAyGEqpt,46,39,25,64,16,7,6,1,158,22.571428571428573,1,0.0,9,25,60,16,30,7,4,6,1,110,48,1
4880,99139,Q8CD0UEUMHAcRhd0KntpUKYo8YWk4fXe,SpATywNh6bZuzm8s1ceuBUnMUAeoAHHw,6,5,0,0,0,0,1,0,6,0.8571428571428571,1,0.0,0,0,0,0,5,0,0,1,0,0,6,1
4881,99174,u8ZjG1mGoKDfAR0qANs0LauHsnuYvByf,SpATywNh6bZuzm8s1ceuBUnMUAeoAHHw,2,0,0,0,0,0,2,0,2,0.2857142857142857,1,0.0,0,0,0,0,0,0,0,2,0,0,2,1
4882,99181,3gKLDpGjwKizSsdfJ1bxm4OzkmE9SSv0,G8EPVSXsOYB5YQWZGiz1aVq5Pgr2GrQu,10,5,3,0,3,0,5,2,18,2.5714285714285716,1,0.0,1,3,0,3,4,0,0,5,2,7,11,1
4883,99209,cKCzrCCCXe9nkBgWepq9AEXje7SITRTz,RXDvfPUBYFlVdlueBFbLW0mhhAyGEqpt,1,0,0,0,0,0,1,0,1,0.14285714285714285,1,0.0,0,0,0,0,0,0,0,1,0,0,1,1
4884,99238,Sd9iWVuleZqBvt54uADj49zmx7nnkEGd,SpATywNh6bZuzm8s1ceuBUnMUAeoAHHw,7,4,2,0,1,1,7,0,15,2.142857142857143,2,0.0,0,2,0,1,4,1,0,7,0,3,12,1
4885,99239,T0WYTVwYJgFl0x8drZ3acqWyc5rt9vgS,bWdj2GDclj5ofokWjzoa5jAwMkxCykd6,8,6,4,0,3,0,8,0,21,3.0,1,0.0,0,4,0,3,6,0,0,8,0,7,14,1
4886,99253,8i7cvJkHkgdZTPaFAtgMAW0lWMM44P2s,bWdj2GDclj5ofokWjzoa5jAwMkxCykd6,11,11,5,26,0,2,3,0,47,6.714285714285714,1,0.0,5,5,24,0,6,2,2,3,0,34,13,0
4887,99270,CV7h2ez66N3XbcrhHK1a0MSuvaKeLrbg,SpATywNh6bZuzm8s1ceuBUnMUAeoAHHw,4,2,1,0,1,0,1,0,5,0.7142857142857143,1,0.0,0,1,0,1,2,0,0,1,0,2,3,1
4888,99271,Pe5w2Jkb1gsjqOIYHp7FZfmU0KM6bSQ8,SpATywNh6bZuzm8s1ceuBUnMUAeoAHHw,9,15,1,24,0,39,3,0,82,11.714285714285714,2,0.0,9,1,19,0,6,39,5,3,0,29,53,1
4889,99274,F6DWPZmYOtVM9PypQunsAj9fDIO5oqCA,SpATywNh6bZuzm8s1ceuBUnMUAeoAHHw,7,3,1,0,2,0,2,0,8,1.1428571428571428,1,0.0,0,1,0,2,3,0,0,2,0,3,5,1
4890,99278,Zq7w9tMtshfWhXKxO6HgVWaJZugCDD4X,SpATywNh6bZuzm8s1ceuBUnMUAeoAHHw,7,2,0,0,0,0,6,1,9,1.2857142857142858,1,0.0,0,0,0,0,2,0,0,6,1,0,9,1
4891,99281,kLCnsSmz7iq09RICj2W5oj0rePK2t86T,A3fsA9Zfv1X2fVEQhTw51lKENdNrEqT3,7,4,2,0,1,0,5,0,12,1.7142857142857142,2,0.0,0,2,0,1,4,0,0,5,0,3,9,1
4892,99291,kkiueCBXYoPTmt9I3HbEovrMKKFeGu6b,SpATywNh6bZuzm8s1ceuBUnMUAeoAHHw,7,4,3,0,2,0,1,0,10,1.4285714285714286,1,0.0,0,3,0,2,4,0,0,1,0,5,5,1
4893,99301,U77qPrnpSziwcYTMiYVhQDvF7hOqssuP,A3fsA9Zfv1X2fVEQhTw51lKENdNrEqT3,1,0,0,0,0,0,1,0,1,0.14285714285714285,1,0.0,0,0,0,0,0,0,0,1,0,0,1,1
4894,99307,uA8rfZuH0eMveW06zMXRELfenuAEs8xA,RXDvfPUBYFlVdlueBFbLW0mhhAyGEqpt,12,10,8,0,6,0,1,0,25,3.5714285714285716,1,0.0,1,8,0,6,9,0,0,1,0,15,10,1
4895,99308,LtEcnNjG2bVTqyOQr5fGITsmCk6KdvTV,SpATywNh6bZuzm8s1ceuBUnMUAeoAHHw,7,3,2,0,2,0,2,0,9,1.2857142857142858,1,0.0,0,2,0,2,3,0,0,2,0,4,5,1
4896,99311,70RjGajH7pmMAPjzGV9cfLTOEtPaOO7x,bWdj2GDclj5ofokWjzoa5jAwMkxCykd6,4,0,0,0,0,0,5,1,6,0.8571428571428571,1,0.0,0,0,0,0,0,0,0,5,1,0,6,1
4897,99324,zZiKahy0aUh5eIyH06AprK07k6t9S0px,SpATywNh6bZuzm8s1ceuBUnMUAeoAHHw,1,0,0,0,0,0,1,0,1,0.14285714285714285,1,0.0,0,0,0,0,0,0,0,1,0,0,1,1
4898,99328,4lIBX7jVNURqeuVw7y54KWNhg5lYseZ6,bWdj2GDclj5ofokWjzoa5jAwMkxCykd6,10,8,3,0,2,5,7,0,25,3.5714285714285716,3,0.0,0,3,0,2,8,5,0,7,0,5,20,1
4899,99344,JbEjxQ5AsXJ2R3WBH2hwFnQgUiz9YCm1,RXDvfPUBYFlVdlueBFbLW0mhhAyGEqpt,33,71,42,41,21,19,32,5,231,33.0,3,0.0,14,42,33,21,57,19,8,32,5,110,121,0
4900,99347,d03TqUFy5aM2PIFe72rgYScPoI0zjriD,SpATywNh6bZuzm8s1ceuBUnMUAeoAHHw,1,0,0,0,0,0,1,0,1,0.14285714285714285,1,0.0,0,0,0,0,0,0,0,1,0,0,1,1
4901,99352,KQNAn65G00s1hNhpNIZbIlQjdMIvn0te,SpATywNh6bZuzm8s1ceuBUnMUAeoAHHw,3,2,0,0,0,1,2,0,5,0.7142857142857143,1,0.0,0,0,0,0,2,1,0,2,0,0,5,1
4902,99357,dA2znH7Ys1BZ6Ag1jC6siF2XLsfXuatY,G8EPVSXsOYB5YQWZGiz1aVq5Pgr2GrQu,3,0,0,0,0,0,3,0,3,0.42857142857142855,1,0.0,0,0,0,0,0,0,0,3,0,0,3,1
4903,99361,RUkwQN28KywAbYCPf8B2kmvVB4j6glMk,SpATywNh6bZuzm8s1ceuBUnMUAeoAHHw,4,3,0,0,0,0,2,0,5,0.7142857142857143,1,0.0,0,0,0,0,3,0,0,2,0,0,5,1
4904,99362,pUTxXh2GY765KSOGlKRsr8whr66yS2si,SpATywNh6bZuzm8s1ceuBUnMUAeoAHHw,6,3,1,0,1,0,2,0,7,1.0,1,0.0,0,1,0,1,3,0,0,2,0,2,5,1
4905,99367,7j1Qy60pQmlvQ7Dqk2iUN3aMOz565Svk,SpATywNh6bZuzm8s1ceuBUnMUAeoAHHw,9,5,3,0,3,0,3,0,14,2.0,2,0.0,1,3,0,3,4,0,0,3,0,7,7,1
4906,99368,7M1gTpajHgYWFRBJBTE3YPlAjNYb9gfx,SpATywNh6bZuzm8s1ceuBUnMUAeoAHHw,1,0,0,0,0,0,1,0,1,0.14285714285714285,1,0.0,0,0,0,0,0,0,0,1,0,0,1,1
4907,99369,qW9QfVksexOjxQBoakOZ3N1wOwk2Uoq3,SpATywNh6bZuzm8s1ceuBUnMUAeoAHHw,4,2,0,0,0,0,4,0,6,0.8571428571428571,1,0.0,0,0,0,0,2,0,0,4,0,0,6,1
4908,99379,0DbC5JilnobJmMMZ806aDGvS966g1ymK,SpATywNh6bZuzm8s1ceuBUnMUAeoAHHw,5,3,1,0,1,1,2,0,8,1.1428571428571428,1,0.0,0,1,0,1,3,1,0,2,0,2,6,1
4909,99380,0DbC5JilnobJmMMZ806aDGvS966g1ymK,G8EPVSXsOYB5YQWZGiz1aVq5Pgr2GrQu,1,0,0,0,0,0,1,0,1,0.14285714285714285,1,0.0,0,0,0,0,0,0,0,1,0,0,1,1
4910,99395,kKVwpcRVIoBHXwQJxUscCmJVsObHmuic,SpATywNh6bZuzm8s1ceuBUnMUAeoAHHw,11,6,4,0,3,0,5,1,19,2.7142857142857144,1,0.0,0,4,0,3,6,0,0,5,1,7,12,1
4911,99410,RrZI3LBwWWMML70TBgENRap2pJnz1WcI,G8EPVSXsOYB5YQWZGiz1aVq5Pgr2GrQu,7,8,2,0,3,0,3,0,16,2.2857142857142856,1,0.0,4,2,0,3,4,0,0,3,0,9,7,1
4912,99419,CIojvdkZCguBWuN7246vWmUJ6qBNp7JQ,RXDvfPUBYFlVdlueBFbLW0mhhAyGEqpt,28,20,5,49,2,0,3,0,79,11.285714285714286,1,0.0,7,5,48,2,13,0,1,3,0,62,17,1
4913,99429,Og1p6VqqK505SKTAg7oggM1PpCX9htgK,bWdj2GDclj5ofokWjzoa5jAwMkxCykd6,2,0,0,0,0,0,2,0,2,0.2857142857142857,1,0.0,0,0,0,0,0,0,0,2,0,0,2,1
4914,99436,rPmua3xrnLtgdU4TZGq8z4hoSz54twnz,RXDvfPUBYFlVdlueBFbLW0mhhAyGEqpt,2,0,0,0,0,0,2,0,2,0.2857142857142857,1,0.0,0,0,0,0,0,0,0,2,0,0,2,1
4915,99458,XKiESHLmmxxFLSNhNTicMKXZo07ga8rR,SpATywNh6bZuzm8s1ceuBUnMUAeoAHHw,17,21,6,27,3,5,9,1,72,10.285714285714286,1,0.0,12,6,22,3,9,5,5,9,1,43,29,1
4916,99460,x0kuyWECJARUGYUkf8OBmp3NS07aeieW,SpATywNh6bZuzm8s1ceuBUnMUAeoAHHw,13,9,6,6,5,19,5,1,51,7.285714285714286,1,0.0,0,6,5,5,9,19,1,5,1,16,35,1
4917,99465,dDLv4oouOmVB45Y4hnRyV7IUqT7tMKiq,RXDvfPUBYFlVdlueBFbLW0mhhAyGEqpt,5,4,2,0,1,2,2,0,11,1.5714285714285714,1,0.0,0,2,0,1,4,2,0,2,0,3,8,1
4918,99476,H1SXscwZbeBIGdJtjznbLlFWKEefKgS4,bWdj2GDclj5ofokWjzoa5jAwMkxCykd6,1,0,0,0,0,0,1,0,1,0.14285714285714285,1,0.0,0,0,0,0,0,0,0,1,0,0,1,1
4919,99482,YLgIjYna0b19CObH0aixdNFVjkWguI8z,SpATywNh6bZuzm8s1ceuBUnMUAeoAHHw,6,3,1,0,1,0,2,0,7,1.0,1,0.0,0,1,0,1,3,0,0,2,0,2,5,1
4920,99499,nazeZS8BdRMOGGuVriyb5M21Pn5Qng36,RXDvfPUBYFlVdlueBFbLW0mhhAyGEqpt,1,0,0,0,0,0,2,0,2,0.2857142857142857,2,0.0,0,0,0,0,0,0,0,2,0,0,2,1
4921,99504,F6k3M4cXPmDcGMYwz4MYjROjPe1tP3Ym,SpATywNh6bZuzm8s1ceuBUnMUAeoAHHw,2,0,0,0,0,0,2,0,2,0.2857142857142857,1,0.0,0,0,0,0,0,0,0,2,0,0,2,1
4922,99519,qsSi1uSJyI5PyAmcKOuOd3i9fMbo7Kcq,SpATywNh6bZuzm8s1ceuBUnMUAeoAHHw,11,14,1,4,0,7,9,6,41,5.857142857142857,1,0.0,0,1,3,0,14,7,1,9,6,4,37,1
4923,99523,tItJmM8DSrsR2C4SUW6G90kGTH9CET7i,A3fsA9Zfv1X2fVEQhTw51lKENdNrEqT3,1,0,0,0,0,0,1,0,1,0.14285714285714285,1,0.0,0,0,0,0,0,0,0,1,0,0,1,1
4924,99528,9HLdaHmr6CL0Qkr0yUtrnxT1uvy3iohQ,G8EPVSXsOYB5YQWZGiz1aVq5Pgr2GrQu,4,4,2,0,0,2,3,0,11,1.5714285714285714,1,0.0,0,2,0,0,4,2,0,3,0,2,9,1
4925,99538,aApTNsNL5V8p77KfIZfCDf8PLQlY5mEZ,RXDvfPUBYFlVdlueBFbLW0mhhAyGEqpt,10,5,4,0,3,0,2,0,14,2.0,1,0.0,0,4,0,3,5,0,0,2,0,7,7,1
4926,99544,VMv3kIqXbjzzweiSaOh7btZJMGqiha14,SpATywNh6bZuzm8s1ceuBUnMUAeoAHHw,8,5,3,0,2,0,4,0,14,2.0,2,0.0,0,3,0,2,5,0,0,4,0,5,9,1
4927,99548,hbUthRcRktel8CTk5FJE2GFw0tsGaPJX,SpATywNh6bZuzm8s1ceuBUnMUAeoAHHw,8,7,1,0,0,0,6,1,15,2.142857142857143,2,0.0,2,1,0,0,5,0,0,6,1,3,12,1
4928,99553,B48liWLvGTFhxmScNtRccVTYMrDSRz6T,SpATywNh6bZuzm8s1ceuBUnMUAeoAHHw,11,30,0,17,0,9,6,0,62,8.857142857142858,1,0.0,15,0,16,0,15,9,1,6,0,31,31,1
4929,99559,UvQp4bR98Xn1uwzsk2XfrzaGsOC8PbwE,SpATywNh6bZuzm8s1ceuBUnMUAeoAHHw,13,10,4,16,3,0,2,0,35,5.0,1,0.0,4,4,14,3,6,0,2,2,0,25,10,1
4930,99570,K9rvD8Iu0wq956P4CDD0WYKLX5TfMvJ0,G8EPVSXsOYB5YQWZGiz1aVq5Pgr2GrQu,1,0,0,0,0,0,1,0,1,0.14285714285714285,1,0.0,0,0,0,0,0,0,0,1,0,0,1,1
4931,99582,pJZjfxkmSUcLjysKXGMvcQJcdn3Lfmps,G8EPVSXsOYB5YQWZGiz1aVq5Pgr2GrQu,9,21,1,4,4,0,4,1,35,5.0,1,0.0,15,1,2,4,6,0,2,4,1,22,13,1
4932,99585,MsXQVdqX93JlyFfWTzQyZnJZn8bWw73p,G8EPVSXsOYB5YQWZGiz1aVq5Pgr2GrQu,1,0,0,0,0,0,1,0,1,0.14285714285714285,1,0.0,0,0,0,0,0,0,0,1,0,0,1,1
4933,99589,X2tBPTLsKr1PUmH63wCYNuKDkAG71YDY,SpATywNh6bZuzm8s1ceuBUnMUAeoAHHw,2,0,0,0,0,0,2,0,2,0.2857142857142857,1,0.0,0,0,0,0,0,0,0,2,0,0,2,1
4934,99591,X2tBPTLsKr1PUmH63wCYNuKDkAG71YDY,bWdj2GDclj5ofokWjzoa5jAwMkxCykd6,2,0,0,0,0,0,2,0,2,0.2857142857142857,1,0.0,0,0,0,0,0,0,0,2,0,0,2,1
4935,99624,eeYgUeHIQERDYwF1mxwVIZYsVaVSgwlV,RXDvfPUBYFlVdlueBFbLW0mhhAyGEqpt,1,0,0,0,0,0,1,0,1,0.14285714285714285,1,0.0,0,0,0,0,0,0,0,1,0,0,1,1
4936,99632,XcU2XTxeLZ8F89uBFmVFyW4cnWhjcEiA,SpATywNh6bZuzm8s1ceuBUnMUAeoAHHw,13,17,7,9,5,5,4,0,47,6.714285714285714,2,0.0,5,7,9,5,12,5,0,4,0,26,21,1
4937,99634,iKW0Nip3dgY8YRgutfX9HfgsuYc5FITi,SpATywNh6bZuzm8s1ceuBUnMUAeoAHHw,16,16,9,15,6,3,6,0,55,7.857142857142857,1,0.0,4,9,14,6,12,3,1,6,0,33,22,1
4938,99638,KfP7DqXlruQE3Tc1dgUq6GzZBbeDyO72,SpATywNh6bZuzm8s1ceuBUnMUAeoAHHw,6,7,2,0,1,1,2,0,13,1.8571428571428572,1,0.0,0,2,0,1,7,1,0,2,0,3,10,1
4939,99639,HdhmGphCRXsQFbeFhgLmEJAXmcjxk1qH,G8EPVSXsOYB5YQWZGiz1aVq5Pgr2GrQu,1,0,0,0,0,0,1,0,1,0.14285714285714285,1,0.0,0,0,0,0,0,0,0,1,0,0,1,1
4940,99653,2ENDZhPlfPQ7xqwHjrfLuuWg5Duw7ZBj,SpATywNh6bZuzm8s1ceuBUnMUAeoAHHw,17,37,17,12,4,1,15,1,87,12.428571428571429,5,0.0,5,17,12,4,32,1,0,15,1,38,49,0
4941,99654,uA8rfZuH0eMveW06zMXRELfenuAEs8xA,A3fsA9Zfv1X2fVEQhTw51lKENdNrEqT3,1,0,0,0,0,0,1,0,1,0.14285714285714285,1,0.0,0,0,0,0,0,0,0,1,0,0,1,1
4942,99667,yUFGaXV6e729cAx9t4iOfoMO0XzOm9Tn,SpATywNh6bZuzm8s1ceuBUnMUAeoAHHw,5,3,2,0,1,0,1,0,7,1.0,1,0.0,0,2,0,1,3,0,0,1,0,3,4,1
4943,99671,KbnH0sTIlztrZBuSXZduD8Hjf6pJFDbi,G8EPVSXsOYB5YQWZGiz1aVq5Pgr2GrQu,6,2,1,0,1,0,3,0,7,1.0,1,0.0,0,1,0,1,2,0,0,3,0,2,5,1
4944,99693,1poMA1x0qhCnYBPVsxm5CInRDHfF8Q0k,SpATywNh6bZuzm8s1ceuBUnMUAeoAHHw,10,12,8,0,4,2,15,3,44,6.285714285714286,1,0.0,0,8,0,4,12,2,0,15,3,12,32,1
4945,99715,xg8dkQPzve0MzcpgxvEsbKyY4VwKrxAC,G8EPVSXsOYB5YQWZGiz1aVq5Pgr2GrQu,1,0,0,0,0,0,1,0,1,0.14285714285714285,1,0.0,0,0,0,0,0,0,0,1,0,0,1,1
4946,99717,0b1xMc7vBqRRfJj4HArRLbAJZWV8VISr,RXDvfPUBYFlVdlueBFbLW0mhhAyGEqpt,1,0,0,0,0,0,1,0,1,0.14285714285714285,1,0.0,0,0,0,0,0,0,0,1,0,0,1,1
4947,99728,507IdnNFIDoiPRr88JDQa6OplkPcxI18,G8EPVSXsOYB5YQWZGiz1aVq5Pgr2GrQu,1,0,0,0,0,0,1,0,1,0.14285714285714285,1,0.0,0,0,0,0,0,0,0,1,0,0,1,1
4948,99747,SH3THvT9ATqMny80GD63EuK5GGnf8XMU,bWdj2GDclj5ofokWjzoa5jAwMkxCykd6,3,0,0,0,0,3,5,0,8,1.1428571428571428,2,0.0,0,0,0,0,0,3,0,5,0,0,8,1
4949,99752,v8s2hAX8tQgFD6i9MrUt2cuWPYPq3DuN,G8EPVSXsOYB5YQWZGiz1aVq5Pgr2GrQu,5,4,2,0,1,0,2,0,9,1.2857142857142858,2,0.0,0,2,0,1,4,0,0,2,0,3,6,0
4950,99758,q5R81Yw8uRP3FrwNvV49L9qc5ag0j7J9,A3fsA9Zfv1X2fVEQhTw51lKENdNrEqT3,1,0,0,0,0,0,1,0,1,0.14285714285714285,1,0.0,0,0,0,0,0,0,0,1,0,0,1,1
4951,99759,LgCMqz3FdP5FVzPuiAaae1dvV0Dou3Op,SpATywNh6bZuzm8s1ceuBUnMUAeoAHHw,7,3,2,0,2,0,2,0,9,1.2857142857142858,1,0.0,0,2,0,2,3,0,0,2,0,4,5,1
4952,99785,oNDKvCCMv3YHycTSYSxE4vCb7yy2VCwV,SpATywNh6bZuzm8s1ceuBUnMUAeoAHHw,10,3,2,0,2,7,5,1,20,2.857142857142857,1,0.0,0,2,0,2,3,7,0,5,1,4,16,1
4953,99798,t84V1IZRpqwPOLkIILsxQF8RqF1exsFD,SpATywNh6bZuzm8s1ceuBUnMUAeoAHHw,4,2,1,0,0,0,2,0,5,0.7142857142857143,1,0.0,0,1,0,0,2,0,0,2,0,1,4,1
4954,99810,E5f5bNHHVwXdE8xNDAy656AeEbGGB2sd,SpATywNh6bZuzm8s1ceuBUnMUAeoAHHw,11,43,3,27,2,0,3,0,78,11.142857142857142,2,0.0,30,3,23,2,13,0,4,3,0,58,20,1
4955,99812,ZDVmuYiPoGm0gu1bR2BaE1soF6dU5v1W,bWdj2GDclj5ofokWjzoa5jAwMkxCykd6,6,12,6,14,0,2,6,0,40,5.714285714285714,1,0.0,4,6,14,0,8,2,0,6,0,24,16,1
4956,99813,7aA6BrVZipLHOrozlrYBMEmfMq4MXahq,A3fsA9Zfv1X2fVEQhTw51lKENdNrEqT3,1,0,0,0,0,0,1,0,1,0.14285714285714285,1,0.0,0,0,0,0,0,0,0,1,0,0,1,1
4957,99817,TJwArXyryXs3RiLiYIGaN8bFGgjvPLws,SpATywNh6bZuzm8s1ceuBUnMUAeoAHHw,4,2,1,0,1,0,2,0,6,0.8571428571428571,1,0.0,0,1,0,1,2,0,0,2,0,2,4,1
4958,99819,GjfzOWel7UtLS6b5EULEaoKkW3os5vHa,SpATywNh6bZuzm8s1ceuBUnMUAeoAHHw,5,2,1,0,1,0,3,0,7,1.0,1,0.0,0,1,0,1,2,0,0,3,0,2,5,1
4959,99822,mb36VuCvp1Z6gW8mqkNElCgDYgcBIF3z,SpATywNh6bZuzm8s1ceuBUnMUAeoAHHw,7,11,8,0,6,0,3,0,28,4.0,1,0.0,0,8,0,6,11,0,0,3,0,14,14,1
4960,99831,Jzdxwa4kNVDonbh32Q542LfZRfsA4OPw,SpATywNh6bZuzm8s1ceuBUnMUAeoAHHw,8,3,2,0,2,1,4,0,12,1.7142857142857142,1,0.0,0,2,0,2,3,1,0,4,0,4,8,1
4961,99839,TdfXOtlNb7Av3MtzwkldFOrTHIZeitdz,SpATywNh6bZuzm8s1ceuBUnMUAeoAHHw,10,24,16,0,9,3,10,0,62,8.857142857142858,3,0.0,0,16,0,9,24,3,0,10,0,25,37,0
4962,99840,eVv8K2gdE5SVTmPw9MARDIRZSaYqMHSQ,SpATywNh6bZuzm8s1ceuBUnMUAeoAHHw,11,9,0,10,0,0,3,2,24,3.4285714285714284,1,0.0,2,0,9,0,7,0,1,3,2,11,13,1
4963,99843,oNDKvCCMv3YHycTSYSxE4vCb7yy2VCwV,RXDvfPUBYFlVdlueBFbLW0mhhAyGEqpt,9,5,4,0,4,0,4,0,17,2.4285714285714284,1,0.0,0,4,0,4,5,0,0,4,0,8,9,1
4964,99866,7aA6BrVZipLHOrozlrYBMEmfMq4MXahq,bWdj2GDclj5ofokWjzoa5jAwMkxCykd6,1,0,0,0,0,0,1,0,1,0.14285714285714285,1,0.0,0,0,0,0,0,0,0,1,0,0,1,1
4965,99879,6ACUaz471Pn1fnrZDeY9K0EfEHUBtjpk,SpATywNh6bZuzm8s1ceuBUnMUAeoAHHw,17,11,6,17,3,24,13,3,77,11.0,1,0.0,2,6,15,3,9,24,2,13,3,26,51,1
4966,99883,CFvk4wjTMYl1iJidR1XmhJBW4azBqofZ,SpATywNh6bZuzm8s1ceuBUnMUAeoAHHw,6,3,1,0,1,0,4,0,9,1.2857142857142858,1,0.0,0,1,0,1,3,0,0,4,0,2,7,1
4967,99891,cNOMlpfCFQuhn4NfuqDzr2Vocotv36oU,A3fsA9Zfv1X2fVEQhTw51lKENdNrEqT3,1,0,0,0,0,0,1,0,1,0.14285714285714285,1,0.0,0,0,0,0,0,0,0,1,0,0,1,1
4968,99892,DDOsm4qYmwEA6E1tTBXPjk0uhAES8TZ9,SpATywNh6bZuzm8s1ceuBUnMUAeoAHHw,9,7,3,3,2,0,2,0,17,2.4285714285714284,1,0.0,3,3,3,2,4,0,0,2,0,11,6,1
4969,99895,sRTon1VBBuP0uvdQE1lWLIce29YVBv8J,SpATywNh6bZuzm8s1ceuBUnMUAeoAHHw,13,19,0,11,0,4,8,0,42,6.0,2,0.0,6,0,10,0,13,4,1,8,0,16,26,1
4970,99900,90Ea96jYOrWvumropceyEFhiPsTvKfzf,bWdj2GDclj5ofokWjzoa5jAwMkxCykd6,8,4,0,0,0,1,4,1,10,1.4285714285714286,1,0.0,0,0,0,0,4,1,0,4,1,0,10,1
4971,99902,Fio0BW8a5yrv46EIdUqSrGYnBJXNuvAc,G8EPVSXsOYB5YQWZGiz1aVq5Pgr2GrQu,1,0,0,0,0,0,1,0,1,0.14285714285714285,1,0.0,0,0,0,0,0,0,0,1,0,0,1,1
4972,99905,GR0IZ8RAROGoO8dlKHQecnjtd4J4CV8E,SpATywNh6bZuzm8s1ceuBUnMUAeoAHHw,7,4,3,0,3,0,2,0,12,1.7142857142857142,1,0.0,0,3,0,3,4,0,0,2,0,6,6,1
4973,99908,Wlz3wRUCGZdxuPjJRKNKqt34F0pjoQUU,SpATywNh6bZuzm8s1ceuBUnMUAeoAHHw,5,3,0,0,0,0,2,0,5,0.7142857142857143,1,0.0,0,0,0,0,3,0,0,2,0,0,5,1
4974,99910,T0V1MC6bsX3mZxJfTJfqpva6BwB6iZOI,SpATywNh6bZuzm8s1ceuBUnMUAeoAHHw,5,3,2,0,2,0,2,0,9,1.2857142857142858,1,0.0,0,2,0,2,3,0,0,2,0,4,5,1
4975,99919,bzlTCtIUcO5BfACSIQwT3PRYSdK0QGTr,bWdj2GDclj5ofokWjzoa5jAwMkxCykd6,5,2,1,0,1,0,3,0,7,1.0,2,0.0,0,1,0,1,2,0,0,3,0,2,5,1
4976,99924,s22y3yJL9OZAJbywe5kehjyeI57l8QWk,SpATywNh6bZuzm8s1ceuBUnMUAeoAHHw,1,0,0,0,0,0,2,0,2,0.2857142857142857,1,0.0,0,0,0,0,0,0,0,2,0,0,2,1
4977,99933,grGzcyT8HhVfjhYhmvwa7hRZvpxVILf7,SpATywNh6bZuzm8s1ceuBUnMUAeoAHHw,12,19,5,15,4,0,1,0,44,6.285714285714286,1,0.0,13,5,14,4,6,0,1,1,0,36,8,1
4978,99936,Oi7Qhc5WNxKsxx530z6SWxDXUzxiC0Iw,G8EPVSXsOYB5YQWZGiz1aVq5Pgr2GrQu,10,15,1,0,2,0,9,0,27,3.857142857142857,2,0.0,8,1,0,2,7,0,0,9,0,11,16,0
4979,99937,cnsyUcQdXkjXAZu2LRhrO31c8mThrNUr,SpATywNh6bZuzm8s1ceuBUnMUAeoAHHw,13,11,5,20,2,0,4,0,42,6.0,2,0.0,2,5,16,2,9,0,4,4,0,25,17,1
4980,99947,IZ16dnDzM5qLtyHLu3aaKf2eiaAGYSGA,SpATywNh6bZuzm8s1ceuBUnMUAeoAHHw,1,0,0,0,0,0,1,0,1,0.14285714285714285,1,0.0,0,0,0,0,0,0,0,1,0,0,1,1
4981,99956,JncF0A6NLmySeUG55ffbMgtwYs8JPP1N,bWdj2GDclj5ofokWjzoa5jAwMkxCykd6,2,0,0,0,0,0,2,0,2,0.2857142857142857,1,0.0,0,0,0,0,0,0,0,2,0,0,2,1
4982,99986,4dUaGH7iXRv1eQLzCgjayv9tRaG807lp,SpATywNh6bZuzm8s1ceuBUnMUAeoAHHw,12,9,6,16,3,0,1,0,35,5.0,1,0.0,2,6,13,3,7,0,3,1,0,24,11,1
4983,99990,BY7rZbvKNAuIQddu3IMUH8CKbKBlCl4t,SpATywNh6bZuzm8s1ceuBUnMUAeoAHHw,15,43,24,17,8,6,11,0,109,15.571428571428571,3,0.0,6,24,14,8,37,6,3,11,0,52,57,0
4984,99994,25I3ZHC2CKPuZdwEsDJVb3ivMmenYIrh,SpATywNh6bZuzm8s1ceuBUnMUAeoAHHw,1,0,0,0,0,0,1,0,1,0.14285714285714285,1,0.0,0,0,0,0,0,0,0,1,0,0,1,1
4985,99997,DtHgKVPDhIQdcn9LoDGSbijzl93Gk2jn,SpATywNh6bZuzm8s1ceuBUnMUAeoAHHw,6,3,1,0,1,0,2,0,7,1.0,1,0.0,0,1,0,1,3,0,0,2,0,2,5,1
4986,99999,6sN2V3D1BSB8BILaihUzYoUSAATbUImJ,G8EPVSXsOYB5YQWZGiz1aVq5Pgr2GrQu,2,0,0,0,0,0,2,0,2,0.2857142857142857,1,0.0,0,0,0,0,0,0,0,2,0,0,2,1
4987,100015,kVQgvZQEECWcBpDBfOHSkyukPIRvJ5sY,RXDvfPUBYFlVdlueBFbLW0mhhAyGEqpt,1,0,0,0,0,0,1,0,1,0.14285714285714285,1,0.0,0,0,0,0,0,0,0,1,0,0,1,1
4988,100024,yIWuZECPMnNHsT4nnuxaCnrNgzyFmEU4,SpATywNh6bZuzm8s1ceuBUnMUAeoAHHw,12,9,1,13,0,0,6,0,29,4.142857142857143,2,0.0,2,1,11,0,7,0,2,6,0,14,15,1
4989,100027,lVpMvFJQUkBRc5QzVKlkj16QaA3takHv,G8EPVSXsOYB5YQWZGiz1aVq5Pgr2GrQu,20,10,6,42,3,5,4,0,70,10.0,1,0.0,3,6,34,3,7,5,8,4,0,46,24,0
4990,100028,AMKNyvONM5p8NpA87JkQdxEGdnEv8UBc,SpATywNh6bZuzm8s1ceuBUnMUAeoAHHw,14,14,2,20,1,11,11,4,63,9.0,2,0.0,2,2,17,1,12,11,3,11,4,22,41,1
4991,100034,UO4K287BxB8BWqN4Vsyelgc9IxlYK4Tg,SpATywNh6bZuzm8s1ceuBUnMUAeoAHHw,13,8,5,12,4,0,2,0,31,4.428571428571429,1,0.0,2,5,12,4,6,0,0,2,0,23,8,1
4992,100036,drecLIVL8lECR1fdFh4q87LPP9hTNU3f,SpATywNh6bZuzm8s1ceuBUnMUAeoAHHw,5,2,1,0,1,0,2,0,6,0.8571428571428571,1,0.0,0,1,0,1,2,0,0,2,0,2,4,1
4993,100061,wSHJOUrC5HDoRV04dRmaj6jhdM6NYaj6,RXDvfPUBYFlVdlueBFbLW0mhhAyGEqpt,17,26,16,0,9,1,12,0,64,9.142857142857142,1,0.0,0,16,0,9,26,1,0,12,0,25,39,1
4994,100063,ZmILkESSKwaUf7dlv2MYezsPM9kEgn0g,bWdj2GDclj5ofokWjzoa5jAwMkxCykd6,1,0,0,0,0,0,1,0,1,0.14285714285714285,1,0.0,0,0,0,0,0,0,0,1,0,0,1,1
4995,100072,GCBiFXC2EhwXYwz6gh8rDQT1ItPzfReO,SpATywNh6bZuzm8s1ceuBUnMUAeoAHHw,1,0,0,0,0,0,1,0,1,0.14285714285714285,1,0.0,0,0,0,0,0,0,0,1,0,0,1,1
4996,100101,7BLSB26pFgDMSTV4x8nY66FLFZIw20Ig,bWdj2GDclj5ofokWjzoa5jAwMkxCykd6,3,0,0,0,0,0,3,0,3,0.42857142857142855,1,0.0,0,0,0,0,0,0,0,3,0,0,3,1
4997,100118,e0PSviaCUv7g6edvYkj3Wxxy57eyFNfw,G8EPVSXsOYB5YQWZGiz1aVq5Pgr2GrQu,8,6,4,0,3,0,3,0,16,2.2857142857142856,1,0.0,0,4,0,3,6,0,0,3,0,7,9,1
4998,100121,zDkFthLb8QiYlJN46xEgukiHh2xvNh17,SpATywNh6bZuzm8s1ceuBUnMUAeoAHHw,12,8,4,4,6,24,5,0,51,7.285714285714286,1,0.0,0,4,4,6,8,24,0,5,0,14,37,1
4999,100126,92FUTIKpJKurgJxPcqboELrIlwQuRnws,SpATywNh6bZuzm8s1ceuBUnMUAeoAHHw,4,2,1,0,1,0,3,0,7,1.0,1,0.0,0,1,0,1,2,0,0,3,0,2,5,1
5000,100128,sQN6Ivaey7nQA0xFHZwWETnwBmEDP3C4,bWdj2GDclj5ofokWjzoa5jAwMkxCykd6,1,0,0,0,0,0,1,0,1,0.14285714285714285,1,0.0,0,0,0,0,0,0,0,1,0,0,1,1
5001,100129,UKq5lhvAp06ZhcbYGirhBoJurTHlyP25,SpATywNh6bZuzm8s1ceuBUnMUAeoAHHw,4,2,1,0,0,0,3,0,6,0.8571428571428571,1,0.0,0,1,0,0,2,0,0,3,0,1,5,0
5002,100132,zhtf7EZUjW6s3Guz5lXD8KDXJ4lw9cuB,SpATywNh6bZuzm8s1ceuBUnMUAeoAHHw,14,19,11,14,6,0,3,0,53,7.571428571428571,2,0.0,7,11,13,6,12,0,1,3,0,37,16,0
5003,100141,OMeQBd65CGlFdF9LPjtleDAWNG4SlWp3,SpATywNh6bZuzm8s1ceuBUnMUAeoAHHw,15,45,4,27,3,24,7,1,111,15.857142857142858,2,0.0,27,4,21,3,18,24,6,7,1,55,56,1
5004,100153,3ZBkeExde7b5snRqlcNlkhznPWJKIR4u,SpATywNh6bZuzm8s1ceuBUnMUAeoAHHw,3,2,0,0,0,0,1,0,3,0.42857142857142855,1,0.0,0,0,0,0,2,0,0,1,0,0,3,1
5005,100197,7VYsu22xA0behvNW5V0HO7suqw3RpS8G,A3fsA9Zfv1X2fVEQhTw51lKENdNrEqT3,1,0,0,0,0,0,1,0,1,0.14285714285714285,1,0.0,0,0,0,0,0,0,0,1,0,0,1,1
5006,100212,2bZFunHMPmr3ZtiaHMdXxkvbsb400BRF,bWdj2GDclj5ofokWjzoa5jAwMkxCykd6,7,2,1,0,1,0,5,1,10,1.4285714285714286,2,0.0,0,1,0,1,2,0,0,5,1,2,8,1
5007,100234,mV6vIHBrgth3lTaajvzuqQeEfK5qY5yY,SpATywNh6bZuzm8s1ceuBUnMUAeoAHHw,14,26,3,19,2,0,4,0,54,7.714285714285714,2,0.0,6,3,16,2,20,0,3,4,0,27,27,1
5008,100242,pOVkDtM2cW4XWonAB3isY5WCbnNkYAIp,G8EPVSXsOYB5YQWZGiz1aVq5Pgr2GrQu,12,38,2,30,5,1,6,1,83,11.857142857142858,1,0.0,21,2,21,5,17,1,9,6,1,49,34,0
5009,100248,YNyEESXbqSWkVhYDWRBMKhf7B8RI9hCb,SpATywNh6bZuzm8s1ceuBUnMUAeoAHHw,9,9,1,0,1,0,9,0,20,2.857142857142857,2,0.0,0,1,0,1,9,0,0,9,0,2,18,1
5010,100250,TciQEzJA4hKxeo0Ve5JLByGDZHpNx3uy,RXDvfPUBYFlVdlueBFbLW0mhhAyGEqpt,1,0,0,0,0,0,1,0,1,0.14285714285714285,1,0.0,0,0,0,0,0,0,0,1,0,0,1,1
5011,100254,qNh1HmZZ5IODkL9bGcGUg3xnGvE9VrLH,A3fsA9Zfv1X2fVEQhTw51lKENdNrEqT3,1,0,0,0,0,0,1,0,1,0.14285714285714285,1,0.0,0,0,0,0,0,0,0,1,0,0,1,1
5012,100255,CyLrnwOuvkEKQhwjogaYhZvzxTeqKBge,bWdj2GDclj5ofokWjzoa5jAwMkxCykd6,1,0,0,0,0,0,1,0,1,0.14285714285714285,1,0.0,0,0,0,0,0,0,0,1,0,0,1,1
5013,100259,c2Q5B1aYF1KkI9v6dRXIUSAa5DOcN20a,SpATywNh6bZuzm8s1ceuBUnMUAeoAHHw,1,0,0,0,0,0,1,0,1,0.14285714285714285,1,0.0,0,0,0,0,0,0,0,1,0,0,1,1
5014,100274,psBmoUfd8F19brtdh1bZTLzNbdOCOBdc,G8EPVSXsOYB5YQWZGiz1aVq5Pgr2GrQu,12,5,4,0,4,1,5,1,20,2.857142857142857,1,0.0,0,4,0,4,5,1,0,5,1,8,12,1
5015,100279,KyiebHDxme4fhoxffRK8u4aC4pCnnodx,RXDvfPUBYFlVdlueBFbLW0mhhAyGEqpt,7,9,1,0,1,0,3,0,14,2.0,2,0.0,0,1,0,1,9,0,0,3,0,2,12,1
5016,100283,RqdDZ59hZyptwdavZ7BebY7MyinitbUb,RXDvfPUBYFlVdlueBFbLW0mhhAyGEqpt,18,17,2,28,2,6,5,1,61,8.714285714285714,2,0.0,2,2,26,2,15,6,2,5,1,32,29,1
5017,100306,mSmEv1ySOfyHPKXATZwYWxeWIR1bOlzf,A3fsA9Zfv1X2fVEQhTw51lKENdNrEqT3,1,0,0,0,0,0,1,0,1,0.14285714285714285,1,0.0,0,0,0,0,0,0,0,1,0,0,1,1
5018,100316,zOam8QEm9OnWecRZGQt83gQL3mhsAeeZ,bWdj2GDclj5ofokWjzoa5jAwMkxCykd6,3,0,0,0,0,0,3,0,3,0.42857142857142855,1,0.0,0,0,0,0,0,0,0,3,0,0,3,1
5019,100317,jHFndzgHWJwhCt25LmxPZ3zqNFqlRdEb,A3fsA9Zfv1X2fVEQhTw51lKENdNrEqT3,7,3,2,0,2,0,2,0,9,1.2857142857142858,2,0.0,0,2,0,2,3,0,0,2,0,4,5,1
5020,100327,wrKMasi8LNygKef8piFZGi3m3QxjccZE,bWdj2GDclj5ofokWjzoa5jAwMkxCykd6,4,2,1,0,1,0,1,0,5,0.7142857142857143,1,0.0,0,1,0,1,2,0,0,1,0,2,3,1
5021,100328,KgI1c7voNVzVIvjs4ZhktR8A7fWkMDoW,SpATywNh6bZuzm8s1ceuBUnMUAeoAHHw,1,0,0,0,0,0,1,0,1,0.14285714285714285,1,0.0,0,0,0,0,0,0,0,1,0,0,1,1
5022,100330,XIlz5QvnlEzidDqYGld3VSh8CaOyBXAa,bWdj2GDclj5ofokWjzoa5jAwMkxCykd6,1,0,0,0,0,0,1,0,1,0.14285714285714285,1,0.0,0,0,0,0,0,0,0,1,0,0,1,1
5023,100338,ZtkS0KlWCGCzlEANBJ5GgCPzAAljBHVt,bWdj2GDclj5ofokWjzoa5jAwMkxCykd6,10,8,4,10,4,0,4,0,30,4.285714285714286,2,0.0,2,4,10,4,6,0,0,4,0,20,10,1
5024,100373,7rPiBqfbPQeCxCiqXyPinFDIqFEPCizE,SpATywNh6bZuzm8s1ceuBUnMUAeoAHHw,4,2,1,0,0,0,2,0,5,0.7142857142857143,1,0.0,0,1,0,0,2,0,0,2,0,1,4,1
5025,100377,MlHPKmdi90dDdvX24jYoFlYEp8xS4RGn,SpATywNh6bZuzm8s1ceuBUnMUAeoAHHw,8,23,8,0,3,3,6,0,43,6.142857142857143,3,0.0,1,8,0,3,22,3,0,6,0,12,31,0
5026,100383,CgW6eb6Uo35foWi9RCL2029DF7zH5e88,SpATywNh6bZuzm8s1ceuBUnMUAeoAHHw,2,0,0,0,0,0,2,0,2,0.2857142857142857,1,0.0,0,0,0,0,0,0,0,2,0,0,2,1
5027,100384,FMxvsapRPXXXNxGG3GDsHR7zl4E2ofKu,bWdj2GDclj5ofokWjzoa5jAwMkxCykd6,2,0,0,0,0,0,2,0,2,0.2857142857142857,1,0.0,0,0,0,0,0,0,0,2,0,0,2,1
5028,100388,2JB50R0jD3NibtfXa92f6mpF735lk1Oo,SpATywNh6bZuzm8s1ceuBUnMUAeoAHHw,13,10,6,16,3,0,1,0,36,5.142857142857143,1,0.0,2,6,14,3,8,0,2,1,0,25,11,1
5029,100391,kyGh4gel5GTGb41pTkpUlnRTMKLiWXKA,G8EPVSXsOYB5YQWZGiz1aVq5Pgr2GrQu,5,2,1,0,1,0,2,0,6,0.8571428571428571,1,0.0,0,1,0,1,2,0,0,2,0,2,4,1
5030,100395,lDJQud5AwL6Ba2zEaWPbxkrhuulYEvyw,bWdj2GDclj5ofokWjzoa5jAwMkxCykd6,1,0,0,0,0,0,3,0,3,0.42857142857142855,1,0.0,0,0,0,0,0,0,0,3,0,0,3,1
5031,100405,lsAfokF5POsODUr1G2X0v5zWkAd5sfbB,SpATywNh6bZuzm8s1ceuBUnMUAeoAHHw,2,0,0,0,0,0,3,0,3,0.42857142857142855,1,0.0,0,0,0,0,0,0,0,3,0,0,3,1
5032,100408,MlHPKmdi90dDdvX24jYoFlYEp8xS4RGn,RXDvfPUBYFlVdlueBFbLW0mhhAyGEqpt,14,20,1,0,1,3,1,0,26,3.7142857142857144,1,0.0,4,1,0,1,16,3,0,1,0,6,20,0
5033,100412,OvbupWSPA81Tk7Ur62Bs2bcQ5LB2mCRC,bWdj2GDclj5ofokWjzoa5jAwMkxCykd6,1,0,0,0,0,0,1,0,1,0.14285714285714285,1,0.0,0,0,0,0,0,0,0,1,0,0,1,1
5034,100426,sWiS7fnOghX7y7YX6Vs9Fow1ZPp98c2P,bWdj2GDclj5ofokWjzoa5jAwMkxCykd6,10,26,0,0,3,3,15,1,48,6.857142857142857,1,0.0,9,0,0,3,17,3,0,15,1,12,36,1
5035,100439,FhVGWSUXUeZGSguiLBd186fsM4sRhpPL,G8EPVSXsOYB5YQWZGiz1aVq5Pgr2GrQu,9,11,1,22,1,0,1,0,36,5.142857142857143,1,0.0,3,1,17,1,8,0,5,1,0,22,14,1
5036,100450,lU8LXbJuGJewdk0jE0yxpPj20hcwCqO8,A3fsA9Zfv1X2fVEQhTw51lKENdNrEqT3,39,12,10,38,7,0,10,0,77,11.0,2,0.0,1,10,38,7,11,0,0,10,0,56,21,0
5037,100489,siw3z9CF4q7PdqdWdVvFDzTmHm8ZHf2L,SpATywNh6bZuzm8s1ceuBUnMUAeoAHHw,1,0,0,0,0,0,1,0,1,0.14285714285714285,1,0.0,0,0,0,0,0,0,0,1,0,0,1,1
5038,100499,ZIt5iRfEuLMxmr9xMDT0sX9zx5GgOmQf,A3fsA9Zfv1X2fVEQhTw51lKENdNrEqT3,1,0,0,0,0,0,2,0,2,0.2857142857142857,1,0.0,0,0,0,0,0,0,0,2,0,0,2,1
5039,100512,sv1H0k2AOskJuUJSlRoi2iUdzle6ZY5e,G8EPVSXsOYB5YQWZGiz1aVq5Pgr2GrQu,3,0,0,0,0,0,3,0,3,0.42857142857142855,1,0.0,0,0,0,0,0,0,0,3,0,0,3,1
5040,100523,FifZKzWgnHbxPg1j0vi1JZCTI4cVJ25l,G8EPVSXsOYB5YQWZGiz1aVq5Pgr2GrQu,9,8,0,6,0,0,2,0,16,2.2857142857142856,1,0.0,3,0,3,0,5,0,3,2,0,6,10,1
5041,100547,0Czxo1UyRYR5I2rUJ5duK2VwsqwaqR13,SpATywNh6bZuzm8s1ceuBUnMUAeoAHHw,10,6,0,0,0,4,6,1,17,2.4285714285714284,1,0.0,0,0,0,0,6,4,0,6,1,0,17,1
5042,100554,8msriFvaCCtQyOBjAsLjk1IXyxsB0lzq,RXDvfPUBYFlVdlueBFbLW0mhhAyGEqpt,5,3,1,0,0,0,2,0,6,0.8571428571428571,1,0.0,0,1,0,0,3,0,0,2,0,1,5,1
5043,100560,x8DjxiuO7OZapd2gSqXnLZdmO4eYlUve,bWdj2GDclj5ofokWjzoa5jAwMkxCykd6,1,0,0,0,0,0,1,0,1,0.14285714285714285,1,0.0,0,0,0,0,0,0,0,1,0,0,1,1
5044,100568,9fKCM48WCwLwvCl1vZ5Sx66ep0GEs87k,RXDvfPUBYFlVdlueBFbLW0mhhAyGEqpt,10,8,3,6,1,0,1,0,19,2.7142857142857144,1,0.0,1,3,6,1,7,0,0,1,0,11,8,1
5045,100573,krUqGfXTBwqDLoVqEC6x5HRNcKeuU2b1,SpATywNh6bZuzm8s1ceuBUnMUAeoAHHw,1,0,0,0,0,0,1,0,1,0.14285714285714285,1,0.0,0,0,0,0,0,0,0,1,0,0,1,1
5046,100594,0m1xQAlS5S5aY7jod2X9WwncTIVqHxA2,SpATywNh6bZuzm8s1ceuBUnMUAeoAHHw,4,2,1,0,0,0,2,0,5,0.7142857142857143,1,0.0,0,1,0,0,2,0,0,2,0,1,4,0
5047,100599,2sNFZBlVAcN0C3ozIX9ouOQIe9XjJNO6,RXDvfPUBYFlVdlueBFbLW0mhhAyGEqpt,8,5,2,0,2,0,6,0,15,2.142857142857143,2,0.0,0,2,0,2,5,0,0,6,0,4,11,1
5048,100604,FYehGDNRsrl5wDaAnO5HST0ivs3hH7sH,SpATywNh6bZuzm8s1ceuBUnMUAeoAHHw,12,12,1,12,1,12,3,0,41,5.857142857142857,1,0.0,3,1,12,1,9,12,0,3,0,17,24,1
5049,100606,EW14eVSThxGfz3peXBNT9jQSWqEa62yw,SpATywNh6bZuzm8s1ceuBUnMUAeoAHHw,5,2,1,0,1,0,4,0,8,1.1428571428571428,1,0.0,0,1,0,1,2,0,0,4,0,2,6,1
5050,100608,qrBxOx4xvfJbTRNtYXFo4mMHRch3LE9R,bWdj2GDclj5ofokWjzoa5jAwMkxCykd6,2,0,0,0,0,0,3,0,3,0.42857142857142855,1,0.0,0,0,0,0,0,0,0,3,0,0,3,1
5051,100610,vPuo8DmIldZLRb6b5UgHPfgjxOLUxczJ,SpATywNh6bZuzm8s1ceuBUnMUAeoAHHw,8,6,3,0,2,4,4,0,19,2.7142857142857144,2,0.0,0,3,0,2,6,4,0,4,0,5,14,1
5052,100614,qeHXe8DRkB9urr63HS1yAMwTxQkwIbff,RXDvfPUBYFlVdlueBFbLW0mhhAyGEqpt,43,84,2,85,9,10,25,6,221,31.571428571428573,4,0.0,32,2,78,9,52,10,7,25,6,121,100,1
5053,100628,5POGITm84aGrgNJ0nsPFC65wjX6UfDmC,SpATywNh6bZuzm8s1ceuBUnMUAeoAHHw,4,2,0,0,0,0,5,0,7,1.0,1,0.0,0,0,0,0,2,0,0,5,0,0,7,1
5054,100642,5kFbFpqTAfcE9zjpZiw5sGDR5BhJdfrE,SpATywNh6bZuzm8s1ceuBUnMUAeoAHHw,5,3,0,0,0,0,2,0,5,0.7142857142857143,1,0.0,0,0,0,0,3,0,0,2,0,0,5,1
5055,100644,W3mRXTG4xhvVAzedNOQzsJsrgQcHfu8g,A3fsA9Zfv1X2fVEQhTw51lKENdNrEqT3,1,0,0,0,0,0,1,0,1,0.14285714285714285,1,0.0,0,0,0,0,0,0,0,1,0,0,1,1
5056,100647,rOlo2GoZP9TqbgRI0oVgxX8oSUKh8U3d,RXDvfPUBYFlVdlueBFbLW0mhhAyGEqpt,7,5,0,0,0,0,4,0,9,1.2857142857142858,1,0.0,0,0,0,0,5,0,0,4,0,0,9,1
5057,100648,lWNGGFUB9gkHAgPFHpuxssg4Y5G8A4T2,bWdj2GDclj5ofokWjzoa5jAwMkxCykd6,4,2,1,0,0,0,2,0,5,0.7142857142857143,1,0.0,0,1,0,0,2,0,0,2,0,1,4,1
5058,100659,rDec3XLpppIQx4sScddB7i9e44PtAV8K,A3fsA9Zfv1X2fVEQhTw51lKENdNrEqT3,1,0,0,0,0,0,1,0,1,0.14285714285714285,1,0.0,0,0,0,0,0,0,0,1,0,0,1,1
5059,100661,3C8bDgUvFDILMw4UNlmk2n4yo5NHVGtC,SpATywNh6bZuzm8s1ceuBUnMUAeoAHHw,11,16,0,15,0,1,4,0,36,5.142857142857143,1,0.0,8,0,15,0,8,1,0,4,0,23,13,1
5060,100677,ga70xb8tiQejcbGQlS6US7AEzd2ynNMR,bWdj2GDclj5ofokWjzoa5jAwMkxCykd6,5,5,2,0,1,0,2,0,10,1.4285714285714286,1,0.0,0,2,0,1,5,0,0,2,0,3,7,0
5061,100690,TqIZW6TBerJNN7EZw5XWZ32AUByseuDz,bWdj2GDclj5ofokWjzoa5jAwMkxCykd6,1,0,0,0,0,0,1,0,1,0.14285714285714285,1,0.0,0,0,0,0,0,0,0,1,0,0,1,1
5062,100693,5hXITOhzRYMjx2VRfYxzWyiyJwxTbApF,RXDvfPUBYFlVdlueBFbLW0mhhAyGEqpt,3,0,0,0,0,0,3,0,3,0.42857142857142855,1,0.0,0,0,0,0,0,0,0,3,0,0,3,1
5063,100715,vt827MYpYgT0JKXBC62SZ24Gxa8OJ87k,bWdj2GDclj5ofokWjzoa5jAwMkxCykd6,4,5,1,0,0,0,1,0,7,1.0,1,0.0,0,1,0,0,5,0,0,1,0,1,6,1
5064,100716,dGI6yveNenjFfT8c0PjNzk1ugu0VsvkU,G8EPVSXsOYB5YQWZGiz1aVq5Pgr2GrQu,2,0,0,0,0,0,2,0,2,0.2857142857142857,1,0.0,0,0,0,0,0,0,0,2,0,0,2,1
5065,100739,MqqmdkYysHqA6UDBkyqkZJffv3577kEU,SpATywNh6bZuzm8s1ceuBUnMUAeoAHHw,7,2,1,0,1,1,5,1,11,1.5714285714285714,1,0.0,0,1,0,1,2,1,0,5,1,2,9,1
5066,100745,oBC6VJY82mEcAXDVlIE68Xc4JnrHjU4b,SpATywNh6bZuzm8s1ceuBUnMUAeoAHHw,6,8,2,0,1,0,4,0,15,2.142857142857143,1,0.0,0,2,0,1,8,0,0,4,0,3,12,1
5067,100774,6cRse7eR1s1pCddP2ji9L7RuB7UYuqjL,SpATywNh6bZuzm8s1ceuBUnMUAeoAHHw,5,3,2,0,0,0,2,0,7,1.0,1,0.0,0,2,0,0,3,0,0,2,0,2,5,1
5068,100778,Wigd4PnyDnjfDcFOxsTBcEnXo7kl9GSg,SpATywNh6bZuzm8s1ceuBUnMUAeoAHHw,16,26,9,22,3,5,15,1,81,11.571428571428571,2,0.0,6,9,18,3,20,5,4,15,1,36,45,1
5069,100779,Qi3PLuC7w2Yo9hFgq37MObjY8icnRdc6,bWdj2GDclj5ofokWjzoa5jAwMkxCykd6,18,39,15,36,3,34,18,0,145,20.714285714285715,5,0.0,4,15,31,3,35,34,5,18,0,53,92,1
5070,100781,C82stxYBdobab5s8FnzuMHxgMBwKu2tD,A3fsA9Zfv1X2fVEQhTw51lKENdNrEqT3,1,0,0,0,0,0,1,0,1,0.14285714285714285,1,0.0,0,0,0,0,0,0,0,1,0,0,1,1
5071,100796,oDUwm6L4MXQ6JEb98dYg8X4b6ULu2zCm,SpATywNh6bZuzm8s1ceuBUnMUAeoAHHw,7,14,4,0,0,0,2,0,20,2.857142857142857,1,0.0,3,4,0,0,11,0,0,2,0,7,13,1
5072,100807,zfQZFTiqHKQUgpAItjpYn7ZjkbIcP825,SpATywNh6bZuzm8s1ceuBUnMUAeoAHHw,5,3,1,0,0,0,2,0,6,0.8571428571428571,2,0.0,0,1,0,0,3,0,0,2,0,1,5,1
5073,100817,jSNLRK8jxSbbcqhbWW7DXZqoGlvGgXDY,G8EPVSXsOYB5YQWZGiz1aVq5Pgr2GrQu,10,15,4,0,0,2,6,1,28,4.0,4,0.0,0,4,0,0,15,2,0,6,1,4,24,1
5074,100823,3SCBHiEI4HvwPrOQDNTIAqp1rZOAx5IK,bWdj2GDclj5ofokWjzoa5jAwMkxCykd6,17,52,29,112,18,0,10,0,221,31.571428571428573,5,0.0,15,29,105,18,37,0,7,10,0,167,54,1
5075,100834,EhKlFSggqkpH0G4s3hbhvR0dQLyh6jQ2,bWdj2GDclj5ofokWjzoa5jAwMkxCykd6,9,5,1,10,1,0,14,0,31,4.428571428571429,1,0.0,2,1,9,1,3,0,1,14,0,13,18,1
5076,100846,78iUKf97Yd7gLvilaD752YymIdL84Vdn,SpATywNh6bZuzm8s1ceuBUnMUAeoAHHw,5,4,1,0,0,0,2,0,7,1.0,1,0.0,0,1,0,0,4,0,0,2,0,1,6,1
5077,100862,G6iele4ho79nU5jQ1J8umZLq8jEFa9yN,bWdj2GDclj5ofokWjzoa5jAwMkxCykd6,6,4,2,0,1,2,2,1,12,1.7142857142857142,1,0.0,0,2,0,1,4,2,0,2,1,3,9,1
5078,100869,jfd2LG9hNbbf5Lp41xKYtXydDr9rSQaq,G8EPVSXsOYB5YQWZGiz1aVq5Pgr2GrQu,4,3,1,0,1,0,1,0,6,0.8571428571428571,1,0.0,0,1,0,1,3,0,0,1,0,2,4,1
5079,100879,xlgVVLxBZCGRSXArMda1ZJ2EETOVQEd7,SpATywNh6bZuzm8s1ceuBUnMUAeoAHHw,5,2,1,0,1,1,2,0,7,1.0,1,0.0,0,1,0,1,2,1,0,2,0,2,5,1
5080,100888,JfI1PlGVl9kA0mdAoeqyEmchpJwdwBfa,SpATywNh6bZuzm8s1ceuBUnMUAeoAHHw,14,21,8,6,5,6,5,1,52,7.428571428571429,2,0.0,0,8,5,5,21,6,1,5,1,18,34,1
5081,100921,9Dj7cZ9RPLWRgYWhoZq69xKKKshP0n7X,A3fsA9Zfv1X2fVEQhTw51lKENdNrEqT3,1,0,0,0,0,0,1,0,1,0.14285714285714285,1,0.0,0,0,0,0,0,0,0,1,0,0,1,1
5082,100928,erUNLgaqPpXW5SB6BA1vjCrKhwxECQ5B,bWdj2GDclj5ofokWjzoa5jAwMkxCykd6,5,7,0,0,0,0,3,0,10,1.4285714285714286,2,0.0,0,0,0,0,7,0,0,3,0,0,10,1
5083,100931,QAQOQC9orxaSCK47wTUjk6OT4uXNA4IV,SpATywNh6bZuzm8s1ceuBUnMUAeoAHHw,1,0,0,0,0,0,1,0,1,0.14285714285714285,1,0.0,0,0,0,0,0,0,0,1,0,0,1,1
5084,100944,ZqMeeZA1fdjNAJGfaX50qgTzDRJ8YFP5,SpATywNh6bZuzm8s1ceuBUnMUAeoAHHw,7,9,5,0,2,1,4,0,21,3.0,2,0.0,0,5,0,2,9,1,0,4,0,7,14,1
5085,100956,Qi3PLuC7w2Yo9hFgq37MObjY8icnRdc6,RXDvfPUBYFlVdlueBFbLW0mhhAyGEqpt,4,2,1,0,1,0,2,0,6,0.8571428571428571,1,0.0,0,1,0,1,2,0,0,2,0,2,4,1
5086,100957,U04y5vFf0AfyJVGIOJHlryTyRQEOm5pT,bWdj2GDclj5ofokWjzoa5jAwMkxCykd6,4,2,1,0,1,0,1,0,5,0.7142857142857143,1,0.0,0,1,0,1,2,0,0,1,0,2,3,1
5087,100958,JHP5MvKDX3euU7PqF5LcZxc3GqSOARsL,SpATywNh6bZuzm8s1ceuBUnMUAeoAHHw,2,0,0,0,0,0,2,0,2,0.2857142857142857,1,0.0,0,0,0,0,0,0,0,2,0,0,2,1
5088,100960,U04y5vFf0AfyJVGIOJHlryTyRQEOm5pT,G8EPVSXsOYB5YQWZGiz1aVq5Pgr2GrQu,2,0,0,0,0,0,2,0,2,0.2857142857142857,1,0.0,0,0,0,0,0,0,0,2,0,0,2,1
5089,100961,pdDWSL0qqW5lqoVLDvyIeqmUWuTqLvQ6,SpATywNh6bZuzm8s1ceuBUnMUAeoAHHw,1,0,0,0,0,0,1,0,1,0.14285714285714285,1,0.0,0,0,0,0,0,0,0,1,0,0,1,1
5090,100978,4X713FvFJyCLvswyefbqyJ5rn4U0EDrr,G8EPVSXsOYB5YQWZGiz1aVq5Pgr2GrQu,7,2,1,0,1,0,5,1,10,1.4285714285714286,1,0.0,0,1,0,1,2,0,0,5,1,2,8,1
5091,100990,CnuwKGLCLbXYnPgy82VEWYA1NOiOhvr0,SpATywNh6bZuzm8s1ceuBUnMUAeoAHHw,15,36,0,12,1,1,12,2,64,9.142857142857142,4,0.0,10,0,9,1,26,1,3,12,2,20,44,0
5092,100997,coZTr10eytnE55me2AxqRWq6qrVXEB7M,SpATywNh6bZuzm8s1ceuBUnMUAeoAHHw,17,37,15,14,11,22,16,3,118,16.857142857142858,3,0.0,6,15,12,11,31,22,2,16,3,44,74,1
5093,101010,fd2e5NJVnyVwHFHuiTOOM639ZY1uThtn,SpATywNh6bZuzm8s1ceuBUnMUAeoAHHw,1,0,0,0,0,0,1,0,1,0.14285714285714285,1,0.0,0,0,0,0,0,0,0,1,0,0,1,1
5094,101011,6RuWsSvS3Ngnjl37PzNAaaGn8Jd9a1lW,SpATywNh6bZuzm8s1ceuBUnMUAeoAHHw,1,0,0,0,0,0,1,0,1,0.14285714285714285,1,0.0,0,0,0,0,0,0,0,1,0,0,1,1
5095,101020,0ZCSFawDDnRtGIJPo0HlmFehfeS6kHt8,SpATywNh6bZuzm8s1ceuBUnMUAeoAHHw,6,7,3,0,2,0,2,0,14,2.0,1,0.0,0,3,0,2,7,0,0,2,0,5,9,1
5096,101024,WSII4CAtuXXVd816MewodzGLKdBCCfc2,SpATywNh6bZuzm8s1ceuBUnMUAeoAHHw,15,32,11,18,7,1,8,0,77,11.0,2,0.0,14,11,17,7,18,1,1,8,0,49,28,0
5097,101026,mbu5XDK8Rjc919DDY9nTqWKI0jGsFurC,A3fsA9Zfv1X2fVEQhTw51lKENdNrEqT3,1,0,0,0,0,0,1,0,1,0.14285714285714285,1,0.0,0,0,0,0,0,0,0,1,0,0,1,1
5098,101029,qnchlLjb2Sg0NdcHhbSBOQwh2G3s1NPH,G8EPVSXsOYB5YQWZGiz1aVq5Pgr2GrQu,9,6,1,0,1,0,3,0,11,1.5714285714285714,2,0.0,0,1,0,1,6,0,0,3,0,2,9,1
5099,101037,eWW5LWmp2L4jfpnZTKTrpHZw2NPytGoT,A3fsA9Zfv1X2fVEQhTw51lKENdNrEqT3,1,0,0,0,0,0,1,0,1,0.14285714285714285,1,0.0,0,0,0,0,0,0,0,1,0,0,1,1
5100,101039,3Cx4dFPpXfBhy67BB6opyx75Z6TxCQV0,SpATywNh6bZuzm8s1ceuBUnMUAeoAHHw,1,0,0,0,0,0,1,0,1,0.14285714285714285,1,0.0,0,0,0,0,0,0,0,1,0,0,1,1
5101,101040,0MInlyhRLhTct7ctvAmGIMuZ2WCCEQOJ,A3fsA9Zfv1X2fVEQhTw51lKENdNrEqT3,1,0,0,0,0,0,1,0,1,0.14285714285714285,1,0.0,0,0,0,0,0,0,0,1,0,0,1,1
5102,101049,4s35oxsHucC7ffS0wFNPwafPYeG49GAU,SpATywNh6bZuzm8s1ceuBUnMUAeoAHHw,4,0,0,0,0,0,4,1,5,0.7142857142857143,1,0.0,0,0,0,0,0,0,0,4,1,0,5,1
5103,101051,0WQxgoUN7TBDtRGEW7KgYzWz2pgrrK5v,A3fsA9Zfv1X2fVEQhTw51lKENdNrEqT3,1,0,0,0,0,0,1,0,1,0.14285714285714285,1,0.0,0,0,0,0,0,0,0,1,0,0,1,1
5104,101056,OHdLWfOkVYVSxh9avWbeG6oGLyuN9vvx,SpATywNh6bZuzm8s1ceuBUnMUAeoAHHw,6,3,2,0,1,0,3,0,9,1.2857142857142858,1,0.0,0,2,0,1,3,0,0,3,0,3,6,1
5105,101075,2edy9dIAe4yrL8yAxHgqsIKKU0nldbta,SpATywNh6bZuzm8s1ceuBUnMUAeoAHHw,18,32,10,15,4,17,19,1,98,14.0,4,0.0,16,10,12,4,16,17,3,19,1,42,56,0
5106,101076,9QftuNjRCr9ybWcdk9XGcjwoamuBGtxp,RXDvfPUBYFlVdlueBFbLW0mhhAyGEqpt,13,8,3,8,2,0,4,1,26,3.7142857142857144,1,0.0,4,3,8,2,4,0,0,4,1,17,9,1
5107,101088,skwGEmBgIkpxOdkOcle3E7qOBQA7vS2R,SpATywNh6bZuzm8s1ceuBUnMUAeoAHHw,5,3,1,0,1,0,2,0,7,1.0,1,0.0,0,1,0,1,3,0,0,2,0,2,5,1
5108,101089,6mMeVC2B7hFVd1nCtPVGU6PaoCXq1G2c,SpATywNh6bZuzm8s1ceuBUnMUAeoAHHw,3,2,0,0,0,0,1,0,3,0.42857142857142855,1,0.0,0,0,0,0,2,0,0,1,0,0,3,1
5109,101100,mRaBEX7ZDfkFg6XYznVptg421BJGPS3w,SpATywNh6bZuzm8s1ceuBUnMUAeoAHHw,6,3,1,0,1,0,2,1,8,1.1428571428571428,1,0.0,0,1,0,1,3,0,0,2,1,2,6,1
5110,101101,FTGBOUC5qFiXzNQNK1iKg2fvAMPM8ThA,SpATywNh6bZuzm8s1ceuBUnMUAeoAHHw,9,8,4,0,4,0,2,0,18,2.5714285714285716,1,0.0,0,4,0,4,8,0,0,2,0,8,10,1
5111,101111,jWJRJs7mP2iWLScGpcEFZK8ziDAIaDM6,SpATywNh6bZuzm8s1ceuBUnMUAeoAHHw,12,20,1,18,0,0,5,0,44,6.285714285714286,2,0.0,12,1,15,0,8,0,3,5,0,28,16,1
5112,101115,FixP7IuJ80KsWtzMzcQsJZKOjLxDKZgC,SpATywNh6bZuzm8s1ceuBUnMUAeoAHHw,1,0,0,0,0,0,1,0,1,0.14285714285714285,1,0.0,0,0,0,0,0,0,0,1,0,0,1,1
5113,101129,dZFFkuSkEdW4wzDVTZtpVIC64kvJ857o,G8EPVSXsOYB5YQWZGiz1aVq5Pgr2GrQu,5,2,1,0,1,0,2,0,6,0.8571428571428571,1,0.0,0,1,0,1,2,0,0,2,0,2,4,1
5114,101152,7B5rcRMuJ6A1xAdnnIVDusvPjMkwnC77,bWdj2GDclj5ofokWjzoa5jAwMkxCykd6,18,39,5,78,1,3,12,1,139,19.857142857142858,2,0.0,9,5,74,1,30,3,4,12,1,89,50,1
5115,101155,PSxHADin4S7TFVr4zP5HBd1nZjW3cx4M,G8EPVSXsOYB5YQWZGiz1aVq5Pgr2GrQu,11,10,5,6,0,19,2,0,42,6.0,1,0.0,3,5,3,0,7,19,3,2,0,11,31,1
5116,101166,DFKzgJXlXxnZVHESIM4fYC543XX9ZfDV,A3fsA9Zfv1X2fVEQhTw51lKENdNrEqT3,1,0,0,0,0,0,1,0,1,0.14285714285714285,1,0.0,0,0,0,0,0,0,0,1,0,0,1,1
5117,101168,Fa6BLRRKtDwlKrwyXtqO3LGNnTfVpmlS,SpATywNh6bZuzm8s1ceuBUnMUAeoAHHw,1,0,0,0,0,0,1,0,1,0.14285714285714285,1,0.0,0,0,0,0,0,0,0,1,0,0,1,1
5118,101172,hfMGuVwBeucr422AFfEYrtJHa9rVnsoA,SpATywNh6bZuzm8s1ceuBUnMUAeoAHHw,1,0,0,0,0,0,1,0,1,0.14285714285714285,1,0.0,0,0,0,0,0,0,0,1,0,0,1,1
5119,101178,uAXW7zeSaEEtMIdMcVsYpUquscAKUnr7,bWdj2GDclj5ofokWjzoa5jAwMkxCykd6,2,0,0,0,0,0,2,0,2,0.2857142857142857,1,0.0,0,0,0,0,0,0,0,2,0,0,2,1
5120,101183,4moZsX66K72QjGT5GqDqJCMPu4Ct97bi,G8EPVSXsOYB5YQWZGiz1aVq5Pgr2GrQu,6,5,1,0,2,1,2,0,11,1.5714285714285714,1,0.0,2,1,0,2,3,1,0,2,0,5,6,1
5121,101188,gtKTzkXHwS41ljYVmjlLLf4WyQSkK02q,RXDvfPUBYFlVdlueBFbLW0mhhAyGEqpt,2,0,0,0,0,0,2,0,2,0.2857142857142857,1,0.0,0,0,0,0,0,0,0,2,0,0,2,1
5122,101208,6bpPMNX4VLAo5FNzh6WrMNoyVaRnL68O,RXDvfPUBYFlVdlueBFbLW0mhhAyGEqpt,8,9,1,0,0,0,1,0,11,1.5714285714285714,1,0.0,0,1,0,0,9,0,0,1,0,1,10,1
5123,101210,h9fj5ctPIK6vllChG3R7Ob244BG9PpLx,SpATywNh6bZuzm8s1ceuBUnMUAeoAHHw,3,0,0,0,0,0,3,1,4,0.5714285714285714,1,0.0,0,0,0,0,0,0,0,3,1,0,4,1
5124,101217,eoY58NwX7OVcm2sOG1AAgydEA1V5TiLJ,SpATywNh6bZuzm8s1ceuBUnMUAeoAHHw,1,0,0,0,0,0,1,0,1,0.14285714285714285,1,0.0,0,0,0,0,0,0,0,1,0,0,1,1
5125,101222,7SY0SzNTkW1xUX8FK1P49jbfTWqfgLfG,SpATywNh6bZuzm8s1ceuBUnMUAeoAHHw,7,16,2,0,1,0,7,0,26,3.7142857142857144,2,0.0,0,2,0,1,16,0,0,7,0,3,23,1
5126,101225,MwRVXLIjs7ObnboXYRMgXHQa3UWpN5i5,bWdj2GDclj5ofokWjzoa5jAwMkxCykd6,5,2,1,0,1,0,3,0,7,1.0,1,0.0,0,1,0,1,2,0,0,3,0,2,5,1
5127,101227,1zysq5lTXLzGIAe1yQorA74YMvQPYkm5,SpATywNh6bZuzm8s1ceuBUnMUAeoAHHw,1,0,0,0,0,0,2,0,2,0.2857142857142857,1,0.0,0,0,0,0,0,0,0,2,0,0,2,1
5128,101234,7kbuqNU54d8d11QmdSpTGAMhLhmSDka1,RXDvfPUBYFlVdlueBFbLW0mhhAyGEqpt,44,25,15,72,8,0,4,0,124,17.714285714285715,2,0.0,7,15,68,8,18,0,4,4,0,98,26,1
5129,101236,cCvHnoX6St5OTmXQ2AOInGyMnqlmS6DL,SpATywNh6bZuzm8s1ceuBUnMUAeoAHHw,14,14,6,16,4,1,2,0,43,6.142857142857143,1,0.0,4,6,14,4,10,1,2,2,0,28,15,1
5130,101246,I5LLOe5opvt5J43scHH7lI6K5JrrHIsM,SpATywNh6bZuzm8s1ceuBUnMUAeoAHHw,7,2,1,0,1,0,4,0,8,1.1428571428571428,2,0.0,0,1,0,1,2,0,0,4,0,2,6,1
5131,101250,iI85tnA7qrRiHSPoxfEPOdB8KhBODfhh,bWdj2GDclj5ofokWjzoa5jAwMkxCykd6,3,0,0,0,0,0,3,0,3,0.42857142857142855,1,0.0,0,0,0,0,0,0,0,3,0,0,3,1
5132,101260,ti7nrCLZuFBhUOASmDPlWdVcwOuGnHAJ,SpATywNh6bZuzm8s1ceuBUnMUAeoAHHw,7,7,5,0,3,0,3,0,18,2.5714285714285716,2,0.0,0,5,0,3,7,0,0,3,0,8,10,1
5133,103038,TGrjsRoxwzZ35wp3zciCPp8r5aOpBmZm,SpATywNh6bZuzm8s1ceuBUnMUAeoAHHw,1,0,0,0,0,0,2,0,2,0.2857142857142857,1,0.0,0,0,0,0,0,0,0,2,0,0,2,1
5134,103347,hNJz0qbOhrUgajUkzqSdDbybHkuRglfs,SpATywNh6bZuzm8s1ceuBUnMUAeoAHHw,16,27,17,10,6,1,10,3,74,10.571428571428571,3,0.0,4,17,10,6,23,1,0,10,3,37,37,0
5135,103445,YR1IgV2TtttHJ35h5NJxgcWKWfmLYszA,SpATywNh6bZuzm8s1ceuBUnMUAeoAHHw,14,30,16,4,7,1,11,0,69,9.857142857142858,4,0.0,3,16,4,7,27,1,0,11,0,30,39,0
5136,103457,XvNNzv39b8VqKid0q4fV9ms2wVNAdWks,bWdj2GDclj5ofokWjzoa5jAwMkxCykd6,7,10,4,0,4,0,8,0,26,3.7142857142857144,1,0.0,2,4,0,4,8,0,0,8,0,10,16,0
5137,103661,Z5Gd8RjsJSljoHUoBd3hvIVNy4VKuGq0,SpATywNh6bZuzm8s1ceuBUnMUAeoAHHw,16,38,16,8,11,20,4,0,97,13.857142857142858,2,0.0,6,16,7,11,32,20,1,4,0,40,57,0
5138,103849,9poFqdhDn1jEwJp6tGIQlD3gMA14zAqO,SpATywNh6bZuzm8s1ceuBUnMUAeoAHHw,8,6,0,0,0,2,7,1,16,2.2857142857142856,2,0.0,0,0,0,0,6,2,0,7,1,0,16,1
5139,103930,Txv4UTCXPzwxfIDD6g3LwRLt3kYLBXuk,SpATywNh6bZuzm8s1ceuBUnMUAeoAHHw,12,29,1,16,0,48,8,0,102,14.571428571428571,5,0.0,10,1,13,0,19,48,3,8,0,24,78,0
5140,104119,1aQoKDna73jstuOrupWa9Kq8V3FdvbRU,SpATywNh6bZuzm8s1ceuBUnMUAeoAHHw,6,3,2,0,2,0,1,0,8,1.1428571428571428,1,0.0,0,2,0,2,3,0,0,1,0,4,4,1
5141,104284,eTpWGRVGcm2Ik3M0L1jEIkegdNZVCw6R,SpATywNh6bZuzm8s1ceuBUnMUAeoAHHw,14,47,1,21,1,47,6,1,124,17.714285714285715,2,0.0,34,1,18,1,13,47,3,6,1,54,70,0
5142,104292,BhFlcQJWIjFJlF5Tqxm0xkVlpnp9sVr5,A3fsA9Zfv1X2fVEQhTw51lKENdNrEqT3,10,6,4,0,3,0,2,0,15,2.142857142857143,1,0.0,0,4,0,3,6,0,0,2,0,7,8,1
5143,104294,HTFrI1D4p0HbfBDMwhsdYfCOWsNzjXaR,SpATywNh6bZuzm8s1ceuBUnMUAeoAHHw,7,3,2,0,2,0,2,0,9,1.2857142857142858,1,0.0,0,2,0,2,3,0,0,2,0,4,5,1
5144,104337,dMZ9S55l3tq5M3A71U0KoWxXWAhXsFH4,SpATywNh6bZuzm8s1ceuBUnMUAeoAHHw,7,10,4,0,2,0,2,0,18,2.5714285714285716,1,0.0,0,4,0,2,10,0,0,2,0,6,12,1
5145,104341,2rPgSvtsbYrCOUBollArAnVMcQox4Rzz,SpATywNh6bZuzm8s1ceuBUnMUAeoAHHw,10,5,4,0,3,0,6,0,18,2.5714285714285716,1,0.0,0,4,0,3,5,0,0,6,0,7,11,1
5146,104352,Jc6Rj6cwfhWlrTpjaB2LnqARTW8Bbf0L,SpATywNh6bZuzm8s1ceuBUnMUAeoAHHw,5,3,1,0,1,0,2,0,7,1.0,1,0.0,0,1,0,1,3,0,0,2,0,2,5,1
5147,104356,Nvx1FqKYM0wMKIIRgD0fWbHs2ulluJLe,bWdj2GDclj5ofokWjzoa5jAwMkxCykd6,1,0,0,0,0,0,1,0,1,0.14285714285714285,1,0.0,0,0,0,0,0,0,0,1,0,0,1,1
5148,104358,Nvx1FqKYM0wMKIIRgD0fWbHs2ulluJLe,A3fsA9Zfv1X2fVEQhTw51lKENdNrEqT3,4,2,0,0,0,0,2,0,4,0.5714285714285714,1,0.0,0,0,0,0,2,0,0,2,0,0,4,1
5149,104366,uLsUz9dpaUlUOxHeWF3yHSSVzvVLEW6w,SpATywNh6bZuzm8s1ceuBUnMUAeoAHHw,1,0,0,0,0,0,1,0,1,0.14285714285714285,1,0.0,0,0,0,0,0,0,0,1,0,0,1,1
5150,104410,ObbXaQT6J9VxlQqNb4O6euoNIJzHR7rT,SpATywNh6bZuzm8s1ceuBUnMUAeoAHHw,9,4,3,0,3,0,2,0,12,1.7142857142857142,1,0.0,0,3,0,3,4,0,0,2,0,6,6,1
5151,104411,pcsiSS3QOPo0n8yKp6skJyBWeonG4c8P,A3fsA9Zfv1X2fVEQhTw51lKENdNrEqT3,7,4,3,0,3,0,2,0,12,1.7142857142857142,1,0.0,0,3,0,3,4,0,0,2,0,6,6,1
5152,104432,nbu72Hfybp6pv1ykyATXAv2RfzFEFoR8,SpATywNh6bZuzm8s1ceuBUnMUAeoAHHw,12,12,0,20,0,4,5,0,41,5.857142857142857,1,0.0,5,0,17,0,7,4,3,5,0,22,19,1
5153,104441,xMs8rC8PWX4mnQhPoCok61SbExcNBkVe,SpATywNh6bZuzm8s1ceuBUnMUAeoAHHw,6,3,1,0,1,0,2,0,7,1.0,1,0.0,0,1,0,1,3,0,0,2,0,2,5,1
5154,104452,ziSW6xDH8gzyWXn2P08NFoRMJoG4EqEB,SpATywNh6bZuzm8s1ceuBUnMUAeoAHHw,12,25,12,0,7,0,2,0,46,6.571428571428571,1,0.0,4,12,0,7,21,0,0,2,0,23,23,1
5155,104453,8uGMX8Xu6j8RLuhsBjmFgfMaI4mZnvz1,SpATywNh6bZuzm8s1ceuBUnMUAeoAHHw,12,10,4,0,3,0,4,0,21,3.0,1,0.0,0,4,0,3,10,0,0,4,0,7,14,1
5156,104458,I3Y9SshT4Px6bPwzvv7ixI5CQirBePZQ,SpATywNh6bZuzm8s1ceuBUnMUAeoAHHw,5,9,4,0,0,0,3,0,16,2.2857142857142856,2,0.0,0,4,0,0,9,0,0,3,0,4,12,1
5157,104463,DyQHVTNiwX6W4PiKOVh8BCoKQr8u7ImW,A3fsA9Zfv1X2fVEQhTw51lKENdNrEqT3,12,12,1,0,0,3,10,0,26,3.7142857142857144,1,0.0,1,1,0,0,11,3,0,10,0,2,24,1
5158,104466,KXi2lu4GlKmrO1lJTLg3t4l701rvNXNZ,bWdj2GDclj5ofokWjzoa5jAwMkxCykd6,1,0,0,0,0,0,1,0,1,0.14285714285714285,1,0.0,0,0,0,0,0,0,0,1,0,0,1,1
5159,104468,qUJjM2rHGQKXLfW6M7Cfr4tvklEU6daf,SpATywNh6bZuzm8s1ceuBUnMUAeoAHHw,13,12,6,3,2,6,11,3,43,6.142857142857143,2,0.0,1,6,3,2,11,6,0,11,3,12,31,1
5160,104489,wT2PCRFj23I7HDSSujNYjrYVx91GnsP3,A3fsA9Zfv1X2fVEQhTw51lKENdNrEqT3,1,0,0,0,0,0,1,0,1,0.14285714285714285,1,0.0,0,0,0,0,0,0,0,1,0,0,1,0
5161,104492,tPRxZgUxDUTQm2PmIuX0fewSz7eitT8g,SpATywNh6bZuzm8s1ceuBUnMUAeoAHHw,1,0,0,0,0,0,1,0,1,0.14285714285714285,1,0.0,0,0,0,0,0,0,0,1,0,0,1,1
5162,104495,LYehQDSOM5PcdlXuo0xGoCftzdlyd2gI,A3fsA9Zfv1X2fVEQhTw51lKENdNrEqT3,4,0,0,0,0,0,4,0,4,0.5714285714285714,1,0.0,0,0,0,0,0,0,0,4,0,0,4,1
5163,104496,tWy6K2sNXVB2esbGJMyXdZRQGH2Klw9e,SpATywNh6bZuzm8s1ceuBUnMUAeoAHHw,1,0,0,0,0,0,1,0,1,0.14285714285714285,1,0.0,0,0,0,0,0,0,0,1,0,0,1,1
5164,104503,2jTGBIAeHp8pnl61IF8YWrKorMuy9KJe,SpATywNh6bZuzm8s1ceuBUnMUAeoAHHw,2,0,0,0,0,0,2,0,2,0.2857142857142857,1,0.0,0,0,0,0,0,0,0,2,0,0,2,1
5165,104509,oE1QbspE1VaPia0G9CbmnflG7dN6cZJM,SpATywNh6bZuzm8s1ceuBUnMUAeoAHHw,2,0,0,0,0,0,2,0,2,0.2857142857142857,1,0.0,0,0,0,0,0,0,0,2,0,0,2,1
5166,104515,KQvub9kHQ3XpwpO5JgmmZp67zs4af3TX,A3fsA9Zfv1X2fVEQhTw51lKENdNrEqT3,5,2,1,0,1,0,2,0,6,0.8571428571428571,1,0.0,0,1,0,1,2,0,0,2,0,2,4,1
5167,104521,i5EjwCywnHAh7QM2CMkeJsIdXa8rMV6i,bWdj2GDclj5ofokWjzoa5jAwMkxCykd6,2,0,0,0,0,0,2,0,2,0.2857142857142857,1,0.0,0,0,0,0,0,0,0,2,0,0,2,1
5168,104526,ydd1OhJLlZRjAmcrBX6w4fAjd763MlEr,SpATywNh6bZuzm8s1ceuBUnMUAeoAHHw,2,0,0,0,0,0,2,0,2,0.2857142857142857,1,0.0,0,0,0,0,0,0,0,2,0,0,2,1
5169,104531,VqPSgF7LIkhd0l6BSJd84AdcMj5MaqIS,SpATywNh6bZuzm8s1ceuBUnMUAeoAHHw,1,0,0,0,0,0,1,0,1,0.14285714285714285,1,0.0,0,0,0,0,0,0,0,1,0,0,1,1
5170,104540,WELjmgdsP962Pc1teJ96xvofKraKe6qa,bWdj2GDclj5ofokWjzoa5jAwMkxCykd6,6,2,1,0,1,6,7,0,17,2.4285714285714284,3,0.0,0,1,0,1,2,6,0,7,0,2,15,0
5171,104546,h2uPViUap57On5JUqQ9igq5GDP75Rgzf,SpATywNh6bZuzm8s1ceuBUnMUAeoAHHw,14,13,6,9,2,1,3,0,34,4.857142857142857,1,0.0,3,6,9,2,10,1,0,3,0,20,14,1
5172,104548,V0AsQgHGQGwNZqmKaETWBrxe3WpC4m5k,SpATywNh6bZuzm8s1ceuBUnMUAeoAHHw,8,6,3,0,2,0,6,0,17,2.4285714285714284,1,0.0,0,3,0,2,6,0,0,6,0,5,12,1
5173,104555,PSygGEnajNdSwAgw8ZB2LUfijgMjfKqV,bWdj2GDclj5ofokWjzoa5jAwMkxCykd6,1,0,0,0,0,0,1,0,1,0.14285714285714285,1,0.0,0,0,0,0,0,0,0,1,0,0,1,1
5174,104589,LOsVkswWxHe5YwcAM1YjHggicuRbJ5sf,SpATywNh6bZuzm8s1ceuBUnMUAeoAHHw,1,0,0,0,0,0,1,0,1,0.14285714285714285,1,0.0,0,0,0,0,0,0,0,1,0,0,1,1
5175,104590,hlub8IQ6xr3M5qQPn6YnEFWROpuhMcwL,A3fsA9Zfv1X2fVEQhTw51lKENdNrEqT3,9,2,1,0,1,2,9,1,16,2.2857142857142856,2,0.0,0,1,0,1,2,2,0,9,1,2,14,1
5176,104591,nZpaESUo0GJPIuUQLM7WpTAyDvRCYws3,SpATywNh6bZuzm8s1ceuBUnMUAeoAHHw,11,6,2,8,1,0,6,0,23,3.2857142857142856,1,0.0,2,2,6,1,4,0,2,6,0,11,12,1
5177,104593,Q37fGjJ8eugSdDYZTpXfPJGR1Hy2EJgr,A3fsA9Zfv1X2fVEQhTw51lKENdNrEqT3,8,2,1,0,1,1,6,1,12,1.7142857142857142,1,0.0,0,1,0,1,2,1,0,6,1,2,10,1
5178,104608,n0z9CmHQ1aT2Na1Alnc3POrgJ8DExUjg,A3fsA9Zfv1X2fVEQhTw51lKENdNrEqT3,1,0,0,0,0,0,1,0,1,0.14285714285714285,1,0.0,0,0,0,0,0,0,0,1,0,0,1,1
5179,104613,Ek3NRIw6r3qK8qXdjTcUWOMSezARAlja,bWdj2GDclj5ofokWjzoa5jAwMkxCykd6,6,6,2,0,2,1,4,0,15,2.142857142857143,1,0.0,1,2,0,2,5,1,0,4,0,5,10,1
5180,104615,yfPEDU3OzZWMdKaypuOZrACuYp6GNcyd,A3fsA9Zfv1X2fVEQhTw51lKENdNrEqT3,1,0,0,0,0,0,2,0,2,0.2857142857142857,1,0.0,0,0,0,0,0,0,0,2,0,0,2,1
5181,104633,CtmqfatIKebJswM6ar9T0zVFJv52NCRl,SpATywNh6bZuzm8s1ceuBUnMUAeoAHHw,7,5,0,0,0,0,3,0,8,1.1428571428571428,1,0.0,0,0,0,0,5,0,0,3,0,0,8,1
5182,104636,JgNllefl6lxMJFs121u0iwNrhgAg4Z2l,A3fsA9Zfv1X2fVEQhTw51lKENdNrEqT3,4,2,1,0,1,0,1,0,5,0.7142857142857143,1,0.0,0,1,0,1,2,0,0,1,0,2,3,1
5183,104642,OyCwM8soHH8QE4hfLYRsx6iyHPIOqWTw,SpATywNh6bZuzm8s1ceuBUnMUAeoAHHw,13,12,0,11,0,0,8,1,32,4.571428571428571,1,0.0,7,0,9,0,5,0,2,8,1,16,16,1
5184,104688,1vi3aoGF64IJNwusboKMOjObFPU3HDht,SpATywNh6bZuzm8s1ceuBUnMUAeoAHHw,14,15,6,15,4,0,2,0,42,6.0,1,0.0,8,6,12,4,7,0,3,2,0,30,12,0
5185,104693,vGcc0AnjpQHzU6MhASLVTSg5K7Oxs693,bWdj2GDclj5ofokWjzoa5jAwMkxCykd6,1,0,0,0,0,0,1,0,1,0.14285714285714285,1,0.0,0,0,0,0,0,0,0,1,0,0,1,0
5186,104697,HlYiU2TA92it9HWOPDlsBmlpdZ7J7QTJ,A3fsA9Zfv1X2fVEQhTw51lKENdNrEqT3,30,57,29,52,19,11,18,1,187,26.714285714285715,3,0.0,2,29,43,19,55,11,9,18,1,93,94,1
5187,104724,AO2DWs3lh9A1GvC8BAMupQKT1Hlk19lZ,A3fsA9Zfv1X2fVEQhTw51lKENdNrEqT3,5,7,0,0,0,0,6,0,13,1.8571428571428572,1,0.0,0,0,0,0,7,0,0,6,0,0,13,1
5188,104727,T8KPSkXPudd9vKVat9asv5ysr6zWaQCY,SpATywNh6bZuzm8s1ceuBUnMUAeoAHHw,15,25,2,19,0,1,9,2,58,8.285714285714286,1,0.0,9,2,16,0,16,1,3,9,2,27,31,1
5189,104735,XEAzAzWsIHOpS801lITcIzqWP1a4yYMV,SpATywNh6bZuzm8s1ceuBUnMUAeoAHHw,15,12,7,13,4,2,3,1,42,6.0,1,0.0,4,7,12,4,8,2,1,3,1,27,15,1
5190,104737,o6c539lwIkVrO8m1FxoLjW3D1hV2LZeV,SpATywNh6bZuzm8s1ceuBUnMUAeoAHHw,10,7,0,8,0,6,3,0,24,3.4285714285714284,2,0.0,2,0,7,0,5,6,1,3,0,9,15,1
5191,104746,Lzsz8G97Oqbb3ZBCI5dR9gHrqQ1EH7Ym,bWdj2GDclj5ofokWjzoa5jAwMkxCykd6,4,3,0,0,0,0,1,0,4,0.5714285714285714,1,0.0,0,0,0,0,3,0,0,1,0,0,4,1
5192,104757,couyquW2Z4n38XcaXOGqoUN34GlfxMVE,A3fsA9Zfv1X2fVEQhTw51lKENdNrEqT3,6,4,1,0,1,0,2,0,8,1.1428571428571428,1,0.0,0,1,0,1,4,0,0,2,0,2,6,0
5193,104762,Lo2vU6mH3fqBjPz8YtN99A9tnKdHVK6o,SpATywNh6bZuzm8s1ceuBUnMUAeoAHHw,5,2,1,0,1,0,2,0,6,0.8571428571428571,1,0.0,0,1,0,1,2,0,0,2,0,2,4,1
5194,104770,1O5EjoRsscLnc9nXfpqkKtbnynlBSzrx,SpATywNh6bZuzm8s1ceuBUnMUAeoAHHw,6,3,2,0,0,0,3,0,8,1.1428571428571428,1,0.0,0,2,0,0,3,0,0,3,0,2,6,1
5195,104774,tBbhVMYYQ6OTtHw8ihRfnNPpAK2u2FCV,SpATywNh6bZuzm8s1ceuBUnMUAeoAHHw,10,16,7,0,4,0,1,0,28,4.0,1,0.0,0,7,0,4,16,0,0,1,0,11,17,1
5196,104777,7AcpuVe6H4EQE4t982IHxKSRBEP280dQ,SpATywNh6bZuzm8s1ceuBUnMUAeoAHHw,11,13,1,16,0,6,5,1,42,6.0,1,0.0,6,1,15,0,7,6,1,5,1,22,20,1
5197,104784,A7BPMFQzaFIvFoWRCDmdq1av9dzZSKUQ,SpATywNh6bZuzm8s1ceuBUnMUAeoAHHw,1,0,0,0,0,0,1,0,1,0.14285714285714285,1,0.0,0,0,0,0,0,0,0,1,0,0,1,1
5198,104792,uMEUDlZ1tL8WoZ2EmL0CStSYwA0zOal8,SpATywNh6bZuzm8s1ceuBUnMUAeoAHHw,6,3,2,0,2,0,1,0,8,1.1428571428571428,1,0.0,0,2,0,2,3,0,0,1,0,4,4,1
5199,104793,qDtFi7e90cUeHzM7V0dyqooeuFxEYpNm,SpATywNh6bZuzm8s1ceuBUnMUAeoAHHw,7,3,2,0,2,0,2,0,9,1.2857142857142858,1,0.0,0,2,0,2,3,0,0,2,0,4,5,1
5200,104795,cjnjr7Duofdr7KxOEuxuSM38OHUgNo60,G8EPVSXsOYB5YQWZGiz1aVq5Pgr2GrQu,11,12,3,0,3,0,11,1,30,4.285714285714286,1,0.0,0,3,0,3,12,0,0,11,1,6,24,0
5201,104800,mz4uLo9BLm8C45jnilK7oxFwMZeC54GR,A3fsA9Zfv1X2fVEQhTw51lKENdNrEqT3,8,6,1,0,0,3,5,0,15,2.142857142857143,1,0.0,0,1,0,0,6,3,0,5,0,1,14,1
5202,104801,dDRiefJH6VL2xh5SH3Jn4nOIwtp9UE53,SpATywNh6bZuzm8s1ceuBUnMUAeoAHHw,4,0,0,0,0,0,5,0,5,0.7142857142857143,1,0.0,0,0,0,0,0,0,0,5,0,0,5,1
5203,104811,xhZvMzC7C3FI6QGx1nJhPvhS30jV3HlC,SpATywNh6bZuzm8s1ceuBUnMUAeoAHHw,1,0,0,0,0,0,1,0,1,0.14285714285714285,1,0.0,0,0,0,0,0,0,0,1,0,0,1,1
5204,104815,I3l3i5FdvqNSQ2HVtWbrElKwC57iq42m,SpATywNh6bZuzm8s1ceuBUnMUAeoAHHw,6,4,1,0,1,0,2,0,8,1.1428571428571428,1,0.0,1,1,0,1,3,0,0,2,0,3,5,1
5205,104817,kCDwRCPqHBdxL6Zm4oP4P8LFVB7ooBk2,A3fsA9Zfv1X2fVEQhTw51lKENdNrEqT3,1,0,0,0,0,0,1,0,1,0.14285714285714285,1,0.0,0,0,0,0,0,0,0,1,0,0,1,1
5206,104821,HZ09CsQBbpW2jBqTRwR09w2caEvBXEBF,SpATywNh6bZuzm8s1ceuBUnMUAeoAHHw,11,9,0,18,0,0,2,0,29,4.142857142857143,1,0.0,2,0,15,0,7,0,3,2,0,17,12,0
5207,104824,zoXigsWBjyJG6OSyWQP4Y5frh0Mc9ncS,A3fsA9Zfv1X2fVEQhTw51lKENdNrEqT3,5,3,1,0,1,0,3,0,8,1.1428571428571428,1,0.0,1,1,0,1,2,0,0,3,0,3,5,1
5208,104825,fPBHPutjsyATgfjDez6QiXqE3EQ549Sn,bWdj2GDclj5ofokWjzoa5jAwMkxCykd6,10,9,2,56,3,3,5,1,79,11.285714285714286,1,0.0,5,2,53,3,4,3,3,5,1,63,16,1
5209,104835,Ri95AXIo8zsMGIr8iLd7Nlf3hXPlEtcm,SpATywNh6bZuzm8s1ceuBUnMUAeoAHHw,5,3,1,0,0,0,2,0,6,0.8571428571428571,1,0.0,0,1,0,0,3,0,0,2,0,1,5,1
5210,104851,zjreW3h1Ea5BeCNB7vdMhwpbveHkJfhN,SpATywNh6bZuzm8s1ceuBUnMUAeoAHHw,7,2,1,0,1,1,4,1,10,1.4285714285714286,1,0.0,0,1,0,1,2,1,0,4,1,2,8,1
5211,104852,YjmLtoh2FsHRMNwgNAtlpUzEWjN5nhAS,SpATywNh6bZuzm8s1ceuBUnMUAeoAHHw,7,3,2,0,2,0,2,0,9,1.2857142857142858,1,0.0,0,2,0,2,3,0,0,2,0,4,5,1
5212,104857,EfAzIK92h28Gz4WXYVhp9fzk6YRB1DXC,A3fsA9Zfv1X2fVEQhTw51lKENdNrEqT3,1,0,0,0,0,0,1,0,1,0.14285714285714285,1,0.0,0,0,0,0,0,0,0,1,0,0,1,0
5213,104865,w1QHQFv3RratMvfK2BnfmiIqIYey1EzI,bWdj2GDclj5ofokWjzoa5jAwMkxCykd6,12,10,1,72,4,0,1,0,88,12.571428571428571,1,0.0,6,1,70,4,4,0,2,1,0,81,7,1
5214,104879,KLWMzt2lbmi8onKYKX9eWLl5lpM0wx0M,A3fsA9Zfv1X2fVEQhTw51lKENdNrEqT3,1,0,0,0,0,0,1,0,1,0.14285714285714285,1,0.0,0,0,0,0,0,0,0,1,0,0,1,1
5215,104881,RGtc1IdNIb5F1GGBZyglC3Cmje3Zbvbo,SpATywNh6bZuzm8s1ceuBUnMUAeoAHHw,1,0,0,0,0,0,1,0,1,0.14285714285714285,1,0.0,0,0,0,0,0,0,0,1,0,0,1,1
5216,104892,knqmj88BDpPhBept6EC2R3YJ3D5KQUZz,SpATywNh6bZuzm8s1ceuBUnMUAeoAHHw,6,4,1,0,1,0,2,0,8,1.1428571428571428,1,0.0,0,1,0,1,4,0,0,2,0,2,6,1
5217,104895,pOlc1xunOD2pPlaz6EGQWZcGB6A8fwQn,SpATywNh6bZuzm8s1ceuBUnMUAeoAHHw,6,5,0,0,0,0,2,0,7,1.0,1,0.0,0,0,0,0,5,0,0,2,0,0,7,1
5218,104916,Pe6a7Y0LdkKZQUrgr38AH2nCOR1VUYXS,SpATywNh6bZuzm8s1ceuBUnMUAeoAHHw,6,3,2,0,2,0,1,0,8,1.1428571428571428,1,0.0,0,2,0,2,3,0,0,1,0,4,4,0
5219,104925,EmcvJhyzyIpQugXCF4WUuZQjl0kHTxx5,SpATywNh6bZuzm8s1ceuBUnMUAeoAHHw,5,2,1,0,1,0,2,0,6,0.8571428571428571,1,0.0,0,1,0,1,2,0,0,2,0,2,4,1
5220,104926,ONFhYKrJFqmwx9zBxMrT7qWQQw1Hgoxe,SpATywNh6bZuzm8s1ceuBUnMUAeoAHHw,8,7,3,0,2,0,2,0,14,2.0,1,0.0,3,3,0,2,4,0,0,2,0,8,6,1
5221,104928,hp7Gqo5252E9slRfXH0KFbulYobVoVWo,SpATywNh6bZuzm8s1ceuBUnMUAeoAHHw,7,5,3,0,1,0,4,0,13,1.8571428571428572,1,0.0,1,3,0,1,4,0,0,4,0,5,8,1
5222,104936,9xV1wwHzLoXwKNrE0sl58GGQQc4oj1NS,bWdj2GDclj5ofokWjzoa5jAwMkxCykd6,2,0,0,0,0,0,2,0,2,0.2857142857142857,1,0.0,0,0,0,0,0,0,0,2,0,0,2,1
5223,104947,MRBkmzjOlIfmLj12ExsDOcm0igHkBWY5,SpATywNh6bZuzm8s1ceuBUnMUAeoAHHw,4,2,0,0,0,0,2,0,4,0.5714285714285714,1,0.0,0,0,0,0,2,0,0,2,0,0,4,1
5224,104948,GEo21EE9t59WNpPzwlumpgmynliuHSiq,SpATywNh6bZuzm8s1ceuBUnMUAeoAHHw,3,0,0,0,0,0,3,0,3,0.42857142857142855,1,0.0,0,0,0,0,0,0,0,3,0,0,3,1
5225,104968,7cuOR7XN3OKWyCY4rmOlBcFyB6vgzoQs,A3fsA9Zfv1X2fVEQhTw51lKENdNrEqT3,3,0,0,0,0,0,4,0,4,0.5714285714285714,1,0.0,0,0,0,0,0,0,0,4,0,0,4,1
5226,104978,4p8c3FKQ0TxdvnCwTtbL9bKeePWMVkGP,SpATywNh6bZuzm8s1ceuBUnMUAeoAHHw,1,0,0,0,0,0,3,0,3,0.42857142857142855,1,0.0,0,0,0,0,0,0,0,3,0,0,3,1
5227,104984,0BvOWU3Vj9nIRblTj7EEskLoO3PxCxAy,bWdj2GDclj5ofokWjzoa5jAwMkxCykd6,5,2,1,0,1,0,5,0,9,1.2857142857142858,1,0.0,0,1,0,1,2,0,0,5,0,2,7,1
5228,104997,ve3dSb9Szfp4MnOfHAgrGxXGtdEF42Tp,A3fsA9Zfv1X2fVEQhTw51lKENdNrEqT3,10,4,3,0,3,0,3,0,13,1.8571428571428572,1,0.0,0,3,0,3,4,0,0,3,0,6,7,1
5229,105008,yV65Fr78Zm5MeDBgymBFgzc66d5t5Zmy,SpATywNh6bZuzm8s1ceuBUnMUAeoAHHw,12,24,14,0,0,2,13,2,55,7.857142857142857,1,0.0,7,14,0,0,17,2,0,13,2,21,34,0
5230,105014,qUdYzd5flRA3GCXiGt7tidXnS0F0FsHM,SpATywNh6bZuzm8s1ceuBUnMUAeoAHHw,5,3,0,0,0,0,4,2,9,1.2857142857142858,1,0.0,0,0,0,0,3,0,0,4,2,0,9,1
5231,105023,JKdKVDiZ9BQn8tsX4CdH77AcEG85EmQH,SpATywNh6bZuzm8s1ceuBUnMUAeoAHHw,5,3,1,0,0,0,3,0,7,1.0,1,0.0,0,1,0,0,3,0,0,3,0,1,6,1
5232,105024,7NRmTpdp1LUibho8qoHBLQ3GcaVtwUud,SpATywNh6bZuzm8s1ceuBUnMUAeoAHHw,1,0,0,0,0,0,1,0,1,0.14285714285714285,1,0.0,0,0,0,0,0,0,0,1,0,0,1,1
5233,105030,QtcaqP1Oq08hvIX3wqGcQDC13eo6FjVm,SpATywNh6bZuzm8s1ceuBUnMUAeoAHHw,11,11,7,0,5,1,5,1,30,4.285714285714286,1,0.0,0,7,0,5,11,1,0,5,1,12,18,1
5234,105036,ynZ1Df4G2ARwLF4O85BSlMjjeKhXCtXL,SpATywNh6bZuzm8s1ceuBUnMUAeoAHHw,4,4,0,0,0,0,3,0,7,1.0,1,0.0,0,0,0,0,4,0,0,3,0,0,7,1
5235,105049,5GS5OD1cmKWecEPymf3UVauvWYXb9WHE,A3fsA9Zfv1X2fVEQhTw51lKENdNrEqT3,1,0,0,0,0,0,1,0,1,0.14285714285714285,1,0.0,0,0,0,0,0,0,0,1,0,0,1,1
5236,105053,pNgLScEwGgq81vg0a0cEXKNs5eG2UXph,bWdj2GDclj5ofokWjzoa5jAwMkxCykd6,1,0,0,0,0,0,1,0,1,0.14285714285714285,1,0.0,0,0,0,0,0,0,0,1,0,0,1,1
5237,105057,QhYcOEapN0nrffEwA6S7jQzZwToRePP8,A3fsA9Zfv1X2fVEQhTw51lKENdNrEqT3,1,0,0,0,0,0,1,0,1,0.14285714285714285,1,0.0,0,0,0,0,0,0,0,1,0,0,1,1
5238,105059,KbGfmKt9ZBLOdWhdHwa3KVnLDM8esaSY,bWdj2GDclj5ofokWjzoa5jAwMkxCykd6,6,6,4,0,0,0,3,0,13,1.8571428571428572,1,0.0,0,4,0,0,6,0,0,3,0,4,9,1
5239,105061,jbwkj7UcLcGeNeVIuodsT34xBiopSnSK,A3fsA9Zfv1X2fVEQhTw51lKENdNrEqT3,2,0,0,0,0,0,3,0,3,0.42857142857142855,1,0.0,0,0,0,0,0,0,0,3,0,0,3,0
5240,105065,qhE0nq1HVP5Z55HX3UNFMVHvllKc96Rl,SpATywNh6bZuzm8s1ceuBUnMUAeoAHHw,5,3,1,0,1,0,3,0,8,1.1428571428571428,2,0.0,0,1,0,1,3,0,0,3,0,2,6,1
5241,105071,NSXDiRfuzySceLFWn0ct3CJviCtJc0Gq,SpATywNh6bZuzm8s1ceuBUnMUAeoAHHw,1,0,0,0,0,0,1,0,1,0.14285714285714285,1,0.0,0,0,0,0,0,0,0,1,0,0,1,1
5242,105076,drf1IY3xrpWQ9619UjKLyUfcUQsAdZju,bWdj2GDclj5ofokWjzoa5jAwMkxCykd6,5,3,1,0,1,0,2,0,7,1.0,1,0.0,0,1,0,1,3,0,0,2,0,2,5,1
5243,105082,0V54aOwQrSAMewtMntBBMI7Ks56rZdIS,A3fsA9Zfv1X2fVEQhTw51lKENdNrEqT3,12,6,4,0,2,1,7,0,20,2.857142857142857,1,0.0,0,4,0,2,6,1,0,7,0,6,14,1
5244,105085,aBoQ4OrEI4L04m6kqgzVP3CKZVnd2VFV,A3fsA9Zfv1X2fVEQhTw51lKENdNrEqT3,9,9,1,0,1,0,6,1,18,2.5714285714285716,1,0.0,0,1,0,1,9,0,0,6,1,2,16,1
5245,105105,aBoQ4OrEI4L04m6kqgzVP3CKZVnd2VFV,bWdj2GDclj5ofokWjzoa5jAwMkxCykd6,5,4,0,0,1,0,3,0,8,1.1428571428571428,1,0.0,2,0,0,1,2,0,0,3,0,3,5,1
5246,105107,kJpZNsO69ywT5OXmlvOgbLwUz2WmPek1,SpATywNh6bZuzm8s1ceuBUnMUAeoAHHw,13,11,5,14,3,0,2,0,35,5.0,1,0.0,5,5,11,3,6,0,3,2,0,24,11,1
5247,105146,hzBzR1u0wuRoc2H2cG5d9FzvO4PwKrLQ,SpATywNh6bZuzm8s1ceuBUnMUAeoAHHw,4,5,0,0,0,3,4,0,12,1.7142857142857142,1,0.0,0,0,0,0,5,3,0,4,0,0,12,1
5248,105153,qTzYx0lbBuxcg0Yki7msaMyOo4bFeb91,SpATywNh6bZuzm8s1ceuBUnMUAeoAHHw,17,23,13,14,3,0,12,0,65,9.285714285714286,3,0.0,4,13,13,3,19,0,1,12,0,33,32,0
5249,105158,CCtqoOTfmYZ29m0AHaWWxr5jrw4v0sd6,A3fsA9Zfv1X2fVEQhTw51lKENdNrEqT3,2,0,0,0,0,0,2,0,2,0.2857142857142857,1,0.0,0,0,0,0,0,0,0,2,0,0,2,1
5250,105162,k5TsyI58X8P4Z61qSJPkdF5Bt76uuEiR,A3fsA9Zfv1X2fVEQhTw51lKENdNrEqT3,6,5,0,0,0,0,5,0,10,1.4285714285714286,1,0.0,0,0,0,0,5,0,0,5,0,0,10,1
5251,105165,WmDH79DnUcU85ObQwdrX32y257qi5DRa,SpATywNh6bZuzm8s1ceuBUnMUAeoAHHw,5,6,4,0,0,0,2,0,12,1.7142857142857142,1,0.0,1,4,0,0,5,0,0,2,0,5,7,1
5252,105182,w5agfaMGeGtqcOtE7XkU1SDkqYl8T1h1,A3fsA9Zfv1X2fVEQhTw51lKENdNrEqT3,8,5,3,0,2,0,6,1,17,2.4285714285714284,1,0.0,0,3,0,2,5,0,0,6,1,5,12,1
5253,105194,5KBUyFUobvfAu8D7u7bO9wAPV4vuXQZU,A3fsA9Zfv1X2fVEQhTw51lKENdNrEqT3,43,73,20,76,13,0,12,0,194,27.714285714285715,2,0.0,4,20,67,13,69,0,9,12,0,104,90,0
5254,105199,OX6Bv3g06ycMeO3pZBZoU81BWj7ixSi4,A3fsA9Zfv1X2fVEQhTw51lKENdNrEqT3,5,6,0,0,0,0,5,0,11,1.5714285714285714,1,0.0,0,0,0,0,6,0,0,5,0,0,11,1
5255,105209,H9GkE0FMgvPMf43bNx1b9TXX6TZkGY34,SpATywNh6bZuzm8s1ceuBUnMUAeoAHHw,8,10,4,0,0,0,8,0,22,3.142857142857143,2,0.0,0,4,0,0,10,0,0,8,0,4,18,1
5256,105210,4gTXYNChXbNDMcXayBSE04FxQ2nn4APt,SpATywNh6bZuzm8s1ceuBUnMUAeoAHHw,9,11,6,0,4,7,4,0,32,4.571428571428571,1,0.0,0,6,0,4,11,7,0,4,0,10,22,1
5257,105217,OTdrNhcnMXK6bAJrTqNFs6h1YG7CDhcG,SpATywNh6bZuzm8s1ceuBUnMUAeoAHHw,10,10,3,0,2,3,6,3,27,3.857142857142857,1,0.0,0,3,0,2,10,3,0,6,3,5,22,1
5258,105234,taq5KphdnNYof9EF9ofKeGcG174vbrqW,SpATywNh6bZuzm8s1ceuBUnMUAeoAHHw,7,3,2,0,2,0,3,0,10,1.4285714285714286,1,0.0,0,2,0,2,3,0,0,3,0,4,6,1
5259,105243,cOQL66KmsXcVQs1SDl21ZVtRVEM2A2Mr,SpATywNh6bZuzm8s1ceuBUnMUAeoAHHw,15,16,4,17,3,0,6,0,46,6.571428571428571,1,0.0,8,4,14,3,8,0,3,6,0,29,17,1
5260,105252,0XkWdOrszvLHfOAiz41vzdHNx25DrTO5,SpATywNh6bZuzm8s1ceuBUnMUAeoAHHw,18,24,9,14,4,2,7,1,61,8.714285714285714,1,0.0,12,9,13,4,12,2,1,7,1,38,23,1
5261,105253,HVCfWzPuIjheqdsfcEfqumsi8ZGav6vR,SpATywNh6bZuzm8s1ceuBUnMUAeoAHHw,10,14,8,0,3,0,5,0,30,4.285714285714286,1,0.0,0,8,0,3,14,0,0,5,0,11,19,1
5262,105260,IK3mtf86eqab6u3Svud8svoyG25XbueY,SpATywNh6bZuzm8s1ceuBUnMUAeoAHHw,11,11,2,17,0,0,4,0,34,4.857142857142857,1,0.0,2,2,15,0,9,0,2,4,0,19,15,1
5263,105262,47V3QOKZAFRfMjY5qh3dGgU05qgUrwzk,SpATywNh6bZuzm8s1ceuBUnMUAeoAHHw,10,15,7,13,2,11,6,0,54,7.714285714285714,2,0.0,3,7,12,2,12,11,1,6,0,24,30,0
5264,105269,Kbp64JoaypwT9V2b1Sun21o5uQW5G9la,SpATywNh6bZuzm8s1ceuBUnMUAeoAHHw,6,3,2,0,2,0,1,0,8,1.1428571428571428,1,0.0,0,2,0,2,3,0,0,1,0,4,4,1
5265,105271,b1VyhJSDHv0QJ3rH7siQ8iNr5JEetUc9,RXDvfPUBYFlVdlueBFbLW0mhhAyGEqpt,14,35,10,0,7,1,7,1,61,8.714285714285714,1,0.0,13,10,0,7,22,1,0,7,1,30,31,1
5266,105274,6nb23dYhCIP1cVQ6kR327mxTR7zAmW6A,SpATywNh6bZuzm8s1ceuBUnMUAeoAHHw,5,2,1,0,1,0,2,0,6,0.8571428571428571,1,0.0,0,1,0,1,2,0,0,2,0,2,4,1
5267,105306,drUu3tyovHqnF7EAaPHayHDYbWMe2Od6,bWdj2GDclj5ofokWjzoa5jAwMkxCykd6,1,0,0,0,0,0,1,0,1,0.14285714285714285,1,0.0,0,0,0,0,0,0,0,1,0,0,1,1
5268,105322,CSp8QkNZa6B12LzJipxPFgC5w6lKLtbn,SpATywNh6bZuzm8s1ceuBUnMUAeoAHHw,1,0,0,0,0,0,1,0,1,0.14285714285714285,1,0.0,0,0,0,0,0,0,0,1,0,0,1,1
5269,105331,Sk4DUKJRImF6lijTnkABuH01jDj9zcnP,bWdj2GDclj5ofokWjzoa5jAwMkxCykd6,3,2,1,0,0,3,2,0,8,1.1428571428571428,1,0.0,0,1,0,0,2,3,0,2,0,1,7,1
5270,105347,CvSKLBTIxxGXbtAVP0WUmmB2Wsdsb6DU,SpATywNh6bZuzm8s1ceuBUnMUAeoAHHw,10,15,0,16,0,5,3,0,39,5.571428571428571,1,0.0,3,0,14,0,12,5,2,3,0,17,22,0
5271,105360,OWE34kkoT9KAMAmKtdn3UxQ37r5Vj3AT,SpATywNh6bZuzm8s1ceuBUnMUAeoAHHw,7,5,0,0,0,0,2,0,7,1.0,1,0.0,0,0,0,0,5,0,0,2,0,0,7,1
5272,105365,4ReTrx0DPSKofx7nLibnDMfTITGlbh8n,SpATywNh6bZuzm8s1ceuBUnMUAeoAHHw,5,2,1,0,1,0,2,0,6,0.8571428571428571,1,0.0,0,1,0,1,2,0,0,2,0,2,4,1
5273,105366,dcPEtQ1aJsWPQvIFxgPvwR3ekqBX6ZB0,SpATywNh6bZuzm8s1ceuBUnMUAeoAHHw,1,0,0,0,0,0,1,0,1,0.14285714285714285,1,0.0,0,0,0,0,0,0,0,1,0,0,1,1
5274,105375,4Z0DzzRnG5ol9npBuWMZsHzI0G7yrdgb,SpATywNh6bZuzm8s1ceuBUnMUAeoAHHw,1,0,0,0,0,0,1,0,1,0.14285714285714285,1,0.0,0,0,0,0,0,0,0,1,0,0,1,1
5275,105377,ugyzx2kY0haeVd2DKPlWf2u8TPvIWwdG,SpATywNh6bZuzm8s1ceuBUnMUAeoAHHw,10,8,6,0,3,1,6,1,25,3.5714285714285716,1,0.0,0,6,0,3,8,1,0,6,1,9,16,1
5276,105382,OBVOXM1wUEgaM1Ic1TPHZnmgDHa3Iw3E,SpATywNh6bZuzm8s1ceuBUnMUAeoAHHw,5,2,1,0,1,0,2,0,6,0.8571428571428571,1,0.0,0,1,0,1,2,0,0,2,0,2,4,1
5277,105405,itFrYwUUr3TPc7mZS2RWfo2HaYAcNOxB,SpATywNh6bZuzm8s1ceuBUnMUAeoAHHw,15,13,6,13,4,1,9,0,46,6.571428571428571,1,0.0,4,6,12,4,9,1,1,9,0,26,20,1
5278,105409,vqSgORDp5PsEpveQVJoPh4dnJvR6AQkK,bWdj2GDclj5ofokWjzoa5jAwMkxCykd6,1,0,0,0,0,0,1,0,1,0.14285714285714285,1,0.0,0,0,0,0,0,0,0,1,0,0,1,1
5279,105412,6d0wTeGZDr0ncgCyWQX4AMn46gB2ZbPz,bWdj2GDclj5ofokWjzoa5jAwMkxCykd6,6,2,1,0,1,0,3,0,7,1.0,1,0.0,0,1,0,1,2,0,0,3,0,2,5,1
5280,105413,uTHtFLFEH5oi1Mhz7WcXFhd8fnlKyBlD,SpATywNh6bZuzm8s1ceuBUnMUAeoAHHw,11,10,6,0,4,0,2,0,22,3.142857142857143,1,0.0,1,6,0,4,9,0,0,2,0,11,11,1
5281,105431,7bBbNS8igBUmtAlhgWeyPaLpz7A08m0l,A3fsA9Zfv1X2fVEQhTw51lKENdNrEqT3,6,6,4,0,1,0,4,0,15,2.142857142857143,2,0.0,0,4,0,1,6,0,0,4,0,5,10,1
5282,105432,1cSsz0UCfa4Sky1FhbU6sbIRYsZ41OPL,A3fsA9Zfv1X2fVEQhTw51lKENdNrEqT3,20,28,1,38,0,2,24,4,97,13.857142857142858,1,0.0,0,1,32,0,28,2,6,24,4,33,64,1
5283,105439,jmHt2ZlvXO3qz2cHf72G06suxgziLa3C,A3fsA9Zfv1X2fVEQhTw51lKENdNrEqT3,2,0,0,0,0,0,2,0,2,0.2857142857142857,1,0.0,0,0,0,0,0,0,0,2,0,0,2,1
5284,105445,LdIFMEp4Gma3xMuOQ2mpp1BJ3jFvB9c2,bWdj2GDclj5ofokWjzoa5jAwMkxCykd6,16,38,12,36,7,0,12,0,105,15.0,4,0.0,12,12,29,7,26,0,7,12,0,60,45,0
5285,105451,1YSmilr2ajm5pFk4iAawwfB3mRapy4GR,bWdj2GDclj5ofokWjzoa5jAwMkxCykd6,4,2,1,0,1,0,1,0,5,0.7142857142857143,1,0.0,0,1,0,1,2,0,0,1,0,2,3,1
5286,105453,FNaEworzG9JIrUWWqoqtljEERNazKuKb,SpATywNh6bZuzm8s1ceuBUnMUAeoAHHw,6,3,1,0,1,0,2,0,7,1.0,1,0.0,0,1,0,1,3,0,0,2,0,2,5,1
5287,105454,EK81RbZoXEDM3g1RV68PHuRhq28X4Rfk,A3fsA9Zfv1X2fVEQhTw51lKENdNrEqT3,5,2,1,0,1,0,2,0,6,0.8571428571428571,1,0.0,0,1,0,1,2,0,0,2,0,2,4,1
5288,105464,rc8mOopKEVh5BHf3pFrEDGrzFcNfbS3h,SpATywNh6bZuzm8s1ceuBUnMUAeoAHHw,5,2,1,0,1,0,3,0,7,1.0,2,0.0,0,1,0,1,2,0,0,3,0,2,5,1
5289,105471,DIfj5Ba2axfDE4LFDWqKjVBCgesW8XXW,SpATywNh6bZuzm8s1ceuBUnMUAeoAHHw,12,36,8,0,2,3,8,0,57,8.142857142857142,1,0.0,0,8,0,2,36,3,0,8,0,10,47,1
5290,105479,DRqM6Ff42uz4k14OFxcFjetTXyC12WI7,SpATywNh6bZuzm8s1ceuBUnMUAeoAHHw,9,11,1,7,1,0,4,0,24,3.4285714285714284,2,0.0,0,1,6,1,11,0,1,4,0,8,16,1
5291,105480,RSwFpC1qMeXR2lSJtCkUxC2GY1HkPGdb,SpATywNh6bZuzm8s1ceuBUnMUAeoAHHw,9,10,6,0,3,0,3,0,22,3.142857142857143,2,0.0,1,6,0,3,9,0,0,3,0,10,12,1
5292,105491,QKXQzGYic4FsMmW8FpleZuFU3phntMAt,SpATywNh6bZuzm8s1ceuBUnMUAeoAHHw,8,4,3,0,3,0,1,0,11,1.5714285714285714,1,0.0,0,3,0,3,4,0,0,1,0,6,5,0
5293,105497,ouzFxiP7ljIzym1OgbkkNZsSGwRWOJRH,SpATywNh6bZuzm8s1ceuBUnMUAeoAHHw,5,2,1,0,1,0,2,0,6,0.8571428571428571,1,0.0,0,1,0,1,2,0,0,2,0,2,4,1
5294,105507,3xA82OlUzQ8FfAlTJcvVktSt0q894DXz,A3fsA9Zfv1X2fVEQhTw51lKENdNrEqT3,9,4,3,0,2,0,3,0,12,1.7142857142857142,1,0.0,0,3,0,2,4,0,0,3,0,5,7,1
5295,105513,huQkoBKNhxQg56EbGDFifh0dLnvHtGe7,SpATywNh6bZuzm8s1ceuBUnMUAeoAHHw,16,13,5,10,3,7,7,2,47,6.714285714285714,1,0.0,7,5,9,3,6,7,1,7,2,24,23,1
5296,105514,pb0NolqZsXAL2OR3XPD1zckdYQxFlvNU,SpATywNh6bZuzm8s1ceuBUnMUAeoAHHw,5,2,1,0,1,0,4,0,8,1.1428571428571428,1,0.0,0,1,0,1,2,0,0,4,0,2,6,1
5297,105526,dBYXiPq5rGdb4oW5xYaPd7zkgh6w8ny5,SpATywNh6bZuzm8s1ceuBUnMUAeoAHHw,3,3,0,0,0,0,1,0,4,0.5714285714285714,1,0.0,0,0,0,0,3,0,0,1,0,0,4,1
5298,105528,Gs4A8cx631DBKRtaVJfbdm1OgfYfhvQ8,A3fsA9Zfv1X2fVEQhTw51lKENdNrEqT3,2,0,0,0,0,0,2,0,2,0.2857142857142857,1,0.0,0,0,0,0,0,0,0,2,0,0,2,1
5299,105532,YBSh2Ce8VFxfjfLxt9dOr0DLrvgLDo3G,SpATywNh6bZuzm8s1ceuBUnMUAeoAHHw,4,3,1,0,1,0,1,0,6,0.8571428571428571,1,0.0,0,1,0,1,3,0,0,1,0,2,4,1
5300,105538,JFR1iuUdFS1mD5BLqLO5DI7ZsHM5MIC6,SpATywNh6bZuzm8s1ceuBUnMUAeoAHHw,2,0,0,0,0,0,2,0,2,0.2857142857142857,1,0.0,0,0,0,0,0,0,0,2,0,0,2,1
5301,105543,JFR1iuUdFS1mD5BLqLO5DI7ZsHM5MIC6,bWdj2GDclj5ofokWjzoa5jAwMkxCykd6,2,0,0,0,0,0,2,0,2,0.2857142857142857,1,0.0,0,0,0,0,0,0,0,2,0,0,2,0
5302,105549,2OnJKTPobGmyM9bjszCwLbDBhhcw3Ptr,SpATywNh6bZuzm8s1ceuBUnMUAeoAHHw,6,4,2,0,1,0,4,0,11,1.5714285714285714,1,0.0,0,2,0,1,4,0,0,4,0,3,8,1
5303,105560,TBhSGbYkj43z5s2FElhR2mY8V29OFGOl,SpATywNh6bZuzm8s1ceuBUnMUAeoAHHw,9,12,4,14,1,8,1,0,40,5.714285714285714,1,0.0,7,4,12,1,5,8,2,1,0,24,16,1
5304,105564,a160ewxyRJdtN45GnX3uGxkLMyeZKvV7,A3fsA9Zfv1X2fVEQhTw51lKENdNrEqT3,5,3,2,0,1,0,1,0,7,1.0,1,0.0,0,2,0,1,3,0,0,1,0,3,4,1
5305,105572,i1rf4Uc8Jyx4GInthodWWBcAxWOUsNY3,SpATywNh6bZuzm8s1ceuBUnMUAeoAHHw,1,0,0,0,0,0,1,0,1,0.14285714285714285,1,0.0,0,0,0,0,0,0,0,1,0,0,1,1
5306,105578,UZSpGopByMz4vpZWWp6YjynYHDg7IDCz,SpATywNh6bZuzm8s1ceuBUnMUAeoAHHw,7,3,0,0,0,1,7,2,13,1.8571428571428572,1,0.0,0,0,0,0,3,1,0,7,2,0,13,1
5307,105603,U5SVBnEdwM8cChRjcz152ZJPSF8LRTgS,SpATywNh6bZuzm8s1ceuBUnMUAeoAHHw,17,23,12,15,6,10,4,0,70,10.0,1,0.0,10,12,12,6,13,10,3,4,0,40,30,1
5308,105605,vqN40E2i0C3fLg1fxObrFNN6aBFCAnYS,SpATywNh6bZuzm8s1ceuBUnMUAeoAHHw,4,2,1,0,1,0,1,0,5,0.7142857142857143,1,0.0,0,1,0,1,2,0,0,1,0,2,3,1
5309,105615,yt2gjsEupK8sBRyKpoF6RM4kG7zfvxKC,SpATywNh6bZuzm8s1ceuBUnMUAeoAHHw,17,42,11,22,2,9,11,2,99,14.142857142857142,3,0.0,23,11,21,2,19,9,1,11,2,57,42,0
5310,105618,UR2QSgawy0CjHWh1ilXf2hWdYdvRIm7a,A3fsA9Zfv1X2fVEQhTw51lKENdNrEqT3,1,0,0,0,0,0,1,0,1,0.14285714285714285,1,0.0,0,0,0,0,0,0,0,1,0,0,1,1
5311,105622,jkI0zARZWQkZpKjEUfCP0wADmuTyrZSB,A3fsA9Zfv1X2fVEQhTw51lKENdNrEqT3,12,11,2,0,2,0,4,0,19,2.7142857142857144,1,0.0,0,2,0,2,11,0,0,4,0,4,15,1
5312,105627,5uQhTmVLlxOLiyKyZlkmRhPs99pj5h4D,SpATywNh6bZuzm8s1ceuBUnMUAeoAHHw,7,3,2,0,2,0,2,0,9,1.2857142857142858,1,0.0,0,2,0,2,3,0,0,2,0,4,5,1
5313,105633,No3uaZVX8QfUWi2WuoYFYrVrLQNiuZit,SpATywNh6bZuzm8s1ceuBUnMUAeoAHHw,4,2,1,0,1,0,1,0,5,0.7142857142857143,1,0.0,0,1,0,1,2,0,0,1,0,2,3,1
5314,105634,6YparlTvGntzzoJlcpXRHjZMmqjae5pt,SpATywNh6bZuzm8s1ceuBUnMUAeoAHHw,14,7,5,2,3,7,7,1,32,4.571428571428571,1,0.0,0,5,2,3,7,7,0,7,1,10,22,1
5315,105640,gw3yc6n6VFyWcEZvOt8ZtzcLtuPxALTw,SpATywNh6bZuzm8s1ceuBUnMUAeoAHHw,14,25,11,19,0,21,16,1,93,13.285714285714286,4,0.0,8,11,16,0,17,21,3,16,1,35,58,1
5316,105645,jcprw7R15XocpeKMqxQA9O1OxKgjloTM,SpATywNh6bZuzm8s1ceuBUnMUAeoAHHw,1,0,0,0,0,0,1,0,1,0.14285714285714285,1,0.0,0,0,0,0,0,0,0,1,0,0,1,1
5317,105654,YpnxbgvlHOSkecYk2lPrRwAg5SZiWPmr,A3fsA9Zfv1X2fVEQhTw51lKENdNrEqT3,5,2,1,0,1,0,2,0,6,0.8571428571428571,1,0.0,0,1,0,1,2,0,0,2,0,2,4,1
5318,105668,7KQcIrOp3KoypOTvziMED7rHtDH1CXtE,A3fsA9Zfv1X2fVEQhTw51lKENdNrEqT3,1,0,0,0,0,0,1,0,1,0.14285714285714285,1,0.0,0,0,0,0,0,0,0,1,0,0,1,1
5319,105671,wpA3YODDDsWaFQtfPR7v2M6HEJbcAeIY,SpATywNh6bZuzm8s1ceuBUnMUAeoAHHw,5,5,1,0,0,0,3,0,9,1.2857142857142858,2,0.0,0,1,0,0,5,0,0,3,0,1,8,1
5320,105672,V02ryEmMmqjGIIiLHIkYu0vvVMLeyKKP,A3fsA9Zfv1X2fVEQhTw51lKENdNrEqT3,8,4,2,0,2,0,2,0,10,1.4285714285714286,1,0.0,0,2,0,2,4,0,0,2,0,4,6,1
5321,105677,tbzj7Go70gnZDKKkB7OUY9ROk4h4NATx,bWdj2GDclj5ofokWjzoa5jAwMkxCykd6,6,4,2,0,1,0,4,0,11,1.5714285714285714,1,0.0,0,2,0,1,4,0,0,4,0,3,8,1
5322,105690,dCV7p4dH2mfgkfJtane8atsSzuvj1JQf,bWdj2GDclj5ofokWjzoa5jAwMkxCykd6,1,0,0,0,0,0,1,0,1,0.14285714285714285,1,0.0,0,0,0,0,0,0,0,1,0,0,1,1
5323,105699,hBWZaknNj3MZUvkhj5xTqflV3rTd1l4t,bWdj2GDclj5ofokWjzoa5jAwMkxCykd6,2,0,0,0,0,0,2,0,2,0.2857142857142857,1,0.0,0,0,0,0,0,0,0,2,0,0,2,1
5324,105703,xePykhVJ0RKvBcesQ9TJJOkbxCOkEY1s,SpATywNh6bZuzm8s1ceuBUnMUAeoAHHw,4,0,0,0,0,3,3,0,6,0.8571428571428571,2,0.0,0,0,0,0,0,3,0,3,0,0,6,1
5325,105713,RHNP6ku8FrLIdJ9UJ6RZ5wmeyQgTyWsO,A3fsA9Zfv1X2fVEQhTw51lKENdNrEqT3,1,0,0,0,0,0,2,0,2,0.2857142857142857,1,0.0,0,0,0,0,0,0,0,2,0,0,2,1
5326,105746,szmVnhPypUPoSdN8Z8D02a6M8Gjrnwmf,7GRhBDsirIGkRZBtSMEzNTyDr2JQm4xx,4,2,1,0,1,0,1,0,5,0.7142857142857143,1,0.0,0,1,0,1,2,0,0,1,0,2,3,1
5327,105767,mjObtvp4vmduPSr2e6gxrQuYRjgGF8wF,7GRhBDsirIGkRZBtSMEzNTyDr2JQm4xx,11,11,6,0,5,2,1,0,25,3.5714285714285716,1,0.0,4,6,0,5,7,2,0,1,0,15,10,0
5328,106408,3C0RNflDAI8FmTdsE1mhjUkpDZ4xUri7,SpATywNh6bZuzm8s1ceuBUnMUAeoAHHw,1,0,0,0,0,0,1,0,1,0.14285714285714285,1,0.0,0,0,0,0,0,0,0,1,0,0,1,1
5329,106443,t3vj4r7JOWedUjNWDPc1a4izv1Cmnqwm,RXDvfPUBYFlVdlueBFbLW0mhhAyGEqpt,1,0,0,0,0,0,1,0,1,0.14285714285714285,1,0.0,0,0,0,0,0,0,0,1,0,0,1,1
5330,106591,rxfzVJVj4XNymQN7SX1pdLUM549NCrW7,SpATywNh6bZuzm8s1ceuBUnMUAeoAHHw,6,5,3,0,1,0,3,0,12,1.7142857142857142,2,0.0,0,3,0,1,5,0,0,3,0,4,8,0
5331,106650,GebdA7Vo87ReyKP2A7BXi3CttXQIgfXb,SpATywNh6bZuzm8s1ceuBUnMUAeoAHHw,5,3,1,0,0,0,4,0,8,1.1428571428571428,1,0.0,0,1,0,0,3,0,0,4,0,1,7,1
5332,106698,AuIQbwKCl1rpgmIzQXLySneETBtGUcy9,SpATywNh6bZuzm8s1ceuBUnMUAeoAHHw,9,15,2,0,3,0,2,0,22,3.142857142857143,2,0.0,2,2,0,3,13,0,0,2,0,7,15,1
5333,106710,2sYGHfb0Gpw1ITIdkhTs2jjyBEZU4HAF,SpATywNh6bZuzm8s1ceuBUnMUAeoAHHw,4,2,0,0,0,0,4,0,6,0.8571428571428571,1,0.0,0,0,0,0,2,0,0,4,0,0,6,1
5334,106724,LBz8eebDA0q3o7gWfqXlzvsHwwqTUJzd,SpATywNh6bZuzm8s1ceuBUnMUAeoAHHw,7,14,0,0,0,0,3,1,18,2.5714285714285716,1,0.0,0,0,0,0,14,0,0,3,1,0,18,0
5335,106858,wwFNSVNavy53ZZLg1TQ0hM4pFCmqfiLF,A3fsA9Zfv1X2fVEQhTw51lKENdNrEqT3,5,2,1,0,1,0,3,0,7,1.0,1,0.0,0,1,0,1,2,0,0,3,0,2,5,0
5336,106906,myNTp931AmSPRA2kl8memATVLQzx4fxs,SpATywNh6bZuzm8s1ceuBUnMUAeoAHHw,11,11,3,8,0,0,3,0,25,3.5714285714285716,1,0.0,5,3,8,0,6,0,0,3,0,16,9,1
5337,106940,NKTsGtocSBmn1p0LL8TfbQ17Oh6XvCt3,SpATywNh6bZuzm8s1ceuBUnMUAeoAHHw,14,44,2,27,0,71,19,4,167,23.857142857142858,4,0.0,19,2,21,0,25,71,6,19,4,42,125,0
5338,107974,dtVsNki5zywoboI6DGdzIRSljGsEQsRE,SpATywNh6bZuzm8s1ceuBUnMUAeoAHHw,7,6,1,0,1,0,3,0,11,1.5714285714285714,1,0.0,0,1,0,1,6,0,0,3,0,2,9,1
5339,107980,lOPfkJTjHU0xkFfC9CIvobXcPYmnNHom,SpATywNh6bZuzm8s1ceuBUnMUAeoAHHw,15,22,14,10,4,0,9,0,59,8.428571428571429,2,0.0,4,14,9,4,18,0,1,9,0,31,28,0
5340,107985,3zcQqBSlndQvb088xX2bWzjwjrK9gGXb,SpATywNh6bZuzm8s1ceuBUnMUAeoAHHw,13,23,0,21,0,2,4,0,50,7.142857142857143,1,0.0,6,0,20,0,17,2,1,4,0,26,24,1
5341,107989,ilWzYGLWBh9DSc1MV8g2C4Go5wDNgUHX,RXDvfPUBYFlVdlueBFbLW0mhhAyGEqpt,1,0,0,0,0,0,1,0,1,0.14285714285714285,1,0.0,0,0,0,0,0,0,0,1,0,0,1,1
5342,108004,6oCIsm9feSmMCAtwRcz7U3xMlVdQPmgW,SpATywNh6bZuzm8s1ceuBUnMUAeoAHHw,6,3,1,0,1,0,2,0,7,1.0,1,0.0,0,1,0,1,3,0,0,2,0,2,5,1
5343,108008,7JBtUpIhUnYCA4q3ae7hJoTZvMtE4cUd,SpATywNh6bZuzm8s1ceuBUnMUAeoAHHw,15,35,9,3,4,1,9,1,62,8.857142857142858,4,0.0,2,9,3,4,33,1,0,9,1,18,44,1
5344,108022,PouZmZXexxytkMLV0zJhqCjIk5MXfiuJ,SpATywNh6bZuzm8s1ceuBUnMUAeoAHHw,17,18,7,21,4,17,6,2,75,10.714285714285714,1,0.0,8,7,17,4,10,17,4,6,2,36,39,1
5345,108028,bDxjtNxv0fWJdWWEfRKEUv4YBma9IgaW,SpATywNh6bZuzm8s1ceuBUnMUAeoAHHw,15,18,8,18,4,5,12,1,66,9.428571428571429,2,0.0,4,8,16,4,14,5,2,12,1,32,34,1
5346,108043,e2g6ypvlbdTJJDNt2jr7tkCU179qUmrV,SpATywNh6bZuzm8s1ceuBUnMUAeoAHHw,1,0,0,0,0,0,1,0,1,0.14285714285714285,1,0.0,0,0,0,0,0,0,0,1,0,0,1,1
5347,108056,P6v79AbA8JNvvK6UNaNGagvsf7jk48sR,SpATywNh6bZuzm8s1ceuBUnMUAeoAHHw,5,2,1,0,1,0,2,0,6,0.8571428571428571,1,0.0,0,1,0,1,2,0,0,2,0,2,4,1
5348,108059,YHlbNc2DvzqJVtSUhFFwHv9LTYvtn9Mw,RXDvfPUBYFlVdlueBFbLW0mhhAyGEqpt,1,0,0,0,0,0,2,0,2,0.2857142857142857,1,0.0,0,0,0,0,0,0,0,2,0,0,2,1
5349,108063,FLuCisP22zuNYM50DiHloNWfjCL7Trqn,SpATywNh6bZuzm8s1ceuBUnMUAeoAHHw,7,7,2,0,1,0,3,0,13,1.8571428571428572,2,0.0,0,2,0,1,7,0,0,3,0,3,10,1
5350,108066,biPbQQgRZQFKOAVcr8zCs5vcz2Zp7TtR,SpATywNh6bZuzm8s1ceuBUnMUAeoAHHw,6,5,3,0,2,0,3,0,13,1.8571428571428572,1,0.0,0,3,0,2,5,0,0,3,0,5,8,1
5351,108067,7LgsB1Dbs9AWbCH4Qtqx9aZFnEle1djD,A3fsA9Zfv1X2fVEQhTw51lKENdNrEqT3,6,3,0,0,0,0,5,0,8,1.1428571428571428,1,0.0,0,0,0,0,3,0,0,5,0,0,8,1
5352,108068,521YJDVy6G9ul5QyLTUZAuztPLpe7gqW,A3fsA9Zfv1X2fVEQhTw51lKENdNrEqT3,8,4,2,0,0,4,10,0,20,2.857142857142857,1,0.0,1,2,0,0,3,4,0,10,0,3,17,1
5353,108075,EboqTOLce3Kcnbr13rePsINEM3noHrcD,A3fsA9Zfv1X2fVEQhTw51lKENdNrEqT3,8,4,3,0,3,0,1,0,11,1.5714285714285714,1,0.0,0,3,0,3,4,0,0,1,0,6,5,1
5354,108077,aiXR63FJxLzLjxOw200I9QHjcVwt5TEN,RXDvfPUBYFlVdlueBFbLW0mhhAyGEqpt,1,0,0,0,0,0,1,0,1,0.14285714285714285,1,0.0,0,0,0,0,0,0,0,1,0,0,1,1
5355,108080,KMcnmZ5Os9sw6KyJ7BWURh6K8QGi1wsV,bWdj2GDclj5ofokWjzoa5jAwMkxCykd6,8,6,1,0,2,0,3,0,12,1.7142857142857142,1,0.0,2,1,0,2,4,0,0,3,0,5,7,1
5356,108086,3pgK06P2oLAcnmiNZRznn0B0EGmUgMOP,SpATywNh6bZuzm8s1ceuBUnMUAeoAHHw,6,9,3,0,1,0,4,0,17,2.4285714285714284,1,0.0,0,3,0,1,9,0,0,4,0,4,13,1
5357,108100,KYKzKpnBUYOr84PudAmq8tNzhwmTGrJ8,A3fsA9Zfv1X2fVEQhTw51lKENdNrEqT3,10,5,3,0,2,1,6,1,18,2.5714285714285716,1,0.0,0,3,0,2,5,1,0,6,1,5,13,1
5358,108102,7aA6BrVZipLHOrozlrYBMEmfMq4MXahq,SpATywNh6bZuzm8s1ceuBUnMUAeoAHHw,4,6,0,0,0,0,2,0,8,1.1428571428571428,1,0.0,0,0,0,0,6,0,0,2,0,0,8,1
5359,108103,2jvZGTQOv5HI5u69PvJ98o1zG3YXhtLw,SpATywNh6bZuzm8s1ceuBUnMUAeoAHHw,12,12,4,11,2,1,2,0,32,4.571428571428571,1,0.0,6,4,10,2,6,1,1,2,0,22,10,1
5360,108114,sgggYhWjUONtSvJl6cytWZyV2XJXwrfv,RXDvfPUBYFlVdlueBFbLW0mhhAyGEqpt,1,0,0,0,0,0,1,0,1,0.14285714285714285,1,0.0,0,0,0,0,0,0,0,1,0,0,1,1
5361,108117,dpzYaESA6MCFHXGYe2bLHvSr1kNOP50p,bWdj2GDclj5ofokWjzoa5jAwMkxCykd6,1,0,0,0,0,0,1,0,1,0.14285714285714285,1,0.0,0,0,0,0,0,0,0,1,0,0,1,1
5362,108124,dpzYaESA6MCFHXGYe2bLHvSr1kNOP50p,RXDvfPUBYFlVdlueBFbLW0mhhAyGEqpt,1,0,0,0,0,0,1,0,1,0.14285714285714285,1,0.0,0,0,0,0,0,0,0,1,0,0,1,1
5363,108126,5vV5bz7iJVuZlu434ocQi0K0Vkr9Mwnk,bWdj2GDclj5ofokWjzoa5jAwMkxCykd6,4,2,0,0,0,0,4,0,6,0.8571428571428571,1,0.0,0,0,0,0,2,0,0,4,0,0,6,1
5364,108129,5vV5bz7iJVuZlu434ocQi0K0Vkr9Mwnk,A3fsA9Zfv1X2fVEQhTw51lKENdNrEqT3,2,0,0,0,0,0,3,0,3,0.42857142857142855,1,0.0,0,0,0,0,0,0,0,3,0,0,3,1
5365,108132,2w4cE1JaIeIFAZaP4jTngJpTehNnFzsI,G8EPVSXsOYB5YQWZGiz1aVq5Pgr2GrQu,4,2,0,0,0,0,2,0,4,0.5714285714285714,1,0.0,0,0,0,0,2,0,0,2,0,0,4,0
5366,108137,wKzEabDf6tGdNdSmhgTmVPwzaHM3HdDm,bWdj2GDclj5ofokWjzoa5jAwMkxCykd6,1,0,0,0,0,0,1,0,1,0.14285714285714285,1,0.0,0,0,0,0,0,0,0,1,0,0,1,1
5367,108140,wKzEabDf6tGdNdSmhgTmVPwzaHM3HdDm,A3fsA9Zfv1X2fVEQhTw51lKENdNrEqT3,1,0,0,0,0,0,1,0,1,0.14285714285714285,1,0.0,0,0,0,0,0,0,0,1,0,0,1,1
5368,108154,hbTx2HlAPaSfk5EORjF7ocOSpDhWinaD,G8EPVSXsOYB5YQWZGiz1aVq5Pgr2GrQu,8,16,8,0,5,0,14,0,43,6.142857142857143,3,0.0,2,8,0,5,14,0,0,14,0,15,28,0
5369,108178,vz93ZdWSu0NWsoHKFr8vIf7NHeIpZbfP,bWdj2GDclj5ofokWjzoa5jAwMkxCykd6,7,3,2,0,2,0,2,0,9,1.2857142857142858,1,0.0,0,2,0,2,3,0,0,2,0,4,5,1
5370,108187,TSPlBwReynnjQ2q72CnYFjLp85rX76cJ,A3fsA9Zfv1X2fVEQhTw51lKENdNrEqT3,2,0,0,0,0,0,2,0,2,0.2857142857142857,1,0.0,0,0,0,0,0,0,0,2,0,0,2,1
5371,108190,bGjzMxOC88rUacNGu6kshAaxdH2zKDK7,A3fsA9Zfv1X2fVEQhTw51lKENdNrEqT3,6,9,0,0,0,0,1,0,10,1.4285714285714286,1,0.0,0,0,0,0,9,0,0,1,0,0,10,1
5372,108213,zrXVmAXKkFc8iiWu8fCjaRvDc9MMQT2x,SpATywNh6bZuzm8s1ceuBUnMUAeoAHHw,4,2,1,0,1,0,1,0,5,0.7142857142857143,1,0.0,0,1,0,1,2,0,0,1,0,2,3,1
5373,108217,6In9aidJiz35UAmMIZUhwjQpPpqW4IPc,A3fsA9Zfv1X2fVEQhTw51lKENdNrEqT3,4,3,1,0,0,0,4,0,8,1.1428571428571428,1,0.0,0,1,0,0,3,0,0,4,0,1,7,1
5374,108228,6In9aidJiz35UAmMIZUhwjQpPpqW4IPc,bWdj2GDclj5ofokWjzoa5jAwMkxCykd6,2,0,0,0,0,0,2,0,2,0.2857142857142857,1,0.0,0,0,0,0,0,0,0,2,0,0,2,1
5375,108235,uGnwUJpu1DKiWsVPpyszxZyMbYFsrVu7,SpATywNh6bZuzm8s1ceuBUnMUAeoAHHw,10,9,3,11,2,4,2,0,31,4.428571428571429,1,0.0,5,3,11,2,4,4,0,2,0,21,10,0
5376,108247,JVwYgpbMnhyXKC0xUgsIj4AIloKjDOV1,A3fsA9Zfv1X2fVEQhTw51lKENdNrEqT3,2,0,0,0,0,0,2,0,2,0.2857142857142857,1,0.0,0,0,0,0,0,0,0,2,0,0,2,1
5377,108251,Exf9rFmbTdsimBjbWioKYnQ8NgdvC5jd,RXDvfPUBYFlVdlueBFbLW0mhhAyGEqpt,8,9,1,0,0,0,1,0,11,1.5714285714285714,1,0.0,0,1,0,0,9,0,0,1,0,1,10,1
5378,108256,D6COhDGqanxSpN5gApKicTTjeA66WqVe,SpATywNh6bZuzm8s1ceuBUnMUAeoAHHw,1,0,0,0,0,0,1,0,1,0.14285714285714285,1,0.0,0,0,0,0,0,0,0,1,0,0,1,1
5379,108262,BKTGezJoHjleu4tXARXtOL0EOZtL4wb9,bWdj2GDclj5ofokWjzoa5jAwMkxCykd6,3,3,1,0,0,0,1,0,5,0.7142857142857143,1,0.0,0,1,0,0,3,0,0,1,0,1,4,1
5380,108283,hmtOqZVjWQ6rLJb3YkFWytQIy20ogszh,A3fsA9Zfv1X2fVEQhTw51lKENdNrEqT3,5,2,1,0,1,0,3,0,7,1.0,1,0.0,0,1,0,1,2,0,0,3,0,2,5,1
5381,108289,uidhjEbrao8Ccg3eBjaALRRkH9i692Ay,RXDvfPUBYFlVdlueBFbLW0mhhAyGEqpt,1,0,0,0,0,0,1,0,1,0.14285714285714285,1,0.0,0,0,0,0,0,0,0,1,0,0,1,1
5382,108291,KEDl5eQRZ3KXdMwf0omOM9Nnx9xLsQXi,SpATywNh6bZuzm8s1ceuBUnMUAeoAHHw,4,2,0,0,0,0,3,0,5,0.7142857142857143,1,0.0,0,0,0,0,2,0,0,3,0,0,5,1
5383,108292,uux8SuQRwPqDOuP8QlaB5wBQy6rHdvqS,SpATywNh6bZuzm8s1ceuBUnMUAeoAHHw,5,3,1,0,1,4,2,0,11,1.5714285714285714,1,0.0,0,1,0,1,3,4,0,2,0,2,9,1
5384,108301,cLfffYpPluVkrQWrGySOJC5E8Pia7HHf,A3fsA9Zfv1X2fVEQhTw51lKENdNrEqT3,2,0,0,0,0,0,2,0,2,0.2857142857142857,1,0.0,0,0,0,0,0,0,0,2,0,0,2,1
5385,108307,dbPMzxs1MK4eXxSu7capyuymr7qmuT7h,G8EPVSXsOYB5YQWZGiz1aVq5Pgr2GrQu,8,14,5,0,4,0,4,0,27,3.857142857142857,1,0.0,0,5,0,4,14,0,0,4,0,9,18,1
5386,108319,yVtzjNm7Xgz14yjopuLvCh7VRZR9RBra,A3fsA9Zfv1X2fVEQhTw51lKENdNrEqT3,5,0,0,0,0,6,8,0,14,2.0,1,0.0,0,0,0,0,0,6,0,8,0,0,14,1
5387,108328,xzsuu7TKRpeInAyJlxSvMP3hCrOSGC3q,G8EPVSXsOYB5YQWZGiz1aVq5Pgr2GrQu,7,6,2,0,2,0,4,0,14,2.0,1,0.0,3,2,0,2,3,0,0,4,0,7,7,1
5388,108342,LWnw8PqIiH64F1iHRbOem9hLLYoUuhVp,SpATywNh6bZuzm8s1ceuBUnMUAeoAHHw,1,0,0,0,0,0,1,0,1,0.14285714285714285,1,0.0,0,0,0,0,0,0,0,1,0,0,1,1
5389,108349,YbIRWz7aGoZEJGOL5qUEZpXGM6vHAAAA,SpATywNh6bZuzm8s1ceuBUnMUAeoAHHw,7,3,2,0,2,0,2,0,9,1.2857142857142858,1,0.0,0,2,0,2,3,0,0,2,0,4,5,1
5390,108363,LSAqQ9qRJ6IA5mDIPLRj3aw5O17rNapz,SpATywNh6bZuzm8s1ceuBUnMUAeoAHHw,4,3,0,0,0,0,1,0,4,0.5714285714285714,1,0.0,0,0,0,0,3,0,0,1,0,0,4,1
5391,108369,ZelBFCiIf4nT2uZgj3xzub7opPstKtrk,SpATywNh6bZuzm8s1ceuBUnMUAeoAHHw,1,0,0,0,0,0,1,0,1,0.14285714285714285,1,0.0,0,0,0,0,0,0,0,1,0,0,1,1
5392,108382,GibLcUgLW0dAKrvBvyjm1UI7aEhY2EYI,SpATywNh6bZuzm8s1ceuBUnMUAeoAHHw,7,7,5,0,3,0,5,0,20,2.857142857142857,1,0.0,0,5,0,3,7,0,0,5,0,8,12,1
5393,108383,dgp1qm7PjXoVV4MjyzuvWetQrJ3T9kos,SpATywNh6bZuzm8s1ceuBUnMUAeoAHHw,1,0,0,0,0,0,1,0,1,0.14285714285714285,1,0.0,0,0,0,0,0,0,0,1,0,0,1,1
5394,108384,HErgZ4jawN9YK19iQGOcyzXBTFaOouqG,bWdj2GDclj5ofokWjzoa5jAwMkxCykd6,7,4,3,0,3,0,2,0,12,1.7142857142857142,1,0.0,0,3,0,3,4,0,0,2,0,6,6,1
5395,108386,eBckG9AVr6bIBOpezfRr2S1KzQMM7OtD,G8EPVSXsOYB5YQWZGiz1aVq5Pgr2GrQu,14,14,10,0,7,2,6,1,40,5.714285714285714,1,0.0,0,10,0,7,14,2,0,6,1,17,23,0
5396,108388,M5VVteWQySX3L3J4dk5RJz0FGibCUyC6,SpATywNh6bZuzm8s1ceuBUnMUAeoAHHw,1,0,0,0,0,0,2,0,2,0.2857142857142857,1,0.0,0,0,0,0,0,0,0,2,0,0,2,1
5397,108444,slbuLFnaQZJ34dE8jfJqWtRl7JJLBe8u,SpATywNh6bZuzm8s1ceuBUnMUAeoAHHw,8,7,4,0,2,0,3,0,16,2.2857142857142856,1,0.0,0,4,0,2,7,0,0,3,0,6,10,1
5398,108472,AVjxFBCViTyDwpTqU42MWgJe18swM9dv,A3fsA9Zfv1X2fVEQhTw51lKENdNrEqT3,1,0,0,0,0,0,1,0,1,0.14285714285714285,1,0.0,0,0,0,0,0,0,0,1,0,0,1,1
5399,108477,0utD2vP6cBRtrip5Htxbgl8CGlMSWQLX,bWdj2GDclj5ofokWjzoa5jAwMkxCykd6,7,4,1,0,2,31,5,0,43,6.142857142857143,1,0.0,3,1,0,2,1,31,0,5,0,6,37,1
5400,108489,HBfe50okXo4yGURKfz5xhaX3ToIkoF7Q,A3fsA9Zfv1X2fVEQhTw51lKENdNrEqT3,13,12,6,0,2,5,7,1,33,4.714285714285714,1,0.0,0,6,0,2,12,5,0,7,1,8,25,1
5401,108497,FtVfxMAHOJCihrndIwrct9vQdb6Q44Wo,A3fsA9Zfv1X2fVEQhTw51lKENdNrEqT3,6,0,0,0,0,1,12,2,15,2.142857142857143,1,0.0,0,0,0,0,0,1,0,12,2,0,15,1
5402,108502,DfCpxv5XAI5uu8kT5xePLzsIgRboevuL,bWdj2GDclj5ofokWjzoa5jAwMkxCykd6,4,2,0,0,0,1,4,0,7,1.0,1,0.0,0,0,0,0,2,1,0,4,0,0,7,1
5403,108527,zbpyeHVfqJFGdhXASTaYNBrzQldiaNac,RXDvfPUBYFlVdlueBFbLW0mhhAyGEqpt,1,0,0,0,0,0,1,0,1,0.14285714285714285,1,0.0,0,0,0,0,0,0,0,1,0,0,1,1
5404,108530,vZzTgGwK0cR24BSm1xzdfANP52hj4iMk,SpATywNh6bZuzm8s1ceuBUnMUAeoAHHw,2,0,0,0,0,0,2,0,2,0.2857142857142857,1,0.0,0,0,0,0,0,0,0,2,0,0,2,1
5405,108537,CZVgFr3TEx4eVQgnanHCgaKUvWrCxqq0,bWdj2GDclj5ofokWjzoa5jAwMkxCykd6,1,0,0,0,0,0,1,0,1,0.14285714285714285,1,0.0,0,0,0,0,0,0,0,1,0,0,1,1
5406,108561,cJebZdZYNfcRFrDILULKtUjsVZucvQNZ,bWdj2GDclj5ofokWjzoa5jAwMkxCykd6,1,0,0,0,0,0,1,0,1,0.14285714285714285,1,0.0,0,0,0,0,0,0,0,1,0,0,1,1
5407,108566,ojqlaWuS8RKsQp5vm29IP0i1rlepDfW4,SpATywNh6bZuzm8s1ceuBUnMUAeoAHHw,9,7,3,0,1,0,5,0,16,2.2857142857142856,2,0.0,0,3,0,1,7,0,0,5,0,4,12,1
5408,108579,CppQWIoYRvNJi8vbZRpDyWKb0nwHtu8o,SpATywNh6bZuzm8s1ceuBUnMUAeoAHHw,8,9,3,0,1,0,3,0,16,2.2857142857142856,1,0.0,0,3,0,1,9,0,0,3,0,4,12,1
5409,108586,zGoXWftPbgMoerOVXBTD4diPBqy753pp,SpATywNh6bZuzm8s1ceuBUnMUAeoAHHw,14,16,8,11,0,2,10,1,48,6.857142857142857,2,0.0,4,8,10,0,12,2,1,10,1,22,26,1
5410,108588,anqtRE1JbVfWjk9aVYgpNXBcTCoFe9WO,RXDvfPUBYFlVdlueBFbLW0mhhAyGEqpt,1,0,0,0,0,0,1,0,1,0.14285714285714285,1,0.0,0,0,0,0,0,0,0,1,0,0,1,1
5411,108598,imxSDm2buzZ62mNMbQHQ2TU94JYpOhZs,A3fsA9Zfv1X2fVEQhTw51lKENdNrEqT3,2,0,0,0,0,0,2,0,2,0.2857142857142857,1,0.0,0,0,0,0,0,0,0,2,0,0,2,1
5412,108606,l1knNMDAAaNYCbUzngkK8zi8ibAxSEhp,SpATywNh6bZuzm8s1ceuBUnMUAeoAHHw,1,0,0,0,0,0,1,0,1,0.14285714285714285,1,0.0,0,0,0,0,0,0,0,1,0,0,1,1
5413,108614,QNTRCRLtlkIMOKaNSTyyYSuzmrMmUnRO,SpATywNh6bZuzm8s1ceuBUnMUAeoAHHw,11,12,1,17,0,0,2,0,32,4.571428571428571,1,0.0,2,1,14,0,10,0,3,2,0,17,15,1
5414,108616,9Em7ZIIQKauUvueNLPgAUpkXgxbNUW1r,A3fsA9Zfv1X2fVEQhTw51lKENdNrEqT3,16,17,7,0,6,0,6,0,36,5.142857142857143,1,0.0,0,7,0,6,17,0,0,6,0,13,23,1
5415,108620,5USBnLyMGXd4vW6kBwxN1Sg97co2qZq2,A3fsA9Zfv1X2fVEQhTw51lKENdNrEqT3,3,2,0,0,0,0,2,0,4,0.5714285714285714,1,0.0,0,0,0,0,2,0,0,2,0,0,4,1
5416,108622,QBPT1uwial7Y5XFWw81ordtuhoTMulQT,A3fsA9Zfv1X2fVEQhTw51lKENdNrEqT3,10,4,3,0,3,0,6,0,16,2.2857142857142856,1,0.0,0,3,0,3,4,0,0,6,0,6,10,1
5417,108623,vvgFtJK0OvK0nLiIcreYLk1PpU7Og3xn,A3fsA9Zfv1X2fVEQhTw51lKENdNrEqT3,6,1,1,0,1,0,5,0,8,1.1428571428571428,1,0.0,0,1,0,1,1,0,0,5,0,2,6,1
5418,108625,hi6YD0ZFgzDW7d6YNZOEVbYcZq8RBo6y,G8EPVSXsOYB5YQWZGiz1aVq5Pgr2GrQu,10,7,4,0,5,0,5,1,22,3.142857142857143,1,0.0,2,4,0,5,5,0,0,5,1,11,11,1
5419,108626,Pku6n7JNFwWSrlmN4ke1wEsgtvibhHUB,SpATywNh6bZuzm8s1ceuBUnMUAeoAHHw,7,4,1,0,1,0,3,0,9,1.2857142857142858,1,0.0,0,1,0,1,4,0,0,3,0,2,7,1
5420,108632,KCAa0nKBsiapAJL8hF3jy3WnrDUcaBRF,A3fsA9Zfv1X2fVEQhTw51lKENdNrEqT3,1,0,0,0,0,0,6,0,6,0.8571428571428571,1,0.0,0,0,0,0,0,0,0,6,0,0,6,1
5421,108646,WEWYd7NOLi6QToOgocTwXHUAGlncS3ka,A3fsA9Zfv1X2fVEQhTw51lKENdNrEqT3,6,7,1,0,1,0,3,0,12,1.7142857142857142,1,0.0,0,1,0,1,7,0,0,3,0,2,10,1
5422,108649,3R8N615p99BGAZXNRR4tu9I4dMAzyaYx,SpATywNh6bZuzm8s1ceuBUnMUAeoAHHw,10,6,6,0,6,0,3,0,21,3.0,1,0.0,0,6,0,6,6,0,0,3,0,12,9,1
5423,108651,LWFByRJk3azFmQgQM4UimOOGLsmXN342,A3fsA9Zfv1X2fVEQhTw51lKENdNrEqT3,1,0,0,0,0,0,3,0,3,0.42857142857142855,1,0.0,0,0,0,0,0,0,0,3,0,0,3,1
5424,108657,TxKyOi1lNIjE6GBf0G1VUEkgRaSNv5aU,bWdj2GDclj5ofokWjzoa5jAwMkxCykd6,5,2,1,0,1,0,2,0,6,0.8571428571428571,1,0.0,0,1,0,1,2,0,0,2,0,2,4,0
5425,108663,IVLYBILu5bsz4kc422I8sXYkTLjww3zh,SpATywNh6bZuzm8s1ceuBUnMUAeoAHHw,5,4,2,0,1,0,3,0,10,1.4285714285714286,1,0.0,0,2,0,1,4,0,0,3,0,3,7,1
5426,108666,wTFt4jd8Vf2XnbTwygw9m5uOggZGQW45,A3fsA9Zfv1X2fVEQhTw51lKENdNrEqT3,4,3,0,0,0,0,2,0,5,0.7142857142857143,1,0.0,0,0,0,0,3,0,0,2,0,0,5,1
5427,108671,uxgNKX0ZdDu87Z4mjH6KkxEGynnwur5T,A3fsA9Zfv1X2fVEQhTw51lKENdNrEqT3,3,4,0,0,0,0,2,0,6,0.8571428571428571,1,0.0,0,0,0,0,4,0,0,2,0,0,6,1
5428,108680,fihaFvHVK0WmjfjHHr8uDKIAQygBbKLV,A3fsA9Zfv1X2fVEQhTw51lKENdNrEqT3,1,0,0,0,0,0,1,0,1,0.14285714285714285,1,0.0,0,0,0,0,0,0,0,1,0,0,1,1
5429,108687,ABbPtVE9vR3q9TnGdVr0jhQS05eL9aJw,A3fsA9Zfv1X2fVEQhTw51lKENdNrEqT3,15,11,6,0,4,9,11,1,42,6.0,1,0.0,0,6,0,4,11,9,0,11,1,10,32,0
5430,108696,5Rbvag4nzKt7RfTqiThTliUWaR0ZVWak,bWdj2GDclj5ofokWjzoa5jAwMkxCykd6,14,23,13,22,8,4,11,1,82,11.714285714285714,1,0.0,7,13,21,8,16,4,1,11,1,49,33,1
5431,108697,6HIBebNSnNEoSeekVShzxF3x0IcbgohT,A3fsA9Zfv1X2fVEQhTw51lKENdNrEqT3,9,8,0,0,0,2,2,0,12,1.7142857142857142,1,0.0,1,0,0,0,7,2,0,2,0,1,11,1
5432,108708,5Rbvag4nzKt7RfTqiThTliUWaR0ZVWak,A3fsA9Zfv1X2fVEQhTw51lKENdNrEqT3,8,8,5,0,1,0,5,0,19,2.7142857142857144,1,0.0,2,5,0,1,6,0,0,5,0,8,11,1
5433,108719,WF6wuTvQFfQjN4sNbpLPNNaCItibHnsk,SpATywNh6bZuzm8s1ceuBUnMUAeoAHHw,5,2,1,0,1,0,2,0,6,0.8571428571428571,1,0.0,0,1,0,1,2,0,0,2,0,2,4,1
5434,108722,MSyG0cZLfbMN5GFb3dR5puqqT5uvCbhT,SpATywNh6bZuzm8s1ceuBUnMUAeoAHHw,6,1,1,0,1,0,3,0,6,0.8571428571428571,1,0.0,0,1,0,1,1,0,0,3,0,2,4,1
5435,108725,2qs5o4ShoJi8U8TmD1cNHDzshN8FK6oF,A3fsA9Zfv1X2fVEQhTw51lKENdNrEqT3,2,0,0,0,0,0,4,0,4,0.5714285714285714,1,0.0,0,0,0,0,0,0,0,4,0,0,4,1
5436,108728,I5y7gNrP5Yz8ZedoBMi3comUdlpFv5gJ,SpATywNh6bZuzm8s1ceuBUnMUAeoAHHw,3,2,0,0,0,0,1,0,3,0.42857142857142855,1,0.0,0,0,0,0,2,0,0,1,0,0,3,1
5437,108732,2Zhak41HpdUHgCzOLAuYT50kXg4d3Zji,G8EPVSXsOYB5YQWZGiz1aVq5Pgr2GrQu,5,2,1,0,1,0,2,0,6,0.8571428571428571,1,0.0,0,1,0,1,2,0,0,2,0,2,4,1
5438,108736,mFyBIO6GmLHqTEssxzuSwYKXW2BbEyYv,A3fsA9Zfv1X2fVEQhTw51lKENdNrEqT3,7,6,4,0,3,0,2,0,15,2.142857142857143,1,0.0,0,4,0,3,6,0,0,2,0,7,8,1
5439,108740,z8PlFZ3kRCGZCtReInG4syWyRUKvCeDo,RXDvfPUBYFlVdlueBFbLW0mhhAyGEqpt,40,44,1,127,11,1,6,1,191,27.285714285714285,1,0.0,27,1,120,11,17,1,7,6,1,159,32,0
5440,108741,8bMxud2pJnttNvsNwa7l9gc36Q1hRhIk,A3fsA9Zfv1X2fVEQhTw51lKENdNrEqT3,8,4,3,0,3,0,1,0,11,1.5714285714285714,1,0.0,0,3,0,3,4,0,0,1,0,6,5,1
5441,108748,ABbPtVE9vR3q9TnGdVr0jhQS05eL9aJw,bWdj2GDclj5ofokWjzoa5jAwMkxCykd6,6,2,1,0,1,0,3,0,7,1.0,1,0.0,0,1,0,1,2,0,0,3,0,2,5,1
5442,108756,h2bHu87wTYXhBBhcXbsLbNIYZ54rAZgt,A3fsA9Zfv1X2fVEQhTw51lKENdNrEqT3,45,38,27,84,19,7,14,1,190,27.142857142857142,1,0.0,4,27,74,19,34,7,10,14,1,124,66,1
5443,108765,wJC86gc3viBGM4vTuYg8647vhYAtlLLc,A3fsA9Zfv1X2fVEQhTw51lKENdNrEqT3,1,0,0,0,0,0,1,0,1,0.14285714285714285,1,0.0,0,0,0,0,0,0,0,1,0,0,1,1
5444,108766,sOb1oiy6NjSaiCXhGkHSqKHtlguCQRa0,A3fsA9Zfv1X2fVEQhTw51lKENdNrEqT3,1,0,0,0,0,0,1,0,1,0.14285714285714285,1,0.0,0,0,0,0,0,0,0,1,0,0,1,1
5445,108769,K1Izk0V4ksCL81zmOeuNNasAXwE95TLa,SpATywNh6bZuzm8s1ceuBUnMUAeoAHHw,1,0,0,0,0,0,2,0,2,0.2857142857142857,1,0.0,0,0,0,0,0,0,0,2,0,0,2,1
5446,108771,AvefCXcG5Ufaee9dlfNQnJvhOv3ejoZa,bWdj2GDclj5ofokWjzoa5jAwMkxCykd6,16,19,3,94,5,2,13,2,138,19.714285714285715,2,0.0,11,3,91,5,8,2,3,13,2,110,28,1
5447,108782,KdDp90RfX0ap0e8qJs31e2eGxlYje3er,A3fsA9Zfv1X2fVEQhTw51lKENdNrEqT3,40,25,11,96,10,0,4,0,146,20.857142857142858,1,0.0,3,11,83,10,22,0,13,4,0,107,39,1
5448,108786,ue5DigOvMG1l9Z3tvu2VwrvC8NR96FUy,SpATywNh6bZuzm8s1ceuBUnMUAeoAHHw,3,2,0,0,0,0,2,0,4,0.5714285714285714,1,0.0,0,0,0,0,2,0,0,2,0,0,4,1
5449,108787,x7jRdqJhx5ja6FBqxJnzxkapRPVQ2fNm,A3fsA9Zfv1X2fVEQhTw51lKENdNrEqT3,1,0,0,0,0,0,1,0,1,0.14285714285714285,1,0.0,0,0,0,0,0,0,0,1,0,0,1,1
5450,108789,AmjIDQe44ue5n1ufYmtWXDVGVMWDOkiz,A3fsA9Zfv1X2fVEQhTw51lKENdNrEqT3,3,3,0,0,0,0,1,0,4,0.5714285714285714,1,0.0,0,0,0,0,3,0,0,1,0,0,4,1
5451,108793,tn5nSlJLNdxx4Uni5Dn3S8nwDR8GJibq,A3fsA9Zfv1X2fVEQhTw51lKENdNrEqT3,14,7,5,0,3,1,7,1,24,3.4285714285714284,1,0.0,0,5,0,3,7,1,0,7,1,8,16,1
5452,108798,O12TpofOcB7jKUNGaL0IFXdieGzZ8DbW,SpATywNh6bZuzm8s1ceuBUnMUAeoAHHw,4,2,0,0,0,0,2,0,4,0.5714285714285714,1,0.0,0,0,0,0,2,0,0,2,0,0,4,1
5453,108799,J8izYPuHoJnyIb9qLV3GxLKVHOmNnyCQ,bWdj2GDclj5ofokWjzoa5jAwMkxCykd6,7,3,1,22,0,0,5,0,31,4.428571428571429,1,0.0,1,1,21,0,2,0,1,5,0,23,8,1
5454,108810,zcKuGtc5O9cMvHSHaVwufdFteCrEpUtA,A3fsA9Zfv1X2fVEQhTw51lKENdNrEqT3,15,14,10,0,8,4,2,0,38,5.428571428571429,2,0.0,0,10,0,8,14,4,0,2,0,18,20,1
5455,108835,NJrnUAVHenUfV0p23UPZO1ifAbb8gJ0p,SpATywNh6bZuzm8s1ceuBUnMUAeoAHHw,6,4,1,0,1,0,1,0,7,1.0,1,0.0,0,1,0,1,4,0,0,1,0,2,5,1
5456,108845,VBP5PzVQEKJYFH0y5ffEek5WfP9EW7uc,bWdj2GDclj5ofokWjzoa5jAwMkxCykd6,7,9,5,32,3,14,3,0,66,9.428571428571429,3,0.0,1,5,30,3,8,14,2,3,0,39,27,1
5457,108855,KQaABjEuQepl9FAcsVuUoYwnLleiOaUh,A3fsA9Zfv1X2fVEQhTw51lKENdNrEqT3,12,10,7,0,5,0,3,0,25,3.5714285714285716,1,0.0,0,7,0,5,10,0,0,3,0,12,13,1
5458,108856,AmiJtmcKc0Yc4REOzpITViIEZy1tcMgF,A3fsA9Zfv1X2fVEQhTw51lKENdNrEqT3,2,0,0,0,0,0,4,0,4,0.5714285714285714,1,0.0,0,0,0,0,0,0,0,4,0,0,4,1
5459,108857,XaYV3yff9o91oPBR4K32BeMm7Wg8wnLi,A3fsA9Zfv1X2fVEQhTw51lKENdNrEqT3,1,0,0,0,0,0,1,0,1,0.14285714285714285,1,0.0,0,0,0,0,0,0,0,1,0,0,1,1
5460,108869,4mtoRYC9jVVxEoNU8knjZ5oLeF7Lb02c,SpATywNh6bZuzm8s1ceuBUnMUAeoAHHw,5,8,0,0,0,0,2,0,10,1.4285714285714286,2,0.0,0,0,0,0,8,0,0,2,0,0,10,1
5461,108895,RGr3DE14hb7Ufb3qkxo2JnrYRs9POJfu,A3fsA9Zfv1X2fVEQhTw51lKENdNrEqT3,8,2,1,0,1,1,5,1,11,1.5714285714285714,1,0.0,0,1,0,1,2,1,0,5,1,2,9,1
5462,108904,5upQSO7J9z4uj80lVoIg3U6hUe3UwAJY,SpATywNh6bZuzm8s1ceuBUnMUAeoAHHw,2,0,0,0,0,0,2,0,2,0.2857142857142857,1,0.0,0,0,0,0,0,0,0,2,0,0,2,1
5463,108909,PIWGwmpuvT6lwwfSr4RWZP56tih9auMI,SpATywNh6bZuzm8s1ceuBUnMUAeoAHHw,8,5,1,0,1,0,3,0,10,1.4285714285714286,1,0.0,0,1,0,1,5,0,0,3,0,2,8,1
5464,108930,9vnJJcOjSmdwXe3BZQ5uEyhKgS7hqzyX,bWdj2GDclj5ofokWjzoa5jAwMkxCykd6,5,5,1,0,0,0,4,0,10,1.4285714285714286,1,0.0,0,1,0,0,5,0,0,4,0,1,9,1
5465,108946,xCHQAq5m2mtyQES4gfg6MjCHDUVD1J71,SpATywNh6bZuzm8s1ceuBUnMUAeoAHHw,6,7,1,0,0,0,2,0,10,1.4285714285714286,2,0.0,0,1,0,0,7,0,0,2,0,1,9,0
5466,108955,kLrl7hvNIzvhv6K321CFhgLYEgDfA62M,bWdj2GDclj5ofokWjzoa5jAwMkxCykd6,1,0,0,0,0,0,2,0,2,0.2857142857142857,1,0.0,0,0,0,0,0,0,0,2,0,0,2,1
5467,108960,g6loW2VoON94gkUidTjl3Rc73OlFLAiK,A3fsA9Zfv1X2fVEQhTw51lKENdNrEqT3,2,0,0,0,0,0,2,0,2,0.2857142857142857,1,0.0,0,0,0,0,0,0,0,2,0,0,2,0
5468,108961,xOpIfUll35xPHM6WEP4Czjw6kk2qoOGO,SpATywNh6bZuzm8s1ceuBUnMUAeoAHHw,5,7,4,0,3,0,4,0,18,2.5714285714285716,2,0.0,0,4,0,3,7,0,0,4,0,7,11,1
5469,108968,iRrv3nyo6BGr7ILpR2ahzmHKuzrYBh4I,SpATywNh6bZuzm8s1ceuBUnMUAeoAHHw,5,3,2,0,0,0,2,0,7,1.0,1,0.0,0,2,0,0,3,0,0,2,0,2,5,1
5470,108975,O5osNpvARQ134oncM7N5QGhst9sMjRtB,A3fsA9Zfv1X2fVEQhTw51lKENdNrEqT3,4,2,0,0,0,0,2,0,4,0.5714285714285714,1,0.0,0,0,0,0,2,0,0,2,0,0,4,1
5471,108989,i67qzouvUD7nINgK6d1xrH4pvufZqbFd,A3fsA9Zfv1X2fVEQhTw51lKENdNrEqT3,4,4,0,0,0,0,2,0,6,0.8571428571428571,1,0.0,0,0,0,0,4,0,0,2,0,0,6,0
5472,108990,OBplED2L50SmrdwVpOVn4VpcRjjudLK7,A3fsA9Zfv1X2fVEQhTw51lKENdNrEqT3,5,2,1,0,1,0,2,0,6,0.8571428571428571,1,0.0,0,1,0,1,2,0,0,2,0,2,4,1
5473,108993,SvKqfRpvSIeLIO42O4cF9tQtaigEgElY,A3fsA9Zfv1X2fVEQhTw51lKENdNrEqT3,7,6,2,0,2,0,2,0,12,1.7142857142857142,1,0.0,0,2,0,2,6,0,0,2,0,4,8,1
5474,108996,PhB6dZZRUCfcaCQkgFVOf4MMEPnUePaG,RXDvfPUBYFlVdlueBFbLW0mhhAyGEqpt,5,2,1,0,1,0,2,0,6,0.8571428571428571,1,0.0,0,1,0,1,2,0,0,2,0,2,4,1
5475,108999,3eJvDKkDryOUbJ3SYPy86iIynJcgnuci,SpATywNh6bZuzm8s1ceuBUnMUAeoAHHw,1,0,0,0,0,0,1,0,1,0.14285714285714285,1,0.0,0,0,0,0,0,0,0,1,0,0,1,1
5476,109002,qZCURwy8JtTyuwzOv8VNGZdlPKRFUQ4x,A3fsA9Zfv1X2fVEQhTw51lKENdNrEqT3,17,17,1,0,1,4,7,2,32,4.571428571428571,2,0.0,0,1,0,1,17,4,0,7,2,2,30,1
5477,109011,15KYq5P8DtSomIVrM0yWgXsvBsTL3cVz,A3fsA9Zfv1X2fVEQhTw51lKENdNrEqT3,9,5,4,0,4,0,3,0,16,2.2857142857142856,2,0.0,0,4,0,4,5,0,0,3,0,8,8,1
5478,109016,tJDZI9sjRcU2ZrvrdL12AwFT0OmQXIcr,A3fsA9Zfv1X2fVEQhTw51lKENdNrEqT3,5,2,1,0,1,0,4,0,8,1.1428571428571428,1,0.0,0,1,0,1,2,0,0,4,0,2,6,1
5479,109022,uJIh67cllxQLgAhipzdDZMEunDbuBxvF,bWdj2GDclj5ofokWjzoa5jAwMkxCykd6,1,0,0,0,0,0,1,0,1,0.14285714285714285,1,0.0,0,0,0,0,0,0,0,1,0,0,1,1
5480,109028,A1lWOqwgNzPh9AvybgvSnK3H60XpyG9J,SpATywNh6bZuzm8s1ceuBUnMUAeoAHHw,7,6,3,0,0,0,4,0,13,1.8571428571428572,1,0.0,2,3,0,0,4,0,0,4,0,5,8,1
5481,109035,qM8kx4xeCdgN7CQ3kDBj5MRznS4QMkrQ,G8EPVSXsOYB5YQWZGiz1aVq5Pgr2GrQu,1,0,0,0,0,0,1,0,1,0.14285714285714285,1,0.0,0,0,0,0,0,0,0,1,0,0,1,1
5482,109037,uCruZPKaQ2OyzLHOvqZfPPePv6wmtjTT,A3fsA9Zfv1X2fVEQhTw51lKENdNrEqT3,10,7,4,0,3,0,1,0,15,2.142857142857143,1,0.0,0,4,0,3,7,0,0,1,0,7,8,1
5483,109039,9RkNm8sDHM1l6EQFg0Uccrj0rG6zyU2p,A3fsA9Zfv1X2fVEQhTw51lKENdNrEqT3,18,13,0,32,0,0,2,0,47,6.714285714285714,1,0.0,2,0,29,0,11,0,3,2,0,31,16,1
5484,109047,JzBkQb66RlGvGZ9KheszqpvjIwSLUPa9,A3fsA9Zfv1X2fVEQhTw51lKENdNrEqT3,34,36,0,88,0,0,14,0,138,19.714285714285715,1,0.0,19,0,78,0,17,0,10,14,0,97,41,1
5485,109054,ay6BDjRoukNNZyMRT5YgyV5vrEPJDpPO,SpATywNh6bZuzm8s1ceuBUnMUAeoAHHw,8,9,6,0,4,1,5,0,25,3.5714285714285716,2,0.0,0,6,0,4,9,1,0,5,0,10,15,1
5486,109057,6UqKKdBhJ7OhJUUsVD1NV7GupMYMaBeb,RXDvfPUBYFlVdlueBFbLW0mhhAyGEqpt,15,12,8,0,6,0,3,0,29,4.142857142857143,1,0.0,0,8,0,6,12,0,0,3,0,14,15,1
5487,109059,i7lWxTot2xX5tUsFMkvVZL9ZWUCuO03L,A3fsA9Zfv1X2fVEQhTw51lKENdNrEqT3,11,9,4,0,1,1,7,2,24,3.4285714285714284,1,0.0,0,4,0,1,9,1,0,7,2,5,19,1
5488,109069,7JTB4CyOxMIYiscUQS5N24z40QJDU2NG,SpATywNh6bZuzm8s1ceuBUnMUAeoAHHw,13,13,8,7,5,0,5,0,38,5.428571428571429,2,0.0,0,8,6,5,13,0,1,5,0,19,19,1
5489,109074,3Q4BnqdcagQPfwKNQquFMuffhZmA481O,A3fsA9Zfv1X2fVEQhTw51lKENdNrEqT3,31,18,12,82,4,25,15,1,157,22.428571428571427,3,0.0,1,12,74,4,17,25,8,15,1,91,66,0
5490,109084,CJj1ly3IvknwPjPwTtDbF1Ndj6DLlK2p,A3fsA9Zfv1X2fVEQhTw51lKENdNrEqT3,1,0,0,0,0,0,1,0,1,0.14285714285714285,1,0.0,0,0,0,0,0,0,0,1,0,0,1,1
5491,109093,SSeq3zqfD5kMUB9gUKp0rdzGfihYMJi7,bWdj2GDclj5ofokWjzoa5jAwMkxCykd6,8,16,4,32,1,0,3,0,56,8.0,1,0.0,5,4,31,1,11,0,1,3,0,41,15,1
5492,109110,GqdYzH9IQjNV4Qw4poxGmkYlIXbhf40S,A3fsA9Zfv1X2fVEQhTw51lKENdNrEqT3,42,41,14,56,9,6,10,1,137,19.571428571428573,2,0.0,4,14,49,9,37,6,7,10,1,76,61,1
5493,109111,AQdHyQtscAI4B6OA1EdXFLllqKFEoazm,SpATywNh6bZuzm8s1ceuBUnMUAeoAHHw,5,2,1,0,1,0,2,0,6,0.8571428571428571,1,0.0,0,1,0,1,2,0,0,2,0,2,4,1
5494,109119,5bxm8iejKGaSX6YQr0TZiikGC5f5Uall,A3fsA9Zfv1X2fVEQhTw51lKENdNrEqT3,2,0,0,0,0,0,2,0,2,0.2857142857142857,1,0.0,0,0,0,0,0,0,0,2,0,0,2,1
5495,109122,Z9o0wypJqquui2I9MOTdTYh5ZR4U4MfH,A3fsA9Zfv1X2fVEQhTw51lKENdNrEqT3,7,3,0,0,0,0,5,0,8,1.1428571428571428,1,0.0,0,0,0,0,3,0,0,5,0,0,8,1
5496,109127,hIXeM0yyb6wIxVNnB5ijRV2LpcYBbrLW,bWdj2GDclj5ofokWjzoa5jAwMkxCykd6,1,0,0,0,0,0,1,0,1,0.14285714285714285,1,0.0,0,0,0,0,0,0,0,1,0,0,1,1
5497,109128,lvcfwg5xu40SCJNanQ0x3P780n9BnCrh,SpATywNh6bZuzm8s1ceuBUnMUAeoAHHw,5,2,1,0,1,0,2,0,6,0.8571428571428571,1,0.0,0,1,0,1,2,0,0,2,0,2,4,1
5498,109131,WixZusYrasZzR9owXlaQpXrbIZeJOheR,G8EPVSXsOYB5YQWZGiz1aVq5Pgr2GrQu,1,0,0,0,0,0,1,0,1,0.14285714285714285,1,0.0,0,0,0,0,0,0,0,1,0,0,1,1
5499,109132,ZVmjT1rppq7ilCPRRtmAl1wo0gOugsCt,A3fsA9Zfv1X2fVEQhTw51lKENdNrEqT3,43,26,21,66,16,2,7,4,142,20.285714285714285,3,0.0,2,21,58,16,24,2,8,7,4,97,45,1
5500,109136,oqLAJu8zdqUr5XPQYn4bKVmvqSIRanjc,A3fsA9Zfv1X2fVEQhTw51lKENdNrEqT3,1,0,0,0,0,0,1,0,1,0.14285714285714285,1,0.0,0,0,0,0,0,0,0,1,0,0,1,1
5501,109147,yM4AD5P6cznT9ej6JMMHXYh7GR0LcYuh,RXDvfPUBYFlVdlueBFbLW0mhhAyGEqpt,5,2,1,0,1,0,2,0,6,0.8571428571428571,1,0.0,0,1,0,1,2,0,0,2,0,2,4,0
5502,109169,7OAz0qWJXAI5T9rA3xczkfKNiBaKS5xD,A3fsA9Zfv1X2fVEQhTw51lKENdNrEqT3,5,2,1,0,1,0,3,0,7,1.0,1,0.0,0,1,0,1,2,0,0,3,0,2,5,1
5503,109181,YGxQDme0yci5ICjRYEy6Me4N0nnZ0g9H,SpATywNh6bZuzm8s1ceuBUnMUAeoAHHw,4,4,0,0,0,0,1,0,5,0.7142857142857143,1,0.0,0,0,0,0,4,0,0,1,0,0,5,1
5504,109182,QF5cQIRzKp7h2VSkoGej2U04awk99fmw,bWdj2GDclj5ofokWjzoa5jAwMkxCykd6,12,10,6,38,4,1,2,0,61,8.714285714285714,1,0.0,3,6,33,4,7,1,5,2,0,46,15,1
5505,109186,5kEshmgSAUGvBEOsnsKU8IViB0lkOwoD,A3fsA9Zfv1X2fVEQhTw51lKENdNrEqT3,23,4,0,94,0,0,2,0,100,14.285714285714286,1,0.0,1,0,78,0,3,0,16,2,0,79,21,1
5506,109189,eb3mqqeSvUWzy1wBijQrenro4Nhum9Na,SpATywNh6bZuzm8s1ceuBUnMUAeoAHHw,5,2,1,0,1,0,2,0,6,0.8571428571428571,1,0.0,0,1,0,1,2,0,0,2,0,2,4,1
5507,109191,Wigd4PnyDnjfDcFOxsTBcEnXo7kl9GSg,A3fsA9Zfv1X2fVEQhTw51lKENdNrEqT3,16,35,12,0,5,0,5,0,57,8.142857142857142,2,0.0,0,12,0,5,35,0,0,5,0,17,40,1
5508,109193,SclrH2608f72JlTtkBQ5xWQXCuDyyco3,A3fsA9Zfv1X2fVEQhTw51lKENdNrEqT3,36,11,8,80,6,3,8,0,116,16.571428571428573,3,0.0,1,8,70,6,10,3,10,8,0,85,31,0
5509,109195,1Gv11nS0XCuxdjw8VOmeY5aEETIaIhPq,A3fsA9Zfv1X2fVEQhTw51lKENdNrEqT3,9,7,4,0,3,0,2,0,16,2.2857142857142856,1,0.0,0,4,0,3,7,0,0,2,0,7,9,1
5510,109196,dUvs72HAR74VSIdDk98Za5hbojuIxWU6,A3fsA9Zfv1X2fVEQhTw51lKENdNrEqT3,7,5,1,6,0,0,1,0,13,1.8571428571428572,1,0.0,0,1,5,0,5,0,1,1,0,6,7,1
5511,109211,qGqiGKt8aL9OJtRSM5jpSwytmMiScrIj,SpATywNh6bZuzm8s1ceuBUnMUAeoAHHw,4,3,1,0,1,0,1,0,6,0.8571428571428571,1,0.0,0,1,0,1,3,0,0,1,0,2,4,1
5512,109231,eBgUh4wTe9cxKEwDUzWCU7PVyq9kVzKO,RXDvfPUBYFlVdlueBFbLW0mhhAyGEqpt,1,0,0,0,0,0,1,0,1,0.14285714285714285,1,0.0,0,0,0,0,0,0,0,1,0,0,1,1
5513,109241,XuNt1i5t4SR1AjDP4UHvsoux0R9qVf5C,SpATywNh6bZuzm8s1ceuBUnMUAeoAHHw,13,8,4,9,3,0,2,0,26,3.7142857142857144,1,0.0,3,4,9,3,5,0,0,2,0,19,7,1
5514,109250,eS5XywA64oauZkENyWLpeVNsSbZFhj1k,A3fsA9Zfv1X2fVEQhTw51lKENdNrEqT3,4,2,1,0,1,0,1,0,5,0.7142857142857143,1,0.0,0,1,0,1,2,0,0,1,0,2,3,1
5515,109252,urSFKVbpyaFPrDJOmPVaNjyfC2aA3KOx,SpATywNh6bZuzm8s1ceuBUnMUAeoAHHw,9,10,3,0,2,0,10,0,25,3.5714285714285716,2,0.0,0,3,0,2,10,0,0,10,0,5,20,1
5516,109256,FHrj4N2SCEsxza13qmFjgJkCjs8BkrF3,A3fsA9Zfv1X2fVEQhTw51lKENdNrEqT3,1,0,0,0,0,0,1,0,1,0.14285714285714285,1,0.0,0,0,0,0,0,0,0,1,0,0,1,1
5517,109272,BLoa1RvSOgexbSH4hGzCihmBc8pXd0Db,SpATywNh6bZuzm8s1ceuBUnMUAeoAHHw,14,26,3,0,2,11,13,1,56,8.0,4,0.0,4,3,0,2,22,11,0,13,1,9,47,1
5518,109278,fsmpK8LD6WXenVxwQRsdTaVF7iZvaL2a,A3fsA9Zfv1X2fVEQhTw51lKENdNrEqT3,24,31,17,21,9,10,12,1,101,14.428571428571429,2,0.0,0,17,17,9,31,10,4,12,1,43,58,0
5519,109279,Y5EybULOrY5dAmMMQWE7bK5wg4bsR2Lr,A3fsA9Zfv1X2fVEQhTw51lKENdNrEqT3,26,32,21,0,9,46,13,2,123,17.571428571428573,1,0.0,0,21,0,9,32,46,0,13,2,30,93,1
5520,109281,MFZvBtjHJjKdCSK87D1kJEMGtcPTGn4S,A3fsA9Zfv1X2fVEQhTw51lKENdNrEqT3,13,14,1,0,0,9,17,2,43,6.142857142857143,4,0.0,1,1,0,0,13,9,0,17,2,2,41,1
5521,109284,wbX1noywm1bmZy8t47H8TCRwxZP7RsKK,A3fsA9Zfv1X2fVEQhTw51lKENdNrEqT3,1,0,0,0,0,0,1,0,1,0.14285714285714285,1,0.0,0,0,0,0,0,0,0,1,0,0,1,1
5522,109290,A7LjkAd6Hsm6pjjO6SeIGFgQk6AkrU13,A3fsA9Zfv1X2fVEQhTw51lKENdNrEqT3,2,0,0,0,0,0,2,0,2,0.2857142857142857,1,0.0,0,0,0,0,0,0,0,2,0,0,2,1
5523,109297,VHpS9hAicdnMqh79M7ktVNQGD7RUDs6Y,SpATywNh6bZuzm8s1ceuBUnMUAeoAHHw,1,0,0,0,0,0,1,0,1,0.14285714285714285,1,0.0,0,0,0,0,0,0,0,1,0,0,1,1
5524,109304,xIuSJsusLSQAfSXoNCyoYjZ56tZodncr,bWdj2GDclj5ofokWjzoa5jAwMkxCykd6,1,0,0,0,0,0,1,0,1,0.14285714285714285,1,0.0,0,0,0,0,0,0,0,1,0,0,1,1
5525,109312,XyoP35cBUiKk44G72mbtEXCBjk8FmHfo,RXDvfPUBYFlVdlueBFbLW0mhhAyGEqpt,8,3,2,0,1,0,4,0,10,1.4285714285714286,1,0.0,0,2,0,1,3,0,0,4,0,3,7,1
5526,109317,3MhfBeZhIT9AL4Tb9CZUr8w3WzrKSn3o,A3fsA9Zfv1X2fVEQhTw51lKENdNrEqT3,3,1,0,0,0,0,4,0,5,0.7142857142857143,1,0.0,0,0,0,0,1,0,0,4,0,0,5,1
5527,109318,2kGHpLQ025yq85EhWUzksnj6YbPuOHOR,bWdj2GDclj5ofokWjzoa5jAwMkxCykd6,1,0,0,0,0,0,1,0,1,0.14285714285714285,1,0.0,0,0,0,0,0,0,0,1,0,0,1,1
5528,109319,Xv6VsjsdEll9lNbT4VRN24UmJx0y2b5E,SpATywNh6bZuzm8s1ceuBUnMUAeoAHHw,1,0,0,0,0,0,1,0,1,0.14285714285714285,1,0.0,0,0,0,0,0,0,0,1,0,0,1,1
5529,109328,1hnXgqUJOPkoCUYTmndUozE0mj3w5YNX,A3fsA9Zfv1X2fVEQhTw51lKENdNrEqT3,4,2,1,0,1,0,2,0,6,0.8571428571428571,1,0.0,0,1,0,1,2,0,0,2,0,2,4,1
5530,109344,zhiAnt6m0h6AhsgVFkvjzbntxyU6BMtY,A3fsA9Zfv1X2fVEQhTw51lKENdNrEqT3,7,3,2,0,2,0,3,1,11,1.5714285714285714,1,0.0,0,2,0,2,3,0,0,3,1,4,7,1
5531,109345,yjSLpu9rXQ5LHtGm8PnDgnJW6R5BYmgU,A3fsA9Zfv1X2fVEQhTw51lKENdNrEqT3,9,7,0,0,0,0,3,0,10,1.4285714285714286,1,0.0,1,0,0,0,6,0,0,3,0,1,9,1
5532,109346,m5W0Hr8czUb20VBRzQ0jvBI30TuPU4RJ,G8EPVSXsOYB5YQWZGiz1aVq5Pgr2GrQu,6,0,0,0,0,2,6,1,9,1.2857142857142858,1,0.0,0,0,0,0,0,2,0,6,1,0,9,1
5533,109359,G5JFEd58i47FiqQxatEMibk5NL9uoQb2,A3fsA9Zfv1X2fVEQhTw51lKENdNrEqT3,3,3,1,0,0,0,1,0,5,0.7142857142857143,1,0.0,0,1,0,0,3,0,0,1,0,1,4,1
5534,109374,Tpf1XLLzVEPyFa0H95Pm3DK4tc3XDhko,G8EPVSXsOYB5YQWZGiz1aVq5Pgr2GrQu,1,0,0,0,0,0,1,0,1,0.14285714285714285,1,0.0,0,0,0,0,0,0,0,1,0,0,1,1
5535,109376,Sqh5jl1ru6WQiSCN47rLyyyFSF0wkiCq,SpATywNh6bZuzm8s1ceuBUnMUAeoAHHw,6,9,0,0,0,0,2,0,11,1.5714285714285714,1,0.0,0,0,0,0,9,0,0,2,0,0,11,1
5536,109383,gbm2CIpey5BIwuF4GxSVVzkrIqxOpVxg,A3fsA9Zfv1X2fVEQhTw51lKENdNrEqT3,41,36,25,52,19,6,12,1,151,21.571428571428573,3,0.0,3,25,44,19,33,6,8,12,1,91,60,1
5537,109394,Gbu6u21HudOCm7T5rLfdumNquubs5EJ1,SpATywNh6bZuzm8s1ceuBUnMUAeoAHHw,1,0,0,0,0,0,1,0,1,0.14285714285714285,1,0.0,0,0,0,0,0,0,0,1,0,0,1,1
5538,109402,r9Iw8qv5Gd0slmKCVr3aUz7TALROG0cf,A3fsA9Zfv1X2fVEQhTw51lKENdNrEqT3,11,4,3,0,3,1,7,1,19,2.7142857142857144,1,0.0,0,3,0,3,4,1,0,7,1,6,13,1
5539,109403,RJ2AN96oZxuBCR52LgUmQpj4g9Y4mcD4,bWdj2GDclj5ofokWjzoa5jAwMkxCykd6,16,20,12,16,3,1,6,0,58,8.285714285714286,2,0.0,2,12,16,3,18,1,0,6,0,33,25,0
5540,109417,7T8zBGfQI7GmUNFouD9u4M8LhrQmKX66,RXDvfPUBYFlVdlueBFbLW0mhhAyGEqpt,1,0,0,0,0,0,1,0,1,0.14285714285714285,1,0.0,0,0,0,0,0,0,0,1,0,0,1,1
5541,109420,SPTliKTsT7X2iG2wvNL5AHdQ10rMJVZH,SpATywNh6bZuzm8s1ceuBUnMUAeoAHHw,6,4,1,0,1,0,5,0,11,1.5714285714285714,2,0.0,0,1,0,1,4,0,0,5,0,2,9,1
5542,109439,On26vSCnXPxlOaC4mCdb6AzdACXRPBhk,G8EPVSXsOYB5YQWZGiz1aVq5Pgr2GrQu,5,2,1,0,1,0,2,0,6,0.8571428571428571,1,0.0,0,1,0,1,2,0,0,2,0,2,4,1
5543,109443,7M6n6JJz8OT4WvASBJlRAyi4sCwcAzru,A3fsA9Zfv1X2fVEQhTw51lKENdNrEqT3,8,5,4,0,4,0,1,0,14,2.0,1,0.0,0,4,0,4,5,0,0,1,0,8,6,1
5544,109445,bwOsVB833e5tHrwHSqmXCzs0EZClNPpv,A3fsA9Zfv1X2fVEQhTw51lKENdNrEqT3,1,0,0,0,0,0,1,0,1,0.14285714285714285,1,0.0,0,0,0,0,0,0,0,1,0,0,1,1
5545,109451,JbJKnENXbd4D9YGrXPdV81P48WObl8vL,SpATywNh6bZuzm8s1ceuBUnMUAeoAHHw,6,7,0,0,0,0,7,0,14,2.0,1,0.0,0,0,0,0,7,0,0,7,0,0,14,1
5546,109454,xvNZbY8RiapNT0qosUHeJFlEtqfPfVcr,SpATywNh6bZuzm8s1ceuBUnMUAeoAHHw,14,11,6,12,4,0,4,0,37,5.285714285714286,2,0.0,3,6,11,4,8,0,1,4,0,24,13,1
5547,109455,MCvvcTb9wFwriBgKb49jcCFeKRdTXM9j,A3fsA9Zfv1X2fVEQhTw51lKENdNrEqT3,5,2,1,0,1,0,4,0,8,1.1428571428571428,2,0.0,0,1,0,1,2,0,0,4,0,2,6,1
5548,109475,RNh4yH9mZXB6eTgcXXcHwrIgY95Sp0W7,A3fsA9Zfv1X2fVEQhTw51lKENdNrEqT3,7,6,1,0,1,0,1,0,9,1.2857142857142858,1,0.0,0,1,0,1,6,0,0,1,0,2,7,1
5549,109477,7Cs0Abzd0FS9IIdr1A12WVGDozLYcxYb,SpATywNh6bZuzm8s1ceuBUnMUAeoAHHw,1,0,0,0,0,0,1,0,1,0.14285714285714285,1,0.0,0,0,0,0,0,0,0,1,0,0,1,1
5550,109482,ZwZ9L46oJNtj9fhgH7VsyHRiEXY9tnmd,G8EPVSXsOYB5YQWZGiz1aVq5Pgr2GrQu,5,3,1,0,1,0,3,0,8,1.1428571428571428,1,0.0,0,1,0,1,3,0,0,3,0,2,6,1
5551,109484,pdp70UYWh5otKyx4vGTfJaBVRuSZsd0M,SpATywNh6bZuzm8s1ceuBUnMUAeoAHHw,6,2,1,0,1,2,5,0,11,1.5714285714285714,1,0.0,0,1,0,1,2,2,0,5,0,2,9,1
5552,109493,kajklFKczHkuBeWWHTIA518Xzi7jmX3b,A3fsA9Zfv1X2fVEQhTw51lKENdNrEqT3,11,9,1,0,1,6,7,2,26,3.7142857142857144,1,0.0,0,1,0,1,9,6,0,7,2,2,24,1
5553,109503,IoDMPccLVuoP1kfQwv1qzxHOaDwHWJ1B,RXDvfPUBYFlVdlueBFbLW0mhhAyGEqpt,17,15,11,0,6,0,13,0,45,6.428571428571429,2,0.0,0,11,0,6,15,0,0,13,0,17,28,1
5554,109510,xHqnmrHdKLDxnJRARDHa2hpY45Zdt2kb,A3fsA9Zfv1X2fVEQhTw51lKENdNrEqT3,3,2,0,0,0,0,1,0,3,0.42857142857142855,1,0.0,0,0,0,0,2,0,0,1,0,0,3,1
5555,109514,KpYtE2oiCacGgvHDiOR9EPHvEG8K5VAH,bWdj2GDclj5ofokWjzoa5jAwMkxCykd6,6,4,2,0,0,0,4,0,10,1.4285714285714286,2,0.0,0,2,0,0,4,0,0,4,0,2,8,1
5556,109517,EEukb1HtBZxlb0jW8bNwwOHInCYodyW7,bWdj2GDclj5ofokWjzoa5jAwMkxCykd6,1,0,0,0,0,0,1,0,1,0.14285714285714285,1,0.0,0,0,0,0,0,0,0,1,0,0,1,1
5557,109523,qYbhiF3nJ95ttwkxqyX4iKZXAQTXvtdJ,G8EPVSXsOYB5YQWZGiz1aVq5Pgr2GrQu,1,0,0,0,0,0,1,0,1,0.14285714285714285,1,0.0,0,0,0,0,0,0,0,1,0,0,1,1
5558,109527,e0jCfTT6aDMNOYEB4iNXcTbrqQiVpXOZ,bWdj2GDclj5ofokWjzoa5jAwMkxCykd6,1,0,0,0,0,0,1,0,1,0.14285714285714285,1,0.0,0,0,0,0,0,0,0,1,0,0,1,1
5559,109533,7Cs0Abzd0FS9IIdr1A12WVGDozLYcxYb,bWdj2GDclj5ofokWjzoa5jAwMkxCykd6,2,0,0,0,0,0,2,0,2,0.2857142857142857,1,0.0,0,0,0,0,0,0,0,2,0,0,2,1
5560,109537,F5SjzrcjsAWqSZbt6NDh8MAkDqWpXhkX,SpATywNh6bZuzm8s1ceuBUnMUAeoAHHw,13,13,8,8,6,0,4,0,39,5.571428571428571,1,0.0,3,8,7,6,10,0,1,4,0,24,15,1
5561,109547,R2rZMVSlSMqKi5RYuPtRmvScbhOABzyG,SpATywNh6bZuzm8s1ceuBUnMUAeoAHHw,8,5,0,0,1,0,3,0,9,1.2857142857142858,1,0.0,0,0,0,1,5,0,0,3,0,1,8,1
5562,109548,sXsJQIq7yfhUcvdfsv1TB75YziTHrdKC,SpATywNh6bZuzm8s1ceuBUnMUAeoAHHw,1,0,0,0,0,0,1,0,1,0.14285714285714285,1,0.0,0,0,0,0,0,0,0,1,0,0,1,1
5563,109549,rHrqDHLlL0apyY3RByvtRvQofhL6Brvn,A3fsA9Zfv1X2fVEQhTw51lKENdNrEqT3,8,8,0,0,0,4,5,0,17,2.4285714285714284,1,0.0,0,0,0,0,8,4,0,5,0,0,17,1
5564,109555,Cv1aavObJnuABKfipF6OGePzg0BnGPFs,G8EPVSXsOYB5YQWZGiz1aVq5Pgr2GrQu,26,4,3,106,0,0,8,0,121,17.285714285714285,2,0.0,1,3,91,0,3,0,15,8,0,95,26,1
5565,109569,XTOZBwO5vG1hcHef4AbuiTP7iSg27hS9,A3fsA9Zfv1X2fVEQhTw51lKENdNrEqT3,37,21,1,68,1,0,9,0,100,14.285714285714286,1,0.0,2,1,59,1,19,0,9,9,0,63,37,1
5566,109570,ZGw6EJB3cHSkZVviqnd0VnyCd0Hz7wva,SpATywNh6bZuzm8s1ceuBUnMUAeoAHHw,15,12,6,12,2,2,4,1,39,5.571428571428571,1,0.0,4,6,12,2,8,2,0,4,1,24,15,1
5567,109578,QYVRHTpooyTkzSbIywJ7ri5o4t73Xwty,G8EPVSXsOYB5YQWZGiz1aVq5Pgr2GrQu,1,0,0,0,0,0,1,0,1,0.14285714285714285,1,0.0,0,0,0,0,0,0,0,1,0,0,1,1
5568,109585,MF5edVvM6lCZDxnMdHelos9TUh3KERjn,bWdj2GDclj5ofokWjzoa5jAwMkxCykd6,4,2,1,0,1,0,1,0,5,0.7142857142857143,1,0.0,0,1,0,1,2,0,0,1,0,2,3,0
5569,109590,fsmpK8LD6WXenVxwQRsdTaVF7iZvaL2a,RXDvfPUBYFlVdlueBFbLW0mhhAyGEqpt,5,2,1,0,1,0,2,0,6,0.8571428571428571,1,0.0,0,1,0,1,2,0,0,2,0,2,4,0
5570,109591,Lo69R5WSRDc62Oqnj9VlNFkaC1RUwhyo,G8EPVSXsOYB5YQWZGiz1aVq5Pgr2GrQu,8,6,2,0,2,0,3,1,14,2.0,1,0.0,3,2,0,2,3,0,0,3,1,7,7,1
5571,109601,800D5qwHCt3Ko9pzEVC49paGCt6dYzm8,A3fsA9Zfv1X2fVEQhTw51lKENdNrEqT3,5,4,2,0,1,0,3,0,10,1.4285714285714286,1,0.0,0,2,0,1,4,0,0,3,0,3,7,1
5572,109607,6YbtihuLKjD5ARAIowoJ3OQ962AhWkN5,A3fsA9Zfv1X2fVEQhTw51lKENdNrEqT3,5,3,1,0,1,0,2,0,7,1.0,1,0.0,0,1,0,1,3,0,0,2,0,2,5,1
5573,109614,cu1UzrL4copIEW9h08HrvzOBVJhdKzoe,SpATywNh6bZuzm8s1ceuBUnMUAeoAHHw,7,2,1,0,1,0,7,2,13,1.8571428571428572,1,0.0,0,1,0,1,2,0,0,7,2,2,11,1
5574,109621,dpYSVisiS2cUJnMBorcbHAtUmvFhsmWA,bWdj2GDclj5ofokWjzoa5jAwMkxCykd6,7,1,1,0,1,0,7,0,10,1.4285714285714286,1,0.0,0,1,0,1,1,0,0,7,0,2,8,1
5575,109631,ol7Qu6IbbqCzG4dmk5UYJtqKBH41uMvQ,SpATywNh6bZuzm8s1ceuBUnMUAeoAHHw,10,7,5,5,4,0,2,0,23,3.2857142857142856,1,0.0,1,5,4,4,6,0,1,2,0,14,9,1
5576,109642,JsgxGxJYDhwgnBgYbCILUrGTg0zFV4WJ,SpATywNh6bZuzm8s1ceuBUnMUAeoAHHw,12,9,8,6,4,0,2,0,29,4.142857142857143,1,0.0,0,8,5,4,9,0,1,2,0,17,12,1
5577,109647,jHKRHkwov2ldu5B5B6LxfeJx9Okiy1xa,G8EPVSXsOYB5YQWZGiz1aVq5Pgr2GrQu,10,14,5,0,5,0,6,1,31,4.428571428571429,1,0.0,7,5,0,5,7,0,0,6,1,17,14,1
5578,109651,9JqGpnHdkbKBOmcT3LmREcuqxduizBra,SpATywNh6bZuzm8s1ceuBUnMUAeoAHHw,17,36,18,21,5,43,17,2,142,20.285714285714285,3,0.0,8,18,18,5,28,43,3,17,2,49,93,1
5579,109655,rfK1l9cGasJW2YfHTqaTiWeJHGoMfxaD,G8EPVSXsOYB5YQWZGiz1aVq5Pgr2GrQu,9,8,1,0,1,0,3,0,13,1.8571428571428572,1,0.0,2,1,0,1,6,0,0,3,0,4,9,1
5580,109664,SzAtQzNOap38B7fNAidQGz1HfRyu6YSS,A3fsA9Zfv1X2fVEQhTw51lKENdNrEqT3,41,24,15,68,10,0,16,0,133,19.0,1,0.0,6,15,56,10,18,0,12,16,0,87,46,1
5581,109678,PxrASHNEh6iqdpy6HawW3zGbUAupdzGr,G8EPVSXsOYB5YQWZGiz1aVq5Pgr2GrQu,6,1,1,0,1,0,5,0,8,1.1428571428571428,1,0.0,0,1,0,1,1,0,0,5,0,2,6,1
5582,109679,Dpj1ute7yeokptEET2ZfYuubDiXNwLXm,bWdj2GDclj5ofokWjzoa5jAwMkxCykd6,7,11,7,0,3,0,3,0,24,3.4285714285714284,2,0.0,0,7,0,3,11,0,0,3,0,10,14,1
5583,109680,yesikXRZpFYEGoXWRi2rEHboJsFyCCGG,A3fsA9Zfv1X2fVEQhTw51lKENdNrEqT3,4,2,1,0,1,0,1,0,5,0.7142857142857143,1,0.0,0,1,0,1,2,0,0,1,0,2,3,1
5584,109682,HYMxLb0qNi7DvNLdn0aBxzsZewAG7tgU,SpATywNh6bZuzm8s1ceuBUnMUAeoAHHw,1,0,0,0,0,0,1,0,1,0.14285714285714285,1,0.0,0,0,0,0,0,0,0,1,0,0,1,1
5585,109695,3o4QanEzrLxU7IR8E0SkDLt6uwLmz5BV,SpATywNh6bZuzm8s1ceuBUnMUAeoAHHw,1,0,0,0,0,0,1,0,1,0.14285714285714285,1,0.0,0,0,0,0,0,0,0,1,0,0,1,1
5586,109702,eO5PxtKBgjWgF4Rm51wpAuHgGsQTJyoc,G8EPVSXsOYB5YQWZGiz1aVq5Pgr2GrQu,9,4,3,0,3,0,2,0,12,1.7142857142857142,1,0.0,0,3,0,3,4,0,0,2,0,6,6,1
5587,109705,HMYpimZGFgj5IczDutkfjUfnxl45PoHW,A3fsA9Zfv1X2fVEQhTw51lKENdNrEqT3,45,33,21,50,11,32,15,0,162,23.142857142857142,4,0.0,4,21,47,11,29,32,3,15,0,83,79,1
5588,109708,nPYAQvL2RWwzE56jCZxlu4AvBduWOQxo,SpATywNh6bZuzm8s1ceuBUnMUAeoAHHw,4,2,1,0,1,0,2,0,6,0.8571428571428571,1,0.0,0,1,0,1,2,0,0,2,0,2,4,1
5589,109716,9257hE3j2ibuyvUsd5ug9QNBvZR626xP,SpATywNh6bZuzm8s1ceuBUnMUAeoAHHw,9,20,9,0,5,0,5,0,39,5.571428571428571,3,0.0,3,9,0,5,17,0,0,5,0,17,22,1
5590,109718,LauvBEW2SjRiQSbmKACjhjUjr7ycSUes,SpATywNh6bZuzm8s1ceuBUnMUAeoAHHw,13,14,4,12,3,0,2,1,36,5.142857142857143,1,0.0,9,4,12,3,5,0,0,2,1,28,8,1
5591,109731,sXWQCMJ5uWT53YScVl07HilRx1j9KLZ2,SpATywNh6bZuzm8s1ceuBUnMUAeoAHHw,1,0,0,0,0,0,1,0,1,0.14285714285714285,1,0.0,0,0,0,0,0,0,0,1,0,0,1,1
5592,109746,GLXgEITEGSlq2OnY03wIuxcorHQRX3zY,A3fsA9Zfv1X2fVEQhTw51lKENdNrEqT3,10,7,5,0,3,1,5,0,21,3.0,1,0.0,0,5,0,3,7,1,0,5,0,8,13,0
5593,109757,NCq7uMk20xis3HUzEQcWP2K284TvGGUT,G8EPVSXsOYB5YQWZGiz1aVq5Pgr2GrQu,10,5,4,0,3,3,3,0,18,2.5714285714285716,1,0.0,0,4,0,3,5,3,0,3,0,7,11,0
5594,109782,OZaq72DmJH6bReA6lKvO4XbWYjmwsu42,A3fsA9Zfv1X2fVEQhTw51lKENdNrEqT3,1,0,0,0,0,0,1,0,1,0.14285714285714285,1,0.0,0,0,0,0,0,0,0,1,0,0,1,1
5595,109783,TGbtpXBmCBBlZeS2P72XRQZjesW8qA9X,SpATywNh6bZuzm8s1ceuBUnMUAeoAHHw,2,0,0,0,0,0,2,0,2,0.2857142857142857,1,0.0,0,0,0,0,0,0,0,2,0,0,2,1
5596,109784,qp7BLvS8nhXNAuvU9LsQhZWo9nk3BTFw,bWdj2GDclj5ofokWjzoa5jAwMkxCykd6,1,0,0,0,0,0,1,0,1,0.14285714285714285,1,0.0,0,0,0,0,0,0,0,1,0,0,1,1
5597,109785,qp7BLvS8nhXNAuvU9LsQhZWo9nk3BTFw,RXDvfPUBYFlVdlueBFbLW0mhhAyGEqpt,1,0,0,0,0,0,1,0,1,0.14285714285714285,1,0.0,0,0,0,0,0,0,0,1,0,0,1,1
5598,109786,jRi5kMZL8gw9VtNxiN9NAzyTyPmFUqYw,A3fsA9Zfv1X2fVEQhTw51lKENdNrEqT3,9,8,1,0,1,0,11,2,23,3.2857142857142856,1,0.0,0,1,0,1,8,0,0,11,2,2,21,1
5599,109800,PenDUeO0eoR8hyLVdfPN6H7q2FnTGMus,bWdj2GDclj5ofokWjzoa5jAwMkxCykd6,1,0,0,0,0,0,1,0,1,0.14285714285714285,1,0.0,0,0,0,0,0,0,0,1,0,0,1,1
5600,109811,4FKdcJP7BDwtMG7CY9eliEHXAfUQYGv7,RXDvfPUBYFlVdlueBFbLW0mhhAyGEqpt,9,12,6,0,3,0,1,0,22,3.142857142857143,1,0.0,0,6,0,3,12,0,0,1,0,9,13,1
5601,109816,NxKBgCf6L0n0EeCKRoJkVqGpdQ3sLVu2,SpATywNh6bZuzm8s1ceuBUnMUAeoAHHw,6,3,2,0,2,0,1,0,8,1.1428571428571428,1,0.0,0,2,0,2,3,0,0,1,0,4,4,1
5602,109821,OEuLxcw6vw5UY038iWtYfZUlieO9mgsq,RXDvfPUBYFlVdlueBFbLW0mhhAyGEqpt,9,24,15,0,5,0,5,0,49,7.0,2,0.0,0,15,0,5,24,0,0,5,0,20,29,1
5603,109835,QQrQFuArLkquFtXrvX0HKAU3caPT1bEW,SpATywNh6bZuzm8s1ceuBUnMUAeoAHHw,1,0,0,0,0,0,1,0,1,0.14285714285714285,1,0.0,0,0,0,0,0,0,0,1,0,0,1,1
5604,109840,fW2uAkcB4Zo13Su23SC3AqxKoKQQCv9V,bWdj2GDclj5ofokWjzoa5jAwMkxCykd6,14,11,4,28,5,0,2,0,50,7.142857142857143,2,0.0,4,4,27,5,7,0,1,2,0,40,10,1
5605,109841,008XUUt5rc6hUrg7SHj9oW0rG0FE0dkF,A3fsA9Zfv1X2fVEQhTw51lKENdNrEqT3,36,20,12,68,0,1,7,2,110,15.714285714285714,1,0.0,6,12,58,0,14,1,10,7,2,76,34,0
5606,109856,PVIjAE0m0OeJAYOHc5gIjzktRijtXdS4,SpATywNh6bZuzm8s1ceuBUnMUAeoAHHw,6,3,2,0,2,0,1,0,8,1.1428571428571428,2,0.0,0,2,0,2,3,0,0,1,0,4,4,0
5607,109858,45qf8dslh2FbT82HZJkVQ8o4xBP1tetJ,SpATywNh6bZuzm8s1ceuBUnMUAeoAHHw,1,0,0,0,0,0,1,0,1,0.14285714285714285,1,0.0,0,0,0,0,0,0,0,1,0,0,1,1
5608,109865,WRiHtWJX61VUGyAGQFSHJ3czdrgqxeQW,A3fsA9Zfv1X2fVEQhTw51lKENdNrEqT3,3,0,0,0,0,2,2,0,4,0.5714285714285714,1,0.0,0,0,0,0,0,2,0,2,0,0,4,1
5609,109876,J9b5OTfKjKw0x7GgqhJQnViZ6aYw88y1,bWdj2GDclj5ofokWjzoa5jAwMkxCykd6,4,2,0,0,0,0,3,0,5,0.7142857142857143,1,0.0,0,0,0,0,2,0,0,3,0,0,5,1
5610,109884,TiyssQ1xBxRpSE8M84hoblpjLNawoMPM,bWdj2GDclj5ofokWjzoa5jAwMkxCykd6,1,0,0,0,0,0,1,0,1,0.14285714285714285,1,0.0,0,0,0,0,0,0,0,1,0,0,1,1
5611,109888,onkD63zW36qWueM4FnIhDEFep4J6xaTB,SpATywNh6bZuzm8s1ceuBUnMUAeoAHHw,10,9,6,0,6,1,8,1,31,4.428571428571429,3,0.0,0,6,0,6,9,1,0,8,1,12,19,1
5612,109898,26GEnf61bFs7ZWD0apKuRzsFCe2K0kZz,SpATywNh6bZuzm8s1ceuBUnMUAeoAHHw,7,2,0,0,0,14,6,1,23,3.2857142857142856,1,0.0,0,0,0,0,2,14,0,6,1,0,23,1
5613,109903,m4zdr76CpU472F6wsJffFbslI27LpI4g,A3fsA9Zfv1X2fVEQhTw51lKENdNrEqT3,4,2,1,0,1,0,1,0,5,0.7142857142857143,1,0.0,0,1,0,1,2,0,0,1,0,2,3,1
5614,109911,AVOR5ugt0lZQkprV146IIDmyiCL0xSOy,SpATywNh6bZuzm8s1ceuBUnMUAeoAHHw,6,3,1,0,1,0,2,0,7,1.0,1,0.0,0,1,0,1,3,0,0,2,0,2,5,1
5615,109935,CViRSkXaB71kW0MpqfES8A240EKnhiKp,SpATywNh6bZuzm8s1ceuBUnMUAeoAHHw,7,7,5,0,3,0,4,0,19,2.7142857142857144,2,0.0,0,5,0,3,7,0,0,4,0,8,11,1
5616,109938,jhSBNR9EEysD5KhTnnFndvZuefk9V3rI,SpATywNh6bZuzm8s1ceuBUnMUAeoAHHw,13,9,5,8,0,2,7,1,32,4.571428571428571,1,0.0,4,5,7,0,5,2,1,7,1,16,16,0
5617,109950,m46ZDnHY4MCOwsZObE6icbOdSDL76NDY,A3fsA9Zfv1X2fVEQhTw51lKENdNrEqT3,1,0,0,0,0,0,1,0,1,0.14285714285714285,1,0.0,0,0,0,0,0,0,0,1,0,0,1,1
5618,109952,7vgfRfYiZZ2eDFnPmEicllnUmROBENw7,SpATywNh6bZuzm8s1ceuBUnMUAeoAHHw,1,0,0,0,0,0,1,0,1,0.14285714285714285,1,0.0,0,0,0,0,0,0,0,1,0,0,1,1
5619,109957,69mjZoNGtUdd47OHaI2iQubsVwSBE5CT,bWdj2GDclj5ofokWjzoa5jAwMkxCykd6,4,3,1,0,1,0,2,0,7,1.0,1,0.0,0,1,0,1,3,0,0,2,0,2,5,1
5620,109960,dq3iqibSI5OSwCbWRZv7tfgbiuLwOgjh,A3fsA9Zfv1X2fVEQhTw51lKENdNrEqT3,10,7,5,0,4,0,1,0,17,2.4285714285714284,1,0.0,0,5,0,4,7,0,0,1,0,9,8,1
5621,109967,gcway7yukVhkU23YjxQt8J89R78muKel,A3fsA9Zfv1X2fVEQhTw51lKENdNrEqT3,1,0,0,0,0,0,2,0,2,0.2857142857142857,1,0.0,0,0,0,0,0,0,0,2,0,0,2,1
5622,109984,9vKJ7o9c510Kb9hLaAaKExOfBIo69t2w,bWdj2GDclj5ofokWjzoa5jAwMkxCykd6,4,3,1,0,1,0,1,0,6,0.8571428571428571,1,0.0,0,1,0,1,3,0,0,1,0,2,4,1
5623,109993,ma5SB0XT5eSIELPtdH2s2g8qesUddnBJ,SpATywNh6bZuzm8s1ceuBUnMUAeoAHHw,4,2,0,0,0,0,3,0,5,0.7142857142857143,1,0.0,0,0,0,0,2,0,0,3,0,0,5,1
5624,109994,V9A9B2T9pRTU3AqvpqzuKs4MfRcAEte2,bWdj2GDclj5ofokWjzoa5jAwMkxCykd6,7,3,2,0,2,0,3,0,10,1.4285714285714286,2,0.0,0,2,0,2,3,0,0,3,0,4,6,1
5625,109995,9vKJ7o9c510Kb9hLaAaKExOfBIo69t2w,SpATywNh6bZuzm8s1ceuBUnMUAeoAHHw,6,7,3,0,2,0,1,0,13,1.8571428571428572,1,0.0,0,3,0,2,7,0,0,1,0,5,8,1
5626,109996,OZ02Yntpt8Hg8thsFgejT4NSsPYtVPPm,A3fsA9Zfv1X2fVEQhTw51lKENdNrEqT3,4,3,2,0,2,0,1,0,8,1.1428571428571428,1,0.0,0,2,0,2,3,0,0,1,0,4,4,0
5627,109999,rYSxun4NgQnH8EYwHicH82Z91cblITe8,A3fsA9Zfv1X2fVEQhTw51lKENdNrEqT3,8,2,1,0,1,1,10,1,16,2.2857142857142856,1,0.0,0,1,0,1,2,1,0,10,1,2,14,1
5628,110000,A49hnVx3rwiVqM2hX3Oana4wZTCICiZX,SpATywNh6bZuzm8s1ceuBUnMUAeoAHHw,4,2,1,0,1,0,1,0,5,0.7142857142857143,1,0.0,0,1,0,1,2,0,0,1,0,2,3,0
5629,110005,CD2QgLWd9xNuEgr45XWnWQUVbnjf79M7,A3fsA9Zfv1X2fVEQhTw51lKENdNrEqT3,14,7,6,0,5,0,2,0,20,2.857142857142857,1,0.0,0,6,0,5,7,0,0,2,0,11,9,1
5630,110009,9803qM4isShkjkoVAPID7DQVAjFPwCDe,bWdj2GDclj5ofokWjzoa5jAwMkxCykd6,2,0,0,0,0,0,3,0,3,0.42857142857142855,1,0.0,0,0,0,0,0,0,0,3,0,0,3,1
5631,110013,OvIrFDXnTf7lPGXHN37tKh2m9dXSHGJK,A3fsA9Zfv1X2fVEQhTw51lKENdNrEqT3,1,0,0,0,0,0,2,0,2,0.2857142857142857,2,0.0,0,0,0,0,0,0,0,2,0,0,2,1
5632,110021,hkMQnmp0vvHTyvieOAhjYCGC9vi3Sftr,SpATywNh6bZuzm8s1ceuBUnMUAeoAHHw,10,5,3,0,2,5,5,0,20,2.857142857142857,1,0.0,0,3,0,2,5,5,0,5,0,5,15,1
5633,110025,VLJj9ywKL5TKEmvLWZO7iNyx7gDmV9Dg,SpATywNh6bZuzm8s1ceuBUnMUAeoAHHw,1,0,0,0,0,0,1,0,1,0.14285714285714285,1,0.0,0,0,0,0,0,0,0,1,0,0,1,1
5634,110030,2gXHY5qLgY96Nt3kImmboPawcy43EQXt,A3fsA9Zfv1X2fVEQhTw51lKENdNrEqT3,5,6,2,0,2,0,3,0,13,1.8571428571428572,1,0.0,0,2,0,2,6,0,0,3,0,4,9,1
5635,110033,sVIvm416vjfeqMOGnXZuyI7BvpOH8r6a,A3fsA9Zfv1X2fVEQhTw51lKENdNrEqT3,8,2,1,0,1,4,6,1,15,2.142857142857143,1,0.0,0,1,0,1,2,4,0,6,1,2,13,1
5636,110036,pKc7l3x3OfAQ9k2wvNUoHVHE65xXVFbV,G8EPVSXsOYB5YQWZGiz1aVq5Pgr2GrQu,9,5,3,0,2,1,4,0,15,2.142857142857143,1,0.0,0,3,0,2,5,1,0,4,0,5,10,1
5637,110047,mutkCKvqzTd4FkjKQRYUWL51H59AdIct,SpATywNh6bZuzm8s1ceuBUnMUAeoAHHw,10,10,7,0,6,0,4,0,27,3.857142857142857,1,0.0,0,7,0,6,10,0,0,4,0,13,14,0
5638,110051,UCDPR1k7RkPBDIde3KiukiosB55WbRVo,bWdj2GDclj5ofokWjzoa5jAwMkxCykd6,1,0,0,0,0,0,1,0,1,0.14285714285714285,1,0.0,0,0,0,0,0,0,0,1,0,0,1,1
5639,110053,gaD5Av49rKMTRISUDiGUl6H5FYk7vPMw,G8EPVSXsOYB5YQWZGiz1aVq5Pgr2GrQu,29,35,4,66,6,2,3,1,117,16.714285714285715,1,0.0,21,4,51,6,14,2,15,3,1,82,35,0
5640,110060,HAmydfc2dHhpF7W3j97KPwhZZY0mGz44,bWdj2GDclj5ofokWjzoa5jAwMkxCykd6,6,1,0,0,0,0,8,1,10,1.4285714285714286,2,0.0,0,0,0,0,1,0,0,8,1,0,10,1
5641,113846,7hhGe4WcGEHypOzIVz3DLRx9GS52ozkE,7GRhBDsirIGkRZBtSMEzNTyDr2JQm4xx,29,39,14,48,9,0,4,0,114,16.285714285714285,3,0.0,20,14,43,9,19,0,5,4,0,86,28,1
5642,113935,nDRvdnRCphlivJCuFTuhDKgd5jyHoHuK,7GRhBDsirIGkRZBtSMEzNTyDr2JQm4xx,18,26,12,43,5,0,1,0,87,12.428571428571429,1,0.0,13,12,36,5,13,0,7,1,0,66,21,0
5643,113957,JoqAGqbao71wc04PyVzx7SVvlZZ0knbI,7GRhBDsirIGkRZBtSMEzNTyDr2JQm4xx,19,49,15,26,0,4,7,0,101,14.428571428571429,1,0.0,22,15,25,0,27,4,1,7,0,62,39,1
5644,114140,nUWkRuhBy34ASlaPMCQ75Oelnn64cfdy,7GRhBDsirIGkRZBtSMEzNTyDr2JQm4xx,27,75,26,14,23,10,12,1,161,23.0,2,0.0,42,26,12,23,33,10,2,12,1,103,58,0
5645,114349,HHtkMPGPD7M5HjKp2cITsAXThUPUGeqi,7GRhBDsirIGkRZBtSMEzNTyDr2JQm4xx,35,97,41,83,24,10,8,0,263,37.57142857142857,3,0.0,49,41,73,24,48,10,10,8,0,187,76,1
5646,114508,DahdU3m64q9GHbzMvs6TdHVFTDo4asbt,7GRhBDsirIGkRZBtSMEzNTyDr2JQm4xx,10,2,1,0,1,9,8,4,25,3.5714285714285716,1,0.0,0,1,0,1,2,9,0,8,4,2,23,0
5647,114562,BQSRjVmgixA5nv8k53vKwJ20bVp0NOMd,7GRhBDsirIGkRZBtSMEzNTyDr2JQm4xx,34,38,12,42,13,13,12,1,131,18.714285714285715,1,0.0,22,12,36,13,16,13,6,12,1,83,48,0
5648,114622,whDoakw9KuyWQ8M0W7cddKOMydB0d6nf,fbPkOYLVPtPgIt0MxizjfFJov3JbHyAi,7,3,2,0,2,12,5,0,24,3.4285714285714284,1,0.0,0,2,0,2,3,12,0,5,0,4,20,1
5649,114627,uKuE1pqPLKBLlaDHpMsHUJvLz6lxiokY,fbPkOYLVPtPgIt0MxizjfFJov3JbHyAi,11,25,13,0,10,0,5,0,53,7.571428571428571,2,0.0,0,13,0,10,25,0,0,5,0,23,30,1
5650,114634,5MFqn51ngpNJRILTITSLFdc469nefTuS,fbPkOYLVPtPgIt0MxizjfFJov3JbHyAi,9,5,2,0,2,3,4,1,17,2.4285714285714284,1,0.0,2,2,0,2,3,3,0,4,1,6,11,1
5651,114639,IXyECojptU5NkfL9RFdtwIRy87m56pw9,fbPkOYLVPtPgIt0MxizjfFJov3JbHyAi,17,41,20,15,10,9,19,6,120,17.142857142857142,4,0.0,9,20,10,10,32,9,5,19,6,49,71,1
5652,114652,wuaIkUodYTr49NZ7BbMPsEdpO0t0C8Nt,fbPkOYLVPtPgIt0MxizjfFJov3JbHyAi,8,13,1,0,1,0,5,0,20,2.857142857142857,1,0.0,0,1,0,1,13,0,0,5,0,2,18,1
5653,117347,Lmy48LaZfIr9H2JGohLJKVaIoB8r8qji,fbPkOYLVPtPgIt0MxizjfFJov3JbHyAi,7,3,2,0,2,0,4,0,11,1.5714285714285714,1,0.0,0,2,0,2,3,0,0,4,0,4,7,1
5654,117348,5qhlEY7iczknBOw4qaTj0oiHyjQVe9rT,fbPkOYLVPtPgIt0MxizjfFJov3JbHyAi,4,2,1,0,1,0,1,0,5,0.7142857142857143,1,0.0,0,1,0,1,2,0,0,1,0,2,3,1
5655,117349,CcuDWPt1eyW7M86jUsYuAZO2EZvkv343,fbPkOYLVPtPgIt0MxizjfFJov3JbHyAi,2,0,0,0,0,0,2,0,2,0.2857142857142857,1,0.0,0,0,0,0,0,0,0,2,0,0,2,1
5656,117350,THBV67QwrR4fvYsMOGo7siHXFao0S7M8,fbPkOYLVPtPgIt0MxizjfFJov3JbHyAi,4,2,1,0,1,0,1,0,5,0.7142857142857143,1,0.0,0,1,0,1,2,0,0,1,0,2,3,1
5657,117351,S6eQGQp3K76RS5VMtIsaLuIm5UHtwYF7,fbPkOYLVPtPgIt0MxizjfFJov3JbHyAi,5,2,1,0,1,0,4,0,8,1.1428571428571428,1,0.0,0,1,0,1,2,0,0,4,0,2,6,1
5658,117352,W8LiHDfUOd6JJS4l21H06gvkeAd3UQzA,fbPkOYLVPtPgIt0MxizjfFJov3JbHyAi,8,6,2,0,3,0,6,0,17,2.4285714285714284,2,0.0,3,2,0,3,3,0,0,6,0,8,9,1
5659,117353,qsIC4v5Dx0AC8V7VvfXbXh1Orc1wEb3w,fbPkOYLVPtPgIt0MxizjfFJov3JbHyAi,2,0,0,0,0,0,4,0,4,0.5714285714285714,2,0.0,0,0,0,0,0,0,0,4,0,0,4,1
5660,117354,wJflvpFe05Aoyiv7JkqhQs7iDcvnIpoZ,fbPkOYLVPtPgIt0MxizjfFJov3JbHyAi,23,95,36,22,66,45,14,0,278,39.714285714285715,4,0.0,16,36,19,66,79,45,3,14,0,137,141,0
5661,117355,HymjYRZjO8zO0eFKC26krqimHj67lbM0,fbPkOYLVPtPgIt0MxizjfFJov3JbHyAi,9,3,2,0,2,12,13,1,33,4.714285714285714,1,0.0,0,2,0,2,3,12,0,13,1,4,29,1
5662,117356,BEpwi711y09XyC4DFTNZ8NMJ5PwUJeE1,fbPkOYLVPtPgIt0MxizjfFJov3JbHyAi,26,77,30,26,13,26,20,2,194,27.714285714285715,4,0.0,14,30,25,13,63,26,1,20,2,82,112,0
5663,117357,jdo8ZaITXdNg3iaXD5IuBNuDQn99Df8w,fbPkOYLVPtPgIt0MxizjfFJov3JbHyAi,4,2,1,0,1,0,1,0,5,0.7142857142857143,1,0.0,0,1,0,1,2,0,0,1,0,2,3,1
5664,117358,VIIC2sfSYNNzIhFTDhqx6glGRp1LLtBP,fbPkOYLVPtPgIt0MxizjfFJov3JbHyAi,1,0,0,0,0,0,1,0,1,0.14285714285714285,1,0.0,0,0,0,0,0,0,0,1,0,0,1,1
5665,117359,1fv3phUYFf4MQkWpDcJllU01xcW0vo3W,fbPkOYLVPtPgIt0MxizjfFJov3JbHyAi,4,2,1,0,1,0,1,0,5,0.7142857142857143,1,0.0,0,1,0,1,2,0,0,1,0,2,3,1
5666,117360,u8qSA6tNYpciCcX3NsOlG8kpTSmTzvQW,fbPkOYLVPtPgIt0MxizjfFJov3JbHyAi,1,0,0,0,0,0,1,0,1,0.14285714285714285,1,0.0,0,0,0,0,0,0,0,1,0,0,1,1
5667,117361,YmW9sTTkl6fJ0hETvvamJqK86iqzkJtX,fbPkOYLVPtPgIt0MxizjfFJov3JbHyAi,9,12,7,0,4,3,3,0,29,4.142857142857143,2,0.0,0,7,0,4,12,3,0,3,0,11,18,1
5668,117362,GhH23XxJCtHV5BHmHgLHMs1bT51czMlK,fbPkOYLVPtPgIt0MxizjfFJov3JbHyAi,2,0,0,0,0,0,8,0,8,1.1428571428571428,1,0.0,0,0,0,0,0,0,0,8,0,0,8,1
5669,117363,jpOV5NTWg54y4Oc7tw4bVLxYduaerIGO,fbPkOYLVPtPgIt0MxizjfFJov3JbHyAi,5,2,1,0,1,0,4,0,8,1.1428571428571428,1,0.0,0,1,0,1,2,0,0,4,0,2,6,1
5670,117364,gVDka1k86106F8RxhzEk3T4GWmptct3j,fbPkOYLVPtPgIt0MxizjfFJov3JbHyAi,5,2,1,0,1,0,5,0,9,1.2857142857142858,1,0.0,0,1,0,1,2,0,0,5,0,2,7,1
5671,117365,Jab5g3oUGQ9SaeNRnULqHnW16VXqaDjO,fbPkOYLVPtPgIt0MxizjfFJov3JbHyAi,5,3,1,0,1,0,4,0,9,1.2857142857142858,1,0.0,0,1,0,1,3,0,0,4,0,2,7,0
5672,117366,dzyBEAqhGTXZ2XFaP0jn5Y8xrnIodQ3R,fbPkOYLVPtPgIt0MxizjfFJov3JbHyAi,1,0,0,0,0,0,1,0,1,0.14285714285714285,1,0.0,0,0,0,0,0,0,0,1,0,0,1,1
5673,117369,84MmPDpZ0YkQ5nQqNX1rbALt0YU3wNuB,fbPkOYLVPtPgIt0MxizjfFJov3JbHyAi,6,1,0,0,0,0,8,1,10,1.4285714285714286,1,0.0,0,0,0,0,1,0,0,8,1,0,10,1
5674,117371,yr7gisoB3gNrf1PYumUdBsd83AKA13gw,fbPkOYLVPtPgIt0MxizjfFJov3JbHyAi,2,0,0,0,0,0,4,0,4,0.5714285714285714,1,0.0,0,0,0,0,0,0,0,4,0,0,4,1
5675,117372,frevGWOFyf2Wo6uQjpFNvZnyWeFbKP0E,fbPkOYLVPtPgIt0MxizjfFJov3JbHyAi,25,17,8,16,8,5,6,0,60,8.571428571428571,2,0.0,7,8,14,8,10,5,2,6,0,37,23,1
5676,117373,FAatoUEhCvhRpOYbmvA32pbUt7RdzYRu,fbPkOYLVPtPgIt0MxizjfFJov3JbHyAi,5,2,1,0,1,0,5,0,9,1.2857142857142858,1,0.0,0,1,0,1,2,0,0,5,0,2,7,1
5677,117374,ZMs9DXI7ESTFKW1YBMWs95iQQk6J7X2z,fbPkOYLVPtPgIt0MxizjfFJov3JbHyAi,5,3,1,0,1,2,4,0,11,1.5714285714285714,1,0.0,0,1,0,1,3,2,0,4,0,2,9,1
5678,117375,70RbSAVcGIyny9mWjCd20wt9FfgzeOIU,fbPkOYLVPtPgIt0MxizjfFJov3JbHyAi,8,5,2,0,1,10,9,1,28,4.0,1,0.0,0,2,0,1,5,10,0,9,1,3,25,1
5679,117376,7RSTSE7CX0EZRW2RDRnKS7CJkHtK7gJx,fbPkOYLVPtPgIt0MxizjfFJov3JbHyAi,4,3,1,0,1,3,1,0,9,1.2857142857142858,1,0.0,0,1,0,1,3,3,0,1,0,2,7,0
5680,117378,9jhH7wrMd3Eqw0VV440Dc9UHr2dQD82o,fbPkOYLVPtPgIt0MxizjfFJov3JbHyAi,6,1,1,0,1,0,5,0,8,1.1428571428571428,1,0.0,0,1,0,1,1,0,0,5,0,2,6,1
5681,117381,WeKk3LPA70V1znb6M7iSuaLFtRvTgv4L,fbPkOYLVPtPgIt0MxizjfFJov3JbHyAi,4,2,1,0,1,0,1,0,5,0.7142857142857143,1,0.0,0,1,0,1,2,0,0,1,0,2,3,1
5682,117383,cgR6Sk6i1HisakMjtLETZQtfL4e89Msk,fbPkOYLVPtPgIt0MxizjfFJov3JbHyAi,2,0,0,0,0,0,2,0,2,0.2857142857142857,1,0.0,0,0,0,0,0,0,0,2,0,0,2,1
5683,117384,QE7VYemIj4pMHXuEl2xp801KoSOaKbg6,fbPkOYLVPtPgIt0MxizjfFJov3JbHyAi,5,2,1,0,1,0,6,0,10,1.4285714285714286,1,0.0,0,1,0,1,2,0,0,6,0,2,8,1
5684,117387,Q6xW7zlgn9B8VyFUYRYPAiN0jH5lh0YZ,fbPkOYLVPtPgIt0MxizjfFJov3JbHyAi,5,3,1,0,1,0,5,0,10,1.4285714285714286,1,0.0,0,1,0,1,3,0,0,5,0,2,8,1
5685,117388,cdL4DEn7NceHWkENWhz16RxoYhvN1B4t,fbPkOYLVPtPgIt0MxizjfFJov3JbHyAi,9,9,4,0,3,3,7,1,27,3.857142857142857,1,0.0,3,4,0,3,6,3,0,7,1,10,17,1
5686,117390,CadKUf2Mul3ALexXlY5uWvTQFtSrVs8p,fbPkOYLVPtPgIt0MxizjfFJov3JbHyAi,5,2,1,0,1,0,2,0,6,0.8571428571428571,1,0.0,0,1,0,1,2,0,0,2,0,2,4,1
5687,117391,dGox9f4ZDlHQwjKRHa3wEmIJzGDWDxPX,fbPkOYLVPtPgIt0MxizjfFJov3JbHyAi,9,8,3,9,4,10,8,0,42,6.0,1,0.0,4,3,6,4,4,10,3,8,0,17,25,1
5688,117392,A3rmkE1bnOg1XwxjYHudD7UFmCyTX4Vy,fbPkOYLVPtPgIt0MxizjfFJov3JbHyAi,5,2,1,0,1,0,2,0,6,0.8571428571428571,1,0.0,0,1,0,1,2,0,0,2,0,2,4,1
5689,117393,1NRhqP9avvdGMFKMKghbEOxv5wnexLIt,fbPkOYLVPtPgIt0MxizjfFJov3JbHyAi,2,0,0,0,0,0,4,0,4,0.5714285714285714,1,0.0,0,0,0,0,0,0,0,4,0,0,4,1
5690,117394,x61GVEFoUQZEIHnVsxBCw0kitfDOhP0p,fbPkOYLVPtPgIt0MxizjfFJov3JbHyAi,28,56,30,10,22,78,25,1,222,31.714285714285715,3,0.0,13,30,9,22,43,78,1,25,1,74,148,1
5691,117395,Mh66DLCMXZ6dBObZWAREClnDkNcjPB4t,fbPkOYLVPtPgIt0MxizjfFJov3JbHyAi,5,2,1,0,1,0,4,0,8,1.1428571428571428,1,0.0,0,1,0,1,2,0,0,4,0,2,6,1
5692,117398,RToZJlmZ1SKeCpqwz31BArcaj4qy0SaF,fbPkOYLVPtPgIt0MxizjfFJov3JbHyAi,2,0,0,0,0,0,2,0,2,0.2857142857142857,1,0.0,0,0,0,0,0,0,0,2,0,0,2,1
5693,117400,DYhAozmaoJyITokVWonroVftsEgv5K6H,fbPkOYLVPtPgIt0MxizjfFJov3JbHyAi,7,3,2,0,2,0,4,0,11,1.5714285714285714,1,0.0,0,2,0,2,3,0,0,4,0,4,7,1
5694,117401,8loJZqV93UIB0LVEOgs0qIcfMBhyuVR4,fbPkOYLVPtPgIt0MxizjfFJov3JbHyAi,5,2,1,0,1,0,2,0,6,0.8571428571428571,1,0.0,0,1,0,1,2,0,0,2,0,2,4,1
5695,117402,BdMHqR5WAKDssANXDMso5QusZ7X7eexo,fbPkOYLVPtPgIt0MxizjfFJov3JbHyAi,7,7,3,0,2,4,2,0,18,2.5714285714285716,1,0.0,0,3,0,2,7,4,0,2,0,5,13,1
5696,117403,AyVFKMWjzC4gPpDsd8ofzYs7TtpYPztD,fbPkOYLVPtPgIt0MxizjfFJov3JbHyAi,7,4,2,0,1,0,5,0,12,1.7142857142857142,1,0.0,0,2,0,1,4,0,0,5,0,3,9,1
5697,117404,C89edYjc0egHm9DK0UhG6TICXc3cgfYt,fbPkOYLVPtPgIt0MxizjfFJov3JbHyAi,4,2,1,0,0,0,2,0,5,0.7142857142857143,1,0.0,0,1,0,0,2,0,0,2,0,1,4,1
5698,117406,skfYGEKD2YfFTJGYxEqRg06NVhsZf6hd,fbPkOYLVPtPgIt0MxizjfFJov3JbHyAi,2,0,0,0,0,0,2,0,2,0.2857142857142857,1,0.0,0,0,0,0,0,0,0,2,0,0,2,1
5699,117411,K22VFryh5Od9V1LL0eOyTaqPsCNGJ8v3,fbPkOYLVPtPgIt0MxizjfFJov3JbHyAi,5,1,1,0,1,0,2,0,5,0.7142857142857143,1,0.0,0,1,0,1,1,0,0,2,0,2,3,1
5700,117412,27mdD0tYMMLTpcK2D7h6xnCOldDDzHch,fbPkOYLVPtPgIt0MxizjfFJov3JbHyAi,8,17,6,0,3,0,2,0,28,4.0,2,0.0,2,6,0,3,15,0,0,2,0,11,17,1
5701,117413,ZcypYnlQeadTdUIaT74Rv3xxhxFofUjh,fbPkOYLVPtPgIt0MxizjfFJov3JbHyAi,5,2,1,0,1,0,6,0,10,1.4285714285714286,1,0.0,0,1,0,1,2,0,0,6,0,2,8,1
5702,117414,u601bf5LgTloUnzWrvF8VsEbNdAIplE1,fbPkOYLVPtPgIt0MxizjfFJov3JbHyAi,7,3,2,0,2,0,4,0,11,1.5714285714285714,1,0.0,0,2,0,2,3,0,0,4,0,4,7,1
5703,117415,4Qo7Z1J3GHBpS2AY75HBdWU9Il8Ha5mP,fbPkOYLVPtPgIt0MxizjfFJov3JbHyAi,13,17,6,1,8,9,10,1,52,7.428571428571429,1,0.0,9,6,1,8,8,9,0,10,1,24,28,1
5704,117416,no2ug7TKVsupL4LU2a5jY2GhYHkskTdw,fbPkOYLVPtPgIt0MxizjfFJov3JbHyAi,6,14,7,0,1,0,10,0,32,4.571428571428571,5,0.0,0,7,0,1,14,0,0,10,0,8,24,1
5705,117417,MWcyYl4VKJ6gXYTCZ6GsdLjzmXlJRZpp,fbPkOYLVPtPgIt0MxizjfFJov3JbHyAi,10,9,2,0,3,21,12,4,51,7.285714285714286,2,0.0,2,2,0,3,7,21,0,12,4,7,44,1
5706,117418,xO9ez1QwXcTHUWvk9yY6tpiPg2NpvI40,fbPkOYLVPtPgIt0MxizjfFJov3JbHyAi,7,3,2,0,2,0,2,0,9,1.2857142857142858,1,0.0,0,2,0,2,3,0,0,2,0,4,5,1
5707,117419,EDx8dOeIuSiG4dzn3b6IyJq074mUoFqU,fbPkOYLVPtPgIt0MxizjfFJov3JbHyAi,2,0,0,0,0,0,4,0,4,0.5714285714285714,1,0.0,0,0,0,0,0,0,0,4,0,0,4,1
5708,117422,3ufcPQa9fE8hNqWpP8Ewk6MLJ169ewYG,fbPkOYLVPtPgIt0MxizjfFJov3JbHyAi,9,15,3,0,2,0,4,0,24,3.4285714285714284,2,0.0,0,3,0,2,15,0,0,4,0,5,19,1
5709,117423,NXEwBXbU6vvce77sujWgRB6LivhFJvRb,fbPkOYLVPtPgIt0MxizjfFJov3JbHyAi,4,2,1,0,1,0,1,0,5,0.7142857142857143,1,0.0,0,1,0,1,2,0,0,1,0,2,3,1
5710,117424,ksf7O5VoxfMEE12hvGca3f6KoMnOQ3Bh,fbPkOYLVPtPgIt0MxizjfFJov3JbHyAi,5,5,0,0,0,0,7,0,12,1.7142857142857142,1,0.0,0,0,0,0,5,0,0,7,0,0,12,1
5711,117427,bGLdkKassDYyZB9t4bgBBFjAHmjUsNSR,fbPkOYLVPtPgIt0MxizjfFJov3JbHyAi,7,3,1,0,1,1,7,1,14,2.0,1,0.0,0,1,0,1,3,1,0,7,1,2,12,1
5712,117428,es5zwE1DJ3gcng5ye9rbNjDc6YGVZjjA,fbPkOYLVPtPgIt0MxizjfFJov3JbHyAi,7,4,3,0,2,0,4,0,13,1.8571428571428572,1,0.0,0,3,0,2,4,0,0,4,0,5,8,1
5713,117431,da6MhMlDFSRLmIrClGzjJtU8eL0pm2dy,fbPkOYLVPtPgIt0MxizjfFJov3JbHyAi,5,2,1,0,1,0,2,0,6,0.8571428571428571,1,0.0,0,1,0,1,2,0,0,2,0,2,4,1
5714,117433,M75L90OOMTV1kEiI3n7vM0ty47YBFna9,fbPkOYLVPtPgIt0MxizjfFJov3JbHyAi,6,3,2,0,2,0,1,0,8,1.1428571428571428,1,0.0,0,2,0,2,3,0,0,1,0,4,4,1
5715,117435,Mal0OrUqylh9gVaeGBMc9fi4hOm7CY1j,fbPkOYLVPtPgIt0MxizjfFJov3JbHyAi,5,3,1,0,1,0,4,0,9,1.2857142857142858,1,0.0,0,1,0,1,3,0,0,4,0,2,7,1
5716,117436,CarlVCnkEuEWdxEFIyhyUfB0cb91lk3u,fbPkOYLVPtPgIt0MxizjfFJov3JbHyAi,5,2,1,0,1,1,4,0,9,1.2857142857142858,1,0.0,0,1,0,1,2,1,0,4,0,2,7,1
5717,117438,tD6MzN5QxvGBHQOVcmWLTvbMypNYMcey,fbPkOYLVPtPgIt0MxizjfFJov3JbHyAi,6,3,2,0,2,0,1,0,8,1.1428571428571428,1,0.0,0,2,0,2,3,0,0,1,0,4,4,1
5718,117439,vEs30RoWqgpB6hECbcLmFiwxEohGiKSd,fbPkOYLVPtPgIt0MxizjfFJov3JbHyAi,5,2,0,0,0,8,3,0,13,1.8571428571428572,1,0.0,0,0,0,0,2,8,0,3,0,0,13,1
5719,117440,IvHnLbw6NP6LhhQqreTJbhNQU5Zs6JCF,fbPkOYLVPtPgIt0MxizjfFJov3JbHyAi,4,2,1,0,1,0,2,0,6,0.8571428571428571,1,0.0,0,1,0,1,2,0,0,2,0,2,4,1
5720,117441,HptEZjRmdOpiqQNtiQtuC0XhWeQWrU1F,fbPkOYLVPtPgIt0MxizjfFJov3JbHyAi,2,0,0,0,0,0,2,0,2,0.2857142857142857,1,0.0,0,0,0,0,0,0,0,2,0,0,2,1
5721,117448,EVLibPakJPGsb5a9opPnLRzSILBMV36m,fbPkOYLVPtPgIt0MxizjfFJov3JbHyAi,7,2,1,0,1,1,7,1,13,1.8571428571428572,1,0.0,0,1,0,1,2,1,0,7,1,2,11,1
5722,117449,jfWbgHyvVBGKbleke3IOJ4RuvBB6sx7J,fbPkOYLVPtPgIt0MxizjfFJov3JbHyAi,9,5,3,0,3,0,3,0,14,2.0,2,0.0,0,3,0,3,5,0,0,3,0,6,8,1
5723,117450,NTi3RF6xGnkzsfYTj8D33u4sH3LbVAHE,fbPkOYLVPtPgIt0MxizjfFJov3JbHyAi,18,46,21,36,0,0,11,0,114,16.285714285714285,2,0.0,18,21,31,0,28,0,5,11,0,70,44,1
5724,117451,8TpvgxjbFSiTX0WEWOAldouvOlu5hbct,fbPkOYLVPtPgIt0MxizjfFJov3JbHyAi,5,2,0,0,0,22,4,0,28,4.0,1,0.0,0,0,0,0,2,22,0,4,0,0,28,1
5725,117453,GOoApgMbqW9QFX07cCt2mUBIZ8txh6qT,fbPkOYLVPtPgIt0MxizjfFJov3JbHyAi,9,17,9,0,9,15,1,0,51,7.285714285714286,1,0.0,6,9,0,9,11,15,0,1,0,24,27,1
5726,117455,HTst2SMNdS0XNA43FeobA5o05v7CUlNA,fbPkOYLVPtPgIt0MxizjfFJov3JbHyAi,25,42,17,22,18,2,6,1,108,15.428571428571429,1,0.0,22,17,21,18,20,2,1,6,1,78,30,0
5727,117456,PgMYw44fTh4Xx5U2R8ETG8pzBeXCE15Z,fbPkOYLVPtPgIt0MxizjfFJov3JbHyAi,1,0,0,0,0,0,1,0,1,0.14285714285714285,1,0.0,0,0,0,0,0,0,0,1,0,0,1,1
5728,117457,AFgD1DLeorByrsoA4AU51GpZfc6uZUVB,fbPkOYLVPtPgIt0MxizjfFJov3JbHyAi,6,7,3,0,2,0,1,0,13,1.8571428571428572,1,0.0,0,3,0,2,7,0,0,1,0,5,8,1
5729,117458,Uc3HK5Q0vMTy3ljdUcEzfnFcMiWvgtMK,fbPkOYLVPtPgIt0MxizjfFJov3JbHyAi,5,1,1,0,1,0,2,0,5,0.7142857142857143,1,0.0,0,1,0,1,1,0,0,2,0,2,3,1
5730,117459,8BPmxHv8u8jXk5HWBs0qXnY9uZ2rLMGq,fbPkOYLVPtPgIt0MxizjfFJov3JbHyAi,4,3,1,0,1,0,1,0,6,0.8571428571428571,1,0.0,0,1,0,1,3,0,0,1,0,2,4,0
5731,117461,OakZIwMalw5UgG2N0rTydClOEPiV8rki,fbPkOYLVPtPgIt0MxizjfFJov3JbHyAi,7,11,5,0,3,0,3,0,22,3.142857142857143,2,0.0,0,5,0,3,11,0,0,3,0,8,14,1
5732,117462,t9DYQDh2NoshF6BVBhwjK6lRvYfkvSI9,fbPkOYLVPtPgIt0MxizjfFJov3JbHyAi,5,2,1,0,1,0,4,0,8,1.1428571428571428,1,0.0,0,1,0,1,2,0,0,4,0,2,6,1
5733,117463,KMNMpAumo6Yq2T1usaL4CulVhqgN4Ggl,fbPkOYLVPtPgIt0MxizjfFJov3JbHyAi,10,4,3,0,3,0,5,0,15,2.142857142857143,1,0.0,0,3,0,3,4,0,0,5,0,6,9,1
5734,117464,SiySM3c36hCdKDVaWJXLlC2PBQXet4s6,fbPkOYLVPtPgIt0MxizjfFJov3JbHyAi,5,3,2,0,1,0,1,0,7,1.0,1,0.0,0,2,0,1,3,0,0,1,0,3,4,1
5735,117465,c0uK7fknnbIb1l1yn1QtakefMn1Gi8lI,fbPkOYLVPtPgIt0MxizjfFJov3JbHyAi,5,11,4,4,0,5,1,0,25,3.5714285714285716,1,0.0,6,4,4,0,5,5,0,1,0,14,11,1
5736,117466,f46TsvwYgA023En7b0jRPEBnKcXc3eeY,fbPkOYLVPtPgIt0MxizjfFJov3JbHyAi,1,0,0,0,0,0,1,0,1,0.14285714285714285,1,0.0,0,0,0,0,0,0,0,1,0,0,1,1
5737,117468,AyISABpEkA6iYSuwBUoEgieVOrxLsxsQ,fbPkOYLVPtPgIt0MxizjfFJov3JbHyAi,4,2,1,0,0,0,3,0,6,0.8571428571428571,1,0.0,0,1,0,0,2,0,0,3,0,1,5,1
5738,117469,L3IzrZCeDOJTtm8wqYhXyjKAgit0WIBa,fbPkOYLVPtPgIt0MxizjfFJov3JbHyAi,1,0,0,0,0,0,1,0,1,0.14285714285714285,1,0.0,0,0,0,0,0,0,0,1,0,0,1,1
5739,117471,yDbqTKS1iAgd89Ji6xK8IoXm0GxGr49P,fbPkOYLVPtPgIt0MxizjfFJov3JbHyAi,2,0,0,0,0,0,4,0,4,0.5714285714285714,1,0.0,0,0,0,0,0,0,0,4,0,0,4,1
5740,117473,5eQJepE2igmBlMYZK0syg6BGCi1adOu4,fbPkOYLVPtPgIt0MxizjfFJov3JbHyAi,5,2,1,0,1,0,2,0,6,0.8571428571428571,1,0.0,0,1,0,1,2,0,0,2,0,2,4,1
5741,117474,1HKWuDclbOiSiuIlQVduMPq7fJCJ9Rls,fbPkOYLVPtPgIt0MxizjfFJov3JbHyAi,8,20,6,0,2,0,3,0,31,4.428571428571429,2,0.0,3,6,0,2,17,0,0,3,0,11,20,1
5742,117475,SBljO82TZdHeWzc47l4IthlHIwfXwoH3,fbPkOYLVPtPgIt0MxizjfFJov3JbHyAi,7,5,3,0,3,0,6,0,17,2.4285714285714284,1,0.0,0,3,0,3,5,0,0,6,0,6,11,1
5743,117479,Hc79IVDWbH7OTe9ljIsaEhHZLqPrPrds,fbPkOYLVPtPgIt0MxizjfFJov3JbHyAi,7,4,3,0,3,0,2,0,12,1.7142857142857142,1,0.0,0,3,0,3,4,0,0,2,0,6,6,1
5744,117480,O85WftB5NCrDTb9pXVSgYQyFNgKq9cya,fbPkOYLVPtPgIt0MxizjfFJov3JbHyAi,7,3,2,0,2,0,4,0,11,1.5714285714285714,1,0.0,0,2,0,2,3,0,0,4,0,4,7,1
5745,117481,58Jq6K3XLZtch5ZG85QFaonKOWfQNCcP,fbPkOYLVPtPgIt0MxizjfFJov3JbHyAi,7,3,2,0,2,0,2,0,9,1.2857142857142858,1,0.0,0,2,0,2,3,0,0,2,0,4,5,1
5746,117482,ueh8Q0J414FE7Xmjqeh6AbzlK27RwSRw,fbPkOYLVPtPgIt0MxizjfFJov3JbHyAi,1,0,0,0,0,0,1,0,1,0.14285714285714285,1,0.0,0,0,0,0,0,0,0,1,0,0,1,1
5747,117486,XDj6kE9olAchZwfUS0dXzHZTiPPM5bec,fbPkOYLVPtPgIt0MxizjfFJov3JbHyAi,4,4,2,0,2,0,1,0,9,1.2857142857142858,1,0.0,0,2,0,2,4,0,0,1,0,4,5,1
5748,117487,UvYdE00Z5Ts8a6wK0WxKxxpGT2cAkrRh,fbPkOYLVPtPgIt0MxizjfFJov3JbHyAi,17,63,22,4,14,0,8,0,111,15.857142857142858,4,0.0,18,22,4,14,45,0,0,8,0,58,53,0
5749,117488,1CyCTZgUsAiY8PwSyUmbGce1pgpqezgo,fbPkOYLVPtPgIt0MxizjfFJov3JbHyAi,11,9,6,0,4,1,6,3,29,4.142857142857143,1,0.0,0,6,0,4,9,1,0,6,3,10,19,1
5750,117489,36E8EgprLSCZHQtlY5yjvPm97JUh2cfX,fbPkOYLVPtPgIt0MxizjfFJov3JbHyAi,1,0,0,0,0,0,1,0,1,0.14285714285714285,1,0.0,0,0,0,0,0,0,0,1,0,0,1,1
5751,117490,yCzdfwMA9QCcmr5ztirsmSQYamCmcIS7,fbPkOYLVPtPgIt0MxizjfFJov3JbHyAi,1,0,0,0,0,0,1,0,1,0.14285714285714285,1,0.0,0,0,0,0,0,0,0,1,0,0,1,1
5752,117491,WDD9a1qNUJX21r5OnYzYbe9snqA1PiYA,fbPkOYLVPtPgIt0MxizjfFJov3JbHyAi,9,4,3,0,3,0,2,0,12,1.7142857142857142,1,0.0,0,3,0,3,4,0,0,2,0,6,6,1
5753,117492,nsluEqDvvOEPdz5RzSmy7fU8guuqWKfm,fbPkOYLVPtPgIt0MxizjfFJov3JbHyAi,11,11,7,6,5,0,4,0,33,4.714285714285714,2,0.0,1,7,4,5,10,0,2,4,0,17,16,1
5754,117493,Cn5FQ7TJ9erBCpMOguGrs26OG5h6UtTt,fbPkOYLVPtPgIt0MxizjfFJov3JbHyAi,6,4,1,0,1,0,4,0,10,1.4285714285714286,2,0.0,0,1,0,1,4,0,0,4,0,2,8,1
5755,117494,bXLdnFxUVQAW3oOCSdQxNLLTqr9NOtgu,fbPkOYLVPtPgIt0MxizjfFJov3JbHyAi,2,0,0,0,0,0,3,0,3,0.42857142857142855,2,0.0,0,0,0,0,0,0,0,3,0,0,3,1
5756,117495,ETdIqr5m0JR2Poccag4YWGY81ays6ejO,fbPkOYLVPtPgIt0MxizjfFJov3JbHyAi,4,2,0,0,0,0,6,0,8,1.1428571428571428,1,0.0,0,0,0,0,2,0,0,6,0,0,8,1
5757,117496,Hoitr98hXhrf7xDGgACEFamKhiarA3wg,fbPkOYLVPtPgIt0MxizjfFJov3JbHyAi,7,4,2,0,2,0,2,0,10,1.4285714285714286,1,0.0,1,2,0,2,3,0,0,2,0,5,5,0
5758,117509,ydSu1htsBf3RzcwY9UTcwNk58kfOh1CK,SpATywNh6bZuzm8s1ceuBUnMUAeoAHHw,10,9,1,8,1,0,2,0,21,3.0,2,0.0,0,1,7,1,9,0,1,2,0,9,12,0
5759,117517,s6b6Agzyi3Or4EEcsJYYkdvPZgCCL57f,A3fsA9Zfv1X2fVEQhTw51lKENdNrEqT3,19,11,8,0,7,0,3,0,29,4.142857142857143,1,0.0,0,8,0,7,11,0,0,3,0,15,14,1
5760,117536,f07Kut7kBpGHis5iRAbMzHKfd6CS5vLr,A3fsA9Zfv1X2fVEQhTw51lKENdNrEqT3,18,67,41,0,4,150,41,3,306,43.714285714285715,4,0.0,4,41,0,4,63,150,0,41,3,49,257,0
5761,117552,wKSiPD3ccCI47tDYWhx56Wd2BJP8ki2L,SpATywNh6bZuzm8s1ceuBUnMUAeoAHHw,14,37,10,7,6,10,4,0,74,10.571428571428571,2,0.0,11,10,7,6,26,10,0,4,0,34,40,0
5762,117561,ADL0cXowUMs4wyiAOHKMOrtTHu5tmUqi,A3fsA9Zfv1X2fVEQhTw51lKENdNrEqT3,19,17,8,34,1,0,6,0,66,9.428571428571429,4,0.0,2,8,30,1,15,0,4,6,0,41,25,0
5763,117602,BcsAFxTYYWhC1bNDfK977UfoS17oCWvP,SpATywNh6bZuzm8s1ceuBUnMUAeoAHHw,14,23,1,17,0,1,9,2,53,7.571428571428571,2,0.0,9,1,14,0,14,1,3,9,2,24,29,0
5764,117611,BbvGM92sGSMMIrRMXDFdD1GEnySzXRYT,SpATywNh6bZuzm8s1ceuBUnMUAeoAHHw,11,30,3,20,0,0,6,0,59,8.428571428571429,5,0.0,11,3,18,0,19,0,2,6,0,32,27,0
5765,117616,GLClE8eg40BpWvmEfcSMwSvtSTOkzETn,SpATywNh6bZuzm8s1ceuBUnMUAeoAHHw,12,21,2,19,1,5,8,0,56,8.0,4,0.0,3,2,16,1,18,5,3,8,0,22,34,0
5766,117653,xdxiKeJYKflgdr88D3HSJXuR1e81YpjG,A3fsA9Zfv1X2fVEQhTw51lKENdNrEqT3,5,2,1,0,1,0,2,0,6,0.8571428571428571,1,0.0,0,1,0,1,2,0,0,2,0,2,4,1
5767,117664,wbMM6yL6hpsJkBDUrCRoi5Fuo2kgSUdK,SpATywNh6bZuzm8s1ceuBUnMUAeoAHHw,5,3,1,0,1,0,2,0,7,1.0,1,0.0,0,1,0,1,3,0,0,2,0,2,5,1
5768,117669,3xN41ERTxK2f1CGWRDLSjBdLqp0aeXRu,SpATywNh6bZuzm8s1ceuBUnMUAeoAHHw,12,30,24,0,0,5,23,3,85,12.142857142857142,2,0.0,0,24,0,0,30,5,0,23,3,24,61,1
5769,117703,70SrKRY1oWl5d62cNgc8OZe8Ra3cen1a,SpATywNh6bZuzm8s1ceuBUnMUAeoAHHw,16,45,2,19,1,19,16,1,103,14.714285714285714,5,0.0,22,2,17,1,23,19,2,16,1,42,61,0
5770,117749,yNygMjDRQbsmQrkdzv6Ni3gEhrA9rC9T,G8EPVSXsOYB5YQWZGiz1aVq5Pgr2GrQu,11,22,12,6,2,0,3,0,45,6.428571428571429,2,0.0,7,12,3,2,15,0,3,3,0,24,21,1
5771,117776,8EDi9ELIY5NaafGr5ul94OArAKYSlPLk,SpATywNh6bZuzm8s1ceuBUnMUAeoAHHw,4,2,1,0,1,0,2,0,6,0.8571428571428571,1,0.0,0,1,0,1,2,0,0,2,0,2,4,0
5772,117782,usFuTvFQpKrRjDwn3CiAVcIq4WWtoKl0,RXDvfPUBYFlVdlueBFbLW0mhhAyGEqpt,45,102,65,108,42,97,60,75,549,78.42857142857143,5,0.0,20,65,101,42,82,97,7,60,75,228,321,0
5773,117796,2HxuGhGQGzCNLHdg582isvj2k1uv2pCi,SpATywNh6bZuzm8s1ceuBUnMUAeoAHHw,14,45,1,15,1,14,11,2,89,12.714285714285714,1,0.0,27,1,13,1,18,14,2,11,2,42,47,0
5774,117865,57P5UbCfzn8GLpyzVkqMDPp8kp3hFIaz,bWdj2GDclj5ofokWjzoa5jAwMkxCykd6,9,33,7,0,4,0,9,0,53,7.571428571428571,5,0.0,0,7,0,4,33,0,0,9,0,11,42,1
5775,117906,NoA9xueUUthCTfidqnFplOKsMZsY3DHa,A3fsA9Zfv1X2fVEQhTw51lKENdNrEqT3,39,18,14,68,9,0,7,0,116,16.571428571428573,3,0.0,1,14,62,9,17,0,6,7,0,86,30,1
5776,117907,Z3bFvTwttDZ4bCfkqeyPSBE9NPAPKPqN,SpATywNh6bZuzm8s1ceuBUnMUAeoAHHw,11,28,0,23,0,1,8,0,60,8.571428571428571,3,0.0,10,0,19,0,18,1,4,8,0,29,31,0
5777,117910,QtoTN2OyyTcqe6Us4ENFLFoSg3hJkA40,SpATywNh6bZuzm8s1ceuBUnMUAeoAHHw,13,40,1,17,0,4,12,1,75,10.714285714285714,4,0.0,15,1,14,0,25,4,3,12,1,30,45,0
5778,117940,JYCXGTBUXKAgLYAuYSVkBAkWpoJ7TYUE,G8EPVSXsOYB5YQWZGiz1aVq5Pgr2GrQu,10,11,5,12,2,19,24,1,74,10.571428571428571,4,0.0,2,5,9,2,9,19,3,24,1,18,56,0
5779,117944,Lx03w1Z7uki61iSuRTBJrJMgf0kqOIrF,SpATywNh6bZuzm8s1ceuBUnMUAeoAHHw,17,14,6,15,3,7,12,2,59,8.428571428571429,2,0.0,5,6,12,3,9,7,3,12,2,26,33,0
5780,117948,1AlOrbJ2y8dS4ycbJ2sP2OTCfMGEqZ01,SpATywNh6bZuzm8s1ceuBUnMUAeoAHHw,18,33,12,26,3,25,9,1,109,15.571428571428571,1,0.0,17,12,19,3,16,25,7,9,1,51,58,0
5781,117954,jFYWygr5nLqLhHkXltZRkT0S1zQoLEVR,SpATywNh6bZuzm8s1ceuBUnMUAeoAHHw,6,3,2,0,2,0,1,0,8,1.1428571428571428,1,0.0,0,2,0,2,3,0,0,1,0,4,4,0
5782,118025,DBl0Whn7bz7gT7myQMnidYa3zRNL4McA,SpATywNh6bZuzm8s1ceuBUnMUAeoAHHw,12,34,6,21,0,20,14,3,98,14.0,6,0.0,19,6,18,0,15,20,3,14,3,43,55,1
5783,118033,86F6XnjIRLQFbYrnQo4SUAq6YeqsWqJH,SpATywNh6bZuzm8s1ceuBUnMUAeoAHHw,17,18,10,15,4,26,17,16,106,15.142857142857142,2,0.0,5,10,12,4,13,26,3,17,16,31,75,1
5784,118051,PHrtg3UspIdS1qc6Vp5GAq4YFnlF3cc7,G8EPVSXsOYB5YQWZGiz1aVq5Pgr2GrQu,8,22,4,4,0,0,6,0,36,5.142857142857143,1,0.0,6,4,2,0,16,0,2,6,0,12,24,1
5785,118083,hJwtwnOzJaTrAeP4eXJAEwz2xbKsgc4M,SpATywNh6bZuzm8s1ceuBUnMUAeoAHHw,4,2,0,0,0,0,5,0,7,1.0,3,0.0,0,0,0,0,2,0,0,5,0,0,7,0
5786,118145,CUEyHbsjLlbX6I7tsbnNjxFI1v5Lj4iD,SpATywNh6bZuzm8s1ceuBUnMUAeoAHHw,13,34,13,6,7,0,8,0,68,9.714285714285714,3,0.0,3,13,6,7,31,0,0,8,0,29,39,0
5787,118153,UwereIH21fVhvJGOSErkxB1cQ9i013xS,SpATywNh6bZuzm8s1ceuBUnMUAeoAHHw,8,5,3,0,2,1,4,3,18,2.5714285714285716,1,0.0,0,3,0,2,5,1,0,4,3,5,13,0
5788,118171,U3R4m4eLMm2lirgI7HLueBKsNpxhFpn9,A3fsA9Zfv1X2fVEQhTw51lKENdNrEqT3,11,6,4,0,3,0,2,0,15,2.142857142857143,2,0.0,0,4,0,3,6,0,0,2,0,7,8,0
5789,118178,qAVFbR5cx9X92KNDPDJmLoSTth8nEsRM,RXDvfPUBYFlVdlueBFbLW0mhhAyGEqpt,22,33,5,36,3,14,20,2,113,16.142857142857142,3,0.0,6,5,30,3,27,14,6,20,2,44,69,0
5790,118222,IONYwfWuSLUzRHMHVpaPTPvGauCNosjD,SpATywNh6bZuzm8s1ceuBUnMUAeoAHHw,8,35,26,0,17,0,10,0,88,12.571428571428571,3,0.0,0,26,0,17,35,0,0,10,0,43,45,1
5791,118260,5rpYxIaCTDb4PhszkJWpACOx5VMpNGcQ,A3fsA9Zfv1X2fVEQhTw51lKENdNrEqT3,45,15,12,64,10,23,13,4,141,20.142857142857142,3,0.0,1,12,53,10,14,23,11,13,4,76,65,1
5792,118277,LULTOx14kVdHaym020tyvEUUMDRXiDOf,SpATywNh6bZuzm8s1ceuBUnMUAeoAHHw,5,6,3,0,0,0,7,0,16,2.2857142857142856,1,0.0,0,3,0,0,6,0,0,7,0,3,13,1
5793,118321,vCel5g8zGhrngsDNZ5YOyxEmQk5qV7ac,bWdj2GDclj5ofokWjzoa5jAwMkxCykd6,9,14,0,0,1,5,6,1,27,3.857142857142857,2,0.0,5,0,0,1,9,5,0,6,1,6,21,1
5794,118328,oyFfPK6y9oPPwQR5mbsXW98FJaEnU88b,RXDvfPUBYFlVdlueBFbLW0mhhAyGEqpt,7,4,3,0,2,0,1,0,10,1.4285714285714286,1,0.0,0,3,0,2,4,0,0,1,0,5,5,1
5795,118336,50cUUtrBaOZeeifZra0Sj4seKRuBEyFS,SpATywNh6bZuzm8s1ceuBUnMUAeoAHHw,10,25,2,20,2,0,2,0,51,7.285714285714286,3,0.0,14,2,16,2,11,0,4,2,0,34,17,0
5796,118363,FOCCuGaJ7zYTl7CCCo7T3PqrLtxGVeiU,SpATywNh6bZuzm8s1ceuBUnMUAeoAHHw,5,2,1,0,1,0,2,0,6,0.8571428571428571,1,0.0,0,1,0,1,2,0,0,2,0,2,4,0
5797,118375,iCakYP1w40pz3A1o7VgcbnomKTMQfUiT,SpATywNh6bZuzm8s1ceuBUnMUAeoAHHw,1,0,0,0,0,0,1,0,1,0.14285714285714285,1,0.0,0,0,0,0,0,0,0,1,0,0,1,1
5798,118395,LVTU4qA4F3wWkxH81iGfu4ZuIt77nyhh,A3fsA9Zfv1X2fVEQhTw51lKENdNrEqT3,6,6,1,0,0,1,6,0,14,2.0,1,0.0,0,1,0,0,6,1,0,6,0,1,13,0
5799,118427,ycOAtB1gwFcaAwvsqsJPeGAqm0EVwIDN,G8EPVSXsOYB5YQWZGiz1aVq5Pgr2GrQu,22,23,9,16,6,0,15,0,69,9.857142857142858,2,0.0,11,9,14,6,12,0,2,15,0,40,29,1
5800,118432,LFsOk9gu14yLVtdY9pNmboBkRA6YhVq4,SpATywNh6bZuzm8s1ceuBUnMUAeoAHHw,1,0,0,0,0,0,1,0,1,0.14285714285714285,1,0.0,0,0,0,0,0,0,0,1,0,0,1,1
5801,118453,X285XxvFlCKmuDlV3vzMxZpCu1V9X67P,G8EPVSXsOYB5YQWZGiz1aVq5Pgr2GrQu,4,2,1,0,1,0,1,0,5,0.7142857142857143,1,0.0,0,1,0,1,2,0,0,1,0,2,3,1
5802,118469,HlHSVt6QwV3D8zM3oQa4RZqHTHgBTeDb,G8EPVSXsOYB5YQWZGiz1aVq5Pgr2GrQu,3,1,0,0,0,0,2,0,3,0.42857142857142855,1,0.0,0,0,0,0,1,0,0,2,0,0,3,1
5803,118484,grhneBVDCBhvBD53OXACTDGfdH3pEWQ2,SpATywNh6bZuzm8s1ceuBUnMUAeoAHHw,11,22,1,16,0,1,3,0,43,6.142857142857143,2,0.0,7,1,13,0,15,1,3,3,0,21,22,0
5804,118497,D42av4RgpD46CqlOrc3UqYUQGU69fX7w,SpATywNh6bZuzm8s1ceuBUnMUAeoAHHw,10,16,8,7,5,0,1,0,37,5.285714285714286,2,0.0,0,8,6,5,16,0,1,1,0,19,18,1
5805,118517,AADHk2CnqIXqU54SVoJYYzHXkzsT7VVX,SpATywNh6bZuzm8s1ceuBUnMUAeoAHHw,16,68,24,27,1,30,27,9,186,26.571428571428573,4,0.0,30,24,21,1,38,30,6,27,9,76,110,0
5806,118592,RiCs84yGV6JCwVfBOhcXa8oCpUMbIJNf,SpATywNh6bZuzm8s1ceuBUnMUAeoAHHw,15,37,2,19,1,18,16,4,97,13.857142857142858,4,0.0,14,2,17,1,23,18,2,16,4,34,63,0
5807,118651,ANtHTaCISHkEW6ENLanE6G1HEnRFLZdw,SpATywNh6bZuzm8s1ceuBUnMUAeoAHHw,1,0,0,0,0,0,1,0,1,0.14285714285714285,1,0.0,0,0,0,0,0,0,0,1,0,0,1,1
5808,118662,ANtHTaCISHkEW6ENLanE6G1HEnRFLZdw,RXDvfPUBYFlVdlueBFbLW0mhhAyGEqpt,3,2,1,0,0,0,1,0,4,0.5714285714285714,1,0.0,0,1,0,0,2,0,0,1,0,1,3,1
5809,118665,eNgDL8k9xOLyBlZ3UNlseJHly8SfPZZu,A3fsA9Zfv1X2fVEQhTw51lKENdNrEqT3,11,20,11,0,2,13,14,0,60,8.571428571428571,4,0.0,1,11,0,2,19,13,0,14,0,14,46,0
5810,118692,34Xbf7uBGJ4LnJBXPtvvptwjUQQdkYUg,A3fsA9Zfv1X2fVEQhTw51lKENdNrEqT3,44,68,31,44,8,3,45,2,201,28.714285714285715,5,0.0,6,31,42,8,62,3,2,45,2,87,114,0
5811,118695,DvqqmzfQOqhniG6rRYaSYRCVzVLc6KPG,bWdj2GDclj5ofokWjzoa5jAwMkxCykd6,4,3,1,0,1,0,1,0,6,0.8571428571428571,1,0.0,1,1,0,1,2,0,0,1,0,3,3,1
5812,118713,GzZqgl4giqqW7TCBTX5a2jDyy6Q646Os,SpATywNh6bZuzm8s1ceuBUnMUAeoAHHw,16,36,2,19,2,3,16,3,81,11.571428571428571,2,0.0,13,2,16,2,23,3,3,16,3,33,48,1
5813,118738,I3IAdtd399keUxdhVZ1J3PIkz3kC7zL8,RXDvfPUBYFlVdlueBFbLW0mhhAyGEqpt,2,0,0,0,0,0,2,0,2,0.2857142857142857,1,0.0,0,0,0,0,0,0,0,2,0,0,2,1
5814,118771,lrp5AGJUh69hKuCI5IYUEU19E2beipwd,A3fsA9Zfv1X2fVEQhTw51lKENdNrEqT3,16,17,2,0,2,0,6,0,27,3.857142857142857,3,0.0,0,2,0,2,17,0,0,6,0,4,23,1
5815,118783,bKVslXuzEQ1pv4c6iV5mVjs6X6avUbmL,G8EPVSXsOYB5YQWZGiz1aVq5Pgr2GrQu,1,0,0,0,0,0,2,0,2,0.2857142857142857,2,0.0,0,0,0,0,0,0,0,2,0,0,2,0
5816,118876,eLhnZqVqldawLLuaLdbS0XPiIKiZAief,RXDvfPUBYFlVdlueBFbLW0mhhAyGEqpt,19,27,1,0,0,18,14,1,61,8.714285714285714,1,0.0,0,1,0,0,27,18,0,14,1,1,60,0
5817,118879,wuMhhjy7NxtqcBPxbigACLOqg9Xy71R7,SpATywNh6bZuzm8s1ceuBUnMUAeoAHHw,2,0,0,0,0,0,2,0,2,0.2857142857142857,1,0.0,0,0,0,0,0,0,0,2,0,0,2,0
5818,118913,xUhDcXiX03QQg1jNR3Lksh9CrGcRUkPg,A3fsA9Zfv1X2fVEQhTw51lKENdNrEqT3,28,35,25,10,18,23,9,0,120,17.142857142857142,3,0.0,0,25,10,18,35,23,0,9,0,53,67,0
5819,118923,FcPFK6OTsUF1j3uNGabdzGTvbY8kcO3D,A3fsA9Zfv1X2fVEQhTw51lKENdNrEqT3,13,9,8,0,7,0,1,0,25,3.5714285714285716,1,0.0,0,8,0,7,9,0,0,1,0,15,10,1
5820,118926,efygWYkxxUMOGInRZT4qEeuzMRlIpQq6,SpATywNh6bZuzm8s1ceuBUnMUAeoAHHw,5,5,3,0,2,0,2,0,12,1.7142857142857142,1,0.0,0,3,0,2,5,0,0,2,0,5,7,0
5821,118931,ZRfFWalEoINhUGe05gZETSGzjQUd6T5n,SpATywNh6bZuzm8s1ceuBUnMUAeoAHHw,14,22,8,13,4,9,3,0,59,8.428571428571429,2,0.0,12,8,10,4,10,9,3,3,0,34,25,1
5822,118943,6hOFMnbpcErHmlwc3MeiSQOkkbkZvsdF,SpATywNh6bZuzm8s1ceuBUnMUAeoAHHw,11,11,3,0,2,1,7,1,25,3.5714285714285716,2,0.0,6,3,0,2,5,1,0,7,1,11,14,0
5823,118944,pqKCkJOspd9xXtA4k6IDJS4Js61XmolB,SpATywNh6bZuzm8s1ceuBUnMUAeoAHHw,3,2,0,0,0,0,1,0,3,0.42857142857142855,1,0.0,0,0,0,0,2,0,0,1,0,0,3,1
5824,118950,5eO5trczHn4tezH3o1mHOvzooHGmVWMl,A3fsA9Zfv1X2fVEQhTw51lKENdNrEqT3,11,11,7,0,4,0,4,0,26,3.7142857142857144,3,0.0,0,7,0,4,11,0,0,4,0,11,15,1
5825,118964,YvVuka2rxSzzYYNnDLtzVMee0hjbsr3Q,SpATywNh6bZuzm8s1ceuBUnMUAeoAHHw,5,4,0,0,0,0,1,0,5,0.7142857142857143,1,0.0,0,0,0,0,4,0,0,1,0,0,5,1
5826,118966,zQeYO5pZ1xh2UAEMjLOadhLt0hmfHHxb,bWdj2GDclj5ofokWjzoa5jAwMkxCykd6,9,11,5,8,3,1,6,0,34,4.857142857142857,2,0.0,1,5,7,3,10,1,1,6,0,16,18,1
5827,118987,u79qFvGauNOAmgDpP2DklDOwG6ISKFXs,SpATywNh6bZuzm8s1ceuBUnMUAeoAHHw,7,2,1,0,1,32,6,2,44,6.285714285714286,1,0.0,0,1,0,1,2,32,0,6,2,2,42,1
5828,118993,5R2yvtH9LNaB7I0DFs0y5Dgzft4SPkTz,SpATywNh6bZuzm8s1ceuBUnMUAeoAHHw,15,20,11,19,7,0,7,0,64,9.142857142857142,2,0.0,8,11,16,7,12,0,3,7,0,42,22,1
5829,118995,UoQ0PEeqIO4n6Ln8avpcjf2ZoIAx1YCQ,A3fsA9Zfv1X2fVEQhTw51lKENdNrEqT3,42,30,23,54,17,0,9,0,133,19.0,6,0.0,1,23,49,17,29,0,5,9,0,90,43,0
5830,119001,DXaGQeTbJkNEulVow7g1qYtfMHcxt0Bb,SpATywNh6bZuzm8s1ceuBUnMUAeoAHHw,12,11,0,12,0,18,5,1,47,6.714285714285714,1,0.0,4,0,9,0,7,18,3,5,1,13,34,0
5831,119027,5tL0goZ0bMjNeuGHJZ9VZymSM6PzqaXn,SpATywNh6bZuzm8s1ceuBUnMUAeoAHHw,15,23,10,14,5,12,3,0,67,9.571428571428571,1,0.0,11,10,11,5,12,12,3,3,0,37,30,0
5832,119042,lVwgv61cg8fkhW9rg5b1PIPnuUWxb0Vk,bWdj2GDclj5ofokWjzoa5jAwMkxCykd6,19,26,14,24,7,50,14,3,138,19.714285714285715,3,0.0,5,14,22,7,21,50,2,14,3,48,90,1
5833,119043,D5jAgVwgvpw2Kr66NxyapnkPl0dnzBLu,A3fsA9Zfv1X2fVEQhTw51lKENdNrEqT3,4,2,0,0,0,0,15,0,17,2.4285714285714284,4,0.0,0,0,0,0,2,0,0,15,0,0,17,1
5834,119090,RwiQ9qTlDDbK4m60mKR4JxmbkQn57Rff,RXDvfPUBYFlVdlueBFbLW0mhhAyGEqpt,16,16,10,0,5,36,9,3,79,11.285714285714286,3,0.0,2,10,0,5,14,36,0,9,3,17,62,1
5835,119104,jq4JfpgApzrMRuCNvYDPIsQTWPeEZuhJ,G8EPVSXsOYB5YQWZGiz1aVq5Pgr2GrQu,6,4,1,0,1,0,2,0,8,1.1428571428571428,1,0.0,0,1,0,1,4,0,0,2,0,2,6,1
5836,119117,t1xspb1k3lEGBshWKCwAoW44MsPqXHk5,A3fsA9Zfv1X2fVEQhTw51lKENdNrEqT3,1,0,0,0,0,0,1,0,1,0.14285714285714285,1,0.0,0,0,0,0,0,0,0,1,0,0,1,1
5837,119131,NOm4CR7y4Aje7RwR2ZLNwhU4SfabY7lA,SpATywNh6bZuzm8s1ceuBUnMUAeoAHHw,10,58,33,0,3,0,7,0,101,14.428571428571429,1,0.0,20,33,0,3,38,0,0,7,0,56,45,1
5838,119143,YMxXtA5A6XX1bdm998q3OXZqnuIpo8I0,SpATywNh6bZuzm8s1ceuBUnMUAeoAHHw,9,24,9,0,0,0,7,0,40,5.714285714285714,2,0.0,7,9,0,0,17,0,0,7,0,16,24,0
5839,119159,rbbo6gYUB5I1wwOafpQCdj4m6UPXHmsz,SpATywNh6bZuzm8s1ceuBUnMUAeoAHHw,8,20,5,0,1,5,7,2,40,5.714285714285714,3,0.0,8,5,0,1,12,5,0,7,2,14,26,0
5840,119170,kd67Lm5QGeYWxcKJYnacCNFbyj5NIxDh,SpATywNh6bZuzm8s1ceuBUnMUAeoAHHw,8,5,1,12,1,0,2,0,21,3.0,1,0.0,2,1,10,1,3,0,2,2,0,14,7,0
5841,119185,mu7Zdr1ChN6xNMWE8Otd7Si7TQhm7pEQ,SpATywNh6bZuzm8s1ceuBUnMUAeoAHHw,9,20,2,0,2,0,12,1,37,5.285714285714286,3,0.0,2,2,0,2,18,0,0,12,1,6,31,0
5842,119192,NoA9xueUUthCTfidqnFplOKsMZsY3DHa,SpATywNh6bZuzm8s1ceuBUnMUAeoAHHw,13,16,7,4,3,0,3,0,33,4.714285714285714,2,0.0,6,7,4,3,10,0,0,3,0,20,13,1
5843,119204,okqN4nBVKRYYrkYonKicKGOmPqVGYjZh,G8EPVSXsOYB5YQWZGiz1aVq5Pgr2GrQu,5,5,2,0,0,0,5,0,12,1.7142857142857142,2,0.0,0,2,0,0,5,0,0,5,0,2,10,0
5844,119208,BnCTRJ1O4fVqlnxTGriZkJ9JZEc8p58K,A3fsA9Zfv1X2fVEQhTw51lKENdNrEqT3,1,0,0,0,0,0,2,0,2,0.2857142857142857,1,0.0,0,0,0,0,0,0,0,2,0,0,2,1
5845,119239,okqN4nBVKRYYrkYonKicKGOmPqVGYjZh,bWdj2GDclj5ofokWjzoa5jAwMkxCykd6,5,7,3,0,0,13,14,0,37,5.285714285714286,4,0.0,0,3,0,0,7,13,0,14,0,3,34,0
5846,119243,q3pPbgY0JhPpTgQfSrEbBAWd7rbmYjI4,SpATywNh6bZuzm8s1ceuBUnMUAeoAHHw,13,36,0,19,0,6,10,0,71,10.142857142857142,2,0.0,6,0,17,0,30,6,2,10,0,23,48,0
5847,119245,7RIgMHzHpMzY7qBXHPj6WiDKK3U9H2Wz,SpATywNh6bZuzm8s1ceuBUnMUAeoAHHw,14,30,19,0,8,0,25,1,83,11.857142857142858,6,0.0,0,19,0,8,30,0,0,25,1,27,56,0
5848,119265,8oiFYmMp7IOF1mfFRmhZ7Lug8ImrhTTO,SpATywNh6bZuzm8s1ceuBUnMUAeoAHHw,16,23,10,21,5,9,6,0,74,10.571428571428571,2,0.0,9,10,18,5,14,9,3,6,0,42,32,1
5849,119266,iacqYcgHTn7FZ8NE4roe5kgAUjDF0efr,SpATywNh6bZuzm8s1ceuBUnMUAeoAHHw,17,29,15,19,8,6,20,1,98,14.0,3,0.0,10,15,16,8,19,6,3,20,1,49,49,0
5850,119267,4eT20gUbOYkq3qXZQOFYEeSPNFVVnLrB,A3fsA9Zfv1X2fVEQhTw51lKENdNrEqT3,2,0,0,0,0,0,2,0,2,0.2857142857142857,1,0.0,0,0,0,0,0,0,0,2,0,0,2,1
5851,119290,AJAawUTIK5tTWvBfm3QRQhh9S7SsRdRA,SpATywNh6bZuzm8s1ceuBUnMUAeoAHHw,5,2,1,0,1,0,2,0,6,0.8571428571428571,1,0.0,0,1,0,1,2,0,0,2,0,2,4,1
5852,119294,tdyEqQ928g4zwLz7u1XUELM0nW67gqKU,G8EPVSXsOYB5YQWZGiz1aVq5Pgr2GrQu,11,18,7,0,5,5,16,1,52,7.428571428571429,2,0.0,5,7,0,5,13,5,0,16,1,17,35,1
5853,119305,kLbYKjAePyQg6GOXHiVGeoyhhDvXEfjN,SpATywNh6bZuzm8s1ceuBUnMUAeoAHHw,15,32,1,20,1,30,7,2,93,13.285714285714286,3,0.0,20,1,16,1,12,30,4,7,2,38,55,0
5854,119309,kWr0BhoQMxiu9wSeKhtyX0T1P5JfsERH,SpATywNh6bZuzm8s1ceuBUnMUAeoAHHw,17,21,10,17,3,60,26,2,139,19.857142857142858,3,0.0,2,10,15,3,19,60,2,26,2,30,109,0
5855,119325,grNuFIQJF1sOOkw8RJjaExhlwTJt52uU,SpATywNh6bZuzm8s1ceuBUnMUAeoAHHw,17,52,23,12,4,108,31,0,230,32.857142857142854,5,0.0,9,23,12,4,43,108,0,31,0,48,182,0
5856,119349,loZxBAFxFplmuCNvi9UHlWI1qnWbS4Xp,A3fsA9Zfv1X2fVEQhTw51lKENdNrEqT3,7,2,1,0,1,0,9,1,14,2.0,2,0.0,0,1,0,1,2,0,0,9,1,2,12,1
5857,119361,d0czHY9SleKhWFZVHkBc11jXgenCfeaE,SpATywNh6bZuzm8s1ceuBUnMUAeoAHHw,14,12,9,0,6,4,12,5,48,6.857142857142857,1,0.0,0,9,0,6,12,4,0,12,5,15,33,1
5858,119368,WfocL88obqufkiW8V6EsVJAto3ptM4se,RXDvfPUBYFlVdlueBFbLW0mhhAyGEqpt,11,6,0,0,0,1,8,2,17,2.4285714285714284,1,0.0,0,0,0,0,6,1,0,8,2,0,17,1
5859,119372,RwvuGEh3euIR11rktJrGBhzDqcQMkhOC,SpATywNh6bZuzm8s1ceuBUnMUAeoAHHw,17,44,20,8,8,0,17,1,98,14.0,6,0.0,15,20,8,8,29,0,0,17,1,51,47,0
5860,119395,W4swLEiF6xa4CU1Ee5z4jQMNXyEDiyxR,A3fsA9Zfv1X2fVEQhTw51lKENdNrEqT3,8,2,0,0,0,7,7,1,17,2.4285714285714284,1,0.0,0,0,0,0,2,7,0,7,1,0,17,1
5861,119406,qL29jh1ARNpuNbjWhIJAl20fDBQmsVJq,A3fsA9Zfv1X2fVEQhTw51lKENdNrEqT3,1,0,0,0,0,0,1,0,1,0.14285714285714285,1,0.0,0,0,0,0,0,0,0,1,0,0,1,1
5862,119413,HNjmezOX8bu6iW67SYkfKBzixQs4v7AY,SpATywNh6bZuzm8s1ceuBUnMUAeoAHHw,17,23,10,10,3,13,9,1,69,9.857142857142858,1,0.0,10,10,10,3,13,13,0,9,1,33,36,0
5863,119422,8bsgdKFaSfwROHIZCKXm97BMUW4OFzed,SpATywNh6bZuzm8s1ceuBUnMUAeoAHHw,15,15,6,10,3,0,3,0,37,5.285714285714286,2,0.0,7,6,8,3,8,0,2,3,0,24,13,0
5864,119437,WnuLHUQ0J3BeGgl165qL2l7BKuVDR3LS,RXDvfPUBYFlVdlueBFbLW0mhhAyGEqpt,42,54,3,119,2,2,7,2,189,27.0,2,0.0,10,3,112,2,44,2,7,7,2,127,62,0
5865,119446,XvNNzv39b8VqKid0q4fV9ms2wVNAdWks,A3fsA9Zfv1X2fVEQhTw51lKENdNrEqT3,1,0,0,0,0,0,1,0,1,0.14285714285714285,1,0.0,0,0,0,0,0,0,0,1,0,0,1,1
5866,119456,72z519PMt8GGBXLvF1FG0oMJuciCSWYJ,RXDvfPUBYFlVdlueBFbLW0mhhAyGEqpt,44,58,4,136,4,6,13,0,221,31.571428571428573,5,0.0,10,4,120,4,48,6,16,13,0,138,83,1
5867,119461,6ZwHbtvdiS8islxnPJXOOnLtMpvU3IpT,SpATywNh6bZuzm8s1ceuBUnMUAeoAHHw,13,12,6,0,6,0,7,2,33,4.714285714285714,2,0.0,3,6,0,6,9,0,0,7,2,15,18,0
5868,119482,S2q1gEPtloNcMfcAwTCrDjaeEJ3ox2aC,A3fsA9Zfv1X2fVEQhTw51lKENdNrEqT3,43,54,38,94,25,3,10,0,224,32.0,3,0.0,4,38,72,25,50,3,22,10,0,139,85,1
5869,119496,HJsFc87NFCDg5yRkkakXIT7nSH8XGxhF,A3fsA9Zfv1X2fVEQhTw51lKENdNrEqT3,9,4,3,0,3,0,2,0,12,1.7142857142857142,1,0.0,0,3,0,3,4,0,0,2,0,6,6,1
5870,119501,iWlNj0RlfLQkFgeY87o4tMiHnUMI1yTI,G8EPVSXsOYB5YQWZGiz1aVq5Pgr2GrQu,10,14,5,14,5,0,2,0,40,5.714285714285714,2,0.0,8,5,9,5,6,0,5,2,0,27,13,1
5871,119515,0mqsqXT4HPDOQPxpDnEoZEe1KeuUzpQx,SpATywNh6bZuzm8s1ceuBUnMUAeoAHHw,13,29,4,21,1,1,9,0,65,9.285714285714286,5,0.0,8,4,18,1,21,1,3,9,0,31,34,0
5872,119520,ZQcWT47pZxjNboL0V0inwxjvImMCbKfc,SpATywNh6bZuzm8s1ceuBUnMUAeoAHHw,14,60,18,18,7,0,11,0,114,16.285714285714285,4,0.0,4,18,15,7,56,0,3,11,0,44,70,0
5873,119544,NHjxa47feJ9sWQnmg6HoO6L78eHIRwnl,A3fsA9Zfv1X2fVEQhTw51lKENdNrEqT3,3,2,0,0,0,0,1,0,3,0.42857142857142855,1,0.0,0,0,0,0,2,0,0,1,0,0,3,1
5874,119547,NHjxa47feJ9sWQnmg6HoO6L78eHIRwnl,RXDvfPUBYFlVdlueBFbLW0mhhAyGEqpt,12,17,0,0,0,0,6,0,23,3.2857142857142856,1,0.0,1,0,0,0,16,0,0,6,0,1,22,1
5875,119555,72z519PMt8GGBXLvF1FG0oMJuciCSWYJ,A3fsA9Zfv1X2fVEQhTw51lKENdNrEqT3,7,8,1,0,1,0,1,0,11,1.5714285714285714,1,0.0,0,1,0,1,8,0,0,1,0,2,9,0
5876,119556,ZQcWT47pZxjNboL0V0inwxjvImMCbKfc,A3fsA9Zfv1X2fVEQhTw51lKENdNrEqT3,46,56,19,68,11,0,15,1,170,24.285714285714285,3,0.0,2,19,58,11,54,0,10,15,1,90,80,1
5877,119563,HbDZBLuVJ2GX78KybFnufJtg8yn0zj71,SpATywNh6bZuzm8s1ceuBUnMUAeoAHHw,12,12,8,9,6,0,2,0,37,5.285714285714286,1,0.0,3,8,7,6,9,0,2,2,0,24,13,1
5878,119570,vuz6r1wL6cSmPMYDw5wsdIxwDVSbQPGA,SpATywNh6bZuzm8s1ceuBUnMUAeoAHHw,7,3,2,0,2,0,2,0,9,1.2857142857142858,1,0.0,0,2,0,2,3,0,0,2,0,4,5,1
5879,119577,ZtIdVQN3EYruDP82MkDXBV4HsWJ99nHc,SpATywNh6bZuzm8s1ceuBUnMUAeoAHHw,11,7,0,6,0,7,15,1,36,5.142857142857143,2,0.0,0,0,5,0,7,7,1,15,1,5,31,1
5880,119580,TnET23MWjnuobi5dYEzVGlV9qd1ZWPbL,A3fsA9Zfv1X2fVEQhTw51lKENdNrEqT3,11,39,3,0,1,0,2,0,45,6.428571428571429,1,0.0,0,3,0,1,39,0,0,2,0,4,41,0
5881,119603,RwVsCYe1en11KhE66sG3vEW9DQBctFlb,SpATywNh6bZuzm8s1ceuBUnMUAeoAHHw,14,22,7,12,4,0,3,0,48,6.857142857142857,2,0.0,13,7,11,4,9,0,1,3,0,35,13,1
5882,119633,owff2SMFy8taj2Sp3iBe2dPorkqov8kW,SpATywNh6bZuzm8s1ceuBUnMUAeoAHHw,17,44,24,12,12,10,21,5,128,18.285714285714285,6,0.0,7,24,9,12,37,10,3,21,5,52,76,0
5883,119685,OOIu03NBEHePUSUIFa86FGFP5M136EAn,SpATywNh6bZuzm8s1ceuBUnMUAeoAHHw,7,10,6,0,3,0,4,0,23,3.2857142857142856,2,0.0,0,6,0,3,10,0,0,4,0,9,14,0
5884,119699,poqFOGQT2LdvIPHVhQsrQlPpawp1crlg,RXDvfPUBYFlVdlueBFbLW0mhhAyGEqpt,22,72,30,11,26,5,2,0,146,20.857142857142858,3,0.0,0,30,10,26,72,5,1,2,0,66,80,0
5885,119700,6PXcyDdGgas03jfN9GNBg7eDbTNLi58b,A3fsA9Zfv1X2fVEQhTw51lKENdNrEqT3,42,27,13,66,9,0,8,0,123,17.571428571428573,1,0.0,2,13,56,9,25,0,10,8,0,80,43,1
5886,119706,4aBimyYkJ2UKqGpkp7oZ1zAX2svcfueq,SpATywNh6bZuzm8s1ceuBUnMUAeoAHHw,10,4,3,0,3,0,2,0,12,1.7142857142857142,1,0.0,0,3,0,3,4,0,0,2,0,6,6,1
5887,119718,GB4yB9EIEjt1Ja66w5VOBhvDfHhUpkZn,G8EPVSXsOYB5YQWZGiz1aVq5Pgr2GrQu,10,9,7,0,6,0,3,0,25,3.5714285714285716,2,0.0,0,7,0,6,9,0,0,3,0,13,12,1
5888,119720,k6RJ44LpfDefc4BqSfb5Ks3bqRLzpbPs,A3fsA9Zfv1X2fVEQhTw51lKENdNrEqT3,9,8,0,0,0,0,2,0,10,1.4285714285714286,1,0.0,0,0,0,0,8,0,0,2,0,0,10,1
5889,119730,6ap3DhKROc7tFODwClFOjVJl3s3EA3mu,G8EPVSXsOYB5YQWZGiz1aVq5Pgr2GrQu,18,27,17,10,18,0,18,0,90,12.857142857142858,3,0.0,7,17,7,18,20,0,3,18,0,49,41,1
5890,119735,7spTo5lIRwZxDBcGilRyFIwiDfkCxjQE,SpATywNh6bZuzm8s1ceuBUnMUAeoAHHw,14,25,0,24,0,22,11,0,82,11.714285714285714,3,0.0,12,0,20,0,13,22,4,11,0,32,50,1
5891,119742,PHTS4r6mOEHpVZfm3SzAd9KLg785EPpx,SpATywNh6bZuzm8s1ceuBUnMUAeoAHHw,17,37,16,12,8,31,15,2,121,17.285714285714285,4,0.0,3,16,12,8,34,31,0,15,2,39,82,0
5892,119749,r81fu0o4ondjTT64GPXMD4igVXZTnWR1,G8EPVSXsOYB5YQWZGiz1aVq5Pgr2GrQu,1,0,0,0,0,0,2,0,2,0.2857142857142857,1,0.0,0,0,0,0,0,0,0,2,0,0,2,1
5893,119758,VbCHzxhJd8ennilHHm3zMG389MZjcR4g,SpATywNh6bZuzm8s1ceuBUnMUAeoAHHw,5,3,1,0,1,0,2,0,7,1.0,1,0.0,0,1,0,1,3,0,0,2,0,2,5,0
5894,119759,eXv6ACzt62C4hMSoDSIQMvmz4LEnGBtm,SpATywNh6bZuzm8s1ceuBUnMUAeoAHHw,12,25,9,20,0,16,20,3,93,13.285714285714286,4,0.0,7,9,16,0,18,16,4,20,3,32,61,0
5895,119767,OXe0TiHLRyjl3AO2ffihLeA3ZfDF07jU,SpATywNh6bZuzm8s1ceuBUnMUAeoAHHw,6,5,2,0,1,0,1,0,9,1.2857142857142858,1,0.0,0,2,0,1,5,0,0,1,0,3,6,1
5896,119775,Hvo87huFBpCunolEWjcvbDUcmX9h25rT,SpATywNh6bZuzm8s1ceuBUnMUAeoAHHw,12,11,8,0,5,1,7,1,33,4.714285714285714,1,0.0,0,8,0,5,11,1,0,7,1,13,20,1
5897,119791,WdCL06lQKY0BoTH9YYJuYqUtT5XtLkKl,A3fsA9Zfv1X2fVEQhTw51lKENdNrEqT3,1,0,0,0,0,0,1,0,1,0.14285714285714285,1,0.0,0,0,0,0,0,0,0,1,0,0,1,1
5898,119802,pgn1580cn8cQemEJzrm47II2SqctZZrK,G8EPVSXsOYB5YQWZGiz1aVq5Pgr2GrQu,3,2,0,0,0,0,1,0,3,0.42857142857142855,1,0.0,0,0,0,0,2,0,0,1,0,0,3,0
5899,119807,ABAPRQWSFErhHUFQsJmCoj4Rpg4DtQ8w,bWdj2GDclj5ofokWjzoa5jAwMkxCykd6,2,0,0,0,0,0,3,0,3,0.42857142857142855,1,0.0,0,0,0,0,0,0,0,3,0,0,3,1
5900,119825,xwG9GgMrPHgbqqrlvclpGJMpSPdOCjxQ,A3fsA9Zfv1X2fVEQhTw51lKENdNrEqT3,6,6,0,0,0,0,2,0,8,1.1428571428571428,2,0.0,1,0,0,0,5,0,0,2,0,1,7,1
5901,119836,GyWTABuPpZEqO585EnNTIpM2B2faPYN3,A3fsA9Zfv1X2fVEQhTw51lKENdNrEqT3,8,7,5,0,3,0,3,0,18,2.5714285714285716,1,0.0,0,5,0,3,7,0,0,3,0,8,10,1
5902,119878,T7izEMyckZ14Dpb0HXCCbCEgRCtemG2v,A3fsA9Zfv1X2fVEQhTw51lKENdNrEqT3,6,4,1,0,0,0,5,0,10,1.4285714285714286,2,0.0,0,1,0,0,4,0,0,5,0,1,9,1
5903,119896,c4MI9OfbyJ0RGX9j0ZiKqfaHb3fSOPCp,SpATywNh6bZuzm8s1ceuBUnMUAeoAHHw,9,21,1,11,0,0,6,0,39,5.571428571428571,2,0.0,10,1,11,0,11,0,0,6,0,22,17,1
5904,119898,7nQB7cjVdr2HijR82OoX1oMRPa42JjfY,A3fsA9Zfv1X2fVEQhTw51lKENdNrEqT3,13,7,5,0,2,2,8,1,25,3.5714285714285716,2,0.0,0,5,0,2,7,2,0,8,1,7,18,1
5905,119907,Tlrkgpa05toeVrZOHafHN5HVS3Ley7hG,A3fsA9Zfv1X2fVEQhTw51lKENdNrEqT3,5,4,2,0,0,0,4,0,10,1.4285714285714286,3,0.0,0,2,0,0,4,0,0,4,0,2,8,1
5906,119923,nrDkIZH2wqEVh6i4pBxcbRBJIMc9s20b,SpATywNh6bZuzm8s1ceuBUnMUAeoAHHw,12,51,1,18,0,0,13,0,83,11.857142857142858,5,0.0,18,1,15,0,33,0,3,13,0,34,49,0
5907,119935,4uCHoIviHPzCtwadirbZDGuLNqx4H5qx,SpATywNh6bZuzm8s1ceuBUnMUAeoAHHw,15,29,14,21,3,0,8,0,75,10.714285714285714,2,0.0,10,14,17,3,19,0,4,8,0,44,31,0
5908,119938,hdh7f9dbamC5OLbnjQIw5ciTwmy2oqSe,A3fsA9Zfv1X2fVEQhTw51lKENdNrEqT3,22,24,19,0,16,0,7,0,66,9.428571428571429,3,0.0,0,19,0,16,24,0,0,7,0,35,31,1
5909,119947,jnIQMhy9SQ2YnxY9vLXkaYJhqSTRkdV3,SpATywNh6bZuzm8s1ceuBUnMUAeoAHHw,17,31,10,7,4,0,6,0,58,8.285714285714286,2,0.0,18,10,7,4,13,0,0,6,0,39,19,1
5910,119960,4TtGjmtd4ISORDD5okRgx7kXAcGUW8IN,RXDvfPUBYFlVdlueBFbLW0mhhAyGEqpt,8,4,3,0,1,4,4,1,17,2.4285714285714284,1,0.0,0,3,0,1,4,4,0,4,1,4,13,1
5911,119974,VLq5RjmauxaFZfPnx2f9r9Dehjw868o9,SpATywNh6bZuzm8s1ceuBUnMUAeoAHHw,17,25,13,11,7,6,12,2,76,10.857142857142858,4,0.0,2,13,11,7,23,6,0,12,2,33,43,0
5912,119981,hNJz0qbOhrUgajUkzqSdDbybHkuRglfs,A3fsA9Zfv1X2fVEQhTw51lKENdNrEqT3,39,21,15,56,9,1,8,1,111,15.857142857142858,2,0.0,3,15,48,9,18,1,8,8,1,75,36,0
5913,119983,8ZvgmVWPuU4xKWq9tw3YZdhhMDnHsFgT,SpATywNh6bZuzm8s1ceuBUnMUAeoAHHw,16,45,7,12,2,37,29,3,135,19.285714285714285,6,0.0,12,7,11,2,33,37,1,29,3,32,103,0
5914,119991,EjqS3A2Iv9J8JTjinbKy3gdtrrXaSQyJ,bWdj2GDclj5ofokWjzoa5jAwMkxCykd6,3,2,1,0,0,0,1,0,4,0.5714285714285714,1,0.0,0,1,0,0,2,0,0,1,0,1,3,1
5915,119993,GMzSpgZQ6jzVsfHn8W8i83JsYNxnP00b,A3fsA9Zfv1X2fVEQhTw51lKENdNrEqT3,5,3,2,0,1,0,1,0,7,1.0,1,0.0,0,2,0,1,3,0,0,1,0,3,4,1
5916,120004,4mdszhiojUd6ka3AsjiiGyQ3X7W5E7uc,A3fsA9Zfv1X2fVEQhTw51lKENdNrEqT3,1,0,0,0,0,0,2,0,2,0.2857142857142857,2,0.0,0,0,0,0,0,0,0,2,0,0,2,1
5917,120015,4YCZfbR5vSUmQm9JKU53CaLT4o7zzhD5,A3fsA9Zfv1X2fVEQhTw51lKENdNrEqT3,1,0,0,0,0,0,1,0,1,0.14285714285714285,1,0.0,0,0,0,0,0,0,0,1,0,0,1,1
5918,120019,eC4QFVNRkDMJURDQ2ZX8Orvtuy3F8ILJ,SpATywNh6bZuzm8s1ceuBUnMUAeoAHHw,11,14,1,24,0,0,2,0,41,5.857142857142857,1,0.0,8,1,19,0,6,0,5,2,0,28,13,1
5919,120021,xr2T8ak6swOOfU9oanYvPbQ4STab9s9f,bWdj2GDclj5ofokWjzoa5jAwMkxCykd6,7,9,1,0,0,0,13,0,23,3.2857142857142856,4,0.0,1,1,0,0,8,0,0,13,0,2,21,1
5920,120026,ZH0VWJ7XJWogjYH6Qq2Nr4TMh6fe5JGW,SpATywNh6bZuzm8s1ceuBUnMUAeoAHHw,5,14,1,0,0,0,2,0,17,2.4285714285714284,1,0.0,0,1,0,0,14,0,0,2,0,1,16,0
5921,120032,n58OZShh1DSriRlOeR7KzkMLpM8Ixh01,A3fsA9Zfv1X2fVEQhTw51lKENdNrEqT3,2,0,0,0,0,0,3,0,3,0.42857142857142855,1,0.0,0,0,0,0,0,0,0,3,0,0,3,1
5922,120078,saXRSf4MnhO78zgLoljZlslavqJjBtLm,bWdj2GDclj5ofokWjzoa5jAwMkxCykd6,16,73,6,60,6,44,17,0,206,29.428571428571427,2,0.0,20,6,54,6,53,44,6,17,0,86,120,1
5923,120088,ZOVfvlm206voHlGJ4V6McNGjtxTxB7JQ,A3fsA9Zfv1X2fVEQhTw51lKENdNrEqT3,7,4,3,0,2,0,3,0,12,1.7142857142857142,2,0.0,0,3,0,2,4,0,0,3,0,5,7,1
5924,120097,5pfeeYLWSB4wCSWnPZbrmiSBS3yXgMsk,bWdj2GDclj5ofokWjzoa5jAwMkxCykd6,6,3,1,0,1,0,2,0,7,1.0,1,0.0,0,1,0,1,3,0,0,2,0,2,5,1
5925,120100,JdKnU2sktk6AZyjwyIqgEXYK8OtgPCn2,bWdj2GDclj5ofokWjzoa5jAwMkxCykd6,9,7,3,0,12,0,2,0,24,3.4285714285714284,1,0.0,0,3,0,12,7,0,0,2,0,15,9,0
5926,120111,aGyzysUQgcpficWqTygk8rcuo677dPZU,SpATywNh6bZuzm8s1ceuBUnMUAeoAHHw,16,33,3,26,4,29,13,2,110,15.714285714285714,3,0.0,15,3,23,4,18,29,3,13,2,45,65,0
5927,120118,cPZ5ch8V46zptI5nnRGh9SfMnAQrVDUi,bWdj2GDclj5ofokWjzoa5jAwMkxCykd6,12,29,18,0,12,7,10,0,76,10.857142857142858,3,0.0,4,18,0,12,25,7,0,10,0,34,42,0
5928,120126,c6XaDpje2iQSWpoXkTtf00BW6tACh6Q9,SpATywNh6bZuzm8s1ceuBUnMUAeoAHHw,17,48,21,19,8,20,22,2,140,20.0,3,0.0,7,21,16,8,41,20,3,22,2,52,88,0
5929,120134,nKMPTOF6v1sp7aVmO78zmSRg9f9QXrTf,A3fsA9Zfv1X2fVEQhTw51lKENdNrEqT3,9,9,5,0,4,0,4,0,22,3.142857142857143,3,0.0,0,5,0,4,9,0,0,4,0,9,13,1
5930,120149,LY15AitabC9VNRy9N91XwsKL39G9Yhym,SpATywNh6bZuzm8s1ceuBUnMUAeoAHHw,16,21,11,14,6,14,8,4,78,11.142857142857142,2,0.0,6,11,11,6,15,14,3,8,4,34,44,1
5931,120153,la15uCtK5VeDQX41dystrGx2B895Oqjw,RXDvfPUBYFlVdlueBFbLW0mhhAyGEqpt,40,63,36,72,24,9,6,3,213,30.428571428571427,2,0.0,18,36,69,24,45,9,3,6,3,147,66,1
5932,120171,ThGblU6q4nWmu3ORXgM7eQc8q9vcBP4r,A3fsA9Zfv1X2fVEQhTw51lKENdNrEqT3,4,2,1,0,0,0,7,0,10,1.4285714285714286,2,0.0,0,1,0,0,2,0,0,7,0,1,9,1
5933,120177,83cBV2IXkwoW1nUaa1kxaJ98L3bxFsPn,A3fsA9Zfv1X2fVEQhTw51lKENdNrEqT3,18,36,30,0,5,0,8,0,79,11.285714285714286,5,0.0,0,30,0,5,36,0,0,8,0,35,44,0
5934,120181,yBsDX1Dsw9hy8f2NuaeMfD0tvX413Igw,bWdj2GDclj5ofokWjzoa5jAwMkxCykd6,2,0,0,0,0,0,2,0,2,0.2857142857142857,1,0.0,0,0,0,0,0,0,0,2,0,0,2,0
5935,120196,qLscbApWydA7z1h7Ht7RN2UnF0mvGZpF,SpATywNh6bZuzm8s1ceuBUnMUAeoAHHw,14,22,1,15,1,0,4,0,43,6.142857142857143,1,0.0,5,1,12,1,17,0,3,4,0,19,24,1
5936,120204,cQbl9j85owwXzcR0zsrhIz1wkEuaLsqG,A3fsA9Zfv1X2fVEQhTw51lKENdNrEqT3,1,0,0,0,0,0,1,0,1,0.14285714285714285,1,0.0,0,0,0,0,0,0,0,1,0,0,1,1
5937,120211,WfK8spzPGQgUUjtYsrbByJpvEEqSCjRx,A3fsA9Zfv1X2fVEQhTw51lKENdNrEqT3,1,0,0,0,0,0,1,0,1,0.14285714285714285,1,0.0,0,0,0,0,0,0,0,1,0,0,1,1
5938,120230,LY15AitabC9VNRy9N91XwsKL39G9Yhym,G8EPVSXsOYB5YQWZGiz1aVq5Pgr2GrQu,7,14,1,0,1,0,5,0,21,3.0,2,0.0,0,1,0,1,14,0,0,5,0,2,19,1
5939,120240,YYie2sncdtzNtDvv2HrWAX3WcnBaHhtH,A3fsA9Zfv1X2fVEQhTw51lKENdNrEqT3,10,3,2,0,2,0,5,1,13,1.8571428571428572,1,0.0,0,2,0,2,3,0,0,5,1,4,9,1
5940,120251,qY3mO9VSgbSXrTZIckLWUEq4U741QpCT,SpATywNh6bZuzm8s1ceuBUnMUAeoAHHw,18,34,13,12,3,2,11,1,76,10.857142857142858,1,0.0,18,13,12,3,16,2,0,11,1,46,30,0
5941,120255,3nXqsLutTeQFNz1Ya8GTFnWUmV4VnYmX,SpATywNh6bZuzm8s1ceuBUnMUAeoAHHw,13,15,2,17,1,1,4,1,41,5.857142857142857,2,0.0,6,2,15,1,9,1,2,4,1,24,17,1
5942,120257,FsHh7NEicgBmDLs5h5Swts1JnEA5erYu,A3fsA9Zfv1X2fVEQhTw51lKENdNrEqT3,1,0,0,0,0,0,2,0,2,0.2857142857142857,1,0.0,0,0,0,0,0,0,0,2,0,0,2,1
5943,120270,oh70wjHZNiJm6YMEO2zTeIrDQMUiqmDd,A3fsA9Zfv1X2fVEQhTw51lKENdNrEqT3,9,10,0,0,0,0,1,0,11,1.5714285714285714,1,0.0,1,0,0,0,9,0,0,1,0,1,10,1
5944,120284,1cxiENcEp3mVuj0hieZU2n66DvVX0lKj,A3fsA9Zfv1X2fVEQhTw51lKENdNrEqT3,8,2,0,0,0,2,10,1,15,2.142857142857143,1,0.0,0,0,0,0,2,2,0,10,1,0,15,1
5945,120285,G6cW0d2bzLHgB0vreFbhNx3GSiMBKbtv,A3fsA9Zfv1X2fVEQhTw51lKENdNrEqT3,40,23,10,48,9,0,3,0,93,13.285714285714286,2,0.0,2,10,46,9,21,0,2,3,0,67,26,1
5946,120287,JdKnU2sktk6AZyjwyIqgEXYK8OtgPCn2,A3fsA9Zfv1X2fVEQhTw51lKENdNrEqT3,11,11,5,0,3,0,3,1,23,3.2857142857142856,1,0.0,0,5,0,3,11,0,0,3,1,8,15,1
5947,120323,HZLnsnoiGm4WW2vjutmDoR0ipnBBZA4G,A3fsA9Zfv1X2fVEQhTw51lKENdNrEqT3,23,25,19,0,15,0,9,0,68,9.714285714285714,2,0.0,0,19,0,15,25,0,0,9,0,34,34,1
5948,120325,iG6MpbqzKA4jDaDFNYLj8a74oKQT8YWZ,A3fsA9Zfv1X2fVEQhTw51lKENdNrEqT3,2,0,0,0,0,0,4,0,4,0.5714285714285714,1,0.0,0,0,0,0,0,0,0,4,0,0,4,1
5949,120337,KDeaSgZ6wTHm30JcQgLQFVdVYbxH0KHc,SpATywNh6bZuzm8s1ceuBUnMUAeoAHHw,8,12,5,0,3,0,2,0,22,3.142857142857143,1,0.0,2,5,0,3,10,0,0,2,0,10,12,1
5950,120365,aXiJW8ayzWdjAFuCXJZEkZEM0lQLoZYD,bWdj2GDclj5ofokWjzoa5jAwMkxCykd6,9,16,4,0,2,5,11,1,39,5.571428571428571,1,0.0,4,4,0,2,12,5,0,11,1,10,29,1
5951,120371,XQgYe2uvAKPXdUiz5f6AHKp9LdPbPxAU,A3fsA9Zfv1X2fVEQhTw51lKENdNrEqT3,4,2,1,0,1,0,1,0,5,0.7142857142857143,1,0.0,0,1,0,1,2,0,0,1,0,2,3,1
5952,120399,tQgPfoIxEUrRTpkUJ12lc7yYMouZEU13,SpATywNh6bZuzm8s1ceuBUnMUAeoAHHw,6,5,1,0,1,0,6,0,13,1.8571428571428572,1,0.0,0,1,0,1,5,0,0,6,0,2,11,1
5953,120402,Y2MWDCkue2rmZywdTMYpTi8OGrxwTILf,A3fsA9Zfv1X2fVEQhTw51lKENdNrEqT3,1,0,0,0,0,0,1,0,1,0.14285714285714285,1,0.0,0,0,0,0,0,0,0,1,0,0,1,1
5954,120404,NYt3HW4iIDKFfkoDHUmE2GfhEi6C8Rqu,A3fsA9Zfv1X2fVEQhTw51lKENdNrEqT3,8,9,3,0,2,0,6,0,20,2.857142857142857,2,0.0,1,3,0,2,8,0,0,6,0,6,14,1
5955,120406,7Tzl2OTGekrrZ1AXSNaODNbj4vnVdNB2,G8EPVSXsOYB5YQWZGiz1aVq5Pgr2GrQu,8,2,0,0,0,25,14,2,43,6.142857142857143,1,0.0,0,0,0,0,2,25,0,14,2,0,43,0
5956,120412,JPQfQe2O1MgBbogZcbI6qUWraQxSj98z,A3fsA9Zfv1X2fVEQhTw51lKENdNrEqT3,1,0,0,0,0,0,1,0,1,0.14285714285714285,1,0.0,0,0,0,0,0,0,0,1,0,0,1,1
5957,120415,lk6sSo2mEoREiTaQjIlY6dKahZkFRKmP,bWdj2GDclj5ofokWjzoa5jAwMkxCykd6,18,21,9,66,6,0,8,0,110,15.714285714285714,2,0.0,6,9,60,6,15,0,6,8,0,81,29,1
5958,120419,ozv3HO6eArxO9HBSOsAR70hZyYDwrV65,A3fsA9Zfv1X2fVEQhTw51lKENdNrEqT3,6,2,1,0,1,0,5,0,9,1.2857142857142858,1,0.0,0,1,0,1,2,0,0,5,0,2,7,1
5959,120421,ouTwCUFDa5PRzaHQSaChM41Y1q02nIPV,SpATywNh6bZuzm8s1ceuBUnMUAeoAHHw,7,7,0,4,0,2,1,0,14,2.0,2,0.0,2,0,3,0,5,2,1,1,0,5,9,1
5960,120435,OifsLGRBGBgFFNsSrNDnK5W8Vbn9qLGX,SpATywNh6bZuzm8s1ceuBUnMUAeoAHHw,6,19,1,0,0,0,0,0,20,2.857142857142857,3,0.0,0,1,0,0,19,0,0,0,0,1,19,1
5961,120457,1La5rp9ZSz9cfpqCRJiC01Rwvuq5VVrf,SpATywNh6bZuzm8s1ceuBUnMUAeoAHHw,11,9,4,12,3,0,6,0,34,4.857142857142857,4,0.0,4,4,12,3,5,0,0,6,0,23,11,0
5962,120460,5MOHfgPntZIsRWkQebauzpUgUSaHvhFJ,bWdj2GDclj5ofokWjzoa5jAwMkxCykd6,5,4,2,0,1,0,3,0,10,1.4285714285714286,2,0.0,0,2,0,1,4,0,0,3,0,3,7,1
5963,120465,oldypK1fqRkEbCk0bKZUJxOdwxxRRKXf,A3fsA9Zfv1X2fVEQhTw51lKENdNrEqT3,9,6,1,0,1,0,4,0,12,1.7142857142857142,1,0.0,0,1,0,1,6,0,0,4,0,2,10,1
5964,120471,I6qoCcohBrCkqxmkans73ezft5aIvcN6,SpATywNh6bZuzm8s1ceuBUnMUAeoAHHw,3,3,0,0,0,0,2,0,5,0.7142857142857143,1,0.0,2,0,0,0,1,0,0,2,0,2,3,1
5965,120480,GJdrQdNnhszyte4F0GpLkVjDN5SstsoH,SpATywNh6bZuzm8s1ceuBUnMUAeoAHHw,14,10,0,15,0,1,6,1,33,4.714285714285714,3,0.0,2,0,15,0,8,1,0,6,1,17,16,0
5966,120489,MgS6WK9esRya9QyP2ZOjbNdLSIL7NuM9,bWdj2GDclj5ofokWjzoa5jAwMkxCykd6,13,10,5,20,3,2,9,0,49,7.0,2,0.0,1,5,20,3,9,2,0,9,0,29,20,0
5967,120505,QZQvnzqgk3ZJQavig3cFuZehXC8CHrPm,bWdj2GDclj5ofokWjzoa5jAwMkxCykd6,14,41,9,64,15,0,7,0,136,19.428571428571427,2,0.0,28,9,60,15,13,0,4,7,0,112,24,1
5968,120533,vEaXPhyTYPOxUDFFnNSxdj1qZ39pJLBH,A3fsA9Zfv1X2fVEQhTw51lKENdNrEqT3,6,3,2,0,2,0,5,0,12,1.7142857142857142,1,0.0,0,2,0,2,3,0,0,5,0,4,8,1
5969,120538,kJkXo4nSNqbMETrXDpi6P9tfSt1mYjrM,SpATywNh6bZuzm8s1ceuBUnMUAeoAHHw,17,31,14,17,7,0,15,0,84,12.0,4,0.0,12,14,15,7,19,0,2,15,0,48,36,1
5970,120540,U0zx3N1uSd1t4oNG6aeia4oGy5qrTYII,SpATywNh6bZuzm8s1ceuBUnMUAeoAHHw,5,2,1,0,1,0,3,0,7,1.0,1,0.0,0,1,0,1,2,0,0,3,0,2,5,1
5971,120547,6T4qq3cdISFF5pyvVKMrcmEINY6BysCY,A3fsA9Zfv1X2fVEQhTw51lKENdNrEqT3,10,3,2,0,2,1,5,0,13,1.8571428571428572,1,0.0,0,2,0,2,3,1,0,5,0,4,9,0
5972,120567,VL7NPBJuyzF1uV3nhlsl7JEimjvq8BIB,SpATywNh6bZuzm8s1ceuBUnMUAeoAHHw,14,7,4,6,3,4,8,0,32,4.571428571428571,2,0.0,2,4,6,3,5,4,0,8,0,15,17,0
5973,120570,EIpkB0c46fQRf924Hrf1SRiPLyg6N4rm,RXDvfPUBYFlVdlueBFbLW0mhhAyGEqpt,8,4,1,0,1,0,2,0,8,1.1428571428571428,1,0.0,0,1,0,1,4,0,0,2,0,2,6,1
5974,120571,ZcwgBhx2C5CsYaUWf4YQ2u1SWzTYaxss,A3fsA9Zfv1X2fVEQhTw51lKENdNrEqT3,11,10,3,0,2,1,14,1,31,4.428571428571429,2,0.0,6,3,0,2,4,1,0,14,1,11,20,0
5975,120576,WIgM6nvV9YFBo82xFhtQp6923xmcbs69,SpATywNh6bZuzm8s1ceuBUnMUAeoAHHw,11,13,9,3,0,0,6,0,31,4.428571428571429,3,0.0,1,9,3,0,12,0,0,6,0,13,18,0
5976,120580,tepLda5wSKMdrl1YSxQ7o9ErmWSmjLIs,SpATywNh6bZuzm8s1ceuBUnMUAeoAHHw,7,8,4,0,2,0,6,0,20,2.857142857142857,2,0.0,0,4,0,2,8,0,0,6,0,6,14,0
5977,120586,cOTtp4pVPpt9GEFdMZaLCIG1IBXouqo8,A3fsA9Zfv1X2fVEQhTw51lKENdNrEqT3,1,0,0,0,0,0,1,0,1,0.14285714285714285,1,0.0,0,0,0,0,0,0,0,1,0,0,1,1
5978,120628,T84tM0SY1NeTwy8ZOUv1K7SYM12l3y0u,SpATywNh6bZuzm8s1ceuBUnMUAeoAHHw,1,0,0,0,0,0,1,0,1,0.14285714285714285,1,0.0,0,0,0,0,0,0,0,1,0,0,1,1
5979,120634,EDLvNoRIb3gHoThJ1NoAuBrT3yJGczm3,A3fsA9Zfv1X2fVEQhTw51lKENdNrEqT3,2,0,0,0,0,0,4,0,4,0.5714285714285714,1,0.0,0,0,0,0,0,0,0,4,0,0,4,1
5980,120650,AqOYZE1KwO9ElxY4ESIL8wZt1KCX4QiQ,SpATywNh6bZuzm8s1ceuBUnMUAeoAHHw,16,28,11,13,5,16,8,1,82,11.714285714285714,4,0.0,6,11,10,5,22,16,3,8,1,32,50,0
5981,120680,Mv7oSGs75OaCjYLhHCNmqqrqaAjjO5gs,A3fsA9Zfv1X2fVEQhTw51lKENdNrEqT3,1,0,0,0,0,0,1,0,1,0.14285714285714285,1,0.0,0,0,0,0,0,0,0,1,0,0,1,1
5982,120683,1U4BCdHxNjp4LH6S6L2sowJaRSmQKYKF,A3fsA9Zfv1X2fVEQhTw51lKENdNrEqT3,5,8,1,0,1,0,5,0,15,2.142857142857143,2,0.0,0,1,0,1,8,0,0,5,0,2,13,1
5983,120706,RrLCYgvxi3oib8ZNMGweT91KCXFbFqgQ,A3fsA9Zfv1X2fVEQhTw51lKENdNrEqT3,8,8,3,0,1,0,3,0,15,2.142857142857143,1,0.0,0,3,0,1,8,0,0,3,0,4,11,1
5984,120707,YBlpuOz29CjjHYq0RuGLiSzLtjKLdYy2,RXDvfPUBYFlVdlueBFbLW0mhhAyGEqpt,22,32,2,16,2,0,10,0,62,8.857142857142858,3,0.0,6,2,15,2,26,0,1,10,0,25,37,0
5985,120743,es5GTyNQHE6XqsHqRasxkSTkn6q7y8k2,SpATywNh6bZuzm8s1ceuBUnMUAeoAHHw,12,17,7,12,1,4,4,1,46,6.571428571428571,2,0.0,6,7,11,1,11,4,1,4,1,25,21,0
5986,120744,dvGlk7sqlRtsNklrx9jTekm5CnQWuhDQ,SpATywNh6bZuzm8s1ceuBUnMUAeoAHHw,15,18,9,17,3,0,7,0,54,7.714285714285714,3,0.0,6,9,17,3,12,0,0,7,0,35,19,1
5987,120768,lu6LWsHgfburMRdWsFabIR2bIQ3MFD6f,RXDvfPUBYFlVdlueBFbLW0mhhAyGEqpt,36,29,11,70,9,4,6,0,129,18.428571428571427,3,0.0,11,11,63,9,18,4,7,6,0,94,35,0
5988,120769,9ejhHF65VDeA89TY7yPYCEx8qdV4K69n,A3fsA9Zfv1X2fVEQhTw51lKENdNrEqT3,6,5,3,0,1,0,7,0,16,2.2857142857142856,1,0.0,0,3,0,1,5,0,0,7,0,4,12,1
5989,120800,7bnGjPq4sg9VhmEEoEqqXHNgeEpEuUDV,bWdj2GDclj5ofokWjzoa5jAwMkxCykd6,8,7,3,0,1,14,5,3,33,4.714285714285714,1,0.0,0,3,0,1,7,14,0,5,3,4,29,0
5990,120851,dJq8sIYKCGcPSHpIrI20rFWCk7jAqAdY,A3fsA9Zfv1X2fVEQhTw51lKENdNrEqT3,8,4,3,0,3,0,1,0,11,1.5714285714285714,1,0.0,0,3,0,3,4,0,0,1,0,6,5,1
5991,120878,edVuZXQuYE4LHUfAzzB1uGhpYsPr0vJx,SpATywNh6bZuzm8s1ceuBUnMUAeoAHHw,17,20,7,18,4,5,5,2,61,8.714285714285714,1,0.0,6,7,15,4,14,5,3,5,2,32,29,0
5992,120893,xb9WJcv3uIYBfZD9WqegvIpYdxaUF3h5,bWdj2GDclj5ofokWjzoa5jAwMkxCykd6,4,3,0,0,0,0,2,0,5,0.7142857142857143,1,0.0,0,0,0,0,3,0,0,2,0,0,5,1
5993,120896,u5ObOMoHUcvVsOQTGkiv0BRKKcn8v2w8,A3fsA9Zfv1X2fVEQhTw51lKENdNrEqT3,13,14,8,0,5,0,6,0,33,4.714285714285714,1,0.0,2,8,0,5,12,0,0,6,0,15,18,0
5994,120904,kFp6IoufrvIevAVHehiSDqUBNzpbkI6L,bWdj2GDclj5ofokWjzoa5jAwMkxCykd6,15,24,13,28,5,23,21,1,115,16.428571428571427,4,0.0,2,13,26,5,22,23,2,21,1,46,69,0
5995,120927,4bcOXBC1lhgwF9Pg3IMx9vJFVwNtFyik,SpATywNh6bZuzm8s1ceuBUnMUAeoAHHw,14,18,11,2,4,1,12,0,48,6.857142857142857,2,0.0,0,11,2,4,18,1,0,12,0,17,31,1
5996,120936,i0ksX07HnsV5rQlWqOr1uKEuc7yNU24c,A3fsA9Zfv1X2fVEQhTw51lKENdNrEqT3,45,21,14,68,9,10,18,3,143,20.428571428571427,4,0.0,3,14,56,9,18,10,12,18,3,82,61,0
5997,120940,KkBPwixR7onoXlZ2HnK8cYokgUE3P396,bWdj2GDclj5ofokWjzoa5jAwMkxCykd6,5,2,0,0,0,0,6,0,8,1.1428571428571428,2,0.0,0,0,0,0,2,0,0,6,0,0,8,1
5998,120953,HGkuwdB1J817cl9wl529SZa2OTu14HFB,SpATywNh6bZuzm8s1ceuBUnMUAeoAHHw,15,12,5,20,3,0,6,0,46,6.571428571428571,1,0.0,6,5,17,3,6,0,3,6,0,31,15,0
5999,120983,Tg9kFmEr6KGEyzeoopWvQ3WCSPhx01lk,SpATywNh6bZuzm8s1ceuBUnMUAeoAHHw,17,18,11,15,4,5,24,4,81,11.571428571428571,3,0.0,2,11,14,4,16,5,1,24,4,31,50,1
6000,120998,y7Z8jSjEija2cXP8zDhgGRVfac5fnMAR,SpATywNh6bZuzm8s1ceuBUnMUAeoAHHw,5,6,0,0,0,0,2,0,8,1.1428571428571428,2,0.0,0,0,0,0,6,0,0,2,0,0,8,1
6001,121001,k2w7Fl2HRg9SZoDIHFnK8RXCKuBBE2y7,A3fsA9Zfv1X2fVEQhTw51lKENdNrEqT3,41,20,13,50,9,26,10,0,128,18.285714285714285,3,0.0,1,13,45,9,19,26,5,10,0,68,60,1
6002,121085,hWWjbjEJOX0Ph07p1EJp8Ya48hU8wP5v,SpATywNh6bZuzm8s1ceuBUnMUAeoAHHw,15,35,16,22,10,0,8,0,91,13.0,2,0.0,2,16,19,10,33,0,3,8,0,47,44,0
6003,121101,34fQh4AyuAWML6hByTmQJCsftdAFH2Hu,SpATywNh6bZuzm8s1ceuBUnMUAeoAHHw,17,27,8,18,4,0,8,1,66,9.428571428571429,2,0.0,16,8,15,4,11,0,3,8,1,43,23,1
6004,121122,GlVmjWGZ8XsOuLGdZvtzRw0xzELGNzxx,bWdj2GDclj5ofokWjzoa5jAwMkxCykd6,4,5,3,0,0,0,2,0,10,1.4285714285714286,3,0.0,0,3,0,0,5,0,0,2,0,3,7,1
6005,121137,5uUrNOrq1vz8XtHDv1LWcBc27EEqbO5u,SpATywNh6bZuzm8s1ceuBUnMUAeoAHHw,7,9,1,5,0,0,2,0,17,2.4285714285714284,1,0.0,1,1,4,0,8,0,1,2,0,6,11,1
6006,121141,YhSlQp6TZH2sVWIgjyn2YxpekmOBzjQt,SpATywNh6bZuzm8s1ceuBUnMUAeoAHHw,14,15,5,15,3,0,4,0,42,6.0,1,0.0,9,5,13,3,6,0,2,4,0,30,12,0
6007,121205,irUhnQtLaQWO9Ilnw5LLg2nfVwuwwh1f,SpATywNh6bZuzm8s1ceuBUnMUAeoAHHw,5,2,0,0,0,0,5,1,8,1.1428571428571428,1,0.0,0,0,0,0,2,0,0,5,1,0,8,1
6008,121292,b4JhdDZuiMoCYMffFqg7ALO9K4ZBVn12,A3fsA9Zfv1X2fVEQhTw51lKENdNrEqT3,1,0,0,0,0,0,1,0,1,0.14285714285714285,1,0.0,0,0,0,0,0,0,0,1,0,0,1,1
6009,121334,X9tesPfVRQu9R7pVopuvpFNecLnZt8Km,SpATywNh6bZuzm8s1ceuBUnMUAeoAHHw,15,17,0,13,0,3,8,1,42,6.0,1,0.0,8,0,11,0,9,3,2,8,1,19,23,1
6010,121335,rcQSbcF05AQYvzQJmDOGu4MfsQVuu05l,SpATywNh6bZuzm8s1ceuBUnMUAeoAHHw,1,0,0,0,0,0,1,0,1,0.14285714285714285,1,0.0,0,0,0,0,0,0,0,1,0,0,1,0
6011,121350,OaR2omePx63fXdBiAV1sA954f6IcbIvq,A3fsA9Zfv1X2fVEQhTw51lKENdNrEqT3,9,5,4,0,3,0,1,0,13,1.8571428571428572,1,0.0,0,4,0,3,5,0,0,1,0,7,6,0
6012,121354,EIHhmYlRU23gD32AsZHHvSXzjtFCo0yL,SpATywNh6bZuzm8s1ceuBUnMUAeoAHHw,3,2,1,0,0,0,1,0,4,0.5714285714285714,1,0.0,0,1,0,0,2,0,0,1,0,1,3,1
6013,121400,BMjIPGqtYoLatxXDEHrhiIMt72Ckp0Wf,SpATywNh6bZuzm8s1ceuBUnMUAeoAHHw,12,30,0,18,0,5,8,2,63,9.0,1,0.0,6,0,16,0,24,5,2,8,2,22,41,1
6014,121403,Uf8FY0gZoVytp6K7SsDRXVZeOCL2hDEX,bWdj2GDclj5ofokWjzoa5jAwMkxCykd6,6,4,2,0,1,0,3,0,10,1.4285714285714286,1,0.0,0,2,0,1,4,0,0,3,0,3,7,1
6015,121411,VytsQ5XFduK8xsP7edRPe1GY948fNELc,SpATywNh6bZuzm8s1ceuBUnMUAeoAHHw,6,3,2,0,2,0,5,1,13,1.8571428571428572,2,0.0,0,2,0,2,3,0,0,5,1,4,9,1
6016,121419,I6qGclNEImKeNJdvIwY5PrrMknw1zeQu,SpATywNh6bZuzm8s1ceuBUnMUAeoAHHw,15,31,15,20,4,4,11,0,85,12.142857142857142,3,0.0,6,15,17,4,25,4,3,11,0,42,43,0
6017,121430,wmNYHs69T6CHydhCxfzhydbjA79LMuTD,A3fsA9Zfv1X2fVEQhTw51lKENdNrEqT3,8,4,3,0,3,0,1,0,11,1.5714285714285714,1,0.0,0,3,0,3,4,0,0,1,0,6,5,1
6018,121558,YPFriT4OfareXOz7G4xpBUwlcCA03JlS,SpATywNh6bZuzm8s1ceuBUnMUAeoAHHw,11,7,4,0,3,0,6,0,20,2.857142857142857,1,0.0,0,4,0,3,7,0,0,6,0,7,13,1
6019,121611,bDlowck7PoswtmYozGMoa41g1GVEejKh,RXDvfPUBYFlVdlueBFbLW0mhhAyGEqpt,47,42,25,66,17,0,3,0,153,21.857142857142858,2,0.0,14,25,64,17,28,0,2,3,0,120,33,0
6020,121619,JfftjOGdDbpgbrupi0Gwr899R0jzXikJ,A3fsA9Zfv1X2fVEQhTw51lKENdNrEqT3,13,15,8,0,4,1,11,1,40,5.714285714285714,2,0.0,0,8,0,4,15,1,0,11,1,12,28,1
6021,121648,jXl4Q6TFlYw71Bn9dguW333wEk83ysVq,SpATywNh6bZuzm8s1ceuBUnMUAeoAHHw,12,39,0,0,0,16,19,2,76,10.857142857142858,1,0.0,15,0,0,0,24,16,0,19,2,15,61,1
6022,121662,5HXdL6OatNrhiY174KvxQUp0tpTJ3ory,SpATywNh6bZuzm8s1ceuBUnMUAeoAHHw,2,0,0,0,0,0,2,0,2,0.2857142857142857,2,0.0,0,0,0,0,0,0,0,2,0,0,2,0
6023,121729,ZrDgEyfoUHLa5uf0N0ml9T9xO22FqwKE,SpATywNh6bZuzm8s1ceuBUnMUAeoAHHw,12,9,2,0,2,1,7,1,22,3.142857142857143,1,0.0,0,2,0,2,9,1,0,7,1,4,18,0
6024,121817,qZUSZi93i2Ee9CUC34HmFgFywQL2ImeW,SpATywNh6bZuzm8s1ceuBUnMUAeoAHHw,9,6,3,0,2,0,4,0,15,2.142857142857143,1,0.0,0,3,0,2,6,0,0,4,0,5,10,1
6025,121831,SiH274DFlaeNzsDPV8qquK4qRpZHyEyM,SpATywNh6bZuzm8s1ceuBUnMUAeoAHHw,1,0,0,0,0,0,1,0,1,0.14285714285714285,1,0.0,0,0,0,0,0,0,0,1,0,0,1,1
6026,121840,A3FGIvcpmP9UeVzECTe66iC9lFbKmHRb,RXDvfPUBYFlVdlueBFbLW0mhhAyGEqpt,28,38,18,72,15,7,4,0,154,22.0,3,0.0,16,18,59,15,22,7,13,4,0,108,46,0
6027,121859,IcRuYze0CzOpE4oHF70ukHAkSTPB9bCH,SpATywNh6bZuzm8s1ceuBUnMUAeoAHHw,13,32,3,15,0,0,5,0,55,7.857142857142857,3,0.0,15,3,14,0,17,0,1,5,0,32,23,1
6028,121873,nHMoTKw6ss0dSnBzmsq0keGpHH2NjvR7,SpATywNh6bZuzm8s1ceuBUnMUAeoAHHw,18,15,9,8,4,1,16,2,55,7.857142857142857,5,0.0,2,9,7,4,13,1,1,16,2,22,33,1
6029,121891,lyKWlQXSsOSx9dJ1ME8N6mLGOkZhDx56,SpATywNh6bZuzm8s1ceuBUnMUAeoAHHw,17,31,12,6,7,1,6,0,63,9.0,3,0.0,15,12,6,7,16,1,0,6,0,40,23,1
6030,121893,Q8D1GMU9DUO6Nj6ySx5rrvLwl2bu2DGZ,SpATywNh6bZuzm8s1ceuBUnMUAeoAHHw,10,12,6,0,3,2,7,1,31,4.428571428571429,1,0.0,1,6,0,3,11,2,0,7,1,10,21,0
6031,121903,x2eztv69vavhwR6qv43AthcyQwI14YNr,SpATywNh6bZuzm8s1ceuBUnMUAeoAHHw,14,13,6,12,3,2,4,0,40,5.714285714285714,3,0.0,4,6,9,3,9,2,3,4,0,22,18,0
6032,122008,C7BxnTntfGXjkSosgH12xJ8S1pNqiUlY,SpATywNh6bZuzm8s1ceuBUnMUAeoAHHw,8,3,3,0,2,0,5,0,13,1.8571428571428572,2,0.0,0,3,0,2,3,0,0,5,0,5,8,1
6033,122011,rwCHpAN1sY0GvFYG7zQQk2qpgkOBz9O3,SpATywNh6bZuzm8s1ceuBUnMUAeoAHHw,5,4,2,0,0,0,2,0,8,1.1428571428571428,1,0.0,0,2,0,0,4,0,0,2,0,2,6,1
6034,122055,cgc8DGkd3Jwqn7jWLS8pFiVfUMBb7Shb,bWdj2GDclj5ofokWjzoa5jAwMkxCykd6,6,7,0,0,0,3,3,0,13,1.8571428571428572,1,0.0,1,0,0,0,6,3,0,3,0,1,12,1
6035,122060,Cyazs2KNzeLH7rwO0YD9wLQWGHR2SXrB,SpATywNh6bZuzm8s1ceuBUnMUAeoAHHw,5,4,2,0,1,0,2,0,9,1.2857142857142858,2,0.0,0,2,0,1,4,0,0,2,0,3,6,1
6036,122062,Cyazs2KNzeLH7rwO0YD9wLQWGHR2SXrB,A3fsA9Zfv1X2fVEQhTw51lKENdNrEqT3,4,2,1,0,1,0,1,0,5,0.7142857142857143,1,0.0,0,1,0,1,2,0,0,1,0,2,3,1
6037,122063,Cyazs2KNzeLH7rwO0YD9wLQWGHR2SXrB,bWdj2GDclj5ofokWjzoa5jAwMkxCykd6,5,4,2,0,1,0,2,0,9,1.2857142857142858,2,0.0,0,2,0,1,4,0,0,2,0,3,6,1
6038,122074,JbB7hpnQ5hVzqELznLtzJLRyOZ2rdnyH,SpATywNh6bZuzm8s1ceuBUnMUAeoAHHw,15,32,11,18,7,0,5,0,73,10.428571428571429,1,0.0,20,11,15,7,12,0,3,5,0,53,20,1
6039,122079,cderIDaWBR3ykedbqXoG7yh75mThXkpL,A3fsA9Zfv1X2fVEQhTw51lKENdNrEqT3,3,2,0,0,0,0,2,0,4,0.5714285714285714,1,0.0,0,0,0,0,2,0,0,2,0,0,4,1
6040,122080,2dTQ27kTyKMSAN4dn7cbjnuDmdSbybLJ,SpATywNh6bZuzm8s1ceuBUnMUAeoAHHw,17,22,10,16,4,8,12,1,73,10.428571428571429,1,0.0,7,10,16,4,15,8,0,12,1,37,36,0
6041,124650,efygWYkxxUMOGInRZT4qEeuzMRlIpQq6,7GRhBDsirIGkRZBtSMEzNTyDr2JQm4xx,21,60,34,0,36,0,12,2,144,20.571428571428573,3,0.0,20,34,0,36,40,0,0,12,2,90,54,0
6042,124655,znF1cjtWo1KGLXEIK5C3NJfQlk7HZ3U1,7GRhBDsirIGkRZBtSMEzNTyDr2JQm4xx,3,3,0,0,0,0,1,0,4,0.5714285714285714,1,0.0,0,0,0,0,3,0,0,1,0,0,4,1
6043,124664,sL5jw3pLWZoRI7avI17oM60mfF67Acgz,7GRhBDsirIGkRZBtSMEzNTyDr2JQm4xx,1,0,0,0,0,0,1,0,1,0.14285714285714285,1,0.0,0,0,0,0,0,0,0,1,0,0,1,1
6044,124702,Xv0DoRVy2WPaq7NGSTl3PflvzGmHzjVJ,7GRhBDsirIGkRZBtSMEzNTyDr2JQm4xx,26,91,6,50,8,12,35,0,202,28.857142857142858,3,0.0,63,6,42,8,28,12,8,35,0,119,83,0
6045,124731,kAnFbfXpbNeJLwDkVeY9dBv06ssaFoQQ,7GRhBDsirIGkRZBtSMEzNTyDr2JQm4xx,5,4,3,0,3,0,3,0,13,1.8571428571428572,1,0.0,0,3,0,3,4,0,0,3,0,6,7,1
6046,124784,Eh1GmQ1l1uLUtTdjFKV3N8aG3h7KeTZw,7GRhBDsirIGkRZBtSMEzNTyDr2JQm4xx,9,4,3,0,3,10,3,0,23,3.2857142857142856,1,0.0,0,3,0,3,4,10,0,3,0,6,17,1
6047,124806,Th577tzrUuQ2mCFol11GPYRTSP1uxDgy,7GRhBDsirIGkRZBtSMEzNTyDr2JQm4xx,1,0,0,0,0,0,3,0,3,0.42857142857142855,2,0.0,0,0,0,0,0,0,0,3,0,0,3,1
6048,124949,sQym1SSnuvlV9rWhfoiNBuvnxQoSSsrc,7GRhBDsirIGkRZBtSMEzNTyDr2JQm4xx,6,11,3,0,1,0,1,0,16,2.2857142857142856,1,0.0,5,3,0,1,6,0,0,1,0,9,7,0
6049,124950,Xn0FkHI67ejumzKXwubbQ6h7XBOcvKHb,7GRhBDsirIGkRZBtSMEzNTyDr2JQm4xx,1,0,0,0,0,0,1,0,1,0.14285714285714285,1,0.0,0,0,0,0,0,0,0,1,0,0,1,1
6050,124961,MQKEfJfHQjDI3xyJjnjmz4WwmQkpOvq2,7GRhBDsirIGkRZBtSMEzNTyDr2JQm4xx,1,0,0,0,0,0,1,0,1,0.14285714285714285,1,0.0,0,0,0,0,0,0,0,1,0,0,1,1
6051,125231,LKQx76DscP8cMaadDZLCOsushv3ygeRX,7GRhBDsirIGkRZBtSMEzNTyDr2JQm4xx,1,0,0,0,0,0,1,0,1,0.14285714285714285,1,0.0,0,0,0,0,0,0,0,1,0,0,1,1
6052,125245,eOxm8XEI11Xs6eiBi1Nu5QzIagZXwEm9,7GRhBDsirIGkRZBtSMEzNTyDr2JQm4xx,1,0,0,0,0,0,1,0,1,0.14285714285714285,1,0.0,0,0,0,0,0,0,0,1,0,0,1,1
6053,125259,BGrU91p3SJR2EobOQ7G1wG17DcXaN4qI,7GRhBDsirIGkRZBtSMEzNTyDr2JQm4xx,5,2,1,0,1,0,2,0,6,0.8571428571428571,1,0.0,0,1,0,1,2,0,0,2,0,2,4,1
6054,125303,b7PuwalmdIR7gI2f0kgWK9mhLJEyGy0c,7GRhBDsirIGkRZBtSMEzNTyDr2JQm4xx,5,2,1,0,1,0,2,0,6,0.8571428571428571,1,0.0,0,1,0,1,2,0,0,2,0,2,4,1
6055,125376,Im85u8aENweba95uFnFOR6zdQWFnfDOq,7GRhBDsirIGkRZBtSMEzNTyDr2JQm4xx,6,7,4,0,2,0,4,0,17,2.4285714285714284,1,0.0,0,4,0,2,7,0,0,4,0,6,11,1
6056,125428,7tmNprOSiahGzByaY8XiUnCFEIQfWwuf,7GRhBDsirIGkRZBtSMEzNTyDr2JQm4xx,31,138,28,52,13,10,9,0,250,35.714285714285715,3,0.0,76,28,46,13,62,10,6,9,0,163,87,0
6057,125633,FDR62LyL2NPX1eDLrbTp7iEOk4qB3llp,7GRhBDsirIGkRZBtSMEzNTyDr2JQm4xx,16,10,9,0,9,1,8,0,37,5.285714285714286,1,0.0,0,9,0,9,10,1,0,8,0,18,19,1
6058,125658,cUvcpWppohUVKz8Tban8cv5QfXMTXadW,7GRhBDsirIGkRZBtSMEzNTyDr2JQm4xx,1,0,0,0,0,0,1,0,1,0.14285714285714285,1,0.0,0,0,0,0,0,0,0,1,0,0,1,1
6059,125793,xpwei0fjDTwQJLJhl5FjMPXksqpuR5GG,7GRhBDsirIGkRZBtSMEzNTyDr2JQm4xx,30,27,12,26,9,0,6,0,80,11.428571428571429,1,0.0,13,12,26,9,14,0,0,6,0,60,20,0
6060,125803,UgRvVqO3twMvJzAlD49rqrTbxTS8yLpX,7GRhBDsirIGkRZBtSMEzNTyDr2JQm4xx,4,2,1,0,1,0,1,0,5,0.7142857142857143,1,0.0,0,1,0,1,2,0,0,1,0,2,3,1
6061,125959,d8nG3CRjdRKOgHNCQ97Y2ebOYVCkXw4D,7GRhBDsirIGkRZBtSMEzNTyDr2JQm4xx,1,0,0,0,0,0,1,0,1,0.14285714285714285,1,0.0,0,0,0,0,0,0,0,1,0,0,1,1
6062,126003,Vao6JycAVhIhWbjbxKbLXiDUK1ZHKwjo,7GRhBDsirIGkRZBtSMEzNTyDr2JQm4xx,23,30,13,36,2,7,2,0,90,12.857142857142858,1,0.0,9,13,33,2,21,7,3,2,0,57,33,1
6063,126612,OvRHQPlJQt08MjvBAsm9o6SalVx0kpxp,fbPkOYLVPtPgIt0MxizjfFJov3JbHyAi,6,15,1,0,1,0,5,0,22,3.142857142857143,1,0.0,2,1,0,1,13,0,0,5,0,4,18,1
6064,126613,Zl05tzo85snAXIri6adShvvUNKe0OymE,fbPkOYLVPtPgIt0MxizjfFJov3JbHyAi,6,9,3,0,2,0,7,0,21,3.0,1,0.0,4,3,0,2,5,0,0,7,0,9,12,1
6065,126614,heqH52ArHeSze97HDhxIHtMU3K7IMrRM,fbPkOYLVPtPgIt0MxizjfFJov3JbHyAi,9,7,3,0,3,0,6,0,19,2.7142857142857144,1,0.0,2,3,0,3,5,0,0,6,0,8,11,1
6066,126615,YxqQc0FBDNSpG3MFOKGx9ekKufVhxrPh,fbPkOYLVPtPgIt0MxizjfFJov3JbHyAi,16,9,7,0,7,0,3,0,26,3.7142857142857144,1,0.0,0,7,0,7,9,0,0,3,0,14,12,1
6067,126616,uieKgiKz9M2OwhKZvR7kKiTuoDNfJUlP,fbPkOYLVPtPgIt0MxizjfFJov3JbHyAi,2,0,0,0,0,0,5,0,5,0.7142857142857143,1,0.0,0,0,0,0,0,0,0,5,0,0,5,1
6068,126617,ysDhewvMwqkWHpjR0j6mtjJo9sLvpRAM,fbPkOYLVPtPgIt0MxizjfFJov3JbHyAi,16,23,9,2,11,15,18,1,79,11.285714285714286,2,0.0,11,9,2,11,12,15,0,18,1,33,46,1
6069,126618,fbJQhb9qJhxn4GPcwi4AErVjPsHJbyL7,fbPkOYLVPtPgIt0MxizjfFJov3JbHyAi,7,12,4,0,5,0,5,0,26,3.7142857142857144,2,0.0,2,4,0,5,10,0,0,5,0,11,15,1
6070,126620,LSVa2jpU1dF8RnC5rzovm0tv2cSNIe8I,fbPkOYLVPtPgIt0MxizjfFJov3JbHyAi,10,9,6,4,4,0,3,0,26,3.7142857142857144,2,0.0,1,6,3,4,8,0,1,3,0,14,12,1
6071,126621,L1D39t7woJJ3WRGAxRtS5wF9BZQP2EYr,fbPkOYLVPtPgIt0MxizjfFJov3JbHyAi,6,5,3,0,3,0,3,0,14,2.0,1,0.0,0,3,0,3,5,0,0,3,0,6,8,1
6072,126625,arRLaw4hZnmx5zrjvIy48oXkTK5DrU7i,fbPkOYLVPtPgIt0MxizjfFJov3JbHyAi,6,4,2,0,1,2,7,0,16,2.2857142857142856,2,0.0,0,2,0,1,4,2,0,7,0,3,13,1
6073,126626,0PTt7yojLQH47Ob79awcf5jvqfHw2L3I,fbPkOYLVPtPgIt0MxizjfFJov3JbHyAi,27,32,18,23,16,7,6,1,103,14.714285714285714,3,0.0,8,18,18,16,24,7,5,6,1,60,43,1
6074,126627,810MRx7l0r4ApLZ3yM1jRSAg5LUkiCFn,fbPkOYLVPtPgIt0MxizjfFJov3JbHyAi,4,2,1,0,1,0,1,0,5,0.7142857142857143,1,0.0,0,1,0,1,2,0,0,1,0,2,3,1
6075,126628,gdWTcSZVoKN1pGf7JyovC0vqfcnT9h18,fbPkOYLVPtPgIt0MxizjfFJov3JbHyAi,8,7,3,0,4,0,12,0,26,3.7142857142857144,2,0.0,2,3,0,4,5,0,0,12,0,9,17,1
6076,126629,0hd5ExdLnNdKHQRTwwTLHmDaSlTLMdvd,fbPkOYLVPtPgIt0MxizjfFJov3JbHyAi,5,2,1,0,1,0,4,0,8,1.1428571428571428,1,0.0,0,1,0,1,2,0,0,4,0,2,6,1
6077,126631,I2ghGumCKIaVsnJOGZA0xyJzTnEm5KtW,fbPkOYLVPtPgIt0MxizjfFJov3JbHyAi,13,11,7,4,4,10,5,1,42,6.0,2,0.0,1,7,3,4,10,10,1,5,1,15,27,1
6078,126634,euBhTje23sMDM8PPQbKVpH6OVKTfG91O,fbPkOYLVPtPgIt0MxizjfFJov3JbHyAi,1,0,0,0,0,0,1,0,1,0.14285714285714285,1,0.0,0,0,0,0,0,0,0,1,0,0,1,1
6079,126635,bA4tnPZD0UU4XAL3OkL7nUjtkAzbgj9d,fbPkOYLVPtPgIt0MxizjfFJov3JbHyAi,7,4,2,0,2,6,2,0,16,2.2857142857142856,1,0.0,0,2,0,2,4,6,0,2,0,4,12,1
6080,126636,P2xHl8oxJOV4TMoYrxym6L2dPSAdMMJs,fbPkOYLVPtPgIt0MxizjfFJov3JbHyAi,4,2,1,0,1,0,1,0,5,0.7142857142857143,1,0.0,0,1,0,1,2,0,0,1,0,2,3,1
6081,126637,c8TFm45r0bfBe26eBlEeUAKDBoTJT9yV,fbPkOYLVPtPgIt0MxizjfFJov3JbHyAi,8,4,3,0,3,0,1,0,11,1.5714285714285714,1,0.0,0,3,0,3,4,0,0,1,0,6,5,0
6082,126638,IBEBjXb2AhSAQmCEtwVxNy77qVPKcclm,fbPkOYLVPtPgIt0MxizjfFJov3JbHyAi,6,4,2,0,1,2,3,0,12,1.7142857142857142,1,0.0,0,2,0,1,4,2,0,3,0,3,9,1
6083,126639,x6BtQH70uuLHaxqzHA21U9wmfT0SxzD9,fbPkOYLVPtPgIt0MxizjfFJov3JbHyAi,6,2,0,0,0,0,5,1,8,1.1428571428571428,2,0.0,0,0,0,0,2,0,0,5,1,0,8,1
6084,126640,99YWSjgqR4hZD4KPEunWhlG5MDGBBYbJ,fbPkOYLVPtPgIt0MxizjfFJov3JbHyAi,6,3,1,0,1,0,2,0,7,1.0,1,0.0,0,1,0,1,3,0,0,2,0,2,5,1
6085,126642,OseLd0Vj4CawbZPfZRznLZH5tivxQP68,fbPkOYLVPtPgIt0MxizjfFJov3JbHyAi,7,4,2,0,2,0,4,0,12,1.7142857142857142,2,0.0,1,2,0,2,3,0,0,4,0,5,7,1
6086,126643,lRTCAuzQcWWtA62pbQwh7xYqG6ghwvm9,fbPkOYLVPtPgIt0MxizjfFJov3JbHyAi,12,17,5,9,10,3,8,0,52,7.428571428571429,1,0.0,11,5,7,10,6,3,2,8,0,33,19,1
6087,126644,N1bQ5aFhcb1yr21loPYJqu2BbdxHrcfB,fbPkOYLVPtPgIt0MxizjfFJov3JbHyAi,11,8,6,0,2,1,6,1,24,3.4285714285714284,1,0.0,0,6,0,2,8,1,0,6,1,8,16,1
6088,126646,mb7Zd70aH6w6tsEQr8q9cAr4RlsgpSEG,fbPkOYLVPtPgIt0MxizjfFJov3JbHyAi,2,0,0,0,0,0,7,0,7,1.0,1,0.0,0,0,0,0,0,0,0,7,0,0,7,1
6089,126647,1tMY1MpuZPW690JnedcAZZYFmf6foWjL,fbPkOYLVPtPgIt0MxizjfFJov3JbHyAi,7,5,3,0,2,7,2,0,19,2.7142857142857144,1,0.0,0,3,0,2,5,7,0,2,0,5,14,1
6090,126649,wdjY1oC33XqL52RaIYWlfwM88qICxfHB,fbPkOYLVPtPgIt0MxizjfFJov3JbHyAi,8,9,5,0,5,4,3,0,26,3.7142857142857144,1,0.0,2,5,0,5,7,4,0,3,0,12,14,0
6091,126650,LD7pbuVHju3VTu9U8udNh6I7JCsw9ECG,fbPkOYLVPtPgIt0MxizjfFJov3JbHyAi,7,6,4,0,3,0,3,0,16,2.2857142857142856,2,0.0,0,4,0,3,6,0,0,3,0,7,9,0
6092,126651,ctraTKVJ2JhUCIHyavrJWUiIknGdQbqc,fbPkOYLVPtPgIt0MxizjfFJov3JbHyAi,2,0,0,0,0,0,5,0,5,0.7142857142857143,1,0.0,0,0,0,0,0,0,0,5,0,0,5,1
6093,126654,YLJf06fjaksgc6NESkSC4nTSBafk5Yoh,fbPkOYLVPtPgIt0MxizjfFJov3JbHyAi,7,9,2,0,2,0,2,0,15,2.142857142857143,1,0.0,0,2,0,2,9,0,0,2,0,4,11,1
6094,126656,vXwf4MSRd0xkinwiIqWQdnJoLNdmsOvm,fbPkOYLVPtPgIt0MxizjfFJov3JbHyAi,7,3,2,0,2,0,5,0,12,1.7142857142857142,1,0.0,0,2,0,2,3,0,0,5,0,4,8,1
6095,126657,A6zX6I2GfUhXHkfxx6hY7fkYNihUgWzR,fbPkOYLVPtPgIt0MxizjfFJov3JbHyAi,6,6,2,0,2,0,1,0,11,1.5714285714285714,1,0.0,1,2,0,2,5,0,0,1,0,5,6,1
6096,126658,bwZYXSIDocrsg9B80u5hz1s4TUzxdjem,fbPkOYLVPtPgIt0MxizjfFJov3JbHyAi,8,6,2,0,3,0,5,0,16,2.2857142857142856,1,0.0,2,2,0,3,4,0,0,5,0,7,9,1
6097,126659,lUOW63ZIGkmagy3rVXMv25n4vumPKUfs,fbPkOYLVPtPgIt0MxizjfFJov3JbHyAi,5,2,1,0,1,0,3,0,7,1.0,1,0.0,0,1,0,1,2,0,0,3,0,2,5,1
6098,126660,e2CxwSKYgRRxAYL99ajalycn9caM2cox,fbPkOYLVPtPgIt0MxizjfFJov3JbHyAi,5,2,1,0,1,2,6,0,12,1.7142857142857142,1,0.0,0,1,0,1,2,2,0,6,0,2,10,1
6099,126661,7dkSnitaOk46bh4JzUzQh70jkQ2SBZcu,fbPkOYLVPtPgIt0MxizjfFJov3JbHyAi,3,2,1,0,0,0,1,0,4,0.5714285714285714,1,0.0,0,1,0,0,2,0,0,1,0,1,3,1
6100,126662,wUoZ0jO9cvYMtyUP7nefHwtNjYQG7VUS,fbPkOYLVPtPgIt0MxizjfFJov3JbHyAi,2,0,0,0,0,0,7,0,7,1.0,1,0.0,0,0,0,0,0,0,0,7,0,0,7,1
6101,126663,AAbYMvj6N4kPLfJSTWdxJHOFF7gGokhv,fbPkOYLVPtPgIt0MxizjfFJov3JbHyAi,7,3,2,0,2,0,5,0,12,1.7142857142857142,1,0.0,0,2,0,2,3,0,0,5,0,4,8,1
6102,126665,paTNeCrMrWcChojlLsspaorcmQjiSxoH,fbPkOYLVPtPgIt0MxizjfFJov3JbHyAi,2,0,0,0,0,0,3,0,3,0.42857142857142855,1,0.0,0,0,0,0,0,0,0,3,0,0,3,1
6103,126668,GbCaM9AUbbkCquP0Qap7xohw6uCLXYPC,fbPkOYLVPtPgIt0MxizjfFJov3JbHyAi,6,9,0,0,0,3,7,2,21,3.0,2,0.0,0,0,0,0,9,3,0,7,2,0,21,1
6104,126669,pEzMNyrul10BaiwI0ZVRc6CziruRKt37,fbPkOYLVPtPgIt0MxizjfFJov3JbHyAi,1,0,0,0,0,0,1,0,1,0.14285714285714285,1,0.0,0,0,0,0,0,0,0,1,0,0,1,1
6105,126670,G4gv3psLUg6DraQbf90HcUcwjZl74koo,fbPkOYLVPtPgIt0MxizjfFJov3JbHyAi,7,2,2,0,2,0,2,0,8,1.1428571428571428,1,0.0,0,2,0,2,2,0,0,2,0,4,4,1
6106,126672,cAt3kAq8A4nBNACWncm3aidYAQ1d8bbM,fbPkOYLVPtPgIt0MxizjfFJov3JbHyAi,7,6,4,0,2,0,2,0,14,2.0,2,0.0,0,4,0,2,6,0,0,2,0,6,8,1
6107,126673,9iDcxmHxr3SmvjvcATJP2YvHEz7UDHIB,fbPkOYLVPtPgIt0MxizjfFJov3JbHyAi,1,0,0,0,0,0,1,0,1,0.14285714285714285,1,0.0,0,0,0,0,0,0,0,1,0,0,1,1
6108,126674,LqQpVFQv4lJ36VdzJ4TLAuyE3Ov82MrP,fbPkOYLVPtPgIt0MxizjfFJov3JbHyAi,14,13,8,0,6,9,6,1,43,6.142857142857143,2,0.0,1,8,0,6,12,9,0,6,1,15,28,1
6109,126675,IDaqGyhjD6ErPQOFlyvvPqvNK1bXBxI0,fbPkOYLVPtPgIt0MxizjfFJov3JbHyAi,5,3,2,0,2,5,0,0,12,1.7142857142857142,1,0.0,0,2,0,2,3,5,0,0,0,4,8,1
6110,126676,wmND65rZOV8Cdq3Mq9MmFLy7XUHHSgIW,fbPkOYLVPtPgIt0MxizjfFJov3JbHyAi,1,0,0,0,0,0,1,0,1,0.14285714285714285,1,0.0,0,0,0,0,0,0,0,1,0,0,1,1
6111,126682,gCWKTntdRCeMdOtUiFg2mfCjgrvO2vpV,fbPkOYLVPtPgIt0MxizjfFJov3JbHyAi,10,7,5,0,3,0,2,0,17,2.4285714285714284,1,0.0,0,5,0,3,7,0,0,2,0,8,9,1
6112,126684,4nv50J1wZS6kPdidLB1Y9lmEShhD8gDr,fbPkOYLVPtPgIt0MxizjfFJov3JbHyAi,4,2,1,0,1,0,1,0,5,0.7142857142857143,1,0.0,0,1,0,1,2,0,0,1,0,2,3,1
6113,126686,twUid3xG1muFotfbhs814Ag7sscFy0p2,fbPkOYLVPtPgIt0MxizjfFJov3JbHyAi,8,7,3,0,3,0,2,0,15,2.142857142857143,1,0.0,2,3,0,3,5,0,0,2,0,8,7,1
6114,126687,h5bSBTzGWadYMvrkMiapQR2U8CQzOFmW,fbPkOYLVPtPgIt0MxizjfFJov3JbHyAi,6,3,1,0,1,0,2,0,7,1.0,1,0.0,0,1,0,1,3,0,0,2,0,2,5,1
6115,126690,RhUtXI34T3ZAxfPNMapta5ryhpUSWnVk,fbPkOYLVPtPgIt0MxizjfFJov3JbHyAi,4,2,0,0,0,0,3,0,5,0.7142857142857143,2,0.0,0,0,0,0,2,0,0,3,0,0,5,1
6116,126693,v6oH0XZ7BYoM6ZOy0T23nm7pBiES9NPB,fbPkOYLVPtPgIt0MxizjfFJov3JbHyAi,8,10,4,0,4,8,9,0,35,5.0,2,0.0,2,4,0,4,8,8,0,9,0,10,25,1
6117,126694,zn2X74vvqUQRINz90WjZLsSsFglpYr7o,fbPkOYLVPtPgIt0MxizjfFJov3JbHyAi,9,6,4,0,3,6,5,1,25,3.5714285714285716,2,0.0,0,4,0,3,6,6,0,5,1,7,18,1
6118,126695,HSi3yW2yFW0jz9rvJLhKsLbntRdoY32a,fbPkOYLVPtPgIt0MxizjfFJov3JbHyAi,8,4,3,0,3,0,1,0,11,1.5714285714285714,1,0.0,0,3,0,3,4,0,0,1,0,6,5,1
6119,126696,XMNENeqGvf1rZdMY0iLZGJZMfiQXuZuC,fbPkOYLVPtPgIt0MxizjfFJov3JbHyAi,9,12,5,0,4,0,3,0,24,3.4285714285714284,2,0.0,2,5,0,4,10,0,0,3,0,11,13,1
6120,126698,9LD2dY2JJUiq4N2gerCXLTVCO162xgQP,fbPkOYLVPtPgIt0MxizjfFJov3JbHyAi,1,0,0,0,0,0,1,0,1,0.14285714285714285,1,0.0,0,0,0,0,0,0,0,1,0,0,1,1
6121,126700,ltYfR4c85t4WE2sNzApQ2jUPBpU7b957,fbPkOYLVPtPgIt0MxizjfFJov3JbHyAi,7,3,1,0,1,0,4,0,9,1.2857142857142858,1,0.0,0,1,0,1,3,0,0,4,0,2,7,1
6122,126702,dUZiaQQxyKZymoXkd4PU7n1DsSWSaoIy,fbPkOYLVPtPgIt0MxizjfFJov3JbHyAi,8,4,1,0,1,3,15,0,24,3.4285714285714284,2,0.0,0,1,0,1,4,3,0,15,0,2,22,1
6123,126704,T8cbb1vJp70svkAiDdRu3fMjKB52qGra,fbPkOYLVPtPgIt0MxizjfFJov3JbHyAi,18,20,14,0,11,2,4,0,51,7.285714285714286,2,0.0,0,14,0,11,20,2,0,4,0,25,26,1
6124,126706,wRfmNw7A5BDFV6ZZ1hHimgxOa1BKzUIG,fbPkOYLVPtPgIt0MxizjfFJov3JbHyAi,5,2,1,0,1,0,4,0,8,1.1428571428571428,1,0.0,0,1,0,1,2,0,0,4,0,2,6,1
6125,126707,J1iCM60eAwVKTPRoP9hdyFlEQf6db3YF,fbPkOYLVPtPgIt0MxizjfFJov3JbHyAi,5,2,1,0,1,0,2,0,6,0.8571428571428571,1,0.0,0,1,0,1,2,0,0,2,0,2,4,1
6126,126727,okqN4nBVKRYYrkYonKicKGOmPqVGYjZh,fbPkOYLVPtPgIt0MxizjfFJov3JbHyAi,8,11,5,0,3,0,9,0,28,4.0,1,0.0,0,5,0,3,11,0,0,9,0,8,20,0
6127,126741,lkSkVgerjbY9elu2HritmYHEIObp7PjN,fbPkOYLVPtPgIt0MxizjfFJov3JbHyAi,19,12,7,12,7,0,4,0,42,6.0,2,0.0,4,7,10,7,8,0,2,4,0,28,14,1
6128,126762,tedGThhHMqVARfBh6zyzyocTKbTJYJpB,fbPkOYLVPtPgIt0MxizjfFJov3JbHyAi,10,10,7,0,4,9,7,0,37,5.285714285714286,2,0.0,0,7,0,4,10,9,0,7,0,11,26,0
6129,130035,GWG8afsUfRei9CIZYg1Y2sBsF64D5J9k,7GRhBDsirIGkRZBtSMEzNTyDr2JQm4xx,4,2,0,0,0,0,2,0,4,0.5714285714285714,2,0.0,0,0,0,0,2,0,0,2,0,0,4,1
6130,130051,V6I2tWMT4J6OaEfYWYGJXMvy6YbJ0vQk,7GRhBDsirIGkRZBtSMEzNTyDr2JQm4xx,1,0,0,0,0,0,1,0,1,0.14285714285714285,1,0.0,0,0,0,0,0,0,0,1,0,0,1,0
6131,130059,1xcKG4Eeqo6PRlQtqz4lRNBDzvKhe7qL,7GRhBDsirIGkRZBtSMEzNTyDr2JQm4xx,30,67,9,56,7,21,25,3,188,26.857142857142858,4,0.0,35,9,46,7,32,21,10,25,3,97,91,0
6132,130126,Kt9qeiacR1tBDeKKHUR6O60ehH5pm7C9,7GRhBDsirIGkRZBtSMEzNTyDr2JQm4xx,8,11,0,2,0,0,2,0,15,2.142857142857143,1,0.0,4,0,2,0,7,0,0,2,0,6,9,1
6133,130170,bVkBiR8Ol1DpipPI05IgYIPbLOO6oZNi,7GRhBDsirIGkRZBtSMEzNTyDr2JQm4xx,34,71,22,49,9,12,15,4,182,26.0,1,0.0,33,22,44,9,38,12,5,15,4,108,74,0
6134,130205,D5GqwXfacfySSvxPJ9v7ORjiX9Oa23f1,7GRhBDsirIGkRZBtSMEzNTyDr2JQm4xx,34,50,21,72,14,1,21,1,180,25.714285714285715,3,0.0,26,21,63,14,24,1,9,21,1,124,56,1
6135,134918,IFqWOl32JJm0W3Ap2jxVCpJeXeLJlYDp,A3fsA9Zfv1X2fVEQhTw51lKENdNrEqT3,7,8,4,0,0,0,4,0,16,2.2857142857142856,2,0.0,0,4,0,0,8,0,0,4,0,4,12,1
6136,134982,CW7Zlsz0NoDYd7q0tu1Krgi9b7wpQUwQ,A3fsA9Zfv1X2fVEQhTw51lKENdNrEqT3,11,11,6,4,1,0,10,0,32,4.571428571428571,2,0.0,0,6,3,1,11,0,1,10,0,10,22,0
6137,135022,f0rWHmI4rV7ssYizy9jzg3UxqKTtG19Y,SpATywNh6bZuzm8s1ceuBUnMUAeoAHHw,3,4,0,0,0,0,8,0,12,1.7142857142857142,1,0.0,0,0,0,0,4,0,0,8,0,0,12,0
6138,135025,tedGThhHMqVARfBh6zyzyocTKbTJYJpB,SpATywNh6bZuzm8s1ceuBUnMUAeoAHHw,3,2,1,0,0,1,2,0,6,0.8571428571428571,1,0.0,0,1,0,0,2,1,0,2,0,1,5,1
6139,135115,qknWf2eBme9z3XgVNwZwbwdoI0FKipkj,A3fsA9Zfv1X2fVEQhTw51lKENdNrEqT3,8,3,2,0,2,1,9,0,17,2.4285714285714284,2,0.0,0,2,0,2,3,1,0,9,0,4,13,1
6140,135137,A3FGIvcpmP9UeVzECTe66iC9lFbKmHRb,A3fsA9Zfv1X2fVEQhTw51lKENdNrEqT3,11,6,5,0,5,0,2,0,18,2.5714285714285716,1,0.0,0,5,0,5,6,0,0,2,0,10,8,1
6141,135188,qhmgArW8a15UOGQrFTosGi03wE1TjPeN,G8EPVSXsOYB5YQWZGiz1aVq5Pgr2GrQu,6,8,1,0,2,0,1,0,12,1.7142857142857142,1,0.0,4,1,0,2,4,0,0,1,0,7,5,1
6142,135232,ZfIQYurnR6gJbWxLJ81cU3ZqzX4mpHm0,A3fsA9Zfv1X2fVEQhTw51lKENdNrEqT3,17,26,13,0,5,2,21,2,69,9.857142857142858,1,0.0,0,13,0,5,26,2,0,21,2,18,51,1
6143,135247,n67Q6gA8OyrfjvaOwbClftMWf4trlmyC,A3fsA9Zfv1X2fVEQhTw51lKENdNrEqT3,7,3,2,0,2,0,2,0,9,1.2857142857142858,1,0.0,0,2,0,2,3,0,0,2,0,4,5,1
6144,135252,1umo7etGwkx7NcpFxVialzDD37NdyqRT,G8EPVSXsOYB5YQWZGiz1aVq5Pgr2GrQu,4,2,1,0,1,0,1,0,5,0.7142857142857143,1,0.0,0,1,0,1,2,0,0,1,0,2,3,0
6145,135377,ZfIQYurnR6gJbWxLJ81cU3ZqzX4mpHm0,SpATywNh6bZuzm8s1ceuBUnMUAeoAHHw,6,5,2,0,2,0,2,0,11,1.5714285714285714,2,0.0,0,2,0,2,5,0,0,2,0,4,7,0
6146,135390,IGFSjvLtGQCYdnhMcrAQcaIreY53ybWv,bWdj2GDclj5ofokWjzoa5jAwMkxCykd6,19,51,20,48,15,16,13,1,164,23.428571428571427,5,0.0,8,20,41,15,43,16,7,13,1,84,80,0
6147,135396,g5cfvDvYqz1BC4LMGanzPaVPPBmwbapa,SpATywNh6bZuzm8s1ceuBUnMUAeoAHHw,11,8,6,0,4,0,3,0,21,3.0,2,0.0,0,6,0,4,8,0,0,3,0,10,11,0
6148,135425,LoyL1dLg21zF03lUMGts7AHY1XLphBvU,SpATywNh6bZuzm8s1ceuBUnMUAeoAHHw,16,27,8,9,5,1,10,1,61,8.714285714285714,3,0.0,5,8,8,5,22,1,1,10,1,26,35,1
6149,135442,x6BtQH70uuLHaxqzHA21U9wmfT0SxzD9,RXDvfPUBYFlVdlueBFbLW0mhhAyGEqpt,10,17,1,0,1,2,9,1,31,4.428571428571429,1,0.0,0,1,0,1,17,2,0,9,1,2,29,1
6150,135507,irZDaKqT4KdxcZGgiOHoDpvTtZyUugWP,A3fsA9Zfv1X2fVEQhTw51lKENdNrEqT3,20,8,4,60,1,0,2,0,75,10.714285714285714,1,0.0,0,4,49,1,8,0,11,2,0,54,21,1
6151,135554,nrNRU1bochGfgxXZNdc89zA9KtJYIKVZ,SpATywNh6bZuzm8s1ceuBUnMUAeoAHHw,15,28,16,8,9,0,5,0,66,9.428571428571429,2,0.0,7,16,8,9,21,0,0,5,0,40,26,0
6152,135570,JoLD64z5yUuFbScCfKMnv8dODXOTXhRU,RXDvfPUBYFlVdlueBFbLW0mhhAyGEqpt,24,22,2,33,5,1,7,3,73,10.428571428571429,2,0.0,6,2,30,5,16,1,3,7,3,43,30,1
6153,135613,8lCrBaMkcXk8KsL7M8AYgjnsyFuSP4yK,SpATywNh6bZuzm8s1ceuBUnMUAeoAHHw,17,17,8,13,4,6,6,1,55,7.857142857142857,3,0.0,4,8,11,4,13,6,2,6,1,27,28,0
6154,135619,dmVv4oc5Gy8IXIoX1c6y61vCY7ZjC5c1,SpATywNh6bZuzm8s1ceuBUnMUAeoAHHw,16,30,14,6,2,4,11,0,67,9.571428571428571,3,0.0,5,14,6,2,25,4,0,11,0,27,40,1
6155,135627,p8PDk7PIRcdv8OilLQ1EB9K2d3Uc8Sea,SpATywNh6bZuzm8s1ceuBUnMUAeoAHHw,12,27,11,0,3,0,5,0,46,6.571428571428571,3,0.0,9,11,0,3,18,0,0,5,0,23,23,1
6156,135651,8E88mVxxHiSEV3ReMbiLkIuYAxJ6YXeO,A3fsA9Zfv1X2fVEQhTw51lKENdNrEqT3,7,9,6,0,1,0,3,0,19,2.7142857142857144,1,0.0,0,6,0,1,9,0,0,3,0,7,12,0
6157,135660,700mBNy8Tl4Vnb1y2ttxNbwsqHUl4IAM,RXDvfPUBYFlVdlueBFbLW0mhhAyGEqpt,2,0,0,0,0,0,2,0,2,0.2857142857142857,1,0.0,0,0,0,0,0,0,0,2,0,0,2,0
6158,135703,1i94xoT1OVM1lTP3R294JlD5odSrEcP5,SpATywNh6bZuzm8s1ceuBUnMUAeoAHHw,9,14,0,0,0,3,7,1,25,3.5714285714285716,2,0.0,1,0,0,0,13,3,0,7,1,1,24,1
6159,135709,EvNxwwShcQXgwZllGhuS7z5fGOL08A9A,SpATywNh6bZuzm8s1ceuBUnMUAeoAHHw,16,65,29,2,8,24,34,7,169,24.142857142857142,4,0.0,12,29,2,8,53,24,0,34,7,51,118,0
6160,135713,uw4petWia8mRNE3kHXaUdR4MrfrMeMii,SpATywNh6bZuzm8s1ceuBUnMUAeoAHHw,11,16,8,0,3,0,3,0,30,4.285714285714286,3,0.0,3,8,0,3,13,0,0,3,0,14,16,0
6161,135730,H8XaU1gbefHT7MZ45ya2B80ofczKeIUJ,bWdj2GDclj5ofokWjzoa5jAwMkxCykd6,19,34,18,72,9,16,24,1,174,24.857142857142858,2,0.0,7,18,68,9,27,16,4,24,1,102,72,0
6162,135813,E4hjF5LL5g3DmDyETJzEmj6OhjarBopN,A3fsA9Zfv1X2fVEQhTw51lKENdNrEqT3,7,3,1,0,0,1,8,1,14,2.0,1,0.0,0,1,0,0,3,1,0,8,1,1,13,1
6163,135829,iyNW22GLVn7ltcBOUiQmam3mjjq9r9cL,A3fsA9Zfv1X2fVEQhTw51lKENdNrEqT3,5,2,1,0,1,0,2,0,6,0.8571428571428571,1,0.0,0,1,0,1,2,0,0,2,0,2,4,1
6164,135840,Pk1zvEWPdVckXHLEawuIZZjckq66QamN,A3fsA9Zfv1X2fVEQhTw51lKENdNrEqT3,12,12,3,0,1,0,16,1,33,4.714285714285714,2,0.0,0,3,0,1,12,0,0,16,1,4,29,1
6165,135843,QGuKTIBC2KLaYpPdOnB4nXCWgxMM1Dog,bWdj2GDclj5ofokWjzoa5jAwMkxCykd6,10,20,9,4,3,0,8,0,44,6.285714285714286,4,0.0,3,9,3,3,17,0,1,8,0,18,26,0
6166,135882,tTG3Ne3P3A1gAXhNVMiXz0Ee3ILsYPsk,7GRhBDsirIGkRZBtSMEzNTyDr2JQm4xx,1,0,0,0,0,0,1,0,1,0.14285714285714285,1,0.0,0,0,0,0,0,0,0,1,0,0,1,1
6167,135909,s1vgWbMezqTHWPlvrms0WJFKvZbaN3cw,7GRhBDsirIGkRZBtSMEzNTyDr2JQm4xx,22,24,13,16,7,3,6,0,69,9.857142857142858,3,0.0,5,13,13,7,19,3,3,6,0,38,31,1
6168,136010,7bBbNS8igBUmtAlhgWeyPaLpz7A08m0l,7GRhBDsirIGkRZBtSMEzNTyDr2JQm4xx,23,43,18,35,16,2,3,0,117,16.714285714285715,2,0.0,21,18,31,16,22,2,4,3,0,86,31,1
6169,136060,K6gZA7sjhdZCSz3L5n4Avap9MqiCE3Mp,7GRhBDsirIGkRZBtSMEzNTyDr2JQm4xx,1,0,0,0,0,0,1,0,1,0.14285714285714285,1,0.0,0,0,0,0,0,0,0,1,0,0,1,1
6170,136090,1ml1ZIUtZXpkL0JmFSahYiWnT7jKIk9A,7GRhBDsirIGkRZBtSMEzNTyDr2JQm4xx,35,100,41,64,23,28,14,4,274,39.142857142857146,4,0.0,49,41,58,23,51,28,6,14,4,171,103,1
6171,136155,GgCLl5NjwqMgkh5JCvkbSguhpqbBPXLG,7GRhBDsirIGkRZBtSMEzNTyDr2JQm4xx,8,4,0,0,0,1,5,0,10,1.4285714285714286,2,0.0,0,0,0,0,4,1,0,5,0,0,10,1
6172,136220,kJR7SORW78mX9yl9TvMAdIrYcwnnZz4r,7GRhBDsirIGkRZBtSMEzNTyDr2JQm4xx,27,60,29,28,11,0,4,0,132,18.857142857142858,3,0.0,28,29,28,11,32,0,0,4,0,96,36,1
6173,136257,8uSQsFhnhoJeSVZylwMfyqKR37MO9Qyr,SpATywNh6bZuzm8s1ceuBUnMUAeoAHHw,4,2,1,0,1,0,1,0,5,0.7142857142857143,2,0.0,0,1,0,1,2,0,0,1,0,2,3,0
6174,136275,khelYX1bk51SSadsVaUzKR0zRRNCX0tK,7GRhBDsirIGkRZBtSMEzNTyDr2JQm4xx,29,72,27,96,1,0,19,1,216,30.857142857142858,4,0.0,33,27,87,1,39,0,9,19,1,148,68,1
6175,136282,no2ug7TKVsupL4LU2a5jY2GhYHkskTdw,SpATywNh6bZuzm8s1ceuBUnMUAeoAHHw,13,19,13,10,8,0,5,0,55,7.857142857142857,3,0.0,2,13,9,8,17,0,1,5,0,32,23,0
6176,136299,4R8cjmGXnx8F1dFD5UPDPTI5U03hvnfJ,G8EPVSXsOYB5YQWZGiz1aVq5Pgr2GrQu,9,4,3,0,3,0,4,1,15,2.142857142857143,1,0.0,0,3,0,3,4,0,0,4,1,6,9,1
6177,136386,FM7LvWy0SQdmiC09CRsUT44n0BqWWa2S,SpATywNh6bZuzm8s1ceuBUnMUAeoAHHw,10,51,18,0,14,0,10,0,93,13.285714285714286,5,0.0,0,18,0,14,51,0,0,10,0,32,61,0
6178,136442,TOTNiRasgzo7kH1hlyiehLV3DbzVA61v,7GRhBDsirIGkRZBtSMEzNTyDr2JQm4xx,30,49,14,48,16,12,16,0,155,22.142857142857142,3,0.0,32,14,39,16,17,12,9,16,0,101,54,1
6179,136447,ecut1h0rhjLzcs1jrL1hILYqwNtlJCKC,7GRhBDsirIGkRZBtSMEzNTyDr2JQm4xx,33,96,31,59,14,16,11,1,228,32.57142857142857,3,0.0,38,31,55,14,58,16,4,11,1,138,90,1
6180,136460,66UIy9DsqvecX9deVURN28A6eUmaxM2O,7GRhBDsirIGkRZBtSMEzNTyDr2JQm4xx,7,3,1,0,1,2,8,0,15,2.142857142857143,2,0.0,0,1,0,1,3,2,0,8,0,2,13,1
6181,136491,NcracMTfiaTPMbO6SSDnt9CDc4SnvBs9,7GRhBDsirIGkRZBtSMEzNTyDr2JQm4xx,12,29,7,0,7,0,2,0,45,6.428571428571429,1,0.0,21,7,0,7,8,0,0,2,0,35,10,1
6182,136513,hZR4MwcYec4g0GoOyJFngJGEyWOySpv2,bWdj2GDclj5ofokWjzoa5jAwMkxCykd6,9,10,7,0,2,5,9,0,33,4.714285714285714,2,0.0,1,7,0,2,9,5,0,9,0,10,23,0
6183,136514,ODBJIDcvWCzkG2XoiGFYE0mdoqG7tfRb,7GRhBDsirIGkRZBtSMEzNTyDr2JQm4xx,2,0,0,0,0,0,2,0,2,0.2857142857142857,1,0.0,0,0,0,0,0,0,0,2,0,0,2,1
6184,136521,i15PHia6n9agkYRoEhdWcUwrhqvX8pmC,7GRhBDsirIGkRZBtSMEzNTyDr2JQm4xx,1,0,0,0,0,0,1,0,1,0.14285714285714285,1,0.0,0,0,0,0,0,0,0,1,0,0,1,1
6185,136529,jia7n6yiGa4HNwul2FwX7WuWnOCMgFMl,7GRhBDsirIGkRZBtSMEzNTyDr2JQm4xx,21,39,10,21,6,5,1,0,82,11.714285714285714,1,0.0,27,10,21,6,12,5,0,1,0,64,18,1
6186,136530,hZR4MwcYec4g0GoOyJFngJGEyWOySpv2,G8EPVSXsOYB5YQWZGiz1aVq5Pgr2GrQu,17,24,9,0,7,0,10,0,50,7.142857142857143,1,0.0,9,9,0,7,15,0,0,10,0,25,25,0
6187,136533,ZC5rnhfF0O0RN6wj4xnmSbFJHTipD7b4,7GRhBDsirIGkRZBtSMEzNTyDr2JQm4xx,2,0,0,0,0,0,2,0,2,0.2857142857142857,1,0.0,0,0,0,0,0,0,0,2,0,0,2,1
6188,136558,Cv1aavObJnuABKfipF6OGePzg0BnGPFs,7GRhBDsirIGkRZBtSMEzNTyDr2JQm4xx,8,6,3,4,0,0,4,0,17,2.4285714285714284,1,0.0,3,3,4,0,3,0,0,4,0,10,7,1
6189,136562,UUf7W9nrVz0icOeIhIvztvvypaJKgHhN,SpATywNh6bZuzm8s1ceuBUnMUAeoAHHw,10,10,5,8,1,0,5,0,29,4.142857142857143,3,0.0,2,5,8,1,8,0,0,5,0,16,13,1
6190,136566,wamlK8Nx9pa9kXzI19EF5HF3fhJv3sWN,7GRhBDsirIGkRZBtSMEzNTyDr2JQm4xx,4,2,0,0,0,0,2,0,4,0.5714285714285714,1,0.0,0,0,0,0,2,0,0,2,0,0,4,1
6191,136576,wmN4PPC7Vh1X3pevAvwrqSI7HI55oZD6,A3fsA9Zfv1X2fVEQhTw51lKENdNrEqT3,11,8,6,0,6,0,5,1,26,3.7142857142857144,1,0.0,0,6,0,6,8,0,0,5,1,12,14,1
6192,136586,XvNNzv39b8VqKid0q4fV9ms2wVNAdWks,7GRhBDsirIGkRZBtSMEzNTyDr2JQm4xx,3,3,1,0,0,0,2,0,6,0.8571428571428571,2,0.0,0,1,0,0,3,0,0,2,0,1,5,1
6193,136588,KdKmzuUNmhXxN946vW23lms2nowQCTiW,7GRhBDsirIGkRZBtSMEzNTyDr2JQm4xx,6,0,0,0,0,0,17,2,19,2.7142857142857144,1,0.0,0,0,0,0,0,0,0,17,2,0,19,1
6194,136611,X7TCdJnOYqrDdC7umXZiC7RNUdfK8e7D,7GRhBDsirIGkRZBtSMEzNTyDr2JQm4xx,5,3,1,0,1,0,1,0,6,0.8571428571428571,1,0.0,0,1,0,1,3,0,0,1,0,2,4,1
6195,136615,Cv1aavObJnuABKfipF6OGePzg0BnGPFs,RXDvfPUBYFlVdlueBFbLW0mhhAyGEqpt,34,19,10,55,0,0,10,0,94,13.428571428571429,1,0.0,7,10,55,0,12,0,0,10,0,72,22,1
6196,136641,ndSSvoqRP9UOBqRicNUijfD0pPNDqiTJ,7GRhBDsirIGkRZBtSMEzNTyDr2JQm4xx,35,73,39,40,38,1,17,1,209,29.857142857142858,5,0.0,31,39,40,38,42,1,0,17,1,148,61,0
6197,136658,i6Z64SjIvtG8bIYKBDvv4gEAv5H6yeWe,7GRhBDsirIGkRZBtSMEzNTyDr2JQm4xx,1,0,0,0,0,0,2,0,2,0.2857142857142857,1,0.0,0,0,0,0,0,0,0,2,0,0,2,1
6198,136683,J3FKLxbUlPTor4lyG8lMpHc8oUQEjfcp,RXDvfPUBYFlVdlueBFbLW0mhhAyGEqpt,26,30,19,14,18,0,6,0,87,12.428571428571429,1,0.0,4,19,13,18,26,0,1,6,0,54,33,0
6199,136697,ZbpLZuhcPXDt8MCBlzIEU31Qmn57Ldle,G8EPVSXsOYB5YQWZGiz1aVq5Pgr2GrQu,5,7,3,0,1,0,5,0,16,2.2857142857142856,3,0.0,0,3,0,1,7,0,0,5,0,4,12,0
6200,136765,Jpxsd7AQ90urdftfAf3y5kTy6w3x8OIk,7GRhBDsirIGkRZBtSMEzNTyDr2JQm4xx,1,0,0,0,0,0,1,0,1,0.14285714285714285,1,0.0,0,0,0,0,0,0,0,1,0,0,1,1
6201,136798,i8t7Go6rdZ7c7uD9bC7IIvAKxqbWTCzk,7GRhBDsirIGkRZBtSMEzNTyDr2JQm4xx,9,10,3,0,3,0,4,0,20,2.857142857142857,1,0.0,0,3,0,3,10,0,0,4,0,6,14,1
6202,136811,MgBJbfRXH0QNEJmIiGY28SpmFvbhxSoF,7GRhBDsirIGkRZBtSMEzNTyDr2JQm4xx,1,0,0,0,0,0,1,0,1,0.14285714285714285,1,0.0,0,0,0,0,0,0,0,1,0,0,1,1
6203,136845,OmBhuxpgNHza1UgJ4sJoDmhlFXyn8dEO,SpATywNh6bZuzm8s1ceuBUnMUAeoAHHw,16,32,17,21,7,0,12,2,91,13.0,3,0.0,10,17,17,7,22,0,4,12,2,51,40,0
6204,136896,0CZrf1rdgKFCFIVyDqGwyjQ94p1TBewg,SpATywNh6bZuzm8s1ceuBUnMUAeoAHHw,10,9,1,0,1,1,7,1,20,2.857142857142857,1,0.0,1,1,0,1,8,1,0,7,1,3,17,1
6205,136994,UaiNqahLufAkWkzNVXpp9zyadIeXFDQ2,7GRhBDsirIGkRZBtSMEzNTyDr2JQm4xx,2,0,0,0,0,0,4,0,4,0.5714285714285714,1,0.0,0,0,0,0,0,0,0,4,0,0,4,1
6206,136997,azSMvYaBlxi8sVQgX0j44wgyxslA1ZOv,bWdj2GDclj5ofokWjzoa5jAwMkxCykd6,4,2,0,0,0,17,6,0,25,3.5714285714285716,1,0.0,0,0,0,0,2,17,0,6,0,0,25,0
6207,137007,1vvo0r6a7F7cnmAi2geIjNYeLW8STOBo,bWdj2GDclj5ofokWjzoa5jAwMkxCykd6,9,14,5,20,0,4,14,2,59,8.428571428571429,1,0.0,4,5,18,0,10,4,2,14,2,27,32,0
6208,137015,C7bvV9WgtivYIxdtA0RvlWoiA6KPa8KB,A3fsA9Zfv1X2fVEQhTw51lKENdNrEqT3,6,6,1,0,1,0,4,0,12,1.7142857142857142,2,0.0,0,1,0,1,6,0,0,4,0,2,10,1
6209,137018,xwVxmiN6s5Ty9myiVUNDBrV8mOb9D8yx,7GRhBDsirIGkRZBtSMEzNTyDr2JQm4xx,6,13,3,0,1,0,1,0,18,2.5714285714285716,1,0.0,9,3,0,1,4,0,0,1,0,13,5,1
6210,137066,ysgn6TuMNCSCCc3YWRE4ykee40CF0ytw,SpATywNh6bZuzm8s1ceuBUnMUAeoAHHw,9,9,4,0,2,0,8,1,24,3.4285714285714284,1,0.0,4,4,0,2,5,0,0,8,1,10,14,0
6211,137067,3AKxcSEV1jrslQIrEuinY7HEzBYlVr1w,7GRhBDsirIGkRZBtSMEzNTyDr2JQm4xx,1,0,0,0,0,0,1,0,1,0.14285714285714285,1,0.0,0,0,0,0,0,0,0,1,0,0,1,1
6212,137075,D5GqwXfacfySSvxPJ9v7ORjiX9Oa23f1,A3fsA9Zfv1X2fVEQhTw51lKENdNrEqT3,1,0,0,0,0,0,2,0,2,0.2857142857142857,1,0.0,0,0,0,0,0,0,0,2,0,0,2,1
6213,137106,ysgn6TuMNCSCCc3YWRE4ykee40CF0ytw,G8EPVSXsOYB5YQWZGiz1aVq5Pgr2GrQu,4,0,0,0,0,0,4,1,5,0.7142857142857143,1,0.0,0,0,0,0,0,0,0,4,1,0,5,1
6214,137107,XWnCbgeYVoaeV4iWRMUFAsMH4LdV0YRz,7GRhBDsirIGkRZBtSMEzNTyDr2JQm4xx,12,12,5,0,1,0,5,0,23,3.2857142857142856,1,0.0,0,5,0,1,12,0,0,5,0,6,17,1
6215,137120,TXBaUi0GpvXZWCDXsKlkFWTtfaT87UMz,7GRhBDsirIGkRZBtSMEzNTyDr2JQm4xx,1,0,0,0,0,0,1,0,1,0.14285714285714285,1,0.0,0,0,0,0,0,0,0,1,0,0,1,1
6216,137193,PmtrviA6hBub1PH85YXqVyZgghNsuc4g,RXDvfPUBYFlVdlueBFbLW0mhhAyGEqpt,8,8,2,0,1,0,2,0,13,1.8571428571428572,1,0.0,0,2,0,1,8,0,0,2,0,3,10,0
6217,137231,ZSEIlb9ma209LSHLrk2K3oKNlkQui4gF,7GRhBDsirIGkRZBtSMEzNTyDr2JQm4xx,30,43,15,37,9,4,6,0,114,16.285714285714285,2,0.0,24,15,33,9,19,4,4,6,0,81,33,1
6218,137244,v8s2hAX8tQgFD6i9MrUt2cuWPYPq3DuN,7GRhBDsirIGkRZBtSMEzNTyDr2JQm4xx,29,48,18,31,19,12,4,0,132,18.857142857142858,4,0.0,26,18,28,19,22,12,3,4,0,91,41,0
6219,137259,jx3H6f2miwKbLN02Gt82PEqx2tCxuPiz,SpATywNh6bZuzm8s1ceuBUnMUAeoAHHw,17,15,9,7,6,5,20,1,63,9.0,3,0.0,2,9,7,6,13,5,0,20,1,24,39,0
6220,137268,qDignCY8ZSbFAHDmfGr6um90qnmxvInL,7GRhBDsirIGkRZBtSMEzNTyDr2JQm4xx,7,5,2,4,2,0,1,0,14,2.0,1,0.0,2,2,3,2,3,0,1,1,0,9,5,1
6221,137291,zhx9FAttDf9KfTt4QYbmf4kGhKS1JatC,fbPkOYLVPtPgIt0MxizjfFJov3JbHyAi,6,2,0,0,0,8,8,1,19,2.7142857142857144,1,0.0,0,0,0,0,2,8,0,8,1,0,19,1
6222,137293,aJRPciowZ4Uphw6R6OHAqScxIuuZ6bxP,fbPkOYLVPtPgIt0MxizjfFJov3JbHyAi,1,0,0,0,0,0,1,0,1,0.14285714285714285,1,0.0,0,0,0,0,0,0,0,1,0,0,1,0
6223,137294,2AVqf09WA2itMEZz0u7FX3Fi3x3FZzPg,fbPkOYLVPtPgIt0MxizjfFJov3JbHyAi,6,8,4,0,2,1,5,0,20,2.857142857142857,2,0.0,0,4,0,2,8,1,0,5,0,6,14,1
6224,137295,VaoxktacOI8C5q8hn2iIjPvNhrMgUBA1,fbPkOYLVPtPgIt0MxizjfFJov3JbHyAi,1,0,0,0,0,0,1,0,1,0.14285714285714285,1,0.0,0,0,0,0,0,0,0,1,0,0,1,1
6225,137297,YkKsB5X9vnptYYEdKXeE2TLVCO4MMdOc,fbPkOYLVPtPgIt0MxizjfFJov3JbHyAi,6,6,3,0,2,0,3,0,14,2.0,1,0.0,0,3,0,2,6,0,0,3,0,5,9,1
6226,137298,c8WJAdYLV71mOx4ZXSglpCNd0dBUR3Om,fbPkOYLVPtPgIt0MxizjfFJov3JbHyAi,10,8,3,3,2,3,5,0,24,3.4285714285714284,1,0.0,1,3,2,2,7,3,1,5,0,8,16,1
6227,137302,qfe1MUR6a62dAgiCJR4API4cCHsYlsVO,fbPkOYLVPtPgIt0MxizjfFJov3JbHyAi,6,4,3,0,3,0,1,0,11,1.5714285714285714,1,0.0,0,3,0,3,4,0,0,1,0,6,5,1
6228,137303,RUYKIgG46teji8tqIoyMK9d2o6MFKma5,fbPkOYLVPtPgIt0MxizjfFJov3JbHyAi,10,5,3,0,3,0,6,0,17,2.4285714285714284,1,0.0,0,3,0,3,5,0,0,6,0,6,11,1
6229,137305,Z1uIScALT37BtyCtbFy33E9DuvHO2hks,fbPkOYLVPtPgIt0MxizjfFJov3JbHyAi,12,47,8,3,5,2,15,1,81,11.571428571428571,1,0.0,10,8,3,5,37,2,0,15,1,26,55,1
6230,137307,CgQYjUs70RSn4QebA63eL3Qm5MtCUzhj,fbPkOYLVPtPgIt0MxizjfFJov3JbHyAi,6,4,2,0,2,0,1,0,9,1.2857142857142858,1,0.0,1,2,0,2,3,0,0,1,0,5,4,0
6231,137310,3dtK0EXsDFiqPIgXhR4S028y6RGCztxN,fbPkOYLVPtPgIt0MxizjfFJov3JbHyAi,9,6,2,0,3,0,7,0,18,2.5714285714285716,1,0.0,3,2,0,3,3,0,0,7,0,8,10,1
6232,137311,bAltXvR0FBKFy91atPslJEMIb77R3lRC,fbPkOYLVPtPgIt0MxizjfFJov3JbHyAi,5,3,2,0,2,3,6,0,16,2.2857142857142856,2,0.0,0,2,0,2,3,3,0,6,0,4,12,1
6233,137312,yG9o9nU1hVydCMiwULHDO2ptGPwb3jNJ,fbPkOYLVPtPgIt0MxizjfFJov3JbHyAi,10,7,4,0,5,0,6,0,22,3.142857142857143,1,0.0,2,4,0,5,5,0,0,6,0,11,11,1
6234,137314,yQcq1gJWEi9sb58vjqz4cWvz65K4he0Q,fbPkOYLVPtPgIt0MxizjfFJov3JbHyAi,5,2,1,0,1,0,7,0,11,1.5714285714285714,1,0.0,0,1,0,1,2,0,0,7,0,2,9,1
6235,137316,xmbjcbay9FhXPDAWN6ffVRxetrr8jeM4,fbPkOYLVPtPgIt0MxizjfFJov3JbHyAi,16,9,7,0,6,11,14,1,48,6.857142857142857,1,0.0,0,7,0,6,9,11,0,14,1,13,35,1
6236,137317,55wDwHImP2KSV7dhBC7nPdVPLu4YizxX,fbPkOYLVPtPgIt0MxizjfFJov3JbHyAi,5,3,1,0,1,0,6,0,11,1.5714285714285714,1,0.0,0,1,0,1,3,0,0,6,0,2,9,1
6237,137318,5R4vzdx33VN10wY0ny2PCajdeF7dJThU,fbPkOYLVPtPgIt0MxizjfFJov3JbHyAi,5,2,1,0,1,0,3,0,7,1.0,1,0.0,0,1,0,1,2,0,0,3,0,2,5,1
6238,137320,8XstJLDa8agdHppUFVVZbvtgkIjc1hSo,fbPkOYLVPtPgIt0MxizjfFJov3JbHyAi,5,2,1,0,1,3,2,0,9,1.2857142857142858,1,0.0,0,1,0,1,2,3,0,2,0,2,7,1
6239,137322,7YUms5oSq8SOTxahUEH4CgK97RwpzrJL,fbPkOYLVPtPgIt0MxizjfFJov3JbHyAi,1,0,0,0,0,0,1,0,1,0.14285714285714285,1,0.0,0,0,0,0,0,0,0,1,0,0,1,1
6240,137327,4QLYsScyK6MU5AtBG0Whf2A1TPnb1x0x,fbPkOYLVPtPgIt0MxizjfFJov3JbHyAi,4,2,1,0,1,0,1,0,5,0.7142857142857143,1,0.0,0,1,0,1,2,0,0,1,0,2,3,1
6241,137328,DRsh16n3YrIgDiEC23najFM1m1jqkwJO,fbPkOYLVPtPgIt0MxizjfFJov3JbHyAi,5,3,1,0,1,0,1,0,6,0.8571428571428571,1,0.0,0,1,0,1,3,0,0,1,0,2,4,1
6242,137330,VThmvfwuMXDnKChVAYvsJFXoC4zUM0D9,fbPkOYLVPtPgIt0MxizjfFJov3JbHyAi,4,2,1,0,1,0,1,0,5,0.7142857142857143,1,0.0,0,1,0,1,2,0,0,1,0,2,3,1
6243,137333,gctoOufeRjSEdr00xmWUSLYVm7c6Ovl4,fbPkOYLVPtPgIt0MxizjfFJov3JbHyAi,2,0,0,0,0,0,4,0,4,0.5714285714285714,1,0.0,0,0,0,0,0,0,0,4,0,0,4,1
6244,137334,bzOuF27O1YGS02SMyouUKFo24T7mHVXd,fbPkOYLVPtPgIt0MxizjfFJov3JbHyAi,8,6,3,0,4,0,4,0,17,2.4285714285714284,1,0.0,1,3,0,4,5,0,0,4,0,8,9,1
6245,137337,SO9qUKDjuES2bMkck2Ro41uio1RDDMn4,fbPkOYLVPtPgIt0MxizjfFJov3JbHyAi,4,2,0,0,0,0,2,0,4,0.5714285714285714,1,0.0,0,0,0,0,2,0,0,2,0,0,4,1
6246,137338,i1dAtk6qr0Yjyjyw021VWnqB4cTdL0zR,fbPkOYLVPtPgIt0MxizjfFJov3JbHyAi,20,16,11,0,9,12,10,3,61,8.714285714285714,1,0.0,0,11,0,9,16,12,0,10,3,20,41,1
6247,137344,UUY3BPLR7A3Xa6FGsztMCn6xCbxtdCYu,fbPkOYLVPtPgIt0MxizjfFJov3JbHyAi,4,2,1,0,1,0,1,0,5,0.7142857142857143,1,0.0,0,1,0,1,2,0,0,1,0,2,3,1
6248,137346,LhTbpdQPj8McUYLExnN4ONQebEAJlctK,fbPkOYLVPtPgIt0MxizjfFJov3JbHyAi,5,2,1,0,1,0,2,0,6,0.8571428571428571,1,0.0,0,1,0,1,2,0,0,2,0,2,4,1
6249,137347,OilNA0H2OqGoAWakPxAdVr8srp2M8Kk5,fbPkOYLVPtPgIt0MxizjfFJov3JbHyAi,5,2,1,0,1,0,9,0,13,1.8571428571428572,2,0.0,0,1,0,1,2,0,0,9,0,2,11,1
6250,137349,hTAo9KiAJdTi42ZGMp48lMwTSPkKJERF,fbPkOYLVPtPgIt0MxizjfFJov3JbHyAi,2,0,0,0,0,0,4,0,4,0.5714285714285714,1,0.0,0,0,0,0,0,0,0,4,0,0,4,1
6251,137350,LUzWKYsqqChsro86iNB09MI9Og8MojLk,fbPkOYLVPtPgIt0MxizjfFJov3JbHyAi,6,6,2,0,2,0,4,0,14,2.0,1,0.0,3,2,0,2,3,0,0,4,0,7,7,1
6252,137351,wOJGPiHQhntwjEFJywVCc6H0XBUUrn4W,fbPkOYLVPtPgIt0MxizjfFJov3JbHyAi,5,2,1,0,1,0,4,0,8,1.1428571428571428,1,0.0,0,1,0,1,2,0,0,4,0,2,6,1
6253,137352,cuefNHr7cmtAeAOTeZH62xK2M7JgCzzm,fbPkOYLVPtPgIt0MxizjfFJov3JbHyAi,6,3,1,0,1,0,4,0,9,1.2857142857142858,1,0.0,0,1,0,1,3,0,0,4,0,2,7,1
6254,137354,WtDMxixQmy03wB9jEWr2xYQPm36rgbzM,fbPkOYLVPtPgIt0MxizjfFJov3JbHyAi,9,16,2,3,4,0,8,0,33,4.714285714285714,1,0.0,8,2,3,4,8,0,0,8,0,17,16,1
6255,137356,ADL0cXowUMs4wyiAOHKMOrtTHu5tmUqi,fbPkOYLVPtPgIt0MxizjfFJov3JbHyAi,5,3,2,0,1,0,3,0,9,1.2857142857142858,1,0.0,0,2,0,1,3,0,0,3,0,3,6,1
6256,137359,tg3C5tAthjtIE6hVso6iXfcLGroduOx8,fbPkOYLVPtPgIt0MxizjfFJov3JbHyAi,6,4,1,0,1,0,3,0,9,1.2857142857142858,1,0.0,0,1,0,1,4,0,0,3,0,2,7,1
6257,137360,NEKO6BLQdSSPIkqL9Q7yxqF7YpsLWJ2i,fbPkOYLVPtPgIt0MxizjfFJov3JbHyAi,7,4,2,0,1,1,8,0,16,2.2857142857142856,1,0.0,0,2,0,1,4,1,0,8,0,3,13,1
6258,137362,6OO2RXg4fKLY0L2CDQWPbDzS9qYFNLhY,fbPkOYLVPtPgIt0MxizjfFJov3JbHyAi,7,2,1,0,1,2,11,1,18,2.5714285714285716,1,0.0,0,1,0,1,2,2,0,11,1,2,16,1
6259,137363,PG5DcX6LvCCrfUIpAzQI5ebaNfLqaT2x,fbPkOYLVPtPgIt0MxizjfFJov3JbHyAi,9,8,4,0,3,19,6,1,41,5.857142857142857,1,0.0,3,4,0,3,5,19,0,6,1,10,31,1
6260,137364,PNltRKReLHuKml6LKXYu0Xf2LLMAke1h,fbPkOYLVPtPgIt0MxizjfFJov3JbHyAi,5,5,0,0,0,0,4,0,9,1.2857142857142858,1,0.0,0,0,0,0,5,0,0,4,0,0,9,1
6261,137365,X285XxvFlCKmuDlV3vzMxZpCu1V9X67P,fbPkOYLVPtPgIt0MxizjfFJov3JbHyAi,7,8,4,0,3,7,1,0,23,3.2857142857142856,1,0.0,2,4,0,3,6,7,0,1,0,9,14,1
6262,137366,0TSJej9rL1Sb8axummfeQPMEkUPlnJtY,fbPkOYLVPtPgIt0MxizjfFJov3JbHyAi,4,2,1,0,1,0,1,0,5,0.7142857142857143,1,0.0,0,1,0,1,2,0,0,1,0,2,3,1
6263,137367,yUbOTxLRPrMBKeEJQgeZAYWE44xjkzqj,fbPkOYLVPtPgIt0MxizjfFJov3JbHyAi,3,0,0,0,0,7,5,0,12,1.7142857142857142,1,0.0,0,0,0,0,0,7,0,5,0,0,12,1
6264,137368,fWcDM7NTKsDIL7vPWRWhQ3HiIwO7ubW6,fbPkOYLVPtPgIt0MxizjfFJov3JbHyAi,5,3,2,0,1,0,4,0,10,1.4285714285714286,1,0.0,0,2,0,1,3,0,0,4,0,3,7,1
6265,137369,llbduCly6ZFemSI4OiW2PWc2ZsNUujfV,fbPkOYLVPtPgIt0MxizjfFJov3JbHyAi,5,2,1,0,1,2,2,0,8,1.1428571428571428,1,0.0,0,1,0,1,2,2,0,2,0,2,6,1
6266,137371,IDAegjDGT88IxffhIlPXozfrAIyenr6d,fbPkOYLVPtPgIt0MxizjfFJov3JbHyAi,9,11,5,0,3,8,16,0,43,6.142857142857143,1,0.0,3,5,0,3,8,8,0,16,0,11,32,0
6267,137374,XnBCBUkc42wLmZebmQm45ZhzN8434GYt,fbPkOYLVPtPgIt0MxizjfFJov3JbHyAi,9,3,2,0,2,1,8,1,17,2.4285714285714284,1,0.0,0,2,0,2,3,1,0,8,1,4,13,1
6268,137376,xudT2FGfOf7lnAynFZztXlYI3LpEGyZP,fbPkOYLVPtPgIt0MxizjfFJov3JbHyAi,6,5,3,0,2,2,7,0,19,2.7142857142857144,1,0.0,0,3,0,2,5,2,0,7,0,5,14,1
6269,137378,1wIqcRX58Bpw6RXvGnbxsc6WbPwWGwXd,fbPkOYLVPtPgIt0MxizjfFJov3JbHyAi,5,5,3,0,2,2,2,0,14,2.0,2,0.0,0,3,0,2,5,2,0,2,0,5,9,1
6270,137380,yNFkVq3WBH36gbFucxZddTEItgWhR2NG,fbPkOYLVPtPgIt0MxizjfFJov3JbHyAi,7,5,2,0,3,0,2,0,12,1.7142857142857142,1,0.0,2,2,0,3,3,0,0,2,0,7,5,1
6271,137381,XE05vZThEHf17O6FM08AySNf2qZFgNWa,fbPkOYLVPtPgIt0MxizjfFJov3JbHyAi,7,6,3,1,4,0,1,0,15,2.142857142857143,1,0.0,2,3,1,4,4,0,0,1,0,10,5,1
6272,137382,nkm4i9oKKVu0C5FrCnxvTBLSuiaAGdZs,fbPkOYLVPtPgIt0MxizjfFJov3JbHyAi,6,3,2,0,2,0,1,0,8,1.1428571428571428,1,0.0,0,2,0,2,3,0,0,1,0,4,4,1
6273,137385,Cil3ne7R9WaXD5p2VZEmRDvLwX0ITQx4,fbPkOYLVPtPgIt0MxizjfFJov3JbHyAi,5,2,1,0,1,1,3,0,8,1.1428571428571428,1,0.0,0,1,0,1,2,1,0,3,0,2,6,1
6274,137387,KpMidRbqlnB1jsFzzXeXD9SSZ9cT4DEn,fbPkOYLVPtPgIt0MxizjfFJov3JbHyAi,2,0,0,0,0,0,2,0,2,0.2857142857142857,1,0.0,0,0,0,0,0,0,0,2,0,0,2,1
6275,137389,tsTDNHtkzUQqr6Le5CiKzEb1J3ub8XpE,fbPkOYLVPtPgIt0MxizjfFJov3JbHyAi,1,0,0,0,0,0,1,0,1,0.14285714285714285,1,0.0,0,0,0,0,0,0,0,1,0,0,1,1
6276,137390,WGBXR80uiaxU0rQGqPRIQBTLpC89XbJW,fbPkOYLVPtPgIt0MxizjfFJov3JbHyAi,2,0,0,0,0,0,2,0,2,0.2857142857142857,1,0.0,0,0,0,0,0,0,0,2,0,0,2,1
6277,137392,5iWOSqpJMywqKPlLQJ5aQLOawtvw8Iyp,fbPkOYLVPtPgIt0MxizjfFJov3JbHyAi,5,2,1,0,1,0,8,0,12,1.7142857142857142,1,0.0,0,1,0,1,2,0,0,8,0,2,10,1
6278,137393,iRCtUk9qJG1ZNpyYOkrIzRzmwV1jkfTG,fbPkOYLVPtPgIt0MxizjfFJov3JbHyAi,2,0,0,0,0,0,6,0,6,0.8571428571428571,1,0.0,0,0,0,0,0,0,0,6,0,0,6,1
6279,137394,C8zDhaG0vPsQegBtS55u3JZHiYuueFnE,fbPkOYLVPtPgIt0MxizjfFJov3JbHyAi,5,2,1,0,1,0,4,0,8,1.1428571428571428,1,0.0,0,1,0,1,2,0,0,4,0,2,6,1
6280,137395,174L1V9TprbRTHroQ9FWwbu1TqCVlQjk,fbPkOYLVPtPgIt0MxizjfFJov3JbHyAi,5,2,1,0,1,0,2,0,6,0.8571428571428571,1,0.0,0,1,0,1,2,0,0,2,0,2,4,1
6281,137396,mSgxVbbf83kCrpd2JLuv7BfCExmUt2C4,fbPkOYLVPtPgIt0MxizjfFJov3JbHyAi,8,4,2,0,2,2,4,1,15,2.142857142857143,1,0.0,1,2,0,2,3,2,0,4,1,5,10,0
6282,137398,Kc3YlgMAuK3aPMXYbr7Lb1W7MBNaKMiR,fbPkOYLVPtPgIt0MxizjfFJov3JbHyAi,6,3,2,0,2,0,1,0,8,1.1428571428571428,1,0.0,0,2,0,2,3,0,0,1,0,4,4,1
6283,137400,a5h0uXVhrD32xi14HjckmWeHNJHW3EMf,fbPkOYLVPtPgIt0MxizjfFJov3JbHyAi,4,15,2,0,0,0,1,0,18,2.5714285714285716,1,0.0,0,2,0,0,15,0,0,1,0,2,16,1
6284,137401,kQsVPicmVfwF40LR0Bwbh20EXwnKbn92,fbPkOYLVPtPgIt0MxizjfFJov3JbHyAi,9,14,5,1,7,16,9,1,53,7.571428571428571,2,0.0,9,5,1,7,5,16,0,9,1,22,31,1
6285,137402,C8KvwWwhKVcH5gZKcH7dQig9dEhWoVOu,fbPkOYLVPtPgIt0MxizjfFJov3JbHyAi,2,0,0,0,0,0,3,0,3,0.42857142857142855,1,0.0,0,0,0,0,0,0,0,3,0,0,3,1
6286,137403,3rZRyyAqQR0LHT7iXSTyhR4wZI7IzOpN,fbPkOYLVPtPgIt0MxizjfFJov3JbHyAi,6,6,2,0,3,0,1,0,12,1.7142857142857142,1,0.0,3,2,0,3,3,0,0,1,0,8,4,1
6287,137404,nOvIog5xbz5ZKA2OUeEwDTOaSy9QOHTT,fbPkOYLVPtPgIt0MxizjfFJov3JbHyAi,8,8,4,0,3,0,12,0,27,3.857142857142857,1,0.0,0,4,0,3,8,0,0,12,0,7,20,1
6288,137409,OD1pqN8En0iNd52vQpaf4DwGLH3W4dof,fbPkOYLVPtPgIt0MxizjfFJov3JbHyAi,9,7,5,0,3,0,3,0,18,2.5714285714285716,2,0.0,0,5,0,3,7,0,0,3,0,8,10,1
6289,137413,uCu7X2FM1qO7UaWcT7yafBpyCKsVxRuo,fbPkOYLVPtPgIt0MxizjfFJov3JbHyAi,7,2,1,0,1,3,6,1,14,2.0,1,0.0,0,1,0,1,2,3,0,6,1,2,12,1
6290,137416,A41hdT15T7mumzDW53QCDXRUsOilvTI0,fbPkOYLVPtPgIt0MxizjfFJov3JbHyAi,9,16,8,0,3,9,5,0,41,5.857142857142857,2,0.0,0,8,0,3,16,9,0,5,0,11,30,0
6291,137419,wCdkG2gdJ13TsTuESZCgsx6c9HoUuD9s,fbPkOYLVPtPgIt0MxizjfFJov3JbHyAi,8,10,4,7,4,0,1,0,26,3.7142857142857144,1,0.0,4,4,6,4,6,0,1,1,0,18,8,1
6292,137422,cH7MXJwZ1B11Byd6oixA8vDtJ38H8Xie,fbPkOYLVPtPgIt0MxizjfFJov3JbHyAi,5,1,1,0,1,0,3,0,6,0.8571428571428571,1,0.0,0,1,0,1,1,0,0,3,0,2,4,1
6293,137423,BEEx400Zym1Adj0LXV9O094DcgDYxMgU,fbPkOYLVPtPgIt0MxizjfFJov3JbHyAi,4,2,1,0,1,0,1,0,5,0.7142857142857143,1,0.0,0,1,0,1,2,0,0,1,0,2,3,1
6294,137424,bqKMJ5OUNpA2Wgq0oxWCoJ7xNwTYKmHM,fbPkOYLVPtPgIt0MxizjfFJov3JbHyAi,12,9,7,0,6,0,1,0,23,3.2857142857142856,1,0.0,0,7,0,6,9,0,0,1,0,13,10,1
6295,137425,X6JW84BYI57qMmiEsexKiPAn78X5H1sY,fbPkOYLVPtPgIt0MxizjfFJov3JbHyAi,3,2,0,0,0,0,1,0,3,0.42857142857142855,1,0.0,0,0,0,0,2,0,0,1,0,0,3,1
6296,137426,45lJHu4OdGTQsQvp0urXXWXHjLHgbztG,fbPkOYLVPtPgIt0MxizjfFJov3JbHyAi,2,0,0,0,0,0,2,0,2,0.2857142857142857,1,0.0,0,0,0,0,0,0,0,2,0,0,2,1
6297,137428,Q7kz14DBsTywLRi7Bx0P7HkElJgTxbaA,fbPkOYLVPtPgIt0MxizjfFJov3JbHyAi,4,3,2,0,0,0,3,0,8,1.1428571428571428,1,0.0,0,2,0,0,3,0,0,3,0,2,6,1
6298,137430,zEaDEiE5fac9Y3NT8JaitlDl9a7ILbFn,fbPkOYLVPtPgIt0MxizjfFJov3JbHyAi,6,1,1,0,1,0,9,0,12,1.7142857142857142,1,0.0,0,1,0,1,1,0,0,9,0,2,10,1
6299,137432,4foS4JAYOnNJdWly53kH9VyAeI8ZpoB9,fbPkOYLVPtPgIt0MxizjfFJov3JbHyAi,8,5,3,0,2,0,4,0,14,2.0,1,0.0,0,3,0,2,5,0,0,4,0,5,9,1
6300,137433,MXpZg6Y3WvwOURUS1VvgXTxhk1pXKVY7,fbPkOYLVPtPgIt0MxizjfFJov3JbHyAi,7,6,2,0,3,3,2,0,16,2.2857142857142856,1,0.0,3,2,0,3,3,3,0,2,0,8,8,1
6301,137435,2kGVAArEEN0LJBurgHk38pEMZThzj1T0,fbPkOYLVPtPgIt0MxizjfFJov3JbHyAi,6,3,2,0,2,0,1,0,8,1.1428571428571428,1,0.0,0,2,0,2,3,0,0,1,0,4,4,1
6302,137436,NOuxSmdis5r1BA64zbAkvC5MyhRcV1wd,fbPkOYLVPtPgIt0MxizjfFJov3JbHyAi,2,0,0,0,0,0,11,0,11,1.5714285714285714,1,0.0,0,0,0,0,0,0,0,11,0,0,11,1
6303,137437,tQSlSaSXXQMbulfRrarng77t6SPsEo7N,fbPkOYLVPtPgIt0MxizjfFJov3JbHyAi,6,7,4,0,5,0,1,0,17,2.4285714285714284,1,0.0,2,4,0,5,5,0,0,1,0,11,6,1
6304,137439,0PoVNnWMSVMNUD7YbDeAnDdYFFtJNZml,fbPkOYLVPtPgIt0MxizjfFJov3JbHyAi,5,2,1,0,1,0,2,0,6,0.8571428571428571,1,0.0,0,1,0,1,2,0,0,2,0,2,4,1
6305,137441,4hHmnOenTXav8CdwQUU4bXbhMHCuz22G,fbPkOYLVPtPgIt0MxizjfFJov3JbHyAi,12,29,5,8,7,3,12,2,66,9.428571428571429,2,0.0,12,5,8,7,17,3,0,12,2,32,34,1
6306,137442,1LtLQwRGDjWRPORAmpPeWuHr93qsG62M,fbPkOYLVPtPgIt0MxizjfFJov3JbHyAi,3,3,0,0,0,4,1,0,8,1.1428571428571428,1,0.0,0,0,0,0,3,4,0,1,0,0,8,1
6307,137444,7J7CDZ99WfuIWgF8UjFLGxW2Gw1ELsrr,fbPkOYLVPtPgIt0MxizjfFJov3JbHyAi,5,3,1,0,1,0,2,0,7,1.0,1,0.0,1,1,0,1,2,0,0,2,0,3,4,1
6308,137445,CuHzzfkniWARJNGhM9Z8TfGkX4QBNw5S,fbPkOYLVPtPgIt0MxizjfFJov3JbHyAi,2,0,0,0,0,0,5,0,5,0.7142857142857143,1,0.0,0,0,0,0,0,0,0,5,0,0,5,1
6309,137447,ucnh7Je2Ujv5K3Q3wjC5gWq40jwh8dv6,fbPkOYLVPtPgIt0MxizjfFJov3JbHyAi,5,8,3,0,1,0,2,0,14,2.0,1,0.0,0,3,0,1,8,0,0,2,0,4,10,1
6310,137448,ELrr1JfnDsWjEvT48HXDtL9YqiQpfZmF,fbPkOYLVPtPgIt0MxizjfFJov3JbHyAi,6,2,1,0,1,0,9,0,13,1.8571428571428572,1,0.0,0,1,0,1,2,0,0,9,0,2,11,1
6311,137450,nGWRzCfLEHu3fioeTp2MrUVqCTeaWKKh,fbPkOYLVPtPgIt0MxizjfFJov3JbHyAi,8,3,2,0,2,1,5,0,13,1.8571428571428572,1,0.0,0,2,0,2,3,1,0,5,0,4,9,1
6312,137452,OyUzOGgEg3D1ADlF5EJGg06nY3QmnkdW,fbPkOYLVPtPgIt0MxizjfFJov3JbHyAi,2,0,0,0,0,0,4,0,4,0.5714285714285714,1,0.0,0,0,0,0,0,0,0,4,0,0,4,1
6313,137454,U324n6nKpAIcARSxYaybih33hdfe43Hg,fbPkOYLVPtPgIt0MxizjfFJov3JbHyAi,1,0,0,0,0,0,1,0,1,0.14285714285714285,1,0.0,0,0,0,0,0,0,0,1,0,0,1,1
6314,137455,LLnSYhSyIZOYJyyJOzJg3NGJiWH34163,fbPkOYLVPtPgIt0MxizjfFJov3JbHyAi,1,0,0,0,0,0,1,0,1,0.14285714285714285,1,0.0,0,0,0,0,0,0,0,1,0,0,1,1
6315,137456,lYv59CqFZ5WNS1LpSdwbwYgAB1AnSa2W,fbPkOYLVPtPgIt0MxizjfFJov3JbHyAi,10,5,3,0,2,4,7,2,23,3.2857142857142856,1,0.0,0,3,0,2,5,4,0,7,2,5,18,1
6316,137457,5hA99qfStHjQqEYR2bkieX1UEObLPtIn,fbPkOYLVPtPgIt0MxizjfFJov3JbHyAi,5,3,0,0,0,0,2,0,5,0.7142857142857143,1,0.0,0,0,0,0,3,0,0,2,0,0,5,1
6317,137458,ccrvrr39fWp2aVbnA3k1bH1sjmwx7FQs,fbPkOYLVPtPgIt0MxizjfFJov3JbHyAi,8,25,2,0,0,0,9,0,36,5.142857142857143,2,0.0,0,2,0,0,25,0,0,9,0,2,34,1
6318,137459,Rr92BzwqUyCtPYHU3DwB1aivajxBRTFz,fbPkOYLVPtPgIt0MxizjfFJov3JbHyAi,4,2,1,0,1,0,1,0,5,0.7142857142857143,1,0.0,0,1,0,1,2,0,0,1,0,2,3,1
6319,138172,jb9pTa916Vn2VeH0D7ExYaf2JyoI9zrO,7GRhBDsirIGkRZBtSMEzNTyDr2JQm4xx,14,12,1,0,2,15,15,1,46,6.571428571428571,2,0.0,2,1,0,2,10,15,0,15,1,5,41,0
6320,138175,mLD9g4ezOv6SvPMWLaj047DaKrptKosJ,7GRhBDsirIGkRZBtSMEzNTyDr2JQm4xx,4,4,3,0,3,1,1,0,12,1.7142857142857142,1,0.0,0,3,0,3,4,1,0,1,0,6,6,1
6321,138199,x29OOChdmJGXK62DnUpwKbwJurqULmnD,7GRhBDsirIGkRZBtSMEzNTyDr2JQm4xx,7,6,2,0,3,0,2,0,13,1.8571428571428572,1,0.0,3,2,0,3,3,0,0,2,0,8,5,0
6322,138215,RgBHZtppWNmiRr4zn4KqEhMkv6vEscGZ,7GRhBDsirIGkRZBtSMEzNTyDr2JQm4xx,29,41,15,67,14,3,1,0,141,20.142857142857142,1,0.0,24,15,58,14,17,3,9,1,0,111,30,0
6323,138232,MfzRriitP2kzeiTWJO2r85qGclUEFMNK,7GRhBDsirIGkRZBtSMEzNTyDr2JQm4xx,6,3,1,0,1,0,5,0,10,1.4285714285714286,1,0.0,0,1,0,1,3,0,0,5,0,2,8,1
6324,138264,45E6hpwDMHp9Q3Pt1xT8q04bbowKk87g,7GRhBDsirIGkRZBtSMEzNTyDr2JQm4xx,33,92,25,30,22,1,10,0,180,25.714285714285715,2,0.0,63,25,28,22,29,1,2,10,0,138,42,0
6325,138266,pAkhnLI0s5vboktZycO7Tobv6jbspULh,G8EPVSXsOYB5YQWZGiz1aVq5Pgr2GrQu,17,15,8,6,8,0,2,0,39,5.571428571428571,2,0.0,5,8,5,8,10,0,1,2,0,26,13,0
6326,138267,pAkhnLI0s5vboktZycO7Tobv6jbspULh,7GRhBDsirIGkRZBtSMEzNTyDr2JQm4xx,3,2,1,0,0,0,1,0,4,0.5714285714285714,1,0.0,0,1,0,0,2,0,0,1,0,1,3,1
6327,138314,W6AT73CXG4URTyD2I7QWXXVZx4oeh86N,7GRhBDsirIGkRZBtSMEzNTyDr2JQm4xx,16,18,10,0,7,0,9,0,44,6.285714285714286,2,0.0,4,10,0,7,14,0,0,9,0,21,23,1
6328,138324,lVwgv61cg8fkhW9rg5b1PIPnuUWxb0Vk,7GRhBDsirIGkRZBtSMEzNTyDr2JQm4xx,1,0,0,0,0,0,1,0,1,0.14285714285714285,1,0.0,0,0,0,0,0,0,0,1,0,0,1,1
6329,138367,KAW52VBDXCvurEAry0tITiLWjcxVkV8S,SpATywNh6bZuzm8s1ceuBUnMUAeoAHHw,18,41,16,24,4,63,18,1,167,23.857142857142858,4,0.0,16,16,20,4,25,63,4,18,1,56,111,0
6330,138373,0I055s9vaRQ6PXqeLKyD6l9kPxlReBT2,7GRhBDsirIGkRZBtSMEzNTyDr2JQm4xx,1,0,0,0,0,0,1,0,1,0.14285714285714285,1,0.0,0,0,0,0,0,0,0,1,0,0,1,1
6331,138406,73Lo5aiYTeasg8R5eGVwIsechNk0OHx6,SpATywNh6bZuzm8s1ceuBUnMUAeoAHHw,12,6,4,0,3,0,6,0,19,2.7142857142857144,2,0.0,0,4,0,3,6,0,0,6,0,7,12,1
6332,138456,jSWk10JJ0OWajXDG9k2ujEK46fA1leIF,7GRhBDsirIGkRZBtSMEzNTyDr2JQm4xx,2,0,0,0,0,0,2,0,2,0.2857142857142857,1,0.0,0,0,0,0,0,0,0,2,0,0,2,1
6333,138467,LN6esXV3qnIoLg44h6fXbTBvNC9pi5Ym,7GRhBDsirIGkRZBtSMEzNTyDr2JQm4xx,1,0,0,0,0,0,1,0,1,0.14285714285714285,1,0.0,0,0,0,0,0,0,0,1,0,0,1,1
6334,138510,eh4s2O0xG3K7bB3gC9QI2pZbmOHi0FkP,7GRhBDsirIGkRZBtSMEzNTyDr2JQm4xx,6,2,1,0,1,0,3,0,7,1.0,1,0.0,0,1,0,1,2,0,0,3,0,2,5,1
6335,138515,2Vr8sMi8Nmtw7GvPlYj3ww9EzMgjDWh8,SpATywNh6bZuzm8s1ceuBUnMUAeoAHHw,17,108,41,12,5,19,21,3,209,29.857142857142858,3,0.0,35,41,12,5,73,19,0,21,3,93,116,0
6336,138523,BhCvmy8WtOEti83wDjK9xOLWP4oCctij,RXDvfPUBYFlVdlueBFbLW0mhhAyGEqpt,6,4,1,0,2,2,3,0,12,1.7142857142857142,2,0.0,3,1,0,2,1,2,0,3,0,6,6,1
6337,138534,ilUzpPaeFISeGNY7Nt0DehBLL3wxQX0O,7GRhBDsirIGkRZBtSMEzNTyDr2JQm4xx,9,1,1,0,1,0,8,0,11,1.5714285714285714,1,0.0,0,1,0,1,1,0,0,8,0,2,9,1
6338,138537,e3wyIozlRLlcs7B7d4wJ9CCyj0Cy9HNB,7GRhBDsirIGkRZBtSMEzNTyDr2JQm4xx,7,2,1,0,1,0,4,1,9,1.2857142857142858,1,0.0,0,1,0,1,2,0,0,4,1,2,7,1
6339,138553,okqN4nBVKRYYrkYonKicKGOmPqVGYjZh,SpATywNh6bZuzm8s1ceuBUnMUAeoAHHw,15,34,17,15,6,0,17,0,89,12.714285714285714,5,0.0,3,17,14,6,31,0,1,17,0,40,49,0
6340,138559,WNxlasM9yolV5j0jIrxkqf7jn6zMrkGu,SpATywNh6bZuzm8s1ceuBUnMUAeoAHHw,1,0,0,0,0,0,1,0,1,0.14285714285714285,1,0.0,0,0,0,0,0,0,0,1,0,0,1,0
6341,138621,dgFOOUSNfQK8xIrT47Av0Q04bBFeE21W,RXDvfPUBYFlVdlueBFbLW0mhhAyGEqpt,1,0,0,0,0,0,1,0,1,0.14285714285714285,1,0.0,0,0,0,0,0,0,0,1,0,0,1,1
6342,138627,QZoi4xpkEVVH2rbYL53oYFfYungIuUup,7GRhBDsirIGkRZBtSMEzNTyDr2JQm4xx,35,42,13,63,11,5,13,3,150,21.428571428571427,2,0.0,24,13,56,11,18,5,7,13,3,104,46,1
6343,138638,fUQHFT4QEMRSPqJAQlXlvlyNwca9Q0dU,7GRhBDsirIGkRZBtSMEzNTyDr2JQm4xx,2,0,0,0,0,0,2,0,2,0.2857142857142857,1,0.0,0,0,0,0,0,0,0,2,0,0,2,1
6344,138716,bWXDTeHwMBrcFvsHEHi16Kcz6vnkKBkc,SpATywNh6bZuzm8s1ceuBUnMUAeoAHHw,2,0,0,0,0,0,3,0,3,0.42857142857142855,1,0.0,0,0,0,0,0,0,0,3,0,0,3,1
6345,138728,kcajSl3XvPJzA8r8jTipqgj4EAGyDqJf,7GRhBDsirIGkRZBtSMEzNTyDr2JQm4xx,15,47,1,16,5,1,3,0,73,10.428571428571429,1,0.0,23,1,14,5,24,1,2,3,0,43,30,1
6346,138731,Za7TsRG0IgcPg4zI5JWLKyABDBTbji9K,7GRhBDsirIGkRZBtSMEzNTyDr2JQm4xx,23,59,0,55,5,0,4,0,123,17.571428571428573,2,0.0,31,0,49,5,28,0,6,4,0,85,38,1
6347,138736,Sz9JtbyfGasFOcDw3qsqx6peODd97ECd,7GRhBDsirIGkRZBtSMEzNTyDr2JQm4xx,5,2,1,0,1,0,2,0,6,0.8571428571428571,2,0.0,0,1,0,1,2,0,0,2,0,2,4,1
6348,138808,wZxGcsfZmDyO3eZaMEp8V4Qxwmu1n6lt,A3fsA9Zfv1X2fVEQhTw51lKENdNrEqT3,41,14,12,56,11,0,6,0,99,14.142857142857142,1,0.0,1,12,47,11,13,0,9,6,0,71,28,0
6349,138810,KarP5JDxaA55wR1ThEFPoGYFsHmbBCZf,SpATywNh6bZuzm8s1ceuBUnMUAeoAHHw,12,11,4,6,2,0,3,0,26,3.7142857142857144,2,0.0,3,4,6,2,8,0,0,3,0,15,11,1
6350,138873,lLp4bdT6ycggmaUdjHCcgWeQnh0T1b1d,SpATywNh6bZuzm8s1ceuBUnMUAeoAHHw,11,26,10,0,5,0,3,0,44,6.285714285714286,2,0.0,8,10,0,5,18,0,0,3,0,23,21,1
6351,138898,mSs5bB1Rxg3xYWjWjJY9pVTt7WAiMgyu,RXDvfPUBYFlVdlueBFbLW0mhhAyGEqpt,8,9,6,0,1,0,11,0,27,3.857142857142857,1,0.0,0,6,0,1,9,0,0,11,0,7,20,0
6352,138921,SdmxANaN4VeJNVCXABSOs77O0krJ65nl,SpATywNh6bZuzm8s1ceuBUnMUAeoAHHw,18,21,13,19,6,10,15,5,89,12.714285714285714,2,0.0,2,13,16,6,19,10,3,15,5,37,52,1
6353,138933,YbQfcgwKrjskWW3wyOzQUUJYzdeHmY82,7GRhBDsirIGkRZBtSMEzNTyDr2JQm4xx,18,37,8,6,9,0,2,0,62,8.857142857142858,1,0.0,18,8,6,9,19,0,0,2,0,41,21,1
6354,138979,9Mbi6CksSOlTvzJd1jV7pzorOP4mmF9E,SpATywNh6bZuzm8s1ceuBUnMUAeoAHHw,13,17,8,2,4,0,8,0,39,5.571428571428571,3,0.0,2,8,2,4,15,0,0,8,0,16,23,0
6355,139001,PLKaanKvHCtHMqtCskLE9sVgrYP9vmXy,SpATywNh6bZuzm8s1ceuBUnMUAeoAHHw,12,22,9,20,1,0,6,1,59,8.428571428571429,3,0.0,10,9,17,1,12,0,3,6,1,37,22,0
6356,139009,ucdoEtZyBMBpMuHw7eldMzgNsB5u9NZD,7GRhBDsirIGkRZBtSMEzNTyDr2JQm4xx,2,0,0,0,0,0,2,0,2,0.2857142857142857,1,0.0,0,0,0,0,0,0,0,2,0,0,2,1
6357,139030,nZH2h9tRgS1XihszFT0Gsl3zQK5yTzdn,7GRhBDsirIGkRZBtSMEzNTyDr2JQm4xx,1,0,0,0,0,0,2,0,2,0.2857142857142857,1,0.0,0,0,0,0,0,0,0,2,0,0,2,1
6358,139077,sTlxlEkJ3MbMUAeSajnaHOGfpyW9hgq1,7GRhBDsirIGkRZBtSMEzNTyDr2JQm4xx,4,3,1,0,1,0,1,0,6,0.8571428571428571,1,0.0,0,1,0,1,3,0,0,1,0,2,4,1
6359,139091,FqxZInDGuTXmPgpy2HmrKGvUbRHydqL9,A3fsA9Zfv1X2fVEQhTw51lKENdNrEqT3,43,38,29,72,14,12,10,3,178,25.428571428571427,2,0.0,3,29,59,14,35,12,13,10,3,105,73,1
6360,139097,rJa06nlcyBimvgL7PoPXhuOUbmR9mddR,7GRhBDsirIGkRZBtSMEzNTyDr2JQm4xx,1,0,0,0,0,0,1,0,1,0.14285714285714285,1,0.0,0,0,0,0,0,0,0,1,0,0,1,1
6361,139138,pLMdR2T5UiKa0jLlBQ6JAVdYxLS2oAZC,7GRhBDsirIGkRZBtSMEzNTyDr2JQm4xx,9,8,6,0,5,0,3,0,22,3.142857142857143,2,0.0,0,6,0,5,8,0,0,3,0,11,11,1
6362,139172,vQiAys6oOekX5OV9gzy071CxobZT5OY1,7GRhBDsirIGkRZBtSMEzNTyDr2JQm4xx,1,0,0,0,0,0,1,0,1,0.14285714285714285,1,0.0,0,0,0,0,0,0,0,1,0,0,1,1
6363,139207,RIjNzTzWwuMpVu0vcsF9N8cORAAtLFQn,bWdj2GDclj5ofokWjzoa5jAwMkxCykd6,6,5,1,0,2,0,3,0,11,1.5714285714285714,1,0.0,2,1,0,2,3,0,0,3,0,5,6,1
6364,139217,OOIu03NBEHePUSUIFa86FGFP5M136EAn,RXDvfPUBYFlVdlueBFbLW0mhhAyGEqpt,44,71,24,123,11,12,24,4,269,38.42857142857143,3,0.0,12,24,113,11,59,12,10,24,4,160,109,0
6365,139222,St6usTSSgX5U9v7wchuMWqmBKoCcDwN2,bWdj2GDclj5ofokWjzoa5jAwMkxCykd6,1,0,0,0,0,0,1,0,1,0.14285714285714285,1,0.0,0,0,0,0,0,0,0,1,0,0,1,1
6366,139230,Az3rIdfQyspbBZOuftkV0XmT1mpRRVMU,G8EPVSXsOYB5YQWZGiz1aVq5Pgr2GrQu,10,5,4,0,4,0,2,0,15,2.142857142857143,1,0.0,0,4,0,4,5,0,0,2,0,8,7,1
6367,139246,3nkAYJy31glMu7RttArFOqU7gmkfxNPM,SpATywNh6bZuzm8s1ceuBUnMUAeoAHHw,1,0,0,0,0,0,2,0,2,0.2857142857142857,2,0.0,0,0,0,0,0,0,0,2,0,0,2,0
6368,139252,AKVd0gnvEJlgz6OnGwqybMUQOVjHL58y,SpATywNh6bZuzm8s1ceuBUnMUAeoAHHw,13,21,13,18,8,0,6,0,66,9.428571428571429,2,0.0,2,13,16,8,19,0,2,6,0,39,27,0
6369,139262,CQI3ipMoYWvyV7ZuewrTlOYAM3gikvMq,7GRhBDsirIGkRZBtSMEzNTyDr2JQm4xx,2,0,0,0,0,0,3,0,3,0.42857142857142855,1,0.0,0,0,0,0,0,0,0,3,0,0,3,1
6370,139270,9W6HDa8nbr3i4rkBKbOa5qCJz73HRO2D,7GRhBDsirIGkRZBtSMEzNTyDr2JQm4xx,18,20,9,25,8,0,4,0,66,9.428571428571429,2,0.0,9,9,21,8,11,0,4,4,0,47,19,1
6371,139324,hT3A3NhtOhvHOWKsgHNINVDyTB0qBxh1,SpATywNh6bZuzm8s1ceuBUnMUAeoAHHw,16,38,10,31,5,3,9,1,97,13.857142857142858,2,0.0,12,10,27,5,26,3,4,9,1,54,43,0
6372,139332,IAgEmatHzKUXARhFStPcCuJqOEJArzMq,SpATywNh6bZuzm8s1ceuBUnMUAeoAHHw,1,0,0,0,0,0,1,0,1,0.14285714285714285,1,0.0,0,0,0,0,0,0,0,1,0,0,1,0
6373,139342,iO8wfk9CJpGr60f1tg17Yoor3BIrLyLv,bWdj2GDclj5ofokWjzoa5jAwMkxCykd6,2,0,0,0,0,0,3,0,3,0.42857142857142855,1,0.0,0,0,0,0,0,0,0,3,0,0,3,1
6374,139344,h4B8ffuSXL9NZaxc0msh2EYaxC0hStsr,7GRhBDsirIGkRZBtSMEzNTyDr2JQm4xx,5,2,0,0,0,0,3,1,6,0.8571428571428571,1,0.0,0,0,0,0,2,0,0,3,1,0,6,1
6375,139369,aXYyJMDvVYwwKBbiO4CB25XlnDBfWYNg,A3fsA9Zfv1X2fVEQhTw51lKENdNrEqT3,7,4,2,0,1,10,3,0,20,2.857142857142857,1,0.0,1,2,0,1,3,10,0,3,0,4,16,1
6376,139376,wx3mAGKFM6cge9w8piWfsYKppmWVhkYO,7GRhBDsirIGkRZBtSMEzNTyDr2JQm4xx,5,10,2,0,2,0,1,0,15,2.142857142857143,1,0.0,0,2,0,2,10,0,0,1,0,4,11,1
6377,139404,fgEJIqkp4SMlTSJ7SAm1OLRW7sHHzj7J,RXDvfPUBYFlVdlueBFbLW0mhhAyGEqpt,7,6,5,0,2,0,4,1,18,2.5714285714285716,1,0.0,0,5,0,2,6,0,0,4,1,7,11,0
6378,139428,abzlLtUVw5Pp8kU9DAXNl6SvnA5wbEox,7GRhBDsirIGkRZBtSMEzNTyDr2JQm4xx,1,0,0,0,0,0,2,0,2,0.2857142857142857,1,0.0,0,0,0,0,0,0,0,2,0,0,2,1
6379,139436,YOvd9uht0tZm889aIFQH8jd68xtH7inE,bWdj2GDclj5ofokWjzoa5jAwMkxCykd6,18,42,18,44,3,2,14,0,123,17.571428571428573,5,0.0,9,18,37,3,33,2,7,14,0,67,56,0
6380,139465,zbo9FGjTmUUlBLDkbpFTLQYtMVFawINZ,7GRhBDsirIGkRZBtSMEzNTyDr2JQm4xx,1,0,0,0,0,0,2,0,2,0.2857142857142857,1,0.0,0,0,0,0,0,0,0,2,0,0,2,1
6381,139544,G8fLPL9uAaHZvdz6ZdYfgDC2jOIdMG4b,7GRhBDsirIGkRZBtSMEzNTyDr2JQm4xx,1,0,0,0,0,0,1,0,1,0.14285714285714285,1,0.0,0,0,0,0,0,0,0,1,0,0,1,1
6382,139596,7u3azzypzNqPYEFxf0DcbGOgDVhkOXos,7GRhBDsirIGkRZBtSMEzNTyDr2JQm4xx,32,37,8,42,8,4,9,0,108,15.428571428571429,2,0.0,21,8,37,8,16,4,5,9,0,74,34,1
6383,139598,bHMSPD6TpG4I9IyQFzHZ8oywImP9IiZd,7GRhBDsirIGkRZBtSMEzNTyDr2JQm4xx,1,0,0,0,0,0,1,0,1,0.14285714285714285,1,0.0,0,0,0,0,0,0,0,1,0,0,1,1
6384,139703,MDn3CtIIZuEXDPhMfThc5BfvVlOiIwwt,7GRhBDsirIGkRZBtSMEzNTyDr2JQm4xx,9,7,1,0,0,1,9,1,19,2.7142857142857144,1,0.0,0,1,0,0,7,1,0,9,1,1,18,1
6385,139706,BGq4CkiKFU4S6hRTjQFWEyJE9fTf2RIS,7GRhBDsirIGkRZBtSMEzNTyDr2JQm4xx,2,0,0,0,0,0,2,0,2,0.2857142857142857,1,0.0,0,0,0,0,0,0,0,2,0,0,2,1
6386,139713,n51reZ5FTJkHLnQwBqURrmxGDzwEsEjy,7GRhBDsirIGkRZBtSMEzNTyDr2JQm4xx,4,2,1,0,1,0,1,0,5,0.7142857142857143,1,0.0,0,1,0,1,2,0,0,1,0,2,3,1
6387,140068,dRD1DS5DuggVygcG59W7832HdVYwtgOn,7GRhBDsirIGkRZBtSMEzNTyDr2JQm4xx,7,6,1,0,1,0,3,0,11,1.5714285714285714,2,0.0,0,1,0,1,6,0,0,3,0,2,9,1
6388,140636,2lTrV3r5iXOtPSrHMTWqISMwiAr82ziw,7GRhBDsirIGkRZBtSMEzNTyDr2JQm4xx,5,2,1,0,1,0,2,0,6,0.8571428571428571,1,0.0,0,1,0,1,2,0,0,2,0,2,4,1
6389,143597,0cz0w0x5qzuunbgfeQV0i5L0OMvyWFxQ,SpATywNh6bZuzm8s1ceuBUnMUAeoAHHw,13,10,7,0,5,3,17,4,46,6.571428571428571,2,0.0,0,7,0,5,10,3,0,17,4,12,34,1
6390,143602,Jm4nQ05ndX10jbofbWx6S0r9VXrqia6S,A3fsA9Zfv1X2fVEQhTw51lKENdNrEqT3,10,9,6,0,2,0,2,0,19,2.7142857142857144,1,0.0,0,6,0,2,9,0,0,2,0,8,11,0
6391,143603,nWxN8tjySUVOGOns5lP09DIo5v1ke7EL,A3fsA9Zfv1X2fVEQhTw51lKENdNrEqT3,8,9,4,0,3,0,2,0,18,2.5714285714285716,1,0.0,0,4,0,3,9,0,0,2,0,7,11,1
6392,143605,nWxN8tjySUVOGOns5lP09DIo5v1ke7EL,bWdj2GDclj5ofokWjzoa5jAwMkxCykd6,8,4,2,0,1,2,11,2,22,3.142857142857143,1,0.0,0,2,0,1,4,2,0,11,2,3,19,1
6393,143607,3iJrlZJEv2h7DgWBpz6wZtSXPXEy6IAY,bWdj2GDclj5ofokWjzoa5jAwMkxCykd6,6,5,3,0,2,0,2,0,12,1.7142857142857142,2,0.0,0,3,0,2,5,0,0,2,0,5,7,1
6394,143614,n2GF9Yeq4eisQG7nka32xYSXt9etqVaZ,G8EPVSXsOYB5YQWZGiz1aVq5Pgr2GrQu,6,5,3,0,0,1,2,0,11,1.5714285714285714,1,0.0,0,3,0,0,5,1,0,2,0,3,8,1
6395,143623,HtMha1d9fNJoHGbwIKcB3HWdDU94w7Lj,SpATywNh6bZuzm8s1ceuBUnMUAeoAHHw,16,21,11,17,5,0,5,1,60,8.571428571428571,2,0.0,6,11,16,5,15,0,1,5,1,38,22,1
6396,143629,tkMGC5CG4kemHaNbBo6MMddbuqCxk8Qb,SpATywNh6bZuzm8s1ceuBUnMUAeoAHHw,5,5,3,0,1,0,2,0,11,1.5714285714285714,3,0.0,0,3,0,1,5,0,0,2,0,4,7,1
6397,143631,GNXZVEHsVeYck60C0KBPWHG0mMcY0UQQ,SpATywNh6bZuzm8s1ceuBUnMUAeoAHHw,15,20,2,7,3,9,4,0,45,6.428571428571429,5,0.0,2,2,7,3,18,9,0,4,0,14,31,0
6398,143641,Uux0jHna4HKcvE72hnPMG7xrHByftJPh,bWdj2GDclj5ofokWjzoa5jAwMkxCykd6,5,2,1,0,1,0,2,0,6,0.8571428571428571,1,0.0,0,1,0,1,2,0,0,2,0,2,4,1
6399,143650,iyNW22GLVn7ltcBOUiQmam3mjjq9r9cL,bWdj2GDclj5ofokWjzoa5jAwMkxCykd6,1,0,0,0,0,0,1,0,1,0.14285714285714285,1,0.0,0,0,0,0,0,0,0,1,0,0,1,1
6400,143652,NNxm4wTuqK3vBr5exeeaxNmVWigp9kZd,RXDvfPUBYFlVdlueBFbLW0mhhAyGEqpt,9,9,1,0,0,0,4,0,14,2.0,2,0.0,0,1,0,0,9,0,0,4,0,1,13,1
6401,143653,E7W9iVWrVUAUJsVKnfZDdWhC9kKNiFWd,A3fsA9Zfv1X2fVEQhTw51lKENdNrEqT3,4,2,1,0,1,0,1,0,5,0.7142857142857143,1,0.0,0,1,0,1,2,0,0,1,0,2,3,0
6402,143683,oArXTDKLwWKfXkZ74yUJJtvr4UhDGsgG,SpATywNh6bZuzm8s1ceuBUnMUAeoAHHw,7,4,0,0,1,0,2,0,7,1.0,1,0.0,0,0,0,1,4,0,0,2,0,1,6,1
6403,143687,zXaIFCKxfdY9z9fVBcdJ9CKQhYz4fcsP,A3fsA9Zfv1X2fVEQhTw51lKENdNrEqT3,8,4,1,8,1,0,2,0,16,2.2857142857142856,1,0.0,1,1,8,1,3,0,0,2,0,11,5,1
6404,143689,ZaW4RrWrF9gJ30CuAjw5a2IkcpF7An5C,G8EPVSXsOYB5YQWZGiz1aVq5Pgr2GrQu,10,8,3,0,2,5,12,2,32,4.571428571428571,2,0.0,2,3,0,2,6,5,0,12,2,7,25,1
6405,143690,9l6PGZqklFaIeCC4cIui4TvC3Cf7mMtA,G8EPVSXsOYB5YQWZGiz1aVq5Pgr2GrQu,8,3,2,0,2,1,8,1,17,2.4285714285714284,1,0.0,0,2,0,2,3,1,0,8,1,4,13,1
6406,143695,MiA88xKunqu6yy0duOdvLI06Oy5UMt4X,RXDvfPUBYFlVdlueBFbLW0mhhAyGEqpt,4,2,1,0,1,0,1,0,5,0.7142857142857143,1,0.0,0,1,0,1,2,0,0,1,0,2,3,1
6407,143715,vFHaopWeOsxXSRudDrGgOuVKmzwec37W,SpATywNh6bZuzm8s1ceuBUnMUAeoAHHw,13,19,0,9,1,0,4,0,33,4.714285714285714,1,0.0,4,0,9,1,15,0,0,4,0,14,19,1
6408,143722,VzxoAK96NBZMonMzFBNCEGPOgDpcMczp,A3fsA9Zfv1X2fVEQhTw51lKENdNrEqT3,8,2,1,0,1,10,6,1,21,3.0,1,0.0,0,1,0,1,2,10,0,6,1,2,19,1
6409,143731,X2xaI3ENq0OZDZ0s1ETxwXOMaEJnZn8K,A3fsA9Zfv1X2fVEQhTw51lKENdNrEqT3,8,4,3,0,3,0,1,0,11,1.5714285714285714,2,0.0,0,3,0,3,4,0,0,1,0,6,5,1
6410,143736,a2kYXY4DZduwKkGJa8fQrbG6TxHBB94I,A3fsA9Zfv1X2fVEQhTw51lKENdNrEqT3,6,2,1,0,1,0,9,0,13,1.8571428571428572,1,0.0,0,1,0,1,2,0,0,9,0,2,11,1
6411,143739,j1ZwHmxsEQ0TgQEQqgxbWG7UscEDky1c,SpATywNh6bZuzm8s1ceuBUnMUAeoAHHw,13,22,0,11,0,0,8,0,41,5.857142857142857,2,0.0,10,0,10,0,12,0,1,8,0,20,21,1
6412,143745,ravD1f2MIgZP9srRrYJQsdPSYhRi83XU,SpATywNh6bZuzm8s1ceuBUnMUAeoAHHw,16,27,4,21,1,2,13,1,69,9.857142857142858,3,0.0,9,4,18,1,18,2,3,13,1,32,37,0
6413,143749,cZbR6FMlSKlEaK0BZQEtqLknk5lBVQRh,SpATywNh6bZuzm8s1ceuBUnMUAeoAHHw,14,16,1,12,1,12,8,1,51,7.285714285714286,1,0.0,5,1,10,1,11,12,2,8,1,17,34,1
6414,143750,ldpyoNVLH614iuNg2P99R7SYjvFOfdM2,G8EPVSXsOYB5YQWZGiz1aVq5Pgr2GrQu,11,14,6,0,4,1,4,0,29,4.142857142857143,3,0.0,3,6,0,4,11,1,0,4,0,13,16,1
6415,143762,m7fPOqd4GotPyK3pn7xq2eK9izwTqrAR,A3fsA9Zfv1X2fVEQhTw51lKENdNrEqT3,5,1,1,0,1,1,2,0,6,0.8571428571428571,1,0.0,0,1,0,1,1,1,0,2,0,2,4,1
6416,143766,CDMI3gQZrAOAZ9Cf4jB5NzA4daPYwjjn,A3fsA9Zfv1X2fVEQhTw51lKENdNrEqT3,20,16,13,0,7,5,11,4,56,8.0,2,0.0,0,13,0,7,16,5,0,11,4,20,36,1
6417,143772,D0Q5uZnA6QMJZo17g9opktHEQj6b5d5E,SpATywNh6bZuzm8s1ceuBUnMUAeoAHHw,3,0,0,0,0,0,3,0,3,0.42857142857142855,1,0.0,0,0,0,0,0,0,0,3,0,0,3,0
6418,143796,JGBLBGhiZQ8K0PQBUKKu5a6jYm04SHA0,A3fsA9Zfv1X2fVEQhTw51lKENdNrEqT3,2,0,0,0,0,0,2,0,2,0.2857142857142857,1,0.0,0,0,0,0,0,0,0,2,0,0,2,1
6419,143804,qmiNvBvBVayyfYSGvn9Ww6fyfbmmg8Ju,SpATywNh6bZuzm8s1ceuBUnMUAeoAHHw,1,0,0,0,0,0,1,0,1,0.14285714285714285,1,0.0,0,0,0,0,0,0,0,1,0,0,1,1
6420,143810,bACQsAWyyrjdiMPqSUjAzVKv7ajw33ro,SpATywNh6bZuzm8s1ceuBUnMUAeoAHHw,8,7,5,0,4,2,5,1,24,3.4285714285714284,1,0.0,0,5,0,4,7,2,0,5,1,9,15,1
6421,143814,65NT4Vy4CWsCo0yJt0Ser3pgvYWBcuzx,G8EPVSXsOYB5YQWZGiz1aVq5Pgr2GrQu,10,4,2,0,2,1,4,1,14,2.0,1,0.0,0,2,0,2,4,1,0,4,1,4,10,1
6422,143816,dmgKCClueSUfvNvbgn76P7yZNOrcqS51,SpATywNh6bZuzm8s1ceuBUnMUAeoAHHw,5,5,2,0,0,0,5,0,12,1.7142857142857142,1,0.0,0,2,0,0,5,0,0,5,0,2,10,1
6423,143826,vWKarVz9MLdkaeCnowC5zORVIjWhxnGT,A3fsA9Zfv1X2fVEQhTw51lKENdNrEqT3,41,17,11,56,8,1,10,1,104,14.857142857142858,1,0.0,4,11,49,8,13,1,7,10,1,72,32,1
6424,143827,icWbBG6yTFIZ32qTSFWaJeU4GOLom0j8,SpATywNh6bZuzm8s1ceuBUnMUAeoAHHw,12,12,8,0,3,6,12,2,43,6.142857142857143,2,0.0,0,8,0,3,12,6,0,12,2,11,32,1
6425,143828,e0M6WM1PijCu34LKse7mmvSD1YWuaWbQ,SpATywNh6bZuzm8s1ceuBUnMUAeoAHHw,13,10,1,5,1,1,6,1,25,3.5714285714285716,1,0.0,4,1,5,1,6,1,0,6,1,11,14,1
6426,143833,O8HOTucc0KEJXoqiM5XCMFFloSFDXkri,SpATywNh6bZuzm8s1ceuBUnMUAeoAHHw,10,8,3,0,2,0,6,0,19,2.7142857142857144,3,0.0,0,3,0,2,8,0,0,6,0,5,14,0
6427,143840,kuZwBvEdgeUtKZ495C2FptBbxEtLtmVH,bWdj2GDclj5ofokWjzoa5jAwMkxCykd6,6,12,4,0,1,0,4,0,21,3.0,2,0.0,2,4,0,1,10,0,0,4,0,7,14,1
6428,143841,U9j28kbZjF4W0VB5A2yieyyacPtOxvwt,bWdj2GDclj5ofokWjzoa5jAwMkxCykd6,11,69,23,10,11,2,18,1,134,19.142857142857142,4,0.0,28,23,10,11,41,2,0,18,1,72,62,1
6429,143856,k5QrgarfuSQsGSVQQrcJTwJdAAKzf9gw,A3fsA9Zfv1X2fVEQhTw51lKENdNrEqT3,2,0,0,0,0,0,2,0,2,0.2857142857142857,1,0.0,0,0,0,0,0,0,0,2,0,0,2,1
6430,143858,uVezMKauDUYUFjTOlrwzQHcegaGFiPmr,A3fsA9Zfv1X2fVEQhTw51lKENdNrEqT3,7,5,1,0,1,0,4,0,11,1.5714285714285714,1,0.0,0,1,0,1,5,0,0,4,0,2,9,1
6431,143860,kMzMJEHy7fAHiNUZU0um3I2BsPC7gMll,SpATywNh6bZuzm8s1ceuBUnMUAeoAHHw,1,0,0,0,0,0,2,0,2,0.2857142857142857,2,0.0,0,0,0,0,0,0,0,2,0,0,2,1
6432,143863,cQR8w7MfHX2zVKP2ObrWt7YmSX4BnmzU,SpATywNh6bZuzm8s1ceuBUnMUAeoAHHw,5,3,2,0,0,0,2,0,7,1.0,1,0.0,0,2,0,0,3,0,0,2,0,2,5,1
6433,143864,RCdcltNaQLfcoxT7YKTjQxAYUbCmzzKd,bWdj2GDclj5ofokWjzoa5jAwMkxCykd6,9,13,9,0,8,2,5,0,37,5.285714285714286,2,0.0,3,9,0,8,10,2,0,5,0,20,17,1
6434,143865,wovmcysU3CVvWe03Rf3D2PLI3no54RS2,SpATywNh6bZuzm8s1ceuBUnMUAeoAHHw,5,2,1,0,1,0,3,0,7,1.0,1,0.0,0,1,0,1,2,0,0,3,0,2,5,1
6435,143866,cQR8w7MfHX2zVKP2ObrWt7YmSX4BnmzU,bWdj2GDclj5ofokWjzoa5jAwMkxCykd6,1,0,0,0,0,0,1,0,1,0.14285714285714285,1,0.0,0,0,0,0,0,0,0,1,0,0,1,1
6436,143867,Pnezq6slEV4CIBxIFIPqhlGLNILa8T8M,SpATywNh6bZuzm8s1ceuBUnMUAeoAHHw,15,18,7,6,3,4,4,0,42,6.0,3,0.0,6,7,6,3,12,4,0,4,0,22,20,0
6437,143880,zAobqpIInEgToh5g3mHxVZCEkz5XFqde,SpATywNh6bZuzm8s1ceuBUnMUAeoAHHw,10,23,1,18,0,0,3,0,45,6.428571428571429,2,0.0,13,1,17,0,10,0,1,3,0,31,14,1
6438,143881,g5rASgrCPlNIsJec3wFullHkMrOBGptd,SpATywNh6bZuzm8s1ceuBUnMUAeoAHHw,10,7,5,4,4,0,2,0,22,3.142857142857143,1,0.0,0,5,3,4,7,0,1,2,0,12,10,1
6439,143887,SKJH5bhXUHUXBV3YRjTcw0Oe5kVFAmnw,SpATywNh6bZuzm8s1ceuBUnMUAeoAHHw,5,5,2,0,2,0,3,0,12,1.7142857142857142,1,0.0,0,2,0,2,5,0,0,3,0,4,8,1
6440,143888,CdBS5mGJVzgaGDeY8NzEjALJKus99MGR,SpATywNh6bZuzm8s1ceuBUnMUAeoAHHw,17,40,10,16,4,8,15,0,93,13.285714285714286,3,0.0,6,10,14,4,34,8,2,15,0,34,59,1
6441,143891,UpT5KvhktZoGfL90nOmM9gx3GU38kT3j,bWdj2GDclj5ofokWjzoa5jAwMkxCykd6,17,14,1,38,3,11,11,1,79,11.285714285714286,3,0.0,5,1,33,3,9,11,5,11,1,42,37,0
6442,143897,BhOp2rSiJ2q2zT4ZZzNtPz6Fovfll5Yb,SpATywNh6bZuzm8s1ceuBUnMUAeoAHHw,12,8,5,1,3,0,7,2,26,3.7142857142857144,3,0.0,1,5,1,3,7,0,0,7,2,10,16,1
6443,143900,NWUbBzN3rFqJYQQKuHujeEDgr8fxabPr,SpATywNh6bZuzm8s1ceuBUnMUAeoAHHw,16,23,7,20,3,19,8,0,80,11.428571428571429,4,0.0,7,7,16,3,16,19,4,8,0,33,47,0
6444,143901,mvgC6breSmhPTVyyPyUMeu7XoIQqVA6J,bWdj2GDclj5ofokWjzoa5jAwMkxCykd6,1,0,0,0,0,0,1,0,1,0.14285714285714285,1,0.0,0,0,0,0,0,0,0,1,0,0,1,1
6445,143902,qDW8D89X9oTRJFDDcQZTLb3PUIxnDi04,bWdj2GDclj5ofokWjzoa5jAwMkxCykd6,5,2,1,0,1,0,2,0,6,0.8571428571428571,1,0.0,0,1,0,1,2,0,0,2,0,2,4,1
6446,143908,nwFT4lnmg30fCvHRB6tbALo9FpcanuLx,SpATywNh6bZuzm8s1ceuBUnMUAeoAHHw,10,11,1,0,1,0,9,0,22,3.142857142857143,4,0.0,2,1,0,1,9,0,0,9,0,4,18,0
6447,143909,nwFT4lnmg30fCvHRB6tbALo9FpcanuLx,A3fsA9Zfv1X2fVEQhTw51lKENdNrEqT3,1,0,0,0,0,0,2,0,2,0.2857142857142857,2,0.0,0,0,0,0,0,0,0,2,0,0,2,1
6448,143927,2WRiAgv5S6kcFPY2blVGjs9g0YNkJyLP,A3fsA9Zfv1X2fVEQhTw51lKENdNrEqT3,12,6,5,0,5,0,1,0,17,2.4285714285714284,1,0.0,0,5,0,5,6,0,0,1,0,10,7,1
6449,143933,Mi4V9PN04XHkOYjYbsNOyLc2HUiygd5R,SpATywNh6bZuzm8s1ceuBUnMUAeoAHHw,7,6,1,0,1,0,3,0,11,1.5714285714285714,2,0.0,0,1,0,1,6,0,0,3,0,2,9,1
6450,143940,rMQIZQBxSTMFTRmvcfmpoYqCAUhMol3Y,A3fsA9Zfv1X2fVEQhTw51lKENdNrEqT3,10,8,1,0,1,0,2,0,12,1.7142857142857142,2,0.0,0,1,0,1,8,0,0,2,0,2,10,1
6451,143941,QZzKa5b6BbNwk1LIn6xlSQQLnIzRsZka,SpATywNh6bZuzm8s1ceuBUnMUAeoAHHw,13,15,0,16,0,2,14,3,50,7.142857142857143,3,0.0,2,0,14,0,13,2,2,14,3,16,34,1
6452,143945,U0EvfjsY5qqb8sRRReWuk6YqXYpCTRVc,SpATywNh6bZuzm8s1ceuBUnMUAeoAHHw,17,39,12,17,5,0,7,0,80,11.428571428571429,3,0.0,21,12,15,5,18,0,2,7,0,53,27,0
6453,143948,PM49kyPCpZaIfMyV0vVvEZLNApBiy9hl,G8EPVSXsOYB5YQWZGiz1aVq5Pgr2GrQu,18,16,11,22,3,4,29,7,92,13.142857142857142,2,0.0,0,11,17,3,16,4,5,29,7,31,61,0
6454,143956,BjRnjY2o7a3tMcpDhDIkBnAHWrC67ajb,bWdj2GDclj5ofokWjzoa5jAwMkxCykd6,11,13,1,30,4,0,1,0,49,7.0,1,0.0,8,1,28,4,5,0,2,1,0,41,8,1
6455,143959,qE4hwNlGPGhoA6O5q5uX2JQSuwb75VXN,SpATywNh6bZuzm8s1ceuBUnMUAeoAHHw,12,5,4,0,2,5,8,1,25,3.5714285714285716,2,0.0,0,4,0,2,5,5,0,8,1,6,19,1
6456,143964,J4CQZgZBlOmytRfPs9vqhW9gDDIzfvcP,SpATywNh6bZuzm8s1ceuBUnMUAeoAHHw,14,14,8,9,5,0,2,0,38,5.428571428571429,2,0.0,4,8,9,5,10,0,0,2,0,26,12,1
6457,143970,yepbpI2oB7GcEIjPPhcQSpqMxzy4YG1o,A3fsA9Zfv1X2fVEQhTw51lKENdNrEqT3,17,16,11,0,9,0,3,0,39,5.571428571428571,2,0.0,0,11,0,9,16,0,0,3,0,20,19,1
6458,143971,nVB1o73xluQXZjoI2dUYHGxbCDG8qiCL,SpATywNh6bZuzm8s1ceuBUnMUAeoAHHw,9,13,9,0,5,18,8,0,53,7.571428571428571,2,0.0,0,9,0,5,13,18,0,8,0,14,39,0
6459,143981,sNbuAEBvvCL9s1FspvGXLJVjQkFzxwpw,A3fsA9Zfv1X2fVEQhTw51lKENdNrEqT3,2,0,0,0,0,0,3,0,3,0.42857142857142855,2,0.0,0,0,0,0,0,0,0,3,0,0,3,1
6460,143982,4GJSwwikGuUWXSajcKoSlvfsoiC8eEZq,SpATywNh6bZuzm8s1ceuBUnMUAeoAHHw,8,11,2,0,1,0,3,0,17,2.4285714285714284,2,0.0,3,2,0,1,8,0,0,3,0,6,11,1
6461,144006,BNzSA1bHraXMmngTyyc8aHsRdjDVh5h7,bWdj2GDclj5ofokWjzoa5jAwMkxCykd6,6,0,0,0,0,1,7,1,9,1.2857142857142858,1,0.0,0,0,0,0,0,1,0,7,1,0,9,1
6462,144007,jSNLRK8jxSbbcqhbWW7DXZqoGlvGgXDY,SpATywNh6bZuzm8s1ceuBUnMUAeoAHHw,11,34,4,7,0,8,9,0,62,8.857142857142858,4,0.0,8,4,6,0,26,8,1,9,0,18,44,0
6463,144009,xbYSqp0T7Uu69VoCNyfTCvQcS3HV3UeU,A3fsA9Zfv1X2fVEQhTw51lKENdNrEqT3,6,13,7,0,0,10,6,0,36,5.142857142857143,3,0.0,1,7,0,0,12,10,0,6,0,8,28,1
6464,144012,tShEWwQUmNvdJJLgb6IWQwSvspfEXM5K,A3fsA9Zfv1X2fVEQhTw51lKENdNrEqT3,4,2,1,0,1,0,1,0,5,0.7142857142857143,1,0.0,0,1,0,1,2,0,0,1,0,2,3,1
6465,144016,pV3LNiRBcnB0okGlxsutPlVeupVbHeL3,SpATywNh6bZuzm8s1ceuBUnMUAeoAHHw,6,3,2,0,1,0,2,0,8,1.1428571428571428,1,0.0,0,2,0,1,3,0,0,2,0,3,5,1
6466,144037,nCjvWGBuFy5INkXPz8A7SRdydYBldjvQ,SpATywNh6bZuzm8s1ceuBUnMUAeoAHHw,4,2,0,0,0,0,2,0,4,0.5714285714285714,1,0.0,0,0,0,0,2,0,0,2,0,0,4,1
6467,144041,oqyavd6F0mKguMPCfvp0hDFA1MAPWGfD,SpATywNh6bZuzm8s1ceuBUnMUAeoAHHw,13,18,8,17,6,0,1,0,50,7.142857142857143,2,0.0,8,8,14,6,10,0,3,1,0,36,14,0
6468,144045,X6wKs7o7iaOCvuOiKVJE8ObJhZymqim9,A3fsA9Zfv1X2fVEQhTw51lKENdNrEqT3,2,0,0,0,0,0,2,0,2,0.2857142857142857,1,0.0,0,0,0,0,0,0,0,2,0,0,2,1
6469,144054,3gXxAS6JQyT6kaPyX2q9IFEYv8Hv4qpf,SpATywNh6bZuzm8s1ceuBUnMUAeoAHHw,1,0,0,0,0,0,2,0,2,0.2857142857142857,1,0.0,0,0,0,0,0,0,0,2,0,0,2,1
6470,144058,JaYbgvhgx43SysY9J8DaCR3IcdUzCcUf,A3fsA9Zfv1X2fVEQhTw51lKENdNrEqT3,14,26,2,0,2,0,4,0,34,4.857142857142857,3,0.0,0,2,0,2,26,0,0,4,0,4,30,1
6471,144068,lWBDQVwIQrjtFGVOoBxPlW4CU3O2tpal,bWdj2GDclj5ofokWjzoa5jAwMkxCykd6,6,10,3,0,5,0,2,0,20,2.857142857142857,1,0.0,6,3,0,5,4,0,0,2,0,14,6,0
6472,144071,N3PF6286hfkTToYfzWd10OYG6jiYeyxL,A3fsA9Zfv1X2fVEQhTw51lKENdNrEqT3,28,15,6,76,3,2,7,0,109,15.571428571428571,2,0.0,4,6,65,3,11,2,11,7,0,78,31,1
6473,144073,J308vOrLkdYqLmDeq0FXdJXMsr1GuQ4w,SpATywNh6bZuzm8s1ceuBUnMUAeoAHHw,6,4,2,0,1,0,2,0,9,1.2857142857142858,1,0.0,0,2,0,1,4,0,0,2,0,3,6,1
6474,144076,M8cV3FHZsXmaSmJz43zOWXbhj6ecftQ6,A3fsA9Zfv1X2fVEQhTw51lKENdNrEqT3,1,0,0,0,0,0,1,0,1,0.14285714285714285,1,0.0,0,0,0,0,0,0,0,1,0,0,1,1
6475,144079,0MJO2AqnpIZ1IQnC9vPe2n4pS7b47XJt,bWdj2GDclj5ofokWjzoa5jAwMkxCykd6,5,10,8,0,6,0,2,0,26,3.7142857142857144,3,0.0,0,8,0,6,10,0,0,2,0,14,12,1
6476,144084,oM7kzBqhrhvKM9TULmlTbBtomZs2uMAz,bWdj2GDclj5ofokWjzoa5jAwMkxCykd6,7,7,1,0,1,0,3,0,12,1.7142857142857142,1,0.0,1,1,0,1,6,0,0,3,0,3,9,1
6477,144093,xOQ7AnZhBVXWatzUYsH22obdE4ihFc1J,bWdj2GDclj5ofokWjzoa5jAwMkxCykd6,6,11,4,0,2,0,5,0,22,3.142857142857143,2,0.0,4,4,0,2,7,0,0,5,0,10,12,1
6478,144104,8wj2Kr145taRtViYKZRdPMwAZeP9BDRs,A3fsA9Zfv1X2fVEQhTw51lKENdNrEqT3,10,9,1,0,1,0,4,0,15,2.142857142857143,2,0.0,0,1,0,1,9,0,0,4,0,2,13,1
6479,144107,QR8UITZg856bsXeO3qqb9HBw7LvT4WYt,G8EPVSXsOYB5YQWZGiz1aVq5Pgr2GrQu,14,15,2,6,2,1,7,1,34,4.857142857142857,1,0.0,6,2,5,2,9,1,1,7,1,15,19,1
6480,144112,A41hdT15T7mumzDW53QCDXRUsOilvTI0,A3fsA9Zfv1X2fVEQhTw51lKENdNrEqT3,9,8,5,0,3,0,5,0,21,3.0,2,0.0,0,5,0,3,8,0,0,5,0,8,13,0
6481,144120,rqoGLMWp7ee8Ppu4OdHSBl6vmRxDZvKU,A3fsA9Zfv1X2fVEQhTw51lKENdNrEqT3,7,8,2,0,2,0,1,0,13,1.8571428571428572,2,0.0,0,2,0,2,8,0,0,1,0,4,9,1
6482,144140,5F9PaqbFd1lCE07rWZ8QBm5IEOOVBjgP,G8EPVSXsOYB5YQWZGiz1aVq5Pgr2GrQu,48,16,13,96,10,0,5,0,140,20.0,1,0.0,1,13,75,10,15,0,21,5,0,99,41,1
6483,144144,IXIS4Shtcigf6RcvylwWobSKfmofV0Nt,SpATywNh6bZuzm8s1ceuBUnMUAeoAHHw,6,6,3,0,1,0,3,0,13,1.8571428571428572,2,0.0,0,3,0,1,6,0,0,3,0,4,9,1
6484,144158,LfOTQoQ2fSLvFDTNyvPm8DKwqfdrfE91,SpATywNh6bZuzm8s1ceuBUnMUAeoAHHw,17,20,10,6,5,0,4,1,46,6.571428571428571,1,0.0,8,10,6,5,12,0,0,4,1,29,17,1
6485,144159,vSPx0Rg8IfOWpaATb7kkPj0mZPaLkdwk,A3fsA9Zfv1X2fVEQhTw51lKENdNrEqT3,7,7,0,0,0,0,5,0,12,1.7142857142857142,1,0.0,0,0,0,0,7,0,0,5,0,0,12,1
6486,144162,vSPx0Rg8IfOWpaATb7kkPj0mZPaLkdwk,bWdj2GDclj5ofokWjzoa5jAwMkxCykd6,6,6,2,0,3,0,2,0,13,1.8571428571428572,1,0.0,2,2,0,3,4,0,0,2,0,7,6,1
6487,144163,Mi04UWZgqcHrMSZckQSYxOftI8OPYCzT,G8EPVSXsOYB5YQWZGiz1aVq5Pgr2GrQu,10,6,1,0,1,6,6,0,20,2.857142857142857,1,0.0,0,1,0,1,6,6,0,6,0,2,18,0
6488,144168,TTLR6K3ZlbSrGOfX2kjd2U4ChldGiopU,A3fsA9Zfv1X2fVEQhTw51lKENdNrEqT3,9,25,0,0,0,0,4,0,29,4.142857142857143,2,0.0,1,0,0,0,24,0,0,4,0,1,28,1
6489,144172,mSs5bB1Rxg3xYWjWjJY9pVTt7WAiMgyu,G8EPVSXsOYB5YQWZGiz1aVq5Pgr2GrQu,1,0,0,0,0,0,3,0,3,0.42857142857142855,2,0.0,0,0,0,0,0,0,0,3,0,0,3,0
6490,144173,mSs5bB1Rxg3xYWjWjJY9pVTt7WAiMgyu,A3fsA9Zfv1X2fVEQhTw51lKENdNrEqT3,5,3,2,0,2,2,7,0,16,2.2857142857142856,1,0.0,0,2,0,2,3,2,0,7,0,4,12,0
6491,144177,vang2CBp79w46FuP8PHdcPzohOKhBOq7,SpATywNh6bZuzm8s1ceuBUnMUAeoAHHw,8,3,2,0,2,0,3,0,10,1.4285714285714286,2,0.0,0,2,0,2,3,0,0,3,0,4,6,1
6492,144182,vaHtIA00RCulwKK7VIyzWyzyLmevfcyF,RXDvfPUBYFlVdlueBFbLW0mhhAyGEqpt,1,0,0,0,0,0,1,0,1,0.14285714285714285,1,0.0,0,0,0,0,0,0,0,1,0,0,1,1
6493,144190,lxaN8cMu58kiTAIgLqzjn8LLROF5HL13,SpATywNh6bZuzm8s1ceuBUnMUAeoAHHw,1,0,0,0,0,0,2,0,2,0.2857142857142857,2,0.0,0,0,0,0,0,0,0,2,0,0,2,1
6494,144195,TLRNemgJ2qb9k6dqDLHmoeJOx0QEylHX,A3fsA9Zfv1X2fVEQhTw51lKENdNrEqT3,7,3,2,0,2,0,4,0,11,1.5714285714285714,1,0.0,0,2,0,2,3,0,0,4,0,4,7,1
6495,144201,qz846pl1l6yGERGHSFYtB9X4bZxpZ3Ym,SpATywNh6bZuzm8s1ceuBUnMUAeoAHHw,4,2,1,0,1,0,1,0,5,0.7142857142857143,1,0.0,0,1,0,1,2,0,0,1,0,2,3,1
6496,144203,Dd8BaN0Npmwg2omUrerhRcBJi9Zv0QF5,G8EPVSXsOYB5YQWZGiz1aVq5Pgr2GrQu,22,27,16,34,8,1,16,1,103,14.714285714285714,3,0.0,0,16,30,8,27,1,4,16,1,54,49,0
6497,144208,7fciuEa5Xf2g36Xi6ZmKVyrNCJiVORwj,G8EPVSXsOYB5YQWZGiz1aVq5Pgr2GrQu,1,0,0,0,0,0,1,0,1,0.14285714285714285,1,0.0,0,0,0,0,0,0,0,1,0,0,1,1
6498,144209,7fciuEa5Xf2g36Xi6ZmKVyrNCJiVORwj,RXDvfPUBYFlVdlueBFbLW0mhhAyGEqpt,1,0,0,0,0,0,1,0,1,0.14285714285714285,1,0.0,0,0,0,0,0,0,0,1,0,0,1,1
6499,144212,vIAdh2clW8FkvdVniXHQiMyPfgIo07gQ,SpATywNh6bZuzm8s1ceuBUnMUAeoAHHw,4,0,0,0,0,0,3,1,4,0.5714285714285714,1,0.0,0,0,0,0,0,0,0,3,1,0,4,1
6500,144213,P89UxuMs18mdXj4DGhJJSZRF8BUJV2uZ,A3fsA9Zfv1X2fVEQhTw51lKENdNrEqT3,34,13,11,40,10,0,4,0,78,11.142857142857142,2,0.0,1,11,36,10,12,0,4,4,0,58,20,1
6501,144222,s2jX5TZHNhVfY48YU4SNM5eF0Y5PZev6,SpATywNh6bZuzm8s1ceuBUnMUAeoAHHw,5,2,1,0,1,0,2,0,6,0.8571428571428571,1,0.0,0,1,0,1,2,0,0,2,0,2,4,1
6502,144223,lnkkWGyIr1b44KiKgAFL6qVeebRfNJt3,SpATywNh6bZuzm8s1ceuBUnMUAeoAHHw,5,2,1,0,1,0,2,0,6,0.8571428571428571,1,0.0,0,1,0,1,2,0,0,2,0,2,4,1
6503,144237,YCrhaujUJb2ysdJEAlnTFggfP634EwtZ,bWdj2GDclj5ofokWjzoa5jAwMkxCykd6,1,0,0,0,0,0,1,0,1,0.14285714285714285,1,0.0,0,0,0,0,0,0,0,1,0,0,1,1
6504,144240,BPLF5bOPHidVrP3JGHCr9npCCCPEhz1g,SpATywNh6bZuzm8s1ceuBUnMUAeoAHHw,17,50,16,20,6,6,19,2,119,17.0,3,0.0,27,16,18,6,23,6,2,19,2,67,52,1
6505,144244,y3GJh8xEC6iboTvFOS91chZLMqYyEapH,G8EPVSXsOYB5YQWZGiz1aVq5Pgr2GrQu,16,20,3,0,3,1,8,2,37,5.285714285714286,3,0.0,6,3,0,3,14,1,0,8,2,12,25,1
6506,144259,PGj1B7s4Yw1PBLMA6crSiWk0Zk66XU5n,SpATywNh6bZuzm8s1ceuBUnMUAeoAHHw,1,0,0,0,0,0,1,0,1,0.14285714285714285,1,0.0,0,0,0,0,0,0,0,1,0,0,1,1
6507,144260,NxRna5VYeAvwKdtdFMhqdPkmD703DSHi,SpATywNh6bZuzm8s1ceuBUnMUAeoAHHw,17,37,17,18,6,13,14,0,105,15.0,4,0.0,10,17,16,6,27,13,2,14,0,49,56,1
6508,144290,QX3ApvDJvO9Hor69Bz89tLVK3rkHTGIJ,SpATywNh6bZuzm8s1ceuBUnMUAeoAHHw,2,0,0,0,0,0,2,0,2,0.2857142857142857,1,0.0,0,0,0,0,0,0,0,2,0,0,2,1
6509,144292,ObRNFdACerskEaO6OwPXBsUqKEYRJtIa,SpATywNh6bZuzm8s1ceuBUnMUAeoAHHw,7,3,2,0,2,0,2,0,9,1.2857142857142858,1,0.0,0,2,0,2,3,0,0,2,0,4,5,1
6510,144302,pWZNevyPOl4ouTcnYPIT4PYWT7cW7Aq7,SpATywNh6bZuzm8s1ceuBUnMUAeoAHHw,1,0,0,0,0,0,1,0,1,0.14285714285714285,1,0.0,0,0,0,0,0,0,0,1,0,0,1,1
6511,144315,8lCrBaMkcXk8KsL7M8AYgjnsyFuSP4yK,A3fsA9Zfv1X2fVEQhTw51lKENdNrEqT3,18,18,16,0,16,0,1,0,51,7.285714285714286,1,0.0,0,16,0,16,18,0,0,1,0,32,19,1
6512,144325,IKQYwh1PoPanPyuEqIIRzDtzc0tOUD2x,SpATywNh6bZuzm8s1ceuBUnMUAeoAHHw,15,23,4,15,0,1,19,1,63,9.0,5,0.0,5,4,12,0,18,1,3,19,1,21,42,0
6513,144327,SKemaavr5OG5spO92jXls0zhTMuWKDja,A3fsA9Zfv1X2fVEQhTw51lKENdNrEqT3,38,44,23,36,10,0,8,2,123,17.571428571428573,4,0.0,3,23,36,10,41,0,0,8,2,72,51,1
6514,144331,G4MfAXnz0EbVaCbavnksnUIxHSPSMOp9,SpATywNh6bZuzm8s1ceuBUnMUAeoAHHw,7,7,1,0,1,0,2,0,11,1.5714285714285714,2,0.0,0,1,0,1,7,0,0,2,0,2,9,0
6515,144349,0Xxh6UWDrWwPPLaMpUv0ZEdnE00mPUSR,A3fsA9Zfv1X2fVEQhTw51lKENdNrEqT3,4,4,0,0,0,0,4,0,8,1.1428571428571428,2,0.0,0,0,0,0,4,0,0,4,0,0,8,0
6516,144357,Ie7mkAUCVVaLYxvosre748ADQJqirOJg,SpATywNh6bZuzm8s1ceuBUnMUAeoAHHw,6,3,1,0,1,0,2,0,7,1.0,1,0.0,0,1,0,1,3,0,0,2,0,2,5,1
6517,144363,svmQRfMWV47ki33Dy8s4c1zTDx5xyqqy,SpATywNh6bZuzm8s1ceuBUnMUAeoAHHw,1,0,0,0,0,0,1,0,1,0.14285714285714285,1,0.0,0,0,0,0,0,0,0,1,0,0,1,1
6518,144370,BdodnRCsey53xS6PtugKwlzojwI7pwLX,bWdj2GDclj5ofokWjzoa5jAwMkxCykd6,5,2,1,0,1,0,2,0,6,0.8571428571428571,1,0.0,0,1,0,1,2,0,0,2,0,2,4,0
6519,144381,fcKXv9ZhNMmLocipK5ZZiRQ1LDYoPfgB,G8EPVSXsOYB5YQWZGiz1aVq5Pgr2GrQu,10,5,4,0,4,0,3,1,17,2.4285714285714284,2,0.0,0,4,0,4,5,0,0,3,1,8,9,1
6520,144387,sxauqKQQUFpXy4JZb43frlkE4bOqyCWY,G8EPVSXsOYB5YQWZGiz1aVq5Pgr2GrQu,9,5,3,0,2,0,8,0,18,2.5714285714285716,1,0.0,0,3,0,2,5,0,0,8,0,5,13,1
6521,144395,o8axHOLhofevJLu5TvKmRFieQionk0uo,bWdj2GDclj5ofokWjzoa5jAwMkxCykd6,6,10,1,0,2,0,3,0,16,2.2857142857142856,2,0.0,0,1,0,2,10,0,0,3,0,3,13,1
6522,144401,4xrSOv0Zb9s9Mfulum5aoHlVB6c6SKgp,RXDvfPUBYFlVdlueBFbLW0mhhAyGEqpt,24,21,6,37,9,5,13,5,96,13.714285714285714,3,0.0,9,6,32,9,12,5,5,13,5,56,40,1
6523,144405,m0LuTHIjrSW3BF8YSCNgkHg0UqSBwWqE,bWdj2GDclj5ofokWjzoa5jAwMkxCykd6,7,23,6,0,5,0,7,0,41,5.857142857142857,3,0.0,6,6,0,5,17,0,0,7,0,17,24,1
6524,144413,SG7N8DhpCuhIu06IIzLX0CSolbyIDsIx,bWdj2GDclj5ofokWjzoa5jAwMkxCykd6,11,11,5,0,2,1,10,1,30,4.285714285714286,4,0.0,1,5,0,2,10,1,0,10,1,8,22,1
6525,144415,6ElmeAobgOVWMQKbfyTe96fhVbG33C2X,SpATywNh6bZuzm8s1ceuBUnMUAeoAHHw,1,0,0,0,0,0,2,0,2,0.2857142857142857,2,0.0,0,0,0,0,0,0,0,2,0,0,2,1
6526,144420,yntRyPnV06sPev3xKXJHMzKiUHpX97Sd,bWdj2GDclj5ofokWjzoa5jAwMkxCykd6,4,3,1,0,0,0,4,0,8,1.1428571428571428,1,0.0,0,1,0,0,3,0,0,4,0,1,7,1
6527,144425,cDfX3cMJgUCBkullLQDAvI97VlFeM2Mm,SpATywNh6bZuzm8s1ceuBUnMUAeoAHHw,1,0,0,0,0,0,1,0,1,0.14285714285714285,1,0.0,0,0,0,0,0,0,0,1,0,0,1,1
6528,144427,tVItbLut2hv4GIKzxM0DVZ7s3PzDPaT6,A3fsA9Zfv1X2fVEQhTw51lKENdNrEqT3,1,0,0,0,0,0,1,0,1,0.14285714285714285,1,0.0,0,0,0,0,0,0,0,1,0,0,1,1
6529,144430,04LxEQ3nhSzj7dXc7lrpbpcFvVUWGlZI,SpATywNh6bZuzm8s1ceuBUnMUAeoAHHw,16,17,9,18,4,4,10,1,63,9.0,2,0.0,4,9,15,4,13,4,3,10,1,32,31,0
6530,144435,v8vHTBb2c8b6hXbbCm3oZZxhG00wE2vP,SpATywNh6bZuzm8s1ceuBUnMUAeoAHHw,14,14,0,15,0,0,8,0,37,5.285714285714286,2,0.0,5,0,14,0,9,0,1,8,0,19,18,1
6531,144441,SSjG9q1bzvgdf9EkFqx8YjsCqQBg1XFt,A3fsA9Zfv1X2fVEQhTw51lKENdNrEqT3,21,12,9,0,7,0,8,1,37,5.285714285714286,2,0.0,0,9,0,7,12,0,0,8,1,16,21,0
6532,144464,lZNtuG4kxIFp0PJuciNw1EckZr8BFEk1,G8EPVSXsOYB5YQWZGiz1aVq5Pgr2GrQu,9,8,3,0,3,0,2,0,16,2.2857142857142856,1,0.0,4,3,0,3,4,0,0,2,0,10,6,1
6533,144468,mU6A1Eh1Sbu4ybvtOk62E6H19PAtCNgh,SpATywNh6bZuzm8s1ceuBUnMUAeoAHHw,17,29,14,18,4,2,21,2,90,12.857142857142858,5,0.0,6,14,15,4,23,2,3,21,2,39,51,1
6534,144470,3DA03ejzzYcn7ZLRW08jG2ITijpoufwN,G8EPVSXsOYB5YQWZGiz1aVq5Pgr2GrQu,12,17,1,6,1,0,4,1,30,4.285714285714286,1,0.0,7,1,3,1,10,0,3,4,1,12,18,1
6535,144475,JyrEAC8QBM1FImevyuACZ1OHrDsTde69,G8EPVSXsOYB5YQWZGiz1aVq5Pgr2GrQu,5,3,1,0,1,0,1,0,6,0.8571428571428571,1,0.0,0,1,0,1,3,0,0,1,0,2,4,1
6536,144476,uCAoWg5FaKwY0ioNKZmmoCVVstQhRxsa,SpATywNh6bZuzm8s1ceuBUnMUAeoAHHw,6,2,1,0,1,2,6,2,14,2.0,1,0.0,0,1,0,1,2,2,0,6,2,2,12,1
6537,144477,Lrv4yyy1oRPtpNW8S56NcLTs3dActQgc,SpATywNh6bZuzm8s1ceuBUnMUAeoAHHw,10,3,2,0,2,14,5,4,30,4.285714285714286,1,0.0,0,2,0,2,3,14,0,5,4,4,26,1
6538,144479,85biSqbQ9pgTGTSoZq3mDHUWbBBUYgJi,SpATywNh6bZuzm8s1ceuBUnMUAeoAHHw,16,21,11,12,7,5,7,0,63,9.0,2,0.0,8,11,11,7,13,5,1,7,0,37,26,0
6539,144491,liAQef8wjw79hEo9eOQyUXxysuTaQycU,A3fsA9Zfv1X2fVEQhTw51lKENdNrEqT3,2,0,0,0,0,0,2,0,2,0.2857142857142857,1,0.0,0,0,0,0,0,0,0,2,0,0,2,1
6540,144501,rFLQgLWbBhSut44kCW6TkgnVsL5AzEC5,SpATywNh6bZuzm8s1ceuBUnMUAeoAHHw,11,9,3,0,3,0,2,0,17,2.4285714285714284,2,0.0,0,3,0,3,9,0,0,2,0,6,11,1
6541,144506,bEN4cDdCBNI6z1gBK5oUDg5Tkh0maAFl,SpATywNh6bZuzm8s1ceuBUnMUAeoAHHw,9,6,5,0,3,0,2,0,16,2.2857142857142856,1,0.0,0,5,0,3,6,0,0,2,0,8,8,1
6542,144513,CDMI3gQZrAOAZ9Cf4jB5NzA4daPYwjjn,SpATywNh6bZuzm8s1ceuBUnMUAeoAHHw,1,0,0,0,0,0,1,0,1,0.14285714285714285,1,0.0,0,0,0,0,0,0,0,1,0,0,1,1
6543,144521,uCAoWg5FaKwY0ioNKZmmoCVVstQhRxsa,G8EPVSXsOYB5YQWZGiz1aVq5Pgr2GrQu,2,0,0,0,0,0,2,0,2,0.2857142857142857,1,0.0,0,0,0,0,0,0,0,2,0,0,2,1
6544,144526,9lksmcPg7FQE2FGQIA9VvWum1Z9DYrHM,G8EPVSXsOYB5YQWZGiz1aVq5Pgr2GrQu,1,0,0,0,0,0,1,0,1,0.14285714285714285,1,0.0,0,0,0,0,0,0,0,1,0,0,1,1
6545,144527,V76hQrNxMwZx40IX3yjuclMj7tgBsXTX,G8EPVSXsOYB5YQWZGiz1aVq5Pgr2GrQu,2,0,0,0,0,0,2,0,2,0.2857142857142857,1,0.0,0,0,0,0,0,0,0,2,0,0,2,1
6546,144536,393Iwr9LCShShn3ZP9MDE1iyGNI2KLnH,A3fsA9Zfv1X2fVEQhTw51lKENdNrEqT3,13,7,4,0,3,0,6,1,21,3.0,1,0.0,0,4,0,3,7,0,0,6,1,7,14,1
6547,144568,oBzLCci1yorqxivOBJW1dKnQofqyR5pw,A3fsA9Zfv1X2fVEQhTw51lKENdNrEqT3,2,0,0,0,0,0,2,0,2,0.2857142857142857,1,0.0,0,0,0,0,0,0,0,2,0,0,2,1
6548,144578,OUsTbnD6QZatQvggR5YjMxWOH6TYQEkw,SpATywNh6bZuzm8s1ceuBUnMUAeoAHHw,8,6,3,0,3,1,5,2,20,2.857142857142857,2,0.0,0,3,0,3,6,1,0,5,2,6,14,1
6549,144590,aiKrSmMzCgtO0agHJchvzxr28vyUxQZz,G8EPVSXsOYB5YQWZGiz1aVq5Pgr2GrQu,8,3,2,0,2,0,3,1,11,1.5714285714285714,1,0.0,0,2,0,2,3,0,0,3,1,4,7,1
6550,144593,K938KGiMd2B4Ec49syEZjpINF1qucFfC,A3fsA9Zfv1X2fVEQhTw51lKENdNrEqT3,6,3,2,0,2,0,2,0,9,1.2857142857142858,1,0.0,0,2,0,2,3,0,0,2,0,4,5,1
6551,144599,KkSinTdG2PbGrJIRATMZos8HES46UawO,SpATywNh6bZuzm8s1ceuBUnMUAeoAHHw,5,3,1,0,1,0,2,0,7,1.0,2,0.0,0,1,0,1,3,0,0,2,0,2,5,1
6552,144600,9loONblFsvKeToe2mgBZCeASeNdXOJTu,A3fsA9Zfv1X2fVEQhTw51lKENdNrEqT3,1,0,0,0,0,0,1,0,1,0.14285714285714285,1,0.0,0,0,0,0,0,0,0,1,0,0,1,1
6553,144604,5ehf4EFN8WhDbvmb2WvfZwpaBD0cj1oj,A3fsA9Zfv1X2fVEQhTw51lKENdNrEqT3,31,22,3,48,1,0,6,0,80,11.428571428571429,1,0.0,6,3,47,1,16,0,1,6,0,57,23,1
6554,144606,AeCrxYByugIwu4XUBpI0LhoTguBozLAa,SpATywNh6bZuzm8s1ceuBUnMUAeoAHHw,18,36,17,15,9,1,19,1,98,14.0,3,0.0,3,17,14,9,33,1,1,19,1,43,55,1
6555,144610,6oCDtYWE1YbVTX7pVBS5Cflb4KyRNNI9,bWdj2GDclj5ofokWjzoa5jAwMkxCykd6,7,2,0,0,0,1,7,1,11,1.5714285714285714,1,0.0,0,0,0,0,2,1,0,7,1,0,11,1
6556,144633,qpV3C2IZjB1ICwVxeuRFosLbHBid3MJt,A3fsA9Zfv1X2fVEQhTw51lKENdNrEqT3,22,14,10,0,8,1,6,1,40,5.714285714285714,1,0.0,2,10,0,8,12,1,0,6,1,20,20,1
6557,144638,PUdcV8hfT4fAKFK5ZdHY1Ahxf6WKmDC8,A3fsA9Zfv1X2fVEQhTw51lKENdNrEqT3,6,5,2,0,2,0,1,0,10,1.4285714285714286,1,0.0,0,2,0,2,5,0,0,1,0,4,6,1
6558,144639,VY7imgBCSjRZotznUQIcU9HEMteCD7Vu,SpATywNh6bZuzm8s1ceuBUnMUAeoAHHw,8,3,1,0,1,1,5,0,11,1.5714285714285714,2,0.0,0,1,0,1,3,1,0,5,0,2,9,1
6559,144642,9qlyY7aaGl7nuKeZpypgQ9ZpHmFszatV,A3fsA9Zfv1X2fVEQhTw51lKENdNrEqT3,44,24,17,62,14,1,10,1,129,18.428571428571427,2,0.0,3,17,53,14,21,1,9,10,1,87,42,1
6560,144648,2LaA70mUgBYc8D3OKr2EYK4J2QrpGRxB,A3fsA9Zfv1X2fVEQhTw51lKENdNrEqT3,30,9,6,54,4,0,4,0,77,11.0,2,0.0,2,6,48,4,7,0,6,4,0,60,17,1
6561,144650,nv8B6ZD44hAnu4T6PFDyOO5rZhYIZjTq,SpATywNh6bZuzm8s1ceuBUnMUAeoAHHw,8,10,2,0,2,0,6,0,20,2.857142857142857,3,0.0,0,2,0,2,10,0,0,6,0,4,16,1
6562,144659,ObnmYfTIiUEvUBHUZwAwe98p78F42lKP,SpATywNh6bZuzm8s1ceuBUnMUAeoAHHw,11,23,1,17,0,0,1,0,42,6.0,1,0.0,13,1,15,0,10,0,2,1,0,29,13,0
6563,144661,K1P5HkkD06S9UwpMzKhPLUcedpL6qD5q,G8EPVSXsOYB5YQWZGiz1aVq5Pgr2GrQu,1,0,0,0,0,0,1,0,1,0.14285714285714285,1,0.0,0,0,0,0,0,0,0,1,0,0,1,1
6564,144664,ZZTvad4Qf03uG7FsvH1m57TKBNy8UI9m,SpATywNh6bZuzm8s1ceuBUnMUAeoAHHw,6,5,2,0,1,0,5,0,13,1.8571428571428572,2,0.0,2,2,0,1,3,0,0,5,0,5,8,1
6565,144667,uk1SKekwkpaHXYRLjN8ZintRuJ2tncOb,SpATywNh6bZuzm8s1ceuBUnMUAeoAHHw,8,8,0,0,0,0,3,0,11,1.5714285714285714,1,0.0,2,0,0,0,6,0,0,3,0,2,9,0
6566,144669,IX7RiRPOSUbuV2fcXoS0ynYb5Bmt0H4j,G8EPVSXsOYB5YQWZGiz1aVq5Pgr2GrQu,13,8,2,16,2,2,6,1,37,5.285714285714286,1,0.0,5,2,13,2,3,2,3,6,1,22,15,0
6567,144671,2LaA70mUgBYc8D3OKr2EYK4J2QrpGRxB,bWdj2GDclj5ofokWjzoa5jAwMkxCykd6,8,5,3,0,2,0,8,0,18,2.5714285714285716,2,0.0,0,3,0,2,5,0,0,8,0,5,13,1
6568,144683,qpL2vcjziNlnSRSNpZZmRQfFObDSNaQD,A3fsA9Zfv1X2fVEQhTw51lKENdNrEqT3,2,0,0,0,0,0,2,0,2,0.2857142857142857,1,0.0,0,0,0,0,0,0,0,2,0,0,2,1
6569,144686,mp93D5T5EosRPeX8VQcgmycIpnu3UAVQ,SpATywNh6bZuzm8s1ceuBUnMUAeoAHHw,10,6,4,0,3,0,3,0,16,2.2857142857142856,1,0.0,0,4,0,3,6,0,0,3,0,7,9,1
6570,144695,BWZzwZgEWlPhZ8O1NZ0qWUnIi8M3MM7E,RXDvfPUBYFlVdlueBFbLW0mhhAyGEqpt,2,0,0,0,0,0,2,0,2,0.2857142857142857,1,0.0,0,0,0,0,0,0,0,2,0,0,2,1
6571,144700,SgWqRh3XmeJpz6RfUb8yXu2ZkH0AleuJ,A3fsA9Zfv1X2fVEQhTw51lKENdNrEqT3,1,0,0,0,0,0,1,0,1,0.14285714285714285,1,0.0,0,0,0,0,0,0,0,1,0,0,1,1
6572,144702,Edq6Echk8wEs8ShX5RBw5c8Yx8ANHVje,SpATywNh6bZuzm8s1ceuBUnMUAeoAHHw,4,2,0,0,0,0,3,0,5,0.7142857142857143,2,0.0,0,0,0,0,2,0,0,3,0,0,5,1
6573,144703,Edq6Echk8wEs8ShX5RBw5c8Yx8ANHVje,A3fsA9Zfv1X2fVEQhTw51lKENdNrEqT3,5,3,0,0,0,0,2,0,5,0.7142857142857143,1,0.0,0,0,0,0,3,0,0,2,0,0,5,1
6574,144708,Edq6Echk8wEs8ShX5RBw5c8Yx8ANHVje,G8EPVSXsOYB5YQWZGiz1aVq5Pgr2GrQu,5,2,1,0,1,0,3,0,7,1.0,2,0.0,0,1,0,1,2,0,0,3,0,2,5,1
6575,144709,Edq6Echk8wEs8ShX5RBw5c8Yx8ANHVje,RXDvfPUBYFlVdlueBFbLW0mhhAyGEqpt,5,3,0,0,0,0,3,0,6,0.8571428571428571,2,0.0,0,0,0,0,3,0,0,3,0,0,6,1
6576,144711,5W6zUlMsjNEU65Ree05lYmcDiOLewtR2,A3fsA9Zfv1X2fVEQhTw51lKENdNrEqT3,13,14,0,0,0,0,4,0,18,2.5714285714285716,2,0.0,0,0,0,0,14,0,0,4,0,0,18,1
6577,144722,0PHNMn5JYsQigYaNxUJgIv4qow2cWlQK,A3fsA9Zfv1X2fVEQhTw51lKENdNrEqT3,2,0,0,0,0,0,2,0,2,0.2857142857142857,1,0.0,0,0,0,0,0,0,0,2,0,0,2,1
6578,144723,TkLeStjoXAMG5nRKUJ5tMauLM6wlBb8U,SpATywNh6bZuzm8s1ceuBUnMUAeoAHHw,16,13,5,16,3,0,4,0,41,5.857142857142857,1,0.0,6,5,14,3,7,0,2,4,0,28,13,1
6579,144729,Myt16IMVzxwRTOZLb6UMMq0vewiso7Vm,SpATywNh6bZuzm8s1ceuBUnMUAeoAHHw,15,27,1,12,1,8,9,2,60,8.571428571428571,3,0.0,15,1,9,1,12,8,3,9,2,26,34,1
6580,144733,X7TtqcEziDolV47iXb7vXuzoIflttREX,A3fsA9Zfv1X2fVEQhTw51lKENdNrEqT3,2,0,0,0,0,0,2,0,2,0.2857142857142857,1,0.0,0,0,0,0,0,0,0,2,0,0,2,1
6581,144739,i3sBPnecqsJtCmiHMtv0ri41qFT4LGFd,SpATywNh6bZuzm8s1ceuBUnMUAeoAHHw,1,0,0,0,0,0,1,0,1,0.14285714285714285,1,0.0,0,0,0,0,0,0,0,1,0,0,1,1
6582,144750,CWRrmCimMLwDXZTgPsiO3B49woTmmP7J,SpATywNh6bZuzm8s1ceuBUnMUAeoAHHw,4,3,0,0,0,0,2,0,5,0.7142857142857143,1,0.0,0,0,0,0,3,0,0,2,0,0,5,1
6583,144755,0eMlSFoZScU7zUCIgAM0BWfQh50FQz3i,RXDvfPUBYFlVdlueBFbLW0mhhAyGEqpt,22,18,15,10,9,1,2,0,55,7.857142857142857,3,0.0,1,15,8,9,17,1,2,2,0,33,22,1
6584,144758,iEsrSdCjyin4iFARTXOj17FWObSkkW7Y,A3fsA9Zfv1X2fVEQhTw51lKENdNrEqT3,4,2,0,0,0,0,5,0,7,1.0,1,0.0,0,0,0,0,2,0,0,5,0,0,7,1
6585,144761,0xrj8jMy7DRmz2206OV6CH0SXBZh0mT4,SpATywNh6bZuzm8s1ceuBUnMUAeoAHHw,7,3,2,0,2,0,2,0,9,1.2857142857142858,1,0.0,0,2,0,2,3,0,0,2,0,4,5,1
6586,144772,yB2j2tPO2DVKCBBdsLv8a1lbHtfWINMh,A3fsA9Zfv1X2fVEQhTw51lKENdNrEqT3,22,17,14,0,12,0,4,0,47,6.714285714285714,3,0.0,0,14,0,12,17,0,0,4,0,26,21,0
6587,144775,WQI2O3Oijx2QlB8hE2TltFPDzjM5E22B,A3fsA9Zfv1X2fVEQhTw51lKENdNrEqT3,1,0,0,0,0,0,1,0,1,0.14285714285714285,1,0.0,0,0,0,0,0,0,0,1,0,0,1,1
6588,144776,jOKGDo32k5y1tQ1HBtDhmlq3GlvnMuW4,RXDvfPUBYFlVdlueBFbLW0mhhAyGEqpt,5,2,1,0,1,0,2,0,6,0.8571428571428571,1,0.0,0,1,0,1,2,0,0,2,0,2,4,1
6589,144791,qhMicTW8kXbgpTyOx2V27yOmKQOouISe,SpATywNh6bZuzm8s1ceuBUnMUAeoAHHw,17,19,8,19,3,5,7,1,62,8.857142857142858,2,0.0,8,8,16,3,11,5,3,7,1,35,27,1
6590,144792,PbpiZjozcQl91esiggJPwCEQesHzXMge,SpATywNh6bZuzm8s1ceuBUnMUAeoAHHw,4,2,0,0,0,0,3,0,5,0.7142857142857143,1,0.0,0,0,0,0,2,0,0,3,0,0,5,1
6591,144793,Q4yECXO7W1LpqtiMAu4zBn3zpNL7asTt,RXDvfPUBYFlVdlueBFbLW0mhhAyGEqpt,30,27,2,49,2,5,10,3,98,14.0,5,0.0,5,2,45,2,22,5,4,10,3,54,44,1
6592,144807,jOmJWWKjeEAibobmUGCNZpRQTVi2zu3q,SpATywNh6bZuzm8s1ceuBUnMUAeoAHHw,5,2,1,0,1,0,3,0,7,1.0,1,0.0,0,1,0,1,2,0,0,3,0,2,5,1
6593,144812,2plfHoT1TmtCwY9OYRzSThXWtZ22ORll,SpATywNh6bZuzm8s1ceuBUnMUAeoAHHw,4,3,1,0,1,0,1,0,6,0.8571428571428571,1,0.0,0,1,0,1,3,0,0,1,0,2,4,1
6594,144816,kQbCL3ZvWis8hkLoQgkRd3flhuUVeNwO,SpATywNh6bZuzm8s1ceuBUnMUAeoAHHw,5,2,0,0,1,0,2,0,5,0.7142857142857143,1,0.0,0,0,0,1,2,0,0,2,0,1,4,1
6595,144821,CQWretzMoQOL7mDTUjZusG4cd4L6wPQK,SpATywNh6bZuzm8s1ceuBUnMUAeoAHHw,11,8,6,0,4,0,3,0,21,3.0,2,0.0,0,6,0,4,8,0,0,3,0,10,11,1
6596,144822,0xrj8jMy7DRmz2206OV6CH0SXBZh0mT4,A3fsA9Zfv1X2fVEQhTw51lKENdNrEqT3,7,3,2,0,2,0,2,0,9,1.2857142857142858,1,0.0,0,2,0,2,3,0,0,2,0,4,5,0
6597,144828,KiabjnGWKx4XDSpmz6cnPElBww0X3aaK,SpATywNh6bZuzm8s1ceuBUnMUAeoAHHw,16,21,7,22,3,0,5,0,58,8.285714285714286,1,0.0,9,7,19,3,12,0,3,5,0,38,20,1
6598,144838,afGDIbGbSLFIkIVgYTcsM0nZrlLAYXP9,SpATywNh6bZuzm8s1ceuBUnMUAeoAHHw,10,9,6,0,5,1,20,1,42,6.0,2,0.0,0,6,0,5,9,1,0,20,1,11,31,1
6599,144839,59I5in7ieFGusS8qxVtrv60LZ3ifOtyr,A3fsA9Zfv1X2fVEQhTw51lKENdNrEqT3,3,3,0,0,0,0,2,0,5,0.7142857142857143,2,0.0,0,0,0,0,3,0,0,2,0,0,5,1
6600,144841,5o27t78wmU6kJM7l11bepi10qooi6vTp,A3fsA9Zfv1X2fVEQhTw51lKENdNrEqT3,3,0,0,0,0,2,2,0,4,0.5714285714285714,1,0.0,0,0,0,0,0,2,0,2,0,0,4,1
6601,144845,FfUXMT7mZqZTunyhx99wOtQUuUI4jlLj,A3fsA9Zfv1X2fVEQhTw51lKENdNrEqT3,11,7,4,0,4,0,2,0,17,2.4285714285714284,2,0.0,0,4,0,4,7,0,0,2,0,8,9,1
6602,144851,Msnkbi5gSjnXMGVMwapulzDXPJT7PsEO,RXDvfPUBYFlVdlueBFbLW0mhhAyGEqpt,2,0,0,0,0,0,2,0,2,0.2857142857142857,1,0.0,0,0,0,0,0,0,0,2,0,0,2,1
6603,144856,raoWM7iEQ4dq4BWNCSh69Fo9jIIvs47M,RXDvfPUBYFlVdlueBFbLW0mhhAyGEqpt,1,0,0,0,0,0,1,0,1,0.14285714285714285,1,0.0,0,0,0,0,0,0,0,1,0,0,1,1
6604,144861,ytxaMMjv4jRoSu72s5GHMltMaCAqKKcw,A3fsA9Zfv1X2fVEQhTw51lKENdNrEqT3,6,4,1,0,0,0,4,0,9,1.2857142857142858,1,0.0,0,1,0,0,4,0,0,4,0,1,8,1
6605,144862,7ZV5hVKM33Il4ZphKUROohrBCk5SoM3Q,RXDvfPUBYFlVdlueBFbLW0mhhAyGEqpt,8,25,14,0,0,0,1,0,40,5.714285714285714,1,0.0,8,14,0,0,17,0,0,1,0,22,18,1
6606,144865,T9c92JfvB6Kfucc01WIFC70LXWVeMAod,SpATywNh6bZuzm8s1ceuBUnMUAeoAHHw,15,23,0,18,0,13,9,1,64,9.142857142857142,1,0.0,8,0,15,0,15,13,3,9,1,23,41,1
6607,144877,ooFElJ4ZPOLTBMQwigtvKfnHk0DNrR2R,bWdj2GDclj5ofokWjzoa5jAwMkxCykd6,2,0,0,0,0,0,2,0,2,0.2857142857142857,1,0.0,0,0,0,0,0,0,0,2,0,0,2,1
6608,144882,ng2LeRo6bYVrW9ExHXJ3akhqh2xVsMqB,G8EPVSXsOYB5YQWZGiz1aVq5Pgr2GrQu,6,4,0,0,1,4,2,0,11,1.5714285714285714,1,0.0,0,0,0,1,4,4,0,2,0,1,10,1
6609,144904,oIHEiOwjcaMd5CeWZdkq4rXU3yelDWwT,bWdj2GDclj5ofokWjzoa5jAwMkxCykd6,1,0,0,0,0,0,1,0,1,0.14285714285714285,1,0.0,0,0,0,0,0,0,0,1,0,0,1,1
6610,144918,PZdxFgKpeQmexjsFXHDQYKHzq3CXEabo,SpATywNh6bZuzm8s1ceuBUnMUAeoAHHw,7,2,2,0,2,0,2,0,8,1.1428571428571428,1,0.0,0,2,0,2,2,0,0,2,0,4,4,1
6611,144921,1ygmKyxuE9zTchPBrLxYZHBa3CxHnvGx,SpATywNh6bZuzm8s1ceuBUnMUAeoAHHw,1,0,0,0,0,0,1,0,1,0.14285714285714285,1,0.0,0,0,0,0,0,0,0,1,0,0,1,1
6612,144922,1whtO6jrHXBMnMCSb8vftfOcDZoI6lpk,SpATywNh6bZuzm8s1ceuBUnMUAeoAHHw,2,0,0,0,0,0,2,0,2,0.2857142857142857,1,0.0,0,0,0,0,0,0,0,2,0,0,2,1
6613,144930,0ItSpPGfnBPXWyzwV4fknfpLDkx7tWJ8,SpATywNh6bZuzm8s1ceuBUnMUAeoAHHw,1,0,0,0,0,0,1,0,1,0.14285714285714285,1,0.0,0,0,0,0,0,0,0,1,0,0,1,1
6614,144934,WiWr9LeARPPUMTXasnYbOZNxI6vKEOag,SpATywNh6bZuzm8s1ceuBUnMUAeoAHHw,9,12,8,0,6,0,3,0,29,4.142857142857143,1,0.0,0,8,0,6,12,0,0,3,0,14,15,0
6615,144942,sJvbEmQSLPUSlzQVliesQ54qeaDrLfvx,A3fsA9Zfv1X2fVEQhTw51lKENdNrEqT3,1,0,0,0,0,0,1,0,1,0.14285714285714285,1,0.0,0,0,0,0,0,0,0,1,0,0,1,0
6616,144962,Tknw6wFyBHibLmhWsLFULGANgYkknQHe,bWdj2GDclj5ofokWjzoa5jAwMkxCykd6,8,6,0,0,0,0,6,0,12,1.7142857142857142,2,0.0,0,0,0,0,6,0,0,6,0,0,12,1
6617,144964,5x6p4rljKsrejQoWBLOKiqqWs4gJF7v5,bWdj2GDclj5ofokWjzoa5jAwMkxCykd6,4,2,0,0,0,0,2,0,4,0.5714285714285714,1,0.0,0,0,0,0,2,0,0,2,0,0,4,1
6618,144979,AO5lBD55aLiSGI6wc1OCl02CqUcrTOsS,G8EPVSXsOYB5YQWZGiz1aVq5Pgr2GrQu,7,6,2,2,3,0,2,0,15,2.142857142857143,1,0.0,3,2,1,3,3,0,1,2,0,9,6,0
6619,144984,mco1H2E00EJyxVOQ1f2JUOahUZWPVYSV,G8EPVSXsOYB5YQWZGiz1aVq5Pgr2GrQu,12,16,11,0,5,1,9,0,42,6.0,3,0.0,0,11,0,5,16,1,0,9,0,16,26,1
6620,144988,r2BlY5kx3gPU1opGlfjFI0ngbnfS5jKE,bWdj2GDclj5ofokWjzoa5jAwMkxCykd6,1,0,0,0,0,0,2,0,2,0.2857142857142857,1,0.0,0,0,0,0,0,0,0,2,0,0,2,1
6621,144998,QbBXesiuS3b5lRVZqzzdKh71YLAIKh1k,A3fsA9Zfv1X2fVEQhTw51lKENdNrEqT3,20,14,8,0,6,1,7,1,37,5.285714285714286,2,0.0,0,8,0,6,14,1,0,7,1,14,23,0
6622,144999,KQvub9kHQ3XpwpO5JgmmZp67zs4af3TX,SpATywNh6bZuzm8s1ceuBUnMUAeoAHHw,9,7,4,0,1,2,8,1,23,3.2857142857142856,1,0.0,0,4,0,1,7,2,0,8,1,5,18,1
6623,145000,FsN3EYiAfRxm9msVQNiGujMlmaZjdiLV,A3fsA9Zfv1X2fVEQhTw51lKENdNrEqT3,10,5,3,0,2,0,5,0,15,2.142857142857143,1,0.0,0,3,0,2,5,0,0,5,0,5,10,1
6624,145001,cZxcDNlAnm0tcnrjnkTKyh2S3nRuNP2Z,G8EPVSXsOYB5YQWZGiz1aVq5Pgr2GrQu,7,5,1,0,1,0,3,0,10,1.4285714285714286,1,0.0,2,1,0,1,3,0,0,3,0,4,6,1
6625,145005,GkMFrAPlA6A09ccGhHn8t14lF9MeMrXS,SpATywNh6bZuzm8s1ceuBUnMUAeoAHHw,4,5,2,0,0,0,1,0,8,1.1428571428571428,1,0.0,0,2,0,0,5,0,0,1,0,2,6,1
6626,145008,1ORn2IwJawkKgC86QfIvIvcPRotoBurY,RXDvfPUBYFlVdlueBFbLW0mhhAyGEqpt,1,0,0,0,0,0,1,0,1,0.14285714285714285,1,0.0,0,0,0,0,0,0,0,1,0,0,1,1
6627,145013,yIWNRaHiP3wQHGf1Y6WI0xVXEdSpULNT,SpATywNh6bZuzm8s1ceuBUnMUAeoAHHw,6,3,2,0,2,0,1,0,8,1.1428571428571428,1,0.0,0,2,0,2,3,0,0,1,0,4,4,1
6628,145018,sPPWsacmUhKicl9IkMyPoW9C9Hv6wkAR,SpATywNh6bZuzm8s1ceuBUnMUAeoAHHw,11,13,2,0,1,0,4,0,20,2.857142857142857,2,0.0,0,2,0,1,13,0,0,4,0,3,17,1
6629,145030,ZvJHkcI26nhwqsVV9yaOoOyrIpy66iPT,A3fsA9Zfv1X2fVEQhTw51lKENdNrEqT3,6,6,1,0,1,0,1,0,9,1.2857142857142858,1,0.0,0,1,0,1,6,0,0,1,0,2,7,1
6630,145041,yIWNRaHiP3wQHGf1Y6WI0xVXEdSpULNT,bWdj2GDclj5ofokWjzoa5jAwMkxCykd6,5,2,1,0,1,0,2,0,6,0.8571428571428571,1,0.0,0,1,0,1,2,0,0,2,0,2,4,1
6631,145052,xvgAWMkP6HI1IM5orrHyjEEETuOd15kx,A3fsA9Zfv1X2fVEQhTw51lKENdNrEqT3,1,0,0,0,0,0,1,0,1,0.14285714285714285,1,0.0,0,0,0,0,0,0,0,1,0,0,1,1
6632,145055,rL34nWMQELY22w9bM5KXtMtPPdNRd6Vz,bWdj2GDclj5ofokWjzoa5jAwMkxCykd6,8,4,3,0,3,0,2,0,12,1.7142857142857142,1,0.0,0,3,0,3,4,0,0,2,0,6,6,1
6633,145059,0ZuqaZpF1uAdriF9eidLtJ5iuMfVy2xj,SpATywNh6bZuzm8s1ceuBUnMUAeoAHHw,11,16,4,0,2,10,5,0,37,5.285714285714286,2,0.0,0,4,0,2,16,10,0,5,0,6,31,1
6634,145106,DyTFy9Maa2ONHa1kuv16yd2JfoXtDQiQ,A3fsA9Zfv1X2fVEQhTw51lKENdNrEqT3,2,0,0,0,0,0,2,0,2,0.2857142857142857,1,0.0,0,0,0,0,0,0,0,2,0,0,2,1
6635,145109,PnK7IG5mVnL9F5P0hCKqF8uvfGfnI7Zr,SpATywNh6bZuzm8s1ceuBUnMUAeoAHHw,18,15,8,14,3,1,23,4,68,9.714285714285714,2,0.0,5,8,11,3,10,1,3,23,4,27,41,1
6636,145115,s4uxePGHFu7vUUg0QFSUrIPUr6ntECxH,SpATywNh6bZuzm8s1ceuBUnMUAeoAHHw,11,4,3,0,2,1,8,1,19,2.7142857142857144,2,0.0,0,3,0,2,4,1,0,8,1,5,14,1
6637,145116,TQ3ME8oXFjG9uPuJF9DlrWFS3Mh17Asw,SpATywNh6bZuzm8s1ceuBUnMUAeoAHHw,12,14,1,12,0,7,7,1,42,6.0,1,0.0,6,1,9,0,8,7,3,7,1,16,26,1
6638,145118,QoxAfK1F7spDZI2801beWPeXZSdQfP03,SpATywNh6bZuzm8s1ceuBUnMUAeoAHHw,9,14,1,9,0,16,5,0,45,6.428571428571429,2,0.0,10,1,9,0,4,16,0,5,0,20,25,1
6639,145120,iMAPtNJrTh9vdZVbGuGpFbwdggkaxy45,SpATywNh6bZuzm8s1ceuBUnMUAeoAHHw,13,14,9,0,5,4,6,0,38,5.428571428571429,2,0.0,2,9,0,5,12,4,0,6,0,16,22,1
6640,145134,nA58ZDkDJW4coPbkDAFQTIrhFRBe6rSy,G8EPVSXsOYB5YQWZGiz1aVq5Pgr2GrQu,8,14,2,0,0,0,4,0,20,2.857142857142857,2,0.0,4,2,0,0,10,0,0,4,0,6,14,1
6641,145135,ryorMC5bEintyqBNOh5gLfjxAx4QoH5u,A3fsA9Zfv1X2fVEQhTw51lKENdNrEqT3,17,22,13,0,4,12,19,3,73,10.428571428571429,2,0.0,1,13,0,4,21,12,0,19,3,18,55,1
6642,145137,yCZXjIGq001xO7v4MWCrl9HykbxmZHu1,SpATywNh6bZuzm8s1ceuBUnMUAeoAHHw,9,22,6,24,0,0,2,0,54,7.714285714285714,1,0.0,14,6,19,0,8,0,5,2,0,39,15,0
6643,145143,sytW49I21SJ70ElOkXGU5SHeeHl1E3fL,RXDvfPUBYFlVdlueBFbLW0mhhAyGEqpt,1,0,0,0,0,0,1,0,1,0.14285714285714285,1,0.0,0,0,0,0,0,0,0,1,0,0,1,1
6644,145155,BohRHH2vBIgnEZGZjM3WnHwJbVFmITRG,bWdj2GDclj5ofokWjzoa5jAwMkxCykd6,1,0,0,0,0,0,2,0,2,0.2857142857142857,1,0.0,0,0,0,0,0,0,0,2,0,0,2,1
6645,145161,K9rvD8Iu0wq956P4CDD0WYKLX5TfMvJ0,SpATywNh6bZuzm8s1ceuBUnMUAeoAHHw,7,3,2,0,2,0,3,0,10,1.4285714285714286,2,0.0,0,2,0,2,3,0,0,3,0,4,6,1
6646,145165,6h1KbHhbSaGcIKRFEHiX0UdDPCB3E5BQ,A3fsA9Zfv1X2fVEQhTw51lKENdNrEqT3,7,3,2,0,2,0,3,0,10,1.4285714285714286,1,0.0,0,2,0,2,3,0,0,3,0,4,6,1
6647,145167,q1fsTZpD3tHg9RFkIri5aJQcs8ZtVzZU,A3fsA9Zfv1X2fVEQhTw51lKENdNrEqT3,1,0,0,0,0,0,1,0,1,0.14285714285714285,1,0.0,0,0,0,0,0,0,0,1,0,0,1,1
6648,145182,JkokNSOVQ0CmVMNuEphopYOXBxfXEJtF,SpATywNh6bZuzm8s1ceuBUnMUAeoAHHw,5,2,1,0,1,0,7,0,11,1.5714285714285714,2,0.0,0,1,0,1,2,0,0,7,0,2,9,1
6649,145183,l5XRpi9H4fQ2XUHeEPRXRHL6Y4BckIOB,bWdj2GDclj5ofokWjzoa5jAwMkxCykd6,5,10,3,0,5,0,1,0,19,2.7142857142857144,2,0.0,4,3,0,5,6,0,0,1,0,12,7,1
6650,145195,XOKsEN36DokXwcr1smPc9nspsVQlK0Oq,bWdj2GDclj5ofokWjzoa5jAwMkxCykd6,5,2,1,0,0,0,3,0,6,0.8571428571428571,1,0.0,0,1,0,0,2,0,0,3,0,1,5,1
6651,145204,HnmJeuwsJxtO6k1CT8974Qo3Mu0GibPm,SpATywNh6bZuzm8s1ceuBUnMUAeoAHHw,6,3,1,0,1,0,3,0,8,1.1428571428571428,1,0.0,0,1,0,1,3,0,0,3,0,2,6,1
6652,145206,GQtHf5FrRCd4lKlDjEvxcTzFdncOzUUt,SpATywNh6bZuzm8s1ceuBUnMUAeoAHHw,4,2,0,0,0,0,2,0,4,0.5714285714285714,1,0.0,0,0,0,0,2,0,0,2,0,0,4,1
6653,145208,oGbJmKuU02t3nWH0tibgF9TroQlaGQUL,SpATywNh6bZuzm8s1ceuBUnMUAeoAHHw,13,14,8,0,3,0,10,0,35,5.0,1,0.0,2,8,0,3,12,0,0,10,0,13,22,1
6654,145217,TvUMV7rQqIP7XtKwTDDoLxmalP29Ttuw,SpATywNh6bZuzm8s1ceuBUnMUAeoAHHw,15,15,5,20,3,0,3,0,46,6.571428571428571,1,0.0,9,5,17,3,6,0,3,3,0,34,12,1
6655,145226,OpGwtUbMGweipJr0vMybah9tM3IHgiea,G8EPVSXsOYB5YQWZGiz1aVq5Pgr2GrQu,7,8,0,0,0,0,3,0,11,1.5714285714285714,1,0.0,0,0,0,0,8,0,0,3,0,0,11,1
6656,145236,DaYS7gf8DVgCD84ya5YqgMFFiGYw1ps2,bWdj2GDclj5ofokWjzoa5jAwMkxCykd6,10,14,1,0,3,0,7,1,26,3.7142857142857144,2,0.0,5,1,0,3,9,0,0,7,1,9,17,1
6657,145239,OtjE6pGePvcycREQhVmfTMoFJDvUV70D,SpATywNh6bZuzm8s1ceuBUnMUAeoAHHw,11,6,5,2,2,0,3,0,18,2.5714285714285716,1,0.0,0,5,2,2,6,0,0,3,0,9,9,1
6658,145253,5CjxInsWcHYdL9qJZYHVK4nh5ZsDhwos,A3fsA9Zfv1X2fVEQhTw51lKENdNrEqT3,6,3,1,0,1,0,2,0,7,1.0,1,0.0,0,1,0,1,3,0,0,2,0,2,5,1
6659,145259,5CjxInsWcHYdL9qJZYHVK4nh5ZsDhwos,bWdj2GDclj5ofokWjzoa5jAwMkxCykd6,10,16,3,0,3,2,7,1,32,4.571428571428571,2,0.0,0,3,0,3,16,2,0,7,1,6,26,1
6660,145264,EvNxwwShcQXgwZllGhuS7z5fGOL08A9A,G8EPVSXsOYB5YQWZGiz1aVq5Pgr2GrQu,1,0,0,0,0,0,1,0,1,0.14285714285714285,1,0.0,0,0,0,0,0,0,0,1,0,0,1,1
6661,145306,gB1oK8asvoVWRzgcHWrM4vY7Z3TLvmEu,G8EPVSXsOYB5YQWZGiz1aVq5Pgr2GrQu,14,29,2,0,2,1,14,1,49,7.0,2,0.0,0,2,0,2,29,1,0,14,1,4,45,1
6662,145308,UdRvlfQEjfzv2meiEECQoQ6VdSnYEWcK,bWdj2GDclj5ofokWjzoa5jAwMkxCykd6,1,0,0,0,0,0,1,0,1,0.14285714285714285,1,0.0,0,0,0,0,0,0,0,1,0,0,1,1
6663,145314,0G4cec511TtDyNtXCTS7DRIqOcOGSzxj,bWdj2GDclj5ofokWjzoa5jAwMkxCykd6,2,0,0,0,0,0,4,0,4,0.5714285714285714,2,0.0,0,0,0,0,0,0,0,4,0,0,4,1
6664,145324,eb3SHueTE6ugnDkhYnh0RBSPDS20VwLZ,SpATywNh6bZuzm8s1ceuBUnMUAeoAHHw,10,13,6,0,3,0,4,0,26,3.7142857142857144,2,0.0,2,6,0,3,11,0,0,4,0,11,15,1
6665,145327,fB0i7xObEYSWbMZwNEun6y9gdH9iF6Ca,bWdj2GDclj5ofokWjzoa5jAwMkxCykd6,6,4,1,0,0,0,3,0,8,1.1428571428571428,1,0.0,0,1,0,0,4,0,0,3,0,1,7,1
6666,145344,rrHRbXLg6i4u3JAIzGOFXJzGViekqHta,A3fsA9Zfv1X2fVEQhTw51lKENdNrEqT3,5,4,2,0,1,1,3,0,11,1.5714285714285714,2,0.0,0,2,0,1,4,1,0,3,0,3,8,1
6667,145354,KF5OPToc2HXGCGomze0nhcEx5XKSQ0eb,A3fsA9Zfv1X2fVEQhTw51lKENdNrEqT3,1,0,0,0,0,0,1,0,1,0.14285714285714285,1,0.0,0,0,0,0,0,0,0,1,0,0,1,1
6668,145359,KF5OPToc2HXGCGomze0nhcEx5XKSQ0eb,bWdj2GDclj5ofokWjzoa5jAwMkxCykd6,7,6,1,0,0,0,5,1,13,1.8571428571428572,2,0.0,0,1,0,0,6,0,0,5,1,1,12,1
6669,145362,UTEysxng8QdAA1HDzCSMUfK51MYoUK0I,SpATywNh6bZuzm8s1ceuBUnMUAeoAHHw,18,23,8,17,3,1,9,1,62,8.857142857142858,2,0.0,10,8,15,3,13,1,2,9,1,36,26,1
6670,145365,pG2ElR6wLgS0VIoYkLxmyVPOZz4q1huq,SpATywNh6bZuzm8s1ceuBUnMUAeoAHHw,5,3,1,0,1,0,4,0,9,1.2857142857142858,1,0.0,0,1,0,1,3,0,0,4,0,2,7,1
6671,145367,D9K6eWkEOoVrLczNZaGo49KoERtz2c6V,SpATywNh6bZuzm8s1ceuBUnMUAeoAHHw,9,11,7,0,2,0,4,0,24,3.4285714285714284,3,0.0,0,7,0,2,11,0,0,4,0,9,15,1
6672,145368,705a1tvxnZT7omctMx7Fjakho000VDxN,A3fsA9Zfv1X2fVEQhTw51lKENdNrEqT3,1,0,0,0,0,0,2,0,2,0.2857142857142857,1,0.0,0,0,0,0,0,0,0,2,0,0,2,1
6673,145378,cMwTVyssxspl1RAprFyXqPmiVK2Z3yGe,SpATywNh6bZuzm8s1ceuBUnMUAeoAHHw,6,3,1,0,1,0,2,0,7,1.0,1,0.0,0,1,0,1,3,0,0,2,0,2,5,1
6674,145380,hZsYKh9WLvB4Wt2hCg4xVcKygpRAuxj7,A3fsA9Zfv1X2fVEQhTw51lKENdNrEqT3,25,10,9,16,8,0,4,0,47,6.714285714285714,2,0.0,0,9,14,8,10,0,2,4,0,31,16,1
6675,145389,TRYKApgWJsELbbCq5WSkTNwaxvbHHyCj,A3fsA9Zfv1X2fVEQhTw51lKENdNrEqT3,2,0,0,0,0,0,3,0,3,0.42857142857142855,1,0.0,0,0,0,0,0,0,0,3,0,0,3,1
6676,145391,H1aKLEBJtpAOAOCXptqn2WzikG0W6HkP,SpATywNh6bZuzm8s1ceuBUnMUAeoAHHw,3,0,0,0,0,0,2,1,3,0.42857142857142855,1,0.0,0,0,0,0,0,0,0,2,1,0,3,1
6677,145403,NO22WSq5lVGwq6WPEcqalEaMjYIZxX3u,SpATywNh6bZuzm8s1ceuBUnMUAeoAHHw,1,0,0,0,0,0,1,0,1,0.14285714285714285,1,0.0,0,0,0,0,0,0,0,1,0,0,1,1
6678,145411,sETZmDR5b3CheYe2K5IvWb1lrRsZmOT8,bWdj2GDclj5ofokWjzoa5jAwMkxCykd6,7,4,0,0,0,0,6,1,11,1.5714285714285714,2,0.0,0,0,0,0,4,0,0,6,1,0,11,1
6679,145461,XGghmqZSDFp0iwrgmPDUKXBdusY5a7fx,bWdj2GDclj5ofokWjzoa5jAwMkxCykd6,4,3,1,0,1,0,1,0,6,0.8571428571428571,1,0.0,0,1,0,1,3,0,0,1,0,2,4,1
6680,145471,cRlXLJdkIX4KH74JKLBjP86zQb3lppxR,A3fsA9Zfv1X2fVEQhTw51lKENdNrEqT3,9,4,3,0,3,0,2,0,12,1.7142857142857142,1,0.0,0,3,0,3,4,0,0,2,0,6,6,1
6681,145473,UNqMz63UOiLuXMnJzd7YWyfD3qIuNdaK,A3fsA9Zfv1X2fVEQhTw51lKENdNrEqT3,8,3,2,0,2,0,5,0,12,1.7142857142857142,2,0.0,0,2,0,2,3,0,0,5,0,4,8,1
6682,145474,cRlXLJdkIX4KH74JKLBjP86zQb3lppxR,SpATywNh6bZuzm8s1ceuBUnMUAeoAHHw,5,2,1,0,1,0,2,0,6,0.8571428571428571,1,0.0,0,1,0,1,2,0,0,2,0,2,4,1
6683,145483,wAirqcgeWs2CREKJhWAsWOo902skDwiw,SpATywNh6bZuzm8s1ceuBUnMUAeoAHHw,1,0,0,0,0,0,1,0,1,0.14285714285714285,1,0.0,0,0,0,0,0,0,0,1,0,0,1,1
6684,145487,3nvYm1DKrH5EOHAw44wBVldk53PpV7TA,A3fsA9Zfv1X2fVEQhTw51lKENdNrEqT3,14,10,7,0,5,2,2,0,26,3.7142857142857144,1,0.0,0,7,0,5,10,2,0,2,0,12,14,1
6685,145490,cKkpvGwYNdrpPwFgGI1Q3ssqlyxAIVaB,SpATywNh6bZuzm8s1ceuBUnMUAeoAHHw,7,7,4,0,3,0,1,0,15,2.142857142857143,1,0.0,2,4,0,3,5,0,0,1,0,9,6,1
6686,145493,BQyaQ0QwoGWbtLuf0oWIdmIpVjKe7O2x,A3fsA9Zfv1X2fVEQhTw51lKENdNrEqT3,7,4,3,0,2,0,2,0,11,1.5714285714285714,1,0.0,0,3,0,2,4,0,0,2,0,5,6,1
6687,145494,ySy2zYThCkVZr5MjEXuKxq60wfOynxkJ,bWdj2GDclj5ofokWjzoa5jAwMkxCykd6,1,0,0,0,0,0,1,0,1,0.14285714285714285,1,0.0,0,0,0,0,0,0,0,1,0,0,1,1
6688,145496,zhoGGW9mWTf0e7saIpd0Zh4kN5TE5GWq,SpATywNh6bZuzm8s1ceuBUnMUAeoAHHw,10,8,2,0,1,0,7,0,18,2.5714285714285716,1,0.0,0,2,0,1,8,0,0,7,0,3,15,1
6689,145522,vbUXBKy2vKu4AOOOd2rJki0btGiFQNDk,G8EPVSXsOYB5YQWZGiz1aVq5Pgr2GrQu,1,0,0,0,0,0,1,0,1,0.14285714285714285,1,0.0,0,0,0,0,0,0,0,1,0,0,1,1
6690,145525,x9kyeNXnVmIKLkyrDIOwE7AbD5ZpbAEs,RXDvfPUBYFlVdlueBFbLW0mhhAyGEqpt,1,0,0,0,0,0,1,0,1,0.14285714285714285,1,0.0,0,0,0,0,0,0,0,1,0,0,1,1
6691,145547,rT3zpA0g6rjJ1jZXfn6mCIcHmMcmU756,7GRhBDsirIGkRZBtSMEzNTyDr2JQm4xx,4,2,0,0,0,0,2,0,4,0.5714285714285714,1,0.0,0,0,0,0,2,0,0,2,0,0,4,0
6692,145608,3kzqQ9nu0puySXndbv8HvzuMPwBlBjfc,7GRhBDsirIGkRZBtSMEzNTyDr2JQm4xx,13,8,4,13,3,4,11,0,43,6.142857142857143,1,0.0,2,4,10,3,6,4,3,11,0,19,24,1
6693,145622,520kTOJ5a6HoTMe30flreSub2cyQqOhY,7GRhBDsirIGkRZBtSMEzNTyDr2JQm4xx,12,11,3,6,6,0,1,0,27,3.857142857142857,1,0.0,6,3,5,6,5,0,1,1,0,20,7,1
6694,146593,dnF4V3J1QcZ16kz7ecUJEPAkM9rOV7wb,7GRhBDsirIGkRZBtSMEzNTyDr2JQm4xx,1,0,0,0,0,0,1,0,1,0.14285714285714285,1,0.0,0,0,0,0,0,0,0,1,0,0,1,1
6695,146916,nC3nlEcInfZBkfWiBAFT0QImutSJIRDp,RXDvfPUBYFlVdlueBFbLW0mhhAyGEqpt,1,0,0,0,0,0,1,0,1,0.14285714285714285,1,0.0,0,0,0,0,0,0,0,1,0,0,1,1
6696,146924,gNoniBDFX51Yjk2gJg2vMlrLeNPSUasm,G8EPVSXsOYB5YQWZGiz1aVq5Pgr2GrQu,1,0,0,0,0,0,2,0,2,0.2857142857142857,1,0.0,0,0,0,0,0,0,0,2,0,0,2,1
6697,146944,w8NrkUwgMqb3O2jCUrmWBqs2yypNb8dq,RXDvfPUBYFlVdlueBFbLW0mhhAyGEqpt,18,28,3,28,1,0,11,0,71,10.142857142857142,3,0.0,3,3,26,1,25,0,2,11,0,33,38,1
6698,147012,T9AvdYMob6A7XymtAVQOWMZ2VKIDwWSx,RXDvfPUBYFlVdlueBFbLW0mhhAyGEqpt,2,0,0,0,0,0,2,0,2,0.2857142857142857,2,0.0,0,0,0,0,0,0,0,2,0,0,2,1
6699,147075,wVwBkRoAPUoV5PewFP4svSYnl1ZXoHnc,G8EPVSXsOYB5YQWZGiz1aVq5Pgr2GrQu,1,0,0,0,0,0,1,0,1,0.14285714285714285,1,0.0,0,0,0,0,0,0,0,1,0,0,1,1
6700,147096,MZsWffL53WPYhfyCR8aX3Mp9egHMC4ie,RXDvfPUBYFlVdlueBFbLW0mhhAyGEqpt,1,0,0,0,0,0,1,0,1,0.14285714285714285,1,0.0,0,0,0,0,0,0,0,1,0,0,1,1
6701,147103,114X1vLT3OTzchhxfRGg24FTsgrs6Boi,RXDvfPUBYFlVdlueBFbLW0mhhAyGEqpt,1,0,0,0,0,0,2,0,2,0.2857142857142857,1,0.0,0,0,0,0,0,0,0,2,0,0,2,1
6702,147112,sL5jw3pLWZoRI7avI17oM60mfF67Acgz,G8EPVSXsOYB5YQWZGiz1aVq5Pgr2GrQu,1,0,0,0,0,0,2,0,2,0.2857142857142857,2,0.0,0,0,0,0,0,0,0,2,0,0,2,0
6703,147144,a91ewPLjlp1X8KqwrnZISs7xgERRXuh7,RXDvfPUBYFlVdlueBFbLW0mhhAyGEqpt,1,0,0,0,0,0,1,0,1,0.14285714285714285,1,0.0,0,0,0,0,0,0,0,1,0,0,1,1
6704,147223,uUyznY5p2fw7hVKlngBtP5z29uUZt16H,RXDvfPUBYFlVdlueBFbLW0mhhAyGEqpt,1,0,0,0,0,0,1,0,1,0.14285714285714285,1,0.0,0,0,0,0,0,0,0,1,0,0,1,1
6705,147232,bkdCLvSthS1MubyKzxMCvPKPGG70pOZC,G8EPVSXsOYB5YQWZGiz1aVq5Pgr2GrQu,1,0,0,0,0,0,1,0,1,0.14285714285714285,1,0.0,0,0,0,0,0,0,0,1,0,0,1,0
6706,147287,yB2j2tPO2DVKCBBdsLv8a1lbHtfWINMh,RXDvfPUBYFlVdlueBFbLW0mhhAyGEqpt,1,0,0,0,0,0,1,0,1,0.14285714285714285,1,0.0,0,0,0,0,0,0,0,1,0,0,1,1
6707,147309,UfUYHtn7EFCFULfAAiVnfhKrcOfMt4Ug,G8EPVSXsOYB5YQWZGiz1aVq5Pgr2GrQu,1,0,0,0,0,0,1,0,1,0.14285714285714285,1,0.0,0,0,0,0,0,0,0,1,0,0,1,1
6708,147318,GONTKb318b2pNzO4RSf2Oav2TmqJo6yi,G8EPVSXsOYB5YQWZGiz1aVq5Pgr2GrQu,1,0,0,0,0,0,1,0,1,0.14285714285714285,1,0.0,0,0,0,0,0,0,0,1,0,0,1,1
6709,147344,fE8AsLCA0TCwN2lFIpEAgt949Oz2zi2M,G8EPVSXsOYB5YQWZGiz1aVq5Pgr2GrQu,1,0,0,0,0,0,1,0,1,0.14285714285714285,1,0.0,0,0,0,0,0,0,0,1,0,0,1,1
6710,147349,hRH67nWa9zgJtoi4yrmT3KmNMJoVcNRr,G8EPVSXsOYB5YQWZGiz1aVq5Pgr2GrQu,1,0,0,0,0,0,1,0,1,0.14285714285714285,1,0.0,0,0,0,0,0,0,0,1,0,0,1,1
6711,147376,aBcd5xuaSGFcCFUKcCSjEaSoJEfIPYAN,G8EPVSXsOYB5YQWZGiz1aVq5Pgr2GrQu,1,0,0,0,0,0,1,0,1,0.14285714285714285,1,0.0,0,0,0,0,0,0,0,1,0,0,1,1
6712,147407,SVxtFny9oPYbtoixSK2PAs9XNkM3e8hn,RXDvfPUBYFlVdlueBFbLW0mhhAyGEqpt,12,11,1,2,3,0,6,1,24,3.4285714285714284,2,0.0,4,1,2,3,7,0,0,6,1,10,14,1
6713,147416,Wi6NsYPSasqtq71046KwRwCUoJ7gSxqZ,G8EPVSXsOYB5YQWZGiz1aVq5Pgr2GrQu,29,37,21,44,0,25,21,2,150,21.428571428571427,2,0.0,11,21,30,0,26,25,14,21,2,62,88,1
6714,147480,SLkozwcHBufe0UPB64m4o1Ao551WfuNu,G8EPVSXsOYB5YQWZGiz1aVq5Pgr2GrQu,1,0,0,0,0,0,1,0,1,0.14285714285714285,1,0.0,0,0,0,0,0,0,0,1,0,0,1,1
6715,147501,Rw0pJvwCeS9P2HJebYz4vjMvliFwRI8o,G8EPVSXsOYB5YQWZGiz1aVq5Pgr2GrQu,9,2,1,0,1,0,7,2,13,1.8571428571428572,2,0.0,0,1,0,1,2,0,0,7,2,2,11,1
6716,147517,t3323TFWjEAQScP83AS7oMF9sZ2WNapI,G8EPVSXsOYB5YQWZGiz1aVq5Pgr2GrQu,1,0,0,0,0,0,1,0,1,0.14285714285714285,1,0.0,0,0,0,0,0,0,0,1,0,0,1,1
6717,147588,USLTnsAwagwK2c83KXd1SNEeENnzkTTo,RXDvfPUBYFlVdlueBFbLW0mhhAyGEqpt,1,0,0,0,0,0,1,0,1,0.14285714285714285,1,0.0,0,0,0,0,0,0,0,1,0,0,1,1
6718,147597,jN2uzyXO5CSzMfW3pp82AVUf4pDPwJuY,RXDvfPUBYFlVdlueBFbLW0mhhAyGEqpt,1,0,0,0,0,0,1,0,1,0.14285714285714285,1,0.0,0,0,0,0,0,0,0,1,0,0,1,1
6719,147600,cvwnd07iniLpbhx37I857HZu05eA9OFE,RXDvfPUBYFlVdlueBFbLW0mhhAyGEqpt,16,24,15,2,5,15,13,2,76,10.857142857142858,2,0.0,1,15,2,5,23,15,0,13,2,23,53,1
6720,147610,xLkdbbKQJbd2pVZCFImtrA3GPATvYGgD,G8EPVSXsOYB5YQWZGiz1aVq5Pgr2GrQu,1,0,0,0,0,0,1,0,1,0.14285714285714285,1,0.0,0,0,0,0,0,0,0,1,0,0,1,1
6721,147639,MU6JKjzSFjezaWPFdc0IJW3L2fftgaQZ,RXDvfPUBYFlVdlueBFbLW0mhhAyGEqpt,1,0,0,0,0,0,1,0,1,0.14285714285714285,1,0.0,0,0,0,0,0,0,0,1,0,0,1,1
6722,147658,htYzFBi86rzWlzEtyu7aNqTtL2SW6jzn,G8EPVSXsOYB5YQWZGiz1aVq5Pgr2GrQu,1,0,0,0,0,0,1,0,1,0.14285714285714285,1,0.0,0,0,0,0,0,0,0,1,0,0,1,1
6723,147673,5kCR1wjWWz9eEHdizA4crFyxKTH4mIdl,RXDvfPUBYFlVdlueBFbLW0mhhAyGEqpt,1,0,0,0,0,0,1,0,1,0.14285714285714285,1,0.0,0,0,0,0,0,0,0,1,0,0,1,1
6724,147711,Z96ghDF2SEO6eJyjMUuyfBwUaW4sni8D,G8EPVSXsOYB5YQWZGiz1aVq5Pgr2GrQu,11,21,3,4,3,0,4,1,36,5.142857142857143,2,0.0,11,3,2,3,10,0,2,4,1,19,17,1
6725,147717,i4fgy4BVHlpEBMVrUkI9gWLihOonqgFN,G8EPVSXsOYB5YQWZGiz1aVq5Pgr2GrQu,15,13,4,16,2,2,9,1,47,6.714285714285714,3,0.0,5,4,14,2,8,2,2,9,1,25,22,1
6726,147725,DJXPEOqclxMbkJva0g6MJfihz48JHIVn,G8EPVSXsOYB5YQWZGiz1aVq5Pgr2GrQu,1,0,0,0,0,0,1,0,1,0.14285714285714285,1,0.0,0,0,0,0,0,0,0,1,0,0,1,1
6727,147730,J5FkxM9o8L4y51xbaKwQjZuay8KpJMzH,G8EPVSXsOYB5YQWZGiz1aVq5Pgr2GrQu,1,0,0,0,0,0,1,0,1,0.14285714285714285,1,0.0,0,0,0,0,0,0,0,1,0,0,1,1
6728,147737,eXv6ACzt62C4hMSoDSIQMvmz4LEnGBtm,G8EPVSXsOYB5YQWZGiz1aVq5Pgr2GrQu,1,0,0,0,0,0,1,0,1,0.14285714285714285,1,0.0,0,0,0,0,0,0,0,1,0,0,1,1
6729,147759,pFE82fh5DH8NUVtvV1y83suNQP2lNeAe,fbPkOYLVPtPgIt0MxizjfFJov3JbHyAi,6,3,2,0,2,0,1,0,8,1.1428571428571428,1,0.0,0,2,0,2,3,0,0,1,0,4,4,1
6730,147774,GwBsELCYAYNo2pcJ3Hwab6UtiG3ye1Qj,fbPkOYLVPtPgIt0MxizjfFJov3JbHyAi,6,3,2,0,2,0,1,0,8,1.1428571428571428,1,0.0,0,2,0,2,3,0,0,1,0,4,4,1
6731,148334,7gxdF7npc77h7z0KnU9ezGYqtBJqY4fQ,7GRhBDsirIGkRZBtSMEzNTyDr2JQm4xx,10,3,2,0,2,3,6,2,18,2.5714285714285716,1,0.0,0,2,0,2,3,3,0,6,2,4,14,0
6732,148351,UuZ3VzxMOcv1pgBQfP1NUeudFRRQ1mRU,fbPkOYLVPtPgIt0MxizjfFJov3JbHyAi,8,3,2,0,2,0,4,0,11,1.5714285714285714,1,0.0,0,2,0,2,3,0,0,4,0,4,7,1
6733,148352,jHtmhjYvIQCrHvgDxRflQ5IxXJSVFYuQ,fbPkOYLVPtPgIt0MxizjfFJov3JbHyAi,3,2,0,0,0,0,1,0,3,0.42857142857142855,1,0.0,0,0,0,0,2,0,0,1,0,0,3,1
6734,148354,l20aBHleNKjK0XwZQWFPyPJB0cuojdw9,fbPkOYLVPtPgIt0MxizjfFJov3JbHyAi,5,2,1,0,1,0,4,0,8,1.1428571428571428,1,0.0,0,1,0,1,2,0,0,4,0,2,6,1
6735,148355,8PiAS0TmnQl9QEf7dgpgPmWaNztmfJVP,fbPkOYLVPtPgIt0MxizjfFJov3JbHyAi,9,7,4,0,4,0,3,0,18,2.5714285714285716,1,0.0,2,4,0,4,5,0,0,3,0,10,8,1
6736,148356,1FMoEHMl48zOO2kttHN9vLOQurH54seC,fbPkOYLVPtPgIt0MxizjfFJov3JbHyAi,6,7,3,0,2,0,4,0,16,2.2857142857142856,1,0.0,0,3,0,2,7,0,0,4,0,5,11,1
6737,148357,fyc4dkjFagB2LcZciRyqSJPoegzypBzy,fbPkOYLVPtPgIt0MxizjfFJov3JbHyAi,6,5,3,0,2,0,3,0,13,1.8571428571428572,1,0.0,0,3,0,2,5,0,0,3,0,5,8,1
6738,148359,uZ1O39GxSmePAndNprQEBYYChQSQNkhB,fbPkOYLVPtPgIt0MxizjfFJov3JbHyAi,15,13,8,8,6,0,2,0,37,5.285714285714286,1,0.0,2,8,6,6,11,0,2,2,0,22,15,1
6739,148360,wJP9G4aa97RALoz7jgfom2Is1dozR5XV,fbPkOYLVPtPgIt0MxizjfFJov3JbHyAi,8,7,5,0,3,0,2,0,17,2.4285714285714284,1,0.0,0,5,0,3,7,0,0,2,0,8,9,1
6740,148361,X0S4TDZgj5AsEY7rj0bHgFBmM1wEHl8g,fbPkOYLVPtPgIt0MxizjfFJov3JbHyAi,5,2,1,0,1,0,3,0,7,1.0,1,0.0,0,1,0,1,2,0,0,3,0,2,5,1
6741,148362,zo3To03Q5Rdok3x4Zu1wNdsKqNDBlzyd,fbPkOYLVPtPgIt0MxizjfFJov3JbHyAi,7,3,2,0,2,0,4,0,11,1.5714285714285714,1,0.0,0,2,0,2,3,0,0,4,0,4,7,1
6742,148363,mvWG8WfFoikkAB9Wg1mtbCZJVje4NMeg,fbPkOYLVPtPgIt0MxizjfFJov3JbHyAi,2,0,0,0,0,2,1,0,3,0.42857142857142855,1,0.0,0,0,0,0,0,2,0,1,0,0,3,1
6743,148364,8TsC1FJM6vJWYXxMn4XOpAyFu9uyBcwT,fbPkOYLVPtPgIt0MxizjfFJov3JbHyAi,3,0,0,0,0,0,3,0,3,0.42857142857142855,1,0.0,0,0,0,0,0,0,0,3,0,0,3,1
6744,148365,lQTp6SekPVZwhVL0coTG7jI0NerwwRXX,fbPkOYLVPtPgIt0MxizjfFJov3JbHyAi,1,0,0,0,0,0,1,0,1,0.14285714285714285,1,0.0,0,0,0,0,0,0,0,1,0,0,1,1
6745,148369,BZslXVbbVc1YaW2k5ccBUS6eiDl1WM07,fbPkOYLVPtPgIt0MxizjfFJov3JbHyAi,5,4,1,0,1,0,5,0,11,1.5714285714285714,1,0.0,2,1,0,1,2,0,0,5,0,4,7,1
6746,148370,O3TF3GdRfaqFBn0EbABVcwycS92XFqQI,fbPkOYLVPtPgIt0MxizjfFJov3JbHyAi,8,2,1,0,1,0,4,1,9,1.2857142857142858,1,0.0,0,1,0,1,2,0,0,4,1,2,7,1
6747,148372,RVf6e28k6GsRGb8DN1lRFhzAihWj6uwr,fbPkOYLVPtPgIt0MxizjfFJov3JbHyAi,6,6,1,0,2,0,2,0,11,1.5714285714285714,1,0.0,3,1,0,2,3,0,0,2,0,6,5,1
6748,148373,ajZe5IV50P9q1MwLuSJJxiEXkVsZl5Va,fbPkOYLVPtPgIt0MxizjfFJov3JbHyAi,9,4,2,0,3,0,2,0,11,1.5714285714285714,1,0.0,0,2,0,3,4,0,0,2,0,5,6,1
6749,148374,SkGT6P4CYkjpyqSl3XDsa9OtVYpbNLKc,fbPkOYLVPtPgIt0MxizjfFJov3JbHyAi,5,2,1,0,1,0,2,0,6,0.8571428571428571,1,0.0,0,1,0,1,2,0,0,2,0,2,4,1
6750,148376,OektSQ9TNN3cEy3ZKuUs35c7BdSOqtaQ,fbPkOYLVPtPgIt0MxizjfFJov3JbHyAi,6,5,3,0,2,0,5,0,15,2.142857142857143,1,0.0,0,3,0,2,5,0,0,5,0,5,10,1
6751,148377,9DQIIj4A47ahx19xY3qY5HPiF8T9NzKd,fbPkOYLVPtPgIt0MxizjfFJov3JbHyAi,5,3,1,0,1,0,2,0,7,1.0,1,0.0,0,1,0,1,3,0,0,2,0,2,5,1
6752,148380,mmXnUf3Xp68sXzzvqqAwsEL8YCYNkHx6,fbPkOYLVPtPgIt0MxizjfFJov3JbHyAi,9,4,3,0,3,0,5,0,15,2.142857142857143,1,0.0,0,3,0,3,4,0,0,5,0,6,9,1
6753,148386,3J1rNe3uRvedZitqeCdyMGosrBYsQChl,fbPkOYLVPtPgIt0MxizjfFJov3JbHyAi,5,2,1,0,1,0,2,0,6,0.8571428571428571,1,0.0,0,1,0,1,2,0,0,2,0,2,4,0
6754,148387,LZ4FjsgtwzNif1KtUcVyAos1pH68eZ72,fbPkOYLVPtPgIt0MxizjfFJov3JbHyAi,1,0,0,0,0,0,1,0,1,0.14285714285714285,1,0.0,0,0,0,0,0,0,0,1,0,0,1,1
6755,148389,CSh5hGbaSFu2yCb31iVMOVwKocrH471Q,fbPkOYLVPtPgIt0MxizjfFJov3JbHyAi,5,2,1,0,1,0,2,0,6,0.8571428571428571,1,0.0,0,1,0,1,2,0,0,2,0,2,4,1
6756,148694,XydvMA0BgL1Al10q3L0D2wz1Y6wVb2rC,bWdj2GDclj5ofokWjzoa5jAwMkxCykd6,11,13,8,0,6,0,4,1,32,4.571428571428571,1,0.0,2,8,0,6,11,0,0,4,1,16,16,0
6757,148830,9Se0fuNtnF0aDoUMyiU1YG9IfxiIm4MD,SpATywNh6bZuzm8s1ceuBUnMUAeoAHHw,3,0,0,0,0,0,3,0,3,0.42857142857142855,1,0.0,0,0,0,0,0,0,0,3,0,0,3,1
6758,148843,El7h5k9dEnkCTNiRD6ocpDGK1aq9r5Q4,SpATywNh6bZuzm8s1ceuBUnMUAeoAHHw,13,16,0,8,0,6,9,1,40,5.714285714285714,1,0.0,3,0,7,0,13,6,1,9,1,10,30,1
6759,148853,GMzSpgZQ6jzVsfHn8W8i83JsYNxnP00b,SpATywNh6bZuzm8s1ceuBUnMUAeoAHHw,15,21,9,18,7,0,3,0,58,8.285714285714286,2,0.0,8,9,15,7,13,0,3,3,0,39,19,0
6760,148855,i7oHLg2mT287Keuj3rMh6YGhkeP2LXJu,SpATywNh6bZuzm8s1ceuBUnMUAeoAHHw,9,16,5,12,0,0,3,0,36,5.142857142857143,1,0.0,6,5,10,0,10,0,2,3,0,21,15,0
6761,148972,nCi2pdM7sw91EDGAoZtmNoRGljKaB4FL,SpATywNh6bZuzm8s1ceuBUnMUAeoAHHw,12,23,9,23,5,0,1,0,61,8.714285714285714,1,0.0,13,9,19,5,10,0,4,1,0,46,15,0
6762,149077,tvs2CHlzCZXNqvPsCXS6KuyuottEQsCw,A3fsA9Zfv1X2fVEQhTw51lKENdNrEqT3,7,3,1,0,1,3,4,1,13,1.8571428571428572,1,0.0,0,1,0,1,3,3,0,4,1,2,11,1
6763,149087,SneRH8JK6KCMhHOEHp7Zi9NRJB5DLBI8,SpATywNh6bZuzm8s1ceuBUnMUAeoAHHw,10,14,1,5,1,6,2,0,29,4.142857142857143,1,0.0,6,1,4,1,8,6,1,2,0,12,17,1
6764,149109,5is3QPvmCTb2wCYPovTArJero2U5eHRU,SpATywNh6bZuzm8s1ceuBUnMUAeoAHHw,14,27,9,24,0,10,10,1,81,11.571428571428571,3,0.0,14,9,19,0,13,10,5,10,1,42,39,0
6765,149169,SG7N8DhpCuhIu06IIzLX0CSolbyIDsIx,A3fsA9Zfv1X2fVEQhTw51lKENdNrEqT3,1,0,0,0,0,0,1,0,1,0.14285714285714285,1,0.0,0,0,0,0,0,0,0,1,0,0,1,1
6766,149303,qVL008tAQyHTveNNTUZJN2fiJMviNw9f,A3fsA9Zfv1X2fVEQhTw51lKENdNrEqT3,11,10,0,0,1,12,6,1,30,4.285714285714286,1,0.0,0,0,0,1,10,12,0,6,1,1,29,1
6767,149416,PFJhF2sNLYftHHb21pjL43RM5viviTlT,SpATywNh6bZuzm8s1ceuBUnMUAeoAHHw,13,17,8,8,4,0,1,0,38,5.428571428571429,1,0.0,5,8,8,4,12,0,0,1,0,25,13,0
6768,149431,I45Q3yivyiRN2kHVhbV8bUCfrXvtpUvU,SpATywNh6bZuzm8s1ceuBUnMUAeoAHHw,12,7,4,8,3,0,1,0,23,3.2857142857142856,1,0.0,2,4,8,3,5,0,0,1,0,17,6,0
6769,149492,Ev6KS9MaK9gTGqPDnT9PUK5kybHZnCjh,RXDvfPUBYFlVdlueBFbLW0mhhAyGEqpt,24,41,19,21,12,15,18,3,129,18.428571428571427,2,0.0,0,19,15,12,41,15,6,18,3,46,83,1
6770,149526,CW7Zlsz0NoDYd7q0tu1Krgi9b7wpQUwQ,bWdj2GDclj5ofokWjzoa5jAwMkxCykd6,16,15,7,26,4,9,14,1,76,10.857142857142858,2,0.0,4,7,25,4,11,9,1,14,1,40,36,0
6771,149534,M6hmghWj9c26PhfYNN6D8AlzAKngSx0i,SpATywNh6bZuzm8s1ceuBUnMUAeoAHHw,1,0,1,0,0,0,0,0,1,0.14285714285714285,1,0.0,0,1,0,0,0,0,0,0,0,1,0,0
6772,149612,dhNL51CrFkHxhMt1kiIq7Iu6BdYInJEB,RXDvfPUBYFlVdlueBFbLW0mhhAyGEqpt,20,34,2,8,1,21,7,15,88,12.571428571428571,3,0.0,0,2,7,1,34,21,1,7,15,10,78,1
6773,149665,0k9erSYQLRK4wIQFPxo1tbDP6EMqZIo0,A3fsA9Zfv1X2fVEQhTw51lKENdNrEqT3,39,12,10,56,9,3,16,1,107,15.285714285714286,1,0.0,2,10,51,9,10,3,5,16,1,72,35,1
6774,149743,E7Frt6tr6owhsgLSRkD2PqDaTSKmNLId,RXDvfPUBYFlVdlueBFbLW0mhhAyGEqpt,1,0,0,0,0,0,1,0,1,0.14285714285714285,1,0.0,0,0,0,0,0,0,0,1,0,0,1,1
6775,149764,nKMPTOF6v1sp7aVmO78zmSRg9f9QXrTf,bWdj2GDclj5ofokWjzoa5jAwMkxCykd6,17,38,20,20,9,6,14,3,110,15.714285714285714,3,0.0,6,20,18,9,32,6,2,14,3,53,57,0
6776,149820,iSiPEDuhdTDGTEOpkEJzXCeneTDhblqT,A3fsA9Zfv1X2fVEQhTw51lKENdNrEqT3,9,6,4,0,3,0,1,0,14,2.0,1,0.0,0,4,0,3,6,0,0,1,0,7,7,1
6777,149821,j7cR8MulZ7sIljFq9IIvuWVX0W2fGIFM,SpATywNh6bZuzm8s1ceuBUnMUAeoAHHw,16,18,7,14,3,7,8,0,57,8.142857142857142,3,0.0,3,7,11,3,15,7,3,8,0,24,33,0
6778,149848,C8zDhaG0vPsQegBtS55u3JZHiYuueFnE,RXDvfPUBYFlVdlueBFbLW0mhhAyGEqpt,9,12,2,0,2,0,4,0,20,2.857142857142857,2,0.0,0,2,0,2,12,0,0,4,0,4,16,1
6779,149938,zEQiQScIpc1hSOgBtA0a2snrDFq0NA2H,SpATywNh6bZuzm8s1ceuBUnMUAeoAHHw,10,14,4,20,1,0,3,0,42,6.0,1,0.0,9,4,17,1,5,0,3,3,0,31,11,1
6780,150005,D5IkCYseUCO88GE1B1rMaRAAZyqCPk5T,SpATywNh6bZuzm8s1ceuBUnMUAeoAHHw,10,49,2,0,1,8,15,2,77,11.0,2,0.0,14,2,0,1,35,8,0,15,2,17,60,0
6781,150034,dU7DqQeRV0VJw1owh3rH0rASxy6mSG05,RXDvfPUBYFlVdlueBFbLW0mhhAyGEqpt,7,3,2,0,2,2,2,0,11,1.5714285714285714,1,0.0,0,2,0,2,3,2,0,2,0,4,7,1
6782,150105,G2qtWwR1edRN2N5qfu1AgRch8m00Htg9,SpATywNh6bZuzm8s1ceuBUnMUAeoAHHw,12,11,3,8,3,9,1,0,35,5.0,1,0.0,3,3,8,3,8,9,0,1,0,17,18,1
6783,152855,GPbq86k98Rz9tUbijEEopIymy9u0Fcyf,7GRhBDsirIGkRZBtSMEzNTyDr2JQm4xx,1,0,0,0,0,0,1,0,1,0.14285714285714285,1,0.0,0,0,0,0,0,0,0,1,0,0,1,1
6784,152931,bKVslXuzEQ1pv4c6iV5mVjs6X6avUbmL,7GRhBDsirIGkRZBtSMEzNTyDr2JQm4xx,31,50,18,60,13,0,4,0,145,20.714285714285715,2,0.0,21,18,51,13,29,0,9,4,0,103,42,1
6785,153264,yN30P4SLRbmDewtu5A5YdbrNC6oNgNQn,SpATywNh6bZuzm8s1ceuBUnMUAeoAHHw,4,2,1,0,1,0,2,0,6,0.8571428571428571,1,0.0,0,1,0,1,2,0,0,2,0,2,4,1
6786,153326,AZlc6zt0IWDCnhebkR8dcDm8Jn7On2BO,G8EPVSXsOYB5YQWZGiz1aVq5Pgr2GrQu,3,0,0,0,0,27,8,0,35,5.0,1,0.0,0,0,0,0,0,27,0,8,0,0,35,1
6787,153509,EzJJd1vaXRdhAvKq2Q0XoWVWiA4HWk5i,bWdj2GDclj5ofokWjzoa5jAwMkxCykd6,7,4,1,6,1,0,4,0,16,2.2857142857142856,1,0.0,1,1,4,1,3,0,2,4,0,7,9,1
6788,153514,63urTnMQ6906ju0tncFpKl8xLgyyTd5d,SpATywNh6bZuzm8s1ceuBUnMUAeoAHHw,6,4,1,0,1,0,2,0,8,1.1428571428571428,1,0.0,0,1,0,1,4,0,0,2,0,2,6,1
6789,153667,htua1xywlnpsMMY7EJSOsurL86GI912X,SpATywNh6bZuzm8s1ceuBUnMUAeoAHHw,16,22,10,12,4,2,5,1,56,8.0,1,0.0,8,10,9,4,14,2,3,5,1,31,25,1
6790,153676,rMQIZQBxSTMFTRmvcfmpoYqCAUhMol3Y,bWdj2GDclj5ofokWjzoa5jAwMkxCykd6,14,33,1,58,4,2,17,8,123,17.571428571428573,2,0.0,12,1,54,4,21,2,4,17,8,71,52,0
6791,153696,kQrbauxiC7YRwJ9kMbwlTSfqUjp3UrEF,SpATywNh6bZuzm8s1ceuBUnMUAeoAHHw,8,4,2,0,2,0,2,0,10,1.4285714285714286,1,0.0,0,2,0,2,4,0,0,2,0,4,6,1
6792,153765,JTN1G4IwNqBxpxjKApCtLeoFv6NT4I58,SpATywNh6bZuzm8s1ceuBUnMUAeoAHHw,16,24,8,18,4,10,8,1,73,10.428571428571429,2,0.0,10,8,15,4,14,10,3,8,1,37,36,1
6793,153819,HkcPmWCSdk3INCYsquWGQGZKijdTCD0w,SpATywNh6bZuzm8s1ceuBUnMUAeoAHHw,13,9,0,8,0,3,8,1,29,4.142857142857143,2,0.0,2,0,7,0,7,3,1,8,1,9,20,1
6794,153892,d2NzzaJnxOD8hORDU0JQIrwAo12srVeO,SpATywNh6bZuzm8s1ceuBUnMUAeoAHHw,10,9,4,0,3,12,15,7,50,7.142857142857143,2,0.0,0,4,0,3,9,12,0,15,7,7,43,1
6795,153950,4IJ56QlJSL8avuRQEkrBcEyhUIO3LIP3,A3fsA9Zfv1X2fVEQhTw51lKENdNrEqT3,1,0,0,0,0,0,1,0,1,0.14285714285714285,1,0.0,0,0,0,0,0,0,0,1,0,0,1,0
6796,153951,QcAEBwtOda13Q2hwEpOzUuFeV6Y52Ggz,SpATywNh6bZuzm8s1ceuBUnMUAeoAHHw,11,17,1,20,0,0,3,0,41,5.857142857142857,1,0.0,9,1,17,0,8,0,3,3,0,27,14,1
6797,153990,wUS4QMZENKgcJOovrFGfoZniw3fDJWWg,SpATywNh6bZuzm8s1ceuBUnMUAeoAHHw,4,2,1,0,1,0,1,0,5,0.7142857142857143,1,0.0,0,1,0,1,2,0,0,1,0,2,3,0
6798,154002,oO8PkmS40wsHMDT2LhD46mYGdAQ8FooI,bWdj2GDclj5ofokWjzoa5jAwMkxCykd6,14,15,4,48,5,3,4,0,79,11.285714285714286,1,0.0,8,4,45,5,7,3,3,4,0,62,17,1
6799,154104,9Jy1wR1kNKfVIlzkWjf6DnrfYfDGnPzT,SpATywNh6bZuzm8s1ceuBUnMUAeoAHHw,18,22,13,12,9,16,8,1,81,11.571428571428571,2,0.0,7,13,12,9,15,16,0,8,1,41,40,0
6800,154200,ADL0cXowUMs4wyiAOHKMOrtTHu5tmUqi,bWdj2GDclj5ofokWjzoa5jAwMkxCykd6,12,10,7,0,5,3,9,1,35,5.0,3,0.0,0,7,0,5,10,3,0,9,1,12,23,1
6801,154221,1L7XwCOwn8nIJFjaEmGoI47SzrXbe8CM,SpATywNh6bZuzm8s1ceuBUnMUAeoAHHw,16,19,1,20,1,13,12,2,68,9.714285714285714,2,0.0,6,1,16,1,13,13,4,12,2,24,44,0
6802,154253,QweH7yTZRdri03OUSokKH99D0caZDv7H,7GRhBDsirIGkRZBtSMEzNTyDr2JQm4xx,7,4,1,0,2,1,3,0,11,1.5714285714285714,1,0.0,2,1,0,2,2,1,0,3,0,5,6,1
6803,154284,QCIxkwrtd7EyHnigeiQpqn6l0kVuCgK4,7GRhBDsirIGkRZBtSMEzNTyDr2JQm4xx,9,6,2,0,1,2,6,1,18,2.5714285714285716,1,0.0,0,2,0,1,6,2,0,6,1,3,15,1
6804,154301,Q95csmmf8N84WQQSbOMc5rN6dm3wzDuG,SpATywNh6bZuzm8s1ceuBUnMUAeoAHHw,10,20,1,11,1,2,4,0,39,5.571428571428571,1,0.0,0,1,9,1,20,2,2,4,0,11,28,0
6805,154314,ulqdtzoaFKnUas51E4T9qwtZYnxyLzzg,7GRhBDsirIGkRZBtSMEzNTyDr2JQm4xx,3,0,0,0,0,0,9,0,9,1.2857142857142858,1,0.0,0,0,0,0,0,0,0,9,0,0,9,1
6806,154361,Zz1hYW3bIv4cloYkUjUfNR6Tk0kO8ZBM,7GRhBDsirIGkRZBtSMEzNTyDr2JQm4xx,1,0,0,0,0,0,1,0,1,0.14285714285714285,1,0.0,0,0,0,0,0,0,0,1,0,0,1,1
6807,154367,EqDMtLRDV3YTsfyNsZW3gWT7QJ22Zgxb,7GRhBDsirIGkRZBtSMEzNTyDr2JQm4xx,1,0,0,0,0,0,1,0,1,0.14285714285714285,1,0.0,0,0,0,0,0,0,0,1,0,0,1,1
6808,154398,5dFDKTPyqIzDoJ1o2UMmJJhGPtehK3JJ,7GRhBDsirIGkRZBtSMEzNTyDr2JQm4xx,3,0,0,0,0,0,3,0,3,0.42857142857142855,1,0.0,0,0,0,0,0,0,0,3,0,0,3,1
6809,154407,sL5jw3pLWZoRI7avI17oM60mfF67Acgz,SpATywNh6bZuzm8s1ceuBUnMUAeoAHHw,1,0,0,0,0,0,1,0,1,0.14285714285714285,1,0.0,0,0,0,0,0,0,0,1,0,0,1,0
6810,154416,sL5jw3pLWZoRI7avI17oM60mfF67Acgz,A3fsA9Zfv1X2fVEQhTw51lKENdNrEqT3,1,0,0,0,0,0,1,0,1,0.14285714285714285,1,0.0,0,0,0,0,0,0,0,1,0,0,1,0
6811,154427,OykLnAMH2CQ2oGjpNacvJNT6LnoApkhT,7GRhBDsirIGkRZBtSMEzNTyDr2JQm4xx,2,0,0,0,0,0,2,0,2,0.2857142857142857,1,0.0,0,0,0,0,0,0,0,2,0,0,2,1
6812,154448,lhlon92qtIm50z28ydik0v6JhWIxsC1U,7GRhBDsirIGkRZBtSMEzNTyDr2JQm4xx,1,0,0,0,0,0,1,0,1,0.14285714285714285,1,0.0,0,0,0,0,0,0,0,1,0,0,1,1
6813,154474,iZp3ALNWwOETx9Rhz5RySkBkkPAlDqst,7GRhBDsirIGkRZBtSMEzNTyDr2JQm4xx,28,54,16,38,10,9,3,0,130,18.571428571428573,1,0.0,36,16,32,10,18,9,6,3,0,94,36,1
6814,154475,wMQxNrryGKgbGXsy17gJPlh2fJdDvt8s,7GRhBDsirIGkRZBtSMEzNTyDr2JQm4xx,6,3,2,0,2,0,1,0,8,1.1428571428571428,1,0.0,0,2,0,2,3,0,0,1,0,4,4,1
6815,154484,iacqYcgHTn7FZ8NE4roe5kgAUjDF0efr,7GRhBDsirIGkRZBtSMEzNTyDr2JQm4xx,13,11,6,6,5,1,12,1,42,6.0,3,0.0,2,6,5,5,9,1,1,12,1,18,24,1
6816,154517,oT3mLzHF4Tpr8bcFPMHSPaLobLxRQRsd,7GRhBDsirIGkRZBtSMEzNTyDr2JQm4xx,1,0,0,0,0,0,1,0,1,0.14285714285714285,1,0.0,0,0,0,0,0,0,0,1,0,0,1,1
6817,154521,BFTedJpOGn9f3lzS2daZGbUvWzaKCeH4,RXDvfPUBYFlVdlueBFbLW0mhhAyGEqpt,7,2,2,0,2,0,2,0,8,1.1428571428571428,1,0.0,0,2,0,2,2,0,0,2,0,4,4,1
6818,154583,asAtaJoAJHlf2G0ikRIi1BJt6dsbnxvW,7GRhBDsirIGkRZBtSMEzNTyDr2JQm4xx,19,44,2,26,4,0,10,0,86,12.285714285714286,4,0.0,16,2,22,4,28,0,4,10,0,44,42,1
6819,154596,LKQRwZ0wiIjNtxj2rwmRK6v48vwGtrYE,7GRhBDsirIGkRZBtSMEzNTyDr2JQm4xx,1,0,0,0,0,0,1,0,1,0.14285714285714285,1,0.0,0,0,0,0,0,0,0,1,0,0,1,1
6820,154635,futyrc5ZKHBBJxaxN8pRQj4FOD0yyEl8,7GRhBDsirIGkRZBtSMEzNTyDr2JQm4xx,38,107,26,64,36,2,4,0,239,34.142857142857146,3,0.0,42,26,58,36,65,2,6,4,0,162,77,1
6821,154664,wmND65rZOV8Cdq3Mq9MmFLy7XUHHSgIW,7GRhBDsirIGkRZBtSMEzNTyDr2JQm4xx,4,2,1,0,1,0,2,0,6,0.8571428571428571,1,0.0,0,1,0,1,2,0,0,2,0,2,4,1
6822,154665,wmND65rZOV8Cdq3Mq9MmFLy7XUHHSgIW,RXDvfPUBYFlVdlueBFbLW0mhhAyGEqpt,23,22,10,28,5,8,6,0,79,11.285714285714286,1,0.0,4,10,24,5,18,8,4,6,0,43,36,1
6823,154673,Bb6y6KL5R1oXKLejmEf2ogmY60nmHSEg,7GRhBDsirIGkRZBtSMEzNTyDr2JQm4xx,15,19,0,4,0,1,6,0,30,4.285714285714286,1,0.0,4,0,4,0,15,1,0,6,0,8,22,1
6824,154719,bQS9TypVeSJHdaY7Zz5SfbkFkeJ7Xy7P,G8EPVSXsOYB5YQWZGiz1aVq5Pgr2GrQu,11,9,1,0,0,3,9,1,23,3.2857142857142856,1,0.0,0,1,0,0,9,3,0,9,1,1,22,1
6825,154721,JkBKsyFO0Yc8vpbIVFPRsgPENSXQYzwJ,7GRhBDsirIGkRZBtSMEzNTyDr2JQm4xx,7,4,3,0,3,0,3,0,13,1.8571428571428572,1,0.0,0,3,0,3,4,0,0,3,0,6,7,1
6826,154750,9022MHPvnYCQFW4Qbw5KRQ2IXKBbqJc6,7GRhBDsirIGkRZBtSMEzNTyDr2JQm4xx,9,4,3,0,0,6,7,1,21,3.0,1,0.0,0,3,0,0,4,6,0,7,1,3,18,1
6827,154759,9g6cYAmFbDY0CjADcdMWUoQ4H4YvgLXQ,7GRhBDsirIGkRZBtSMEzNTyDr2JQm4xx,1,0,0,0,0,0,1,0,1,0.14285714285714285,1,0.0,0,0,0,0,0,0,0,1,0,0,1,1
6828,154764,BPDxtvSmkKR4nTdKjes8gGxzoOprTkK2,SpATywNh6bZuzm8s1ceuBUnMUAeoAHHw,16,22,12,19,8,8,8,1,78,11.142857142857142,2,0.0,6,12,16,8,16,8,3,8,1,42,36,1
6829,154820,Xf0Og50NXKhKGIY0WPfCy8ERJ7r6XgJl,7GRhBDsirIGkRZBtSMEzNTyDr2JQm4xx,1,0,0,0,0,0,1,0,1,0.14285714285714285,1,0.0,0,0,0,0,0,0,0,1,0,0,1,1
6830,154862,I1340YsGXK2BIG96XRWppOvFniqpKDu7,7GRhBDsirIGkRZBtSMEzNTyDr2JQm4xx,1,0,0,0,0,0,1,0,1,0.14285714285714285,1,0.0,0,0,0,0,0,0,0,1,0,0,1,1
6831,154911,yGvIE15GH4VA1DDC2IJtfMXXasgYhTMz,7GRhBDsirIGkRZBtSMEzNTyDr2JQm4xx,1,0,0,0,0,0,1,0,1,0.14285714285714285,1,0.0,0,0,0,0,0,0,0,1,0,0,1,1
6832,154913,j9DMqIZkavMsFdWoxVo3EuIrdKBeRzf9,RXDvfPUBYFlVdlueBFbLW0mhhAyGEqpt,46,44,24,47,15,5,9,0,144,20.571428571428573,1,0.0,12,24,47,15,32,5,0,9,0,98,46,1
6833,154940,MxhxHMlOpo3bTyeulVXY5tLPOxuKgX9g,RXDvfPUBYFlVdlueBFbLW0mhhAyGEqpt,10,5,4,0,2,2,4,3,20,2.857142857142857,1,0.0,0,4,0,2,5,2,0,4,3,6,14,1
6834,155027,PexOV0LWT1fDCzyfhjsaD6ViAyGfZwtP,SpATywNh6bZuzm8s1ceuBUnMUAeoAHHw,2,0,0,0,0,0,2,0,2,0.2857142857142857,1,0.0,0,0,0,0,0,0,0,2,0,0,2,1
6835,155048,OqBkXI62rrUk2ckZzlCRqJd1hz7KQTiD,7GRhBDsirIGkRZBtSMEzNTyDr2JQm4xx,15,27,1,12,3,0,3,1,47,6.714285714285714,1,0.0,15,1,10,3,12,0,2,3,1,29,18,1
6836,155050,791uZs1oletLjsDrEfx07tDuNe91zVsB,7GRhBDsirIGkRZBtSMEzNTyDr2JQm4xx,7,3,2,0,2,0,2,0,9,1.2857142857142858,1,0.0,0,2,0,2,3,0,0,2,0,4,5,1
6837,155101,JbB7hpnQ5hVzqELznLtzJLRyOZ2rdnyH,A3fsA9Zfv1X2fVEQhTw51lKENdNrEqT3,27,17,9,58,0,19,12,1,116,16.571428571428573,1,0.0,3,9,50,0,14,19,8,12,1,62,54,1
6838,155102,JbB7hpnQ5hVzqELznLtzJLRyOZ2rdnyH,7GRhBDsirIGkRZBtSMEzNTyDr2JQm4xx,4,2,1,0,1,0,1,0,5,0.7142857142857143,1,0.0,0,1,0,1,2,0,0,1,0,2,3,1
6839,155129,t8qBiDTvOvYmrxcVIErRuEOf38tywm6t,7GRhBDsirIGkRZBtSMEzNTyDr2JQm4xx,26,46,22,30,13,36,4,1,152,21.714285714285715,1,0.0,19,22,25,13,27,36,5,4,1,79,73,1
6840,155141,PUySp8Qi7ahosRvBWR6xsbTAmeC3pRdT,SpATywNh6bZuzm8s1ceuBUnMUAeoAHHw,11,27,10,8,2,1,5,0,53,7.571428571428571,3,0.0,4,10,6,2,23,1,2,5,0,22,31,0
6841,155157,YBxdZNwXHdHfvV2eXmAcEoLMgpOYOPHS,7GRhBDsirIGkRZBtSMEzNTyDr2JQm4xx,9,8,5,8,5,0,2,0,28,4.0,1,0.0,3,5,7,5,5,0,1,2,0,20,8,1
6842,155173,JHfmlel9KNxicHtEPCs7j50mTEJgnt8P,7GRhBDsirIGkRZBtSMEzNTyDr2JQm4xx,1,0,0,0,0,0,1,0,1,0.14285714285714285,1,0.0,0,0,0,0,0,0,0,1,0,0,1,1
6843,155247,NfNQzrIJhmgRP7158cjFmvfhx6PtMoIG,7GRhBDsirIGkRZBtSMEzNTyDr2JQm4xx,7,0,0,0,0,2,6,1,9,1.2857142857142858,1,0.0,0,0,0,0,0,2,0,6,1,0,9,1
6844,155268,5WJ9TRmJQHZjCB6N96s5yxRqedfFf2EC,7GRhBDsirIGkRZBtSMEzNTyDr2JQm4xx,5,2,1,0,1,0,2,0,6,0.8571428571428571,1,0.0,0,1,0,1,2,0,0,2,0,2,4,1
6845,155315,2DvkJl9UVozMaO0xGaO2ndEJOUw63HiE,7GRhBDsirIGkRZBtSMEzNTyDr2JQm4xx,4,2,1,0,1,0,1,0,5,0.7142857142857143,1,0.0,0,1,0,1,2,0,0,1,0,2,3,1
6846,155324,Bw1W3aypNX1U28lPbdggaNPof0tcfoYy,7GRhBDsirIGkRZBtSMEzNTyDr2JQm4xx,12,27,7,10,6,0,3,0,53,7.571428571428571,2,0.0,6,7,8,6,21,0,2,3,0,27,26,1
6847,155398,V6OdAS3CbYkwbVZibmDB3Td15gp0rTCi,7GRhBDsirIGkRZBtSMEzNTyDr2JQm4xx,4,2,1,0,1,0,1,0,5,0.7142857142857143,1,0.0,0,1,0,1,2,0,0,1,0,2,3,1
6848,155458,anKy5XeCNcJg717tYlt4WP7NvJptZoH3,RXDvfPUBYFlVdlueBFbLW0mhhAyGEqpt,26,17,16,0,12,0,23,1,69,9.857142857142858,4,0.0,0,16,0,12,17,0,0,23,1,28,41,1
6849,155581,2ZRBFnStzt5cjrck9eS6oYGoTRuicZMh,G8EPVSXsOYB5YQWZGiz1aVq5Pgr2GrQu,9,8,1,0,1,0,2,0,12,1.7142857142857142,1,0.0,0,1,0,1,8,0,0,2,0,2,10,1
6850,155618,s6FY1tnJFeJCup1Eko54ROGWiTGeTtYm,SpATywNh6bZuzm8s1ceuBUnMUAeoAHHw,1,0,0,0,0,0,1,0,1,0.14285714285714285,1,0.0,0,0,0,0,0,0,0,1,0,0,1,0
6851,156083,65WrAm7LwtsX3nVDTLh1bnXt0L79cL04,bWdj2GDclj5ofokWjzoa5jAwMkxCykd6,1,0,0,0,0,0,1,0,1,0.14285714285714285,1,0.0,0,0,0,0,0,0,0,1,0,0,1,0
6852,156248,2rcvhx1rR5YxLdJduMzgm4BAqYgFhtji,G8EPVSXsOYB5YQWZGiz1aVq5Pgr2GrQu,2,0,0,0,0,0,2,0,2,0.2857142857142857,1,0.0,0,0,0,0,0,0,0,2,0,0,2,1
6853,156260,TVPORDuXFZycPf0Vi3wZKRTY1n2f7P3G,A3fsA9Zfv1X2fVEQhTw51lKENdNrEqT3,17,18,7,14,2,14,20,3,78,11.142857142857142,1,0.0,1,7,13,2,17,14,1,20,3,23,55,1
6854,156452,kiukAy7oxipXUU8Ys4wcsL36Pp7URsoj,RXDvfPUBYFlVdlueBFbLW0mhhAyGEqpt,9,8,0,0,0,0,3,0,11,1.5714285714285714,1,0.0,0,0,0,0,8,0,0,3,0,0,11,0
6855,156571,OLSxCkluLildKVrVnzRIsj47tt9tVHj9,RXDvfPUBYFlVdlueBFbLW0mhhAyGEqpt,1,0,0,0,0,0,1,0,1,0.14285714285714285,1,0.0,0,0,0,0,0,0,0,1,0,0,1,1
6856,156708,qzgqMBszLUnJd9ZV8Zyg9x0an59yJyuH,A3fsA9Zfv1X2fVEQhTw51lKENdNrEqT3,46,39,27,64,15,8,19,1,173,24.714285714285715,2,0.0,2,27,57,15,37,8,7,19,1,101,72,1
6857,156757,MOcMwRKo0dtFqZ5xWBgRzquuZGKtQyf4,bWdj2GDclj5ofokWjzoa5jAwMkxCykd6,4,2,1,0,1,0,1,0,5,0.7142857142857143,1,0.0,0,1,0,1,2,0,0,1,0,2,3,1
6858,157338,cOx2ivO0cjd2S3OxGikx2UdSMlRcgy0Q,7GRhBDsirIGkRZBtSMEzNTyDr2JQm4xx,1,0,0,0,0,0,1,0,1,0.14285714285714285,1,0.0,0,0,0,0,0,0,0,1,0,0,1,1
6859,160678,08OTJovI4mN1P4AUjCgqGCGzY3HAu3jj,A3fsA9Zfv1X2fVEQhTw51lKENdNrEqT3,1,0,0,0,0,0,1,0,1,0.14285714285714285,1,0.0,0,0,0,0,0,0,0,1,0,0,1,1
6860,160775,ZgNdO7hyoQRmg00lVh0JR0YxTL2sBLXr,SpATywNh6bZuzm8s1ceuBUnMUAeoAHHw,6,1,1,0,0,0,15,1,18,2.5714285714285716,1,0.0,0,1,0,0,1,0,0,15,1,1,17,0
6861,160837,3f8TEYsxw8fTx61szmPewZsIJHdQMPuP,SpATywNh6bZuzm8s1ceuBUnMUAeoAHHw,15,11,6,12,3,13,11,0,56,8.0,1,0.0,3,6,12,3,8,13,0,11,0,24,32,0
6862,160842,ffjWC7PpsqUyQ4g8h9cR2OgJ4csHrEGY,7GRhBDsirIGkRZBtSMEzNTyDr2JQm4xx,1,0,0,0,0,0,1,0,1,0.14285714285714285,1,0.0,0,0,0,0,0,0,0,1,0,0,1,1
6863,160956,3G8UKlMnri0uMjx4kTUdEFUnuVu9MqyS,7GRhBDsirIGkRZBtSMEzNTyDr2JQm4xx,4,4,1,0,2,0,2,0,9,1.2857142857142858,1,0.0,2,1,0,2,2,0,0,2,0,5,4,1
6864,160963,W4swLEiF6xa4CU1Ee5z4jQMNXyEDiyxR,SpATywNh6bZuzm8s1ceuBUnMUAeoAHHw,4,2,0,0,0,2,2,0,6,0.8571428571428571,1,0.0,0,0,0,0,2,2,0,2,0,0,6,1
6865,160991,fDaxh7N7NdJHdXsnAIuELHd50CNN3hz9,7GRhBDsirIGkRZBtSMEzNTyDr2JQm4xx,2,0,0,0,0,0,2,0,2,0.2857142857142857,1,0.0,0,0,0,0,0,0,0,2,0,0,2,1
6866,161071,kD7KrEgPns8NN7pPH4RunWGvMBAYF6OW,7GRhBDsirIGkRZBtSMEzNTyDr2JQm4xx,4,2,0,0,0,0,3,0,5,0.7142857142857143,1,0.0,0,0,0,0,2,0,0,3,0,0,5,1
6867,161076,BbvGM92sGSMMIrRMXDFdD1GEnySzXRYT,A3fsA9Zfv1X2fVEQhTw51lKENdNrEqT3,1,0,0,0,0,0,1,0,1,0.14285714285714285,1,0.0,0,0,0,0,0,0,0,1,0,0,1,0
6868,161079,JDFQZtkjaBhYZM0MLFNIDJC3MmDM3j4N,SpATywNh6bZuzm8s1ceuBUnMUAeoAHHw,17,16,9,10,4,12,13,1,65,9.285714285714286,3,0.0,5,9,8,4,11,12,2,13,1,26,39,0
6869,161120,bAABlYXwSxLGjyoM2mZWwlEcMoay9TKF,7GRhBDsirIGkRZBtSMEzNTyDr2JQm4xx,34,49,20,36,13,13,25,8,164,23.428571428571427,1,0.0,23,20,33,13,26,13,3,25,8,89,75,1
6870,161146,wKtjicmtXDLrlymiwnuOgL0XJQtQSxfX,7GRhBDsirIGkRZBtSMEzNTyDr2JQm4xx,2,0,0,0,0,0,2,0,2,0.2857142857142857,1,0.0,0,0,0,0,0,0,0,2,0,0,2,1
6871,161208,FgKGJkcyrlk2UGTZTaDtYvcpTKr0lNLA,7GRhBDsirIGkRZBtSMEzNTyDr2JQm4xx,11,12,6,10,4,0,7,0,39,5.571428571428571,2,0.0,4,6,8,4,8,0,2,7,0,22,17,1
6872,161246,B5jlZpEDxUNGCe4UQsaYbJ99Z8y5d2lN,A3fsA9Zfv1X2fVEQhTw51lKENdNrEqT3,1,0,0,0,0,0,1,0,1,0.14285714285714285,1,0.0,0,0,0,0,0,0,0,1,0,0,1,0
6873,161273,vuVnTFCBfdzSvUffWnstx1XETLzOHwWp,SpATywNh6bZuzm8s1ceuBUnMUAeoAHHw,9,10,6,0,5,0,1,0,22,3.142857142857143,1,0.0,0,6,0,5,10,0,0,1,0,11,11,0
6874,161290,jMYQxsCNKY5cLAg44E5z2BIKSAvgdfQc,7GRhBDsirIGkRZBtSMEzNTyDr2JQm4xx,5,2,1,0,1,0,2,0,6,0.8571428571428571,1,0.0,0,1,0,1,2,0,0,2,0,2,4,1
6875,161386,adfbW7xBPY784GRXAIq3fInFogIbD6ro,SpATywNh6bZuzm8s1ceuBUnMUAeoAHHw,15,13,6,8,0,2,9,2,40,5.714285714285714,1,0.0,5,6,7,0,8,2,1,9,2,18,22,0
6876,161412,uqHSgHtPqI0pLXHTpUBns1eF4e9jsvt1,7GRhBDsirIGkRZBtSMEzNTyDr2JQm4xx,1,0,0,0,0,0,1,0,1,0.14285714285714285,1,0.0,0,0,0,0,0,0,0,1,0,0,1,1
6877,161465,QwzgqwSHCQGBlqpFzwe8sYcM8CZG7iZ9,SpATywNh6bZuzm8s1ceuBUnMUAeoAHHw,6,5,1,0,1,0,3,0,10,1.4285714285714286,1,0.0,0,1,0,1,5,0,0,3,0,2,8,1
6878,161577,Khe9KlmSoSTsax6cgkl9d8UgiAE6YdMj,7GRhBDsirIGkRZBtSMEzNTyDr2JQm4xx,8,6,3,0,1,0,3,0,13,1.8571428571428572,1,0.0,0,3,0,1,6,0,0,3,0,4,9,1
6879,161606,JyZKV6Cx4T3sb5lEewrPu89ztBDJpjHB,7GRhBDsirIGkRZBtSMEzNTyDr2JQm4xx,1,0,0,0,0,0,1,0,1,0.14285714285714285,1,0.0,0,0,0,0,0,0,0,1,0,0,1,1
6880,161622,0PgvslXgC0pgpIZFL5uHzeqmbNWkjEcF,7GRhBDsirIGkRZBtSMEzNTyDr2JQm4xx,15,17,1,0,1,6,7,1,33,4.714285714285714,1,0.0,2,1,0,1,15,6,0,7,1,4,29,1
6881,161667,q1QqcOJEpZrZKGZXfigMjZ8ytnCI74VX,7GRhBDsirIGkRZBtSMEzNTyDr2JQm4xx,2,0,0,0,0,0,2,0,2,0.2857142857142857,1,0.0,0,0,0,0,0,0,0,2,0,0,2,1
6882,161706,2XDpaAo3slMsrFQXFgtVX89IlqkzpX74,7GRhBDsirIGkRZBtSMEzNTyDr2JQm4xx,4,4,0,0,0,0,2,0,6,0.8571428571428571,1,0.0,0,0,0,0,4,0,0,2,0,0,6,1
6883,161720,xdxiKeJYKflgdr88D3HSJXuR1e81YpjG,7GRhBDsirIGkRZBtSMEzNTyDr2JQm4xx,10,8,2,6,3,0,3,1,23,3.2857142857142856,1,0.0,5,2,6,3,3,0,0,3,1,16,7,1
6884,161754,Xipj7T5lLiw1KZ1W0l4R2RMWExB1p24F,7GRhBDsirIGkRZBtSMEzNTyDr2JQm4xx,1,0,0,0,0,0,1,0,1,0.14285714285714285,1,0.0,0,0,0,0,0,0,0,1,0,0,1,1
6885,161876,rwuM6JXyr9NW5skD2mjToJGXTpHNXOXm,7GRhBDsirIGkRZBtSMEzNTyDr2JQm4xx,9,5,1,4,2,4,7,0,23,3.2857142857142856,1,0.0,3,1,3,2,2,4,1,7,0,9,14,1
6886,161903,UtNvwiEIu7iQRo2Po9FxglHJbAYaDW68,7GRhBDsirIGkRZBtSMEzNTyDr2JQm4xx,28,51,2,67,0,15,8,0,143,20.428571428571427,2,0.0,33,2,53,0,18,15,14,8,0,88,55,0
6887,161917,ClHMnOLy9vZKRtNjcA9yPWajeNvRCNdE,7GRhBDsirIGkRZBtSMEzNTyDr2JQm4xx,30,53,13,52,9,1,3,0,131,18.714285714285715,1,0.0,28,13,45,9,25,1,7,3,0,95,36,1
6888,161935,uKGXhzbiDEpxCHjVlf9dmkGcQbxLosVe,7GRhBDsirIGkRZBtSMEzNTyDr2JQm4xx,11,4,3,0,3,1,7,1,19,2.7142857142857144,1,0.0,0,3,0,3,4,1,0,7,1,6,13,1
6889,162062,J8ozccvPLhHs7wXw9VrsAZ8xFj3qhhGw,7GRhBDsirIGkRZBtSMEzNTyDr2JQm4xx,8,10,4,4,1,1,2,0,22,3.142857142857143,1,0.0,2,4,3,1,8,1,1,2,0,10,12,1
6890,162105,iJS4NO25TGJOkDkxwNThNbes0mRasAmQ,7GRhBDsirIGkRZBtSMEzNTyDr2JQm4xx,7,5,4,0,4,0,2,0,15,2.142857142857143,1,0.0,0,4,0,4,5,0,0,2,0,8,7,1
6891,162673,7l3GpI16MslYkR5zIHoJyawqfDaUFhUp,fbPkOYLVPtPgIt0MxizjfFJov3JbHyAi,7,3,2,0,2,0,3,0,10,1.4285714285714286,1,0.0,0,2,0,2,3,0,0,3,0,4,6,1
6892,162691,RXL48ch4QpTtcFwRepyduTfKEKrGyTKN,fbPkOYLVPtPgIt0MxizjfFJov3JbHyAi,9,13,6,0,4,2,8,0,33,4.714285714285714,1,0.0,1,6,0,4,12,2,0,8,0,11,22,1
6893,163169,tZMtcgGsCq7JvLpFL4lhYMv0agvGaZe2,7GRhBDsirIGkRZBtSMEzNTyDr2JQm4xx,7,2,1,0,1,1,5,0,10,1.4285714285714286,1,0.0,0,1,0,1,2,1,0,5,0,2,8,1
6894,163445,xXU9KJwMH5fbM7NnMKoHs3jEsDiPaALW,bWdj2GDclj5ofokWjzoa5jAwMkxCykd6,8,9,0,4,1,0,11,0,25,3.5714285714285716,2,0.0,5,0,3,1,4,0,1,11,0,9,16,1
6895,163449,vrjYYhgraDUMACavD1Jq29AQHFh2bMGk,SpATywNh6bZuzm8s1ceuBUnMUAeoAHHw,10,17,0,14,0,0,2,0,33,4.714285714285714,2,0.0,11,0,13,0,6,0,1,2,0,24,9,1
6896,163466,ASnkRnrOf1WwhiZJlBu5Rdb7kpMknjcy,SpATywNh6bZuzm8s1ceuBUnMUAeoAHHw,1,0,0,0,0,0,1,0,1,0.14285714285714285,1,0.0,0,0,0,0,0,0,0,1,0,0,1,1
6897,163470,vbOiF6cnlAMZD8LbHyglMTSugmHV6DHA,RXDvfPUBYFlVdlueBFbLW0mhhAyGEqpt,11,20,7,0,3,0,15,5,50,7.142857142857143,4,0.0,0,7,0,3,20,0,0,15,5,10,40,1
6898,163475,H8YHtkra0xamWmCl1rG6GNG1DeiG8zbG,bWdj2GDclj5ofokWjzoa5jAwMkxCykd6,15,32,0,104,0,14,9,0,159,22.714285714285715,1,0.0,6,0,97,0,26,14,7,9,0,103,56,1
6899,163480,6hX10Wu1E2KDRE7mYGP1VPoNRkdF7lrL,RXDvfPUBYFlVdlueBFbLW0mhhAyGEqpt,6,6,3,0,2,0,2,0,13,1.8571428571428572,1,0.0,0,3,0,2,6,0,0,2,0,5,8,1
6900,163483,pDYlcAIvVnBJ5nJ6t9DMrTdONniDYlEW,RXDvfPUBYFlVdlueBFbLW0mhhAyGEqpt,4,4,0,0,0,3,2,0,9,1.2857142857142858,1,0.0,0,0,0,0,4,3,0,2,0,0,9,1
6901,163490,QP9mUTxIKar5wOD0pjJi5ToJRWI6Qe58,G8EPVSXsOYB5YQWZGiz1aVq5Pgr2GrQu,9,11,0,0,0,0,6,0,17,2.4285714285714284,1,0.0,2,0,0,0,9,0,0,6,0,2,15,0
6902,163507,kGtpt8jv2taW68U9XPA4K4mRWM6eie4a,SpATywNh6bZuzm8s1ceuBUnMUAeoAHHw,9,7,5,0,4,0,4,1,21,3.0,1,0.0,0,5,0,4,7,0,0,4,1,9,12,1
6903,163509,z98RxEOJ89VINRwVTX4KbTlJYz09XMrh,SpATywNh6bZuzm8s1ceuBUnMUAeoAHHw,1,0,0,0,0,0,1,0,1,0.14285714285714285,1,0.0,0,0,0,0,0,0,0,1,0,0,1,1
6904,163510,5oLMWOENowYuBiosAAPZhmNDox994GEM,SpATywNh6bZuzm8s1ceuBUnMUAeoAHHw,14,25,13,16,0,6,26,8,94,13.428571428571429,2,0.0,5,13,13,0,20,6,3,26,8,31,63,1
6905,163514,VulnA8EYzLxbOoYdrjgIqZbvSkkMTK23,RXDvfPUBYFlVdlueBFbLW0mhhAyGEqpt,9,11,1,0,1,0,1,0,14,2.0,1,0.0,0,1,0,1,11,0,0,1,0,2,12,1
6906,163516,cnF5YfjX3CQt7JMSCL8P4leqdmCPbBni,bWdj2GDclj5ofokWjzoa5jAwMkxCykd6,5,2,1,0,1,0,2,0,6,0.8571428571428571,1,0.0,0,1,0,1,2,0,0,2,0,2,4,1
6907,163518,ljvQidttDf2jbMq0Dhco00ANs1OMPP2n,SpATywNh6bZuzm8s1ceuBUnMUAeoAHHw,7,2,1,0,1,1,6,0,11,1.5714285714285714,1,0.0,0,1,0,1,2,1,0,6,0,2,9,1
6908,163533,fkHyrrcfJ6oe60xqsar56Gz0YRl5rHzC,SpATywNh6bZuzm8s1ceuBUnMUAeoAHHw,1,0,0,0,0,0,2,0,2,0.2857142857142857,1,0.0,0,0,0,0,0,0,0,2,0,0,2,1
6909,163542,CSh5hGbaSFu2yCb31iVMOVwKocrH471Q,G8EPVSXsOYB5YQWZGiz1aVq5Pgr2GrQu,4,2,1,0,1,0,1,0,5,0.7142857142857143,2,0.0,0,1,0,1,2,0,0,1,0,2,3,1
6910,163549,kD7KrEgPns8NN7pPH4RunWGvMBAYF6OW,RXDvfPUBYFlVdlueBFbLW0mhhAyGEqpt,9,8,4,0,2,0,5,0,19,2.7142857142857144,2,0.0,0,4,0,2,8,0,0,5,0,6,13,0
6911,163562,H7BcZUb2MJ3mV3eWcUeltHh62X1WzBrw,SpATywNh6bZuzm8s1ceuBUnMUAeoAHHw,1,0,0,0,0,0,1,0,1,0.14285714285714285,1,0.0,0,0,0,0,0,0,0,1,0,0,1,1
6912,163569,C5uVsSF0OJOzgwE9vgQEq40axD3ffZTd,RXDvfPUBYFlVdlueBFbLW0mhhAyGEqpt,7,6,2,0,1,0,8,0,17,2.4285714285714284,2,0.0,0,2,0,1,6,0,0,8,0,3,14,1
6913,163571,F3TqBHACHIYM9Yg9wui66QV7ygJkp22V,bWdj2GDclj5ofokWjzoa5jAwMkxCykd6,7,1,1,0,1,2,6,1,12,1.7142857142857142,1,0.0,0,1,0,1,1,2,0,6,1,2,10,1
6914,163577,Uy2krOPQuopj6gsLDrvSnNpCmzlDZ3lx,G8EPVSXsOYB5YQWZGiz1aVq5Pgr2GrQu,26,30,2,52,0,0,4,0,88,12.571428571428571,1,0.0,15,2,37,0,15,0,15,4,0,54,34,1
6915,163582,eYxD3pCXsuNAtHKPOm6JQVNldqcoc61X,RXDvfPUBYFlVdlueBFbLW0mhhAyGEqpt,9,6,2,0,2,4,5,1,20,2.857142857142857,2,0.0,0,2,0,2,6,4,0,5,1,4,16,1
6916,163588,pvAe37z1FjLTGYdwlJFjXex25zlpyHtu,RXDvfPUBYFlVdlueBFbLW0mhhAyGEqpt,1,0,0,0,0,0,1,0,1,0.14285714285714285,1,0.0,0,0,0,0,0,0,0,1,0,0,1,1
6917,163589,lQAYhw1UzsQa6D4iHlC81XAZ1ajKb7gC,SpATywNh6bZuzm8s1ceuBUnMUAeoAHHw,5,2,1,0,1,1,2,0,7,1.0,1,0.0,0,1,0,1,2,1,0,2,0,2,5,1
6918,163590,vagG6fUZaIryVQfvx8v2uowaOCAY1cdW,G8EPVSXsOYB5YQWZGiz1aVq5Pgr2GrQu,7,5,1,0,1,0,4,0,11,1.5714285714285714,1,0.0,0,1,0,1,5,0,0,4,0,2,9,1
6919,163600,S1y1GaZipa7CZ4Lvwv6Z3UIIwux9mVs2,SpATywNh6bZuzm8s1ceuBUnMUAeoAHHw,6,3,2,0,2,0,1,0,8,1.1428571428571428,1,0.0,0,2,0,2,3,0,0,1,0,4,4,1
6920,163601,XqqzFQNJmn3Nj5uaNCNXStUfXUCSgi1X,SpATywNh6bZuzm8s1ceuBUnMUAeoAHHw,6,3,2,0,2,0,1,0,8,1.1428571428571428,1,0.0,0,2,0,2,3,0,0,1,0,4,4,1
6921,163614,cfOhX0waxJYI0ZiTf440b9KQ8z56ZELH,SpATywNh6bZuzm8s1ceuBUnMUAeoAHHw,13,10,5,0,3,0,7,5,30,4.285714285714286,2,0.0,4,5,0,3,6,0,0,7,5,12,18,1
6922,163618,w1CA5COiIiNblmqtUGzNLlwoBIorG5nj,SpATywNh6bZuzm8s1ceuBUnMUAeoAHHw,13,14,0,7,0,1,6,1,29,4.142857142857143,2,0.0,5,0,7,0,9,1,0,6,1,12,17,1
6923,163619,Fa1mAVxGk4kVn9jd6eDkxLNhUbCZP7qX,G8EPVSXsOYB5YQWZGiz1aVq5Pgr2GrQu,16,8,6,0,5,0,6,0,25,3.5714285714285716,2,0.0,0,6,0,5,8,0,0,6,0,11,14,1
6924,163622,L1AaE8JRIRIV3lw2DVe2AIMIzykmc89e,G8EPVSXsOYB5YQWZGiz1aVq5Pgr2GrQu,26,68,22,26,15,1,11,3,146,20.857142857142858,1,0.0,29,22,23,15,39,1,3,11,3,89,57,1
6925,163625,YMDTxwTCTCMBG5LWHOVv3uaqDpUsACxE,SpATywNh6bZuzm8s1ceuBUnMUAeoAHHw,1,0,0,0,0,0,1,0,1,0.14285714285714285,1,0.0,0,0,0,0,0,0,0,1,0,0,1,1
6926,163631,F3LkPjPg6vCRHLtL3FvDerZrs5n7emOU,SpATywNh6bZuzm8s1ceuBUnMUAeoAHHw,7,5,4,0,4,0,2,0,15,2.142857142857143,1,0.0,0,4,0,4,5,0,0,2,0,8,7,1
6927,163632,PCPmtsqEtkHe7GooXQswbqyH8cnukgFn,SpATywNh6bZuzm8s1ceuBUnMUAeoAHHw,5,2,0,0,0,0,3,0,5,0.7142857142857143,1,0.0,0,0,0,0,2,0,0,3,0,0,5,1
6928,163638,DyoNdvHG07mU6Bz7r3h8R4ubHxjNBfTA,SpATywNh6bZuzm8s1ceuBUnMUAeoAHHw,6,5,2,0,1,1,2,0,11,1.5714285714285714,1,0.0,0,2,0,1,5,1,0,2,0,3,8,1
6929,163643,C4OZeIeoVWL85YLgAEXLqPH3ncq3XA6k,SpATywNh6bZuzm8s1ceuBUnMUAeoAHHw,8,2,1,0,1,1,6,1,12,1.7142857142857142,1,0.0,0,1,0,1,2,1,0,6,1,2,10,1
6930,163650,wi94HT3Va3Hif8CpMS1WVbL5a71j9CMb,RXDvfPUBYFlVdlueBFbLW0mhhAyGEqpt,15,10,7,8,2,15,6,8,56,8.0,1,0.0,1,7,7,2,9,15,1,6,8,17,39,1
6931,163654,mlnhYrciKajvXbMdJptDLVlFyYAjST94,G8EPVSXsOYB5YQWZGiz1aVq5Pgr2GrQu,7,3,0,0,0,8,5,13,29,4.142857142857143,1,0.0,0,0,0,0,3,8,0,5,13,0,29,1
6932,163656,hsKZoLrdrvPaRbEyzj2NgfRJmBw1qqW5,SpATywNh6bZuzm8s1ceuBUnMUAeoAHHw,11,34,17,0,0,11,23,4,89,12.714285714285714,2,0.0,11,17,0,0,23,11,0,23,4,28,61,1
6933,163660,WIulMAW8PLfyLvnliYk0w4Xs9IJHKZPS,bWdj2GDclj5ofokWjzoa5jAwMkxCykd6,6,2,1,0,0,1,5,1,10,1.4285714285714286,2,0.0,0,1,0,0,2,1,0,5,1,1,9,1
6934,163675,0kNhy59h1x4o0Ij6YScRdNhibpvh4SDd,SpATywNh6bZuzm8s1ceuBUnMUAeoAHHw,1,0,0,0,0,0,1,0,1,0.14285714285714285,1,0.0,0,0,0,0,0,0,0,1,0,0,1,0
6935,163678,u40Wnz941IKPEKg6evh8MfJNEbnPlztD,bWdj2GDclj5ofokWjzoa5jAwMkxCykd6,5,2,1,0,1,6,2,0,12,1.7142857142857142,1,0.0,0,1,0,1,2,6,0,2,0,2,10,1
6936,163681,lyMxC1IigTgGwaO3VxYbmlReQwCiDGpV,RXDvfPUBYFlVdlueBFbLW0mhhAyGEqpt,11,14,0,0,0,4,5,2,25,3.5714285714285716,1,0.0,0,0,0,0,14,4,0,5,2,0,25,1
6937,163684,ewJfXKCM3UIjcsxxypCAlFJ00OIwALVK,SpATywNh6bZuzm8s1ceuBUnMUAeoAHHw,16,17,8,23,4,18,7,2,79,11.285714285714286,1,0.0,6,8,19,4,11,18,4,7,2,37,42,1
6938,163689,Ex7M4i0hxnSRXjh3Gag0IYca3K61Kn2n,SpATywNh6bZuzm8s1ceuBUnMUAeoAHHw,13,10,6,10,5,0,3,0,34,4.857142857142857,1,0.0,3,6,8,5,7,0,2,3,0,22,12,1
6939,163699,QZzKa5b6BbNwk1LIn6xlSQQLnIzRsZka,RXDvfPUBYFlVdlueBFbLW0mhhAyGEqpt,9,6,2,0,2,0,4,0,14,2.0,1,0.0,0,2,0,2,6,0,0,4,0,4,10,1
6940,163702,wf4tYLDC26NonKlhHYQJXmb4zsRVp9vv,RXDvfPUBYFlVdlueBFbLW0mhhAyGEqpt,2,1,0,0,0,0,2,0,3,0.42857142857142855,1,0.0,0,0,0,0,1,0,0,2,0,0,3,1
6941,163705,Np4pKivCInwrNv4VDIJNvSdKsE4Ykhes,SpATywNh6bZuzm8s1ceuBUnMUAeoAHHw,7,2,1,0,1,1,4,1,10,1.4285714285714286,1,0.0,0,1,0,1,2,1,0,4,1,2,8,1
6942,163709,pdSGmGjIheArtjBU79xTfiS3vhBu2KPT,SpATywNh6bZuzm8s1ceuBUnMUAeoAHHw,6,2,1,0,1,0,3,0,7,1.0,1,0.0,0,1,0,1,2,0,0,3,0,2,5,1
6943,163717,s7VOudb8mAmGtu7aUQI1pKU0VJWMkjoX,G8EPVSXsOYB5YQWZGiz1aVq5Pgr2GrQu,5,2,1,0,1,0,2,0,6,0.8571428571428571,1,0.0,0,1,0,1,2,0,0,2,0,2,4,1
6944,163721,qefyjSYUZQgFnIvwhQLXYc5FeLuyNtLR,SpATywNh6bZuzm8s1ceuBUnMUAeoAHHw,4,2,0,0,0,0,2,0,4,0.5714285714285714,1,0.0,0,0,0,0,2,0,0,2,0,0,4,1
6945,163725,2jbBgSBiRnod35BsxMp6TsDQi1nWOPvD,SpATywNh6bZuzm8s1ceuBUnMUAeoAHHw,7,3,2,0,2,0,2,0,9,1.2857142857142858,1,0.0,0,2,0,2,3,0,0,2,0,4,5,1
6946,163726,GEJT2aBPUnilxjCoBwgHhTPS1ahoPkLE,RXDvfPUBYFlVdlueBFbLW0mhhAyGEqpt,4,3,2,0,2,0,1,0,8,1.1428571428571428,2,0.0,0,2,0,2,3,0,0,1,0,4,4,1
6947,163732,CEHfXzpDz8lIH5e7jnl07zaS2wVnOurM,bWdj2GDclj5ofokWjzoa5jAwMkxCykd6,1,0,0,0,0,0,2,0,2,0.2857142857142857,1,0.0,0,0,0,0,0,0,0,2,0,0,2,1
6948,163733,XlmyWP3uzEka8XsoWFimEg5Beb9mAoVO,SpATywNh6bZuzm8s1ceuBUnMUAeoAHHw,13,9,2,21,2,1,3,0,38,5.428571428571429,1,0.0,4,2,19,2,5,1,2,3,0,27,11,0
6949,163737,ltg49XAFIsj12MvcvVinx0U6nQzosGwX,SpATywNh6bZuzm8s1ceuBUnMUAeoAHHw,1,0,0,0,0,0,1,0,1,0.14285714285714285,1,0.0,0,0,0,0,0,0,0,1,0,0,1,1
6950,163742,p0fw4v0FzqDHoIprXWv2PhAw9MEKisrS,SpATywNh6bZuzm8s1ceuBUnMUAeoAHHw,11,35,29,0,16,9,8,0,97,13.857142857142858,2,0.0,2,29,0,16,33,9,0,8,0,47,50,1
6951,163746,T40Q6IsSToScgVshLJURvbaPdMvC0SSz,SpATywNh6bZuzm8s1ceuBUnMUAeoAHHw,3,2,0,0,0,0,2,0,4,0.5714285714285714,1,0.0,0,0,0,0,2,0,0,2,0,0,4,1
6952,163749,fyTJxX25s6bGEKgBLCJRWjXtah1KWf2a,SpATywNh6bZuzm8s1ceuBUnMUAeoAHHw,7,3,2,0,0,1,5,1,12,1.7142857142857142,1,0.0,0,2,0,0,3,1,0,5,1,2,10,1
6953,163751,WIulMAW8PLfyLvnliYk0w4Xs9IJHKZPS,RXDvfPUBYFlVdlueBFbLW0mhhAyGEqpt,2,0,0,0,0,0,3,0,3,0.42857142857142855,2,0.0,0,0,0,0,0,0,0,3,0,0,3,1
6954,163755,ePj7Vg45LclsHx65E6l7TrkRBcgJnatl,SpATywNh6bZuzm8s1ceuBUnMUAeoAHHw,16,22,9,23,3,1,5,1,64,9.142857142857142,1,0.0,10,9,19,3,12,1,4,5,1,41,23,1
6955,163762,8frCsvLNU0A4TOJYDtM515jTF7T871uZ,SpATywNh6bZuzm8s1ceuBUnMUAeoAHHw,1,0,0,0,0,0,1,0,1,0.14285714285714285,1,0.0,0,0,0,0,0,0,0,1,0,0,1,1
6956,163764,J1eFEaKfAoVdTBUtGJyjHKFZqTtKoDt7,SpATywNh6bZuzm8s1ceuBUnMUAeoAHHw,2,0,0,0,0,0,2,0,2,0.2857142857142857,2,0.0,0,0,0,0,0,0,0,2,0,0,2,1
6957,163772,4IvlesNs2H0RowHre7RAgbEkJVMxR7AN,SpATywNh6bZuzm8s1ceuBUnMUAeoAHHw,10,8,5,0,4,5,5,0,27,3.857142857142857,1,0.0,0,5,0,4,8,5,0,5,0,9,18,1
6958,163774,MByqWSIhrOuR5hLDV5SDwmnefy1Zfii8,SpATywNh6bZuzm8s1ceuBUnMUAeoAHHw,14,15,2,19,0,2,12,1,51,7.285714285714286,3,0.0,2,2,15,0,13,2,4,12,1,19,32,1
6959,163782,mxBhue6G5uamvaszDl3iuMbiHnjieccs,SpATywNh6bZuzm8s1ceuBUnMUAeoAHHw,6,4,1,0,1,0,2,0,8,1.1428571428571428,2,0.0,1,1,0,1,3,0,0,2,0,3,5,1
6960,163783,uPwSB0CSQ1ut2moqiJ7QCNXIo4WCZY1E,bWdj2GDclj5ofokWjzoa5jAwMkxCykd6,1,0,0,0,0,0,1,0,1,0.14285714285714285,1,0.0,0,0,0,0,0,0,0,1,0,0,1,1
6961,163785,9d3JQQBsPcAu5WcxhfhApcP84UgGH4MP,SpATywNh6bZuzm8s1ceuBUnMUAeoAHHw,6,3,2,0,2,0,1,0,8,1.1428571428571428,1,0.0,0,2,0,2,3,0,0,1,0,4,4,1
6962,163787,8VYVEiIEY85awvLQk1iQtn3EDF8rq6g1,RXDvfPUBYFlVdlueBFbLW0mhhAyGEqpt,1,0,0,0,0,0,1,0,1,0.14285714285714285,1,0.0,0,0,0,0,0,0,0,1,0,0,1,1
6963,163791,D42av4RgpD46CqlOrc3UqYUQGU69fX7w,G8EPVSXsOYB5YQWZGiz1aVq5Pgr2GrQu,10,14,5,8,3,0,2,0,32,4.571428571428571,2,0.0,3,5,5,3,11,0,3,2,0,16,16,1
6964,163803,OTTt0WwDCNei2O0TEm6JKkoSswKCnrig,bWdj2GDclj5ofokWjzoa5jAwMkxCykd6,7,4,2,0,1,2,3,1,13,1.8571428571428572,1,0.0,0,2,0,1,4,2,0,3,1,3,10,1
6965,163805,RGr3DE14hb7Ufb3qkxo2JnrYRs9POJfu,bWdj2GDclj5ofokWjzoa5jAwMkxCykd6,2,0,0,0,0,0,2,0,2,0.2857142857142857,1,0.0,0,0,0,0,0,0,0,2,0,0,2,1
6966,163806,VROspqrlv0dK4X4QLAJe4l0nslgLETjg,SpATywNh6bZuzm8s1ceuBUnMUAeoAHHw,11,21,13,0,0,0,7,1,42,6.0,1,0.0,5,13,0,0,16,0,0,7,1,18,24,1
6967,163808,Zt87siQCmnS8kLlyv5Y5utZhnc1bMPCO,SpATywNh6bZuzm8s1ceuBUnMUAeoAHHw,4,2,0,0,0,0,2,0,4,0.5714285714285714,1,0.0,0,0,0,0,2,0,0,2,0,0,4,1
6968,163814,RmNdouduvikY6rwKOzMijwxrRPvXpOqe,SpATywNh6bZuzm8s1ceuBUnMUAeoAHHw,1,0,0,0,0,0,1,0,1,0.14285714285714285,1,0.0,0,0,0,0,0,0,0,1,0,0,1,1
6969,163822,RGr3DE14hb7Ufb3qkxo2JnrYRs9POJfu,RXDvfPUBYFlVdlueBFbLW0mhhAyGEqpt,2,0,0,0,0,0,2,0,2,0.2857142857142857,1,0.0,0,0,0,0,0,0,0,2,0,0,2,1
6970,163824,8VGorZlY7mV29XrBVXKId31ils1jK6e4,SpATywNh6bZuzm8s1ceuBUnMUAeoAHHw,11,10,1,16,0,0,3,0,30,4.285714285714286,1,0.0,5,1,14,0,5,0,2,3,0,20,10,1
6971,163831,TRkoMMGdlwDWhj0QSrRowmh4NkQmbVQQ,RXDvfPUBYFlVdlueBFbLW0mhhAyGEqpt,7,5,0,0,0,0,2,0,7,1.0,1,0.0,0,0,0,0,5,0,0,2,0,0,7,1
6972,163832,PiD5rrce1Y4GmQw7bDUPO9xN5t3xVeMb,bWdj2GDclj5ofokWjzoa5jAwMkxCykd6,1,0,0,0,0,0,1,0,1,0.14285714285714285,1,0.0,0,0,0,0,0,0,0,1,0,0,1,1
6973,163833,KVtMqoPC0QDsoF45TzGd0BaG4fzRLrFd,SpATywNh6bZuzm8s1ceuBUnMUAeoAHHw,6,3,1,0,1,0,2,0,7,1.0,1,0.0,0,1,0,1,3,0,0,2,0,2,5,1
6974,163836,SQBW44VzMb5zXQWTfzFzAP2RU7qxP2su,SpATywNh6bZuzm8s1ceuBUnMUAeoAHHw,5,4,2,0,1,0,2,0,9,1.2857142857142858,2,0.0,0,2,0,1,4,0,0,2,0,3,6,1
6975,163841,VOYGsHw00bDlJPevH6j2b9TjHm4MTXPJ,bWdj2GDclj5ofokWjzoa5jAwMkxCykd6,7,5,4,0,4,0,4,0,17,2.4285714285714284,1,0.0,0,4,0,4,5,0,0,4,0,8,9,0
6976,163865,5OhxkZY6VrmzMIEqEJk4w0eM2XdsVdBQ,bWdj2GDclj5ofokWjzoa5jAwMkxCykd6,1,0,0,0,0,0,1,0,1,0.14285714285714285,1,0.0,0,0,0,0,0,0,0,1,0,0,1,1
6977,163879,nu1pV8lIFpyulfHtXPUt3mWowV7EAjTM,SpATywNh6bZuzm8s1ceuBUnMUAeoAHHw,1,0,0,0,0,0,2,0,2,0.2857142857142857,1,0.0,0,0,0,0,0,0,0,2,0,0,2,1
6978,163886,Bos3zEEnAcYzPXQktMkJJ0ak5mhGWCAf,bWdj2GDclj5ofokWjzoa5jAwMkxCykd6,14,29,9,32,3,2,6,1,82,11.714285714285714,2,0.0,9,9,31,3,20,2,1,6,1,52,30,0
6979,163895,IdPX4c7Aq1sETI8RH1NYOE4mt2Ch4lHK,G8EPVSXsOYB5YQWZGiz1aVq5Pgr2GrQu,12,6,5,16,2,0,3,0,32,4.571428571428571,1,0.0,0,5,14,2,6,0,2,3,0,21,11,1
6980,163900,3RcsrMTbPrb8ZHYXLlgwoRK7zrqTGSuq,SpATywNh6bZuzm8s1ceuBUnMUAeoAHHw,1,0,0,0,0,0,1,0,1,0.14285714285714285,1,0.0,0,0,0,0,0,0,0,1,0,0,1,1
6981,163902,35YnYP4Tkn7xvOTt0M51AeVR3m7l2sIt,G8EPVSXsOYB5YQWZGiz1aVq5Pgr2GrQu,7,5,1,0,1,0,2,0,9,1.2857142857142858,2,0.0,0,1,0,1,5,0,0,2,0,2,7,1
6982,163908,NrHk4qmJXuD0TsjkQSnghKpk9ZjGAOyU,RXDvfPUBYFlVdlueBFbLW0mhhAyGEqpt,5,3,2,0,2,0,2,0,9,1.2857142857142858,1,0.0,0,2,0,2,3,0,0,2,0,4,5,1
6983,163909,omRh5Z9AcNowwMlq7wsAXczLrDoDOAwv,bWdj2GDclj5ofokWjzoa5jAwMkxCykd6,8,14,7,2,2,0,2,0,27,3.857142857142857,2,0.0,2,7,2,2,12,0,0,2,0,13,14,1
6984,163911,O1GQCvqX78WHj4bvuBKl7CpHmRzidVy9,SpATywNh6bZuzm8s1ceuBUnMUAeoAHHw,4,6,3,0,0,0,1,0,10,1.4285714285714286,1,0.0,2,3,0,0,4,0,0,1,0,5,5,1
6985,163914,ncIBIt1kRS23NRG3HklaOrwS2ep1UY7z,G8EPVSXsOYB5YQWZGiz1aVq5Pgr2GrQu,14,15,6,12,3,0,1,0,37,5.285714285714286,1,0.0,6,6,7,3,9,0,5,1,0,22,15,1
6986,163916,lntlNyrTcmBgMyWfooLFXfRIXX7mctQs,bWdj2GDclj5ofokWjzoa5jAwMkxCykd6,3,1,0,0,0,0,2,0,3,0.42857142857142855,1,0.0,0,0,0,0,1,0,0,2,0,0,3,1
6987,163922,ncIBIt1kRS23NRG3HklaOrwS2ep1UY7z,bWdj2GDclj5ofokWjzoa5jAwMkxCykd6,5,4,1,0,0,0,3,0,8,1.1428571428571428,1,0.0,0,1,0,0,4,0,0,3,0,1,7,1
6988,163925,TbdeJU00oP9V3i4nJearCAXrCR8nfsK3,SpATywNh6bZuzm8s1ceuBUnMUAeoAHHw,7,9,4,0,2,1,2,0,18,2.5714285714285716,2,0.0,0,4,0,2,9,1,0,2,0,6,12,1
6989,163928,VjsjgdvHeFwreLXV4d0cm1ICJk30LzPH,bWdj2GDclj5ofokWjzoa5jAwMkxCykd6,1,0,0,0,0,0,2,0,2,0.2857142857142857,1,0.0,0,0,0,0,0,0,0,2,0,0,2,1
6990,163934,5NIrDL6VpBxdJ6CyWDkvlKDqSlFChzvA,SpATywNh6bZuzm8s1ceuBUnMUAeoAHHw,6,4,2,0,1,0,4,0,11,1.5714285714285714,2,0.0,0,2,0,1,4,0,0,4,0,3,8,0
6991,163936,58CuB3m4LabodooAfWkSdyPNtGlVJfdv,SpATywNh6bZuzm8s1ceuBUnMUAeoAHHw,2,0,0,0,0,0,2,0,2,0.2857142857142857,1,0.0,0,0,0,0,0,0,0,2,0,0,2,1
6992,163940,Kt9qeiacR1tBDeKKHUR6O60ehH5pm7C9,RXDvfPUBYFlVdlueBFbLW0mhhAyGEqpt,1,0,0,0,0,0,1,0,1,0.14285714285714285,1,0.0,0,0,0,0,0,0,0,1,0,0,1,1
6993,163944,k8NseCRyuonMJqIA9r5ZttySeYFCZkvS,bWdj2GDclj5ofokWjzoa5jAwMkxCykd6,2,0,0,0,0,0,2,0,2,0.2857142857142857,1,0.0,0,0,0,0,0,0,0,2,0,0,2,1
6994,163961,NNIDIi1G7HKDU1709vBEwzpydUygCNLC,SpATywNh6bZuzm8s1ceuBUnMUAeoAHHw,15,25,9,21,4,0,7,0,66,9.428571428571429,3,0.0,12,9,18,4,13,0,3,7,0,43,23,1
6995,163972,83J9IXuPcwdDBJoFENdSQFWzvgELVzeu,SpATywNh6bZuzm8s1ceuBUnMUAeoAHHw,1,0,0,0,0,0,1,0,1,0.14285714285714285,1,0.0,0,0,0,0,0,0,0,1,0,0,1,1
6996,163975,dbtlJh8uWixqUAz5pHAMwXOZNVVUTuzi,bWdj2GDclj5ofokWjzoa5jAwMkxCykd6,7,9,4,0,3,0,5,0,21,3.0,1,0.0,2,4,0,3,7,0,0,5,0,9,12,1
6997,163982,cikSh880jtc26b154AaVhDiV1L6H6F3g,SpATywNh6bZuzm8s1ceuBUnMUAeoAHHw,16,11,7,18,4,1,6,0,47,6.714285714285714,2,0.0,2,7,16,4,9,1,2,6,0,29,18,0
6998,163983,Is7lqncTs1EDN9QmzrTbcU6KnB0BCGNX,bWdj2GDclj5ofokWjzoa5jAwMkxCykd6,5,2,1,0,1,0,2,0,6,0.8571428571428571,1,0.0,0,1,0,1,2,0,0,2,0,2,4,1
6999,163986,YgxPec9PZk03SxcMpde0DWwnbgHU13wT,RXDvfPUBYFlVdlueBFbLW0mhhAyGEqpt,1,0,0,0,0,0,1,0,1,0.14285714285714285,1,0.0,0,0,0,0,0,0,0,1,0,0,1,1
7000,163993,EQtZU9INEuWvmS0EVA02NQr3rav8vOCw,SpATywNh6bZuzm8s1ceuBUnMUAeoAHHw,1,0,0,0,0,0,1,0,1,0.14285714285714285,1,0.0,0,0,0,0,0,0,0,1,0,0,1,1
7001,163995,EQtZU9INEuWvmS0EVA02NQr3rav8vOCw,bWdj2GDclj5ofokWjzoa5jAwMkxCykd6,1,0,0,0,0,0,1,0,1,0.14285714285714285,1,0.0,0,0,0,0,0,0,0,1,0,0,1,1
7002,163996,HE0yFYNeyW3jGh5EhXv7uoc6O18ATk5R,bWdj2GDclj5ofokWjzoa5jAwMkxCykd6,9,8,4,0,2,0,4,0,18,2.5714285714285716,3,0.0,0,4,0,2,8,0,0,4,0,6,12,1
7003,163997,KZBxo2oXfcrXYFa3c9hEkQ12gjuvG6yO,SpATywNh6bZuzm8s1ceuBUnMUAeoAHHw,5,3,1,0,1,0,1,0,6,0.8571428571428571,1,0.0,0,1,0,1,3,0,0,1,0,2,4,1
7004,164001,XFqiUKRJW4dHHhbAyhg0HRvuoT5jA7Ib,SpATywNh6bZuzm8s1ceuBUnMUAeoAHHw,8,9,7,0,5,0,3,0,24,3.4285714285714284,2,0.0,0,7,0,5,9,0,0,3,0,12,12,1
7005,164004,RcOO7zh8NeavIcr1ab7xjfpMRrA97BXt,G8EPVSXsOYB5YQWZGiz1aVq5Pgr2GrQu,6,2,1,0,1,0,3,0,7,1.0,1,0.0,0,1,0,1,2,0,0,3,0,2,5,1
7006,164005,DhiB4cJ1TCjmSH3ZWP9m0OqNyBdGeS5P,SpATywNh6bZuzm8s1ceuBUnMUAeoAHHw,10,14,1,16,1,0,1,0,33,4.714285714285714,3,0.0,4,1,14,1,10,0,2,1,0,20,13,1
7007,164006,BMjIPGqtYoLatxXDEHrhiIMt72Ckp0Wf,RXDvfPUBYFlVdlueBFbLW0mhhAyGEqpt,19,16,1,26,0,0,5,1,49,7.0,1,0.0,5,1,25,0,11,0,1,5,1,31,18,1
7008,164008,0sPJG21Jmy137j2MeTN2RYjy8hYUDlLs,G8EPVSXsOYB5YQWZGiz1aVq5Pgr2GrQu,10,11,2,16,1,0,3,0,33,4.714285714285714,1,0.0,4,2,13,1,7,0,3,3,0,20,13,1
7009,164009,g3902agYIRHzac78MKVZlvljLMXXNpQ7,bWdj2GDclj5ofokWjzoa5jAwMkxCykd6,6,3,2,0,2,0,5,0,12,1.7142857142857142,1,0.0,0,2,0,2,3,0,0,5,0,4,8,1
7010,164013,1l8gTBWE0zew7p1xhFmmlqlIh8QPXivD,RXDvfPUBYFlVdlueBFbLW0mhhAyGEqpt,1,0,0,0,0,0,1,0,1,0.14285714285714285,1,0.0,0,0,0,0,0,0,0,1,0,0,1,1
7011,164024,s5CJLvNaNPk4PiGqc6NTFvObROYB0OQQ,SpATywNh6bZuzm8s1ceuBUnMUAeoAHHw,13,28,0,18,0,20,10,0,76,10.857142857142858,4,0.0,8,0,16,0,20,20,2,10,0,24,52,0
7012,164030,1KSlK2xXHUc3PjC1CsQEQaomGBagqDXf,bWdj2GDclj5ofokWjzoa5jAwMkxCykd6,5,2,1,0,1,0,2,0,6,0.8571428571428571,1,0.0,0,1,0,1,2,0,0,2,0,2,4,1
7013,164032,zQ5BnttGrAYjfbNnxAVeHGUEjC3wWZZU,SpATywNh6bZuzm8s1ceuBUnMUAeoAHHw,17,32,19,21,9,8,21,0,110,15.714285714285714,5,0.0,3,19,18,9,29,8,3,21,0,49,61,0
7014,164035,HnIhmL6C5c5V3yK8mmGh4fDvVHyYVu6T,SpATywNh6bZuzm8s1ceuBUnMUAeoAHHw,17,27,4,18,4,0,13,1,67,9.571428571428571,2,0.0,9,4,15,4,18,0,3,13,1,32,35,1
7015,164038,muYojhkvYaqc1I2tE62ZyLEtlEpDYqtR,SpATywNh6bZuzm8s1ceuBUnMUAeoAHHw,10,8,2,0,2,1,6,1,20,2.857142857142857,1,0.0,0,2,0,2,8,1,0,6,1,4,16,1
7016,164048,ZhPOxBDoDGtWvBUdn6MZkcPVAapzwktO,SpATywNh6bZuzm8s1ceuBUnMUAeoAHHw,15,32,1,22,0,2,11,1,69,9.857142857142858,3,0.0,13,1,19,0,19,2,3,11,1,33,36,1
7017,164050,frevGWOFyf2Wo6uQjpFNvZnyWeFbKP0E,bWdj2GDclj5ofokWjzoa5jAwMkxCykd6,3,3,0,0,0,0,1,0,4,0.5714285714285714,1,0.0,1,0,0,0,2,0,0,1,0,1,3,1
7018,164051,frevGWOFyf2Wo6uQjpFNvZnyWeFbKP0E,RXDvfPUBYFlVdlueBFbLW0mhhAyGEqpt,9,13,1,0,0,0,1,0,15,2.142857142857143,1,0.0,4,1,0,0,9,0,0,1,0,5,10,1
7019,164053,C0k0i5iW9Kp3SljhwW4D102xschKnWU2,RXDvfPUBYFlVdlueBFbLW0mhhAyGEqpt,1,0,0,0,0,0,1,0,1,0.14285714285714285,1,0.0,0,0,0,0,0,0,0,1,0,0,1,1
7020,164059,KNSr5UQyphUzZdobhnLn0kvEqH22GN8U,G8EPVSXsOYB5YQWZGiz1aVq5Pgr2GrQu,2,0,0,0,0,0,2,0,2,0.2857142857142857,1,0.0,0,0,0,0,0,0,0,2,0,0,2,1
7021,164064,uuxrUSHn3GpYFneZnY8GpLgr5XiyDABs,bWdj2GDclj5ofokWjzoa5jAwMkxCykd6,9,19,7,0,6,13,10,3,58,8.285714285714286,1,0.0,8,7,0,6,11,13,0,10,3,21,37,1
7022,164068,83H2FVc0DUlyPpMlZsbpGsFQRMFc6fan,bWdj2GDclj5ofokWjzoa5jAwMkxCykd6,3,4,0,0,0,0,2,0,6,0.8571428571428571,1,0.0,0,0,0,0,4,0,0,2,0,0,6,1
7023,164072,KRDbzApPGunbpzFiIxAlDnKcVqmXz93Z,SpATywNh6bZuzm8s1ceuBUnMUAeoAHHw,9,9,0,0,0,1,5,1,16,2.2857142857142856,1,0.0,0,0,0,0,9,1,0,5,1,0,16,1
7024,164075,Qfoj47ZFH9kFoOklCPtfSf7qImKKODGj,bWdj2GDclj5ofokWjzoa5jAwMkxCykd6,1,0,0,0,0,0,1,0,1,0.14285714285714285,1,0.0,0,0,0,0,0,0,0,1,0,0,1,1
7025,164078,WsP1VDhZbOPlkd3sbnAsknbzVniUGVR6,SpATywNh6bZuzm8s1ceuBUnMUAeoAHHw,11,18,6,12,3,0,2,0,41,5.857142857142857,1,0.0,6,6,11,3,12,0,1,2,0,26,15,1
7026,164089,O3lqSpngMxAwSEkWjBn3tk145jZG19Vi,SpATywNh6bZuzm8s1ceuBUnMUAeoAHHw,8,8,5,0,4,1,5,1,24,3.4285714285714284,1,0.0,0,5,0,4,8,1,0,5,1,9,15,1
7027,164094,ndz80WiJUz0adE8axEB4JuY9X6KNPO7X,SpATywNh6bZuzm8s1ceuBUnMUAeoAHHw,1,0,0,0,0,0,1,0,1,0.14285714285714285,1,0.0,0,0,0,0,0,0,0,1,0,0,1,1
7028,164095,yPIqHEe4AecQ4GX5I2LJPYqjiV9xQfx2,SpATywNh6bZuzm8s1ceuBUnMUAeoAHHw,7,3,2,0,2,0,2,0,9,1.2857142857142858,1,0.0,0,2,0,2,3,0,0,2,0,4,5,1
7029,164097,yKlpCOv4oX3vHTFVM0BhF8OwgGT3xUhB,G8EPVSXsOYB5YQWZGiz1aVq5Pgr2GrQu,11,22,0,2,0,0,1,0,25,3.5714285714285716,1,0.0,6,0,2,0,16,0,0,1,0,8,17,0
7030,164105,UjuYob8V8C70Onzp78W1rkt8ybxbAbwx,RXDvfPUBYFlVdlueBFbLW0mhhAyGEqpt,9,4,3,0,1,2,5,1,16,2.2857142857142856,1,0.0,1,3,0,1,3,2,0,5,1,5,11,0
7031,164114,7ynsHGhJ1N4494Hez57ckblgtBNGbed9,bWdj2GDclj5ofokWjzoa5jAwMkxCykd6,7,2,1,0,0,24,12,2,41,5.857142857142857,1,0.0,0,1,0,0,2,24,0,12,2,1,40,1
7032,164128,3iB62eqNt3nRiXslxHuT1UtvhrRX1eLs,SpATywNh6bZuzm8s1ceuBUnMUAeoAHHw,14,19,14,0,8,10,10,3,64,9.142857142857142,1,0.0,0,14,0,8,19,10,0,10,3,22,42,0
7033,164135,blaKT90TeOTAa2RsAkTxWQqeLxEi93Qu,G8EPVSXsOYB5YQWZGiz1aVq5Pgr2GrQu,16,28,1,0,1,0,3,0,33,4.714285714285714,1,0.0,6,1,0,1,22,0,0,3,0,8,25,0
7034,164143,Rfx55so0bnrgOG7iRmEYhpikxS2TaZXD,SpATywNh6bZuzm8s1ceuBUnMUAeoAHHw,6,6,4,0,2,0,4,0,16,2.2857142857142856,1,0.0,0,4,0,2,6,0,0,4,0,6,10,1
7035,164152,DFbejjY7iFDbzUdxXNh2pDwgdrX3wa4i,SpATywNh6bZuzm8s1ceuBUnMUAeoAHHw,14,28,8,24,3,10,5,1,79,11.285714285714286,2,0.0,12,8,18,3,16,10,6,5,1,41,38,1
7036,164156,RJbtfdnDfiKYbXA54RnQnnmr6xKZwlkg,bWdj2GDclj5ofokWjzoa5jAwMkxCykd6,8,9,1,20,1,3,6,0,40,5.714285714285714,1,0.0,4,1,18,1,5,3,2,6,0,24,16,1
7037,164158,uZwtgzrFploohPWTfTTW4oFbLgraM3NM,RXDvfPUBYFlVdlueBFbLW0mhhAyGEqpt,5,6,4,0,1,0,1,0,12,1.7142857142857142,2,0.0,0,4,0,1,6,0,0,1,0,5,7,1
7038,164162,8rrasDTB21WkgxqQeAJWm6ZLoQBQi4Tp,SpATywNh6bZuzm8s1ceuBUnMUAeoAHHw,9,3,2,0,1,1,7,1,15,2.142857142857143,1,0.0,0,2,0,1,3,1,0,7,1,3,12,1
7039,164163,GY3gjlGW984FFVVjyCHJw8AVsx1rzHGL,SpATywNh6bZuzm8s1ceuBUnMUAeoAHHw,1,0,0,0,0,0,2,0,2,0.2857142857142857,1,0.0,0,0,0,0,0,0,0,2,0,0,2,1
7040,164167,g8GaCwXJUf6SPnVxk3h41vOpn1g2rMNj,SpATywNh6bZuzm8s1ceuBUnMUAeoAHHw,14,17,7,17,3,0,4,0,48,6.857142857142857,1,0.0,8,7,15,3,9,0,2,4,0,33,15,1
7041,164173,o3O6sFZEm4uYUPzBaiRjRHoiv6fwyQLX,bWdj2GDclj5ofokWjzoa5jAwMkxCykd6,11,7,5,0,3,0,6,0,21,3.0,2,0.0,1,5,0,3,6,0,0,6,0,9,12,1
7042,164180,Lwf7mfGJ3FePZ7LRuU8J3HhoGD7wCy3e,bWdj2GDclj5ofokWjzoa5jAwMkxCykd6,6,0,0,0,0,3,11,1,15,2.142857142857143,1,0.0,0,0,0,0,0,3,0,11,1,0,15,1
7043,164181,9Gcg3d2ByGJfHaOgn8q1nODMxGfTga0V,SpATywNh6bZuzm8s1ceuBUnMUAeoAHHw,4,2,1,0,1,0,1,0,5,0.7142857142857143,1,0.0,0,1,0,1,2,0,0,1,0,2,3,1
7044,164182,ztJdAnCpBgEgLx5fhRggF88Y3Pxlvyek,SpATywNh6bZuzm8s1ceuBUnMUAeoAHHw,5,5,1,0,1,0,1,0,8,1.1428571428571428,1,0.0,0,1,0,1,5,0,0,1,0,2,6,1
7045,164189,vFfdM0ONqhREkb5cy2nDN88l9Gb7gZxp,SpATywNh6bZuzm8s1ceuBUnMUAeoAHHw,12,14,7,9,4,2,17,0,53,7.571428571428571,1,0.0,3,7,7,4,11,2,2,17,0,21,32,1
7046,164190,9ygKD7mdzmGQqRwlKeL15CcGPS61a1pB,SpATywNh6bZuzm8s1ceuBUnMUAeoAHHw,1,0,0,0,0,0,1,0,1,0.14285714285714285,1,0.0,0,0,0,0,0,0,0,1,0,0,1,1
7047,164196,CXOtKVmMQojq2XNTO0iupqinfdnG9ZHO,SpATywNh6bZuzm8s1ceuBUnMUAeoAHHw,12,23,5,13,0,19,4,0,64,9.142857142857142,1,0.0,13,5,11,0,10,19,2,4,0,29,35,1
7048,164198,w0MOevkqL7TIdK3soXlSk0InhRt5D2OI,SpATywNh6bZuzm8s1ceuBUnMUAeoAHHw,7,15,0,0,0,10,5,0,30,4.285714285714286,3,0.0,1,0,0,0,14,10,0,5,0,1,29,1
7049,164199,Fk4hjEUqgyLHxBlk1cbfR9hWyVsJsJLo,bWdj2GDclj5ofokWjzoa5jAwMkxCykd6,6,5,2,0,2,0,1,0,10,1.4285714285714286,1,0.0,0,2,0,2,5,0,0,1,0,4,6,1
7050,164202,BlqNhk6hbhpwG32KfW3xxRFbNDrCRljo,bWdj2GDclj5ofokWjzoa5jAwMkxCykd6,9,18,11,0,0,16,19,3,67,9.571428571428571,2,0.0,0,11,0,0,18,16,0,19,3,11,56,1
7051,164204,Yp9LyEPv40Da5bhTi9YoLgYAzGahNHA7,RXDvfPUBYFlVdlueBFbLW0mhhAyGEqpt,13,19,14,0,6,2,5,0,46,6.571428571428571,2,0.0,1,14,0,6,18,2,0,5,0,21,25,1
7052,164211,o4jfOgo2dfLmNdqfH47BtVPD4gDTd4tS,RXDvfPUBYFlVdlueBFbLW0mhhAyGEqpt,3,0,0,0,0,4,5,0,9,1.2857142857142858,2,0.0,0,0,0,0,0,4,0,5,0,0,9,1
7053,164212,BqQvzvKumSuXZDEF5Fpfkr95tleas1E0,bWdj2GDclj5ofokWjzoa5jAwMkxCykd6,1,0,0,0,0,0,1,0,1,0.14285714285714285,1,0.0,0,0,0,0,0,0,0,1,0,0,1,1
7054,164213,wFvodFqghxL7iISMFbYXkYNq6P6eK5gH,RXDvfPUBYFlVdlueBFbLW0mhhAyGEqpt,6,5,0,0,0,0,6,0,11,1.5714285714285714,1,0.0,0,0,0,0,5,0,0,6,0,0,11,1
7055,164214,HDmenaP9dq5AQ9fnpOe9TUOGtyNR5hfW,bWdj2GDclj5ofokWjzoa5jAwMkxCykd6,5,2,1,0,1,0,4,0,8,1.1428571428571428,1,0.0,0,1,0,1,2,0,0,4,0,2,6,1
7056,164218,a8UKs1NxAK1Rc6mTIgzTKX0mHyAKUP88,G8EPVSXsOYB5YQWZGiz1aVq5Pgr2GrQu,12,14,5,8,4,0,1,0,32,4.571428571428571,1,0.0,8,5,5,4,6,0,3,1,0,22,10,1
7057,164219,cderIDaWBR3ykedbqXoG7yh75mThXkpL,SpATywNh6bZuzm8s1ceuBUnMUAeoAHHw,7,2,1,0,1,0,5,1,10,1.4285714285714286,1,0.0,0,1,0,1,2,0,0,5,1,2,8,1
7058,164223,dXCvdD4j2gSkM89QjHdpheWOht9HZ4w4,SpATywNh6bZuzm8s1ceuBUnMUAeoAHHw,13,12,4,20,3,0,2,0,41,5.857142857142857,1,0.0,7,4,16,3,5,0,4,2,0,30,11,1
7059,164226,ylaFiKTL5M7uyaxbJV4j95mbCqvhbcFS,G8EPVSXsOYB5YQWZGiz1aVq5Pgr2GrQu,26,98,3,26,8,26,8,1,170,24.285714285714285,2,0.0,27,3,23,8,71,26,3,8,1,61,109,1
7060,164229,m7lUxDgRiiqzb1cDzFb6FRFrHWjmnS0E,bWdj2GDclj5ofokWjzoa5jAwMkxCykd6,15,21,10,28,6,2,11,1,79,11.285714285714286,2,0.0,5,10,25,6,16,2,3,11,1,46,33,1
7061,164237,ZfIQYurnR6gJbWxLJ81cU3ZqzX4mpHm0,RXDvfPUBYFlVdlueBFbLW0mhhAyGEqpt,6,4,2,0,1,0,3,0,10,1.4285714285714286,1,0.0,0,2,0,1,4,0,0,3,0,3,7,1
7062,164238,mQPNS4mAXxHsb5X4ulTZ0rUofu82I30M,SpATywNh6bZuzm8s1ceuBUnMUAeoAHHw,4,0,0,0,0,1,4,0,5,0.7142857142857143,1,0.0,0,0,0,0,0,1,0,4,0,0,5,1
7063,164243,wFvodFqghxL7iISMFbYXkYNq6P6eK5gH,G8EPVSXsOYB5YQWZGiz1aVq5Pgr2GrQu,1,0,0,0,0,0,1,0,1,0.14285714285714285,1,0.0,0,0,0,0,0,0,0,1,0,0,1,1
7064,164253,s53Goue7PBVQuWwuk4njE0FTuXBFYzWT,bWdj2GDclj5ofokWjzoa5jAwMkxCykd6,5,2,1,0,1,0,2,0,6,0.8571428571428571,1,0.0,0,1,0,1,2,0,0,2,0,2,4,1
7065,164257,yLdwUTmew1kIx5gdbRjo7r2vOLkom0w2,RXDvfPUBYFlVdlueBFbLW0mhhAyGEqpt,1,0,0,0,0,0,1,0,1,0.14285714285714285,1,0.0,0,0,0,0,0,0,0,1,0,0,1,1
7066,164266,JHhY30IKFzw4LWcyrHuTEglWNqRkqdDU,G8EPVSXsOYB5YQWZGiz1aVq5Pgr2GrQu,16,13,7,22,3,0,7,0,52,7.428571428571429,1,0.0,6,7,19,3,7,0,3,7,0,35,17,1
7067,164273,wg7LkabhS9jTmBy5bEF3lQSLJkluKGUF,SpATywNh6bZuzm8s1ceuBUnMUAeoAHHw,5,2,1,0,1,0,2,0,6,0.8571428571428571,1,0.0,0,1,0,1,2,0,0,2,0,2,4,1
7068,164276,mdAxXzEXQEyyjCtALtGRFZS9oxIIimgr,G8EPVSXsOYB5YQWZGiz1aVq5Pgr2GrQu,1,0,0,0,0,0,5,0,5,0.7142857142857143,1,0.0,0,0,0,0,0,0,0,5,0,0,5,1
7069,164277,VCOGW9OE6DqAZaAneJJM4ZOSOc2aI6o3,SpATywNh6bZuzm8s1ceuBUnMUAeoAHHw,1,0,0,0,0,0,1,0,1,0.14285714285714285,1,0.0,0,0,0,0,0,0,0,1,0,0,1,1
7070,164283,44FzEVxwFpCY2dQQ0BkdyMwLoRQRjARq,bWdj2GDclj5ofokWjzoa5jAwMkxCykd6,5,2,1,0,1,0,2,0,6,0.8571428571428571,1,0.0,0,1,0,1,2,0,0,2,0,2,4,1
7071,164288,VD6TkymcxBFMdB1MoYEexj8K6lT6eEyR,SpATywNh6bZuzm8s1ceuBUnMUAeoAHHw,13,9,6,14,5,5,3,0,42,6.0,2,0.0,2,6,11,5,7,5,3,3,0,24,18,1
7072,164293,5iSY38QlsciL98g4h2hbNSbA8fYeSyCj,SpATywNh6bZuzm8s1ceuBUnMUAeoAHHw,5,6,2,0,1,0,2,0,11,1.5714285714285714,2,0.0,1,2,0,1,5,0,0,2,0,4,7,1
7073,164295,R6At1oAc7WZXNfKoQsgcMko62fJQGIiO,SpATywNh6bZuzm8s1ceuBUnMUAeoAHHw,2,0,0,0,0,0,2,0,2,0.2857142857142857,1,0.0,0,0,0,0,0,0,0,2,0,0,2,1
7074,164297,XpHgf5hU50AoSdtBhnyxR1OezCcdtpcw,SpATywNh6bZuzm8s1ceuBUnMUAeoAHHw,2,0,0,0,0,0,2,0,2,0.2857142857142857,1,0.0,0,0,0,0,0,0,0,2,0,0,2,1
7075,164299,4PiVkHMvtEasaFMOjyfke8CDtZnJS1Ch,G8EPVSXsOYB5YQWZGiz1aVq5Pgr2GrQu,5,1,1,0,1,0,2,0,5,0.7142857142857143,1,0.0,0,1,0,1,1,0,0,2,0,2,3,1
7076,164300,4pta5bIC2z8xvBYipNvHjqZfFKDEeM7X,SpATywNh6bZuzm8s1ceuBUnMUAeoAHHw,3,2,0,0,0,0,1,0,3,0.42857142857142855,1,0.0,0,0,0,0,2,0,0,1,0,0,3,0
7077,164304,P61EBU96iANevNQaamAZ1nmVdv1hlahG,RXDvfPUBYFlVdlueBFbLW0mhhAyGEqpt,5,2,1,0,1,0,2,0,6,0.8571428571428571,1,0.0,0,1,0,1,2,0,0,2,0,2,4,1
7078,164310,3kLiq8d9Yk709I1l6E6cFZpYQ45LBOgu,bWdj2GDclj5ofokWjzoa5jAwMkxCykd6,13,13,5,24,5,8,4,1,60,8.571428571428571,1,0.0,6,5,22,5,7,8,2,4,1,38,22,1
7079,164321,u889jcGO7u4YLeZfY23r5rctOxqBf6PA,SpATywNh6bZuzm8s1ceuBUnMUAeoAHHw,4,2,1,0,1,0,1,0,5,0.7142857142857143,1,0.0,0,1,0,1,2,0,0,1,0,2,3,1
7080,164323,KhocfHwmF39ufDx3XWH1QBLAW0hrIea9,SpATywNh6bZuzm8s1ceuBUnMUAeoAHHw,5,2,1,0,1,0,2,0,6,0.8571428571428571,1,0.0,0,1,0,1,2,0,0,2,0,2,4,1
7081,164326,Elyv0DBesmIDtda22RvPoYHZeyVOycgU,SpATywNh6bZuzm8s1ceuBUnMUAeoAHHw,13,16,5,13,3,0,5,0,42,6.0,2,0.0,6,5,13,3,10,0,0,5,0,27,15,0
7082,164333,pDmI6y2Fn3FHC3y8A6z8rbPnUAwXuAZ7,bWdj2GDclj5ofokWjzoa5jAwMkxCykd6,5,12,1,0,2,0,1,0,16,2.2857142857142856,2,0.0,2,1,0,2,10,0,0,1,0,5,11,1
7083,164338,vcmcxuoPWSwobaWPUxsfdhKEplWa2ces,SpATywNh6bZuzm8s1ceuBUnMUAeoAHHw,1,0,0,0,0,0,1,0,1,0.14285714285714285,1,0.0,0,0,0,0,0,0,0,1,0,0,1,1
7084,164341,vxGkTn6WfGBki29hwuSV6Xuc1hbgzs4I,bWdj2GDclj5ofokWjzoa5jAwMkxCykd6,1,0,0,0,0,0,1,0,1,0.14285714285714285,1,0.0,0,0,0,0,0,0,0,1,0,0,1,1
7085,164346,yB2j2tPO2DVKCBBdsLv8a1lbHtfWINMh,SpATywNh6bZuzm8s1ceuBUnMUAeoAHHw,7,14,7,0,5,0,3,0,29,4.142857142857143,3,0.0,1,7,0,5,13,0,0,3,0,13,16,1
7086,164356,MVnPWBm2d0gRS2GY8sfJnIUDF0K4iyE8,SpATywNh6bZuzm8s1ceuBUnMUAeoAHHw,1,0,0,0,0,0,1,0,1,0.14285714285714285,1,0.0,0,0,0,0,0,0,0,1,0,0,1,1
7087,164357,JsqrqubnjjSuqmmuivzKTDyASkdX1tsp,bWdj2GDclj5ofokWjzoa5jAwMkxCykd6,4,2,1,0,1,0,1,0,5,0.7142857142857143,1,0.0,0,1,0,1,2,0,0,1,0,2,3,1
7088,164378,Gt7xzQhw88EwESh7Xb4lU1zFZmxNJNIK,SpATywNh6bZuzm8s1ceuBUnMUAeoAHHw,9,7,4,0,1,2,7,1,22,3.142857142857143,2,0.0,0,4,0,1,7,2,0,7,1,5,17,1
7089,164387,ocTIjxG8zBs0mQRpUtpuAKc7MDpzU7Sd,SpATywNh6bZuzm8s1ceuBUnMUAeoAHHw,18,37,15,16,4,54,21,4,151,21.571428571428573,5,0.0,12,15,14,4,25,54,2,21,4,45,106,0
7090,164395,TAkEj78WoaHvO22LXzTn955rJBXiVudz,SpATywNh6bZuzm8s1ceuBUnMUAeoAHHw,1,0,0,0,0,0,1,0,1,0.14285714285714285,1,0.0,0,0,0,0,0,0,0,1,0,0,1,1
7091,164400,PUS8mu8K3BWjJGC8YlXjmQjHGQC9v5P9,SpATywNh6bZuzm8s1ceuBUnMUAeoAHHw,6,6,1,0,0,0,2,0,9,1.2857142857142858,1,0.0,0,1,0,0,6,0,0,2,0,1,8,1
7092,164403,ORIXOLqWtzi0s28E5aG42qOb01NSXSRE,SpATywNh6bZuzm8s1ceuBUnMUAeoAHHw,1,0,0,0,0,0,1,0,1,0.14285714285714285,1,0.0,0,0,0,0,0,0,0,1,0,0,1,1
7093,164404,mR38LOzPkDgy4Z7CZO92yHt4TSlNwfzC,bWdj2GDclj5ofokWjzoa5jAwMkxCykd6,14,31,1,50,1,12,23,6,124,17.714285714285715,3,0.0,10,1,45,1,21,12,5,23,6,57,67,1
7094,164407,KFG6G55toGAeaWBt5UmyioW5n1NVxSjT,SpATywNh6bZuzm8s1ceuBUnMUAeoAHHw,6,6,4,0,3,0,3,0,16,2.2857142857142856,1,0.0,0,4,0,3,6,0,0,3,0,7,9,1
7095,164411,y0PkAopIdLmRFrkWC9eBHvWT77KfVWMh,G8EPVSXsOYB5YQWZGiz1aVq5Pgr2GrQu,7,15,8,0,6,4,11,0,44,6.285714285714286,2,0.0,1,8,0,6,14,4,0,11,0,15,29,1
7096,164412,Z8r3kWGF2ZuWSy5TZGg00SEG4qfRh2Ag,bWdj2GDclj5ofokWjzoa5jAwMkxCykd6,5,6,3,0,1,0,5,0,15,2.142857142857143,3,0.0,0,3,0,1,6,0,0,5,0,4,11,1
7097,164415,GJ6G7nOOlt6NQXt3GWs6ppYe9Y1fZaES,bWdj2GDclj5ofokWjzoa5jAwMkxCykd6,1,0,0,0,0,0,1,0,1,0.14285714285714285,1,0.0,0,0,0,0,0,0,0,1,0,0,1,1
7098,164425,GJ6G7nOOlt6NQXt3GWs6ppYe9Y1fZaES,SpATywNh6bZuzm8s1ceuBUnMUAeoAHHw,1,0,0,0,0,0,1,0,1,0.14285714285714285,1,0.0,0,0,0,0,0,0,0,1,0,0,1,1
7099,164433,kaAc9OSRmTYmUacyuwJF8uvWHTHZhU6I,RXDvfPUBYFlVdlueBFbLW0mhhAyGEqpt,27,17,11,35,8,0,1,0,72,10.285714285714286,1,0.0,5,11,31,8,12,0,4,1,0,55,17,1
7100,164435,notZnFUBIqcbpWIYWbyK9wwcfdCEbsj2,RXDvfPUBYFlVdlueBFbLW0mhhAyGEqpt,6,2,1,0,1,0,3,0,7,1.0,1,0.0,0,1,0,1,2,0,0,3,0,2,5,1
7101,164436,Dqr6qIWfTOfWtI2PbseZL8Rm5WmdZOyL,SpATywNh6bZuzm8s1ceuBUnMUAeoAHHw,8,12,0,15,0,23,1,0,51,7.285714285714286,1,0.0,6,0,14,0,6,23,1,1,0,20,31,1
7102,164444,R7nlNg2K1A6D7NxbdpuHIgXqttVlWJcu,RXDvfPUBYFlVdlueBFbLW0mhhAyGEqpt,1,0,0,0,0,0,1,0,1,0.14285714285714285,1,0.0,0,0,0,0,0,0,0,1,0,0,1,1
7103,164447,JfftjOGdDbpgbrupi0Gwr899R0jzXikJ,bWdj2GDclj5ofokWjzoa5jAwMkxCykd6,11,16,8,0,4,5,9,2,44,6.285714285714286,4,0.0,0,8,0,4,16,5,0,9,2,12,32,1
7104,164452,LLZV0fRwNBkHHCO0iJlbUS4AGPQGvo8C,SpATywNh6bZuzm8s1ceuBUnMUAeoAHHw,10,15,0,14,1,0,2,0,32,4.571428571428571,1,0.0,8,0,13,1,7,0,1,2,0,22,10,1
7105,164456,QYjw7Y4e4Czbt9G691x4dA9fq3fXHjUR,bWdj2GDclj5ofokWjzoa5jAwMkxCykd6,6,2,1,0,1,7,6,0,17,2.4285714285714284,2,0.0,0,1,0,1,2,7,0,6,0,2,15,1
7106,164457,RNMplhTvSIPFgFZTfBAvIrYzbjwGfRpO,RXDvfPUBYFlVdlueBFbLW0mhhAyGEqpt,16,17,9,6,6,0,8,8,54,7.714285714285714,2,0.0,2,9,6,6,15,0,0,8,8,23,31,1
7107,164474,WLXtV9xU02TWrBcV5JQ79YomKzdOBWBA,bWdj2GDclj5ofokWjzoa5jAwMkxCykd6,3,3,1,0,0,0,1,0,5,0.7142857142857143,1,0.0,0,1,0,0,3,0,0,1,0,1,4,1
7108,164475,PrXGfRfcXAOp5eyOk9i7xyvPZyDLOEXf,SpATywNh6bZuzm8s1ceuBUnMUAeoAHHw,1,0,0,0,0,0,1,0,1,0.14285714285714285,1,0.0,0,0,0,0,0,0,0,1,0,0,1,1
7109,164476,1QkcpD1DfxC2p3XNS9AeGnCICPIyGC1C,SpATywNh6bZuzm8s1ceuBUnMUAeoAHHw,6,3,2,0,2,0,1,0,8,1.1428571428571428,1,0.0,0,2,0,2,3,0,0,1,0,4,4,1
7110,164478,lcxEu4F2dIRGolbGM8J7dkDro6hPXvBJ,SpATywNh6bZuzm8s1ceuBUnMUAeoAHHw,12,21,9,8,1,4,11,0,54,7.714285714285714,2,0.0,8,9,8,1,13,4,0,11,0,26,28,0
7111,164487,NA8Wgtfbm0wtXt1SByxQO0XvsqhkLzxE,SpATywNh6bZuzm8s1ceuBUnMUAeoAHHw,5,3,1,0,1,0,1,0,6,0.8571428571428571,1,0.0,0,1,0,1,3,0,0,1,0,2,4,1
7112,164489,rZSqEDajDij6VIcQBEDrdSlRO8swoKNK,SpATywNh6bZuzm8s1ceuBUnMUAeoAHHw,7,1,1,0,1,1,4,1,9,1.2857142857142858,1,0.0,0,1,0,1,1,1,0,4,1,2,7,1
7113,164491,Gcm2rqLAF1kWEJPfH2gzQRI0pndoww3G,bWdj2GDclj5ofokWjzoa5jAwMkxCykd6,8,8,5,0,3,0,6,0,22,3.142857142857143,2,0.0,0,5,0,3,8,0,0,6,0,8,14,1
7114,164492,p3tXqS62uMFoMZgoBWInrsBqScyEVB75,RXDvfPUBYFlVdlueBFbLW0mhhAyGEqpt,9,13,6,0,4,1,13,3,40,5.714285714285714,1,0.0,0,6,0,4,13,1,0,13,3,10,30,1
7115,164497,r0yZNwEG828V0TMkCl61Reya5Y5HO5aR,SpATywNh6bZuzm8s1ceuBUnMUAeoAHHw,13,16,8,0,4,2,8,2,40,5.714285714285714,2,0.0,0,8,0,4,16,2,0,8,2,12,28,1
7116,164505,yL460nvgMDqeAUMg6jxieurwSdj92YoI,SpATywNh6bZuzm8s1ceuBUnMUAeoAHHw,12,17,0,20,1,35,5,1,79,11.285714285714286,3,0.0,5,0,16,1,12,35,4,5,1,22,57,1
7117,164513,AaS8GsfaaiK26oA6b0QdGhs8opVCkjvV,RXDvfPUBYFlVdlueBFbLW0mhhAyGEqpt,1,0,0,0,0,0,1,0,1,0.14285714285714285,1,0.0,0,0,0,0,0,0,0,1,0,0,1,1
7118,164515,7wCkCmm5cR5EEXcCUnyxM6sXtrHGDdV9,SpATywNh6bZuzm8s1ceuBUnMUAeoAHHw,6,3,0,0,1,0,2,0,6,0.8571428571428571,1,0.0,0,0,0,1,3,0,0,2,0,1,5,1
7119,164516,kdAMRS8ek5nIImAJzh3SQaTESbJTFYQj,SpATywNh6bZuzm8s1ceuBUnMUAeoAHHw,14,10,5,9,3,0,5,2,34,4.857142857142857,1,0.0,3,5,8,3,7,0,1,5,2,19,15,1
7120,164522,KsAGy1yiN8nYXJpS6DHcH3mgCmV9iuno,RXDvfPUBYFlVdlueBFbLW0mhhAyGEqpt,7,4,3,0,2,0,1,0,10,1.4285714285714286,1,0.0,0,3,0,2,4,0,0,1,0,5,5,1
7121,164523,plzzrHT4KCGyPPQGvIdYTvuIq5SPXcu1,RXDvfPUBYFlVdlueBFbLW0mhhAyGEqpt,7,1,1,0,1,2,9,2,16,2.2857142857142856,1,0.0,0,1,0,1,1,2,0,9,2,2,14,1
7122,164524,T9Cyxm8vF5hMWVEQAwASNLuJdzjdg5o1,SpATywNh6bZuzm8s1ceuBUnMUAeoAHHw,1,0,0,0,0,0,1,0,1,0.14285714285714285,1,0.0,0,0,0,0,0,0,0,1,0,0,1,1
7123,164529,Ldp7KDHbr0atRXYQ3DSiKhwRPw9nfvPl,SpATywNh6bZuzm8s1ceuBUnMUAeoAHHw,1,0,0,0,0,0,1,0,1,0.14285714285714285,1,0.0,0,0,0,0,0,0,0,1,0,0,1,1
7124,164534,8yNyyy8aPKd19nuqwaynaLkU67KuROpn,SpATywNh6bZuzm8s1ceuBUnMUAeoAHHw,4,3,1,0,1,0,1,0,6,0.8571428571428571,1,0.0,0,1,0,1,3,0,0,1,0,2,4,1
7125,164537,9poFqdhDn1jEwJp6tGIQlD3gMA14zAqO,RXDvfPUBYFlVdlueBFbLW0mhhAyGEqpt,15,29,0,13,1,0,5,0,48,6.857142857142857,3,0.0,1,0,13,1,28,0,0,5,0,15,33,1
7126,164539,TMVDThY2bkgDg7sHqM0GQP2XTTPMcYfY,SpATywNh6bZuzm8s1ceuBUnMUAeoAHHw,8,6,3,0,2,7,4,0,22,3.142857142857143,1,0.0,0,3,0,2,6,7,0,4,0,5,17,1
7127,164542,8p1yDT05QCsKrFjaE90DCIRByQyt5uxS,bWdj2GDclj5ofokWjzoa5jAwMkxCykd6,5,2,0,0,0,0,3,0,5,0.7142857142857143,1,0.0,0,0,0,0,2,0,0,3,0,0,5,1
7128,164552,SOZQ09msP4gFSDHArJmMSKrG8q4wIkm6,bWdj2GDclj5ofokWjzoa5jAwMkxCykd6,5,3,1,0,1,0,2,0,7,1.0,1,0.0,0,1,0,1,3,0,0,2,0,2,5,1
7129,164557,xN8qQh9NkfWvTtFHmPyQN8TpX680eL1v,SpATywNh6bZuzm8s1ceuBUnMUAeoAHHw,8,4,3,0,3,0,1,0,11,1.5714285714285714,1,0.0,0,3,0,3,4,0,0,1,0,6,5,1
7130,164565,s6KPq1RjdqeVgQrh8kntPjnSOHQAM1j3,SpATywNh6bZuzm8s1ceuBUnMUAeoAHHw,4,4,1,0,0,2,2,0,9,1.2857142857142858,2,0.0,0,1,0,0,4,2,0,2,0,1,8,1
7131,164568,y79Bz5Pe0nNA2zswV3Szg0JL3sj7FjTw,SpATywNh6bZuzm8s1ceuBUnMUAeoAHHw,7,8,0,10,0,1,1,0,20,2.857142857142857,1,0.0,4,0,9,0,4,1,1,1,0,13,7,1
7132,164575,bNBhDpviOcrLuVFG9Qda6S7fiYJ6jIvc,RXDvfPUBYFlVdlueBFbLW0mhhAyGEqpt,16,16,12,11,7,0,5,0,51,7.285714285714286,1,0.0,1,12,9,7,15,0,2,5,0,29,22,1
7133,164576,mFgVeo284zyRw0AHsEf7Tlutzf0jRu5y,G8EPVSXsOYB5YQWZGiz1aVq5Pgr2GrQu,38,42,24,38,15,0,12,2,133,19.0,3,0.0,12,24,26,15,30,0,12,12,2,77,56,1
7134,164583,4M7imMvvjejITdlkdL2tmwikUUTIrCPh,SpATywNh6bZuzm8s1ceuBUnMUAeoAHHw,5,2,1,0,1,3,2,0,9,1.2857142857142858,1,0.0,0,1,0,1,2,3,0,2,0,2,7,1
7135,164586,z1G7LpYxsjwTZY4hppMJzutv7SFcW56t,bWdj2GDclj5ofokWjzoa5jAwMkxCykd6,5,8,5,0,3,1,3,0,20,2.857142857142857,2,0.0,0,5,0,3,8,1,0,3,0,8,12,1
7136,164588,LqURTBP4yk5vSqNo0hCLASnfQyzdI5Pp,SpATywNh6bZuzm8s1ceuBUnMUAeoAHHw,5,7,0,0,0,1,2,0,10,1.4285714285714286,1,0.0,0,0,0,0,7,1,0,2,0,0,10,1
7137,164596,huVRXsZzo8sJwzNaUCXkQqT8IVauIRmI,G8EPVSXsOYB5YQWZGiz1aVq5Pgr2GrQu,5,3,1,0,1,0,1,0,6,0.8571428571428571,1,0.0,0,1,0,1,3,0,0,1,0,2,4,1
7138,164599,3eIemZUCKErDOaY2n5eaZc2Nb7KmqL3h,SpATywNh6bZuzm8s1ceuBUnMUAeoAHHw,7,3,1,0,1,0,4,0,9,1.2857142857142858,1,0.0,0,1,0,1,3,0,0,4,0,2,7,1
7139,164604,D5T00vfAoymuLZctUEYUqWRUSFLxc6S2,SpATywNh6bZuzm8s1ceuBUnMUAeoAHHw,17,13,8,6,5,0,16,9,57,8.142857142857142,1,0.0,2,8,6,5,11,0,0,16,9,21,36,1
7140,164609,KGwvzr0w0g2Ui1Ce7HWqcTPb5LubNTcC,bWdj2GDclj5ofokWjzoa5jAwMkxCykd6,16,26,11,132,7,0,7,0,183,26.142857142857142,1,0.0,14,11,128,7,12,0,4,7,0,160,23,1
7141,164612,vMgdrowUhfs65egdim3M3Ibio1bafxKv,SpATywNh6bZuzm8s1ceuBUnMUAeoAHHw,3,2,0,0,0,0,1,0,3,0.42857142857142855,1,0.0,0,0,0,0,2,0,0,1,0,0,3,1
7142,164614,Ia1CTpUugiWywdlf9kz3F5HfoicyRI2a,SpATywNh6bZuzm8s1ceuBUnMUAeoAHHw,10,12,0,22,0,0,8,0,42,6.0,1,0.0,6,0,17,0,6,0,5,8,0,23,19,1
7143,164618,GMzSpgZQ6jzVsfHn8W8i83JsYNxnP00b,bWdj2GDclj5ofokWjzoa5jAwMkxCykd6,3,2,0,0,0,0,1,0,3,0.42857142857142855,1,0.0,0,0,0,0,2,0,0,1,0,0,3,1
7144,164621,OK36i7c8u9GmSfG9DXL0YN94pRFkcmzE,bWdj2GDclj5ofokWjzoa5jAwMkxCykd6,10,14,4,62,3,0,3,1,87,12.428571428571429,1,0.0,9,4,62,3,5,0,0,3,1,78,9,1
7145,164623,rk9NUxSXr4iC638u7CUrQUKNTm3BCpYr,bWdj2GDclj5ofokWjzoa5jAwMkxCykd6,5,5,0,0,0,0,2,0,7,1.0,1,0.0,0,0,0,0,5,0,0,2,0,0,7,1
7146,164624,h3Oxw2qM6MZeJxbxgclKfxWrkznzqR3o,SpATywNh6bZuzm8s1ceuBUnMUAeoAHHw,1,0,0,0,0,0,1,0,1,0.14285714285714285,1,0.0,0,0,0,0,0,0,0,1,0,0,1,1
7147,164625,9BDe6DEjC6kCZdUf85MYhGs6ssX3Yd66,SpATywNh6bZuzm8s1ceuBUnMUAeoAHHw,2,0,0,0,0,0,2,0,2,0.2857142857142857,1,0.0,0,0,0,0,0,0,0,2,0,0,2,1
7148,164629,SVcpJb6gXZcQDuOEWDQYFqv2P86R1Xaj,bWdj2GDclj5ofokWjzoa5jAwMkxCykd6,1,0,0,0,0,0,2,0,2,0.2857142857142857,1,0.0,0,0,0,0,0,0,0,2,0,0,2,1
7149,164630,MWkXS8wTteiq3wnUOJQXQCzRJDoS4fUl,SpATywNh6bZuzm8s1ceuBUnMUAeoAHHw,8,11,1,0,1,2,8,2,25,3.5714285714285716,2,0.0,0,1,0,1,11,2,0,8,2,2,23,1
7150,164633,jQaCxlcrIW3B0ti76HtzjtRZOLJHPbzy,SpATywNh6bZuzm8s1ceuBUnMUAeoAHHw,6,8,4,0,0,0,1,0,13,1.8571428571428572,1,0.0,0,4,0,0,8,0,0,1,0,4,9,1
7151,164639,ZRcEnEYSSBQbkjzMu7sidjbxasfrmw8l,bWdj2GDclj5ofokWjzoa5jAwMkxCykd6,3,6,1,0,1,0,1,0,9,1.2857142857142858,1,0.0,2,1,0,1,4,0,0,1,0,4,5,1
7152,164650,WQKKwzu8xDLLktMRV89tUbRag4kJ87WF,SpATywNh6bZuzm8s1ceuBUnMUAeoAHHw,11,6,3,0,2,1,5,1,18,2.5714285714285716,1,0.0,0,3,0,2,6,1,0,5,1,5,13,1
7153,164652,pOBmP02v5rRyUAaKAfr6us8i87HHPyHg,G8EPVSXsOYB5YQWZGiz1aVq5Pgr2GrQu,7,4,2,0,2,0,5,0,13,1.8571428571428572,2,0.0,0,2,0,2,4,0,0,5,0,4,9,1
7154,164654,kW1xniKv3zwqO5oh82gt2iROU6EwbCnD,bWdj2GDclj5ofokWjzoa5jAwMkxCykd6,9,5,1,18,1,0,3,0,28,4.0,1,0.0,2,1,17,1,3,0,1,3,0,21,7,1
7155,164662,4lIBX7jVNURqeuVw7y54KWNhg5lYseZ6,SpATywNh6bZuzm8s1ceuBUnMUAeoAHHw,8,7,5,0,1,0,3,0,16,2.2857142857142856,2,0.0,0,5,0,1,7,0,0,3,0,6,10,1
7156,164669,Ib8KHMHKfyTwrkbnwsSOuVq4nV1vOamx,bWdj2GDclj5ofokWjzoa5jAwMkxCykd6,6,6,1,0,2,0,2,0,11,1.5714285714285714,1,0.0,3,1,0,2,3,0,0,2,0,6,5,1
7157,164672,JnItsaXrVUFk1SorJ52og61s5dE3TwDr,SpATywNh6bZuzm8s1ceuBUnMUAeoAHHw,13,18,2,15,0,0,7,1,43,6.142857142857143,2,0.0,8,2,14,0,10,0,1,7,1,24,19,1
7158,164694,uUMf8oHT3hYC8oh9guwKDiIUlL3eooGH,RXDvfPUBYFlVdlueBFbLW0mhhAyGEqpt,6,5,0,0,0,0,1,0,6,0.8571428571428571,1,0.0,0,0,0,0,5,0,0,1,0,0,6,1
7159,164698,xKvX1ldWoix080dPRcCCrhtY6KsUvocI,SpATywNh6bZuzm8s1ceuBUnMUAeoAHHw,6,3,2,0,1,0,3,0,9,1.2857142857142858,2,0.0,0,2,0,1,3,0,0,3,0,3,6,1
7160,164708,QRKDYncXtzqUo7eYzl5ZNiNJ63G2lU5V,bWdj2GDclj5ofokWjzoa5jAwMkxCykd6,3,3,1,0,0,0,2,0,6,0.8571428571428571,1,0.0,0,1,0,0,3,0,0,2,0,1,5,1
7161,164710,T4zdcGe48q1WGzA0YIvniMTWo2k6dk59,SpATywNh6bZuzm8s1ceuBUnMUAeoAHHw,3,2,0,0,0,0,1,0,3,0.42857142857142855,1,0.0,0,0,0,0,2,0,0,1,0,0,3,1
7162,164715,D5IkCYseUCO88GE1B1rMaRAAZyqCPk5T,G8EPVSXsOYB5YQWZGiz1aVq5Pgr2GrQu,1,0,0,0,0,0,1,0,1,0.14285714285714285,1,0.0,0,0,0,0,0,0,0,1,0,0,1,1
7163,164718,YHt0dZJFvCE3vP08l7NFcQ3cbtNDgaRS,SpATywNh6bZuzm8s1ceuBUnMUAeoAHHw,7,6,3,0,2,0,3,0,14,2.0,1,0.0,0,3,0,2,6,0,0,3,0,5,9,1
7164,164720,6CAW15U7onmNe5U8VRNHyhImgcvFA6AP,G8EPVSXsOYB5YQWZGiz1aVq5Pgr2GrQu,7,3,2,0,2,0,2,0,9,1.2857142857142858,1,0.0,0,2,0,2,3,0,0,2,0,4,5,1
7165,164721,WhbpJZxh93gnEo0Bkb56Vi4OStNv0BeR,G8EPVSXsOYB5YQWZGiz1aVq5Pgr2GrQu,6,4,2,0,1,0,2,0,9,1.2857142857142858,1,0.0,0,2,0,1,4,0,0,2,0,3,6,1
7166,164725,dpMiuMIGfVjkJNBGAa2GW5Vztul0ul4C,SpATywNh6bZuzm8s1ceuBUnMUAeoAHHw,14,26,6,23,2,19,6,0,82,11.714285714285714,2,0.0,15,6,20,2,11,19,3,6,0,43,39,1
7167,164731,haO9EV3Nk4mk3OeBYKT0QOiPfUTqVhFn,SpATywNh6bZuzm8s1ceuBUnMUAeoAHHw,10,16,0,6,0,0,2,0,24,3.4285714285714284,1,0.0,4,0,6,0,12,0,0,2,0,10,14,1
7168,164737,IaoTQrvjcHkJTQC9F8CfKXXVgVZXu8JB,SpATywNh6bZuzm8s1ceuBUnMUAeoAHHw,5,2,1,0,1,0,5,0,9,1.2857142857142858,1,0.0,0,1,0,1,2,0,0,5,0,2,7,1
7169,164746,ikRlhkwZCU39UKjMqWVQGSSX3n2hrElG,SpATywNh6bZuzm8s1ceuBUnMUAeoAHHw,1,0,0,0,0,0,2,0,2,0.2857142857142857,1,0.0,0,0,0,0,0,0,0,2,0,0,2,1
7170,164749,DVyimdGTTnbLGYwEpoGlJAG1kt7yY9fR,SpATywNh6bZuzm8s1ceuBUnMUAeoAHHw,4,2,1,0,1,0,1,0,5,0.7142857142857143,1,0.0,0,1,0,1,2,0,0,1,0,2,3,1
7171,164755,hgQRm8OL4JkmLyk7gplu1M4NKLxrHiyO,SpATywNh6bZuzm8s1ceuBUnMUAeoAHHw,4,2,1,0,1,0,1,0,5,0.7142857142857143,1,0.0,0,1,0,1,2,0,0,1,0,2,3,1
7172,164769,w14rTBVaKAEl5wo1WnNS26mWscctUzrO,SpATywNh6bZuzm8s1ceuBUnMUAeoAHHw,13,11,5,14,4,1,2,0,37,5.285714285714286,1,0.0,5,5,12,4,6,1,2,2,0,26,11,1
7173,164771,qOfaZTBIbb7J17xXt4ZWUinnClou9TNY,SpATywNh6bZuzm8s1ceuBUnMUAeoAHHw,13,19,0,17,0,11,11,2,60,8.571428571428571,1,0.0,13,0,15,0,6,11,2,11,2,28,32,1
7174,164775,s8rbNwiDb6Ued6nUvpbwuDl2s256fOiD,bWdj2GDclj5ofokWjzoa5jAwMkxCykd6,8,4,1,0,1,1,5,1,13,1.8571428571428572,1,0.0,0,1,0,1,4,1,0,5,1,2,11,1
7175,164791,6aBFBdVzdNrq3IlbLV8DRjoHXWBDTkRv,bWdj2GDclj5ofokWjzoa5jAwMkxCykd6,1,0,0,0,0,0,1,0,1,0.14285714285714285,1,0.0,0,0,0,0,0,0,0,1,0,0,1,1
7176,164793,VD6TkymcxBFMdB1MoYEexj8K6lT6eEyR,bWdj2GDclj5ofokWjzoa5jAwMkxCykd6,9,6,2,18,2,13,5,1,47,6.714285714285714,1,0.0,3,2,18,2,3,13,0,5,1,25,22,1
7177,164798,jmSgKLjYRvCwLEN3cPhxDpejaRW1URFZ,SpATywNh6bZuzm8s1ceuBUnMUAeoAHHw,4,2,1,0,1,0,1,0,5,0.7142857142857143,1,0.0,0,1,0,1,2,0,0,1,0,2,3,1
7178,164799,pPZkiQmDPKqQ9IZ0jTf8ExIfHdZSz9Tp,SpATywNh6bZuzm8s1ceuBUnMUAeoAHHw,14,18,7,18,4,11,5,1,64,9.142857142857142,2,0.0,9,7,15,4,9,11,3,5,1,35,29,1
7179,164800,Exq64VXC5vAwuYwY4YHzQg0BjMOxcioB,G8EPVSXsOYB5YQWZGiz1aVq5Pgr2GrQu,1,0,0,0,0,0,1,0,1,0.14285714285714285,1,0.0,0,0,0,0,0,0,0,1,0,0,1,1
7180,164805,BBfiARXlf8DQ4mmAXStqrzMqGcJUzid6,bWdj2GDclj5ofokWjzoa5jAwMkxCykd6,4,4,0,0,0,1,1,0,6,0.8571428571428571,1,0.0,0,0,0,0,4,1,0,1,0,0,6,1
7181,164807,aKmGG28IIMsmRYbcnkO5kp7ipo4I9wj0,bWdj2GDclj5ofokWjzoa5jAwMkxCykd6,1,0,0,0,0,0,1,0,1,0.14285714285714285,1,0.0,0,0,0,0,0,0,0,1,0,0,1,1
7182,164813,cZWFemuqv22LyBzJ62hqYFI8OPrcmsVO,RXDvfPUBYFlVdlueBFbLW0mhhAyGEqpt,1,0,0,0,0,0,1,0,1,0.14285714285714285,1,0.0,0,0,0,0,0,0,0,1,0,0,1,1
7183,164816,2uLwwxMo6zi7FYS0noJqK7cA1dw8HmPb,SpATywNh6bZuzm8s1ceuBUnMUAeoAHHw,1,0,0,0,0,0,1,0,1,0.14285714285714285,1,0.0,0,0,0,0,0,0,0,1,0,0,1,1
7184,164817,WTwb8dUqzcP0BlBT1I9MZd2r9gTEXFM0,bWdj2GDclj5ofokWjzoa5jAwMkxCykd6,5,2,1,0,1,0,2,0,6,0.8571428571428571,1,0.0,0,1,0,1,2,0,0,2,0,2,4,1
7185,164818,7xT79xUxciGCPT2px4CYK4DLm3lIDEn8,bWdj2GDclj5ofokWjzoa5jAwMkxCykd6,3,2,1,0,0,0,1,0,4,0.5714285714285714,1,0.0,0,1,0,0,2,0,0,1,0,1,3,1
7186,164819,td1qPqbY65yQMbPFzvqLZhtQGNGi89Aa,SpATywNh6bZuzm8s1ceuBUnMUAeoAHHw,16,16,9,19,3,0,12,1,60,8.571428571428571,2,0.0,6,9,16,3,10,0,3,12,1,34,26,1
7187,164820,opdILbT2IBFIYJvyIT5NXM7ymKeuMTcM,bWdj2GDclj5ofokWjzoa5jAwMkxCykd6,4,3,2,0,2,0,3,0,10,1.4285714285714286,1,0.0,0,2,0,2,3,0,0,3,0,4,6,1
7188,164823,xdClWt95AonMUbXmVncDz7pyQAF4u9BG,SpATywNh6bZuzm8s1ceuBUnMUAeoAHHw,4,2,0,0,0,0,3,0,5,0.7142857142857143,1,0.0,0,0,0,0,2,0,0,3,0,0,5,1
7189,164825,IfM7NFN1EcMfjBhCGt0UvdSV1gN33bRZ,bWdj2GDclj5ofokWjzoa5jAwMkxCykd6,2,0,0,0,0,0,4,0,4,0.5714285714285714,1,0.0,0,0,0,0,0,0,0,4,0,0,4,1
7190,164828,v7OTUgukPaXTchqClaPcgxRHfeAHlZs8,SpATywNh6bZuzm8s1ceuBUnMUAeoAHHw,9,4,3,0,2,0,3,1,13,1.8571428571428572,1,0.0,0,3,0,2,4,0,0,3,1,5,8,1
7191,164831,yNygMjDRQbsmQrkdzv6Ni3gEhrA9rC9T,RXDvfPUBYFlVdlueBFbLW0mhhAyGEqpt,2,0,0,0,0,0,2,0,2,0.2857142857142857,1,0.0,0,0,0,0,0,0,0,2,0,0,2,1
7192,164832,DmjOQ53VXOobMBTmNf8WzrNOpoPBXteN,G8EPVSXsOYB5YQWZGiz1aVq5Pgr2GrQu,10,9,3,0,3,0,3,0,18,2.5714285714285716,2,0.0,0,3,0,3,9,0,0,3,0,6,12,1
7193,164833,Vdk84P68xIHXBGrWqw3oEozZYT063dLv,bWdj2GDclj5ofokWjzoa5jAwMkxCykd6,6,2,1,0,1,0,3,0,7,1.0,1,0.0,0,1,0,1,2,0,0,3,0,2,5,1
7194,164839,k0fNZidBUd2gbryk31YveUTLLwvsjsHF,bWdj2GDclj5ofokWjzoa5jAwMkxCykd6,6,5,2,56,1,0,1,0,65,9.285714285714286,1,0.0,2,2,55,1,3,0,1,1,0,60,5,1
7195,164840,MSOPexvB5Mxvh6qEAn5PDvoAxMalQijS,SpATywNh6bZuzm8s1ceuBUnMUAeoAHHw,8,3,2,0,2,0,3,0,10,1.4285714285714286,1,0.0,0,2,0,2,3,0,0,3,0,4,6,1
7196,164843,oVaXXkgNP2VtEgRht0YdjYINkh8LeLTs,bWdj2GDclj5ofokWjzoa5jAwMkxCykd6,7,4,1,0,0,0,4,0,9,1.2857142857142858,1,0.0,0,1,0,0,4,0,0,4,0,1,8,1
7197,164854,iCakYP1w40pz3A1o7VgcbnomKTMQfUiT,RXDvfPUBYFlVdlueBFbLW0mhhAyGEqpt,1,0,0,0,0,0,1,0,1,0.14285714285714285,1,0.0,0,0,0,0,0,0,0,1,0,0,1,1
7198,164859,dgFOOUSNfQK8xIrT47Av0Q04bBFeE21W,SpATywNh6bZuzm8s1ceuBUnMUAeoAHHw,6,3,1,0,1,0,4,0,9,1.2857142857142858,2,0.0,0,1,0,1,3,0,0,4,0,2,7,1
7199,164870,6lI1WuhNHXlfVKzmWVMcaMqLcjUDqRef,SpATywNh6bZuzm8s1ceuBUnMUAeoAHHw,13,17,10,0,6,4,12,1,50,7.142857142857143,2,0.0,5,10,0,6,12,4,0,12,1,21,29,1
7200,164877,jqdafBVztOaU7B8oBuajiXxvz1FDItGv,RXDvfPUBYFlVdlueBFbLW0mhhAyGEqpt,1,0,0,0,0,0,1,0,1,0.14285714285714285,1,0.0,0,0,0,0,0,0,0,1,0,0,1,1
7201,164884,1vSzQDGr3DRQD3m17X46GyHlBw9UnL8Y,SpATywNh6bZuzm8s1ceuBUnMUAeoAHHw,5,2,1,0,1,0,2,0,6,0.8571428571428571,1,0.0,0,1,0,1,2,0,0,2,0,2,4,1
7202,164885,qOfaZTBIbb7J17xXt4ZWUinnClou9TNY,G8EPVSXsOYB5YQWZGiz1aVq5Pgr2GrQu,1,0,0,0,0,0,1,0,1,0.14285714285714285,1,0.0,0,0,0,0,0,0,0,1,0,0,1,1
7203,164894,d1YpWm8ZrJHw6yZFmSUUfwiG1uncdFaC,SpATywNh6bZuzm8s1ceuBUnMUAeoAHHw,7,8,6,0,5,0,2,0,21,3.0,2,0.0,0,6,0,5,8,0,0,2,0,11,10,1
7204,164897,OfowGKzB14DtDFMAzalSIqF59FGJmwsI,SpATywNh6bZuzm8s1ceuBUnMUAeoAHHw,7,4,3,0,2,0,1,0,10,1.4285714285714286,1,0.0,0,3,0,2,4,0,0,1,0,5,5,1
7205,164899,hJaHVe8Xh44z9hukeLNeR2pNBHqQdjsc,SpATywNh6bZuzm8s1ceuBUnMUAeoAHHw,8,5,2,0,2,0,2,0,11,1.5714285714285714,1,0.0,0,2,0,2,5,0,0,2,0,4,7,1
7206,164901,i7nraLaHwBYgXZfTke5TbxgaFvaS9vbl,SpATywNh6bZuzm8s1ceuBUnMUAeoAHHw,9,9,2,0,0,3,8,1,23,3.2857142857142856,2,0.0,2,2,0,0,7,3,0,8,1,4,19,1
7207,164902,kBQcF47B5gP441lpSW9ys93OU4QAjKEG,RXDvfPUBYFlVdlueBFbLW0mhhAyGEqpt,1,0,0,0,0,0,1,0,1,0.14285714285714285,1,0.0,0,0,0,0,0,0,0,1,0,0,1,1
7208,164903,kBQcF47B5gP441lpSW9ys93OU4QAjKEG,G8EPVSXsOYB5YQWZGiz1aVq5Pgr2GrQu,2,0,0,0,0,0,2,0,2,0.2857142857142857,1,0.0,0,0,0,0,0,0,0,2,0,0,2,1
7209,164905,plHbrJsV4vYGjRBOcUzcsYwkbv9wQX5B,SpATywNh6bZuzm8s1ceuBUnMUAeoAHHw,7,3,2,0,1,0,6,1,13,1.8571428571428572,1,0.0,0,2,0,1,3,0,0,6,1,3,10,1
7210,164913,0Gs9Qa1O3WvMBUAbfZOfCgWR0kizA6yM,bWdj2GDclj5ofokWjzoa5jAwMkxCykd6,6,2,0,0,0,0,8,0,10,1.4285714285714286,1,0.0,0,0,0,0,2,0,0,8,0,0,10,1
7211,164921,ID4lEXkhsumNcBZAAsLvwOjDHErWPU9z,RXDvfPUBYFlVdlueBFbLW0mhhAyGEqpt,7,7,2,0,2,0,2,0,13,1.8571428571428572,1,0.0,0,2,0,2,7,0,0,2,0,4,9,1
7212,164925,AI4uNtWiMMh2sMzoXDYV3Lbf88yJL8Br,SpATywNh6bZuzm8s1ceuBUnMUAeoAHHw,14,24,10,17,7,2,11,0,71,10.142857142857142,2,0.0,4,10,15,7,20,2,2,11,0,36,35,1
7213,164933,oz2lIvXgN1G19jRJoPetgndSl9b9808T,bWdj2GDclj5ofokWjzoa5jAwMkxCykd6,8,6,3,0,4,0,1,0,14,2.0,2,0.0,2,3,0,4,4,0,0,1,0,9,5,1
7214,164941,j0ueLtQ2R4YY5IElzCXogrNJYFltC4bt,G8EPVSXsOYB5YQWZGiz1aVq5Pgr2GrQu,8,10,3,0,2,0,4,0,19,2.7142857142857144,2,0.0,1,3,0,2,9,0,0,4,0,6,13,1
7215,164948,aGKf0W7DbO5pZNcjJ5sGrg9jyzAmLXkB,bWdj2GDclj5ofokWjzoa5jAwMkxCykd6,8,11,4,0,2,0,8,0,25,3.5714285714285716,1,0.0,0,4,0,2,11,0,0,8,0,6,19,1
7216,164949,QJffKxs9lkFscQquMcfEw8hYo0ArYTkN,SpATywNh6bZuzm8s1ceuBUnMUAeoAHHw,4,3,1,0,1,0,2,0,7,1.0,3,0.0,0,1,0,1,3,0,0,2,0,2,5,1
7217,164952,oZPmpjOeoiaunM2zVcQx8binL7fSfr4d,SpATywNh6bZuzm8s1ceuBUnMUAeoAHHw,1,0,0,0,0,0,1,0,1,0.14285714285714285,1,0.0,0,0,0,0,0,0,0,1,0,0,1,1
7218,164955,5BBW4T6qopgkCdcRVxFBI93aopzlZ3Vz,bWdj2GDclj5ofokWjzoa5jAwMkxCykd6,5,5,3,0,1,0,2,0,11,1.5714285714285714,2,0.0,0,3,0,1,5,0,0,2,0,4,7,1
7219,164957,1d49ijo1gfMUzl6uYLthfVZwQuAtGF5H,SpATywNh6bZuzm8s1ceuBUnMUAeoAHHw,1,0,0,0,0,0,1,0,1,0.14285714285714285,1,0.0,0,0,0,0,0,0,0,1,0,0,1,1
7220,164958,d9MkkuCn04Toz7g1JpLdUJWD9xM5braA,SpATywNh6bZuzm8s1ceuBUnMUAeoAHHw,1,0,0,0,0,0,1,0,1,0.14285714285714285,1,0.0,0,0,0,0,0,0,0,1,0,0,1,1
7221,164967,Jk09qA6alwSJzVuIqHppbDvZyk5u7ZHA,SpATywNh6bZuzm8s1ceuBUnMUAeoAHHw,11,7,0,19,0,9,8,2,45,6.428571428571429,1,0.0,2,0,16,0,5,9,3,8,2,18,27,1
7222,165009,z79FxI6IxKXksSKIwsXSYM1kOlaP8f6r,A3fsA9Zfv1X2fVEQhTw51lKENdNrEqT3,3,3,0,0,0,0,1,0,4,0.5714285714285714,1,0.0,0,0,0,0,3,0,0,1,0,0,4,1
7223,165038,Im85u8aENweba95uFnFOR6zdQWFnfDOq,A3fsA9Zfv1X2fVEQhTw51lKENdNrEqT3,2,0,0,0,0,0,2,0,2,0.2857142857142857,1,0.0,0,0,0,0,0,0,0,2,0,0,2,1
7224,165045,WzO2F8mFL9S6WyVuaBKRnAo7AfpK6MFq,SpATywNh6bZuzm8s1ceuBUnMUAeoAHHw,7,7,3,0,4,0,2,0,16,2.2857142857142856,1,0.0,0,3,0,4,7,0,0,2,0,7,9,1
7225,165056,AOCx0foyQMeiMTgZQ1N4fT75yVQcQ0J9,A3fsA9Zfv1X2fVEQhTw51lKENdNrEqT3,2,0,0,0,0,0,2,0,2,0.2857142857142857,1,0.0,0,0,0,0,0,0,0,2,0,0,2,0
7226,165066,jaOmqqWd0RurZsiyeEDBNOhHZZXgisPQ,G8EPVSXsOYB5YQWZGiz1aVq5Pgr2GrQu,11,10,6,0,1,4,14,1,36,5.142857142857143,1,0.0,0,6,0,1,10,4,0,14,1,7,29,1
7227,165075,ij6lhOw7nYbJY8ZynpI4C6NhJmjCSNsH,A3fsA9Zfv1X2fVEQhTw51lKENdNrEqT3,2,0,0,0,0,0,2,0,2,0.2857142857142857,1,0.0,0,0,0,0,0,0,0,2,0,0,2,1
7228,165087,M4k2b8losoqUFktWiKn58aOnUoYhQVU3,A3fsA9Zfv1X2fVEQhTw51lKENdNrEqT3,9,5,4,0,4,0,10,0,23,3.2857142857142856,3,0.0,0,4,0,4,5,0,0,10,0,8,15,0
7229,165115,o0yBW91wJfDjK5Q4nsWKulavXcIg9y1s,A3fsA9Zfv1X2fVEQhTw51lKENdNrEqT3,1,0,0,0,0,0,1,0,1,0.14285714285714285,1,0.0,0,0,0,0,0,0,0,1,0,0,1,1
7230,165187,Wm4d7ifDaTgcR0GfUqwJt5OZKbYglRCq,SpATywNh6bZuzm8s1ceuBUnMUAeoAHHw,1,0,0,0,0,0,1,0,1,0.14285714285714285,1,0.0,0,0,0,0,0,0,0,1,0,0,1,1
7231,165204,gfT397rHr4ZgHPLGZxZdcWxic55z4KQu,A3fsA9Zfv1X2fVEQhTw51lKENdNrEqT3,5,4,1,0,0,0,3,0,8,1.1428571428571428,2,0.0,0,1,0,0,4,0,0,3,0,1,7,1
7232,165231,kERhRnhdT9O0KrRIFldGxnMdaroWZIzP,A3fsA9Zfv1X2fVEQhTw51lKENdNrEqT3,6,3,1,0,1,0,2,0,7,1.0,1,0.0,0,1,0,1,3,0,0,2,0,2,5,1
7233,165233,dVeRIohjfohGjzEkLsaU11h0LM0FLGYK,A3fsA9Zfv1X2fVEQhTw51lKENdNrEqT3,1,0,0,0,0,0,1,0,1,0.14285714285714285,1,0.0,0,0,0,0,0,0,0,1,0,0,1,1
7234,165249,luS4LypZudLH1I2R9ITqSmx2yCBqIuBV,A3fsA9Zfv1X2fVEQhTw51lKENdNrEqT3,5,0,0,0,0,0,10,2,12,1.7142857142857142,1,0.0,0,0,0,0,0,0,0,10,2,0,12,1
7235,165251,pQwQ7lq50KHnzLX18552MmFyRyK2NBh3,SpATywNh6bZuzm8s1ceuBUnMUAeoAHHw,16,33,15,19,6,0,3,0,76,10.857142857142858,2,0.0,13,15,18,6,20,0,1,3,0,52,24,1
7236,165254,SHOQyzWMzeXzTVojp4arGhfbJLLjl3Lx,A3fsA9Zfv1X2fVEQhTw51lKENdNrEqT3,25,8,5,68,0,0,3,0,84,12.0,1,0.0,1,5,68,0,7,0,0,3,0,74,10,1
7237,165256,z9oiQyplHlMmhFVKenfY0OjMOlRO24Ty,SpATywNh6bZuzm8s1ceuBUnMUAeoAHHw,9,7,3,0,3,0,2,0,15,2.142857142857143,1,0.0,0,3,0,3,7,0,0,2,0,6,9,0
7238,165269,NrHk4qmJXuD0TsjkQSnghKpk9ZjGAOyU,bWdj2GDclj5ofokWjzoa5jAwMkxCykd6,6,7,4,0,4,0,1,0,16,2.2857142857142856,1,0.0,0,4,0,4,7,0,0,1,0,8,8,1
7239,165318,H5hq1RXMZvjdgAVV42G1HlcBUWfqaAQD,SpATywNh6bZuzm8s1ceuBUnMUAeoAHHw,9,13,3,0,1,2,10,0,29,4.142857142857143,1,0.0,0,3,0,1,13,2,0,10,0,4,25,1
7240,165319,ELnpGakFfMjgNeN5VeZv7LPxT1yvRGG2,SpATywNh6bZuzm8s1ceuBUnMUAeoAHHw,16,8,4,10,3,1,7,1,34,4.857142857142857,1,0.0,3,4,10,3,5,1,0,7,1,20,14,1
7241,165320,mvS4OjvaKNqVV60dVhvpTVSSCBc97FlN,A3fsA9Zfv1X2fVEQhTw51lKENdNrEqT3,1,0,0,0,0,0,2,0,2,0.2857142857142857,1,0.0,0,0,0,0,0,0,0,2,0,0,2,1
7242,165340,oaoj9be4jW2Hot8wYgYrzLRvB0RU4KYy,SpATywNh6bZuzm8s1ceuBUnMUAeoAHHw,5,4,2,0,1,0,2,0,9,1.2857142857142858,2,0.0,0,2,0,1,4,0,0,2,0,3,6,1
7243,165342,oaoj9be4jW2Hot8wYgYrzLRvB0RU4KYy,A3fsA9Zfv1X2fVEQhTw51lKENdNrEqT3,5,6,3,0,1,0,3,0,13,1.8571428571428572,3,0.0,0,3,0,1,6,0,0,3,0,4,9,0
7244,165359,SiDEVAV0vWeEC76b25xnijgEBNeEhRJy,A3fsA9Zfv1X2fVEQhTw51lKENdNrEqT3,1,0,0,0,0,0,1,0,1,0.14285714285714285,1,0.0,0,0,0,0,0,0,0,1,0,0,1,1
7245,165376,yR0NraAWygNs5cts7Fvc0zvbt2sGOVtI,SpATywNh6bZuzm8s1ceuBUnMUAeoAHHw,8,5,4,0,4,0,1,0,14,2.0,1,0.0,0,4,0,4,5,0,0,1,0,8,6,1
7246,165393,yfeIcWRmFLjQgBIM196kRoHXCKG0ateC,A3fsA9Zfv1X2fVEQhTw51lKENdNrEqT3,24,21,14,0,9,3,11,0,58,8.285714285714286,3,0.0,3,14,0,9,18,3,0,11,0,26,32,1
7247,165398,4BWY4WoZwowebQpACrizuzaSUpqFUPYV,A3fsA9Zfv1X2fVEQhTw51lKENdNrEqT3,1,0,0,0,0,0,2,0,2,0.2857142857142857,1,0.0,0,0,0,0,0,0,0,2,0,0,2,1
7248,165402,RDChRApYRv6Sfe9dw6iFymmd1hK0JhGY,A3fsA9Zfv1X2fVEQhTw51lKENdNrEqT3,1,0,0,0,0,0,1,0,1,0.14285714285714285,1,0.0,0,0,0,0,0,0,0,1,0,0,1,1
7249,165431,DrolXxynktOsAUhkf2q3qgLe9PvqdRq3,A3fsA9Zfv1X2fVEQhTw51lKENdNrEqT3,1,0,0,0,0,0,1,0,1,0.14285714285714285,1,0.0,0,0,0,0,0,0,0,1,0,0,1,1
7250,165458,MQKEfJfHQjDI3xyJjnjmz4WwmQkpOvq2,bWdj2GDclj5ofokWjzoa5jAwMkxCykd6,5,2,1,0,1,0,2,0,6,0.8571428571428571,1,0.0,0,1,0,1,2,0,0,2,0,2,4,1
7251,165509,E7ohNiXaqWq4qLMuCCQXRkjiO7PGgPyS,A3fsA9Zfv1X2fVEQhTw51lKENdNrEqT3,1,0,0,0,0,0,1,0,1,0.14285714285714285,1,0.0,0,0,0,0,0,0,0,1,0,0,1,1
7252,165596,QqNuARzccJUP5HNszzjljOhC9t53eZLk,A3fsA9Zfv1X2fVEQhTw51lKENdNrEqT3,42,25,11,66,7,5,11,8,133,19.0,2,0.0,4,11,57,7,21,5,9,11,8,79,54,1
7253,165636,OLNUzQUHvlNsi2WFlH5eEyaieqKXrEz7,A3fsA9Zfv1X2fVEQhTw51lKENdNrEqT3,1,0,0,0,0,0,1,0,1,0.14285714285714285,1,0.0,0,0,0,0,0,0,0,1,0,0,1,1
7254,165705,jFvQpyb1OqXqTZx0rW1xHWEtpgyxk2Lr,A3fsA9Zfv1X2fVEQhTw51lKENdNrEqT3,1,0,0,0,0,0,1,0,1,0.14285714285714285,1,0.0,0,0,0,0,0,0,0,1,0,0,1,1
7255,165713,0beqYHGnxE1kTUwjVs54066oNfD5qFpw,A3fsA9Zfv1X2fVEQhTw51lKENdNrEqT3,4,3,1,0,1,0,1,0,6,0.8571428571428571,1,0.0,0,1,0,1,3,0,0,1,0,2,4,1
7256,165723,M2gu56p2gwP0LePGc68gh6Y3xSriA9x3,A3fsA9Zfv1X2fVEQhTw51lKENdNrEqT3,2,2,0,0,0,0,0,0,2,0.2857142857142857,1,0.0,0,0,0,0,2,0,0,0,0,0,2,1
7257,165748,GrUpT0uWeNhnYmy4WRpw1EFafAAAhhi9,SpATywNh6bZuzm8s1ceuBUnMUAeoAHHw,12,21,0,16,1,0,6,0,44,6.285714285714286,1,0.0,6,0,16,1,15,0,0,6,0,23,21,0
7258,165762,6WkOKMKB5P2APoB7vbWWLXwAR3emifoG,A3fsA9Zfv1X2fVEQhTw51lKENdNrEqT3,6,7,4,0,1,0,2,0,14,2.0,1,0.0,1,4,0,1,6,0,0,2,0,6,8,1
7259,165768,hbzbE3YW3TFJZGn3KQWHVTTu9qGbrE8v,A3fsA9Zfv1X2fVEQhTw51lKENdNrEqT3,2,0,0,0,0,0,2,0,2,0.2857142857142857,1,0.0,0,0,0,0,0,0,0,2,0,0,2,1
7260,165781,hyGNNqxhAyFxbHW9ng6YRyMeUCWAgj0x,A3fsA9Zfv1X2fVEQhTw51lKENdNrEqT3,3,2,0,0,0,0,1,0,3,0.42857142857142855,1,0.0,0,0,0,0,2,0,0,1,0,0,3,0
7261,165785,rh0SgumcqbNnCp7Kv0VptrPMVPtrWDm8,A3fsA9Zfv1X2fVEQhTw51lKENdNrEqT3,7,8,2,0,1,0,4,0,15,2.142857142857143,1,0.0,2,2,0,1,6,0,0,4,0,5,10,1
7262,165793,NKdzAvohqx5ZB0phtZyAtuBxXKa68OBU,SpATywNh6bZuzm8s1ceuBUnMUAeoAHHw,7,6,0,0,0,0,3,0,9,1.2857142857142858,1,0.0,0,0,0,0,6,0,0,3,0,0,9,1
7263,165820,wcSIko8HPcmbs4cOPlImi3EyazICOLlR,A3fsA9Zfv1X2fVEQhTw51lKENdNrEqT3,1,0,0,0,0,0,2,0,2,0.2857142857142857,1,0.0,0,0,0,0,0,0,0,2,0,0,2,1
7264,166036,wCZGolOXIHC0m5ValHsltDi5uu5i6G63,fbPkOYLVPtPgIt0MxizjfFJov3JbHyAi,4,3,1,0,1,0,1,0,6,0.8571428571428571,1,0.0,0,1,0,1,3,0,0,1,0,2,4,1
7265,166037,wc8ABOXSHDqwIaE5k0JYlZP66W8tdlRo,fbPkOYLVPtPgIt0MxizjfFJov3JbHyAi,12,12,6,0,2,8,13,1,42,6.0,2,0.0,0,6,0,2,12,8,0,13,1,8,34,1
7266,166038,FFaLaJRa89FKW6pVYuJ3dXumxZUbwjZC,fbPkOYLVPtPgIt0MxizjfFJov3JbHyAi,1,0,0,0,0,0,1,0,1,0.14285714285714285,1,0.0,0,0,0,0,0,0,0,1,0,0,1,1
7267,166039,ESUjI9FMN0bUSmI9r3u304t5lebCsXMM,fbPkOYLVPtPgIt0MxizjfFJov3JbHyAi,6,2,1,0,0,1,5,1,10,1.4285714285714286,1,0.0,0,1,0,0,2,1,0,5,1,1,9,1
7268,166040,fcgIoTowNoXtysmcakqXD5rIrFDMOLMS,fbPkOYLVPtPgIt0MxizjfFJov3JbHyAi,4,2,1,0,1,0,1,0,5,0.7142857142857143,1,0.0,0,1,0,1,2,0,0,1,0,2,3,1
7269,166042,fTFCMd76UjKBUrosPwesoa2JcVylSbm0,fbPkOYLVPtPgIt0MxizjfFJov3JbHyAi,15,57,2,14,7,1,10,2,93,13.285714285714286,1,0.0,14,2,11,7,43,1,3,10,2,34,59,1
7270,166044,yImV3f0xQc91646kWaaTCoHPHfLcFyiE,fbPkOYLVPtPgIt0MxizjfFJov3JbHyAi,4,2,1,0,1,0,1,0,5,0.7142857142857143,1,0.0,0,1,0,1,2,0,0,1,0,2,3,1
7271,166045,fOR5X73Jlz0p1e9noRgVbo5kXcgdZJVO,fbPkOYLVPtPgIt0MxizjfFJov3JbHyAi,7,3,2,0,2,0,2,0,9,1.2857142857142858,1,0.0,0,2,0,2,3,0,0,2,0,4,5,1
7272,166047,vqP7fSXyXiWaT2K7Qf3eA0zXPxAvIBz4,fbPkOYLVPtPgIt0MxizjfFJov3JbHyAi,6,3,2,0,2,0,1,0,8,1.1428571428571428,1,0.0,0,2,0,2,3,0,0,1,0,4,4,1
7273,166048,aih3bUgUWJe7LHDxPrKqUKv7M1PtyZMy,fbPkOYLVPtPgIt0MxizjfFJov3JbHyAi,7,3,2,0,2,0,2,0,9,1.2857142857142858,1,0.0,0,2,0,2,3,0,0,2,0,4,5,1
7274,166049,wDXghK2BIM2TBsqSOrjDvr9Ut4FXTmRS,fbPkOYLVPtPgIt0MxizjfFJov3JbHyAi,7,3,2,0,2,0,3,0,10,1.4285714285714286,1,0.0,0,2,0,2,3,0,0,3,0,4,6,1
7275,166053,DhiB4cJ1TCjmSH3ZWP9m0OqNyBdGeS5P,fbPkOYLVPtPgIt0MxizjfFJov3JbHyAi,3,0,0,0,0,1,2,0,3,0.42857142857142855,1,0.0,0,0,0,0,0,1,0,2,0,0,3,1
7276,166057,y23uUtZASm6un1sOo8Z3FtFtr7wmEBUC,fbPkOYLVPtPgIt0MxizjfFJov3JbHyAi,8,3,1,0,1,2,5,1,13,1.8571428571428572,1,0.0,0,1,0,1,3,2,0,5,1,2,11,1
7277,166058,u3Es5hUyjf5nk8KFgVLYAoNUWyPWxnEj,fbPkOYLVPtPgIt0MxizjfFJov3JbHyAi,6,7,4,0,2,0,6,0,19,2.7142857142857144,1,0.0,0,4,0,2,7,0,0,6,0,6,13,1
7278,166059,tDLUr7SnRwxXyYOlr1OOOB7neeYu2GfR,fbPkOYLVPtPgIt0MxizjfFJov3JbHyAi,2,0,0,0,0,0,3,0,3,0.42857142857142855,1,0.0,0,0,0,0,0,0,0,3,0,0,3,1
7279,166060,NcjYJr1XLJ9a71yX9v2oEtoXLbIWWmNa,fbPkOYLVPtPgIt0MxizjfFJov3JbHyAi,7,10,1,1,2,0,4,0,18,2.5714285714285716,1,0.0,4,1,1,2,6,0,0,4,0,8,10,1
7280,166062,RQ6jHOF0XaVCtNO9cGrCBZ0SdqPrnq0p,fbPkOYLVPtPgIt0MxizjfFJov3JbHyAi,5,2,1,0,1,0,2,0,6,0.8571428571428571,1,0.0,0,1,0,1,2,0,0,2,0,2,4,1
7281,166066,0nSJm9RR2EHSZbxafc9dMAvqeh04T45l,fbPkOYLVPtPgIt0MxizjfFJov3JbHyAi,18,10,9,0,8,0,2,0,29,4.142857142857143,1,0.0,0,9,0,8,10,0,0,2,0,17,12,1
7282,166071,wdYj6Nt0ckfUFBd2Af4u2WMsP126y1D7,fbPkOYLVPtPgIt0MxizjfFJov3JbHyAi,7,2,2,0,1,0,3,0,8,1.1428571428571428,1,0.0,0,2,0,1,2,0,0,3,0,3,5,1
7283,166072,xzTUXMkATDrzXhPVq5lWKfyqNyH6U4X9,fbPkOYLVPtPgIt0MxizjfFJov3JbHyAi,1,0,0,0,0,0,1,0,1,0.14285714285714285,1,0.0,0,0,0,0,0,0,0,1,0,0,1,1
7284,166074,Xy9hY2jzdaXdVDhVwpfMWrmwNRASq6RF,fbPkOYLVPtPgIt0MxizjfFJov3JbHyAi,7,3,2,0,2,0,3,0,10,1.4285714285714286,1,0.0,0,2,0,2,3,0,0,3,0,4,6,1
7285,166075,AeNkuMZiCOxqxMy4dCnuYLHaK5F326HO,fbPkOYLVPtPgIt0MxizjfFJov3JbHyAi,1,0,0,0,0,0,1,0,1,0.14285714285714285,1,0.0,0,0,0,0,0,0,0,1,0,0,1,1
7286,166190,m0ftathRLrGnJCnhmZSV8vDms8QzsQ7P,fbPkOYLVPtPgIt0MxizjfFJov3JbHyAi,23,16,7,21,7,0,2,0,53,7.571428571428571,1,0.0,7,7,17,7,9,0,4,2,0,38,15,1
7287,166304,cr6Tgf9hnYbWIgXq8hI7G8mwIYtkpuPn,SpATywNh6bZuzm8s1ceuBUnMUAeoAHHw,8,12,8,0,0,0,12,0,32,4.571428571428571,3,0.0,0,8,0,0,12,0,0,12,0,8,24,1
7288,166334,O9GgLjRVV0VZ4XM2UvjBFBWJXBSS6aK0,SpATywNh6bZuzm8s1ceuBUnMUAeoAHHw,13,19,10,15,6,5,4,0,59,8.428571428571429,1,0.0,4,10,13,6,15,5,2,4,0,33,26,1
7289,166338,VGpsDdnTGsfrp3adgxkdRhxpkaNF7Bg2,SpATywNh6bZuzm8s1ceuBUnMUAeoAHHw,10,8,6,0,5,0,4,0,23,3.2857142857142856,1,0.0,0,6,0,5,8,0,0,4,0,11,12,1
7290,166409,iIkBXne7Ob9Fgz6Oa5wXMKZwMdTiJR2o,SpATywNh6bZuzm8s1ceuBUnMUAeoAHHw,7,2,1,0,1,2,5,1,12,1.7142857142857142,1,0.0,0,1,0,1,2,2,0,5,1,2,10,1
7291,166778,AtDlkFSnWTgMt7xJ3PkbVdpoMvsEJuZd,SpATywNh6bZuzm8s1ceuBUnMUAeoAHHw,5,2,0,0,1,0,2,0,5,0.7142857142857143,1,0.0,0,0,0,1,2,0,0,2,0,1,4,1
7292,166787,35YnYP4Tkn7xvOTt0M51AeVR3m7l2sIt,SpATywNh6bZuzm8s1ceuBUnMUAeoAHHw,13,11,0,10,0,1,5,1,28,4.0,1,0.0,4,0,9,0,7,1,1,5,1,13,15,1
7293,167084,OtGMx6eKyVYjbz3L87VVmC99kyg1WjEl,SpATywNh6bZuzm8s1ceuBUnMUAeoAHHw,17,36,12,28,3,14,11,2,106,15.142857142857142,3,0.0,16,12,21,3,20,14,7,11,2,52,54,0
7294,167109,riXqOkhR5seretWfUGQsZViiD6naR0Fb,G8EPVSXsOYB5YQWZGiz1aVq5Pgr2GrQu,8,6,3,0,2,0,3,0,14,2.0,1,0.0,0,3,0,2,6,0,0,3,0,5,9,1
7295,167207,l6rkobnqEUKXFQnaBVgonlwU5l25TkcG,A3fsA9Zfv1X2fVEQhTw51lKENdNrEqT3,30,9,6,54,4,1,4,1,79,11.285714285714286,1,0.0,1,6,53,4,8,1,1,4,1,64,15,0
7296,167283,ilday4HM3BCIYcolQVgtTOYVZxbISCZm,G8EPVSXsOYB5YQWZGiz1aVq5Pgr2GrQu,12,7,2,6,3,1,6,0,25,3.5714285714285716,1,0.0,4,2,3,3,3,1,3,6,0,12,13,1
7297,167492,kMJdIf6lyKBj8d5FH5wYfeAvXu9zJZ2k,A3fsA9Zfv1X2fVEQhTw51lKENdNrEqT3,6,1,1,0,0,0,7,0,9,1.2857142857142858,1,0.0,0,1,0,0,1,0,0,7,0,1,8,1
7298,167712,JhqtKTVVZhx2wzcUoD48zfOf7XJtvv55,SpATywNh6bZuzm8s1ceuBUnMUAeoAHHw,9,7,4,0,2,0,6,0,19,2.7142857142857144,1,0.0,0,4,0,2,7,0,0,6,0,6,13,1
7299,167714,nyH7Jx4kN1AdDJdwkZQoUDqYoovHgbk5,G8EPVSXsOYB5YQWZGiz1aVq5Pgr2GrQu,13,31,12,10,9,0,3,0,65,9.285714285714286,3,0.0,13,12,6,9,18,0,4,3,0,40,25,1
7300,167777,BWZyBrJDBbkcDEXyE3CSVFoVlT2CRRku,bWdj2GDclj5ofokWjzoa5jAwMkxCykd6,1,0,0,0,0,0,1,0,1,0.14285714285714285,1,0.0,0,0,0,0,0,0,0,1,0,0,1,1
7301,169735,5IM8g7YMOYo5qH7Yu3x31T3JkVOH9iqe,7GRhBDsirIGkRZBtSMEzNTyDr2JQm4xx,5,2,1,0,1,0,2,0,6,0.8571428571428571,2,0.0,0,1,0,1,2,0,0,2,0,2,4,1
7302,169800,g3902agYIRHzac78MKVZlvljLMXXNpQ7,7GRhBDsirIGkRZBtSMEzNTyDr2JQm4xx,10,7,4,4,2,0,6,0,23,3.2857142857142856,1,0.0,1,4,4,2,6,0,0,6,0,11,12,1
7303,169865,FUKsUHV3URSaK57Jrek7EonPjAGWSjXW,7GRhBDsirIGkRZBtSMEzNTyDr2JQm4xx,3,2,1,0,0,0,2,0,5,0.7142857142857143,1,0.0,0,1,0,0,2,0,0,2,0,1,4,1
7304,169885,BSj3AAnB5ipEkdnoMrRkK2tTYOV9mAFC,7GRhBDsirIGkRZBtSMEzNTyDr2JQm4xx,9,9,3,4,1,2,5,0,24,3.4285714285714284,2,0.0,2,3,3,1,7,2,1,5,0,9,15,1
7305,169911,2j6SiYhVaWD27toQPxUbfR6IzUCgWGsO,7GRhBDsirIGkRZBtSMEzNTyDr2JQm4xx,1,0,0,0,0,0,1,0,1,0.14285714285714285,1,0.0,0,0,0,0,0,0,0,1,0,0,1,1
7306,169914,EX4mN8VqjmDrg8vjZaJJar6Z7qHJihO0,SpATywNh6bZuzm8s1ceuBUnMUAeoAHHw,16,18,6,14,3,1,6,1,49,7.0,1,0.0,9,6,14,3,9,1,0,6,1,32,17,0
7307,169943,BLyKMpisIDss4MmDNKRytNOAQZEOycAU,7GRhBDsirIGkRZBtSMEzNTyDr2JQm4xx,1,0,0,0,0,0,1,0,1,0.14285714285714285,1,0.0,0,0,0,0,0,0,0,1,0,0,1,1
7308,169955,ZQcqpVyhrZVshH7yyuAn3ze3B9JEoNBU,SpATywNh6bZuzm8s1ceuBUnMUAeoAHHw,1,0,0,0,0,0,1,0,1,0.14285714285714285,1,0.0,0,0,0,0,0,0,0,1,0,0,1,1
7309,169971,bNG7kJA3jy4DW8PDzMNAT9OoyHwhutqS,7GRhBDsirIGkRZBtSMEzNTyDr2JQm4xx,3,2,1,0,0,0,1,0,4,0.5714285714285714,1,0.0,0,1,0,0,2,0,0,1,0,1,3,1
7310,170020,nVB1o73xluQXZjoI2dUYHGxbCDG8qiCL,7GRhBDsirIGkRZBtSMEzNTyDr2JQm4xx,5,2,1,0,1,0,10,0,14,2.0,3,0.0,0,1,0,1,2,0,0,10,0,2,12,1
7311,170040,qqtHlVJpcH8uxc5327KA4fBoZNP0U5Xd,7GRhBDsirIGkRZBtSMEzNTyDr2JQm4xx,6,4,3,0,0,0,2,0,9,1.2857142857142858,1,0.0,0,3,0,0,4,0,0,2,0,3,6,1
7312,170061,tfoakS3EMOjWuYWNRSgWZTjBxe3Mf9Te,7GRhBDsirIGkRZBtSMEzNTyDr2JQm4xx,1,0,0,0,0,0,1,0,1,0.14285714285714285,1,0.0,0,0,0,0,0,0,0,1,0,0,1,1
7313,170075,nmifCUUA8im6jjkFk86bK5knz02SLRlN,7GRhBDsirIGkRZBtSMEzNTyDr2JQm4xx,7,4,2,0,2,0,2,0,10,1.4285714285714286,1,0.0,0,2,0,2,4,0,0,2,0,4,6,1
7314,170100,R0iGmWkfHC0JwSUufNxBJOtu3BmW7cey,7GRhBDsirIGkRZBtSMEzNTyDr2JQm4xx,10,21,6,0,4,2,3,0,36,5.142857142857143,1,0.0,13,6,0,4,8,2,0,3,0,23,13,1
7315,170206,mKHQM9iW9olu6z2WamdxK7ySH3UwX3JX,bWdj2GDclj5ofokWjzoa5jAwMkxCykd6,1,0,0,0,0,0,1,0,1,0.14285714285714285,1,0.0,0,0,0,0,0,0,0,1,0,0,1,1
7316,170213,dRpHvWsltBuE4KgJgZUdCQKV5v7VQuHh,7GRhBDsirIGkRZBtSMEzNTyDr2JQm4xx,10,2,1,0,1,3,8,4,19,2.7142857142857144,1,0.0,0,1,0,1,2,3,0,8,4,2,17,1
7317,170244,GdGI6ZUeHNfDd16CDy7Y3YMvqdJfsIRh,7GRhBDsirIGkRZBtSMEzNTyDr2JQm4xx,1,0,0,0,0,0,2,0,2,0.2857142857142857,1,0.0,0,0,0,0,0,0,0,2,0,0,2,1
7318,170247,vaWLVKWyrsUzDV0qs20ZUq8M3VNW01Uk,7GRhBDsirIGkRZBtSMEzNTyDr2JQm4xx,9,4,2,6,2,5,3,0,22,3.142857142857143,2,0.0,1,2,5,2,3,5,1,3,0,10,12,1
7319,170250,7jkKKf5Pb7FrtJ3WnuF11G7ePioUPJm3,bWdj2GDclj5ofokWjzoa5jAwMkxCykd6,3,2,1,0,0,1,1,0,5,0.7142857142857143,1,0.0,0,1,0,0,2,1,0,1,0,1,4,1
7320,170262,RHsk3gHUm8VEfb9FwEFf8vBDNKZZ0LWe,bWdj2GDclj5ofokWjzoa5jAwMkxCykd6,18,23,16,30,12,15,12,1,109,15.571428571428571,1,0.0,5,16,22,12,18,15,8,12,1,55,54,0
7321,170274,eb3SHueTE6ugnDkhYnh0RBSPDS20VwLZ,7GRhBDsirIGkRZBtSMEzNTyDr2JQm4xx,16,26,12,0,7,0,2,0,47,6.714285714285714,2,0.0,0,12,0,7,26,0,0,2,0,19,28,1
7322,170320,pqBs8sN0PT2UoBL7VKu89PIVTchItwDs,7GRhBDsirIGkRZBtSMEzNTyDr2JQm4xx,4,2,0,0,0,0,5,0,7,1.0,1,0.0,0,0,0,0,2,0,0,5,0,0,7,1
7323,170347,ung1DnQyYgd0tfz7mAKTwJrrm5UPHWt1,7GRhBDsirIGkRZBtSMEzNTyDr2JQm4xx,1,0,0,0,0,0,1,0,1,0.14285714285714285,1,0.0,0,0,0,0,0,0,0,1,0,0,1,1
7324,170400,qlV7NVEcCnAsxKC17kpoGCtCEpV1bUS5,A3fsA9Zfv1X2fVEQhTw51lKENdNrEqT3,11,4,3,0,3,3,4,0,17,2.4285714285714284,1,0.0,0,3,0,3,4,3,0,4,0,6,11,1
7325,170403,TY1XSpzUxZYHUqU0tQYtstvuwKCsGYpR,SpATywNh6bZuzm8s1ceuBUnMUAeoAHHw,3,2,0,0,0,0,2,0,4,0.5714285714285714,1,0.0,0,0,0,0,2,0,0,2,0,0,4,1
7326,170412,Z6SakRvyvh7ZuaV4DHEE1b3QLOpPcfOm,SpATywNh6bZuzm8s1ceuBUnMUAeoAHHw,11,7,0,14,0,0,7,1,29,4.142857142857143,2,0.0,2,0,13,0,5,0,1,7,1,15,14,0
7327,170432,CDy3wblikhG2TGdNI3LhbAglknKqeMeq,7GRhBDsirIGkRZBtSMEzNTyDr2JQm4xx,1,0,0,0,0,0,1,0,1,0.14285714285714285,1,0.0,0,0,0,0,0,0,0,1,0,0,1,1
7328,170458,DIfj5Ba2axfDE4LFDWqKjVBCgesW8XXW,A3fsA9Zfv1X2fVEQhTw51lKENdNrEqT3,1,0,0,0,0,0,1,0,1,0.14285714285714285,1,0.0,0,0,0,0,0,0,0,1,0,0,1,1
7329,170460,m8tZWvMesr1zQS0esJJogsiMlXHxe2Cd,7GRhBDsirIGkRZBtSMEzNTyDr2JQm4xx,1,0,0,0,0,0,1,0,1,0.14285714285714285,1,0.0,0,0,0,0,0,0,0,1,0,0,1,1
7330,170490,2H6KbsPWrpdsyjI0g4q0nnMN85W6it1n,7GRhBDsirIGkRZBtSMEzNTyDr2JQm4xx,1,0,0,0,0,0,1,0,1,0.14285714285714285,1,0.0,0,0,0,0,0,0,0,1,0,0,1,1
7331,170572,lyUyYIfExuGOGDXTlbgjuS96P5Iv4Fw9,SpATywNh6bZuzm8s1ceuBUnMUAeoAHHw,18,27,10,21,4,21,17,5,105,15.0,2,0.0,12,10,18,4,15,21,3,17,5,44,61,1
7332,170619,SSjJLhqPp3KtEjhygN5aGwtbWcKsJk4h,7GRhBDsirIGkRZBtSMEzNTyDr2JQm4xx,1,0,0,0,0,0,2,0,2,0.2857142857142857,1,0.0,0,0,0,0,0,0,0,2,0,0,2,1
7333,170650,WJvUM8vrAZx3jP5SMFm1lAFz7l2iXld4,7GRhBDsirIGkRZBtSMEzNTyDr2JQm4xx,5,2,1,0,1,0,2,0,6,0.8571428571428571,1,0.0,0,1,0,1,2,0,0,2,0,2,4,1
7334,170674,GfrMOiCcFGorw9y2zYLBWSI6Ij42MMT7,7GRhBDsirIGkRZBtSMEzNTyDr2JQm4xx,1,0,0,0,0,0,1,0,1,0.14285714285714285,1,0.0,0,0,0,0,0,0,0,1,0,0,1,1
7335,170692,Hm7TJQq1vAhYsYwItY96s4Me02Vfs6zP,7GRhBDsirIGkRZBtSMEzNTyDr2JQm4xx,1,0,0,0,0,0,1,0,1,0.14285714285714285,1,0.0,0,0,0,0,0,0,0,1,0,0,1,1
7336,172761,sL5jw3pLWZoRI7avI17oM60mfF67Acgz,fbPkOYLVPtPgIt0MxizjfFJov3JbHyAi,4,0,0,0,0,1,4,0,5,0.7142857142857143,1,0.0,0,0,0,0,0,1,0,4,0,0,5,0
7337,173137,jV4bQZTO8NhEnxumKD5qHxnk6auhtohn,SpATywNh6bZuzm8s1ceuBUnMUAeoAHHw,12,7,3,10,2,0,2,0,24,3.4285714285714284,1,0.0,2,3,10,2,5,0,0,2,0,17,7,0
7338,173167,R2PVhKsPZcwfUBkw7hJ62cbr2j1XWSh4,SpATywNh6bZuzm8s1ceuBUnMUAeoAHHw,11,13,7,0,6,1,3,1,31,4.428571428571429,1,0.0,4,7,0,6,9,1,0,3,1,17,14,1
7339,173247,WLAmx1xu6Oqj4DvlomeHAJXvMyktUiPG,SpATywNh6bZuzm8s1ceuBUnMUAeoAHHw,1,0,0,0,0,0,1,0,1,0.14285714285714285,1,0.0,0,0,0,0,0,0,0,1,0,0,1,0
7340,173397,PUvUSLbNhJCmhl8hY6hN43xWGmaNTEJm,SpATywNh6bZuzm8s1ceuBUnMUAeoAHHw,3,2,0,0,0,0,1,0,3,0.42857142857142855,1,0.0,0,0,0,0,2,0,0,1,0,0,3,1
7341,173485,Gj6yrFuP2L0UySRxwG1ZhYaHhmyFPckw,SpATywNh6bZuzm8s1ceuBUnMUAeoAHHw,6,5,3,0,3,0,1,0,12,1.7142857142857142,1,0.0,1,3,0,3,4,0,0,1,0,7,5,1
7342,173594,fPM57KFy9Z8MO9ygSzYz3vMhCvMUYCpW,SpATywNh6bZuzm8s1ceuBUnMUAeoAHHw,4,3,0,0,0,0,1,0,4,0.5714285714285714,1,0.0,0,0,0,0,3,0,0,1,0,0,4,1
7343,173626,aEIz8d9s1BC7n4fBeFuKK0VhLVqwpGhk,SpATywNh6bZuzm8s1ceuBUnMUAeoAHHw,17,12,5,19,3,33,19,3,94,13.428571428571429,1,0.0,4,5,16,3,8,33,3,19,3,28,66,0
7344,173683,zKbFB2XJ8gemmfPKgB0q2D34TEqFCaPJ,SpATywNh6bZuzm8s1ceuBUnMUAeoAHHw,11,10,6,2,4,1,1,0,24,3.4285714285714284,1,0.0,2,6,2,4,8,1,0,1,0,14,10,1
7345,173759,OO1JwGoh4BUjbVi8UpZSb7D59mBcs3nt,bWdj2GDclj5ofokWjzoa5jAwMkxCykd6,4,3,1,0,1,0,1,0,6,0.8571428571428571,1,0.0,0,1,0,1,3,0,0,1,0,2,4,1
7346,174023,qCRa9Z4oZ6HdXxtc9b3V1X8DNEfTKusC,SpATywNh6bZuzm8s1ceuBUnMUAeoAHHw,3,2,1,0,0,0,1,0,4,0.5714285714285714,1,0.0,0,1,0,0,2,0,0,1,0,1,3,1
7347,174123,vAGOe6e2RHZZ1EaDZrX2SIPJIAyfl840,SpATywNh6bZuzm8s1ceuBUnMUAeoAHHw,7,5,4,0,3,0,4,0,16,2.2857142857142856,2,0.0,0,4,0,3,5,0,0,4,0,7,9,1
7348,174379,BeoWdDFNsVFqWVq3B4qjYh8vNjNTgwSB,A3fsA9Zfv1X2fVEQhTw51lKENdNrEqT3,9,6,3,0,1,0,11,0,21,3.0,1,0.0,1,3,0,1,5,0,0,11,0,5,16,1
7349,174624,oGK3c8nk6Ftl3V2u1zOvslszD4LDLr3w,SpATywNh6bZuzm8s1ceuBUnMUAeoAHHw,6,13,7,0,3,0,5,0,28,4.0,2,0.0,2,7,0,3,11,0,0,5,0,12,16,1
7350,174850,JsUvqozri9AItThk54BBjEwYIqDey9JK,SpATywNh6bZuzm8s1ceuBUnMUAeoAHHw,14,20,10,20,6,0,4,0,60,8.571428571428571,3,0.0,6,10,16,6,14,0,4,4,0,38,22,1
7351,174896,W38DcguBOORgyx8AQARyx9O00yMNPg6e,A3fsA9Zfv1X2fVEQhTw51lKENdNrEqT3,8,14,3,0,0,0,3,0,20,2.857142857142857,1,0.0,0,3,0,0,14,0,0,3,0,3,17,1
7352,175031,fiQPKilJkIFWShuteKFoAKrsoRjAoTQq,G8EPVSXsOYB5YQWZGiz1aVq5Pgr2GrQu,5,3,2,0,0,2,5,0,12,1.7142857142857142,1,0.0,0,2,0,0,3,2,0,5,0,2,10,1
7353,175139,Vdk84P68xIHXBGrWqw3oEozZYT063dLv,A3fsA9Zfv1X2fVEQhTw51lKENdNrEqT3,11,9,7,0,7,0,5,0,28,4.0,1,0.0,0,7,0,7,9,0,0,5,0,14,14,1
7354,175382,YcbMhXf6WOxBHwzY0X9hWTypvQthAicg,SpATywNh6bZuzm8s1ceuBUnMUAeoAHHw,5,3,2,0,1,0,1,0,7,1.0,1,0.0,0,2,0,1,3,0,0,1,0,3,4,1
7355,175437,Ht8gQquuDWuHnE8TA1lycaHJ8C9MVf20,fbPkOYLVPtPgIt0MxizjfFJov3JbHyAi,1,0,0,0,0,0,1,0,1,0.14285714285714285,1,0.0,0,0,0,0,0,0,0,1,0,0,1,1
7356,175500,052V26a8dvnnaUmI4wUAzyjC2b7PSOrg,fbPkOYLVPtPgIt0MxizjfFJov3JbHyAi,4,2,1,0,1,0,1,0,5,0.7142857142857143,1,0.0,0,1,0,1,2,0,0,1,0,2,3,1
7357,175533,TL1aA8ITe7VP42GX52yE5M5UsjXNCOS3,fbPkOYLVPtPgIt0MxizjfFJov3JbHyAi,6,3,2,0,2,5,1,0,13,1.8571428571428572,1,0.0,0,2,0,2,3,5,0,1,0,4,9,1
7358,175540,xB6Yoh3Jxp1w9CTAondnOiYqF7QVxKDy,fbPkOYLVPtPgIt0MxizjfFJov3JbHyAi,8,7,4,0,2,12,3,0,28,4.0,1,0.0,0,4,0,2,7,12,0,3,0,6,22,1
7359,176352,0Tg2flbTUdD7fODqYIfpiJiK0IDdFiOP,fbPkOYLVPtPgIt0MxizjfFJov3JbHyAi,10,11,8,0,3,9,4,1,36,5.142857142857143,1,0.0,0,8,0,3,11,9,0,4,1,11,25,1
7360,177084,KGMUqHbYYqeF4kil6zUa1qpianJR3FpM,SpATywNh6bZuzm8s1ceuBUnMUAeoAHHw,9,8,1,0,0,0,6,1,16,2.2857142857142856,2,0.0,1,1,0,0,7,0,0,6,1,2,14,1
7361,177087,9G22TFSpifXf2dRYsg4E8vgkMWfro3Ct,bWdj2GDclj5ofokWjzoa5jAwMkxCykd6,6,4,0,0,0,0,8,0,12,1.7142857142857142,1,0.0,0,0,0,0,4,0,0,8,0,0,12,1
7362,177114,wingMAl29ucopfiyx66jxxaUInzOOQW5,SpATywNh6bZuzm8s1ceuBUnMUAeoAHHw,1,0,0,0,0,0,1,0,1,0.14285714285714285,1,0.0,0,0,0,0,0,0,0,1,0,0,1,1
7363,177342,ukV83h2gop6RgQ4r0p0CZA73Nn6q15H2,SpATywNh6bZuzm8s1ceuBUnMUAeoAHHw,8,6,4,0,3,0,3,0,16,2.2857142857142856,1,0.0,0,4,0,3,6,0,0,3,0,7,9,1
7364,177506,TL1aA8ITe7VP42GX52yE5M5UsjXNCOS3,SpATywNh6bZuzm8s1ceuBUnMUAeoAHHw,12,8,5,14,4,23,2,0,56,8.0,1,0.0,2,5,11,4,6,23,3,2,0,22,34,1
7365,177744,7MJ8Lhv2PsjCppkY7orFcs7zn9hmP4MG,A3fsA9Zfv1X2fVEQhTw51lKENdNrEqT3,1,0,0,0,0,0,1,0,1,0.14285714285714285,1,0.0,0,0,0,0,0,0,0,1,0,0,1,1
7366,177879,M8C9BDFICk4ida59GU0jjp556zazDEi1,G8EPVSXsOYB5YQWZGiz1aVq5Pgr2GrQu,4,2,1,0,0,0,2,0,5,0.7142857142857143,1,0.0,0,1,0,0,2,0,0,2,0,1,4,1
7367,178048,ZnF4cH0Rkfun3Ujybr1tuGGeHps3w9hO,A3fsA9Zfv1X2fVEQhTw51lKENdNrEqT3,1,0,0,0,0,0,1,0,1,0.14285714285714285,1,0.0,0,0,0,0,0,0,0,1,0,0,1,1
7368,178058,xk56WEVJEAYlfTe18KDPHjwyCpm6eESo,G8EPVSXsOYB5YQWZGiz1aVq5Pgr2GrQu,18,35,19,30,10,0,4,0,98,14.0,1,0.0,7,19,29,10,28,0,1,4,0,65,33,1
7369,179272,XydvMA0BgL1Al10q3L0D2wz1Y6wVb2rC,RXDvfPUBYFlVdlueBFbLW0mhhAyGEqpt,23,15,14,0,10,0,2,0,41,5.857142857142857,1,0.0,0,14,0,10,15,0,0,2,0,24,17,1
7370,179318,0islXLiLHhX22socdAlKCtW1OjyrNJz9,SpATywNh6bZuzm8s1ceuBUnMUAeoAHHw,7,3,2,0,2,0,2,0,9,1.2857142857142858,1,0.0,0,2,0,2,3,0,0,2,0,4,5,1
7371,179424,RyFLXBVd2U304JMB6ECFi9FilOybDHpw,SpATywNh6bZuzm8s1ceuBUnMUAeoAHHw,12,7,1,17,0,0,4,2,31,4.428571428571429,1,0.0,3,1,16,0,4,0,1,4,2,20,11,1
7372,179447,sRKFcCOCmJuLZB6RUcOH6aSVKmD3A5OQ,SpATywNh6bZuzm8s1ceuBUnMUAeoAHHw,1,0,0,0,0,0,1,0,1,0.14285714285714285,1,0.0,0,0,0,0,0,0,0,1,0,0,1,1
7373,179732,GnMMDgMkehWbrroCw3WzwugiIkCP2y33,G8EPVSXsOYB5YQWZGiz1aVq5Pgr2GrQu,18,14,9,34,6,7,4,0,74,10.571428571428571,1,0.0,2,9,29,6,12,7,5,4,0,46,28,1
7374,179739,yYsW32kCOP4EgbR8poMa9E3lg8DNZAYh,SpATywNh6bZuzm8s1ceuBUnMUAeoAHHw,1,0,0,0,0,0,1,0,1,0.14285714285714285,1,0.0,0,0,0,0,0,0,0,1,0,0,1,1
7375,179772,StY7mIcclc0vcUIJFTvL9RrXxdUXnEhh,SpATywNh6bZuzm8s1ceuBUnMUAeoAHHw,14,13,7,6,5,3,2,0,36,5.142857142857143,1,0.0,5,7,6,5,8,3,0,2,0,23,13,1
7376,179802,fIbdXFPoTOYlPmaY1ETJ8qg0oyUmhp0g,bWdj2GDclj5ofokWjzoa5jAwMkxCykd6,1,0,0,0,0,0,1,0,1,0.14285714285714285,1,0.0,0,0,0,0,0,0,0,1,0,0,1,1
7377,180006,5I4Sxxub5eHlZ4uVi2doKTMQ77gD08Kz,SpATywNh6bZuzm8s1ceuBUnMUAeoAHHw,3,2,0,0,0,0,2,0,4,0.5714285714285714,1,0.0,0,0,0,0,2,0,0,2,0,0,4,1
7378,180043,IB6QwGjfRbp7aWxgSMpIkngT9FviLi1Z,bWdj2GDclj5ofokWjzoa5jAwMkxCykd6,1,0,0,0,0,0,1,0,1,0.14285714285714285,1,0.0,0,0,0,0,0,0,0,1,0,0,1,1
7379,180269,oPqCsuIFtZAPoNsyhKvigrqOFJmD29Ve,7GRhBDsirIGkRZBtSMEzNTyDr2JQm4xx,9,4,1,4,0,1,7,1,18,2.5714285714285716,1,0.0,1,1,3,0,3,1,1,7,1,5,13,1
7380,182109,Gwa0DmAnwS7uFof0niE4PXKO0jXe3Slf,fbPkOYLVPtPgIt0MxizjfFJov3JbHyAi,1,0,0,0,0,0,1,0,1,0.14285714285714285,1,0.0,0,0,0,0,0,0,0,1,0,0,1,1
7381,182112,zlwQbpNIekZraqM3friulFpxhiOo1ayo,fbPkOYLVPtPgIt0MxizjfFJov3JbHyAi,10,15,5,12,5,0,1,0,38,5.428571428571429,1,0.0,8,5,10,5,7,0,2,1,0,28,10,1
7382,182113,GYgjnVWPCrydBlTq2p9TNsOMewn9I740,fbPkOYLVPtPgIt0MxizjfFJov3JbHyAi,7,3,2,0,2,1,2,0,10,1.4285714285714286,1,0.0,0,2,0,2,3,1,0,2,0,4,6,1
7383,182116,hHZ1kUumh00Z1O4WNdKmul7qhC5wFHpp,fbPkOYLVPtPgIt0MxizjfFJov3JbHyAi,2,0,0,0,0,0,2,0,2,0.2857142857142857,1,0.0,0,0,0,0,0,0,0,2,0,0,2,1
7384,182119,3cxRLD4ivD6Xixr11d6ir7hAedI4FyWB,fbPkOYLVPtPgIt0MxizjfFJov3JbHyAi,4,4,0,0,0,0,2,0,6,0.8571428571428571,1,0.0,0,0,0,0,4,0,0,2,0,0,6,1
7385,182120,6VA6nLOi6ahJ2WGPKX7ioAOUNgqPHvUs,fbPkOYLVPtPgIt0MxizjfFJov3JbHyAi,2,0,0,0,0,0,6,0,6,0.8571428571428571,1,0.0,0,0,0,0,0,0,0,6,0,0,6,1
7386,182121,E6bBR9HWJxY6CHMf6HUGhFy5mb5tOylJ,fbPkOYLVPtPgIt0MxizjfFJov3JbHyAi,11,8,5,0,5,0,7,0,25,3.5714285714285716,1,0.0,0,5,0,5,8,0,0,7,0,10,15,1
7387,182122,5YQOb4e4NWGumJICWtGzlXhZqNgwWRbu,fbPkOYLVPtPgIt0MxizjfFJov3JbHyAi,4,2,1,0,1,0,2,0,6,0.8571428571428571,1,0.0,0,1,0,1,2,0,0,2,0,2,4,1
7388,182123,ymJ3Ly9A46GdjQR1wi3rfZi54oWQxUId,fbPkOYLVPtPgIt0MxizjfFJov3JbHyAi,18,18,10,0,5,3,10,1,47,6.714285714285714,1,0.0,0,10,0,5,18,3,0,10,1,15,32,1
7389,182126,olMbWc9RSQc0Tu4bEWQzOnwezTDWcrs8,fbPkOYLVPtPgIt0MxizjfFJov3JbHyAi,6,5,1,0,1,0,2,0,9,1.2857142857142858,1,0.0,0,1,0,1,5,0,0,2,0,2,7,1
7390,182127,vRSgOJQhE6Dmiwqh3C4hk74qCb0K1GB9,fbPkOYLVPtPgIt0MxizjfFJov3JbHyAi,10,11,3,0,5,6,8,1,34,4.857142857142857,1,0.0,5,3,0,5,6,6,0,8,1,13,21,1
7391,182129,KZwRHcnI3AfT8vnaT6jXgPBnofHOQ7LC,fbPkOYLVPtPgIt0MxizjfFJov3JbHyAi,7,3,2,0,2,0,2,0,9,1.2857142857142858,1,0.0,0,2,0,2,3,0,0,2,0,4,5,1
7392,182130,NYIqoSfm9poo24TZ0kcwGlXtybBgVCOL,fbPkOYLVPtPgIt0MxizjfFJov3JbHyAi,11,13,6,4,6,13,6,1,49,7.0,1,0.0,5,6,4,6,8,13,0,6,1,21,28,1
7393,182131,fNApL5o3nJBE8hTLknxUE86rJy4pC3GT,fbPkOYLVPtPgIt0MxizjfFJov3JbHyAi,4,3,0,0,0,0,8,0,11,1.5714285714285714,1,0.0,0,0,0,0,3,0,0,8,0,0,11,1
7394,182132,hl9NS7ZQVsxPwew9lFoMcbw555xXfA7K,fbPkOYLVPtPgIt0MxizjfFJov3JbHyAi,7,5,2,0,1,4,3,0,15,2.142857142857143,1,0.0,0,2,0,1,5,4,0,3,0,3,12,1
7395,182133,UyFXTBkXJQGbTK6ia4vV9zDaXqtiIBQm,fbPkOYLVPtPgIt0MxizjfFJov3JbHyAi,7,8,2,0,3,0,2,0,15,2.142857142857143,1,0.0,5,2,0,3,3,0,0,2,0,10,5,1
7396,182136,X4KSPkBIdPEeXdEy4Fa5NvixCQZdfNj3,fbPkOYLVPtPgIt0MxizjfFJov3JbHyAi,4,2,1,0,1,2,1,0,7,1.0,1,0.0,0,1,0,1,2,2,0,1,0,2,5,0
7397,182137,y20f09CxhvS55Wblm8XZJQuRockZgjId,fbPkOYLVPtPgIt0MxizjfFJov3JbHyAi,7,6,2,0,3,0,4,0,15,2.142857142857143,1,0.0,3,2,0,3,3,0,0,4,0,8,7,1
7398,182140,CspzBeiHo2fn2vKCGW8HrTuVGO5NjODD,fbPkOYLVPtPgIt0MxizjfFJov3JbHyAi,7,7,4,0,3,1,1,0,16,2.2857142857142856,1,0.0,1,4,0,3,6,1,0,1,0,8,8,1
7399,182141,AauRkOnfsQwSVeed7CUEfyrgZR6O3N4f,fbPkOYLVPtPgIt0MxizjfFJov3JbHyAi,9,3,2,0,2,1,5,1,14,2.0,1,0.0,0,2,0,2,3,1,0,5,1,4,10,1
7400,182142,ZpH2lTvJnGFaqS5AMOBCpvMR4Yj9r7Pd,fbPkOYLVPtPgIt0MxizjfFJov3JbHyAi,9,3,2,0,2,0,6,1,14,2.0,1,0.0,0,2,0,2,3,0,0,6,1,4,10,1
7401,182148,QXkIuj2oxPauvAqRj9R3CrSpnC0ZZZoj,fbPkOYLVPtPgIt0MxizjfFJov3JbHyAi,1,0,0,0,0,0,1,0,1,0.14285714285714285,1,0.0,0,0,0,0,0,0,0,1,0,0,1,1
7402,182149,Gk8pzlz0IYhW1OkJmVAg6JK1p1uZlJAZ,fbPkOYLVPtPgIt0MxizjfFJov3JbHyAi,1,0,0,0,0,0,1,0,1,0.14285714285714285,1,0.0,0,0,0,0,0,0,0,1,0,0,1,1
7403,182150,7DufOZH7uJb86RSw7kwej322YsuvsAOn,fbPkOYLVPtPgIt0MxizjfFJov3JbHyAi,8,7,3,0,2,0,2,0,14,2.0,1,0.0,0,3,0,2,7,0,0,2,0,5,9,1
7404,182151,9IwP7y3bv6FVCnKXUMMCB32M5XkaXZUv,fbPkOYLVPtPgIt0MxizjfFJov3JbHyAi,4,2,1,0,1,3,1,0,8,1.1428571428571428,1,0.0,0,1,0,1,2,3,0,1,0,2,6,1
7405,182153,LYRECt7UvWAQo3p4ZaUgaxhi8hvbxrUh,fbPkOYLVPtPgIt0MxizjfFJov3JbHyAi,8,3,2,0,2,4,4,1,16,2.2857142857142856,1,0.0,0,2,0,2,3,4,0,4,1,4,12,1
7406,182157,qjvNhzawDTohg4QJduwMXhiyYQLWnwRL,fbPkOYLVPtPgIt0MxizjfFJov3JbHyAi,5,2,1,0,1,0,5,0,9,1.2857142857142858,1,0.0,0,1,0,1,2,0,0,5,0,2,7,1
7407,182158,EbhEKkK0InsrxKv61aHGTKOc8r6D96CH,fbPkOYLVPtPgIt0MxizjfFJov3JbHyAi,5,2,1,0,1,4,5,0,13,1.8571428571428572,1,0.0,0,1,0,1,2,4,0,5,0,2,11,1
7408,182161,fnqTxztLKveM5YvxSzdyiaXhOlLMcpQz,fbPkOYLVPtPgIt0MxizjfFJov3JbHyAi,6,3,2,0,2,0,1,0,8,1.1428571428571428,1,0.0,0,2,0,2,3,0,0,1,0,4,4,1
7409,182290,5toCKkjnRq0eSPOLqtFoS578XbzD4wBw,G8EPVSXsOYB5YQWZGiz1aVq5Pgr2GrQu,1,0,0,0,0,0,1,0,1,0.14285714285714285,1,0.0,0,0,0,0,0,0,0,1,0,0,1,1
7410,182291,cQRD9R1lgeOAK9gupu9KhB7dk2fRklcD,SpATywNh6bZuzm8s1ceuBUnMUAeoAHHw,1,0,0,0,0,0,1,0,1,0.14285714285714285,1,0.0,0,0,0,0,0,0,0,1,0,0,1,1
7411,182293,rjvGhIVc59Kfmh4NTR3DXDqHucpB5jFj,SpATywNh6bZuzm8s1ceuBUnMUAeoAHHw,1,0,0,0,0,0,1,0,1,0.14285714285714285,1,0.0,0,0,0,0,0,0,0,1,0,0,1,1
7412,182294,yzxOtAUXbE94zTY0JAZtWSh2NXgDCsgD,RXDvfPUBYFlVdlueBFbLW0mhhAyGEqpt,1,0,0,0,0,0,2,0,2,0.2857142857142857,1,0.0,0,0,0,0,0,0,0,2,0,0,2,1
7413,182295,zDSSBRMWP1Y5CJVqlFdftdl4OIpV063x,G8EPVSXsOYB5YQWZGiz1aVq5Pgr2GrQu,5,5,2,0,2,0,9,0,18,2.5714285714285716,1,0.0,2,2,0,2,3,0,0,9,0,6,12,1
7414,182301,kSqoYJOiSgMSgk1xmaagqD7swBESTNnk,SpATywNh6bZuzm8s1ceuBUnMUAeoAHHw,1,0,0,0,0,0,1,0,1,0.14285714285714285,1,0.0,0,0,0,0,0,0,0,1,0,0,1,1
7415,182303,6V0aEecugZSGEGjp9sOtqKaVX0hdaxfx,SpATywNh6bZuzm8s1ceuBUnMUAeoAHHw,1,0,0,0,0,0,1,0,1,0.14285714285714285,1,0.0,0,0,0,0,0,0,0,1,0,0,1,1
7416,182311,v2pq4xsqndqpApLtzn0qeg9IWIRhaLtH,RXDvfPUBYFlVdlueBFbLW0mhhAyGEqpt,1,0,0,0,0,0,1,0,1,0.14285714285714285,1,0.0,0,0,0,0,0,0,0,1,0,0,1,1
7417,182316,PlkufWXrNLS9iN2k0xnVvGFQQ3lcdAbM,G8EPVSXsOYB5YQWZGiz1aVq5Pgr2GrQu,1,0,0,0,0,0,1,0,1,0.14285714285714285,1,0.0,0,0,0,0,0,0,0,1,0,0,1,1
7418,182317,pCLzLzljqYC5o1UQJ6Cha7geyVzPY5Vr,SpATywNh6bZuzm8s1ceuBUnMUAeoAHHw,6,3,0,0,0,12,12,2,29,4.142857142857143,1,0.0,0,0,0,0,3,12,0,12,2,0,29,1
7419,182319,dVj05AozpSMnDp2rhv4XKLX2a6Zq0Qtw,G8EPVSXsOYB5YQWZGiz1aVq5Pgr2GrQu,1,0,0,0,0,0,1,0,1,0.14285714285714285,1,0.0,0,0,0,0,0,0,0,1,0,0,1,1
7420,182326,Sw8bR12uIoqYzcTEWiNrFu21bYIsPZ21,SpATywNh6bZuzm8s1ceuBUnMUAeoAHHw,8,3,1,0,1,4,11,1,21,3.0,2,0.0,0,1,0,1,3,4,0,11,1,2,19,1
7421,182335,o4d7pEXcgiRK88QgwrazSAkO64S1An1t,SpATywNh6bZuzm8s1ceuBUnMUAeoAHHw,5,0,0,0,0,1,6,1,8,1.1428571428571428,1,0.0,0,0,0,0,0,1,0,6,1,0,8,1
7422,182339,Xx5J61LsGAAIQtOy53VIgrfa1jCLAM7p,SpATywNh6bZuzm8s1ceuBUnMUAeoAHHw,6,4,0,0,0,0,9,3,16,2.2857142857142856,1,0.0,0,0,0,0,4,0,0,9,3,0,16,1
7423,182340,0hNxT6GuoMZdI4yowbLV9KqXkZO6tOr5,bWdj2GDclj5ofokWjzoa5jAwMkxCykd6,2,0,0,0,0,0,2,0,2,0.2857142857142857,1,0.0,0,0,0,0,0,0,0,2,0,0,2,1
7424,182347,HtQh4lek05i0a5loRX7CCHUQbHgEiPqt,G8EPVSXsOYB5YQWZGiz1aVq5Pgr2GrQu,1,0,0,0,0,0,1,0,1,0.14285714285714285,1,0.0,0,0,0,0,0,0,0,1,0,0,1,1
7425,182353,WO9GKA0lZwTMWZPNOUikUeUkOH5TeVRT,bWdj2GDclj5ofokWjzoa5jAwMkxCykd6,5,1,0,0,0,1,3,0,5,0.7142857142857143,1,0.0,0,0,0,0,1,1,0,3,0,0,5,1
7426,182356,Bk9dV86JsBuitZPucHUYfkNksrS8wdwY,G8EPVSXsOYB5YQWZGiz1aVq5Pgr2GrQu,1,0,0,0,0,0,1,0,1,0.14285714285714285,1,0.0,0,0,0,0,0,0,0,1,0,0,1,1
7427,182364,sHXZP4MEjEMzkkOQfvmTepwt8uTqOiyM,bWdj2GDclj5ofokWjzoa5jAwMkxCykd6,1,0,0,0,0,0,2,0,2,0.2857142857142857,1,0.0,0,0,0,0,0,0,0,2,0,0,2,1
7428,182373,JQ5HcehgeZikB3gBiE8cU639NjwVjWKa,SpATywNh6bZuzm8s1ceuBUnMUAeoAHHw,6,2,0,0,0,4,12,1,19,2.7142857142857144,1,0.0,0,0,0,0,2,4,0,12,1,0,19,1
7429,182381,qaaVUOEYbrLxp7YRueHtvaFuKfMUdZFu,SpATywNh6bZuzm8s1ceuBUnMUAeoAHHw,4,1,0,0,0,0,5,0,6,0.8571428571428571,1,0.0,0,0,0,0,1,0,0,5,0,0,6,1
7430,182382,GaGH1fy9jH1iKzXu03szgy9cHdGLnq5i,SpATywNh6bZuzm8s1ceuBUnMUAeoAHHw,5,3,0,0,0,1,8,1,13,1.8571428571428572,1,0.0,0,0,0,0,3,1,0,8,1,0,13,0
7431,182386,qPi2PGJwgnVJqcFYKHdGLm3vb4xL3Vqe,SpATywNh6bZuzm8s1ceuBUnMUAeoAHHw,3,1,0,0,0,0,2,1,4,0.5714285714285714,1,0.0,0,0,0,0,1,0,0,2,1,0,4,1
7432,182390,1b8W57uM2By4uHrSNMMSnzGhkYIXdyHL,SpATywNh6bZuzm8s1ceuBUnMUAeoAHHw,8,12,6,0,0,17,9,1,45,6.428571428571429,1,0.0,0,6,0,0,12,17,0,9,1,6,39,1
7433,182396,zp4PyZk9acvJn0zAHSStMGVB47KHiGqV,SpATywNh6bZuzm8s1ceuBUnMUAeoAHHw,4,2,0,0,0,1,6,0,9,1.2857142857142858,1,0.0,0,0,0,0,2,1,0,6,0,0,9,1
7434,182408,guVBQQJjeYDSTq5MuNRM97IJcEbUqgcR,bWdj2GDclj5ofokWjzoa5jAwMkxCykd6,1,0,0,0,0,0,1,0,1,0.14285714285714285,1,0.0,0,0,0,0,0,0,0,1,0,0,1,1
7435,182409,Ts2aYicZBB6YO6VPNN4UcEdjhKngsoNN,SpATywNh6bZuzm8s1ceuBUnMUAeoAHHw,5,7,2,0,1,0,4,0,14,2.0,1,0.0,0,2,0,1,7,0,0,4,0,3,11,1
7436,182410,LF2KQyoh29W4ySeHppAbd59MSPNMzEhL,SpATywNh6bZuzm8s1ceuBUnMUAeoAHHw,7,4,3,0,3,0,3,0,13,1.8571428571428572,1,0.0,0,3,0,3,4,0,0,3,0,6,7,1
7437,182412,nWBGuFtxvcnIdby83CLlwrZAI2gdEnIT,SpATywNh6bZuzm8s1ceuBUnMUAeoAHHw,12,23,0,32,0,0,5,0,60,8.571428571428571,1,0.0,15,0,31,0,8,0,1,5,0,46,14,1
7438,182413,GXDOLXInBDPENmCe7wGStFtoPK2oUX4s,SpATywNh6bZuzm8s1ceuBUnMUAeoAHHw,1,0,0,0,0,0,7,0,7,1.0,1,0.0,0,0,0,0,0,0,0,7,0,0,7,1
7439,182431,FvzTIFO6hWFbSbURKzXHQcilBAcLEPtg,SpATywNh6bZuzm8s1ceuBUnMUAeoAHHw,7,6,4,0,2,1,1,0,14,2.0,1,0.0,0,4,0,2,6,1,0,1,0,6,8,1
7440,182432,42bX0uPWOXgBHMwF4wqdnl1Ve6wIHNQe,RXDvfPUBYFlVdlueBFbLW0mhhAyGEqpt,1,0,0,0,0,0,1,0,1,0.14285714285714285,1,0.0,0,0,0,0,0,0,0,1,0,0,1,1
7441,182435,HxeyM7hnjqqrHkT4PVJnwDZtWwoxUMiy,SpATywNh6bZuzm8s1ceuBUnMUAeoAHHw,11,10,1,0,1,1,6,1,20,2.857142857142857,1,0.0,2,1,0,1,8,1,0,6,1,4,16,1
7442,182437,6tKFS11agpQ0olDkx5j9iNHGPGSGzhhI,SpATywNh6bZuzm8s1ceuBUnMUAeoAHHw,5,2,1,0,1,0,3,0,7,1.0,1,0.0,0,1,0,1,2,0,0,3,0,2,5,1
7443,182438,Lj5uTbeKi1sufoHMuLZiALNDuJSM9yU6,SpATywNh6bZuzm8s1ceuBUnMUAeoAHHw,8,12,6,0,4,22,6,0,50,7.142857142857143,1,0.0,0,6,0,4,12,22,0,6,0,10,40,1
7444,182440,kEYZryUXXrs1JDEn4cAws8bSjO65yGwg,SpATywNh6bZuzm8s1ceuBUnMUAeoAHHw,10,4,3,0,2,0,5,0,14,2.0,1,0.0,0,3,0,2,4,0,0,5,0,5,9,1
7445,182443,xS1af9TI3CHZS0INarz6NC45nSv9EYbw,SpATywNh6bZuzm8s1ceuBUnMUAeoAHHw,4,3,1,0,0,0,2,0,6,0.8571428571428571,1,0.0,0,1,0,0,3,0,0,2,0,1,5,0
7446,182456,N48ctBBocxdq0KkO9X20oV13gY0Gjyl2,SpATywNh6bZuzm8s1ceuBUnMUAeoAHHw,5,3,2,0,2,0,2,0,9,1.2857142857142858,1,0.0,0,2,0,2,3,0,0,2,0,4,5,1
7447,182460,GjfYG8nVkFnRE6YCq1jd11CdDUHtJYRI,RXDvfPUBYFlVdlueBFbLW0mhhAyGEqpt,2,0,0,0,0,0,2,0,2,0.2857142857142857,1,0.0,0,0,0,0,0,0,0,2,0,0,2,1
7448,182462,SKgefBsbooOLi1DQ2ANZv6uhR5LclYyt,SpATywNh6bZuzm8s1ceuBUnMUAeoAHHw,2,0,0,0,0,0,2,0,2,0.2857142857142857,1,0.0,0,0,0,0,0,0,0,2,0,0,2,1
7449,182469,3kzqQ9nu0puySXndbv8HvzuMPwBlBjfc,SpATywNh6bZuzm8s1ceuBUnMUAeoAHHw,5,2,1,0,1,0,3,0,7,1.0,1,0.0,0,1,0,1,2,0,0,3,0,2,5,1
7450,182474,jhtAULfQ5yICMx2IFQr24sJJ4xrsxsJG,SpATywNh6bZuzm8s1ceuBUnMUAeoAHHw,5,2,1,0,1,0,2,0,6,0.8571428571428571,1,0.0,0,1,0,1,2,0,0,2,0,2,4,1
7451,182475,mN4qYBgpy4Qxh2rSlBkY5ZDyLEZtAHu9,SpATywNh6bZuzm8s1ceuBUnMUAeoAHHw,6,5,3,0,1,4,3,1,17,2.4285714285714284,2,0.0,0,3,0,1,5,4,0,3,1,4,13,1
7452,182481,vyEmNT9CTTZs1s1eotM7mTmxUqBkMZB7,RXDvfPUBYFlVdlueBFbLW0mhhAyGEqpt,1,0,0,0,0,0,1,0,1,0.14285714285714285,1,0.0,0,0,0,0,0,0,0,1,0,0,1,1
7453,182485,z17j9VE8hh3UoPkOgrySRSueL3ju2tA5,SpATywNh6bZuzm8s1ceuBUnMUAeoAHHw,5,2,1,0,1,0,2,0,6,0.8571428571428571,1,0.0,0,1,0,1,2,0,0,2,0,2,4,1
7454,182486,m5upFVNgYoX0YbIT8oOeY2wNVmvYCqj2,SpATywNh6bZuzm8s1ceuBUnMUAeoAHHw,14,16,0,8,0,0,11,1,36,5.142857142857143,2,0.0,2,0,8,0,14,0,0,11,1,10,26,1
7455,182487,nVOg10sq8HgH3D4DlsGdX3NFr8soVHEc,RXDvfPUBYFlVdlueBFbLW0mhhAyGEqpt,3,0,0,0,0,1,2,1,4,0.5714285714285714,1,0.0,0,0,0,0,0,1,0,2,1,0,4,1
7456,182489,NrHk4qmJXuD0TsjkQSnghKpk9ZjGAOyU,SpATywNh6bZuzm8s1ceuBUnMUAeoAHHw,6,4,3,0,3,0,1,0,11,1.5714285714285714,1,0.0,0,3,0,3,4,0,0,1,0,6,5,1
7457,182494,zsHSwvXoubMUxhT2AYVzfcvRGMppEBUX,SpATywNh6bZuzm8s1ceuBUnMUAeoAHHw,1,0,0,0,0,0,1,0,1,0.14285714285714285,1,0.0,0,0,0,0,0,0,0,1,0,0,1,1
7458,182500,VBP5PzVQEKJYFH0y5ffEek5WfP9EW7uc,RXDvfPUBYFlVdlueBFbLW0mhhAyGEqpt,1,0,0,0,0,0,1,0,1,0.14285714285714285,1,0.0,0,0,0,0,0,0,0,1,0,0,1,1
7459,182502,kAraFi42vk7T3fSVrfxFu4iOqntHqrmm,SpATywNh6bZuzm8s1ceuBUnMUAeoAHHw,5,2,1,0,1,0,2,0,6,0.8571428571428571,1,0.0,0,1,0,1,2,0,0,2,0,2,4,1
7460,182505,m0a4B9CqoOZviuEOZZDt94aINv2ug5oe,SpATywNh6bZuzm8s1ceuBUnMUAeoAHHw,12,12,0,18,0,1,5,1,37,5.285714285714286,1,0.0,7,0,16,0,5,1,2,5,1,23,14,1
7461,182512,6hJQXXKt3z1MdoT6ARo6T723NTe1XSxK,SpATywNh6bZuzm8s1ceuBUnMUAeoAHHw,5,3,2,0,0,0,2,0,7,1.0,1,0.0,0,2,0,0,3,0,0,2,0,2,5,1
7462,182517,ks5e3RcWAMPB7dYikwZWJXfUkWO8gZ3N,SpATywNh6bZuzm8s1ceuBUnMUAeoAHHw,4,3,0,0,1,0,1,0,5,0.7142857142857143,1,0.0,0,0,0,1,3,0,0,1,0,1,4,1
7463,182521,T5B0wanX0DF5aMvlnBdjCYkcuibanyPc,SpATywNh6bZuzm8s1ceuBUnMUAeoAHHw,7,3,2,0,2,1,2,0,10,1.4285714285714286,1,0.0,0,2,0,2,3,1,0,2,0,4,6,1
7464,182523,84Vq27rxsidbGJFxLO0cd5e2CSiXRChu,bWdj2GDclj5ofokWjzoa5jAwMkxCykd6,9,5,3,0,2,0,5,0,15,2.142857142857143,2,0.0,0,3,0,2,5,0,0,5,0,5,10,1
7465,182525,cPdYTPvgiw01Ix09y30D3fRJUN12tLct,SpATywNh6bZuzm8s1ceuBUnMUAeoAHHw,4,2,1,0,1,0,1,0,5,0.7142857142857143,1,0.0,0,1,0,1,2,0,0,1,0,2,3,1
7466,182528,9BiLYY350hgtHO5tL7nbMfcZU0JcfZbs,bWdj2GDclj5ofokWjzoa5jAwMkxCykd6,13,32,11,26,8,6,15,3,101,14.428571428571429,2,0.0,7,11,25,8,25,6,1,15,3,51,50,1
7467,182532,hnqQN2i26CUAGHIpVFZ6rAak8SqbOivU,SpATywNh6bZuzm8s1ceuBUnMUAeoAHHw,14,12,7,0,4,12,6,2,43,6.142857142857143,1,0.0,3,7,0,4,9,12,0,6,2,14,29,1
7468,182535,Y6X26XefNz3sdpw3wkwyK5sCZwXPgnq9,G8EPVSXsOYB5YQWZGiz1aVq5Pgr2GrQu,1,0,0,0,0,0,1,0,1,0.14285714285714285,1,0.0,0,0,0,0,0,0,0,1,0,0,1,1
7469,182537,1MlRC5B28v0ZYaZMhNewOGPdpzQmr9tm,G8EPVSXsOYB5YQWZGiz1aVq5Pgr2GrQu,1,0,0,0,0,0,2,0,2,0.2857142857142857,1,0.0,0,0,0,0,0,0,0,2,0,0,2,1
7470,182549,95du6AurTX5krUoy6t3WLkl60ccYr4Yy,SpATywNh6bZuzm8s1ceuBUnMUAeoAHHw,7,6,3,0,2,0,1,0,12,1.7142857142857142,1,0.0,0,3,0,2,6,0,0,1,0,5,7,1
7471,182550,s7vJJA7T1Y0Q1LgIP8wcUZxSj1YxtrKh,SpATywNh6bZuzm8s1ceuBUnMUAeoAHHw,5,2,1,0,1,0,2,0,6,0.8571428571428571,1,0.0,0,1,0,1,2,0,0,2,0,2,4,1
7472,182551,TzUoSJ3pyMjwCKLIHuVSKLad9h9hLr5U,bWdj2GDclj5ofokWjzoa5jAwMkxCykd6,4,4,0,0,0,0,2,0,6,0.8571428571428571,2,0.0,0,0,0,0,4,0,0,2,0,0,6,1
7473,182562,abjQNDbGZHBvhV75LOq4Zq7eUXUW7X3t,SpATywNh6bZuzm8s1ceuBUnMUAeoAHHw,5,2,1,0,1,16,4,0,24,3.4285714285714284,1,0.0,0,1,0,1,2,16,0,4,0,2,22,1
7474,182564,9TiNdK7h4B0s8IwXYYwGBHmjweOZzBSB,SpATywNh6bZuzm8s1ceuBUnMUAeoAHHw,6,3,2,0,2,0,1,0,8,1.1428571428571428,1,0.0,0,2,0,2,3,0,0,1,0,4,4,1
7475,182566,d5l2AueqCUuxelNqQjpUQXmepKxeL9RK,SpATywNh6bZuzm8s1ceuBUnMUAeoAHHw,2,0,0,0,0,0,3,0,3,0.42857142857142855,1,0.0,0,0,0,0,0,0,0,3,0,0,3,1
7476,182578,2lL4O2JkoYHXEIhykvPcKhzBe5EQva7N,SpATywNh6bZuzm8s1ceuBUnMUAeoAHHw,10,6,4,0,3,1,4,0,18,2.5714285714285716,1,0.0,0,4,0,3,6,1,0,4,0,7,11,1
7477,182580,Sg8cI88TycyqBJF3IvR4MAi6ZTHZwK4Y,SpATywNh6bZuzm8s1ceuBUnMUAeoAHHw,8,4,2,0,2,0,2,0,10,1.4285714285714286,1,0.0,0,2,0,2,4,0,0,2,0,4,6,1
7478,182581,jU374KwiA6GV2KDGbAoaF4QnL7rMxEi0,G8EPVSXsOYB5YQWZGiz1aVq5Pgr2GrQu,2,0,0,0,0,0,2,0,2,0.2857142857142857,1,0.0,0,0,0,0,0,0,0,2,0,0,2,1
7479,182585,2a0JX3oGEViqf41bSYpVwPl2biPpAdoF,SpATywNh6bZuzm8s1ceuBUnMUAeoAHHw,1,0,0,0,0,0,2,0,2,0.2857142857142857,1,0.0,0,0,0,0,0,0,0,2,0,0,2,1
7480,182588,0PHNMn5JYsQigYaNxUJgIv4qow2cWlQK,RXDvfPUBYFlVdlueBFbLW0mhhAyGEqpt,1,0,0,0,0,0,1,0,1,0.14285714285714285,1,0.0,0,0,0,0,0,0,0,1,0,0,1,1
7481,182594,i1weaEaafaiWi31Ms4bwoF6JM4IRf714,RXDvfPUBYFlVdlueBFbLW0mhhAyGEqpt,4,2,1,0,1,0,1,0,5,0.7142857142857143,1,0.0,0,1,0,1,2,0,0,1,0,2,3,1
7482,182597,yP6YIcdT0zgy1EQJGlMcTsst8ErbjUGy,SpATywNh6bZuzm8s1ceuBUnMUAeoAHHw,15,12,7,8,4,0,4,0,35,5.0,1,0.0,2,7,8,4,10,0,0,4,0,21,14,1
7483,182601,ryvCYWNER8Ti86HxjplPmDOVtkpCfcHF,SpATywNh6bZuzm8s1ceuBUnMUAeoAHHw,5,2,0,3,0,0,3,0,8,1.1428571428571428,1,0.0,1,0,3,0,1,0,0,3,0,4,4,1
7484,182603,pC6FwYDHxh9swUa6nvJYcLLtE0AYC1Cg,G8EPVSXsOYB5YQWZGiz1aVq5Pgr2GrQu,1,0,0,0,0,0,1,0,1,0.14285714285714285,1,0.0,0,0,0,0,0,0,0,1,0,0,1,1
7485,182606,DgUbD2nFaZ1xgkcPsb7gJ6lYqMu1fGiD,SpATywNh6bZuzm8s1ceuBUnMUAeoAHHw,10,3,3,0,3,1,8,1,19,2.7142857142857144,1,0.0,0,3,0,3,3,1,0,8,1,6,13,1
7486,182607,wMgpdygsXgp7CzOQBDeaQc0sjt2NDO9y,SpATywNh6bZuzm8s1ceuBUnMUAeoAHHw,9,13,6,0,3,0,3,0,25,3.5714285714285716,1,0.0,0,6,0,3,13,0,0,3,0,9,16,1
7487,182612,0hrKpjkp9zkhrQR2RoP7TZCXn5cdSG8v,SpATywNh6bZuzm8s1ceuBUnMUAeoAHHw,9,12,3,1,2,0,5,0,23,3.2857142857142856,1,0.0,3,3,1,2,9,0,0,5,0,9,14,1
7488,182615,gnekWLWeAJ1MVfJL4ZXLvhc4aznPtP4v,RXDvfPUBYFlVdlueBFbLW0mhhAyGEqpt,18,24,18,0,8,0,6,0,56,8.0,1,0.0,2,18,0,8,22,0,0,6,0,28,28,1
7489,182616,8JTz84ZDdJm6tvsd7hgyCl1RB6wU6r2e,SpATywNh6bZuzm8s1ceuBUnMUAeoAHHw,5,3,2,0,1,0,1,0,7,1.0,1,0.0,0,2,0,1,3,0,0,1,0,3,4,1
7490,182620,pmyN5Lpd7zPzDMrdwaddb9OujjdVFpIA,SpATywNh6bZuzm8s1ceuBUnMUAeoAHHw,1,0,0,0,0,0,1,0,1,0.14285714285714285,1,0.0,0,0,0,0,0,0,0,1,0,0,1,1
7491,182621,uLzTTG1K0rlYPSkAfYE7pAYKyeT5Eqlp,bWdj2GDclj5ofokWjzoa5jAwMkxCykd6,14,24,9,78,4,0,4,0,119,17.0,2,0.0,10,9,71,4,14,0,7,4,0,94,25,1
7492,182622,99qhCmy07rsquumjTFRELTtrLHpQpj07,SpATywNh6bZuzm8s1ceuBUnMUAeoAHHw,9,9,4,0,3,0,1,0,17,2.4285714285714284,1,0.0,0,4,0,3,9,0,0,1,0,7,10,1
7493,182625,pmyN5Lpd7zPzDMrdwaddb9OujjdVFpIA,G8EPVSXsOYB5YQWZGiz1aVq5Pgr2GrQu,1,0,0,0,0,0,1,0,1,0.14285714285714285,1,0.0,0,0,0,0,0,0,0,1,0,0,1,1
7494,182631,jvMxvmnfDR2nX2SDb9U9vK3bZQo5n6aS,SpATywNh6bZuzm8s1ceuBUnMUAeoAHHw,8,4,2,0,2,0,2,0,10,1.4285714285714286,1,0.0,0,2,0,2,4,0,0,2,0,4,6,1
7495,182632,JDFQZtkjaBhYZM0MLFNIDJC3MmDM3j4N,G8EPVSXsOYB5YQWZGiz1aVq5Pgr2GrQu,1,0,0,0,0,0,1,0,1,0.14285714285714285,1,0.0,0,0,0,0,0,0,0,1,0,0,1,1
7496,182635,xQkXRLMidDA6kOSlXJCwzS4szskglPiE,SpATywNh6bZuzm8s1ceuBUnMUAeoAHHw,8,2,2,0,2,0,6,0,12,1.7142857142857142,1,0.0,0,2,0,2,2,0,0,6,0,4,8,1
7497,182642,1KbKxaDkaJs93myqaKszRgBW1gxYyrTr,SpATywNh6bZuzm8s1ceuBUnMUAeoAHHw,7,3,2,0,2,0,2,0,9,1.2857142857142858,1,0.0,0,2,0,2,3,0,0,2,0,4,5,1
7498,182652,OvE6fswKcyt8W4X23yrGAT3owgNKqghE,SpATywNh6bZuzm8s1ceuBUnMUAeoAHHw,5,2,1,0,1,1,2,0,7,1.0,1,0.0,0,1,0,1,2,1,0,2,0,2,5,1
7499,182653,kNUYVfCCGHx63xQDhqVhj2cbZ7iw47SV,SpATywNh6bZuzm8s1ceuBUnMUAeoAHHw,15,18,11,12,5,10,8,0,64,9.142857142857142,1,0.0,2,11,12,5,16,10,0,8,0,30,34,1
7500,182656,3jm0outqyG6Dt6oUYnLDUhzCWjwa7f0d,SpATywNh6bZuzm8s1ceuBUnMUAeoAHHw,5,3,1,0,1,0,2,0,7,1.0,1,0.0,0,1,0,1,3,0,0,2,0,2,5,1
7501,182657,NgSAymzGStRSHltSswQtmpS99cSj4EzE,SpATywNh6bZuzm8s1ceuBUnMUAeoAHHw,14,23,8,20,5,2,4,0,62,8.857142857142858,1,0.0,12,8,17,5,11,2,3,4,0,42,20,1
7502,182659,42WJ8lF0jtc8jUDcyiUTsDeA2HGhhgcv,SpATywNh6bZuzm8s1ceuBUnMUAeoAHHw,5,2,1,0,1,0,3,0,7,1.0,1,0.0,0,1,0,1,2,0,0,3,0,2,5,1
7503,182676,Tqsu4RE8c8PTxIWjwbo0acp1R4rHJLQK,G8EPVSXsOYB5YQWZGiz1aVq5Pgr2GrQu,1,0,0,0,0,0,1,0,1,0.14285714285714285,1,0.0,0,0,0,0,0,0,0,1,0,0,1,1
7504,182681,wIYlooJ3PkONzNoU7I0nxWGWuqjalYcP,SpATywNh6bZuzm8s1ceuBUnMUAeoAHHw,7,5,0,0,0,0,2,0,7,1.0,1,0.0,0,0,0,0,5,0,0,2,0,0,7,1
7505,182683,PmtrviA6hBub1PH85YXqVyZgghNsuc4g,bWdj2GDclj5ofokWjzoa5jAwMkxCykd6,5,6,2,0,1,0,3,0,12,1.7142857142857142,1,0.0,0,2,0,1,6,0,0,3,0,3,9,0
7506,182684,u1buUEFv61yp0wROjZxTLttJ3M1La8iE,bWdj2GDclj5ofokWjzoa5jAwMkxCykd6,5,2,1,0,1,0,2,0,6,0.8571428571428571,1,0.0,0,1,0,1,2,0,0,2,0,2,4,1
7507,182691,PhL2ZyLw1V28vd4DfOVSi8FZIcPFQkVx,RXDvfPUBYFlVdlueBFbLW0mhhAyGEqpt,9,9,0,15,0,0,1,0,25,3.5714285714285716,1,0.0,1,0,14,0,8,0,1,1,0,15,10,1
7508,182692,Dtr7OzFhzoVvzJKeK0urGyJsIrB0TIJH,bWdj2GDclj5ofokWjzoa5jAwMkxCykd6,4,2,0,0,0,0,3,0,5,0.7142857142857143,1,0.0,0,0,0,0,2,0,0,3,0,0,5,1
7509,182700,bpGrzhHHu1EmIR8DPqrwGOVi55Jq7xh3,SpATywNh6bZuzm8s1ceuBUnMUAeoAHHw,1,0,0,0,0,0,1,0,1,0.14285714285714285,1,0.0,0,0,0,0,0,0,0,1,0,0,1,1
7510,182707,vCFSDawXLqrnXpNrVBnTFno2SpXSvGWp,SpATywNh6bZuzm8s1ceuBUnMUAeoAHHw,9,4,3,0,3,0,2,0,12,1.7142857142857142,1,0.0,0,3,0,3,4,0,0,2,0,6,6,1
7511,182709,RGPmxfpZ3Hotrw69jr331xicKNruhw9Y,SpATywNh6bZuzm8s1ceuBUnMUAeoAHHw,9,11,0,1,0,0,3,0,15,2.142857142857143,1,0.0,1,0,1,0,10,0,0,3,0,2,13,1
7512,182713,CZTcq7wzEt9ONvni7ZzjQbcLcDeC1DZ4,SpATywNh6bZuzm8s1ceuBUnMUAeoAHHw,1,0,0,0,0,0,1,0,1,0.14285714285714285,1,0.0,0,0,0,0,0,0,0,1,0,0,1,1
7513,182715,l70wRZ2DS0s6LjbT7C4gRoGrF27x9p2H,RXDvfPUBYFlVdlueBFbLW0mhhAyGEqpt,3,2,0,0,0,0,1,0,3,0.42857142857142855,1,0.0,0,0,0,0,2,0,0,1,0,0,3,1
7514,182719,E2SmOalca4Mn2HYnea1ltBRrUmhkEunr,RXDvfPUBYFlVdlueBFbLW0mhhAyGEqpt,2,0,0,0,0,0,2,0,2,0.2857142857142857,1,0.0,0,0,0,0,0,0,0,2,0,0,2,1
7515,182728,YyGH9YI1z47bsz19P5wTavf6fegO5GlF,SpATywNh6bZuzm8s1ceuBUnMUAeoAHHw,7,8,4,0,3,0,1,0,16,2.2857142857142856,1,0.0,3,4,0,3,5,0,0,1,0,10,6,1
7516,182729,AdlQluSNsa5qamKMPw9WD0mzbeMDsH2H,SpATywNh6bZuzm8s1ceuBUnMUAeoAHHw,4,4,0,0,0,0,4,0,8,1.1428571428571428,1,0.0,2,0,0,0,2,0,0,4,0,2,6,1
7517,182732,58s2cb7fdRQwJqQoDBtdpi70NOxjg3qZ,SpATywNh6bZuzm8s1ceuBUnMUAeoAHHw,4,2,1,0,1,0,1,0,5,0.7142857142857143,1,0.0,0,1,0,1,2,0,0,1,0,2,3,1
7518,182733,sTHTvkTsGG8vLnHKJRukF2jRzSiTp03D,SpATywNh6bZuzm8s1ceuBUnMUAeoAHHw,5,0,0,0,0,1,5,1,7,1.0,1,0.0,0,0,0,0,0,1,0,5,1,0,7,1
7519,182734,4CoRulGyQ4icBbm2v9jyxX1ENJFCtIe4,SpATywNh6bZuzm8s1ceuBUnMUAeoAHHw,15,20,11,27,7,15,5,0,85,12.142857142857142,1,0.0,8,11,21,7,12,15,6,5,0,47,38,1
7520,182737,m2BGUVswXHBZPtMgyVgsV42eoIMpIlIe,SpATywNh6bZuzm8s1ceuBUnMUAeoAHHw,4,0,0,0,0,0,4,0,4,0.5714285714285714,1,0.0,0,0,0,0,0,0,0,4,0,0,4,1
7521,182740,mSs5bB1Rxg3xYWjWjJY9pVTt7WAiMgyu,bWdj2GDclj5ofokWjzoa5jAwMkxCykd6,1,0,0,0,0,0,2,0,2,0.2857142857142857,1,0.0,0,0,0,0,0,0,0,2,0,0,2,1
7522,182741,TDJgAusC4tcAuKVU8oHZGKrqhY6Lp4X4,SpATywNh6bZuzm8s1ceuBUnMUAeoAHHw,9,10,1,25,0,0,1,0,37,5.285714285714286,1,0.0,4,1,20,0,6,0,5,1,0,25,12,1
7523,182747,y8tduZmgWrgzcw2L4zthOZlXWzNlHnmJ,SpATywNh6bZuzm8s1ceuBUnMUAeoAHHw,5,2,1,0,1,0,2,0,6,0.8571428571428571,1,0.0,0,1,0,1,2,0,0,2,0,2,4,1
7524,182748,qBpMFzKW2718794c3zfgwmEpIQp9kP8K,SpATywNh6bZuzm8s1ceuBUnMUAeoAHHw,1,0,0,0,0,0,1,0,1,0.14285714285714285,1,0.0,0,0,0,0,0,0,0,1,0,0,1,1
7525,182758,2HbabEHSEnqM0bBaiJs30PG9549v5yOk,bWdj2GDclj5ofokWjzoa5jAwMkxCykd6,6,7,4,0,2,10,5,0,28,4.0,1,0.0,0,4,0,2,7,10,0,5,0,6,22,1
7526,182767,sNbJ7pzaVnDxlASTW0niTKovpFXjQSy0,SpATywNh6bZuzm8s1ceuBUnMUAeoAHHw,5,5,3,0,1,3,2,0,14,2.0,1,0.0,0,3,0,1,5,3,0,2,0,4,10,1
7527,182770,VyinneBSnu52o8UNYSCuv49XXxRYrO53,bWdj2GDclj5ofokWjzoa5jAwMkxCykd6,1,0,0,0,0,0,2,0,2,0.2857142857142857,1,0.0,0,0,0,0,0,0,0,2,0,0,2,1
7528,182774,TzCu0qgQvcoK9kO9NBGEPpkuqzoJ6woq,RXDvfPUBYFlVdlueBFbLW0mhhAyGEqpt,20,15,11,28,4,8,4,0,70,10.0,2,0.0,2,11,26,4,13,8,2,4,0,43,27,1
7529,182780,yMIQHZsn323wNw1rKC7KVgV21MZHgiuz,bWdj2GDclj5ofokWjzoa5jAwMkxCykd6,2,0,0,0,0,0,2,0,2,0.2857142857142857,1,0.0,0,0,0,0,0,0,0,2,0,0,2,1
7530,182782,9tOn7goHN9N7J9eojiuTfPcShVM7kNFp,SpATywNh6bZuzm8s1ceuBUnMUAeoAHHw,5,9,1,0,1,0,1,0,12,1.7142857142857142,1,0.0,0,1,0,1,9,0,0,1,0,2,10,1
7531,182784,VWOXBW9EkYxZ0T2dOO4SxzMKxSN8bgNI,G8EPVSXsOYB5YQWZGiz1aVq5Pgr2GrQu,12,11,3,0,3,6,23,1,47,6.714285714285714,1,0.0,2,3,0,3,9,6,0,23,1,8,39,0
7532,182798,IkIRLi9Hmy3B5WcPYXBnOiu1cJErCZKt,RXDvfPUBYFlVdlueBFbLW0mhhAyGEqpt,8,7,0,13,2,0,5,0,27,3.857142857142857,1,0.0,6,0,10,2,1,0,3,5,0,18,9,1
7533,182808,kCXzR6ce1eaurKGud1Yjcq6ND5eQQb6c,G8EPVSXsOYB5YQWZGiz1aVq5Pgr2GrQu,19,25,13,60,5,3,10,2,118,16.857142857142858,1,0.0,8,13,53,5,17,3,7,10,2,79,39,1
7534,182810,kqM4LD5JOLaYmtsmvPLTUDaTCfv2YPdG,SpATywNh6bZuzm8s1ceuBUnMUAeoAHHw,1,0,0,0,0,0,1,0,1,0.14285714285714285,1,0.0,0,0,0,0,0,0,0,1,0,0,1,1
7535,182813,mSXZKJ9e3RCTXopgrFUphpxYgeKp7tlG,G8EPVSXsOYB5YQWZGiz1aVq5Pgr2GrQu,11,16,7,0,4,7,2,0,36,5.142857142857143,1,0.0,7,7,0,4,9,7,0,2,0,18,18,1
7536,182814,jhJWgDURvdBA1kmFGY4Ezste38F8s208,SpATywNh6bZuzm8s1ceuBUnMUAeoAHHw,6,2,0,0,0,4,6,1,13,1.8571428571428572,1,0.0,0,0,0,0,2,4,0,6,1,0,13,1
7537,182819,p7Mr6Ok0a4vcUFYBslKXHXBRGQMy3QGf,G8EPVSXsOYB5YQWZGiz1aVq5Pgr2GrQu,5,2,0,0,0,0,3,0,5,0.7142857142857143,1,0.0,0,0,0,0,2,0,0,3,0,0,5,1
7538,182820,o3hN6q5KODtoiHqaRQtCHeenQfWWwJmZ,bWdj2GDclj5ofokWjzoa5jAwMkxCykd6,8,3,1,0,1,3,6,1,15,2.142857142857143,1,0.0,1,1,0,1,2,3,0,6,1,3,12,1
7539,182823,YkXExE2iZQg9FZbuDDBEUmC7J16BAywt,SpATywNh6bZuzm8s1ceuBUnMUAeoAHHw,7,3,2,0,2,0,2,0,9,1.2857142857142858,1,0.0,0,2,0,2,3,0,0,2,0,4,5,1
7540,182824,HguVwcZaqEwGXJzY3HP39fA7Ctl2ESJX,SpATywNh6bZuzm8s1ceuBUnMUAeoAHHw,3,0,0,0,0,0,3,0,3,0.42857142857142855,1,0.0,0,0,0,0,0,0,0,3,0,0,3,1
7541,182825,akObaqJGuxjG1OPwZ5IUA6gd9nOx4oJA,SpATywNh6bZuzm8s1ceuBUnMUAeoAHHw,6,3,2,0,2,0,1,0,8,1.1428571428571428,1,0.0,0,2,0,2,3,0,0,1,0,4,4,1
7542,182834,9MvSiFhTOIXzdJdkvHVmHtDUCykt8hMb,RXDvfPUBYFlVdlueBFbLW0mhhAyGEqpt,1,0,0,0,0,0,1,0,1,0.14285714285714285,1,0.0,0,0,0,0,0,0,0,1,0,0,1,1
7543,182835,RkK6wAnzc2qyntdfmCfNZV178HOs8z1G,SpATywNh6bZuzm8s1ceuBUnMUAeoAHHw,7,3,2,0,2,0,2,0,9,1.2857142857142858,1,0.0,0,2,0,2,3,0,0,2,0,4,5,1
7544,182836,vIwO29pFDuU0ivIbuEkS0ajYobih9mJy,SpATywNh6bZuzm8s1ceuBUnMUAeoAHHw,1,0,0,0,0,0,1,0,1,0.14285714285714285,1,0.0,0,0,0,0,0,0,0,1,0,0,1,1
7545,182839,1i94xoT1OVM1lTP3R294JlD5odSrEcP5,G8EPVSXsOYB5YQWZGiz1aVq5Pgr2GrQu,4,8,0,0,1,0,1,0,10,1.4285714285714286,1,0.0,3,0,0,1,5,0,0,1,0,4,6,1
7546,182850,Klt9qoufCaIWdba44x7MkMWwmjaj9rrO,SpATywNh6bZuzm8s1ceuBUnMUAeoAHHw,7,3,2,0,2,0,2,0,9,1.2857142857142858,1,0.0,0,2,0,2,3,0,0,2,0,4,5,1
7547,182854,JO39AO6t7PlfqwBybyNaLNHxe7KK1KKl,SpATywNh6bZuzm8s1ceuBUnMUAeoAHHw,5,2,1,0,1,0,2,0,6,0.8571428571428571,1,0.0,0,1,0,1,2,0,0,2,0,2,4,1
7548,182855,NaGWxZf58IyW9QoVHeBvFF43QTruA6pk,G8EPVSXsOYB5YQWZGiz1aVq5Pgr2GrQu,5,3,1,0,1,0,1,0,6,0.8571428571428571,1,0.0,0,1,0,1,3,0,0,1,0,2,4,1
7549,182863,HXHzL7PqrUL6ax4VV0BL6WUNfIFy8UXd,bWdj2GDclj5ofokWjzoa5jAwMkxCykd6,5,2,1,0,1,0,2,0,6,0.8571428571428571,1,0.0,0,1,0,1,2,0,0,2,0,2,4,1
7550,182874,wfWgaSJojVTsOWnu0Zw38TJ4gTxVsstc,SpATywNh6bZuzm8s1ceuBUnMUAeoAHHw,10,8,5,0,3,0,2,0,18,2.5714285714285716,1,0.0,0,5,0,3,8,0,0,2,0,8,10,1
7551,182875,PdvjXH7022Nj56iHc15p9NRzsFaRES9J,SpATywNh6bZuzm8s1ceuBUnMUAeoAHHw,6,7,2,0,0,0,3,0,12,1.7142857142857142,1,0.0,0,2,0,0,7,0,0,3,0,2,10,1
7552,182886,zcNroqWUiRIsPxABKRrWkwPAId27OxZy,SpATywNh6bZuzm8s1ceuBUnMUAeoAHHw,1,0,0,0,0,0,1,0,1,0.14285714285714285,1,0.0,0,0,0,0,0,0,0,1,0,0,1,1
7553,182891,fdJXQSSucuzaRljy096jXgInnW2TakHQ,G8EPVSXsOYB5YQWZGiz1aVq5Pgr2GrQu,1,0,0,0,0,0,1,0,1,0.14285714285714285,1,0.0,0,0,0,0,0,0,0,1,0,0,1,1
7554,182894,Wm4d7ifDaTgcR0GfUqwJt5OZKbYglRCq,RXDvfPUBYFlVdlueBFbLW0mhhAyGEqpt,1,0,0,0,0,0,1,0,1,0.14285714285714285,1,0.0,0,0,0,0,0,0,0,1,0,0,1,1
7555,182899,LgLijvJ6nDDZDXZheZk4D1S1H0ok87z5,SpATywNh6bZuzm8s1ceuBUnMUAeoAHHw,10,7,5,0,4,0,3,0,19,2.7142857142857144,1,0.0,0,5,0,4,7,0,0,3,0,9,10,1
7556,182900,CqHYUR2wxaYgHzOmefYHdYFAqnjgWzGT,G8EPVSXsOYB5YQWZGiz1aVq5Pgr2GrQu,9,4,1,0,2,1,9,1,18,2.5714285714285716,1,0.0,2,1,0,2,2,1,0,9,1,5,13,1
7557,182906,DYhVLGAPWOAx4wB3gzSHS1w7MxX73feL,RXDvfPUBYFlVdlueBFbLW0mhhAyGEqpt,5,4,1,0,1,0,2,0,8,1.1428571428571428,1,0.0,0,1,0,1,4,0,0,2,0,2,6,1
7558,182912,effsEtqrwknjHEr0npnCFm7KOzCTSt0r,SpATywNh6bZuzm8s1ceuBUnMUAeoAHHw,7,2,1,0,1,0,4,1,9,1.2857142857142858,1,0.0,0,1,0,1,2,0,0,4,1,2,7,0
7559,182916,QBj5ZW5uQiE9SstQccaFKwhAjo1qH9Dk,RXDvfPUBYFlVdlueBFbLW0mhhAyGEqpt,1,0,0,0,0,0,1,0,1,0.14285714285714285,1,0.0,0,0,0,0,0,0,0,1,0,0,1,1
7560,182917,HidChEYUkwCd57tLyDRaYOVeEhFDQ3Gw,bWdj2GDclj5ofokWjzoa5jAwMkxCykd6,5,8,0,53,2,0,1,0,64,9.142857142857142,1,0.0,5,0,52,2,3,0,1,1,0,59,5,1
7561,182918,7kTFcvgxY9P1Hkw99pjiwbkFh98nJXIE,RXDvfPUBYFlVdlueBFbLW0mhhAyGEqpt,6,5,4,0,2,0,1,0,12,1.7142857142857142,1,0.0,0,4,0,2,5,0,0,1,0,6,6,1
7562,182920,Dtrw7jIOc6N9cJtQZ4pVW9s2qBJPFTTc,SpATywNh6bZuzm8s1ceuBUnMUAeoAHHw,7,2,1,0,1,1,4,1,10,1.4285714285714286,1,0.0,0,1,0,1,2,1,0,4,1,2,8,1
7563,182922,TulvnxhxqY9XFV1SbRR2w0EFWo4ahEEO,SpATywNh6bZuzm8s1ceuBUnMUAeoAHHw,10,27,8,0,0,1,21,3,60,8.571428571428571,2,0.0,19,8,0,0,8,1,0,21,3,27,33,1
7564,182924,eCJN0zxGlTEvXWXpm18IFLjiZf0BGvPo,SpATywNh6bZuzm8s1ceuBUnMUAeoAHHw,9,7,4,0,3,0,5,0,19,2.7142857142857144,2,0.0,1,4,0,3,6,0,0,5,0,8,11,1
7565,182925,VU8zmf7Owaz6sNWcWKLdrCl3ZTLYDEQY,SpATywNh6bZuzm8s1ceuBUnMUAeoAHHw,1,0,0,0,0,0,1,0,1,0.14285714285714285,1,0.0,0,0,0,0,0,0,0,1,0,0,1,1
7566,182931,jtsbnKKZ9XPpwCclPqSDCMPCyLbC3Ksj,SpATywNh6bZuzm8s1ceuBUnMUAeoAHHw,12,36,0,13,0,72,11,4,136,19.428571428571427,1,0.0,24,0,11,0,12,72,2,11,4,35,101,0
7567,182940,FIgFPRNDKi4WgyVVOEDupBUIDsQ9EQjV,bWdj2GDclj5ofokWjzoa5jAwMkxCykd6,6,3,2,0,2,0,1,0,8,1.1428571428571428,1,0.0,0,2,0,2,3,0,0,1,0,4,4,1
7568,182941,rwSODbQgRDu2S1bK7vXZWKLJHo1nYnGp,RXDvfPUBYFlVdlueBFbLW0mhhAyGEqpt,5,2,1,0,1,0,3,0,7,1.0,1,0.0,0,1,0,1,2,0,0,3,0,2,5,1
7569,182946,vxHy8fVeIc8PK6sLXnCDyEMZZSM3Rj0M,RXDvfPUBYFlVdlueBFbLW0mhhAyGEqpt,10,9,1,0,1,0,3,0,14,2.0,2,0.0,0,1,0,1,9,0,0,3,0,2,12,1
7570,182948,vag4ySgp6Xv9LLImwgHsnSu0uSrwUg8z,SpATywNh6bZuzm8s1ceuBUnMUAeoAHHw,7,5,1,0,1,0,4,0,11,1.5714285714285714,1,0.0,0,1,0,1,5,0,0,4,0,2,9,1
7571,182949,ffGclPAQxsNqhgZk4UCZvcIXCepIlinY,SpATywNh6bZuzm8s1ceuBUnMUAeoAHHw,4,2,0,0,0,0,4,0,6,0.8571428571428571,1,0.0,0,0,0,0,2,0,0,4,0,0,6,1
7572,182952,IBE9FtQ9x1E7k3ZNC16nikEg5d3E4b8O,bWdj2GDclj5ofokWjzoa5jAwMkxCykd6,14,25,0,51,2,10,11,4,103,14.714285714285714,1,0.0,17,0,48,2,8,10,3,11,4,67,36,1
7573,182954,c6Fui1ajX2dPIYhG2OvpvJJxojMFsXjs,SpATywNh6bZuzm8s1ceuBUnMUAeoAHHw,3,2,0,0,0,0,2,0,4,0.5714285714285714,1,0.0,0,0,0,0,2,0,0,2,0,0,4,1
7574,182968,XARPe6DPXR8KDgKnXuqN5NP0VHFMzwUO,SpATywNh6bZuzm8s1ceuBUnMUAeoAHHw,6,1,1,0,1,0,3,0,6,0.8571428571428571,1,0.0,0,1,0,1,1,0,0,3,0,2,4,1
7575,182984,2hadEUwp57oaCSemFWbiVdojDARXylA4,SpATywNh6bZuzm8s1ceuBUnMUAeoAHHw,16,25,6,6,4,6,5,2,54,7.714285714285714,1,0.0,18,6,6,4,7,6,0,5,2,34,20,1
7576,182985,EHr9i7DrAmLY9IIcFmxYuvipqCAk2sM7,SpATywNh6bZuzm8s1ceuBUnMUAeoAHHw,1,0,0,0,0,0,1,0,1,0.14285714285714285,1,0.0,0,0,0,0,0,0,0,1,0,0,1,1
7577,182987,CflmnNLx1El6KrTaSWqI7nU1TsN8LeKr,G8EPVSXsOYB5YQWZGiz1aVq5Pgr2GrQu,5,2,1,0,1,0,2,0,6,0.8571428571428571,1,0.0,0,1,0,1,2,0,0,2,0,2,4,1
7578,182993,ZxyDDY406MYSLk3FLUMvDHc7n6my0jWC,bWdj2GDclj5ofokWjzoa5jAwMkxCykd6,10,4,2,0,1,21,14,4,46,6.571428571428571,1,0.0,0,2,0,1,4,21,0,14,4,3,43,1
7579,183001,bG2jmidl1bDsU5kwFldO2hSfMzLKGTZ3,SpATywNh6bZuzm8s1ceuBUnMUAeoAHHw,1,0,0,0,0,0,1,0,1,0.14285714285714285,1,0.0,0,0,0,0,0,0,0,1,0,0,1,1
7580,183002,qeZsVtb8AWeyVhfs2hYQ0ujp2PobwrVT,RXDvfPUBYFlVdlueBFbLW0mhhAyGEqpt,6,3,0,0,0,0,4,0,7,1.0,1,0.0,0,0,0,0,3,0,0,4,0,0,7,1
7581,183004,hzI7F4aEa5EKvJiM87cs2lRhWvluO07x,SpATywNh6bZuzm8s1ceuBUnMUAeoAHHw,18,28,13,9,4,2,18,4,78,11.142857142857142,2,0.0,8,13,8,4,20,2,1,18,4,33,45,0
7582,183007,bXjfWJe04qOx78zkMNdSaPRQzOnTNGYL,SpATywNh6bZuzm8s1ceuBUnMUAeoAHHw,4,3,1,0,1,0,1,0,6,0.8571428571428571,1,0.0,0,1,0,1,3,0,0,1,0,2,4,1
7583,183009,hPhWVQjBXU898finCJGmzk0KCmEwCOvP,SpATywNh6bZuzm8s1ceuBUnMUAeoAHHw,1,0,0,0,0,0,1,0,1,0.14285714285714285,1,0.0,0,0,0,0,0,0,0,1,0,0,1,1
7584,183010,5PoE3YvA0iZFEwystRRucVmekQOUvlOx,RXDvfPUBYFlVdlueBFbLW0mhhAyGEqpt,1,0,0,0,0,0,2,0,2,0.2857142857142857,1,0.0,0,0,0,0,0,0,0,2,0,0,2,1
7585,183016,GQxqlKBuTHN1s8soumNB9QXxdu6crGoG,bWdj2GDclj5ofokWjzoa5jAwMkxCykd6,3,1,0,0,0,0,3,0,4,0.5714285714285714,1,0.0,0,0,0,0,1,0,0,3,0,0,4,1
7586,183024,Yb5pEK7VjcxeVZ9fUeqOSZHX1vLfJthY,SpATywNh6bZuzm8s1ceuBUnMUAeoAHHw,9,4,2,0,1,1,9,1,18,2.5714285714285716,1,0.0,0,2,0,1,4,1,0,9,1,3,15,1
7587,183026,rVKS9MvAzj9bHO6qj6FhT80Vyfah5rgx,RXDvfPUBYFlVdlueBFbLW0mhhAyGEqpt,2,0,0,0,0,0,3,0,3,0.42857142857142855,1,0.0,0,0,0,0,0,0,0,3,0,0,3,1
7588,183033,5RiaRbVAffy243QN8cvvydK7FTo8Ge7y,SpATywNh6bZuzm8s1ceuBUnMUAeoAHHw,6,3,2,0,2,0,1,0,8,1.1428571428571428,1,0.0,0,2,0,2,3,0,0,1,0,4,4,1
7589,183038,AvefIGzCaOx0Wgqe3dv7u8LN0NNvyUzu,RXDvfPUBYFlVdlueBFbLW0mhhAyGEqpt,2,0,0,0,0,0,2,0,2,0.2857142857142857,1,0.0,0,0,0,0,0,0,0,2,0,0,2,1
7590,183040,PybrMIHJW5iPpVWCSYrCV4jYePWbXmcH,SpATywNh6bZuzm8s1ceuBUnMUAeoAHHw,4,2,0,0,0,1,4,1,8,1.1428571428571428,1,0.0,0,0,0,0,2,1,0,4,1,0,8,1
7591,183041,b07lyeDRIGTDb23WDQrqmxKnx7uJ6kqa,RXDvfPUBYFlVdlueBFbLW0mhhAyGEqpt,6,2,0,0,0,0,5,2,9,1.2857142857142858,1,0.0,0,0,0,0,2,0,0,5,2,0,9,1
7592,183042,43XnUoAZbDkvxCOgOY8IuFHvhpNa62ol,SpATywNh6bZuzm8s1ceuBUnMUAeoAHHw,1,0,0,0,0,0,1,0,1,0.14285714285714285,1,0.0,0,0,0,0,0,0,0,1,0,0,1,1
7593,183048,oeQ1nHqbsofIU4Gddro5UkGg44HCxqO8,SpATywNh6bZuzm8s1ceuBUnMUAeoAHHw,8,9,3,0,2,0,2,0,16,2.2857142857142856,1,0.0,1,3,0,2,8,0,0,2,0,6,10,1
7594,183050,aBjPpLZjZVQXphzIZ2ZdW0Gy5cspTPuz,SpATywNh6bZuzm8s1ceuBUnMUAeoAHHw,8,3,1,0,1,0,4,2,11,1.5714285714285714,1,0.0,0,1,0,1,3,0,0,4,2,2,9,1
7595,183056,h6N9SyV6dQj6If7QxGp31IQ94XXyWUIO,bWdj2GDclj5ofokWjzoa5jAwMkxCykd6,4,2,1,0,1,0,2,0,6,0.8571428571428571,1,0.0,0,1,0,1,2,0,0,2,0,2,4,0
7596,183059,6xyaVeSZsCu6Nqe5h1ruYj89xweZsGkX,SpATywNh6bZuzm8s1ceuBUnMUAeoAHHw,8,2,1,0,1,0,10,1,15,2.142857142857143,1,0.0,0,1,0,1,2,0,0,10,1,2,13,1
7597,183066,Oq9Z1hsv3NeEDP3Q4F964BpI3HU1uf4u,RXDvfPUBYFlVdlueBFbLW0mhhAyGEqpt,41,87,26,104,14,19,3,0,253,36.142857142857146,1,0.0,28,26,97,14,59,19,7,3,0,165,88,1
7598,183075,8SwolTrUbLeQIryGNwnSraj6AIJcPhi1,RXDvfPUBYFlVdlueBFbLW0mhhAyGEqpt,8,3,2,0,0,1,6,2,14,2.0,1,0.0,0,2,0,0,3,1,0,6,2,2,12,1
7599,183076,kE46GjSqE5uiUhF9LbgXs97FJQSvErKB,SpATywNh6bZuzm8s1ceuBUnMUAeoAHHw,18,14,9,8,5,2,9,1,48,6.857142857142857,3,0.0,2,9,8,5,12,2,0,9,1,24,24,0
7600,183079,UZQMHBD59LcFUBlLzTajpfngFoDhvuqd,bWdj2GDclj5ofokWjzoa5jAwMkxCykd6,2,0,0,0,0,0,2,0,2,0.2857142857142857,1,0.0,0,0,0,0,0,0,0,2,0,0,2,0
7601,183082,IKXwL3bDtlAxjRP4WWhZczJlcbIhG3ib,bWdj2GDclj5ofokWjzoa5jAwMkxCykd6,5,2,1,0,1,0,3,0,7,1.0,1,0.0,0,1,0,1,2,0,0,3,0,2,5,1
7602,183083,EbfkLutG3Wlnfk5dlvXr0Vcdn1M25FU9,bWdj2GDclj5ofokWjzoa5jAwMkxCykd6,13,21,11,0,7,15,10,1,65,9.285714285714286,2,0.0,4,11,0,7,17,15,0,10,1,22,43,1
7603,183092,xrcBYo5W41za7iW83F0KEtd3oYoFiOrz,SpATywNh6bZuzm8s1ceuBUnMUAeoAHHw,6,3,2,0,2,0,2,0,9,1.2857142857142858,1,0.0,0,2,0,2,3,0,0,2,0,4,5,1
7604,183094,LielUY2CViAshyTPFVeBFjcM9c8YHKw6,SpATywNh6bZuzm8s1ceuBUnMUAeoAHHw,4,2,0,0,0,0,2,0,4,0.5714285714285714,1,0.0,0,0,0,0,2,0,0,2,0,0,4,1
7605,183098,iYmkUVGHT7OvfSsIIRGv9c31sCISp6uV,bWdj2GDclj5ofokWjzoa5jAwMkxCykd6,3,2,0,0,0,0,2,0,4,0.5714285714285714,2,0.0,0,0,0,0,2,0,0,2,0,0,4,1
7606,183100,zgTz7w4MQKVAfOVf6tj5uMnkGGy77PYu,SpATywNh6bZuzm8s1ceuBUnMUAeoAHHw,8,3,1,0,1,1,4,1,11,1.5714285714285714,1,0.0,0,1,0,1,3,1,0,4,1,2,9,1
7607,183105,HTGHrKrt9bt2no7NEjeTqA36pNapNLke,bWdj2GDclj5ofokWjzoa5jAwMkxCykd6,1,0,0,0,0,0,1,0,1,0.14285714285714285,1,0.0,0,0,0,0,0,0,0,1,0,0,1,1
7608,183106,5UgB7WrC5inA92uoZPywCX6RsZIYfbPF,SpATywNh6bZuzm8s1ceuBUnMUAeoAHHw,7,5,2,0,2,6,4,0,19,2.7142857142857144,1,0.0,0,2,0,2,5,6,0,4,0,4,15,1
7609,183110,53fG4qjpoEeWdWNP9xPO2S2BFstrPjGH,RXDvfPUBYFlVdlueBFbLW0mhhAyGEqpt,9,5,0,0,0,1,10,11,27,3.857142857142857,2,0.0,0,0,0,0,5,1,0,10,11,0,27,1
7610,183113,PHVZqegG7Zevy6zLiqsCasCOZvoRRNNg,SpATywNh6bZuzm8s1ceuBUnMUAeoAHHw,7,5,4,0,3,0,2,0,14,2.0,1,0.0,0,4,0,3,5,0,0,2,0,7,7,1
7611,183114,g1dFQ3mnVnBiIhnsU4zqK21biH9l5lF9,bWdj2GDclj5ofokWjzoa5jAwMkxCykd6,8,5,1,0,1,0,4,1,12,1.7142857142857142,1,0.0,0,1,0,1,5,0,0,4,1,2,10,1
7612,183117,WDD9a1qNUJX21r5OnYzYbe9snqA1PiYA,G8EPVSXsOYB5YQWZGiz1aVq5Pgr2GrQu,10,7,4,0,3,0,3,0,17,2.4285714285714284,1,0.0,1,4,0,3,6,0,0,3,0,8,9,1
7613,183118,Xebl2a1reCTgb3CZmsapTzbcj94w3H8B,SpATywNh6bZuzm8s1ceuBUnMUAeoAHHw,1,0,0,0,0,0,2,0,2,0.2857142857142857,1,0.0,0,0,0,0,0,0,0,2,0,0,2,1
7614,183125,juPgseiv6fz8BUaq09A165VVR6UHjpbU,SpATywNh6bZuzm8s1ceuBUnMUAeoAHHw,5,2,1,0,1,1,2,1,8,1.1428571428571428,1,0.0,0,1,0,1,2,1,0,2,1,2,6,1
7615,183127,Hm8PhmgumYGSpnWdU16xXCEPyBtXct0m,G8EPVSXsOYB5YQWZGiz1aVq5Pgr2GrQu,6,3,0,0,0,0,3,0,6,0.8571428571428571,1,0.0,0,0,0,0,3,0,0,3,0,0,6,1
7616,183128,JChnJwlkYSD6G5rkj5DhsEWsQiOBTkEx,G8EPVSXsOYB5YQWZGiz1aVq5Pgr2GrQu,8,2,1,0,1,1,6,1,12,1.7142857142857142,1,0.0,0,1,0,1,2,1,0,6,1,2,10,1
7617,183135,TVBdP57RgHmXdzDOQxhhxrruZniECnNa,G8EPVSXsOYB5YQWZGiz1aVq5Pgr2GrQu,10,5,3,0,2,3,11,1,25,3.5714285714285716,2,0.0,0,3,0,2,5,3,0,11,1,5,20,0
7618,183136,Wh6uG1HOxpwP3HtqSjbX0A0Sk2Rn3Ci7,SpATywNh6bZuzm8s1ceuBUnMUAeoAHHw,3,0,0,0,0,0,3,0,3,0.42857142857142855,1,0.0,0,0,0,0,0,0,0,3,0,0,3,1
7619,183137,HIa1PFcWZWr32eqQoCfZvVHM2iyl701E,G8EPVSXsOYB5YQWZGiz1aVq5Pgr2GrQu,8,13,4,0,2,1,3,0,23,3.2857142857142856,1,0.0,3,4,0,2,10,1,0,3,0,9,14,1
7620,183142,DZfIhfsDxjKeEsV2YKbtNB2Ii6s7pc9Z,G8EPVSXsOYB5YQWZGiz1aVq5Pgr2GrQu,5,2,1,0,1,0,2,0,6,0.8571428571428571,1,0.0,0,1,0,1,2,0,0,2,0,2,4,1
7621,183145,Jur8wTdD1tDMuHkI3CFyF52Um8NeR9PV,G8EPVSXsOYB5YQWZGiz1aVq5Pgr2GrQu,37,31,8,71,7,0,1,0,118,16.857142857142858,1,0.0,20,8,48,7,11,0,23,1,0,83,35,1
7622,183155,ZjtLHxVaFYGXpjpGEU4pMEKPyHOa2BQR,SpATywNh6bZuzm8s1ceuBUnMUAeoAHHw,4,3,1,0,1,0,1,0,6,0.8571428571428571,1,0.0,0,1,0,1,3,0,0,1,0,2,4,1
7623,183157,uxG0FJsqPkZSNzWDeidAA0UNFfE5AajW,SpATywNh6bZuzm8s1ceuBUnMUAeoAHHw,17,26,11,22,7,17,9,2,94,13.428571428571429,1,0.0,11,11,19,7,15,17,3,9,2,48,46,1
7624,183159,hiXDc0k3aCbg2PlfMmAMtnsGGLI4iZVQ,SpATywNh6bZuzm8s1ceuBUnMUAeoAHHw,1,0,0,0,0,0,1,0,1,0.14285714285714285,1,0.0,0,0,0,0,0,0,0,1,0,0,1,1
7625,183161,giWgdBNdbd331HsBTghzm2Zz7pyTR32i,bWdj2GDclj5ofokWjzoa5jAwMkxCykd6,7,4,1,0,1,10,8,2,26,3.7142857142857144,1,0.0,2,1,0,1,2,10,0,8,2,4,22,1
7626,183162,OKPZyRTenUKO4uf828hjTvwVhuS9Ozxv,SpATywNh6bZuzm8s1ceuBUnMUAeoAHHw,4,2,1,0,1,0,1,0,5,0.7142857142857143,1,0.0,0,1,0,1,2,0,0,1,0,2,3,1
7627,183164,7RSTSE7CX0EZRW2RDRnKS7CJkHtK7gJx,RXDvfPUBYFlVdlueBFbLW0mhhAyGEqpt,6,5,3,0,0,4,2,0,14,2.0,1,0.0,0,3,0,0,5,4,0,2,0,3,11,1
7628,183165,ZsigjPuCWauQ6fedPh3KulNWQfy4Omyd,bWdj2GDclj5ofokWjzoa5jAwMkxCykd6,16,22,9,34,2,5,10,1,83,11.857142857142858,1,0.0,7,9,30,2,15,5,4,10,1,48,35,1
7629,183168,HwQlDqQYrfHrBUx2SSkCNQ3Dej1xgfkf,bWdj2GDclj5ofokWjzoa5jAwMkxCykd6,6,6,0,0,0,4,3,0,13,1.8571428571428572,1,0.0,0,0,0,0,6,4,0,3,0,0,13,1
7630,183172,8UbjMY8dXKhktWVxiVJfz8pElgxOXJnG,G8EPVSXsOYB5YQWZGiz1aVq5Pgr2GrQu,12,20,10,18,6,0,1,0,55,7.857142857142857,1,0.0,8,10,16,6,12,0,2,1,0,40,15,1
7631,183180,hc7DHMNIyA27xd52J4BHXtmpErxPTaQY,SpATywNh6bZuzm8s1ceuBUnMUAeoAHHw,4,2,1,0,1,0,2,0,6,0.8571428571428571,1,0.0,0,1,0,1,2,0,0,2,0,2,4,1
7632,183184,QBUSyyOSif4bY2k2ASnON62QDLzUWAXK,SpATywNh6bZuzm8s1ceuBUnMUAeoAHHw,6,2,1,0,1,1,3,1,9,1.2857142857142858,1,0.0,0,1,0,1,2,1,0,3,1,2,7,1
7633,183188,CUbueK74RGsaWBcRtztdoMN84Z7TxEjm,SpATywNh6bZuzm8s1ceuBUnMUAeoAHHw,1,0,0,0,0,0,1,0,1,0.14285714285714285,1,0.0,0,0,0,0,0,0,0,1,0,0,1,1
7634,183194,Ck862YJ4TKsW5xBb6Obw9gcSWBzSDmoA,bWdj2GDclj5ofokWjzoa5jAwMkxCykd6,2,0,0,0,0,0,2,0,2,0.2857142857142857,1,0.0,0,0,0,0,0,0,0,2,0,0,2,1
7635,183196,MHxssLIOse4kgwRMC6Bd41Ph9QZkPYqP,SpATywNh6bZuzm8s1ceuBUnMUAeoAHHw,12,7,5,0,3,1,3,1,20,2.857142857142857,1,0.0,0,5,0,3,7,1,0,3,1,8,12,1
7636,183198,Bb87wS5DPfEgqeumUQCP2v4mASdjKigL,RXDvfPUBYFlVdlueBFbLW0mhhAyGEqpt,7,2,1,0,1,7,5,2,18,2.5714285714285716,1,0.0,0,1,0,1,2,7,0,5,2,2,16,1
7637,183200,JxLtKAnMek98G5fWpyeTaKlh0zheuNnU,SpATywNh6bZuzm8s1ceuBUnMUAeoAHHw,8,4,2,0,2,0,4,0,12,1.7142857142857142,1,0.0,0,2,0,2,4,0,0,4,0,4,8,0
7638,183209,OO1JwGoh4BUjbVi8UpZSb7D59mBcs3nt,RXDvfPUBYFlVdlueBFbLW0mhhAyGEqpt,7,5,3,0,1,0,2,0,11,1.5714285714285714,1,0.0,0,3,0,1,5,0,0,2,0,4,7,1
7639,183211,oqLAJu8zdqUr5XPQYn4bKVmvqSIRanjc,bWdj2GDclj5ofokWjzoa5jAwMkxCykd6,9,9,1,0,2,8,6,1,27,3.857142857142857,1,0.0,2,1,0,2,7,8,0,6,1,5,22,1
7640,183214,4zGb8KPKuLvneJBtnBUfe0LzhdWsYBWD,G8EPVSXsOYB5YQWZGiz1aVq5Pgr2GrQu,12,4,3,0,3,3,6,1,20,2.857142857142857,1,0.0,0,3,0,3,4,3,0,6,1,6,14,1
7641,183215,AIHzQdi1VPMOsdN6EyZk6CRIyb9n7SRR,SpATywNh6bZuzm8s1ceuBUnMUAeoAHHw,3,1,0,0,0,0,2,0,3,0.42857142857142855,1,0.0,0,0,0,0,1,0,0,2,0,0,3,1
7642,183220,e3UIGG7UQFKXGRFOxu4N5schAIY0VK0V,SpATywNh6bZuzm8s1ceuBUnMUAeoAHHw,9,9,6,0,3,0,1,0,19,2.7142857142857144,1,0.0,2,6,0,3,7,0,0,1,0,11,8,1
7643,183224,tgGXquDTTGvx5MwsNQ6vkm5pQoRrWFlX,SpATywNh6bZuzm8s1ceuBUnMUAeoAHHw,4,2,0,0,0,0,2,0,4,0.5714285714285714,1,0.0,0,0,0,0,2,0,0,2,0,0,4,1
7644,183231,FBOPqv9eeto5z974B2QRTSbPP2n29lzH,SpATywNh6bZuzm8s1ceuBUnMUAeoAHHw,14,10,1,9,1,5,10,1,37,5.285714285714286,1,0.0,1,1,8,1,9,5,1,10,1,11,26,0
7645,183234,u2dRmVeIaLoDMHF5VEceAEEDchUnRMzS,SpATywNh6bZuzm8s1ceuBUnMUAeoAHHw,2,0,0,0,0,0,2,0,2,0.2857142857142857,1,0.0,0,0,0,0,0,0,0,2,0,0,2,1
7646,183240,5tBgJZtV2IcrOsT8dEGT5vR2wgUVL0Ki,RXDvfPUBYFlVdlueBFbLW0mhhAyGEqpt,7,9,0,0,1,0,1,0,11,1.5714285714285714,1,0.0,0,0,0,1,9,0,0,1,0,1,10,1
7647,183242,bOMNnv3BcmeLvNMeUxuJFunXB0SEjjhL,G8EPVSXsOYB5YQWZGiz1aVq5Pgr2GrQu,6,5,0,0,0,0,1,0,6,0.8571428571428571,1,0.0,0,0,0,0,5,0,0,1,0,0,6,1
7648,183243,FGCLu23qz5rUrelYuCtqPnMTqZtXAAMw,SpATywNh6bZuzm8s1ceuBUnMUAeoAHHw,3,2,0,0,0,0,1,0,3,0.42857142857142855,1,0.0,0,0,0,0,2,0,0,1,0,0,3,1
7649,183246,0XGLQ2e4IRT7VYRVdCJkoQRc2HBjT9PI,SpATywNh6bZuzm8s1ceuBUnMUAeoAHHw,6,3,2,0,2,1,5,4,17,2.4285714285714284,1,0.0,0,2,0,2,3,1,0,5,4,4,13,1
7650,183255,o0L0ZsTU5fXkPgqce1TgnefJury1RfBP,SpATywNh6bZuzm8s1ceuBUnMUAeoAHHw,1,0,0,0,0,0,1,0,1,0.14285714285714285,1,0.0,0,0,0,0,0,0,0,1,0,0,1,1
7651,183256,Hqq2J56mzskAJKg1DKQGyeniCWvGpIGe,G8EPVSXsOYB5YQWZGiz1aVq5Pgr2GrQu,8,5,0,0,0,0,14,1,20,2.857142857142857,1,0.0,0,0,0,0,5,0,0,14,1,0,20,1
7652,183259,oAeA1FcKJgCgppNdDO8cyAq9ijjrn0WR,SpATywNh6bZuzm8s1ceuBUnMUAeoAHHw,1,0,0,0,0,0,1,0,1,0.14285714285714285,1,0.0,0,0,0,0,0,0,0,1,0,0,1,1
7653,183263,sRTon1VBBuP0uvdQE1lWLIce29YVBv8J,G8EPVSXsOYB5YQWZGiz1aVq5Pgr2GrQu,7,8,4,0,0,1,6,0,19,2.7142857142857144,1,0.0,0,4,0,0,8,1,0,6,0,4,15,1
7654,183270,7nQB7cjVdr2HijR82OoX1oMRPa42JjfY,SpATywNh6bZuzm8s1ceuBUnMUAeoAHHw,15,20,7,16,5,4,8,2,62,8.857142857142858,1,0.0,12,7,14,5,8,4,2,8,2,38,24,1
7655,183275,xQCtMoNknB0tylWKH0fJbJooatlzGcif,bWdj2GDclj5ofokWjzoa5jAwMkxCykd6,2,0,0,0,0,0,2,0,2,0.2857142857142857,1,0.0,0,0,0,0,0,0,0,2,0,0,2,1
7656,183278,GPLdxh0c6YlbU65pqQa5Y6COOTFoYUCD,bWdj2GDclj5ofokWjzoa5jAwMkxCykd6,1,0,0,0,0,0,1,0,1,0.14285714285714285,1,0.0,0,0,0,0,0,0,0,1,0,0,1,1
7657,183281,QCcqcVaEKUPWiTK3zDmg4MUzFmU49Qen,G8EPVSXsOYB5YQWZGiz1aVq5Pgr2GrQu,8,8,0,4,0,2,4,0,18,2.5714285714285716,1,0.0,5,0,2,0,3,2,2,4,0,7,11,1
7658,183282,eOxm8XEI11Xs6eiBi1Nu5QzIagZXwEm9,bWdj2GDclj5ofokWjzoa5jAwMkxCykd6,8,9,3,0,3,3,4,0,22,3.142857142857143,1,0.0,4,3,0,3,5,3,0,4,0,10,12,1
7659,183283,3uajdhCj0s2q50MqyB5gJCI3ZNoF8Pn6,SpATywNh6bZuzm8s1ceuBUnMUAeoAHHw,11,18,1,16,0,6,4,0,45,6.428571428571429,2,0.0,7,1,13,0,11,6,3,4,0,21,24,0
7660,183287,myIIBocNFelldmuN47bMrRiORGKDSj7S,bWdj2GDclj5ofokWjzoa5jAwMkxCykd6,5,2,1,0,1,0,2,0,6,0.8571428571428571,1,0.0,0,1,0,1,2,0,0,2,0,2,4,1
7661,183295,pjhJt7Jli5gOZV2lL76izW3SObuDigHu,SpATywNh6bZuzm8s1ceuBUnMUAeoAHHw,6,6,1,0,1,0,1,0,9,1.2857142857142858,1,0.0,0,1,0,1,6,0,0,1,0,2,7,1
7662,183298,JazzJWzkixijQw0lzFOQdWkrQaVq1jug,SpATywNh6bZuzm8s1ceuBUnMUAeoAHHw,1,0,0,0,0,0,1,0,1,0.14285714285714285,1,0.0,0,0,0,0,0,0,0,1,0,0,1,1
7663,183302,UVJV0Z8LgePBFvFPqKCGcnBV2sDOhrhM,SpATywNh6bZuzm8s1ceuBUnMUAeoAHHw,9,9,5,0,2,3,15,2,36,5.142857142857143,1,0.0,0,5,0,2,9,3,0,15,2,7,29,1
7664,183304,xyEiirOhDK1UDi4PZ4UKu6B69xftDWtO,G8EPVSXsOYB5YQWZGiz1aVq5Pgr2GrQu,3,1,0,0,0,0,2,0,3,0.42857142857142855,1,0.0,0,0,0,0,1,0,0,2,0,0,3,1
7665,183314,8lLmfOvYbkWA0I629B3U62LfaD1fwQEn,RXDvfPUBYFlVdlueBFbLW0mhhAyGEqpt,4,3,0,0,0,0,1,0,4,0.5714285714285714,1,0.0,0,0,0,0,3,0,0,1,0,0,4,1
7666,183318,5ZZ7ac02MMtLItQmBAzvselJyRLR3oem,RXDvfPUBYFlVdlueBFbLW0mhhAyGEqpt,13,8,6,14,4,0,1,0,33,4.714285714285714,1,0.0,1,6,13,4,7,0,1,1,0,24,9,1
7667,183322,aoDqbYwTSNONO0ewp0wUEkLRTmINlnHL,bWdj2GDclj5ofokWjzoa5jAwMkxCykd6,4,2,1,0,1,0,2,0,6,0.8571428571428571,1,0.0,0,1,0,1,2,0,0,2,0,2,4,0
7668,183335,DfGFChbBes1JC5MAOGd9A1oO26eP1NW8,SpATywNh6bZuzm8s1ceuBUnMUAeoAHHw,5,2,1,0,1,0,2,0,6,0.8571428571428571,1,0.0,0,1,0,1,2,0,0,2,0,2,4,1
7669,183336,tMAhwsb1zwYUL3evTh1bPfibKP5Qon6G,SpATywNh6bZuzm8s1ceuBUnMUAeoAHHw,14,26,12,23,0,16,12,3,92,13.142857142857142,1,0.0,11,12,19,0,15,16,4,12,3,42,50,1
7670,183338,AwyuEC08S0bk8UcEbhYUOEEzGzNqDKU8,SpATywNh6bZuzm8s1ceuBUnMUAeoAHHw,15,13,7,10,4,0,5,0,39,5.571428571428571,1,0.0,2,7,10,4,11,0,0,5,0,23,16,1
7671,183339,6mOQPHYetbEhBA0tIxsajGc8MOtDRaKo,SpATywNh6bZuzm8s1ceuBUnMUAeoAHHw,14,9,4,12,3,2,4,0,34,4.857142857142857,1,0.0,4,4,9,3,5,2,3,4,0,20,14,1
7672,183341,idNHVa5qTuX7uet3LgzHDgeF9ZtnSDQ3,bWdj2GDclj5ofokWjzoa5jAwMkxCykd6,5,4,2,0,2,0,4,0,12,1.7142857142857142,2,0.0,1,2,0,2,3,0,0,4,0,5,7,1
7673,183349,jM6CIVoPwE4qSBrp1fYyKBxxPBT1cEI7,SpATywNh6bZuzm8s1ceuBUnMUAeoAHHw,13,18,0,13,0,22,5,1,59,8.428571428571429,1,0.0,9,0,11,0,9,22,2,5,1,20,39,1
7674,183352,F60PWu4BLsLJcl06zQNatmmupVqE7UvO,SpATywNh6bZuzm8s1ceuBUnMUAeoAHHw,8,2,1,0,1,41,6,1,52,7.428571428571429,1,0.0,0,1,0,1,2,41,0,6,1,2,50,1
7675,183355,E2ARe3Bjs7AnrUVutsjVawfNV9IbxIpY,SpATywNh6bZuzm8s1ceuBUnMUAeoAHHw,10,2,2,0,2,1,6,1,14,2.0,1,0.0,0,2,0,2,2,1,0,6,1,4,10,1
7676,183356,dgFOOUSNfQK8xIrT47Av0Q04bBFeE21W,bWdj2GDclj5ofokWjzoa5jAwMkxCykd6,5,2,1,0,1,0,3,0,7,1.0,1,0.0,0,1,0,1,2,0,0,3,0,2,5,0
7677,183359,ks16hCmKEY3uCrrfZAVFFF4H8o1iqNYf,SpATywNh6bZuzm8s1ceuBUnMUAeoAHHw,2,0,0,0,0,0,2,0,2,0.2857142857142857,1,0.0,0,0,0,0,0,0,0,2,0,0,2,1
7678,183360,9s0JhEhDR0DB5lchGcAvAZmTtIRHEPQm,G8EPVSXsOYB5YQWZGiz1aVq5Pgr2GrQu,4,3,0,0,0,0,2,0,5,0.7142857142857143,1,0.0,0,0,0,0,3,0,0,2,0,0,5,1
7679,183364,wVXoala8XOb2iYKmDwv4j0mTTabnjV0o,SpATywNh6bZuzm8s1ceuBUnMUAeoAHHw,3,3,0,0,0,1,2,0,6,0.8571428571428571,1,0.0,0,0,0,0,3,1,0,2,0,0,6,1
7680,183366,lRau52E8JZjvrp0KLukaOoqpUzIxzIMQ,bWdj2GDclj5ofokWjzoa5jAwMkxCykd6,1,0,0,0,0,0,1,0,1,0.14285714285714285,1,0.0,0,0,0,0,0,0,0,1,0,0,1,1
7681,183371,kqNwxNjHDwzzgcfuymv6Zjh6rnLpzjX1,G8EPVSXsOYB5YQWZGiz1aVq5Pgr2GrQu,4,2,1,0,1,0,1,0,5,0.7142857142857143,1,0.0,0,1,0,1,2,0,0,1,0,2,3,0
7682,183373,BhK0qN7yCyRENwc0cuo4sVnEheX7uuVm,RXDvfPUBYFlVdlueBFbLW0mhhAyGEqpt,4,2,1,0,1,0,1,0,5,0.7142857142857143,1,0.0,0,1,0,1,2,0,0,1,0,2,3,1
7683,183375,t5Hw0caPG6L3nFHgMe2ewZ65zHyUbUJs,G8EPVSXsOYB5YQWZGiz1aVq5Pgr2GrQu,2,0,0,0,0,0,2,0,2,0.2857142857142857,1,0.0,0,0,0,0,0,0,0,2,0,0,2,1
7684,183376,bBc0KX5JgaSX0V8JzMsfaXljJJH0L4ZY,bWdj2GDclj5ofokWjzoa5jAwMkxCykd6,1,0,0,0,0,0,1,0,1,0.14285714285714285,1,0.0,0,0,0,0,0,0,0,1,0,0,1,0
7685,183377,IEfUasRNK7F4OXmh9ZRgY5RLlk7j6VcY,SpATywNh6bZuzm8s1ceuBUnMUAeoAHHw,5,6,2,0,1,0,1,0,10,1.4285714285714286,1,0.0,3,2,0,1,3,0,0,1,0,6,4,1
7686,183379,qHIKvxolHHwVyfUrUuTQ7lCeMbWX7sYP,RXDvfPUBYFlVdlueBFbLW0mhhAyGEqpt,14,16,2,6,3,1,1,0,29,4.142857142857143,1,0.0,5,2,6,3,11,1,0,1,0,16,13,1
7687,183381,I2UwAjBakgo7ulEE8gv6S9DLeFdNO1pr,bWdj2GDclj5ofokWjzoa5jAwMkxCykd6,3,0,0,0,0,0,2,1,3,0.42857142857142855,1,0.0,0,0,0,0,0,0,0,2,1,0,3,1
7688,183386,O7fzJfuKfqlfMIjfhNwbu2i8Ce4wMF9H,SpATywNh6bZuzm8s1ceuBUnMUAeoAHHw,2,0,0,0,0,0,2,0,2,0.2857142857142857,1,0.0,0,0,0,0,0,0,0,2,0,0,2,1
7689,183387,AT7MUJLyTRujCGftxJSRLnutVHzi2W6K,bWdj2GDclj5ofokWjzoa5jAwMkxCykd6,1,0,0,0,0,0,1,0,1,0.14285714285714285,1,0.0,0,0,0,0,0,0,0,1,0,0,1,1
7690,183394,rEeBeKGH612kEsTNiutHYC8nvtLgJLl3,bWdj2GDclj5ofokWjzoa5jAwMkxCykd6,6,4,1,0,2,8,5,0,20,2.857142857142857,1,0.0,2,1,0,2,2,8,0,5,0,5,15,1
7691,183395,3ypTaFxEmzRhgWt1V6ubGImksm3gaDqi,G8EPVSXsOYB5YQWZGiz1aVq5Pgr2GrQu,6,6,0,0,0,0,3,0,9,1.2857142857142858,1,0.0,1,0,0,0,5,0,0,3,0,1,8,1
7692,183402,uZccjrlfbKn6BDCm3jPoxZprWusdhQYC,RXDvfPUBYFlVdlueBFbLW0mhhAyGEqpt,8,3,2,0,0,2,6,1,14,2.0,1,0.0,0,2,0,0,3,2,0,6,1,2,12,1
7693,183404,StBmEv3I1e5i7om3Qal9RCxtr12zGldK,SpATywNh6bZuzm8s1ceuBUnMUAeoAHHw,3,2,1,0,0,0,1,0,4,0.5714285714285714,1,0.0,0,1,0,0,2,0,0,1,0,1,3,1
7694,183406,6x4B9nu8vwEEwbbJ91dM7syOmh6Wd3T4,RXDvfPUBYFlVdlueBFbLW0mhhAyGEqpt,15,12,8,0,9,0,7,0,36,5.142857142857143,2,0.0,3,8,0,9,9,0,0,7,0,20,16,1
7695,183409,p2WxyRGvLvUMOSoEWtLVx9Ca2AiCwjk0,SpATywNh6bZuzm8s1ceuBUnMUAeoAHHw,10,7,4,10,0,0,2,0,23,3.2857142857142856,1,0.0,2,4,8,0,5,0,2,2,0,14,9,1
7696,183414,e2iZvNKfdNseGOCno9jVScN4rf0x278a,G8EPVSXsOYB5YQWZGiz1aVq5Pgr2GrQu,10,6,2,10,1,0,3,0,22,3.142857142857143,1,0.0,3,2,7,1,3,0,3,3,0,13,9,1
7697,183423,CViRSkXaB71kW0MpqfES8A240EKnhiKp,bWdj2GDclj5ofokWjzoa5jAwMkxCykd6,6,6,3,0,2,0,2,0,13,1.8571428571428572,1,0.0,2,3,0,2,4,0,0,2,0,7,6,1
7698,183427,BYDzZvbHlPLB5l5C8F0sCY7jgUh5E5kF,SpATywNh6bZuzm8s1ceuBUnMUAeoAHHw,4,3,2,0,0,0,1,0,6,0.8571428571428571,1,0.0,0,2,0,0,3,0,0,1,0,2,4,1
7699,183430,MofLU1eAzpaUKN6d2uNrYpUKgP1lpdHE,RXDvfPUBYFlVdlueBFbLW0mhhAyGEqpt,15,16,11,12,3,3,7,1,53,7.571428571428571,1,0.0,0,11,10,3,16,3,2,7,1,24,29,1
7700,183431,8BTLZqMynI47lpeExrpUyf3Ycam7Kqwv,SpATywNh6bZuzm8s1ceuBUnMUAeoAHHw,9,28,10,0,0,0,4,0,42,6.0,1,0.0,3,10,0,0,25,0,0,4,0,13,29,1
7701,183435,t4uSkzpGvWF0mtXEP739NS9nOIoxwvm0,RXDvfPUBYFlVdlueBFbLW0mhhAyGEqpt,6,4,0,0,0,0,2,0,6,0.8571428571428571,1,0.0,0,0,0,0,4,0,0,2,0,0,6,1
7702,183440,EtfxOXHEuVBMaj0eMSXrIIrSQlTvW9sK,bWdj2GDclj5ofokWjzoa5jAwMkxCykd6,1,0,0,0,0,0,1,0,1,0.14285714285714285,1,0.0,0,0,0,0,0,0,0,1,0,0,1,1
7703,183442,v9EzyBMgqrHmKu64Jm356JCxNk5lnRyw,G8EPVSXsOYB5YQWZGiz1aVq5Pgr2GrQu,2,0,0,0,0,0,2,0,2,0.2857142857142857,1,0.0,0,0,0,0,0,0,0,2,0,0,2,1
7704,183452,RnIxYOCcvRkH5SmLcSLbuQiMmbZTCV4X,bWdj2GDclj5ofokWjzoa5jAwMkxCykd6,7,4,2,0,1,2,3,1,13,1.8571428571428572,1,0.0,0,2,0,1,4,2,0,3,1,3,10,1
7705,183456,InAOZGiL3znHtTGfF0VCl2ivku6eLEMF,RXDvfPUBYFlVdlueBFbLW0mhhAyGEqpt,20,30,16,35,14,1,7,11,114,16.285714285714285,1,0.0,12,16,30,14,18,1,5,7,11,72,42,1
7706,183465,Mie6PMLFZ6GTGAAMZLvUdpU4rgeHjvP2,bWdj2GDclj5ofokWjzoa5jAwMkxCykd6,5,2,1,0,1,0,2,0,6,0.8571428571428571,1,0.0,0,1,0,1,2,0,0,2,0,2,4,1
7707,183466,nwVilrO2xxpsCBw1FRKGSujEDxCOupgS,SpATywNh6bZuzm8s1ceuBUnMUAeoAHHw,6,6,2,0,1,1,4,0,14,2.0,1,0.0,0,2,0,1,6,1,0,4,0,3,11,1
7708,183467,PFkCedTA1DArZVlA7QIlGHqePzUVifGy,SpATywNh6bZuzm8s1ceuBUnMUAeoAHHw,1,0,0,0,0,0,1,0,1,0.14285714285714285,1,0.0,0,0,0,0,0,0,0,1,0,0,1,1
7709,183468,SSM7wEvdZo8FZW0zxJcXGwdA1S6Vbn5Q,SpATywNh6bZuzm8s1ceuBUnMUAeoAHHw,10,9,5,13,0,1,2,0,30,4.285714285714286,1,0.0,3,5,11,0,6,1,2,2,0,19,11,0
7710,183471,ZWE0n8BTbJ9FUQALYDITtcmVETezeafV,bWdj2GDclj5ofokWjzoa5jAwMkxCykd6,10,8,2,40,2,1,4,1,58,8.285714285714286,1,0.0,5,2,39,2,3,1,1,4,1,48,10,1
7711,183472,UJgg3Z7RMqrOzehAajABZyrolXDOj0JJ,G8EPVSXsOYB5YQWZGiz1aVq5Pgr2GrQu,3,2,0,0,0,0,2,0,4,0.5714285714285714,1,0.0,0,0,0,0,2,0,0,2,0,0,4,1
7712,183474,pk69em2bhNfGTrrqysMHCMfzjd22WDJE,SpATywNh6bZuzm8s1ceuBUnMUAeoAHHw,13,8,4,2,3,0,4,1,22,3.142857142857143,1,0.0,0,4,2,3,8,0,0,4,1,9,13,1
7713,183475,bz5GKxlsbJHiQ5yHN3mGDylrAg3DXi5E,SpATywNh6bZuzm8s1ceuBUnMUAeoAHHw,9,9,8,0,5,0,2,0,24,3.4285714285714284,1,0.0,0,8,0,5,9,0,0,2,0,13,11,1
7714,183480,pumsIIBvkIDHPLuElv7OSuQxwiyrjr12,SpATywNh6bZuzm8s1ceuBUnMUAeoAHHw,14,27,8,20,4,1,5,0,65,9.285714285714286,1,0.0,9,8,18,4,18,1,2,5,0,39,26,1
7715,183491,hMsNCldAkGadwgGX6yjkMuu7X3GLTjYs,bWdj2GDclj5ofokWjzoa5jAwMkxCykd6,12,14,10,8,7,10,11,0,60,8.571428571428571,2,0.0,1,10,6,7,13,10,2,11,0,24,36,1
7716,183493,wTO6PriqUjklZvIhTLmF52Ryme8SIc0k,SpATywNh6bZuzm8s1ceuBUnMUAeoAHHw,1,0,0,0,0,0,1,0,1,0.14285714285714285,1,0.0,0,0,0,0,0,0,0,1,0,0,1,1
7717,183495,O6uNlqe4D6fw6uKpeBg3BRdXTyp6hhXG,RXDvfPUBYFlVdlueBFbLW0mhhAyGEqpt,1,0,0,0,0,0,1,0,1,0.14285714285714285,1,0.0,0,0,0,0,0,0,0,1,0,0,1,1
7718,183498,cQingcIr6b1ihV5kJhN5qPmtxp0KcxRT,G8EPVSXsOYB5YQWZGiz1aVq5Pgr2GrQu,7,6,3,0,2,3,3,0,17,2.4285714285714284,1,0.0,0,3,0,2,6,3,0,3,0,5,12,1
7719,183506,VtCUQBk0TlN0AJOAq0bEC4tTAH6HVrBA,RXDvfPUBYFlVdlueBFbLW0mhhAyGEqpt,5,3,1,0,1,0,1,0,6,0.8571428571428571,1,0.0,0,1,0,1,3,0,0,1,0,2,4,1
7720,183507,dRkGRhgEz0P6Cj2gSWKZ3jwm6LAB5sTl,RXDvfPUBYFlVdlueBFbLW0mhhAyGEqpt,6,14,10,0,0,0,5,0,29,4.142857142857143,1,0.0,0,10,0,0,14,0,0,5,0,10,19,1
7721,183510,UjlYIZQOEINWayGhC3yn2Cik0ILUnmNg,RXDvfPUBYFlVdlueBFbLW0mhhAyGEqpt,10,11,7,0,4,0,10,0,32,4.571428571428571,1,0.0,0,7,0,4,11,0,0,10,0,11,21,1
7722,183512,DhiB4cJ1TCjmSH3ZWP9m0OqNyBdGeS5P,bWdj2GDclj5ofokWjzoa5jAwMkxCykd6,5,6,0,0,0,0,2,0,8,1.1428571428571428,1,0.0,0,0,0,0,6,0,0,2,0,0,8,1
7723,183515,dRbINtWX4PACMb6CoPwzFcGIwIksepgL,SpATywNh6bZuzm8s1ceuBUnMUAeoAHHw,1,0,0,0,0,0,1,0,1,0.14285714285714285,1,0.0,0,0,0,0,0,0,0,1,0,0,1,1
7724,183516,AwMbVkwoHOO4RwVeu0kWHW1pZCX6cyCm,bWdj2GDclj5ofokWjzoa5jAwMkxCykd6,2,0,0,0,0,0,2,0,2,0.2857142857142857,1,0.0,0,0,0,0,0,0,0,2,0,0,2,1
7725,183519,B4PjpXbBdKDLR1d4bTEW8nYb1XQ8zgOw,RXDvfPUBYFlVdlueBFbLW0mhhAyGEqpt,3,2,1,0,0,0,1,0,4,0.5714285714285714,1,0.0,0,1,0,0,2,0,0,1,0,1,3,1
7726,183520,1D6eUyCJP5alahovvE13UJeLeWGqXCSN,SpATywNh6bZuzm8s1ceuBUnMUAeoAHHw,1,0,0,0,0,0,1,0,1,0.14285714285714285,1,0.0,0,0,0,0,0,0,0,1,0,0,1,0
7727,183522,jdDAkKv7CXlTSONMrkYEJDMOqMZv4NO7,G8EPVSXsOYB5YQWZGiz1aVq5Pgr2GrQu,7,5,1,0,1,0,3,0,10,1.4285714285714286,1,0.0,0,1,0,1,5,0,0,3,0,2,8,1
7728,183523,uvHFiZDnxbLoaMgYUEvYxJ8fEqaBGtVR,SpATywNh6bZuzm8s1ceuBUnMUAeoAHHw,6,3,2,0,1,0,2,0,8,1.1428571428571428,1,0.0,0,2,0,1,3,0,0,2,0,3,5,1
7729,183525,l4fUBbt2UkEBI1IQ0gPXz6asVAEuAAgG,SpATywNh6bZuzm8s1ceuBUnMUAeoAHHw,8,6,6,0,4,0,5,0,21,3.0,3,0.0,0,6,0,4,6,0,0,5,0,10,11,1
7730,183529,Nqn3ANjR8SmFf4pF0O8Kve4CiSpmex7G,SpATywNh6bZuzm8s1ceuBUnMUAeoAHHw,1,0,0,0,0,0,1,0,1,0.14285714285714285,1,0.0,0,0,0,0,0,0,0,1,0,0,1,1
7731,183532,vrlk2ULHn3q7og5F7d4moUFSIP81jWhe,SpATywNh6bZuzm8s1ceuBUnMUAeoAHHw,5,2,1,0,1,0,2,0,6,0.8571428571428571,1,0.0,0,1,0,1,2,0,0,2,0,2,4,1
7732,183533,M75L90OOMTV1kEiI3n7vM0ty47YBFna9,SpATywNh6bZuzm8s1ceuBUnMUAeoAHHw,3,3,0,0,0,0,1,0,4,0.5714285714285714,1,0.0,0,0,0,0,3,0,0,1,0,0,4,1
7733,183544,pIUA4CxUOhlZMOg4cOlVb2la0FCnmRD3,RXDvfPUBYFlVdlueBFbLW0mhhAyGEqpt,11,6,5,0,3,0,2,0,16,2.2857142857142856,1,0.0,0,5,0,3,6,0,0,2,0,8,8,1
7734,183554,4gFDIkwCKsDbUhjdoZqM1BZ32HnFPqUv,bWdj2GDclj5ofokWjzoa5jAwMkxCykd6,2,0,0,0,0,0,2,0,2,0.2857142857142857,1,0.0,0,0,0,0,0,0,0,2,0,0,2,1
7735,183562,AWvgwCQmPH4OGAIYypj87Tg2RKpUEZjK,RXDvfPUBYFlVdlueBFbLW0mhhAyGEqpt,23,42,2,36,4,3,4,2,93,13.285714285714286,1,0.0,29,2,31,4,13,3,5,4,2,66,27,1
7736,183563,Edq6Echk8wEs8ShX5RBw5c8Yx8ANHVje,bWdj2GDclj5ofokWjzoa5jAwMkxCykd6,5,2,1,0,1,0,5,0,9,1.2857142857142858,1,0.0,0,1,0,1,2,0,0,5,0,2,7,1
7737,183564,K7VioOgkoW2bG7ynS7EVbYmEm9sNay8P,bWdj2GDclj5ofokWjzoa5jAwMkxCykd6,8,3,2,0,2,0,3,0,10,1.4285714285714286,1,0.0,0,2,0,2,3,0,0,3,0,4,6,1
7738,183568,lRbeD3dHMTos4W2d1Naqv6Hm53gM6ove,RXDvfPUBYFlVdlueBFbLW0mhhAyGEqpt,5,5,3,0,0,0,3,0,11,1.5714285714285714,1,0.0,0,3,0,0,5,0,0,3,0,3,8,1
7739,183574,kGkU7DU5zOC0IQHNRlo6r0rouCnUfi6R,bWdj2GDclj5ofokWjzoa5jAwMkxCykd6,1,0,0,0,0,0,1,0,1,0.14285714285714285,1,0.0,0,0,0,0,0,0,0,1,0,0,1,1
7740,183575,dTjL08in9jKZ00BA9Kf6biDJuIA4OzlF,bWdj2GDclj5ofokWjzoa5jAwMkxCykd6,1,0,0,0,0,0,1,0,1,0.14285714285714285,1,0.0,0,0,0,0,0,0,0,1,0,0,1,1
7741,183578,b1g4AWG6A2zG5plnQY4paLSHRFnrgObC,bWdj2GDclj5ofokWjzoa5jAwMkxCykd6,3,2,0,0,0,0,2,0,4,0.5714285714285714,1,0.0,0,0,0,0,2,0,0,2,0,0,4,1
7742,183580,3t9ZicXafEarB5kevklUjZj2RJMyb5VH,bWdj2GDclj5ofokWjzoa5jAwMkxCykd6,1,0,0,0,0,0,1,0,1,0.14285714285714285,1,0.0,0,0,0,0,0,0,0,1,0,0,1,1
7743,183583,eDzTwNhYw5qEG2zvbZVjOixJZpRNeUjf,SpATywNh6bZuzm8s1ceuBUnMUAeoAHHw,16,12,6,14,4,3,8,2,49,7.0,1,0.0,4,6,12,4,8,3,2,8,2,26,23,1
7744,183584,9KpScbHudyYdTVutfkp65lLJaFeSgBWp,SpATywNh6bZuzm8s1ceuBUnMUAeoAHHw,4,3,1,0,0,0,2,0,6,0.8571428571428571,1,0.0,0,1,0,0,3,0,0,2,0,1,5,1
7745,183597,Eh6H4i1zHStqzSkD6GI2c0vx2yJEOPJN,RXDvfPUBYFlVdlueBFbLW0mhhAyGEqpt,1,0,0,0,0,0,1,0,1,0.14285714285714285,1,0.0,0,0,0,0,0,0,0,1,0,0,1,1
7746,183600,0ZbsYtS35s7opWGwTDlJClFUqsKIqJ5M,SpATywNh6bZuzm8s1ceuBUnMUAeoAHHw,9,3,2,0,2,1,4,1,13,1.8571428571428572,1,0.0,0,2,0,2,3,1,0,4,1,4,9,1
7747,183602,VRgPAzuxIaYkNO2Qx5nEdyuDaVR0Pn8E,SpATywNh6bZuzm8s1ceuBUnMUAeoAHHw,7,5,4,0,3,0,4,0,16,2.2857142857142856,1,0.0,0,4,0,3,5,0,0,4,0,7,9,1
7748,183604,SKEZ0daa2ls5AsPymaWXx3HMK7ugoFOQ,SpATywNh6bZuzm8s1ceuBUnMUAeoAHHw,3,2,0,0,0,0,2,0,4,0.5714285714285714,1,0.0,0,0,0,0,2,0,0,2,0,0,4,1
7749,183605,u4EZDHauXLY7CQOXsbgjEXdCMOX1ZIIi,bWdj2GDclj5ofokWjzoa5jAwMkxCykd6,8,6,1,0,2,0,9,1,19,2.7142857142857144,1,0.0,3,1,0,2,3,0,0,9,1,6,13,1
7750,183608,5Qb7U49ZGB6vPwkkfqIlX0DILe5PUAX7,SpATywNh6bZuzm8s1ceuBUnMUAeoAHHw,4,3,1,0,0,0,2,0,6,0.8571428571428571,1,0.0,0,1,0,0,3,0,0,2,0,1,5,1
7751,183615,jcXoYFaI9QPcliotiwIgOLeObkrSUvNn,bWdj2GDclj5ofokWjzoa5jAwMkxCykd6,1,0,0,0,0,0,1,0,1,0.14285714285714285,1,0.0,0,0,0,0,0,0,0,1,0,0,1,1
7752,183617,Pv9LrfjnRw1WO1VwPNHCu7aKxUz6zC8i,SpATywNh6bZuzm8s1ceuBUnMUAeoAHHw,9,11,6,8,0,0,4,0,29,4.142857142857143,2,0.0,4,6,6,0,7,0,2,4,0,16,13,1
7753,183618,Fy49pMsTJR4qc7kCFAlWxZsMejdzrbbw,SpATywNh6bZuzm8s1ceuBUnMUAeoAHHw,6,2,1,0,1,0,3,1,8,1.1428571428571428,1,0.0,0,1,0,1,2,0,0,3,1,2,6,1
7754,183620,8f6cUr3CdC0FEH3V0o2H0iLNd9nVyUsV,SpATywNh6bZuzm8s1ceuBUnMUAeoAHHw,6,0,0,0,0,1,7,1,9,1.2857142857142858,1,0.0,0,0,0,0,0,1,0,7,1,0,9,1
7755,183623,7wyfXvc1g99QNmXzEb4w8C1vE0Vi2bHm,bWdj2GDclj5ofokWjzoa5jAwMkxCykd6,4,2,0,0,0,0,4,0,6,0.8571428571428571,1,0.0,0,0,0,0,2,0,0,4,0,0,6,1
7756,183626,Qntf4pjwhrrlpkPkdw7xTOHA3tqEKwZo,SpATywNh6bZuzm8s1ceuBUnMUAeoAHHw,1,0,0,0,0,0,1,0,1,0.14285714285714285,1,0.0,0,0,0,0,0,0,0,1,0,0,1,1
7757,183627,vpIRkrpJz2fnOEDQ7QyDeADagL23RUmm,SpATywNh6bZuzm8s1ceuBUnMUAeoAHHw,5,2,1,0,1,0,3,0,7,1.0,1,0.0,0,1,0,1,2,0,0,3,0,2,5,1
7758,183628,r3xrbycrTBTOJ8lVkbmPIEtnYkwuySp0,G8EPVSXsOYB5YQWZGiz1aVq5Pgr2GrQu,7,7,1,0,1,0,1,0,10,1.4285714285714286,1,0.0,1,1,0,1,6,0,0,1,0,3,7,1
7759,183642,mbEX76fVD9CfdxvS9S0YmboTh2OQRRH9,SpATywNh6bZuzm8s1ceuBUnMUAeoAHHw,9,10,0,10,0,23,1,0,44,6.285714285714286,1,0.0,4,0,9,0,6,23,1,1,0,13,31,1
7760,183647,a4RYqILKcnu8c617gYSbD0KQIm9DqZnc,RXDvfPUBYFlVdlueBFbLW0mhhAyGEqpt,6,5,4,0,2,0,1,0,12,1.7142857142857142,1,0.0,0,4,0,2,5,0,0,1,0,6,6,1
7761,183667,H01qgmsAzE6UZ02rpT0g0cPQbKgigwE6,SpATywNh6bZuzm8s1ceuBUnMUAeoAHHw,1,0,0,0,0,0,1,0,1,0.14285714285714285,1,0.0,0,0,0,0,0,0,0,1,0,0,1,1
7762,183668,NMciPbdIeB9uIZwCMcw6mXU2i3BtnB5v,RXDvfPUBYFlVdlueBFbLW0mhhAyGEqpt,13,8,5,15,3,0,1,0,32,4.571428571428571,1,0.0,1,5,12,3,7,0,3,1,0,21,11,0
7763,183677,3kAfPhBAdLqCd25fZapuQy7eXOe7UiZ6,SpATywNh6bZuzm8s1ceuBUnMUAeoAHHw,2,0,0,0,0,0,3,0,3,0.42857142857142855,1,0.0,0,0,0,0,0,0,0,3,0,0,3,1
7764,183678,00w736SmRTShB1yHSNNQKxZ90wTM71uT,SpATywNh6bZuzm8s1ceuBUnMUAeoAHHw,1,0,0,0,0,0,1,0,1,0.14285714285714285,1,0.0,0,0,0,0,0,0,0,1,0,0,1,1
7765,183681,tUa09YYOUnb3wVzvjQGH0FvIpZ5hsZpt,SpATywNh6bZuzm8s1ceuBUnMUAeoAHHw,6,1,0,0,0,1,4,1,7,1.0,1,0.0,0,0,0,0,1,1,0,4,1,0,7,1
7766,183683,Hqlgf2n4GScNbLk3LnpSlhqbXS4k1V5Y,bWdj2GDclj5ofokWjzoa5jAwMkxCykd6,2,0,0,0,0,0,2,0,2,0.2857142857142857,1,0.0,0,0,0,0,0,0,0,2,0,0,2,1
7767,183684,PJVOwbqsSqxmbQfiqysBeUsqu2d0RHYt,SpATywNh6bZuzm8s1ceuBUnMUAeoAHHw,1,0,0,0,0,0,1,0,1,0.14285714285714285,1,0.0,0,0,0,0,0,0,0,1,0,0,1,1
7768,183685,srrwedRjbv42svoIh3SiJfl8lc5wqthR,SpATywNh6bZuzm8s1ceuBUnMUAeoAHHw,8,6,1,0,1,0,3,1,12,1.7142857142857142,1,0.0,0,1,0,1,6,0,0,3,1,2,10,1
7769,183690,LrnqEdfBj0D0yEwqlIwYFq7gG4yeMv2F,RXDvfPUBYFlVdlueBFbLW0mhhAyGEqpt,5,3,2,0,2,0,2,0,9,1.2857142857142858,1,0.0,0,2,0,2,3,0,0,2,0,4,5,1
7770,183692,pGwYJRrX7MfzhhSwNLSQAMurehSIgkJ9,bWdj2GDclj5ofokWjzoa5jAwMkxCykd6,9,5,3,16,2,8,7,1,42,6.0,2,0.0,1,3,16,2,4,8,0,7,1,22,20,1
7771,183696,5507vCg0B1i7QYbqjYirkMGFioj9q8do,bWdj2GDclj5ofokWjzoa5jAwMkxCykd6,7,3,3,0,3,0,2,0,11,1.5714285714285714,1,0.0,0,3,0,3,3,0,0,2,0,6,5,1
7772,183697,XTAgcCcMxVaOaQnxZJfZgo5L5IIUp6vo,SpATywNh6bZuzm8s1ceuBUnMUAeoAHHw,7,4,1,0,1,0,4,0,10,1.4285714285714286,1,0.0,0,1,0,1,4,0,0,4,0,2,8,1
7773,183703,0tUsWRwcM5Diph5ritKgQygdUhSNn96x,SpATywNh6bZuzm8s1ceuBUnMUAeoAHHw,6,2,1,0,1,0,2,0,6,0.8571428571428571,1,0.0,0,1,0,1,2,0,0,2,0,2,4,1
7774,183705,fsTTrbfLLX3LLKI2ivzhVe8zchwg73pj,SpATywNh6bZuzm8s1ceuBUnMUAeoAHHw,15,12,6,14,3,1,5,0,41,5.857142857142857,1,0.0,4,6,13,3,8,1,1,5,0,26,15,1
7775,183706,0eu2uHXXHlrxtRapovPIpFp8IooLmBew,SpATywNh6bZuzm8s1ceuBUnMUAeoAHHw,5,2,1,0,1,0,2,0,6,0.8571428571428571,1,0.0,0,1,0,1,2,0,0,2,0,2,4,1
7776,183707,NaRJmQnyQzKeB0w8DDGDf6ZmsPHjlThO,SpATywNh6bZuzm8s1ceuBUnMUAeoAHHw,10,6,0,6,0,0,4,1,17,2.4285714285714284,1,0.0,1,0,5,0,5,0,1,4,1,6,11,1
7777,183721,j77DK4hco4PDLnfPsujP1vD7LFaP7p4V,SpATywNh6bZuzm8s1ceuBUnMUAeoAHHw,10,10,0,0,1,3,5,3,22,3.142857142857143,1,0.0,1,0,0,1,9,3,0,5,3,2,20,1
7778,183725,GfV76YxFEig6L2nHg6sIaPDE5VPf3uRt,SpATywNh6bZuzm8s1ceuBUnMUAeoAHHw,8,4,3,0,3,0,3,0,13,1.8571428571428572,1,0.0,0,3,0,3,4,0,0,3,0,6,7,1
7779,183728,wjS8ie6ACTxewSCQo7zpBy0tu4z4RYPD,RXDvfPUBYFlVdlueBFbLW0mhhAyGEqpt,1,0,0,0,0,0,1,0,1,0.14285714285714285,1,0.0,0,0,0,0,0,0,0,1,0,0,1,1
7780,183730,eDzTwNhYw5qEG2zvbZVjOixJZpRNeUjf,bWdj2GDclj5ofokWjzoa5jAwMkxCykd6,11,14,8,10,4,0,7,0,43,6.142857142857143,1,0.0,1,8,8,4,13,0,2,7,0,21,22,1
7781,183732,Cu4fMSI1LUWMJcNR5zM13WUwE6Hxc1yL,SpATywNh6bZuzm8s1ceuBUnMUAeoAHHw,10,7,4,11,0,0,2,0,24,3.4285714285714284,1,0.0,2,4,10,0,5,0,1,2,0,16,8,1
7782,183733,MlcE1JFENTunAHw0ocZkMchxf8NdWNFO,bWdj2GDclj5ofokWjzoa5jAwMkxCykd6,3,4,1,0,1,0,1,0,7,1.0,1,0.0,2,1,0,1,2,0,0,1,0,4,3,1
7783,183735,68jxA2PUjT1NQfZbUcdmPfGR0u6r2zeM,RXDvfPUBYFlVdlueBFbLW0mhhAyGEqpt,1,0,0,0,0,0,1,0,1,0.14285714285714285,1,0.0,0,0,0,0,0,0,0,1,0,0,1,1
7784,183745,FR3djrgj8pkYcAIqYiRiT862Pvu77Ath,SpATywNh6bZuzm8s1ceuBUnMUAeoAHHw,1,0,0,0,0,0,1,0,1,0.14285714285714285,1,0.0,0,0,0,0,0,0,0,1,0,0,1,1
7785,183748,hD4qEuZFDZPZ2RLgArJFuhYLdzuJCt01,bWdj2GDclj5ofokWjzoa5jAwMkxCykd6,7,5,1,0,0,0,5,0,11,1.5714285714285714,1,0.0,0,1,0,0,5,0,0,5,0,1,10,1
7786,183750,G7MC8DJ4FubRjcyO7f3yIgxskIjZSZjx,SpATywNh6bZuzm8s1ceuBUnMUAeoAHHw,1,0,0,0,0,0,1,0,1,0.14285714285714285,1,0.0,0,0,0,0,0,0,0,1,0,0,1,1
7787,183751,hJq2MbZS4JBSMT1a0Z3Gv6HKBJY6P875,bWdj2GDclj5ofokWjzoa5jAwMkxCykd6,1,0,0,0,0,0,1,0,1,0.14285714285714285,1,0.0,0,0,0,0,0,0,0,1,0,0,1,1
7788,183752,bxybXAkYqJdxWDLSPlh74sjGoIJub8gI,SpATywNh6bZuzm8s1ceuBUnMUAeoAHHw,4,3,1,0,1,0,1,0,6,0.8571428571428571,1,0.0,0,1,0,1,3,0,0,1,0,2,4,1
7789,183756,hJq2MbZS4JBSMT1a0Z3Gv6HKBJY6P875,G8EPVSXsOYB5YQWZGiz1aVq5Pgr2GrQu,1,0,0,0,0,0,1,0,1,0.14285714285714285,1,0.0,0,0,0,0,0,0,0,1,0,0,1,1
7790,183762,o1et1l3gB2UO6Zee7jdvT3mFoSzRmTnv,SpATywNh6bZuzm8s1ceuBUnMUAeoAHHw,11,67,43,0,0,2,18,1,131,18.714285714285715,1,0.0,11,43,0,0,56,2,0,18,1,54,77,1
7791,183763,VeIUrvtz2WpmBOVKmRi9CiIdJh5W97e2,RXDvfPUBYFlVdlueBFbLW0mhhAyGEqpt,6,1,1,0,1,0,4,0,7,1.0,1,0.0,0,1,0,1,1,0,0,4,0,2,5,1
7792,183764,Nlh27vHI7XhT6kQrXYnVdjcOvglbank1,G8EPVSXsOYB5YQWZGiz1aVq5Pgr2GrQu,5,4,1,0,0,0,1,0,6,0.8571428571428571,1,0.0,0,1,0,0,4,0,0,1,0,1,5,1
7793,183765,rQAguOaTDu3xVeM76HB96fgatKOO1sTk,SpATywNh6bZuzm8s1ceuBUnMUAeoAHHw,1,0,0,0,0,0,1,0,1,0.14285714285714285,1,0.0,0,0,0,0,0,0,0,1,0,0,1,1
7794,183769,YV5fQTL2YvQLATfqnj9sLfcWGppiWs4n,bWdj2GDclj5ofokWjzoa5jAwMkxCykd6,9,12,5,0,2,0,6,1,26,3.7142857142857144,1,0.0,0,5,0,2,12,0,0,6,1,7,19,1
7795,183771,rQAguOaTDu3xVeM76HB96fgatKOO1sTk,bWdj2GDclj5ofokWjzoa5jAwMkxCykd6,1,0,0,0,0,0,1,0,1,0.14285714285714285,1,0.0,0,0,0,0,0,0,0,1,0,0,1,1
7796,183772,cYRBWOkDMP7C555Y2eZz5GOKMhCVJBvZ,SpATywNh6bZuzm8s1ceuBUnMUAeoAHHw,8,5,3,0,2,0,4,0,14,2.0,1,0.0,0,3,0,2,5,0,0,4,0,5,9,1
7797,183773,aXiJW8ayzWdjAFuCXJZEkZEM0lQLoZYD,SpATywNh6bZuzm8s1ceuBUnMUAeoAHHw,1,0,0,0,0,0,1,0,1,0.14285714285714285,1,0.0,0,0,0,0,0,0,0,1,0,0,1,1
7798,183776,K8gGtH4J6AjA9U9FV7bczDiv6su7TqD9,SpATywNh6bZuzm8s1ceuBUnMUAeoAHHw,2,0,0,0,0,0,2,0,2,0.2857142857142857,1,0.0,0,0,0,0,0,0,0,2,0,0,2,1
7799,183778,jVE9J6XTbZz7EeUuDkD5BDSnxkl65G8L,bWdj2GDclj5ofokWjzoa5jAwMkxCykd6,6,7,4,0,1,6,4,0,22,3.142857142857143,1,0.0,0,4,0,1,7,6,0,4,0,5,17,1
7800,183782,wzcKXGYxAENlw35KZ5i9A0UYj84yOcRo,SpATywNh6bZuzm8s1ceuBUnMUAeoAHHw,1,0,0,0,0,0,1,0,1,0.14285714285714285,1,0.0,0,0,0,0,0,0,0,1,0,0,1,1
7801,183794,oqyLKKVVYW9EATjohuVL1hNLHTIkDxiu,RXDvfPUBYFlVdlueBFbLW0mhhAyGEqpt,9,6,3,0,1,1,7,1,19,2.7142857142857144,1,0.0,0,3,0,1,6,1,0,7,1,4,15,1
7802,183795,8u2jHFBQdYbssbxd155XumepML5OnCFA,SpATywNh6bZuzm8s1ceuBUnMUAeoAHHw,9,3,2,0,1,1,5,1,13,1.8571428571428572,1,0.0,0,2,0,1,3,1,0,5,1,3,10,1
7803,183797,vlHmtLHxbw7S6zxC5oHlY3I9JCi1BY6K,bWdj2GDclj5ofokWjzoa5jAwMkxCykd6,1,0,0,0,0,0,1,0,1,0.14285714285714285,1,0.0,0,0,0,0,0,0,0,1,0,0,1,1
7804,183799,bxybXAkYqJdxWDLSPlh74sjGoIJub8gI,bWdj2GDclj5ofokWjzoa5jAwMkxCykd6,7,5,2,0,1,0,4,0,12,1.7142857142857142,2,0.0,0,2,0,1,5,0,0,4,0,3,9,1
7805,183807,nB4B19Wi7VjyTtJDPkIXAAww5TaYMuNU,G8EPVSXsOYB5YQWZGiz1aVq5Pgr2GrQu,6,5,3,0,1,0,2,0,11,1.5714285714285714,1,0.0,0,3,0,1,5,0,0,2,0,4,7,0
7806,183809,hr7uGA6N7pm5Wb3vahUIH4sx0GWC6IQD,G8EPVSXsOYB5YQWZGiz1aVq5Pgr2GrQu,5,2,1,0,1,0,3,0,7,1.0,1,0.0,0,1,0,1,2,0,0,3,0,2,5,1
7807,183811,YXm8bq7zaK4Xr5i1u3w8eLm5WwHCxSwx,bWdj2GDclj5ofokWjzoa5jAwMkxCykd6,2,0,0,0,0,4,1,0,5,0.7142857142857143,1,0.0,0,0,0,0,0,4,0,1,0,0,5,1
7808,183814,aOe6ryD5RYplhCYczJ8onj52Uh9OP4Rs,SpATywNh6bZuzm8s1ceuBUnMUAeoAHHw,7,7,1,0,1,1,3,0,13,1.8571428571428572,1,0.0,0,1,0,1,7,1,0,3,0,2,11,1
7809,183815,cfg2dvjgHRrRXnLKehwyxBIarxQiiXUS,bWdj2GDclj5ofokWjzoa5jAwMkxCykd6,4,2,0,0,1,0,1,0,4,0.5714285714285714,1,0.0,0,0,0,1,2,0,0,1,0,1,3,1
7810,183816,1y8Z7kbql2eWHeUppugE1NMIawh69MAq,SpATywNh6bZuzm8s1ceuBUnMUAeoAHHw,1,0,0,0,0,0,2,0,2,0.2857142857142857,1,0.0,0,0,0,0,0,0,0,2,0,0,2,1
7811,183820,RtJIi7yt7eqxxsJXnxUwVJPkYwTwddBt,SpATywNh6bZuzm8s1ceuBUnMUAeoAHHw,1,0,0,0,0,0,1,0,1,0.14285714285714285,1,0.0,0,0,0,0,0,0,0,1,0,0,1,1
7812,183824,ijNpE1ugmA4mkAddk2e3bQh6TJ0jb7HD,RXDvfPUBYFlVdlueBFbLW0mhhAyGEqpt,5,2,1,0,1,10,2,1,17,2.4285714285714284,1,0.0,0,1,0,1,2,10,0,2,1,2,15,1
7813,183826,GZEmn2jDYiPNelTXdP84Wl4gxgVXz7UQ,SpATywNh6bZuzm8s1ceuBUnMUAeoAHHw,7,4,3,0,2,1,2,0,12,1.7142857142857142,1,0.0,0,3,0,2,4,1,0,2,0,5,7,1
7814,183828,KyIbCsqzwxfjreA4vfXflB0Ayn4dl9kJ,SpATywNh6bZuzm8s1ceuBUnMUAeoAHHw,16,15,7,18,3,22,8,2,75,10.714285714285714,1,0.0,6,7,15,3,9,22,3,8,2,31,44,1
7815,183831,G4FZ5Oaaa2T6hGa1xufDgayvfMZLCg3D,bWdj2GDclj5ofokWjzoa5jAwMkxCykd6,2,0,0,0,0,0,2,0,2,0.2857142857142857,1,0.0,0,0,0,0,0,0,0,2,0,0,2,1
7816,183832,114X1vLT3OTzchhxfRGg24FTsgrs6Boi,SpATywNh6bZuzm8s1ceuBUnMUAeoAHHw,6,3,1,0,1,1,2,0,8,1.1428571428571428,1,0.0,0,1,0,1,3,1,0,2,0,2,6,1
7817,183833,vjbajDbPbQrGXYYcs1rbmRr6ezhDtDUy,bWdj2GDclj5ofokWjzoa5jAwMkxCykd6,1,0,0,0,0,0,1,0,1,0.14285714285714285,1,0.0,0,0,0,0,0,0,0,1,0,0,1,1
7818,183837,9veooDPdHGt0QPXOfcP4HtwqJxaobeIU,SpATywNh6bZuzm8s1ceuBUnMUAeoAHHw,11,17,3,14,0,8,5,1,48,6.857142857142857,1,0.0,10,3,13,0,7,8,1,5,1,26,22,1
7819,183838,aHceKEl94riboDVp8PRLPCY1XwhHlQv5,SpATywNh6bZuzm8s1ceuBUnMUAeoAHHw,1,0,0,0,0,0,1,0,1,0.14285714285714285,1,0.0,0,0,0,0,0,0,0,1,0,0,1,1
7820,183840,nxF8oaRxp1kRmW1R62DpnweCKcBsKTqd,SpATywNh6bZuzm8s1ceuBUnMUAeoAHHw,10,17,8,0,3,17,4,0,49,7.0,1,0.0,2,8,0,3,15,17,0,4,0,13,36,1
7821,183841,EytS791DMHkWPyEwKtiaQ332ujzLnBwF,bWdj2GDclj5ofokWjzoa5jAwMkxCykd6,5,10,1,0,1,0,2,0,14,2.0,1,0.0,0,1,0,1,10,0,0,2,0,2,12,1
7822,183846,umctuhbIVZDh6EHjPhWargzhNqVIeFMx,RXDvfPUBYFlVdlueBFbLW0mhhAyGEqpt,2,0,0,0,0,0,2,0,2,0.2857142857142857,1,0.0,0,0,0,0,0,0,0,2,0,0,2,1
7823,183861,DIfWHwFZNZPga0SgQhZ5mLJfHSTndMBk,G8EPVSXsOYB5YQWZGiz1aVq5Pgr2GrQu,4,0,0,0,0,1,3,1,5,0.7142857142857143,1,0.0,0,0,0,0,0,1,0,3,1,0,5,1
7824,183863,OyUzOGgEg3D1ADlF5EJGg06nY3QmnkdW,RXDvfPUBYFlVdlueBFbLW0mhhAyGEqpt,9,4,4,0,2,0,2,0,12,1.7142857142857142,1,0.0,0,4,0,2,4,0,0,2,0,6,6,1
7825,183866,lLsAMLGXDOsZeatceMnZJfI2N4EJjHne,G8EPVSXsOYB5YQWZGiz1aVq5Pgr2GrQu,1,0,0,0,0,0,4,0,4,0.5714285714285714,1,0.0,0,0,0,0,0,0,0,4,0,0,4,1
7826,183878,EnOE2zcU3adIQka8zXE5uaDcwrIceQaF,bWdj2GDclj5ofokWjzoa5jAwMkxCykd6,3,2,0,0,0,0,2,0,4,0.5714285714285714,1,0.0,0,0,0,0,2,0,0,2,0,0,4,1
7827,183879,5wfiCJMdbkN7MkoUGvo3cfz8jV3jCktA,SpATywNh6bZuzm8s1ceuBUnMUAeoAHHw,4,2,1,0,1,0,1,0,5,0.7142857142857143,1,0.0,0,1,0,1,2,0,0,1,0,2,3,1
7828,183881,8qABUnBBHxxZkfUhEQNUn5NNMSRrqvPC,bWdj2GDclj5ofokWjzoa5jAwMkxCykd6,7,4,1,36,0,0,3,1,45,6.428571428571429,1,0.0,2,1,35,0,2,0,1,3,1,38,7,1
7829,183888,TL1aA8ITe7VP42GX52yE5M5UsjXNCOS3,RXDvfPUBYFlVdlueBFbLW0mhhAyGEqpt,14,6,4,10,2,5,4,3,34,4.857142857142857,1,0.0,1,4,9,2,5,5,1,4,3,16,18,1
7830,183892,4wMgOAufqnPs3VhoygBeCYo4HP5tpnQt,SpATywNh6bZuzm8s1ceuBUnMUAeoAHHw,13,22,0,17,0,27,14,2,82,11.714285714285714,2,0.0,6,0,16,0,16,27,1,14,2,22,60,1
7831,183896,0a6HihupPBi4xpjolN637qOYG6WSN1Gx,bWdj2GDclj5ofokWjzoa5jAwMkxCykd6,1,0,0,0,0,0,1,0,1,0.14285714285714285,1,0.0,0,0,0,0,0,0,0,1,0,0,1,1
7832,183897,0a6HihupPBi4xpjolN637qOYG6WSN1Gx,G8EPVSXsOYB5YQWZGiz1aVq5Pgr2GrQu,1,0,0,0,0,0,1,0,1,0.14285714285714285,1,0.0,0,0,0,0,0,0,0,1,0,0,1,1
7833,183902,Z0eVgz6SGtmMg7DreMuN7iJOutansTOw,SpATywNh6bZuzm8s1ceuBUnMUAeoAHHw,5,2,1,0,1,0,2,0,6,0.8571428571428571,1,0.0,0,1,0,1,2,0,0,2,0,2,4,1
7834,183903,Pe0BOQruXYclUh2pOuaZXsDRh9S1JXgK,G8EPVSXsOYB5YQWZGiz1aVq5Pgr2GrQu,5,3,1,0,1,0,1,0,6,0.8571428571428571,1,0.0,0,1,0,1,3,0,0,1,0,2,4,1
7835,183927,1dSFrGV3jJZZA6qD4kOvZZNlB08eN9yU,SpATywNh6bZuzm8s1ceuBUnMUAeoAHHw,5,2,1,0,1,0,2,0,6,0.8571428571428571,1,0.0,0,1,0,1,2,0,0,2,0,2,4,1
7836,183929,BDdKHYPp1edgylVPYUBHaWJ6W3VobGdR,bWdj2GDclj5ofokWjzoa5jAwMkxCykd6,1,0,0,0,0,0,1,0,1,0.14285714285714285,1,0.0,0,0,0,0,0,0,0,1,0,0,1,1
7837,183936,MQT2DULvI9Dh4Sv1Ybk3xSqbqkDpET5t,RXDvfPUBYFlVdlueBFbLW0mhhAyGEqpt,5,1,1,0,1,0,3,0,6,0.8571428571428571,1,0.0,0,1,0,1,1,0,0,3,0,2,4,1
7838,183944,OB9oqmKPpcpFDkINdhqqXHF5hvJxfFBy,RXDvfPUBYFlVdlueBFbLW0mhhAyGEqpt,10,6,3,0,4,4,3,1,21,3.0,1,0.0,2,3,0,4,4,4,0,3,1,9,12,1
7839,183945,eswhmtF9u6PPevIa1f1kWFAOOSBwFxOH,SpATywNh6bZuzm8s1ceuBUnMUAeoAHHw,11,12,0,17,0,6,11,0,46,6.571428571428571,1,0.0,5,0,15,0,7,6,2,11,0,20,26,1
7840,183948,FFv9BpeuCytTk0cAY5ewtWqnPg8thMxr,SpATywNh6bZuzm8s1ceuBUnMUAeoAHHw,6,4,1,0,1,0,2,0,8,1.1428571428571428,1,0.0,0,1,0,1,4,0,0,2,0,2,6,1
7841,183956,qWnVRlOPWMpKhlz6DOCzqOXTcukhQiSA,bWdj2GDclj5ofokWjzoa5jAwMkxCykd6,3,2,0,0,0,0,1,0,3,0.42857142857142855,1,0.0,0,0,0,0,2,0,0,1,0,0,3,1
7842,183960,Q1yHZhB4hdcEznkeMey1ms0QifJ1CmdJ,G8EPVSXsOYB5YQWZGiz1aVq5Pgr2GrQu,1,0,0,0,0,0,1,0,1,0.14285714285714285,1,0.0,0,0,0,0,0,0,0,1,0,0,1,1
7843,183961,EWfsPxhCOXyE5eAI95GRpmzvT2SBrtgo,bWdj2GDclj5ofokWjzoa5jAwMkxCykd6,5,2,1,0,1,0,2,0,6,0.8571428571428571,1,0.0,0,1,0,1,2,0,0,2,0,2,4,1
7844,183975,f87pZCpThW6wNSnbexp1IWcK6VsMLCVr,RXDvfPUBYFlVdlueBFbLW0mhhAyGEqpt,19,11,7,14,4,0,2,0,38,5.428571428571429,1,0.0,3,7,14,4,8,0,0,2,0,28,10,1
7845,183982,Y87S79gsUH7x23XztCpMBa6RocL8Wlfk,bWdj2GDclj5ofokWjzoa5jAwMkxCykd6,5,4,0,0,1,0,5,0,10,1.4285714285714286,1,0.0,2,0,0,1,2,0,0,5,0,3,7,0
7846,183983,SEGJwH5xjhu0GixnmBSSBGNuHPRYimOx,SpATywNh6bZuzm8s1ceuBUnMUAeoAHHw,6,4,3,0,3,0,2,0,12,1.7142857142857142,1,0.0,0,3,0,3,4,0,0,2,0,6,6,1
7847,183985,GkZnrGaNbm07rAcHFJINai1bqc5xBBHT,SpATywNh6bZuzm8s1ceuBUnMUAeoAHHw,13,9,5,14,3,0,2,0,33,4.714285714285714,1,0.0,3,5,12,3,6,0,2,2,0,23,10,1
7848,183986,fNmDgjJniXOszcIHzS3zC4fz25NLjlFC,SpATywNh6bZuzm8s1ceuBUnMUAeoAHHw,1,0,0,0,0,0,1,0,1,0.14285714285714285,1,0.0,0,0,0,0,0,0,0,1,0,0,1,1
7849,183989,m4zdr76CpU472F6wsJffFbslI27LpI4g,SpATywNh6bZuzm8s1ceuBUnMUAeoAHHw,4,2,1,0,1,0,1,0,5,0.7142857142857143,1,0.0,0,1,0,1,2,0,0,1,0,2,3,1
7850,183993,dHF0lmwAWj90dNkEJgjhA3G1B2pjJava,bWdj2GDclj5ofokWjzoa5jAwMkxCykd6,1,0,0,0,0,0,1,0,1,0.14285714285714285,1,0.0,0,0,0,0,0,0,0,1,0,0,1,1
7851,183996,37daqGAbA6x2VvXkiqdWX1nBv2Tqqgte,SpATywNh6bZuzm8s1ceuBUnMUAeoAHHw,5,6,2,0,0,0,4,0,12,1.7142857142857142,1,0.0,0,2,0,0,6,0,0,4,0,2,10,1
7852,184009,wB8pBt76NTGPtrvjIdU3pN9EwIWhKGQo,SpATywNh6bZuzm8s1ceuBUnMUAeoAHHw,1,0,0,0,0,0,1,0,1,0.14285714285714285,1,0.0,0,0,0,0,0,0,0,1,0,0,1,1
7853,184012,mEFKCYz8MVHPZugokUhGo6T9qmLFE897,SpATywNh6bZuzm8s1ceuBUnMUAeoAHHw,16,28,10,13,5,2,8,2,68,9.714285714285714,2,0.0,8,10,13,5,20,2,0,8,2,36,32,1
7854,184033,BMzXa4F1HK4MbDTdR0pGzLHAAodUPJ6y,bWdj2GDclj5ofokWjzoa5jAwMkxCykd6,1,0,0,0,0,0,1,0,1,0.14285714285714285,1,0.0,0,0,0,0,0,0,0,1,0,0,1,1
7855,184038,Q12SmIgxAUIk1yKqjdfp0LXtJMgJdL9G,G8EPVSXsOYB5YQWZGiz1aVq5Pgr2GrQu,4,2,1,0,1,0,1,0,5,0.7142857142857143,1,0.0,0,1,0,1,2,0,0,1,0,2,3,1
7856,184039,GuBhksrnBhutuN529M1YtfTMCYIFJ6lY,G8EPVSXsOYB5YQWZGiz1aVq5Pgr2GrQu,12,10,5,0,4,0,2,0,21,3.0,1,0.0,0,5,0,4,10,0,0,2,0,9,12,1
7857,184047,XGJyrNdICrlEhPA3ZH7TFUF5DLeflEqn,SpATywNh6bZuzm8s1ceuBUnMUAeoAHHw,5,2,1,0,1,0,2,0,6,0.8571428571428571,1,0.0,0,1,0,1,2,0,0,2,0,2,4,1
7858,184048,k03NkUiM55XNDdygu6sbcCzBSQB1ke1d,RXDvfPUBYFlVdlueBFbLW0mhhAyGEqpt,11,17,1,0,1,0,4,0,23,3.2857142857142856,2,0.0,4,1,0,1,13,0,0,4,0,6,17,1
7859,184049,e41xflW3FJ2sfkSYCVTAw1yP2aJoqexe,SpATywNh6bZuzm8s1ceuBUnMUAeoAHHw,8,3,2,0,2,0,3,0,10,1.4285714285714286,1,0.0,0,2,0,2,3,0,0,3,0,4,6,1
7860,184060,BggPiWvKnxZgtt6PObC5h6pkP2Vpotku,SpATywNh6bZuzm8s1ceuBUnMUAeoAHHw,6,6,0,0,0,0,1,0,7,1.0,1,0.0,1,0,0,0,5,0,0,1,0,1,6,1
7861,184061,f5Mcw4567TFpDJkhEoRSw0Jz1pQ2BFAk,bWdj2GDclj5ofokWjzoa5jAwMkxCykd6,8,3,2,0,1,9,6,1,22,3.142857142857143,1,0.0,0,2,0,1,3,9,0,6,1,3,19,1
7862,184062,0CZR6JiyNyPl8nfnIp1u7wOec3poXsdF,SpATywNh6bZuzm8s1ceuBUnMUAeoAHHw,2,0,0,0,0,0,3,0,3,0.42857142857142855,1,0.0,0,0,0,0,0,0,0,3,0,0,3,1
7863,184063,Dpc0zozzlSgsLSateIgSdps1xubS3wT6,SpATywNh6bZuzm8s1ceuBUnMUAeoAHHw,7,3,2,0,2,0,2,0,9,1.2857142857142858,1,0.0,0,2,0,2,3,0,0,2,0,4,5,1
7864,184064,4RuLKPumIDuBK6n356cKgw9GML4wpFFR,SpATywNh6bZuzm8s1ceuBUnMUAeoAHHw,3,2,0,0,0,0,1,0,3,0.42857142857142855,1,0.0,0,0,0,0,2,0,0,1,0,0,3,1
7865,184066,qgG4OU0HRuoi21bBKmy9fO5g8h7KcP6E,SpATywNh6bZuzm8s1ceuBUnMUAeoAHHw,1,0,0,0,0,0,2,0,2,0.2857142857142857,1,0.0,0,0,0,0,0,0,0,2,0,0,2,1
7866,184067,OQfqRWOxxNsIi3nGxNChuaOEpiwW2MKx,RXDvfPUBYFlVdlueBFbLW0mhhAyGEqpt,5,2,1,0,1,0,2,0,6,0.8571428571428571,1,0.0,0,1,0,1,2,0,0,2,0,2,4,1
7867,184068,4RuLKPumIDuBK6n356cKgw9GML4wpFFR,bWdj2GDclj5ofokWjzoa5jAwMkxCykd6,1,0,0,0,0,0,1,0,1,0.14285714285714285,1,0.0,0,0,0,0,0,0,0,1,0,0,1,1
7868,184069,8KiAWlLGlDWFZP4JQG4AIAZhrqwvN88h,SpATywNh6bZuzm8s1ceuBUnMUAeoAHHw,3,2,1,0,0,1,2,0,6,0.8571428571428571,1,0.0,0,1,0,0,2,1,0,2,0,1,5,1
7869,184071,BpUC3MNCHd8FaxSe6moajPD8WZk6dYxr,SpATywNh6bZuzm8s1ceuBUnMUAeoAHHw,8,7,3,0,1,0,5,0,16,2.2857142857142856,2,0.0,1,3,0,1,6,0,0,5,0,5,11,1
7870,184075,ZGG633YrnGbNzVczhlK5S0rasrudTzhc,bWdj2GDclj5ofokWjzoa5jAwMkxCykd6,5,2,1,0,1,0,2,0,6,0.8571428571428571,1,0.0,0,1,0,1,2,0,0,2,0,2,4,1
7871,184076,1WYr5BJIApYgFHMSnNu25YjtJhDOUsgy,SpATywNh6bZuzm8s1ceuBUnMUAeoAHHw,6,3,2,0,2,0,1,0,8,1.1428571428571428,1,0.0,0,2,0,2,3,0,0,1,0,4,4,1
7872,184079,CbIcKD0jazBhPd3ibnu0zTtemqpWb0KP,bWdj2GDclj5ofokWjzoa5jAwMkxCykd6,2,0,0,0,0,0,4,0,4,0.5714285714285714,1,0.0,0,0,0,0,0,0,0,4,0,0,4,1
7873,184083,1KWQQsGdbVWUkaTLPILtfeXnjhFZjqBM,G8EPVSXsOYB5YQWZGiz1aVq5Pgr2GrQu,9,17,5,10,0,0,1,0,33,4.714285714285714,1,0.0,11,5,7,0,6,0,3,1,0,23,10,1
7874,184088,NslicJCNMxB9cZhzoMFtRxmqPnqyw5Ii,bWdj2GDclj5ofokWjzoa5jAwMkxCykd6,2,0,0,0,0,0,2,0,2,0.2857142857142857,1,0.0,0,0,0,0,0,0,0,2,0,0,2,1
7875,184089,OcFLLEI56U80V98vNeJ7LrlE5FWxkkpp,G8EPVSXsOYB5YQWZGiz1aVq5Pgr2GrQu,3,0,0,0,0,0,3,0,3,0.42857142857142855,1,0.0,0,0,0,0,0,0,0,3,0,0,3,1
7876,184094,CJe4pjtrcC0FOMy3krEkccqFJZO0Cqq4,bWdj2GDclj5ofokWjzoa5jAwMkxCykd6,1,0,0,0,0,0,1,0,1,0.14285714285714285,1,0.0,0,0,0,0,0,0,0,1,0,0,1,1
7877,184095,P3USQ4ceul2wiH8GV6NzM8M3iSKwMNo4,SpATywNh6bZuzm8s1ceuBUnMUAeoAHHw,5,4,0,0,0,0,3,0,7,1.0,1,0.0,0,0,0,0,4,0,0,3,0,0,7,1
7878,184098,z6xFpyaGUcaO2LWirVvA3M3GqpWgJhqS,SpATywNh6bZuzm8s1ceuBUnMUAeoAHHw,1,0,0,0,0,0,1,0,1,0.14285714285714285,1,0.0,0,0,0,0,0,0,0,1,0,0,1,1
7879,184101,PgqyyO7ndxsbTeXX946lNioQkjXip4tO,SpATywNh6bZuzm8s1ceuBUnMUAeoAHHw,16,16,5,3,4,2,5,1,36,5.142857142857143,1,0.0,4,5,3,4,12,2,0,5,1,16,20,1
7880,184107,qZ6pNkd000rAjy9LHfRpNpwESWSmgGUc,bWdj2GDclj5ofokWjzoa5jAwMkxCykd6,5,1,1,0,1,0,2,0,5,0.7142857142857143,1,0.0,0,1,0,1,1,0,0,2,0,2,3,1
7881,184110,CDBOTUK7uywn5HAqBz0EsxjWXDFENYqJ,SpATywNh6bZuzm8s1ceuBUnMUAeoAHHw,7,5,3,0,2,2,4,1,17,2.4285714285714284,1,0.0,0,3,0,2,5,2,0,4,1,5,12,1
7882,184113,87SYGQjFYUtEWda0pG12bcNker0JGBy3,G8EPVSXsOYB5YQWZGiz1aVq5Pgr2GrQu,4,5,0,0,0,0,1,0,6,0.8571428571428571,1,0.0,0,0,0,0,5,0,0,1,0,0,6,1
7883,184118,s26PJmkfPL2SwqWbKoi56ybE6GBIg4Tm,SpATywNh6bZuzm8s1ceuBUnMUAeoAHHw,7,2,0,0,0,1,7,1,11,1.5714285714285714,1,0.0,0,0,0,0,2,1,0,7,1,0,11,1
7884,184122,uUI9pQoArlf6QZxuJL0Anm2VUW5XAEuG,SpATywNh6bZuzm8s1ceuBUnMUAeoAHHw,6,2,1,0,1,0,3,0,7,1.0,1,0.0,0,1,0,1,2,0,0,3,0,2,5,1
7885,184126,6MUx7O8xcYuB5a5sYqWaf93meZNmeUNV,SpATywNh6bZuzm8s1ceuBUnMUAeoAHHw,1,0,0,0,0,0,1,0,1,0.14285714285714285,1,0.0,0,0,0,0,0,0,0,1,0,0,1,1
7886,184133,4YlVfpMODnahyqQ3n65BCTHXZpXYZLKw,G8EPVSXsOYB5YQWZGiz1aVq5Pgr2GrQu,6,5,1,0,0,0,4,0,10,1.4285714285714286,1,0.0,0,1,0,0,5,0,0,4,0,1,9,1
7887,184142,drGvqw10fBGceNSK8gYikgxOQZE0vxto,SpATywNh6bZuzm8s1ceuBUnMUAeoAHHw,7,6,4,0,3,0,1,0,14,2.0,1,0.0,0,4,0,3,6,0,0,1,0,7,7,1
7888,184150,Ywa3CoCRvYFskTMBH1zQHBLyzuQWtUYW,RXDvfPUBYFlVdlueBFbLW0mhhAyGEqpt,1,0,0,0,0,0,1,0,1,0.14285714285714285,1,0.0,0,0,0,0,0,0,0,1,0,0,1,1
7889,184153,Pb9hmoXos06ovaJ97f9maK0LR5EwPgFN,SpATywNh6bZuzm8s1ceuBUnMUAeoAHHw,1,0,0,0,0,0,1,0,1,0.14285714285714285,1,0.0,0,0,0,0,0,0,0,1,0,0,1,1
7890,184154,4DUZBFD9Fwl71r8i0SB6pVZCzmNoxKnn,RXDvfPUBYFlVdlueBFbLW0mhhAyGEqpt,4,2,1,0,1,0,1,0,5,0.7142857142857143,1,0.0,0,1,0,1,2,0,0,1,0,2,3,1
7891,184156,4DUZBFD9Fwl71r8i0SB6pVZCzmNoxKnn,bWdj2GDclj5ofokWjzoa5jAwMkxCykd6,6,3,2,0,2,0,1,0,8,1.1428571428571428,1,0.0,0,2,0,2,3,0,0,1,0,4,4,1
7892,184160,h58kvDL22TD1HjsSMB6VxjCw9rBsMnsj,SpATywNh6bZuzm8s1ceuBUnMUAeoAHHw,15,18,9,6,5,4,4,0,46,6.571428571428571,2,0.0,7,9,6,5,11,4,0,4,0,27,19,1
7893,184165,oQLN4c1EqhMjc5I7s4sQvYxTs3qNNEKF,SpATywNh6bZuzm8s1ceuBUnMUAeoAHHw,1,0,0,0,0,0,1,0,1,0.14285714285714285,1,0.0,0,0,0,0,0,0,0,1,0,0,1,1
7894,184169,CalIeuRUuDsI51PX7a2T0B5AXb9dl64K,SpATywNh6bZuzm8s1ceuBUnMUAeoAHHw,1,0,0,0,0,0,1,0,1,0.14285714285714285,1,0.0,0,0,0,0,0,0,0,1,0,0,1,1
7895,184170,zx92A3etlZOmjWi19IMDYlwaWCkvF08z,bWdj2GDclj5ofokWjzoa5jAwMkxCykd6,3,2,0,0,0,0,2,0,4,0.5714285714285714,1,0.0,0,0,0,0,2,0,0,2,0,0,4,0
7896,184180,w0NgQbkpBdIfJsaBSOoX4c1UgwA7dN8N,RXDvfPUBYFlVdlueBFbLW0mhhAyGEqpt,11,5,5,0,4,1,4,2,21,3.0,1,0.0,0,5,0,4,5,1,0,4,2,9,12,1
7897,184182,7EvTIqysZmn3AonROhXlIbdOubKSMiWg,G8EPVSXsOYB5YQWZGiz1aVq5Pgr2GrQu,5,2,1,0,1,0,2,0,6,0.8571428571428571,1,0.0,0,1,0,1,2,0,0,2,0,2,4,1
7898,184183,i39wrwOFUT4cBFVx9tMMQ3lQ2qJwZK9W,bWdj2GDclj5ofokWjzoa5jAwMkxCykd6,11,9,4,38,2,2,4,1,60,8.571428571428571,1,0.0,1,4,35,2,8,2,3,4,1,42,18,1
7899,184189,wTZQy1XFMokTUfJmtWSLn3pA2hHc02jP,G8EPVSXsOYB5YQWZGiz1aVq5Pgr2GrQu,13,13,7,0,1,0,15,1,37,5.285714285714286,1,0.0,0,7,0,1,13,0,0,15,1,8,29,1
7900,184192,t5YYcIeNMVb3RFW5w6rNVr5dnA806rKL,SpATywNh6bZuzm8s1ceuBUnMUAeoAHHw,7,4,3,0,3,8,3,0,21,3.0,1,0.0,0,3,0,3,4,8,0,3,0,6,15,1
7901,184195,pumsIIBvkIDHPLuElv7OSuQxwiyrjr12,bWdj2GDclj5ofokWjzoa5jAwMkxCykd6,4,4,1,0,1,0,1,0,7,1.0,1,0.0,1,1,0,1,3,0,0,1,0,3,4,1
7902,184201,AFZF0g5bqQh2xcoSPcZTvnmo1YmyGZbs,bWdj2GDclj5ofokWjzoa5jAwMkxCykd6,6,5,2,0,2,0,3,0,12,1.7142857142857142,2,0.0,0,2,0,2,5,0,0,3,0,4,8,1
7903,184202,XAN5G2SZeU8Zht7MvC5iqTKg1rYC9VmO,G8EPVSXsOYB5YQWZGiz1aVq5Pgr2GrQu,5,7,0,2,1,0,2,0,12,1.7142857142857142,1,0.0,5,0,1,1,2,0,1,2,0,7,5,1
7904,184203,cCvHnoX6St5OTmXQ2AOInGyMnqlmS6DL,bWdj2GDclj5ofokWjzoa5jAwMkxCykd6,5,2,1,0,1,0,4,0,8,1.1428571428571428,1,0.0,0,1,0,1,2,0,0,4,0,2,6,1
7905,184207,CR6hbwvXPZHEYYcI4AAX4civM4Pp6Aex,SpATywNh6bZuzm8s1ceuBUnMUAeoAHHw,5,2,1,0,1,0,2,0,6,0.8571428571428571,1,0.0,0,1,0,1,2,0,0,2,0,2,4,1
7906,184209,H3w465L7hDzZfQglT7xQ9IAtKqV2E37U,bWdj2GDclj5ofokWjzoa5jAwMkxCykd6,1,0,0,0,0,0,1,0,1,0.14285714285714285,1,0.0,0,0,0,0,0,0,0,1,0,0,1,1
7907,185697,sZk8u46TtWwCnXAO1CfZDLpjuO4MvayN,SpATywNh6bZuzm8s1ceuBUnMUAeoAHHw,1,0,0,0,0,0,1,0,1,0.14285714285714285,1,0.0,0,0,0,0,0,0,0,1,0,0,1,1
7908,185699,iHtSvehLiNBG0wCDW2WxQ7UVFKpHQkCr,G8EPVSXsOYB5YQWZGiz1aVq5Pgr2GrQu,5,2,0,0,1,0,2,0,5,0.7142857142857143,1,0.0,0,0,0,1,2,0,0,2,0,1,4,1
7909,185701,V02ryEmMmqjGIIiLHIkYu0vvVMLeyKKP,SpATywNh6bZuzm8s1ceuBUnMUAeoAHHw,4,2,0,0,0,0,2,0,4,0.5714285714285714,1,0.0,0,0,0,0,2,0,0,2,0,0,4,1
7910,185711,uhhlffPGiUyqHwKWs4eYUM0KXbbqijwF,bWdj2GDclj5ofokWjzoa5jAwMkxCykd6,5,2,1,0,1,0,3,0,7,1.0,1,0.0,0,1,0,1,2,0,0,3,0,2,5,1
7911,185712,cqvPqhuUpY41CAAgpjP0jUqubyRnUma9,A3fsA9Zfv1X2fVEQhTw51lKENdNrEqT3,12,10,0,10,0,0,4,0,24,3.4285714285714284,1,0.0,0,0,9,0,10,0,1,4,0,9,15,1
7912,185717,xMPYVkKLJasLVs71q8GhDTIiypmAhLbm,bWdj2GDclj5ofokWjzoa5jAwMkxCykd6,4,2,0,0,0,0,2,0,4,0.5714285714285714,1,0.0,0,0,0,0,2,0,0,2,0,0,4,1
7913,185719,DedOVhQ90meYxq6Misau3AEJ23SFBM8N,SpATywNh6bZuzm8s1ceuBUnMUAeoAHHw,3,0,0,0,0,0,3,1,4,0.5714285714285714,1,0.0,0,0,0,0,0,0,0,3,1,0,4,1
7914,185720,pnqwjatzPNd5f8exo5KMAGnQXVJnxQke,bWdj2GDclj5ofokWjzoa5jAwMkxCykd6,1,0,0,0,0,0,1,0,1,0.14285714285714285,1,0.0,0,0,0,0,0,0,0,1,0,0,1,1
7915,185721,9SQvvdARLUcjeNs1HN0rEVcQQDFBRIFU,SpATywNh6bZuzm8s1ceuBUnMUAeoAHHw,13,20,8,22,5,0,6,0,61,8.714285714285714,4,0.0,4,8,18,5,16,0,4,6,0,35,26,0
7916,185735,IO3o6QwloFvMHM9ifw0qIeLDZXWrcK99,G8EPVSXsOYB5YQWZGiz1aVq5Pgr2GrQu,11,25,7,2,4,0,6,0,44,6.285714285714286,1,0.0,7,7,2,4,18,0,0,6,0,20,24,1
7917,185740,alnogGpZqhBWQHh6ZLeZUIXk896ksLOu,A3fsA9Zfv1X2fVEQhTw51lKENdNrEqT3,8,13,1,0,0,0,8,2,24,3.4285714285714284,1,0.0,0,1,0,0,13,0,0,8,2,1,23,1
7918,185749,4iA1ycKJBUtgZZkZgkIUFUIpxxqEAlGx,bWdj2GDclj5ofokWjzoa5jAwMkxCykd6,2,0,0,0,0,0,2,0,2,0.2857142857142857,1,0.0,0,0,0,0,0,0,0,2,0,0,2,1
7919,185751,MbewcgzgToNhp9B6eaNSolme5R0M2nkY,SpATywNh6bZuzm8s1ceuBUnMUAeoAHHw,13,17,1,10,0,0,4,0,32,4.571428571428571,1,0.0,5,1,9,0,12,0,1,4,0,15,17,1
7920,185762,wi94HT3Va3Hif8CpMS1WVbL5a71j9CMb,A3fsA9Zfv1X2fVEQhTw51lKENdNrEqT3,23,3,2,84,0,0,4,0,93,13.285714285714286,1,0.0,1,2,65,0,2,0,19,4,0,68,25,1
7921,185773,VDLlgOqW7FFpT6uHqFXXlnnZR1JOz0x8,SpATywNh6bZuzm8s1ceuBUnMUAeoAHHw,2,0,0,0,0,0,2,0,2,0.2857142857142857,1,0.0,0,0,0,0,0,0,0,2,0,0,2,1
7922,185778,oIHEiOwjcaMd5CeWZdkq4rXU3yelDWwT,A3fsA9Zfv1X2fVEQhTw51lKENdNrEqT3,40,25,13,50,11,0,10,0,109,15.571428571428571,1,0.0,1,13,50,11,24,0,0,10,0,75,34,1
7923,185781,b247UYxQmorWoByqHaWMP4yZ1NRODrQz,SpATywNh6bZuzm8s1ceuBUnMUAeoAHHw,8,4,0,0,0,0,6,1,11,1.5714285714285714,1,0.0,0,0,0,0,4,0,0,6,1,0,11,1
7924,185783,XLVBkGRL2w5Wpk8oB8gzWVUvCGz9Rhlw,SpATywNh6bZuzm8s1ceuBUnMUAeoAHHw,1,0,0,0,0,0,1,0,1,0.14285714285714285,1,0.0,0,0,0,0,0,0,0,1,0,0,1,1
7925,185788,ggqCYexsMA3gqHfUfLE6gTs4JZ2aYAma,G8EPVSXsOYB5YQWZGiz1aVq5Pgr2GrQu,5,2,1,0,1,2,2,0,8,1.1428571428571428,1,0.0,0,1,0,1,2,2,0,2,0,2,6,1
7926,185789,KsZJWOsbWvg6N1GJmMWPndE2481JZ5k3,A3fsA9Zfv1X2fVEQhTw51lKENdNrEqT3,12,9,3,0,2,1,8,0,23,3.2857142857142856,1,0.0,0,3,0,2,9,1,0,8,0,5,18,1
7927,185799,5vZRuON34JUuUxkGF08Mu94iTiQzZas4,A3fsA9Zfv1X2fVEQhTw51lKENdNrEqT3,14,11,7,0,4,0,5,0,27,3.857142857142857,2,0.0,0,7,0,4,11,0,0,5,0,11,16,1
7928,185800,UiNc6Olm5OJvjLtbHiGutXVBHbKcOCGc,G8EPVSXsOYB5YQWZGiz1aVq5Pgr2GrQu,9,5,2,0,2,0,4,1,14,2.0,1,0.0,0,2,0,2,5,0,0,4,1,4,10,1
7929,185802,OuF01YeNHtVi6Jk1MFlWzs0i66xxscb1,bWdj2GDclj5ofokWjzoa5jAwMkxCykd6,4,2,0,0,0,0,3,0,5,0.7142857142857143,1,0.0,0,0,0,0,2,0,0,3,0,0,5,1
7930,185803,p54dVByd9epbS397rAmrAwTW19iwa3UI,A3fsA9Zfv1X2fVEQhTw51lKENdNrEqT3,2,0,0,0,0,0,2,0,2,0.2857142857142857,2,0.0,0,0,0,0,0,0,0,2,0,0,2,1
7931,185805,ggqCYexsMA3gqHfUfLE6gTs4JZ2aYAma,A3fsA9Zfv1X2fVEQhTw51lKENdNrEqT3,1,0,0,0,0,0,1,0,1,0.14285714285714285,1,0.0,0,0,0,0,0,0,0,1,0,0,1,1
7932,185808,ggqCYexsMA3gqHfUfLE6gTs4JZ2aYAma,RXDvfPUBYFlVdlueBFbLW0mhhAyGEqpt,1,0,0,0,0,0,1,0,1,0.14285714285714285,1,0.0,0,0,0,0,0,0,0,1,0,0,1,1
7933,185810,ggqCYexsMA3gqHfUfLE6gTs4JZ2aYAma,bWdj2GDclj5ofokWjzoa5jAwMkxCykd6,1,0,0,0,0,0,1,0,1,0.14285714285714285,1,0.0,0,0,0,0,0,0,0,1,0,0,1,1
7934,185816,lMDmp2qNyRczEhhMTcMnsuhXMIgG5u4z,SpATywNh6bZuzm8s1ceuBUnMUAeoAHHw,8,5,2,0,2,0,4,0,13,1.8571428571428572,1,0.0,0,2,0,2,5,0,0,4,0,4,9,1
7935,185822,xr2T8ak6swOOfU9oanYvPbQ4STab9s9f,A3fsA9Zfv1X2fVEQhTw51lKENdNrEqT3,16,16,1,0,1,0,7,0,25,3.5714285714285716,2,0.0,0,1,0,1,16,0,0,7,0,2,23,1
7936,185827,BiROhpVKZVE8DbOW78DzcMxwLwnrk2vP,SpATywNh6bZuzm8s1ceuBUnMUAeoAHHw,4,2,0,0,0,0,2,0,4,0.5714285714285714,1,0.0,0,0,0,0,2,0,0,2,0,0,4,1
7937,185865,KqT70GlMbxQHBXiXc69IrkuqKmM7JyJa,A3fsA9Zfv1X2fVEQhTw51lKENdNrEqT3,1,0,0,0,0,0,1,0,1,0.14285714285714285,1,0.0,0,0,0,0,0,0,0,1,0,0,1,1
7938,185873,fjIKsKO6rizBomnPFn2db56S1nui3RlN,RXDvfPUBYFlVdlueBFbLW0mhhAyGEqpt,10,7,5,0,3,4,5,0,24,3.4285714285714284,1,0.0,1,5,0,3,6,4,0,5,0,9,15,1
7939,185875,a7oEKWybXixFIxItLioFkgXev62XcPSx,SpATywNh6bZuzm8s1ceuBUnMUAeoAHHw,7,3,2,0,2,0,2,0,9,1.2857142857142858,1,0.0,0,2,0,2,3,0,0,2,0,4,5,1
7940,185876,BCr2GOpOyeEKOuzlRV7PJCL1CEnRyr6Q,bWdj2GDclj5ofokWjzoa5jAwMkxCykd6,1,0,0,0,0,0,1,0,1,0.14285714285714285,1,0.0,0,0,0,0,0,0,0,1,0,0,1,1
7941,185888,GHTsld2FtHJjs2ejBig6RPBMNqBTieZV,G8EPVSXsOYB5YQWZGiz1aVq5Pgr2GrQu,1,0,0,0,0,0,1,0,1,0.14285714285714285,1,0.0,0,0,0,0,0,0,0,1,0,0,1,1
7942,185899,HXRY1mkagv1TklYNb6z2U5DQSLEv5d2U,bWdj2GDclj5ofokWjzoa5jAwMkxCykd6,3,2,0,0,0,0,2,0,4,0.5714285714285714,1,0.0,0,0,0,0,2,0,0,2,0,0,4,1
7943,185912,l6rkobnqEUKXFQnaBVgonlwU5l25TkcG,SpATywNh6bZuzm8s1ceuBUnMUAeoAHHw,7,4,3,0,3,0,3,0,13,1.8571428571428572,1,0.0,0,3,0,3,4,0,0,3,0,6,7,1
7944,185917,qU5mfkjhD9M0R49RmBMaCeXLeTqIOyhm,bWdj2GDclj5ofokWjzoa5jAwMkxCykd6,7,8,1,0,0,1,7,2,19,2.7142857142857144,1,0.0,0,1,0,0,8,1,0,7,2,1,18,1
7945,185926,BFrfDseDfXCBvtTfCsJAy36Ogk6b0Rfx,bWdj2GDclj5ofokWjzoa5jAwMkxCykd6,6,5,2,0,2,0,1,0,10,1.4285714285714286,1,0.0,0,2,0,2,5,0,0,1,0,4,6,1
7946,185934,YisM8PtG7Ux1VoDWsMxvoOKtYDxnQIkB,SpATywNh6bZuzm8s1ceuBUnMUAeoAHHw,6,4,1,0,0,0,2,0,7,1.0,1,0.0,0,1,0,0,4,0,0,2,0,1,6,0
7947,185935,g3k1QLHPwEzAuA17RgcYJkFPtaOb0o3B,SpATywNh6bZuzm8s1ceuBUnMUAeoAHHw,6,3,1,0,1,0,2,0,7,1.0,1,0.0,0,1,0,1,3,0,0,2,0,2,5,1
7948,185940,JpOYg97nyPxwnn3z2vFN1FK1LYz5DhTY,A3fsA9Zfv1X2fVEQhTw51lKENdNrEqT3,6,2,1,0,1,0,3,0,7,1.0,1,0.0,0,1,0,1,2,0,0,3,0,2,5,1
7949,185947,ztsQNM9uMd9SZEOM5x5YQ0KVKbbr5L7g,SpATywNh6bZuzm8s1ceuBUnMUAeoAHHw,5,2,1,0,1,0,2,0,6,0.8571428571428571,1,0.0,0,1,0,1,2,0,0,2,0,2,4,1
7950,185967,pyMEb6x72KY9mgbYMOoJOte9pQweaRy0,A3fsA9Zfv1X2fVEQhTw51lKENdNrEqT3,4,2,0,0,0,0,2,0,4,0.5714285714285714,1,0.0,0,0,0,0,2,0,0,2,0,0,4,1
7951,185977,q3IBH9ErSFzy7COPLzEQoKQuyHgNCnZt,SpATywNh6bZuzm8s1ceuBUnMUAeoAHHw,4,2,1,0,1,0,2,0,6,0.8571428571428571,1,0.0,0,1,0,1,2,0,0,2,0,2,4,1
7952,185981,9GkiQywusvhD7mWAdJSKQKuF3YnhYHyY,SpATywNh6bZuzm8s1ceuBUnMUAeoAHHw,4,4,0,0,0,0,3,0,7,1.0,1,0.0,0,0,0,0,4,0,0,3,0,0,7,1
7953,185989,HHr7pweQNhEg4xRoOlqDUkqUpKwnfVTC,bWdj2GDclj5ofokWjzoa5jAwMkxCykd6,4,2,1,0,1,0,1,0,5,0.7142857142857143,1,0.0,0,1,0,1,2,0,0,1,0,2,3,1
7954,185993,4lIBX7jVNURqeuVw7y54KWNhg5lYseZ6,A3fsA9Zfv1X2fVEQhTw51lKENdNrEqT3,16,15,10,0,0,6,9,0,40,5.714285714285714,1,0.0,0,10,0,0,15,6,0,9,0,10,30,1
7955,185996,rqLYGFT8OdZ1rVwTL6aA81jhg4BwFBcq,SpATywNh6bZuzm8s1ceuBUnMUAeoAHHw,8,15,9,0,6,7,4,0,41,5.857142857142857,2,0.0,0,9,0,6,15,7,0,4,0,15,26,1
7956,186008,OQ7W8hYEVefBsrV36TMIjyhMvo7kqJ6U,bWdj2GDclj5ofokWjzoa5jAwMkxCykd6,1,0,0,0,0,0,1,0,1,0.14285714285714285,1,0.0,0,0,0,0,0,0,0,1,0,0,1,1
7957,186010,pwdsR2guw7jGBDVAdaksGODr7uJoy6bJ,A3fsA9Zfv1X2fVEQhTw51lKENdNrEqT3,13,5,4,0,4,21,8,1,43,6.142857142857143,1,0.0,0,4,0,4,5,21,0,8,1,8,35,1
7958,186017,3kmVKNRbGOm4fMFsW3dgnHkHEGKHE1G0,SpATywNh6bZuzm8s1ceuBUnMUAeoAHHw,1,0,0,0,0,0,1,0,1,0.14285714285714285,1,0.0,0,0,0,0,0,0,0,1,0,0,1,1
7959,186024,mshtCxMsmXSptJoESXKNMH3UVCFV33v0,bWdj2GDclj5ofokWjzoa5jAwMkxCykd6,7,6,2,0,1,0,5,0,14,2.0,1,0.0,0,2,0,1,6,0,0,5,0,3,11,1
7960,186027,eGRaiLXqwboqQlaTTQYr1FB1cM61jV4I,bWdj2GDclj5ofokWjzoa5jAwMkxCykd6,16,38,8,80,5,0,10,0,141,20.142857142857142,3,0.0,9,8,73,5,29,0,7,10,0,95,46,0
7961,186030,WgIzAwP7DckFZQVcLeYgUBCqWImeGyjc,bWdj2GDclj5ofokWjzoa5jAwMkxCykd6,1,0,0,0,0,0,1,0,1,0.14285714285714285,1,0.0,0,0,0,0,0,0,0,1,0,0,1,1
7962,186033,oBeAGLSBA1xupWifcihdC6keBG4wuecB,SpATywNh6bZuzm8s1ceuBUnMUAeoAHHw,12,14,6,0,4,0,5,5,34,4.857142857142857,1,0.0,6,6,0,4,8,0,0,5,5,16,18,1
7963,186034,VKd5p4d9iO6xk39JhIOj5DwKdihmd0lg,SpATywNh6bZuzm8s1ceuBUnMUAeoAHHw,1,0,0,0,0,0,2,0,2,0.2857142857142857,1,0.0,0,0,0,0,0,0,0,2,0,0,2,1
7964,186053,pwdsR2guw7jGBDVAdaksGODr7uJoy6bJ,G8EPVSXsOYB5YQWZGiz1aVq5Pgr2GrQu,1,0,0,0,0,0,1,0,1,0.14285714285714285,1,0.0,0,0,0,0,0,0,0,1,0,0,1,1
7965,186054,pwdsR2guw7jGBDVAdaksGODr7uJoy6bJ,RXDvfPUBYFlVdlueBFbLW0mhhAyGEqpt,1,0,0,0,0,0,1,0,1,0.14285714285714285,1,0.0,0,0,0,0,0,0,0,1,0,0,1,1
7966,186069,1Qo7KMYcvZsuiBzdvEuPj5kKA7qUbqJV,bWdj2GDclj5ofokWjzoa5jAwMkxCykd6,1,0,0,0,0,0,1,0,1,0.14285714285714285,1,0.0,0,0,0,0,0,0,0,1,0,0,1,1
7967,186070,TCINPpi4BOwqMGx315JhuBgHLWH5YLIC,SpATywNh6bZuzm8s1ceuBUnMUAeoAHHw,11,11,5,0,4,0,3,0,23,3.2857142857142856,1,0.0,0,5,0,4,11,0,0,3,0,9,14,1
7968,186080,k1v3XdotdB8LdO3icpee6tW4PUfHmiil,SpATywNh6bZuzm8s1ceuBUnMUAeoAHHw,1,0,0,0,0,0,1,0,1,0.14285714285714285,1,0.0,0,0,0,0,0,0,0,1,0,0,1,1
7969,186090,RKevUFoWjA4gBXEFiCKb5AP4PJvgxsMD,SpATywNh6bZuzm8s1ceuBUnMUAeoAHHw,7,21,4,0,0,1,2,2,30,4.285714285714286,1,0.0,15,4,0,0,6,1,0,2,2,19,11,1
7970,186093,4RiemE5r88jWq9gaL0lVYzjeUhWq3sNP,bWdj2GDclj5ofokWjzoa5jAwMkxCykd6,5,2,1,0,1,0,2,0,6,0.8571428571428571,1,0.0,0,1,0,1,2,0,0,2,0,2,4,1
7971,186105,H7QRgEunakiQpSkvgA6e0kPLJYMsizvQ,RXDvfPUBYFlVdlueBFbLW0mhhAyGEqpt,20,12,6,20,5,1,4,2,50,7.142857142857143,1,0.0,4,6,17,5,8,1,3,4,2,32,18,1
7972,186108,movFtkKyZ7KF2alge61BByZFH1juXwvn,G8EPVSXsOYB5YQWZGiz1aVq5Pgr2GrQu,6,20,5,0,5,0,3,0,33,4.714285714285714,1,0.0,6,5,0,5,14,0,0,3,0,16,17,0
7973,186126,v7J9oMmutdLnNr3JZvwlkpjW9LXfiVjj,bWdj2GDclj5ofokWjzoa5jAwMkxCykd6,1,0,0,0,0,0,3,0,3,0.42857142857142855,1,0.0,0,0,0,0,0,0,0,3,0,0,3,1
7974,186149,3RleWWZim0t3JTvkySadKrLWZcHXfb0j,SpATywNh6bZuzm8s1ceuBUnMUAeoAHHw,5,2,1,0,1,1,2,0,7,1.0,1,0.0,0,1,0,1,2,1,0,2,0,2,5,1
7975,186152,U7gTTHbgIV4F5dvLWAHaZprd34m8Q6vZ,A3fsA9Zfv1X2fVEQhTw51lKENdNrEqT3,2,0,0,0,0,0,3,0,3,0.42857142857142855,1,0.0,0,0,0,0,0,0,0,3,0,0,3,1
7976,186160,76AvlH3YIWFXw8S2TlpvkGfhwLRoEd9v,G8EPVSXsOYB5YQWZGiz1aVq5Pgr2GrQu,1,0,0,0,0,0,1,0,1,0.14285714285714285,1,0.0,0,0,0,0,0,0,0,1,0,0,1,1
7977,186167,vmgNze76nhe4Mg9lRleNqfB4tioADZEi,SpATywNh6bZuzm8s1ceuBUnMUAeoAHHw,5,2,1,0,1,0,2,0,6,0.8571428571428571,1,0.0,0,1,0,1,2,0,0,2,0,2,4,1
7978,186172,eC7mMb2gTYoACNwQi5SJ70EXu79ikkpz,G8EPVSXsOYB5YQWZGiz1aVq5Pgr2GrQu,6,4,2,0,1,0,4,0,11,1.5714285714285714,1,0.0,0,2,0,1,4,0,0,4,0,3,8,0
7979,186188,7I0I1azNl6RTMt3ii9CU0GnkhQk3GlzK,bWdj2GDclj5ofokWjzoa5jAwMkxCykd6,4,2,1,0,1,0,1,0,5,0.7142857142857143,1,0.0,0,1,0,1,2,0,0,1,0,2,3,1
7980,186217,joApt9vAdh8Ppf8VaTUE5PED1Gnaa6Cg,SpATywNh6bZuzm8s1ceuBUnMUAeoAHHw,9,6,3,0,1,0,6,0,16,2.2857142857142856,2,0.0,2,3,0,1,4,0,0,6,0,6,10,1
7981,186219,9hgjLw4OD5u1XjZx0s9EMRnEguVXBlYy,bWdj2GDclj5ofokWjzoa5jAwMkxCykd6,5,3,2,0,1,0,1,0,7,1.0,1,0.0,0,2,0,1,3,0,0,1,0,3,4,1
7982,186226,NJMgv4F05c0UQYudEdfqMGLsHyyDDfGS,bWdj2GDclj5ofokWjzoa5jAwMkxCykd6,1,0,0,0,0,0,1,0,1,0.14285714285714285,1,0.0,0,0,0,0,0,0,0,1,0,0,1,1
7983,186239,6LXzBe3NOudMerEzgOt0MkAbIrREFpjB,SpATywNh6bZuzm8s1ceuBUnMUAeoAHHw,6,2,1,0,1,0,8,0,12,1.7142857142857142,1,0.0,0,1,0,1,2,0,0,8,0,2,10,1
7984,186260,CYN3tl2d8PV3r7FRKTn3DmaQTLhkh777,bWdj2GDclj5ofokWjzoa5jAwMkxCykd6,4,4,0,0,0,0,4,0,8,1.1428571428571428,1,0.0,0,0,0,0,4,0,0,4,0,0,8,1
7985,186262,qtck8S6SMYpkxbIZosuQoFSB26vuEbBy,SpATywNh6bZuzm8s1ceuBUnMUAeoAHHw,12,13,6,0,2,2,6,1,30,4.285714285714286,1,0.0,5,6,0,2,8,2,0,6,1,13,17,1
7986,186265,O54CNBN3NKMMQYcBy9CQbkmesf27d5tK,bWdj2GDclj5ofokWjzoa5jAwMkxCykd6,8,7,3,0,4,0,1,0,15,2.142857142857143,1,0.0,3,3,0,4,4,0,0,1,0,10,5,1
7987,186274,UjdXV2LbbZ78dbdYSbQt8OX1VfVSyWoG,RXDvfPUBYFlVdlueBFbLW0mhhAyGEqpt,1,0,0,0,0,0,1,0,1,0.14285714285714285,1,0.0,0,0,0,0,0,0,0,1,0,0,1,1
7988,186278,tRniyBbP3M0j7k24AHpOwHltcVZ3Mvlp,G8EPVSXsOYB5YQWZGiz1aVq5Pgr2GrQu,19,7,6,10,4,4,12,1,44,6.285714285714286,1,0.0,0,6,9,4,7,4,1,12,1,19,25,1
7989,186282,NbCrL52EtsGx8vVNfWSZpmpE4q33iGMd,bWdj2GDclj5ofokWjzoa5jAwMkxCykd6,1,0,0,0,0,0,1,0,1,0.14285714285714285,1,0.0,0,0,0,0,0,0,0,1,0,0,1,1
7990,186293,dN9FTYZkbDCdtR1BnEY22uyGdtBZPVhu,bWdj2GDclj5ofokWjzoa5jAwMkxCykd6,13,12,7,20,4,0,2,0,45,6.428571428571429,2,0.0,2,7,17,4,10,0,3,2,0,30,15,1
7991,186296,B72h1YINVnIBuQnVvUdewAz5RbHuw445,SpATywNh6bZuzm8s1ceuBUnMUAeoAHHw,7,10,1,0,0,0,5,0,16,2.2857142857142856,1,0.0,0,1,0,0,10,0,0,5,0,1,15,1
7992,186306,4i4PHyTAjN8h3LruWdRgGB0UcB2mKwQS,G8EPVSXsOYB5YQWZGiz1aVq5Pgr2GrQu,7,5,4,0,4,0,2,0,15,2.142857142857143,1,0.0,0,4,0,4,5,0,0,2,0,8,7,1
7993,186307,LDAJhM2EkTXhEhkZMewkMv22tm6tjZRZ,G8EPVSXsOYB5YQWZGiz1aVq5Pgr2GrQu,11,17,7,0,0,1,9,1,35,5.0,1,0.0,6,7,0,0,11,1,0,9,1,13,22,1
7994,186310,oiCPMPa63rog2k5BPZRkJCoJXfrcSy1e,SpATywNh6bZuzm8s1ceuBUnMUAeoAHHw,11,8,5,0,3,0,5,2,23,3.2857142857142856,1,0.0,1,5,0,3,7,0,0,5,2,9,14,1
7995,186315,8UDPY0GORYpQM3S1dtt5YkG0CDkJUfAi,G8EPVSXsOYB5YQWZGiz1aVq5Pgr2GrQu,1,0,0,0,0,0,1,0,1,0.14285714285714285,1,0.0,0,0,0,0,0,0,0,1,0,0,1,1
7996,186316,JKjbqPpgyVuFohWzcaEzU3vXeEuQMCY2,SpATywNh6bZuzm8s1ceuBUnMUAeoAHHw,6,6,2,0,1,0,3,0,12,1.7142857142857142,1,0.0,4,2,0,1,2,0,0,3,0,7,5,1
7997,186326,oXcCXnNaPGvzw5MpNzQ49lDnTqlhdcyO,RXDvfPUBYFlVdlueBFbLW0mhhAyGEqpt,6,4,3,0,2,0,2,0,11,1.5714285714285714,1,0.0,0,3,0,2,4,0,0,2,0,5,6,1
7998,186327,5YRs7upinP21LnBzrkpoBo8Kvhb3lSkQ,SpATywNh6bZuzm8s1ceuBUnMUAeoAHHw,9,14,9,0,7,0,9,0,39,5.571428571428571,1,0.0,2,9,0,7,12,0,0,9,0,18,21,1
7999,186343,hNSGUbGCRW7qjA1g49kHgu4SIBbwJo9q,SpATywNh6bZuzm8s1ceuBUnMUAeoAHHw,9,5,4,0,4,0,2,0,15,2.142857142857143,1,0.0,0,4,0,4,5,0,0,2,0,8,7,1
8000,186346,0tNPU3kkt3CooZ4NeVBPjpcYXq8dTU8q,SpATywNh6bZuzm8s1ceuBUnMUAeoAHHw,5,2,1,0,1,0,3,0,7,1.0,1,0.0,0,1,0,1,2,0,0,3,0,2,5,1
8001,186361,ia27UAQHt7F9XiRQIIX7AOZPA1Z4gISX,G8EPVSXsOYB5YQWZGiz1aVq5Pgr2GrQu,24,16,12,0,13,0,14,4,59,8.428571428571429,1,0.0,3,12,0,13,13,0,0,14,4,28,31,1
8002,186368,ihKJAzCpK1sJmaODICQLggyYKl8s1XF0,A3fsA9Zfv1X2fVEQhTw51lKENdNrEqT3,2,0,0,0,0,0,4,0,4,0.5714285714285714,1,0.0,0,0,0,0,0,0,0,4,0,0,4,1
8003,186369,trBO4BEJIC9uXexHjtiN83f66AEsM41a,RXDvfPUBYFlVdlueBFbLW0mhhAyGEqpt,7,3,2,0,2,0,2,0,9,1.2857142857142858,1,0.0,0,2,0,2,3,0,0,2,0,4,5,1
8004,186372,4lhCwJo7yYXKFlssNpVO8DZHuYKFBvLp,bWdj2GDclj5ofokWjzoa5jAwMkxCykd6,5,2,1,0,1,0,2,0,6,0.8571428571428571,1,0.0,0,1,0,1,2,0,0,2,0,2,4,1
8005,186376,61PsrnqGMh19xjWowe2Lz8ELqYCTUUqE,A3fsA9Zfv1X2fVEQhTw51lKENdNrEqT3,6,5,2,0,1,0,3,0,11,1.5714285714285714,1,0.0,0,2,0,1,5,0,0,3,0,3,8,1
8006,186385,TREm1kp17GnbcApEfZDyA7Kp4fSLmJio,SpATywNh6bZuzm8s1ceuBUnMUAeoAHHw,2,0,0,0,0,0,3,0,3,0.42857142857142855,1,0.0,0,0,0,0,0,0,0,3,0,0,3,1
8007,186390,AeCrxYByugIwu4XUBpI0LhoTguBozLAa,G8EPVSXsOYB5YQWZGiz1aVq5Pgr2GrQu,26,28,6,66,4,0,3,0,107,15.285714285714286,1,0.0,16,6,48,4,12,0,18,3,0,74,33,1
8008,186417,gLeI9VliEYF371soyxZF0epS12DLfvFA,SpATywNh6bZuzm8s1ceuBUnMUAeoAHHw,10,14,1,12,0,0,1,0,28,4.0,1,0.0,6,1,11,0,8,0,1,1,0,18,10,0
8009,186425,Vgv9Vbo4BqJtU7GBUbwfi1DvG0Q1nDxJ,A3fsA9Zfv1X2fVEQhTw51lKENdNrEqT3,6,3,2,0,1,0,2,0,8,1.1428571428571428,1,0.0,0,2,0,1,3,0,0,2,0,3,5,1
8010,186430,s5UknTeAXWW62hajP9UwOYzwqzInPkkx,SpATywNh6bZuzm8s1ceuBUnMUAeoAHHw,7,2,1,0,1,0,4,0,8,1.1428571428571428,1,0.0,0,1,0,1,2,0,0,4,0,2,6,1
8011,186455,ocTIjxG8zBs0mQRpUtpuAKc7MDpzU7Sd,A3fsA9Zfv1X2fVEQhTw51lKENdNrEqT3,7,4,2,0,1,32,10,0,49,7.0,3,0.0,0,2,0,1,4,32,0,10,0,3,46,0
8012,186465,qJgl58YR6SFE9WBZ5w9d3OO6sin62mbS,G8EPVSXsOYB5YQWZGiz1aVq5Pgr2GrQu,5,2,1,0,1,0,2,0,6,0.8571428571428571,1,0.0,0,1,0,1,2,0,0,2,0,2,4,1
8013,186482,xTif7TWTzpmMlOz25LEjdVnoxKR0Djir,bWdj2GDclj5ofokWjzoa5jAwMkxCykd6,1,0,0,0,0,0,1,0,1,0.14285714285714285,1,0.0,0,0,0,0,0,0,0,1,0,0,1,1
8014,186507,Ws3AQXJqw3VTjixWLsavB7mzhprdidTH,G8EPVSXsOYB5YQWZGiz1aVq5Pgr2GrQu,4,2,1,0,1,0,1,0,5,0.7142857142857143,1,0.0,0,1,0,1,2,0,0,1,0,2,3,1
8015,186513,bieYN909hTRWSvc3EaZDiQYQdygsSUNW,SpATywNh6bZuzm8s1ceuBUnMUAeoAHHw,7,6,3,0,3,0,3,0,15,2.142857142857143,1,0.0,0,3,0,3,6,0,0,3,0,6,9,1
8016,186514,bYD2u7vuN3G54awyDYPdRiZI3O4zw6kx,A3fsA9Zfv1X2fVEQhTw51lKENdNrEqT3,9,7,4,0,2,4,5,0,22,3.142857142857143,2,0.0,1,4,0,2,6,4,0,5,0,7,15,1
8017,186522,xe3aQO2zOncGcTg3GZj4Ju1vwkPuneGt,A3fsA9Zfv1X2fVEQhTw51lKENdNrEqT3,26,21,16,6,11,2,7,1,64,9.142857142857142,2,0.0,0,16,5,11,21,2,1,7,1,32,32,1
8018,186541,k9uZHzVbTw2SpPQ5TgMY9urRyaKHQ7D1,SpATywNh6bZuzm8s1ceuBUnMUAeoAHHw,11,10,0,3,0,0,5,0,18,2.5714285714285716,1,0.0,5,0,3,0,5,0,0,5,0,8,10,1
8019,186552,fiJeUe4rD7XOpUxN73ysB6UZAqbfZlmt,SpATywNh6bZuzm8s1ceuBUnMUAeoAHHw,8,2,2,0,2,0,3,0,9,1.2857142857142858,1,0.0,0,2,0,2,2,0,0,3,0,4,5,1
8020,186565,7ho1Tg0rPKs5S3R4MH5byApVMAoQWEXh,RXDvfPUBYFlVdlueBFbLW0mhhAyGEqpt,10,4,3,0,2,12,10,5,36,5.142857142857143,1,0.0,0,3,0,2,4,12,0,10,5,5,31,1
8021,186574,2hFnq94PJL4XDwPjj8ZoE3JMQah41FEA,SpATywNh6bZuzm8s1ceuBUnMUAeoAHHw,5,3,2,0,1,0,2,0,8,1.1428571428571428,2,0.0,0,2,0,1,3,0,0,2,0,3,5,1
8022,186576,dCkOxG7NzEIrFHNAIlnaKMlesPlFB6No,bWdj2GDclj5ofokWjzoa5jAwMkxCykd6,3,0,0,0,0,1,3,0,4,0.5714285714285714,1,0.0,0,0,0,0,0,1,0,3,0,0,4,1
8023,186587,rBTUDXHsyVAHRzecZ0JrUNZO0FdtzEgU,SpATywNh6bZuzm8s1ceuBUnMUAeoAHHw,12,13,0,11,1,0,3,0,28,4.0,1,0.0,4,0,10,1,9,0,1,3,0,15,13,1
8024,186595,QZIRHdwFgibI2SBehTrmLAZxED1F4JL7,bWdj2GDclj5ofokWjzoa5jAwMkxCykd6,3,3,0,0,0,0,2,0,5,0.7142857142857143,1,0.0,0,0,0,0,3,0,0,2,0,0,5,1
8025,186611,aZ82NGvfiihxQfhlR4uS7n77c1b4mi5Z,G8EPVSXsOYB5YQWZGiz1aVq5Pgr2GrQu,6,4,1,0,1,0,3,0,9,1.2857142857142858,1,0.0,0,1,0,1,4,0,0,3,0,2,7,1
8026,186626,0zEvDhRJYIh90RBOGZBHRBqiMwb7D8PK,SpATywNh6bZuzm8s1ceuBUnMUAeoAHHw,1,0,0,0,0,0,1,0,1,0.14285714285714285,1,0.0,0,0,0,0,0,0,0,1,0,0,1,1
8027,186632,65P7KaQODeqWFWqHnCldB0bW07lJUhzD,A3fsA9Zfv1X2fVEQhTw51lKENdNrEqT3,7,5,3,0,1,0,2,0,11,1.5714285714285714,1,0.0,0,3,0,1,5,0,0,2,0,4,7,1
8028,186643,GOc4kNORXKPP2dp4IaPI0qi7cdZjVMoK,bWdj2GDclj5ofokWjzoa5jAwMkxCykd6,1,0,0,0,0,0,1,0,1,0.14285714285714285,1,0.0,0,0,0,0,0,0,0,1,0,0,1,1
8029,186660,G6IoTlb3c3ZQL96Z5jLVHovz7cxEUWx5,SpATywNh6bZuzm8s1ceuBUnMUAeoAHHw,5,2,1,0,1,0,2,0,6,0.8571428571428571,1,0.0,0,1,0,1,2,0,0,2,0,2,4,1
8030,186668,Q3SCEqfg6AiZK4k6l6uETosmZAruIeRz,bWdj2GDclj5ofokWjzoa5jAwMkxCykd6,5,2,1,0,1,0,2,0,6,0.8571428571428571,1,0.0,0,1,0,1,2,0,0,2,0,2,4,1
8031,186671,fWFaAKdCQbV0w3S48FeXgmzcwLTDxziF,RXDvfPUBYFlVdlueBFbLW0mhhAyGEqpt,2,0,0,0,0,0,2,0,2,0.2857142857142857,1,0.0,0,0,0,0,0,0,0,2,0,0,2,1
8032,186690,C7zqVICfiC5LB2CDdZC77m5k2umUb3cp,SpATywNh6bZuzm8s1ceuBUnMUAeoAHHw,18,27,10,9,4,0,13,1,64,9.142857142857142,2,0.0,11,10,9,4,16,0,0,13,1,34,30,1
8033,186696,XWqfdH6YA4Zk74Kdlw1zAAjKNGLWzY2X,A3fsA9Zfv1X2fVEQhTw51lKENdNrEqT3,5,0,0,0,0,1,4,1,6,0.8571428571428571,1,0.0,0,0,0,0,0,1,0,4,1,0,6,1
8034,186698,cdSk14IbXqFAl31nStZhqBGbvhRNZQDG,A3fsA9Zfv1X2fVEQhTw51lKENdNrEqT3,2,0,0,0,0,0,2,0,2,0.2857142857142857,1,0.0,0,0,0,0,0,0,0,2,0,0,2,1
8035,186710,i8nr5dg8z4enS0u6hepa5rlWzI5t4l3G,SpATywNh6bZuzm8s1ceuBUnMUAeoAHHw,6,6,0,0,0,0,7,0,13,1.8571428571428572,2,0.0,0,0,0,0,6,0,0,7,0,0,13,1
8036,186711,VrzXB04D4NAWNSSnAJBQgbBcugtgsrsf,SpATywNh6bZuzm8s1ceuBUnMUAeoAHHw,5,2,1,0,1,0,3,0,7,1.0,1,0.0,0,1,0,1,2,0,0,3,0,2,5,1
8037,186716,yTPe4A1Cw5qKDjYpFW5H73VItf0UPFbm,A3fsA9Zfv1X2fVEQhTw51lKENdNrEqT3,4,2,1,0,1,0,1,0,5,0.7142857142857143,1,0.0,0,1,0,1,2,0,0,1,0,2,3,1
8038,186723,XO4yOVP7eCwBTi6pYIgtRmMh0ft7YdHb,A3fsA9Zfv1X2fVEQhTw51lKENdNrEqT3,9,12,1,0,1,0,4,0,18,2.5714285714285716,1,0.0,0,1,0,1,12,0,0,4,0,2,16,1
8039,186727,rwCHpAN1sY0GvFYG7zQQk2qpgkOBz9O3,A3fsA9Zfv1X2fVEQhTw51lKENdNrEqT3,1,0,0,0,0,0,1,0,1,0.14285714285714285,1,0.0,0,0,0,0,0,0,0,1,0,0,1,1
8040,186740,ctYjDizjossnFRGdONqI7hfhQiNCx3Il,SpATywNh6bZuzm8s1ceuBUnMUAeoAHHw,5,2,1,0,1,0,2,0,6,0.8571428571428571,1,0.0,0,1,0,1,2,0,0,2,0,2,4,1
8041,186744,5QmsfWrr8re1QceHmRAqqM6UDRZ5H0Jh,A3fsA9Zfv1X2fVEQhTw51lKENdNrEqT3,1,0,0,0,0,0,1,0,1,0.14285714285714285,1,0.0,0,0,0,0,0,0,0,1,0,0,1,1
8042,186749,sHd9Ol41vgPIb8hQT0QvUGTmi4Ucq4PU,A3fsA9Zfv1X2fVEQhTw51lKENdNrEqT3,7,5,1,0,1,0,2,1,10,1.4285714285714286,1,0.0,0,1,0,1,5,0,0,2,1,2,8,0
8043,186757,hDObtbeavxijehIK2xeebS18vJ3HSLBF,G8EPVSXsOYB5YQWZGiz1aVq5Pgr2GrQu,20,13,2,28,2,8,9,2,64,9.142857142857142,1,0.0,7,2,22,2,6,8,6,9,2,33,31,1
8044,186771,EEukb1HtBZxlb0jW8bNwwOHInCYodyW7,SpATywNh6bZuzm8s1ceuBUnMUAeoAHHw,10,8,5,0,3,1,2,0,19,2.7142857142857144,1,0.0,2,5,0,3,6,1,0,2,0,10,9,1
8045,186772,FfI4UUUkiQJXZUOcZvQpEfxlQuZiIFGh,SpATywNh6bZuzm8s1ceuBUnMUAeoAHHw,16,21,6,19,3,1,7,1,58,8.285714285714286,1,0.0,15,6,16,3,6,1,3,7,1,40,18,1
8046,186778,RPs2tKrisA27ObcW2SBs1xNMfhflcdme,A3fsA9Zfv1X2fVEQhTw51lKENdNrEqT3,26,16,13,0,10,2,7,1,49,7.0,1,0.0,1,13,0,10,15,2,0,7,1,24,25,1
8047,186781,7AJKHqkajNqeFVOiguDrQip0qHhqaIRR,SpATywNh6bZuzm8s1ceuBUnMUAeoAHHw,4,3,0,0,0,0,4,0,7,1.0,1,0.0,0,0,0,0,3,0,0,4,0,0,7,1
8048,186783,gGYcWzk2NzIvua4pLrzA2aQChS7C946h,bWdj2GDclj5ofokWjzoa5jAwMkxCykd6,1,0,0,0,0,0,1,0,1,0.14285714285714285,1,0.0,0,0,0,0,0,0,0,1,0,0,1,1
8049,186784,gGYcWzk2NzIvua4pLrzA2aQChS7C946h,A3fsA9Zfv1X2fVEQhTw51lKENdNrEqT3,1,0,0,0,0,0,1,0,1,0.14285714285714285,1,0.0,0,0,0,0,0,0,0,1,0,0,1,1
8050,186800,5dOCb3tuN0oLC3HIthm7sT5KORDlaOZw,bWdj2GDclj5ofokWjzoa5jAwMkxCykd6,1,0,0,0,0,0,1,0,1,0.14285714285714285,1,0.0,0,0,0,0,0,0,0,1,0,0,1,1
8051,186810,fOtwdZktYnpxoylqFRzXhWQ4IRQZkjMB,bWdj2GDclj5ofokWjzoa5jAwMkxCykd6,2,0,0,0,0,0,2,0,2,0.2857142857142857,1,0.0,0,0,0,0,0,0,0,2,0,0,2,1
8052,186813,YxZ9FmNlyuWdg66eoHTORDjjSmjY5VNG,G8EPVSXsOYB5YQWZGiz1aVq5Pgr2GrQu,1,0,0,0,0,0,1,0,1,0.14285714285714285,1,0.0,0,0,0,0,0,0,0,1,0,0,1,1
8053,186814,CBTOHCGcjccQ2o1Vrrh64wBXcjBq7Z16,SpATywNh6bZuzm8s1ceuBUnMUAeoAHHw,1,0,0,0,0,0,1,0,1,0.14285714285714285,1,0.0,0,0,0,0,0,0,0,1,0,0,1,1
8054,186847,hz69aGX7TSXJFEooFn03184YEuUmyXMU,A3fsA9Zfv1X2fVEQhTw51lKENdNrEqT3,1,0,0,0,0,0,1,0,1,0.14285714285714285,1,0.0,0,0,0,0,0,0,0,1,0,0,1,1
8055,186850,UgDeDsY1WA9fQwWE8jwZFiYA6EyOF0ZW,SpATywNh6bZuzm8s1ceuBUnMUAeoAHHw,8,10,6,0,4,0,5,0,25,3.5714285714285716,2,0.0,0,6,0,4,10,0,0,5,0,10,15,1
8056,186853,LsOIP6tIKtIJyz4AzkO8CiGUDMpbTeCo,A3fsA9Zfv1X2fVEQhTw51lKENdNrEqT3,6,13,2,0,0,0,2,0,17,2.4285714285714284,1,0.0,5,2,0,0,8,0,0,2,0,7,10,1
8057,186855,nxuexUreiYSzpSapqT3MF6tzgH9I1i5D,SpATywNh6bZuzm8s1ceuBUnMUAeoAHHw,2,0,0,0,0,0,2,0,2,0.2857142857142857,1,0.0,0,0,0,0,0,0,0,2,0,0,2,1
8058,186856,LsOIP6tIKtIJyz4AzkO8CiGUDMpbTeCo,bWdj2GDclj5ofokWjzoa5jAwMkxCykd6,3,0,0,0,0,0,5,0,5,0.7142857142857143,1,0.0,0,0,0,0,0,0,0,5,0,0,5,1
8059,186860,6wrpSaMSo2sFDvbkUAkMpT5um9Gim187,RXDvfPUBYFlVdlueBFbLW0mhhAyGEqpt,7,4,1,0,1,0,2,0,8,1.1428571428571428,1,0.0,0,1,0,1,4,0,0,2,0,2,6,1
8060,186863,8Sv91LR7V2lE7Zyit6yFhnYKBfbSa4xP,bWdj2GDclj5ofokWjzoa5jAwMkxCykd6,1,0,0,0,0,0,1,0,1,0.14285714285714285,1,0.0,0,0,0,0,0,0,0,1,0,0,1,1
8061,186871,gCagcmlQCSqfTruAye7CNDK3pgpCGf84,G8EPVSXsOYB5YQWZGiz1aVq5Pgr2GrQu,4,2,0,0,0,0,2,0,4,0.5714285714285714,1,0.0,0,0,0,0,2,0,0,2,0,0,4,1
8062,186872,qyt4OAUG4MKvi1Q9hL19EWAbFxfkdehH,SpATywNh6bZuzm8s1ceuBUnMUAeoAHHw,1,0,0,0,0,0,1,0,1,0.14285714285714285,1,0.0,0,0,0,0,0,0,0,1,0,0,1,1
8063,186890,3eKiIXhRJU4AcaSK2OGxb5hm0pCKaHgd,A3fsA9Zfv1X2fVEQhTw51lKENdNrEqT3,39,13,11,46,10,6,2,0,88,12.571428571428571,2,0.0,1,11,45,10,12,6,1,2,0,67,21,1
8064,188110,C3IAtr3DP6X43hGuQp5cpcBsS3W9ZHlR,A3fsA9Zfv1X2fVEQhTw51lKENdNrEqT3,7,3,2,0,2,0,3,0,10,1.4285714285714286,2,0.0,0,2,0,2,3,0,0,3,0,4,6,1
8065,188116,MK8k0hhUdWdpYmj0isuX8T1dViy4UCt1,SpATywNh6bZuzm8s1ceuBUnMUAeoAHHw,15,14,5,18,3,0,4,0,44,6.285714285714286,1,0.0,8,5,15,3,6,0,3,4,0,31,13,1
8066,188366,Qb1CgQ8SxoQQTE8swhxPBVi0nI23eAzb,A3fsA9Zfv1X2fVEQhTw51lKENdNrEqT3,8,7,2,0,1,0,5,0,15,2.142857142857143,1,0.0,0,2,0,1,7,0,0,5,0,3,12,1
8067,188559,pGYLDmhkSj1iBp1YljlDSId0XSrjZNZR,A3fsA9Zfv1X2fVEQhTw51lKENdNrEqT3,6,3,2,0,2,0,2,0,9,1.2857142857142858,1,0.0,0,2,0,2,3,0,0,2,0,4,5,1
8068,188933,Xtlrv3IpXCAfEIMntfnxIykrduMXBwb6,7GRhBDsirIGkRZBtSMEzNTyDr2JQm4xx,1,0,0,0,0,0,1,0,1,0.14285714285714285,1,0.0,0,0,0,0,0,0,0,1,0,0,1,1
8069,188937,7gxdF7npc77h7z0KnU9ezGYqtBJqY4fQ,A3fsA9Zfv1X2fVEQhTw51lKENdNrEqT3,1,0,0,0,0,0,2,0,2,0.2857142857142857,1,0.0,0,0,0,0,0,0,0,2,0,0,2,1
8070,188963,bGjzMxOC88rUacNGu6kshAaxdH2zKDK7,7GRhBDsirIGkRZBtSMEzNTyDr2JQm4xx,2,0,0,0,0,0,2,0,2,0.2857142857142857,1,0.0,0,0,0,0,0,0,0,2,0,0,2,1
8071,188974,KcVR47mhsCByukl6kUhifp06p0t9ddmf,7GRhBDsirIGkRZBtSMEzNTyDr2JQm4xx,1,0,0,0,0,0,1,0,1,0.14285714285714285,1,0.0,0,0,0,0,0,0,0,1,0,0,1,1
8072,188976,hlny1PkYo5JEvtbsehOwAyHgv8hye7Vl,7GRhBDsirIGkRZBtSMEzNTyDr2JQm4xx,1,0,0,0,0,0,1,0,1,0.14285714285714285,1,0.0,0,0,0,0,0,0,0,1,0,0,1,1
8073,188979,XoKIP4RGpnZk163890vUyWhLOIUSaapU,7GRhBDsirIGkRZBtSMEzNTyDr2JQm4xx,28,58,22,50,13,2,1,0,146,20.857142857142858,1,0.0,35,22,40,13,23,2,10,1,0,110,36,1
8074,188986,pDtmXyCxgvpAGK1UHOqTKB1Mk4ad0Obx,7GRhBDsirIGkRZBtSMEzNTyDr2JQm4xx,2,0,0,0,0,0,3,0,3,0.42857142857142855,1,0.0,0,0,0,0,0,0,0,3,0,0,3,1
8075,188997,vDLgajPV6eBsq6waPGg2sGMVCdUz10kh,7GRhBDsirIGkRZBtSMEzNTyDr2JQm4xx,6,0,0,0,0,0,9,1,10,1.4285714285714286,1,0.0,0,0,0,0,0,0,0,9,1,0,10,1
8076,189038,CaO6lbKucftN7Eu0LZWcCZKQchWcKCTo,7GRhBDsirIGkRZBtSMEzNTyDr2JQm4xx,6,0,0,0,0,0,6,0,6,0.8571428571428571,1,0.0,0,0,0,0,0,0,0,6,0,0,6,1
8077,189121,v4Sdqo21VERdMlPPJ5lxFzea2Futc16m,7GRhBDsirIGkRZBtSMEzNTyDr2JQm4xx,10,5,3,7,3,1,2,1,22,3.142857142857143,1,0.0,1,3,6,3,4,1,1,2,1,13,9,1
8078,189123,f3G4rcF7hvAe5fW36C69obxNMOERmdUr,7GRhBDsirIGkRZBtSMEzNTyDr2JQm4xx,2,0,0,0,0,0,2,0,2,0.2857142857142857,1,0.0,0,0,0,0,0,0,0,2,0,0,2,1
8079,189125,BlhCYC8woOBcOY9B6dneqhiXvmHLTuKE,7GRhBDsirIGkRZBtSMEzNTyDr2JQm4xx,2,0,0,0,0,0,2,0,2,0.2857142857142857,1,0.0,0,0,0,0,0,0,0,2,0,0,2,1
8080,189138,jiFzFGisDkK72ZBTna8wrY4pq5bLzUOt,SpATywNh6bZuzm8s1ceuBUnMUAeoAHHw,4,2,1,0,1,0,1,0,5,0.7142857142857143,1,0.0,0,1,0,1,2,0,0,1,0,2,3,1
8081,189142,skSnSfH7XcyX8lYXpZBS74pGLHKMwWNm,7GRhBDsirIGkRZBtSMEzNTyDr2JQm4xx,1,0,0,0,0,0,1,0,1,0.14285714285714285,1,0.0,0,0,0,0,0,0,0,1,0,0,1,1
8082,189149,RD8IEsnXxFXH4Z6OD9WSAuQqmJ27nHhK,7GRhBDsirIGkRZBtSMEzNTyDr2JQm4xx,2,0,0,0,0,0,2,0,2,0.2857142857142857,1,0.0,0,0,0,0,0,0,0,2,0,0,2,1
8083,189157,KADzrQcaGi7TzZIKCqh7I8E0i863BBoH,7GRhBDsirIGkRZBtSMEzNTyDr2JQm4xx,2,0,0,0,0,0,2,0,2,0.2857142857142857,1,0.0,0,0,0,0,0,0,0,2,0,0,2,1
8084,189163,YdCaKimqYb8kuFiHEtjPDsCbtIch1tfO,7GRhBDsirIGkRZBtSMEzNTyDr2JQm4xx,8,9,2,0,0,1,5,2,19,2.7142857142857144,1,0.0,5,2,0,0,4,1,0,5,2,7,12,1
8085,189178,UpLwu6T0ULbCdikK3k55n17m75BbWAqs,7GRhBDsirIGkRZBtSMEzNTyDr2JQm4xx,7,4,1,0,2,0,4,0,11,1.5714285714285714,1,0.0,2,1,0,2,2,0,0,4,0,5,6,1
8086,189180,De3af8LDoF4IXXnUzXAiZVCskiGXJoAd,7GRhBDsirIGkRZBtSMEzNTyDr2JQm4xx,11,11,4,4,2,15,9,3,48,6.857142857142857,1,0.0,2,4,3,2,9,15,1,9,3,11,37,1
8087,189185,waDceRgc2N0BjPJorKWJj1WtKs87R7xP,7GRhBDsirIGkRZBtSMEzNTyDr2JQm4xx,4,2,0,0,0,0,2,0,4,0.5714285714285714,1,0.0,0,0,0,0,2,0,0,2,0,0,4,1
8088,189190,hz69aGX7TSXJFEooFn03184YEuUmyXMU,7GRhBDsirIGkRZBtSMEzNTyDr2JQm4xx,2,0,0,0,0,0,2,0,2,0.2857142857142857,1,0.0,0,0,0,0,0,0,0,2,0,0,2,1
8089,189200,jxw4QkqvvdLlUDAf97E2SumJv5ThdQ3m,7GRhBDsirIGkRZBtSMEzNTyDr2JQm4xx,2,0,0,0,0,0,5,0,5,0.7142857142857143,1,0.0,0,0,0,0,0,0,0,5,0,0,5,1
8090,189217,S685sFeuH7ep81myXbWJBadTSgXcwR6Q,7GRhBDsirIGkRZBtSMEzNTyDr2JQm4xx,5,2,1,0,1,0,3,0,7,1.0,1,0.0,0,1,0,1,2,0,0,3,0,2,5,1
8091,189225,V1EykxyqrSjJS8SrSU1L9A5qCk92mw9z,7GRhBDsirIGkRZBtSMEzNTyDr2JQm4xx,23,34,18,24,17,1,2,0,96,13.714285714285714,1,0.0,8,18,21,17,26,1,3,2,0,64,32,1
8092,189237,XqzZzhc9uB2wCLtNHGWt7epj98UW1aCq,7GRhBDsirIGkRZBtSMEzNTyDr2JQm4xx,2,0,0,0,0,0,2,0,2,0.2857142857142857,1,0.0,0,0,0,0,0,0,0,2,0,0,2,1
8093,189251,gKEmxl73O6lgpzCm5W5THfmE7UMUjyMT,7GRhBDsirIGkRZBtSMEzNTyDr2JQm4xx,6,1,1,0,0,5,4,3,14,2.0,1,0.0,0,1,0,0,1,5,0,4,3,1,13,1
8094,189258,vKg7m5YebaxRd5kf6WsIAhVoxmBX8DKD,7GRhBDsirIGkRZBtSMEzNTyDr2JQm4xx,2,0,0,0,0,0,2,0,2,0.2857142857142857,1,0.0,0,0,0,0,0,0,0,2,0,0,2,1
8095,189329,IDVV2jtBUYHXvZRwUeupKpLFwBDZmMvi,7GRhBDsirIGkRZBtSMEzNTyDr2JQm4xx,3,2,0,0,0,0,1,0,3,0.42857142857142855,1,0.0,0,0,0,0,2,0,0,1,0,0,3,1
8096,189332,xhCV750Vmz3Zc8n6WSG04S1Of863qTkW,7GRhBDsirIGkRZBtSMEzNTyDr2JQm4xx,1,0,0,0,0,0,1,0,1,0.14285714285714285,1,0.0,0,0,0,0,0,0,0,1,0,0,1,1
8097,189336,y71lRBqIdu5iPiLn9Yi5PQm6GFIvgLwB,7GRhBDsirIGkRZBtSMEzNTyDr2JQm4xx,1,0,0,0,0,0,1,0,1,0.14285714285714285,1,0.0,0,0,0,0,0,0,0,1,0,0,1,1
8098,189381,d9mMxxcMI65zEdojLuYluBZegkL9kaO9,7GRhBDsirIGkRZBtSMEzNTyDr2JQm4xx,2,0,0,0,0,0,2,0,2,0.2857142857142857,1,0.0,0,0,0,0,0,0,0,2,0,0,2,1
8099,189401,PB7h0UvHpsEAKo6BKDI2Oe83oHx4FlRv,7GRhBDsirIGkRZBtSMEzNTyDr2JQm4xx,5,4,1,0,2,0,2,0,9,1.2857142857142858,1,0.0,2,1,0,2,2,0,0,2,0,5,4,1
8100,189408,XsZuRX3JjxC6rjjGF8ce2xx3yowgSNne,7GRhBDsirIGkRZBtSMEzNTyDr2JQm4xx,8,3,2,0,2,0,4,0,11,1.5714285714285714,1,0.0,0,2,0,2,3,0,0,4,0,4,7,1
8101,189442,ifnHK7elzUrx6FoT7eceCrEZMhAwQ98l,7GRhBDsirIGkRZBtSMEzNTyDr2JQm4xx,5,3,1,4,1,0,2,0,11,1.5714285714285714,1,0.0,1,1,3,1,2,0,1,2,0,6,5,1
8102,189444,HO1jCcwERynGUi1jR0hjkSfXZ85j5jaW,7GRhBDsirIGkRZBtSMEzNTyDr2JQm4xx,1,0,0,0,0,0,1,0,1,0.14285714285714285,1,0.0,0,0,0,0,0,0,0,1,0,0,1,1
8103,189448,opKUJLQunILYTzpA0JfEP9KQkwUgY37v,7GRhBDsirIGkRZBtSMEzNTyDr2JQm4xx,16,8,5,0,3,3,10,1,30,4.285714285714286,1,0.0,0,5,0,3,8,3,0,10,1,8,22,1
8104,189453,CwPtG0pQpatgEgPUJC1fzC45UnY2lgMF,7GRhBDsirIGkRZBtSMEzNTyDr2JQm4xx,10,11,7,10,5,0,4,0,37,5.285714285714286,2,0.0,3,7,8,5,8,0,2,4,0,23,14,1
8105,189519,W44EUSPSAj1fZWLor5hD25joUoQF1Axq,7GRhBDsirIGkRZBtSMEzNTyDr2JQm4xx,9,6,0,2,1,0,2,0,11,1.5714285714285714,1,0.0,1,0,2,1,5,0,0,2,0,4,7,1
8106,189520,xPkJLyddSzkSguLc8iFCPUKp6SiHPVYA,7GRhBDsirIGkRZBtSMEzNTyDr2JQm4xx,1,0,0,0,0,0,1,0,1,0.14285714285714285,1,0.0,0,0,0,0,0,0,0,1,0,0,1,1
8107,189576,QGuKTIBC2KLaYpPdOnB4nXCWgxMM1Dog,7GRhBDsirIGkRZBtSMEzNTyDr2JQm4xx,1,0,0,0,0,0,1,0,1,0.14285714285714285,1,0.0,0,0,0,0,0,0,0,1,0,0,1,1
8108,189593,MgVP6LodMhznTbusy8mYmerhW0RKcSCB,7GRhBDsirIGkRZBtSMEzNTyDr2JQm4xx,1,0,0,0,0,0,1,0,1,0.14285714285714285,1,0.0,0,0,0,0,0,0,0,1,0,0,1,1
8109,189605,yrczal0ybDrTDoOYd1WvgcBQApn5E29e,7GRhBDsirIGkRZBtSMEzNTyDr2JQm4xx,1,0,0,0,0,0,1,0,1,0.14285714285714285,1,0.0,0,0,0,0,0,0,0,1,0,0,1,1
8110,189608,1HkkpfSVTiT6CtY9J3aLZcX4FRE5LVLz,7GRhBDsirIGkRZBtSMEzNTyDr2JQm4xx,3,0,0,0,0,3,2,0,5,0.7142857142857143,1,0.0,0,0,0,0,0,3,0,2,0,0,5,1
8111,189614,5PZBmKEXGmnHhrok7M9vaGB06CAzFVOO,7GRhBDsirIGkRZBtSMEzNTyDr2JQm4xx,6,4,1,2,1,0,1,0,9,1.2857142857142858,1,0.0,1,1,2,1,3,0,0,1,0,5,4,0
8112,189666,lbgTV2YMskSv2TX4EXpaazpMVWfsftEV,7GRhBDsirIGkRZBtSMEzNTyDr2JQm4xx,1,0,0,0,0,0,1,0,1,0.14285714285714285,1,0.0,0,0,0,0,0,0,0,1,0,0,1,1
8113,189696,PMZJ7vxYEpwybeGWTMZuFimiDLzBBGfH,7GRhBDsirIGkRZBtSMEzNTyDr2JQm4xx,9,7,1,0,1,0,2,0,11,1.5714285714285714,1,0.0,0,1,0,1,7,0,0,2,0,2,9,1
8114,189792,tr8E6i6LhPPOpsyObFM4xo1Myl86ILao,A3fsA9Zfv1X2fVEQhTw51lKENdNrEqT3,4,3,0,0,0,0,1,0,4,0.5714285714285714,1,0.0,0,0,0,0,3,0,0,1,0,0,4,1
8115,189835,vXT2w57VYk2IRPGUPSaMsXQX7TQrsaxB,7GRhBDsirIGkRZBtSMEzNTyDr2JQm4xx,1,0,0,0,0,0,1,0,1,0.14285714285714285,1,0.0,0,0,0,0,0,0,0,1,0,0,1,1
8116,189836,xgQYbfvDEw17v13YEvx2pY52YvDa4jfG,7GRhBDsirIGkRZBtSMEzNTyDr2JQm4xx,12,6,5,0,5,0,1,0,17,2.4285714285714284,1,0.0,0,5,0,5,6,0,0,1,0,10,7,0
8117,189841,c6EQxl5Y5srE1l7qShfQ6CExe7ZkgJ6z,7GRhBDsirIGkRZBtSMEzNTyDr2JQm4xx,4,2,0,0,0,1,2,0,5,0.7142857142857143,1,0.0,0,0,0,0,2,1,0,2,0,0,5,0
8118,189872,tvbjaq3OPKemCIT5KViqtpbuzjmnk9iv,7GRhBDsirIGkRZBtSMEzNTyDr2JQm4xx,1,0,0,0,0,0,1,0,1,0.14285714285714285,1,0.0,0,0,0,0,0,0,0,1,0,0,1,1
8119,189878,EuByZSROH9lLZ2dnd4GXxahw8RdkgjTd,7GRhBDsirIGkRZBtSMEzNTyDr2JQm4xx,5,2,1,0,1,0,4,0,8,1.1428571428571428,1,0.0,0,1,0,1,2,0,0,4,0,2,6,1
8120,189962,vqeyrkQOvY6ito5wie8yXLKkDfcoR2Qk,7GRhBDsirIGkRZBtSMEzNTyDr2JQm4xx,1,0,0,0,0,0,1,0,1,0.14285714285714285,1,0.0,0,0,0,0,0,0,0,1,0,0,1,1
8121,189987,VAnGmjZDe4mKyUygxHcsKkNd3a9DThub,7GRhBDsirIGkRZBtSMEzNTyDr2JQm4xx,9,8,2,4,3,0,3,0,20,2.857142857142857,1,0.0,3,2,3,3,5,0,1,3,0,11,9,1
8122,190043,9NL6pIdeoq3qoMYjmrqicRwQF6as6xWO,7GRhBDsirIGkRZBtSMEzNTyDr2JQm4xx,6,7,1,0,1,0,3,0,12,1.7142857142857142,1,0.0,0,1,0,1,7,0,0,3,0,2,10,1
8123,190059,zX9pboSJ4vJa1gdfSLlOQHMTjhsQEp32,7GRhBDsirIGkRZBtSMEzNTyDr2JQm4xx,1,0,0,0,0,0,1,0,1,0.14285714285714285,1,0.0,0,0,0,0,0,0,0,1,0,0,1,1
8124,190148,WQMZ2fhdRzqYNsK6k2GeqeA3Ess2PfYw,7GRhBDsirIGkRZBtSMEzNTyDr2JQm4xx,1,0,0,0,0,0,1,0,1,0.14285714285714285,1,0.0,0,0,0,0,0,0,0,1,0,0,1,1
8125,190207,LuEM6Ji2sbchJvZp3E6DXQ6Q9idvBGe0,7GRhBDsirIGkRZBtSMEzNTyDr2JQm4xx,5,1,1,0,1,2,2,0,7,1.0,1,0.0,0,1,0,1,1,2,0,2,0,2,5,1
8126,190718,DpxuYKp6sa0JAnGuKmqElQRmCDtXLEpJ,SpATywNh6bZuzm8s1ceuBUnMUAeoAHHw,1,0,0,0,0,0,1,0,1,0.14285714285714285,1,0.0,0,0,0,0,0,0,0,1,0,0,1,1
8127,190722,Ms1kL8mhYcPEiDk8tgcaN8I4C5LMNZxp,G8EPVSXsOYB5YQWZGiz1aVq5Pgr2GrQu,11,9,1,19,0,0,1,0,30,4.285714285714286,1,0.0,4,1,15,0,5,0,4,1,0,20,10,1
8128,190727,37BDHc0OYB1UI75qIorGre2ofEZmPc4J,A3fsA9Zfv1X2fVEQhTw51lKENdNrEqT3,1,0,0,0,0,0,1,0,1,0.14285714285714285,1,0.0,0,0,0,0,0,0,0,1,0,0,1,1
8129,190733,qwFC3xpje0fSY3HguoMOOzyv51OIHJQc,SpATywNh6bZuzm8s1ceuBUnMUAeoAHHw,5,2,1,0,1,0,2,0,6,0.8571428571428571,1,0.0,0,1,0,1,2,0,0,2,0,2,4,1
8130,190740,MK8n1r3R3tfWcasYdKrOSnVNYSZNSOlt,SpATywNh6bZuzm8s1ceuBUnMUAeoAHHw,13,33,4,23,0,1,7,2,70,10.0,1,0.0,10,4,20,0,23,1,3,7,2,34,36,1
8131,190746,TCMrwUanMGda0OSNc9BMWUDLbksnXQ2Q,SpATywNh6bZuzm8s1ceuBUnMUAeoAHHw,11,13,7,0,4,5,6,1,36,5.142857142857143,1,0.0,0,7,0,4,13,5,0,6,1,11,25,0
8132,190751,wIcAqiIkhVke6PQk1FQ10LQjFUOa268K,A3fsA9Zfv1X2fVEQhTw51lKENdNrEqT3,1,0,0,0,0,0,2,0,2,0.2857142857142857,1,0.0,0,0,0,0,0,0,0,2,0,0,2,1
8133,190753,d91YjGHVAp34DYQkswrOrvZeIJcGcFNO,SpATywNh6bZuzm8s1ceuBUnMUAeoAHHw,13,13,5,12,4,0,2,0,36,5.142857142857143,1,0.0,6,5,11,4,7,0,1,2,0,26,10,1
8134,190765,3RcsrMTbPrb8ZHYXLlgwoRK7zrqTGSuq,RXDvfPUBYFlVdlueBFbLW0mhhAyGEqpt,4,2,1,0,1,0,1,0,5,0.7142857142857143,1,0.0,0,1,0,1,2,0,0,1,0,2,3,1
8135,190772,HBKLIFAfKd9tCUbnjwmqE9j7uloBEJrv,bWdj2GDclj5ofokWjzoa5jAwMkxCykd6,6,8,1,0,1,5,6,0,21,3.0,2,0.0,0,1,0,1,8,5,0,6,0,2,19,1
8136,190777,Ah2AGzYhaU2T8uPD2EY56TT31dJPAut5,SpATywNh6bZuzm8s1ceuBUnMUAeoAHHw,6,3,1,0,1,0,2,0,7,1.0,1,0.0,0,1,0,1,3,0,0,2,0,2,5,1
8137,190783,jImHfNEIObE674KdIbKVj7cCJ4ufqzHJ,bWdj2GDclj5ofokWjzoa5jAwMkxCykd6,6,6,2,0,0,10,4,0,22,3.142857142857143,1,0.0,1,2,0,0,5,10,0,4,0,3,19,1
8138,190788,ub8WyOqIuzODPtpQPBgjCOsRi8689oKs,bWdj2GDclj5ofokWjzoa5jAwMkxCykd6,9,16,6,34,6,0,3,0,65,9.285714285714286,1,0.0,7,6,33,6,9,0,1,3,0,52,13,1
8139,190789,OVHTSfVPYj0AbzU459n1EpNOKwcVwoC1,SpATywNh6bZuzm8s1ceuBUnMUAeoAHHw,6,1,1,0,1,0,5,0,8,1.1428571428571428,1,0.0,0,1,0,1,1,0,0,5,0,2,6,1
8140,190799,4e4wTy2Vsuz8jVFYgJOgi1kIGDWREiPH,A3fsA9Zfv1X2fVEQhTw51lKENdNrEqT3,1,0,0,0,0,0,1,0,1,0.14285714285714285,1,0.0,0,0,0,0,0,0,0,1,0,0,1,1
8141,190810,kKpnSjKhiG2j5iddaCKIyt4CCm1rwmVr,bWdj2GDclj5ofokWjzoa5jAwMkxCykd6,2,0,0,0,0,0,2,0,2,0.2857142857142857,1,0.0,0,0,0,0,0,0,0,2,0,0,2,0
8142,190812,3GA2inbDa4Qb67FoyO0TodCHsf82hLjI,bWdj2GDclj5ofokWjzoa5jAwMkxCykd6,7,9,0,0,0,0,6,0,15,2.142857142857143,2,0.0,0,0,0,0,9,0,0,6,0,0,15,1
8143,190843,hfNogWjrbSkOb5OMhhVjR3oNpdgCCLmb,SpATywNh6bZuzm8s1ceuBUnMUAeoAHHw,3,0,0,0,0,0,3,0,3,0.42857142857142855,1,0.0,0,0,0,0,0,0,0,3,0,0,3,1
8144,190859,ckUpblr5wnpb1JdYLODP4lr2g04VPwJ3,SpATywNh6bZuzm8s1ceuBUnMUAeoAHHw,6,8,4,0,4,0,1,0,17,2.4285714285714284,1,0.0,3,4,0,4,5,0,0,1,0,11,6,1
8145,190862,6ZrLKRxT6wri7cDqZ6Wete0KvsW58pUp,SpATywNh6bZuzm8s1ceuBUnMUAeoAHHw,3,2,0,0,0,0,1,0,3,0.42857142857142855,1,0.0,0,0,0,0,2,0,0,1,0,0,3,1
8146,190865,tE94PJyjcpdWxXLDLcWw5U2hOs3lOnfb,SpATywNh6bZuzm8s1ceuBUnMUAeoAHHw,12,4,3,0,3,1,5,1,17,2.4285714285714284,1,0.0,0,3,0,3,4,1,0,5,1,6,11,1
8147,190871,DanoP5XpHODQZmwuFGZgNKBiu5nY9yH1,bWdj2GDclj5ofokWjzoa5jAwMkxCykd6,5,3,1,0,1,1,2,1,9,1.2857142857142858,1,0.0,1,1,0,1,2,1,0,2,1,3,6,1
8148,190878,XZVdP9VG9V0aFXSF7pNpI4xf6QSEG5Qi,SpATywNh6bZuzm8s1ceuBUnMUAeoAHHw,1,0,0,0,0,0,1,0,1,0.14285714285714285,1,0.0,0,0,0,0,0,0,0,1,0,0,1,1
8149,190881,qKdcEew3Ozu2wI3f7P370tw3NiiGDkW3,bWdj2GDclj5ofokWjzoa5jAwMkxCykd6,1,0,0,0,0,0,1,0,1,0.14285714285714285,1,0.0,0,0,0,0,0,0,0,1,0,0,1,1
8150,190890,9Yh9BGNzlB70iEC7VABYNXfepXjXz9Ik,A3fsA9Zfv1X2fVEQhTw51lKENdNrEqT3,1,0,0,0,0,0,3,0,3,0.42857142857142855,1,0.0,0,0,0,0,0,0,0,3,0,0,3,1
8151,190896,jGtiVf5HYLqgOasCrKGgOBMBFuA9x4ae,SpATywNh6bZuzm8s1ceuBUnMUAeoAHHw,7,6,2,0,2,0,2,0,12,1.7142857142857142,1,0.0,0,2,0,2,6,0,0,2,0,4,8,1
8152,190918,withnGSnYLu5h0Gra5Fz5vQjZTgJGD3V,SpATywNh6bZuzm8s1ceuBUnMUAeoAHHw,7,3,2,0,2,0,4,0,11,1.5714285714285714,1,0.0,0,2,0,2,3,0,0,4,0,4,7,1
8153,190922,tbFJlVh7YWaPwir5TDxmcNNiJWy4IdR6,SpATywNh6bZuzm8s1ceuBUnMUAeoAHHw,7,8,5,0,3,0,3,0,19,2.7142857142857144,1,0.0,0,5,0,3,8,0,0,3,0,8,11,1
8154,190929,KK8c9Dmj5I63bhg4LxlQHTWu5jCGLVNt,SpATywNh6bZuzm8s1ceuBUnMUAeoAHHw,1,0,0,0,0,0,1,0,1,0.14285714285714285,1,0.0,0,0,0,0,0,0,0,1,0,0,1,1
8155,190932,gWQVeEY6kY0Jw04P2MZyClMk9GLvVaq0,RXDvfPUBYFlVdlueBFbLW0mhhAyGEqpt,14,11,8,19,2,0,11,0,51,7.285714285714286,1,0.0,1,8,16,2,10,0,3,11,0,27,24,1
8156,190938,QxwH5Fww2hdJXhksXEKBkHoArOFw3LA7,bWdj2GDclj5ofokWjzoa5jAwMkxCykd6,1,0,0,0,0,0,1,0,1,0.14285714285714285,1,0.0,0,0,0,0,0,0,0,1,0,0,1,1
8157,190943,2AimReANoYwzi4n9y5GufQBbWWeoLfr2,bWdj2GDclj5ofokWjzoa5jAwMkxCykd6,1,0,0,0,0,0,1,0,1,0.14285714285714285,1,0.0,0,0,0,0,0,0,0,1,0,0,1,1
8158,190946,NzGQ6qHi5I7oDznlM4iA1Evelv3MLoFE,SpATywNh6bZuzm8s1ceuBUnMUAeoAHHw,10,16,5,4,0,2,6,0,33,4.714285714285714,1,0.0,1,5,3,0,15,2,1,6,0,9,24,1
8159,190948,BwqiPFy1sDFuBLb3rSXiF0IO3CLelW7L,SpATywNh6bZuzm8s1ceuBUnMUAeoAHHw,14,14,5,16,2,13,8,4,62,8.857142857142858,2,0.0,8,5,14,2,6,13,2,8,4,29,33,1
8160,190950,9Yh9BGNzlB70iEC7VABYNXfepXjXz9Ik,bWdj2GDclj5ofokWjzoa5jAwMkxCykd6,4,2,0,0,0,3,4,0,9,1.2857142857142858,1,0.0,0,0,0,0,2,3,0,4,0,0,9,1
8161,190952,C4ydYZ7sRMBYk7EGihDGPeJUEQIdQEOw,SpATywNh6bZuzm8s1ceuBUnMUAeoAHHw,8,18,10,0,6,0,4,0,38,5.428571428571429,3,0.0,0,10,0,6,18,0,0,4,0,16,22,0
8162,190956,MBe2FxezhNNSk0O4l1Td85ufwdvtDvm8,SpATywNh6bZuzm8s1ceuBUnMUAeoAHHw,14,7,4,12,3,7,4,0,37,5.285714285714286,1,0.0,2,4,10,3,5,7,2,4,0,19,18,1
8163,190963,AilYGUB2b7U7u3L7JzReiarkucWyF0Uz,SpATywNh6bZuzm8s1ceuBUnMUAeoAHHw,2,0,0,0,0,0,4,0,4,0.5714285714285714,1,0.0,0,0,0,0,0,0,0,4,0,0,4,1
8164,190970,LLbWHvDvBPRMaeOD85m6rAaUvdLFucgj,bWdj2GDclj5ofokWjzoa5jAwMkxCykd6,3,0,0,0,0,0,3,0,3,0.42857142857142855,1,0.0,0,0,0,0,0,0,0,3,0,0,3,1
8165,190979,pMptAyZDeGXiIThstiLzNxB1KwRjAXpm,SpATywNh6bZuzm8s1ceuBUnMUAeoAHHw,1,0,0,0,0,0,1,0,1,0.14285714285714285,1,0.0,0,0,0,0,0,0,0,1,0,0,1,1
8166,190983,FiovvlFjZXQo41RA25FaJ17VJEgdj2le,SpATywNh6bZuzm8s1ceuBUnMUAeoAHHw,9,17,1,20,0,0,1,0,39,5.571428571428571,1,0.0,8,1,17,0,9,0,3,1,0,26,13,0
8167,191003,hupbjCOx448dHGDJQGqmUPOcvI9LWbzv,SpATywNh6bZuzm8s1ceuBUnMUAeoAHHw,4,2,1,0,0,7,3,0,13,1.8571428571428572,2,0.0,0,1,0,0,2,7,0,3,0,1,12,1
8168,191006,Q8nnFnGSO36eBGAiyp2wP0aveYg77DlE,G8EPVSXsOYB5YQWZGiz1aVq5Pgr2GrQu,5,6,1,0,2,1,2,0,12,1.7142857142857142,1,0.0,2,1,0,2,4,1,0,2,0,5,7,1
8169,191018,co3nb33nJ0Krxm21xnzLNxLQgo7GndnG,SpATywNh6bZuzm8s1ceuBUnMUAeoAHHw,1,0,0,0,0,0,1,0,1,0.14285714285714285,1,0.0,0,0,0,0,0,0,0,1,0,0,1,1
8170,191019,NCCp8fTS5s1iyttaNh3WkMeHCOcN3tb4,bWdj2GDclj5ofokWjzoa5jAwMkxCykd6,2,0,0,0,0,0,2,0,2,0.2857142857142857,1,0.0,0,0,0,0,0,0,0,2,0,0,2,1
8171,191021,nNXCDU7pCvXdQPycxWESwEGIIRWvHKWv,SpATywNh6bZuzm8s1ceuBUnMUAeoAHHw,3,2,1,0,0,0,1,0,4,0.5714285714285714,1,0.0,0,1,0,0,2,0,0,1,0,1,3,1
8172,191027,uFHm9PGn5yQICMVzgF44FzRtCVKrar2K,SpATywNh6bZuzm8s1ceuBUnMUAeoAHHw,7,2,1,0,1,1,4,0,9,1.2857142857142858,1,0.0,0,1,0,1,2,1,0,4,0,2,7,0
8173,191029,qSgfNAK24EhdWunFvzpQNvLLVkPV61Hr,A3fsA9Zfv1X2fVEQhTw51lKENdNrEqT3,1,0,0,0,0,0,1,0,1,0.14285714285714285,1,0.0,0,0,0,0,0,0,0,1,0,0,1,1
8174,191038,Sc510MM1IFPp0fhdgDOEyRVvZYZOxuoR,A3fsA9Zfv1X2fVEQhTw51lKENdNrEqT3,1,0,0,0,0,0,1,0,1,0.14285714285714285,1,0.0,0,0,0,0,0,0,0,1,0,0,1,1
8175,191041,trENMyltvkElnFRacDKrV1O2HLSxf35j,A3fsA9Zfv1X2fVEQhTw51lKENdNrEqT3,5,2,1,0,1,0,2,0,6,0.8571428571428571,2,0.0,0,1,0,1,2,0,0,2,0,2,4,1
8176,191050,Y3qAEqzdKJewEkb06n8n2BrJMQzX9urI,SpATywNh6bZuzm8s1ceuBUnMUAeoAHHw,15,13,5,19,3,7,6,1,54,7.714285714285714,1,0.0,8,5,16,3,5,7,3,6,1,32,22,1
8177,191063,nRHQUNRUIsIinoYx4tQlxNnAC0I3YYVk,G8EPVSXsOYB5YQWZGiz1aVq5Pgr2GrQu,41,59,33,88,16,0,11,5,212,30.285714285714285,1,0.0,20,33,75,16,39,0,13,11,5,144,68,1
8178,191064,yB2j2tPO2DVKCBBdsLv8a1lbHtfWINMh,bWdj2GDclj5ofokWjzoa5jAwMkxCykd6,1,0,0,0,0,0,1,0,1,0.14285714285714285,1,0.0,0,0,0,0,0,0,0,1,0,0,1,1
8179,191078,hjK9g2c0CglrLajBSxgIKqI54vivYEKM,SpATywNh6bZuzm8s1ceuBUnMUAeoAHHw,1,0,0,0,0,0,1,0,1,0.14285714285714285,1,0.0,0,0,0,0,0,0,0,1,0,0,1,1
8180,191102,etudbAO9CMrW6LcXYzcIWXUJFoLMbVh9,SpATywNh6bZuzm8s1ceuBUnMUAeoAHHw,10,5,3,0,2,9,5,1,25,3.5714285714285716,1,0.0,0,3,0,2,5,9,0,5,1,5,20,1
8181,191103,917C36aL5o1yjdcDTH5lZyAgXpc01Gk5,SpATywNh6bZuzm8s1ceuBUnMUAeoAHHw,4,2,0,0,0,1,2,1,6,0.8571428571428571,1,0.0,0,0,0,0,2,1,0,2,1,0,6,1
8182,191106,geEAXwfPbJ0MhEZG0COad1UptHNAilTd,bWdj2GDclj5ofokWjzoa5jAwMkxCykd6,2,0,0,0,0,0,2,0,2,0.2857142857142857,1,0.0,0,0,0,0,0,0,0,2,0,0,2,1
8183,191129,SHOQyzWMzeXzTVojp4arGhfbJLLjl3Lx,bWdj2GDclj5ofokWjzoa5jAwMkxCykd6,4,2,1,0,1,0,1,0,5,0.7142857142857143,1,0.0,0,1,0,1,2,0,0,1,0,2,3,1
8184,191131,HcFsEHTYadygQKRPBb3uDSEv8jpRHr6D,A3fsA9Zfv1X2fVEQhTw51lKENdNrEqT3,1,0,0,0,0,0,2,0,2,0.2857142857142857,1,0.0,0,0,0,0,0,0,0,2,0,0,2,1
8185,191132,deraFog8y0MjwcE23P6Rs0pGeytN3xmN,SpATywNh6bZuzm8s1ceuBUnMUAeoAHHw,9,11,0,0,0,2,14,4,31,4.428571428571429,1,0.0,0,0,0,0,11,2,0,14,4,0,31,1
8186,191135,OPQKWFr5Ag3gYEWW9i0rWdZ5Gc0wk3FB,SpATywNh6bZuzm8s1ceuBUnMUAeoAHHw,5,2,1,0,1,0,4,0,8,1.1428571428571428,1,0.0,0,1,0,1,2,0,0,4,0,2,6,1
8187,191143,KarP5JDxaA55wR1ThEFPoGYFsHmbBCZf,bWdj2GDclj5ofokWjzoa5jAwMkxCykd6,5,2,1,0,1,0,2,0,6,0.8571428571428571,1,0.0,0,1,0,1,2,0,0,2,0,2,4,1
8188,191147,21VuQSD13OpzBWnKCJ94z3vzUwy0J7cg,SpATywNh6bZuzm8s1ceuBUnMUAeoAHHw,9,7,3,0,0,0,5,1,16,2.2857142857142856,1,0.0,1,3,0,0,6,0,0,5,1,4,12,1
8189,191149,2KkJ2RPeYYnwpoBmLIbDX3SHVzQ9KAtd,SpATywNh6bZuzm8s1ceuBUnMUAeoAHHw,1,0,0,0,0,0,1,0,1,0.14285714285714285,1,0.0,0,0,0,0,0,0,0,1,0,0,1,1
8190,191155,S1LmT8vUaszGt2C5KVBW9KkkZ6u3e67K,SpATywNh6bZuzm8s1ceuBUnMUAeoAHHw,1,0,0,0,0,0,1,0,1,0.14285714285714285,1,0.0,0,0,0,0,0,0,0,1,0,0,1,1
8191,191165,XKiESHLmmxxFLSNhNTicMKXZo07ga8rR,bWdj2GDclj5ofokWjzoa5jAwMkxCykd6,2,0,0,0,0,0,2,0,2,0.2857142857142857,1,0.0,0,0,0,0,0,0,0,2,0,0,2,1
8192,191170,SfAUcZmUPYD4dsdFfOX7wSpg4mGcve5n,RXDvfPUBYFlVdlueBFbLW0mhhAyGEqpt,1,0,0,0,0,0,1,0,1,0.14285714285714285,1,0.0,0,0,0,0,0,0,0,1,0,0,1,1
8193,191179,wFv26V6AwzjCWPgCKpY50WBZiVw3xNw6,SpATywNh6bZuzm8s1ceuBUnMUAeoAHHw,7,4,3,0,3,0,2,0,12,1.7142857142857142,1,0.0,0,3,0,3,4,0,0,2,0,6,6,1
8194,191183,fXZkHvfRnLNWddfTwlt8RK2cRTiOmg3N,A3fsA9Zfv1X2fVEQhTw51lKENdNrEqT3,1,0,0,0,0,0,1,0,1,0.14285714285714285,1,0.0,0,0,0,0,0,0,0,1,0,0,1,1
8195,191190,aapkW8QMW8TztGeQlTnDfKEKcZX1vbn1,G8EPVSXsOYB5YQWZGiz1aVq5Pgr2GrQu,13,9,5,0,3,4,15,3,39,5.571428571428571,2,0.0,0,5,0,3,9,4,0,15,3,8,31,1
8196,191209,p8HUn53OHQxlBbPvpqicSSSkhMnoLuUk,A3fsA9Zfv1X2fVEQhTw51lKENdNrEqT3,1,0,0,0,0,0,1,0,1,0.14285714285714285,1,0.0,0,0,0,0,0,0,0,1,0,0,1,1
8197,191216,Rrclmw0iWTQ4R8VbZgEecyKPKpTh2o7K,SpATywNh6bZuzm8s1ceuBUnMUAeoAHHw,6,2,0,0,0,12,9,4,27,3.857142857142857,1,0.0,0,0,0,0,2,12,0,9,4,0,27,1
8198,191217,ecMZFfPrfYojsNqJQgwYc4hJSMzDZMZK,A3fsA9Zfv1X2fVEQhTw51lKENdNrEqT3,3,0,0,0,0,0,5,0,5,0.7142857142857143,2,0.0,0,0,0,0,0,0,0,5,0,0,5,1
8199,191224,3g91EUZkauWqcKpU9xr8zVzrn0H8G1A9,bWdj2GDclj5ofokWjzoa5jAwMkxCykd6,1,0,0,0,0,0,1,0,1,0.14285714285714285,1,0.0,0,0,0,0,0,0,0,1,0,0,1,1
8200,191240,z79FxI6IxKXksSKIwsXSYM1kOlaP8f6r,SpATywNh6bZuzm8s1ceuBUnMUAeoAHHw,4,5,0,0,0,0,1,0,6,0.8571428571428571,1,0.0,0,0,0,0,5,0,0,1,0,0,6,1
8201,191243,6lzjvaZGtQnKLrqzhDE3hBesO66bNsQN,SpATywNh6bZuzm8s1ceuBUnMUAeoAHHw,1,0,0,0,0,0,1,0,1,0.14285714285714285,1,0.0,0,0,0,0,0,0,0,1,0,0,1,1
8202,191248,Vl2QqZFE2XGfXDYVL2VXW5So0Zc5MScE,A3fsA9Zfv1X2fVEQhTw51lKENdNrEqT3,1,0,0,0,0,0,1,0,1,0.14285714285714285,1,0.0,0,0,0,0,0,0,0,1,0,0,1,1
8203,191266,eSnXFXUMyU3QpBQqVY71joco7MnEt79W,SpATywNh6bZuzm8s1ceuBUnMUAeoAHHw,8,5,1,0,1,0,2,0,9,1.2857142857142858,1,0.0,0,1,0,1,5,0,0,2,0,2,7,1
8204,191276,VFwcKDLRscQsLZ6sHhxlnjIEC63BsTj9,SpATywNh6bZuzm8s1ceuBUnMUAeoAHHw,5,5,0,0,0,0,1,0,6,0.8571428571428571,1,0.0,0,0,0,0,5,0,0,1,0,0,6,1
8205,191277,rqoGLMWp7ee8Ppu4OdHSBl6vmRxDZvKU,bWdj2GDclj5ofokWjzoa5jAwMkxCykd6,5,2,1,0,1,2,3,0,9,1.2857142857142858,1,0.0,0,1,0,1,2,2,0,3,0,2,7,1
8206,191282,ThbUQJBeO3JBYqtYMPK5UU7NNpR9FBno,SpATywNh6bZuzm8s1ceuBUnMUAeoAHHw,7,2,1,0,0,1,6,1,11,1.5714285714285714,1,0.0,0,1,0,0,2,1,0,6,1,1,10,1
8207,191294,bQTEZZd4jSi2B0W0A1TlEJEWBwzOd8zQ,SpATywNh6bZuzm8s1ceuBUnMUAeoAHHw,1,0,0,0,0,0,2,0,2,0.2857142857142857,1,0.0,0,0,0,0,0,0,0,2,0,0,2,1
8208,191295,kpqLFmJCsamYXFuknK3QXbLEc5jdZhta,RXDvfPUBYFlVdlueBFbLW0mhhAyGEqpt,1,0,0,0,0,0,1,0,1,0.14285714285714285,1,0.0,0,0,0,0,0,0,0,1,0,0,1,1
8209,191296,UfBZxbp3dHdvs4dmjpPF1a599SiVHfq9,SpATywNh6bZuzm8s1ceuBUnMUAeoAHHw,1,0,0,0,0,0,1,0,1,0.14285714285714285,1,0.0,0,0,0,0,0,0,0,1,0,0,1,1
8210,191301,UfBZxbp3dHdvs4dmjpPF1a599SiVHfq9,A3fsA9Zfv1X2fVEQhTw51lKENdNrEqT3,1,0,0,0,0,0,1,0,1,0.14285714285714285,1,0.0,0,0,0,0,0,0,0,1,0,0,1,0
8211,191326,bqKGVuyOqvCYIWLNoZkiDVBShCS1Solh,bWdj2GDclj5ofokWjzoa5jAwMkxCykd6,7,3,2,0,2,0,2,0,9,1.2857142857142858,1,0.0,0,2,0,2,3,0,0,2,0,4,5,1
8212,191328,d5HAnSQkztXQmCBt7mWJteYbuGp9eXK9,SpATywNh6bZuzm8s1ceuBUnMUAeoAHHw,17,11,5,16,3,1,6,1,43,6.142857142857143,1,0.0,4,5,13,3,7,1,3,6,1,25,18,0
8213,191333,u2lFPFqaHTPOsPVzurefGhIungrLsH3I,G8EPVSXsOYB5YQWZGiz1aVq5Pgr2GrQu,4,2,1,0,1,0,1,0,5,0.7142857142857143,1,0.0,0,1,0,1,2,0,0,1,0,2,3,1
8214,191336,2XCqRCsUPBJ1NAgHMrTgcxY6YdxrycrK,G8EPVSXsOYB5YQWZGiz1aVq5Pgr2GrQu,4,2,0,0,0,0,2,0,4,0.5714285714285714,1,0.0,0,0,0,0,2,0,0,2,0,0,4,1
8215,191348,SI69wwcTWVHmHvMK3iTZ6yjmoQxbU7l5,SpATywNh6bZuzm8s1ceuBUnMUAeoAHHw,10,12,0,22,0,8,5,1,48,6.857142857142857,1,0.0,6,0,20,0,6,8,2,5,1,26,22,1
8216,191352,9I8c8L7WQpD9ZtJRhVVfTlPNfkSlIEEb,SpATywNh6bZuzm8s1ceuBUnMUAeoAHHw,14,17,1,22,0,4,9,1,54,7.714285714285714,2,0.0,8,1,20,0,9,4,2,9,1,29,25,0
8217,191361,uvyVPWEsqLIlBRKFxrhWDmK1U2rKG8GE,SpATywNh6bZuzm8s1ceuBUnMUAeoAHHw,18,44,20,20,10,11,17,3,125,17.857142857142858,2,0.0,17,20,16,10,27,11,4,17,3,63,62,1
8218,191363,fayEZWE6L5NpkIRwMpEH7DP3Ho4nLIru,RXDvfPUBYFlVdlueBFbLW0mhhAyGEqpt,7,4,0,0,0,0,3,0,7,1.0,1,0.0,0,0,0,0,4,0,0,3,0,0,7,1
8219,191366,CRRYXyAc4ijr26PN9CuVczNnv8kJ91AK,SpATywNh6bZuzm8s1ceuBUnMUAeoAHHw,9,8,4,0,2,0,5,0,19,2.7142857142857144,1,0.0,2,4,0,2,6,0,0,5,0,8,11,1
8220,191379,Ieqd5itEcYJJN0R1exEtlEqnGZPAbCE6,bWdj2GDclj5ofokWjzoa5jAwMkxCykd6,4,3,1,0,1,0,1,0,6,0.8571428571428571,1,0.0,0,1,0,1,3,0,0,1,0,2,4,1
8221,191384,dmUrk0xMCS6SDyaouVCuyhAM6JJFFbys,SpATywNh6bZuzm8s1ceuBUnMUAeoAHHw,5,3,0,0,0,2,4,0,9,1.2857142857142858,1,0.0,0,0,0,0,3,2,0,4,0,0,9,1
8222,191389,smdC4Gk5L0XnGuMq4y1IOb0E2yVqYROb,SpATywNh6bZuzm8s1ceuBUnMUAeoAHHw,3,0,0,0,0,1,2,0,3,0.42857142857142855,1,0.0,0,0,0,0,0,1,0,2,0,0,3,1
8223,191398,ArHJamcmypPdkqgLXvwA7Xp8QRSvXxlF,SpATywNh6bZuzm8s1ceuBUnMUAeoAHHw,7,3,2,0,2,0,2,0,9,1.2857142857142858,1,0.0,0,2,0,2,3,0,0,2,0,4,5,1
8224,191409,uIv1Q8Ye5xXUaFW9tumYDZDxTsrCfpst,SpATywNh6bZuzm8s1ceuBUnMUAeoAHHw,1,0,0,0,0,0,1,0,1,0.14285714285714285,1,0.0,0,0,0,0,0,0,0,1,0,0,1,1
8225,191419,S4sULDuFAQWAEdmQxVT34py82agUl29W,bWdj2GDclj5ofokWjzoa5jAwMkxCykd6,6,1,1,0,1,0,3,0,6,0.8571428571428571,1,0.0,0,1,0,1,1,0,0,3,0,2,4,1
8226,191424,dnQdmZcm7uKA0vljQm6kJeP4CqW8fiMU,SpATywNh6bZuzm8s1ceuBUnMUAeoAHHw,5,2,1,0,1,0,2,0,6,0.8571428571428571,1,0.0,0,1,0,1,2,0,0,2,0,2,4,1
8227,191440,y1w3D4hQ1692TSq31BiNSwe5l2ooxLrJ,SpATywNh6bZuzm8s1ceuBUnMUAeoAHHw,7,2,1,0,1,0,4,0,8,1.1428571428571428,1,0.0,0,1,0,1,2,0,0,4,0,2,6,1
8228,191458,N9XRkzLdEnO1yDrNCc5jLvv7TriIRXAT,SpATywNh6bZuzm8s1ceuBUnMUAeoAHHw,9,4,2,0,1,0,8,1,16,2.2857142857142856,1,0.0,0,2,0,1,4,0,0,8,1,3,13,1
8229,191479,lcq8rKaAKyasaLAhf4XgwtdTDaLQpKXs,G8EPVSXsOYB5YQWZGiz1aVq5Pgr2GrQu,1,0,0,0,0,0,1,0,1,0.14285714285714285,1,0.0,0,0,0,0,0,0,0,1,0,0,1,1
8230,191482,qV9YvOiEawMvqxu18S9WhO9WLokOJG0e,SpATywNh6bZuzm8s1ceuBUnMUAeoAHHw,16,26,13,16,5,10,11,1,82,11.714285714285714,1,0.0,7,13,14,5,19,10,2,11,1,39,43,1
8231,191505,MRzfDn8Dt6xZQHTAuGEWQiuznoHxxpTX,G8EPVSXsOYB5YQWZGiz1aVq5Pgr2GrQu,1,0,0,0,0,0,1,0,1,0.14285714285714285,1,0.0,0,0,0,0,0,0,0,1,0,0,1,1
8232,191507,JIbJQhNgua4oE3gk86Jkguj8qmM444Gu,A3fsA9Zfv1X2fVEQhTw51lKENdNrEqT3,1,0,0,0,0,0,1,0,1,0.14285714285714285,1,0.0,0,0,0,0,0,0,0,1,0,0,1,1
8233,191531,zFJwABbnu7ecHOUlCE6eTmrBM1zbvMVg,SpATywNh6bZuzm8s1ceuBUnMUAeoAHHw,7,3,2,0,2,0,2,0,9,1.2857142857142858,1,0.0,0,2,0,2,3,0,0,2,0,4,5,1
8234,191534,wme4hkVddg0xzeatj2MinEZLWEQ5E7bR,SpATywNh6bZuzm8s1ceuBUnMUAeoAHHw,1,0,0,0,0,0,1,0,1,0.14285714285714285,1,0.0,0,0,0,0,0,0,0,1,0,0,1,1
8235,191545,xe9PdHtL47ijNdtrDmdC73RUGIc061NJ,SpATywNh6bZuzm8s1ceuBUnMUAeoAHHw,7,5,2,0,2,0,2,0,11,1.5714285714285714,1,0.0,0,2,0,2,5,0,0,2,0,4,7,1
8236,191560,lQY8mxQRqkTrX8U3ZBCC39fTp3ibXjgY,A3fsA9Zfv1X2fVEQhTw51lKENdNrEqT3,1,0,0,0,0,0,1,0,1,0.14285714285714285,1,0.0,0,0,0,0,0,0,0,1,0,0,1,1
8237,191562,LzUunErgfx3QBtzhgVcWGMItAqeQB5qb,bWdj2GDclj5ofokWjzoa5jAwMkxCykd6,10,20,7,44,8,0,16,0,95,13.571428571428571,2,0.0,3,7,42,8,17,0,2,16,0,60,35,1
8238,191570,8O8F8lqVhamnWAYoriozJh1JpqbQqAoe,SpATywNh6bZuzm8s1ceuBUnMUAeoAHHw,15,34,14,18,7,1,7,1,82,11.714285714285714,1,0.0,12,14,17,7,22,1,1,7,1,50,32,1
8239,191577,O9WtdqogfiBdd3zkscxK6K63kFz00EHp,SpATywNh6bZuzm8s1ceuBUnMUAeoAHHw,4,3,1,0,1,0,1,0,6,0.8571428571428571,1,0.0,0,1,0,1,3,0,0,1,0,2,4,1
8240,191578,BPpNiGtPp3VJWjhMdlZulJsFMsfFBZVO,SpATywNh6bZuzm8s1ceuBUnMUAeoAHHw,1,0,0,0,0,0,1,0,1,0.14285714285714285,1,0.0,0,0,0,0,0,0,0,1,0,0,1,1
8241,191579,ZP3SwNjKPikYYkMi8mCd8YXWyZ9QqocI,SpATywNh6bZuzm8s1ceuBUnMUAeoAHHw,15,13,6,16,5,0,6,0,46,6.571428571428571,1,0.0,6,6,13,5,7,0,3,6,0,30,16,1
8242,191585,7GKeqKRq8nTlHW07udIOaXEQQyokdI9X,G8EPVSXsOYB5YQWZGiz1aVq5Pgr2GrQu,12,9,5,6,5,0,2,0,27,3.857142857142857,1,0.0,3,5,3,5,6,0,3,2,0,16,11,1
8243,191591,PowQ1NVYMTVwKWPXrRw8LaXCisXsIuwA,SpATywNh6bZuzm8s1ceuBUnMUAeoAHHw,8,7,2,0,1,0,4,0,14,2.0,1,0.0,0,2,0,1,7,0,0,4,0,3,11,1
8244,191594,HaJu4RsCsmkTJbtFh34ypsakOUnNCikb,SpATywNh6bZuzm8s1ceuBUnMUAeoAHHw,1,0,0,0,0,0,1,0,1,0.14285714285714285,1,0.0,0,0,0,0,0,0,0,1,0,0,1,1
8245,191598,9Gr4ivUbGE9SyepAFZz19vI7kz7neHyv,SpATywNh6bZuzm8s1ceuBUnMUAeoAHHw,4,1,0,0,0,0,4,0,5,0.7142857142857143,1,0.0,0,0,0,0,1,0,0,4,0,0,5,1
8246,191608,K3reDywuca5r3zDnGu7WqoG47Og2VsxH,SpATywNh6bZuzm8s1ceuBUnMUAeoAHHw,8,10,5,0,2,1,12,0,30,4.285714285714286,1,0.0,0,5,0,2,10,1,0,12,0,7,23,0
8247,191621,01qQ2I7uJit5AcT5N3y2JZTjrStNpmSM,A3fsA9Zfv1X2fVEQhTw51lKENdNrEqT3,1,0,0,0,0,0,1,0,1,0.14285714285714285,1,0.0,0,0,0,0,0,0,0,1,0,0,1,1
8248,191628,WlHV3frRLxQmTIY14HccRXj4N1zg8F2y,bWdj2GDclj5ofokWjzoa5jAwMkxCykd6,1,0,0,0,0,0,1,0,1,0.14285714285714285,1,0.0,0,0,0,0,0,0,0,1,0,0,1,1
8249,191645,2m7SzUThbQ51vSBFUnCl1CYaMYSooUEI,bWdj2GDclj5ofokWjzoa5jAwMkxCykd6,4,2,1,0,1,0,1,0,5,0.7142857142857143,1,0.0,0,1,0,1,2,0,0,1,0,2,3,1
8250,191648,Xl3alXCSFw7Pm6L09eZSxygjyh6OTCwK,SpATywNh6bZuzm8s1ceuBUnMUAeoAHHw,7,4,2,0,2,1,2,0,11,1.5714285714285714,1,0.0,0,2,0,2,4,1,0,2,0,4,7,1
8251,191653,5MNPQvl4M43vX9Ck1VibapAl5kRKA0Ky,SpATywNh6bZuzm8s1ceuBUnMUAeoAHHw,5,3,1,0,1,0,1,0,6,0.8571428571428571,1,0.0,0,1,0,1,3,0,0,1,0,2,4,1
8252,191654,pOCc4XSnI7H8LGdDjvbS3fdE3PxuanE9,SpATywNh6bZuzm8s1ceuBUnMUAeoAHHw,4,2,1,0,1,2,2,0,8,1.1428571428571428,1,0.0,0,1,0,1,2,2,0,2,0,2,6,1
8253,191658,rrHRbXLg6i4u3JAIzGOFXJzGViekqHta,bWdj2GDclj5ofokWjzoa5jAwMkxCykd6,1,0,0,0,0,0,1,0,1,0.14285714285714285,1,0.0,0,0,0,0,0,0,0,1,0,0,1,1
8254,191667,jLTXtk76CIwYt4vY9Qrj5n40JdJeuHTk,SpATywNh6bZuzm8s1ceuBUnMUAeoAHHw,10,8,1,20,0,9,7,1,46,6.571428571428571,2,0.0,2,1,16,0,6,9,4,7,1,19,27,1
8255,191673,eEQqKnaUGHJzSnB7MrBGgZfDTYsV36xI,SpATywNh6bZuzm8s1ceuBUnMUAeoAHHw,5,2,1,0,1,0,2,0,6,0.8571428571428571,1,0.0,0,1,0,1,2,0,0,2,0,2,4,1
8256,191681,poTjed6dzFzOdJfGIhM72y1g95A9uYj5,SpATywNh6bZuzm8s1ceuBUnMUAeoAHHw,4,2,1,0,1,0,1,0,5,0.7142857142857143,1,0.0,0,1,0,1,2,0,0,1,0,2,3,1
8257,191683,hzmNiaPcq2EodwDNxyNnOX6tvxR9MJ1N,SpATywNh6bZuzm8s1ceuBUnMUAeoAHHw,5,2,1,0,1,0,2,0,6,0.8571428571428571,1,0.0,0,1,0,1,2,0,0,2,0,2,4,1
8258,191684,voXAnjlRro0uKeE7Bhzlc3B8ctN5va8G,A3fsA9Zfv1X2fVEQhTw51lKENdNrEqT3,1,0,0,0,0,0,1,0,1,0.14285714285714285,1,0.0,0,0,0,0,0,0,0,1,0,0,1,1
8259,191689,KNNMSW3oLxGqEqv2czanNkhQgdUkOWgY,SpATywNh6bZuzm8s1ceuBUnMUAeoAHHw,1,0,0,0,0,0,1,0,1,0.14285714285714285,1,0.0,0,0,0,0,0,0,0,1,0,0,1,1
8260,191694,WpYtemwKZQxcuLGpndx0lQojfh6o5GOv,A3fsA9Zfv1X2fVEQhTw51lKENdNrEqT3,1,0,0,0,0,0,1,0,1,0.14285714285714285,1,0.0,0,0,0,0,0,0,0,1,0,0,1,1
8261,191705,GfTG7Jl5LqR9ys6qGsGxQl3P09Y2SKWt,SpATywNh6bZuzm8s1ceuBUnMUAeoAHHw,6,4,1,0,1,0,2,0,8,1.1428571428571428,1,0.0,0,1,0,1,4,0,0,2,0,2,6,1
8262,191718,eIW9M0Trkt0EiuTzN2HuEtF6QnUOm4E9,G8EPVSXsOYB5YQWZGiz1aVq5Pgr2GrQu,1,0,0,0,0,0,1,0,1,0.14285714285714285,1,0.0,0,0,0,0,0,0,0,1,0,0,1,1
8263,191719,KFU9DDalEkLY57CnYLljzPh20kfkJgg1,SpATywNh6bZuzm8s1ceuBUnMUAeoAHHw,1,0,0,0,0,0,3,0,3,0.42857142857142855,1,0.0,0,0,0,0,0,0,0,3,0,0,3,1
8264,191736,7891kkT0UkgzTiNar1WxxiRFlwbJEBnB,SpATywNh6bZuzm8s1ceuBUnMUAeoAHHw,10,24,10,3,5,0,2,0,44,6.285714285714286,1,0.0,5,10,3,5,19,0,0,2,0,23,21,1
8265,191746,Yy2T8AQun3h4tOt3dyFcuzCw5XOF0cCp,SpATywNh6bZuzm8s1ceuBUnMUAeoAHHw,1,0,0,0,0,0,2,0,2,0.2857142857142857,1,0.0,0,0,0,0,0,0,0,2,0,0,2,1
8266,191756,Nw8BNhwzOdO3iOxqT3HR1nBiyOtFleo0,SpATywNh6bZuzm8s1ceuBUnMUAeoAHHw,1,0,0,0,0,0,1,0,1,0.14285714285714285,1,0.0,0,0,0,0,0,0,0,1,0,0,1,1
8267,191760,xdfT7UfbG0ewFi6FNN3zlNGBGpobyBrO,RXDvfPUBYFlVdlueBFbLW0mhhAyGEqpt,6,6,0,0,0,0,5,2,13,1.8571428571428572,1,0.0,0,0,0,0,6,0,0,5,2,0,13,1
8268,191773,LuPgMCIdX2ugHzDAngaEsA394qOat0id,A3fsA9Zfv1X2fVEQhTw51lKENdNrEqT3,11,10,5,0,1,0,6,0,22,3.142857142857143,2,0.0,0,5,0,1,10,0,0,6,0,6,16,1
8269,191798,HsUrz2Tvq8sRzoPDsx1zZZFVKu21a9Fj,A3fsA9Zfv1X2fVEQhTw51lKENdNrEqT3,1,0,0,0,0,0,1,0,1,0.14285714285714285,1,0.0,0,0,0,0,0,0,0,1,0,0,1,1
8270,191799,sxhiQuS3HfySJYy4LOfQjplyCzgTKScO,SpATywNh6bZuzm8s1ceuBUnMUAeoAHHw,7,8,4,0,0,0,6,3,21,3.0,1,0.0,0,4,0,0,8,0,0,6,3,4,17,1
8271,191802,kadlP2QWuFIFKLOUJo5sW8v7B7XAv9LQ,SpATywNh6bZuzm8s1ceuBUnMUAeoAHHw,5,3,1,0,1,0,2,0,7,1.0,1,0.0,0,1,0,1,3,0,0,2,0,2,5,1
8272,191804,MU4dVyJTD7iIRSTZIdJZ9VoLOxogfKQN,bWdj2GDclj5ofokWjzoa5jAwMkxCykd6,2,0,0,0,0,0,2,0,2,0.2857142857142857,1,0.0,0,0,0,0,0,0,0,2,0,0,2,1
8273,191808,QhgZ8WnXOcD5WE8AKIXP6yesa48bioAv,G8EPVSXsOYB5YQWZGiz1aVq5Pgr2GrQu,1,0,0,0,0,0,1,0,1,0.14285714285714285,1,0.0,0,0,0,0,0,0,0,1,0,0,1,1
8274,191812,glVCC77LfitTkPbkpypiclvPPbAnhs5Z,SpATywNh6bZuzm8s1ceuBUnMUAeoAHHw,1,0,0,0,0,0,1,0,1,0.14285714285714285,1,0.0,0,0,0,0,0,0,0,1,0,0,1,1
8275,191821,IERsxa1qtpNEp0IX6fqnPIs58eKAo4jM,RXDvfPUBYFlVdlueBFbLW0mhhAyGEqpt,3,2,1,0,0,0,1,0,4,0.5714285714285714,1,0.0,0,1,0,0,2,0,0,1,0,1,3,1
8276,191834,xFQWFF18peOPGJbc58SGDlEI5nMMZqZ4,SpATywNh6bZuzm8s1ceuBUnMUAeoAHHw,16,11,4,19,3,1,6,1,45,6.428571428571429,1,0.0,6,4,17,3,5,1,2,6,1,30,15,1
8277,191845,HL02PKMnOIDdiDp79NgTxbZJpjcKEWWT,SpATywNh6bZuzm8s1ceuBUnMUAeoAHHw,5,5,1,0,1,0,1,0,8,1.1428571428571428,1,0.0,0,1,0,1,5,0,0,1,0,2,6,1
8278,191893,F90BMBHCwVLSbJKgbHhGlOavE20yEHNs,SpATywNh6bZuzm8s1ceuBUnMUAeoAHHw,7,1,1,0,1,1,4,1,9,1.2857142857142858,1,0.0,0,1,0,1,1,1,0,4,1,2,7,1
8279,191919,eh0y0gctBGer07yOzwET1ULsjXcAMiHK,A3fsA9Zfv1X2fVEQhTw51lKENdNrEqT3,1,0,0,0,0,0,1,0,1,0.14285714285714285,1,0.0,0,0,0,0,0,0,0,1,0,0,1,1
8280,191927,e7i4vctFK9ije7n1OkadHlIYbLm8AOao,A3fsA9Zfv1X2fVEQhTw51lKENdNrEqT3,1,0,0,0,0,0,1,0,1,0.14285714285714285,1,0.0,0,0,0,0,0,0,0,1,0,0,1,1
8281,191930,Y0uNzgYoq3o4UIUWA7DyI9uIWevNL2UZ,SpATywNh6bZuzm8s1ceuBUnMUAeoAHHw,1,0,0,0,0,0,1,0,1,0.14285714285714285,1,0.0,0,0,0,0,0,0,0,1,0,0,1,1
8282,191936,pVHJZ63Y7JdfMuJUTvroL7qbSGOfkgFO,SpATywNh6bZuzm8s1ceuBUnMUAeoAHHw,1,0,0,0,0,0,1,0,1,0.14285714285714285,1,0.0,0,0,0,0,0,0,0,1,0,0,1,1
8283,191946,X14gKVD1ZKu0qL0NchpqxwhoYSEpz9QI,A3fsA9Zfv1X2fVEQhTw51lKENdNrEqT3,1,0,0,0,0,0,1,0,1,0.14285714285714285,1,0.0,0,0,0,0,0,0,0,1,0,0,1,1
8284,191949,5nY7bkwDkC2HlVFlWmyBFJRNx9a0SeRf,SpATywNh6bZuzm8s1ceuBUnMUAeoAHHw,6,6,2,0,1,0,2,0,11,1.5714285714285714,1,0.0,2,2,0,1,4,0,0,2,0,5,6,1
8285,191957,q8qv4J0WokPksYuUIg2pKKJs5I4YE8LL,bWdj2GDclj5ofokWjzoa5jAwMkxCykd6,7,5,3,0,1,0,4,0,13,1.8571428571428572,1,0.0,0,3,0,1,5,0,0,4,0,4,9,1
8286,191961,XirdNKPxR3QK6AqsS5xwiQuah55CHklz,SpATywNh6bZuzm8s1ceuBUnMUAeoAHHw,6,4,1,0,1,0,2,0,8,1.1428571428571428,1,0.0,0,1,0,1,4,0,0,2,0,2,6,1
8287,191970,guhTAC2wGHeGVbnCgc8qjrM4m2j0yBgB,bWdj2GDclj5ofokWjzoa5jAwMkxCykd6,7,5,2,0,3,0,3,0,13,1.8571428571428572,1,0.0,2,2,0,3,3,0,0,3,0,7,6,1
8288,191977,ECkqmAuIkv3ncN9wNJby8oOn15qTd9kR,SpATywNh6bZuzm8s1ceuBUnMUAeoAHHw,3,2,0,0,0,0,4,0,6,0.8571428571428571,2,0.0,0,0,0,0,2,0,0,4,0,0,6,1
8289,191981,1kpLB0DAS1b0ejanJYSedd5z8Kef2r9d,SpATywNh6bZuzm8s1ceuBUnMUAeoAHHw,6,5,3,0,2,0,3,0,13,1.8571428571428572,2,0.0,0,3,0,2,5,0,0,3,0,5,8,1
8290,191987,guhTAC2wGHeGVbnCgc8qjrM4m2j0yBgB,A3fsA9Zfv1X2fVEQhTw51lKENdNrEqT3,20,11,8,0,5,2,8,1,35,5.0,2,0.0,0,8,0,5,11,2,0,8,1,13,22,0
8291,191992,LW6zzfd6Z7RUZZtZGyYDx5y4SX3cBpdo,SpATywNh6bZuzm8s1ceuBUnMUAeoAHHw,4,6,0,0,0,0,3,0,9,1.2857142857142858,1,0.0,0,0,0,0,6,0,0,3,0,0,9,1
8292,192004,E3N8Ml469xlgFPJmAY5Sxe1V7qT3zvY6,SpATywNh6bZuzm8s1ceuBUnMUAeoAHHw,5,2,1,0,1,0,2,0,6,0.8571428571428571,1,0.0,0,1,0,1,2,0,0,2,0,2,4,1
8293,192005,co2tEDTUQOPBlFecfyW4CBakQdUodp0x,A3fsA9Zfv1X2fVEQhTw51lKENdNrEqT3,1,0,0,0,0,0,1,0,1,0.14285714285714285,1,0.0,0,0,0,0,0,0,0,1,0,0,1,1
8294,192010,tAelht5FQdpcbtZQoKgvZA90XQy6zeRb,SpATywNh6bZuzm8s1ceuBUnMUAeoAHHw,1,0,0,0,0,0,1,0,1,0.14285714285714285,1,0.0,0,0,0,0,0,0,0,1,0,0,1,1
8295,192012,br6ITMcvmAAwree2VNmUR9deXubPoM9q,G8EPVSXsOYB5YQWZGiz1aVq5Pgr2GrQu,3,0,0,0,0,0,3,0,3,0.42857142857142855,1,0.0,0,0,0,0,0,0,0,3,0,0,3,1
8296,192018,eotRm6Y2SbyKhVlLkGLDzSxdsKqSBO9y,SpATywNh6bZuzm8s1ceuBUnMUAeoAHHw,6,3,2,0,2,0,1,0,8,1.1428571428571428,1,0.0,0,2,0,2,3,0,0,1,0,4,4,1
8297,192024,Q12SmIgxAUIk1yKqjdfp0LXtJMgJdL9G,SpATywNh6bZuzm8s1ceuBUnMUAeoAHHw,6,3,2,0,2,0,1,0,8,1.1428571428571428,1,0.0,0,2,0,2,3,0,0,1,0,4,4,1
8298,192034,6BEGVp3lU36uMYUemMIuUfA5VThOFY5Z,SpATywNh6bZuzm8s1ceuBUnMUAeoAHHw,3,2,0,0,0,0,1,0,3,0.42857142857142855,1,0.0,0,0,0,0,2,0,0,1,0,0,3,0
8299,192039,JuuQdyakOE1dmJoAhQzVgyBgj45A1hjb,G8EPVSXsOYB5YQWZGiz1aVq5Pgr2GrQu,6,2,1,0,1,0,3,0,7,1.0,1,0.0,0,1,0,1,2,0,0,3,0,2,5,1
8300,192050,dQYdXrn6Y9f5Ts4mUHKMqkz2QoUbyo9u,SpATywNh6bZuzm8s1ceuBUnMUAeoAHHw,10,16,7,0,0,1,6,1,31,4.428571428571429,1,0.0,6,7,0,0,10,1,0,6,1,13,18,1
8301,192058,rv4ArbR8ug8w4z8sISrvrxALsLkp46Ty,bWdj2GDclj5ofokWjzoa5jAwMkxCykd6,6,23,0,0,0,0,5,0,28,4.0,1,0.0,4,0,0,0,19,0,0,5,0,4,24,1
8302,192065,FaNPo4Qqcy5TdmFUv8WUTRgDMV0ZgbCp,RXDvfPUBYFlVdlueBFbLW0mhhAyGEqpt,19,10,7,22,5,0,2,0,46,6.571428571428571,1,0.0,2,7,20,5,8,0,2,2,0,34,12,1
8303,192091,dmhkL35doRyRiXlb3XuDnJlpO05GLvg1,SpATywNh6bZuzm8s1ceuBUnMUAeoAHHw,4,3,1,0,1,0,2,0,7,1.0,1,0.0,0,1,0,1,3,0,0,2,0,2,5,1
8304,192098,LTXDIL613XcTInp5rf7qYUY6DFOgTe7d,G8EPVSXsOYB5YQWZGiz1aVq5Pgr2GrQu,6,4,1,0,2,0,7,0,14,2.0,1,0.0,2,1,0,2,2,0,0,7,0,5,9,0
8305,192109,BlzehVS9w06tJmaZKz9FlNz9VFUjaNUH,G8EPVSXsOYB5YQWZGiz1aVq5Pgr2GrQu,5,2,0,0,0,0,3,0,5,0.7142857142857143,1,0.0,0,0,0,0,2,0,0,3,0,0,5,1
8306,192117,TiNNJ9dGwnc8LtrTW4Oq8UzJGxXCWpRS,A3fsA9Zfv1X2fVEQhTw51lKENdNrEqT3,1,0,0,0,0,0,1,0,1,0.14285714285714285,1,0.0,0,0,0,0,0,0,0,1,0,0,1,1
8307,192125,PhoKgDlJTLmZpXJ7XlrprWN3ANMNNAAs,SpATywNh6bZuzm8s1ceuBUnMUAeoAHHw,7,3,1,0,1,0,5,0,10,1.4285714285714286,1,0.0,0,1,0,1,3,0,0,5,0,2,8,1
8308,192134,vsDIa2pTzMsANsuFnkRlfs0CNdNFRShO,bWdj2GDclj5ofokWjzoa5jAwMkxCykd6,1,0,0,0,0,0,1,0,1,0.14285714285714285,1,0.0,0,0,0,0,0,0,0,1,0,0,1,1
8309,192141,vsDIa2pTzMsANsuFnkRlfs0CNdNFRShO,RXDvfPUBYFlVdlueBFbLW0mhhAyGEqpt,1,0,0,0,0,0,1,0,1,0.14285714285714285,1,0.0,0,0,0,0,0,0,0,1,0,0,1,1
8310,192147,luNGlNTmJ26UVXohAPNf4yZNgIUDcpxK,RXDvfPUBYFlVdlueBFbLW0mhhAyGEqpt,1,0,0,0,0,0,1,0,1,0.14285714285714285,1,0.0,0,0,0,0,0,0,0,1,0,0,1,1
8311,192149,kz806LJqSjCWsOsMbb4QF8SkTWd8OARr,bWdj2GDclj5ofokWjzoa5jAwMkxCykd6,5,2,0,0,0,0,9,0,11,1.5714285714285714,1,0.0,0,0,0,0,2,0,0,9,0,0,11,1
8312,192150,luNGlNTmJ26UVXohAPNf4yZNgIUDcpxK,A3fsA9Zfv1X2fVEQhTw51lKENdNrEqT3,1,0,0,0,0,0,1,0,1,0.14285714285714285,1,0.0,0,0,0,0,0,0,0,1,0,0,1,1
8313,192176,UAWEvfipqNVrtAY7A1ItWPIZCE9n4bC0,A3fsA9Zfv1X2fVEQhTw51lKENdNrEqT3,1,0,0,0,0,0,1,0,1,0.14285714285714285,1,0.0,0,0,0,0,0,0,0,1,0,0,1,1
8314,192185,REBUdT3PdwenVsbHSd8vx9j28veewpFY,G8EPVSXsOYB5YQWZGiz1aVq5Pgr2GrQu,1,0,0,0,0,0,3,0,3,0.42857142857142855,1,0.0,0,0,0,0,0,0,0,3,0,0,3,1
8315,192186,JQ24AQoZsOQkDbcWerb6XGxtCwcxcjqd,SpATywNh6bZuzm8s1ceuBUnMUAeoAHHw,4,2,0,0,0,0,2,0,4,0.5714285714285714,1,0.0,0,0,0,0,2,0,0,2,0,0,4,1
8316,192194,lHTZAvBbd0zcUoZ0ZCqy0WxYTp3sveXN,SpATywNh6bZuzm8s1ceuBUnMUAeoAHHw,3,2,0,0,0,0,1,0,3,0.42857142857142855,1,0.0,0,0,0,0,2,0,0,1,0,0,3,1
8317,192209,Qws7jSORIWaamW2WkksSfXYG3Zz7g3Xb,SpATywNh6bZuzm8s1ceuBUnMUAeoAHHw,5,2,1,0,1,0,3,0,7,1.0,1,0.0,0,1,0,1,2,0,0,3,0,2,5,1
8318,192216,WqVnvIDeqK0FV6SVy7LE13jQheJAXDUI,SpATywNh6bZuzm8s1ceuBUnMUAeoAHHw,6,3,0,0,1,0,2,0,6,0.8571428571428571,1,0.0,0,0,0,1,3,0,0,2,0,1,5,1
8319,192217,AcQwcLzGnWU6HJG1JegBGJmpymCdTsiJ,SpATywNh6bZuzm8s1ceuBUnMUAeoAHHw,1,0,0,0,0,0,1,0,1,0.14285714285714285,1,0.0,0,0,0,0,0,0,0,1,0,0,1,1
8320,192223,DtCbpRVw6ZPHzvqt3yEtockBy9bOvWMU,SpATywNh6bZuzm8s1ceuBUnMUAeoAHHw,15,31,9,18,5,0,3,0,66,9.428571428571429,1,0.0,13,9,16,5,18,0,2,3,0,43,23,1
8321,192225,RFIYCucE5KCs9Bz4puoVDGPVmKoCQR4H,SpATywNh6bZuzm8s1ceuBUnMUAeoAHHw,1,0,0,0,0,0,1,0,1,0.14285714285714285,1,0.0,0,0,0,0,0,0,0,1,0,0,1,1
8322,192230,SMcFR1tzrGAErGanrAOTaiQacFJ5UscL,SpATywNh6bZuzm8s1ceuBUnMUAeoAHHw,6,2,1,0,1,0,3,1,8,1.1428571428571428,1,0.0,0,1,0,1,2,0,0,3,1,2,6,1
8323,192233,Av0so8JeZkL37S3USay6JyAc2H9w3WcS,SpATywNh6bZuzm8s1ceuBUnMUAeoAHHw,8,8,1,0,1,0,2,0,12,1.7142857142857142,1,0.0,1,1,0,1,7,0,0,2,0,3,9,1
8324,192236,4WRiJt7yDLRdAnLXyL07imUb9PD066er,SpATywNh6bZuzm8s1ceuBUnMUAeoAHHw,7,1,1,0,1,1,9,3,16,2.2857142857142856,2,0.0,0,1,0,1,1,1,0,9,3,2,14,1
8325,192247,HR02YAHzGFr2hdShoIiTumT2tyoMXoiF,SpATywNh6bZuzm8s1ceuBUnMUAeoAHHw,7,5,0,0,0,0,5,1,11,1.5714285714285714,2,0.0,0,0,0,0,5,0,0,5,1,0,11,1
8326,192248,Qb1CgQ8SxoQQTE8swhxPBVi0nI23eAzb,bWdj2GDclj5ofokWjzoa5jAwMkxCykd6,11,21,9,16,6,1,6,1,60,8.571428571428571,2,0.0,3,9,16,6,18,1,0,6,1,34,26,1
8327,192253,HTVs7V0e4g4fF28WOVqp2vXklALtMpIX,RXDvfPUBYFlVdlueBFbLW0mhhAyGEqpt,1,0,0,0,0,0,1,0,1,0.14285714285714285,1,0.0,0,0,0,0,0,0,0,1,0,0,1,1
8328,192265,NE6VVAXhm16C7ZaHLYFeGaAbJXqSbS5P,SpATywNh6bZuzm8s1ceuBUnMUAeoAHHw,1,0,0,0,0,0,1,0,1,0.14285714285714285,1,0.0,0,0,0,0,0,0,0,1,0,0,1,1
8329,192272,AE77uBYkDOA4olq3PELAlnphtU2v0TDL,A3fsA9Zfv1X2fVEQhTw51lKENdNrEqT3,1,0,0,0,0,0,1,0,1,0.14285714285714285,1,0.0,0,0,0,0,0,0,0,1,0,0,1,1
8330,192281,oOq0KGCcuj3zSTyAkLmOA3bz1mpT4Cy2,SpATywNh6bZuzm8s1ceuBUnMUAeoAHHw,1,0,0,0,0,0,1,0,1,0.14285714285714285,1,0.0,0,0,0,0,0,0,0,1,0,0,1,1
8331,192285,DanoP5XpHODQZmwuFGZgNKBiu5nY9yH1,RXDvfPUBYFlVdlueBFbLW0mhhAyGEqpt,6,5,4,0,2,0,1,0,12,1.7142857142857142,1,0.0,0,4,0,2,5,0,0,1,0,6,6,1
8332,192293,k0fNZidBUd2gbryk31YveUTLLwvsjsHF,A3fsA9Zfv1X2fVEQhTw51lKENdNrEqT3,1,0,0,0,0,0,1,0,1,0.14285714285714285,1,0.0,0,0,0,0,0,0,0,1,0,0,1,1
8333,192300,4YD7ENfnhFTRFL7ILKgGgEPnhlw4hbFM,SpATywNh6bZuzm8s1ceuBUnMUAeoAHHw,6,3,1,0,1,0,2,0,7,1.0,1,0.0,0,1,0,1,3,0,0,2,0,2,5,1
8334,192306,ypGCuSMoTu4jFEklb1OmiXvUyZSt3GFy,A3fsA9Zfv1X2fVEQhTw51lKENdNrEqT3,1,0,0,0,0,0,1,0,1,0.14285714285714285,1,0.0,0,0,0,0,0,0,0,1,0,0,1,1
8335,192308,5Vw6FQuIrDyG4P6UKq7rbidOHP4recgB,SpATywNh6bZuzm8s1ceuBUnMUAeoAHHw,1,0,0,0,0,0,1,0,1,0.14285714285714285,1,0.0,0,0,0,0,0,0,0,1,0,0,1,1
8336,192310,pr4S9UwIGe9A49oNuW5UlWpQYB2ZSYV0,SpATywNh6bZuzm8s1ceuBUnMUAeoAHHw,2,0,0,0,0,0,2,0,2,0.2857142857142857,1,0.0,0,0,0,0,0,0,0,2,0,0,2,1
8337,192329,SgmklvgEB9LRwbyM7mjtFwPn2s1gjHGn,A3fsA9Zfv1X2fVEQhTw51lKENdNrEqT3,1,0,0,0,0,0,1,0,1,0.14285714285714285,1,0.0,0,0,0,0,0,0,0,1,0,0,1,1
8338,192356,3T8jD055VA7hJ3tuRSbjf4ntse0zAX7A,bWdj2GDclj5ofokWjzoa5jAwMkxCykd6,8,15,4,0,2,1,8,1,31,4.428571428571429,1,0.0,6,4,0,2,9,1,0,8,1,12,19,1
8339,192365,ooAUGXFOFAguQ9s1QlStBjM610gDeFBk,bWdj2GDclj5ofokWjzoa5jAwMkxCykd6,8,7,4,0,3,0,3,0,17,2.4285714285714284,1,0.0,0,4,0,3,7,0,0,3,0,7,10,1
8340,192376,JuG3mNYUQgxAVzPcc7Ar48FfL6xAPMUZ,SpATywNh6bZuzm8s1ceuBUnMUAeoAHHw,6,6,1,0,1,0,2,0,10,1.4285714285714286,1,0.0,3,1,0,1,3,0,0,2,0,5,5,1
8341,192381,cfgt4lcsD0BLDwVvHK3CK5jqeK8KZQhZ,SpATywNh6bZuzm8s1ceuBUnMUAeoAHHw,8,2,1,0,1,2,5,2,13,1.8571428571428572,1,0.0,0,1,0,1,2,2,0,5,2,2,11,1
8342,192384,eGRaiLXqwboqQlaTTQYr1FB1cM61jV4I,RXDvfPUBYFlVdlueBFbLW0mhhAyGEqpt,2,0,0,0,0,0,2,0,2,0.2857142857142857,1,0.0,0,0,0,0,0,0,0,2,0,0,2,1
8343,192402,waC8kf8PXJ6GslXvkly6fK7T4isyWaN7,bWdj2GDclj5ofokWjzoa5jAwMkxCykd6,11,6,4,0,3,3,8,1,25,3.5714285714285716,2,0.0,0,4,0,3,6,3,0,8,1,7,18,1
8344,192404,FmxPauZCcN5TsI90By7Uh5tN8Q2Qo10j,A3fsA9Zfv1X2fVEQhTw51lKENdNrEqT3,1,0,0,0,0,0,2,0,2,0.2857142857142857,1,0.0,0,0,0,0,0,0,0,2,0,0,2,1
8345,192407,RVzC5vQBqN30AW6Su7sjAfdP0iWczm3N,G8EPVSXsOYB5YQWZGiz1aVq5Pgr2GrQu,13,8,5,0,3,0,9,0,25,3.5714285714285716,1,0.0,0,5,0,3,8,0,0,9,0,8,17,1
8346,192413,1StpqFExawTnYrEXKci6A5cFxEzx53P4,RXDvfPUBYFlVdlueBFbLW0mhhAyGEqpt,3,3,1,0,0,0,1,0,5,0.7142857142857143,1,0.0,0,1,0,0,3,0,0,1,0,1,4,1
8347,192425,GyLB5V57I2KbnfFgZclSqyQAUY6eRpjt,bWdj2GDclj5ofokWjzoa5jAwMkxCykd6,1,0,0,0,0,0,1,0,1,0.14285714285714285,1,0.0,0,0,0,0,0,0,0,1,0,0,1,1
8348,192426,o4zmJwxCaOlZRS6sjq7iHLRJ7DThOMe1,G8EPVSXsOYB5YQWZGiz1aVq5Pgr2GrQu,7,5,1,0,1,0,2,0,9,1.2857142857142858,1,0.0,0,1,0,1,5,0,0,2,0,2,7,1
8349,192431,OZzcwN4ObB1Nk33MS2zCa76PywvXNHRC,SpATywNh6bZuzm8s1ceuBUnMUAeoAHHw,5,5,1,0,1,0,1,0,8,1.1428571428571428,1,0.0,0,1,0,1,5,0,0,1,0,2,6,1
8350,192434,c1BXmJNemroOPh6WUefTBD28s2WzSNwi,G8EPVSXsOYB5YQWZGiz1aVq5Pgr2GrQu,1,0,0,0,0,0,1,0,1,0.14285714285714285,1,0.0,0,0,0,0,0,0,0,1,0,0,1,1
8351,192441,s1qTQc7ciJLP829kxDx1Q2usdHCCY2Ax,SpATywNh6bZuzm8s1ceuBUnMUAeoAHHw,2,0,0,0,0,0,2,0,2,0.2857142857142857,1,0.0,0,0,0,0,0,0,0,2,0,0,2,1
8352,192449,IihMsyE33bR2W1CinvLERaFEike0N1tI,SpATywNh6bZuzm8s1ceuBUnMUAeoAHHw,1,0,0,0,0,0,1,0,1,0.14285714285714285,1,0.0,0,0,0,0,0,0,0,1,0,0,1,1
8353,192450,fm4PPCUPLg6L0eK2GymW6alb9TJFqvnn,SpATywNh6bZuzm8s1ceuBUnMUAeoAHHw,1,0,0,0,0,0,1,0,1,0.14285714285714285,1,0.0,0,0,0,0,0,0,0,1,0,0,1,1
8354,192464,FnLRbhWfyqv6yBzd4jhbaUJyw3LJoL3p,SpATywNh6bZuzm8s1ceuBUnMUAeoAHHw,1,0,0,0,0,0,1,0,1,0.14285714285714285,1,0.0,0,0,0,0,0,0,0,1,0,0,1,0
8355,192468,XKJKqrTlrk5aKXeVOrE6ycEvLm3u912L,SpATywNh6bZuzm8s1ceuBUnMUAeoAHHw,1,0,0,0,0,0,1,0,1,0.14285714285714285,1,0.0,0,0,0,0,0,0,0,1,0,0,1,1
8356,192471,D2lFXeOodglgSTRNVccRvVrNvHlYgfLJ,SpATywNh6bZuzm8s1ceuBUnMUAeoAHHw,1,0,0,0,0,0,1,0,1,0.14285714285714285,1,0.0,0,0,0,0,0,0,0,1,0,0,1,1
8357,192474,cRUmHDnCm3xvppfYUcJkwRqBBl5OBCgi,SpATywNh6bZuzm8s1ceuBUnMUAeoAHHw,1,0,0,0,0,0,1,0,1,0.14285714285714285,1,0.0,0,0,0,0,0,0,0,1,0,0,1,1
8358,194476,48cQDxCvkp2Kfh2llKaDd9ViunV47JS8,SpATywNh6bZuzm8s1ceuBUnMUAeoAHHw,4,3,0,0,0,0,2,0,5,0.7142857142857143,1,0.0,0,0,0,0,3,0,0,2,0,0,5,1
8359,194483,uWA9XLuGA6XEQSt93Q0BaDvrrOLPsSDK,SpATywNh6bZuzm8s1ceuBUnMUAeoAHHw,7,3,2,0,2,0,2,0,9,1.2857142857142858,1,0.0,0,2,0,2,3,0,0,2,0,4,5,1
8360,194504,Idacmra5qZXQ5ItNCju8xTvAUotHMPrs,SpATywNh6bZuzm8s1ceuBUnMUAeoAHHw,6,8,5,0,0,1,5,0,19,2.7142857142857144,1,0.0,1,5,0,0,7,1,0,5,0,6,13,1
8361,194515,YwHqDHYDccXkxjPE1B044eDwvxiVBTeO,SpATywNh6bZuzm8s1ceuBUnMUAeoAHHw,3,2,1,0,0,0,1,0,4,0.5714285714285714,1,0.0,0,1,0,0,2,0,0,1,0,1,3,1
8362,194534,H3KvIatiAwzsCPQBVABALz431TkTR6tW,bWdj2GDclj5ofokWjzoa5jAwMkxCykd6,1,0,0,0,0,0,1,0,1,0.14285714285714285,1,0.0,0,0,0,0,0,0,0,1,0,0,1,1
8363,194544,p8BRO2js5DMFomuFhLGv1L7bXBEJtOjM,SpATywNh6bZuzm8s1ceuBUnMUAeoAHHw,2,0,0,0,0,0,3,0,3,0.42857142857142855,1,0.0,0,0,0,0,0,0,0,3,0,0,3,1
8364,194556,AsOrTv5l2WGfE3oCrdncC2RTwz7dm912,bWdj2GDclj5ofokWjzoa5jAwMkxCykd6,2,0,0,0,0,0,3,0,3,0.42857142857142855,1,0.0,0,0,0,0,0,0,0,3,0,0,3,1
8365,194581,XFUUwZmtEN3cKElSp0idT6cWlW88ytvr,SpATywNh6bZuzm8s1ceuBUnMUAeoAHHw,1,0,0,0,0,0,2,0,2,0.2857142857142857,1,0.0,0,0,0,0,0,0,0,2,0,0,2,1
8366,194597,MYuwori4SZLwwApulVomE37Zmv9CBJsc,SpATywNh6bZuzm8s1ceuBUnMUAeoAHHw,1,0,0,0,0,0,1,0,1,0.14285714285714285,1,0.0,0,0,0,0,0,0,0,1,0,0,1,1
8367,194626,xxqm3MFvp9JeD1lH1hC9xIrY8O1L8Xjf,SpATywNh6bZuzm8s1ceuBUnMUAeoAHHw,3,2,0,0,0,1,1,0,4,0.5714285714285714,1,0.0,0,0,0,0,2,1,0,1,0,0,4,1
8368,194629,mRThjjGON0zU0Y2plEdpqVN16fEiXwSr,A3fsA9Zfv1X2fVEQhTw51lKENdNrEqT3,1,0,0,0,0,0,2,0,2,0.2857142857142857,1,0.0,0,0,0,0,0,0,0,2,0,0,2,1
8369,194632,mhoMg2u4vZZCHMZwVbOPSr9rKeZ90EyX,SpATywNh6bZuzm8s1ceuBUnMUAeoAHHw,1,0,0,0,0,0,1,0,1,0.14285714285714285,1,0.0,0,0,0,0,0,0,0,1,0,0,1,1
8370,194655,Ntq8V5vAbhpRqfZVmDonWfflMXALrE62,A3fsA9Zfv1X2fVEQhTw51lKENdNrEqT3,7,5,3,0,1,0,4,0,13,1.8571428571428572,1,0.0,0,3,0,1,5,0,0,4,0,4,9,1
8371,194658,YTC5509AOhIkCtNjrBmjv9Yv2oK29NsL,SpATywNh6bZuzm8s1ceuBUnMUAeoAHHw,6,1,1,0,1,0,3,0,6,0.8571428571428571,1,0.0,0,1,0,1,1,0,0,3,0,2,4,1
8372,194667,sbaCeCpavj6HRFMhWrWMN8T04nCg0Bj4,SpATywNh6bZuzm8s1ceuBUnMUAeoAHHw,4,3,1,0,1,0,2,0,7,1.0,1,0.0,0,1,0,1,3,0,0,2,0,2,5,1
8373,194668,1sJ6YPYoSHma92rhmUGAalTdAYX4i2lG,SpATywNh6bZuzm8s1ceuBUnMUAeoAHHw,7,5,3,0,3,0,2,0,13,1.8571428571428572,1,0.0,0,3,0,3,5,0,0,2,0,6,7,1
8374,194674,VK6VYsFJEy8hhWdKq52KmrJkO3b6jNbn,bWdj2GDclj5ofokWjzoa5jAwMkxCykd6,4,2,1,0,1,0,1,0,5,0.7142857142857143,1,0.0,0,1,0,1,2,0,0,1,0,2,3,1
8375,194677,D0i6ZcBzVub6eIaIAw4ckCiIW5ThBWQ4,A3fsA9Zfv1X2fVEQhTw51lKENdNrEqT3,1,0,0,0,0,0,1,0,1,0.14285714285714285,1,0.0,0,0,0,0,0,0,0,1,0,0,1,1
8376,194678,96DWLTPjQt7WYS8cwfEQ2OGqQgPivHHX,SpATywNh6bZuzm8s1ceuBUnMUAeoAHHw,6,5,4,0,2,2,3,0,16,2.2857142857142856,1,0.0,0,4,0,2,5,2,0,3,0,6,10,1
8377,194684,d5TfbEyt4nCHCAaoxySwtX2WVur5Z8A1,A3fsA9Zfv1X2fVEQhTw51lKENdNrEqT3,1,0,0,0,0,0,1,0,1,0.14285714285714285,1,0.0,0,0,0,0,0,0,0,1,0,0,1,1
8378,194685,1YrPSVRax2MbGnGgOZ0qdLQfDXuMb3FP,SpATywNh6bZuzm8s1ceuBUnMUAeoAHHw,4,2,1,0,1,0,1,0,5,0.7142857142857143,1,0.0,0,1,0,1,2,0,0,1,0,2,3,1
8379,194693,8TF2Yz03M0ctxPaKqQO9uTaRyGlE3FTS,bWdj2GDclj5ofokWjzoa5jAwMkxCykd6,1,0,0,0,0,0,1,0,1,0.14285714285714285,1,0.0,0,0,0,0,0,0,0,1,0,0,1,1
8380,194694,6Ypoz1HptUjxpuR7fZtuIow2vA2n53uM,A3fsA9Zfv1X2fVEQhTw51lKENdNrEqT3,1,0,0,0,0,0,1,0,1,0.14285714285714285,1,0.0,0,0,0,0,0,0,0,1,0,0,1,1
8381,194713,aMZE4hDrTfaO5VrIlGdTGgvjbzOnIun0,A3fsA9Zfv1X2fVEQhTw51lKENdNrEqT3,1,0,0,0,0,0,1,0,1,0.14285714285714285,1,0.0,0,0,0,0,0,0,0,1,0,0,1,1
8382,194719,wj7PR2dOTCSENZUxdS1JrjKR8466zZVl,bWdj2GDclj5ofokWjzoa5jAwMkxCykd6,8,2,1,0,1,1,6,1,12,1.7142857142857142,1,0.0,0,1,0,1,2,1,0,6,1,2,10,1
8383,194722,4rwe5BmciR8qkFj7YwyJ3a5aK2xp9xod,A3fsA9Zfv1X2fVEQhTw51lKENdNrEqT3,6,5,3,0,2,0,3,0,13,1.8571428571428572,1,0.0,0,3,0,2,5,0,0,3,0,5,8,1
8384,194729,yWWr0HnJqf4TxBLaD1ZmBW6mPdbU2NXV,SpATywNh6bZuzm8s1ceuBUnMUAeoAHHw,5,4,1,0,1,0,4,0,10,1.4285714285714286,1,0.0,0,1,0,1,4,0,0,4,0,2,8,1
8385,194733,MBzpq6BeyrKVsFmJlf8cgHZW8NmCppoM,bWdj2GDclj5ofokWjzoa5jAwMkxCykd6,5,2,1,0,1,0,2,0,6,0.8571428571428571,1,0.0,0,1,0,1,2,0,0,2,0,2,4,1
8386,194734,55FtCsTJdMN32PE70MZj9DHqTCxXeYP2,SpATywNh6bZuzm8s1ceuBUnMUAeoAHHw,6,3,2,0,2,0,1,0,8,1.1428571428571428,1,0.0,0,2,0,2,3,0,0,1,0,4,4,1
8387,194739,ivSdmGnxv1Uz6NLl4IGvBJeRY1HBPrVZ,SpATywNh6bZuzm8s1ceuBUnMUAeoAHHw,9,4,1,0,1,8,5,1,20,2.857142857142857,1,0.0,0,1,0,1,4,8,0,5,1,2,18,1
8388,194753,Bxz1zTHFCCx9o1kJA9B0Pzm3PnmqKxr5,A3fsA9Zfv1X2fVEQhTw51lKENdNrEqT3,7,3,2,0,2,0,2,0,9,1.2857142857142858,1,0.0,0,2,0,2,3,0,0,2,0,4,5,1
8389,194767,i4NsQYAbaUfmQ6n2VMTiVWggNWktkrDX,bWdj2GDclj5ofokWjzoa5jAwMkxCykd6,5,10,3,0,0,0,5,0,18,2.5714285714285716,1,0.0,0,3,0,0,10,0,0,5,0,3,15,0
8390,194779,KheifBHmTnDsYBIH7TBBDpXQ1Bd1UA3a,SpATywNh6bZuzm8s1ceuBUnMUAeoAHHw,1,0,0,0,0,0,1,0,1,0.14285714285714285,1,0.0,0,0,0,0,0,0,0,1,0,0,1,1
8391,194784,LDPCm5FHAiMLt4xJYeSbtfjm8D9WglxJ,SpATywNh6bZuzm8s1ceuBUnMUAeoAHHw,16,15,7,14,3,0,5,0,44,6.285714285714286,1,0.0,4,7,14,3,11,0,0,5,0,28,16,1
8392,194788,BH0g3wVCilU6qeEv507COxWXunEVyQCt,A3fsA9Zfv1X2fVEQhTw51lKENdNrEqT3,4,6,3,0,0,0,2,0,11,1.5714285714285714,1,0.0,0,3,0,0,6,0,0,2,0,3,8,1
8393,194803,YqqcH0qThFMdLP4k9i9U0gJ4gpbELjkv,SpATywNh6bZuzm8s1ceuBUnMUAeoAHHw,8,8,6,0,0,0,5,2,21,3.0,1,0.0,0,6,0,0,8,0,0,5,2,6,15,1
8394,194806,FF4dRvqzL3V5nW7v3NbN8PsUIVH4lz6F,SpATywNh6bZuzm8s1ceuBUnMUAeoAHHw,1,0,0,0,0,0,1,0,1,0.14285714285714285,1,0.0,0,0,0,0,0,0,0,1,0,0,1,1
8395,194807,tyVcDsPvN4UjeaGnK8HkYLM1DiaISxPh,A3fsA9Zfv1X2fVEQhTw51lKENdNrEqT3,10,10,5,0,1,12,13,0,41,5.857142857142857,2,0.0,2,5,0,1,8,12,0,13,0,8,33,1
8396,194810,mNLR1O6gqXF6Zqi4uIf130gITni9gN1A,SpATywNh6bZuzm8s1ceuBUnMUAeoAHHw,7,3,2,0,2,0,2,0,9,1.2857142857142858,1,0.0,0,2,0,2,3,0,0,2,0,4,5,0
8397,194817,7HNfi5OY69fAwtBXY2Bx1G7GFcGZh7Ly,SpATywNh6bZuzm8s1ceuBUnMUAeoAHHw,1,0,0,0,0,0,1,0,1,0.14285714285714285,1,0.0,0,0,0,0,0,0,0,1,0,0,1,1
8398,194820,W3q5xabVGlYtHwCF6azkr4rDuBoAdzu5,SpATywNh6bZuzm8s1ceuBUnMUAeoAHHw,4,2,1,0,1,0,1,0,5,0.7142857142857143,1,0.0,0,1,0,1,2,0,0,1,0,2,3,1
8399,194822,oLy9nBdTYL8NCOYS922zyTRG6EziMvh0,SpATywNh6bZuzm8s1ceuBUnMUAeoAHHw,5,2,1,0,1,0,2,0,6,0.8571428571428571,1,0.0,0,1,0,1,2,0,0,2,0,2,4,1
8400,194837,h1POuqYbxnxgGkE4pWe2S8wS54aC8n19,SpATywNh6bZuzm8s1ceuBUnMUAeoAHHw,7,2,1,0,1,1,4,1,10,1.4285714285714286,1,0.0,0,1,0,1,2,1,0,4,1,2,8,1
8401,194852,nq0fTUXEyf4zNsnzbVQxJGqu2ei3Zzxd,SpATywNh6bZuzm8s1ceuBUnMUAeoAHHw,1,0,0,0,0,0,1,0,1,0.14285714285714285,1,0.0,0,0,0,0,0,0,0,1,0,0,1,1
8402,194853,SSxnRLkRY8Nz6yCXbxisiyKLbaiWbjIK,bWdj2GDclj5ofokWjzoa5jAwMkxCykd6,1,0,0,0,0,0,1,0,1,0.14285714285714285,1,0.0,0,0,0,0,0,0,0,1,0,0,1,1
8403,194862,cW4Q7k8uorP2ZaATVwEYmHiYgqZDhGz3,SpATywNh6bZuzm8s1ceuBUnMUAeoAHHw,5,2,1,0,1,2,2,0,8,1.1428571428571428,1,0.0,0,1,0,1,2,2,0,2,0,2,6,1
8404,194886,AYPzYs86vNA5oOhv1GafopaYTci4zq2u,SpATywNh6bZuzm8s1ceuBUnMUAeoAHHw,3,3,0,0,0,0,2,0,5,0.7142857142857143,1,0.0,0,0,0,0,3,0,0,2,0,0,5,1
8405,194887,QUGraFxtzCQNNKP2kQzaB6kauOeKIjbk,SpATywNh6bZuzm8s1ceuBUnMUAeoAHHw,5,2,1,0,1,0,2,0,6,0.8571428571428571,1,0.0,0,1,0,1,2,0,0,2,0,2,4,1
8406,194888,nfvdVPsl73HsB5v26CK2d3kpAhmyAPaZ,SpATywNh6bZuzm8s1ceuBUnMUAeoAHHw,2,0,0,0,0,0,2,0,2,0.2857142857142857,1,0.0,0,0,0,0,0,0,0,2,0,0,2,1
8407,194896,50aSuabL02e7lLNBHTRXsMQnBChV2lSX,SpATywNh6bZuzm8s1ceuBUnMUAeoAHHw,9,4,3,0,3,0,2,0,12,1.7142857142857142,1,0.0,0,3,0,3,4,0,0,2,0,6,6,0
8408,194907,r8kATVhVTFWwFIt4UfjEkmBJAJ9dIcZn,SpATywNh6bZuzm8s1ceuBUnMUAeoAHHw,11,10,3,0,1,6,8,2,30,4.285714285714286,1,0.0,4,3,0,1,6,6,0,8,2,8,22,1
8409,194908,FtHUJIDgcRIKvAk6G0aJG28BljfTCpR1,SpATywNh6bZuzm8s1ceuBUnMUAeoAHHw,3,0,0,0,0,2,2,0,4,0.5714285714285714,1,0.0,0,0,0,0,0,2,0,2,0,0,4,1
8410,194921,coZTr10eytnE55me2AxqRWq6qrVXEB7M,bWdj2GDclj5ofokWjzoa5jAwMkxCykd6,1,0,0,0,0,0,1,0,1,0.14285714285714285,1,0.0,0,0,0,0,0,0,0,1,0,0,1,1
8411,194932,XzsCpdFAPGr3HoHuPSOeqUJ9vrQ1cDvx,SpATywNh6bZuzm8s1ceuBUnMUAeoAHHw,1,0,0,0,0,0,1,0,1,0.14285714285714285,1,0.0,0,0,0,0,0,0,0,1,0,0,1,1
8412,194941,WOgCErvth3RYtZvlZwUgSVLnOS4A1Eul,SpATywNh6bZuzm8s1ceuBUnMUAeoAHHw,1,0,0,0,0,0,1,0,1,0.14285714285714285,1,0.0,0,0,0,0,0,0,0,1,0,0,1,1
8413,194948,gDo9M8HDbXmLQPxqqLTsn9N4ZUEPKvcn,SpATywNh6bZuzm8s1ceuBUnMUAeoAHHw,7,10,1,0,0,0,2,0,13,1.8571428571428572,1,0.0,3,1,0,0,7,0,0,2,0,4,9,1
8414,194949,88fLpsc97HhNfdaSPlKqNnhAVgW27BAo,SpATywNh6bZuzm8s1ceuBUnMUAeoAHHw,5,3,0,0,0,0,3,1,7,1.0,1,0.0,0,0,0,0,3,0,0,3,1,0,7,1
8415,194968,Jx42Ejc8m7xjALEiD0Ys2DAnttPYIxMG,A3fsA9Zfv1X2fVEQhTw51lKENdNrEqT3,17,14,0,0,0,12,7,1,34,4.857142857142857,1,0.0,1,0,0,0,13,12,0,7,1,1,33,1
8416,194972,sESOR36K7nBM311FFRUj2nLw7gbYwiJz,SpATywNh6bZuzm8s1ceuBUnMUAeoAHHw,7,7,3,0,2,0,3,0,15,2.142857142857143,1,0.0,1,3,0,2,6,0,0,3,0,6,9,1
8417,194974,Io5gLr8QOxaBw8nFReloAXOpt3IlZ5WE,bWdj2GDclj5ofokWjzoa5jAwMkxCykd6,1,0,0,0,0,0,1,0,1,0.14285714285714285,1,0.0,0,0,0,0,0,0,0,1,0,0,1,1
8418,194975,Io5gLr8QOxaBw8nFReloAXOpt3IlZ5WE,A3fsA9Zfv1X2fVEQhTw51lKENdNrEqT3,1,0,0,0,0,0,1,0,1,0.14285714285714285,1,0.0,0,0,0,0,0,0,0,1,0,0,1,1
8419,194980,z2EPdF3qYcFLBwhpfABa73PTR23asQuU,A3fsA9Zfv1X2fVEQhTw51lKENdNrEqT3,9,3,1,0,1,2,7,1,15,2.142857142857143,1,0.0,0,1,0,1,3,2,0,7,1,2,13,1
8420,194982,1GEou0jUAwSZvf4K9js5E10dDnbmQpAC,A3fsA9Zfv1X2fVEQhTw51lKENdNrEqT3,8,2,1,0,1,0,5,1,10,1.4285714285714286,1,0.0,0,1,0,1,2,0,0,5,1,2,8,1
8421,194988,uiws4KxaJyhkKSkkHMDme11rXJg9xyaL,SpATywNh6bZuzm8s1ceuBUnMUAeoAHHw,11,13,7,0,4,2,13,1,40,5.714285714285714,1,0.0,3,7,0,4,10,2,0,13,1,14,26,1
8422,195002,LfNMIOZFn9FNdYWiUKFIdgjlnXx6yIVQ,SpATywNh6bZuzm8s1ceuBUnMUAeoAHHw,12,14,1,2,1,0,6,0,24,3.4285714285714284,1,0.0,0,1,2,1,14,0,0,6,0,4,20,1
8423,195022,0FxfzBL8lExhKYYcGcci82l6xBLomyet,SpATywNh6bZuzm8s1ceuBUnMUAeoAHHw,9,5,4,0,4,0,3,0,16,2.2857142857142856,1,0.0,0,4,0,4,5,0,0,3,0,8,8,1
8424,195029,3bqYNHEttQnrSXCOjNHPi8cuvQEsNCSU,bWdj2GDclj5ofokWjzoa5jAwMkxCykd6,1,0,0,0,0,0,1,0,1,0.14285714285714285,1,0.0,0,0,0,0,0,0,0,1,0,0,1,1
8425,195031,2wS8JVpw1CsKg56Cx9G9VOnhu3l1G4I0,SpATywNh6bZuzm8s1ceuBUnMUAeoAHHw,17,21,11,15,4,9,8,2,70,10.0,1,0.0,4,11,14,4,17,9,1,8,2,33,37,1
8426,195036,A8zAoi2Uw9AkuLfLEgj43RiYhGLMNj18,SpATywNh6bZuzm8s1ceuBUnMUAeoAHHw,5,5,1,0,1,0,1,0,8,1.1428571428571428,1,0.0,0,1,0,1,5,0,0,1,0,2,6,1
8427,195039,I9J4QWiXHWCNKaic0XgJQZKgGASYH4yX,SpATywNh6bZuzm8s1ceuBUnMUAeoAHHw,7,6,4,0,3,0,1,0,14,2.0,1,0.0,0,4,0,3,6,0,0,1,0,7,7,1
8428,195057,NikqZ1qZg3zBUaGWiNf6mGXz34uqYANW,bWdj2GDclj5ofokWjzoa5jAwMkxCykd6,7,3,1,0,1,0,5,6,16,2.2857142857142856,1,0.0,1,1,0,1,2,0,0,5,6,3,13,1
8429,195059,4LHx8JspDAj57obmMYSAAyDYEzuHjEJP,A3fsA9Zfv1X2fVEQhTw51lKENdNrEqT3,2,0,0,0,0,0,2,0,2,0.2857142857142857,1,0.0,0,0,0,0,0,0,0,2,0,0,2,1
8430,195066,xsq0NNhfMlJSps1up5uJcRMXvgRrV0sJ,SpATywNh6bZuzm8s1ceuBUnMUAeoAHHw,1,0,0,0,0,0,1,0,1,0.14285714285714285,1,0.0,0,0,0,0,0,0,0,1,0,0,1,1
8431,195089,qX3w4IgztgXyu9swieirFObama3kJyza,SpATywNh6bZuzm8s1ceuBUnMUAeoAHHw,2,0,0,0,0,0,3,0,3,0.42857142857142855,1,0.0,0,0,0,0,0,0,0,3,0,0,3,1
8432,195091,L8lHLh6Mth1S7I3sErP5oDZD885a1BOh,SpATywNh6bZuzm8s1ceuBUnMUAeoAHHw,5,3,2,0,2,0,2,0,9,1.2857142857142858,1,0.0,0,2,0,2,3,0,0,2,0,4,5,1
8433,195092,aBOCGRJtSTLes0jxdeecmLlgi9rWLU2d,SpATywNh6bZuzm8s1ceuBUnMUAeoAHHw,4,1,0,0,0,0,3,0,4,0.5714285714285714,1,0.0,0,0,0,0,1,0,0,3,0,0,4,1
8434,195103,vxGkTn6WfGBki29hwuSV6Xuc1hbgzs4I,SpATywNh6bZuzm8s1ceuBUnMUAeoAHHw,1,0,0,0,0,0,1,0,1,0.14285714285714285,1,0.0,0,0,0,0,0,0,0,1,0,0,1,1
8435,195104,90Hur8PGj0IjqXgPOcR65ST1YxNz0ds7,A3fsA9Zfv1X2fVEQhTw51lKENdNrEqT3,12,9,3,0,2,0,7,1,22,3.142857142857143,2,0.0,0,3,0,2,9,0,0,7,1,5,17,1
8436,195119,aWAFF1Fze4LYlsUU8ERMTgVYzoyOI6Lv,SpATywNh6bZuzm8s1ceuBUnMUAeoAHHw,5,3,0,0,1,0,1,0,5,0.7142857142857143,1,0.0,0,0,0,1,3,0,0,1,0,1,4,1
8437,195127,jg3jOKfanNJPAzYxAIsKTejRcuHuYakD,SpATywNh6bZuzm8s1ceuBUnMUAeoAHHw,2,1,0,0,0,0,1,0,2,0.2857142857142857,1,0.0,0,0,0,0,1,0,0,1,0,0,2,1
8438,195132,TAT1t0HA0deInUIqMQU3qN2hNwJUolWn,SpATywNh6bZuzm8s1ceuBUnMUAeoAHHw,10,8,6,3,4,0,2,0,23,3.2857142857142856,1,0.0,1,6,3,4,7,0,0,2,0,14,9,1
8439,195149,lxP21JAeoGw4N8j8NgjQVcD64XYgvMHQ,SpATywNh6bZuzm8s1ceuBUnMUAeoAHHw,3,2,0,0,0,0,1,0,3,0.42857142857142855,1,0.0,0,0,0,0,2,0,0,1,0,0,3,1
8440,195158,YwfI8H5GXP8M3NnSeLcRy7i15qMPqaXk,SpATywNh6bZuzm8s1ceuBUnMUAeoAHHw,7,4,1,0,1,0,3,1,10,1.4285714285714286,1,0.0,0,1,0,1,4,0,0,3,1,2,8,1
8441,195169,S3f0JK9oaNTPyiRDrmkpSKmLckAAblqI,SpATywNh6bZuzm8s1ceuBUnMUAeoAHHw,6,5,3,0,1,0,1,0,10,1.4285714285714286,1,0.0,0,3,0,1,5,0,0,1,0,4,6,1
8442,195174,iXadVTWz0gSvLWs1uknu7xrsEL401uhz,SpATywNh6bZuzm8s1ceuBUnMUAeoAHHw,3,0,0,0,0,0,3,0,3,0.42857142857142855,1,0.0,0,0,0,0,0,0,0,3,0,0,3,1
8443,195179,xEHo4X1rukdspRGBdfJyX5P4IZVyDEcz,SpATywNh6bZuzm8s1ceuBUnMUAeoAHHw,7,3,2,0,2,0,2,0,9,1.2857142857142858,1,0.0,0,2,0,2,3,0,0,2,0,4,5,1
8444,195208,L2VtKU10xoYfk9AeXI4ucBlRANoxyJAj,SpATywNh6bZuzm8s1ceuBUnMUAeoAHHw,7,30,3,0,0,0,7,0,40,5.714285714285714,1,0.0,0,3,0,0,30,0,0,7,0,3,37,1
8445,195223,jtdJ8s2kyNzwf06KTNChcN9oAOS9ZmYk,A3fsA9Zfv1X2fVEQhTw51lKENdNrEqT3,8,5,2,0,2,0,3,0,12,1.7142857142857142,1,0.0,0,2,0,2,5,0,0,3,0,4,8,1
8446,195227,bONRCO0uATZ9orvOXASjWia0swY9AaMZ,A3fsA9Zfv1X2fVEQhTw51lKENdNrEqT3,6,2,1,0,1,0,8,0,12,1.7142857142857142,1,0.0,0,1,0,1,2,0,0,8,0,2,10,1
8447,195231,8qABUnBBHxxZkfUhEQNUn5NNMSRrqvPC,A3fsA9Zfv1X2fVEQhTw51lKENdNrEqT3,7,8,5,0,0,0,2,0,15,2.142857142857143,2,0.0,0,5,0,0,8,0,0,2,0,5,10,1
8448,195240,nhwZ1i3tBLPpKZ1jf7waw2ZZrzqPTraF,A3fsA9Zfv1X2fVEQhTw51lKENdNrEqT3,1,0,0,0,0,0,2,0,2,0.2857142857142857,1,0.0,0,0,0,0,0,0,0,2,0,0,2,1
8449,195246,hNV2TDc5kXTQn8foo4aRN6FCIXLNr4nn,SpATywNh6bZuzm8s1ceuBUnMUAeoAHHw,6,0,0,0,0,1,6,1,8,1.1428571428571428,1,0.0,0,0,0,0,0,1,0,6,1,0,8,1
8450,195253,K6R10YCm4EKgUGnQY53FYbuIV8YOCHd6,A3fsA9Zfv1X2fVEQhTw51lKENdNrEqT3,14,11,9,0,6,0,3,0,29,4.142857142857143,1,0.0,0,9,0,6,11,0,0,3,0,15,14,1
8451,195255,nFy3S5ktNxWHxSxQEsVxABtdYtTHm2QG,SpATywNh6bZuzm8s1ceuBUnMUAeoAHHw,10,6,1,6,0,0,5,0,18,2.5714285714285716,1,0.0,1,1,5,0,5,0,1,5,0,7,11,1
8452,195259,7dlRqTed9Vz3lG7sCkGqwL4Rf479l4Lf,SpATywNh6bZuzm8s1ceuBUnMUAeoAHHw,3,2,0,0,0,0,1,0,3,0.42857142857142855,1,0.0,0,0,0,0,2,0,0,1,0,0,3,1
8453,195275,JIBg2bFQYc7ncSPQhvBWrAlcobShyiXA,SpATywNh6bZuzm8s1ceuBUnMUAeoAHHw,11,8,1,11,0,0,3,1,24,3.4285714285714284,1,0.0,2,1,10,0,6,0,1,3,1,13,11,1
8454,195278,8cxCnT3STAEth9x4HzjOcerWufkhGlX3,A3fsA9Zfv1X2fVEQhTw51lKENdNrEqT3,1,0,0,0,0,0,1,0,1,0.14285714285714285,1,0.0,0,0,0,0,0,0,0,1,0,0,1,1
8455,195303,ouhJVRUNWH7xFlD4xC7qUWcBbb5kOVSM,SpATywNh6bZuzm8s1ceuBUnMUAeoAHHw,7,3,0,0,0,0,8,0,11,1.5714285714285714,1,0.0,0,0,0,0,3,0,0,8,0,0,11,1
8456,195307,3PN3AyL6tfmtfTSkHxR5sSs7QxGCrkua,SpATywNh6bZuzm8s1ceuBUnMUAeoAHHw,1,0,0,0,0,0,1,0,1,0.14285714285714285,1,0.0,0,0,0,0,0,0,0,1,0,0,1,1
8457,195309,qqPuA4adS4zWJNjZeIJQCgaT64XJRtor,A3fsA9Zfv1X2fVEQhTw51lKENdNrEqT3,32,31,16,14,11,8,8,0,88,12.571428571428571,1,0.0,0,16,13,11,31,8,1,8,0,40,48,1
8458,195323,PQAJu1VB3GuaUzJI11vB182M1L2se1PX,SpATywNh6bZuzm8s1ceuBUnMUAeoAHHw,10,3,2,0,2,1,6,2,16,2.2857142857142856,1,0.0,0,2,0,2,3,1,0,6,2,4,12,1
8459,195328,kKCWVPsmOCuRmD5n3b0FhPNIyXfeeMNV,SpATywNh6bZuzm8s1ceuBUnMUAeoAHHw,3,2,0,0,0,0,1,0,3,0.42857142857142855,1,0.0,0,0,0,0,2,0,0,1,0,0,3,1
8460,195336,cA8asOLHRHcK3Kr0VMyGtrDdcfovAiM5,A3fsA9Zfv1X2fVEQhTw51lKENdNrEqT3,21,11,10,0,8,0,3,0,32,4.571428571428571,1,0.0,1,10,0,8,10,0,0,3,0,19,13,1
8461,195357,rYmd6vnR5Pxkj69jVuGfihv9dJd27d4j,SpATywNh6bZuzm8s1ceuBUnMUAeoAHHw,7,3,2,0,2,0,2,0,9,1.2857142857142858,1,0.0,0,2,0,2,3,0,0,2,0,4,5,1
8462,195359,v4pwVH1VWldeBobir3iEqSHO6IoG1mdb,SpATywNh6bZuzm8s1ceuBUnMUAeoAHHw,14,17,6,12,4,0,2,0,41,5.857142857142857,1,0.0,4,6,11,4,13,0,1,2,0,25,16,1
8463,195361,v4pwVH1VWldeBobir3iEqSHO6IoG1mdb,A3fsA9Zfv1X2fVEQhTw51lKENdNrEqT3,10,9,3,0,3,0,2,0,17,2.4285714285714284,1,0.0,0,3,0,3,9,0,0,2,0,6,11,1
8464,195368,YPWJVK9ueaONJH89FoDwiyUXkyNj3an5,SpATywNh6bZuzm8s1ceuBUnMUAeoAHHw,7,3,2,0,2,0,2,0,9,1.2857142857142858,1,0.0,0,2,0,2,3,0,0,2,0,4,5,1
8465,195397,Px3zRsOzY6lifmzZgnqcwuqsaYej1KKL,A3fsA9Zfv1X2fVEQhTw51lKENdNrEqT3,1,0,0,0,0,0,1,0,1,0.14285714285714285,1,0.0,0,0,0,0,0,0,0,1,0,0,1,0
8466,195413,bvN6XOPoER6NVEf5NoGSs2X6xsEr92h3,SpATywNh6bZuzm8s1ceuBUnMUAeoAHHw,8,3,1,0,1,0,4,1,10,1.4285714285714286,1,0.0,0,1,0,1,3,0,0,4,1,2,8,1
8467,195425,izM8opj3xJHFbPsERjrPScHIIGoVU3sL,SpATywNh6bZuzm8s1ceuBUnMUAeoAHHw,6,0,0,0,0,1,12,1,14,2.0,1,0.0,0,0,0,0,0,1,0,12,1,0,14,1
8468,195430,fHIOg4CLMDgqxwisMJ0FCaIJdtYNnnlj,SpATywNh6bZuzm8s1ceuBUnMUAeoAHHw,4,2,1,0,1,0,1,0,5,0.7142857142857143,1,0.0,0,1,0,1,2,0,0,1,0,2,3,1
8469,195432,LICyXxeZEgLwXHk4xrNu6rCpPIKDNqKx,bWdj2GDclj5ofokWjzoa5jAwMkxCykd6,4,0,0,0,0,2,3,1,6,0.8571428571428571,1,0.0,0,0,0,0,0,2,0,3,1,0,6,0
8470,195452,k57D5r1HBQsYTFYwjCvC4VLOFbsyC3KY,bWdj2GDclj5ofokWjzoa5jAwMkxCykd6,5,2,1,0,1,0,2,0,6,0.8571428571428571,1,0.0,0,1,0,1,2,0,0,2,0,2,4,1
8471,195453,k57D5r1HBQsYTFYwjCvC4VLOFbsyC3KY,A3fsA9Zfv1X2fVEQhTw51lKENdNrEqT3,9,4,3,0,3,0,2,0,12,1.7142857142857142,1,0.0,0,3,0,3,4,0,0,2,0,6,6,1
8472,195458,fp4riRNidjgqRkLYeMfperPsuliabiil,A3fsA9Zfv1X2fVEQhTw51lKENdNrEqT3,2,0,0,0,0,0,2,0,2,0.2857142857142857,1,0.0,0,0,0,0,0,0,0,2,0,0,2,1
8473,195463,Vc1baHxuYCOF9wXqOziB65UR0NyB8LSm,A3fsA9Zfv1X2fVEQhTw51lKENdNrEqT3,4,2,1,0,1,0,1,0,5,0.7142857142857143,1,0.0,0,1,0,1,2,0,0,1,0,2,3,1
8474,195471,VCHjbUg5mmZIrDffSGKLebg8S6dLXnyn,SpATywNh6bZuzm8s1ceuBUnMUAeoAHHw,2,0,0,0,0,0,2,0,2,0.2857142857142857,1,0.0,0,0,0,0,0,0,0,2,0,0,2,1
8475,195495,s6FY1tnJFeJCup1Eko54ROGWiTGeTtYm,bWdj2GDclj5ofokWjzoa5jAwMkxCykd6,1,0,0,0,0,0,1,0,1,0.14285714285714285,1,0.0,0,0,0,0,0,0,0,1,0,0,1,1
8476,195497,s6FY1tnJFeJCup1Eko54ROGWiTGeTtYm,A3fsA9Zfv1X2fVEQhTw51lKENdNrEqT3,2,0,0,0,0,0,2,0,2,0.2857142857142857,1,0.0,0,0,0,0,0,0,0,2,0,0,2,1
8477,195501,Sy7PnSgnanE6MmRmOk45JZv7731jQKG6,SpATywNh6bZuzm8s1ceuBUnMUAeoAHHw,4,3,0,0,0,0,3,0,6,0.8571428571428571,1,0.0,0,0,0,0,3,0,0,3,0,0,6,1
8478,195511,KzP79COW0J6jugsTdx8JCjyWx6PlJCcn,bWdj2GDclj5ofokWjzoa5jAwMkxCykd6,4,0,0,0,0,1,3,0,4,0.5714285714285714,1,0.0,0,0,0,0,0,1,0,3,0,0,4,1
8479,195530,OuoRlyFtQHB6CBdOhxOFsh6hGiNcDFNC,SpATywNh6bZuzm8s1ceuBUnMUAeoAHHw,1,0,0,0,0,0,1,0,1,0.14285714285714285,1,0.0,0,0,0,0,0,0,0,1,0,0,1,1
8480,195542,BXV7sGq2IrRSqCFuLKgoxpKYDPSPpUSj,SpATywNh6bZuzm8s1ceuBUnMUAeoAHHw,9,3,2,0,1,0,6,1,13,1.8571428571428572,1,0.0,0,2,0,1,3,0,0,6,1,3,10,1
8481,195557,23A4h0mJIxgdd7Lfc0ogX2OGnwyxoL13,SpATywNh6bZuzm8s1ceuBUnMUAeoAHHw,5,9,1,0,1,0,1,0,12,1.7142857142857142,1,0.0,0,1,0,1,9,0,0,1,0,2,10,1
8482,195558,xUhDcXiX03QQg1jNR3Lksh9CrGcRUkPg,SpATywNh6bZuzm8s1ceuBUnMUAeoAHHw,1,0,0,0,0,0,1,0,1,0.14285714285714285,1,0.0,0,0,0,0,0,0,0,1,0,0,1,0
8483,195572,SSpeewBDHUNKkvUJM5ASinNHvMXIOEwr,A3fsA9Zfv1X2fVEQhTw51lKENdNrEqT3,2,0,0,0,0,2,2,0,4,0.5714285714285714,1,0.0,0,0,0,0,0,2,0,2,0,0,4,1
8484,197544,FySmfd2hS941zbI2PjxLl96G2jk3gIlQ,bWdj2GDclj5ofokWjzoa5jAwMkxCykd6,1,0,0,0,0,0,1,0,1,0.14285714285714285,1,0.0,0,0,0,0,0,0,0,1,0,0,1,1
8485,197561,1sxU5u2tB4cfcS6yRjPgL8Lbs961wxI1,A3fsA9Zfv1X2fVEQhTw51lKENdNrEqT3,1,0,0,0,0,0,1,0,1,0.14285714285714285,1,0.0,0,0,0,0,0,0,0,1,0,0,1,1
8486,197565,cSPs7Fdln4Ch49nnOhLrL6tMXQVWaRtw,SpATywNh6bZuzm8s1ceuBUnMUAeoAHHw,1,0,0,0,0,0,1,0,1,0.14285714285714285,1,0.0,0,0,0,0,0,0,0,1,0,0,1,1
8487,197581,3UIhyDBe2cVwfnPbxOe5VWApIlUgpsbX,bWdj2GDclj5ofokWjzoa5jAwMkxCykd6,1,0,0,0,0,0,1,0,1,0.14285714285714285,1,0.0,0,0,0,0,0,0,0,1,0,0,1,1
8488,197585,wrEd0NIQV39m2xEAHNuU1Ww6eryiacbC,SpATywNh6bZuzm8s1ceuBUnMUAeoAHHw,11,15,0,21,0,4,3,0,43,6.142857142857143,1,0.0,7,0,18,0,8,4,3,3,0,25,18,1
8489,197592,ECkqmAuIkv3ncN9wNJby8oOn15qTd9kR,RXDvfPUBYFlVdlueBFbLW0mhhAyGEqpt,1,0,0,0,0,0,2,0,2,0.2857142857142857,1,0.0,0,0,0,0,0,0,0,2,0,0,2,1
8490,197598,RCC0chPMKpWYHBcYuZNQFLP3RQicCreS,SpATywNh6bZuzm8s1ceuBUnMUAeoAHHw,2,0,0,0,0,0,3,0,3,0.42857142857142855,1,0.0,0,0,0,0,0,0,0,3,0,0,3,1
8491,197603,xOGjXyyeq87fCMSZ9z7Yuds9sMvR7Ohh,A3fsA9Zfv1X2fVEQhTw51lKENdNrEqT3,20,12,10,0,10,0,1,0,33,4.714285714285714,1,0.0,0,10,0,10,12,0,0,1,0,20,13,1
8492,197604,xWQhq9RZKw08hANIa0LgFXN2DnwycQf4,bWdj2GDclj5ofokWjzoa5jAwMkxCykd6,5,2,1,0,1,0,2,0,6,0.8571428571428571,1,0.0,0,1,0,1,2,0,0,2,0,2,4,1
8493,197622,d8GXnhJ8BgnDSKpTLyLaGdg2jK5wWL8e,G8EPVSXsOYB5YQWZGiz1aVq5Pgr2GrQu,27,31,11,10,12,0,9,0,73,10.428571428571429,1,0.0,17,11,6,12,14,0,4,9,0,46,27,1
8494,197629,pyv0DnRM0PUGZlRUjUkquPGtUI5wlNKd,bWdj2GDclj5ofokWjzoa5jAwMkxCykd6,3,0,0,0,0,0,3,0,3,0.42857142857142855,1,0.0,0,0,0,0,0,0,0,3,0,0,3,1
8495,197633,klchONEdPI3u3wOB4C8jNpM0hCX3C5RZ,RXDvfPUBYFlVdlueBFbLW0mhhAyGEqpt,24,23,17,7,12,0,4,0,63,9.0,1,0.0,3,17,7,12,20,0,0,4,0,39,24,1
8496,197640,ybqXs1BYgb66Ubmo4CtWBedAmyNUZkNR,SpATywNh6bZuzm8s1ceuBUnMUAeoAHHw,5,2,1,0,1,0,3,0,7,1.0,1,0.0,0,1,0,1,2,0,0,3,0,2,5,1
8497,197645,hbSZ24mH4oabI0uhhWxmu9uILNkjYUT4,SpATywNh6bZuzm8s1ceuBUnMUAeoAHHw,6,1,1,0,1,0,3,0,6,0.8571428571428571,1,0.0,0,1,0,1,1,0,0,3,0,2,4,1
8498,197658,VhMVe0e0vgyahnrJinzgUUFfkUYIGngP,bWdj2GDclj5ofokWjzoa5jAwMkxCykd6,1,0,0,0,0,0,1,0,1,0.14285714285714285,1,0.0,0,0,0,0,0,0,0,1,0,0,1,1
8499,197660,4fYqS5i8zH5iFL9FCzQ9Jw4wAZdnrAvU,RXDvfPUBYFlVdlueBFbLW0mhhAyGEqpt,8,5,4,0,2,0,1,0,12,1.7142857142857142,1,0.0,0,4,0,2,5,0,0,1,0,6,6,1
8500,197671,bRDOwsDzRQZuxjrOsoP53hDwwMbqZqej,SpATywNh6bZuzm8s1ceuBUnMUAeoAHHw,1,0,0,0,0,0,1,0,1,0.14285714285714285,1,0.0,0,0,0,0,0,0,0,1,0,0,1,1
8501,197673,f0YMm9i9boHqaqH06EMyOVgZ4eqVoTpv,SpATywNh6bZuzm8s1ceuBUnMUAeoAHHw,9,10,7,0,0,1,9,1,28,4.0,1,0.0,0,7,0,0,10,1,0,9,1,7,21,0
8502,197674,PpAhko9wN0CoGGKMK5cOihgQKnJKH7vJ,SpATywNh6bZuzm8s1ceuBUnMUAeoAHHw,1,0,0,0,0,0,1,0,1,0.14285714285714285,1,0.0,0,0,0,0,0,0,0,1,0,0,1,1
8503,197684,1oYUpAzbanZgtAfH9FWjQtyhbjb42Xx4,bWdj2GDclj5ofokWjzoa5jAwMkxCykd6,1,0,0,0,0,0,1,0,1,0.14285714285714285,1,0.0,0,0,0,0,0,0,0,1,0,0,1,1
8504,197685,1oYUpAzbanZgtAfH9FWjQtyhbjb42Xx4,RXDvfPUBYFlVdlueBFbLW0mhhAyGEqpt,1,0,0,0,0,0,1,0,1,0.14285714285714285,1,0.0,0,0,0,0,0,0,0,1,0,0,1,1
8505,197695,4fYqS5i8zH5iFL9FCzQ9Jw4wAZdnrAvU,bWdj2GDclj5ofokWjzoa5jAwMkxCykd6,4,2,1,0,1,0,1,0,5,0.7142857142857143,1,0.0,0,1,0,1,2,0,0,1,0,2,3,1
8506,197700,iKVVP8eq0ppb7OxMxmGwiOY8iziYmfHr,A3fsA9Zfv1X2fVEQhTw51lKENdNrEqT3,1,0,0,0,0,0,2,0,2,0.2857142857142857,1,0.0,0,0,0,0,0,0,0,2,0,0,2,1
8507,197708,HE0yFYNeyW3jGh5EhXv7uoc6O18ATk5R,A3fsA9Zfv1X2fVEQhTw51lKENdNrEqT3,19,10,8,0,8,0,1,0,27,3.857142857142857,1,0.0,0,8,0,8,10,0,0,1,0,16,11,1
8508,197723,A2szMVZ2xHQSx9WPUKhhkvBSuScZqBJF,A3fsA9Zfv1X2fVEQhTw51lKENdNrEqT3,13,7,5,0,5,0,1,0,18,2.5714285714285716,1,0.0,0,5,0,5,7,0,0,1,0,10,8,1
8509,197732,jqN3FAeYERU2lkKz9K4K9sLSZnaWl5Zg,SpATywNh6bZuzm8s1ceuBUnMUAeoAHHw,4,3,1,0,1,0,3,0,8,1.1428571428571428,1,0.0,0,1,0,1,3,0,0,3,0,2,6,1
8510,197737,HhuDqntCSTLCVngcOF2eAHqFrhEVuPmX,SpATywNh6bZuzm8s1ceuBUnMUAeoAHHw,4,2,0,0,0,0,2,0,4,0.5714285714285714,1,0.0,0,0,0,0,2,0,0,2,0,0,4,1
8511,197803,vtBnoyzeCC8wZr284IGH2R9KjVsQkSSy,SpATywNh6bZuzm8s1ceuBUnMUAeoAHHw,1,0,0,0,0,0,1,0,1,0.14285714285714285,1,0.0,0,0,0,0,0,0,0,1,0,0,1,1
8512,197827,mVLfrQRFV4YD7pibAFgNSJRdbeuiy0Sw,G8EPVSXsOYB5YQWZGiz1aVq5Pgr2GrQu,1,0,0,0,0,0,1,0,1,0.14285714285714285,1,0.0,0,0,0,0,0,0,0,1,0,0,1,1
8513,197843,1AZmjj77W8BIGEE1Hrm2nLFWlidLNL1Q,G8EPVSXsOYB5YQWZGiz1aVq5Pgr2GrQu,3,1,0,0,0,0,2,0,3,0.42857142857142855,1,0.0,0,0,0,0,1,0,0,2,0,0,3,1
8514,197860,kukBD4x4uH6xHKp8zwbeAlZ5XIJZfUlp,SpATywNh6bZuzm8s1ceuBUnMUAeoAHHw,5,2,1,0,1,0,2,0,6,0.8571428571428571,1,0.0,0,1,0,1,2,0,0,2,0,2,4,1
8515,197865,UmYxiFu6na7ioq4pFJaZYbHcM2Oxxqgd,SpATywNh6bZuzm8s1ceuBUnMUAeoAHHw,11,8,5,8,3,0,5,0,29,4.142857142857143,1,0.0,2,5,8,3,6,0,0,5,0,18,11,1
8516,197867,NvxM2w7KuHaUb4w9IwWeNWL1FPcoZWlg,SpATywNh6bZuzm8s1ceuBUnMUAeoAHHw,4,3,2,0,0,0,1,0,6,0.8571428571428571,1,0.0,0,2,0,0,3,0,0,1,0,2,4,1
8517,197891,ew6rgTKhfFlJk0TBM29erpe2hVQwpNiX,bWdj2GDclj5ofokWjzoa5jAwMkxCykd6,3,0,0,0,0,0,3,0,3,0.42857142857142855,1,0.0,0,0,0,0,0,0,0,3,0,0,3,1
8518,197901,3E2J8oODQN7NkqxkMAgArJcF2FBjPre3,G8EPVSXsOYB5YQWZGiz1aVq5Pgr2GrQu,10,5,3,0,3,0,4,0,15,2.142857142857143,1,0.0,0,3,0,3,5,0,0,4,0,6,9,1
8519,197903,quZIfUvhbgq4XxK5fzctoX77uKRPby0l,SpATywNh6bZuzm8s1ceuBUnMUAeoAHHw,5,4,1,0,1,0,1,0,7,1.0,1,0.0,0,1,0,1,4,0,0,1,0,2,5,1
8520,197906,kSxsrTO5exODRPeD7VJyPIeGcMKlqOQM,A3fsA9Zfv1X2fVEQhTw51lKENdNrEqT3,1,0,0,0,0,0,1,0,1,0.14285714285714285,1,0.0,0,0,0,0,0,0,0,1,0,0,1,1
8521,197912,OM3FARUmSrkVmJXDiM3P0y6LhqqplIHH,SpATywNh6bZuzm8s1ceuBUnMUAeoAHHw,6,2,1,0,1,0,4,0,8,1.1428571428571428,1,0.0,0,1,0,1,2,0,0,4,0,2,6,1
8522,197920,Jmn2E7XgQKFifDbJIxuDxMHLi4YpW3jx,G8EPVSXsOYB5YQWZGiz1aVq5Pgr2GrQu,3,0,0,0,0,4,2,0,6,0.8571428571428571,1,0.0,0,0,0,0,0,4,0,2,0,0,6,1
8523,197928,oqI20pdqFt40phk7jIrltWVMqWvZcban,A3fsA9Zfv1X2fVEQhTw51lKENdNrEqT3,1,0,0,0,0,0,1,0,1,0.14285714285714285,1,0.0,0,0,0,0,0,0,0,1,0,0,1,1
8524,197963,xp0PGlV4qhp60qYyxRe8xCxRmmPbM3Jj,bWdj2GDclj5ofokWjzoa5jAwMkxCykd6,1,0,0,0,0,0,4,0,4,0.5714285714285714,1,0.0,0,0,0,0,0,0,0,4,0,0,4,1
8525,197968,Kc8b3JW1MQKQC6TGWRiZEShHUO8QsHV5,SpATywNh6bZuzm8s1ceuBUnMUAeoAHHw,1,0,0,0,0,0,1,0,1,0.14285714285714285,1,0.0,0,0,0,0,0,0,0,1,0,0,1,1
8526,197975,xlZo0JM0E05KNiKs7UHaCnGkhTzmaKtg,SpATywNh6bZuzm8s1ceuBUnMUAeoAHHw,2,0,0,0,0,0,2,0,2,0.2857142857142857,1,0.0,0,0,0,0,0,0,0,2,0,0,2,1
8527,197977,WbJsJWqKM3lS43E1ayfblK0uOswvkrBy,bWdj2GDclj5ofokWjzoa5jAwMkxCykd6,2,0,0,0,0,0,3,0,3,0.42857142857142855,1,0.0,0,0,0,0,0,0,0,3,0,0,3,1
8528,197984,h4sY8Ph1vbc191O1JmHGbdnyocsoSDQO,G8EPVSXsOYB5YQWZGiz1aVq5Pgr2GrQu,5,10,1,0,0,0,3,0,14,2.0,1,0.0,0,1,0,0,10,0,0,3,0,1,13,1
8529,197985,qMtHlzOZxaTrhiGkJGWyjk6FQrkiMtpo,SpATywNh6bZuzm8s1ceuBUnMUAeoAHHw,4,3,0,0,0,0,3,0,6,0.8571428571428571,1,0.0,0,0,0,0,3,0,0,3,0,0,6,1
8530,197986,UZPajHzpSX5mbiv3Scxfu2s5ueCVoTcN,RXDvfPUBYFlVdlueBFbLW0mhhAyGEqpt,5,0,0,0,0,0,5,1,6,0.8571428571428571,1,0.0,0,0,0,0,0,0,0,5,1,0,6,1
8531,197990,EH79kaJEIeXcrssngPKoTUSLUCjHUazt,A3fsA9Zfv1X2fVEQhTw51lKENdNrEqT3,2,0,0,0,0,0,4,0,4,0.5714285714285714,1,0.0,0,0,0,0,0,0,0,4,0,0,4,1
8532,197996,6hX10Wu1E2KDRE7mYGP1VPoNRkdF7lrL,A3fsA9Zfv1X2fVEQhTw51lKENdNrEqT3,3,0,0,0,0,0,3,0,3,0.42857142857142855,1,0.0,0,0,0,0,0,0,0,3,0,0,3,0
8533,197999,NVzsLV2hJQHxCBnLyaDpT9HrhRSWUOfa,A3fsA9Zfv1X2fVEQhTw51lKENdNrEqT3,2,0,0,0,0,0,2,0,2,0.2857142857142857,1,0.0,0,0,0,0,0,0,0,2,0,0,2,1
8534,198002,Juod2UGp1EISVAlVAqDeLcVK1OmKMlrq,A3fsA9Zfv1X2fVEQhTw51lKENdNrEqT3,5,2,1,0,1,1,4,0,9,1.2857142857142858,1,0.0,0,1,0,1,2,1,0,4,0,2,7,1
8535,198015,G40CqBl9Wk8vBpLpRLZfdLIUELNw0IuK,bWdj2GDclj5ofokWjzoa5jAwMkxCykd6,11,20,7,32,6,1,8,0,74,10.571428571428571,1,0.0,8,7,30,6,12,1,2,8,0,51,23,1
8536,198020,mBkByOktWGTfbLjZh4oUEAyrYqB4PqkG,A3fsA9Zfv1X2fVEQhTw51lKENdNrEqT3,5,3,1,0,1,0,2,0,7,1.0,1,0.0,0,1,0,1,3,0,0,2,0,2,5,1
8537,198037,ptvJrZNOUMqIwb7dgd5momqDwhHuKgqy,A3fsA9Zfv1X2fVEQhTw51lKENdNrEqT3,1,0,0,0,0,0,1,0,1,0.14285714285714285,1,0.0,0,0,0,0,0,0,0,1,0,0,1,1
8538,198039,mBkByOktWGTfbLjZh4oUEAyrYqB4PqkG,bWdj2GDclj5ofokWjzoa5jAwMkxCykd6,7,7,2,10,1,0,2,0,22,3.142857142857143,1,0.0,2,2,9,1,5,0,1,2,0,14,8,1
8539,198040,hwsOMQoQpEm6hpx9rFynsAz9z0b8kZIy,SpATywNh6bZuzm8s1ceuBUnMUAeoAHHw,6,3,1,0,0,0,3,1,8,1.1428571428571428,1,0.0,0,1,0,0,3,0,0,3,1,1,7,1
8540,198057,ZPbUovw1YoDeaWUVrbGEj5A5WdIXTYjf,A3fsA9Zfv1X2fVEQhTw51lKENdNrEqT3,41,20,16,58,10,4,3,0,111,15.857142857142858,1,0.0,1,16,52,10,19,4,6,3,0,79,32,1
8541,198059,THP1XMjHSxStaFTc2EbpYMi7w0ocTWsv,A3fsA9Zfv1X2fVEQhTw51lKENdNrEqT3,2,0,0,0,0,0,2,0,2,0.2857142857142857,1,0.0,0,0,0,0,0,0,0,2,0,0,2,1
8542,198064,FmREEBmKaoWQV1gJ6HLZOzgC3kziEupI,SpATywNh6bZuzm8s1ceuBUnMUAeoAHHw,9,6,3,5,2,0,2,0,18,2.5714285714285716,1,0.0,2,3,4,2,4,0,1,2,0,11,7,1
8543,198072,ydSu1htsBf3RzcwY9UTcwNk58kfOh1CK,A3fsA9Zfv1X2fVEQhTw51lKENdNrEqT3,1,0,0,0,0,0,1,0,1,0.14285714285714285,1,0.0,0,0,0,0,0,0,0,1,0,0,1,1
8544,198075,Zh41FGMVAot9ISpRqN7C51AlQVbP6TRp,G8EPVSXsOYB5YQWZGiz1aVq5Pgr2GrQu,1,0,0,0,0,0,1,0,1,0.14285714285714285,1,0.0,0,0,0,0,0,0,0,1,0,0,1,1
8545,198089,1Y8zyxJNFqsbAxngaSR4MBCJMYy7aumA,A3fsA9Zfv1X2fVEQhTw51lKENdNrEqT3,1,0,0,0,0,0,1,0,1,0.14285714285714285,1,0.0,0,0,0,0,0,0,0,1,0,0,1,1
8546,198092,7qSkKlCfwbOANWGSAwfdpq7Q0evXlyXJ,A3fsA9Zfv1X2fVEQhTw51lKENdNrEqT3,2,0,0,0,0,0,2,0,2,0.2857142857142857,1,0.0,0,0,0,0,0,0,0,2,0,0,2,1
8547,198094,NVHlXFJKdfwucYR5YquGJkYfegUD35pC,bWdj2GDclj5ofokWjzoa5jAwMkxCykd6,1,0,0,0,0,0,1,0,1,0.14285714285714285,1,0.0,0,0,0,0,0,0,0,1,0,0,1,1
8548,198096,gQqEJZs7B37MmzRexP5otRszUHd2KLYy,A3fsA9Zfv1X2fVEQhTw51lKENdNrEqT3,18,11,9,0,7,0,4,0,31,4.428571428571429,1,0.0,0,9,0,7,11,0,0,4,0,16,15,1
8549,198102,UmMUmfW7iDbccQsjMsWCLdabczIvW3k8,G8EPVSXsOYB5YQWZGiz1aVq5Pgr2GrQu,10,20,7,10,4,0,4,0,45,6.428571428571429,1,0.0,10,7,6,4,10,0,4,4,0,27,18,1
8550,198108,tpRB0Y2odcJ8wbxdjaREs5gktwFdDR2h,A3fsA9Zfv1X2fVEQhTw51lKENdNrEqT3,46,72,30,82,21,41,15,3,264,37.714285714285715,1,0.0,1,30,64,21,71,41,18,15,3,116,148,1
8551,198110,Psbjgi8UNl2rcrsYIe1cv0JHA13unwqh,A3fsA9Zfv1X2fVEQhTw51lKENdNrEqT3,9,6,4,0,3,0,1,0,14,2.0,1,0.0,0,4,0,3,6,0,0,1,0,7,7,1
8552,198119,ivQxpA3T4qXcNV0IuvLDkzJLb00vpKY1,A3fsA9Zfv1X2fVEQhTw51lKENdNrEqT3,9,5,4,0,4,0,3,0,16,2.2857142857142856,1,0.0,0,4,0,4,5,0,0,3,0,8,8,1
8553,198123,Bobzv8PFDIeID7NJyzm72ZPzBi51TYoj,G8EPVSXsOYB5YQWZGiz1aVq5Pgr2GrQu,4,1,0,0,0,0,6,0,7,1.0,1,0.0,0,0,0,0,1,0,0,6,0,0,7,1
8554,198126,EuJrP6kozTqtmrZ2kvjKbbdLy1MAtd6Q,G8EPVSXsOYB5YQWZGiz1aVq5Pgr2GrQu,5,2,0,0,0,0,3,0,5,0.7142857142857143,1,0.0,0,0,0,0,2,0,0,3,0,0,5,1
8555,198127,NRHQ3tSUEv4DHf8jZg8RV7YWaKkLB0Yk,A3fsA9Zfv1X2fVEQhTw51lKENdNrEqT3,4,3,0,0,0,0,2,0,5,0.7142857142857143,1,0.0,1,0,0,0,2,0,0,2,0,1,4,1
8556,198148,PumYHOn9wm04kyhWSxqPbI3SWXpAfHRE,bWdj2GDclj5ofokWjzoa5jAwMkxCykd6,5,11,3,0,3,0,2,0,19,2.7142857142857144,1,0.0,4,3,0,3,7,0,0,2,0,10,9,1
8557,198151,1DCeTt0CkcmxoPvN3IFKoXhg62qIczOd,G8EPVSXsOYB5YQWZGiz1aVq5Pgr2GrQu,7,4,1,0,1,0,3,0,9,1.2857142857142858,1,0.0,0,1,0,1,4,0,0,3,0,2,7,1
8558,198157,BnOHUZJJ8tQ0RqiSOgsTvzjr9EqA1Ahw,A3fsA9Zfv1X2fVEQhTw51lKENdNrEqT3,2,0,0,0,0,0,4,0,4,0.5714285714285714,1,0.0,0,0,0,0,0,0,0,4,0,0,4,1
8559,198160,BAyN80jjR5TuHhGoBQcino62lPw8bhBn,A3fsA9Zfv1X2fVEQhTw51lKENdNrEqT3,8,7,5,0,3,0,5,0,20,2.857142857142857,1,0.0,0,5,0,3,7,0,0,5,0,8,12,1
8560,198164,Wm4d7ifDaTgcR0GfUqwJt5OZKbYglRCq,A3fsA9Zfv1X2fVEQhTw51lKENdNrEqT3,1,0,0,0,0,0,1,0,1,0.14285714285714285,1,0.0,0,0,0,0,0,0,0,1,0,0,1,1
8561,198174,sN8O8pu3Q2qKEwnDCRLYVlmO1uAJE4Tm,bWdj2GDclj5ofokWjzoa5jAwMkxCykd6,2,0,0,0,0,0,2,0,2,0.2857142857142857,1,0.0,0,0,0,0,0,0,0,2,0,0,2,1
8562,198185,sAxHVWDxoGkBRa6727BiAQz0xOxKCIGR,A3fsA9Zfv1X2fVEQhTw51lKENdNrEqT3,13,12,6,12,5,0,4,0,39,5.571428571428571,1,0.0,0,6,10,5,12,0,2,4,0,21,18,1
8563,198188,l5G8UW1TXnTSjtyKClgVOnqQm4ApNaj0,SpATywNh6bZuzm8s1ceuBUnMUAeoAHHw,1,0,0,0,0,0,1,0,1,0.14285714285714285,1,0.0,0,0,0,0,0,0,0,1,0,0,1,1
8564,198191,5bHmfN0X9wT3swMDlkpW5ii5MZXZrCFW,SpATywNh6bZuzm8s1ceuBUnMUAeoAHHw,15,22,6,19,4,2,4,0,57,8.142857142857142,1,0.0,15,6,16,4,7,2,3,4,0,41,16,1
8565,198193,LFKsM29SPdpn03mCOLrrK3FdXPUDZBKB,A3fsA9Zfv1X2fVEQhTw51lKENdNrEqT3,5,2,1,0,1,0,5,0,9,1.2857142857142858,1,0.0,0,1,0,1,2,0,0,5,0,2,7,1
8566,198197,SC8FL9WL3BPOx8OCkTnqw5xmr73Pqs8z,A3fsA9Zfv1X2fVEQhTw51lKENdNrEqT3,7,4,3,0,3,0,2,0,12,1.7142857142857142,1,0.0,0,3,0,3,4,0,0,2,0,6,6,1
8567,198198,93Os1dPmyvzf4unZeLzWAm1E98vamZ7f,SpATywNh6bZuzm8s1ceuBUnMUAeoAHHw,5,2,1,0,1,0,2,0,6,0.8571428571428571,1,0.0,0,1,0,1,2,0,0,2,0,2,4,1
8568,198209,xudoA9elSC5Ik0l8XT7ohHiAxUwBFTwg,SpATywNh6bZuzm8s1ceuBUnMUAeoAHHw,14,9,6,11,4,0,2,0,32,4.571428571428571,1,0.0,2,6,9,4,7,0,2,2,0,21,11,1
8569,198227,NXiIb9Dcpvf6m1gIchCaIvmdnXDXN6rC,A3fsA9Zfv1X2fVEQhTw51lKENdNrEqT3,21,10,9,0,9,1,12,1,42,6.0,1,0.0,0,9,0,9,10,1,0,12,1,18,24,1
8570,198228,So8gZ8cXseEZ7lXf4idNMqcN46bXtlIA,bWdj2GDclj5ofokWjzoa5jAwMkxCykd6,4,2,1,0,1,0,1,0,5,0.7142857142857143,1,0.0,0,1,0,1,2,0,0,1,0,2,3,1
8571,198231,tblYMREbAeB7j9qmk5L4ctIeWrhD9ybH,A3fsA9Zfv1X2fVEQhTw51lKENdNrEqT3,1,0,0,0,0,0,1,0,1,0.14285714285714285,1,0.0,0,0,0,0,0,0,0,1,0,0,1,1
8572,198245,qq2f8Akny1ajULPtgXYv9fMRWduKMr9q,A3fsA9Zfv1X2fVEQhTw51lKENdNrEqT3,7,2,1,0,1,0,4,1,9,1.2857142857142858,1,0.0,0,1,0,1,2,0,0,4,1,2,7,1
8573,198253,eZIzehl9YTnThSDhfRvumYM9JAWW8X94,A3fsA9Zfv1X2fVEQhTw51lKENdNrEqT3,9,6,1,0,1,1,5,3,17,2.4285714285714284,1,0.0,0,1,0,1,6,1,0,5,3,2,15,1
8574,198257,FM9F7roZRXjjLVpKJMa3bf9FDgpJfg8g,A3fsA9Zfv1X2fVEQhTw51lKENdNrEqT3,1,0,0,0,0,0,1,0,1,0.14285714285714285,1,0.0,0,0,0,0,0,0,0,1,0,0,1,1
8575,198260,84GcjGYfYBEDW8RMth7eOtG4XRkKowY7,SpATywNh6bZuzm8s1ceuBUnMUAeoAHHw,5,5,2,0,1,0,2,0,10,1.4285714285714286,1,0.0,0,2,0,1,5,0,0,2,0,3,7,1
8576,198261,2dPSdalUbHtu7nWWfNnHcWGVd8UXHjrQ,SpATywNh6bZuzm8s1ceuBUnMUAeoAHHw,16,16,5,11,3,1,4,2,42,6.0,1,0.0,7,5,10,3,9,1,1,4,2,25,17,1
8577,198266,itycNCCvd4Cws5pdd4hKIkDKI4KaE5Jt,A3fsA9Zfv1X2fVEQhTw51lKENdNrEqT3,27,11,10,16,9,0,1,0,47,6.714285714285714,1,0.0,0,10,16,9,11,0,0,1,0,35,12,1
8578,198268,aIL1NEjCe1OHtEKm6JpGdIdTZNDD6Wwu,SpATywNh6bZuzm8s1ceuBUnMUAeoAHHw,1,0,0,0,0,0,1,0,1,0.14285714285714285,1,0.0,0,0,0,0,0,0,0,1,0,0,1,1
8579,198273,3UZJYrArdmpKznqwnck7MTEpjxG34pMK,SpATywNh6bZuzm8s1ceuBUnMUAeoAHHw,5,2,1,0,1,0,2,0,6,0.8571428571428571,1,0.0,0,1,0,1,2,0,0,2,0,2,4,1
8580,198284,TPwZPOPBUdCaLSbv54gObUYtfBQKaJVW,A3fsA9Zfv1X2fVEQhTw51lKENdNrEqT3,1,0,0,0,0,0,1,0,1,0.14285714285714285,1,0.0,0,0,0,0,0,0,0,1,0,0,1,1
8581,198297,bpXV0HZ9yixzCGyJdeSxqm4EvQYi9XKg,SpATywNh6bZuzm8s1ceuBUnMUAeoAHHw,2,0,0,0,0,0,3,0,3,0.42857142857142855,1,0.0,0,0,0,0,0,0,0,3,0,0,3,1
8582,198303,qzSOzKpDnUaSHLwAqVpSpGcUMfaOhDjD,G8EPVSXsOYB5YQWZGiz1aVq5Pgr2GrQu,5,2,1,0,1,0,2,0,6,0.8571428571428571,1,0.0,0,1,0,1,2,0,0,2,0,2,4,1
8583,198310,Cgmx3Ujcxc92HHP4N1UU0TjRl5xBcyRy,A3fsA9Zfv1X2fVEQhTw51lKENdNrEqT3,8,5,3,0,3,0,1,0,12,1.7142857142857142,1,0.0,1,3,0,3,4,0,0,1,0,7,5,1
8584,198312,nrvDpyOlV5T6ZU5wiBAqPXpBwJOtawqO,bWdj2GDclj5ofokWjzoa5jAwMkxCykd6,9,9,3,0,2,6,7,4,31,4.428571428571429,1,0.0,1,3,0,2,8,6,0,7,4,6,25,1
8585,198314,d6GKFo7VpAwS4H9iF45HPuBB7oVkM6uC,SpATywNh6bZuzm8s1ceuBUnMUAeoAHHw,10,8,3,16,2,0,2,0,31,4.428571428571429,1,0.0,4,3,13,2,4,0,3,2,0,22,9,1
8586,198319,hM78zuTWvc2c2WdiFwwJZnLKCiMEzZwE,RXDvfPUBYFlVdlueBFbLW0mhhAyGEqpt,5,4,3,0,2,0,1,0,10,1.4285714285714286,1,0.0,0,3,0,2,4,0,0,1,0,5,5,1
8587,198322,ZdxnlwASEXds7VOuv4UniogqFzAjU71x,G8EPVSXsOYB5YQWZGiz1aVq5Pgr2GrQu,4,0,0,0,0,1,3,0,4,0.5714285714285714,1,0.0,0,0,0,0,0,1,0,3,0,0,4,1
8588,198342,X3X3klM03RXeGUjty93sg2SlkZrg3xpQ,SpATywNh6bZuzm8s1ceuBUnMUAeoAHHw,1,0,0,0,0,0,1,0,1,0.14285714285714285,1,0.0,0,0,0,0,0,0,0,1,0,0,1,1
8589,198343,7XiYdmZTSPhaWzjUuGCUAw2ynyRrmxfl,SpATywNh6bZuzm8s1ceuBUnMUAeoAHHw,8,12,4,0,2,3,2,0,23,3.2857142857142856,1,0.0,6,4,0,2,6,3,0,2,0,12,11,1
8590,198344,walE7JsvJqHl8yLz0PR8Oim32Lz4OIQ0,A3fsA9Zfv1X2fVEQhTw51lKENdNrEqT3,1,0,0,0,0,0,1,0,1,0.14285714285714285,1,0.0,0,0,0,0,0,0,0,1,0,0,1,1
8591,198353,ByX3sCZWzA6bGb4zKqYogAA175eLOyAG,SpATywNh6bZuzm8s1ceuBUnMUAeoAHHw,11,8,6,2,3,0,1,0,20,2.857142857142857,1,0.0,1,6,2,3,7,0,0,1,0,12,8,1
8592,198372,hl3CIQ0lpvTB8gq9L7ARkQJG7PfzlcBL,RXDvfPUBYFlVdlueBFbLW0mhhAyGEqpt,1,0,0,0,0,0,1,0,1,0.14285714285714285,1,0.0,0,0,0,0,0,0,0,1,0,0,1,1
8593,198374,5fiIK7VmqPKr4nf6AwCLv5FpXOs8AmIF,A3fsA9Zfv1X2fVEQhTw51lKENdNrEqT3,4,2,1,0,1,0,2,0,6,0.8571428571428571,1,0.0,0,1,0,1,2,0,0,2,0,2,4,1
8594,198378,xsoPQiWD0DInR2Sgur0NcgW3AIl7NeY0,SpATywNh6bZuzm8s1ceuBUnMUAeoAHHw,5,3,1,0,1,0,2,0,7,1.0,1,0.0,0,1,0,1,3,0,0,2,0,2,5,1
8595,198379,dgFOOUSNfQK8xIrT47Av0Q04bBFeE21W,A3fsA9Zfv1X2fVEQhTw51lKENdNrEqT3,7,3,2,0,2,0,3,0,10,1.4285714285714286,1,0.0,0,2,0,2,3,0,0,3,0,4,6,0
8596,198388,zum8lmwUciqBOjRcsKypiYs2OlSb1h15,A3fsA9Zfv1X2fVEQhTw51lKENdNrEqT3,9,6,1,0,1,0,4,0,12,1.7142857142857142,1,0.0,0,1,0,1,6,0,0,4,0,2,10,0
8597,198398,83TQNbmBQ9BH29WB1QIy1fMhXfCV72jv,A3fsA9Zfv1X2fVEQhTw51lKENdNrEqT3,1,0,0,0,0,0,1,0,1,0.14285714285714285,1,0.0,0,0,0,0,0,0,0,1,0,0,1,1
8598,198400,C23sTQ3IqWj72FdxhbjBadlgfhNvNhLt,bWdj2GDclj5ofokWjzoa5jAwMkxCykd6,4,2,1,0,0,0,2,0,5,0.7142857142857143,1,0.0,0,1,0,0,2,0,0,2,0,1,4,1
8599,198403,Dq2cCGdJlkpRnI9Tq5kE4JyzjGIGvpDz,A3fsA9Zfv1X2fVEQhTw51lKENdNrEqT3,9,5,3,0,3,0,4,0,15,2.142857142857143,1,0.0,0,3,0,3,5,0,0,4,0,6,9,1
8600,198404,hrPjKcL9rUfM1fnC8qta4lu2HmlsBLv6,A3fsA9Zfv1X2fVEQhTw51lKENdNrEqT3,12,6,5,0,5,0,1,0,17,2.4285714285714284,1,0.0,0,5,0,5,6,0,0,1,0,10,7,1
8601,198410,Kkww4jmevg0ZHJyNJmjfSGoxXiVH3qc9,SpATywNh6bZuzm8s1ceuBUnMUAeoAHHw,5,2,1,0,1,3,3,0,10,1.4285714285714286,1,0.0,0,1,0,1,2,3,0,3,0,2,8,1
8602,198411,6dJBpGT7qNr0NTuZjVXnITeb9R9DQeyE,SpATywNh6bZuzm8s1ceuBUnMUAeoAHHw,2,0,0,0,0,0,2,0,2,0.2857142857142857,1,0.0,0,0,0,0,0,0,0,2,0,0,2,1
8603,198416,KhKCxhPBpm8wuQfuIb6HFYBHnnvZJlex,RXDvfPUBYFlVdlueBFbLW0mhhAyGEqpt,1,0,0,0,0,0,1,0,1,0.14285714285714285,1,0.0,0,0,0,0,0,0,0,1,0,0,1,1
8604,198417,2uLHED4iY9VmLy5RW7Mfy2sLsR8ze3u7,RXDvfPUBYFlVdlueBFbLW0mhhAyGEqpt,1,0,0,0,0,0,1,0,1,0.14285714285714285,1,0.0,0,0,0,0,0,0,0,1,0,0,1,1
8605,198429,Fm0KmurJVBFEZiRcw3nlgAYLTArGnQaR,SpATywNh6bZuzm8s1ceuBUnMUAeoAHHw,16,30,1,14,1,20,14,4,84,12.0,1,0.0,7,1,12,1,23,20,2,14,4,21,63,1
8606,198446,P4gIdHzF607L8e8VPH3Qb09lxgNZRJFa,SpATywNh6bZuzm8s1ceuBUnMUAeoAHHw,4,3,0,0,0,0,1,0,4,0.5714285714285714,1,0.0,0,0,0,0,3,0,0,1,0,0,4,0
8607,198448,brW82YOCdOnTyLjpAh6QOg0ROSIhJ2Rz,A3fsA9Zfv1X2fVEQhTw51lKENdNrEqT3,2,0,0,0,0,0,3,0,3,0.42857142857142855,1,0.0,0,0,0,0,0,0,0,3,0,0,3,1
8608,198449,ncZpzPYvUtQjJgcrnY99CiTzo4JQVsl8,SpATywNh6bZuzm8s1ceuBUnMUAeoAHHw,4,2,0,0,0,0,2,0,4,0.5714285714285714,1,0.0,0,0,0,0,2,0,0,2,0,0,4,1
8609,198454,MqwnKklVqrb7jfevVzyfhGQMDPOkys7S,A3fsA9Zfv1X2fVEQhTw51lKENdNrEqT3,6,2,0,0,0,1,7,1,11,1.5714285714285714,1,0.0,0,0,0,0,2,1,0,7,1,0,11,1
8610,198475,Wq2ch7EEtsSKF9Vm0sUqWsaIHScTXudA,SpATywNh6bZuzm8s1ceuBUnMUAeoAHHw,4,2,1,0,1,0,1,0,5,0.7142857142857143,1,0.0,0,1,0,1,2,0,0,1,0,2,3,1
8611,198479,zHNYns4eYsvaD0PCrPbR7JoIqflHxrEv,A3fsA9Zfv1X2fVEQhTw51lKENdNrEqT3,1,0,0,0,0,0,1,0,1,0.14285714285714285,1,0.0,0,0,0,0,0,0,0,1,0,0,1,1
8612,198486,jHa0rWGu66mtR6qdZK3honEGURZjLRQo,SpATywNh6bZuzm8s1ceuBUnMUAeoAHHw,4,4,3,0,3,0,1,0,11,1.5714285714285714,1,0.0,0,3,0,3,4,0,0,1,0,6,5,0
8613,198492,SZnZ9mw8U8WzrYPDnWgxJCTIBCqTF6rB,SpATywNh6bZuzm8s1ceuBUnMUAeoAHHw,2,0,0,0,0,0,2,0,2,0.2857142857142857,1,0.0,0,0,0,0,0,0,0,2,0,0,2,1
8614,198495,OO2Ag6HEFKkZRtZuzzt1ya8SiL4BLCOC,RXDvfPUBYFlVdlueBFbLW0mhhAyGEqpt,1,0,0,0,0,0,1,0,1,0.14285714285714285,1,0.0,0,0,0,0,0,0,0,1,0,0,1,1
8615,198496,byyujsciSYId0rQQrEakxEnXcWLiLPay,SpATywNh6bZuzm8s1ceuBUnMUAeoAHHw,10,9,1,0,1,1,9,1,22,3.142857142857143,1,0.0,0,1,0,1,9,1,0,9,1,2,20,1
8616,198497,AfmdKPTL0IbcupndNMlY5c7PImPraChY,A3fsA9Zfv1X2fVEQhTw51lKENdNrEqT3,13,7,5,0,5,0,1,0,18,2.5714285714285716,1,0.0,0,5,0,5,7,0,0,1,0,10,8,1
8617,198500,dN2hlyHLZZp4dyg60YxnWe6xCUBAX5se,bWdj2GDclj5ofokWjzoa5jAwMkxCykd6,4,3,1,0,1,0,2,0,7,1.0,1,0.0,0,1,0,1,3,0,0,2,0,2,5,1
8618,198501,EwaALzeaojV7pPZOsHFx7jzB7xjVDGvQ,bWdj2GDclj5ofokWjzoa5jAwMkxCykd6,8,4,0,14,0,1,3,1,23,3.2857142857142856,1,0.0,1,0,14,0,3,1,0,3,1,15,8,1
8619,198503,F16OuTgaH1ZbsvG4bVnrHtSG2xmdMXNR,A3fsA9Zfv1X2fVEQhTw51lKENdNrEqT3,7,5,2,0,2,0,2,1,12,1.7142857142857142,1,0.0,0,2,0,2,5,0,0,2,1,4,8,1
8620,198506,sVvZPZ3GVHWR4Hg1FcQf4FWks0TLCNOR,A3fsA9Zfv1X2fVEQhTw51lKENdNrEqT3,14,7,5,0,3,1,8,1,25,3.5714285714285716,1,0.0,0,5,0,3,7,1,0,8,1,8,17,1
8621,198517,xIuD143aD9LhLXzAc6byVmIGYF4SpJsZ,A3fsA9Zfv1X2fVEQhTw51lKENdNrEqT3,1,0,0,0,0,0,1,0,1,0.14285714285714285,1,0.0,0,0,0,0,0,0,0,1,0,0,1,1
8622,198518,eEUIScknc9SimnLuPMm5Vf07ulWcWd92,A3fsA9Zfv1X2fVEQhTw51lKENdNrEqT3,1,0,0,0,0,0,1,0,1,0.14285714285714285,1,0.0,0,0,0,0,0,0,0,1,0,0,1,1
8623,198529,eBQTzPv3v3TV7mZrXSw0RrOHTLWkqz5k,bWdj2GDclj5ofokWjzoa5jAwMkxCykd6,7,4,2,0,2,0,2,0,10,1.4285714285714286,1,0.0,1,2,0,2,3,0,0,2,0,5,5,1
8624,198539,w7s7CbDlE2P2RGY2w8kEYH9keSavEsec,bWdj2GDclj5ofokWjzoa5jAwMkxCykd6,2,0,0,0,0,0,2,0,2,0.2857142857142857,1,0.0,0,0,0,0,0,0,0,2,0,0,2,1
8625,198547,2kSwVlbsGRMwb7boxmMBKvNiRXYYeI1Y,SpATywNh6bZuzm8s1ceuBUnMUAeoAHHw,2,0,0,0,0,0,2,0,2,0.2857142857142857,1,0.0,0,0,0,0,0,0,0,2,0,0,2,1
8626,198550,dYWKoJoBpKPEwdcqoTPZCoTIyvG7V1Tu,A3fsA9Zfv1X2fVEQhTw51lKENdNrEqT3,6,3,1,0,1,6,5,0,16,2.2857142857142856,1,0.0,0,1,0,1,3,6,0,5,0,2,14,1
8627,198555,s37SmpVU3dTE3yD2mQmjjcBs0sjjoAwz,SpATywNh6bZuzm8s1ceuBUnMUAeoAHHw,15,28,0,18,0,4,8,3,61,8.714285714285714,1,0.0,18,0,17,0,10,4,1,8,3,35,26,1
8628,198560,b0mgWZqNzMdtJFxZULQczG8Tc3XpTILP,bWdj2GDclj5ofokWjzoa5jAwMkxCykd6,9,6,3,2,3,0,1,0,15,2.142857142857143,1,0.0,2,3,2,3,4,0,0,1,0,10,5,0
8629,198562,dYWKoJoBpKPEwdcqoTPZCoTIyvG7V1Tu,bWdj2GDclj5ofokWjzoa5jAwMkxCykd6,7,5,2,0,2,0,1,0,10,1.4285714285714286,1,0.0,0,2,0,2,5,0,0,1,0,4,6,1
8630,198566,zhF9aamFaaPbw8uvKpkg1m1HOa3rg91T,A3fsA9Zfv1X2fVEQhTw51lKENdNrEqT3,18,9,8,0,8,0,1,0,26,3.7142857142857144,1,0.0,0,8,0,8,9,0,0,1,0,16,10,1
8631,198567,4GJSwwikGuUWXSajcKoSlvfsoiC8eEZq,A3fsA9Zfv1X2fVEQhTw51lKENdNrEqT3,12,16,14,0,0,0,4,0,34,4.857142857142857,1,0.0,0,14,0,0,16,0,0,4,0,14,20,1
8632,198575,IR9p9WuPGPaaA4f6RkgkUYRRmOTg8aPE,SpATywNh6bZuzm8s1ceuBUnMUAeoAHHw,1,0,0,0,0,0,1,0,1,0.14285714285714285,1,0.0,0,0,0,0,0,0,0,1,0,0,1,1
8633,198576,M75L90OOMTV1kEiI3n7vM0ty47YBFna9,A3fsA9Zfv1X2fVEQhTw51lKENdNrEqT3,5,7,1,0,1,0,2,0,11,1.5714285714285714,1,0.0,0,1,0,1,7,0,0,2,0,2,9,1
8634,198577,QXph4cOoRqm5422pzQXvVGuiJ0zPyE5f,SpATywNh6bZuzm8s1ceuBUnMUAeoAHHw,7,4,3,0,3,0,2,0,12,1.7142857142857142,1,0.0,0,3,0,3,4,0,0,2,0,6,6,1
8635,198580,iJRgFwBj3cEAZI5JrvtGnB3yvPVZ5Cdq,bWdj2GDclj5ofokWjzoa5jAwMkxCykd6,8,2,2,0,2,0,3,0,9,1.2857142857142858,1,0.0,0,2,0,2,2,0,0,3,0,4,5,1
8636,198581,W5wwRspxUk4ZCYBlSnCmonKbHdsPqzQn,SpATywNh6bZuzm8s1ceuBUnMUAeoAHHw,2,0,0,0,0,0,2,0,2,0.2857142857142857,1,0.0,0,0,0,0,0,0,0,2,0,0,2,1
8637,198584,0q3P6YGkZ2dxtBIeVbo5DKpZyIRZVZAM,A3fsA9Zfv1X2fVEQhTw51lKENdNrEqT3,1,0,0,0,0,0,1,0,1,0.14285714285714285,1,0.0,0,0,0,0,0,0,0,1,0,0,1,1
8638,198596,ZfjfwFl0JPdJif1Zgl3u0FEb4C4l2Zxn,A3fsA9Zfv1X2fVEQhTw51lKENdNrEqT3,8,4,2,0,3,0,1,0,10,1.4285714285714286,1,0.0,0,2,0,3,4,0,0,1,0,5,5,1
8639,198603,fsydotVTfs3IO9vO0Vkp2xRbb1WB0CCz,SpATywNh6bZuzm8s1ceuBUnMUAeoAHHw,8,3,1,0,1,0,7,1,13,1.8571428571428572,1,0.0,0,1,0,1,3,0,0,7,1,2,11,1
8640,198605,pnnKMIXc9aatMHlNextjL8MoSsu3IuzR,SpATywNh6bZuzm8s1ceuBUnMUAeoAHHw,5,2,1,0,1,0,2,0,6,0.8571428571428571,1,0.0,0,1,0,1,2,0,0,2,0,2,4,1
8641,198637,CUEyHbsjLlbX6I7tsbnNjxFI1v5Lj4iD,bWdj2GDclj5ofokWjzoa5jAwMkxCykd6,5,2,1,0,1,0,2,0,6,0.8571428571428571,1,0.0,0,1,0,1,2,0,0,2,0,2,4,1
8642,198643,6lxqO6gucEPo0iFbRZ4Psmditgm2GZdr,SpATywNh6bZuzm8s1ceuBUnMUAeoAHHw,10,7,4,6,0,0,3,0,20,2.857142857142857,1,0.0,2,4,6,0,5,0,0,3,0,12,8,1
8643,198646,iCEb35gaygczCVXBPDGlI3sXrSsDaVej,bWdj2GDclj5ofokWjzoa5jAwMkxCykd6,1,0,0,0,0,0,2,0,2,0.2857142857142857,1,0.0,0,0,0,0,0,0,0,2,0,0,2,1
8644,198656,mXfwwTIVjHMqoVKAh2iEQbinKUCJHwTp,A3fsA9Zfv1X2fVEQhTw51lKENdNrEqT3,8,6,3,0,2,0,8,0,19,2.7142857142857144,1,0.0,0,3,0,2,6,0,0,8,0,5,14,1
8645,198671,34cVbMGyVO1SqQjOK9RNk00q4uKA3nIE,SpATywNh6bZuzm8s1ceuBUnMUAeoAHHw,5,2,1,0,1,0,2,0,6,0.8571428571428571,1,0.0,0,1,0,1,2,0,0,2,0,2,4,1
8646,198676,8OMQVFIkmUspkJuyYp0KATDRhux0sdCZ,A3fsA9Zfv1X2fVEQhTw51lKENdNrEqT3,5,0,0,0,0,1,5,1,7,1.0,1,0.0,0,0,0,0,0,1,0,5,1,0,7,1
8647,198682,O1JCj9IRlzuPnXGSMFH3o6nPheXmI0dk,A3fsA9Zfv1X2fVEQhTw51lKENdNrEqT3,5,2,0,0,0,0,3,1,6,0.8571428571428571,1,0.0,0,0,0,0,2,0,0,3,1,0,6,1
8648,198700,iJRgFwBj3cEAZI5JrvtGnB3yvPVZ5Cdq,A3fsA9Zfv1X2fVEQhTw51lKENdNrEqT3,6,1,1,0,1,0,3,0,6,0.8571428571428571,1,0.0,0,1,0,1,1,0,0,3,0,2,4,1
8649,198709,JlndvP2EuIlwJAySHuL6QfQBf6i8elGn,G8EPVSXsOYB5YQWZGiz1aVq5Pgr2GrQu,2,0,0,0,0,0,2,0,2,0.2857142857142857,1,0.0,0,0,0,0,0,0,0,2,0,0,2,1
8650,198711,5Lnagj9S1Vv0G8cjSfxcxK2ro2WrQMdB,G8EPVSXsOYB5YQWZGiz1aVq5Pgr2GrQu,4,2,0,0,0,0,5,0,7,1.0,1,0.0,0,0,0,0,2,0,0,5,0,0,7,1
8651,198722,ITvb0EWV8ZZ88RI4SBwUoVbHLyVcwZRP,A3fsA9Zfv1X2fVEQhTw51lKENdNrEqT3,13,12,1,0,0,0,2,0,15,2.142857142857143,1,0.0,0,1,0,0,12,0,0,2,0,1,14,1
8652,198734,QCY6rb7yvcagouaf25uIFV9RWdPPOb7l,SpATywNh6bZuzm8s1ceuBUnMUAeoAHHw,5,4,0,0,0,0,1,0,5,0.7142857142857143,1,0.0,0,0,0,0,4,0,0,1,0,0,5,1
8653,198739,QvUtN7NvmMmWACtjGZbRh5vUGOqoadOI,SpATywNh6bZuzm8s1ceuBUnMUAeoAHHw,1,0,0,0,0,0,1,0,1,0.14285714285714285,1,0.0,0,0,0,0,0,0,0,1,0,0,1,1
8654,198740,ilMjmMVbiUSUOOjXRXyXhngOcMKQcGhx,G8EPVSXsOYB5YQWZGiz1aVq5Pgr2GrQu,2,0,0,0,0,0,2,0,2,0.2857142857142857,1,0.0,0,0,0,0,0,0,0,2,0,0,2,1
8655,198747,ScmiDI5AINzZbjcs2bWNBHbp8udIsqgh,SpATywNh6bZuzm8s1ceuBUnMUAeoAHHw,7,7,2,0,1,0,3,0,13,1.8571428571428572,1,0.0,0,2,0,1,7,0,0,3,0,3,10,1
8656,198755,l99Zcol89MEEF7ym4ZK8FY1ESaelZnlP,A3fsA9Zfv1X2fVEQhTw51lKENdNrEqT3,8,5,4,0,4,0,1,0,14,2.0,1,0.0,0,4,0,4,5,0,0,1,0,8,6,0
8657,198761,ONe4iInwtHkZ5gtlbWN831JopVHbaD8L,SpATywNh6bZuzm8s1ceuBUnMUAeoAHHw,3,0,0,0,0,2,5,0,7,1.0,1,0.0,0,0,0,0,0,2,0,5,0,0,7,1
8658,198769,XduGpggqMznFnxTLbAhFUOyKgFLNMc8n,SpATywNh6bZuzm8s1ceuBUnMUAeoAHHw,4,2,1,0,1,0,1,0,5,0.7142857142857143,1,0.0,0,1,0,1,2,0,0,1,0,2,3,1
8659,198792,g1dFQ3mnVnBiIhnsU4zqK21biH9l5lF9,A3fsA9Zfv1X2fVEQhTw51lKENdNrEqT3,1,0,0,0,0,0,1,0,1,0.14285714285714285,1,0.0,0,0,0,0,0,0,0,1,0,0,1,1
8660,198793,QrIpd1N2l4iqQkNACgUM7iTDn2RZjb2Z,A3fsA9Zfv1X2fVEQhTw51lKENdNrEqT3,1,0,0,0,0,0,1,0,1,0.14285714285714285,1,0.0,0,0,0,0,0,0,0,1,0,0,1,1
8661,198807,FrcNdFNfLYMOg5fdBzjs15qKbgtHEYZH,A3fsA9Zfv1X2fVEQhTw51lKENdNrEqT3,5,2,1,0,1,0,2,0,6,0.8571428571428571,1,0.0,0,1,0,1,2,0,0,2,0,2,4,0
8662,198812,DxsFVZh699mkeWBLgWLRdSxOs5e2KIgS,SpATywNh6bZuzm8s1ceuBUnMUAeoAHHw,11,8,4,0,2,3,7,1,25,3.5714285714285716,1,0.0,2,4,0,2,6,3,0,7,1,8,17,1
8663,198820,chD7Ekz0CCeTW4cvhA1an0KXokkNIvTf,SpATywNh6bZuzm8s1ceuBUnMUAeoAHHw,1,0,0,0,0,0,1,0,1,0.14285714285714285,1,0.0,0,0,0,0,0,0,0,1,0,0,1,1
8664,198822,uZbzvdzFyR1ceRxI8f80IsSKw8Wzuev1,SpATywNh6bZuzm8s1ceuBUnMUAeoAHHw,7,7,1,0,1,0,2,0,11,1.5714285714285714,1,0.0,0,1,0,1,7,0,0,2,0,2,9,0
8665,198823,2ENDZhPlfPQ7xqwHjrfLuuWg5Duw7ZBj,G8EPVSXsOYB5YQWZGiz1aVq5Pgr2GrQu,4,4,1,0,1,0,1,0,7,1.0,1,0.0,1,1,0,1,3,0,0,1,0,3,4,1
8666,198832,PKdKWqW1VQJFocRWfF0D5fFjfdW8ENqW,SpATywNh6bZuzm8s1ceuBUnMUAeoAHHw,2,0,0,0,0,0,2,0,2,0.2857142857142857,1,0.0,0,0,0,0,0,0,0,2,0,0,2,1
8667,198844,9xn3imvdiJkc9HcKhWV1Hhylco4OVjiR,SpATywNh6bZuzm8s1ceuBUnMUAeoAHHw,2,0,0,0,0,0,2,0,2,0.2857142857142857,1,0.0,0,0,0,0,0,0,0,2,0,0,2,1
8668,198849,9xn3imvdiJkc9HcKhWV1Hhylco4OVjiR,G8EPVSXsOYB5YQWZGiz1aVq5Pgr2GrQu,7,13,0,0,0,0,4,0,17,2.4285714285714284,1,0.0,1,0,0,0,12,0,0,4,0,1,16,1
8669,198863,ZWKBU7cFyL8Xqx9wqUlqIH5ujAlqP1xm,A3fsA9Zfv1X2fVEQhTw51lKENdNrEqT3,8,7,3,0,2,0,3,0,15,2.142857142857143,1,0.0,0,3,0,2,7,0,0,3,0,5,10,1
8670,198865,AUCcjgWVaeHbyOo7n1ZoCM3NX1aTzthI,G8EPVSXsOYB5YQWZGiz1aVq5Pgr2GrQu,7,4,0,0,0,0,5,0,9,1.2857142857142858,1,0.0,0,0,0,0,4,0,0,5,0,0,9,1
8671,198866,cGujrM5GGnHFlTqKFoeVE54jkUOVyngH,A3fsA9Zfv1X2fVEQhTw51lKENdNrEqT3,1,0,0,0,0,0,1,0,1,0.14285714285714285,1,0.0,0,0,0,0,0,0,0,1,0,0,1,1
8672,198868,rlQIqtgsDfEVihltHvVH3EnaOkFIJWY2,A3fsA9Zfv1X2fVEQhTw51lKENdNrEqT3,1,0,0,0,0,0,1,0,1,0.14285714285714285,1,0.0,0,0,0,0,0,0,0,1,0,0,1,1
8673,198869,TSm2R7cUPaXhbTrj1LddmwVL7dduRSSa,A3fsA9Zfv1X2fVEQhTw51lKENdNrEqT3,8,3,2,0,2,8,6,1,22,3.142857142857143,1,0.0,0,2,0,2,3,8,0,6,1,4,18,1
8674,198870,3Ayux0uPJ6ML3SyziM62LSRrG0V1OgIm,SpATywNh6bZuzm8s1ceuBUnMUAeoAHHw,17,18,11,10,6,1,6,1,53,7.571428571428571,1,0.0,5,11,9,6,13,1,1,6,1,31,22,1
8675,198874,JdraUX9nFc2Y8K2LiincPu5HyHjoquI8,A3fsA9Zfv1X2fVEQhTw51lKENdNrEqT3,8,6,0,0,0,1,10,1,18,2.5714285714285716,1,0.0,3,0,0,0,3,1,0,10,1,3,15,1
8676,198894,nKVAY2GHYnzf4BfG261ddlVdtqvsIA9B,A3fsA9Zfv1X2fVEQhTw51lKENdNrEqT3,6,4,2,0,2,0,1,0,9,1.2857142857142858,1,0.0,0,2,0,2,4,0,0,1,0,4,5,1
8677,198899,ctoSfpAfvm3av2aqkT0D3Yq8icDxZKCx,A3fsA9Zfv1X2fVEQhTw51lKENdNrEqT3,1,0,0,0,0,0,1,0,1,0.14285714285714285,1,0.0,0,0,0,0,0,0,0,1,0,0,1,1
8678,198902,pSRqXJrhW3cpcIMqshrNJY13lAR5UPwX,G8EPVSXsOYB5YQWZGiz1aVq5Pgr2GrQu,2,0,0,0,0,0,2,0,2,0.2857142857142857,1,0.0,0,0,0,0,0,0,0,2,0,0,2,1
8679,198903,iUqEEHE7KFlYvrJ9lttneq6sdDOxoE0o,SpATywNh6bZuzm8s1ceuBUnMUAeoAHHw,1,0,0,0,0,0,1,0,1,0.14285714285714285,1,0.0,0,0,0,0,0,0,0,1,0,0,1,0
8680,198910,pSRqXJrhW3cpcIMqshrNJY13lAR5UPwX,A3fsA9Zfv1X2fVEQhTw51lKENdNrEqT3,2,0,0,0,0,0,2,0,2,0.2857142857142857,1,0.0,0,0,0,0,0,0,0,2,0,0,2,1
8681,198915,5RFNEnBqW8mdktbwEzjZ2lPhm72vzWhr,SpATywNh6bZuzm8s1ceuBUnMUAeoAHHw,8,4,3,0,2,0,2,0,11,1.5714285714285714,1,0.0,0,3,0,2,4,0,0,2,0,5,6,1
8682,198936,QO42SHgXwWqLSSYHUVMAX8sjMgYnpZEl,G8EPVSXsOYB5YQWZGiz1aVq5Pgr2GrQu,7,3,2,0,2,0,2,0,9,1.2857142857142858,1,0.0,0,2,0,2,3,0,0,2,0,4,5,1
8683,198955,25eiJkNBguZOcrPXS1ZGiSW1nfaRn05c,SpATywNh6bZuzm8s1ceuBUnMUAeoAHHw,7,3,2,0,2,0,2,0,9,1.2857142857142858,1,0.0,0,2,0,2,3,0,0,2,0,4,5,1
8684,198956,GyLB5V57I2KbnfFgZclSqyQAUY6eRpjt,A3fsA9Zfv1X2fVEQhTw51lKENdNrEqT3,2,0,0,0,0,0,2,0,2,0.2857142857142857,1,0.0,0,0,0,0,0,0,0,2,0,0,2,1
8685,198963,WAnB7c5F1PHHqCCd4HzBf0vmVEoM8DG4,SpATywNh6bZuzm8s1ceuBUnMUAeoAHHw,6,3,0,0,0,2,6,0,11,1.5714285714285714,1,0.0,0,0,0,0,3,2,0,6,0,0,11,1
8686,198965,9og5l3kBrvNmeUS7WEJnLIW5U5JOFnlr,SpATywNh6bZuzm8s1ceuBUnMUAeoAHHw,5,1,1,0,1,0,2,0,5,0.7142857142857143,1,0.0,0,1,0,1,1,0,0,2,0,2,3,1
8687,198975,2oTvbzieHn2y5oozeOgSnruqE6N0BtR5,bWdj2GDclj5ofokWjzoa5jAwMkxCykd6,11,11,6,0,5,7,4,0,33,4.714285714285714,1,0.0,2,6,0,5,9,7,0,4,0,13,20,1
8688,198976,qJSVGIIBKQpzllCeTCwG3pgdEZIo3QRz,bWdj2GDclj5ofokWjzoa5jAwMkxCykd6,1,0,0,0,0,0,1,0,1,0.14285714285714285,1,0.0,0,0,0,0,0,0,0,1,0,0,1,1
8689,198979,U5aocuOsbgg0bKahFwFd1In2DcDc3oBc,G8EPVSXsOYB5YQWZGiz1aVq5Pgr2GrQu,7,5,2,0,2,0,2,0,11,1.5714285714285714,1,0.0,0,2,0,2,5,0,0,2,0,4,7,1
8690,198991,mSWRBlOsrbB7GjQNoTuNmuW3YOy77l6X,bWdj2GDclj5ofokWjzoa5jAwMkxCykd6,1,0,0,0,0,0,1,0,1,0.14285714285714285,1,0.0,0,0,0,0,0,0,0,1,0,0,1,1
8691,198993,mSWRBlOsrbB7GjQNoTuNmuW3YOy77l6X,A3fsA9Zfv1X2fVEQhTw51lKENdNrEqT3,1,0,0,0,0,0,1,0,1,0.14285714285714285,1,0.0,0,0,0,0,0,0,0,1,0,0,1,1
8692,199000,4UScXtt088oGe9dJ2KJws6faWfnlaEO8,G8EPVSXsOYB5YQWZGiz1aVq5Pgr2GrQu,8,12,0,0,0,0,4,0,16,2.2857142857142856,1,0.0,0,0,0,0,12,0,0,4,0,0,16,1
8693,199004,wB1zTvSxiuMnQ6mG62KhRDH75H6JzCKK,G8EPVSXsOYB5YQWZGiz1aVq5Pgr2GrQu,1,0,0,0,0,0,1,0,1,0.14285714285714285,1,0.0,0,0,0,0,0,0,0,1,0,0,1,1
8694,199009,UoLm4A2shVKJTBQjYq1cnhy9CVAb6BPB,SpATywNh6bZuzm8s1ceuBUnMUAeoAHHw,1,0,0,0,0,0,2,0,2,0.2857142857142857,1,0.0,0,0,0,0,0,0,0,2,0,0,2,1
8695,199016,C4ciI1Hxrse5ND4h1rvhsDGjFinNO7RJ,bWdj2GDclj5ofokWjzoa5jAwMkxCykd6,8,9,1,0,1,1,10,5,27,3.857142857142857,1,0.0,5,1,0,1,4,1,0,10,5,7,20,1
8696,199018,YQQ0U1ySGhxQGw2MpzkqAJru8VuefP0L,bWdj2GDclj5ofokWjzoa5jAwMkxCykd6,4,5,2,0,0,0,2,0,9,1.2857142857142858,1,0.0,2,2,0,0,3,0,0,2,0,4,5,1
8697,199029,cderIDaWBR3ykedbqXoG7yh75mThXkpL,bWdj2GDclj5ofokWjzoa5jAwMkxCykd6,1,0,0,0,0,0,1,0,1,0.14285714285714285,1,0.0,0,0,0,0,0,0,0,1,0,0,1,1
8698,199032,aTQ4Ypzwh1rImg9ZYH1ng3j22ZvxNJg3,SpATywNh6bZuzm8s1ceuBUnMUAeoAHHw,1,0,0,0,0,0,1,0,1,0.14285714285714285,1,0.0,0,0,0,0,0,0,0,1,0,0,1,1
8699,199036,Cj6qzoa736NxMqt5KsDr9YuISfsEJCrb,SpATywNh6bZuzm8s1ceuBUnMUAeoAHHw,6,3,1,0,1,0,2,0,7,1.0,1,0.0,0,1,0,1,3,0,0,2,0,2,5,1
8700,199044,nmlYjXdaqWSjPWm2kQhmjZqjjBKhkQAm,bWdj2GDclj5ofokWjzoa5jAwMkxCykd6,6,3,2,0,2,1,4,1,13,1.8571428571428572,1,0.0,0,2,0,2,3,1,0,4,1,4,9,1
8701,199046,xcyypTvwSo3LXkXsaePEIK0Y1mo0nQoS,SpATywNh6bZuzm8s1ceuBUnMUAeoAHHw,13,15,8,4,3,0,2,0,32,4.571428571428571,1,0.0,6,8,4,3,9,0,0,2,0,21,11,1
8702,199049,Yer7ST1oiQQLYYgjANCmG1MBkWuTCohH,bWdj2GDclj5ofokWjzoa5jAwMkxCykd6,1,0,0,0,0,0,1,0,1,0.14285714285714285,1,0.0,0,0,0,0,0,0,0,1,0,0,1,1
8703,199051,uufXnXOfmStAymRAiMYAROVtj5hPlDvd,A3fsA9Zfv1X2fVEQhTw51lKENdNrEqT3,1,0,0,0,0,0,1,0,1,0.14285714285714285,1,0.0,0,0,0,0,0,0,0,1,0,0,1,1
8704,199056,OGCl7FuINJMmIPxVehaSeriK0obhKOqa,SpATywNh6bZuzm8s1ceuBUnMUAeoAHHw,8,6,4,0,3,0,1,0,14,2.0,1,0.0,0,4,0,3,6,0,0,1,0,7,7,1
8705,199057,AW3qB37tEUxBhbQEUxhofJkaUbKF4F7i,bWdj2GDclj5ofokWjzoa5jAwMkxCykd6,2,0,0,0,0,4,1,0,5,0.7142857142857143,1,0.0,0,0,0,0,0,4,0,1,0,0,5,1
8706,199058,VeLCqoeC0RO3eUOAMmBgbUdlxxqFnwbN,SpATywNh6bZuzm8s1ceuBUnMUAeoAHHw,4,4,0,0,0,0,2,0,6,0.8571428571428571,1,0.0,0,0,0,0,4,0,0,2,0,0,6,0
8707,199069,M45QNJ6951iGJajsprAeFVhHViiX50AV,A3fsA9Zfv1X2fVEQhTw51lKENdNrEqT3,22,12,10,0,9,5,5,1,42,6.0,1,0.0,0,10,0,9,12,5,0,5,1,19,23,1
8708,199078,pXGBcTffNYWAUeYw1RFCIuTgQsIvI4OJ,G8EPVSXsOYB5YQWZGiz1aVq5Pgr2GrQu,5,2,1,0,1,0,2,0,6,0.8571428571428571,1,0.0,0,1,0,1,2,0,0,2,0,2,4,0
